Simulation,PlayerID,Player,Position,Team,Age,Games Played,Goals,Assists,Points
1,8478402,Connor McDavid,C,EDM,26,80,44,93,137
1,8477492,Nathan MacKinnon,C,COL,28,82,43,87,130
1,8476453,Nikita Kucherov,R,TBL,30,81,46,83,129
1,8477939,William Nylander,R,TOR,27,82,45,63,108
1,8478550,Artemi Panarin,L,NYR,32,82,44,64,108
1,8479318,Auston Matthews,C,TOR,26,81,70,37,107
1,8477933,Sam Reinhart,C,FLA,28,82,59,48,107
1,8479314,Matthew Tkachuk,L,FLA,26,82,31,75,106
1,8477956,David Pastrnak,R,BOS,27,82,44,58,102
1,8478427,Sebastian Aho,C,CAR,26,78,43,58,101
1,8478420,Mikko Rantanen,R,COL,27,82,45,55,100
1,8477934,Leon Draisaitl,C,EDM,28,82,39,60,99
1,8480012,Elias Pettersson,C,VAN,25,81,40,56,96
1,8476468,J.T. Miller,C,VAN,30,81,34,61,95
1,8478483,Mitchell Marner,R,TOR,26,81,30,63,93
1,8480800,Quinn Hughes,D,VAN,24,81,20,71,91
1,8479407,Jesper Bratt,L,NJD,25,81,29,61,90
1,8480069,Cale Makar,D,COL,25,77,20,70,90
1,8471675,Sidney Crosby,C,PIT,36,82,48,39,87
1,8477409,Carter Verhaeghe,C,FLA,28,82,48,39,87
1,8480023,Robert Thomas,C,STL,24,82,32,55,87
1,8478445,Mathew Barzal,C,NYI,26,81,27,59,86
1,8476887,Filip Forsberg,L,NSH,29,82,41,44,85
1,8480027,Jason Robertson,L,DAL,24,82,24,61,85
1,8480865,Noah Dobson,D,NYI,23,82,15,70,85
1,8477493,Aleksander Barkov,C,FLA,28,76,21,63,84
1,8476459,Mika Zibanejad,C,NYR,30,81,26,55,81
1,8478444,Brock Boeser,R,VAN,26,81,42,38,80
1,8478439,Travis Konecny,R,PHI,26,81,39,41,80
1,8478864,Kirill Kaprizov,L,MIN,26,75,35,45,80
1,8475168,Matt Duchene,C,DAL,32,81,34,45,79
1,8477404,Jake Guentzel,L,PIT,29,81,29,50,79
1,8478010,Brayden Point,C,TBL,27,82,34,44,78
1,8474564,Steven Stamkos,C,TBL,33,79,34,44,78
1,8479343,Clayton Keller,R,ARI,25,82,33,45,78
1,8476454,Ryan Nugent-Hopkins,C,EDM,30,82,23,55,78
1,8480803,Evan Bouchard,D,EDM,24,82,18,60,78
1,8477946,Dylan Larkin,C,DET,27,76,38,39,77
1,8480018,Nick Suzuki,C,MTL,24,82,31,46,77
1,8481559,Jack Hughes,C,NJD,22,65,26,51,77
1,8475167,Victor Hedman,D,TBL,33,80,16,61,77
1,8473419,Brad Marchand,L,BOS,35,82,42,34,76
1,8478449,Roope Hintz,C,DAL,27,80,34,42,76
1,8475158,Ryan O'Reilly,C,NSH,32,82,30,46,76
1,8479542,Brandon Hagel,L,TBL,25,82,29,47,76
1,8475184,Chris Kreider,L,NYR,32,82,43,32,75
1,8470794,Joe Pavelski,C,DAL,39,82,32,43,75
1,8476389,Vincent Trocheck,C,NYR,30,82,29,46,75
1,8475786,Zach Hyman,L,EDM,31,81,47,27,74
1,8481540,Cole Caufield,R,MTL,22,82,30,44,74
1,8474600,Roman Josi,D,NSH,33,82,16,57,73
1,8477402,Pavel Buchnevich,L,STL,28,80,27,45,72
1,8477942,Kevin Fiala,L,LAK,27,82,24,48,72
1,8477500,Bo Horvat,C,NYI,28,81,33,38,71
1,8471685,Anze Kopitar,C,LAK,36,82,28,43,71
1,8479323,Adam Fox,D,NYR,25,72,13,58,71
1,8479385,Jordan Kyrou,C,STL,25,82,30,40,70
1,8477501,Valeri Nichushkin,R,COL,28,67,32,37,69
1,8478403,Jack Eichel,C,VGK,27,70,28,40,68
1,8480208,Drake Batherson,R,OTT,25,82,27,41,68
1,8480839,Rasmus Dahlin,D,BUF,23,81,23,45,68
1,8482116,Tim Stützle,C,OTT,21,82,17,51,68
1,8478975,Mason Marchment,L,DAL,28,81,29,38,67
1,8476539,Jonathan Marchessault,R,VGK,33,81,42,24,66
1,8475794,Tyler Seguin,C,DAL,31,82,27,39,66
1,8479337,Alex DeBrincat,R,DET,26,82,26,40,66
1,8480801,Brady Tkachuk,L,OTT,24,82,37,28,65
1,8476881,Tomas Hertl,C,SJS,30,76,28,37,65
1,8477960,Adrian Kempe,R,LAK,27,82,22,43,65
1,8475913,Mark Stone,R,VGK,31,81,19,46,65
1,8482093,Seth Jarvis,C,CAR,21,81,24,40,64
1,8475692,Mats Zuccarello,R,MIN,36,73,18,46,64
1,8480002,Nico Hischier,C,NJD,24,70,29,34,63
1,8475172,Nazem Kadri,C,CGY,33,82,27,36,63
1,8480797,Joel Farabee,L,PHI,23,81,25,38,63
1,8478366,Frank Vatrano,R,ANA,29,82,32,30,62
1,8475754,Brock Nelson,C,NYI,32,82,28,34,62
1,8477496,Elias Lindholm,C,VAN,29,81,24,38,62
1,8478493,Joel Eriksson Ek,C,MIN,26,82,34,27,61
1,8475810,Bryan Rust,R,PIT,31,69,28,33,61
1,8475765,Vladimir Tarasenko,R,OTT,32,80,27,34,61
1,8478873,Troy Terry,R,ANA,26,79,23,38,61
1,8475745,Charlie Coyle,C,BOS,31,82,22,39,61
1,8482078,Lucas Raymond,L,DET,21,82,22,39,61
1,8477949,Alex Tuch,R,BUF,27,75,23,37,60
1,8474679,Gustav Nyquist,C,NSH,34,82,21,39,60
1,8476346,Johnny Gaudreau,L,CBJ,30,81,16,44,60
1,8479999,Casey Mittelstadt,C,BUF,25,82,15,45,60
1,8471214,Alex Ovechkin,L,WSH,38,79,26,33,59
1,8476460,Mark Scheifele,C,WPG,30,75,22,37,59
1,8474578,Erik Karlsson,D,PIT,33,82,12,47,59
1,8478407,Vince Dunn,D,SEA,27,78,12,47,59
1,8476875,Mike Matheson,D,MTL,29,82,9,50,59
1,8476448,William Karlsson,C,VGK,30,69,24,34,58
1,8475166,John Tavares,C,TOR,33,80,22,36,58
1,8473512,Claude Giroux,R,OTT,35,82,20,38,58
1,8476882,Teuvo Teravainen,L,CAR,29,81,28,29,57
1,8476399,Blake Coleman,C,CGY,32,82,26,31,57
1,8482124,Quinton Byfield,R,LAK,21,80,24,33,57
1,8471215,Evgeni Malkin,C,PIT,37,82,21,36,57
1,8477955,Jared McCann,L,SEA,27,81,33,23,56
1,8481557,Matt Boldy,L,MIN,22,75,26,30,56
1,8477416,Oliver Bjorkstrand,R,SEA,28,82,19,37,56
1,8478440,Dylan Strome,C,WSH,26,82,31,24,55
1,8477497,Sean Monahan,C,WPG,29,83,21,34,55
1,8478460,Zach Werenski,D,CBJ,26,69,4,51,55
1,8475726,Tyler Toffoli,R,NJD,31,80,31,23,54
1,8480039,Martin Necas,C,CAR,24,76,22,32,54
1,8480830,Andrei Svechnikov,R,CAR,23,60,20,34,54
1,8474037,James van Riemsdyk,L,BOS,34,78,19,35,54
1,8481542,Moritz Seider,D,DET,22,82,9,45,54
1,8476853,Morgan Rielly,D,TOR,29,79,8,46,54
1,8480015,Owen Tippett,R,PHI,24,77,29,24,53
1,8474641,Adam Henrique,C,ANA,33,81,25,28,53
1,8482740,Wyatt Johnston,C,DAL,20,82,25,28,53
1,8481711,Matias Maccelli,L,ARI,23,82,11,42,53
1,8477951,Nick Schmaltz,C,ARI,27,79,26,26,52
1,8479325,Charlie McAvoy,D,BOS,26,74,10,42,52
1,8479420,Tage Thompson,C,BUF,26,72,28,23,51
1,8475784,Jeff Skinner,L,BUF,31,74,28,23,51
1,8477935,Sam Bennett,C,FLA,27,70,22,29,51
1,8476479,Phillip Danault,C,LAK,30,82,16,35,51
1,8477504,Josh Morrissey,D,WPG,28,81,11,40,51
1,8479675,Trevor Moore,L,LAK,28,82,27,23,50
1,8477346,MacKenzie Weegar,D,CGY,29,82,23,27,50
1,8478047,Michael Bunting,L,CAR,28,80,17,33,50
1,8476906,Shayne Gostisbehere,D,DET,30,81,10,40,50
1,8475798,Mikael Granlund,C,SJS,31,68,8,42,50
1,8479425,Filip Hronek,D,VAN,26,81,5,45,50
1,8477948,Travis Sanheim,D,PHI,27,80,5,45,50
1,8478474,Lawson Crouse,L,ARI,26,81,30,19,49
1,8482175,JJ Peterka,R,BUF,21,82,25,24,49
1,8477940,Nikolaj Ehlers,L,WPG,27,81,21,28,49
1,8481068,Yegor Sharangovich,C,CGY,25,82,24,24,48
1,8477494,Jonathan Drouin,L,COL,28,80,18,30,48
1,8478401,Pavel Zacha,C,BOS,26,78,14,34,48
1,8478396,Noah Hanifin,D,CGY,26,82,13,35,48
1,8478397,Rasmus Andersson,D,CGY,27,78,11,37,48
1,8475169,Evander Kane,L,EDM,32,81,28,19,47
1,8476456,Jonathan Huberdeau,C,CGY,30,81,13,34,47
1,8471724,Kris Letang,D,PIT,36,82,7,40,47
1,8474590,John Carlson,D,WSH,33,82,5,42,47
1,8482149,Cole Perfetti,C,WPG,21,81,20,26,46
1,8478519,Anthony Cirelli,C,TBL,26,81,18,28,46
1,8478233,Andrew Mangiapane,L,CGY,27,81,17,29,46
1,8481528,Dylan Cozens,C,BUF,22,79,16,30,46
1,8477451,Ryan Hartman,R,MIN,29,77,26,19,45
1,8482109,Alexis Lafrenière,L,NYR,22,82,20,25,45
1,8475170,Brayden Schenn,C,STL,32,82,19,26,45
1,8475760,Nick Bjugstad,C,ARI,31,82,19,26,45
1,8474563,Drew Doughty,D,LAK,34,82,16,29,45
1,8473994,Jamie Benn,L,DAL,34,82,14,31,45
1,8477998,Warren Foegele,L,EDM,27,82,14,31,45
1,8482122,Brock Faber,D,MIN,21,82,7,38,45
1,8479400,Pierre-Luc Dubois,C,LAK,25,82,22,22,44
1,8479365,Trent Frederic,C,BOS,25,82,20,24,44
1,8474586,Jordan Eberle,R,SEA,33,78,17,27,44
1,8480798,Philipp Kurashev,C,CHI,24,75,12,32,44
1,8476458,Ryan Strome,C,ANA,30,79,12,32,44
1,8477021,Alex Kerfoot,C,ARI,29,82,11,33,44
1,8480036,Miro Heiskanen,D,DAL,24,72,8,36,44
1,8478398,Kyle Connor,L,WPG,27,65,28,15,43
1,8482089,Jake Neighbours,L,STL,21,82,28,15,43
1,8480014,Gabriel Vilardi,C,WPG,24,61,22,21,43
1,8475151,Kyle Palmieri,C,NYI,32,82,20,23,43
1,8481624,Ilya Mikheyev,R,VAN,29,77,20,23,43
1,8475287,Erik Haula,L,NJD,32,75,19,24,43
1,8482745,Mason McTavish,C,ANA,20,74,19,24,43
1,8481581,Thomas Harley,D,DAL,22,79,18,25,43
1,8474150,Mikael Backlund,C,CGY,34,82,17,26,43
1,8478038,Devon Toews,D,COL,29,82,12,31,43
1,8480434,Sean Durzi,D,ARI,25,76,10,33,43
1,8477503,Max Domi,C,TOR,28,82,10,33,43
1,8476792,Torey Krug,D,STL,32,82,3,40,43
1,8482079,Marco Rossi,C,MIN,22,82,22,20,42
1,8477456,J.T. Compher,L,DET,28,77,18,24,42
1,8483515,Juraj Slafkovsky,L,MTL,19,82,18,24,42
1,8474141,Patrick Kane,R,DET,35,51,17,25,42
1,8477429,Andrew Copp,C,DET,29,81,16,26,42
1,8482684,Luke Hughes,D,NJD,20,81,14,28,42
1,8478542,Evan Rodrigues,C,FLA,30,82,12,30,42
1,8478438,Tommy Novak,C,NSH,26,71,17,24,41
1,8476905,Chandler Stephenson,C,VGK,29,77,14,27,41
1,8475764,Cam Fowler,D,ANA,32,82,6,35,41
1,8477511,Anthony Mantha,R,WSH,29,78,24,16,40
1,8482110,Dawson Mercer,C,NJD,22,81,23,17,40
1,8480893,Kirill Marchenko,R,CBJ,23,79,22,18,40
1,8475799,Nino Niederreiter,R,WPG,31,81,20,20,40
1,8482146,Luke Evangelista,R,NSH,21,80,18,22,40
1,8482720,Matthew Knies,L,TOR,21,80,15,25,40
1,8476872,Scott Laughton,C,PHI,29,81,11,29,40
1,8482113,Anton Lundell,C,FLA,22,78,9,31,40
1,8476432,Boone Jenner,C,CBJ,30,66,27,12,39
1,8480009,Eeli Tolvanen,R,SEA,24,82,20,19,39
1,8483808,Andrei Kuzmenko,L,CGY,27,76,19,20,39
1,8479525,Ross Colton,C,COL,27,80,18,21,39
1,8478414,Timo Meier,R,NJD,27,68,15,24,39
1,8476869,Brady Skjei,D,CAR,29,81,11,28,39
1,8470613,Brent Burns,D,CAR,38,81,9,30,39
1,8475191,Reilly Smith,R,PIT,32,76,19,19,38
1,8473422,Nick Foligno,L,CHI,36,75,19,19,38
1,8476925,Colton Sissons,C,NSH,30,82,18,20,38
1,8474102,David Perron,L,DET,35,76,17,21,38
1,8477964,Ivan Barbashev,C,VGK,28,81,17,21,38
1,8475722,Jason Zucker,L,ARI,31,72,15,23,38
1,8482667,William Eklund,L,SJS,21,80,11,27,38
1,8477450,Jason Dickinson,C,CHI,28,82,24,13,37
1,8477426,Nicholas Paul,L,TBL,28,82,20,17,37
1,8475768,Jaden Schwartz,C,SEA,31,66,18,19,37
1,8476419,Jean-Gabriel Pageau,C,NYI,31,82,15,22,37
1,8477479,Tyler Bertuzzi,L,TOR,28,81,15,22,37
1,8478462,Nicolas Roy,C,VGK,26,72,14,23,37
1,8478856,Conor Garland,R,VAN,27,81,14,23,37
1,8478055,Gustav Forsling,D,FLA,27,81,13,24,37
1,8479345,Jakob Chychrun,D,OTT,25,82,11,26,37
1,8480028,Morgan Frost,C,PHI,24,70,11,26,37
1,8482159,Tyson Foerster,R,PHI,21,78,23,13,36
1,8480064,Josh Norris,C,OTT,24,75,19,17,36
1,8477952,Robby Fabbri,C,DET,27,68,19,17,36
1,8480813,Joe Veleno,C,DET,23,80,17,19,36
1,8475193,Tomas Tatar,L,SEA,33,78,12,24,36
1,8482105,Jake Sanderson,D,OTT,21,79,10,26,36
1,8476927,Teddy Blueger,C,VAN,29,67,10,26,36
1,8476483,Rickard Rakell,R,PIT,30,70,7,29,36
1,8475753,Justin Faulk,D,STL,31,68,6,30,36
1,8474565,Alex Pietrangelo,D,VGK,33,76,3,33,36
1,8478498,Jake DeBrusk,L,BOS,27,80,19,16,35
1,8474149,Evgenii Dadonov,R,DAL,34,77,17,18,35
1,8474884,Mike Hoffman,C,SJS,34,79,16,19,35
1,8481186,Logan O'Connor,R,COL,27,78,16,19,35
1,8478057,Dakota Joshua,C,VAN,27,79,16,19,35
1,8482092,Ridly Greig,C,OTT,21,72,15,20,35
1,8482125,Alexander Holtz,R,NJD,21,81,15,20,35
1,8473986,Alex Killorn,L,ANA,34,63,14,21,35
1,8479987,Morgan Geekie,C,BOS,25,76,14,21,35
1,8475171,Oliver Ekman-Larsson,D,FLA,32,82,13,22,35
1,8478472,Mathieu Joseph,R,OTT,26,72,12,23,35
1,8476480,Vladislav Namestnikov,C,WPG,31,78,10,25,35
1,8479410,Mikhail Sergachev,D,TBL,25,60,6,29,35
1,8477495,Seth Jones,D,CHI,29,67,3,32,35
1,8480188,Fabian Zetterlund,L,SJS,24,81,21,13,34
1,8476438,Brandon Saad,L,STL,31,82,18,16,34
1,8479941,Justin Danforth,R,CBJ,30,81,17,17,34
1,8479339,Patrik Laine,L,CBJ,25,47,14,20,34
1,8478466,Daniel Sprong,R,DET,26,54,14,20,34
1,8475744,Evgeny Kuznetsov,C,WSH,31,72,12,22,34
1,8476892,Colton Parayko,D,STL,30,82,10,24,34
1,8477447,Shea Theodore,D,VGK,28,48,9,25,34
1,8481577,Philip Tomasino,C,NSH,22,68,9,25,34
1,8478500,Ivan Provorov,D,CBJ,26,81,6,28,34
1,8479351,Sam Steel,C,DAL,25,77,15,18,33
1,8476921,Jordan Martinook,L,CAR,31,81,14,19,33
1,8471218,Blake Wheeler,R,NYR,37,82,14,19,33
1,8476979,Erik Gustafsson,D,NYR,31,81,6,27,33
1,8476854,Hampus Lindholm,D,BOS,29,82,3,30,33
1,8477969,Marcus Pettersson,D,PIT,27,82,3,30,33
1,8475314,Anders Lee,L,NYI,33,82,22,10,32
1,8482475,Yegor Chinakhov,R,CBJ,22,69,18,14,32
1,8473449,Kyle Okposo,R,BUF,35,79,16,16,32
1,8477476,Artturi Lehkonen,L,COL,28,47,14,18,32
1,8473533,Jordan Staal,C,CAR,35,81,13,19,32
1,8475763,Kevin Hayes,R,STL,31,82,13,19,32
1,8475149,Marcus Johansson,L,MIN,33,82,12,20,32
1,8476392,Adam Lowry,C,WPG,30,81,12,20,32
1,8480855,Jack McBain,C,ARI,23,67,12,20,32
1,8478109,Victor Olofsson,L,BUF,28,63,12,20,32
1,8482665,Matty Beniers,C,SEA,21,77,11,21,32
1,8476462,Dougie Hamilton,D,NJD,30,48,9,23,32
1,8475181,Nick Leddy,D,STL,32,82,7,25,32
1,8478469,Thomas Chabot,D,OTT,26,60,6,26,32
1,8481582,Nicholas Robertson,L,TOR,22,64,18,13,31
1,8478891,Mason Appleton,C,WPG,27,81,12,19,31
1,8477986,Brandon Montour,D,FLA,29,66,9,22,31
1,8476958,Jaccob Slavin,D,CAR,29,81,7,24,31
1,8476885,Jacob Trouba,D,NYR,29,80,5,26,31
1,8482671,Owen Power,D,BUF,21,79,4,27,31
1,8476374,Sean Kuraly,C,CBJ,30,73,18,12,30
1,8479992,Michael Rasmussen,C,DET,24,82,16,14,30
1,8477505,Alex Wennberg,C,SEA,29,82,11,19,30
1,8475220,Marcus Foligno,L,MIN,32,75,11,19,30
1,8478507,John Marino,D,NJD,26,81,8,22,30
1,8476826,Yanni Gourde,C,SEA,32,80,8,22,30
1,8480145,Neal Pionk,D,WPG,28,81,6,24,30
1,8482655,J.J. Moser,D,ARI,23,80,6,24,30
1,8476292,Ondrej Palat,L,NJD,32,71,15,14,29
1,8475714,Calle Jarnkrok,C,TOR,32,75,15,14,29
1,8479415,Michael McLeod,C,NJD,25,73,15,14,29
1,8481560,Arthur Kaliyev,R,LAK,22,68,14,15,29
1,8482705,Cole Sillinger,C,CBJ,20,76,13,16,29
1,8480802,Ryan McLeod,C,EDM,24,81,13,16,29
1,8481032,Paul Cotter,C,VGK,24,80,9,20,29
1,8481546,Cam York,D,PHI,22,81,8,21,29
1,8476931,Jake McCabe,D,TOR,30,76,6,23,29
1,8475218,Mattias Ekholm,D,EDM,33,81,5,24,29
1,8480873,Rasmus Sandin,D,WSH,23,74,4,25,29
1,8476880,Tom Wilson,R,WSH,29,81,16,12,28
1,8480459,Pius Suter,C,VAN,27,67,16,12,28
1,8475343,Nic Dowd,C,WSH,33,73,15,13,28
1,8478046,Danton Heinen,L,BOS,28,74,15,13,28
1,8479977,Kailer Yamamoto,R,SEA,25,73,14,14,28
1,8478115,Pierre Engvall,L,NYI,27,76,13,15,28
1,8481604,Pavel Dorofeyev,L,VGK,23,57,13,15,28
1,8478020,Michael Amadio,R,VGK,27,74,12,16,28
1,8476474,Stefan Noesen,R,CAR,30,52,11,17,28
1,8477953,Kasperi Kapanen,R,STL,27,75,8,20,28
1,8479398,Samuel Girard,D,COL,25,61,7,21,28
1,8476902,Esa Lindell,D,DAL,29,82,7,21,28
1,8480336,Sean Walker,D,PHI,29,81,6,22,28
1,8476457,Adam Larsson,D,SEA,31,82,4,24,28
1,8474574,Tyler Myers,D,VAN,33,81,4,24,28
1,8474189,Lars Eller,C,PIT,34,82,16,11,27
1,8481601,Simon Holmstrom,R,NYI,22,81,16,11,27
1,8481524,Bowen  Byram,D,COL,22,74,11,16,27
1,8480113,Alex Iafallo,L,WPG,30,81,11,16,27
1,8474053,Logan Couture,C,SJS,34,34,9,18,27
1,8482097,Jack Quinn,R,BUF,22,45,9,18,27
1,8482055,Drew O'Connor,L,PIT,25,82,9,18,27
1,8478882,Vladislav Gavrikov,D,LAK,28,77,6,21,27
1,8478911,Matt Roy,D,LAK,28,81,6,21,27
1,8482245,Artem Zub,D,OTT,28,72,4,23,27
1,8480246,Nick Perbix,D,TBL,25,80,4,23,27
1,8475197,Tyson Barrie,D,NSH,32,62,3,24,27
1,8477330,Dominik Kubalik,L,OTT,28,78,18,8,26
1,8475793,Ryan Johansen,C,COL,31,82,14,12,26
1,8477498,Darnell Nurse,D,EDM,28,82,11,15,26
1,8476923,Damon Severson,D,CBJ,29,66,11,15,26
1,8480068,Ryan Poehling,C,PHI,24,76,11,15,26
1,8481533,Trevor Zegras,C,ANA,22,48,10,16,26
1,8480849,Barrett Hayton,C,ARI,23,50,9,17,26
1,8477932,Aaron Ekblad,D,FLA,27,64,7,19,26
1,8478178,Darren Raddysh,D,TBL,27,82,5,21,26
1,8479998,Mikey Anderson,D,LAK,24,82,3,23,26
1,8479619,Michael Carcone,L,ARI,27,76,18,7,25
1,8480185,Eetu Luostarinen,C,FLA,25,82,16,9,25
1,8477407,Anthony Duclair,L,SJS,28,76,14,11,25
1,8481580,Connor McMichael,C,WSH,22,80,13,12,25
1,8481618,Alex Newhook,C,MTL,22,55,12,13,25
1,8478136,Jake Middleton,D,MIN,27,82,11,14,25
1,8476897,Oskar Sundqvist,C,STL,29,82,8,17,25
1,8480817,K'Andre Miller,D,NYR,23,80,7,18,25
1,8482062,Cole Smith,L,NSH,28,81,6,19,25
1,8474602,Justin Schultz,D,SEA,33,72,4,21,25
1,8476918,Jimmy Vesey,L,NYR,30,80,17,7,24
1,8481535,Nils Hoglander,L,VAN,23,53,17,7,24
1,8471698,T.J. Oshie,R,WSH,37,65,15,9,24
1,8478013,Jake Walman,D,DET,27,76,14,10,24
1,8478413,Jordan Greenway,L,BUF,26,70,10,14,24
1,8475164,Jakob Silfverberg,R,ANA,33,81,8,16,24
1,8480835,Jack Drury,C,CAR,23,53,8,16,24
1,8478133,Jake Evans,C,MTL,27,82,6,18,24
1,8478458,Jack Roslovic,C,CBJ,26,58,5,19,24
1,8476422,Mike Reilly,D,NYI,30,61,4,20,24
1,8479661,Tanner Jeannot,L,TBL,26,68,14,9,23
1,8480829,Jesperi Kotkaniemi,C,CAR,23,81,13,10,23
1,8474870,Tyler Johnson,C,CHI,33,67,12,11,23
1,8479591,Michael Eyssimont,C,TBL,27,81,12,11,23
1,8475855,Jesper Fast,R,CAR,32,78,8,15,23
1,8477508,Curtis Lazar,C,NJD,28,76,8,15,23
1,8480078,Filip Chytil,C,NYR,24,38,6,17,23
1,8480878,Nils Lundkvist,D,DAL,23,70,5,18,23
1,8475790,Erik Gudbranson,D,CBJ,31,77,4,19,23
1,8475188,Brayden McNabb,D,VGK,32,81,3,20,23
1,8477425,Miles Wood,L,COL,28,77,11,11,22
1,8478043,Sam Lafferty,C,VAN,28,79,11,11,22
1,8476329,Travis Boyd,C,ARI,30,45,9,13,22
1,8475455,Brenden Dillon,D,WPG,33,78,8,14,22
1,8476312,Josh Manson,D,COL,32,77,8,14,22
1,8478463,Anthony Beauvillier,L,CHI,26,64,8,14,22
1,8474157,Max Pacioretty,L,WSH,35,47,8,14,22
1,8482142,Jamie Drysdale,D,PHI,21,49,5,17,22
1,8476463,Jonas Brodin,D,MIN,30,64,4,18,22
1,8482087,Kaiden Guhle,D,MTL,21,78,4,18,22
1,8478859,Niko Mikkola,D,FLA,27,82,4,18,22
1,8475200,Dmitry Orlov,D,CAR,32,81,4,18,22
1,8473507,Jeff Petry,D,DET,36,73,3,19,22
1,8476879,Cody Ceci,D,EDM,30,82,2,20,22
1,8480796,Martin Fehervary,D,WSH,24,76,2,20,22
1,8480281,Alexey Toropchenko,R,STL,24,82,16,5,21
1,8482157,Will Cuylle,L,NYR,21,82,11,10,21
1,8476981,Josh Anderson,R,MTL,29,78,9,12,21
1,8479390,Taylor Raddysh,R,CHI,25,77,9,12,21
1,8475231,Casey Cizikas,C,NYI,32,71,8,13,21
1,8470621,Corey Perry,R,EDM,38,54,8,13,21
1,8475233,David Savard,D,MTL,33,60,7,14,21
1,8478851,Alexandre Carrier,D,NSH,27,77,5,16,21
1,8481656,Aliaksei Protas,C,WSH,22,52,4,17,21
1,8474161,Jakub Voracek,R,CBJ,34,29,3,18,21
1,8478840,Will Borgen,D,SEA,27,82,2,19,21
1,8474673,TJ Brodie,D,TOR,33,81,1,20,21
1,8470600,Ryan Suter,D,DAL,38,82,1,20,21
1,8479316,Luke Kunin,C,SJS,26,76,12,8,20
1,8482699,Dylan Guenther,R,ARI,20,45,11,9,20
1,8481554,Kaapo Kakko,R,NYR,22,61,11,9,20
1,8482222,Alexander Barabanov,L,SJS,29,61,9,11,20
1,8479353,Brett Howden,C,VGK,25,79,9,11,20
1,8471699,Andrew Cogliano,C,COL,36,76,6,14,20
1,8477919,Frederick Gaudreau,C,MIN,30,70,4,16,20
1,8480043,Timothy Liljegren,D,TOR,24,65,2,18,20
1,8475906,John Klingberg,D,TOR,31,43,1,19,20
1,8476331,Dylan DeMelo,D,WPG,30,81,1,19,20
1,8475179,Dmitry Kulikov,D,FLA,33,78,0,20,20
1,8478508,Yakov Trenin,C,NSH,26,79,15,4,19
1,8476469,Joel Armia,R,MTL,30,66,13,6,19
1,8481704,Juuso Parssinen,C,NSH,22,71,13,6,19
1,8478831,Kevin Stenlund,C,FLA,27,82,12,7,19
1,8475208,Brian Dumoulin,D,SEA,32,80,9,10,19
1,8479346,Dillon Dube,C,CGY,25,70,9,10,19
1,8477444,Andre Burakovsky,L,SEA,28,51,6,13,19
1,8481014,Alexander Romanov,D,NYI,23,81,5,14,19
1,8475279,Ben Chiarot,D,DET,32,77,4,15,19
1,8474573,Josh Bailey,R,NYI,34,29,4,15,19
1,8477950,Tony DeAngelo,D,CAR,28,51,3,16,19
1,8474151,Ryan McDonagh,D,NSH,34,75,2,17,19
1,8475690,Chris Tanev,D,CGY,34,79,1,18,19
1,8482111,Justin Barron,D,MTL,22,68,11,7,18
1,8477989,Christian Dvorak,C,MTL,27,52,10,8,18
1,8473453,Trevor Lewis,C,LAK,36,82,10,8,18
1,8481481,Blake Lizotte,C,LAK,26,64,8,10,18
1,8477947,Sonny Milano,L,WSH,27,53,7,11,18
1,8477507,Nikita Zadorov,D,VAN,28,75,5,13,18
1,8482073,Braden Schneider,D,NYR,22,82,5,13,18
1,8478443,Brandon Carlo,D,BOS,27,77,4,14,18
1,8479976,Juuso Valimaki,D,ARI,25,68,2,16,18
1,8480049,Dylan Samberg,D,WPG,24,81,1,17,18
1,8470604,Jeff Carter,C,PIT,38,76,11,6,17
1,8474040,Sam Gagner,C,EDM,34,55,10,7,17
1,8479393,Noah Gregor,C,TOR,25,81,8,9,17
1,8480821,Filip Zadina,R,SJS,24,48,7,10,17
1,8476960,Andreas Athanasiou,C,CHI,29,38,6,11,17
1,8480172,Jan Rutta,D,SJS,33,75,5,12,17
1,8479359,Beck Malenstyn,L,WSH,25,81,5,12,17
1,8481093,Rafael Harvey-Pinard,L,MTL,24,51,4,13,17
1,8479983,Mario Ferraro,D,SJS,25,77,2,15,17
1,8477220,Nate Schmidt,D,WPG,32,75,2,15,17
1,8477365,Connor Clifton,D,BUF,28,79,0,17,17
1,8471274,Alex Goligoski,D,MIN,38,58,0,17,17
1,8479293,Brandon Tanev,L,SEA,32,66,9,7,16
1,8475848,Brendan Gallagher,R,MTL,31,50,8,8,16
1,8474166,Alec Martinez,D,VGK,36,64,7,9,16
1,8477506,Ryan Pulock,D,NYI,29,58,6,10,16
1,8477435,Ryan Graves,D,PIT,28,82,6,10,16
1,8475462,Radko Gudas,D,ANA,33,76,6,10,16
1,8482660,Kent Johnson,C,CBJ,21,36,6,10,16
1,8477944,Jakub Vrana,L,STL,27,49,6,10,16
1,8480035,Henri Jokiharju,D,BUF,24,74,5,11,16
1,8480220,Noah Cates,L,PHI,24,59,5,11,16
1,8480848,Ty Dellandrea,C,DAL,23,53,5,11,16
1,8476889,Radek Faksa,C,DAL,29,74,5,11,16
1,8479980,Nicolas Hague,D,VGK,25,73,4,12,16
1,8477839,Conor Sheary,L,TBL,31,64,4,12,16
1,8474034,Pat Maroon,L,MIN,35,49,4,12,16
1,8480994,Damien Giroux,C,MIN,23,28,2,14,16
1,8475324,Nick Jensen,D,WSH,33,82,2,14,16
1,8476941,Connor Carrick,D,BOS,29,27,1,15,16
1,8481606,Jordan Spence,D,LAK,22,44,0,16,16
1,8470638,Patrice Bergeron,C,BOS,38,27,10,5,15
1,8482101,Danil Gushchin,L,SJS,21,30,7,8,15
1,8477987,Ryan Donato,C,CHI,27,51,6,9,15
1,8476858,Phillip Di Giuseppe,L,VAN,30,62,6,9,15
1,8476442,Matt Nieto,L,PIT,31,53,6,9,15
1,8476525,Colin Miller,D,NJD,31,61,5,10,15
1,8481178,Egor Zamula,D,PHI,23,44,5,10,15
1,8479996,Cody Glass,C,NSH,24,54,5,10,15
1,8473548,Phil Kessel,R,VGK,36,28,4,11,15
1,8479324,Ryan Lindgren,D,NYR,25,80,2,13,15
1,8477845,Trevor van Riemsdyk,D,WSH,32,70,0,15,15
1,8481690,Tyler Angle,C,CBJ,23,29,11,3,14
1,8478468,Jeremy Lauzon,D,NSH,26,82,10,4,14
1,8482679,Matt Coronato,R,CGY,21,42,6,8,14
1,8474031,Kevin Shattenkirk,D,BOS,34,44,5,9,14
1,8478042,Viktor Arvidsson,R,LAK,30,32,5,9,14
1,8482117,Lukas Reichel,L,CHI,21,77,5,9,14
1,8478970,Jalen Chatfield,D,CAR,27,48,5,9,14
1,8480144,David Kampf,C,TOR,28,78,5,9,14
1,8477979,Nicolas Aube-Kubel,R,WSH,27,39,5,9,14
1,8481596,Shane Pinto,C,OTT,23,41,4,10,14
1,8473504,Cal Clutterbuck,R,NYI,36,53,4,10,14
1,8477380,Jonny Brodzinski,C,NYR,30,35,4,10,14
1,8481568,Alex Vlasic,D,CHI,22,76,3,11,14
1,8480807,Mattias Samuelsson,D,BUF,23,69,3,11,14
1,8481523,Kirby Dach,C,MTL,22,29,3,11,14
1,8474716,Jared Spurgeon,D,MIN,34,44,2,12,14
1,8477903,Garnet Hathaway,R,PHI,32,81,10,3,13
1,8481013,Jonatan Berggren,R,DET,23,37,9,4,13
1,8480289,Morgan Barron,C,WPG,25,51,9,4,13
1,8477446,Michael McCarron,R,NSH,28,43,7,6,13
1,8482259,Bobby McMann,C,TOR,27,29,7,6,13
1,8475791,Taylor Hall,L,CHI,32,37,6,7,13
1,8480448,Parker Kelly,L,OTT,24,51,6,7,13
1,8480762,Eric Robinson,L,BUF,28,54,4,9,13
1,8482711,Stanislav Svozil,D,CBJ,20,29,3,10,13
1,8476967,Brett Kulak,D,EDM,29,82,3,10,13
1,8477406,Mattias Janmark,C,EDM,31,71,3,10,13
1,8473544,Derick Brassard,C,OTT,36,31,3,10,13
1,8476917,Adam Pelech,D,NYI,29,58,2,11,13
1,8475825,Jani Hakanpää,D,DAL,31,82,2,11,13
1,8482192,Isaak Phillips,D,CHI,22,56,0,13,13
1,8477353,Tyler Motte,C,TBL,28,72,9,3,12
1,8480192,Johnathan Kovacevic,D,MTL,26,74,8,4,12
1,8479336,Carl Grundstrom,R,LAK,26,50,8,4,12
1,8480072,Lias Andersson,C,LAK,25,30,7,5,12
1,8481517,Brett Leason,R,ANA,24,43,6,6,12
1,8480883,Ty Smith,D,PIT,23,31,5,7,12
1,8474683,Derek Grant,C,ANA,33,28,5,7,12
1,8480748,Kiefer Sherwood,L,NSH,28,41,5,7,12
1,8476410,Josh Leivo,L,STL,30,28,5,7,12
1,8477488,Brett Pesce,D,CAR,29,71,4,8,12
1,8476473,Connor Murphy,D,CHI,30,70,4,8,12
1,8471276,David Krejci,C,BOS,37,27,4,8,12
1,8480891,Michael Kesselring,D,ARI,23,36,4,8,12
1,8481522,Peyton Krebs,C,BUF,22,80,4,8,12
1,8479344,Jesse Puljujarvi,R,PIT,25,36,4,8,12
1,8480073,Erik Brannstrom,D,OTT,24,45,3,9,12
1,8476467,Jamie Oleksiak,D,SEA,31,82,2,10,12
1,8481605,Jackson LaCombe,D,ANA,22,76,2,10,12
1,8476874,Olli Maatta,D,DET,29,46,2,10,12
1,8474567,Zach Bogosian,D,MIN,33,70,2,10,12
1,8478432,Christian Fischer,R,DET,26,51,2,10,12
1,8474013,Ian Cole,D,VAN,34,80,1,11,12
1,8480884,Calen Addison,D,SJS,23,45,1,11,12
1,8480860,Kevin Bahl,D,NJD,23,81,1,11,12
1,8475762,Derek Forbort,D,BOS,31,57,0,12,12
1,8476822,Luke Glendening,C,TBL,34,82,9,2,11
1,8475225,Craig Smith,C,DAL,34,50,7,4,11
1,8475177,Calvin de Haan,D,TBL,32,72,6,5,11
1,8480205,Emil Bemstrom,R,CBJ,24,31,5,6,11
1,8478585,Derek Ryan,C,EDM,37,51,5,6,11
1,8480879,Jacob Bernard-Docker,D,OTT,23,42,4,7,11
1,8476624,Barclay Goodrow,C,NYR,30,80,4,7,11
1,8480001,Urho Vaakanainen,D,ANA,24,74,3,8,11
1,8476988,Matt Benning,D,SJS,29,42,2,9,11
1,8471669,Paul Stastny,C,CAR,38,28,2,9,11
1,8478416,Erik Cernak,D,TBL,26,71,1,10,11
1,8477335,Kyle Burroughs,D,SJS,28,74,1,10,11
1,8475842,Sam Carrick,C,ANA,31,54,7,3,10
1,8480980,Connor Dewar,C,MIN,24,48,7,3,10
1,8478421,A.J. Greer,L,CGY,27,47,6,4,10
1,8480806,Isac Lundestrom,C,ANA,24,46,5,5,10
1,8477941,Nick Ritchie,L,CGY,28,27,5,5,10
1,8473604,Jonathan Toews,C,CHI,35,27,4,6,10
1,8475461,Andrew Agozzino,L,SJS,32,28,4,6,10
1,8476871,Tanner Pearson,L,MTL,31,36,4,6,10
1,8478434,Keegan Kolesar,R,VGK,26,50,4,6,10
1,8474612,Travis Hamonic,D,OTT,33,75,3,7,10
1,8471677,Jack Johnson,D,COL,36,80,3,7,10
1,8479414,Nathan Bastian,R,NJD,26,51,3,7,10
1,8479543,Michael Pezzetta,L,MTL,25,44,3,7,10
1,8480887,Jordan Harris,D,MTL,23,58,2,8,10
1,8479371,Dante Fabbro,D,NSH,25,42,2,8,10
1,8478399,Jonas Siegenthaler,D,NJD,26,66,1,9,10
1,8476429,Scott Mayfield,D,NYI,31,67,1,9,10
1,8480328,David Gust,R,CHI,29,27,7,2,9
1,8479718,Alex Barré-Boulet,C,TBL,26,35,6,3,9
1,8478870,Rudolfs Balcers,L,TBL,26,26,5,4,9
1,8479383,Boris Katchouk,L,CHI,25,35,5,4,9
1,8479328,Julien Gauthier,R,NYI,26,27,5,4,9
1,8479402,Jake Bean,D,CBJ,25,49,4,5,9
1,8478569,Noel Acciari,C,PIT,32,70,4,5,9
1,8476393,Nick Cousins,C,FLA,30,70,4,5,9
1,8481567,Henry Thrun,D,SJS,22,51,3,6,9
1,8480727,Zach Whitecloud,D,VGK,27,65,3,6,9
1,8477846,Ryan Carpenter,C,SJS,32,36,3,6,9
1,8480008,Adam Ruzicka,C,ARI,24,41,3,6,9
1,8478028,Fredrik Olofsson,L,COL,27,53,3,6,9
1,8473563,Nicklas Backstrom,C,WSH,36,37,2,7,9
1,8479315,Joey Anderson,R,CHI,25,28,2,7,9
1,8474162,Jake Muzzin,D,TOR,34,29,1,8,9
1,8479442,Troy Stecher,D,ARI,29,71,1,8,9
1,8481527,Kaedan Korczak,D,VGK,22,26,1,8,9
1,8477018,Ben Hutton,D,VGK,30,31,1,8,9
1,8483460,David Jiricek,D,CBJ,20,36,1,8,9
1,8476372,Nick Seeler,D,PHI,30,55,0,9,9
1,8482081,Sean Farrell,C,MTL,22,27,6,2,8
1,8481754,Nikita Nesterenko,C,ANA,22,28,5,3,8
1,8482712,Oskar Olausson,R,COL,21,28,5,3,8
1,8476856,Matt Dumba,D,ARI,29,78,4,4,8
1,8480252,Cole Guttman,C,CHI,24,27,4,4,8
1,8479322,Wade Allison,R,PHI,26,26,4,4,8
1,8479368,Max Jones,L,ANA,25,38,4,4,8
1,8481477,Nico Sturm,C,SJS,28,34,3,5,8
1,8480058,Pierre-Olivier Joseph,D,PIT,24,53,3,5,8
1,8479514,Rem Pitlick,C,CHI,26,36,3,5,8
1,8477392,Hudson Fasching,R,NYI,28,35,3,5,8
1,8477070,Liam O'Brien,C,ARI,29,49,3,5,8
1,8474009,Nick Bonino,C,NYR,35,73,2,6,8
1,8480995,Pontus Holmberg,R,TOR,24,27,2,6,8
1,8479576,Vincent Desharnais,D,EDM,27,49,1,7,8
1,8477015,Connor Brown,R,EDM,29,75,1,7,8
1,8478495,Denis Gurianov,R,NSH,26,40,1,7,8
1,8477971,Andreas Englund,D,LAK,27,52,1,7,8
1,8477034,Jaycob Megna,D,CHI,31,45,0,8,8
1,8475718,Justin Holl,D,DET,31,63,0,8,8
1,8479439,Jacob MacDonald,D,SJS,30,21,6,1,7
1,8471709,Marc-Edouard Vlasic,D,SJS,36,31,5,2,7
1,8477478,William Carrier,L,VGK,29,33,5,2,7
1,8477573,Nathan Walker,L,STL,29,18,5,2,7
1,8482241,Radim Zohorna,L,PIT,27,31,4,3,7
1,8471303,Alexander Edler,D,LAK,37,30,3,4,7
1,8481058,Jesse Ylönen,R,MTL,24,43,3,4,7
1,8480874,Adam Ginning,D,PHI,23,26,2,5,7
1,8476891,Matt Grzelcyk,D,BOS,29,41,2,5,7
1,8481812,Nikolai Knyzhov,D,SJS,26,38,2,5,7
1,8479458,Nikita Zaitsev,D,CHI,32,26,2,5,7
1,8482730,Brandt Clarke,D,LAK,20,38,2,5,7
1,8477541,Dakota Mermis,D,MIN,29,37,2,5,7
1,8476915,Jujhar Khaira,L,MIN,29,29,2,5,7
1,8478099,Kevin Labanc,R,SJS,28,32,2,5,7
1,8481641,Joel Kiviranta,L,COL,27,40,2,5,7
1,8480880,Jakub Lauko,C,BOS,23,40,2,5,7
1,8470966,Mark Giordano,D,TOR,40,36,1,6,7
1,8477499,Rasmus Ristolainen,D,PHI,29,57,1,6,7
1,8476441,Joel Edmundson,D,WSH,30,66,1,6,7
1,8474207,Nick Holden,D,OTT,36,31,1,6,7
1,8481537,Nikita Okhotiuk,D,SJS,23,38,1,6,7
1,8478502,Dennis Gilbert,D,CGY,27,31,1,6,7
1,8478104,Sammy Blais,L,STL,27,43,1,6,7
1,8480871,Adam Boqvist,D,CBJ,23,22,0,7,7
1,8479520,Brandon Duhaime,R,MIN,26,54,4,2,6
1,8479066,Ryan Lomberg,L,FLA,29,55,4,2,6
1,8470610,Zach Parise,L,COL,39,33,3,3,6
1,8476278,Colin Blackwell,C,CHI,30,25,3,3,6
1,8477454,Adam Erne,L,EDM,28,54,3,3,6
1,8479968,Vinni Lettieri,C,MIN,28,24,3,3,6
1,8477369,Carson Soucy,D,VAN,29,21,2,4,6
1,8482496,Nils Aman,C,VAN,23,31,2,4,6
1,8480789,Oliver Wahlstrom,R,NYI,23,27,2,4,6
1,8480222,Sebastian Aho,D,NYI,27,41,1,5,6
1,8474568,Luke Schenn,D,NSH,34,36,1,5,6
1,8479982,Conor Timmins,D,TOR,25,16,1,5,6
1,8479369,Andrew Peeke,D,CBJ,25,20,0,6,6
1,8480950,Ilya Lyubushkin,D,ANA,29,79,0,6,6
1,8475797,Jarred Tinordi,D,CHI,31,32,0,6,6
1,8479372,Josh Mahura,D,FLA,25,20,0,6,6
1,8479291,Kevin Rooney,C,CGY,30,33,4,1,5
1,8477930,Pierre-Edouard Bellemare,L,SEA,38,29,4,1,5
1,8480184,Gustav Lindström,D,ANA,25,22,3,2,5
1,8470595,Eric Staal,C,FLA,39,27,3,2,5
1,8478408,Travis Dermott,D,ARI,27,37,2,3,5
1,8482964,Arber Xhekaj,D,MTL,22,24,2,3,5
1,8475750,Jon Merrill,D,MIN,31,38,2,3,5
1,8474618,Marco Scandella,D,STL,33,49,2,3,5
1,8478131,Ondrej Kase,R,CAR,28,28,2,3,5
1,8476310,Lukas Sedlak,C,PHI,30,26,2,3,5
1,8480025,MacKenzie Entwistle,R,CHI,24,46,2,3,5
1,8479536,Axel Jonsson-Fjallby,L,WPG,25,26,2,3,5
1,8479348,Kale Clague,D,BUF,25,28,1,4,5
1,8474090,Brendan Smith,D,NJD,34,36,1,4,5
1,8477384,Josh Brown,D,ARI,29,28,1,4,5
1,8480031,Max Comtois,L,ANA,24,28,1,4,5
1,8481708,Zac Jones,D,NYR,23,17,1,4,5
1,8481592,Jakob Pelletier,L,CGY,22,31,1,4,5
1,8480084,Nick DeSimone,D,NJD,29,23,1,4,5
1,8479671,Mathieu Olivier,R,CBJ,26,25,1,4,5
1,8479547,Matthew Phillips,R,PIT,25,27,1,4,5
1,8476919,Chris Tierney,C,NJD,29,28,1,4,5
1,8476952,Dominic Toninato,C,WPG,29,15,1,4,5
1,8482652,Walker Duehr,R,CGY,26,26,1,4,5
1,8480913,Jordan Gross,D,NSH,28,27,0,5,5
1,8477482,Zach Sanford,L,CHI,29,26,0,5,5
1,8476878,Zemgus Girgensons,L,BUF,29,36,4,0,4
1,8479580,Dylan Gambrell,C,OTT,27,31,4,0,4
1,8480901,Karson Kuhlman,C,WPG,28,30,3,1,4
1,8482077,Dylan Holloway,L,EDM,22,23,3,1,4
1,8480011,Klim Kostin,C,DET,24,32,3,1,4
1,8481617,Vasily Podkolzin,R,VAN,22,26,2,2,4
1,8479370,Tyson Jost,C,BUF,25,29,2,2,4
1,8477931,Tomas Nosek,L,NJD,31,40,2,2,4
1,8481019,David Gustafsson,C,WPG,23,27,2,2,4
1,8479981,Jonah Gadjovich,L,FLA,25,27,2,2,4
1,8482516,Matthew Kessel,D,STL,23,47,1,3,4
1,8476449,Scott Harrington,D,ANA,30,28,1,3,4
1,8480041,Dmitri Samorukov,D,STL,24,28,1,3,4
1,8477938,Haydn Fleury,D,TBL,27,16,1,3,4
1,8481167,Brayden Pachal,D,CGY,24,50,1,3,4
1,8480275,Nick Swaney,R,MIN,26,28,1,3,4
1,8480003,Jesper Boqvist,C,BOS,25,20,1,3,4
1,8479994,Jaret Anderson-Dolan,C,LAK,24,24,1,3,4
1,8475752,Tyler Pitlick,C,NYR,32,34,1,3,4
1,8476913,Devin Shore,C,SEA,29,21,1,3,4
1,8475747,Patrik Nemeth,D,ARI,31,29,0,4,4
1,8482176,Wyatt Kaiser,D,CHI,21,23,0,4,4
1,8477359,Tucker Poolman,D,VAN,30,26,0,4,4
1,8478452,Caleb Jones,D,COL,26,20,0,4,4
1,8477851,Jordan Oesterle,D,CGY,31,48,0,4,4
1,8478454,Noah Juulsen,D,VAN,26,38,0,4,4
1,8483641,Anton Levtchi,L,FLA,28,27,0,4,4
1,8478424,Jansen Harkins,C,PIT,26,34,0,4,4
1,8473446,Erik Johnson,D,BUF,35,46,3,0,3
1,8482452,Elliot Desnoyers,L,PHI,21,26,2,1,3
1,8480242,Arnaud Durandeau,L,NYI,24,29,2,1,3
1,8481147,Reese Johnson,C,CHI,25,34,2,1,3
1,8478078,Rourke Chartier,C,OTT,27,34,2,1,3
1,8474709,Matt Martin,L,NYI,34,31,2,1,3
1,8479772,Zack MacEwen,R,OTT,27,22,2,1,3
1,8477962,Brendan Lemieux,L,CAR,27,23,2,1,3
1,8475766,Austin Watson,L,TBL,31,28,2,1,3
1,8480468,James Hamblin,L,EDM,24,31,2,1,3
1,8480355,Mark Kastelic,C,OTT,24,34,2,1,3
1,8481122,Simon Benoit,D,TOR,25,39,1,2,3
1,8478451,Ethan Bear,D,WSH,26,16,1,2,3
1,8471686,Marc Staal,D,PHI,36,20,1,2,3
1,8474218,Jason Demers,D,EDM,35,31,1,2,3
1,8477244,Chad Ruhwedel,D,PIT,33,37,1,2,3
1,8481541,Samuel Bolduc,D,NYI,23,33,1,2,3
1,8476934,Brock McGinn,L,ANA,29,24,1,2,3
1,8476994,Vinnie Hinostroza,C,PIT,29,14,1,2,3
1,8480007,Jonas Rondbjerg,R,VGK,24,17,1,2,3
1,8476867,Brendan Gaunce,C,CBJ,29,8,1,2,3
1,8478904,Steven Lorentz,C,FLA,27,28,1,2,3
1,8479379,Givani Smith,R,SJS,25,26,1,2,3
1,8471873,Anton Stralman,D,BOS,37,27,0,3,3
1,8483424,Owen Beck,C,MTL,19,27,0,3,3
1,8482451,Mikael Pyyhtia,L,CBJ,22,29,0,3,3
1,8478450,Parker Wotherspoon,D,BOS,26,23,0,3,3
1,8482181,Tristen Robins,C,SJS,22,28,0,3,3
1,8480977,Semyon Der-Arguchintsev,C,TOR,23,29,0,3,3
1,8477810,Joel Hanley,D,DAL,32,26,0,3,3
1,8480853,Liam Foudy,C,NSH,23,13,0,3,3
1,8475235,Nicolas Deslauriers,L,PHI,32,47,0,3,3
1,8480776,Sheldon Rempal,R,VGK,28,5,2,0,2
1,8471817,Ryan Reaves,R,TOR,36,27,2,0,2
1,8477073,Kurtis MacDermid,D,COL,29,28,2,0,2
1,8483464,Marco Kasper,C,DET,19,28,1,1,2
1,8480831,Alec Regula,D,CHI,23,27,1,1,2
1,8482133,Thomas Bordeleau,C,SJS,21,6,1,1,2
1,8481006,Tyler Tucker,D,STL,23,16,1,1,2
1,8479362,Riley Tufte,L,COL,25,5,1,1,2
1,8478051,Max Willman,C,NJD,28,13,1,1,2
1,8481532,Alex Turcotte,C,LAK,22,6,1,1,2
1,8480070,Ian Mitchell,D,BOS,24,13,0,2,2
1,8480196,Jacob Bryson,D,BUF,26,8,0,2,2
1,8482207,William Dufour,R,NYI,21,29,0,2,2
1,8480870,Bo Groulx,C,ANA,23,32,0,2,2
1,8473473,Milan Lucic,L,BOS,35,4,0,2,2
1,8477464,Nic Petan,C,MIN,28,6,0,2,2
1,8477527,Ross Johnston,L,ANA,29,41,0,2,2
1,8481043,Cole Koepke,L,TBL,25,8,0,2,2
1,8482448,Samuel Knazko,D,CBJ,21,29,1,0,1
1,8481056,Spencer Stastney,D,NSH,23,9,1,0,1
1,8480823,Alexander Alexeyev,D,WSH,24,13,1,0,1
1,8476873,Mark Jankowski,C,NSH,29,5,1,0,1
1,8480021,Jack Studnicka,C,SJS,24,14,1,0,1
1,8478409,Anthony Richard,C,BOS,27,4,1,0,1
1,8483570,Ben Meyers,C,COL,25,9,1,0,1
1,8481422,Jacob Lucchini,C,MIN,28,13,1,0,1
1,8479546,Oskar Steen,C,BOS,25,34,1,0,1
1,8481239,Samuel Fagemo,L,LAK,23,8,1,0,1
1,8482762,Simon Edvinsson,D,DET,20,2,0,1,1
1,8481161,Jake Christiansen,D,CBJ,24,3,0,1,1
1,8480157,Calle Rosen,D,STL,29,5,0,1,1
1,8479984,Cal Foote,D,NJD,25,4,0,1,1
1,8479321,Lucas Johansen,D,WSH,26,6,0,1,1
1,8479378,Logan Stanley,D,WPG,25,10,0,1,1
1,8478017,Mark Friedman,D,VAN,28,20,0,1,1
1,8482095,Tyler Kleven,D,OTT,21,5,0,1,1
1,8479320,Max Lajoie,D,TOR,26,5,0,1,1
1,8477887,Patrick Brown,C,BOS,31,11,0,1,1
1,8480245,Olle Lycksell,R,PHI,24,5,0,1,1
1,8478146,Matthew Highmore,C,OTT,27,6,0,1,1
1,8480845,Rasmus Kupari,C,WPG,23,21,0,1,1
1,8478512,Austin Czarnik,C,DET,31,18,0,1,1
1,8479367,William Lockwood,R,FLA,25,23,0,1,1
1,8481543,Nikita Alexandrov,C,STL,23,18,0,1,1
1,8483597,Milos Kelemen,L,ARI,24,10,0,1,1
1,8483565,Nick Blankenburg,D,CBJ,25,6,0,0,0
1,8483620,Marcus Bjork,D,CBJ,26,0,0,0,0
1,8481521,Ronnie Attard,D,PHI,24,0,0,0,0
1,8482399,Billy Sweezey,D,CBJ,27,0,0,0,0
1,8481072,Tim Berni,D,CBJ,23,0,0,0,0
1,8476884,Derrick Pouliot,D,SJS,29,0,0,0,0
1,8482624,Daniil Miromanov,D,VGK,26,2,0,0,0
1,8482861,Vincent Iorio,D,WSH,21,0,0,0,0
1,8478465,Guillaume Brisebois,D,VAN,26,0,0,0,0
1,8484256,Jake Livingstone,D,NSH,24,0,0,0,0
1,8481599,Victor Soderstrom,D,ARI,22,1,0,0,0
1,8474027,Justin Braun,D,PHI,36,0,0,0,0
1,8478062,Dysin Mayo,D,ARI,27,0,0,0,0
1,8481563,Drew Helleson,D,ANA,22,0,0,0,0
1,8481575,Lassi Thomson,D,OTT,23,0,0,0,0
1,8483619,Filip Roos,D,CHI,24,4,0,0,0
1,8481461,Corey Schueneman,D,MTL,28,0,0,0,0
1,8478846,Christian Wolanin,D,VAN,28,0,0,0,0
1,8479395,Dennis Cholowski,D,NYI,25,0,0,0,0
1,8479945,Gavin Bayreuther,D,CBJ,29,0,0,0,0
1,8474818,Jordie Benn,D,TOR,36,0,0,0,0
1,8479421,Jacob Moverare,D,LAK,25,5,0,0,0
1,8479329,Frederic Allard,D,MTL,26,0,0,0,0
1,8481600,Tobias Bjornfot,D,VGK,22,3,0,0,0
1,8477462,Robert Hagg,D,ANA,28,5,0,0,0
1,8476470,Nathan Beaulieu,D,ANA,31,0,0,0,0
1,8484254,Akito Hirose,D,VAN,24,3,0,0,0
1,8479388,Riley Stillman,D,BUF,25,0,0,0,0
1,8482824,Nick Cicek,D,SJS,23,0,0,0,0
1,8480056,Jack Rathbone,D,VAN,24,0,0,0,0
1,8476850,Ryan Murray,D,EDM,30,0,0,0,0
1,8478841,Colton White,D,ANA,26,0,0,0,0
1,8480160,Radim Simek,D,SJS,31,0,0,0,0
1,8478491,Jacob Larsson,D,OTT,26,0,0,0,0
1,8475857,Kevin Gravel,D,NSH,31,0,0,0,0
1,8482067,Connor Mackey,D,NYR,27,1,0,0,0
1,8477433,Ben Harpur,D,NYR,28,0,0,0,0
1,8481572,Ville Heinola,D,WPG,22,0,0,0,0
1,8478415,Jakub Zboril,D,BOS,26,0,0,0,0
1,8477341,Andreas Johnsson,L,SJS,29,0,0,0,0
1,8480216,Jacob Peterson,C,SJS,24,6,0,0,0
1,8477467,Gustav Olofsson,D,SEA,29,0,0,0,0
1,8478476,Kyle Capobianco,D,WPG,26,0,0,0,0
1,8479985,Cale Fleury,D,SEA,25,0,0,0,0
1,8475227,Chris Wideman,D,MTL,33,0,0,0,0
1,8479333,Libor Hajek,D,NYR,25,0,0,0,0
1,8479376,Victor Mete,D,PHI,25,1,0,0,0
1,8480439,Mac Hollowell,D,TOR,25,0,0,0,0
1,8480467,Austin Strand,D,ANA,26,0,0,0,0
1,8477981,Roland McKeown,D,NSH,27,0,0,0,0
1,8474628,Michael Stone,D,CGY,33,0,0,0,0
1,8480034,Joel Teasdale,L,MTL,24,0,0,0,0
1,8481609,Vladislav Kolyachonok,D,ARI,22,1,0,0,0
1,8479602,Jeremy Davies,D,BUF,27,0,0,0,0
1,8479639,Dylan Coghlan,D,CAR,25,0,0,0,0
1,8478506,Gabriel Carlsson,D,WSH,26,0,0,0,0
1,8477463,Steven Santini,D,STL,28,0,0,0,0
1,8478075,Anders Bjork,L,CHI,27,0,0,0,0
1,8484287,Cole McWard,D,VAN,22,1,0,0,0
1,8474145,Robert Bortuzzo,D,NYI,34,15,0,0,0
1,8475625,Matt Irwin,D,WSH,36,0,0,0,0
1,8482179,Justin Richards,C,CBJ,25,0,0,0,0
1,8481649,Joona Luoto,L,CBJ,26,0,0,0,0
1,8479026,Philippe Myers,D,TBL,26,5,0,0,0
1,8480935,Lawrence Pilut,D,BUF,28,0,0,0,0
1,8479578,Casey Fitzgerald,D,FLA,26,0,0,0,0
1,8480071,Robin Salo,D,NYI,25,0,0,0,0
1,8478224,Luke Philp,C,CHI,28,0,0,0,0
1,8484125,Hunter McKown,C,CBJ,21,0,0,0,0
1,8481679,Maxence Guenette,D,OTT,22,1,0,0,0
1,8479423,Alex Nylander,L,PIT,25,5,0,0,0
1,8480441,Trey Fix-Wolansky,R,CBJ,24,1,0,0,0
1,8480820,Filip Kral,D,TOR,24,0,0,0,0
1,8479523,Lucas Carlsson,D,FLA,26,0,0,0,0
1,8479304,Kyle Criscuolo,C,SJS,31,0,0,0,0
1,8474697,Mark Borowiecki,D,NSH,34,0,0,0,0
1,8475780,Chris Wagner,R,BOS,32,27,0,0,0
1,8480842,Filip Hallander,C,PIT,23,0,0,0,0
1,8481725,Elmer Soderblom,L,DET,22,0,0,0,0
1,8479252,Dan Renouf,D,BOS,29,0,0,0,0
1,8481591,Sam Poulin,R,PIT,22,0,0,0,0
1,8475968,Alex Belzile,R,MTL,32,0,0,0,0
1,8475772,Riley Sheahan,C,BUF,32,0,0,0,0
1,8475163,Alex Chiasson,R,DET,33,0,0,0,0
1,8481598,Philip Broberg,D,EDM,22,10,0,0,0
1,8478455,Austin Wagner,L,CHI,26,0,0,0,0
1,8476779,Brad Hunt,D,COL,35,0,0,0,0
1,8479335,Rasmus Asplund,C,NSH,26,0,0,0,0
1,8478967,Lane Pederson,C,CBJ,26,0,0,0,0
1,8481077,John Leonard,L,NSH,25,0,0,0,0
1,8481585,Egor Afanasyev,L,NSH,22,2,0,0,0
1,8483397,Marc McLaughlin,C,BOS,24,0,0,0,0
1,8480443,Kristian Reichel,C,WPG,25,0,0,0,0
1,8481751,Lukas Rousek,R,BUF,24,5,0,0,0
1,8476396,Steven Fogarty,C,MIN,30,0,0,0,0
1,8478881,Brett Seney,L,CHI,27,4,0,0,0
1,8480326,Sheldon Dries,C,VAN,29,0,0,0,0
1,8481433,Taro Hirose,L,DET,27,0,0,0,0
1,8480833,Vitali Kravtsov,R,VAN,24,0,0,0,0
1,8481550,Adam Beckman,L,MIN,22,0,0,0,0
1,8479972,Mason Shaw,C,MIN,25,0,0,0,0
1,8477460,Laurent Dauphin,C,ARI,28,0,0,0,0
1,8476166,Taylor Fedun,D,PIT,35,0,0,0,0
1,8478067,Oskar Lindblom,L,SJS,27,1,0,0,0
1,8479944,Zach Aston-Reese,C,DET,29,1,0,0,0
1,8479465,Drake Caggiula,L,PIT,29,0,0,0,0
1,8481740,Tyce Thompson,R,NJD,24,0,0,0,0
1,8476948,Charles Hudon,L,COL,29,0,0,0,0
1,8480863,Gabriel Fortier,L,TBL,23,0,0,0,0
1,8471887,Patric Hornqvist,R,FLA,36,0,0,0,0
1,8477471,Dillon Heatherington,D,OTT,28,0,0,0,0
1,8481441,Joe Snively,C,WSH,27,3,0,0,0
1,8478173,Hayden Hodgson,R,PHI,27,0,0,0,0
1,8481720,Nick Abruzzese,C,TOR,24,0,0,0,0
1,8478843,Denis Malgin,C,COL,26,0,0,0,0
1,8483630,Pavol Regenda,L,ANA,24,0,0,0,0
1,8478373,Nikita Soshnikov,R,NYI,30,0,0,0,0
1,8482147,Jean-Luc Foudy,C,COL,21,0,0,0,0
1,8478431,Evgeny Svechnikov,L,SJS,27,0,0,0,0
1,8477210,Buddy Robinson,R,CHI,32,0,0,0,0
1,8479404,Henrik Borgstrom,C,WSH,26,0,0,0,0
1,8481712,Matej Blumel,R,DAL,23,0,0,0,0
1,8475278,Byron Froese,C,VGK,32,7,0,0,0
1,8479338,Markus Niemelainen,D,EDM,25,0,0,0,0
1,8471794,Darren Helm,C,COL,36,0,0,0,0
1,8482623,Josh Dunne,C,CBJ,25,0,0,0,0
1,8482641,Matt Kiersted,D,FLA,25,0,0,0,0
1,8476851,Alex Galchenyuk,C,COL,29,0,0,0,0
1,8479366,Logan Brown,C,STL,25,0,0,0,0
1,8480822,Martin Kaut,R,SJS,24,0,0,0,0
1,8482834,Jesper Froden,R,SEA,29,0,0,0,0
1,8480844,Grigori Denisenko,L,VGK,23,3,0,0,0
1,8482635,Mike Hardman,L,CHI,24,0,0,0,0
1,8477357,Saku Maenalanen,R,WPG,29,0,0,0,0
1,8480979,Nathan Smith,C,ARI,25,0,0,0,0
1,8479356,Kieffer Bellows,L,PHI,25,0,0,0,0
1,8475795,Dylan McIlrath,D,WSH,31,1,0,0,0
1,8478400,Colin White,C,PIT,26,9,0,0,0
1,8478446,Glenn Gawdin,C,ANA,26,0,0,0,0
1,8476326,Josh Archibald,R,PIT,31,0,0,0,0
1,8481683,Aidan McDonough,L,VAN,24,0,0,0,0
1,8480267,Sammy Walker,C,MIN,24,4,0,0,0
1,8477520,Jean-Sebastien Dea,C,ARI,29,0,0,0,0
1,8476439,Brett Ritchie,R,ARI,30,0,0,0,0
1,8479518,Fredrik Karlström,C,DAL,25,0,0,0,0
1,8477126,Jayson Megna,C,ANA,33,0,0,0,0
1,8479644,Matt Luff,R,DET,26,0,0,0,0
1,8478211,Dryden Hunt,L,CGY,28,5,0,0,0
1,8480226,Marián Studenic,R,SEA,25,2,0,0,0
1,8480037,Aleksi Heponiemi,C,FLA,24,0,0,0,0
1,8480292,Carson Meyer,R,CBJ,26,0,0,0,0
1,8482634,Alex Steeves,C,TOR,24,1,0,0,0
1,8475178,Zack Kassian,R,ARI,32,0,0,0,0
1,8483524,Shane Wright,C,SEA,19,3,0,0,0
1,8482654,Jackson Cates,C,PHI,26,0,0,0,0
1,8479550,Tanner Laczynski,C,PHI,26,0,0,0,0
1,8479991,Jake Leschyshyn,C,NYR,24,1,0,0,0
1,8474613,Derek Stepan,C,CAR,33,0,0,0,0
1,8478367,Cole Bardreau,C,NYI,30,0,0,0,0
1,8480890,Jan Jenik,R,ARI,23,1,0,0,0
1,8475160,Kyle Clifford,L,TOR,32,0,0,0,0
1,8479705,Jeffrey Viel,L,SJS,26,0,0,0,0
1,8477401,John Hayden,C,SEA,28,2,0,0,0
1,8480846,Sampo Ranta,L,COL,23,0,0,0,0
1,8482691,Aatu Raty,C,VAN,21,0,0,0,0
1,8481070,Hugh McGing,L,STL,25,5,0,0,0
1,8479573,Mikhail Maltsev,L,COL,25,0,0,0,0
1,8482250,Callahan Burke,C,CAR,26,1,0,0,0
1,8481102,Egor Sokolov,L,OTT,23,0,0,0,0
1,8481518,Nolan Foote,L,NJD,23,0,0,0,0
1,8474190,Wayne Simmonds,R,TOR,35,0,0,0,0
1,8474610,Zac Dalpe,C,FLA,34,0,0,0,0
1,8479347,Tyler Benson,L,EDM,25,0,0,0,0
1,8476404,Andy Andreoff,C,NYI,32,0,0,0,0
1,8476390,Joseph Cramarossa,C,MIN,31,0,0,0,0
1,8483549,Lucas Condotta,L,MTL,26,3,0,0,0
1,8482197,Adam Raska,R,MIN,22,5,0,0,0
1,8479533,Joona Koppanen,L,PIT,25,3,0,0,0
1,8479526,Otto Koivula,L,NYI,25,0,0,0,0
1,8479375,William Bitten,C,STL,25,0,0,0,0
1,8474089,Brad Malone,C,EDM,34,0,0,0,0
1,8478058,CJ Suess,L,SJS,29,0,0,0,0
1,8478147,Bokondji Imama,L,ARI,27,0,0,0,0
1,8477320,Anton Blidh,L,NYR,28,1,0,0,0
1,8477993,Justin Kirkland,C,ARI,27,2,0,0,0
1,8480836,Jonathan Gruden,C,PIT,23,5,0,0,0
1,8480032,Shane Bowers,C,NJD,24,3,0,0,0
2,8478402,Connor McDavid,C,EDM,26,80,31,109,140
2,8476453,Nikita Kucherov,R,TBL,30,81,51,87,138
2,8477492,Nathan MacKinnon,C,COL,28,82,44,79,123
2,8477934,Leon Draisaitl,C,EDM,28,82,44,66,110
2,8477956,David Pastrnak,R,BOS,27,82,48,58,106
2,8476468,J.T. Miller,C,VAN,30,81,38,67,105
2,8479318,Auston Matthews,C,TOR,26,81,68,34,102
2,8477933,Sam Reinhart,C,FLA,28,82,61,41,102
2,8480800,Quinn Hughes,D,VAN,24,81,19,81,100
2,8477939,William Nylander,R,TOR,27,82,35,64,99
2,8480012,Elias Pettersson,C,VAN,25,81,42,56,98
2,8478550,Artemi Panarin,L,NYR,32,82,40,58,98
2,8479314,Matthew Tkachuk,L,FLA,26,82,27,69,96
2,8478420,Mikko Rantanen,R,COL,27,82,38,56,94
2,8475786,Zach Hyman,L,EDM,31,81,58,30,88
2,8474564,Steven Stamkos,C,TBL,33,79,42,46,88
2,8480023,Robert Thomas,C,STL,24,82,27,61,88
2,8471675,Sidney Crosby,C,PIT,36,82,42,45,87
2,8478864,Kirill Kaprizov,L,MIN,26,75,36,51,87
2,8478427,Sebastian Aho,C,CAR,26,78,31,55,86
2,8475913,Mark Stone,R,VGK,31,81,28,58,86
2,8478483,Mitchell Marner,R,TOR,26,81,34,51,85
2,8476454,Ryan Nugent-Hopkins,C,EDM,30,82,29,56,85
2,8475168,Matt Duchene,C,DAL,32,81,35,48,83
2,8480027,Jason Robertson,L,DAL,24,82,30,53,83
2,8478010,Brayden Point,C,TBL,27,82,41,41,82
2,8480069,Cale Makar,D,COL,25,77,19,63,82
2,8479323,Adam Fox,D,NYR,25,72,16,66,82
2,8475167,Victor Hedman,D,TBL,33,80,14,68,82
2,8482116,Tim Stützle,C,OTT,21,82,22,59,81
2,8478444,Brock Boeser,R,VAN,26,81,42,37,79
2,8478439,Travis Konecny,R,PHI,26,81,35,44,79
2,8481559,Jack Hughes,C,NJD,22,65,26,53,79
2,8477404,Jake Guentzel,L,PIT,29,81,35,43,78
2,8473419,Brad Marchand,L,BOS,35,82,35,43,78
2,8478445,Mathew Barzal,C,NYI,26,81,23,55,78
2,8476459,Mika Zibanejad,C,NYR,30,81,27,50,77
2,8480803,Evan Bouchard,D,EDM,24,82,17,60,77
2,8480865,Noah Dobson,D,NYI,23,82,11,66,77
2,8477409,Carter Verhaeghe,C,FLA,28,82,38,38,76
2,8479407,Jesper Bratt,L,NJD,25,81,27,49,76
2,8478403,Jack Eichel,C,VGK,27,70,29,46,75
2,8480018,Nick Suzuki,C,MTL,24,82,24,50,74
2,8476389,Vincent Trocheck,C,NYR,30,82,27,46,73
2,8474600,Roman Josi,D,NSH,33,82,20,53,73
2,8477493,Aleksander Barkov,C,FLA,28,76,17,56,73
2,8480801,Brady Tkachuk,L,OTT,24,82,39,33,72
2,8478449,Roope Hintz,C,DAL,27,80,37,35,72
2,8475184,Chris Kreider,L,NYR,32,82,36,36,72
2,8479337,Alex DeBrincat,R,DET,26,82,32,40,72
2,8476887,Filip Forsberg,L,NSH,29,82,34,37,71
2,8475794,Tyler Seguin,C,DAL,31,82,31,39,70
2,8473512,Claude Giroux,R,OTT,35,82,24,46,70
2,8477946,Dylan Larkin,C,DET,27,76,35,34,69
2,8479542,Brandon Hagel,L,TBL,25,82,28,40,68
2,8480797,Joel Farabee,L,PHI,23,81,27,41,68
2,8471215,Evgeni Malkin,C,PIT,37,82,24,44,68
2,8477942,Kevin Fiala,L,LAK,27,82,17,51,68
2,8477500,Bo Horvat,C,NYI,28,81,31,36,67
2,8470794,Joe Pavelski,C,DAL,39,82,28,39,67
2,8471685,Anze Kopitar,C,LAK,36,82,24,43,67
2,8482078,Lucas Raymond,L,DET,21,82,24,43,67
2,8475692,Mats Zuccarello,R,MIN,36,73,14,53,67
2,8476539,Jonathan Marchessault,R,VGK,33,81,39,27,66
2,8479343,Clayton Keller,R,ARI,25,82,29,37,66
2,8474679,Gustav Nyquist,C,NSH,34,82,20,46,66
2,8478493,Joel Eriksson Ek,C,MIN,26,82,41,24,65
2,8478398,Kyle Connor,L,WPG,27,65,38,27,65
2,8478366,Frank Vatrano,R,ANA,29,82,35,30,65
2,8477960,Adrian Kempe,R,LAK,27,82,28,37,65
2,8477402,Pavel Buchnevich,L,STL,28,80,26,39,65
2,8475166,John Tavares,C,TOR,33,80,24,41,65
2,8477501,Valeri Nichushkin,R,COL,28,67,34,30,64
2,8475745,Charlie Coyle,C,BOS,31,82,26,38,64
2,8482124,Quinton Byfield,R,LAK,21,80,24,40,64
2,8476460,Mark Scheifele,C,WPG,30,75,22,42,64
2,8475754,Brock Nelson,C,NYI,32,82,31,32,63
2,8479385,Jordan Kyrou,C,STL,25,82,26,37,63
2,8482093,Seth Jarvis,C,CAR,21,81,23,40,63
2,8471214,Alex Ovechkin,L,WSH,38,79,27,35,62
2,8478975,Mason Marchment,L,DAL,28,81,23,39,62
2,8476853,Morgan Rielly,D,TOR,29,79,8,54,62
2,8478440,Dylan Strome,C,WSH,26,82,31,30,61
2,8480208,Drake Batherson,R,OTT,25,82,27,34,61
2,8475158,Ryan O'Reilly,C,NSH,32,82,26,35,61
2,8480839,Rasmus Dahlin,D,BUF,23,81,22,39,61
2,8477955,Jared McCann,L,SEA,27,81,35,25,60
2,8477416,Oliver Bjorkstrand,R,SEA,28,82,19,41,60
2,8481540,Cole Caufield,R,MTL,22,82,27,32,59
2,8478407,Vince Dunn,D,SEA,27,78,12,47,59
2,8471724,Kris Letang,D,PIT,36,82,8,51,59
2,8479999,Casey Mittelstadt,C,BUF,25,82,17,41,58
2,8480039,Martin Necas,C,CAR,24,76,24,33,57
2,8477497,Sean Monahan,C,WPG,29,83,19,38,57
2,8479425,Filip Hronek,D,VAN,26,81,5,52,57
2,8475784,Jeff Skinner,L,BUF,31,74,27,29,56
2,8476448,William Karlsson,C,VGK,30,69,26,30,56
2,8480002,Nico Hischier,C,NJD,24,70,25,31,56
2,8481557,Matt Boldy,L,MIN,22,75,25,31,56
2,8476881,Tomas Hertl,C,SJS,30,76,24,32,56
2,8475765,Vladimir Tarasenko,R,OTT,32,80,23,33,56
2,8477496,Elias Lindholm,C,VAN,29,81,22,34,56
2,8476346,Johnny Gaudreau,L,CBJ,30,81,15,41,56
2,8479325,Charlie McAvoy,D,BOS,26,74,13,43,56
2,8474578,Erik Karlsson,D,PIT,33,82,10,46,56
2,8477940,Nikolaj Ehlers,L,WPG,27,81,24,31,55
2,8474037,James van Riemsdyk,L,BOS,34,78,17,38,55
2,8479345,Jakob Chychrun,D,OTT,25,82,17,38,55
2,8475798,Mikael Granlund,C,SJS,31,68,12,43,55
2,8477504,Josh Morrissey,D,WPG,28,81,8,47,55
2,8476882,Teuvo Teravainen,L,CAR,29,81,26,28,54
2,8478873,Troy Terry,R,ANA,26,79,21,33,54
2,8480830,Andrei Svechnikov,R,CAR,23,60,17,37,54
2,8475170,Brayden Schenn,C,STL,32,82,22,31,53
2,8476905,Chandler Stephenson,C,VGK,29,77,21,32,53
2,8477494,Jonathan Drouin,L,COL,28,80,18,35,53
2,8480798,Philipp Kurashev,C,CHI,24,75,14,39,53
2,8477511,Anthony Mantha,R,WSH,29,78,32,20,52
2,8475169,Evander Kane,L,EDM,32,81,31,21,52
2,8479675,Trevor Moore,L,LAK,28,82,29,23,52
2,8476399,Blake Coleman,C,CGY,32,82,25,27,52
2,8482740,Wyatt Johnston,C,DAL,20,82,22,30,52
2,8475172,Nazem Kadri,C,CGY,33,82,20,32,52
2,8476479,Phillip Danault,C,LAK,30,82,17,35,52
2,8475810,Bryan Rust,R,PIT,31,69,28,23,51
2,8481068,Yegor Sharangovich,C,CGY,25,82,29,21,50
2,8480015,Owen Tippett,R,PHI,24,77,28,22,50
2,8482175,JJ Peterka,R,BUF,21,82,23,27,50
2,8482109,Alexis Lafrenière,L,NYR,22,82,23,27,50
2,8477949,Alex Tuch,R,BUF,27,75,20,30,50
2,8476456,Jonathan Huberdeau,C,CGY,30,81,13,37,50
2,8476875,Mike Matheson,D,MTL,29,82,8,42,50
2,8479420,Tage Thompson,C,BUF,26,72,26,23,49
2,8478401,Pavel Zacha,C,BOS,26,78,18,30,48
2,8481528,Dylan Cozens,C,BUF,22,79,18,30,48
2,8482667,William Eklund,L,SJS,21,80,18,30,48
2,8476906,Shayne Gostisbehere,D,DET,30,81,11,37,48
2,8475726,Tyler Toffoli,R,NJD,31,80,32,15,47
2,8479365,Trent Frederic,C,BOS,25,82,23,24,47
2,8477346,MacKenzie Weegar,D,CGY,29,82,21,26,47
2,8474641,Adam Henrique,C,ANA,33,81,20,27,47
2,8482149,Cole Perfetti,C,WPG,21,81,20,27,47
2,8482665,Matty Beniers,C,SEA,21,77,13,34,47
2,8478542,Evan Rodrigues,C,FLA,30,82,11,36,47
2,8475764,Cam Fowler,D,ANA,32,82,10,37,47
2,8474590,John Carlson,D,WSH,33,82,4,43,47
2,8475287,Erik Haula,L,NJD,32,75,21,25,46
2,8482079,Marco Rossi,C,MIN,22,82,21,25,46
2,8478047,Michael Bunting,L,CAR,28,80,18,28,46
2,8477964,Ivan Barbashev,C,VGK,28,81,18,28,46
2,8478038,Devon Toews,D,COL,29,82,13,33,46
2,8480036,Miro Heiskanen,D,DAL,24,72,8,38,46
2,8482745,Mason McTavish,C,ANA,20,74,22,23,45
2,8480009,Eeli Tolvanen,R,SEA,24,82,21,24,45
2,8478519,Anthony Cirelli,C,TBL,26,81,18,27,45
2,8474563,Drew Doughty,D,LAK,34,82,16,29,45
2,8477021,Alex Kerfoot,C,ARI,29,82,13,32,45
2,8476432,Boone Jenner,C,CBJ,30,66,31,13,44
2,8477951,Nick Schmaltz,C,ARI,27,79,22,22,44
2,8475151,Kyle Palmieri,C,NYI,32,82,20,24,44
2,8477456,J.T. Compher,L,DET,28,77,17,27,44
2,8475171,Oliver Ekman-Larsson,D,FLA,32,82,14,30,44
2,8481711,Matias Maccelli,L,ARI,23,82,12,32,44
2,8470613,Brent Burns,D,CAR,38,81,11,33,44
2,8477447,Shea Theodore,D,VGK,28,48,10,34,44
2,8480434,Sean Durzi,D,ARI,25,76,9,35,44
2,8477450,Jason Dickinson,C,CHI,28,82,29,14,43
2,8475799,Nino Niederreiter,R,WPG,31,81,25,18,43
2,8480893,Kirill Marchenko,R,CBJ,23,79,24,19,43
2,8482475,Yegor Chinakhov,R,CBJ,22,69,21,22,43
2,8474586,Jordan Eberle,R,SEA,33,78,18,25,43
2,8481581,Thomas Harley,D,DAL,22,79,18,25,43
2,8479525,Ross Colton,C,COL,27,80,16,27,43
2,8476458,Ryan Strome,C,ANA,30,79,14,29,43
2,8476979,Erik Gustafsson,D,NYR,31,81,8,35,43
2,8478460,Zach Werenski,D,CBJ,26,69,3,40,43
2,8477451,Ryan Hartman,R,MIN,29,77,21,21,42
2,8474102,David Perron,L,DET,35,76,18,24,42
2,8474150,Mikael Backlund,C,CGY,34,82,17,25,42
2,8473994,Jamie Benn,L,DAL,34,82,15,27,42
2,8477998,Warren Foegele,L,EDM,27,82,15,27,42
2,8476869,Brady Skjei,D,CAR,29,81,13,29,42
2,8480028,Morgan Frost,C,PHI,24,70,13,29,42
2,8478233,Andrew Mangiapane,L,CGY,27,81,12,30,42
2,8476462,Dougie Hamilton,D,NJD,30,48,10,32,42
2,8478474,Lawson Crouse,L,ARI,26,81,28,13,41
2,8479400,Pierre-Luc Dubois,C,LAK,25,82,17,24,41
2,8477505,Alex Wennberg,C,SEA,29,82,16,25,41
2,8476392,Adam Lowry,C,WPG,30,81,15,26,41
2,8478462,Nicolas Roy,C,VGK,26,72,14,27,41
2,8474141,Patrick Kane,R,DET,35,51,13,28,41
2,8481542,Moritz Seider,D,DET,22,82,9,32,41
2,8476480,Vladislav Namestnikov,C,WPG,31,78,9,32,41
2,8482122,Brock Faber,D,MIN,21,82,4,37,41
2,8474565,Alex Pietrangelo,D,VGK,33,76,3,38,41
2,8477935,Sam Bennett,C,FLA,27,70,21,19,40
2,8482110,Dawson Mercer,C,NJD,22,81,21,19,40
2,8478856,Conor Garland,R,VAN,27,81,16,24,40
2,8479410,Mikhail Sergachev,D,TBL,25,60,3,37,40
2,8476792,Torey Krug,D,STL,32,82,2,38,40
2,8482089,Jake Neighbours,L,STL,21,82,30,9,39
2,8482125,Alexander Holtz,R,NJD,21,81,20,19,39
2,8478414,Timo Meier,R,NJD,27,68,18,21,39
2,8478396,Noah Hanifin,D,CGY,26,82,13,26,39
2,8482684,Luke Hughes,D,NJD,20,81,13,26,39
2,8476483,Rickard Rakell,R,PIT,30,70,10,29,39
2,8478397,Rasmus Andersson,D,CGY,27,78,9,30,39
2,8477952,Robby Fabbri,C,DET,27,68,22,16,38
2,8480064,Josh Norris,C,OTT,24,75,18,20,38
2,8481624,Ilya Mikheyev,R,VAN,29,77,16,22,38
2,8473533,Jordan Staal,C,CAR,35,81,16,22,38
2,8477426,Nicholas Paul,L,TBL,28,82,15,23,38
2,8483515,Juraj Slafkovsky,L,MTL,19,82,14,24,38
2,8478055,Gustav Forsling,D,FLA,27,81,13,25,38
2,8478891,Mason Appleton,C,WPG,27,81,13,25,38
2,8475744,Evgeny Kuznetsov,C,WSH,31,72,10,28,38
2,8477948,Travis Sanheim,D,PHI,27,80,5,33,38
2,8475191,Reilly Smith,R,PIT,32,76,18,19,37
2,8479339,Patrik Laine,L,CBJ,25,47,18,19,37
2,8477429,Andrew Copp,C,DET,29,81,16,21,37
2,8475768,Jaden Schwartz,C,SEA,31,66,16,21,37
2,8476872,Scott Laughton,C,PHI,29,81,12,25,37
2,8478500,Ivan Provorov,D,CBJ,26,81,7,30,37
2,8476925,Colton Sissons,C,NSH,30,82,19,17,36
2,8476921,Jordan Martinook,L,CAR,31,81,18,18,36
2,8478498,Jake DeBrusk,L,BOS,27,80,17,19,36
2,8482092,Ridly Greig,C,OTT,21,72,17,19,36
2,8482146,Luke Evangelista,R,NSH,21,80,14,22,36
2,8478472,Mathieu Joseph,R,OTT,26,72,13,23,36
2,8475760,Nick Bjugstad,C,ARI,31,82,12,24,36
2,8475149,Marcus Johansson,L,MIN,33,82,12,24,36
2,8478469,Thomas Chabot,D,OTT,26,60,9,27,36
2,8477503,Max Domi,C,TOR,28,82,8,28,36
2,8481186,Logan O'Connor,R,COL,27,78,17,18,35
2,8470621,Corey Perry,R,EDM,38,54,16,19,35
2,8478438,Tommy Novak,C,NSH,26,71,15,20,35
2,8471218,Blake Wheeler,R,NYR,37,82,13,22,35
2,8477479,Tyler Bertuzzi,L,TOR,28,81,11,24,35
2,8476958,Jaccob Slavin,D,CAR,29,81,8,27,35
2,8482671,Owen Power,D,BUF,21,79,6,29,35
2,8477495,Seth Jones,D,CHI,29,67,3,32,35
2,8479619,Michael Carcone,L,ARI,27,76,24,10,34
2,8478013,Jake Walman,D,DET,27,76,18,16,34
2,8473422,Nick Foligno,L,CHI,36,75,17,17,34
2,8478057,Dakota Joshua,C,VAN,27,79,16,18,34
2,8476826,Yanni Gourde,C,SEA,32,80,15,19,34
2,8475722,Jason Zucker,L,ARI,31,72,14,20,34
2,8479987,Morgan Geekie,C,BOS,25,76,14,20,34
2,8478466,Daniel Sprong,R,DET,26,54,14,20,34
2,8482113,Anton Lundell,C,FLA,22,78,13,21,34
2,8476292,Ondrej Palat,L,NJD,32,71,13,21,34
2,8478458,Jack Roslovic,C,CBJ,26,58,11,23,34
2,8475218,Mattias Ekholm,D,EDM,33,81,10,24,34
2,8480145,Neal Pionk,D,WPG,28,81,9,25,34
2,8480188,Fabian Zetterlund,L,SJS,24,81,22,11,33
2,8483808,Andrei Kuzmenko,L,CGY,27,76,17,16,33
2,8478043,Sam Lafferty,C,VAN,28,79,17,16,33
2,8474149,Evgenii Dadonov,R,DAL,34,77,16,17,33
2,8476419,Jean-Gabriel Pageau,C,NYI,31,82,11,22,33
2,8480014,Gabriel Vilardi,C,WPG,24,61,17,15,32
2,8482159,Tyson Foerster,R,PHI,21,78,16,16,32
2,8479992,Michael Rasmussen,C,DET,24,82,15,17,32
2,8476892,Colton Parayko,D,STL,30,82,14,18,32
2,8477476,Artturi Lehkonen,L,COL,28,47,12,20,32
2,8475763,Kevin Hayes,R,STL,31,82,10,22,32
2,8476885,Jacob Trouba,D,NYR,29,80,7,25,32
2,8475314,Anders Lee,L,NYI,33,82,21,10,31
2,8479941,Justin Danforth,R,CBJ,30,81,15,16,31
2,8474884,Mike Hoffman,C,SJS,34,79,13,18,31
2,8481582,Nicholas Robertson,L,TOR,22,64,13,18,31
2,8476897,Oskar Sundqvist,C,STL,29,82,10,21,31
2,8473986,Alex Killorn,L,ANA,34,63,9,22,31
2,8476312,Josh Manson,D,COL,32,77,9,22,31
2,8482105,Jake Sanderson,D,OTT,21,79,8,23,31
2,8476902,Esa Lindell,D,DAL,29,82,5,26,31
2,8477969,Marcus Pettersson,D,PIT,27,82,3,28,31
2,8479415,Michael McLeod,C,NJD,25,73,16,14,30
2,8481604,Pavel Dorofeyev,L,VGK,23,57,16,14,30
2,8474189,Lars Eller,C,PIT,34,82,16,14,30
2,8475343,Nic Dowd,C,WSH,33,73,15,15,30
2,8481533,Trevor Zegras,C,ANA,22,48,13,17,30
2,8480813,Joe Veleno,C,DET,23,80,12,18,30
2,8482705,Cole Sillinger,C,CBJ,20,76,12,18,30
2,8475193,Tomas Tatar,L,SEA,33,78,11,19,30
2,8474602,Justin Schultz,D,SEA,33,72,11,19,30
2,8476927,Teddy Blueger,C,VAN,29,67,6,24,30
2,8475181,Nick Leddy,D,STL,32,82,4,26,30
2,8476854,Hampus Lindholm,D,BOS,29,82,1,29,30
2,8476880,Tom Wilson,R,WSH,29,81,15,14,29
2,8480802,Ryan McLeod,C,EDM,24,81,14,15,29
2,8477407,Anthony Duclair,L,SJS,28,76,13,16,29
2,8481524,Bowen  Byram,D,COL,22,74,12,17,29
2,8481577,Philip Tomasino,C,NSH,22,68,11,18,29
2,8480113,Alex Iafallo,L,WPG,30,81,11,18,29
2,8475188,Brayden McNabb,D,VGK,32,81,5,24,29
2,8482655,J.J. Moser,D,ARI,23,80,4,25,29
2,8479983,Mario Ferraro,D,SJS,25,77,1,28,29
2,8476918,Jimmy Vesey,L,NYR,30,80,20,8,28
2,8476438,Brandon Saad,L,STL,31,82,16,12,28
2,8471698,T.J. Oshie,R,WSH,37,65,16,12,28
2,8477425,Miles Wood,L,COL,28,77,15,13,28
2,8475714,Calle Jarnkrok,C,TOR,32,75,14,14,28
2,8475793,Ryan Johansen,C,COL,31,82,14,14,28
2,8481580,Connor McMichael,C,WSH,22,80,12,16,28
2,8476474,Stefan Noesen,R,CAR,30,52,11,17,28
2,8480817,K'Andre Miller,D,NYR,23,80,11,17,28
2,8477498,Darnell Nurse,D,EDM,28,82,8,20,28
2,8480336,Sean Walker,D,PHI,29,81,6,22,28
2,8475753,Justin Faulk,D,STL,31,68,5,23,28
2,8480873,Rasmus Sandin,D,WSH,23,74,5,23,28
2,8479398,Samuel Girard,D,COL,25,61,5,23,28
2,8475200,Dmitry Orlov,D,CAR,32,81,5,23,28
2,8474574,Tyler Myers,D,VAN,33,81,4,24,28
2,8474870,Tyler Johnson,C,CHI,33,67,17,10,27
2,8480459,Pius Suter,C,VAN,27,67,16,11,27
2,8475220,Marcus Foligno,L,MIN,32,75,13,14,27
2,8481560,Arthur Kaliyev,R,LAK,22,68,12,15,27
2,8474157,Max Pacioretty,L,WSH,35,47,12,15,27
2,8482055,Drew O'Connor,L,PIT,25,82,11,16,27
2,8482062,Cole Smith,L,NSH,28,81,11,16,27
2,8478413,Jordan Greenway,L,BUF,26,70,11,16,27
2,8482222,Alexander Barabanov,L,SJS,29,61,10,17,27
2,8478136,Jake Middleton,D,MIN,27,82,9,18,27
2,8475164,Jakob Silfverberg,R,ANA,33,81,7,20,27
2,8482245,Artem Zub,D,OTT,28,72,3,24,27
2,8479977,Kailer Yamamoto,R,SEA,25,73,16,10,26
2,8482097,Jack Quinn,R,BUF,22,45,14,12,26
2,8478046,Danton Heinen,L,BOS,28,74,13,13,26
2,8482720,Matthew Knies,L,TOR,21,80,11,15,26
2,8480855,Jack McBain,C,ARI,23,67,8,18,26
2,8478178,Darren Raddysh,D,TBL,27,82,6,20,26
2,8478840,Will Borgen,D,SEA,27,82,2,24,26
2,8480829,Jesperi Kotkaniemi,C,CAR,23,81,13,12,25
2,8482157,Will Cuylle,L,NYR,21,82,13,12,25
2,8480185,Eetu Luostarinen,C,FLA,25,82,11,14,25
2,8476923,Damon Severson,D,CBJ,29,66,8,17,25
2,8477444,Andre Burakovsky,L,SEA,28,51,8,17,25
2,8476931,Jake McCabe,D,TOR,30,76,7,18,25
2,8476329,Travis Boyd,C,ARI,30,45,7,18,25
2,8471699,Andrew Cogliano,C,COL,36,76,7,18,25
2,8476457,Adam Larsson,D,SEA,31,82,4,21,25
2,8481535,Nils Hoglander,L,VAN,23,53,17,7,24
2,8476374,Sean Kuraly,C,CBJ,30,73,12,12,24
2,8477947,Sonny Milano,L,WSH,27,53,11,13,24
2,8478020,Michael Amadio,R,VGK,27,74,10,14,24
2,8479351,Sam Steel,C,DAL,25,77,9,15,24
2,8481032,Paul Cotter,C,VGK,24,80,8,16,24
2,8480835,Jack Drury,C,CAR,23,53,8,16,24
2,8477932,Aaron Ekblad,D,FLA,27,64,7,17,24
2,8477508,Curtis Lazar,C,NJD,28,76,7,17,24
2,8478507,John Marino,D,NJD,26,81,5,19,24
2,8477953,Kasperi Kapanen,R,STL,27,75,5,19,24
2,8476463,Jonas Brodin,D,MIN,30,64,5,19,24
2,8480246,Nick Perbix,D,TBL,25,80,3,21,24
2,8475197,Tyson Barrie,D,NSH,32,62,3,21,24
2,8476331,Dylan DeMelo,D,WPG,30,81,2,22,24
2,8473449,Kyle Okposo,R,BUF,35,79,13,10,23
2,8478109,Victor Olofsson,L,BUF,28,63,8,15,23
2,8481546,Cam York,D,PHI,22,81,8,15,23
2,8478463,Anthony Beauvillier,L,CHI,26,64,7,16,23
2,8478133,Jake Evans,C,MTL,27,82,6,17,23
2,8482073,Braden Schneider,D,NYR,22,82,5,18,23
2,8477986,Brandon Montour,D,FLA,29,66,4,19,23
2,8478042,Viktor Arvidsson,R,LAK,30,32,14,8,22
2,8475791,Taylor Hall,L,CHI,32,37,8,14,22
2,8482117,Lukas Reichel,L,CHI,21,77,7,15,22
2,8478882,Vladislav Gavrikov,D,LAK,28,77,6,16,22
2,8480043,Timothy Liljegren,D,TOR,24,65,5,17,22
2,8481568,Alex Vlasic,D,CHI,22,76,5,17,22
2,8479316,Luke Kunin,C,SJS,26,76,16,5,21
2,8481601,Simon Holmstrom,R,NYI,22,81,14,7,21
2,8481704,Juuso Parssinen,C,NSH,22,71,13,8,21
2,8474040,Sam Gagner,C,EDM,34,55,12,9,21
2,8479591,Michael Eyssimont,C,TBL,27,81,10,11,21
2,8475855,Jesper Fast,R,CAR,32,78,10,11,21
2,8480068,Ryan Poehling,C,PHI,24,76,9,12,21
2,8478115,Pierre Engvall,L,NYI,27,76,8,13,21
2,8482111,Justin Barron,D,MTL,22,68,8,13,21
2,8482087,Kaiden Guhle,D,MTL,21,78,6,15,21
2,8473563,Nicklas Backstrom,C,WSH,36,37,5,16,21
2,8481656,Aliaksei Protas,C,WSH,22,52,4,17,21
2,8478911,Matt Roy,D,LAK,28,81,3,18,21
2,8479998,Mikey Anderson,D,LAK,24,82,3,18,21
2,8480049,Dylan Samberg,D,WPG,24,81,2,19,21
2,8480281,Alexey Toropchenko,R,STL,24,82,15,5,20
2,8481618,Alex Newhook,C,MTL,22,55,10,10,20
2,8479661,Tanner Jeannot,L,TBL,26,68,9,11,20
2,8481481,Blake Lizotte,C,LAK,26,64,9,11,20
2,8479353,Brett Howden,C,VGK,25,79,8,12,20
2,8475462,Radko Gudas,D,ANA,33,76,8,12,20
2,8475231,Casey Cizikas,C,NYI,32,71,7,13,20
2,8478851,Alexandre Carrier,D,NSH,27,77,5,15,20
2,8475790,Erik Gudbranson,D,CBJ,31,77,4,16,20
2,8475279,Ben Chiarot,D,DET,32,77,4,16,20
2,8477950,Tony DeAngelo,D,CAR,28,51,3,17,20
2,8473507,Jeff Petry,D,DET,36,73,2,18,20
2,8476879,Cody Ceci,D,EDM,30,82,1,19,20
2,8478399,Jonas Siegenthaler,D,NJD,26,66,1,19,20
2,8477845,Trevor van Riemsdyk,D,WSH,32,70,0,20,20
2,8478831,Kevin Stenlund,C,FLA,27,82,12,7,19
2,8477330,Dominik Kubalik,L,OTT,28,78,11,8,19
2,8476981,Josh Anderson,R,MTL,29,78,10,9,19
2,8475233,David Savard,D,MTL,33,60,7,12,19
2,8481014,Alexander Romanov,D,NYI,23,81,7,12,19
2,8474053,Logan Couture,C,SJS,34,34,6,13,19
2,8480878,Nils Lundkvist,D,DAL,23,70,3,16,19
2,8474151,Ryan McDonagh,D,NSH,34,75,2,17,19
2,8477839,Conor Sheary,L,TBL,31,64,2,17,19
2,8470600,Ryan Suter,D,DAL,38,82,1,18,19
2,8477365,Connor Clifton,D,BUF,28,79,1,18,19
2,8478508,Yakov Trenin,C,NSH,26,79,14,4,18
2,8473453,Trevor Lewis,C,LAK,36,82,11,7,18
2,8482699,Dylan Guenther,R,ARI,20,45,10,8,18
2,8479390,Taylor Raddysh,R,CHI,25,77,9,9,18
2,8479293,Brandon Tanev,L,SEA,32,66,9,9,18
2,8475455,Brenden Dillon,D,WPG,33,78,7,11,18
2,8477435,Ryan Graves,D,PIT,28,82,7,11,18
2,8480883,Ty Smith,D,PIT,23,31,5,13,18
2,8477488,Brett Pesce,D,CAR,29,71,5,13,18
2,8480220,Noah Cates,L,PHI,24,59,4,14,18
2,8480796,Martin Fehervary,D,WSH,24,76,3,15,18
2,8477507,Nikita Zadorov,D,VAN,28,75,2,16,18
2,8480001,Urho Vaakanainen,D,ANA,24,74,1,17,18
2,8476469,Joel Armia,R,MTL,30,66,12,5,17
2,8470604,Jeff Carter,C,PIT,38,76,12,5,17
2,8480821,Filip Zadina,R,SJS,24,48,7,10,17
2,8480078,Filip Chytil,C,NYR,24,38,5,12,17
2,8479359,Beck Malenstyn,L,WSH,25,81,5,12,17
2,8474166,Alec Martinez,D,VGK,36,64,5,12,17
2,8480848,Ty Dellandrea,C,DAL,23,53,5,12,17
2,8470638,Patrice Bergeron,C,BOS,38,27,5,12,17
2,8480172,Jan Rutta,D,SJS,33,75,4,13,17
2,8478443,Brandon Carlo,D,BOS,27,77,3,14,17
2,8474161,Jakub Voracek,R,CBJ,34,29,1,16,17
2,8474673,TJ Brodie,D,TOR,33,81,1,16,17
2,8471274,Alex Goligoski,D,MIN,38,58,0,17,17
2,8476822,Luke Glendening,C,TBL,34,82,15,1,16
2,8481554,Kaapo Kakko,R,NYR,22,61,11,5,16
2,8479393,Noah Gregor,C,TOR,25,81,9,7,16
2,8477944,Jakub Vrana,L,STL,27,49,9,7,16
2,8470610,Zach Parise,L,COL,39,33,9,7,16
2,8475848,Brendan Gallagher,R,MTL,31,50,8,8,16
2,8482142,Jamie Drysdale,D,PHI,21,49,7,9,16
2,8473548,Phil Kessel,R,VGK,36,28,7,9,16
2,8482660,Kent Johnson,C,CBJ,21,36,6,10,16
2,8476422,Mike Reilly,D,NYI,30,61,4,12,16
2,8475208,Brian Dumoulin,D,SEA,32,80,4,12,16
2,8474034,Pat Maroon,L,MIN,35,49,4,12,16
2,8481523,Kirby Dach,C,MTL,22,29,4,12,16
2,8481522,Peyton Krebs,C,BUF,22,80,4,12,16
2,8478859,Niko Mikkola,D,FLA,27,82,3,13,16
2,8475324,Nick Jensen,D,WSH,33,82,2,14,16
2,8475179,Dmitry Kulikov,D,FLA,33,78,0,16,16
2,8481606,Jordan Spence,D,LAK,22,44,0,16,16
2,8480144,David Kampf,C,TOR,28,78,8,7,15
2,8475461,Andrew Agozzino,L,SJS,32,28,7,8,15
2,8477987,Ryan Donato,C,CHI,27,51,6,9,15
2,8481178,Egor Zamula,D,PHI,23,44,5,10,15
2,8477919,Frederick Gaudreau,C,MIN,30,70,4,11,15
2,8476889,Radek Faksa,C,DAL,29,74,4,11,15
2,8479976,Juuso Valimaki,D,ARI,25,68,3,12,15
2,8480035,Henri Jokiharju,D,BUF,24,74,3,12,15
2,8475825,Jani Hakanpää,D,DAL,31,82,3,12,15
2,8474567,Zach Bogosian,D,MIN,33,70,3,12,15
2,8474683,Derek Grant,C,ANA,33,28,2,13,15
2,8481605,Jackson LaCombe,D,ANA,22,76,2,13,15
2,8475690,Chris Tanev,D,CGY,34,79,1,14,15
2,8475718,Justin Holl,D,DET,31,63,1,14,15
2,8482101,Danil Gushchin,L,SJS,21,30,8,6,14
2,8474031,Kevin Shattenkirk,D,BOS,34,44,5,9,14
2,8478970,Jalen Chatfield,D,CAR,27,48,5,9,14
2,8477979,Nicolas Aube-Kubel,R,WSH,27,39,5,9,14
2,8481596,Shane Pinto,C,OTT,23,41,5,9,14
2,8473504,Cal Clutterbuck,R,NYI,36,53,4,10,14
2,8477380,Jonny Brodzinski,C,NYR,30,35,4,10,14
2,8475906,John Klingberg,D,TOR,31,43,3,11,14
2,8479980,Nicolas Hague,D,VGK,25,73,3,11,14
2,8476917,Adam Pelech,D,NYI,29,58,3,11,14
2,8478416,Erik Cernak,D,TBL,26,71,3,11,14
2,8480031,Max Comtois,L,ANA,24,28,10,3,13
2,8480289,Morgan Barron,C,WPG,25,51,9,4,13
2,8481013,Jonatan Berggren,R,DET,23,37,7,6,13
2,8477446,Michael McCarron,R,NSH,28,43,7,6,13
2,8482259,Bobby McMann,C,TOR,27,29,7,6,13
2,8474573,Josh Bailey,R,NYI,34,29,6,7,13
2,8480448,Parker Kelly,L,OTT,24,51,6,7,13
2,8481093,Rafael Harvey-Pinard,L,MTL,24,51,5,8,13
2,8480762,Eric Robinson,L,BUF,28,54,5,8,13
2,8476473,Connor Murphy,D,CHI,30,70,5,8,13
2,8475177,Calvin de Haan,D,TBL,32,72,5,8,13
2,8476393,Nick Cousins,C,FLA,30,70,5,8,13
2,8474009,Nick Bonino,C,NYR,35,73,5,8,13
2,8480849,Barrett Hayton,C,ARI,23,50,2,11,13
2,8480994,Damien Giroux,C,MIN,23,28,1,12,13
2,8476941,Connor Carrick,D,BOS,29,27,1,12,13
2,8479336,Carl Grundstrom,R,LAK,26,50,8,4,12
2,8473544,Derick Brassard,C,OTT,36,31,7,5,12
2,8478131,Ondrej Kase,R,CAR,28,28,7,5,12
2,8476858,Phillip Di Giuseppe,L,VAN,30,62,6,6,12
2,8481517,Brett Leason,R,ANA,24,43,6,6,12
2,8480748,Kiefer Sherwood,L,NSH,28,41,5,7,12
2,8481567,Henry Thrun,D,SJS,22,51,5,7,12
2,8479322,Wade Allison,R,PHI,26,26,5,7,12
2,8477989,Christian Dvorak,C,MTL,27,52,4,8,12
2,8477506,Ryan Pulock,D,NYI,29,58,4,8,12
2,8476967,Brett Kulak,D,EDM,29,82,4,8,12
2,8480891,Michael Kesselring,D,ARI,23,36,4,8,12
2,8476960,Andreas Athanasiou,C,CHI,29,38,3,9,12
2,8477220,Nate Schmidt,D,WPG,32,75,3,9,12
2,8480073,Erik Brannstrom,D,OTT,24,45,3,9,12
2,8474612,Travis Hamonic,D,OTT,33,75,3,9,12
2,8471677,Jack Johnson,D,COL,36,80,3,9,12
2,8477499,Rasmus Ristolainen,D,PHI,29,57,3,9,12
2,8479996,Cody Glass,C,NSH,24,54,2,10,12
2,8479324,Ryan Lindgren,D,NYR,25,80,2,10,12
2,8476467,Jamie Oleksiak,D,SEA,31,82,2,10,12
2,8476874,Olli Maatta,D,DET,29,46,2,10,12
2,8478432,Christian Fischer,R,DET,26,51,2,10,12
2,8476624,Barclay Goodrow,C,NYR,30,80,2,10,12
2,8477335,Kyle Burroughs,D,SJS,28,74,2,10,12
2,8476441,Joel Edmundson,D,WSH,30,66,2,10,12
2,8480884,Calen Addison,D,SJS,23,45,1,11,12
2,8482192,Isaak Phillips,D,CHI,22,56,0,12,12
2,8480192,Johnathan Kovacevic,D,MTL,26,74,9,2,11
2,8482679,Matt Coronato,R,CGY,21,42,7,4,11
2,8477903,Garnet Hathaway,R,PHI,32,81,7,4,11
2,8475225,Craig Smith,C,DAL,34,50,7,4,11
2,8478468,Jeremy Lauzon,D,NSH,26,82,6,5,11
2,8479344,Jesse Puljujarvi,R,PIT,25,36,6,5,11
2,8479346,Dillon Dube,C,CGY,25,70,5,6,11
2,8480205,Emil Bemstrom,R,CBJ,24,31,5,6,11
2,8478585,Derek Ryan,C,EDM,37,51,5,6,11
2,8476525,Colin Miller,D,NJD,31,61,4,7,11
2,8480879,Jacob Bernard-Docker,D,OTT,23,42,4,7,11
2,8476915,Jujhar Khaira,L,MIN,29,29,4,7,11
2,8480887,Jordan Harris,D,MTL,23,58,2,9,11
2,8474207,Nick Holden,D,OTT,36,31,2,9,11
2,8480807,Mattias Samuelsson,D,BUF,23,69,1,10,11
2,8477406,Mattias Janmark,C,EDM,31,71,1,10,11
2,8480328,David Gust,R,CHI,29,27,8,2,10
2,8475842,Sam Carrick,C,ANA,31,54,7,3,10
2,8480980,Connor Dewar,C,MIN,24,48,7,3,10
2,8477353,Tyler Motte,C,TBL,28,72,6,4,10
2,8478421,A.J. Greer,L,CGY,27,47,6,4,10
2,8477941,Nick Ritchie,L,CGY,28,27,5,5,10
2,8476871,Tanner Pearson,L,MTL,31,36,4,6,10
2,8478434,Keegan Kolesar,R,VGK,26,50,4,6,10
2,8471669,Paul Stastny,C,CAR,38,28,3,7,10
2,8479414,Nathan Bastian,R,NJD,26,51,3,7,10
2,8479543,Michael Pezzetta,L,MTL,25,44,3,7,10
2,8480727,Zach Whitecloud,D,VGK,27,65,3,7,10
2,8482451,Mikael Pyyhtia,L,CBJ,22,29,3,7,10
2,8479371,Dante Fabbro,D,NSH,25,42,2,8,10
2,8482711,Stanislav Svozil,D,CBJ,20,29,1,9,10
2,8480860,Kevin Bahl,D,NJD,23,81,1,9,10
2,8477015,Connor Brown,R,EDM,29,75,1,9,10
2,8479718,Alex Barré-Boulet,C,TBL,26,35,6,3,9
2,8477454,Adam Erne,L,EDM,28,54,6,3,9
2,8479383,Boris Katchouk,L,CHI,25,35,5,4,9
2,8479328,Julien Gauthier,R,NYI,26,27,5,4,9
2,8478569,Noel Acciari,C,PIT,32,70,5,4,9
2,8476442,Matt Nieto,L,PIT,31,53,4,5,9
2,8476410,Josh Leivo,L,STL,30,28,4,5,9
2,8479402,Jake Bean,D,CBJ,25,49,4,5,9
2,8476856,Matt Dumba,D,ARI,29,78,4,5,9
2,8482730,Brandt Clarke,D,LAK,20,38,4,5,9
2,8477846,Ryan Carpenter,C,SJS,32,36,3,6,9
2,8480008,Adam Ruzicka,C,ARI,24,41,3,6,9
2,8478028,Fredrik Olofsson,L,COL,27,53,3,6,9
2,8474013,Ian Cole,D,VAN,34,80,2,7,9
2,8473604,Jonathan Toews,C,CHI,35,27,2,7,9
2,8479315,Joey Anderson,R,CHI,25,28,2,7,9
2,8482448,Samuel Knazko,D,CBJ,21,29,2,7,9
2,8479442,Troy Stecher,D,ARI,29,71,1,8,9
2,8481527,Kaedan Korczak,D,VGK,22,26,1,8,9
2,8477018,Ben Hutton,D,VGK,30,31,1,8,9
2,8483460,David Jiricek,D,CBJ,20,36,1,8,9
2,8476372,Nick Seeler,D,PHI,30,55,0,9,9
2,8477034,Jaycob Megna,D,CHI,31,45,0,9,9
2,8480252,Cole Guttman,C,CHI,24,27,4,4,8
2,8479368,Max Jones,L,ANA,25,38,4,4,8
2,8479514,Rem Pitlick,C,CHI,26,36,4,4,8
2,8480806,Isac Lundestrom,C,ANA,24,46,3,5,8
2,8481477,Nico Sturm,C,SJS,28,34,3,5,8
2,8477392,Hudson Fasching,R,NYI,28,35,3,5,8
2,8477070,Liam O'Brien,C,ARI,29,49,3,5,8
2,8480913,Jordan Gross,D,NSH,28,27,3,5,8
2,8480995,Pontus Holmberg,R,TOR,24,27,2,6,8
2,8471303,Alexander Edler,D,LAK,37,30,2,6,8
2,8481592,Jakob Pelletier,L,CGY,22,31,2,6,8
2,8474218,Jason Demers,D,EDM,35,31,2,6,8
2,8474716,Jared Spurgeon,D,MIN,34,44,1,7,8
2,8480058,Pierre-Olivier Joseph,D,PIT,24,53,1,7,8
2,8479576,Vincent Desharnais,D,EDM,27,49,1,7,8
2,8478495,Denis Gurianov,R,NSH,26,40,1,7,8
2,8477971,Andreas Englund,D,LAK,27,52,1,7,8
2,8480950,Ilya Lyubushkin,D,ANA,29,79,1,7,8
2,8481690,Tyler Angle,C,CBJ,23,29,6,1,7
2,8479439,Jacob MacDonald,D,SJS,30,21,6,1,7
2,8481754,Nikita Nesterenko,C,ANA,22,28,5,2,7
2,8471709,Marc-Edouard Vlasic,D,SJS,36,31,5,2,7
2,8477478,William Carrier,L,VGK,29,33,5,2,7
2,8477573,Nathan Walker,L,STL,29,18,5,2,7
2,8482241,Radim Zohorna,L,PIT,27,31,4,3,7
2,8471276,David Krejci,C,BOS,37,27,3,4,7
2,8481058,Jesse Ylönen,R,MTL,24,43,3,4,7
2,8482712,Oskar Olausson,R,COL,21,28,2,5,7
2,8476891,Matt Grzelcyk,D,BOS,29,41,2,5,7
2,8479458,Nikita Zaitsev,D,CHI,32,26,2,5,7
2,8477541,Dakota Mermis,D,MIN,29,37,2,5,7
2,8478099,Kevin Labanc,R,SJS,28,32,2,5,7
2,8481641,Joel Kiviranta,L,COL,27,40,2,5,7
2,8480880,Jakub Lauko,C,BOS,23,40,2,5,7
2,8470966,Mark Giordano,D,TOR,40,36,1,6,7
2,8481537,Nikita Okhotiuk,D,SJS,23,38,1,6,7
2,8478502,Dennis Gilbert,D,CGY,27,31,1,6,7
2,8478104,Sammy Blais,L,STL,27,43,1,6,7
2,8480871,Adam Boqvist,D,CBJ,23,22,0,7,7
2,8479520,Brandon Duhaime,R,MIN,26,54,4,2,6
2,8479066,Ryan Lomberg,L,FLA,29,55,4,2,6
2,8476278,Colin Blackwell,C,CHI,30,25,3,3,6
2,8479968,Vinni Lettieri,C,MIN,28,24,3,3,6
2,8477369,Carson Soucy,D,VAN,29,21,2,4,6
2,8482496,Nils Aman,C,VAN,23,31,2,4,6
2,8480789,Oliver Wahlstrom,R,NYI,23,27,2,4,6
2,8481812,Nikolai Knyzhov,D,SJS,26,38,1,5,6
2,8480222,Sebastian Aho,D,NYI,27,41,1,5,6
2,8474568,Luke Schenn,D,NSH,34,36,1,5,6
2,8479982,Conor Timmins,D,TOR,25,16,1,5,6
2,8476988,Matt Benning,D,SJS,29,42,0,6,6
2,8476429,Scott Mayfield,D,NYI,31,67,0,6,6
2,8479369,Andrew Peeke,D,CBJ,25,20,0,6,6
2,8475797,Jarred Tinordi,D,CHI,31,32,0,6,6
2,8479372,Josh Mahura,D,FLA,25,20,0,6,6
2,8482081,Sean Farrell,C,MTL,22,27,5,0,5
2,8477930,Pierre-Edouard Bellemare,L,SEA,38,29,4,1,5
2,8480184,Gustav Lindström,D,ANA,25,22,3,2,5
2,8481167,Brayden Pachal,D,CGY,24,50,3,2,5
2,8471873,Anton Stralman,D,BOS,37,27,3,2,5
2,8470595,Eric Staal,C,FLA,39,27,2,3,5
2,8478408,Travis Dermott,D,ARI,27,37,2,3,5
2,8482964,Arber Xhekaj,D,MTL,22,24,2,3,5
2,8475750,Jon Merrill,D,MIN,31,38,2,3,5
2,8474618,Marco Scandella,D,STL,33,49,2,3,5
2,8480025,MacKenzie Entwistle,R,CHI,24,46,2,3,5
2,8479536,Axel Jonsson-Fjallby,L,WPG,25,26,2,3,5
2,8481617,Vasily Podkolzin,R,VAN,22,26,2,3,5
2,8475747,Patrik Nemeth,D,ARI,31,29,2,3,5
2,8474090,Brendan Smith,D,NJD,34,36,1,4,5
2,8477384,Josh Brown,D,ARI,29,28,1,4,5
2,8481708,Zac Jones,D,NYR,23,17,1,4,5
2,8480084,Nick DeSimone,D,NJD,29,23,1,4,5
2,8479671,Mathieu Olivier,R,CBJ,26,25,1,4,5
2,8479547,Matthew Phillips,R,PIT,25,27,1,4,5
2,8476919,Chris Tierney,C,NJD,29,28,1,4,5
2,8476952,Dominic Toninato,C,WPG,29,15,1,4,5
2,8482652,Walker Duehr,R,CGY,26,26,1,4,5
2,8475762,Derek Forbort,D,BOS,31,57,0,5,5
2,8477482,Zach Sanford,L,CHI,29,26,0,5,5
2,8476878,Zemgus Girgensons,L,BUF,29,36,4,0,4
2,8482077,Dylan Holloway,L,EDM,22,23,3,1,4
2,8480011,Klim Kostin,C,DET,24,32,3,1,4
2,8480275,Nick Swaney,R,MIN,26,28,3,1,4
2,8476310,Lukas Sedlak,C,PHI,30,26,2,2,4
2,8479370,Tyson Jost,C,BUF,25,29,2,2,4
2,8481019,David Gustafsson,C,WPG,23,27,2,2,4
2,8479981,Jonah Gadjovich,L,FLA,25,27,2,2,4
2,8482207,William Dufour,R,NYI,21,29,2,2,4
2,8477938,Haydn Fleury,D,TBL,27,16,1,3,4
2,8480003,Jesper Boqvist,C,BOS,25,20,1,3,4
2,8479994,Jaret Anderson-Dolan,C,LAK,24,24,1,3,4
2,8475752,Tyler Pitlick,C,NYR,32,34,1,3,4
2,8476913,Devin Shore,C,SEA,29,21,1,3,4
2,8477851,Jordan Oesterle,D,CGY,31,48,1,3,4
2,8483641,Anton Levtchi,L,FLA,28,27,1,3,4
2,8475780,Chris Wagner,R,BOS,32,27,1,3,4
2,8474162,Jake Muzzin,D,TOR,34,29,0,4,4
2,8482176,Wyatt Kaiser,D,CHI,21,23,0,4,4
2,8478452,Caleb Jones,D,COL,26,20,0,4,4
2,8478454,Noah Juulsen,D,VAN,26,38,0,4,4
2,8478424,Jansen Harkins,C,PIT,26,34,0,4,4
2,8478870,Rudolfs Balcers,L,TBL,26,26,3,0,3
2,8473446,Erik Johnson,D,BUF,35,46,3,0,3
2,8479291,Kevin Rooney,C,CGY,30,33,2,1,3
2,8480901,Karson Kuhlman,C,WPG,28,30,2,1,3
2,8482452,Elliot Desnoyers,L,PHI,21,26,2,1,3
2,8480242,Arnaud Durandeau,L,NYI,24,29,2,1,3
2,8481147,Reese Johnson,C,CHI,25,34,2,1,3
2,8478078,Rourke Chartier,C,OTT,27,34,2,1,3
2,8474709,Matt Martin,L,NYI,34,31,2,1,3
2,8479772,Zack MacEwen,R,OTT,27,22,2,1,3
2,8477962,Brendan Lemieux,L,CAR,27,23,2,1,3
2,8475766,Austin Watson,L,TBL,31,28,2,1,3
2,8480468,James Hamblin,L,EDM,24,31,2,1,3
2,8480355,Mark Kastelic,C,OTT,24,34,2,1,3
2,8483424,Owen Beck,C,MTL,19,27,2,1,3
2,8480874,Adam Ginning,D,PHI,23,26,1,2,3
2,8479580,Dylan Gambrell,C,OTT,27,31,1,2,3
2,8477359,Tucker Poolman,D,VAN,30,26,1,2,3
2,8481122,Simon Benoit,D,TOR,25,39,1,2,3
2,8478451,Ethan Bear,D,WSH,26,16,1,2,3
2,8471686,Marc Staal,D,PHI,36,20,1,2,3
2,8477244,Chad Ruhwedel,D,PIT,33,37,1,2,3
2,8481541,Samuel Bolduc,D,NYI,23,33,1,2,3
2,8476934,Brock McGinn,L,ANA,29,24,1,2,3
2,8476994,Vinnie Hinostroza,C,PIT,29,14,1,2,3
2,8480007,Jonas Rondbjerg,R,VGK,24,17,1,2,3
2,8476867,Brendan Gaunce,C,CBJ,29,8,1,2,3
2,8478904,Steven Lorentz,C,FLA,27,28,1,2,3
2,8479379,Givani Smith,R,SJS,25,26,1,2,3
2,8480831,Alec Regula,D,CHI,23,27,1,2,3
2,8480072,Lias Andersson,C,LAK,25,30,0,3,3
2,8482516,Matthew Kessel,D,STL,23,47,0,3,3
2,8478450,Parker Wotherspoon,D,BOS,26,23,0,3,3
2,8477810,Joel Hanley,D,DAL,32,26,0,3,3
2,8480853,Liam Foudy,C,NSH,23,13,0,3,3
2,8475235,Nicolas Deslauriers,L,PHI,32,47,0,3,3
2,8483464,Marco Kasper,C,DET,19,28,0,3,3
2,8480776,Sheldon Rempal,R,VGK,28,5,2,0,2
2,8471817,Ryan Reaves,R,TOR,36,27,2,0,2
2,8477073,Kurtis MacDermid,D,COL,29,28,2,0,2
2,8480041,Dmitri Samorukov,D,STL,24,28,1,1,2
2,8482133,Thomas Bordeleau,C,SJS,21,6,1,1,2
2,8481006,Tyler Tucker,D,STL,23,16,1,1,2
2,8479362,Riley Tufte,L,COL,25,5,1,1,2
2,8478051,Max Willman,C,NJD,28,13,1,1,2
2,8481532,Alex Turcotte,C,LAK,22,6,1,1,2
2,8479348,Kale Clague,D,BUF,25,28,0,2,2
2,8482181,Tristen Robins,C,SJS,22,28,0,2,2
2,8480977,Semyon Der-Arguchintsev,C,TOR,23,29,0,2,2
2,8480070,Ian Mitchell,D,BOS,24,13,0,2,2
2,8480196,Jacob Bryson,D,BUF,26,8,0,2,2
2,8480870,Bo Groulx,C,ANA,23,32,0,2,2
2,8473473,Milan Lucic,L,BOS,35,4,0,2,2
2,8477464,Nic Petan,C,MIN,28,6,0,2,2
2,8477527,Ross Johnston,L,ANA,29,41,0,2,2
2,8481043,Cole Koepke,L,TBL,25,8,0,2,2
2,8481056,Spencer Stastney,D,NSH,23,9,1,0,1
2,8480823,Alexander Alexeyev,D,WSH,24,13,1,0,1
2,8476873,Mark Jankowski,C,NSH,29,5,1,0,1
2,8480021,Jack Studnicka,C,SJS,24,14,1,0,1
2,8478409,Anthony Richard,C,BOS,27,4,1,0,1
2,8483570,Ben Meyers,C,COL,25,9,1,0,1
2,8481422,Jacob Lucchini,C,MIN,28,13,1,0,1
2,8479546,Oskar Steen,C,BOS,25,34,1,0,1
2,8481239,Samuel Fagemo,L,LAK,23,8,1,0,1
2,8477931,Tomas Nosek,L,NJD,31,40,0,1,1
2,8476449,Scott Harrington,D,ANA,30,28,0,1,1
2,8482762,Simon Edvinsson,D,DET,20,2,0,1,1
2,8481161,Jake Christiansen,D,CBJ,24,3,0,1,1
2,8480157,Calle Rosen,D,STL,29,5,0,1,1
2,8479984,Cal Foote,D,NJD,25,4,0,1,1
2,8479321,Lucas Johansen,D,WSH,26,6,0,1,1
2,8479378,Logan Stanley,D,WPG,25,10,0,1,1
2,8478017,Mark Friedman,D,VAN,28,20,0,1,1
2,8482095,Tyler Kleven,D,OTT,21,5,0,1,1
2,8479320,Max Lajoie,D,TOR,26,5,0,1,1
2,8477887,Patrick Brown,C,BOS,31,11,0,1,1
2,8480245,Olle Lycksell,R,PHI,24,5,0,1,1
2,8478146,Matthew Highmore,C,OTT,27,6,0,1,1
2,8480845,Rasmus Kupari,C,WPG,23,21,0,1,1
2,8478512,Austin Czarnik,C,DET,31,18,0,1,1
2,8479367,William Lockwood,R,FLA,25,23,0,1,1
2,8481543,Nikita Alexandrov,C,STL,23,18,0,1,1
2,8483597,Milos Kelemen,L,ARI,24,10,0,1,1
2,8483565,Nick Blankenburg,D,CBJ,25,6,0,0,0
2,8483620,Marcus Bjork,D,CBJ,26,0,0,0,0
2,8481521,Ronnie Attard,D,PHI,24,0,0,0,0
2,8482399,Billy Sweezey,D,CBJ,27,0,0,0,0
2,8481072,Tim Berni,D,CBJ,23,0,0,0,0
2,8476884,Derrick Pouliot,D,SJS,29,0,0,0,0
2,8482624,Daniil Miromanov,D,VGK,26,2,0,0,0
2,8482861,Vincent Iorio,D,WSH,21,0,0,0,0
2,8478465,Guillaume Brisebois,D,VAN,26,0,0,0,0
2,8484256,Jake Livingstone,D,NSH,24,0,0,0,0
2,8481599,Victor Soderstrom,D,ARI,22,1,0,0,0
2,8474027,Justin Braun,D,PHI,36,0,0,0,0
2,8478062,Dysin Mayo,D,ARI,27,0,0,0,0
2,8481563,Drew Helleson,D,ANA,22,0,0,0,0
2,8481575,Lassi Thomson,D,OTT,23,0,0,0,0
2,8483619,Filip Roos,D,CHI,24,4,0,0,0
2,8481461,Corey Schueneman,D,MTL,28,0,0,0,0
2,8478846,Christian Wolanin,D,VAN,28,0,0,0,0
2,8479395,Dennis Cholowski,D,NYI,25,0,0,0,0
2,8479945,Gavin Bayreuther,D,CBJ,29,0,0,0,0
2,8474818,Jordie Benn,D,TOR,36,0,0,0,0
2,8479421,Jacob Moverare,D,LAK,25,5,0,0,0
2,8479329,Frederic Allard,D,MTL,26,0,0,0,0
2,8481600,Tobias Bjornfot,D,VGK,22,3,0,0,0
2,8477462,Robert Hagg,D,ANA,28,5,0,0,0
2,8476470,Nathan Beaulieu,D,ANA,31,0,0,0,0
2,8484254,Akito Hirose,D,VAN,24,3,0,0,0
2,8479388,Riley Stillman,D,BUF,25,0,0,0,0
2,8482824,Nick Cicek,D,SJS,23,0,0,0,0
2,8480056,Jack Rathbone,D,VAN,24,0,0,0,0
2,8476850,Ryan Murray,D,EDM,30,0,0,0,0
2,8478841,Colton White,D,ANA,26,0,0,0,0
2,8480160,Radim Simek,D,SJS,31,0,0,0,0
2,8478491,Jacob Larsson,D,OTT,26,0,0,0,0
2,8475857,Kevin Gravel,D,NSH,31,0,0,0,0
2,8482067,Connor Mackey,D,NYR,27,1,0,0,0
2,8477433,Ben Harpur,D,NYR,28,0,0,0,0
2,8481572,Ville Heinola,D,WPG,22,0,0,0,0
2,8478415,Jakub Zboril,D,BOS,26,0,0,0,0
2,8477341,Andreas Johnsson,L,SJS,29,0,0,0,0
2,8480216,Jacob Peterson,C,SJS,24,6,0,0,0
2,8477467,Gustav Olofsson,D,SEA,29,0,0,0,0
2,8478476,Kyle Capobianco,D,WPG,26,0,0,0,0
2,8479985,Cale Fleury,D,SEA,25,0,0,0,0
2,8475227,Chris Wideman,D,MTL,33,0,0,0,0
2,8479333,Libor Hajek,D,NYR,25,0,0,0,0
2,8479376,Victor Mete,D,PHI,25,1,0,0,0
2,8480439,Mac Hollowell,D,TOR,25,0,0,0,0
2,8480467,Austin Strand,D,ANA,26,0,0,0,0
2,8477981,Roland McKeown,D,NSH,27,0,0,0,0
2,8474628,Michael Stone,D,CGY,33,0,0,0,0
2,8480034,Joel Teasdale,L,MTL,24,0,0,0,0
2,8481609,Vladislav Kolyachonok,D,ARI,22,1,0,0,0
2,8479602,Jeremy Davies,D,BUF,27,0,0,0,0
2,8479639,Dylan Coghlan,D,CAR,25,0,0,0,0
2,8478506,Gabriel Carlsson,D,WSH,26,0,0,0,0
2,8477463,Steven Santini,D,STL,28,0,0,0,0
2,8478075,Anders Bjork,L,CHI,27,0,0,0,0
2,8484287,Cole McWard,D,VAN,22,1,0,0,0
2,8474145,Robert Bortuzzo,D,NYI,34,15,0,0,0
2,8475625,Matt Irwin,D,WSH,36,0,0,0,0
2,8482179,Justin Richards,C,CBJ,25,0,0,0,0
2,8481649,Joona Luoto,L,CBJ,26,0,0,0,0
2,8479026,Philippe Myers,D,TBL,26,5,0,0,0
2,8480935,Lawrence Pilut,D,BUF,28,0,0,0,0
2,8479578,Casey Fitzgerald,D,FLA,26,0,0,0,0
2,8480071,Robin Salo,D,NYI,25,0,0,0,0
2,8478224,Luke Philp,C,CHI,28,0,0,0,0
2,8484125,Hunter McKown,C,CBJ,21,0,0,0,0
2,8481679,Maxence Guenette,D,OTT,22,1,0,0,0
2,8479423,Alex Nylander,L,PIT,25,5,0,0,0
2,8480441,Trey Fix-Wolansky,R,CBJ,24,1,0,0,0
2,8480820,Filip Kral,D,TOR,24,0,0,0,0
2,8479523,Lucas Carlsson,D,FLA,26,0,0,0,0
2,8479304,Kyle Criscuolo,C,SJS,31,0,0,0,0
2,8474697,Mark Borowiecki,D,NSH,34,0,0,0,0
2,8480842,Filip Hallander,C,PIT,23,0,0,0,0
2,8481725,Elmer Soderblom,L,DET,22,0,0,0,0
2,8479252,Dan Renouf,D,BOS,29,0,0,0,0
2,8481591,Sam Poulin,R,PIT,22,0,0,0,0
2,8475968,Alex Belzile,R,MTL,32,0,0,0,0
2,8475772,Riley Sheahan,C,BUF,32,0,0,0,0
2,8475163,Alex Chiasson,R,DET,33,0,0,0,0
2,8481598,Philip Broberg,D,EDM,22,10,0,0,0
2,8478455,Austin Wagner,L,CHI,26,0,0,0,0
2,8476779,Brad Hunt,D,COL,35,0,0,0,0
2,8479335,Rasmus Asplund,C,NSH,26,0,0,0,0
2,8478967,Lane Pederson,C,CBJ,26,0,0,0,0
2,8481077,John Leonard,L,NSH,25,0,0,0,0
2,8481585,Egor Afanasyev,L,NSH,22,2,0,0,0
2,8483397,Marc McLaughlin,C,BOS,24,0,0,0,0
2,8480443,Kristian Reichel,C,WPG,25,0,0,0,0
2,8481751,Lukas Rousek,R,BUF,24,5,0,0,0
2,8476396,Steven Fogarty,C,MIN,30,0,0,0,0
2,8478881,Brett Seney,L,CHI,27,4,0,0,0
2,8480326,Sheldon Dries,C,VAN,29,0,0,0,0
2,8481433,Taro Hirose,L,DET,27,0,0,0,0
2,8480833,Vitali Kravtsov,R,VAN,24,0,0,0,0
2,8481550,Adam Beckman,L,MIN,22,0,0,0,0
2,8479972,Mason Shaw,C,MIN,25,0,0,0,0
2,8477460,Laurent Dauphin,C,ARI,28,0,0,0,0
2,8476166,Taylor Fedun,D,PIT,35,0,0,0,0
2,8478067,Oskar Lindblom,L,SJS,27,1,0,0,0
2,8479944,Zach Aston-Reese,C,DET,29,1,0,0,0
2,8479465,Drake Caggiula,L,PIT,29,0,0,0,0
2,8481740,Tyce Thompson,R,NJD,24,0,0,0,0
2,8476948,Charles Hudon,L,COL,29,0,0,0,0
2,8480863,Gabriel Fortier,L,TBL,23,0,0,0,0
2,8471887,Patric Hornqvist,R,FLA,36,0,0,0,0
2,8477471,Dillon Heatherington,D,OTT,28,0,0,0,0
2,8481441,Joe Snively,C,WSH,27,3,0,0,0
2,8478173,Hayden Hodgson,R,PHI,27,0,0,0,0
2,8481720,Nick Abruzzese,C,TOR,24,0,0,0,0
2,8478843,Denis Malgin,C,COL,26,0,0,0,0
2,8483630,Pavol Regenda,L,ANA,24,0,0,0,0
2,8478373,Nikita Soshnikov,R,NYI,30,0,0,0,0
2,8482147,Jean-Luc Foudy,C,COL,21,0,0,0,0
2,8478431,Evgeny Svechnikov,L,SJS,27,0,0,0,0
2,8477210,Buddy Robinson,R,CHI,32,0,0,0,0
2,8479404,Henrik Borgstrom,C,WSH,26,0,0,0,0
2,8481712,Matej Blumel,R,DAL,23,0,0,0,0
2,8475278,Byron Froese,C,VGK,32,7,0,0,0
2,8479338,Markus Niemelainen,D,EDM,25,0,0,0,0
2,8471794,Darren Helm,C,COL,36,0,0,0,0
2,8482623,Josh Dunne,C,CBJ,25,0,0,0,0
2,8482641,Matt Kiersted,D,FLA,25,0,0,0,0
2,8476851,Alex Galchenyuk,C,COL,29,0,0,0,0
2,8479366,Logan Brown,C,STL,25,0,0,0,0
2,8480822,Martin Kaut,R,SJS,24,0,0,0,0
2,8482834,Jesper Froden,R,SEA,29,0,0,0,0
2,8480844,Grigori Denisenko,L,VGK,23,3,0,0,0
2,8482635,Mike Hardman,L,CHI,24,0,0,0,0
2,8477357,Saku Maenalanen,R,WPG,29,0,0,0,0
2,8480979,Nathan Smith,C,ARI,25,0,0,0,0
2,8479356,Kieffer Bellows,L,PHI,25,0,0,0,0
2,8475795,Dylan McIlrath,D,WSH,31,1,0,0,0
2,8478400,Colin White,C,PIT,26,9,0,0,0
2,8478446,Glenn Gawdin,C,ANA,26,0,0,0,0
2,8476326,Josh Archibald,R,PIT,31,0,0,0,0
2,8481683,Aidan McDonough,L,VAN,24,0,0,0,0
2,8480267,Sammy Walker,C,MIN,24,4,0,0,0
2,8477520,Jean-Sebastien Dea,C,ARI,29,0,0,0,0
2,8476439,Brett Ritchie,R,ARI,30,0,0,0,0
2,8479518,Fredrik Karlström,C,DAL,25,0,0,0,0
2,8477126,Jayson Megna,C,ANA,33,0,0,0,0
2,8479644,Matt Luff,R,DET,26,0,0,0,0
2,8478211,Dryden Hunt,L,CGY,28,5,0,0,0
2,8480226,Marián Studenic,R,SEA,25,2,0,0,0
2,8480037,Aleksi Heponiemi,C,FLA,24,0,0,0,0
2,8480292,Carson Meyer,R,CBJ,26,0,0,0,0
2,8482634,Alex Steeves,C,TOR,24,1,0,0,0
2,8475178,Zack Kassian,R,ARI,32,0,0,0,0
2,8483524,Shane Wright,C,SEA,19,3,0,0,0
2,8482654,Jackson Cates,C,PHI,26,0,0,0,0
2,8479550,Tanner Laczynski,C,PHI,26,0,0,0,0
2,8479991,Jake Leschyshyn,C,NYR,24,1,0,0,0
2,8474613,Derek Stepan,C,CAR,33,0,0,0,0
2,8478367,Cole Bardreau,C,NYI,30,0,0,0,0
2,8480890,Jan Jenik,R,ARI,23,1,0,0,0
2,8475160,Kyle Clifford,L,TOR,32,0,0,0,0
2,8479705,Jeffrey Viel,L,SJS,26,0,0,0,0
2,8477401,John Hayden,C,SEA,28,2,0,0,0
2,8480846,Sampo Ranta,L,COL,23,0,0,0,0
2,8482691,Aatu Raty,C,VAN,21,0,0,0,0
2,8481070,Hugh McGing,L,STL,25,5,0,0,0
2,8479573,Mikhail Maltsev,L,COL,25,0,0,0,0
2,8482250,Callahan Burke,C,CAR,26,1,0,0,0
2,8481102,Egor Sokolov,L,OTT,23,0,0,0,0
2,8481518,Nolan Foote,L,NJD,23,0,0,0,0
2,8474190,Wayne Simmonds,R,TOR,35,0,0,0,0
2,8474610,Zac Dalpe,C,FLA,34,0,0,0,0
2,8479347,Tyler Benson,L,EDM,25,0,0,0,0
2,8476404,Andy Andreoff,C,NYI,32,0,0,0,0
2,8476390,Joseph Cramarossa,C,MIN,31,0,0,0,0
2,8483549,Lucas Condotta,L,MTL,26,3,0,0,0
2,8482197,Adam Raska,R,MIN,22,5,0,0,0
2,8479533,Joona Koppanen,L,PIT,25,3,0,0,0
2,8479526,Otto Koivula,L,NYI,25,0,0,0,0
2,8479375,William Bitten,C,STL,25,0,0,0,0
2,8474089,Brad Malone,C,EDM,34,0,0,0,0
2,8478058,CJ Suess,L,SJS,29,0,0,0,0
2,8478147,Bokondji Imama,L,ARI,27,0,0,0,0
2,8477320,Anton Blidh,L,NYR,28,1,0,0,0
2,8477993,Justin Kirkland,C,ARI,27,2,0,0,0
2,8480836,Jonathan Gruden,C,PIT,23,5,0,0,0
2,8480032,Shane Bowers,C,NJD,24,3,0,0,0
3,8477492,Nathan MacKinnon,C,COL,28,82,48,81,129
3,8476453,Nikita Kucherov,R,TBL,30,81,48,78,126
3,8478402,Connor McDavid,C,EDM,26,80,35,89,124
3,8477956,David Pastrnak,R,BOS,27,82,55,60,115
3,8479318,Auston Matthews,C,TOR,26,81,73,40,113
3,8477939,William Nylander,R,TOR,27,82,41,68,109
3,8477934,Leon Draisaitl,C,EDM,28,82,47,61,108
3,8478420,Mikko Rantanen,R,COL,27,82,43,63,106
3,8479314,Matthew Tkachuk,L,FLA,26,82,34,68,102
3,8480012,Elias Pettersson,C,VAN,25,81,40,60,100
3,8478483,Mitchell Marner,R,TOR,26,81,39,61,100
3,8480800,Quinn Hughes,D,VAN,24,81,18,81,99
3,8476468,J.T. Miller,C,VAN,30,81,31,64,95
3,8477933,Sam Reinhart,C,FLA,28,82,53,41,94
3,8480069,Cale Makar,D,COL,25,77,18,75,93
3,8478550,Artemi Panarin,L,NYR,32,82,39,53,92
3,8471675,Sidney Crosby,C,PIT,36,82,44,46,90
3,8477493,Aleksander Barkov,C,FLA,28,76,22,68,90
3,8480023,Robert Thomas,C,STL,24,82,27,60,87
3,8478010,Brayden Point,C,TBL,27,82,40,46,86
3,8482116,Tim Stützle,C,OTT,21,82,24,62,86
3,8476887,Filip Forsberg,L,NSH,29,82,38,47,85
3,8481559,Jack Hughes,C,NJD,22,65,29,56,85
3,8479407,Jesper Bratt,L,NJD,25,81,25,60,85
3,8478439,Travis Konecny,R,PHI,26,81,37,46,83
3,8478445,Mathew Barzal,C,NYI,26,81,26,57,83
3,8481540,Cole Caufield,R,MTL,22,82,36,46,82
3,8475167,Victor Hedman,D,TBL,33,80,13,69,82
3,8477409,Carter Verhaeghe,C,FLA,28,82,42,39,81
3,8476454,Ryan Nugent-Hopkins,C,EDM,30,82,26,53,79
3,8480865,Noah Dobson,D,NYI,23,82,11,68,79
3,8480018,Nick Suzuki,C,MTL,24,82,26,52,78
3,8475168,Matt Duchene,C,DAL,32,81,31,46,77
3,8471215,Evgeni Malkin,C,PIT,37,82,30,47,77
3,8478427,Sebastian Aho,C,CAR,26,78,26,51,77
3,8476460,Mark Scheifele,C,WPG,30,75,24,53,77
3,8475913,Mark Stone,R,VGK,31,81,22,55,77
3,8475786,Zach Hyman,L,EDM,31,81,45,31,76
3,8478444,Brock Boeser,R,VAN,26,81,45,31,76
3,8477404,Jake Guentzel,L,PIT,29,81,36,40,76
3,8478864,Kirill Kaprizov,L,MIN,26,75,38,36,74
3,8480027,Jason Robertson,L,DAL,24,82,24,50,74
3,8474600,Roman Josi,D,NSH,33,82,17,57,74
3,8478449,Roope Hintz,C,DAL,27,80,32,41,73
3,8479343,Clayton Keller,R,ARI,25,82,29,44,73
3,8479542,Brandon Hagel,L,TBL,25,82,27,46,73
3,8480803,Evan Bouchard,D,EDM,24,82,20,53,73
3,8478403,Jack Eichel,C,VGK,27,70,32,40,72
3,8477501,Valeri Nichushkin,R,COL,28,67,36,35,71
3,8474564,Steven Stamkos,C,TBL,33,79,34,37,71
3,8477500,Bo Horvat,C,NYI,28,81,30,41,71
3,8475158,Ryan O'Reilly,C,NSH,32,82,28,43,71
3,8476389,Vincent Trocheck,C,NYR,30,82,25,46,71
3,8480801,Brady Tkachuk,L,OTT,24,82,35,35,70
3,8479337,Alex DeBrincat,R,DET,26,82,28,42,70
3,8473512,Claude Giroux,R,OTT,35,82,23,47,70
3,8477942,Kevin Fiala,L,LAK,27,82,22,47,69
3,8476853,Morgan Rielly,D,TOR,29,79,12,57,69
3,8475184,Chris Kreider,L,NYR,32,82,36,32,68
3,8473419,Brad Marchand,L,BOS,35,82,33,35,68
3,8477946,Dylan Larkin,C,DET,27,76,30,37,67
3,8470794,Joe Pavelski,C,DAL,39,82,27,40,67
3,8478975,Mason Marchment,L,DAL,28,81,24,43,67
3,8476539,Jonathan Marchessault,R,VGK,33,81,39,27,66
3,8480002,Nico Hischier,C,NJD,24,70,30,36,66
3,8471685,Anze Kopitar,C,LAK,36,82,28,38,66
3,8475172,Nazem Kadri,C,CGY,33,82,25,41,66
3,8476459,Mika Zibanejad,C,NYR,30,81,21,44,65
3,8475692,Mats Zuccarello,R,MIN,36,73,15,50,65
3,8475754,Brock Nelson,C,NYI,32,82,34,30,64
3,8476399,Blake Coleman,C,CGY,32,82,32,32,64
3,8475794,Tyler Seguin,C,DAL,31,82,31,33,64
3,8479999,Casey Mittelstadt,C,BUF,25,82,20,44,64
3,8479323,Adam Fox,D,NYR,25,72,11,53,64
3,8476881,Tomas Hertl,C,SJS,30,76,27,36,63
3,8475166,John Tavares,C,TOR,33,80,21,42,63
3,8477960,Adrian Kempe,R,LAK,27,82,21,41,62
3,8482078,Lucas Raymond,L,DET,21,82,25,36,61
3,8478366,Frank Vatrano,R,ANA,29,82,33,27,60
3,8476448,William Karlsson,C,VGK,30,69,27,33,60
3,8476875,Mike Matheson,D,MTL,29,82,9,51,60
3,8475726,Tyler Toffoli,R,NJD,31,80,34,25,59
3,8478398,Kyle Connor,L,WPG,27,65,32,27,59
3,8477940,Nikolaj Ehlers,L,WPG,27,81,27,32,59
3,8480797,Joel Farabee,L,PHI,23,81,25,34,59
3,8475745,Charlie Coyle,C,BOS,31,82,24,35,59
3,8479385,Jordan Kyrou,C,STL,25,82,24,35,59
3,8482093,Seth Jarvis,C,CAR,21,81,25,33,58
3,8471214,Alex Ovechkin,L,WSH,38,79,22,36,58
3,8477416,Oliver Bjorkstrand,R,SEA,28,82,19,39,58
3,8480208,Drake Batherson,R,OTT,25,82,27,30,57
3,8482745,Mason McTavish,C,ANA,20,74,24,33,57
3,8480039,Martin Necas,C,CAR,24,76,21,36,57
3,8478873,Troy Terry,R,ANA,26,79,21,36,57
3,8478407,Vince Dunn,D,SEA,27,78,13,44,57
3,8482124,Quinton Byfield,R,LAK,21,80,24,32,56
3,8479325,Charlie McAvoy,D,BOS,26,74,10,46,56
3,8478493,Joel Eriksson Ek,C,MIN,26,82,31,24,55
3,8477402,Pavel Buchnevich,L,STL,28,80,26,29,55
3,8475765,Vladimir Tarasenko,R,OTT,32,80,23,32,55
3,8480839,Rasmus Dahlin,D,BUF,23,81,21,34,55
3,8476456,Jonathan Huberdeau,C,CGY,30,81,14,41,55
3,8476346,Johnny Gaudreau,L,CBJ,30,81,10,45,55
3,8477955,Jared McCann,L,SEA,27,81,32,22,54
3,8478440,Dylan Strome,C,WSH,26,82,27,27,54
3,8481068,Yegor Sharangovich,C,CGY,25,82,33,20,53
3,8482740,Wyatt Johnston,C,DAL,20,82,25,28,53
3,8475151,Kyle Palmieri,C,NYI,32,82,24,29,53
3,8480830,Andrei Svechnikov,R,CAR,23,60,23,30,53
3,8477496,Elias Lindholm,C,VAN,29,81,18,35,53
3,8476458,Ryan Strome,C,ANA,30,79,14,39,53
3,8474641,Adam Henrique,C,ANA,33,81,28,24,52
3,8481557,Matt Boldy,L,MIN,22,75,25,27,52
3,8476905,Chandler Stephenson,C,VGK,29,77,18,34,52
3,8474679,Gustav Nyquist,C,NSH,34,82,16,36,52
3,8474037,James van Riemsdyk,L,BOS,34,78,16,36,52
3,8477456,J.T. Compher,L,DET,28,77,16,36,52
3,8480036,Miro Heiskanen,D,DAL,24,72,12,40,52
3,8475810,Bryan Rust,R,PIT,31,69,24,27,51
3,8477497,Sean Monahan,C,WPG,29,83,17,34,51
3,8475798,Mikael Granlund,C,SJS,31,68,16,35,51
3,8479345,Jakob Chychrun,D,OTT,25,82,15,36,51
3,8477504,Josh Morrissey,D,WPG,28,81,11,40,51
3,8471724,Kris Letang,D,PIT,36,82,6,45,51
3,8479425,Filip Hronek,D,VAN,26,81,5,46,51
3,8477346,MacKenzie Weegar,D,CGY,29,82,22,28,50
3,8477949,Alex Tuch,R,BUF,27,75,17,33,50
3,8476479,Phillip Danault,C,LAK,30,82,16,34,50
3,8478397,Rasmus Andersson,D,CGY,27,78,12,38,50
3,8480015,Owen Tippett,R,PHI,24,77,24,25,49
3,8482149,Cole Perfetti,C,WPG,21,81,23,26,49
3,8478047,Michael Bunting,L,CAR,28,80,19,30,49
3,8478396,Noah Hanifin,D,CGY,26,82,12,37,49
3,8474590,John Carlson,D,WSH,33,82,7,42,49
3,8475169,Evander Kane,L,EDM,32,81,30,18,48
3,8479675,Trevor Moore,L,LAK,28,82,28,20,48
3,8482175,JJ Peterka,R,BUF,21,82,27,21,48
3,8474141,Patrick Kane,R,DET,35,51,21,27,48
3,8477494,Jonathan Drouin,L,COL,28,80,15,33,48
3,8476906,Shayne Gostisbehere,D,DET,30,81,10,38,48
3,8481711,Matias Maccelli,L,ARI,23,82,10,38,48
3,8474578,Erik Karlsson,D,PIT,33,82,8,40,48
3,8480009,Eeli Tolvanen,R,SEA,24,82,25,22,47
3,8475287,Erik Haula,L,NJD,32,75,22,25,47
3,8477964,Ivan Barbashev,C,VGK,28,81,21,26,47
3,8475784,Jeff Skinner,L,BUF,31,74,20,27,47
3,8480798,Philipp Kurashev,C,CHI,24,75,16,31,47
3,8478462,Nicolas Roy,C,VGK,26,72,16,31,47
3,8477021,Alex Kerfoot,C,ARI,29,82,13,34,47
3,8478460,Zach Werenski,D,CBJ,26,69,3,44,47
3,8479420,Tage Thompson,C,BUF,26,72,23,23,46
3,8477951,Nick Schmaltz,C,ARI,27,79,20,26,46
3,8476882,Teuvo Teravainen,L,CAR,29,81,19,27,46
3,8479400,Pierre-Luc Dubois,C,LAK,25,82,23,22,45
3,8481581,Thomas Harley,D,DAL,22,79,21,24,45
3,8482684,Luke Hughes,D,NJD,20,81,18,27,45
3,8478401,Pavel Zacha,C,BOS,26,78,15,30,45
3,8474586,Jordan Eberle,R,SEA,33,78,13,32,45
3,8478542,Evan Rodrigues,C,FLA,30,82,12,33,45
3,8470613,Brent Burns,D,CAR,38,81,10,35,45
3,8477511,Anthony Mantha,R,WSH,29,78,28,16,44
3,8479365,Trent Frederic,C,BOS,25,82,22,22,44
3,8478519,Anthony Cirelli,C,TBL,26,81,18,26,44
3,8473994,Jamie Benn,L,DAL,34,82,16,27,43
3,8480434,Sean Durzi,D,ARI,25,76,14,29,43
3,8476792,Torey Krug,D,STL,32,82,4,39,43
3,8481528,Dylan Cozens,C,BUF,22,79,15,27,42
3,8482667,William Eklund,L,SJS,21,80,13,29,42
3,8476480,Vladislav Namestnikov,C,WPG,31,78,11,31,42
3,8482105,Jake Sanderson,D,OTT,21,79,11,31,42
3,8477948,Travis Sanheim,D,PHI,27,80,8,34,42
3,8480064,Josh Norris,C,OTT,24,75,22,19,41
3,8478438,Tommy Novak,C,NSH,26,71,17,24,41
3,8475170,Brayden Schenn,C,STL,32,82,16,25,41
3,8478233,Andrew Mangiapane,L,CGY,27,81,14,27,41
3,8474102,David Perron,L,DET,35,76,18,22,40
3,8478856,Conor Garland,R,VAN,27,81,17,23,40
3,8482109,Alexis Lafrenière,L,NYR,22,82,16,24,40
3,8480028,Morgan Frost,C,PHI,24,70,16,24,40
3,8475760,Nick Bjugstad,C,ARI,31,82,16,24,40
3,8474565,Alex Pietrangelo,D,VGK,33,76,7,33,40
3,8475764,Cam Fowler,D,ANA,32,82,6,34,40
3,8480893,Kirill Marchenko,R,CBJ,23,79,21,18,39
3,8482110,Dawson Mercer,C,NJD,22,81,21,18,39
3,8477426,Nicholas Paul,L,TBL,28,82,21,18,39
3,8483808,Andrei Kuzmenko,L,CGY,27,76,18,21,39
3,8477935,Sam Bennett,C,FLA,27,70,17,22,39
3,8479525,Ross Colton,C,COL,27,80,13,26,39
3,8476462,Dougie Hamilton,D,NJD,30,48,13,26,39
3,8478472,Mathieu Joseph,R,OTT,26,72,13,26,39
3,8476483,Rickard Rakell,R,PIT,30,70,12,27,39
3,8476419,Jean-Gabriel Pageau,C,NYI,31,82,12,27,39
3,8478038,Devon Toews,D,COL,29,82,10,29,39
3,8481542,Moritz Seider,D,DET,22,82,7,32,39
3,8479398,Samuel Girard,D,COL,25,61,6,33,39
3,8482475,Yegor Chinakhov,R,CBJ,22,69,20,18,38
3,8478414,Timo Meier,R,NJD,27,68,20,18,38
3,8482159,Tyson Foerster,R,PHI,21,78,19,19,38
3,8475799,Nino Niederreiter,R,WPG,31,81,17,21,38
3,8482665,Matty Beniers,C,SEA,21,77,14,24,38
3,8477503,Max Domi,C,TOR,28,82,7,31,38
3,8476432,Boone Jenner,C,CBJ,30,66,23,14,37
3,8480014,Gabriel Vilardi,C,WPG,24,61,21,16,37
3,8474150,Mikael Backlund,C,CGY,34,82,15,22,37
3,8474563,Drew Doughty,D,LAK,34,82,14,23,37
3,8481577,Philip Tomasino,C,NSH,22,68,14,23,37
3,8477998,Warren Foegele,L,EDM,27,82,12,25,37
3,8476869,Brady Skjei,D,CAR,29,81,10,27,37
3,8476438,Brandon Saad,L,STL,31,82,21,15,36
3,8478498,Jake DeBrusk,L,BOS,27,80,17,19,36
3,8482092,Ridly Greig,C,OTT,21,72,15,21,36
3,8483515,Juraj Slafkovsky,L,MTL,19,82,14,22,36
3,8482122,Brock Faber,D,MIN,21,82,5,31,36
3,8479410,Mikhail Sergachev,D,TBL,25,60,4,32,36
3,8482089,Jake Neighbours,L,STL,21,82,25,10,35
3,8478474,Lawson Crouse,L,ARI,26,81,22,13,35
3,8475714,Calle Jarnkrok,C,TOR,32,75,20,15,35
3,8477451,Ryan Hartman,R,MIN,29,77,19,16,35
3,8474149,Evgenii Dadonov,R,DAL,34,77,17,18,35
3,8475722,Jason Zucker,L,ARI,31,72,15,20,35
3,8477505,Alex Wennberg,C,SEA,29,82,12,23,35
3,8478055,Gustav Forsling,D,FLA,27,81,10,25,35
3,8477498,Darnell Nurse,D,EDM,28,82,10,25,35
3,8476872,Scott Laughton,C,PHI,29,81,9,26,35
3,8475753,Justin Faulk,D,STL,31,68,3,32,35
3,8477952,Robby Fabbri,C,DET,27,68,20,14,34
3,8482146,Luke Evangelista,R,NSH,21,80,19,15,34
3,8481186,Logan O'Connor,R,COL,27,78,19,15,34
3,8474157,Max Pacioretty,L,WSH,35,47,18,16,34
3,8475191,Reilly Smith,R,PIT,32,76,17,17,34
3,8476925,Colton Sissons,C,NSH,30,82,17,17,34
3,8475768,Jaden Schwartz,C,SEA,31,66,16,18,34
3,8482079,Marco Rossi,C,MIN,22,82,15,19,34
3,8479987,Morgan Geekie,C,BOS,25,76,14,20,34
3,8478466,Daniel Sprong,R,DET,26,54,14,20,34
3,8477407,Anthony Duclair,L,SJS,28,76,13,21,34
3,8475171,Oliver Ekman-Larsson,D,FLA,32,82,12,22,34
3,8473986,Alex Killorn,L,ANA,34,63,10,24,34
3,8477495,Seth Jones,D,CHI,29,67,6,28,34
3,8476902,Esa Lindell,D,DAL,29,82,6,28,34
3,8477450,Jason Dickinson,C,CHI,28,82,21,12,33
3,8481582,Nicholas Robertson,L,TOR,22,64,15,18,33
3,8482062,Cole Smith,L,NSH,28,81,13,20,33
3,8476392,Adam Lowry,C,WPG,30,81,12,21,33
3,8477479,Tyler Bertuzzi,L,TOR,28,81,11,22,33
3,8482113,Anton Lundell,C,FLA,22,78,11,22,33
3,8476292,Ondrej Palat,L,NJD,32,71,11,22,33
3,8477447,Shea Theodore,D,VGK,28,48,9,24,33
3,8476958,Jaccob Slavin,D,CAR,29,81,4,29,33
3,8477969,Marcus Pettersson,D,PIT,27,82,2,31,33
3,8474870,Tyler Johnson,C,CHI,33,67,20,12,32
3,8479591,Michael Eyssimont,C,TBL,27,81,20,12,32
3,8478046,Danton Heinen,L,BOS,28,74,16,16,32
3,8477476,Artturi Lehkonen,L,COL,28,47,15,17,32
3,8480813,Joe Veleno,C,DET,23,80,15,17,32
3,8476921,Jordan Martinook,L,CAR,31,81,14,18,32
3,8478413,Jordan Greenway,L,BUF,26,70,14,18,32
3,8475763,Kevin Hayes,R,STL,31,82,13,19,32
3,8478891,Mason Appleton,C,WPG,27,81,12,20,32
3,8482705,Cole Sillinger,C,CBJ,20,76,12,20,32
3,8480113,Alex Iafallo,L,WPG,30,81,12,20,32
3,8478042,Viktor Arvidsson,R,LAK,30,32,10,22,32
3,8479619,Michael Carcone,L,ARI,27,76,23,8,31
3,8476918,Jimmy Vesey,L,NYR,30,80,22,9,31
3,8478057,Dakota Joshua,C,VAN,27,79,18,13,31
3,8480188,Fabian Zetterlund,L,SJS,24,81,18,13,31
3,8479992,Michael Rasmussen,C,DET,24,82,18,13,31
3,8475314,Anders Lee,L,NYI,33,82,18,13,31
3,8473422,Nick Foligno,L,CHI,36,75,16,15,31
3,8481524,Bowen  Byram,D,COL,22,74,16,15,31
3,8476880,Tom Wilson,R,WSH,29,81,15,16,31
3,8481624,Ilya Mikheyev,R,VAN,29,77,14,17,31
3,8479415,Michael McLeod,C,NJD,25,73,14,17,31
3,8476826,Yanni Gourde,C,SEA,32,80,10,21,31
3,8481560,Arthur Kaliyev,R,LAK,22,68,9,22,31
3,8480817,K'Andre Miller,D,NYR,23,80,8,23,31
3,8478851,Alexandre Carrier,D,NSH,27,77,8,23,31
3,8476927,Teddy Blueger,C,VAN,29,67,6,25,31
3,8476854,Hampus Lindholm,D,BOS,29,82,2,29,31
3,8480459,Pius Suter,C,VAN,27,67,18,12,30
3,8482125,Alexander Holtz,R,NJD,21,81,15,15,30
3,8475793,Ryan Johansen,C,COL,31,82,15,15,30
3,8476981,Josh Anderson,R,MTL,29,78,15,15,30
3,8477429,Andrew Copp,C,DET,29,81,13,17,30
3,8478020,Michael Amadio,R,VGK,27,74,12,18,30
3,8479351,Sam Steel,C,DAL,25,77,10,20,30
3,8478178,Darren Raddysh,D,TBL,27,82,6,24,30
3,8476979,Erik Gustafsson,D,NYR,31,81,4,26,30
3,8480829,Jesperi Kotkaniemi,C,CAR,23,81,16,13,29
3,8478013,Jake Walman,D,DET,27,76,14,15,29
3,8481604,Pavel Dorofeyev,L,VGK,23,57,14,15,29
3,8475220,Marcus Foligno,L,MIN,32,75,12,17,29
3,8481032,Paul Cotter,C,VGK,24,80,12,17,29
3,8475149,Marcus Johansson,L,MIN,33,82,10,19,29
3,8475744,Evgeny Kuznetsov,C,WSH,31,72,8,21,29
3,8480145,Neal Pionk,D,WPG,28,81,7,22,29
3,8478500,Ivan Provorov,D,CBJ,26,81,6,23,29
3,8478507,John Marino,D,NJD,26,81,5,24,29
3,8477986,Brandon Montour,D,FLA,29,66,5,24,29
3,8478469,Thomas Chabot,D,OTT,26,60,4,25,29
3,8482655,J.J. Moser,D,ARI,23,80,4,25,29
3,8480873,Rasmus Sandin,D,WSH,23,74,3,26,29
3,8479941,Justin Danforth,R,CBJ,30,81,14,14,28
3,8471218,Blake Wheeler,R,NYR,37,82,11,17,28
3,8474884,Mike Hoffman,C,SJS,34,79,11,17,28
3,8476474,Stefan Noesen,R,CAR,30,52,11,17,28
3,8478136,Jake Middleton,D,MIN,27,82,10,18,28
3,8480855,Jack McBain,C,ARI,23,67,10,18,28
3,8480336,Sean Walker,D,PHI,29,81,8,20,28
3,8476931,Jake McCabe,D,TOR,30,76,8,20,28
3,8476463,Jonas Brodin,D,MIN,30,64,7,21,28
3,8475218,Mattias Ekholm,D,EDM,33,81,6,22,28
3,8476885,Jacob Trouba,D,NYR,29,80,6,22,28
3,8479983,Mario Ferraro,D,SJS,25,77,5,23,28
3,8482101,Danil Gushchin,L,SJS,21,30,18,9,27
3,8475193,Tomas Tatar,L,SEA,33,78,13,14,27
3,8476374,Sean Kuraly,C,CBJ,30,73,13,14,27
3,8481618,Alex Newhook,C,MTL,22,55,13,14,27
3,8476892,Colton Parayko,D,STL,30,82,11,16,27
3,8482720,Matthew Knies,L,TOR,21,80,11,16,27
3,8482055,Drew O'Connor,L,PIT,25,82,10,17,27
3,8477953,Kasperi Kapanen,R,STL,27,75,10,17,27
3,8474053,Logan Couture,C,SJS,34,34,10,17,27
3,8473533,Jordan Staal,C,CAR,35,81,9,18,27
3,8481546,Cam York,D,PHI,22,81,8,19,27
3,8474574,Tyler Myers,D,VAN,33,81,5,22,27
3,8475181,Nick Leddy,D,STL,32,82,4,23,27
3,8475188,Brayden McNabb,D,VGK,32,81,3,24,27
3,8473449,Kyle Okposo,R,BUF,35,79,15,11,26
3,8475455,Brenden Dillon,D,WPG,33,78,13,13,26
3,8477508,Curtis Lazar,C,NJD,28,76,10,16,26
3,8476329,Travis Boyd,C,ARI,30,45,9,17,26
3,8478133,Jake Evans,C,MTL,27,82,7,19,26
3,8480246,Nick Perbix,D,TBL,25,80,5,21,26
3,8473507,Jeff Petry,D,DET,36,73,4,22,26
3,8476331,Dylan DeMelo,D,WPG,30,81,2,24,26
3,8471698,T.J. Oshie,R,WSH,37,65,17,8,25
3,8482157,Will Cuylle,L,NYR,21,82,16,9,25
3,8477330,Dominik Kubalik,L,OTT,28,78,16,9,25
3,8479339,Patrik Laine,L,CBJ,25,47,15,10,25
3,8478043,Sam Lafferty,C,VAN,28,79,13,12,25
3,8470621,Corey Perry,R,EDM,38,54,12,13,25
3,8480802,Ryan McLeod,C,EDM,24,81,11,14,25
3,8478911,Matt Roy,D,LAK,28,81,7,18,25
3,8474602,Justin Schultz,D,SEA,33,72,6,19,25
3,8482222,Alexander Barabanov,L,SJS,29,61,6,19,25
3,8475200,Dmitry Orlov,D,CAR,32,81,5,20,25
3,8474151,Ryan McDonagh,D,NSH,34,75,4,21,25
3,8482245,Artem Zub,D,OTT,28,72,3,22,25
3,8482671,Owen Power,D,BUF,21,79,2,23,25
3,8481535,Nils Hoglander,L,VAN,23,53,17,7,24
3,8481601,Simon Holmstrom,R,NYI,22,81,15,9,24
3,8479316,Luke Kunin,C,SJS,26,76,13,11,24
3,8474189,Lars Eller,C,PIT,34,82,12,12,24
3,8475343,Nic Dowd,C,WSH,33,73,12,12,24
3,8477425,Miles Wood,L,COL,28,77,11,13,24
3,8480068,Ryan Poehling,C,PHI,24,76,9,15,24
3,8480835,Jack Drury,C,CAR,23,53,8,16,24
3,8481523,Kirby Dach,C,MTL,22,29,7,17,24
3,8471699,Andrew Cogliano,C,COL,36,76,6,18,24
3,8478882,Vladislav Gavrikov,D,LAK,28,77,6,18,24
3,8481580,Connor McMichael,C,WSH,22,80,10,13,23
3,8482097,Jack Quinn,R,BUF,22,45,10,13,23
3,8476312,Josh Manson,D,COL,32,77,9,14,23
3,8482111,Justin Barron,D,MTL,22,68,9,14,23
3,8480078,Filip Chytil,C,NYR,24,38,8,15,23
3,8478443,Brandon Carlo,D,BOS,27,77,7,16,23
3,8476457,Adam Larsson,D,SEA,31,82,6,17,23
3,8477839,Conor Sheary,L,TBL,31,64,6,17,23
3,8480878,Nils Lundkvist,D,DAL,23,70,4,19,23
3,8479976,Juuso Valimaki,D,ARI,25,68,4,19,23
3,8478840,Will Borgen,D,SEA,27,82,2,21,23
3,8475231,Casey Cizikas,C,NYI,32,71,12,10,22
3,8480185,Eetu Luostarinen,C,FLA,25,82,11,11,22
3,8479661,Tanner Jeannot,L,TBL,26,68,11,11,22
3,8476897,Oskar Sundqvist,C,STL,29,82,8,14,22
3,8476422,Mike Reilly,D,NYI,30,61,7,15,22
3,8481596,Shane Pinto,C,OTT,23,41,7,15,22
3,8477932,Aaron Ekblad,D,FLA,27,64,5,17,22
3,8482073,Braden Schneider,D,NYR,22,82,5,17,22
3,8478458,Jack Roslovic,C,CBJ,26,58,3,19,22
3,8475197,Tyson Barrie,D,NSH,32,62,3,19,22
3,8480043,Timothy Liljegren,D,TOR,24,65,2,20,22
3,8482699,Dylan Guenther,R,ARI,20,45,13,8,21
3,8474040,Sam Gagner,C,EDM,34,55,10,11,21
3,8481533,Trevor Zegras,C,ANA,22,48,8,13,21
3,8475791,Taylor Hall,L,CHI,32,37,8,13,21
3,8478115,Pierre Engvall,L,NYI,27,76,8,13,21
3,8475208,Brian Dumoulin,D,SEA,32,80,7,14,21
3,8476923,Damon Severson,D,CBJ,29,66,6,15,21
3,8480220,Noah Cates,L,PHI,24,59,5,16,21
3,8481656,Aliaksei Protas,C,WSH,22,52,4,17,21
3,8479998,Mikey Anderson,D,LAK,24,82,2,19,21
3,8480281,Alexey Toropchenko,R,STL,24,82,12,8,20
3,8473453,Trevor Lewis,C,LAK,36,82,9,11,20
3,8475164,Jakob Silfverberg,R,ANA,33,81,5,15,20
3,8478859,Niko Mikkola,D,FLA,27,82,5,15,20
3,8480049,Dylan Samberg,D,WPG,24,81,4,16,20
3,8475790,Erik Gudbranson,D,CBJ,31,77,4,16,20
3,8470600,Ryan Suter,D,DAL,38,82,1,19,20
3,8475179,Dmitry Kulikov,D,FLA,33,78,0,20,20
3,8478109,Victor Olofsson,L,BUF,28,63,9,10,19
3,8475462,Radko Gudas,D,ANA,33,76,8,11,19
3,8479393,Noah Gregor,C,TOR,25,81,8,11,19
3,8482087,Kaiden Guhle,D,MTL,21,78,6,13,19
3,8475279,Ben Chiarot,D,DET,32,77,4,15,19
3,8477444,Andre Burakovsky,L,SEA,28,51,3,16,19
3,8479980,Nicolas Hague,D,VGK,25,73,3,16,19
3,8476879,Cody Ceci,D,EDM,30,82,1,18,19
3,8480860,Kevin Bahl,D,NJD,23,81,1,18,19
3,8478831,Kevin Stenlund,C,FLA,27,82,13,5,18
3,8476469,Joel Armia,R,MTL,30,66,13,5,18
3,8481554,Kaapo Kakko,R,NYR,22,61,11,7,18
3,8470604,Jeff Carter,C,PIT,38,76,9,9,18
3,8477947,Sonny Milano,L,WSH,27,53,8,10,18
3,8477989,Christian Dvorak,C,MTL,27,52,8,10,18
3,8478463,Anthony Beauvillier,L,CHI,26,64,6,12,18
3,8479353,Brett Howden,C,VGK,25,79,6,12,18
3,8475233,David Savard,D,MTL,33,60,6,12,18
3,8481014,Alexander Romanov,D,NYI,23,81,6,12,18
3,8477506,Ryan Pulock,D,NYI,29,58,6,12,18
3,8477950,Tony DeAngelo,D,CAR,28,51,5,13,18
3,8481522,Peyton Krebs,C,BUF,22,80,5,13,18
3,8480172,Jan Rutta,D,SJS,33,75,3,15,18
3,8474673,TJ Brodie,D,TOR,33,81,0,18,18
3,8479977,Kailer Yamamoto,R,SEA,25,73,10,7,17
3,8481704,Juuso Parssinen,C,NSH,22,71,10,7,17
3,8481481,Blake Lizotte,C,LAK,26,64,9,8,17
3,8480821,Filip Zadina,R,SJS,24,48,7,10,17
3,8482117,Lukas Reichel,L,CHI,21,77,6,11,17
3,8477435,Ryan Graves,D,PIT,28,82,6,11,17
3,8476889,Radek Faksa,C,DAL,29,74,6,11,17
3,8477919,Frederick Gaudreau,C,MIN,30,70,5,12,17
3,8479346,Dillon Dube,C,CGY,25,70,4,13,17
3,8477507,Nikita Zadorov,D,VAN,28,75,3,14,17
3,8475825,Jani Hakanpää,D,DAL,31,82,3,14,17
3,8474161,Jakub Voracek,R,CBJ,34,29,2,15,17
3,8478416,Erik Cernak,D,TBL,26,71,2,15,17
3,8478399,Jonas Siegenthaler,D,NJD,26,66,1,16,17
3,8477944,Jakub Vrana,L,STL,27,49,8,8,16
3,8475848,Brendan Gallagher,R,MTL,31,50,8,8,16
3,8479359,Beck Malenstyn,L,WSH,25,81,6,10,16
3,8474166,Alec Martinez,D,VGK,36,64,6,10,16
3,8482142,Jamie Drysdale,D,PHI,21,49,6,10,16
3,8482660,Kent Johnson,C,CBJ,21,36,6,10,16
3,8476525,Colin Miller,D,NJD,31,61,6,10,16
3,8476858,Phillip Di Giuseppe,L,VAN,30,62,5,11,16
3,8479996,Cody Glass,C,NSH,24,54,5,11,16
3,8474034,Pat Maroon,L,MIN,35,49,4,12,16
3,8474567,Zach Bogosian,D,MIN,33,70,1,15,16
3,8475690,Chris Tanev,D,CGY,34,79,1,15,16
3,8480994,Damien Giroux,C,MIN,23,28,1,15,16
3,8481606,Jordan Spence,D,LAK,22,44,0,16,16
3,8480144,David Kampf,C,TOR,28,78,8,7,15
3,8478468,Jeremy Lauzon,D,NSH,26,82,8,7,15
3,8479390,Taylor Raddysh,R,CHI,25,77,7,8,15
3,8477987,Ryan Donato,C,CHI,27,51,6,9,15
3,8481093,Rafael Harvey-Pinard,L,MTL,24,51,6,9,15
3,8481178,Egor Zamula,D,PHI,23,44,5,10,15
3,8474683,Derek Grant,C,ANA,33,28,5,10,15
3,8473563,Nicklas Backstrom,C,WSH,36,37,4,11,15
3,8476473,Connor Murphy,D,CHI,30,70,4,11,15
3,8477220,Nate Schmidt,D,WPG,32,75,4,11,15
3,8481568,Alex Vlasic,D,CHI,22,76,2,13,15
3,8480796,Martin Fehervary,D,WSH,24,76,2,13,15
3,8475906,John Klingberg,D,TOR,31,43,1,14,15
3,8477845,Trevor van Riemsdyk,D,WSH,32,70,0,15,15
3,8481690,Tyler Angle,C,CBJ,23,29,13,1,14
3,8475855,Jesper Fast,R,CAR,32,78,7,7,14
3,8480849,Barrett Hayton,C,ARI,23,50,7,7,14
3,8479293,Brandon Tanev,L,SEA,32,66,6,8,14
3,8474009,Nick Bonino,C,NYR,35,73,6,8,14
3,8473604,Jonathan Toews,C,CHI,35,27,6,8,14
3,8480035,Henri Jokiharju,D,BUF,24,74,5,9,14
3,8474031,Kevin Shattenkirk,D,BOS,34,44,5,9,14
3,8478970,Jalen Chatfield,D,CAR,27,48,5,9,14
3,8477979,Nicolas Aube-Kubel,R,WSH,27,39,5,9,14
3,8473504,Cal Clutterbuck,R,NYI,36,53,4,10,14
3,8477380,Jonny Brodzinski,C,NYR,30,35,4,10,14
3,8480762,Eric Robinson,L,BUF,28,54,4,10,14
3,8476967,Brett Kulak,D,EDM,29,82,3,11,14
3,8476624,Barclay Goodrow,C,NYR,30,80,2,12,14
3,8480727,Zach Whitecloud,D,VGK,27,65,2,12,14
3,8481605,Jackson LaCombe,D,ANA,22,76,1,13,14
3,8476941,Connor Carrick,D,BOS,29,27,1,13,14
3,8478508,Yakov Trenin,C,NSH,26,79,9,4,13
3,8480289,Morgan Barron,C,WPG,25,51,9,4,13
3,8473544,Derick Brassard,C,OTT,36,31,8,5,13
3,8481013,Jonatan Berggren,R,DET,23,37,7,6,13
3,8477446,Michael McCarron,R,NSH,28,43,7,6,13
3,8482259,Bobby McMann,C,TOR,27,29,7,6,13
3,8480448,Parker Kelly,L,OTT,24,51,6,7,13
3,8480848,Ty Dellandrea,C,DAL,23,53,5,8,13
3,8481592,Jakob Pelletier,L,CGY,22,31,5,8,13
3,8474612,Travis Hamonic,D,OTT,33,75,4,9,13
3,8476410,Josh Leivo,L,STL,30,28,4,9,13
3,8480001,Urho Vaakanainen,D,ANA,24,74,2,11,13
3,8471677,Jack Johnson,D,COL,36,80,2,11,13
3,8475324,Nick Jensen,D,WSH,33,82,1,12,13
3,8477365,Connor Clifton,D,BUF,28,79,0,13,13
3,8479336,Carl Grundstrom,R,LAK,26,50,8,4,12
3,8478569,Noel Acciari,C,PIT,32,70,8,4,12
3,8481517,Brett Leason,R,ANA,24,43,6,6,12
3,8476856,Matt Dumba,D,ARI,29,78,6,6,12
3,8478131,Ondrej Kase,R,CAR,28,28,5,7,12
3,8480748,Kiefer Sherwood,L,NSH,28,41,5,7,12
3,8482712,Oskar Olausson,R,COL,21,28,5,7,12
3,8475177,Calvin de Haan,D,TBL,32,72,4,8,12
3,8480891,Michael Kesselring,D,ARI,23,36,4,8,12
3,8482730,Brandt Clarke,D,LAK,20,38,4,8,12
3,8482516,Matthew Kessel,D,STL,23,47,4,8,12
3,8480073,Erik Brannstrom,D,OTT,24,45,3,9,12
3,8479324,Ryan Lindgren,D,NYR,25,80,2,10,12
3,8476874,Olli Maatta,D,DET,29,46,2,10,12
3,8478432,Christian Fischer,R,DET,26,51,2,10,12
3,8477335,Kyle Burroughs,D,SJS,28,74,2,10,12
3,8480884,Calen Addison,D,SJS,23,45,1,11,12
3,8471274,Alex Goligoski,D,MIN,38,58,0,12,12
3,8476822,Luke Glendening,C,TBL,34,82,10,1,11
3,8477903,Garnet Hathaway,R,PHI,32,81,7,4,11
3,8475225,Craig Smith,C,DAL,34,50,7,4,11
3,8479322,Wade Allison,R,PHI,26,26,6,5,11
3,8480806,Isac Lundestrom,C,ANA,24,46,6,5,11
3,8478870,Rudolfs Balcers,L,TBL,26,26,6,5,11
3,8477488,Brett Pesce,D,CAR,29,71,5,6,11
3,8475461,Andrew Agozzino,L,SJS,32,28,5,6,11
3,8480205,Emil Bemstrom,R,CBJ,24,31,5,6,11
3,8478585,Derek Ryan,C,EDM,37,51,5,6,11
3,8470638,Patrice Bergeron,C,BOS,38,27,4,7,11
3,8481567,Henry Thrun,D,SJS,22,51,4,7,11
3,8480879,Jacob Bernard-Docker,D,OTT,23,42,4,7,11
3,8477941,Nick Ritchie,L,CGY,28,27,4,7,11
3,8476442,Matt Nieto,L,PIT,31,53,4,7,11
3,8471276,David Krejci,C,BOS,37,27,3,8,11
3,8476467,Jamie Oleksiak,D,SEA,31,82,2,9,11
3,8474716,Jared Spurgeon,D,MIN,34,44,2,9,11
3,8474162,Jake Muzzin,D,TOR,34,29,2,9,11
3,8476960,Andreas Athanasiou,C,CHI,29,38,1,10,11
3,8482192,Isaak Phillips,D,CHI,22,56,1,10,11
3,8480807,Mattias Samuelsson,D,BUF,23,69,1,10,11
3,8476429,Scott Mayfield,D,NYI,31,67,1,10,11
3,8480192,Johnathan Kovacevic,D,MTL,26,74,8,2,10
3,8475842,Sam Carrick,C,ANA,31,54,7,3,10
3,8480980,Connor Dewar,C,MIN,24,48,7,3,10
3,8478421,A.J. Greer,L,CGY,27,47,6,4,10
3,8473548,Phil Kessel,R,VGK,36,28,5,5,10
3,8471669,Paul Stastny,C,CAR,38,28,5,5,10
3,8474573,Josh Bailey,R,NYI,34,29,4,6,10
3,8476871,Tanner Pearson,L,MTL,31,36,4,6,10
3,8478434,Keegan Kolesar,R,VGK,26,50,4,6,10
3,8479414,Nathan Bastian,R,NJD,26,51,3,7,10
3,8479543,Michael Pezzetta,L,MTL,25,44,3,7,10
3,8479371,Dante Fabbro,D,NSH,25,42,2,8,10
3,8480883,Ty Smith,D,PIT,23,31,1,9,10
3,8480887,Jordan Harris,D,MTL,23,58,1,9,10
3,8477406,Mattias Janmark,C,EDM,31,71,1,9,10
3,8475718,Justin Holl,D,DET,31,63,0,10,10
3,8476917,Adam Pelech,D,NYI,29,58,0,10,10
3,8470610,Zach Parise,L,COL,39,33,6,3,9
3,8479718,Alex Barré-Boulet,C,TBL,26,35,6,3,9
3,8477353,Tyler Motte,C,TBL,28,72,5,4,9
3,8479383,Boris Katchouk,L,CHI,25,35,5,4,9
3,8479328,Julien Gauthier,R,NYI,26,27,5,4,9
3,8481754,Nikita Nesterenko,C,ANA,22,28,5,4,9
3,8480031,Max Comtois,L,ANA,24,28,4,5,9
3,8476393,Nick Cousins,C,FLA,30,70,4,5,9
3,8482679,Matt Coronato,R,CGY,21,42,4,5,9
3,8479402,Jake Bean,D,CBJ,25,49,4,5,9
3,8476915,Jujhar Khaira,L,MIN,29,29,3,6,9
3,8477846,Ryan Carpenter,C,SJS,32,36,3,6,9
3,8480008,Adam Ruzicka,C,ARI,24,41,3,6,9
3,8478028,Fredrik Olofsson,L,COL,27,53,3,6,9
3,8477499,Rasmus Ristolainen,D,PHI,29,57,2,7,9
3,8474013,Ian Cole,D,VAN,34,80,2,7,9
3,8479315,Joey Anderson,R,CHI,25,28,2,7,9
3,8481527,Kaedan Korczak,D,VGK,22,26,1,8,9
3,8477018,Ben Hutton,D,VGK,30,31,1,8,9
3,8483460,David Jiricek,D,CBJ,20,36,1,8,9
3,8476372,Nick Seeler,D,PHI,30,55,0,9,9
3,8479580,Dylan Gambrell,C,OTT,27,31,6,2,8
3,8479344,Jesse Puljujarvi,R,PIT,25,36,5,3,8
3,8470595,Eric Staal,C,FLA,39,27,5,3,8
3,8480252,Cole Guttman,C,CHI,24,27,4,4,8
3,8479368,Max Jones,L,ANA,25,38,4,4,8
3,8481617,Vasily Podkolzin,R,VAN,22,26,4,4,8
3,8477454,Adam Erne,L,EDM,28,54,3,5,8
3,8481477,Nico Sturm,C,SJS,28,34,3,5,8
3,8477392,Hudson Fasching,R,NYI,28,35,3,5,8
3,8477070,Liam O'Brien,C,ARI,29,49,3,5,8
3,8480913,Jordan Gross,D,NSH,28,27,2,6,8
3,8480995,Pontus Holmberg,R,TOR,24,27,2,6,8
3,8479576,Vincent Desharnais,D,EDM,27,49,1,7,8
3,8477971,Andreas Englund,D,LAK,27,52,1,7,8
3,8475762,Derek Forbort,D,BOS,31,57,1,7,8
3,8479439,Jacob MacDonald,D,SJS,30,21,6,1,7
3,8471709,Marc-Edouard Vlasic,D,SJS,36,31,5,2,7
3,8477478,William Carrier,L,VGK,29,33,5,2,7
3,8477573,Nathan Walker,L,STL,29,18,5,2,7
3,8482241,Radim Zohorna,L,PIT,27,31,4,3,7
3,8481058,Jesse Ylönen,R,MTL,24,43,3,4,7
3,8476891,Matt Grzelcyk,D,BOS,29,41,2,5,7
3,8479458,Nikita Zaitsev,D,CHI,32,26,2,5,7
3,8477541,Dakota Mermis,D,MIN,29,37,2,5,7
3,8478099,Kevin Labanc,R,SJS,28,32,2,5,7
3,8481641,Joel Kiviranta,L,COL,27,40,2,5,7
3,8480880,Jakub Lauko,C,BOS,23,40,2,5,7
3,8471303,Alexander Edler,D,LAK,37,30,1,6,7
3,8470966,Mark Giordano,D,TOR,40,36,1,6,7
3,8481537,Nikita Okhotiuk,D,SJS,23,38,1,6,7
3,8478502,Dennis Gilbert,D,CGY,27,31,1,6,7
3,8478104,Sammy Blais,L,STL,27,43,1,6,7
3,8476310,Lukas Sedlak,C,PHI,30,26,1,6,7
3,8479348,Kale Clague,D,BUF,25,28,1,6,7
3,8480871,Adam Boqvist,D,CBJ,23,22,0,7,7
3,8481812,Nikolai Knyzhov,D,SJS,26,38,0,7,7
3,8480072,Lias Andersson,C,LAK,25,30,6,0,6
3,8479520,Brandon Duhaime,R,MIN,26,54,4,2,6
3,8479066,Ryan Lomberg,L,FLA,29,55,4,2,6
3,8478495,Denis Gurianov,R,NSH,26,40,3,3,6
3,8476278,Colin Blackwell,C,CHI,30,25,3,3,6
3,8479968,Vinni Lettieri,C,MIN,28,24,3,3,6
3,8471873,Anton Stralman,D,BOS,37,27,3,3,6
3,8476441,Joel Edmundson,D,WSH,30,66,2,4,6
3,8477015,Connor Brown,R,EDM,29,75,2,4,6
3,8480058,Pierre-Olivier Joseph,D,PIT,24,53,2,4,6
3,8477369,Carson Soucy,D,VAN,29,21,2,4,6
3,8482496,Nils Aman,C,VAN,23,31,2,4,6
3,8480789,Oliver Wahlstrom,R,NYI,23,27,2,4,6
3,8480242,Arnaud Durandeau,L,NYI,24,29,2,4,6
3,8480874,Adam Ginning,D,PHI,23,26,2,4,6
3,8477931,Tomas Nosek,L,NJD,31,40,2,4,6
3,8479442,Troy Stecher,D,ARI,29,71,1,5,6
3,8480222,Sebastian Aho,D,NYI,27,41,1,5,6
3,8474568,Luke Schenn,D,NSH,34,36,1,5,6
3,8479982,Conor Timmins,D,TOR,25,16,1,5,6
3,8476988,Matt Benning,D,SJS,29,42,1,5,6
3,8480831,Alec Regula,D,CHI,23,27,1,5,6
3,8476449,Scott Harrington,D,ANA,30,28,1,5,6
3,8480950,Ilya Lyubushkin,D,ANA,29,79,0,6,6
3,8479369,Andrew Peeke,D,CBJ,25,20,0,6,6
3,8475797,Jarred Tinordi,D,CHI,31,32,0,6,6
3,8479372,Josh Mahura,D,FLA,25,20,0,6,6
3,8477930,Pierre-Edouard Bellemare,L,SEA,38,29,4,1,5
3,8483641,Anton Levtchi,L,FLA,28,27,4,1,5
3,8482451,Mikael Pyyhtia,L,CBJ,22,29,3,2,5
3,8480184,Gustav Lindström,D,ANA,25,22,3,2,5
3,8479291,Kevin Rooney,C,CGY,30,33,3,2,5
3,8481167,Brayden Pachal,D,CGY,24,50,2,3,5
3,8478408,Travis Dermott,D,ARI,27,37,2,3,5
3,8482964,Arber Xhekaj,D,MTL,22,24,2,3,5
3,8475750,Jon Merrill,D,MIN,31,38,2,3,5
3,8474618,Marco Scandella,D,STL,33,49,2,3,5
3,8480025,MacKenzie Entwistle,R,CHI,24,46,2,3,5
3,8479536,Axel Jonsson-Fjallby,L,WPG,25,26,2,3,5
3,8483464,Marco Kasper,C,DET,19,28,2,3,5
3,8474090,Brendan Smith,D,NJD,34,36,1,4,5
3,8477384,Josh Brown,D,ARI,29,28,1,4,5
3,8481708,Zac Jones,D,NYR,23,17,1,4,5
3,8480084,Nick DeSimone,D,NJD,29,23,1,4,5
3,8479671,Mathieu Olivier,R,CBJ,26,25,1,4,5
3,8479547,Matthew Phillips,R,PIT,25,27,1,4,5
3,8476919,Chris Tierney,C,NJD,29,28,1,4,5
3,8476952,Dominic Toninato,C,WPG,29,15,1,4,5
3,8482652,Walker Duehr,R,CGY,26,26,1,4,5
3,8482452,Elliot Desnoyers,L,PHI,21,26,1,4,5
3,8475747,Patrik Nemeth,D,ARI,31,29,0,5,5
3,8477482,Zach Sanford,L,CHI,29,26,0,5,5
3,8476878,Zemgus Girgensons,L,BUF,29,36,4,0,4
3,8482077,Dylan Holloway,L,EDM,22,23,3,1,4
3,8480011,Klim Kostin,C,DET,24,32,3,1,4
3,8482711,Stanislav Svozil,D,CBJ,20,29,2,2,4
3,8479370,Tyson Jost,C,BUF,25,29,2,2,4
3,8481019,David Gustafsson,C,WPG,23,27,2,2,4
3,8479981,Jonah Gadjovich,L,FLA,25,27,2,2,4
3,8480901,Karson Kuhlman,C,WPG,28,30,2,2,4
3,8474207,Nick Holden,D,OTT,36,31,1,3,4
3,8477938,Haydn Fleury,D,TBL,27,16,1,3,4
3,8480003,Jesper Boqvist,C,BOS,25,20,1,3,4
3,8479994,Jaret Anderson-Dolan,C,LAK,24,24,1,3,4
3,8475752,Tyler Pitlick,C,NYR,32,34,1,3,4
3,8476913,Devin Shore,C,SEA,29,21,1,3,4
3,8477851,Jordan Oesterle,D,CGY,31,48,0,4,4
3,8482176,Wyatt Kaiser,D,CHI,21,23,0,4,4
3,8478452,Caleb Jones,D,COL,26,20,0,4,4
3,8478454,Noah Juulsen,D,VAN,26,38,0,4,4
3,8478424,Jansen Harkins,C,PIT,26,34,0,4,4
3,8473446,Erik Johnson,D,BUF,35,46,3,0,3
3,8482081,Sean Farrell,C,MTL,22,27,2,1,3
3,8475780,Chris Wagner,R,BOS,32,27,2,1,3
3,8481147,Reese Johnson,C,CHI,25,34,2,1,3
3,8478078,Rourke Chartier,C,OTT,27,34,2,1,3
3,8474709,Matt Martin,L,NYI,34,31,2,1,3
3,8479772,Zack MacEwen,R,OTT,27,22,2,1,3
3,8477962,Brendan Lemieux,L,CAR,27,23,2,1,3
3,8475766,Austin Watson,L,TBL,31,28,2,1,3
3,8480468,James Hamblin,L,EDM,24,31,2,1,3
3,8480355,Mark Kastelic,C,OTT,24,34,2,1,3
3,8480328,David Gust,R,CHI,29,27,1,2,3
3,8482448,Samuel Knazko,D,CBJ,21,29,1,2,3
3,8481122,Simon Benoit,D,TOR,25,39,1,2,3
3,8478451,Ethan Bear,D,WSH,26,16,1,2,3
3,8471686,Marc Staal,D,PHI,36,20,1,2,3
3,8477244,Chad Ruhwedel,D,PIT,33,37,1,2,3
3,8481541,Samuel Bolduc,D,NYI,23,33,1,2,3
3,8476934,Brock McGinn,L,ANA,29,24,1,2,3
3,8476994,Vinnie Hinostroza,C,PIT,29,14,1,2,3
3,8480007,Jonas Rondbjerg,R,VGK,24,17,1,2,3
3,8476867,Brendan Gaunce,C,CBJ,29,8,1,2,3
3,8478904,Steven Lorentz,C,FLA,27,28,1,2,3
3,8479379,Givani Smith,R,SJS,25,26,1,2,3
3,8482181,Tristen Robins,C,SJS,22,28,1,2,3
3,8477034,Jaycob Megna,D,CHI,31,45,0,3,3
3,8479514,Rem Pitlick,C,CHI,26,36,0,3,3
3,8483424,Owen Beck,C,MTL,19,27,0,3,3
3,8478450,Parker Wotherspoon,D,BOS,26,23,0,3,3
3,8477810,Joel Hanley,D,DAL,32,26,0,3,3
3,8480853,Liam Foudy,C,NSH,23,13,0,3,3
3,8475235,Nicolas Deslauriers,L,PHI,32,47,0,3,3
3,8480776,Sheldon Rempal,R,VGK,28,5,2,0,2
3,8471817,Ryan Reaves,R,TOR,36,27,2,0,2
3,8477073,Kurtis MacDermid,D,COL,29,28,2,0,2
3,8482207,William Dufour,R,NYI,21,29,1,1,2
3,8480041,Dmitri Samorukov,D,STL,24,28,1,1,2
3,8482133,Thomas Bordeleau,C,SJS,21,6,1,1,2
3,8481006,Tyler Tucker,D,STL,23,16,1,1,2
3,8479362,Riley Tufte,L,COL,25,5,1,1,2
3,8478051,Max Willman,C,NJD,28,13,1,1,2
3,8481532,Alex Turcotte,C,LAK,22,6,1,1,2
3,8474218,Jason Demers,D,EDM,35,31,0,2,2
3,8480070,Ian Mitchell,D,BOS,24,13,0,2,2
3,8480196,Jacob Bryson,D,BUF,26,8,0,2,2
3,8480870,Bo Groulx,C,ANA,23,32,0,2,2
3,8473473,Milan Lucic,L,BOS,35,4,0,2,2
3,8477464,Nic Petan,C,MIN,28,6,0,2,2
3,8477527,Ross Johnston,L,ANA,29,41,0,2,2
3,8481043,Cole Koepke,L,TBL,25,8,0,2,2
3,8480977,Semyon Der-Arguchintsev,C,TOR,23,29,1,0,1
3,8481056,Spencer Stastney,D,NSH,23,9,1,0,1
3,8480823,Alexander Alexeyev,D,WSH,24,13,1,0,1
3,8476873,Mark Jankowski,C,NSH,29,5,1,0,1
3,8480021,Jack Studnicka,C,SJS,24,14,1,0,1
3,8478409,Anthony Richard,C,BOS,27,4,1,0,1
3,8483570,Ben Meyers,C,COL,25,9,1,0,1
3,8481422,Jacob Lucchini,C,MIN,28,13,1,0,1
3,8479546,Oskar Steen,C,BOS,25,34,1,0,1
3,8481239,Samuel Fagemo,L,LAK,23,8,1,0,1
3,8477359,Tucker Poolman,D,VAN,30,26,0,1,1
3,8482762,Simon Edvinsson,D,DET,20,2,0,1,1
3,8481161,Jake Christiansen,D,CBJ,24,3,0,1,1
3,8480157,Calle Rosen,D,STL,29,5,0,1,1
3,8479984,Cal Foote,D,NJD,25,4,0,1,1
3,8479321,Lucas Johansen,D,WSH,26,6,0,1,1
3,8479378,Logan Stanley,D,WPG,25,10,0,1,1
3,8478017,Mark Friedman,D,VAN,28,20,0,1,1
3,8482095,Tyler Kleven,D,OTT,21,5,0,1,1
3,8479320,Max Lajoie,D,TOR,26,5,0,1,1
3,8477887,Patrick Brown,C,BOS,31,11,0,1,1
3,8480245,Olle Lycksell,R,PHI,24,5,0,1,1
3,8478146,Matthew Highmore,C,OTT,27,6,0,1,1
3,8480845,Rasmus Kupari,C,WPG,23,21,0,1,1
3,8478512,Austin Czarnik,C,DET,31,18,0,1,1
3,8479367,William Lockwood,R,FLA,25,23,0,1,1
3,8481543,Nikita Alexandrov,C,STL,23,18,0,1,1
3,8483597,Milos Kelemen,L,ARI,24,10,0,1,1
3,8480275,Nick Swaney,R,MIN,26,28,0,0,0
3,8483565,Nick Blankenburg,D,CBJ,25,6,0,0,0
3,8483620,Marcus Bjork,D,CBJ,26,0,0,0,0
3,8481521,Ronnie Attard,D,PHI,24,0,0,0,0
3,8482399,Billy Sweezey,D,CBJ,27,0,0,0,0
3,8481072,Tim Berni,D,CBJ,23,0,0,0,0
3,8476884,Derrick Pouliot,D,SJS,29,0,0,0,0
3,8482624,Daniil Miromanov,D,VGK,26,2,0,0,0
3,8482861,Vincent Iorio,D,WSH,21,0,0,0,0
3,8478465,Guillaume Brisebois,D,VAN,26,0,0,0,0
3,8484256,Jake Livingstone,D,NSH,24,0,0,0,0
3,8481599,Victor Soderstrom,D,ARI,22,1,0,0,0
3,8474027,Justin Braun,D,PHI,36,0,0,0,0
3,8478062,Dysin Mayo,D,ARI,27,0,0,0,0
3,8481563,Drew Helleson,D,ANA,22,0,0,0,0
3,8481575,Lassi Thomson,D,OTT,23,0,0,0,0
3,8483619,Filip Roos,D,CHI,24,4,0,0,0
3,8481461,Corey Schueneman,D,MTL,28,0,0,0,0
3,8478846,Christian Wolanin,D,VAN,28,0,0,0,0
3,8479395,Dennis Cholowski,D,NYI,25,0,0,0,0
3,8479945,Gavin Bayreuther,D,CBJ,29,0,0,0,0
3,8474818,Jordie Benn,D,TOR,36,0,0,0,0
3,8479421,Jacob Moverare,D,LAK,25,5,0,0,0
3,8479329,Frederic Allard,D,MTL,26,0,0,0,0
3,8481600,Tobias Bjornfot,D,VGK,22,3,0,0,0
3,8477462,Robert Hagg,D,ANA,28,5,0,0,0
3,8476470,Nathan Beaulieu,D,ANA,31,0,0,0,0
3,8484254,Akito Hirose,D,VAN,24,3,0,0,0
3,8479388,Riley Stillman,D,BUF,25,0,0,0,0
3,8482824,Nick Cicek,D,SJS,23,0,0,0,0
3,8480056,Jack Rathbone,D,VAN,24,0,0,0,0
3,8476850,Ryan Murray,D,EDM,30,0,0,0,0
3,8478841,Colton White,D,ANA,26,0,0,0,0
3,8480160,Radim Simek,D,SJS,31,0,0,0,0
3,8478491,Jacob Larsson,D,OTT,26,0,0,0,0
3,8475857,Kevin Gravel,D,NSH,31,0,0,0,0
3,8482067,Connor Mackey,D,NYR,27,1,0,0,0
3,8477433,Ben Harpur,D,NYR,28,0,0,0,0
3,8481572,Ville Heinola,D,WPG,22,0,0,0,0
3,8478415,Jakub Zboril,D,BOS,26,0,0,0,0
3,8477341,Andreas Johnsson,L,SJS,29,0,0,0,0
3,8480216,Jacob Peterson,C,SJS,24,6,0,0,0
3,8477467,Gustav Olofsson,D,SEA,29,0,0,0,0
3,8478476,Kyle Capobianco,D,WPG,26,0,0,0,0
3,8479985,Cale Fleury,D,SEA,25,0,0,0,0
3,8475227,Chris Wideman,D,MTL,33,0,0,0,0
3,8479333,Libor Hajek,D,NYR,25,0,0,0,0
3,8479376,Victor Mete,D,PHI,25,1,0,0,0
3,8480439,Mac Hollowell,D,TOR,25,0,0,0,0
3,8480467,Austin Strand,D,ANA,26,0,0,0,0
3,8477981,Roland McKeown,D,NSH,27,0,0,0,0
3,8474628,Michael Stone,D,CGY,33,0,0,0,0
3,8480034,Joel Teasdale,L,MTL,24,0,0,0,0
3,8481609,Vladislav Kolyachonok,D,ARI,22,1,0,0,0
3,8479602,Jeremy Davies,D,BUF,27,0,0,0,0
3,8479639,Dylan Coghlan,D,CAR,25,0,0,0,0
3,8478506,Gabriel Carlsson,D,WSH,26,0,0,0,0
3,8477463,Steven Santini,D,STL,28,0,0,0,0
3,8478075,Anders Bjork,L,CHI,27,0,0,0,0
3,8484287,Cole McWard,D,VAN,22,1,0,0,0
3,8474145,Robert Bortuzzo,D,NYI,34,15,0,0,0
3,8475625,Matt Irwin,D,WSH,36,0,0,0,0
3,8482179,Justin Richards,C,CBJ,25,0,0,0,0
3,8481649,Joona Luoto,L,CBJ,26,0,0,0,0
3,8479026,Philippe Myers,D,TBL,26,5,0,0,0
3,8480935,Lawrence Pilut,D,BUF,28,0,0,0,0
3,8479578,Casey Fitzgerald,D,FLA,26,0,0,0,0
3,8480071,Robin Salo,D,NYI,25,0,0,0,0
3,8478224,Luke Philp,C,CHI,28,0,0,0,0
3,8484125,Hunter McKown,C,CBJ,21,0,0,0,0
3,8481679,Maxence Guenette,D,OTT,22,1,0,0,0
3,8479423,Alex Nylander,L,PIT,25,5,0,0,0
3,8480441,Trey Fix-Wolansky,R,CBJ,24,1,0,0,0
3,8480820,Filip Kral,D,TOR,24,0,0,0,0
3,8479523,Lucas Carlsson,D,FLA,26,0,0,0,0
3,8479304,Kyle Criscuolo,C,SJS,31,0,0,0,0
3,8474697,Mark Borowiecki,D,NSH,34,0,0,0,0
3,8480842,Filip Hallander,C,PIT,23,0,0,0,0
3,8481725,Elmer Soderblom,L,DET,22,0,0,0,0
3,8479252,Dan Renouf,D,BOS,29,0,0,0,0
3,8481591,Sam Poulin,R,PIT,22,0,0,0,0
3,8475968,Alex Belzile,R,MTL,32,0,0,0,0
3,8475772,Riley Sheahan,C,BUF,32,0,0,0,0
3,8475163,Alex Chiasson,R,DET,33,0,0,0,0
3,8481598,Philip Broberg,D,EDM,22,10,0,0,0
3,8478455,Austin Wagner,L,CHI,26,0,0,0,0
3,8476779,Brad Hunt,D,COL,35,0,0,0,0
3,8479335,Rasmus Asplund,C,NSH,26,0,0,0,0
3,8478967,Lane Pederson,C,CBJ,26,0,0,0,0
3,8481077,John Leonard,L,NSH,25,0,0,0,0
3,8481585,Egor Afanasyev,L,NSH,22,2,0,0,0
3,8483397,Marc McLaughlin,C,BOS,24,0,0,0,0
3,8480443,Kristian Reichel,C,WPG,25,0,0,0,0
3,8481751,Lukas Rousek,R,BUF,24,5,0,0,0
3,8476396,Steven Fogarty,C,MIN,30,0,0,0,0
3,8478881,Brett Seney,L,CHI,27,4,0,0,0
3,8480326,Sheldon Dries,C,VAN,29,0,0,0,0
3,8481433,Taro Hirose,L,DET,27,0,0,0,0
3,8480833,Vitali Kravtsov,R,VAN,24,0,0,0,0
3,8481550,Adam Beckman,L,MIN,22,0,0,0,0
3,8479972,Mason Shaw,C,MIN,25,0,0,0,0
3,8477460,Laurent Dauphin,C,ARI,28,0,0,0,0
3,8476166,Taylor Fedun,D,PIT,35,0,0,0,0
3,8478067,Oskar Lindblom,L,SJS,27,1,0,0,0
3,8479944,Zach Aston-Reese,C,DET,29,1,0,0,0
3,8479465,Drake Caggiula,L,PIT,29,0,0,0,0
3,8481740,Tyce Thompson,R,NJD,24,0,0,0,0
3,8476948,Charles Hudon,L,COL,29,0,0,0,0
3,8480863,Gabriel Fortier,L,TBL,23,0,0,0,0
3,8471887,Patric Hornqvist,R,FLA,36,0,0,0,0
3,8477471,Dillon Heatherington,D,OTT,28,0,0,0,0
3,8481441,Joe Snively,C,WSH,27,3,0,0,0
3,8478173,Hayden Hodgson,R,PHI,27,0,0,0,0
3,8481720,Nick Abruzzese,C,TOR,24,0,0,0,0
3,8478843,Denis Malgin,C,COL,26,0,0,0,0
3,8483630,Pavol Regenda,L,ANA,24,0,0,0,0
3,8478373,Nikita Soshnikov,R,NYI,30,0,0,0,0
3,8482147,Jean-Luc Foudy,C,COL,21,0,0,0,0
3,8478431,Evgeny Svechnikov,L,SJS,27,0,0,0,0
3,8477210,Buddy Robinson,R,CHI,32,0,0,0,0
3,8479404,Henrik Borgstrom,C,WSH,26,0,0,0,0
3,8481712,Matej Blumel,R,DAL,23,0,0,0,0
3,8475278,Byron Froese,C,VGK,32,7,0,0,0
3,8479338,Markus Niemelainen,D,EDM,25,0,0,0,0
3,8471794,Darren Helm,C,COL,36,0,0,0,0
3,8482623,Josh Dunne,C,CBJ,25,0,0,0,0
3,8482641,Matt Kiersted,D,FLA,25,0,0,0,0
3,8476851,Alex Galchenyuk,C,COL,29,0,0,0,0
3,8479366,Logan Brown,C,STL,25,0,0,0,0
3,8480822,Martin Kaut,R,SJS,24,0,0,0,0
3,8482834,Jesper Froden,R,SEA,29,0,0,0,0
3,8480844,Grigori Denisenko,L,VGK,23,3,0,0,0
3,8482635,Mike Hardman,L,CHI,24,0,0,0,0
3,8477357,Saku Maenalanen,R,WPG,29,0,0,0,0
3,8480979,Nathan Smith,C,ARI,25,0,0,0,0
3,8479356,Kieffer Bellows,L,PHI,25,0,0,0,0
3,8475795,Dylan McIlrath,D,WSH,31,1,0,0,0
3,8478400,Colin White,C,PIT,26,9,0,0,0
3,8478446,Glenn Gawdin,C,ANA,26,0,0,0,0
3,8476326,Josh Archibald,R,PIT,31,0,0,0,0
3,8481683,Aidan McDonough,L,VAN,24,0,0,0,0
3,8480267,Sammy Walker,C,MIN,24,4,0,0,0
3,8477520,Jean-Sebastien Dea,C,ARI,29,0,0,0,0
3,8476439,Brett Ritchie,R,ARI,30,0,0,0,0
3,8479518,Fredrik Karlström,C,DAL,25,0,0,0,0
3,8477126,Jayson Megna,C,ANA,33,0,0,0,0
3,8479644,Matt Luff,R,DET,26,0,0,0,0
3,8478211,Dryden Hunt,L,CGY,28,5,0,0,0
3,8480226,Marián Studenic,R,SEA,25,2,0,0,0
3,8480037,Aleksi Heponiemi,C,FLA,24,0,0,0,0
3,8480292,Carson Meyer,R,CBJ,26,0,0,0,0
3,8482634,Alex Steeves,C,TOR,24,1,0,0,0
3,8475178,Zack Kassian,R,ARI,32,0,0,0,0
3,8483524,Shane Wright,C,SEA,19,3,0,0,0
3,8482654,Jackson Cates,C,PHI,26,0,0,0,0
3,8479550,Tanner Laczynski,C,PHI,26,0,0,0,0
3,8479991,Jake Leschyshyn,C,NYR,24,1,0,0,0
3,8474613,Derek Stepan,C,CAR,33,0,0,0,0
3,8478367,Cole Bardreau,C,NYI,30,0,0,0,0
3,8480890,Jan Jenik,R,ARI,23,1,0,0,0
3,8475160,Kyle Clifford,L,TOR,32,0,0,0,0
3,8479705,Jeffrey Viel,L,SJS,26,0,0,0,0
3,8477401,John Hayden,C,SEA,28,2,0,0,0
3,8480846,Sampo Ranta,L,COL,23,0,0,0,0
3,8482691,Aatu Raty,C,VAN,21,0,0,0,0
3,8481070,Hugh McGing,L,STL,25,5,0,0,0
3,8479573,Mikhail Maltsev,L,COL,25,0,0,0,0
3,8482250,Callahan Burke,C,CAR,26,1,0,0,0
3,8481102,Egor Sokolov,L,OTT,23,0,0,0,0
3,8481518,Nolan Foote,L,NJD,23,0,0,0,0
3,8474190,Wayne Simmonds,R,TOR,35,0,0,0,0
3,8474610,Zac Dalpe,C,FLA,34,0,0,0,0
3,8479347,Tyler Benson,L,EDM,25,0,0,0,0
3,8476404,Andy Andreoff,C,NYI,32,0,0,0,0
3,8476390,Joseph Cramarossa,C,MIN,31,0,0,0,0
3,8483549,Lucas Condotta,L,MTL,26,3,0,0,0
3,8482197,Adam Raska,R,MIN,22,5,0,0,0
3,8479533,Joona Koppanen,L,PIT,25,3,0,0,0
3,8479526,Otto Koivula,L,NYI,25,0,0,0,0
3,8479375,William Bitten,C,STL,25,0,0,0,0
3,8474089,Brad Malone,C,EDM,34,0,0,0,0
3,8478058,CJ Suess,L,SJS,29,0,0,0,0
3,8478147,Bokondji Imama,L,ARI,27,0,0,0,0
3,8477320,Anton Blidh,L,NYR,28,1,0,0,0
3,8477993,Justin Kirkland,C,ARI,27,2,0,0,0
3,8480836,Jonathan Gruden,C,PIT,23,5,0,0,0
3,8480032,Shane Bowers,C,NJD,24,3,0,0,0
4,8477492,Nathan MacKinnon,C,COL,28,82,47,87,134
4,8476453,Nikita Kucherov,R,TBL,30,81,44,82,126
4,8478402,Connor McDavid,C,EDM,26,80,33,89,122
4,8477956,David Pastrnak,R,BOS,27,82,48,63,111
4,8477934,Leon Draisaitl,C,EDM,28,82,41,66,107
4,8476468,J.T. Miller,C,VAN,30,81,34,71,105
4,8478550,Artemi Panarin,L,NYR,32,82,43,61,104
4,8477939,William Nylander,R,TOR,27,82,41,63,104
4,8479318,Auston Matthews,C,TOR,26,81,65,37,102
4,8477933,Sam Reinhart,C,FLA,28,82,59,40,99
4,8480012,Elias Pettersson,C,VAN,25,81,40,59,99
4,8478483,Mitchell Marner,R,TOR,26,81,39,60,99
4,8479314,Matthew Tkachuk,L,FLA,26,82,34,64,98
4,8480800,Quinn Hughes,D,VAN,24,81,23,72,95
4,8478420,Mikko Rantanen,R,COL,27,82,38,55,93
4,8480023,Robert Thomas,C,STL,24,82,29,62,91
4,8480069,Cale Makar,D,COL,25,77,18,73,91
4,8476887,Filip Forsberg,L,NSH,29,82,37,50,87
4,8480027,Jason Robertson,L,DAL,24,82,30,57,87
4,8481559,Jack Hughes,C,NJD,22,65,27,60,87
4,8478444,Brock Boeser,R,VAN,26,81,48,38,86
4,8478427,Sebastian Aho,C,CAR,26,78,28,58,86
4,8477493,Aleksander Barkov,C,FLA,28,76,21,64,85
4,8477409,Carter Verhaeghe,C,FLA,28,82,44,40,84
4,8482116,Tim Stützle,C,OTT,21,82,21,63,84
4,8479343,Clayton Keller,R,ARI,25,82,39,44,83
4,8478864,Kirill Kaprizov,L,MIN,26,75,34,49,83
4,8480801,Brady Tkachuk,L,OTT,24,82,48,34,82
4,8477946,Dylan Larkin,C,DET,27,76,38,44,82
4,8479407,Jesper Bratt,L,NJD,25,81,29,53,82
4,8478445,Mathew Barzal,C,NYI,26,81,23,59,82
4,8475786,Zach Hyman,L,EDM,31,81,51,30,81
4,8477404,Jake Guentzel,L,PIT,29,81,32,49,81
4,8475913,Mark Stone,R,VGK,31,81,24,57,81
4,8471675,Sidney Crosby,C,PIT,36,82,40,40,80
4,8475168,Matt Duchene,C,DAL,32,81,31,48,79
4,8478010,Brayden Point,C,TBL,27,82,42,35,77
4,8476460,Mark Scheifele,C,WPG,30,75,28,49,77
4,8476454,Ryan Nugent-Hopkins,C,EDM,30,82,23,53,76
4,8474600,Roman Josi,D,NSH,33,82,17,59,76
4,8478449,Roope Hintz,C,DAL,27,80,37,38,75
4,8480803,Evan Bouchard,D,EDM,24,82,21,54,75
4,8480865,Noah Dobson,D,NYI,23,82,8,67,75
4,8474564,Steven Stamkos,C,TBL,33,79,33,41,74
4,8480018,Nick Suzuki,C,MTL,24,82,29,45,74
4,8482078,Lucas Raymond,L,DET,21,82,24,50,74
4,8476853,Morgan Rielly,D,TOR,29,79,12,62,74
4,8479323,Adam Fox,D,NYR,25,72,11,63,74
4,8473419,Brad Marchand,L,BOS,35,82,36,37,73
4,8475167,Victor Hedman,D,TBL,33,80,13,60,73
4,8475184,Chris Kreider,L,NYR,32,82,40,32,72
4,8479542,Brandon Hagel,L,TBL,25,82,29,43,72
4,8479337,Alex DeBrincat,R,DET,26,82,28,44,72
4,8476539,Jonathan Marchessault,R,VGK,33,81,49,22,71
4,8475794,Tyler Seguin,C,DAL,31,82,30,40,70
4,8476389,Vincent Trocheck,C,NYR,30,82,24,46,70
4,8476459,Mika Zibanejad,C,NYR,30,81,24,46,70
4,8478493,Joel Eriksson Ek,C,MIN,26,82,41,27,68
4,8477960,Adrian Kempe,R,LAK,27,82,28,40,68
4,8479385,Jordan Kyrou,C,STL,25,82,33,34,67
4,8477940,Nikolaj Ehlers,L,WPG,27,81,30,37,67
4,8478403,Jack Eichel,C,VGK,27,70,29,38,67
4,8477402,Pavel Buchnevich,L,STL,28,80,25,42,67
4,8475765,Vladimir Tarasenko,R,OTT,32,80,24,43,67
4,8473512,Claude Giroux,R,OTT,35,82,22,45,67
4,8477500,Bo Horvat,C,NYI,28,81,29,37,66
4,8471685,Anze Kopitar,C,LAK,36,82,26,40,66
4,8475166,John Tavares,C,TOR,33,80,24,42,66
4,8480839,Rasmus Dahlin,D,BUF,23,81,18,47,65
4,8477955,Jared McCann,L,SEA,27,81,34,30,64
4,8478439,Travis Konecny,R,PHI,26,81,30,34,64
4,8480002,Nico Hischier,C,NJD,24,70,24,40,64
4,8477942,Kevin Fiala,L,LAK,27,82,20,44,64
4,8481540,Cole Caufield,R,MTL,22,82,27,36,63
4,8482093,Seth Jarvis,C,CAR,21,81,25,38,63
4,8476881,Tomas Hertl,C,SJS,30,76,24,39,63
4,8478975,Mason Marchment,L,DAL,28,81,23,40,63
4,8476448,William Karlsson,C,VGK,30,69,28,34,62
4,8482124,Quinton Byfield,R,LAK,21,80,28,33,61
4,8478873,Troy Terry,R,ANA,26,79,22,39,61
4,8474679,Gustav Nyquist,C,NSH,34,82,21,40,61
4,8477501,Valeri Nichushkin,R,COL,28,67,31,29,60
4,8475158,Ryan O'Reilly,C,NSH,32,82,28,32,60
4,8470794,Joe Pavelski,C,DAL,39,82,25,35,60
4,8471214,Alex Ovechkin,L,WSH,38,79,25,35,60
4,8471215,Evgeni Malkin,C,PIT,37,82,24,36,60
4,8479999,Casey Mittelstadt,C,BUF,25,82,18,42,60
4,8476875,Mike Matheson,D,MTL,29,82,11,49,60
4,8474578,Erik Karlsson,D,PIT,33,82,10,50,60
4,8475726,Tyler Toffoli,R,NJD,31,80,40,19,59
4,8481557,Matt Boldy,L,MIN,22,75,27,32,59
4,8480797,Joel Farabee,L,PHI,23,81,24,35,59
4,8475172,Nazem Kadri,C,CGY,33,82,20,39,59
4,8475754,Brock Nelson,C,NYI,32,82,31,27,58
4,8474641,Adam Henrique,C,ANA,33,81,25,33,58
4,8475745,Charlie Coyle,C,BOS,31,82,22,36,58
4,8477496,Elias Lindholm,C,VAN,29,81,20,38,58
4,8475692,Mats Zuccarello,R,MIN,36,73,17,41,58
4,8475798,Mikael Granlund,C,SJS,31,68,13,45,58
4,8480208,Drake Batherson,R,OTT,25,82,27,30,57
4,8479425,Filip Hronek,D,VAN,26,81,7,50,57
4,8476882,Teuvo Teravainen,L,CAR,29,81,32,24,56
4,8479675,Trevor Moore,L,LAK,28,82,30,26,56
4,8480039,Martin Necas,C,CAR,24,76,21,35,56
4,8477949,Alex Tuch,R,BUF,27,75,21,35,56
4,8477416,Oliver Bjorkstrand,R,SEA,28,82,15,41,56
4,8478440,Dylan Strome,C,WSH,26,82,27,28,55
4,8475810,Bryan Rust,R,PIT,31,69,25,30,55
4,8478398,Kyle Connor,L,WPG,27,65,35,19,54
4,8478401,Pavel Zacha,C,BOS,26,78,23,31,54
4,8477456,J.T. Compher,L,DET,28,77,22,32,54
4,8477497,Sean Monahan,C,WPG,29,83,20,34,54
4,8474037,James van Riemsdyk,L,BOS,34,78,17,37,54
4,8478407,Vince Dunn,D,SEA,27,78,9,45,54
4,8478460,Zach Werenski,D,CBJ,26,69,4,50,54
4,8478366,Frank Vatrano,R,ANA,29,82,30,23,53
4,8482175,JJ Peterka,R,BUF,21,82,29,24,53
4,8475151,Kyle Palmieri,C,NYI,32,82,23,30,53
4,8474141,Patrick Kane,R,DET,35,51,21,32,53
4,8479325,Charlie McAvoy,D,BOS,26,74,12,41,53
4,8477504,Josh Morrissey,D,WPG,28,81,11,42,53
4,8476399,Blake Coleman,C,CGY,32,82,27,25,52
4,8482740,Wyatt Johnston,C,DAL,20,82,26,26,52
4,8476905,Chandler Stephenson,C,VGK,29,77,16,36,52
4,8480798,Philipp Kurashev,C,CHI,24,75,16,36,52
4,8478462,Nicolas Roy,C,VGK,26,72,16,36,52
4,8474590,John Carlson,D,WSH,33,82,8,44,52
4,8477951,Nick Schmaltz,C,ARI,27,79,22,29,51
4,8477447,Shea Theodore,D,VGK,28,48,13,38,51
4,8480015,Owen Tippett,R,PHI,24,77,30,20,50
4,8475170,Brayden Schenn,C,STL,32,82,22,28,50
4,8476479,Phillip Danault,C,LAK,30,82,17,33,50
4,8476346,Johnny Gaudreau,L,CBJ,30,81,10,40,50
4,8479420,Tage Thompson,C,BUF,26,72,28,21,49
4,8481068,Yegor Sharangovich,C,CGY,25,82,27,22,49
4,8475784,Jeff Skinner,L,BUF,31,74,25,24,49
4,8475287,Erik Haula,L,NJD,32,75,23,26,49
4,8480830,Andrei Svechnikov,R,CAR,23,60,19,30,49
4,8478397,Rasmus Andersson,D,CGY,27,78,11,38,49
4,8475169,Evander Kane,L,EDM,32,81,26,22,48
4,8482109,Alexis Lafrenière,L,NYR,22,82,25,23,48
4,8482149,Cole Perfetti,C,WPG,21,81,19,29,48
4,8476906,Shayne Gostisbehere,D,DET,30,81,8,40,48
4,8481542,Moritz Seider,D,DET,22,82,8,40,48
4,8471724,Kris Letang,D,PIT,36,82,6,42,48
4,8482089,Jake Neighbours,L,STL,21,82,31,16,47
4,8477451,Ryan Hartman,R,MIN,29,77,26,21,47
4,8479365,Trent Frederic,C,BOS,25,82,23,24,47
4,8482745,Mason McTavish,C,ANA,20,74,22,25,47
4,8479345,Jakob Chychrun,D,OTT,25,82,17,30,47
4,8474565,Alex Pietrangelo,D,VGK,33,76,3,44,47
4,8478474,Lawson Crouse,L,ARI,26,81,27,19,46
4,8477346,MacKenzie Weegar,D,CGY,29,82,20,26,46
4,8478438,Tommy Novak,C,NSH,26,71,19,27,46
4,8478047,Michael Bunting,L,CAR,28,80,15,31,46
4,8478038,Devon Toews,D,COL,29,82,13,33,46
4,8480036,Miro Heiskanen,D,DAL,24,72,10,36,46
4,8477021,Alex Kerfoot,C,ARI,29,82,10,36,46
4,8482684,Luke Hughes,D,NJD,20,81,10,36,46
4,8480434,Sean Durzi,D,ARI,25,76,10,36,46
4,8482110,Dawson Mercer,C,NJD,22,81,26,19,45
4,8480009,Eeli Tolvanen,R,SEA,24,82,22,23,45
4,8478856,Conor Garland,R,VAN,27,81,21,24,45
4,8478498,Jake DeBrusk,L,BOS,27,80,21,24,45
4,8478414,Timo Meier,R,NJD,27,68,20,25,45
4,8474586,Jordan Eberle,R,SEA,33,78,19,26,45
4,8476458,Ryan Strome,C,ANA,30,79,13,32,45
4,8478396,Noah Hanifin,D,CGY,26,82,13,32,45
4,8473994,Jamie Benn,L,DAL,34,82,13,32,45
4,8477503,Max Domi,C,TOR,28,82,11,34,45
4,8477948,Travis Sanheim,D,PHI,27,80,5,40,45
4,8477511,Anthony Mantha,R,WSH,29,78,26,18,44
4,8470613,Brent Burns,D,CAR,38,81,11,33,44
4,8476792,Torey Krug,D,STL,32,82,4,40,44
4,8475799,Nino Niederreiter,R,WPG,31,81,23,20,43
4,8474102,David Perron,L,DET,35,76,20,23,43
4,8475760,Nick Bjugstad,C,ARI,31,82,19,24,43
4,8478055,Gustav Forsling,D,FLA,27,81,14,29,43
4,8481711,Matias Maccelli,L,ARI,23,82,10,33,43
4,8476869,Brady Skjei,D,CAR,29,81,10,33,43
4,8480064,Josh Norris,C,OTT,24,75,23,19,42
4,8477964,Ivan Barbashev,C,VGK,28,81,19,23,42
4,8481624,Ilya Mikheyev,R,VAN,29,77,17,25,42
4,8477429,Andrew Copp,C,DET,29,81,17,25,42
4,8477494,Jonathan Drouin,L,COL,28,80,16,26,42
4,8479525,Ross Colton,C,COL,27,80,16,26,42
4,8471218,Blake Wheeler,R,NYR,37,82,16,26,42
4,8476872,Scott Laughton,C,PHI,29,81,13,29,42
4,8471698,T.J. Oshie,R,WSH,37,65,25,16,41
4,8478472,Mathieu Joseph,R,OTT,26,72,17,24,41
4,8474563,Drew Doughty,D,LAK,34,82,16,25,41
4,8477479,Tyler Bertuzzi,L,TOR,28,81,13,28,41
4,8482122,Brock Faber,D,MIN,21,82,5,36,41
4,8477935,Sam Bennett,C,FLA,27,70,18,22,40
4,8482146,Luke Evangelista,R,NSH,21,80,18,22,40
4,8478519,Anthony Cirelli,C,TBL,26,81,17,23,40
4,8479400,Pierre-Luc Dubois,C,LAK,25,82,16,24,40
4,8481581,Thomas Harley,D,DAL,22,79,16,24,40
4,8481528,Dylan Cozens,C,BUF,22,79,15,25,40
4,8475722,Jason Zucker,L,ARI,31,72,13,27,40
4,8473986,Alex Killorn,L,ANA,34,63,13,27,40
4,8475149,Marcus Johansson,L,MIN,33,82,11,29,40
4,8478542,Evan Rodrigues,C,FLA,30,82,8,32,40
4,8477450,Jason Dickinson,C,CHI,28,82,26,13,39
4,8482475,Yegor Chinakhov,R,CBJ,22,69,21,18,39
4,8476880,Tom Wilson,R,WSH,29,81,20,19,39
4,8480014,Gabriel Vilardi,C,WPG,24,61,16,23,39
4,8478057,Dakota Joshua,C,VAN,27,79,16,23,39
4,8480028,Morgan Frost,C,PHI,24,70,13,26,39
4,8482667,William Eklund,L,SJS,21,80,12,27,39
4,8477986,Brandon Montour,D,FLA,29,66,11,28,39
4,8478500,Ivan Provorov,D,CBJ,26,81,9,30,39
4,8476925,Colton Sissons,C,NSH,30,82,25,13,38
4,8481186,Logan O'Connor,R,COL,27,78,22,16,38
4,8480893,Kirill Marchenko,R,CBJ,23,79,19,19,38
4,8474150,Mikael Backlund,C,CGY,34,82,18,20,38
4,8483808,Andrei Kuzmenko,L,CGY,27,76,17,21,38
4,8482079,Marco Rossi,C,MIN,22,82,16,22,38
4,8476292,Ondrej Palat,L,NJD,32,71,15,23,38
4,8475764,Cam Fowler,D,ANA,32,82,7,31,38
4,8475314,Anders Lee,L,NYI,33,82,24,13,37
4,8483515,Juraj Slafkovsky,L,MTL,19,82,13,24,37
4,8476462,Dougie Hamilton,D,NJD,30,48,12,25,37
4,8476456,Jonathan Huberdeau,C,CGY,30,81,9,28,37
4,8476480,Vladislav Namestnikov,C,WPG,31,78,8,29,37
4,8475753,Justin Faulk,D,STL,31,68,5,32,37
4,8478469,Thomas Chabot,D,OTT,26,60,5,32,37
4,8479410,Mikhail Sergachev,D,TBL,25,60,4,33,37
4,8476432,Boone Jenner,C,CBJ,30,66,29,7,36
4,8477426,Nicholas Paul,L,TBL,28,82,18,18,36
4,8475763,Kevin Hayes,R,STL,31,82,18,18,36
4,8479992,Michael Rasmussen,C,DET,24,82,17,19,36
4,8481533,Trevor Zegras,C,ANA,22,48,14,22,36
4,8477998,Warren Foegele,L,EDM,27,82,13,23,36
4,8476392,Adam Lowry,C,WPG,30,81,13,23,36
4,8478233,Andrew Mangiapane,L,CGY,27,81,11,25,36
4,8482092,Ridly Greig,C,OTT,21,72,14,21,35
4,8481580,Connor McMichael,C,WSH,22,80,13,22,35
4,8476419,Jean-Gabriel Pageau,C,NYI,31,82,11,24,35
4,8481577,Philip Tomasino,C,NSH,22,68,11,24,35
4,8476927,Teddy Blueger,C,VAN,29,67,10,25,35
4,8476483,Rickard Rakell,R,PIT,30,70,9,26,35
4,8475218,Mattias Ekholm,D,EDM,33,81,7,28,35
4,8475714,Calle Jarnkrok,C,TOR,32,75,20,14,34
4,8477407,Anthony Duclair,L,SJS,28,76,16,18,34
4,8480813,Joe Veleno,C,DET,23,80,15,19,34
4,8478891,Mason Appleton,C,WPG,27,81,15,19,34
4,8474157,Max Pacioretty,L,WSH,35,47,14,20,34
4,8478466,Daniel Sprong,R,DET,26,54,14,20,34
4,8475171,Oliver Ekman-Larsson,D,FLA,32,82,12,22,34
4,8476958,Jaccob Slavin,D,CAR,29,81,8,26,34
4,8477952,Robby Fabbri,C,DET,27,68,20,13,33
4,8480188,Fabian Zetterlund,L,SJS,24,81,19,14,33
4,8482159,Tyson Foerster,R,PHI,21,78,17,16,33
4,8477505,Alex Wennberg,C,SEA,29,82,12,21,33
4,8475744,Evgeny Kuznetsov,C,WSH,31,72,10,23,33
4,8476979,Erik Gustafsson,D,NYR,31,81,8,25,33
4,8481601,Simon Holmstrom,R,NYI,22,81,21,11,32
4,8474149,Evgenii Dadonov,R,DAL,34,77,16,16,32
4,8473422,Nick Foligno,L,CHI,36,75,16,16,32
4,8482665,Matty Beniers,C,SEA,21,77,14,18,32
4,8479987,Morgan Geekie,C,BOS,25,76,12,20,32
4,8482113,Anton Lundell,C,FLA,22,78,9,23,32
4,8482105,Jake Sanderson,D,OTT,21,79,8,24,32
4,8476902,Esa Lindell,D,DAL,29,82,5,27,32
4,8475197,Tyson Barrie,D,NSH,32,62,4,28,32
4,8478013,Jake Walman,D,DET,27,76,19,12,31
4,8476438,Brandon Saad,L,STL,31,82,18,13,31
4,8475793,Ryan Johansen,C,COL,31,82,18,13,31
4,8480068,Ryan Poehling,C,PHI,24,76,16,15,31
4,8476921,Jordan Martinook,L,CAR,31,81,15,16,31
4,8478413,Jordan Greenway,L,BUF,26,70,14,17,31
4,8475191,Reilly Smith,R,PIT,32,76,13,18,31
4,8481032,Paul Cotter,C,VGK,24,80,13,18,31
4,8482720,Matthew Knies,L,TOR,21,80,13,18,31
4,8477425,Miles Wood,L,COL,28,77,13,18,31
4,8480113,Alex Iafallo,L,WPG,30,81,12,19,31
4,8480829,Jesperi Kotkaniemi,C,CAR,23,81,11,20,31
4,8480145,Neal Pionk,D,WPG,28,81,8,23,31
4,8475181,Nick Leddy,D,STL,32,82,5,26,31
4,8475768,Jaden Schwartz,C,SEA,31,66,17,13,30
4,8479339,Patrik Laine,L,CBJ,25,47,15,15,30
4,8482705,Cole Sillinger,C,CBJ,20,76,14,16,30
4,8475220,Marcus Foligno,L,MIN,32,75,14,16,30
4,8480817,K'Andre Miller,D,NYR,23,80,10,20,30
4,8477932,Aaron Ekblad,D,FLA,27,64,8,22,30
4,8480336,Sean Walker,D,PHI,29,81,7,23,30
4,8482655,J.J. Moser,D,ARI,23,80,4,26,30
4,8480994,Damien Giroux,C,MIN,23,28,3,27,30
4,8478046,Danton Heinen,L,BOS,28,74,15,14,29
4,8479415,Michael McLeod,C,NJD,25,73,15,14,29
4,8479941,Justin Danforth,R,CBJ,30,81,15,14,29
4,8474884,Mike Hoffman,C,SJS,34,79,14,15,29
4,8480802,Ryan McLeod,C,EDM,24,81,14,15,29
4,8480855,Jack McBain,C,ARI,23,67,12,17,29
4,8477498,Darnell Nurse,D,EDM,28,82,10,19,29
4,8478178,Darren Raddysh,D,TBL,27,82,6,23,29
4,8476885,Jacob Trouba,D,NYR,29,80,4,25,29
4,8477969,Marcus Pettersson,D,PIT,27,82,3,26,29
4,8480873,Rasmus Sandin,D,WSH,23,74,3,26,29
4,8476331,Dylan DeMelo,D,WPG,30,81,3,26,29
4,8476854,Hampus Lindholm,D,BOS,29,82,1,28,29
4,8479619,Michael Carcone,L,ARI,27,76,21,7,28
4,8482125,Alexander Holtz,R,NJD,21,81,15,13,28
4,8473533,Jordan Staal,C,CAR,35,81,14,14,28
4,8473449,Kyle Okposo,R,BUF,35,79,13,15,28
4,8476826,Yanni Gourde,C,SEA,32,80,12,16,28
4,8476474,Stefan Noesen,R,CAR,30,52,11,17,28
4,8477508,Curtis Lazar,C,NJD,28,76,10,18,28
4,8476931,Jake McCabe,D,TOR,30,76,8,20,28
4,8478507,John Marino,D,NJD,26,81,6,22,28
4,8475188,Brayden McNabb,D,VGK,32,81,4,24,28
4,8476879,Cody Ceci,D,EDM,30,82,2,26,28
4,8474189,Lars Eller,C,PIT,34,82,16,11,27
4,8478043,Sam Lafferty,C,VAN,28,79,13,14,27
4,8482097,Jack Quinn,R,BUF,22,45,13,14,27
4,8476892,Colton Parayko,D,STL,30,82,11,16,27
4,8476312,Josh Manson,D,COL,32,77,8,19,27
4,8476897,Oskar Sundqvist,C,STL,29,82,8,19,27
4,8482671,Owen Power,D,BUF,21,79,3,24,27
4,8476918,Jimmy Vesey,L,NYR,30,80,17,9,26
4,8480459,Pius Suter,C,VAN,27,67,17,9,26
4,8479977,Kailer Yamamoto,R,SEA,25,73,15,11,26
4,8476981,Josh Anderson,R,MTL,29,78,14,12,26
4,8479353,Brett Howden,C,VGK,25,79,14,12,26
4,8477476,Artturi Lehkonen,L,COL,28,47,10,16,26
4,8481618,Alex Newhook,C,MTL,22,55,10,16,26
4,8478109,Victor Olofsson,L,BUF,28,63,9,17,26
4,8482222,Alexander Barabanov,L,SJS,29,61,7,19,26
4,8478911,Matt Roy,D,LAK,28,81,6,20,26
4,8474602,Justin Schultz,D,SEA,33,72,5,21,26
4,8473507,Jeff Petry,D,DET,36,73,4,22,26
4,8474151,Ryan McDonagh,D,NSH,34,75,3,23,26
4,8480878,Nils Lundkvist,D,DAL,23,70,3,23,26
4,8477330,Dominik Kubalik,L,OTT,28,78,12,13,25
4,8481524,Bowen  Byram,D,COL,22,74,11,14,25
4,8481560,Arthur Kaliyev,R,LAK,22,68,11,14,25
4,8480185,Eetu Luostarinen,C,FLA,25,82,11,14,25
4,8476923,Damon Severson,D,CBJ,29,66,9,16,25
4,8482062,Cole Smith,L,NSH,28,81,8,17,25
4,8474053,Logan Couture,C,SJS,34,34,8,17,25
4,8475455,Brenden Dillon,D,WPG,33,78,8,17,25
4,8476463,Jonas Brodin,D,MIN,30,64,6,19,25
4,8474574,Tyler Myers,D,VAN,33,81,5,20,25
4,8481535,Nils Hoglander,L,VAN,23,53,17,7,24
4,8482157,Will Cuylle,L,NYR,21,82,14,10,24
4,8475343,Nic Dowd,C,WSH,33,73,12,12,24
4,8470621,Corey Perry,R,EDM,38,54,11,13,24
4,8470638,Patrice Bergeron,C,BOS,38,27,11,13,24
4,8481582,Nicholas Robertson,L,TOR,22,64,10,14,24
4,8478020,Michael Amadio,R,VGK,27,74,10,14,24
4,8479351,Sam Steel,C,DAL,25,77,10,14,24
4,8478115,Pierre Engvall,L,NYI,27,76,10,14,24
4,8480835,Jack Drury,C,CAR,23,53,8,16,24
4,8478851,Alexandre Carrier,D,NSH,27,77,7,17,24
4,8482087,Kaiden Guhle,D,MTL,21,78,7,17,24
4,8479398,Samuel Girard,D,COL,25,61,6,18,24
4,8478443,Brandon Carlo,D,BOS,27,77,5,19,24
4,8478458,Jack Roslovic,C,CBJ,26,58,5,19,24
4,8482245,Artem Zub,D,OTT,28,72,4,20,24
4,8477495,Seth Jones,D,CHI,29,67,3,21,24
4,8480246,Nick Perbix,D,TBL,25,80,3,21,24
4,8480049,Dylan Samberg,D,WPG,24,81,3,21,24
4,8482055,Drew O'Connor,L,PIT,25,82,10,13,23
4,8478136,Jake Middleton,D,MIN,27,82,9,14,23
4,8475193,Tomas Tatar,L,SEA,33,78,7,16,23
4,8476457,Adam Larsson,D,SEA,31,82,4,19,23
4,8478840,Will Borgen,D,SEA,27,82,2,21,23
4,8480281,Alexey Toropchenko,R,STL,24,82,13,9,22
4,8481604,Pavel Dorofeyev,L,VGK,23,57,12,10,22
4,8480849,Barrett Hayton,C,ARI,23,50,9,13,22
4,8477950,Tony DeAngelo,D,CAR,28,51,8,14,22
4,8478882,Vladislav Gavrikov,D,LAK,28,77,7,15,22
4,8477953,Kasperi Kapanen,R,STL,27,75,6,16,22
4,8476422,Mike Reilly,D,NYI,30,61,6,16,22
4,8479976,Juuso Valimaki,D,ARI,25,68,4,18,22
4,8478463,Anthony Beauvillier,L,CHI,26,64,4,18,22
4,8480035,Henri Jokiharju,D,BUF,24,74,4,18,22
4,8475200,Dmitry Orlov,D,CAR,32,81,3,19,22
4,8479998,Mikey Anderson,D,LAK,24,82,1,21,22
4,8474870,Tyler Johnson,C,CHI,33,67,13,8,21
4,8482101,Danil Gushchin,L,SJS,21,30,11,10,21
4,8476960,Andreas Athanasiou,C,CHI,29,38,9,12,21
4,8481596,Shane Pinto,C,OTT,23,41,5,16,21
4,8475164,Jakob Silfverberg,R,ANA,33,81,5,16,21
4,8481656,Aliaksei Protas,C,WSH,22,52,4,17,21
4,8475790,Erik Gudbranson,D,CBJ,31,77,4,17,21
4,8479983,Mario Ferraro,D,SJS,25,77,2,19,21
4,8481690,Tyler Angle,C,CBJ,23,29,18,2,20
4,8479591,Michael Eyssimont,C,TBL,27,81,11,9,20
4,8474040,Sam Gagner,C,EDM,34,55,11,9,20
4,8481481,Blake Lizotte,C,LAK,26,64,11,9,20
4,8477947,Sonny Milano,L,WSH,27,53,10,10,20
4,8475855,Jesper Fast,R,CAR,32,78,9,11,20
4,8479996,Cody Glass,C,NSH,24,54,7,13,20
4,8481546,Cam York,D,PHI,22,81,6,14,20
4,8475791,Taylor Hall,L,CHI,32,37,6,14,20
4,8471699,Andrew Cogliano,C,COL,36,76,5,15,20
4,8478133,Jake Evans,C,MTL,27,82,4,16,20
4,8480043,Timothy Liljegren,D,TOR,24,65,4,16,20
4,8470600,Ryan Suter,D,DAL,38,82,2,18,20
4,8478831,Kevin Stenlund,C,FLA,27,82,15,4,19
4,8479393,Noah Gregor,C,TOR,25,81,9,10,19
4,8482111,Justin Barron,D,MTL,22,68,8,11,19
4,8475231,Casey Cizikas,C,NYI,32,71,7,12,19
4,8480220,Noah Cates,L,PHI,24,59,7,12,19
4,8479359,Beck Malenstyn,L,WSH,25,81,7,12,19
4,8475279,Ben Chiarot,D,DET,32,77,5,14,19
4,8480172,Jan Rutta,D,SJS,33,75,5,14,19
4,8478859,Niko Mikkola,D,FLA,27,82,4,15,19
4,8479980,Nicolas Hague,D,VGK,25,73,4,15,19
4,8478042,Viktor Arvidsson,R,LAK,30,32,3,16,19
4,8474161,Jakub Voracek,R,CBJ,34,29,1,18,19
4,8477365,Connor Clifton,D,BUF,28,79,0,19,19
4,8479316,Luke Kunin,C,SJS,26,76,15,3,18
4,8476469,Joel Armia,R,MTL,30,66,11,7,18
4,8482699,Dylan Guenther,R,ARI,20,45,8,10,18
4,8476410,Josh Leivo,L,STL,30,28,7,11,18
4,8475462,Radko Gudas,D,ANA,33,76,6,12,18
4,8477444,Andre Burakovsky,L,SEA,28,51,5,13,18
4,8476858,Phillip Di Giuseppe,L,VAN,30,62,5,13,18
4,8480078,Filip Chytil,C,NYR,24,38,4,14,18
4,8482073,Braden Schneider,D,NYR,22,82,4,14,18
4,8480796,Martin Fehervary,D,WSH,24,76,4,14,18
4,8475690,Chris Tanev,D,CGY,34,79,2,16,18
4,8474716,Jared Spurgeon,D,MIN,34,44,2,16,18
4,8477903,Garnet Hathaway,R,PHI,32,81,12,5,17
4,8470604,Jeff Carter,C,PIT,38,76,11,6,17
4,8479661,Tanner Jeannot,L,TBL,26,68,10,7,17
4,8476374,Sean Kuraly,C,CBJ,30,73,9,8,17
4,8477435,Ryan Graves,D,PIT,28,82,9,8,17
4,8477944,Jakub Vrana,L,STL,27,49,9,8,17
4,8480821,Filip Zadina,R,SJS,24,48,7,10,17
4,8475233,David Savard,D,MTL,33,60,6,11,17
4,8482117,Lukas Reichel,L,CHI,21,77,6,11,17
4,8476889,Radek Faksa,C,DAL,29,74,6,11,17
4,8476329,Travis Boyd,C,ARI,30,45,4,13,17
4,8482142,Jamie Drysdale,D,PHI,21,49,4,13,17
4,8480883,Ty Smith,D,PIT,23,31,4,13,17
4,8481568,Alex Vlasic,D,CHI,22,76,3,14,17
4,8478416,Erik Cernak,D,TBL,26,71,1,16,17
4,8475179,Dmitry Kulikov,D,FLA,33,78,0,17,17
4,8474673,TJ Brodie,D,TOR,33,81,0,17,17
4,8475848,Brendan Gallagher,R,MTL,31,50,8,8,16
4,8480144,David Kampf,C,TOR,28,78,7,9,16
4,8482660,Kent Johnson,C,CBJ,21,36,6,10,16
4,8476967,Brett Kulak,D,EDM,29,82,6,10,16
4,8475208,Brian Dumoulin,D,SEA,32,80,4,12,16
4,8477919,Frederick Gaudreau,C,MIN,30,70,4,12,16
4,8474166,Alec Martinez,D,VGK,36,64,4,12,16
4,8474034,Pat Maroon,L,MIN,35,49,4,12,16
4,8471677,Jack Johnson,D,COL,36,80,3,13,16
4,8479324,Ryan Lindgren,D,NYR,25,80,2,14,16
4,8482192,Isaak Phillips,D,CHI,22,56,2,14,16
4,8481606,Jordan Spence,D,LAK,22,44,0,16,16
4,8479293,Brandon Tanev,L,SEA,32,66,9,6,15
4,8473453,Trevor Lewis,C,LAK,36,82,8,7,15
4,8481093,Rafael Harvey-Pinard,L,MTL,24,51,7,8,15
4,8477987,Ryan Donato,C,CHI,27,51,6,9,15
4,8480762,Eric Robinson,L,BUF,28,54,6,9,15
4,8481014,Alexander Romanov,D,NYI,23,81,5,10,15
4,8481178,Egor Zamula,D,PHI,23,44,5,10,15
4,8474567,Zach Bogosian,D,MIN,33,70,4,11,15
4,8471276,David Krejci,C,BOS,37,27,3,12,15
4,8478399,Jonas Siegenthaler,D,NJD,26,66,2,13,15
4,8475906,John Klingberg,D,TOR,31,43,1,14,15
4,8480860,Kevin Bahl,D,NJD,23,81,0,15,15
4,8478508,Yakov Trenin,C,NSH,26,79,10,4,14
4,8481554,Kaapo Kakko,R,NYR,22,61,9,5,14
4,8478569,Noel Acciari,C,PIT,32,70,9,5,14
4,8478495,Denis Gurianov,R,NSH,26,40,6,8,14
4,8477506,Ryan Pulock,D,NYI,29,58,5,9,14
4,8479390,Taylor Raddysh,R,CHI,25,77,5,9,14
4,8474031,Kevin Shattenkirk,D,BOS,34,44,5,9,14
4,8478970,Jalen Chatfield,D,CAR,27,48,5,9,14
4,8477979,Nicolas Aube-Kubel,R,WSH,27,39,5,9,14
4,8477488,Brett Pesce,D,CAR,29,71,5,9,14
4,8473504,Cal Clutterbuck,R,NYI,36,53,4,10,14
4,8477380,Jonny Brodzinski,C,NYR,30,35,4,10,14
4,8476467,Jamie Oleksiak,D,SEA,31,82,4,10,14
4,8473548,Phil Kessel,R,VGK,36,28,3,11,14
4,8477839,Conor Sheary,L,TBL,31,64,2,12,14
4,8481704,Juuso Parssinen,C,NSH,22,71,9,4,13
4,8480289,Morgan Barron,C,WPG,25,51,9,4,13
4,8477446,Michael McCarron,R,NSH,28,43,7,6,13
4,8482259,Bobby McMann,C,TOR,27,29,7,6,13
4,8480448,Parker Kelly,L,OTT,24,51,6,7,13
4,8474009,Nick Bonino,C,NYR,35,73,5,8,13
4,8476442,Matt Nieto,L,PIT,31,53,5,8,13
4,8480328,David Gust,R,CHI,29,27,5,8,13
4,8477989,Christian Dvorak,C,MTL,27,52,4,9,13
4,8481522,Peyton Krebs,C,BUF,22,80,4,9,13
4,8480848,Ty Dellandrea,C,DAL,23,53,4,9,13
4,8476393,Nick Cousins,C,FLA,30,70,4,9,13
4,8476473,Connor Murphy,D,CHI,30,70,3,10,13
4,8477406,Mattias Janmark,C,EDM,31,71,3,10,13
4,8481605,Jackson LaCombe,D,ANA,22,76,2,11,13
4,8477335,Kyle Burroughs,D,SJS,28,74,2,11,13
4,8474162,Jake Muzzin,D,TOR,34,29,2,11,13
4,8477499,Rasmus Ristolainen,D,PHI,29,57,2,11,13
4,8477845,Trevor van Riemsdyk,D,WSH,32,70,0,13,13
4,8475324,Nick Jensen,D,WSH,33,82,0,13,13
4,8476822,Luke Glendening,C,TBL,34,82,11,1,12
4,8473544,Derick Brassard,C,OTT,36,31,10,2,12
4,8480192,Johnathan Kovacevic,D,MTL,26,74,9,3,12
4,8478468,Jeremy Lauzon,D,NSH,26,82,8,4,12
4,8479336,Carl Grundstrom,R,LAK,26,50,8,4,12
4,8480806,Isac Lundestrom,C,ANA,24,46,8,4,12
4,8481517,Brett Leason,R,ANA,24,43,6,6,12
4,8482730,Brandt Clarke,D,LAK,20,38,6,6,12
4,8480748,Kiefer Sherwood,L,NSH,28,41,5,7,12
4,8481013,Jonatan Berggren,R,DET,23,37,4,8,12
4,8476856,Matt Dumba,D,ARI,29,78,4,8,12
4,8475177,Calvin de Haan,D,TBL,32,72,4,8,12
4,8480891,Michael Kesselring,D,ARI,23,36,4,8,12
4,8475825,Jani Hakanpää,D,DAL,31,82,3,9,12
4,8480073,Erik Brannstrom,D,OTT,24,45,3,9,12
4,8477507,Nikita Zadorov,D,VAN,28,75,2,10,12
4,8476624,Barclay Goodrow,C,NYR,30,80,2,10,12
4,8476874,Olli Maatta,D,DET,29,46,2,10,12
4,8478432,Christian Fischer,R,DET,26,51,2,10,12
4,8480001,Urho Vaakanainen,D,ANA,24,74,1,11,12
4,8480884,Calen Addison,D,SJS,23,45,1,11,12
4,8480950,Ilya Lyubushkin,D,ANA,29,79,1,11,12
4,8473563,Nicklas Backstrom,C,WSH,36,37,0,12,12
4,8471274,Alex Goligoski,D,MIN,38,58,0,12,12
4,8475225,Craig Smith,C,DAL,34,50,7,4,11
4,8471669,Paul Stastny,C,CAR,38,28,7,4,11
4,8477353,Tyler Motte,C,TBL,28,72,7,4,11
4,8479291,Kevin Rooney,C,CGY,30,33,7,4,11
4,8479346,Dillon Dube,C,CGY,25,70,5,6,11
4,8474683,Derek Grant,C,ANA,33,28,5,6,11
4,8480205,Emil Bemstrom,R,CBJ,24,31,5,6,11
4,8478585,Derek Ryan,C,EDM,37,51,5,6,11
4,8480879,Jacob Bernard-Docker,D,OTT,23,42,4,7,11
4,8476525,Colin Miller,D,NJD,31,61,3,8,11
4,8480727,Zach Whitecloud,D,VGK,27,65,3,8,11
4,8480807,Mattias Samuelsson,D,BUF,23,69,2,9,11
4,8482711,Stanislav Svozil,D,CBJ,20,29,2,9,11
4,8477220,Nate Schmidt,D,WPG,32,75,1,10,11
4,8476429,Scott Mayfield,D,NYI,31,67,0,11,11
4,8475842,Sam Carrick,C,ANA,31,54,7,3,10
4,8480980,Connor Dewar,C,MIN,24,48,7,3,10
4,8478421,A.J. Greer,L,CGY,27,47,6,4,10
4,8480072,Lias Andersson,C,LAK,25,30,6,4,10
4,8476871,Tanner Pearson,L,MTL,31,36,4,6,10
4,8478434,Keegan Kolesar,R,VGK,26,50,4,6,10
4,8474612,Travis Hamonic,D,OTT,33,75,3,7,10
4,8479414,Nathan Bastian,R,NJD,26,51,3,7,10
4,8479543,Michael Pezzetta,L,MTL,25,44,3,7,10
4,8479442,Troy Stecher,D,ARI,29,71,3,7,10
4,8482451,Mikael Pyyhtia,L,CBJ,22,29,3,7,10
4,8479371,Dante Fabbro,D,NSH,25,42,2,8,10
4,8476917,Adam Pelech,D,NYI,29,58,2,8,10
4,8480887,Jordan Harris,D,MTL,23,58,1,9,10
4,8474013,Ian Cole,D,VAN,34,80,1,9,10
4,8475718,Justin Holl,D,DET,31,63,0,10,10
4,8479344,Jesse Puljujarvi,R,PIT,25,36,7,2,9
4,8479718,Alex Barré-Boulet,C,TBL,26,35,6,3,9
4,8477941,Nick Ritchie,L,CGY,28,27,5,4,9
4,8479383,Boris Katchouk,L,CHI,25,35,5,4,9
4,8479328,Julien Gauthier,R,NYI,26,27,5,4,9
4,8479402,Jake Bean,D,CBJ,25,49,4,5,9
4,8481567,Henry Thrun,D,SJS,22,51,3,6,9
4,8477846,Ryan Carpenter,C,SJS,32,36,3,6,9
4,8480008,Adam Ruzicka,C,ARI,24,41,3,6,9
4,8478028,Fredrik Olofsson,L,COL,27,53,3,6,9
4,8479315,Joey Anderson,R,CHI,25,28,2,7,9
4,8480913,Jordan Gross,D,NSH,28,27,2,7,9
4,8481527,Kaedan Korczak,D,VGK,22,26,1,8,9
4,8477018,Ben Hutton,D,VGK,30,31,1,8,9
4,8483460,David Jiricek,D,CBJ,20,36,1,8,9
4,8476372,Nick Seeler,D,PHI,30,55,0,9,9
4,8480058,Pierre-Olivier Joseph,D,PIT,24,53,0,9,9
4,8473604,Jonathan Toews,C,CHI,35,27,5,3,8
4,8470610,Zach Parise,L,COL,39,33,5,3,8
4,8480031,Max Comtois,L,ANA,24,28,4,4,8
4,8470595,Eric Staal,C,FLA,39,27,4,4,8
4,8480252,Cole Guttman,C,CHI,24,27,4,4,8
4,8479368,Max Jones,L,ANA,25,38,4,4,8
4,8481477,Nico Sturm,C,SJS,28,34,3,5,8
4,8477392,Hudson Fasching,R,NYI,28,35,3,5,8
4,8477070,Liam O'Brien,C,ARI,29,49,3,5,8
4,8476941,Connor Carrick,D,BOS,29,27,2,6,8
4,8482679,Matt Coronato,R,CGY,21,42,2,6,8
4,8477454,Adam Erne,L,EDM,28,54,2,6,8
4,8480995,Pontus Holmberg,R,TOR,24,27,2,6,8
4,8481523,Kirby Dach,C,MTL,22,29,1,7,8
4,8479576,Vincent Desharnais,D,EDM,27,49,1,7,8
4,8477971,Andreas Englund,D,LAK,27,52,1,7,8
4,8482448,Samuel Knazko,D,CBJ,21,29,1,7,8
4,8476988,Matt Benning,D,SJS,29,42,0,8,8
4,8479439,Jacob MacDonald,D,SJS,30,21,6,1,7
4,8471709,Marc-Edouard Vlasic,D,SJS,36,31,5,2,7
4,8477478,William Carrier,L,VGK,29,33,5,2,7
4,8477573,Nathan Walker,L,STL,29,18,5,2,7
4,8475461,Andrew Agozzino,L,SJS,32,28,4,3,7
4,8474573,Josh Bailey,R,NYI,34,29,4,3,7
4,8482241,Radim Zohorna,L,PIT,27,31,4,3,7
4,8481754,Nikita Nesterenko,C,ANA,22,28,3,4,7
4,8481058,Jesse Ylönen,R,MTL,24,43,3,4,7
4,8481812,Nikolai Knyzhov,D,SJS,26,38,3,4,7
4,8480874,Adam Ginning,D,PHI,23,26,3,4,7
4,8482181,Tristen Robins,C,SJS,22,28,3,4,7
4,8476891,Matt Grzelcyk,D,BOS,29,41,2,5,7
4,8479458,Nikita Zaitsev,D,CHI,32,26,2,5,7
4,8477541,Dakota Mermis,D,MIN,29,37,2,5,7
4,8478099,Kevin Labanc,R,SJS,28,32,2,5,7
4,8481641,Joel Kiviranta,L,COL,27,40,2,5,7
4,8480880,Jakub Lauko,C,BOS,23,40,2,5,7
4,8470966,Mark Giordano,D,TOR,40,36,1,6,7
4,8481537,Nikita Okhotiuk,D,SJS,23,38,1,6,7
4,8478502,Dennis Gilbert,D,CGY,27,31,1,6,7
4,8478104,Sammy Blais,L,STL,27,43,1,6,7
4,8480871,Adam Boqvist,D,CBJ,23,22,0,7,7
4,8474207,Nick Holden,D,OTT,36,31,0,7,7
4,8479520,Brandon Duhaime,R,MIN,26,54,4,2,6
4,8479066,Ryan Lomberg,L,FLA,29,55,4,2,6
4,8480901,Karson Kuhlman,C,WPG,28,30,4,2,6
4,8476278,Colin Blackwell,C,CHI,30,25,3,3,6
4,8479968,Vinni Lettieri,C,MIN,28,24,3,3,6
4,8476449,Scott Harrington,D,ANA,30,28,3,3,6
4,8478131,Ondrej Kase,R,CAR,28,28,2,4,6
4,8476310,Lukas Sedlak,C,PHI,30,26,2,4,6
4,8479348,Kale Clague,D,BUF,25,28,2,4,6
4,8476441,Joel Edmundson,D,WSH,30,66,2,4,6
4,8477369,Carson Soucy,D,VAN,29,21,2,4,6
4,8482496,Nils Aman,C,VAN,23,31,2,4,6
4,8480789,Oliver Wahlstrom,R,NYI,23,27,2,4,6
4,8483464,Marco Kasper,C,DET,19,28,2,4,6
4,8482516,Matthew Kessel,D,STL,23,47,1,5,6
4,8480222,Sebastian Aho,D,NYI,27,41,1,5,6
4,8474568,Luke Schenn,D,NSH,34,36,1,5,6
4,8479982,Conor Timmins,D,TOR,25,16,1,5,6
4,8477015,Connor Brown,R,EDM,29,75,0,6,6
4,8479369,Andrew Peeke,D,CBJ,25,20,0,6,6
4,8475797,Jarred Tinordi,D,CHI,31,32,0,6,6
4,8479372,Josh Mahura,D,FLA,25,20,0,6,6
4,8477851,Jordan Oesterle,D,CGY,31,48,0,6,6
4,8477930,Pierre-Edouard Bellemare,L,SEA,38,29,4,1,5
4,8482081,Sean Farrell,C,MTL,22,27,4,1,5
4,8474218,Jason Demers,D,EDM,35,31,4,1,5
4,8477931,Tomas Nosek,L,NJD,31,40,3,2,5
4,8480184,Gustav Lindström,D,ANA,25,22,3,2,5
4,8475747,Patrik Nemeth,D,ARI,31,29,3,2,5
4,8479514,Rem Pitlick,C,CHI,26,36,3,2,5
4,8480242,Arnaud Durandeau,L,NYI,24,29,2,3,5
4,8478408,Travis Dermott,D,ARI,27,37,2,3,5
4,8482964,Arber Xhekaj,D,MTL,22,24,2,3,5
4,8475750,Jon Merrill,D,MIN,31,38,2,3,5
4,8474618,Marco Scandella,D,STL,33,49,2,3,5
4,8480025,MacKenzie Entwistle,R,CHI,24,46,2,3,5
4,8479536,Axel Jonsson-Fjallby,L,WPG,25,26,2,3,5
4,8480275,Nick Swaney,R,MIN,26,28,2,3,5
4,8481617,Vasily Podkolzin,R,VAN,22,26,1,4,5
4,8474090,Brendan Smith,D,NJD,34,36,1,4,5
4,8477384,Josh Brown,D,ARI,29,28,1,4,5
4,8481708,Zac Jones,D,NYR,23,17,1,4,5
4,8480084,Nick DeSimone,D,NJD,29,23,1,4,5
4,8479671,Mathieu Olivier,R,CBJ,26,25,1,4,5
4,8479547,Matthew Phillips,R,PIT,25,27,1,4,5
4,8476919,Chris Tierney,C,NJD,29,28,1,4,5
4,8476952,Dominic Toninato,C,WPG,29,15,1,4,5
4,8482652,Walker Duehr,R,CGY,26,26,1,4,5
4,8482452,Elliot Desnoyers,L,PHI,21,26,1,4,5
4,8475762,Derek Forbort,D,BOS,31,57,0,5,5
4,8477482,Zach Sanford,L,CHI,29,26,0,5,5
4,8476878,Zemgus Girgensons,L,BUF,29,36,4,0,4
4,8483424,Owen Beck,C,MTL,19,27,4,0,4
4,8482077,Dylan Holloway,L,EDM,22,23,3,1,4
4,8480011,Klim Kostin,C,DET,24,32,3,1,4
4,8476915,Jujhar Khaira,L,MIN,29,29,2,2,4
4,8479370,Tyson Jost,C,BUF,25,29,2,2,4
4,8481019,David Gustafsson,C,WPG,23,27,2,2,4
4,8479981,Jonah Gadjovich,L,FLA,25,27,2,2,4
4,8471873,Anton Stralman,D,BOS,37,27,1,3,4
4,8477938,Haydn Fleury,D,TBL,27,16,1,3,4
4,8480003,Jesper Boqvist,C,BOS,25,20,1,3,4
4,8479994,Jaret Anderson-Dolan,C,LAK,24,24,1,3,4
4,8475752,Tyler Pitlick,C,NYR,32,34,1,3,4
4,8476913,Devin Shore,C,SEA,29,21,1,3,4
4,8482207,William Dufour,R,NYI,21,29,1,3,4
4,8482176,Wyatt Kaiser,D,CHI,21,23,0,4,4
4,8478452,Caleb Jones,D,COL,26,20,0,4,4
4,8478454,Noah Juulsen,D,VAN,26,38,0,4,4
4,8478424,Jansen Harkins,C,PIT,26,34,0,4,4
4,8473446,Erik Johnson,D,BUF,35,46,3,0,3
4,8482712,Oskar Olausson,R,COL,21,28,2,1,3
4,8478870,Rudolfs Balcers,L,TBL,26,26,2,1,3
4,8481167,Brayden Pachal,D,CGY,24,50,2,1,3
4,8481147,Reese Johnson,C,CHI,25,34,2,1,3
4,8478078,Rourke Chartier,C,OTT,27,34,2,1,3
4,8474709,Matt Martin,L,NYI,34,31,2,1,3
4,8479772,Zack MacEwen,R,OTT,27,22,2,1,3
4,8477962,Brendan Lemieux,L,CAR,27,23,2,1,3
4,8475766,Austin Watson,L,TBL,31,28,2,1,3
4,8480468,James Hamblin,L,EDM,24,31,2,1,3
4,8480355,Mark Kastelic,C,OTT,24,34,2,1,3
4,8480041,Dmitri Samorukov,D,STL,24,28,2,1,3
4,8481592,Jakob Pelletier,L,CGY,22,31,1,2,3
4,8481122,Simon Benoit,D,TOR,25,39,1,2,3
4,8478451,Ethan Bear,D,WSH,26,16,1,2,3
4,8471686,Marc Staal,D,PHI,36,20,1,2,3
4,8477244,Chad Ruhwedel,D,PIT,33,37,1,2,3
4,8481541,Samuel Bolduc,D,NYI,23,33,1,2,3
4,8476934,Brock McGinn,L,ANA,29,24,1,2,3
4,8476994,Vinnie Hinostroza,C,PIT,29,14,1,2,3
4,8480007,Jonas Rondbjerg,R,VGK,24,17,1,2,3
4,8476867,Brendan Gaunce,C,CBJ,29,8,1,2,3
4,8478904,Steven Lorentz,C,FLA,27,28,1,2,3
4,8479379,Givani Smith,R,SJS,25,26,1,2,3
4,8475780,Chris Wagner,R,BOS,32,27,0,3,3
4,8477034,Jaycob Megna,D,CHI,31,45,0,3,3
4,8478450,Parker Wotherspoon,D,BOS,26,23,0,3,3
4,8477810,Joel Hanley,D,DAL,32,26,0,3,3
4,8480853,Liam Foudy,C,NSH,23,13,0,3,3
4,8475235,Nicolas Deslauriers,L,PHI,32,47,0,3,3
4,8480776,Sheldon Rempal,R,VGK,28,5,2,0,2
4,8471817,Ryan Reaves,R,TOR,36,27,2,0,2
4,8477073,Kurtis MacDermid,D,COL,29,28,2,0,2
4,8479322,Wade Allison,R,PHI,26,26,1,1,2
4,8482133,Thomas Bordeleau,C,SJS,21,6,1,1,2
4,8481006,Tyler Tucker,D,STL,23,16,1,1,2
4,8479362,Riley Tufte,L,COL,25,5,1,1,2
4,8478051,Max Willman,C,NJD,28,13,1,1,2
4,8481532,Alex Turcotte,C,LAK,22,6,1,1,2
4,8480977,Semyon Der-Arguchintsev,C,TOR,23,29,1,1,2
4,8479580,Dylan Gambrell,C,OTT,27,31,0,2,2
4,8471303,Alexander Edler,D,LAK,37,30,0,2,2
4,8480070,Ian Mitchell,D,BOS,24,13,0,2,2
4,8480196,Jacob Bryson,D,BUF,26,8,0,2,2
4,8480870,Bo Groulx,C,ANA,23,32,0,2,2
4,8473473,Milan Lucic,L,BOS,35,4,0,2,2
4,8477464,Nic Petan,C,MIN,28,6,0,2,2
4,8477527,Ross Johnston,L,ANA,29,41,0,2,2
4,8481043,Cole Koepke,L,TBL,25,8,0,2,2
4,8477359,Tucker Poolman,D,VAN,30,26,0,2,2
4,8481056,Spencer Stastney,D,NSH,23,9,1,0,1
4,8480823,Alexander Alexeyev,D,WSH,24,13,1,0,1
4,8476873,Mark Jankowski,C,NSH,29,5,1,0,1
4,8480021,Jack Studnicka,C,SJS,24,14,1,0,1
4,8478409,Anthony Richard,C,BOS,27,4,1,0,1
4,8483570,Ben Meyers,C,COL,25,9,1,0,1
4,8481422,Jacob Lucchini,C,MIN,28,13,1,0,1
4,8479546,Oskar Steen,C,BOS,25,34,1,0,1
4,8481239,Samuel Fagemo,L,LAK,23,8,1,0,1
4,8480831,Alec Regula,D,CHI,23,27,0,1,1
4,8482762,Simon Edvinsson,D,DET,20,2,0,1,1
4,8481161,Jake Christiansen,D,CBJ,24,3,0,1,1
4,8480157,Calle Rosen,D,STL,29,5,0,1,1
4,8479984,Cal Foote,D,NJD,25,4,0,1,1
4,8479321,Lucas Johansen,D,WSH,26,6,0,1,1
4,8479378,Logan Stanley,D,WPG,25,10,0,1,1
4,8478017,Mark Friedman,D,VAN,28,20,0,1,1
4,8482095,Tyler Kleven,D,OTT,21,5,0,1,1
4,8479320,Max Lajoie,D,TOR,26,5,0,1,1
4,8477887,Patrick Brown,C,BOS,31,11,0,1,1
4,8480245,Olle Lycksell,R,PHI,24,5,0,1,1
4,8478146,Matthew Highmore,C,OTT,27,6,0,1,1
4,8480845,Rasmus Kupari,C,WPG,23,21,0,1,1
4,8478512,Austin Czarnik,C,DET,31,18,0,1,1
4,8479367,William Lockwood,R,FLA,25,23,0,1,1
4,8481543,Nikita Alexandrov,C,STL,23,18,0,1,1
4,8483597,Milos Kelemen,L,ARI,24,10,0,1,1
4,8483641,Anton Levtchi,L,FLA,28,27,0,0,0
4,8483565,Nick Blankenburg,D,CBJ,25,6,0,0,0
4,8483620,Marcus Bjork,D,CBJ,26,0,0,0,0
4,8481521,Ronnie Attard,D,PHI,24,0,0,0,0
4,8482399,Billy Sweezey,D,CBJ,27,0,0,0,0
4,8481072,Tim Berni,D,CBJ,23,0,0,0,0
4,8476884,Derrick Pouliot,D,SJS,29,0,0,0,0
4,8482624,Daniil Miromanov,D,VGK,26,2,0,0,0
4,8482861,Vincent Iorio,D,WSH,21,0,0,0,0
4,8478465,Guillaume Brisebois,D,VAN,26,0,0,0,0
4,8484256,Jake Livingstone,D,NSH,24,0,0,0,0
4,8481599,Victor Soderstrom,D,ARI,22,1,0,0,0
4,8474027,Justin Braun,D,PHI,36,0,0,0,0
4,8478062,Dysin Mayo,D,ARI,27,0,0,0,0
4,8481563,Drew Helleson,D,ANA,22,0,0,0,0
4,8481575,Lassi Thomson,D,OTT,23,0,0,0,0
4,8483619,Filip Roos,D,CHI,24,4,0,0,0
4,8481461,Corey Schueneman,D,MTL,28,0,0,0,0
4,8478846,Christian Wolanin,D,VAN,28,0,0,0,0
4,8479395,Dennis Cholowski,D,NYI,25,0,0,0,0
4,8479945,Gavin Bayreuther,D,CBJ,29,0,0,0,0
4,8474818,Jordie Benn,D,TOR,36,0,0,0,0
4,8479421,Jacob Moverare,D,LAK,25,5,0,0,0
4,8479329,Frederic Allard,D,MTL,26,0,0,0,0
4,8481600,Tobias Bjornfot,D,VGK,22,3,0,0,0
4,8477462,Robert Hagg,D,ANA,28,5,0,0,0
4,8476470,Nathan Beaulieu,D,ANA,31,0,0,0,0
4,8484254,Akito Hirose,D,VAN,24,3,0,0,0
4,8479388,Riley Stillman,D,BUF,25,0,0,0,0
4,8482824,Nick Cicek,D,SJS,23,0,0,0,0
4,8480056,Jack Rathbone,D,VAN,24,0,0,0,0
4,8476850,Ryan Murray,D,EDM,30,0,0,0,0
4,8478841,Colton White,D,ANA,26,0,0,0,0
4,8480160,Radim Simek,D,SJS,31,0,0,0,0
4,8478491,Jacob Larsson,D,OTT,26,0,0,0,0
4,8475857,Kevin Gravel,D,NSH,31,0,0,0,0
4,8482067,Connor Mackey,D,NYR,27,1,0,0,0
4,8477433,Ben Harpur,D,NYR,28,0,0,0,0
4,8481572,Ville Heinola,D,WPG,22,0,0,0,0
4,8478415,Jakub Zboril,D,BOS,26,0,0,0,0
4,8477341,Andreas Johnsson,L,SJS,29,0,0,0,0
4,8480216,Jacob Peterson,C,SJS,24,6,0,0,0
4,8477467,Gustav Olofsson,D,SEA,29,0,0,0,0
4,8478476,Kyle Capobianco,D,WPG,26,0,0,0,0
4,8479985,Cale Fleury,D,SEA,25,0,0,0,0
4,8475227,Chris Wideman,D,MTL,33,0,0,0,0
4,8479333,Libor Hajek,D,NYR,25,0,0,0,0
4,8479376,Victor Mete,D,PHI,25,1,0,0,0
4,8480439,Mac Hollowell,D,TOR,25,0,0,0,0
4,8480467,Austin Strand,D,ANA,26,0,0,0,0
4,8477981,Roland McKeown,D,NSH,27,0,0,0,0
4,8474628,Michael Stone,D,CGY,33,0,0,0,0
4,8480034,Joel Teasdale,L,MTL,24,0,0,0,0
4,8481609,Vladislav Kolyachonok,D,ARI,22,1,0,0,0
4,8479602,Jeremy Davies,D,BUF,27,0,0,0,0
4,8479639,Dylan Coghlan,D,CAR,25,0,0,0,0
4,8478506,Gabriel Carlsson,D,WSH,26,0,0,0,0
4,8477463,Steven Santini,D,STL,28,0,0,0,0
4,8478075,Anders Bjork,L,CHI,27,0,0,0,0
4,8484287,Cole McWard,D,VAN,22,1,0,0,0
4,8474145,Robert Bortuzzo,D,NYI,34,15,0,0,0
4,8475625,Matt Irwin,D,WSH,36,0,0,0,0
4,8482179,Justin Richards,C,CBJ,25,0,0,0,0
4,8481649,Joona Luoto,L,CBJ,26,0,0,0,0
4,8479026,Philippe Myers,D,TBL,26,5,0,0,0
4,8480935,Lawrence Pilut,D,BUF,28,0,0,0,0
4,8479578,Casey Fitzgerald,D,FLA,26,0,0,0,0
4,8480071,Robin Salo,D,NYI,25,0,0,0,0
4,8478224,Luke Philp,C,CHI,28,0,0,0,0
4,8484125,Hunter McKown,C,CBJ,21,0,0,0,0
4,8481679,Maxence Guenette,D,OTT,22,1,0,0,0
4,8479423,Alex Nylander,L,PIT,25,5,0,0,0
4,8480441,Trey Fix-Wolansky,R,CBJ,24,1,0,0,0
4,8480820,Filip Kral,D,TOR,24,0,0,0,0
4,8479523,Lucas Carlsson,D,FLA,26,0,0,0,0
4,8479304,Kyle Criscuolo,C,SJS,31,0,0,0,0
4,8474697,Mark Borowiecki,D,NSH,34,0,0,0,0
4,8480842,Filip Hallander,C,PIT,23,0,0,0,0
4,8481725,Elmer Soderblom,L,DET,22,0,0,0,0
4,8479252,Dan Renouf,D,BOS,29,0,0,0,0
4,8481591,Sam Poulin,R,PIT,22,0,0,0,0
4,8475968,Alex Belzile,R,MTL,32,0,0,0,0
4,8475772,Riley Sheahan,C,BUF,32,0,0,0,0
4,8475163,Alex Chiasson,R,DET,33,0,0,0,0
4,8481598,Philip Broberg,D,EDM,22,10,0,0,0
4,8478455,Austin Wagner,L,CHI,26,0,0,0,0
4,8476779,Brad Hunt,D,COL,35,0,0,0,0
4,8479335,Rasmus Asplund,C,NSH,26,0,0,0,0
4,8478967,Lane Pederson,C,CBJ,26,0,0,0,0
4,8481077,John Leonard,L,NSH,25,0,0,0,0
4,8481585,Egor Afanasyev,L,NSH,22,2,0,0,0
4,8483397,Marc McLaughlin,C,BOS,24,0,0,0,0
4,8480443,Kristian Reichel,C,WPG,25,0,0,0,0
4,8481751,Lukas Rousek,R,BUF,24,5,0,0,0
4,8476396,Steven Fogarty,C,MIN,30,0,0,0,0
4,8478881,Brett Seney,L,CHI,27,4,0,0,0
4,8480326,Sheldon Dries,C,VAN,29,0,0,0,0
4,8481433,Taro Hirose,L,DET,27,0,0,0,0
4,8480833,Vitali Kravtsov,R,VAN,24,0,0,0,0
4,8481550,Adam Beckman,L,MIN,22,0,0,0,0
4,8479972,Mason Shaw,C,MIN,25,0,0,0,0
4,8477460,Laurent Dauphin,C,ARI,28,0,0,0,0
4,8476166,Taylor Fedun,D,PIT,35,0,0,0,0
4,8478067,Oskar Lindblom,L,SJS,27,1,0,0,0
4,8479944,Zach Aston-Reese,C,DET,29,1,0,0,0
4,8479465,Drake Caggiula,L,PIT,29,0,0,0,0
4,8481740,Tyce Thompson,R,NJD,24,0,0,0,0
4,8476948,Charles Hudon,L,COL,29,0,0,0,0
4,8480863,Gabriel Fortier,L,TBL,23,0,0,0,0
4,8471887,Patric Hornqvist,R,FLA,36,0,0,0,0
4,8477471,Dillon Heatherington,D,OTT,28,0,0,0,0
4,8481441,Joe Snively,C,WSH,27,3,0,0,0
4,8478173,Hayden Hodgson,R,PHI,27,0,0,0,0
4,8481720,Nick Abruzzese,C,TOR,24,0,0,0,0
4,8478843,Denis Malgin,C,COL,26,0,0,0,0
4,8483630,Pavol Regenda,L,ANA,24,0,0,0,0
4,8478373,Nikita Soshnikov,R,NYI,30,0,0,0,0
4,8482147,Jean-Luc Foudy,C,COL,21,0,0,0,0
4,8478431,Evgeny Svechnikov,L,SJS,27,0,0,0,0
4,8477210,Buddy Robinson,R,CHI,32,0,0,0,0
4,8479404,Henrik Borgstrom,C,WSH,26,0,0,0,0
4,8481712,Matej Blumel,R,DAL,23,0,0,0,0
4,8475278,Byron Froese,C,VGK,32,7,0,0,0
4,8479338,Markus Niemelainen,D,EDM,25,0,0,0,0
4,8471794,Darren Helm,C,COL,36,0,0,0,0
4,8482623,Josh Dunne,C,CBJ,25,0,0,0,0
4,8482641,Matt Kiersted,D,FLA,25,0,0,0,0
4,8476851,Alex Galchenyuk,C,COL,29,0,0,0,0
4,8479366,Logan Brown,C,STL,25,0,0,0,0
4,8480822,Martin Kaut,R,SJS,24,0,0,0,0
4,8482834,Jesper Froden,R,SEA,29,0,0,0,0
4,8480844,Grigori Denisenko,L,VGK,23,3,0,0,0
4,8482635,Mike Hardman,L,CHI,24,0,0,0,0
4,8477357,Saku Maenalanen,R,WPG,29,0,0,0,0
4,8480979,Nathan Smith,C,ARI,25,0,0,0,0
4,8479356,Kieffer Bellows,L,PHI,25,0,0,0,0
4,8475795,Dylan McIlrath,D,WSH,31,1,0,0,0
4,8478400,Colin White,C,PIT,26,9,0,0,0
4,8478446,Glenn Gawdin,C,ANA,26,0,0,0,0
4,8476326,Josh Archibald,R,PIT,31,0,0,0,0
4,8481683,Aidan McDonough,L,VAN,24,0,0,0,0
4,8480267,Sammy Walker,C,MIN,24,4,0,0,0
4,8477520,Jean-Sebastien Dea,C,ARI,29,0,0,0,0
4,8476439,Brett Ritchie,R,ARI,30,0,0,0,0
4,8479518,Fredrik Karlström,C,DAL,25,0,0,0,0
4,8477126,Jayson Megna,C,ANA,33,0,0,0,0
4,8479644,Matt Luff,R,DET,26,0,0,0,0
4,8478211,Dryden Hunt,L,CGY,28,5,0,0,0
4,8480226,Marián Studenic,R,SEA,25,2,0,0,0
4,8480037,Aleksi Heponiemi,C,FLA,24,0,0,0,0
4,8480292,Carson Meyer,R,CBJ,26,0,0,0,0
4,8482634,Alex Steeves,C,TOR,24,1,0,0,0
4,8475178,Zack Kassian,R,ARI,32,0,0,0,0
4,8483524,Shane Wright,C,SEA,19,3,0,0,0
4,8482654,Jackson Cates,C,PHI,26,0,0,0,0
4,8479550,Tanner Laczynski,C,PHI,26,0,0,0,0
4,8479991,Jake Leschyshyn,C,NYR,24,1,0,0,0
4,8474613,Derek Stepan,C,CAR,33,0,0,0,0
4,8478367,Cole Bardreau,C,NYI,30,0,0,0,0
4,8480890,Jan Jenik,R,ARI,23,1,0,0,0
4,8475160,Kyle Clifford,L,TOR,32,0,0,0,0
4,8479705,Jeffrey Viel,L,SJS,26,0,0,0,0
4,8477401,John Hayden,C,SEA,28,2,0,0,0
4,8480846,Sampo Ranta,L,COL,23,0,0,0,0
4,8482691,Aatu Raty,C,VAN,21,0,0,0,0
4,8481070,Hugh McGing,L,STL,25,5,0,0,0
4,8479573,Mikhail Maltsev,L,COL,25,0,0,0,0
4,8482250,Callahan Burke,C,CAR,26,1,0,0,0
4,8481102,Egor Sokolov,L,OTT,23,0,0,0,0
4,8481518,Nolan Foote,L,NJD,23,0,0,0,0
4,8474190,Wayne Simmonds,R,TOR,35,0,0,0,0
4,8474610,Zac Dalpe,C,FLA,34,0,0,0,0
4,8479347,Tyler Benson,L,EDM,25,0,0,0,0
4,8476404,Andy Andreoff,C,NYI,32,0,0,0,0
4,8476390,Joseph Cramarossa,C,MIN,31,0,0,0,0
4,8483549,Lucas Condotta,L,MTL,26,3,0,0,0
4,8482197,Adam Raska,R,MIN,22,5,0,0,0
4,8479533,Joona Koppanen,L,PIT,25,3,0,0,0
4,8479526,Otto Koivula,L,NYI,25,0,0,0,0
4,8479375,William Bitten,C,STL,25,0,0,0,0
4,8474089,Brad Malone,C,EDM,34,0,0,0,0
4,8478058,CJ Suess,L,SJS,29,0,0,0,0
4,8478147,Bokondji Imama,L,ARI,27,0,0,0,0
4,8477320,Anton Blidh,L,NYR,28,1,0,0,0
4,8477993,Justin Kirkland,C,ARI,27,2,0,0,0
4,8480836,Jonathan Gruden,C,PIT,23,5,0,0,0
4,8480032,Shane Bowers,C,NJD,24,3,0,0,0
5,8478402,Connor McDavid,C,EDM,26,80,42,106,148
5,8476453,Nikita Kucherov,R,TBL,30,81,48,80,128
5,8477492,Nathan MacKinnon,C,COL,28,82,44,79,123
5,8477956,David Pastrnak,R,BOS,27,82,50,63,113
5,8479318,Auston Matthews,C,TOR,26,81,75,36,111
5,8477939,William Nylander,R,TOR,27,82,41,68,109
5,8477934,Leon Draisaitl,C,EDM,28,82,38,69,107
5,8478420,Mikko Rantanen,R,COL,27,82,40,63,103
5,8476468,J.T. Miller,C,VAN,30,81,36,66,102
5,8478550,Artemi Panarin,L,NYR,32,82,44,57,101
5,8480012,Elias Pettersson,C,VAN,25,81,40,57,97
5,8478427,Sebastian Aho,C,CAR,26,78,35,59,94
5,8478483,Mitchell Marner,R,TOR,26,81,33,61,94
5,8479314,Matthew Tkachuk,L,FLA,26,82,26,66,92
5,8477933,Sam Reinhart,C,FLA,28,82,51,40,91
5,8471675,Sidney Crosby,C,PIT,36,82,44,47,91
5,8480023,Robert Thomas,C,STL,24,82,29,60,89
5,8480865,Noah Dobson,D,NYI,23,82,11,77,88
5,8476459,Mika Zibanejad,C,NYR,30,81,31,56,87
5,8481559,Jack Hughes,C,NJD,22,65,29,58,87
5,8480069,Cale Makar,D,COL,25,77,18,69,87
5,8478010,Brayden Point,C,TBL,27,82,41,45,86
5,8479407,Jesper Bratt,L,NJD,25,81,29,56,85
5,8478445,Mathew Barzal,C,NYI,26,81,25,59,84
5,8480800,Quinn Hughes,D,VAN,24,81,12,72,84
5,8477409,Carter Verhaeghe,C,FLA,28,82,44,38,82
5,8478864,Kirill Kaprizov,L,MIN,26,75,38,44,82
5,8477960,Adrian Kempe,R,LAK,27,82,30,52,82
5,8480018,Nick Suzuki,C,MTL,24,82,28,53,81
5,8476389,Vincent Trocheck,C,NYR,30,82,27,53,80
5,8477493,Aleksander Barkov,C,FLA,28,76,18,62,80
5,8475786,Zach Hyman,L,EDM,31,81,52,27,79
5,8477404,Jake Guentzel,L,PIT,29,81,32,47,79
5,8475913,Mark Stone,R,VGK,31,81,23,55,78
5,8480027,Jason Robertson,L,DAL,24,82,27,50,77
5,8475167,Victor Hedman,D,TBL,33,80,13,64,77
5,8476887,Filip Forsberg,L,NSH,29,82,37,39,76
5,8473419,Brad Marchand,L,BOS,35,82,37,39,76
5,8474600,Roman Josi,D,NSH,33,82,19,57,76
5,8477946,Dylan Larkin,C,DET,27,76,41,34,75
5,8478444,Brock Boeser,R,VAN,26,81,38,37,75
5,8479337,Alex DeBrincat,R,DET,26,82,25,49,74
5,8470794,Joe Pavelski,C,DAL,39,82,32,41,73
5,8479385,Jordan Kyrou,C,STL,25,82,27,46,73
5,8474564,Steven Stamkos,C,TBL,33,79,34,38,72
5,8482116,Tim Stützle,C,OTT,21,82,17,55,72
5,8479323,Adam Fox,D,NYR,25,72,12,60,72
5,8475184,Chris Kreider,L,NYR,32,82,39,32,71
5,8475168,Matt Duchene,C,DAL,32,81,30,41,71
5,8478403,Jack Eichel,C,VGK,27,70,26,45,71
5,8481540,Cole Caufield,R,MTL,22,82,33,37,70
5,8479542,Brandon Hagel,L,TBL,25,82,30,40,70
5,8475745,Charlie Coyle,C,BOS,31,82,29,41,70
5,8473512,Claude Giroux,R,OTT,35,82,26,44,70
5,8478449,Roope Hintz,C,DAL,27,80,32,37,69
5,8477402,Pavel Buchnevich,L,STL,28,80,28,41,69
5,8480803,Evan Bouchard,D,EDM,24,82,23,46,69
5,8482078,Lucas Raymond,L,DET,21,82,22,47,69
5,8477501,Valeri Nichushkin,R,COL,28,67,36,32,68
5,8478439,Travis Konecny,R,PHI,26,81,35,33,68
5,8475166,John Tavares,C,TOR,33,80,28,40,68
5,8477942,Kevin Fiala,L,LAK,27,82,18,50,68
5,8482093,Seth Jarvis,C,CAR,21,81,28,38,66
5,8475158,Ryan O'Reilly,C,NSH,32,82,28,38,66
5,8478975,Mason Marchment,L,DAL,28,81,26,40,66
5,8471215,Evgeni Malkin,C,PIT,37,82,25,41,66
5,8476454,Ryan Nugent-Hopkins,C,EDM,30,82,23,43,66
5,8476875,Mike Matheson,D,MTL,29,82,14,52,66
5,8474578,Erik Karlsson,D,PIT,33,82,13,53,66
5,8476853,Morgan Rielly,D,TOR,29,79,10,56,66
5,8475794,Tyler Seguin,C,DAL,31,82,27,38,65
5,8476460,Mark Scheifele,C,WPG,30,75,25,40,65
5,8479425,Filip Hronek,D,VAN,26,81,7,58,65
5,8478493,Joel Eriksson Ek,C,MIN,26,82,33,31,64
5,8479343,Clayton Keller,R,ARI,25,82,24,40,64
5,8475172,Nazem Kadri,C,CGY,33,82,23,41,64
5,8475692,Mats Zuccarello,R,MIN,36,73,16,48,64
5,8476539,Jonathan Marchessault,R,VGK,33,81,35,28,63
5,8476399,Blake Coleman,C,CGY,32,82,33,30,63
5,8478366,Frank Vatrano,R,ANA,29,82,32,31,63
5,8480039,Martin Necas,C,CAR,24,76,28,35,63
5,8479999,Casey Mittelstadt,C,BUF,25,82,20,43,63
5,8478440,Dylan Strome,C,WSH,26,82,32,30,62
5,8477500,Bo Horvat,C,NYI,28,81,27,35,62
5,8478873,Troy Terry,R,ANA,26,79,25,37,62
5,8476346,Johnny Gaudreau,L,CBJ,30,81,13,49,62
5,8481557,Matt Boldy,L,MIN,22,75,31,30,61
5,8480797,Joel Farabee,L,PHI,23,81,30,31,61
5,8477940,Nikolaj Ehlers,L,WPG,27,81,24,37,61
5,8480830,Andrei Svechnikov,R,CAR,23,60,24,37,61
5,8475754,Brock Nelson,C,NYI,32,82,33,27,60
5,8478398,Kyle Connor,L,WPG,27,65,31,29,60
5,8480208,Drake Batherson,R,OTT,25,82,26,34,60
5,8471685,Anze Kopitar,C,LAK,36,82,21,39,60
5,8480839,Rasmus Dahlin,D,BUF,23,81,20,40,60
5,8477416,Oliver Bjorkstrand,R,SEA,28,82,14,46,60
5,8474590,John Carlson,D,WSH,33,82,6,54,60
5,8471214,Alex Ovechkin,L,WSH,38,79,26,33,59
5,8477949,Alex Tuch,R,BUF,27,75,26,33,59
5,8480798,Philipp Kurashev,C,CHI,24,75,19,40,59
5,8480036,Miro Heiskanen,D,DAL,24,72,11,48,59
5,8476448,William Karlsson,C,VGK,30,69,28,30,58
5,8471724,Kris Letang,D,PIT,36,82,12,46,58
5,8475726,Tyler Toffoli,R,NJD,31,80,35,22,57
5,8479325,Charlie McAvoy,D,BOS,26,74,12,45,57
5,8480801,Brady Tkachuk,L,OTT,24,82,30,26,56
5,8476881,Tomas Hertl,C,SJS,30,76,27,29,56
5,8478047,Michael Bunting,L,CAR,28,80,24,32,56
5,8474037,James van Riemsdyk,L,BOS,34,78,15,41,56
5,8474679,Gustav Nyquist,C,NSH,34,82,14,42,56
5,8482740,Wyatt Johnston,C,DAL,20,82,25,30,55
5,8478407,Vince Dunn,D,SEA,27,78,14,41,55
5,8475765,Vladimir Tarasenko,R,OTT,32,80,21,32,53
5,8477496,Elias Lindholm,C,VAN,29,81,21,32,53
5,8475784,Jeff Skinner,L,BUF,31,74,21,32,53
5,8477504,Josh Morrissey,D,WPG,28,81,9,44,53
5,8475810,Bryan Rust,R,PIT,31,69,27,25,52
5,8480015,Owen Tippett,R,PHI,24,77,26,26,52
5,8476456,Jonathan Huberdeau,C,CGY,30,81,9,43,52
5,8480002,Nico Hischier,C,NJD,24,70,25,26,51
5,8479420,Tage Thompson,C,BUF,26,72,25,26,51
5,8477951,Nick Schmaltz,C,ARI,27,79,23,28,51
5,8475170,Brayden Schenn,C,STL,32,82,22,29,51
5,8476905,Chandler Stephenson,C,VGK,29,77,20,31,51
5,8476882,Teuvo Teravainen,L,CAR,29,81,25,25,50
5,8477346,MacKenzie Weegar,D,CGY,29,82,22,28,50
5,8474102,David Perron,L,DET,35,76,21,29,50
5,8477497,Sean Monahan,C,WPG,29,83,19,31,50
5,8478414,Timo Meier,R,NJD,27,68,27,22,49
5,8477955,Jared McCann,L,SEA,27,81,26,23,49
5,8482745,Mason McTavish,C,ANA,20,74,26,23,49
5,8481068,Yegor Sharangovich,C,CGY,25,82,24,25,49
5,8478462,Nicolas Roy,C,VGK,26,72,21,28,49
5,8482124,Quinton Byfield,R,LAK,21,80,20,29,49
5,8479525,Ross Colton,C,COL,27,80,19,30,49
5,8474141,Patrick Kane,R,DET,35,51,18,31,49
5,8478542,Evan Rodrigues,C,FLA,30,82,16,33,49
5,8482149,Cole Perfetti,C,WPG,21,81,25,23,48
5,8477935,Sam Bennett,C,FLA,27,70,24,24,48
5,8477456,J.T. Compher,L,DET,28,77,23,25,48
5,8482175,JJ Peterka,R,BUF,21,82,23,25,48
5,8475151,Kyle Palmieri,C,NYI,32,82,23,25,48
5,8480009,Eeli Tolvanen,R,SEA,24,82,20,27,47
5,8478401,Pavel Zacha,C,BOS,26,78,17,30,47
5,8479345,Jakob Chychrun,D,OTT,25,82,15,32,47
5,8481711,Matias Maccelli,L,ARI,23,82,12,35,47
5,8476906,Shayne Gostisbehere,D,DET,30,81,9,38,47
5,8482122,Brock Faber,D,MIN,21,82,4,43,47
5,8478460,Zach Werenski,D,CBJ,26,69,3,44,47
5,8482109,Alexis Lafrenière,L,NYR,22,82,22,24,46
5,8474641,Adam Henrique,C,ANA,33,81,19,27,46
5,8477494,Jonathan Drouin,L,COL,28,80,14,32,46
5,8476792,Torey Krug,D,STL,32,82,4,42,46
5,8475169,Evander Kane,L,EDM,32,81,26,19,45
5,8480893,Kirill Marchenko,R,CBJ,23,79,26,19,45
5,8482079,Marco Rossi,C,MIN,22,82,23,22,45
5,8476458,Ryan Strome,C,ANA,30,79,15,30,45
5,8473994,Jamie Benn,L,DAL,34,82,14,31,45
5,8477426,Nicholas Paul,L,TBL,28,82,22,22,44
5,8474563,Drew Doughty,D,LAK,34,82,17,27,44
5,8478038,Devon Toews,D,COL,29,82,13,31,44
5,8481528,Dylan Cozens,C,BUF,22,79,13,31,44
5,8475798,Mikael Granlund,C,SJS,31,68,11,33,44
5,8474565,Alex Pietrangelo,D,VGK,33,76,6,38,44
5,8479675,Trevor Moore,L,LAK,28,82,25,18,43
5,8478438,Tommy Novak,C,NSH,26,71,20,23,43
5,8482665,Matty Beniers,C,SEA,21,77,19,24,43
5,8478233,Andrew Mangiapane,L,CGY,27,81,18,25,43
5,8481581,Thomas Harley,D,DAL,22,79,17,26,43
5,8476479,Phillip Danault,C,LAK,30,82,16,27,43
5,8475760,Nick Bjugstad,C,ARI,31,82,16,27,43
5,8470613,Brent Burns,D,CAR,38,81,12,31,43
5,8477948,Travis Sanheim,D,PHI,27,80,7,36,43
5,8478474,Lawson Crouse,L,ARI,26,81,28,14,42
5,8475763,Kevin Hayes,R,STL,31,82,17,25,42
5,8477476,Artturi Lehkonen,L,COL,28,47,17,25,42
5,8475171,Oliver Ekman-Larsson,D,FLA,32,82,16,26,42
5,8474586,Jordan Eberle,R,SEA,33,78,15,27,42
5,8480434,Sean Durzi,D,ARI,25,76,11,31,42
5,8475799,Nino Niederreiter,R,WPG,31,81,24,17,41
5,8480014,Gabriel Vilardi,C,WPG,24,61,22,19,41
5,8475149,Marcus Johansson,L,MIN,33,82,17,24,41
5,8477964,Ivan Barbashev,C,VGK,28,81,16,25,41
5,8478055,Gustav Forsling,D,FLA,27,81,13,28,41
5,8477021,Alex Kerfoot,C,ARI,29,82,11,30,41
5,8476462,Dougie Hamilton,D,NJD,30,48,9,32,41
5,8477503,Max Domi,C,TOR,28,82,7,34,41
5,8476979,Erik Gustafsson,D,NYR,31,81,7,34,41
5,8479365,Trent Frederic,C,BOS,25,82,22,18,40
5,8477451,Ryan Hartman,R,MIN,29,77,20,20,40
5,8477429,Andrew Copp,C,DET,29,81,16,24,40
5,8483515,Juraj Slafkovsky,L,MTL,19,82,16,24,40
5,8477998,Warren Foegele,L,EDM,27,82,15,25,40
5,8478519,Anthony Cirelli,C,TBL,26,81,14,26,40
5,8475287,Erik Haula,L,NJD,32,75,13,27,40
5,8482684,Luke Hughes,D,NJD,20,81,13,27,40
5,8480028,Morgan Frost,C,PHI,24,70,12,28,40
5,8478397,Rasmus Andersson,D,CGY,27,78,7,33,40
5,8477450,Jason Dickinson,C,CHI,28,82,24,15,39
5,8479339,Patrik Laine,L,CBJ,25,47,21,18,39
5,8474150,Mikael Backlund,C,CGY,34,82,20,19,39
5,8471218,Blake Wheeler,R,NYR,37,82,15,24,39
5,8478396,Noah Hanifin,D,CGY,26,82,14,25,39
5,8482105,Jake Sanderson,D,OTT,21,79,12,27,39
5,8481542,Moritz Seider,D,DET,22,82,8,31,39
5,8482655,J.J. Moser,D,ARI,23,80,3,36,39
5,8482146,Luke Evangelista,R,NSH,21,80,19,19,38
5,8480064,Josh Norris,C,OTT,24,75,18,20,38
5,8480813,Joe Veleno,C,DET,23,80,15,23,38
5,8476921,Jordan Martinook,L,CAR,31,81,15,23,38
5,8479410,Mikhail Sergachev,D,TBL,25,60,4,34,38
5,8482110,Dawson Mercer,C,NJD,22,81,24,13,37
5,8475191,Reilly Smith,R,PIT,32,76,21,16,37
5,8477952,Robby Fabbri,C,DET,27,68,20,17,37
5,8479992,Michael Rasmussen,C,DET,24,82,19,18,37
5,8475722,Jason Zucker,L,ARI,31,72,15,22,37
5,8476872,Scott Laughton,C,PHI,29,81,12,25,37
5,8476869,Brady Skjei,D,CAR,29,81,10,27,37
5,8478463,Anthony Beauvillier,L,CHI,26,64,10,27,37
5,8476480,Vladislav Namestnikov,C,WPG,31,78,8,29,37
5,8475753,Justin Faulk,D,STL,31,68,5,32,37
5,8476432,Boone Jenner,C,CBJ,30,66,27,9,36
5,8477511,Anthony Mantha,R,WSH,29,78,22,14,36
5,8478046,Danton Heinen,L,BOS,28,74,22,14,36
5,8482475,Yegor Chinakhov,R,CBJ,22,69,20,16,36
5,8476925,Colton Sissons,C,NSH,30,82,19,17,36
5,8478856,Conor Garland,R,VAN,27,81,14,22,36
5,8478891,Mason Appleton,C,WPG,27,81,13,23,36
5,8482113,Anton Lundell,C,FLA,22,78,9,27,36
5,8475764,Cam Fowler,D,ANA,32,82,5,31,36
5,8483808,Andrei Kuzmenko,L,CGY,27,76,16,19,35
5,8473422,Nick Foligno,L,CHI,36,75,16,19,35
5,8477479,Tyler Bertuzzi,L,TOR,28,81,14,21,35
5,8476392,Adam Lowry,C,WPG,30,81,13,22,35
5,8480113,Alex Iafallo,L,WPG,30,81,13,22,35
5,8479987,Morgan Geekie,C,BOS,25,76,12,23,35
5,8476419,Jean-Gabriel Pageau,C,NYI,31,82,10,25,35
5,8475314,Anders Lee,L,NYI,33,82,20,14,34
5,8477425,Miles Wood,L,COL,28,77,19,15,34
5,8478057,Dakota Joshua,C,VAN,27,79,18,16,34
5,8479400,Pierre-Luc Dubois,C,LAK,25,82,17,17,34
5,8482720,Matthew Knies,L,TOR,21,80,15,19,34
5,8478466,Daniel Sprong,R,DET,26,54,14,20,34
5,8478472,Mathieu Joseph,R,OTT,26,72,11,23,34
5,8476483,Rickard Rakell,R,PIT,30,70,9,25,34
5,8477498,Darnell Nurse,D,EDM,28,82,8,26,34
5,8477447,Shea Theodore,D,VGK,28,48,7,27,34
5,8478500,Ivan Provorov,D,CBJ,26,81,7,27,34
5,8475181,Nick Leddy,D,STL,32,82,5,29,34
5,8476880,Tom Wilson,R,WSH,29,81,17,16,33
5,8477505,Alex Wennberg,C,SEA,29,82,13,20,33
5,8480802,Ryan McLeod,C,EDM,24,81,13,20,33
5,8482705,Cole Sillinger,C,CBJ,20,76,12,21,33
5,8475220,Marcus Foligno,L,MIN,32,75,12,21,33
5,8475193,Tomas Tatar,L,SEA,33,78,12,21,33
5,8473986,Alex Killorn,L,ANA,34,63,11,22,33
5,8475218,Mattias Ekholm,D,EDM,33,81,6,27,33
5,8482089,Jake Neighbours,L,STL,21,82,25,7,32
5,8475714,Calle Jarnkrok,C,TOR,32,75,17,15,32
5,8481186,Logan O'Connor,R,COL,27,78,15,17,32
5,8475768,Jaden Schwartz,C,SEA,31,66,15,17,32
5,8478498,Jake DeBrusk,L,BOS,27,80,13,19,32
5,8482667,William Eklund,L,SJS,21,80,12,20,32
5,8477932,Aaron Ekblad,D,FLA,27,64,12,20,32
5,8476958,Jaccob Slavin,D,CAR,29,81,6,26,32
5,8479398,Samuel Girard,D,COL,25,61,6,26,32
5,8482092,Ridly Greig,C,OTT,21,72,17,14,31
5,8475793,Ryan Johansen,C,COL,31,82,17,14,31
5,8474149,Evgenii Dadonov,R,DAL,34,77,15,16,31
5,8481624,Ilya Mikheyev,R,VAN,29,77,14,17,31
5,8482125,Alexander Holtz,R,NJD,21,81,14,17,31
5,8476892,Colton Parayko,D,STL,30,82,13,18,31
5,8478136,Jake Middleton,D,MIN,27,82,12,19,31
5,8482062,Cole Smith,L,NSH,28,81,10,21,31
5,8480145,Neal Pionk,D,WPG,28,81,6,25,31
5,8476438,Brandon Saad,L,STL,31,82,20,10,30
5,8481577,Philip Tomasino,C,NSH,22,68,11,19,30
5,8476292,Ondrej Palat,L,NJD,32,71,10,20,30
5,8473533,Jordan Staal,C,CAR,35,81,10,20,30
5,8478020,Michael Amadio,R,VGK,27,74,10,20,30
5,8474602,Justin Schultz,D,SEA,33,72,9,21,30
5,8478458,Jack Roslovic,C,CBJ,26,58,9,21,30
5,8478507,John Marino,D,NJD,26,81,7,23,30
5,8477950,Tony DeAngelo,D,CAR,28,51,7,23,30
5,8474574,Tyler Myers,D,VAN,33,81,4,26,30
5,8478840,Will Borgen,D,SEA,27,82,4,26,30
5,8471698,T.J. Oshie,R,WSH,37,65,14,15,29
5,8477407,Anthony Duclair,L,SJS,28,76,12,17,29
5,8480817,K'Andre Miller,D,NYR,23,80,11,18,29
5,8476923,Damon Severson,D,CBJ,29,66,10,19,29
5,8477444,Andre Burakovsky,L,SEA,28,51,10,19,29
5,8477969,Marcus Pettersson,D,PIT,27,82,5,24,29
5,8477495,Seth Jones,D,CHI,29,67,3,26,29
5,8476854,Hampus Lindholm,D,BOS,29,82,1,28,29
5,8478013,Jake Walman,D,DET,27,76,15,13,28
5,8479415,Michael McLeod,C,NJD,25,73,14,14,28
5,8476826,Yanni Gourde,C,SEA,32,80,12,16,28
5,8476474,Stefan Noesen,R,CAR,30,52,11,17,28
5,8476927,Teddy Blueger,C,VAN,29,67,7,21,28
5,8476902,Esa Lindell,D,DAL,29,82,4,24,28
5,8473507,Jeff Petry,D,DET,36,73,4,24,28
5,8476331,Dylan DeMelo,D,WPG,30,81,3,25,28
5,8481601,Simon Holmstrom,R,NYI,22,81,19,8,27
5,8480188,Fabian Zetterlund,L,SJS,24,81,16,11,27
5,8474870,Tyler Johnson,C,CHI,33,67,15,12,27
5,8482159,Tyson Foerster,R,PHI,21,78,13,14,27
5,8476981,Josh Anderson,R,MTL,29,78,13,14,27
5,8482157,Will Cuylle,L,NYR,21,82,13,14,27
5,8475744,Evgeny Kuznetsov,C,WSH,31,72,11,16,27
5,8481618,Alex Newhook,C,MTL,22,55,11,16,27
5,8475462,Radko Gudas,D,ANA,33,76,11,16,27
5,8480855,Jack McBain,C,ARI,23,67,10,17,27
5,8476931,Jake McCabe,D,TOR,30,76,9,18,27
5,8477508,Curtis Lazar,C,NJD,28,76,8,19,27
5,8476312,Josh Manson,D,COL,32,77,8,19,27
5,8478178,Darren Raddysh,D,TBL,27,82,6,21,27
5,8476885,Jacob Trouba,D,NYR,29,80,5,22,27
5,8476463,Jonas Brodin,D,MIN,30,64,5,22,27
5,8475200,Dmitry Orlov,D,CAR,32,81,4,23,27
5,8476879,Cody Ceci,D,EDM,30,82,1,26,27
5,8479619,Michael Carcone,L,ARI,27,76,20,6,26
5,8480459,Pius Suter,C,VAN,27,67,17,9,26
5,8476918,Jimmy Vesey,L,NYR,30,80,16,10,26
5,8480185,Eetu Luostarinen,C,FLA,25,82,13,13,26
5,8481604,Pavel Dorofeyev,L,VGK,23,57,13,13,26
5,8479351,Sam Steel,C,DAL,25,77,12,14,26
5,8481533,Trevor Zegras,C,ANA,22,48,10,16,26
5,8482055,Drew O'Connor,L,PIT,25,82,10,16,26
5,8481032,Paul Cotter,C,VGK,24,80,9,17,26
5,8480336,Sean Walker,D,PHI,29,81,5,21,26
5,8482671,Owen Power,D,BUF,21,79,5,21,26
5,8478469,Thomas Chabot,D,OTT,26,60,3,23,26
5,8474157,Max Pacioretty,L,WSH,35,47,12,13,25
5,8478043,Sam Lafferty,C,VAN,28,79,12,13,25
5,8481580,Connor McMichael,C,WSH,22,80,11,14,25
5,8478115,Pierre Engvall,L,NYI,27,76,11,14,25
5,8481582,Nicholas Robertson,L,TOR,22,64,9,16,25
5,8475455,Brenden Dillon,D,WPG,33,78,8,17,25
5,8476897,Oskar Sundqvist,C,STL,29,82,7,18,25
5,8480873,Rasmus Sandin,D,WSH,23,74,3,22,25
5,8480049,Dylan Samberg,D,WPG,24,81,3,22,25
5,8475690,Chris Tanev,D,CGY,34,79,3,22,25
5,8481535,Nils Hoglander,L,VAN,23,53,17,7,24
5,8473449,Kyle Okposo,R,BUF,35,79,16,8,24
5,8479941,Justin Danforth,R,CBJ,30,81,12,12,24
5,8470621,Corey Perry,R,EDM,38,54,11,13,24
5,8474884,Mike Hoffman,C,SJS,34,79,9,15,24
5,8481524,Bowen  Byram,D,COL,22,74,9,15,24
5,8481546,Cam York,D,PHI,22,81,9,15,24
5,8475791,Taylor Hall,L,CHI,32,37,9,15,24
5,8480835,Jack Drury,C,CAR,23,53,8,16,24
5,8482245,Artem Zub,D,OTT,28,72,5,19,24
5,8476457,Adam Larsson,D,SEA,31,82,5,19,24
5,8480043,Timothy Liljegren,D,TOR,24,65,5,19,24
5,8478413,Jordan Greenway,L,BUF,26,70,12,11,23
5,8481560,Arthur Kaliyev,R,LAK,22,68,12,11,23
5,8480829,Jesperi Kotkaniemi,C,CAR,23,81,11,12,23
5,8478109,Victor Olofsson,L,BUF,28,63,10,13,23
5,8479359,Beck Malenstyn,L,WSH,25,81,9,14,23
5,8477953,Kasperi Kapanen,R,STL,27,75,6,17,23
5,8478851,Alexandre Carrier,D,NSH,27,77,5,18,23
5,8480246,Nick Perbix,D,TBL,25,80,5,18,23
5,8477986,Brandon Montour,D,FLA,29,66,4,19,23
5,8478133,Jake Evans,C,MTL,27,82,4,19,23
5,8475197,Tyson Barrie,D,NSH,32,62,2,21,23
5,8477330,Dominik Kubalik,L,OTT,28,78,18,4,22
5,8477944,Jakub Vrana,L,STL,27,49,16,6,22
5,8482699,Dylan Guenther,R,ARI,20,45,14,8,22
5,8474040,Sam Gagner,C,EDM,34,55,12,10,22
5,8479390,Taylor Raddysh,R,CHI,25,77,12,10,22
5,8474189,Lars Eller,C,PIT,34,82,11,11,22
5,8482097,Jack Quinn,R,BUF,22,45,10,12,22
5,8476374,Sean Kuraly,C,CBJ,30,73,10,12,22
5,8477989,Christian Dvorak,C,MTL,27,52,9,13,22
5,8480068,Ryan Poehling,C,PHI,24,76,8,14,22
5,8471699,Andrew Cogliano,C,COL,36,76,8,14,22
5,8475164,Jakob Silfverberg,R,ANA,33,81,6,16,22
5,8475279,Ben Chiarot,D,DET,32,77,5,17,22
5,8477839,Conor Sheary,L,TBL,31,64,5,17,22
5,8474151,Ryan McDonagh,D,NSH,34,75,3,19,22
5,8475790,Erik Gudbranson,D,CBJ,31,77,3,19,22
5,8479983,Mario Ferraro,D,SJS,25,77,2,20,22
5,8475343,Nic Dowd,C,WSH,33,73,11,10,21
5,8479591,Michael Eyssimont,C,TBL,27,81,11,10,21
5,8475855,Jesper Fast,R,CAR,32,78,7,14,21
5,8482087,Kaiden Guhle,D,MTL,21,78,6,15,21
5,8481656,Aliaksei Protas,C,WSH,22,52,4,17,21
5,8476960,Andreas Athanasiou,C,CHI,29,38,10,10,20
5,8470638,Patrice Bergeron,C,BOS,38,27,9,11,20
5,8481093,Rafael Harvey-Pinard,L,MTL,24,51,9,11,20
5,8479353,Brett Howden,C,VGK,25,79,8,12,20
5,8480078,Filip Chytil,C,NYR,24,38,8,12,20
5,8475233,David Savard,D,MTL,33,60,6,14,20
5,8478859,Niko Mikkola,D,FLA,27,82,5,15,20
5,8480878,Nils Lundkvist,D,DAL,23,70,4,16,20
5,8478443,Brandon Carlo,D,BOS,27,77,4,16,20
5,8475188,Brayden McNabb,D,VGK,32,81,3,17,20
5,8479998,Mikey Anderson,D,LAK,24,82,3,17,20
5,8476917,Adam Pelech,D,NYI,29,58,1,19,20
5,8475179,Dmitry Kulikov,D,FLA,33,78,0,20,20
5,8476469,Joel Armia,R,MTL,30,66,15,4,19
5,8478042,Viktor Arvidsson,R,LAK,30,32,8,11,19
5,8482222,Alexander Barabanov,L,SJS,29,61,7,12,19
5,8481596,Shane Pinto,C,OTT,23,41,6,13,19
5,8476329,Travis Boyd,C,ARI,30,45,6,13,19
5,8481523,Kirby Dach,C,MTL,22,29,6,13,19
5,8478882,Vladislav Gavrikov,D,LAK,28,77,5,14,19
5,8479980,Nicolas Hague,D,VGK,25,73,4,15,19
5,8476889,Radek Faksa,C,DAL,29,74,4,15,19
5,8476822,Luke Glendening,C,TBL,34,82,14,4,18
5,8480281,Alexey Toropchenko,R,STL,24,82,12,6,18
5,8479661,Tanner Jeannot,L,TBL,26,68,9,9,18
5,8479393,Noah Gregor,C,TOR,25,81,8,10,18
5,8470604,Jeff Carter,C,PIT,38,76,8,10,18
5,8474053,Logan Couture,C,SJS,34,34,5,13,18
5,8482142,Jamie Drysdale,D,PHI,21,49,5,13,18
5,8481568,Alex Vlasic,D,CHI,22,76,4,14,18
5,8481522,Peyton Krebs,C,BUF,22,80,4,14,18
5,8482073,Braden Schneider,D,NYR,22,82,3,15,18
5,8476473,Connor Murphy,D,CHI,30,70,3,15,18
5,8470600,Ryan Suter,D,DAL,38,82,2,16,18
5,8478831,Kevin Stenlund,C,FLA,27,82,12,5,17
5,8479977,Kailer Yamamoto,R,SEA,25,73,10,7,17
5,8474166,Alec Martinez,D,VGK,36,64,8,9,17
5,8480821,Filip Zadina,R,SJS,24,48,7,10,17
5,8482111,Justin Barron,D,MTL,22,68,6,11,17
5,8480035,Henri Jokiharju,D,BUF,24,74,5,12,17
5,8477507,Nikita Zadorov,D,VAN,28,75,5,12,17
5,8474161,Jakub Voracek,R,CBJ,34,29,4,13,17
5,8473563,Nicklas Backstrom,C,WSH,36,37,4,13,17
5,8478911,Matt Roy,D,LAK,28,81,3,14,17
5,8475825,Jani Hakanpää,D,DAL,31,82,3,14,17
5,8475906,John Klingberg,D,TOR,31,43,2,15,17
5,8474673,TJ Brodie,D,TOR,33,81,0,17,17
5,8475231,Casey Cizikas,C,NYI,32,71,9,7,16
5,8477947,Sonny Milano,L,WSH,27,53,8,8,16
5,8475848,Brendan Gallagher,R,MTL,31,50,8,8,16
5,8476422,Mike Reilly,D,NYI,30,61,6,10,16
5,8477435,Ryan Graves,D,PIT,28,82,6,10,16
5,8482660,Kent Johnson,C,CBJ,21,36,6,10,16
5,8477919,Frederick Gaudreau,C,MIN,30,70,5,11,16
5,8480796,Martin Fehervary,D,WSH,24,76,4,12,16
5,8474034,Pat Maroon,L,MIN,35,49,4,12,16
5,8477488,Brett Pesce,D,CAR,29,71,4,12,16
5,8481606,Jordan Spence,D,LAK,22,44,0,16,16
5,8470610,Zach Parise,L,COL,39,33,11,4,15
5,8482101,Danil Gushchin,L,SJS,21,30,10,5,15
5,8473453,Trevor Lewis,C,LAK,36,82,10,5,15
5,8478508,Yakov Trenin,C,NSH,26,79,9,6,15
5,8481704,Juuso Parssinen,C,NSH,22,71,9,6,15
5,8478468,Jeremy Lauzon,D,NSH,26,82,8,7,15
5,8481013,Jonatan Berggren,R,DET,23,37,8,7,15
5,8477506,Ryan Pulock,D,NYI,29,58,7,8,15
5,8477987,Ryan Donato,C,CHI,27,51,6,9,15
5,8479346,Dillon Dube,C,CGY,25,70,6,9,15
5,8475208,Brian Dumoulin,D,SEA,32,80,5,10,15
5,8481014,Alexander Romanov,D,NYI,23,81,5,10,15
5,8481178,Egor Zamula,D,PHI,23,44,5,10,15
5,8480848,Ty Dellandrea,C,DAL,23,53,4,11,15
5,8476624,Barclay Goodrow,C,NYR,30,80,4,11,15
5,8480172,Jan Rutta,D,SJS,33,75,3,12,15
5,8479976,Juuso Valimaki,D,ARI,25,68,2,13,15
5,8481605,Jackson LaCombe,D,ANA,22,76,2,13,15
5,8477845,Trevor van Riemsdyk,D,WSH,32,70,2,13,15
5,8471274,Alex Goligoski,D,MIN,38,58,1,14,15
5,8480994,Damien Giroux,C,MIN,23,28,0,15,15
5,8477365,Connor Clifton,D,BUF,28,79,0,15,15
5,8481554,Kaapo Kakko,R,NYR,22,61,9,5,14
5,8480849,Barrett Hayton,C,ARI,23,50,6,8,14
5,8473548,Phil Kessel,R,VGK,36,28,6,8,14
5,8479996,Cody Glass,C,NSH,24,54,5,9,14
5,8480883,Ty Smith,D,PIT,23,31,5,9,14
5,8480144,David Kampf,C,TOR,28,78,5,9,14
5,8474031,Kevin Shattenkirk,D,BOS,34,44,5,9,14
5,8478970,Jalen Chatfield,D,CAR,27,48,5,9,14
5,8477979,Nicolas Aube-Kubel,R,WSH,27,39,5,9,14
5,8480220,Noah Cates,L,PHI,24,59,4,10,14
5,8473504,Cal Clutterbuck,R,NYI,36,53,4,10,14
5,8477380,Jonny Brodzinski,C,NYR,30,35,4,10,14
5,8478416,Erik Cernak,D,TBL,26,71,3,11,14
5,8482192,Isaak Phillips,D,CHI,22,56,1,13,14
5,8475324,Nick Jensen,D,WSH,33,82,0,14,14
5,8479316,Luke Kunin,C,SJS,26,76,9,4,13
5,8471276,David Krejci,C,BOS,37,27,9,4,13
5,8480289,Morgan Barron,C,WPG,25,51,9,4,13
5,8480192,Johnathan Kovacevic,D,MTL,26,74,9,4,13
5,8479293,Brandon Tanev,L,SEA,32,66,8,5,13
5,8477446,Michael McCarron,R,NSH,28,43,7,6,13
5,8482259,Bobby McMann,C,TOR,27,29,7,6,13
5,8480448,Parker Kelly,L,OTT,24,51,6,7,13
5,8482117,Lukas Reichel,L,CHI,21,77,5,8,13
5,8476410,Josh Leivo,L,STL,30,28,4,9,13
5,8480762,Eric Robinson,L,BUF,28,54,4,9,13
5,8479324,Ryan Lindgren,D,NYR,25,80,3,10,13
5,8478399,Jonas Siegenthaler,D,NJD,26,66,3,10,13
5,8476467,Jamie Oleksiak,D,SEA,31,82,3,10,13
5,8476429,Scott Mayfield,D,NYI,31,67,3,10,13
5,8474716,Jared Spurgeon,D,MIN,34,44,2,11,13
5,8476967,Brett Kulak,D,EDM,29,82,2,11,13
5,8471677,Jack Johnson,D,COL,36,80,2,11,13
5,8474567,Zach Bogosian,D,MIN,33,70,2,11,13
5,8477220,Nate Schmidt,D,WPG,32,75,2,11,13
5,8480807,Mattias Samuelsson,D,BUF,23,69,1,12,13
5,8478569,Noel Acciari,C,PIT,32,70,8,4,12
5,8479336,Carl Grundstrom,R,LAK,26,50,8,4,12
5,8477903,Garnet Hathaway,R,PHI,32,81,7,5,12
5,8476858,Phillip Di Giuseppe,L,VAN,30,62,6,6,12
5,8481517,Brett Leason,R,ANA,24,43,6,6,12
5,8480806,Isac Lundestrom,C,ANA,24,46,5,7,12
5,8480748,Kiefer Sherwood,L,NSH,28,41,5,7,12
5,8474683,Derek Grant,C,ANA,33,28,5,7,12
5,8475177,Calvin de Haan,D,TBL,32,72,4,8,12
5,8480891,Michael Kesselring,D,ARI,23,36,4,8,12
5,8482679,Matt Coronato,R,CGY,21,42,4,8,12
5,8477499,Rasmus Ristolainen,D,PHI,29,57,3,9,12
5,8480073,Erik Brannstrom,D,OTT,24,45,3,9,12
5,8476874,Olli Maatta,D,DET,29,46,2,10,12
5,8478432,Christian Fischer,R,DET,26,51,2,10,12
5,8477015,Connor Brown,R,EDM,29,75,2,10,12
5,8480001,Urho Vaakanainen,D,ANA,24,74,1,11,12
5,8480884,Calen Addison,D,SJS,23,45,1,11,12
5,8476941,Connor Carrick,D,BOS,29,27,1,11,12
5,8480860,Kevin Bahl,D,NJD,23,81,0,12,12
5,8475225,Craig Smith,C,DAL,34,50,7,4,11
5,8481481,Blake Lizotte,C,LAK,26,64,6,5,11
5,8479322,Wade Allison,R,PHI,26,26,6,5,11
5,8480205,Emil Bemstrom,R,CBJ,24,31,5,6,11
5,8478585,Derek Ryan,C,EDM,37,51,5,6,11
5,8477406,Mattias Janmark,C,EDM,31,71,4,7,11
5,8482730,Brandt Clarke,D,LAK,20,38,4,7,11
5,8480879,Jacob Bernard-Docker,D,OTT,23,42,4,7,11
5,8474013,Ian Cole,D,VAN,34,80,3,8,11
5,8476525,Colin Miller,D,NJD,31,61,2,9,11
5,8477454,Adam Erne,L,EDM,28,54,8,2,10
5,8480328,David Gust,R,CHI,29,27,7,3,10
5,8475842,Sam Carrick,C,ANA,31,54,7,3,10
5,8480980,Connor Dewar,C,MIN,24,48,7,3,10
5,8478421,A.J. Greer,L,CGY,27,47,6,4,10
5,8478495,Denis Gurianov,R,NSH,26,40,5,5,10
5,8478131,Ondrej Kase,R,CAR,28,28,5,5,10
5,8476393,Nick Cousins,C,FLA,30,70,4,6,10
5,8476871,Tanner Pearson,L,MTL,31,36,4,6,10
5,8478434,Keegan Kolesar,R,VGK,26,50,4,6,10
5,8474612,Travis Hamonic,D,OTT,33,75,4,6,10
5,8482712,Oskar Olausson,R,COL,21,28,4,6,10
5,8476442,Matt Nieto,L,PIT,31,53,3,7,10
5,8473544,Derick Brassard,C,OTT,36,31,3,7,10
5,8479414,Nathan Bastian,R,NJD,26,51,3,7,10
5,8479543,Michael Pezzetta,L,MTL,25,44,3,7,10
5,8480913,Jordan Gross,D,NSH,28,27,3,7,10
5,8476915,Jujhar Khaira,L,MIN,29,29,3,7,10
5,8477335,Kyle Burroughs,D,SJS,28,74,2,8,10
5,8479371,Dante Fabbro,D,NSH,25,42,2,8,10
5,8480887,Jordan Harris,D,MTL,23,58,1,9,10
5,8475718,Justin Holl,D,DET,31,63,0,10,10
5,8481690,Tyler Angle,C,CBJ,23,29,6,3,9
5,8479291,Kevin Rooney,C,CGY,30,33,6,3,9
5,8479718,Alex Barré-Boulet,C,TBL,26,35,6,3,9
5,8479383,Boris Katchouk,L,CHI,25,35,5,4,9
5,8479328,Julien Gauthier,R,NYI,26,27,5,4,9
5,8480727,Zach Whitecloud,D,VGK,27,65,4,5,9
5,8479402,Jake Bean,D,CBJ,25,49,4,5,9
5,8481567,Henry Thrun,D,SJS,22,51,3,6,9
5,8477846,Ryan Carpenter,C,SJS,32,36,3,6,9
5,8480008,Adam Ruzicka,C,ARI,24,41,3,6,9
5,8478028,Fredrik Olofsson,L,COL,27,53,3,6,9
5,8479442,Troy Stecher,D,ARI,29,71,2,7,9
5,8479315,Joey Anderson,R,CHI,25,28,2,7,9
5,8473604,Jonathan Toews,C,CHI,35,27,2,7,9
5,8475461,Andrew Agozzino,L,SJS,32,28,2,7,9
5,8476441,Joel Edmundson,D,WSH,30,66,2,7,9
5,8481527,Kaedan Korczak,D,VGK,22,26,1,8,9
5,8477018,Ben Hutton,D,VGK,30,31,1,8,9
5,8483460,David Jiricek,D,CBJ,20,36,1,8,9
5,8474573,Josh Bailey,R,NYI,34,29,1,8,9
5,8476372,Nick Seeler,D,PHI,30,55,0,9,9
5,8477353,Tyler Motte,C,TBL,28,72,5,3,8
5,8480031,Max Comtois,L,ANA,24,28,5,3,8
5,8476856,Matt Dumba,D,ARI,29,78,4,4,8
5,8480252,Cole Guttman,C,CHI,24,27,4,4,8
5,8479368,Max Jones,L,ANA,25,38,4,4,8
5,8481477,Nico Sturm,C,SJS,28,34,3,5,8
5,8477392,Hudson Fasching,R,NYI,28,35,3,5,8
5,8477070,Liam O'Brien,C,ARI,29,49,3,5,8
5,8480058,Pierre-Olivier Joseph,D,PIT,24,53,2,6,8
5,8480995,Pontus Holmberg,R,TOR,24,27,2,6,8
5,8479514,Rem Pitlick,C,CHI,26,36,2,6,8
5,8479576,Vincent Desharnais,D,EDM,27,49,1,7,8
5,8477971,Andreas Englund,D,LAK,27,52,1,7,8
5,8477034,Jaycob Megna,D,CHI,31,45,1,7,8
5,8474162,Jake Muzzin,D,TOR,34,29,0,8,8
5,8479439,Jacob MacDonald,D,SJS,30,21,6,1,7
5,8471709,Marc-Edouard Vlasic,D,SJS,36,31,5,2,7
5,8477478,William Carrier,L,VGK,29,33,5,2,7
5,8477573,Nathan Walker,L,STL,29,18,5,2,7
5,8482241,Radim Zohorna,L,PIT,27,31,4,3,7
5,8482451,Mikael Pyyhtia,L,CBJ,22,29,3,4,7
5,8481754,Nikita Nesterenko,C,ANA,22,28,3,4,7
5,8481058,Jesse Ylönen,R,MTL,24,43,3,4,7
5,8480901,Karson Kuhlman,C,WPG,28,30,3,4,7
5,8474009,Nick Bonino,C,NYR,35,73,2,5,7
5,8476891,Matt Grzelcyk,D,BOS,29,41,2,5,7
5,8479458,Nikita Zaitsev,D,CHI,32,26,2,5,7
5,8477541,Dakota Mermis,D,MIN,29,37,2,5,7
5,8478099,Kevin Labanc,R,SJS,28,32,2,5,7
5,8481641,Joel Kiviranta,L,COL,27,40,2,5,7
5,8480880,Jakub Lauko,C,BOS,23,40,2,5,7
5,8470966,Mark Giordano,D,TOR,40,36,1,6,7
5,8481537,Nikita Okhotiuk,D,SJS,23,38,1,6,7
5,8478502,Dennis Gilbert,D,CGY,27,31,1,6,7
5,8478104,Sammy Blais,L,STL,27,43,1,6,7
5,8476449,Scott Harrington,D,ANA,30,28,1,6,7
5,8483424,Owen Beck,C,MTL,19,27,1,6,7
5,8482711,Stanislav Svozil,D,CBJ,20,29,0,7,7
5,8476988,Matt Benning,D,SJS,29,42,0,7,7
5,8480871,Adam Boqvist,D,CBJ,23,22,0,7,7
5,8479520,Brandon Duhaime,R,MIN,26,54,4,2,6
5,8479066,Ryan Lomberg,L,FLA,29,55,4,2,6
5,8471669,Paul Stastny,C,CAR,38,28,3,3,6
5,8482448,Samuel Knazko,D,CBJ,21,29,3,3,6
5,8476278,Colin Blackwell,C,CHI,30,25,3,3,6
5,8479968,Vinni Lettieri,C,MIN,28,24,3,3,6
5,8482452,Elliot Desnoyers,L,PHI,21,26,3,3,6
5,8477369,Carson Soucy,D,VAN,29,21,2,4,6
5,8482496,Nils Aman,C,VAN,23,31,2,4,6
5,8480789,Oliver Wahlstrom,R,NYI,23,27,2,4,6
5,8471303,Alexander Edler,D,LAK,37,30,2,4,6
5,8480831,Alec Regula,D,CHI,23,27,2,4,6
5,8480222,Sebastian Aho,D,NYI,27,41,1,5,6
5,8474568,Luke Schenn,D,NSH,34,36,1,5,6
5,8479982,Conor Timmins,D,TOR,25,16,1,5,6
5,8471873,Anton Stralman,D,BOS,37,27,1,5,6
5,8482516,Matthew Kessel,D,STL,23,47,0,6,6
5,8479369,Andrew Peeke,D,CBJ,25,20,0,6,6
5,8475797,Jarred Tinordi,D,CHI,31,32,0,6,6
5,8479372,Josh Mahura,D,FLA,25,20,0,6,6
5,8475762,Derek Forbort,D,BOS,31,57,0,6,6
5,8477930,Pierre-Edouard Bellemare,L,SEA,38,29,4,1,5
5,8480184,Gustav Lindström,D,ANA,25,22,3,2,5
5,8477941,Nick Ritchie,L,CGY,28,27,2,3,5
5,8478408,Travis Dermott,D,ARI,27,37,2,3,5
5,8482964,Arber Xhekaj,D,MTL,22,24,2,3,5
5,8475750,Jon Merrill,D,MIN,31,38,2,3,5
5,8474618,Marco Scandella,D,STL,33,49,2,3,5
5,8480025,MacKenzie Entwistle,R,CHI,24,46,2,3,5
5,8479536,Axel Jonsson-Fjallby,L,WPG,25,26,2,3,5
5,8480041,Dmitri Samorukov,D,STL,24,28,2,3,5
5,8477931,Tomas Nosek,L,NJD,31,40,1,4,5
5,8480275,Nick Swaney,R,MIN,26,28,1,4,5
5,8474090,Brendan Smith,D,NJD,34,36,1,4,5
5,8477384,Josh Brown,D,ARI,29,28,1,4,5
5,8481708,Zac Jones,D,NYR,23,17,1,4,5
5,8480084,Nick DeSimone,D,NJD,29,23,1,4,5
5,8479671,Mathieu Olivier,R,CBJ,26,25,1,4,5
5,8479547,Matthew Phillips,R,PIT,25,27,1,4,5
5,8476919,Chris Tierney,C,NJD,29,28,1,4,5
5,8476952,Dominic Toninato,C,WPG,29,15,1,4,5
5,8482652,Walker Duehr,R,CGY,26,26,1,4,5
5,8481167,Brayden Pachal,D,CGY,24,50,1,4,5
5,8479580,Dylan Gambrell,C,OTT,27,31,1,4,5
5,8480950,Ilya Lyubushkin,D,ANA,29,79,0,5,5
5,8482181,Tristen Robins,C,SJS,22,28,0,5,5
5,8477851,Jordan Oesterle,D,CGY,31,48,0,5,5
5,8477482,Zach Sanford,L,CHI,29,26,0,5,5
5,8481617,Vasily Podkolzin,R,VAN,22,26,4,0,4
5,8476878,Zemgus Girgensons,L,BUF,29,36,4,0,4
5,8482077,Dylan Holloway,L,EDM,22,23,3,1,4
5,8480011,Klim Kostin,C,DET,24,32,3,1,4
5,8480242,Arnaud Durandeau,L,NYI,24,29,2,2,4
5,8479370,Tyson Jost,C,BUF,25,29,2,2,4
5,8481019,David Gustafsson,C,WPG,23,27,2,2,4
5,8479981,Jonah Gadjovich,L,FLA,25,27,2,2,4
5,8481812,Nikolai Knyzhov,D,SJS,26,38,1,3,4
5,8477938,Haydn Fleury,D,TBL,27,16,1,3,4
5,8480003,Jesper Boqvist,C,BOS,25,20,1,3,4
5,8479994,Jaret Anderson-Dolan,C,LAK,24,24,1,3,4
5,8475752,Tyler Pitlick,C,NYR,32,34,1,3,4
5,8476913,Devin Shore,C,SEA,29,21,1,3,4
5,8482207,William Dufour,R,NYI,21,29,1,3,4
5,8478870,Rudolfs Balcers,L,TBL,26,26,1,3,4
5,8483464,Marco Kasper,C,DET,19,28,0,4,4
5,8482176,Wyatt Kaiser,D,CHI,21,23,0,4,4
5,8478452,Caleb Jones,D,COL,26,20,0,4,4
5,8478454,Noah Juulsen,D,VAN,26,38,0,4,4
5,8478424,Jansen Harkins,C,PIT,26,34,0,4,4
5,8477359,Tucker Poolman,D,VAN,30,26,0,4,4
5,8473446,Erik Johnson,D,BUF,35,46,3,0,3
5,8480874,Adam Ginning,D,PHI,23,26,2,1,3
5,8481147,Reese Johnson,C,CHI,25,34,2,1,3
5,8478078,Rourke Chartier,C,OTT,27,34,2,1,3
5,8474709,Matt Martin,L,NYI,34,31,2,1,3
5,8479772,Zack MacEwen,R,OTT,27,22,2,1,3
5,8477962,Brendan Lemieux,L,CAR,27,23,2,1,3
5,8475766,Austin Watson,L,TBL,31,28,2,1,3
5,8480468,James Hamblin,L,EDM,24,31,2,1,3
5,8480355,Mark Kastelic,C,OTT,24,34,2,1,3
5,8480072,Lias Andersson,C,LAK,25,30,1,2,3
5,8474218,Jason Demers,D,EDM,35,31,1,2,3
5,8481592,Jakob Pelletier,L,CGY,22,31,1,2,3
5,8481122,Simon Benoit,D,TOR,25,39,1,2,3
5,8478451,Ethan Bear,D,WSH,26,16,1,2,3
5,8471686,Marc Staal,D,PHI,36,20,1,2,3
5,8477244,Chad Ruhwedel,D,PIT,33,37,1,2,3
5,8481541,Samuel Bolduc,D,NYI,23,33,1,2,3
5,8476934,Brock McGinn,L,ANA,29,24,1,2,3
5,8476994,Vinnie Hinostroza,C,PIT,29,14,1,2,3
5,8480007,Jonas Rondbjerg,R,VGK,24,17,1,2,3
5,8476867,Brendan Gaunce,C,CBJ,29,8,1,2,3
5,8478904,Steven Lorentz,C,FLA,27,28,1,2,3
5,8479379,Givani Smith,R,SJS,25,26,1,2,3
5,8475780,Chris Wagner,R,BOS,32,27,1,2,3
5,8474207,Nick Holden,D,OTT,36,31,0,3,3
5,8475747,Patrik Nemeth,D,ARI,31,29,0,3,3
5,8478450,Parker Wotherspoon,D,BOS,26,23,0,3,3
5,8477810,Joel Hanley,D,DAL,32,26,0,3,3
5,8480853,Liam Foudy,C,NSH,23,13,0,3,3
5,8475235,Nicolas Deslauriers,L,PHI,32,47,0,3,3
5,8483641,Anton Levtchi,L,FLA,28,27,0,3,3
5,8480776,Sheldon Rempal,R,VGK,28,5,2,0,2
5,8471817,Ryan Reaves,R,TOR,36,27,2,0,2
5,8477073,Kurtis MacDermid,D,COL,29,28,2,0,2
5,8470595,Eric Staal,C,FLA,39,27,1,1,2
5,8482081,Sean Farrell,C,MTL,22,27,1,1,2
5,8482133,Thomas Bordeleau,C,SJS,21,6,1,1,2
5,8481006,Tyler Tucker,D,STL,23,16,1,1,2
5,8479362,Riley Tufte,L,COL,25,5,1,1,2
5,8478051,Max Willman,C,NJD,28,13,1,1,2
5,8481532,Alex Turcotte,C,LAK,22,6,1,1,2
5,8479344,Jesse Puljujarvi,R,PIT,25,36,0,2,2
5,8476310,Lukas Sedlak,C,PHI,30,26,0,2,2
5,8480070,Ian Mitchell,D,BOS,24,13,0,2,2
5,8480196,Jacob Bryson,D,BUF,26,8,0,2,2
5,8480870,Bo Groulx,C,ANA,23,32,0,2,2
5,8473473,Milan Lucic,L,BOS,35,4,0,2,2
5,8477464,Nic Petan,C,MIN,28,6,0,2,2
5,8477527,Ross Johnston,L,ANA,29,41,0,2,2
5,8481043,Cole Koepke,L,TBL,25,8,0,2,2
5,8481056,Spencer Stastney,D,NSH,23,9,1,0,1
5,8480823,Alexander Alexeyev,D,WSH,24,13,1,0,1
5,8476873,Mark Jankowski,C,NSH,29,5,1,0,1
5,8480021,Jack Studnicka,C,SJS,24,14,1,0,1
5,8478409,Anthony Richard,C,BOS,27,4,1,0,1
5,8483570,Ben Meyers,C,COL,25,9,1,0,1
5,8481422,Jacob Lucchini,C,MIN,28,13,1,0,1
5,8479546,Oskar Steen,C,BOS,25,34,1,0,1
5,8481239,Samuel Fagemo,L,LAK,23,8,1,0,1
5,8479348,Kale Clague,D,BUF,25,28,0,1,1
5,8480977,Semyon Der-Arguchintsev,C,TOR,23,29,0,1,1
5,8482762,Simon Edvinsson,D,DET,20,2,0,1,1
5,8481161,Jake Christiansen,D,CBJ,24,3,0,1,1
5,8480157,Calle Rosen,D,STL,29,5,0,1,1
5,8479984,Cal Foote,D,NJD,25,4,0,1,1
5,8479321,Lucas Johansen,D,WSH,26,6,0,1,1
5,8479378,Logan Stanley,D,WPG,25,10,0,1,1
5,8478017,Mark Friedman,D,VAN,28,20,0,1,1
5,8482095,Tyler Kleven,D,OTT,21,5,0,1,1
5,8479320,Max Lajoie,D,TOR,26,5,0,1,1
5,8477887,Patrick Brown,C,BOS,31,11,0,1,1
5,8480245,Olle Lycksell,R,PHI,24,5,0,1,1
5,8478146,Matthew Highmore,C,OTT,27,6,0,1,1
5,8480845,Rasmus Kupari,C,WPG,23,21,0,1,1
5,8478512,Austin Czarnik,C,DET,31,18,0,1,1
5,8479367,William Lockwood,R,FLA,25,23,0,1,1
5,8481543,Nikita Alexandrov,C,STL,23,18,0,1,1
5,8483597,Milos Kelemen,L,ARI,24,10,0,1,1
5,8483565,Nick Blankenburg,D,CBJ,25,6,0,0,0
5,8483620,Marcus Bjork,D,CBJ,26,0,0,0,0
5,8481521,Ronnie Attard,D,PHI,24,0,0,0,0
5,8482399,Billy Sweezey,D,CBJ,27,0,0,0,0
5,8481072,Tim Berni,D,CBJ,23,0,0,0,0
5,8476884,Derrick Pouliot,D,SJS,29,0,0,0,0
5,8482624,Daniil Miromanov,D,VGK,26,2,0,0,0
5,8482861,Vincent Iorio,D,WSH,21,0,0,0,0
5,8478465,Guillaume Brisebois,D,VAN,26,0,0,0,0
5,8484256,Jake Livingstone,D,NSH,24,0,0,0,0
5,8481599,Victor Soderstrom,D,ARI,22,1,0,0,0
5,8474027,Justin Braun,D,PHI,36,0,0,0,0
5,8478062,Dysin Mayo,D,ARI,27,0,0,0,0
5,8481563,Drew Helleson,D,ANA,22,0,0,0,0
5,8481575,Lassi Thomson,D,OTT,23,0,0,0,0
5,8483619,Filip Roos,D,CHI,24,4,0,0,0
5,8481461,Corey Schueneman,D,MTL,28,0,0,0,0
5,8478846,Christian Wolanin,D,VAN,28,0,0,0,0
5,8479395,Dennis Cholowski,D,NYI,25,0,0,0,0
5,8479945,Gavin Bayreuther,D,CBJ,29,0,0,0,0
5,8474818,Jordie Benn,D,TOR,36,0,0,0,0
5,8479421,Jacob Moverare,D,LAK,25,5,0,0,0
5,8479329,Frederic Allard,D,MTL,26,0,0,0,0
5,8481600,Tobias Bjornfot,D,VGK,22,3,0,0,0
5,8477462,Robert Hagg,D,ANA,28,5,0,0,0
5,8476470,Nathan Beaulieu,D,ANA,31,0,0,0,0
5,8484254,Akito Hirose,D,VAN,24,3,0,0,0
5,8479388,Riley Stillman,D,BUF,25,0,0,0,0
5,8482824,Nick Cicek,D,SJS,23,0,0,0,0
5,8480056,Jack Rathbone,D,VAN,24,0,0,0,0
5,8476850,Ryan Murray,D,EDM,30,0,0,0,0
5,8478841,Colton White,D,ANA,26,0,0,0,0
5,8480160,Radim Simek,D,SJS,31,0,0,0,0
5,8478491,Jacob Larsson,D,OTT,26,0,0,0,0
5,8475857,Kevin Gravel,D,NSH,31,0,0,0,0
5,8482067,Connor Mackey,D,NYR,27,1,0,0,0
5,8477433,Ben Harpur,D,NYR,28,0,0,0,0
5,8481572,Ville Heinola,D,WPG,22,0,0,0,0
5,8478415,Jakub Zboril,D,BOS,26,0,0,0,0
5,8477341,Andreas Johnsson,L,SJS,29,0,0,0,0
5,8480216,Jacob Peterson,C,SJS,24,6,0,0,0
5,8477467,Gustav Olofsson,D,SEA,29,0,0,0,0
5,8478476,Kyle Capobianco,D,WPG,26,0,0,0,0
5,8479985,Cale Fleury,D,SEA,25,0,0,0,0
5,8475227,Chris Wideman,D,MTL,33,0,0,0,0
5,8479333,Libor Hajek,D,NYR,25,0,0,0,0
5,8479376,Victor Mete,D,PHI,25,1,0,0,0
5,8480439,Mac Hollowell,D,TOR,25,0,0,0,0
5,8480467,Austin Strand,D,ANA,26,0,0,0,0
5,8477981,Roland McKeown,D,NSH,27,0,0,0,0
5,8474628,Michael Stone,D,CGY,33,0,0,0,0
5,8480034,Joel Teasdale,L,MTL,24,0,0,0,0
5,8481609,Vladislav Kolyachonok,D,ARI,22,1,0,0,0
5,8479602,Jeremy Davies,D,BUF,27,0,0,0,0
5,8479639,Dylan Coghlan,D,CAR,25,0,0,0,0
5,8478506,Gabriel Carlsson,D,WSH,26,0,0,0,0
5,8477463,Steven Santini,D,STL,28,0,0,0,0
5,8478075,Anders Bjork,L,CHI,27,0,0,0,0
5,8484287,Cole McWard,D,VAN,22,1,0,0,0
5,8474145,Robert Bortuzzo,D,NYI,34,15,0,0,0
5,8475625,Matt Irwin,D,WSH,36,0,0,0,0
5,8482179,Justin Richards,C,CBJ,25,0,0,0,0
5,8481649,Joona Luoto,L,CBJ,26,0,0,0,0
5,8479026,Philippe Myers,D,TBL,26,5,0,0,0
5,8480935,Lawrence Pilut,D,BUF,28,0,0,0,0
5,8479578,Casey Fitzgerald,D,FLA,26,0,0,0,0
5,8480071,Robin Salo,D,NYI,25,0,0,0,0
5,8478224,Luke Philp,C,CHI,28,0,0,0,0
5,8484125,Hunter McKown,C,CBJ,21,0,0,0,0
5,8481679,Maxence Guenette,D,OTT,22,1,0,0,0
5,8479423,Alex Nylander,L,PIT,25,5,0,0,0
5,8480441,Trey Fix-Wolansky,R,CBJ,24,1,0,0,0
5,8480820,Filip Kral,D,TOR,24,0,0,0,0
5,8479523,Lucas Carlsson,D,FLA,26,0,0,0,0
5,8479304,Kyle Criscuolo,C,SJS,31,0,0,0,0
5,8474697,Mark Borowiecki,D,NSH,34,0,0,0,0
5,8480842,Filip Hallander,C,PIT,23,0,0,0,0
5,8481725,Elmer Soderblom,L,DET,22,0,0,0,0
5,8479252,Dan Renouf,D,BOS,29,0,0,0,0
5,8481591,Sam Poulin,R,PIT,22,0,0,0,0
5,8475968,Alex Belzile,R,MTL,32,0,0,0,0
5,8475772,Riley Sheahan,C,BUF,32,0,0,0,0
5,8475163,Alex Chiasson,R,DET,33,0,0,0,0
5,8481598,Philip Broberg,D,EDM,22,10,0,0,0
5,8478455,Austin Wagner,L,CHI,26,0,0,0,0
5,8476779,Brad Hunt,D,COL,35,0,0,0,0
5,8479335,Rasmus Asplund,C,NSH,26,0,0,0,0
5,8478967,Lane Pederson,C,CBJ,26,0,0,0,0
5,8481077,John Leonard,L,NSH,25,0,0,0,0
5,8481585,Egor Afanasyev,L,NSH,22,2,0,0,0
5,8483397,Marc McLaughlin,C,BOS,24,0,0,0,0
5,8480443,Kristian Reichel,C,WPG,25,0,0,0,0
5,8481751,Lukas Rousek,R,BUF,24,5,0,0,0
5,8476396,Steven Fogarty,C,MIN,30,0,0,0,0
5,8478881,Brett Seney,L,CHI,27,4,0,0,0
5,8480326,Sheldon Dries,C,VAN,29,0,0,0,0
5,8481433,Taro Hirose,L,DET,27,0,0,0,0
5,8480833,Vitali Kravtsov,R,VAN,24,0,0,0,0
5,8481550,Adam Beckman,L,MIN,22,0,0,0,0
5,8479972,Mason Shaw,C,MIN,25,0,0,0,0
5,8477460,Laurent Dauphin,C,ARI,28,0,0,0,0
5,8476166,Taylor Fedun,D,PIT,35,0,0,0,0
5,8478067,Oskar Lindblom,L,SJS,27,1,0,0,0
5,8479944,Zach Aston-Reese,C,DET,29,1,0,0,0
5,8479465,Drake Caggiula,L,PIT,29,0,0,0,0
5,8481740,Tyce Thompson,R,NJD,24,0,0,0,0
5,8476948,Charles Hudon,L,COL,29,0,0,0,0
5,8480863,Gabriel Fortier,L,TBL,23,0,0,0,0
5,8471887,Patric Hornqvist,R,FLA,36,0,0,0,0
5,8477471,Dillon Heatherington,D,OTT,28,0,0,0,0
5,8481441,Joe Snively,C,WSH,27,3,0,0,0
5,8478173,Hayden Hodgson,R,PHI,27,0,0,0,0
5,8481720,Nick Abruzzese,C,TOR,24,0,0,0,0
5,8478843,Denis Malgin,C,COL,26,0,0,0,0
5,8483630,Pavol Regenda,L,ANA,24,0,0,0,0
5,8478373,Nikita Soshnikov,R,NYI,30,0,0,0,0
5,8482147,Jean-Luc Foudy,C,COL,21,0,0,0,0
5,8478431,Evgeny Svechnikov,L,SJS,27,0,0,0,0
5,8477210,Buddy Robinson,R,CHI,32,0,0,0,0
5,8479404,Henrik Borgstrom,C,WSH,26,0,0,0,0
5,8481712,Matej Blumel,R,DAL,23,0,0,0,0
5,8475278,Byron Froese,C,VGK,32,7,0,0,0
5,8479338,Markus Niemelainen,D,EDM,25,0,0,0,0
5,8471794,Darren Helm,C,COL,36,0,0,0,0
5,8482623,Josh Dunne,C,CBJ,25,0,0,0,0
5,8482641,Matt Kiersted,D,FLA,25,0,0,0,0
5,8476851,Alex Galchenyuk,C,COL,29,0,0,0,0
5,8479366,Logan Brown,C,STL,25,0,0,0,0
5,8480822,Martin Kaut,R,SJS,24,0,0,0,0
5,8482834,Jesper Froden,R,SEA,29,0,0,0,0
5,8480844,Grigori Denisenko,L,VGK,23,3,0,0,0
5,8482635,Mike Hardman,L,CHI,24,0,0,0,0
5,8477357,Saku Maenalanen,R,WPG,29,0,0,0,0
5,8480979,Nathan Smith,C,ARI,25,0,0,0,0
5,8479356,Kieffer Bellows,L,PHI,25,0,0,0,0
5,8475795,Dylan McIlrath,D,WSH,31,1,0,0,0
5,8478400,Colin White,C,PIT,26,9,0,0,0
5,8478446,Glenn Gawdin,C,ANA,26,0,0,0,0
5,8476326,Josh Archibald,R,PIT,31,0,0,0,0
5,8481683,Aidan McDonough,L,VAN,24,0,0,0,0
5,8480267,Sammy Walker,C,MIN,24,4,0,0,0
5,8477520,Jean-Sebastien Dea,C,ARI,29,0,0,0,0
5,8476439,Brett Ritchie,R,ARI,30,0,0,0,0
5,8479518,Fredrik Karlström,C,DAL,25,0,0,0,0
5,8477126,Jayson Megna,C,ANA,33,0,0,0,0
5,8479644,Matt Luff,R,DET,26,0,0,0,0
5,8478211,Dryden Hunt,L,CGY,28,5,0,0,0
5,8480226,Marián Studenic,R,SEA,25,2,0,0,0
5,8480037,Aleksi Heponiemi,C,FLA,24,0,0,0,0
5,8480292,Carson Meyer,R,CBJ,26,0,0,0,0
5,8482634,Alex Steeves,C,TOR,24,1,0,0,0
5,8475178,Zack Kassian,R,ARI,32,0,0,0,0
5,8483524,Shane Wright,C,SEA,19,3,0,0,0
5,8482654,Jackson Cates,C,PHI,26,0,0,0,0
5,8479550,Tanner Laczynski,C,PHI,26,0,0,0,0
5,8479991,Jake Leschyshyn,C,NYR,24,1,0,0,0
5,8474613,Derek Stepan,C,CAR,33,0,0,0,0
5,8478367,Cole Bardreau,C,NYI,30,0,0,0,0
5,8480890,Jan Jenik,R,ARI,23,1,0,0,0
5,8475160,Kyle Clifford,L,TOR,32,0,0,0,0
5,8479705,Jeffrey Viel,L,SJS,26,0,0,0,0
5,8477401,John Hayden,C,SEA,28,2,0,0,0
5,8480846,Sampo Ranta,L,COL,23,0,0,0,0
5,8482691,Aatu Raty,C,VAN,21,0,0,0,0
5,8481070,Hugh McGing,L,STL,25,5,0,0,0
5,8479573,Mikhail Maltsev,L,COL,25,0,0,0,0
5,8482250,Callahan Burke,C,CAR,26,1,0,0,0
5,8481102,Egor Sokolov,L,OTT,23,0,0,0,0
5,8481518,Nolan Foote,L,NJD,23,0,0,0,0
5,8474190,Wayne Simmonds,R,TOR,35,0,0,0,0
5,8474610,Zac Dalpe,C,FLA,34,0,0,0,0
5,8479347,Tyler Benson,L,EDM,25,0,0,0,0
5,8476404,Andy Andreoff,C,NYI,32,0,0,0,0
5,8476390,Joseph Cramarossa,C,MIN,31,0,0,0,0
5,8483549,Lucas Condotta,L,MTL,26,3,0,0,0
5,8482197,Adam Raska,R,MIN,22,5,0,0,0
5,8479533,Joona Koppanen,L,PIT,25,3,0,0,0
5,8479526,Otto Koivula,L,NYI,25,0,0,0,0
5,8479375,William Bitten,C,STL,25,0,0,0,0
5,8474089,Brad Malone,C,EDM,34,0,0,0,0
5,8478058,CJ Suess,L,SJS,29,0,0,0,0
5,8478147,Bokondji Imama,L,ARI,27,0,0,0,0
5,8477320,Anton Blidh,L,NYR,28,1,0,0,0
5,8477993,Justin Kirkland,C,ARI,27,2,0,0,0
5,8480836,Jonathan Gruden,C,PIT,23,5,0,0,0
5,8480032,Shane Bowers,C,NJD,24,3,0,0,0
6,8477492,Nathan MacKinnon,C,COL,28,82,50,91,141
6,8476453,Nikita Kucherov,R,TBL,30,81,51,89,140
6,8478402,Connor McDavid,C,EDM,26,80,41,94,135
6,8477956,David Pastrnak,R,BOS,27,82,48,67,115
6,8479318,Auston Matthews,C,TOR,26,81,79,33,112
6,8477934,Leon Draisaitl,C,EDM,28,82,44,68,112
6,8477939,William Nylander,R,TOR,27,82,41,66,107
6,8478420,Mikko Rantanen,R,COL,27,82,41,63,104
6,8478550,Artemi Panarin,L,NYR,32,82,49,54,103
6,8477933,Sam Reinhart,C,FLA,28,82,59,42,101
6,8480012,Elias Pettersson,C,VAN,25,81,40,59,99
6,8479314,Matthew Tkachuk,L,FLA,26,82,35,64,99
6,8478483,Mitchell Marner,R,TOR,26,81,34,64,98
6,8476468,J.T. Miller,C,VAN,30,81,36,61,97
6,8480023,Robert Thomas,C,STL,24,82,31,65,96
6,8480069,Cale Makar,D,COL,25,77,22,73,95
6,8481559,Jack Hughes,C,NJD,22,65,33,58,91
6,8478445,Mathew Barzal,C,NYI,26,81,26,65,91
6,8480800,Quinn Hughes,D,VAN,24,81,17,73,90
6,8478010,Brayden Point,C,TBL,27,82,42,46,88
6,8477404,Jake Guentzel,L,PIT,29,81,38,47,85
6,8477493,Aleksander Barkov,C,FLA,28,76,20,65,85
6,8471675,Sidney Crosby,C,PIT,36,82,43,41,84
6,8477409,Carter Verhaeghe,C,FLA,28,82,41,43,84
6,8478439,Travis Konecny,R,PHI,26,81,37,46,83
6,8480865,Noah Dobson,D,NYI,23,82,13,69,82
6,8475786,Zach Hyman,L,EDM,31,81,46,35,81
6,8478427,Sebastian Aho,C,CAR,26,78,29,52,81
6,8476887,Filip Forsberg,L,NSH,29,82,35,44,79
6,8473419,Brad Marchand,L,BOS,35,82,40,38,78
6,8480027,Jason Robertson,L,DAL,24,82,26,52,78
6,8476454,Ryan Nugent-Hopkins,C,EDM,30,82,23,55,78
6,8474564,Steven Stamkos,C,TBL,33,79,37,40,77
6,8477500,Bo Horvat,C,NYI,28,81,36,41,77
6,8479407,Jesper Bratt,L,NJD,25,81,31,46,77
6,8475913,Mark Stone,R,VGK,31,81,21,56,77
6,8476853,Morgan Rielly,D,TOR,29,79,11,66,77
6,8478864,Kirill Kaprizov,L,MIN,26,75,32,44,76
6,8479337,Alex DeBrincat,R,DET,26,82,31,44,75
6,8475168,Matt Duchene,C,DAL,32,81,28,47,75
6,8473512,Claude Giroux,R,OTT,35,82,26,49,75
6,8480803,Evan Bouchard,D,EDM,24,82,23,52,75
6,8474600,Roman Josi,D,NSH,33,82,20,55,75
6,8479542,Brandon Hagel,L,TBL,25,82,27,47,74
6,8476460,Mark Scheifele,C,WPG,30,75,26,48,74
6,8478444,Brock Boeser,R,VAN,26,81,41,32,73
6,8478403,Jack Eichel,C,VGK,27,70,32,41,73
6,8476459,Mika Zibanejad,C,NYR,30,81,25,47,72
6,8477946,Dylan Larkin,C,DET,27,76,36,35,71
6,8476389,Vincent Trocheck,C,NYR,30,82,21,50,71
6,8475167,Victor Hedman,D,TBL,33,80,12,59,71
6,8476539,Jonathan Marchessault,R,VGK,33,81,43,27,70
6,8471685,Anze Kopitar,C,LAK,36,82,26,44,70
6,8478449,Roope Hintz,C,DAL,27,80,29,40,69
6,8475692,Mats Zuccarello,R,MIN,36,73,15,54,69
6,8475158,Ryan O'Reilly,C,NSH,32,82,31,37,68
6,8478975,Mason Marchment,L,DAL,28,81,30,38,68
6,8480018,Nick Suzuki,C,MTL,24,82,26,42,68
6,8479343,Clayton Keller,R,ARI,25,82,26,42,68
6,8480839,Rasmus Dahlin,D,BUF,23,81,19,49,68
6,8475184,Chris Kreider,L,NYR,32,82,34,33,67
6,8479385,Jordan Kyrou,C,STL,25,82,29,38,67
6,8482116,Tim Stützle,C,OTT,21,82,16,51,67
6,8479323,Adam Fox,D,NYR,25,72,14,53,67
6,8477501,Valeri Nichushkin,R,COL,28,67,34,32,66
6,8482078,Lucas Raymond,L,DET,21,82,20,46,66
6,8478493,Joel Eriksson Ek,C,MIN,26,82,36,29,65
6,8480801,Brady Tkachuk,L,OTT,24,82,36,29,65
6,8481540,Cole Caufield,R,MTL,22,82,28,36,64
6,8470794,Joe Pavelski,C,DAL,39,82,25,39,64
6,8475745,Charlie Coyle,C,BOS,31,82,24,40,64
6,8475172,Nazem Kadri,C,CGY,33,82,23,41,64
6,8477955,Jared McCann,L,SEA,27,81,38,25,63
6,8480797,Joel Farabee,L,PHI,23,81,26,37,63
6,8477960,Adrian Kempe,R,LAK,27,82,25,38,63
6,8481557,Matt Boldy,L,MIN,22,75,35,27,62
6,8476882,Teuvo Teravainen,L,CAR,29,81,27,35,62
6,8475166,John Tavares,C,TOR,33,80,25,37,62
6,8477942,Kevin Fiala,L,LAK,27,82,18,44,62
6,8471214,Alex Ovechkin,L,WSH,38,79,26,35,61
6,8479425,Filip Hronek,D,VAN,26,81,6,55,61
6,8478366,Frank Vatrano,R,ANA,29,82,32,28,60
6,8477402,Pavel Buchnevich,L,STL,28,80,26,34,60
6,8482124,Quinton Byfield,R,LAK,21,80,23,37,60
6,8476448,William Karlsson,C,VGK,30,69,30,29,59
6,8477940,Nikolaj Ehlers,L,WPG,27,81,24,35,59
6,8471215,Evgeni Malkin,C,PIT,37,82,22,37,59
6,8477416,Oliver Bjorkstrand,R,SEA,28,82,22,37,59
6,8474679,Gustav Nyquist,C,NSH,34,82,17,42,59
6,8477504,Josh Morrissey,D,WPG,28,81,16,43,59
6,8476399,Blake Coleman,C,CGY,32,82,30,28,58
6,8475794,Tyler Seguin,C,DAL,31,82,28,30,58
6,8480830,Andrei Svechnikov,R,CAR,23,60,23,35,58
6,8475765,Vladimir Tarasenko,R,OTT,32,80,20,38,58
6,8474578,Erik Karlsson,D,PIT,33,82,10,48,58
6,8480002,Nico Hischier,C,NJD,24,70,25,32,57
6,8476881,Tomas Hertl,C,SJS,30,76,24,33,57
6,8477949,Alex Tuch,R,BUF,27,75,23,34,57
6,8482093,Seth Jarvis,C,CAR,21,81,22,35,57
6,8476456,Jonathan Huberdeau,C,CGY,30,81,17,40,57
6,8476346,Johnny Gaudreau,L,CBJ,30,81,15,42,57
6,8476875,Mike Matheson,D,MTL,29,82,9,48,57
6,8478398,Kyle Connor,L,WPG,27,65,37,19,56
6,8475726,Tyler Toffoli,R,NJD,31,80,35,21,56
6,8475754,Brock Nelson,C,NYI,32,82,32,24,56
6,8482149,Cole Perfetti,C,WPG,21,81,24,32,56
6,8478873,Troy Terry,R,ANA,26,79,21,35,56
6,8478401,Pavel Zacha,C,BOS,26,78,20,36,56
6,8479999,Casey Mittelstadt,C,BUF,25,82,17,39,56
6,8477497,Sean Monahan,C,WPG,29,83,21,34,55
6,8477951,Nick Schmaltz,C,ARI,27,79,20,35,55
6,8478407,Vince Dunn,D,SEA,27,78,13,42,55
6,8471724,Kris Letang,D,PIT,36,82,10,45,55
6,8482745,Mason McTavish,C,ANA,20,74,27,27,54
6,8480208,Drake Batherson,R,OTT,25,82,25,29,54
6,8474590,John Carlson,D,WSH,33,82,7,47,54
6,8475169,Evander Kane,L,EDM,32,81,29,24,53
6,8476906,Shayne Gostisbehere,D,DET,30,81,12,41,53
6,8482740,Wyatt Johnston,C,DAL,20,82,21,31,52
6,8477456,J.T. Compher,L,DET,28,77,20,32,52
6,8480039,Martin Necas,C,CAR,24,76,19,33,52
6,8475798,Mikael Granlund,C,SJS,31,68,12,40,52
6,8482175,JJ Peterka,R,BUF,21,82,28,23,51
6,8474037,James van Riemsdyk,L,BOS,34,78,17,34,51
6,8478542,Evan Rodrigues,C,FLA,30,82,13,38,51
6,8479325,Charlie McAvoy,D,BOS,26,74,12,39,51
6,8479675,Trevor Moore,L,LAK,28,82,28,22,50
6,8479420,Tage Thompson,C,BUF,26,72,22,28,50
6,8474641,Adam Henrique,C,ANA,33,81,20,30,50
6,8476905,Chandler Stephenson,C,VGK,29,77,17,33,50
6,8479365,Trent Frederic,C,BOS,25,82,23,26,49
6,8474102,David Perron,L,DET,35,76,21,28,49
6,8474141,Patrick Kane,R,DET,35,51,20,29,49
6,8478047,Michael Bunting,L,CAR,28,80,18,31,49
6,8480036,Miro Heiskanen,D,DAL,24,72,10,39,49
6,8480015,Owen Tippett,R,PHI,24,77,27,21,48
6,8481068,Yegor Sharangovich,C,CGY,25,82,26,22,48
6,8477935,Sam Bennett,C,FLA,27,70,26,22,48
6,8475784,Jeff Skinner,L,BUF,31,74,24,24,48
6,8474563,Drew Doughty,D,LAK,34,82,21,27,48
6,8473994,Jamie Benn,L,DAL,34,82,19,29,48
6,8478462,Nicolas Roy,C,VGK,26,72,16,32,48
6,8475810,Bryan Rust,R,PIT,31,69,24,23,47
6,8477494,Jonathan Drouin,L,COL,28,80,14,33,47
6,8481542,Moritz Seider,D,DET,22,82,13,34,47
6,8482122,Brock Faber,D,MIN,21,82,8,39,47
6,8478440,Dylan Strome,C,WSH,26,82,26,20,46
6,8475151,Kyle Palmieri,C,NYI,32,82,20,26,46
6,8478233,Andrew Mangiapane,L,CGY,27,81,16,30,46
6,8478519,Anthony Cirelli,C,TBL,26,81,14,32,46
6,8477503,Max Domi,C,TOR,28,82,10,36,46
6,8478057,Dakota Joshua,C,VAN,27,79,23,22,45
6,8475191,Reilly Smith,R,PIT,32,76,20,25,45
6,8481581,Thomas Harley,D,DAL,22,79,19,26,45
6,8477496,Elias Lindholm,C,VAN,29,81,15,30,45
6,8481528,Dylan Cozens,C,BUF,22,79,15,30,45
6,8478038,Devon Toews,D,COL,29,82,14,31,45
6,8474586,Jordan Eberle,R,SEA,33,78,14,31,45
6,8479345,Jakob Chychrun,D,OTT,25,82,11,34,45
6,8476925,Colton Sissons,C,NSH,30,82,24,20,44
6,8482110,Dawson Mercer,C,NJD,22,81,23,21,44
6,8482109,Alexis Lafrenière,L,NYR,22,82,21,23,44
6,8475170,Brayden Schenn,C,STL,32,82,20,24,44
6,8479525,Ross Colton,C,COL,27,80,17,27,44
6,8475287,Erik Haula,L,NJD,32,75,16,28,44
6,8477498,Darnell Nurse,D,EDM,28,82,14,30,44
6,8478474,Lawson Crouse,L,ARI,26,81,27,16,43
6,8477511,Anthony Mantha,R,WSH,29,78,25,18,43
6,8477964,Ivan Barbashev,C,VGK,28,81,18,25,43
6,8476479,Phillip Danault,C,LAK,30,82,16,27,43
6,8482146,Luke Evangelista,R,NSH,21,80,15,28,43
6,8476458,Ryan Strome,C,ANA,30,79,14,29,43
6,8480798,Philipp Kurashev,C,CHI,24,75,12,31,43
6,8476869,Brady Skjei,D,CAR,29,81,11,32,43
6,8481711,Matias Maccelli,L,ARI,23,82,9,34,43
6,8476792,Torey Krug,D,STL,32,82,4,39,43
6,8475799,Nino Niederreiter,R,WPG,31,81,22,20,42
6,8476872,Scott Laughton,C,PHI,29,81,17,25,42
6,8477429,Andrew Copp,C,DET,29,81,16,26,42
6,8480009,Eeli Tolvanen,R,SEA,24,82,15,27,42
6,8477021,Alex Kerfoot,C,ARI,29,82,11,31,42
6,8480893,Kirill Marchenko,R,CBJ,23,79,24,17,41
6,8477346,MacKenzie Weegar,D,CGY,29,82,19,22,41
6,8482079,Marco Rossi,C,MIN,22,82,19,22,41
6,8475760,Nick Bjugstad,C,ARI,31,82,18,23,41
6,8478856,Conor Garland,R,VAN,27,81,15,26,41
6,8480028,Morgan Frost,C,PHI,24,70,14,27,41
6,8482684,Luke Hughes,D,NJD,20,81,13,28,41
6,8478055,Gustav Forsling,D,FLA,27,81,10,31,41
6,8475764,Cam Fowler,D,ANA,32,82,7,34,41
6,8479410,Mikhail Sergachev,D,TBL,25,60,6,35,41
6,8477451,Ryan Hartman,R,MIN,29,77,25,15,40
6,8477426,Nicholas Paul,L,TBL,28,82,19,21,40
6,8479400,Pierre-Luc Dubois,C,LAK,25,82,19,21,40
6,8477998,Warren Foegele,L,EDM,27,82,17,23,40
6,8474150,Mikael Backlund,C,CGY,34,82,16,24,40
6,8475763,Kevin Hayes,R,STL,31,82,15,25,40
6,8475744,Evgeny Kuznetsov,C,WSH,31,72,14,26,40
6,8480434,Sean Durzi,D,ARI,25,76,13,27,40
6,8478396,Noah Hanifin,D,CGY,26,82,12,28,40
6,8476392,Adam Lowry,C,WPG,30,81,11,29,40
6,8470613,Brent Burns,D,CAR,38,81,9,31,40
6,8477948,Travis Sanheim,D,PHI,27,80,6,34,40
6,8478500,Ivan Provorov,D,CBJ,26,81,6,34,40
6,8474565,Alex Pietrangelo,D,VGK,33,76,4,36,40
6,8481186,Logan O'Connor,R,COL,27,78,22,17,39
6,8477952,Robby Fabbri,C,DET,27,68,21,18,39
6,8480064,Josh Norris,C,OTT,24,75,19,20,39
6,8482125,Alexander Holtz,R,NJD,21,81,19,20,39
6,8478414,Timo Meier,R,NJD,27,68,18,21,39
6,8478498,Jake DeBrusk,L,BOS,27,80,18,21,39
6,8478438,Tommy Novak,C,NSH,26,71,15,24,39
6,8479987,Morgan Geekie,C,BOS,25,76,15,24,39
6,8478472,Mathieu Joseph,R,OTT,26,72,14,25,39
6,8478397,Rasmus Andersson,D,CGY,27,78,10,29,39
6,8482667,William Eklund,L,SJS,21,80,10,29,39
6,8478460,Zach Werenski,D,CBJ,26,69,1,38,39
6,8482089,Jake Neighbours,L,STL,21,82,28,10,38
6,8477450,Jason Dickinson,C,CHI,28,82,25,13,38
6,8473422,Nick Foligno,L,CHI,36,75,19,19,38
6,8479992,Michael Rasmussen,C,DET,24,82,15,23,38
6,8475149,Marcus Johansson,L,MIN,33,82,12,26,38
6,8480813,Joe Veleno,C,DET,23,80,18,19,37
6,8482092,Ridly Greig,C,OTT,21,72,16,21,37
6,8475171,Oliver Ekman-Larsson,D,FLA,32,82,14,23,37
6,8476292,Ondrej Palat,L,NJD,32,71,12,25,37
6,8477447,Shea Theodore,D,VGK,28,48,10,27,37
6,8476958,Jaccob Slavin,D,CAR,29,81,6,31,37
6,8476432,Boone Jenner,C,CBJ,30,66,25,11,36
6,8476826,Yanni Gourde,C,SEA,32,80,14,22,36
6,8482105,Jake Sanderson,D,OTT,21,79,11,25,36
6,8477479,Tyler Bertuzzi,L,TOR,28,81,11,25,36
6,8482475,Yegor Chinakhov,R,CBJ,22,69,20,15,35
6,8475714,Calle Jarnkrok,C,TOR,32,75,20,15,35
6,8482159,Tyson Foerster,R,PHI,21,78,19,16,35
6,8474149,Evgenii Dadonov,R,DAL,34,77,17,18,35
6,8471698,T.J. Oshie,R,WSH,37,65,17,18,35
6,8478020,Michael Amadio,R,VGK,27,74,16,19,35
6,8479415,Michael McLeod,C,NJD,25,73,15,20,35
6,8475722,Jason Zucker,L,ARI,31,72,13,22,35
6,8476480,Vladislav Namestnikov,C,WPG,31,78,10,25,35
6,8476483,Rickard Rakell,R,PIT,30,70,10,25,35
6,8483808,Andrei Kuzmenko,L,CGY,27,76,18,16,34
6,8483515,Juraj Slafkovsky,L,MTL,19,82,14,20,34
6,8478466,Daniel Sprong,R,DET,26,54,14,20,34
6,8477505,Alex Wennberg,C,SEA,29,82,12,22,34
6,8478891,Mason Appleton,C,WPG,27,81,11,23,34
6,8482113,Anton Lundell,C,FLA,22,78,9,25,34
6,8476462,Dougie Hamilton,D,NJD,30,48,8,26,34
6,8473533,Jordan Staal,C,CAR,35,81,17,16,33
6,8476921,Jordan Martinook,L,CAR,31,81,16,17,33
6,8475768,Jaden Schwartz,C,SEA,31,66,16,17,33
6,8480014,Gabriel Vilardi,C,WPG,24,61,15,18,33
6,8477476,Artturi Lehkonen,L,COL,28,47,14,19,33
6,8481624,Ilya Mikheyev,R,VAN,29,77,14,19,33
6,8482720,Matthew Knies,L,TOR,21,80,12,21,33
6,8477947,Sonny Milano,L,WSH,27,53,12,21,33
6,8473986,Alex Killorn,L,ANA,34,63,10,23,33
6,8482665,Matty Beniers,C,SEA,21,77,9,24,33
6,8476885,Jacob Trouba,D,NYR,29,80,5,28,33
6,8476897,Oskar Sundqvist,C,STL,29,82,13,19,32
6,8477407,Anthony Duclair,L,SJS,28,76,11,21,32
6,8476419,Jean-Gabriel Pageau,C,NYI,31,82,10,22,32
6,8476927,Teddy Blueger,C,VAN,29,67,10,22,32
6,8480817,K'Andre Miller,D,NYR,23,80,9,23,32
6,8476931,Jake McCabe,D,TOR,30,76,8,24,32
6,8476979,Erik Gustafsson,D,NYR,31,81,5,27,32
6,8475181,Nick Leddy,D,STL,32,82,5,27,32
6,8477969,Marcus Pettersson,D,PIT,27,82,2,30,32
6,8475314,Anders Lee,L,NYI,33,82,20,11,31
6,8474189,Lars Eller,C,PIT,34,82,20,11,31
6,8476880,Tom Wilson,R,WSH,29,81,14,17,31
6,8476892,Colton Parayko,D,STL,30,82,14,17,31
6,8482245,Artem Zub,D,OTT,28,72,7,24,31
6,8478469,Thomas Chabot,D,OTT,26,60,6,25,31
6,8479619,Michael Carcone,L,ARI,27,76,22,8,30
6,8480188,Fabian Zetterlund,L,SJS,24,81,19,11,30
6,8480459,Pius Suter,C,VAN,27,67,19,11,30
6,8476918,Jimmy Vesey,L,NYR,30,80,18,12,30
6,8482055,Drew O'Connor,L,PIT,25,82,13,17,30
6,8481524,Bowen  Byram,D,COL,22,74,12,18,30
6,8481577,Philip Tomasino,C,NSH,22,68,11,19,30
6,8475218,Mattias Ekholm,D,EDM,33,81,6,24,30
6,8478507,John Marino,D,NJD,26,81,6,24,30
6,8475188,Brayden McNabb,D,VGK,32,81,5,25,30
6,8476854,Hampus Lindholm,D,BOS,29,82,2,28,30
6,8476438,Brandon Saad,L,STL,31,82,18,11,29
6,8481601,Simon Holmstrom,R,NYI,22,81,17,12,29
6,8482157,Will Cuylle,L,NYR,21,82,16,13,29
6,8478013,Jake Walman,D,DET,27,76,14,15,29
6,8480113,Alex Iafallo,L,WPG,30,81,13,16,29
6,8474157,Max Pacioretty,L,WSH,35,47,12,17,29
6,8481032,Paul Cotter,C,VGK,24,80,11,18,29
6,8480829,Jesperi Kotkaniemi,C,CAR,23,81,11,18,29
6,8481546,Cam York,D,PHI,22,81,10,19,29
6,8480855,Jack McBain,C,ARI,23,67,9,20,29
6,8474602,Justin Schultz,D,SEA,33,72,8,21,29
6,8480336,Sean Walker,D,PHI,29,81,6,23,29
6,8477986,Brandon Montour,D,FLA,29,66,6,23,29
6,8475197,Tyson Barrie,D,NSH,32,62,6,23,29
6,8478840,Will Borgen,D,SEA,27,82,4,25,29
6,8475753,Justin Faulk,D,STL,31,68,3,26,29
6,8480246,Nick Perbix,D,TBL,25,80,3,26,29
6,8478508,Yakov Trenin,C,NSH,26,79,20,8,28
6,8473449,Kyle Okposo,R,BUF,35,79,16,12,28
6,8471218,Blake Wheeler,R,NYR,37,82,13,15,28
6,8480802,Ryan McLeod,C,EDM,24,81,13,15,28
6,8481580,Connor McMichael,C,WSH,22,80,13,15,28
6,8476923,Damon Severson,D,CBJ,29,66,11,17,28
6,8476474,Stefan Noesen,R,CAR,30,52,11,17,28
6,8478109,Victor Olofsson,L,BUF,28,63,11,17,28
6,8478463,Anthony Beauvillier,L,CHI,26,64,10,18,28
6,8478115,Pierre Engvall,L,NYI,27,76,8,20,28
6,8474574,Tyler Myers,D,VAN,33,81,5,23,28
6,8477495,Seth Jones,D,CHI,29,67,2,26,28
6,8478413,Jordan Greenway,L,BUF,26,70,14,13,27
6,8474884,Mike Hoffman,C,SJS,34,79,13,14,27
6,8481560,Arthur Kaliyev,R,LAK,22,68,12,15,27
6,8477508,Curtis Lazar,C,NJD,28,76,11,16,27
6,8478178,Darren Raddysh,D,TBL,27,82,7,20,27
6,8477953,Kasperi Kapanen,R,STL,27,75,7,20,27
6,8478911,Matt Roy,D,LAK,28,81,7,20,27
6,8477932,Aaron Ekblad,D,FLA,27,64,5,22,27
6,8480145,Neal Pionk,D,WPG,28,81,5,22,27
6,8475200,Dmitry Orlov,D,CAR,32,81,5,22,27
6,8478851,Alexandre Carrier,D,NSH,27,77,5,22,27
6,8476879,Cody Ceci,D,EDM,30,82,3,24,27
6,8480185,Eetu Luostarinen,C,FLA,25,82,16,10,26
6,8481604,Pavel Dorofeyev,L,VGK,23,57,14,12,26
6,8478046,Danton Heinen,L,BOS,28,74,13,13,26
6,8477425,Miles Wood,L,COL,28,77,13,13,26
6,8475343,Nic Dowd,C,WSH,33,73,13,13,26
6,8478043,Sam Lafferty,C,VAN,28,79,12,14,26
6,8475220,Marcus Foligno,L,MIN,32,75,10,16,26
6,8482655,J.J. Moser,D,ARI,23,80,6,20,26
6,8474673,TJ Brodie,D,TOR,33,81,2,24,26
6,8475793,Ryan Johansen,C,COL,31,82,13,12,25
6,8481596,Shane Pinto,C,OTT,23,41,13,12,25
6,8470621,Corey Perry,R,EDM,38,54,11,14,25
6,8482705,Cole Sillinger,C,CBJ,20,76,10,15,25
6,8475193,Tomas Tatar,L,SEA,33,78,8,17,25
6,8478042,Viktor Arvidsson,R,LAK,30,32,8,17,25
6,8482062,Cole Smith,L,NSH,28,81,7,18,25
6,8476902,Esa Lindell,D,DAL,29,82,4,21,25
6,8476463,Jonas Brodin,D,MIN,30,64,4,21,25
6,8482671,Owen Power,D,BUF,21,79,3,22,25
6,8481535,Nils Hoglander,L,VAN,23,53,17,7,24
6,8474870,Tyler Johnson,C,CHI,33,67,14,10,24
6,8479591,Michael Eyssimont,C,TBL,27,81,14,10,24
6,8482097,Jack Quinn,R,BUF,22,45,11,13,24
6,8476374,Sean Kuraly,C,CBJ,30,73,11,13,24
6,8479351,Sam Steel,C,DAL,25,77,10,14,24
6,8481533,Trevor Zegras,C,ANA,22,48,9,15,24
6,8482222,Alexander Barabanov,L,SJS,29,61,9,15,24
6,8480835,Jack Drury,C,CAR,23,53,8,16,24
6,8479398,Samuel Girard,D,COL,25,61,6,18,24
6,8473507,Jeff Petry,D,DET,36,73,5,19,24
6,8480043,Timothy Liljegren,D,TOR,24,65,5,19,24
6,8478882,Vladislav Gavrikov,D,LAK,28,77,5,19,24
6,8480994,Damien Giroux,C,MIN,23,28,4,20,24
6,8475855,Jesper Fast,R,CAR,32,78,13,10,23
6,8481704,Juuso Parssinen,C,NSH,22,71,13,10,23
6,8480068,Ryan Poehling,C,PHI,24,76,9,14,23
6,8477950,Tony DeAngelo,D,CAR,28,51,7,16,23
6,8476312,Josh Manson,D,COL,32,77,7,16,23
6,8475455,Brenden Dillon,D,WPG,33,78,6,17,23
6,8476457,Adam Larsson,D,SEA,31,82,5,18,23
6,8478859,Niko Mikkola,D,FLA,27,82,5,18,23
6,8482073,Braden Schneider,D,NYR,22,82,5,18,23
6,8477444,Andre Burakovsky,L,SEA,28,51,4,19,23
6,8479661,Tanner Jeannot,L,TBL,26,68,13,9,22
6,8481618,Alex Newhook,C,MTL,22,55,12,10,22
6,8479393,Noah Gregor,C,TOR,25,81,10,12,22
6,8475208,Brian Dumoulin,D,SEA,32,80,6,16,22
6,8478133,Jake Evans,C,MTL,27,82,5,17,22
6,8481568,Alex Vlasic,D,CHI,22,76,4,18,22
6,8479998,Mikey Anderson,D,LAK,24,82,1,21,22
6,8479293,Brandon Tanev,L,SEA,32,66,13,8,21
6,8479390,Taylor Raddysh,R,CHI,25,77,11,10,21
6,8481582,Nicholas Robertson,L,TOR,22,64,10,11,21
6,8479941,Justin Danforth,R,CBJ,30,81,10,11,21
6,8478136,Jake Middleton,D,MIN,27,82,9,12,21
6,8477919,Frederick Gaudreau,C,MIN,30,70,7,14,21
6,8478458,Jack Roslovic,C,CBJ,26,58,6,15,21
6,8476329,Travis Boyd,C,ARI,30,45,6,15,21
6,8480883,Ty Smith,D,PIT,23,31,6,15,21
6,8481656,Aliaksei Protas,C,WSH,22,52,4,17,21
6,8480873,Rasmus Sandin,D,WSH,23,74,3,18,21
6,8480878,Nils Lundkvist,D,DAL,23,70,2,19,21
6,8480281,Alexey Toropchenko,R,STL,24,82,15,5,20
6,8477330,Dominik Kubalik,L,OTT,28,78,14,6,20
6,8475462,Radko Gudas,D,ANA,33,76,8,12,20
6,8474166,Alec Martinez,D,VGK,36,64,8,12,20
6,8477506,Ryan Pulock,D,NYI,29,58,8,12,20
6,8475790,Erik Gudbranson,D,CBJ,31,77,5,15,20
6,8480035,Henri Jokiharju,D,BUF,24,74,5,15,20
6,8480172,Jan Rutta,D,SJS,33,75,5,15,20
6,8474151,Ryan McDonagh,D,NSH,34,75,4,16,20
6,8481522,Peyton Krebs,C,BUF,22,80,4,16,20
6,8479976,Juuso Valimaki,D,ARI,25,68,4,16,20
6,8475690,Chris Tanev,D,CGY,34,79,2,18,20
6,8479983,Mario Ferraro,D,SJS,25,77,2,18,20
6,8480049,Dylan Samberg,D,WPG,24,81,1,19,20
6,8479316,Luke Kunin,C,SJS,26,76,15,4,19
6,8479339,Patrik Laine,L,CBJ,25,47,11,8,19
6,8481481,Blake Lizotte,C,LAK,26,64,10,9,19
6,8476981,Josh Anderson,R,MTL,29,78,9,10,19
6,8480849,Barrett Hayton,C,ARI,23,50,9,10,19
6,8482087,Kaiden Guhle,D,MTL,21,78,8,11,19
6,8480220,Noah Cates,L,PHI,24,59,6,13,19
6,8478443,Brandon Carlo,D,BOS,27,77,5,14,19
6,8482142,Jamie Drysdale,D,PHI,21,49,4,15,19
6,8476331,Dylan DeMelo,D,WPG,30,81,1,18,19
6,8473453,Trevor Lewis,C,LAK,36,82,11,7,18
6,8482699,Dylan Guenther,R,ARI,20,45,10,8,18
6,8479977,Kailer Yamamoto,R,SEA,25,73,10,8,18
6,8475791,Taylor Hall,L,CHI,32,37,8,10,18
6,8480762,Eric Robinson,L,BUF,28,54,7,11,18
6,8479359,Beck Malenstyn,L,WSH,25,81,6,12,18
6,8475164,Jakob Silfverberg,R,ANA,33,81,6,12,18
6,8476889,Radek Faksa,C,DAL,29,74,6,12,18
6,8475233,David Savard,D,MTL,33,60,5,13,18
6,8481014,Alexander Romanov,D,NYI,23,81,5,13,18
6,8481523,Kirby Dach,C,MTL,22,29,2,16,18
6,8475179,Dmitry Kulikov,D,FLA,33,78,0,18,18
6,8476469,Joel Armia,R,MTL,30,66,12,5,17
6,8478831,Kevin Stenlund,C,FLA,27,82,11,6,17
6,8481554,Kaapo Kakko,R,NYR,22,61,11,6,17
6,8477944,Jakub Vrana,L,STL,27,49,8,9,17
6,8479353,Brett Howden,C,VGK,25,79,7,10,17
6,8480821,Filip Zadina,R,SJS,24,48,7,10,17
6,8480144,David Kampf,C,TOR,28,78,7,10,17
6,8470638,Patrice Bergeron,C,BOS,38,27,6,11,17
6,8471699,Andrew Cogliano,C,COL,36,76,4,13,17
6,8475279,Ben Chiarot,D,DET,32,77,4,13,17
6,8477839,Conor Sheary,L,TBL,31,64,4,13,17
6,8479980,Nicolas Hague,D,VGK,25,73,4,13,17
6,8470600,Ryan Suter,D,DAL,38,82,1,16,17
6,8482101,Danil Gushchin,L,SJS,21,30,10,6,16
6,8474040,Sam Gagner,C,EDM,34,55,9,7,16
6,8477903,Garnet Hathaway,R,PHI,32,81,9,7,16
6,8476393,Nick Cousins,C,FLA,30,70,9,7,16
6,8474053,Logan Couture,C,SJS,34,34,8,8,16
6,8475848,Brendan Gallagher,R,MTL,31,50,8,8,16
6,8482660,Kent Johnson,C,CBJ,21,36,6,10,16
6,8474573,Josh Bailey,R,NYI,34,29,6,10,16
6,8477507,Nikita Zadorov,D,VAN,28,75,5,11,16
6,8474034,Pat Maroon,L,MIN,35,49,4,12,16
6,8477845,Trevor van Riemsdyk,D,WSH,32,70,3,13,16
6,8476917,Adam Pelech,D,NYI,29,58,2,14,16
6,8475906,John Klingberg,D,TOR,31,43,1,15,16
6,8480913,Jordan Gross,D,NSH,28,27,1,15,16
6,8481606,Jordan Spence,D,LAK,22,44,0,16,16
6,8476822,Luke Glendening,C,TBL,34,82,12,3,15
6,8475231,Casey Cizikas,C,NYI,32,71,9,6,15
6,8480192,Johnathan Kovacevic,D,MTL,26,74,9,6,15
6,8481093,Rafael Harvey-Pinard,L,MTL,24,51,7,8,15
6,8477987,Ryan Donato,C,CHI,27,51,6,9,15
6,8479346,Dillon Dube,C,CGY,25,70,6,9,15
6,8480031,Max Comtois,L,ANA,24,28,6,9,15
6,8477435,Ryan Graves,D,PIT,28,82,5,10,15
6,8481178,Egor Zamula,D,PHI,23,44,5,10,15
6,8479996,Cody Glass,C,NSH,24,54,4,11,15
6,8480796,Martin Fehervary,D,WSH,24,76,2,13,15
6,8474612,Travis Hamonic,D,OTT,33,75,7,7,14
6,8477989,Christian Dvorak,C,MTL,27,52,6,8,14
6,8482111,Justin Barron,D,MTL,22,68,6,8,14
6,8476960,Andreas Athanasiou,C,CHI,29,38,5,9,14
6,8480078,Filip Chytil,C,NYR,24,38,5,9,14
6,8474031,Kevin Shattenkirk,D,BOS,34,44,5,9,14
6,8478970,Jalen Chatfield,D,CAR,27,48,5,9,14
6,8477979,Nicolas Aube-Kubel,R,WSH,27,39,5,9,14
6,8479322,Wade Allison,R,PHI,26,26,5,9,14
6,8476422,Mike Reilly,D,NYI,30,61,4,10,14
6,8477488,Brett Pesce,D,CAR,29,71,4,10,14
6,8473504,Cal Clutterbuck,R,NYI,36,53,4,10,14
6,8477380,Jonny Brodzinski,C,NYR,30,35,4,10,14
6,8477499,Rasmus Ristolainen,D,PHI,29,57,3,11,14
6,8477406,Mattias Janmark,C,EDM,31,71,2,12,14
6,8476525,Colin Miller,D,NJD,31,61,2,12,14
6,8477365,Connor Clifton,D,BUF,28,79,1,13,14
6,8477220,Nate Schmidt,D,WPG,32,75,1,13,14
6,8476941,Connor Carrick,D,BOS,29,27,1,13,14
6,8474716,Jared Spurgeon,D,MIN,34,44,0,14,14
6,8480289,Morgan Barron,C,WPG,25,51,9,4,13
6,8478468,Jeremy Lauzon,D,NSH,26,82,8,5,13
6,8477446,Michael McCarron,R,NSH,28,43,7,6,13
6,8482259,Bobby McMann,C,TOR,27,29,7,6,13
6,8480848,Ty Dellandrea,C,DAL,23,53,6,7,13
6,8480448,Parker Kelly,L,OTT,24,51,6,7,13
6,8480807,Mattias Samuelsson,D,BUF,23,69,5,8,13
6,8479344,Jesse Puljujarvi,R,PIT,25,36,5,8,13
6,8478399,Jonas Siegenthaler,D,NJD,26,66,4,9,13
6,8476473,Connor Murphy,D,CHI,30,70,3,10,13
6,8471276,David Krejci,C,BOS,37,27,3,10,13
6,8482117,Lukas Reichel,L,CHI,21,77,3,10,13
6,8471677,Jack Johnson,D,COL,36,80,3,10,13
6,8475825,Jani Hakanpää,D,DAL,31,82,2,11,13
6,8473548,Phil Kessel,R,VGK,36,28,2,11,13
6,8479324,Ryan Lindgren,D,NYR,25,80,2,11,13
6,8480001,Urho Vaakanainen,D,ANA,24,74,2,11,13
6,8478416,Erik Cernak,D,TBL,26,71,1,12,13
6,8482192,Isaak Phillips,D,CHI,22,56,1,12,13
6,8475324,Nick Jensen,D,WSH,33,82,0,13,13
6,8479336,Carl Grundstrom,R,LAK,26,50,8,4,12
6,8481517,Brett Leason,R,ANA,24,43,6,6,12
6,8473604,Jonathan Toews,C,CHI,35,27,6,6,12
6,8481013,Jonatan Berggren,R,DET,23,37,5,7,12
6,8478569,Noel Acciari,C,PIT,32,70,5,7,12
6,8480748,Kiefer Sherwood,L,NSH,28,41,5,7,12
6,8473563,Nicklas Backstrom,C,WSH,36,37,4,8,12
6,8480891,Michael Kesselring,D,ARI,23,36,4,8,12
6,8480073,Erik Brannstrom,D,OTT,24,45,3,9,12
6,8480887,Jordan Harris,D,MTL,23,58,3,9,12
6,8476874,Olli Maatta,D,DET,29,46,2,10,12
6,8478432,Christian Fischer,R,DET,26,51,2,10,12
6,8474013,Ian Cole,D,VAN,34,80,2,10,12
6,8480727,Zach Whitecloud,D,VGK,27,65,2,10,12
6,8481605,Jackson LaCombe,D,ANA,22,76,1,11,12
6,8480884,Calen Addison,D,SJS,23,45,1,11,12
6,8471274,Alex Goligoski,D,MIN,38,58,0,12,12
6,8475225,Craig Smith,C,DAL,34,50,7,4,11
6,8470610,Zach Parise,L,COL,39,33,5,6,11
6,8480205,Emil Bemstrom,R,CBJ,24,31,5,6,11
6,8478585,Derek Ryan,C,EDM,37,51,5,6,11
6,8471669,Paul Stastny,C,CAR,38,28,5,6,11
6,8480879,Jacob Bernard-Docker,D,OTT,23,42,4,7,11
6,8476467,Jamie Oleksiak,D,SEA,31,82,3,8,11
6,8476858,Phillip Di Giuseppe,L,VAN,30,62,3,8,11
6,8479514,Rem Pitlick,C,CHI,26,36,3,8,11
6,8476624,Barclay Goodrow,C,NYR,30,80,2,9,11
6,8477034,Jaycob Megna,D,CHI,31,45,2,9,11
6,8480058,Pierre-Olivier Joseph,D,PIT,24,53,1,10,11
6,8477851,Jordan Oesterle,D,CGY,31,48,0,11,11
6,8470604,Jeff Carter,C,PIT,38,76,8,2,10
6,8477353,Tyler Motte,C,TBL,28,72,8,2,10
6,8475842,Sam Carrick,C,ANA,31,54,7,3,10
6,8480980,Connor Dewar,C,MIN,24,48,7,3,10
6,8478421,A.J. Greer,L,CGY,27,47,6,4,10
6,8480806,Isac Lundestrom,C,ANA,24,46,5,5,10
6,8482712,Oskar Olausson,R,COL,21,28,5,5,10
6,8476856,Matt Dumba,D,ARI,29,78,5,5,10
6,8476871,Tanner Pearson,L,MTL,31,36,4,6,10
6,8478434,Keegan Kolesar,R,VGK,26,50,4,6,10
6,8478495,Denis Gurianov,R,NSH,26,40,3,7,10
6,8476442,Matt Nieto,L,PIT,31,53,3,7,10
6,8479414,Nathan Bastian,R,NJD,26,51,3,7,10
6,8479543,Michael Pezzetta,L,MTL,25,44,3,7,10
6,8475461,Andrew Agozzino,L,SJS,32,28,3,7,10
6,8474161,Jakub Voracek,R,CBJ,34,29,2,8,10
6,8477015,Connor Brown,R,EDM,29,75,2,8,10
6,8479371,Dante Fabbro,D,NSH,25,42,2,8,10
6,8476441,Joel Edmundson,D,WSH,30,66,2,8,10
6,8481592,Jakob Pelletier,L,CGY,22,31,2,8,10
6,8474567,Zach Bogosian,D,MIN,33,70,1,9,10
6,8480860,Kevin Bahl,D,NJD,23,81,0,10,10
6,8474207,Nick Holden,D,OTT,36,31,0,10,10
6,8479718,Alex Barré-Boulet,C,TBL,26,35,6,3,9
6,8479383,Boris Katchouk,L,CHI,25,35,5,4,9
6,8479328,Julien Gauthier,R,NYI,26,27,5,4,9
6,8479402,Jake Bean,D,CBJ,25,49,4,5,9
6,8477931,Tomas Nosek,L,NJD,31,40,4,5,9
6,8475177,Calvin de Haan,D,TBL,32,72,3,6,9
6,8477846,Ryan Carpenter,C,SJS,32,36,3,6,9
6,8480008,Adam Ruzicka,C,ARI,24,41,3,6,9
6,8478028,Fredrik Olofsson,L,COL,27,53,3,6,9
6,8482451,Mikael Pyyhtia,L,CBJ,22,29,3,6,9
6,8476410,Josh Leivo,L,STL,30,28,2,7,9
6,8476429,Scott Mayfield,D,NYI,31,67,2,7,9
6,8476967,Brett Kulak,D,EDM,29,82,2,7,9
6,8482730,Brandt Clarke,D,LAK,20,38,2,7,9
6,8479315,Joey Anderson,R,CHI,25,28,2,7,9
6,8474162,Jake Muzzin,D,TOR,34,29,2,7,9
6,8477335,Kyle Burroughs,D,SJS,28,74,1,8,9
6,8481527,Kaedan Korczak,D,VGK,22,26,1,8,9
6,8477018,Ben Hutton,D,VGK,30,31,1,8,9
6,8483460,David Jiricek,D,CBJ,20,36,1,8,9
6,8476372,Nick Seeler,D,PHI,30,55,0,9,9
6,8482679,Matt Coronato,R,CGY,21,42,5,3,8
6,8480252,Cole Guttman,C,CHI,24,27,4,4,8
6,8479368,Max Jones,L,ANA,25,38,4,4,8
6,8482452,Elliot Desnoyers,L,PHI,21,26,4,4,8
6,8474683,Derek Grant,C,ANA,33,28,3,5,8
6,8481477,Nico Sturm,C,SJS,28,34,3,5,8
6,8477392,Hudson Fasching,R,NYI,28,35,3,5,8
6,8477070,Liam O'Brien,C,ARI,29,49,3,5,8
6,8478870,Rudolfs Balcers,L,TBL,26,26,3,5,8
6,8480995,Pontus Holmberg,R,TOR,24,27,2,6,8
6,8479442,Troy Stecher,D,ARI,29,71,1,7,8
6,8479576,Vincent Desharnais,D,EDM,27,49,1,7,8
6,8477971,Andreas Englund,D,LAK,27,52,1,7,8
6,8470595,Eric Staal,C,FLA,39,27,1,7,8
6,8475718,Justin Holl,D,DET,31,63,0,8,8
6,8481690,Tyler Angle,C,CBJ,23,29,6,1,7
6,8479439,Jacob MacDonald,D,SJS,30,21,6,1,7
6,8471709,Marc-Edouard Vlasic,D,SJS,36,31,5,2,7
6,8477478,William Carrier,L,VGK,29,33,5,2,7
6,8477573,Nathan Walker,L,STL,29,18,5,2,7
6,8478131,Ondrej Kase,R,CAR,28,28,4,3,7
6,8482241,Radim Zohorna,L,PIT,27,31,4,3,7
6,8477941,Nick Ritchie,L,CGY,28,27,4,3,7
6,8480328,David Gust,R,CHI,29,27,3,4,7
6,8481058,Jesse Ylönen,R,MTL,24,43,3,4,7
6,8474009,Nick Bonino,C,NYR,35,73,3,4,7
6,8476891,Matt Grzelcyk,D,BOS,29,41,2,5,7
6,8479458,Nikita Zaitsev,D,CHI,32,26,2,5,7
6,8477541,Dakota Mermis,D,MIN,29,37,2,5,7
6,8478099,Kevin Labanc,R,SJS,28,32,2,5,7
6,8481641,Joel Kiviranta,L,COL,27,40,2,5,7
6,8480880,Jakub Lauko,C,BOS,23,40,2,5,7
6,8470966,Mark Giordano,D,TOR,40,36,1,6,7
6,8481537,Nikita Okhotiuk,D,SJS,23,38,1,6,7
6,8478502,Dennis Gilbert,D,CGY,27,31,1,6,7
6,8478104,Sammy Blais,L,STL,27,43,1,6,7
6,8480871,Adam Boqvist,D,CBJ,23,22,0,7,7
6,8479291,Kevin Rooney,C,CGY,30,33,4,2,6
6,8479520,Brandon Duhaime,R,MIN,26,54,4,2,6
6,8479066,Ryan Lomberg,L,FLA,29,55,4,2,6
6,8476278,Colin Blackwell,C,CHI,30,25,3,3,6
6,8479968,Vinni Lettieri,C,MIN,28,24,3,3,6
6,8475780,Chris Wagner,R,BOS,32,27,3,3,6
6,8480901,Karson Kuhlman,C,WPG,28,30,2,4,6
6,8476449,Scott Harrington,D,ANA,30,28,2,4,6
6,8477369,Carson Soucy,D,VAN,29,21,2,4,6
6,8482496,Nils Aman,C,VAN,23,31,2,4,6
6,8480789,Oliver Wahlstrom,R,NYI,23,27,2,4,6
6,8479348,Kale Clague,D,BUF,25,28,2,4,6
6,8476915,Jujhar Khaira,L,MIN,29,29,1,5,6
6,8481567,Henry Thrun,D,SJS,22,51,1,5,6
6,8480222,Sebastian Aho,D,NYI,27,41,1,5,6
6,8474568,Luke Schenn,D,NSH,34,36,1,5,6
6,8479982,Conor Timmins,D,TOR,25,16,1,5,6
6,8483464,Marco Kasper,C,DET,19,28,1,5,6
6,8479369,Andrew Peeke,D,CBJ,25,20,0,6,6
6,8475797,Jarred Tinordi,D,CHI,31,32,0,6,6
6,8479372,Josh Mahura,D,FLA,25,20,0,6,6
6,8477930,Pierre-Edouard Bellemare,L,SEA,38,29,4,1,5
6,8480184,Gustav Lindström,D,ANA,25,22,3,2,5
6,8480072,Lias Andersson,C,LAK,25,30,3,2,5
6,8473544,Derick Brassard,C,OTT,36,31,2,3,5
6,8480831,Alec Regula,D,CHI,23,27,2,3,5
6,8478408,Travis Dermott,D,ARI,27,37,2,3,5
6,8482964,Arber Xhekaj,D,MTL,22,24,2,3,5
6,8475750,Jon Merrill,D,MIN,31,38,2,3,5
6,8474618,Marco Scandella,D,STL,33,49,2,3,5
6,8480025,MacKenzie Entwistle,R,CHI,24,46,2,3,5
6,8479536,Axel Jonsson-Fjallby,L,WPG,25,26,2,3,5
6,8480275,Nick Swaney,R,MIN,26,28,2,3,5
6,8481167,Brayden Pachal,D,CGY,24,50,2,3,5
6,8482711,Stanislav Svozil,D,CBJ,20,29,1,4,5
6,8474090,Brendan Smith,D,NJD,34,36,1,4,5
6,8477384,Josh Brown,D,ARI,29,28,1,4,5
6,8481708,Zac Jones,D,NYR,23,17,1,4,5
6,8480084,Nick DeSimone,D,NJD,29,23,1,4,5
6,8479671,Mathieu Olivier,R,CBJ,26,25,1,4,5
6,8479547,Matthew Phillips,R,PIT,25,27,1,4,5
6,8476919,Chris Tierney,C,NJD,29,28,1,4,5
6,8476952,Dominic Toninato,C,WPG,29,15,1,4,5
6,8482652,Walker Duehr,R,CGY,26,26,1,4,5
6,8476988,Matt Benning,D,SJS,29,42,0,5,5
6,8471303,Alexander Edler,D,LAK,37,30,0,5,5
6,8480950,Ilya Lyubushkin,D,ANA,29,79,0,5,5
6,8477482,Zach Sanford,L,CHI,29,26,0,5,5
6,8481617,Vasily Podkolzin,R,VAN,22,26,0,5,5
6,8476878,Zemgus Girgensons,L,BUF,29,36,4,0,4
6,8481754,Nikita Nesterenko,C,ANA,22,28,3,1,4
6,8482077,Dylan Holloway,L,EDM,22,23,3,1,4
6,8480011,Klim Kostin,C,DET,24,32,3,1,4
6,8477454,Adam Erne,L,EDM,28,54,2,2,4
6,8479370,Tyson Jost,C,BUF,25,29,2,2,4
6,8481019,David Gustafsson,C,WPG,23,27,2,2,4
6,8479981,Jonah Gadjovich,L,FLA,25,27,2,2,4
6,8480041,Dmitri Samorukov,D,STL,24,28,1,3,4
6,8477938,Haydn Fleury,D,TBL,27,16,1,3,4
6,8480003,Jesper Boqvist,C,BOS,25,20,1,3,4
6,8479994,Jaret Anderson-Dolan,C,LAK,24,24,1,3,4
6,8475752,Tyler Pitlick,C,NYR,32,34,1,3,4
6,8476913,Devin Shore,C,SEA,29,21,1,3,4
6,8480874,Adam Ginning,D,PHI,23,26,1,3,4
6,8483641,Anton Levtchi,L,FLA,28,27,1,3,4
6,8475762,Derek Forbort,D,BOS,31,57,0,4,4
6,8480242,Arnaud Durandeau,L,NYI,24,29,0,4,4
6,8482176,Wyatt Kaiser,D,CHI,21,23,0,4,4
6,8478452,Caleb Jones,D,COL,26,20,0,4,4
6,8478454,Noah Juulsen,D,VAN,26,38,0,4,4
6,8478424,Jansen Harkins,C,PIT,26,34,0,4,4
6,8480977,Semyon Der-Arguchintsev,C,TOR,23,29,0,4,4
6,8473446,Erik Johnson,D,BUF,35,46,3,0,3
6,8481147,Reese Johnson,C,CHI,25,34,2,1,3
6,8478078,Rourke Chartier,C,OTT,27,34,2,1,3
6,8474709,Matt Martin,L,NYI,34,31,2,1,3
6,8479772,Zack MacEwen,R,OTT,27,22,2,1,3
6,8477962,Brendan Lemieux,L,CAR,27,23,2,1,3
6,8475766,Austin Watson,L,TBL,31,28,2,1,3
6,8480468,James Hamblin,L,EDM,24,31,2,1,3
6,8480355,Mark Kastelic,C,OTT,24,34,2,1,3
6,8482081,Sean Farrell,C,MTL,22,27,2,1,3
6,8474218,Jason Demers,D,EDM,35,31,1,2,3
6,8481122,Simon Benoit,D,TOR,25,39,1,2,3
6,8478451,Ethan Bear,D,WSH,26,16,1,2,3
6,8471686,Marc Staal,D,PHI,36,20,1,2,3
6,8477244,Chad Ruhwedel,D,PIT,33,37,1,2,3
6,8481541,Samuel Bolduc,D,NYI,23,33,1,2,3
6,8476934,Brock McGinn,L,ANA,29,24,1,2,3
6,8476994,Vinnie Hinostroza,C,PIT,29,14,1,2,3
6,8480007,Jonas Rondbjerg,R,VGK,24,17,1,2,3
6,8476867,Brendan Gaunce,C,CBJ,29,8,1,2,3
6,8478904,Steven Lorentz,C,FLA,27,28,1,2,3
6,8479379,Givani Smith,R,SJS,25,26,1,2,3
6,8476310,Lukas Sedlak,C,PHI,30,26,1,2,3
6,8482448,Samuel Knazko,D,CBJ,21,29,0,3,3
6,8482516,Matthew Kessel,D,STL,23,47,0,3,3
6,8478450,Parker Wotherspoon,D,BOS,26,23,0,3,3
6,8477810,Joel Hanley,D,DAL,32,26,0,3,3
6,8480853,Liam Foudy,C,NSH,23,13,0,3,3
6,8475235,Nicolas Deslauriers,L,PHI,32,47,0,3,3
6,8479580,Dylan Gambrell,C,OTT,27,31,2,0,2
6,8480776,Sheldon Rempal,R,VGK,28,5,2,0,2
6,8471817,Ryan Reaves,R,TOR,36,27,2,0,2
6,8477073,Kurtis MacDermid,D,COL,29,28,2,0,2
6,8482207,William Dufour,R,NYI,21,29,1,1,2
6,8482133,Thomas Bordeleau,C,SJS,21,6,1,1,2
6,8481006,Tyler Tucker,D,STL,23,16,1,1,2
6,8479362,Riley Tufte,L,COL,25,5,1,1,2
6,8478051,Max Willman,C,NJD,28,13,1,1,2
6,8481532,Alex Turcotte,C,LAK,22,6,1,1,2
6,8481812,Nikolai Knyzhov,D,SJS,26,38,0,2,2
6,8475747,Patrik Nemeth,D,ARI,31,29,0,2,2
6,8480070,Ian Mitchell,D,BOS,24,13,0,2,2
6,8480196,Jacob Bryson,D,BUF,26,8,0,2,2
6,8480870,Bo Groulx,C,ANA,23,32,0,2,2
6,8473473,Milan Lucic,L,BOS,35,4,0,2,2
6,8477464,Nic Petan,C,MIN,28,6,0,2,2
6,8477527,Ross Johnston,L,ANA,29,41,0,2,2
6,8481043,Cole Koepke,L,TBL,25,8,0,2,2
6,8471873,Anton Stralman,D,BOS,37,27,1,0,1
6,8482181,Tristen Robins,C,SJS,22,28,1,0,1
6,8481056,Spencer Stastney,D,NSH,23,9,1,0,1
6,8480823,Alexander Alexeyev,D,WSH,24,13,1,0,1
6,8476873,Mark Jankowski,C,NSH,29,5,1,0,1
6,8480021,Jack Studnicka,C,SJS,24,14,1,0,1
6,8478409,Anthony Richard,C,BOS,27,4,1,0,1
6,8483570,Ben Meyers,C,COL,25,9,1,0,1
6,8481422,Jacob Lucchini,C,MIN,28,13,1,0,1
6,8479546,Oskar Steen,C,BOS,25,34,1,0,1
6,8481239,Samuel Fagemo,L,LAK,23,8,1,0,1
6,8483424,Owen Beck,C,MTL,19,27,0,1,1
6,8482762,Simon Edvinsson,D,DET,20,2,0,1,1
6,8481161,Jake Christiansen,D,CBJ,24,3,0,1,1
6,8480157,Calle Rosen,D,STL,29,5,0,1,1
6,8479984,Cal Foote,D,NJD,25,4,0,1,1
6,8479321,Lucas Johansen,D,WSH,26,6,0,1,1
6,8479378,Logan Stanley,D,WPG,25,10,0,1,1
6,8478017,Mark Friedman,D,VAN,28,20,0,1,1
6,8482095,Tyler Kleven,D,OTT,21,5,0,1,1
6,8479320,Max Lajoie,D,TOR,26,5,0,1,1
6,8477887,Patrick Brown,C,BOS,31,11,0,1,1
6,8480245,Olle Lycksell,R,PHI,24,5,0,1,1
6,8478146,Matthew Highmore,C,OTT,27,6,0,1,1
6,8480845,Rasmus Kupari,C,WPG,23,21,0,1,1
6,8478512,Austin Czarnik,C,DET,31,18,0,1,1
6,8479367,William Lockwood,R,FLA,25,23,0,1,1
6,8481543,Nikita Alexandrov,C,STL,23,18,0,1,1
6,8483597,Milos Kelemen,L,ARI,24,10,0,1,1
6,8477359,Tucker Poolman,D,VAN,30,26,0,0,0
6,8483565,Nick Blankenburg,D,CBJ,25,6,0,0,0
6,8483620,Marcus Bjork,D,CBJ,26,0,0,0,0
6,8481521,Ronnie Attard,D,PHI,24,0,0,0,0
6,8482399,Billy Sweezey,D,CBJ,27,0,0,0,0
6,8481072,Tim Berni,D,CBJ,23,0,0,0,0
6,8476884,Derrick Pouliot,D,SJS,29,0,0,0,0
6,8482624,Daniil Miromanov,D,VGK,26,2,0,0,0
6,8482861,Vincent Iorio,D,WSH,21,0,0,0,0
6,8478465,Guillaume Brisebois,D,VAN,26,0,0,0,0
6,8484256,Jake Livingstone,D,NSH,24,0,0,0,0
6,8481599,Victor Soderstrom,D,ARI,22,1,0,0,0
6,8474027,Justin Braun,D,PHI,36,0,0,0,0
6,8478062,Dysin Mayo,D,ARI,27,0,0,0,0
6,8481563,Drew Helleson,D,ANA,22,0,0,0,0
6,8481575,Lassi Thomson,D,OTT,23,0,0,0,0
6,8483619,Filip Roos,D,CHI,24,4,0,0,0
6,8481461,Corey Schueneman,D,MTL,28,0,0,0,0
6,8478846,Christian Wolanin,D,VAN,28,0,0,0,0
6,8479395,Dennis Cholowski,D,NYI,25,0,0,0,0
6,8479945,Gavin Bayreuther,D,CBJ,29,0,0,0,0
6,8474818,Jordie Benn,D,TOR,36,0,0,0,0
6,8479421,Jacob Moverare,D,LAK,25,5,0,0,0
6,8479329,Frederic Allard,D,MTL,26,0,0,0,0
6,8481600,Tobias Bjornfot,D,VGK,22,3,0,0,0
6,8477462,Robert Hagg,D,ANA,28,5,0,0,0
6,8476470,Nathan Beaulieu,D,ANA,31,0,0,0,0
6,8484254,Akito Hirose,D,VAN,24,3,0,0,0
6,8479388,Riley Stillman,D,BUF,25,0,0,0,0
6,8482824,Nick Cicek,D,SJS,23,0,0,0,0
6,8480056,Jack Rathbone,D,VAN,24,0,0,0,0
6,8476850,Ryan Murray,D,EDM,30,0,0,0,0
6,8478841,Colton White,D,ANA,26,0,0,0,0
6,8480160,Radim Simek,D,SJS,31,0,0,0,0
6,8478491,Jacob Larsson,D,OTT,26,0,0,0,0
6,8475857,Kevin Gravel,D,NSH,31,0,0,0,0
6,8482067,Connor Mackey,D,NYR,27,1,0,0,0
6,8477433,Ben Harpur,D,NYR,28,0,0,0,0
6,8481572,Ville Heinola,D,WPG,22,0,0,0,0
6,8478415,Jakub Zboril,D,BOS,26,0,0,0,0
6,8477341,Andreas Johnsson,L,SJS,29,0,0,0,0
6,8480216,Jacob Peterson,C,SJS,24,6,0,0,0
6,8477467,Gustav Olofsson,D,SEA,29,0,0,0,0
6,8478476,Kyle Capobianco,D,WPG,26,0,0,0,0
6,8479985,Cale Fleury,D,SEA,25,0,0,0,0
6,8475227,Chris Wideman,D,MTL,33,0,0,0,0
6,8479333,Libor Hajek,D,NYR,25,0,0,0,0
6,8479376,Victor Mete,D,PHI,25,1,0,0,0
6,8480439,Mac Hollowell,D,TOR,25,0,0,0,0
6,8480467,Austin Strand,D,ANA,26,0,0,0,0
6,8477981,Roland McKeown,D,NSH,27,0,0,0,0
6,8474628,Michael Stone,D,CGY,33,0,0,0,0
6,8480034,Joel Teasdale,L,MTL,24,0,0,0,0
6,8481609,Vladislav Kolyachonok,D,ARI,22,1,0,0,0
6,8479602,Jeremy Davies,D,BUF,27,0,0,0,0
6,8479639,Dylan Coghlan,D,CAR,25,0,0,0,0
6,8478506,Gabriel Carlsson,D,WSH,26,0,0,0,0
6,8477463,Steven Santini,D,STL,28,0,0,0,0
6,8478075,Anders Bjork,L,CHI,27,0,0,0,0
6,8484287,Cole McWard,D,VAN,22,1,0,0,0
6,8474145,Robert Bortuzzo,D,NYI,34,15,0,0,0
6,8475625,Matt Irwin,D,WSH,36,0,0,0,0
6,8482179,Justin Richards,C,CBJ,25,0,0,0,0
6,8481649,Joona Luoto,L,CBJ,26,0,0,0,0
6,8479026,Philippe Myers,D,TBL,26,5,0,0,0
6,8480935,Lawrence Pilut,D,BUF,28,0,0,0,0
6,8479578,Casey Fitzgerald,D,FLA,26,0,0,0,0
6,8480071,Robin Salo,D,NYI,25,0,0,0,0
6,8478224,Luke Philp,C,CHI,28,0,0,0,0
6,8484125,Hunter McKown,C,CBJ,21,0,0,0,0
6,8481679,Maxence Guenette,D,OTT,22,1,0,0,0
6,8479423,Alex Nylander,L,PIT,25,5,0,0,0
6,8480441,Trey Fix-Wolansky,R,CBJ,24,1,0,0,0
6,8480820,Filip Kral,D,TOR,24,0,0,0,0
6,8479523,Lucas Carlsson,D,FLA,26,0,0,0,0
6,8479304,Kyle Criscuolo,C,SJS,31,0,0,0,0
6,8474697,Mark Borowiecki,D,NSH,34,0,0,0,0
6,8480842,Filip Hallander,C,PIT,23,0,0,0,0
6,8481725,Elmer Soderblom,L,DET,22,0,0,0,0
6,8479252,Dan Renouf,D,BOS,29,0,0,0,0
6,8481591,Sam Poulin,R,PIT,22,0,0,0,0
6,8475968,Alex Belzile,R,MTL,32,0,0,0,0
6,8475772,Riley Sheahan,C,BUF,32,0,0,0,0
6,8475163,Alex Chiasson,R,DET,33,0,0,0,0
6,8481598,Philip Broberg,D,EDM,22,10,0,0,0
6,8478455,Austin Wagner,L,CHI,26,0,0,0,0
6,8476779,Brad Hunt,D,COL,35,0,0,0,0
6,8479335,Rasmus Asplund,C,NSH,26,0,0,0,0
6,8478967,Lane Pederson,C,CBJ,26,0,0,0,0
6,8481077,John Leonard,L,NSH,25,0,0,0,0
6,8481585,Egor Afanasyev,L,NSH,22,2,0,0,0
6,8483397,Marc McLaughlin,C,BOS,24,0,0,0,0
6,8480443,Kristian Reichel,C,WPG,25,0,0,0,0
6,8481751,Lukas Rousek,R,BUF,24,5,0,0,0
6,8476396,Steven Fogarty,C,MIN,30,0,0,0,0
6,8478881,Brett Seney,L,CHI,27,4,0,0,0
6,8480326,Sheldon Dries,C,VAN,29,0,0,0,0
6,8481433,Taro Hirose,L,DET,27,0,0,0,0
6,8480833,Vitali Kravtsov,R,VAN,24,0,0,0,0
6,8481550,Adam Beckman,L,MIN,22,0,0,0,0
6,8479972,Mason Shaw,C,MIN,25,0,0,0,0
6,8477460,Laurent Dauphin,C,ARI,28,0,0,0,0
6,8476166,Taylor Fedun,D,PIT,35,0,0,0,0
6,8478067,Oskar Lindblom,L,SJS,27,1,0,0,0
6,8479944,Zach Aston-Reese,C,DET,29,1,0,0,0
6,8479465,Drake Caggiula,L,PIT,29,0,0,0,0
6,8481740,Tyce Thompson,R,NJD,24,0,0,0,0
6,8476948,Charles Hudon,L,COL,29,0,0,0,0
6,8480863,Gabriel Fortier,L,TBL,23,0,0,0,0
6,8471887,Patric Hornqvist,R,FLA,36,0,0,0,0
6,8477471,Dillon Heatherington,D,OTT,28,0,0,0,0
6,8481441,Joe Snively,C,WSH,27,3,0,0,0
6,8478173,Hayden Hodgson,R,PHI,27,0,0,0,0
6,8481720,Nick Abruzzese,C,TOR,24,0,0,0,0
6,8478843,Denis Malgin,C,COL,26,0,0,0,0
6,8483630,Pavol Regenda,L,ANA,24,0,0,0,0
6,8478373,Nikita Soshnikov,R,NYI,30,0,0,0,0
6,8482147,Jean-Luc Foudy,C,COL,21,0,0,0,0
6,8478431,Evgeny Svechnikov,L,SJS,27,0,0,0,0
6,8477210,Buddy Robinson,R,CHI,32,0,0,0,0
6,8479404,Henrik Borgstrom,C,WSH,26,0,0,0,0
6,8481712,Matej Blumel,R,DAL,23,0,0,0,0
6,8475278,Byron Froese,C,VGK,32,7,0,0,0
6,8479338,Markus Niemelainen,D,EDM,25,0,0,0,0
6,8471794,Darren Helm,C,COL,36,0,0,0,0
6,8482623,Josh Dunne,C,CBJ,25,0,0,0,0
6,8482641,Matt Kiersted,D,FLA,25,0,0,0,0
6,8476851,Alex Galchenyuk,C,COL,29,0,0,0,0
6,8479366,Logan Brown,C,STL,25,0,0,0,0
6,8480822,Martin Kaut,R,SJS,24,0,0,0,0
6,8482834,Jesper Froden,R,SEA,29,0,0,0,0
6,8480844,Grigori Denisenko,L,VGK,23,3,0,0,0
6,8482635,Mike Hardman,L,CHI,24,0,0,0,0
6,8477357,Saku Maenalanen,R,WPG,29,0,0,0,0
6,8480979,Nathan Smith,C,ARI,25,0,0,0,0
6,8479356,Kieffer Bellows,L,PHI,25,0,0,0,0
6,8475795,Dylan McIlrath,D,WSH,31,1,0,0,0
6,8478400,Colin White,C,PIT,26,9,0,0,0
6,8478446,Glenn Gawdin,C,ANA,26,0,0,0,0
6,8476326,Josh Archibald,R,PIT,31,0,0,0,0
6,8481683,Aidan McDonough,L,VAN,24,0,0,0,0
6,8480267,Sammy Walker,C,MIN,24,4,0,0,0
6,8477520,Jean-Sebastien Dea,C,ARI,29,0,0,0,0
6,8476439,Brett Ritchie,R,ARI,30,0,0,0,0
6,8479518,Fredrik Karlström,C,DAL,25,0,0,0,0
6,8477126,Jayson Megna,C,ANA,33,0,0,0,0
6,8479644,Matt Luff,R,DET,26,0,0,0,0
6,8478211,Dryden Hunt,L,CGY,28,5,0,0,0
6,8480226,Marián Studenic,R,SEA,25,2,0,0,0
6,8480037,Aleksi Heponiemi,C,FLA,24,0,0,0,0
6,8480292,Carson Meyer,R,CBJ,26,0,0,0,0
6,8482634,Alex Steeves,C,TOR,24,1,0,0,0
6,8475178,Zack Kassian,R,ARI,32,0,0,0,0
6,8483524,Shane Wright,C,SEA,19,3,0,0,0
6,8482654,Jackson Cates,C,PHI,26,0,0,0,0
6,8479550,Tanner Laczynski,C,PHI,26,0,0,0,0
6,8479991,Jake Leschyshyn,C,NYR,24,1,0,0,0
6,8474613,Derek Stepan,C,CAR,33,0,0,0,0
6,8478367,Cole Bardreau,C,NYI,30,0,0,0,0
6,8480890,Jan Jenik,R,ARI,23,1,0,0,0
6,8475160,Kyle Clifford,L,TOR,32,0,0,0,0
6,8479705,Jeffrey Viel,L,SJS,26,0,0,0,0
6,8477401,John Hayden,C,SEA,28,2,0,0,0
6,8480846,Sampo Ranta,L,COL,23,0,0,0,0
6,8482691,Aatu Raty,C,VAN,21,0,0,0,0
6,8481070,Hugh McGing,L,STL,25,5,0,0,0
6,8479573,Mikhail Maltsev,L,COL,25,0,0,0,0
6,8482250,Callahan Burke,C,CAR,26,1,0,0,0
6,8481102,Egor Sokolov,L,OTT,23,0,0,0,0
6,8481518,Nolan Foote,L,NJD,23,0,0,0,0
6,8474190,Wayne Simmonds,R,TOR,35,0,0,0,0
6,8474610,Zac Dalpe,C,FLA,34,0,0,0,0
6,8479347,Tyler Benson,L,EDM,25,0,0,0,0
6,8476404,Andy Andreoff,C,NYI,32,0,0,0,0
6,8476390,Joseph Cramarossa,C,MIN,31,0,0,0,0
6,8483549,Lucas Condotta,L,MTL,26,3,0,0,0
6,8482197,Adam Raska,R,MIN,22,5,0,0,0
6,8479533,Joona Koppanen,L,PIT,25,3,0,0,0
6,8479526,Otto Koivula,L,NYI,25,0,0,0,0
6,8479375,William Bitten,C,STL,25,0,0,0,0
6,8474089,Brad Malone,C,EDM,34,0,0,0,0
6,8478058,CJ Suess,L,SJS,29,0,0,0,0
6,8478147,Bokondji Imama,L,ARI,27,0,0,0,0
6,8477320,Anton Blidh,L,NYR,28,1,0,0,0
6,8477993,Justin Kirkland,C,ARI,27,2,0,0,0
6,8480836,Jonathan Gruden,C,PIT,23,5,0,0,0
6,8480032,Shane Bowers,C,NJD,24,3,0,0,0
7,8477492,Nathan MacKinnon,C,COL,28,82,51,87,138
7,8478402,Connor McDavid,C,EDM,26,80,37,93,130
7,8478420,Mikko Rantanen,R,COL,27,82,47,74,121
7,8476453,Nikita Kucherov,R,TBL,30,81,49,71,120
7,8477956,David Pastrnak,R,BOS,27,82,47,71,118
7,8478550,Artemi Panarin,L,NYR,32,82,48,69,117
7,8479318,Auston Matthews,C,TOR,26,81,76,39,115
7,8480012,Elias Pettersson,C,VAN,25,81,41,63,104
7,8479314,Matthew Tkachuk,L,FLA,26,82,35,66,101
7,8476468,J.T. Miller,C,VAN,30,81,34,67,101
7,8477934,Leon Draisaitl,C,EDM,28,82,35,64,99
7,8477939,William Nylander,R,TOR,27,82,36,62,98
7,8478483,Mitchell Marner,R,TOR,26,81,34,63,97
7,8480069,Cale Makar,D,COL,25,77,22,70,92
7,8471675,Sidney Crosby,C,PIT,36,82,49,41,90
7,8480800,Quinn Hughes,D,VAN,24,81,17,72,89
7,8477933,Sam Reinhart,C,FLA,28,82,51,37,88
7,8477404,Jake Guentzel,L,PIT,29,81,38,49,87
7,8478445,Mathew Barzal,C,NYI,26,81,26,61,87
7,8476887,Filip Forsberg,L,NSH,29,82,40,45,85
7,8477409,Carter Verhaeghe,C,FLA,28,82,43,41,84
7,8474564,Steven Stamkos,C,TBL,33,79,43,41,84
7,8477493,Aleksander Barkov,C,FLA,28,76,20,64,84
7,8476459,Mika Zibanejad,C,NYR,30,81,33,50,83
7,8480023,Robert Thomas,C,STL,24,82,23,60,83
7,8480027,Jason Robertson,L,DAL,24,82,27,54,81
7,8476454,Ryan Nugent-Hopkins,C,EDM,30,82,23,58,81
7,8475786,Zach Hyman,L,EDM,31,81,50,30,80
7,8475184,Chris Kreider,L,NYR,32,82,42,38,80
7,8478439,Travis Konecny,R,PHI,26,81,38,42,80
7,8478864,Kirill Kaprizov,L,MIN,26,75,32,48,80
7,8479407,Jesper Bratt,L,NJD,25,81,26,54,80
7,8475167,Victor Hedman,D,TBL,33,80,13,67,80
7,8478427,Sebastian Aho,C,CAR,26,78,29,50,79
7,8475913,Mark Stone,R,VGK,31,81,26,53,79
7,8482116,Tim Stützle,C,OTT,21,82,20,59,79
7,8478010,Brayden Point,C,TBL,27,82,35,43,78
7,8479323,Adam Fox,D,NYR,25,72,21,57,78
7,8478444,Brock Boeser,R,VAN,26,81,43,34,77
7,8475168,Matt Duchene,C,DAL,32,81,32,45,77
7,8480018,Nick Suzuki,C,MTL,24,82,29,48,77
7,8481559,Jack Hughes,C,NJD,22,65,24,53,77
7,8474600,Roman Josi,D,NSH,33,82,20,55,75
7,8480865,Noah Dobson,D,NYI,23,82,10,65,75
7,8478449,Roope Hintz,C,DAL,27,80,36,38,74
7,8477500,Bo Horvat,C,NYI,28,81,34,38,72
7,8479343,Clayton Keller,R,ARI,25,82,32,40,72
7,8470794,Joe Pavelski,C,DAL,39,82,28,44,72
7,8473512,Claude Giroux,R,OTT,35,82,32,39,71
7,8476460,Mark Scheifele,C,WPG,30,75,28,43,71
7,8477949,Alex Tuch,R,BUF,27,75,27,44,71
7,8479542,Brandon Hagel,L,TBL,25,82,26,45,71
7,8478975,Mason Marchment,L,DAL,28,81,26,45,71
7,8473419,Brad Marchand,L,BOS,35,82,37,33,70
7,8480208,Drake Batherson,R,OTT,25,82,31,39,70
7,8475158,Ryan O'Reilly,C,NSH,32,82,27,43,70
7,8479385,Jordan Kyrou,C,STL,25,82,26,44,70
7,8477960,Adrian Kempe,R,LAK,27,82,26,44,70
7,8471685,Anze Kopitar,C,LAK,36,82,24,46,70
7,8477942,Kevin Fiala,L,LAK,27,82,20,50,70
7,8475692,Mats Zuccarello,R,MIN,36,73,16,54,70
7,8477946,Dylan Larkin,C,DET,27,76,33,36,69
7,8476399,Blake Coleman,C,CGY,32,82,33,36,69
7,8475794,Tyler Seguin,C,DAL,31,82,29,40,69
7,8476389,Vincent Trocheck,C,NYR,30,82,23,46,69
7,8480803,Evan Bouchard,D,EDM,24,82,21,48,69
7,8478403,Jack Eichel,C,VGK,27,70,29,38,67
7,8480797,Joel Farabee,L,PHI,23,81,29,38,67
7,8475172,Nazem Kadri,C,CGY,33,82,24,43,67
7,8476539,Jonathan Marchessault,R,VGK,33,81,41,25,66
7,8479999,Casey Mittelstadt,C,BUF,25,82,20,46,66
7,8474578,Erik Karlsson,D,PIT,33,82,14,52,66
7,8480801,Brady Tkachuk,L,OTT,24,82,34,31,65
7,8471214,Alex Ovechkin,L,WSH,38,79,25,40,65
7,8475784,Jeff Skinner,L,BUF,31,74,28,36,64
7,8478873,Troy Terry,R,ANA,26,79,26,38,64
7,8479337,Alex DeBrincat,R,DET,26,82,25,39,64
7,8480839,Rasmus Dahlin,D,BUF,23,81,22,42,64
7,8479425,Filip Hronek,D,VAN,26,81,10,54,64
7,8477955,Jared McCann,L,SEA,27,81,36,27,63
7,8478493,Joel Eriksson Ek,C,MIN,26,82,34,29,63
7,8475754,Brock Nelson,C,NYI,32,82,34,29,63
7,8477501,Valeri Nichushkin,R,COL,28,67,30,33,63
7,8481540,Cole Caufield,R,MTL,22,82,29,33,62
7,8477402,Pavel Buchnevich,L,STL,28,80,26,36,62
7,8475745,Charlie Coyle,C,BOS,31,82,25,37,62
7,8482093,Seth Jarvis,C,CAR,21,81,24,38,62
7,8477416,Oliver Bjorkstrand,R,SEA,28,82,23,39,62
7,8475765,Vladimir Tarasenko,R,OTT,32,80,22,40,62
7,8478366,Frank Vatrano,R,ANA,29,82,36,25,61
7,8471215,Evgeni Malkin,C,PIT,37,82,24,36,60
7,8476853,Morgan Rielly,D,TOR,29,79,10,50,60
7,8475166,John Tavares,C,TOR,33,80,19,40,59
7,8482124,Quinton Byfield,R,LAK,21,80,25,33,58
7,8482078,Lucas Raymond,L,DET,21,82,24,34,58
7,8480039,Martin Necas,C,CAR,24,76,23,35,58
7,8477504,Josh Morrissey,D,WPG,28,81,11,47,58
7,8476875,Mike Matheson,D,MTL,29,82,9,49,58
7,8481557,Matt Boldy,L,MIN,22,75,30,27,57
7,8477940,Nikolaj Ehlers,L,WPG,27,81,24,33,57
7,8480830,Andrei Svechnikov,R,CAR,23,60,21,36,57
7,8474679,Gustav Nyquist,C,NSH,34,82,16,41,57
7,8478398,Kyle Connor,L,WPG,27,65,37,19,56
7,8475726,Tyler Toffoli,R,NJD,31,80,33,23,56
7,8482740,Wyatt Johnston,C,DAL,20,82,28,28,56
7,8477496,Elias Lindholm,C,VAN,29,81,21,35,56
7,8478407,Vince Dunn,D,SEA,27,78,14,42,56
7,8480015,Owen Tippett,R,PHI,24,77,31,24,55
7,8479420,Tage Thompson,C,BUF,26,72,26,29,55
7,8477497,Sean Monahan,C,WPG,29,83,20,35,55
7,8481581,Thomas Harley,D,DAL,22,79,19,36,55
7,8478542,Evan Rodrigues,C,FLA,30,82,17,38,55
7,8471724,Kris Letang,D,PIT,36,82,9,46,55
7,8481068,Yegor Sharangovich,C,CGY,25,82,26,28,54
7,8480002,Nico Hischier,C,NJD,24,70,25,29,54
7,8474037,James van Riemsdyk,L,BOS,34,78,16,38,54
7,8479675,Trevor Moore,L,LAK,28,82,33,20,53
7,8476448,William Karlsson,C,VGK,30,69,24,29,53
7,8475169,Evander Kane,L,EDM,32,81,24,29,53
7,8477964,Ivan Barbashev,C,VGK,28,81,24,29,53
7,8475170,Brayden Schenn,C,STL,32,82,23,29,52
7,8476882,Teuvo Teravainen,L,CAR,29,81,21,31,52
7,8474641,Adam Henrique,C,ANA,33,81,18,34,52
7,8480036,Miro Heiskanen,D,DAL,24,72,11,41,52
7,8476346,Johnny Gaudreau,L,CBJ,30,81,9,43,52
7,8478460,Zach Werenski,D,CBJ,26,69,6,46,52
7,8476479,Phillip Danault,C,LAK,30,82,18,33,51
7,8477494,Jonathan Drouin,L,COL,28,80,16,35,51
7,8475798,Mikael Granlund,C,SJS,31,68,11,40,51
7,8479325,Charlie McAvoy,D,BOS,26,74,10,41,51
7,8478440,Dylan Strome,C,WSH,26,82,27,23,50
7,8478047,Michael Bunting,L,CAR,28,80,22,28,50
7,8480009,Eeli Tolvanen,R,SEA,24,82,22,28,50
7,8477346,MacKenzie Weegar,D,CGY,29,82,19,31,50
7,8480798,Philipp Kurashev,C,CHI,24,75,14,36,50
7,8476881,Tomas Hertl,C,SJS,30,76,23,26,49
7,8478401,Pavel Zacha,C,BOS,26,78,20,29,49
7,8477951,Nick Schmaltz,C,ARI,27,79,19,30,49
7,8477456,J.T. Compher,L,DET,28,77,18,31,49
7,8470613,Brent Burns,D,CAR,38,81,15,34,49
7,8481711,Matias Maccelli,L,ARI,23,82,14,35,49
7,8482684,Luke Hughes,D,NJD,20,81,14,35,49
7,8476905,Chandler Stephenson,C,VGK,29,77,12,37,49
7,8481528,Dylan Cozens,C,BUF,22,79,18,30,48
7,8478396,Noah Hanifin,D,CGY,26,82,15,33,48
7,8477935,Sam Bennett,C,FLA,27,70,22,25,47
7,8482149,Cole Perfetti,C,WPG,21,81,20,27,47
7,8475810,Bryan Rust,R,PIT,31,69,17,30,47
7,8474586,Jordan Eberle,R,SEA,33,78,15,32,47
7,8482110,Dawson Mercer,C,NJD,22,81,29,17,46
7,8478233,Andrew Mangiapane,L,CGY,27,81,17,29,46
7,8473994,Jamie Benn,L,DAL,34,82,16,30,46
7,8476456,Jonathan Huberdeau,C,CGY,30,81,11,35,46
7,8476458,Ryan Strome,C,ANA,30,79,11,35,46
7,8477447,Shea Theodore,D,VGK,28,48,6,40,46
7,8482175,JJ Peterka,R,BUF,21,82,24,21,45
7,8475151,Kyle Palmieri,C,NYI,32,82,21,24,45
7,8482109,Alexis Lafrenière,L,NYR,22,82,20,25,45
7,8480064,Josh Norris,C,OTT,24,75,20,25,45
7,8479345,Jakob Chychrun,D,OTT,25,82,12,33,45
7,8476906,Shayne Gostisbehere,D,DET,30,81,10,35,45
7,8477948,Travis Sanheim,D,PHI,27,80,10,35,45
7,8476792,Torey Krug,D,STL,32,82,5,40,45
7,8474590,John Carlson,D,WSH,33,82,3,42,45
7,8478462,Nicolas Roy,C,VGK,26,72,18,26,44
7,8474563,Drew Doughty,D,LAK,34,82,17,27,44
7,8478474,Lawson Crouse,L,ARI,26,81,24,19,43
7,8475191,Reilly Smith,R,PIT,32,76,22,21,43
7,8482745,Mason McTavish,C,ANA,20,74,21,22,43
7,8478519,Anthony Cirelli,C,TBL,26,81,20,23,43
7,8478438,Tommy Novak,C,NSH,26,71,19,24,43
7,8476419,Jean-Gabriel Pageau,C,NYI,31,82,15,28,43
7,8480434,Sean Durzi,D,ARI,25,76,11,32,43
7,8478397,Rasmus Andersson,D,CGY,27,78,10,33,43
7,8477503,Max Domi,C,TOR,28,82,7,36,43
7,8478472,Mathieu Joseph,R,OTT,26,72,13,29,42
7,8479365,Trent Frederic,C,BOS,25,82,21,20,41
7,8475287,Erik Haula,L,NJD,32,75,17,24,41
7,8474141,Patrick Kane,R,DET,35,51,16,25,41
7,8477479,Tyler Bertuzzi,L,TOR,28,81,15,26,41
7,8482667,William Eklund,L,SJS,21,80,14,27,41
7,8471218,Blake Wheeler,R,NYR,37,82,14,27,41
7,8478055,Gustav Forsling,D,FLA,27,81,13,28,41
7,8477021,Alex Kerfoot,C,ARI,29,82,9,32,41
7,8482089,Jake Neighbours,L,STL,21,82,28,12,40
7,8476432,Boone Jenner,C,CBJ,30,66,26,14,40
7,8477450,Jason Dickinson,C,CHI,28,82,24,16,40
7,8477451,Ryan Hartman,R,MIN,29,77,23,17,40
7,8475799,Nino Niederreiter,R,WPG,31,81,21,19,40
7,8473422,Nick Foligno,L,CHI,36,75,20,20,40
7,8477426,Nicholas Paul,L,TBL,28,82,17,23,40
7,8479400,Pierre-Luc Dubois,C,LAK,25,82,16,24,40
7,8476392,Adam Lowry,C,WPG,30,81,14,26,40
7,8478038,Devon Toews,D,COL,29,82,11,29,40
7,8480893,Kirill Marchenko,R,CBJ,23,79,24,15,39
7,8482475,Yegor Chinakhov,R,CBJ,22,69,22,17,39
7,8476925,Colton Sissons,C,NSH,30,82,20,19,39
7,8475768,Jaden Schwartz,C,SEA,31,66,18,21,39
7,8477998,Warren Foegele,L,EDM,27,82,16,23,39
7,8481577,Philip Tomasino,C,NSH,22,68,15,24,39
7,8480028,Morgan Frost,C,PHI,24,70,13,26,39
7,8482665,Matty Beniers,C,SEA,21,77,12,27,39
7,8481542,Moritz Seider,D,DET,22,82,7,32,39
7,8482122,Brock Faber,D,MIN,21,82,6,33,39
7,8478414,Timo Meier,R,NJD,27,68,19,19,38
7,8479992,Michael Rasmussen,C,DET,24,82,18,20,38
7,8480014,Gabriel Vilardi,C,WPG,24,61,18,20,38
7,8483515,Juraj Slafkovsky,L,MTL,19,82,16,22,38
7,8476869,Brady Skjei,D,CAR,29,81,10,28,38
7,8475764,Cam Fowler,D,ANA,32,82,7,31,38
7,8474565,Alex Pietrangelo,D,VGK,33,76,4,34,38
7,8478498,Jake DeBrusk,L,BOS,27,80,18,19,37
7,8475760,Nick Bjugstad,C,ARI,31,82,16,21,37
7,8482079,Marco Rossi,C,MIN,22,82,15,22,37
7,8474102,David Perron,L,DET,35,76,14,23,37
7,8477429,Andrew Copp,C,DET,29,81,14,23,37
7,8478891,Mason Appleton,C,WPG,27,81,14,23,37
7,8476480,Vladislav Namestnikov,C,WPG,31,78,10,27,37
7,8478500,Ivan Provorov,D,CBJ,26,81,7,30,37
7,8477952,Robby Fabbri,C,DET,27,68,19,17,36
7,8476880,Tom Wilson,R,WSH,29,81,19,17,36
7,8483808,Andrei Kuzmenko,L,CGY,27,76,17,19,36
7,8478856,Conor Garland,R,VAN,27,81,15,21,36
7,8480813,Joe Veleno,C,DET,23,80,14,22,36
7,8475149,Marcus Johansson,L,MIN,33,82,13,23,36
7,8475171,Oliver Ekman-Larsson,D,FLA,32,82,13,23,36
7,8476927,Teddy Blueger,C,VAN,29,67,10,26,36
7,8476979,Erik Gustafsson,D,NYR,31,81,6,30,36
7,8479619,Michael Carcone,L,ARI,27,76,23,12,35
7,8477511,Anthony Mantha,R,WSH,29,78,22,13,35
7,8480459,Pius Suter,C,VAN,27,67,19,16,35
7,8477476,Artturi Lehkonen,L,COL,28,47,17,18,35
7,8474150,Mikael Backlund,C,CGY,34,82,15,20,35
7,8475763,Kevin Hayes,R,STL,31,82,14,21,35
7,8479525,Ross Colton,C,COL,27,80,12,23,35
7,8476872,Scott Laughton,C,PHI,29,81,12,23,35
7,8479987,Morgan Geekie,C,BOS,25,76,11,24,35
7,8475314,Anders Lee,L,NYI,33,82,19,15,34
7,8474149,Evgenii Dadonov,R,DAL,34,77,17,17,34
7,8481624,Ilya Mikheyev,R,VAN,29,77,16,18,34
7,8482159,Tyson Foerster,R,PHI,21,78,14,20,34
7,8478466,Daniel Sprong,R,DET,26,54,14,20,34
7,8482720,Matthew Knies,L,TOR,21,80,14,20,34
7,8477407,Anthony Duclair,L,SJS,28,76,13,21,34
7,8482146,Luke Evangelista,R,NSH,21,80,12,22,34
7,8477505,Alex Wennberg,C,SEA,29,82,12,22,34
7,8475753,Justin Faulk,D,STL,31,68,6,28,34
7,8478057,Dakota Joshua,C,VAN,27,79,16,17,33
7,8481524,Bowen  Byram,D,COL,22,74,13,20,33
7,8479410,Mikhail Sergachev,D,TBL,25,60,6,27,33
7,8476958,Jaccob Slavin,D,CAR,29,81,6,27,33
7,8478469,Thomas Chabot,D,OTT,26,60,5,28,33
7,8476885,Jacob Trouba,D,NYR,29,80,4,29,33
7,8477969,Marcus Pettersson,D,PIT,27,82,3,30,33
7,8481186,Logan O'Connor,R,COL,27,78,17,15,32
7,8471698,T.J. Oshie,R,WSH,37,65,17,15,32
7,8481618,Alex Newhook,C,MTL,22,55,17,15,32
7,8475220,Marcus Foligno,L,MIN,32,75,16,16,32
7,8480829,Jesperi Kotkaniemi,C,CAR,23,81,14,18,32
7,8478020,Michael Amadio,R,VGK,27,74,13,19,32
7,8479351,Sam Steel,C,DAL,25,77,13,19,32
7,8476897,Oskar Sundqvist,C,STL,29,82,12,20,32
7,8482062,Cole Smith,L,NSH,28,81,12,20,32
7,8475193,Tomas Tatar,L,SEA,33,78,11,21,32
7,8482105,Jake Sanderson,D,OTT,21,79,9,23,32
7,8473986,Alex Killorn,L,ANA,34,63,9,23,32
7,8476483,Rickard Rakell,R,PIT,30,70,8,24,32
7,8482655,J.J. Moser,D,ARI,23,80,4,28,32
7,8479941,Justin Danforth,R,CBJ,30,81,15,16,31
7,8476921,Jordan Martinook,L,CAR,31,81,13,18,31
7,8476292,Ondrej Palat,L,NJD,32,71,12,19,31
7,8475722,Jason Zucker,L,ARI,31,72,12,19,31
7,8473533,Jordan Staal,C,CAR,35,81,12,19,31
7,8477425,Miles Wood,L,COL,28,77,12,19,31
7,8479398,Samuel Girard,D,COL,25,61,5,26,31
7,8480188,Fabian Zetterlund,L,SJS,24,81,20,10,30
7,8474870,Tyler Johnson,C,CHI,33,67,17,13,30
7,8482125,Alexander Holtz,R,NJD,21,81,14,16,30
7,8478413,Jordan Greenway,L,BUF,26,70,14,16,30
7,8476892,Colton Parayko,D,STL,30,82,12,18,30
7,8480802,Ryan McLeod,C,EDM,24,81,11,19,30
7,8478042,Viktor Arvidsson,R,LAK,30,32,11,19,30
7,8476826,Yanni Gourde,C,SEA,32,80,10,20,30
7,8478458,Jack Roslovic,C,CBJ,26,58,9,21,30
7,8475200,Dmitry Orlov,D,CAR,32,81,6,24,30
7,8477495,Seth Jones,D,CHI,29,67,5,25,30
7,8475181,Nick Leddy,D,STL,32,82,4,26,30
7,8476854,Hampus Lindholm,D,BOS,29,82,4,26,30
7,8475793,Ryan Johansen,C,COL,31,82,21,8,29
7,8473449,Kyle Okposo,R,BUF,35,79,18,11,29
7,8474053,Logan Couture,C,SJS,34,34,13,16,29
7,8480855,Jack McBain,C,ARI,23,67,12,17,29
7,8474884,Mike Hoffman,C,SJS,34,79,12,17,29
7,8476462,Dougie Hamilton,D,NJD,30,48,8,21,29
7,8475218,Mattias Ekholm,D,EDM,33,81,6,23,29
7,8478133,Jake Evans,C,MTL,27,82,6,23,29
7,8475188,Brayden McNabb,D,VGK,32,81,2,27,29
7,8476918,Jimmy Vesey,L,NYR,30,80,18,10,28
7,8476438,Brandon Saad,L,STL,31,82,18,10,28
7,8478043,Sam Lafferty,C,VAN,28,79,17,11,28
7,8478046,Danton Heinen,L,BOS,28,74,16,12,28
7,8482092,Ridly Greig,C,OTT,21,72,14,14,28
7,8475714,Calle Jarnkrok,C,TOR,32,75,13,15,28
7,8477947,Sonny Milano,L,WSH,27,53,13,15,28
7,8477498,Darnell Nurse,D,EDM,28,82,11,17,28
7,8476474,Stefan Noesen,R,CAR,30,52,11,17,28
7,8482097,Jack Quinn,R,BUF,22,45,10,18,28
7,8476931,Jake McCabe,D,TOR,30,76,9,19,28
7,8477932,Aaron Ekblad,D,FLA,27,64,7,21,28
7,8480145,Neal Pionk,D,WPG,28,81,7,21,28
7,8478178,Darren Raddysh,D,TBL,27,82,5,23,28
7,8480246,Nick Perbix,D,TBL,25,80,3,25,28
7,8477330,Dominik Kubalik,L,OTT,28,78,18,9,27
7,8477944,Jakub Vrana,L,STL,27,49,17,10,27
7,8478013,Jake Walman,D,DET,27,76,16,11,27
7,8481582,Nicholas Robertson,L,TOR,22,64,13,14,27
7,8475455,Brenden Dillon,D,WPG,33,78,10,17,27
7,8477986,Brandon Montour,D,FLA,29,66,5,22,27
7,8478911,Matt Roy,D,LAK,28,81,4,23,27
7,8482073,Braden Schneider,D,NYR,22,82,4,23,27
7,8482671,Owen Power,D,BUF,21,79,2,25,27
7,8476331,Dylan DeMelo,D,WPG,30,81,2,25,27
7,8481601,Simon Holmstrom,R,NYI,22,81,17,9,26
7,8474189,Lars Eller,C,PIT,34,82,12,14,26
7,8477508,Curtis Lazar,C,NJD,28,76,12,14,26
7,8478109,Victor Olofsson,L,BUF,28,63,11,15,26
7,8480113,Alex Iafallo,L,WPG,30,81,10,16,26
7,8474157,Max Pacioretty,L,WSH,35,47,10,16,26
7,8481032,Paul Cotter,C,VGK,24,80,10,16,26
7,8480068,Ryan Poehling,C,PHI,24,76,10,16,26
7,8482705,Cole Sillinger,C,CBJ,20,76,9,17,26
7,8475744,Evgeny Kuznetsov,C,WSH,31,72,8,18,26
7,8478463,Anthony Beauvillier,L,CHI,26,64,8,18,26
7,8476902,Esa Lindell,D,DAL,29,82,4,22,26
7,8475343,Nic Dowd,C,WSH,33,73,12,13,25
7,8479339,Patrik Laine,L,CBJ,25,47,10,15,25
7,8480817,K'Andre Miller,D,NYR,23,80,9,16,25
7,8478136,Jake Middleton,D,MIN,27,82,9,16,25
7,8482113,Anton Lundell,C,FLA,22,78,8,17,25
7,8476312,Josh Manson,D,COL,32,77,8,17,25
7,8477950,Tony DeAngelo,D,CAR,28,51,7,18,25
7,8481546,Cam York,D,PHI,22,81,6,19,25
7,8480336,Sean Walker,D,PHI,29,81,6,19,25
7,8482245,Artem Zub,D,OTT,28,72,5,20,25
7,8474602,Justin Schultz,D,SEA,33,72,4,21,25
7,8476463,Jonas Brodin,D,MIN,30,64,3,22,25
7,8479998,Mikey Anderson,D,LAK,24,82,3,22,25
7,8481535,Nils Hoglander,L,VAN,23,53,17,7,24
7,8481604,Pavel Dorofeyev,L,VGK,23,57,14,10,24
7,8476374,Sean Kuraly,C,CBJ,30,73,12,12,24
7,8482111,Justin Barron,D,MTL,22,68,12,12,24
7,8481560,Arthur Kaliyev,R,LAK,22,68,11,13,24
7,8470621,Corey Perry,R,EDM,38,54,11,13,24
7,8479591,Michael Eyssimont,C,TBL,27,81,11,13,24
7,8481596,Shane Pinto,C,OTT,23,41,9,15,24
7,8480835,Jack Drury,C,CAR,23,53,8,16,24
7,8477953,Kasperi Kapanen,R,STL,27,75,6,18,24
7,8475790,Erik Gudbranson,D,CBJ,31,77,6,18,24
7,8478443,Brandon Carlo,D,BOS,27,77,6,18,24
7,8476422,Mike Reilly,D,NYI,30,61,5,19,24
7,8474574,Tyler Myers,D,VAN,33,81,4,20,24
7,8478840,Will Borgen,D,SEA,27,82,3,21,24
7,8473507,Jeff Petry,D,DET,36,73,3,21,24
7,8481554,Kaapo Kakko,R,NYR,22,61,17,6,23
7,8479977,Kailer Yamamoto,R,SEA,25,73,14,9,23
7,8481580,Connor McMichael,C,WSH,22,80,12,11,23
7,8481533,Trevor Zegras,C,ANA,22,48,12,11,23
7,8475855,Jesper Fast,R,CAR,32,78,12,11,23
7,8470638,Patrice Bergeron,C,BOS,38,27,11,12,23
7,8478115,Pierre Engvall,L,NYI,27,76,9,14,23
7,8479293,Brandon Tanev,L,SEA,32,66,9,14,23
7,8475164,Jakob Silfverberg,R,ANA,33,81,8,15,23
7,8476457,Adam Larsson,D,SEA,31,82,7,16,23
7,8480078,Filip Chytil,C,NYR,24,38,6,17,23
7,8478851,Alexandre Carrier,D,NSH,27,77,5,18,23
7,8480878,Nils Lundkvist,D,DAL,23,70,5,18,23
7,8478507,John Marino,D,NJD,26,81,4,19,23
7,8475197,Tyson Barrie,D,NSH,32,62,4,19,23
7,8474151,Ryan McDonagh,D,NSH,34,75,3,20,23
7,8477507,Nikita Zadorov,D,VAN,28,75,3,20,23
7,8480873,Rasmus Sandin,D,WSH,23,74,2,21,23
7,8480185,Eetu Luostarinen,C,FLA,25,82,13,9,22
7,8480281,Alexey Toropchenko,R,STL,24,82,13,9,22
7,8482157,Will Cuylle,L,NYR,21,82,12,10,22
7,8476981,Josh Anderson,R,MTL,29,78,9,13,22
7,8482055,Drew O'Connor,L,PIT,25,82,7,15,22
7,8478882,Vladislav Gavrikov,D,LAK,28,77,7,15,22
7,8475233,David Savard,D,MTL,33,60,7,15,22
7,8480762,Eric Robinson,L,BUF,28,54,6,16,22
7,8471699,Andrew Cogliano,C,COL,36,76,6,16,22
7,8482087,Kaiden Guhle,D,MTL,21,78,5,17,22
7,8477444,Andre Burakovsky,L,SEA,28,51,11,10,21
7,8474040,Sam Gagner,C,EDM,34,55,11,10,21
7,8479415,Michael McLeod,C,NJD,25,73,10,11,21
7,8479353,Brett Howden,C,VGK,25,79,8,13,21
7,8480220,Noah Cates,L,PHI,24,59,6,15,21
7,8481014,Alexander Romanov,D,NYI,23,81,6,15,21
7,8480994,Damien Giroux,C,MIN,23,28,4,17,21
7,8481656,Aliaksei Protas,C,WSH,22,52,4,17,21
7,8475690,Chris Tanev,D,CGY,34,79,2,19,21
7,8478508,Yakov Trenin,C,NSH,26,79,15,5,20
7,8473453,Trevor Lewis,C,LAK,36,82,11,9,20
7,8479390,Taylor Raddysh,R,CHI,25,77,9,11,20
7,8477435,Ryan Graves,D,PIT,28,82,7,13,20
7,8476960,Andreas Athanasiou,C,CHI,29,38,7,13,20
7,8479976,Juuso Valimaki,D,ARI,25,68,5,15,20
7,8480796,Martin Fehervary,D,WSH,24,76,3,17,20
7,8476879,Cody Ceci,D,EDM,30,82,2,18,20
7,8475179,Dmitry Kulikov,D,FLA,33,78,0,20,20
7,8476469,Joel Armia,R,MTL,30,66,14,5,19
7,8481704,Juuso Parssinen,C,NSH,22,71,10,9,19
7,8480849,Barrett Hayton,C,ARI,23,50,10,9,19
7,8479661,Tanner Jeannot,L,TBL,26,68,9,10,19
7,8480144,David Kampf,C,TOR,28,78,9,10,19
7,8482222,Alexander Barabanov,L,SJS,29,61,8,11,19
7,8476923,Damon Severson,D,CBJ,29,66,7,12,19
7,8476525,Colin Miller,D,NJD,31,61,7,12,19
7,8476889,Radek Faksa,C,DAL,29,74,5,14,19
7,8475279,Ben Chiarot,D,DET,32,77,4,15,19
7,8479980,Nicolas Hague,D,VGK,25,73,4,15,19
7,8476624,Barclay Goodrow,C,NYR,30,80,3,16,19
7,8480043,Timothy Liljegren,D,TOR,24,65,2,17,19
7,8479983,Mario Ferraro,D,SJS,25,77,1,18,19
7,8480049,Dylan Samberg,D,WPG,24,81,1,18,19
7,8482699,Dylan Guenther,R,ARI,20,45,10,8,18
7,8479346,Dillon Dube,C,CGY,25,70,9,9,18
7,8476410,Josh Leivo,L,STL,30,28,9,9,18
7,8474166,Alec Martinez,D,VGK,36,64,8,10,18
7,8482117,Lukas Reichel,L,CHI,21,77,8,10,18
7,8479359,Beck Malenstyn,L,WSH,25,81,7,11,18
7,8477989,Christian Dvorak,C,MTL,27,52,6,12,18
7,8480172,Jan Rutta,D,SJS,33,75,5,13,18
7,8475324,Nick Jensen,D,WSH,33,82,0,18,18
7,8479316,Luke Kunin,C,SJS,26,76,11,6,17
7,8478831,Kevin Stenlund,C,FLA,27,82,11,6,17
7,8481481,Blake Lizotte,C,LAK,26,64,9,8,17
7,8477941,Nick Ritchie,L,CGY,28,27,8,9,17
7,8475208,Brian Dumoulin,D,SEA,32,80,7,10,17
7,8477506,Ryan Pulock,D,NYI,29,58,7,10,17
7,8480821,Filip Zadina,R,SJS,24,48,7,10,17
7,8480806,Isac Lundestrom,C,ANA,24,46,7,10,17
7,8475462,Radko Gudas,D,ANA,33,76,6,11,17
7,8480035,Henri Jokiharju,D,BUF,24,74,4,13,17
7,8474567,Zach Bogosian,D,MIN,33,70,2,15,17
7,8470600,Ryan Suter,D,DAL,38,82,1,16,17
7,8477365,Connor Clifton,D,BUF,28,79,0,17,17
7,8481690,Tyler Angle,C,CBJ,23,29,14,2,16
7,8475848,Brendan Gallagher,R,MTL,31,50,8,8,16
7,8475231,Casey Cizikas,C,NYI,32,71,8,8,16
7,8479393,Noah Gregor,C,TOR,25,81,7,9,16
7,8476329,Travis Boyd,C,ARI,30,45,7,9,16
7,8482660,Kent Johnson,C,CBJ,21,36,6,10,16
7,8481522,Peyton Krebs,C,BUF,22,80,5,11,16
7,8474573,Josh Bailey,R,NYI,34,29,5,11,16
7,8474034,Pat Maroon,L,MIN,35,49,4,12,16
7,8478859,Niko Mikkola,D,FLA,27,82,3,13,16
7,8475825,Jani Hakanpää,D,DAL,31,82,3,13,16
7,8475906,John Klingberg,D,TOR,31,43,2,14,16
7,8474161,Jakub Voracek,R,CBJ,34,29,2,14,16
7,8481606,Jordan Spence,D,LAK,22,44,0,16,16
7,8477488,Brett Pesce,D,CAR,29,71,7,8,15
7,8477987,Ryan Donato,C,CHI,27,51,6,9,15
7,8471677,Jack Johnson,D,COL,36,80,6,9,15
7,8477353,Tyler Motte,C,TBL,28,72,6,9,15
7,8477919,Frederick Gaudreau,C,MIN,30,70,5,10,15
7,8481178,Egor Zamula,D,PHI,23,44,5,10,15
7,8474716,Jared Spurgeon,D,MIN,34,44,5,10,15
7,8474162,Jake Muzzin,D,TOR,34,29,5,10,15
7,8473563,Nicklas Backstrom,C,WSH,36,37,4,11,15
7,8481523,Kirby Dach,C,MTL,22,29,3,12,15
7,8477499,Rasmus Ristolainen,D,PHI,29,57,3,12,15
7,8478416,Erik Cernak,D,TBL,26,71,3,12,15
7,8482192,Isaak Phillips,D,CHI,22,56,3,12,15
7,8476917,Adam Pelech,D,NYI,29,58,2,13,15
7,8477335,Kyle Burroughs,D,SJS,28,74,2,13,15
7,8480860,Kevin Bahl,D,NJD,23,81,0,15,15
7,8470604,Jeff Carter,C,PIT,38,76,10,4,14
7,8475791,Taylor Hall,L,CHI,32,37,5,9,14
7,8481093,Rafael Harvey-Pinard,L,MTL,24,51,5,9,14
7,8474031,Kevin Shattenkirk,D,BOS,34,44,5,9,14
7,8478970,Jalen Chatfield,D,CAR,27,48,5,9,14
7,8477979,Nicolas Aube-Kubel,R,WSH,27,39,5,9,14
7,8473504,Cal Clutterbuck,R,NYI,36,53,4,10,14
7,8477380,Jonny Brodzinski,C,NYR,30,35,4,10,14
7,8477839,Conor Sheary,L,TBL,31,64,3,11,14
7,8477220,Nate Schmidt,D,WPG,32,75,3,11,14
7,8480887,Jordan Harris,D,MTL,23,58,3,11,14
7,8476856,Matt Dumba,D,ARI,29,78,3,11,14
7,8481568,Alex Vlasic,D,CHI,22,76,2,12,14
7,8480807,Mattias Samuelsson,D,BUF,23,69,2,12,14
7,8476467,Jamie Oleksiak,D,SEA,31,82,2,12,14
7,8474673,TJ Brodie,D,TOR,33,81,1,13,14
7,8476941,Connor Carrick,D,BOS,29,27,1,13,14
7,8471274,Alex Goligoski,D,MIN,38,58,1,13,14
7,8480289,Morgan Barron,C,WPG,25,51,9,4,13
7,8482679,Matt Coronato,R,CGY,21,42,9,4,13
7,8480192,Johnathan Kovacevic,D,MTL,26,74,8,5,13
7,8477903,Garnet Hathaway,R,PHI,32,81,7,6,13
7,8477446,Michael McCarron,R,NSH,28,43,7,6,13
7,8482259,Bobby McMann,C,TOR,27,29,7,6,13
7,8473548,Phil Kessel,R,VGK,36,28,7,6,13
7,8477454,Adam Erne,L,EDM,28,54,7,6,13
7,8478468,Jeremy Lauzon,D,NSH,26,82,6,7,13
7,8480448,Parker Kelly,L,OTT,24,51,6,7,13
7,8476967,Brett Kulak,D,EDM,29,82,4,9,13
7,8480727,Zach Whitecloud,D,VGK,27,65,3,10,13
7,8479324,Ryan Lindgren,D,NYR,25,80,2,11,13
7,8480001,Urho Vaakanainen,D,ANA,24,74,2,11,13
7,8474009,Nick Bonino,C,NYR,35,73,2,11,13
7,8482101,Danil Gushchin,L,SJS,21,30,9,3,12
7,8476822,Luke Glendening,C,TBL,34,82,9,3,12
7,8479336,Carl Grundstrom,R,LAK,26,50,8,4,12
7,8481517,Brett Leason,R,ANA,24,43,6,6,12
7,8476393,Nick Cousins,C,FLA,30,70,5,7,12
7,8480748,Kiefer Sherwood,L,NSH,28,41,5,7,12
7,8480891,Michael Kesselring,D,ARI,23,36,4,8,12
7,8482142,Jamie Drysdale,D,PHI,21,49,3,9,12
7,8474612,Travis Hamonic,D,OTT,33,75,3,9,12
7,8480848,Ty Dellandrea,C,DAL,23,53,3,9,12
7,8471276,David Krejci,C,BOS,37,27,3,9,12
7,8480073,Erik Brannstrom,D,OTT,24,45,3,9,12
7,8476858,Phillip Di Giuseppe,L,VAN,30,62,3,9,12
7,8478399,Jonas Siegenthaler,D,NJD,26,66,2,10,12
7,8476874,Olli Maatta,D,DET,29,46,2,10,12
7,8478432,Christian Fischer,R,DET,26,51,2,10,12
7,8477845,Trevor van Riemsdyk,D,WSH,32,70,1,11,12
7,8480884,Calen Addison,D,SJS,23,45,1,11,12
7,8477015,Connor Brown,R,EDM,29,75,1,11,12
7,8475225,Craig Smith,C,DAL,34,50,7,4,11
7,8475177,Calvin de Haan,D,TBL,32,72,6,5,11
7,8479996,Cody Glass,C,NSH,24,54,5,6,11
7,8481013,Jonatan Berggren,R,DET,23,37,5,6,11
7,8480205,Emil Bemstrom,R,CBJ,24,31,5,6,11
7,8478585,Derek Ryan,C,EDM,37,51,5,6,11
7,8478495,Denis Gurianov,R,NSH,26,40,5,6,11
7,8480879,Jacob Bernard-Docker,D,OTT,23,42,4,7,11
7,8477406,Mattias Janmark,C,EDM,31,71,3,8,11
7,8476473,Connor Murphy,D,CHI,30,70,3,8,11
7,8476441,Joel Edmundson,D,WSH,30,66,3,8,11
7,8482730,Brandt Clarke,D,LAK,20,38,2,9,11
7,8474013,Ian Cole,D,VAN,34,80,1,10,11
7,8481605,Jackson LaCombe,D,ANA,22,76,1,10,11
7,8475842,Sam Carrick,C,ANA,31,54,7,3,10
7,8480980,Connor Dewar,C,MIN,24,48,7,3,10
7,8471669,Paul Stastny,C,CAR,38,28,6,4,10
7,8478421,A.J. Greer,L,CGY,27,47,6,4,10
7,8470610,Zach Parise,L,COL,39,33,4,6,10
7,8476871,Tanner Pearson,L,MTL,31,36,4,6,10
7,8478434,Keegan Kolesar,R,VGK,26,50,4,6,10
7,8478870,Rudolfs Balcers,L,TBL,26,26,4,6,10
7,8479414,Nathan Bastian,R,NJD,26,51,3,7,10
7,8479543,Michael Pezzetta,L,MTL,25,44,3,7,10
7,8473604,Jonathan Toews,C,CHI,35,27,2,8,10
7,8475461,Andrew Agozzino,L,SJS,32,28,2,8,10
7,8479371,Dante Fabbro,D,NSH,25,42,2,8,10
7,8482711,Stanislav Svozil,D,CBJ,20,29,2,8,10
7,8479442,Troy Stecher,D,ARI,29,71,1,9,10
7,8478569,Noel Acciari,C,PIT,32,70,6,3,9
7,8479718,Alex Barré-Boulet,C,TBL,26,35,6,3,9
7,8480031,Max Comtois,L,ANA,24,28,5,4,9
7,8479322,Wade Allison,R,PHI,26,26,5,4,9
7,8479383,Boris Katchouk,L,CHI,25,35,5,4,9
7,8479328,Julien Gauthier,R,NYI,26,27,5,4,9
7,8473544,Derick Brassard,C,OTT,36,31,5,4,9
7,8479402,Jake Bean,D,CBJ,25,49,4,5,9
7,8477846,Ryan Carpenter,C,SJS,32,36,3,6,9
7,8480008,Adam Ruzicka,C,ARI,24,41,3,6,9
7,8478028,Fredrik Olofsson,L,COL,27,53,3,6,9
7,8479315,Joey Anderson,R,CHI,25,28,2,7,9
7,8480328,David Gust,R,CHI,29,27,2,7,9
7,8481527,Kaedan Korczak,D,VGK,22,26,1,8,9
7,8477018,Ben Hutton,D,VGK,30,31,1,8,9
7,8483460,David Jiricek,D,CBJ,20,36,1,8,9
7,8475718,Justin Holl,D,DET,31,63,1,8,9
7,8476372,Nick Seeler,D,PHI,30,55,0,9,9
7,8480883,Ty Smith,D,PIT,23,31,6,2,8
7,8480252,Cole Guttman,C,CHI,24,27,4,4,8
7,8479368,Max Jones,L,ANA,25,38,4,4,8
7,8481477,Nico Sturm,C,SJS,28,34,3,5,8
7,8477392,Hudson Fasching,R,NYI,28,35,3,5,8
7,8477070,Liam O'Brien,C,ARI,29,49,3,5,8
7,8470595,Eric Staal,C,FLA,39,27,3,5,8
7,8480995,Pontus Holmberg,R,TOR,24,27,2,6,8
7,8479576,Vincent Desharnais,D,EDM,27,49,1,7,8
7,8477971,Andreas Englund,D,LAK,27,52,1,7,8
7,8480901,Karson Kuhlman,C,WPG,28,30,1,7,8
7,8476988,Matt Benning,D,SJS,29,42,0,8,8
7,8479439,Jacob MacDonald,D,SJS,30,21,6,1,7
7,8471709,Marc-Edouard Vlasic,D,SJS,36,31,5,2,7
7,8477478,William Carrier,L,VGK,29,33,5,2,7
7,8477573,Nathan Walker,L,STL,29,18,5,2,7
7,8479344,Jesse Puljujarvi,R,PIT,25,36,4,3,7
7,8482241,Radim Zohorna,L,PIT,27,31,4,3,7
7,8479291,Kevin Rooney,C,CGY,30,33,4,3,7
7,8480072,Lias Andersson,C,LAK,25,30,4,3,7
7,8476442,Matt Nieto,L,PIT,31,53,3,4,7
7,8481058,Jesse Ylönen,R,MTL,24,43,3,4,7
7,8476891,Matt Grzelcyk,D,BOS,29,41,2,5,7
7,8479458,Nikita Zaitsev,D,CHI,32,26,2,5,7
7,8477541,Dakota Mermis,D,MIN,29,37,2,5,7
7,8478099,Kevin Labanc,R,SJS,28,32,2,5,7
7,8481641,Joel Kiviranta,L,COL,27,40,2,5,7
7,8480880,Jakub Lauko,C,BOS,23,40,2,5,7
7,8480913,Jordan Gross,D,NSH,28,27,1,6,7
7,8479514,Rem Pitlick,C,CHI,26,36,1,6,7
7,8470966,Mark Giordano,D,TOR,40,36,1,6,7
7,8481537,Nikita Okhotiuk,D,SJS,23,38,1,6,7
7,8478502,Dennis Gilbert,D,CGY,27,31,1,6,7
7,8478104,Sammy Blais,L,STL,27,43,1,6,7
7,8479348,Kale Clague,D,BUF,25,28,1,6,7
7,8480871,Adam Boqvist,D,CBJ,23,22,0,7,7
7,8479520,Brandon Duhaime,R,MIN,26,54,4,2,6
7,8479066,Ryan Lomberg,L,FLA,29,55,4,2,6
7,8481592,Jakob Pelletier,L,CGY,22,31,3,3,6
7,8474683,Derek Grant,C,ANA,33,28,3,3,6
7,8478131,Ondrej Kase,R,CAR,28,28,3,3,6
7,8476278,Colin Blackwell,C,CHI,30,25,3,3,6
7,8479968,Vinni Lettieri,C,MIN,28,24,3,3,6
7,8482451,Mikael Pyyhtia,L,CBJ,22,29,2,4,6
7,8477369,Carson Soucy,D,VAN,29,21,2,4,6
7,8482496,Nils Aman,C,VAN,23,31,2,4,6
7,8480789,Oliver Wahlstrom,R,NYI,23,27,2,4,6
7,8480058,Pierre-Olivier Joseph,D,PIT,24,53,1,5,6
7,8480222,Sebastian Aho,D,NYI,27,41,1,5,6
7,8474568,Luke Schenn,D,NSH,34,36,1,5,6
7,8479982,Conor Timmins,D,TOR,25,16,1,5,6
7,8476429,Scott Mayfield,D,NYI,31,67,0,6,6
7,8479369,Andrew Peeke,D,CBJ,25,20,0,6,6
7,8475797,Jarred Tinordi,D,CHI,31,32,0,6,6
7,8479372,Josh Mahura,D,FLA,25,20,0,6,6
7,8480950,Ilya Lyubushkin,D,ANA,29,79,0,6,6
7,8475762,Derek Forbort,D,BOS,31,57,0,6,6
7,8477930,Pierre-Edouard Bellemare,L,SEA,38,29,4,1,5
7,8480184,Gustav Lindström,D,ANA,25,22,3,2,5
7,8482207,William Dufour,R,NYI,21,29,3,2,5
7,8477034,Jaycob Megna,D,CHI,31,45,2,3,5
7,8478408,Travis Dermott,D,ARI,27,37,2,3,5
7,8482964,Arber Xhekaj,D,MTL,22,24,2,3,5
7,8475750,Jon Merrill,D,MIN,31,38,2,3,5
7,8474618,Marco Scandella,D,STL,33,49,2,3,5
7,8480025,MacKenzie Entwistle,R,CHI,24,46,2,3,5
7,8479536,Axel Jonsson-Fjallby,L,WPG,25,26,2,3,5
7,8481167,Brayden Pachal,D,CGY,24,50,2,3,5
7,8480874,Adam Ginning,D,PHI,23,26,2,3,5
7,8474207,Nick Holden,D,OTT,36,31,1,4,5
7,8481567,Henry Thrun,D,SJS,22,51,1,4,5
7,8474090,Brendan Smith,D,NJD,34,36,1,4,5
7,8477384,Josh Brown,D,ARI,29,28,1,4,5
7,8481708,Zac Jones,D,NYR,23,17,1,4,5
7,8480084,Nick DeSimone,D,NJD,29,23,1,4,5
7,8479671,Mathieu Olivier,R,CBJ,26,25,1,4,5
7,8479547,Matthew Phillips,R,PIT,25,27,1,4,5
7,8476919,Chris Tierney,C,NJD,29,28,1,4,5
7,8476952,Dominic Toninato,C,WPG,29,15,1,4,5
7,8482652,Walker Duehr,R,CGY,26,26,1,4,5
7,8476310,Lukas Sedlak,C,PHI,30,26,1,4,5
7,8477482,Zach Sanford,L,CHI,29,26,0,5,5
7,8476878,Zemgus Girgensons,L,BUF,29,36,4,0,4
7,8481754,Nikita Nesterenko,C,ANA,22,28,3,1,4
7,8482077,Dylan Holloway,L,EDM,22,23,3,1,4
7,8480011,Klim Kostin,C,DET,24,32,3,1,4
7,8476449,Scott Harrington,D,ANA,30,28,2,2,4
7,8479370,Tyson Jost,C,BUF,25,29,2,2,4
7,8481019,David Gustafsson,C,WPG,23,27,2,2,4
7,8479981,Jonah Gadjovich,L,FLA,25,27,2,2,4
7,8482448,Samuel Knazko,D,CBJ,21,29,2,2,4
7,8482712,Oskar Olausson,R,COL,21,28,1,3,4
7,8481617,Vasily Podkolzin,R,VAN,22,26,1,3,4
7,8477938,Haydn Fleury,D,TBL,27,16,1,3,4
7,8480003,Jesper Boqvist,C,BOS,25,20,1,3,4
7,8479994,Jaret Anderson-Dolan,C,LAK,24,24,1,3,4
7,8475752,Tyler Pitlick,C,NYR,32,34,1,3,4
7,8476913,Devin Shore,C,SEA,29,21,1,3,4
7,8479580,Dylan Gambrell,C,OTT,27,31,1,3,4
7,8471873,Anton Stralman,D,BOS,37,27,1,3,4
7,8483424,Owen Beck,C,MTL,19,27,1,3,4
7,8482176,Wyatt Kaiser,D,CHI,21,23,0,4,4
7,8478452,Caleb Jones,D,COL,26,20,0,4,4
7,8478454,Noah Juulsen,D,VAN,26,38,0,4,4
7,8478424,Jansen Harkins,C,PIT,26,34,0,4,4
7,8481812,Nikolai Knyzhov,D,SJS,26,38,0,4,4
7,8473446,Erik Johnson,D,BUF,35,46,3,0,3
7,8475780,Chris Wagner,R,BOS,32,27,2,1,3
7,8481147,Reese Johnson,C,CHI,25,34,2,1,3
7,8478078,Rourke Chartier,C,OTT,27,34,2,1,3
7,8474709,Matt Martin,L,NYI,34,31,2,1,3
7,8479772,Zack MacEwen,R,OTT,27,22,2,1,3
7,8477962,Brendan Lemieux,L,CAR,27,23,2,1,3
7,8475766,Austin Watson,L,TBL,31,28,2,1,3
7,8480468,James Hamblin,L,EDM,24,31,2,1,3
7,8480355,Mark Kastelic,C,OTT,24,34,2,1,3
7,8482081,Sean Farrell,C,MTL,22,27,2,1,3
7,8483464,Marco Kasper,C,DET,19,28,1,2,3
7,8480831,Alec Regula,D,CHI,23,27,1,2,3
7,8471303,Alexander Edler,D,LAK,37,30,1,2,3
7,8481122,Simon Benoit,D,TOR,25,39,1,2,3
7,8478451,Ethan Bear,D,WSH,26,16,1,2,3
7,8471686,Marc Staal,D,PHI,36,20,1,2,3
7,8477244,Chad Ruhwedel,D,PIT,33,37,1,2,3
7,8481541,Samuel Bolduc,D,NYI,23,33,1,2,3
7,8476934,Brock McGinn,L,ANA,29,24,1,2,3
7,8476994,Vinnie Hinostroza,C,PIT,29,14,1,2,3
7,8480007,Jonas Rondbjerg,R,VGK,24,17,1,2,3
7,8476867,Brendan Gaunce,C,CBJ,29,8,1,2,3
7,8478904,Steven Lorentz,C,FLA,27,28,1,2,3
7,8479379,Givani Smith,R,SJS,25,26,1,2,3
7,8477851,Jordan Oesterle,D,CGY,31,48,0,3,3
7,8482516,Matthew Kessel,D,STL,23,47,0,3,3
7,8478450,Parker Wotherspoon,D,BOS,26,23,0,3,3
7,8477810,Joel Hanley,D,DAL,32,26,0,3,3
7,8480853,Liam Foudy,C,NSH,23,13,0,3,3
7,8475235,Nicolas Deslauriers,L,PHI,32,47,0,3,3
7,8482452,Elliot Desnoyers,L,PHI,21,26,2,0,2
7,8480776,Sheldon Rempal,R,VGK,28,5,2,0,2
7,8471817,Ryan Reaves,R,TOR,36,27,2,0,2
7,8477073,Kurtis MacDermid,D,COL,29,28,2,0,2
7,8476915,Jujhar Khaira,L,MIN,29,29,1,1,2
7,8483641,Anton Levtchi,L,FLA,28,27,1,1,2
7,8480242,Arnaud Durandeau,L,NYI,24,29,1,1,2
7,8474218,Jason Demers,D,EDM,35,31,1,1,2
7,8482133,Thomas Bordeleau,C,SJS,21,6,1,1,2
7,8481006,Tyler Tucker,D,STL,23,16,1,1,2
7,8479362,Riley Tufte,L,COL,25,5,1,1,2
7,8478051,Max Willman,C,NJD,28,13,1,1,2
7,8481532,Alex Turcotte,C,LAK,22,6,1,1,2
7,8477359,Tucker Poolman,D,VAN,30,26,1,1,2
7,8480275,Nick Swaney,R,MIN,26,28,0,2,2
7,8475747,Patrik Nemeth,D,ARI,31,29,0,2,2
7,8480070,Ian Mitchell,D,BOS,24,13,0,2,2
7,8480196,Jacob Bryson,D,BUF,26,8,0,2,2
7,8480870,Bo Groulx,C,ANA,23,32,0,2,2
7,8473473,Milan Lucic,L,BOS,35,4,0,2,2
7,8477464,Nic Petan,C,MIN,28,6,0,2,2
7,8477527,Ross Johnston,L,ANA,29,41,0,2,2
7,8481043,Cole Koepke,L,TBL,25,8,0,2,2
7,8477931,Tomas Nosek,L,NJD,31,40,1,0,1
7,8480041,Dmitri Samorukov,D,STL,24,28,1,0,1
7,8481056,Spencer Stastney,D,NSH,23,9,1,0,1
7,8480823,Alexander Alexeyev,D,WSH,24,13,1,0,1
7,8476873,Mark Jankowski,C,NSH,29,5,1,0,1
7,8480021,Jack Studnicka,C,SJS,24,14,1,0,1
7,8478409,Anthony Richard,C,BOS,27,4,1,0,1
7,8483570,Ben Meyers,C,COL,25,9,1,0,1
7,8481422,Jacob Lucchini,C,MIN,28,13,1,0,1
7,8479546,Oskar Steen,C,BOS,25,34,1,0,1
7,8481239,Samuel Fagemo,L,LAK,23,8,1,0,1
7,8482762,Simon Edvinsson,D,DET,20,2,0,1,1
7,8481161,Jake Christiansen,D,CBJ,24,3,0,1,1
7,8480157,Calle Rosen,D,STL,29,5,0,1,1
7,8479984,Cal Foote,D,NJD,25,4,0,1,1
7,8479321,Lucas Johansen,D,WSH,26,6,0,1,1
7,8479378,Logan Stanley,D,WPG,25,10,0,1,1
7,8478017,Mark Friedman,D,VAN,28,20,0,1,1
7,8482095,Tyler Kleven,D,OTT,21,5,0,1,1
7,8479320,Max Lajoie,D,TOR,26,5,0,1,1
7,8477887,Patrick Brown,C,BOS,31,11,0,1,1
7,8480245,Olle Lycksell,R,PHI,24,5,0,1,1
7,8478146,Matthew Highmore,C,OTT,27,6,0,1,1
7,8480845,Rasmus Kupari,C,WPG,23,21,0,1,1
7,8478512,Austin Czarnik,C,DET,31,18,0,1,1
7,8479367,William Lockwood,R,FLA,25,23,0,1,1
7,8481543,Nikita Alexandrov,C,STL,23,18,0,1,1
7,8483597,Milos Kelemen,L,ARI,24,10,0,1,1
7,8480977,Semyon Der-Arguchintsev,C,TOR,23,29,0,0,0
7,8482181,Tristen Robins,C,SJS,22,28,0,0,0
7,8483565,Nick Blankenburg,D,CBJ,25,6,0,0,0
7,8483620,Marcus Bjork,D,CBJ,26,0,0,0,0
7,8481521,Ronnie Attard,D,PHI,24,0,0,0,0
7,8482399,Billy Sweezey,D,CBJ,27,0,0,0,0
7,8481072,Tim Berni,D,CBJ,23,0,0,0,0
7,8476884,Derrick Pouliot,D,SJS,29,0,0,0,0
7,8482624,Daniil Miromanov,D,VGK,26,2,0,0,0
7,8482861,Vincent Iorio,D,WSH,21,0,0,0,0
7,8478465,Guillaume Brisebois,D,VAN,26,0,0,0,0
7,8484256,Jake Livingstone,D,NSH,24,0,0,0,0
7,8481599,Victor Soderstrom,D,ARI,22,1,0,0,0
7,8474027,Justin Braun,D,PHI,36,0,0,0,0
7,8478062,Dysin Mayo,D,ARI,27,0,0,0,0
7,8481563,Drew Helleson,D,ANA,22,0,0,0,0
7,8481575,Lassi Thomson,D,OTT,23,0,0,0,0
7,8483619,Filip Roos,D,CHI,24,4,0,0,0
7,8481461,Corey Schueneman,D,MTL,28,0,0,0,0
7,8478846,Christian Wolanin,D,VAN,28,0,0,0,0
7,8479395,Dennis Cholowski,D,NYI,25,0,0,0,0
7,8479945,Gavin Bayreuther,D,CBJ,29,0,0,0,0
7,8474818,Jordie Benn,D,TOR,36,0,0,0,0
7,8479421,Jacob Moverare,D,LAK,25,5,0,0,0
7,8479329,Frederic Allard,D,MTL,26,0,0,0,0
7,8481600,Tobias Bjornfot,D,VGK,22,3,0,0,0
7,8477462,Robert Hagg,D,ANA,28,5,0,0,0
7,8476470,Nathan Beaulieu,D,ANA,31,0,0,0,0
7,8484254,Akito Hirose,D,VAN,24,3,0,0,0
7,8479388,Riley Stillman,D,BUF,25,0,0,0,0
7,8482824,Nick Cicek,D,SJS,23,0,0,0,0
7,8480056,Jack Rathbone,D,VAN,24,0,0,0,0
7,8476850,Ryan Murray,D,EDM,30,0,0,0,0
7,8478841,Colton White,D,ANA,26,0,0,0,0
7,8480160,Radim Simek,D,SJS,31,0,0,0,0
7,8478491,Jacob Larsson,D,OTT,26,0,0,0,0
7,8475857,Kevin Gravel,D,NSH,31,0,0,0,0
7,8482067,Connor Mackey,D,NYR,27,1,0,0,0
7,8477433,Ben Harpur,D,NYR,28,0,0,0,0
7,8481572,Ville Heinola,D,WPG,22,0,0,0,0
7,8478415,Jakub Zboril,D,BOS,26,0,0,0,0
7,8477341,Andreas Johnsson,L,SJS,29,0,0,0,0
7,8480216,Jacob Peterson,C,SJS,24,6,0,0,0
7,8477467,Gustav Olofsson,D,SEA,29,0,0,0,0
7,8478476,Kyle Capobianco,D,WPG,26,0,0,0,0
7,8479985,Cale Fleury,D,SEA,25,0,0,0,0
7,8475227,Chris Wideman,D,MTL,33,0,0,0,0
7,8479333,Libor Hajek,D,NYR,25,0,0,0,0
7,8479376,Victor Mete,D,PHI,25,1,0,0,0
7,8480439,Mac Hollowell,D,TOR,25,0,0,0,0
7,8480467,Austin Strand,D,ANA,26,0,0,0,0
7,8477981,Roland McKeown,D,NSH,27,0,0,0,0
7,8474628,Michael Stone,D,CGY,33,0,0,0,0
7,8480034,Joel Teasdale,L,MTL,24,0,0,0,0
7,8481609,Vladislav Kolyachonok,D,ARI,22,1,0,0,0
7,8479602,Jeremy Davies,D,BUF,27,0,0,0,0
7,8479639,Dylan Coghlan,D,CAR,25,0,0,0,0
7,8478506,Gabriel Carlsson,D,WSH,26,0,0,0,0
7,8477463,Steven Santini,D,STL,28,0,0,0,0
7,8478075,Anders Bjork,L,CHI,27,0,0,0,0
7,8484287,Cole McWard,D,VAN,22,1,0,0,0
7,8474145,Robert Bortuzzo,D,NYI,34,15,0,0,0
7,8475625,Matt Irwin,D,WSH,36,0,0,0,0
7,8482179,Justin Richards,C,CBJ,25,0,0,0,0
7,8481649,Joona Luoto,L,CBJ,26,0,0,0,0
7,8479026,Philippe Myers,D,TBL,26,5,0,0,0
7,8480935,Lawrence Pilut,D,BUF,28,0,0,0,0
7,8479578,Casey Fitzgerald,D,FLA,26,0,0,0,0
7,8480071,Robin Salo,D,NYI,25,0,0,0,0
7,8478224,Luke Philp,C,CHI,28,0,0,0,0
7,8484125,Hunter McKown,C,CBJ,21,0,0,0,0
7,8481679,Maxence Guenette,D,OTT,22,1,0,0,0
7,8479423,Alex Nylander,L,PIT,25,5,0,0,0
7,8480441,Trey Fix-Wolansky,R,CBJ,24,1,0,0,0
7,8480820,Filip Kral,D,TOR,24,0,0,0,0
7,8479523,Lucas Carlsson,D,FLA,26,0,0,0,0
7,8479304,Kyle Criscuolo,C,SJS,31,0,0,0,0
7,8474697,Mark Borowiecki,D,NSH,34,0,0,0,0
7,8480842,Filip Hallander,C,PIT,23,0,0,0,0
7,8481725,Elmer Soderblom,L,DET,22,0,0,0,0
7,8479252,Dan Renouf,D,BOS,29,0,0,0,0
7,8481591,Sam Poulin,R,PIT,22,0,0,0,0
7,8475968,Alex Belzile,R,MTL,32,0,0,0,0
7,8475772,Riley Sheahan,C,BUF,32,0,0,0,0
7,8475163,Alex Chiasson,R,DET,33,0,0,0,0
7,8481598,Philip Broberg,D,EDM,22,10,0,0,0
7,8478455,Austin Wagner,L,CHI,26,0,0,0,0
7,8476779,Brad Hunt,D,COL,35,0,0,0,0
7,8479335,Rasmus Asplund,C,NSH,26,0,0,0,0
7,8478967,Lane Pederson,C,CBJ,26,0,0,0,0
7,8481077,John Leonard,L,NSH,25,0,0,0,0
7,8481585,Egor Afanasyev,L,NSH,22,2,0,0,0
7,8483397,Marc McLaughlin,C,BOS,24,0,0,0,0
7,8480443,Kristian Reichel,C,WPG,25,0,0,0,0
7,8481751,Lukas Rousek,R,BUF,24,5,0,0,0
7,8476396,Steven Fogarty,C,MIN,30,0,0,0,0
7,8478881,Brett Seney,L,CHI,27,4,0,0,0
7,8480326,Sheldon Dries,C,VAN,29,0,0,0,0
7,8481433,Taro Hirose,L,DET,27,0,0,0,0
7,8480833,Vitali Kravtsov,R,VAN,24,0,0,0,0
7,8481550,Adam Beckman,L,MIN,22,0,0,0,0
7,8479972,Mason Shaw,C,MIN,25,0,0,0,0
7,8477460,Laurent Dauphin,C,ARI,28,0,0,0,0
7,8476166,Taylor Fedun,D,PIT,35,0,0,0,0
7,8478067,Oskar Lindblom,L,SJS,27,1,0,0,0
7,8479944,Zach Aston-Reese,C,DET,29,1,0,0,0
7,8479465,Drake Caggiula,L,PIT,29,0,0,0,0
7,8481740,Tyce Thompson,R,NJD,24,0,0,0,0
7,8476948,Charles Hudon,L,COL,29,0,0,0,0
7,8480863,Gabriel Fortier,L,TBL,23,0,0,0,0
7,8471887,Patric Hornqvist,R,FLA,36,0,0,0,0
7,8477471,Dillon Heatherington,D,OTT,28,0,0,0,0
7,8481441,Joe Snively,C,WSH,27,3,0,0,0
7,8478173,Hayden Hodgson,R,PHI,27,0,0,0,0
7,8481720,Nick Abruzzese,C,TOR,24,0,0,0,0
7,8478843,Denis Malgin,C,COL,26,0,0,0,0
7,8483630,Pavol Regenda,L,ANA,24,0,0,0,0
7,8478373,Nikita Soshnikov,R,NYI,30,0,0,0,0
7,8482147,Jean-Luc Foudy,C,COL,21,0,0,0,0
7,8478431,Evgeny Svechnikov,L,SJS,27,0,0,0,0
7,8477210,Buddy Robinson,R,CHI,32,0,0,0,0
7,8479404,Henrik Borgstrom,C,WSH,26,0,0,0,0
7,8481712,Matej Blumel,R,DAL,23,0,0,0,0
7,8475278,Byron Froese,C,VGK,32,7,0,0,0
7,8479338,Markus Niemelainen,D,EDM,25,0,0,0,0
7,8471794,Darren Helm,C,COL,36,0,0,0,0
7,8482623,Josh Dunne,C,CBJ,25,0,0,0,0
7,8482641,Matt Kiersted,D,FLA,25,0,0,0,0
7,8476851,Alex Galchenyuk,C,COL,29,0,0,0,0
7,8479366,Logan Brown,C,STL,25,0,0,0,0
7,8480822,Martin Kaut,R,SJS,24,0,0,0,0
7,8482834,Jesper Froden,R,SEA,29,0,0,0,0
7,8480844,Grigori Denisenko,L,VGK,23,3,0,0,0
7,8482635,Mike Hardman,L,CHI,24,0,0,0,0
7,8477357,Saku Maenalanen,R,WPG,29,0,0,0,0
7,8480979,Nathan Smith,C,ARI,25,0,0,0,0
7,8479356,Kieffer Bellows,L,PHI,25,0,0,0,0
7,8475795,Dylan McIlrath,D,WSH,31,1,0,0,0
7,8478400,Colin White,C,PIT,26,9,0,0,0
7,8478446,Glenn Gawdin,C,ANA,26,0,0,0,0
7,8476326,Josh Archibald,R,PIT,31,0,0,0,0
7,8481683,Aidan McDonough,L,VAN,24,0,0,0,0
7,8480267,Sammy Walker,C,MIN,24,4,0,0,0
7,8477520,Jean-Sebastien Dea,C,ARI,29,0,0,0,0
7,8476439,Brett Ritchie,R,ARI,30,0,0,0,0
7,8479518,Fredrik Karlström,C,DAL,25,0,0,0,0
7,8477126,Jayson Megna,C,ANA,33,0,0,0,0
7,8479644,Matt Luff,R,DET,26,0,0,0,0
7,8478211,Dryden Hunt,L,CGY,28,5,0,0,0
7,8480226,Marián Studenic,R,SEA,25,2,0,0,0
7,8480037,Aleksi Heponiemi,C,FLA,24,0,0,0,0
7,8480292,Carson Meyer,R,CBJ,26,0,0,0,0
7,8482634,Alex Steeves,C,TOR,24,1,0,0,0
7,8475178,Zack Kassian,R,ARI,32,0,0,0,0
7,8483524,Shane Wright,C,SEA,19,3,0,0,0
7,8482654,Jackson Cates,C,PHI,26,0,0,0,0
7,8479550,Tanner Laczynski,C,PHI,26,0,0,0,0
7,8479991,Jake Leschyshyn,C,NYR,24,1,0,0,0
7,8474613,Derek Stepan,C,CAR,33,0,0,0,0
7,8478367,Cole Bardreau,C,NYI,30,0,0,0,0
7,8480890,Jan Jenik,R,ARI,23,1,0,0,0
7,8475160,Kyle Clifford,L,TOR,32,0,0,0,0
7,8479705,Jeffrey Viel,L,SJS,26,0,0,0,0
7,8477401,John Hayden,C,SEA,28,2,0,0,0
7,8480846,Sampo Ranta,L,COL,23,0,0,0,0
7,8482691,Aatu Raty,C,VAN,21,0,0,0,0
7,8481070,Hugh McGing,L,STL,25,5,0,0,0
7,8479573,Mikhail Maltsev,L,COL,25,0,0,0,0
7,8482250,Callahan Burke,C,CAR,26,1,0,0,0
7,8481102,Egor Sokolov,L,OTT,23,0,0,0,0
7,8481518,Nolan Foote,L,NJD,23,0,0,0,0
7,8474190,Wayne Simmonds,R,TOR,35,0,0,0,0
7,8474610,Zac Dalpe,C,FLA,34,0,0,0,0
7,8479347,Tyler Benson,L,EDM,25,0,0,0,0
7,8476404,Andy Andreoff,C,NYI,32,0,0,0,0
7,8476390,Joseph Cramarossa,C,MIN,31,0,0,0,0
7,8483549,Lucas Condotta,L,MTL,26,3,0,0,0
7,8482197,Adam Raska,R,MIN,22,5,0,0,0
7,8479533,Joona Koppanen,L,PIT,25,3,0,0,0
7,8479526,Otto Koivula,L,NYI,25,0,0,0,0
7,8479375,William Bitten,C,STL,25,0,0,0,0
7,8474089,Brad Malone,C,EDM,34,0,0,0,0
7,8478058,CJ Suess,L,SJS,29,0,0,0,0
7,8478147,Bokondji Imama,L,ARI,27,0,0,0,0
7,8477320,Anton Blidh,L,NYR,28,1,0,0,0
7,8477993,Justin Kirkland,C,ARI,27,2,0,0,0
7,8480836,Jonathan Gruden,C,PIT,23,5,0,0,0
7,8480032,Shane Bowers,C,NJD,24,3,0,0,0
8,8477492,Nathan MacKinnon,C,COL,28,82,44,84,128
8,8478402,Connor McDavid,C,EDM,26,80,28,99,127
8,8476453,Nikita Kucherov,R,TBL,30,81,46,78,124
8,8477934,Leon Draisaitl,C,EDM,28,82,52,64,116
8,8477956,David Pastrnak,R,BOS,27,82,49,60,109
8,8480012,Elias Pettersson,C,VAN,25,81,41,67,108
8,8478420,Mikko Rantanen,R,COL,27,82,42,65,107
8,8478550,Artemi Panarin,L,NYR,32,82,41,60,101
8,8479318,Auston Matthews,C,TOR,26,81,64,36,100
8,8478483,Mitchell Marner,R,TOR,26,81,31,69,100
8,8477939,William Nylander,R,TOR,27,82,46,53,99
8,8477933,Sam Reinhart,C,FLA,28,82,56,41,97
8,8478427,Sebastian Aho,C,CAR,26,78,34,63,97
8,8480800,Quinn Hughes,D,VAN,24,81,17,77,94
8,8479407,Jesper Bratt,L,NJD,25,81,31,62,93
8,8479314,Matthew Tkachuk,L,FLA,26,82,25,68,93
8,8480069,Cale Makar,D,COL,25,77,20,71,91
8,8476468,J.T. Miller,C,VAN,30,81,36,53,89
8,8478010,Brayden Point,C,TBL,27,82,42,46,88
8,8476459,Mika Zibanejad,C,NYR,30,81,36,52,88
8,8475913,Mark Stone,R,VGK,31,81,31,55,86
8,8477493,Aleksander Barkov,C,FLA,28,76,24,62,86
8,8480865,Noah Dobson,D,NYI,23,82,11,75,86
8,8477404,Jake Guentzel,L,PIT,29,81,33,52,85
8,8480023,Robert Thomas,C,STL,24,82,25,60,85
8,8474600,Roman Josi,D,NSH,33,82,17,67,84
8,8475167,Victor Hedman,D,TBL,33,80,16,68,84
8,8477409,Carter Verhaeghe,C,FLA,28,82,42,41,83
8,8480027,Jason Robertson,L,DAL,24,82,29,53,82
8,8471675,Sidney Crosby,C,PIT,36,82,43,38,81
8,8479337,Alex DeBrincat,R,DET,26,82,31,50,81
8,8476887,Filip Forsberg,L,NSH,29,82,39,41,80
8,8473512,Claude Giroux,R,OTT,35,82,31,48,79
8,8471215,Evgeni Malkin,C,PIT,37,82,29,50,79
8,8477946,Dylan Larkin,C,DET,27,76,39,39,78
8,8481559,Jack Hughes,C,NJD,22,65,26,52,78
8,8478445,Mathew Barzal,C,NYI,26,81,21,57,78
8,8475786,Zach Hyman,L,EDM,31,81,49,28,77
8,8475168,Matt Duchene,C,DAL,32,81,32,45,77
8,8476454,Ryan Nugent-Hopkins,C,EDM,30,82,22,55,77
8,8478403,Jack Eichel,C,VGK,27,70,35,41,76
8,8478864,Kirill Kaprizov,L,MIN,26,75,31,45,76
8,8482093,Seth Jarvis,C,CAR,21,81,31,44,75
8,8477960,Adrian Kempe,R,LAK,27,82,28,46,74
8,8479542,Brandon Hagel,L,TBL,25,82,27,47,74
8,8471685,Anze Kopitar,C,LAK,36,82,25,48,73
8,8480803,Evan Bouchard,D,EDM,24,82,19,54,73
8,8475184,Chris Kreider,L,NYR,32,82,37,35,72
8,8478449,Roope Hintz,C,DAL,27,80,34,38,72
8,8474564,Steven Stamkos,C,TBL,33,79,30,42,72
8,8480801,Brady Tkachuk,L,OTT,24,82,40,31,71
8,8478439,Travis Konecny,R,PHI,26,81,35,36,71
8,8480018,Nick Suzuki,C,MTL,24,82,27,44,71
8,8477942,Kevin Fiala,L,LAK,27,82,24,47,71
8,8478444,Brock Boeser,R,VAN,26,81,40,30,70
8,8477500,Bo Horvat,C,NYI,28,81,31,39,70
8,8470794,Joe Pavelski,C,DAL,39,82,27,43,70
8,8474578,Erik Karlsson,D,PIT,33,82,12,58,70
8,8476460,Mark Scheifele,C,WPG,30,75,27,42,69
8,8480839,Rasmus Dahlin,D,BUF,23,81,19,50,69
8,8482116,Tim Stützle,C,OTT,21,82,17,52,69
8,8478493,Joel Eriksson Ek,C,MIN,26,82,37,31,68
8,8476389,Vincent Trocheck,C,NYR,30,82,23,45,68
8,8478398,Kyle Connor,L,WPG,27,65,39,28,67
8,8475158,Ryan O'Reilly,C,NSH,32,82,32,35,67
8,8473419,Brad Marchand,L,BOS,35,82,33,33,66
8,8479343,Clayton Keller,R,ARI,25,82,28,38,66
8,8475172,Nazem Kadri,C,CGY,33,82,24,42,66
8,8476853,Morgan Rielly,D,TOR,29,79,11,55,66
8,8477955,Jared McCann,L,SEA,27,81,35,30,65
8,8480039,Martin Necas,C,CAR,24,76,31,34,65
8,8478975,Mason Marchment,L,DAL,28,81,28,37,65
8,8482078,Lucas Raymond,L,DET,21,82,22,43,65
8,8479425,Filip Hronek,D,VAN,26,81,8,57,65
8,8476539,Jonathan Marchessault,R,VGK,33,81,39,25,64
8,8481540,Cole Caufield,R,MTL,22,82,32,32,64
8,8480797,Joel Farabee,L,PHI,23,81,25,39,64
8,8478366,Frank Vatrano,R,ANA,29,82,35,28,63
8,8475754,Brock Nelson,C,NYI,32,82,31,32,63
8,8480002,Nico Hischier,C,NJD,24,70,27,36,63
8,8477402,Pavel Buchnevich,L,STL,28,80,26,36,62
8,8476905,Chandler Stephenson,C,VGK,29,77,23,39,62
8,8476875,Mike Matheson,D,MTL,29,82,10,52,62
8,8478407,Vince Dunn,D,SEA,27,78,10,52,62
8,8475745,Charlie Coyle,C,BOS,31,82,23,38,61
8,8475166,John Tavares,C,TOR,33,80,20,41,61
8,8479999,Casey Mittelstadt,C,BUF,25,82,19,42,61
8,8474037,James van Riemsdyk,L,BOS,34,78,19,42,61
8,8471214,Alex Ovechkin,L,WSH,38,79,21,39,60
8,8479323,Adam Fox,D,NYR,25,72,10,50,60
8,8477501,Valeri Nichushkin,R,COL,28,67,34,25,59
8,8476448,William Karlsson,C,VGK,30,69,29,30,59
8,8477416,Oliver Bjorkstrand,R,SEA,28,82,23,36,59
8,8482124,Quinton Byfield,R,LAK,21,80,23,36,59
8,8477949,Alex Tuch,R,BUF,27,75,20,39,59
8,8474679,Gustav Nyquist,C,NSH,34,82,16,43,59
8,8476881,Tomas Hertl,C,SJS,30,76,24,34,58
8,8480208,Drake Batherson,R,OTT,25,82,22,36,58
8,8475726,Tyler Toffoli,R,NJD,31,80,35,22,57
8,8479675,Trevor Moore,L,LAK,28,82,30,27,57
8,8475810,Bryan Rust,R,PIT,31,69,27,30,57
8,8478873,Troy Terry,R,ANA,26,79,23,34,57
8,8475765,Vladimir Tarasenko,R,OTT,32,80,21,36,57
8,8477504,Josh Morrissey,D,WPG,28,81,10,47,57
8,8477940,Nikolaj Ehlers,L,WPG,27,81,28,28,56
8,8476479,Phillip Danault,C,LAK,30,82,16,40,56
8,8475798,Mikael Granlund,C,SJS,31,68,14,42,56
8,8479325,Charlie McAvoy,D,BOS,26,74,14,42,56
8,8475794,Tyler Seguin,C,DAL,31,82,23,32,55
8,8477497,Sean Monahan,C,WPG,29,83,20,35,55
8,8475692,Mats Zuccarello,R,MIN,36,73,15,40,55
8,8476399,Blake Coleman,C,CGY,32,82,27,27,54
8,8479385,Jordan Kyrou,C,STL,25,82,25,29,54
8,8476882,Teuvo Teravainen,L,CAR,29,81,21,33,54
8,8480036,Miro Heiskanen,D,DAL,24,72,10,44,54
8,8478440,Dylan Strome,C,WSH,26,82,26,27,53
8,8479345,Jakob Chychrun,D,OTT,25,82,23,30,53
8,8478401,Pavel Zacha,C,BOS,26,78,19,34,53
8,8475784,Jeff Skinner,L,BUF,31,74,30,22,52
8,8481068,Yegor Sharangovich,C,CGY,25,82,30,22,52
8,8475169,Evander Kane,L,EDM,32,81,28,24,52
8,8471724,Kris Letang,D,PIT,36,82,9,43,52
8,8475170,Brayden Schenn,C,STL,32,82,28,23,51
8,8479420,Tage Thompson,C,BUF,26,72,27,24,51
8,8475151,Kyle Palmieri,C,NYI,32,82,27,24,51
8,8481557,Matt Boldy,L,MIN,22,75,23,28,51
8,8476456,Jonathan Huberdeau,C,CGY,30,81,13,38,51
8,8477451,Ryan Hartman,R,MIN,29,77,23,27,50
8,8482745,Mason McTavish,C,ANA,20,74,22,28,50
8,8474563,Drew Doughty,D,LAK,34,82,18,32,50
8,8478047,Michael Bunting,L,CAR,28,80,17,33,50
8,8478397,Rasmus Andersson,D,CGY,27,78,14,36,50
8,8476869,Brady Skjei,D,CAR,29,81,10,40,50
8,8477511,Anthony Mantha,R,WSH,29,78,26,23,49
8,8480830,Andrei Svechnikov,R,CAR,23,60,21,28,49
8,8474641,Adam Henrique,C,ANA,33,81,21,28,49
8,8477496,Elias Lindholm,C,VAN,29,81,18,31,49
8,8474141,Patrick Kane,R,DET,35,51,17,32,49
8,8476906,Shayne Gostisbehere,D,DET,30,81,11,38,49
8,8476346,Johnny Gaudreau,L,CBJ,30,81,10,39,49
8,8474565,Alex Pietrangelo,D,VGK,33,76,4,45,49
8,8477450,Jason Dickinson,C,CHI,28,82,31,17,48
8,8480015,Owen Tippett,R,PHI,24,77,25,23,48
8,8480009,Eeli Tolvanen,R,SEA,24,82,24,24,48
8,8482175,JJ Peterka,R,BUF,21,82,24,24,48
8,8479400,Pierre-Luc Dubois,C,LAK,25,82,23,25,48
8,8477951,Nick Schmaltz,C,ARI,27,79,20,28,48
8,8477964,Ivan Barbashev,C,VGK,28,81,18,30,48
8,8474586,Jordan Eberle,R,SEA,33,78,17,31,48
8,8478462,Nicolas Roy,C,VGK,26,72,15,33,48
8,8481711,Matias Maccelli,L,ARI,23,82,12,36,48
8,8478460,Zach Werenski,D,CBJ,26,69,9,39,48
8,8474590,John Carlson,D,WSH,33,82,4,44,48
8,8482740,Wyatt Johnston,C,DAL,20,82,24,23,47
8,8482109,Alexis Lafrenière,L,NYR,22,82,23,24,47
8,8477429,Andrew Copp,C,DET,29,81,20,27,47
8,8478519,Anthony Cirelli,C,TBL,26,81,19,28,47
8,8477456,J.T. Compher,L,DET,28,77,18,29,47
8,8478856,Conor Garland,R,VAN,27,81,17,30,47
8,8481528,Dylan Cozens,C,BUF,22,79,15,32,47
8,8480434,Sean Durzi,D,ARI,25,76,13,34,47
8,8477021,Alex Kerfoot,C,ARI,29,82,11,36,47
8,8478474,Lawson Crouse,L,ARI,26,81,31,15,46
8,8475768,Jaden Schwartz,C,SEA,31,66,22,24,46
8,8478396,Noah Hanifin,D,CGY,26,82,13,33,46
8,8482149,Cole Perfetti,C,WPG,21,81,21,24,45
8,8474150,Mikael Backlund,C,CGY,34,82,21,24,45
8,8477494,Jonathan Drouin,L,COL,28,80,15,30,45
8,8470613,Brent Burns,D,CAR,38,81,10,35,45
8,8481542,Moritz Seider,D,DET,22,82,7,38,45
8,8477952,Robby Fabbri,C,DET,27,68,23,21,44
8,8477935,Sam Bennett,C,FLA,27,70,21,23,44
8,8476458,Ryan Strome,C,ANA,30,79,10,34,44
8,8476792,Torey Krug,D,STL,32,82,5,39,44
8,8482110,Dawson Mercer,C,NJD,22,81,22,21,43
8,8477346,MacKenzie Weegar,D,CGY,29,82,18,25,43
8,8481581,Thomas Harley,D,DAL,22,79,17,26,43
8,8479365,Trent Frederic,C,BOS,25,82,20,22,42
8,8477998,Warren Foegele,L,EDM,27,82,20,22,42
8,8477479,Tyler Bertuzzi,L,TOR,28,81,17,25,42
8,8476483,Rickard Rakell,R,PIT,30,70,15,27,42
8,8473994,Jamie Benn,L,DAL,34,82,14,28,42
8,8478038,Devon Toews,D,COL,29,82,12,30,42
8,8482122,Brock Faber,D,MIN,21,82,5,37,42
8,8480064,Josh Norris,C,OTT,24,75,22,19,41
8,8480893,Kirill Marchenko,R,CBJ,23,79,22,19,41
8,8476925,Colton Sissons,C,NSH,30,82,21,20,41
8,8482079,Marco Rossi,C,MIN,22,82,20,21,41
8,8479987,Morgan Geekie,C,BOS,25,76,18,23,41
8,8475191,Reilly Smith,R,PIT,32,76,16,25,41
8,8478233,Andrew Mangiapane,L,CGY,27,81,14,27,41
8,8479525,Ross Colton,C,COL,27,80,14,27,41
8,8482665,Matty Beniers,C,SEA,21,77,12,29,41
8,8478472,Mathieu Joseph,R,OTT,26,72,11,30,41
8,8478542,Evan Rodrigues,C,FLA,30,82,10,31,41
8,8478414,Timo Meier,R,NJD,27,68,23,17,40
8,8480014,Gabriel Vilardi,C,WPG,24,61,23,17,40
8,8477447,Shea Theodore,D,VGK,28,48,8,32,40
8,8475799,Nino Niederreiter,R,WPG,31,81,19,20,39
8,8482667,William Eklund,L,SJS,21,80,17,22,39
8,8477426,Nicholas Paul,L,TBL,28,82,17,22,39
8,8476392,Adam Lowry,C,WPG,30,81,12,27,39
8,8476462,Dougie Hamilton,D,NJD,30,48,12,27,39
8,8482105,Jake Sanderson,D,OTT,21,79,8,31,39
8,8480188,Fabian Zetterlund,L,SJS,24,81,21,17,38
8,8475722,Jason Zucker,L,ARI,31,72,19,19,38
8,8478438,Tommy Novak,C,NSH,26,71,16,22,38
8,8480798,Philipp Kurashev,C,CHI,24,75,12,26,38
8,8482684,Luke Hughes,D,NJD,20,81,12,26,38
8,8476480,Vladislav Namestnikov,C,WPG,31,78,9,29,38
8,8477503,Max Domi,C,TOR,28,82,8,30,38
8,8477948,Travis Sanheim,D,PHI,27,80,6,32,38
8,8476432,Boone Jenner,C,CBJ,30,66,28,9,37
8,8478057,Dakota Joshua,C,VAN,27,79,19,18,37
8,8474102,David Perron,L,DET,35,76,18,19,37
8,8483808,Andrei Kuzmenko,L,CGY,27,76,14,23,37
8,8476826,Yanni Gourde,C,SEA,32,80,14,23,37
8,8476419,Jean-Gabriel Pageau,C,NYI,31,82,13,24,37
8,8478891,Mason Appleton,C,WPG,27,81,13,24,37
8,8477505,Alex Wennberg,C,SEA,29,82,13,24,37
8,8473986,Alex Killorn,L,ANA,34,63,12,25,37
8,8482113,Anton Lundell,C,FLA,22,78,11,26,37
8,8475764,Cam Fowler,D,ANA,32,82,5,32,37
8,8482089,Jake Neighbours,L,STL,21,82,26,10,36
8,8478046,Danton Heinen,L,BOS,28,74,20,16,36
8,8476880,Tom Wilson,R,WSH,29,81,19,17,36
8,8482475,Yegor Chinakhov,R,CBJ,22,69,18,18,36
8,8473422,Nick Foligno,L,CHI,36,75,17,19,36
8,8482146,Luke Evangelista,R,NSH,21,80,17,19,36
8,8475287,Erik Haula,L,NJD,32,75,15,21,36
8,8483515,Juraj Slafkovsky,L,MTL,19,82,14,22,36
8,8475171,Oliver Ekman-Larsson,D,FLA,32,82,13,23,36
8,8476438,Brandon Saad,L,STL,31,82,20,15,35
8,8480028,Morgan Frost,C,PHI,24,70,15,20,35
8,8478498,Jake DeBrusk,L,BOS,27,80,15,20,35
8,8478020,Michael Amadio,R,VGK,27,74,13,22,35
8,8475744,Evgeny Kuznetsov,C,WSH,31,72,13,22,35
8,8475760,Nick Bjugstad,C,ARI,31,82,12,23,35
8,8476979,Erik Gustafsson,D,NYR,31,81,9,26,35
8,8479410,Mikhail Sergachev,D,TBL,25,60,8,27,35
8,8478500,Ivan Provorov,D,CBJ,26,81,6,29,35
8,8477969,Marcus Pettersson,D,PIT,27,82,5,30,35
8,8482245,Artem Zub,D,OTT,28,72,5,30,35
8,8482159,Tyson Foerster,R,PHI,21,78,19,15,34
8,8481186,Logan O'Connor,R,COL,27,78,19,15,34
8,8474149,Evgenii Dadonov,R,DAL,34,77,17,17,34
8,8481524,Bowen  Byram,D,COL,22,74,15,19,34
8,8478466,Daniel Sprong,R,DET,26,54,14,20,34
8,8477407,Anthony Duclair,L,SJS,28,76,14,20,34
8,8475193,Tomas Tatar,L,SEA,33,78,11,23,34
8,8480817,K'Andre Miller,D,NYR,23,80,11,23,34
8,8481624,Ilya Mikheyev,R,VAN,29,77,15,18,33
8,8473533,Jordan Staal,C,CAR,35,81,13,20,33
8,8478055,Gustav Forsling,D,FLA,27,81,11,22,33
8,8476872,Scott Laughton,C,PHI,29,81,11,22,33
8,8477498,Darnell Nurse,D,EDM,28,82,11,22,33
8,8482055,Drew O'Connor,L,PIT,25,82,10,23,33
8,8479398,Samuel Girard,D,COL,25,61,7,26,33
8,8475218,Mattias Ekholm,D,EDM,33,81,6,27,33
8,8478469,Thomas Chabot,D,OTT,26,60,5,28,33
8,8480459,Pius Suter,C,VAN,27,67,21,11,32
8,8481582,Nicholas Robertson,L,TOR,22,64,16,16,32
8,8481560,Arthur Kaliyev,R,LAK,22,68,16,16,32
8,8477425,Miles Wood,L,COL,28,77,15,17,32
8,8482125,Alexander Holtz,R,NJD,21,81,15,17,32
8,8478043,Sam Lafferty,C,VAN,28,79,15,17,32
8,8479415,Michael McLeod,C,NJD,25,73,15,17,32
8,8475763,Kevin Hayes,R,STL,31,82,12,20,32
8,8476931,Jake McCabe,D,TOR,30,76,8,24,32
8,8476927,Teddy Blueger,C,VAN,29,67,5,27,32
8,8475188,Brayden McNabb,D,VGK,32,81,3,29,32
8,8475793,Ryan Johansen,C,COL,31,82,19,12,31
8,8475220,Marcus Foligno,L,MIN,32,75,15,16,31
8,8480829,Jesperi Kotkaniemi,C,CAR,23,81,15,16,31
8,8479992,Michael Rasmussen,C,DET,24,82,13,18,31
8,8480813,Joe Veleno,C,DET,23,80,13,18,31
8,8471218,Blake Wheeler,R,NYR,37,82,12,19,31
8,8481032,Paul Cotter,C,VGK,24,80,12,19,31
8,8474157,Max Pacioretty,L,WSH,35,47,11,20,31
8,8476902,Esa Lindell,D,DAL,29,82,7,24,31
8,8480873,Rasmus Sandin,D,WSH,23,74,6,25,31
8,8475181,Nick Leddy,D,STL,32,82,4,27,31
8,8475753,Justin Faulk,D,STL,31,68,3,28,31
8,8474189,Lars Eller,C,PIT,34,82,18,12,30
8,8478042,Viktor Arvidsson,R,LAK,30,32,17,13,30
8,8476892,Colton Parayko,D,STL,30,82,12,18,30
8,8475149,Marcus Johansson,L,MIN,33,82,9,21,30
8,8476292,Ondrej Palat,L,NJD,32,71,9,21,30
8,8476885,Jacob Trouba,D,NYR,29,80,6,24,30
8,8477495,Seth Jones,D,CHI,29,67,4,26,30
8,8475314,Anders Lee,L,NYI,33,82,21,8,29
8,8477476,Artturi Lehkonen,L,COL,28,47,11,18,29
8,8475200,Dmitry Orlov,D,CAR,32,81,8,21,29
8,8476958,Jaccob Slavin,D,CAR,29,81,6,23,29
8,8474602,Justin Schultz,D,SEA,33,72,6,23,29
8,8476854,Hampus Lindholm,D,BOS,29,82,5,24,29
8,8473449,Kyle Okposo,R,BUF,35,79,18,10,28
8,8471698,T.J. Oshie,R,WSH,37,65,15,13,28
8,8478013,Jake Walman,D,DET,27,76,15,13,28
8,8481604,Pavel Dorofeyev,L,VGK,23,57,14,14,28
8,8470621,Corey Perry,R,EDM,38,54,12,16,28
8,8481533,Trevor Zegras,C,ANA,22,48,12,16,28
8,8476921,Jordan Martinook,L,CAR,31,81,11,17,28
8,8476474,Stefan Noesen,R,CAR,30,52,11,17,28
8,8480113,Alex Iafallo,L,WPG,30,81,10,18,28
8,8478115,Pierre Engvall,L,NYI,27,76,10,18,28
8,8475455,Brenden Dillon,D,WPG,33,78,9,19,28
8,8481577,Philip Tomasino,C,NSH,22,68,7,21,28
8,8479619,Michael Carcone,L,ARI,27,76,17,10,27
8,8476918,Jimmy Vesey,L,NYR,30,80,17,10,27
8,8479941,Justin Danforth,R,CBJ,30,81,14,13,27
8,8475714,Calle Jarnkrok,C,TOR,32,75,14,13,27
8,8474884,Mike Hoffman,C,SJS,34,79,13,14,27
8,8482705,Cole Sillinger,C,CBJ,20,76,13,14,27
8,8482720,Matthew Knies,L,TOR,21,80,11,16,27
8,8476312,Josh Manson,D,COL,32,77,9,18,27
8,8476897,Oskar Sundqvist,C,STL,29,82,8,19,27
8,8481546,Cam York,D,PHI,22,81,8,19,27
8,8477953,Kasperi Kapanen,R,STL,27,75,8,19,27
8,8482062,Cole Smith,L,NSH,28,81,7,20,27
8,8478178,Darren Raddysh,D,TBL,27,82,6,21,27
8,8482073,Braden Schneider,D,NYR,22,82,5,22,27
8,8480336,Sean Walker,D,PHI,29,81,5,22,27
8,8476879,Cody Ceci,D,EDM,30,82,4,23,27
8,8478508,Yakov Trenin,C,NSH,26,79,17,9,26
8,8482092,Ridly Greig,C,OTT,21,72,13,13,26
8,8478413,Jordan Greenway,L,BUF,26,70,12,14,26
8,8481580,Connor McMichael,C,WSH,22,80,11,15,26
8,8476463,Jonas Brodin,D,MIN,30,64,6,20,26
8,8474574,Tyler Myers,D,VAN,33,81,6,20,26
8,8482655,J.J. Moser,D,ARI,23,80,4,22,26
8,8482671,Owen Power,D,BUF,21,79,4,22,26
8,8479339,Patrik Laine,L,CBJ,25,47,15,10,25
8,8478136,Jake Middleton,D,MIN,27,82,10,15,25
8,8479351,Sam Steel,C,DAL,25,77,9,16,25
8,8475164,Jakob Silfverberg,R,ANA,33,81,9,16,25
8,8480145,Neal Pionk,D,WPG,28,81,7,18,25
8,8478109,Victor Olofsson,L,BUF,28,63,7,18,25
8,8471699,Andrew Cogliano,C,COL,36,76,7,18,25
8,8476422,Mike Reilly,D,NYI,30,61,6,19,25
8,8480078,Filip Chytil,C,NYR,24,38,6,19,25
8,8477932,Aaron Ekblad,D,FLA,27,64,4,21,25
8,8476457,Adam Larsson,D,SEA,31,82,4,21,25
8,8480246,Nick Perbix,D,TBL,25,80,3,22,25
8,8479983,Mario Ferraro,D,SJS,25,77,2,23,25
8,8481535,Nils Hoglander,L,VAN,23,53,17,7,24
8,8476981,Josh Anderson,R,MTL,29,78,15,9,24
8,8474870,Tyler Johnson,C,CHI,33,67,12,12,24
8,8480185,Eetu Luostarinen,C,FLA,25,82,12,12,24
8,8480802,Ryan McLeod,C,EDM,24,81,11,13,24
8,8474053,Logan Couture,C,SJS,34,34,10,14,24
8,8477444,Andre Burakovsky,L,SEA,28,51,10,14,24
8,8480855,Jack McBain,C,ARI,23,67,8,16,24
8,8478133,Jake Evans,C,MTL,27,82,8,16,24
8,8480835,Jack Drury,C,CAR,23,53,8,16,24
8,8470638,Patrice Bergeron,C,BOS,38,27,8,16,24
8,8478882,Vladislav Gavrikov,D,LAK,28,77,6,18,24
8,8477986,Brandon Montour,D,FLA,29,66,5,19,24
8,8477950,Tony DeAngelo,D,CAR,28,51,5,19,24
8,8474151,Ryan McDonagh,D,NSH,34,75,5,19,24
8,8478911,Matt Roy,D,LAK,28,81,4,20,24
8,8475197,Tyson Barrie,D,NSH,32,62,4,20,24
8,8480878,Nils Lundkvist,D,DAL,23,70,3,21,24
8,8474673,TJ Brodie,D,TOR,33,81,0,24,24
8,8477330,Dominik Kubalik,L,OTT,28,78,16,7,23
8,8481601,Simon Holmstrom,R,NYI,22,81,15,8,23
8,8475343,Nic Dowd,C,WSH,33,73,13,10,23
8,8479661,Tanner Jeannot,L,TBL,26,68,13,10,23
8,8475855,Jesper Fast,R,CAR,32,78,12,11,23
8,8482157,Will Cuylle,L,NYR,21,82,12,11,23
8,8479591,Michael Eyssimont,C,TBL,27,81,11,12,23
8,8475462,Radko Gudas,D,ANA,33,76,11,12,23
8,8481618,Alex Newhook,C,MTL,22,55,10,13,23
8,8482699,Dylan Guenther,R,ARI,20,45,10,13,23
8,8477508,Curtis Lazar,C,NJD,28,76,9,14,23
8,8480068,Ryan Poehling,C,PHI,24,76,9,14,23
8,8478851,Alexandre Carrier,D,NSH,27,77,6,17,23
8,8482222,Alexander Barabanov,L,SJS,29,61,5,18,23
8,8478840,Will Borgen,D,SEA,27,82,4,19,23
8,8473507,Jeff Petry,D,DET,36,73,4,19,23
8,8482087,Kaiden Guhle,D,MTL,21,78,4,19,23
8,8477947,Sonny Milano,L,WSH,27,53,13,9,22
8,8479293,Brandon Tanev,L,SEA,32,66,13,9,22
8,8476374,Sean Kuraly,C,CBJ,30,73,11,11,22
8,8479359,Beck Malenstyn,L,WSH,25,81,11,11,22
8,8481596,Shane Pinto,C,OTT,23,41,6,16,22
8,8480796,Martin Fehervary,D,WSH,24,76,3,19,22
8,8480043,Timothy Liljegren,D,TOR,24,65,3,19,22
8,8479316,Luke Kunin,C,SJS,26,76,15,6,21
8,8481704,Juuso Parssinen,C,NSH,22,71,13,8,21
8,8482097,Jack Quinn,R,BUF,22,45,12,9,21
8,8481554,Kaapo Kakko,R,NYR,22,61,11,10,21
8,8479977,Kailer Yamamoto,R,SEA,25,73,11,10,21
8,8477919,Frederick Gaudreau,C,MIN,30,70,5,16,21
8,8478443,Brandon Carlo,D,BOS,27,77,4,17,21
8,8478507,John Marino,D,NJD,26,81,4,17,21
8,8481656,Aliaksei Protas,C,WSH,22,52,4,17,21
8,8476331,Dylan DeMelo,D,WPG,30,81,2,19,21
8,8475690,Chris Tanev,D,CGY,34,79,2,19,21
8,8470600,Ryan Suter,D,DAL,38,82,2,19,21
8,8479353,Brett Howden,C,VGK,25,79,5,15,20
8,8475790,Erik Gudbranson,D,CBJ,31,77,3,17,20
8,8479980,Nicolas Hague,D,VGK,25,73,3,17,20
8,8479998,Mikey Anderson,D,LAK,24,82,1,19,20
8,8474161,Jakub Voracek,R,CBJ,34,29,1,19,20
8,8478399,Jonas Siegenthaler,D,NJD,26,66,1,19,20
8,8482101,Danil Gushchin,L,SJS,21,30,11,8,19
8,8475231,Casey Cizikas,C,NYI,32,71,10,9,19
8,8474166,Alec Martinez,D,VGK,36,64,7,12,19
8,8478458,Jack Roslovic,C,CBJ,26,58,6,13,19
8,8476923,Damon Severson,D,CBJ,29,66,6,13,19
8,8477506,Ryan Pulock,D,NYI,29,58,6,13,19
8,8477488,Brett Pesce,D,CAR,29,71,5,14,19
8,8475233,David Savard,D,MTL,33,60,4,15,19
8,8477839,Conor Sheary,L,TBL,31,64,4,15,19
8,8480049,Dylan Samberg,D,WPG,24,81,1,18,19
8,8480281,Alexey Toropchenko,R,STL,24,82,13,5,18
8,8473453,Trevor Lewis,C,LAK,36,82,11,7,18
8,8482111,Justin Barron,D,MTL,22,68,8,10,18
8,8474040,Sam Gagner,C,EDM,34,55,8,10,18
8,8479390,Taylor Raddysh,R,CHI,25,77,7,11,18
8,8477435,Ryan Graves,D,PIT,28,82,7,11,18
8,8476329,Travis Boyd,C,ARI,30,45,6,12,18
8,8473604,Jonathan Toews,C,CHI,35,27,6,12,18
8,8478463,Anthony Beauvillier,L,CHI,26,64,5,13,18
8,8480035,Henri Jokiharju,D,BUF,24,74,3,15,18
8,8481568,Alex Vlasic,D,CHI,22,76,3,15,18
8,8479976,Juuso Valimaki,D,ARI,25,68,2,16,18
8,8480001,Urho Vaakanainen,D,ANA,24,74,1,17,18
8,8477944,Jakub Vrana,L,STL,27,49,7,10,17
8,8480821,Filip Zadina,R,SJS,24,48,7,10,17
8,8475791,Taylor Hall,L,CHI,32,37,7,10,17
8,8482117,Lukas Reichel,L,CHI,21,77,5,12,17
8,8480762,Eric Robinson,L,BUF,28,54,4,13,17
8,8477507,Nikita Zadorov,D,VAN,28,75,3,14,17
8,8480220,Noah Cates,L,PHI,24,59,3,14,17
8,8475279,Ben Chiarot,D,DET,32,77,3,14,17
8,8475179,Dmitry Kulikov,D,FLA,33,78,1,16,17
8,8476822,Luke Glendening,C,TBL,34,82,13,3,16
8,8476469,Joel Armia,R,MTL,30,66,11,5,16
8,8478831,Kevin Stenlund,C,FLA,27,82,11,5,16
8,8479393,Noah Gregor,C,TOR,25,81,9,7,16
8,8480849,Barrett Hayton,C,ARI,23,50,8,8,16
8,8481481,Blake Lizotte,C,LAK,26,64,8,8,16
8,8475848,Brendan Gallagher,R,MTL,31,50,8,8,16
8,8476442,Matt Nieto,L,PIT,31,53,7,9,16
8,8481014,Alexander Romanov,D,NYI,23,81,6,10,16
8,8482660,Kent Johnson,C,CBJ,21,36,6,10,16
8,8476960,Andreas Athanasiou,C,CHI,29,38,5,11,16
8,8481523,Kirby Dach,C,MTL,22,29,5,11,16
8,8482142,Jamie Drysdale,D,PHI,21,49,5,11,16
8,8480172,Jan Rutta,D,SJS,33,75,4,12,16
8,8475208,Brian Dumoulin,D,SEA,32,80,4,12,16
8,8474034,Pat Maroon,L,MIN,35,49,4,12,16
8,8475825,Jani Hakanpää,D,DAL,31,82,2,14,16
8,8477365,Connor Clifton,D,BUF,28,79,0,16,16
8,8481606,Jordan Spence,D,LAK,22,44,0,16,16
8,8477987,Ryan Donato,C,CHI,27,51,6,9,15
8,8481178,Egor Zamula,D,PHI,23,44,5,10,15
8,8476525,Colin Miller,D,NJD,31,61,4,11,15
8,8474013,Ian Cole,D,VAN,34,80,3,12,15
8,8481605,Jackson LaCombe,D,ANA,22,76,1,14,15
8,8471274,Alex Goligoski,D,MIN,38,58,0,15,15
8,8479344,Jesse Puljujarvi,R,PIT,25,36,9,5,14
8,8470604,Jeff Carter,C,PIT,38,76,8,6,14
8,8479346,Dillon Dube,C,CGY,25,70,6,8,14
8,8477989,Christian Dvorak,C,MTL,27,52,5,9,14
8,8481522,Peyton Krebs,C,BUF,22,80,5,9,14
8,8474031,Kevin Shattenkirk,D,BOS,34,44,5,9,14
8,8478970,Jalen Chatfield,D,CAR,27,48,5,9,14
8,8477979,Nicolas Aube-Kubel,R,WSH,27,39,5,9,14
8,8478859,Niko Mikkola,D,FLA,27,82,4,10,14
8,8473504,Cal Clutterbuck,R,NYI,36,53,4,10,14
8,8477380,Jonny Brodzinski,C,NYR,30,35,4,10,14
8,8476449,Scott Harrington,D,ANA,30,28,4,10,14
8,8477845,Trevor van Riemsdyk,D,WSH,32,70,1,13,14
8,8480289,Morgan Barron,C,WPG,25,51,9,4,13
8,8473548,Phil Kessel,R,VGK,36,28,8,5,13
8,8476856,Matt Dumba,D,ARI,29,78,7,6,13
8,8480192,Johnathan Kovacevic,D,MTL,26,74,7,6,13
8,8477446,Michael McCarron,R,NSH,28,43,7,6,13
8,8482259,Bobby McMann,C,TOR,27,29,7,6,13
8,8480448,Parker Kelly,L,OTT,24,51,6,7,13
8,8476889,Radek Faksa,C,DAL,29,74,5,8,13
8,8471677,Jack Johnson,D,COL,36,80,4,9,13
8,8476473,Connor Murphy,D,CHI,30,70,4,9,13
8,8476467,Jamie Oleksiak,D,SEA,31,82,3,10,13
8,8479996,Cody Glass,C,NSH,24,54,3,10,13
8,8480994,Damien Giroux,C,MIN,23,28,2,11,13
8,8482192,Isaak Phillips,D,CHI,22,56,2,11,13
8,8474567,Zach Bogosian,D,MIN,33,70,1,12,13
8,8475718,Justin Holl,D,DET,31,63,1,12,13
8,8476988,Matt Benning,D,SJS,29,42,1,12,13
8,8480806,Isac Lundestrom,C,ANA,24,46,8,4,12
8,8479336,Carl Grundstrom,R,LAK,26,50,8,4,12
8,8470610,Zach Parise,L,COL,39,33,7,5,12
8,8481517,Brett Leason,R,ANA,24,43,6,6,12
8,8476858,Phillip Di Giuseppe,L,VAN,30,62,6,6,12
8,8475177,Calvin de Haan,D,TBL,32,72,6,6,12
8,8480748,Kiefer Sherwood,L,NSH,28,41,5,7,12
8,8480891,Michael Kesselring,D,ARI,23,36,4,8,12
8,8480073,Erik Brannstrom,D,OTT,24,45,3,9,12
8,8475906,John Klingberg,D,TOR,31,43,2,10,12
8,8481093,Rafael Harvey-Pinard,L,MTL,24,51,2,10,12
8,8477220,Nate Schmidt,D,WPG,32,75,2,10,12
8,8480887,Jordan Harris,D,MTL,23,58,2,10,12
8,8476874,Olli Maatta,D,DET,29,46,2,10,12
8,8478432,Christian Fischer,R,DET,26,51,2,10,12
8,8480884,Calen Addison,D,SJS,23,45,1,11,12
8,8475324,Nick Jensen,D,WSH,33,82,0,12,12
8,8480860,Kevin Bahl,D,NJD,23,81,0,12,12
8,8471303,Alexander Edler,D,LAK,37,30,0,12,12
8,8478569,Noel Acciari,C,PIT,32,70,8,3,11
8,8475225,Craig Smith,C,DAL,34,50,7,4,11
8,8480144,David Kampf,C,TOR,28,78,6,5,11
8,8477353,Tyler Motte,C,TBL,28,72,6,5,11
8,8478468,Jeremy Lauzon,D,NSH,26,82,6,5,11
8,8471669,Paul Stastny,C,CAR,38,28,6,5,11
8,8477931,Tomas Nosek,L,NJD,31,40,6,5,11
8,8480205,Emil Bemstrom,R,CBJ,24,31,5,6,11
8,8478585,Derek Ryan,C,EDM,37,51,5,6,11
8,8480879,Jacob Bernard-Docker,D,OTT,23,42,4,7,11
8,8480031,Max Comtois,L,ANA,24,28,4,7,11
8,8480913,Jordan Gross,D,NSH,28,27,3,8,11
8,8481567,Henry Thrun,D,SJS,22,51,3,8,11
8,8480848,Ty Dellandrea,C,DAL,23,53,2,9,11
8,8477406,Mattias Janmark,C,EDM,31,71,2,9,11
8,8479514,Rem Pitlick,C,CHI,26,36,2,9,11
8,8476624,Barclay Goodrow,C,NYR,30,80,1,10,11
8,8478416,Erik Cernak,D,TBL,26,71,1,10,11
8,8471276,David Krejci,C,BOS,37,27,1,10,11
8,8476917,Adam Pelech,D,NYI,29,58,0,11,11
8,8475842,Sam Carrick,C,ANA,31,54,7,3,10
8,8480980,Connor Dewar,C,MIN,24,48,7,3,10
8,8478421,A.J. Greer,L,CGY,27,47,6,4,10
8,8476871,Tanner Pearson,L,MTL,31,36,4,6,10
8,8478434,Keegan Kolesar,R,VGK,26,50,4,6,10
8,8474162,Jake Muzzin,D,TOR,34,29,3,7,10
8,8479414,Nathan Bastian,R,NJD,26,51,3,7,10
8,8479543,Michael Pezzetta,L,MTL,25,44,3,7,10
8,8474573,Josh Bailey,R,NYI,34,29,2,8,10
8,8480807,Mattias Samuelsson,D,BUF,23,69,2,8,10
8,8479324,Ryan Lindgren,D,NYR,25,80,2,8,10
8,8474009,Nick Bonino,C,NYR,35,73,2,8,10
8,8479371,Dante Fabbro,D,NSH,25,42,2,8,10
8,8482712,Oskar Olausson,R,COL,21,28,2,8,10
8,8476941,Connor Carrick,D,BOS,29,27,1,9,10
8,8482711,Stanislav Svozil,D,CBJ,20,29,1,9,10
8,8480883,Ty Smith,D,PIT,23,31,1,9,10
8,8476429,Scott Mayfield,D,NYI,31,67,1,9,10
8,8474716,Jared Spurgeon,D,MIN,34,44,0,10,10
8,8473544,Derick Brassard,C,OTT,36,31,7,2,9
8,8482679,Matt Coronato,R,CGY,21,42,6,3,9
8,8477903,Garnet Hathaway,R,PHI,32,81,6,3,9
8,8479718,Alex Barré-Boulet,C,TBL,26,35,6,3,9
8,8481013,Jonatan Berggren,R,DET,23,37,5,4,9
8,8478495,Denis Gurianov,R,NSH,26,40,5,4,9
8,8479322,Wade Allison,R,PHI,26,26,5,4,9
8,8479383,Boris Katchouk,L,CHI,25,35,5,4,9
8,8479328,Julien Gauthier,R,NYI,26,27,5,4,9
8,8470595,Eric Staal,C,FLA,39,27,5,4,9
8,8480072,Lias Andersson,C,LAK,25,30,5,4,9
8,8478131,Ondrej Kase,R,CAR,28,28,5,4,9
8,8479402,Jake Bean,D,CBJ,25,49,4,5,9
8,8474683,Derek Grant,C,ANA,33,28,4,5,9
8,8480727,Zach Whitecloud,D,VGK,27,65,3,6,9
8,8474612,Travis Hamonic,D,OTT,33,75,3,6,9
8,8475461,Andrew Agozzino,L,SJS,32,28,3,6,9
8,8477846,Ryan Carpenter,C,SJS,32,36,3,6,9
8,8480008,Adam Ruzicka,C,ARI,24,41,3,6,9
8,8478028,Fredrik Olofsson,L,COL,27,53,3,6,9
8,8474218,Jason Demers,D,EDM,35,31,3,6,9
8,8477015,Connor Brown,R,EDM,29,75,2,7,9
8,8479315,Joey Anderson,R,CHI,25,28,2,7,9
8,8473563,Nicklas Backstrom,C,WSH,36,37,1,8,9
8,8477335,Kyle Burroughs,D,SJS,28,74,1,8,9
8,8481527,Kaedan Korczak,D,VGK,22,26,1,8,9
8,8477018,Ben Hutton,D,VGK,30,31,1,8,9
8,8483460,David Jiricek,D,CBJ,20,36,1,8,9
8,8477034,Jaycob Megna,D,CHI,31,45,1,8,9
8,8476372,Nick Seeler,D,PHI,30,55,0,9,9
8,8480058,Pierre-Olivier Joseph,D,PIT,24,53,0,9,9
8,8481690,Tyler Angle,C,CBJ,23,29,7,1,8
8,8477941,Nick Ritchie,L,CGY,28,27,4,4,8
8,8480252,Cole Guttman,C,CHI,24,27,4,4,8
8,8479368,Max Jones,L,ANA,25,38,4,4,8
8,8481477,Nico Sturm,C,SJS,28,34,3,5,8
8,8477392,Hudson Fasching,R,NYI,28,35,3,5,8
8,8477070,Liam O'Brien,C,ARI,29,49,3,5,8
8,8476967,Brett Kulak,D,EDM,29,82,2,6,8
8,8482730,Brandt Clarke,D,LAK,20,38,2,6,8
8,8480995,Pontus Holmberg,R,TOR,24,27,2,6,8
8,8479576,Vincent Desharnais,D,EDM,27,49,1,7,8
8,8477971,Andreas Englund,D,LAK,27,52,1,7,8
8,8479439,Jacob MacDonald,D,SJS,30,21,6,1,7
8,8480328,David Gust,R,CHI,29,27,5,2,7
8,8471709,Marc-Edouard Vlasic,D,SJS,36,31,5,2,7
8,8477478,William Carrier,L,VGK,29,33,5,2,7
8,8477573,Nathan Walker,L,STL,29,18,5,2,7
8,8482241,Radim Zohorna,L,PIT,27,31,4,3,7
8,8478870,Rudolfs Balcers,L,TBL,26,26,3,4,7
8,8481058,Jesse Ylönen,R,MTL,24,43,3,4,7
8,8482081,Sean Farrell,C,MTL,22,27,3,4,7
8,8476915,Jujhar Khaira,L,MIN,29,29,3,4,7
8,8476393,Nick Cousins,C,FLA,30,70,2,5,7
8,8476891,Matt Grzelcyk,D,BOS,29,41,2,5,7
8,8479458,Nikita Zaitsev,D,CHI,32,26,2,5,7
8,8477541,Dakota Mermis,D,MIN,29,37,2,5,7
8,8478099,Kevin Labanc,R,SJS,28,32,2,5,7
8,8481641,Joel Kiviranta,L,COL,27,40,2,5,7
8,8480880,Jakub Lauko,C,BOS,23,40,2,5,7
8,8477499,Rasmus Ristolainen,D,PHI,29,57,1,6,7
8,8470966,Mark Giordano,D,TOR,40,36,1,6,7
8,8481537,Nikita Okhotiuk,D,SJS,23,38,1,6,7
8,8478502,Dennis Gilbert,D,CGY,27,31,1,6,7
8,8478104,Sammy Blais,L,STL,27,43,1,6,7
8,8475762,Derek Forbort,D,BOS,31,57,1,6,7
8,8480871,Adam Boqvist,D,CBJ,23,22,0,7,7
8,8477851,Jordan Oesterle,D,CGY,31,48,0,7,7
8,8483464,Marco Kasper,C,DET,19,28,6,0,6
8,8479291,Kevin Rooney,C,CGY,30,33,4,2,6
8,8479520,Brandon Duhaime,R,MIN,26,54,4,2,6
8,8479066,Ryan Lomberg,L,FLA,29,55,4,2,6
8,8477454,Adam Erne,L,EDM,28,54,3,3,6
8,8476278,Colin Blackwell,C,CHI,30,25,3,3,6
8,8479968,Vinni Lettieri,C,MIN,28,24,3,3,6
8,8483424,Owen Beck,C,MTL,19,27,3,3,6
8,8476441,Joel Edmundson,D,WSH,30,66,2,4,6
8,8479348,Kale Clague,D,BUF,25,28,2,4,6
8,8477369,Carson Soucy,D,VAN,29,21,2,4,6
8,8482496,Nils Aman,C,VAN,23,31,2,4,6
8,8480789,Oliver Wahlstrom,R,NYI,23,27,2,4,6
8,8471873,Anton Stralman,D,BOS,37,27,2,4,6
8,8481812,Nikolai Knyzhov,D,SJS,26,38,2,4,6
8,8480977,Semyon Der-Arguchintsev,C,TOR,23,29,2,4,6
8,8480222,Sebastian Aho,D,NYI,27,41,1,5,6
8,8474568,Luke Schenn,D,NSH,34,36,1,5,6
8,8479982,Conor Timmins,D,TOR,25,16,1,5,6
8,8476410,Josh Leivo,L,STL,30,28,0,6,6
8,8479369,Andrew Peeke,D,CBJ,25,20,0,6,6
8,8475797,Jarred Tinordi,D,CHI,31,32,0,6,6
8,8479372,Josh Mahura,D,FLA,25,20,0,6,6
8,8477930,Pierre-Edouard Bellemare,L,SEA,38,29,4,1,5
8,8481592,Jakob Pelletier,L,CGY,22,31,3,2,5
8,8480184,Gustav Lindström,D,ANA,25,22,3,2,5
8,8478408,Travis Dermott,D,ARI,27,37,2,3,5
8,8482964,Arber Xhekaj,D,MTL,22,24,2,3,5
8,8475750,Jon Merrill,D,MIN,31,38,2,3,5
8,8474618,Marco Scandella,D,STL,33,49,2,3,5
8,8480025,MacKenzie Entwistle,R,CHI,24,46,2,3,5
8,8479536,Axel Jonsson-Fjallby,L,WPG,25,26,2,3,5
8,8474207,Nick Holden,D,OTT,36,31,2,3,5
8,8481617,Vasily Podkolzin,R,VAN,22,26,2,3,5
8,8479442,Troy Stecher,D,ARI,29,71,1,4,5
8,8474090,Brendan Smith,D,NJD,34,36,1,4,5
8,8477384,Josh Brown,D,ARI,29,28,1,4,5
8,8481708,Zac Jones,D,NYR,23,17,1,4,5
8,8480084,Nick DeSimone,D,NJD,29,23,1,4,5
8,8479671,Mathieu Olivier,R,CBJ,26,25,1,4,5
8,8479547,Matthew Phillips,R,PIT,25,27,1,4,5
8,8476919,Chris Tierney,C,NJD,29,28,1,4,5
8,8476952,Dominic Toninato,C,WPG,29,15,1,4,5
8,8482652,Walker Duehr,R,CGY,26,26,1,4,5
8,8477359,Tucker Poolman,D,VAN,30,26,1,4,5
8,8482451,Mikael Pyyhtia,L,CBJ,22,29,0,5,5
8,8480950,Ilya Lyubushkin,D,ANA,29,79,0,5,5
8,8477482,Zach Sanford,L,CHI,29,26,0,5,5
8,8476878,Zemgus Girgensons,L,BUF,29,36,4,0,4
8,8482077,Dylan Holloway,L,EDM,22,23,3,1,4
8,8480011,Klim Kostin,C,DET,24,32,3,1,4
8,8482207,William Dufour,R,NYI,21,29,2,2,4
8,8479370,Tyson Jost,C,BUF,25,29,2,2,4
8,8481019,David Gustafsson,C,WPG,23,27,2,2,4
8,8479981,Jonah Gadjovich,L,FLA,25,27,2,2,4
8,8480275,Nick Swaney,R,MIN,26,28,2,2,4
8,8477938,Haydn Fleury,D,TBL,27,16,1,3,4
8,8480003,Jesper Boqvist,C,BOS,25,20,1,3,4
8,8479994,Jaret Anderson-Dolan,C,LAK,24,24,1,3,4
8,8475752,Tyler Pitlick,C,NYR,32,34,1,3,4
8,8476913,Devin Shore,C,SEA,29,21,1,3,4
8,8482181,Tristen Robins,C,SJS,22,28,1,3,4
8,8482176,Wyatt Kaiser,D,CHI,21,23,0,4,4
8,8478452,Caleb Jones,D,COL,26,20,0,4,4
8,8478454,Noah Juulsen,D,VAN,26,38,0,4,4
8,8478424,Jansen Harkins,C,PIT,26,34,0,4,4
8,8473446,Erik Johnson,D,BUF,35,46,3,0,3
8,8481754,Nikita Nesterenko,C,ANA,22,28,2,1,3
8,8479580,Dylan Gambrell,C,OTT,27,31,2,1,3
8,8481147,Reese Johnson,C,CHI,25,34,2,1,3
8,8478078,Rourke Chartier,C,OTT,27,34,2,1,3
8,8474709,Matt Martin,L,NYI,34,31,2,1,3
8,8479772,Zack MacEwen,R,OTT,27,22,2,1,3
8,8477962,Brendan Lemieux,L,CAR,27,23,2,1,3
8,8475766,Austin Watson,L,TBL,31,28,2,1,3
8,8480468,James Hamblin,L,EDM,24,31,2,1,3
8,8480355,Mark Kastelic,C,OTT,24,34,2,1,3
8,8480901,Karson Kuhlman,C,WPG,28,30,1,2,3
8,8482448,Samuel Knazko,D,CBJ,21,29,1,2,3
8,8480831,Alec Regula,D,CHI,23,27,1,2,3
8,8481122,Simon Benoit,D,TOR,25,39,1,2,3
8,8478451,Ethan Bear,D,WSH,26,16,1,2,3
8,8471686,Marc Staal,D,PHI,36,20,1,2,3
8,8477244,Chad Ruhwedel,D,PIT,33,37,1,2,3
8,8481541,Samuel Bolduc,D,NYI,23,33,1,2,3
8,8476934,Brock McGinn,L,ANA,29,24,1,2,3
8,8476994,Vinnie Hinostroza,C,PIT,29,14,1,2,3
8,8480007,Jonas Rondbjerg,R,VGK,24,17,1,2,3
8,8476867,Brendan Gaunce,C,CBJ,29,8,1,2,3
8,8478904,Steven Lorentz,C,FLA,27,28,1,2,3
8,8479379,Givani Smith,R,SJS,25,26,1,2,3
8,8482452,Elliot Desnoyers,L,PHI,21,26,1,2,3
8,8482516,Matthew Kessel,D,STL,23,47,0,3,3
8,8478450,Parker Wotherspoon,D,BOS,26,23,0,3,3
8,8477810,Joel Hanley,D,DAL,32,26,0,3,3
8,8480853,Liam Foudy,C,NSH,23,13,0,3,3
8,8475235,Nicolas Deslauriers,L,PHI,32,47,0,3,3
8,8480776,Sheldon Rempal,R,VGK,28,5,2,0,2
8,8471817,Ryan Reaves,R,TOR,36,27,2,0,2
8,8477073,Kurtis MacDermid,D,COL,29,28,2,0,2
8,8480242,Arnaud Durandeau,L,NYI,24,29,2,0,2
8,8483641,Anton Levtchi,L,FLA,28,27,1,1,2
8,8482133,Thomas Bordeleau,C,SJS,21,6,1,1,2
8,8481006,Tyler Tucker,D,STL,23,16,1,1,2
8,8479362,Riley Tufte,L,COL,25,5,1,1,2
8,8478051,Max Willman,C,NJD,28,13,1,1,2
8,8481532,Alex Turcotte,C,LAK,22,6,1,1,2
8,8480041,Dmitri Samorukov,D,STL,24,28,1,1,2
8,8480874,Adam Ginning,D,PHI,23,26,0,2,2
8,8480070,Ian Mitchell,D,BOS,24,13,0,2,2
8,8480196,Jacob Bryson,D,BUF,26,8,0,2,2
8,8480870,Bo Groulx,C,ANA,23,32,0,2,2
8,8473473,Milan Lucic,L,BOS,35,4,0,2,2
8,8477464,Nic Petan,C,MIN,28,6,0,2,2
8,8477527,Ross Johnston,L,ANA,29,41,0,2,2
8,8481043,Cole Koepke,L,TBL,25,8,0,2,2
8,8481167,Brayden Pachal,D,CGY,24,50,1,0,1
8,8481056,Spencer Stastney,D,NSH,23,9,1,0,1
8,8480823,Alexander Alexeyev,D,WSH,24,13,1,0,1
8,8476873,Mark Jankowski,C,NSH,29,5,1,0,1
8,8480021,Jack Studnicka,C,SJS,24,14,1,0,1
8,8478409,Anthony Richard,C,BOS,27,4,1,0,1
8,8483570,Ben Meyers,C,COL,25,9,1,0,1
8,8481422,Jacob Lucchini,C,MIN,28,13,1,0,1
8,8479546,Oskar Steen,C,BOS,25,34,1,0,1
8,8481239,Samuel Fagemo,L,LAK,23,8,1,0,1
8,8476310,Lukas Sedlak,C,PHI,30,26,0,1,1
8,8475780,Chris Wagner,R,BOS,32,27,0,1,1
8,8482762,Simon Edvinsson,D,DET,20,2,0,1,1
8,8481161,Jake Christiansen,D,CBJ,24,3,0,1,1
8,8480157,Calle Rosen,D,STL,29,5,0,1,1
8,8479984,Cal Foote,D,NJD,25,4,0,1,1
8,8479321,Lucas Johansen,D,WSH,26,6,0,1,1
8,8479378,Logan Stanley,D,WPG,25,10,0,1,1
8,8478017,Mark Friedman,D,VAN,28,20,0,1,1
8,8482095,Tyler Kleven,D,OTT,21,5,0,1,1
8,8479320,Max Lajoie,D,TOR,26,5,0,1,1
8,8477887,Patrick Brown,C,BOS,31,11,0,1,1
8,8480245,Olle Lycksell,R,PHI,24,5,0,1,1
8,8478146,Matthew Highmore,C,OTT,27,6,0,1,1
8,8480845,Rasmus Kupari,C,WPG,23,21,0,1,1
8,8478512,Austin Czarnik,C,DET,31,18,0,1,1
8,8479367,William Lockwood,R,FLA,25,23,0,1,1
8,8481543,Nikita Alexandrov,C,STL,23,18,0,1,1
8,8483597,Milos Kelemen,L,ARI,24,10,0,1,1
8,8475747,Patrik Nemeth,D,ARI,31,29,0,0,0
8,8483565,Nick Blankenburg,D,CBJ,25,6,0,0,0
8,8483620,Marcus Bjork,D,CBJ,26,0,0,0,0
8,8481521,Ronnie Attard,D,PHI,24,0,0,0,0
8,8482399,Billy Sweezey,D,CBJ,27,0,0,0,0
8,8481072,Tim Berni,D,CBJ,23,0,0,0,0
8,8476884,Derrick Pouliot,D,SJS,29,0,0,0,0
8,8482624,Daniil Miromanov,D,VGK,26,2,0,0,0
8,8482861,Vincent Iorio,D,WSH,21,0,0,0,0
8,8478465,Guillaume Brisebois,D,VAN,26,0,0,0,0
8,8484256,Jake Livingstone,D,NSH,24,0,0,0,0
8,8481599,Victor Soderstrom,D,ARI,22,1,0,0,0
8,8474027,Justin Braun,D,PHI,36,0,0,0,0
8,8478062,Dysin Mayo,D,ARI,27,0,0,0,0
8,8481563,Drew Helleson,D,ANA,22,0,0,0,0
8,8481575,Lassi Thomson,D,OTT,23,0,0,0,0
8,8483619,Filip Roos,D,CHI,24,4,0,0,0
8,8481461,Corey Schueneman,D,MTL,28,0,0,0,0
8,8478846,Christian Wolanin,D,VAN,28,0,0,0,0
8,8479395,Dennis Cholowski,D,NYI,25,0,0,0,0
8,8479945,Gavin Bayreuther,D,CBJ,29,0,0,0,0
8,8474818,Jordie Benn,D,TOR,36,0,0,0,0
8,8479421,Jacob Moverare,D,LAK,25,5,0,0,0
8,8479329,Frederic Allard,D,MTL,26,0,0,0,0
8,8481600,Tobias Bjornfot,D,VGK,22,3,0,0,0
8,8477462,Robert Hagg,D,ANA,28,5,0,0,0
8,8476470,Nathan Beaulieu,D,ANA,31,0,0,0,0
8,8484254,Akito Hirose,D,VAN,24,3,0,0,0
8,8479388,Riley Stillman,D,BUF,25,0,0,0,0
8,8482824,Nick Cicek,D,SJS,23,0,0,0,0
8,8480056,Jack Rathbone,D,VAN,24,0,0,0,0
8,8476850,Ryan Murray,D,EDM,30,0,0,0,0
8,8478841,Colton White,D,ANA,26,0,0,0,0
8,8480160,Radim Simek,D,SJS,31,0,0,0,0
8,8478491,Jacob Larsson,D,OTT,26,0,0,0,0
8,8475857,Kevin Gravel,D,NSH,31,0,0,0,0
8,8482067,Connor Mackey,D,NYR,27,1,0,0,0
8,8477433,Ben Harpur,D,NYR,28,0,0,0,0
8,8481572,Ville Heinola,D,WPG,22,0,0,0,0
8,8478415,Jakub Zboril,D,BOS,26,0,0,0,0
8,8477341,Andreas Johnsson,L,SJS,29,0,0,0,0
8,8480216,Jacob Peterson,C,SJS,24,6,0,0,0
8,8477467,Gustav Olofsson,D,SEA,29,0,0,0,0
8,8478476,Kyle Capobianco,D,WPG,26,0,0,0,0
8,8479985,Cale Fleury,D,SEA,25,0,0,0,0
8,8475227,Chris Wideman,D,MTL,33,0,0,0,0
8,8479333,Libor Hajek,D,NYR,25,0,0,0,0
8,8479376,Victor Mete,D,PHI,25,1,0,0,0
8,8480439,Mac Hollowell,D,TOR,25,0,0,0,0
8,8480467,Austin Strand,D,ANA,26,0,0,0,0
8,8477981,Roland McKeown,D,NSH,27,0,0,0,0
8,8474628,Michael Stone,D,CGY,33,0,0,0,0
8,8480034,Joel Teasdale,L,MTL,24,0,0,0,0
8,8481609,Vladislav Kolyachonok,D,ARI,22,1,0,0,0
8,8479602,Jeremy Davies,D,BUF,27,0,0,0,0
8,8479639,Dylan Coghlan,D,CAR,25,0,0,0,0
8,8478506,Gabriel Carlsson,D,WSH,26,0,0,0,0
8,8477463,Steven Santini,D,STL,28,0,0,0,0
8,8478075,Anders Bjork,L,CHI,27,0,0,0,0
8,8484287,Cole McWard,D,VAN,22,1,0,0,0
8,8474145,Robert Bortuzzo,D,NYI,34,15,0,0,0
8,8475625,Matt Irwin,D,WSH,36,0,0,0,0
8,8482179,Justin Richards,C,CBJ,25,0,0,0,0
8,8481649,Joona Luoto,L,CBJ,26,0,0,0,0
8,8479026,Philippe Myers,D,TBL,26,5,0,0,0
8,8480935,Lawrence Pilut,D,BUF,28,0,0,0,0
8,8479578,Casey Fitzgerald,D,FLA,26,0,0,0,0
8,8480071,Robin Salo,D,NYI,25,0,0,0,0
8,8478224,Luke Philp,C,CHI,28,0,0,0,0
8,8484125,Hunter McKown,C,CBJ,21,0,0,0,0
8,8481679,Maxence Guenette,D,OTT,22,1,0,0,0
8,8479423,Alex Nylander,L,PIT,25,5,0,0,0
8,8480441,Trey Fix-Wolansky,R,CBJ,24,1,0,0,0
8,8480820,Filip Kral,D,TOR,24,0,0,0,0
8,8479523,Lucas Carlsson,D,FLA,26,0,0,0,0
8,8479304,Kyle Criscuolo,C,SJS,31,0,0,0,0
8,8474697,Mark Borowiecki,D,NSH,34,0,0,0,0
8,8480842,Filip Hallander,C,PIT,23,0,0,0,0
8,8481725,Elmer Soderblom,L,DET,22,0,0,0,0
8,8479252,Dan Renouf,D,BOS,29,0,0,0,0
8,8481591,Sam Poulin,R,PIT,22,0,0,0,0
8,8475968,Alex Belzile,R,MTL,32,0,0,0,0
8,8475772,Riley Sheahan,C,BUF,32,0,0,0,0
8,8475163,Alex Chiasson,R,DET,33,0,0,0,0
8,8481598,Philip Broberg,D,EDM,22,10,0,0,0
8,8478455,Austin Wagner,L,CHI,26,0,0,0,0
8,8476779,Brad Hunt,D,COL,35,0,0,0,0
8,8479335,Rasmus Asplund,C,NSH,26,0,0,0,0
8,8478967,Lane Pederson,C,CBJ,26,0,0,0,0
8,8481077,John Leonard,L,NSH,25,0,0,0,0
8,8481585,Egor Afanasyev,L,NSH,22,2,0,0,0
8,8483397,Marc McLaughlin,C,BOS,24,0,0,0,0
8,8480443,Kristian Reichel,C,WPG,25,0,0,0,0
8,8481751,Lukas Rousek,R,BUF,24,5,0,0,0
8,8476396,Steven Fogarty,C,MIN,30,0,0,0,0
8,8478881,Brett Seney,L,CHI,27,4,0,0,0
8,8480326,Sheldon Dries,C,VAN,29,0,0,0,0
8,8481433,Taro Hirose,L,DET,27,0,0,0,0
8,8480833,Vitali Kravtsov,R,VAN,24,0,0,0,0
8,8481550,Adam Beckman,L,MIN,22,0,0,0,0
8,8479972,Mason Shaw,C,MIN,25,0,0,0,0
8,8477460,Laurent Dauphin,C,ARI,28,0,0,0,0
8,8476166,Taylor Fedun,D,PIT,35,0,0,0,0
8,8478067,Oskar Lindblom,L,SJS,27,1,0,0,0
8,8479944,Zach Aston-Reese,C,DET,29,1,0,0,0
8,8479465,Drake Caggiula,L,PIT,29,0,0,0,0
8,8481740,Tyce Thompson,R,NJD,24,0,0,0,0
8,8476948,Charles Hudon,L,COL,29,0,0,0,0
8,8480863,Gabriel Fortier,L,TBL,23,0,0,0,0
8,8471887,Patric Hornqvist,R,FLA,36,0,0,0,0
8,8477471,Dillon Heatherington,D,OTT,28,0,0,0,0
8,8481441,Joe Snively,C,WSH,27,3,0,0,0
8,8478173,Hayden Hodgson,R,PHI,27,0,0,0,0
8,8481720,Nick Abruzzese,C,TOR,24,0,0,0,0
8,8478843,Denis Malgin,C,COL,26,0,0,0,0
8,8483630,Pavol Regenda,L,ANA,24,0,0,0,0
8,8478373,Nikita Soshnikov,R,NYI,30,0,0,0,0
8,8482147,Jean-Luc Foudy,C,COL,21,0,0,0,0
8,8478431,Evgeny Svechnikov,L,SJS,27,0,0,0,0
8,8477210,Buddy Robinson,R,CHI,32,0,0,0,0
8,8479404,Henrik Borgstrom,C,WSH,26,0,0,0,0
8,8481712,Matej Blumel,R,DAL,23,0,0,0,0
8,8475278,Byron Froese,C,VGK,32,7,0,0,0
8,8479338,Markus Niemelainen,D,EDM,25,0,0,0,0
8,8471794,Darren Helm,C,COL,36,0,0,0,0
8,8482623,Josh Dunne,C,CBJ,25,0,0,0,0
8,8482641,Matt Kiersted,D,FLA,25,0,0,0,0
8,8476851,Alex Galchenyuk,C,COL,29,0,0,0,0
8,8479366,Logan Brown,C,STL,25,0,0,0,0
8,8480822,Martin Kaut,R,SJS,24,0,0,0,0
8,8482834,Jesper Froden,R,SEA,29,0,0,0,0
8,8480844,Grigori Denisenko,L,VGK,23,3,0,0,0
8,8482635,Mike Hardman,L,CHI,24,0,0,0,0
8,8477357,Saku Maenalanen,R,WPG,29,0,0,0,0
8,8480979,Nathan Smith,C,ARI,25,0,0,0,0
8,8479356,Kieffer Bellows,L,PHI,25,0,0,0,0
8,8475795,Dylan McIlrath,D,WSH,31,1,0,0,0
8,8478400,Colin White,C,PIT,26,9,0,0,0
8,8478446,Glenn Gawdin,C,ANA,26,0,0,0,0
8,8476326,Josh Archibald,R,PIT,31,0,0,0,0
8,8481683,Aidan McDonough,L,VAN,24,0,0,0,0
8,8480267,Sammy Walker,C,MIN,24,4,0,0,0
8,8477520,Jean-Sebastien Dea,C,ARI,29,0,0,0,0
8,8476439,Brett Ritchie,R,ARI,30,0,0,0,0
8,8479518,Fredrik Karlström,C,DAL,25,0,0,0,0
8,8477126,Jayson Megna,C,ANA,33,0,0,0,0
8,8479644,Matt Luff,R,DET,26,0,0,0,0
8,8478211,Dryden Hunt,L,CGY,28,5,0,0,0
8,8480226,Marián Studenic,R,SEA,25,2,0,0,0
8,8480037,Aleksi Heponiemi,C,FLA,24,0,0,0,0
8,8480292,Carson Meyer,R,CBJ,26,0,0,0,0
8,8482634,Alex Steeves,C,TOR,24,1,0,0,0
8,8475178,Zack Kassian,R,ARI,32,0,0,0,0
8,8483524,Shane Wright,C,SEA,19,3,0,0,0
8,8482654,Jackson Cates,C,PHI,26,0,0,0,0
8,8479550,Tanner Laczynski,C,PHI,26,0,0,0,0
8,8479991,Jake Leschyshyn,C,NYR,24,1,0,0,0
8,8474613,Derek Stepan,C,CAR,33,0,0,0,0
8,8478367,Cole Bardreau,C,NYI,30,0,0,0,0
8,8480890,Jan Jenik,R,ARI,23,1,0,0,0
8,8475160,Kyle Clifford,L,TOR,32,0,0,0,0
8,8479705,Jeffrey Viel,L,SJS,26,0,0,0,0
8,8477401,John Hayden,C,SEA,28,2,0,0,0
8,8480846,Sampo Ranta,L,COL,23,0,0,0,0
8,8482691,Aatu Raty,C,VAN,21,0,0,0,0
8,8481070,Hugh McGing,L,STL,25,5,0,0,0
8,8479573,Mikhail Maltsev,L,COL,25,0,0,0,0
8,8482250,Callahan Burke,C,CAR,26,1,0,0,0
8,8481102,Egor Sokolov,L,OTT,23,0,0,0,0
8,8481518,Nolan Foote,L,NJD,23,0,0,0,0
8,8474190,Wayne Simmonds,R,TOR,35,0,0,0,0
8,8474610,Zac Dalpe,C,FLA,34,0,0,0,0
8,8479347,Tyler Benson,L,EDM,25,0,0,0,0
8,8476404,Andy Andreoff,C,NYI,32,0,0,0,0
8,8476390,Joseph Cramarossa,C,MIN,31,0,0,0,0
8,8483549,Lucas Condotta,L,MTL,26,3,0,0,0
8,8482197,Adam Raska,R,MIN,22,5,0,0,0
8,8479533,Joona Koppanen,L,PIT,25,3,0,0,0
8,8479526,Otto Koivula,L,NYI,25,0,0,0,0
8,8479375,William Bitten,C,STL,25,0,0,0,0
8,8474089,Brad Malone,C,EDM,34,0,0,0,0
8,8478058,CJ Suess,L,SJS,29,0,0,0,0
8,8478147,Bokondji Imama,L,ARI,27,0,0,0,0
8,8477320,Anton Blidh,L,NYR,28,1,0,0,0
8,8477993,Justin Kirkland,C,ARI,27,2,0,0,0
8,8480836,Jonathan Gruden,C,PIT,23,5,0,0,0
8,8480032,Shane Bowers,C,NJD,24,3,0,0,0
9,8477492,Nathan MacKinnon,C,COL,28,82,46,91,137
9,8478402,Connor McDavid,C,EDM,26,80,35,93,128
9,8476453,Nikita Kucherov,R,TBL,30,81,45,78,123
9,8477956,David Pastrnak,R,BOS,27,82,48,62,110
9,8478550,Artemi Panarin,L,NYR,32,82,47,63,110
9,8480012,Elias Pettersson,C,VAN,25,81,40,67,107
9,8479318,Auston Matthews,C,TOR,26,81,70,33,103
9,8477934,Leon Draisaitl,C,EDM,28,82,42,61,103
9,8480800,Quinn Hughes,D,VAN,24,81,20,83,103
9,8477939,William Nylander,R,TOR,27,82,40,62,102
9,8477933,Sam Reinhart,C,FLA,28,82,60,40,100
9,8479314,Matthew Tkachuk,L,FLA,26,82,32,68,100
9,8478420,Mikko Rantanen,R,COL,27,82,42,57,99
9,8476468,J.T. Miller,C,VAN,30,81,32,64,96
9,8478483,Mitchell Marner,R,TOR,26,81,31,61,92
9,8479407,Jesper Bratt,L,NJD,25,81,30,62,92
9,8478444,Brock Boeser,R,VAN,26,81,51,40,91
9,8478427,Sebastian Aho,C,CAR,26,78,30,61,91
9,8480069,Cale Makar,D,COL,25,77,22,67,89
9,8477409,Carter Verhaeghe,C,FLA,28,82,45,39,84
9,8479542,Brandon Hagel,L,TBL,25,82,37,47,84
9,8476454,Ryan Nugent-Hopkins,C,EDM,30,82,25,59,84
9,8478010,Brayden Point,C,TBL,27,82,41,41,82
9,8478445,Mathew Barzal,C,NYI,26,81,25,57,82
9,8475786,Zach Hyman,L,EDM,31,81,51,30,81
9,8473419,Brad Marchand,L,BOS,35,82,35,46,81
9,8475168,Matt Duchene,C,DAL,32,81,33,48,81
9,8477404,Jake Guentzel,L,PIT,29,81,32,49,81
9,8471675,Sidney Crosby,C,PIT,36,82,40,40,80
9,8478439,Travis Konecny,R,PHI,26,81,40,40,80
9,8480023,Robert Thomas,C,STL,24,82,21,59,80
9,8475184,Chris Kreider,L,NYR,32,82,42,37,79
9,8476887,Filip Forsberg,L,NSH,29,82,36,43,79
9,8478864,Kirill Kaprizov,L,MIN,26,75,27,52,79
9,8480803,Evan Bouchard,D,EDM,24,82,24,55,79
9,8480865,Noah Dobson,D,NYI,23,82,14,65,79
9,8475167,Victor Hedman,D,TBL,33,80,13,66,79
9,8474564,Steven Stamkos,C,TBL,33,79,38,40,78
9,8478449,Roope Hintz,C,DAL,27,80,36,42,78
9,8480027,Jason Robertson,L,DAL,24,82,27,51,78
9,8477493,Aleksander Barkov,C,FLA,28,76,17,61,78
9,8473512,Claude Giroux,R,OTT,35,82,26,51,77
9,8474600,Roman Josi,D,NSH,33,82,16,61,77
9,8475794,Tyler Seguin,C,DAL,31,82,32,44,76
9,8478403,Jack Eichel,C,VGK,27,70,28,48,76
9,8477942,Kevin Fiala,L,LAK,27,82,26,50,76
9,8481559,Jack Hughes,C,NJD,22,65,25,51,76
9,8475913,Mark Stone,R,VGK,31,81,22,54,76
9,8477500,Bo Horvat,C,NYI,28,81,33,41,74
9,8480018,Nick Suzuki,C,MTL,24,82,32,41,73
9,8476389,Vincent Trocheck,C,NYR,30,82,25,48,73
9,8477946,Dylan Larkin,C,DET,27,76,33,37,70
9,8471215,Evgeni Malkin,C,PIT,37,82,25,45,70
9,8476539,Jonathan Marchessault,R,VGK,33,81,40,29,69
9,8478493,Joel Eriksson Ek,C,MIN,26,82,38,31,69
9,8477960,Adrian Kempe,R,LAK,27,82,27,41,68
9,8470794,Joe Pavelski,C,DAL,39,82,27,41,68
9,8477416,Oliver Bjorkstrand,R,SEA,28,82,27,41,68
9,8482116,Tim Stützle,C,OTT,21,82,16,52,68
9,8480801,Brady Tkachuk,L,OTT,24,82,43,24,67
9,8477402,Pavel Buchnevich,L,STL,28,80,32,35,67
9,8471685,Anze Kopitar,C,LAK,36,82,24,43,67
9,8476459,Mika Zibanejad,C,NYR,30,81,23,44,67
9,8477501,Valeri Nichushkin,R,COL,28,67,32,34,66
9,8479337,Alex DeBrincat,R,DET,26,82,27,39,66
9,8479343,Clayton Keller,R,ARI,25,82,22,43,65
9,8480839,Rasmus Dahlin,D,BUF,23,81,20,44,64
9,8478407,Vince Dunn,D,SEA,27,78,14,50,64
9,8476853,Morgan Rielly,D,TOR,29,79,11,53,64
9,8478398,Kyle Connor,L,WPG,27,65,35,28,63
9,8475169,Evander Kane,L,EDM,32,81,34,29,63
9,8475745,Charlie Coyle,C,BOS,31,82,22,41,63
9,8479999,Casey Mittelstadt,C,BUF,25,82,21,42,63
9,8479425,Filip Hronek,D,VAN,26,81,10,53,63
9,8480015,Owen Tippett,R,PHI,24,77,33,29,62
9,8481540,Cole Caufield,R,MTL,22,82,24,38,62
9,8476460,Mark Scheifele,C,WPG,30,75,20,42,62
9,8479323,Adam Fox,D,NYR,25,72,13,49,62
9,8479385,Jordan Kyrou,C,STL,25,82,29,32,61
9,8475158,Ryan O'Reilly,C,NSH,32,82,28,33,61
9,8480039,Martin Necas,C,CAR,24,76,28,33,61
9,8476448,William Karlsson,C,VGK,30,69,26,35,61
9,8475692,Mats Zuccarello,R,MIN,36,73,17,44,61
9,8476875,Mike Matheson,D,MTL,29,82,11,50,61
9,8477955,Jared McCann,L,SEA,27,81,32,28,60
9,8475172,Nazem Kadri,C,CGY,33,82,26,34,60
9,8475166,John Tavares,C,TOR,33,80,26,34,60
9,8475765,Vladimir Tarasenko,R,OTT,32,80,25,35,60
9,8480797,Joel Farabee,L,PHI,23,81,24,36,60
9,8478873,Troy Terry,R,ANA,26,79,23,37,60
9,8474578,Erik Karlsson,D,PIT,33,82,13,47,60
9,8481557,Matt Boldy,L,MIN,22,75,32,27,59
9,8478975,Mason Marchment,L,DAL,28,81,25,34,59
9,8477949,Alex Tuch,R,BUF,27,75,24,35,59
9,8471214,Alex Ovechkin,L,WSH,38,79,20,39,59
9,8478366,Frank Vatrano,R,ANA,29,82,32,26,58
9,8476881,Tomas Hertl,C,SJS,30,76,24,34,58
9,8482124,Quinton Byfield,R,LAK,21,80,23,35,58
9,8482078,Lucas Raymond,L,DET,21,82,18,40,58
9,8482093,Seth Jarvis,C,CAR,21,81,22,35,57
9,8477940,Nikolaj Ehlers,L,WPG,27,81,22,35,57
9,8477497,Sean Monahan,C,WPG,29,83,18,39,57
9,8478542,Evan Rodrigues,C,FLA,30,82,13,44,57
9,8475754,Brock Nelson,C,NYI,32,82,32,24,56
9,8475810,Bryan Rust,R,PIT,31,69,29,27,56
9,8476399,Blake Coleman,C,CGY,32,82,27,29,56
9,8480002,Nico Hischier,C,NJD,24,70,26,30,56
9,8479325,Charlie McAvoy,D,BOS,26,74,13,43,56
9,8477504,Josh Morrissey,D,WPG,28,81,11,45,56
9,8475784,Jeff Skinner,L,BUF,31,74,27,28,55
9,8477496,Elias Lindholm,C,VAN,29,81,17,38,55
9,8476456,Jonathan Huberdeau,C,CGY,30,81,14,41,55
9,8476346,Johnny Gaudreau,L,CBJ,30,81,10,45,55
9,8475798,Mikael Granlund,C,SJS,31,68,9,46,55
9,8479675,Trevor Moore,L,LAK,28,82,27,27,54
9,8482740,Wyatt Johnston,C,DAL,20,82,23,31,54
9,8480208,Drake Batherson,R,OTT,25,82,21,33,54
9,8478047,Michael Bunting,L,CAR,28,80,20,34,54
9,8474679,Gustav Nyquist,C,NSH,34,82,14,40,54
9,8478440,Dylan Strome,C,WSH,26,82,27,26,53
9,8474641,Adam Henrique,C,ANA,33,81,27,26,53
9,8480830,Andrei Svechnikov,R,CAR,23,60,24,29,53
9,8476905,Chandler Stephenson,C,VGK,29,77,21,31,52
9,8471724,Kris Letang,D,PIT,36,82,8,44,52
9,8473994,Jamie Benn,L,DAL,34,82,18,33,51
9,8480036,Miro Heiskanen,D,DAL,24,72,9,42,51
9,8479420,Tage Thompson,C,BUF,26,72,25,25,50
9,8476882,Teuvo Teravainen,L,CAR,29,81,21,29,50
9,8474563,Drew Doughty,D,LAK,34,82,20,30,50
9,8476906,Shayne Gostisbehere,D,DET,30,81,10,40,50
9,8478474,Lawson Crouse,L,ARI,26,81,28,21,49
9,8482175,JJ Peterka,R,BUF,21,82,25,24,49
9,8482665,Matty Beniers,C,SEA,21,77,19,30,49
9,8476872,Scott Laughton,C,PHI,29,81,15,34,49
9,8482109,Alexis Lafrenière,L,NYR,22,82,24,24,48
9,8474102,David Perron,L,DET,35,76,22,26,48
9,8482745,Mason McTavish,C,ANA,20,74,21,27,48
9,8478462,Nicolas Roy,C,VGK,26,72,18,30,48
9,8478519,Anthony Cirelli,C,TBL,26,81,16,32,48
9,8474141,Patrick Kane,R,DET,35,51,15,33,48
9,8477494,Jonathan Drouin,L,COL,28,80,13,35,48
9,8475726,Tyler Toffoli,R,NJD,31,80,30,17,47
9,8475151,Kyle Palmieri,C,NYI,32,82,22,25,47
9,8477951,Nick Schmaltz,C,ARI,27,79,21,26,47
9,8478401,Pavel Zacha,C,BOS,26,78,16,31,47
9,8474037,James van Riemsdyk,L,BOS,34,78,12,35,47
9,8481068,Yegor Sharangovich,C,CGY,25,82,24,22,46
9,8475170,Brayden Schenn,C,STL,32,82,19,27,46
9,8482122,Brock Faber,D,MIN,21,82,6,40,46
9,8479365,Trent Frederic,C,BOS,25,82,23,22,45
9,8474586,Jordan Eberle,R,SEA,33,78,18,27,45
9,8477456,J.T. Compher,L,DET,28,77,16,29,45
9,8470613,Brent Burns,D,CAR,38,81,12,33,45
9,8480798,Philipp Kurashev,C,CHI,24,75,10,35,45
9,8475799,Nino Niederreiter,R,WPG,31,81,25,19,44
9,8478856,Conor Garland,R,VAN,27,81,16,28,44
9,8478233,Andrew Mangiapane,L,CGY,27,81,14,30,44
9,8478397,Rasmus Andersson,D,CGY,27,78,13,31,44
9,8477964,Ivan Barbashev,C,VGK,28,81,22,21,43
9,8477935,Sam Bennett,C,FLA,27,70,20,23,43
9,8477346,MacKenzie Weegar,D,CGY,29,82,20,23,43
9,8483515,Juraj Slafkovsky,L,MTL,19,82,18,25,43
9,8479400,Pierre-Luc Dubois,C,LAK,25,82,16,27,43
9,8480009,Eeli Tolvanen,R,SEA,24,82,15,28,43
9,8476458,Ryan Strome,C,ANA,30,79,15,28,43
9,8481581,Thomas Harley,D,DAL,22,79,15,28,43
9,8481528,Dylan Cozens,C,BUF,22,79,14,29,43
9,8482105,Jake Sanderson,D,OTT,21,79,13,30,43
9,8473986,Alex Killorn,L,ANA,34,63,13,30,43
9,8482684,Luke Hughes,D,NJD,20,81,10,33,43
9,8478498,Jake DeBrusk,L,BOS,27,80,25,17,42
9,8482079,Marco Rossi,C,MIN,22,82,20,22,42
9,8477426,Nicholas Paul,L,TBL,28,82,20,22,42
9,8475149,Marcus Johansson,L,MIN,33,82,18,24,42
9,8477503,Max Domi,C,TOR,28,82,14,28,42
9,8480028,Morgan Frost,C,PHI,24,70,14,28,42
9,8478396,Noah Hanifin,D,CGY,26,82,11,31,42
9,8476979,Erik Gustafsson,D,NYR,31,81,8,34,42
9,8477511,Anthony Mantha,R,WSH,29,78,22,19,41
9,8478057,Dakota Joshua,C,VAN,27,79,21,20,41
9,8476925,Colton Sissons,C,NSH,30,82,20,21,41
9,8477998,Warren Foegele,L,EDM,27,82,16,25,41
9,8478472,Mathieu Joseph,R,OTT,26,72,16,25,41
9,8481711,Matias Maccelli,L,ARI,23,82,13,28,41
9,8475171,Oliver Ekman-Larsson,D,FLA,32,82,13,28,41
9,8477021,Alex Kerfoot,C,ARI,29,82,12,29,41
9,8478055,Gustav Forsling,D,FLA,27,81,12,29,41
9,8476462,Dougie Hamilton,D,NJD,30,48,11,30,41
9,8477948,Travis Sanheim,D,PHI,27,80,6,35,41
9,8477450,Jason Dickinson,C,CHI,28,82,25,15,40
9,8478414,Timo Meier,R,NJD,27,68,21,19,40
9,8482149,Cole Perfetti,C,WPG,21,81,20,20,40
9,8477505,Alex Wennberg,C,SEA,29,82,20,20,40
9,8476479,Phillip Danault,C,LAK,30,82,15,25,40
9,8478038,Devon Toews,D,COL,29,82,12,28,40
9,8479345,Jakob Chychrun,D,OTT,25,82,10,30,40
9,8480434,Sean Durzi,D,ARI,25,76,10,30,40
9,8480893,Kirill Marchenko,R,CBJ,23,79,24,15,39
9,8477451,Ryan Hartman,R,MIN,29,77,20,19,39
9,8480813,Joe Veleno,C,DET,23,80,18,21,39
9,8477429,Andrew Copp,C,DET,29,81,15,24,39
9,8476869,Brady Skjei,D,CAR,29,81,9,30,39
9,8481542,Moritz Seider,D,DET,22,82,7,32,39
9,8474590,John Carlson,D,WSH,33,82,4,35,39
9,8475287,Erik Haula,L,NJD,32,75,15,23,38
9,8479987,Morgan Geekie,C,BOS,25,76,14,24,38
9,8479525,Ross Colton,C,COL,27,80,14,24,38
9,8474150,Mikael Backlund,C,CGY,34,82,13,25,38
9,8476483,Rickard Rakell,R,PIT,30,70,11,27,38
9,8478460,Zach Werenski,D,CBJ,26,69,1,37,38
9,8480188,Fabian Zetterlund,L,SJS,24,81,24,13,37
9,8482110,Dawson Mercer,C,NJD,22,81,21,16,37
9,8477476,Artturi Lehkonen,L,COL,28,47,14,23,37
9,8478438,Tommy Novak,C,NSH,26,71,13,24,37
9,8478500,Ivan Provorov,D,CBJ,26,81,7,30,37
9,8479410,Mikhail Sergachev,D,TBL,25,60,4,33,37
9,8476880,Tom Wilson,R,WSH,29,81,20,16,36
9,8475768,Jaden Schwartz,C,SEA,31,66,17,19,36
9,8476392,Adam Lowry,C,WPG,30,81,15,21,36
9,8475760,Nick Bjugstad,C,ARI,31,82,15,21,36
9,8476480,Vladislav Namestnikov,C,WPG,31,78,14,22,36
9,8475764,Cam Fowler,D,ANA,32,82,5,31,36
9,8480459,Pius Suter,C,VAN,27,67,22,13,35
9,8477952,Robby Fabbri,C,DET,27,68,21,14,35
9,8478043,Sam Lafferty,C,VAN,28,79,17,18,35
9,8473422,Nick Foligno,L,CHI,36,75,16,19,35
9,8482159,Tyson Foerster,R,PHI,21,78,16,19,35
9,8475193,Tomas Tatar,L,SEA,33,78,16,19,35
9,8476292,Ondrej Palat,L,NJD,32,71,15,20,35
9,8475722,Jason Zucker,L,ARI,31,72,12,23,35
9,8475220,Marcus Foligno,L,MIN,32,75,12,23,35
9,8476927,Teddy Blueger,C,VAN,29,67,8,27,35
9,8477447,Shea Theodore,D,VGK,28,48,5,30,35
9,8476885,Jacob Trouba,D,NYR,29,80,5,30,35
9,8476432,Boone Jenner,C,CBJ,30,66,24,10,34
9,8476921,Jordan Martinook,L,CAR,31,81,16,18,34
9,8483808,Andrei Kuzmenko,L,CGY,27,76,15,19,34
9,8479992,Michael Rasmussen,C,DET,24,82,15,19,34
9,8482092,Ridly Greig,C,OTT,21,72,15,19,34
9,8478466,Daniel Sprong,R,DET,26,54,14,20,34
9,8471218,Blake Wheeler,R,NYR,37,82,13,21,34
9,8474565,Alex Pietrangelo,D,VGK,33,76,4,30,34
9,8482089,Jake Neighbours,L,STL,21,82,23,10,33
9,8480064,Josh Norris,C,OTT,24,75,19,14,33
9,8481186,Logan O'Connor,R,COL,27,78,18,15,33
9,8471698,T.J. Oshie,R,WSH,37,65,17,16,33
9,8480014,Gabriel Vilardi,C,WPG,24,61,16,17,33
9,8475191,Reilly Smith,R,PIT,32,76,14,19,33
9,8474157,Max Pacioretty,L,WSH,35,47,14,19,33
9,8478413,Jordan Greenway,L,BUF,26,70,14,19,33
9,8476419,Jean-Gabriel Pageau,C,NYI,31,82,13,20,33
9,8473533,Jordan Staal,C,CAR,35,81,11,22,33
9,8476826,Yanni Gourde,C,SEA,32,80,9,24,33
9,8477498,Darnell Nurse,D,EDM,28,82,8,25,33
9,8475200,Dmitry Orlov,D,CAR,32,81,7,26,33
9,8478469,Thomas Chabot,D,OTT,26,60,5,28,33
9,8476792,Torey Krug,D,STL,32,82,2,31,33
9,8477969,Marcus Pettersson,D,PIT,27,82,2,31,33
9,8482671,Owen Power,D,BUF,21,79,2,31,33
9,8481560,Arthur Kaliyev,R,LAK,22,68,18,14,32
9,8473449,Kyle Okposo,R,BUF,35,79,18,14,32
9,8481601,Simon Holmstrom,R,NYI,22,81,18,14,32
9,8474149,Evgenii Dadonov,R,DAL,34,77,17,15,32
9,8482125,Alexander Holtz,R,NJD,21,81,17,15,32
9,8482475,Yegor Chinakhov,R,CBJ,22,69,15,17,32
9,8482146,Luke Evangelista,R,NSH,21,80,14,18,32
9,8475763,Kevin Hayes,R,STL,31,82,12,20,32
9,8482667,William Eklund,L,SJS,21,80,11,21,32
9,8478133,Jake Evans,C,MTL,27,82,10,22,32
9,8482113,Anton Lundell,C,FLA,22,78,8,24,32
9,8476438,Brandon Saad,L,STL,31,82,20,11,31
9,8479941,Justin Danforth,R,CBJ,30,81,18,13,31
9,8480802,Ryan McLeod,C,EDM,24,81,16,15,31
9,8481624,Ilya Mikheyev,R,VAN,29,77,15,16,31
9,8477479,Tyler Bertuzzi,L,TOR,28,81,11,20,31
9,8475218,Mattias Ekholm,D,EDM,33,81,7,24,31
9,8476958,Jaccob Slavin,D,CAR,29,81,7,24,31
9,8477986,Brandon Montour,D,FLA,29,66,7,24,31
9,8475181,Nick Leddy,D,STL,32,82,5,26,31
9,8475314,Anders Lee,L,NYI,33,82,18,12,30
9,8482720,Matthew Knies,L,TOR,21,80,13,17,30
9,8478891,Mason Appleton,C,WPG,27,81,12,18,30
9,8476892,Colton Parayko,D,STL,30,82,11,19,30
9,8479591,Michael Eyssimont,C,TBL,27,81,11,19,30
9,8480817,K'Andre Miller,D,NYR,23,80,9,21,30
9,8475753,Justin Faulk,D,STL,31,68,7,23,30
9,8480145,Neal Pionk,D,WPG,28,81,6,24,30
9,8477425,Miles Wood,L,COL,28,77,15,14,29
9,8477407,Anthony Duclair,L,SJS,28,76,14,15,29
9,8481618,Alex Newhook,C,MTL,22,55,14,15,29
9,8479415,Michael McLeod,C,NJD,25,73,13,16,29
9,8476923,Damon Severson,D,CBJ,29,66,11,18,29
9,8478115,Pierre Engvall,L,NYI,27,76,10,19,29
9,8476312,Josh Manson,D,COL,32,77,10,19,29
9,8480873,Rasmus Sandin,D,WSH,23,74,6,23,29
9,8476854,Hampus Lindholm,D,BOS,29,82,3,26,29
9,8479619,Michael Carcone,L,ARI,27,76,21,7,28
9,8480185,Eetu Luostarinen,C,FLA,25,82,18,10,28
9,8478046,Danton Heinen,L,BOS,28,74,15,13,28
9,8475714,Calle Jarnkrok,C,TOR,32,75,14,14,28
9,8474884,Mike Hoffman,C,SJS,34,79,12,16,28
9,8476474,Stefan Noesen,R,CAR,30,52,11,17,28
9,8481577,Philip Tomasino,C,NSH,22,68,11,17,28
9,8478020,Michael Amadio,R,VGK,27,74,10,18,28
9,8478136,Jake Middleton,D,MIN,27,82,10,18,28
9,8482062,Cole Smith,L,NSH,28,81,9,19,28
9,8478463,Anthony Beauvillier,L,CHI,26,64,7,21,28
9,8479398,Samuel Girard,D,COL,25,61,6,22,28
9,8478178,Darren Raddysh,D,TBL,27,82,6,22,28
9,8478507,John Marino,D,NJD,26,81,5,23,28
9,8482245,Artem Zub,D,OTT,28,72,3,25,28
9,8478013,Jake Walman,D,DET,27,76,17,10,27
9,8474870,Tyler Johnson,C,CHI,33,67,17,10,27
9,8481604,Pavel Dorofeyev,L,VGK,23,57,16,11,27
9,8475793,Ryan Johansen,C,COL,31,82,14,13,27
9,8476981,Josh Anderson,R,MTL,29,78,12,15,27
9,8482097,Jack Quinn,R,BUF,22,45,12,15,27
9,8481533,Trevor Zegras,C,ANA,22,48,9,18,27
9,8479351,Sam Steel,C,DAL,25,77,9,18,27
9,8476463,Jonas Brodin,D,MIN,30,64,6,21,27
9,8480078,Filip Chytil,C,NYR,24,38,4,23,27
9,8476879,Cody Ceci,D,EDM,30,82,3,24,27
9,8476918,Jimmy Vesey,L,NYR,30,80,18,8,26
9,8475343,Nic Dowd,C,WSH,33,73,13,13,26
9,8474189,Lars Eller,C,PIT,34,82,12,14,26
9,8477508,Curtis Lazar,C,NJD,28,76,12,14,26
9,8478109,Victor Olofsson,L,BUF,28,63,11,15,26
9,8480220,Noah Cates,L,PHI,24,59,9,17,26
9,8477953,Kasperi Kapanen,R,STL,27,75,8,18,26
9,8476897,Oskar Sundqvist,C,STL,29,82,7,19,26
9,8474574,Tyler Myers,D,VAN,33,81,5,21,26
9,8474151,Ryan McDonagh,D,NSH,34,75,3,23,26
9,8478840,Will Borgen,D,SEA,27,82,2,24,26
9,8476331,Dylan DeMelo,D,WPG,30,81,2,24,26
9,8481524,Bowen  Byram,D,COL,22,74,12,13,25
9,8481580,Connor McMichael,C,WSH,22,80,11,14,25
9,8481582,Nicholas Robertson,L,TOR,22,64,10,15,25
9,8470621,Corey Perry,R,EDM,38,54,9,16,25
9,8481546,Cam York,D,PHI,22,81,7,18,25
9,8476902,Esa Lindell,D,DAL,29,82,6,19,25
9,8476457,Adam Larsson,D,SEA,31,82,5,20,25
9,8475188,Brayden McNabb,D,VGK,32,81,4,21,25
9,8474602,Justin Schultz,D,SEA,33,72,4,21,25
9,8482655,J.J. Moser,D,ARI,23,80,4,21,25
9,8475197,Tyson Barrie,D,NSH,32,62,4,21,25
9,8481535,Nils Hoglander,L,VAN,23,53,17,7,24
9,8482055,Drew O'Connor,L,PIT,25,82,11,13,24
9,8482705,Cole Sillinger,C,CBJ,20,76,11,13,24
9,8480829,Jesperi Kotkaniemi,C,CAR,23,81,10,14,24
9,8475462,Radko Gudas,D,ANA,33,76,10,14,24
9,8480068,Ryan Poehling,C,PHI,24,76,10,14,24
9,8481032,Paul Cotter,C,VGK,24,80,8,16,24
9,8480835,Jack Drury,C,CAR,23,53,8,16,24
9,8477932,Aaron Ekblad,D,FLA,27,64,6,18,24
9,8480043,Timothy Liljegren,D,TOR,24,65,3,21,24
9,8480281,Alexey Toropchenko,R,STL,24,82,16,7,23
9,8482157,Will Cuylle,L,NYR,21,82,13,10,23
9,8479977,Kailer Yamamoto,R,SEA,25,73,11,12,23
9,8475744,Evgeny Kuznetsov,C,WSH,31,72,9,14,23
9,8480113,Alex Iafallo,L,WPG,30,81,8,15,23
9,8471699,Andrew Cogliano,C,COL,36,76,7,16,23
9,8477989,Christian Dvorak,C,MTL,27,52,6,17,23
9,8480336,Sean Walker,D,PHI,29,81,5,18,23
9,8482087,Kaiden Guhle,D,MTL,21,78,5,18,23
9,8474161,Jakub Voracek,R,CBJ,34,29,5,18,23
9,8480878,Nils Lundkvist,D,DAL,23,70,3,20,23
9,8477947,Sonny Milano,L,WSH,27,53,11,11,22
9,8474040,Sam Gagner,C,EDM,34,55,11,11,22
9,8479339,Patrik Laine,L,CBJ,25,47,10,12,22
9,8481014,Alexander Romanov,D,NYI,23,81,8,14,22
9,8475164,Jakob Silfverberg,R,ANA,33,81,7,15,22
9,8478851,Alexandre Carrier,D,NSH,27,77,6,16,22
9,8475790,Erik Gudbranson,D,CBJ,31,77,6,16,22
9,8479980,Nicolas Hague,D,VGK,25,73,6,16,22
9,8475208,Brian Dumoulin,D,SEA,32,80,6,16,22
9,8473507,Jeff Petry,D,DET,36,73,5,17,22
9,8477950,Tony DeAngelo,D,CAR,28,51,4,18,22
9,8481568,Alex Vlasic,D,CHI,22,76,3,19,22
9,8480246,Nick Perbix,D,TBL,25,80,2,20,22
9,8475179,Dmitry Kulikov,D,FLA,33,78,0,22,22
9,8476469,Joel Armia,R,MTL,30,66,16,5,21
9,8479316,Luke Kunin,C,SJS,26,76,14,7,21
9,8479293,Brandon Tanev,L,SEA,32,66,13,8,21
9,8475455,Brenden Dillon,D,WPG,33,78,9,12,21
9,8470638,Patrice Bergeron,C,BOS,38,27,9,12,21
9,8476960,Andreas Athanasiou,C,CHI,29,38,9,12,21
9,8479359,Beck Malenstyn,L,WSH,25,81,8,13,21
9,8478458,Jack Roslovic,C,CBJ,26,58,8,13,21
9,8477444,Andre Burakovsky,L,SEA,28,51,7,14,21
9,8480855,Jack McBain,C,ARI,23,67,7,14,21
9,8482222,Alexander Barabanov,L,SJS,29,61,7,14,21
9,8479353,Brett Howden,C,VGK,25,79,7,14,21
9,8476931,Jake McCabe,D,TOR,30,76,6,15,21
9,8478042,Viktor Arvidsson,R,LAK,30,32,6,15,21
9,8478911,Matt Roy,D,LAK,28,81,5,16,21
9,8481656,Aliaksei Protas,C,WSH,22,52,4,17,21
9,8479998,Mikey Anderson,D,LAK,24,82,1,20,21
9,8477944,Jakub Vrana,L,STL,27,49,8,12,20
9,8481481,Blake Lizotte,C,LAK,26,64,8,12,20
9,8478882,Vladislav Gavrikov,D,LAK,28,77,7,13,20
9,8474166,Alec Martinez,D,VGK,36,64,6,14,20
9,8480035,Henri Jokiharju,D,BUF,24,74,6,14,20
9,8478443,Brandon Carlo,D,BOS,27,77,5,15,20
9,8478859,Niko Mikkola,D,FLA,27,82,5,15,20
9,8477495,Seth Jones,D,CHI,29,67,1,19,20
9,8475690,Chris Tanev,D,CGY,34,79,1,19,20
9,8478508,Yakov Trenin,C,NSH,26,79,13,6,19
9,8479661,Tanner Jeannot,L,TBL,26,68,11,8,19
9,8481704,Juuso Parssinen,C,NSH,22,71,11,8,19
9,8475855,Jesper Fast,R,CAR,32,78,8,11,19
9,8476374,Sean Kuraly,C,CBJ,30,73,8,11,19
9,8475231,Casey Cizikas,C,NYI,32,71,7,12,19
9,8476889,Radek Faksa,C,DAL,29,74,7,12,19
9,8482142,Jamie Drysdale,D,PHI,21,49,6,13,19
9,8481522,Peyton Krebs,C,BUF,22,80,5,14,19
9,8475233,David Savard,D,MTL,33,60,4,15,19
9,8475279,Ben Chiarot,D,DET,32,77,4,15,19
9,8471274,Alex Goligoski,D,MIN,38,58,4,15,19
9,8470600,Ryan Suter,D,DAL,38,82,1,18,19
9,8480049,Dylan Samberg,D,WPG,24,81,1,18,19
9,8477365,Connor Clifton,D,BUF,28,79,1,18,19
9,8474673,TJ Brodie,D,TOR,33,81,0,19,19
9,8477330,Dominik Kubalik,L,OTT,28,78,13,5,18
9,8473548,Phil Kessel,R,VGK,36,28,9,9,18
9,8482111,Justin Barron,D,MTL,22,68,8,10,18
9,8482699,Dylan Guenther,R,ARI,20,45,7,11,18
9,8481596,Shane Pinto,C,OTT,23,41,7,11,18
9,8477839,Conor Sheary,L,TBL,31,64,4,14,18
9,8470604,Jeff Carter,C,PIT,38,76,14,3,17
9,8481554,Kaapo Kakko,R,NYR,22,61,11,6,17
9,8473604,Jonathan Toews,C,CHI,35,27,8,9,17
9,8480821,Filip Zadina,R,SJS,24,48,7,10,17
9,8479324,Ryan Lindgren,D,NYR,25,80,4,13,17
9,8480883,Ty Smith,D,PIT,23,31,4,13,17
9,8476329,Travis Boyd,C,ARI,30,45,3,14,17
9,8480994,Damien Giroux,C,MIN,23,28,2,15,17
9,8476822,Luke Glendening,C,TBL,34,82,13,3,16
9,8482101,Danil Gushchin,L,SJS,21,30,9,7,16
9,8473453,Trevor Lewis,C,LAK,36,82,8,8,16
9,8479390,Taylor Raddysh,R,CHI,25,77,8,8,16
9,8475848,Brendan Gallagher,R,MTL,31,50,8,8,16
9,8482117,Lukas Reichel,L,CHI,21,77,7,9,16
9,8477919,Frederick Gaudreau,C,MIN,30,70,6,10,16
9,8482660,Kent Johnson,C,CBJ,21,36,6,10,16
9,8480144,David Kampf,C,TOR,28,78,5,11,16
9,8475791,Taylor Hall,L,CHI,32,37,4,12,16
9,8477507,Nikita Zadorov,D,VAN,28,75,4,12,16
9,8474034,Pat Maroon,L,MIN,35,49,4,12,16
9,8477220,Nate Schmidt,D,WPG,32,75,4,12,16
9,8482073,Braden Schneider,D,NYR,22,82,3,13,16
9,8480001,Urho Vaakanainen,D,ANA,24,74,3,13,16
9,8480762,Eric Robinson,L,BUF,28,54,3,13,16
9,8479976,Juuso Valimaki,D,ARI,25,68,2,14,16
9,8479983,Mario Ferraro,D,SJS,25,77,1,15,16
9,8481606,Jordan Spence,D,LAK,22,44,0,16,16
9,8478831,Kevin Stenlund,C,FLA,27,82,10,5,15
9,8481093,Rafael Harvey-Pinard,L,MTL,24,51,8,7,15
9,8479393,Noah Gregor,C,TOR,25,81,7,8,15
9,8479346,Dillon Dube,C,CGY,25,70,7,8,15
9,8476442,Matt Nieto,L,PIT,31,53,6,9,15
9,8477987,Ryan Donato,C,CHI,27,51,6,9,15
9,8481178,Egor Zamula,D,PHI,23,44,5,10,15
9,8480796,Martin Fehervary,D,WSH,24,76,2,13,15
9,8480849,Barrett Hayton,C,ARI,23,50,9,5,14
9,8481013,Jonatan Berggren,R,DET,23,37,9,5,14
9,8474053,Logan Couture,C,SJS,34,34,8,6,14
9,8478468,Jeremy Lauzon,D,NSH,26,82,8,6,14
9,8477506,Ryan Pulock,D,NYI,29,58,5,9,14
9,8474031,Kevin Shattenkirk,D,BOS,34,44,5,9,14
9,8478970,Jalen Chatfield,D,CAR,27,48,5,9,14
9,8477979,Nicolas Aube-Kubel,R,WSH,27,39,5,9,14
9,8475177,Calvin de Haan,D,TBL,32,72,5,9,14
9,8473563,Nicklas Backstrom,C,WSH,36,37,5,9,14
9,8476967,Brett Kulak,D,EDM,29,82,5,9,14
9,8476422,Mike Reilly,D,NYI,30,61,4,10,14
9,8473504,Cal Clutterbuck,R,NYI,36,53,4,10,14
9,8477380,Jonny Brodzinski,C,NYR,30,35,4,10,14
9,8480172,Jan Rutta,D,SJS,33,75,3,11,14
9,8481605,Jackson LaCombe,D,ANA,22,76,2,12,14
9,8477015,Connor Brown,R,EDM,29,75,2,12,14
9,8477845,Trevor van Riemsdyk,D,WSH,32,70,1,13,14
9,8474567,Zach Bogosian,D,MIN,33,70,1,13,14
9,8481690,Tyler Angle,C,CBJ,23,29,11,2,13
9,8480289,Morgan Barron,C,WPG,25,51,9,4,13
9,8477353,Tyler Motte,C,TBL,28,72,8,5,13
9,8477446,Michael McCarron,R,NSH,28,43,7,6,13
9,8482259,Bobby McMann,C,TOR,27,29,7,6,13
9,8470610,Zach Parise,L,COL,39,33,7,6,13
9,8477488,Brett Pesce,D,CAR,29,71,6,7,13
9,8480448,Parker Kelly,L,OTT,24,51,6,7,13
9,8481523,Kirby Dach,C,MTL,22,29,4,9,13
9,8471677,Jack Johnson,D,COL,36,80,4,9,13
9,8476858,Phillip Di Giuseppe,L,VAN,30,62,4,9,13
9,8479996,Cody Glass,C,NSH,24,54,3,10,13
9,8478399,Jonas Siegenthaler,D,NJD,26,66,2,11,13
9,8475825,Jani Hakanpää,D,DAL,31,82,2,11,13
9,8477406,Mattias Janmark,C,EDM,31,71,2,11,13
9,8478416,Erik Cernak,D,TBL,26,71,2,11,13
9,8477335,Kyle Burroughs,D,SJS,28,74,2,11,13
9,8482730,Brandt Clarke,D,LAK,20,38,2,11,13
9,8475324,Nick Jensen,D,WSH,33,82,1,12,13
9,8475906,John Klingberg,D,TOR,31,43,0,13,13
9,8477903,Garnet Hathaway,R,PHI,32,81,9,3,12
9,8479336,Carl Grundstrom,R,LAK,26,50,8,4,12
9,8471669,Paul Stastny,C,CAR,38,28,7,5,12
9,8471276,David Krejci,C,BOS,37,27,7,5,12
9,8474009,Nick Bonino,C,NYR,35,73,7,5,12
9,8481517,Brett Leason,R,ANA,24,43,6,6,12
9,8480748,Kiefer Sherwood,L,NSH,28,41,5,7,12
9,8477435,Ryan Graves,D,PIT,28,82,4,8,12
9,8480891,Michael Kesselring,D,ARI,23,36,4,8,12
9,8474683,Derek Grant,C,ANA,33,28,4,8,12
9,8480727,Zach Whitecloud,D,VGK,27,65,4,8,12
9,8480073,Erik Brannstrom,D,OTT,24,45,3,9,12
9,8476874,Olli Maatta,D,DET,29,46,2,10,12
9,8478432,Christian Fischer,R,DET,26,51,2,10,12
9,8476917,Adam Pelech,D,NYI,29,58,2,10,12
9,8474716,Jared Spurgeon,D,MIN,34,44,2,10,12
9,8477499,Rasmus Ristolainen,D,PHI,29,57,2,10,12
9,8480884,Calen Addison,D,SJS,23,45,1,11,12
9,8482192,Isaak Phillips,D,CHI,22,56,0,12,12
9,8476856,Matt Dumba,D,ARI,29,78,7,4,11
9,8475225,Craig Smith,C,DAL,34,50,7,4,11
9,8481592,Jakob Pelletier,L,CGY,22,31,7,4,11
9,8480205,Emil Bemstrom,R,CBJ,24,31,5,6,11
9,8478585,Derek Ryan,C,EDM,37,51,5,6,11
9,8476393,Nick Cousins,C,FLA,30,70,5,6,11
9,8477454,Adam Erne,L,EDM,28,54,5,6,11
9,8480879,Jacob Bernard-Docker,D,OTT,23,42,4,7,11
9,8474612,Travis Hamonic,D,OTT,33,75,4,7,11
9,8475461,Andrew Agozzino,L,SJS,32,28,4,7,11
9,8476473,Connor Murphy,D,CHI,30,70,3,8,11
9,8476467,Jamie Oleksiak,D,SEA,31,82,3,8,11
9,8479348,Kale Clague,D,BUF,25,28,3,8,11
9,8480807,Mattias Samuelsson,D,BUF,23,69,2,9,11
9,8476941,Connor Carrick,D,BOS,29,27,1,10,11
9,8475842,Sam Carrick,C,ANA,31,54,7,3,10
9,8480980,Connor Dewar,C,MIN,24,48,7,3,10
9,8478421,A.J. Greer,L,CGY,27,47,6,4,10
9,8478131,Ondrej Kase,R,CAR,28,28,5,5,10
9,8483464,Marco Kasper,C,DET,19,28,5,5,10
9,8480848,Ty Dellandrea,C,DAL,23,53,4,6,10
9,8476871,Tanner Pearson,L,MTL,31,36,4,6,10
9,8478434,Keegan Kolesar,R,VGK,26,50,4,6,10
9,8476525,Colin Miller,D,NJD,31,61,3,7,10
9,8479414,Nathan Bastian,R,NJD,26,51,3,7,10
9,8479543,Michael Pezzetta,L,MTL,25,44,3,7,10
9,8479371,Dante Fabbro,D,NSH,25,42,2,8,10
9,8480860,Kevin Bahl,D,NJD,23,81,0,10,10
9,8475762,Derek Forbort,D,BOS,31,57,0,10,10
9,8478495,Denis Gurianov,R,NSH,26,40,8,1,9
9,8480192,Johnathan Kovacevic,D,MTL,26,74,6,3,9
9,8479718,Alex Barré-Boulet,C,TBL,26,35,6,3,9
9,8479344,Jesse Puljujarvi,R,PIT,25,36,5,4,9
9,8479383,Boris Katchouk,L,CHI,25,35,5,4,9
9,8479328,Julien Gauthier,R,NYI,26,27,5,4,9
9,8477941,Nick Ritchie,L,CGY,28,27,5,4,9
9,8480328,David Gust,R,CHI,29,27,5,4,9
9,8479402,Jake Bean,D,CBJ,25,49,4,5,9
9,8477846,Ryan Carpenter,C,SJS,32,36,3,6,9
9,8480008,Adam Ruzicka,C,ARI,24,41,3,6,9
9,8478028,Fredrik Olofsson,L,COL,27,53,3,6,9
9,8479315,Joey Anderson,R,CHI,25,28,2,7,9
9,8475718,Justin Holl,D,DET,31,63,1,8,9
9,8480887,Jordan Harris,D,MTL,23,58,1,8,9
9,8476624,Barclay Goodrow,C,NYR,30,80,1,8,9
9,8482711,Stanislav Svozil,D,CBJ,20,29,1,8,9
9,8481527,Kaedan Korczak,D,VGK,22,26,1,8,9
9,8477018,Ben Hutton,D,VGK,30,31,1,8,9
9,8483460,David Jiricek,D,CBJ,20,36,1,8,9
9,8480058,Pierre-Olivier Joseph,D,PIT,24,53,1,8,9
9,8476372,Nick Seeler,D,PHI,30,55,0,9,9
9,8478569,Noel Acciari,C,PIT,32,70,6,2,8
9,8477931,Tomas Nosek,L,NJD,31,40,5,3,8
9,8480252,Cole Guttman,C,CHI,24,27,4,4,8
9,8479368,Max Jones,L,ANA,25,38,4,4,8
9,8481617,Vasily Podkolzin,R,VAN,22,26,4,4,8
9,8480806,Isac Lundestrom,C,ANA,24,46,3,5,8
9,8481477,Nico Sturm,C,SJS,28,34,3,5,8
9,8477392,Hudson Fasching,R,NYI,28,35,3,5,8
9,8477070,Liam O'Brien,C,ARI,29,49,3,5,8
9,8480995,Pontus Holmberg,R,TOR,24,27,2,6,8
9,8476441,Joel Edmundson,D,WSH,30,66,2,6,8
9,8479442,Troy Stecher,D,ARI,29,71,2,6,8
9,8474013,Ian Cole,D,VAN,34,80,1,7,8
9,8474162,Jake Muzzin,D,TOR,34,29,1,7,8
9,8474573,Josh Bailey,R,NYI,34,29,1,7,8
9,8474218,Jason Demers,D,EDM,35,31,1,7,8
9,8479576,Vincent Desharnais,D,EDM,27,49,1,7,8
9,8477971,Andreas Englund,D,LAK,27,52,1,7,8
9,8476429,Scott Mayfield,D,NYI,31,67,0,8,8
9,8479439,Jacob MacDonald,D,SJS,30,21,6,1,7
9,8471709,Marc-Edouard Vlasic,D,SJS,36,31,5,2,7
9,8477478,William Carrier,L,VGK,29,33,5,2,7
9,8477573,Nathan Walker,L,STL,29,18,5,2,7
9,8480913,Jordan Gross,D,NSH,28,27,4,3,7
9,8482241,Radim Zohorna,L,PIT,27,31,4,3,7
9,8480031,Max Comtois,L,ANA,24,28,3,4,7
9,8481058,Jesse Ylönen,R,MTL,24,43,3,4,7
9,8476915,Jujhar Khaira,L,MIN,29,29,3,4,7
9,8480831,Alec Regula,D,CHI,23,27,3,4,7
9,8481567,Henry Thrun,D,SJS,22,51,2,5,7
9,8476891,Matt Grzelcyk,D,BOS,29,41,2,5,7
9,8479458,Nikita Zaitsev,D,CHI,32,26,2,5,7
9,8477541,Dakota Mermis,D,MIN,29,37,2,5,7
9,8478099,Kevin Labanc,R,SJS,28,32,2,5,7
9,8481641,Joel Kiviranta,L,COL,27,40,2,5,7
9,8480880,Jakub Lauko,C,BOS,23,40,2,5,7
9,8482712,Oskar Olausson,R,COL,21,28,1,6,7
9,8470966,Mark Giordano,D,TOR,40,36,1,6,7
9,8481537,Nikita Okhotiuk,D,SJS,23,38,1,6,7
9,8478502,Dennis Gilbert,D,CGY,27,31,1,6,7
9,8478104,Sammy Blais,L,STL,27,43,1,6,7
9,8481812,Nikolai Knyzhov,D,SJS,26,38,1,6,7
9,8480871,Adam Boqvist,D,CBJ,23,22,0,7,7
9,8478870,Rudolfs Balcers,L,TBL,26,26,4,2,6
9,8479291,Kevin Rooney,C,CGY,30,33,4,2,6
9,8479520,Brandon Duhaime,R,MIN,26,54,4,2,6
9,8479066,Ryan Lomberg,L,FLA,29,55,4,2,6
9,8482679,Matt Coronato,R,CGY,21,42,3,3,6
9,8476278,Colin Blackwell,C,CHI,30,25,3,3,6
9,8479968,Vinni Lettieri,C,MIN,28,24,3,3,6
9,8479322,Wade Allison,R,PHI,26,26,2,4,6
9,8477369,Carson Soucy,D,VAN,29,21,2,4,6
9,8482496,Nils Aman,C,VAN,23,31,2,4,6
9,8480789,Oliver Wahlstrom,R,NYI,23,27,2,4,6
9,8482451,Mikael Pyyhtia,L,CBJ,22,29,2,4,6
9,8471303,Alexander Edler,D,LAK,37,30,1,5,6
9,8480222,Sebastian Aho,D,NYI,27,41,1,5,6
9,8474568,Luke Schenn,D,NSH,34,36,1,5,6
9,8479982,Conor Timmins,D,TOR,25,16,1,5,6
9,8482181,Tristen Robins,C,SJS,22,28,1,5,6
9,8480874,Adam Ginning,D,PHI,23,26,1,5,6
9,8476988,Matt Benning,D,SJS,29,42,0,6,6
9,8479369,Andrew Peeke,D,CBJ,25,20,0,6,6
9,8475797,Jarred Tinordi,D,CHI,31,32,0,6,6
9,8479372,Josh Mahura,D,FLA,25,20,0,6,6
9,8477930,Pierre-Edouard Bellemare,L,SEA,38,29,4,1,5
9,8479514,Rem Pitlick,C,CHI,26,36,3,2,5
9,8480072,Lias Andersson,C,LAK,25,30,3,2,5
9,8480184,Gustav Lindström,D,ANA,25,22,3,2,5
9,8478408,Travis Dermott,D,ARI,27,37,2,3,5
9,8482964,Arber Xhekaj,D,MTL,22,24,2,3,5
9,8475750,Jon Merrill,D,MIN,31,38,2,3,5
9,8474618,Marco Scandella,D,STL,33,49,2,3,5
9,8480025,MacKenzie Entwistle,R,CHI,24,46,2,3,5
9,8479536,Axel Jonsson-Fjallby,L,WPG,25,26,2,3,5
9,8481754,Nikita Nesterenko,C,ANA,22,28,2,3,5
9,8476310,Lukas Sedlak,C,PHI,30,26,2,3,5
9,8474090,Brendan Smith,D,NJD,34,36,1,4,5
9,8477384,Josh Brown,D,ARI,29,28,1,4,5
9,8481708,Zac Jones,D,NYR,23,17,1,4,5
9,8480084,Nick DeSimone,D,NJD,29,23,1,4,5
9,8479671,Mathieu Olivier,R,CBJ,26,25,1,4,5
9,8479547,Matthew Phillips,R,PIT,25,27,1,4,5
9,8476919,Chris Tierney,C,NJD,29,28,1,4,5
9,8476952,Dominic Toninato,C,WPG,29,15,1,4,5
9,8482652,Walker Duehr,R,CGY,26,26,1,4,5
9,8482452,Elliot Desnoyers,L,PHI,21,26,1,4,5
9,8480242,Arnaud Durandeau,L,NYI,24,29,1,4,5
9,8477034,Jaycob Megna,D,CHI,31,45,0,5,5
9,8477359,Tucker Poolman,D,VAN,30,26,0,5,5
9,8480950,Ilya Lyubushkin,D,ANA,29,79,0,5,5
9,8477482,Zach Sanford,L,CHI,29,26,0,5,5
9,8476878,Zemgus Girgensons,L,BUF,29,36,4,0,4
9,8482077,Dylan Holloway,L,EDM,22,23,3,1,4
9,8480011,Klim Kostin,C,DET,24,32,3,1,4
9,8480901,Karson Kuhlman,C,WPG,28,30,3,1,4
9,8482081,Sean Farrell,C,MTL,22,27,2,2,4
9,8471873,Anton Stralman,D,BOS,37,27,2,2,4
9,8476410,Josh Leivo,L,STL,30,28,2,2,4
9,8479370,Tyson Jost,C,BUF,25,29,2,2,4
9,8481019,David Gustafsson,C,WPG,23,27,2,2,4
9,8479981,Jonah Gadjovich,L,FLA,25,27,2,2,4
9,8480275,Nick Swaney,R,MIN,26,28,2,2,4
9,8470595,Eric Staal,C,FLA,39,27,1,3,4
9,8477938,Haydn Fleury,D,TBL,27,16,1,3,4
9,8480003,Jesper Boqvist,C,BOS,25,20,1,3,4
9,8479994,Jaret Anderson-Dolan,C,LAK,24,24,1,3,4
9,8475752,Tyler Pitlick,C,NYR,32,34,1,3,4
9,8476913,Devin Shore,C,SEA,29,21,1,3,4
9,8475747,Patrik Nemeth,D,ARI,31,29,1,3,4
9,8473544,Derick Brassard,C,OTT,36,31,0,4,4
9,8477851,Jordan Oesterle,D,CGY,31,48,0,4,4
9,8482176,Wyatt Kaiser,D,CHI,21,23,0,4,4
9,8478452,Caleb Jones,D,COL,26,20,0,4,4
9,8478454,Noah Juulsen,D,VAN,26,38,0,4,4
9,8478424,Jansen Harkins,C,PIT,26,34,0,4,4
9,8482516,Matthew Kessel,D,STL,23,47,0,4,4
9,8473446,Erik Johnson,D,BUF,35,46,3,0,3
9,8481147,Reese Johnson,C,CHI,25,34,2,1,3
9,8478078,Rourke Chartier,C,OTT,27,34,2,1,3
9,8474709,Matt Martin,L,NYI,34,31,2,1,3
9,8479772,Zack MacEwen,R,OTT,27,22,2,1,3
9,8477962,Brendan Lemieux,L,CAR,27,23,2,1,3
9,8475766,Austin Watson,L,TBL,31,28,2,1,3
9,8480468,James Hamblin,L,EDM,24,31,2,1,3
9,8480355,Mark Kastelic,C,OTT,24,34,2,1,3
9,8481122,Simon Benoit,D,TOR,25,39,1,2,3
9,8478451,Ethan Bear,D,WSH,26,16,1,2,3
9,8471686,Marc Staal,D,PHI,36,20,1,2,3
9,8477244,Chad Ruhwedel,D,PIT,33,37,1,2,3
9,8481541,Samuel Bolduc,D,NYI,23,33,1,2,3
9,8476934,Brock McGinn,L,ANA,29,24,1,2,3
9,8476994,Vinnie Hinostroza,C,PIT,29,14,1,2,3
9,8480007,Jonas Rondbjerg,R,VGK,24,17,1,2,3
9,8476867,Brendan Gaunce,C,CBJ,29,8,1,2,3
9,8478904,Steven Lorentz,C,FLA,27,28,1,2,3
9,8479379,Givani Smith,R,SJS,25,26,1,2,3
9,8481167,Brayden Pachal,D,CGY,24,50,1,2,3
9,8482448,Samuel Knazko,D,CBJ,21,29,0,3,3
9,8478450,Parker Wotherspoon,D,BOS,26,23,0,3,3
9,8477810,Joel Hanley,D,DAL,32,26,0,3,3
9,8480853,Liam Foudy,C,NSH,23,13,0,3,3
9,8475235,Nicolas Deslauriers,L,PHI,32,47,0,3,3
9,8483641,Anton Levtchi,L,FLA,28,27,0,3,3
9,8480776,Sheldon Rempal,R,VGK,28,5,2,0,2
9,8471817,Ryan Reaves,R,TOR,36,27,2,0,2
9,8477073,Kurtis MacDermid,D,COL,29,28,2,0,2
9,8483424,Owen Beck,C,MTL,19,27,1,1,2
9,8480977,Semyon Der-Arguchintsev,C,TOR,23,29,1,1,2
9,8482207,William Dufour,R,NYI,21,29,1,1,2
9,8482133,Thomas Bordeleau,C,SJS,21,6,1,1,2
9,8481006,Tyler Tucker,D,STL,23,16,1,1,2
9,8479362,Riley Tufte,L,COL,25,5,1,1,2
9,8478051,Max Willman,C,NJD,28,13,1,1,2
9,8481532,Alex Turcotte,C,LAK,22,6,1,1,2
9,8475780,Chris Wagner,R,BOS,32,27,1,1,2
9,8474207,Nick Holden,D,OTT,36,31,0,2,2
9,8479580,Dylan Gambrell,C,OTT,27,31,0,2,2
9,8480070,Ian Mitchell,D,BOS,24,13,0,2,2
9,8480196,Jacob Bryson,D,BUF,26,8,0,2,2
9,8480870,Bo Groulx,C,ANA,23,32,0,2,2
9,8473473,Milan Lucic,L,BOS,35,4,0,2,2
9,8477464,Nic Petan,C,MIN,28,6,0,2,2
9,8477527,Ross Johnston,L,ANA,29,41,0,2,2
9,8481043,Cole Koepke,L,TBL,25,8,0,2,2
9,8481056,Spencer Stastney,D,NSH,23,9,1,0,1
9,8480823,Alexander Alexeyev,D,WSH,24,13,1,0,1
9,8476873,Mark Jankowski,C,NSH,29,5,1,0,1
9,8480021,Jack Studnicka,C,SJS,24,14,1,0,1
9,8478409,Anthony Richard,C,BOS,27,4,1,0,1
9,8483570,Ben Meyers,C,COL,25,9,1,0,1
9,8481422,Jacob Lucchini,C,MIN,28,13,1,0,1
9,8479546,Oskar Steen,C,BOS,25,34,1,0,1
9,8481239,Samuel Fagemo,L,LAK,23,8,1,0,1
9,8476449,Scott Harrington,D,ANA,30,28,0,1,1
9,8480041,Dmitri Samorukov,D,STL,24,28,0,1,1
9,8482762,Simon Edvinsson,D,DET,20,2,0,1,1
9,8481161,Jake Christiansen,D,CBJ,24,3,0,1,1
9,8480157,Calle Rosen,D,STL,29,5,0,1,1
9,8479984,Cal Foote,D,NJD,25,4,0,1,1
9,8479321,Lucas Johansen,D,WSH,26,6,0,1,1
9,8479378,Logan Stanley,D,WPG,25,10,0,1,1
9,8478017,Mark Friedman,D,VAN,28,20,0,1,1
9,8482095,Tyler Kleven,D,OTT,21,5,0,1,1
9,8479320,Max Lajoie,D,TOR,26,5,0,1,1
9,8477887,Patrick Brown,C,BOS,31,11,0,1,1
9,8480245,Olle Lycksell,R,PHI,24,5,0,1,1
9,8478146,Matthew Highmore,C,OTT,27,6,0,1,1
9,8480845,Rasmus Kupari,C,WPG,23,21,0,1,1
9,8478512,Austin Czarnik,C,DET,31,18,0,1,1
9,8479367,William Lockwood,R,FLA,25,23,0,1,1
9,8481543,Nikita Alexandrov,C,STL,23,18,0,1,1
9,8483597,Milos Kelemen,L,ARI,24,10,0,1,1
9,8483565,Nick Blankenburg,D,CBJ,25,6,0,0,0
9,8483620,Marcus Bjork,D,CBJ,26,0,0,0,0
9,8481521,Ronnie Attard,D,PHI,24,0,0,0,0
9,8482399,Billy Sweezey,D,CBJ,27,0,0,0,0
9,8481072,Tim Berni,D,CBJ,23,0,0,0,0
9,8476884,Derrick Pouliot,D,SJS,29,0,0,0,0
9,8482624,Daniil Miromanov,D,VGK,26,2,0,0,0
9,8482861,Vincent Iorio,D,WSH,21,0,0,0,0
9,8478465,Guillaume Brisebois,D,VAN,26,0,0,0,0
9,8484256,Jake Livingstone,D,NSH,24,0,0,0,0
9,8481599,Victor Soderstrom,D,ARI,22,1,0,0,0
9,8474027,Justin Braun,D,PHI,36,0,0,0,0
9,8478062,Dysin Mayo,D,ARI,27,0,0,0,0
9,8481563,Drew Helleson,D,ANA,22,0,0,0,0
9,8481575,Lassi Thomson,D,OTT,23,0,0,0,0
9,8483619,Filip Roos,D,CHI,24,4,0,0,0
9,8481461,Corey Schueneman,D,MTL,28,0,0,0,0
9,8478846,Christian Wolanin,D,VAN,28,0,0,0,0
9,8479395,Dennis Cholowski,D,NYI,25,0,0,0,0
9,8479945,Gavin Bayreuther,D,CBJ,29,0,0,0,0
9,8474818,Jordie Benn,D,TOR,36,0,0,0,0
9,8479421,Jacob Moverare,D,LAK,25,5,0,0,0
9,8479329,Frederic Allard,D,MTL,26,0,0,0,0
9,8481600,Tobias Bjornfot,D,VGK,22,3,0,0,0
9,8477462,Robert Hagg,D,ANA,28,5,0,0,0
9,8476470,Nathan Beaulieu,D,ANA,31,0,0,0,0
9,8484254,Akito Hirose,D,VAN,24,3,0,0,0
9,8479388,Riley Stillman,D,BUF,25,0,0,0,0
9,8482824,Nick Cicek,D,SJS,23,0,0,0,0
9,8480056,Jack Rathbone,D,VAN,24,0,0,0,0
9,8476850,Ryan Murray,D,EDM,30,0,0,0,0
9,8478841,Colton White,D,ANA,26,0,0,0,0
9,8480160,Radim Simek,D,SJS,31,0,0,0,0
9,8478491,Jacob Larsson,D,OTT,26,0,0,0,0
9,8475857,Kevin Gravel,D,NSH,31,0,0,0,0
9,8482067,Connor Mackey,D,NYR,27,1,0,0,0
9,8477433,Ben Harpur,D,NYR,28,0,0,0,0
9,8481572,Ville Heinola,D,WPG,22,0,0,0,0
9,8478415,Jakub Zboril,D,BOS,26,0,0,0,0
9,8477341,Andreas Johnsson,L,SJS,29,0,0,0,0
9,8480216,Jacob Peterson,C,SJS,24,6,0,0,0
9,8477467,Gustav Olofsson,D,SEA,29,0,0,0,0
9,8478476,Kyle Capobianco,D,WPG,26,0,0,0,0
9,8479985,Cale Fleury,D,SEA,25,0,0,0,0
9,8475227,Chris Wideman,D,MTL,33,0,0,0,0
9,8479333,Libor Hajek,D,NYR,25,0,0,0,0
9,8479376,Victor Mete,D,PHI,25,1,0,0,0
9,8480439,Mac Hollowell,D,TOR,25,0,0,0,0
9,8480467,Austin Strand,D,ANA,26,0,0,0,0
9,8477981,Roland McKeown,D,NSH,27,0,0,0,0
9,8474628,Michael Stone,D,CGY,33,0,0,0,0
9,8480034,Joel Teasdale,L,MTL,24,0,0,0,0
9,8481609,Vladislav Kolyachonok,D,ARI,22,1,0,0,0
9,8479602,Jeremy Davies,D,BUF,27,0,0,0,0
9,8479639,Dylan Coghlan,D,CAR,25,0,0,0,0
9,8478506,Gabriel Carlsson,D,WSH,26,0,0,0,0
9,8477463,Steven Santini,D,STL,28,0,0,0,0
9,8478075,Anders Bjork,L,CHI,27,0,0,0,0
9,8484287,Cole McWard,D,VAN,22,1,0,0,0
9,8474145,Robert Bortuzzo,D,NYI,34,15,0,0,0
9,8475625,Matt Irwin,D,WSH,36,0,0,0,0
9,8482179,Justin Richards,C,CBJ,25,0,0,0,0
9,8481649,Joona Luoto,L,CBJ,26,0,0,0,0
9,8479026,Philippe Myers,D,TBL,26,5,0,0,0
9,8480935,Lawrence Pilut,D,BUF,28,0,0,0,0
9,8479578,Casey Fitzgerald,D,FLA,26,0,0,0,0
9,8480071,Robin Salo,D,NYI,25,0,0,0,0
9,8478224,Luke Philp,C,CHI,28,0,0,0,0
9,8484125,Hunter McKown,C,CBJ,21,0,0,0,0
9,8481679,Maxence Guenette,D,OTT,22,1,0,0,0
9,8479423,Alex Nylander,L,PIT,25,5,0,0,0
9,8480441,Trey Fix-Wolansky,R,CBJ,24,1,0,0,0
9,8480820,Filip Kral,D,TOR,24,0,0,0,0
9,8479523,Lucas Carlsson,D,FLA,26,0,0,0,0
9,8479304,Kyle Criscuolo,C,SJS,31,0,0,0,0
9,8474697,Mark Borowiecki,D,NSH,34,0,0,0,0
9,8480842,Filip Hallander,C,PIT,23,0,0,0,0
9,8481725,Elmer Soderblom,L,DET,22,0,0,0,0
9,8479252,Dan Renouf,D,BOS,29,0,0,0,0
9,8481591,Sam Poulin,R,PIT,22,0,0,0,0
9,8475968,Alex Belzile,R,MTL,32,0,0,0,0
9,8475772,Riley Sheahan,C,BUF,32,0,0,0,0
9,8475163,Alex Chiasson,R,DET,33,0,0,0,0
9,8481598,Philip Broberg,D,EDM,22,10,0,0,0
9,8478455,Austin Wagner,L,CHI,26,0,0,0,0
9,8476779,Brad Hunt,D,COL,35,0,0,0,0
9,8479335,Rasmus Asplund,C,NSH,26,0,0,0,0
9,8478967,Lane Pederson,C,CBJ,26,0,0,0,0
9,8481077,John Leonard,L,NSH,25,0,0,0,0
9,8481585,Egor Afanasyev,L,NSH,22,2,0,0,0
9,8483397,Marc McLaughlin,C,BOS,24,0,0,0,0
9,8480443,Kristian Reichel,C,WPG,25,0,0,0,0
9,8481751,Lukas Rousek,R,BUF,24,5,0,0,0
9,8476396,Steven Fogarty,C,MIN,30,0,0,0,0
9,8478881,Brett Seney,L,CHI,27,4,0,0,0
9,8480326,Sheldon Dries,C,VAN,29,0,0,0,0
9,8481433,Taro Hirose,L,DET,27,0,0,0,0
9,8480833,Vitali Kravtsov,R,VAN,24,0,0,0,0
9,8481550,Adam Beckman,L,MIN,22,0,0,0,0
9,8479972,Mason Shaw,C,MIN,25,0,0,0,0
9,8477460,Laurent Dauphin,C,ARI,28,0,0,0,0
9,8476166,Taylor Fedun,D,PIT,35,0,0,0,0
9,8478067,Oskar Lindblom,L,SJS,27,1,0,0,0
9,8479944,Zach Aston-Reese,C,DET,29,1,0,0,0
9,8479465,Drake Caggiula,L,PIT,29,0,0,0,0
9,8481740,Tyce Thompson,R,NJD,24,0,0,0,0
9,8476948,Charles Hudon,L,COL,29,0,0,0,0
9,8480863,Gabriel Fortier,L,TBL,23,0,0,0,0
9,8471887,Patric Hornqvist,R,FLA,36,0,0,0,0
9,8477471,Dillon Heatherington,D,OTT,28,0,0,0,0
9,8481441,Joe Snively,C,WSH,27,3,0,0,0
9,8478173,Hayden Hodgson,R,PHI,27,0,0,0,0
9,8481720,Nick Abruzzese,C,TOR,24,0,0,0,0
9,8478843,Denis Malgin,C,COL,26,0,0,0,0
9,8483630,Pavol Regenda,L,ANA,24,0,0,0,0
9,8478373,Nikita Soshnikov,R,NYI,30,0,0,0,0
9,8482147,Jean-Luc Foudy,C,COL,21,0,0,0,0
9,8478431,Evgeny Svechnikov,L,SJS,27,0,0,0,0
9,8477210,Buddy Robinson,R,CHI,32,0,0,0,0
9,8479404,Henrik Borgstrom,C,WSH,26,0,0,0,0
9,8481712,Matej Blumel,R,DAL,23,0,0,0,0
9,8475278,Byron Froese,C,VGK,32,7,0,0,0
9,8479338,Markus Niemelainen,D,EDM,25,0,0,0,0
9,8471794,Darren Helm,C,COL,36,0,0,0,0
9,8482623,Josh Dunne,C,CBJ,25,0,0,0,0
9,8482641,Matt Kiersted,D,FLA,25,0,0,0,0
9,8476851,Alex Galchenyuk,C,COL,29,0,0,0,0
9,8479366,Logan Brown,C,STL,25,0,0,0,0
9,8480822,Martin Kaut,R,SJS,24,0,0,0,0
9,8482834,Jesper Froden,R,SEA,29,0,0,0,0
9,8480844,Grigori Denisenko,L,VGK,23,3,0,0,0
9,8482635,Mike Hardman,L,CHI,24,0,0,0,0
9,8477357,Saku Maenalanen,R,WPG,29,0,0,0,0
9,8480979,Nathan Smith,C,ARI,25,0,0,0,0
9,8479356,Kieffer Bellows,L,PHI,25,0,0,0,0
9,8475795,Dylan McIlrath,D,WSH,31,1,0,0,0
9,8478400,Colin White,C,PIT,26,9,0,0,0
9,8478446,Glenn Gawdin,C,ANA,26,0,0,0,0
9,8476326,Josh Archibald,R,PIT,31,0,0,0,0
9,8481683,Aidan McDonough,L,VAN,24,0,0,0,0
9,8480267,Sammy Walker,C,MIN,24,4,0,0,0
9,8477520,Jean-Sebastien Dea,C,ARI,29,0,0,0,0
9,8476439,Brett Ritchie,R,ARI,30,0,0,0,0
9,8479518,Fredrik Karlström,C,DAL,25,0,0,0,0
9,8477126,Jayson Megna,C,ANA,33,0,0,0,0
9,8479644,Matt Luff,R,DET,26,0,0,0,0
9,8478211,Dryden Hunt,L,CGY,28,5,0,0,0
9,8480226,Marián Studenic,R,SEA,25,2,0,0,0
9,8480037,Aleksi Heponiemi,C,FLA,24,0,0,0,0
9,8480292,Carson Meyer,R,CBJ,26,0,0,0,0
9,8482634,Alex Steeves,C,TOR,24,1,0,0,0
9,8475178,Zack Kassian,R,ARI,32,0,0,0,0
9,8483524,Shane Wright,C,SEA,19,3,0,0,0
9,8482654,Jackson Cates,C,PHI,26,0,0,0,0
9,8479550,Tanner Laczynski,C,PHI,26,0,0,0,0
9,8479991,Jake Leschyshyn,C,NYR,24,1,0,0,0
9,8474613,Derek Stepan,C,CAR,33,0,0,0,0
9,8478367,Cole Bardreau,C,NYI,30,0,0,0,0
9,8480890,Jan Jenik,R,ARI,23,1,0,0,0
9,8475160,Kyle Clifford,L,TOR,32,0,0,0,0
9,8479705,Jeffrey Viel,L,SJS,26,0,0,0,0
9,8477401,John Hayden,C,SEA,28,2,0,0,0
9,8480846,Sampo Ranta,L,COL,23,0,0,0,0
9,8482691,Aatu Raty,C,VAN,21,0,0,0,0
9,8481070,Hugh McGing,L,STL,25,5,0,0,0
9,8479573,Mikhail Maltsev,L,COL,25,0,0,0,0
9,8482250,Callahan Burke,C,CAR,26,1,0,0,0
9,8481102,Egor Sokolov,L,OTT,23,0,0,0,0
9,8481518,Nolan Foote,L,NJD,23,0,0,0,0
9,8474190,Wayne Simmonds,R,TOR,35,0,0,0,0
9,8474610,Zac Dalpe,C,FLA,34,0,0,0,0
9,8479347,Tyler Benson,L,EDM,25,0,0,0,0
9,8476404,Andy Andreoff,C,NYI,32,0,0,0,0
9,8476390,Joseph Cramarossa,C,MIN,31,0,0,0,0
9,8483549,Lucas Condotta,L,MTL,26,3,0,0,0
9,8482197,Adam Raska,R,MIN,22,5,0,0,0
9,8479533,Joona Koppanen,L,PIT,25,3,0,0,0
9,8479526,Otto Koivula,L,NYI,25,0,0,0,0
9,8479375,William Bitten,C,STL,25,0,0,0,0
9,8474089,Brad Malone,C,EDM,34,0,0,0,0
9,8478058,CJ Suess,L,SJS,29,0,0,0,0
9,8478147,Bokondji Imama,L,ARI,27,0,0,0,0
9,8477320,Anton Blidh,L,NYR,28,1,0,0,0
9,8477993,Justin Kirkland,C,ARI,27,2,0,0,0
9,8480836,Jonathan Gruden,C,PIT,23,5,0,0,0
9,8480032,Shane Bowers,C,NJD,24,3,0,0,0
10,8476453,Nikita Kucherov,R,TBL,30,81,53,80,133
10,8478402,Connor McDavid,C,EDM,26,80,36,90,126
10,8477492,Nathan MacKinnon,C,COL,28,82,45,74,119
10,8477939,William Nylander,R,TOR,27,82,48,70,118
10,8477956,David Pastrnak,R,BOS,27,82,48,66,114
10,8480012,Elias Pettersson,C,VAN,25,81,44,69,113
10,8476468,J.T. Miller,C,VAN,30,81,40,69,109
10,8479318,Auston Matthews,C,TOR,26,81,73,34,107
10,8478420,Mikko Rantanen,R,COL,27,82,46,60,106
10,8478550,Artemi Panarin,L,NYR,32,82,45,60,105
10,8480069,Cale Makar,D,COL,25,77,21,79,100
10,8477933,Sam Reinhart,C,FLA,28,82,55,44,99
10,8479314,Matthew Tkachuk,L,FLA,26,82,30,69,99
10,8478483,Mitchell Marner,R,TOR,26,81,38,60,98
10,8477493,Aleksander Barkov,C,FLA,28,76,20,77,97
10,8480023,Robert Thomas,C,STL,24,82,28,65,93
10,8477934,Leon Draisaitl,C,EDM,28,82,35,55,90
10,8479407,Jesper Bratt,L,NJD,25,81,34,55,89
10,8477409,Carter Verhaeghe,C,FLA,28,82,41,47,88
10,8478864,Kirill Kaprizov,L,MIN,26,75,36,51,87
10,8480800,Quinn Hughes,D,VAN,24,81,16,71,87
10,8480865,Noah Dobson,D,NYI,23,82,11,76,87
10,8475167,Victor Hedman,D,TBL,33,80,11,76,87
10,8477404,Jake Guentzel,L,PIT,29,81,39,47,86
10,8478427,Sebastian Aho,C,CAR,26,78,32,54,86
10,8480027,Jason Robertson,L,DAL,24,82,27,58,85
10,8478449,Roope Hintz,C,DAL,27,80,36,48,84
10,8478439,Travis Konecny,R,PHI,26,81,39,44,83
10,8478010,Brayden Point,C,TBL,27,82,38,44,82
10,8471675,Sidney Crosby,C,PIT,36,82,42,39,81
10,8481559,Jack Hughes,C,NJD,22,65,30,51,81
10,8476459,Mika Zibanejad,C,NYR,30,81,24,57,81
10,8474600,Roman Josi,D,NSH,33,82,21,60,81
10,8478403,Jack Eichel,C,VGK,27,70,35,45,80
10,8476389,Vincent Trocheck,C,NYR,30,82,29,51,80
10,8480803,Evan Bouchard,D,EDM,24,82,24,56,80
10,8479343,Clayton Keller,R,ARI,25,82,36,42,78
10,8475913,Mark Stone,R,VGK,31,81,30,48,78
10,8475786,Zach Hyman,L,EDM,31,81,47,30,77
10,8478444,Brock Boeser,R,VAN,26,81,41,36,77
10,8477500,Bo Horvat,C,NYI,28,81,34,43,77
10,8479542,Brandon Hagel,L,TBL,25,82,28,49,77
10,8474564,Steven Stamkos,C,TBL,33,79,34,42,76
10,8475745,Charlie Coyle,C,BOS,31,82,32,44,76
10,8480018,Nick Suzuki,C,MTL,24,82,29,47,76
10,8475184,Chris Kreider,L,NYR,32,82,39,36,75
10,8477946,Dylan Larkin,C,DET,27,76,38,37,75
10,8475168,Matt Duchene,C,DAL,32,81,28,47,75
10,8476454,Ryan Nugent-Hopkins,C,EDM,30,82,22,52,74
10,8475158,Ryan O'Reilly,C,NSH,32,82,31,42,73
10,8478445,Mathew Barzal,C,NYI,26,81,18,54,72
10,8476887,Filip Forsberg,L,NSH,29,82,34,36,70
10,8473419,Brad Marchand,L,BOS,35,82,32,38,70
10,8470794,Joe Pavelski,C,DAL,39,82,28,42,70
10,8478975,Mason Marchment,L,DAL,28,81,27,43,70
10,8471214,Alex Ovechkin,L,WSH,38,79,26,44,70
10,8480801,Brady Tkachuk,L,OTT,24,82,39,30,69
10,8473512,Claude Giroux,R,OTT,35,82,27,42,69
10,8478407,Vince Dunn,D,SEA,27,78,12,57,69
10,8475794,Tyler Seguin,C,DAL,31,82,31,37,68
10,8479337,Alex DeBrincat,R,DET,26,82,27,41,68
10,8475166,John Tavares,C,TOR,33,80,24,44,68
10,8482116,Tim Stützle,C,OTT,21,82,17,51,68
10,8477501,Valeri Nichushkin,R,COL,28,67,34,33,67
10,8481540,Cole Caufield,R,MTL,22,82,28,39,67
10,8478873,Troy Terry,R,ANA,26,79,24,42,66
10,8476875,Mike Matheson,D,MTL,29,82,10,56,66
10,8476539,Jonathan Marchessault,R,VGK,33,81,40,25,65
10,8479385,Jordan Kyrou,C,STL,25,82,30,35,65
10,8471215,Evgeni Malkin,C,PIT,37,82,28,37,65
10,8477960,Adrian Kempe,R,LAK,27,82,26,39,65
10,8478493,Joel Eriksson Ek,C,MIN,26,82,34,30,64
10,8476460,Mark Scheifele,C,WPG,30,75,23,41,64
10,8477942,Kevin Fiala,L,LAK,27,82,22,42,64
10,8476853,Morgan Rielly,D,TOR,29,79,10,54,64
10,8479425,Filip Hronek,D,VAN,26,81,6,58,64
10,8471685,Anze Kopitar,C,LAK,36,82,23,40,63
10,8480839,Rasmus Dahlin,D,BUF,23,81,19,44,63
10,8479323,Adam Fox,D,NYR,25,72,8,55,63
10,8475754,Brock Nelson,C,NYI,32,82,34,28,62
10,8476448,William Karlsson,C,VGK,30,69,26,36,62
10,8477402,Pavel Buchnevich,L,STL,28,80,24,38,62
10,8480797,Joel Farabee,L,PHI,23,81,24,38,62
10,8479999,Casey Mittelstadt,C,BUF,25,82,18,44,62
10,8475172,Nazem Kadri,C,CGY,33,82,23,38,61
10,8476882,Teuvo Teravainen,L,CAR,29,81,27,33,60
10,8481068,Yegor Sharangovich,C,CGY,25,82,31,28,59
10,8480002,Nico Hischier,C,NJD,24,70,25,34,59
10,8480208,Drake Batherson,R,OTT,25,82,24,35,59
10,8477346,MacKenzie Weegar,D,CGY,29,82,22,37,59
10,8475765,Vladimir Tarasenko,R,OTT,32,80,20,39,59
10,8474679,Gustav Nyquist,C,NSH,34,82,18,41,59
10,8481557,Matt Boldy,L,MIN,22,75,32,26,58
10,8475169,Evander Kane,L,EDM,32,81,29,29,58
10,8480039,Martin Necas,C,CAR,24,76,25,33,58
10,8476456,Jonathan Huberdeau,C,CGY,30,81,16,42,58
10,8480036,Miro Heiskanen,D,DAL,24,72,10,48,58
10,8478366,Frank Vatrano,R,ANA,29,82,32,25,57
10,8477949,Alex Tuch,R,BUF,27,75,25,32,57
10,8474641,Adam Henrique,C,ANA,33,81,24,33,57
10,8475692,Mats Zuccarello,R,MIN,36,73,13,44,57
10,8477504,Josh Morrissey,D,WPG,28,81,12,45,57
10,8474578,Erik Karlsson,D,PIT,33,82,9,48,57
10,8477955,Jared McCann,L,SEA,27,81,30,26,56
10,8477496,Elias Lindholm,C,VAN,29,81,19,37,56
10,8476399,Blake Coleman,C,CGY,32,82,28,27,55
10,8479420,Tage Thompson,C,BUF,26,72,27,28,55
10,8477416,Oliver Bjorkstrand,R,SEA,28,82,19,36,55
10,8475810,Bryan Rust,R,PIT,31,69,25,29,54
10,8482124,Quinton Byfield,R,LAK,21,80,20,34,54
10,8482078,Lucas Raymond,L,DET,21,82,19,35,54
10,8478440,Dylan Strome,C,WSH,26,82,32,21,53
10,8477951,Nick Schmaltz,C,ARI,27,79,21,32,53
10,8478401,Pavel Zacha,C,BOS,26,78,21,32,53
10,8475784,Jeff Skinner,L,BUF,31,74,23,29,52
10,8482740,Wyatt Johnston,C,DAL,20,82,23,29,52
10,8471724,Kris Letang,D,PIT,36,82,8,44,52
10,8475726,Tyler Toffoli,R,NJD,31,80,35,16,51
10,8478398,Kyle Connor,L,WPG,27,65,31,20,51
10,8479675,Trevor Moore,L,LAK,28,82,30,21,51
10,8477940,Nikolaj Ehlers,L,WPG,27,81,24,27,51
10,8477497,Sean Monahan,C,WPG,29,83,21,30,51
10,8482093,Seth Jarvis,C,CAR,21,81,20,31,51
10,8480798,Philipp Kurashev,C,CHI,24,75,18,33,51
10,8479345,Jakob Chychrun,D,OTT,25,82,17,34,51
10,8478038,Devon Toews,D,COL,29,82,15,36,51
10,8479325,Charlie McAvoy,D,BOS,26,74,13,38,51
10,8476881,Tomas Hertl,C,SJS,30,76,21,29,50
10,8477456,J.T. Compher,L,DET,28,77,19,31,50
10,8478542,Evan Rodrigues,C,FLA,30,82,17,33,50
10,8482745,Mason McTavish,C,ANA,20,74,23,26,49
10,8478462,Nicolas Roy,C,VGK,26,72,19,30,49
10,8478519,Anthony Cirelli,C,TBL,26,81,19,30,49
10,8480830,Andrei Svechnikov,R,CAR,23,60,18,31,49
10,8474037,James van Riemsdyk,L,BOS,34,78,17,32,49
10,8476346,Johnny Gaudreau,L,CBJ,30,81,11,38,49
10,8481711,Matias Maccelli,L,ARI,23,82,11,38,49
10,8477948,Travis Sanheim,D,PHI,27,80,10,39,49
10,8479365,Trent Frederic,C,BOS,25,82,24,24,48
10,8482149,Cole Perfetti,C,WPG,21,81,23,25,48
10,8475170,Brayden Schenn,C,STL,32,82,21,27,48
10,8481528,Dylan Cozens,C,BUF,22,79,16,32,48
10,8473994,Jamie Benn,L,DAL,34,82,15,33,48
10,8478474,Lawson Crouse,L,ARI,26,81,29,18,47
10,8482175,JJ Peterka,R,BUF,21,82,23,24,47
10,8475151,Kyle Palmieri,C,NYI,32,82,22,25,47
10,8478047,Michael Bunting,L,CAR,28,80,17,30,47
10,8476458,Ryan Strome,C,ANA,30,79,17,30,47
10,8470613,Brent Burns,D,CAR,38,81,16,31,47
10,8474590,John Carlson,D,WSH,33,82,7,40,47
10,8480009,Eeli Tolvanen,R,SEA,24,82,22,24,46
10,8474586,Jordan Eberle,R,SEA,33,78,15,31,46
10,8476479,Phillip Danault,C,LAK,30,82,14,32,46
10,8478396,Noah Hanifin,D,CGY,26,82,12,34,46
10,8479400,Pierre-Luc Dubois,C,LAK,25,82,21,24,45
10,8475799,Nino Niederreiter,R,WPG,31,81,20,25,45
10,8477021,Alex Kerfoot,C,ARI,29,82,12,33,45
10,8476906,Shayne Gostisbehere,D,DET,30,81,9,36,45
10,8476792,Torey Krug,D,STL,32,82,3,42,45
10,8478460,Zach Werenski,D,CBJ,26,69,2,43,45
10,8477450,Jason Dickinson,C,CHI,28,82,25,19,44
10,8480064,Josh Norris,C,OTT,24,75,23,21,44
10,8481581,Thomas Harley,D,DAL,22,79,21,23,44
10,8480015,Owen Tippett,R,PHI,24,77,24,19,43
10,8482109,Alexis Lafrenière,L,NYR,22,82,22,21,43
10,8471218,Blake Wheeler,R,NYR,37,82,19,24,43
10,8478233,Andrew Mangiapane,L,CGY,27,81,17,26,43
10,8483515,Juraj Slafkovsky,L,MTL,19,82,16,27,43
10,8476483,Rickard Rakell,R,PIT,30,70,14,29,43
10,8478397,Rasmus Andersson,D,CGY,27,78,13,30,43
10,8477494,Jonathan Drouin,L,COL,28,80,10,33,43
10,8475798,Mikael Granlund,C,SJS,31,68,7,36,43
10,8474150,Mikael Backlund,C,CGY,34,82,16,26,42
10,8474563,Drew Doughty,D,LAK,34,82,15,27,42
10,8480028,Morgan Frost,C,PHI,24,70,15,27,42
10,8475760,Nick Bjugstad,C,ARI,31,82,15,27,42
10,8476905,Chandler Stephenson,C,VGK,29,77,11,31,42
10,8481542,Moritz Seider,D,DET,22,82,7,35,42
10,8475764,Cam Fowler,D,ANA,32,82,5,37,42
10,8482122,Brock Faber,D,MIN,21,82,4,38,42
10,8474565,Alex Pietrangelo,D,VGK,33,76,4,38,42
10,8477935,Sam Bennett,C,FLA,27,70,19,22,41
10,8482475,Yegor Chinakhov,R,CBJ,22,69,19,22,41
10,8482079,Marco Rossi,C,MIN,22,82,18,23,41
10,8477964,Ivan Barbashev,C,VGK,28,81,17,24,41
10,8476925,Colton Sissons,C,NSH,30,82,21,19,40
10,8475768,Jaden Schwartz,C,SEA,31,66,21,19,40
10,8478414,Timo Meier,R,NJD,27,68,20,20,40
10,8477426,Nicholas Paul,L,TBL,28,82,19,21,40
10,8475191,Reilly Smith,R,PIT,32,76,18,22,40
10,8477429,Andrew Copp,C,DET,29,81,17,23,40
10,8476927,Teddy Blueger,C,VAN,29,67,13,27,40
10,8478055,Gustav Forsling,D,FLA,27,81,12,28,40
10,8476869,Brady Skjei,D,CAR,29,81,10,30,40
10,8477451,Ryan Hartman,R,MIN,29,77,21,18,39
10,8478438,Tommy Novak,C,NSH,26,71,15,24,39
10,8474141,Patrick Kane,R,DET,35,51,14,25,39
10,8475763,Kevin Hayes,R,STL,31,82,14,25,39
10,8482684,Luke Hughes,D,NJD,20,81,11,28,39
10,8478057,Dakota Joshua,C,VAN,27,79,21,17,38
10,8479525,Ross Colton,C,COL,27,80,17,21,38
10,8482113,Anton Lundell,C,FLA,22,78,15,23,38
10,8478891,Mason Appleton,C,WPG,27,81,15,23,38
10,8473986,Alex Killorn,L,ANA,34,63,13,25,38
10,8475287,Erik Haula,L,NJD,32,75,13,25,38
10,8476826,Yanni Gourde,C,SEA,32,80,13,25,38
10,8482665,Matty Beniers,C,SEA,21,77,12,26,38
10,8477503,Max Domi,C,TOR,28,82,7,31,38
10,8477511,Anthony Mantha,R,WSH,29,78,22,15,37
10,8475714,Calle Jarnkrok,C,TOR,32,75,17,20,37
10,8478472,Mathieu Joseph,R,OTT,26,72,11,26,37
10,8476438,Brandon Saad,L,STL,31,82,23,13,36
10,8480893,Kirill Marchenko,R,CBJ,23,79,20,16,36
10,8475722,Jason Zucker,L,ARI,31,72,17,19,36
10,8474102,David Perron,L,DET,35,76,16,20,36
10,8475149,Marcus Johansson,L,MIN,33,82,14,22,36
10,8482667,William Eklund,L,SJS,21,80,14,22,36
10,8476419,Jean-Gabriel Pageau,C,NYI,31,82,11,25,36
10,8475744,Evgeny Kuznetsov,C,WSH,31,72,11,25,36
10,8480434,Sean Durzi,D,ARI,25,76,9,27,36
10,8475314,Anders Lee,L,NYI,33,82,26,9,35
10,8479992,Michael Rasmussen,C,DET,24,82,17,18,35
10,8474884,Mike Hoffman,C,SJS,34,79,16,19,35
10,8482146,Luke Evangelista,R,NSH,21,80,14,21,35
10,8476897,Oskar Sundqvist,C,STL,29,82,11,24,35
10,8476462,Dougie Hamilton,D,NJD,30,48,8,27,35
10,8478469,Thomas Chabot,D,OTT,26,60,6,29,35
10,8476979,Erik Gustafsson,D,NYR,31,81,5,30,35
10,8482089,Jake Neighbours,L,STL,21,82,23,11,34
10,8482110,Dawson Mercer,C,NJD,22,81,20,14,34
10,8474870,Tyler Johnson,C,CHI,33,67,19,15,34
10,8481186,Logan O'Connor,R,COL,27,78,18,16,34
10,8474149,Evgenii Dadonov,R,DAL,34,77,18,16,34
10,8473422,Nick Foligno,L,CHI,36,75,15,19,34
10,8479415,Michael McLeod,C,NJD,25,73,15,19,34
10,8482092,Ridly Greig,C,OTT,21,72,14,20,34
10,8478466,Daniel Sprong,R,DET,26,54,14,20,34
10,8478856,Conor Garland,R,VAN,27,81,13,21,34
10,8477998,Warren Foegele,L,EDM,27,82,13,21,34
10,8477479,Tyler Bertuzzi,L,TOR,28,81,11,23,34
10,8475218,Mattias Ekholm,D,EDM,33,81,7,27,34
10,8476480,Vladislav Namestnikov,C,WPG,31,78,6,28,34
10,8477495,Seth Jones,D,CHI,29,67,4,30,34
10,8475753,Justin Faulk,D,STL,31,68,3,31,34
10,8482159,Tyson Foerster,R,PHI,21,78,21,12,33
10,8471698,T.J. Oshie,R,WSH,37,65,18,15,33
10,8482125,Alexander Holtz,R,NJD,21,81,18,15,33
10,8474157,Max Pacioretty,L,WSH,35,47,13,20,33
10,8482720,Matthew Knies,L,TOR,21,80,13,20,33
10,8481618,Alex Newhook,C,MTL,22,55,12,21,33
10,8477505,Alex Wennberg,C,SEA,29,82,11,22,33
10,8476292,Ondrej Palat,L,NJD,32,71,11,22,33
10,8479987,Morgan Geekie,C,BOS,25,76,10,23,33
10,8477447,Shea Theodore,D,VGK,28,48,8,25,33
10,8477498,Darnell Nurse,D,EDM,28,82,8,25,33
10,8477969,Marcus Pettersson,D,PIT,27,82,3,30,33
10,8480188,Fabian Zetterlund,L,SJS,24,81,21,11,32
10,8478498,Jake DeBrusk,L,BOS,27,80,17,15,32
10,8476880,Tom Wilson,R,WSH,29,81,17,15,32
10,8478046,Danton Heinen,L,BOS,28,74,17,15,32
10,8476392,Adam Lowry,C,WPG,30,81,12,20,32
10,8476872,Scott Laughton,C,PHI,29,81,10,22,32
10,8482655,J.J. Moser,D,ARI,23,80,6,26,32
10,8478500,Ivan Provorov,D,CBJ,26,81,5,27,32
10,8475181,Nick Leddy,D,STL,32,82,5,27,32
10,8476854,Hampus Lindholm,D,BOS,29,82,1,31,32
10,8479619,Michael Carcone,L,ARI,27,76,23,8,31
10,8477952,Robby Fabbri,C,DET,27,68,19,12,31
10,8478043,Sam Lafferty,C,VAN,28,79,17,14,31
10,8481624,Ilya Mikheyev,R,VAN,29,77,15,16,31
10,8483808,Andrei Kuzmenko,L,CGY,27,76,12,19,31
10,8477476,Artturi Lehkonen,L,COL,28,47,10,21,31
10,8476885,Jacob Trouba,D,NYR,29,80,8,23,31
10,8480145,Neal Pionk,D,WPG,28,81,7,24,31
10,8482245,Artem Zub,D,OTT,28,72,4,27,31
10,8478013,Jake Walman,D,DET,27,76,17,13,30
10,8480459,Pius Suter,C,VAN,27,67,16,14,30
10,8476892,Colton Parayko,D,STL,30,82,15,15,30
10,8478020,Michael Amadio,R,VGK,27,74,14,16,30
10,8478413,Jordan Greenway,L,BUF,26,70,13,17,30
10,8480802,Ryan McLeod,C,EDM,24,81,13,17,30
10,8480813,Joe Veleno,C,DET,23,80,12,18,30
10,8475193,Tomas Tatar,L,SEA,33,78,12,18,30
10,8478463,Anthony Beauvillier,L,CHI,26,64,12,18,30
10,8475171,Oliver Ekman-Larsson,D,FLA,32,82,10,20,30
10,8482055,Drew O'Connor,L,PIT,25,82,10,20,30
10,8476960,Andreas Athanasiou,C,CHI,29,38,10,20,30
10,8480817,K'Andre Miller,D,NYR,23,80,9,21,30
10,8477986,Brandon Montour,D,FLA,29,66,8,22,30
10,8479941,Justin Danforth,R,CBJ,30,81,17,12,29
10,8475793,Ryan Johansen,C,COL,31,82,16,13,29
10,8477425,Miles Wood,L,COL,28,77,15,14,29
10,8481582,Nicholas Robertson,L,TOR,22,64,15,14,29
10,8480014,Gabriel Vilardi,C,WPG,24,61,14,15,29
10,8480113,Alex Iafallo,L,WPG,30,81,13,16,29
10,8482105,Jake Sanderson,D,OTT,21,79,10,19,29
10,8476921,Jordan Martinook,L,CAR,31,81,10,19,29
10,8482062,Cole Smith,L,NSH,28,81,10,19,29
10,8479351,Sam Steel,C,DAL,25,77,9,20,29
10,8481032,Paul Cotter,C,VGK,24,80,9,20,29
10,8476958,Jaccob Slavin,D,CAR,29,81,5,24,29
10,8476902,Esa Lindell,D,DAL,29,82,5,24,29
10,8476432,Boone Jenner,C,CBJ,30,66,18,10,28
10,8480829,Jesperi Kotkaniemi,C,CAR,23,81,15,13,28
10,8475343,Nic Dowd,C,WSH,33,73,13,15,28
10,8476474,Stefan Noesen,R,CAR,30,52,11,17,28
10,8481524,Bowen  Byram,D,COL,22,74,11,17,28
10,8476923,Damon Severson,D,CBJ,29,66,10,18,28
10,8481577,Philip Tomasino,C,NSH,22,68,10,18,28
10,8479410,Mikhail Sergachev,D,TBL,25,60,2,26,28
10,8475906,John Klingberg,D,TOR,31,43,1,27,28
10,8476918,Jimmy Vesey,L,NYR,30,80,18,9,27
10,8481604,Pavel Dorofeyev,L,VGK,23,57,15,12,27
10,8482097,Jack Quinn,R,BUF,22,45,15,12,27
10,8477407,Anthony Duclair,L,SJS,28,76,13,14,27
10,8474189,Lars Eller,C,PIT,34,82,13,14,27
10,8481533,Trevor Zegras,C,ANA,22,48,9,18,27
10,8480855,Jack McBain,C,ARI,23,67,9,18,27
10,8475188,Brayden McNabb,D,VGK,32,81,3,24,27
10,8478115,Pierre Engvall,L,NYI,27,76,13,13,26
10,8481580,Connor McMichael,C,WSH,22,80,13,13,26
10,8479339,Patrik Laine,L,CBJ,25,47,13,13,26
10,8470621,Corey Perry,R,EDM,38,54,12,14,26
10,8478136,Jake Middleton,D,MIN,27,82,11,15,26
10,8473533,Jordan Staal,C,CAR,35,81,10,16,26
10,8476312,Josh Manson,D,COL,32,77,9,17,26
10,8478178,Darren Raddysh,D,TBL,27,82,8,18,26
10,8480336,Sean Walker,D,PHI,29,81,8,18,26
10,8478851,Alexandre Carrier,D,NSH,27,77,7,19,26
10,8478911,Matt Roy,D,LAK,28,81,6,20,26
10,8473507,Jeff Petry,D,DET,36,73,5,21,26
10,8474151,Ryan McDonagh,D,NSH,34,75,4,22,26
10,8476469,Joel Armia,R,MTL,30,66,18,7,25
10,8475220,Marcus Foligno,L,MIN,32,75,12,13,25
10,8482705,Cole Sillinger,C,CBJ,20,76,11,14,25
10,8477508,Curtis Lazar,C,NJD,28,76,9,16,25
10,8477953,Kasperi Kapanen,R,STL,27,75,8,17,25
10,8481596,Shane Pinto,C,OTT,23,41,8,17,25
10,8476422,Mike Reilly,D,NYI,30,61,6,19,25
10,8476931,Jake McCabe,D,TOR,30,76,5,20,25
10,8479398,Samuel Girard,D,COL,25,61,4,21,25
10,8477932,Aaron Ekblad,D,FLA,27,64,4,21,25
10,8480873,Rasmus Sandin,D,WSH,23,74,3,22,25
10,8481535,Nils Hoglander,L,VAN,23,53,17,7,24
10,8477330,Dominik Kubalik,L,OTT,28,78,17,7,24
10,8478831,Kevin Stenlund,C,FLA,27,82,16,8,24
10,8473449,Kyle Okposo,R,BUF,35,79,14,10,24
10,8479591,Michael Eyssimont,C,TBL,27,81,12,12,24
10,8475791,Taylor Hall,L,CHI,32,37,9,15,24
10,8480835,Jack Drury,C,CAR,23,53,8,16,24
10,8481546,Cam York,D,PHI,22,81,7,17,24
10,8476463,Jonas Brodin,D,MIN,30,64,6,18,24
10,8478507,John Marino,D,NJD,26,81,5,19,24
10,8474574,Tyler Myers,D,VAN,33,81,4,20,24
10,8482671,Owen Power,D,BUF,21,79,3,21,24
10,8480185,Eetu Luostarinen,C,FLA,25,82,15,8,23
10,8482111,Justin Barron,D,MTL,22,68,13,10,23
10,8482157,Will Cuylle,L,NYR,21,82,12,11,23
10,8474053,Logan Couture,C,SJS,34,34,12,11,23
10,8475462,Radko Gudas,D,ANA,33,76,11,12,23
10,8475855,Jesper Fast,R,CAR,32,78,10,13,23
10,8481560,Arthur Kaliyev,R,LAK,22,68,9,14,23
10,8474602,Justin Schultz,D,SEA,33,72,5,18,23
10,8482087,Kaiden Guhle,D,MTL,21,78,5,18,23
10,8478458,Jack Roslovic,C,CBJ,26,58,4,19,23
10,8478840,Will Borgen,D,SEA,27,82,2,21,23
10,8480246,Nick Perbix,D,TBL,25,80,2,21,23
10,8479983,Mario Ferraro,D,SJS,25,77,2,21,23
10,8479661,Tanner Jeannot,L,TBL,26,68,12,10,22
10,8477947,Sonny Milano,L,WSH,27,53,11,11,22
10,8482222,Alexander Barabanov,L,SJS,29,61,8,14,22
10,8476329,Travis Boyd,C,ARI,30,45,8,14,22
10,8480078,Filip Chytil,C,NYR,24,38,7,15,22
10,8481014,Alexander Romanov,D,NYI,23,81,7,15,22
10,8480878,Nils Lundkvist,D,DAL,23,70,5,17,22
10,8478443,Brandon Carlo,D,BOS,27,77,5,17,22
10,8479998,Mikey Anderson,D,LAK,24,82,2,20,22
10,8476331,Dylan DeMelo,D,WPG,30,81,1,21,22
10,8474673,TJ Brodie,D,TOR,33,81,1,21,22
10,8481554,Kaapo Kakko,R,NYR,22,61,14,7,21
10,8481601,Simon Holmstrom,R,NYI,22,81,13,8,21
10,8478109,Victor Olofsson,L,BUF,28,63,10,11,21
10,8476981,Josh Anderson,R,MTL,29,78,9,12,21
10,8480068,Ryan Poehling,C,PHI,24,76,8,13,21
10,8475164,Jakob Silfverberg,R,ANA,33,81,6,15,21
10,8482073,Braden Schneider,D,NYR,22,82,5,16,21
10,8481656,Aliaksei Protas,C,WSH,22,52,4,17,21
10,8473563,Nicklas Backstrom,C,WSH,36,37,4,17,21
10,8476879,Cody Ceci,D,EDM,30,82,2,19,21
10,8475197,Tyson Barrie,D,NSH,32,62,2,19,21
10,8480049,Dylan Samberg,D,WPG,24,81,2,19,21
10,8477944,Jakub Vrana,L,STL,27,49,12,8,20
10,8477989,Christian Dvorak,C,MTL,27,52,10,10,20
10,8470638,Patrice Bergeron,C,BOS,38,27,10,10,20
10,8479977,Kailer Yamamoto,R,SEA,25,73,9,11,20
10,8481704,Juuso Parssinen,C,NSH,22,71,9,11,20
10,8475455,Brenden Dillon,D,WPG,33,78,8,12,20
10,8477444,Andre Burakovsky,L,SEA,28,51,6,14,20
10,8474166,Alec Martinez,D,VGK,36,64,6,14,20
10,8475200,Dmitry Orlov,D,CAR,32,81,4,16,20
10,8475790,Erik Gudbranson,D,CBJ,31,77,4,16,20
10,8480849,Barrett Hayton,C,ARI,23,50,4,16,20
10,8477950,Tony DeAngelo,D,CAR,28,51,3,17,20
10,8475279,Ben Chiarot,D,DET,32,77,3,17,20
10,8470600,Ryan Suter,D,DAL,38,82,3,17,20
10,8480796,Martin Fehervary,D,WSH,24,76,3,17,20
10,8478468,Jeremy Lauzon,D,NSH,26,82,11,8,19
10,8471699,Andrew Cogliano,C,COL,36,76,8,11,19
10,8479293,Brandon Tanev,L,SEA,32,66,8,11,19
10,8479353,Brett Howden,C,VGK,25,79,8,11,19
10,8476889,Radek Faksa,C,DAL,29,74,8,11,19
10,8478882,Vladislav Gavrikov,D,LAK,28,77,6,13,19
10,8482101,Danil Gushchin,L,SJS,21,30,6,13,19
10,8478133,Jake Evans,C,MTL,27,82,4,15,19
10,8475690,Chris Tanev,D,CGY,34,79,2,17,19
10,8470604,Jeff Carter,C,PIT,38,76,11,7,18
10,8478042,Viktor Arvidsson,R,LAK,30,32,9,9,18
10,8479359,Beck Malenstyn,L,WSH,25,81,7,11,18
10,8475233,David Savard,D,MTL,33,60,5,13,18
10,8480172,Jan Rutta,D,SJS,33,75,5,13,18
10,8477435,Ryan Graves,D,PIT,28,82,5,13,18
10,8476457,Adam Larsson,D,SEA,31,82,4,14,18
10,8475179,Dmitry Kulikov,D,FLA,33,78,1,17,18
10,8478508,Yakov Trenin,C,NSH,26,79,12,5,17
10,8476374,Sean Kuraly,C,CBJ,30,73,9,8,17
10,8481093,Rafael Harvey-Pinard,L,MTL,24,51,9,8,17
10,8475208,Brian Dumoulin,D,SEA,32,80,8,9,17
10,8479390,Taylor Raddysh,R,CHI,25,77,8,9,17
10,8481481,Blake Lizotte,C,LAK,26,64,7,10,17
10,8481522,Peyton Krebs,C,BUF,22,80,7,10,17
10,8480821,Filip Zadina,R,SJS,24,48,7,10,17
10,8479393,Noah Gregor,C,TOR,25,81,7,10,17
10,8480883,Ty Smith,D,PIT,23,31,5,12,17
10,8482117,Lukas Reichel,L,CHI,21,77,5,12,17
10,8477919,Frederick Gaudreau,C,MIN,30,70,5,12,17
10,8481568,Alex Vlasic,D,CHI,22,76,4,13,17
10,8480035,Henri Jokiharju,D,BUF,24,74,4,13,17
10,8477507,Nikita Zadorov,D,VAN,28,75,3,14,17
10,8474716,Jared Spurgeon,D,MIN,34,44,2,15,17
10,8476822,Luke Glendening,C,TBL,34,82,15,1,16
10,8480281,Alexey Toropchenko,R,STL,24,82,12,4,16
10,8473453,Trevor Lewis,C,LAK,36,82,10,6,16
10,8475231,Casey Cizikas,C,NYI,32,71,9,7,16
10,8482699,Dylan Guenther,R,ARI,20,45,9,7,16
10,8474040,Sam Gagner,C,EDM,34,55,8,8,16
10,8475848,Brendan Gallagher,R,MTL,31,50,8,8,16
10,8480144,David Kampf,C,TOR,28,78,8,8,16
10,8482660,Kent Johnson,C,CBJ,21,36,6,10,16
10,8482142,Jamie Drysdale,D,PHI,21,49,5,11,16
10,8477839,Conor Sheary,L,TBL,31,64,5,11,16
10,8481523,Kirby Dach,C,MTL,22,29,5,11,16
10,8479996,Cody Glass,C,NSH,24,54,5,11,16
10,8480058,Pierre-Olivier Joseph,D,PIT,24,53,5,11,16
10,8480220,Noah Cates,L,PHI,24,59,4,12,16
10,8480043,Timothy Liljegren,D,TOR,24,65,4,12,16
10,8478859,Niko Mikkola,D,FLA,27,82,4,12,16
10,8474034,Pat Maroon,L,MIN,35,49,4,12,16
10,8477365,Connor Clifton,D,BUF,28,79,0,16,16
10,8481606,Jordan Spence,D,LAK,22,44,0,16,16
10,8482192,Isaak Phillips,D,CHI,22,56,0,16,16
10,8477353,Tyler Motte,C,TBL,28,72,9,6,15
10,8477987,Ryan Donato,C,CHI,27,51,6,9,15
10,8477506,Ryan Pulock,D,NYI,29,58,6,9,15
10,8480762,Eric Robinson,L,BUF,28,54,5,10,15
10,8481178,Egor Zamula,D,PHI,23,44,5,10,15
10,8479976,Juuso Valimaki,D,ARI,25,68,4,11,15
10,8478399,Jonas Siegenthaler,D,NJD,26,66,3,12,15
10,8475825,Jani Hakanpää,D,DAL,31,82,3,12,15
10,8479980,Nicolas Hague,D,VGK,25,73,2,13,15
10,8474567,Zach Bogosian,D,MIN,33,70,2,13,15
10,8481690,Tyler Angle,C,CBJ,23,29,14,0,14
10,8479316,Luke Kunin,C,SJS,26,76,10,4,14
10,8477903,Garnet Hathaway,R,PHI,32,81,10,4,14
10,8473544,Derick Brassard,C,OTT,36,31,9,5,14
10,8480848,Ty Dellandrea,C,DAL,23,53,6,8,14
10,8474031,Kevin Shattenkirk,D,BOS,34,44,5,9,14
10,8478970,Jalen Chatfield,D,CAR,27,48,5,9,14
10,8477979,Nicolas Aube-Kubel,R,WSH,27,39,5,9,14
10,8473548,Phil Kessel,R,VGK,36,28,4,10,14
10,8473504,Cal Clutterbuck,R,NYI,36,53,4,10,14
10,8477380,Jonny Brodzinski,C,NYR,30,35,4,10,14
10,8477335,Kyle Burroughs,D,SJS,28,74,4,10,14
10,8480994,Damien Giroux,C,MIN,23,28,3,11,14
10,8477015,Connor Brown,R,EDM,29,75,3,11,14
10,8474683,Derek Grant,C,ANA,33,28,3,11,14
10,8474161,Jakub Voracek,R,CBJ,34,29,2,12,14
10,8480001,Urho Vaakanainen,D,ANA,24,74,2,12,14
10,8479514,Rem Pitlick,C,CHI,26,36,2,12,14
10,8477220,Nate Schmidt,D,WPG,32,75,1,13,14
10,8471274,Alex Goligoski,D,MIN,38,58,0,14,14
10,8479346,Dillon Dube,C,CGY,25,70,9,4,13
10,8480289,Morgan Barron,C,WPG,25,51,9,4,13
10,8477446,Michael McCarron,R,NSH,28,43,7,6,13
10,8482259,Bobby McMann,C,TOR,27,29,7,6,13
10,8476967,Brett Kulak,D,EDM,29,82,6,7,13
10,8480448,Parker Kelly,L,OTT,24,51,6,7,13
10,8477406,Mattias Janmark,C,EDM,31,71,4,9,13
10,8476473,Connor Murphy,D,CHI,30,70,4,9,13
10,8480807,Mattias Samuelsson,D,BUF,23,69,3,10,13
10,8474162,Jake Muzzin,D,TOR,34,29,3,10,13
10,8476917,Adam Pelech,D,NYI,29,58,2,11,13
10,8478416,Erik Cernak,D,TBL,26,71,1,12,13
10,8479336,Carl Grundstrom,R,LAK,26,50,8,4,12
10,8481517,Brett Leason,R,ANA,24,43,6,6,12
10,8473604,Jonathan Toews,C,CHI,35,27,5,7,12
10,8480748,Kiefer Sherwood,L,NSH,28,41,5,7,12
10,8477488,Brett Pesce,D,CAR,29,71,4,8,12
10,8480891,Michael Kesselring,D,ARI,23,36,4,8,12
10,8474573,Josh Bailey,R,NYI,34,29,4,8,12
10,8480727,Zach Whitecloud,D,VGK,27,65,3,9,12
10,8480073,Erik Brannstrom,D,OTT,24,45,3,9,12
10,8476467,Jamie Oleksiak,D,SEA,31,82,3,9,12
10,8476525,Colin Miller,D,NJD,31,61,3,9,12
10,8479324,Ryan Lindgren,D,NYR,25,80,2,10,12
10,8481605,Jackson LaCombe,D,ANA,22,76,2,10,12
10,8476874,Olli Maatta,D,DET,29,46,2,10,12
10,8478432,Christian Fischer,R,DET,26,51,2,10,12
10,8476624,Barclay Goodrow,C,NYR,30,80,2,10,12
10,8475324,Nick Jensen,D,WSH,33,82,1,11,12
10,8480884,Calen Addison,D,SJS,23,45,1,11,12
10,8477845,Trevor van Riemsdyk,D,WSH,32,70,0,12,12
10,8475718,Justin Holl,D,DET,31,63,0,12,12
10,8480192,Johnathan Kovacevic,D,MTL,26,74,8,3,11
10,8478569,Noel Acciari,C,PIT,32,70,8,3,11
10,8481013,Jonatan Berggren,R,DET,23,37,7,4,11
10,8475225,Craig Smith,C,DAL,34,50,7,4,11
10,8480205,Emil Bemstrom,R,CBJ,24,31,5,6,11
10,8478585,Derek Ryan,C,EDM,37,51,5,6,11
10,8476393,Nick Cousins,C,FLA,30,70,5,6,11
10,8478495,Denis Gurianov,R,NSH,26,40,5,6,11
10,8475177,Calvin de Haan,D,TBL,32,72,4,7,11
10,8476858,Phillip Di Giuseppe,L,VAN,30,62,4,7,11
10,8480879,Jacob Bernard-Docker,D,OTT,23,42,4,7,11
10,8474009,Nick Bonino,C,NYR,35,73,2,9,11
10,8480887,Jordan Harris,D,MTL,23,58,2,9,11
10,8476941,Connor Carrick,D,BOS,29,27,1,10,11
10,8480860,Kevin Bahl,D,NJD,23,81,0,11,11
10,8475842,Sam Carrick,C,ANA,31,54,7,3,10
10,8480980,Connor Dewar,C,MIN,24,48,7,3,10
10,8478421,A.J. Greer,L,CGY,27,47,6,4,10
10,8479344,Jesse Puljujarvi,R,PIT,25,36,5,5,10
10,8479442,Troy Stecher,D,ARI,29,71,5,5,10
10,8479291,Kevin Rooney,C,CGY,30,33,5,5,10
10,8482679,Matt Coronato,R,CGY,21,42,5,5,10
10,8474612,Travis Hamonic,D,OTT,33,75,4,6,10
10,8476871,Tanner Pearson,L,MTL,31,36,4,6,10
10,8478434,Keegan Kolesar,R,VGK,26,50,4,6,10
10,8477941,Nick Ritchie,L,CGY,28,27,4,6,10
10,8476856,Matt Dumba,D,ARI,29,78,3,7,10
10,8479414,Nathan Bastian,R,NJD,26,51,3,7,10
10,8479543,Michael Pezzetta,L,MTL,25,44,3,7,10
10,8476442,Matt Nieto,L,PIT,31,53,2,8,10
10,8471677,Jack Johnson,D,COL,36,80,2,8,10
10,8471276,David Krejci,C,BOS,37,27,2,8,10
10,8479371,Dante Fabbro,D,NSH,25,42,2,8,10
10,8482730,Brandt Clarke,D,LAK,20,38,1,9,10
10,8478131,Ondrej Kase,R,CAR,28,28,6,3,9
10,8479718,Alex Barré-Boulet,C,TBL,26,35,6,3,9
10,8470610,Zach Parise,L,COL,39,33,5,4,9
10,8479383,Boris Katchouk,L,CHI,25,35,5,4,9
10,8479328,Julien Gauthier,R,NYI,26,27,5,4,9
10,8481754,Nikita Nesterenko,C,ANA,22,28,5,4,9
10,8479402,Jake Bean,D,CBJ,25,49,4,5,9
10,8475461,Andrew Agozzino,L,SJS,32,28,3,6,9
10,8477846,Ryan Carpenter,C,SJS,32,36,3,6,9
10,8480008,Adam Ruzicka,C,ARI,24,41,3,6,9
10,8478028,Fredrik Olofsson,L,COL,27,53,3,6,9
10,8479315,Joey Anderson,R,CHI,25,28,2,7,9
10,8474013,Ian Cole,D,VAN,34,80,2,7,9
10,8481567,Henry Thrun,D,SJS,22,51,2,7,9
10,8480901,Karson Kuhlman,C,WPG,28,30,2,7,9
10,8481527,Kaedan Korczak,D,VGK,22,26,1,8,9
10,8477018,Ben Hutton,D,VGK,30,31,1,8,9
10,8483460,David Jiricek,D,CBJ,20,36,1,8,9
10,8476441,Joel Edmundson,D,WSH,30,66,1,8,9
10,8476915,Jujhar Khaira,L,MIN,29,29,1,8,9
10,8476372,Nick Seeler,D,PHI,30,55,0,9,9
10,8480252,Cole Guttman,C,CHI,24,27,4,4,8
10,8479368,Max Jones,L,ANA,25,38,4,4,8
10,8480031,Max Comtois,L,ANA,24,28,4,4,8
10,8477931,Tomas Nosek,L,NJD,31,40,3,5,8
10,8481477,Nico Sturm,C,SJS,28,34,3,5,8
10,8477392,Hudson Fasching,R,NYI,28,35,3,5,8
10,8477070,Liam O'Brien,C,ARI,29,49,3,5,8
10,8480995,Pontus Holmberg,R,TOR,24,27,2,6,8
10,8482516,Matthew Kessel,D,STL,23,47,2,6,8
10,8477499,Rasmus Ristolainen,D,PHI,29,57,1,7,8
10,8479576,Vincent Desharnais,D,EDM,27,49,1,7,8
10,8477971,Andreas Englund,D,LAK,27,52,1,7,8
10,8476988,Matt Benning,D,SJS,29,42,0,8,8
10,8479439,Jacob MacDonald,D,SJS,30,21,6,1,7
10,8471709,Marc-Edouard Vlasic,D,SJS,36,31,5,2,7
10,8477478,William Carrier,L,VGK,29,33,5,2,7
10,8477573,Nathan Walker,L,STL,29,18,5,2,7
10,8480806,Isac Lundestrom,C,ANA,24,46,4,3,7
10,8482241,Radim Zohorna,L,PIT,27,31,4,3,7
10,8477454,Adam Erne,L,EDM,28,54,3,4,7
10,8481058,Jesse Ylönen,R,MTL,24,43,3,4,7
10,8482448,Samuel Knazko,D,CBJ,21,29,3,4,7
10,8475762,Derek Forbort,D,BOS,31,57,2,5,7
10,8476891,Matt Grzelcyk,D,BOS,29,41,2,5,7
10,8479458,Nikita Zaitsev,D,CHI,32,26,2,5,7
10,8477541,Dakota Mermis,D,MIN,29,37,2,5,7
10,8478099,Kevin Labanc,R,SJS,28,32,2,5,7
10,8481641,Joel Kiviranta,L,COL,27,40,2,5,7
10,8480880,Jakub Lauko,C,BOS,23,40,2,5,7
10,8470966,Mark Giordano,D,TOR,40,36,1,6,7
10,8481537,Nikita Okhotiuk,D,SJS,23,38,1,6,7
10,8478502,Dennis Gilbert,D,CGY,27,31,1,6,7
10,8478104,Sammy Blais,L,STL,27,43,1,6,7
10,8482451,Mikael Pyyhtia,L,CBJ,22,29,1,6,7
10,8471303,Alexander Edler,D,LAK,37,30,1,6,7
10,8477359,Tucker Poolman,D,VAN,30,26,1,6,7
10,8477851,Jordan Oesterle,D,CGY,31,48,1,6,7
10,8480871,Adam Boqvist,D,CBJ,23,22,0,7,7
10,8479520,Brandon Duhaime,R,MIN,26,54,4,2,6
10,8479066,Ryan Lomberg,L,FLA,29,55,4,2,6
10,8476278,Colin Blackwell,C,CHI,30,25,3,3,6
10,8479968,Vinni Lettieri,C,MIN,28,24,3,3,6
10,8479322,Wade Allison,R,PHI,26,26,3,3,6
10,8480072,Lias Andersson,C,LAK,25,30,3,3,6
10,8481167,Brayden Pachal,D,CGY,24,50,3,3,6
10,8477369,Carson Soucy,D,VAN,29,21,2,4,6
10,8482496,Nils Aman,C,VAN,23,31,2,4,6
10,8480789,Oliver Wahlstrom,R,NYI,23,27,2,4,6
10,8477034,Jaycob Megna,D,CHI,31,45,2,4,6
10,8476410,Josh Leivo,L,STL,30,28,2,4,6
10,8476449,Scott Harrington,D,ANA,30,28,2,4,6
10,8481592,Jakob Pelletier,L,CGY,22,31,1,5,6
10,8480222,Sebastian Aho,D,NYI,27,41,1,5,6
10,8474568,Luke Schenn,D,NSH,34,36,1,5,6
10,8479982,Conor Timmins,D,TOR,25,16,1,5,6
10,8470595,Eric Staal,C,FLA,39,27,1,5,6
10,8476429,Scott Mayfield,D,NYI,31,67,0,6,6
10,8479369,Andrew Peeke,D,CBJ,25,20,0,6,6
10,8475797,Jarred Tinordi,D,CHI,31,32,0,6,6
10,8479372,Josh Mahura,D,FLA,25,20,0,6,6
10,8477930,Pierre-Edouard Bellemare,L,SEA,38,29,4,1,5
10,8481617,Vasily Podkolzin,R,VAN,22,26,3,2,5
10,8480831,Alec Regula,D,CHI,23,27,3,2,5
10,8480184,Gustav Lindström,D,ANA,25,22,3,2,5
10,8482081,Sean Farrell,C,MTL,22,27,3,2,5
10,8471669,Paul Stastny,C,CAR,38,28,2,3,5
10,8480913,Jordan Gross,D,NSH,28,27,2,3,5
10,8478408,Travis Dermott,D,ARI,27,37,2,3,5
10,8482964,Arber Xhekaj,D,MTL,22,24,2,3,5
10,8475750,Jon Merrill,D,MIN,31,38,2,3,5
10,8474618,Marco Scandella,D,STL,33,49,2,3,5
10,8480025,MacKenzie Entwistle,R,CHI,24,46,2,3,5
10,8479536,Axel Jonsson-Fjallby,L,WPG,25,26,2,3,5
10,8482711,Stanislav Svozil,D,CBJ,20,29,1,4,5
10,8474090,Brendan Smith,D,NJD,34,36,1,4,5
10,8477384,Josh Brown,D,ARI,29,28,1,4,5
10,8481708,Zac Jones,D,NYR,23,17,1,4,5
10,8480084,Nick DeSimone,D,NJD,29,23,1,4,5
10,8479671,Mathieu Olivier,R,CBJ,26,25,1,4,5
10,8479547,Matthew Phillips,R,PIT,25,27,1,4,5
10,8476919,Chris Tierney,C,NJD,29,28,1,4,5
10,8476952,Dominic Toninato,C,WPG,29,15,1,4,5
10,8482652,Walker Duehr,R,CGY,26,26,1,4,5
10,8479580,Dylan Gambrell,C,OTT,27,31,1,4,5
10,8482712,Oskar Olausson,R,COL,21,28,0,5,5
10,8481812,Nikolai Knyzhov,D,SJS,26,38,0,5,5
10,8482452,Elliot Desnoyers,L,PHI,21,26,0,5,5
10,8480950,Ilya Lyubushkin,D,ANA,29,79,0,5,5
10,8477482,Zach Sanford,L,CHI,29,26,0,5,5
10,8476878,Zemgus Girgensons,L,BUF,29,36,4,0,4
10,8483464,Marco Kasper,C,DET,19,28,3,1,4
10,8480328,David Gust,R,CHI,29,27,3,1,4
10,8482077,Dylan Holloway,L,EDM,22,23,3,1,4
10,8480011,Klim Kostin,C,DET,24,32,3,1,4
10,8478870,Rudolfs Balcers,L,TBL,26,26,2,2,4
10,8479370,Tyson Jost,C,BUF,25,29,2,2,4
10,8481019,David Gustafsson,C,WPG,23,27,2,2,4
10,8479981,Jonah Gadjovich,L,FLA,25,27,2,2,4
10,8479348,Kale Clague,D,BUF,25,28,1,3,4
10,8477938,Haydn Fleury,D,TBL,27,16,1,3,4
10,8480003,Jesper Boqvist,C,BOS,25,20,1,3,4
10,8479994,Jaret Anderson-Dolan,C,LAK,24,24,1,3,4
10,8475752,Tyler Pitlick,C,NYR,32,34,1,3,4
10,8476913,Devin Shore,C,SEA,29,21,1,3,4
10,8483424,Owen Beck,C,MTL,19,27,1,3,4
10,8475747,Patrik Nemeth,D,ARI,31,29,0,4,4
10,8482176,Wyatt Kaiser,D,CHI,21,23,0,4,4
10,8478452,Caleb Jones,D,COL,26,20,0,4,4
10,8478454,Noah Juulsen,D,VAN,26,38,0,4,4
10,8478424,Jansen Harkins,C,PIT,26,34,0,4,4
10,8474207,Nick Holden,D,OTT,36,31,0,4,4
10,8473446,Erik Johnson,D,BUF,35,46,3,0,3
10,8480242,Arnaud Durandeau,L,NYI,24,29,2,1,3
10,8480275,Nick Swaney,R,MIN,26,28,2,1,3
10,8481147,Reese Johnson,C,CHI,25,34,2,1,3
10,8478078,Rourke Chartier,C,OTT,27,34,2,1,3
10,8474709,Matt Martin,L,NYI,34,31,2,1,3
10,8479772,Zack MacEwen,R,OTT,27,22,2,1,3
10,8477962,Brendan Lemieux,L,CAR,27,23,2,1,3
10,8475766,Austin Watson,L,TBL,31,28,2,1,3
10,8480468,James Hamblin,L,EDM,24,31,2,1,3
10,8480355,Mark Kastelic,C,OTT,24,34,2,1,3
10,8481122,Simon Benoit,D,TOR,25,39,1,2,3
10,8478451,Ethan Bear,D,WSH,26,16,1,2,3
10,8471686,Marc Staal,D,PHI,36,20,1,2,3
10,8477244,Chad Ruhwedel,D,PIT,33,37,1,2,3
10,8481541,Samuel Bolduc,D,NYI,23,33,1,2,3
10,8476934,Brock McGinn,L,ANA,29,24,1,2,3
10,8476994,Vinnie Hinostroza,C,PIT,29,14,1,2,3
10,8480007,Jonas Rondbjerg,R,VGK,24,17,1,2,3
10,8476867,Brendan Gaunce,C,CBJ,29,8,1,2,3
10,8478904,Steven Lorentz,C,FLA,27,28,1,2,3
10,8479379,Givani Smith,R,SJS,25,26,1,2,3
10,8482181,Tristen Robins,C,SJS,22,28,0,3,3
10,8471873,Anton Stralman,D,BOS,37,27,0,3,3
10,8478450,Parker Wotherspoon,D,BOS,26,23,0,3,3
10,8477810,Joel Hanley,D,DAL,32,26,0,3,3
10,8480853,Liam Foudy,C,NSH,23,13,0,3,3
10,8475235,Nicolas Deslauriers,L,PHI,32,47,0,3,3
10,8475780,Chris Wagner,R,BOS,32,27,0,3,3
10,8474218,Jason Demers,D,EDM,35,31,2,0,2
10,8480776,Sheldon Rempal,R,VGK,28,5,2,0,2
10,8471817,Ryan Reaves,R,TOR,36,27,2,0,2
10,8477073,Kurtis MacDermid,D,COL,29,28,2,0,2
10,8482133,Thomas Bordeleau,C,SJS,21,6,1,1,2
10,8481006,Tyler Tucker,D,STL,23,16,1,1,2
10,8479362,Riley Tufte,L,COL,25,5,1,1,2
10,8478051,Max Willman,C,NJD,28,13,1,1,2
10,8481532,Alex Turcotte,C,LAK,22,6,1,1,2
10,8480977,Semyon Der-Arguchintsev,C,TOR,23,29,0,2,2
10,8480070,Ian Mitchell,D,BOS,24,13,0,2,2
10,8480196,Jacob Bryson,D,BUF,26,8,0,2,2
10,8480870,Bo Groulx,C,ANA,23,32,0,2,2
10,8473473,Milan Lucic,L,BOS,35,4,0,2,2
10,8477464,Nic Petan,C,MIN,28,6,0,2,2
10,8477527,Ross Johnston,L,ANA,29,41,0,2,2
10,8481043,Cole Koepke,L,TBL,25,8,0,2,2
10,8483641,Anton Levtchi,L,FLA,28,27,1,0,1
10,8481056,Spencer Stastney,D,NSH,23,9,1,0,1
10,8480823,Alexander Alexeyev,D,WSH,24,13,1,0,1
10,8476873,Mark Jankowski,C,NSH,29,5,1,0,1
10,8480021,Jack Studnicka,C,SJS,24,14,1,0,1
10,8478409,Anthony Richard,C,BOS,27,4,1,0,1
10,8483570,Ben Meyers,C,COL,25,9,1,0,1
10,8481422,Jacob Lucchini,C,MIN,28,13,1,0,1
10,8479546,Oskar Steen,C,BOS,25,34,1,0,1
10,8481239,Samuel Fagemo,L,LAK,23,8,1,0,1
10,8480041,Dmitri Samorukov,D,STL,24,28,1,0,1
10,8480874,Adam Ginning,D,PHI,23,26,0,1,1
10,8476310,Lukas Sedlak,C,PHI,30,26,0,1,1
10,8482762,Simon Edvinsson,D,DET,20,2,0,1,1
10,8481161,Jake Christiansen,D,CBJ,24,3,0,1,1
10,8480157,Calle Rosen,D,STL,29,5,0,1,1
10,8479984,Cal Foote,D,NJD,25,4,0,1,1
10,8479321,Lucas Johansen,D,WSH,26,6,0,1,1
10,8479378,Logan Stanley,D,WPG,25,10,0,1,1
10,8478017,Mark Friedman,D,VAN,28,20,0,1,1
10,8482095,Tyler Kleven,D,OTT,21,5,0,1,1
10,8479320,Max Lajoie,D,TOR,26,5,0,1,1
10,8477887,Patrick Brown,C,BOS,31,11,0,1,1
10,8480245,Olle Lycksell,R,PHI,24,5,0,1,1
10,8478146,Matthew Highmore,C,OTT,27,6,0,1,1
10,8480845,Rasmus Kupari,C,WPG,23,21,0,1,1
10,8478512,Austin Czarnik,C,DET,31,18,0,1,1
10,8479367,William Lockwood,R,FLA,25,23,0,1,1
10,8481543,Nikita Alexandrov,C,STL,23,18,0,1,1
10,8483597,Milos Kelemen,L,ARI,24,10,0,1,1
10,8482207,William Dufour,R,NYI,21,29,0,0,0
10,8483565,Nick Blankenburg,D,CBJ,25,6,0,0,0
10,8483620,Marcus Bjork,D,CBJ,26,0,0,0,0
10,8481521,Ronnie Attard,D,PHI,24,0,0,0,0
10,8482399,Billy Sweezey,D,CBJ,27,0,0,0,0
10,8481072,Tim Berni,D,CBJ,23,0,0,0,0
10,8476884,Derrick Pouliot,D,SJS,29,0,0,0,0
10,8482624,Daniil Miromanov,D,VGK,26,2,0,0,0
10,8482861,Vincent Iorio,D,WSH,21,0,0,0,0
10,8478465,Guillaume Brisebois,D,VAN,26,0,0,0,0
10,8484256,Jake Livingstone,D,NSH,24,0,0,0,0
10,8481599,Victor Soderstrom,D,ARI,22,1,0,0,0
10,8474027,Justin Braun,D,PHI,36,0,0,0,0
10,8478062,Dysin Mayo,D,ARI,27,0,0,0,0
10,8481563,Drew Helleson,D,ANA,22,0,0,0,0
10,8481575,Lassi Thomson,D,OTT,23,0,0,0,0
10,8483619,Filip Roos,D,CHI,24,4,0,0,0
10,8481461,Corey Schueneman,D,MTL,28,0,0,0,0
10,8478846,Christian Wolanin,D,VAN,28,0,0,0,0
10,8479395,Dennis Cholowski,D,NYI,25,0,0,0,0
10,8479945,Gavin Bayreuther,D,CBJ,29,0,0,0,0
10,8474818,Jordie Benn,D,TOR,36,0,0,0,0
10,8479421,Jacob Moverare,D,LAK,25,5,0,0,0
10,8479329,Frederic Allard,D,MTL,26,0,0,0,0
10,8481600,Tobias Bjornfot,D,VGK,22,3,0,0,0
10,8477462,Robert Hagg,D,ANA,28,5,0,0,0
10,8476470,Nathan Beaulieu,D,ANA,31,0,0,0,0
10,8484254,Akito Hirose,D,VAN,24,3,0,0,0
10,8479388,Riley Stillman,D,BUF,25,0,0,0,0
10,8482824,Nick Cicek,D,SJS,23,0,0,0,0
10,8480056,Jack Rathbone,D,VAN,24,0,0,0,0
10,8476850,Ryan Murray,D,EDM,30,0,0,0,0
10,8478841,Colton White,D,ANA,26,0,0,0,0
10,8480160,Radim Simek,D,SJS,31,0,0,0,0
10,8478491,Jacob Larsson,D,OTT,26,0,0,0,0
10,8475857,Kevin Gravel,D,NSH,31,0,0,0,0
10,8482067,Connor Mackey,D,NYR,27,1,0,0,0
10,8477433,Ben Harpur,D,NYR,28,0,0,0,0
10,8481572,Ville Heinola,D,WPG,22,0,0,0,0
10,8478415,Jakub Zboril,D,BOS,26,0,0,0,0
10,8477341,Andreas Johnsson,L,SJS,29,0,0,0,0
10,8480216,Jacob Peterson,C,SJS,24,6,0,0,0
10,8477467,Gustav Olofsson,D,SEA,29,0,0,0,0
10,8478476,Kyle Capobianco,D,WPG,26,0,0,0,0
10,8479985,Cale Fleury,D,SEA,25,0,0,0,0
10,8475227,Chris Wideman,D,MTL,33,0,0,0,0
10,8479333,Libor Hajek,D,NYR,25,0,0,0,0
10,8479376,Victor Mete,D,PHI,25,1,0,0,0
10,8480439,Mac Hollowell,D,TOR,25,0,0,0,0
10,8480467,Austin Strand,D,ANA,26,0,0,0,0
10,8477981,Roland McKeown,D,NSH,27,0,0,0,0
10,8474628,Michael Stone,D,CGY,33,0,0,0,0
10,8480034,Joel Teasdale,L,MTL,24,0,0,0,0
10,8481609,Vladislav Kolyachonok,D,ARI,22,1,0,0,0
10,8479602,Jeremy Davies,D,BUF,27,0,0,0,0
10,8479639,Dylan Coghlan,D,CAR,25,0,0,0,0
10,8478506,Gabriel Carlsson,D,WSH,26,0,0,0,0
10,8477463,Steven Santini,D,STL,28,0,0,0,0
10,8478075,Anders Bjork,L,CHI,27,0,0,0,0
10,8484287,Cole McWard,D,VAN,22,1,0,0,0
10,8474145,Robert Bortuzzo,D,NYI,34,15,0,0,0
10,8475625,Matt Irwin,D,WSH,36,0,0,0,0
10,8482179,Justin Richards,C,CBJ,25,0,0,0,0
10,8481649,Joona Luoto,L,CBJ,26,0,0,0,0
10,8479026,Philippe Myers,D,TBL,26,5,0,0,0
10,8480935,Lawrence Pilut,D,BUF,28,0,0,0,0
10,8479578,Casey Fitzgerald,D,FLA,26,0,0,0,0
10,8480071,Robin Salo,D,NYI,25,0,0,0,0
10,8478224,Luke Philp,C,CHI,28,0,0,0,0
10,8484125,Hunter McKown,C,CBJ,21,0,0,0,0
10,8481679,Maxence Guenette,D,OTT,22,1,0,0,0
10,8479423,Alex Nylander,L,PIT,25,5,0,0,0
10,8480441,Trey Fix-Wolansky,R,CBJ,24,1,0,0,0
10,8480820,Filip Kral,D,TOR,24,0,0,0,0
10,8479523,Lucas Carlsson,D,FLA,26,0,0,0,0
10,8479304,Kyle Criscuolo,C,SJS,31,0,0,0,0
10,8474697,Mark Borowiecki,D,NSH,34,0,0,0,0
10,8480842,Filip Hallander,C,PIT,23,0,0,0,0
10,8481725,Elmer Soderblom,L,DET,22,0,0,0,0
10,8479252,Dan Renouf,D,BOS,29,0,0,0,0
10,8481591,Sam Poulin,R,PIT,22,0,0,0,0
10,8475968,Alex Belzile,R,MTL,32,0,0,0,0
10,8475772,Riley Sheahan,C,BUF,32,0,0,0,0
10,8475163,Alex Chiasson,R,DET,33,0,0,0,0
10,8481598,Philip Broberg,D,EDM,22,10,0,0,0
10,8478455,Austin Wagner,L,CHI,26,0,0,0,0
10,8476779,Brad Hunt,D,COL,35,0,0,0,0
10,8479335,Rasmus Asplund,C,NSH,26,0,0,0,0
10,8478967,Lane Pederson,C,CBJ,26,0,0,0,0
10,8481077,John Leonard,L,NSH,25,0,0,0,0
10,8481585,Egor Afanasyev,L,NSH,22,2,0,0,0
10,8483397,Marc McLaughlin,C,BOS,24,0,0,0,0
10,8480443,Kristian Reichel,C,WPG,25,0,0,0,0
10,8481751,Lukas Rousek,R,BUF,24,5,0,0,0
10,8476396,Steven Fogarty,C,MIN,30,0,0,0,0
10,8478881,Brett Seney,L,CHI,27,4,0,0,0
10,8480326,Sheldon Dries,C,VAN,29,0,0,0,0
10,8481433,Taro Hirose,L,DET,27,0,0,0,0
10,8480833,Vitali Kravtsov,R,VAN,24,0,0,0,0
10,8481550,Adam Beckman,L,MIN,22,0,0,0,0
10,8479972,Mason Shaw,C,MIN,25,0,0,0,0
10,8477460,Laurent Dauphin,C,ARI,28,0,0,0,0
10,8476166,Taylor Fedun,D,PIT,35,0,0,0,0
10,8478067,Oskar Lindblom,L,SJS,27,1,0,0,0
10,8479944,Zach Aston-Reese,C,DET,29,1,0,0,0
10,8479465,Drake Caggiula,L,PIT,29,0,0,0,0
10,8481740,Tyce Thompson,R,NJD,24,0,0,0,0
10,8476948,Charles Hudon,L,COL,29,0,0,0,0
10,8480863,Gabriel Fortier,L,TBL,23,0,0,0,0
10,8471887,Patric Hornqvist,R,FLA,36,0,0,0,0
10,8477471,Dillon Heatherington,D,OTT,28,0,0,0,0
10,8481441,Joe Snively,C,WSH,27,3,0,0,0
10,8478173,Hayden Hodgson,R,PHI,27,0,0,0,0
10,8481720,Nick Abruzzese,C,TOR,24,0,0,0,0
10,8478843,Denis Malgin,C,COL,26,0,0,0,0
10,8483630,Pavol Regenda,L,ANA,24,0,0,0,0
10,8478373,Nikita Soshnikov,R,NYI,30,0,0,0,0
10,8482147,Jean-Luc Foudy,C,COL,21,0,0,0,0
10,8478431,Evgeny Svechnikov,L,SJS,27,0,0,0,0
10,8477210,Buddy Robinson,R,CHI,32,0,0,0,0
10,8479404,Henrik Borgstrom,C,WSH,26,0,0,0,0
10,8481712,Matej Blumel,R,DAL,23,0,0,0,0
10,8475278,Byron Froese,C,VGK,32,7,0,0,0
10,8479338,Markus Niemelainen,D,EDM,25,0,0,0,0
10,8471794,Darren Helm,C,COL,36,0,0,0,0
10,8482623,Josh Dunne,C,CBJ,25,0,0,0,0
10,8482641,Matt Kiersted,D,FLA,25,0,0,0,0
10,8476851,Alex Galchenyuk,C,COL,29,0,0,0,0
10,8479366,Logan Brown,C,STL,25,0,0,0,0
10,8480822,Martin Kaut,R,SJS,24,0,0,0,0
10,8482834,Jesper Froden,R,SEA,29,0,0,0,0
10,8480844,Grigori Denisenko,L,VGK,23,3,0,0,0
10,8482635,Mike Hardman,L,CHI,24,0,0,0,0
10,8477357,Saku Maenalanen,R,WPG,29,0,0,0,0
10,8480979,Nathan Smith,C,ARI,25,0,0,0,0
10,8479356,Kieffer Bellows,L,PHI,25,0,0,0,0
10,8475795,Dylan McIlrath,D,WSH,31,1,0,0,0
10,8478400,Colin White,C,PIT,26,9,0,0,0
10,8478446,Glenn Gawdin,C,ANA,26,0,0,0,0
10,8476326,Josh Archibald,R,PIT,31,0,0,0,0
10,8481683,Aidan McDonough,L,VAN,24,0,0,0,0
10,8480267,Sammy Walker,C,MIN,24,4,0,0,0
10,8477520,Jean-Sebastien Dea,C,ARI,29,0,0,0,0
10,8476439,Brett Ritchie,R,ARI,30,0,0,0,0
10,8479518,Fredrik Karlström,C,DAL,25,0,0,0,0
10,8477126,Jayson Megna,C,ANA,33,0,0,0,0
10,8479644,Matt Luff,R,DET,26,0,0,0,0
10,8478211,Dryden Hunt,L,CGY,28,5,0,0,0
10,8480226,Marián Studenic,R,SEA,25,2,0,0,0
10,8480037,Aleksi Heponiemi,C,FLA,24,0,0,0,0
10,8480292,Carson Meyer,R,CBJ,26,0,0,0,0
10,8482634,Alex Steeves,C,TOR,24,1,0,0,0
10,8475178,Zack Kassian,R,ARI,32,0,0,0,0
10,8483524,Shane Wright,C,SEA,19,3,0,0,0
10,8482654,Jackson Cates,C,PHI,26,0,0,0,0
10,8479550,Tanner Laczynski,C,PHI,26,0,0,0,0
10,8479991,Jake Leschyshyn,C,NYR,24,1,0,0,0
10,8474613,Derek Stepan,C,CAR,33,0,0,0,0
10,8478367,Cole Bardreau,C,NYI,30,0,0,0,0
10,8480890,Jan Jenik,R,ARI,23,1,0,0,0
10,8475160,Kyle Clifford,L,TOR,32,0,0,0,0
10,8479705,Jeffrey Viel,L,SJS,26,0,0,0,0
10,8477401,John Hayden,C,SEA,28,2,0,0,0
10,8480846,Sampo Ranta,L,COL,23,0,0,0,0
10,8482691,Aatu Raty,C,VAN,21,0,0,0,0
10,8481070,Hugh McGing,L,STL,25,5,0,0,0
10,8479573,Mikhail Maltsev,L,COL,25,0,0,0,0
10,8482250,Callahan Burke,C,CAR,26,1,0,0,0
10,8481102,Egor Sokolov,L,OTT,23,0,0,0,0
10,8481518,Nolan Foote,L,NJD,23,0,0,0,0
10,8474190,Wayne Simmonds,R,TOR,35,0,0,0,0
10,8474610,Zac Dalpe,C,FLA,34,0,0,0,0
10,8479347,Tyler Benson,L,EDM,25,0,0,0,0
10,8476404,Andy Andreoff,C,NYI,32,0,0,0,0
10,8476390,Joseph Cramarossa,C,MIN,31,0,0,0,0
10,8483549,Lucas Condotta,L,MTL,26,3,0,0,0
10,8482197,Adam Raska,R,MIN,22,5,0,0,0
10,8479533,Joona Koppanen,L,PIT,25,3,0,0,0
10,8479526,Otto Koivula,L,NYI,25,0,0,0,0
10,8479375,William Bitten,C,STL,25,0,0,0,0
10,8474089,Brad Malone,C,EDM,34,0,0,0,0
10,8478058,CJ Suess,L,SJS,29,0,0,0,0
10,8478147,Bokondji Imama,L,ARI,27,0,0,0,0
10,8477320,Anton Blidh,L,NYR,28,1,0,0,0
10,8477993,Justin Kirkland,C,ARI,27,2,0,0,0
10,8480836,Jonathan Gruden,C,PIT,23,5,0,0,0
10,8480032,Shane Bowers,C,NJD,24,3,0,0,0
