Simulation,PlayerID,Player,Position,Team,Age,Games Played,Goals,Assists,Points
1,8476453,Nikita Kucherov,R,TBL,31,82,34,108,142
1,8478402,Connor McDavid,C,EDM,27,82,45,82,127
1,8477934,Leon Draisaitl,C,EDM,29,82,38,88,126
1,8477492,Nathan MacKinnon,C,COL,29,82,49,74,123
1,8478550,Artemi Panarin,L,NYR,33,82,41,82,123
1,8477956,David Pastrnak,R,BOS,28,82,44,68,112
1,8477946,Dylan Larkin,C,DET,28,82,47,61,108
1,8478864,Kirill Kaprizov,L,MIN,27,82,46,57,103
1,8481559,Jack Hughes,C,NJD,23,82,38,65,103
1,8478420,Mikko Rantanen,R,COL,28,82,36,67,103
1,8477939,William Nylander,R,TOR,28,82,48,52,100
1,8481557,Matt Boldy,L,MIN,23,82,39,60,99
1,8480023,Robert Thomas,C,STL,25,82,27,71,98
1,8479318,Auston Matthews,C,TOR,27,82,51,46,97
1,8479314,Matthew Tkachuk,L,FLA,27,82,34,61,95
1,8475913,Mark Stone,R,VGK,32,82,28,67,95
1,8480069,Cale Makar,D,COL,26,82,22,73,95
1,8476468,J.T. Miller,C,VAN,31,82,38,56,94
1,8478873,Troy Terry,R,ANA,27,82,34,60,94
1,8478010,Brayden Point,C,TBL,28,82,55,38,93
1,8476887,Filip Forsberg,L,NSH,30,82,43,48,91
1,8480027,Jason Robertson,L,DAL,25,82,40,50,90
1,8471675,Sidney Crosby,C,PIT,37,82,35,54,89
1,8479407,Jesper Bratt,L,NJD,26,82,32,57,89
1,8476539,Jonathan Marchessault,R,VGK,34,82,47,41,88
1,8480801,Brady Tkachuk,L,OTT,25,82,37,50,87
1,8480036,Miro Heiskanen,D,DAL,25,82,21,66,87
1,8475184,Chris Kreider,L,NYR,33,82,48,38,86
1,8475172,Nazem Kadri,C,CGY,34,82,44,42,86
1,8478427,Sebastian Aho,C,CAR,27,82,32,54,86
1,8477404,Jake Guentzel,C,CAR,30,82,41,44,85
1,8476389,Vincent Trocheck,C,NYR,31,82,34,51,85
1,8477493,Aleksander Barkov,C,FLA,29,82,28,57,85
1,8481523,Kirby Dach,C,MTL,23,82,9,76,85
1,8477500,Bo Horvat,C,NYI,29,82,45,39,84
1,8479343,Clayton Keller,R,ARI,26,82,34,50,84
1,8474141,Patrick Kane,R,DET,36,82,32,50,82
1,8477942,Kevin Fiala,L,LAK,28,82,29,53,82
1,8474600,Roman Josi,D,NSH,34,82,22,60,82
1,8475166,John Tavares,C,TOR,34,82,29,52,81
1,8474590,John Carlson,D,WSH,34,82,20,61,81
1,8471214,Alex Ovechkin,L,WSH,39,82,39,41,80
1,8477949,Alex Tuch,R,BUF,28,82,23,57,80
1,8474564,Steven Stamkos,C,TBL,34,82,36,43,79
1,8476460,Mark Scheifele,C,WPG,31,82,33,46,79
1,8473512,Claude Giroux,R,OTT,36,82,30,49,79
1,8477416,Oliver Bjorkstrand,R,SEA,29,82,36,42,78
1,8478449,Roope Hintz,C,DAL,28,82,30,48,78
1,8476454,Ryan Nugent-Hopkins,C,EDM,31,82,27,51,78
1,8478403,Jack Eichel,C,VGK,28,82,32,45,77
1,8482116,Tim Stützle,C,OTT,22,82,28,49,77
1,8477402,Pavel Buchnevich,L,STL,29,82,41,35,76
1,8478440,Dylan Strome,C,WSH,27,82,28,48,76
1,8471685,Anze Kopitar,C,LAK,37,82,28,48,76
1,8479385,Jordan Kyrou,C,STL,26,82,26,50,76
1,8475786,Zach Hyman,L,EDM,32,82,43,32,75
1,8482093,Seth Jarvis,C,CAR,22,82,38,37,75
1,8477933,Sam Reinhart,C,FLA,29,82,35,40,75
1,8477501,Valeri Nichushkin,R,COL,29,82,38,36,74
1,8480012,Elias Pettersson,C,VAN,26,82,36,38,74
1,8477409,Carter Verhaeghe,C,FLA,29,82,34,40,74
1,8480002,Nico Hischier,C,NJD,25,82,33,41,74
1,8477444,Andre Burakovsky,L,SEA,29,82,28,46,74
1,8473419,Brad Marchand,L,BOS,36,82,22,52,74
1,8477940,Nikolaj Ehlers,L,WPG,28,82,27,46,73
1,8481540,Cole Caufield,R,MTL,23,82,40,32,72
1,8480830,Andrei Svechnikov,R,CAR,24,82,27,45,72
1,8477951,Nick Schmaltz,C,ARI,28,82,22,50,72
1,8478445,Mathew Barzal,C,NYI,27,82,17,55,72
1,8479420,Tage Thompson,C,BUF,27,82,32,39,71
1,8478398,Kyle Connor,L,WPG,28,82,31,40,71
1,8475784,Jeff Skinner,C,BUF,32,82,25,46,71
1,8481533,Trevor Zegras,C,ANA,23,82,24,47,71
1,8478460,Zach Werenski,D,CBJ,27,82,12,59,71
1,8479337,Alex DeBrincat,R,DET,27,82,31,39,70
1,8476346,Johnny Gaudreau,L,CBJ,31,82,16,54,70
1,8479999,Casey Mittelstadt,C,COL,26,82,16,53,69
1,8480800,Quinn Hughes,D,VAN,25,82,14,55,69
1,8479323,Adam Fox,D,NYR,26,82,14,55,69
1,8476459,Mika Zibanejad,C,NYR,31,82,33,35,68
1,8475170,Brayden Schenn,C,STL,33,82,32,36,68
1,8474641,Adam Henrique,C,EDM,34,82,29,39,68
1,8479325,Charlie McAvoy,D,BOS,27,82,13,55,68
1,8479339,Patrik Laine,L,CBJ,26,82,28,39,67
1,8470794,Joe Pavelski,C,DAL,40,82,25,42,67
1,8482665,Matty Beniers,C,SEA,22,82,23,44,67
1,8477504,Josh Morrissey,D,WPG,29,82,13,54,67
1,8478498,Jake DeBrusk,L,BOS,28,82,40,26,66
1,8482078,Lucas Raymond,L,DET,22,82,33,33,66
1,8476448,William Karlsson,C,VGK,31,82,26,40,66
1,8476875,Mike Matheson,D,MTL,30,82,20,46,66
1,8478407,Vince Dunn,D,SEA,28,82,13,53,66
1,8474563,Drew Doughty,D,LAK,35,82,9,57,66
1,8478047,Michael Bunting,L,PIT,29,82,31,34,65
1,8477407,Anthony Duclair,L,TBL,29,82,27,38,65
1,8475692,Mats Zuccarello,R,MIN,37,82,12,53,65
1,8481528,Dylan Cozens,C,BUF,23,82,25,39,64
1,8476399,Blake Coleman,C,CGY,33,82,24,40,64
1,8480208,Drake Batherson,R,OTT,26,82,23,41,64
1,8477955,Jared McCann,L,SEA,28,82,36,27,63
1,8476881,Tomas Hertl,C,VGK,31,82,31,32,63
1,8478439,Travis Konecny,R,PHI,27,82,28,35,63
1,8471215,Evgeni Malkin,C,PIT,38,82,26,36,62
1,8476462,Dougie Hamilton,D,NJD,31,82,23,39,62
1,8476479,Phillip Danault,C,LAK,31,82,21,41,62
1,8476456,Jonathan Huberdeau,C,CGY,31,82,16,46,62
1,8480839,Rasmus Dahlin,D,BUF,24,82,16,46,62
1,8478493,Joel Eriksson Ek,C,MIN,27,82,33,28,61
1,8475726,Tyler Toffoli,C,WPG,32,82,33,28,61
1,8479542,Brandon Hagel,L,TBL,26,82,29,32,61
1,8475810,Bryan Rust,R,PIT,32,82,26,35,61
1,8475745,Charlie Coyle,C,BOS,32,82,23,38,61
1,8477447,Shea Theodore,D,VGK,29,82,13,48,61
1,8476853,Morgan Rielly,D,TOR,30,82,9,52,61
1,8473994,Jamie Benn,L,DAL,35,82,25,35,60
1,8475168,Matt Duchene,C,DAL,33,82,23,37,60
1,8480018,Nick Suzuki,C,MTL,25,82,20,40,60
1,8478469,Thomas Chabot,D,OTT,27,82,19,41,60
1,8475754,Brock Nelson,C,NYI,33,82,31,28,59
1,8478458,Jack Roslovic,C,NYR,27,82,19,40,59
1,8475169,Evander Kane,L,EDM,33,82,31,27,58
1,8478233,Andrew Mangiapane,L,CGY,28,82,21,37,58
1,8482124,Quinton Byfield,R,LAK,22,82,17,41,58
1,8475798,Mikael Granlund,C,SJS,32,82,15,43,58
1,8480803,Evan Bouchard,D,EDM,25,82,10,48,58
1,8482175,JJ Peterka,R,BUF,22,82,37,20,57
1,8478444,Brock Boeser,R,VAN,27,82,31,26,57
1,8477960,Adrian Kempe,R,LAK,28,82,31,26,57
1,8480188,Fabian Zetterlund,L,SJS,25,82,25,32,57
1,8475763,Kevin Hayes,R,STL,32,82,23,34,57
1,8475167,Victor Hedman,D,TBL,34,82,9,48,57
1,8478975,Mason Marchment,L,DAL,29,82,31,25,56
1,8480014,Gabriel Vilardi,C,WPG,25,82,31,25,56
1,8471698,T.J. Oshie,R,WSH,38,82,29,27,56
1,8478042,Viktor Arvidsson,R,LAK,31,82,26,30,56
1,8480039,Martin Necas,C,CAR,25,82,21,35,56
1,8476905,Chandler Stephenson,C,VGK,30,82,19,37,56
1,8477986,Brandon Montour,D,FLA,30,82,19,37,56
1,8479400,Pierre-Luc Dubois,L,LAK,26,82,19,37,56
1,8478401,Pavel Zacha,C,BOS,27,82,18,38,56
1,8474150,Mikael Backlund,C,CGY,35,82,17,39,56
1,8481068,Yegor Sharangovich,C,CGY,26,82,31,24,55
1,8475765,Vladimir Tarasenko,R,FLA,33,82,25,30,55
1,8482699,Dylan Guenther,R,ARI,21,82,25,30,55
1,8477494,Jonathan Drouin,L,COL,29,82,21,34,55
1,8473986,Alex Killorn,L,ANA,35,82,21,34,55
1,8476329,Travis Boyd,C,ARI,31,82,19,36,55
1,8476882,Teuvo Teravainen,L,CAR,30,82,17,38,55
1,8477503,Max Domi,C,TOR,29,82,16,39,55
1,8479410,Mikhail Sergachev,D,TBL,26,82,11,44,55
1,8481711,Matias Maccelli,L,ARI,24,82,22,32,54
1,8476483,Rickard Rakell,R,PIT,31,82,22,32,54
1,8475744,Evgeny Kuznetsov,C,CAR,32,82,20,34,54
1,8481596,Shane Pinto,C,OTT,24,82,16,38,54
1,8478038,Devon Toews,D,COL,30,82,14,40,54
1,8478397,Rasmus Andersson,D,CGY,28,82,12,42,54
1,8476906,Shayne Gostisbehere,D,DET,31,82,11,43,54
1,8480064,Josh Norris,C,OTT,25,82,33,20,53
1,8478366,Frank Vatrano,R,ANA,30,82,28,25,53
1,8480015,Owen Tippett,R,PHI,25,82,27,26,53
1,8476292,Ondrej Palat,L,NJD,33,82,24,29,53
1,8479675,Trevor Moore,L,LAK,29,82,23,30,53
1,8476880,Tom Wilson,R,WSH,30,82,20,33,53
1,8477451,Ryan Hartman,R,MIN,30,82,30,22,52
1,8478115,Pierre Engvall,L,NYI,28,82,26,26,52
1,8478462,Nicolas Roy,C,VGK,27,82,25,27,52
1,8482705,Cole Sillinger,C,CBJ,21,82,21,31,52
1,8480028,Morgan Frost,C,PHI,25,82,19,33,52
1,8478438,Tommy Novak,C,NSH,27,82,18,34,52
1,8478466,Daniel Sprong,R,DET,27,82,17,35,52
1,8474102,David Perron,L,DET,36,82,16,36,52
1,8478542,Evan Rodrigues,C,FLA,31,82,16,36,52
1,8475151,Kyle Palmieri,C,NYI,33,82,29,22,51
1,8477476,Artturi Lehkonen,L,COL,29,82,25,26,51
1,8475191,Reilly Smith,R,PIT,33,82,24,27,51
1,8477497,Sean Monahan,C,WPG,30,82,19,32,51
1,8477429,Andrew Copp,C,DET,30,82,17,34,51
1,8471724,Kris Letang,D,PIT,37,82,16,35,51
1,8475753,Justin Faulk,D,STL,32,82,16,35,51
1,8476432,Boone Jenner,C,CBJ,31,82,25,25,50
1,8484144,Connor Bedard,C,CHI,19,82,24,26,50
1,8474053,Logan Couture,C,SJS,35,82,21,29,50
1,8480078,Filip Chytil,C,NYR,25,82,19,31,50
1,8475791,Taylor Hall,L,CHI,33,82,15,35,50
1,8476854,Hampus Lindholm,D,BOS,30,82,9,41,50
1,8478414,Timo Meier,R,NJD,28,82,25,24,49
1,8477426,Nicholas Paul,L,TBL,29,82,23,26,49
1,8480459,Pius Suter,C,VAN,28,82,20,29,49
1,8480009,Eeli Tolvanen,R,SEA,25,82,17,32,49
1,8477932,Aaron Ekblad,D,FLA,28,82,15,34,49
1,8474565,Alex Pietrangelo,D,VGK,34,82,10,39,49
1,8482109,Alexis Lafrenière,L,NYR,23,82,23,25,48
1,8475794,Tyler Seguin,C,DAL,32,82,20,28,48
1,8478519,Anthony Cirelli,C,TBL,27,82,17,31,48
1,8477964,Ivan Barbashev,C,VGK,29,82,16,32,48
1,8477021,Alex Kerfoot,C,ARI,30,82,14,34,48
1,8480798,Philipp Kurashev,C,CHI,25,82,12,36,48
1,8476869,Brady Skjei,D,CAR,30,82,11,37,48
1,8474578,Erik Karlsson,D,PIT,34,82,10,38,48
1,8480145,Neal Pionk,D,WPG,29,82,10,38,48
1,8479525,Ross Colton,C,COL,28,82,25,22,47
1,8478856,Conor Garland,R,VAN,28,82,23,24,47
1,8482740,Wyatt Johnston,C,DAL,21,82,20,27,47
1,8482745,Mason McTavish,C,ANA,21,82,19,28,47
1,8477479,Tyler Bertuzzi,L,TOR,29,82,16,31,47
1,8478472,Mathieu Joseph,R,OTT,27,82,13,34,47
1,8479425,Filip Hronek,D,VAN,27,82,10,37,47
1,8480865,Noah Dobson,D,NYI,24,82,7,40,47
1,8476892,Colton Parayko,D,STL,31,82,7,40,47
1,8478055,Gustav Forsling,D,FLA,28,82,6,41,47
1,8474586,Jordan Eberle,R,SEA,34,82,19,27,46
1,8475768,Jaden Schwartz,C,SEA,32,82,18,28,46
1,8479992,Michael Rasmussen,C,DET,25,82,18,28,46
1,8479941,Justin Danforth,R,CBJ,31,82,18,28,46
1,8471218,Blake Wheeler,R,NYR,38,82,16,30,46
1,8474679,Gustav Nyquist,C,NSH,35,82,15,31,46
1,8481656,Aliaksei Protas,C,WSH,23,82,15,31,46
1,8477496,Elias Lindholm,C,VAN,30,82,14,32,46
1,8477498,Darnell Nurse,D,EDM,29,82,9,37,46
1,8481618,Alex Newhook,C,MTL,23,82,28,17,45
1,8482110,Dawson Mercer,C,NJD,23,82,27,18,45
1,8480802,Ryan McLeod,C,EDM,25,82,24,21,45
1,8478474,Lawson Crouse,L,ARI,27,82,23,22,45
1,8476438,Brandon Saad,L,STL,32,82,21,24,45
1,8476826,Yanni Gourde,C,SEA,33,82,20,25,45
1,8480068,Ryan Poehling,C,PHI,25,82,19,26,45
1,8474157,Max Pacioretty,L,WSH,36,82,27,17,44
1,8478057,Dakota Joshua,C,VAN,28,82,24,20,44
1,8482159,Tyson Foerster,R,PHI,22,82,23,21,44
1,8482475,Yegor Chinakhov,R,CBJ,23,82,22,22,44
1,8479987,Morgan Geekie,C,BOS,26,82,21,23,44
1,8477511,Anthony Mantha,R,VGK,30,82,20,24,44
1,8473422,Nick Foligno,L,CHI,37,82,19,25,44
1,8482105,Jake Sanderson,D,OTT,22,82,18,26,44
1,8476923,Damon Severson,D,CBJ,30,82,10,34,44
1,8477935,Sam Bennett,C,FLA,28,82,26,17,43
1,8475314,Anders Lee,L,NYI,34,82,22,21,43
1,8475760,Nick Bjugstad,C,ARI,32,82,21,22,43
1,8483808,Andrei Kuzmenko,L,CGY,28,82,19,24,43
1,8476897,Oskar Sundqvist,C,STL,30,82,19,24,43
1,8477456,J.T. Compher,L,DET,29,82,15,28,43
1,8483515,Juraj Slafkovsky,L,MTL,20,82,14,29,43
1,8476458,Ryan Strome,C,ANA,31,82,13,30,43
1,8477346,MacKenzie Weegar,D,CGY,30,82,11,32,43
1,8482671,Owen Power,D,BUF,22,82,11,32,43
1,8478396,Noah Hanifin,D,VGK,27,82,10,33,43
1,8482684,Luke Hughes,D,NJD,21,82,9,34,43
1,8481542,Moritz Seider,D,DET,23,82,3,40,43
1,8478463,Anthony Beauvillier,L,NSH,27,82,21,21,42
1,8482720,Matthew Knies,L,TOR,22,82,21,21,42
1,8479345,Jakob Chychrun,D,OTT,26,82,18,24,42
1,8470613,Brent Burns,D,CAR,39,82,14,28,42
1,8477495,Seth Jones,D,CHI,30,82,13,29,42
1,8476419,Jean-Gabriel Pageau,C,NYI,32,82,13,29,42
1,8474716,Jared Spurgeon,D,MIN,35,82,12,30,42
1,8480434,Sean Durzi,D,ARI,26,82,11,31,42
1,8481581,Thomas Harley,D,DAL,23,82,11,31,42
1,8477948,Travis Sanheim,D,PHI,28,82,4,38,42
1,8478046,Danton Heinen,L,BOS,29,82,22,19,41
1,8475799,Nino Niederreiter,R,WPG,32,82,21,20,41
1,8475722,Jason Zucker,L,NSH,32,82,20,21,41
1,8474884,Mike Hoffman,C,SJS,35,82,18,23,41
1,8478891,Mason Appleton,C,WPG,28,82,17,24,41
1,8476927,Teddy Blueger,C,VAN,30,82,15,26,41
1,8479996,Cody Glass,C,NSH,25,82,15,26,41
1,8482667,William Eklund,L,SJS,22,82,13,28,41
1,8476931,Jake McCabe,D,TOR,31,82,9,32,41
1,8480849,Barrett Hayton,C,ARI,24,82,24,16,40
1,8470621,Corey Perry,R,EDM,39,82,24,16,40
1,8482055,Drew O'Connor,L,PIT,26,82,22,18,40
1,8481604,Pavel Dorofeyev,L,VGK,24,82,20,20,40
1,8482146,Luke Evangelista,R,NSH,22,82,19,21,40
1,8482097,Jack Quinn,R,BUF,23,82,17,23,40
1,8475287,Erik Haula,L,NJD,33,82,12,28,40
1,8475906,John Klingberg,D,TOR,32,82,6,34,40
1,8481560,Arthur Kaliyev,R,LAK,23,82,27,12,39
1,8482089,Jake Neighbours,L,STL,22,82,22,17,39
1,8474870,Tyler Johnson,C,CHI,34,82,21,18,39
1,8481554,Kaapo Kakko,R,NYR,23,82,21,18,39
1,8482113,Anton Lundell,C,FLA,23,82,13,26,39
1,8476885,Jacob Trouba,D,NYR,30,82,11,28,39
1,8481703,Valtteri Puustinen,R,PIT,25,82,8,31,39
1,8475171,Oliver Ekman-Larsson,D,FLA,33,82,4,35,39
1,8477969,Marcus Pettersson,D,PIT,28,82,3,36,39
1,8479365,Trent Frederic,C,BOS,26,82,22,16,38
1,8475793,Ryan Johansen,C,PHI,32,82,20,18,38
1,8480797,Joel Farabee,L,PHI,24,82,18,20,38
1,8474715,Cam Atkinson,R,PHI,35,82,16,22,38
1,8476872,Scott Laughton,C,PHI,30,82,15,23,38
1,8476960,Andreas Athanasiou,C,CHI,30,82,14,24,38
1,8477947,Sonny Milano,L,WSH,28,82,13,25,38
1,8476792,Torey Krug,D,STL,33,82,12,26,38
1,8477953,Kasperi Kapanen,R,STL,28,82,9,29,38
1,8475197,Tyson Barrie,D,NSH,33,82,7,31,38
1,8476463,Jonas Brodin,D,MIN,31,82,4,34,38
1,8478413,Jordan Greenway,L,BUF,27,82,20,17,37
1,8475158,Ryan O'Reilly,C,NSH,33,82,18,19,37
1,8475149,Marcus Johansson,L,MIN,34,82,13,24,37
1,8480185,Eetu Luostarinen,C,FLA,26,82,18,18,36
1,8479977,Kailer Yamamoto,R,SEA,26,82,18,18,36
1,8481624,Ilya Mikheyev,R,VAN,30,82,16,20,36
1,8479353,Brett Howden,C,VGK,26,82,16,20,36
1,8477989,Christian Dvorak,C,MTL,28,82,14,22,36
1,8482222,Alexander Barabanov,L,SJS,30,82,12,24,36
1,8476981,Josh Anderson,R,MTL,30,82,12,24,36
1,8475218,Mattias Ekholm,D,EDM,34,82,7,29,36
1,8476917,Adam Pelech,D,NYI,30,82,5,31,36
1,8480821,Filip Zadina,R,SJS,25,82,20,15,35
1,8481580,Connor McMichael,C,WSH,23,82,18,17,35
1,8476461,Sean Couturier,C,PHI,32,82,14,21,35
1,8475220,Marcus Foligno,L,MIN,33,82,14,21,35
1,8475714,Calle Jarnkrok,C,TOR,33,82,12,23,35
1,8475164,Jakob Silfverberg,R,ANA,34,82,12,23,35
1,8481553,Bobby Brink,R,PHI,23,82,11,24,35
1,8476958,Jaccob Slavin,D,CAR,30,82,9,26,35
1,8473507,Jeff Petry,D,DET,37,82,7,28,35
1,8480043,Timothy Liljegren,D,TOR,25,82,5,30,35
1,8482079,Marco Rossi,C,MIN,23,82,22,12,34
1,8484166,Adam Fantilli,C,CBJ,20,82,21,13,34
1,8477952,Robby Fabbri,C,DET,28,82,19,15,34
1,8473533,Jordan Staal,C,CAR,36,82,18,16,34
1,8481704,Juuso Parssinen,C,NSH,23,82,18,16,34
1,8470610,Zach Parise,L,COL,40,82,16,18,34
1,8480113,Alex Iafallo,L,WPG,31,82,15,19,34
1,8476925,Colton Sissons,C,NSH,31,82,14,20,34
1,8481013,Jonatan Berggren,R,DET,24,82,13,21,34
1,8474189,Lars Eller,C,PIT,35,82,13,21,34
1,8478911,Matt Roy,D,LAK,29,82,12,22,34
1,8476979,Erik Gustafsson,D,NYR,32,82,6,28,34
1,8475181,Nick Leddy,D,STL,33,82,5,29,34
1,8474151,Ryan McDonagh,D,NSH,35,82,4,30,34
1,8480893,Kirill Marchenko,R,CBJ,24,82,22,11,33
1,8477944,Jakub Vrana,L,STL,28,82,21,12,33
1,8477839,Conor Sheary,L,TBL,32,82,18,15,33
1,8482624,Daniil Miromanov,D,CGY,27,82,17,16,33
1,8479390,Taylor Raddysh,R,CHI,26,82,17,16,33
1,8477425,Miles Wood,L,COL,29,82,17,16,33
1,8476480,Vladislav Namestnikov,C,WPG,32,82,14,19,33
1,8480336,Sean Walker,D,COL,30,82,8,25,33
1,8482092,Ridly Greig,C,OTT,22,82,8,25,33
1,8480817,K'Andre Miller,D,NYR,24,82,7,26,33
1,8481546,Cam York,D,PHI,23,82,7,26,33
1,8476879,Cody Ceci,D,EDM,31,82,5,28,33
1,8481093,Rafael Harvey-Pinard,L,MTL,25,82,22,10,32
1,8473449,Kyle Okposo,R,FLA,36,82,17,15,32
1,8478109,Victor Olofsson,L,BUF,29,82,15,17,32
1,8476871,Tanner Pearson,L,MTL,32,82,15,17,32
1,8481477,Nico Sturm,C,SJS,29,82,15,17,32
1,8483431,Logan Cooley,C,ARI,20,82,15,17,32
1,8477998,Warren Foegele,L,EDM,28,82,11,21,32
1,8480220,Noah Cates,L,PHI,25,82,11,21,32
1,8480873,Rasmus Sandin,D,WSH,24,82,6,26,32
1,8479398,Samuel Girard,D,COL,26,82,5,27,32
1,8478507,John Marino,D,NJD,27,82,5,27,32
1,8478500,Ivan Provorov,D,CBJ,27,82,5,27,32
1,8479976,Juuso Valimaki,D,ARI,26,82,4,28,32
1,8477330,Dominik Kubalik,L,OTT,29,82,16,15,31
1,8482125,Alexander Holtz,R,NJD,22,82,13,18,31
1,8474149,Evgenii Dadonov,R,DAL,35,82,9,22,31
1,8477845,Trevor van Riemsdyk,D,WSH,33,82,4,27,31
1,8481517,Brett Leason,R,ANA,25,82,18,12,30
1,8479415,Michael McLeod,C,NJD,26,82,16,14,30
1,8478133,Jake Evans,C,MTL,28,82,10,20,30
1,8476921,Jordan Martinook,L,CAR,32,82,10,20,30
1,8478043,Sam Lafferty,C,VAN,29,82,10,20,30
1,8484153,Leo Carlsson,C,ANA,20,82,10,20,30
1,8482133,Thomas Bordeleau,C,SJS,22,82,9,21,30
1,8482122,Brock Faber,D,MIN,22,82,7,23,30
1,8475188,Brayden McNabb,D,VGK,33,82,3,27,30
1,8478020,Michael Amadio,C,VGK,28,82,16,13,29
1,8473563,Nicklas Backstrom,C,WSH,37,82,12,17,29
1,8477919,Frederick Gaudreau,C,MIN,31,82,12,17,29
1,8479293,Brandon Tanev,L,SEA,33,82,10,19,29
1,8477392,Hudson Fasching,R,NYI,29,82,10,19,29
1,8481606,Jordan Spence,D,LAK,23,82,8,21,29
1,8476902,Esa Lindell,D,DAL,30,82,8,21,29
1,8475200,Dmitry Orlov,D,CAR,33,82,7,22,29
1,8481601,Simon Holmstrom,R,NYI,23,82,16,12,28
1,8476873,Mark Jankowski,C,NSH,30,82,13,15,28
1,8475343,Nic Dowd,C,WSH,34,82,12,16,28
1,8479514,Rem Pitlick,C,CHI,27,82,10,18,28
1,8482111,Justin Barron,D,MTL,23,82,8,20,28
1,8480855,Jack McBain,C,ARI,24,82,6,22,28
1,8476457,Adam Larsson,D,SEA,32,82,5,23,28
1,8474037,James van Riemsdyk,L,BOS,35,82,13,14,27
1,8481186,Logan O'Connor,R,COL,28,82,13,14,27
1,8481535,Nils Hoglander,L,VAN,24,82,13,14,27
1,8482117,Lukas Reichel,L,CHI,22,82,12,15,27
1,8480806,Isac Lundestrom,C,ANA,25,82,11,16,27
1,8476422,Mike Reilly,D,NYI,31,82,10,17,27
1,8480871,Adam Boqvist,D,CBJ,24,82,8,19,27
1,8475279,Ben Chiarot,D,DET,33,82,8,19,27
1,8475231,Casey Cizikas,C,NYI,33,82,8,19,27
1,8475825,Jani Hakanpää,D,DAL,32,82,7,20,27
1,8475233,David Savard,D,MTL,34,82,6,21,27
1,8482142,Jamie Drysdale,D,PHI,22,82,6,21,27
1,8475324,Nick Jensen,D,WSH,34,82,6,21,27
1,8476392,Adam Lowry,C,WPG,31,82,11,15,26
1,8479661,Tanner Jeannot,L,TBL,27,82,11,15,26
1,8477508,Curtis Lazar,C,NJD,29,82,11,15,26
1,8481481,Blake Lizotte,C,LAK,27,82,10,16,26
1,8477015,Connor Brown,R,EDM,30,82,10,16,26
1,8476878,Zemgus Girgensons,L,BUF,30,82,10,16,26
1,8483457,Lane Hutson,D,MTL,20,82,9,17,26
1,8477353,Tyler Motte,C,TBL,29,82,8,18,26
1,8484203,Bradly Nadeau,L,CAR,19,82,8,18,26
1,8480074,Alexandre Texier,C,CBJ,25,82,7,19,26
1,8476467,Jamie Oleksiak,D,SEA,32,82,4,22,26
1,8475764,Cam Fowler,D,ANA,33,82,3,23,26
1,8480073,Erik Brannstrom,D,OTT,25,82,3,23,26
1,8470604,Jeff Carter,C,PIT,39,82,17,8,25
1,8480995,Pontus Holmberg,R,TOR,25,82,10,15,25
1,8482074,Connor Zary,C,CGY,23,82,10,15,25
1,8481537,Nikita Okhotiuk,D,CGY,24,82,9,16,25
1,8477931,Tomas Nosek,L,NJD,32,82,8,17,25
1,8479346,Dillon Dube,C,CGY,26,82,7,18,25
1,8479983,Mario Ferraro,D,SJS,26,82,7,18,25
1,8475842,Sam Carrick,C,EDM,32,82,7,18,25
1,8482655,J.J. Moser,D,ARI,24,82,4,21,25
1,8476312,Josh Manson,D,COL,33,82,4,21,25
1,8478136,Jake Middleton,D,MIN,28,82,3,22,25
1,8474574,Tyler Myers,D,VAN,34,82,2,23,25
1,8477220,Nate Schmidt,D,WPG,33,82,1,24,25
1,8482166,Shakir Mukhamadullin,D,SJS,22,82,14,10,24
1,8479591,Michael Eyssimont,C,TBL,28,82,12,12,24
1,8475848,Brendan Gallagher,R,MTL,32,82,12,12,24
1,8477406,Mattias Janmark,C,EDM,32,82,12,12,24
1,8480144,David Kampf,C,TOR,29,82,11,13,24
1,8478569,Noel Acciari,C,PIT,33,82,11,13,24
1,8481699,Aku Raty,R,ARI,23,82,5,19,24
1,8475690,Chris Tanev,D,DAL,35,82,4,20,24
1,8479980,Nicolas Hague,D,VGK,26,82,4,20,24
1,8479423,Alex Nylander,L,CBJ,26,82,14,9,23
1,8474034,Pat Maroon,L,BOS,36,82,11,12,23
1,8476374,Sean Kuraly,C,CBJ,31,82,11,12,23
1,8483493,Frank Nazar,C,CHI,20,82,11,12,23
1,8482062,Cole Smith,L,NSH,29,82,10,13,23
1,8479316,Luke Kunin,C,SJS,27,82,10,13,23
1,8476278,Colin Blackwell,C,CHI,31,82,9,14,23
1,8482733,Logan Mailloux,D,MTL,31,82,9,14,23
1,8478882,Vladislav Gavrikov,D,LAK,29,82,5,18,23
1,8482807,Ethan Del Mastro,D,CHI,21,82,5,18,23
1,8476331,Dylan DeMelo,D,WPG,31,82,3,20,23
1,8482087,Kaiden Guhle,D,MTL,22,82,3,20,23
1,8480813,Joe Veleno,C,DET,24,82,11,11,22
1,8479351,Sam Steel,C,DAL,26,82,10,12,22
1,8483565,Nick Blankenburg,D,CBJ,26,82,9,13,22
1,8484145,Zach Benson,L,BUF,19,82,9,13,22
1,8479359,Beck Malenstyn,L,WSH,26,82,9,13,22
1,8481522,Peyton Krebs,C,BUF,23,82,8,14,22
1,8483490,Pavel Mintyukov,D,ANA,21,82,7,15,22
1,8476891,Matt Grzelcyk,D,BOS,30,82,4,18,22
1,8478178,Darren Raddysh,D,TBL,28,82,4,18,22
1,8474567,Zach Bogosian,D,MIN,34,82,4,18,22
1,8477506,Ryan Pulock,D,NYI,30,82,3,19,22
1,8477435,Ryan Graves,D,PIT,29,82,3,19,22
1,8480807,Mattias Samuelsson,D,BUF,24,82,2,20,22
1,8482259,Bobby McMann,C,TOR,28,82,16,5,21
1,8479393,Noah Gregor,C,TOR,26,82,15,6,21
1,8477450,Jason Dickinson,C,CHI,29,82,12,9,21
1,8476469,Joel Armia,R,MTL,31,82,8,13,21
1,8476624,Barclay Goodrow,C,NYR,31,82,7,14,21
1,8482470,Ilya Solovyov,D,CGY,24,82,5,16,21
1,8479369,Andrew Peeke,D,BOS,26,82,4,17,21
1,8480796,Martin Fehervary,D,WSH,25,82,4,17,21
1,8482073,Braden Schneider,D,NYR,23,82,3,18,21
1,8478840,Will Borgen,D,SEA,28,82,2,19,21
1,8480035,Henri Jokiharju,D,BUF,25,82,2,19,21
1,8474013,Ian Cole,D,VAN,35,82,2,19,21
1,8481568,Alex Vlasic,D,CHI,23,82,0,21,21
1,8478013,Jake Walman,D,DET,28,82,10,10,20
1,8483524,Shane Wright,C,SEA,20,82,10,10,20
1,8480448,Parker Kelly,L,OTT,25,82,9,11,20
1,8482803,Olen Zellweger,D,ANA,21,82,8,12,20
1,8479383,Boris Katchouk,L,OTT,26,82,8,12,20
1,8475177,Calvin de Haan,D,TBL,33,82,6,14,20
1,8476967,Brett Kulak,D,EDM,30,82,4,16,20
1,8478399,Jonas Siegenthaler,D,NJD,27,82,4,16,20
1,8479371,Dante Fabbro,D,NSH,26,82,3,17,20
1,8481059,Scott Perunovich,D,STL,26,82,2,18,20
1,8478831,Kevin Stenlund,C,FLA,28,82,11,8,19
1,8483763,Maksymilian Szuber,D,ARI,22,82,9,10,19
1,8483468,Jiri Kulich,C,BUF,20,82,9,10,19
1,8477488,Brett Pesce,D,CAR,30,82,7,12,19
1,8473453,Trevor Lewis,C,LAK,37,82,7,12,19
1,8478416,Erik Cernak,D,TBL,27,82,6,13,19
1,8474166,Alec Martinez,D,VGK,37,82,6,13,19
1,8482666,Scott Morrow,D,CAR,22,82,6,13,19
1,8481178,Egor Zamula,D,PHI,24,82,3,16,19
1,8477507,Nikita Zadorov,D,VAN,29,82,3,16,19
1,8479998,Mikey Anderson,D,LAK,25,82,3,16,19
1,8482809,Jackson Blake,R,CAR,21,82,3,16,19
1,8482245,Artem Zub,D,OTT,29,82,1,18,19
1,8480281,Alexey Toropchenko,R,STL,25,82,11,7,18
1,8477505,Alexander Wennberg,C,NYR,30,82,10,8,18
1,8482679,Matt Coronato,R,CGY,22,82,9,9,18
1,8477499,Rasmus Ristolainen,D,PHI,30,82,7,11,18
1,8482737,Zack Bolduc,C,STL,21,82,7,11,18
1,8479291,Kevin Rooney,C,CGY,31,82,6,12,18
1,8479324,Ryan Lindgren,D,NYR,26,82,5,13,18
1,8478430,Oliver Kylington,D,CGY,27,82,5,13,18
1,8471677,Jack Johnson,D,COL,37,82,5,13,18
1,8475462,Radko Gudas,D,ANA,34,82,4,14,18
1,8480990,Declan Chisholm,D,MIN,24,82,4,14,18
1,8475179,Dmitry Kulikov,D,FLA,34,82,3,15,18
1,8470600,Ryan Suter,D,DAL,39,82,3,15,18
1,8481014,Alexander Romanov,D,NYI,24,82,2,16,18
1,8481567,Henry Thrun,D,SJS,23,82,2,16,18
1,8482155,Alex Laferriere,R,LAK,23,82,12,5,17
1,8481028,Martin Pospisil,C,CGY,25,82,9,8,17
1,8483491,Ivan Miroshnichenko,L,WSH,20,82,8,9,17
1,8482858,Ryker Evans,D,SEA,23,82,6,11,17
1,8482762,Simon Edvinsson,D,DET,21,82,6,11,17
1,8482730,Brandt Clarke,D,LAK,21,82,5,12,17
1,8482118,Sam Colangelo,R,ANA,23,82,5,12,17
1,8475790,Erik Gudbranson,D,CBJ,32,82,4,13,17
1,8476525,Colin Miller,D,WPG,32,82,3,14,17
1,8477365,Connor Clifton,D,BUF,29,82,3,14,17
1,8470966,Mark Giordano,D,TOR,41,82,3,14,17
1,8478859,Niko Mikkola,D,FLA,28,82,3,14,17
1,8474673,TJ Brodie,D,TOR,34,82,2,15,17
1,8478851,Alexandre Carrier,D,NSH,28,82,2,15,17
1,8480172,Jan Rutta,D,SJS,34,82,2,15,17
1,8478508,Yakov Trenin,C,COL,27,82,12,4,16
1,8476822,Luke Glendening,C,TBL,35,82,7,9,16
1,8479442,Troy Stecher,D,EDM,30,82,6,10,16
1,8483466,Kevin Korchinski,D,CHI,20,82,6,10,16
1,8483482,Tristan Luneau,D,ANA,20,82,5,11,16
1,8483499,Liam Ohgren,L,MIN,20,82,5,11,16
1,8476372,Nick Seeler,D,PHI,31,82,4,12,16
1,8480246,Nick Perbix,D,TBL,26,82,3,13,16
1,8477369,Carson Soucy,D,VAN,30,82,3,13,16
1,8475208,Brian Dumoulin,D,SEA,33,82,1,15,16
1,8480834,Ty Emberson,D,SJS,24,82,1,15,16
1,8476429,Scott Mayfield,D,NYI,32,82,0,16,16
1,8481605,Jackson LaCombe,D,ANA,23,82,7,8,15
1,8482702,Logan Stankoven,C,DAL,21,82,6,9,15
1,8478443,Brandon Carlo,D,BOS,28,82,5,10,15
1,8480058,Pierre-Olivier Joseph,D,PIT,25,82,4,11,15
1,8473504,Cal Clutterbuck,R,NYI,37,82,4,11,15
1,8483445,Cutter Gauthier,L,ANA,20,82,3,12,15
1,8480860,Kevin Bahl,D,NJD,24,82,1,14,15
1,8481524,Bowen Byram,D,BUF,23,82,9,5,14
1,8476858,Phillip Di Giuseppe,L,VAN,31,82,7,7,14
1,8483397,Marc McLaughlin,C,BOS,25,82,6,8,14
1,8483495,Simon Nemec,D,NJD,20,82,5,9,14
1,8481578,Graeme Clarke,R,NJD,23,82,4,10,14
1,8475762,Derek Forbort,D,BOS,32,82,3,11,14
1,8482516,Matthew Kessel,D,STL,24,82,2,12,14
1,8484149,Gavin Brindley,C,CBJ,20,82,1,13,14
1,8482177,Marat Khusnutdinov,C,MIN,22,82,1,13,14
1,8484911,Collin Graf,R,SJS,22,82,6,7,13
1,8483012,Logan Morrison,C,SEA,22,82,6,7,13
1,8480879,Jacob Bernard-Docker,D,OTT,24,82,3,10,13
1,8480031,Maxime Comtois,L,CAR,25,82,3,10,13
1,8477335,Kyle Burroughs,D,SJS,29,82,2,11,13
1,8478451,Ethan Bear,D,WSH,27,82,3,9,12
1,8476442,Matt Nieto,L,PIT,32,82,3,9,12
1,8481030,Jack St. Ivany,D,PIT,25,82,2,10,12
1,8483505,Matthew Poitras,C,BOS,20,82,2,10,12
1,8474009,Nick Bonino,C,NYR,36,82,7,4,11
1,8478468,Jeremy Lauzon,D,NSH,27,82,5,6,11
1,8481016,Ruslan Iskhakov,C,NYI,24,82,4,7,11
1,8481599,Victor Soderstrom,D,ARI,23,82,6,4,10
1,8482145,Mavrik Bourque,C,DAL,22,82,6,4,10
1,8482101,Danil Gushchin,L,SJS,22,82,4,6,10
1,8482859,Zack Ostapchuk,C,OTT,21,82,4,6,10
1,8478408,Travis Dermott,D,ARI,28,82,3,7,10
1,8483471,Brad Lambert,C,WPG,31,82,3,7,10
1,8476473,Connor Murphy,D,CHI,31,82,2,8,10
1,8475455,Brenden Dillon,D,WPG,34,82,0,10,10
1,8482713,Mackie Samoskevich,R,FLA,22,82,3,6,9
1,8477034,Jaycob Megna,D,CHI,32,82,1,8,9
1,8483489,Fraser Minten,C,TOR,31,82,3,4,7
1,8476915,Jujhar Khaira,L,MIN,30,82,3,4,7
1,8482712,Oskar Olausson,R,COL,22,82,2,4,6
1,8477950,Tony DeAngelo,D,CAR,29,0,0,0,0
1,8481577,Philip Tomasino,C,NSH,23,0,0,0,0
1,8482660,Kent Johnson,C,CBJ,22,0,0,0,0
1,8481019,David Gustafsson,C,WPG,24,0,0,0,0
1,8479348,Kale Clague,D,BUF,26,0,0,0,0
1,8482149,Cole Perfetti,C,WPG,22,0,0,0,0
1,8476952,Dominic Toninato,C,WPG,30,0,0,0,0
1,8473473,Milan Lucic,L,BOS,36,0,0,0,0
1,8480829,Jesperi Kotkaniemi,C,CAR,24,0,0,0,0
1,8474602,Justin Schultz,D,SEA,34,0,0,0,0
1,8480049,Dylan Samberg,D,WPG,25,0,0,0,0
1,8479372,Josh Mahura,D,FLA,26,0,0,0,0
1,8480878,Nils Lundkvist,D,DAL,24,0,0,0,0
1,8479982,Conor Timmins,D,TOR,26,0,0,0,0
1,8474031,Kevin Shattenkirk,D,BOS,35,0,0,0,0
1,8480835,Jack Drury,C,CAR,24,0,0,0,0
1,8480008,Adam Ruzicka,C,ARI,25,0,0,0,0
1,8479402,Jake Bean,D,CBJ,26,0,0,0,0
1,8476474,Stefan Noesen,R,CAR,31,0,0,0,0
1,8480884,Calen Addison,D,SJS,24,0,0,0,0
1,8476994,Vinnie Hinostroza,C,PIT,30,0,0,0,0
1,8477987,Ryan Donato,C,CHI,28,0,0,0,0
1,8481582,Nicholas Robertson,L,TOR,23,0,0,0,0
1,8478452,Caleb Jones,D,COL,27,0,0,0,0
1,8480157,Calle Rosen,D,STL,30,0,0,0,0
1,8481609,Vladislav Kolyachonok,D,ARI,23,0,0,0,0
1,8476919,Chris Tierney,C,NJD,30,0,0,0,0
1,8479639,Dylan Coghlan,D,CAR,26,0,0,0,0
1,8475193,Tomas Tatar,L,SEA,34,0,0,0,0
1,8480748,Kiefer Sherwood,L,NSH,29,0,0,0,0
1,8478146,Matthew Highmore,C,OTT,28,0,0,0,0
1,8478970,Jalen Chatfield,D,CAR,28,0,0,0,0
1,8480205,Emil Bemstrom,C,PIT,25,0,0,0,0
1,8471274,Alex Goligoski,D,MIN,39,0,0,0,0
1,8478104,Sammy Blais,L,STL,28,0,0,0,0
1,8476913,Devin Shore,C,SEA,30,0,0,0,0
1,8481708,Zac Jones,D,NYR,24,0,0,0,0
1,8480222,Sebastian Aho,D,NYI,28,0,0,0,0
1,8481598,Philip Broberg,D,EDM,23,0,0,0,0
1,8480789,Oliver Wahlstrom,R,NYI,24,0,0,0,0
1,8480891,Michael Kesselring,D,ARI,24,0,0,0,0
1,8477979,Nicolas Aube-Kubel,R,WSH,28,0,0,0,0
1,8476393,Nick Cousins,C,FLA,31,0,0,0,0
1,8480003,Jesper Boqvist,C,BOS,26,0,0,0,0
1,8479543,Michael Pezzetta,L,MTL,26,0,0,0,0
1,8475855,Jesper Fast,R,CAR,33,0,0,0,0
1,8477018,Ben Hutton,D,VGK,31,0,0,0,0
1,8480762,Eric Robinson,L,BUF,29,0,0,0,0
1,8481058,Jesse Ylönen,R,MTL,25,0,0,0,0
1,8481527,Kaedan Korczak,D,VGK,23,0,0,0,0
1,8482192,Isaak Phillips,D,CHI,23,0,0,0,0
1,8480727,Zach Whitecloud,D,VGK,28,0,0,0,0
1,8480001,Urho Vaakanainen,D,ANA,25,0,0,0,0
1,8480853,Liam Foudy,C,NSH,24,0,0,0,0
1,8475225,Craig Smith,C,DAL,35,0,0,0,0
1,8479972,Mason Shaw,C,MIN,26,0,0,0,0
1,8474040,Sam Gagner,C,EDM,35,0,0,0,0
1,8480196,Jacob Bryson,D,BUF,27,0,0,0,0
1,8475718,Justin Holl,D,DET,32,0,0,0,0
1,8479984,Cal Foote,D,NJD,26,0,0,0,0
1,8480011,Klim Kostin,C,SJS,25,0,0,0,0
1,8482176,Wyatt Kaiser,D,CHI,22,0,0,0,0
1,8476918,Jimmy Vesey,L,NYR,31,0,0,0,0
1,8476988,Matt Benning,D,SJS,30,0,0,0,0
1,8479370,Tyson Jost,C,BUF,26,0,0,0,0
1,8477464,Nic Petan,C,MIN,29,0,0,0,0
1,8477380,Jonny Brodzinski,C,NYR,31,0,0,0,0
1,8480070,Ian Mitchell,D,BOS,25,0,0,0,0
1,8479315,Joey Anderson,R,CHI,26,0,0,0,0
1,8478099,Kevin Labanc,R,SJS,29,0,0,0,0
1,8476874,Olli Maatta,D,DET,30,0,0,0,0
1,8479414,Nathan Bastian,R,NJD,27,0,0,0,0
1,8478434,Keegan Kolesar,R,VGK,27,0,0,0,0
1,8479536,Axel Jonsson-Fjallby,L,WPG,26,0,0,0,0
1,8479671,Mathieu Olivier,R,CBJ,27,0,0,0,0
1,8471709,Marc-Edouard Vlasic,D,SJS,37,0,0,0,0
1,8479328,Julien Gauthier,R,NYI,27,0,0,0,0
1,8478421,A.J. Greer,L,CGY,28,0,0,0,0
1,8477573,Nathan Walker,L,STL,30,0,0,0,0
1,8477478,William Carrier,L,VGK,30,0,0,0,0
1,8479344,Jesse Puljujarvi,R,PIT,26,0,0,0,0
1,8480887,Jordan Harris,D,MTL,24,0,0,0,0
1,8478502,Dennis Gilbert,D,CGY,28,0,0,0,0
1,8480355,Mark Kastelic,C,OTT,25,0,0,0,0
1,8475750,Jon Merrill,D,MIN,32,0,0,0,0
1,8476889,Radek Faksa,C,DAL,30,0,0,0,0
1,8478432,Christian Fischer,R,DET,27,0,0,0,0
1,8479439,Jacob MacDonald,D,SJS,31,0,0,0,0
1,8474568,Luke Schenn,D,NSH,35,0,0,0,0
1,8478454,Noah Juulsen,D,VAN,27,0,0,0,0
1,8475752,Tyler Pitlick,C,NYR,33,0,0,0,0
1,8482148,Hendrix Lapierre,C,WSH,22,0,0,0,0
1,8481167,Brayden Pachal,D,CGY,25,0,0,0,0
1,8478211,Dryden Hunt,L,CGY,29,0,0,0,0
1,8479321,Lucas Johansen,D,WSH,27,0,0,0,0
1,8480950,Ilya Lyubushkin,D,TOR,30,0,0,0,0
1,8479368,Max Jones,L,ANA,26,0,0,0,0
1,8471699,Andrew Cogliano,C,COL,37,0,0,0,0
1,8481521,Ronnie Attard,D,PHI,25,0,0,0,0
1,8481161,Jake Christiansen,D,CBJ,25,0,0,0,0
1,8479458,Nikita Zaitsev,D,CHI,33,0,0,0,0
1,8479619,Michael Carcone,L,ARI,28,0,0,0,0
1,8479026,Philippe Myers,D,TBL,27,0,0,0,0
1,8481617,Vasily Podkolzin,R,VAN,23,0,0,0,0
1,8481701,Santeri Hatakka,D,NJD,23,0,0,0,0
1,8477446,Michael McCarron,R,NSH,29,0,0,0,0
1,8483460,David Jiricek,D,CBJ,21,0,0,0,0
1,8474090,Brendan Smith,D,NJD,35,0,0,0,0
1,8482241,Radim Zohorna,L,PIT,28,0,0,0,0
1,8481032,Paul Cotter,C,VGK,25,0,0,0,0
1,8480289,Morgan Barron,C,WPG,26,0,0,0,0
1,8479379,Givani Smith,R,SJS,26,0,0,0,0
1,8480216,Jacob Peterson,C,SJS,25,0,0,0,0
1,8477851,Jordan Oesterle,D,CGY,32,0,0,0,0
1,8484258,Sam Malinski,D,COL,26,0,0,0,0
1,8478904,Steven Lorentz,C,FLA,28,0,0,0,0
1,8482095,Tyler Kleven,D,OTT,22,0,0,0,0
1,8480980,Connor Dewar,C,TOR,25,0,0,0,0
1,8480848,Ty Dellandrea,C,DAL,24,0,0,0,0
1,8476884,Derrick Pouliot,D,DAL,30,0,0,0,0
1,8480025,MacKenzie Entwistle,R,CHI,25,0,0,0,0
1,8474612,Travis Hamonic,D,OTT,34,0,0,0,0
1,8479336,Carl Grundstrom,R,LAK,27,0,0,0,0
1,8482964,Arber Xhekaj,D,MTL,23,0,0,0,0
1,8471686,Marc Staal,D,PHI,37,0,0,0,0
1,8477887,Patrick Brown,C,BOS,32,0,0,0,0
1,8478495,Denis Gurianov,R,PHI,27,0,0,0,0
1,8481550,Adam Beckman,L,MIN,23,0,0,0,0
1,8480845,Rasmus Kupari,C,WPG,24,0,0,0,0
1,8478585,Derek Ryan,C,EDM,38,0,0,0,0
1,8482141,Lukas Cormier,D,VGK,22,0,0,0,0
1,8477962,Brendan Lemieux,L,CAR,28,0,0,0,0
1,8482861,Vincent Iorio,D,WSH,22,0,0,0,0
1,8479378,Logan Stanley,D,WPG,26,0,0,0,0
1,8473446,Erik Johnson,D,PHI,36,0,0,0,0
1,8481743,Marc Del Gaizo,D,NSH,25,0,0,0,0
1,8478450,Parker Wotherspoon,D,BOS,27,0,0,0,0
1,8477384,Josh Brown,D,ARI,30,0,0,0,0
1,8482165,Yan Kuznetsov,D,CGY,22,0,0,0,0
1,8478424,Jansen Harkins,C,PIT,27,0,0,0,0
1,8482144,Jack Thompson,D,SJS,22,0,0,0,0
1,8479576,Vincent Desharnais,D,EDM,28,0,0,0,0
1,8478512,Austin Czarnik,C,DET,32,0,0,0,0
1,8477527,Ross Johnston,L,ANA,30,0,0,0,0
1,8482094,Daemon Hunt,D,MIN,22,0,0,0,0
1,8481719,Maxwell Crozier,D,TBL,24,0,0,0,0
1,8480192,Johnathan Kovacevic,D,MTL,27,0,0,0,0
1,8479376,Victor Mete,D,PHI,26,0,0,0,0
1,8482511,Mason Lohrei,D,BOS,23,0,0,0,0
1,8478021,William Lagesson,D,ANA,28,0,0,0,0
1,8475795,Dylan McIlrath,D,WSH,32,0,0,0,0
1,8477846,Ryan Carpenter,C,SJS,33,0,0,0,0
1,8481056,Spencer Stastney,D,NSH,24,0,0,0,0
1,8481564,Ryan Johnson,D,BUF,23,0,0,0,0
1,8478017,Mark Friedman,D,VAN,29,0,0,0,0
1,8479320,Max Lajoie,D,TOR,27,0,0,0,0
1,8480075,Cameron Crotty,D,ARI,25,0,0,0,0
1,8484287,Cole McWard,D,VAN,23,0,0,0,0
1,8484254,Akito Hirose,D,VAN,25,0,0,0,0
1,8483407,Brandon Scanlin,D,NYR,25,0,0,0,0
1,8480274,Philip Kemp,D,EDM,25,0,0,0,0
1,8479522,Hardy Haman Aktell,D,WSH,26,0,0,0,0
1,8480007,Jonas Rondbjerg,R,VGK,25,0,0,0,0
1,8477454,Adam Erne,L,EDM,29,0,0,0,0
1,8481679,Maxence Guenette,D,OTT,23,0,0,0,0
1,8477938,Haydn Fleury,D,TBL,28,0,0,0,0
1,8476441,Joel Edmundson,D,TOR,31,0,0,0,0
1,8477903,Garnet Hathaway,R,PHI,33,0,0,0,0
1,8480441,Trey Fix-Wolansky,R,CBJ,25,0,0,0,0
1,8483546,Marshall Rifai,D,TOR,26,0,0,0,0
1,8480084,Nick DeSimone,D,NJD,30,0,0,0,0
1,8481592,Jakob Pelletier,L,CGY,23,0,0,0,0
1,8478011,Louie Belpedio,D,PHI,28,0,0,0,0
1,8477930,Pierre-Edouard Bellemare,L,SEA,39,0,0,0,0
1,8484321,Nikolas Matinpalo,D,OTT,26,0,0,0,0
1,8482067,Connor Mackey,D,NYR,28,0,0,0,0
1,8481806,Louis Crevier,D,CHI,23,0,0,0,0
1,8484326,Patrik Koch,D,ARI,28,0,0,0,0
1,8477971,Andreas Englund,D,LAK,28,0,0,0,0
1,8481751,Lukas Rousek,R,BUF,25,0,0,0,0
1,8481006,Tyler Tucker,D,STL,24,0,0,0,0
1,8481641,Joel Kiviranta,L,COL,28,0,0,0,0
1,8476867,Brendan Gaunce,C,CBJ,30,0,0,0,0
1,8479520,Brandon Duhaime,R,COL,27,0,0,0,0
1,8477073,Kurtis MacDermid,L,NJD,30,0,0,0,0
1,8480874,Adam Ginning,D,PHI,24,0,0,0,0
1,8477473,Justin Bailey,R,SJS,29,0,0,0,0
1,8479066,Ryan Lomberg,L,FLA,30,0,0,0,0
1,8477070,Liam O'Brien,C,ARI,30,0,0,0,0
1,8474618,Marco Scandella,D,STL,34,0,0,0,0
1,8475797,Jarred Tinordi,D,CHI,32,0,0,0,0
1,8481441,Joe Snively,C,WSH,28,0,0,0,0
1,8477244,Chad Ruhwedel,D,NYR,34,0,0,0,0
1,8482077,Dylan Holloway,L,EDM,23,0,0,0,0
1,8479772,Zack MacEwen,R,OTT,28,0,0,0,0
1,8481147,Reese Johnson,C,CHI,26,0,0,0,0
1,8481043,Cole Koepke,L,TBL,26,0,0,0,0
1,8483619,Filip Roos,D,CHI,25,0,0,0,0
1,8481541,Samuel Bolduc,D,NYI,24,0,0,0,0
1,8477810,Joel Hanley,D,CGY,33,0,0,0,0
1,8476907,Mackenzie MacEachern,L,STL,30,0,0,0,0
1,8482652,Walker Duehr,R,CGY,27,0,0,0,0
1,8477126,Jayson Megna,C,BOS,34,0,0,0,0
1,8483398,Declan Carlile,D,TBL,31,0,0,0,0
1,8482929,Emil Lilleberg,D,TBL,23,0,0,0,0
1,8480880,Jakub Lauko,C,BOS,24,0,0,0,0
1,8478874,Adam Gaudette,C,STL,28,0,0,0,0
1,8480245,Olle Lycksell,R,PHI,25,0,0,0,0
1,8480252,Cole Guttman,C,CHI,25,0,0,0,0
1,8477467,Gustav Olofsson,D,SEA,30,0,0,0,0
1,8479968,Vinni Lettieri,C,MIN,29,0,0,0,0
1,8478400,Colin White,C,MTL,27,0,0,0,0
1,8475755,Alexander Petrovic,D,DAL,32,0,0,0,0
1,8481812,Nikolai Knyzhov,D,SJS,27,0,0,0,0
1,8481593,Jayden Struble,D,MTL,23,0,0,0,0
1,8481532,Alex Turcotte,C,LAK,23,0,0,0,0
1,8482126,Emil Andrae,D,PHI,31,0,0,0,0
1,8479944,Zach Aston-Reese,C,DET,30,0,0,0,0
1,8471817,Ryan Reaves,R,TOR,37,0,0,0,0
1,8481206,John Ludvig,D,PIT,24,0,0,0,0
1,8480292,Carson Meyer,R,CBJ,27,0,0,0,0
1,8482496,Nils Aman,C,VAN,24,0,0,0,0
1,8479718,Alex Barré-Boulet,C,TBL,27,0,0,0,0
1,8479994,Jaret Anderson-Dolan,C,NSH,25,0,0,0,0
1,8480184,Gustav Lindstrom,D,ANA,26,0,0,0,0
1,8480890,Jan Jenik,R,ARI,24,0,0,0,0
1,8478067,Oskar Lindblom,L,SJS,28,0,0,0,0
1,8476934,Brock McGinn,L,ANA,30,0,0,0,0
1,8479985,Cale Fleury,D,SEA,26,0,0,0,0
1,8482153,Brendan Brisson,C,VGK,23,0,0,0,0
1,8480021,Jack Studnicka,C,SJS,25,0,0,0,0
1,8484304,Uvis Balinskis,D,FLA,28,0,0,0,0
1,8479981,Jonah Gadjovich,L,FLA,26,0,0,0,0
1,8481716,Dmitri Voronkov,L,CBJ,24,0,0,0,0
1,8482659,Josh Doan,R,ARI,22,0,0,0,0
1,8481122,Simon Benoit,D,TOR,26,0,0,0,0
1,8474709,Matt Martin,L,NYI,35,0,0,0,0
1,8482634,Alex Steeves,C,TOR,25,0,0,0,0
1,8480823,Alexander Alexeyev,D,WSH,25,0,0,0,0
1,8477541,Dakota Mermis,D,MIN,30,0,0,0,0
1,8478477,Mitchell Stephens,C,MTL,27,0,0,0,0
1,8481543,Nikita Alexandrov,C,STL,24,0,0,0,0
1,8482451,Mikael Pyyhtia,L,CBJ,23,0,0,0,0
1,8480306,Grant Hutton,D,NYI,29,0,0,0,0
1,8478028,Fredrik Olofsson,L,COL,28,0,0,0,0
1,8477462,Robert Hagg,D,ANA,29,0,0,0,0
1,8477320,Anton Blidh,L,NYR,29,0,0,0,0
1,8482749,Joshua Roy,R,MTL,21,0,0,0,0
1,8482157,Will Cuylle,L,NYR,22,0,0,0,0
1,8481239,Samuel Fagemo,L,LAK,24,0,0,0,0
1,8481600,Tobias Bjornfot,D,FLA,23,0,0,0,0
1,8478409,Anthony Richard,C,BOS,28,0,0,0,0
1,8474145,Robert Bortuzzo,D,NYI,35,0,0,0,0
1,8475958,Michael Sgarbossa,C,WSH,32,0,0,0,0
1,8479986,Kole Lind,R,SEA,26,0,0,0,0
1,8479249,Andrew Poturalski,C,SEA,30,0,0,0,0
1,8479362,Riley Tufte,L,COL,26,0,0,0,0
1,8479991,Jake Leschyshyn,C,NYR,25,0,0,0,0
1,8479587,Rhett Gardner,C,PHI,28,0,0,0,0
1,8482744,James Malatesta,L,CBJ,21,0,0,0,0
1,8478854,Ryan Shea,D,PIT,27,0,0,0,0
1,8481591,Sam Poulin,R,PIT,23,0,0,0,0
1,8483512,Matt Savoie,C,BUF,20,0,0,0,0
1,8482102,Vasily Ponomarev,C,CAR,22,0,0,0,0
1,8482162,Roby Jarventie,L,OTT,22,0,0,0,0
1,8482172,Landon Slaggert,L,CHI,22,0,0,0,0
1,8482747,Brennan Othmann,L,NYR,21,0,0,0,0
1,8480226,Marián Studenic,R,SEA,26,0,0,0,0
1,8481518,Nolan Foote,L,NJD,24,0,0,0,0
1,8479419,Brett Murray,L,BUF,26,0,0,0,0
1,8482088,Justin Sourdif,R,FLA,22,0,0,0,0
1,8482201,Gage Goncalves,C,TBL,23,0,0,0,0
1,8481754,Nikita Nesterenko,C,ANA,23,0,0,0,0
1,8483531,Brian Halonen,L,NJD,25,0,0,0,0
1,8483920,Pierrick Dube,R,WSH,23,0,0,0,0
1,8480851,Akil Thomas,C,LAK,24,0,0,0,0
1,8475235,Nicolas Deslauriers,L,PHI,33,0,0,0,0
1,8482476,Emil Heineman,L,MTL,23,0,0,0,0
1,8477149,Scott Sabourin,R,SJS,32,0,0,0,0
1,8483549,Lucas Condotta,L,MTL,27,0,0,0,0
1,8483567,Georgii Merkulov,C,BOS,24,0,0,0,0
1,8482765,Isak Rosen,R,BUF,21,0,0,0,0
1,8481237,Kyle MacLean,C,NYI,25,0,0,0,0
1,8481024,Linus Karlsson,C,VAN,25,0,0,0,0
1,8481690,Tyler Angle,C,CBJ,24,0,0,0,0
1,8483570,Ben Meyers,C,ANA,26,0,0,0,0
1,8481655,Cole Schwindt,R,CGY,23,0,0,0,0
1,8481462,Mason Morelli,L,VGK,28,0,0,0,0
1,8483401,Marc Johnstone,R,PIT,28,0,0,0,0
1,8478956,Samuel Laberge,L,NJD,27,0,0,0,0
1,8479533,Joona Koppanen,L,PIT,26,0,0,0,0
1,8482197,Adam Raska,R,MIN,23,0,0,0,0
1,8482250,Callahan Burke,C,CAR,27,0,0,0,0
1,8482784,Zach Dean,C,STL,21,0,0,0,0
1,8484255,Jason Polin,R,COL,25,0,0,0,0
1,8481077,John Leonard,L,ARI,26,0,0,0,0
1,8481534,Raphael Lavoie,C,EDM,24,0,0,0,0
1,8483609,Adam Klapka,R,CGY,24,0,0,0,0
1,8482751,Ryan Winterton,C,SEA,21,0,0,0,0
1,8480267,Sammy Walker,C,MIN,25,0,0,0,0
1,8475766,Austin Watson,L,TBL,32,0,0,0,0
1,8482460,Matt Rempe,C,NYR,22,0,0,0,0
1,8482787,Nikita Chibrikov,R,WPG,31,0,0,0,0
1,8481065,Angus Crookshank,L,OTT,25,0,0,0,0
1,8481070,Hugh McGing,L,STL,26,0,0,0,0
1,8476323,Max McCormick,L,SEA,32,0,0,0,0
1,8483395,Arshdeep Bains,L,VAN,23,0,0,0,0
1,8484259,Ondrej Pavel,C,COL,31,0,0,0,0
1,8483432,Luca Del Bel Belluz,C,CBJ,31,0,0,0,0
1,8483045,Cameron Butler,R,CBJ,31,0,0,0,0
1,8482061,Brandon Biro,L,BUF,26,0,0,0,0
1,8477401,John Hayden,C,SEA,29,0,0,0,0
1,8475278,Byron Froese,C,VGK,33,0,0,0,0
1,8478446,Glenn Gawdin,C,ANA,27,0,0,0,0
1,8477993,Justin Kirkland,C,ARI,28,0,0,0,0
1,8482147,Jean-Luc Foudy,C,COL,22,0,0,0,0
1,8480032,Shane Bowers,C,NJD,25,0,0,0,0
1,8479330,Brandon Gignac,C,MTL,27,0,0,0,0
1,8480776,Sheldon Rempal,R,VGK,29,0,0,0,0
1,8475413,Justin Dowling,C,NJD,34,0,0,0,0
1,8481726,Adam Edstrom,C,NYR,24,0,0,0,0
1,8479638,Justin Brazeau,R,BOS,26,0,0,0,0
1,8480844,Grigori Denisenko,L,VGK,24,0,0,0,0
1,8474062,Riley Nash,C,NYR,35,0,0,0,0
1,8478147,Bokondji Imama,L,OTT,28,0,0,0,0
1,8478881,Brett Seney,L,CHI,28,0,0,0,0
1,8483630,Pavol Regenda,L,ANA,25,0,0,0,0
1,8480836,Jonathan Gruden,C,PIT,24,0,0,0,0
1,8484314,Jiri Smejkal,L,OTT,28,0,0,0,0
1,8475780,Chris Wagner,R,COL,33,0,0,0,0
1,8482070,Mitchell Chaffee,R,TBL,26,0,0,0,0
1,8479546,Oskar Steen,C,BOS,26,0,0,0,0
1,8483597,Milos Kelemen,L,ARI,25,0,0,0,0
1,8481789,Tye Kartye,L,SEA,23,0,0,0,0
1,8484325,Waltteri Merela,C,TBL,26,0,0,0,0
1,8479421,Jacob Moverare,D,LAK,26,0,0,0,0
1,8481585,Egor Afanasyev,L,NSH,23,0,0,0,0
1,8479547,Matthew Phillips,R,WSH,26,0,0,0,0
1,8479367,William Lockwood,R,FLA,26,0,0,0,0
1,8481422,Jacob Lucchini,C,MIN,29,0,0,0,0
1,8480468,James Hamblin,L,EDM,25,0,0,0,0
1,8480870,Bo Groulx,C,ANA,24,0,0,0,0
1,8478051,Max Willman,C,NJD,29,0,0,0,0
1,8481556,John Beecher,C,BOS,23,0,0,0,0
1,8478078,Rourke Chartier,C,OTT,28,0,0,0,0
2,8479318,Auston Matthews,C,TOR,27,82,76,66,142
2,8476453,Nikita Kucherov,R,TBL,31,82,28,113,141
2,8478402,Connor McDavid,C,EDM,27,82,45,89,134
2,8477492,Nathan MacKinnon,C,COL,29,82,41,78,119
2,8477956,David Pastrnak,R,BOS,28,82,50,60,110
2,8479314,Matthew Tkachuk,L,FLA,27,82,35,75,110
2,8478550,Artemi Panarin,L,NYR,33,82,40,69,109
2,8476468,J.T. Miller,C,VAN,31,82,42,66,108
2,8477934,Leon Draisaitl,C,EDM,29,82,55,50,105
2,8477933,Sam Reinhart,C,FLA,29,82,48,57,105
2,8478010,Brayden Point,C,TBL,28,82,48,53,101
2,8477402,Pavel Buchnevich,L,STL,29,82,33,67,100
2,8478864,Kirill Kaprizov,L,MIN,27,82,50,48,98
2,8471675,Sidney Crosby,C,PIT,37,82,48,50,98
2,8477939,William Nylander,R,TOR,28,82,43,55,98
2,8481559,Jack Hughes,C,NJD,23,82,34,63,97
2,8477409,Carter Verhaeghe,C,FLA,29,82,48,47,95
2,8476459,Mika Zibanejad,C,NYR,31,82,35,60,95
2,8476389,Vincent Trocheck,C,NYR,31,82,42,52,94
2,8478420,Mikko Rantanen,R,COL,28,82,27,67,94
2,8471214,Alex Ovechkin,L,WSH,39,82,47,46,93
2,8473419,Brad Marchand,L,BOS,36,82,36,55,91
2,8475913,Mark Stone,R,VGK,32,82,24,67,91
2,8479337,Alex DeBrincat,R,DET,27,82,36,54,90
2,8476460,Mark Scheifele,C,WPG,31,82,31,59,90
2,8478445,Mathew Barzal,C,NYI,27,82,28,62,90
2,8479420,Tage Thompson,C,BUF,27,82,46,43,89
2,8478403,Jack Eichel,C,VGK,28,82,43,46,89
2,8482665,Matty Beniers,C,SEA,22,82,35,54,89
2,8477447,Shea Theodore,D,VGK,29,82,15,74,89
2,8475754,Brock Nelson,C,NYI,33,82,43,45,88
2,8477949,Alex Tuch,R,BUF,28,82,36,52,88
2,8480002,Nico Hischier,C,NJD,25,82,35,53,88
2,8480023,Robert Thomas,C,STL,25,82,29,59,88
2,8478427,Sebastian Aho,C,CAR,27,82,44,43,87
2,8476887,Filip Forsberg,L,NSH,30,82,42,45,87
2,8482116,Tim Stützle,C,OTT,22,82,34,51,85
2,8477946,Dylan Larkin,C,DET,28,82,42,42,84
2,8477404,Jake Guentzel,C,CAR,30,82,41,42,83
2,8477951,Nick Schmaltz,C,ARI,28,82,29,54,83
2,8479343,Clayton Keller,R,ARI,26,82,37,45,82
2,8479407,Jesper Bratt,L,NJD,26,82,33,49,82
2,8475172,Nazem Kadri,C,CGY,34,82,28,54,82
2,8481523,Kirby Dach,C,MTL,23,82,17,65,82
2,8478398,Kyle Connor,L,WPG,28,82,37,44,81
2,8475692,Mats Zuccarello,R,MIN,37,82,24,57,81
2,8476539,Jonathan Marchessault,R,VGK,34,82,48,32,80
2,8474564,Steven Stamkos,C,TBL,34,82,43,37,80
2,8481557,Matt Boldy,L,MIN,23,82,36,44,80
2,8475184,Chris Kreider,L,NYR,33,82,44,35,79
2,8478439,Travis Konecny,R,PHI,27,82,34,45,79
2,8480801,Brady Tkachuk,L,OTT,25,82,30,49,79
2,8480027,Jason Robertson,L,DAL,25,82,26,53,79
2,8473512,Claude Giroux,R,OTT,36,82,26,53,79
2,8477504,Josh Morrissey,D,WPG,29,82,19,60,79
2,8477942,Kevin Fiala,L,LAK,28,82,30,48,78
2,8480830,Andrei Svechnikov,R,CAR,24,82,30,48,78
2,8474600,Roman Josi,D,NSH,34,82,20,58,78
2,8480069,Cale Makar,D,COL,26,82,17,61,78
2,8474578,Erik Karlsson,D,PIT,34,82,16,62,78
2,8480012,Elias Pettersson,C,VAN,26,82,36,41,77
2,8480015,Owen Tippett,R,PHI,25,82,34,42,76
2,8476454,Ryan Nugent-Hopkins,C,EDM,31,82,21,55,76
2,8475810,Bryan Rust,R,PIT,32,82,40,35,75
2,8479385,Jordan Kyrou,C,STL,26,82,29,46,75
2,8474590,John Carlson,D,WSH,34,82,14,61,75
2,8480800,Quinn Hughes,D,VAN,25,82,13,62,75
2,8474141,Patrick Kane,R,DET,36,82,28,46,74
2,8476346,Johnny Gaudreau,L,CBJ,31,82,16,58,74
2,8480839,Rasmus Dahlin,D,BUF,24,82,11,63,74
2,8475786,Zach Hyman,L,EDM,32,82,35,38,73
2,8476881,Tomas Hertl,C,VGK,31,82,28,45,73
2,8471685,Anze Kopitar,C,LAK,37,82,25,48,73
2,8480865,Noah Dobson,D,NYI,24,82,15,58,73
2,8479542,Brandon Hagel,L,TBL,26,82,36,36,72
2,8480208,Drake Batherson,R,OTT,26,82,27,45,72
2,8475158,Ryan O'Reilly,C,NSH,33,82,24,48,72
2,8475167,Victor Hedman,D,TBL,34,82,16,56,72
2,8479323,Adam Fox,D,NYR,26,82,9,63,72
2,8478449,Roope Hintz,C,DAL,28,82,37,34,71
2,8477501,Valeri Nichushkin,R,COL,29,82,32,39,71
2,8480039,Martin Necas,C,CAR,25,82,28,43,71
2,8475170,Brayden Schenn,C,STL,33,82,27,44,71
2,8477493,Aleksander Barkov,C,FLA,29,82,23,48,71
2,8478440,Dylan Strome,C,WSH,27,82,28,42,70
2,8477960,Adrian Kempe,R,LAK,28,82,28,42,70
2,8478414,Timo Meier,R,NJD,28,82,46,23,69
2,8477500,Bo Horvat,C,NYI,29,82,33,36,69
2,8475166,John Tavares,C,TOR,34,82,31,38,69
2,8476456,Jonathan Huberdeau,C,CGY,31,82,19,50,69
2,8478042,Viktor Arvidsson,R,LAK,31,82,19,50,69
2,8479675,Trevor Moore,L,LAK,29,82,39,29,68
2,8482093,Seth Jarvis,C,CAR,22,82,28,40,68
2,8479339,Patrik Laine,L,CBJ,26,82,27,41,68
2,8475314,Anders Lee,L,NYI,34,82,33,34,67
2,8471215,Evgeni Malkin,C,PIT,38,82,29,38,67
2,8476905,Chandler Stephenson,C,VGK,30,82,23,44,67
2,8482124,Quinton Byfield,R,LAK,22,82,22,45,67
2,8476432,Boone Jenner,C,CBJ,31,82,35,31,66
2,8481596,Shane Pinto,C,OTT,24,82,30,36,66
2,8477935,Sam Bennett,C,FLA,28,82,31,34,65
2,8478519,Anthony Cirelli,C,TBL,27,82,30,35,65
2,8482078,Lucas Raymond,L,DET,22,82,26,39,65
2,8478444,Brock Boeser,R,VAN,27,82,34,30,64
2,8478873,Troy Terry,R,ANA,27,82,25,39,64
2,8476853,Morgan Rielly,D,TOR,30,82,14,50,64
2,8482109,Alexis Lafrenière,L,NYR,23,82,34,29,63
2,8470794,Joe Pavelski,C,DAL,40,82,33,30,63
2,8475784,Jeff Skinner,C,BUF,32,82,32,31,63
2,8477407,Anthony Duclair,L,TBL,29,82,20,43,63
2,8478460,Zach Werenski,D,CBJ,27,82,13,50,63
2,8478397,Rasmus Andersson,D,CGY,28,82,7,56,63
2,8475726,Tyler Toffoli,C,WPG,32,82,37,25,62
2,8479992,Michael Rasmussen,C,DET,25,82,21,41,62
2,8477940,Nikolaj Ehlers,L,WPG,28,82,18,44,62
2,8471724,Kris Letang,D,PIT,37,82,18,44,62
2,8474563,Drew Doughty,D,LAK,35,82,17,45,62
2,8475745,Charlie Coyle,C,BOS,32,82,27,34,61
2,8477416,Oliver Bjorkstrand,R,SEA,29,82,26,35,61
2,8476448,William Karlsson,C,VGK,31,82,25,36,61
2,8481533,Trevor Zegras,C,ANA,23,82,24,37,61
2,8476869,Brady Skjei,D,CAR,30,82,12,49,61
2,8479325,Charlie McAvoy,D,BOS,27,82,9,52,61
2,8473994,Jamie Benn,L,DAL,35,82,21,39,60
2,8476462,Dougie Hamilton,D,NJD,31,82,17,43,60
2,8480036,Miro Heiskanen,D,DAL,25,82,14,46,60
2,8477495,Seth Jones,D,CHI,30,82,13,47,60
2,8479410,Mikhail Sergachev,D,TBL,26,82,9,51,60
2,8480014,Gabriel Vilardi,C,WPG,25,82,31,28,59
2,8477955,Jared McCann,L,SEA,28,82,27,32,59
2,8477986,Brandon Montour,D,FLA,30,82,22,37,59
2,8477497,Sean Monahan,C,WPG,30,82,22,37,59
2,8478493,Joel Eriksson Ek,C,MIN,27,82,20,39,59
2,8476875,Mike Matheson,D,MTL,30,82,12,47,59
2,8477511,Anthony Mantha,R,VGK,30,82,27,31,58
2,8481618,Alex Newhook,C,MTL,23,82,21,37,58
2,8480018,Nick Suzuki,C,MTL,25,82,19,39,58
2,8480078,Filip Chytil,C,NYR,25,82,19,39,58
2,8482684,Luke Hughes,D,NJD,21,82,12,46,58
2,8475798,Mikael Granlund,C,SJS,32,82,10,48,58
2,8480803,Evan Bouchard,D,EDM,25,82,8,50,58
2,8481540,Cole Caufield,R,MTL,23,82,30,27,57
2,8477476,Artturi Lehkonen,L,COL,29,82,27,30,57
2,8482097,Jack Quinn,R,BUF,23,82,21,36,57
2,8477451,Ryan Hartman,R,MIN,30,82,20,37,57
2,8479345,Jakob Chychrun,D,OTT,26,82,20,37,57
2,8478407,Vince Dunn,D,SEA,28,82,17,40,57
2,8476792,Torey Krug,D,STL,33,82,16,41,57
2,8478438,Tommy Novak,C,NSH,27,82,21,35,56
2,8481068,Yegor Sharangovich,C,CGY,26,82,22,33,55
2,8477346,MacKenzie Weegar,D,CGY,30,82,20,35,55
2,8481711,Matias Maccelli,L,ARI,24,82,19,36,55
2,8477932,Aaron Ekblad,D,FLA,28,82,19,36,55
2,8473986,Alex Killorn,L,ANA,35,82,18,37,55
2,8475753,Justin Faulk,D,STL,32,82,12,43,55
2,8480064,Josh Norris,C,OTT,25,82,34,20,54
2,8478366,Frank Vatrano,R,ANA,30,82,27,27,54
2,8478401,Pavel Zacha,C,BOS,27,82,23,31,54
2,8478047,Michael Bunting,L,PIT,29,82,21,33,54
2,8474586,Jordan Eberle,R,SEA,34,82,18,36,54
2,8479425,Filip Hronek,D,VAN,27,82,7,47,54
2,8475151,Kyle Palmieri,C,NYI,33,82,31,22,53
2,8483808,Andrei Kuzmenko,L,CGY,28,82,29,24,53
2,8480798,Philipp Kurashev,C,CHI,25,82,21,32,53
2,8477496,Elias Lindholm,C,VAN,30,82,20,33,53
2,8476882,Teuvo Teravainen,L,CAR,30,82,16,37,53
2,8479999,Casey Mittelstadt,C,COL,26,82,14,39,53
2,8476958,Jaccob Slavin,D,CAR,30,82,13,40,53
2,8479365,Trent Frederic,C,BOS,26,82,22,30,52
2,8474102,David Perron,L,DET,36,82,18,34,52
2,8470613,Brent Burns,D,CAR,39,82,18,34,52
2,8479400,Pierre-Luc Dubois,L,LAK,26,82,17,35,52
2,8474565,Alex Pietrangelo,D,VGK,34,82,14,38,52
2,8475763,Kevin Hayes,R,STL,32,82,10,42,52
2,8480434,Sean Durzi,D,ARI,26,82,7,45,52
2,8476438,Brandon Saad,L,STL,32,82,31,20,51
2,8477494,Jonathan Drouin,L,COL,29,82,22,29,51
2,8482110,Dawson Mercer,C,NJD,23,82,21,30,51
2,8482720,Matthew Knies,L,TOR,22,82,21,30,51
2,8478498,Jake DeBrusk,L,BOS,28,82,20,31,51
2,8477444,Andre Burakovsky,L,SEA,29,82,17,34,51
2,8475744,Evgeny Kuznetsov,C,CAR,32,82,16,35,51
2,8475191,Reilly Smith,R,PIT,33,82,16,35,51
2,8482745,Mason McTavish,C,ANA,21,82,26,24,50
2,8474053,Logan Couture,C,SJS,35,82,22,28,50
2,8482175,JJ Peterka,R,BUF,22,82,21,29,50
2,8481528,Dylan Cozens,C,BUF,23,82,20,30,50
2,8476897,Oskar Sundqvist,C,STL,30,82,19,31,50
2,8476906,Shayne Gostisbehere,D,DET,31,82,17,33,50
2,8478469,Thomas Chabot,D,OTT,27,82,14,36,50
2,8481542,Moritz Seider,D,DET,23,82,3,47,50
2,8479996,Cody Glass,C,NSH,25,82,31,18,49
2,8476483,Rickard Rakell,R,PIT,31,82,26,23,49
2,8474679,Gustav Nyquist,C,NSH,35,82,22,27,49
2,8475848,Brendan Gallagher,R,MTL,32,82,22,27,49
2,8474150,Mikael Backlund,C,CGY,35,82,21,28,49
2,8478856,Conor Garland,R,VAN,28,82,19,30,49
2,8478474,Lawson Crouse,L,ARI,27,82,19,30,49
2,8475168,Matt Duchene,C,DAL,33,82,15,34,49
2,8471698,T.J. Oshie,R,WSH,38,82,24,24,48
2,8475765,Vladimir Tarasenko,R,FLA,33,82,19,29,48
2,8478466,Daniel Sprong,R,DET,27,82,19,29,48
2,8478038,Devon Toews,D,COL,30,82,13,35,48
2,8476923,Damon Severson,D,CBJ,30,82,11,37,48
2,8475794,Tyler Seguin,C,DAL,32,82,23,24,47
2,8476479,Phillip Danault,C,LAK,31,82,16,31,47
2,8478396,Noah Hanifin,D,VGK,27,82,11,36,47
2,8477426,Nicholas Paul,L,TBL,29,82,26,20,46
2,8476880,Tom Wilson,R,WSH,30,82,22,24,46
2,8482667,William Eklund,L,SJS,22,82,21,25,46
2,8476458,Ryan Strome,C,ANA,31,82,20,26,46
2,8475169,Evander Kane,L,EDM,33,82,19,27,46
2,8478975,Mason Marchment,L,DAL,29,82,19,27,46
2,8477964,Ivan Barbashev,C,VGK,29,82,18,28,46
2,8482475,Yegor Chinakhov,R,CBJ,23,82,17,29,46
2,8474157,Max Pacioretty,L,WSH,36,82,15,31,46
2,8475791,Taylor Hall,L,CHI,33,82,13,33,46
2,8482105,Jake Sanderson,D,OTT,22,82,12,34,46
2,8478055,Gustav Forsling,D,FLA,28,82,5,41,46
2,8475722,Jason Zucker,L,NSH,32,82,28,17,45
2,8480459,Pius Suter,C,VAN,28,82,27,18,45
2,8482740,Wyatt Johnston,C,DAL,21,82,22,23,45
2,8478462,Nicolas Roy,C,VGK,27,82,20,25,45
2,8482705,Cole Sillinger,C,CBJ,21,82,19,26,45
2,8480113,Alex Iafallo,L,WPG,31,82,19,26,45
2,8480797,Joel Farabee,L,PHI,24,82,16,29,45
2,8475287,Erik Haula,L,NJD,33,82,15,30,45
2,8481535,Nils Hoglander,L,VAN,24,82,23,21,44
2,8481656,Aliaksei Protas,C,WSH,23,82,20,24,44
2,8478542,Evan Rodrigues,C,FLA,31,82,14,30,44
2,8471218,Blake Wheeler,R,NYR,38,82,14,30,44
2,8475171,Oliver Ekman-Larsson,D,FLA,33,82,9,35,44
2,8476979,Erik Gustafsson,D,NYR,32,82,7,37,44
2,8475149,Marcus Johansson,L,MIN,34,82,24,19,43
2,8481604,Pavel Dorofeyev,L,VGK,24,82,23,20,43
2,8474641,Adam Henrique,C,EDM,34,82,20,23,43
2,8482113,Anton Lundell,C,FLA,23,82,20,23,43
2,8480185,Eetu Luostarinen,C,FLA,26,82,19,24,43
2,8477952,Robby Fabbri,C,DET,28,82,19,24,43
2,8474037,James van Riemsdyk,L,BOS,35,82,19,24,43
2,8478472,Mathieu Joseph,R,OTT,27,82,18,25,43
2,8480188,Fabian Zetterlund,L,SJS,25,82,16,27,43
2,8477456,J.T. Compher,L,DET,29,82,16,27,43
2,8476927,Teddy Blueger,C,VAN,30,82,15,28,43
2,8475218,Mattias Ekholm,D,EDM,34,82,12,31,43
2,8476872,Scott Laughton,C,PHI,30,82,22,20,42
2,8476871,Tanner Pearson,L,MTL,32,82,22,20,42
2,8480849,Barrett Hayton,C,ARI,24,82,21,21,42
2,8475760,Nick Bjugstad,C,ARI,32,82,20,22,42
2,8482146,Luke Evangelista,R,NSH,22,82,19,23,42
2,8476419,Jean-Gabriel Pageau,C,NYI,32,82,17,25,42
2,8475714,Calle Jarnkrok,C,TOR,33,82,17,25,42
2,8480028,Morgan Frost,C,PHI,25,82,14,28,42
2,8482671,Owen Power,D,BUF,22,82,8,34,42
2,8475799,Nino Niederreiter,R,WPG,32,82,24,17,41
2,8480009,Eeli Tolvanen,R,SEA,25,82,20,21,41
2,8482092,Ridly Greig,C,OTT,22,82,19,22,41
2,8473449,Kyle Okposo,R,FLA,36,82,19,22,41
2,8477479,Tyler Bertuzzi,L,TOR,29,82,17,24,41
2,8475793,Ryan Johansen,C,PHI,32,82,16,25,41
2,8476392,Adam Lowry,C,WPG,31,82,14,27,41
2,8475197,Tyson Barrie,D,NSH,33,82,4,37,41
2,8481186,Logan O'Connor,R,COL,28,82,22,18,40
2,8476826,Yanni Gourde,C,SEA,33,82,18,22,40
2,8482159,Tyson Foerster,R,PHI,22,82,17,23,40
2,8479987,Morgan Geekie,C,BOS,26,82,17,23,40
2,8477947,Sonny Milano,L,WSH,28,82,16,24,40
2,8477839,Conor Sheary,L,TBL,32,82,15,25,40
2,8476329,Travis Boyd,C,ARI,31,82,11,29,40
2,8477503,Max Domi,C,TOR,29,82,11,29,40
2,8475768,Jaden Schwartz,C,SEA,32,82,11,29,40
2,8481606,Jordan Spence,D,LAK,23,82,11,29,40
2,8481546,Cam York,D,PHI,23,82,10,30,40
2,8478013,Jake Walman,D,DET,28,82,18,21,39
2,8480220,Noah Cates,L,PHI,25,82,15,24,39
2,8477498,Darnell Nurse,D,EDM,29,82,12,27,39
2,8480817,K'Andre Miller,D,NYR,24,82,9,30,39
2,8482699,Dylan Guenther,R,ARI,21,82,21,17,38
2,8479941,Justin Danforth,R,CBJ,31,82,19,19,38
2,8474149,Evgenii Dadonov,R,DAL,35,82,19,19,38
2,8481624,Ilya Mikheyev,R,VAN,30,82,17,21,38
2,8481481,Blake Lizotte,C,LAK,27,82,17,21,38
2,8473563,Nicklas Backstrom,C,WSH,37,82,12,26,38
2,8476480,Vladislav Namestnikov,C,WPG,32,82,10,28,38
2,8478020,Michael Amadio,C,VGK,28,82,20,17,37
2,8482089,Jake Neighbours,L,STL,22,82,19,18,37
2,8476399,Blake Coleman,C,CGY,33,82,18,19,37
2,8483515,Juraj Slafkovsky,L,MTL,20,82,16,21,37
2,8484203,Bradly Nadeau,L,CAR,19,82,15,22,37
2,8478413,Jordan Greenway,L,BUF,27,82,10,27,37
2,8478458,Jack Roslovic,C,NYR,27,82,9,28,37
2,8475200,Dmitry Orlov,D,CAR,33,82,9,28,37
2,8480043,Timothy Liljegren,D,TOR,25,82,5,32,37
2,8478507,John Marino,D,NJD,27,82,3,34,37
2,8475906,John Klingberg,D,TOR,32,82,1,36,37
2,8481580,Connor McMichael,C,WSH,23,82,18,18,36
2,8473422,Nick Foligno,L,CHI,37,82,17,19,36
2,8476921,Jordan Martinook,L,CAR,32,82,16,20,36
2,8474716,Jared Spurgeon,D,MIN,35,82,15,21,36
2,8482111,Justin Barron,D,MTL,23,82,13,23,36
2,8476885,Jacob Trouba,D,NYR,30,82,12,24,36
2,8477948,Travis Sanheim,D,PHI,28,82,8,28,36
2,8476917,Adam Pelech,D,NYI,30,82,6,30,36
2,8484144,Connor Bedard,C,CHI,19,82,15,20,35
2,8480802,Ryan McLeod,C,EDM,25,82,15,20,35
2,8480806,Isac Lundestrom,C,ANA,25,82,15,20,35
2,8477429,Andrew Copp,C,DET,30,82,14,21,35
2,8476292,Ondrej Palat,L,NJD,33,82,12,23,35
2,8482222,Alexander Barabanov,L,SJS,30,82,12,23,35
2,8478133,Jake Evans,C,MTL,28,82,10,25,35
2,8482142,Jamie Drysdale,D,PHI,22,82,8,27,35
2,8476854,Hampus Lindholm,D,BOS,30,82,6,29,35
2,8481554,Kaapo Kakko,R,NYR,23,82,21,13,34
2,8470610,Zach Parise,L,COL,40,82,20,14,34
2,8482117,Lukas Reichel,L,CHI,22,82,19,15,34
2,8479661,Tanner Jeannot,L,TBL,27,82,17,17,34
2,8477021,Alex Kerfoot,C,ARI,30,82,16,18,34
2,8478057,Dakota Joshua,C,VAN,28,82,15,19,34
2,8478569,Noel Acciari,C,PIT,33,82,14,20,34
2,8477989,Christian Dvorak,C,MTL,28,82,13,21,34
2,8482055,Drew O'Connor,L,PIT,26,82,12,22,34
2,8481581,Thomas Harley,D,DAL,23,82,11,23,34
2,8476925,Colton Sissons,C,NSH,31,82,11,23,34
2,8478911,Matt Roy,D,LAK,29,82,9,25,34
2,8474673,TJ Brodie,D,TOR,34,82,6,28,34
2,8474574,Tyler Myers,D,VAN,34,82,5,29,34
2,8482245,Artem Zub,D,OTT,29,82,5,29,34
2,8475764,Cam Fowler,D,ANA,33,82,1,33,34
2,8478233,Andrew Mangiapane,L,CGY,28,82,21,12,33
2,8479525,Ross Colton,C,COL,28,82,20,13,33
2,8477998,Warren Foegele,L,EDM,28,82,19,14,33
2,8479393,Noah Gregor,C,TOR,26,82,19,14,33
2,8481560,Arthur Kaliyev,R,LAK,23,82,18,15,33
2,8478046,Danton Heinen,L,BOS,29,82,17,16,33
2,8473533,Jordan Staal,C,CAR,36,82,16,17,33
2,8480871,Adam Boqvist,D,CBJ,24,82,14,19,33
2,8482125,Alexander Holtz,R,NJD,22,82,13,20,33
2,8477508,Curtis Lazar,C,NJD,29,82,13,20,33
2,8480145,Neal Pionk,D,WPG,29,82,6,27,33
2,8479371,Dante Fabbro,D,NSH,26,82,5,28,33
2,8477944,Jakub Vrana,L,STL,28,82,24,8,32
2,8476981,Josh Anderson,R,MTL,30,82,21,11,32
2,8480068,Ryan Poehling,C,PHI,25,82,17,15,32
2,8483431,Logan Cooley,C,ARI,20,82,17,15,32
2,8482259,Bobby McMann,C,TOR,28,82,17,15,32
2,8479977,Kailer Yamamoto,R,SEA,26,82,16,16,32
2,8475343,Nic Dowd,C,WSH,34,82,15,17,32
2,8479346,Dillon Dube,C,CGY,26,82,15,17,32
2,8479293,Brandon Tanev,L,SEA,33,82,14,18,32
2,8478891,Mason Appleton,C,WPG,28,82,11,21,32
2,8474870,Tyler Johnson,C,CHI,34,82,11,21,32
2,8480813,Joe Veleno,C,DET,24,82,11,21,32
2,8482133,Thomas Bordeleau,C,SJS,22,82,8,24,32
2,8480035,Henri Jokiharju,D,BUF,25,82,7,25,32
2,8480893,Kirill Marchenko,R,CBJ,24,82,22,9,31
2,8480821,Filip Zadina,R,SJS,25,82,18,13,31
2,8476469,Joel Armia,R,MTL,31,82,18,13,31
2,8481013,Jonatan Berggren,R,DET,24,82,17,14,31
2,8481522,Peyton Krebs,C,BUF,23,82,14,17,31
2,8477919,Frederick Gaudreau,C,MIN,31,82,13,18,31
2,8476461,Sean Couturier,C,PHI,32,82,12,19,31
2,8476278,Colin Blackwell,C,CHI,31,82,12,19,31
2,8478115,Pierre Engvall,L,NYI,28,82,11,20,31
2,8476960,Andreas Athanasiou,C,CHI,30,82,11,20,31
2,8481703,Valtteri Puustinen,R,PIT,25,82,8,23,31
2,8482122,Brock Faber,D,MIN,22,82,4,27,31
2,8477953,Kasperi Kapanen,R,STL,28,82,16,14,30
2,8477330,Dominik Kubalik,L,OTT,29,82,16,14,30
2,8480336,Sean Walker,D,COL,30,82,15,15,30
2,8477931,Tomas Nosek,L,NJD,32,82,15,15,30
2,8484145,Zach Benson,L,BUF,19,82,15,15,30
2,8477406,Mattias Janmark,C,EDM,32,82,14,16,30
2,8474884,Mike Hoffman,C,SJS,35,82,13,17,30
2,8476873,Mark Jankowski,C,NSH,30,82,13,17,30
2,8478463,Anthony Beauvillier,L,NSH,27,82,12,18,30
2,8474189,Lars Eller,C,PIT,35,82,12,18,30
2,8482803,Olen Zellweger,D,ANA,21,82,10,20,30
2,8481704,Juuso Parssinen,C,NSH,23,82,9,21,30
2,8479351,Sam Steel,C,DAL,26,82,7,23,30
2,8482087,Kaiden Guhle,D,MTL,22,82,4,26,30
2,8478500,Ivan Provorov,D,CBJ,27,82,2,28,30
2,8479316,Luke Kunin,C,SJS,27,82,20,9,29
2,8479591,Michael Eyssimont,C,TBL,28,82,15,14,29
2,8479415,Michael McLeod,C,NJD,26,82,13,16,29
2,8480074,Alexandre Texier,C,CBJ,25,82,13,16,29
2,8477435,Ryan Graves,D,PIT,29,82,6,23,29
2,8475324,Nick Jensen,D,WSH,34,82,5,24,29
2,8475179,Dmitry Kulikov,D,FLA,34,82,5,24,29
2,8476892,Colton Parayko,D,STL,31,82,4,25,29
2,8478840,Will Borgen,D,SEA,28,82,4,25,29
2,8477450,Jason Dickinson,C,CHI,29,82,16,12,28
2,8476422,Mike Reilly,D,NYI,31,82,10,18,28
2,8480448,Parker Kelly,L,OTT,25,82,8,20,28
2,8475181,Nick Leddy,D,STL,33,82,7,21,28
2,8483490,Pavel Mintyukov,D,ANA,21,82,6,22,28
2,8479324,Ryan Lindgren,D,NYR,26,82,6,22,28
2,8476463,Jonas Brodin,D,MIN,31,82,5,23,28
2,8482655,J.J. Moser,D,ARI,24,82,5,23,28
2,8476931,Jake McCabe,D,TOR,31,82,4,24,28
2,8477488,Brett Pesce,D,CAR,30,82,3,25,28
2,8479514,Rem Pitlick,C,CHI,27,82,17,10,27
2,8474715,Cam Atkinson,R,PHI,35,82,14,13,27
2,8470621,Corey Perry,R,EDM,39,82,13,14,27
2,8478043,Sam Lafferty,C,VAN,29,82,13,14,27
2,8483457,Lane Hutson,D,MTL,20,82,13,14,27
2,8481028,Martin Pospisil,C,CGY,25,82,12,15,27
2,8479390,Taylor Raddysh,R,CHI,26,82,11,16,27
2,8477499,Rasmus Ristolainen,D,PHI,30,82,8,19,27
2,8478882,Vladislav Gavrikov,D,LAK,29,82,7,20,27
2,8476457,Adam Larsson,D,SEA,32,82,5,22,27
2,8480873,Rasmus Sandin,D,WSH,24,82,4,23,27
2,8477392,Hudson Fasching,R,NYI,29,82,13,13,26
2,8476374,Sean Kuraly,C,CBJ,31,82,12,14,26
2,8480144,David Kampf,C,TOR,29,82,10,16,26
2,8477425,Miles Wood,L,COL,29,82,9,17,26
2,8482807,Ethan Del Mastro,D,CHI,21,82,9,17,26
2,8484149,Gavin Brindley,C,CBJ,20,82,9,17,26
2,8479998,Mikey Anderson,D,LAK,25,82,5,21,26
2,8478851,Alexandre Carrier,D,NSH,28,82,5,21,26
2,8476879,Cody Ceci,D,EDM,31,82,4,22,26
2,8479398,Samuel Girard,D,COL,26,82,3,23,26
2,8482074,Connor Zary,C,CGY,23,82,16,9,25
2,8476878,Zemgus Girgensons,L,BUF,30,82,15,10,25
2,8481093,Rafael Harvey-Pinard,L,MTL,25,82,13,12,25
2,8473453,Trevor Lewis,C,LAK,37,82,13,12,25
2,8480855,Jack McBain,C,ARI,24,82,10,15,25
2,8475164,Jakob Silfverberg,R,ANA,34,82,9,16,25
2,8481553,Bobby Brink,R,PHI,23,82,8,17,25
2,8483763,Maksymilian Szuber,D,ARI,22,82,8,17,25
2,8483499,Liam Ohgren,L,MIN,20,82,8,17,25
2,8481524,Bowen Byram,D,BUF,23,82,8,17,25
2,8476902,Esa Lindell,D,DAL,30,82,6,19,25
2,8479369,Andrew Peeke,D,BOS,26,82,6,19,25
2,8479983,Mario Ferraro,D,SJS,26,82,3,22,25
2,8476891,Matt Grzelcyk,D,BOS,30,82,3,22,25
2,8478416,Erik Cernak,D,TBL,27,82,2,23,25
2,8482079,Marco Rossi,C,MIN,23,82,14,10,24
2,8481517,Brett Leason,R,ANA,25,82,14,10,24
2,8478508,Yakov Trenin,C,COL,27,82,13,11,24
2,8477505,Alexander Wennberg,C,NYR,30,82,10,14,24
2,8483491,Ivan Miroshnichenko,L,WSH,20,82,7,17,24
2,8481059,Scott Perunovich,D,STL,26,82,6,18,24
2,8475762,Derek Forbort,D,BOS,32,82,6,18,24
2,8475690,Chris Tanev,D,DAL,35,82,4,20,24
2,8475188,Brayden McNabb,D,VGK,33,82,3,21,24
2,8481014,Alexander Romanov,D,NYI,24,82,1,23,24
2,8479423,Alex Nylander,L,CBJ,26,82,13,10,23
2,8483524,Shane Wright,C,SEA,20,82,13,10,23
2,8482624,Daniil Miromanov,D,CGY,27,82,11,12,23
2,8475231,Casey Cizikas,C,NYI,33,82,11,12,23
2,8479353,Brett Howden,C,VGK,26,82,10,13,23
2,8484166,Adam Fantilli,C,CBJ,20,82,10,13,23
2,8481477,Nico Sturm,C,SJS,29,82,9,14,23
2,8475220,Marcus Foligno,L,MIN,33,82,8,15,23
2,8483482,Tristan Luneau,D,ANA,20,82,7,16,23
2,8480172,Jan Rutta,D,SJS,34,82,5,18,23
2,8474151,Ryan McDonagh,D,NSH,35,82,3,20,23
2,8474013,Ian Cole,D,VAN,35,82,3,20,23
2,8476858,Phillip Di Giuseppe,L,VAN,31,82,15,7,22
2,8482702,Logan Stankoven,C,DAL,21,82,13,9,22
2,8474034,Pat Maroon,L,BOS,36,82,11,11,22
2,8482062,Cole Smith,L,NSH,29,82,11,11,22
2,8478831,Kevin Stenlund,C,FLA,28,82,11,11,22
2,8479980,Nicolas Hague,D,VGK,26,82,8,14,22
2,8483468,Jiri Kulich,C,BUF,20,82,7,15,22
2,8477507,Nikita Zadorov,D,VAN,29,82,7,15,22
2,8478136,Jake Middleton,D,MIN,28,82,6,16,22
2,8482073,Braden Schneider,D,NYR,23,82,5,17,22
2,8481568,Alex Vlasic,D,CHI,23,82,5,17,22
2,8480058,Pierre-Olivier Joseph,D,PIT,25,82,5,17,22
2,8476467,Jamie Oleksiak,D,SEA,32,82,3,19,22
2,8477220,Nate Schmidt,D,WPG,33,82,3,19,22
2,8477969,Marcus Pettersson,D,PIT,28,82,2,20,22
2,8477506,Ryan Pulock,D,NYI,30,82,2,20,22
2,8482155,Alex Laferriere,R,LAK,23,82,15,6,21
2,8478109,Victor Olofsson,L,BUF,29,82,11,10,21
2,8484153,Leo Carlsson,C,ANA,20,82,10,11,21
2,8470604,Jeff Carter,C,PIT,39,82,9,12,21
2,8479359,Beck Malenstyn,L,WSH,26,82,9,12,21
2,8476442,Matt Nieto,L,PIT,32,82,9,12,21
2,8475842,Sam Carrick,C,EDM,32,82,8,13,21
2,8482809,Jackson Blake,R,CAR,21,82,6,15,21
2,8475279,Ben Chiarot,D,DET,33,82,5,16,21
2,8480807,Mattias Samuelsson,D,BUF,24,82,2,19,21
2,8474166,Alec Martinez,D,VGK,37,82,0,21,21
2,8480281,Alexey Toropchenko,R,STL,25,82,10,10,20
2,8478451,Ethan Bear,D,WSH,27,82,10,10,20
2,8482762,Simon Edvinsson,D,DET,21,82,9,11,20
2,8481601,Simon Holmstrom,R,NYI,23,82,8,12,20
2,8476312,Josh Manson,D,COL,33,82,7,13,20
2,8478178,Darren Raddysh,D,TBL,28,82,6,14,20
2,8479442,Troy Stecher,D,EDM,30,82,6,14,20
2,8477015,Connor Brown,R,EDM,30,82,5,15,20
2,8476331,Dylan DeMelo,D,WPG,31,82,4,16,20
2,8483565,Nick Blankenburg,D,CBJ,26,82,4,16,20
2,8478399,Jonas Siegenthaler,D,NJD,27,82,4,16,20
2,8480879,Jacob Bernard-Docker,D,OTT,24,82,4,16,20
2,8482679,Matt Coronato,R,CGY,22,82,8,11,19
2,8477353,Tyler Motte,C,TBL,29,82,7,12,19
2,8475825,Jani Hakanpää,D,DAL,32,82,4,15,19
2,8476429,Scott Mayfield,D,NYI,32,82,3,16,19
2,8478468,Jeremy Lauzon,D,NSH,27,82,3,16,19
2,8478430,Oliver Kylington,D,CGY,27,82,2,17,19
2,8475233,David Savard,D,MTL,34,82,1,18,19
2,8481699,Aku Raty,R,ARI,23,82,7,11,18
2,8480073,Erik Brannstrom,D,OTT,25,82,6,12,18
2,8482730,Brandt Clarke,D,LAK,21,82,6,12,18
2,8483495,Simon Nemec,D,NJD,20,82,5,13,18
2,8477845,Trevor van Riemsdyk,D,WSH,33,82,4,14,18
2,8470600,Ryan Suter,D,DAL,39,82,4,14,18
2,8470966,Mark Giordano,D,TOR,41,82,4,14,18
2,8475208,Brian Dumoulin,D,SEA,33,82,3,15,18
2,8478443,Brandon Carlo,D,BOS,28,82,3,15,18
2,8479976,Juuso Valimaki,D,ARI,26,82,2,16,18
2,8475790,Erik Gudbranson,D,CBJ,32,82,2,16,18
2,8477365,Connor Clifton,D,BUF,29,82,2,16,18
2,8473507,Jeff Petry,D,DET,37,82,1,17,18
2,8481578,Graeme Clarke,R,NJD,23,82,10,7,17
2,8482666,Scott Morrow,D,CAR,22,82,8,9,17
2,8483493,Frank Nazar,C,CHI,20,82,7,10,17
2,8483445,Cutter Gauthier,L,ANA,20,82,7,10,17
2,8471677,Jack Johnson,D,COL,37,82,5,12,17
2,8482166,Shakir Mukhamadullin,D,SJS,22,82,4,13,17
2,8476525,Colin Miller,D,WPG,32,82,4,13,17
2,8477369,Carson Soucy,D,VAN,30,82,3,14,17
2,8480860,Kevin Bahl,D,NJD,24,82,3,14,17
2,8481178,Egor Zamula,D,PHI,24,82,2,15,17
2,8482470,Ilya Solovyov,D,CGY,24,82,1,16,17
2,8480995,Pontus Holmberg,R,TOR,25,82,8,8,16
2,8476624,Barclay Goodrow,C,NYR,31,82,8,8,16
2,8474009,Nick Bonino,C,NYR,36,82,7,9,16
2,8475177,Calvin de Haan,D,TBL,33,82,6,10,16
2,8481016,Ruslan Iskhakov,C,NYI,24,82,6,10,16
2,8484911,Collin Graf,R,SJS,22,82,5,11,16
2,8482101,Danil Gushchin,L,SJS,22,82,5,11,16
2,8482858,Ryker Evans,D,SEA,23,82,4,12,16
2,8482859,Zack Ostapchuk,C,OTT,21,82,4,12,16
2,8482737,Zack Bolduc,C,STL,21,82,9,6,15
2,8479383,Boris Katchouk,L,OTT,26,82,6,9,15
2,8482733,Logan Mailloux,D,MTL,31,82,4,11,15
2,8481537,Nikita Okhotiuk,D,CGY,24,82,3,12,15
2,8475462,Radko Gudas,D,ANA,34,82,1,14,15
2,8479291,Kevin Rooney,C,CGY,31,82,12,2,14
2,8483012,Logan Morrison,C,SEA,22,82,6,8,14
2,8482177,Marat Khusnutdinov,C,MIN,22,82,5,9,14
2,8480246,Nick Perbix,D,TBL,26,82,4,10,14
2,8476473,Connor Murphy,D,CHI,31,82,3,11,14
2,8480796,Martin Fehervary,D,WSH,25,82,1,13,14
2,8476822,Luke Glendening,C,TBL,35,82,8,5,13
2,8473504,Cal Clutterbuck,R,NYI,37,82,6,7,13
2,8482712,Oskar Olausson,R,COL,22,82,6,7,13
2,8483471,Brad Lambert,C,WPG,31,82,5,8,13
2,8480834,Ty Emberson,D,SJS,24,82,3,10,13
2,8475455,Brenden Dillon,D,WPG,34,82,2,11,13
2,8477034,Jaycob Megna,D,CHI,32,82,1,12,13
2,8481567,Henry Thrun,D,SJS,23,82,7,5,12
2,8482145,Mavrik Bourque,C,DAL,22,82,6,6,12
2,8477335,Kyle Burroughs,D,SJS,29,82,5,7,12
2,8480990,Declan Chisholm,D,MIN,24,82,4,8,12
2,8476967,Brett Kulak,D,EDM,30,82,3,9,12
2,8482713,Mackie Samoskevich,R,FLA,22,82,3,9,12
2,8476372,Nick Seeler,D,PHI,31,82,4,7,11
2,8478859,Niko Mikkola,D,FLA,28,82,3,8,11
2,8483505,Matthew Poitras,C,BOS,20,82,3,8,11
2,8482118,Sam Colangelo,R,ANA,23,82,2,9,11
2,8474567,Zach Bogosian,D,MIN,34,82,1,10,11
2,8481605,Jackson LaCombe,D,ANA,23,82,1,10,11
2,8483466,Kevin Korchinski,D,CHI,20,82,2,8,10
2,8483397,Marc McLaughlin,C,BOS,25,82,6,3,9
2,8480031,Maxime Comtois,L,CAR,25,82,4,5,9
2,8481030,Jack St. Ivany,D,PIT,25,82,4,5,9
2,8482516,Matthew Kessel,D,STL,24,82,1,8,9
2,8476915,Jujhar Khaira,L,MIN,30,82,5,3,8
2,8481599,Victor Soderstrom,D,ARI,23,82,2,6,8
2,8478408,Travis Dermott,D,ARI,28,82,1,6,7
2,8483489,Fraser Minten,C,TOR,31,82,3,3,6
2,8477950,Tony DeAngelo,D,CAR,29,0,0,0,0
2,8481577,Philip Tomasino,C,NSH,23,0,0,0,0
2,8482660,Kent Johnson,C,CBJ,22,0,0,0,0
2,8481019,David Gustafsson,C,WPG,24,0,0,0,0
2,8479348,Kale Clague,D,BUF,26,0,0,0,0
2,8482149,Cole Perfetti,C,WPG,22,0,0,0,0
2,8476952,Dominic Toninato,C,WPG,30,0,0,0,0
2,8473473,Milan Lucic,L,BOS,36,0,0,0,0
2,8480829,Jesperi Kotkaniemi,C,CAR,24,0,0,0,0
2,8474602,Justin Schultz,D,SEA,34,0,0,0,0
2,8480049,Dylan Samberg,D,WPG,25,0,0,0,0
2,8479372,Josh Mahura,D,FLA,26,0,0,0,0
2,8480878,Nils Lundkvist,D,DAL,24,0,0,0,0
2,8479982,Conor Timmins,D,TOR,26,0,0,0,0
2,8474031,Kevin Shattenkirk,D,BOS,35,0,0,0,0
2,8480835,Jack Drury,C,CAR,24,0,0,0,0
2,8480008,Adam Ruzicka,C,ARI,25,0,0,0,0
2,8479402,Jake Bean,D,CBJ,26,0,0,0,0
2,8476474,Stefan Noesen,R,CAR,31,0,0,0,0
2,8480884,Calen Addison,D,SJS,24,0,0,0,0
2,8476994,Vinnie Hinostroza,C,PIT,30,0,0,0,0
2,8477987,Ryan Donato,C,CHI,28,0,0,0,0
2,8481582,Nicholas Robertson,L,TOR,23,0,0,0,0
2,8478452,Caleb Jones,D,COL,27,0,0,0,0
2,8480157,Calle Rosen,D,STL,30,0,0,0,0
2,8481609,Vladislav Kolyachonok,D,ARI,23,0,0,0,0
2,8476919,Chris Tierney,C,NJD,30,0,0,0,0
2,8479639,Dylan Coghlan,D,CAR,26,0,0,0,0
2,8475193,Tomas Tatar,L,SEA,34,0,0,0,0
2,8480748,Kiefer Sherwood,L,NSH,29,0,0,0,0
2,8478146,Matthew Highmore,C,OTT,28,0,0,0,0
2,8478970,Jalen Chatfield,D,CAR,28,0,0,0,0
2,8480205,Emil Bemstrom,C,PIT,25,0,0,0,0
2,8471274,Alex Goligoski,D,MIN,39,0,0,0,0
2,8478104,Sammy Blais,L,STL,28,0,0,0,0
2,8476913,Devin Shore,C,SEA,30,0,0,0,0
2,8481708,Zac Jones,D,NYR,24,0,0,0,0
2,8480222,Sebastian Aho,D,NYI,28,0,0,0,0
2,8481598,Philip Broberg,D,EDM,23,0,0,0,0
2,8480789,Oliver Wahlstrom,R,NYI,24,0,0,0,0
2,8480891,Michael Kesselring,D,ARI,24,0,0,0,0
2,8477979,Nicolas Aube-Kubel,R,WSH,28,0,0,0,0
2,8476393,Nick Cousins,C,FLA,31,0,0,0,0
2,8480003,Jesper Boqvist,C,BOS,26,0,0,0,0
2,8479543,Michael Pezzetta,L,MTL,26,0,0,0,0
2,8475855,Jesper Fast,R,CAR,33,0,0,0,0
2,8477018,Ben Hutton,D,VGK,31,0,0,0,0
2,8480762,Eric Robinson,L,BUF,29,0,0,0,0
2,8481058,Jesse Ylönen,R,MTL,25,0,0,0,0
2,8481527,Kaedan Korczak,D,VGK,23,0,0,0,0
2,8482192,Isaak Phillips,D,CHI,23,0,0,0,0
2,8480727,Zach Whitecloud,D,VGK,28,0,0,0,0
2,8480001,Urho Vaakanainen,D,ANA,25,0,0,0,0
2,8480853,Liam Foudy,C,NSH,24,0,0,0,0
2,8475225,Craig Smith,C,DAL,35,0,0,0,0
2,8479972,Mason Shaw,C,MIN,26,0,0,0,0
2,8474040,Sam Gagner,C,EDM,35,0,0,0,0
2,8480196,Jacob Bryson,D,BUF,27,0,0,0,0
2,8475718,Justin Holl,D,DET,32,0,0,0,0
2,8479984,Cal Foote,D,NJD,26,0,0,0,0
2,8480011,Klim Kostin,C,SJS,25,0,0,0,0
2,8482176,Wyatt Kaiser,D,CHI,22,0,0,0,0
2,8476918,Jimmy Vesey,L,NYR,31,0,0,0,0
2,8476988,Matt Benning,D,SJS,30,0,0,0,0
2,8479370,Tyson Jost,C,BUF,26,0,0,0,0
2,8477464,Nic Petan,C,MIN,29,0,0,0,0
2,8477380,Jonny Brodzinski,C,NYR,31,0,0,0,0
2,8480070,Ian Mitchell,D,BOS,25,0,0,0,0
2,8479315,Joey Anderson,R,CHI,26,0,0,0,0
2,8478099,Kevin Labanc,R,SJS,29,0,0,0,0
2,8476874,Olli Maatta,D,DET,30,0,0,0,0
2,8479414,Nathan Bastian,R,NJD,27,0,0,0,0
2,8478434,Keegan Kolesar,R,VGK,27,0,0,0,0
2,8479536,Axel Jonsson-Fjallby,L,WPG,26,0,0,0,0
2,8479671,Mathieu Olivier,R,CBJ,27,0,0,0,0
2,8471709,Marc-Edouard Vlasic,D,SJS,37,0,0,0,0
2,8479328,Julien Gauthier,R,NYI,27,0,0,0,0
2,8478421,A.J. Greer,L,CGY,28,0,0,0,0
2,8477573,Nathan Walker,L,STL,30,0,0,0,0
2,8477478,William Carrier,L,VGK,30,0,0,0,0
2,8479344,Jesse Puljujarvi,R,PIT,26,0,0,0,0
2,8480887,Jordan Harris,D,MTL,24,0,0,0,0
2,8478502,Dennis Gilbert,D,CGY,28,0,0,0,0
2,8480355,Mark Kastelic,C,OTT,25,0,0,0,0
2,8475750,Jon Merrill,D,MIN,32,0,0,0,0
2,8476889,Radek Faksa,C,DAL,30,0,0,0,0
2,8478432,Christian Fischer,R,DET,27,0,0,0,0
2,8479439,Jacob MacDonald,D,SJS,31,0,0,0,0
2,8474568,Luke Schenn,D,NSH,35,0,0,0,0
2,8478454,Noah Juulsen,D,VAN,27,0,0,0,0
2,8475752,Tyler Pitlick,C,NYR,33,0,0,0,0
2,8482148,Hendrix Lapierre,C,WSH,22,0,0,0,0
2,8481167,Brayden Pachal,D,CGY,25,0,0,0,0
2,8478211,Dryden Hunt,L,CGY,29,0,0,0,0
2,8479321,Lucas Johansen,D,WSH,27,0,0,0,0
2,8480950,Ilya Lyubushkin,D,TOR,30,0,0,0,0
2,8479368,Max Jones,L,ANA,26,0,0,0,0
2,8471699,Andrew Cogliano,C,COL,37,0,0,0,0
2,8481521,Ronnie Attard,D,PHI,25,0,0,0,0
2,8481161,Jake Christiansen,D,CBJ,25,0,0,0,0
2,8479458,Nikita Zaitsev,D,CHI,33,0,0,0,0
2,8479619,Michael Carcone,L,ARI,28,0,0,0,0
2,8479026,Philippe Myers,D,TBL,27,0,0,0,0
2,8481617,Vasily Podkolzin,R,VAN,23,0,0,0,0
2,8481701,Santeri Hatakka,D,NJD,23,0,0,0,0
2,8477446,Michael McCarron,R,NSH,29,0,0,0,0
2,8483460,David Jiricek,D,CBJ,21,0,0,0,0
2,8474090,Brendan Smith,D,NJD,35,0,0,0,0
2,8482241,Radim Zohorna,L,PIT,28,0,0,0,0
2,8481032,Paul Cotter,C,VGK,25,0,0,0,0
2,8480289,Morgan Barron,C,WPG,26,0,0,0,0
2,8479379,Givani Smith,R,SJS,26,0,0,0,0
2,8480216,Jacob Peterson,C,SJS,25,0,0,0,0
2,8477851,Jordan Oesterle,D,CGY,32,0,0,0,0
2,8484258,Sam Malinski,D,COL,26,0,0,0,0
2,8478904,Steven Lorentz,C,FLA,28,0,0,0,0
2,8482095,Tyler Kleven,D,OTT,22,0,0,0,0
2,8480980,Connor Dewar,C,TOR,25,0,0,0,0
2,8480848,Ty Dellandrea,C,DAL,24,0,0,0,0
2,8476884,Derrick Pouliot,D,DAL,30,0,0,0,0
2,8480025,MacKenzie Entwistle,R,CHI,25,0,0,0,0
2,8474612,Travis Hamonic,D,OTT,34,0,0,0,0
2,8479336,Carl Grundstrom,R,LAK,27,0,0,0,0
2,8482964,Arber Xhekaj,D,MTL,23,0,0,0,0
2,8471686,Marc Staal,D,PHI,37,0,0,0,0
2,8477887,Patrick Brown,C,BOS,32,0,0,0,0
2,8478495,Denis Gurianov,R,PHI,27,0,0,0,0
2,8481550,Adam Beckman,L,MIN,23,0,0,0,0
2,8480845,Rasmus Kupari,C,WPG,24,0,0,0,0
2,8478585,Derek Ryan,C,EDM,38,0,0,0,0
2,8482141,Lukas Cormier,D,VGK,22,0,0,0,0
2,8477962,Brendan Lemieux,L,CAR,28,0,0,0,0
2,8482861,Vincent Iorio,D,WSH,22,0,0,0,0
2,8479378,Logan Stanley,D,WPG,26,0,0,0,0
2,8473446,Erik Johnson,D,PHI,36,0,0,0,0
2,8481743,Marc Del Gaizo,D,NSH,25,0,0,0,0
2,8478450,Parker Wotherspoon,D,BOS,27,0,0,0,0
2,8477384,Josh Brown,D,ARI,30,0,0,0,0
2,8482165,Yan Kuznetsov,D,CGY,22,0,0,0,0
2,8478424,Jansen Harkins,C,PIT,27,0,0,0,0
2,8482144,Jack Thompson,D,SJS,22,0,0,0,0
2,8479576,Vincent Desharnais,D,EDM,28,0,0,0,0
2,8478512,Austin Czarnik,C,DET,32,0,0,0,0
2,8477527,Ross Johnston,L,ANA,30,0,0,0,0
2,8482094,Daemon Hunt,D,MIN,22,0,0,0,0
2,8481719,Maxwell Crozier,D,TBL,24,0,0,0,0
2,8480192,Johnathan Kovacevic,D,MTL,27,0,0,0,0
2,8479376,Victor Mete,D,PHI,26,0,0,0,0
2,8482511,Mason Lohrei,D,BOS,23,0,0,0,0
2,8478021,William Lagesson,D,ANA,28,0,0,0,0
2,8475795,Dylan McIlrath,D,WSH,32,0,0,0,0
2,8477846,Ryan Carpenter,C,SJS,33,0,0,0,0
2,8481056,Spencer Stastney,D,NSH,24,0,0,0,0
2,8481564,Ryan Johnson,D,BUF,23,0,0,0,0
2,8478017,Mark Friedman,D,VAN,29,0,0,0,0
2,8479320,Max Lajoie,D,TOR,27,0,0,0,0
2,8480075,Cameron Crotty,D,ARI,25,0,0,0,0
2,8484287,Cole McWard,D,VAN,23,0,0,0,0
2,8484254,Akito Hirose,D,VAN,25,0,0,0,0
2,8483407,Brandon Scanlin,D,NYR,25,0,0,0,0
2,8480274,Philip Kemp,D,EDM,25,0,0,0,0
2,8479522,Hardy Haman Aktell,D,WSH,26,0,0,0,0
2,8480007,Jonas Rondbjerg,R,VGK,25,0,0,0,0
2,8477454,Adam Erne,L,EDM,29,0,0,0,0
2,8481679,Maxence Guenette,D,OTT,23,0,0,0,0
2,8477938,Haydn Fleury,D,TBL,28,0,0,0,0
2,8476441,Joel Edmundson,D,TOR,31,0,0,0,0
2,8477903,Garnet Hathaway,R,PHI,33,0,0,0,0
2,8480441,Trey Fix-Wolansky,R,CBJ,25,0,0,0,0
2,8483546,Marshall Rifai,D,TOR,26,0,0,0,0
2,8480084,Nick DeSimone,D,NJD,30,0,0,0,0
2,8481592,Jakob Pelletier,L,CGY,23,0,0,0,0
2,8478011,Louie Belpedio,D,PHI,28,0,0,0,0
2,8477930,Pierre-Edouard Bellemare,L,SEA,39,0,0,0,0
2,8484321,Nikolas Matinpalo,D,OTT,26,0,0,0,0
2,8482067,Connor Mackey,D,NYR,28,0,0,0,0
2,8481806,Louis Crevier,D,CHI,23,0,0,0,0
2,8484326,Patrik Koch,D,ARI,28,0,0,0,0
2,8477971,Andreas Englund,D,LAK,28,0,0,0,0
2,8481751,Lukas Rousek,R,BUF,25,0,0,0,0
2,8481006,Tyler Tucker,D,STL,24,0,0,0,0
2,8481641,Joel Kiviranta,L,COL,28,0,0,0,0
2,8476867,Brendan Gaunce,C,CBJ,30,0,0,0,0
2,8479520,Brandon Duhaime,R,COL,27,0,0,0,0
2,8477073,Kurtis MacDermid,L,NJD,30,0,0,0,0
2,8480874,Adam Ginning,D,PHI,24,0,0,0,0
2,8477473,Justin Bailey,R,SJS,29,0,0,0,0
2,8479066,Ryan Lomberg,L,FLA,30,0,0,0,0
2,8477070,Liam O'Brien,C,ARI,30,0,0,0,0
2,8474618,Marco Scandella,D,STL,34,0,0,0,0
2,8475797,Jarred Tinordi,D,CHI,32,0,0,0,0
2,8481441,Joe Snively,C,WSH,28,0,0,0,0
2,8477244,Chad Ruhwedel,D,NYR,34,0,0,0,0
2,8482077,Dylan Holloway,L,EDM,23,0,0,0,0
2,8479772,Zack MacEwen,R,OTT,28,0,0,0,0
2,8481147,Reese Johnson,C,CHI,26,0,0,0,0
2,8481043,Cole Koepke,L,TBL,26,0,0,0,0
2,8483619,Filip Roos,D,CHI,25,0,0,0,0
2,8481541,Samuel Bolduc,D,NYI,24,0,0,0,0
2,8477810,Joel Hanley,D,CGY,33,0,0,0,0
2,8476907,Mackenzie MacEachern,L,STL,30,0,0,0,0
2,8482652,Walker Duehr,R,CGY,27,0,0,0,0
2,8477126,Jayson Megna,C,BOS,34,0,0,0,0
2,8483398,Declan Carlile,D,TBL,31,0,0,0,0
2,8482929,Emil Lilleberg,D,TBL,23,0,0,0,0
2,8480880,Jakub Lauko,C,BOS,24,0,0,0,0
2,8478874,Adam Gaudette,C,STL,28,0,0,0,0
2,8480245,Olle Lycksell,R,PHI,25,0,0,0,0
2,8480252,Cole Guttman,C,CHI,25,0,0,0,0
2,8477467,Gustav Olofsson,D,SEA,30,0,0,0,0
2,8479968,Vinni Lettieri,C,MIN,29,0,0,0,0
2,8478400,Colin White,C,MTL,27,0,0,0,0
2,8475755,Alexander Petrovic,D,DAL,32,0,0,0,0
2,8481812,Nikolai Knyzhov,D,SJS,27,0,0,0,0
2,8481593,Jayden Struble,D,MTL,23,0,0,0,0
2,8481532,Alex Turcotte,C,LAK,23,0,0,0,0
2,8482126,Emil Andrae,D,PHI,31,0,0,0,0
2,8479944,Zach Aston-Reese,C,DET,30,0,0,0,0
2,8471817,Ryan Reaves,R,TOR,37,0,0,0,0
2,8481206,John Ludvig,D,PIT,24,0,0,0,0
2,8480292,Carson Meyer,R,CBJ,27,0,0,0,0
2,8482496,Nils Aman,C,VAN,24,0,0,0,0
2,8479718,Alex Barré-Boulet,C,TBL,27,0,0,0,0
2,8479994,Jaret Anderson-Dolan,C,NSH,25,0,0,0,0
2,8480184,Gustav Lindstrom,D,ANA,26,0,0,0,0
2,8480890,Jan Jenik,R,ARI,24,0,0,0,0
2,8478067,Oskar Lindblom,L,SJS,28,0,0,0,0
2,8476934,Brock McGinn,L,ANA,30,0,0,0,0
2,8479985,Cale Fleury,D,SEA,26,0,0,0,0
2,8482153,Brendan Brisson,C,VGK,23,0,0,0,0
2,8480021,Jack Studnicka,C,SJS,25,0,0,0,0
2,8484304,Uvis Balinskis,D,FLA,28,0,0,0,0
2,8479981,Jonah Gadjovich,L,FLA,26,0,0,0,0
2,8481716,Dmitri Voronkov,L,CBJ,24,0,0,0,0
2,8482659,Josh Doan,R,ARI,22,0,0,0,0
2,8481122,Simon Benoit,D,TOR,26,0,0,0,0
2,8474709,Matt Martin,L,NYI,35,0,0,0,0
2,8482634,Alex Steeves,C,TOR,25,0,0,0,0
2,8480823,Alexander Alexeyev,D,WSH,25,0,0,0,0
2,8477541,Dakota Mermis,D,MIN,30,0,0,0,0
2,8478477,Mitchell Stephens,C,MTL,27,0,0,0,0
2,8481543,Nikita Alexandrov,C,STL,24,0,0,0,0
2,8482451,Mikael Pyyhtia,L,CBJ,23,0,0,0,0
2,8480306,Grant Hutton,D,NYI,29,0,0,0,0
2,8478028,Fredrik Olofsson,L,COL,28,0,0,0,0
2,8477462,Robert Hagg,D,ANA,29,0,0,0,0
2,8477320,Anton Blidh,L,NYR,29,0,0,0,0
2,8482749,Joshua Roy,R,MTL,21,0,0,0,0
2,8482157,Will Cuylle,L,NYR,22,0,0,0,0
2,8481239,Samuel Fagemo,L,LAK,24,0,0,0,0
2,8481600,Tobias Bjornfot,D,FLA,23,0,0,0,0
2,8478409,Anthony Richard,C,BOS,28,0,0,0,0
2,8474145,Robert Bortuzzo,D,NYI,35,0,0,0,0
2,8475958,Michael Sgarbossa,C,WSH,32,0,0,0,0
2,8479986,Kole Lind,R,SEA,26,0,0,0,0
2,8479249,Andrew Poturalski,C,SEA,30,0,0,0,0
2,8479362,Riley Tufte,L,COL,26,0,0,0,0
2,8479991,Jake Leschyshyn,C,NYR,25,0,0,0,0
2,8479587,Rhett Gardner,C,PHI,28,0,0,0,0
2,8482744,James Malatesta,L,CBJ,21,0,0,0,0
2,8478854,Ryan Shea,D,PIT,27,0,0,0,0
2,8481591,Sam Poulin,R,PIT,23,0,0,0,0
2,8483512,Matt Savoie,C,BUF,20,0,0,0,0
2,8482102,Vasily Ponomarev,C,CAR,22,0,0,0,0
2,8482162,Roby Jarventie,L,OTT,22,0,0,0,0
2,8482172,Landon Slaggert,L,CHI,22,0,0,0,0
2,8482747,Brennan Othmann,L,NYR,21,0,0,0,0
2,8480226,Marián Studenic,R,SEA,26,0,0,0,0
2,8481518,Nolan Foote,L,NJD,24,0,0,0,0
2,8479419,Brett Murray,L,BUF,26,0,0,0,0
2,8482088,Justin Sourdif,R,FLA,22,0,0,0,0
2,8482201,Gage Goncalves,C,TBL,23,0,0,0,0
2,8481754,Nikita Nesterenko,C,ANA,23,0,0,0,0
2,8483531,Brian Halonen,L,NJD,25,0,0,0,0
2,8483920,Pierrick Dube,R,WSH,23,0,0,0,0
2,8480851,Akil Thomas,C,LAK,24,0,0,0,0
2,8475235,Nicolas Deslauriers,L,PHI,33,0,0,0,0
2,8482476,Emil Heineman,L,MTL,23,0,0,0,0
2,8477149,Scott Sabourin,R,SJS,32,0,0,0,0
2,8483549,Lucas Condotta,L,MTL,27,0,0,0,0
2,8483567,Georgii Merkulov,C,BOS,24,0,0,0,0
2,8482765,Isak Rosen,R,BUF,21,0,0,0,0
2,8481237,Kyle MacLean,C,NYI,25,0,0,0,0
2,8481024,Linus Karlsson,C,VAN,25,0,0,0,0
2,8481690,Tyler Angle,C,CBJ,24,0,0,0,0
2,8483570,Ben Meyers,C,ANA,26,0,0,0,0
2,8481655,Cole Schwindt,R,CGY,23,0,0,0,0
2,8481462,Mason Morelli,L,VGK,28,0,0,0,0
2,8483401,Marc Johnstone,R,PIT,28,0,0,0,0
2,8478956,Samuel Laberge,L,NJD,27,0,0,0,0
2,8479533,Joona Koppanen,L,PIT,26,0,0,0,0
2,8482197,Adam Raska,R,MIN,23,0,0,0,0
2,8482250,Callahan Burke,C,CAR,27,0,0,0,0
2,8482784,Zach Dean,C,STL,21,0,0,0,0
2,8484255,Jason Polin,R,COL,25,0,0,0,0
2,8481077,John Leonard,L,ARI,26,0,0,0,0
2,8481534,Raphael Lavoie,C,EDM,24,0,0,0,0
2,8483609,Adam Klapka,R,CGY,24,0,0,0,0
2,8482751,Ryan Winterton,C,SEA,21,0,0,0,0
2,8480267,Sammy Walker,C,MIN,25,0,0,0,0
2,8475766,Austin Watson,L,TBL,32,0,0,0,0
2,8482460,Matt Rempe,C,NYR,22,0,0,0,0
2,8482787,Nikita Chibrikov,R,WPG,31,0,0,0,0
2,8481065,Angus Crookshank,L,OTT,25,0,0,0,0
2,8481070,Hugh McGing,L,STL,26,0,0,0,0
2,8476323,Max McCormick,L,SEA,32,0,0,0,0
2,8483395,Arshdeep Bains,L,VAN,23,0,0,0,0
2,8484259,Ondrej Pavel,C,COL,31,0,0,0,0
2,8483432,Luca Del Bel Belluz,C,CBJ,31,0,0,0,0
2,8483045,Cameron Butler,R,CBJ,31,0,0,0,0
2,8482061,Brandon Biro,L,BUF,26,0,0,0,0
2,8477401,John Hayden,C,SEA,29,0,0,0,0
2,8475278,Byron Froese,C,VGK,33,0,0,0,0
2,8478446,Glenn Gawdin,C,ANA,27,0,0,0,0
2,8477993,Justin Kirkland,C,ARI,28,0,0,0,0
2,8482147,Jean-Luc Foudy,C,COL,22,0,0,0,0
2,8480032,Shane Bowers,C,NJD,25,0,0,0,0
2,8479330,Brandon Gignac,C,MTL,27,0,0,0,0
2,8480776,Sheldon Rempal,R,VGK,29,0,0,0,0
2,8475413,Justin Dowling,C,NJD,34,0,0,0,0
2,8481726,Adam Edstrom,C,NYR,24,0,0,0,0
2,8479638,Justin Brazeau,R,BOS,26,0,0,0,0
2,8480844,Grigori Denisenko,L,VGK,24,0,0,0,0
2,8474062,Riley Nash,C,NYR,35,0,0,0,0
2,8478147,Bokondji Imama,L,OTT,28,0,0,0,0
2,8478881,Brett Seney,L,CHI,28,0,0,0,0
2,8483630,Pavol Regenda,L,ANA,25,0,0,0,0
2,8480836,Jonathan Gruden,C,PIT,24,0,0,0,0
2,8484314,Jiri Smejkal,L,OTT,28,0,0,0,0
2,8475780,Chris Wagner,R,COL,33,0,0,0,0
2,8482070,Mitchell Chaffee,R,TBL,26,0,0,0,0
2,8479546,Oskar Steen,C,BOS,26,0,0,0,0
2,8483597,Milos Kelemen,L,ARI,25,0,0,0,0
2,8481789,Tye Kartye,L,SEA,23,0,0,0,0
2,8484325,Waltteri Merela,C,TBL,26,0,0,0,0
2,8479421,Jacob Moverare,D,LAK,26,0,0,0,0
2,8481585,Egor Afanasyev,L,NSH,23,0,0,0,0
2,8479547,Matthew Phillips,R,WSH,26,0,0,0,0
2,8479367,William Lockwood,R,FLA,26,0,0,0,0
2,8481422,Jacob Lucchini,C,MIN,29,0,0,0,0
2,8480468,James Hamblin,L,EDM,25,0,0,0,0
2,8480870,Bo Groulx,C,ANA,24,0,0,0,0
2,8478051,Max Willman,C,NJD,29,0,0,0,0
2,8481556,John Beecher,C,BOS,23,0,0,0,0
2,8478078,Rourke Chartier,C,OTT,28,0,0,0,0
3,8478402,Connor McDavid,C,EDM,27,82,50,100,150
3,8477939,William Nylander,R,TOR,28,82,50,77,127
3,8479318,Auston Matthews,C,TOR,27,82,75,50,125
3,8477956,David Pastrnak,R,BOS,28,82,50,74,124
3,8477934,Leon Draisaitl,C,EDM,29,82,48,75,123
3,8477492,Nathan MacKinnon,C,COL,29,82,46,76,122
3,8481559,Jack Hughes,C,NJD,23,82,47,72,119
3,8476468,J.T. Miller,C,VAN,31,82,41,77,118
3,8476453,Nikita Kucherov,R,TBL,31,82,38,80,118
3,8479314,Matthew Tkachuk,L,FLA,27,82,34,84,118
3,8479343,Clayton Keller,R,ARI,26,82,54,61,115
3,8478420,Mikko Rantanen,R,COL,28,82,53,60,113
3,8480012,Elias Pettersson,C,VAN,26,82,40,68,108
3,8480800,Quinn Hughes,D,VAN,25,82,15,91,106
3,8478550,Artemi Panarin,L,NYR,33,82,34,68,102
3,8480027,Jason Robertson,L,DAL,25,82,36,65,101
3,8477946,Dylan Larkin,C,DET,28,82,51,44,95
3,8480865,Noah Dobson,D,NYI,24,82,20,75,95
3,8478864,Kirill Kaprizov,L,MIN,27,82,50,44,94
3,8481557,Matt Boldy,L,MIN,23,82,37,57,94
3,8471675,Sidney Crosby,C,PIT,37,82,39,54,93
3,8477404,Jake Guentzel,C,CAR,30,82,38,54,92
3,8480801,Brady Tkachuk,L,OTT,25,82,37,55,92
3,8477409,Carter Verhaeghe,C,FLA,29,82,49,42,91
3,8477940,Nikolaj Ehlers,L,WPG,28,82,37,54,91
3,8478010,Brayden Point,C,TBL,28,82,42,48,90
3,8476887,Filip Forsberg,L,NSH,30,82,42,48,90
3,8478398,Kyle Connor,L,WPG,28,82,38,52,90
3,8476459,Mika Zibanejad,C,NYR,31,82,31,59,90
3,8474600,Roman Josi,D,NSH,34,82,27,63,90
3,8476346,Johnny Gaudreau,L,CBJ,31,82,23,67,90
3,8482116,Tim Stützle,C,OTT,22,82,34,55,89
3,8480002,Nico Hischier,C,NJD,25,82,30,59,89
3,8478445,Mathew Barzal,C,NYI,27,82,32,54,86
3,8477493,Aleksander Barkov,C,FLA,29,82,28,58,86
3,8477942,Kevin Fiala,L,LAK,28,82,27,59,86
3,8482078,Lucas Raymond,L,DET,22,82,22,64,86
3,8479385,Jordan Kyrou,C,STL,26,82,31,54,85
3,8480839,Rasmus Dahlin,D,BUF,24,82,17,68,85
3,8471214,Alex Ovechkin,L,WSH,39,82,46,38,84
3,8477933,Sam Reinhart,C,FLA,29,82,42,42,84
3,8480208,Drake Batherson,R,OTT,26,82,35,49,84
3,8474564,Steven Stamkos,C,TBL,34,82,32,52,84
3,8480069,Cale Makar,D,COL,26,82,21,63,84
3,8481523,Kirby Dach,C,MTL,23,82,19,65,84
3,8478403,Jack Eichel,C,VGK,28,82,38,45,83
3,8480023,Robert Thomas,C,STL,25,82,31,52,83
3,8478439,Travis Konecny,R,PHI,27,82,31,52,83
3,8480036,Miro Heiskanen,D,DAL,25,82,23,60,83
3,8477402,Pavel Buchnevich,L,STL,29,82,41,41,82
3,8476460,Mark Scheifele,C,WPG,31,82,33,49,82
3,8473419,Brad Marchand,L,BOS,36,82,31,51,82
3,8479420,Tage Thompson,C,BUF,27,82,42,38,80
3,8476881,Tomas Hertl,C,VGK,31,82,32,48,80
3,8477501,Valeri Nichushkin,R,COL,29,82,32,48,80
3,8475167,Victor Hedman,D,TBL,34,82,13,67,80
3,8475784,Jeff Skinner,C,BUF,32,82,35,44,79
3,8475172,Nazem Kadri,C,CGY,34,82,30,49,79
3,8476539,Jonathan Marchessault,R,VGK,34,82,44,34,78
3,8477949,Alex Tuch,R,BUF,28,82,22,56,78
3,8473512,Claude Giroux,R,OTT,36,82,22,56,78
3,8479337,Alex DeBrincat,R,DET,27,82,33,44,77
3,8475168,Matt Duchene,C,DAL,33,82,33,44,77
3,8475166,John Tavares,C,TOR,34,82,33,43,76
3,8475692,Mats Zuccarello,R,MIN,37,82,21,55,76
3,8479323,Adam Fox,D,NYR,26,82,21,55,76
3,8476389,Vincent Trocheck,C,NYR,31,82,37,38,75
3,8475913,Mark Stone,R,VGK,32,82,25,50,75
3,8479339,Patrik Laine,L,CBJ,26,82,25,49,74
3,8477951,Nick Schmaltz,C,ARI,28,82,23,51,74
3,8476454,Ryan Nugent-Hopkins,C,EDM,31,82,23,51,74
3,8479675,Trevor Moore,L,LAK,29,82,41,32,73
3,8475810,Bryan Rust,R,PIT,32,82,40,33,73
3,8471685,Anze Kopitar,C,LAK,37,82,22,51,73
3,8475158,Ryan O'Reilly,C,NSH,33,82,22,51,73
3,8478449,Roope Hintz,C,DAL,28,82,37,35,72
3,8478493,Joel Eriksson Ek,C,MIN,27,82,25,47,72
3,8478460,Zach Werenski,D,CBJ,27,82,19,53,72
3,8470794,Joe Pavelski,C,DAL,40,82,25,46,71
3,8477494,Jonathan Drouin,L,COL,29,82,21,50,71
3,8480830,Andrei Svechnikov,R,CAR,24,82,24,46,70
3,8479407,Jesper Bratt,L,NJD,26,82,23,47,70
3,8477960,Adrian Kempe,R,LAK,28,82,36,33,69
3,8478414,Timo Meier,R,NJD,28,82,36,33,69
3,8478042,Viktor Arvidsson,R,LAK,31,82,31,38,69
3,8478440,Dylan Strome,C,WSH,27,82,27,42,69
3,8478975,Mason Marchment,L,DAL,29,82,33,35,68
3,8475170,Brayden Schenn,C,STL,33,82,32,36,68
3,8477935,Sam Bennett,C,FLA,28,82,30,38,68
3,8475765,Vladimir Tarasenko,R,FLA,33,82,22,46,68
3,8481711,Matias Maccelli,L,ARI,24,82,16,52,68
3,8471724,Kris Letang,D,PIT,37,82,15,53,68
3,8475786,Zach Hyman,L,EDM,32,82,39,28,67
3,8475726,Tyler Toffoli,C,WPG,32,82,31,36,67
3,8478444,Brock Boeser,R,VAN,27,82,29,38,67
3,8475151,Kyle Palmieri,C,NYI,33,82,38,28,66
3,8479542,Brandon Hagel,L,TBL,26,82,29,37,66
3,8475754,Brock Nelson,C,NYI,33,82,26,40,66
3,8479999,Casey Mittelstadt,C,COL,26,82,19,47,66
3,8474590,John Carlson,D,WSH,34,82,13,53,66
3,8477500,Bo Horvat,C,NYI,29,82,39,26,65
3,8477416,Oliver Bjorkstrand,R,SEA,29,82,22,43,65
3,8477496,Elias Lindholm,C,VAN,30,82,22,43,65
3,8474141,Patrick Kane,R,DET,36,82,19,46,65
3,8476479,Phillip Danault,C,LAK,31,82,16,49,65
3,8477955,Jared McCann,L,SEA,28,82,30,34,64
3,8482093,Seth Jarvis,C,CAR,22,82,28,36,64
3,8476826,Yanni Gourde,C,SEA,33,82,24,40,64
3,8477447,Shea Theodore,D,VGK,29,82,17,47,64
3,8476456,Jonathan Huberdeau,C,CGY,31,82,15,49,64
3,8477503,Max Domi,C,TOR,29,82,14,50,64
3,8474578,Erik Karlsson,D,PIT,34,82,13,51,64
3,8481528,Dylan Cozens,C,BUF,23,82,34,29,63
3,8478427,Sebastian Aho,C,CAR,27,82,33,30,63
3,8476875,Mike Matheson,D,MTL,30,82,14,49,63
3,8478038,Devon Toews,D,COL,30,82,12,51,63
3,8477504,Josh Morrissey,D,WPG,29,82,9,54,63
3,8481540,Cole Caufield,R,MTL,23,82,29,33,62
3,8477497,Sean Monahan,C,WPG,30,82,25,37,62
3,8475184,Chris Kreider,L,NYR,33,82,40,21,61
3,8475794,Tyler Seguin,C,DAL,32,82,31,30,61
3,8478401,Pavel Zacha,C,BOS,27,82,28,33,61
3,8474641,Adam Henrique,C,EDM,34,82,27,33,60
3,8482699,Dylan Guenther,R,ARI,21,82,27,33,60
3,8474679,Gustav Nyquist,C,NSH,35,82,26,34,60
3,8480018,Nick Suzuki,C,MTL,25,82,21,39,60
3,8471215,Evgeni Malkin,C,PIT,38,82,19,41,60
3,8477986,Brandon Montour,D,FLA,30,82,15,45,60
3,8470613,Brent Burns,D,CAR,39,82,14,46,60
3,8476853,Morgan Rielly,D,TOR,30,82,10,50,60
3,8479325,Charlie McAvoy,D,BOS,27,82,7,53,60
3,8480039,Martin Necas,C,CAR,25,82,30,29,59
3,8476448,William Karlsson,C,VGK,31,82,27,32,59
3,8474586,Jordan Eberle,R,SEA,34,82,21,38,59
3,8478407,Vince Dunn,D,SEA,28,82,5,54,59
3,8476432,Boone Jenner,C,CBJ,31,82,34,24,58
3,8479400,Pierre-Luc Dubois,L,LAK,26,82,33,25,58
3,8473994,Jamie Benn,L,DAL,35,82,18,40,58
3,8478873,Troy Terry,R,ANA,27,82,13,45,58
3,8477476,Artturi Lehkonen,L,COL,29,82,37,20,57
3,8480064,Josh Norris,C,OTT,25,82,30,27,57
3,8478463,Anthony Beauvillier,L,NSH,27,82,24,33,57
3,8478396,Noah Hanifin,D,VGK,27,82,15,42,57
3,8481542,Moritz Seider,D,DET,23,82,8,49,57
3,8481596,Shane Pinto,C,OTT,24,82,28,28,56
3,8482740,Wyatt Johnston,C,DAL,21,82,28,28,56
3,8480015,Owen Tippett,R,PHI,25,82,26,30,56
3,8482097,Jack Quinn,R,BUF,23,82,24,32,56
3,8474150,Mikael Backlund,C,CGY,35,82,21,35,56
3,8480803,Evan Bouchard,D,EDM,25,82,13,43,56
3,8475768,Jaden Schwartz,C,SEA,32,82,27,28,55
3,8478498,Jake DeBrusk,L,BOS,28,82,26,29,55
3,8482159,Tyson Foerster,R,PHI,22,82,24,31,55
3,8482175,JJ Peterka,R,BUF,22,82,23,32,55
3,8475714,Calle Jarnkrok,C,TOR,33,82,22,33,55
3,8477964,Ivan Barbashev,C,VGK,29,82,20,35,55
3,8481068,Yegor Sharangovich,C,CGY,26,82,30,24,54
3,8477451,Ryan Hartman,R,MIN,30,82,25,29,54
3,8482124,Quinton Byfield,R,LAK,22,82,21,33,54
3,8475798,Mikael Granlund,C,SJS,32,82,11,43,54
3,8478474,Lawson Crouse,L,ARI,27,82,31,22,53
3,8480014,Gabriel Vilardi,C,WPG,25,82,28,25,53
3,8476905,Chandler Stephenson,C,VGK,30,82,14,39,53
3,8478366,Frank Vatrano,R,ANA,30,82,30,22,52
3,8475287,Erik Haula,L,NJD,33,82,29,23,52
3,8476882,Teuvo Teravainen,L,CAR,30,82,22,30,52
3,8478438,Tommy Novak,C,NSH,27,82,19,33,52
3,8474565,Alex Pietrangelo,D,VGK,34,82,18,34,52
3,8480028,Morgan Frost,C,PHI,25,82,18,34,52
3,8478458,Jack Roslovic,C,NYR,27,82,13,39,52
3,8482109,Alexis Lafrenière,L,NYR,23,82,30,21,51
3,8480188,Fabian Zetterlund,L,SJS,25,82,23,28,51
3,8471698,T.J. Oshie,R,WSH,38,82,21,30,51
3,8480797,Joel Farabee,L,PHI,24,82,20,31,51
3,8481533,Trevor Zegras,C,ANA,23,82,19,32,51
3,8478469,Thomas Chabot,D,OTT,27,82,19,32,51
3,8474563,Drew Doughty,D,LAK,35,82,14,37,51
3,8478397,Rasmus Andersson,D,CGY,28,82,7,44,51
3,8476399,Blake Coleman,C,CGY,33,82,24,26,50
3,8483515,Juraj Slafkovsky,L,MTL,20,82,23,27,50
3,8478046,Danton Heinen,L,BOS,29,82,23,27,50
3,8480078,Filip Chytil,C,NYR,25,82,15,35,50
3,8479425,Filip Hronek,D,VAN,27,82,11,39,50
3,8479992,Michael Rasmussen,C,DET,25,82,22,27,49
3,8478047,Michael Bunting,L,PIT,29,82,22,27,49
3,8476329,Travis Boyd,C,ARI,31,82,14,35,49
3,8482745,Mason McTavish,C,ANA,21,82,23,25,48
3,8481618,Alex Newhook,C,MTL,23,82,19,29,48
3,8477498,Darnell Nurse,D,EDM,29,82,19,29,48
3,8477456,J.T. Compher,L,DET,29,82,16,32,48
3,8477021,Alex Kerfoot,C,ARI,30,82,16,32,48
3,8475753,Justin Faulk,D,STL,32,82,8,40,48
3,8478055,Gustav Forsling,D,FLA,28,82,7,41,48
3,8476792,Torey Krug,D,STL,33,82,5,43,48
3,8476438,Brandon Saad,L,STL,32,82,28,19,47
3,8475799,Nino Niederreiter,R,WPG,32,82,27,20,47
3,8473986,Alex Killorn,L,ANA,35,82,24,23,47
3,8477407,Anthony Duclair,L,TBL,29,82,23,24,47
3,8482475,Yegor Chinakhov,R,CBJ,23,82,21,26,47
3,8482146,Luke Evangelista,R,NSH,22,82,19,28,47
3,8482113,Anton Lundell,C,FLA,23,82,18,29,47
3,8474157,Max Pacioretty,L,WSH,36,82,14,33,47
3,8482105,Jake Sanderson,D,OTT,22,82,14,33,47
3,8476872,Scott Laughton,C,PHI,30,82,14,33,47
3,8479410,Mikhail Sergachev,D,TBL,26,82,13,34,47
3,8482110,Dawson Mercer,C,NJD,23,82,28,18,46
3,8478856,Conor Garland,R,VAN,28,82,19,27,46
3,8477479,Tyler Bertuzzi,L,TOR,29,82,16,30,46
3,8480434,Sean Durzi,D,ARI,26,82,12,34,46
3,8477346,MacKenzie Weegar,D,CGY,30,82,10,36,46
3,8480009,Eeli Tolvanen,R,SEA,25,82,24,21,45
3,8476880,Tom Wilson,R,WSH,30,82,23,22,45
3,8480849,Barrett Hayton,C,ARI,24,82,23,22,45
3,8474102,David Perron,L,DET,36,82,21,24,45
3,8477429,Andrew Copp,C,DET,30,82,21,24,45
3,8482720,Matthew Knies,L,TOR,22,82,19,26,45
3,8480220,Noah Cates,L,PHI,25,82,19,26,45
3,8482665,Matty Beniers,C,SEA,22,82,18,27,45
3,8480798,Philipp Kurashev,C,CHI,25,82,17,28,45
3,8475169,Evander Kane,L,EDM,33,82,17,28,45
3,8478462,Nicolas Roy,C,VGK,27,82,15,30,45
3,8475745,Charlie Coyle,C,BOS,32,82,14,31,45
3,8476462,Dougie Hamilton,D,NJD,31,82,12,33,45
3,8482667,William Eklund,L,SJS,22,82,12,33,45
3,8477948,Travis Sanheim,D,PHI,28,82,10,35,45
3,8475906,John Klingberg,D,TOR,32,82,9,36,45
3,8479987,Morgan Geekie,C,BOS,26,82,23,21,44
3,8477998,Warren Foegele,L,EDM,28,82,23,21,44
3,8477952,Robby Fabbri,C,DET,28,82,22,22,44
3,8475722,Jason Zucker,L,NSH,32,82,21,23,44
3,8474037,James van Riemsdyk,L,BOS,35,82,19,25,44
3,8475191,Reilly Smith,R,PIT,33,82,18,26,44
3,8475744,Evgeny Kuznetsov,C,CAR,32,82,16,28,44
3,8476458,Ryan Strome,C,ANA,31,82,16,28,44
3,8476885,Jacob Trouba,D,NYR,30,82,15,29,44
3,8475760,Nick Bjugstad,C,ARI,32,82,30,13,43
3,8475793,Ryan Johansen,C,PHI,32,82,24,19,43
3,8476483,Rickard Rakell,R,PIT,31,82,20,23,43
3,8479941,Justin Danforth,R,CBJ,31,82,19,24,43
3,8475791,Taylor Hall,L,CHI,33,82,16,27,43
3,8475763,Kevin Hayes,R,STL,32,82,15,28,43
3,8477426,Nicholas Paul,L,TBL,29,82,15,28,43
3,8475314,Anders Lee,L,NYI,34,82,12,31,43
3,8476906,Shayne Gostisbehere,D,DET,31,82,7,36,43
3,8479398,Samuel Girard,D,COL,26,82,6,37,43
3,8476392,Adam Lowry,C,WPG,31,82,16,26,42
3,8481546,Cam York,D,PHI,23,82,8,34,42
3,8476917,Adam Pelech,D,NYI,30,82,7,35,42
3,8476958,Jaccob Slavin,D,CAR,30,82,4,38,42
3,8474715,Cam Atkinson,R,PHI,35,82,28,13,41
3,8480185,Eetu Luostarinen,C,FLA,26,82,22,19,41
3,8479591,Michael Eyssimont,C,TBL,28,82,22,19,41
3,8475848,Brendan Gallagher,R,MTL,32,82,21,20,41
3,8477989,Christian Dvorak,C,MTL,28,82,19,22,41
3,8481554,Kaapo Kakko,R,NYR,23,82,18,23,41
3,8482705,Cole Sillinger,C,CBJ,21,82,17,24,41
3,8471218,Blake Wheeler,R,NYR,38,82,16,25,41
3,8476461,Sean Couturier,C,PHI,32,82,15,26,41
3,8481560,Arthur Kaliyev,R,LAK,23,82,14,27,41
3,8480855,Jack McBain,C,ARI,24,82,12,29,41
3,8476292,Ondrej Palat,L,NJD,33,82,11,30,41
3,8482684,Luke Hughes,D,NJD,21,82,9,32,41
3,8476927,Teddy Blueger,C,VAN,30,82,22,18,40
3,8476925,Colton Sissons,C,NSH,31,82,21,19,40
3,8478466,Daniel Sprong,R,DET,27,82,17,23,40
3,8478057,Dakota Joshua,C,VAN,28,82,17,23,40
3,8474870,Tyler Johnson,C,CHI,34,82,15,25,40
3,8479345,Jakob Chychrun,D,OTT,26,82,12,28,40
3,8473563,Nicklas Backstrom,C,WSH,37,82,12,28,40
3,8482671,Owen Power,D,BUF,22,82,10,30,40
3,8477932,Aaron Ekblad,D,FLA,28,82,9,31,40
3,8475218,Mattias Ekholm,D,EDM,34,82,9,31,40
3,8478472,Mathieu Joseph,R,OTT,27,82,7,33,40
3,8480802,Ryan McLeod,C,EDM,25,82,17,22,39
3,8476419,Jean-Gabriel Pageau,C,NYI,32,82,10,29,39
3,8475197,Tyson Barrie,D,NSH,33,82,7,32,39
3,8474151,Ryan McDonagh,D,NSH,35,82,2,37,39
3,8483431,Logan Cooley,C,ARI,20,82,22,16,38
3,8480459,Pius Suter,C,VAN,28,82,21,17,38
3,8477919,Frederick Gaudreau,C,MIN,31,82,20,18,38
3,8481656,Aliaksei Protas,C,WSH,23,82,17,21,38
3,8474053,Logan Couture,C,SJS,35,82,16,22,38
3,8477511,Anthony Mantha,R,VGK,30,82,12,26,38
3,8474149,Evgenii Dadonov,R,DAL,35,82,12,26,38
3,8480145,Neal Pionk,D,WPG,29,82,10,28,38
3,8480043,Timothy Liljegren,D,TOR,25,82,3,35,38
3,8482655,J.J. Moser,D,ARI,24,82,2,36,38
3,8480893,Kirill Marchenko,R,CBJ,24,82,23,14,37
3,8480068,Ryan Poehling,C,PHI,25,82,22,15,37
3,8481624,Ilya Mikheyev,R,VAN,30,82,20,17,37
3,8479996,Cody Glass,C,NSH,25,82,18,19,37
3,8482092,Ridly Greig,C,OTT,22,82,18,19,37
3,8476921,Jordan Martinook,L,CAR,32,82,17,20,37
3,8476871,Tanner Pearson,L,MTL,32,82,16,21,37
3,8481704,Juuso Parssinen,C,NSH,23,82,16,21,37
3,8478519,Anthony Cirelli,C,TBL,27,82,13,24,37
3,8478413,Jordan Greenway,L,BUF,27,82,13,24,37
3,8478133,Jake Evans,C,MTL,28,82,10,27,37
3,8476923,Damon Severson,D,CBJ,30,82,7,30,37
3,8480817,K'Andre Miller,D,NYR,24,82,5,32,37
3,8475764,Cam Fowler,D,ANA,33,82,4,33,37
3,8481186,Logan O'Connor,R,COL,28,82,21,15,36
3,8477444,Andre Burakovsky,L,SEA,29,82,18,18,36
3,8477944,Jakub Vrana,L,STL,28,82,17,19,36
3,8476480,Vladislav Namestnikov,C,WPG,32,82,14,22,36
3,8477953,Kasperi Kapanen,R,STL,28,82,13,23,36
3,8477495,Seth Jones,D,CHI,30,82,11,25,36
3,8476869,Brady Skjei,D,CAR,30,82,7,29,36
3,8476981,Josh Anderson,R,MTL,30,82,20,15,35
3,8474884,Mike Hoffman,C,SJS,35,82,19,16,35
3,8482079,Marco Rossi,C,MIN,23,82,19,16,35
3,8479525,Ross Colton,C,COL,28,82,16,19,35
3,8477450,Jason Dickinson,C,CHI,29,82,16,19,35
3,8484144,Connor Bedard,C,CHI,19,82,15,20,35
3,8478233,Andrew Mangiapane,L,CGY,28,82,15,20,35
3,8480113,Alex Iafallo,L,WPG,31,82,10,25,35
3,8474673,TJ Brodie,D,TOR,34,82,4,31,35
3,8478542,Evan Rodrigues,C,FLA,31,82,17,17,34
3,8475200,Dmitry Orlov,D,CAR,33,82,16,18,34
3,8476469,Joel Armia,R,MTL,31,82,16,18,34
3,8470621,Corey Perry,R,EDM,39,82,16,18,34
3,8478109,Victor Olofsson,L,BUF,29,82,13,21,34
3,8479415,Michael McLeod,C,NJD,26,82,12,22,34
3,8480871,Adam Boqvist,D,CBJ,24,82,11,23,34
3,8482133,Thomas Bordeleau,C,SJS,22,82,8,26,34
3,8477969,Marcus Pettersson,D,PIT,28,82,7,27,34
3,8481535,Nils Hoglander,L,VAN,24,82,20,13,33
3,8479514,Rem Pitlick,C,CHI,27,82,18,15,33
3,8480995,Pontus Holmberg,R,TOR,25,82,16,17,33
3,8477947,Sonny Milano,L,WSH,28,82,14,19,33
3,8476897,Oskar Sundqvist,C,STL,30,82,12,21,33
3,8479365,Trent Frederic,C,BOS,26,82,11,22,33
3,8476854,Hampus Lindholm,D,BOS,30,82,10,23,33
3,8482117,Lukas Reichel,L,CHI,22,82,9,24,33
3,8475220,Marcus Foligno,L,MIN,33,82,9,24,33
3,8481581,Thomas Harley,D,DAL,23,82,7,26,33
3,8481178,Egor Zamula,D,PHI,24,82,4,29,33
3,8476331,Dylan DeMelo,D,WPG,31,82,3,30,33
3,8481580,Connor McMichael,C,WSH,23,82,16,16,32
3,8483808,Andrei Kuzmenko,L,CGY,28,82,14,18,32
3,8473533,Jordan Staal,C,CAR,36,82,14,18,32
3,8476374,Sean Kuraly,C,CBJ,31,82,8,24,32
3,8477506,Ryan Pulock,D,NYI,30,82,7,25,32
3,8478500,Ivan Provorov,D,CBJ,27,82,6,26,32
3,8475171,Oliver Ekman-Larsson,D,FLA,33,82,4,28,32
3,8479976,Juuso Valimaki,D,ARI,26,82,3,29,32
3,8482089,Jake Neighbours,L,STL,22,82,20,11,31
3,8477330,Dominik Kubalik,L,OTT,29,82,18,13,31
3,8474189,Lars Eller,C,PIT,35,82,17,14,31
3,8476960,Andreas Athanasiou,C,CHI,30,82,16,15,31
3,8484145,Zach Benson,L,BUF,19,82,16,15,31
3,8479293,Brandon Tanev,L,SEA,33,82,15,16,31
3,8482055,Drew O'Connor,L,PIT,26,82,14,17,31
3,8475343,Nic Dowd,C,WSH,34,82,11,20,31
3,8483457,Lane Hutson,D,MTL,20,82,9,22,31
3,8480073,Erik Brannstrom,D,OTT,25,82,5,26,31
3,8481604,Pavel Dorofeyev,L,VGK,24,82,16,14,30
3,8481601,Simon Holmstrom,R,NYI,23,82,16,14,30
3,8473422,Nick Foligno,L,CHI,37,82,14,16,30
3,8479977,Kailer Yamamoto,R,SEA,26,82,13,17,30
3,8482222,Alexander Barabanov,L,SJS,30,82,11,19,30
3,8478891,Mason Appleton,C,WPG,28,82,8,22,30
3,8470966,Mark Giordano,D,TOR,41,82,8,22,30
3,8482122,Brock Faber,D,MIN,22,82,3,27,30
3,8476892,Colton Parayko,D,STL,31,82,1,29,30
3,8481477,Nico Sturm,C,SJS,29,82,18,11,29
3,8482125,Alexander Holtz,R,NJD,22,82,14,15,29
3,8475149,Marcus Johansson,L,MIN,34,82,9,20,29
3,8481522,Peyton Krebs,C,BUF,23,82,9,20,29
3,8476979,Erik Gustafsson,D,NYR,32,82,6,23,29
3,8481606,Jordan Spence,D,LAK,23,82,6,23,29
3,8482245,Artem Zub,D,OTT,29,82,6,23,29
3,8481013,Jonatan Berggren,R,DET,24,82,15,13,28
3,8479351,Sam Steel,C,DAL,26,82,15,13,28
3,8484166,Adam Fantilli,C,CBJ,20,82,15,13,28
3,8478115,Pierre Engvall,L,NYI,28,82,13,15,28
3,8480813,Joe Veleno,C,DET,24,82,12,16,28
3,8479353,Brett Howden,C,VGK,26,82,12,16,28
3,8477220,Nate Schmidt,D,WPG,33,82,12,16,28
3,8481703,Valtteri Puustinen,R,PIT,25,82,11,17,28
3,8481553,Bobby Brink,R,PHI,23,82,10,18,28
3,8482624,Daniil Miromanov,D,CGY,27,82,8,20,28
3,8476457,Adam Larsson,D,SEA,32,82,7,21,28
3,8480336,Sean Walker,D,COL,30,82,6,22,28
3,8476891,Matt Grzelcyk,D,BOS,30,82,6,22,28
3,8480873,Rasmus Sandin,D,WSH,24,82,4,24,28
3,8480807,Mattias Samuelsson,D,BUF,24,82,4,24,28
3,8478443,Brandon Carlo,D,BOS,28,82,3,25,28
3,8482259,Bobby McMann,C,TOR,28,82,18,9,27
3,8479661,Tanner Jeannot,L,TBL,27,82,16,11,27
3,8478508,Yakov Trenin,C,COL,27,82,15,12,27
3,8478043,Sam Lafferty,C,VAN,29,82,13,14,27
3,8484203,Bradly Nadeau,L,CAR,19,82,11,16,27
3,8470610,Zach Parise,L,COL,40,82,11,16,27
3,8478451,Ethan Bear,D,WSH,27,82,7,20,27
3,8476463,Jonas Brodin,D,MIN,31,82,6,21,27
3,8476312,Josh Manson,D,COL,33,82,5,22,27
3,8477845,Trevor van Riemsdyk,D,WSH,33,82,5,22,27
3,8477488,Brett Pesce,D,CAR,30,82,4,23,27
3,8480058,Pierre-Olivier Joseph,D,PIT,25,82,4,23,27
3,8475279,Ben Chiarot,D,DET,33,82,4,23,27
3,8478840,Will Borgen,D,SEA,28,82,2,25,27
3,8473449,Kyle Okposo,R,FLA,36,82,15,11,26
3,8477425,Miles Wood,L,COL,29,82,13,13,26
3,8478013,Jake Walman,D,DET,28,82,12,14,26
3,8482074,Connor Zary,C,CGY,23,82,11,15,26
3,8477392,Hudson Fasching,R,NYI,29,82,10,16,26
3,8478911,Matt Roy,D,LAK,29,82,8,18,26
3,8481481,Blake Lizotte,C,LAK,27,82,7,19,26
3,8478851,Alexandre Carrier,D,NSH,28,82,7,19,26
3,8477435,Ryan Graves,D,PIT,29,82,6,20,26
3,8478136,Jake Middleton,D,MIN,28,82,3,23,26
3,8479393,Noah Gregor,C,TOR,26,82,14,11,25
3,8477406,Mattias Janmark,C,EDM,32,82,14,11,25
3,8474716,Jared Spurgeon,D,MIN,35,82,12,13,25
3,8482062,Cole Smith,L,NSH,29,82,12,13,25
3,8482166,Shakir Mukhamadullin,D,SJS,22,82,12,13,25
3,8474034,Pat Maroon,L,BOS,36,82,11,14,25
3,8478468,Jeremy Lauzon,D,NSH,27,82,9,16,25
3,8476624,Barclay Goodrow,C,NYR,31,82,9,16,25
3,8478569,Noel Acciari,C,PIT,33,82,8,17,25
3,8476878,Zemgus Girgensons,L,BUF,30,82,8,17,25
3,8482087,Kaiden Guhle,D,MTL,22,82,7,18,25
3,8474574,Tyler Myers,D,VAN,34,82,4,21,25
3,8470600,Ryan Suter,D,DAL,39,82,4,21,25
3,8475690,Chris Tanev,D,DAL,35,82,2,23,25
3,8480281,Alexey Toropchenko,R,STL,25,82,17,7,24
3,8480821,Filip Zadina,R,SJS,25,82,10,14,24
3,8483499,Liam Ohgren,L,MIN,20,82,10,14,24
3,8484153,Leo Carlsson,C,ANA,20,82,10,14,24
3,8483763,Maksymilian Szuber,D,ARI,22,82,9,15,24
3,8477369,Carson Soucy,D,VAN,30,82,9,15,24
3,8483482,Tristan Luneau,D,ANA,20,82,8,16,24
3,8477839,Conor Sheary,L,TBL,32,82,7,17,24
3,8482111,Justin Barron,D,MTL,23,82,7,17,24
3,8479359,Beck Malenstyn,L,WSH,26,82,7,17,24
3,8476873,Mark Jankowski,C,NSH,30,82,6,18,24
3,8479983,Mario Ferraro,D,SJS,26,82,6,18,24
3,8478859,Niko Mikkola,D,FLA,28,82,6,18,24
3,8483490,Pavel Mintyukov,D,ANA,21,82,5,19,24
3,8481014,Alexander Romanov,D,NYI,24,82,5,19,24
3,8477015,Connor Brown,R,EDM,30,82,5,19,24
3,8476429,Scott Mayfield,D,NYI,32,82,4,20,24
3,8475181,Nick Leddy,D,STL,33,82,2,22,24
3,8476931,Jake McCabe,D,TOR,31,82,2,22,24
3,8479346,Dillon Dube,C,CGY,26,82,16,7,23
3,8478020,Michael Amadio,C,VGK,28,82,15,8,23
3,8482803,Olen Zellweger,D,ANA,21,82,12,11,23
3,8470604,Jeff Carter,C,PIT,39,82,12,11,23
3,8482733,Logan Mailloux,D,MTL,31,82,12,11,23
3,8483397,Marc McLaughlin,C,BOS,25,82,12,11,23
3,8479316,Luke Kunin,C,SJS,27,82,11,12,23
3,8477507,Nikita Zadorov,D,VAN,29,82,9,14,23
3,8479371,Dante Fabbro,D,NSH,26,82,8,15,23
3,8482142,Jamie Drysdale,D,PHI,22,82,6,17,23
3,8478507,John Marino,D,NJD,27,82,5,18,23
3,8476422,Mike Reilly,D,NYI,31,82,5,18,23
3,8479324,Ryan Lindgren,D,NYR,26,82,5,18,23
3,8478178,Darren Raddysh,D,TBL,28,82,5,18,23
3,8475208,Brian Dumoulin,D,SEA,33,82,4,19,23
3,8476902,Esa Lindell,D,DAL,30,82,3,20,23
3,8477365,Connor Clifton,D,BUF,29,82,2,21,23
3,8473507,Jeff Petry,D,DET,37,82,2,21,23
3,8477505,Alexander Wennberg,C,NYR,30,82,11,11,22
3,8475164,Jakob Silfverberg,R,ANA,34,82,10,12,22
3,8479390,Taylor Raddysh,R,CHI,26,82,9,13,22
3,8476442,Matt Nieto,L,PIT,32,82,8,14,22
3,8481699,Aku Raty,R,ARI,23,82,8,14,22
3,8479383,Boris Katchouk,L,OTT,26,82,8,14,22
3,8482730,Brandt Clarke,D,LAK,21,82,7,15,22
3,8483495,Simon Nemec,D,NJD,20,82,7,15,22
3,8478882,Vladislav Gavrikov,D,LAK,29,82,5,17,22
3,8480035,Henri Jokiharju,D,BUF,25,82,4,18,22
3,8479998,Mikey Anderson,D,LAK,25,82,4,18,22
3,8481059,Scott Perunovich,D,STL,26,82,3,19,22
3,8479423,Alex Nylander,L,CBJ,26,82,16,5,21
3,8475231,Casey Cizikas,C,NYI,33,82,13,8,21
3,8481517,Brett Leason,R,ANA,25,82,12,9,21
3,8482807,Ethan Del Mastro,D,CHI,21,82,11,10,21
3,8483491,Ivan Miroshnichenko,L,WSH,20,82,10,11,21
3,8476467,Jamie Oleksiak,D,SEA,32,82,8,13,21
3,8475842,Sam Carrick,C,EDM,32,82,8,13,21
3,8482762,Simon Edvinsson,D,DET,21,82,8,13,21
3,8482809,Jackson Blake,R,CAR,21,82,7,14,21
3,8476278,Colin Blackwell,C,CHI,31,82,5,16,21
3,8475179,Dmitry Kulikov,D,FLA,34,82,5,16,21
3,8483565,Nick Blankenburg,D,CBJ,26,82,5,16,21
3,8479369,Andrew Peeke,D,BOS,26,82,4,17,21
3,8481568,Alex Vlasic,D,CHI,23,82,4,17,21
3,8480860,Kevin Bahl,D,NJD,24,82,3,18,21
3,8476372,Nick Seeler,D,PHI,31,82,3,18,21
3,8480144,David Kampf,C,TOR,29,82,8,12,20
3,8473504,Cal Clutterbuck,R,NYI,37,82,8,12,20
3,8477508,Curtis Lazar,C,NJD,29,82,7,13,20
3,8473453,Trevor Lewis,C,LAK,37,82,7,13,20
3,8480074,Alexandre Texier,C,CBJ,25,82,5,15,20
3,8474013,Ian Cole,D,VAN,35,82,5,15,20
3,8482470,Ilya Solovyov,D,CGY,24,82,5,15,20
3,8482858,Ryker Evans,D,SEA,23,82,5,15,20
3,8480796,Martin Fehervary,D,WSH,25,82,5,15,20
3,8477499,Rasmus Ristolainen,D,PHI,30,82,4,16,20
3,8475233,David Savard,D,MTL,34,82,4,16,20
3,8475462,Radko Gudas,D,ANA,34,82,3,17,20
3,8479980,Nicolas Hague,D,VGK,26,82,2,18,20
3,8482073,Braden Schneider,D,NYR,23,82,2,18,20
3,8474567,Zach Bogosian,D,MIN,34,82,2,18,20
3,8475188,Brayden McNabb,D,VGK,33,82,0,20,20
3,8482679,Matt Coronato,R,CGY,22,82,12,7,19
3,8474009,Nick Bonino,C,NYR,36,82,11,8,19
3,8481093,Rafael Harvey-Pinard,L,MTL,25,82,10,9,19
3,8476858,Phillip Di Giuseppe,L,VAN,31,82,9,10,19
3,8478831,Kevin Stenlund,C,FLA,28,82,9,10,19
3,8481537,Nikita Okhotiuk,D,CGY,24,82,9,10,19
3,8483505,Matthew Poitras,C,BOS,20,82,8,11,19
3,8482155,Alex Laferriere,R,LAK,23,82,6,13,19
3,8480806,Isac Lundestrom,C,ANA,25,82,4,15,19
3,8474166,Alec Martinez,D,VGK,37,82,4,15,19
3,8475324,Nick Jensen,D,WSH,34,82,3,16,19
3,8477353,Tyler Motte,C,TBL,29,82,10,8,18
3,8481524,Bowen Byram,D,BUF,23,82,9,9,18
3,8482702,Logan Stankoven,C,DAL,21,82,9,9,18
3,8478416,Erik Cernak,D,TBL,27,82,7,11,18
3,8475790,Erik Gudbranson,D,CBJ,32,82,5,13,18
3,8481599,Victor Soderstrom,D,ARI,23,82,5,13,18
3,8480879,Jacob Bernard-Docker,D,OTT,24,82,3,15,18
3,8482666,Scott Morrow,D,CAR,22,82,3,15,18
3,8475825,Jani Hakanpää,D,DAL,32,82,0,18,18
3,8484911,Collin Graf,R,SJS,22,82,8,9,17
3,8483471,Brad Lambert,C,WPG,31,82,8,9,17
3,8480448,Parker Kelly,L,OTT,25,82,7,10,17
3,8484149,Gavin Brindley,C,CBJ,20,82,5,12,17
3,8483493,Frank Nazar,C,CHI,20,82,5,12,17
3,8480246,Nick Perbix,D,TBL,26,82,5,12,17
3,8477034,Jaycob Megna,D,CHI,32,82,5,12,17
3,8480172,Jan Rutta,D,SJS,34,82,4,13,17
3,8483445,Cutter Gauthier,L,ANA,20,82,4,13,17
3,8478399,Jonas Siegenthaler,D,NJD,27,82,3,14,17
3,8476879,Cody Ceci,D,EDM,31,82,0,17,17
3,8482712,Oskar Olausson,R,COL,22,82,9,7,16
3,8483524,Shane Wright,C,SEA,20,82,8,8,16
3,8481028,Martin Pospisil,C,CGY,25,82,6,10,16
3,8483468,Jiri Kulich,C,BUF,20,82,6,10,16
3,8482145,Mavrik Bourque,C,DAL,22,82,6,10,16
3,8479442,Troy Stecher,D,EDM,30,82,3,13,16
3,8482101,Danil Gushchin,L,SJS,22,82,7,8,15
3,8483012,Logan Morrison,C,SEA,22,82,5,10,15
3,8481605,Jackson LaCombe,D,ANA,23,82,4,11,15
3,8481567,Henry Thrun,D,SJS,23,82,3,12,15
3,8480031,Maxime Comtois,L,CAR,25,82,3,12,15
3,8475455,Brenden Dillon,D,WPG,34,82,2,13,15
3,8476967,Brett Kulak,D,EDM,30,82,2,13,15
3,8478408,Travis Dermott,D,ARI,28,82,2,13,15
3,8476525,Colin Miller,D,WPG,32,82,1,14,15
3,8482713,Mackie Samoskevich,R,FLA,22,82,7,7,14
3,8482737,Zack Bolduc,C,STL,21,82,5,9,14
3,8481016,Ruslan Iskhakov,C,NYI,24,82,7,6,13
3,8476915,Jujhar Khaira,L,MIN,30,82,6,7,13
3,8475177,Calvin de Haan,D,TBL,33,82,5,8,13
3,8480834,Ty Emberson,D,SJS,24,82,3,10,13
3,8483466,Kevin Korchinski,D,CHI,20,82,3,10,13
3,8476822,Luke Glendening,C,TBL,35,82,6,6,12
3,8477931,Tomas Nosek,L,NJD,32,82,3,9,12
3,8476473,Connor Murphy,D,CHI,31,82,3,9,12
3,8482118,Sam Colangelo,R,ANA,23,82,3,9,12
3,8475762,Derek Forbort,D,BOS,32,82,2,10,12
3,8481578,Graeme Clarke,R,NJD,23,82,7,4,11
3,8478430,Oliver Kylington,D,CGY,27,82,5,6,11
3,8477335,Kyle Burroughs,D,SJS,29,82,5,6,11
3,8482859,Zack Ostapchuk,C,OTT,21,82,3,8,11
3,8482516,Matthew Kessel,D,STL,24,82,3,8,11
3,8481030,Jack St. Ivany,D,PIT,25,82,1,10,11
3,8482177,Marat Khusnutdinov,C,MIN,22,82,4,6,10
3,8483489,Fraser Minten,C,TOR,31,82,4,6,10
3,8480990,Declan Chisholm,D,MIN,24,82,2,8,10
3,8479291,Kevin Rooney,C,CGY,31,82,6,3,9
3,8471677,Jack Johnson,D,COL,37,82,2,7,9
3,8477950,Tony DeAngelo,D,CAR,29,0,0,0,0
3,8481577,Philip Tomasino,C,NSH,23,0,0,0,0
3,8482660,Kent Johnson,C,CBJ,22,0,0,0,0
3,8481019,David Gustafsson,C,WPG,24,0,0,0,0
3,8479348,Kale Clague,D,BUF,26,0,0,0,0
3,8482149,Cole Perfetti,C,WPG,22,0,0,0,0
3,8476952,Dominic Toninato,C,WPG,30,0,0,0,0
3,8473473,Milan Lucic,L,BOS,36,0,0,0,0
3,8480829,Jesperi Kotkaniemi,C,CAR,24,0,0,0,0
3,8474602,Justin Schultz,D,SEA,34,0,0,0,0
3,8480049,Dylan Samberg,D,WPG,25,0,0,0,0
3,8479372,Josh Mahura,D,FLA,26,0,0,0,0
3,8480878,Nils Lundkvist,D,DAL,24,0,0,0,0
3,8479982,Conor Timmins,D,TOR,26,0,0,0,0
3,8474031,Kevin Shattenkirk,D,BOS,35,0,0,0,0
3,8480835,Jack Drury,C,CAR,24,0,0,0,0
3,8480008,Adam Ruzicka,C,ARI,25,0,0,0,0
3,8479402,Jake Bean,D,CBJ,26,0,0,0,0
3,8476474,Stefan Noesen,R,CAR,31,0,0,0,0
3,8480884,Calen Addison,D,SJS,24,0,0,0,0
3,8476994,Vinnie Hinostroza,C,PIT,30,0,0,0,0
3,8477987,Ryan Donato,C,CHI,28,0,0,0,0
3,8481582,Nicholas Robertson,L,TOR,23,0,0,0,0
3,8478452,Caleb Jones,D,COL,27,0,0,0,0
3,8480157,Calle Rosen,D,STL,30,0,0,0,0
3,8481609,Vladislav Kolyachonok,D,ARI,23,0,0,0,0
3,8476919,Chris Tierney,C,NJD,30,0,0,0,0
3,8479639,Dylan Coghlan,D,CAR,26,0,0,0,0
3,8475193,Tomas Tatar,L,SEA,34,0,0,0,0
3,8480748,Kiefer Sherwood,L,NSH,29,0,0,0,0
3,8478146,Matthew Highmore,C,OTT,28,0,0,0,0
3,8478970,Jalen Chatfield,D,CAR,28,0,0,0,0
3,8480205,Emil Bemstrom,C,PIT,25,0,0,0,0
3,8471274,Alex Goligoski,D,MIN,39,0,0,0,0
3,8478104,Sammy Blais,L,STL,28,0,0,0,0
3,8476913,Devin Shore,C,SEA,30,0,0,0,0
3,8481708,Zac Jones,D,NYR,24,0,0,0,0
3,8480222,Sebastian Aho,D,NYI,28,0,0,0,0
3,8481598,Philip Broberg,D,EDM,23,0,0,0,0
3,8480789,Oliver Wahlstrom,R,NYI,24,0,0,0,0
3,8480891,Michael Kesselring,D,ARI,24,0,0,0,0
3,8477979,Nicolas Aube-Kubel,R,WSH,28,0,0,0,0
3,8476393,Nick Cousins,C,FLA,31,0,0,0,0
3,8480003,Jesper Boqvist,C,BOS,26,0,0,0,0
3,8479543,Michael Pezzetta,L,MTL,26,0,0,0,0
3,8475855,Jesper Fast,R,CAR,33,0,0,0,0
3,8477018,Ben Hutton,D,VGK,31,0,0,0,0
3,8480762,Eric Robinson,L,BUF,29,0,0,0,0
3,8481058,Jesse Ylönen,R,MTL,25,0,0,0,0
3,8481527,Kaedan Korczak,D,VGK,23,0,0,0,0
3,8482192,Isaak Phillips,D,CHI,23,0,0,0,0
3,8480727,Zach Whitecloud,D,VGK,28,0,0,0,0
3,8480001,Urho Vaakanainen,D,ANA,25,0,0,0,0
3,8480853,Liam Foudy,C,NSH,24,0,0,0,0
3,8475225,Craig Smith,C,DAL,35,0,0,0,0
3,8479972,Mason Shaw,C,MIN,26,0,0,0,0
3,8474040,Sam Gagner,C,EDM,35,0,0,0,0
3,8480196,Jacob Bryson,D,BUF,27,0,0,0,0
3,8475718,Justin Holl,D,DET,32,0,0,0,0
3,8479984,Cal Foote,D,NJD,26,0,0,0,0
3,8480011,Klim Kostin,C,SJS,25,0,0,0,0
3,8482176,Wyatt Kaiser,D,CHI,22,0,0,0,0
3,8476918,Jimmy Vesey,L,NYR,31,0,0,0,0
3,8476988,Matt Benning,D,SJS,30,0,0,0,0
3,8479370,Tyson Jost,C,BUF,26,0,0,0,0
3,8477464,Nic Petan,C,MIN,29,0,0,0,0
3,8477380,Jonny Brodzinski,C,NYR,31,0,0,0,0
3,8480070,Ian Mitchell,D,BOS,25,0,0,0,0
3,8479315,Joey Anderson,R,CHI,26,0,0,0,0
3,8478099,Kevin Labanc,R,SJS,29,0,0,0,0
3,8476874,Olli Maatta,D,DET,30,0,0,0,0
3,8479414,Nathan Bastian,R,NJD,27,0,0,0,0
3,8478434,Keegan Kolesar,R,VGK,27,0,0,0,0
3,8479536,Axel Jonsson-Fjallby,L,WPG,26,0,0,0,0
3,8479671,Mathieu Olivier,R,CBJ,27,0,0,0,0
3,8471709,Marc-Edouard Vlasic,D,SJS,37,0,0,0,0
3,8479328,Julien Gauthier,R,NYI,27,0,0,0,0
3,8478421,A.J. Greer,L,CGY,28,0,0,0,0
3,8477573,Nathan Walker,L,STL,30,0,0,0,0
3,8477478,William Carrier,L,VGK,30,0,0,0,0
3,8479344,Jesse Puljujarvi,R,PIT,26,0,0,0,0
3,8480887,Jordan Harris,D,MTL,24,0,0,0,0
3,8478502,Dennis Gilbert,D,CGY,28,0,0,0,0
3,8480355,Mark Kastelic,C,OTT,25,0,0,0,0
3,8475750,Jon Merrill,D,MIN,32,0,0,0,0
3,8476889,Radek Faksa,C,DAL,30,0,0,0,0
3,8478432,Christian Fischer,R,DET,27,0,0,0,0
3,8479439,Jacob MacDonald,D,SJS,31,0,0,0,0
3,8474568,Luke Schenn,D,NSH,35,0,0,0,0
3,8478454,Noah Juulsen,D,VAN,27,0,0,0,0
3,8475752,Tyler Pitlick,C,NYR,33,0,0,0,0
3,8482148,Hendrix Lapierre,C,WSH,22,0,0,0,0
3,8481167,Brayden Pachal,D,CGY,25,0,0,0,0
3,8478211,Dryden Hunt,L,CGY,29,0,0,0,0
3,8479321,Lucas Johansen,D,WSH,27,0,0,0,0
3,8480950,Ilya Lyubushkin,D,TOR,30,0,0,0,0
3,8479368,Max Jones,L,ANA,26,0,0,0,0
3,8471699,Andrew Cogliano,C,COL,37,0,0,0,0
3,8481521,Ronnie Attard,D,PHI,25,0,0,0,0
3,8481161,Jake Christiansen,D,CBJ,25,0,0,0,0
3,8479458,Nikita Zaitsev,D,CHI,33,0,0,0,0
3,8479619,Michael Carcone,L,ARI,28,0,0,0,0
3,8479026,Philippe Myers,D,TBL,27,0,0,0,0
3,8481617,Vasily Podkolzin,R,VAN,23,0,0,0,0
3,8481701,Santeri Hatakka,D,NJD,23,0,0,0,0
3,8477446,Michael McCarron,R,NSH,29,0,0,0,0
3,8483460,David Jiricek,D,CBJ,21,0,0,0,0
3,8474090,Brendan Smith,D,NJD,35,0,0,0,0
3,8482241,Radim Zohorna,L,PIT,28,0,0,0,0
3,8481032,Paul Cotter,C,VGK,25,0,0,0,0
3,8480289,Morgan Barron,C,WPG,26,0,0,0,0
3,8479379,Givani Smith,R,SJS,26,0,0,0,0
3,8480216,Jacob Peterson,C,SJS,25,0,0,0,0
3,8477851,Jordan Oesterle,D,CGY,32,0,0,0,0
3,8484258,Sam Malinski,D,COL,26,0,0,0,0
3,8478904,Steven Lorentz,C,FLA,28,0,0,0,0
3,8482095,Tyler Kleven,D,OTT,22,0,0,0,0
3,8480980,Connor Dewar,C,TOR,25,0,0,0,0
3,8480848,Ty Dellandrea,C,DAL,24,0,0,0,0
3,8476884,Derrick Pouliot,D,DAL,30,0,0,0,0
3,8480025,MacKenzie Entwistle,R,CHI,25,0,0,0,0
3,8474612,Travis Hamonic,D,OTT,34,0,0,0,0
3,8479336,Carl Grundstrom,R,LAK,27,0,0,0,0
3,8482964,Arber Xhekaj,D,MTL,23,0,0,0,0
3,8471686,Marc Staal,D,PHI,37,0,0,0,0
3,8477887,Patrick Brown,C,BOS,32,0,0,0,0
3,8478495,Denis Gurianov,R,PHI,27,0,0,0,0
3,8481550,Adam Beckman,L,MIN,23,0,0,0,0
3,8480845,Rasmus Kupari,C,WPG,24,0,0,0,0
3,8478585,Derek Ryan,C,EDM,38,0,0,0,0
3,8482141,Lukas Cormier,D,VGK,22,0,0,0,0
3,8477962,Brendan Lemieux,L,CAR,28,0,0,0,0
3,8482861,Vincent Iorio,D,WSH,22,0,0,0,0
3,8479378,Logan Stanley,D,WPG,26,0,0,0,0
3,8473446,Erik Johnson,D,PHI,36,0,0,0,0
3,8481743,Marc Del Gaizo,D,NSH,25,0,0,0,0
3,8478450,Parker Wotherspoon,D,BOS,27,0,0,0,0
3,8477384,Josh Brown,D,ARI,30,0,0,0,0
3,8482165,Yan Kuznetsov,D,CGY,22,0,0,0,0
3,8478424,Jansen Harkins,C,PIT,27,0,0,0,0
3,8482144,Jack Thompson,D,SJS,22,0,0,0,0
3,8479576,Vincent Desharnais,D,EDM,28,0,0,0,0
3,8478512,Austin Czarnik,C,DET,32,0,0,0,0
3,8477527,Ross Johnston,L,ANA,30,0,0,0,0
3,8482094,Daemon Hunt,D,MIN,22,0,0,0,0
3,8481719,Maxwell Crozier,D,TBL,24,0,0,0,0
3,8480192,Johnathan Kovacevic,D,MTL,27,0,0,0,0
3,8479376,Victor Mete,D,PHI,26,0,0,0,0
3,8482511,Mason Lohrei,D,BOS,23,0,0,0,0
3,8478021,William Lagesson,D,ANA,28,0,0,0,0
3,8475795,Dylan McIlrath,D,WSH,32,0,0,0,0
3,8477846,Ryan Carpenter,C,SJS,33,0,0,0,0
3,8481056,Spencer Stastney,D,NSH,24,0,0,0,0
3,8481564,Ryan Johnson,D,BUF,23,0,0,0,0
3,8478017,Mark Friedman,D,VAN,29,0,0,0,0
3,8479320,Max Lajoie,D,TOR,27,0,0,0,0
3,8480075,Cameron Crotty,D,ARI,25,0,0,0,0
3,8484287,Cole McWard,D,VAN,23,0,0,0,0
3,8484254,Akito Hirose,D,VAN,25,0,0,0,0
3,8483407,Brandon Scanlin,D,NYR,25,0,0,0,0
3,8480274,Philip Kemp,D,EDM,25,0,0,0,0
3,8479522,Hardy Haman Aktell,D,WSH,26,0,0,0,0
3,8480007,Jonas Rondbjerg,R,VGK,25,0,0,0,0
3,8477454,Adam Erne,L,EDM,29,0,0,0,0
3,8481679,Maxence Guenette,D,OTT,23,0,0,0,0
3,8477938,Haydn Fleury,D,TBL,28,0,0,0,0
3,8476441,Joel Edmundson,D,TOR,31,0,0,0,0
3,8477903,Garnet Hathaway,R,PHI,33,0,0,0,0
3,8480441,Trey Fix-Wolansky,R,CBJ,25,0,0,0,0
3,8483546,Marshall Rifai,D,TOR,26,0,0,0,0
3,8480084,Nick DeSimone,D,NJD,30,0,0,0,0
3,8481592,Jakob Pelletier,L,CGY,23,0,0,0,0
3,8478011,Louie Belpedio,D,PHI,28,0,0,0,0
3,8477930,Pierre-Edouard Bellemare,L,SEA,39,0,0,0,0
3,8484321,Nikolas Matinpalo,D,OTT,26,0,0,0,0
3,8482067,Connor Mackey,D,NYR,28,0,0,0,0
3,8481806,Louis Crevier,D,CHI,23,0,0,0,0
3,8484326,Patrik Koch,D,ARI,28,0,0,0,0
3,8477971,Andreas Englund,D,LAK,28,0,0,0,0
3,8481751,Lukas Rousek,R,BUF,25,0,0,0,0
3,8481006,Tyler Tucker,D,STL,24,0,0,0,0
3,8481641,Joel Kiviranta,L,COL,28,0,0,0,0
3,8476867,Brendan Gaunce,C,CBJ,30,0,0,0,0
3,8479520,Brandon Duhaime,R,COL,27,0,0,0,0
3,8477073,Kurtis MacDermid,L,NJD,30,0,0,0,0
3,8480874,Adam Ginning,D,PHI,24,0,0,0,0
3,8477473,Justin Bailey,R,SJS,29,0,0,0,0
3,8479066,Ryan Lomberg,L,FLA,30,0,0,0,0
3,8477070,Liam O'Brien,C,ARI,30,0,0,0,0
3,8474618,Marco Scandella,D,STL,34,0,0,0,0
3,8475797,Jarred Tinordi,D,CHI,32,0,0,0,0
3,8481441,Joe Snively,C,WSH,28,0,0,0,0
3,8477244,Chad Ruhwedel,D,NYR,34,0,0,0,0
3,8482077,Dylan Holloway,L,EDM,23,0,0,0,0
3,8479772,Zack MacEwen,R,OTT,28,0,0,0,0
3,8481147,Reese Johnson,C,CHI,26,0,0,0,0
3,8481043,Cole Koepke,L,TBL,26,0,0,0,0
3,8483619,Filip Roos,D,CHI,25,0,0,0,0
3,8481541,Samuel Bolduc,D,NYI,24,0,0,0,0
3,8477810,Joel Hanley,D,CGY,33,0,0,0,0
3,8476907,Mackenzie MacEachern,L,STL,30,0,0,0,0
3,8482652,Walker Duehr,R,CGY,27,0,0,0,0
3,8477126,Jayson Megna,C,BOS,34,0,0,0,0
3,8483398,Declan Carlile,D,TBL,31,0,0,0,0
3,8482929,Emil Lilleberg,D,TBL,23,0,0,0,0
3,8480880,Jakub Lauko,C,BOS,24,0,0,0,0
3,8478874,Adam Gaudette,C,STL,28,0,0,0,0
3,8480245,Olle Lycksell,R,PHI,25,0,0,0,0
3,8480252,Cole Guttman,C,CHI,25,0,0,0,0
3,8477467,Gustav Olofsson,D,SEA,30,0,0,0,0
3,8479968,Vinni Lettieri,C,MIN,29,0,0,0,0
3,8478400,Colin White,C,MTL,27,0,0,0,0
3,8475755,Alexander Petrovic,D,DAL,32,0,0,0,0
3,8481812,Nikolai Knyzhov,D,SJS,27,0,0,0,0
3,8481593,Jayden Struble,D,MTL,23,0,0,0,0
3,8481532,Alex Turcotte,C,LAK,23,0,0,0,0
3,8482126,Emil Andrae,D,PHI,31,0,0,0,0
3,8479944,Zach Aston-Reese,C,DET,30,0,0,0,0
3,8471817,Ryan Reaves,R,TOR,37,0,0,0,0
3,8481206,John Ludvig,D,PIT,24,0,0,0,0
3,8480292,Carson Meyer,R,CBJ,27,0,0,0,0
3,8482496,Nils Aman,C,VAN,24,0,0,0,0
3,8479718,Alex Barré-Boulet,C,TBL,27,0,0,0,0
3,8479994,Jaret Anderson-Dolan,C,NSH,25,0,0,0,0
3,8480184,Gustav Lindstrom,D,ANA,26,0,0,0,0
3,8480890,Jan Jenik,R,ARI,24,0,0,0,0
3,8478067,Oskar Lindblom,L,SJS,28,0,0,0,0
3,8476934,Brock McGinn,L,ANA,30,0,0,0,0
3,8479985,Cale Fleury,D,SEA,26,0,0,0,0
3,8482153,Brendan Brisson,C,VGK,23,0,0,0,0
3,8480021,Jack Studnicka,C,SJS,25,0,0,0,0
3,8484304,Uvis Balinskis,D,FLA,28,0,0,0,0
3,8479981,Jonah Gadjovich,L,FLA,26,0,0,0,0
3,8481716,Dmitri Voronkov,L,CBJ,24,0,0,0,0
3,8482659,Josh Doan,R,ARI,22,0,0,0,0
3,8481122,Simon Benoit,D,TOR,26,0,0,0,0
3,8474709,Matt Martin,L,NYI,35,0,0,0,0
3,8482634,Alex Steeves,C,TOR,25,0,0,0,0
3,8480823,Alexander Alexeyev,D,WSH,25,0,0,0,0
3,8477541,Dakota Mermis,D,MIN,30,0,0,0,0
3,8478477,Mitchell Stephens,C,MTL,27,0,0,0,0
3,8481543,Nikita Alexandrov,C,STL,24,0,0,0,0
3,8482451,Mikael Pyyhtia,L,CBJ,23,0,0,0,0
3,8480306,Grant Hutton,D,NYI,29,0,0,0,0
3,8478028,Fredrik Olofsson,L,COL,28,0,0,0,0
3,8477462,Robert Hagg,D,ANA,29,0,0,0,0
3,8477320,Anton Blidh,L,NYR,29,0,0,0,0
3,8482749,Joshua Roy,R,MTL,21,0,0,0,0
3,8482157,Will Cuylle,L,NYR,22,0,0,0,0
3,8481239,Samuel Fagemo,L,LAK,24,0,0,0,0
3,8481600,Tobias Bjornfot,D,FLA,23,0,0,0,0
3,8478409,Anthony Richard,C,BOS,28,0,0,0,0
3,8474145,Robert Bortuzzo,D,NYI,35,0,0,0,0
3,8475958,Michael Sgarbossa,C,WSH,32,0,0,0,0
3,8479986,Kole Lind,R,SEA,26,0,0,0,0
3,8479249,Andrew Poturalski,C,SEA,30,0,0,0,0
3,8479362,Riley Tufte,L,COL,26,0,0,0,0
3,8479991,Jake Leschyshyn,C,NYR,25,0,0,0,0
3,8479587,Rhett Gardner,C,PHI,28,0,0,0,0
3,8482744,James Malatesta,L,CBJ,21,0,0,0,0
3,8478854,Ryan Shea,D,PIT,27,0,0,0,0
3,8481591,Sam Poulin,R,PIT,23,0,0,0,0
3,8483512,Matt Savoie,C,BUF,20,0,0,0,0
3,8482102,Vasily Ponomarev,C,CAR,22,0,0,0,0
3,8482162,Roby Jarventie,L,OTT,22,0,0,0,0
3,8482172,Landon Slaggert,L,CHI,22,0,0,0,0
3,8482747,Brennan Othmann,L,NYR,21,0,0,0,0
3,8480226,Marián Studenic,R,SEA,26,0,0,0,0
3,8481518,Nolan Foote,L,NJD,24,0,0,0,0
3,8479419,Brett Murray,L,BUF,26,0,0,0,0
3,8482088,Justin Sourdif,R,FLA,22,0,0,0,0
3,8482201,Gage Goncalves,C,TBL,23,0,0,0,0
3,8481754,Nikita Nesterenko,C,ANA,23,0,0,0,0
3,8483531,Brian Halonen,L,NJD,25,0,0,0,0
3,8483920,Pierrick Dube,R,WSH,23,0,0,0,0
3,8480851,Akil Thomas,C,LAK,24,0,0,0,0
3,8475235,Nicolas Deslauriers,L,PHI,33,0,0,0,0
3,8482476,Emil Heineman,L,MTL,23,0,0,0,0
3,8477149,Scott Sabourin,R,SJS,32,0,0,0,0
3,8483549,Lucas Condotta,L,MTL,27,0,0,0,0
3,8483567,Georgii Merkulov,C,BOS,24,0,0,0,0
3,8482765,Isak Rosen,R,BUF,21,0,0,0,0
3,8481237,Kyle MacLean,C,NYI,25,0,0,0,0
3,8481024,Linus Karlsson,C,VAN,25,0,0,0,0
3,8481690,Tyler Angle,C,CBJ,24,0,0,0,0
3,8483570,Ben Meyers,C,ANA,26,0,0,0,0
3,8481655,Cole Schwindt,R,CGY,23,0,0,0,0
3,8481462,Mason Morelli,L,VGK,28,0,0,0,0
3,8483401,Marc Johnstone,R,PIT,28,0,0,0,0
3,8478956,Samuel Laberge,L,NJD,27,0,0,0,0
3,8479533,Joona Koppanen,L,PIT,26,0,0,0,0
3,8482197,Adam Raska,R,MIN,23,0,0,0,0
3,8482250,Callahan Burke,C,CAR,27,0,0,0,0
3,8482784,Zach Dean,C,STL,21,0,0,0,0
3,8484255,Jason Polin,R,COL,25,0,0,0,0
3,8481077,John Leonard,L,ARI,26,0,0,0,0
3,8481534,Raphael Lavoie,C,EDM,24,0,0,0,0
3,8483609,Adam Klapka,R,CGY,24,0,0,0,0
3,8482751,Ryan Winterton,C,SEA,21,0,0,0,0
3,8480267,Sammy Walker,C,MIN,25,0,0,0,0
3,8475766,Austin Watson,L,TBL,32,0,0,0,0
3,8482460,Matt Rempe,C,NYR,22,0,0,0,0
3,8482787,Nikita Chibrikov,R,WPG,31,0,0,0,0
3,8481065,Angus Crookshank,L,OTT,25,0,0,0,0
3,8481070,Hugh McGing,L,STL,26,0,0,0,0
3,8476323,Max McCormick,L,SEA,32,0,0,0,0
3,8483395,Arshdeep Bains,L,VAN,23,0,0,0,0
3,8484259,Ondrej Pavel,C,COL,31,0,0,0,0
3,8483432,Luca Del Bel Belluz,C,CBJ,31,0,0,0,0
3,8483045,Cameron Butler,R,CBJ,31,0,0,0,0
3,8482061,Brandon Biro,L,BUF,26,0,0,0,0
3,8477401,John Hayden,C,SEA,29,0,0,0,0
3,8475278,Byron Froese,C,VGK,33,0,0,0,0
3,8478446,Glenn Gawdin,C,ANA,27,0,0,0,0
3,8477993,Justin Kirkland,C,ARI,28,0,0,0,0
3,8482147,Jean-Luc Foudy,C,COL,22,0,0,0,0
3,8480032,Shane Bowers,C,NJD,25,0,0,0,0
3,8479330,Brandon Gignac,C,MTL,27,0,0,0,0
3,8480776,Sheldon Rempal,R,VGK,29,0,0,0,0
3,8475413,Justin Dowling,C,NJD,34,0,0,0,0
3,8481726,Adam Edstrom,C,NYR,24,0,0,0,0
3,8479638,Justin Brazeau,R,BOS,26,0,0,0,0
3,8480844,Grigori Denisenko,L,VGK,24,0,0,0,0
3,8474062,Riley Nash,C,NYR,35,0,0,0,0
3,8478147,Bokondji Imama,L,OTT,28,0,0,0,0
3,8478881,Brett Seney,L,CHI,28,0,0,0,0
3,8483630,Pavol Regenda,L,ANA,25,0,0,0,0
3,8480836,Jonathan Gruden,C,PIT,24,0,0,0,0
3,8484314,Jiri Smejkal,L,OTT,28,0,0,0,0
3,8475780,Chris Wagner,R,COL,33,0,0,0,0
3,8482070,Mitchell Chaffee,R,TBL,26,0,0,0,0
3,8479546,Oskar Steen,C,BOS,26,0,0,0,0
3,8483597,Milos Kelemen,L,ARI,25,0,0,0,0
3,8481789,Tye Kartye,L,SEA,23,0,0,0,0
3,8484325,Waltteri Merela,C,TBL,26,0,0,0,0
3,8479421,Jacob Moverare,D,LAK,26,0,0,0,0
3,8481585,Egor Afanasyev,L,NSH,23,0,0,0,0
3,8479547,Matthew Phillips,R,WSH,26,0,0,0,0
3,8479367,William Lockwood,R,FLA,26,0,0,0,0
3,8481422,Jacob Lucchini,C,MIN,29,0,0,0,0
3,8480468,James Hamblin,L,EDM,25,0,0,0,0
3,8480870,Bo Groulx,C,ANA,24,0,0,0,0
3,8478051,Max Willman,C,NJD,29,0,0,0,0
3,8481556,John Beecher,C,BOS,23,0,0,0,0
3,8478078,Rourke Chartier,C,OTT,28,0,0,0,0
4,8478402,Connor McDavid,C,EDM,27,82,52,99,151
4,8477492,Nathan MacKinnon,C,COL,29,82,46,87,133
4,8477493,Aleksander Barkov,C,FLA,29,82,35,87,122
4,8476453,Nikita Kucherov,R,TBL,31,82,44,69,113
4,8478864,Kirill Kaprizov,L,MIN,27,82,48,61,109
4,8479314,Matthew Tkachuk,L,FLA,27,82,27,81,108
4,8478420,Mikko Rantanen,R,COL,28,82,45,61,106
4,8480069,Cale Makar,D,COL,26,82,24,78,102
4,8477956,David Pastrnak,R,BOS,28,82,42,57,99
4,8478550,Artemi Panarin,L,NYR,33,82,32,67,99
4,8477402,Pavel Buchnevich,L,STL,29,82,31,68,99
4,8479318,Auston Matthews,C,TOR,27,82,58,40,98
4,8477934,Leon Draisaitl,C,EDM,29,82,36,62,98
4,8479323,Adam Fox,D,NYR,26,82,16,82,98
4,8480800,Quinn Hughes,D,VAN,25,82,13,82,95
4,8476459,Mika Zibanejad,C,NYR,31,82,41,52,93
4,8476468,J.T. Miller,C,VAN,31,82,31,62,93
4,8477409,Carter Verhaeghe,C,FLA,29,82,56,36,92
4,8481559,Jack Hughes,C,NJD,23,82,38,54,92
4,8478010,Brayden Point,C,TBL,28,82,36,55,91
4,8473419,Brad Marchand,L,BOS,36,82,33,58,91
4,8474564,Steven Stamkos,C,TBL,34,82,45,45,90
4,8479385,Jordan Kyrou,C,STL,26,82,42,48,90
4,8477960,Adrian Kempe,R,LAK,28,82,30,60,90
4,8477404,Jake Guentzel,C,CAR,30,82,29,61,90
4,8480036,Miro Heiskanen,D,DAL,25,82,22,68,90
4,8479343,Clayton Keller,R,ARI,26,82,44,45,89
4,8480002,Nico Hischier,C,NJD,25,82,31,58,89
4,8478445,Mathew Barzal,C,NYI,27,82,31,58,89
4,8478398,Kyle Connor,L,WPG,28,82,42,46,88
4,8477939,William Nylander,R,TOR,28,82,39,48,87
4,8481557,Matt Boldy,L,MIN,23,82,37,50,87
4,8477933,Sam Reinhart,C,FLA,29,82,45,41,86
4,8476389,Vincent Trocheck,C,NYR,31,82,38,48,86
4,8471675,Sidney Crosby,C,PIT,37,82,33,53,86
4,8482116,Tim Stützle,C,OTT,22,82,31,55,86
4,8471214,Alex Ovechkin,L,WSH,39,82,45,40,85
4,8478873,Troy Terry,R,ANA,27,82,35,50,85
4,8480801,Brady Tkachuk,L,OTT,25,82,31,54,85
4,8480027,Jason Robertson,L,DAL,25,82,23,60,83
4,8476887,Filip Forsberg,L,NSH,30,82,37,45,82
4,8477942,Kevin Fiala,L,LAK,28,82,27,55,82
4,8479420,Tage Thompson,C,BUF,27,82,46,35,81
4,8475172,Nazem Kadri,C,CGY,34,82,38,43,81
4,8480830,Andrei Svechnikov,R,CAR,24,82,35,46,81
4,8474600,Roman Josi,D,NSH,34,82,26,55,81
4,8479407,Jesper Bratt,L,NJD,26,82,26,55,81
4,8480012,Elias Pettersson,C,VAN,26,82,31,49,80
4,8478439,Travis Konecny,R,PHI,27,82,28,52,80
4,8476460,Mark Scheifele,C,WPG,31,82,27,53,80
4,8477949,Alex Tuch,R,BUF,28,82,33,46,79
4,8475692,Mats Zuccarello,R,MIN,37,82,16,63,79
4,8471215,Evgeni Malkin,C,PIT,38,82,30,47,77
4,8480023,Robert Thomas,C,STL,25,82,24,53,77
4,8478449,Roope Hintz,C,DAL,28,82,30,46,76
4,8478444,Brock Boeser,R,VAN,27,82,47,28,75
4,8477946,Dylan Larkin,C,DET,28,82,36,39,75
4,8475784,Jeff Skinner,C,BUF,32,82,30,44,74
4,8474141,Patrick Kane,R,DET,36,82,28,46,74
4,8480839,Rasmus Dahlin,D,BUF,24,82,22,52,74
4,8481523,Kirby Dach,C,MTL,23,82,19,55,74
4,8475158,Ryan O'Reilly,C,NSH,33,82,17,57,74
4,8481540,Cole Caufield,R,MTL,23,82,39,34,73
4,8478047,Michael Bunting,L,PIT,29,82,29,44,73
4,8480803,Evan Bouchard,D,EDM,25,82,17,55,72
4,8475184,Chris Kreider,L,NYR,33,82,50,21,71
4,8477501,Valeri Nichushkin,R,COL,29,82,36,35,71
4,8478414,Timo Meier,R,NJD,28,82,31,40,71
4,8473994,Jamie Benn,L,DAL,35,82,25,46,71
4,8481528,Dylan Cozens,C,BUF,23,82,23,48,71
4,8476346,Johnny Gaudreau,L,CBJ,31,82,19,52,71
4,8475166,John Tavares,C,TOR,34,82,26,44,70
4,8477951,Nick Schmaltz,C,ARI,28,82,25,45,70
4,8480208,Drake Batherson,R,OTT,26,82,23,47,70
4,8478975,Mason Marchment,L,DAL,29,82,36,33,69
4,8478427,Sebastian Aho,C,CAR,27,82,36,33,69
4,8482665,Matty Beniers,C,SEA,22,82,29,40,69
4,8478466,Daniel Sprong,R,DET,27,82,29,40,69
4,8482124,Quinton Byfield,R,LAK,22,82,28,41,69
4,8474578,Erik Karlsson,D,PIT,34,82,13,56,69
4,8470794,Joe Pavelski,C,DAL,40,82,28,40,68
4,8480039,Martin Necas,C,CAR,25,82,28,40,68
4,8477447,Shea Theodore,D,VGK,29,82,20,48,68
4,8482078,Lucas Raymond,L,DET,22,82,29,38,67
4,8475810,Bryan Rust,R,PIT,32,82,34,32,66
4,8479337,Alex DeBrincat,R,DET,27,82,27,39,66
4,8471685,Anze Kopitar,C,LAK,37,82,25,41,66
4,8473512,Claude Giroux,R,OTT,36,82,23,43,66
4,8475167,Victor Hedman,D,TBL,34,82,9,57,66
4,8476539,Jonathan Marchessault,R,VGK,34,82,33,32,65
4,8475726,Tyler Toffoli,C,WPG,32,82,27,38,65
4,8479410,Mikhail Sergachev,D,TBL,26,82,14,51,65
4,8475786,Zach Hyman,L,EDM,32,82,25,39,64
4,8476454,Ryan Nugent-Hopkins,C,EDM,31,82,24,40,64
4,8478460,Zach Werenski,D,CBJ,27,82,21,43,64
4,8477504,Josh Morrissey,D,WPG,29,82,11,53,64
4,8481533,Trevor Zegras,C,ANA,23,82,29,34,63
4,8475745,Charlie Coyle,C,BOS,32,82,20,43,63
4,8477494,Jonathan Drouin,L,COL,29,82,17,46,63
4,8477503,Max Domi,C,TOR,29,82,15,48,63
4,8478498,Jake DeBrusk,L,BOS,28,82,42,20,62
4,8477500,Bo Horvat,C,NYI,29,82,32,30,62
4,8482740,Wyatt Johnston,C,DAL,21,82,29,33,62
4,8480015,Owen Tippett,R,PHI,25,82,29,33,62
4,8478856,Conor Garland,R,VAN,28,82,29,33,62
4,8482093,Seth Jarvis,C,CAR,22,82,27,35,62
4,8476479,Phillip Danault,C,LAK,31,82,26,36,62
4,8478438,Tommy Novak,C,NSH,27,82,24,38,62
4,8477955,Jared McCann,L,SEA,28,82,23,39,62
4,8476882,Teuvo Teravainen,L,CAR,30,82,23,39,62
4,8478038,Devon Toews,D,COL,30,82,11,51,62
4,8476853,Morgan Rielly,D,TOR,30,82,10,52,62
4,8475913,Mark Stone,R,VGK,32,82,27,34,61
4,8474150,Mikael Backlund,C,CGY,35,82,20,41,61
4,8478042,Viktor Arvidsson,R,LAK,31,82,17,44,61
4,8476456,Jonathan Huberdeau,C,CGY,31,82,16,45,61
4,8477935,Sam Bennett,C,FLA,28,82,36,24,60
4,8475794,Tyler Seguin,C,DAL,32,82,28,32,60
4,8477416,Oliver Bjorkstrand,R,SEA,29,82,24,36,60
4,8476906,Shayne Gostisbehere,D,DET,31,82,21,39,60
4,8477940,Nikolaj Ehlers,L,WPG,28,82,20,40,60
4,8475798,Mikael Granlund,C,SJS,32,82,17,43,60
4,8474563,Drew Doughty,D,LAK,35,82,12,48,60
4,8478403,Jack Eichel,C,VGK,28,82,30,29,59
4,8476483,Rickard Rakell,R,PIT,31,82,29,30,59
4,8475168,Matt Duchene,C,DAL,33,82,28,31,59
4,8477407,Anthony Duclair,L,TBL,29,82,28,31,59
4,8475191,Reilly Smith,R,PIT,33,82,26,33,59
4,8477496,Elias Lindholm,C,VAN,30,82,22,37,59
4,8481068,Yegor Sharangovich,C,CGY,26,82,19,40,59
4,8482684,Luke Hughes,D,NJD,21,82,18,41,59
4,8478407,Vince Dunn,D,SEA,28,82,14,45,59
4,8478493,Joel Eriksson Ek,C,MIN,27,82,28,30,58
4,8480797,Joel Farabee,L,PHI,24,82,26,32,58
4,8476448,William Karlsson,C,VGK,31,82,23,35,58
4,8474586,Jordan Eberle,R,SEA,34,82,23,35,58
4,8473986,Alex Killorn,L,ANA,35,82,23,35,58
4,8479339,Patrik Laine,L,CBJ,26,82,22,36,58
4,8478401,Pavel Zacha,C,BOS,27,82,21,37,58
4,8481711,Matias Maccelli,L,ARI,24,82,20,38,58
4,8478440,Dylan Strome,C,WSH,27,82,19,39,58
4,8477986,Brandon Montour,D,FLA,30,82,17,41,58
4,8476438,Brandon Saad,L,STL,32,82,35,22,57
4,8479675,Trevor Moore,L,LAK,29,82,27,30,57
4,8476875,Mike Matheson,D,MTL,30,82,11,46,57
4,8482159,Tyson Foerster,R,PHI,22,82,29,27,56
4,8480014,Gabriel Vilardi,C,WPG,25,82,29,27,56
4,8482097,Jack Quinn,R,BUF,23,82,22,34,56
4,8473422,Nick Foligno,L,CHI,37,82,21,35,56
4,8480028,Morgan Frost,C,PHI,25,82,18,38,56
4,8480434,Sean Durzi,D,ARI,26,82,13,43,56
4,8480018,Nick Suzuki,C,MTL,25,82,23,32,55
4,8479345,Jakob Chychrun,D,OTT,26,82,17,38,55
4,8476462,Dougie Hamilton,D,NJD,31,82,12,43,55
4,8476432,Boone Jenner,C,CBJ,31,82,32,22,54
4,8480188,Fabian Zetterlund,L,SJS,25,82,27,27,54
4,8475791,Taylor Hall,L,CHI,33,82,23,31,54
4,8477476,Artturi Lehkonen,L,COL,29,82,29,24,53
4,8471698,T.J. Oshie,R,WSH,38,82,26,27,53
4,8474679,Gustav Nyquist,C,NSH,35,82,22,31,53
4,8474053,Logan Couture,C,SJS,35,82,22,31,53
4,8482667,William Eklund,L,SJS,22,82,19,34,53
4,8477021,Alex Kerfoot,C,ARI,30,82,15,38,53
4,8479999,Casey Mittelstadt,C,COL,26,82,14,39,53
4,8480865,Noah Dobson,D,NYI,24,82,9,44,53
4,8479325,Charlie McAvoy,D,BOS,27,82,9,44,53
4,8482175,JJ Peterka,R,BUF,22,82,28,24,52
4,8483808,Andrei Kuzmenko,L,CGY,28,82,26,26,52
4,8479542,Brandon Hagel,L,TBL,26,82,23,29,52
4,8476881,Tomas Hertl,C,VGK,31,82,22,30,52
4,8475170,Brayden Schenn,C,STL,33,82,22,30,52
4,8475765,Vladimir Tarasenko,R,FLA,33,82,11,41,52
4,8478397,Rasmus Andersson,D,CGY,28,82,10,42,52
4,8476792,Torey Krug,D,STL,33,82,9,43,52
4,8481542,Moritz Seider,D,DET,23,82,6,46,52
4,8476399,Blake Coleman,C,CGY,33,82,32,19,51
4,8474641,Adam Henrique,C,EDM,34,82,22,29,51
4,8480078,Filip Chytil,C,NYR,25,82,22,29,51
4,8477456,J.T. Compher,L,DET,29,82,17,34,51
4,8475754,Brock Nelson,C,NYI,33,82,27,23,50
4,8478474,Lawson Crouse,L,ARI,27,82,21,29,50
4,8478519,Anthony Cirelli,C,TBL,27,82,18,32,50
4,8477932,Aaron Ekblad,D,FLA,28,82,12,38,50
4,8476880,Tom Wilson,R,WSH,30,82,34,15,49
4,8480064,Josh Norris,C,OTT,25,82,27,22,49
4,8474102,David Perron,L,DET,36,82,26,23,49
4,8479400,Pierre-Luc Dubois,L,LAK,26,82,24,25,49
4,8482745,Mason McTavish,C,ANA,21,82,24,25,49
4,8478366,Frank Vatrano,R,ANA,30,82,20,29,49
4,8474157,Max Pacioretty,L,WSH,36,82,20,29,49
4,8480113,Alex Iafallo,L,WPG,31,82,17,32,49
4,8476872,Scott Laughton,C,PHI,30,82,16,33,49
4,8474565,Alex Pietrangelo,D,VGK,34,82,13,36,49
4,8475151,Kyle Palmieri,C,NYI,33,82,26,22,48
4,8481596,Shane Pinto,C,OTT,24,82,23,25,48
4,8475768,Jaden Schwartz,C,SEA,32,82,20,28,48
4,8478046,Danton Heinen,L,BOS,29,82,19,29,48
4,8481581,Thomas Harley,D,DAL,23,82,19,29,48
4,8482146,Luke Evangelista,R,NSH,22,82,18,30,48
4,8475197,Tyson Barrie,D,NSH,33,82,18,30,48
4,8477498,Darnell Nurse,D,EDM,29,82,9,39,48
4,8477998,Warren Foegele,L,EDM,28,82,33,14,47
4,8477964,Ivan Barbashev,C,VGK,29,82,20,27,47
4,8482109,Alexis Lafrenière,L,NYR,23,82,20,27,47
4,8482113,Anton Lundell,C,FLA,23,82,19,28,47
4,8480798,Philipp Kurashev,C,CHI,25,82,19,28,47
4,8478472,Mathieu Joseph,R,OTT,27,82,15,32,47
4,8471724,Kris Letang,D,PIT,37,82,14,33,47
4,8474590,John Carlson,D,WSH,34,82,13,34,47
4,8476905,Chandler Stephenson,C,VGK,30,82,12,35,47
4,8478055,Gustav Forsling,D,FLA,28,82,11,36,47
4,8476869,Brady Skjei,D,CAR,30,82,7,40,47
4,8475799,Nino Niederreiter,R,WPG,32,82,27,19,46
4,8481535,Nils Hoglander,L,VAN,24,82,25,21,46
4,8479525,Ross Colton,C,COL,28,82,20,26,46
4,8478458,Jack Roslovic,C,NYR,27,82,18,28,46
4,8479425,Filip Hronek,D,VAN,27,82,14,32,46
4,8475753,Justin Faulk,D,STL,32,82,10,36,46
4,8475906,John Klingberg,D,TOR,32,82,13,32,45
4,8474149,Evgenii Dadonov,R,DAL,35,82,22,22,44
4,8478057,Dakota Joshua,C,VAN,28,82,21,23,44
4,8482055,Drew O'Connor,L,PIT,26,82,21,23,44
4,8475287,Erik Haula,L,NJD,33,82,18,26,44
4,8476461,Sean Couturier,C,PHI,32,82,14,30,44
4,8476329,Travis Boyd,C,ARI,31,82,12,32,44
4,8478469,Thomas Chabot,D,OTT,27,82,10,34,44
4,8476885,Jacob Trouba,D,NYR,30,82,10,34,44
4,8477495,Seth Jones,D,CHI,30,82,8,36,44
4,8476826,Yanni Gourde,C,SEA,33,82,19,24,43
4,8477451,Ryan Hartman,R,MIN,30,82,18,25,43
4,8478396,Noah Hanifin,D,VGK,27,82,14,29,43
4,8477444,Andre Burakovsky,L,SEA,29,82,14,29,43
4,8478233,Andrew Mangiapane,L,CGY,28,82,14,29,43
4,8474716,Jared Spurgeon,D,MIN,35,82,11,32,43
4,8477346,MacKenzie Weegar,D,CGY,30,82,5,38,43
4,8482720,Matthew Knies,L,TOR,22,82,22,20,42
4,8474884,Mike Hoffman,C,SJS,35,82,22,20,42
4,8475760,Nick Bjugstad,C,ARI,32,82,21,21,42
4,8480009,Eeli Tolvanen,R,SEA,25,82,19,23,42
4,8479415,Michael McLeod,C,NJD,26,82,19,23,42
4,8480220,Noah Cates,L,PHI,25,82,18,24,42
4,8481624,Ilya Mikheyev,R,VAN,30,82,16,26,42
4,8477479,Tyler Bertuzzi,L,TOR,29,82,14,28,42
4,8481656,Aliaksei Protas,C,WSH,23,82,11,31,42
4,8477948,Travis Sanheim,D,PHI,28,82,6,36,42
4,8483431,Logan Cooley,C,ARI,20,82,26,15,41
4,8477497,Sean Monahan,C,WPG,30,82,18,23,41
4,8481618,Alex Newhook,C,MTL,23,82,17,24,41
4,8475744,Evgeny Kuznetsov,C,CAR,32,82,17,24,41
4,8477426,Nicholas Paul,L,TBL,29,82,17,24,41
4,8477429,Andrew Copp,C,DET,30,82,16,25,41
4,8482475,Yegor Chinakhov,R,CBJ,23,82,15,26,41
4,8481186,Logan O'Connor,R,COL,28,82,22,18,40
4,8473449,Kyle Okposo,R,FLA,36,82,21,19,40
4,8476925,Colton Sissons,C,NSH,31,82,19,21,40
4,8470621,Corey Perry,R,EDM,39,82,19,21,40
4,8476458,Ryan Strome,C,ANA,31,82,13,27,40
4,8473563,Nicklas Backstrom,C,WSH,37,82,13,27,40
4,8479992,Michael Rasmussen,C,DET,25,82,11,29,40
4,8482671,Owen Power,D,BUF,22,82,10,30,40
4,8476854,Hampus Lindholm,D,BOS,30,82,10,30,40
4,8476958,Jaccob Slavin,D,CAR,30,82,6,34,40
4,8481560,Arthur Kaliyev,R,LAK,23,82,22,17,39
4,8471218,Blake Wheeler,R,NYR,38,82,17,22,39
4,8480145,Neal Pionk,D,WPG,29,82,6,33,39
4,8475764,Cam Fowler,D,ANA,33,82,4,35,39
4,8479390,Taylor Raddysh,R,CHI,26,82,19,19,38
4,8476927,Teddy Blueger,C,VAN,30,82,15,23,38
4,8482222,Alexander Barabanov,L,SJS,30,82,14,24,38
4,8477947,Sonny Milano,L,WSH,28,82,13,25,38
4,8478413,Jordan Greenway,L,BUF,27,82,12,26,38
4,8482105,Jake Sanderson,D,OTT,22,82,10,28,38
4,8480043,Timothy Liljegren,D,TOR,25,82,6,32,38
4,8480817,K'Andre Miller,D,NYR,24,82,6,32,38
4,8476892,Colton Parayko,D,STL,31,82,4,34,38
4,8482699,Dylan Guenther,R,ARI,21,82,18,19,37
4,8478115,Pierre Engvall,L,NYI,28,82,14,23,37
4,8482705,Cole Sillinger,C,CBJ,21,82,13,24,37
4,8476480,Vladislav Namestnikov,C,WPG,32,82,13,24,37
4,8484144,Connor Bedard,C,CHI,19,82,13,24,37
4,8476979,Erik Gustafsson,D,NYR,32,82,10,27,37
4,8476419,Jean-Gabriel Pageau,C,NYI,32,82,9,28,37
4,8480873,Rasmus Sandin,D,WSH,24,82,3,34,37
4,8480893,Kirill Marchenko,R,CBJ,24,82,25,11,36
4,8479996,Cody Glass,C,NSH,25,82,24,12,36
4,8475314,Anders Lee,L,NYI,34,82,19,17,36
4,8474189,Lars Eller,C,PIT,35,82,15,21,36
4,8479987,Morgan Geekie,C,BOS,26,82,13,23,36
4,8475763,Kevin Hayes,R,STL,32,82,13,23,36
4,8480871,Adam Boqvist,D,CBJ,24,82,13,23,36
4,8480459,Pius Suter,C,VAN,28,82,12,24,36
4,8475171,Oliver Ekman-Larsson,D,FLA,33,82,11,25,36
4,8475149,Marcus Johansson,L,MIN,34,82,11,25,36
4,8481703,Valtteri Puustinen,R,PIT,25,82,9,27,36
4,8474870,Tyler Johnson,C,CHI,34,82,19,16,35
4,8482089,Jake Neighbours,L,STL,22,82,17,18,35
4,8479977,Kailer Yamamoto,R,SEA,26,82,17,18,35
4,8478463,Anthony Beauvillier,L,NSH,27,82,16,19,35
4,8475848,Brendan Gallagher,R,MTL,32,82,16,19,35
4,8475722,Jason Zucker,L,NSH,32,82,15,20,35
4,8480802,Ryan McLeod,C,EDM,25,82,14,21,35
4,8481546,Cam York,D,PHI,23,82,13,22,35
4,8477953,Kasperi Kapanen,R,STL,28,82,13,22,35
4,8479346,Dillon Dube,C,CGY,26,82,13,22,35
4,8475793,Ryan Johansen,C,PHI,32,82,12,23,35
4,8478542,Evan Rodrigues,C,FLA,31,82,12,23,35
4,8479351,Sam Steel,C,DAL,26,82,12,23,35
4,8477919,Frederick Gaudreau,C,MIN,31,82,10,25,35
4,8476312,Josh Manson,D,COL,33,82,6,29,35
4,8477969,Marcus Pettersson,D,PIT,28,82,4,31,35
4,8479976,Juuso Valimaki,D,ARI,26,82,3,32,35
4,8470610,Zach Parise,L,COL,40,82,23,11,34
4,8482092,Ridly Greig,C,OTT,22,82,22,12,34
4,8475169,Evander Kane,L,EDM,33,82,20,14,34
4,8476278,Colin Blackwell,C,CHI,31,82,19,15,34
4,8477511,Anthony Mantha,R,VGK,30,82,18,16,34
4,8482079,Marco Rossi,C,MIN,23,82,17,17,34
4,8475220,Marcus Foligno,L,MIN,33,82,16,18,34
4,8474715,Cam Atkinson,R,PHI,35,82,14,20,34
4,8480855,Jack McBain,C,ARI,24,82,13,21,34
4,8476292,Ondrej Palat,L,NJD,33,82,13,21,34
4,8475231,Casey Cizikas,C,NYI,33,82,13,21,34
4,8482133,Thomas Bordeleau,C,SJS,22,82,12,22,34
4,8479398,Samuel Girard,D,COL,26,82,9,25,34
4,8476923,Damon Severson,D,CBJ,30,82,9,25,34
4,8475218,Mattias Ekholm,D,EDM,34,82,6,28,34
4,8482655,J.J. Moser,D,ARI,24,82,6,28,34
4,8478500,Ivan Provorov,D,CBJ,27,82,0,34,34
4,8478508,Yakov Trenin,C,COL,27,82,22,11,33
4,8480068,Ryan Poehling,C,PHI,25,82,13,20,33
4,8480806,Isac Lundestrom,C,ANA,25,82,13,20,33
4,8480185,Eetu Luostarinen,C,FLA,26,82,12,21,33
4,8478109,Victor Olofsson,L,BUF,29,82,11,22,33
4,8480074,Alexandre Texier,C,CBJ,25,82,11,22,33
4,8478911,Matt Roy,D,LAK,29,82,10,23,33
4,8478462,Nicolas Roy,C,VGK,27,82,9,24,33
4,8475462,Radko Gudas,D,ANA,34,82,4,29,33
4,8470604,Jeff Carter,C,PIT,39,82,17,15,32
4,8482110,Dawson Mercer,C,NJD,23,82,16,16,32
4,8480849,Barrett Hayton,C,ARI,24,82,16,16,32
4,8477952,Robby Fabbri,C,DET,28,82,15,17,32
4,8479591,Michael Eyssimont,C,TBL,28,82,12,20,32
4,8476897,Oskar Sundqvist,C,STL,30,82,12,20,32
4,8476960,Andreas Athanasiou,C,CHI,30,82,11,21,32
4,8476457,Adam Larsson,D,SEA,32,82,8,24,32
4,8476917,Adam Pelech,D,NYI,30,82,5,27,32
4,8474037,James van Riemsdyk,L,BOS,35,82,18,13,31
4,8481553,Bobby Brink,R,PHI,23,82,18,13,31
4,8479941,Justin Danforth,R,CBJ,31,82,16,15,31
4,8475714,Calle Jarnkrok,C,TOR,33,82,14,17,31
4,8476921,Jordan Martinook,L,CAR,32,82,14,17,31
4,8479293,Brandon Tanev,L,SEA,33,82,12,19,31
4,8479353,Brett Howden,C,VGK,26,82,12,19,31
4,8480336,Sean Walker,D,COL,30,82,12,19,31
4,8483515,Juraj Slafkovsky,L,MTL,20,82,10,21,31
4,8478133,Jake Evans,C,MTL,28,82,7,24,31
4,8473507,Jeff Petry,D,DET,37,82,6,25,31
4,8474574,Tyler Myers,D,VAN,34,82,4,27,31
4,8476469,Joel Armia,R,MTL,31,82,13,17,30
4,8481481,Blake Lizotte,C,LAK,27,82,13,17,30
4,8481606,Jordan Spence,D,LAK,23,82,9,21,30
4,8481522,Peyton Krebs,C,BUF,23,82,7,23,30
4,8476463,Jonas Brodin,D,MIN,31,82,6,24,30
4,8476931,Jake McCabe,D,TOR,31,82,5,25,30
4,8475181,Nick Leddy,D,STL,33,82,4,26,30
4,8476902,Esa Lindell,D,DAL,30,82,3,27,30
4,8478430,Oliver Kylington,D,CGY,27,82,3,27,30
4,8480281,Alexey Toropchenko,R,STL,25,82,22,7,29
4,8476981,Josh Anderson,R,MTL,30,82,19,10,29
4,8478891,Mason Appleton,C,WPG,28,82,15,14,29
4,8477330,Dominik Kubalik,L,OTT,29,82,14,15,29
4,8482125,Alexander Holtz,R,NJD,22,82,14,15,29
4,8477839,Conor Sheary,L,TBL,32,82,14,15,29
4,8476392,Adam Lowry,C,WPG,31,82,11,18,29
4,8476871,Tanner Pearson,L,MTL,32,82,11,18,29
4,8479514,Rem Pitlick,C,CHI,27,82,11,18,29
4,8479365,Trent Frederic,C,BOS,26,82,10,19,29
4,8480144,David Kampf,C,TOR,29,82,10,19,29
4,8470613,Brent Burns,D,CAR,39,82,4,25,29
4,8474673,TJ Brodie,D,TOR,34,82,4,25,29
4,8481580,Connor McMichael,C,WSH,23,82,15,13,28
4,8479316,Luke Kunin,C,SJS,27,82,13,15,28
4,8483763,Maksymilian Szuber,D,ARI,22,82,12,16,28
4,8481554,Kaapo Kakko,R,NYR,23,82,11,17,28
4,8475200,Dmitry Orlov,D,CAR,33,82,9,19,28
4,8477507,Nikita Zadorov,D,VAN,29,82,9,19,28
4,8481567,Henry Thrun,D,SJS,23,82,9,19,28
4,8480035,Henri Jokiharju,D,BUF,25,82,5,23,28
4,8476331,Dylan DeMelo,D,WPG,31,82,3,25,28
4,8474151,Ryan McDonagh,D,NSH,35,82,2,26,28
4,8477508,Curtis Lazar,C,NJD,29,82,16,11,27
4,8484153,Leo Carlsson,C,ANA,20,82,15,12,27
4,8478569,Noel Acciari,C,PIT,33,82,14,13,27
4,8482074,Connor Zary,C,CGY,23,82,13,14,27
4,8480821,Filip Zadina,R,SJS,25,82,13,14,27
4,8480073,Erik Brannstrom,D,OTT,25,82,9,18,27
4,8482111,Justin Barron,D,MTL,23,82,9,18,27
4,8477488,Brett Pesce,D,CAR,30,82,5,22,27
4,8481601,Simon Holmstrom,R,NYI,23,82,17,9,26
4,8477944,Jakub Vrana,L,STL,28,82,16,10,26
4,8480813,Joe Veleno,C,DET,24,82,16,10,26
4,8482259,Bobby McMann,C,TOR,28,82,16,10,26
4,8476624,Barclay Goodrow,C,NYR,31,82,14,12,26
4,8473533,Jordan Staal,C,CAR,36,82,13,13,26
4,8481517,Brett Leason,R,ANA,25,82,12,14,26
4,8477506,Ryan Pulock,D,NYI,30,82,9,17,26
4,8482122,Brock Faber,D,MIN,22,82,9,17,26
4,8482803,Olen Zellweger,D,ANA,21,82,8,18,26
4,8481013,Jonatan Berggren,R,DET,24,82,7,19,26
4,8482142,Jamie Drysdale,D,PHI,22,82,3,23,26
4,8478507,John Marino,D,NJD,27,82,3,23,26
4,8482245,Artem Zub,D,OTT,29,82,2,24,26
4,8479324,Ryan Lindgren,D,NYR,26,82,2,24,26
4,8478043,Sam Lafferty,C,VAN,29,82,16,9,25
4,8479661,Tanner Jeannot,L,TBL,27,82,15,10,25
4,8479393,Noah Gregor,C,TOR,26,82,14,11,25
4,8476374,Sean Kuraly,C,CBJ,31,82,13,12,25
4,8481477,Nico Sturm,C,SJS,29,82,13,12,25
4,8479423,Alex Nylander,L,CBJ,26,82,13,12,25
4,8477450,Jason Dickinson,C,CHI,29,82,12,13,25
4,8482624,Daniil Miromanov,D,CGY,27,82,7,18,25
4,8482807,Ethan Del Mastro,D,CHI,21,82,7,18,25
4,8482166,Shakir Mukhamadullin,D,SJS,22,82,6,19,25
4,8481524,Bowen Byram,D,BUF,23,82,6,19,25
4,8470966,Mark Giordano,D,TOR,41,82,3,22,25
4,8475324,Nick Jensen,D,WSH,34,82,3,22,25
4,8481014,Alexander Romanov,D,NYI,24,82,2,23,25
4,8479998,Mikey Anderson,D,LAK,25,82,0,25,25
4,8480448,Parker Kelly,L,OTT,25,82,14,10,24
4,8484145,Zach Benson,L,BUF,19,82,13,11,24
4,8483468,Jiri Kulich,C,BUF,20,82,12,12,24
4,8484203,Bradly Nadeau,L,CAR,19,82,10,14,24
4,8478020,Michael Amadio,C,VGK,28,82,10,14,24
4,8479383,Boris Katchouk,L,OTT,26,82,10,14,24
4,8483457,Lane Hutson,D,MTL,20,82,9,15,24
4,8481604,Pavel Dorofeyev,L,VGK,24,82,9,15,24
4,8477425,Miles Wood,L,COL,29,82,9,15,24
4,8476525,Colin Miller,D,WPG,32,82,6,18,24
4,8482858,Ryker Evans,D,SEA,23,82,5,19,24
4,8475790,Erik Gudbranson,D,CBJ,32,82,3,21,24
4,8476891,Matt Grzelcyk,D,BOS,30,82,2,22,24
4,8481704,Juuso Parssinen,C,NSH,23,82,12,11,23
4,8477406,Mattias Janmark,C,EDM,32,82,10,13,23
4,8483524,Shane Wright,C,SEA,20,82,10,13,23
4,8483495,Simon Nemec,D,NJD,20,82,9,14,23
4,8482117,Lukas Reichel,L,CHI,22,82,8,15,23
4,8477220,Nate Schmidt,D,WPG,33,82,8,15,23
4,8482062,Cole Smith,L,NSH,29,82,8,15,23
4,8482073,Braden Schneider,D,NYR,23,82,7,16,23
4,8482516,Matthew Kessel,D,STL,24,82,7,16,23
4,8476422,Mike Reilly,D,NYI,31,82,5,18,23
4,8476967,Brett Kulak,D,EDM,30,82,5,18,23
4,8480807,Mattias Samuelsson,D,BUF,24,82,4,19,23
4,8477435,Ryan Graves,D,PIT,29,82,4,19,23
4,8478882,Vladislav Gavrikov,D,LAK,29,82,4,19,23
4,8476879,Cody Ceci,D,EDM,31,82,3,20,23
4,8475690,Chris Tanev,D,DAL,35,82,1,22,23
4,8477353,Tyler Motte,C,TBL,29,82,12,10,22
4,8480995,Pontus Holmberg,R,TOR,25,82,11,11,22
4,8476878,Zemgus Girgensons,L,BUF,30,82,10,12,22
4,8475343,Nic Dowd,C,WSH,34,82,9,13,22
4,8481093,Rafael Harvey-Pinard,L,MTL,25,82,9,13,22
4,8481016,Ruslan Iskhakov,C,NYI,24,82,7,15,22
4,8483505,Matthew Poitras,C,BOS,20,82,6,16,22
4,8475164,Jakob Silfverberg,R,ANA,34,82,5,17,22
4,8478399,Jonas Siegenthaler,D,NJD,27,82,4,18,22
4,8477365,Connor Clifton,D,BUF,29,82,3,19,22
4,8480246,Nick Perbix,D,TBL,26,82,3,19,22
4,8475842,Sam Carrick,C,EDM,32,82,13,8,21
4,8479291,Kevin Rooney,C,CGY,31,82,12,9,21
4,8482679,Matt Coronato,R,CGY,22,82,11,10,21
4,8478831,Kevin Stenlund,C,FLA,28,82,11,10,21
4,8478451,Ethan Bear,D,WSH,27,82,7,14,21
4,8477015,Connor Brown,R,EDM,30,82,7,14,21
4,8477369,Carson Soucy,D,VAN,30,82,6,15,21
4,8475233,David Savard,D,MTL,34,82,5,16,21
4,8478178,Darren Raddysh,D,TBL,28,82,4,17,21
4,8476429,Scott Mayfield,D,NYI,32,82,3,18,21
4,8478859,Niko Mikkola,D,FLA,28,82,2,19,21
4,8475188,Brayden McNabb,D,VGK,33,82,2,19,21
4,8482155,Alex Laferriere,R,LAK,23,82,13,7,20
4,8476873,Mark Jankowski,C,NSH,30,82,10,10,20
4,8483397,Marc McLaughlin,C,BOS,25,82,9,11,20
4,8477989,Christian Dvorak,C,MTL,28,82,8,12,20
4,8476442,Matt Nieto,L,PIT,32,82,8,12,20
4,8482666,Scott Morrow,D,CAR,22,82,8,12,20
4,8482730,Brandt Clarke,D,LAK,21,82,7,13,20
4,8475179,Dmitry Kulikov,D,FLA,34,82,4,16,20
4,8475279,Ben Chiarot,D,DET,33,82,3,17,20
4,8479369,Andrew Peeke,D,BOS,26,82,3,17,20
4,8474013,Ian Cole,D,VAN,35,82,3,17,20
4,8483565,Nick Blankenburg,D,CBJ,26,82,2,18,20
4,8480172,Jan Rutta,D,SJS,34,82,1,19,20
4,8477931,Tomas Nosek,L,NJD,32,82,9,10,19
4,8482118,Sam Colangelo,R,ANA,23,82,9,10,19
4,8473504,Cal Clutterbuck,R,NYI,37,82,8,11,19
4,8476858,Phillip Di Giuseppe,L,VAN,31,82,7,12,19
4,8481537,Nikita Okhotiuk,D,CGY,24,82,7,12,19
4,8483493,Frank Nazar,C,CHI,20,82,6,13,19
4,8475762,Derek Forbort,D,BOS,32,82,5,14,19
4,8475208,Brian Dumoulin,D,SEA,33,82,4,15,19
4,8477845,Trevor van Riemsdyk,D,WSH,33,82,2,17,19
4,8480860,Kevin Bahl,D,NJD,24,82,2,17,19
4,8481568,Alex Vlasic,D,CHI,23,82,1,18,19
4,8473453,Trevor Lewis,C,LAK,37,82,11,7,18
4,8474009,Nick Bonino,C,NYR,36,82,10,8,18
4,8484166,Adam Fantilli,C,CBJ,20,82,8,10,18
4,8483445,Cutter Gauthier,L,ANA,20,82,8,10,18
4,8479359,Beck Malenstyn,L,WSH,26,82,7,11,18
4,8481578,Graeme Clarke,R,NJD,23,82,7,11,18
4,8483499,Liam Ohgren,L,MIN,20,82,6,12,18
4,8476915,Jujhar Khaira,L,MIN,30,82,6,12,18
4,8476473,Connor Murphy,D,CHI,31,82,6,12,18
4,8476372,Nick Seeler,D,PHI,31,82,5,13,18
4,8479980,Nicolas Hague,D,VGK,26,82,5,13,18
4,8479371,Dante Fabbro,D,NSH,26,82,4,14,18
4,8478851,Alexandre Carrier,D,NSH,28,82,2,16,18
4,8477392,Hudson Fasching,R,NYI,29,82,9,8,17
4,8482712,Oskar Olausson,R,COL,22,82,9,8,17
4,8477505,Alexander Wennberg,C,NYR,30,82,8,9,17
4,8478013,Jake Walman,D,DET,28,82,7,10,17
4,8477499,Rasmus Ristolainen,D,PHI,30,82,7,10,17
4,8478136,Jake Middleton,D,MIN,28,82,5,12,17
4,8483490,Pavel Mintyukov,D,ANA,21,82,5,12,17
4,8478416,Erik Cernak,D,TBL,27,82,5,12,17
4,8480796,Martin Fehervary,D,WSH,25,82,3,14,17
4,8481059,Scott Perunovich,D,STL,26,82,2,15,17
4,8481028,Martin Pospisil,C,CGY,25,82,10,6,16
4,8482702,Logan Stankoven,C,DAL,21,82,8,8,16
4,8479983,Mario Ferraro,D,SJS,26,82,5,11,16
4,8482101,Danil Gushchin,L,SJS,22,82,3,13,16
4,8470600,Ryan Suter,D,DAL,39,82,2,14,16
4,8481178,Egor Zamula,D,PHI,24,82,1,15,16
4,8480879,Jacob Bernard-Docker,D,OTT,24,82,1,15,16
4,8474034,Pat Maroon,L,BOS,36,82,9,6,15
4,8482809,Jackson Blake,R,CAR,21,82,8,7,15
4,8482737,Zack Bolduc,C,STL,21,82,6,9,15
4,8483482,Tristan Luneau,D,ANA,20,82,5,10,15
4,8482733,Logan Mailloux,D,MTL,31,82,4,11,15
4,8476467,Jamie Oleksiak,D,SEA,32,82,4,11,15
4,8480834,Ty Emberson,D,SJS,24,82,4,11,15
4,8474166,Alec Martinez,D,VGK,37,82,3,12,15
4,8475455,Brenden Dillon,D,WPG,34,82,3,12,15
4,8480058,Pierre-Olivier Joseph,D,PIT,25,82,0,15,15
4,8481699,Aku Raty,R,ARI,23,82,7,7,14
4,8482145,Mavrik Bourque,C,DAL,22,82,6,8,14
4,8478468,Jeremy Lauzon,D,NSH,27,82,2,12,14
4,8475825,Jani Hakanpää,D,DAL,32,82,2,12,14
4,8481030,Jack St. Ivany,D,PIT,25,82,2,12,14
4,8476822,Luke Glendening,C,TBL,35,82,9,4,13
4,8484911,Collin Graf,R,SJS,22,82,7,6,13
4,8478443,Brandon Carlo,D,BOS,28,82,3,10,13
4,8483471,Brad Lambert,C,WPG,31,82,3,10,13
4,8482087,Kaiden Guhle,D,MTL,22,82,2,11,13
4,8482470,Ilya Solovyov,D,CGY,24,82,4,8,12
4,8484149,Gavin Brindley,C,CBJ,20,82,3,9,12
4,8480031,Maxime Comtois,L,CAR,25,82,6,5,11
4,8483012,Logan Morrison,C,SEA,22,82,5,6,11
4,8479442,Troy Stecher,D,EDM,30,82,4,7,11
4,8481605,Jackson LaCombe,D,ANA,23,82,4,7,11
4,8478408,Travis Dermott,D,ARI,28,82,3,8,11
4,8471677,Jack Johnson,D,COL,37,82,3,8,11
4,8482859,Zack Ostapchuk,C,OTT,21,82,5,5,10
4,8482713,Mackie Samoskevich,R,FLA,22,82,4,6,10
4,8478840,Will Borgen,D,SEA,28,82,2,8,10
4,8483489,Fraser Minten,C,TOR,31,82,6,3,9
4,8480990,Declan Chisholm,D,MIN,24,82,5,4,9
4,8482762,Simon Edvinsson,D,DET,21,82,2,7,9
4,8481599,Victor Soderstrom,D,ARI,23,82,2,7,9
4,8477335,Kyle Burroughs,D,SJS,29,82,0,9,9
4,8482177,Marat Khusnutdinov,C,MIN,22,82,4,4,8
4,8483491,Ivan Miroshnichenko,L,WSH,20,82,3,5,8
4,8474567,Zach Bogosian,D,MIN,34,82,2,6,8
4,8477034,Jaycob Megna,D,CHI,32,82,2,6,8
4,8475177,Calvin de Haan,D,TBL,33,82,0,6,6
4,8483466,Kevin Korchinski,D,CHI,20,82,0,4,4
4,8477950,Tony DeAngelo,D,CAR,29,0,0,0,0
4,8481577,Philip Tomasino,C,NSH,23,0,0,0,0
4,8482660,Kent Johnson,C,CBJ,22,0,0,0,0
4,8481019,David Gustafsson,C,WPG,24,0,0,0,0
4,8479348,Kale Clague,D,BUF,26,0,0,0,0
4,8482149,Cole Perfetti,C,WPG,22,0,0,0,0
4,8476952,Dominic Toninato,C,WPG,30,0,0,0,0
4,8473473,Milan Lucic,L,BOS,36,0,0,0,0
4,8480829,Jesperi Kotkaniemi,C,CAR,24,0,0,0,0
4,8474602,Justin Schultz,D,SEA,34,0,0,0,0
4,8480049,Dylan Samberg,D,WPG,25,0,0,0,0
4,8479372,Josh Mahura,D,FLA,26,0,0,0,0
4,8480878,Nils Lundkvist,D,DAL,24,0,0,0,0
4,8479982,Conor Timmins,D,TOR,26,0,0,0,0
4,8474031,Kevin Shattenkirk,D,BOS,35,0,0,0,0
4,8480835,Jack Drury,C,CAR,24,0,0,0,0
4,8480008,Adam Ruzicka,C,ARI,25,0,0,0,0
4,8479402,Jake Bean,D,CBJ,26,0,0,0,0
4,8476474,Stefan Noesen,R,CAR,31,0,0,0,0
4,8480884,Calen Addison,D,SJS,24,0,0,0,0
4,8476994,Vinnie Hinostroza,C,PIT,30,0,0,0,0
4,8477987,Ryan Donato,C,CHI,28,0,0,0,0
4,8481582,Nicholas Robertson,L,TOR,23,0,0,0,0
4,8478452,Caleb Jones,D,COL,27,0,0,0,0
4,8480157,Calle Rosen,D,STL,30,0,0,0,0
4,8481609,Vladislav Kolyachonok,D,ARI,23,0,0,0,0
4,8476919,Chris Tierney,C,NJD,30,0,0,0,0
4,8479639,Dylan Coghlan,D,CAR,26,0,0,0,0
4,8475193,Tomas Tatar,L,SEA,34,0,0,0,0
4,8480748,Kiefer Sherwood,L,NSH,29,0,0,0,0
4,8478146,Matthew Highmore,C,OTT,28,0,0,0,0
4,8478970,Jalen Chatfield,D,CAR,28,0,0,0,0
4,8480205,Emil Bemstrom,C,PIT,25,0,0,0,0
4,8471274,Alex Goligoski,D,MIN,39,0,0,0,0
4,8478104,Sammy Blais,L,STL,28,0,0,0,0
4,8476913,Devin Shore,C,SEA,30,0,0,0,0
4,8481708,Zac Jones,D,NYR,24,0,0,0,0
4,8480222,Sebastian Aho,D,NYI,28,0,0,0,0
4,8481598,Philip Broberg,D,EDM,23,0,0,0,0
4,8480789,Oliver Wahlstrom,R,NYI,24,0,0,0,0
4,8480891,Michael Kesselring,D,ARI,24,0,0,0,0
4,8477979,Nicolas Aube-Kubel,R,WSH,28,0,0,0,0
4,8476393,Nick Cousins,C,FLA,31,0,0,0,0
4,8480003,Jesper Boqvist,C,BOS,26,0,0,0,0
4,8479543,Michael Pezzetta,L,MTL,26,0,0,0,0
4,8475855,Jesper Fast,R,CAR,33,0,0,0,0
4,8477018,Ben Hutton,D,VGK,31,0,0,0,0
4,8480762,Eric Robinson,L,BUF,29,0,0,0,0
4,8481058,Jesse Ylönen,R,MTL,25,0,0,0,0
4,8481527,Kaedan Korczak,D,VGK,23,0,0,0,0
4,8482192,Isaak Phillips,D,CHI,23,0,0,0,0
4,8480727,Zach Whitecloud,D,VGK,28,0,0,0,0
4,8480001,Urho Vaakanainen,D,ANA,25,0,0,0,0
4,8480853,Liam Foudy,C,NSH,24,0,0,0,0
4,8475225,Craig Smith,C,DAL,35,0,0,0,0
4,8479972,Mason Shaw,C,MIN,26,0,0,0,0
4,8474040,Sam Gagner,C,EDM,35,0,0,0,0
4,8480196,Jacob Bryson,D,BUF,27,0,0,0,0
4,8475718,Justin Holl,D,DET,32,0,0,0,0
4,8479984,Cal Foote,D,NJD,26,0,0,0,0
4,8480011,Klim Kostin,C,SJS,25,0,0,0,0
4,8482176,Wyatt Kaiser,D,CHI,22,0,0,0,0
4,8476918,Jimmy Vesey,L,NYR,31,0,0,0,0
4,8476988,Matt Benning,D,SJS,30,0,0,0,0
4,8479370,Tyson Jost,C,BUF,26,0,0,0,0
4,8477464,Nic Petan,C,MIN,29,0,0,0,0
4,8477380,Jonny Brodzinski,C,NYR,31,0,0,0,0
4,8480070,Ian Mitchell,D,BOS,25,0,0,0,0
4,8479315,Joey Anderson,R,CHI,26,0,0,0,0
4,8478099,Kevin Labanc,R,SJS,29,0,0,0,0
4,8476874,Olli Maatta,D,DET,30,0,0,0,0
4,8479414,Nathan Bastian,R,NJD,27,0,0,0,0
4,8478434,Keegan Kolesar,R,VGK,27,0,0,0,0
4,8479536,Axel Jonsson-Fjallby,L,WPG,26,0,0,0,0
4,8479671,Mathieu Olivier,R,CBJ,27,0,0,0,0
4,8471709,Marc-Edouard Vlasic,D,SJS,37,0,0,0,0
4,8479328,Julien Gauthier,R,NYI,27,0,0,0,0
4,8478421,A.J. Greer,L,CGY,28,0,0,0,0
4,8477573,Nathan Walker,L,STL,30,0,0,0,0
4,8477478,William Carrier,L,VGK,30,0,0,0,0
4,8479344,Jesse Puljujarvi,R,PIT,26,0,0,0,0
4,8480887,Jordan Harris,D,MTL,24,0,0,0,0
4,8478502,Dennis Gilbert,D,CGY,28,0,0,0,0
4,8480355,Mark Kastelic,C,OTT,25,0,0,0,0
4,8475750,Jon Merrill,D,MIN,32,0,0,0,0
4,8476889,Radek Faksa,C,DAL,30,0,0,0,0
4,8478432,Christian Fischer,R,DET,27,0,0,0,0
4,8479439,Jacob MacDonald,D,SJS,31,0,0,0,0
4,8474568,Luke Schenn,D,NSH,35,0,0,0,0
4,8478454,Noah Juulsen,D,VAN,27,0,0,0,0
4,8475752,Tyler Pitlick,C,NYR,33,0,0,0,0
4,8482148,Hendrix Lapierre,C,WSH,22,0,0,0,0
4,8481167,Brayden Pachal,D,CGY,25,0,0,0,0
4,8478211,Dryden Hunt,L,CGY,29,0,0,0,0
4,8479321,Lucas Johansen,D,WSH,27,0,0,0,0
4,8480950,Ilya Lyubushkin,D,TOR,30,0,0,0,0
4,8479368,Max Jones,L,ANA,26,0,0,0,0
4,8471699,Andrew Cogliano,C,COL,37,0,0,0,0
4,8481521,Ronnie Attard,D,PHI,25,0,0,0,0
4,8481161,Jake Christiansen,D,CBJ,25,0,0,0,0
4,8479458,Nikita Zaitsev,D,CHI,33,0,0,0,0
4,8479619,Michael Carcone,L,ARI,28,0,0,0,0
4,8479026,Philippe Myers,D,TBL,27,0,0,0,0
4,8481617,Vasily Podkolzin,R,VAN,23,0,0,0,0
4,8481701,Santeri Hatakka,D,NJD,23,0,0,0,0
4,8477446,Michael McCarron,R,NSH,29,0,0,0,0
4,8483460,David Jiricek,D,CBJ,21,0,0,0,0
4,8474090,Brendan Smith,D,NJD,35,0,0,0,0
4,8482241,Radim Zohorna,L,PIT,28,0,0,0,0
4,8481032,Paul Cotter,C,VGK,25,0,0,0,0
4,8480289,Morgan Barron,C,WPG,26,0,0,0,0
4,8479379,Givani Smith,R,SJS,26,0,0,0,0
4,8480216,Jacob Peterson,C,SJS,25,0,0,0,0
4,8477851,Jordan Oesterle,D,CGY,32,0,0,0,0
4,8484258,Sam Malinski,D,COL,26,0,0,0,0
4,8478904,Steven Lorentz,C,FLA,28,0,0,0,0
4,8482095,Tyler Kleven,D,OTT,22,0,0,0,0
4,8480980,Connor Dewar,C,TOR,25,0,0,0,0
4,8480848,Ty Dellandrea,C,DAL,24,0,0,0,0
4,8476884,Derrick Pouliot,D,DAL,30,0,0,0,0
4,8480025,MacKenzie Entwistle,R,CHI,25,0,0,0,0
4,8474612,Travis Hamonic,D,OTT,34,0,0,0,0
4,8479336,Carl Grundstrom,R,LAK,27,0,0,0,0
4,8482964,Arber Xhekaj,D,MTL,23,0,0,0,0
4,8471686,Marc Staal,D,PHI,37,0,0,0,0
4,8477887,Patrick Brown,C,BOS,32,0,0,0,0
4,8478495,Denis Gurianov,R,PHI,27,0,0,0,0
4,8481550,Adam Beckman,L,MIN,23,0,0,0,0
4,8480845,Rasmus Kupari,C,WPG,24,0,0,0,0
4,8478585,Derek Ryan,C,EDM,38,0,0,0,0
4,8482141,Lukas Cormier,D,VGK,22,0,0,0,0
4,8477962,Brendan Lemieux,L,CAR,28,0,0,0,0
4,8482861,Vincent Iorio,D,WSH,22,0,0,0,0
4,8479378,Logan Stanley,D,WPG,26,0,0,0,0
4,8473446,Erik Johnson,D,PHI,36,0,0,0,0
4,8481743,Marc Del Gaizo,D,NSH,25,0,0,0,0
4,8478450,Parker Wotherspoon,D,BOS,27,0,0,0,0
4,8477384,Josh Brown,D,ARI,30,0,0,0,0
4,8482165,Yan Kuznetsov,D,CGY,22,0,0,0,0
4,8478424,Jansen Harkins,C,PIT,27,0,0,0,0
4,8482144,Jack Thompson,D,SJS,22,0,0,0,0
4,8479576,Vincent Desharnais,D,EDM,28,0,0,0,0
4,8478512,Austin Czarnik,C,DET,32,0,0,0,0
4,8477527,Ross Johnston,L,ANA,30,0,0,0,0
4,8482094,Daemon Hunt,D,MIN,22,0,0,0,0
4,8481719,Maxwell Crozier,D,TBL,24,0,0,0,0
4,8480192,Johnathan Kovacevic,D,MTL,27,0,0,0,0
4,8479376,Victor Mete,D,PHI,26,0,0,0,0
4,8482511,Mason Lohrei,D,BOS,23,0,0,0,0
4,8478021,William Lagesson,D,ANA,28,0,0,0,0
4,8475795,Dylan McIlrath,D,WSH,32,0,0,0,0
4,8477846,Ryan Carpenter,C,SJS,33,0,0,0,0
4,8481056,Spencer Stastney,D,NSH,24,0,0,0,0
4,8481564,Ryan Johnson,D,BUF,23,0,0,0,0
4,8478017,Mark Friedman,D,VAN,29,0,0,0,0
4,8479320,Max Lajoie,D,TOR,27,0,0,0,0
4,8480075,Cameron Crotty,D,ARI,25,0,0,0,0
4,8484287,Cole McWard,D,VAN,23,0,0,0,0
4,8484254,Akito Hirose,D,VAN,25,0,0,0,0
4,8483407,Brandon Scanlin,D,NYR,25,0,0,0,0
4,8480274,Philip Kemp,D,EDM,25,0,0,0,0
4,8479522,Hardy Haman Aktell,D,WSH,26,0,0,0,0
4,8480007,Jonas Rondbjerg,R,VGK,25,0,0,0,0
4,8477454,Adam Erne,L,EDM,29,0,0,0,0
4,8481679,Maxence Guenette,D,OTT,23,0,0,0,0
4,8477938,Haydn Fleury,D,TBL,28,0,0,0,0
4,8476441,Joel Edmundson,D,TOR,31,0,0,0,0
4,8477903,Garnet Hathaway,R,PHI,33,0,0,0,0
4,8480441,Trey Fix-Wolansky,R,CBJ,25,0,0,0,0
4,8483546,Marshall Rifai,D,TOR,26,0,0,0,0
4,8480084,Nick DeSimone,D,NJD,30,0,0,0,0
4,8481592,Jakob Pelletier,L,CGY,23,0,0,0,0
4,8478011,Louie Belpedio,D,PHI,28,0,0,0,0
4,8477930,Pierre-Edouard Bellemare,L,SEA,39,0,0,0,0
4,8484321,Nikolas Matinpalo,D,OTT,26,0,0,0,0
4,8482067,Connor Mackey,D,NYR,28,0,0,0,0
4,8481806,Louis Crevier,D,CHI,23,0,0,0,0
4,8484326,Patrik Koch,D,ARI,28,0,0,0,0
4,8477971,Andreas Englund,D,LAK,28,0,0,0,0
4,8481751,Lukas Rousek,R,BUF,25,0,0,0,0
4,8481006,Tyler Tucker,D,STL,24,0,0,0,0
4,8481641,Joel Kiviranta,L,COL,28,0,0,0,0
4,8476867,Brendan Gaunce,C,CBJ,30,0,0,0,0
4,8479520,Brandon Duhaime,R,COL,27,0,0,0,0
4,8477073,Kurtis MacDermid,L,NJD,30,0,0,0,0
4,8480874,Adam Ginning,D,PHI,24,0,0,0,0
4,8477473,Justin Bailey,R,SJS,29,0,0,0,0
4,8479066,Ryan Lomberg,L,FLA,30,0,0,0,0
4,8477070,Liam O'Brien,C,ARI,30,0,0,0,0
4,8474618,Marco Scandella,D,STL,34,0,0,0,0
4,8475797,Jarred Tinordi,D,CHI,32,0,0,0,0
4,8481441,Joe Snively,C,WSH,28,0,0,0,0
4,8477244,Chad Ruhwedel,D,NYR,34,0,0,0,0
4,8482077,Dylan Holloway,L,EDM,23,0,0,0,0
4,8479772,Zack MacEwen,R,OTT,28,0,0,0,0
4,8481147,Reese Johnson,C,CHI,26,0,0,0,0
4,8481043,Cole Koepke,L,TBL,26,0,0,0,0
4,8483619,Filip Roos,D,CHI,25,0,0,0,0
4,8481541,Samuel Bolduc,D,NYI,24,0,0,0,0
4,8477810,Joel Hanley,D,CGY,33,0,0,0,0
4,8476907,Mackenzie MacEachern,L,STL,30,0,0,0,0
4,8482652,Walker Duehr,R,CGY,27,0,0,0,0
4,8477126,Jayson Megna,C,BOS,34,0,0,0,0
4,8483398,Declan Carlile,D,TBL,31,0,0,0,0
4,8482929,Emil Lilleberg,D,TBL,23,0,0,0,0
4,8480880,Jakub Lauko,C,BOS,24,0,0,0,0
4,8478874,Adam Gaudette,C,STL,28,0,0,0,0
4,8480245,Olle Lycksell,R,PHI,25,0,0,0,0
4,8480252,Cole Guttman,C,CHI,25,0,0,0,0
4,8477467,Gustav Olofsson,D,SEA,30,0,0,0,0
4,8479968,Vinni Lettieri,C,MIN,29,0,0,0,0
4,8478400,Colin White,C,MTL,27,0,0,0,0
4,8475755,Alexander Petrovic,D,DAL,32,0,0,0,0
4,8481812,Nikolai Knyzhov,D,SJS,27,0,0,0,0
4,8481593,Jayden Struble,D,MTL,23,0,0,0,0
4,8481532,Alex Turcotte,C,LAK,23,0,0,0,0
4,8482126,Emil Andrae,D,PHI,31,0,0,0,0
4,8479944,Zach Aston-Reese,C,DET,30,0,0,0,0
4,8471817,Ryan Reaves,R,TOR,37,0,0,0,0
4,8481206,John Ludvig,D,PIT,24,0,0,0,0
4,8480292,Carson Meyer,R,CBJ,27,0,0,0,0
4,8482496,Nils Aman,C,VAN,24,0,0,0,0
4,8479718,Alex Barré-Boulet,C,TBL,27,0,0,0,0
4,8479994,Jaret Anderson-Dolan,C,NSH,25,0,0,0,0
4,8480184,Gustav Lindstrom,D,ANA,26,0,0,0,0
4,8480890,Jan Jenik,R,ARI,24,0,0,0,0
4,8478067,Oskar Lindblom,L,SJS,28,0,0,0,0
4,8476934,Brock McGinn,L,ANA,30,0,0,0,0
4,8479985,Cale Fleury,D,SEA,26,0,0,0,0
4,8482153,Brendan Brisson,C,VGK,23,0,0,0,0
4,8480021,Jack Studnicka,C,SJS,25,0,0,0,0
4,8484304,Uvis Balinskis,D,FLA,28,0,0,0,0
4,8479981,Jonah Gadjovich,L,FLA,26,0,0,0,0
4,8481716,Dmitri Voronkov,L,CBJ,24,0,0,0,0
4,8482659,Josh Doan,R,ARI,22,0,0,0,0
4,8481122,Simon Benoit,D,TOR,26,0,0,0,0
4,8474709,Matt Martin,L,NYI,35,0,0,0,0
4,8482634,Alex Steeves,C,TOR,25,0,0,0,0
4,8480823,Alexander Alexeyev,D,WSH,25,0,0,0,0
4,8477541,Dakota Mermis,D,MIN,30,0,0,0,0
4,8478477,Mitchell Stephens,C,MTL,27,0,0,0,0
4,8481543,Nikita Alexandrov,C,STL,24,0,0,0,0
4,8482451,Mikael Pyyhtia,L,CBJ,23,0,0,0,0
4,8480306,Grant Hutton,D,NYI,29,0,0,0,0
4,8478028,Fredrik Olofsson,L,COL,28,0,0,0,0
4,8477462,Robert Hagg,D,ANA,29,0,0,0,0
4,8477320,Anton Blidh,L,NYR,29,0,0,0,0
4,8482749,Joshua Roy,R,MTL,21,0,0,0,0
4,8482157,Will Cuylle,L,NYR,22,0,0,0,0
4,8481239,Samuel Fagemo,L,LAK,24,0,0,0,0
4,8481600,Tobias Bjornfot,D,FLA,23,0,0,0,0
4,8478409,Anthony Richard,C,BOS,28,0,0,0,0
4,8474145,Robert Bortuzzo,D,NYI,35,0,0,0,0
4,8475958,Michael Sgarbossa,C,WSH,32,0,0,0,0
4,8479986,Kole Lind,R,SEA,26,0,0,0,0
4,8479249,Andrew Poturalski,C,SEA,30,0,0,0,0
4,8479362,Riley Tufte,L,COL,26,0,0,0,0
4,8479991,Jake Leschyshyn,C,NYR,25,0,0,0,0
4,8479587,Rhett Gardner,C,PHI,28,0,0,0,0
4,8482744,James Malatesta,L,CBJ,21,0,0,0,0
4,8478854,Ryan Shea,D,PIT,27,0,0,0,0
4,8481591,Sam Poulin,R,PIT,23,0,0,0,0
4,8483512,Matt Savoie,C,BUF,20,0,0,0,0
4,8482102,Vasily Ponomarev,C,CAR,22,0,0,0,0
4,8482162,Roby Jarventie,L,OTT,22,0,0,0,0
4,8482172,Landon Slaggert,L,CHI,22,0,0,0,0
4,8482747,Brennan Othmann,L,NYR,21,0,0,0,0
4,8480226,Marián Studenic,R,SEA,26,0,0,0,0
4,8481518,Nolan Foote,L,NJD,24,0,0,0,0
4,8479419,Brett Murray,L,BUF,26,0,0,0,0
4,8482088,Justin Sourdif,R,FLA,22,0,0,0,0
4,8482201,Gage Goncalves,C,TBL,23,0,0,0,0
4,8481754,Nikita Nesterenko,C,ANA,23,0,0,0,0
4,8483531,Brian Halonen,L,NJD,25,0,0,0,0
4,8483920,Pierrick Dube,R,WSH,23,0,0,0,0
4,8480851,Akil Thomas,C,LAK,24,0,0,0,0
4,8475235,Nicolas Deslauriers,L,PHI,33,0,0,0,0
4,8482476,Emil Heineman,L,MTL,23,0,0,0,0
4,8477149,Scott Sabourin,R,SJS,32,0,0,0,0
4,8483549,Lucas Condotta,L,MTL,27,0,0,0,0
4,8483567,Georgii Merkulov,C,BOS,24,0,0,0,0
4,8482765,Isak Rosen,R,BUF,21,0,0,0,0
4,8481237,Kyle MacLean,C,NYI,25,0,0,0,0
4,8481024,Linus Karlsson,C,VAN,25,0,0,0,0
4,8481690,Tyler Angle,C,CBJ,24,0,0,0,0
4,8483570,Ben Meyers,C,ANA,26,0,0,0,0
4,8481655,Cole Schwindt,R,CGY,23,0,0,0,0
4,8481462,Mason Morelli,L,VGK,28,0,0,0,0
4,8483401,Marc Johnstone,R,PIT,28,0,0,0,0
4,8478956,Samuel Laberge,L,NJD,27,0,0,0,0
4,8479533,Joona Koppanen,L,PIT,26,0,0,0,0
4,8482197,Adam Raska,R,MIN,23,0,0,0,0
4,8482250,Callahan Burke,C,CAR,27,0,0,0,0
4,8482784,Zach Dean,C,STL,21,0,0,0,0
4,8484255,Jason Polin,R,COL,25,0,0,0,0
4,8481077,John Leonard,L,ARI,26,0,0,0,0
4,8481534,Raphael Lavoie,C,EDM,24,0,0,0,0
4,8483609,Adam Klapka,R,CGY,24,0,0,0,0
4,8482751,Ryan Winterton,C,SEA,21,0,0,0,0
4,8480267,Sammy Walker,C,MIN,25,0,0,0,0
4,8475766,Austin Watson,L,TBL,32,0,0,0,0
4,8482460,Matt Rempe,C,NYR,22,0,0,0,0
4,8482787,Nikita Chibrikov,R,WPG,31,0,0,0,0
4,8481065,Angus Crookshank,L,OTT,25,0,0,0,0
4,8481070,Hugh McGing,L,STL,26,0,0,0,0
4,8476323,Max McCormick,L,SEA,32,0,0,0,0
4,8483395,Arshdeep Bains,L,VAN,23,0,0,0,0
4,8484259,Ondrej Pavel,C,COL,31,0,0,0,0
4,8483432,Luca Del Bel Belluz,C,CBJ,31,0,0,0,0
4,8483045,Cameron Butler,R,CBJ,31,0,0,0,0
4,8482061,Brandon Biro,L,BUF,26,0,0,0,0
4,8477401,John Hayden,C,SEA,29,0,0,0,0
4,8475278,Byron Froese,C,VGK,33,0,0,0,0
4,8478446,Glenn Gawdin,C,ANA,27,0,0,0,0
4,8477993,Justin Kirkland,C,ARI,28,0,0,0,0
4,8482147,Jean-Luc Foudy,C,COL,22,0,0,0,0
4,8480032,Shane Bowers,C,NJD,25,0,0,0,0
4,8479330,Brandon Gignac,C,MTL,27,0,0,0,0
4,8480776,Sheldon Rempal,R,VGK,29,0,0,0,0
4,8475413,Justin Dowling,C,NJD,34,0,0,0,0
4,8481726,Adam Edstrom,C,NYR,24,0,0,0,0
4,8479638,Justin Brazeau,R,BOS,26,0,0,0,0
4,8480844,Grigori Denisenko,L,VGK,24,0,0,0,0
4,8474062,Riley Nash,C,NYR,35,0,0,0,0
4,8478147,Bokondji Imama,L,OTT,28,0,0,0,0
4,8478881,Brett Seney,L,CHI,28,0,0,0,0
4,8483630,Pavol Regenda,L,ANA,25,0,0,0,0
4,8480836,Jonathan Gruden,C,PIT,24,0,0,0,0
4,8484314,Jiri Smejkal,L,OTT,28,0,0,0,0
4,8475780,Chris Wagner,R,COL,33,0,0,0,0
4,8482070,Mitchell Chaffee,R,TBL,26,0,0,0,0
4,8479546,Oskar Steen,C,BOS,26,0,0,0,0
4,8483597,Milos Kelemen,L,ARI,25,0,0,0,0
4,8481789,Tye Kartye,L,SEA,23,0,0,0,0
4,8484325,Waltteri Merela,C,TBL,26,0,0,0,0
4,8479421,Jacob Moverare,D,LAK,26,0,0,0,0
4,8481585,Egor Afanasyev,L,NSH,23,0,0,0,0
4,8479547,Matthew Phillips,R,WSH,26,0,0,0,0
4,8479367,William Lockwood,R,FLA,26,0,0,0,0
4,8481422,Jacob Lucchini,C,MIN,29,0,0,0,0
4,8480468,James Hamblin,L,EDM,25,0,0,0,0
4,8480870,Bo Groulx,C,ANA,24,0,0,0,0
4,8478051,Max Willman,C,NJD,29,0,0,0,0
4,8481556,John Beecher,C,BOS,23,0,0,0,0
4,8478078,Rourke Chartier,C,OTT,28,0,0,0,0
5,8478402,Connor McDavid,C,EDM,27,82,54,115,169
5,8476453,Nikita Kucherov,R,TBL,31,82,42,92,134
5,8477492,Nathan MacKinnon,C,COL,29,82,47,74,121
5,8481559,Jack Hughes,C,NJD,23,82,46,74,120
5,8479318,Auston Matthews,C,TOR,27,82,62,56,118
5,8479343,Clayton Keller,R,ARI,26,82,48,65,113
5,8478550,Artemi Panarin,L,NYR,33,82,33,80,113
5,8476887,Filip Forsberg,L,NSH,30,82,47,64,111
5,8477956,David Pastrnak,R,BOS,28,82,57,53,110
5,8477934,Leon Draisaitl,C,EDM,29,82,39,71,110
5,8478864,Kirill Kaprizov,L,MIN,27,82,55,54,109
5,8480069,Cale Makar,D,COL,26,82,31,77,108
5,8476468,J.T. Miller,C,VAN,31,82,37,69,106
5,8477939,William Nylander,R,TOR,28,82,48,56,104
5,8478420,Mikko Rantanen,R,COL,28,82,49,53,102
5,8480012,Elias Pettersson,C,VAN,26,82,34,67,101
5,8479314,Matthew Tkachuk,L,FLA,27,82,31,68,99
5,8480023,Robert Thomas,C,STL,25,82,31,68,99
5,8471675,Sidney Crosby,C,PIT,37,82,40,58,98
5,8482116,Tim Stützle,C,OTT,22,82,30,67,97
5,8480027,Jason Robertson,L,DAL,25,82,39,57,96
5,8480801,Brady Tkachuk,L,OTT,25,82,48,47,95
5,8478403,Jack Eichel,C,VGK,28,82,43,52,95
5,8477946,Dylan Larkin,C,DET,28,82,48,46,94
5,8477942,Kevin Fiala,L,LAK,28,82,30,62,92
5,8480208,Drake Batherson,R,OTT,26,82,28,64,92
5,8477940,Nikolaj Ehlers,L,WPG,28,82,29,62,91
5,8478398,Kyle Connor,L,WPG,28,82,44,46,90
5,8480002,Nico Hischier,C,NJD,25,82,32,58,90
5,8478427,Sebastian Aho,C,CAR,27,82,36,53,89
5,8474141,Patrick Kane,R,DET,36,82,34,55,89
5,8479323,Adam Fox,D,NYR,26,82,20,67,87
5,8478010,Brayden Point,C,TBL,28,82,50,36,86
5,8477933,Sam Reinhart,C,FLA,29,82,38,48,86
5,8478042,Viktor Arvidsson,R,LAK,31,82,35,51,86
5,8481557,Matt Boldy,L,MIN,23,82,29,57,86
5,8474600,Roman Josi,D,NSH,34,82,25,61,86
5,8478445,Mathew Barzal,C,NYI,27,82,19,67,86
5,8479407,Jesper Bratt,L,NJD,26,82,31,54,85
5,8471214,Alex Ovechkin,L,WSH,39,82,47,37,84
5,8478439,Travis Konecny,R,PHI,27,82,32,52,84
5,8481523,Kirby Dach,C,MTL,23,82,13,71,84
5,8477960,Adrian Kempe,R,LAK,28,82,36,47,83
5,8475172,Nazem Kadri,C,CGY,34,82,27,56,83
5,8476454,Ryan Nugent-Hopkins,C,EDM,31,82,27,56,83
5,8475786,Zach Hyman,L,EDM,32,82,47,35,82
5,8477404,Jake Guentzel,C,CAR,30,82,42,40,82
5,8477409,Carter Verhaeghe,C,FLA,29,82,41,41,82
5,8477447,Shea Theodore,D,VGK,29,82,11,71,82
5,8476346,Johnny Gaudreau,L,CBJ,31,82,20,61,81
5,8477493,Aleksander Barkov,C,FLA,29,82,19,62,81
5,8478493,Joel Eriksson Ek,C,MIN,27,82,43,37,80
5,8470794,Joe Pavelski,C,DAL,40,82,36,43,79
5,8477402,Pavel Buchnevich,L,STL,29,82,32,47,79
5,8475692,Mats Zuccarello,R,MIN,37,82,13,66,79
5,8477501,Valeri Nichushkin,R,COL,29,82,34,44,78
5,8476881,Tomas Hertl,C,VGK,31,82,33,45,78
5,8474564,Steven Stamkos,C,TBL,34,82,31,47,78
5,8475168,Matt Duchene,C,DAL,33,82,26,52,78
5,8475166,John Tavares,C,TOR,34,82,36,41,77
5,8474578,Erik Karlsson,D,PIT,34,82,23,54,77
5,8474590,John Carlson,D,WSH,34,82,18,59,77
5,8475913,Mark Stone,R,VGK,32,82,26,50,76
5,8477951,Nick Schmaltz,C,ARI,28,82,25,51,76
5,8479420,Tage Thompson,C,BUF,27,82,35,40,75
5,8471215,Evgeni Malkin,C,PIT,38,82,30,45,75
5,8480800,Quinn Hughes,D,VAN,25,82,12,63,75
5,8478414,Timo Meier,R,NJD,28,82,37,37,74
5,8478047,Michael Bunting,L,PIT,29,82,32,42,74
5,8475810,Bryan Rust,R,PIT,32,82,31,43,74
5,8476459,Mika Zibanejad,C,NYR,31,82,26,48,74
5,8477949,Alex Tuch,R,BUF,28,82,26,48,74
5,8476389,Vincent Trocheck,C,NYR,31,82,42,31,73
5,8479385,Jordan Kyrou,C,STL,26,82,35,38,73
5,8482078,Lucas Raymond,L,DET,22,82,23,49,72
5,8477500,Bo Horvat,C,NYI,29,82,40,31,71
5,8479339,Patrik Laine,L,CBJ,26,82,35,36,71
5,8478449,Roope Hintz,C,DAL,28,82,34,37,71
5,8479542,Brandon Hagel,L,TBL,26,82,33,38,71
5,8478407,Vince Dunn,D,SEA,28,82,21,50,71
5,8475167,Victor Hedman,D,TBL,34,82,13,58,71
5,8476875,Mike Matheson,D,MTL,30,82,14,56,70
5,8478460,Zach Werenski,D,CBJ,27,82,10,60,70
5,8475158,Ryan O'Reilly,C,NSH,33,82,27,42,69
5,8473994,Jamie Benn,L,DAL,35,82,25,44,69
5,8479325,Charlie McAvoy,D,BOS,27,82,12,57,69
5,8475184,Chris Kreider,L,NYR,33,82,41,27,68
5,8476539,Jonathan Marchessault,R,VGK,34,82,41,27,68
5,8477456,J.T. Compher,L,DET,29,82,26,42,68
5,8480830,Andrei Svechnikov,R,CAR,24,82,25,43,68
5,8473512,Claude Giroux,R,OTT,36,82,22,46,68
5,8477416,Oliver Bjorkstrand,R,SEA,29,82,22,46,68
5,8478401,Pavel Zacha,C,BOS,27,82,21,47,68
5,8474679,Gustav Nyquist,C,NSH,35,82,20,48,68
5,8477955,Jared McCann,L,SEA,28,82,36,31,67
5,8473419,Brad Marchand,L,BOS,36,82,22,45,67
5,8480865,Noah Dobson,D,NYI,24,82,16,51,67
5,8480039,Martin Necas,C,CAR,25,82,28,38,66
5,8473986,Alex Killorn,L,ANA,35,82,26,40,66
5,8479337,Alex DeBrincat,R,DET,27,82,22,44,66
5,8478440,Dylan Strome,C,WSH,27,82,22,44,66
5,8478444,Brock Boeser,R,VAN,27,82,32,33,65
5,8475798,Mikael Granlund,C,SJS,32,82,20,45,65
5,8480803,Evan Bouchard,D,EDM,25,82,13,52,65
5,8476432,Boone Jenner,C,CBJ,31,82,40,24,64
5,8477497,Sean Monahan,C,WPG,30,82,23,41,64
5,8477346,MacKenzie Weegar,D,CGY,30,82,16,48,64
5,8476460,Mark Scheifele,C,WPG,31,82,26,37,63
5,8480018,Nick Suzuki,C,MTL,25,82,25,38,63
5,8481596,Shane Pinto,C,OTT,24,82,23,40,63
5,8479345,Jakob Chychrun,D,OTT,26,82,22,41,63
5,8476456,Jonathan Huberdeau,C,CGY,31,82,18,45,63
5,8476792,Torey Krug,D,STL,33,82,17,46,63
5,8482124,Quinton Byfield,R,LAK,22,82,16,47,63
5,8477504,Josh Morrissey,D,WPG,29,82,16,47,63
5,8480839,Rasmus Dahlin,D,BUF,24,82,15,48,63
5,8480036,Miro Heiskanen,D,DAL,25,82,11,52,63
5,8476853,Morgan Rielly,D,TOR,30,82,11,51,62
5,8482684,Luke Hughes,D,NJD,21,82,10,52,62
5,8475169,Evander Kane,L,EDM,33,82,36,25,61
5,8479675,Trevor Moore,L,LAK,29,82,35,26,61
5,8481540,Cole Caufield,R,MTL,23,82,32,29,61
5,8476483,Rickard Rakell,R,PIT,31,82,29,32,61
5,8475170,Brayden Schenn,C,STL,33,82,24,37,61
5,8482699,Dylan Guenther,R,ARI,21,82,24,37,61
5,8475745,Charlie Coyle,C,BOS,32,82,23,38,61
5,8481533,Trevor Zegras,C,ANA,23,82,19,42,61
5,8471724,Kris Letang,D,PIT,37,82,10,51,61
5,8480014,Gabriel Vilardi,C,WPG,25,82,35,25,60
5,8482740,Wyatt Johnston,C,DAL,21,82,31,29,60
5,8478366,Frank Vatrano,R,ANA,30,82,31,29,60
5,8479400,Pierre-Luc Dubois,L,LAK,26,82,28,32,60
5,8475784,Jeff Skinner,C,BUF,32,82,24,36,60
5,8478873,Troy Terry,R,ANA,27,82,22,38,60
5,8475754,Brock Nelson,C,NYI,33,82,30,29,59
5,8477496,Elias Lindholm,C,VAN,30,82,26,33,59
5,8478438,Tommy Novak,C,NSH,27,82,24,35,59
5,8475753,Justin Faulk,D,STL,32,82,12,47,59
5,8478397,Rasmus Andersson,D,CGY,28,82,10,49,59
5,8482665,Matty Beniers,C,SEA,22,82,27,31,58
5,8477444,Andre Burakovsky,L,SEA,29,82,27,31,58
5,8477479,Tyler Bertuzzi,L,TOR,29,82,27,31,58
5,8480028,Morgan Frost,C,PHI,25,82,22,36,58
5,8475906,John Klingberg,D,TOR,32,82,14,44,58
5,8480064,Josh Norris,C,OTT,25,82,32,25,57
5,8480015,Owen Tippett,R,PHI,25,82,26,31,57
5,8477407,Anthony Duclair,L,TBL,29,82,22,35,57
5,8476906,Shayne Gostisbehere,D,DET,31,82,17,40,57
5,8476462,Dougie Hamilton,D,NJD,31,82,17,40,57
5,8481711,Matias Maccelli,L,ARI,24,82,13,44,57
5,8476905,Chandler Stephenson,C,VGK,30,82,13,44,57
5,8475287,Erik Haula,L,NJD,33,82,32,24,56
5,8478458,Jack Roslovic,C,NYR,27,82,17,39,56
5,8475791,Taylor Hall,L,CHI,33,82,28,27,55
5,8471698,T.J. Oshie,R,WSH,38,82,27,28,55
5,8480797,Joel Farabee,L,PHI,24,82,26,29,55
5,8482097,Jack Quinn,R,BUF,23,82,25,30,55
5,8478975,Mason Marchment,L,DAL,29,82,24,31,55
5,8477986,Brandon Montour,D,FLA,30,82,20,34,54
5,8482667,William Eklund,L,SJS,22,82,20,34,54
5,8476479,Phillip Danault,C,LAK,31,82,19,35,54
5,8482159,Tyson Foerster,R,PHI,22,82,26,27,53
5,8482175,JJ Peterka,R,BUF,22,82,25,28,53
5,8474563,Drew Doughty,D,LAK,35,82,13,40,53
5,8479999,Casey Mittelstadt,C,COL,26,82,13,40,53
5,8471685,Anze Kopitar,C,LAK,37,82,12,41,53
5,8478469,Thomas Chabot,D,OTT,27,82,11,42,53
5,8481542,Moritz Seider,D,DET,23,82,6,47,53
5,8475794,Tyler Seguin,C,DAL,32,82,21,31,52
5,8482222,Alexander Barabanov,L,SJS,30,82,19,33,52
5,8477021,Alex Kerfoot,C,ARI,30,82,17,35,52
5,8478396,Noah Hanifin,D,VGK,27,82,16,36,52
5,8478046,Danton Heinen,L,BOS,29,82,33,18,51
5,8476880,Tom Wilson,R,WSH,30,82,26,25,51
5,8474641,Adam Henrique,C,EDM,34,82,24,27,51
5,8475726,Tyler Toffoli,C,WPG,32,82,22,29,51
5,8474586,Jordan Eberle,R,SEA,34,82,20,31,51
5,8482475,Yegor Chinakhov,R,CBJ,23,82,20,31,51
5,8474150,Mikael Backlund,C,CGY,35,82,17,34,51
5,8475197,Tyson Barrie,D,NSH,33,82,12,39,51
5,8477935,Sam Bennett,C,FLA,28,82,29,21,50
5,8482745,Mason McTavish,C,ANA,21,82,20,30,50
5,8482113,Anton Lundell,C,FLA,23,82,20,30,50
5,8480188,Fabian Zetterlund,L,SJS,25,82,17,33,50
5,8478498,Jake DeBrusk,L,BOS,28,82,16,34,50
5,8477495,Seth Jones,D,CHI,30,82,14,36,50
5,8478038,Devon Toews,D,COL,30,82,11,39,50
5,8478856,Conor Garland,R,VAN,28,82,19,30,49
5,8474716,Jared Spurgeon,D,MIN,35,82,18,31,49
5,8478462,Nicolas Roy,C,VGK,27,82,18,31,49
5,8480798,Philipp Kurashev,C,CHI,25,82,15,34,49
5,8475218,Mattias Ekholm,D,EDM,34,82,14,35,49
5,8476923,Damon Severson,D,CBJ,30,82,10,39,49
5,8479410,Mikhail Sergachev,D,TBL,26,82,9,40,49
5,8480893,Kirill Marchenko,R,CBJ,24,82,34,14,48
5,8477426,Nicholas Paul,L,TBL,29,82,23,25,48
5,8476448,William Karlsson,C,VGK,31,82,22,26,48
5,8476438,Brandon Saad,L,STL,32,82,22,26,48
5,8475191,Reilly Smith,R,PIT,33,82,21,27,48
5,8482110,Dawson Mercer,C,NJD,23,82,20,28,48
5,8478472,Mathieu Joseph,R,OTT,27,82,18,30,48
5,8474102,David Perron,L,DET,36,82,16,32,48
5,8477451,Ryan Hartman,R,MIN,30,82,14,34,48
5,8475151,Kyle Palmieri,C,NYI,33,82,30,17,47
5,8479365,Trent Frederic,C,BOS,26,82,27,20,47
5,8481068,Yegor Sharangovich,C,CGY,26,82,26,21,47
5,8475765,Vladimir Tarasenko,R,FLA,33,82,25,22,47
5,8475722,Jason Zucker,L,NSH,32,82,25,22,47
5,8475799,Nino Niederreiter,R,WPG,32,82,24,23,47
5,8477429,Andrew Copp,C,DET,30,82,17,30,47
5,8481528,Dylan Cozens,C,BUF,23,82,16,31,47
5,8476329,Travis Boyd,C,ARI,31,82,16,31,47
5,8475768,Jaden Schwartz,C,SEA,32,82,12,35,47
5,8475744,Evgeny Kuznetsov,C,CAR,32,82,7,40,47
5,8477476,Artturi Lehkonen,L,COL,29,82,31,15,46
5,8482720,Matthew Knies,L,TOR,22,82,20,26,46
5,8480185,Eetu Luostarinen,C,FLA,26,82,20,26,46
5,8481618,Alex Newhook,C,MTL,23,82,19,27,46
5,8475763,Kevin Hayes,R,STL,32,82,19,27,46
5,8475714,Calle Jarnkrok,C,TOR,33,82,18,28,46
5,8473563,Nicklas Backstrom,C,WSH,37,82,15,31,46
5,8477503,Max Domi,C,TOR,29,82,13,33,46
5,8479425,Filip Hronek,D,VAN,27,82,13,33,46
5,8480434,Sean Durzi,D,ARI,26,82,11,35,46
5,8477969,Marcus Pettersson,D,PIT,28,82,4,42,46
5,8480043,Timothy Liljegren,D,TOR,25,82,3,43,46
5,8482093,Seth Jarvis,C,CAR,22,82,24,21,45
5,8478233,Andrew Mangiapane,L,CGY,28,82,24,21,45
5,8478057,Dakota Joshua,C,VAN,28,82,22,23,45
5,8474053,Logan Couture,C,SJS,35,82,21,24,45
5,8477998,Warren Foegele,L,EDM,28,82,19,26,45
5,8482705,Cole Sillinger,C,CBJ,21,82,18,27,45
5,8480871,Adam Boqvist,D,CBJ,24,82,15,30,45
5,8475314,Anders Lee,L,NYI,34,82,29,15,44
5,8480113,Alex Iafallo,L,WPG,31,82,23,21,44
5,8474037,James van Riemsdyk,L,BOS,35,82,23,21,44
5,8482109,Alexis Lafrenière,L,NYR,23,82,21,23,44
5,8482079,Marco Rossi,C,MIN,23,82,21,23,44
5,8480849,Barrett Hayton,C,ARI,24,82,21,23,44
5,8474157,Max Pacioretty,L,WSH,36,82,18,26,44
5,8478463,Anthony Beauvillier,L,NSH,27,82,16,28,44
5,8477494,Jonathan Drouin,L,COL,29,82,14,30,44
5,8476458,Ryan Strome,C,ANA,31,82,14,30,44
5,8476854,Hampus Lindholm,D,BOS,30,82,9,35,44
5,8475848,Brendan Gallagher,R,MTL,32,82,23,20,43
5,8476882,Teuvo Teravainen,L,CAR,30,82,20,23,43
5,8482092,Ridly Greig,C,OTT,22,82,20,23,43
5,8476925,Colton Sissons,C,NSH,31,82,18,25,43
5,8480009,Eeli Tolvanen,R,SEA,25,82,17,26,43
5,8471218,Blake Wheeler,R,NYR,38,82,14,29,43
5,8477964,Ivan Barbashev,C,VGK,29,82,13,30,43
5,8476292,Ondrej Palat,L,NJD,33,82,13,30,43
5,8479415,Michael McLeod,C,NJD,26,82,20,22,42
5,8482146,Luke Evangelista,R,NSH,22,82,19,23,42
5,8479941,Justin Danforth,R,CBJ,31,82,19,23,42
5,8483515,Juraj Slafkovsky,L,MTL,20,82,19,23,42
5,8478474,Lawson Crouse,L,ARI,27,82,15,27,42
5,8474565,Alex Pietrangelo,D,VGK,34,82,11,31,42
5,8477498,Darnell Nurse,D,EDM,29,82,7,35,42
5,8481560,Arthur Kaliyev,R,LAK,23,82,26,15,41
5,8479525,Ross Colton,C,COL,28,82,24,17,41
5,8481604,Pavel Dorofeyev,L,VGK,24,82,24,17,41
5,8478109,Victor Olofsson,L,BUF,29,82,20,21,41
5,8473533,Jordan Staal,C,CAR,36,82,19,22,41
5,8473507,Jeff Petry,D,DET,37,82,8,33,41
5,8480145,Neal Pionk,D,WPG,29,82,5,36,41
5,8475149,Marcus Johansson,L,MIN,34,82,24,16,40
5,8479353,Brett Howden,C,VGK,26,82,19,21,40
5,8477989,Christian Dvorak,C,MTL,28,82,18,22,40
5,8478055,Gustav Forsling,D,FLA,28,82,7,33,40
5,8482055,Drew O'Connor,L,PIT,26,82,22,17,39
5,8473422,Nick Foligno,L,CHI,37,82,21,18,39
5,8481535,Nils Hoglander,L,VAN,24,82,21,18,39
5,8480802,Ryan McLeod,C,EDM,25,82,21,18,39
5,8478133,Jake Evans,C,MTL,28,82,17,22,39
5,8479996,Cody Glass,C,NSH,25,82,16,23,39
5,8474149,Evgenii Dadonov,R,DAL,35,82,15,24,39
5,8482133,Thomas Bordeleau,C,SJS,22,82,14,25,39
5,8480074,Alexandre Texier,C,CBJ,25,82,14,25,39
5,8480078,Filip Chytil,C,NYR,25,82,13,26,39
5,8479987,Morgan Geekie,C,BOS,26,82,13,26,39
5,8476960,Andreas Athanasiou,C,CHI,30,82,12,27,39
5,8476826,Yanni Gourde,C,SEA,33,82,11,28,39
5,8476419,Jean-Gabriel Pageau,C,NYI,32,82,10,29,39
5,8482089,Jake Neighbours,L,STL,22,82,24,14,38
5,8477330,Dominik Kubalik,L,OTT,29,82,24,14,38
5,8475760,Nick Bjugstad,C,ARI,32,82,19,19,38
5,8479992,Michael Rasmussen,C,DET,25,82,19,19,38
5,8475793,Ryan Johansen,C,PHI,32,82,19,19,38
5,8481656,Aliaksei Protas,C,WSH,23,82,14,24,38
5,8482105,Jake Sanderson,D,OTT,22,82,10,28,38
5,8480817,K'Andre Miller,D,NYR,24,82,10,28,38
5,8476399,Blake Coleman,C,CGY,33,82,27,10,37
5,8477952,Robby Fabbri,C,DET,28,82,19,18,37
5,8483808,Andrei Kuzmenko,L,CGY,28,82,11,26,37
5,8476461,Sean Couturier,C,PHI,32,82,10,27,37
5,8476885,Jacob Trouba,D,NYR,30,82,9,28,37
5,8483457,Lane Hutson,D,MTL,20,82,9,28,37
5,8476958,Jaccob Slavin,D,CAR,30,82,8,29,37
5,8482671,Owen Power,D,BUF,22,82,7,30,37
5,8480873,Rasmus Sandin,D,WSH,24,82,3,34,37
5,8481580,Connor McMichael,C,WSH,23,82,20,16,36
5,8478466,Daniel Sprong,R,DET,27,82,19,17,36
5,8477953,Kasperi Kapanen,R,STL,28,82,18,18,36
5,8470621,Corey Perry,R,EDM,39,82,17,19,36
5,8479393,Noah Gregor,C,TOR,26,82,17,19,36
5,8478519,Anthony Cirelli,C,TBL,27,82,16,20,36
5,8477947,Sonny Milano,L,WSH,28,82,16,20,36
5,8476927,Teddy Blueger,C,VAN,30,82,8,28,36
5,8477392,Hudson Fasching,R,NYI,29,82,20,15,35
5,8478569,Noel Acciari,C,PIT,33,82,18,17,35
5,8476873,Mark Jankowski,C,NSH,30,82,14,21,35
5,8477511,Anthony Mantha,R,VGK,30,82,13,22,35
5,8482117,Lukas Reichel,L,CHI,22,82,13,22,35
5,8477948,Travis Sanheim,D,PHI,28,82,11,24,35
5,8480220,Noah Cates,L,PHI,25,82,9,26,35
5,8477488,Brett Pesce,D,CAR,30,82,9,26,35
5,8476869,Brady Skjei,D,CAR,30,82,8,27,35
5,8481703,Valtteri Puustinen,R,PIT,25,82,8,27,35
5,8476979,Erik Gustafsson,D,NYR,32,82,7,28,35
5,8482122,Brock Faber,D,MIN,22,82,7,28,35
5,8476463,Jonas Brodin,D,MIN,31,82,6,29,35
5,8480459,Pius Suter,C,VAN,28,82,19,15,34
5,8481093,Rafael Harvey-Pinard,L,MTL,25,82,15,19,34
5,8480068,Ryan Poehling,C,PHI,25,82,14,20,34
5,8476897,Oskar Sundqvist,C,STL,30,82,14,20,34
5,8478013,Jake Walman,D,DET,28,82,14,20,34
5,8478542,Evan Rodrigues,C,FLA,31,82,13,21,34
5,8484166,Adam Fantilli,C,CBJ,20,82,13,21,34
5,8476871,Tanner Pearson,L,MTL,32,82,12,22,34
5,8484144,Connor Bedard,C,CHI,19,82,11,23,34
5,8475764,Cam Fowler,D,ANA,33,82,6,28,34
5,8481581,Thomas Harley,D,DAL,23,82,3,31,34
5,8479398,Samuel Girard,D,COL,26,82,0,34,34
5,8479977,Kailer Yamamoto,R,SEA,26,82,22,11,33
5,8478020,Michael Amadio,C,VGK,28,82,21,12,33
5,8481704,Juuso Parssinen,C,NSH,23,82,20,13,33
5,8481186,Logan O'Connor,R,COL,28,82,17,16,33
5,8482259,Bobby McMann,C,TOR,28,82,17,16,33
5,8481553,Bobby Brink,R,PHI,23,82,15,18,33
5,8481477,Nico Sturm,C,SJS,29,82,15,18,33
5,8476392,Adam Lowry,C,WPG,31,82,11,22,33
5,8476891,Matt Grzelcyk,D,BOS,30,82,10,23,33
5,8475181,Nick Leddy,D,STL,33,82,6,27,33
5,8477506,Ryan Pulock,D,NYI,30,82,3,30,33
5,8476278,Colin Blackwell,C,CHI,31,82,17,15,32
5,8470604,Jeff Carter,C,PIT,39,82,16,16,32
5,8480144,David Kampf,C,TOR,29,82,14,18,32
5,8474715,Cam Atkinson,R,PHI,35,82,10,22,32
5,8470613,Brent Burns,D,CAR,39,82,6,26,32
5,8477435,Ryan Graves,D,PIT,29,82,4,28,32
5,8479661,Tanner Jeannot,L,TBL,27,82,19,12,31
5,8478508,Yakov Trenin,C,COL,27,82,17,14,31
5,8479514,Rem Pitlick,C,CHI,27,82,16,15,31
5,8474884,Mike Hoffman,C,SJS,35,82,14,17,31
5,8476921,Jordan Martinook,L,CAR,32,82,12,19,31
5,8478891,Mason Appleton,C,WPG,28,82,12,19,31
5,8482111,Justin Barron,D,MTL,23,82,12,19,31
5,8474574,Tyler Myers,D,VAN,34,82,9,22,31
5,8475171,Oliver Ekman-Larsson,D,FLA,33,82,6,25,31
5,8478500,Ivan Provorov,D,CBJ,27,82,4,27,31
5,8477932,Aaron Ekblad,D,FLA,28,82,3,28,31
5,8482125,Alexander Holtz,R,NJD,22,82,18,12,30
5,8481554,Kaapo Kakko,R,NYR,23,82,17,13,30
5,8481624,Ilya Mikheyev,R,VAN,30,82,16,14,30
5,8482062,Cole Smith,L,NSH,29,82,14,16,30
5,8481546,Cam York,D,PHI,23,82,12,18,30
5,8470610,Zach Parise,L,COL,40,82,12,18,30
5,8478115,Pierre Engvall,L,NYI,28,82,10,20,30
5,8475220,Marcus Foligno,L,MIN,33,82,9,21,30
5,8482624,Daniil Miromanov,D,CGY,27,82,9,21,30
5,8480073,Erik Brannstrom,D,OTT,25,82,5,25,30
5,8478399,Jonas Siegenthaler,D,NJD,27,82,5,25,30
5,8479976,Juuso Valimaki,D,ARI,26,82,4,26,30
5,8476931,Jake McCabe,D,TOR,31,82,3,27,30
5,8474870,Tyler Johnson,C,CHI,34,82,14,15,29
5,8481601,Simon Holmstrom,R,NYI,23,82,14,15,29
5,8480821,Filip Zadina,R,SJS,25,82,13,16,29
5,8477353,Tyler Motte,C,TBL,29,82,13,16,29
5,8479316,Luke Kunin,C,SJS,27,82,12,17,29
5,8477015,Connor Brown,R,EDM,30,82,11,18,29
5,8476872,Scott Laughton,C,PHI,30,82,10,19,29
5,8479591,Michael Eyssimont,C,TBL,28,82,9,20,29
5,8477450,Jason Dickinson,C,CHI,29,82,9,20,29
5,8478882,Vladislav Gavrikov,D,LAK,29,82,9,20,29
5,8481481,Blake Lizotte,C,LAK,27,82,7,22,29
5,8476624,Barclay Goodrow,C,NYR,31,82,7,22,29
5,8476525,Colin Miller,D,WPG,32,82,5,24,29
5,8482073,Braden Schneider,D,NYR,23,82,5,24,29
5,8474151,Ryan McDonagh,D,NSH,35,82,2,27,29
5,8476469,Joel Armia,R,MTL,31,82,19,9,28
5,8475164,Jakob Silfverberg,R,ANA,34,82,14,14,28
5,8480813,Joe Veleno,C,DET,24,82,11,17,28
5,8477425,Miles Wood,L,COL,29,82,11,17,28
5,8473449,Kyle Okposo,R,FLA,36,82,10,18,28
5,8480336,Sean Walker,D,COL,30,82,7,21,28
5,8480807,Mattias Samuelsson,D,BUF,24,82,7,21,28
5,8482655,J.J. Moser,D,ARI,24,82,6,22,28
5,8475790,Erik Gudbranson,D,CBJ,32,82,6,22,28
5,8476374,Sean Kuraly,C,CBJ,31,82,15,12,27
5,8478043,Sam Lafferty,C,VAN,29,82,14,13,27
5,8478413,Jordan Greenway,L,BUF,27,82,13,14,27
5,8480855,Jack McBain,C,ARI,24,82,13,14,27
5,8477944,Jakub Vrana,L,STL,28,82,11,16,27
5,8480995,Pontus Holmberg,R,TOR,25,82,11,16,27
5,8470600,Ryan Suter,D,DAL,39,82,6,21,27
5,8481522,Peyton Krebs,C,BUF,23,82,5,22,27
5,8476902,Esa Lindell,D,DAL,30,82,5,22,27
5,8477839,Conor Sheary,L,TBL,32,82,5,22,27
5,8476892,Colton Parayko,D,STL,31,82,4,23,27
5,8476331,Dylan DeMelo,D,WPG,31,82,3,24,27
5,8476981,Josh Anderson,R,MTL,30,82,16,10,26
5,8483431,Logan Cooley,C,ARI,20,82,15,11,26
5,8482155,Alex Laferriere,R,LAK,23,82,15,11,26
5,8474189,Lars Eller,C,PIT,35,82,12,14,26
5,8480806,Isac Lundestrom,C,ANA,25,82,11,15,26
5,8482679,Matt Coronato,R,CGY,22,82,11,15,26
5,8477919,Frederick Gaudreau,C,MIN,31,82,8,18,26
5,8479983,Mario Ferraro,D,SJS,26,82,6,20,26
5,8476879,Cody Ceci,D,EDM,31,82,5,21,26
5,8478507,John Marino,D,NJD,27,82,3,23,26
5,8474673,TJ Brodie,D,TOR,34,82,2,24,26
5,8482074,Connor Zary,C,CGY,23,82,11,14,25
5,8480448,Parker Kelly,L,OTT,25,82,8,17,25
5,8478911,Matt Roy,D,LAK,29,82,7,18,25
5,8484153,Leo Carlsson,C,ANA,20,82,7,18,25
5,8475343,Nic Dowd,C,WSH,34,82,7,18,25
5,8483490,Pavel Mintyukov,D,ANA,21,82,7,18,25
5,8479998,Mikey Anderson,D,LAK,25,82,6,19,25
5,8481606,Jordan Spence,D,LAK,23,82,5,20,25
5,8475179,Dmitry Kulikov,D,FLA,34,82,5,20,25
5,8476967,Brett Kulak,D,EDM,30,82,4,21,25
5,8474034,Pat Maroon,L,BOS,36,82,4,21,25
5,8479293,Brandon Tanev,L,SEA,33,82,13,11,24
5,8479423,Alex Nylander,L,CBJ,26,82,11,13,24
5,8476480,Vladislav Namestnikov,C,WPG,32,82,10,14,24
5,8479351,Sam Steel,C,DAL,26,82,10,14,24
5,8478468,Jeremy Lauzon,D,NSH,27,82,9,15,24
5,8475279,Ben Chiarot,D,DET,33,82,7,17,24
5,8479359,Beck Malenstyn,L,WSH,26,82,7,17,24
5,8477507,Nikita Zadorov,D,VAN,29,82,6,18,24
5,8477931,Tomas Nosek,L,NJD,32,82,6,18,24
5,8478851,Alexandre Carrier,D,NSH,28,82,6,18,24
5,8482087,Kaiden Guhle,D,MTL,22,82,6,18,24
5,8476467,Jamie Oleksiak,D,SEA,32,82,5,19,24
5,8477034,Jaycob Megna,D,CHI,32,82,5,19,24
5,8475188,Brayden McNabb,D,VGK,33,82,4,20,24
5,8475200,Dmitry Orlov,D,CAR,33,82,2,22,24
5,8478840,Will Borgen,D,SEA,28,82,2,22,24
5,8480281,Alexey Toropchenko,R,STL,25,82,14,9,23
5,8482166,Shakir Mukhamadullin,D,SJS,22,82,11,12,23
5,8475842,Sam Carrick,C,EDM,32,82,11,12,23
5,8475231,Casey Cizikas,C,NYI,33,82,10,13,23
5,8481028,Martin Pospisil,C,CGY,25,82,10,13,23
5,8483505,Matthew Poitras,C,BOS,20,82,9,14,23
5,8477845,Trevor van Riemsdyk,D,WSH,33,82,5,18,23
5,8479371,Dante Fabbro,D,NSH,26,82,5,18,23
5,8480879,Jacob Bernard-Docker,D,OTT,24,82,4,19,23
5,8482245,Artem Zub,D,OTT,29,82,2,21,23
5,8476915,Jujhar Khaira,L,MIN,30,82,18,4,22
5,8477505,Alexander Wennberg,C,NYR,30,82,12,10,22
5,8479390,Taylor Raddysh,R,CHI,26,82,10,12,22
5,8482666,Scott Morrow,D,CAR,22,82,9,13,22
5,8482737,Zack Bolduc,C,STL,21,82,9,13,22
5,8483468,Jiri Kulich,C,BUF,20,82,8,14,22
5,8477369,Carson Soucy,D,VAN,30,82,6,16,22
5,8481178,Egor Zamula,D,PHI,24,82,5,17,22
5,8477220,Nate Schmidt,D,WPG,33,82,4,18,22
5,8478451,Ethan Bear,D,WSH,27,82,4,18,22
5,8476457,Adam Larsson,D,SEA,32,82,3,19,22
5,8480246,Nick Perbix,D,TBL,26,82,3,19,22
5,8481568,Alex Vlasic,D,CHI,23,82,0,22,22
5,8476858,Phillip Di Giuseppe,L,VAN,31,82,13,8,21
5,8481524,Bowen Byram,D,BUF,23,82,10,11,21
5,8481517,Brett Leason,R,ANA,25,82,9,12,21
5,8481599,Victor Soderstrom,D,ARI,23,82,9,12,21
5,8482702,Logan Stankoven,C,DAL,21,82,8,13,21
5,8475825,Jani Hakanpää,D,DAL,32,82,8,13,21
5,8477406,Mattias Janmark,C,EDM,32,82,7,14,21
5,8473504,Cal Clutterbuck,R,NYI,37,82,7,14,21
5,8480172,Jan Rutta,D,SJS,34,82,6,15,21
5,8470966,Mark Giordano,D,TOR,41,82,4,17,21
5,8475208,Brian Dumoulin,D,SEA,33,82,3,18,21
5,8478136,Jake Middleton,D,MIN,28,82,3,18,21
5,8475455,Brenden Dillon,D,WPG,34,82,3,18,21
5,8476917,Adam Pelech,D,NYI,30,82,2,19,21
5,8475762,Derek Forbort,D,BOS,32,82,1,20,21
5,8476822,Luke Glendening,C,TBL,35,82,14,6,20
5,8478831,Kevin Stenlund,C,FLA,28,82,12,8,20
5,8481013,Jonatan Berggren,R,DET,24,82,10,10,20
5,8476442,Matt Nieto,L,PIT,32,82,9,11,20
5,8482730,Brandt Clarke,D,LAK,21,82,8,12,20
5,8483493,Frank Nazar,C,CHI,20,82,8,12,20
5,8480031,Maxime Comtois,L,CAR,25,82,8,12,20
5,8477508,Curtis Lazar,C,NJD,29,82,7,13,20
5,8484911,Collin Graf,R,SJS,22,82,6,14,20
5,8477499,Rasmus Ristolainen,D,PHI,30,82,3,17,20
5,8481059,Scott Perunovich,D,STL,26,82,3,17,20
5,8479980,Nicolas Hague,D,VGK,26,82,2,18,20
5,8484145,Zach Benson,L,BUF,19,82,12,7,19
5,8483763,Maksymilian Szuber,D,ARI,22,82,10,9,19
5,8483445,Cutter Gauthier,L,ANA,20,82,10,9,19
5,8484203,Bradly Nadeau,L,CAR,19,82,8,11,19
5,8481016,Ruslan Iskhakov,C,NYI,24,82,8,11,19
5,8484149,Gavin Brindley,C,CBJ,20,82,7,12,19
5,8478859,Niko Mikkola,D,FLA,28,82,4,15,19
5,8480796,Martin Fehervary,D,WSH,25,82,4,15,19
5,8476312,Josh Manson,D,COL,33,82,3,16,19
5,8476429,Scott Mayfield,D,NYI,32,82,3,16,19
5,8479383,Boris Katchouk,L,OTT,26,82,11,7,18
5,8483491,Ivan Miroshnichenko,L,WSH,20,82,9,9,18
5,8479346,Dillon Dube,C,CGY,26,82,8,10,18
5,8482142,Jamie Drysdale,D,PHI,22,82,6,12,18
5,8480860,Kevin Bahl,D,NJD,24,82,5,13,18
5,8478416,Erik Cernak,D,TBL,27,82,3,15,18
5,8475233,David Savard,D,MTL,34,82,1,17,18
5,8474009,Nick Bonino,C,NYR,36,82,7,10,17
5,8482101,Danil Gushchin,L,SJS,22,82,7,10,17
5,8478443,Brandon Carlo,D,BOS,28,82,7,10,17
5,8482762,Simon Edvinsson,D,DET,21,82,7,10,17
5,8477335,Kyle Burroughs,D,SJS,29,82,7,10,17
5,8482803,Olen Zellweger,D,ANA,21,82,6,11,17
5,8482809,Jackson Blake,R,CAR,21,82,5,12,17
5,8480990,Declan Chisholm,D,MIN,24,82,5,12,17
5,8482858,Ryker Evans,D,SEA,23,82,4,13,17
5,8476422,Mike Reilly,D,NYI,31,82,4,13,17
5,8480035,Henri Jokiharju,D,BUF,25,82,3,14,17
5,8475690,Chris Tanev,D,DAL,35,82,3,14,17
5,8479369,Andrew Peeke,D,BOS,26,82,1,16,17
5,8481537,Nikita Okhotiuk,D,CGY,24,82,10,6,16
5,8482145,Mavrik Bourque,C,DAL,22,82,9,7,16
5,8481605,Jackson LaCombe,D,ANA,23,82,6,10,16
5,8483565,Nick Blankenburg,D,CBJ,26,82,5,11,16
5,8480834,Ty Emberson,D,SJS,24,82,5,11,16
5,8475177,Calvin de Haan,D,TBL,33,82,5,11,16
5,8478178,Darren Raddysh,D,TBL,28,82,4,12,16
5,8483499,Liam Ohgren,L,MIN,20,82,4,12,16
5,8481014,Alexander Romanov,D,NYI,24,82,2,14,16
5,8474013,Ian Cole,D,VAN,35,82,2,14,16
5,8474166,Alec Martinez,D,VGK,37,82,2,14,16
5,8476878,Zemgus Girgensons,L,BUF,30,82,7,8,15
5,8482470,Ilya Solovyov,D,CGY,24,82,7,8,15
5,8482712,Oskar Olausson,R,COL,22,82,6,9,15
5,8479442,Troy Stecher,D,EDM,30,82,5,10,15
5,8482807,Ethan Del Mastro,D,CHI,21,82,4,11,15
5,8482177,Marat Khusnutdinov,C,MIN,22,82,4,11,15
5,8477365,Connor Clifton,D,BUF,29,82,2,13,15
5,8483397,Marc McLaughlin,C,BOS,25,82,8,6,14
5,8483524,Shane Wright,C,SEA,20,82,7,7,14
5,8483495,Simon Nemec,D,NJD,20,82,6,8,14
5,8479324,Ryan Lindgren,D,NYR,26,82,5,9,14
5,8481699,Aku Raty,R,ARI,23,82,5,9,14
5,8478430,Oliver Kylington,D,CGY,27,82,3,11,14
5,8475462,Radko Gudas,D,ANA,34,82,2,12,14
5,8481567,Henry Thrun,D,SJS,23,82,2,12,14
5,8475324,Nick Jensen,D,WSH,34,82,1,13,14
5,8476372,Nick Seeler,D,PHI,31,82,1,13,14
5,8481578,Graeme Clarke,R,NJD,23,82,7,6,13
5,8471677,Jack Johnson,D,COL,37,82,6,7,13
5,8483482,Tristan Luneau,D,ANA,20,82,4,9,13
5,8482733,Logan Mailloux,D,MTL,31,82,3,10,13
5,8482118,Sam Colangelo,R,ANA,23,82,7,5,12
5,8479291,Kevin Rooney,C,CGY,31,82,6,6,12
5,8482516,Matthew Kessel,D,STL,24,82,5,7,12
5,8481030,Jack St. Ivany,D,PIT,25,82,5,7,12
5,8480058,Pierre-Olivier Joseph,D,PIT,25,82,2,10,12
5,8483466,Kevin Korchinski,D,CHI,20,82,2,10,12
5,8474567,Zach Bogosian,D,MIN,34,82,0,12,12
5,8483489,Fraser Minten,C,TOR,31,82,3,8,11
5,8476473,Connor Murphy,D,CHI,31,82,1,10,11
5,8473453,Trevor Lewis,C,LAK,37,82,3,7,10
5,8483471,Brad Lambert,C,WPG,31,82,3,7,10
5,8478408,Travis Dermott,D,ARI,28,82,2,6,8
5,8483012,Logan Morrison,C,SEA,22,82,4,3,7
5,8482859,Zack Ostapchuk,C,OTT,21,82,3,4,7
5,8482713,Mackie Samoskevich,R,FLA,22,82,3,3,6
5,8477950,Tony DeAngelo,D,CAR,29,0,0,0,0
5,8481577,Philip Tomasino,C,NSH,23,0,0,0,0
5,8482660,Kent Johnson,C,CBJ,22,0,0,0,0
5,8481019,David Gustafsson,C,WPG,24,0,0,0,0
5,8479348,Kale Clague,D,BUF,26,0,0,0,0
5,8482149,Cole Perfetti,C,WPG,22,0,0,0,0
5,8476952,Dominic Toninato,C,WPG,30,0,0,0,0
5,8473473,Milan Lucic,L,BOS,36,0,0,0,0
5,8480829,Jesperi Kotkaniemi,C,CAR,24,0,0,0,0
5,8474602,Justin Schultz,D,SEA,34,0,0,0,0
5,8480049,Dylan Samberg,D,WPG,25,0,0,0,0
5,8479372,Josh Mahura,D,FLA,26,0,0,0,0
5,8480878,Nils Lundkvist,D,DAL,24,0,0,0,0
5,8479982,Conor Timmins,D,TOR,26,0,0,0,0
5,8474031,Kevin Shattenkirk,D,BOS,35,0,0,0,0
5,8480835,Jack Drury,C,CAR,24,0,0,0,0
5,8480008,Adam Ruzicka,C,ARI,25,0,0,0,0
5,8479402,Jake Bean,D,CBJ,26,0,0,0,0
5,8476474,Stefan Noesen,R,CAR,31,0,0,0,0
5,8480884,Calen Addison,D,SJS,24,0,0,0,0
5,8476994,Vinnie Hinostroza,C,PIT,30,0,0,0,0
5,8477987,Ryan Donato,C,CHI,28,0,0,0,0
5,8481582,Nicholas Robertson,L,TOR,23,0,0,0,0
5,8478452,Caleb Jones,D,COL,27,0,0,0,0
5,8480157,Calle Rosen,D,STL,30,0,0,0,0
5,8481609,Vladislav Kolyachonok,D,ARI,23,0,0,0,0
5,8476919,Chris Tierney,C,NJD,30,0,0,0,0
5,8479639,Dylan Coghlan,D,CAR,26,0,0,0,0
5,8475193,Tomas Tatar,L,SEA,34,0,0,0,0
5,8480748,Kiefer Sherwood,L,NSH,29,0,0,0,0
5,8478146,Matthew Highmore,C,OTT,28,0,0,0,0
5,8478970,Jalen Chatfield,D,CAR,28,0,0,0,0
5,8480205,Emil Bemstrom,C,PIT,25,0,0,0,0
5,8471274,Alex Goligoski,D,MIN,39,0,0,0,0
5,8478104,Sammy Blais,L,STL,28,0,0,0,0
5,8476913,Devin Shore,C,SEA,30,0,0,0,0
5,8481708,Zac Jones,D,NYR,24,0,0,0,0
5,8480222,Sebastian Aho,D,NYI,28,0,0,0,0
5,8481598,Philip Broberg,D,EDM,23,0,0,0,0
5,8480789,Oliver Wahlstrom,R,NYI,24,0,0,0,0
5,8480891,Michael Kesselring,D,ARI,24,0,0,0,0
5,8477979,Nicolas Aube-Kubel,R,WSH,28,0,0,0,0
5,8476393,Nick Cousins,C,FLA,31,0,0,0,0
5,8480003,Jesper Boqvist,C,BOS,26,0,0,0,0
5,8479543,Michael Pezzetta,L,MTL,26,0,0,0,0
5,8475855,Jesper Fast,R,CAR,33,0,0,0,0
5,8477018,Ben Hutton,D,VGK,31,0,0,0,0
5,8480762,Eric Robinson,L,BUF,29,0,0,0,0
5,8481058,Jesse Ylönen,R,MTL,25,0,0,0,0
5,8481527,Kaedan Korczak,D,VGK,23,0,0,0,0
5,8482192,Isaak Phillips,D,CHI,23,0,0,0,0
5,8480727,Zach Whitecloud,D,VGK,28,0,0,0,0
5,8480001,Urho Vaakanainen,D,ANA,25,0,0,0,0
5,8480853,Liam Foudy,C,NSH,24,0,0,0,0
5,8475225,Craig Smith,C,DAL,35,0,0,0,0
5,8479972,Mason Shaw,C,MIN,26,0,0,0,0
5,8474040,Sam Gagner,C,EDM,35,0,0,0,0
5,8480196,Jacob Bryson,D,BUF,27,0,0,0,0
5,8475718,Justin Holl,D,DET,32,0,0,0,0
5,8479984,Cal Foote,D,NJD,26,0,0,0,0
5,8480011,Klim Kostin,C,SJS,25,0,0,0,0
5,8482176,Wyatt Kaiser,D,CHI,22,0,0,0,0
5,8476918,Jimmy Vesey,L,NYR,31,0,0,0,0
5,8476988,Matt Benning,D,SJS,30,0,0,0,0
5,8479370,Tyson Jost,C,BUF,26,0,0,0,0
5,8477464,Nic Petan,C,MIN,29,0,0,0,0
5,8477380,Jonny Brodzinski,C,NYR,31,0,0,0,0
5,8480070,Ian Mitchell,D,BOS,25,0,0,0,0
5,8479315,Joey Anderson,R,CHI,26,0,0,0,0
5,8478099,Kevin Labanc,R,SJS,29,0,0,0,0
5,8476874,Olli Maatta,D,DET,30,0,0,0,0
5,8479414,Nathan Bastian,R,NJD,27,0,0,0,0
5,8478434,Keegan Kolesar,R,VGK,27,0,0,0,0
5,8479536,Axel Jonsson-Fjallby,L,WPG,26,0,0,0,0
5,8479671,Mathieu Olivier,R,CBJ,27,0,0,0,0
5,8471709,Marc-Edouard Vlasic,D,SJS,37,0,0,0,0
5,8479328,Julien Gauthier,R,NYI,27,0,0,0,0
5,8478421,A.J. Greer,L,CGY,28,0,0,0,0
5,8477573,Nathan Walker,L,STL,30,0,0,0,0
5,8477478,William Carrier,L,VGK,30,0,0,0,0
5,8479344,Jesse Puljujarvi,R,PIT,26,0,0,0,0
5,8480887,Jordan Harris,D,MTL,24,0,0,0,0
5,8478502,Dennis Gilbert,D,CGY,28,0,0,0,0
5,8480355,Mark Kastelic,C,OTT,25,0,0,0,0
5,8475750,Jon Merrill,D,MIN,32,0,0,0,0
5,8476889,Radek Faksa,C,DAL,30,0,0,0,0
5,8478432,Christian Fischer,R,DET,27,0,0,0,0
5,8479439,Jacob MacDonald,D,SJS,31,0,0,0,0
5,8474568,Luke Schenn,D,NSH,35,0,0,0,0
5,8478454,Noah Juulsen,D,VAN,27,0,0,0,0
5,8475752,Tyler Pitlick,C,NYR,33,0,0,0,0
5,8482148,Hendrix Lapierre,C,WSH,22,0,0,0,0
5,8481167,Brayden Pachal,D,CGY,25,0,0,0,0
5,8478211,Dryden Hunt,L,CGY,29,0,0,0,0
5,8479321,Lucas Johansen,D,WSH,27,0,0,0,0
5,8480950,Ilya Lyubushkin,D,TOR,30,0,0,0,0
5,8479368,Max Jones,L,ANA,26,0,0,0,0
5,8471699,Andrew Cogliano,C,COL,37,0,0,0,0
5,8481521,Ronnie Attard,D,PHI,25,0,0,0,0
5,8481161,Jake Christiansen,D,CBJ,25,0,0,0,0
5,8479458,Nikita Zaitsev,D,CHI,33,0,0,0,0
5,8479619,Michael Carcone,L,ARI,28,0,0,0,0
5,8479026,Philippe Myers,D,TBL,27,0,0,0,0
5,8481617,Vasily Podkolzin,R,VAN,23,0,0,0,0
5,8481701,Santeri Hatakka,D,NJD,23,0,0,0,0
5,8477446,Michael McCarron,R,NSH,29,0,0,0,0
5,8483460,David Jiricek,D,CBJ,21,0,0,0,0
5,8474090,Brendan Smith,D,NJD,35,0,0,0,0
5,8482241,Radim Zohorna,L,PIT,28,0,0,0,0
5,8481032,Paul Cotter,C,VGK,25,0,0,0,0
5,8480289,Morgan Barron,C,WPG,26,0,0,0,0
5,8479379,Givani Smith,R,SJS,26,0,0,0,0
5,8480216,Jacob Peterson,C,SJS,25,0,0,0,0
5,8477851,Jordan Oesterle,D,CGY,32,0,0,0,0
5,8484258,Sam Malinski,D,COL,26,0,0,0,0
5,8478904,Steven Lorentz,C,FLA,28,0,0,0,0
5,8482095,Tyler Kleven,D,OTT,22,0,0,0,0
5,8480980,Connor Dewar,C,TOR,25,0,0,0,0
5,8480848,Ty Dellandrea,C,DAL,24,0,0,0,0
5,8476884,Derrick Pouliot,D,DAL,30,0,0,0,0
5,8480025,MacKenzie Entwistle,R,CHI,25,0,0,0,0
5,8474612,Travis Hamonic,D,OTT,34,0,0,0,0
5,8479336,Carl Grundstrom,R,LAK,27,0,0,0,0
5,8482964,Arber Xhekaj,D,MTL,23,0,0,0,0
5,8471686,Marc Staal,D,PHI,37,0,0,0,0
5,8477887,Patrick Brown,C,BOS,32,0,0,0,0
5,8478495,Denis Gurianov,R,PHI,27,0,0,0,0
5,8481550,Adam Beckman,L,MIN,23,0,0,0,0
5,8480845,Rasmus Kupari,C,WPG,24,0,0,0,0
5,8478585,Derek Ryan,C,EDM,38,0,0,0,0
5,8482141,Lukas Cormier,D,VGK,22,0,0,0,0
5,8477962,Brendan Lemieux,L,CAR,28,0,0,0,0
5,8482861,Vincent Iorio,D,WSH,22,0,0,0,0
5,8479378,Logan Stanley,D,WPG,26,0,0,0,0
5,8473446,Erik Johnson,D,PHI,36,0,0,0,0
5,8481743,Marc Del Gaizo,D,NSH,25,0,0,0,0
5,8478450,Parker Wotherspoon,D,BOS,27,0,0,0,0
5,8477384,Josh Brown,D,ARI,30,0,0,0,0
5,8482165,Yan Kuznetsov,D,CGY,22,0,0,0,0
5,8478424,Jansen Harkins,C,PIT,27,0,0,0,0
5,8482144,Jack Thompson,D,SJS,22,0,0,0,0
5,8479576,Vincent Desharnais,D,EDM,28,0,0,0,0
5,8478512,Austin Czarnik,C,DET,32,0,0,0,0
5,8477527,Ross Johnston,L,ANA,30,0,0,0,0
5,8482094,Daemon Hunt,D,MIN,22,0,0,0,0
5,8481719,Maxwell Crozier,D,TBL,24,0,0,0,0
5,8480192,Johnathan Kovacevic,D,MTL,27,0,0,0,0
5,8479376,Victor Mete,D,PHI,26,0,0,0,0
5,8482511,Mason Lohrei,D,BOS,23,0,0,0,0
5,8478021,William Lagesson,D,ANA,28,0,0,0,0
5,8475795,Dylan McIlrath,D,WSH,32,0,0,0,0
5,8477846,Ryan Carpenter,C,SJS,33,0,0,0,0
5,8481056,Spencer Stastney,D,NSH,24,0,0,0,0
5,8481564,Ryan Johnson,D,BUF,23,0,0,0,0
5,8478017,Mark Friedman,D,VAN,29,0,0,0,0
5,8479320,Max Lajoie,D,TOR,27,0,0,0,0
5,8480075,Cameron Crotty,D,ARI,25,0,0,0,0
5,8484287,Cole McWard,D,VAN,23,0,0,0,0
5,8484254,Akito Hirose,D,VAN,25,0,0,0,0
5,8483407,Brandon Scanlin,D,NYR,25,0,0,0,0
5,8480274,Philip Kemp,D,EDM,25,0,0,0,0
5,8479522,Hardy Haman Aktell,D,WSH,26,0,0,0,0
5,8480007,Jonas Rondbjerg,R,VGK,25,0,0,0,0
5,8477454,Adam Erne,L,EDM,29,0,0,0,0
5,8481679,Maxence Guenette,D,OTT,23,0,0,0,0
5,8477938,Haydn Fleury,D,TBL,28,0,0,0,0
5,8476441,Joel Edmundson,D,TOR,31,0,0,0,0
5,8477903,Garnet Hathaway,R,PHI,33,0,0,0,0
5,8480441,Trey Fix-Wolansky,R,CBJ,25,0,0,0,0
5,8483546,Marshall Rifai,D,TOR,26,0,0,0,0
5,8480084,Nick DeSimone,D,NJD,30,0,0,0,0
5,8481592,Jakob Pelletier,L,CGY,23,0,0,0,0
5,8478011,Louie Belpedio,D,PHI,28,0,0,0,0
5,8477930,Pierre-Edouard Bellemare,L,SEA,39,0,0,0,0
5,8484321,Nikolas Matinpalo,D,OTT,26,0,0,0,0
5,8482067,Connor Mackey,D,NYR,28,0,0,0,0
5,8481806,Louis Crevier,D,CHI,23,0,0,0,0
5,8484326,Patrik Koch,D,ARI,28,0,0,0,0
5,8477971,Andreas Englund,D,LAK,28,0,0,0,0
5,8481751,Lukas Rousek,R,BUF,25,0,0,0,0
5,8481006,Tyler Tucker,D,STL,24,0,0,0,0
5,8481641,Joel Kiviranta,L,COL,28,0,0,0,0
5,8476867,Brendan Gaunce,C,CBJ,30,0,0,0,0
5,8479520,Brandon Duhaime,R,COL,27,0,0,0,0
5,8477073,Kurtis MacDermid,L,NJD,30,0,0,0,0
5,8480874,Adam Ginning,D,PHI,24,0,0,0,0
5,8477473,Justin Bailey,R,SJS,29,0,0,0,0
5,8479066,Ryan Lomberg,L,FLA,30,0,0,0,0
5,8477070,Liam O'Brien,C,ARI,30,0,0,0,0
5,8474618,Marco Scandella,D,STL,34,0,0,0,0
5,8475797,Jarred Tinordi,D,CHI,32,0,0,0,0
5,8481441,Joe Snively,C,WSH,28,0,0,0,0
5,8477244,Chad Ruhwedel,D,NYR,34,0,0,0,0
5,8482077,Dylan Holloway,L,EDM,23,0,0,0,0
5,8479772,Zack MacEwen,R,OTT,28,0,0,0,0
5,8481147,Reese Johnson,C,CHI,26,0,0,0,0
5,8481043,Cole Koepke,L,TBL,26,0,0,0,0
5,8483619,Filip Roos,D,CHI,25,0,0,0,0
5,8481541,Samuel Bolduc,D,NYI,24,0,0,0,0
5,8477810,Joel Hanley,D,CGY,33,0,0,0,0
5,8476907,Mackenzie MacEachern,L,STL,30,0,0,0,0
5,8482652,Walker Duehr,R,CGY,27,0,0,0,0
5,8477126,Jayson Megna,C,BOS,34,0,0,0,0
5,8483398,Declan Carlile,D,TBL,31,0,0,0,0
5,8482929,Emil Lilleberg,D,TBL,23,0,0,0,0
5,8480880,Jakub Lauko,C,BOS,24,0,0,0,0
5,8478874,Adam Gaudette,C,STL,28,0,0,0,0
5,8480245,Olle Lycksell,R,PHI,25,0,0,0,0
5,8480252,Cole Guttman,C,CHI,25,0,0,0,0
5,8477467,Gustav Olofsson,D,SEA,30,0,0,0,0
5,8479968,Vinni Lettieri,C,MIN,29,0,0,0,0
5,8478400,Colin White,C,MTL,27,0,0,0,0
5,8475755,Alexander Petrovic,D,DAL,32,0,0,0,0
5,8481812,Nikolai Knyzhov,D,SJS,27,0,0,0,0
5,8481593,Jayden Struble,D,MTL,23,0,0,0,0
5,8481532,Alex Turcotte,C,LAK,23,0,0,0,0
5,8482126,Emil Andrae,D,PHI,31,0,0,0,0
5,8479944,Zach Aston-Reese,C,DET,30,0,0,0,0
5,8471817,Ryan Reaves,R,TOR,37,0,0,0,0
5,8481206,John Ludvig,D,PIT,24,0,0,0,0
5,8480292,Carson Meyer,R,CBJ,27,0,0,0,0
5,8482496,Nils Aman,C,VAN,24,0,0,0,0
5,8479718,Alex Barré-Boulet,C,TBL,27,0,0,0,0
5,8479994,Jaret Anderson-Dolan,C,NSH,25,0,0,0,0
5,8480184,Gustav Lindstrom,D,ANA,26,0,0,0,0
5,8480890,Jan Jenik,R,ARI,24,0,0,0,0
5,8478067,Oskar Lindblom,L,SJS,28,0,0,0,0
5,8476934,Brock McGinn,L,ANA,30,0,0,0,0
5,8479985,Cale Fleury,D,SEA,26,0,0,0,0
5,8482153,Brendan Brisson,C,VGK,23,0,0,0,0
5,8480021,Jack Studnicka,C,SJS,25,0,0,0,0
5,8484304,Uvis Balinskis,D,FLA,28,0,0,0,0
5,8479981,Jonah Gadjovich,L,FLA,26,0,0,0,0
5,8481716,Dmitri Voronkov,L,CBJ,24,0,0,0,0
5,8482659,Josh Doan,R,ARI,22,0,0,0,0
5,8481122,Simon Benoit,D,TOR,26,0,0,0,0
5,8474709,Matt Martin,L,NYI,35,0,0,0,0
5,8482634,Alex Steeves,C,TOR,25,0,0,0,0
5,8480823,Alexander Alexeyev,D,WSH,25,0,0,0,0
5,8477541,Dakota Mermis,D,MIN,30,0,0,0,0
5,8478477,Mitchell Stephens,C,MTL,27,0,0,0,0
5,8481543,Nikita Alexandrov,C,STL,24,0,0,0,0
5,8482451,Mikael Pyyhtia,L,CBJ,23,0,0,0,0
5,8480306,Grant Hutton,D,NYI,29,0,0,0,0
5,8478028,Fredrik Olofsson,L,COL,28,0,0,0,0
5,8477462,Robert Hagg,D,ANA,29,0,0,0,0
5,8477320,Anton Blidh,L,NYR,29,0,0,0,0
5,8482749,Joshua Roy,R,MTL,21,0,0,0,0
5,8482157,Will Cuylle,L,NYR,22,0,0,0,0
5,8481239,Samuel Fagemo,L,LAK,24,0,0,0,0
5,8481600,Tobias Bjornfot,D,FLA,23,0,0,0,0
5,8478409,Anthony Richard,C,BOS,28,0,0,0,0
5,8474145,Robert Bortuzzo,D,NYI,35,0,0,0,0
5,8475958,Michael Sgarbossa,C,WSH,32,0,0,0,0
5,8479986,Kole Lind,R,SEA,26,0,0,0,0
5,8479249,Andrew Poturalski,C,SEA,30,0,0,0,0
5,8479362,Riley Tufte,L,COL,26,0,0,0,0
5,8479991,Jake Leschyshyn,C,NYR,25,0,0,0,0
5,8479587,Rhett Gardner,C,PHI,28,0,0,0,0
5,8482744,James Malatesta,L,CBJ,21,0,0,0,0
5,8478854,Ryan Shea,D,PIT,27,0,0,0,0
5,8481591,Sam Poulin,R,PIT,23,0,0,0,0
5,8483512,Matt Savoie,C,BUF,20,0,0,0,0
5,8482102,Vasily Ponomarev,C,CAR,22,0,0,0,0
5,8482162,Roby Jarventie,L,OTT,22,0,0,0,0
5,8482172,Landon Slaggert,L,CHI,22,0,0,0,0
5,8482747,Brennan Othmann,L,NYR,21,0,0,0,0
5,8480226,Marián Studenic,R,SEA,26,0,0,0,0
5,8481518,Nolan Foote,L,NJD,24,0,0,0,0
5,8479419,Brett Murray,L,BUF,26,0,0,0,0
5,8482088,Justin Sourdif,R,FLA,22,0,0,0,0
5,8482201,Gage Goncalves,C,TBL,23,0,0,0,0
5,8481754,Nikita Nesterenko,C,ANA,23,0,0,0,0
5,8483531,Brian Halonen,L,NJD,25,0,0,0,0
5,8483920,Pierrick Dube,R,WSH,23,0,0,0,0
5,8480851,Akil Thomas,C,LAK,24,0,0,0,0
5,8475235,Nicolas Deslauriers,L,PHI,33,0,0,0,0
5,8482476,Emil Heineman,L,MTL,23,0,0,0,0
5,8477149,Scott Sabourin,R,SJS,32,0,0,0,0
5,8483549,Lucas Condotta,L,MTL,27,0,0,0,0
5,8483567,Georgii Merkulov,C,BOS,24,0,0,0,0
5,8482765,Isak Rosen,R,BUF,21,0,0,0,0
5,8481237,Kyle MacLean,C,NYI,25,0,0,0,0
5,8481024,Linus Karlsson,C,VAN,25,0,0,0,0
5,8481690,Tyler Angle,C,CBJ,24,0,0,0,0
5,8483570,Ben Meyers,C,ANA,26,0,0,0,0
5,8481655,Cole Schwindt,R,CGY,23,0,0,0,0
5,8481462,Mason Morelli,L,VGK,28,0,0,0,0
5,8483401,Marc Johnstone,R,PIT,28,0,0,0,0
5,8478956,Samuel Laberge,L,NJD,27,0,0,0,0
5,8479533,Joona Koppanen,L,PIT,26,0,0,0,0
5,8482197,Adam Raska,R,MIN,23,0,0,0,0
5,8482250,Callahan Burke,C,CAR,27,0,0,0,0
5,8482784,Zach Dean,C,STL,21,0,0,0,0
5,8484255,Jason Polin,R,COL,25,0,0,0,0
5,8481077,John Leonard,L,ARI,26,0,0,0,0
5,8481534,Raphael Lavoie,C,EDM,24,0,0,0,0
5,8483609,Adam Klapka,R,CGY,24,0,0,0,0
5,8482751,Ryan Winterton,C,SEA,21,0,0,0,0
5,8480267,Sammy Walker,C,MIN,25,0,0,0,0
5,8475766,Austin Watson,L,TBL,32,0,0,0,0
5,8482460,Matt Rempe,C,NYR,22,0,0,0,0
5,8482787,Nikita Chibrikov,R,WPG,31,0,0,0,0
5,8481065,Angus Crookshank,L,OTT,25,0,0,0,0
5,8481070,Hugh McGing,L,STL,26,0,0,0,0
5,8476323,Max McCormick,L,SEA,32,0,0,0,0
5,8483395,Arshdeep Bains,L,VAN,23,0,0,0,0
5,8484259,Ondrej Pavel,C,COL,31,0,0,0,0
5,8483432,Luca Del Bel Belluz,C,CBJ,31,0,0,0,0
5,8483045,Cameron Butler,R,CBJ,31,0,0,0,0
5,8482061,Brandon Biro,L,BUF,26,0,0,0,0
5,8477401,John Hayden,C,SEA,29,0,0,0,0
5,8475278,Byron Froese,C,VGK,33,0,0,0,0
5,8478446,Glenn Gawdin,C,ANA,27,0,0,0,0
5,8477993,Justin Kirkland,C,ARI,28,0,0,0,0
5,8482147,Jean-Luc Foudy,C,COL,22,0,0,0,0
5,8480032,Shane Bowers,C,NJD,25,0,0,0,0
5,8479330,Brandon Gignac,C,MTL,27,0,0,0,0
5,8480776,Sheldon Rempal,R,VGK,29,0,0,0,0
5,8475413,Justin Dowling,C,NJD,34,0,0,0,0
5,8481726,Adam Edstrom,C,NYR,24,0,0,0,0
5,8479638,Justin Brazeau,R,BOS,26,0,0,0,0
5,8480844,Grigori Denisenko,L,VGK,24,0,0,0,0
5,8474062,Riley Nash,C,NYR,35,0,0,0,0
5,8478147,Bokondji Imama,L,OTT,28,0,0,0,0
5,8478881,Brett Seney,L,CHI,28,0,0,0,0
5,8483630,Pavol Regenda,L,ANA,25,0,0,0,0
5,8480836,Jonathan Gruden,C,PIT,24,0,0,0,0
5,8484314,Jiri Smejkal,L,OTT,28,0,0,0,0
5,8475780,Chris Wagner,R,COL,33,0,0,0,0
5,8482070,Mitchell Chaffee,R,TBL,26,0,0,0,0
5,8479546,Oskar Steen,C,BOS,26,0,0,0,0
5,8483597,Milos Kelemen,L,ARI,25,0,0,0,0
5,8481789,Tye Kartye,L,SEA,23,0,0,0,0
5,8484325,Waltteri Merela,C,TBL,26,0,0,0,0
5,8479421,Jacob Moverare,D,LAK,26,0,0,0,0
5,8481585,Egor Afanasyev,L,NSH,23,0,0,0,0
5,8479547,Matthew Phillips,R,WSH,26,0,0,0,0
5,8479367,William Lockwood,R,FLA,26,0,0,0,0
5,8481422,Jacob Lucchini,C,MIN,29,0,0,0,0
5,8480468,James Hamblin,L,EDM,25,0,0,0,0
5,8480870,Bo Groulx,C,ANA,24,0,0,0,0
5,8478051,Max Willman,C,NJD,29,0,0,0,0
5,8481556,John Beecher,C,BOS,23,0,0,0,0
5,8478078,Rourke Chartier,C,OTT,28,0,0,0,0
6,8478402,Connor McDavid,C,EDM,27,82,37,99,136
6,8476453,Nikita Kucherov,R,TBL,31,82,42,84,126
6,8479318,Auston Matthews,C,TOR,27,82,65,58,123
6,8478420,Mikko Rantanen,R,COL,28,82,51,69,120
6,8477934,Leon Draisaitl,C,EDM,29,82,45,71,116
6,8477956,David Pastrnak,R,BOS,28,82,53,54,107
6,8476468,J.T. Miller,C,VAN,31,82,33,72,105
6,8481559,Jack Hughes,C,NJD,23,82,40,63,103
6,8478445,Mathew Barzal,C,NYI,27,82,24,78,102
6,8478864,Kirill Kaprizov,L,MIN,27,82,39,61,100
6,8477492,Nathan MacKinnon,C,COL,29,82,37,63,100
6,8478398,Kyle Connor,L,WPG,28,82,51,46,97
6,8480027,Jason Robertson,L,DAL,25,82,35,62,97
6,8482116,Tim Stützle,C,OTT,22,82,33,62,95
6,8479343,Clayton Keller,R,ARI,26,82,32,63,95
6,8479385,Jordan Kyrou,C,STL,26,82,36,58,94
6,8477404,Jake Guentzel,C,CAR,30,82,47,45,92
6,8477501,Valeri Nichushkin,R,COL,29,82,47,45,92
6,8471675,Sidney Crosby,C,PIT,37,82,37,55,92
6,8480069,Cale Makar,D,COL,26,82,18,74,92
6,8476454,Ryan Nugent-Hopkins,C,EDM,31,82,37,54,91
6,8476460,Mark Scheifele,C,WPG,31,82,45,45,90
6,8475166,John Tavares,C,TOR,34,82,41,49,90
6,8474564,Steven Stamkos,C,TBL,34,82,39,51,90
6,8480023,Robert Thomas,C,STL,25,82,28,62,90
6,8477933,Sam Reinhart,C,FLA,29,82,51,38,89
6,8476459,Mika Zibanejad,C,NYR,31,82,32,57,89
6,8477493,Aleksander Barkov,C,FLA,29,82,26,63,89
6,8480012,Elias Pettersson,C,VAN,26,82,35,53,88
6,8476389,Vincent Trocheck,C,NYR,31,82,40,47,87
6,8478440,Dylan Strome,C,WSH,27,82,36,51,87
6,8480002,Nico Hischier,C,NJD,25,82,33,54,87
6,8477939,William Nylander,R,TOR,28,82,28,59,87
6,8475184,Chris Kreider,L,NYR,33,82,52,33,85
6,8476887,Filip Forsberg,L,NSH,30,82,42,43,85
6,8478403,Jack Eichel,C,VGK,28,82,39,46,85
6,8478550,Artemi Panarin,L,NYR,33,82,28,57,85
6,8478873,Troy Terry,R,ANA,27,82,31,53,84
6,8481557,Matt Boldy,L,MIN,23,82,31,52,83
6,8480036,Miro Heiskanen,D,DAL,25,82,21,62,83
6,8478010,Brayden Point,C,TBL,28,82,43,39,82
6,8478439,Travis Konecny,R,PHI,27,82,31,51,82
6,8479420,Tage Thompson,C,BUF,27,82,38,43,81
6,8478427,Sebastian Aho,C,CAR,27,82,33,48,81
6,8480839,Rasmus Dahlin,D,BUF,24,82,18,63,81
6,8476853,Morgan Rielly,D,TOR,30,82,16,65,81
6,8477951,Nick Schmaltz,C,ARI,28,82,33,47,80
6,8481523,Kirby Dach,C,MTL,23,82,19,61,80
6,8477504,Josh Morrissey,D,WPG,29,82,17,63,80
6,8477942,Kevin Fiala,L,LAK,28,82,30,48,78
6,8470794,Joe Pavelski,C,DAL,40,82,30,48,78
6,8479314,Matthew Tkachuk,L,FLA,27,82,25,52,77
6,8475754,Brock Nelson,C,NYI,33,82,39,37,76
6,8477960,Adrian Kempe,R,LAK,28,82,37,39,76
6,8480801,Brady Tkachuk,L,OTT,25,82,35,41,76
6,8480039,Martin Necas,C,CAR,25,82,29,47,76
6,8474600,Roman Josi,D,NSH,34,82,16,60,76
6,8477946,Dylan Larkin,C,DET,28,82,36,39,75
6,8479337,Alex DeBrincat,R,DET,27,82,31,44,75
6,8475692,Mats Zuccarello,R,MIN,37,82,23,52,75
6,8478444,Brock Boeser,R,VAN,27,82,36,38,74
6,8475913,Mark Stone,R,VGK,32,82,34,40,74
6,8479407,Jesper Bratt,L,NJD,26,82,26,48,74
6,8474679,Gustav Nyquist,C,NSH,35,82,22,52,74
6,8475786,Zach Hyman,L,EDM,32,82,42,31,73
6,8471214,Alex Ovechkin,L,WSH,39,82,36,37,73
6,8477940,Nikolaj Ehlers,L,WPG,28,82,29,44,73
6,8481528,Dylan Cozens,C,BUF,23,82,28,45,73
6,8477402,Pavel Buchnevich,L,STL,29,82,25,48,73
6,8478460,Zach Werenski,D,CBJ,27,82,18,55,73
6,8480865,Noah Dobson,D,NYI,24,82,13,60,73
6,8476539,Jonathan Marchessault,R,VGK,34,82,40,32,72
6,8477500,Bo Horvat,C,NYI,29,82,35,37,72
6,8475172,Nazem Kadri,C,CGY,34,82,27,43,70
6,8474141,Patrick Kane,R,DET,36,82,23,47,70
6,8478449,Roope Hintz,C,DAL,28,82,42,27,69
6,8475784,Jeff Skinner,C,BUF,32,82,34,35,69
6,8475158,Ryan O'Reilly,C,NSH,33,82,28,41,69
6,8477479,Tyler Bertuzzi,L,TOR,29,82,25,44,69
6,8477949,Alex Tuch,R,BUF,28,82,20,49,69
6,8480803,Evan Bouchard,D,EDM,25,82,19,50,69
6,8478414,Timo Meier,R,NJD,28,82,32,36,68
6,8480018,Nick Suzuki,C,MTL,25,82,25,43,68
6,8475167,Victor Hedman,D,TBL,34,82,9,59,68
6,8478493,Joel Eriksson Ek,C,MIN,27,82,27,40,67
6,8471215,Evgeni Malkin,C,PIT,38,82,25,42,67
6,8475753,Justin Faulk,D,STL,32,82,21,46,67
6,8473512,Claude Giroux,R,OTT,36,82,20,47,67
6,8480800,Quinn Hughes,D,VAN,25,82,11,56,67
6,8479323,Adam Fox,D,NYR,26,82,9,58,67
6,8475810,Bryan Rust,R,PIT,32,82,30,36,66
6,8479542,Brandon Hagel,L,TBL,26,82,23,43,66
6,8481533,Trevor Zegras,C,ANA,23,82,23,43,66
6,8478407,Vince Dunn,D,SEA,28,82,21,45,66
6,8477447,Shea Theodore,D,VGK,29,82,8,58,66
6,8477407,Anthony Duclair,L,TBL,29,82,40,25,65
6,8477476,Artturi Lehkonen,L,COL,29,82,37,28,65
6,8477409,Carter Verhaeghe,C,FLA,29,82,33,32,65
6,8479325,Charlie McAvoy,D,BOS,27,82,9,55,64
6,8473986,Alex Killorn,L,ANA,35,82,24,39,63
6,8477496,Elias Lindholm,C,VAN,30,82,22,41,63
6,8475765,Vladimir Tarasenko,R,FLA,33,82,18,45,63
6,8474578,Erik Karlsson,D,PIT,34,82,16,47,63
6,8478397,Rasmus Andersson,D,CGY,28,82,13,50,63
6,8474590,John Carlson,D,WSH,34,82,11,52,63
6,8471685,Anze Kopitar,C,LAK,37,82,27,35,62
6,8482093,Seth Jarvis,C,CAR,22,82,20,42,62
6,8482089,Jake Neighbours,L,STL,22,82,35,26,61
6,8475726,Tyler Toffoli,C,WPG,32,82,29,32,61
6,8480188,Fabian Zetterlund,L,SJS,25,82,28,33,61
6,8478519,Anthony Cirelli,C,TBL,27,82,26,35,61
6,8482124,Quinton Byfield,R,LAK,22,82,24,37,61
6,8478047,Michael Bunting,L,PIT,29,82,18,43,61
6,8479999,Casey Mittelstadt,C,COL,26,82,16,45,61
6,8481068,Yegor Sharangovich,C,CGY,26,82,31,29,60
6,8477955,Jared McCann,L,SEA,28,82,28,32,60
6,8477451,Ryan Hartman,R,MIN,30,82,28,32,60
6,8482740,Wyatt Johnston,C,DAL,21,82,24,36,60
6,8482078,Lucas Raymond,L,DET,22,82,23,37,60
6,8479345,Jakob Chychrun,D,OTT,26,82,23,37,60
6,8482684,Luke Hughes,D,NJD,21,82,15,45,60
6,8481711,Matias Maccelli,L,ARI,24,82,15,45,60
6,8480014,Gabriel Vilardi,C,WPG,25,82,37,22,59
6,8475169,Evander Kane,L,EDM,33,82,34,25,59
6,8476881,Tomas Hertl,C,VGK,31,82,25,34,59
6,8473419,Brad Marchand,L,BOS,36,82,24,35,59
6,8478975,Mason Marchment,L,DAL,29,82,21,38,59
6,8480208,Drake Batherson,R,OTT,26,82,20,39,59
6,8482110,Dawson Mercer,C,NJD,23,82,38,20,58
6,8476346,Johnny Gaudreau,L,CBJ,31,82,15,43,58
6,8481542,Moritz Seider,D,DET,23,82,11,47,58
6,8481540,Cole Caufield,R,MTL,23,82,34,23,57
6,8476432,Boone Jenner,C,CBJ,31,82,31,26,57
6,8478042,Viktor Arvidsson,R,LAK,31,82,28,29,57
6,8473994,Jamie Benn,L,DAL,35,82,27,30,57
6,8480028,Morgan Frost,C,PHI,25,82,25,32,57
6,8477935,Sam Bennett,C,FLA,28,82,23,34,57
6,8476448,William Karlsson,C,VGK,31,82,23,34,57
6,8480113,Alex Iafallo,L,WPG,31,82,18,39,57
6,8479410,Mikhail Sergachev,D,TBL,26,82,14,43,57
6,8480064,Josh Norris,C,OTT,25,82,31,25,56
6,8477456,J.T. Compher,L,DET,29,82,28,28,56
6,8482113,Anton Lundell,C,FLA,23,82,27,29,56
6,8477964,Ivan Barbashev,C,VGK,29,82,25,31,56
6,8479675,Trevor Moore,L,LAK,29,82,23,33,56
6,8478401,Pavel Zacha,C,BOS,27,82,22,34,56
6,8470613,Brent Burns,D,CAR,39,82,20,36,56
6,8475168,Matt Duchene,C,DAL,33,82,17,39,56
6,8481581,Thomas Harley,D,DAL,23,82,14,42,56
6,8479339,Patrik Laine,L,CBJ,26,82,31,24,55
6,8478498,Jake DeBrusk,L,BOS,28,82,28,27,55
6,8480830,Andrei Svechnikov,R,CAR,24,82,20,35,55
6,8476875,Mike Matheson,D,MTL,30,82,14,41,55
6,8475798,Mikael Granlund,C,SJS,32,82,11,44,55
6,8475314,Anders Lee,L,NYI,34,82,27,27,54
6,8482097,Jack Quinn,R,BUF,23,82,26,28,54
6,8475768,Jaden Schwartz,C,SEA,32,82,25,29,54
6,8482745,Mason McTavish,C,ANA,21,82,24,30,54
6,8477444,Andre Burakovsky,L,SEA,29,82,21,33,54
6,8475170,Brayden Schenn,C,STL,33,82,18,36,54
6,8471724,Kris Letang,D,PIT,37,82,18,36,54
6,8480078,Filip Chytil,C,NYR,25,82,18,36,54
6,8475744,Evgeny Kuznetsov,C,CAR,32,82,17,37,54
6,8476792,Torey Krug,D,STL,33,82,12,42,54
6,8477503,Max Domi,C,TOR,29,82,10,44,54
6,8482146,Luke Evangelista,R,NSH,22,82,28,25,53
6,8476399,Blake Coleman,C,CGY,33,82,26,27,53
6,8476483,Rickard Rakell,R,PIT,31,82,21,32,53
6,8478856,Conor Garland,R,VAN,28,82,19,34,53
6,8473563,Nicklas Backstrom,C,WSH,37,82,16,37,53
6,8476905,Chandler Stephenson,C,VGK,30,82,15,38,53
6,8477494,Jonathan Drouin,L,COL,29,82,13,40,53
6,8479525,Ross Colton,C,COL,28,82,13,40,53
6,8478366,Frank Vatrano,R,ANA,30,82,30,22,52
6,8476880,Tom Wilson,R,WSH,30,82,26,26,52
6,8475745,Charlie Coyle,C,BOS,32,82,20,32,52
6,8478542,Evan Rodrigues,C,FLA,31,82,19,33,52
6,8478038,Devon Toews,D,COL,30,82,16,36,52
6,8477986,Brandon Montour,D,FLA,30,82,15,37,52
6,8480434,Sean Durzi,D,ARI,26,82,15,37,52
6,8478115,Pierre Engvall,L,NYI,28,82,14,38,52
6,8475793,Ryan Johansen,C,PHI,32,82,28,23,51
6,8475191,Reilly Smith,R,PIT,33,82,26,25,51
6,8475722,Jason Zucker,L,NSH,32,82,25,26,51
6,8481596,Shane Pinto,C,OTT,24,82,24,27,51
6,8480015,Owen Tippett,R,PHI,25,82,22,29,51
6,8474150,Mikael Backlund,C,CGY,35,82,20,31,51
6,8477416,Oliver Bjorkstrand,R,SEA,29,82,18,33,51
6,8477497,Sean Monahan,C,WPG,30,82,13,38,51
6,8476462,Dougie Hamilton,D,NJD,31,82,12,39,51
6,8477346,MacKenzie Weegar,D,CGY,30,82,11,40,51
6,8478469,Thomas Chabot,D,OTT,27,82,9,42,51
6,8471698,T.J. Oshie,R,WSH,38,82,29,21,50
6,8477021,Alex Kerfoot,C,ARI,30,82,20,30,50
6,8475287,Erik Haula,L,NJD,33,82,18,32,50
6,8474102,David Perron,L,DET,36,82,18,32,50
6,8476479,Phillip Danault,C,LAK,31,82,14,36,50
6,8477495,Seth Jones,D,CHI,30,82,10,40,50
6,8475151,Kyle Palmieri,C,NYI,33,82,28,21,49
6,8480009,Eeli Tolvanen,R,SEA,25,82,23,26,49
6,8476456,Jonathan Huberdeau,C,CGY,31,82,11,38,49
6,8482159,Tyson Foerster,R,PHI,22,82,28,20,48
6,8482699,Dylan Guenther,R,ARI,21,82,24,24,48
6,8474641,Adam Henrique,C,EDM,34,82,23,25,48
6,8478466,Daniel Sprong,R,DET,27,82,20,28,48
6,8482665,Matty Beniers,C,SEA,22,82,18,30,48
6,8482222,Alexander Barabanov,L,SJS,30,82,23,24,47
6,8478233,Andrew Mangiapane,L,CGY,28,82,22,25,47
6,8476458,Ryan Strome,C,ANA,31,82,21,26,47
6,8477953,Kasperi Kapanen,R,STL,28,82,20,27,47
6,8477932,Aaron Ekblad,D,FLA,28,82,13,34,47
6,8476872,Scott Laughton,C,PHI,30,82,13,34,47
6,8477429,Andrew Copp,C,DET,30,82,8,39,47
6,8482109,Alexis Lafrenière,L,NYR,23,82,27,19,46
6,8476438,Brandon Saad,L,STL,32,82,26,20,46
6,8483808,Andrei Kuzmenko,L,CGY,28,82,19,27,46
6,8481618,Alex Newhook,C,MTL,23,82,18,28,46
6,8474586,Jordan Eberle,R,SEA,34,82,14,32,46
6,8475197,Tyson Barrie,D,NSH,33,82,12,34,46
6,8480797,Joel Farabee,L,PHI,24,82,13,32,45
6,8480798,Philipp Kurashev,C,CHI,25,82,13,32,45
6,8475218,Mattias Ekholm,D,EDM,34,82,9,36,45
6,8482720,Matthew Knies,L,TOR,22,82,24,20,44
6,8478046,Danton Heinen,L,BOS,29,82,23,21,44
6,8477511,Anthony Mantha,R,VGK,30,82,22,22,44
6,8476461,Sean Couturier,C,PHI,32,82,20,24,44
6,8484144,Connor Bedard,C,CHI,19,82,19,25,44
6,8471218,Blake Wheeler,R,NYR,38,82,18,26,44
6,8479425,Filip Hronek,D,VAN,27,82,12,32,44
6,8474563,Drew Doughty,D,LAK,35,82,10,34,44
6,8478396,Noah Hanifin,D,VGK,27,82,9,35,44
6,8480145,Neal Pionk,D,WPG,29,82,9,35,44
6,8475906,John Klingberg,D,TOR,32,82,6,38,44
6,8476892,Colton Parayko,D,STL,31,82,5,39,44
6,8475714,Calle Jarnkrok,C,TOR,33,82,21,22,43
6,8475848,Brendan Gallagher,R,MTL,32,82,20,23,43
6,8476925,Colton Sissons,C,NSH,31,82,20,23,43
6,8475799,Nino Niederreiter,R,WPG,32,82,19,24,43
6,8478438,Tommy Novak,C,NSH,27,82,17,26,43
6,8479400,Pierre-Luc Dubois,L,LAK,26,82,15,28,43
6,8480871,Adam Boqvist,D,CBJ,24,82,14,29,43
6,8476958,Jaccob Slavin,D,CAR,30,82,8,35,43
6,8474565,Alex Pietrangelo,D,VGK,34,82,7,36,43
6,8482175,JJ Peterka,R,BUF,22,82,21,21,42
6,8475794,Tyler Seguin,C,DAL,32,82,21,21,42
6,8478057,Dakota Joshua,C,VAN,28,82,21,21,42
6,8474157,Max Pacioretty,L,WSH,36,82,21,21,42
6,8478463,Anthony Beauvillier,L,NSH,27,82,19,23,42
6,8474189,Lars Eller,C,PIT,35,82,19,23,42
6,8479365,Trent Frederic,C,BOS,26,82,18,24,42
6,8476882,Teuvo Teravainen,L,CAR,30,82,18,24,42
6,8476480,Vladislav Namestnikov,C,WPG,32,82,18,24,42
6,8480849,Barrett Hayton,C,ARI,24,82,16,26,42
6,8482133,Thomas Bordeleau,C,SJS,22,82,14,28,42
6,8479514,Rem Pitlick,C,CHI,27,82,14,28,42
6,8476869,Brady Skjei,D,CAR,30,82,10,32,42
6,8475764,Cam Fowler,D,ANA,33,82,3,39,42
6,8474037,James van Riemsdyk,L,BOS,35,82,19,22,41
6,8477998,Warren Foegele,L,EDM,28,82,18,23,41
6,8470604,Jeff Carter,C,PIT,39,82,15,26,41
6,8482671,Owen Power,D,BUF,22,82,12,29,41
6,8481604,Pavel Dorofeyev,L,VGK,24,82,22,18,40
6,8482117,Lukas Reichel,L,CHI,22,82,18,22,40
6,8479987,Morgan Geekie,C,BOS,26,82,17,23,40
6,8481553,Bobby Brink,R,PHI,23,82,17,23,40
6,8478458,Jack Roslovic,C,NYR,27,82,16,24,40
6,8478413,Jordan Greenway,L,BUF,27,82,16,24,40
6,8476292,Ondrej Palat,L,NJD,33,82,12,28,40
6,8480802,Ryan McLeod,C,EDM,25,82,12,28,40
6,8477948,Travis Sanheim,D,PHI,28,82,10,30,40
6,8476854,Hampus Lindholm,D,BOS,30,82,9,31,40
6,8475791,Taylor Hall,L,CHI,33,82,7,33,40
6,8482105,Jake Sanderson,D,OTT,22,82,18,21,39
6,8481624,Ilya Mikheyev,R,VAN,30,82,17,22,39
6,8478474,Lawson Crouse,L,ARI,27,82,11,28,39
6,8476392,Adam Lowry,C,WPG,31,82,11,28,39
6,8481606,Jordan Spence,D,LAK,23,82,5,34,39
6,8473422,Nick Foligno,L,CHI,37,82,22,16,38
6,8475763,Kevin Hayes,R,STL,32,82,19,19,38
6,8480893,Kirill Marchenko,R,CBJ,24,82,18,20,38
6,8481560,Arthur Kaliyev,R,LAK,23,82,18,20,38
6,8478020,Michael Amadio,C,VGK,28,82,18,20,38
6,8477426,Nicholas Paul,L,TBL,29,82,17,21,38
6,8482092,Ridly Greig,C,OTT,22,82,17,21,38
6,8481554,Kaapo Kakko,R,NYR,23,82,17,21,38
6,8480185,Eetu Luostarinen,C,FLA,26,82,15,23,38
6,8475149,Marcus Johansson,L,MIN,34,82,14,24,38
6,8474151,Ryan McDonagh,D,NSH,35,82,3,35,38
6,8479390,Taylor Raddysh,R,CHI,26,82,21,16,37
6,8479661,Tanner Jeannot,L,TBL,27,82,19,18,37
6,8476312,Josh Manson,D,COL,33,82,15,22,37
6,8474053,Logan Couture,C,SJS,35,82,13,24,37
6,8480817,K'Andre Miller,D,NYR,24,82,8,29,37
6,8480807,Mattias Samuelsson,D,BUF,24,82,6,31,37
6,8476923,Damon Severson,D,CBJ,30,82,5,32,37
6,8480873,Rasmus Sandin,D,WSH,24,82,4,33,37
6,8478500,Ivan Provorov,D,CBJ,27,82,4,33,37
6,8473449,Kyle Okposo,R,FLA,36,82,22,14,36
6,8479996,Cody Glass,C,NSH,25,82,19,17,36
6,8470621,Corey Perry,R,EDM,39,82,19,17,36
6,8476897,Oskar Sundqvist,C,STL,30,82,16,20,36
6,8479415,Michael McLeod,C,NJD,26,82,15,21,36
6,8475760,Nick Bjugstad,C,ARI,32,82,15,21,36
6,8476826,Yanni Gourde,C,SEA,33,82,12,24,36
6,8478891,Mason Appleton,C,WPG,28,82,12,24,36
6,8481703,Valtteri Puustinen,R,PIT,25,82,8,28,36
6,8475171,Oliver Ekman-Larsson,D,FLA,33,82,6,30,36
6,8482079,Marco Rossi,C,MIN,23,82,19,16,35
6,8482667,William Eklund,L,SJS,22,82,14,21,35
6,8478109,Victor Olofsson,L,BUF,29,82,14,21,35
6,8474715,Cam Atkinson,R,PHI,35,82,14,21,35
6,8477947,Sonny Milano,L,WSH,28,82,13,22,35
6,8480336,Sean Walker,D,COL,30,82,13,22,35
6,8476960,Andreas Athanasiou,C,CHI,30,82,12,23,35
6,8478472,Mathieu Joseph,R,OTT,27,82,11,24,35
6,8478462,Nicolas Roy,C,VGK,27,82,10,25,35
6,8478911,Matt Roy,D,LAK,29,82,7,28,35
6,8476469,Joel Armia,R,MTL,31,82,22,12,34
6,8480068,Ryan Poehling,C,PHI,25,82,16,18,34
6,8482475,Yegor Chinakhov,R,CBJ,23,82,15,19,34
6,8475220,Marcus Foligno,L,MIN,33,82,15,19,34
6,8476885,Jacob Trouba,D,NYR,30,82,13,21,34
6,8476927,Teddy Blueger,C,VAN,30,82,13,21,34
6,8476873,Mark Jankowski,C,NSH,30,82,13,21,34
6,8476906,Shayne Gostisbehere,D,DET,31,82,11,23,34
6,8473533,Jordan Staal,C,CAR,36,82,10,24,34
6,8481704,Juuso Parssinen,C,NSH,23,82,9,25,34
6,8481546,Cam York,D,PHI,23,82,6,28,34
6,8477969,Marcus Pettersson,D,PIT,28,82,5,29,34
6,8474149,Evgenii Dadonov,R,DAL,35,82,16,17,33
6,8480281,Alexey Toropchenko,R,STL,25,82,16,17,33
6,8478013,Jake Walman,D,DET,28,82,14,19,33
6,8480806,Isac Lundestrom,C,ANA,25,82,13,20,33
6,8477450,Jason Dickinson,C,CHI,29,82,9,24,33
6,8477488,Brett Pesce,D,CAR,30,82,8,25,33
6,8476917,Adam Pelech,D,NYI,30,82,6,27,33
6,8476979,Erik Gustafsson,D,NYR,32,82,5,28,33
6,8477498,Darnell Nurse,D,EDM,29,82,4,29,33
6,8479393,Noah Gregor,C,TOR,26,82,21,11,32
6,8474870,Tyler Johnson,C,CHI,34,82,15,17,32
6,8480813,Joe Veleno,C,DET,24,82,15,17,32
6,8479353,Brett Howden,C,VGK,26,82,13,19,32
6,8482055,Drew O'Connor,L,PIT,26,82,13,19,32
6,8480220,Noah Cates,L,PHI,25,82,12,20,32
6,8484166,Adam Fantilli,C,CBJ,20,82,12,20,32
6,8482125,Alexander Holtz,R,NJD,22,82,12,20,32
6,8481481,Blake Lizotte,C,LAK,27,82,12,20,32
6,8479591,Michael Eyssimont,C,TBL,28,82,11,21,32
6,8477839,Conor Sheary,L,TBL,32,82,8,24,32
6,8479398,Samuel Girard,D,COL,26,82,6,26,32
6,8476331,Dylan DeMelo,D,WPG,31,82,3,29,32
6,8470610,Zach Parise,L,COL,40,82,16,15,31
6,8479977,Kailer Yamamoto,R,SEA,26,82,13,18,31
6,8476981,Josh Anderson,R,MTL,30,82,13,18,31
6,8479976,Juuso Valimaki,D,ARI,26,82,7,24,31
6,8482122,Brock Faber,D,MIN,22,82,5,26,31
6,8480043,Timothy Liljegren,D,TOR,25,82,3,28,31
6,8479324,Ryan Lindgren,D,NYR,26,82,2,29,31
6,8476921,Jordan Martinook,L,CAR,32,82,21,9,30
6,8481656,Aliaksei Protas,C,WSH,23,82,14,16,30
6,8475343,Nic Dowd,C,WSH,34,82,13,17,30
6,8483457,Lane Hutson,D,MTL,20,82,10,20,30
6,8477435,Ryan Graves,D,PIT,29,82,9,21,30
6,8482062,Cole Smith,L,NSH,29,82,18,11,29
6,8478508,Yakov Trenin,C,COL,27,82,16,13,29
6,8478043,Sam Lafferty,C,VAN,29,82,16,13,29
6,8483431,Logan Cooley,C,ARI,20,82,16,13,29
6,8481013,Jonatan Berggren,R,DET,24,82,14,15,29
6,8479992,Michael Rasmussen,C,DET,25,82,12,17,29
6,8480855,Jack McBain,C,ARI,24,82,12,17,29
6,8479351,Sam Steel,C,DAL,26,82,11,18,29
6,8477989,Christian Dvorak,C,MTL,28,82,10,19,29
6,8479359,Beck Malenstyn,L,WSH,26,82,9,20,29
6,8470966,Mark Giordano,D,TOR,41,82,9,20,29
6,8476422,Mike Reilly,D,NYI,31,82,9,20,29
6,8477220,Nate Schmidt,D,WPG,33,82,8,21,29
6,8474716,Jared Spurgeon,D,MIN,35,82,7,22,29
6,8476902,Esa Lindell,D,DAL,30,82,7,22,29
6,8475200,Dmitry Orlov,D,CAR,33,82,7,22,29
6,8473507,Jeff Petry,D,DET,37,82,5,24,29
6,8480879,Jacob Bernard-Docker,D,OTT,24,82,5,24,29
6,8476879,Cody Ceci,D,EDM,31,82,2,27,29
6,8481580,Connor McMichael,C,WSH,23,82,10,18,28
6,8482111,Justin Barron,D,MTL,23,82,10,18,28
6,8476419,Jean-Gabriel Pageau,C,NYI,32,82,9,19,28
6,8483490,Pavel Mintyukov,D,ANA,21,82,7,21,28
6,8478133,Jake Evans,C,MTL,28,82,6,22,28
6,8476891,Matt Grzelcyk,D,BOS,30,82,5,23,28
6,8478507,John Marino,D,NJD,27,82,5,23,28
6,8477952,Robby Fabbri,C,DET,28,82,15,12,27
6,8475842,Sam Carrick,C,EDM,32,82,15,12,27
6,8480995,Pontus Holmberg,R,TOR,25,82,12,15,27
6,8482803,Olen Zellweger,D,ANA,21,82,12,15,27
6,8480459,Pius Suter,C,VAN,28,82,11,16,27
6,8484153,Leo Carlsson,C,ANA,20,82,9,18,27
6,8476463,Jonas Brodin,D,MIN,31,82,7,20,27
6,8478399,Jonas Siegenthaler,D,NJD,27,82,2,25,27
6,8474673,TJ Brodie,D,TOR,34,82,1,26,27
6,8481535,Nils Hoglander,L,VAN,24,82,16,10,26
6,8477406,Mattias Janmark,C,EDM,32,82,15,11,26
6,8476329,Travis Boyd,C,ARI,31,82,14,12,26
6,8473504,Cal Clutterbuck,R,NYI,37,82,14,12,26
6,8479293,Brandon Tanev,L,SEA,33,82,13,13,26
6,8476374,Sean Kuraly,C,CBJ,31,82,12,14,26
6,8479383,Boris Katchouk,L,OTT,26,82,12,14,26
6,8481186,Logan O'Connor,R,COL,28,82,11,15,26
6,8480821,Filip Zadina,R,SJS,25,82,11,15,26
6,8477392,Hudson Fasching,R,NYI,29,82,9,17,26
6,8478055,Gustav Forsling,D,FLA,28,82,8,18,26
6,8475181,Nick Leddy,D,STL,33,82,5,21,26
6,8482655,J.J. Moser,D,ARI,24,82,5,21,26
6,8478451,Ethan Bear,D,WSH,27,82,5,21,26
6,8480073,Erik Brannstrom,D,OTT,25,82,3,23,26
6,8476871,Tanner Pearson,L,MTL,32,82,12,13,25
6,8482259,Bobby McMann,C,TOR,28,82,12,13,25
6,8477944,Jakub Vrana,L,STL,28,82,11,14,25
6,8476467,Jamie Oleksiak,D,SEA,32,82,10,15,25
6,8482624,Daniil Miromanov,D,CGY,27,82,8,17,25
6,8477506,Ryan Pulock,D,NYI,30,82,7,18,25
6,8481014,Alexander Romanov,D,NYI,24,82,7,18,25
6,8477425,Miles Wood,L,COL,29,82,6,19,25
6,8474034,Pat Maroon,L,BOS,36,82,5,20,25
6,8481568,Alex Vlasic,D,CHI,23,82,5,20,25
6,8478569,Noel Acciari,C,PIT,33,82,13,11,24
6,8479346,Dillon Dube,C,CGY,26,82,12,12,24
6,8483515,Juraj Slafkovsky,L,MTL,20,82,11,13,24
6,8480144,David Kampf,C,TOR,29,82,11,13,24
6,8483445,Cutter Gauthier,L,ANA,20,82,11,13,24
6,8480074,Alexandre Texier,C,CBJ,25,82,10,14,24
6,8482666,Scott Morrow,D,CAR,22,82,10,14,24
6,8483482,Tristan Luneau,D,ANA,20,82,10,14,24
6,8481093,Rafael Harvey-Pinard,L,MTL,25,82,9,15,24
6,8482705,Cole Sillinger,C,CBJ,21,82,7,17,24
6,8477353,Tyler Motte,C,TBL,29,82,7,17,24
6,8476429,Scott Mayfield,D,NYI,32,82,7,17,24
6,8476931,Jake McCabe,D,TOR,31,82,5,19,24
6,8482142,Jamie Drysdale,D,PHI,22,82,5,19,24
6,8477499,Rasmus Ristolainen,D,PHI,30,82,3,21,24
6,8475455,Brenden Dillon,D,WPG,34,82,2,22,24
6,8480035,Henri Jokiharju,D,BUF,25,82,1,23,24
6,8473453,Trevor Lewis,C,LAK,37,82,16,7,23
6,8477330,Dominik Kubalik,L,OTT,29,82,15,8,23
6,8484145,Zach Benson,L,BUF,19,82,12,11,23
6,8483524,Shane Wright,C,SEA,20,82,12,11,23
6,8482074,Connor Zary,C,CGY,23,82,11,12,23
6,8480058,Pierre-Olivier Joseph,D,PIT,25,82,11,12,23
6,8477919,Frederick Gaudreau,C,MIN,31,82,9,14,23
6,8477369,Carson Soucy,D,VAN,30,82,9,14,23
6,8475177,Calvin de Haan,D,TBL,33,82,9,14,23
6,8477015,Connor Brown,R,EDM,30,82,8,15,23
6,8483565,Nick Blankenburg,D,CBJ,26,82,8,15,23
6,8479980,Nicolas Hague,D,VGK,26,82,5,18,23
6,8482087,Kaiden Guhle,D,MTL,22,82,4,19,23
6,8475462,Radko Gudas,D,ANA,34,82,3,20,23
6,8478136,Jake Middleton,D,MIN,28,82,2,21,23
6,8481178,Egor Zamula,D,PHI,24,82,1,22,23
6,8479941,Justin Danforth,R,CBJ,31,82,14,8,22
6,8481477,Nico Sturm,C,SJS,29,82,14,8,22
6,8474884,Mike Hoffman,C,SJS,35,82,10,12,22
6,8482858,Ryker Evans,D,SEA,23,82,10,12,22
6,8482166,Shakir Mukhamadullin,D,SJS,22,82,8,14,22
6,8477507,Nikita Zadorov,D,VAN,29,82,6,16,22
6,8477845,Trevor van Riemsdyk,D,WSH,33,82,6,16,22
6,8478416,Erik Cernak,D,TBL,27,82,6,16,22
6,8475164,Jakob Silfverberg,R,ANA,34,82,4,18,22
6,8475179,Dmitry Kulikov,D,FLA,34,82,4,18,22
6,8475233,David Savard,D,MTL,34,82,4,18,22
6,8476278,Colin Blackwell,C,CHI,31,82,15,6,21
6,8483493,Frank Nazar,C,CHI,20,82,13,8,21
6,8476624,Barclay Goodrow,C,NYR,31,82,12,9,21
6,8476442,Matt Nieto,L,PIT,32,82,11,10,21
6,8484203,Bradly Nadeau,L,CAR,19,82,10,11,21
6,8481567,Henry Thrun,D,SJS,23,82,8,13,21
6,8474013,Ian Cole,D,VAN,35,82,6,15,21
6,8479983,Mario Ferraro,D,SJS,26,82,5,16,21
6,8482470,Ilya Solovyov,D,CGY,24,82,5,16,21
6,8478430,Oliver Kylington,D,CGY,27,82,5,16,21
6,8479369,Andrew Peeke,D,BOS,26,82,3,18,21
6,8476457,Adam Larsson,D,SEA,32,82,2,19,21
6,8475825,Jani Hakanpää,D,DAL,32,82,2,19,21
6,8477505,Alexander Wennberg,C,NYR,30,82,11,9,20
6,8480834,Ty Emberson,D,SJS,24,82,7,13,20
6,8478882,Vladislav Gavrikov,D,LAK,29,82,4,16,20
6,8476525,Colin Miller,D,WPG,32,82,4,16,20
6,8483468,Jiri Kulich,C,BUF,20,82,11,8,19
6,8482679,Matt Coronato,R,CGY,22,82,10,9,19
6,8483763,Maksymilian Szuber,D,ARI,22,82,10,9,19
6,8475231,Casey Cizikas,C,NYI,33,82,9,10,19
6,8477931,Tomas Nosek,L,NJD,32,82,8,11,19
6,8481059,Scott Perunovich,D,STL,26,82,8,11,19
6,8481537,Nikita Okhotiuk,D,CGY,24,82,7,12,19
6,8482145,Mavrik Bourque,C,DAL,22,82,7,12,19
6,8481522,Peyton Krebs,C,BUF,23,82,6,13,19
6,8483505,Matthew Poitras,C,BOS,20,82,6,13,19
6,8480860,Kevin Bahl,D,NJD,24,82,6,13,19
6,8480246,Nick Perbix,D,TBL,26,82,5,14,19
6,8474166,Alec Martinez,D,VGK,37,82,4,15,19
6,8476967,Brett Kulak,D,EDM,30,82,2,17,19
6,8475188,Brayden McNabb,D,VGK,33,82,2,17,19
6,8480172,Jan Rutta,D,SJS,34,82,2,17,19
6,8475208,Brian Dumoulin,D,SEA,33,82,1,18,19
6,8482155,Alex Laferriere,R,LAK,23,82,12,6,18
6,8481601,Simon Holmstrom,R,NYI,23,82,10,8,18
6,8482702,Logan Stankoven,C,DAL,21,82,8,10,18
6,8484911,Collin Graf,R,SJS,22,82,8,10,18
6,8484149,Gavin Brindley,C,CBJ,20,82,8,10,18
6,8483012,Logan Morrison,C,SEA,22,82,8,10,18
6,8479316,Luke Kunin,C,SJS,27,82,7,11,18
6,8481028,Martin Pospisil,C,CGY,25,82,7,11,18
6,8474009,Nick Bonino,C,NYR,36,82,7,11,18
6,8470600,Ryan Suter,D,DAL,39,82,5,13,18
6,8475279,Ben Chiarot,D,DET,33,82,4,14,18
6,8481599,Victor Soderstrom,D,ARI,23,82,4,14,18
6,8478840,Will Borgen,D,SEA,28,82,3,15,18
6,8478851,Alexandre Carrier,D,NSH,28,82,2,16,18
6,8482245,Artem Zub,D,OTT,29,82,2,16,18
6,8482807,Ethan Del Mastro,D,CHI,21,82,7,10,17
6,8482118,Sam Colangelo,R,ANA,23,82,6,11,17
6,8483471,Brad Lambert,C,WPG,31,82,4,13,17
6,8479371,Dante Fabbro,D,NSH,26,82,3,14,17
6,8480796,Martin Fehervary,D,WSH,25,82,3,14,17
6,8475324,Nick Jensen,D,WSH,34,82,3,14,17
6,8476878,Zemgus Girgensons,L,BUF,30,82,11,5,16
6,8481517,Brett Leason,R,ANA,25,82,9,7,16
6,8477508,Curtis Lazar,C,NJD,29,82,9,7,16
6,8478408,Travis Dermott,D,ARI,28,82,8,8,16
6,8474574,Tyler Myers,D,VAN,34,82,4,12,16
6,8482730,Brandt Clarke,D,LAK,21,82,3,13,16
6,8478178,Darren Raddysh,D,TBL,28,82,2,14,16
6,8481016,Ruslan Iskhakov,C,NYI,24,82,1,15,16
6,8480448,Parker Kelly,L,OTT,25,82,9,6,15
6,8479291,Kevin Rooney,C,CGY,31,82,8,7,15
6,8471677,Jack Johnson,D,COL,37,82,6,9,15
6,8481605,Jackson LaCombe,D,ANA,23,82,5,10,15
6,8481030,Jack St. Ivany,D,PIT,25,82,5,10,15
6,8479442,Troy Stecher,D,EDM,30,82,4,11,15
6,8482073,Braden Schneider,D,NYR,23,82,1,14,15
6,8475690,Chris Tanev,D,DAL,35,82,1,14,15
6,8476915,Jujhar Khaira,L,MIN,30,82,8,6,14
6,8482809,Jackson Blake,R,CAR,21,82,8,6,14
6,8483491,Ivan Miroshnichenko,L,WSH,20,82,7,7,14
6,8483499,Liam Ohgren,L,MIN,20,82,7,7,14
6,8482101,Danil Gushchin,L,SJS,22,82,6,8,14
6,8482762,Simon Edvinsson,D,DET,21,82,5,9,14
6,8475790,Erik Gudbranson,D,CBJ,32,82,4,10,14
6,8481524,Bowen Byram,D,BUF,23,82,3,11,14
6,8478443,Brandon Carlo,D,BOS,28,82,2,12,14
6,8483466,Kevin Korchinski,D,CHI,20,82,2,12,14
6,8474567,Zach Bogosian,D,MIN,34,82,2,12,14
6,8476858,Phillip Di Giuseppe,L,VAN,31,82,8,5,13
6,8478831,Kevin Stenlund,C,FLA,28,82,8,5,13
6,8483397,Marc McLaughlin,C,BOS,25,82,7,6,13
6,8482737,Zack Bolduc,C,STL,21,82,5,8,13
6,8481699,Aku Raty,R,ARI,23,82,5,8,13
6,8482733,Logan Mailloux,D,MTL,31,82,5,8,13
6,8478468,Jeremy Lauzon,D,NSH,27,82,4,9,13
6,8482712,Oskar Olausson,R,COL,22,82,2,11,13
6,8476473,Connor Murphy,D,CHI,31,82,1,12,13
6,8477365,Connor Clifton,D,BUF,29,82,0,13,13
6,8480990,Declan Chisholm,D,MIN,24,82,4,8,12
6,8482177,Marat Khusnutdinov,C,MIN,22,82,4,8,12
6,8483495,Simon Nemec,D,NJD,20,82,4,8,12
6,8481578,Graeme Clarke,R,NJD,23,82,4,8,12
6,8476372,Nick Seeler,D,PHI,31,82,2,10,12
6,8479998,Mikey Anderson,D,LAK,25,82,1,11,12
6,8480031,Maxime Comtois,L,CAR,25,82,4,7,11
6,8477034,Jaycob Megna,D,CHI,32,82,3,8,11
6,8479423,Alex Nylander,L,CBJ,26,82,7,3,10
6,8476822,Luke Glendening,C,TBL,35,82,5,5,10
6,8477335,Kyle Burroughs,D,SJS,29,82,2,8,10
6,8478859,Niko Mikkola,D,FLA,28,82,0,10,10
6,8475762,Derek Forbort,D,BOS,32,82,1,8,9
6,8483489,Fraser Minten,C,TOR,31,82,3,5,8
6,8482859,Zack Ostapchuk,C,OTT,21,82,1,7,8
6,8482713,Mackie Samoskevich,R,FLA,22,82,3,4,7
6,8482516,Matthew Kessel,D,STL,24,82,1,6,7
6,8477950,Tony DeAngelo,D,CAR,29,0,0,0,0
6,8481577,Philip Tomasino,C,NSH,23,0,0,0,0
6,8482660,Kent Johnson,C,CBJ,22,0,0,0,0
6,8481019,David Gustafsson,C,WPG,24,0,0,0,0
6,8479348,Kale Clague,D,BUF,26,0,0,0,0
6,8482149,Cole Perfetti,C,WPG,22,0,0,0,0
6,8476952,Dominic Toninato,C,WPG,30,0,0,0,0
6,8473473,Milan Lucic,L,BOS,36,0,0,0,0
6,8480829,Jesperi Kotkaniemi,C,CAR,24,0,0,0,0
6,8474602,Justin Schultz,D,SEA,34,0,0,0,0
6,8480049,Dylan Samberg,D,WPG,25,0,0,0,0
6,8479372,Josh Mahura,D,FLA,26,0,0,0,0
6,8480878,Nils Lundkvist,D,DAL,24,0,0,0,0
6,8479982,Conor Timmins,D,TOR,26,0,0,0,0
6,8474031,Kevin Shattenkirk,D,BOS,35,0,0,0,0
6,8480835,Jack Drury,C,CAR,24,0,0,0,0
6,8480008,Adam Ruzicka,C,ARI,25,0,0,0,0
6,8479402,Jake Bean,D,CBJ,26,0,0,0,0
6,8476474,Stefan Noesen,R,CAR,31,0,0,0,0
6,8480884,Calen Addison,D,SJS,24,0,0,0,0
6,8476994,Vinnie Hinostroza,C,PIT,30,0,0,0,0
6,8477987,Ryan Donato,C,CHI,28,0,0,0,0
6,8481582,Nicholas Robertson,L,TOR,23,0,0,0,0
6,8478452,Caleb Jones,D,COL,27,0,0,0,0
6,8480157,Calle Rosen,D,STL,30,0,0,0,0
6,8481609,Vladislav Kolyachonok,D,ARI,23,0,0,0,0
6,8476919,Chris Tierney,C,NJD,30,0,0,0,0
6,8479639,Dylan Coghlan,D,CAR,26,0,0,0,0
6,8475193,Tomas Tatar,L,SEA,34,0,0,0,0
6,8480748,Kiefer Sherwood,L,NSH,29,0,0,0,0
6,8478146,Matthew Highmore,C,OTT,28,0,0,0,0
6,8478970,Jalen Chatfield,D,CAR,28,0,0,0,0
6,8480205,Emil Bemstrom,C,PIT,25,0,0,0,0
6,8471274,Alex Goligoski,D,MIN,39,0,0,0,0
6,8478104,Sammy Blais,L,STL,28,0,0,0,0
6,8476913,Devin Shore,C,SEA,30,0,0,0,0
6,8481708,Zac Jones,D,NYR,24,0,0,0,0
6,8480222,Sebastian Aho,D,NYI,28,0,0,0,0
6,8481598,Philip Broberg,D,EDM,23,0,0,0,0
6,8480789,Oliver Wahlstrom,R,NYI,24,0,0,0,0
6,8480891,Michael Kesselring,D,ARI,24,0,0,0,0
6,8477979,Nicolas Aube-Kubel,R,WSH,28,0,0,0,0
6,8476393,Nick Cousins,C,FLA,31,0,0,0,0
6,8480003,Jesper Boqvist,C,BOS,26,0,0,0,0
6,8479543,Michael Pezzetta,L,MTL,26,0,0,0,0
6,8475855,Jesper Fast,R,CAR,33,0,0,0,0
6,8477018,Ben Hutton,D,VGK,31,0,0,0,0
6,8480762,Eric Robinson,L,BUF,29,0,0,0,0
6,8481058,Jesse Ylönen,R,MTL,25,0,0,0,0
6,8481527,Kaedan Korczak,D,VGK,23,0,0,0,0
6,8482192,Isaak Phillips,D,CHI,23,0,0,0,0
6,8480727,Zach Whitecloud,D,VGK,28,0,0,0,0
6,8480001,Urho Vaakanainen,D,ANA,25,0,0,0,0
6,8480853,Liam Foudy,C,NSH,24,0,0,0,0
6,8475225,Craig Smith,C,DAL,35,0,0,0,0
6,8479972,Mason Shaw,C,MIN,26,0,0,0,0
6,8474040,Sam Gagner,C,EDM,35,0,0,0,0
6,8480196,Jacob Bryson,D,BUF,27,0,0,0,0
6,8475718,Justin Holl,D,DET,32,0,0,0,0
6,8479984,Cal Foote,D,NJD,26,0,0,0,0
6,8480011,Klim Kostin,C,SJS,25,0,0,0,0
6,8482176,Wyatt Kaiser,D,CHI,22,0,0,0,0
6,8476918,Jimmy Vesey,L,NYR,31,0,0,0,0
6,8476988,Matt Benning,D,SJS,30,0,0,0,0
6,8479370,Tyson Jost,C,BUF,26,0,0,0,0
6,8477464,Nic Petan,C,MIN,29,0,0,0,0
6,8477380,Jonny Brodzinski,C,NYR,31,0,0,0,0
6,8480070,Ian Mitchell,D,BOS,25,0,0,0,0
6,8479315,Joey Anderson,R,CHI,26,0,0,0,0
6,8478099,Kevin Labanc,R,SJS,29,0,0,0,0
6,8476874,Olli Maatta,D,DET,30,0,0,0,0
6,8479414,Nathan Bastian,R,NJD,27,0,0,0,0
6,8478434,Keegan Kolesar,R,VGK,27,0,0,0,0
6,8479536,Axel Jonsson-Fjallby,L,WPG,26,0,0,0,0
6,8479671,Mathieu Olivier,R,CBJ,27,0,0,0,0
6,8471709,Marc-Edouard Vlasic,D,SJS,37,0,0,0,0
6,8479328,Julien Gauthier,R,NYI,27,0,0,0,0
6,8478421,A.J. Greer,L,CGY,28,0,0,0,0
6,8477573,Nathan Walker,L,STL,30,0,0,0,0
6,8477478,William Carrier,L,VGK,30,0,0,0,0
6,8479344,Jesse Puljujarvi,R,PIT,26,0,0,0,0
6,8480887,Jordan Harris,D,MTL,24,0,0,0,0
6,8478502,Dennis Gilbert,D,CGY,28,0,0,0,0
6,8480355,Mark Kastelic,C,OTT,25,0,0,0,0
6,8475750,Jon Merrill,D,MIN,32,0,0,0,0
6,8476889,Radek Faksa,C,DAL,30,0,0,0,0
6,8478432,Christian Fischer,R,DET,27,0,0,0,0
6,8479439,Jacob MacDonald,D,SJS,31,0,0,0,0
6,8474568,Luke Schenn,D,NSH,35,0,0,0,0
6,8478454,Noah Juulsen,D,VAN,27,0,0,0,0
6,8475752,Tyler Pitlick,C,NYR,33,0,0,0,0
6,8482148,Hendrix Lapierre,C,WSH,22,0,0,0,0
6,8481167,Brayden Pachal,D,CGY,25,0,0,0,0
6,8478211,Dryden Hunt,L,CGY,29,0,0,0,0
6,8479321,Lucas Johansen,D,WSH,27,0,0,0,0
6,8480950,Ilya Lyubushkin,D,TOR,30,0,0,0,0
6,8479368,Max Jones,L,ANA,26,0,0,0,0
6,8471699,Andrew Cogliano,C,COL,37,0,0,0,0
6,8481521,Ronnie Attard,D,PHI,25,0,0,0,0
6,8481161,Jake Christiansen,D,CBJ,25,0,0,0,0
6,8479458,Nikita Zaitsev,D,CHI,33,0,0,0,0
6,8479619,Michael Carcone,L,ARI,28,0,0,0,0
6,8479026,Philippe Myers,D,TBL,27,0,0,0,0
6,8481617,Vasily Podkolzin,R,VAN,23,0,0,0,0
6,8481701,Santeri Hatakka,D,NJD,23,0,0,0,0
6,8477446,Michael McCarron,R,NSH,29,0,0,0,0
6,8483460,David Jiricek,D,CBJ,21,0,0,0,0
6,8474090,Brendan Smith,D,NJD,35,0,0,0,0
6,8482241,Radim Zohorna,L,PIT,28,0,0,0,0
6,8481032,Paul Cotter,C,VGK,25,0,0,0,0
6,8480289,Morgan Barron,C,WPG,26,0,0,0,0
6,8479379,Givani Smith,R,SJS,26,0,0,0,0
6,8480216,Jacob Peterson,C,SJS,25,0,0,0,0
6,8477851,Jordan Oesterle,D,CGY,32,0,0,0,0
6,8484258,Sam Malinski,D,COL,26,0,0,0,0
6,8478904,Steven Lorentz,C,FLA,28,0,0,0,0
6,8482095,Tyler Kleven,D,OTT,22,0,0,0,0
6,8480980,Connor Dewar,C,TOR,25,0,0,0,0
6,8480848,Ty Dellandrea,C,DAL,24,0,0,0,0
6,8476884,Derrick Pouliot,D,DAL,30,0,0,0,0
6,8480025,MacKenzie Entwistle,R,CHI,25,0,0,0,0
6,8474612,Travis Hamonic,D,OTT,34,0,0,0,0
6,8479336,Carl Grundstrom,R,LAK,27,0,0,0,0
6,8482964,Arber Xhekaj,D,MTL,23,0,0,0,0
6,8471686,Marc Staal,D,PHI,37,0,0,0,0
6,8477887,Patrick Brown,C,BOS,32,0,0,0,0
6,8478495,Denis Gurianov,R,PHI,27,0,0,0,0
6,8481550,Adam Beckman,L,MIN,23,0,0,0,0
6,8480845,Rasmus Kupari,C,WPG,24,0,0,0,0
6,8478585,Derek Ryan,C,EDM,38,0,0,0,0
6,8482141,Lukas Cormier,D,VGK,22,0,0,0,0
6,8477962,Brendan Lemieux,L,CAR,28,0,0,0,0
6,8482861,Vincent Iorio,D,WSH,22,0,0,0,0
6,8479378,Logan Stanley,D,WPG,26,0,0,0,0
6,8473446,Erik Johnson,D,PHI,36,0,0,0,0
6,8481743,Marc Del Gaizo,D,NSH,25,0,0,0,0
6,8478450,Parker Wotherspoon,D,BOS,27,0,0,0,0
6,8477384,Josh Brown,D,ARI,30,0,0,0,0
6,8482165,Yan Kuznetsov,D,CGY,22,0,0,0,0
6,8478424,Jansen Harkins,C,PIT,27,0,0,0,0
6,8482144,Jack Thompson,D,SJS,22,0,0,0,0
6,8479576,Vincent Desharnais,D,EDM,28,0,0,0,0
6,8478512,Austin Czarnik,C,DET,32,0,0,0,0
6,8477527,Ross Johnston,L,ANA,30,0,0,0,0
6,8482094,Daemon Hunt,D,MIN,22,0,0,0,0
6,8481719,Maxwell Crozier,D,TBL,24,0,0,0,0
6,8480192,Johnathan Kovacevic,D,MTL,27,0,0,0,0
6,8479376,Victor Mete,D,PHI,26,0,0,0,0
6,8482511,Mason Lohrei,D,BOS,23,0,0,0,0
6,8478021,William Lagesson,D,ANA,28,0,0,0,0
6,8475795,Dylan McIlrath,D,WSH,32,0,0,0,0
6,8477846,Ryan Carpenter,C,SJS,33,0,0,0,0
6,8481056,Spencer Stastney,D,NSH,24,0,0,0,0
6,8481564,Ryan Johnson,D,BUF,23,0,0,0,0
6,8478017,Mark Friedman,D,VAN,29,0,0,0,0
6,8479320,Max Lajoie,D,TOR,27,0,0,0,0
6,8480075,Cameron Crotty,D,ARI,25,0,0,0,0
6,8484287,Cole McWard,D,VAN,23,0,0,0,0
6,8484254,Akito Hirose,D,VAN,25,0,0,0,0
6,8483407,Brandon Scanlin,D,NYR,25,0,0,0,0
6,8480274,Philip Kemp,D,EDM,25,0,0,0,0
6,8479522,Hardy Haman Aktell,D,WSH,26,0,0,0,0
6,8480007,Jonas Rondbjerg,R,VGK,25,0,0,0,0
6,8477454,Adam Erne,L,EDM,29,0,0,0,0
6,8481679,Maxence Guenette,D,OTT,23,0,0,0,0
6,8477938,Haydn Fleury,D,TBL,28,0,0,0,0
6,8476441,Joel Edmundson,D,TOR,31,0,0,0,0
6,8477903,Garnet Hathaway,R,PHI,33,0,0,0,0
6,8480441,Trey Fix-Wolansky,R,CBJ,25,0,0,0,0
6,8483546,Marshall Rifai,D,TOR,26,0,0,0,0
6,8480084,Nick DeSimone,D,NJD,30,0,0,0,0
6,8481592,Jakob Pelletier,L,CGY,23,0,0,0,0
6,8478011,Louie Belpedio,D,PHI,28,0,0,0,0
6,8477930,Pierre-Edouard Bellemare,L,SEA,39,0,0,0,0
6,8484321,Nikolas Matinpalo,D,OTT,26,0,0,0,0
6,8482067,Connor Mackey,D,NYR,28,0,0,0,0
6,8481806,Louis Crevier,D,CHI,23,0,0,0,0
6,8484326,Patrik Koch,D,ARI,28,0,0,0,0
6,8477971,Andreas Englund,D,LAK,28,0,0,0,0
6,8481751,Lukas Rousek,R,BUF,25,0,0,0,0
6,8481006,Tyler Tucker,D,STL,24,0,0,0,0
6,8481641,Joel Kiviranta,L,COL,28,0,0,0,0
6,8476867,Brendan Gaunce,C,CBJ,30,0,0,0,0
6,8479520,Brandon Duhaime,R,COL,27,0,0,0,0
6,8477073,Kurtis MacDermid,L,NJD,30,0,0,0,0
6,8480874,Adam Ginning,D,PHI,24,0,0,0,0
6,8477473,Justin Bailey,R,SJS,29,0,0,0,0
6,8479066,Ryan Lomberg,L,FLA,30,0,0,0,0
6,8477070,Liam O'Brien,C,ARI,30,0,0,0,0
6,8474618,Marco Scandella,D,STL,34,0,0,0,0
6,8475797,Jarred Tinordi,D,CHI,32,0,0,0,0
6,8481441,Joe Snively,C,WSH,28,0,0,0,0
6,8477244,Chad Ruhwedel,D,NYR,34,0,0,0,0
6,8482077,Dylan Holloway,L,EDM,23,0,0,0,0
6,8479772,Zack MacEwen,R,OTT,28,0,0,0,0
6,8481147,Reese Johnson,C,CHI,26,0,0,0,0
6,8481043,Cole Koepke,L,TBL,26,0,0,0,0
6,8483619,Filip Roos,D,CHI,25,0,0,0,0
6,8481541,Samuel Bolduc,D,NYI,24,0,0,0,0
6,8477810,Joel Hanley,D,CGY,33,0,0,0,0
6,8476907,Mackenzie MacEachern,L,STL,30,0,0,0,0
6,8482652,Walker Duehr,R,CGY,27,0,0,0,0
6,8477126,Jayson Megna,C,BOS,34,0,0,0,0
6,8483398,Declan Carlile,D,TBL,31,0,0,0,0
6,8482929,Emil Lilleberg,D,TBL,23,0,0,0,0
6,8480880,Jakub Lauko,C,BOS,24,0,0,0,0
6,8478874,Adam Gaudette,C,STL,28,0,0,0,0
6,8480245,Olle Lycksell,R,PHI,25,0,0,0,0
6,8480252,Cole Guttman,C,CHI,25,0,0,0,0
6,8477467,Gustav Olofsson,D,SEA,30,0,0,0,0
6,8479968,Vinni Lettieri,C,MIN,29,0,0,0,0
6,8478400,Colin White,C,MTL,27,0,0,0,0
6,8475755,Alexander Petrovic,D,DAL,32,0,0,0,0
6,8481812,Nikolai Knyzhov,D,SJS,27,0,0,0,0
6,8481593,Jayden Struble,D,MTL,23,0,0,0,0
6,8481532,Alex Turcotte,C,LAK,23,0,0,0,0
6,8482126,Emil Andrae,D,PHI,31,0,0,0,0
6,8479944,Zach Aston-Reese,C,DET,30,0,0,0,0
6,8471817,Ryan Reaves,R,TOR,37,0,0,0,0
6,8481206,John Ludvig,D,PIT,24,0,0,0,0
6,8480292,Carson Meyer,R,CBJ,27,0,0,0,0
6,8482496,Nils Aman,C,VAN,24,0,0,0,0
6,8479718,Alex Barré-Boulet,C,TBL,27,0,0,0,0
6,8479994,Jaret Anderson-Dolan,C,NSH,25,0,0,0,0
6,8480184,Gustav Lindstrom,D,ANA,26,0,0,0,0
6,8480890,Jan Jenik,R,ARI,24,0,0,0,0
6,8478067,Oskar Lindblom,L,SJS,28,0,0,0,0
6,8476934,Brock McGinn,L,ANA,30,0,0,0,0
6,8479985,Cale Fleury,D,SEA,26,0,0,0,0
6,8482153,Brendan Brisson,C,VGK,23,0,0,0,0
6,8480021,Jack Studnicka,C,SJS,25,0,0,0,0
6,8484304,Uvis Balinskis,D,FLA,28,0,0,0,0
6,8479981,Jonah Gadjovich,L,FLA,26,0,0,0,0
6,8481716,Dmitri Voronkov,L,CBJ,24,0,0,0,0
6,8482659,Josh Doan,R,ARI,22,0,0,0,0
6,8481122,Simon Benoit,D,TOR,26,0,0,0,0
6,8474709,Matt Martin,L,NYI,35,0,0,0,0
6,8482634,Alex Steeves,C,TOR,25,0,0,0,0
6,8480823,Alexander Alexeyev,D,WSH,25,0,0,0,0
6,8477541,Dakota Mermis,D,MIN,30,0,0,0,0
6,8478477,Mitchell Stephens,C,MTL,27,0,0,0,0
6,8481543,Nikita Alexandrov,C,STL,24,0,0,0,0
6,8482451,Mikael Pyyhtia,L,CBJ,23,0,0,0,0
6,8480306,Grant Hutton,D,NYI,29,0,0,0,0
6,8478028,Fredrik Olofsson,L,COL,28,0,0,0,0
6,8477462,Robert Hagg,D,ANA,29,0,0,0,0
6,8477320,Anton Blidh,L,NYR,29,0,0,0,0
6,8482749,Joshua Roy,R,MTL,21,0,0,0,0
6,8482157,Will Cuylle,L,NYR,22,0,0,0,0
6,8481239,Samuel Fagemo,L,LAK,24,0,0,0,0
6,8481600,Tobias Bjornfot,D,FLA,23,0,0,0,0
6,8478409,Anthony Richard,C,BOS,28,0,0,0,0
6,8474145,Robert Bortuzzo,D,NYI,35,0,0,0,0
6,8475958,Michael Sgarbossa,C,WSH,32,0,0,0,0
6,8479986,Kole Lind,R,SEA,26,0,0,0,0
6,8479249,Andrew Poturalski,C,SEA,30,0,0,0,0
6,8479362,Riley Tufte,L,COL,26,0,0,0,0
6,8479991,Jake Leschyshyn,C,NYR,25,0,0,0,0
6,8479587,Rhett Gardner,C,PHI,28,0,0,0,0
6,8482744,James Malatesta,L,CBJ,21,0,0,0,0
6,8478854,Ryan Shea,D,PIT,27,0,0,0,0
6,8481591,Sam Poulin,R,PIT,23,0,0,0,0
6,8483512,Matt Savoie,C,BUF,20,0,0,0,0
6,8482102,Vasily Ponomarev,C,CAR,22,0,0,0,0
6,8482162,Roby Jarventie,L,OTT,22,0,0,0,0
6,8482172,Landon Slaggert,L,CHI,22,0,0,0,0
6,8482747,Brennan Othmann,L,NYR,21,0,0,0,0
6,8480226,Marián Studenic,R,SEA,26,0,0,0,0
6,8481518,Nolan Foote,L,NJD,24,0,0,0,0
6,8479419,Brett Murray,L,BUF,26,0,0,0,0
6,8482088,Justin Sourdif,R,FLA,22,0,0,0,0
6,8482201,Gage Goncalves,C,TBL,23,0,0,0,0
6,8481754,Nikita Nesterenko,C,ANA,23,0,0,0,0
6,8483531,Brian Halonen,L,NJD,25,0,0,0,0
6,8483920,Pierrick Dube,R,WSH,23,0,0,0,0
6,8480851,Akil Thomas,C,LAK,24,0,0,0,0
6,8475235,Nicolas Deslauriers,L,PHI,33,0,0,0,0
6,8482476,Emil Heineman,L,MTL,23,0,0,0,0
6,8477149,Scott Sabourin,R,SJS,32,0,0,0,0
6,8483549,Lucas Condotta,L,MTL,27,0,0,0,0
6,8483567,Georgii Merkulov,C,BOS,24,0,0,0,0
6,8482765,Isak Rosen,R,BUF,21,0,0,0,0
6,8481237,Kyle MacLean,C,NYI,25,0,0,0,0
6,8481024,Linus Karlsson,C,VAN,25,0,0,0,0
6,8481690,Tyler Angle,C,CBJ,24,0,0,0,0
6,8483570,Ben Meyers,C,ANA,26,0,0,0,0
6,8481655,Cole Schwindt,R,CGY,23,0,0,0,0
6,8481462,Mason Morelli,L,VGK,28,0,0,0,0
6,8483401,Marc Johnstone,R,PIT,28,0,0,0,0
6,8478956,Samuel Laberge,L,NJD,27,0,0,0,0
6,8479533,Joona Koppanen,L,PIT,26,0,0,0,0
6,8482197,Adam Raska,R,MIN,23,0,0,0,0
6,8482250,Callahan Burke,C,CAR,27,0,0,0,0
6,8482784,Zach Dean,C,STL,21,0,0,0,0
6,8484255,Jason Polin,R,COL,25,0,0,0,0
6,8481077,John Leonard,L,ARI,26,0,0,0,0
6,8481534,Raphael Lavoie,C,EDM,24,0,0,0,0
6,8483609,Adam Klapka,R,CGY,24,0,0,0,0
6,8482751,Ryan Winterton,C,SEA,21,0,0,0,0
6,8480267,Sammy Walker,C,MIN,25,0,0,0,0
6,8475766,Austin Watson,L,TBL,32,0,0,0,0
6,8482460,Matt Rempe,C,NYR,22,0,0,0,0
6,8482787,Nikita Chibrikov,R,WPG,31,0,0,0,0
6,8481065,Angus Crookshank,L,OTT,25,0,0,0,0
6,8481070,Hugh McGing,L,STL,26,0,0,0,0
6,8476323,Max McCormick,L,SEA,32,0,0,0,0
6,8483395,Arshdeep Bains,L,VAN,23,0,0,0,0
6,8484259,Ondrej Pavel,C,COL,31,0,0,0,0
6,8483432,Luca Del Bel Belluz,C,CBJ,31,0,0,0,0
6,8483045,Cameron Butler,R,CBJ,31,0,0,0,0
6,8482061,Brandon Biro,L,BUF,26,0,0,0,0
6,8477401,John Hayden,C,SEA,29,0,0,0,0
6,8475278,Byron Froese,C,VGK,33,0,0,0,0
6,8478446,Glenn Gawdin,C,ANA,27,0,0,0,0
6,8477993,Justin Kirkland,C,ARI,28,0,0,0,0
6,8482147,Jean-Luc Foudy,C,COL,22,0,0,0,0
6,8480032,Shane Bowers,C,NJD,25,0,0,0,0
6,8479330,Brandon Gignac,C,MTL,27,0,0,0,0
6,8480776,Sheldon Rempal,R,VGK,29,0,0,0,0
6,8475413,Justin Dowling,C,NJD,34,0,0,0,0
6,8481726,Adam Edstrom,C,NYR,24,0,0,0,0
6,8479638,Justin Brazeau,R,BOS,26,0,0,0,0
6,8480844,Grigori Denisenko,L,VGK,24,0,0,0,0
6,8474062,Riley Nash,C,NYR,35,0,0,0,0
6,8478147,Bokondji Imama,L,OTT,28,0,0,0,0
6,8478881,Brett Seney,L,CHI,28,0,0,0,0
6,8483630,Pavol Regenda,L,ANA,25,0,0,0,0
6,8480836,Jonathan Gruden,C,PIT,24,0,0,0,0
6,8484314,Jiri Smejkal,L,OTT,28,0,0,0,0
6,8475780,Chris Wagner,R,COL,33,0,0,0,0
6,8482070,Mitchell Chaffee,R,TBL,26,0,0,0,0
6,8479546,Oskar Steen,C,BOS,26,0,0,0,0
6,8483597,Milos Kelemen,L,ARI,25,0,0,0,0
6,8481789,Tye Kartye,L,SEA,23,0,0,0,0
6,8484325,Waltteri Merela,C,TBL,26,0,0,0,0
6,8479421,Jacob Moverare,D,LAK,26,0,0,0,0
6,8481585,Egor Afanasyev,L,NSH,23,0,0,0,0
6,8479547,Matthew Phillips,R,WSH,26,0,0,0,0
6,8479367,William Lockwood,R,FLA,26,0,0,0,0
6,8481422,Jacob Lucchini,C,MIN,29,0,0,0,0
6,8480468,James Hamblin,L,EDM,25,0,0,0,0
6,8480870,Bo Groulx,C,ANA,24,0,0,0,0
6,8478051,Max Willman,C,NJD,29,0,0,0,0
6,8481556,John Beecher,C,BOS,23,0,0,0,0
6,8478078,Rourke Chartier,C,OTT,28,0,0,0,0
7,8478402,Connor McDavid,C,EDM,27,82,58,108,166
7,8476453,Nikita Kucherov,R,TBL,31,82,41,99,140
7,8477492,Nathan MacKinnon,C,COL,29,82,38,91,129
7,8477934,Leon Draisaitl,C,EDM,29,82,54,74,128
7,8476887,Filip Forsberg,L,NSH,30,82,60,53,113
7,8480023,Robert Thomas,C,STL,25,82,30,82,112
7,8477956,David Pastrnak,R,BOS,28,82,58,53,111
7,8479318,Auston Matthews,C,TOR,27,82,54,56,110
7,8477939,William Nylander,R,TOR,28,82,49,61,110
7,8480027,Jason Robertson,L,DAL,25,82,42,64,106
7,8476468,J.T. Miller,C,VAN,31,82,38,67,105
7,8480069,Cale Makar,D,COL,26,82,29,74,103
7,8480012,Elias Pettersson,C,VAN,26,82,47,54,101
7,8478420,Mikko Rantanen,R,COL,28,82,43,58,101
7,8480801,Brady Tkachuk,L,OTT,25,82,44,56,100
7,8480002,Nico Hischier,C,NJD,25,82,41,57,98
7,8481559,Jack Hughes,C,NJD,23,82,41,56,97
7,8477493,Aleksander Barkov,C,FLA,29,82,27,70,97
7,8471675,Sidney Crosby,C,PIT,37,82,36,58,94
7,8478864,Kirill Kaprizov,L,MIN,27,82,40,52,92
7,8478550,Artemi Panarin,L,NYR,33,82,37,55,92
7,8475166,John Tavares,C,TOR,34,82,37,54,91
7,8477946,Dylan Larkin,C,DET,28,82,35,55,90
7,8477404,Jake Guentzel,C,CAR,30,82,31,58,89
7,8476456,Jonathan Huberdeau,C,CGY,31,82,27,62,89
7,8478445,Mathew Barzal,C,NYI,27,82,28,60,88
7,8475172,Nazem Kadri,C,CGY,34,82,22,66,88
7,8471215,Evgeni Malkin,C,PIT,38,82,36,51,87
7,8477949,Alex Tuch,R,BUF,28,82,32,55,87
7,8479314,Matthew Tkachuk,L,FLA,27,82,26,61,87
7,8477402,Pavel Buchnevich,L,STL,29,82,31,55,86
7,8480800,Quinn Hughes,D,VAN,25,82,14,72,86
7,8477933,Sam Reinhart,C,FLA,29,82,39,45,84
7,8481557,Matt Boldy,L,MIN,23,82,34,50,84
7,8480839,Rasmus Dahlin,D,BUF,24,82,23,61,84
7,8474600,Roman Josi,D,NSH,34,82,21,63,84
7,8477501,Valeri Nichushkin,R,COL,29,82,40,43,83
7,8478493,Joel Eriksson Ek,C,MIN,27,82,37,46,83
7,8476539,Jonathan Marchessault,R,VGK,34,82,40,42,82
7,8474564,Steven Stamkos,C,TBL,34,82,36,46,82
7,8476454,Ryan Nugent-Hopkins,C,EDM,31,82,24,58,82
7,8482116,Tim Stützle,C,OTT,22,82,22,59,81
7,8478398,Kyle Connor,L,WPG,28,82,36,44,80
7,8480208,Drake Batherson,R,OTT,26,82,34,46,80
7,8479542,Brandon Hagel,L,TBL,26,82,33,47,80
7,8477942,Kevin Fiala,L,LAK,28,82,31,49,80
7,8476346,Johnny Gaudreau,L,CBJ,31,82,18,61,79
7,8478401,Pavel Zacha,C,BOS,27,82,35,43,78
7,8478427,Sebastian Aho,C,CAR,27,82,30,48,78
7,8477951,Nick Schmaltz,C,ARI,28,82,29,49,78
7,8480803,Evan Bouchard,D,EDM,25,82,16,62,78
7,8475786,Zach Hyman,L,EDM,32,82,40,37,77
7,8479407,Jesper Bratt,L,NJD,26,82,32,45,77
7,8475168,Matt Duchene,C,DAL,33,82,29,48,77
7,8473512,Claude Giroux,R,OTT,36,82,26,51,77
7,8473419,Brad Marchand,L,BOS,36,82,25,52,77
7,8478460,Zach Werenski,D,CBJ,27,82,16,61,77
7,8478403,Jack Eichel,C,VGK,28,82,30,46,76
7,8475913,Mark Stone,R,VGK,32,82,28,47,75
7,8477504,Josh Morrissey,D,WPG,29,82,10,65,75
7,8479420,Tage Thompson,C,BUF,27,82,35,39,74
7,8476853,Morgan Rielly,D,TOR,30,82,10,64,74
7,8475754,Brock Nelson,C,NYI,33,82,38,35,73
7,8478010,Brayden Point,C,TBL,28,82,28,45,73
7,8477496,Elias Lindholm,C,VAN,30,82,23,50,73
7,8475692,Mats Zuccarello,R,MIN,37,82,18,55,73
7,8474590,John Carlson,D,WSH,34,82,16,57,73
7,8480039,Martin Necas,C,CAR,25,82,37,35,72
7,8478449,Roope Hintz,C,DAL,28,82,36,36,72
7,8479337,Alex DeBrincat,R,DET,27,82,35,37,72
7,8477500,Bo Horvat,C,NYI,29,82,34,38,72
7,8478440,Dylan Strome,C,WSH,27,82,32,40,72
7,8480830,Andrei Svechnikov,R,CAR,24,82,20,52,72
7,8474578,Erik Karlsson,D,PIT,34,82,18,54,72
7,8477447,Shea Theodore,D,VGK,29,82,15,57,72
7,8476462,Dougie Hamilton,D,NJD,31,82,21,50,71
7,8471685,Anze Kopitar,C,LAK,37,82,19,52,71
7,8471214,Alex Ovechkin,L,WSH,39,82,39,31,70
7,8470794,Joe Pavelski,C,DAL,40,82,30,40,70
7,8479343,Clayton Keller,R,ARI,26,82,24,46,70
7,8474679,Gustav Nyquist,C,NSH,35,82,22,48,70
7,8478038,Devon Toews,D,COL,30,82,13,57,70
7,8479385,Jordan Kyrou,C,STL,26,82,34,35,69
7,8475170,Brayden Schenn,C,STL,33,82,27,42,69
7,8482113,Anton Lundell,C,FLA,23,82,33,34,67
7,8474141,Patrick Kane,R,DET,36,82,25,42,67
7,8476792,Torey Krug,D,STL,33,82,22,45,67
7,8473994,Jamie Benn,L,DAL,35,82,21,46,67
7,8477409,Carter Verhaeghe,C,FLA,29,82,40,26,66
7,8477479,Tyler Bertuzzi,L,TOR,29,82,37,29,66
7,8476459,Mika Zibanejad,C,NYR,31,82,28,38,66
7,8482665,Matty Beniers,C,SEA,22,82,23,43,66
7,8481523,Kirby Dach,C,MTL,23,82,14,52,66
7,8482684,Luke Hughes,D,NJD,21,82,14,52,66
7,8475726,Tyler Toffoli,C,WPG,32,82,33,32,65
7,8482093,Seth Jarvis,C,CAR,22,82,25,40,65
7,8478873,Troy Terry,R,ANA,27,82,23,42,65
7,8480018,Nick Suzuki,C,MTL,25,82,19,46,65
7,8475184,Chris Kreider,L,NYR,33,82,34,30,64
7,8475784,Jeff Skinner,C,BUF,32,82,25,39,64
7,8479323,Adam Fox,D,NYR,26,82,18,46,64
7,8480865,Noah Dobson,D,NYI,24,82,9,55,64
7,8477476,Artturi Lehkonen,L,COL,29,82,37,26,63
7,8476432,Boone Jenner,C,CBJ,31,82,34,29,63
7,8478444,Brock Boeser,R,VAN,27,82,31,32,63
7,8478439,Travis Konecny,R,PHI,27,82,26,37,63
7,8476483,Rickard Rakell,R,PIT,31,82,32,30,62
7,8476460,Mark Scheifele,C,WPG,31,82,28,34,62
7,8481528,Dylan Cozens,C,BUF,23,82,27,35,62
7,8475158,Ryan O'Reilly,C,NSH,33,82,23,39,62
7,8476881,Tomas Hertl,C,VGK,31,82,22,40,62
7,8477955,Jared McCann,L,SEA,28,82,34,27,61
7,8481540,Cole Caufield,R,MTL,23,82,32,29,61
7,8475765,Vladimir Tarasenko,R,FLA,33,82,24,37,61
7,8476389,Vincent Trocheck,C,NYR,31,82,20,41,61
7,8474150,Mikael Backlund,C,CGY,35,82,20,41,61
7,8480036,Miro Heiskanen,D,DAL,25,82,15,46,61
7,8475810,Bryan Rust,R,PIT,32,82,31,29,60
7,8474157,Max Pacioretty,L,WSH,36,82,27,33,60
7,8476479,Phillip Danault,C,LAK,31,82,19,41,60
7,8482097,Jack Quinn,R,BUF,23,82,18,42,60
7,8478396,Noah Hanifin,D,VGK,27,82,17,43,60
7,8477960,Adrian Kempe,R,LAK,28,82,28,31,59
7,8475745,Charlie Coyle,C,BOS,32,82,24,35,59
7,8480015,Owen Tippett,R,PHI,25,82,24,35,59
7,8478397,Rasmus Andersson,D,CGY,28,82,15,44,59
7,8479999,Casey Mittelstadt,C,COL,26,82,10,49,59
7,8482159,Tyson Foerster,R,PHI,22,82,26,32,58
7,8482078,Lucas Raymond,L,DET,22,82,21,37,58
7,8477416,Oliver Bjorkstrand,R,SEA,29,82,20,38,58
7,8479987,Morgan Geekie,C,BOS,26,82,20,38,58
7,8477940,Nikolaj Ehlers,L,WPG,28,82,17,41,58
7,8475167,Victor Hedman,D,TBL,34,82,15,43,58
7,8479325,Charlie McAvoy,D,BOS,27,82,13,45,58
7,8475798,Mikael Granlund,C,SJS,32,82,13,45,58
7,8480434,Sean Durzi,D,ARI,26,82,13,45,58
7,8479410,Mikhail Sergachev,D,TBL,26,82,12,46,58
7,8480014,Gabriel Vilardi,C,WPG,25,82,34,23,57
7,8475169,Evander Kane,L,EDM,33,82,28,29,57
7,8476399,Blake Coleman,C,CGY,33,82,27,30,57
7,8476880,Tom Wilson,R,WSH,30,82,21,36,57
7,8478047,Michael Bunting,L,PIT,29,82,18,39,57
7,8481068,Yegor Sharangovich,C,CGY,26,82,30,26,56
7,8478474,Lawson Crouse,L,ARI,27,82,29,27,56
7,8481533,Trevor Zegras,C,ANA,23,82,24,32,56
7,8478975,Mason Marchment,L,DAL,29,82,23,33,56
7,8474565,Alex Pietrangelo,D,VGK,34,82,19,37,56
7,8481711,Matias Maccelli,L,ARI,24,82,18,38,56
7,8477935,Sam Bennett,C,FLA,28,82,18,38,56
7,8476906,Shayne Gostisbehere,D,DET,31,82,13,43,56
7,8478498,Jake DeBrusk,L,BOS,28,82,29,26,55
7,8478856,Conor Garland,R,VAN,28,82,20,35,55
7,8482475,Yegor Chinakhov,R,CBJ,23,82,18,37,55
7,8477986,Brandon Montour,D,FLA,30,82,16,39,55
7,8476875,Mike Matheson,D,MTL,30,82,15,40,55
7,8478469,Thomas Chabot,D,OTT,27,82,15,40,55
7,8475763,Kevin Hayes,R,STL,32,82,15,40,55
7,8482699,Dylan Guenther,R,ARI,21,82,27,27,54
7,8482124,Quinton Byfield,R,LAK,22,82,18,36,54
7,8474563,Drew Doughty,D,LAK,35,82,15,39,54
7,8477932,Aaron Ekblad,D,FLA,28,82,12,42,54
7,8478407,Vince Dunn,D,SEA,28,82,8,46,54
7,8475794,Tyler Seguin,C,DAL,32,82,30,23,53
7,8476981,Josh Anderson,R,MTL,30,82,26,27,53
7,8479675,Trevor Moore,L,LAK,29,82,25,28,53
7,8475768,Jaden Schwartz,C,SEA,32,82,25,28,53
7,8480797,Joel Farabee,L,PHI,24,82,25,28,53
7,8482740,Wyatt Johnston,C,DAL,21,82,24,29,53
7,8477511,Anthony Mantha,R,VGK,30,82,23,30,53
7,8477497,Sean Monahan,C,WPG,30,82,20,33,53
7,8479345,Jakob Chychrun,D,OTT,26,82,11,42,53
7,8478414,Timo Meier,R,NJD,28,82,27,25,52
7,8475722,Jason Zucker,L,NSH,32,82,27,25,52
7,8475191,Reilly Smith,R,PIT,33,82,23,29,52
7,8474586,Jordan Eberle,R,SEA,34,82,17,35,52
7,8479525,Ross Colton,C,COL,28,82,22,29,51
7,8484144,Connor Bedard,C,CHI,19,82,22,29,51
7,8482109,Alexis Lafrenière,L,NYR,23,82,21,30,51
7,8474102,David Perron,L,DET,36,82,20,31,51
7,8478042,Viktor Arvidsson,R,LAK,31,82,17,34,51
7,8477494,Jonathan Drouin,L,COL,29,82,15,36,51
7,8477346,MacKenzie Weegar,D,CGY,30,82,8,43,51
7,8475151,Kyle Palmieri,C,NYI,33,82,27,23,50
7,8478233,Andrew Mangiapane,L,CGY,28,82,23,27,50
7,8478519,Anthony Cirelli,C,TBL,27,82,20,30,50
7,8482667,William Eklund,L,SJS,22,82,17,33,50
7,8482146,Luke Evangelista,R,NSH,22,82,28,21,49
7,8481618,Alex Newhook,C,MTL,23,82,26,23,49
7,8478366,Frank Vatrano,R,ANA,30,82,24,25,49
7,8481580,Connor McMichael,C,WSH,23,82,24,25,49
7,8477964,Ivan Barbashev,C,VGK,29,82,22,27,49
7,8477953,Kasperi Kapanen,R,STL,28,82,21,28,49
7,8478462,Nicolas Roy,C,VGK,27,82,21,28,49
7,8473986,Alex Killorn,L,ANA,35,82,20,29,49
7,8476905,Chandler Stephenson,C,VGK,30,82,18,31,49
7,8471724,Kris Letang,D,PIT,37,82,11,38,49
7,8475744,Evgeny Kuznetsov,C,CAR,32,82,11,38,49
7,8480798,Philipp Kurashev,C,CHI,25,82,11,38,49
7,8475314,Anders Lee,L,NYI,34,82,23,25,48
7,8481596,Shane Pinto,C,OTT,24,82,21,27,48
7,8477456,J.T. Compher,L,DET,29,82,19,29,48
7,8481581,Thomas Harley,D,DAL,23,82,14,34,48
7,8477021,Alex Kerfoot,C,ARI,30,82,11,37,48
7,8477948,Travis Sanheim,D,PHI,28,82,11,37,48
7,8479339,Patrik Laine,L,CBJ,26,82,27,20,47
7,8477998,Warren Foegele,L,EDM,28,82,19,28,47
7,8480078,Filip Chytil,C,NYR,25,82,18,29,47
7,8478438,Tommy Novak,C,NSH,27,82,14,33,47
7,8480145,Neal Pionk,D,WPG,29,82,8,38,46
7,8480064,Josh Norris,C,OTT,25,82,25,20,45
7,8480459,Pius Suter,C,VAN,28,82,23,22,45
7,8482175,JJ Peterka,R,BUF,22,82,22,23,45
7,8475793,Ryan Johansen,C,PHI,32,82,20,25,45
7,8470613,Brent Burns,D,CAR,39,82,10,35,45
7,8479425,Filip Hronek,D,VAN,27,82,9,36,45
7,8478472,Mathieu Joseph,R,OTT,27,82,9,36,45
7,8475760,Nick Bjugstad,C,ARI,32,82,27,17,44
7,8471698,T.J. Oshie,R,WSH,38,82,24,20,44
7,8473422,Nick Foligno,L,CHI,37,82,22,22,44
7,8473563,Nicklas Backstrom,C,WSH,37,82,16,28,44
7,8477498,Darnell Nurse,D,EDM,29,82,14,30,44
7,8475753,Justin Faulk,D,STL,32,82,13,31,44
7,8480873,Rasmus Sandin,D,WSH,24,82,6,38,44
7,8480009,Eeli Tolvanen,R,SEA,25,82,28,15,43
7,8475799,Nino Niederreiter,R,WPG,32,82,24,19,43
7,8477947,Sonny Milano,L,WSH,28,82,23,20,43
7,8477407,Anthony Duclair,L,TBL,29,82,22,21,43
7,8475791,Taylor Hall,L,CHI,33,82,20,23,43
7,8481546,Cam York,D,PHI,23,82,16,27,43
7,8476329,Travis Boyd,C,ARI,31,82,16,27,43
7,8476927,Teddy Blueger,C,VAN,30,82,15,28,43
7,8483808,Andrei Kuzmenko,L,CGY,28,82,21,21,42
7,8482745,Mason McTavish,C,ANA,21,82,19,23,42
7,8478020,Michael Amadio,C,VGK,28,82,18,24,42
7,8480855,Jack McBain,C,ARI,24,82,18,24,42
7,8482105,Jake Sanderson,D,OTT,22,82,16,26,42
7,8474149,Evgenii Dadonov,R,DAL,35,82,14,28,42
7,8476448,William Karlsson,C,VGK,31,82,10,32,42
7,8478133,Jake Evans,C,MTL,28,82,9,33,42
7,8475197,Tyson Barrie,D,NSH,33,82,6,36,42
7,8482110,Dawson Mercer,C,NJD,23,82,23,18,41
7,8481604,Pavel Dorofeyev,L,VGK,24,82,22,19,41
7,8476826,Yanni Gourde,C,SEA,33,82,21,20,41
7,8478057,Dakota Joshua,C,VAN,28,82,18,23,41
7,8474037,James van Riemsdyk,L,BOS,35,82,16,25,41
7,8478542,Evan Rodrigues,C,FLA,31,82,15,26,41
7,8476958,Jaccob Slavin,D,CAR,30,82,12,29,41
7,8480821,Filip Zadina,R,SJS,25,82,23,17,40
7,8476438,Brandon Saad,L,STL,32,82,22,18,40
7,8476882,Teuvo Teravainen,L,CAR,30,82,21,19,40
7,8480188,Fabian Zetterlund,L,SJS,25,82,20,20,40
7,8475218,Mattias Ekholm,D,EDM,34,82,19,21,40
7,8478046,Danton Heinen,L,BOS,29,82,19,21,40
7,8475848,Brendan Gallagher,R,MTL,32,82,19,21,40
7,8474053,Logan Couture,C,SJS,35,82,18,22,40
7,8476873,Mark Jankowski,C,NSH,30,82,17,23,40
7,8481656,Aliaksei Protas,C,WSH,23,82,13,27,40
7,8480893,Kirill Marchenko,R,CBJ,24,82,27,12,39
7,8470610,Zach Parise,L,COL,40,82,24,15,39
7,8482079,Marco Rossi,C,MIN,23,82,23,16,39
7,8477989,Christian Dvorak,C,MTL,28,82,21,18,39
7,8482055,Drew O'Connor,L,PIT,26,82,20,19,39
7,8480849,Barrett Hayton,C,ARI,24,82,19,20,39
7,8477952,Robby Fabbri,C,DET,28,82,19,20,39
7,8471218,Blake Wheeler,R,NYR,38,82,17,22,39
7,8477944,Jakub Vrana,L,STL,28,82,17,22,39
7,8476461,Sean Couturier,C,PHI,32,82,15,24,39
7,8478458,Jack Roslovic,C,NYR,27,82,12,27,39
7,8476871,Tanner Pearson,L,MTL,32,82,12,27,39
7,8480802,Ryan McLeod,C,EDM,25,82,10,29,39
7,8474151,Ryan McDonagh,D,NSH,35,82,4,35,39
7,8481624,Ilya Mikheyev,R,VAN,30,82,20,18,38
7,8480281,Alexey Toropchenko,R,STL,25,82,20,18,38
7,8475714,Calle Jarnkrok,C,TOR,33,82,17,21,38
7,8477426,Nicholas Paul,L,TBL,29,82,17,21,38
7,8479346,Dillon Dube,C,CGY,26,82,17,21,38
7,8474641,Adam Henrique,C,EDM,34,82,16,22,38
7,8479365,Trent Frederic,C,BOS,26,82,16,22,38
7,8482705,Cole Sillinger,C,CBJ,21,82,14,24,38
7,8477444,Andre Burakovsky,L,SEA,29,82,12,26,38
7,8476960,Andreas Athanasiou,C,CHI,30,82,12,26,38
7,8476458,Ryan Strome,C,ANA,31,82,11,27,38
7,8476872,Scott Laughton,C,PHI,30,82,9,29,38
7,8475906,John Klingberg,D,TOR,32,82,8,30,38
7,8477503,Max Domi,C,TOR,29,82,6,32,38
7,8482089,Jake Neighbours,L,STL,22,82,21,16,37
7,8480185,Eetu Luostarinen,C,FLA,26,82,18,19,37
7,8477451,Ryan Hartman,R,MIN,30,82,17,20,37
7,8478466,Daniel Sprong,R,DET,27,82,17,20,37
7,8479992,Michael Rasmussen,C,DET,25,82,13,24,37
7,8474716,Jared Spurgeon,D,MIN,35,82,13,24,37
7,8477495,Seth Jones,D,CHI,30,82,7,30,37
7,8481542,Moritz Seider,D,DET,23,82,4,33,37
7,8480028,Morgan Frost,C,PHI,25,82,19,17,36
7,8479400,Pierre-Luc Dubois,L,LAK,26,82,16,20,36
7,8476869,Brady Skjei,D,CAR,30,82,11,25,36
7,8480871,Adam Boqvist,D,CBJ,24,82,7,29,36
7,8475171,Oliver Ekman-Larsson,D,FLA,33,82,6,30,36
7,8481535,Nils Hoglander,L,VAN,24,82,19,16,35
7,8482117,Lukas Reichel,L,CHI,22,82,18,17,35
7,8481481,Blake Lizotte,C,LAK,27,82,17,18,35
7,8481186,Logan O'Connor,R,COL,28,82,17,18,35
7,8474870,Tyler Johnson,C,CHI,34,82,16,19,35
7,8477429,Andrew Copp,C,DET,30,82,14,21,35
7,8475287,Erik Haula,L,NJD,33,82,12,23,35
7,8476917,Adam Pelech,D,NYI,30,82,12,23,35
7,8474715,Cam Atkinson,R,PHI,35,82,11,24,35
7,8480074,Alexandre Texier,C,CBJ,25,82,11,24,35
7,8482671,Owen Power,D,BUF,22,82,10,25,35
7,8481606,Jordan Spence,D,LAK,23,82,9,26,35
7,8475181,Nick Leddy,D,STL,33,82,6,29,35
7,8481601,Simon Holmstrom,R,NYI,23,82,26,8,34
7,8477330,Dominik Kubalik,L,OTT,29,82,23,11,34
7,8478508,Yakov Trenin,C,COL,27,82,21,13,34
7,8479941,Justin Danforth,R,CBJ,31,82,19,15,34
7,8476469,Joel Armia,R,MTL,31,82,18,16,34
7,8482092,Ridly Greig,C,OTT,22,82,16,18,34
7,8478115,Pierre Engvall,L,NYI,28,82,15,19,34
7,8476392,Adam Lowry,C,WPG,31,82,15,19,34
7,8475200,Dmitry Orlov,D,CAR,33,82,10,24,34
7,8482222,Alexander Barabanov,L,SJS,30,82,8,26,34
7,8482245,Artem Zub,D,OTT,29,82,8,26,34
7,8478463,Anthony Beauvillier,L,NSH,27,82,19,14,33
7,8475231,Casey Cizikas,C,NYI,33,82,12,21,33
7,8481522,Peyton Krebs,C,BUF,23,82,12,21,33
7,8478413,Jordan Greenway,L,BUF,27,82,11,22,33
7,8476312,Josh Manson,D,COL,33,82,11,22,33
7,8476419,Jean-Gabriel Pageau,C,NYI,32,82,11,22,33
7,8480336,Sean Walker,D,COL,30,82,9,24,33
7,8480220,Noah Cates,L,PHI,25,82,9,24,33
7,8482122,Brock Faber,D,MIN,22,82,8,25,33
7,8475764,Cam Fowler,D,ANA,33,82,7,26,33
7,8482655,J.J. Moser,D,ARI,24,82,6,27,33
7,8479976,Juuso Valimaki,D,ARI,26,82,5,28,33
7,8482087,Kaiden Guhle,D,MTL,22,82,5,28,33
7,8473449,Kyle Okposo,R,FLA,36,82,18,14,32
7,8476925,Colton Sissons,C,NSH,31,82,15,17,32
7,8473533,Jordan Staal,C,CAR,36,82,15,17,32
7,8477919,Frederick Gaudreau,C,MIN,31,82,15,17,32
7,8480113,Alex Iafallo,L,WPG,31,82,14,18,32
7,8481703,Valtteri Puustinen,R,PIT,25,82,6,26,32
7,8475233,David Savard,D,MTL,34,82,5,27,32
7,8476967,Brett Kulak,D,EDM,30,82,4,28,32
7,8482259,Bobby McMann,C,TOR,28,82,17,14,31
7,8480068,Ryan Poehling,C,PHI,25,82,12,19,31
7,8476292,Ondrej Palat,L,NJD,33,82,10,21,31
7,8476923,Damon Severson,D,CBJ,30,82,7,24,31
7,8478055,Gustav Forsling,D,FLA,28,82,7,24,31
7,8476854,Hampus Lindholm,D,BOS,30,82,6,25,31
7,8477220,Nate Schmidt,D,WPG,33,82,5,26,31
7,8481568,Alex Vlasic,D,CHI,23,82,5,26,31
7,8478500,Ivan Provorov,D,CBJ,27,82,4,27,31
7,8476331,Dylan DeMelo,D,WPG,31,82,4,27,31
7,8478840,Will Borgen,D,SEA,28,82,4,27,31
7,8470621,Corey Perry,R,EDM,39,82,21,9,30
7,8479390,Taylor Raddysh,R,CHI,26,82,20,10,30
7,8479661,Tanner Jeannot,L,TBL,27,82,19,11,30
7,8481013,Jonatan Berggren,R,DET,24,82,14,16,30
7,8482624,Daniil Miromanov,D,CGY,27,82,13,17,30
7,8481028,Martin Pospisil,C,CGY,25,82,12,18,30
7,8482074,Connor Zary,C,CGY,23,82,11,19,30
7,8475343,Nic Dowd,C,WSH,34,82,8,22,30
7,8476463,Jonas Brodin,D,MIN,31,82,6,24,30
7,8477506,Ryan Pulock,D,NYI,30,82,3,27,30
7,8484166,Adam Fantilli,C,CBJ,20,82,19,10,29
7,8481554,Kaapo Kakko,R,NYR,23,82,17,12,29
7,8479977,Kailer Yamamoto,R,SEA,26,82,16,13,29
7,8478043,Sam Lafferty,C,VAN,29,82,16,13,29
7,8479415,Michael McLeod,C,NJD,26,82,14,15,29
7,8483515,Juraj Slafkovsky,L,MTL,20,82,14,15,29
7,8476921,Jordan Martinook,L,CAR,32,82,12,17,29
7,8476374,Sean Kuraly,C,CBJ,31,82,9,20,29
7,8477499,Rasmus Ristolainen,D,PHI,30,82,9,20,29
7,8476879,Cody Ceci,D,EDM,31,82,6,23,29
7,8480073,Erik Brannstrom,D,OTT,25,82,3,26,29
7,8481059,Scott Perunovich,D,STL,26,82,3,26,29
7,8479371,Dante Fabbro,D,NSH,26,82,1,28,29
7,8477425,Miles Wood,L,COL,29,82,18,10,28
7,8475149,Marcus Johansson,L,MIN,34,82,13,15,28
7,8474884,Mike Hoffman,C,SJS,35,82,12,16,28
7,8482720,Matthew Knies,L,TOR,22,82,11,17,28
7,8478109,Victor Olofsson,L,BUF,29,82,11,17,28
7,8474189,Lars Eller,C,PIT,35,82,10,18,28
7,8478891,Mason Appleton,C,WPG,28,82,9,19,28
7,8476931,Jake McCabe,D,TOR,31,82,6,22,28
7,8476885,Jacob Trouba,D,NYR,30,82,5,23,28
7,8477845,Trevor van Riemsdyk,D,WSH,33,82,2,26,28
7,8481704,Juuso Parssinen,C,NSH,23,82,15,12,27
7,8484153,Leo Carlsson,C,ANA,20,82,13,14,27
7,8475220,Marcus Foligno,L,MIN,33,82,9,18,27
7,8478013,Jake Walman,D,DET,28,82,8,19,27
7,8479351,Sam Steel,C,DAL,26,82,7,20,27
7,8474673,TJ Brodie,D,TOR,34,82,5,22,27
7,8479983,Mario Ferraro,D,SJS,26,82,5,22,27
7,8476892,Colton Parayko,D,STL,31,82,4,23,27
7,8480035,Henri Jokiharju,D,BUF,25,82,3,24,27
7,8475690,Chris Tanev,D,DAL,35,82,1,26,27
7,8481560,Arthur Kaliyev,R,LAK,23,82,15,11,26
7,8479393,Noah Gregor,C,TOR,26,82,14,12,26
7,8476897,Oskar Sundqvist,C,STL,30,82,11,15,26
7,8477839,Conor Sheary,L,TBL,32,82,11,15,26
7,8482111,Justin Barron,D,MTL,23,82,9,17,26
7,8476467,Jamie Oleksiak,D,SEA,32,82,9,17,26
7,8474574,Tyler Myers,D,VAN,34,82,7,19,26
7,8480246,Nick Perbix,D,TBL,26,82,6,20,26
7,8476457,Adam Larsson,D,SEA,32,82,5,21,26
7,8477507,Nikita Zadorov,D,VAN,29,82,4,22,26
7,8477969,Marcus Pettersson,D,PIT,28,82,3,23,26
7,8482125,Alexander Holtz,R,NJD,22,82,13,12,25
7,8482062,Cole Smith,L,NSH,29,82,13,12,25
7,8476278,Colin Blackwell,C,CHI,31,82,13,12,25
7,8479316,Luke Kunin,C,SJS,27,82,12,13,25
7,8479996,Cody Glass,C,NSH,25,82,10,15,25
7,8475842,Sam Carrick,C,EDM,32,82,10,15,25
7,8476979,Erik Gustafsson,D,NYR,32,82,7,18,25
7,8479398,Samuel Girard,D,COL,26,82,7,18,25
7,8477015,Connor Brown,R,EDM,30,82,7,18,25
7,8473507,Jeff Petry,D,DET,37,82,6,19,25
7,8474034,Pat Maroon,L,BOS,36,82,4,21,25
7,8476891,Matt Grzelcyk,D,BOS,30,82,1,24,25
7,8481553,Bobby Brink,R,PHI,23,82,15,9,24
7,8479353,Brett Howden,C,VGK,26,82,12,12,24
7,8479591,Michael Eyssimont,C,TBL,28,82,12,12,24
7,8474009,Nick Bonino,C,NYR,36,82,11,13,24
7,8476480,Vladislav Namestnikov,C,WPG,32,82,10,14,24
7,8484203,Bradly Nadeau,L,CAR,19,82,10,14,24
7,8477488,Brett Pesce,D,CAR,30,82,7,17,24
7,8483445,Cutter Gauthier,L,ANA,20,82,7,17,24
7,8478911,Matt Roy,D,LAK,29,82,6,18,24
7,8475208,Brian Dumoulin,D,SEA,33,82,4,20,24
7,8475188,Brayden McNabb,D,VGK,33,82,3,21,24
7,8480043,Timothy Liljegren,D,TOR,25,82,2,22,24
7,8480144,David Kampf,C,TOR,29,82,11,12,23
7,8481477,Nico Sturm,C,SJS,29,82,11,12,23
7,8477353,Tyler Motte,C,TBL,29,82,10,13,23
7,8476442,Matt Nieto,L,PIT,32,82,10,13,23
7,8477392,Hudson Fasching,R,NYI,29,82,8,15,23
7,8482809,Jackson Blake,R,CAR,21,82,8,15,23
7,8473504,Cal Clutterbuck,R,NYI,37,82,7,16,23
7,8481014,Alexander Romanov,D,NYI,24,82,5,18,23
7,8480807,Mattias Samuelsson,D,BUF,24,82,4,19,23
7,8476429,Scott Mayfield,D,NYI,32,82,4,19,23
7,8475324,Nick Jensen,D,WSH,34,82,4,19,23
7,8479383,Boris Katchouk,L,OTT,26,82,14,8,22
7,8484145,Zach Benson,L,BUF,19,82,12,10,22
7,8482762,Simon Edvinsson,D,DET,21,82,11,11,22
7,8479514,Rem Pitlick,C,CHI,27,82,9,13,22
7,8480860,Kevin Bahl,D,NJD,24,82,5,17,22
7,8480817,K'Andre Miller,D,NYR,24,82,2,20,22
7,8478507,John Marino,D,NJD,27,82,2,20,22
7,8476902,Esa Lindell,D,DAL,30,82,1,21,22
7,8479291,Kevin Rooney,C,CGY,31,82,11,10,21
7,8470604,Jeff Carter,C,PIT,39,82,9,12,21
7,8477406,Mattias Janmark,C,EDM,32,82,9,12,21
7,8470966,Mark Giordano,D,TOR,41,82,7,14,21
7,8479369,Andrew Peeke,D,BOS,26,82,6,15,21
7,8483505,Matthew Poitras,C,BOS,20,82,6,15,21
7,8476422,Mike Reilly,D,NYI,31,82,4,17,21
7,8475790,Erik Gudbranson,D,CBJ,32,82,4,17,21
7,8478851,Alexandre Carrier,D,NSH,28,82,2,19,21
7,8480172,Jan Rutta,D,SJS,34,82,1,20,21
7,8482133,Thomas Bordeleau,C,SJS,22,82,13,7,20
7,8482155,Alex Laferriere,R,LAK,23,82,13,7,20
7,8477505,Alexander Wennberg,C,NYR,30,82,11,9,20
7,8481524,Bowen Byram,D,BUF,23,82,11,9,20
7,8480995,Pontus Holmberg,R,TOR,25,82,10,10,20
7,8480806,Isac Lundestrom,C,ANA,25,82,9,11,20
7,8480813,Joe Veleno,C,DET,24,82,9,11,20
7,8479293,Brandon Tanev,L,SEA,33,82,9,11,20
7,8478569,Noel Acciari,C,PIT,33,82,9,11,20
7,8480448,Parker Kelly,L,OTT,25,82,9,11,20
7,8476624,Barclay Goodrow,C,NYR,31,82,7,13,20
7,8482516,Matthew Kessel,D,STL,24,82,7,13,20
7,8478859,Niko Mikkola,D,FLA,28,82,6,14,20
7,8474013,Ian Cole,D,VAN,35,82,5,15,20
7,8475455,Brenden Dillon,D,WPG,34,82,4,16,20
7,8482073,Braden Schneider,D,NYR,23,82,4,16,20
7,8475179,Dmitry Kulikov,D,FLA,34,82,3,17,20
7,8483431,Logan Cooley,C,ARI,20,82,12,7,19
7,8481093,Rafael Harvey-Pinard,L,MTL,25,82,11,8,19
7,8482666,Scott Morrow,D,CAR,22,82,10,9,19
7,8482803,Olen Zellweger,D,ANA,21,82,9,10,19
7,8483482,Tristan Luneau,D,ANA,20,82,9,10,19
7,8483490,Pavel Mintyukov,D,ANA,21,82,8,11,19
7,8482858,Ryker Evans,D,SEA,23,82,7,12,19
7,8477365,Connor Clifton,D,BUF,29,82,7,12,19
7,8483524,Shane Wright,C,SEA,20,82,6,13,19
7,8478882,Vladislav Gavrikov,D,LAK,29,82,6,13,19
7,8475164,Jakob Silfverberg,R,ANA,34,82,5,14,19
7,8478430,Oliver Kylington,D,CGY,27,82,5,14,19
7,8483012,Logan Morrison,C,SEA,22,82,5,14,19
7,8479980,Nicolas Hague,D,VGK,26,82,4,15,19
7,8477369,Carson Soucy,D,VAN,30,82,3,16,19
7,8478399,Jonas Siegenthaler,D,NJD,27,82,2,17,19
7,8475462,Radko Gudas,D,ANA,34,82,2,17,19
7,8478136,Jake Middleton,D,MIN,28,82,2,17,19
7,8478416,Erik Cernak,D,TBL,27,82,2,17,19
7,8475279,Ben Chiarot,D,DET,33,82,2,17,19
7,8479423,Alex Nylander,L,CBJ,26,82,12,6,18
7,8477450,Jason Dickinson,C,CHI,29,82,10,8,18
7,8483493,Frank Nazar,C,CHI,20,82,8,10,18
7,8481537,Nikita Okhotiuk,D,CGY,24,82,7,11,18
7,8482730,Brandt Clarke,D,LAK,21,82,7,11,18
7,8483495,Simon Nemec,D,NJD,20,82,7,11,18
7,8484149,Gavin Brindley,C,CBJ,20,82,6,12,18
7,8482807,Ethan Del Mastro,D,CHI,21,82,6,12,18
7,8480796,Martin Fehervary,D,WSH,25,82,4,14,18
7,8481178,Egor Zamula,D,PHI,24,82,1,17,18
7,8478831,Kevin Stenlund,C,FLA,28,82,10,7,17
7,8482737,Zack Bolduc,C,STL,21,82,9,8,17
7,8483468,Jiri Kulich,C,BUF,20,82,8,9,17
7,8477931,Tomas Nosek,L,NJD,32,82,8,9,17
7,8482118,Sam Colangelo,R,ANA,23,82,8,9,17
7,8483491,Ivan Miroshnichenko,L,WSH,20,82,7,10,17
7,8482713,Mackie Samoskevich,R,FLA,22,82,7,10,17
7,8478451,Ethan Bear,D,WSH,27,82,6,11,17
7,8477508,Curtis Lazar,C,NJD,29,82,6,11,17
7,8483457,Lane Hutson,D,MTL,20,82,5,12,17
7,8480990,Declan Chisholm,D,MIN,24,82,4,13,17
7,8478178,Darren Raddysh,D,TBL,28,82,3,14,17
7,8481605,Jackson LaCombe,D,ANA,23,82,2,15,17
7,8476858,Phillip Di Giuseppe,L,VAN,31,82,13,3,16
7,8476878,Zemgus Girgensons,L,BUF,30,82,9,7,16
7,8479359,Beck Malenstyn,L,WSH,26,82,8,8,16
7,8482679,Matt Coronato,R,CGY,22,82,8,8,16
7,8473453,Trevor Lewis,C,LAK,37,82,7,9,16
7,8475825,Jani Hakanpää,D,DAL,32,82,7,9,16
7,8482145,Mavrik Bourque,C,DAL,22,82,7,9,16
7,8484911,Collin Graf,R,SJS,22,82,7,9,16
7,8480834,Ty Emberson,D,SJS,24,82,4,12,16
7,8482702,Logan Stankoven,C,DAL,21,82,4,12,16
7,8470600,Ryan Suter,D,DAL,39,82,4,12,16
7,8479442,Troy Stecher,D,EDM,30,82,4,12,16
7,8483499,Liam Ohgren,L,MIN,20,82,4,12,16
7,8480058,Pierre-Olivier Joseph,D,PIT,25,82,3,13,16
7,8478468,Jeremy Lauzon,D,NSH,27,82,3,13,16
7,8480879,Jacob Bernard-Docker,D,OTT,24,82,2,14,16
7,8483466,Kevin Korchinski,D,CHI,20,82,1,15,16
7,8482166,Shakir Mukhamadullin,D,SJS,22,82,7,8,15
7,8482142,Jamie Drysdale,D,PHI,22,82,6,9,15
7,8479324,Ryan Lindgren,D,NYR,26,82,2,13,15
7,8476473,Connor Murphy,D,CHI,31,82,2,13,15
7,8475762,Derek Forbort,D,BOS,32,82,1,14,15
7,8482101,Danil Gushchin,L,SJS,22,82,5,9,14
7,8477335,Kyle Burroughs,D,SJS,29,82,5,9,14
7,8478443,Brandon Carlo,D,BOS,28,82,4,10,14
7,8475177,Calvin de Haan,D,TBL,33,82,3,11,14
7,8481699,Aku Raty,R,ARI,23,82,2,12,14
7,8482733,Logan Mailloux,D,MTL,31,82,6,7,13
7,8474567,Zach Bogosian,D,MIN,34,82,3,10,13
7,8477034,Jaycob Megna,D,CHI,32,82,2,11,13
7,8481030,Jack St. Ivany,D,PIT,25,82,1,12,13
7,8476372,Nick Seeler,D,PHI,31,82,0,13,13
7,8483397,Marc McLaughlin,C,BOS,25,82,7,5,12
7,8481578,Graeme Clarke,R,NJD,23,82,7,5,12
7,8482712,Oskar Olausson,R,COL,22,82,5,7,12
7,8477435,Ryan Graves,D,PIT,29,82,4,8,12
7,8483565,Nick Blankenburg,D,CBJ,26,82,4,8,12
7,8482470,Ilya Solovyov,D,CGY,24,82,4,8,12
7,8474166,Alec Martinez,D,VGK,37,82,3,9,12
7,8481517,Brett Leason,R,ANA,25,82,3,9,12
7,8481567,Henry Thrun,D,SJS,23,82,1,11,12
7,8476822,Luke Glendening,C,TBL,35,82,6,5,11
7,8482859,Zack Ostapchuk,C,OTT,21,82,6,5,11
7,8482177,Marat Khusnutdinov,C,MIN,22,82,3,8,11
7,8476525,Colin Miller,D,WPG,32,82,2,9,11
7,8471677,Jack Johnson,D,COL,37,82,1,10,11
7,8481599,Victor Soderstrom,D,ARI,23,82,4,6,10
7,8479998,Mikey Anderson,D,LAK,25,82,4,6,10
7,8481016,Ruslan Iskhakov,C,NYI,24,82,2,8,10
7,8483763,Maksymilian Szuber,D,ARI,22,82,4,5,9
7,8476915,Jujhar Khaira,L,MIN,30,82,4,5,9
7,8483489,Fraser Minten,C,TOR,31,82,0,9,9
7,8483471,Brad Lambert,C,WPG,31,82,7,1,8
7,8480031,Maxime Comtois,L,CAR,25,82,4,2,6
7,8478408,Travis Dermott,D,ARI,28,82,2,3,5
7,8477950,Tony DeAngelo,D,CAR,29,0,0,0,0
7,8481577,Philip Tomasino,C,NSH,23,0,0,0,0
7,8482660,Kent Johnson,C,CBJ,22,0,0,0,0
7,8481019,David Gustafsson,C,WPG,24,0,0,0,0
7,8479348,Kale Clague,D,BUF,26,0,0,0,0
7,8482149,Cole Perfetti,C,WPG,22,0,0,0,0
7,8476952,Dominic Toninato,C,WPG,30,0,0,0,0
7,8473473,Milan Lucic,L,BOS,36,0,0,0,0
7,8480829,Jesperi Kotkaniemi,C,CAR,24,0,0,0,0
7,8474602,Justin Schultz,D,SEA,34,0,0,0,0
7,8480049,Dylan Samberg,D,WPG,25,0,0,0,0
7,8479372,Josh Mahura,D,FLA,26,0,0,0,0
7,8480878,Nils Lundkvist,D,DAL,24,0,0,0,0
7,8479982,Conor Timmins,D,TOR,26,0,0,0,0
7,8474031,Kevin Shattenkirk,D,BOS,35,0,0,0,0
7,8480835,Jack Drury,C,CAR,24,0,0,0,0
7,8480008,Adam Ruzicka,C,ARI,25,0,0,0,0
7,8479402,Jake Bean,D,CBJ,26,0,0,0,0
7,8476474,Stefan Noesen,R,CAR,31,0,0,0,0
7,8480884,Calen Addison,D,SJS,24,0,0,0,0
7,8476994,Vinnie Hinostroza,C,PIT,30,0,0,0,0
7,8477987,Ryan Donato,C,CHI,28,0,0,0,0
7,8481582,Nicholas Robertson,L,TOR,23,0,0,0,0
7,8478452,Caleb Jones,D,COL,27,0,0,0,0
7,8480157,Calle Rosen,D,STL,30,0,0,0,0
7,8481609,Vladislav Kolyachonok,D,ARI,23,0,0,0,0
7,8476919,Chris Tierney,C,NJD,30,0,0,0,0
7,8479639,Dylan Coghlan,D,CAR,26,0,0,0,0
7,8475193,Tomas Tatar,L,SEA,34,0,0,0,0
7,8480748,Kiefer Sherwood,L,NSH,29,0,0,0,0
7,8478146,Matthew Highmore,C,OTT,28,0,0,0,0
7,8478970,Jalen Chatfield,D,CAR,28,0,0,0,0
7,8480205,Emil Bemstrom,C,PIT,25,0,0,0,0
7,8471274,Alex Goligoski,D,MIN,39,0,0,0,0
7,8478104,Sammy Blais,L,STL,28,0,0,0,0
7,8476913,Devin Shore,C,SEA,30,0,0,0,0
7,8481708,Zac Jones,D,NYR,24,0,0,0,0
7,8480222,Sebastian Aho,D,NYI,28,0,0,0,0
7,8481598,Philip Broberg,D,EDM,23,0,0,0,0
7,8480789,Oliver Wahlstrom,R,NYI,24,0,0,0,0
7,8480891,Michael Kesselring,D,ARI,24,0,0,0,0
7,8477979,Nicolas Aube-Kubel,R,WSH,28,0,0,0,0
7,8476393,Nick Cousins,C,FLA,31,0,0,0,0
7,8480003,Jesper Boqvist,C,BOS,26,0,0,0,0
7,8479543,Michael Pezzetta,L,MTL,26,0,0,0,0
7,8475855,Jesper Fast,R,CAR,33,0,0,0,0
7,8477018,Ben Hutton,D,VGK,31,0,0,0,0
7,8480762,Eric Robinson,L,BUF,29,0,0,0,0
7,8481058,Jesse Ylönen,R,MTL,25,0,0,0,0
7,8481527,Kaedan Korczak,D,VGK,23,0,0,0,0
7,8482192,Isaak Phillips,D,CHI,23,0,0,0,0
7,8480727,Zach Whitecloud,D,VGK,28,0,0,0,0
7,8480001,Urho Vaakanainen,D,ANA,25,0,0,0,0
7,8480853,Liam Foudy,C,NSH,24,0,0,0,0
7,8475225,Craig Smith,C,DAL,35,0,0,0,0
7,8479972,Mason Shaw,C,MIN,26,0,0,0,0
7,8474040,Sam Gagner,C,EDM,35,0,0,0,0
7,8480196,Jacob Bryson,D,BUF,27,0,0,0,0
7,8475718,Justin Holl,D,DET,32,0,0,0,0
7,8479984,Cal Foote,D,NJD,26,0,0,0,0
7,8480011,Klim Kostin,C,SJS,25,0,0,0,0
7,8482176,Wyatt Kaiser,D,CHI,22,0,0,0,0
7,8476918,Jimmy Vesey,L,NYR,31,0,0,0,0
7,8476988,Matt Benning,D,SJS,30,0,0,0,0
7,8479370,Tyson Jost,C,BUF,26,0,0,0,0
7,8477464,Nic Petan,C,MIN,29,0,0,0,0
7,8477380,Jonny Brodzinski,C,NYR,31,0,0,0,0
7,8480070,Ian Mitchell,D,BOS,25,0,0,0,0
7,8479315,Joey Anderson,R,CHI,26,0,0,0,0
7,8478099,Kevin Labanc,R,SJS,29,0,0,0,0
7,8476874,Olli Maatta,D,DET,30,0,0,0,0
7,8479414,Nathan Bastian,R,NJD,27,0,0,0,0
7,8478434,Keegan Kolesar,R,VGK,27,0,0,0,0
7,8479536,Axel Jonsson-Fjallby,L,WPG,26,0,0,0,0
7,8479671,Mathieu Olivier,R,CBJ,27,0,0,0,0
7,8471709,Marc-Edouard Vlasic,D,SJS,37,0,0,0,0
7,8479328,Julien Gauthier,R,NYI,27,0,0,0,0
7,8478421,A.J. Greer,L,CGY,28,0,0,0,0
7,8477573,Nathan Walker,L,STL,30,0,0,0,0
7,8477478,William Carrier,L,VGK,30,0,0,0,0
7,8479344,Jesse Puljujarvi,R,PIT,26,0,0,0,0
7,8480887,Jordan Harris,D,MTL,24,0,0,0,0
7,8478502,Dennis Gilbert,D,CGY,28,0,0,0,0
7,8480355,Mark Kastelic,C,OTT,25,0,0,0,0
7,8475750,Jon Merrill,D,MIN,32,0,0,0,0
7,8476889,Radek Faksa,C,DAL,30,0,0,0,0
7,8478432,Christian Fischer,R,DET,27,0,0,0,0
7,8479439,Jacob MacDonald,D,SJS,31,0,0,0,0
7,8474568,Luke Schenn,D,NSH,35,0,0,0,0
7,8478454,Noah Juulsen,D,VAN,27,0,0,0,0
7,8475752,Tyler Pitlick,C,NYR,33,0,0,0,0
7,8482148,Hendrix Lapierre,C,WSH,22,0,0,0,0
7,8481167,Brayden Pachal,D,CGY,25,0,0,0,0
7,8478211,Dryden Hunt,L,CGY,29,0,0,0,0
7,8479321,Lucas Johansen,D,WSH,27,0,0,0,0
7,8480950,Ilya Lyubushkin,D,TOR,30,0,0,0,0
7,8479368,Max Jones,L,ANA,26,0,0,0,0
7,8471699,Andrew Cogliano,C,COL,37,0,0,0,0
7,8481521,Ronnie Attard,D,PHI,25,0,0,0,0
7,8481161,Jake Christiansen,D,CBJ,25,0,0,0,0
7,8479458,Nikita Zaitsev,D,CHI,33,0,0,0,0
7,8479619,Michael Carcone,L,ARI,28,0,0,0,0
7,8479026,Philippe Myers,D,TBL,27,0,0,0,0
7,8481617,Vasily Podkolzin,R,VAN,23,0,0,0,0
7,8481701,Santeri Hatakka,D,NJD,23,0,0,0,0
7,8477446,Michael McCarron,R,NSH,29,0,0,0,0
7,8483460,David Jiricek,D,CBJ,21,0,0,0,0
7,8474090,Brendan Smith,D,NJD,35,0,0,0,0
7,8482241,Radim Zohorna,L,PIT,28,0,0,0,0
7,8481032,Paul Cotter,C,VGK,25,0,0,0,0
7,8480289,Morgan Barron,C,WPG,26,0,0,0,0
7,8479379,Givani Smith,R,SJS,26,0,0,0,0
7,8480216,Jacob Peterson,C,SJS,25,0,0,0,0
7,8477851,Jordan Oesterle,D,CGY,32,0,0,0,0
7,8484258,Sam Malinski,D,COL,26,0,0,0,0
7,8478904,Steven Lorentz,C,FLA,28,0,0,0,0
7,8482095,Tyler Kleven,D,OTT,22,0,0,0,0
7,8480980,Connor Dewar,C,TOR,25,0,0,0,0
7,8480848,Ty Dellandrea,C,DAL,24,0,0,0,0
7,8476884,Derrick Pouliot,D,DAL,30,0,0,0,0
7,8480025,MacKenzie Entwistle,R,CHI,25,0,0,0,0
7,8474612,Travis Hamonic,D,OTT,34,0,0,0,0
7,8479336,Carl Grundstrom,R,LAK,27,0,0,0,0
7,8482964,Arber Xhekaj,D,MTL,23,0,0,0,0
7,8471686,Marc Staal,D,PHI,37,0,0,0,0
7,8477887,Patrick Brown,C,BOS,32,0,0,0,0
7,8478495,Denis Gurianov,R,PHI,27,0,0,0,0
7,8481550,Adam Beckman,L,MIN,23,0,0,0,0
7,8480845,Rasmus Kupari,C,WPG,24,0,0,0,0
7,8478585,Derek Ryan,C,EDM,38,0,0,0,0
7,8482141,Lukas Cormier,D,VGK,22,0,0,0,0
7,8477962,Brendan Lemieux,L,CAR,28,0,0,0,0
7,8482861,Vincent Iorio,D,WSH,22,0,0,0,0
7,8479378,Logan Stanley,D,WPG,26,0,0,0,0
7,8473446,Erik Johnson,D,PHI,36,0,0,0,0
7,8481743,Marc Del Gaizo,D,NSH,25,0,0,0,0
7,8478450,Parker Wotherspoon,D,BOS,27,0,0,0,0
7,8477384,Josh Brown,D,ARI,30,0,0,0,0
7,8482165,Yan Kuznetsov,D,CGY,22,0,0,0,0
7,8478424,Jansen Harkins,C,PIT,27,0,0,0,0
7,8482144,Jack Thompson,D,SJS,22,0,0,0,0
7,8479576,Vincent Desharnais,D,EDM,28,0,0,0,0
7,8478512,Austin Czarnik,C,DET,32,0,0,0,0
7,8477527,Ross Johnston,L,ANA,30,0,0,0,0
7,8482094,Daemon Hunt,D,MIN,22,0,0,0,0
7,8481719,Maxwell Crozier,D,TBL,24,0,0,0,0
7,8480192,Johnathan Kovacevic,D,MTL,27,0,0,0,0
7,8479376,Victor Mete,D,PHI,26,0,0,0,0
7,8482511,Mason Lohrei,D,BOS,23,0,0,0,0
7,8478021,William Lagesson,D,ANA,28,0,0,0,0
7,8475795,Dylan McIlrath,D,WSH,32,0,0,0,0
7,8477846,Ryan Carpenter,C,SJS,33,0,0,0,0
7,8481056,Spencer Stastney,D,NSH,24,0,0,0,0
7,8481564,Ryan Johnson,D,BUF,23,0,0,0,0
7,8478017,Mark Friedman,D,VAN,29,0,0,0,0
7,8479320,Max Lajoie,D,TOR,27,0,0,0,0
7,8480075,Cameron Crotty,D,ARI,25,0,0,0,0
7,8484287,Cole McWard,D,VAN,23,0,0,0,0
7,8484254,Akito Hirose,D,VAN,25,0,0,0,0
7,8483407,Brandon Scanlin,D,NYR,25,0,0,0,0
7,8480274,Philip Kemp,D,EDM,25,0,0,0,0
7,8479522,Hardy Haman Aktell,D,WSH,26,0,0,0,0
7,8480007,Jonas Rondbjerg,R,VGK,25,0,0,0,0
7,8477454,Adam Erne,L,EDM,29,0,0,0,0
7,8481679,Maxence Guenette,D,OTT,23,0,0,0,0
7,8477938,Haydn Fleury,D,TBL,28,0,0,0,0
7,8476441,Joel Edmundson,D,TOR,31,0,0,0,0
7,8477903,Garnet Hathaway,R,PHI,33,0,0,0,0
7,8480441,Trey Fix-Wolansky,R,CBJ,25,0,0,0,0
7,8483546,Marshall Rifai,D,TOR,26,0,0,0,0
7,8480084,Nick DeSimone,D,NJD,30,0,0,0,0
7,8481592,Jakob Pelletier,L,CGY,23,0,0,0,0
7,8478011,Louie Belpedio,D,PHI,28,0,0,0,0
7,8477930,Pierre-Edouard Bellemare,L,SEA,39,0,0,0,0
7,8484321,Nikolas Matinpalo,D,OTT,26,0,0,0,0
7,8482067,Connor Mackey,D,NYR,28,0,0,0,0
7,8481806,Louis Crevier,D,CHI,23,0,0,0,0
7,8484326,Patrik Koch,D,ARI,28,0,0,0,0
7,8477971,Andreas Englund,D,LAK,28,0,0,0,0
7,8481751,Lukas Rousek,R,BUF,25,0,0,0,0
7,8481006,Tyler Tucker,D,STL,24,0,0,0,0
7,8481641,Joel Kiviranta,L,COL,28,0,0,0,0
7,8476867,Brendan Gaunce,C,CBJ,30,0,0,0,0
7,8479520,Brandon Duhaime,R,COL,27,0,0,0,0
7,8477073,Kurtis MacDermid,L,NJD,30,0,0,0,0
7,8480874,Adam Ginning,D,PHI,24,0,0,0,0
7,8477473,Justin Bailey,R,SJS,29,0,0,0,0
7,8479066,Ryan Lomberg,L,FLA,30,0,0,0,0
7,8477070,Liam O'Brien,C,ARI,30,0,0,0,0
7,8474618,Marco Scandella,D,STL,34,0,0,0,0
7,8475797,Jarred Tinordi,D,CHI,32,0,0,0,0
7,8481441,Joe Snively,C,WSH,28,0,0,0,0
7,8477244,Chad Ruhwedel,D,NYR,34,0,0,0,0
7,8482077,Dylan Holloway,L,EDM,23,0,0,0,0
7,8479772,Zack MacEwen,R,OTT,28,0,0,0,0
7,8481147,Reese Johnson,C,CHI,26,0,0,0,0
7,8481043,Cole Koepke,L,TBL,26,0,0,0,0
7,8483619,Filip Roos,D,CHI,25,0,0,0,0
7,8481541,Samuel Bolduc,D,NYI,24,0,0,0,0
7,8477810,Joel Hanley,D,CGY,33,0,0,0,0
7,8476907,Mackenzie MacEachern,L,STL,30,0,0,0,0
7,8482652,Walker Duehr,R,CGY,27,0,0,0,0
7,8477126,Jayson Megna,C,BOS,34,0,0,0,0
7,8483398,Declan Carlile,D,TBL,31,0,0,0,0
7,8482929,Emil Lilleberg,D,TBL,23,0,0,0,0
7,8480880,Jakub Lauko,C,BOS,24,0,0,0,0
7,8478874,Adam Gaudette,C,STL,28,0,0,0,0
7,8480245,Olle Lycksell,R,PHI,25,0,0,0,0
7,8480252,Cole Guttman,C,CHI,25,0,0,0,0
7,8477467,Gustav Olofsson,D,SEA,30,0,0,0,0
7,8479968,Vinni Lettieri,C,MIN,29,0,0,0,0
7,8478400,Colin White,C,MTL,27,0,0,0,0
7,8475755,Alexander Petrovic,D,DAL,32,0,0,0,0
7,8481812,Nikolai Knyzhov,D,SJS,27,0,0,0,0
7,8481593,Jayden Struble,D,MTL,23,0,0,0,0
7,8481532,Alex Turcotte,C,LAK,23,0,0,0,0
7,8482126,Emil Andrae,D,PHI,31,0,0,0,0
7,8479944,Zach Aston-Reese,C,DET,30,0,0,0,0
7,8471817,Ryan Reaves,R,TOR,37,0,0,0,0
7,8481206,John Ludvig,D,PIT,24,0,0,0,0
7,8480292,Carson Meyer,R,CBJ,27,0,0,0,0
7,8482496,Nils Aman,C,VAN,24,0,0,0,0
7,8479718,Alex Barré-Boulet,C,TBL,27,0,0,0,0
7,8479994,Jaret Anderson-Dolan,C,NSH,25,0,0,0,0
7,8480184,Gustav Lindstrom,D,ANA,26,0,0,0,0
7,8480890,Jan Jenik,R,ARI,24,0,0,0,0
7,8478067,Oskar Lindblom,L,SJS,28,0,0,0,0
7,8476934,Brock McGinn,L,ANA,30,0,0,0,0
7,8479985,Cale Fleury,D,SEA,26,0,0,0,0
7,8482153,Brendan Brisson,C,VGK,23,0,0,0,0
7,8480021,Jack Studnicka,C,SJS,25,0,0,0,0
7,8484304,Uvis Balinskis,D,FLA,28,0,0,0,0
7,8479981,Jonah Gadjovich,L,FLA,26,0,0,0,0
7,8481716,Dmitri Voronkov,L,CBJ,24,0,0,0,0
7,8482659,Josh Doan,R,ARI,22,0,0,0,0
7,8481122,Simon Benoit,D,TOR,26,0,0,0,0
7,8474709,Matt Martin,L,NYI,35,0,0,0,0
7,8482634,Alex Steeves,C,TOR,25,0,0,0,0
7,8480823,Alexander Alexeyev,D,WSH,25,0,0,0,0
7,8477541,Dakota Mermis,D,MIN,30,0,0,0,0
7,8478477,Mitchell Stephens,C,MTL,27,0,0,0,0
7,8481543,Nikita Alexandrov,C,STL,24,0,0,0,0
7,8482451,Mikael Pyyhtia,L,CBJ,23,0,0,0,0
7,8480306,Grant Hutton,D,NYI,29,0,0,0,0
7,8478028,Fredrik Olofsson,L,COL,28,0,0,0,0
7,8477462,Robert Hagg,D,ANA,29,0,0,0,0
7,8477320,Anton Blidh,L,NYR,29,0,0,0,0
7,8482749,Joshua Roy,R,MTL,21,0,0,0,0
7,8482157,Will Cuylle,L,NYR,22,0,0,0,0
7,8481239,Samuel Fagemo,L,LAK,24,0,0,0,0
7,8481600,Tobias Bjornfot,D,FLA,23,0,0,0,0
7,8478409,Anthony Richard,C,BOS,28,0,0,0,0
7,8474145,Robert Bortuzzo,D,NYI,35,0,0,0,0
7,8475958,Michael Sgarbossa,C,WSH,32,0,0,0,0
7,8479986,Kole Lind,R,SEA,26,0,0,0,0
7,8479249,Andrew Poturalski,C,SEA,30,0,0,0,0
7,8479362,Riley Tufte,L,COL,26,0,0,0,0
7,8479991,Jake Leschyshyn,C,NYR,25,0,0,0,0
7,8479587,Rhett Gardner,C,PHI,28,0,0,0,0
7,8482744,James Malatesta,L,CBJ,21,0,0,0,0
7,8478854,Ryan Shea,D,PIT,27,0,0,0,0
7,8481591,Sam Poulin,R,PIT,23,0,0,0,0
7,8483512,Matt Savoie,C,BUF,20,0,0,0,0
7,8482102,Vasily Ponomarev,C,CAR,22,0,0,0,0
7,8482162,Roby Jarventie,L,OTT,22,0,0,0,0
7,8482172,Landon Slaggert,L,CHI,22,0,0,0,0
7,8482747,Brennan Othmann,L,NYR,21,0,0,0,0
7,8480226,Marián Studenic,R,SEA,26,0,0,0,0
7,8481518,Nolan Foote,L,NJD,24,0,0,0,0
7,8479419,Brett Murray,L,BUF,26,0,0,0,0
7,8482088,Justin Sourdif,R,FLA,22,0,0,0,0
7,8482201,Gage Goncalves,C,TBL,23,0,0,0,0
7,8481754,Nikita Nesterenko,C,ANA,23,0,0,0,0
7,8483531,Brian Halonen,L,NJD,25,0,0,0,0
7,8483920,Pierrick Dube,R,WSH,23,0,0,0,0
7,8480851,Akil Thomas,C,LAK,24,0,0,0,0
7,8475235,Nicolas Deslauriers,L,PHI,33,0,0,0,0
7,8482476,Emil Heineman,L,MTL,23,0,0,0,0
7,8477149,Scott Sabourin,R,SJS,32,0,0,0,0
7,8483549,Lucas Condotta,L,MTL,27,0,0,0,0
7,8483567,Georgii Merkulov,C,BOS,24,0,0,0,0
7,8482765,Isak Rosen,R,BUF,21,0,0,0,0
7,8481237,Kyle MacLean,C,NYI,25,0,0,0,0
7,8481024,Linus Karlsson,C,VAN,25,0,0,0,0
7,8481690,Tyler Angle,C,CBJ,24,0,0,0,0
7,8483570,Ben Meyers,C,ANA,26,0,0,0,0
7,8481655,Cole Schwindt,R,CGY,23,0,0,0,0
7,8481462,Mason Morelli,L,VGK,28,0,0,0,0
7,8483401,Marc Johnstone,R,PIT,28,0,0,0,0
7,8478956,Samuel Laberge,L,NJD,27,0,0,0,0
7,8479533,Joona Koppanen,L,PIT,26,0,0,0,0
7,8482197,Adam Raska,R,MIN,23,0,0,0,0
7,8482250,Callahan Burke,C,CAR,27,0,0,0,0
7,8482784,Zach Dean,C,STL,21,0,0,0,0
7,8484255,Jason Polin,R,COL,25,0,0,0,0
7,8481077,John Leonard,L,ARI,26,0,0,0,0
7,8481534,Raphael Lavoie,C,EDM,24,0,0,0,0
7,8483609,Adam Klapka,R,CGY,24,0,0,0,0
7,8482751,Ryan Winterton,C,SEA,21,0,0,0,0
7,8480267,Sammy Walker,C,MIN,25,0,0,0,0
7,8475766,Austin Watson,L,TBL,32,0,0,0,0
7,8482460,Matt Rempe,C,NYR,22,0,0,0,0
7,8482787,Nikita Chibrikov,R,WPG,31,0,0,0,0
7,8481065,Angus Crookshank,L,OTT,25,0,0,0,0
7,8481070,Hugh McGing,L,STL,26,0,0,0,0
7,8476323,Max McCormick,L,SEA,32,0,0,0,0
7,8483395,Arshdeep Bains,L,VAN,23,0,0,0,0
7,8484259,Ondrej Pavel,C,COL,31,0,0,0,0
7,8483432,Luca Del Bel Belluz,C,CBJ,31,0,0,0,0
7,8483045,Cameron Butler,R,CBJ,31,0,0,0,0
7,8482061,Brandon Biro,L,BUF,26,0,0,0,0
7,8477401,John Hayden,C,SEA,29,0,0,0,0
7,8475278,Byron Froese,C,VGK,33,0,0,0,0
7,8478446,Glenn Gawdin,C,ANA,27,0,0,0,0
7,8477993,Justin Kirkland,C,ARI,28,0,0,0,0
7,8482147,Jean-Luc Foudy,C,COL,22,0,0,0,0
7,8480032,Shane Bowers,C,NJD,25,0,0,0,0
7,8479330,Brandon Gignac,C,MTL,27,0,0,0,0
7,8480776,Sheldon Rempal,R,VGK,29,0,0,0,0
7,8475413,Justin Dowling,C,NJD,34,0,0,0,0
7,8481726,Adam Edstrom,C,NYR,24,0,0,0,0
7,8479638,Justin Brazeau,R,BOS,26,0,0,0,0
7,8480844,Grigori Denisenko,L,VGK,24,0,0,0,0
7,8474062,Riley Nash,C,NYR,35,0,0,0,0
7,8478147,Bokondji Imama,L,OTT,28,0,0,0,0
7,8478881,Brett Seney,L,CHI,28,0,0,0,0
7,8483630,Pavol Regenda,L,ANA,25,0,0,0,0
7,8480836,Jonathan Gruden,C,PIT,24,0,0,0,0
7,8484314,Jiri Smejkal,L,OTT,28,0,0,0,0
7,8475780,Chris Wagner,R,COL,33,0,0,0,0
7,8482070,Mitchell Chaffee,R,TBL,26,0,0,0,0
7,8479546,Oskar Steen,C,BOS,26,0,0,0,0
7,8483597,Milos Kelemen,L,ARI,25,0,0,0,0
7,8481789,Tye Kartye,L,SEA,23,0,0,0,0
7,8484325,Waltteri Merela,C,TBL,26,0,0,0,0
7,8479421,Jacob Moverare,D,LAK,26,0,0,0,0
7,8481585,Egor Afanasyev,L,NSH,23,0,0,0,0
7,8479547,Matthew Phillips,R,WSH,26,0,0,0,0
7,8479367,William Lockwood,R,FLA,26,0,0,0,0
7,8481422,Jacob Lucchini,C,MIN,29,0,0,0,0
7,8480468,James Hamblin,L,EDM,25,0,0,0,0
7,8480870,Bo Groulx,C,ANA,24,0,0,0,0
7,8478051,Max Willman,C,NJD,29,0,0,0,0
7,8481556,John Beecher,C,BOS,23,0,0,0,0
7,8478078,Rourke Chartier,C,OTT,28,0,0,0,0
8,8476453,Nikita Kucherov,R,TBL,31,82,50,109,159
8,8478402,Connor McDavid,C,EDM,27,82,42,89,131
8,8477939,William Nylander,R,TOR,28,82,44,85,129
8,8479318,Auston Matthews,C,TOR,27,82,66,59,125
8,8477956,David Pastrnak,R,BOS,28,82,59,65,124
8,8477492,Nathan MacKinnon,C,COL,29,82,44,78,122
8,8478864,Kirill Kaprizov,L,MIN,27,82,60,59,119
8,8477934,Leon Draisaitl,C,EDM,29,82,47,71,118
8,8478420,Mikko Rantanen,R,COL,28,82,57,55,112
8,8477404,Jake Guentzel,C,CAR,30,82,52,55,107
8,8478550,Artemi Panarin,L,NYR,33,82,39,67,106
8,8479314,Matthew Tkachuk,L,FLA,27,82,46,59,105
8,8481559,Jack Hughes,C,NJD,23,82,44,61,105
8,8471675,Sidney Crosby,C,PIT,37,82,42,61,103
8,8480023,Robert Thomas,C,STL,25,82,27,75,102
8,8480012,Elias Pettersson,C,VAN,26,82,43,56,99
8,8476468,J.T. Miller,C,VAN,31,82,30,69,99
8,8477493,Aleksander Barkov,C,FLA,29,82,27,72,99
8,8480027,Jason Robertson,L,DAL,25,82,33,65,98
8,8475172,Nazem Kadri,C,CGY,34,82,32,64,96
8,8480800,Quinn Hughes,D,VAN,25,82,9,87,96
8,8478010,Brayden Point,C,TBL,28,82,49,46,95
8,8474564,Steven Stamkos,C,TBL,34,82,45,49,94
8,8478493,Joel Eriksson Ek,C,MIN,27,82,39,55,94
8,8471215,Evgeni Malkin,C,PIT,38,82,38,56,94
8,8473419,Brad Marchand,L,BOS,36,82,29,63,92
8,8478439,Travis Konecny,R,PHI,27,82,46,45,91
8,8474600,Roman Josi,D,NSH,34,82,18,73,91
8,8476887,Filip Forsberg,L,NSH,30,82,41,48,89
8,8481523,Kirby Dach,C,MTL,23,82,13,75,88
8,8478403,Jack Eichel,C,VGK,28,82,42,45,87
8,8479343,Clayton Keller,R,ARI,26,82,33,54,87
8,8476454,Ryan Nugent-Hopkins,C,EDM,31,82,28,58,86
8,8480069,Cale Makar,D,COL,26,82,20,66,86
8,8477942,Kevin Fiala,L,LAK,28,82,31,54,85
8,8477949,Alex Tuch,R,BUF,28,82,29,55,84
8,8480803,Evan Bouchard,D,EDM,25,82,16,68,84
8,8475168,Matt Duchene,C,DAL,33,82,41,42,83
8,8477409,Carter Verhaeghe,C,FLA,29,82,41,42,83
8,8480801,Brady Tkachuk,L,OTT,25,82,38,45,83
8,8477402,Pavel Buchnevich,L,STL,29,82,34,49,83
8,8478427,Sebastian Aho,C,CAR,27,82,28,55,83
8,8477940,Nikolaj Ehlers,L,WPG,28,82,26,57,83
8,8475798,Mikael Granlund,C,SJS,32,82,23,60,83
8,8475786,Zach Hyman,L,EDM,32,82,53,29,82
8,8482665,Matty Beniers,C,SEA,22,82,32,50,82
8,8475167,Victor Hedman,D,TBL,34,82,16,66,82
8,8477933,Sam Reinhart,C,FLA,29,82,38,43,81
8,8476460,Mark Scheifele,C,WPG,31,82,25,56,81
8,8471214,Alex Ovechkin,L,WSH,39,82,41,39,80
8,8471724,Kris Letang,D,PIT,37,82,15,65,80
8,8476459,Mika Zibanejad,C,NYR,31,82,32,47,79
8,8479385,Jordan Kyrou,C,STL,26,82,36,42,78
8,8481533,Trevor Zegras,C,ANA,23,82,28,50,78
8,8478440,Dylan Strome,C,WSH,27,82,30,47,77
8,8478445,Mathew Barzal,C,NYI,27,82,23,54,77
8,8478873,Troy Terry,R,ANA,27,82,35,41,76
8,8481557,Matt Boldy,L,MIN,23,82,27,49,76
8,8478449,Roope Hintz,C,DAL,28,82,38,37,75
8,8476389,Vincent Trocheck,C,NYR,31,82,28,47,75
8,8477497,Sean Monahan,C,WPG,30,82,24,51,75
8,8474590,John Carlson,D,WSH,34,82,10,65,75
8,8477501,Valeri Nichushkin,R,COL,29,82,35,39,74
8,8477960,Adrian Kempe,R,LAK,28,82,33,41,74
8,8477496,Elias Lindholm,C,VAN,30,82,26,48,74
8,8480208,Drake Batherson,R,OTT,26,82,23,51,74
8,8476346,Johnny Gaudreau,L,CBJ,31,82,20,54,74
8,8479407,Jesper Bratt,L,NJD,26,82,29,44,73
8,8479323,Adam Fox,D,NYR,26,82,14,59,73
8,8479420,Tage Thompson,C,BUF,27,82,42,30,72
8,8475754,Brock Nelson,C,NYI,33,82,36,36,72
8,8478398,Kyle Connor,L,WPG,28,82,33,39,72
8,8475913,Mark Stone,R,VGK,32,82,24,48,72
8,8475692,Mats Zuccarello,R,MIN,37,82,24,48,72
8,8482116,Tim Stützle,C,OTT,22,82,21,51,72
8,8471685,Anze Kopitar,C,LAK,37,82,17,55,72
8,8482093,Seth Jarvis,C,CAR,22,82,34,37,71
8,8478414,Timo Meier,R,NJD,28,82,30,41,71
8,8475166,John Tavares,C,TOR,34,82,27,44,71
8,8474141,Patrick Kane,R,DET,36,82,27,44,71
8,8475726,Tyler Toffoli,C,WPG,32,82,35,35,70
8,8480002,Nico Hischier,C,NJD,25,82,28,42,70
8,8476456,Jonathan Huberdeau,C,CGY,31,82,14,56,70
8,8477946,Dylan Larkin,C,DET,28,82,31,38,69
8,8478975,Mason Marchment,L,DAL,29,82,25,44,69
8,8480865,Noah Dobson,D,NYI,24,82,8,61,69
8,8479675,Trevor Moore,L,LAK,29,82,36,32,68
8,8479339,Patrik Laine,L,CBJ,26,82,31,37,68
8,8478047,Michael Bunting,L,PIT,29,82,28,40,68
8,8480830,Andrei Svechnikov,R,CAR,24,82,26,42,68
8,8480018,Nick Suzuki,C,MTL,25,82,26,42,68
8,8474578,Erik Karlsson,D,PIT,34,82,14,54,68
8,8475810,Bryan Rust,R,PIT,32,82,39,28,67
8,8475784,Jeff Skinner,C,BUF,32,82,28,39,67
8,8477407,Anthony Duclair,L,TBL,29,82,26,41,67
8,8482078,Lucas Raymond,L,DET,22,82,25,42,67
8,8479325,Charlie McAvoy,D,BOS,27,82,13,54,67
8,8477416,Oliver Bjorkstrand,R,SEA,29,82,30,36,66
8,8475765,Vladimir Tarasenko,R,FLA,33,82,22,44,66
8,8481540,Cole Caufield,R,MTL,23,82,38,27,65
8,8476399,Blake Coleman,C,CGY,33,82,32,33,65
8,8481068,Yegor Sharangovich,C,CGY,26,82,32,33,65
8,8474157,Max Pacioretty,L,WSH,36,82,26,39,65
8,8476881,Tomas Hertl,C,VGK,31,82,25,40,65
8,8477951,Nick Schmaltz,C,ARI,28,82,22,43,65
8,8476853,Morgan Rielly,D,TOR,30,82,11,54,65
8,8470794,Joe Pavelski,C,DAL,40,82,29,35,64
8,8477451,Ryan Hartman,R,MIN,30,82,29,35,64
8,8480839,Rasmus Dahlin,D,BUF,24,82,16,48,64
8,8478397,Rasmus Andersson,D,CGY,28,82,15,49,64
8,8478444,Brock Boeser,R,VAN,27,82,34,29,63
8,8476880,Tom Wilson,R,WSH,30,82,28,35,63
8,8477500,Bo Horvat,C,NYI,29,82,34,28,62
8,8477935,Sam Bennett,C,FLA,28,82,28,34,62
8,8478401,Pavel Zacha,C,BOS,27,82,18,44,62
8,8480036,Miro Heiskanen,D,DAL,25,82,8,54,62
8,8473994,Jamie Benn,L,DAL,35,82,28,33,61
8,8477955,Jared McCann,L,SEA,28,82,28,33,61
8,8479337,Alex DeBrincat,R,DET,27,82,25,36,61
8,8482740,Wyatt Johnston,C,DAL,21,82,23,38,61
8,8478407,Vince Dunn,D,SEA,28,82,12,49,61
8,8473986,Alex Killorn,L,ANA,35,82,27,33,60
8,8474563,Drew Doughty,D,LAK,35,82,11,49,60
8,8478498,Jake DeBrusk,L,BOS,28,82,31,28,59
8,8478366,Frank Vatrano,R,ANA,30,82,28,31,59
8,8481528,Dylan Cozens,C,BUF,23,82,20,39,59
8,8477346,MacKenzie Weegar,D,CGY,30,82,19,40,59
8,8474586,Jordan Eberle,R,SEA,34,82,18,41,59
8,8475184,Chris Kreider,L,NYR,33,82,38,20,58
8,8483808,Andrei Kuzmenko,L,CGY,28,82,26,32,58
8,8475170,Brayden Schenn,C,STL,33,82,23,35,58
8,8482745,Mason McTavish,C,ANA,21,82,20,38,58
8,8476462,Dougie Hamilton,D,NJD,31,82,16,42,58
8,8478460,Zach Werenski,D,CBJ,27,82,11,47,58
8,8477447,Shea Theodore,D,VGK,29,82,11,47,58
8,8480014,Gabriel Vilardi,C,WPG,25,82,31,26,57
8,8477494,Jonathan Drouin,L,COL,29,82,17,40,57
8,8477503,Max Domi,C,TOR,29,82,17,40,57
8,8476875,Mike Matheson,D,MTL,30,82,16,41,57
8,8476432,Boone Jenner,C,CBJ,31,82,31,25,56
8,8481580,Connor McMichael,C,WSH,23,82,31,25,56
8,8479542,Brandon Hagel,L,TBL,26,82,25,31,56
8,8478519,Anthony Cirelli,C,TBL,27,82,24,32,56
8,8476483,Rickard Rakell,R,PIT,31,82,22,34,56
8,8481711,Matias Maccelli,L,ARI,24,82,17,39,56
8,8477504,Josh Morrissey,D,WPG,29,82,11,45,56
8,8478038,Devon Toews,D,COL,30,82,9,47,56
8,8477952,Robby Fabbri,C,DET,28,82,33,22,55
8,8475794,Tyler Seguin,C,DAL,32,82,24,31,55
8,8482097,Jack Quinn,R,BUF,23,82,22,33,55
8,8476792,Torey Krug,D,STL,33,82,12,43,55
8,8478042,Viktor Arvidsson,R,LAK,31,82,24,30,54
8,8475191,Reilly Smith,R,PIT,33,82,23,31,54
8,8475158,Ryan O'Reilly,C,NSH,33,82,21,33,54
8,8475745,Charlie Coyle,C,BOS,32,82,21,33,54
8,8476480,Vladislav Namestnikov,C,WPG,32,82,20,34,54
8,8479999,Casey Mittelstadt,C,COL,26,82,15,39,54
8,8479410,Mikhail Sergachev,D,TBL,26,82,12,42,54
8,8477426,Nicholas Paul,L,TBL,29,82,29,24,53
8,8482159,Tyson Foerster,R,PHI,22,82,28,25,53
8,8473512,Claude Giroux,R,OTT,36,82,21,32,53
8,8477476,Artturi Lehkonen,L,COL,29,82,21,32,53
8,8477932,Aaron Ekblad,D,FLA,28,82,17,36,53
8,8477479,Tyler Bertuzzi,L,TOR,29,82,30,22,52
8,8476826,Yanni Gourde,C,SEA,33,82,20,32,52
8,8480015,Owen Tippett,R,PHI,25,82,17,35,52
8,8477964,Ivan Barbashev,C,VGK,29,82,16,36,52
8,8474565,Alex Pietrangelo,D,VGK,34,82,14,38,52
8,8470613,Brent Burns,D,CAR,39,82,14,38,52
8,8477429,Andrew Copp,C,DET,30,82,12,40,52
8,8476539,Jonathan Marchessault,R,VGK,34,82,30,21,51
8,8480009,Eeli Tolvanen,R,SEA,25,82,22,29,51
8,8478458,Jack Roslovic,C,NYR,27,82,18,33,51
8,8477986,Brandon Montour,D,FLA,30,82,9,42,51
8,8478856,Conor Garland,R,VAN,28,82,25,25,50
8,8478233,Andrew Mangiapane,L,CGY,28,82,25,25,50
8,8480797,Joel Farabee,L,PHI,24,82,17,33,50
8,8476882,Teuvo Teravainen,L,CAR,30,82,15,35,50
8,8480028,Morgan Frost,C,PHI,25,82,14,36,50
8,8479345,Jakob Chychrun,D,OTT,26,82,13,37,50
8,8480078,Filip Chytil,C,NYR,25,82,12,38,50
8,8471218,Blake Wheeler,R,NYR,38,82,27,22,49
8,8481560,Arthur Kaliyev,R,LAK,23,82,25,24,49
8,8475169,Evander Kane,L,EDM,33,82,24,25,49
8,8482667,William Eklund,L,SJS,22,82,24,25,49
8,8482175,JJ Peterka,R,BUF,22,82,24,25,49
8,8477511,Anthony Mantha,R,VGK,30,82,23,26,49
8,8474189,Lars Eller,C,PIT,35,82,23,26,49
8,8477021,Alex Kerfoot,C,ARI,30,82,20,29,49
8,8478474,Lawson Crouse,L,ARI,27,82,27,21,48
8,8481596,Shane Pinto,C,OTT,24,82,24,24,48
8,8480798,Philipp Kurashev,C,CHI,25,82,19,29,48
8,8482110,Dawson Mercer,C,NJD,23,82,18,30,48
8,8474150,Mikael Backlund,C,CGY,35,82,16,32,48
8,8482124,Quinton Byfield,R,LAK,22,82,12,36,48
8,8478891,Mason Appleton,C,WPG,28,82,11,37,48
8,8471698,T.J. Oshie,R,WSH,38,82,25,22,47
8,8480188,Fabian Zetterlund,L,SJS,25,82,18,29,47
8,8476872,Scott Laughton,C,PHI,30,82,17,30,47
8,8479400,Pierre-Luc Dubois,L,LAK,26,82,16,31,47
8,8481581,Thomas Harley,D,DAL,23,82,15,32,47
8,8480145,Neal Pionk,D,WPG,29,82,15,32,47
8,8477839,Conor Sheary,L,TBL,32,82,13,34,47
8,8480434,Sean Durzi,D,ARI,26,82,12,35,47
8,8476905,Chandler Stephenson,C,VGK,30,82,11,36,47
8,8480064,Josh Norris,C,OTT,25,82,29,17,46
8,8475799,Nino Niederreiter,R,WPG,32,82,29,17,46
8,8482109,Alexis Lafrenière,L,NYR,23,82,26,20,46
8,8473422,Nick Foligno,L,CHI,37,82,23,23,46
8,8475287,Erik Haula,L,NJD,33,82,22,24,46
8,8480068,Ryan Poehling,C,PHI,25,82,21,25,46
8,8478046,Danton Heinen,L,BOS,29,82,19,27,46
8,8476897,Oskar Sundqvist,C,STL,30,82,17,29,46
8,8478472,Mathieu Joseph,R,OTT,27,82,15,31,46
8,8482684,Luke Hughes,D,NJD,21,82,13,33,46
8,8478396,Noah Hanifin,D,VGK,27,82,12,34,46
8,8478469,Thomas Chabot,D,OTT,27,82,10,36,46
8,8482146,Luke Evangelista,R,NSH,22,82,25,20,45
8,8478115,Pierre Engvall,L,NYI,28,82,25,20,45
8,8479987,Morgan Geekie,C,BOS,26,82,23,22,45
8,8480039,Martin Necas,C,CAR,25,82,19,26,45
8,8482699,Dylan Guenther,R,ARI,21,82,19,26,45
8,8476479,Phillip Danault,C,LAK,31,82,16,29,45
8,8481656,Aliaksei Protas,C,WSH,23,82,11,34,45
8,8475764,Cam Fowler,D,ANA,33,82,5,40,45
8,8478466,Daniel Sprong,R,DET,27,82,23,21,44
8,8479365,Trent Frederic,C,BOS,26,82,22,22,44
8,8476448,William Karlsson,C,VGK,31,82,16,28,44
8,8474679,Gustav Nyquist,C,NSH,35,82,15,29,44
8,8473563,Nicklas Backstrom,C,WSH,37,82,15,29,44
8,8476869,Brady Skjei,D,CAR,30,82,15,29,44
8,8475768,Jaden Schwartz,C,SEA,32,82,13,31,44
8,8475197,Tyson Barrie,D,NSH,33,82,13,31,44
8,8474716,Jared Spurgeon,D,MIN,35,82,13,31,44
8,8479525,Ross Colton,C,COL,28,82,21,22,43
8,8482092,Ridly Greig,C,OTT,22,82,21,22,43
8,8484144,Connor Bedard,C,CHI,19,82,19,24,43
8,8483515,Juraj Slafkovsky,L,MTL,20,82,17,26,43
8,8475793,Ryan Johansen,C,PHI,32,82,13,30,43
8,8479425,Filip Hronek,D,VAN,27,82,11,32,43
8,8475744,Evgeny Kuznetsov,C,CAR,32,82,9,34,43
8,8480849,Barrett Hayton,C,ARI,24,82,24,18,42
8,8475218,Mattias Ekholm,D,EDM,34,82,21,21,42
8,8482705,Cole Sillinger,C,CBJ,21,82,13,29,42
8,8482671,Owen Power,D,BUF,22,82,13,29,42
8,8482089,Jake Neighbours,L,STL,22,82,28,13,41
8,8474641,Adam Henrique,C,EDM,34,82,21,20,41
8,8479293,Brandon Tanev,L,SEA,33,82,20,21,41
8,8477444,Andre Burakovsky,L,SEA,29,82,19,22,41
8,8477456,J.T. Compher,L,DET,29,82,16,25,41
8,8482720,Matthew Knies,L,TOR,22,82,16,25,41
8,8477498,Darnell Nurse,D,EDM,29,82,14,27,41
8,8478542,Evan Rodrigues,C,FLA,31,82,13,28,41
8,8476923,Damon Severson,D,CBJ,30,82,10,31,41
8,8475314,Anders Lee,L,NYI,34,82,29,11,40
8,8481535,Nils Hoglander,L,VAN,24,82,23,17,40
8,8480220,Noah Cates,L,PHI,25,82,20,20,40
8,8482475,Yegor Chinakhov,R,CBJ,23,82,18,22,40
8,8476927,Teddy Blueger,C,VAN,30,82,18,22,40
8,8475714,Calle Jarnkrok,C,TOR,33,82,17,23,40
8,8477495,Seth Jones,D,CHI,30,82,13,27,40
8,8476854,Hampus Lindholm,D,BOS,30,82,10,30,40
8,8481542,Moritz Seider,D,DET,23,82,5,35,40
8,8476906,Shayne Gostisbehere,D,DET,31,82,4,36,40
8,8478438,Tommy Novak,C,NSH,27,82,18,21,39
8,8470604,Jeff Carter,C,PIT,39,82,18,21,39
8,8482113,Anton Lundell,C,FLA,23,82,15,24,39
8,8481606,Jordan Spence,D,LAK,23,82,9,30,39
8,8482055,Drew O'Connor,L,PIT,26,82,20,18,38
8,8474102,David Perron,L,DET,36,82,17,21,38
8,8475151,Kyle Palmieri,C,NYI,33,82,14,24,38
8,8476958,Jaccob Slavin,D,CAR,30,82,7,31,38
8,8477969,Marcus Pettersson,D,PIT,28,82,5,33,38
8,8482117,Lukas Reichel,L,CHI,22,82,18,19,37
8,8478462,Nicolas Roy,C,VGK,27,82,16,21,37
8,8474870,Tyler Johnson,C,CHI,34,82,16,21,37
8,8476458,Ryan Strome,C,ANA,31,82,12,25,37
8,8477220,Nate Schmidt,D,WPG,33,82,8,29,37
8,8480035,Henri Jokiharju,D,BUF,25,82,5,32,37
8,8482655,J.J. Moser,D,ARI,24,82,3,34,37
8,8475722,Jason Zucker,L,NSH,32,82,20,16,36
8,8482259,Bobby McMann,C,TOR,28,82,20,16,36
8,8476438,Brandon Saad,L,STL,32,82,19,17,36
8,8477330,Dominik Kubalik,L,OTT,29,82,19,17,36
8,8481554,Kaapo Kakko,R,NYR,23,82,19,17,36
8,8474037,James van Riemsdyk,L,BOS,35,82,17,19,36
8,8475848,Brendan Gallagher,R,MTL,32,82,17,19,36
8,8481186,Logan O'Connor,R,COL,28,82,15,21,36
8,8479977,Kailer Yamamoto,R,SEA,26,82,15,21,36
8,8479992,Michael Rasmussen,C,DET,25,82,11,25,36
8,8482133,Thomas Bordeleau,C,SJS,22,82,10,26,36
8,8477948,Travis Sanheim,D,PHI,28,82,9,27,36
8,8476329,Travis Boyd,C,ARI,31,82,7,29,36
8,8478508,Yakov Trenin,C,COL,27,82,22,13,35
8,8479393,Noah Gregor,C,TOR,26,82,20,15,35
8,8477998,Warren Foegele,L,EDM,28,82,15,20,35
8,8480802,Ryan McLeod,C,EDM,25,82,14,21,35
8,8474715,Cam Atkinson,R,PHI,35,82,14,21,35
8,8478413,Jordan Greenway,L,BUF,27,82,14,21,35
8,8470621,Corey Perry,R,EDM,39,82,14,21,35
8,8476960,Andreas Athanasiou,C,CHI,30,82,12,23,35
8,8480185,Eetu Luostarinen,C,FLA,26,82,19,15,34
8,8481481,Blake Lizotte,C,LAK,27,82,18,16,34
8,8481618,Alex Newhook,C,MTL,23,82,17,17,34
8,8478569,Noel Acciari,C,PIT,33,82,16,18,34
8,8478057,Dakota Joshua,C,VAN,28,82,15,19,34
8,8476871,Tanner Pearson,L,MTL,32,82,14,20,34
8,8477953,Kasperi Kapanen,R,STL,28,82,13,21,34
8,8475906,John Klingberg,D,TOR,32,82,6,28,34
8,8480043,Timothy Liljegren,D,TOR,25,82,6,28,34
8,8480817,K'Andre Miller,D,NYR,24,82,6,28,34
8,8481546,Cam York,D,PHI,23,82,5,29,34
8,8476331,Dylan DeMelo,D,WPG,31,82,5,29,34
8,8480113,Alex Iafallo,L,WPG,31,82,17,16,33
8,8478911,Matt Roy,D,LAK,29,82,16,17,33
8,8476469,Joel Armia,R,MTL,31,82,15,18,33
8,8475763,Kevin Hayes,R,STL,32,82,13,20,33
8,8475760,Nick Bjugstad,C,ARI,32,82,12,21,33
8,8478055,Gustav Forsling,D,FLA,28,82,11,22,33
8,8475200,Dmitry Orlov,D,CAR,33,82,9,24,33
8,8482105,Jake Sanderson,D,OTT,22,82,7,26,33
8,8475181,Nick Leddy,D,STL,33,82,4,29,33
8,8477947,Sonny Milano,L,WSH,28,82,20,12,32
8,8481624,Ilya Mikheyev,R,VAN,30,82,20,12,32
8,8476392,Adam Lowry,C,WPG,31,82,16,16,32
8,8481704,Juuso Parssinen,C,NSH,23,82,16,16,32
8,8479591,Michael Eyssimont,C,TBL,28,82,16,16,32
8,8479316,Luke Kunin,C,SJS,27,82,15,17,32
8,8479390,Taylor Raddysh,R,CHI,26,82,14,18,32
8,8478109,Victor Olofsson,L,BUF,29,82,14,18,32
8,8475791,Taylor Hall,L,CHI,33,82,13,19,32
8,8478463,Anthony Beauvillier,L,NSH,27,82,12,20,32
8,8479514,Rem Pitlick,C,CHI,27,82,10,22,32
8,8475149,Marcus Johansson,L,MIN,34,82,9,23,32
8,8478133,Jake Evans,C,MTL,28,82,6,26,32
8,8475753,Justin Faulk,D,STL,32,82,5,27,32
8,8475233,David Savard,D,MTL,34,82,5,27,32
8,8478416,Erik Cernak,D,TBL,27,82,4,28,32
8,8476981,Josh Anderson,R,MTL,30,82,18,13,31
8,8473449,Kyle Okposo,R,FLA,36,82,18,13,31
8,8481604,Pavel Dorofeyev,L,VGK,24,82,17,14,31
8,8481553,Bobby Brink,R,PHI,23,82,14,17,31
8,8482079,Marco Rossi,C,MIN,23,82,13,18,31
8,8479415,Michael McLeod,C,NJD,26,82,11,20,31
8,8481014,Alexander Romanov,D,NYI,24,82,8,23,31
8,8480893,Kirill Marchenko,R,CBJ,24,82,20,10,30
8,8483431,Logan Cooley,C,ARI,20,82,17,13,30
8,8482111,Justin Barron,D,MTL,23,82,13,17,30
8,8474053,Logan Couture,C,SJS,35,82,11,19,30
8,8476292,Ondrej Palat,L,NJD,33,82,11,19,30
8,8476278,Colin Blackwell,C,CHI,31,82,11,19,30
8,8473533,Jordan Staal,C,CAR,36,82,10,20,30
8,8480813,Joe Veleno,C,DET,24,82,10,20,30
8,8482733,Logan Mailloux,D,MTL,31,82,9,21,30
8,8477845,Trevor van Riemsdyk,D,WSH,33,82,6,24,30
8,8476463,Jonas Brodin,D,MIN,31,82,5,25,30
8,8480459,Pius Suter,C,VAN,28,82,15,14,29
8,8482222,Alexander Barabanov,L,SJS,30,82,15,14,29
8,8481093,Rafael Harvey-Pinard,L,MTL,25,82,14,15,29
8,8482062,Cole Smith,L,NSH,29,82,13,16,29
8,8475343,Nic Dowd,C,WSH,34,82,12,17,29
8,8481601,Simon Holmstrom,R,NYI,23,82,11,18,29
8,8477919,Frederick Gaudreau,C,MIN,31,82,10,19,29
8,8475220,Marcus Foligno,L,MIN,33,82,10,19,29
8,8480336,Sean Walker,D,COL,30,82,8,21,29
8,8476312,Josh Manson,D,COL,33,82,7,22,29
8,8476892,Colton Parayko,D,STL,31,82,5,24,29
8,8475188,Brayden McNabb,D,VGK,33,82,5,24,29
8,8478500,Ivan Provorov,D,CBJ,27,82,4,25,29
8,8476891,Matt Grzelcyk,D,BOS,30,82,4,25,29
8,8477392,Hudson Fasching,R,NYI,29,82,19,9,28
8,8479941,Justin Danforth,R,CBJ,31,82,17,11,28
8,8479353,Brett Howden,C,VGK,26,82,16,12,28
8,8481517,Brett Leason,R,ANA,25,82,15,13,28
8,8478013,Jake Walman,D,DET,28,82,14,14,28
8,8474884,Mike Hoffman,C,SJS,35,82,13,15,28
8,8480871,Adam Boqvist,D,CBJ,24,82,9,19,28
8,8480074,Alexandre Texier,C,CBJ,25,82,8,20,28
8,8476457,Adam Larsson,D,SEA,32,82,8,20,28
8,8473507,Jeff Petry,D,DET,37,82,7,21,28
8,8477369,Carson Soucy,D,VAN,30,82,7,21,28
8,8477435,Ryan Graves,D,PIT,29,82,6,22,28
8,8479998,Mikey Anderson,D,LAK,25,82,4,24,28
8,8474673,TJ Brodie,D,TOR,34,82,2,26,28
8,8475455,Brenden Dillon,D,WPG,34,82,2,26,28
8,8482074,Connor Zary,C,CGY,23,82,12,15,27
8,8477931,Tomas Nosek,L,NJD,32,82,11,16,27
8,8482624,Daniil Miromanov,D,CGY,27,82,9,18,27
8,8477499,Rasmus Ristolainen,D,PHI,30,82,9,18,27
8,8479351,Sam Steel,C,DAL,26,82,9,18,27
8,8479983,Mario Ferraro,D,SJS,26,82,9,18,27
8,8476873,Mark Jankowski,C,NSH,30,82,8,19,27
8,8476419,Jean-Gabriel Pageau,C,NYI,32,82,8,19,27
8,8476931,Jake McCabe,D,TOR,31,82,4,23,27
8,8475690,Chris Tanev,D,DAL,35,82,4,23,27
8,8476879,Cody Ceci,D,EDM,31,82,2,25,27
8,8481568,Alex Vlasic,D,CHI,23,82,1,26,27
8,8478020,Michael Amadio,C,VGK,28,82,17,9,26
8,8482155,Alex Laferriere,R,LAK,23,82,16,10,26
8,8477944,Jakub Vrana,L,STL,28,82,14,12,26
8,8477425,Miles Wood,L,COL,29,82,14,12,26
8,8477989,Christian Dvorak,C,MTL,28,82,13,13,26
8,8484145,Zach Benson,L,BUF,19,82,13,13,26
8,8480855,Jack McBain,C,ARI,24,82,12,14,26
8,8481013,Jonatan Berggren,R,DET,24,82,11,15,26
8,8476921,Jordan Martinook,L,CAR,32,82,11,15,26
8,8479996,Cody Glass,C,NSH,25,82,11,15,26
8,8477450,Jason Dickinson,C,CHI,29,82,11,15,26
8,8483457,Lane Hutson,D,MTL,20,82,11,15,26
8,8477488,Brett Pesce,D,CAR,30,82,9,17,26
8,8476461,Sean Couturier,C,PHI,32,82,8,18,26
8,8476917,Adam Pelech,D,NYI,30,82,8,18,26
8,8476925,Colton Sissons,C,NSH,31,82,8,18,26
8,8478430,Oliver Kylington,D,CGY,27,82,6,20,26
8,8479324,Ryan Lindgren,D,NYR,26,82,5,21,26
8,8474151,Ryan McDonagh,D,NSH,35,82,4,22,26
8,8475171,Oliver Ekman-Larsson,D,FLA,33,82,4,22,26
8,8482122,Brock Faber,D,MIN,22,82,4,22,26
8,8475279,Ben Chiarot,D,DET,33,82,3,23,26
8,8478840,Will Borgen,D,SEA,28,82,2,24,26
8,8480873,Rasmus Sandin,D,WSH,24,82,1,25,26
8,8477506,Ryan Pulock,D,NYI,30,82,1,25,26
8,8480281,Alexey Toropchenko,R,STL,25,82,16,9,25
8,8480995,Pontus Holmberg,R,TOR,25,82,11,14,25
8,8480821,Filip Zadina,R,SJS,25,82,10,15,25
8,8477507,Nikita Zadorov,D,VAN,29,82,7,18,25
8,8477015,Connor Brown,R,EDM,30,82,7,18,25
8,8476902,Esa Lindell,D,DAL,30,82,5,20,25
8,8470966,Mark Giordano,D,TOR,41,82,5,20,25
8,8482087,Kaiden Guhle,D,MTL,22,82,4,21,25
8,8476979,Erik Gustafsson,D,NYR,32,82,4,21,25
8,8476624,Barclay Goodrow,C,NYR,31,82,3,22,25
8,8484153,Leo Carlsson,C,ANA,20,82,12,12,24
8,8481028,Martin Pospisil,C,CGY,25,82,10,14,24
8,8480796,Martin Fehervary,D,WSH,25,82,8,16,24
8,8474149,Evgenii Dadonov,R,DAL,35,82,6,18,24
8,8476422,Mike Reilly,D,NYI,31,82,6,18,24
8,8479976,Juuso Valimaki,D,ARI,26,82,4,20,24
8,8476885,Jacob Trouba,D,NYR,30,82,4,20,24
8,8478882,Vladislav Gavrikov,D,LAK,29,82,4,20,24
8,8478451,Ethan Bear,D,WSH,27,82,4,20,24
8,8474574,Tyler Myers,D,VAN,34,82,3,21,24
8,8480246,Nick Perbix,D,TBL,26,82,3,21,24
8,8475179,Dmitry Kulikov,D,FLA,34,82,2,22,24
8,8484166,Adam Fantilli,C,CBJ,20,82,15,8,23
8,8475842,Sam Carrick,C,EDM,32,82,14,9,23
8,8476442,Matt Nieto,L,PIT,32,82,12,11,23
8,8484203,Bradly Nadeau,L,CAR,19,82,11,12,23
8,8482125,Alexander Holtz,R,NJD,22,82,10,13,23
8,8476467,Jamie Oleksiak,D,SEA,32,82,9,14,23
8,8482807,Ethan Del Mastro,D,CHI,21,82,9,14,23
8,8483565,Nick Blankenburg,D,CBJ,26,82,7,16,23
8,8482245,Artem Zub,D,OTT,29,82,2,21,23
8,8479398,Samuel Girard,D,COL,26,82,1,22,23
8,8479423,Alex Nylander,L,CBJ,26,82,16,6,22
8,8479346,Dillon Dube,C,CGY,26,82,13,9,22
8,8480806,Isac Lundestrom,C,ANA,25,82,12,10,22
8,8483524,Shane Wright,C,SEA,20,82,12,10,22
8,8482702,Logan Stankoven,C,DAL,21,82,12,10,22
8,8476374,Sean Kuraly,C,CBJ,31,82,9,13,22
8,8477406,Mattias Janmark,C,EDM,32,82,9,13,22
8,8481524,Bowen Byram,D,BUF,23,82,9,13,22
8,8482809,Jackson Blake,R,CAR,21,82,8,14,22
8,8481703,Valtteri Puustinen,R,PIT,25,82,6,16,22
8,8479371,Dante Fabbro,D,NSH,26,82,4,18,22
8,8479369,Andrew Peeke,D,BOS,26,82,4,18,22
8,8475790,Erik Gudbranson,D,CBJ,32,82,4,18,22
8,8480073,Erik Brannstrom,D,OTT,25,82,2,20,22
8,8481178,Egor Zamula,D,PHI,24,82,2,20,22
8,8482762,Simon Edvinsson,D,DET,21,82,12,9,21
8,8477508,Curtis Lazar,C,NJD,29,82,10,11,21
8,8475231,Casey Cizikas,C,NYI,33,82,9,12,21
8,8478851,Alexandre Carrier,D,NSH,28,82,7,14,21
8,8481537,Nikita Okhotiuk,D,CGY,24,82,7,14,21
8,8483468,Jiri Kulich,C,BUF,20,82,7,14,21
8,8470600,Ryan Suter,D,DAL,39,82,5,16,21
8,8478136,Jake Middleton,D,MIN,28,82,4,17,21
8,8473504,Cal Clutterbuck,R,NYI,37,82,3,18,21
8,8476858,Phillip Di Giuseppe,L,VAN,31,82,12,8,20
8,8477353,Tyler Motte,C,TBL,29,82,9,11,20
8,8481522,Peyton Krebs,C,BUF,23,82,8,12,20
8,8483499,Liam Ohgren,L,MIN,20,82,8,12,20
8,8483445,Cutter Gauthier,L,ANA,20,82,7,13,20
8,8482142,Jamie Drysdale,D,PHI,22,82,7,13,20
8,8483763,Maksymilian Szuber,D,ARI,22,82,7,13,20
8,8478859,Niko Mikkola,D,FLA,28,82,6,14,20
8,8483495,Simon Nemec,D,NJD,20,82,5,15,20
8,8475324,Nick Jensen,D,WSH,34,82,4,16,20
8,8482666,Scott Morrow,D,CAR,22,82,4,16,20
8,8474166,Alec Martinez,D,VGK,37,82,4,16,20
8,8478043,Sam Lafferty,C,VAN,29,82,9,10,19
8,8483482,Tristan Luneau,D,ANA,20,82,8,11,19
8,8482737,Zack Bolduc,C,STL,21,82,8,11,19
8,8481030,Jack St. Ivany,D,PIT,25,82,8,11,19
8,8483493,Frank Nazar,C,CHI,20,82,7,12,19
8,8483490,Pavel Mintyukov,D,ANA,21,82,5,14,19
8,8480807,Mattias Samuelsson,D,BUF,24,82,4,15,19
8,8482803,Olen Zellweger,D,ANA,21,82,4,15,19
8,8474013,Ian Cole,D,VAN,35,82,3,16,19
8,8477365,Connor Clifton,D,BUF,29,82,3,16,19
8,8480058,Pierre-Olivier Joseph,D,PIT,25,82,3,16,19
8,8476429,Scott Mayfield,D,NYI,32,82,2,17,19
8,8480860,Kevin Bahl,D,NJD,24,82,1,18,19
8,8481477,Nico Sturm,C,SJS,29,82,9,9,18
8,8483505,Matthew Poitras,C,BOS,20,82,8,10,18
8,8484149,Gavin Brindley,C,CBJ,20,82,8,10,18
8,8475164,Jakob Silfverberg,R,ANA,34,82,7,11,18
8,8482730,Brandt Clarke,D,LAK,21,82,6,12,18
8,8478178,Darren Raddysh,D,TBL,28,82,6,12,18
8,8478507,John Marino,D,NJD,27,82,4,14,18
8,8475208,Brian Dumoulin,D,SEA,33,82,3,15,18
8,8479980,Nicolas Hague,D,VGK,26,82,2,16,18
8,8476967,Brett Kulak,D,EDM,30,82,1,17,18
8,8479291,Kevin Rooney,C,CGY,31,82,11,6,17
8,8479661,Tanner Jeannot,L,TBL,27,82,10,7,17
8,8470610,Zach Parise,L,COL,40,82,9,8,17
8,8480448,Parker Kelly,L,OTT,25,82,9,8,17
8,8482166,Shakir Mukhamadullin,D,SJS,22,82,8,9,17
8,8483012,Logan Morrison,C,SEA,22,82,7,10,17
8,8479383,Boris Katchouk,L,OTT,26,82,6,11,17
8,8482118,Sam Colangelo,R,ANA,23,82,6,11,17
8,8482679,Matt Coronato,R,CGY,22,82,5,12,17
8,8481567,Henry Thrun,D,SJS,23,82,5,12,17
8,8479359,Beck Malenstyn,L,WSH,26,82,4,13,17
8,8481059,Scott Perunovich,D,STL,26,82,2,15,17
8,8474009,Nick Bonino,C,NYR,36,82,9,7,16
8,8473453,Trevor Lewis,C,LAK,37,82,8,8,16
8,8480144,David Kampf,C,TOR,29,82,7,9,16
8,8480172,Jan Rutta,D,SJS,34,82,5,11,16
8,8478399,Jonas Siegenthaler,D,NJD,27,82,4,12,16
8,8478443,Brandon Carlo,D,BOS,28,82,3,13,16
8,8477034,Jaycob Megna,D,CHI,32,82,3,13,16
8,8482470,Ilya Solovyov,D,CGY,24,82,3,13,16
8,8482073,Braden Schneider,D,NYR,23,82,2,14,16
8,8483471,Brad Lambert,C,WPG,31,82,10,5,15
8,8477505,Alexander Wennberg,C,NYR,30,82,8,7,15
8,8483397,Marc McLaughlin,C,BOS,25,82,8,7,15
8,8478831,Kevin Stenlund,C,FLA,28,82,7,8,15
8,8476822,Luke Glendening,C,TBL,35,82,7,8,15
8,8481016,Ruslan Iskhakov,C,NYI,24,82,6,9,15
8,8474034,Pat Maroon,L,BOS,36,82,5,10,15
8,8481699,Aku Raty,R,ARI,23,82,4,11,15
8,8475462,Radko Gudas,D,ANA,34,82,2,13,15
8,8482516,Matthew Kessel,D,STL,24,82,7,7,14
8,8482712,Oskar Olausson,R,COL,22,82,7,7,14
8,8480990,Declan Chisholm,D,MIN,24,82,6,8,14
8,8482177,Marat Khusnutdinov,C,MIN,22,82,6,8,14
8,8481599,Victor Soderstrom,D,ARI,23,82,6,8,14
8,8476525,Colin Miller,D,WPG,32,82,5,9,14
8,8482145,Mavrik Bourque,C,DAL,22,82,4,10,14
8,8480879,Jacob Bernard-Docker,D,OTT,24,82,3,11,14
8,8476372,Nick Seeler,D,PHI,31,82,3,11,14
8,8480834,Ty Emberson,D,SJS,24,82,2,12,14
8,8474567,Zach Bogosian,D,MIN,34,82,1,13,14
8,8482858,Ryker Evans,D,SEA,23,82,7,6,13
8,8483491,Ivan Miroshnichenko,L,WSH,20,82,5,8,13
8,8476473,Connor Murphy,D,CHI,31,82,3,10,13
8,8475762,Derek Forbort,D,BOS,32,82,2,11,13
8,8481578,Graeme Clarke,R,NJD,23,82,8,4,12
8,8476878,Zemgus Girgensons,L,BUF,30,82,6,6,12
8,8476915,Jujhar Khaira,L,MIN,30,82,5,7,12
8,8478468,Jeremy Lauzon,D,NSH,27,82,3,9,12
8,8471677,Jack Johnson,D,COL,37,82,2,10,12
8,8483489,Fraser Minten,C,TOR,31,82,7,4,11
8,8480031,Maxime Comtois,L,CAR,25,82,4,7,11
8,8484911,Collin Graf,R,SJS,22,82,3,8,11
8,8483466,Kevin Korchinski,D,CHI,20,82,3,8,11
8,8482101,Danil Gushchin,L,SJS,22,82,3,8,11
8,8479442,Troy Stecher,D,EDM,30,82,4,5,9
8,8475177,Calvin de Haan,D,TBL,33,82,1,8,9
8,8477335,Kyle Burroughs,D,SJS,29,82,2,6,8
8,8478408,Travis Dermott,D,ARI,28,82,2,6,8
8,8481605,Jackson LaCombe,D,ANA,23,82,1,7,8
8,8475825,Jani Hakanpää,D,DAL,32,82,2,5,7
8,8482859,Zack Ostapchuk,C,OTT,21,82,1,6,7
8,8482713,Mackie Samoskevich,R,FLA,22,82,0,7,7
8,8477950,Tony DeAngelo,D,CAR,29,0,0,0,0
8,8481577,Philip Tomasino,C,NSH,23,0,0,0,0
8,8482660,Kent Johnson,C,CBJ,22,0,0,0,0
8,8481019,David Gustafsson,C,WPG,24,0,0,0,0
8,8479348,Kale Clague,D,BUF,26,0,0,0,0
8,8482149,Cole Perfetti,C,WPG,22,0,0,0,0
8,8476952,Dominic Toninato,C,WPG,30,0,0,0,0
8,8473473,Milan Lucic,L,BOS,36,0,0,0,0
8,8480829,Jesperi Kotkaniemi,C,CAR,24,0,0,0,0
8,8474602,Justin Schultz,D,SEA,34,0,0,0,0
8,8480049,Dylan Samberg,D,WPG,25,0,0,0,0
8,8479372,Josh Mahura,D,FLA,26,0,0,0,0
8,8480878,Nils Lundkvist,D,DAL,24,0,0,0,0
8,8479982,Conor Timmins,D,TOR,26,0,0,0,0
8,8474031,Kevin Shattenkirk,D,BOS,35,0,0,0,0
8,8480835,Jack Drury,C,CAR,24,0,0,0,0
8,8480008,Adam Ruzicka,C,ARI,25,0,0,0,0
8,8479402,Jake Bean,D,CBJ,26,0,0,0,0
8,8476474,Stefan Noesen,R,CAR,31,0,0,0,0
8,8480884,Calen Addison,D,SJS,24,0,0,0,0
8,8476994,Vinnie Hinostroza,C,PIT,30,0,0,0,0
8,8477987,Ryan Donato,C,CHI,28,0,0,0,0
8,8481582,Nicholas Robertson,L,TOR,23,0,0,0,0
8,8478452,Caleb Jones,D,COL,27,0,0,0,0
8,8480157,Calle Rosen,D,STL,30,0,0,0,0
8,8481609,Vladislav Kolyachonok,D,ARI,23,0,0,0,0
8,8476919,Chris Tierney,C,NJD,30,0,0,0,0
8,8479639,Dylan Coghlan,D,CAR,26,0,0,0,0
8,8475193,Tomas Tatar,L,SEA,34,0,0,0,0
8,8480748,Kiefer Sherwood,L,NSH,29,0,0,0,0
8,8478146,Matthew Highmore,C,OTT,28,0,0,0,0
8,8478970,Jalen Chatfield,D,CAR,28,0,0,0,0
8,8480205,Emil Bemstrom,C,PIT,25,0,0,0,0
8,8471274,Alex Goligoski,D,MIN,39,0,0,0,0
8,8478104,Sammy Blais,L,STL,28,0,0,0,0
8,8476913,Devin Shore,C,SEA,30,0,0,0,0
8,8481708,Zac Jones,D,NYR,24,0,0,0,0
8,8480222,Sebastian Aho,D,NYI,28,0,0,0,0
8,8481598,Philip Broberg,D,EDM,23,0,0,0,0
8,8480789,Oliver Wahlstrom,R,NYI,24,0,0,0,0
8,8480891,Michael Kesselring,D,ARI,24,0,0,0,0
8,8477979,Nicolas Aube-Kubel,R,WSH,28,0,0,0,0
8,8476393,Nick Cousins,C,FLA,31,0,0,0,0
8,8480003,Jesper Boqvist,C,BOS,26,0,0,0,0
8,8479543,Michael Pezzetta,L,MTL,26,0,0,0,0
8,8475855,Jesper Fast,R,CAR,33,0,0,0,0
8,8477018,Ben Hutton,D,VGK,31,0,0,0,0
8,8480762,Eric Robinson,L,BUF,29,0,0,0,0
8,8481058,Jesse Ylönen,R,MTL,25,0,0,0,0
8,8481527,Kaedan Korczak,D,VGK,23,0,0,0,0
8,8482192,Isaak Phillips,D,CHI,23,0,0,0,0
8,8480727,Zach Whitecloud,D,VGK,28,0,0,0,0
8,8480001,Urho Vaakanainen,D,ANA,25,0,0,0,0
8,8480853,Liam Foudy,C,NSH,24,0,0,0,0
8,8475225,Craig Smith,C,DAL,35,0,0,0,0
8,8479972,Mason Shaw,C,MIN,26,0,0,0,0
8,8474040,Sam Gagner,C,EDM,35,0,0,0,0
8,8480196,Jacob Bryson,D,BUF,27,0,0,0,0
8,8475718,Justin Holl,D,DET,32,0,0,0,0
8,8479984,Cal Foote,D,NJD,26,0,0,0,0
8,8480011,Klim Kostin,C,SJS,25,0,0,0,0
8,8482176,Wyatt Kaiser,D,CHI,22,0,0,0,0
8,8476918,Jimmy Vesey,L,NYR,31,0,0,0,0
8,8476988,Matt Benning,D,SJS,30,0,0,0,0
8,8479370,Tyson Jost,C,BUF,26,0,0,0,0
8,8477464,Nic Petan,C,MIN,29,0,0,0,0
8,8477380,Jonny Brodzinski,C,NYR,31,0,0,0,0
8,8480070,Ian Mitchell,D,BOS,25,0,0,0,0
8,8479315,Joey Anderson,R,CHI,26,0,0,0,0
8,8478099,Kevin Labanc,R,SJS,29,0,0,0,0
8,8476874,Olli Maatta,D,DET,30,0,0,0,0
8,8479414,Nathan Bastian,R,NJD,27,0,0,0,0
8,8478434,Keegan Kolesar,R,VGK,27,0,0,0,0
8,8479536,Axel Jonsson-Fjallby,L,WPG,26,0,0,0,0
8,8479671,Mathieu Olivier,R,CBJ,27,0,0,0,0
8,8471709,Marc-Edouard Vlasic,D,SJS,37,0,0,0,0
8,8479328,Julien Gauthier,R,NYI,27,0,0,0,0
8,8478421,A.J. Greer,L,CGY,28,0,0,0,0
8,8477573,Nathan Walker,L,STL,30,0,0,0,0
8,8477478,William Carrier,L,VGK,30,0,0,0,0
8,8479344,Jesse Puljujarvi,R,PIT,26,0,0,0,0
8,8480887,Jordan Harris,D,MTL,24,0,0,0,0
8,8478502,Dennis Gilbert,D,CGY,28,0,0,0,0
8,8480355,Mark Kastelic,C,OTT,25,0,0,0,0
8,8475750,Jon Merrill,D,MIN,32,0,0,0,0
8,8476889,Radek Faksa,C,DAL,30,0,0,0,0
8,8478432,Christian Fischer,R,DET,27,0,0,0,0
8,8479439,Jacob MacDonald,D,SJS,31,0,0,0,0
8,8474568,Luke Schenn,D,NSH,35,0,0,0,0
8,8478454,Noah Juulsen,D,VAN,27,0,0,0,0
8,8475752,Tyler Pitlick,C,NYR,33,0,0,0,0
8,8482148,Hendrix Lapierre,C,WSH,22,0,0,0,0
8,8481167,Brayden Pachal,D,CGY,25,0,0,0,0
8,8478211,Dryden Hunt,L,CGY,29,0,0,0,0
8,8479321,Lucas Johansen,D,WSH,27,0,0,0,0
8,8480950,Ilya Lyubushkin,D,TOR,30,0,0,0,0
8,8479368,Max Jones,L,ANA,26,0,0,0,0
8,8471699,Andrew Cogliano,C,COL,37,0,0,0,0
8,8481521,Ronnie Attard,D,PHI,25,0,0,0,0
8,8481161,Jake Christiansen,D,CBJ,25,0,0,0,0
8,8479458,Nikita Zaitsev,D,CHI,33,0,0,0,0
8,8479619,Michael Carcone,L,ARI,28,0,0,0,0
8,8479026,Philippe Myers,D,TBL,27,0,0,0,0
8,8481617,Vasily Podkolzin,R,VAN,23,0,0,0,0
8,8481701,Santeri Hatakka,D,NJD,23,0,0,0,0
8,8477446,Michael McCarron,R,NSH,29,0,0,0,0
8,8483460,David Jiricek,D,CBJ,21,0,0,0,0
8,8474090,Brendan Smith,D,NJD,35,0,0,0,0
8,8482241,Radim Zohorna,L,PIT,28,0,0,0,0
8,8481032,Paul Cotter,C,VGK,25,0,0,0,0
8,8480289,Morgan Barron,C,WPG,26,0,0,0,0
8,8479379,Givani Smith,R,SJS,26,0,0,0,0
8,8480216,Jacob Peterson,C,SJS,25,0,0,0,0
8,8477851,Jordan Oesterle,D,CGY,32,0,0,0,0
8,8484258,Sam Malinski,D,COL,26,0,0,0,0
8,8478904,Steven Lorentz,C,FLA,28,0,0,0,0
8,8482095,Tyler Kleven,D,OTT,22,0,0,0,0
8,8480980,Connor Dewar,C,TOR,25,0,0,0,0
8,8480848,Ty Dellandrea,C,DAL,24,0,0,0,0
8,8476884,Derrick Pouliot,D,DAL,30,0,0,0,0
8,8480025,MacKenzie Entwistle,R,CHI,25,0,0,0,0
8,8474612,Travis Hamonic,D,OTT,34,0,0,0,0
8,8479336,Carl Grundstrom,R,LAK,27,0,0,0,0
8,8482964,Arber Xhekaj,D,MTL,23,0,0,0,0
8,8471686,Marc Staal,D,PHI,37,0,0,0,0
8,8477887,Patrick Brown,C,BOS,32,0,0,0,0
8,8478495,Denis Gurianov,R,PHI,27,0,0,0,0
8,8481550,Adam Beckman,L,MIN,23,0,0,0,0
8,8480845,Rasmus Kupari,C,WPG,24,0,0,0,0
8,8478585,Derek Ryan,C,EDM,38,0,0,0,0
8,8482141,Lukas Cormier,D,VGK,22,0,0,0,0
8,8477962,Brendan Lemieux,L,CAR,28,0,0,0,0
8,8482861,Vincent Iorio,D,WSH,22,0,0,0,0
8,8479378,Logan Stanley,D,WPG,26,0,0,0,0
8,8473446,Erik Johnson,D,PHI,36,0,0,0,0
8,8481743,Marc Del Gaizo,D,NSH,25,0,0,0,0
8,8478450,Parker Wotherspoon,D,BOS,27,0,0,0,0
8,8477384,Josh Brown,D,ARI,30,0,0,0,0
8,8482165,Yan Kuznetsov,D,CGY,22,0,0,0,0
8,8478424,Jansen Harkins,C,PIT,27,0,0,0,0
8,8482144,Jack Thompson,D,SJS,22,0,0,0,0
8,8479576,Vincent Desharnais,D,EDM,28,0,0,0,0
8,8478512,Austin Czarnik,C,DET,32,0,0,0,0
8,8477527,Ross Johnston,L,ANA,30,0,0,0,0
8,8482094,Daemon Hunt,D,MIN,22,0,0,0,0
8,8481719,Maxwell Crozier,D,TBL,24,0,0,0,0
8,8480192,Johnathan Kovacevic,D,MTL,27,0,0,0,0
8,8479376,Victor Mete,D,PHI,26,0,0,0,0
8,8482511,Mason Lohrei,D,BOS,23,0,0,0,0
8,8478021,William Lagesson,D,ANA,28,0,0,0,0
8,8475795,Dylan McIlrath,D,WSH,32,0,0,0,0
8,8477846,Ryan Carpenter,C,SJS,33,0,0,0,0
8,8481056,Spencer Stastney,D,NSH,24,0,0,0,0
8,8481564,Ryan Johnson,D,BUF,23,0,0,0,0
8,8478017,Mark Friedman,D,VAN,29,0,0,0,0
8,8479320,Max Lajoie,D,TOR,27,0,0,0,0
8,8480075,Cameron Crotty,D,ARI,25,0,0,0,0
8,8484287,Cole McWard,D,VAN,23,0,0,0,0
8,8484254,Akito Hirose,D,VAN,25,0,0,0,0
8,8483407,Brandon Scanlin,D,NYR,25,0,0,0,0
8,8480274,Philip Kemp,D,EDM,25,0,0,0,0
8,8479522,Hardy Haman Aktell,D,WSH,26,0,0,0,0
8,8480007,Jonas Rondbjerg,R,VGK,25,0,0,0,0
8,8477454,Adam Erne,L,EDM,29,0,0,0,0
8,8481679,Maxence Guenette,D,OTT,23,0,0,0,0
8,8477938,Haydn Fleury,D,TBL,28,0,0,0,0
8,8476441,Joel Edmundson,D,TOR,31,0,0,0,0
8,8477903,Garnet Hathaway,R,PHI,33,0,0,0,0
8,8480441,Trey Fix-Wolansky,R,CBJ,25,0,0,0,0
8,8483546,Marshall Rifai,D,TOR,26,0,0,0,0
8,8480084,Nick DeSimone,D,NJD,30,0,0,0,0
8,8481592,Jakob Pelletier,L,CGY,23,0,0,0,0
8,8478011,Louie Belpedio,D,PHI,28,0,0,0,0
8,8477930,Pierre-Edouard Bellemare,L,SEA,39,0,0,0,0
8,8484321,Nikolas Matinpalo,D,OTT,26,0,0,0,0
8,8482067,Connor Mackey,D,NYR,28,0,0,0,0
8,8481806,Louis Crevier,D,CHI,23,0,0,0,0
8,8484326,Patrik Koch,D,ARI,28,0,0,0,0
8,8477971,Andreas Englund,D,LAK,28,0,0,0,0
8,8481751,Lukas Rousek,R,BUF,25,0,0,0,0
8,8481006,Tyler Tucker,D,STL,24,0,0,0,0
8,8481641,Joel Kiviranta,L,COL,28,0,0,0,0
8,8476867,Brendan Gaunce,C,CBJ,30,0,0,0,0
8,8479520,Brandon Duhaime,R,COL,27,0,0,0,0
8,8477073,Kurtis MacDermid,L,NJD,30,0,0,0,0
8,8480874,Adam Ginning,D,PHI,24,0,0,0,0
8,8477473,Justin Bailey,R,SJS,29,0,0,0,0
8,8479066,Ryan Lomberg,L,FLA,30,0,0,0,0
8,8477070,Liam O'Brien,C,ARI,30,0,0,0,0
8,8474618,Marco Scandella,D,STL,34,0,0,0,0
8,8475797,Jarred Tinordi,D,CHI,32,0,0,0,0
8,8481441,Joe Snively,C,WSH,28,0,0,0,0
8,8477244,Chad Ruhwedel,D,NYR,34,0,0,0,0
8,8482077,Dylan Holloway,L,EDM,23,0,0,0,0
8,8479772,Zack MacEwen,R,OTT,28,0,0,0,0
8,8481147,Reese Johnson,C,CHI,26,0,0,0,0
8,8481043,Cole Koepke,L,TBL,26,0,0,0,0
8,8483619,Filip Roos,D,CHI,25,0,0,0,0
8,8481541,Samuel Bolduc,D,NYI,24,0,0,0,0
8,8477810,Joel Hanley,D,CGY,33,0,0,0,0
8,8476907,Mackenzie MacEachern,L,STL,30,0,0,0,0
8,8482652,Walker Duehr,R,CGY,27,0,0,0,0
8,8477126,Jayson Megna,C,BOS,34,0,0,0,0
8,8483398,Declan Carlile,D,TBL,31,0,0,0,0
8,8482929,Emil Lilleberg,D,TBL,23,0,0,0,0
8,8480880,Jakub Lauko,C,BOS,24,0,0,0,0
8,8478874,Adam Gaudette,C,STL,28,0,0,0,0
8,8480245,Olle Lycksell,R,PHI,25,0,0,0,0
8,8480252,Cole Guttman,C,CHI,25,0,0,0,0
8,8477467,Gustav Olofsson,D,SEA,30,0,0,0,0
8,8479968,Vinni Lettieri,C,MIN,29,0,0,0,0
8,8478400,Colin White,C,MTL,27,0,0,0,0
8,8475755,Alexander Petrovic,D,DAL,32,0,0,0,0
8,8481812,Nikolai Knyzhov,D,SJS,27,0,0,0,0
8,8481593,Jayden Struble,D,MTL,23,0,0,0,0
8,8481532,Alex Turcotte,C,LAK,23,0,0,0,0
8,8482126,Emil Andrae,D,PHI,31,0,0,0,0
8,8479944,Zach Aston-Reese,C,DET,30,0,0,0,0
8,8471817,Ryan Reaves,R,TOR,37,0,0,0,0
8,8481206,John Ludvig,D,PIT,24,0,0,0,0
8,8480292,Carson Meyer,R,CBJ,27,0,0,0,0
8,8482496,Nils Aman,C,VAN,24,0,0,0,0
8,8479718,Alex Barré-Boulet,C,TBL,27,0,0,0,0
8,8479994,Jaret Anderson-Dolan,C,NSH,25,0,0,0,0
8,8480184,Gustav Lindstrom,D,ANA,26,0,0,0,0
8,8480890,Jan Jenik,R,ARI,24,0,0,0,0
8,8478067,Oskar Lindblom,L,SJS,28,0,0,0,0
8,8476934,Brock McGinn,L,ANA,30,0,0,0,0
8,8479985,Cale Fleury,D,SEA,26,0,0,0,0
8,8482153,Brendan Brisson,C,VGK,23,0,0,0,0
8,8480021,Jack Studnicka,C,SJS,25,0,0,0,0
8,8484304,Uvis Balinskis,D,FLA,28,0,0,0,0
8,8479981,Jonah Gadjovich,L,FLA,26,0,0,0,0
8,8481716,Dmitri Voronkov,L,CBJ,24,0,0,0,0
8,8482659,Josh Doan,R,ARI,22,0,0,0,0
8,8481122,Simon Benoit,D,TOR,26,0,0,0,0
8,8474709,Matt Martin,L,NYI,35,0,0,0,0
8,8482634,Alex Steeves,C,TOR,25,0,0,0,0
8,8480823,Alexander Alexeyev,D,WSH,25,0,0,0,0
8,8477541,Dakota Mermis,D,MIN,30,0,0,0,0
8,8478477,Mitchell Stephens,C,MTL,27,0,0,0,0
8,8481543,Nikita Alexandrov,C,STL,24,0,0,0,0
8,8482451,Mikael Pyyhtia,L,CBJ,23,0,0,0,0
8,8480306,Grant Hutton,D,NYI,29,0,0,0,0
8,8478028,Fredrik Olofsson,L,COL,28,0,0,0,0
8,8477462,Robert Hagg,D,ANA,29,0,0,0,0
8,8477320,Anton Blidh,L,NYR,29,0,0,0,0
8,8482749,Joshua Roy,R,MTL,21,0,0,0,0
8,8482157,Will Cuylle,L,NYR,22,0,0,0,0
8,8481239,Samuel Fagemo,L,LAK,24,0,0,0,0
8,8481600,Tobias Bjornfot,D,FLA,23,0,0,0,0
8,8478409,Anthony Richard,C,BOS,28,0,0,0,0
8,8474145,Robert Bortuzzo,D,NYI,35,0,0,0,0
8,8475958,Michael Sgarbossa,C,WSH,32,0,0,0,0
8,8479986,Kole Lind,R,SEA,26,0,0,0,0
8,8479249,Andrew Poturalski,C,SEA,30,0,0,0,0
8,8479362,Riley Tufte,L,COL,26,0,0,0,0
8,8479991,Jake Leschyshyn,C,NYR,25,0,0,0,0
8,8479587,Rhett Gardner,C,PHI,28,0,0,0,0
8,8482744,James Malatesta,L,CBJ,21,0,0,0,0
8,8478854,Ryan Shea,D,PIT,27,0,0,0,0
8,8481591,Sam Poulin,R,PIT,23,0,0,0,0
8,8483512,Matt Savoie,C,BUF,20,0,0,0,0
8,8482102,Vasily Ponomarev,C,CAR,22,0,0,0,0
8,8482162,Roby Jarventie,L,OTT,22,0,0,0,0
8,8482172,Landon Slaggert,L,CHI,22,0,0,0,0
8,8482747,Brennan Othmann,L,NYR,21,0,0,0,0
8,8480226,Marián Studenic,R,SEA,26,0,0,0,0
8,8481518,Nolan Foote,L,NJD,24,0,0,0,0
8,8479419,Brett Murray,L,BUF,26,0,0,0,0
8,8482088,Justin Sourdif,R,FLA,22,0,0,0,0
8,8482201,Gage Goncalves,C,TBL,23,0,0,0,0
8,8481754,Nikita Nesterenko,C,ANA,23,0,0,0,0
8,8483531,Brian Halonen,L,NJD,25,0,0,0,0
8,8483920,Pierrick Dube,R,WSH,23,0,0,0,0
8,8480851,Akil Thomas,C,LAK,24,0,0,0,0
8,8475235,Nicolas Deslauriers,L,PHI,33,0,0,0,0
8,8482476,Emil Heineman,L,MTL,23,0,0,0,0
8,8477149,Scott Sabourin,R,SJS,32,0,0,0,0
8,8483549,Lucas Condotta,L,MTL,27,0,0,0,0
8,8483567,Georgii Merkulov,C,BOS,24,0,0,0,0
8,8482765,Isak Rosen,R,BUF,21,0,0,0,0
8,8481237,Kyle MacLean,C,NYI,25,0,0,0,0
8,8481024,Linus Karlsson,C,VAN,25,0,0,0,0
8,8481690,Tyler Angle,C,CBJ,24,0,0,0,0
8,8483570,Ben Meyers,C,ANA,26,0,0,0,0
8,8481655,Cole Schwindt,R,CGY,23,0,0,0,0
8,8481462,Mason Morelli,L,VGK,28,0,0,0,0
8,8483401,Marc Johnstone,R,PIT,28,0,0,0,0
8,8478956,Samuel Laberge,L,NJD,27,0,0,0,0
8,8479533,Joona Koppanen,L,PIT,26,0,0,0,0
8,8482197,Adam Raska,R,MIN,23,0,0,0,0
8,8482250,Callahan Burke,C,CAR,27,0,0,0,0
8,8482784,Zach Dean,C,STL,21,0,0,0,0
8,8484255,Jason Polin,R,COL,25,0,0,0,0
8,8481077,John Leonard,L,ARI,26,0,0,0,0
8,8481534,Raphael Lavoie,C,EDM,24,0,0,0,0
8,8483609,Adam Klapka,R,CGY,24,0,0,0,0
8,8482751,Ryan Winterton,C,SEA,21,0,0,0,0
8,8480267,Sammy Walker,C,MIN,25,0,0,0,0
8,8475766,Austin Watson,L,TBL,32,0,0,0,0
8,8482460,Matt Rempe,C,NYR,22,0,0,0,0
8,8482787,Nikita Chibrikov,R,WPG,31,0,0,0,0
8,8481065,Angus Crookshank,L,OTT,25,0,0,0,0
8,8481070,Hugh McGing,L,STL,26,0,0,0,0
8,8476323,Max McCormick,L,SEA,32,0,0,0,0
8,8483395,Arshdeep Bains,L,VAN,23,0,0,0,0
8,8484259,Ondrej Pavel,C,COL,31,0,0,0,0
8,8483432,Luca Del Bel Belluz,C,CBJ,31,0,0,0,0
8,8483045,Cameron Butler,R,CBJ,31,0,0,0,0
8,8482061,Brandon Biro,L,BUF,26,0,0,0,0
8,8477401,John Hayden,C,SEA,29,0,0,0,0
8,8475278,Byron Froese,C,VGK,33,0,0,0,0
8,8478446,Glenn Gawdin,C,ANA,27,0,0,0,0
8,8477993,Justin Kirkland,C,ARI,28,0,0,0,0
8,8482147,Jean-Luc Foudy,C,COL,22,0,0,0,0
8,8480032,Shane Bowers,C,NJD,25,0,0,0,0
8,8479330,Brandon Gignac,C,MTL,27,0,0,0,0
8,8480776,Sheldon Rempal,R,VGK,29,0,0,0,0
8,8475413,Justin Dowling,C,NJD,34,0,0,0,0
8,8481726,Adam Edstrom,C,NYR,24,0,0,0,0
8,8479638,Justin Brazeau,R,BOS,26,0,0,0,0
8,8480844,Grigori Denisenko,L,VGK,24,0,0,0,0
8,8474062,Riley Nash,C,NYR,35,0,0,0,0
8,8478147,Bokondji Imama,L,OTT,28,0,0,0,0
8,8478881,Brett Seney,L,CHI,28,0,0,0,0
8,8483630,Pavol Regenda,L,ANA,25,0,0,0,0
8,8480836,Jonathan Gruden,C,PIT,24,0,0,0,0
8,8484314,Jiri Smejkal,L,OTT,28,0,0,0,0
8,8475780,Chris Wagner,R,COL,33,0,0,0,0
8,8482070,Mitchell Chaffee,R,TBL,26,0,0,0,0
8,8479546,Oskar Steen,C,BOS,26,0,0,0,0
8,8483597,Milos Kelemen,L,ARI,25,0,0,0,0
8,8481789,Tye Kartye,L,SEA,23,0,0,0,0
8,8484325,Waltteri Merela,C,TBL,26,0,0,0,0
8,8479421,Jacob Moverare,D,LAK,26,0,0,0,0
8,8481585,Egor Afanasyev,L,NSH,23,0,0,0,0
8,8479547,Matthew Phillips,R,WSH,26,0,0,0,0
8,8479367,William Lockwood,R,FLA,26,0,0,0,0
8,8481422,Jacob Lucchini,C,MIN,29,0,0,0,0
8,8480468,James Hamblin,L,EDM,25,0,0,0,0
8,8480870,Bo Groulx,C,ANA,24,0,0,0,0
8,8478051,Max Willman,C,NJD,29,0,0,0,0
8,8481556,John Beecher,C,BOS,23,0,0,0,0
8,8478078,Rourke Chartier,C,OTT,28,0,0,0,0
9,8477492,Nathan MacKinnon,C,COL,29,82,44,103,147
9,8478402,Connor McDavid,C,EDM,27,82,49,97,146
9,8476453,Nikita Kucherov,R,TBL,31,82,32,103,135
9,8481559,Jack Hughes,C,NJD,23,82,42,82,124
9,8477934,Leon Draisaitl,C,EDM,29,82,49,74,123
9,8471675,Sidney Crosby,C,PIT,37,82,54,67,121
9,8478550,Artemi Panarin,L,NYR,33,82,43,71,114
9,8479314,Matthew Tkachuk,L,FLA,27,82,42,69,111
9,8479318,Auston Matthews,C,TOR,27,82,61,47,108
9,8477956,David Pastrnak,R,BOS,28,82,48,60,108
9,8478420,Mikko Rantanen,R,COL,28,82,50,56,106
9,8478864,Kirill Kaprizov,L,MIN,27,82,45,61,106
9,8476887,Filip Forsberg,L,NSH,30,82,55,48,103
9,8474600,Roman Josi,D,NSH,34,82,17,84,101
9,8476454,Ryan Nugent-Hopkins,C,EDM,31,82,43,56,99
9,8477939,William Nylander,R,TOR,28,82,50,47,97
9,8482116,Tim Stützle,C,OTT,22,82,34,63,97
9,8480069,Cale Makar,D,COL,26,82,28,69,97
9,8475810,Bryan Rust,R,PIT,32,82,48,48,96
9,8477493,Aleksander Barkov,C,FLA,29,82,26,70,96
9,8479385,Jordan Kyrou,C,STL,26,82,41,54,95
9,8480801,Brady Tkachuk,L,OTT,25,82,37,57,94
9,8478010,Brayden Point,C,TBL,28,82,43,49,92
9,8480002,Nico Hischier,C,NJD,25,82,35,56,91
9,8476468,J.T. Miller,C,VAN,31,82,34,57,91
9,8479407,Jesper Bratt,L,NJD,26,82,32,59,91
9,8475166,John Tavares,C,TOR,34,82,35,55,90
9,8477946,Dylan Larkin,C,DET,28,82,42,47,89
9,8478440,Dylan Strome,C,WSH,27,82,31,55,86
9,8480800,Quinn Hughes,D,VAN,25,82,15,71,86
9,8480027,Jason Robertson,L,DAL,25,82,36,48,84
9,8478401,Pavel Zacha,C,BOS,27,82,27,57,84
9,8480023,Robert Thomas,C,STL,25,82,20,64,84
9,8471214,Alex Ovechkin,L,WSH,39,82,44,39,83
9,8479420,Tage Thompson,C,BUF,27,82,35,48,83
9,8478427,Sebastian Aho,C,CAR,27,82,33,50,83
9,8471215,Evgeni Malkin,C,PIT,38,82,30,53,83
9,8477409,Carter Verhaeghe,C,FLA,29,82,46,35,81
9,8475913,Mark Stone,R,VGK,32,82,31,50,81
9,8479542,Brandon Hagel,L,TBL,26,82,28,53,81
9,8480036,Miro Heiskanen,D,DAL,25,82,10,71,81
9,8479343,Clayton Keller,R,ARI,26,82,36,44,80
9,8480012,Elias Pettersson,C,VAN,26,82,31,49,80
9,8475172,Nazem Kadri,C,CGY,34,82,33,46,79
9,8477942,Kevin Fiala,L,LAK,28,82,32,47,79
9,8478403,Jack Eichel,C,VGK,28,82,30,49,79
9,8480830,Andrei Svechnikov,R,CAR,24,82,25,54,79
9,8477447,Shea Theodore,D,VGK,29,82,16,63,79
9,8474564,Steven Stamkos,C,TBL,34,82,38,40,78
9,8476460,Mark Scheifele,C,WPG,31,82,37,41,78
9,8477504,Josh Morrissey,D,WPG,29,82,14,64,78
9,8475167,Victor Hedman,D,TBL,34,82,13,65,78
9,8477402,Pavel Buchnevich,L,STL,29,82,34,43,77
9,8478439,Travis Konecny,R,PHI,27,82,24,53,77
9,8475798,Mikael Granlund,C,SJS,32,82,18,59,77
9,8476539,Jonathan Marchessault,R,VGK,34,82,43,33,76
9,8481557,Matt Boldy,L,MIN,23,82,33,43,76
9,8478445,Mathew Barzal,C,NYI,27,82,22,54,76
9,8477960,Adrian Kempe,R,LAK,28,82,38,37,75
9,8477955,Jared McCann,L,SEA,28,82,36,39,75
9,8476389,Vincent Trocheck,C,NYR,31,82,40,34,74
9,8477496,Elias Lindholm,C,VAN,30,82,31,43,74
9,8475754,Brock Nelson,C,NYI,33,82,31,43,74
9,8473512,Claude Giroux,R,OTT,36,82,25,49,74
9,8475692,Mats Zuccarello,R,MIN,37,82,23,51,74
9,8477494,Jonathan Drouin,L,COL,29,82,21,52,73
9,8480865,Noah Dobson,D,NYI,24,82,18,55,73
9,8478519,Anthony Cirelli,C,TBL,27,82,34,38,72
9,8477949,Alex Tuch,R,BUF,28,82,27,45,72
9,8481523,Kirby Dach,C,MTL,23,82,8,64,72
9,8473419,Brad Marchand,L,BOS,36,82,21,49,70
9,8478460,Zach Werenski,D,CBJ,27,82,16,54,70
9,8477501,Valeri Nichushkin,R,COL,29,82,40,29,69
9,8475158,Ryan O'Reilly,C,NSH,33,82,35,34,69
9,8480208,Drake Batherson,R,OTT,26,82,29,40,69
9,8475765,Vladimir Tarasenko,R,FLA,33,82,29,40,69
9,8477964,Ivan Barbashev,C,VGK,29,82,29,40,69
9,8477951,Nick Schmaltz,C,ARI,28,82,26,43,69
9,8474578,Erik Karlsson,D,PIT,34,82,16,53,69
9,8477407,Anthony Duclair,L,TBL,29,82,39,29,68
9,8482093,Seth Jarvis,C,CAR,22,82,37,31,68
9,8479337,Alex DeBrincat,R,DET,27,82,30,38,68
9,8475786,Zach Hyman,L,EDM,32,82,28,40,68
9,8476456,Jonathan Huberdeau,C,CGY,31,82,18,50,68
9,8475784,Jeff Skinner,C,BUF,32,82,26,41,67
9,8476905,Chandler Stephenson,C,VGK,30,82,21,46,67
9,8478396,Noah Hanifin,D,VGK,27,82,17,50,67
9,8482109,Alexis Lafrenière,L,NYR,23,82,35,31,66
9,8477404,Jake Guentzel,C,CAR,30,82,32,34,66
9,8482665,Matty Beniers,C,SEA,22,82,29,37,66
9,8479339,Patrik Laine,L,CBJ,26,82,27,39,66
9,8475191,Reilly Smith,R,PIT,33,82,20,46,66
9,8476346,Johnny Gaudreau,L,CBJ,31,82,18,48,66
9,8476432,Boone Jenner,C,CBJ,31,82,39,26,65
9,8476880,Tom Wilson,R,WSH,30,82,37,28,65
9,8478873,Troy Terry,R,ANA,27,82,30,35,65
9,8477940,Nikolaj Ehlers,L,WPG,28,82,20,45,65
9,8478407,Vince Dunn,D,SEA,28,82,13,52,65
9,8476853,Morgan Rielly,D,TOR,30,82,11,54,65
9,8480803,Evan Bouchard,D,EDM,25,82,10,55,65
9,8476881,Tomas Hertl,C,VGK,31,82,30,34,64
9,8478444,Brock Boeser,R,VAN,27,82,30,34,64
9,8475791,Taylor Hall,L,CHI,33,82,30,34,64
9,8470794,Joe Pavelski,C,DAL,40,82,25,39,64
9,8478462,Nicolas Roy,C,VGK,27,82,24,40,64
9,8476462,Dougie Hamilton,D,NJD,31,82,19,45,64
9,8478398,Kyle Connor,L,WPG,28,82,35,28,63
9,8478449,Roope Hintz,C,DAL,28,82,33,30,63
9,8475745,Charlie Coyle,C,BOS,32,82,30,33,63
9,8479675,Trevor Moore,L,LAK,29,82,27,36,63
9,8475170,Brayden Schenn,C,STL,33,82,25,38,63
9,8476459,Mika Zibanejad,C,NYR,31,82,24,39,63
9,8476448,William Karlsson,C,VGK,31,82,24,39,63
9,8480018,Nick Suzuki,C,MTL,25,82,22,41,63
9,8480839,Rasmus Dahlin,D,BUF,24,82,17,46,63
9,8479323,Adam Fox,D,NYR,26,82,13,50,63
9,8474679,Gustav Nyquist,C,NSH,35,82,13,50,63
9,8481540,Cole Caufield,R,MTL,23,82,33,29,62
9,8477933,Sam Reinhart,C,FLA,29,82,28,34,62
9,8471685,Anze Kopitar,C,LAK,37,82,22,39,61
9,8476882,Teuvo Teravainen,L,CAR,30,82,22,39,61
9,8481711,Matias Maccelli,L,ARI,24,82,21,40,61
9,8482078,Lucas Raymond,L,DET,22,82,18,43,61
9,8477346,MacKenzie Weegar,D,CGY,30,82,15,46,61
9,8477500,Bo Horvat,C,NYI,29,82,29,31,60
9,8474141,Patrick Kane,R,DET,36,82,21,39,60
9,8479345,Jakob Chychrun,D,OTT,26,82,19,41,60
9,8475794,Tyler Seguin,C,DAL,32,82,31,28,59
9,8482097,Jack Quinn,R,BUF,23,82,26,33,59
9,8478047,Michael Bunting,L,PIT,29,82,25,34,59
9,8478042,Viktor Arvidsson,R,LAK,31,82,23,36,59
9,8475168,Matt Duchene,C,DAL,33,82,21,38,59
9,8478472,Mathieu Joseph,R,OTT,27,82,20,39,59
9,8478038,Devon Toews,D,COL,30,82,18,41,59
9,8474590,John Carlson,D,WSH,34,82,13,46,59
9,8475151,Kyle Palmieri,C,NYI,33,82,33,25,58
9,8475184,Chris Kreider,L,NYR,33,82,32,26,58
9,8480014,Gabriel Vilardi,C,WPG,25,82,30,28,58
9,8475726,Tyler Toffoli,C,WPG,32,82,29,28,57
9,8477476,Artturi Lehkonen,L,COL,29,82,20,37,57
9,8470613,Brent Burns,D,CAR,39,82,17,40,57
9,8481533,Trevor Zegras,C,ANA,23,82,26,30,56
9,8476875,Mike Matheson,D,MTL,30,82,12,44,56
9,8475287,Erik Haula,L,NJD,33,82,33,22,55
9,8475169,Evander Kane,L,EDM,33,82,29,26,55
9,8476483,Rickard Rakell,R,PIT,31,82,28,27,55
9,8478414,Timo Meier,R,NJD,28,82,27,28,55
9,8478493,Joel Eriksson Ek,C,MIN,27,82,25,30,55
9,8477479,Tyler Bertuzzi,L,TOR,29,82,22,33,55
9,8477935,Sam Bennett,C,FLA,28,82,25,29,54
9,8481528,Dylan Cozens,C,BUF,23,82,24,30,54
9,8478438,Tommy Novak,C,NSH,27,82,21,33,54
9,8480434,Sean Durzi,D,ARI,26,82,11,43,54
9,8474563,Drew Doughty,D,LAK,35,82,8,46,54
9,8480015,Owen Tippett,R,PHI,25,82,32,21,53
9,8471698,T.J. Oshie,R,WSH,38,82,24,29,53
9,8480064,Josh Norris,C,OTT,25,82,21,32,53
9,8480185,Eetu Luostarinen,C,FLA,26,82,21,32,53
9,8476479,Phillip Danault,C,LAK,31,82,15,38,53
9,8478469,Thomas Chabot,D,OTT,27,82,10,43,53
9,8478366,Frank Vatrano,R,ANA,30,82,30,22,52
9,8478856,Conor Garland,R,VAN,28,82,23,29,52
9,8474641,Adam Henrique,C,EDM,34,82,23,29,52
9,8477497,Sean Monahan,C,WPG,30,82,20,32,52
9,8477444,Andre Burakovsky,L,SEA,29,82,20,32,52
9,8479987,Morgan Geekie,C,BOS,26,82,19,33,52
9,8477986,Brandon Montour,D,FLA,30,82,15,37,52
9,8478397,Rasmus Andersson,D,CGY,28,82,11,41,52
9,8481542,Moritz Seider,D,DET,23,82,11,41,52
9,8479410,Mikhail Sergachev,D,TBL,26,82,8,44,52
9,8482740,Wyatt Johnston,C,DAL,21,82,27,24,51
9,8479400,Pierre-Luc Dubois,L,LAK,26,82,26,25,51
9,8478233,Andrew Mangiapane,L,CGY,28,82,22,29,51
9,8471218,Blake Wheeler,R,NYR,38,82,20,31,51
9,8482475,Yegor Chinakhov,R,CBJ,23,82,18,33,51
9,8474102,David Perron,L,DET,36,82,18,33,51
9,8482745,Mason McTavish,C,ANA,21,82,16,35,51
9,8482124,Quinton Byfield,R,LAK,22,82,16,35,51
9,8477932,Aaron Ekblad,D,FLA,28,82,14,37,51
9,8477495,Seth Jones,D,CHI,30,82,12,39,51
9,8471724,Kris Letang,D,PIT,37,82,8,43,51
9,8480039,Martin Necas,C,CAR,25,82,30,20,50
9,8476399,Blake Coleman,C,CGY,33,82,25,25,50
9,8477511,Anthony Mantha,R,VGK,30,82,24,26,50
9,8476419,Jean-Gabriel Pageau,C,NYI,32,82,22,28,50
9,8475744,Evgeny Kuznetsov,C,CAR,32,82,21,29,50
9,8475722,Jason Zucker,L,NSH,32,82,20,30,50
9,8481618,Alex Newhook,C,MTL,23,82,25,24,49
9,8477416,Oliver Bjorkstrand,R,SEA,29,82,21,28,49
9,8477456,J.T. Compher,L,DET,29,82,20,29,49
9,8473986,Alex Killorn,L,ANA,35,82,19,30,49
9,8481068,Yegor Sharangovich,C,CGY,26,82,26,22,48
9,8475314,Anders Lee,L,NYI,34,82,23,25,48
9,8478474,Lawson Crouse,L,ARI,27,82,19,29,48
9,8473994,Jamie Benn,L,DAL,35,82,18,30,48
9,8480798,Philipp Kurashev,C,CHI,25,82,15,33,48
9,8476854,Hampus Lindholm,D,BOS,30,82,9,39,48
9,8478046,Danton Heinen,L,BOS,29,82,23,24,47
9,8478466,Daniel Sprong,R,DET,27,82,21,26,47
9,8474586,Jordan Eberle,R,SEA,34,82,20,27,47
9,8480028,Morgan Frost,C,PHI,25,82,20,27,47
9,8474157,Max Pacioretty,L,WSH,36,82,19,28,47
9,8479999,Casey Mittelstadt,C,COL,26,82,14,33,47
9,8481596,Shane Pinto,C,OTT,24,82,14,33,47
9,8474150,Mikael Backlund,C,CGY,35,82,13,34,47
9,8478498,Jake DeBrusk,L,BOS,28,82,24,22,46
9,8477451,Ryan Hartman,R,MIN,30,82,19,27,46
9,8477021,Alex Kerfoot,C,ARI,30,82,19,27,46
9,8482113,Anton Lundell,C,FLA,23,82,19,27,46
9,8477998,Warren Foegele,L,EDM,28,82,19,27,46
9,8482175,JJ Peterka,R,BUF,22,82,18,28,46
9,8475768,Jaden Schwartz,C,SEA,32,82,18,28,46
9,8476329,Travis Boyd,C,ARI,31,82,15,31,46
9,8474565,Alex Pietrangelo,D,VGK,34,82,14,32,46
9,8478458,Jack Roslovic,C,NYR,27,82,14,32,46
9,8475753,Justin Faulk,D,STL,32,82,14,32,46
9,8475218,Mattias Ekholm,D,EDM,34,82,10,36,46
9,8475714,Calle Jarnkrok,C,TOR,33,82,26,19,45
9,8479525,Ross Colton,C,COL,28,82,24,21,45
9,8483808,Andrei Kuzmenko,L,CGY,28,82,20,25,45
9,8482667,William Eklund,L,SJS,22,82,20,25,45
9,8478891,Mason Appleton,C,WPG,28,82,16,29,45
9,8476292,Ondrej Palat,L,NJD,33,82,14,31,45
9,8482684,Luke Hughes,D,NJD,21,82,11,34,45
9,8476906,Shayne Gostisbehere,D,DET,31,82,6,39,45
9,8478975,Mason Marchment,L,DAL,29,82,26,18,44
9,8481624,Ilya Mikheyev,R,VAN,30,82,25,19,44
9,8479992,Michael Rasmussen,C,DET,25,82,21,23,44
9,8477498,Darnell Nurse,D,EDM,29,82,14,30,44
9,8476792,Torey Krug,D,STL,33,82,12,32,44
9,8476923,Damon Severson,D,CBJ,30,82,10,34,44
9,8477948,Travis Sanheim,D,PHI,28,82,10,34,44
9,8482699,Dylan Guenther,R,ARI,21,82,17,26,43
9,8478463,Anthony Beauvillier,L,NSH,27,82,17,26,43
9,8477503,Max Domi,C,TOR,29,82,14,29,43
9,8480893,Kirill Marchenko,R,CBJ,24,82,26,16,42
9,8481704,Juuso Parssinen,C,NSH,23,82,23,19,42
9,8483515,Juraj Slafkovsky,L,MTL,20,82,21,21,42
9,8479996,Cody Glass,C,NSH,25,82,19,23,42
9,8476826,Yanni Gourde,C,SEA,33,82,18,24,42
9,8476921,Jordan Martinook,L,CAR,32,82,17,25,42
9,8474149,Evgenii Dadonov,R,DAL,35,82,17,25,42
9,8480797,Joel Farabee,L,PHI,24,82,16,26,42
9,8480009,Eeli Tolvanen,R,SEA,25,82,14,28,42
9,8476869,Brady Skjei,D,CAR,30,82,9,33,42
9,8476872,Scott Laughton,C,PHI,30,82,23,18,41
9,8479365,Trent Frederic,C,BOS,26,82,21,20,41
9,8482146,Luke Evangelista,R,NSH,22,82,17,24,41
9,8480078,Filip Chytil,C,NYR,25,82,13,28,41
9,8481656,Aliaksei Protas,C,WSH,23,82,13,28,41
9,8475197,Tyson Barrie,D,NSH,33,82,9,32,41
9,8480220,Noah Cates,L,PHI,25,82,9,32,41
9,8475906,John Klingberg,D,TOR,32,82,4,37,41
9,8476438,Brandon Saad,L,STL,32,82,27,13,40
9,8475760,Nick Bjugstad,C,ARI,32,82,24,16,40
9,8474053,Logan Couture,C,SJS,35,82,22,18,40
9,8480849,Barrett Hayton,C,ARI,24,82,21,19,40
9,8482110,Dawson Mercer,C,NJD,23,82,18,22,40
9,8482105,Jake Sanderson,D,OTT,22,82,15,25,40
9,8473533,Jordan Staal,C,CAR,36,82,13,27,40
9,8479325,Charlie McAvoy,D,BOS,27,82,12,28,40
9,8479425,Filip Hronek,D,VAN,27,82,10,30,40
9,8480043,Timothy Liljegren,D,TOR,25,82,8,32,40
9,8474151,Ryan McDonagh,D,NSH,35,82,3,37,40
9,8473563,Nicklas Backstrom,C,WSH,37,82,20,19,39
9,8481560,Arthur Kaliyev,R,LAK,23,82,19,20,39
9,8475799,Nino Niederreiter,R,WPG,32,82,19,20,39
9,8478055,Gustav Forsling,D,FLA,28,82,5,34,39
9,8482055,Drew O'Connor,L,PIT,26,82,25,13,38
9,8477330,Dominik Kubalik,L,OTT,29,82,24,14,38
9,8473422,Nick Foligno,L,CHI,37,82,21,17,38
9,8484166,Adam Fantilli,C,CBJ,20,82,21,17,38
9,8478542,Evan Rodrigues,C,FLA,31,82,17,21,38
9,8477839,Conor Sheary,L,TBL,32,82,13,25,38
9,8482117,Lukas Reichel,L,CHI,22,82,13,25,38
9,8484144,Connor Bedard,C,CHI,19,82,12,26,38
9,8480144,David Kampf,C,TOR,29,82,12,26,38
9,8481581,Thomas Harley,D,DAL,23,82,10,28,38
9,8477944,Jakub Vrana,L,STL,28,82,22,15,37
9,8481554,Kaapo Kakko,R,NYR,23,82,21,16,37
9,8482092,Ridly Greig,C,OTT,22,82,19,18,37
9,8470621,Corey Perry,R,EDM,39,82,19,18,37
9,8481186,Logan O'Connor,R,COL,28,82,18,19,37
9,8477450,Jason Dickinson,C,CHI,29,82,18,19,37
9,8475793,Ryan Johansen,C,PHI,32,82,15,22,37
9,8480188,Fabian Zetterlund,L,SJS,25,82,14,23,37
9,8478413,Jordan Greenway,L,BUF,27,82,12,25,37
9,8480817,K'Andre Miller,D,NYR,24,82,11,26,37
9,8482222,Alexander Barabanov,L,SJS,30,82,10,27,37
9,8480145,Neal Pionk,D,WPG,29,82,8,29,37
9,8476931,Jake McCabe,D,TOR,31,82,6,31,37
9,8481178,Egor Zamula,D,PHI,24,82,6,31,37
9,8478500,Ivan Provorov,D,CBJ,27,82,5,32,37
9,8479398,Samuel Girard,D,COL,26,82,3,34,37
9,8482089,Jake Neighbours,L,STL,22,82,19,17,36
9,8476392,Adam Lowry,C,WPG,31,82,16,20,36
9,8476960,Andreas Athanasiou,C,CHI,30,82,15,21,36
9,8481517,Brett Leason,R,ANA,25,82,14,22,36
9,8475763,Kevin Hayes,R,STL,32,82,13,23,36
9,8482720,Matthew Knies,L,TOR,22,82,12,24,36
9,8475149,Marcus Johansson,L,MIN,34,82,11,25,36
9,8475764,Cam Fowler,D,ANA,33,82,3,33,36
9,8481568,Alex Vlasic,D,CHI,23,82,3,33,36
9,8479661,Tanner Jeannot,L,TBL,27,82,20,15,35
9,8478057,Dakota Joshua,C,VAN,28,82,13,22,35
9,8479346,Dillon Dube,C,CGY,26,82,10,25,35
9,8476958,Jaccob Slavin,D,CAR,30,82,5,30,35
9,8476979,Erik Gustafsson,D,NYR,32,82,5,30,35
9,8481014,Alexander Romanov,D,NYI,24,82,4,31,35
9,8478020,Michael Amadio,C,VGK,28,82,18,16,34
9,8480068,Ryan Poehling,C,PHI,25,82,17,17,34
9,8474870,Tyler Johnson,C,CHI,34,82,16,18,34
9,8480459,Pius Suter,C,VAN,28,82,15,19,34
9,8479941,Justin Danforth,R,CBJ,31,82,15,19,34
9,8474189,Lars Eller,C,PIT,35,82,13,21,34
9,8476925,Colton Sissons,C,NSH,31,82,13,21,34
9,8477953,Kasperi Kapanen,R,STL,28,82,12,22,34
9,8474037,James van Riemsdyk,L,BOS,35,82,10,24,34
9,8476927,Teddy Blueger,C,VAN,30,82,9,25,34
9,8482671,Owen Power,D,BUF,22,82,8,26,34
9,8476480,Vladislav Namestnikov,C,WPG,32,82,6,28,34
9,8476892,Colton Parayko,D,STL,31,82,4,30,34
9,8481535,Nils Hoglander,L,VAN,24,82,24,9,33
9,8479591,Michael Eyssimont,C,TBL,28,82,15,18,33
9,8481604,Pavel Dorofeyev,L,VGK,24,82,14,19,33
9,8482159,Tyson Foerster,R,PHI,22,82,17,15,32
9,8479390,Taylor Raddysh,R,CHI,26,82,17,15,32
9,8480448,Parker Kelly,L,OTT,25,82,17,15,32
9,8474884,Mike Hoffman,C,SJS,35,82,16,16,32
9,8480802,Ryan McLeod,C,EDM,25,82,13,19,32
9,8474716,Jared Spurgeon,D,MIN,35,82,11,21,32
9,8476312,Josh Manson,D,COL,33,82,11,21,32
9,8480855,Jack McBain,C,ARI,24,82,11,21,32
9,8482705,Cole Sillinger,C,CBJ,21,82,9,23,32
9,8481059,Scott Perunovich,D,STL,26,82,3,29,32
9,8480873,Rasmus Sandin,D,WSH,24,82,2,30,32
9,8477426,Nicholas Paul,L,TBL,29,82,19,12,31
9,8482125,Alexander Holtz,R,NJD,22,82,18,13,31
9,8477952,Robby Fabbri,C,DET,28,82,15,16,31
9,8476873,Mark Jankowski,C,NSH,30,82,15,16,31
9,8481013,Jonatan Berggren,R,DET,24,82,10,21,31
9,8476461,Sean Couturier,C,PHI,32,82,10,21,31
9,8477508,Curtis Lazar,C,NJD,29,82,10,21,31
9,8480336,Sean Walker,D,COL,30,82,9,22,31
9,8479369,Andrew Peeke,D,BOS,26,82,8,23,31
9,8481703,Valtteri Puustinen,R,PIT,25,82,4,27,31
9,8481580,Connor McMichael,C,WSH,23,82,20,10,30
9,8482062,Cole Smith,L,NSH,29,82,20,10,30
9,8476278,Colin Blackwell,C,CHI,31,82,18,12,30
9,8479316,Luke Kunin,C,SJS,27,82,17,13,30
9,8475231,Casey Cizikas,C,NYI,33,82,14,16,30
9,8482133,Thomas Bordeleau,C,SJS,22,82,12,18,30
9,8478911,Matt Roy,D,LAK,29,82,12,18,30
9,8475220,Marcus Foligno,L,MIN,33,82,10,20,30
9,8477429,Andrew Copp,C,DET,30,82,9,21,30
9,8481546,Cam York,D,PHI,23,82,9,21,30
9,8479415,Michael McLeod,C,NJD,26,82,9,21,30
9,8481606,Jordan Spence,D,LAK,23,82,7,23,30
9,8474013,Ian Cole,D,VAN,35,82,6,24,30
9,8482655,J.J. Moser,D,ARI,24,82,5,25,30
9,8475188,Brayden McNabb,D,VGK,33,82,3,27,30
9,8476458,Ryan Strome,C,ANA,31,82,13,16,29
9,8476871,Tanner Pearson,L,MTL,32,82,13,16,29
9,8482259,Bobby McMann,C,TOR,28,82,11,18,29
9,8483457,Lane Hutson,D,MTL,20,82,9,20,29
9,8480860,Kevin Bahl,D,NJD,24,82,8,21,29
9,8476917,Adam Pelech,D,NYI,30,82,6,23,29
9,8476422,Mike Reilly,D,NYI,31,82,6,23,29
9,8478507,John Marino,D,NJD,27,82,4,25,29
9,8476902,Esa Lindell,D,DAL,30,82,3,26,29
9,8476981,Josh Anderson,R,MTL,30,82,21,7,28
9,8473449,Kyle Okposo,R,FLA,36,82,15,13,28
9,8479514,Rem Pitlick,C,CHI,27,82,12,16,28
9,8479353,Brett Howden,C,VGK,26,82,11,17,28
9,8482074,Connor Zary,C,CGY,23,82,11,17,28
9,8479383,Boris Katchouk,L,OTT,26,82,11,17,28
9,8476374,Sean Kuraly,C,CBJ,31,82,10,18,28
9,8479293,Brandon Tanev,L,SEA,33,82,9,19,28
9,8480871,Adam Boqvist,D,CBJ,24,82,7,21,28
9,8479351,Sam Steel,C,DAL,26,82,7,21,28
9,8477506,Ryan Pulock,D,NYI,30,82,6,22,28
9,8482122,Brock Faber,D,MIN,22,82,5,23,28
9,8475181,Nick Leddy,D,STL,33,82,3,25,28
9,8470610,Zach Parise,L,COL,40,82,17,10,27
9,8483431,Logan Cooley,C,ARI,20,82,15,12,27
9,8480821,Filip Zadina,R,SJS,25,82,14,13,27
9,8476897,Oskar Sundqvist,C,STL,30,82,12,15,27
9,8478115,Pierre Engvall,L,NYI,28,82,12,15,27
9,8480806,Isac Lundestrom,C,ANA,25,82,12,15,27
9,8481553,Bobby Brink,R,PHI,23,82,11,16,27
9,8481522,Peyton Krebs,C,BUF,23,82,11,16,27
9,8476885,Jacob Trouba,D,NYR,30,82,9,18,27
9,8475233,David Savard,D,MTL,34,82,6,21,27
9,8483490,Pavel Mintyukov,D,ANA,21,82,6,21,27
9,8477969,Marcus Pettersson,D,PIT,28,82,2,25,27
9,8479423,Alex Nylander,L,CBJ,26,82,19,7,26
9,8480281,Alexey Toropchenko,R,STL,25,82,17,9,26
9,8478569,Noel Acciari,C,PIT,33,82,13,13,26
9,8477989,Christian Dvorak,C,MTL,28,82,13,13,26
9,8477406,Mattias Janmark,C,EDM,32,82,13,13,26
9,8478109,Victor Olofsson,L,BUF,29,82,12,14,26
9,8478133,Jake Evans,C,MTL,28,82,12,14,26
9,8477947,Sonny Milano,L,WSH,28,82,11,15,26
9,8479291,Kevin Rooney,C,CGY,31,82,11,15,26
9,8473504,Cal Clutterbuck,R,NYI,37,82,10,16,26
9,8483445,Cutter Gauthier,L,ANA,20,82,8,18,26
9,8475171,Oliver Ekman-Larsson,D,FLA,33,82,6,20,26
9,8481567,Henry Thrun,D,SJS,23,82,6,20,26
9,8476525,Colin Miller,D,WPG,32,82,5,21,26
9,8473507,Jeff Petry,D,DET,37,82,2,24,26
9,8477034,Jaycob Megna,D,CHI,32,82,2,24,26
9,8476967,Brett Kulak,D,EDM,30,82,1,25,26
9,8480113,Alex Iafallo,L,WPG,31,82,14,11,25
9,8484145,Zach Benson,L,BUF,19,82,14,11,25
9,8477931,Tomas Nosek,L,NJD,32,82,12,13,25
9,8482079,Marco Rossi,C,MIN,23,82,11,14,25
9,8480074,Alexandre Texier,C,CBJ,25,82,11,14,25
9,8477425,Miles Wood,L,COL,29,82,11,14,25
9,8476878,Zemgus Girgensons,L,BUF,30,82,11,14,25
9,8476469,Joel Armia,R,MTL,31,82,9,16,25
9,8474034,Pat Maroon,L,BOS,36,82,9,16,25
9,8482111,Justin Barron,D,MTL,23,82,6,19,25
9,8479980,Nicolas Hague,D,VGK,26,82,6,19,25
9,8476879,Cody Ceci,D,EDM,31,82,5,20,25
9,8483763,Maksymilian Szuber,D,ARI,22,82,5,20,25
9,8474673,TJ Brodie,D,TOR,34,82,4,21,25
9,8478882,Vladislav Gavrikov,D,LAK,29,82,4,21,25
9,8478840,Will Borgen,D,SEA,28,82,2,23,25
9,8478013,Jake Walman,D,DET,28,82,12,12,24
9,8484153,Leo Carlsson,C,ANA,20,82,12,12,24
9,8481481,Blake Lizotte,C,LAK,27,82,10,14,24
9,8482142,Jamie Drysdale,D,PHI,22,82,9,15,24
9,8481477,Nico Sturm,C,SJS,29,82,9,15,24
9,8479983,Mario Ferraro,D,SJS,26,82,8,16,24
9,8475200,Dmitry Orlov,D,CAR,33,82,7,17,24
9,8482809,Jackson Blake,R,CAR,21,82,7,17,24
9,8477353,Tyler Motte,C,TBL,29,82,7,17,24
9,8480807,Mattias Samuelsson,D,BUF,24,82,7,17,24
9,8479324,Ryan Lindgren,D,NYR,26,82,6,18,24
9,8476467,Jamie Oleksiak,D,SEA,32,82,6,18,24
9,8477435,Ryan Graves,D,PIT,29,82,5,19,24
9,8475455,Brenden Dillon,D,WPG,34,82,4,20,24
9,8480073,Erik Brannstrom,D,OTT,25,82,3,21,24
9,8470600,Ryan Suter,D,DAL,39,82,3,21,24
9,8478859,Niko Mikkola,D,FLA,28,82,2,22,24
9,8475690,Chris Tanev,D,DAL,35,82,1,23,24
9,8478831,Kevin Stenlund,C,FLA,28,82,14,9,23
9,8480995,Pontus Holmberg,R,TOR,25,82,9,14,23
9,8476457,Adam Larsson,D,SEA,32,82,8,15,23
9,8475343,Nic Dowd,C,WSH,34,82,7,16,23
9,8480246,Nick Perbix,D,TBL,26,82,5,18,23
9,8478851,Alexandre Carrier,D,NSH,28,82,5,18,23
9,8475324,Nick Jensen,D,WSH,34,82,3,20,23
9,8480172,Jan Rutta,D,SJS,34,82,3,20,23
9,8482679,Matt Coronato,R,CGY,22,82,16,6,22
9,8478043,Sam Lafferty,C,VAN,29,82,11,11,22
9,8474715,Cam Atkinson,R,PHI,35,82,8,14,22
9,8474009,Nick Bonino,C,NYR,36,82,8,14,22
9,8477488,Brett Pesce,D,CAR,30,82,7,15,22
9,8477507,Nikita Zadorov,D,VAN,29,82,7,15,22
9,8477369,Carson Soucy,D,VAN,30,82,6,16,22
9,8479998,Mikey Anderson,D,LAK,25,82,5,17,22
9,8479976,Juuso Valimaki,D,ARI,26,82,4,18,22
9,8475179,Dmitry Kulikov,D,FLA,34,82,4,18,22
9,8480058,Pierre-Olivier Joseph,D,PIT,25,82,3,19,22
9,8483524,Shane Wright,C,SEA,20,82,13,8,21
9,8470604,Jeff Carter,C,PIT,39,82,11,10,21
9,8481093,Rafael Harvey-Pinard,L,MTL,25,82,11,10,21
9,8470966,Mark Giordano,D,TOR,41,82,8,13,21
9,8476624,Barclay Goodrow,C,NYR,31,82,6,15,21
9,8482087,Kaiden Guhle,D,MTL,22,82,5,16,21
9,8478178,Darren Raddysh,D,TBL,28,82,5,16,21
9,8477845,Trevor van Riemsdyk,D,WSH,33,82,1,20,21
9,8482073,Braden Schneider,D,NYR,23,82,1,20,21
9,8480035,Henri Jokiharju,D,BUF,25,82,0,21,21
9,8475842,Sam Carrick,C,EDM,32,82,14,6,20
9,8479393,Noah Gregor,C,TOR,26,82,11,9,20
9,8482807,Ethan Del Mastro,D,CHI,21,82,11,9,20
9,8482166,Shakir Mukhamadullin,D,SJS,22,82,9,11,20
9,8482470,Ilya Solovyov,D,CGY,24,82,8,12,20
9,8483482,Tristan Luneau,D,ANA,20,82,6,14,20
9,8480834,Ty Emberson,D,SJS,24,82,4,16,20
9,8475790,Erik Gudbranson,D,CBJ,32,82,2,18,20
9,8477365,Connor Clifton,D,BUF,29,82,2,18,20
9,8475208,Brian Dumoulin,D,SEA,33,82,2,18,20
9,8478508,Yakov Trenin,C,COL,27,82,15,4,19
9,8483397,Marc McLaughlin,C,BOS,25,82,11,8,19
9,8482859,Zack Ostapchuk,C,OTT,21,82,10,9,19
9,8481601,Simon Holmstrom,R,NYI,23,82,9,10,19
9,8477392,Hudson Fasching,R,NYI,29,82,9,10,19
9,8482101,Danil Gushchin,L,SJS,22,82,8,11,19
9,8475848,Brendan Gallagher,R,MTL,32,82,7,12,19
9,8477919,Frederick Gaudreau,C,MIN,31,82,7,12,19
9,8482624,Daniil Miromanov,D,CGY,27,82,6,13,19
9,8484203,Bradly Nadeau,L,CAR,19,82,6,13,19
9,8481699,Aku Raty,R,ARI,23,82,6,13,19
9,8478136,Jake Middleton,D,MIN,28,82,5,14,19
9,8480796,Martin Fehervary,D,WSH,25,82,3,16,19
9,8476331,Dylan DeMelo,D,WPG,31,82,0,19,19
9,8480813,Joe Veleno,C,DET,24,82,13,5,18
9,8476858,Phillip Di Giuseppe,L,VAN,31,82,10,8,18
9,8475164,Jakob Silfverberg,R,ANA,34,82,8,10,18
9,8482737,Zack Bolduc,C,STL,21,82,7,11,18
9,8479977,Kailer Yamamoto,R,SEA,26,82,6,12,18
9,8482666,Scott Morrow,D,CAR,22,82,6,12,18
9,8483505,Matthew Poitras,C,BOS,20,82,6,12,18
9,8483565,Nick Blankenburg,D,CBJ,26,82,5,13,18
9,8482730,Brandt Clarke,D,LAK,21,82,4,14,18
9,8478399,Jonas Siegenthaler,D,NJD,27,82,3,15,18
9,8480879,Jacob Bernard-Docker,D,OTT,24,82,3,15,18
9,8482245,Artem Zub,D,OTT,29,82,2,16,18
9,8473453,Trevor Lewis,C,LAK,37,82,8,9,17
9,8479442,Troy Stecher,D,EDM,30,82,8,9,17
9,8476442,Matt Nieto,L,PIT,32,82,7,10,17
9,8481537,Nikita Okhotiuk,D,CGY,24,82,5,12,17
9,8483468,Jiri Kulich,C,BUF,20,82,5,12,17
9,8478416,Erik Cernak,D,TBL,27,82,4,13,17
9,8477015,Connor Brown,R,EDM,30,82,4,13,17
9,8478451,Ethan Bear,D,WSH,27,82,4,13,17
9,8477220,Nate Schmidt,D,WPG,33,82,3,14,17
9,8474574,Tyler Myers,D,VAN,34,82,2,15,17
9,8479371,Dante Fabbro,D,NSH,26,82,2,15,17
9,8474166,Alec Martinez,D,VGK,37,82,2,15,17
9,8475462,Radko Gudas,D,ANA,34,82,2,15,17
9,8478430,Oliver Kylington,D,CGY,27,82,1,16,17
9,8481524,Bowen Byram,D,BUF,23,82,9,7,16
9,8482712,Oskar Olausson,R,COL,22,82,6,10,16
9,8483493,Frank Nazar,C,CHI,20,82,5,11,16
9,8484149,Gavin Brindley,C,CBJ,20,82,5,11,16
9,8476463,Jonas Brodin,D,MIN,31,82,4,12,16
9,8475279,Ben Chiarot,D,DET,33,82,4,12,16
9,8482118,Sam Colangelo,R,ANA,23,82,4,12,16
9,8482733,Logan Mailloux,D,MTL,31,82,3,13,16
9,8476891,Matt Grzelcyk,D,BOS,30,82,3,13,16
9,8482155,Alex Laferriere,R,LAK,23,82,8,7,15
9,8481028,Martin Pospisil,C,CGY,25,82,8,7,15
9,8479359,Beck Malenstyn,L,WSH,26,82,3,12,15
9,8476372,Nick Seeler,D,PHI,31,82,2,13,15
9,8484911,Collin Graf,R,SJS,22,82,9,5,14
9,8483491,Ivan Miroshnichenko,L,WSH,20,82,7,7,14
9,8483495,Simon Nemec,D,NJD,20,82,4,10,14
9,8482803,Olen Zellweger,D,ANA,21,82,4,10,14
9,8474567,Zach Bogosian,D,MIN,34,82,4,10,14
9,8477335,Kyle Burroughs,D,SJS,29,82,4,10,14
9,8482713,Mackie Samoskevich,R,FLA,22,82,4,10,14
9,8477499,Rasmus Ristolainen,D,PHI,30,82,2,12,14
9,8482762,Simon Edvinsson,D,DET,21,82,8,5,13
9,8482702,Logan Stankoven,C,DAL,21,82,7,6,13
9,8483012,Logan Morrison,C,SEA,22,82,7,6,13
9,8481578,Graeme Clarke,R,NJD,23,82,7,6,13
9,8480990,Declan Chisholm,D,MIN,24,82,5,8,13
9,8475762,Derek Forbort,D,BOS,32,82,5,8,13
9,8483466,Kevin Korchinski,D,CHI,20,82,5,8,13
9,8481605,Jackson LaCombe,D,ANA,23,82,5,8,13
9,8483499,Liam Ohgren,L,MIN,20,82,4,9,13
9,8471677,Jack Johnson,D,COL,37,82,4,9,13
9,8475177,Calvin de Haan,D,TBL,33,82,4,9,13
9,8476473,Connor Murphy,D,CHI,31,82,3,10,13
9,8483471,Brad Lambert,C,WPG,31,82,6,6,12
9,8477505,Alexander Wennberg,C,NYR,30,82,5,7,12
9,8482145,Mavrik Bourque,C,DAL,22,82,5,7,12
9,8475825,Jani Hakanpää,D,DAL,32,82,5,7,12
9,8481599,Victor Soderstrom,D,ARI,23,82,4,8,12
9,8481030,Jack St. Ivany,D,PIT,25,82,3,9,12
9,8481016,Ruslan Iskhakov,C,NYI,24,82,5,6,11
9,8482858,Ryker Evans,D,SEA,23,82,5,6,11
9,8476429,Scott Mayfield,D,NYI,32,82,3,8,11
9,8476915,Jujhar Khaira,L,MIN,30,82,6,4,10
9,8478468,Jeremy Lauzon,D,NSH,27,82,3,7,10
9,8480031,Maxime Comtois,L,CAR,25,82,1,9,10
9,8476822,Luke Glendening,C,TBL,35,82,7,2,9
9,8482516,Matthew Kessel,D,STL,24,82,2,7,9
9,8478443,Brandon Carlo,D,BOS,28,82,1,8,9
9,8482177,Marat Khusnutdinov,C,MIN,22,82,3,5,8
9,8478408,Travis Dermott,D,ARI,28,82,2,5,7
9,8483489,Fraser Minten,C,TOR,31,82,3,3,6
9,8477950,Tony DeAngelo,D,CAR,29,0,0,0,0
9,8481577,Philip Tomasino,C,NSH,23,0,0,0,0
9,8482660,Kent Johnson,C,CBJ,22,0,0,0,0
9,8481019,David Gustafsson,C,WPG,24,0,0,0,0
9,8479348,Kale Clague,D,BUF,26,0,0,0,0
9,8482149,Cole Perfetti,C,WPG,22,0,0,0,0
9,8476952,Dominic Toninato,C,WPG,30,0,0,0,0
9,8473473,Milan Lucic,L,BOS,36,0,0,0,0
9,8480829,Jesperi Kotkaniemi,C,CAR,24,0,0,0,0
9,8474602,Justin Schultz,D,SEA,34,0,0,0,0
9,8480049,Dylan Samberg,D,WPG,25,0,0,0,0
9,8479372,Josh Mahura,D,FLA,26,0,0,0,0
9,8480878,Nils Lundkvist,D,DAL,24,0,0,0,0
9,8479982,Conor Timmins,D,TOR,26,0,0,0,0
9,8474031,Kevin Shattenkirk,D,BOS,35,0,0,0,0
9,8480835,Jack Drury,C,CAR,24,0,0,0,0
9,8480008,Adam Ruzicka,C,ARI,25,0,0,0,0
9,8479402,Jake Bean,D,CBJ,26,0,0,0,0
9,8476474,Stefan Noesen,R,CAR,31,0,0,0,0
9,8480884,Calen Addison,D,SJS,24,0,0,0,0
9,8476994,Vinnie Hinostroza,C,PIT,30,0,0,0,0
9,8477987,Ryan Donato,C,CHI,28,0,0,0,0
9,8481582,Nicholas Robertson,L,TOR,23,0,0,0,0
9,8478452,Caleb Jones,D,COL,27,0,0,0,0
9,8480157,Calle Rosen,D,STL,30,0,0,0,0
9,8481609,Vladislav Kolyachonok,D,ARI,23,0,0,0,0
9,8476919,Chris Tierney,C,NJD,30,0,0,0,0
9,8479639,Dylan Coghlan,D,CAR,26,0,0,0,0
9,8475193,Tomas Tatar,L,SEA,34,0,0,0,0
9,8480748,Kiefer Sherwood,L,NSH,29,0,0,0,0
9,8478146,Matthew Highmore,C,OTT,28,0,0,0,0
9,8478970,Jalen Chatfield,D,CAR,28,0,0,0,0
9,8480205,Emil Bemstrom,C,PIT,25,0,0,0,0
9,8471274,Alex Goligoski,D,MIN,39,0,0,0,0
9,8478104,Sammy Blais,L,STL,28,0,0,0,0
9,8476913,Devin Shore,C,SEA,30,0,0,0,0
9,8481708,Zac Jones,D,NYR,24,0,0,0,0
9,8480222,Sebastian Aho,D,NYI,28,0,0,0,0
9,8481598,Philip Broberg,D,EDM,23,0,0,0,0
9,8480789,Oliver Wahlstrom,R,NYI,24,0,0,0,0
9,8480891,Michael Kesselring,D,ARI,24,0,0,0,0
9,8477979,Nicolas Aube-Kubel,R,WSH,28,0,0,0,0
9,8476393,Nick Cousins,C,FLA,31,0,0,0,0
9,8480003,Jesper Boqvist,C,BOS,26,0,0,0,0
9,8479543,Michael Pezzetta,L,MTL,26,0,0,0,0
9,8475855,Jesper Fast,R,CAR,33,0,0,0,0
9,8477018,Ben Hutton,D,VGK,31,0,0,0,0
9,8480762,Eric Robinson,L,BUF,29,0,0,0,0
9,8481058,Jesse Ylönen,R,MTL,25,0,0,0,0
9,8481527,Kaedan Korczak,D,VGK,23,0,0,0,0
9,8482192,Isaak Phillips,D,CHI,23,0,0,0,0
9,8480727,Zach Whitecloud,D,VGK,28,0,0,0,0
9,8480001,Urho Vaakanainen,D,ANA,25,0,0,0,0
9,8480853,Liam Foudy,C,NSH,24,0,0,0,0
9,8475225,Craig Smith,C,DAL,35,0,0,0,0
9,8479972,Mason Shaw,C,MIN,26,0,0,0,0
9,8474040,Sam Gagner,C,EDM,35,0,0,0,0
9,8480196,Jacob Bryson,D,BUF,27,0,0,0,0
9,8475718,Justin Holl,D,DET,32,0,0,0,0
9,8479984,Cal Foote,D,NJD,26,0,0,0,0
9,8480011,Klim Kostin,C,SJS,25,0,0,0,0
9,8482176,Wyatt Kaiser,D,CHI,22,0,0,0,0
9,8476918,Jimmy Vesey,L,NYR,31,0,0,0,0
9,8476988,Matt Benning,D,SJS,30,0,0,0,0
9,8479370,Tyson Jost,C,BUF,26,0,0,0,0
9,8477464,Nic Petan,C,MIN,29,0,0,0,0
9,8477380,Jonny Brodzinski,C,NYR,31,0,0,0,0
9,8480070,Ian Mitchell,D,BOS,25,0,0,0,0
9,8479315,Joey Anderson,R,CHI,26,0,0,0,0
9,8478099,Kevin Labanc,R,SJS,29,0,0,0,0
9,8476874,Olli Maatta,D,DET,30,0,0,0,0
9,8479414,Nathan Bastian,R,NJD,27,0,0,0,0
9,8478434,Keegan Kolesar,R,VGK,27,0,0,0,0
9,8479536,Axel Jonsson-Fjallby,L,WPG,26,0,0,0,0
9,8479671,Mathieu Olivier,R,CBJ,27,0,0,0,0
9,8471709,Marc-Edouard Vlasic,D,SJS,37,0,0,0,0
9,8479328,Julien Gauthier,R,NYI,27,0,0,0,0
9,8478421,A.J. Greer,L,CGY,28,0,0,0,0
9,8477573,Nathan Walker,L,STL,30,0,0,0,0
9,8477478,William Carrier,L,VGK,30,0,0,0,0
9,8479344,Jesse Puljujarvi,R,PIT,26,0,0,0,0
9,8480887,Jordan Harris,D,MTL,24,0,0,0,0
9,8478502,Dennis Gilbert,D,CGY,28,0,0,0,0
9,8480355,Mark Kastelic,C,OTT,25,0,0,0,0
9,8475750,Jon Merrill,D,MIN,32,0,0,0,0
9,8476889,Radek Faksa,C,DAL,30,0,0,0,0
9,8478432,Christian Fischer,R,DET,27,0,0,0,0
9,8479439,Jacob MacDonald,D,SJS,31,0,0,0,0
9,8474568,Luke Schenn,D,NSH,35,0,0,0,0
9,8478454,Noah Juulsen,D,VAN,27,0,0,0,0
9,8475752,Tyler Pitlick,C,NYR,33,0,0,0,0
9,8482148,Hendrix Lapierre,C,WSH,22,0,0,0,0
9,8481167,Brayden Pachal,D,CGY,25,0,0,0,0
9,8478211,Dryden Hunt,L,CGY,29,0,0,0,0
9,8479321,Lucas Johansen,D,WSH,27,0,0,0,0
9,8480950,Ilya Lyubushkin,D,TOR,30,0,0,0,0
9,8479368,Max Jones,L,ANA,26,0,0,0,0
9,8471699,Andrew Cogliano,C,COL,37,0,0,0,0
9,8481521,Ronnie Attard,D,PHI,25,0,0,0,0
9,8481161,Jake Christiansen,D,CBJ,25,0,0,0,0
9,8479458,Nikita Zaitsev,D,CHI,33,0,0,0,0
9,8479619,Michael Carcone,L,ARI,28,0,0,0,0
9,8479026,Philippe Myers,D,TBL,27,0,0,0,0
9,8481617,Vasily Podkolzin,R,VAN,23,0,0,0,0
9,8481701,Santeri Hatakka,D,NJD,23,0,0,0,0
9,8477446,Michael McCarron,R,NSH,29,0,0,0,0
9,8483460,David Jiricek,D,CBJ,21,0,0,0,0
9,8474090,Brendan Smith,D,NJD,35,0,0,0,0
9,8482241,Radim Zohorna,L,PIT,28,0,0,0,0
9,8481032,Paul Cotter,C,VGK,25,0,0,0,0
9,8480289,Morgan Barron,C,WPG,26,0,0,0,0
9,8479379,Givani Smith,R,SJS,26,0,0,0,0
9,8480216,Jacob Peterson,C,SJS,25,0,0,0,0
9,8477851,Jordan Oesterle,D,CGY,32,0,0,0,0
9,8484258,Sam Malinski,D,COL,26,0,0,0,0
9,8478904,Steven Lorentz,C,FLA,28,0,0,0,0
9,8482095,Tyler Kleven,D,OTT,22,0,0,0,0
9,8480980,Connor Dewar,C,TOR,25,0,0,0,0
9,8480848,Ty Dellandrea,C,DAL,24,0,0,0,0
9,8476884,Derrick Pouliot,D,DAL,30,0,0,0,0
9,8480025,MacKenzie Entwistle,R,CHI,25,0,0,0,0
9,8474612,Travis Hamonic,D,OTT,34,0,0,0,0
9,8479336,Carl Grundstrom,R,LAK,27,0,0,0,0
9,8482964,Arber Xhekaj,D,MTL,23,0,0,0,0
9,8471686,Marc Staal,D,PHI,37,0,0,0,0
9,8477887,Patrick Brown,C,BOS,32,0,0,0,0
9,8478495,Denis Gurianov,R,PHI,27,0,0,0,0
9,8481550,Adam Beckman,L,MIN,23,0,0,0,0
9,8480845,Rasmus Kupari,C,WPG,24,0,0,0,0
9,8478585,Derek Ryan,C,EDM,38,0,0,0,0
9,8482141,Lukas Cormier,D,VGK,22,0,0,0,0
9,8477962,Brendan Lemieux,L,CAR,28,0,0,0,0
9,8482861,Vincent Iorio,D,WSH,22,0,0,0,0
9,8479378,Logan Stanley,D,WPG,26,0,0,0,0
9,8473446,Erik Johnson,D,PHI,36,0,0,0,0
9,8481743,Marc Del Gaizo,D,NSH,25,0,0,0,0
9,8478450,Parker Wotherspoon,D,BOS,27,0,0,0,0
9,8477384,Josh Brown,D,ARI,30,0,0,0,0
9,8482165,Yan Kuznetsov,D,CGY,22,0,0,0,0
9,8478424,Jansen Harkins,C,PIT,27,0,0,0,0
9,8482144,Jack Thompson,D,SJS,22,0,0,0,0
9,8479576,Vincent Desharnais,D,EDM,28,0,0,0,0
9,8478512,Austin Czarnik,C,DET,32,0,0,0,0
9,8477527,Ross Johnston,L,ANA,30,0,0,0,0
9,8482094,Daemon Hunt,D,MIN,22,0,0,0,0
9,8481719,Maxwell Crozier,D,TBL,24,0,0,0,0
9,8480192,Johnathan Kovacevic,D,MTL,27,0,0,0,0
9,8479376,Victor Mete,D,PHI,26,0,0,0,0
9,8482511,Mason Lohrei,D,BOS,23,0,0,0,0
9,8478021,William Lagesson,D,ANA,28,0,0,0,0
9,8475795,Dylan McIlrath,D,WSH,32,0,0,0,0
9,8477846,Ryan Carpenter,C,SJS,33,0,0,0,0
9,8481056,Spencer Stastney,D,NSH,24,0,0,0,0
9,8481564,Ryan Johnson,D,BUF,23,0,0,0,0
9,8478017,Mark Friedman,D,VAN,29,0,0,0,0
9,8479320,Max Lajoie,D,TOR,27,0,0,0,0
9,8480075,Cameron Crotty,D,ARI,25,0,0,0,0
9,8484287,Cole McWard,D,VAN,23,0,0,0,0
9,8484254,Akito Hirose,D,VAN,25,0,0,0,0
9,8483407,Brandon Scanlin,D,NYR,25,0,0,0,0
9,8480274,Philip Kemp,D,EDM,25,0,0,0,0
9,8479522,Hardy Haman Aktell,D,WSH,26,0,0,0,0
9,8480007,Jonas Rondbjerg,R,VGK,25,0,0,0,0
9,8477454,Adam Erne,L,EDM,29,0,0,0,0
9,8481679,Maxence Guenette,D,OTT,23,0,0,0,0
9,8477938,Haydn Fleury,D,TBL,28,0,0,0,0
9,8476441,Joel Edmundson,D,TOR,31,0,0,0,0
9,8477903,Garnet Hathaway,R,PHI,33,0,0,0,0
9,8480441,Trey Fix-Wolansky,R,CBJ,25,0,0,0,0
9,8483546,Marshall Rifai,D,TOR,26,0,0,0,0
9,8480084,Nick DeSimone,D,NJD,30,0,0,0,0
9,8481592,Jakob Pelletier,L,CGY,23,0,0,0,0
9,8478011,Louie Belpedio,D,PHI,28,0,0,0,0
9,8477930,Pierre-Edouard Bellemare,L,SEA,39,0,0,0,0
9,8484321,Nikolas Matinpalo,D,OTT,26,0,0,0,0
9,8482067,Connor Mackey,D,NYR,28,0,0,0,0
9,8481806,Louis Crevier,D,CHI,23,0,0,0,0
9,8484326,Patrik Koch,D,ARI,28,0,0,0,0
9,8477971,Andreas Englund,D,LAK,28,0,0,0,0
9,8481751,Lukas Rousek,R,BUF,25,0,0,0,0
9,8481006,Tyler Tucker,D,STL,24,0,0,0,0
9,8481641,Joel Kiviranta,L,COL,28,0,0,0,0
9,8476867,Brendan Gaunce,C,CBJ,30,0,0,0,0
9,8479520,Brandon Duhaime,R,COL,27,0,0,0,0
9,8477073,Kurtis MacDermid,L,NJD,30,0,0,0,0
9,8480874,Adam Ginning,D,PHI,24,0,0,0,0
9,8477473,Justin Bailey,R,SJS,29,0,0,0,0
9,8479066,Ryan Lomberg,L,FLA,30,0,0,0,0
9,8477070,Liam O'Brien,C,ARI,30,0,0,0,0
9,8474618,Marco Scandella,D,STL,34,0,0,0,0
9,8475797,Jarred Tinordi,D,CHI,32,0,0,0,0
9,8481441,Joe Snively,C,WSH,28,0,0,0,0
9,8477244,Chad Ruhwedel,D,NYR,34,0,0,0,0
9,8482077,Dylan Holloway,L,EDM,23,0,0,0,0
9,8479772,Zack MacEwen,R,OTT,28,0,0,0,0
9,8481147,Reese Johnson,C,CHI,26,0,0,0,0
9,8481043,Cole Koepke,L,TBL,26,0,0,0,0
9,8483619,Filip Roos,D,CHI,25,0,0,0,0
9,8481541,Samuel Bolduc,D,NYI,24,0,0,0,0
9,8477810,Joel Hanley,D,CGY,33,0,0,0,0
9,8476907,Mackenzie MacEachern,L,STL,30,0,0,0,0
9,8482652,Walker Duehr,R,CGY,27,0,0,0,0
9,8477126,Jayson Megna,C,BOS,34,0,0,0,0
9,8483398,Declan Carlile,D,TBL,31,0,0,0,0
9,8482929,Emil Lilleberg,D,TBL,23,0,0,0,0
9,8480880,Jakub Lauko,C,BOS,24,0,0,0,0
9,8478874,Adam Gaudette,C,STL,28,0,0,0,0
9,8480245,Olle Lycksell,R,PHI,25,0,0,0,0
9,8480252,Cole Guttman,C,CHI,25,0,0,0,0
9,8477467,Gustav Olofsson,D,SEA,30,0,0,0,0
9,8479968,Vinni Lettieri,C,MIN,29,0,0,0,0
9,8478400,Colin White,C,MTL,27,0,0,0,0
9,8475755,Alexander Petrovic,D,DAL,32,0,0,0,0
9,8481812,Nikolai Knyzhov,D,SJS,27,0,0,0,0
9,8481593,Jayden Struble,D,MTL,23,0,0,0,0
9,8481532,Alex Turcotte,C,LAK,23,0,0,0,0
9,8482126,Emil Andrae,D,PHI,31,0,0,0,0
9,8479944,Zach Aston-Reese,C,DET,30,0,0,0,0
9,8471817,Ryan Reaves,R,TOR,37,0,0,0,0
9,8481206,John Ludvig,D,PIT,24,0,0,0,0
9,8480292,Carson Meyer,R,CBJ,27,0,0,0,0
9,8482496,Nils Aman,C,VAN,24,0,0,0,0
9,8479718,Alex Barré-Boulet,C,TBL,27,0,0,0,0
9,8479994,Jaret Anderson-Dolan,C,NSH,25,0,0,0,0
9,8480184,Gustav Lindstrom,D,ANA,26,0,0,0,0
9,8480890,Jan Jenik,R,ARI,24,0,0,0,0
9,8478067,Oskar Lindblom,L,SJS,28,0,0,0,0
9,8476934,Brock McGinn,L,ANA,30,0,0,0,0
9,8479985,Cale Fleury,D,SEA,26,0,0,0,0
9,8482153,Brendan Brisson,C,VGK,23,0,0,0,0
9,8480021,Jack Studnicka,C,SJS,25,0,0,0,0
9,8484304,Uvis Balinskis,D,FLA,28,0,0,0,0
9,8479981,Jonah Gadjovich,L,FLA,26,0,0,0,0
9,8481716,Dmitri Voronkov,L,CBJ,24,0,0,0,0
9,8482659,Josh Doan,R,ARI,22,0,0,0,0
9,8481122,Simon Benoit,D,TOR,26,0,0,0,0
9,8474709,Matt Martin,L,NYI,35,0,0,0,0
9,8482634,Alex Steeves,C,TOR,25,0,0,0,0
9,8480823,Alexander Alexeyev,D,WSH,25,0,0,0,0
9,8477541,Dakota Mermis,D,MIN,30,0,0,0,0
9,8478477,Mitchell Stephens,C,MTL,27,0,0,0,0
9,8481543,Nikita Alexandrov,C,STL,24,0,0,0,0
9,8482451,Mikael Pyyhtia,L,CBJ,23,0,0,0,0
9,8480306,Grant Hutton,D,NYI,29,0,0,0,0
9,8478028,Fredrik Olofsson,L,COL,28,0,0,0,0
9,8477462,Robert Hagg,D,ANA,29,0,0,0,0
9,8477320,Anton Blidh,L,NYR,29,0,0,0,0
9,8482749,Joshua Roy,R,MTL,21,0,0,0,0
9,8482157,Will Cuylle,L,NYR,22,0,0,0,0
9,8481239,Samuel Fagemo,L,LAK,24,0,0,0,0
9,8481600,Tobias Bjornfot,D,FLA,23,0,0,0,0
9,8478409,Anthony Richard,C,BOS,28,0,0,0,0
9,8474145,Robert Bortuzzo,D,NYI,35,0,0,0,0
9,8475958,Michael Sgarbossa,C,WSH,32,0,0,0,0
9,8479986,Kole Lind,R,SEA,26,0,0,0,0
9,8479249,Andrew Poturalski,C,SEA,30,0,0,0,0
9,8479362,Riley Tufte,L,COL,26,0,0,0,0
9,8479991,Jake Leschyshyn,C,NYR,25,0,0,0,0
9,8479587,Rhett Gardner,C,PHI,28,0,0,0,0
9,8482744,James Malatesta,L,CBJ,21,0,0,0,0
9,8478854,Ryan Shea,D,PIT,27,0,0,0,0
9,8481591,Sam Poulin,R,PIT,23,0,0,0,0
9,8483512,Matt Savoie,C,BUF,20,0,0,0,0
9,8482102,Vasily Ponomarev,C,CAR,22,0,0,0,0
9,8482162,Roby Jarventie,L,OTT,22,0,0,0,0
9,8482172,Landon Slaggert,L,CHI,22,0,0,0,0
9,8482747,Brennan Othmann,L,NYR,21,0,0,0,0
9,8480226,Marián Studenic,R,SEA,26,0,0,0,0
9,8481518,Nolan Foote,L,NJD,24,0,0,0,0
9,8479419,Brett Murray,L,BUF,26,0,0,0,0
9,8482088,Justin Sourdif,R,FLA,22,0,0,0,0
9,8482201,Gage Goncalves,C,TBL,23,0,0,0,0
9,8481754,Nikita Nesterenko,C,ANA,23,0,0,0,0
9,8483531,Brian Halonen,L,NJD,25,0,0,0,0
9,8483920,Pierrick Dube,R,WSH,23,0,0,0,0
9,8480851,Akil Thomas,C,LAK,24,0,0,0,0
9,8475235,Nicolas Deslauriers,L,PHI,33,0,0,0,0
9,8482476,Emil Heineman,L,MTL,23,0,0,0,0
9,8477149,Scott Sabourin,R,SJS,32,0,0,0,0
9,8483549,Lucas Condotta,L,MTL,27,0,0,0,0
9,8483567,Georgii Merkulov,C,BOS,24,0,0,0,0
9,8482765,Isak Rosen,R,BUF,21,0,0,0,0
9,8481237,Kyle MacLean,C,NYI,25,0,0,0,0
9,8481024,Linus Karlsson,C,VAN,25,0,0,0,0
9,8481690,Tyler Angle,C,CBJ,24,0,0,0,0
9,8483570,Ben Meyers,C,ANA,26,0,0,0,0
9,8481655,Cole Schwindt,R,CGY,23,0,0,0,0
9,8481462,Mason Morelli,L,VGK,28,0,0,0,0
9,8483401,Marc Johnstone,R,PIT,28,0,0,0,0
9,8478956,Samuel Laberge,L,NJD,27,0,0,0,0
9,8479533,Joona Koppanen,L,PIT,26,0,0,0,0
9,8482197,Adam Raska,R,MIN,23,0,0,0,0
9,8482250,Callahan Burke,C,CAR,27,0,0,0,0
9,8482784,Zach Dean,C,STL,21,0,0,0,0
9,8484255,Jason Polin,R,COL,25,0,0,0,0
9,8481077,John Leonard,L,ARI,26,0,0,0,0
9,8481534,Raphael Lavoie,C,EDM,24,0,0,0,0
9,8483609,Adam Klapka,R,CGY,24,0,0,0,0
9,8482751,Ryan Winterton,C,SEA,21,0,0,0,0
9,8480267,Sammy Walker,C,MIN,25,0,0,0,0
9,8475766,Austin Watson,L,TBL,32,0,0,0,0
9,8482460,Matt Rempe,C,NYR,22,0,0,0,0
9,8482787,Nikita Chibrikov,R,WPG,31,0,0,0,0
9,8481065,Angus Crookshank,L,OTT,25,0,0,0,0
9,8481070,Hugh McGing,L,STL,26,0,0,0,0
9,8476323,Max McCormick,L,SEA,32,0,0,0,0
9,8483395,Arshdeep Bains,L,VAN,23,0,0,0,0
9,8484259,Ondrej Pavel,C,COL,31,0,0,0,0
9,8483432,Luca Del Bel Belluz,C,CBJ,31,0,0,0,0
9,8483045,Cameron Butler,R,CBJ,31,0,0,0,0
9,8482061,Brandon Biro,L,BUF,26,0,0,0,0
9,8477401,John Hayden,C,SEA,29,0,0,0,0
9,8475278,Byron Froese,C,VGK,33,0,0,0,0
9,8478446,Glenn Gawdin,C,ANA,27,0,0,0,0
9,8477993,Justin Kirkland,C,ARI,28,0,0,0,0
9,8482147,Jean-Luc Foudy,C,COL,22,0,0,0,0
9,8480032,Shane Bowers,C,NJD,25,0,0,0,0
9,8479330,Brandon Gignac,C,MTL,27,0,0,0,0
9,8480776,Sheldon Rempal,R,VGK,29,0,0,0,0
9,8475413,Justin Dowling,C,NJD,34,0,0,0,0
9,8481726,Adam Edstrom,C,NYR,24,0,0,0,0
9,8479638,Justin Brazeau,R,BOS,26,0,0,0,0
9,8480844,Grigori Denisenko,L,VGK,24,0,0,0,0
9,8474062,Riley Nash,C,NYR,35,0,0,0,0
9,8478147,Bokondji Imama,L,OTT,28,0,0,0,0
9,8478881,Brett Seney,L,CHI,28,0,0,0,0
9,8483630,Pavol Regenda,L,ANA,25,0,0,0,0
9,8480836,Jonathan Gruden,C,PIT,24,0,0,0,0
9,8484314,Jiri Smejkal,L,OTT,28,0,0,0,0
9,8475780,Chris Wagner,R,COL,33,0,0,0,0
9,8482070,Mitchell Chaffee,R,TBL,26,0,0,0,0
9,8479546,Oskar Steen,C,BOS,26,0,0,0,0
9,8483597,Milos Kelemen,L,ARI,25,0,0,0,0
9,8481789,Tye Kartye,L,SEA,23,0,0,0,0
9,8484325,Waltteri Merela,C,TBL,26,0,0,0,0
9,8479421,Jacob Moverare,D,LAK,26,0,0,0,0
9,8481585,Egor Afanasyev,L,NSH,23,0,0,0,0
9,8479547,Matthew Phillips,R,WSH,26,0,0,0,0
9,8479367,William Lockwood,R,FLA,26,0,0,0,0
9,8481422,Jacob Lucchini,C,MIN,29,0,0,0,0
9,8480468,James Hamblin,L,EDM,25,0,0,0,0
9,8480870,Bo Groulx,C,ANA,24,0,0,0,0
9,8478051,Max Willman,C,NJD,29,0,0,0,0
9,8481556,John Beecher,C,BOS,23,0,0,0,0
9,8478078,Rourke Chartier,C,OTT,28,0,0,0,0
10,8476453,Nikita Kucherov,R,TBL,31,82,41,101,142
10,8478402,Connor McDavid,C,EDM,27,82,40,98,138
10,8481559,Jack Hughes,C,NJD,23,82,54,80,134
10,8477492,Nathan MacKinnon,C,COL,29,82,53,77,130
10,8477934,Leon Draisaitl,C,EDM,29,82,43,86,129
10,8477956,David Pastrnak,R,BOS,28,82,60,61,121
10,8477939,William Nylander,R,TOR,28,82,46,73,119
10,8479318,Auston Matthews,C,TOR,27,82,60,58,118
10,8476887,Filip Forsberg,L,NSH,30,82,55,61,116
10,8476468,J.T. Miller,C,VAN,31,82,44,69,113
10,8478550,Artemi Panarin,L,NYR,33,82,31,82,113
10,8478010,Brayden Point,C,TBL,28,82,42,68,110
10,8479314,Matthew Tkachuk,L,FLA,27,82,34,73,107
10,8478864,Kirill Kaprizov,L,MIN,27,82,54,48,102
10,8478420,Mikko Rantanen,R,COL,28,82,42,60,102
10,8478439,Travis Konecny,R,PHI,27,82,39,62,101
10,8475172,Nazem Kadri,C,CGY,34,82,36,62,98
10,8471675,Sidney Crosby,C,PIT,37,82,41,56,97
10,8474564,Steven Stamkos,C,TBL,34,82,43,53,96
10,8474600,Roman Josi,D,NSH,34,82,24,72,96
10,8477404,Jake Guentzel,C,CAR,30,82,42,53,95
10,8471215,Evgeni Malkin,C,PIT,38,82,40,55,95
10,8478445,Mathew Barzal,C,NYI,27,82,29,66,95
10,8480801,Brady Tkachuk,L,OTT,25,82,44,49,93
10,8475913,Mark Stone,R,VGK,32,82,25,68,93
10,8480012,Elias Pettersson,C,VAN,26,82,32,60,92
10,8480023,Robert Thomas,C,STL,25,82,24,65,89
10,8476389,Vincent Trocheck,C,NYR,31,82,42,46,88
10,8480208,Drake Batherson,R,OTT,26,82,37,51,88
10,8475168,Matt Duchene,C,DAL,33,82,32,56,88
10,8480069,Cale Makar,D,COL,26,82,30,58,88
10,8477949,Alex Tuch,R,BUF,28,82,29,59,88
10,8478403,Jack Eichel,C,VGK,28,82,41,46,87
10,8480027,Jason Robertson,L,DAL,25,82,35,52,87
10,8477942,Kevin Fiala,L,LAK,28,82,30,57,87
10,8479343,Clayton Keller,R,ARI,26,82,42,43,85
10,8482116,Tim Stützle,C,OTT,22,82,24,61,85
10,8477493,Aleksander Barkov,C,FLA,29,82,21,64,85
10,8477933,Sam Reinhart,C,FLA,29,82,36,48,84
10,8480002,Nico Hischier,C,NJD,25,82,33,51,84
10,8477946,Dylan Larkin,C,DET,28,82,26,58,84
10,8475167,Victor Hedman,D,TBL,34,82,17,67,84
10,8479323,Adam Fox,D,NYR,26,82,18,65,83
10,8480800,Quinn Hughes,D,VAN,25,82,15,68,83
10,8477501,Valeri Nichushkin,R,COL,29,82,44,38,82
10,8479385,Jordan Kyrou,C,STL,26,82,30,51,81
10,8480036,Miro Heiskanen,D,DAL,25,82,21,60,81
10,8477409,Carter Verhaeghe,C,FLA,29,82,38,42,80
10,8477402,Pavel Buchnevich,L,STL,29,82,29,51,80
10,8476459,Mika Zibanejad,C,NYR,31,82,28,52,80
10,8475692,Mats Zuccarello,R,MIN,37,82,27,53,80
10,8478427,Sebastian Aho,C,CAR,27,82,39,40,79
10,8479407,Jesper Bratt,L,NJD,26,82,23,55,78
10,8479420,Tage Thompson,C,BUF,27,82,44,33,77
10,8475166,John Tavares,C,TOR,34,82,34,43,77
10,8476462,Dougie Hamilton,D,NJD,31,82,26,51,77
10,8474590,John Carlson,D,WSH,34,82,14,63,77
10,8481557,Matt Boldy,L,MIN,23,82,33,43,76
10,8470794,Joe Pavelski,C,DAL,40,82,31,45,76
10,8477951,Nick Schmaltz,C,ARI,28,82,30,46,76
10,8478449,Roope Hintz,C,DAL,28,82,29,47,76
10,8476454,Ryan Nugent-Hopkins,C,EDM,31,82,27,49,76
10,8482684,Luke Hughes,D,NJD,21,82,23,53,76
10,8475810,Bryan Rust,R,PIT,32,82,34,41,75
10,8480830,Andrei Svechnikov,R,CAR,24,82,31,44,75
10,8471214,Alex Ovechkin,L,WSH,39,82,25,50,75
10,8480865,Noah Dobson,D,NYI,24,82,19,56,75
10,8478460,Zach Werenski,D,CBJ,27,82,18,57,75
10,8475184,Chris Kreider,L,NYR,33,82,49,25,74
10,8481528,Dylan Cozens,C,BUF,23,82,34,40,74
10,8480018,Nick Suzuki,C,MTL,25,82,22,52,74
10,8480839,Rasmus Dahlin,D,BUF,24,82,17,57,74
10,8481523,Kirby Dach,C,MTL,23,82,14,59,73
10,8477955,Jared McCann,L,SEA,28,82,32,40,72
10,8474141,Patrick Kane,R,DET,36,82,27,45,72
10,8477504,Josh Morrissey,D,WPG,29,82,14,58,72
10,8475786,Zach Hyman,L,EDM,32,82,44,27,71
10,8477500,Bo Horvat,C,NYI,29,82,44,27,71
10,8482093,Seth Jarvis,C,CAR,22,82,36,35,71
10,8477416,Oliver Bjorkstrand,R,SEA,29,82,30,41,71
10,8476399,Blake Coleman,C,CGY,33,82,28,43,71
10,8477447,Shea Theodore,D,VGK,29,82,16,55,71
10,8478398,Kyle Connor,L,WPG,28,82,22,48,70
10,8475158,Ryan O'Reilly,C,NSH,33,82,33,36,69
10,8477960,Adrian Kempe,R,LAK,28,82,29,40,69
10,8480039,Martin Necas,C,CAR,25,82,29,40,69
10,8482124,Quinton Byfield,R,LAK,22,82,28,41,69
10,8474679,Gustav Nyquist,C,NSH,35,82,19,50,69
10,8474578,Erik Karlsson,D,PIT,34,82,17,52,69
10,8476881,Tomas Hertl,C,VGK,31,82,31,37,68
10,8477940,Nikolaj Ehlers,L,WPG,28,82,28,40,68
10,8481533,Trevor Zegras,C,ANA,23,82,23,45,68
10,8478396,Noah Hanifin,D,VGK,27,82,16,52,68
10,8476539,Jonathan Marchessault,R,VGK,34,82,34,33,67
10,8478444,Brock Boeser,R,VAN,27,82,33,34,67
10,8475754,Brock Nelson,C,NYI,33,82,30,37,67
10,8474586,Jordan Eberle,R,SEA,34,82,27,40,67
10,8473512,Claude Giroux,R,OTT,36,82,22,45,67
10,8478438,Tommy Novak,C,NSH,27,82,17,50,67
10,8476880,Tom Wilson,R,WSH,30,82,32,34,66
10,8478493,Joel Eriksson Ek,C,MIN,27,82,30,36,66
10,8477479,Tyler Bertuzzi,L,TOR,29,82,27,39,66
10,8477496,Elias Lindholm,C,VAN,30,82,26,40,66
10,8473419,Brad Marchand,L,BOS,36,82,19,47,66
10,8478975,Mason Marchment,L,DAL,29,82,29,36,65
10,8481711,Matias Maccelli,L,ARI,24,82,17,48,65
10,8482665,Matty Beniers,C,SEA,22,82,29,35,64
10,8479339,Patrik Laine,L,CBJ,26,82,29,35,64
10,8478414,Timo Meier,R,NJD,28,82,27,37,64
10,8479542,Brandon Hagel,L,TBL,26,82,23,41,64
10,8475765,Vladimir Tarasenko,R,FLA,33,82,22,42,64
10,8478474,Lawson Crouse,L,ARI,27,82,35,28,63
10,8478042,Viktor Arvidsson,R,LAK,31,82,26,37,63
10,8478233,Andrew Mangiapane,L,CGY,28,82,26,37,63
10,8476346,Johnny Gaudreau,L,CBJ,31,82,17,46,63
10,8480014,Gabriel Vilardi,C,WPG,25,82,39,23,62
10,8476432,Boone Jenner,C,CBJ,31,82,36,26,62
10,8481540,Cole Caufield,R,MTL,23,82,30,32,62
10,8482078,Lucas Raymond,L,DET,22,82,26,36,62
10,8473994,Jamie Benn,L,DAL,35,82,26,36,62
10,8475726,Tyler Toffoli,C,WPG,32,82,29,32,61
10,8479337,Alex DeBrincat,R,DET,27,82,23,38,61
10,8477494,Jonathan Drouin,L,COL,29,82,16,45,61
10,8476456,Jonathan Huberdeau,C,CGY,31,82,15,46,61
10,8476875,Mike Matheson,D,MTL,30,82,15,46,61
10,8482745,Mason McTavish,C,ANA,21,82,25,35,60
10,8474565,Alex Pietrangelo,D,VGK,34,82,20,40,60
10,8476460,Mark Scheifele,C,WPG,31,82,19,41,60
10,8478519,Anthony Cirelli,C,TBL,27,82,25,34,59
10,8477021,Alex Kerfoot,C,ARI,30,82,18,41,59
10,8480803,Evan Bouchard,D,EDM,25,82,15,44,59
10,8479325,Charlie McAvoy,D,BOS,27,82,15,44,59
10,8474641,Adam Henrique,C,EDM,34,82,33,25,58
10,8482110,Dawson Mercer,C,NJD,23,82,30,28,58
10,8481596,Shane Pinto,C,OTT,24,82,28,30,58
10,8478401,Pavel Zacha,C,BOS,27,82,23,35,58
10,8481618,Alex Newhook,C,MTL,23,82,23,35,58
10,8477932,Aaron Ekblad,D,FLA,28,82,19,39,58
10,8478440,Dylan Strome,C,WSH,27,82,26,31,57
10,8475784,Jeff Skinner,C,BUF,32,82,24,33,57
10,8480028,Morgan Frost,C,PHI,25,82,21,36,57
10,8477444,Andre Burakovsky,L,SEA,29,82,18,39,57
10,8478856,Conor Garland,R,VAN,28,82,17,40,57
10,8477503,Max Domi,C,TOR,29,82,15,42,57
10,8478397,Rasmus Andersson,D,CGY,28,82,12,45,57
10,8477495,Seth Jones,D,CHI,30,82,11,46,57
10,8481068,Yegor Sharangovich,C,CGY,26,82,26,30,56
10,8474150,Mikael Backlund,C,CGY,35,82,22,34,56
10,8471685,Anze Kopitar,C,LAK,37,82,20,36,56
10,8475798,Mikael Granlund,C,SJS,32,82,14,42,56
10,8474563,Drew Doughty,D,LAK,35,82,13,43,56
10,8480064,Josh Norris,C,OTT,25,82,36,19,55
10,8477986,Brandon Montour,D,FLA,30,82,26,29,55
10,8478047,Michael Bunting,L,PIT,29,82,21,34,55
10,8475170,Brayden Schenn,C,STL,33,82,20,35,55
10,8479345,Jakob Chychrun,D,OTT,26,82,15,40,55
10,8471724,Kris Letang,D,PIT,37,82,12,43,55
10,8475794,Tyler Seguin,C,DAL,32,82,30,24,54
10,8482097,Jack Quinn,R,BUF,23,82,27,27,54
10,8473986,Alex Killorn,L,ANA,35,82,21,33,54
10,8478873,Troy Terry,R,ANA,27,82,20,34,54
10,8479400,Pierre-Luc Dubois,L,LAK,26,82,20,34,54
10,8476853,Morgan Rielly,D,TOR,30,82,13,41,54
10,8479410,Mikhail Sergachev,D,TBL,26,82,12,42,54
10,8480015,Owen Tippett,R,PHI,25,82,33,20,53
10,8474053,Logan Couture,C,SJS,35,82,31,22,53
10,8476448,William Karlsson,C,VGK,31,82,26,27,53
10,8482699,Dylan Guenther,R,ARI,21,82,25,28,53
10,8479675,Trevor Moore,L,LAK,29,82,24,29,53
10,8483808,Andrei Kuzmenko,L,CGY,28,82,23,30,53
10,8478498,Jake DeBrusk,L,BOS,28,82,21,32,53
10,8476438,Brandon Saad,L,STL,32,82,29,23,52
10,8475714,Calle Jarnkrok,C,TOR,33,82,27,25,52
10,8478462,Nicolas Roy,C,VGK,27,82,26,26,52
10,8475287,Erik Haula,L,NJD,33,82,26,26,52
10,8477935,Sam Bennett,C,FLA,28,82,23,29,52
10,8482113,Anton Lundell,C,FLA,23,82,22,30,52
10,8475791,Taylor Hall,L,CHI,33,82,20,32,52
10,8478466,Daniel Sprong,R,DET,27,82,20,32,52
10,8474157,Max Pacioretty,L,WSH,36,82,18,34,52
10,8478407,Vince Dunn,D,SEA,28,82,12,40,52
10,8471698,T.J. Oshie,R,WSH,38,82,27,24,51
10,8482092,Ridly Greig,C,OTT,22,82,26,25,51
10,8482740,Wyatt Johnston,C,DAL,21,82,20,31,51
10,8474102,David Perron,L,DET,36,82,20,31,51
10,8480078,Filip Chytil,C,NYR,25,82,20,31,51
10,8475745,Charlie Coyle,C,BOS,32,82,18,33,51
10,8479425,Filip Hronek,D,VAN,27,82,14,37,51
10,8482159,Tyson Foerster,R,PHI,22,82,26,24,50
10,8475151,Kyle Palmieri,C,NYI,33,82,25,25,50
10,8482175,JJ Peterka,R,BUF,22,82,23,27,50
10,8480009,Eeli Tolvanen,R,SEA,25,82,20,30,50
10,8476479,Phillip Danault,C,LAK,31,82,17,33,50
10,8476905,Chandler Stephenson,C,VGK,30,82,15,35,50
10,8475191,Reilly Smith,R,PIT,33,82,25,24,49
10,8480459,Pius Suter,C,VAN,28,82,24,25,49
10,8478542,Evan Rodrigues,C,FLA,31,82,21,28,49
10,8482667,William Eklund,L,SJS,22,82,20,29,49
10,8481186,Logan O'Connor,R,COL,28,82,17,32,49
10,8476458,Ryan Strome,C,ANA,31,82,15,34,49
10,8477948,Travis Sanheim,D,PHI,28,82,14,35,49
10,8482105,Jake Sanderson,D,OTT,22,82,13,36,49
10,8478469,Thomas Chabot,D,OTT,27,82,12,37,49
10,8477426,Nicholas Paul,L,TBL,29,82,27,21,48
10,8482109,Alexis Lafrenière,L,NYR,23,82,25,23,48
10,8475169,Evander Kane,L,EDM,33,82,22,26,48
10,8480188,Fabian Zetterlund,L,SJS,25,82,19,29,48
10,8477346,MacKenzie Weegar,D,CGY,30,82,11,37,48
10,8480434,Sean Durzi,D,ARI,26,82,11,37,48
10,8476906,Shayne Gostisbehere,D,DET,31,82,11,37,48
10,8470613,Brent Burns,D,CAR,39,82,10,38,48
10,8478055,Gustav Forsling,D,FLA,28,82,8,40,48
10,8478038,Devon Toews,D,COL,30,82,7,41,48
10,8482146,Luke Evangelista,R,NSH,22,82,28,19,47
10,8474037,James van Riemsdyk,L,BOS,35,82,23,24,47
10,8475760,Nick Bjugstad,C,ARI,32,82,19,28,47
10,8475799,Nino Niederreiter,R,WPG,32,82,17,30,47
10,8480113,Alex Iafallo,L,WPG,31,82,16,31,47
10,8479999,Casey Mittelstadt,C,COL,26,82,11,36,47
10,8475744,Evgeny Kuznetsov,C,CAR,32,82,10,37,47
10,8477407,Anthony Duclair,L,TBL,29,82,27,19,46
10,8475793,Ryan Johansen,C,PHI,32,82,23,23,46
10,8476882,Teuvo Teravainen,L,CAR,30,82,21,25,46
10,8477456,J.T. Compher,L,DET,29,82,18,28,46
10,8483515,Juraj Slafkovsky,L,MTL,20,82,27,18,45
10,8475314,Anders Lee,L,NYI,34,82,22,23,45
10,8475768,Jaden Schwartz,C,SEA,32,82,21,24,45
10,8483431,Logan Cooley,C,ARI,20,82,21,24,45
10,8477947,Sonny Milano,L,WSH,28,82,21,24,45
10,8478458,Jack Roslovic,C,NYR,27,82,18,27,45
10,8484144,Connor Bedard,C,CHI,19,82,15,30,45
10,8482671,Owen Power,D,BUF,22,82,12,33,45
10,8476792,Torey Krug,D,STL,33,82,11,34,45
10,8478507,John Marino,D,NJD,27,82,6,39,45
10,8476869,Brady Skjei,D,CAR,30,82,5,40,45
10,8476483,Rickard Rakell,R,PIT,31,82,24,20,44
10,8478366,Frank Vatrano,R,ANA,30,82,23,21,44
10,8482055,Drew O'Connor,L,PIT,26,82,21,23,44
10,8476329,Travis Boyd,C,ARI,31,82,16,28,44
10,8477964,Ivan Barbashev,C,VGK,29,82,15,29,44
10,8481581,Thomas Harley,D,DAL,23,82,15,29,44
10,8477476,Artturi Lehkonen,L,COL,29,82,14,30,44
10,8479365,Trent Frederic,C,BOS,26,82,22,21,43
10,8480849,Barrett Hayton,C,ARI,24,82,22,21,43
10,8474149,Evgenii Dadonov,R,DAL,35,82,19,24,43
10,8476292,Ondrej Palat,L,NJD,33,82,15,28,43
10,8477497,Sean Monahan,C,WPG,30,82,20,22,42
10,8480797,Joel Farabee,L,PHI,24,82,19,23,42
10,8480798,Philipp Kurashev,C,CHI,25,82,16,26,42
10,8478463,Anthony Beauvillier,L,NSH,27,82,19,22,41
10,8478046,Danton Heinen,L,BOS,29,82,18,23,41
10,8477998,Warren Foegele,L,EDM,28,82,15,26,41
10,8475197,Tyson Barrie,D,NSH,33,82,12,29,41
10,8476854,Hampus Lindholm,D,BOS,30,82,9,32,41
10,8480817,K'Andre Miller,D,NYR,24,82,7,34,41
10,8477511,Anthony Mantha,R,VGK,30,82,21,19,40
10,8473422,Nick Foligno,L,CHI,37,82,21,19,40
10,8471218,Blake Wheeler,R,NYR,38,82,17,23,40
10,8474189,Lars Eller,C,PIT,35,82,17,23,40
10,8474870,Tyler Johnson,C,CHI,34,82,16,24,40
10,8479992,Michael Rasmussen,C,DET,25,82,15,25,40
10,8475753,Justin Faulk,D,STL,32,82,14,26,40
10,8477451,Ryan Hartman,R,MIN,30,82,13,27,40
10,8476826,Yanni Gourde,C,SEA,33,82,10,30,40
10,8480871,Adam Boqvist,D,CBJ,24,82,10,30,40
10,8476958,Jaccob Slavin,D,CAR,30,82,9,31,40
10,8477969,Marcus Pettersson,D,PIT,28,82,1,39,40
10,8481554,Kaapo Kakko,R,NYR,23,82,20,19,39
10,8480068,Ryan Poehling,C,PHI,25,82,18,21,39
10,8479415,Michael McLeod,C,NJD,26,82,18,21,39
10,8477839,Conor Sheary,L,TBL,32,82,16,23,39
10,8481656,Aliaksei Protas,C,WSH,23,82,14,25,39
10,8475763,Kevin Hayes,R,STL,32,82,14,25,39
10,8482111,Justin Barron,D,MTL,23,82,14,25,39
10,8477498,Darnell Nurse,D,EDM,29,82,12,27,39
10,8475218,Mattias Ekholm,D,EDM,34,82,11,28,39
10,8478472,Mathieu Joseph,R,OTT,27,82,9,30,39
10,8479591,Michael Eyssimont,C,TBL,28,82,24,14,38
10,8480893,Kirill Marchenko,R,CBJ,24,82,21,17,38
10,8475722,Jason Zucker,L,NSH,32,82,20,18,38
10,8482222,Alexander Barabanov,L,SJS,30,82,19,19,38
10,8476927,Teddy Blueger,C,VAN,30,82,15,23,38
10,8478413,Jordan Greenway,L,BUF,27,82,14,24,38
10,8475149,Marcus Johansson,L,MIN,34,82,12,26,38
10,8475906,John Klingberg,D,TOR,32,82,8,30,38
10,8479941,Justin Danforth,R,CBJ,31,82,22,15,37
10,8482117,Lukas Reichel,L,CHI,22,82,20,17,37
10,8478057,Dakota Joshua,C,VAN,28,82,19,18,37
10,8478115,Pierre Engvall,L,NYI,28,82,17,20,37
10,8482720,Matthew Knies,L,TOR,22,82,16,21,37
10,8481624,Ilya Mikheyev,R,VAN,30,82,14,23,37
10,8481542,Moritz Seider,D,DET,23,82,11,26,37
10,8476979,Erik Gustafsson,D,NYR,32,82,9,28,37
10,8475764,Cam Fowler,D,ANA,33,82,4,33,37
10,8482089,Jake Neighbours,L,STL,22,82,25,11,36
10,8480821,Filip Zadina,R,SJS,25,82,22,14,36
10,8481560,Arthur Kaliyev,R,LAK,23,82,21,15,36
10,8475848,Brendan Gallagher,R,MTL,32,82,17,19,36
10,8476925,Colton Sissons,C,NSH,31,82,16,20,36
10,8476885,Jacob Trouba,D,NYR,30,82,7,29,36
10,8480043,Timothy Liljegren,D,TOR,25,82,4,32,36
10,8470604,Jeff Carter,C,PIT,39,82,18,17,35
10,8480185,Eetu Luostarinen,C,FLA,26,82,17,18,35
10,8476392,Adam Lowry,C,WPG,31,82,17,18,35
10,8479423,Alex Nylander,L,CBJ,26,82,16,19,35
10,8480074,Alexandre Texier,C,CBJ,25,82,14,21,35
10,8477989,Christian Dvorak,C,MTL,28,82,13,22,35
10,8476419,Jean-Gabriel Pageau,C,NYI,32,82,12,23,35
10,8477953,Kasperi Kapanen,R,STL,28,82,11,24,35
10,8476872,Scott Laughton,C,PHI,30,82,10,25,35
10,8480220,Noah Cates,L,PHI,25,82,10,25,35
10,8476897,Oskar Sundqvist,C,STL,30,82,10,25,35
10,8481535,Nils Hoglander,L,VAN,24,82,21,13,34
10,8479525,Ross Colton,C,COL,28,82,18,16,34
10,8476873,Mark Jankowski,C,NSH,30,82,16,18,34
10,8481704,Juuso Parssinen,C,NSH,23,82,15,19,34
10,8481553,Bobby Brink,R,PHI,23,82,14,20,34
10,8479996,Cody Glass,C,NSH,25,82,11,23,34
10,8481606,Jordan Spence,D,LAK,23,82,7,27,34
10,8476917,Adam Pelech,D,NYI,30,82,7,27,34
10,8473563,Nicklas Backstrom,C,WSH,37,82,16,17,33
10,8477429,Andrew Copp,C,DET,30,82,10,23,33
10,8474716,Jared Spurgeon,D,MIN,35,82,6,27,33
10,8482655,J.J. Moser,D,ARI,24,82,4,29,33
10,8478851,Alexandre Carrier,D,NSH,28,82,3,30,33
10,8481580,Connor McMichael,C,WSH,23,82,19,13,32
10,8480813,Joe Veleno,C,DET,24,82,18,14,32
10,8481013,Jonatan Berggren,R,DET,24,82,17,15,32
10,8476921,Jordan Martinook,L,CAR,32,82,16,16,32
10,8481604,Pavel Dorofeyev,L,VGK,24,82,15,17,32
10,8479346,Dillon Dube,C,CGY,26,82,14,18,32
10,8482125,Alexander Holtz,R,NJD,22,82,13,19,32
10,8479987,Morgan Geekie,C,BOS,26,82,10,22,32
10,8481703,Valtteri Puustinen,R,PIT,25,82,10,22,32
10,8476278,Colin Blackwell,C,CHI,31,82,9,23,32
10,8477506,Ryan Pulock,D,NYI,30,82,8,24,32
10,8480073,Erik Brannstrom,D,OTT,25,82,7,25,32
10,8483457,Lane Hutson,D,MTL,20,82,6,26,32
10,8473507,Jeff Petry,D,DET,37,82,5,27,32
10,8479976,Juuso Valimaki,D,ARI,26,82,3,29,32
10,8476892,Colton Parayko,D,STL,31,82,1,31,32
10,8477944,Jakub Vrana,L,STL,28,82,18,13,31
10,8482062,Cole Smith,L,NSH,29,82,18,13,31
10,8476981,Josh Anderson,R,MTL,30,82,17,14,31
10,8477952,Robby Fabbri,C,DET,28,82,16,15,31
10,8476871,Tanner Pearson,L,MTL,32,82,14,17,31
10,8479353,Brett Howden,C,VGK,26,82,12,19,31
10,8475343,Nic Dowd,C,WSH,34,82,12,19,31
10,8481481,Blake Lizotte,C,LAK,27,82,11,20,31
10,8481522,Peyton Krebs,C,BUF,23,82,8,23,31
10,8475171,Oliver Ekman-Larsson,D,FLA,33,82,8,23,31
10,8484153,Leo Carlsson,C,ANA,20,82,18,12,30
10,8478109,Victor Olofsson,L,BUF,29,82,16,14,30
10,8479293,Brandon Tanev,L,SEA,33,82,14,16,30
10,8482475,Yegor Chinakhov,R,CBJ,23,82,11,19,30
10,8480855,Jack McBain,C,ARI,24,82,10,20,30
10,8476461,Sean Couturier,C,PHI,32,82,10,20,30
10,8479351,Sam Steel,C,DAL,26,82,9,21,30
10,8476960,Andreas Athanasiou,C,CHI,30,82,8,22,30
10,8476931,Jake McCabe,D,TOR,31,82,5,25,30
10,8477488,Brett Pesce,D,CAR,30,82,4,26,30
10,8480035,Henri Jokiharju,D,BUF,25,82,3,27,30
10,8479390,Taylor Raddysh,R,CHI,26,82,16,13,29
10,8477425,Miles Wood,L,COL,29,82,15,14,29
10,8473449,Kyle Okposo,R,FLA,36,82,13,16,29
10,8482624,Daniil Miromanov,D,CGY,27,82,12,17,29
10,8478911,Matt Roy,D,LAK,29,82,11,18,29
10,8478013,Jake Walman,D,DET,28,82,11,18,29
10,8479977,Kailer Yamamoto,R,SEA,26,82,11,18,29
10,8482809,Jackson Blake,R,CAR,21,82,9,20,29
10,8476467,Jamie Oleksiak,D,SEA,32,82,9,20,29
10,8476312,Josh Manson,D,COL,33,82,7,22,29
10,8476923,Damon Severson,D,CBJ,30,82,6,23,29
10,8475200,Dmitry Orlov,D,CAR,33,82,5,24,29
10,8478178,Darren Raddysh,D,TBL,28,82,5,24,29
10,8479398,Samuel Girard,D,COL,26,82,4,25,29
10,8477330,Dominik Kubalik,L,OTT,29,82,17,11,28
10,8476480,Vladislav Namestnikov,C,WPG,32,82,14,14,28
10,8482079,Marco Rossi,C,MIN,23,82,13,15,28
10,8482133,Thomas Bordeleau,C,SJS,22,82,10,18,28
10,8481537,Nikita Okhotiuk,D,CGY,24,82,9,19,28
10,8478882,Vladislav Gavrikov,D,LAK,29,82,7,21,28
10,8478500,Ivan Provorov,D,CBJ,27,82,4,24,28
10,8476463,Jonas Brodin,D,MIN,31,82,4,24,28
10,8474151,Ryan McDonagh,D,NSH,35,82,3,25,28
10,8479371,Dante Fabbro,D,NSH,26,82,2,26,28
10,8478508,Yakov Trenin,C,COL,27,82,20,7,27
10,8473533,Jordan Staal,C,CAR,36,82,16,11,27
10,8480281,Alexey Toropchenko,R,STL,25,82,15,12,27
10,8482074,Connor Zary,C,CGY,23,82,13,14,27
10,8476525,Colin Miller,D,WPG,32,82,7,20,27
10,8474715,Cam Atkinson,R,PHI,35,82,7,20,27
10,8478451,Ethan Bear,D,WSH,27,82,7,20,27
10,8483495,Simon Nemec,D,NJD,20,82,6,21,27
10,8482142,Jamie Drysdale,D,PHI,22,82,2,25,27
10,8479998,Mikey Anderson,D,LAK,25,82,2,25,27
10,8481093,Rafael Harvey-Pinard,L,MTL,25,82,16,10,26
10,8470610,Zach Parise,L,COL,40,82,14,12,26
10,8479393,Noah Gregor,C,TOR,26,82,13,13,26
10,8480806,Isac Lundestrom,C,ANA,25,82,12,14,26
10,8484203,Bradly Nadeau,L,CAR,19,82,11,15,26
10,8473504,Cal Clutterbuck,R,NYI,37,82,10,16,26
10,8477220,Nate Schmidt,D,WPG,33,82,10,16,26
10,8480336,Sean Walker,D,COL,30,82,7,19,26
10,8478133,Jake Evans,C,MTL,28,82,7,19,26
10,8476902,Esa Lindell,D,DAL,30,82,3,23,26
10,8470621,Corey Perry,R,EDM,39,82,12,13,25
10,8477450,Jason Dickinson,C,CHI,29,82,12,13,25
10,8480802,Ryan McLeod,C,EDM,25,82,12,13,25
10,8477505,Alexander Wennberg,C,NYR,30,82,10,15,25
10,8480144,David Kampf,C,TOR,29,82,9,16,25
10,8479316,Luke Kunin,C,SJS,27,82,9,16,25
10,8479514,Rem Pitlick,C,CHI,27,82,8,17,25
10,8478569,Noel Acciari,C,PIT,33,82,8,17,25
10,8476422,Mike Reilly,D,NYI,31,82,5,20,25
10,8482122,Brock Faber,D,MIN,22,82,5,20,25
10,8476967,Brett Kulak,D,EDM,30,82,5,20,25
10,8475690,Chris Tanev,D,DAL,35,82,5,20,25
10,8470966,Mark Giordano,D,TOR,41,82,4,21,25
10,8482245,Artem Zub,D,OTT,29,82,4,21,25
10,8481178,Egor Zamula,D,PHI,24,82,2,23,25
10,8474673,TJ Brodie,D,TOR,34,82,2,23,25
10,8478020,Michael Amadio,C,VGK,28,82,16,8,24
10,8477392,Hudson Fasching,R,NYI,29,82,12,12,24
10,8482166,Shakir Mukhamadullin,D,SJS,22,82,10,14,24
10,8475220,Marcus Foligno,L,MIN,33,82,8,16,24
10,8481546,Cam York,D,PHI,23,82,8,16,24
10,8482705,Cole Sillinger,C,CBJ,21,82,6,18,24
10,8480246,Nick Perbix,D,TBL,26,82,6,18,24
10,8480145,Neal Pionk,D,WPG,29,82,5,19,24
10,8479983,Mario Ferraro,D,SJS,26,82,5,19,24
10,8475181,Nick Leddy,D,STL,33,82,3,21,24
10,8475279,Ben Chiarot,D,DET,33,82,3,21,24
10,8480860,Kevin Bahl,D,NJD,24,82,2,22,24
10,8476469,Joel Armia,R,MTL,31,82,17,6,23
10,8478043,Sam Lafferty,C,VAN,29,82,15,8,23
10,8481517,Brett Leason,R,ANA,25,82,11,12,23
10,8483524,Shane Wright,C,SEA,20,82,11,12,23
10,8481601,Simon Holmstrom,R,NYI,23,82,11,12,23
10,8477015,Connor Brown,R,EDM,30,82,11,12,23
10,8479661,Tanner Jeannot,L,TBL,27,82,10,13,23
10,8478891,Mason Appleton,C,WPG,28,82,9,14,23
10,8481599,Victor Soderstrom,D,ARI,23,82,8,15,23
10,8477499,Rasmus Ristolainen,D,PHI,30,82,6,17,23
10,8482087,Kaiden Guhle,D,MTL,22,82,5,18,23
10,8478136,Jake Middleton,D,MIN,28,82,5,18,23
10,8479369,Andrew Peeke,D,BOS,26,82,4,19,23
10,8475233,David Savard,D,MTL,34,82,3,20,23
10,8480873,Rasmus Sandin,D,WSH,24,82,2,21,23
10,8479291,Kevin Rooney,C,CGY,31,82,16,6,22
10,8484145,Zach Benson,L,BUF,19,82,11,11,22
10,8476374,Sean Kuraly,C,CBJ,31,82,10,12,22
10,8482730,Brandt Clarke,D,LAK,21,82,10,12,22
10,8481477,Nico Sturm,C,SJS,29,82,9,13,22
10,8482666,Scott Morrow,D,CAR,22,82,9,13,22
10,8477508,Curtis Lazar,C,NJD,29,82,8,14,22
10,8475208,Brian Dumoulin,D,SEA,33,82,3,19,22
10,8480879,Jacob Bernard-Docker,D,OTT,24,82,3,19,22
10,8481568,Alex Vlasic,D,CHI,23,82,2,20,22
10,8475179,Dmitry Kulikov,D,FLA,34,82,1,21,22
10,8477931,Tomas Nosek,L,NJD,32,82,15,6,21
10,8482259,Bobby McMann,C,TOR,28,82,14,7,21
10,8484166,Adam Fantilli,C,CBJ,20,82,11,10,21
10,8473453,Trevor Lewis,C,LAK,37,82,10,11,21
10,8483505,Matthew Poitras,C,BOS,20,82,9,12,21
10,8476442,Matt Nieto,L,PIT,32,82,9,12,21
10,8482702,Logan Stankoven,C,DAL,21,82,9,12,21
10,8484149,Gavin Brindley,C,CBJ,20,82,8,13,21
10,8477406,Mattias Janmark,C,EDM,32,82,7,14,21
10,8482858,Ryker Evans,D,SEA,23,82,7,14,21
10,8474166,Alec Martinez,D,VGK,37,82,4,17,21
10,8480172,Jan Rutta,D,SJS,34,82,3,18,21
10,8477845,Trevor van Riemsdyk,D,WSH,33,82,3,18,21
10,8476331,Dylan DeMelo,D,WPG,31,82,3,18,21
10,8476429,Scott Mayfield,D,NYI,32,82,3,18,21
10,8481014,Alexander Romanov,D,NYI,24,82,2,19,21
10,8479980,Nicolas Hague,D,VGK,26,82,2,19,21
10,8479324,Ryan Lindgren,D,NYR,26,82,2,19,21
10,8475188,Brayden McNabb,D,VGK,33,82,1,20,21
10,8482155,Alex Laferriere,R,LAK,23,82,17,3,20
10,8478831,Kevin Stenlund,C,FLA,28,82,13,7,20
10,8476624,Barclay Goodrow,C,NYR,31,82,10,10,20
10,8481028,Martin Pospisil,C,CGY,25,82,10,10,20
10,8480448,Parker Kelly,L,OTT,25,82,9,11,20
10,8475231,Casey Cizikas,C,NYI,33,82,9,11,20
10,8482762,Simon Edvinsson,D,DET,21,82,9,11,20
10,8479383,Boris Katchouk,L,OTT,26,82,8,12,20
10,8483763,Maksymilian Szuber,D,ARI,22,82,8,12,20
10,8474009,Nick Bonino,C,NYR,36,82,8,12,20
10,8482803,Olen Zellweger,D,ANA,21,82,8,12,20
10,8474884,Mike Hoffman,C,SJS,35,82,7,13,20
10,8479359,Beck Malenstyn,L,WSH,26,82,7,13,20
10,8478468,Jeremy Lauzon,D,NSH,27,82,6,14,20
10,8481524,Bowen Byram,D,BUF,23,82,5,15,20
10,8478840,Will Borgen,D,SEA,28,82,4,16,20
10,8477435,Ryan Graves,D,PIT,29,82,4,16,20
10,8477507,Nikita Zadorov,D,VAN,29,82,3,17,20
10,8483445,Cutter Gauthier,L,ANA,20,82,12,7,19
10,8477353,Tyler Motte,C,TBL,29,82,12,7,19
10,8482737,Zack Bolduc,C,STL,21,82,11,8,19
10,8482101,Danil Gushchin,L,SJS,22,82,8,11,19
10,8480995,Pontus Holmberg,R,TOR,25,82,7,12,19
10,8475842,Sam Carrick,C,EDM,32,82,7,12,19
10,8475164,Jakob Silfverberg,R,ANA,34,82,7,12,19
10,8478859,Niko Mikkola,D,FLA,28,82,6,13,19
10,8483468,Jiri Kulich,C,BUF,20,82,6,13,19
10,8481567,Henry Thrun,D,SJS,23,82,5,14,19
10,8479442,Troy Stecher,D,EDM,30,82,4,15,19
10,8474013,Ian Cole,D,VAN,35,82,3,16,19
10,8483490,Pavel Mintyukov,D,ANA,21,82,3,16,19
10,8480058,Pierre-Olivier Joseph,D,PIT,25,82,3,16,19
10,8482073,Braden Schneider,D,NYR,23,82,3,16,19
10,8483565,Nick Blankenburg,D,CBJ,26,82,3,16,19
10,8475324,Nick Jensen,D,WSH,34,82,2,17,19
10,8476878,Zemgus Girgensons,L,BUF,30,82,7,11,18
10,8474034,Pat Maroon,L,BOS,36,82,7,11,18
10,8478430,Oliver Kylington,D,CGY,27,82,6,12,18
10,8480807,Mattias Samuelsson,D,BUF,24,82,5,13,18
10,8476457,Adam Larsson,D,SEA,32,82,5,13,18
10,8475790,Erik Gudbranson,D,CBJ,32,82,5,13,18
10,8480796,Martin Fehervary,D,WSH,25,82,5,13,18
10,8481059,Scott Perunovich,D,STL,26,82,4,14,18
10,8475455,Brenden Dillon,D,WPG,34,82,4,14,18
10,8476891,Matt Grzelcyk,D,BOS,30,82,3,15,18
10,8475177,Calvin de Haan,D,TBL,33,82,3,15,18
10,8478443,Brandon Carlo,D,BOS,28,82,3,15,18
10,8475462,Radko Gudas,D,ANA,34,82,2,16,18
10,8478416,Erik Cernak,D,TBL,27,82,1,17,18
10,8482807,Ethan Del Mastro,D,CHI,21,82,10,7,17
10,8481578,Graeme Clarke,R,NJD,23,82,8,9,17
10,8470600,Ryan Suter,D,DAL,39,82,3,14,17
10,8476879,Cody Ceci,D,EDM,31,82,2,15,17
10,8482470,Ilya Solovyov,D,CGY,24,82,2,15,17
10,8477365,Connor Clifton,D,BUF,29,82,2,15,17
10,8474574,Tyler Myers,D,VAN,34,82,2,15,17
10,8482733,Logan Mailloux,D,MTL,31,82,8,8,16
10,8477034,Jaycob Megna,D,CHI,32,82,3,13,16
10,8477335,Kyle Burroughs,D,SJS,29,82,2,14,16
10,8476915,Jujhar Khaira,L,MIN,30,82,9,6,15
10,8476858,Phillip Di Giuseppe,L,VAN,31,82,8,7,15
10,8483493,Frank Nazar,C,CHI,20,82,6,9,15
10,8483466,Kevin Korchinski,D,CHI,20,82,4,11,15
10,8478399,Jonas Siegenthaler,D,NJD,27,82,3,12,15
10,8482679,Matt Coronato,R,CGY,22,82,9,5,14
10,8476822,Luke Glendening,C,TBL,35,82,9,5,14
10,8482118,Sam Colangelo,R,ANA,23,82,7,7,14
10,8477369,Carson Soucy,D,VAN,30,82,5,9,14
10,8482713,Mackie Samoskevich,R,FLA,22,82,5,9,14
10,8474567,Zach Bogosian,D,MIN,34,82,4,10,14
10,8483499,Liam Ohgren,L,MIN,20,82,4,10,14
10,8477919,Frederick Gaudreau,C,MIN,31,82,3,11,14
10,8482859,Zack Ostapchuk,C,OTT,21,82,5,8,13
10,8482712,Oskar Olausson,R,COL,22,82,5,8,13
10,8481699,Aku Raty,R,ARI,23,82,4,9,13
10,8480031,Maxime Comtois,L,CAR,25,82,4,9,13
10,8480834,Ty Emberson,D,SJS,24,82,3,10,13
10,8484911,Collin Graf,R,SJS,22,82,3,10,13
10,8478408,Travis Dermott,D,ARI,28,82,3,10,13
10,8480990,Declan Chisholm,D,MIN,24,82,2,11,13
10,8476372,Nick Seeler,D,PHI,31,82,1,12,13
10,8483471,Brad Lambert,C,WPG,31,82,7,5,12
10,8483491,Ivan Miroshnichenko,L,WSH,20,82,4,8,12
10,8483012,Logan Morrison,C,SEA,22,82,3,9,12
10,8481605,Jackson LaCombe,D,ANA,23,82,2,10,12
10,8471677,Jack Johnson,D,COL,37,82,2,10,12
10,8483397,Marc McLaughlin,C,BOS,25,82,5,6,11
10,8475825,Jani Hakanpää,D,DAL,32,82,4,7,11
10,8482177,Marat Khusnutdinov,C,MIN,22,82,4,7,11
10,8475762,Derek Forbort,D,BOS,32,82,3,8,11
10,8476473,Connor Murphy,D,CHI,31,82,3,8,11
10,8481030,Jack St. Ivany,D,PIT,25,82,2,9,11
10,8482516,Matthew Kessel,D,STL,24,82,2,9,11
10,8481016,Ruslan Iskhakov,C,NYI,24,82,4,6,10
10,8482145,Mavrik Bourque,C,DAL,22,82,3,7,10
10,8483489,Fraser Minten,C,TOR,31,82,5,3,8
10,8483482,Tristan Luneau,D,ANA,20,82,1,7,8
10,8477950,Tony DeAngelo,D,CAR,29,0,0,0,0
10,8481577,Philip Tomasino,C,NSH,23,0,0,0,0
10,8482660,Kent Johnson,C,CBJ,22,0,0,0,0
10,8481019,David Gustafsson,C,WPG,24,0,0,0,0
10,8479348,Kale Clague,D,BUF,26,0,0,0,0
10,8482149,Cole Perfetti,C,WPG,22,0,0,0,0
10,8476952,Dominic Toninato,C,WPG,30,0,0,0,0
10,8473473,Milan Lucic,L,BOS,36,0,0,0,0
10,8480829,Jesperi Kotkaniemi,C,CAR,24,0,0,0,0
10,8474602,Justin Schultz,D,SEA,34,0,0,0,0
10,8480049,Dylan Samberg,D,WPG,25,0,0,0,0
10,8479372,Josh Mahura,D,FLA,26,0,0,0,0
10,8480878,Nils Lundkvist,D,DAL,24,0,0,0,0
10,8479982,Conor Timmins,D,TOR,26,0,0,0,0
10,8474031,Kevin Shattenkirk,D,BOS,35,0,0,0,0
10,8480835,Jack Drury,C,CAR,24,0,0,0,0
10,8480008,Adam Ruzicka,C,ARI,25,0,0,0,0
10,8479402,Jake Bean,D,CBJ,26,0,0,0,0
10,8476474,Stefan Noesen,R,CAR,31,0,0,0,0
10,8480884,Calen Addison,D,SJS,24,0,0,0,0
10,8476994,Vinnie Hinostroza,C,PIT,30,0,0,0,0
10,8477987,Ryan Donato,C,CHI,28,0,0,0,0
10,8481582,Nicholas Robertson,L,TOR,23,0,0,0,0
10,8478452,Caleb Jones,D,COL,27,0,0,0,0
10,8480157,Calle Rosen,D,STL,30,0,0,0,0
10,8481609,Vladislav Kolyachonok,D,ARI,23,0,0,0,0
10,8476919,Chris Tierney,C,NJD,30,0,0,0,0
10,8479639,Dylan Coghlan,D,CAR,26,0,0,0,0
10,8475193,Tomas Tatar,L,SEA,34,0,0,0,0
10,8480748,Kiefer Sherwood,L,NSH,29,0,0,0,0
10,8478146,Matthew Highmore,C,OTT,28,0,0,0,0
10,8478970,Jalen Chatfield,D,CAR,28,0,0,0,0
10,8480205,Emil Bemstrom,C,PIT,25,0,0,0,0
10,8471274,Alex Goligoski,D,MIN,39,0,0,0,0
10,8478104,Sammy Blais,L,STL,28,0,0,0,0
10,8476913,Devin Shore,C,SEA,30,0,0,0,0
10,8481708,Zac Jones,D,NYR,24,0,0,0,0
10,8480222,Sebastian Aho,D,NYI,28,0,0,0,0
10,8481598,Philip Broberg,D,EDM,23,0,0,0,0
10,8480789,Oliver Wahlstrom,R,NYI,24,0,0,0,0
10,8480891,Michael Kesselring,D,ARI,24,0,0,0,0
10,8477979,Nicolas Aube-Kubel,R,WSH,28,0,0,0,0
10,8476393,Nick Cousins,C,FLA,31,0,0,0,0
10,8480003,Jesper Boqvist,C,BOS,26,0,0,0,0
10,8479543,Michael Pezzetta,L,MTL,26,0,0,0,0
10,8475855,Jesper Fast,R,CAR,33,0,0,0,0
10,8477018,Ben Hutton,D,VGK,31,0,0,0,0
10,8480762,Eric Robinson,L,BUF,29,0,0,0,0
10,8481058,Jesse Ylönen,R,MTL,25,0,0,0,0
10,8481527,Kaedan Korczak,D,VGK,23,0,0,0,0
10,8482192,Isaak Phillips,D,CHI,23,0,0,0,0
10,8480727,Zach Whitecloud,D,VGK,28,0,0,0,0
10,8480001,Urho Vaakanainen,D,ANA,25,0,0,0,0
10,8480853,Liam Foudy,C,NSH,24,0,0,0,0
10,8475225,Craig Smith,C,DAL,35,0,0,0,0
10,8479972,Mason Shaw,C,MIN,26,0,0,0,0
10,8474040,Sam Gagner,C,EDM,35,0,0,0,0
10,8480196,Jacob Bryson,D,BUF,27,0,0,0,0
10,8475718,Justin Holl,D,DET,32,0,0,0,0
10,8479984,Cal Foote,D,NJD,26,0,0,0,0
10,8480011,Klim Kostin,C,SJS,25,0,0,0,0
10,8482176,Wyatt Kaiser,D,CHI,22,0,0,0,0
10,8476918,Jimmy Vesey,L,NYR,31,0,0,0,0
10,8476988,Matt Benning,D,SJS,30,0,0,0,0
10,8479370,Tyson Jost,C,BUF,26,0,0,0,0
10,8477464,Nic Petan,C,MIN,29,0,0,0,0
10,8477380,Jonny Brodzinski,C,NYR,31,0,0,0,0
10,8480070,Ian Mitchell,D,BOS,25,0,0,0,0
10,8479315,Joey Anderson,R,CHI,26,0,0,0,0
10,8478099,Kevin Labanc,R,SJS,29,0,0,0,0
10,8476874,Olli Maatta,D,DET,30,0,0,0,0
10,8479414,Nathan Bastian,R,NJD,27,0,0,0,0
10,8478434,Keegan Kolesar,R,VGK,27,0,0,0,0
10,8479536,Axel Jonsson-Fjallby,L,WPG,26,0,0,0,0
10,8479671,Mathieu Olivier,R,CBJ,27,0,0,0,0
10,8471709,Marc-Edouard Vlasic,D,SJS,37,0,0,0,0
10,8479328,Julien Gauthier,R,NYI,27,0,0,0,0
10,8478421,A.J. Greer,L,CGY,28,0,0,0,0
10,8477573,Nathan Walker,L,STL,30,0,0,0,0
10,8477478,William Carrier,L,VGK,30,0,0,0,0
10,8479344,Jesse Puljujarvi,R,PIT,26,0,0,0,0
10,8480887,Jordan Harris,D,MTL,24,0,0,0,0
10,8478502,Dennis Gilbert,D,CGY,28,0,0,0,0
10,8480355,Mark Kastelic,C,OTT,25,0,0,0,0
10,8475750,Jon Merrill,D,MIN,32,0,0,0,0
10,8476889,Radek Faksa,C,DAL,30,0,0,0,0
10,8478432,Christian Fischer,R,DET,27,0,0,0,0
10,8479439,Jacob MacDonald,D,SJS,31,0,0,0,0
10,8474568,Luke Schenn,D,NSH,35,0,0,0,0
10,8478454,Noah Juulsen,D,VAN,27,0,0,0,0
10,8475752,Tyler Pitlick,C,NYR,33,0,0,0,0
10,8482148,Hendrix Lapierre,C,WSH,22,0,0,0,0
10,8481167,Brayden Pachal,D,CGY,25,0,0,0,0
10,8478211,Dryden Hunt,L,CGY,29,0,0,0,0
10,8479321,Lucas Johansen,D,WSH,27,0,0,0,0
10,8480950,Ilya Lyubushkin,D,TOR,30,0,0,0,0
10,8479368,Max Jones,L,ANA,26,0,0,0,0
10,8471699,Andrew Cogliano,C,COL,37,0,0,0,0
10,8481521,Ronnie Attard,D,PHI,25,0,0,0,0
10,8481161,Jake Christiansen,D,CBJ,25,0,0,0,0
10,8479458,Nikita Zaitsev,D,CHI,33,0,0,0,0
10,8479619,Michael Carcone,L,ARI,28,0,0,0,0
10,8479026,Philippe Myers,D,TBL,27,0,0,0,0
10,8481617,Vasily Podkolzin,R,VAN,23,0,0,0,0
10,8481701,Santeri Hatakka,D,NJD,23,0,0,0,0
10,8477446,Michael McCarron,R,NSH,29,0,0,0,0
10,8483460,David Jiricek,D,CBJ,21,0,0,0,0
10,8474090,Brendan Smith,D,NJD,35,0,0,0,0
10,8482241,Radim Zohorna,L,PIT,28,0,0,0,0
10,8481032,Paul Cotter,C,VGK,25,0,0,0,0
10,8480289,Morgan Barron,C,WPG,26,0,0,0,0
10,8479379,Givani Smith,R,SJS,26,0,0,0,0
10,8480216,Jacob Peterson,C,SJS,25,0,0,0,0
10,8477851,Jordan Oesterle,D,CGY,32,0,0,0,0
10,8484258,Sam Malinski,D,COL,26,0,0,0,0
10,8478904,Steven Lorentz,C,FLA,28,0,0,0,0
10,8482095,Tyler Kleven,D,OTT,22,0,0,0,0
10,8480980,Connor Dewar,C,TOR,25,0,0,0,0
10,8480848,Ty Dellandrea,C,DAL,24,0,0,0,0
10,8476884,Derrick Pouliot,D,DAL,30,0,0,0,0
10,8480025,MacKenzie Entwistle,R,CHI,25,0,0,0,0
10,8474612,Travis Hamonic,D,OTT,34,0,0,0,0
10,8479336,Carl Grundstrom,R,LAK,27,0,0,0,0
10,8482964,Arber Xhekaj,D,MTL,23,0,0,0,0
10,8471686,Marc Staal,D,PHI,37,0,0,0,0
10,8477887,Patrick Brown,C,BOS,32,0,0,0,0
10,8478495,Denis Gurianov,R,PHI,27,0,0,0,0
10,8481550,Adam Beckman,L,MIN,23,0,0,0,0
10,8480845,Rasmus Kupari,C,WPG,24,0,0,0,0
10,8478585,Derek Ryan,C,EDM,38,0,0,0,0
10,8482141,Lukas Cormier,D,VGK,22,0,0,0,0
10,8477962,Brendan Lemieux,L,CAR,28,0,0,0,0
10,8482861,Vincent Iorio,D,WSH,22,0,0,0,0
10,8479378,Logan Stanley,D,WPG,26,0,0,0,0
10,8473446,Erik Johnson,D,PHI,36,0,0,0,0
10,8481743,Marc Del Gaizo,D,NSH,25,0,0,0,0
10,8478450,Parker Wotherspoon,D,BOS,27,0,0,0,0
10,8477384,Josh Brown,D,ARI,30,0,0,0,0
10,8482165,Yan Kuznetsov,D,CGY,22,0,0,0,0
10,8478424,Jansen Harkins,C,PIT,27,0,0,0,0
10,8482144,Jack Thompson,D,SJS,22,0,0,0,0
10,8479576,Vincent Desharnais,D,EDM,28,0,0,0,0
10,8478512,Austin Czarnik,C,DET,32,0,0,0,0
10,8477527,Ross Johnston,L,ANA,30,0,0,0,0
10,8482094,Daemon Hunt,D,MIN,22,0,0,0,0
10,8481719,Maxwell Crozier,D,TBL,24,0,0,0,0
10,8480192,Johnathan Kovacevic,D,MTL,27,0,0,0,0
10,8479376,Victor Mete,D,PHI,26,0,0,0,0
10,8482511,Mason Lohrei,D,BOS,23,0,0,0,0
10,8478021,William Lagesson,D,ANA,28,0,0,0,0
10,8475795,Dylan McIlrath,D,WSH,32,0,0,0,0
10,8477846,Ryan Carpenter,C,SJS,33,0,0,0,0
10,8481056,Spencer Stastney,D,NSH,24,0,0,0,0
10,8481564,Ryan Johnson,D,BUF,23,0,0,0,0
10,8478017,Mark Friedman,D,VAN,29,0,0,0,0
10,8479320,Max Lajoie,D,TOR,27,0,0,0,0
10,8480075,Cameron Crotty,D,ARI,25,0,0,0,0
10,8484287,Cole McWard,D,VAN,23,0,0,0,0
10,8484254,Akito Hirose,D,VAN,25,0,0,0,0
10,8483407,Brandon Scanlin,D,NYR,25,0,0,0,0
10,8480274,Philip Kemp,D,EDM,25,0,0,0,0
10,8479522,Hardy Haman Aktell,D,WSH,26,0,0,0,0
10,8480007,Jonas Rondbjerg,R,VGK,25,0,0,0,0
10,8477454,Adam Erne,L,EDM,29,0,0,0,0
10,8481679,Maxence Guenette,D,OTT,23,0,0,0,0
10,8477938,Haydn Fleury,D,TBL,28,0,0,0,0
10,8476441,Joel Edmundson,D,TOR,31,0,0,0,0
10,8477903,Garnet Hathaway,R,PHI,33,0,0,0,0
10,8480441,Trey Fix-Wolansky,R,CBJ,25,0,0,0,0
10,8483546,Marshall Rifai,D,TOR,26,0,0,0,0
10,8480084,Nick DeSimone,D,NJD,30,0,0,0,0
10,8481592,Jakob Pelletier,L,CGY,23,0,0,0,0
10,8478011,Louie Belpedio,D,PHI,28,0,0,0,0
10,8477930,Pierre-Edouard Bellemare,L,SEA,39,0,0,0,0
10,8484321,Nikolas Matinpalo,D,OTT,26,0,0,0,0
10,8482067,Connor Mackey,D,NYR,28,0,0,0,0
10,8481806,Louis Crevier,D,CHI,23,0,0,0,0
10,8484326,Patrik Koch,D,ARI,28,0,0,0,0
10,8477971,Andreas Englund,D,LAK,28,0,0,0,0
10,8481751,Lukas Rousek,R,BUF,25,0,0,0,0
10,8481006,Tyler Tucker,D,STL,24,0,0,0,0
10,8481641,Joel Kiviranta,L,COL,28,0,0,0,0
10,8476867,Brendan Gaunce,C,CBJ,30,0,0,0,0
10,8479520,Brandon Duhaime,R,COL,27,0,0,0,0
10,8477073,Kurtis MacDermid,L,NJD,30,0,0,0,0
10,8480874,Adam Ginning,D,PHI,24,0,0,0,0
10,8477473,Justin Bailey,R,SJS,29,0,0,0,0
10,8479066,Ryan Lomberg,L,FLA,30,0,0,0,0
10,8477070,Liam O'Brien,C,ARI,30,0,0,0,0
10,8474618,Marco Scandella,D,STL,34,0,0,0,0
10,8475797,Jarred Tinordi,D,CHI,32,0,0,0,0
10,8481441,Joe Snively,C,WSH,28,0,0,0,0
10,8477244,Chad Ruhwedel,D,NYR,34,0,0,0,0
10,8482077,Dylan Holloway,L,EDM,23,0,0,0,0
10,8479772,Zack MacEwen,R,OTT,28,0,0,0,0
10,8481147,Reese Johnson,C,CHI,26,0,0,0,0
10,8481043,Cole Koepke,L,TBL,26,0,0,0,0
10,8483619,Filip Roos,D,CHI,25,0,0,0,0
10,8481541,Samuel Bolduc,D,NYI,24,0,0,0,0
10,8477810,Joel Hanley,D,CGY,33,0,0,0,0
10,8476907,Mackenzie MacEachern,L,STL,30,0,0,0,0
10,8482652,Walker Duehr,R,CGY,27,0,0,0,0
10,8477126,Jayson Megna,C,BOS,34,0,0,0,0
10,8483398,Declan Carlile,D,TBL,31,0,0,0,0
10,8482929,Emil Lilleberg,D,TBL,23,0,0,0,0
10,8480880,Jakub Lauko,C,BOS,24,0,0,0,0
10,8478874,Adam Gaudette,C,STL,28,0,0,0,0
10,8480245,Olle Lycksell,R,PHI,25,0,0,0,0
10,8480252,Cole Guttman,C,CHI,25,0,0,0,0
10,8477467,Gustav Olofsson,D,SEA,30,0,0,0,0
10,8479968,Vinni Lettieri,C,MIN,29,0,0,0,0
10,8478400,Colin White,C,MTL,27,0,0,0,0
10,8475755,Alexander Petrovic,D,DAL,32,0,0,0,0
10,8481812,Nikolai Knyzhov,D,SJS,27,0,0,0,0
10,8481593,Jayden Struble,D,MTL,23,0,0,0,0
10,8481532,Alex Turcotte,C,LAK,23,0,0,0,0
10,8482126,Emil Andrae,D,PHI,31,0,0,0,0
10,8479944,Zach Aston-Reese,C,DET,30,0,0,0,0
10,8471817,Ryan Reaves,R,TOR,37,0,0,0,0
10,8481206,John Ludvig,D,PIT,24,0,0,0,0
10,8480292,Carson Meyer,R,CBJ,27,0,0,0,0
10,8482496,Nils Aman,C,VAN,24,0,0,0,0
10,8479718,Alex Barré-Boulet,C,TBL,27,0,0,0,0
10,8479994,Jaret Anderson-Dolan,C,NSH,25,0,0,0,0
10,8480184,Gustav Lindstrom,D,ANA,26,0,0,0,0
10,8480890,Jan Jenik,R,ARI,24,0,0,0,0
10,8478067,Oskar Lindblom,L,SJS,28,0,0,0,0
10,8476934,Brock McGinn,L,ANA,30,0,0,0,0
10,8479985,Cale Fleury,D,SEA,26,0,0,0,0
10,8482153,Brendan Brisson,C,VGK,23,0,0,0,0
10,8480021,Jack Studnicka,C,SJS,25,0,0,0,0
10,8484304,Uvis Balinskis,D,FLA,28,0,0,0,0
10,8479981,Jonah Gadjovich,L,FLA,26,0,0,0,0
10,8481716,Dmitri Voronkov,L,CBJ,24,0,0,0,0
10,8482659,Josh Doan,R,ARI,22,0,0,0,0
10,8481122,Simon Benoit,D,TOR,26,0,0,0,0
10,8474709,Matt Martin,L,NYI,35,0,0,0,0
10,8482634,Alex Steeves,C,TOR,25,0,0,0,0
10,8480823,Alexander Alexeyev,D,WSH,25,0,0,0,0
10,8477541,Dakota Mermis,D,MIN,30,0,0,0,0
10,8478477,Mitchell Stephens,C,MTL,27,0,0,0,0
10,8481543,Nikita Alexandrov,C,STL,24,0,0,0,0
10,8482451,Mikael Pyyhtia,L,CBJ,23,0,0,0,0
10,8480306,Grant Hutton,D,NYI,29,0,0,0,0
10,8478028,Fredrik Olofsson,L,COL,28,0,0,0,0
10,8477462,Robert Hagg,D,ANA,29,0,0,0,0
10,8477320,Anton Blidh,L,NYR,29,0,0,0,0
10,8482749,Joshua Roy,R,MTL,21,0,0,0,0
10,8482157,Will Cuylle,L,NYR,22,0,0,0,0
10,8481239,Samuel Fagemo,L,LAK,24,0,0,0,0
10,8481600,Tobias Bjornfot,D,FLA,23,0,0,0,0
10,8478409,Anthony Richard,C,BOS,28,0,0,0,0
10,8474145,Robert Bortuzzo,D,NYI,35,0,0,0,0
10,8475958,Michael Sgarbossa,C,WSH,32,0,0,0,0
10,8479986,Kole Lind,R,SEA,26,0,0,0,0
10,8479249,Andrew Poturalski,C,SEA,30,0,0,0,0
10,8479362,Riley Tufte,L,COL,26,0,0,0,0
10,8479991,Jake Leschyshyn,C,NYR,25,0,0,0,0
10,8479587,Rhett Gardner,C,PHI,28,0,0,0,0
10,8482744,James Malatesta,L,CBJ,21,0,0,0,0
10,8478854,Ryan Shea,D,PIT,27,0,0,0,0
10,8481591,Sam Poulin,R,PIT,23,0,0,0,0
10,8483512,Matt Savoie,C,BUF,20,0,0,0,0
10,8482102,Vasily Ponomarev,C,CAR,22,0,0,0,0
10,8482162,Roby Jarventie,L,OTT,22,0,0,0,0
10,8482172,Landon Slaggert,L,CHI,22,0,0,0,0
10,8482747,Brennan Othmann,L,NYR,21,0,0,0,0
10,8480226,Marián Studenic,R,SEA,26,0,0,0,0
10,8481518,Nolan Foote,L,NJD,24,0,0,0,0
10,8479419,Brett Murray,L,BUF,26,0,0,0,0
10,8482088,Justin Sourdif,R,FLA,22,0,0,0,0
10,8482201,Gage Goncalves,C,TBL,23,0,0,0,0
10,8481754,Nikita Nesterenko,C,ANA,23,0,0,0,0
10,8483531,Brian Halonen,L,NJD,25,0,0,0,0
10,8483920,Pierrick Dube,R,WSH,23,0,0,0,0
10,8480851,Akil Thomas,C,LAK,24,0,0,0,0
10,8475235,Nicolas Deslauriers,L,PHI,33,0,0,0,0
10,8482476,Emil Heineman,L,MTL,23,0,0,0,0
10,8477149,Scott Sabourin,R,SJS,32,0,0,0,0
10,8483549,Lucas Condotta,L,MTL,27,0,0,0,0
10,8483567,Georgii Merkulov,C,BOS,24,0,0,0,0
10,8482765,Isak Rosen,R,BUF,21,0,0,0,0
10,8481237,Kyle MacLean,C,NYI,25,0,0,0,0
10,8481024,Linus Karlsson,C,VAN,25,0,0,0,0
10,8481690,Tyler Angle,C,CBJ,24,0,0,0,0
10,8483570,Ben Meyers,C,ANA,26,0,0,0,0
10,8481655,Cole Schwindt,R,CGY,23,0,0,0,0
10,8481462,Mason Morelli,L,VGK,28,0,0,0,0
10,8483401,Marc Johnstone,R,PIT,28,0,0,0,0
10,8478956,Samuel Laberge,L,NJD,27,0,0,0,0
10,8479533,Joona Koppanen,L,PIT,26,0,0,0,0
10,8482197,Adam Raska,R,MIN,23,0,0,0,0
10,8482250,Callahan Burke,C,CAR,27,0,0,0,0
10,8482784,Zach Dean,C,STL,21,0,0,0,0
10,8484255,Jason Polin,R,COL,25,0,0,0,0
10,8481077,John Leonard,L,ARI,26,0,0,0,0
10,8481534,Raphael Lavoie,C,EDM,24,0,0,0,0
10,8483609,Adam Klapka,R,CGY,24,0,0,0,0
10,8482751,Ryan Winterton,C,SEA,21,0,0,0,0
10,8480267,Sammy Walker,C,MIN,25,0,0,0,0
10,8475766,Austin Watson,L,TBL,32,0,0,0,0
10,8482460,Matt Rempe,C,NYR,22,0,0,0,0
10,8482787,Nikita Chibrikov,R,WPG,31,0,0,0,0
10,8481065,Angus Crookshank,L,OTT,25,0,0,0,0
10,8481070,Hugh McGing,L,STL,26,0,0,0,0
10,8476323,Max McCormick,L,SEA,32,0,0,0,0
10,8483395,Arshdeep Bains,L,VAN,23,0,0,0,0
10,8484259,Ondrej Pavel,C,COL,31,0,0,0,0
10,8483432,Luca Del Bel Belluz,C,CBJ,31,0,0,0,0
10,8483045,Cameron Butler,R,CBJ,31,0,0,0,0
10,8482061,Brandon Biro,L,BUF,26,0,0,0,0
10,8477401,John Hayden,C,SEA,29,0,0,0,0
10,8475278,Byron Froese,C,VGK,33,0,0,0,0
10,8478446,Glenn Gawdin,C,ANA,27,0,0,0,0
10,8477993,Justin Kirkland,C,ARI,28,0,0,0,0
10,8482147,Jean-Luc Foudy,C,COL,22,0,0,0,0
10,8480032,Shane Bowers,C,NJD,25,0,0,0,0
10,8479330,Brandon Gignac,C,MTL,27,0,0,0,0
10,8480776,Sheldon Rempal,R,VGK,29,0,0,0,0
10,8475413,Justin Dowling,C,NJD,34,0,0,0,0
10,8481726,Adam Edstrom,C,NYR,24,0,0,0,0
10,8479638,Justin Brazeau,R,BOS,26,0,0,0,0
10,8480844,Grigori Denisenko,L,VGK,24,0,0,0,0
10,8474062,Riley Nash,C,NYR,35,0,0,0,0
10,8478147,Bokondji Imama,L,OTT,28,0,0,0,0
10,8478881,Brett Seney,L,CHI,28,0,0,0,0
10,8483630,Pavol Regenda,L,ANA,25,0,0,0,0
10,8480836,Jonathan Gruden,C,PIT,24,0,0,0,0
10,8484314,Jiri Smejkal,L,OTT,28,0,0,0,0
10,8475780,Chris Wagner,R,COL,33,0,0,0,0
10,8482070,Mitchell Chaffee,R,TBL,26,0,0,0,0
10,8479546,Oskar Steen,C,BOS,26,0,0,0,0
10,8483597,Milos Kelemen,L,ARI,25,0,0,0,0
10,8481789,Tye Kartye,L,SEA,23,0,0,0,0
10,8484325,Waltteri Merela,C,TBL,26,0,0,0,0
10,8479421,Jacob Moverare,D,LAK,26,0,0,0,0
10,8481585,Egor Afanasyev,L,NSH,23,0,0,0,0
10,8479547,Matthew Phillips,R,WSH,26,0,0,0,0
10,8479367,William Lockwood,R,FLA,26,0,0,0,0
10,8481422,Jacob Lucchini,C,MIN,29,0,0,0,0
10,8480468,James Hamblin,L,EDM,25,0,0,0,0
10,8480870,Bo Groulx,C,ANA,24,0,0,0,0
10,8478051,Max Willman,C,NJD,29,0,0,0,0
10,8481556,John Beecher,C,BOS,23,0,0,0,0
10,8478078,Rourke Chartier,C,OTT,28,0,0,0,0
11,8478402,Connor McDavid,C,EDM,27,82,51,108,159
11,8476453,Nikita Kucherov,R,TBL,31,82,38,118,156
11,8479318,Auston Matthews,C,TOR,27,82,75,58,133
11,8477956,David Pastrnak,R,BOS,28,82,59,66,125
11,8477934,Leon Draisaitl,C,EDM,29,82,42,81,123
11,8478550,Artemi Panarin,L,NYR,33,82,41,81,122
11,8481559,Jack Hughes,C,NJD,23,82,49,63,112
11,8480027,Jason Robertson,L,DAL,25,82,48,63,111
11,8477492,Nathan MacKinnon,C,COL,29,82,42,68,110
11,8477404,Jake Guentzel,C,CAR,30,82,48,57,105
11,8477939,William Nylander,R,TOR,28,82,50,54,104
11,8473419,Brad Marchand,L,BOS,36,82,32,72,104
11,8479343,Clayton Keller,R,ARI,26,82,43,60,103
11,8480800,Quinn Hughes,D,VAN,25,82,15,88,103
11,8478864,Kirill Kaprizov,L,MIN,27,82,47,53,100
11,8476454,Ryan Nugent-Hopkins,C,EDM,31,82,27,69,96
11,8479314,Matthew Tkachuk,L,FLA,27,82,37,58,95
11,8478427,Sebastian Aho,C,CAR,27,82,37,56,93
11,8475913,Mark Stone,R,VGK,32,82,28,65,93
11,8477946,Dylan Larkin,C,DET,28,82,46,46,92
11,8482116,Tim Stützle,C,OTT,22,82,35,57,92
11,8479420,Tage Thompson,C,BUF,27,82,47,44,91
11,8481557,Matt Boldy,L,MIN,23,82,36,55,91
11,8480801,Brady Tkachuk,L,OTT,25,82,49,41,90
11,8471675,Sidney Crosby,C,PIT,37,82,41,49,90
11,8479385,Jordan Kyrou,C,STL,26,82,36,54,90
11,8476468,J.T. Miller,C,VAN,31,82,26,63,89
11,8480036,Miro Heiskanen,D,DAL,25,82,11,78,89
11,8480012,Elias Pettersson,C,VAN,26,82,42,46,88
11,8476887,Filip Forsberg,L,NSH,30,82,38,50,88
11,8477940,Nikolaj Ehlers,L,WPG,28,82,29,58,87
11,8476853,Morgan Rielly,D,TOR,30,82,13,73,86
11,8478445,Mathew Barzal,C,NYI,27,82,15,69,84
11,8476346,Johnny Gaudreau,L,CBJ,31,82,24,58,82
11,8477493,Aleksander Barkov,C,FLA,29,82,22,60,82
11,8474600,Roman Josi,D,NSH,34,82,19,63,82
11,8475786,Zach Hyman,L,EDM,32,82,37,44,81
11,8478398,Kyle Connor,L,WPG,28,82,36,45,81
11,8470794,Joe Pavelski,C,DAL,40,82,33,48,81
11,8478420,Mikko Rantanen,R,COL,28,82,37,43,80
11,8474564,Steven Stamkos,C,TBL,34,82,37,43,80
11,8480023,Robert Thomas,C,STL,25,82,37,43,80
11,8477949,Alex Tuch,R,BUF,28,82,29,51,80
11,8477951,Nick Schmaltz,C,ARI,28,82,29,51,80
11,8479542,Brandon Hagel,L,TBL,26,82,39,40,79
11,8478010,Brayden Point,C,TBL,28,82,38,41,79
11,8478439,Travis Konecny,R,PHI,27,82,37,42,79
11,8475168,Matt Duchene,C,DAL,33,82,36,42,78
11,8475692,Mats Zuccarello,R,MIN,37,82,22,56,78
11,8478444,Brock Boeser,R,VAN,27,82,37,40,77
11,8475172,Nazem Kadri,C,CGY,34,82,30,47,77
11,8480830,Andrei Svechnikov,R,CAR,24,82,27,50,77
11,8480069,Cale Makar,D,COL,26,82,20,57,77
11,8479407,Jesper Bratt,L,NJD,26,82,31,44,75
11,8482665,Matty Beniers,C,SEA,22,82,31,44,75
11,8475167,Victor Hedman,D,TBL,34,82,14,61,75
11,8477501,Valeri Nichushkin,R,COL,29,82,35,39,74
11,8477933,Sam Reinhart,C,FLA,29,82,32,42,74
11,8476460,Mark Scheifele,C,WPG,31,82,30,44,74
11,8480865,Noah Dobson,D,NYI,24,82,25,49,74
11,8479325,Charlie McAvoy,D,BOS,27,82,20,54,74
11,8475158,Ryan O'Reilly,C,NSH,33,82,33,40,73
11,8478493,Joel Eriksson Ek,C,MIN,27,82,30,43,73
11,8481523,Kirby Dach,C,MTL,23,82,10,63,73
11,8471214,Alex Ovechkin,L,WSH,39,82,35,37,72
11,8475169,Evander Kane,L,EDM,33,82,35,37,72
11,8477409,Carter Verhaeghe,C,FLA,29,82,34,38,72
11,8471215,Evgeni Malkin,C,PIT,38,82,31,41,72
11,8480018,Nick Suzuki,C,MTL,25,82,27,45,72
11,8473512,Claude Giroux,R,OTT,36,82,20,52,72
11,8476456,Jonathan Huberdeau,C,CGY,31,82,18,54,72
11,8477504,Josh Morrissey,D,WPG,29,82,16,56,72
11,8479323,Adam Fox,D,NYR,26,82,13,59,72
11,8475166,John Tavares,C,TOR,34,82,35,36,71
11,8478042,Viktor Arvidsson,R,LAK,31,82,33,38,71
11,8480188,Fabian Zetterlund,L,SJS,25,82,33,38,71
11,8482078,Lucas Raymond,L,DET,22,82,32,39,71
11,8478403,Jack Eichel,C,VGK,28,82,29,42,71
11,8476462,Dougie Hamilton,D,NJD,31,82,19,52,71
11,8478460,Zach Werenski,D,CBJ,27,82,11,60,71
11,8476539,Jonathan Marchessault,R,VGK,34,82,35,35,70
11,8477451,Ryan Hartman,R,MIN,30,82,35,35,70
11,8477955,Jared McCann,L,SEA,28,82,34,36,70
11,8478449,Roope Hintz,C,DAL,28,82,29,41,70
11,8477402,Pavel Buchnevich,L,STL,29,82,27,43,70
11,8475784,Jeff Skinner,C,BUF,32,82,24,46,70
11,8480803,Evan Bouchard,D,EDM,25,82,21,49,70
11,8471685,Anze Kopitar,C,LAK,37,82,18,52,70
11,8478407,Vince Dunn,D,SEA,28,82,13,57,70
11,8478414,Timo Meier,R,NJD,28,82,36,33,69
11,8478873,Troy Terry,R,ANA,27,82,27,42,69
11,8477942,Kevin Fiala,L,LAK,28,82,26,43,69
11,8481528,Dylan Cozens,C,BUF,23,82,24,45,69
11,8474141,Patrick Kane,R,DET,36,82,23,45,68
11,8475765,Vladimir Tarasenko,R,FLA,33,82,23,45,68
11,8474679,Gustav Nyquist,C,NSH,35,82,24,43,67
11,8474578,Erik Karlsson,D,PIT,34,82,14,53,67
11,8481540,Cole Caufield,R,MTL,23,82,39,27,66
11,8475170,Brayden Schenn,C,STL,33,82,28,38,66
11,8474590,John Carlson,D,WSH,34,82,16,50,66
11,8479410,Mikhail Sergachev,D,TBL,26,82,7,59,66
11,8477416,Oliver Bjorkstrand,R,SEA,29,82,27,38,65
11,8480002,Nico Hischier,C,NJD,25,82,26,39,65
11,8476459,Mika Zibanejad,C,NYR,31,82,24,41,65
11,8478498,Jake DeBrusk,L,BOS,28,82,24,41,65
11,8477479,Tyler Bertuzzi,L,TOR,29,82,23,42,65
11,8480839,Rasmus Dahlin,D,BUF,24,82,22,43,65
11,8478975,Mason Marchment,L,DAL,29,82,20,45,65
11,8475798,Mikael Granlund,C,SJS,32,82,16,49,65
11,8479337,Alex DeBrincat,R,DET,27,82,24,40,64
11,8482699,Dylan Guenther,R,ARI,21,82,28,35,63
11,8473994,Jamie Benn,L,DAL,35,82,27,36,63
11,8478401,Pavel Zacha,C,BOS,27,82,26,37,63
11,8478438,Tommy Novak,C,NSH,27,82,20,43,63
11,8477503,Max Domi,C,TOR,29,82,17,46,63
11,8475754,Brock Nelson,C,NYI,33,82,30,32,62
11,8482110,Dawson Mercer,C,NJD,23,82,28,34,62
11,8476389,Vincent Trocheck,C,NYR,31,82,27,35,62
11,8475810,Bryan Rust,R,PIT,32,82,26,36,62
11,8477960,Adrian Kempe,R,LAK,28,82,26,36,62
11,8477496,Elias Lindholm,C,VAN,30,82,20,42,62
11,8475726,Tyler Toffoli,C,WPG,32,82,33,28,61
11,8481068,Yegor Sharangovich,C,CGY,26,82,32,29,61
11,8475768,Jaden Schwartz,C,SEA,32,82,26,35,61
11,8478440,Dylan Strome,C,WSH,27,82,24,37,61
11,8477986,Brandon Montour,D,FLA,30,82,16,45,61
11,8482667,William Eklund,L,SJS,22,82,32,28,60
11,8479339,Patrik Laine,L,CBJ,26,82,30,30,60
11,8479675,Trevor Moore,L,LAK,29,82,29,31,60
11,8481711,Matias Maccelli,L,ARI,24,82,18,42,60
11,8480208,Drake Batherson,R,OTT,26,82,17,43,60
11,8482093,Seth Jarvis,C,CAR,22,82,35,24,59
11,8477407,Anthony Duclair,L,TBL,29,82,32,27,59
11,8482475,Yegor Chinakhov,R,CBJ,23,82,30,29,59
11,8478856,Conor Garland,R,VAN,28,82,25,34,59
11,8477497,Sean Monahan,C,WPG,30,82,25,34,59
11,8478047,Michael Bunting,L,PIT,29,82,21,38,59
11,8476483,Rickard Rakell,R,PIT,31,82,31,27,58
11,8482175,JJ Peterka,R,BUF,22,82,30,28,58
11,8474102,David Perron,L,DET,36,82,22,36,58
11,8480039,Martin Necas,C,CAR,25,82,21,37,58
11,8476875,Mike Matheson,D,MTL,30,82,18,40,58
11,8479345,Jakob Chychrun,D,OTT,26,82,23,34,57
11,8476881,Tomas Hertl,C,VGK,31,82,22,35,57
11,8482097,Jack Quinn,R,BUF,23,82,15,42,57
11,8475745,Charlie Coyle,C,BOS,32,82,22,34,56
11,8476906,Shayne Gostisbehere,D,DET,31,82,16,40,56
11,8477021,Alex Kerfoot,C,ARI,30,82,15,41,56
11,8479999,Casey Mittelstadt,C,COL,26,82,15,41,56
11,8480014,Gabriel Vilardi,C,WPG,25,82,33,22,55
11,8484144,Connor Bedard,C,CHI,19,82,28,27,55
11,8474641,Adam Henrique,C,EDM,34,82,27,28,55
11,8473986,Alex Killorn,L,ANA,35,82,25,30,55
11,8481533,Trevor Zegras,C,ANA,23,82,24,31,55
11,8478474,Lawson Crouse,L,ARI,27,82,24,31,55
11,8474565,Alex Pietrangelo,D,VGK,34,82,18,37,55
11,8476905,Chandler Stephenson,C,VGK,30,82,17,38,55
11,8471724,Kris Letang,D,PIT,37,82,12,43,55
11,8476438,Brandon Saad,L,STL,32,82,23,31,54
11,8475287,Erik Haula,L,NJD,33,82,23,31,54
11,8478038,Devon Toews,D,COL,30,82,13,41,54
11,8482684,Luke Hughes,D,NJD,21,82,12,42,54
11,8482671,Owen Power,D,BUF,22,82,11,43,54
11,8475794,Tyler Seguin,C,DAL,32,82,27,26,53
11,8474586,Jordan Eberle,R,SEA,34,82,21,32,53
11,8475744,Evgeny Kuznetsov,C,CAR,32,82,18,35,53
11,8480015,Owen Tippett,R,PHI,25,82,31,21,52
11,8477476,Artturi Lehkonen,L,COL,29,82,27,25,52
11,8480078,Filip Chytil,C,NYR,25,82,23,29,52
11,8477429,Andrew Copp,C,DET,30,82,23,29,52
11,8478396,Noah Hanifin,D,VGK,27,82,19,33,52
11,8478233,Andrew Mangiapane,L,CGY,28,82,17,35,52
11,8474563,Drew Doughty,D,LAK,35,82,7,45,52
11,8476432,Boone Jenner,C,CBJ,31,82,32,19,51
11,8481624,Ilya Mikheyev,R,VAN,30,82,28,23,51
11,8479400,Pierre-Luc Dubois,L,LAK,26,82,26,25,51
11,8482124,Quinton Byfield,R,LAK,22,82,20,31,51
11,8480434,Sean Durzi,D,ARI,26,82,16,35,51
11,8475753,Justin Faulk,D,STL,32,82,13,38,51
11,8477447,Shea Theodore,D,VGK,29,82,12,39,51
11,8480893,Kirill Marchenko,R,CBJ,24,82,30,20,50
11,8475184,Chris Kreider,L,NYR,33,82,28,22,50
11,8477426,Nicholas Paul,L,TBL,29,82,27,23,50
11,8480797,Joel Farabee,L,PHI,24,82,25,25,50
11,8476448,William Karlsson,C,VGK,31,82,22,28,50
11,8478462,Nicolas Roy,C,VGK,27,82,19,31,50
11,8482222,Alexander Barabanov,L,SJS,30,82,18,32,50
11,8480220,Noah Cates,L,PHI,25,82,18,32,50
11,8481581,Thomas Harley,D,DAL,23,82,13,37,50
11,8482740,Wyatt Johnston,C,DAL,21,82,29,20,49
11,8478519,Anthony Cirelli,C,TBL,27,82,26,23,49
11,8481596,Shane Pinto,C,OTT,24,82,24,25,49
11,8473422,Nick Foligno,L,CHI,37,82,21,28,49
11,8477444,Andre Burakovsky,L,SEA,29,82,17,32,49
11,8476479,Phillip Danault,C,LAK,31,82,17,32,49
11,8478055,Gustav Forsling,D,FLA,28,82,17,32,49
11,8481542,Moritz Seider,D,DET,23,82,7,42,49
11,8477500,Bo Horvat,C,NYI,29,82,26,22,48
11,8477935,Sam Bennett,C,FLA,28,82,24,24,48
11,8482113,Anton Lundell,C,FLA,23,82,23,25,48
11,8470613,Brent Burns,D,CAR,39,82,17,31,48
11,8476458,Ryan Strome,C,ANA,31,82,14,34,48
11,8476882,Teuvo Teravainen,L,CAR,30,82,14,34,48
11,8478472,Mathieu Joseph,R,OTT,27,82,14,34,48
11,8476854,Hampus Lindholm,D,BOS,30,82,11,37,48
11,8482159,Tyson Foerster,R,PHI,22,82,22,25,47
11,8478413,Jordan Greenway,L,BUF,27,82,21,26,47
11,8482705,Cole Sillinger,C,CBJ,21,82,19,28,47
11,8477932,Aaron Ekblad,D,FLA,28,82,17,30,47
11,8475218,Mattias Ekholm,D,EDM,34,82,15,32,47
11,8476329,Travis Boyd,C,ARI,31,82,14,33,47
11,8474157,Max Pacioretty,L,WSH,36,82,17,29,46
11,8478458,Jack Roslovic,C,NYR,27,82,15,31,46
11,8478463,Anthony Beauvillier,L,NSH,27,82,13,33,46
11,8476792,Torey Krug,D,STL,33,82,12,34,46
11,8480145,Neal Pionk,D,WPG,29,82,11,35,46
11,8482146,Luke Evangelista,R,NSH,22,82,28,17,45
11,8478366,Frank Vatrano,R,ANA,30,82,27,18,45
11,8476927,Teddy Blueger,C,VAN,30,82,20,25,45
11,8481535,Nils Hoglander,L,VAN,24,82,20,25,45
11,8482745,Mason McTavish,C,ANA,21,82,19,26,45
11,8477511,Anthony Mantha,R,VGK,30,82,18,27,45
11,8474149,Evgenii Dadonov,R,DAL,35,82,16,29,45
11,8480798,Philipp Kurashev,C,CHI,25,82,15,30,45
11,8477346,MacKenzie Weegar,D,CGY,30,82,8,37,45
11,8478397,Rasmus Andersson,D,CGY,28,82,6,39,45
11,8480009,Eeli Tolvanen,R,SEA,25,82,23,21,44
11,8475151,Kyle Palmieri,C,NYI,33,82,22,22,44
11,8478057,Dakota Joshua,C,VAN,28,82,22,22,44
11,8477494,Jonathan Drouin,L,COL,29,82,19,25,44
11,8478469,Thomas Chabot,D,OTT,27,82,13,31,44
11,8476923,Damon Severson,D,CBJ,30,82,8,36,44
11,8479425,Filip Hronek,D,VAN,27,82,4,40,44
11,8482092,Ridly Greig,C,OTT,22,82,19,24,43
11,8476461,Sean Couturier,C,PHI,32,82,17,26,43
11,8481618,Alex Newhook,C,MTL,23,82,16,27,43
11,8475197,Tyson Barrie,D,NSH,33,82,9,34,43
11,8477495,Seth Jones,D,CHI,30,82,7,36,43
11,8481560,Arthur Kaliyev,R,LAK,23,82,22,20,42
11,8477998,Warren Foegele,L,EDM,28,82,21,21,42
11,8475848,Brendan Gallagher,R,MTL,32,82,18,24,42
11,8483515,Juraj Slafkovsky,L,MTL,20,82,17,25,42
11,8473563,Nicklas Backstrom,C,WSH,37,82,15,27,42
11,8475791,Taylor Hall,L,CHI,33,82,14,28,42
11,8480185,Eetu Luostarinen,C,FLA,26,82,14,28,42
11,8480028,Morgan Frost,C,PHI,25,82,13,29,42
11,8481013,Jonatan Berggren,R,DET,24,82,13,29,42
11,8476869,Brady Skjei,D,CAR,30,82,11,31,42
11,8476880,Tom Wilson,R,WSH,30,82,22,19,41
11,8477456,J.T. Compher,L,DET,29,82,17,24,41
11,8478466,Daniel Sprong,R,DET,27,82,15,26,41
11,8478542,Evan Rodrigues,C,FLA,31,82,15,26,41
11,8479992,Michael Rasmussen,C,DET,25,82,15,26,41
11,8482720,Matthew Knies,L,TOR,22,82,15,26,41
11,8479525,Ross Colton,C,COL,28,82,20,20,40
11,8477964,Ivan Barbashev,C,VGK,29,82,19,21,40
11,8482055,Drew O'Connor,L,PIT,26,82,18,22,40
11,8479365,Trent Frederic,C,BOS,26,82,17,23,40
11,8474150,Mikael Backlund,C,CGY,35,82,13,27,40
11,8479987,Morgan Geekie,C,BOS,26,82,12,28,40
11,8483808,Andrei Kuzmenko,L,CGY,28,82,27,12,39
11,8478046,Danton Heinen,L,BOS,29,82,26,13,39
11,8475191,Reilly Smith,R,PIT,33,82,22,17,39
11,8477944,Jakub Vrana,L,STL,28,82,18,21,39
11,8474870,Tyler Johnson,C,CHI,34,82,15,24,39
11,8476826,Yanni Gourde,C,SEA,33,82,14,25,39
11,8482105,Jake Sanderson,D,OTT,22,82,12,27,39
11,8478891,Mason Appleton,C,WPG,28,82,12,27,39
11,8474716,Jared Spurgeon,D,MIN,35,82,9,30,39
11,8476958,Jaccob Slavin,D,CAR,30,82,8,31,39
11,8478500,Ivan Provorov,D,CBJ,27,82,5,34,39
11,8480064,Josh Norris,C,OTT,25,82,23,15,38
11,8482109,Alexis Lafrenière,L,NYR,23,82,22,16,38
11,8479415,Michael McLeod,C,NJD,26,82,21,17,38
11,8475714,Calle Jarnkrok,C,TOR,33,82,19,19,38
11,8471698,T.J. Oshie,R,WSH,38,82,19,19,38
11,8480802,Ryan McLeod,C,EDM,25,82,15,23,38
11,8475149,Marcus Johansson,L,MIN,34,82,13,25,38
11,8480336,Sean Walker,D,COL,30,82,8,30,38
11,8476872,Scott Laughton,C,PHI,30,82,6,32,38
11,8481546,Cam York,D,PHI,23,82,5,33,38
11,8475314,Anders Lee,L,NYI,34,82,21,16,37
11,8476399,Blake Coleman,C,CGY,33,82,19,18,37
11,8479941,Justin Danforth,R,CBJ,31,82,18,19,37
11,8478109,Victor Olofsson,L,BUF,29,82,18,19,37
11,8481477,Nico Sturm,C,SJS,29,82,16,21,37
11,8474884,Mike Hoffman,C,SJS,35,82,15,22,37
11,8483457,Lane Hutson,D,MTL,20,82,11,26,37
11,8477947,Sonny Milano,L,WSH,28,82,17,19,36
11,8479293,Brandon Tanev,L,SEA,33,82,17,19,36
11,8479393,Noah Gregor,C,TOR,26,82,17,19,36
11,8480144,David Kampf,C,TOR,29,82,14,22,36
11,8482133,Thomas Bordeleau,C,SJS,22,82,13,23,36
11,8481656,Aliaksei Protas,C,WSH,23,82,12,24,36
11,8481481,Blake Lizotte,C,LAK,27,82,12,24,36
11,8475763,Kevin Hayes,R,STL,32,82,10,26,36
11,8480849,Barrett Hayton,C,ARI,24,82,22,13,35
11,8476981,Josh Anderson,R,MTL,30,82,22,13,35
11,8475760,Nick Bjugstad,C,ARI,32,82,20,15,35
11,8479316,Luke Kunin,C,SJS,27,82,18,17,35
11,8473449,Kyle Okposo,R,FLA,36,82,16,19,35
11,8478043,Sam Lafferty,C,VAN,29,82,15,20,35
11,8480855,Jack McBain,C,ARI,24,82,14,21,35
11,8474037,James van Riemsdyk,L,BOS,35,82,12,23,35
11,8477498,Darnell Nurse,D,EDM,29,82,12,23,35
11,8476480,Vladislav Namestnikov,C,WPG,32,82,11,24,35
11,8480871,Adam Boqvist,D,CBJ,24,82,10,25,35
11,8479977,Kailer Yamamoto,R,SEA,26,82,10,25,35
11,8475793,Ryan Johansen,C,PHI,32,82,9,26,35
11,8479398,Samuel Girard,D,COL,26,82,9,26,35
11,8481703,Valtteri Puustinen,R,PIT,25,82,8,27,35
11,8478507,John Marino,D,NJD,27,82,6,29,35
11,8470621,Corey Perry,R,EDM,39,82,19,15,34
11,8482079,Marco Rossi,C,MIN,23,82,18,16,34
11,8482089,Jake Neighbours,L,STL,22,82,17,17,34
11,8475722,Jason Zucker,L,NSH,32,82,16,18,34
11,8480821,Filip Zadina,R,SJS,25,82,14,20,34
11,8474053,Logan Couture,C,SJS,35,82,12,22,34
11,8476902,Esa Lindell,D,DAL,30,82,7,27,34
11,8475906,John Klingberg,D,TOR,32,82,5,29,34
11,8480459,Pius Suter,C,VAN,28,82,23,10,33
11,8477952,Robby Fabbri,C,DET,28,82,20,13,33
11,8481704,Juuso Parssinen,C,NSH,23,82,18,15,33
11,8473533,Jordan Staal,C,CAR,36,82,17,16,33
11,8480113,Alex Iafallo,L,WPG,31,82,16,17,33
11,8482117,Lukas Reichel,L,CHI,22,82,16,17,33
11,8479661,Tanner Jeannot,L,TBL,27,82,14,19,33
11,8476921,Jordan Martinook,L,CAR,32,82,12,21,33
11,8476419,Jean-Gabriel Pageau,C,NYI,32,82,11,22,33
11,8481522,Peyton Krebs,C,BUF,23,82,8,25,33
11,8476292,Ondrej Palat,L,NJD,33,82,7,26,33
11,8478911,Matt Roy,D,LAK,29,82,5,28,33
11,8480073,Erik Brannstrom,D,OTT,25,82,4,29,33
11,8476925,Colton Sissons,C,NSH,31,82,18,14,32
11,8481580,Connor McMichael,C,WSH,23,82,18,14,32
11,8478020,Michael Amadio,C,VGK,28,82,17,15,32
11,8477989,Christian Dvorak,C,MTL,28,82,15,17,32
11,8476897,Oskar Sundqvist,C,STL,30,82,14,18,32
11,8477953,Kasperi Kapanen,R,STL,28,82,12,20,32
11,8477488,Brett Pesce,D,CAR,30,82,11,21,32
11,8475220,Marcus Foligno,L,MIN,33,82,10,22,32
11,8477839,Conor Sheary,L,TBL,32,82,9,23,32
11,8480817,K'Andre Miller,D,NYR,24,82,8,24,32
11,8477507,Nikita Zadorov,D,VAN,29,82,7,25,32
11,8476467,Jamie Oleksiak,D,SEA,32,82,6,26,32
11,8480873,Rasmus Sandin,D,WSH,24,82,4,28,32
11,8480043,Timothy Liljegren,D,TOR,25,82,3,29,32
11,8479390,Taylor Raddysh,R,CHI,26,82,17,14,31
11,8477330,Dominik Kubalik,L,OTT,29,82,15,16,31
11,8476392,Adam Lowry,C,WPG,31,82,12,19,31
11,8480813,Joe Veleno,C,DET,24,82,12,19,31
11,8476278,Colin Blackwell,C,CHI,31,82,12,19,31
11,8481186,Logan O'Connor,R,COL,28,82,11,20,31
11,8477450,Jason Dickinson,C,CHI,29,82,11,20,31
11,8477506,Ryan Pulock,D,NYI,30,82,7,24,31
11,8479976,Juuso Valimaki,D,ARI,26,82,7,24,31
11,8477220,Nate Schmidt,D,WPG,33,82,7,24,31
11,8482122,Brock Faber,D,MIN,22,82,5,26,31
11,8477969,Marcus Pettersson,D,PIT,28,82,4,27,31
11,8475799,Nino Niederreiter,R,WPG,32,82,14,16,30
11,8483431,Logan Cooley,C,ARI,20,82,13,17,30
11,8482624,Daniil Miromanov,D,CGY,27,82,12,18,30
11,8479351,Sam Steel,C,DAL,26,82,11,19,30
11,8482142,Jamie Drysdale,D,PHI,22,82,9,21,30
11,8476879,Cody Ceci,D,EDM,31,82,7,23,30
11,8478882,Vladislav Gavrikov,D,LAK,29,82,5,25,30
11,8474034,Pat Maroon,L,BOS,36,82,15,14,29
11,8478508,Yakov Trenin,C,COL,27,82,14,15,29
11,8484145,Zach Benson,L,BUF,19,82,14,15,29
11,8477406,Mattias Janmark,C,EDM,32,82,13,16,29
11,8476463,Jonas Brodin,D,MIN,31,82,9,20,29
11,8475164,Jakob Silfverberg,R,ANA,34,82,8,21,29
11,8477425,Miles Wood,L,COL,29,82,15,13,28
11,8470610,Zach Parise,L,COL,40,82,14,14,28
11,8479996,Cody Glass,C,NSH,25,82,10,18,28
11,8483499,Liam Ohgren,L,MIN,20,82,10,18,28
11,8477948,Travis Sanheim,D,PHI,28,82,6,22,28
11,8476312,Josh Manson,D,COL,33,82,6,22,28
11,8478133,Jake Evans,C,MTL,28,82,6,22,28
11,8478840,Will Borgen,D,SEA,28,82,5,23,28
11,8475181,Nick Leddy,D,STL,33,82,4,24,28
11,8481568,Alex Vlasic,D,CHI,23,82,4,24,28
11,8476892,Colton Parayko,D,STL,31,82,3,25,28
11,8477435,Ryan Graves,D,PIT,29,82,3,25,28
11,8475764,Cam Fowler,D,ANA,33,82,2,26,28
11,8477353,Tyler Motte,C,TBL,29,82,17,10,27
11,8478115,Pierre Engvall,L,NYI,28,82,15,12,27
11,8482062,Cole Smith,L,NSH,29,82,15,12,27
11,8482259,Bobby McMann,C,TOR,28,82,15,12,27
11,8483524,Shane Wright,C,SEA,20,82,13,14,27
11,8471218,Blake Wheeler,R,NYR,38,82,12,15,27
11,8479591,Michael Eyssimont,C,TBL,28,82,12,15,27
11,8481553,Bobby Brink,R,PHI,23,82,12,15,27
11,8480448,Parker Kelly,L,OTT,25,82,11,16,27
11,8477919,Frederick Gaudreau,C,MIN,31,82,10,17,27
11,8475171,Oliver Ekman-Larsson,D,FLA,33,82,4,23,27
11,8478136,Jake Middleton,D,MIN,28,82,4,23,27
11,8475790,Erik Gudbranson,D,CBJ,32,82,3,24,27
11,8482074,Connor Zary,C,CGY,23,82,16,10,26
11,8475343,Nic Dowd,C,WSH,34,82,13,13,26
11,8484203,Bradly Nadeau,L,CAR,19,82,12,14,26
11,8480995,Pontus Holmberg,R,TOR,25,82,10,16,26
11,8477508,Curtis Lazar,C,NJD,29,82,9,17,26
11,8476885,Jacob Trouba,D,NYR,30,82,8,18,26
11,8475279,Ben Chiarot,D,DET,33,82,8,18,26
11,8481517,Brett Leason,R,ANA,25,82,6,20,26
11,8482111,Justin Barron,D,MTL,23,82,5,21,26
11,8475690,Chris Tanev,D,DAL,35,82,5,21,26
11,8470966,Mark Giordano,D,TOR,41,82,5,21,26
11,8476457,Adam Larsson,D,SEA,32,82,5,21,26
11,8474574,Tyler Myers,D,VAN,34,82,5,21,26
11,8479371,Dante Fabbro,D,NSH,26,82,3,23,26
11,8479369,Andrew Peeke,D,BOS,26,82,1,25,26
11,8482655,J.J. Moser,D,ARI,24,82,0,26,26
11,8474673,TJ Brodie,D,TOR,34,82,0,26,26
11,8479353,Brett Howden,C,VGK,26,82,12,13,25
11,8483468,Jiri Kulich,C,BUF,20,82,11,14,25
11,8480074,Alexandre Texier,C,CBJ,25,82,10,15,25
11,8476871,Tanner Pearson,L,MTL,32,82,10,15,25
11,8481606,Jordan Spence,D,LAK,23,82,9,16,25
11,8479346,Dillon Dube,C,CGY,26,82,8,17,25
11,8477369,Carson Soucy,D,VAN,30,82,8,17,25
11,8479359,Beck Malenstyn,L,WSH,26,82,7,18,25
11,8478859,Niko Mikkola,D,FLA,28,82,7,18,25
11,8476331,Dylan DeMelo,D,WPG,31,82,6,19,25
11,8483565,Nick Blankenburg,D,CBJ,26,82,4,21,25
11,8474151,Ryan McDonagh,D,NSH,35,82,3,22,25
11,8480068,Ryan Poehling,C,PHI,25,82,14,10,24
11,8481093,Rafael Harvey-Pinard,L,MTL,25,82,14,10,24
11,8478831,Kevin Stenlund,C,FLA,28,82,14,10,24
11,8477505,Alexander Wennberg,C,NYR,30,82,13,11,24
11,8470604,Jeff Carter,C,PIT,39,82,12,12,24
11,8476873,Mark Jankowski,C,NSH,30,82,12,12,24
11,8474189,Lars Eller,C,PIT,35,82,9,15,24
11,8477931,Tomas Nosek,L,NJD,32,82,8,16,24
11,8482730,Brandt Clarke,D,LAK,21,82,6,18,24
11,8476891,Matt Grzelcyk,D,BOS,30,82,6,18,24
11,8482166,Shakir Mukhamadullin,D,SJS,22,82,5,19,24
11,8480796,Martin Fehervary,D,WSH,25,82,5,19,24
11,8477365,Connor Clifton,D,BUF,29,82,5,19,24
11,8475200,Dmitry Orlov,D,CAR,33,82,4,20,24
11,8473507,Jeff Petry,D,DET,37,82,2,22,24
11,8476469,Joel Armia,R,MTL,31,82,13,10,23
11,8483397,Marc McLaughlin,C,BOS,25,82,11,12,23
11,8477392,Hudson Fasching,R,NYI,29,82,10,13,23
11,8477015,Connor Brown,R,EDM,30,82,9,14,23
11,8482125,Alexander Holtz,R,NJD,22,82,7,16,23
11,8478430,Oliver Kylington,D,CGY,27,82,7,16,23
11,8479514,Rem Pitlick,C,CHI,27,82,6,17,23
11,8478416,Erik Cernak,D,TBL,27,82,6,17,23
11,8476979,Erik Gustafsson,D,NYR,32,82,4,19,23
11,8482666,Scott Morrow,D,CAR,22,82,4,19,23
11,8481554,Kaapo Kakko,R,NYR,23,82,15,7,22
11,8474009,Nick Bonino,C,NYR,36,82,12,10,22
11,8481601,Simon Holmstrom,R,NYI,23,82,11,11,22
11,8481537,Nikita Okhotiuk,D,CGY,24,82,8,14,22
11,8482807,Ethan Del Mastro,D,CHI,21,82,8,14,22
11,8482245,Artem Zub,D,OTT,29,82,5,17,22
11,8475324,Nick Jensen,D,WSH,34,82,4,18,22
11,8480834,Ty Emberson,D,SJS,24,82,4,18,22
11,8476917,Adam Pelech,D,NYI,30,82,3,19,22
11,8478851,Alexandre Carrier,D,NSH,28,82,3,19,22
11,8481059,Scott Perunovich,D,STL,26,82,3,19,22
11,8479998,Mikey Anderson,D,LAK,25,82,2,20,22
11,8476858,Phillip Di Giuseppe,L,VAN,31,82,16,5,21
11,8484153,Leo Carlsson,C,ANA,20,82,9,12,21
11,8481014,Alexander Romanov,D,NYI,24,82,3,18,21
11,8476967,Brett Kulak,D,EDM,30,82,2,19,21
11,8475842,Sam Carrick,C,EDM,32,82,13,7,20
11,8473453,Trevor Lewis,C,LAK,37,82,12,8,20
11,8482809,Jackson Blake,R,CAR,21,82,11,9,20
11,8478451,Ethan Bear,D,WSH,27,82,11,9,20
11,8483505,Matthew Poitras,C,BOS,20,82,8,12,20
11,8483471,Brad Lambert,C,WPG,31,82,8,12,20
11,8476422,Mike Reilly,D,NYI,31,82,7,13,20
11,8481604,Pavel Dorofeyev,L,VGK,24,82,6,14,20
11,8481016,Ruslan Iskhakov,C,NYI,24,82,6,14,20
11,8482087,Kaiden Guhle,D,MTL,22,82,5,15,20
11,8479383,Boris Katchouk,L,OTT,26,82,5,15,20
11,8480990,Declan Chisholm,D,MIN,24,82,5,15,20
11,8475208,Brian Dumoulin,D,SEA,33,82,4,16,20
11,8475233,David Savard,D,MTL,34,82,3,17,20
11,8477845,Trevor van Riemsdyk,D,WSH,33,82,2,18,20
11,8470600,Ryan Suter,D,DAL,39,82,2,18,20
11,8476374,Sean Kuraly,C,CBJ,31,82,13,6,19
11,8482679,Matt Coronato,R,CGY,22,82,12,7,19
11,8479423,Alex Nylander,L,CBJ,26,82,9,10,19
11,8483495,Simon Nemec,D,NJD,20,82,6,13,19
11,8482145,Mavrik Bourque,C,DAL,22,82,6,13,19
11,8481567,Henry Thrun,D,SJS,23,82,5,14,19
11,8480246,Nick Perbix,D,TBL,26,82,4,15,19
11,8479983,Mario Ferraro,D,SJS,26,82,4,15,19
11,8474013,Ian Cole,D,VAN,35,82,4,15,19
11,8474567,Zach Bogosian,D,MIN,34,82,4,15,19
11,8478178,Darren Raddysh,D,TBL,28,82,3,16,19
11,8476525,Colin Miller,D,WPG,32,82,3,16,19
11,8476931,Jake McCabe,D,TOR,31,82,2,17,19
11,8480035,Henri Jokiharju,D,BUF,25,82,2,17,19
11,8480860,Kevin Bahl,D,NJD,24,82,1,18,19
11,8476878,Zemgus Girgensons,L,BUF,30,82,13,5,18
11,8483445,Cutter Gauthier,L,ANA,20,82,10,8,18
11,8484149,Gavin Brindley,C,CBJ,20,82,8,10,18
11,8482858,Ryker Evans,D,SEA,23,82,8,10,18
11,8476960,Andreas Athanasiou,C,CHI,30,82,7,11,18
11,8476624,Barclay Goodrow,C,NYR,31,82,6,12,18
11,8481524,Bowen Byram,D,BUF,23,82,6,12,18
11,8479442,Troy Stecher,D,EDM,30,82,6,12,18
11,8475455,Brenden Dillon,D,WPG,34,82,6,12,18
11,8483763,Maksymilian Szuber,D,ARI,22,82,5,13,18
11,8475462,Radko Gudas,D,ANA,34,82,5,13,18
11,8481605,Jackson LaCombe,D,ANA,23,82,5,13,18
11,8476429,Scott Mayfield,D,NYI,32,82,2,16,18
11,8480879,Jacob Bernard-Docker,D,OTT,24,82,1,17,18
11,8480281,Alexey Toropchenko,R,STL,25,82,11,6,17
11,8483466,Kevin Korchinski,D,CHI,20,82,10,7,17
11,8480031,Maxime Comtois,L,CAR,25,82,8,9,17
11,8473504,Cal Clutterbuck,R,NYI,37,82,7,10,17
11,8477499,Rasmus Ristolainen,D,PHI,30,82,6,11,17
11,8484166,Adam Fantilli,C,CBJ,20,82,5,12,17
11,8476915,Jujhar Khaira,L,MIN,30,82,12,4,16
11,8478569,Noel Acciari,C,PIT,33,82,10,6,16
11,8482118,Sam Colangelo,R,ANA,23,82,7,9,16
11,8474715,Cam Atkinson,R,PHI,35,82,6,10,16
11,8482470,Ilya Solovyov,D,CGY,24,82,3,13,16
11,8482733,Logan Mailloux,D,MTL,31,82,3,13,16
11,8479324,Ryan Lindgren,D,NYR,26,82,2,14,16
11,8483490,Pavel Mintyukov,D,ANA,21,82,2,14,16
11,8482155,Alex Laferriere,R,LAK,23,82,11,4,15
11,8481028,Martin Pospisil,C,CGY,25,82,11,4,15
11,8483493,Frank Nazar,C,CHI,20,82,7,8,15
11,8475762,Derek Forbort,D,BOS,32,82,7,8,15
11,8475177,Calvin de Haan,D,TBL,33,82,6,9,15
11,8478013,Jake Walman,D,DET,28,82,5,10,15
11,8482762,Simon Edvinsson,D,DET,21,82,5,10,15
11,8479291,Kevin Rooney,C,CGY,31,82,4,11,15
11,8475188,Brayden McNabb,D,VGK,33,82,3,12,15
11,8478468,Jeremy Lauzon,D,NSH,27,82,3,12,15
11,8478443,Brandon Carlo,D,BOS,28,82,3,12,15
11,8478399,Jonas Siegenthaler,D,NJD,27,82,1,14,15
11,8481178,Egor Zamula,D,PHI,24,82,0,15,15
11,8475231,Casey Cizikas,C,NYI,33,82,9,5,14
11,8480806,Isac Lundestrom,C,ANA,25,82,6,8,14
11,8475825,Jani Hakanpää,D,DAL,32,82,5,9,14
11,8479980,Nicolas Hague,D,VGK,26,82,4,10,14
11,8477335,Kyle Burroughs,D,SJS,29,82,4,10,14
11,8483491,Ivan Miroshnichenko,L,WSH,20,82,2,12,14
11,8483489,Fraser Minten,C,TOR,31,82,6,7,13
11,8483012,Logan Morrison,C,SEA,22,82,5,8,13
11,8474166,Alec Martinez,D,VGK,37,82,3,10,13
11,8480807,Mattias Samuelsson,D,BUF,24,82,3,10,13
11,8481599,Victor Soderstrom,D,ARI,23,82,2,11,13
11,8475179,Dmitry Kulikov,D,FLA,34,82,1,12,13
11,8482073,Braden Schneider,D,NYR,23,82,1,12,13
11,8482702,Logan Stankoven,C,DAL,21,82,6,6,12
11,8481699,Aku Raty,R,ARI,23,82,6,6,12
11,8482516,Matthew Kessel,D,STL,24,82,4,8,12
11,8484911,Collin Graf,R,SJS,22,82,2,10,12
11,8480058,Pierre-Olivier Joseph,D,PIT,25,82,1,11,12
11,8476372,Nick Seeler,D,PHI,31,82,2,9,11
11,8471677,Jack Johnson,D,COL,37,82,2,9,11
11,8481030,Jack St. Ivany,D,PIT,25,82,2,9,11
11,8480172,Jan Rutta,D,SJS,34,82,1,10,11
11,8482737,Zack Bolduc,C,STL,21,82,4,6,10
11,8482712,Oskar Olausson,R,COL,22,82,4,6,10
11,8483482,Tristan Luneau,D,ANA,20,82,4,6,10
11,8482803,Olen Zellweger,D,ANA,21,82,3,7,10
11,8477034,Jaycob Megna,D,CHI,32,82,1,9,10
11,8476822,Luke Glendening,C,TBL,35,82,4,5,9
11,8476442,Matt Nieto,L,PIT,32,82,3,6,9
11,8482101,Danil Gushchin,L,SJS,22,82,3,6,9
11,8482859,Zack Ostapchuk,C,OTT,21,82,3,6,9
11,8482177,Marat Khusnutdinov,C,MIN,22,82,3,6,9
11,8476473,Connor Murphy,D,CHI,31,82,2,7,9
11,8481578,Graeme Clarke,R,NJD,23,82,2,5,7
11,8482713,Mackie Samoskevich,R,FLA,22,82,2,5,7
11,8478408,Travis Dermott,D,ARI,28,82,3,2,5
11,8477950,Tony DeAngelo,D,CAR,29,0,0,0,0
11,8481577,Philip Tomasino,C,NSH,23,0,0,0,0
11,8482660,Kent Johnson,C,CBJ,22,0,0,0,0
11,8481019,David Gustafsson,C,WPG,24,0,0,0,0
11,8479348,Kale Clague,D,BUF,26,0,0,0,0
11,8482149,Cole Perfetti,C,WPG,22,0,0,0,0
11,8476952,Dominic Toninato,C,WPG,30,0,0,0,0
11,8473473,Milan Lucic,L,BOS,36,0,0,0,0
11,8480829,Jesperi Kotkaniemi,C,CAR,24,0,0,0,0
11,8474602,Justin Schultz,D,SEA,34,0,0,0,0
11,8480049,Dylan Samberg,D,WPG,25,0,0,0,0
11,8479372,Josh Mahura,D,FLA,26,0,0,0,0
11,8480878,Nils Lundkvist,D,DAL,24,0,0,0,0
11,8479982,Conor Timmins,D,TOR,26,0,0,0,0
11,8474031,Kevin Shattenkirk,D,BOS,35,0,0,0,0
11,8480835,Jack Drury,C,CAR,24,0,0,0,0
11,8480008,Adam Ruzicka,C,ARI,25,0,0,0,0
11,8479402,Jake Bean,D,CBJ,26,0,0,0,0
11,8476474,Stefan Noesen,R,CAR,31,0,0,0,0
11,8480884,Calen Addison,D,SJS,24,0,0,0,0
11,8476994,Vinnie Hinostroza,C,PIT,30,0,0,0,0
11,8477987,Ryan Donato,C,CHI,28,0,0,0,0
11,8481582,Nicholas Robertson,L,TOR,23,0,0,0,0
11,8478452,Caleb Jones,D,COL,27,0,0,0,0
11,8480157,Calle Rosen,D,STL,30,0,0,0,0
11,8481609,Vladislav Kolyachonok,D,ARI,23,0,0,0,0
11,8476919,Chris Tierney,C,NJD,30,0,0,0,0
11,8479639,Dylan Coghlan,D,CAR,26,0,0,0,0
11,8475193,Tomas Tatar,L,SEA,34,0,0,0,0
11,8480748,Kiefer Sherwood,L,NSH,29,0,0,0,0
11,8478146,Matthew Highmore,C,OTT,28,0,0,0,0
11,8478970,Jalen Chatfield,D,CAR,28,0,0,0,0
11,8480205,Emil Bemstrom,C,PIT,25,0,0,0,0
11,8471274,Alex Goligoski,D,MIN,39,0,0,0,0
11,8478104,Sammy Blais,L,STL,28,0,0,0,0
11,8476913,Devin Shore,C,SEA,30,0,0,0,0
11,8481708,Zac Jones,D,NYR,24,0,0,0,0
11,8480222,Sebastian Aho,D,NYI,28,0,0,0,0
11,8481598,Philip Broberg,D,EDM,23,0,0,0,0
11,8480789,Oliver Wahlstrom,R,NYI,24,0,0,0,0
11,8480891,Michael Kesselring,D,ARI,24,0,0,0,0
11,8477979,Nicolas Aube-Kubel,R,WSH,28,0,0,0,0
11,8476393,Nick Cousins,C,FLA,31,0,0,0,0
11,8480003,Jesper Boqvist,C,BOS,26,0,0,0,0
11,8479543,Michael Pezzetta,L,MTL,26,0,0,0,0
11,8475855,Jesper Fast,R,CAR,33,0,0,0,0
11,8477018,Ben Hutton,D,VGK,31,0,0,0,0
11,8480762,Eric Robinson,L,BUF,29,0,0,0,0
11,8481058,Jesse Ylönen,R,MTL,25,0,0,0,0
11,8481527,Kaedan Korczak,D,VGK,23,0,0,0,0
11,8482192,Isaak Phillips,D,CHI,23,0,0,0,0
11,8480727,Zach Whitecloud,D,VGK,28,0,0,0,0
11,8480001,Urho Vaakanainen,D,ANA,25,0,0,0,0
11,8480853,Liam Foudy,C,NSH,24,0,0,0,0
11,8475225,Craig Smith,C,DAL,35,0,0,0,0
11,8479972,Mason Shaw,C,MIN,26,0,0,0,0
11,8474040,Sam Gagner,C,EDM,35,0,0,0,0
11,8480196,Jacob Bryson,D,BUF,27,0,0,0,0
11,8475718,Justin Holl,D,DET,32,0,0,0,0
11,8479984,Cal Foote,D,NJD,26,0,0,0,0
11,8480011,Klim Kostin,C,SJS,25,0,0,0,0
11,8482176,Wyatt Kaiser,D,CHI,22,0,0,0,0
11,8476918,Jimmy Vesey,L,NYR,31,0,0,0,0
11,8476988,Matt Benning,D,SJS,30,0,0,0,0
11,8479370,Tyson Jost,C,BUF,26,0,0,0,0
11,8477464,Nic Petan,C,MIN,29,0,0,0,0
11,8477380,Jonny Brodzinski,C,NYR,31,0,0,0,0
11,8480070,Ian Mitchell,D,BOS,25,0,0,0,0
11,8479315,Joey Anderson,R,CHI,26,0,0,0,0
11,8478099,Kevin Labanc,R,SJS,29,0,0,0,0
11,8476874,Olli Maatta,D,DET,30,0,0,0,0
11,8479414,Nathan Bastian,R,NJD,27,0,0,0,0
11,8478434,Keegan Kolesar,R,VGK,27,0,0,0,0
11,8479536,Axel Jonsson-Fjallby,L,WPG,26,0,0,0,0
11,8479671,Mathieu Olivier,R,CBJ,27,0,0,0,0
11,8471709,Marc-Edouard Vlasic,D,SJS,37,0,0,0,0
11,8479328,Julien Gauthier,R,NYI,27,0,0,0,0
11,8478421,A.J. Greer,L,CGY,28,0,0,0,0
11,8477573,Nathan Walker,L,STL,30,0,0,0,0
11,8477478,William Carrier,L,VGK,30,0,0,0,0
11,8479344,Jesse Puljujarvi,R,PIT,26,0,0,0,0
11,8480887,Jordan Harris,D,MTL,24,0,0,0,0
11,8478502,Dennis Gilbert,D,CGY,28,0,0,0,0
11,8480355,Mark Kastelic,C,OTT,25,0,0,0,0
11,8475750,Jon Merrill,D,MIN,32,0,0,0,0
11,8476889,Radek Faksa,C,DAL,30,0,0,0,0
11,8478432,Christian Fischer,R,DET,27,0,0,0,0
11,8479439,Jacob MacDonald,D,SJS,31,0,0,0,0
11,8474568,Luke Schenn,D,NSH,35,0,0,0,0
11,8478454,Noah Juulsen,D,VAN,27,0,0,0,0
11,8475752,Tyler Pitlick,C,NYR,33,0,0,0,0
11,8482148,Hendrix Lapierre,C,WSH,22,0,0,0,0
11,8481167,Brayden Pachal,D,CGY,25,0,0,0,0
11,8478211,Dryden Hunt,L,CGY,29,0,0,0,0
11,8479321,Lucas Johansen,D,WSH,27,0,0,0,0
11,8480950,Ilya Lyubushkin,D,TOR,30,0,0,0,0
11,8479368,Max Jones,L,ANA,26,0,0,0,0
11,8471699,Andrew Cogliano,C,COL,37,0,0,0,0
11,8481521,Ronnie Attard,D,PHI,25,0,0,0,0
11,8481161,Jake Christiansen,D,CBJ,25,0,0,0,0
11,8479458,Nikita Zaitsev,D,CHI,33,0,0,0,0
11,8479619,Michael Carcone,L,ARI,28,0,0,0,0
11,8479026,Philippe Myers,D,TBL,27,0,0,0,0
11,8481617,Vasily Podkolzin,R,VAN,23,0,0,0,0
11,8481701,Santeri Hatakka,D,NJD,23,0,0,0,0
11,8477446,Michael McCarron,R,NSH,29,0,0,0,0
11,8483460,David Jiricek,D,CBJ,21,0,0,0,0
11,8474090,Brendan Smith,D,NJD,35,0,0,0,0
11,8482241,Radim Zohorna,L,PIT,28,0,0,0,0
11,8481032,Paul Cotter,C,VGK,25,0,0,0,0
11,8480289,Morgan Barron,C,WPG,26,0,0,0,0
11,8479379,Givani Smith,R,SJS,26,0,0,0,0
11,8480216,Jacob Peterson,C,SJS,25,0,0,0,0
11,8477851,Jordan Oesterle,D,CGY,32,0,0,0,0
11,8484258,Sam Malinski,D,COL,26,0,0,0,0
11,8478904,Steven Lorentz,C,FLA,28,0,0,0,0
11,8482095,Tyler Kleven,D,OTT,22,0,0,0,0
11,8480980,Connor Dewar,C,TOR,25,0,0,0,0
11,8480848,Ty Dellandrea,C,DAL,24,0,0,0,0
11,8476884,Derrick Pouliot,D,DAL,30,0,0,0,0
11,8480025,MacKenzie Entwistle,R,CHI,25,0,0,0,0
11,8474612,Travis Hamonic,D,OTT,34,0,0,0,0
11,8479336,Carl Grundstrom,R,LAK,27,0,0,0,0
11,8482964,Arber Xhekaj,D,MTL,23,0,0,0,0
11,8471686,Marc Staal,D,PHI,37,0,0,0,0
11,8477887,Patrick Brown,C,BOS,32,0,0,0,0
11,8478495,Denis Gurianov,R,PHI,27,0,0,0,0
11,8481550,Adam Beckman,L,MIN,23,0,0,0,0
11,8480845,Rasmus Kupari,C,WPG,24,0,0,0,0
11,8478585,Derek Ryan,C,EDM,38,0,0,0,0
11,8482141,Lukas Cormier,D,VGK,22,0,0,0,0
11,8477962,Brendan Lemieux,L,CAR,28,0,0,0,0
11,8482861,Vincent Iorio,D,WSH,22,0,0,0,0
11,8479378,Logan Stanley,D,WPG,26,0,0,0,0
11,8473446,Erik Johnson,D,PHI,36,0,0,0,0
11,8481743,Marc Del Gaizo,D,NSH,25,0,0,0,0
11,8478450,Parker Wotherspoon,D,BOS,27,0,0,0,0
11,8477384,Josh Brown,D,ARI,30,0,0,0,0
11,8482165,Yan Kuznetsov,D,CGY,22,0,0,0,0
11,8478424,Jansen Harkins,C,PIT,27,0,0,0,0
11,8482144,Jack Thompson,D,SJS,22,0,0,0,0
11,8479576,Vincent Desharnais,D,EDM,28,0,0,0,0
11,8478512,Austin Czarnik,C,DET,32,0,0,0,0
11,8477527,Ross Johnston,L,ANA,30,0,0,0,0
11,8482094,Daemon Hunt,D,MIN,22,0,0,0,0
11,8481719,Maxwell Crozier,D,TBL,24,0,0,0,0
11,8480192,Johnathan Kovacevic,D,MTL,27,0,0,0,0
11,8479376,Victor Mete,D,PHI,26,0,0,0,0
11,8482511,Mason Lohrei,D,BOS,23,0,0,0,0
11,8478021,William Lagesson,D,ANA,28,0,0,0,0
11,8475795,Dylan McIlrath,D,WSH,32,0,0,0,0
11,8477846,Ryan Carpenter,C,SJS,33,0,0,0,0
11,8481056,Spencer Stastney,D,NSH,24,0,0,0,0
11,8481564,Ryan Johnson,D,BUF,23,0,0,0,0
11,8478017,Mark Friedman,D,VAN,29,0,0,0,0
11,8479320,Max Lajoie,D,TOR,27,0,0,0,0
11,8480075,Cameron Crotty,D,ARI,25,0,0,0,0
11,8484287,Cole McWard,D,VAN,23,0,0,0,0
11,8484254,Akito Hirose,D,VAN,25,0,0,0,0
11,8483407,Brandon Scanlin,D,NYR,25,0,0,0,0
11,8480274,Philip Kemp,D,EDM,25,0,0,0,0
11,8479522,Hardy Haman Aktell,D,WSH,26,0,0,0,0
11,8480007,Jonas Rondbjerg,R,VGK,25,0,0,0,0
11,8477454,Adam Erne,L,EDM,29,0,0,0,0
11,8481679,Maxence Guenette,D,OTT,23,0,0,0,0
11,8477938,Haydn Fleury,D,TBL,28,0,0,0,0
11,8476441,Joel Edmundson,D,TOR,31,0,0,0,0
11,8477903,Garnet Hathaway,R,PHI,33,0,0,0,0
11,8480441,Trey Fix-Wolansky,R,CBJ,25,0,0,0,0
11,8483546,Marshall Rifai,D,TOR,26,0,0,0,0
11,8480084,Nick DeSimone,D,NJD,30,0,0,0,0
11,8481592,Jakob Pelletier,L,CGY,23,0,0,0,0
11,8478011,Louie Belpedio,D,PHI,28,0,0,0,0
11,8477930,Pierre-Edouard Bellemare,L,SEA,39,0,0,0,0
11,8484321,Nikolas Matinpalo,D,OTT,26,0,0,0,0
11,8482067,Connor Mackey,D,NYR,28,0,0,0,0
11,8481806,Louis Crevier,D,CHI,23,0,0,0,0
11,8484326,Patrik Koch,D,ARI,28,0,0,0,0
11,8477971,Andreas Englund,D,LAK,28,0,0,0,0
11,8481751,Lukas Rousek,R,BUF,25,0,0,0,0
11,8481006,Tyler Tucker,D,STL,24,0,0,0,0
11,8481641,Joel Kiviranta,L,COL,28,0,0,0,0
11,8476867,Brendan Gaunce,C,CBJ,30,0,0,0,0
11,8479520,Brandon Duhaime,R,COL,27,0,0,0,0
11,8477073,Kurtis MacDermid,L,NJD,30,0,0,0,0
11,8480874,Adam Ginning,D,PHI,24,0,0,0,0
11,8477473,Justin Bailey,R,SJS,29,0,0,0,0
11,8479066,Ryan Lomberg,L,FLA,30,0,0,0,0
11,8477070,Liam O'Brien,C,ARI,30,0,0,0,0
11,8474618,Marco Scandella,D,STL,34,0,0,0,0
11,8475797,Jarred Tinordi,D,CHI,32,0,0,0,0
11,8481441,Joe Snively,C,WSH,28,0,0,0,0
11,8477244,Chad Ruhwedel,D,NYR,34,0,0,0,0
11,8482077,Dylan Holloway,L,EDM,23,0,0,0,0
11,8479772,Zack MacEwen,R,OTT,28,0,0,0,0
11,8481147,Reese Johnson,C,CHI,26,0,0,0,0
11,8481043,Cole Koepke,L,TBL,26,0,0,0,0
11,8483619,Filip Roos,D,CHI,25,0,0,0,0
11,8481541,Samuel Bolduc,D,NYI,24,0,0,0,0
11,8477810,Joel Hanley,D,CGY,33,0,0,0,0
11,8476907,Mackenzie MacEachern,L,STL,30,0,0,0,0
11,8482652,Walker Duehr,R,CGY,27,0,0,0,0
11,8477126,Jayson Megna,C,BOS,34,0,0,0,0
11,8483398,Declan Carlile,D,TBL,31,0,0,0,0
11,8482929,Emil Lilleberg,D,TBL,23,0,0,0,0
11,8480880,Jakub Lauko,C,BOS,24,0,0,0,0
11,8478874,Adam Gaudette,C,STL,28,0,0,0,0
11,8480245,Olle Lycksell,R,PHI,25,0,0,0,0
11,8480252,Cole Guttman,C,CHI,25,0,0,0,0
11,8477467,Gustav Olofsson,D,SEA,30,0,0,0,0
11,8479968,Vinni Lettieri,C,MIN,29,0,0,0,0
11,8478400,Colin White,C,MTL,27,0,0,0,0
11,8475755,Alexander Petrovic,D,DAL,32,0,0,0,0
11,8481812,Nikolai Knyzhov,D,SJS,27,0,0,0,0
11,8481593,Jayden Struble,D,MTL,23,0,0,0,0
11,8481532,Alex Turcotte,C,LAK,23,0,0,0,0
11,8482126,Emil Andrae,D,PHI,31,0,0,0,0
11,8479944,Zach Aston-Reese,C,DET,30,0,0,0,0
11,8471817,Ryan Reaves,R,TOR,37,0,0,0,0
11,8481206,John Ludvig,D,PIT,24,0,0,0,0
11,8480292,Carson Meyer,R,CBJ,27,0,0,0,0
11,8482496,Nils Aman,C,VAN,24,0,0,0,0
11,8479718,Alex Barré-Boulet,C,TBL,27,0,0,0,0
11,8479994,Jaret Anderson-Dolan,C,NSH,25,0,0,0,0
11,8480184,Gustav Lindstrom,D,ANA,26,0,0,0,0
11,8480890,Jan Jenik,R,ARI,24,0,0,0,0
11,8478067,Oskar Lindblom,L,SJS,28,0,0,0,0
11,8476934,Brock McGinn,L,ANA,30,0,0,0,0
11,8479985,Cale Fleury,D,SEA,26,0,0,0,0
11,8482153,Brendan Brisson,C,VGK,23,0,0,0,0
11,8480021,Jack Studnicka,C,SJS,25,0,0,0,0
11,8484304,Uvis Balinskis,D,FLA,28,0,0,0,0
11,8479981,Jonah Gadjovich,L,FLA,26,0,0,0,0
11,8481716,Dmitri Voronkov,L,CBJ,24,0,0,0,0
11,8482659,Josh Doan,R,ARI,22,0,0,0,0
11,8481122,Simon Benoit,D,TOR,26,0,0,0,0
11,8474709,Matt Martin,L,NYI,35,0,0,0,0
11,8482634,Alex Steeves,C,TOR,25,0,0,0,0
11,8480823,Alexander Alexeyev,D,WSH,25,0,0,0,0
11,8477541,Dakota Mermis,D,MIN,30,0,0,0,0
11,8478477,Mitchell Stephens,C,MTL,27,0,0,0,0
11,8481543,Nikita Alexandrov,C,STL,24,0,0,0,0
11,8482451,Mikael Pyyhtia,L,CBJ,23,0,0,0,0
11,8480306,Grant Hutton,D,NYI,29,0,0,0,0
11,8478028,Fredrik Olofsson,L,COL,28,0,0,0,0
11,8477462,Robert Hagg,D,ANA,29,0,0,0,0
11,8477320,Anton Blidh,L,NYR,29,0,0,0,0
11,8482749,Joshua Roy,R,MTL,21,0,0,0,0
11,8482157,Will Cuylle,L,NYR,22,0,0,0,0
11,8481239,Samuel Fagemo,L,LAK,24,0,0,0,0
11,8481600,Tobias Bjornfot,D,FLA,23,0,0,0,0
11,8478409,Anthony Richard,C,BOS,28,0,0,0,0
11,8474145,Robert Bortuzzo,D,NYI,35,0,0,0,0
11,8475958,Michael Sgarbossa,C,WSH,32,0,0,0,0
11,8479986,Kole Lind,R,SEA,26,0,0,0,0
11,8479249,Andrew Poturalski,C,SEA,30,0,0,0,0
11,8479362,Riley Tufte,L,COL,26,0,0,0,0
11,8479991,Jake Leschyshyn,C,NYR,25,0,0,0,0
11,8479587,Rhett Gardner,C,PHI,28,0,0,0,0
11,8482744,James Malatesta,L,CBJ,21,0,0,0,0
11,8478854,Ryan Shea,D,PIT,27,0,0,0,0
11,8481591,Sam Poulin,R,PIT,23,0,0,0,0
11,8483512,Matt Savoie,C,BUF,20,0,0,0,0
11,8482102,Vasily Ponomarev,C,CAR,22,0,0,0,0
11,8482162,Roby Jarventie,L,OTT,22,0,0,0,0
11,8482172,Landon Slaggert,L,CHI,22,0,0,0,0
11,8482747,Brennan Othmann,L,NYR,21,0,0,0,0
11,8480226,Marián Studenic,R,SEA,26,0,0,0,0
11,8481518,Nolan Foote,L,NJD,24,0,0,0,0
11,8479419,Brett Murray,L,BUF,26,0,0,0,0
11,8482088,Justin Sourdif,R,FLA,22,0,0,0,0
11,8482201,Gage Goncalves,C,TBL,23,0,0,0,0
11,8481754,Nikita Nesterenko,C,ANA,23,0,0,0,0
11,8483531,Brian Halonen,L,NJD,25,0,0,0,0
11,8483920,Pierrick Dube,R,WSH,23,0,0,0,0
11,8480851,Akil Thomas,C,LAK,24,0,0,0,0
11,8475235,Nicolas Deslauriers,L,PHI,33,0,0,0,0
11,8482476,Emil Heineman,L,MTL,23,0,0,0,0
11,8477149,Scott Sabourin,R,SJS,32,0,0,0,0
11,8483549,Lucas Condotta,L,MTL,27,0,0,0,0
11,8483567,Georgii Merkulov,C,BOS,24,0,0,0,0
11,8482765,Isak Rosen,R,BUF,21,0,0,0,0
11,8481237,Kyle MacLean,C,NYI,25,0,0,0,0
11,8481024,Linus Karlsson,C,VAN,25,0,0,0,0
11,8481690,Tyler Angle,C,CBJ,24,0,0,0,0
11,8483570,Ben Meyers,C,ANA,26,0,0,0,0
11,8481655,Cole Schwindt,R,CGY,23,0,0,0,0
11,8481462,Mason Morelli,L,VGK,28,0,0,0,0
11,8483401,Marc Johnstone,R,PIT,28,0,0,0,0
11,8478956,Samuel Laberge,L,NJD,27,0,0,0,0
11,8479533,Joona Koppanen,L,PIT,26,0,0,0,0
11,8482197,Adam Raska,R,MIN,23,0,0,0,0
11,8482250,Callahan Burke,C,CAR,27,0,0,0,0
11,8482784,Zach Dean,C,STL,21,0,0,0,0
11,8484255,Jason Polin,R,COL,25,0,0,0,0
11,8481077,John Leonard,L,ARI,26,0,0,0,0
11,8481534,Raphael Lavoie,C,EDM,24,0,0,0,0
11,8483609,Adam Klapka,R,CGY,24,0,0,0,0
11,8482751,Ryan Winterton,C,SEA,21,0,0,0,0
11,8480267,Sammy Walker,C,MIN,25,0,0,0,0
11,8475766,Austin Watson,L,TBL,32,0,0,0,0
11,8482460,Matt Rempe,C,NYR,22,0,0,0,0
11,8482787,Nikita Chibrikov,R,WPG,31,0,0,0,0
11,8481065,Angus Crookshank,L,OTT,25,0,0,0,0
11,8481070,Hugh McGing,L,STL,26,0,0,0,0
11,8476323,Max McCormick,L,SEA,32,0,0,0,0
11,8483395,Arshdeep Bains,L,VAN,23,0,0,0,0
11,8484259,Ondrej Pavel,C,COL,31,0,0,0,0
11,8483432,Luca Del Bel Belluz,C,CBJ,31,0,0,0,0
11,8483045,Cameron Butler,R,CBJ,31,0,0,0,0
11,8482061,Brandon Biro,L,BUF,26,0,0,0,0
11,8477401,John Hayden,C,SEA,29,0,0,0,0
11,8475278,Byron Froese,C,VGK,33,0,0,0,0
11,8478446,Glenn Gawdin,C,ANA,27,0,0,0,0
11,8477993,Justin Kirkland,C,ARI,28,0,0,0,0
11,8482147,Jean-Luc Foudy,C,COL,22,0,0,0,0
11,8480032,Shane Bowers,C,NJD,25,0,0,0,0
11,8479330,Brandon Gignac,C,MTL,27,0,0,0,0
11,8480776,Sheldon Rempal,R,VGK,29,0,0,0,0
11,8475413,Justin Dowling,C,NJD,34,0,0,0,0
11,8481726,Adam Edstrom,C,NYR,24,0,0,0,0
11,8479638,Justin Brazeau,R,BOS,26,0,0,0,0
11,8480844,Grigori Denisenko,L,VGK,24,0,0,0,0
11,8474062,Riley Nash,C,NYR,35,0,0,0,0
11,8478147,Bokondji Imama,L,OTT,28,0,0,0,0
11,8478881,Brett Seney,L,CHI,28,0,0,0,0
11,8483630,Pavol Regenda,L,ANA,25,0,0,0,0
11,8480836,Jonathan Gruden,C,PIT,24,0,0,0,0
11,8484314,Jiri Smejkal,L,OTT,28,0,0,0,0
11,8475780,Chris Wagner,R,COL,33,0,0,0,0
11,8482070,Mitchell Chaffee,R,TBL,26,0,0,0,0
11,8479546,Oskar Steen,C,BOS,26,0,0,0,0
11,8483597,Milos Kelemen,L,ARI,25,0,0,0,0
11,8481789,Tye Kartye,L,SEA,23,0,0,0,0
11,8484325,Waltteri Merela,C,TBL,26,0,0,0,0
11,8479421,Jacob Moverare,D,LAK,26,0,0,0,0
11,8481585,Egor Afanasyev,L,NSH,23,0,0,0,0
11,8479547,Matthew Phillips,R,WSH,26,0,0,0,0
11,8479367,William Lockwood,R,FLA,26,0,0,0,0
11,8481422,Jacob Lucchini,C,MIN,29,0,0,0,0
11,8480468,James Hamblin,L,EDM,25,0,0,0,0
11,8480870,Bo Groulx,C,ANA,24,0,0,0,0
11,8478051,Max Willman,C,NJD,29,0,0,0,0
11,8481556,John Beecher,C,BOS,23,0,0,0,0
11,8478078,Rourke Chartier,C,OTT,28,0,0,0,0
12,8477492,Nathan MacKinnon,C,COL,29,82,51,82,133
12,8476453,Nikita Kucherov,R,TBL,31,82,36,93,129
12,8481559,Jack Hughes,C,NJD,23,82,49,77,126
12,8478402,Connor McDavid,C,EDM,27,82,32,93,125
12,8477934,Leon Draisaitl,C,EDM,29,82,40,72,112
12,8479318,Auston Matthews,C,TOR,27,82,56,50,106
12,8478864,Kirill Kaprizov,L,MIN,27,82,47,56,103
12,8477409,Carter Verhaeghe,C,FLA,29,82,53,48,101
12,8471675,Sidney Crosby,C,PIT,37,82,45,56,101
12,8478427,Sebastian Aho,C,CAR,27,82,38,61,99
12,8476468,J.T. Miller,C,VAN,31,82,41,57,98
12,8477493,Aleksander Barkov,C,FLA,29,82,38,60,98
12,8477404,Jake Guentzel,C,CAR,30,82,48,47,95
12,8479343,Clayton Keller,R,ARI,26,82,46,49,95
12,8474564,Steven Stamkos,C,TBL,34,82,46,49,95
12,8478550,Artemi Panarin,L,NYR,33,82,30,65,95
12,8480023,Robert Thomas,C,STL,25,82,23,72,95
12,8477949,Alex Tuch,R,BUF,28,82,22,73,95
12,8477956,David Pastrnak,R,BOS,28,82,48,46,94
12,8478420,Mikko Rantanen,R,COL,28,82,36,58,94
12,8480069,Cale Makar,D,COL,26,82,19,75,94
12,8478398,Kyle Connor,L,WPG,28,82,41,52,93
12,8482116,Tim Stützle,C,OTT,22,82,40,53,93
12,8477402,Pavel Buchnevich,L,STL,29,82,38,55,93
12,8480830,Andrei Svechnikov,R,CAR,24,82,36,57,93
12,8480012,Elias Pettersson,C,VAN,26,82,31,60,91
12,8478403,Jack Eichel,C,VGK,28,82,40,50,90
12,8479314,Matthew Tkachuk,L,FLA,27,82,33,56,89
12,8481557,Matt Boldy,L,MIN,23,82,33,56,89
12,8480002,Nico Hischier,C,NJD,25,82,32,57,89
12,8475166,John Tavares,C,TOR,34,82,27,59,86
12,8478445,Mathew Barzal,C,NYI,27,82,22,64,86
12,8481523,Kirby Dach,C,MTL,23,82,14,72,86
12,8475810,Bryan Rust,R,PIT,32,82,37,48,85
12,8476887,Filip Forsberg,L,NSH,30,82,44,40,84
12,8480800,Quinn Hughes,D,VAN,25,82,11,73,84
12,8477501,Valeri Nichushkin,R,COL,29,82,48,35,83
12,8477939,William Nylander,R,TOR,28,82,35,48,83
12,8475172,Nazem Kadri,C,CGY,34,82,29,54,83
12,8477946,Dylan Larkin,C,DET,28,82,40,42,82
12,8477940,Nikolaj Ehlers,L,WPG,28,82,34,48,82
12,8479420,Tage Thompson,C,BUF,27,82,46,35,81
12,8480801,Brady Tkachuk,L,OTT,25,82,42,39,81
12,8479337,Alex DeBrincat,R,DET,27,82,33,48,81
12,8476853,Morgan Rielly,D,TOR,30,82,10,71,81
12,8478414,Timo Meier,R,NJD,28,82,43,37,80
12,8480027,Jason Robertson,L,DAL,25,82,38,42,80
12,8476460,Mark Scheifele,C,WPG,31,82,28,52,80
12,8477476,Artturi Lehkonen,L,COL,29,82,33,46,79
12,8480865,Noah Dobson,D,NYI,24,82,15,64,79
12,8479407,Jesper Bratt,L,NJD,26,82,30,48,78
12,8474600,Roman Josi,D,NSH,34,82,16,62,78
12,8476539,Jonathan Marchessault,R,VGK,34,82,47,30,77
12,8477933,Sam Reinhart,C,FLA,29,82,34,43,77
12,8475765,Vladimir Tarasenko,R,FLA,33,82,28,49,77
12,8477942,Kevin Fiala,L,LAK,28,82,27,50,77
12,8479385,Jordan Kyrou,C,STL,26,82,35,41,76
12,8478440,Dylan Strome,C,WSH,27,82,32,44,76
12,8480208,Drake Batherson,R,OTT,26,82,31,45,76
12,8478439,Travis Konecny,R,PHI,27,82,22,54,76
12,8478010,Brayden Point,C,TBL,28,82,31,44,75
12,8475692,Mats Zuccarello,R,MIN,37,82,24,51,75
12,8479323,Adam Fox,D,NYR,26,82,20,55,75
12,8476389,Vincent Trocheck,C,NYR,31,82,32,42,74
12,8474141,Patrick Kane,R,DET,36,82,28,46,74
12,8480036,Miro Heiskanen,D,DAL,25,82,11,63,74
12,8482665,Matty Beniers,C,SEA,22,82,26,47,73
12,8477504,Josh Morrissey,D,WPG,29,82,10,63,73
12,8482093,Seth Jarvis,C,CAR,22,82,40,32,72
12,8477960,Adrian Kempe,R,LAK,28,82,31,41,72
12,8475913,Mark Stone,R,VGK,32,82,24,48,72
12,8476459,Mika Zibanejad,C,NYR,31,82,24,48,72
12,8478449,Roope Hintz,C,DAL,28,82,38,33,71
12,8478444,Brock Boeser,R,VAN,27,82,36,35,71
12,8476448,William Karlsson,C,VGK,31,82,30,41,71
12,8477951,Nick Schmaltz,C,ARI,28,82,21,50,71
12,8477494,Jonathan Drouin,L,COL,29,82,19,52,71
12,8480839,Rasmus Dahlin,D,BUF,24,82,17,54,71
12,8482078,Lucas Raymond,L,DET,22,82,24,45,69
12,8476905,Chandler Stephenson,C,VGK,30,82,20,49,69
12,8474590,John Carlson,D,WSH,34,82,19,50,69
12,8479999,Casey Mittelstadt,C,COL,26,82,23,45,68
12,8475167,Victor Hedman,D,TBL,34,82,19,49,68
12,8480039,Martin Necas,C,CAR,25,82,18,50,68
12,8475168,Matt Duchene,C,DAL,33,82,27,40,67
12,8478047,Michael Bunting,L,PIT,29,82,26,41,67
12,8474586,Jordan Eberle,R,SEA,34,82,24,43,67
12,8478493,Joel Eriksson Ek,C,MIN,27,82,32,34,66
12,8471215,Evgeni Malkin,C,PIT,38,82,28,38,66
12,8480018,Nick Suzuki,C,MTL,25,82,23,43,66
12,8478975,Mason Marchment,L,DAL,29,82,26,39,65
12,8473512,Claude Giroux,R,OTT,36,82,19,46,65
12,8476346,Johnny Gaudreau,L,CBJ,31,82,16,49,65
12,8477955,Jared McCann,L,SEA,28,82,28,36,64
12,8478873,Troy Terry,R,ANA,27,82,25,39,64
12,8477497,Sean Monahan,C,WPG,30,82,24,40,64
12,8481533,Trevor Zegras,C,ANA,23,82,20,44,64
12,8480434,Sean Durzi,D,ARI,26,82,14,50,64
12,8476456,Jonathan Huberdeau,C,CGY,31,82,12,52,64
12,8477500,Bo Horvat,C,NYI,29,82,32,31,63
12,8475786,Zach Hyman,L,EDM,32,82,30,33,63
12,8475726,Tyler Toffoli,C,WPG,32,82,30,33,63
12,8473986,Alex Killorn,L,ANA,35,82,21,42,63
12,8480803,Evan Bouchard,D,EDM,25,82,14,49,63
12,8477447,Shea Theodore,D,VGK,29,82,12,51,63
12,8475784,Jeff Skinner,C,BUF,32,82,31,31,62
12,8478401,Pavel Zacha,C,BOS,27,82,28,34,62
12,8478460,Zach Werenski,D,CBJ,27,82,16,46,62
12,8471724,Kris Letang,D,PIT,37,82,16,46,62
12,8471214,Alex Ovechkin,L,WSH,39,82,34,27,61
12,8477456,J.T. Compher,L,DET,29,82,26,35,61
12,8482097,Jack Quinn,R,BUF,23,82,21,40,61
12,8478462,Nicolas Roy,C,VGK,27,82,21,40,61
12,8478042,Viktor Arvidsson,R,LAK,31,82,20,41,61
12,8474150,Mikael Backlund,C,CGY,35,82,19,42,61
12,8476958,Jaccob Slavin,D,CAR,30,82,12,49,61
12,8476881,Tomas Hertl,C,VGK,31,82,27,33,60
12,8479542,Brandon Hagel,L,TBL,26,82,26,34,60
12,8478466,Daniel Sprong,R,DET,27,82,24,36,60
12,8475158,Ryan O'Reilly,C,NSH,33,82,22,38,60
12,8479345,Jakob Chychrun,D,OTT,26,82,19,41,60
12,8475197,Tyson Barrie,D,NSH,33,82,14,46,60
12,8471685,Anze Kopitar,C,LAK,37,82,13,47,60
12,8474565,Alex Pietrangelo,D,VGK,34,82,13,47,60
12,8478469,Thomas Chabot,D,OTT,27,82,12,48,60
12,8474578,Erik Karlsson,D,PIT,34,82,10,50,60
12,8476906,Shayne Gostisbehere,D,DET,31,82,9,51,60
12,8480014,Gabriel Vilardi,C,WPG,25,82,40,19,59
12,8482109,Alexis Lafrenière,L,NYR,23,82,28,31,59
12,8482124,Quinton Byfield,R,LAK,22,82,24,35,59
12,8477346,MacKenzie Weegar,D,CGY,30,82,15,44,59
12,8476438,Brandon Saad,L,STL,32,82,32,26,58
12,8479400,Pierre-Luc Dubois,L,LAK,26,82,31,27,58
12,8478366,Frank Vatrano,R,ANA,30,82,31,27,58
12,8474157,Max Pacioretty,L,WSH,36,82,29,29,58
12,8473419,Brad Marchand,L,BOS,36,82,21,37,58
12,8476454,Ryan Nugent-Hopkins,C,EDM,31,82,17,41,58
12,8481068,Yegor Sharangovich,C,CGY,26,82,27,30,57
12,8482159,Tyson Foerster,R,PHI,22,82,23,34,57
12,8477416,Oliver Bjorkstrand,R,SEA,29,82,21,36,57
12,8480064,Josh Norris,C,OTT,25,82,20,37,57
12,8473994,Jamie Benn,L,DAL,35,82,17,40,57
12,8481542,Moritz Seider,D,DET,23,82,11,46,57
12,8475169,Evander Kane,L,EDM,33,82,30,26,56
12,8482110,Dawson Mercer,C,NJD,23,82,29,27,56
12,8474102,David Perron,L,DET,36,82,23,33,56
12,8483515,Juraj Slafkovsky,L,MTL,20,82,21,35,56
12,8481711,Matias Maccelli,L,ARI,24,82,16,40,56
12,8476875,Mike Matheson,D,MTL,30,82,15,41,56
12,8483808,Andrei Kuzmenko,L,CGY,28,82,33,22,55
12,8475768,Jaden Schwartz,C,SEA,32,82,30,25,55
12,8481540,Cole Caufield,R,MTL,23,82,25,30,55
12,8479675,Trevor Moore,L,LAK,29,82,24,31,55
12,8482745,Mason McTavish,C,ANA,21,82,23,32,55
12,8470794,Joe Pavelski,C,DAL,40,82,21,34,55
12,8477503,Max Domi,C,TOR,29,82,19,36,55
12,8479325,Charlie McAvoy,D,BOS,27,82,10,45,55
12,8475794,Tyler Seguin,C,DAL,32,82,21,33,54
12,8473422,Nick Foligno,L,CHI,37,82,17,37,54
12,8476462,Dougie Hamilton,D,NJD,31,82,15,39,54
12,8470613,Brent Burns,D,CAR,39,82,14,40,54
12,8477479,Tyler Bertuzzi,L,TOR,29,82,31,22,53
12,8481528,Dylan Cozens,C,BUF,23,82,24,29,53
12,8480797,Joel Farabee,L,PHI,24,82,23,30,53
12,8477496,Elias Lindholm,C,VAN,30,82,21,32,53
12,8475744,Evgeny Kuznetsov,C,CAR,32,82,18,35,53
12,8475798,Mikael Granlund,C,SJS,32,82,12,41,53
12,8475184,Chris Kreider,L,NYR,33,82,33,19,52
12,8475793,Ryan Johansen,C,PHI,32,82,27,25,52
12,8474641,Adam Henrique,C,EDM,34,82,24,28,52
12,8477935,Sam Bennett,C,FLA,28,82,20,32,52
12,8476882,Teuvo Teravainen,L,CAR,30,82,18,34,52
12,8479992,Michael Rasmussen,C,DET,25,82,18,34,52
12,8478438,Tommy Novak,C,NSH,27,82,17,35,52
12,8477986,Brandon Montour,D,FLA,30,82,17,35,52
12,8475753,Justin Faulk,D,STL,32,82,14,38,52
12,8477495,Seth Jones,D,CHI,30,82,12,40,52
12,8478055,Gustav Forsling,D,FLA,28,82,11,41,52
12,8480015,Owen Tippett,R,PHI,25,82,25,26,51
12,8477511,Anthony Mantha,R,VGK,30,82,25,26,51
12,8475191,Reilly Smith,R,PIT,33,82,24,27,51
12,8479425,Filip Hronek,D,VAN,27,82,13,38,51
12,8475754,Brock Nelson,C,NYI,33,82,26,24,50
12,8478057,Dakota Joshua,C,VAN,28,82,19,31,50
12,8477964,Ivan Barbashev,C,VGK,29,82,19,31,50
12,8478458,Jack Roslovic,C,NYR,27,82,17,33,50
12,8478397,Rasmus Andersson,D,CGY,28,82,13,37,50
12,8476869,Brady Skjei,D,CAR,30,82,9,41,50
12,8478233,Andrew Mangiapane,L,CGY,28,82,26,23,49
12,8478856,Conor Garland,R,VAN,28,82,25,24,49
12,8476399,Blake Coleman,C,CGY,33,82,22,27,49
12,8473449,Kyle Okposo,R,FLA,36,82,21,28,49
12,8481596,Shane Pinto,C,OTT,24,82,18,31,49
12,8480078,Filip Chytil,C,NYR,25,82,16,33,49
12,8475763,Kevin Hayes,R,STL,32,82,10,39,49
12,8482740,Wyatt Johnston,C,DAL,21,82,31,17,48
12,8480188,Fabian Zetterlund,L,SJS,25,82,19,29,48
12,8478474,Lawson Crouse,L,ARI,27,82,19,29,48
12,8477407,Anthony Duclair,L,TBL,29,82,18,30,48
12,8478542,Evan Rodrigues,C,FLA,31,82,15,33,48
12,8476483,Rickard Rakell,R,PIT,31,82,25,22,47
12,8484144,Connor Bedard,C,CHI,19,82,23,24,47
12,8479525,Ross Colton,C,COL,28,82,23,24,47
12,8477451,Ryan Hartman,R,MIN,30,82,22,25,47
12,8476872,Scott Laughton,C,PHI,30,82,21,26,47
12,8474679,Gustav Nyquist,C,NSH,35,82,20,27,47
12,8479987,Morgan Geekie,C,BOS,26,82,20,27,47
12,8476826,Yanni Gourde,C,SEA,33,82,19,28,47
12,8475760,Nick Bjugstad,C,ARI,32,82,19,28,47
12,8478396,Noah Hanifin,D,VGK,27,82,13,34,47
12,8477932,Aaron Ekblad,D,FLA,28,82,13,34,47
12,8482105,Jake Sanderson,D,OTT,22,82,12,35,47
12,8482684,Luke Hughes,D,NJD,21,82,8,39,47
12,8475170,Brayden Schenn,C,STL,33,82,22,24,46
12,8482699,Dylan Guenther,R,ARI,21,82,19,27,46
12,8482720,Matthew Knies,L,TOR,22,82,18,28,46
12,8480798,Philipp Kurashev,C,CHI,25,82,14,32,46
12,8476880,Tom Wilson,R,WSH,30,82,25,20,45
12,8480849,Barrett Hayton,C,ARI,24,82,24,21,45
12,8480009,Eeli Tolvanen,R,SEA,25,82,22,23,45
12,8480068,Ryan Poehling,C,PHI,25,82,21,24,45
12,8482113,Anton Lundell,C,FLA,23,82,17,28,45
12,8476792,Torey Krug,D,STL,33,82,17,28,45
12,8481703,Valtteri Puustinen,R,PIT,25,82,12,33,45
12,8478038,Devon Toews,D,COL,30,82,7,38,45
12,8479410,Mikhail Sergachev,D,TBL,26,82,6,39,45
12,8479339,Patrik Laine,L,CBJ,26,82,26,18,44
12,8477952,Robby Fabbri,C,DET,28,82,24,20,44
12,8475714,Calle Jarnkrok,C,TOR,33,82,23,21,44
12,8482079,Marco Rossi,C,MIN,23,82,23,21,44
12,8481656,Aliaksei Protas,C,WSH,23,82,22,22,44
12,8477429,Andrew Copp,C,DET,30,82,18,26,44
12,8482092,Ridly Greig,C,OTT,22,82,17,27,44
12,8476392,Adam Lowry,C,WPG,31,82,14,30,44
12,8476461,Sean Couturier,C,PHI,32,82,13,31,44
12,8478407,Vince Dunn,D,SEA,28,82,12,32,44
12,8477021,Alex Kerfoot,C,ARI,30,82,12,32,44
12,8474563,Drew Doughty,D,LAK,35,82,11,33,44
12,8476854,Hampus Lindholm,D,BOS,30,82,3,41,44
12,8482475,Yegor Chinakhov,R,CBJ,23,82,20,23,43
12,8482222,Alexander Barabanov,L,SJS,30,82,16,27,43
12,8480336,Sean Walker,D,COL,30,82,15,28,43
12,8481481,Blake Lizotte,C,LAK,27,82,14,29,43
12,8476419,Jean-Gabriel Pageau,C,NYI,32,82,13,30,43
12,8480028,Morgan Frost,C,PHI,25,82,12,31,43
12,8476923,Damon Severson,D,CBJ,30,82,7,36,43
12,8477969,Marcus Pettersson,D,PIT,28,82,6,37,43
12,8478498,Jake DeBrusk,L,BOS,28,82,25,17,42
12,8482175,JJ Peterka,R,BUF,22,82,24,18,42
12,8476432,Boone Jenner,C,CBJ,31,82,23,19,42
12,8482146,Luke Evangelista,R,NSH,22,82,19,23,42
12,8470610,Zach Parise,L,COL,40,82,18,24,42
12,8480220,Noah Cates,L,PHI,25,82,15,27,42
12,8476329,Travis Boyd,C,ARI,31,82,10,32,42
12,8481581,Thomas Harley,D,DAL,23,82,9,33,42
12,8475906,John Klingberg,D,TOR,32,82,8,34,42
12,8471698,T.J. Oshie,R,WSH,38,82,20,21,41
12,8480185,Eetu Luostarinen,C,FLA,26,82,19,22,41
12,8476480,Vladislav Namestnikov,C,WPG,32,82,19,22,41
12,8476292,Ondrej Palat,L,NJD,33,82,16,25,41
12,8477444,Andre Burakovsky,L,SEA,29,82,15,26,41
12,8473563,Nicklas Backstrom,C,WSH,37,82,14,27,41
12,8479415,Michael McLeod,C,NJD,26,82,12,29,41
12,8480145,Neal Pionk,D,WPG,29,82,10,31,41
12,8475151,Kyle Palmieri,C,NYI,33,82,24,16,40
12,8475287,Erik Haula,L,NJD,33,82,16,24,40
12,8482667,William Eklund,L,SJS,22,82,10,30,40
12,8481546,Cam York,D,PHI,23,82,10,30,40
12,8480873,Rasmus Sandin,D,WSH,24,82,2,38,40
12,8482089,Jake Neighbours,L,STL,22,82,27,12,39
12,8473533,Jordan Staal,C,CAR,36,82,23,16,39
12,8480459,Pius Suter,C,VAN,28,82,22,17,39
12,8477989,Christian Dvorak,C,MTL,28,82,18,21,39
12,8482111,Justin Barron,D,MTL,23,82,14,25,39
12,8475745,Charlie Coyle,C,BOS,32,82,13,26,39
12,8475791,Taylor Hall,L,CHI,33,82,13,26,39
12,8482671,Owen Power,D,BUF,22,82,12,27,39
12,8476892,Colton Parayko,D,STL,31,82,6,33,39
12,8476525,Colin Miller,D,WPG,32,82,4,35,39
12,8477426,Nicholas Paul,L,TBL,29,82,20,18,38
12,8476921,Jordan Martinook,L,CAR,32,82,19,19,38
12,8481013,Jonatan Berggren,R,DET,24,82,17,21,38
12,8476479,Phillip Danault,C,LAK,31,82,16,22,38
12,8477919,Frederick Gaudreau,C,MIN,31,82,14,24,38
12,8480043,Timothy Liljegren,D,TOR,25,82,12,26,38
12,8477948,Travis Sanheim,D,PHI,28,82,11,27,38
12,8482062,Cole Smith,L,NSH,29,82,23,14,37
12,8479390,Taylor Raddysh,R,CHI,26,82,20,17,37
12,8478115,Pierre Engvall,L,NYI,28,82,20,17,37
12,8471218,Blake Wheeler,R,NYR,38,82,18,19,37
12,8484153,Leo Carlsson,C,ANA,20,82,18,19,37
12,8477953,Kasperi Kapanen,R,STL,28,82,16,21,37
12,8479365,Trent Frederic,C,BOS,26,82,14,23,37
12,8474037,James van Riemsdyk,L,BOS,35,82,14,23,37
12,8475164,Jakob Silfverberg,R,ANA,34,82,13,24,37
12,8482055,Drew O'Connor,L,PIT,26,82,12,25,37
12,8480871,Adam Boqvist,D,CBJ,24,82,11,26,37
12,8475799,Nino Niederreiter,R,WPG,32,82,25,11,36
12,8478020,Michael Amadio,C,VGK,28,82,23,13,36
12,8481535,Nils Hoglander,L,VAN,24,82,21,15,36
12,8482705,Cole Sillinger,C,CBJ,21,82,16,20,36
12,8478463,Anthony Beauvillier,L,NSH,27,82,15,21,36
12,8470621,Corey Perry,R,EDM,39,82,15,21,36
12,8480113,Alex Iafallo,L,WPG,31,82,15,21,36
12,8477425,Miles Wood,L,COL,29,82,15,21,36
12,8482125,Alexander Holtz,R,NJD,22,82,15,21,36
12,8477498,Darnell Nurse,D,EDM,29,82,12,24,36
12,8477507,Nikita Zadorov,D,VAN,29,82,12,24,36
12,8477947,Sonny Milano,L,WSH,28,82,11,25,36
12,8474151,Ryan McDonagh,D,NSH,35,82,6,30,36
12,8478046,Danton Heinen,L,BOS,29,82,20,15,35
12,8476469,Joel Armia,R,MTL,31,82,20,15,35
12,8481553,Bobby Brink,R,PHI,23,82,16,19,35
12,8478519,Anthony Cirelli,C,TBL,27,82,15,20,35
12,8476458,Ryan Strome,C,ANA,31,82,15,20,35
12,8478413,Jordan Greenway,L,BUF,27,82,14,21,35
12,8481618,Alex Newhook,C,MTL,23,82,12,23,35
12,8478891,Mason Appleton,C,WPG,28,82,12,23,35
12,8477506,Ryan Pulock,D,NYI,30,82,12,23,35
12,8474716,Jared Spurgeon,D,MIN,35,82,11,24,35
12,8481606,Jordan Spence,D,LAK,23,82,9,26,35
12,8476463,Jonas Brodin,D,MIN,31,82,8,27,35
12,8477944,Jakub Vrana,L,STL,28,82,17,17,34
12,8477998,Warren Foegele,L,EDM,28,82,16,18,34
12,8474870,Tyler Johnson,C,CHI,34,82,15,19,34
12,8475343,Nic Dowd,C,WSH,34,82,13,21,34
12,8478472,Mathieu Joseph,R,OTT,27,82,12,22,34
12,8476885,Jacob Trouba,D,NYR,30,82,12,22,34
12,8483482,Tristan Luneau,D,ANA,20,82,12,22,34
12,8476927,Teddy Blueger,C,VAN,30,82,8,26,34
12,8475218,Mattias Ekholm,D,EDM,34,82,6,28,34
12,8479383,Boris Katchouk,L,OTT,26,82,17,16,33
12,8474149,Evgenii Dadonov,R,DAL,35,82,16,17,33
12,8480821,Filip Zadina,R,SJS,25,82,16,17,33
12,8482133,Thomas Bordeleau,C,SJS,22,82,10,23,33
12,8479359,Beck Malenstyn,L,WSH,26,82,7,26,33
12,8477220,Nate Schmidt,D,WPG,33,82,6,27,33
12,8475764,Cam Fowler,D,ANA,33,82,5,28,33
12,8481186,Logan O'Connor,R,COL,28,82,20,12,32
12,8475314,Anders Lee,L,NYI,34,82,19,13,32
12,8475848,Brendan Gallagher,R,MTL,32,82,18,14,32
12,8480893,Kirill Marchenko,R,CBJ,24,82,17,15,32
12,8480802,Ryan McLeod,C,EDM,25,82,17,15,32
12,8481624,Ilya Mikheyev,R,VAN,30,82,13,19,32
12,8479514,Rem Pitlick,C,CHI,27,82,10,22,32
12,8477488,Brett Pesce,D,CAR,30,82,8,24,32
12,8481568,Alex Vlasic,D,CHI,23,82,6,26,32
12,8478569,Noel Acciari,C,PIT,33,82,19,12,31
12,8481704,Juuso Parssinen,C,NSH,23,82,17,14,31
12,8474715,Cam Atkinson,R,PHI,35,82,16,15,31
12,8475722,Jason Zucker,L,NSH,32,82,15,16,31
12,8479351,Sam Steel,C,DAL,26,82,13,18,31
12,8481554,Kaapo Kakko,R,NYR,23,82,13,18,31
12,8479293,Brandon Tanev,L,SEA,33,82,12,19,31
12,8478013,Jake Walman,D,DET,28,82,12,19,31
12,8476931,Jake McCabe,D,TOR,31,82,10,21,31
12,8481560,Arthur Kaliyev,R,LAK,23,82,15,15,30
12,8479941,Justin Danforth,R,CBJ,31,82,14,16,30
12,8474053,Logan Couture,C,SJS,35,82,11,19,30
12,8483490,Pavel Mintyukov,D,ANA,21,82,8,22,30
12,8475171,Oliver Ekman-Larsson,D,FLA,33,82,5,25,30
12,8475181,Nick Leddy,D,STL,33,82,3,27,30
12,8476981,Josh Anderson,R,MTL,30,82,19,10,29
12,8478508,Yakov Trenin,C,COL,27,82,17,12,29
12,8477330,Dominik Kubalik,L,OTT,29,82,14,15,29
12,8477450,Jason Dickinson,C,CHI,29,82,14,15,29
12,8474189,Lars Eller,C,PIT,35,82,14,15,29
12,8480806,Isac Lundestrom,C,ANA,25,82,14,15,29
12,8475149,Marcus Johansson,L,MIN,34,82,10,19,29
12,8478109,Victor Olofsson,L,BUF,29,82,10,19,29
12,8481522,Peyton Krebs,C,BUF,23,82,10,19,29
12,8476897,Oskar Sundqvist,C,STL,30,82,10,19,29
12,8479393,Noah Gregor,C,TOR,26,82,9,20,29
12,8483457,Lane Hutson,D,MTL,20,82,8,21,29
12,8478133,Jake Evans,C,MTL,28,82,8,21,29
12,8476902,Esa Lindell,D,DAL,30,82,7,22,29
12,8482624,Daniil Miromanov,D,CGY,27,82,7,22,29
12,8479996,Cody Glass,C,NSH,25,82,7,22,29
12,8474673,TJ Brodie,D,TOR,34,82,6,23,29
12,8482087,Kaiden Guhle,D,MTL,22,82,5,24,29
12,8481604,Pavel Dorofeyev,L,VGK,24,82,13,15,28
12,8480144,David Kampf,C,TOR,29,82,12,16,28
12,8476960,Andreas Athanasiou,C,CHI,30,82,9,19,28
12,8477435,Ryan Graves,D,PIT,29,82,8,20,28
12,8479353,Brett Howden,C,VGK,26,82,7,21,28
12,8476467,Jamie Oleksiak,D,SEA,32,82,5,23,28
12,8482142,Jamie Drysdale,D,PHI,22,82,5,23,28
12,8476879,Cody Ceci,D,EDM,31,82,5,23,28
12,8482122,Brock Faber,D,MIN,22,82,4,24,28
12,8476979,Erik Gustafsson,D,NYR,32,82,4,24,28
12,8479316,Luke Kunin,C,SJS,27,82,16,11,27
12,8476873,Mark Jankowski,C,NSH,30,82,15,12,27
12,8481477,Nico Sturm,C,SJS,29,82,14,13,27
12,8477839,Conor Sheary,L,TBL,32,82,13,14,27
12,8482117,Lukas Reichel,L,CHI,22,82,11,16,27
12,8476925,Colton Sissons,C,NSH,31,82,9,18,27
12,8480073,Erik Brannstrom,D,OTT,25,82,4,23,27
12,8478840,Will Borgen,D,SEA,28,82,4,23,27
12,8481014,Alexander Romanov,D,NYI,24,82,3,24,27
12,8480035,Henri Jokiharju,D,BUF,25,82,1,26,27
12,8476278,Colin Blackwell,C,CHI,31,82,16,10,26
12,8479591,Michael Eyssimont,C,TBL,28,82,12,14,26
12,8476871,Tanner Pearson,L,MTL,32,82,11,15,26
12,8481580,Connor McMichael,C,WSH,23,82,10,16,26
12,8475200,Dmitry Orlov,D,CAR,33,82,10,16,26
12,8484203,Bradly Nadeau,L,CAR,19,82,9,17,26
12,8478911,Matt Roy,D,LAK,29,82,7,19,26
12,8480817,K'Andre Miller,D,NYR,24,82,7,19,26
12,8482245,Artem Zub,D,OTT,29,82,5,21,26
12,8476891,Matt Grzelcyk,D,BOS,30,82,3,23,26
12,8476331,Dylan DeMelo,D,WPG,31,82,2,24,26
12,8475179,Dmitry Kulikov,D,FLA,34,82,2,24,26
12,8480448,Parker Kelly,L,OTT,25,82,17,8,25
12,8481517,Brett Leason,R,ANA,25,82,14,11,25
12,8480855,Jack McBain,C,ARI,24,82,12,13,25
12,8479346,Dillon Dube,C,CGY,26,82,9,16,25
12,8478430,Oliver Kylington,D,CGY,27,82,5,20,25
12,8479369,Andrew Peeke,D,BOS,26,82,2,23,25
12,8481093,Rafael Harvey-Pinard,L,MTL,25,82,15,9,24
12,8482259,Bobby McMann,C,TOR,28,82,14,10,24
12,8479661,Tanner Jeannot,L,TBL,27,82,13,11,24
12,8474009,Nick Bonino,C,NYR,36,82,13,11,24
12,8481601,Simon Holmstrom,R,NYI,23,82,13,11,24
12,8482166,Shakir Mukhamadullin,D,SJS,22,82,12,12,24
12,8480995,Pontus Holmberg,R,TOR,25,82,11,13,24
12,8477369,Carson Soucy,D,VAN,30,82,11,13,24
12,8476878,Zemgus Girgensons,L,BUF,30,82,10,14,24
12,8482712,Oskar Olausson,R,COL,22,82,9,15,24
12,8482807,Ethan Del Mastro,D,CHI,21,82,8,16,24
12,8482762,Simon Edvinsson,D,DET,21,82,6,18,24
12,8473507,Jeff Petry,D,DET,37,82,4,20,24
12,8479976,Juuso Valimaki,D,ARI,26,82,3,21,24
12,8476457,Adam Larsson,D,SEA,32,82,2,22,24
12,8481059,Scott Perunovich,D,STL,26,82,1,23,24
12,8484145,Zach Benson,L,BUF,19,82,13,10,23
12,8476374,Sean Kuraly,C,CBJ,31,82,12,11,23
12,8483763,Maksymilian Szuber,D,ARI,22,82,12,11,23
12,8474884,Mike Hoffman,C,SJS,35,82,11,12,23
12,8478043,Sam Lafferty,C,VAN,29,82,11,12,23
12,8477406,Mattias Janmark,C,EDM,32,82,10,13,23
12,8476442,Matt Nieto,L,PIT,32,82,10,13,23
12,8479977,Kailer Yamamoto,R,SEA,26,82,8,15,23
12,8475279,Ben Chiarot,D,DET,33,82,6,17,23
12,8475462,Radko Gudas,D,ANA,34,82,5,18,23
12,8477505,Alexander Wennberg,C,NYR,30,82,12,10,22
12,8481028,Martin Pospisil,C,CGY,25,82,8,14,22
12,8479324,Ryan Lindgren,D,NYR,26,82,6,16,22
12,8478178,Darren Raddysh,D,TBL,28,82,5,17,22
12,8483445,Cutter Gauthier,L,ANA,20,82,5,17,22
12,8478851,Alexandre Carrier,D,NSH,28,82,4,18,22
12,8475790,Erik Gudbranson,D,CBJ,32,82,2,20,22
12,8480074,Alexandre Texier,C,CBJ,25,82,13,8,21
12,8480281,Alexey Toropchenko,R,STL,25,82,12,9,21
12,8477392,Hudson Fasching,R,NYI,29,82,11,10,21
12,8482666,Scott Morrow,D,CAR,22,82,10,11,21
12,8477353,Tyler Motte,C,TBL,29,82,9,12,21
12,8484166,Adam Fantilli,C,CBJ,20,82,9,12,21
12,8475220,Marcus Foligno,L,MIN,33,82,7,14,21
12,8479983,Mario Ferraro,D,SJS,26,82,7,14,21
12,8480796,Martin Fehervary,D,WSH,25,82,5,16,21
12,8475233,David Savard,D,MTL,34,82,5,16,21
12,8479998,Mikey Anderson,D,LAK,25,82,4,17,21
12,8480246,Nick Perbix,D,TBL,26,82,3,18,21
12,8479398,Samuel Girard,D,COL,26,82,1,20,21
12,8483431,Logan Cooley,C,ARI,20,82,15,5,20
12,8480813,Joe Veleno,C,DET,24,82,9,11,20
12,8481524,Bowen Byram,D,BUF,23,82,9,11,20
12,8482074,Connor Zary,C,CGY,23,82,8,12,20
12,8483493,Frank Nazar,C,CHI,20,82,8,12,20
12,8482809,Jackson Blake,R,CAR,21,82,7,13,20
12,8477499,Rasmus Ristolainen,D,PHI,30,82,6,14,20
12,8482803,Olen Zellweger,D,ANA,21,82,6,14,20
12,8478882,Vladislav Gavrikov,D,LAK,29,82,5,15,20
12,8478500,Ivan Provorov,D,CBJ,27,82,4,16,20
12,8480172,Jan Rutta,D,SJS,34,82,4,16,20
12,8476312,Josh Manson,D,COL,33,82,3,17,20
12,8474574,Tyler Myers,D,VAN,34,82,3,17,20
12,8478136,Jake Middleton,D,MIN,28,82,2,18,20
12,8475690,Chris Tanev,D,DAL,35,82,2,18,20
12,8475842,Sam Carrick,C,EDM,32,82,13,6,19
12,8482679,Matt Coronato,R,CGY,22,82,13,6,19
12,8479291,Kevin Rooney,C,CGY,31,82,12,7,19
12,8482858,Ryker Evans,D,SEA,23,82,9,10,19
12,8475231,Casey Cizikas,C,NYI,33,82,9,10,19
12,8473504,Cal Clutterbuck,R,NYI,37,82,8,11,19
12,8470604,Jeff Carter,C,PIT,39,82,7,12,19
12,8483495,Simon Nemec,D,NJD,20,82,6,13,19
12,8483565,Nick Blankenburg,D,CBJ,26,82,3,16,19
12,8475208,Brian Dumoulin,D,SEA,33,82,3,16,19
12,8470600,Ryan Suter,D,DAL,39,82,3,16,19
12,8478399,Jonas Siegenthaler,D,NJD,27,82,3,16,19
12,8479980,Nicolas Hague,D,VGK,26,82,3,16,19
12,8478451,Ethan Bear,D,WSH,27,82,2,17,19
12,8475188,Brayden McNabb,D,VGK,33,82,2,17,19
12,8480058,Pierre-Olivier Joseph,D,PIT,25,82,0,19,19
12,8479423,Alex Nylander,L,CBJ,26,82,9,9,18
12,8483012,Logan Morrison,C,SEA,22,82,9,9,18
12,8476822,Luke Glendening,C,TBL,35,82,9,9,18
12,8478831,Kevin Stenlund,C,FLA,28,82,7,11,18
12,8482145,Mavrik Bourque,C,DAL,22,82,7,11,18
12,8473453,Trevor Lewis,C,LAK,37,82,6,12,18
12,8482655,J.J. Moser,D,ARI,24,82,5,13,18
12,8477845,Trevor van Riemsdyk,D,WSH,33,82,5,13,18
12,8482101,Danil Gushchin,L,SJS,22,82,5,13,18
12,8478507,John Marino,D,NJD,27,82,4,14,18
12,8476422,Mike Reilly,D,NYI,31,82,4,14,18
12,8481178,Egor Zamula,D,PHI,24,82,3,15,18
12,8474166,Alec Martinez,D,VGK,37,82,2,16,18
12,8476917,Adam Pelech,D,NYI,30,82,1,17,18
12,8482155,Alex Laferriere,R,LAK,23,82,11,6,17
12,8477015,Connor Brown,R,EDM,30,82,10,7,17
12,8483524,Shane Wright,C,SEA,20,82,9,8,17
12,8481016,Ruslan Iskhakov,C,NYI,24,82,9,8,17
12,8474034,Pat Maroon,L,BOS,36,82,8,9,17
12,8481578,Graeme Clarke,R,NJD,23,82,8,9,17
12,8478859,Niko Mikkola,D,FLA,28,82,5,12,17
12,8480807,Mattias Samuelsson,D,BUF,24,82,5,12,17
12,8482859,Zack Ostapchuk,C,OTT,21,82,5,12,17
12,8474567,Zach Bogosian,D,MIN,34,82,4,13,17
12,8480031,Maxime Comtois,L,CAR,25,82,4,13,17
12,8470966,Mark Giordano,D,TOR,41,82,3,14,17
12,8475455,Brenden Dillon,D,WPG,34,82,3,14,17
12,8476429,Scott Mayfield,D,NYI,32,82,2,15,17
12,8477508,Curtis Lazar,C,NJD,29,82,7,9,16
12,8476858,Phillip Di Giuseppe,L,VAN,31,82,7,9,16
12,8483505,Matthew Poitras,C,BOS,20,82,6,10,16
12,8481567,Henry Thrun,D,SJS,23,82,5,11,16
12,8477335,Kyle Burroughs,D,SJS,29,82,5,11,16
12,8479371,Dante Fabbro,D,NSH,26,82,3,13,16
12,8477365,Connor Clifton,D,BUF,29,82,3,13,16
12,8482733,Logan Mailloux,D,MTL,31,82,3,13,16
12,8475324,Nick Jensen,D,WSH,34,82,2,14,16
12,8480860,Kevin Bahl,D,NJD,24,82,0,16,16
12,8482702,Logan Stankoven,C,DAL,21,82,9,6,15
12,8482516,Matthew Kessel,D,STL,24,82,7,8,15
12,8482177,Marat Khusnutdinov,C,MIN,22,82,7,8,15
12,8483499,Liam Ohgren,L,MIN,20,82,6,9,15
12,8476967,Brett Kulak,D,EDM,30,82,6,9,15
12,8481030,Jack St. Ivany,D,PIT,25,82,5,10,15
12,8481599,Victor Soderstrom,D,ARI,23,82,3,12,15
12,8480990,Declan Chisholm,D,MIN,24,82,2,13,15
12,8483468,Jiri Kulich,C,BUF,20,82,7,7,14
12,8477931,Tomas Nosek,L,NJD,32,82,7,7,14
12,8484149,Gavin Brindley,C,CBJ,20,82,5,9,14
12,8481537,Nikita Okhotiuk,D,CGY,24,82,3,11,14
12,8480879,Jacob Bernard-Docker,D,OTT,24,82,3,11,14
12,8476624,Barclay Goodrow,C,NYR,31,82,7,6,13
12,8483491,Ivan Miroshnichenko,L,WSH,20,82,7,6,13
12,8484911,Collin Graf,R,SJS,22,82,7,6,13
12,8478416,Erik Cernak,D,TBL,27,82,6,7,13
12,8478468,Jeremy Lauzon,D,NSH,27,82,5,8,13
12,8477034,Jaycob Megna,D,CHI,32,82,4,9,13
12,8475825,Jani Hakanpää,D,DAL,32,82,3,10,13
12,8483466,Kevin Korchinski,D,CHI,20,82,2,11,13
12,8471677,Jack Johnson,D,COL,37,82,2,11,13
12,8481699,Aku Raty,R,ARI,23,82,6,6,12
12,8482713,Mackie Samoskevich,R,FLA,22,82,6,6,12
12,8482730,Brandt Clarke,D,LAK,21,82,4,8,12
12,8483471,Brad Lambert,C,WPG,31,82,4,8,12
12,8475177,Calvin de Haan,D,TBL,33,82,1,11,12
12,8482073,Braden Schneider,D,NYR,23,82,1,11,12
12,8483397,Marc McLaughlin,C,BOS,25,82,6,5,11
12,8474013,Ian Cole,D,VAN,35,82,3,8,11
12,8482470,Ilya Solovyov,D,CGY,24,82,2,9,11
12,8479442,Troy Stecher,D,EDM,30,82,1,10,11
12,8476915,Jujhar Khaira,L,MIN,30,82,5,5,10
12,8480834,Ty Emberson,D,SJS,24,82,4,6,10
12,8476372,Nick Seeler,D,PHI,31,82,3,7,10
12,8482737,Zack Bolduc,C,STL,21,82,3,7,10
12,8478443,Brandon Carlo,D,BOS,28,82,2,8,10
12,8481605,Jackson LaCombe,D,ANA,23,82,4,5,9
12,8476473,Connor Murphy,D,CHI,31,82,3,6,9
12,8482118,Sam Colangelo,R,ANA,23,82,2,6,8
12,8478408,Travis Dermott,D,ARI,28,82,5,2,7
12,8475762,Derek Forbort,D,BOS,32,82,3,2,5
12,8483489,Fraser Minten,C,TOR,31,82,2,2,4
12,8477950,Tony DeAngelo,D,CAR,29,0,0,0,0
12,8481577,Philip Tomasino,C,NSH,23,0,0,0,0
12,8482660,Kent Johnson,C,CBJ,22,0,0,0,0
12,8481019,David Gustafsson,C,WPG,24,0,0,0,0
12,8479348,Kale Clague,D,BUF,26,0,0,0,0
12,8482149,Cole Perfetti,C,WPG,22,0,0,0,0
12,8476952,Dominic Toninato,C,WPG,30,0,0,0,0
12,8473473,Milan Lucic,L,BOS,36,0,0,0,0
12,8480829,Jesperi Kotkaniemi,C,CAR,24,0,0,0,0
12,8474602,Justin Schultz,D,SEA,34,0,0,0,0
12,8480049,Dylan Samberg,D,WPG,25,0,0,0,0
12,8479372,Josh Mahura,D,FLA,26,0,0,0,0
12,8480878,Nils Lundkvist,D,DAL,24,0,0,0,0
12,8479982,Conor Timmins,D,TOR,26,0,0,0,0
12,8474031,Kevin Shattenkirk,D,BOS,35,0,0,0,0
12,8480835,Jack Drury,C,CAR,24,0,0,0,0
12,8480008,Adam Ruzicka,C,ARI,25,0,0,0,0
12,8479402,Jake Bean,D,CBJ,26,0,0,0,0
12,8476474,Stefan Noesen,R,CAR,31,0,0,0,0
12,8480884,Calen Addison,D,SJS,24,0,0,0,0
12,8476994,Vinnie Hinostroza,C,PIT,30,0,0,0,0
12,8477987,Ryan Donato,C,CHI,28,0,0,0,0
12,8481582,Nicholas Robertson,L,TOR,23,0,0,0,0
12,8478452,Caleb Jones,D,COL,27,0,0,0,0
12,8480157,Calle Rosen,D,STL,30,0,0,0,0
12,8481609,Vladislav Kolyachonok,D,ARI,23,0,0,0,0
12,8476919,Chris Tierney,C,NJD,30,0,0,0,0
12,8479639,Dylan Coghlan,D,CAR,26,0,0,0,0
12,8475193,Tomas Tatar,L,SEA,34,0,0,0,0
12,8480748,Kiefer Sherwood,L,NSH,29,0,0,0,0
12,8478146,Matthew Highmore,C,OTT,28,0,0,0,0
12,8478970,Jalen Chatfield,D,CAR,28,0,0,0,0
12,8480205,Emil Bemstrom,C,PIT,25,0,0,0,0
12,8471274,Alex Goligoski,D,MIN,39,0,0,0,0
12,8478104,Sammy Blais,L,STL,28,0,0,0,0
12,8476913,Devin Shore,C,SEA,30,0,0,0,0
12,8481708,Zac Jones,D,NYR,24,0,0,0,0
12,8480222,Sebastian Aho,D,NYI,28,0,0,0,0
12,8481598,Philip Broberg,D,EDM,23,0,0,0,0
12,8480789,Oliver Wahlstrom,R,NYI,24,0,0,0,0
12,8480891,Michael Kesselring,D,ARI,24,0,0,0,0
12,8477979,Nicolas Aube-Kubel,R,WSH,28,0,0,0,0
12,8476393,Nick Cousins,C,FLA,31,0,0,0,0
12,8480003,Jesper Boqvist,C,BOS,26,0,0,0,0
12,8479543,Michael Pezzetta,L,MTL,26,0,0,0,0
12,8475855,Jesper Fast,R,CAR,33,0,0,0,0
12,8477018,Ben Hutton,D,VGK,31,0,0,0,0
12,8480762,Eric Robinson,L,BUF,29,0,0,0,0
12,8481058,Jesse Ylönen,R,MTL,25,0,0,0,0
12,8481527,Kaedan Korczak,D,VGK,23,0,0,0,0
12,8482192,Isaak Phillips,D,CHI,23,0,0,0,0
12,8480727,Zach Whitecloud,D,VGK,28,0,0,0,0
12,8480001,Urho Vaakanainen,D,ANA,25,0,0,0,0
12,8480853,Liam Foudy,C,NSH,24,0,0,0,0
12,8475225,Craig Smith,C,DAL,35,0,0,0,0
12,8479972,Mason Shaw,C,MIN,26,0,0,0,0
12,8474040,Sam Gagner,C,EDM,35,0,0,0,0
12,8480196,Jacob Bryson,D,BUF,27,0,0,0,0
12,8475718,Justin Holl,D,DET,32,0,0,0,0
12,8479984,Cal Foote,D,NJD,26,0,0,0,0
12,8480011,Klim Kostin,C,SJS,25,0,0,0,0
12,8482176,Wyatt Kaiser,D,CHI,22,0,0,0,0
12,8476918,Jimmy Vesey,L,NYR,31,0,0,0,0
12,8476988,Matt Benning,D,SJS,30,0,0,0,0
12,8479370,Tyson Jost,C,BUF,26,0,0,0,0
12,8477464,Nic Petan,C,MIN,29,0,0,0,0
12,8477380,Jonny Brodzinski,C,NYR,31,0,0,0,0
12,8480070,Ian Mitchell,D,BOS,25,0,0,0,0
12,8479315,Joey Anderson,R,CHI,26,0,0,0,0
12,8478099,Kevin Labanc,R,SJS,29,0,0,0,0
12,8476874,Olli Maatta,D,DET,30,0,0,0,0
12,8479414,Nathan Bastian,R,NJD,27,0,0,0,0
12,8478434,Keegan Kolesar,R,VGK,27,0,0,0,0
12,8479536,Axel Jonsson-Fjallby,L,WPG,26,0,0,0,0
12,8479671,Mathieu Olivier,R,CBJ,27,0,0,0,0
12,8471709,Marc-Edouard Vlasic,D,SJS,37,0,0,0,0
12,8479328,Julien Gauthier,R,NYI,27,0,0,0,0
12,8478421,A.J. Greer,L,CGY,28,0,0,0,0
12,8477573,Nathan Walker,L,STL,30,0,0,0,0
12,8477478,William Carrier,L,VGK,30,0,0,0,0
12,8479344,Jesse Puljujarvi,R,PIT,26,0,0,0,0
12,8480887,Jordan Harris,D,MTL,24,0,0,0,0
12,8478502,Dennis Gilbert,D,CGY,28,0,0,0,0
12,8480355,Mark Kastelic,C,OTT,25,0,0,0,0
12,8475750,Jon Merrill,D,MIN,32,0,0,0,0
12,8476889,Radek Faksa,C,DAL,30,0,0,0,0
12,8478432,Christian Fischer,R,DET,27,0,0,0,0
12,8479439,Jacob MacDonald,D,SJS,31,0,0,0,0
12,8474568,Luke Schenn,D,NSH,35,0,0,0,0
12,8478454,Noah Juulsen,D,VAN,27,0,0,0,0
12,8475752,Tyler Pitlick,C,NYR,33,0,0,0,0
12,8482148,Hendrix Lapierre,C,WSH,22,0,0,0,0
12,8481167,Brayden Pachal,D,CGY,25,0,0,0,0
12,8478211,Dryden Hunt,L,CGY,29,0,0,0,0
12,8479321,Lucas Johansen,D,WSH,27,0,0,0,0
12,8480950,Ilya Lyubushkin,D,TOR,30,0,0,0,0
12,8479368,Max Jones,L,ANA,26,0,0,0,0
12,8471699,Andrew Cogliano,C,COL,37,0,0,0,0
12,8481521,Ronnie Attard,D,PHI,25,0,0,0,0
12,8481161,Jake Christiansen,D,CBJ,25,0,0,0,0
12,8479458,Nikita Zaitsev,D,CHI,33,0,0,0,0
12,8479619,Michael Carcone,L,ARI,28,0,0,0,0
12,8479026,Philippe Myers,D,TBL,27,0,0,0,0
12,8481617,Vasily Podkolzin,R,VAN,23,0,0,0,0
12,8481701,Santeri Hatakka,D,NJD,23,0,0,0,0
12,8477446,Michael McCarron,R,NSH,29,0,0,0,0
12,8483460,David Jiricek,D,CBJ,21,0,0,0,0
12,8474090,Brendan Smith,D,NJD,35,0,0,0,0
12,8482241,Radim Zohorna,L,PIT,28,0,0,0,0
12,8481032,Paul Cotter,C,VGK,25,0,0,0,0
12,8480289,Morgan Barron,C,WPG,26,0,0,0,0
12,8479379,Givani Smith,R,SJS,26,0,0,0,0
12,8480216,Jacob Peterson,C,SJS,25,0,0,0,0
12,8477851,Jordan Oesterle,D,CGY,32,0,0,0,0
12,8484258,Sam Malinski,D,COL,26,0,0,0,0
12,8478904,Steven Lorentz,C,FLA,28,0,0,0,0
12,8482095,Tyler Kleven,D,OTT,22,0,0,0,0
12,8480980,Connor Dewar,C,TOR,25,0,0,0,0
12,8480848,Ty Dellandrea,C,DAL,24,0,0,0,0
12,8476884,Derrick Pouliot,D,DAL,30,0,0,0,0
12,8480025,MacKenzie Entwistle,R,CHI,25,0,0,0,0
12,8474612,Travis Hamonic,D,OTT,34,0,0,0,0
12,8479336,Carl Grundstrom,R,LAK,27,0,0,0,0
12,8482964,Arber Xhekaj,D,MTL,23,0,0,0,0
12,8471686,Marc Staal,D,PHI,37,0,0,0,0
12,8477887,Patrick Brown,C,BOS,32,0,0,0,0
12,8478495,Denis Gurianov,R,PHI,27,0,0,0,0
12,8481550,Adam Beckman,L,MIN,23,0,0,0,0
12,8480845,Rasmus Kupari,C,WPG,24,0,0,0,0
12,8478585,Derek Ryan,C,EDM,38,0,0,0,0
12,8482141,Lukas Cormier,D,VGK,22,0,0,0,0
12,8477962,Brendan Lemieux,L,CAR,28,0,0,0,0
12,8482861,Vincent Iorio,D,WSH,22,0,0,0,0
12,8479378,Logan Stanley,D,WPG,26,0,0,0,0
12,8473446,Erik Johnson,D,PHI,36,0,0,0,0
12,8481743,Marc Del Gaizo,D,NSH,25,0,0,0,0
12,8478450,Parker Wotherspoon,D,BOS,27,0,0,0,0
12,8477384,Josh Brown,D,ARI,30,0,0,0,0
12,8482165,Yan Kuznetsov,D,CGY,22,0,0,0,0
12,8478424,Jansen Harkins,C,PIT,27,0,0,0,0
12,8482144,Jack Thompson,D,SJS,22,0,0,0,0
12,8479576,Vincent Desharnais,D,EDM,28,0,0,0,0
12,8478512,Austin Czarnik,C,DET,32,0,0,0,0
12,8477527,Ross Johnston,L,ANA,30,0,0,0,0
12,8482094,Daemon Hunt,D,MIN,22,0,0,0,0
12,8481719,Maxwell Crozier,D,TBL,24,0,0,0,0
12,8480192,Johnathan Kovacevic,D,MTL,27,0,0,0,0
12,8479376,Victor Mete,D,PHI,26,0,0,0,0
12,8482511,Mason Lohrei,D,BOS,23,0,0,0,0
12,8478021,William Lagesson,D,ANA,28,0,0,0,0
12,8475795,Dylan McIlrath,D,WSH,32,0,0,0,0
12,8477846,Ryan Carpenter,C,SJS,33,0,0,0,0
12,8481056,Spencer Stastney,D,NSH,24,0,0,0,0
12,8481564,Ryan Johnson,D,BUF,23,0,0,0,0
12,8478017,Mark Friedman,D,VAN,29,0,0,0,0
12,8479320,Max Lajoie,D,TOR,27,0,0,0,0
12,8480075,Cameron Crotty,D,ARI,25,0,0,0,0
12,8484287,Cole McWard,D,VAN,23,0,0,0,0
12,8484254,Akito Hirose,D,VAN,25,0,0,0,0
12,8483407,Brandon Scanlin,D,NYR,25,0,0,0,0
12,8480274,Philip Kemp,D,EDM,25,0,0,0,0
12,8479522,Hardy Haman Aktell,D,WSH,26,0,0,0,0
12,8480007,Jonas Rondbjerg,R,VGK,25,0,0,0,0
12,8477454,Adam Erne,L,EDM,29,0,0,0,0
12,8481679,Maxence Guenette,D,OTT,23,0,0,0,0
12,8477938,Haydn Fleury,D,TBL,28,0,0,0,0
12,8476441,Joel Edmundson,D,TOR,31,0,0,0,0
12,8477903,Garnet Hathaway,R,PHI,33,0,0,0,0
12,8480441,Trey Fix-Wolansky,R,CBJ,25,0,0,0,0
12,8483546,Marshall Rifai,D,TOR,26,0,0,0,0
12,8480084,Nick DeSimone,D,NJD,30,0,0,0,0
12,8481592,Jakob Pelletier,L,CGY,23,0,0,0,0
12,8478011,Louie Belpedio,D,PHI,28,0,0,0,0
12,8477930,Pierre-Edouard Bellemare,L,SEA,39,0,0,0,0
12,8484321,Nikolas Matinpalo,D,OTT,26,0,0,0,0
12,8482067,Connor Mackey,D,NYR,28,0,0,0,0
12,8481806,Louis Crevier,D,CHI,23,0,0,0,0
12,8484326,Patrik Koch,D,ARI,28,0,0,0,0
12,8477971,Andreas Englund,D,LAK,28,0,0,0,0
12,8481751,Lukas Rousek,R,BUF,25,0,0,0,0
12,8481006,Tyler Tucker,D,STL,24,0,0,0,0
12,8481641,Joel Kiviranta,L,COL,28,0,0,0,0
12,8476867,Brendan Gaunce,C,CBJ,30,0,0,0,0
12,8479520,Brandon Duhaime,R,COL,27,0,0,0,0
12,8477073,Kurtis MacDermid,L,NJD,30,0,0,0,0
12,8480874,Adam Ginning,D,PHI,24,0,0,0,0
12,8477473,Justin Bailey,R,SJS,29,0,0,0,0
12,8479066,Ryan Lomberg,L,FLA,30,0,0,0,0
12,8477070,Liam O'Brien,C,ARI,30,0,0,0,0
12,8474618,Marco Scandella,D,STL,34,0,0,0,0
12,8475797,Jarred Tinordi,D,CHI,32,0,0,0,0
12,8481441,Joe Snively,C,WSH,28,0,0,0,0
12,8477244,Chad Ruhwedel,D,NYR,34,0,0,0,0
12,8482077,Dylan Holloway,L,EDM,23,0,0,0,0
12,8479772,Zack MacEwen,R,OTT,28,0,0,0,0
12,8481147,Reese Johnson,C,CHI,26,0,0,0,0
12,8481043,Cole Koepke,L,TBL,26,0,0,0,0
12,8483619,Filip Roos,D,CHI,25,0,0,0,0
12,8481541,Samuel Bolduc,D,NYI,24,0,0,0,0
12,8477810,Joel Hanley,D,CGY,33,0,0,0,0
12,8476907,Mackenzie MacEachern,L,STL,30,0,0,0,0
12,8482652,Walker Duehr,R,CGY,27,0,0,0,0
12,8477126,Jayson Megna,C,BOS,34,0,0,0,0
12,8483398,Declan Carlile,D,TBL,31,0,0,0,0
12,8482929,Emil Lilleberg,D,TBL,23,0,0,0,0
12,8480880,Jakub Lauko,C,BOS,24,0,0,0,0
12,8478874,Adam Gaudette,C,STL,28,0,0,0,0
12,8480245,Olle Lycksell,R,PHI,25,0,0,0,0
12,8480252,Cole Guttman,C,CHI,25,0,0,0,0
12,8477467,Gustav Olofsson,D,SEA,30,0,0,0,0
12,8479968,Vinni Lettieri,C,MIN,29,0,0,0,0
12,8478400,Colin White,C,MTL,27,0,0,0,0
12,8475755,Alexander Petrovic,D,DAL,32,0,0,0,0
12,8481812,Nikolai Knyzhov,D,SJS,27,0,0,0,0
12,8481593,Jayden Struble,D,MTL,23,0,0,0,0
12,8481532,Alex Turcotte,C,LAK,23,0,0,0,0
12,8482126,Emil Andrae,D,PHI,31,0,0,0,0
12,8479944,Zach Aston-Reese,C,DET,30,0,0,0,0
12,8471817,Ryan Reaves,R,TOR,37,0,0,0,0
12,8481206,John Ludvig,D,PIT,24,0,0,0,0
12,8480292,Carson Meyer,R,CBJ,27,0,0,0,0
12,8482496,Nils Aman,C,VAN,24,0,0,0,0
12,8479718,Alex Barré-Boulet,C,TBL,27,0,0,0,0
12,8479994,Jaret Anderson-Dolan,C,NSH,25,0,0,0,0
12,8480184,Gustav Lindstrom,D,ANA,26,0,0,0,0
12,8480890,Jan Jenik,R,ARI,24,0,0,0,0
12,8478067,Oskar Lindblom,L,SJS,28,0,0,0,0
12,8476934,Brock McGinn,L,ANA,30,0,0,0,0
12,8479985,Cale Fleury,D,SEA,26,0,0,0,0
12,8482153,Brendan Brisson,C,VGK,23,0,0,0,0
12,8480021,Jack Studnicka,C,SJS,25,0,0,0,0
12,8484304,Uvis Balinskis,D,FLA,28,0,0,0,0
12,8479981,Jonah Gadjovich,L,FLA,26,0,0,0,0
12,8481716,Dmitri Voronkov,L,CBJ,24,0,0,0,0
12,8482659,Josh Doan,R,ARI,22,0,0,0,0
12,8481122,Simon Benoit,D,TOR,26,0,0,0,0
12,8474709,Matt Martin,L,NYI,35,0,0,0,0
12,8482634,Alex Steeves,C,TOR,25,0,0,0,0
12,8480823,Alexander Alexeyev,D,WSH,25,0,0,0,0
12,8477541,Dakota Mermis,D,MIN,30,0,0,0,0
12,8478477,Mitchell Stephens,C,MTL,27,0,0,0,0
12,8481543,Nikita Alexandrov,C,STL,24,0,0,0,0
12,8482451,Mikael Pyyhtia,L,CBJ,23,0,0,0,0
12,8480306,Grant Hutton,D,NYI,29,0,0,0,0
12,8478028,Fredrik Olofsson,L,COL,28,0,0,0,0
12,8477462,Robert Hagg,D,ANA,29,0,0,0,0
12,8477320,Anton Blidh,L,NYR,29,0,0,0,0
12,8482749,Joshua Roy,R,MTL,21,0,0,0,0
12,8482157,Will Cuylle,L,NYR,22,0,0,0,0
12,8481239,Samuel Fagemo,L,LAK,24,0,0,0,0
12,8481600,Tobias Bjornfot,D,FLA,23,0,0,0,0
12,8478409,Anthony Richard,C,BOS,28,0,0,0,0
12,8474145,Robert Bortuzzo,D,NYI,35,0,0,0,0
12,8475958,Michael Sgarbossa,C,WSH,32,0,0,0,0
12,8479986,Kole Lind,R,SEA,26,0,0,0,0
12,8479249,Andrew Poturalski,C,SEA,30,0,0,0,0
12,8479362,Riley Tufte,L,COL,26,0,0,0,0
12,8479991,Jake Leschyshyn,C,NYR,25,0,0,0,0
12,8479587,Rhett Gardner,C,PHI,28,0,0,0,0
12,8482744,James Malatesta,L,CBJ,21,0,0,0,0
12,8478854,Ryan Shea,D,PIT,27,0,0,0,0
12,8481591,Sam Poulin,R,PIT,23,0,0,0,0
12,8483512,Matt Savoie,C,BUF,20,0,0,0,0
12,8482102,Vasily Ponomarev,C,CAR,22,0,0,0,0
12,8482162,Roby Jarventie,L,OTT,22,0,0,0,0
12,8482172,Landon Slaggert,L,CHI,22,0,0,0,0
12,8482747,Brennan Othmann,L,NYR,21,0,0,0,0
12,8480226,Marián Studenic,R,SEA,26,0,0,0,0
12,8481518,Nolan Foote,L,NJD,24,0,0,0,0
12,8479419,Brett Murray,L,BUF,26,0,0,0,0
12,8482088,Justin Sourdif,R,FLA,22,0,0,0,0
12,8482201,Gage Goncalves,C,TBL,23,0,0,0,0
12,8481754,Nikita Nesterenko,C,ANA,23,0,0,0,0
12,8483531,Brian Halonen,L,NJD,25,0,0,0,0
12,8483920,Pierrick Dube,R,WSH,23,0,0,0,0
12,8480851,Akil Thomas,C,LAK,24,0,0,0,0
12,8475235,Nicolas Deslauriers,L,PHI,33,0,0,0,0
12,8482476,Emil Heineman,L,MTL,23,0,0,0,0
12,8477149,Scott Sabourin,R,SJS,32,0,0,0,0
12,8483549,Lucas Condotta,L,MTL,27,0,0,0,0
12,8483567,Georgii Merkulov,C,BOS,24,0,0,0,0
12,8482765,Isak Rosen,R,BUF,21,0,0,0,0
12,8481237,Kyle MacLean,C,NYI,25,0,0,0,0
12,8481024,Linus Karlsson,C,VAN,25,0,0,0,0
12,8481690,Tyler Angle,C,CBJ,24,0,0,0,0
12,8483570,Ben Meyers,C,ANA,26,0,0,0,0
12,8481655,Cole Schwindt,R,CGY,23,0,0,0,0
12,8481462,Mason Morelli,L,VGK,28,0,0,0,0
12,8483401,Marc Johnstone,R,PIT,28,0,0,0,0
12,8478956,Samuel Laberge,L,NJD,27,0,0,0,0
12,8479533,Joona Koppanen,L,PIT,26,0,0,0,0
12,8482197,Adam Raska,R,MIN,23,0,0,0,0
12,8482250,Callahan Burke,C,CAR,27,0,0,0,0
12,8482784,Zach Dean,C,STL,21,0,0,0,0
12,8484255,Jason Polin,R,COL,25,0,0,0,0
12,8481077,John Leonard,L,ARI,26,0,0,0,0
12,8481534,Raphael Lavoie,C,EDM,24,0,0,0,0
12,8483609,Adam Klapka,R,CGY,24,0,0,0,0
12,8482751,Ryan Winterton,C,SEA,21,0,0,0,0
12,8480267,Sammy Walker,C,MIN,25,0,0,0,0
12,8475766,Austin Watson,L,TBL,32,0,0,0,0
12,8482460,Matt Rempe,C,NYR,22,0,0,0,0
12,8482787,Nikita Chibrikov,R,WPG,31,0,0,0,0
12,8481065,Angus Crookshank,L,OTT,25,0,0,0,0
12,8481070,Hugh McGing,L,STL,26,0,0,0,0
12,8476323,Max McCormick,L,SEA,32,0,0,0,0
12,8483395,Arshdeep Bains,L,VAN,23,0,0,0,0
12,8484259,Ondrej Pavel,C,COL,31,0,0,0,0
12,8483432,Luca Del Bel Belluz,C,CBJ,31,0,0,0,0
12,8483045,Cameron Butler,R,CBJ,31,0,0,0,0
12,8482061,Brandon Biro,L,BUF,26,0,0,0,0
12,8477401,John Hayden,C,SEA,29,0,0,0,0
12,8475278,Byron Froese,C,VGK,33,0,0,0,0
12,8478446,Glenn Gawdin,C,ANA,27,0,0,0,0
12,8477993,Justin Kirkland,C,ARI,28,0,0,0,0
12,8482147,Jean-Luc Foudy,C,COL,22,0,0,0,0
12,8480032,Shane Bowers,C,NJD,25,0,0,0,0
12,8479330,Brandon Gignac,C,MTL,27,0,0,0,0
12,8480776,Sheldon Rempal,R,VGK,29,0,0,0,0
12,8475413,Justin Dowling,C,NJD,34,0,0,0,0
12,8481726,Adam Edstrom,C,NYR,24,0,0,0,0
12,8479638,Justin Brazeau,R,BOS,26,0,0,0,0
12,8480844,Grigori Denisenko,L,VGK,24,0,0,0,0
12,8474062,Riley Nash,C,NYR,35,0,0,0,0
12,8478147,Bokondji Imama,L,OTT,28,0,0,0,0
12,8478881,Brett Seney,L,CHI,28,0,0,0,0
12,8483630,Pavol Regenda,L,ANA,25,0,0,0,0
12,8480836,Jonathan Gruden,C,PIT,24,0,0,0,0
12,8484314,Jiri Smejkal,L,OTT,28,0,0,0,0
12,8475780,Chris Wagner,R,COL,33,0,0,0,0
12,8482070,Mitchell Chaffee,R,TBL,26,0,0,0,0
12,8479546,Oskar Steen,C,BOS,26,0,0,0,0
12,8483597,Milos Kelemen,L,ARI,25,0,0,0,0
12,8481789,Tye Kartye,L,SEA,23,0,0,0,0
12,8484325,Waltteri Merela,C,TBL,26,0,0,0,0
12,8479421,Jacob Moverare,D,LAK,26,0,0,0,0
12,8481585,Egor Afanasyev,L,NSH,23,0,0,0,0
12,8479547,Matthew Phillips,R,WSH,26,0,0,0,0
12,8479367,William Lockwood,R,FLA,26,0,0,0,0
12,8481422,Jacob Lucchini,C,MIN,29,0,0,0,0
12,8480468,James Hamblin,L,EDM,25,0,0,0,0
12,8480870,Bo Groulx,C,ANA,24,0,0,0,0
12,8478051,Max Willman,C,NJD,29,0,0,0,0
12,8481556,John Beecher,C,BOS,23,0,0,0,0
12,8478078,Rourke Chartier,C,OTT,28,0,0,0,0
13,8477956,David Pastrnak,R,BOS,28,82,71,66,137
13,8476453,Nikita Kucherov,R,TBL,31,82,40,97,137
13,8478402,Connor McDavid,C,EDM,27,82,48,88,136
13,8477492,Nathan MacKinnon,C,COL,29,82,47,78,125
13,8479318,Auston Matthews,C,TOR,27,82,68,56,124
13,8476887,Filip Forsberg,L,NSH,30,82,65,56,121
13,8481559,Jack Hughes,C,NJD,23,82,56,63,119
13,8478864,Kirill Kaprizov,L,MIN,27,82,55,61,116
13,8477939,William Nylander,R,TOR,28,82,47,69,116
13,8479407,Jesper Bratt,L,NJD,26,82,43,65,108
13,8474600,Roman Josi,D,NSH,34,82,22,86,108
13,8478010,Brayden Point,C,TBL,28,82,50,55,105
13,8480012,Elias Pettersson,C,VAN,26,82,45,58,103
13,8480023,Robert Thomas,C,STL,25,82,27,74,101
13,8479314,Matthew Tkachuk,L,FLA,27,82,36,63,99
13,8477493,Aleksander Barkov,C,FLA,29,82,35,62,97
13,8477934,Leon Draisaitl,C,EDM,29,82,34,63,97
13,8478420,Mikko Rantanen,R,COL,28,82,37,59,96
13,8476468,J.T. Miller,C,VAN,31,82,30,65,95
13,8480069,Cale Makar,D,COL,26,82,19,75,94
13,8481557,Matt Boldy,L,MIN,23,82,44,49,93
13,8480801,Brady Tkachuk,L,OTT,25,82,43,50,93
13,8482116,Tim Stützle,C,OTT,22,82,34,59,93
13,8480002,Nico Hischier,C,NJD,25,82,33,59,92
13,8473419,Brad Marchand,L,BOS,36,82,33,57,90
13,8477501,Valeri Nichushkin,R,COL,29,82,46,43,89
13,8471214,Alex Ovechkin,L,WSH,39,82,43,44,87
13,8471675,Sidney Crosby,C,PIT,37,82,41,46,87
13,8474564,Steven Stamkos,C,TBL,34,82,36,51,87
13,8475810,Bryan Rust,R,PIT,32,82,35,52,87
13,8478440,Dylan Strome,C,WSH,27,82,30,55,85
13,8477404,Jake Guentzel,C,CAR,30,82,35,49,84
13,8475172,Nazem Kadri,C,CGY,34,82,37,46,83
13,8475166,John Tavares,C,TOR,34,82,33,50,83
13,8477402,Pavel Buchnevich,L,STL,29,82,32,51,83
13,8479385,Jordan Kyrou,C,STL,26,82,37,45,82
13,8478427,Sebastian Aho,C,CAR,27,82,33,49,82
13,8475158,Ryan O'Reilly,C,NSH,33,82,33,49,82
13,8480208,Drake Batherson,R,OTT,26,82,29,53,82
13,8478873,Troy Terry,R,ANA,27,82,37,44,81
13,8478550,Artemi Panarin,L,NYR,33,82,28,53,81
13,8477942,Kevin Fiala,L,LAK,28,82,31,49,80
13,8478439,Travis Konecny,R,PHI,27,82,35,44,79
13,8477960,Adrian Kempe,R,LAK,28,82,32,47,79
13,8476853,Morgan Rielly,D,TOR,30,82,12,66,78
13,8477946,Dylan Larkin,C,DET,28,82,37,40,77
13,8478403,Jack Eichel,C,VGK,28,82,30,47,77
13,8480027,Jason Robertson,L,DAL,25,82,30,47,77
13,8478445,Mathew Barzal,C,NYI,27,82,27,50,77
13,8475913,Mark Stone,R,VGK,32,82,27,50,77
13,8479325,Charlie McAvoy,D,BOS,27,82,16,61,77
13,8479343,Clayton Keller,R,ARI,26,82,38,38,76
13,8477949,Alex Tuch,R,BUF,28,82,19,57,76
13,8476456,Jonathan Huberdeau,C,CGY,31,82,18,58,76
13,8481523,Kirby Dach,C,MTL,23,82,16,60,76
13,8475754,Brock Nelson,C,NYI,33,82,43,32,75
13,8474679,Gustav Nyquist,C,NSH,35,82,33,42,75
13,8476462,Dougie Hamilton,D,NJD,31,82,26,49,75
13,8471215,Evgeni Malkin,C,PIT,38,82,29,45,74
13,8479542,Brandon Hagel,L,TBL,26,82,42,31,73
13,8475786,Zach Hyman,L,EDM,32,82,40,32,72
13,8477409,Carter Verhaeghe,C,FLA,29,82,36,36,72
13,8477955,Jared McCann,L,SEA,28,82,33,39,72
13,8481533,Trevor Zegras,C,ANA,23,82,33,39,72
13,8477940,Nikolaj Ehlers,L,WPG,28,82,28,44,72
13,8482097,Jack Quinn,R,BUF,23,82,28,44,72
13,8480800,Quinn Hughes,D,VAN,25,82,10,62,72
13,8478414,Timo Meier,R,NJD,28,82,39,32,71
13,8479420,Tage Thompson,C,BUF,27,82,34,37,71
13,8476460,Mark Scheifele,C,WPG,31,82,24,47,71
13,8478042,Viktor Arvidsson,R,LAK,31,82,22,49,71
13,8474578,Erik Karlsson,D,PIT,34,82,10,61,71
13,8481540,Cole Caufield,R,MTL,23,82,38,32,70
13,8474141,Patrick Kane,R,DET,36,82,26,44,70
13,8471685,Anze Kopitar,C,LAK,37,82,25,45,70
13,8477496,Elias Lindholm,C,VAN,30,82,24,46,70
13,8475798,Mikael Granlund,C,SJS,32,82,18,52,70
13,8477951,Nick Schmaltz,C,ARI,28,82,22,47,69
13,8476346,Johnny Gaudreau,L,CBJ,31,82,16,53,69
13,8480803,Evan Bouchard,D,EDM,25,82,15,54,69
13,8475184,Chris Kreider,L,NYR,33,82,37,31,68
13,8475784,Jeff Skinner,C,BUF,32,82,23,45,68
13,8480188,Fabian Zetterlund,L,SJS,25,82,23,44,67
13,8477504,Josh Morrissey,D,WPG,29,82,18,49,67
13,8479323,Adam Fox,D,NYR,26,82,13,54,67
13,8475167,Victor Hedman,D,TBL,34,82,13,54,67
13,8478444,Brock Boeser,R,VAN,27,82,34,32,66
13,8477476,Artturi Lehkonen,L,COL,29,82,32,33,65
13,8476389,Vincent Trocheck,C,NYR,31,82,31,34,65
13,8478449,Roope Hintz,C,DAL,28,82,29,36,65
13,8476454,Ryan Nugent-Hopkins,C,EDM,31,82,23,42,65
13,8477933,Sam Reinhart,C,FLA,29,82,33,31,64
13,8477500,Bo Horvat,C,NYI,29,82,30,34,64
13,8482078,Lucas Raymond,L,DET,22,82,29,35,64
13,8478498,Jake DeBrusk,L,BOS,28,82,26,38,64
13,8482159,Tyson Foerster,R,PHI,22,82,22,42,64
13,8477447,Shea Theodore,D,VGK,29,82,13,51,64
13,8481068,Yegor Sharangovich,C,CGY,26,82,37,26,63
13,8482740,Wyatt Johnston,C,DAL,21,82,30,33,63
13,8480830,Andrei Svechnikov,R,CAR,24,82,26,37,63
13,8479337,Alex DeBrincat,R,DET,27,82,26,37,63
13,8476459,Mika Zibanejad,C,NYR,31,82,20,43,63
13,8475692,Mats Zuccarello,R,MIN,37,82,17,46,63
13,8480865,Noah Dobson,D,NYI,24,82,9,54,63
13,8480434,Sean Durzi,D,ARI,26,82,7,56,63
13,8478398,Kyle Connor,L,WPG,28,82,27,35,62
13,8475168,Matt Duchene,C,DAL,33,82,25,37,62
13,8481596,Shane Pinto,C,OTT,24,82,24,38,62
13,8482124,Quinton Byfield,R,LAK,22,82,22,40,62
13,8478519,Anthony Cirelli,C,TBL,27,82,22,40,62
13,8480028,Morgan Frost,C,PHI,25,82,21,41,62
13,8474563,Drew Doughty,D,LAK,35,82,19,43,62
13,8478407,Vince Dunn,D,SEA,28,82,12,50,62
13,8476826,Yanni Gourde,C,SEA,33,82,24,37,61
13,8480018,Nick Suzuki,C,MTL,25,82,22,39,61
13,8481711,Matias Maccelli,L,ARI,24,82,22,39,61
13,8477451,Ryan Hartman,R,MIN,30,82,20,41,61
13,8476881,Tomas Hertl,C,VGK,31,82,21,39,60
13,8480839,Rasmus Dahlin,D,BUF,24,82,16,44,60
13,8476539,Jonathan Marchessault,R,VGK,34,82,30,29,59
13,8477479,Tyler Bertuzzi,L,TOR,29,82,28,31,59
13,8475794,Tyler Seguin,C,DAL,32,82,24,35,59
13,8481528,Dylan Cozens,C,BUF,23,82,23,36,59
13,8474150,Mikael Backlund,C,CGY,35,82,18,41,59
13,8477503,Max Domi,C,TOR,29,82,13,46,59
13,8478401,Pavel Zacha,C,BOS,27,82,26,32,58
13,8479675,Trevor Moore,L,LAK,29,82,25,33,58
13,8475765,Vladimir Tarasenko,R,FLA,33,82,24,34,58
13,8478047,Michael Bunting,L,PIT,29,82,23,35,58
13,8473512,Claude Giroux,R,OTT,36,82,22,36,58
13,8478469,Thomas Chabot,D,OTT,27,82,19,39,58
13,8477494,Jonathan Drouin,L,COL,29,82,16,42,58
13,8476483,Rickard Rakell,R,PIT,31,82,28,29,57
13,8481618,Alex Newhook,C,MTL,23,82,26,31,57
13,8474157,Max Pacioretty,L,WSH,36,82,22,35,57
13,8473986,Alex Killorn,L,ANA,35,82,20,37,57
13,8480036,Miro Heiskanen,D,DAL,25,82,16,41,57
13,8477346,MacKenzie Weegar,D,CGY,30,82,14,43,57
13,8478397,Rasmus Andersson,D,CGY,28,82,12,45,57
13,8475169,Evander Kane,L,EDM,33,82,28,28,56
13,8480015,Owen Tippett,R,PHI,25,82,28,28,56
13,8478366,Frank Vatrano,R,ANA,30,82,24,32,56
13,8479987,Morgan Geekie,C,BOS,26,82,24,32,56
13,8482665,Matty Beniers,C,SEA,22,82,23,33,56
13,8475191,Reilly Smith,R,PIT,33,82,23,33,56
13,8476906,Shayne Gostisbehere,D,DET,31,82,12,44,56
13,8474641,Adam Henrique,C,EDM,34,82,27,28,55
13,8477935,Sam Bennett,C,FLA,28,82,26,29,55
13,8480039,Martin Necas,C,CAR,25,82,25,30,55
13,8478493,Joel Eriksson Ek,C,MIN,27,82,25,30,55
13,8471724,Kris Letang,D,PIT,37,82,14,41,55
13,8476875,Mike Matheson,D,MTL,30,82,10,45,55
13,8482093,Seth Jarvis,C,CAR,22,82,30,24,54
13,8476882,Teuvo Teravainen,L,CAR,30,82,25,29,54
13,8478115,Pierre Engvall,L,NYI,28,82,24,30,54
13,8475151,Kyle Palmieri,C,NYI,33,82,22,32,54
13,8479345,Jakob Chychrun,D,OTT,26,82,21,33,54
13,8476981,Josh Anderson,R,MTL,30,82,32,21,53
13,8482109,Alexis Lafrenière,L,NYR,23,82,29,24,53
13,8479365,Trent Frederic,C,BOS,26,82,27,26,53
13,8475791,Taylor Hall,L,CHI,33,82,26,27,53
13,8475726,Tyler Toffoli,C,WPG,32,82,25,28,53
13,8477416,Oliver Bjorkstrand,R,SEA,29,82,20,33,53
13,8475170,Brayden Schenn,C,STL,33,82,20,33,53
13,8473994,Jamie Benn,L,DAL,35,82,19,34,53
13,8478460,Zach Werenski,D,CBJ,27,82,17,36,53
13,8475745,Charlie Coyle,C,BOS,32,82,17,36,53
13,8479400,Pierre-Luc Dubois,L,LAK,26,82,16,37,53
13,8476792,Torey Krug,D,STL,33,82,16,37,53
13,8475197,Tyson Barrie,D,NSH,33,82,10,43,53
13,8476880,Tom Wilson,R,WSH,30,82,29,23,52
13,8480064,Josh Norris,C,OTT,25,82,26,26,52
13,8479992,Michael Rasmussen,C,DET,25,82,25,27,52
13,8470794,Joe Pavelski,C,DAL,40,82,20,32,52
13,8479339,Patrik Laine,L,CBJ,26,82,19,33,52
13,8476399,Blake Coleman,C,CGY,33,82,25,26,51
13,8479999,Casey Mittelstadt,C,COL,26,82,22,29,51
13,8480849,Barrett Hayton,C,ARI,24,82,21,30,51
13,8478856,Conor Garland,R,VAN,28,82,20,31,51
13,8482092,Ridly Greig,C,OTT,22,82,18,33,51
13,8474102,David Perron,L,DET,36,82,15,36,51
13,8479410,Mikhail Sergachev,D,TBL,26,82,7,44,51
13,8475799,Nino Niederreiter,R,WPG,32,82,24,26,50
13,8476905,Chandler Stephenson,C,VGK,30,82,22,28,50
13,8482175,JJ Peterka,R,BUF,22,82,22,28,50
13,8474586,Jordan Eberle,R,SEA,34,82,21,29,50
13,8477497,Sean Monahan,C,WPG,30,82,19,31,50
13,8477407,Anthony Duclair,L,TBL,29,82,18,32,50
13,8476872,Scott Laughton,C,PHI,30,82,17,33,50
13,8476458,Ryan Strome,C,ANA,31,82,16,34,50
13,8474590,John Carlson,D,WSH,34,82,13,37,50
13,8477498,Darnell Nurse,D,EDM,29,82,13,37,50
13,8480014,Gabriel Vilardi,C,WPG,25,82,31,18,49
13,8475848,Brendan Gallagher,R,MTL,32,82,25,24,49
13,8477964,Ivan Barbashev,C,VGK,29,82,23,26,49
13,8476479,Phillip Danault,C,LAK,31,82,22,27,49
13,8477444,Andre Burakovsky,L,SEA,29,82,19,30,49
13,8478396,Noah Hanifin,D,VGK,27,82,11,38,49
13,8477495,Seth Jones,D,CHI,30,82,10,39,49
13,8476432,Boone Jenner,C,CBJ,31,82,26,22,48
13,8476438,Brandon Saad,L,STL,32,82,25,23,48
13,8478975,Mason Marchment,L,DAL,29,82,14,34,48
13,8478038,Devon Toews,D,COL,30,82,12,36,48
13,8482684,Luke Hughes,D,NJD,21,82,9,39,48
13,8482745,Mason McTavish,C,ANA,21,82,28,19,47
13,8476448,William Karlsson,C,VGK,31,82,24,23,47
13,8482699,Dylan Guenther,R,ARI,21,82,24,23,47
13,8483515,Juraj Slafkovsky,L,MTL,20,82,19,28,47
13,8475722,Jason Zucker,L,NSH,32,82,19,28,47
13,8480797,Joel Farabee,L,PHI,24,82,15,32,47
13,8475744,Evgeny Kuznetsov,C,CAR,32,82,14,33,47
13,8482133,Thomas Bordeleau,C,SJS,22,82,14,33,47
13,8477932,Aaron Ekblad,D,FLA,28,82,12,35,47
13,8476869,Brady Skjei,D,CAR,30,82,11,36,47
13,8475218,Mattias Ekholm,D,EDM,34,82,8,39,47
13,8478233,Andrew Mangiapane,L,CGY,28,82,19,27,46
13,8478466,Daniel Sprong,R,DET,27,82,18,28,46
13,8478438,Tommy Novak,C,NSH,27,82,18,28,46
13,8470613,Brent Burns,D,CAR,39,82,17,29,46
13,8473563,Nicklas Backstrom,C,WSH,37,82,16,30,46
13,8477986,Brandon Montour,D,FLA,30,82,15,31,46
13,8480798,Philipp Kurashev,C,CHI,25,82,14,32,46
13,8478891,Mason Appleton,C,WPG,28,82,14,32,46
13,8482720,Matthew Knies,L,TOR,22,82,11,35,46
13,8479425,Filip Hronek,D,VAN,27,82,10,36,46
13,8475714,Calle Jarnkrok,C,TOR,33,82,27,18,45
13,8474053,Logan Couture,C,SJS,35,82,24,21,45
13,8481477,Nico Sturm,C,SJS,29,82,24,21,45
13,8480009,Eeli Tolvanen,R,SEA,25,82,21,24,45
13,8478020,Michael Amadio,C,VGK,28,82,18,27,45
13,8476871,Tanner Pearson,L,MTL,32,82,17,28,45
13,8480185,Eetu Luostarinen,C,FLA,26,82,15,30,45
13,8474884,Mike Hoffman,C,SJS,35,82,20,24,44
13,8482110,Dawson Mercer,C,NJD,23,82,17,27,44
13,8480113,Alex Iafallo,L,WPG,31,82,17,27,44
13,8475768,Jaden Schwartz,C,SEA,32,82,13,31,44
13,8478055,Gustav Forsling,D,FLA,28,82,10,34,44
13,8478474,Lawson Crouse,L,ARI,27,82,23,20,43
13,8478046,Danton Heinen,L,BOS,29,82,20,23,43
13,8477021,Alex Kerfoot,C,ARI,30,82,11,32,43
13,8480145,Neal Pionk,D,WPG,29,82,10,33,43
13,8478057,Dakota Joshua,C,VAN,28,82,25,17,42
13,8482146,Luke Evangelista,R,NSH,22,82,22,20,42
13,8483808,Andrei Kuzmenko,L,CGY,28,82,20,22,42
13,8478463,Anthony Beauvillier,L,NSH,27,82,20,22,42
13,8477947,Sonny Milano,L,WSH,28,82,15,27,42
13,8482222,Alexander Barabanov,L,SJS,30,82,14,28,42
13,8478911,Matt Roy,D,LAK,29,82,13,29,42
13,8481542,Moritz Seider,D,DET,23,82,10,32,42
13,8480043,Timothy Liljegren,D,TOR,25,82,4,38,42
13,8482475,Yegor Chinakhov,R,CBJ,23,82,27,14,41
13,8477998,Warren Foegele,L,EDM,28,82,25,16,41
13,8480893,Kirill Marchenko,R,CBJ,24,82,24,17,41
13,8475760,Nick Bjugstad,C,ARI,32,82,23,18,41
13,8482667,William Eklund,L,SJS,22,82,22,19,41
13,8477511,Anthony Mantha,R,VGK,30,82,19,22,41
13,8474870,Tyler Johnson,C,CHI,34,82,18,23,41
13,8479525,Ross Colton,C,COL,28,82,17,24,41
13,8474149,Evgenii Dadonov,R,DAL,35,82,17,24,41
13,8480802,Ryan McLeod,C,EDM,25,82,16,25,41
13,8475287,Erik Haula,L,NJD,33,82,15,26,41
13,8482671,Owen Power,D,BUF,22,82,14,27,41
13,8476461,Sean Couturier,C,PHI,32,82,12,29,41
13,8474565,Alex Pietrangelo,D,VGK,34,82,11,30,41
13,8480336,Sean Walker,D,COL,30,82,8,33,41
13,8475764,Cam Fowler,D,ANA,33,82,7,34,41
13,8481560,Arthur Kaliyev,R,LAK,23,82,24,16,40
13,8471698,T.J. Oshie,R,WSH,38,82,19,21,40
13,8478458,Jack Roslovic,C,NYR,27,82,17,23,40
13,8480459,Pius Suter,C,VAN,28,82,17,23,40
13,8475753,Justin Faulk,D,STL,32,82,11,29,40
13,8480873,Rasmus Sandin,D,WSH,24,82,10,30,40
13,8478472,Mathieu Joseph,R,OTT,27,82,9,31,40
13,8477944,Jakub Vrana,L,STL,28,82,24,15,39
13,8482055,Drew O'Connor,L,PIT,26,82,20,19,39
13,8480068,Ryan Poehling,C,PHI,25,82,19,20,39
13,8478542,Evan Rodrigues,C,FLA,31,82,17,22,39
13,8477953,Kasperi Kapanen,R,STL,28,82,16,23,39
13,8482705,Cole Sillinger,C,CBJ,21,82,16,23,39
13,8480871,Adam Boqvist,D,CBJ,24,82,12,27,39
13,8479415,Michael McLeod,C,NJD,26,82,10,29,39
13,8476958,Jaccob Slavin,D,CAR,30,82,7,32,39
13,8476923,Damon Severson,D,CBJ,30,82,7,32,39
13,8482113,Anton Lundell,C,FLA,23,82,14,24,38
13,8477429,Andrew Copp,C,DET,30,82,14,24,38
13,8471218,Blake Wheeler,R,NYR,38,82,13,25,38
13,8477456,J.T. Compher,L,DET,29,82,10,28,38
13,8473422,Nick Foligno,L,CHI,37,82,22,15,37
13,8475314,Anders Lee,L,NYI,34,82,19,18,37
13,8483431,Logan Cooley,C,ARI,20,82,19,18,37
13,8478413,Jordan Greenway,L,BUF,27,82,17,20,37
13,8475763,Kevin Hayes,R,STL,32,82,14,23,37
13,8481546,Cam York,D,PHI,23,82,11,26,37
13,8481656,Aliaksei Protas,C,WSH,23,82,7,30,37
13,8478882,Vladislav Gavrikov,D,LAK,29,82,7,30,37
13,8476917,Adam Pelech,D,NYI,30,82,5,32,37
13,8481535,Nils Hoglander,L,VAN,24,82,23,13,36
13,8476392,Adam Lowry,C,WPG,31,82,17,19,36
13,8476419,Jean-Gabriel Pageau,C,NYI,32,82,16,20,36
13,8473449,Kyle Okposo,R,FLA,36,82,15,21,36
13,8476885,Jacob Trouba,D,NYR,30,82,11,25,36
13,8474716,Jared Spurgeon,D,MIN,35,82,9,27,36
13,8476979,Erik Gustafsson,D,NYR,32,82,8,28,36
13,8477952,Robby Fabbri,C,DET,28,82,17,18,35
13,8479293,Brandon Tanev,L,SEA,33,82,17,18,35
13,8479390,Taylor Raddysh,R,CHI,26,82,16,19,35
13,8474037,James van Riemsdyk,L,BOS,35,82,14,21,35
13,8479353,Brett Howden,C,VGK,26,82,14,21,35
13,8478462,Nicolas Roy,C,VGK,27,82,13,22,35
13,8476925,Colton Sissons,C,NSH,31,82,11,24,35
13,8476292,Ondrej Palat,L,NJD,33,82,7,28,35
13,8476854,Hampus Lindholm,D,BOS,30,82,5,30,35
13,8476331,Dylan DeMelo,D,WPG,31,82,5,30,35
13,8477506,Ryan Pulock,D,NYI,30,82,3,32,35
13,8482111,Justin Barron,D,MTL,23,82,15,19,34
13,8481553,Bobby Brink,R,PHI,23,82,13,21,34
13,8476960,Andreas Athanasiou,C,CHI,30,82,13,21,34
13,8476329,Travis Boyd,C,ARI,31,82,10,24,34
13,8476927,Teddy Blueger,C,VAN,30,82,10,24,34
13,8480078,Filip Chytil,C,NYR,25,82,9,25,34
13,8477989,Christian Dvorak,C,MTL,28,82,7,27,34
13,8477488,Brett Pesce,D,CAR,30,82,7,27,34
13,8478508,Yakov Trenin,C,COL,27,82,22,11,33
13,8479393,Noah Gregor,C,TOR,26,82,16,17,33
13,8481013,Jonatan Berggren,R,DET,24,82,13,20,33
13,8481581,Thomas Harley,D,DAL,23,82,11,22,33
13,8475149,Marcus Johansson,L,MIN,34,82,11,22,33
13,8479398,Samuel Girard,D,COL,26,82,6,27,33
13,8482089,Jake Neighbours,L,STL,22,82,22,10,32
13,8475793,Ryan Johansen,C,PHI,32,82,19,13,32
13,8481624,Ilya Mikheyev,R,VAN,30,82,18,14,32
13,8480220,Noah Cates,L,PHI,25,82,16,16,32
13,8482079,Marco Rossi,C,MIN,23,82,13,19,32
13,8481580,Connor McMichael,C,WSH,23,82,13,19,32
13,8475343,Nic Dowd,C,WSH,34,82,12,20,32
13,8483457,Lane Hutson,D,MTL,20,82,9,23,32
13,8482117,Lukas Reichel,L,CHI,22,82,9,23,32
13,8477948,Travis Sanheim,D,PHI,28,82,8,24,32
13,8481606,Jordan Spence,D,LAK,23,82,7,25,32
13,8475171,Oliver Ekman-Larsson,D,FLA,33,82,4,28,32
13,8475181,Nick Leddy,D,STL,33,82,4,28,32
13,8480073,Erik Brannstrom,D,OTT,25,82,4,28,32
13,8481178,Egor Zamula,D,PHI,24,82,2,30,32
13,8484166,Adam Fantilli,C,CBJ,20,82,14,17,31
13,8484144,Connor Bedard,C,CHI,19,82,13,18,31
13,8478109,Victor Olofsson,L,BUF,29,82,13,18,31
13,8473533,Jordan Staal,C,CAR,36,82,10,21,31
13,8475906,John Klingberg,D,TOR,32,82,7,24,31
13,8476457,Adam Larsson,D,SEA,32,82,7,24,31
13,8482087,Kaiden Guhle,D,MTL,22,82,3,28,31
13,8476469,Joel Armia,R,MTL,31,82,16,14,30
13,8470621,Corey Perry,R,EDM,39,82,14,16,30
13,8476897,Oskar Sundqvist,C,STL,30,82,12,18,30
13,8476873,Mark Jankowski,C,NSH,30,82,12,18,30
13,8481604,Pavel Dorofeyev,L,VGK,24,82,11,19,30
13,8482624,Daniil Miromanov,D,CGY,27,82,10,20,30
13,8480144,David Kampf,C,TOR,29,82,9,21,30
13,8478133,Jake Evans,C,MTL,28,82,8,22,30
13,8480806,Isac Lundestrom,C,ANA,25,82,7,23,30
13,8482142,Jamie Drysdale,D,PHI,22,82,7,23,30
13,8474673,TJ Brodie,D,TOR,34,82,5,25,30
13,8477969,Marcus Pettersson,D,PIT,28,82,3,27,30
13,8481554,Kaapo Kakko,R,NYR,23,82,21,8,29
13,8482125,Alexander Holtz,R,NJD,22,82,17,12,29
13,8479941,Justin Danforth,R,CBJ,31,82,15,14,29
13,8474715,Cam Atkinson,R,PHI,35,82,14,15,29
13,8476278,Colin Blackwell,C,CHI,31,82,11,18,29
13,8481703,Valtteri Puustinen,R,PIT,25,82,10,19,29
13,8474034,Pat Maroon,L,BOS,36,82,8,21,29
13,8482122,Brock Faber,D,MIN,22,82,7,22,29
13,8476921,Jordan Martinook,L,CAR,32,82,15,13,28
13,8478569,Noel Acciari,C,PIT,33,82,13,15,28
13,8480821,Filip Zadina,R,SJS,25,82,11,17,28
13,8481704,Juuso Parssinen,C,NSH,23,82,11,17,28
13,8479996,Cody Glass,C,NSH,25,82,11,17,28
13,8477839,Conor Sheary,L,TBL,32,82,10,18,28
13,8480074,Alexandre Texier,C,CBJ,25,82,10,18,28
13,8481481,Blake Lizotte,C,LAK,27,82,9,19,28
13,8484203,Bradly Nadeau,L,CAR,19,82,9,19,28
13,8482105,Jake Sanderson,D,OTT,22,82,8,20,28
13,8481028,Martin Pospisil,C,CGY,25,82,7,21,28
13,8476463,Jonas Brodin,D,MIN,31,82,6,22,28
13,8480246,Nick Perbix,D,TBL,26,82,6,22,28
13,8477845,Trevor van Riemsdyk,D,WSH,33,82,5,23,28
13,8476878,Zemgus Girgensons,L,BUF,30,82,18,9,27
13,8482259,Bobby McMann,C,TOR,28,82,14,13,27
13,8476480,Vladislav Namestnikov,C,WPG,32,82,13,14,27
13,8477450,Jason Dickinson,C,CHI,29,82,12,15,27
13,8475231,Casey Cizikas,C,NYI,33,82,12,15,27
13,8477392,Hudson Fasching,R,NYI,29,82,11,16,27
13,8481186,Logan O'Connor,R,COL,28,82,10,17,27
13,8479983,Mario Ferraro,D,SJS,26,82,10,17,27
13,8481517,Brett Leason,R,ANA,25,82,8,19,27
13,8477330,Dominik Kubalik,L,OTT,29,82,16,10,26
13,8479591,Michael Eyssimont,C,TBL,28,82,15,11,26
13,8484153,Leo Carlsson,C,ANA,20,82,13,13,26
13,8477425,Miles Wood,L,COL,29,82,12,14,26
13,8482807,Ethan Del Mastro,D,CHI,21,82,7,19,26
13,8477220,Nate Schmidt,D,WPG,33,82,5,21,26
13,8480817,K'Andre Miller,D,NYR,24,82,4,22,26
13,8478399,Jonas Siegenthaler,D,NJD,27,82,3,23,26
13,8476892,Colton Parayko,D,STL,31,82,2,24,26
13,8478416,Erik Cernak,D,TBL,27,82,2,24,26
13,8479371,Dante Fabbro,D,NSH,26,82,1,25,26
13,8479661,Tanner Jeannot,L,TBL,27,82,15,10,25
13,8473504,Cal Clutterbuck,R,NYI,37,82,14,11,25
13,8482702,Logan Stankoven,C,DAL,21,82,11,14,25
13,8481522,Peyton Krebs,C,BUF,23,82,8,17,25
13,8475200,Dmitry Orlov,D,CAR,33,82,8,17,25
13,8473507,Jeff Petry,D,DET,37,82,5,20,25
13,8476312,Josh Manson,D,COL,33,82,4,21,25
13,8474151,Ryan McDonagh,D,NSH,35,82,3,22,25
13,8475462,Radko Gudas,D,ANA,34,82,3,22,25
13,8477426,Nicholas Paul,L,TBL,29,82,13,11,24
13,8480855,Jack McBain,C,ARI,24,82,11,13,24
13,8477435,Ryan Graves,D,PIT,29,82,8,16,24
13,8482733,Logan Mailloux,D,MTL,31,82,8,16,24
13,8478859,Niko Mikkola,D,FLA,28,82,7,17,24
13,8475233,David Savard,D,MTL,34,82,3,21,24
13,8484145,Zach Benson,L,BUF,19,82,15,8,23
13,8479359,Beck Malenstyn,L,WSH,26,82,14,9,23
13,8480448,Parker Kelly,L,OTT,25,82,14,9,23
13,8479977,Kailer Yamamoto,R,SEA,26,82,14,9,23
13,8477508,Curtis Lazar,C,NJD,29,82,14,9,23
13,8478831,Kevin Stenlund,C,FLA,28,82,13,10,23
13,8477015,Connor Brown,R,EDM,30,82,13,10,23
13,8478013,Jake Walman,D,DET,28,82,11,12,23
13,8476374,Sean Kuraly,C,CBJ,31,82,10,13,23
13,8477353,Tyler Motte,C,TBL,29,82,10,13,23
13,8476902,Esa Lindell,D,DAL,30,82,9,14,23
13,8477919,Frederick Gaudreau,C,MIN,31,82,8,15,23
13,8477507,Nikita Zadorov,D,VAN,29,82,8,15,23
13,8479351,Sam Steel,C,DAL,26,82,8,15,23
13,8480796,Martin Fehervary,D,WSH,25,82,7,16,23
13,8482803,Olen Zellweger,D,ANA,21,82,7,16,23
13,8481537,Nikita Okhotiuk,D,CGY,24,82,7,16,23
13,8478451,Ethan Bear,D,WSH,27,82,5,18,23
13,8479324,Ryan Lindgren,D,NYR,26,82,4,19,23
13,8480035,Henri Jokiharju,D,BUF,25,82,3,20,23
13,8476422,Mike Reilly,D,NYI,31,82,3,20,23
13,8476879,Cody Ceci,D,EDM,31,82,1,22,23
13,8482155,Alex Laferriere,R,LAK,23,82,16,6,22
13,8479316,Luke Kunin,C,SJS,27,82,10,12,22
13,8483493,Frank Nazar,C,CHI,20,82,9,13,22
13,8482730,Brandt Clarke,D,LAK,21,82,9,13,22
13,8481093,Rafael Harvey-Pinard,L,MTL,25,82,7,15,22
13,8483505,Matthew Poitras,C,BOS,20,82,6,16,22
13,8476467,Jamie Oleksiak,D,SEA,32,82,3,19,22
13,8475690,Chris Tanev,D,DAL,35,82,3,19,22
13,8482062,Cole Smith,L,NSH,29,82,12,9,21
13,8477505,Alexander Wennberg,C,NYR,30,82,10,11,21
13,8479514,Rem Pitlick,C,CHI,27,82,9,12,21
13,8475220,Marcus Foligno,L,MIN,33,82,9,12,21
13,8473453,Trevor Lewis,C,LAK,37,82,9,12,21
13,8476624,Barclay Goodrow,C,NYR,31,82,8,13,21
13,8478443,Brandon Carlo,D,BOS,28,82,8,13,21
13,8475324,Nick Jensen,D,WSH,34,82,5,16,21
13,8479976,Juuso Valimaki,D,ARI,26,82,4,17,21
13,8479980,Nicolas Hague,D,VGK,26,82,4,17,21
13,8482245,Artem Zub,D,OTT,29,82,3,18,21
13,8475790,Erik Gudbranson,D,CBJ,32,82,3,18,21
13,8478507,John Marino,D,NJD,27,82,1,20,21
13,8479346,Dillon Dube,C,CGY,26,82,12,8,20
13,8470604,Jeff Carter,C,PIT,39,82,10,10,20
13,8480995,Pontus Holmberg,R,TOR,25,82,9,11,20
13,8483763,Maksymilian Szuber,D,ARI,22,82,9,11,20
13,8480813,Joe Veleno,C,DET,24,82,9,11,20
13,8481524,Bowen Byram,D,BUF,23,82,8,12,20
13,8482809,Jackson Blake,R,CAR,21,82,8,12,20
13,8482858,Ryker Evans,D,SEA,23,82,8,12,20
13,8483482,Tristan Luneau,D,ANA,20,82,7,13,20
13,8476525,Colin Miller,D,WPG,32,82,5,15,20
13,8478430,Oliver Kylington,D,CGY,27,82,5,15,20
13,8480879,Jacob Bernard-Docker,D,OTT,24,82,4,16,20
13,8483490,Pavel Mintyukov,D,ANA,21,82,2,18,20
13,8475179,Dmitry Kulikov,D,FLA,34,82,2,18,20
13,8470600,Ryan Suter,D,DAL,39,82,2,18,20
13,8477365,Connor Clifton,D,BUF,29,82,2,18,20
13,8476891,Matt Grzelcyk,D,BOS,30,82,0,20,20
13,8482666,Scott Morrow,D,CAR,22,82,9,10,19
13,8476442,Matt Nieto,L,PIT,32,82,8,11,19
13,8479423,Alex Nylander,L,CBJ,26,82,8,11,19
13,8471677,Jack Johnson,D,COL,37,82,7,12,19
13,8482101,Danil Gushchin,L,SJS,22,82,6,13,19
13,8476429,Scott Mayfield,D,NYI,32,82,5,14,19
13,8484911,Collin Graf,R,SJS,22,82,5,14,19
13,8479442,Troy Stecher,D,EDM,30,82,5,14,19
13,8477499,Rasmus Ristolainen,D,PHI,30,82,4,15,19
13,8481014,Alexander Romanov,D,NYI,24,82,3,16,19
13,8480807,Mattias Samuelsson,D,BUF,24,82,3,16,19
13,8476931,Jake McCabe,D,TOR,31,82,2,17,19
13,8479369,Andrew Peeke,D,BOS,26,82,1,18,19
13,8478136,Jake Middleton,D,MIN,28,82,1,18,19
13,8480058,Pierre-Olivier Joseph,D,PIT,25,82,1,18,19
13,8474574,Tyler Myers,D,VAN,34,82,0,19,19
13,8483524,Shane Wright,C,SEA,20,82,12,6,18
13,8481601,Simon Holmstrom,R,NYI,23,82,10,8,18
13,8483468,Jiri Kulich,C,BUF,20,82,10,8,18
13,8478043,Sam Lafferty,C,VAN,29,82,7,11,18
13,8481016,Ruslan Iskhakov,C,NYI,24,82,7,11,18
13,8477369,Carson Soucy,D,VAN,30,82,6,12,18
13,8482166,Shakir Mukhamadullin,D,SJS,22,82,5,13,18
13,8474013,Ian Cole,D,VAN,35,82,5,13,18
13,8477406,Mattias Janmark,C,EDM,32,82,4,14,18
13,8481699,Aku Raty,R,ARI,23,82,4,14,18
13,8475279,Ben Chiarot,D,DET,33,82,3,15,18
13,8478500,Ivan Provorov,D,CBJ,27,82,3,15,18
13,8481059,Scott Perunovich,D,STL,26,82,2,16,18
13,8483466,Kevin Korchinski,D,CHI,20,82,2,16,18
13,8482074,Connor Zary,C,CGY,23,82,12,5,17
13,8470610,Zach Parise,L,COL,40,82,10,7,17
13,8479383,Boris Katchouk,L,OTT,26,82,9,8,17
13,8474189,Lars Eller,C,PIT,35,82,8,9,17
13,8482679,Matt Coronato,R,CGY,22,82,8,9,17
13,8478178,Darren Raddysh,D,TBL,28,82,5,12,17
13,8483445,Cutter Gauthier,L,ANA,20,82,5,12,17
13,8479998,Mikey Anderson,D,LAK,25,82,5,12,17
13,8483499,Liam Ohgren,L,MIN,20,82,5,12,17
13,8480834,Ty Emberson,D,SJS,24,82,4,13,17
13,8475455,Brenden Dillon,D,WPG,34,82,3,14,17
13,8478851,Alexandre Carrier,D,NSH,28,82,1,16,17
13,8480281,Alexey Toropchenko,R,STL,25,82,12,4,16
13,8484149,Gavin Brindley,C,CBJ,20,82,8,8,16
13,8475164,Jakob Silfverberg,R,ANA,34,82,6,10,16
13,8477931,Tomas Nosek,L,NJD,32,82,6,10,16
13,8482118,Sam Colangelo,R,ANA,23,82,6,10,16
13,8482655,J.J. Moser,D,ARI,24,82,5,11,16
13,8482516,Matthew Kessel,D,STL,24,82,5,11,16
13,8480990,Declan Chisholm,D,MIN,24,82,5,11,16
13,8481568,Alex Vlasic,D,CHI,23,82,4,12,16
13,8470966,Mark Giordano,D,TOR,41,82,4,12,16
13,8482073,Braden Schneider,D,NYR,23,82,4,12,16
13,8480031,Maxime Comtois,L,CAR,25,82,3,13,16
13,8481567,Henry Thrun,D,SJS,23,82,3,13,16
13,8483491,Ivan Miroshnichenko,L,WSH,20,82,3,13,16
13,8483495,Simon Nemec,D,NJD,20,82,1,15,16
13,8478840,Will Borgen,D,SEA,28,82,0,16,16
13,8475842,Sam Carrick,C,EDM,32,82,8,7,15
13,8477335,Kyle Burroughs,D,SJS,29,82,7,8,15
13,8479291,Kevin Rooney,C,CGY,31,82,6,9,15
13,8482762,Simon Edvinsson,D,DET,21,82,5,10,15
13,8482145,Mavrik Bourque,C,DAL,22,82,5,10,15
13,8483565,Nick Blankenburg,D,CBJ,26,82,3,12,15
13,8480172,Jan Rutta,D,SJS,34,82,2,13,15
13,8477034,Jaycob Megna,D,CHI,32,82,2,13,15
13,8482737,Zack Bolduc,C,STL,21,82,6,8,14
13,8483397,Marc McLaughlin,C,BOS,25,82,4,10,14
13,8474166,Alec Martinez,D,VGK,37,82,3,11,14
13,8478468,Jeremy Lauzon,D,NSH,27,82,2,12,14
13,8481605,Jackson LaCombe,D,ANA,23,82,6,7,13
13,8482859,Zack Ostapchuk,C,OTT,21,82,4,9,13
13,8481599,Victor Soderstrom,D,ARI,23,82,3,10,13
13,8475188,Brayden McNabb,D,VGK,33,82,2,11,13
13,8476822,Luke Glendening,C,TBL,35,82,9,3,12
13,8482712,Oskar Olausson,R,COL,22,82,5,7,12
13,8476473,Connor Murphy,D,CHI,31,82,5,7,12
13,8481030,Jack St. Ivany,D,PIT,25,82,4,8,12
13,8482470,Ilya Solovyov,D,CGY,24,82,3,9,12
13,8480860,Kevin Bahl,D,NJD,24,82,0,12,12
13,8474009,Nick Bonino,C,NYR,36,82,4,7,11
13,8474567,Zach Bogosian,D,MIN,34,82,3,8,11
13,8482177,Marat Khusnutdinov,C,MIN,22,82,3,8,11
13,8476967,Brett Kulak,D,EDM,30,82,3,8,11
13,8478408,Travis Dermott,D,ARI,28,82,3,8,11
13,8475177,Calvin de Haan,D,TBL,33,82,2,9,11
13,8475762,Derek Forbort,D,BOS,32,82,1,10,11
13,8476858,Phillip Di Giuseppe,L,VAN,31,82,8,2,10
13,8483471,Brad Lambert,C,WPG,31,82,7,3,10
13,8476915,Jujhar Khaira,L,MIN,30,82,6,4,10
13,8475208,Brian Dumoulin,D,SEA,33,82,1,9,10
13,8483012,Logan Morrison,C,SEA,22,82,5,4,9
13,8482713,Mackie Samoskevich,R,FLA,22,82,5,4,9
13,8476372,Nick Seeler,D,PHI,31,82,4,5,9
13,8475825,Jani Hakanpää,D,DAL,32,82,3,6,9
13,8481578,Graeme Clarke,R,NJD,23,82,5,3,8
13,8483489,Fraser Minten,C,TOR,31,82,3,5,8
13,8477950,Tony DeAngelo,D,CAR,29,0,0,0,0
13,8481577,Philip Tomasino,C,NSH,23,0,0,0,0
13,8482660,Kent Johnson,C,CBJ,22,0,0,0,0
13,8481019,David Gustafsson,C,WPG,24,0,0,0,0
13,8479348,Kale Clague,D,BUF,26,0,0,0,0
13,8482149,Cole Perfetti,C,WPG,22,0,0,0,0
13,8476952,Dominic Toninato,C,WPG,30,0,0,0,0
13,8473473,Milan Lucic,L,BOS,36,0,0,0,0
13,8480829,Jesperi Kotkaniemi,C,CAR,24,0,0,0,0
13,8474602,Justin Schultz,D,SEA,34,0,0,0,0
13,8480049,Dylan Samberg,D,WPG,25,0,0,0,0
13,8479372,Josh Mahura,D,FLA,26,0,0,0,0
13,8480878,Nils Lundkvist,D,DAL,24,0,0,0,0
13,8479982,Conor Timmins,D,TOR,26,0,0,0,0
13,8474031,Kevin Shattenkirk,D,BOS,35,0,0,0,0
13,8480835,Jack Drury,C,CAR,24,0,0,0,0
13,8480008,Adam Ruzicka,C,ARI,25,0,0,0,0
13,8479402,Jake Bean,D,CBJ,26,0,0,0,0
13,8476474,Stefan Noesen,R,CAR,31,0,0,0,0
13,8480884,Calen Addison,D,SJS,24,0,0,0,0
13,8476994,Vinnie Hinostroza,C,PIT,30,0,0,0,0
13,8477987,Ryan Donato,C,CHI,28,0,0,0,0
13,8481582,Nicholas Robertson,L,TOR,23,0,0,0,0
13,8478452,Caleb Jones,D,COL,27,0,0,0,0
13,8480157,Calle Rosen,D,STL,30,0,0,0,0
13,8481609,Vladislav Kolyachonok,D,ARI,23,0,0,0,0
13,8476919,Chris Tierney,C,NJD,30,0,0,0,0
13,8479639,Dylan Coghlan,D,CAR,26,0,0,0,0
13,8475193,Tomas Tatar,L,SEA,34,0,0,0,0
13,8480748,Kiefer Sherwood,L,NSH,29,0,0,0,0
13,8478146,Matthew Highmore,C,OTT,28,0,0,0,0
13,8478970,Jalen Chatfield,D,CAR,28,0,0,0,0
13,8480205,Emil Bemstrom,C,PIT,25,0,0,0,0
13,8471274,Alex Goligoski,D,MIN,39,0,0,0,0
13,8478104,Sammy Blais,L,STL,28,0,0,0,0
13,8476913,Devin Shore,C,SEA,30,0,0,0,0
13,8481708,Zac Jones,D,NYR,24,0,0,0,0
13,8480222,Sebastian Aho,D,NYI,28,0,0,0,0
13,8481598,Philip Broberg,D,EDM,23,0,0,0,0
13,8480789,Oliver Wahlstrom,R,NYI,24,0,0,0,0
13,8480891,Michael Kesselring,D,ARI,24,0,0,0,0
13,8477979,Nicolas Aube-Kubel,R,WSH,28,0,0,0,0
13,8476393,Nick Cousins,C,FLA,31,0,0,0,0
13,8480003,Jesper Boqvist,C,BOS,26,0,0,0,0
13,8479543,Michael Pezzetta,L,MTL,26,0,0,0,0
13,8475855,Jesper Fast,R,CAR,33,0,0,0,0
13,8477018,Ben Hutton,D,VGK,31,0,0,0,0
13,8480762,Eric Robinson,L,BUF,29,0,0,0,0
13,8481058,Jesse Ylönen,R,MTL,25,0,0,0,0
13,8481527,Kaedan Korczak,D,VGK,23,0,0,0,0
13,8482192,Isaak Phillips,D,CHI,23,0,0,0,0
13,8480727,Zach Whitecloud,D,VGK,28,0,0,0,0
13,8480001,Urho Vaakanainen,D,ANA,25,0,0,0,0
13,8480853,Liam Foudy,C,NSH,24,0,0,0,0
13,8475225,Craig Smith,C,DAL,35,0,0,0,0
13,8479972,Mason Shaw,C,MIN,26,0,0,0,0
13,8474040,Sam Gagner,C,EDM,35,0,0,0,0
13,8480196,Jacob Bryson,D,BUF,27,0,0,0,0
13,8475718,Justin Holl,D,DET,32,0,0,0,0
13,8479984,Cal Foote,D,NJD,26,0,0,0,0
13,8480011,Klim Kostin,C,SJS,25,0,0,0,0
13,8482176,Wyatt Kaiser,D,CHI,22,0,0,0,0
13,8476918,Jimmy Vesey,L,NYR,31,0,0,0,0
13,8476988,Matt Benning,D,SJS,30,0,0,0,0
13,8479370,Tyson Jost,C,BUF,26,0,0,0,0
13,8477464,Nic Petan,C,MIN,29,0,0,0,0
13,8477380,Jonny Brodzinski,C,NYR,31,0,0,0,0
13,8480070,Ian Mitchell,D,BOS,25,0,0,0,0
13,8479315,Joey Anderson,R,CHI,26,0,0,0,0
13,8478099,Kevin Labanc,R,SJS,29,0,0,0,0
13,8476874,Olli Maatta,D,DET,30,0,0,0,0
13,8479414,Nathan Bastian,R,NJD,27,0,0,0,0
13,8478434,Keegan Kolesar,R,VGK,27,0,0,0,0
13,8479536,Axel Jonsson-Fjallby,L,WPG,26,0,0,0,0
13,8479671,Mathieu Olivier,R,CBJ,27,0,0,0,0
13,8471709,Marc-Edouard Vlasic,D,SJS,37,0,0,0,0
13,8479328,Julien Gauthier,R,NYI,27,0,0,0,0
13,8478421,A.J. Greer,L,CGY,28,0,0,0,0
13,8477573,Nathan Walker,L,STL,30,0,0,0,0
13,8477478,William Carrier,L,VGK,30,0,0,0,0
13,8479344,Jesse Puljujarvi,R,PIT,26,0,0,0,0
13,8480887,Jordan Harris,D,MTL,24,0,0,0,0
13,8478502,Dennis Gilbert,D,CGY,28,0,0,0,0
13,8480355,Mark Kastelic,C,OTT,25,0,0,0,0
13,8475750,Jon Merrill,D,MIN,32,0,0,0,0
13,8476889,Radek Faksa,C,DAL,30,0,0,0,0
13,8478432,Christian Fischer,R,DET,27,0,0,0,0
13,8479439,Jacob MacDonald,D,SJS,31,0,0,0,0
13,8474568,Luke Schenn,D,NSH,35,0,0,0,0
13,8478454,Noah Juulsen,D,VAN,27,0,0,0,0
13,8475752,Tyler Pitlick,C,NYR,33,0,0,0,0
13,8482148,Hendrix Lapierre,C,WSH,22,0,0,0,0
13,8481167,Brayden Pachal,D,CGY,25,0,0,0,0
13,8478211,Dryden Hunt,L,CGY,29,0,0,0,0
13,8479321,Lucas Johansen,D,WSH,27,0,0,0,0
13,8480950,Ilya Lyubushkin,D,TOR,30,0,0,0,0
13,8479368,Max Jones,L,ANA,26,0,0,0,0
13,8471699,Andrew Cogliano,C,COL,37,0,0,0,0
13,8481521,Ronnie Attard,D,PHI,25,0,0,0,0
13,8481161,Jake Christiansen,D,CBJ,25,0,0,0,0
13,8479458,Nikita Zaitsev,D,CHI,33,0,0,0,0
13,8479619,Michael Carcone,L,ARI,28,0,0,0,0
13,8479026,Philippe Myers,D,TBL,27,0,0,0,0
13,8481617,Vasily Podkolzin,R,VAN,23,0,0,0,0
13,8481701,Santeri Hatakka,D,NJD,23,0,0,0,0
13,8477446,Michael McCarron,R,NSH,29,0,0,0,0
13,8483460,David Jiricek,D,CBJ,21,0,0,0,0
13,8474090,Brendan Smith,D,NJD,35,0,0,0,0
13,8482241,Radim Zohorna,L,PIT,28,0,0,0,0
13,8481032,Paul Cotter,C,VGK,25,0,0,0,0
13,8480289,Morgan Barron,C,WPG,26,0,0,0,0
13,8479379,Givani Smith,R,SJS,26,0,0,0,0
13,8480216,Jacob Peterson,C,SJS,25,0,0,0,0
13,8477851,Jordan Oesterle,D,CGY,32,0,0,0,0
13,8484258,Sam Malinski,D,COL,26,0,0,0,0
13,8478904,Steven Lorentz,C,FLA,28,0,0,0,0
13,8482095,Tyler Kleven,D,OTT,22,0,0,0,0
13,8480980,Connor Dewar,C,TOR,25,0,0,0,0
13,8480848,Ty Dellandrea,C,DAL,24,0,0,0,0
13,8476884,Derrick Pouliot,D,DAL,30,0,0,0,0
13,8480025,MacKenzie Entwistle,R,CHI,25,0,0,0,0
13,8474612,Travis Hamonic,D,OTT,34,0,0,0,0
13,8479336,Carl Grundstrom,R,LAK,27,0,0,0,0
13,8482964,Arber Xhekaj,D,MTL,23,0,0,0,0
13,8471686,Marc Staal,D,PHI,37,0,0,0,0
13,8477887,Patrick Brown,C,BOS,32,0,0,0,0
13,8478495,Denis Gurianov,R,PHI,27,0,0,0,0
13,8481550,Adam Beckman,L,MIN,23,0,0,0,0
13,8480845,Rasmus Kupari,C,WPG,24,0,0,0,0
13,8478585,Derek Ryan,C,EDM,38,0,0,0,0
13,8482141,Lukas Cormier,D,VGK,22,0,0,0,0
13,8477962,Brendan Lemieux,L,CAR,28,0,0,0,0
13,8482861,Vincent Iorio,D,WSH,22,0,0,0,0
13,8479378,Logan Stanley,D,WPG,26,0,0,0,0
13,8473446,Erik Johnson,D,PHI,36,0,0,0,0
13,8481743,Marc Del Gaizo,D,NSH,25,0,0,0,0
13,8478450,Parker Wotherspoon,D,BOS,27,0,0,0,0
13,8477384,Josh Brown,D,ARI,30,0,0,0,0
13,8482165,Yan Kuznetsov,D,CGY,22,0,0,0,0
13,8478424,Jansen Harkins,C,PIT,27,0,0,0,0
13,8482144,Jack Thompson,D,SJS,22,0,0,0,0
13,8479576,Vincent Desharnais,D,EDM,28,0,0,0,0
13,8478512,Austin Czarnik,C,DET,32,0,0,0,0
13,8477527,Ross Johnston,L,ANA,30,0,0,0,0
13,8482094,Daemon Hunt,D,MIN,22,0,0,0,0
13,8481719,Maxwell Crozier,D,TBL,24,0,0,0,0
13,8480192,Johnathan Kovacevic,D,MTL,27,0,0,0,0
13,8479376,Victor Mete,D,PHI,26,0,0,0,0
13,8482511,Mason Lohrei,D,BOS,23,0,0,0,0
13,8478021,William Lagesson,D,ANA,28,0,0,0,0
13,8475795,Dylan McIlrath,D,WSH,32,0,0,0,0
13,8477846,Ryan Carpenter,C,SJS,33,0,0,0,0
13,8481056,Spencer Stastney,D,NSH,24,0,0,0,0
13,8481564,Ryan Johnson,D,BUF,23,0,0,0,0
13,8478017,Mark Friedman,D,VAN,29,0,0,0,0
13,8479320,Max Lajoie,D,TOR,27,0,0,0,0
13,8480075,Cameron Crotty,D,ARI,25,0,0,0,0
13,8484287,Cole McWard,D,VAN,23,0,0,0,0
13,8484254,Akito Hirose,D,VAN,25,0,0,0,0
13,8483407,Brandon Scanlin,D,NYR,25,0,0,0,0
13,8480274,Philip Kemp,D,EDM,25,0,0,0,0
13,8479522,Hardy Haman Aktell,D,WSH,26,0,0,0,0
13,8480007,Jonas Rondbjerg,R,VGK,25,0,0,0,0
13,8477454,Adam Erne,L,EDM,29,0,0,0,0
13,8481679,Maxence Guenette,D,OTT,23,0,0,0,0
13,8477938,Haydn Fleury,D,TBL,28,0,0,0,0
13,8476441,Joel Edmundson,D,TOR,31,0,0,0,0
13,8477903,Garnet Hathaway,R,PHI,33,0,0,0,0
13,8480441,Trey Fix-Wolansky,R,CBJ,25,0,0,0,0
13,8483546,Marshall Rifai,D,TOR,26,0,0,0,0
13,8480084,Nick DeSimone,D,NJD,30,0,0,0,0
13,8481592,Jakob Pelletier,L,CGY,23,0,0,0,0
13,8478011,Louie Belpedio,D,PHI,28,0,0,0,0
13,8477930,Pierre-Edouard Bellemare,L,SEA,39,0,0,0,0
13,8484321,Nikolas Matinpalo,D,OTT,26,0,0,0,0
13,8482067,Connor Mackey,D,NYR,28,0,0,0,0
13,8481806,Louis Crevier,D,CHI,23,0,0,0,0
13,8484326,Patrik Koch,D,ARI,28,0,0,0,0
13,8477971,Andreas Englund,D,LAK,28,0,0,0,0
13,8481751,Lukas Rousek,R,BUF,25,0,0,0,0
13,8481006,Tyler Tucker,D,STL,24,0,0,0,0
13,8481641,Joel Kiviranta,L,COL,28,0,0,0,0
13,8476867,Brendan Gaunce,C,CBJ,30,0,0,0,0
13,8479520,Brandon Duhaime,R,COL,27,0,0,0,0
13,8477073,Kurtis MacDermid,L,NJD,30,0,0,0,0
13,8480874,Adam Ginning,D,PHI,24,0,0,0,0
13,8477473,Justin Bailey,R,SJS,29,0,0,0,0
13,8479066,Ryan Lomberg,L,FLA,30,0,0,0,0
13,8477070,Liam O'Brien,C,ARI,30,0,0,0,0
13,8474618,Marco Scandella,D,STL,34,0,0,0,0
13,8475797,Jarred Tinordi,D,CHI,32,0,0,0,0
13,8481441,Joe Snively,C,WSH,28,0,0,0,0
13,8477244,Chad Ruhwedel,D,NYR,34,0,0,0,0
13,8482077,Dylan Holloway,L,EDM,23,0,0,0,0
13,8479772,Zack MacEwen,R,OTT,28,0,0,0,0
13,8481147,Reese Johnson,C,CHI,26,0,0,0,0
13,8481043,Cole Koepke,L,TBL,26,0,0,0,0
13,8483619,Filip Roos,D,CHI,25,0,0,0,0
13,8481541,Samuel Bolduc,D,NYI,24,0,0,0,0
13,8477810,Joel Hanley,D,CGY,33,0,0,0,0
13,8476907,Mackenzie MacEachern,L,STL,30,0,0,0,0
13,8482652,Walker Duehr,R,CGY,27,0,0,0,0
13,8477126,Jayson Megna,C,BOS,34,0,0,0,0
13,8483398,Declan Carlile,D,TBL,31,0,0,0,0
13,8482929,Emil Lilleberg,D,TBL,23,0,0,0,0
13,8480880,Jakub Lauko,C,BOS,24,0,0,0,0
13,8478874,Adam Gaudette,C,STL,28,0,0,0,0
13,8480245,Olle Lycksell,R,PHI,25,0,0,0,0
13,8480252,Cole Guttman,C,CHI,25,0,0,0,0
13,8477467,Gustav Olofsson,D,SEA,30,0,0,0,0
13,8479968,Vinni Lettieri,C,MIN,29,0,0,0,0
13,8478400,Colin White,C,MTL,27,0,0,0,0
13,8475755,Alexander Petrovic,D,DAL,32,0,0,0,0
13,8481812,Nikolai Knyzhov,D,SJS,27,0,0,0,0
13,8481593,Jayden Struble,D,MTL,23,0,0,0,0
13,8481532,Alex Turcotte,C,LAK,23,0,0,0,0
13,8482126,Emil Andrae,D,PHI,31,0,0,0,0
13,8479944,Zach Aston-Reese,C,DET,30,0,0,0,0
13,8471817,Ryan Reaves,R,TOR,37,0,0,0,0
13,8481206,John Ludvig,D,PIT,24,0,0,0,0
13,8480292,Carson Meyer,R,CBJ,27,0,0,0,0
13,8482496,Nils Aman,C,VAN,24,0,0,0,0
13,8479718,Alex Barré-Boulet,C,TBL,27,0,0,0,0
13,8479994,Jaret Anderson-Dolan,C,NSH,25,0,0,0,0
13,8480184,Gustav Lindstrom,D,ANA,26,0,0,0,0
13,8480890,Jan Jenik,R,ARI,24,0,0,0,0
13,8478067,Oskar Lindblom,L,SJS,28,0,0,0,0
13,8476934,Brock McGinn,L,ANA,30,0,0,0,0
13,8479985,Cale Fleury,D,SEA,26,0,0,0,0
13,8482153,Brendan Brisson,C,VGK,23,0,0,0,0
13,8480021,Jack Studnicka,C,SJS,25,0,0,0,0
13,8484304,Uvis Balinskis,D,FLA,28,0,0,0,0
13,8479981,Jonah Gadjovich,L,FLA,26,0,0,0,0
13,8481716,Dmitri Voronkov,L,CBJ,24,0,0,0,0
13,8482659,Josh Doan,R,ARI,22,0,0,0,0
13,8481122,Simon Benoit,D,TOR,26,0,0,0,0
13,8474709,Matt Martin,L,NYI,35,0,0,0,0
13,8482634,Alex Steeves,C,TOR,25,0,0,0,0
13,8480823,Alexander Alexeyev,D,WSH,25,0,0,0,0
13,8477541,Dakota Mermis,D,MIN,30,0,0,0,0
13,8478477,Mitchell Stephens,C,MTL,27,0,0,0,0
13,8481543,Nikita Alexandrov,C,STL,24,0,0,0,0
13,8482451,Mikael Pyyhtia,L,CBJ,23,0,0,0,0
13,8480306,Grant Hutton,D,NYI,29,0,0,0,0
13,8478028,Fredrik Olofsson,L,COL,28,0,0,0,0
13,8477462,Robert Hagg,D,ANA,29,0,0,0,0
13,8477320,Anton Blidh,L,NYR,29,0,0,0,0
13,8482749,Joshua Roy,R,MTL,21,0,0,0,0
13,8482157,Will Cuylle,L,NYR,22,0,0,0,0
13,8481239,Samuel Fagemo,L,LAK,24,0,0,0,0
13,8481600,Tobias Bjornfot,D,FLA,23,0,0,0,0
13,8478409,Anthony Richard,C,BOS,28,0,0,0,0
13,8474145,Robert Bortuzzo,D,NYI,35,0,0,0,0
13,8475958,Michael Sgarbossa,C,WSH,32,0,0,0,0
13,8479986,Kole Lind,R,SEA,26,0,0,0,0
13,8479249,Andrew Poturalski,C,SEA,30,0,0,0,0
13,8479362,Riley Tufte,L,COL,26,0,0,0,0
13,8479991,Jake Leschyshyn,C,NYR,25,0,0,0,0
13,8479587,Rhett Gardner,C,PHI,28,0,0,0,0
13,8482744,James Malatesta,L,CBJ,21,0,0,0,0
13,8478854,Ryan Shea,D,PIT,27,0,0,0,0
13,8481591,Sam Poulin,R,PIT,23,0,0,0,0
13,8483512,Matt Savoie,C,BUF,20,0,0,0,0
13,8482102,Vasily Ponomarev,C,CAR,22,0,0,0,0
13,8482162,Roby Jarventie,L,OTT,22,0,0,0,0
13,8482172,Landon Slaggert,L,CHI,22,0,0,0,0
13,8482747,Brennan Othmann,L,NYR,21,0,0,0,0
13,8480226,Marián Studenic,R,SEA,26,0,0,0,0
13,8481518,Nolan Foote,L,NJD,24,0,0,0,0
13,8479419,Brett Murray,L,BUF,26,0,0,0,0
13,8482088,Justin Sourdif,R,FLA,22,0,0,0,0
13,8482201,Gage Goncalves,C,TBL,23,0,0,0,0
13,8481754,Nikita Nesterenko,C,ANA,23,0,0,0,0
13,8483531,Brian Halonen,L,NJD,25,0,0,0,0
13,8483920,Pierrick Dube,R,WSH,23,0,0,0,0
13,8480851,Akil Thomas,C,LAK,24,0,0,0,0
13,8475235,Nicolas Deslauriers,L,PHI,33,0,0,0,0
13,8482476,Emil Heineman,L,MTL,23,0,0,0,0
13,8477149,Scott Sabourin,R,SJS,32,0,0,0,0
13,8483549,Lucas Condotta,L,MTL,27,0,0,0,0
13,8483567,Georgii Merkulov,C,BOS,24,0,0,0,0
13,8482765,Isak Rosen,R,BUF,21,0,0,0,0
13,8481237,Kyle MacLean,C,NYI,25,0,0,0,0
13,8481024,Linus Karlsson,C,VAN,25,0,0,0,0
13,8481690,Tyler Angle,C,CBJ,24,0,0,0,0
13,8483570,Ben Meyers,C,ANA,26,0,0,0,0
13,8481655,Cole Schwindt,R,CGY,23,0,0,0,0
13,8481462,Mason Morelli,L,VGK,28,0,0,0,0
13,8483401,Marc Johnstone,R,PIT,28,0,0,0,0
13,8478956,Samuel Laberge,L,NJD,27,0,0,0,0
13,8479533,Joona Koppanen,L,PIT,26,0,0,0,0
13,8482197,Adam Raska,R,MIN,23,0,0,0,0
13,8482250,Callahan Burke,C,CAR,27,0,0,0,0
13,8482784,Zach Dean,C,STL,21,0,0,0,0
13,8484255,Jason Polin,R,COL,25,0,0,0,0
13,8481077,John Leonard,L,ARI,26,0,0,0,0
13,8481534,Raphael Lavoie,C,EDM,24,0,0,0,0
13,8483609,Adam Klapka,R,CGY,24,0,0,0,0
13,8482751,Ryan Winterton,C,SEA,21,0,0,0,0
13,8480267,Sammy Walker,C,MIN,25,0,0,0,0
13,8475766,Austin Watson,L,TBL,32,0,0,0,0
13,8482460,Matt Rempe,C,NYR,22,0,0,0,0
13,8482787,Nikita Chibrikov,R,WPG,31,0,0,0,0
13,8481065,Angus Crookshank,L,OTT,25,0,0,0,0
13,8481070,Hugh McGing,L,STL,26,0,0,0,0
13,8476323,Max McCormick,L,SEA,32,0,0,0,0
13,8483395,Arshdeep Bains,L,VAN,23,0,0,0,0
13,8484259,Ondrej Pavel,C,COL,31,0,0,0,0
13,8483432,Luca Del Bel Belluz,C,CBJ,31,0,0,0,0
13,8483045,Cameron Butler,R,CBJ,31,0,0,0,0
13,8482061,Brandon Biro,L,BUF,26,0,0,0,0
13,8477401,John Hayden,C,SEA,29,0,0,0,0
13,8475278,Byron Froese,C,VGK,33,0,0,0,0
13,8478446,Glenn Gawdin,C,ANA,27,0,0,0,0
13,8477993,Justin Kirkland,C,ARI,28,0,0,0,0
13,8482147,Jean-Luc Foudy,C,COL,22,0,0,0,0
13,8480032,Shane Bowers,C,NJD,25,0,0,0,0
13,8479330,Brandon Gignac,C,MTL,27,0,0,0,0
13,8480776,Sheldon Rempal,R,VGK,29,0,0,0,0
13,8475413,Justin Dowling,C,NJD,34,0,0,0,0
13,8481726,Adam Edstrom,C,NYR,24,0,0,0,0
13,8479638,Justin Brazeau,R,BOS,26,0,0,0,0
13,8480844,Grigori Denisenko,L,VGK,24,0,0,0,0
13,8474062,Riley Nash,C,NYR,35,0,0,0,0
13,8478147,Bokondji Imama,L,OTT,28,0,0,0,0
13,8478881,Brett Seney,L,CHI,28,0,0,0,0
13,8483630,Pavol Regenda,L,ANA,25,0,0,0,0
13,8480836,Jonathan Gruden,C,PIT,24,0,0,0,0
13,8484314,Jiri Smejkal,L,OTT,28,0,0,0,0
13,8475780,Chris Wagner,R,COL,33,0,0,0,0
13,8482070,Mitchell Chaffee,R,TBL,26,0,0,0,0
13,8479546,Oskar Steen,C,BOS,26,0,0,0,0
13,8483597,Milos Kelemen,L,ARI,25,0,0,0,0
13,8481789,Tye Kartye,L,SEA,23,0,0,0,0
13,8484325,Waltteri Merela,C,TBL,26,0,0,0,0
13,8479421,Jacob Moverare,D,LAK,26,0,0,0,0
13,8481585,Egor Afanasyev,L,NSH,23,0,0,0,0
13,8479547,Matthew Phillips,R,WSH,26,0,0,0,0
13,8479367,William Lockwood,R,FLA,26,0,0,0,0
13,8481422,Jacob Lucchini,C,MIN,29,0,0,0,0
13,8480468,James Hamblin,L,EDM,25,0,0,0,0
13,8480870,Bo Groulx,C,ANA,24,0,0,0,0
13,8478051,Max Willman,C,NJD,29,0,0,0,0
13,8481556,John Beecher,C,BOS,23,0,0,0,0
13,8478078,Rourke Chartier,C,OTT,28,0,0,0,0
14,8477492,Nathan MacKinnon,C,COL,29,82,59,87,146
14,8476453,Nikita Kucherov,R,TBL,31,82,42,103,145
14,8477956,David Pastrnak,R,BOS,28,82,67,67,134
14,8479318,Auston Matthews,C,TOR,27,82,68,64,132
14,8478402,Connor McDavid,C,EDM,27,82,48,84,132
14,8476468,J.T. Miller,C,VAN,31,82,44,80,124
14,8477934,Leon Draisaitl,C,EDM,29,82,46,74,120
14,8481559,Jack Hughes,C,NJD,23,82,51,68,119
14,8478550,Artemi Panarin,L,NYR,33,82,44,71,115
14,8471675,Sidney Crosby,C,PIT,37,82,39,74,113
14,8480027,Jason Robertson,L,DAL,25,82,48,62,110
14,8477493,Aleksander Barkov,C,FLA,29,82,31,79,110
14,8479343,Clayton Keller,R,ARI,26,82,48,59,107
14,8478864,Kirill Kaprizov,L,MIN,27,82,47,60,107
14,8480012,Elias Pettersson,C,VAN,26,82,42,63,105
14,8479314,Matthew Tkachuk,L,FLA,27,82,31,73,104
14,8476887,Filip Forsberg,L,NSH,30,82,45,57,102
14,8479407,Jesper Bratt,L,NJD,26,82,37,64,101
14,8482116,Tim Stützle,C,OTT,22,82,36,64,100
14,8477946,Dylan Larkin,C,DET,28,82,37,59,96
14,8478010,Brayden Point,C,TBL,28,82,47,47,94
14,8477939,William Nylander,R,TOR,28,82,39,52,91
14,8477942,Kevin Fiala,L,LAK,28,82,30,61,91
14,8476346,Johnny Gaudreau,L,CBJ,31,82,23,66,89
14,8471215,Evgeni Malkin,C,PIT,38,82,37,51,88
14,8480002,Nico Hischier,C,NJD,25,82,33,55,88
14,8478445,Mathew Barzal,C,NYI,27,82,24,64,88
14,8478398,Kyle Connor,L,WPG,28,82,40,47,87
14,8478439,Travis Konecny,R,PHI,27,82,38,49,87
14,8478403,Jack Eichel,C,VGK,28,82,37,50,87
14,8475172,Nazem Kadri,C,CGY,34,82,30,57,87
14,8481557,Matt Boldy,L,MIN,23,82,37,49,86
14,8477402,Pavel Buchnevich,L,STL,29,82,33,53,86
14,8478414,Timo Meier,R,NJD,28,82,33,53,86
14,8478420,Mikko Rantanen,R,COL,28,82,40,45,85
14,8471214,Alex Ovechkin,L,WSH,39,82,41,42,83
14,8480830,Andrei Svechnikov,R,CAR,24,82,31,52,83
14,8478427,Sebastian Aho,C,CAR,27,82,42,40,82
14,8475810,Bryan Rust,R,PIT,32,82,40,42,82
14,8480801,Brady Tkachuk,L,OTT,25,82,36,46,82
14,8480800,Quinn Hughes,D,VAN,25,82,11,71,82
14,8477949,Alex Tuch,R,BUF,28,82,29,52,81
14,8479420,Tage Thompson,C,BUF,27,82,49,31,80
14,8474564,Steven Stamkos,C,TBL,34,82,35,45,80
14,8475166,John Tavares,C,TOR,34,82,36,43,79
14,8474600,Roman Josi,D,NSH,34,82,28,51,79
14,8477416,Oliver Bjorkstrand,R,SEA,29,82,27,52,79
14,8476454,Ryan Nugent-Hopkins,C,EDM,31,82,26,53,79
14,8480023,Robert Thomas,C,STL,25,82,22,57,79
14,8475692,Mats Zuccarello,R,MIN,37,82,14,65,79
14,8477933,Sam Reinhart,C,FLA,29,82,32,46,78
14,8480018,Nick Suzuki,C,MTL,25,82,23,55,78
14,8480069,Cale Makar,D,COL,26,82,16,62,78
14,8478460,Zach Werenski,D,CBJ,27,82,16,62,78
14,8476389,Vincent Trocheck,C,NYR,31,82,32,45,77
14,8479542,Brandon Hagel,L,TBL,26,82,30,47,77
14,8470794,Joe Pavelski,C,DAL,40,82,40,36,76
14,8479323,Adam Fox,D,NYR,26,82,17,59,76
14,8476462,Dougie Hamilton,D,NJD,31,82,27,48,75
14,8478401,Pavel Zacha,C,BOS,27,82,27,48,75
14,8475168,Matt Duchene,C,DAL,33,82,21,54,75
14,8477501,Valeri Nichushkin,R,COL,29,82,33,41,74
14,8477504,Josh Morrissey,D,WPG,29,82,18,56,74
14,8476460,Mark Scheifele,C,WPG,31,82,34,39,73
14,8475754,Brock Nelson,C,NYI,33,82,33,40,73
14,8477404,Jake Guentzel,C,CAR,30,82,37,34,71
14,8475765,Vladimir Tarasenko,R,FLA,33,82,26,45,71
14,8476853,Morgan Rielly,D,TOR,30,82,15,56,71
14,8478366,Frank Vatrano,R,ANA,30,82,30,40,70
14,8478407,Vince Dunn,D,SEA,28,82,19,51,70
14,8475167,Victor Hedman,D,TBL,34,82,13,57,70
14,8477409,Carter Verhaeghe,C,FLA,29,82,32,37,69
14,8477940,Nikolaj Ehlers,L,WPG,28,82,25,44,69
14,8477960,Adrian Kempe,R,LAK,28,82,24,45,69
14,8475158,Ryan O'Reilly,C,NSH,33,82,21,48,69
14,8480036,Miro Heiskanen,D,DAL,25,82,19,50,69
14,8473419,Brad Marchand,L,BOS,36,82,18,51,69
14,8480839,Rasmus Dahlin,D,BUF,24,82,16,53,69
14,8478444,Brock Boeser,R,VAN,27,82,31,37,68
14,8476459,Mika Zibanejad,C,NYR,31,82,29,39,68
14,8476881,Tomas Hertl,C,VGK,31,82,27,41,68
14,8479337,Alex DeBrincat,R,DET,27,82,24,44,68
14,8473512,Claude Giroux,R,OTT,36,82,20,48,68
14,8476905,Chandler Stephenson,C,VGK,30,82,19,49,68
14,8477495,Seth Jones,D,CHI,30,82,18,50,68
14,8474590,John Carlson,D,WSH,34,82,15,53,68
14,8476432,Boone Jenner,C,CBJ,31,82,35,32,67
14,8474141,Patrick Kane,R,DET,36,82,27,40,67
14,8481523,Kirby Dach,C,MTL,23,82,16,51,67
14,8474578,Erik Karlsson,D,PIT,34,82,14,53,67
14,8475786,Zach Hyman,L,EDM,32,82,33,33,66
14,8478873,Troy Terry,R,ANA,27,82,25,41,66
14,8478440,Dylan Strome,C,WSH,27,82,17,49,66
14,8474679,Gustav Nyquist,C,NSH,35,82,14,52,66
14,8479339,Patrik Laine,L,CBJ,26,82,34,31,65
14,8477479,Tyler Bertuzzi,L,TOR,29,82,26,39,65
14,8477494,Jonathan Drouin,L,COL,29,82,24,41,65
14,8477951,Nick Schmaltz,C,ARI,28,82,23,42,65
14,8477986,Brandon Montour,D,FLA,30,82,23,42,65
14,8471685,Anze Kopitar,C,LAK,37,82,19,46,65
14,8477935,Sam Bennett,C,FLA,28,82,30,34,64
14,8480015,Owen Tippett,R,PHI,25,82,27,37,64
14,8476448,William Karlsson,C,VGK,31,82,26,38,64
14,8478449,Roope Hintz,C,DAL,28,82,25,39,64
14,8474586,Jordan Eberle,R,SEA,34,82,25,39,64
14,8476456,Jonathan Huberdeau,C,CGY,31,82,18,46,64
14,8480014,Gabriel Vilardi,C,WPG,25,82,36,27,63
14,8477955,Jared McCann,L,SEA,28,82,25,38,63
14,8473994,Jamie Benn,L,DAL,35,82,25,38,63
14,8480078,Filip Chytil,C,NYR,25,82,21,42,63
14,8475913,Mark Stone,R,VGK,32,82,16,47,63
14,8480803,Evan Bouchard,D,EDM,25,82,11,52,63
14,8481528,Dylan Cozens,C,BUF,23,82,30,32,62
14,8478042,Viktor Arvidsson,R,LAK,31,82,27,35,62
14,8479400,Pierre-Luc Dubois,L,LAK,26,82,27,35,62
14,8474102,David Perron,L,DET,36,82,26,36,62
14,8482097,Jack Quinn,R,BUF,23,82,23,39,62
14,8475184,Chris Kreider,L,NYR,33,82,41,20,61
14,8477500,Bo Horvat,C,NYI,29,82,36,25,61
14,8478493,Joel Eriksson Ek,C,MIN,27,82,31,30,61
14,8475170,Brayden Schenn,C,STL,33,82,30,31,61
14,8482159,Tyson Foerster,R,PHI,22,82,26,35,61
14,8482078,Lucas Raymond,L,DET,22,82,24,37,61
14,8475791,Taylor Hall,L,CHI,33,82,22,39,61
14,8477447,Shea Theodore,D,VGK,29,82,8,53,61
14,8476880,Tom Wilson,R,WSH,30,82,30,30,60
14,8479385,Jordan Kyrou,C,STL,26,82,27,33,60
14,8476539,Jonathan Marchessault,R,VGK,34,82,29,30,59
14,8478975,Mason Marchment,L,DAL,29,82,28,31,59
14,8475784,Jeff Skinner,C,BUF,32,82,25,34,59
14,8482665,Matty Beniers,C,SEA,22,82,19,40,59
14,8476875,Mike Matheson,D,MTL,30,82,15,44,59
14,8474565,Alex Pietrangelo,D,VGK,34,82,15,44,59
14,8475768,Jaden Schwartz,C,SEA,32,82,30,28,58
14,8475745,Charlie Coyle,C,BOS,32,82,26,32,58
14,8479345,Jakob Chychrun,D,OTT,26,82,23,35,58
14,8475744,Evgeny Kuznetsov,C,CAR,32,82,19,39,58
14,8482684,Luke Hughes,D,NJD,21,82,12,46,58
14,8479325,Charlie McAvoy,D,BOS,27,82,11,47,58
14,8480064,Josh Norris,C,OTT,25,82,32,25,57
14,8482093,Seth Jarvis,C,CAR,22,82,26,31,57
14,8478047,Michael Bunting,L,PIT,29,82,23,34,57
14,8480798,Philipp Kurashev,C,CHI,25,82,23,34,57
14,8477456,J.T. Compher,L,DET,29,82,22,35,57
14,8477444,Andre Burakovsky,L,SEA,29,82,19,38,57
14,8475726,Tyler Toffoli,C,WPG,32,82,33,23,56
14,8482124,Quinton Byfield,R,LAK,22,82,24,32,56
14,8477932,Aaron Ekblad,D,FLA,28,82,19,37,56
14,8475798,Mikael Granlund,C,SJS,32,82,18,38,56
14,8481711,Matias Maccelli,L,ARI,24,82,16,40,56
14,8480865,Noah Dobson,D,NYI,24,82,9,47,56
14,8471724,Kris Letang,D,PIT,37,82,9,47,56
14,8482740,Wyatt Johnston,C,DAL,21,82,33,22,55
14,8481533,Trevor Zegras,C,ANA,23,82,29,26,55
14,8482667,William Eklund,L,SJS,22,82,28,27,55
14,8475793,Ryan Johansen,C,PHI,32,82,26,29,55
14,8478542,Evan Rodrigues,C,FLA,31,82,21,34,55
14,8478396,Noah Hanifin,D,VGK,27,82,18,37,55
14,8477451,Ryan Hartman,R,MIN,30,82,30,24,54
14,8474157,Max Pacioretty,L,WSH,36,82,29,25,54
14,8480208,Drake Batherson,R,OTT,26,82,26,28,54
14,8475714,Calle Jarnkrok,C,TOR,33,82,25,29,54
14,8477496,Elias Lindholm,C,VAN,30,82,23,31,54
14,8477407,Anthony Duclair,L,TBL,29,82,29,24,53
14,8482745,Mason McTavish,C,ANA,21,82,29,24,53
14,8477476,Artturi Lehkonen,L,COL,29,82,28,25,53
14,8482113,Anton Lundell,C,FLA,23,82,28,25,53
14,8476479,Phillip Danault,C,LAK,31,82,25,28,53
14,8480039,Martin Necas,C,CAR,25,82,15,38,53
14,8476906,Shayne Gostisbehere,D,DET,31,82,12,41,53
14,8475764,Cam Fowler,D,ANA,33,82,3,50,53
14,8480893,Kirill Marchenko,R,CBJ,24,82,29,23,52
14,8479675,Trevor Moore,L,LAK,29,82,22,30,52
14,8482699,Dylan Guenther,R,ARI,21,82,22,30,52
14,8476826,Yanni Gourde,C,SEA,33,82,21,31,52
14,8477511,Anthony Mantha,R,VGK,30,82,19,33,52
14,8478438,Tommy Novak,C,NSH,27,82,18,34,52
14,8481596,Shane Pinto,C,OTT,24,82,15,37,52
14,8479425,Filip Hronek,D,VAN,27,82,6,46,52
14,8477964,Ivan Barbashev,C,VGK,29,82,26,25,51
14,8476399,Blake Coleman,C,CGY,33,82,25,26,51
14,8480188,Fabian Zetterlund,L,SJS,25,82,23,28,51
14,8478038,Devon Toews,D,COL,30,82,12,39,51
14,8476854,Hampus Lindholm,D,BOS,30,82,8,43,51
14,8481560,Arthur Kaliyev,R,LAK,23,82,25,25,50
14,8480028,Morgan Frost,C,PHI,25,82,23,27,50
14,8482109,Alexis Lafrenière,L,NYR,23,82,18,32,50
14,8478397,Rasmus Andersson,D,CGY,28,82,10,40,50
14,8475197,Tyson Barrie,D,NSH,33,82,10,40,50
14,8474563,Drew Doughty,D,LAK,35,82,8,42,50
14,8478046,Danton Heinen,L,BOS,29,82,23,26,49
14,8481540,Cole Caufield,R,MTL,23,82,22,27,49
14,8480849,Barrett Hayton,C,ARI,24,82,22,27,49
14,8475191,Reilly Smith,R,PIT,33,82,21,28,49
14,8476292,Ondrej Palat,L,NJD,33,82,21,28,49
14,8474037,James van Riemsdyk,L,BOS,35,82,24,24,48
14,8481068,Yegor Sharangovich,C,CGY,26,82,23,25,48
14,8479987,Morgan Geekie,C,BOS,26,82,22,26,48
14,8473986,Alex Killorn,L,ANA,35,82,21,27,48
14,8478856,Conor Garland,R,VAN,28,82,21,27,48
14,8484144,Connor Bedard,C,CHI,19,82,15,33,48
14,8475169,Evander Kane,L,EDM,33,82,27,20,47
14,8475760,Nick Bjugstad,C,ARI,32,82,27,20,47
14,8478474,Lawson Crouse,L,ARI,27,82,26,21,47
14,8478519,Anthony Cirelli,C,TBL,27,82,22,25,47
14,8477947,Sonny Milano,L,WSH,28,82,22,25,47
14,8477429,Andrew Copp,C,DET,30,82,19,28,47
14,8480220,Noah Cates,L,PHI,25,82,17,30,47
14,8474149,Evgenii Dadonov,R,DAL,35,82,15,32,47
14,8475753,Justin Faulk,D,STL,32,82,12,35,47
14,8476869,Brady Skjei,D,CAR,30,82,11,36,47
14,8478055,Gustav Forsling,D,FLA,28,82,9,38,47
14,8476958,Jaccob Slavin,D,CAR,30,82,9,38,47
14,8477952,Robby Fabbri,C,DET,28,82,25,21,46
14,8478233,Andrew Mangiapane,L,CGY,28,82,22,24,46
14,8475287,Erik Haula,L,NJD,33,82,22,24,46
14,8475151,Kyle Palmieri,C,NYI,33,82,21,25,46
14,8473422,Nick Foligno,L,CHI,37,82,20,26,46
14,8480797,Joel Farabee,L,PHI,24,82,18,28,46
14,8477497,Sean Monahan,C,WPG,30,82,16,30,46
14,8480434,Sean Durzi,D,ARI,26,82,6,40,46
14,8479293,Brandon Tanev,L,SEA,33,82,25,20,45
14,8480009,Eeli Tolvanen,R,SEA,25,82,24,21,45
14,8478466,Daniel Sprong,R,DET,27,82,18,27,45
14,8483515,Juraj Slafkovsky,L,MTL,20,82,17,28,45
14,8474870,Tyler Johnson,C,CHI,34,82,17,28,45
14,8478498,Jake DeBrusk,L,BOS,28,82,16,29,45
14,8481581,Thomas Harley,D,DAL,23,82,13,32,45
14,8479999,Casey Mittelstadt,C,COL,26,82,11,34,45
14,8482222,Alexander Barabanov,L,SJS,30,82,11,34,45
14,8476882,Teuvo Teravainen,L,CAR,30,82,10,35,45
14,8480145,Neal Pionk,D,WPG,29,82,9,36,45
14,8476483,Rickard Rakell,R,PIT,31,82,27,17,44
14,8475794,Tyler Seguin,C,DAL,32,82,17,27,44
14,8477426,Nicholas Paul,L,TBL,29,82,17,27,44
14,8478469,Thomas Chabot,D,OTT,27,82,11,33,44
14,8476792,Torey Krug,D,STL,33,82,10,34,44
14,8477503,Max Domi,C,TOR,29,82,7,37,44
14,8482110,Dawson Mercer,C,NJD,23,82,21,22,43
14,8474150,Mikael Backlund,C,CGY,35,82,20,23,43
14,8477021,Alex Kerfoot,C,ARI,30,82,13,30,43
14,8477953,Kasperi Kapanen,R,STL,28,82,11,32,43
14,8481542,Moritz Seider,D,DET,23,82,7,36,43
14,8471698,T.J. Oshie,R,WSH,38,82,19,23,42
14,8476872,Scott Laughton,C,PHI,30,82,18,24,42
14,8475763,Kevin Hayes,R,STL,32,82,17,25,42
14,8479365,Trent Frederic,C,BOS,26,82,16,26,42
14,8478472,Mathieu Joseph,R,OTT,27,82,15,27,42
14,8476392,Adam Lowry,C,WPG,31,82,15,27,42
14,8478109,Victor Olofsson,L,BUF,29,82,14,28,42
14,8475149,Marcus Johansson,L,MIN,34,82,13,29,42
14,8475171,Oliver Ekman-Larsson,D,FLA,33,82,13,29,42
14,8479415,Michael McLeod,C,NJD,26,82,12,30,42
14,8476902,Esa Lindell,D,DAL,30,82,12,30,42
14,8479410,Mikhail Sergachev,D,TBL,26,82,11,31,42
14,8470613,Brent Burns,D,CAR,39,82,11,31,42
14,8474716,Jared Spurgeon,D,MIN,35,82,11,31,42
14,8479390,Taylor Raddysh,R,CHI,26,82,21,20,41
14,8482175,JJ Peterka,R,BUF,22,82,18,23,41
14,8476458,Ryan Strome,C,ANA,31,82,16,25,41
14,8471218,Blake Wheeler,R,NYR,38,82,15,26,41
14,8475218,Mattias Ekholm,D,EDM,34,82,13,28,41
14,8477498,Darnell Nurse,D,EDM,29,82,12,29,41
14,8476329,Travis Boyd,C,ARI,31,82,11,30,41
14,8482671,Owen Power,D,BUF,22,82,10,31,41
14,8480817,K'Andre Miller,D,NYR,24,82,7,34,41
14,8480871,Adam Boqvist,D,CBJ,24,82,5,36,41
14,8475314,Anders Lee,L,NYI,34,82,26,14,40
14,8475722,Jason Zucker,L,NSH,32,82,21,19,40
14,8479591,Michael Eyssimont,C,TBL,28,82,20,20,40
14,8480459,Pius Suter,C,VAN,28,82,18,22,40
14,8480185,Eetu Luostarinen,C,FLA,26,82,17,23,40
14,8476960,Andreas Athanasiou,C,CHI,30,82,16,24,40
14,8473563,Nicklas Backstrom,C,WSH,37,82,13,27,40
14,8478463,Anthony Beauvillier,L,NSH,27,82,12,28,40
14,8481553,Bobby Brink,R,PHI,23,82,12,28,40
14,8481703,Valtteri Puustinen,R,PIT,25,82,12,28,40
14,8476917,Adam Pelech,D,NYI,30,82,10,30,40
14,8481604,Pavel Dorofeyev,L,VGK,24,82,21,18,39
14,8481624,Ilya Mikheyev,R,VAN,30,82,16,23,39
14,8474053,Logan Couture,C,SJS,35,82,15,24,39
14,8474189,Lars Eller,C,PIT,35,82,14,25,39
14,8475799,Nino Niederreiter,R,WPG,32,82,12,27,39
14,8477948,Travis Sanheim,D,PHI,28,82,12,27,39
14,8477346,MacKenzie Weegar,D,CGY,30,82,8,31,39
14,8478500,Ivan Provorov,D,CBJ,27,82,7,32,39
14,8482146,Luke Evangelista,R,NSH,22,82,28,10,38
14,8480068,Ryan Poehling,C,PHI,25,82,20,18,38
14,8479525,Ross Colton,C,COL,28,82,18,20,38
14,8482055,Drew O'Connor,L,PIT,26,82,18,20,38
14,8481656,Aliaksei Protas,C,WSH,23,82,17,21,38
14,8481618,Alex Newhook,C,MTL,23,82,16,22,38
14,8470621,Corey Perry,R,EDM,39,82,16,22,38
14,8479359,Beck Malenstyn,L,WSH,26,82,10,28,38
14,8476892,Colton Parayko,D,STL,31,82,3,35,38
14,8476931,Jake McCabe,D,TOR,31,82,1,37,38
14,8481535,Nils Hoglander,L,VAN,24,82,25,12,37
14,8476921,Jordan Martinook,L,CAR,32,82,20,17,37
14,8483808,Andrei Kuzmenko,L,CGY,28,82,17,20,37
14,8482705,Cole Sillinger,C,CBJ,21,82,17,20,37
14,8479977,Kailer Yamamoto,R,SEA,26,82,17,20,37
14,8482092,Ridly Greig,C,OTT,22,82,16,21,37
14,8476871,Tanner Pearson,L,MTL,32,82,16,21,37
14,8481704,Juuso Parssinen,C,NSH,23,82,14,23,37
14,8476923,Damon Severson,D,CBJ,30,82,6,31,37
14,8478462,Nicolas Roy,C,VGK,27,82,21,15,36
14,8482079,Marco Rossi,C,MIN,23,82,20,16,36
14,8481093,Rafael Harvey-Pinard,L,MTL,25,82,19,17,36
14,8478891,Mason Appleton,C,WPG,28,82,14,22,36
14,8480806,Isac Lundestrom,C,ANA,25,82,13,23,36
14,8476480,Vladislav Namestnikov,C,WPG,32,82,13,23,36
14,8480074,Alexandre Texier,C,CBJ,25,82,12,24,36
14,8481546,Cam York,D,PHI,23,82,7,29,36
14,8477506,Ryan Pulock,D,NYI,30,82,5,31,36
14,8480281,Alexey Toropchenko,R,STL,25,82,22,13,35
14,8474641,Adam Henrique,C,EDM,34,82,20,15,35
14,8476438,Brandon Saad,L,STL,32,82,20,15,35
14,8477944,Jakub Vrana,L,STL,28,82,17,18,35
14,8481013,Jonatan Berggren,R,DET,24,82,17,18,35
14,8476278,Colin Blackwell,C,CHI,31,82,17,18,35
14,8480144,David Kampf,C,TOR,29,82,16,19,35
14,8475343,Nic Dowd,C,WSH,34,82,15,20,35
14,8482475,Yegor Chinakhov,R,CBJ,23,82,14,21,35
14,8474034,Pat Maroon,L,BOS,36,82,12,23,35
14,8482125,Alexander Holtz,R,NJD,22,82,19,15,34
14,8475848,Brendan Gallagher,R,MTL,32,82,16,18,34
14,8480802,Ryan McLeod,C,EDM,25,82,13,21,34
14,8474715,Cam Atkinson,R,PHI,35,82,9,25,34
14,8482105,Jake Sanderson,D,OTT,22,82,6,28,34
14,8480043,Timothy Liljegren,D,TOR,25,82,5,29,34
14,8481554,Kaapo Kakko,R,NYR,23,82,21,12,33
14,8478057,Dakota Joshua,C,VAN,28,82,19,14,33
14,8479353,Brett Howden,C,VGK,26,82,17,16,33
14,8476419,Jean-Gabriel Pageau,C,NYI,32,82,16,17,33
14,8477015,Connor Brown,R,EDM,30,82,16,17,33
14,8477919,Frederick Gaudreau,C,MIN,31,82,15,18,33
14,8480113,Alex Iafallo,L,WPG,31,82,13,20,33
14,8477998,Warren Foegele,L,EDM,28,82,13,20,33
14,8474884,Mike Hoffman,C,SJS,35,82,12,21,33
14,8476885,Jacob Trouba,D,NYR,30,82,12,21,33
14,8477220,Nate Schmidt,D,WPG,33,82,7,26,33
14,8476879,Cody Ceci,D,EDM,31,82,3,30,33
14,8482089,Jake Neighbours,L,STL,22,82,20,12,32
14,8470604,Jeff Carter,C,PIT,39,82,19,13,32
14,8478508,Yakov Trenin,C,COL,27,82,18,14,32
14,8476469,Joel Armia,R,MTL,31,82,17,15,32
14,8479661,Tanner Jeannot,L,TBL,27,82,16,16,32
14,8476927,Teddy Blueger,C,VAN,30,82,10,22,32
14,8478413,Jordan Greenway,L,BUF,27,82,9,23,32
14,8482245,Artem Zub,D,OTT,29,82,9,23,32
14,8479398,Samuel Girard,D,COL,26,82,5,27,32
14,8476429,Scott Mayfield,D,NYI,32,82,5,27,32
14,8480873,Rasmus Sandin,D,WSH,24,82,2,30,32
14,8479941,Justin Danforth,R,CBJ,31,82,20,11,31
14,8482062,Cole Smith,L,NSH,29,82,16,15,31
14,8479514,Rem Pitlick,C,CHI,27,82,14,17,31
14,8478043,Sam Lafferty,C,VAN,29,82,14,17,31
14,8478133,Jake Evans,C,MTL,28,82,8,23,31
14,8476461,Sean Couturier,C,PHI,32,82,6,25,31
14,8475906,John Klingberg,D,TOR,32,82,6,25,31
14,8479992,Michael Rasmussen,C,DET,25,82,15,15,30
14,8480821,Filip Zadina,R,SJS,25,82,15,15,30
14,8476897,Oskar Sundqvist,C,STL,30,82,12,18,30
14,8478115,Pierre Engvall,L,NYI,28,82,9,21,30
14,8478458,Jack Roslovic,C,NYR,27,82,9,21,30
14,8481522,Peyton Krebs,C,BUF,23,82,9,21,30
14,8474574,Tyler Myers,D,VAN,34,82,6,24,30
14,8476331,Dylan DeMelo,D,WPG,31,82,5,25,30
14,8480246,Nick Perbix,D,TBL,26,82,5,25,30
14,8480035,Henri Jokiharju,D,BUF,25,82,5,25,30
14,8477330,Dominik Kubalik,L,OTT,29,82,17,12,29
14,8470610,Zach Parise,L,COL,40,82,16,13,29
14,8479316,Luke Kunin,C,SJS,27,82,15,14,29
14,8476925,Colton Sissons,C,NSH,31,82,14,15,29
14,8476374,Sean Kuraly,C,CBJ,31,82,14,15,29
14,8484166,Adam Fantilli,C,CBJ,20,82,13,16,29
14,8476981,Josh Anderson,R,MTL,30,82,12,17,29
14,8478911,Matt Roy,D,LAK,29,82,11,18,29
14,8477989,Christian Dvorak,C,MTL,28,82,11,18,29
14,8479996,Cody Glass,C,NSH,25,82,11,18,29
14,8482133,Thomas Bordeleau,C,SJS,22,82,9,20,29
14,8475200,Dmitry Orlov,D,CAR,33,82,9,20,29
14,8476457,Adam Larsson,D,SEA,32,82,7,22,29
14,8475188,Brayden McNabb,D,VGK,33,82,7,22,29
14,8476979,Erik Gustafsson,D,NYR,32,82,6,23,29
14,8476312,Josh Manson,D,COL,33,82,6,23,29
14,8482655,J.J. Moser,D,ARI,24,82,0,29,29
14,8482111,Justin Barron,D,MTL,23,82,18,10,28
14,8481477,Nico Sturm,C,SJS,29,82,14,14,28
14,8478020,Michael Amadio,C,VGK,28,82,11,17,28
14,8473449,Kyle Okposo,R,FLA,36,82,11,17,28
14,8483457,Lane Hutson,D,MTL,20,82,11,17,28
14,8482666,Scott Morrow,D,CAR,22,82,10,18,28
14,8477392,Hudson Fasching,R,NYI,29,82,9,19,28
14,8481606,Jordan Spence,D,LAK,23,82,6,22,28
14,8478416,Erik Cernak,D,TBL,27,82,6,22,28
14,8478882,Vladislav Gavrikov,D,LAK,29,82,5,23,28
14,8478507,John Marino,D,NJD,27,82,4,24,28
14,8476873,Mark Jankowski,C,NSH,30,82,13,14,27
14,8477505,Alexander Wennberg,C,NYR,30,82,13,14,27
14,8482720,Matthew Knies,L,TOR,22,82,10,17,27
14,8481186,Logan O'Connor,R,COL,28,82,10,17,27
14,8477507,Nikita Zadorov,D,VAN,29,82,9,18,27
14,8478451,Ethan Bear,D,WSH,27,82,9,18,27
14,8482122,Brock Faber,D,MIN,22,82,6,21,27
14,8479351,Sam Steel,C,DAL,26,82,6,21,27
14,8477969,Marcus Pettersson,D,PIT,28,82,5,22,27
14,8475455,Brenden Dillon,D,WPG,34,82,4,23,27
14,8478136,Jake Middleton,D,MIN,28,82,3,24,27
14,8477425,Miles Wood,L,COL,29,82,14,12,26
14,8481578,Graeme Clarke,R,NJD,23,82,12,14,26
14,8476422,Mike Reilly,D,NYI,31,82,10,16,26
14,8477369,Carson Soucy,D,VAN,30,82,9,17,26
14,8481481,Blake Lizotte,C,LAK,27,82,8,18,26
14,8482858,Ryker Evans,D,SEA,23,82,8,18,26
14,8480807,Mattias Samuelsson,D,BUF,24,82,5,21,26
14,8475324,Nick Jensen,D,WSH,34,82,4,22,26
14,8470600,Ryan Suter,D,DAL,39,82,4,22,26
14,8478831,Kevin Stenlund,C,FLA,28,82,16,9,25
14,8481580,Connor McMichael,C,WSH,23,82,14,11,25
14,8482117,Lukas Reichel,L,CHI,22,82,11,14,25
14,8478569,Noel Acciari,C,PIT,33,82,11,14,25
14,8482803,Olen Zellweger,D,ANA,21,82,10,15,25
14,8483445,Cutter Gauthier,L,ANA,20,82,8,17,25
14,8477365,Connor Clifton,D,BUF,29,82,7,18,25
14,8475279,Ben Chiarot,D,DET,33,82,5,20,25
14,8479976,Juuso Valimaki,D,ARI,26,82,4,21,25
14,8479423,Alex Nylander,L,CBJ,26,82,16,8,24
14,8481601,Simon Holmstrom,R,NYI,23,82,13,11,24
14,8480813,Joe Veleno,C,DET,24,82,12,12,24
14,8479346,Dillon Dube,C,CGY,26,82,10,14,24
14,8475164,Jakob Silfverberg,R,ANA,34,82,9,15,24
14,8482762,Simon Edvinsson,D,DET,21,82,9,15,24
14,8477839,Conor Sheary,L,TBL,32,82,8,16,24
14,8481030,Jack St. Ivany,D,PIT,25,82,8,16,24
14,8482624,Daniil Miromanov,D,CGY,27,82,7,17,24
14,8475220,Marcus Foligno,L,MIN,33,82,7,17,24
14,8475181,Nick Leddy,D,STL,33,82,3,21,24
14,8475208,Brian Dumoulin,D,SEA,33,82,2,22,24
14,8479983,Mario Ferraro,D,SJS,26,82,1,23,24
14,8484203,Bradly Nadeau,L,CAR,19,82,13,10,23
14,8480855,Jack McBain,C,ARI,24,82,13,10,23
14,8480995,Pontus Holmberg,R,TOR,25,82,9,14,23
14,8476442,Matt Nieto,L,PIT,32,82,6,17,23
14,8480336,Sean Walker,D,COL,30,82,5,18,23
14,8479998,Mikey Anderson,D,LAK,25,82,5,18,23
14,8470966,Mark Giordano,D,TOR,41,82,5,18,23
14,8476525,Colin Miller,D,WPG,32,82,4,19,23
14,8482073,Braden Schneider,D,NYR,23,82,3,20,23
14,8481178,Egor Zamula,D,PHI,24,82,2,21,23
14,8476463,Jonas Brodin,D,MIN,31,82,2,21,23
14,8479324,Ryan Lindgren,D,NYR,26,82,2,21,23
14,8476467,Jamie Oleksiak,D,SEA,32,82,1,22,23
14,8476858,Phillip Di Giuseppe,L,VAN,31,82,14,8,22
14,8483431,Logan Cooley,C,ARI,20,82,13,9,22
14,8482259,Bobby McMann,C,TOR,28,82,13,9,22
14,8476878,Zemgus Girgensons,L,BUF,30,82,11,11,22
14,8482074,Connor Zary,C,CGY,23,82,11,11,22
14,8474009,Nick Bonino,C,NYR,36,82,11,11,22
14,8475231,Casey Cizikas,C,NYI,33,82,10,12,22
14,8484153,Leo Carlsson,C,ANA,20,82,8,14,22
14,8477450,Jason Dickinson,C,CHI,29,82,7,15,22
14,8477508,Curtis Lazar,C,NJD,29,82,7,15,22
14,8483495,Simon Nemec,D,NJD,20,82,7,15,22
14,8482733,Logan Mailloux,D,MTL,31,82,6,16,22
14,8480073,Erik Brannstrom,D,OTT,25,82,5,17,22
14,8482142,Jamie Drysdale,D,PHI,22,82,5,17,22
14,8479371,Dante Fabbro,D,NSH,26,82,5,17,22
14,8473507,Jeff Petry,D,DET,37,82,3,19,22
14,8474673,TJ Brodie,D,TOR,34,82,0,22,22
14,8473533,Jordan Staal,C,CAR,36,82,8,13,21
14,8474013,Ian Cole,D,VAN,35,82,8,13,21
14,8483763,Maksymilian Szuber,D,ARI,22,82,4,17,21
14,8478840,Will Borgen,D,SEA,28,82,4,17,21
14,8482087,Kaiden Guhle,D,MTL,22,82,3,18,21
14,8475690,Chris Tanev,D,DAL,35,82,3,18,21
14,8478443,Brandon Carlo,D,BOS,28,82,2,19,21
14,8484911,Collin Graf,R,SJS,22,82,11,9,20
14,8483493,Frank Nazar,C,CHI,20,82,10,10,20
14,8476624,Barclay Goodrow,C,NYR,31,82,10,10,20
14,8483471,Brad Lambert,C,WPG,31,82,9,11,20
14,8481537,Nikita Okhotiuk,D,CGY,24,82,6,14,20
14,8476891,Matt Grzelcyk,D,BOS,30,82,5,15,20
14,8482101,Danil Gushchin,L,SJS,22,82,5,15,20
14,8480058,Pierre-Olivier Joseph,D,PIT,25,82,5,15,20
14,8476372,Nick Seeler,D,PHI,31,82,5,15,20
14,8482807,Ethan Del Mastro,D,CHI,21,82,4,16,20
14,8481568,Alex Vlasic,D,CHI,23,82,4,16,20
14,8477845,Trevor van Riemsdyk,D,WSH,33,82,3,17,20
14,8479980,Nicolas Hague,D,VGK,26,82,3,17,20
14,8480834,Ty Emberson,D,SJS,24,82,3,17,20
14,8478178,Darren Raddysh,D,TBL,28,82,2,18,20
14,8475842,Sam Carrick,C,EDM,32,82,12,7,19
14,8480448,Parker Kelly,L,OTT,25,82,9,10,19
14,8482166,Shakir Mukhamadullin,D,SJS,22,82,9,10,19
14,8480796,Martin Fehervary,D,WSH,25,82,8,11,19
14,8483499,Liam Ohgren,L,MIN,20,82,8,11,19
14,8482145,Mavrik Bourque,C,DAL,22,82,8,11,19
14,8483012,Logan Morrison,C,SEA,22,82,8,11,19
14,8477353,Tyler Motte,C,TBL,29,82,7,12,19
14,8482730,Brandt Clarke,D,LAK,21,82,7,12,19
14,8478430,Oliver Kylington,D,CGY,27,82,7,12,19
14,8477406,Mattias Janmark,C,EDM,32,82,5,14,19
14,8481059,Scott Perunovich,D,STL,26,82,4,15,19
14,8477034,Jaycob Megna,D,CHI,32,82,4,15,19
14,8475790,Erik Gudbranson,D,CBJ,32,82,3,16,19
14,8476967,Brett Kulak,D,EDM,30,82,3,16,19
14,8477435,Ryan Graves,D,PIT,29,82,2,17,19
14,8478851,Alexandre Carrier,D,NSH,28,82,2,17,19
14,8480860,Kevin Bahl,D,NJD,24,82,2,17,19
14,8479393,Noah Gregor,C,TOR,26,82,14,4,18
14,8473453,Trevor Lewis,C,LAK,37,82,11,7,18
14,8484145,Zach Benson,L,BUF,19,82,10,8,18
14,8483482,Tristan Luneau,D,ANA,20,82,9,9,18
14,8483468,Jiri Kulich,C,BUF,20,82,8,10,18
14,8482737,Zack Bolduc,C,STL,21,82,7,11,18
14,8477499,Rasmus Ristolainen,D,PHI,30,82,4,14,18
14,8479369,Andrew Peeke,D,BOS,26,82,4,14,18
14,8480172,Jan Rutta,D,SJS,34,82,4,14,18
14,8478399,Jonas Siegenthaler,D,NJD,27,82,1,17,18
14,8479291,Kevin Rooney,C,CGY,31,82,9,8,17
14,8481517,Brett Leason,R,ANA,25,82,8,9,17
14,8476822,Luke Glendening,C,TBL,35,82,8,9,17
14,8480990,Declan Chisholm,D,MIN,24,82,7,10,17
14,8475825,Jani Hakanpää,D,DAL,32,82,6,11,17
14,8475233,David Savard,D,MTL,34,82,2,15,17
14,8475179,Dmitry Kulikov,D,FLA,34,82,1,16,17
14,8478013,Jake Walman,D,DET,28,82,9,7,16
14,8479383,Boris Katchouk,L,OTT,26,82,7,9,16
14,8483491,Ivan Miroshnichenko,L,WSH,20,82,7,9,16
14,8473504,Cal Clutterbuck,R,NYI,37,82,6,10,16
14,8481524,Bowen Byram,D,BUF,23,82,5,11,16
14,8481567,Henry Thrun,D,SJS,23,82,5,11,16
14,8481599,Victor Soderstrom,D,ARI,23,82,5,11,16
14,8482859,Zack Ostapchuk,C,OTT,21,82,4,12,16
14,8477488,Brett Pesce,D,CAR,30,82,3,13,16
14,8483524,Shane Wright,C,SEA,20,82,10,5,15
14,8481016,Ruslan Iskhakov,C,NYI,24,82,8,7,15
14,8482712,Oskar Olausson,R,COL,22,82,8,7,15
14,8482679,Matt Coronato,R,CGY,22,82,7,8,15
14,8474151,Ryan McDonagh,D,NSH,35,82,4,11,15
14,8484149,Gavin Brindley,C,CBJ,20,82,4,11,15
14,8481605,Jackson LaCombe,D,ANA,23,82,3,12,15
14,8476473,Connor Murphy,D,CHI,31,82,5,9,14
14,8478468,Jeremy Lauzon,D,NSH,27,82,4,10,14
14,8478859,Niko Mikkola,D,FLA,28,82,3,11,14
14,8483490,Pavel Mintyukov,D,ANA,21,82,3,11,14
14,8483565,Nick Blankenburg,D,CBJ,26,82,3,11,14
14,8475462,Radko Gudas,D,ANA,34,82,2,12,14
14,8474166,Alec Martinez,D,VGK,37,82,2,12,14
14,8482809,Jackson Blake,R,CAR,21,82,9,4,13
14,8481028,Martin Pospisil,C,CGY,25,82,6,7,13
14,8482702,Logan Stankoven,C,DAL,21,82,6,7,13
14,8471677,Jack Johnson,D,COL,37,82,2,11,13
14,8483466,Kevin Korchinski,D,CHI,20,82,2,11,13
14,8479442,Troy Stecher,D,EDM,30,82,0,13,13
14,8482155,Alex Laferriere,R,LAK,23,82,5,7,12
14,8482177,Marat Khusnutdinov,C,MIN,22,82,5,7,12
14,8475177,Calvin de Haan,D,TBL,33,82,5,7,12
14,8477931,Tomas Nosek,L,NJD,32,82,4,8,12
14,8482516,Matthew Kessel,D,STL,24,82,4,8,12
14,8480879,Jacob Bernard-Docker,D,OTT,24,82,3,9,12
14,8475762,Derek Forbort,D,BOS,32,82,3,9,12
14,8482470,Ilya Solovyov,D,CGY,24,82,2,10,12
14,8478408,Travis Dermott,D,ARI,28,82,5,6,11
14,8481014,Alexander Romanov,D,NYI,24,82,3,8,11
14,8480031,Maxime Comtois,L,CAR,25,82,2,9,11
14,8474567,Zach Bogosian,D,MIN,34,82,1,10,11
14,8481699,Aku Raty,R,ARI,23,82,3,7,10
14,8476915,Jujhar Khaira,L,MIN,30,82,7,2,9
14,8483505,Matthew Poitras,C,BOS,20,82,3,6,9
14,8483489,Fraser Minten,C,TOR,31,82,3,6,9
14,8477335,Kyle Burroughs,D,SJS,29,82,2,7,9
14,8482713,Mackie Samoskevich,R,FLA,22,82,2,7,9
14,8482118,Sam Colangelo,R,ANA,23,82,1,8,9
14,8483397,Marc McLaughlin,C,BOS,25,82,2,3,5
14,8477950,Tony DeAngelo,D,CAR,29,0,0,0,0
14,8481577,Philip Tomasino,C,NSH,23,0,0,0,0
14,8482660,Kent Johnson,C,CBJ,22,0,0,0,0
14,8481019,David Gustafsson,C,WPG,24,0,0,0,0
14,8479348,Kale Clague,D,BUF,26,0,0,0,0
14,8482149,Cole Perfetti,C,WPG,22,0,0,0,0
14,8476952,Dominic Toninato,C,WPG,30,0,0,0,0
14,8473473,Milan Lucic,L,BOS,36,0,0,0,0
14,8480829,Jesperi Kotkaniemi,C,CAR,24,0,0,0,0
14,8474602,Justin Schultz,D,SEA,34,0,0,0,0
14,8480049,Dylan Samberg,D,WPG,25,0,0,0,0
14,8479372,Josh Mahura,D,FLA,26,0,0,0,0
14,8480878,Nils Lundkvist,D,DAL,24,0,0,0,0
14,8479982,Conor Timmins,D,TOR,26,0,0,0,0
14,8474031,Kevin Shattenkirk,D,BOS,35,0,0,0,0
14,8480835,Jack Drury,C,CAR,24,0,0,0,0
14,8480008,Adam Ruzicka,C,ARI,25,0,0,0,0
14,8479402,Jake Bean,D,CBJ,26,0,0,0,0
14,8476474,Stefan Noesen,R,CAR,31,0,0,0,0
14,8480884,Calen Addison,D,SJS,24,0,0,0,0
14,8476994,Vinnie Hinostroza,C,PIT,30,0,0,0,0
14,8477987,Ryan Donato,C,CHI,28,0,0,0,0
14,8481582,Nicholas Robertson,L,TOR,23,0,0,0,0
14,8478452,Caleb Jones,D,COL,27,0,0,0,0
14,8480157,Calle Rosen,D,STL,30,0,0,0,0
14,8481609,Vladislav Kolyachonok,D,ARI,23,0,0,0,0
14,8476919,Chris Tierney,C,NJD,30,0,0,0,0
14,8479639,Dylan Coghlan,D,CAR,26,0,0,0,0
14,8475193,Tomas Tatar,L,SEA,34,0,0,0,0
14,8480748,Kiefer Sherwood,L,NSH,29,0,0,0,0
14,8478146,Matthew Highmore,C,OTT,28,0,0,0,0
14,8478970,Jalen Chatfield,D,CAR,28,0,0,0,0
14,8480205,Emil Bemstrom,C,PIT,25,0,0,0,0
14,8471274,Alex Goligoski,D,MIN,39,0,0,0,0
14,8478104,Sammy Blais,L,STL,28,0,0,0,0
14,8476913,Devin Shore,C,SEA,30,0,0,0,0
14,8481708,Zac Jones,D,NYR,24,0,0,0,0
14,8480222,Sebastian Aho,D,NYI,28,0,0,0,0
14,8481598,Philip Broberg,D,EDM,23,0,0,0,0
14,8480789,Oliver Wahlstrom,R,NYI,24,0,0,0,0
14,8480891,Michael Kesselring,D,ARI,24,0,0,0,0
14,8477979,Nicolas Aube-Kubel,R,WSH,28,0,0,0,0
14,8476393,Nick Cousins,C,FLA,31,0,0,0,0
14,8480003,Jesper Boqvist,C,BOS,26,0,0,0,0
14,8479543,Michael Pezzetta,L,MTL,26,0,0,0,0
14,8475855,Jesper Fast,R,CAR,33,0,0,0,0
14,8477018,Ben Hutton,D,VGK,31,0,0,0,0
14,8480762,Eric Robinson,L,BUF,29,0,0,0,0
14,8481058,Jesse Ylönen,R,MTL,25,0,0,0,0
14,8481527,Kaedan Korczak,D,VGK,23,0,0,0,0
14,8482192,Isaak Phillips,D,CHI,23,0,0,0,0
14,8480727,Zach Whitecloud,D,VGK,28,0,0,0,0
14,8480001,Urho Vaakanainen,D,ANA,25,0,0,0,0
14,8480853,Liam Foudy,C,NSH,24,0,0,0,0
14,8475225,Craig Smith,C,DAL,35,0,0,0,0
14,8479972,Mason Shaw,C,MIN,26,0,0,0,0
14,8474040,Sam Gagner,C,EDM,35,0,0,0,0
14,8480196,Jacob Bryson,D,BUF,27,0,0,0,0
14,8475718,Justin Holl,D,DET,32,0,0,0,0
14,8479984,Cal Foote,D,NJD,26,0,0,0,0
14,8480011,Klim Kostin,C,SJS,25,0,0,0,0
14,8482176,Wyatt Kaiser,D,CHI,22,0,0,0,0
14,8476918,Jimmy Vesey,L,NYR,31,0,0,0,0
14,8476988,Matt Benning,D,SJS,30,0,0,0,0
14,8479370,Tyson Jost,C,BUF,26,0,0,0,0
14,8477464,Nic Petan,C,MIN,29,0,0,0,0
14,8477380,Jonny Brodzinski,C,NYR,31,0,0,0,0
14,8480070,Ian Mitchell,D,BOS,25,0,0,0,0
14,8479315,Joey Anderson,R,CHI,26,0,0,0,0
14,8478099,Kevin Labanc,R,SJS,29,0,0,0,0
14,8476874,Olli Maatta,D,DET,30,0,0,0,0
14,8479414,Nathan Bastian,R,NJD,27,0,0,0,0
14,8478434,Keegan Kolesar,R,VGK,27,0,0,0,0
14,8479536,Axel Jonsson-Fjallby,L,WPG,26,0,0,0,0
14,8479671,Mathieu Olivier,R,CBJ,27,0,0,0,0
14,8471709,Marc-Edouard Vlasic,D,SJS,37,0,0,0,0
14,8479328,Julien Gauthier,R,NYI,27,0,0,0,0
14,8478421,A.J. Greer,L,CGY,28,0,0,0,0
14,8477573,Nathan Walker,L,STL,30,0,0,0,0
14,8477478,William Carrier,L,VGK,30,0,0,0,0
14,8479344,Jesse Puljujarvi,R,PIT,26,0,0,0,0
14,8480887,Jordan Harris,D,MTL,24,0,0,0,0
14,8478502,Dennis Gilbert,D,CGY,28,0,0,0,0
14,8480355,Mark Kastelic,C,OTT,25,0,0,0,0
14,8475750,Jon Merrill,D,MIN,32,0,0,0,0
14,8476889,Radek Faksa,C,DAL,30,0,0,0,0
14,8478432,Christian Fischer,R,DET,27,0,0,0,0
14,8479439,Jacob MacDonald,D,SJS,31,0,0,0,0
14,8474568,Luke Schenn,D,NSH,35,0,0,0,0
14,8478454,Noah Juulsen,D,VAN,27,0,0,0,0
14,8475752,Tyler Pitlick,C,NYR,33,0,0,0,0
14,8482148,Hendrix Lapierre,C,WSH,22,0,0,0,0
14,8481167,Brayden Pachal,D,CGY,25,0,0,0,0
14,8478211,Dryden Hunt,L,CGY,29,0,0,0,0
14,8479321,Lucas Johansen,D,WSH,27,0,0,0,0
14,8480950,Ilya Lyubushkin,D,TOR,30,0,0,0,0
14,8479368,Max Jones,L,ANA,26,0,0,0,0
14,8471699,Andrew Cogliano,C,COL,37,0,0,0,0
14,8481521,Ronnie Attard,D,PHI,25,0,0,0,0
14,8481161,Jake Christiansen,D,CBJ,25,0,0,0,0
14,8479458,Nikita Zaitsev,D,CHI,33,0,0,0,0
14,8479619,Michael Carcone,L,ARI,28,0,0,0,0
14,8479026,Philippe Myers,D,TBL,27,0,0,0,0
14,8481617,Vasily Podkolzin,R,VAN,23,0,0,0,0
14,8481701,Santeri Hatakka,D,NJD,23,0,0,0,0
14,8477446,Michael McCarron,R,NSH,29,0,0,0,0
14,8483460,David Jiricek,D,CBJ,21,0,0,0,0
14,8474090,Brendan Smith,D,NJD,35,0,0,0,0
14,8482241,Radim Zohorna,L,PIT,28,0,0,0,0
14,8481032,Paul Cotter,C,VGK,25,0,0,0,0
14,8480289,Morgan Barron,C,WPG,26,0,0,0,0
14,8479379,Givani Smith,R,SJS,26,0,0,0,0
14,8480216,Jacob Peterson,C,SJS,25,0,0,0,0
14,8477851,Jordan Oesterle,D,CGY,32,0,0,0,0
14,8484258,Sam Malinski,D,COL,26,0,0,0,0
14,8478904,Steven Lorentz,C,FLA,28,0,0,0,0
14,8482095,Tyler Kleven,D,OTT,22,0,0,0,0
14,8480980,Connor Dewar,C,TOR,25,0,0,0,0
14,8480848,Ty Dellandrea,C,DAL,24,0,0,0,0
14,8476884,Derrick Pouliot,D,DAL,30,0,0,0,0
14,8480025,MacKenzie Entwistle,R,CHI,25,0,0,0,0
14,8474612,Travis Hamonic,D,OTT,34,0,0,0,0
14,8479336,Carl Grundstrom,R,LAK,27,0,0,0,0
14,8482964,Arber Xhekaj,D,MTL,23,0,0,0,0
14,8471686,Marc Staal,D,PHI,37,0,0,0,0
14,8477887,Patrick Brown,C,BOS,32,0,0,0,0
14,8478495,Denis Gurianov,R,PHI,27,0,0,0,0
14,8481550,Adam Beckman,L,MIN,23,0,0,0,0
14,8480845,Rasmus Kupari,C,WPG,24,0,0,0,0
14,8478585,Derek Ryan,C,EDM,38,0,0,0,0
14,8482141,Lukas Cormier,D,VGK,22,0,0,0,0
14,8477962,Brendan Lemieux,L,CAR,28,0,0,0,0
14,8482861,Vincent Iorio,D,WSH,22,0,0,0,0
14,8479378,Logan Stanley,D,WPG,26,0,0,0,0
14,8473446,Erik Johnson,D,PHI,36,0,0,0,0
14,8481743,Marc Del Gaizo,D,NSH,25,0,0,0,0
14,8478450,Parker Wotherspoon,D,BOS,27,0,0,0,0
14,8477384,Josh Brown,D,ARI,30,0,0,0,0
14,8482165,Yan Kuznetsov,D,CGY,22,0,0,0,0
14,8478424,Jansen Harkins,C,PIT,27,0,0,0,0
14,8482144,Jack Thompson,D,SJS,22,0,0,0,0
14,8479576,Vincent Desharnais,D,EDM,28,0,0,0,0
14,8478512,Austin Czarnik,C,DET,32,0,0,0,0
14,8477527,Ross Johnston,L,ANA,30,0,0,0,0
14,8482094,Daemon Hunt,D,MIN,22,0,0,0,0
14,8481719,Maxwell Crozier,D,TBL,24,0,0,0,0
14,8480192,Johnathan Kovacevic,D,MTL,27,0,0,0,0
14,8479376,Victor Mete,D,PHI,26,0,0,0,0
14,8482511,Mason Lohrei,D,BOS,23,0,0,0,0
14,8478021,William Lagesson,D,ANA,28,0,0,0,0
14,8475795,Dylan McIlrath,D,WSH,32,0,0,0,0
14,8477846,Ryan Carpenter,C,SJS,33,0,0,0,0
14,8481056,Spencer Stastney,D,NSH,24,0,0,0,0
14,8481564,Ryan Johnson,D,BUF,23,0,0,0,0
14,8478017,Mark Friedman,D,VAN,29,0,0,0,0
14,8479320,Max Lajoie,D,TOR,27,0,0,0,0
14,8480075,Cameron Crotty,D,ARI,25,0,0,0,0
14,8484287,Cole McWard,D,VAN,23,0,0,0,0
14,8484254,Akito Hirose,D,VAN,25,0,0,0,0
14,8483407,Brandon Scanlin,D,NYR,25,0,0,0,0
14,8480274,Philip Kemp,D,EDM,25,0,0,0,0
14,8479522,Hardy Haman Aktell,D,WSH,26,0,0,0,0
14,8480007,Jonas Rondbjerg,R,VGK,25,0,0,0,0
14,8477454,Adam Erne,L,EDM,29,0,0,0,0
14,8481679,Maxence Guenette,D,OTT,23,0,0,0,0
14,8477938,Haydn Fleury,D,TBL,28,0,0,0,0
14,8476441,Joel Edmundson,D,TOR,31,0,0,0,0
14,8477903,Garnet Hathaway,R,PHI,33,0,0,0,0
14,8480441,Trey Fix-Wolansky,R,CBJ,25,0,0,0,0
14,8483546,Marshall Rifai,D,TOR,26,0,0,0,0
14,8480084,Nick DeSimone,D,NJD,30,0,0,0,0
14,8481592,Jakob Pelletier,L,CGY,23,0,0,0,0
14,8478011,Louie Belpedio,D,PHI,28,0,0,0,0
14,8477930,Pierre-Edouard Bellemare,L,SEA,39,0,0,0,0
14,8484321,Nikolas Matinpalo,D,OTT,26,0,0,0,0
14,8482067,Connor Mackey,D,NYR,28,0,0,0,0
14,8481806,Louis Crevier,D,CHI,23,0,0,0,0
14,8484326,Patrik Koch,D,ARI,28,0,0,0,0
14,8477971,Andreas Englund,D,LAK,28,0,0,0,0
14,8481751,Lukas Rousek,R,BUF,25,0,0,0,0
14,8481006,Tyler Tucker,D,STL,24,0,0,0,0
14,8481641,Joel Kiviranta,L,COL,28,0,0,0,0
14,8476867,Brendan Gaunce,C,CBJ,30,0,0,0,0
14,8479520,Brandon Duhaime,R,COL,27,0,0,0,0
14,8477073,Kurtis MacDermid,L,NJD,30,0,0,0,0
14,8480874,Adam Ginning,D,PHI,24,0,0,0,0
14,8477473,Justin Bailey,R,SJS,29,0,0,0,0
14,8479066,Ryan Lomberg,L,FLA,30,0,0,0,0
14,8477070,Liam O'Brien,C,ARI,30,0,0,0,0
14,8474618,Marco Scandella,D,STL,34,0,0,0,0
14,8475797,Jarred Tinordi,D,CHI,32,0,0,0,0
14,8481441,Joe Snively,C,WSH,28,0,0,0,0
14,8477244,Chad Ruhwedel,D,NYR,34,0,0,0,0
14,8482077,Dylan Holloway,L,EDM,23,0,0,0,0
14,8479772,Zack MacEwen,R,OTT,28,0,0,0,0
14,8481147,Reese Johnson,C,CHI,26,0,0,0,0
14,8481043,Cole Koepke,L,TBL,26,0,0,0,0
14,8483619,Filip Roos,D,CHI,25,0,0,0,0
14,8481541,Samuel Bolduc,D,NYI,24,0,0,0,0
14,8477810,Joel Hanley,D,CGY,33,0,0,0,0
14,8476907,Mackenzie MacEachern,L,STL,30,0,0,0,0
14,8482652,Walker Duehr,R,CGY,27,0,0,0,0
14,8477126,Jayson Megna,C,BOS,34,0,0,0,0
14,8483398,Declan Carlile,D,TBL,31,0,0,0,0
14,8482929,Emil Lilleberg,D,TBL,23,0,0,0,0
14,8480880,Jakub Lauko,C,BOS,24,0,0,0,0
14,8478874,Adam Gaudette,C,STL,28,0,0,0,0
14,8480245,Olle Lycksell,R,PHI,25,0,0,0,0
14,8480252,Cole Guttman,C,CHI,25,0,0,0,0
14,8477467,Gustav Olofsson,D,SEA,30,0,0,0,0
14,8479968,Vinni Lettieri,C,MIN,29,0,0,0,0
14,8478400,Colin White,C,MTL,27,0,0,0,0
14,8475755,Alexander Petrovic,D,DAL,32,0,0,0,0
14,8481812,Nikolai Knyzhov,D,SJS,27,0,0,0,0
14,8481593,Jayden Struble,D,MTL,23,0,0,0,0
14,8481532,Alex Turcotte,C,LAK,23,0,0,0,0
14,8482126,Emil Andrae,D,PHI,31,0,0,0,0
14,8479944,Zach Aston-Reese,C,DET,30,0,0,0,0
14,8471817,Ryan Reaves,R,TOR,37,0,0,0,0
14,8481206,John Ludvig,D,PIT,24,0,0,0,0
14,8480292,Carson Meyer,R,CBJ,27,0,0,0,0
14,8482496,Nils Aman,C,VAN,24,0,0,0,0
14,8479718,Alex Barré-Boulet,C,TBL,27,0,0,0,0
14,8479994,Jaret Anderson-Dolan,C,NSH,25,0,0,0,0
14,8480184,Gustav Lindstrom,D,ANA,26,0,0,0,0
14,8480890,Jan Jenik,R,ARI,24,0,0,0,0
14,8478067,Oskar Lindblom,L,SJS,28,0,0,0,0
14,8476934,Brock McGinn,L,ANA,30,0,0,0,0
14,8479985,Cale Fleury,D,SEA,26,0,0,0,0
14,8482153,Brendan Brisson,C,VGK,23,0,0,0,0
14,8480021,Jack Studnicka,C,SJS,25,0,0,0,0
14,8484304,Uvis Balinskis,D,FLA,28,0,0,0,0
14,8479981,Jonah Gadjovich,L,FLA,26,0,0,0,0
14,8481716,Dmitri Voronkov,L,CBJ,24,0,0,0,0
14,8482659,Josh Doan,R,ARI,22,0,0,0,0
14,8481122,Simon Benoit,D,TOR,26,0,0,0,0
14,8474709,Matt Martin,L,NYI,35,0,0,0,0
14,8482634,Alex Steeves,C,TOR,25,0,0,0,0
14,8480823,Alexander Alexeyev,D,WSH,25,0,0,0,0
14,8477541,Dakota Mermis,D,MIN,30,0,0,0,0
14,8478477,Mitchell Stephens,C,MTL,27,0,0,0,0
14,8481543,Nikita Alexandrov,C,STL,24,0,0,0,0
14,8482451,Mikael Pyyhtia,L,CBJ,23,0,0,0,0
14,8480306,Grant Hutton,D,NYI,29,0,0,0,0
14,8478028,Fredrik Olofsson,L,COL,28,0,0,0,0
14,8477462,Robert Hagg,D,ANA,29,0,0,0,0
14,8477320,Anton Blidh,L,NYR,29,0,0,0,0
14,8482749,Joshua Roy,R,MTL,21,0,0,0,0
14,8482157,Will Cuylle,L,NYR,22,0,0,0,0
14,8481239,Samuel Fagemo,L,LAK,24,0,0,0,0
14,8481600,Tobias Bjornfot,D,FLA,23,0,0,0,0
14,8478409,Anthony Richard,C,BOS,28,0,0,0,0
14,8474145,Robert Bortuzzo,D,NYI,35,0,0,0,0
14,8475958,Michael Sgarbossa,C,WSH,32,0,0,0,0
14,8479986,Kole Lind,R,SEA,26,0,0,0,0
14,8479249,Andrew Poturalski,C,SEA,30,0,0,0,0
14,8479362,Riley Tufte,L,COL,26,0,0,0,0
14,8479991,Jake Leschyshyn,C,NYR,25,0,0,0,0
14,8479587,Rhett Gardner,C,PHI,28,0,0,0,0
14,8482744,James Malatesta,L,CBJ,21,0,0,0,0
14,8478854,Ryan Shea,D,PIT,27,0,0,0,0
14,8481591,Sam Poulin,R,PIT,23,0,0,0,0
14,8483512,Matt Savoie,C,BUF,20,0,0,0,0
14,8482102,Vasily Ponomarev,C,CAR,22,0,0,0,0
14,8482162,Roby Jarventie,L,OTT,22,0,0,0,0
14,8482172,Landon Slaggert,L,CHI,22,0,0,0,0
14,8482747,Brennan Othmann,L,NYR,21,0,0,0,0
14,8480226,Marián Studenic,R,SEA,26,0,0,0,0
14,8481518,Nolan Foote,L,NJD,24,0,0,0,0
14,8479419,Brett Murray,L,BUF,26,0,0,0,0
14,8482088,Justin Sourdif,R,FLA,22,0,0,0,0
14,8482201,Gage Goncalves,C,TBL,23,0,0,0,0
14,8481754,Nikita Nesterenko,C,ANA,23,0,0,0,0
14,8483531,Brian Halonen,L,NJD,25,0,0,0,0
14,8483920,Pierrick Dube,R,WSH,23,0,0,0,0
14,8480851,Akil Thomas,C,LAK,24,0,0,0,0
14,8475235,Nicolas Deslauriers,L,PHI,33,0,0,0,0
14,8482476,Emil Heineman,L,MTL,23,0,0,0,0
14,8477149,Scott Sabourin,R,SJS,32,0,0,0,0
14,8483549,Lucas Condotta,L,MTL,27,0,0,0,0
14,8483567,Georgii Merkulov,C,BOS,24,0,0,0,0
14,8482765,Isak Rosen,R,BUF,21,0,0,0,0
14,8481237,Kyle MacLean,C,NYI,25,0,0,0,0
14,8481024,Linus Karlsson,C,VAN,25,0,0,0,0
14,8481690,Tyler Angle,C,CBJ,24,0,0,0,0
14,8483570,Ben Meyers,C,ANA,26,0,0,0,0
14,8481655,Cole Schwindt,R,CGY,23,0,0,0,0
14,8481462,Mason Morelli,L,VGK,28,0,0,0,0
14,8483401,Marc Johnstone,R,PIT,28,0,0,0,0
14,8478956,Samuel Laberge,L,NJD,27,0,0,0,0
14,8479533,Joona Koppanen,L,PIT,26,0,0,0,0
14,8482197,Adam Raska,R,MIN,23,0,0,0,0
14,8482250,Callahan Burke,C,CAR,27,0,0,0,0
14,8482784,Zach Dean,C,STL,21,0,0,0,0
14,8484255,Jason Polin,R,COL,25,0,0,0,0
14,8481077,John Leonard,L,ARI,26,0,0,0,0
14,8481534,Raphael Lavoie,C,EDM,24,0,0,0,0
14,8483609,Adam Klapka,R,CGY,24,0,0,0,0
14,8482751,Ryan Winterton,C,SEA,21,0,0,0,0
14,8480267,Sammy Walker,C,MIN,25,0,0,0,0
14,8475766,Austin Watson,L,TBL,32,0,0,0,0
14,8482460,Matt Rempe,C,NYR,22,0,0,0,0
14,8482787,Nikita Chibrikov,R,WPG,31,0,0,0,0
14,8481065,Angus Crookshank,L,OTT,25,0,0,0,0
14,8481070,Hugh McGing,L,STL,26,0,0,0,0
14,8476323,Max McCormick,L,SEA,32,0,0,0,0
14,8483395,Arshdeep Bains,L,VAN,23,0,0,0,0
14,8484259,Ondrej Pavel,C,COL,31,0,0,0,0
14,8483432,Luca Del Bel Belluz,C,CBJ,31,0,0,0,0
14,8483045,Cameron Butler,R,CBJ,31,0,0,0,0
14,8482061,Brandon Biro,L,BUF,26,0,0,0,0
14,8477401,John Hayden,C,SEA,29,0,0,0,0
14,8475278,Byron Froese,C,VGK,33,0,0,0,0
14,8478446,Glenn Gawdin,C,ANA,27,0,0,0,0
14,8477993,Justin Kirkland,C,ARI,28,0,0,0,0
14,8482147,Jean-Luc Foudy,C,COL,22,0,0,0,0
14,8480032,Shane Bowers,C,NJD,25,0,0,0,0
14,8479330,Brandon Gignac,C,MTL,27,0,0,0,0
14,8480776,Sheldon Rempal,R,VGK,29,0,0,0,0
14,8475413,Justin Dowling,C,NJD,34,0,0,0,0
14,8481726,Adam Edstrom,C,NYR,24,0,0,0,0
14,8479638,Justin Brazeau,R,BOS,26,0,0,0,0
14,8480844,Grigori Denisenko,L,VGK,24,0,0,0,0
14,8474062,Riley Nash,C,NYR,35,0,0,0,0
14,8478147,Bokondji Imama,L,OTT,28,0,0,0,0
14,8478881,Brett Seney,L,CHI,28,0,0,0,0
14,8483630,Pavol Regenda,L,ANA,25,0,0,0,0
14,8480836,Jonathan Gruden,C,PIT,24,0,0,0,0
14,8484314,Jiri Smejkal,L,OTT,28,0,0,0,0
14,8475780,Chris Wagner,R,COL,33,0,0,0,0
14,8482070,Mitchell Chaffee,R,TBL,26,0,0,0,0
14,8479546,Oskar Steen,C,BOS,26,0,0,0,0
14,8483597,Milos Kelemen,L,ARI,25,0,0,0,0
14,8481789,Tye Kartye,L,SEA,23,0,0,0,0
14,8484325,Waltteri Merela,C,TBL,26,0,0,0,0
14,8479421,Jacob Moverare,D,LAK,26,0,0,0,0
14,8481585,Egor Afanasyev,L,NSH,23,0,0,0,0
14,8479547,Matthew Phillips,R,WSH,26,0,0,0,0
14,8479367,William Lockwood,R,FLA,26,0,0,0,0
14,8481422,Jacob Lucchini,C,MIN,29,0,0,0,0
14,8480468,James Hamblin,L,EDM,25,0,0,0,0
14,8480870,Bo Groulx,C,ANA,24,0,0,0,0
14,8478051,Max Willman,C,NJD,29,0,0,0,0
14,8481556,John Beecher,C,BOS,23,0,0,0,0
14,8478078,Rourke Chartier,C,OTT,28,0,0,0,0
15,8478402,Connor McDavid,C,EDM,27,82,48,102,150
15,8476453,Nikita Kucherov,R,TBL,31,82,45,93,138
15,8481559,Jack Hughes,C,NJD,23,82,53,73,126
15,8477492,Nathan MacKinnon,C,COL,29,82,56,69,125
15,8476468,J.T. Miller,C,VAN,31,82,35,82,117
15,8476887,Filip Forsberg,L,NSH,30,82,51,62,113
15,8479318,Auston Matthews,C,TOR,27,82,51,57,108
15,8477956,David Pastrnak,R,BOS,28,82,47,61,108
15,8477946,Dylan Larkin,C,DET,28,82,45,63,108
15,8478864,Kirill Kaprizov,L,MIN,27,82,46,59,105
15,8477939,William Nylander,R,TOR,28,82,55,49,104
15,8478550,Artemi Panarin,L,NYR,33,82,43,61,104
15,8480800,Quinn Hughes,D,VAN,25,82,15,88,103
15,8477934,Leon Draisaitl,C,EDM,29,82,37,65,102
15,8481523,Kirby Dach,C,MTL,23,82,20,80,100
15,8479420,Tage Thompson,C,BUF,27,82,53,45,98
15,8480027,Jason Robertson,L,DAL,25,82,45,53,98
15,8480012,Elias Pettersson,C,VAN,26,82,41,57,98
15,8478420,Mikko Rantanen,R,COL,28,82,45,52,97
15,8471675,Sidney Crosby,C,PIT,37,82,35,61,96
15,8478398,Kyle Connor,L,WPG,28,82,46,47,93
15,8474600,Roman Josi,D,NSH,34,82,23,69,92
15,8477404,Jake Guentzel,C,CAR,30,82,34,57,91
15,8477949,Alex Tuch,R,BUF,28,82,27,63,90
15,8477933,Sam Reinhart,C,FLA,29,82,38,50,88
15,8479314,Matthew Tkachuk,L,FLA,27,82,27,61,88
15,8478445,Mathew Barzal,C,NYI,27,82,25,63,88
15,8478427,Sebastian Aho,C,CAR,27,82,42,45,87
15,8475167,Victor Hedman,D,TBL,34,82,18,69,87
15,8474564,Steven Stamkos,C,TBL,34,82,37,47,84
15,8476853,Morgan Rielly,D,TOR,30,82,14,70,84
15,8476460,Mark Scheifele,C,WPG,31,82,34,49,83
15,8471685,Anze Kopitar,C,LAK,37,82,22,60,82
15,8478403,Jack Eichel,C,VGK,28,82,43,38,81
15,8477496,Elias Lindholm,C,VAN,30,82,39,42,81
15,8478010,Brayden Point,C,TBL,28,82,38,43,81
15,8479385,Jordan Kyrou,C,STL,26,82,34,47,81
15,8476454,Ryan Nugent-Hopkins,C,EDM,31,82,18,63,81
15,8480069,Cale Makar,D,COL,26,82,18,63,81
15,8477501,Valeri Nichushkin,R,COL,29,82,38,42,80
15,8479343,Clayton Keller,R,ARI,26,82,35,45,80
15,8477409,Carter Verhaeghe,C,FLA,29,82,33,47,80
15,8471215,Evgeni Malkin,C,PIT,38,82,24,56,80
15,8475913,Mark Stone,R,VGK,32,82,23,57,80
15,8480023,Robert Thomas,C,STL,25,82,29,50,79
15,8474141,Patrick Kane,R,DET,36,82,26,53,79
15,8479407,Jesper Bratt,L,NJD,26,82,20,59,79
15,8475726,Tyler Toffoli,C,WPG,32,82,32,46,78
15,8475172,Nazem Kadri,C,CGY,34,82,26,52,78
15,8476346,Johnny Gaudreau,L,CBJ,31,82,17,61,78
15,8480208,Drake Batherson,R,OTT,26,82,40,37,77
15,8480801,Brady Tkachuk,L,OTT,25,82,31,46,77
15,8478439,Travis Konecny,R,PHI,27,82,30,47,77
15,8482116,Tim Stützle,C,OTT,22,82,28,49,77
15,8478444,Brock Boeser,R,VAN,27,82,41,35,76
15,8479339,Patrik Laine,L,CBJ,26,82,33,43,76
15,8480830,Andrei Svechnikov,R,CAR,24,82,30,46,76
15,8477940,Nikolaj Ehlers,L,WPG,28,82,28,48,76
15,8482665,Matty Beniers,C,SEA,22,82,27,49,76
15,8478414,Timo Meier,R,NJD,28,82,41,34,75
15,8471214,Alex Ovechkin,L,WSH,39,82,40,35,75
15,8475786,Zach Hyman,L,EDM,32,82,40,35,75
15,8480002,Nico Hischier,C,NJD,25,82,32,43,75
15,8480036,Miro Heiskanen,D,DAL,25,82,18,57,75
15,8477960,Adrian Kempe,R,LAK,28,82,37,37,74
15,8479337,Alex DeBrincat,R,DET,27,82,27,46,73
15,8480014,Gabriel Vilardi,C,WPG,25,82,38,34,72
15,8477447,Shea Theodore,D,VGK,29,82,13,59,72
15,8475810,Bryan Rust,R,PIT,32,82,46,25,71
15,8477955,Jared McCann,L,SEA,28,82,36,35,71
15,8481557,Matt Boldy,L,MIN,23,82,32,39,71
15,8477493,Aleksander Barkov,C,FLA,29,82,25,46,71
15,8475798,Mikael Granlund,C,SJS,32,82,21,50,71
15,8478493,Joel Eriksson Ek,C,MIN,27,82,35,35,70
15,8482093,Seth Jarvis,C,CAR,22,82,32,38,70
15,8480018,Nick Suzuki,C,MTL,25,82,20,50,70
15,8474590,John Carlson,D,WSH,34,82,20,50,70
15,8477494,Jonathan Drouin,L,COL,29,82,19,51,70
15,8477504,Josh Morrissey,D,WPG,29,82,12,58,70
15,8482078,Lucas Raymond,L,DET,22,82,34,35,69
15,8476539,Jonathan Marchessault,R,VGK,34,82,33,36,69
15,8477416,Oliver Bjorkstrand,R,SEA,29,82,32,37,69
15,8475166,John Tavares,C,TOR,34,82,29,40,69
15,8476459,Mika Zibanejad,C,NYR,31,82,28,41,69
15,8478440,Dylan Strome,C,WSH,27,82,24,45,69
15,8475184,Chris Kreider,L,NYR,33,82,41,27,68
15,8482159,Tyson Foerster,R,PHI,22,82,34,34,68
15,8479542,Brandon Hagel,L,TBL,26,82,30,38,68
15,8473419,Brad Marchand,L,BOS,36,82,27,41,68
15,8481596,Shane Pinto,C,OTT,24,82,24,44,68
15,8480839,Rasmus Dahlin,D,BUF,24,82,19,49,68
15,8479425,Filip Hronek,D,VAN,27,82,12,56,68
15,8478449,Roope Hintz,C,DAL,28,82,35,32,67
15,8481528,Dylan Cozens,C,BUF,23,82,24,43,67
15,8477942,Kevin Fiala,L,LAK,28,82,33,33,66
15,8473994,Jamie Benn,L,DAL,35,82,24,42,66
15,8476456,Jonathan Huberdeau,C,CGY,31,82,21,45,66
15,8480803,Evan Bouchard,D,EDM,25,82,15,51,66
15,8477346,MacKenzie Weegar,D,CGY,30,82,10,56,66
15,8475784,Jeff Skinner,C,BUF,32,82,30,35,65
15,8478856,Conor Garland,R,VAN,28,82,23,42,65
15,8479323,Adam Fox,D,NYR,26,82,9,56,65
15,8481542,Moritz Seider,D,DET,23,82,4,61,65
15,8476881,Tomas Hertl,C,VGK,31,82,32,32,64
15,8482667,William Eklund,L,SJS,22,82,30,34,64
15,8475158,Ryan O'Reilly,C,NSH,33,82,29,35,64
15,8481540,Cole Caufield,R,MTL,23,82,29,35,64
15,8476906,Shayne Gostisbehere,D,DET,31,82,13,51,64
15,8477500,Bo Horvat,C,NYI,29,82,41,22,63
15,8479675,Trevor Moore,L,LAK,29,82,25,38,63
15,8478047,Michael Bunting,L,PIT,29,82,19,44,63
15,8475692,Mats Zuccarello,R,MIN,37,82,15,48,63
15,8475168,Matt Duchene,C,DAL,33,82,36,26,62
15,8478042,Viktor Arvidsson,R,LAK,31,82,29,33,62
15,8480015,Owen Tippett,R,PHI,25,82,28,34,62
15,8475754,Brock Nelson,C,NYI,33,82,27,35,62
15,8477402,Pavel Buchnevich,L,STL,29,82,26,36,62
15,8473512,Claude Giroux,R,OTT,36,82,25,37,62
15,8478873,Troy Terry,R,ANA,27,82,25,37,62
15,8474679,Gustav Nyquist,C,NSH,35,82,17,45,62
15,8476483,Rickard Rakell,R,PIT,31,82,30,31,61
15,8478401,Pavel Zacha,C,BOS,27,82,27,34,61
15,8475170,Brayden Schenn,C,STL,33,82,23,38,61
15,8477951,Nick Schmaltz,C,ARI,28,82,20,41,61
15,8480797,Joel Farabee,L,PHI,24,82,20,41,61
15,8474565,Alex Pietrangelo,D,VGK,34,82,16,45,61
15,8476432,Boone Jenner,C,CBJ,31,82,31,29,60
15,8477476,Artturi Lehkonen,L,COL,29,82,30,30,60
15,8476389,Vincent Trocheck,C,NYR,31,82,28,32,60
15,8484144,Connor Bedard,C,CHI,19,82,26,34,60
15,8470794,Joe Pavelski,C,DAL,40,82,23,37,60
15,8476882,Teuvo Teravainen,L,CAR,30,82,16,44,60
15,8478458,Jack Roslovic,C,NYR,27,82,16,44,60
15,8479325,Charlie McAvoy,D,BOS,27,82,15,45,60
15,8480865,Noah Dobson,D,NYI,24,82,13,47,60
15,8473986,Alex Killorn,L,ANA,35,82,25,34,59
15,8478460,Zach Werenski,D,CBJ,27,82,24,35,59
15,8474150,Mikael Backlund,C,CGY,35,82,23,36,59
15,8476448,William Karlsson,C,VGK,31,82,31,27,58
15,8478366,Frank Vatrano,R,ANA,30,82,30,28,58
15,8475191,Reilly Smith,R,PIT,33,82,28,30,58
15,8481533,Trevor Zegras,C,ANA,23,82,24,34,58
15,8476479,Phillip Danault,C,LAK,31,82,23,35,58
15,8474563,Drew Doughty,D,LAK,35,82,15,43,58
15,8478397,Rasmus Andersson,D,CGY,28,82,13,45,58
15,8480188,Fabian Zetterlund,L,SJS,25,82,28,29,57
15,8475794,Tyler Seguin,C,DAL,32,82,25,32,57
15,8479525,Ross Colton,C,COL,28,82,23,34,57
15,8477503,Max Domi,C,TOR,29,82,21,36,57
15,8475745,Charlie Coyle,C,BOS,32,82,19,38,57
15,8480009,Eeli Tolvanen,R,SEA,25,82,19,38,57
15,8480434,Sean Durzi,D,ARI,26,82,15,42,57
15,8479410,Mikhail Sergachev,D,TBL,26,82,15,42,57
15,8478407,Vince Dunn,D,SEA,28,82,9,48,57
15,8482124,Quinton Byfield,R,LAK,22,82,20,36,56
15,8480039,Martin Necas,C,CAR,25,82,19,37,56
15,8481656,Aliaksei Protas,C,WSH,23,82,17,39,56
15,8476462,Dougie Hamilton,D,NJD,31,82,16,40,56
15,8478474,Lawson Crouse,L,ARI,27,82,29,26,55
15,8474053,Logan Couture,C,SJS,35,82,27,28,55
15,8477479,Tyler Bertuzzi,L,TOR,29,82,26,29,55
15,8477021,Alex Kerfoot,C,ARI,30,82,14,41,55
15,8481068,Yegor Sharangovich,C,CGY,26,82,27,27,54
15,8475218,Mattias Ekholm,D,EDM,34,82,15,39,54
15,8478396,Noah Hanifin,D,VGK,27,82,13,41,54
15,8474578,Erik Karlsson,D,PIT,34,82,11,43,54
15,8475765,Vladimir Tarasenko,R,FLA,33,82,27,26,53
15,8480064,Josh Norris,C,OTT,25,82,25,28,53
15,8475791,Taylor Hall,L,CHI,33,82,24,29,53
15,8475744,Evgeny Kuznetsov,C,CAR,32,82,14,39,53
15,8478438,Tommy Novak,C,NSH,27,82,11,42,53
15,8477935,Sam Bennett,C,FLA,28,82,25,27,52
15,8475151,Kyle Palmieri,C,NYI,33,82,24,28,52
15,8476880,Tom Wilson,R,WSH,30,82,23,29,52
15,8474586,Jordan Eberle,R,SEA,34,82,22,30,52
15,8482097,Jack Quinn,R,BUF,23,82,22,30,52
15,8478463,Anthony Beauvillier,L,NSH,27,82,17,35,52
15,8479987,Morgan Geekie,C,BOS,26,82,15,37,52
15,8482684,Luke Hughes,D,NJD,21,82,13,39,52
15,8482475,Yegor Chinakhov,R,CBJ,23,82,28,23,51
15,8477451,Ryan Hartman,R,MIN,30,82,23,28,51
15,8481618,Alex Newhook,C,MTL,23,82,21,30,51
15,8482745,Mason McTavish,C,ANA,21,82,20,31,51
15,8481711,Matias Maccelli,L,ARI,24,82,17,34,51
15,8476875,Mike Matheson,D,MTL,30,82,14,37,51
15,8471724,Kris Letang,D,PIT,37,82,13,38,51
15,8475197,Tyson Barrie,D,NSH,33,82,13,38,51
15,8475906,John Klingberg,D,TOR,32,82,10,41,51
15,8477495,Seth Jones,D,CHI,30,82,9,42,51
15,8481581,Thomas Harley,D,DAL,23,82,7,44,51
15,8475314,Anders Lee,L,NYI,34,82,24,26,50
15,8474157,Max Pacioretty,L,WSH,36,82,20,30,50
15,8482705,Cole Sillinger,C,CBJ,21,82,20,30,50
15,8480068,Ryan Poehling,C,PHI,25,82,18,32,50
15,8477986,Brandon Montour,D,FLA,30,82,11,39,50
15,8474641,Adam Henrique,C,EDM,34,82,29,20,49
15,8481580,Connor McMichael,C,WSH,23,82,28,21,49
15,8482113,Anton Lundell,C,FLA,23,82,26,23,49
15,8474102,David Perron,L,DET,36,82,22,27,49
15,8479400,Pierre-Luc Dubois,L,LAK,26,82,20,29,49
15,8479999,Casey Mittelstadt,C,COL,26,82,17,32,49
15,8479345,Jakob Chychrun,D,OTT,26,82,16,33,49
15,8480078,Filip Chytil,C,NYR,25,82,12,37,49
15,8477932,Aaron Ekblad,D,FLA,28,82,10,39,49
15,8478038,Devon Toews,D,COL,30,82,8,41,49
15,8477497,Sean Monahan,C,WPG,30,82,22,26,48
15,8476399,Blake Coleman,C,CGY,33,82,19,29,48
15,8475753,Justin Faulk,D,STL,32,82,11,37,48
15,8482109,Alexis Lafrenière,L,NYR,23,82,26,21,47
15,8481535,Nils Hoglander,L,VAN,24,82,25,22,47
15,8479393,Noah Gregor,C,TOR,26,82,25,22,47
15,8475287,Erik Haula,L,NJD,33,82,20,27,47
15,8476438,Brandon Saad,L,STL,32,82,19,28,47
15,8478233,Andrew Mangiapane,L,CGY,28,82,17,30,47
15,8476826,Yanni Gourde,C,SEA,33,82,13,34,47
15,8476958,Jaccob Slavin,D,CAR,30,82,7,40,47
15,8475764,Cam Fowler,D,ANA,33,82,4,43,47
15,8480459,Pius Suter,C,VAN,28,82,23,23,46
15,8475768,Jaden Schwartz,C,SEA,32,82,19,27,46
15,8475848,Brendan Gallagher,R,MTL,32,82,19,27,46
15,8478115,Pierre Engvall,L,NYI,28,82,17,29,46
15,8476905,Chandler Stephenson,C,VGK,30,82,16,30,46
15,8477407,Anthony Duclair,L,TBL,29,82,24,21,45
15,8476458,Ryan Strome,C,ANA,31,82,19,26,45
15,8482222,Alexander Barabanov,L,SJS,30,82,17,28,45
15,8473422,Nick Foligno,L,CHI,37,82,15,30,45
15,8476419,Jean-Gabriel Pageau,C,NYI,32,82,14,31,45
15,8478462,Nicolas Roy,C,VGK,27,82,13,32,45
15,8470613,Brent Burns,D,CAR,39,82,10,35,45
15,8480893,Kirill Marchenko,R,CBJ,24,82,28,16,44
15,8478975,Mason Marchment,L,DAL,29,82,20,24,44
15,8475793,Ryan Johansen,C,PHI,32,82,18,26,44
15,8471218,Blake Wheeler,R,NYR,38,82,17,27,44
15,8476461,Sean Couturier,C,PHI,32,82,17,27,44
15,8475714,Calle Jarnkrok,C,TOR,33,82,16,28,44
15,8473563,Nicklas Backstrom,C,WSH,37,82,15,29,44
15,8478472,Mathieu Joseph,R,OTT,27,82,11,33,44
15,8481560,Arthur Kaliyev,R,LAK,23,82,25,18,43
15,8478498,Jake DeBrusk,L,BOS,28,82,20,23,43
15,8476869,Brady Skjei,D,CAR,30,82,12,31,43
15,8476979,Erik Gustafsson,D,NYR,32,82,12,31,43
15,8482110,Dawson Mercer,C,NJD,23,82,22,20,42
15,8480113,Alex Iafallo,L,WPG,31,82,22,20,42
15,8477511,Anthony Mantha,R,VGK,30,82,20,22,42
15,8477429,Andrew Copp,C,DET,30,82,20,22,42
15,8477426,Nicholas Paul,L,TBL,29,82,20,22,42
15,8475799,Nino Niederreiter,R,WPG,32,82,18,24,42
15,8470610,Zach Parise,L,COL,40,82,16,26,42
15,8480145,Neal Pionk,D,WPG,29,82,9,33,42
15,8483808,Andrei Kuzmenko,L,CGY,28,82,24,17,41
15,8474037,James van Riemsdyk,L,BOS,35,82,20,21,41
15,8480028,Morgan Frost,C,PHI,25,82,19,22,41
15,8475169,Evander Kane,L,EDM,33,82,19,22,41
15,8482699,Dylan Guenther,R,ARI,21,82,18,23,41
15,8479992,Michael Rasmussen,C,DET,25,82,18,23,41
15,8477456,J.T. Compher,L,DET,29,82,17,24,41
15,8476927,Teddy Blueger,C,VAN,30,82,15,26,41
15,8476872,Scott Laughton,C,PHI,30,82,13,28,41
15,8482671,Owen Power,D,BUF,22,82,11,30,41
15,8479977,Kailer Yamamoto,R,SEA,26,82,22,18,40
15,8474189,Lars Eller,C,PIT,35,82,20,20,40
15,8476921,Jordan Martinook,L,CAR,32,82,20,20,40
15,8479346,Dillon Dube,C,CGY,26,82,20,20,40
15,8477998,Warren Foegele,L,EDM,28,82,19,21,40
15,8482055,Drew O'Connor,L,PIT,26,82,18,22,40
15,8478109,Victor Olofsson,L,BUF,29,82,17,23,40
15,8480185,Eetu Luostarinen,C,FLA,26,82,17,23,40
15,8477989,Christian Dvorak,C,MTL,28,82,17,23,40
15,8479351,Sam Steel,C,DAL,26,82,14,26,40
15,8477948,Travis Sanheim,D,PHI,28,82,9,31,40
15,8478469,Thomas Chabot,D,OTT,27,82,7,33,40
15,8478055,Gustav Forsling,D,FLA,28,82,6,34,40
15,8475722,Jason Zucker,L,NSH,32,82,21,18,39
15,8482146,Luke Evangelista,R,NSH,22,82,21,18,39
15,8478020,Michael Amadio,C,VGK,28,82,21,18,39
15,8471698,T.J. Oshie,R,WSH,38,82,20,19,39
15,8479415,Michael McLeod,C,NJD,26,82,18,21,39
15,8478542,Evan Rodrigues,C,FLA,31,82,17,22,39
15,8476329,Travis Boyd,C,ARI,31,82,11,28,39
15,8479398,Samuel Girard,D,COL,26,82,4,35,39
15,8473533,Jordan Staal,C,CAR,36,82,22,16,38
15,8477952,Robby Fabbri,C,DET,28,82,20,18,38
15,8475760,Nick Bjugstad,C,ARI,32,82,19,19,38
15,8478057,Dakota Joshua,C,VAN,28,82,17,21,38
15,8477444,Andre Burakovsky,L,SEA,29,82,16,22,38
15,8478519,Anthony Cirelli,C,TBL,27,82,16,22,38
15,8482079,Marco Rossi,C,MIN,23,82,16,22,38
15,8477964,Ivan Barbashev,C,VGK,29,82,11,27,38
15,8475763,Kevin Hayes,R,STL,32,82,10,28,38
15,8478133,Jake Evans,C,MTL,28,82,9,29,38
15,8476892,Colton Parayko,D,STL,31,82,8,30,38
15,8481704,Juuso Parssinen,C,NSH,23,82,28,9,37
15,8482089,Jake Neighbours,L,STL,22,82,20,17,37
15,8480821,Filip Zadina,R,SJS,25,82,20,17,37
15,8480798,Philipp Kurashev,C,CHI,25,82,19,18,37
15,8480220,Noah Cates,L,PHI,25,82,18,19,37
15,8482175,JJ Peterka,R,BUF,22,82,18,19,37
15,8476292,Ondrej Palat,L,NJD,33,82,17,20,37
15,8482105,Jake Sanderson,D,OTT,22,82,11,26,37
15,8474716,Jared Spurgeon,D,MIN,35,82,9,28,37
15,8481554,Kaapo Kakko,R,NYR,23,82,24,12,36
15,8476469,Joel Armia,R,MTL,31,82,24,12,36
15,8478466,Daniel Sprong,R,DET,27,82,18,18,36
15,8481013,Jonatan Berggren,R,DET,24,82,17,19,36
15,8473449,Kyle Okposo,R,FLA,36,82,16,20,36
15,8483431,Logan Cooley,C,ARI,20,82,16,20,36
15,8476792,Torey Krug,D,STL,33,82,15,21,36
15,8479591,Michael Eyssimont,C,TBL,28,82,15,21,36
15,8481186,Logan O'Connor,R,COL,28,82,15,21,36
15,8477947,Sonny Milano,L,WSH,28,82,14,22,36
15,8481481,Blake Lizotte,C,LAK,27,82,13,23,36
15,8480336,Sean Walker,D,COL,30,82,11,25,36
15,8482133,Thomas Bordeleau,C,SJS,22,82,8,28,36
15,8476923,Damon Severson,D,CBJ,30,82,6,30,36
15,8477506,Ryan Pulock,D,NYI,30,82,6,30,36
15,8480043,Timothy Liljegren,D,TOR,25,82,5,31,36
15,8482074,Connor Zary,C,CGY,23,82,19,16,35
15,8480849,Barrett Hayton,C,ARI,24,82,18,17,35
15,8479365,Trent Frederic,C,BOS,26,82,17,18,35
15,8482740,Wyatt Johnston,C,DAL,21,82,16,19,35
15,8478046,Danton Heinen,L,BOS,29,82,15,20,35
15,8482720,Matthew Knies,L,TOR,22,82,14,21,35
15,8473453,Trevor Lewis,C,LAK,37,82,14,21,35
15,8476897,Oskar Sundqvist,C,STL,30,82,12,23,35
15,8480873,Rasmus Sandin,D,WSH,24,82,5,30,35
15,8477425,Miles Wood,L,COL,29,82,19,15,34
15,8470604,Jeff Carter,C,PIT,39,82,17,17,34
15,8476480,Vladislav Namestnikov,C,WPG,32,82,13,21,34
15,8473507,Jeff Petry,D,DET,37,82,4,30,34
15,8476873,Mark Jankowski,C,NSH,30,82,19,14,33
15,8476960,Andreas Athanasiou,C,CHI,30,82,15,18,33
15,8474715,Cam Atkinson,R,PHI,35,82,13,20,33
15,8480802,Ryan McLeod,C,EDM,25,82,12,21,33
15,8479514,Rem Pitlick,C,CHI,27,82,12,21,33
15,8477953,Kasperi Kapanen,R,STL,28,82,10,23,33
15,8477498,Darnell Nurse,D,EDM,29,82,10,23,33
15,8481703,Valtteri Puustinen,R,PIT,25,82,8,25,33
15,8477969,Marcus Pettersson,D,PIT,28,82,4,29,33
15,8481604,Pavel Dorofeyev,L,VGK,24,82,22,10,32
15,8477919,Frederick Gaudreau,C,MIN,31,82,15,17,32
15,8475164,Jakob Silfverberg,R,ANA,34,82,15,17,32
15,8479996,Cody Glass,C,NSH,25,82,14,18,32
15,8480855,Jack McBain,C,ARI,24,82,14,18,32
15,8481522,Peyton Krebs,C,BUF,23,82,11,21,32
15,8478430,Oliver Kylington,D,CGY,27,82,11,21,32
15,8476854,Hampus Lindholm,D,BOS,30,82,9,23,32
15,8479983,Mario Ferraro,D,SJS,26,82,8,24,32
15,8475231,Casey Cizikas,C,NYI,33,82,8,24,32
15,8477845,Trevor van Riemsdyk,D,WSH,33,82,7,25,32
15,8480871,Adam Boqvist,D,CBJ,24,82,5,27,32
15,8476931,Jake McCabe,D,TOR,31,82,3,29,32
15,8479293,Brandon Tanev,L,SEA,33,82,17,14,31
15,8480806,Isac Lundestrom,C,ANA,25,82,16,15,31
15,8481477,Nico Sturm,C,SJS,29,82,16,15,31
15,8479941,Justin Danforth,R,CBJ,31,82,15,16,31
15,8478413,Jordan Greenway,L,BUF,27,82,14,17,31
15,8475343,Nic Dowd,C,WSH,34,82,12,19,31
15,8483457,Lane Hutson,D,MTL,20,82,12,19,31
15,8478891,Mason Appleton,C,WPG,28,82,10,21,31
15,8476885,Jacob Trouba,D,NYR,30,82,10,21,31
15,8475149,Marcus Johansson,L,MIN,34,82,9,22,31
15,8475171,Oliver Ekman-Larsson,D,FLA,33,82,9,22,31
15,8480817,K'Andre Miller,D,NYR,24,82,8,23,31
15,8481546,Cam York,D,PHI,23,82,6,25,31
15,8477507,Nikita Zadorov,D,VAN,29,82,6,25,31
15,8478508,Yakov Trenin,C,COL,27,82,20,10,30
15,8482092,Ridly Greig,C,OTT,22,82,19,11,30
15,8476981,Josh Anderson,R,MTL,30,82,19,11,30
15,8474884,Mike Hoffman,C,SJS,35,82,13,17,30
15,8480074,Alexandre Texier,C,CBJ,25,82,11,19,30
15,8470621,Corey Perry,R,EDM,39,82,10,20,30
15,8476902,Esa Lindell,D,DAL,30,82,6,24,30
15,8474151,Ryan McDonagh,D,NSH,35,82,4,26,30
15,8481606,Jordan Spence,D,LAK,23,82,3,27,30
15,8476463,Jonas Brodin,D,MIN,31,82,3,27,30
15,8482666,Scott Morrow,D,CAR,22,82,18,11,29
15,8475842,Sam Carrick,C,EDM,32,82,17,12,29
15,8475200,Dmitry Orlov,D,CAR,33,82,12,17,29
15,8476871,Tanner Pearson,L,MTL,32,82,11,18,29
15,8476278,Colin Blackwell,C,CHI,31,82,11,18,29
15,8480813,Joe Veleno,C,DET,24,82,11,18,29
15,8476392,Adam Lowry,C,WPG,31,82,10,19,29
15,8474870,Tyler Johnson,C,CHI,34,82,17,11,28
15,8477944,Jakub Vrana,L,STL,28,82,17,11,28
15,8483515,Juraj Slafkovsky,L,MTL,20,82,16,12,28
15,8475220,Marcus Foligno,L,MIN,33,82,15,13,28
15,8482117,Lukas Reichel,L,CHI,22,82,14,14,28
15,8477839,Conor Sheary,L,TBL,32,82,14,14,28
15,8484166,Adam Fantilli,C,CBJ,20,82,11,17,28
15,8479390,Taylor Raddysh,R,CHI,26,82,10,18,28
15,8478507,John Marino,D,NJD,27,82,3,25,28
15,8481624,Ilya Mikheyev,R,VAN,30,82,15,12,27
15,8482062,Cole Smith,L,NSH,29,82,15,12,27
15,8481093,Rafael Harvey-Pinard,L,MTL,25,82,14,13,27
15,8479661,Tanner Jeannot,L,TBL,27,82,14,13,27
15,8479316,Luke Kunin,C,SJS,27,82,11,16,27
15,8477931,Tomas Nosek,L,NJD,32,82,9,18,27
15,8480144,David Kampf,C,TOR,29,82,8,19,27
15,8474673,TJ Brodie,D,TOR,34,82,7,20,27
15,8476925,Colton Sissons,C,NSH,31,82,6,21,27
15,8479976,Juuso Valimaki,D,ARI,26,82,6,21,27
15,8474149,Evgenii Dadonov,R,DAL,35,82,5,22,27
15,8480246,Nick Perbix,D,TBL,26,82,5,22,27
15,8475188,Brayden McNabb,D,VGK,33,82,3,24,27
15,8478416,Erik Cernak,D,TBL,27,82,2,25,27
15,8478840,Will Borgen,D,SEA,28,82,2,25,27
15,8477488,Brett Pesce,D,CAR,30,82,2,25,27
15,8482624,Daniil Miromanov,D,CGY,27,82,13,13,26
15,8483505,Matthew Poitras,C,BOS,20,82,11,15,26
15,8482111,Justin Barron,D,MTL,23,82,10,16,26
15,8478013,Jake Walman,D,DET,28,82,10,16,26
15,8478851,Alexandre Carrier,D,NSH,28,82,8,18,26
15,8474034,Pat Maroon,L,BOS,36,82,7,19,26
15,8476429,Scott Mayfield,D,NYI,32,82,5,21,26
15,8482166,Shakir Mukhamadullin,D,SJS,22,82,5,21,26
15,8476917,Adam Pelech,D,NYI,30,82,4,22,26
15,8482259,Bobby McMann,C,TOR,28,82,15,10,25
15,8480995,Pontus Holmberg,R,TOR,25,82,13,12,25
15,8482125,Alexander Holtz,R,NJD,22,82,10,15,25
15,8477499,Rasmus Ristolainen,D,PHI,30,82,9,16,25
15,8476312,Josh Manson,D,COL,33,82,7,18,25
15,8483468,Jiri Kulich,C,BUF,20,82,7,18,25
15,8476624,Barclay Goodrow,C,NYR,31,82,6,19,25
15,8481537,Nikita Okhotiuk,D,CGY,24,82,5,20,25
15,8481568,Alex Vlasic,D,CHI,23,82,5,20,25
15,8475790,Erik Gudbranson,D,CBJ,32,82,5,20,25
15,8478500,Ivan Provorov,D,CBJ,27,82,4,21,25
15,8476331,Dylan DeMelo,D,WPG,31,82,3,22,25
15,8480073,Erik Brannstrom,D,OTT,25,82,3,22,25
15,8475324,Nick Jensen,D,WSH,34,82,2,23,25
15,8477015,Connor Brown,R,EDM,30,82,15,9,24
15,8477330,Dominik Kubalik,L,OTT,29,82,9,15,24
15,8470966,Mark Giordano,D,TOR,41,82,9,15,24
15,8474574,Tyler Myers,D,VAN,34,82,7,17,24
15,8477220,Nate Schmidt,D,WPG,33,82,6,18,24
15,8477450,Jason Dickinson,C,CHI,29,82,5,19,24
15,8479980,Nicolas Hague,D,VGK,26,82,5,19,24
15,8478178,Darren Raddysh,D,TBL,28,82,5,19,24
15,8479369,Andrew Peeke,D,BOS,26,82,4,20,24
15,8482655,J.J. Moser,D,ARI,24,82,3,21,24
15,8475690,Chris Tanev,D,DAL,35,82,3,21,24
15,8476967,Brett Kulak,D,EDM,30,82,3,21,24
15,8478043,Sam Lafferty,C,VAN,29,82,17,6,23
15,8481601,Simon Holmstrom,R,NYI,23,82,14,9,23
15,8482762,Simon Edvinsson,D,DET,21,82,9,14,23
15,8482809,Jackson Blake,R,CAR,21,82,9,14,23
15,8476457,Adam Larsson,D,SEA,32,82,8,15,23
15,8478451,Ethan Bear,D,WSH,27,82,8,15,23
15,8483763,Maksymilian Szuber,D,ARI,22,82,8,15,23
15,8480172,Jan Rutta,D,SJS,34,82,8,15,23
15,8477353,Tyler Motte,C,TBL,29,82,7,16,23
15,8480035,Henri Jokiharju,D,BUF,25,82,6,17,23
15,8478911,Matt Roy,D,LAK,29,82,5,18,23
15,8480807,Mattias Samuelsson,D,BUF,24,82,4,19,23
15,8475208,Brian Dumoulin,D,SEA,33,82,4,19,23
15,8477365,Connor Clifton,D,BUF,29,82,2,21,23
15,8475233,David Savard,D,MTL,34,82,2,21,23
15,8480281,Alexey Toropchenko,R,STL,25,82,15,7,22
15,8479423,Alex Nylander,L,CBJ,26,82,10,12,22
15,8482118,Sam Colangelo,R,ANA,23,82,8,14,22
15,8481553,Bobby Brink,R,PHI,23,82,7,15,22
15,8484203,Bradly Nadeau,L,CAR,19,82,7,15,22
15,8483495,Simon Nemec,D,NJD,20,82,6,16,22
15,8483490,Pavel Mintyukov,D,ANA,21,82,6,16,22
15,8479324,Ryan Lindgren,D,NYR,26,82,4,18,22
15,8481567,Henry Thrun,D,SJS,23,82,4,18,22
15,8483565,Nick Blankenburg,D,CBJ,26,82,4,18,22
15,8476525,Colin Miller,D,WPG,32,82,3,19,22
15,8479371,Dante Fabbro,D,NSH,26,82,3,19,22
15,8483524,Shane Wright,C,SEA,20,82,11,10,21
15,8481517,Brett Leason,R,ANA,25,82,8,13,21
15,8476422,Mike Reilly,D,NYI,31,82,7,14,21
15,8476442,Matt Nieto,L,PIT,32,82,7,14,21
15,8477508,Curtis Lazar,C,NJD,29,82,7,14,21
15,8480796,Martin Fehervary,D,WSH,25,82,7,14,21
15,8483482,Tristan Luneau,D,ANA,20,82,7,14,21
15,8477435,Ryan Graves,D,PIT,29,82,6,15,21
15,8478136,Jake Middleton,D,MIN,28,82,5,16,21
15,8470600,Ryan Suter,D,DAL,39,82,5,16,21
15,8479998,Mikey Anderson,D,LAK,25,82,3,18,21
15,8482073,Braden Schneider,D,NYR,23,82,3,18,21
15,8477335,Kyle Burroughs,D,SJS,29,82,2,19,21
15,8482122,Brock Faber,D,MIN,22,82,1,20,21
15,8480860,Kevin Bahl,D,NJD,24,82,0,21,21
15,8479359,Beck Malenstyn,L,WSH,26,82,12,8,20
15,8476374,Sean Kuraly,C,CBJ,31,82,10,10,20
15,8477392,Hudson Fasching,R,NYI,29,82,10,10,20
15,8478569,Noel Acciari,C,PIT,33,82,10,10,20
15,8481178,Egor Zamula,D,PHI,24,82,9,11,20
15,8474009,Nick Bonino,C,NYR,36,82,8,12,20
15,8482679,Matt Coronato,R,CGY,22,82,8,12,20
15,8479353,Brett Howden,C,VGK,26,82,7,13,20
15,8477406,Mattias Janmark,C,EDM,32,82,6,14,20
15,8476467,Jamie Oleksiak,D,SEA,32,82,5,15,20
15,8482101,Danil Gushchin,L,SJS,22,82,5,15,20
15,8484153,Leo Carlsson,C,ANA,20,82,4,16,20
15,8480834,Ty Emberson,D,SJS,24,82,4,16,20
15,8481014,Alexander Romanov,D,NYI,24,82,4,16,20
15,8476879,Cody Ceci,D,EDM,31,82,3,17,20
15,8482245,Artem Zub,D,OTT,29,82,3,17,20
15,8475181,Nick Leddy,D,STL,33,82,2,18,20
15,8480058,Pierre-Olivier Joseph,D,PIT,25,82,2,18,20
15,8478882,Vladislav Gavrikov,D,LAK,29,82,0,20,20
15,8482807,Ethan Del Mastro,D,CHI,21,82,11,8,19
15,8481524,Bowen Byram,D,BUF,23,82,10,9,19
15,8483445,Cutter Gauthier,L,ANA,20,82,8,11,19
15,8473504,Cal Clutterbuck,R,NYI,37,82,8,11,19
15,8478468,Jeremy Lauzon,D,NSH,27,82,8,11,19
15,8480990,Declan Chisholm,D,MIN,24,82,7,12,19
15,8479383,Boris Katchouk,L,OTT,26,82,7,12,19
15,8481030,Jack St. Ivany,D,PIT,25,82,6,13,19
15,8483471,Brad Lambert,C,WPG,31,82,6,13,19
15,8484149,Gavin Brindley,C,CBJ,20,82,5,14,19
15,8474166,Alec Martinez,D,VGK,37,82,4,15,19
15,8474013,Ian Cole,D,VAN,35,82,3,16,19
15,8482142,Jamie Drysdale,D,PHI,22,82,1,18,19
15,8479291,Kevin Rooney,C,CGY,31,82,8,10,18
15,8480031,Maxime Comtois,L,CAR,25,82,6,12,18
15,8483466,Kevin Korchinski,D,CHI,20,82,5,13,18
15,8476891,Matt Grzelcyk,D,BOS,30,82,3,15,18
15,8481059,Scott Perunovich,D,STL,26,82,3,15,18
15,8475462,Radko Gudas,D,ANA,34,82,2,16,18
15,8482712,Oskar Olausson,R,COL,22,82,8,9,17
15,8483012,Logan Morrison,C,SEA,22,82,7,10,17
15,8478443,Brandon Carlo,D,BOS,28,82,5,12,17
15,8480448,Parker Kelly,L,OTT,25,82,5,12,17
15,8483491,Ivan Miroshnichenko,L,WSH,20,82,5,12,17
15,8482470,Ilya Solovyov,D,CGY,24,82,5,12,17
15,8482803,Olen Zellweger,D,ANA,21,82,4,13,17
15,8482087,Kaiden Guhle,D,MTL,22,82,4,13,17
15,8481605,Jackson LaCombe,D,ANA,23,82,4,13,17
15,8474567,Zach Bogosian,D,MIN,34,82,4,13,17
15,8483493,Frank Nazar,C,CHI,20,82,3,14,17
15,8481028,Martin Pospisil,C,CGY,25,82,3,14,17
15,8480879,Jacob Bernard-Docker,D,OTT,24,82,3,14,17
15,8477505,Alexander Wennberg,C,NYR,30,82,8,8,16
15,8482702,Logan Stankoven,C,DAL,21,82,6,10,16
15,8475177,Calvin de Haan,D,TBL,33,82,6,10,16
15,8478399,Jonas Siegenthaler,D,NJD,27,82,3,13,16
15,8475455,Brenden Dillon,D,WPG,34,82,2,14,16
15,8478859,Niko Mikkola,D,FLA,28,82,2,14,16
15,8476858,Phillip Di Giuseppe,L,VAN,31,82,9,6,15
15,8482155,Alex Laferriere,R,LAK,23,82,9,6,15
15,8481578,Graeme Clarke,R,NJD,23,82,7,8,15
15,8482733,Logan Mailloux,D,MTL,31,82,7,8,15
15,8483499,Liam Ohgren,L,MIN,20,82,7,8,15
15,8484145,Zach Benson,L,BUF,19,82,6,9,15
15,8482145,Mavrik Bourque,C,DAL,22,82,5,10,15
15,8475825,Jani Hakanpää,D,DAL,32,82,5,10,15
15,8484911,Collin Graf,R,SJS,22,82,4,11,15
15,8481599,Victor Soderstrom,D,ARI,23,82,6,8,14
15,8475279,Ben Chiarot,D,DET,33,82,4,10,14
15,8476372,Nick Seeler,D,PHI,31,82,3,11,14
15,8477034,Jaycob Megna,D,CHI,32,82,2,12,14
15,8481016,Ruslan Iskhakov,C,NYI,24,82,7,6,13
15,8482730,Brandt Clarke,D,LAK,21,82,6,7,13
15,8475179,Dmitry Kulikov,D,FLA,34,82,3,10,13
15,8476473,Connor Murphy,D,CHI,31,82,2,11,13
15,8479442,Troy Stecher,D,EDM,30,82,6,6,12
15,8482858,Ryker Evans,D,SEA,23,82,5,7,12
15,8482713,Mackie Samoskevich,R,FLA,22,82,4,8,12
15,8482516,Matthew Kessel,D,STL,24,82,3,9,12
15,8476822,Luke Glendening,C,TBL,35,82,8,3,11
15,8476915,Jujhar Khaira,L,MIN,30,82,8,3,11
15,8482859,Zack Ostapchuk,C,OTT,21,82,6,5,11
15,8478408,Travis Dermott,D,ARI,28,82,5,6,11
15,8483397,Marc McLaughlin,C,BOS,25,82,5,6,11
15,8477369,Carson Soucy,D,VAN,30,82,3,8,11
15,8481699,Aku Raty,R,ARI,23,82,2,9,11
15,8478831,Kevin Stenlund,C,FLA,28,82,8,2,10
15,8475762,Derek Forbort,D,BOS,32,82,4,6,10
15,8471677,Jack Johnson,D,COL,37,82,2,8,10
15,8482737,Zack Bolduc,C,STL,21,82,6,3,9
15,8476878,Zemgus Girgensons,L,BUF,30,82,3,4,7
15,8482177,Marat Khusnutdinov,C,MIN,22,82,2,5,7
15,8483489,Fraser Minten,C,TOR,31,82,4,2,6
15,8477950,Tony DeAngelo,D,CAR,29,0,0,0,0
15,8481577,Philip Tomasino,C,NSH,23,0,0,0,0
15,8482660,Kent Johnson,C,CBJ,22,0,0,0,0
15,8481019,David Gustafsson,C,WPG,24,0,0,0,0
15,8479348,Kale Clague,D,BUF,26,0,0,0,0
15,8482149,Cole Perfetti,C,WPG,22,0,0,0,0
15,8476952,Dominic Toninato,C,WPG,30,0,0,0,0
15,8473473,Milan Lucic,L,BOS,36,0,0,0,0
15,8480829,Jesperi Kotkaniemi,C,CAR,24,0,0,0,0
15,8474602,Justin Schultz,D,SEA,34,0,0,0,0
15,8480049,Dylan Samberg,D,WPG,25,0,0,0,0
15,8479372,Josh Mahura,D,FLA,26,0,0,0,0
15,8480878,Nils Lundkvist,D,DAL,24,0,0,0,0
15,8479982,Conor Timmins,D,TOR,26,0,0,0,0
15,8474031,Kevin Shattenkirk,D,BOS,35,0,0,0,0
15,8480835,Jack Drury,C,CAR,24,0,0,0,0
15,8480008,Adam Ruzicka,C,ARI,25,0,0,0,0
15,8479402,Jake Bean,D,CBJ,26,0,0,0,0
15,8476474,Stefan Noesen,R,CAR,31,0,0,0,0
15,8480884,Calen Addison,D,SJS,24,0,0,0,0
15,8476994,Vinnie Hinostroza,C,PIT,30,0,0,0,0
15,8477987,Ryan Donato,C,CHI,28,0,0,0,0
15,8481582,Nicholas Robertson,L,TOR,23,0,0,0,0
15,8478452,Caleb Jones,D,COL,27,0,0,0,0
15,8480157,Calle Rosen,D,STL,30,0,0,0,0
15,8481609,Vladislav Kolyachonok,D,ARI,23,0,0,0,0
15,8476919,Chris Tierney,C,NJD,30,0,0,0,0
15,8479639,Dylan Coghlan,D,CAR,26,0,0,0,0
15,8475193,Tomas Tatar,L,SEA,34,0,0,0,0
15,8480748,Kiefer Sherwood,L,NSH,29,0,0,0,0
15,8478146,Matthew Highmore,C,OTT,28,0,0,0,0
15,8478970,Jalen Chatfield,D,CAR,28,0,0,0,0
15,8480205,Emil Bemstrom,C,PIT,25,0,0,0,0
15,8471274,Alex Goligoski,D,MIN,39,0,0,0,0
15,8478104,Sammy Blais,L,STL,28,0,0,0,0
15,8476913,Devin Shore,C,SEA,30,0,0,0,0
15,8481708,Zac Jones,D,NYR,24,0,0,0,0
15,8480222,Sebastian Aho,D,NYI,28,0,0,0,0
15,8481598,Philip Broberg,D,EDM,23,0,0,0,0
15,8480789,Oliver Wahlstrom,R,NYI,24,0,0,0,0
15,8480891,Michael Kesselring,D,ARI,24,0,0,0,0
15,8477979,Nicolas Aube-Kubel,R,WSH,28,0,0,0,0
15,8476393,Nick Cousins,C,FLA,31,0,0,0,0
15,8480003,Jesper Boqvist,C,BOS,26,0,0,0,0
15,8479543,Michael Pezzetta,L,MTL,26,0,0,0,0
15,8475855,Jesper Fast,R,CAR,33,0,0,0,0
15,8477018,Ben Hutton,D,VGK,31,0,0,0,0
15,8480762,Eric Robinson,L,BUF,29,0,0,0,0
15,8481058,Jesse Ylönen,R,MTL,25,0,0,0,0
15,8481527,Kaedan Korczak,D,VGK,23,0,0,0,0
15,8482192,Isaak Phillips,D,CHI,23,0,0,0,0
15,8480727,Zach Whitecloud,D,VGK,28,0,0,0,0
15,8480001,Urho Vaakanainen,D,ANA,25,0,0,0,0
15,8480853,Liam Foudy,C,NSH,24,0,0,0,0
15,8475225,Craig Smith,C,DAL,35,0,0,0,0
15,8479972,Mason Shaw,C,MIN,26,0,0,0,0
15,8474040,Sam Gagner,C,EDM,35,0,0,0,0
15,8480196,Jacob Bryson,D,BUF,27,0,0,0,0
15,8475718,Justin Holl,D,DET,32,0,0,0,0
15,8479984,Cal Foote,D,NJD,26,0,0,0,0
15,8480011,Klim Kostin,C,SJS,25,0,0,0,0
15,8482176,Wyatt Kaiser,D,CHI,22,0,0,0,0
15,8476918,Jimmy Vesey,L,NYR,31,0,0,0,0
15,8476988,Matt Benning,D,SJS,30,0,0,0,0
15,8479370,Tyson Jost,C,BUF,26,0,0,0,0
15,8477464,Nic Petan,C,MIN,29,0,0,0,0
15,8477380,Jonny Brodzinski,C,NYR,31,0,0,0,0
15,8480070,Ian Mitchell,D,BOS,25,0,0,0,0
15,8479315,Joey Anderson,R,CHI,26,0,0,0,0
15,8478099,Kevin Labanc,R,SJS,29,0,0,0,0
15,8476874,Olli Maatta,D,DET,30,0,0,0,0
15,8479414,Nathan Bastian,R,NJD,27,0,0,0,0
15,8478434,Keegan Kolesar,R,VGK,27,0,0,0,0
15,8479536,Axel Jonsson-Fjallby,L,WPG,26,0,0,0,0
15,8479671,Mathieu Olivier,R,CBJ,27,0,0,0,0
15,8471709,Marc-Edouard Vlasic,D,SJS,37,0,0,0,0
15,8479328,Julien Gauthier,R,NYI,27,0,0,0,0
15,8478421,A.J. Greer,L,CGY,28,0,0,0,0
15,8477573,Nathan Walker,L,STL,30,0,0,0,0
15,8477478,William Carrier,L,VGK,30,0,0,0,0
15,8479344,Jesse Puljujarvi,R,PIT,26,0,0,0,0
15,8480887,Jordan Harris,D,MTL,24,0,0,0,0
15,8478502,Dennis Gilbert,D,CGY,28,0,0,0,0
15,8480355,Mark Kastelic,C,OTT,25,0,0,0,0
15,8475750,Jon Merrill,D,MIN,32,0,0,0,0
15,8476889,Radek Faksa,C,DAL,30,0,0,0,0
15,8478432,Christian Fischer,R,DET,27,0,0,0,0
15,8479439,Jacob MacDonald,D,SJS,31,0,0,0,0
15,8474568,Luke Schenn,D,NSH,35,0,0,0,0
15,8478454,Noah Juulsen,D,VAN,27,0,0,0,0
15,8475752,Tyler Pitlick,C,NYR,33,0,0,0,0
15,8482148,Hendrix Lapierre,C,WSH,22,0,0,0,0
15,8481167,Brayden Pachal,D,CGY,25,0,0,0,0
15,8478211,Dryden Hunt,L,CGY,29,0,0,0,0
15,8479321,Lucas Johansen,D,WSH,27,0,0,0,0
15,8480950,Ilya Lyubushkin,D,TOR,30,0,0,0,0
15,8479368,Max Jones,L,ANA,26,0,0,0,0
15,8471699,Andrew Cogliano,C,COL,37,0,0,0,0
15,8481521,Ronnie Attard,D,PHI,25,0,0,0,0
15,8481161,Jake Christiansen,D,CBJ,25,0,0,0,0
15,8479458,Nikita Zaitsev,D,CHI,33,0,0,0,0
15,8479619,Michael Carcone,L,ARI,28,0,0,0,0
15,8479026,Philippe Myers,D,TBL,27,0,0,0,0
15,8481617,Vasily Podkolzin,R,VAN,23,0,0,0,0
15,8481701,Santeri Hatakka,D,NJD,23,0,0,0,0
15,8477446,Michael McCarron,R,NSH,29,0,0,0,0
15,8483460,David Jiricek,D,CBJ,21,0,0,0,0
15,8474090,Brendan Smith,D,NJD,35,0,0,0,0
15,8482241,Radim Zohorna,L,PIT,28,0,0,0,0
15,8481032,Paul Cotter,C,VGK,25,0,0,0,0
15,8480289,Morgan Barron,C,WPG,26,0,0,0,0
15,8479379,Givani Smith,R,SJS,26,0,0,0,0
15,8480216,Jacob Peterson,C,SJS,25,0,0,0,0
15,8477851,Jordan Oesterle,D,CGY,32,0,0,0,0
15,8484258,Sam Malinski,D,COL,26,0,0,0,0
15,8478904,Steven Lorentz,C,FLA,28,0,0,0,0
15,8482095,Tyler Kleven,D,OTT,22,0,0,0,0
15,8480980,Connor Dewar,C,TOR,25,0,0,0,0
15,8480848,Ty Dellandrea,C,DAL,24,0,0,0,0
15,8476884,Derrick Pouliot,D,DAL,30,0,0,0,0
15,8480025,MacKenzie Entwistle,R,CHI,25,0,0,0,0
15,8474612,Travis Hamonic,D,OTT,34,0,0,0,0
15,8479336,Carl Grundstrom,R,LAK,27,0,0,0,0
15,8482964,Arber Xhekaj,D,MTL,23,0,0,0,0
15,8471686,Marc Staal,D,PHI,37,0,0,0,0
15,8477887,Patrick Brown,C,BOS,32,0,0,0,0
15,8478495,Denis Gurianov,R,PHI,27,0,0,0,0
15,8481550,Adam Beckman,L,MIN,23,0,0,0,0
15,8480845,Rasmus Kupari,C,WPG,24,0,0,0,0
15,8478585,Derek Ryan,C,EDM,38,0,0,0,0
15,8482141,Lukas Cormier,D,VGK,22,0,0,0,0
15,8477962,Brendan Lemieux,L,CAR,28,0,0,0,0
15,8482861,Vincent Iorio,D,WSH,22,0,0,0,0
15,8479378,Logan Stanley,D,WPG,26,0,0,0,0
15,8473446,Erik Johnson,D,PHI,36,0,0,0,0
15,8481743,Marc Del Gaizo,D,NSH,25,0,0,0,0
15,8478450,Parker Wotherspoon,D,BOS,27,0,0,0,0
15,8477384,Josh Brown,D,ARI,30,0,0,0,0
15,8482165,Yan Kuznetsov,D,CGY,22,0,0,0,0
15,8478424,Jansen Harkins,C,PIT,27,0,0,0,0
15,8482144,Jack Thompson,D,SJS,22,0,0,0,0
15,8479576,Vincent Desharnais,D,EDM,28,0,0,0,0
15,8478512,Austin Czarnik,C,DET,32,0,0,0,0
15,8477527,Ross Johnston,L,ANA,30,0,0,0,0
15,8482094,Daemon Hunt,D,MIN,22,0,0,0,0
15,8481719,Maxwell Crozier,D,TBL,24,0,0,0,0
15,8480192,Johnathan Kovacevic,D,MTL,27,0,0,0,0
15,8479376,Victor Mete,D,PHI,26,0,0,0,0
15,8482511,Mason Lohrei,D,BOS,23,0,0,0,0
15,8478021,William Lagesson,D,ANA,28,0,0,0,0
15,8475795,Dylan McIlrath,D,WSH,32,0,0,0,0
15,8477846,Ryan Carpenter,C,SJS,33,0,0,0,0
15,8481056,Spencer Stastney,D,NSH,24,0,0,0,0
15,8481564,Ryan Johnson,D,BUF,23,0,0,0,0
15,8478017,Mark Friedman,D,VAN,29,0,0,0,0
15,8479320,Max Lajoie,D,TOR,27,0,0,0,0
15,8480075,Cameron Crotty,D,ARI,25,0,0,0,0
15,8484287,Cole McWard,D,VAN,23,0,0,0,0
15,8484254,Akito Hirose,D,VAN,25,0,0,0,0
15,8483407,Brandon Scanlin,D,NYR,25,0,0,0,0
15,8480274,Philip Kemp,D,EDM,25,0,0,0,0
15,8479522,Hardy Haman Aktell,D,WSH,26,0,0,0,0
15,8480007,Jonas Rondbjerg,R,VGK,25,0,0,0,0
15,8477454,Adam Erne,L,EDM,29,0,0,0,0
15,8481679,Maxence Guenette,D,OTT,23,0,0,0,0
15,8477938,Haydn Fleury,D,TBL,28,0,0,0,0
15,8476441,Joel Edmundson,D,TOR,31,0,0,0,0
15,8477903,Garnet Hathaway,R,PHI,33,0,0,0,0
15,8480441,Trey Fix-Wolansky,R,CBJ,25,0,0,0,0
15,8483546,Marshall Rifai,D,TOR,26,0,0,0,0
15,8480084,Nick DeSimone,D,NJD,30,0,0,0,0
15,8481592,Jakob Pelletier,L,CGY,23,0,0,0,0
15,8478011,Louie Belpedio,D,PHI,28,0,0,0,0
15,8477930,Pierre-Edouard Bellemare,L,SEA,39,0,0,0,0
15,8484321,Nikolas Matinpalo,D,OTT,26,0,0,0,0
15,8482067,Connor Mackey,D,NYR,28,0,0,0,0
15,8481806,Louis Crevier,D,CHI,23,0,0,0,0
15,8484326,Patrik Koch,D,ARI,28,0,0,0,0
15,8477971,Andreas Englund,D,LAK,28,0,0,0,0
15,8481751,Lukas Rousek,R,BUF,25,0,0,0,0
15,8481006,Tyler Tucker,D,STL,24,0,0,0,0
15,8481641,Joel Kiviranta,L,COL,28,0,0,0,0
15,8476867,Brendan Gaunce,C,CBJ,30,0,0,0,0
15,8479520,Brandon Duhaime,R,COL,27,0,0,0,0
15,8477073,Kurtis MacDermid,L,NJD,30,0,0,0,0
15,8480874,Adam Ginning,D,PHI,24,0,0,0,0
15,8477473,Justin Bailey,R,SJS,29,0,0,0,0
15,8479066,Ryan Lomberg,L,FLA,30,0,0,0,0
15,8477070,Liam O'Brien,C,ARI,30,0,0,0,0
15,8474618,Marco Scandella,D,STL,34,0,0,0,0
15,8475797,Jarred Tinordi,D,CHI,32,0,0,0,0
15,8481441,Joe Snively,C,WSH,28,0,0,0,0
15,8477244,Chad Ruhwedel,D,NYR,34,0,0,0,0
15,8482077,Dylan Holloway,L,EDM,23,0,0,0,0
15,8479772,Zack MacEwen,R,OTT,28,0,0,0,0
15,8481147,Reese Johnson,C,CHI,26,0,0,0,0
15,8481043,Cole Koepke,L,TBL,26,0,0,0,0
15,8483619,Filip Roos,D,CHI,25,0,0,0,0
15,8481541,Samuel Bolduc,D,NYI,24,0,0,0,0
15,8477810,Joel Hanley,D,CGY,33,0,0,0,0
15,8476907,Mackenzie MacEachern,L,STL,30,0,0,0,0
15,8482652,Walker Duehr,R,CGY,27,0,0,0,0
15,8477126,Jayson Megna,C,BOS,34,0,0,0,0
15,8483398,Declan Carlile,D,TBL,31,0,0,0,0
15,8482929,Emil Lilleberg,D,TBL,23,0,0,0,0
15,8480880,Jakub Lauko,C,BOS,24,0,0,0,0
15,8478874,Adam Gaudette,C,STL,28,0,0,0,0
15,8480245,Olle Lycksell,R,PHI,25,0,0,0,0
15,8480252,Cole Guttman,C,CHI,25,0,0,0,0
15,8477467,Gustav Olofsson,D,SEA,30,0,0,0,0
15,8479968,Vinni Lettieri,C,MIN,29,0,0,0,0
15,8478400,Colin White,C,MTL,27,0,0,0,0
15,8475755,Alexander Petrovic,D,DAL,32,0,0,0,0
15,8481812,Nikolai Knyzhov,D,SJS,27,0,0,0,0
15,8481593,Jayden Struble,D,MTL,23,0,0,0,0
15,8481532,Alex Turcotte,C,LAK,23,0,0,0,0
15,8482126,Emil Andrae,D,PHI,31,0,0,0,0
15,8479944,Zach Aston-Reese,C,DET,30,0,0,0,0
15,8471817,Ryan Reaves,R,TOR,37,0,0,0,0
15,8481206,John Ludvig,D,PIT,24,0,0,0,0
15,8480292,Carson Meyer,R,CBJ,27,0,0,0,0
15,8482496,Nils Aman,C,VAN,24,0,0,0,0
15,8479718,Alex Barré-Boulet,C,TBL,27,0,0,0,0
15,8479994,Jaret Anderson-Dolan,C,NSH,25,0,0,0,0
15,8480184,Gustav Lindstrom,D,ANA,26,0,0,0,0
15,8480890,Jan Jenik,R,ARI,24,0,0,0,0
15,8478067,Oskar Lindblom,L,SJS,28,0,0,0,0
15,8476934,Brock McGinn,L,ANA,30,0,0,0,0
15,8479985,Cale Fleury,D,SEA,26,0,0,0,0
15,8482153,Brendan Brisson,C,VGK,23,0,0,0,0
15,8480021,Jack Studnicka,C,SJS,25,0,0,0,0
15,8484304,Uvis Balinskis,D,FLA,28,0,0,0,0
15,8479981,Jonah Gadjovich,L,FLA,26,0,0,0,0
15,8481716,Dmitri Voronkov,L,CBJ,24,0,0,0,0
15,8482659,Josh Doan,R,ARI,22,0,0,0,0
15,8481122,Simon Benoit,D,TOR,26,0,0,0,0
15,8474709,Matt Martin,L,NYI,35,0,0,0,0
15,8482634,Alex Steeves,C,TOR,25,0,0,0,0
15,8480823,Alexander Alexeyev,D,WSH,25,0,0,0,0
15,8477541,Dakota Mermis,D,MIN,30,0,0,0,0
15,8478477,Mitchell Stephens,C,MTL,27,0,0,0,0
15,8481543,Nikita Alexandrov,C,STL,24,0,0,0,0
15,8482451,Mikael Pyyhtia,L,CBJ,23,0,0,0,0
15,8480306,Grant Hutton,D,NYI,29,0,0,0,0
15,8478028,Fredrik Olofsson,L,COL,28,0,0,0,0
15,8477462,Robert Hagg,D,ANA,29,0,0,0,0
15,8477320,Anton Blidh,L,NYR,29,0,0,0,0
15,8482749,Joshua Roy,R,MTL,21,0,0,0,0
15,8482157,Will Cuylle,L,NYR,22,0,0,0,0
15,8481239,Samuel Fagemo,L,LAK,24,0,0,0,0
15,8481600,Tobias Bjornfot,D,FLA,23,0,0,0,0
15,8478409,Anthony Richard,C,BOS,28,0,0,0,0
15,8474145,Robert Bortuzzo,D,NYI,35,0,0,0,0
15,8475958,Michael Sgarbossa,C,WSH,32,0,0,0,0
15,8479986,Kole Lind,R,SEA,26,0,0,0,0
15,8479249,Andrew Poturalski,C,SEA,30,0,0,0,0
15,8479362,Riley Tufte,L,COL,26,0,0,0,0
15,8479991,Jake Leschyshyn,C,NYR,25,0,0,0,0
15,8479587,Rhett Gardner,C,PHI,28,0,0,0,0
15,8482744,James Malatesta,L,CBJ,21,0,0,0,0
15,8478854,Ryan Shea,D,PIT,27,0,0,0,0
15,8481591,Sam Poulin,R,PIT,23,0,0,0,0
15,8483512,Matt Savoie,C,BUF,20,0,0,0,0
15,8482102,Vasily Ponomarev,C,CAR,22,0,0,0,0
15,8482162,Roby Jarventie,L,OTT,22,0,0,0,0
15,8482172,Landon Slaggert,L,CHI,22,0,0,0,0
15,8482747,Brennan Othmann,L,NYR,21,0,0,0,0
15,8480226,Marián Studenic,R,SEA,26,0,0,0,0
15,8481518,Nolan Foote,L,NJD,24,0,0,0,0
15,8479419,Brett Murray,L,BUF,26,0,0,0,0
15,8482088,Justin Sourdif,R,FLA,22,0,0,0,0
15,8482201,Gage Goncalves,C,TBL,23,0,0,0,0
15,8481754,Nikita Nesterenko,C,ANA,23,0,0,0,0
15,8483531,Brian Halonen,L,NJD,25,0,0,0,0
15,8483920,Pierrick Dube,R,WSH,23,0,0,0,0
15,8480851,Akil Thomas,C,LAK,24,0,0,0,0
15,8475235,Nicolas Deslauriers,L,PHI,33,0,0,0,0
15,8482476,Emil Heineman,L,MTL,23,0,0,0,0
15,8477149,Scott Sabourin,R,SJS,32,0,0,0,0
15,8483549,Lucas Condotta,L,MTL,27,0,0,0,0
15,8483567,Georgii Merkulov,C,BOS,24,0,0,0,0
15,8482765,Isak Rosen,R,BUF,21,0,0,0,0
15,8481237,Kyle MacLean,C,NYI,25,0,0,0,0
15,8481024,Linus Karlsson,C,VAN,25,0,0,0,0
15,8481690,Tyler Angle,C,CBJ,24,0,0,0,0
15,8483570,Ben Meyers,C,ANA,26,0,0,0,0
15,8481655,Cole Schwindt,R,CGY,23,0,0,0,0
15,8481462,Mason Morelli,L,VGK,28,0,0,0,0
15,8483401,Marc Johnstone,R,PIT,28,0,0,0,0
15,8478956,Samuel Laberge,L,NJD,27,0,0,0,0
15,8479533,Joona Koppanen,L,PIT,26,0,0,0,0
15,8482197,Adam Raska,R,MIN,23,0,0,0,0
15,8482250,Callahan Burke,C,CAR,27,0,0,0,0
15,8482784,Zach Dean,C,STL,21,0,0,0,0
15,8484255,Jason Polin,R,COL,25,0,0,0,0
15,8481077,John Leonard,L,ARI,26,0,0,0,0
15,8481534,Raphael Lavoie,C,EDM,24,0,0,0,0
15,8483609,Adam Klapka,R,CGY,24,0,0,0,0
15,8482751,Ryan Winterton,C,SEA,21,0,0,0,0
15,8480267,Sammy Walker,C,MIN,25,0,0,0,0
15,8475766,Austin Watson,L,TBL,32,0,0,0,0
15,8482460,Matt Rempe,C,NYR,22,0,0,0,0
15,8482787,Nikita Chibrikov,R,WPG,31,0,0,0,0
15,8481065,Angus Crookshank,L,OTT,25,0,0,0,0
15,8481070,Hugh McGing,L,STL,26,0,0,0,0
15,8476323,Max McCormick,L,SEA,32,0,0,0,0
15,8483395,Arshdeep Bains,L,VAN,23,0,0,0,0
15,8484259,Ondrej Pavel,C,COL,31,0,0,0,0
15,8483432,Luca Del Bel Belluz,C,CBJ,31,0,0,0,0
15,8483045,Cameron Butler,R,CBJ,31,0,0,0,0
15,8482061,Brandon Biro,L,BUF,26,0,0,0,0
15,8477401,John Hayden,C,SEA,29,0,0,0,0
15,8475278,Byron Froese,C,VGK,33,0,0,0,0
15,8478446,Glenn Gawdin,C,ANA,27,0,0,0,0
15,8477993,Justin Kirkland,C,ARI,28,0,0,0,0
15,8482147,Jean-Luc Foudy,C,COL,22,0,0,0,0
15,8480032,Shane Bowers,C,NJD,25,0,0,0,0
15,8479330,Brandon Gignac,C,MTL,27,0,0,0,0
15,8480776,Sheldon Rempal,R,VGK,29,0,0,0,0
15,8475413,Justin Dowling,C,NJD,34,0,0,0,0
15,8481726,Adam Edstrom,C,NYR,24,0,0,0,0
15,8479638,Justin Brazeau,R,BOS,26,0,0,0,0
15,8480844,Grigori Denisenko,L,VGK,24,0,0,0,0
15,8474062,Riley Nash,C,NYR,35,0,0,0,0
15,8478147,Bokondji Imama,L,OTT,28,0,0,0,0
15,8478881,Brett Seney,L,CHI,28,0,0,0,0
15,8483630,Pavol Regenda,L,ANA,25,0,0,0,0
15,8480836,Jonathan Gruden,C,PIT,24,0,0,0,0
15,8484314,Jiri Smejkal,L,OTT,28,0,0,0,0
15,8475780,Chris Wagner,R,COL,33,0,0,0,0
15,8482070,Mitchell Chaffee,R,TBL,26,0,0,0,0
15,8479546,Oskar Steen,C,BOS,26,0,0,0,0
15,8483597,Milos Kelemen,L,ARI,25,0,0,0,0
15,8481789,Tye Kartye,L,SEA,23,0,0,0,0
15,8484325,Waltteri Merela,C,TBL,26,0,0,0,0
15,8479421,Jacob Moverare,D,LAK,26,0,0,0,0
15,8481585,Egor Afanasyev,L,NSH,23,0,0,0,0
15,8479547,Matthew Phillips,R,WSH,26,0,0,0,0
15,8479367,William Lockwood,R,FLA,26,0,0,0,0
15,8481422,Jacob Lucchini,C,MIN,29,0,0,0,0
15,8480468,James Hamblin,L,EDM,25,0,0,0,0
15,8480870,Bo Groulx,C,ANA,24,0,0,0,0
15,8478051,Max Willman,C,NJD,29,0,0,0,0
15,8481556,John Beecher,C,BOS,23,0,0,0,0
15,8478078,Rourke Chartier,C,OTT,28,0,0,0,0
16,8476453,Nikita Kucherov,R,TBL,31,82,38,104,142
16,8478402,Connor McDavid,C,EDM,27,82,36,95,131
16,8477492,Nathan MacKinnon,C,COL,29,82,42,84,126
16,8476887,Filip Forsberg,L,NSH,30,82,61,57,118
16,8478550,Artemi Panarin,L,NYR,33,82,46,70,116
16,8479318,Auston Matthews,C,TOR,27,82,56,57,113
16,8471675,Sidney Crosby,C,PIT,37,82,47,66,113
16,8481559,Jack Hughes,C,NJD,23,82,51,59,110
16,8479407,Jesper Bratt,L,NJD,26,82,37,72,109
16,8478864,Kirill Kaprizov,L,MIN,27,82,62,44,106
16,8478420,Mikko Rantanen,R,COL,28,82,42,64,106
16,8476468,J.T. Miller,C,VAN,31,82,34,72,106
16,8477934,Leon Draisaitl,C,EDM,29,82,51,52,103
16,8480027,Jason Robertson,L,DAL,25,82,27,73,100
16,8480023,Robert Thomas,C,STL,25,82,28,71,99
16,8477956,David Pastrnak,R,BOS,28,82,48,49,97
16,8478427,Sebastian Aho,C,CAR,27,82,44,52,96
16,8479314,Matthew Tkachuk,L,FLA,27,82,36,60,96
16,8477946,Dylan Larkin,C,DET,28,82,35,60,95
16,8477942,Kevin Fiala,L,LAK,28,82,32,63,95
16,8479343,Clayton Keller,R,ARI,26,82,44,48,92
16,8477939,William Nylander,R,TOR,28,82,39,53,92
16,8477955,Jared McCann,L,SEA,28,82,34,57,91
16,8480801,Brady Tkachuk,L,OTT,25,82,44,46,90
16,8481523,Kirby Dach,C,MTL,23,82,21,67,88
16,8478398,Kyle Connor,L,WPG,28,82,47,40,87
16,8478449,Roope Hintz,C,DAL,28,82,41,46,87
16,8477404,Jake Guentzel,C,CAR,30,82,38,49,87
16,8477933,Sam Reinhart,C,FLA,29,82,37,50,87
16,8480002,Nico Hischier,C,NJD,25,82,34,53,87
16,8478010,Brayden Point,C,TBL,28,82,48,38,86
16,8482078,Lucas Raymond,L,DET,22,82,37,49,86
16,8477960,Adrian Kempe,R,LAK,28,82,35,50,85
16,8480012,Elias Pettersson,C,VAN,26,82,34,51,85
16,8479385,Jordan Kyrou,C,STL,26,82,29,56,85
16,8480865,Noah Dobson,D,NYI,24,82,17,68,85
16,8474564,Steven Stamkos,C,TBL,34,82,42,42,84
16,8478403,Jack Eichel,C,VGK,28,82,36,47,83
16,8476539,Jonathan Marchessault,R,VGK,34,82,53,29,82
16,8476389,Vincent Trocheck,C,NYR,31,82,35,47,82
16,8477493,Aleksander Barkov,C,FLA,29,82,18,64,82
16,8478439,Travis Konecny,R,PHI,27,82,30,51,81
16,8482116,Tim Stützle,C,OTT,22,82,30,51,81
16,8479337,Alex DeBrincat,R,DET,27,82,29,51,80
16,8477409,Carter Verhaeghe,C,FLA,29,82,40,39,79
16,8481557,Matt Boldy,L,MIN,23,82,31,48,79
16,8476460,Mark Scheifele,C,WPG,31,82,26,53,79
16,8475754,Brock Nelson,C,NYI,33,82,43,35,78
16,8478414,Timo Meier,R,NJD,28,82,36,42,78
16,8481540,Cole Caufield,R,MTL,23,82,31,47,78
16,8480069,Cale Makar,D,COL,26,82,25,53,78
16,8473512,Claude Giroux,R,OTT,36,82,25,53,78
16,8480036,Miro Heiskanen,D,DAL,25,82,15,63,78
16,8478445,Mathew Barzal,C,NYI,27,82,14,64,78
16,8477402,Pavel Buchnevich,L,STL,29,82,40,37,77
16,8475726,Tyler Toffoli,C,WPG,32,82,38,39,77
16,8482665,Matty Beniers,C,SEA,22,82,33,44,77
16,8479323,Adam Fox,D,NYR,26,82,13,64,77
16,8474600,Roman Josi,D,NSH,34,82,21,55,76
16,8475798,Mikael Granlund,C,SJS,32,82,17,59,76
16,8473994,Jamie Benn,L,DAL,35,82,35,40,75
16,8475692,Mats Zuccarello,R,MIN,37,82,17,58,75
16,8475170,Brayden Schenn,C,STL,33,82,30,44,74
16,8471215,Evgeni Malkin,C,PIT,38,82,25,49,74
16,8478440,Dylan Strome,C,WSH,27,82,25,49,74
16,8480839,Rasmus Dahlin,D,BUF,24,82,16,58,74
16,8471214,Alex Ovechkin,L,WSH,39,82,39,34,73
16,8473419,Brad Marchand,L,BOS,36,82,33,40,73
16,8476459,Mika Zibanejad,C,NYR,31,82,29,44,73
16,8477940,Nikolaj Ehlers,L,WPG,28,82,23,50,73
16,8476346,Johnny Gaudreau,L,CBJ,31,82,13,60,73
16,8478873,Troy Terry,R,ANA,27,82,28,44,72
16,8474141,Patrick Kane,R,DET,36,82,24,48,72
16,8476456,Jonathan Huberdeau,C,CGY,31,82,24,48,72
16,8480800,Quinn Hughes,D,VAN,25,82,11,61,72
16,8475166,John Tavares,C,TOR,34,82,37,34,71
16,8479420,Tage Thompson,C,BUF,27,82,36,35,71
16,8480830,Andrei Svechnikov,R,CAR,24,82,29,42,71
16,8480208,Drake Batherson,R,OTT,26,82,28,43,71
16,8478397,Rasmus Andersson,D,CGY,28,82,16,55,71
16,8471724,Kris Letang,D,PIT,37,82,13,58,71
16,8475794,Tyler Seguin,C,DAL,32,82,33,37,70
16,8480018,Nick Suzuki,C,MTL,25,82,24,46,70
16,8474590,John Carlson,D,WSH,34,82,13,57,70
16,8475168,Matt Duchene,C,DAL,33,82,38,31,69
16,8475810,Bryan Rust,R,PIT,32,82,30,39,69
16,8478047,Michael Bunting,L,PIT,29,82,29,40,69
16,8477447,Shea Theodore,D,VGK,29,82,13,56,69
16,8482740,Wyatt Johnston,C,DAL,21,82,38,30,68
16,8477951,Nick Schmaltz,C,ARI,28,82,31,37,68
16,8476399,Blake Coleman,C,CGY,33,82,30,38,68
16,8475913,Mark Stone,R,VGK,32,82,21,47,68
16,8475172,Nazem Kadri,C,CGY,34,82,18,50,68
16,8475184,Chris Kreider,L,NYR,33,82,39,28,67
16,8477501,Valeri Nichushkin,R,COL,29,82,38,29,67
16,8476881,Tomas Hertl,C,VGK,31,82,23,44,67
16,8476454,Ryan Nugent-Hopkins,C,EDM,31,82,20,47,67
16,8477949,Alex Tuch,R,BUF,28,82,24,42,66
16,8479425,Filip Hronek,D,VAN,27,82,15,51,66
16,8478493,Joel Eriksson Ek,C,MIN,27,82,30,35,65
16,8478042,Viktor Arvidsson,R,LAK,31,82,29,36,65
16,8475158,Ryan O'Reilly,C,NSH,33,82,23,42,65
16,8471685,Anze Kopitar,C,LAK,37,82,19,46,65
16,8479325,Charlie McAvoy,D,BOS,27,82,16,49,65
16,8477504,Josh Morrissey,D,WPG,29,82,7,58,65
16,8474102,David Perron,L,DET,36,82,36,28,64
16,8474586,Jordan Eberle,R,SEA,34,82,34,30,64
16,8480064,Josh Norris,C,OTT,25,82,31,33,64
16,8477497,Sean Monahan,C,WPG,30,82,31,33,64
16,8475151,Kyle Palmieri,C,NYI,33,82,29,35,64
16,8482097,Jack Quinn,R,BUF,23,82,28,36,64
16,8470794,Joe Pavelski,C,DAL,40,82,27,37,64
16,8478038,Devon Toews,D,COL,30,82,16,48,64
16,8478407,Vince Dunn,D,SEA,28,82,14,50,64
16,8476483,Rickard Rakell,R,PIT,31,82,28,35,63
16,8477451,Ryan Hartman,R,MIN,30,82,23,40,63
16,8474150,Mikael Backlund,C,CGY,35,82,19,44,63
16,8475167,Victor Hedman,D,TBL,34,82,18,45,63
16,8476905,Chandler Stephenson,C,VGK,30,82,17,46,63
16,8480803,Evan Bouchard,D,EDM,25,82,16,47,63
16,8477496,Elias Lindholm,C,VAN,30,82,27,35,62
16,8480188,Fabian Zetterlund,L,SJS,25,82,25,37,62
16,8474563,Drew Doughty,D,LAK,35,82,15,47,62
16,8477500,Bo Horvat,C,NYI,29,82,32,29,61
16,8477416,Oliver Bjorkstrand,R,SEA,29,82,31,30,61
16,8475765,Vladimir Tarasenko,R,FLA,33,82,30,31,61
16,8478438,Tommy Novak,C,NSH,27,82,18,43,61
16,8475786,Zach Hyman,L,EDM,32,82,36,24,60
16,8478444,Brock Boeser,R,VAN,27,82,33,27,60
16,8480028,Morgan Frost,C,PHI,25,82,21,39,60
16,8476462,Dougie Hamilton,D,NJD,31,82,18,42,60
16,8478519,Anthony Cirelli,C,TBL,27,82,24,35,59
16,8481533,Trevor Zegras,C,ANA,23,82,18,41,59
16,8474578,Erik Karlsson,D,PIT,34,82,15,44,59
16,8477932,Aaron Ekblad,D,FLA,28,82,14,45,59
16,8476448,William Karlsson,C,VGK,31,82,30,28,58
16,8476853,Morgan Rielly,D,TOR,30,82,13,45,58
16,8481528,Dylan Cozens,C,BUF,23,82,26,31,57
16,8480015,Owen Tippett,R,PHI,25,82,25,32,57
16,8476882,Teuvo Teravainen,L,CAR,30,82,21,36,57
16,8478975,Mason Marchment,L,DAL,29,82,20,37,57
16,8477503,Max Domi,C,TOR,29,82,12,45,57
16,8480039,Martin Necas,C,CAR,25,82,31,25,56
16,8475722,Jason Zucker,L,NSH,32,82,31,25,56
16,8475784,Jeff Skinner,C,BUF,32,82,23,33,56
16,8480078,Filip Chytil,C,NYR,25,82,19,37,56
16,8478401,Pavel Zacha,C,BOS,27,82,17,39,56
16,8477986,Brandon Montour,D,FLA,30,82,16,40,56
16,8475799,Nino Niederreiter,R,WPG,32,82,31,24,55
16,8478366,Frank Vatrano,R,ANA,30,82,29,26,55
16,8481068,Yegor Sharangovich,C,CGY,26,82,29,26,55
16,8482159,Tyson Foerster,R,PHI,22,82,28,27,55
16,8477479,Tyler Bertuzzi,L,TOR,29,82,25,30,55
16,8479339,Patrik Laine,L,CBJ,26,82,23,32,55
16,8476872,Scott Laughton,C,PHI,30,82,18,37,55
16,8478460,Zach Werenski,D,CBJ,27,82,14,41,55
16,8478396,Noah Hanifin,D,VGK,27,82,14,41,55
16,8474565,Alex Pietrangelo,D,VGK,34,82,13,42,55
16,8479410,Mikhail Sergachev,D,TBL,26,82,11,44,55
16,8477476,Artturi Lehkonen,L,COL,29,82,28,26,54
16,8478498,Jake DeBrusk,L,BOS,28,82,28,26,54
16,8482124,Quinton Byfield,R,LAK,22,82,25,29,54
16,8482745,Mason McTavish,C,ANA,21,82,24,30,54
16,8478469,Thomas Chabot,D,OTT,27,82,19,35,54
16,8476875,Mike Matheson,D,MTL,30,82,12,42,54
16,8476792,Torey Krug,D,STL,33,82,12,42,54
16,8481618,Alex Newhook,C,MTL,23,82,27,26,53
16,8478856,Conor Garland,R,VAN,28,82,22,31,53
16,8482093,Seth Jarvis,C,CAR,22,82,27,25,52
16,8475745,Charlie Coyle,C,BOS,32,82,22,30,52
16,8477407,Anthony Duclair,L,TBL,29,82,22,30,52
16,8479987,Morgan Geekie,C,BOS,26,82,19,33,52
16,8478233,Andrew Mangiapane,L,CGY,28,82,19,33,52
16,8480797,Joel Farabee,L,PHI,24,82,15,37,52
16,8476479,Phillip Danault,C,LAK,31,82,15,37,52
16,8476869,Brady Skjei,D,CAR,30,82,14,38,52
16,8481711,Matias Maccelli,L,ARI,24,82,12,40,52
16,8477426,Nicholas Paul,L,TBL,29,82,29,22,51
16,8476880,Tom Wilson,R,WSH,30,82,26,25,51
16,8482055,Drew O'Connor,L,PIT,26,82,25,26,51
16,8477935,Sam Bennett,C,FLA,28,82,21,30,51
16,8475191,Reilly Smith,R,PIT,33,82,19,32,51
16,8476906,Shayne Gostisbehere,D,DET,31,82,16,35,51
16,8471698,T.J. Oshie,R,WSH,38,82,23,27,50
16,8482109,Alexis Lafrenière,L,NYR,23,82,20,30,50
16,8481596,Shane Pinto,C,OTT,24,82,19,31,50
16,8479542,Brandon Hagel,L,TBL,26,82,18,32,50
16,8482113,Anton Lundell,C,FLA,23,82,18,32,50
16,8481581,Thomas Harley,D,DAL,23,82,14,36,50
16,8477021,Alex Kerfoot,C,ARI,30,82,10,40,50
16,8479675,Trevor Moore,L,LAK,29,82,26,23,49
16,8477964,Ivan Barbashev,C,VGK,29,82,25,24,49
16,8473986,Alex Killorn,L,ANA,35,82,16,33,49
16,8479999,Casey Mittelstadt,C,COL,26,82,13,36,49
16,8478474,Lawson Crouse,L,ARI,27,82,25,23,48
16,8482667,William Eklund,L,SJS,22,82,19,29,48
16,8475149,Marcus Johansson,L,MIN,34,82,19,29,48
16,8478463,Anthony Beauvillier,L,NSH,27,82,18,30,48
16,8479400,Pierre-Luc Dubois,L,LAK,26,82,21,26,47
16,8475768,Jaden Schwartz,C,SEA,32,82,21,26,47
16,8474679,Gustav Nyquist,C,NSH,35,82,18,29,47
16,8477495,Seth Jones,D,CHI,30,82,11,36,47
16,8476958,Jaccob Slavin,D,CAR,30,82,8,39,47
16,8480014,Gabriel Vilardi,C,WPG,25,82,27,19,46
16,8475848,Brendan Gallagher,R,MTL,32,82,21,25,46
16,8477947,Sonny Milano,L,WSH,28,82,21,25,46
16,8480849,Barrett Hayton,C,ARI,24,82,21,25,46
16,8471218,Blake Wheeler,R,NYR,38,82,20,26,46
16,8475287,Erik Haula,L,NJD,33,82,19,27,46
16,8482475,Yegor Chinakhov,R,CBJ,23,82,18,28,46
16,8480434,Sean Durzi,D,ARI,26,82,8,38,46
16,8477429,Andrew Copp,C,DET,30,82,23,22,45
16,8478046,Danton Heinen,L,BOS,29,82,22,23,45
16,8476925,Colton Sissons,C,NSH,31,82,16,29,45
16,8478466,Daniel Sprong,R,DET,27,82,15,30,45
16,8476826,Yanni Gourde,C,SEA,33,82,14,31,45
16,8478472,Mathieu Joseph,R,OTT,27,82,12,33,45
16,8475197,Tyson Barrie,D,NSH,33,82,8,37,45
16,8480145,Neal Pionk,D,WPG,29,82,7,38,45
16,8481542,Moritz Seider,D,DET,23,82,5,40,45
16,8476432,Boone Jenner,C,CBJ,31,82,31,13,44
16,8482089,Jake Neighbours,L,STL,22,82,29,15,44
16,8479525,Ross Colton,C,COL,28,82,24,20,44
16,8480798,Philipp Kurashev,C,CHI,25,82,21,23,44
16,8475793,Ryan Johansen,C,PHI,32,82,19,25,44
16,8477444,Andre Burakovsky,L,SEA,29,82,19,25,44
16,8477494,Jonathan Drouin,L,COL,29,82,12,32,44
16,8482684,Luke Hughes,D,NJD,21,82,10,34,44
16,8474716,Jared Spurgeon,D,MIN,35,82,10,34,44
16,8478462,Nicolas Roy,C,VGK,27,82,8,36,44
16,8476329,Travis Boyd,C,ARI,31,82,8,36,44
16,8481656,Aliaksei Protas,C,WSH,23,82,18,25,43
16,8474037,James van Riemsdyk,L,BOS,35,82,16,27,43
16,8480009,Eeli Tolvanen,R,SEA,25,82,15,28,43
16,8476419,Jean-Gabriel Pageau,C,NYI,32,82,15,28,43
16,8470613,Brent Burns,D,CAR,39,82,12,31,43
16,8475744,Evgeny Kuznetsov,C,CAR,32,82,11,32,43
16,8475169,Evander Kane,L,EDM,33,82,24,18,42
16,8481186,Logan O'Connor,R,COL,28,82,20,22,42
16,8478458,Jack Roslovic,C,NYR,27,82,16,26,42
16,8475753,Justin Faulk,D,STL,32,82,16,26,42
16,8483808,Andrei Kuzmenko,L,CGY,28,82,15,27,42
16,8482671,Owen Power,D,BUF,22,82,15,27,42
16,8475763,Kevin Hayes,R,STL,32,82,15,27,42
16,8482133,Thomas Bordeleau,C,SJS,22,82,15,27,42
16,8476392,Adam Lowry,C,WPG,31,82,12,30,42
16,8480336,Sean Walker,D,COL,30,82,10,32,42
16,8476461,Sean Couturier,C,PHI,32,82,9,33,42
16,8476854,Hampus Lindholm,D,BOS,30,82,8,34,42
16,8478542,Evan Rodrigues,C,FLA,31,82,24,17,41
16,8475314,Anders Lee,L,NYI,34,82,22,19,41
16,8474149,Evgenii Dadonov,R,DAL,35,82,20,21,41
16,8484144,Connor Bedard,C,CHI,19,82,18,23,41
16,8476292,Ondrej Palat,L,NJD,33,82,18,23,41
16,8479390,Taylor Raddysh,R,CHI,26,82,17,24,41
16,8482105,Jake Sanderson,D,OTT,22,82,13,28,41
16,8479345,Jakob Chychrun,D,OTT,26,82,12,29,41
16,8477346,MacKenzie Weegar,D,CGY,30,82,11,30,41
16,8476931,Jake McCabe,D,TOR,31,82,7,34,41
16,8474189,Lars Eller,C,PIT,35,82,24,16,40
16,8475714,Calle Jarnkrok,C,TOR,33,82,23,17,40
16,8479365,Trent Frederic,C,BOS,26,82,23,17,40
16,8480459,Pius Suter,C,VAN,28,82,21,19,40
16,8482146,Luke Evangelista,R,NSH,22,82,19,21,40
16,8478057,Dakota Joshua,C,VAN,28,82,19,21,40
16,8476480,Vladislav Namestnikov,C,WPG,32,82,19,21,40
16,8482222,Alexander Barabanov,L,SJS,30,82,17,23,40
16,8481704,Juuso Parssinen,C,NSH,23,82,14,26,40
16,8477953,Kasperi Kapanen,R,STL,28,82,13,27,40
16,8481554,Kaapo Kakko,R,NYR,23,82,24,15,39
16,8475760,Nick Bjugstad,C,ARI,32,82,23,16,39
16,8482699,Dylan Guenther,R,ARI,21,82,22,17,39
16,8474870,Tyler Johnson,C,CHI,34,82,22,17,39
16,8476438,Brandon Saad,L,STL,32,82,21,18,39
16,8482705,Cole Sillinger,C,CBJ,21,82,20,19,39
16,8482110,Dawson Mercer,C,NJD,23,82,20,19,39
16,8470610,Zach Parise,L,COL,40,82,18,21,39
16,8476458,Ryan Strome,C,ANA,31,82,17,22,39
16,8474884,Mike Hoffman,C,SJS,35,82,16,23,39
16,8474157,Max Pacioretty,L,WSH,36,82,15,24,39
16,8477456,J.T. Compher,L,DET,29,82,14,25,39
16,8481546,Cam York,D,PHI,23,82,14,25,39
16,8476885,Jacob Trouba,D,NYR,30,82,12,27,39
16,8475906,John Klingberg,D,TOR,32,82,9,30,39
16,8475764,Cam Fowler,D,ANA,33,82,7,32,39
16,8478055,Gustav Forsling,D,FLA,28,82,6,33,39
16,8481580,Connor McMichael,C,WSH,23,82,18,20,38
16,8480185,Eetu Luostarinen,C,FLA,26,82,18,20,38
16,8476923,Damon Severson,D,CBJ,30,82,16,22,38
16,8479415,Michael McLeod,C,NJD,26,82,14,24,38
16,8475791,Taylor Hall,L,CHI,33,82,13,25,38
16,8480220,Noah Cates,L,PHI,25,82,13,25,38
16,8478115,Pierre Engvall,L,NYI,28,82,12,26,38
16,8480817,K'Andre Miller,D,NYR,24,82,8,30,38
16,8474715,Cam Atkinson,R,PHI,35,82,19,18,37
16,8482092,Ridly Greig,C,OTT,22,82,18,19,37
16,8476871,Tanner Pearson,L,MTL,32,82,16,21,37
16,8476927,Teddy Blueger,C,VAN,30,82,13,24,37
16,8480871,Adam Boqvist,D,CBJ,24,82,12,25,37
16,8478133,Jake Evans,C,MTL,28,82,11,26,37
16,8480073,Erik Brannstrom,D,OTT,25,82,3,34,37
16,8476873,Mark Jankowski,C,NSH,30,82,20,16,36
16,8479992,Michael Rasmussen,C,DET,25,82,18,18,36
16,8479977,Kailer Yamamoto,R,SEA,26,82,17,19,36
16,8473449,Kyle Okposo,R,FLA,36,82,17,19,36
16,8478043,Sam Lafferty,C,VAN,29,82,17,19,36
16,8477425,Miles Wood,L,COL,29,82,16,20,36
16,8477948,Travis Sanheim,D,PHI,28,82,11,25,36
16,8477488,Brett Pesce,D,CAR,30,82,6,30,36
16,8480068,Ryan Poehling,C,PHI,25,82,22,13,35
16,8480821,Filip Zadina,R,SJS,25,82,22,13,35
16,8476981,Josh Anderson,R,MTL,30,82,21,14,35
16,8480113,Alex Iafallo,L,WPG,31,82,17,18,35
16,8483515,Juraj Slafkovsky,L,MTL,20,82,17,18,35
16,8481624,Ilya Mikheyev,R,VAN,30,82,17,18,35
16,8479293,Brandon Tanev,L,SEA,33,82,16,19,35
16,8482117,Lukas Reichel,L,CHI,22,82,15,20,35
16,8473563,Nicklas Backstrom,C,WSH,37,82,14,21,35
16,8479514,Rem Pitlick,C,CHI,27,82,14,21,35
16,8479996,Cody Glass,C,NSH,25,82,14,21,35
16,8476921,Jordan Martinook,L,CAR,32,82,13,22,35
16,8475343,Nic Dowd,C,WSH,34,82,11,24,35
16,8473507,Jeff Petry,D,DET,37,82,8,27,35
16,8481606,Jordan Spence,D,LAK,23,82,8,27,35
16,8476463,Jonas Brodin,D,MIN,31,82,8,27,35
16,8482074,Connor Zary,C,CGY,23,82,19,15,34
16,8474641,Adam Henrique,C,EDM,34,82,15,19,34
16,8481560,Arthur Kaliyev,R,LAK,23,82,15,19,34
16,8480855,Jack McBain,C,ARI,24,82,14,20,34
16,8478891,Mason Appleton,C,WPG,28,82,14,20,34
16,8476902,Esa Lindell,D,DAL,30,82,7,27,34
16,8479976,Juuso Valimaki,D,ARI,26,82,7,27,34
16,8479941,Justin Danforth,R,CBJ,31,82,18,15,33
16,8478020,Michael Amadio,C,VGK,28,82,17,16,33
16,8475164,Jakob Silfverberg,R,ANA,34,82,17,16,33
16,8482125,Alexander Holtz,R,NJD,22,82,16,17,33
16,8475220,Marcus Foligno,L,MIN,33,82,14,19,33
16,8482175,JJ Peterka,R,BUF,22,82,10,23,33
16,8476897,Oskar Sundqvist,C,STL,30,82,10,23,33
16,8481522,Peyton Krebs,C,BUF,23,82,10,23,33
16,8477507,Nikita Zadorov,D,VAN,29,82,10,23,33
16,8478013,Jake Walman,D,DET,28,82,10,23,33
16,8476467,Jamie Oleksiak,D,SEA,32,82,8,25,33
16,8479316,Luke Kunin,C,SJS,27,82,20,12,32
16,8479393,Noah Gregor,C,TOR,26,82,19,13,32
16,8476469,Joel Armia,R,MTL,31,82,17,15,32
16,8482166,Shakir Mukhamadullin,D,SJS,22,82,15,17,32
16,8482259,Bobby McMann,C,TOR,28,82,14,18,32
16,8477511,Anthony Mantha,R,VGK,30,82,13,19,32
16,8482720,Matthew Knies,L,TOR,22,82,11,21,32
16,8473533,Jordan Staal,C,CAR,36,82,10,22,32
16,8482111,Justin Barron,D,MTL,23,82,10,22,32
16,8478840,Will Borgen,D,SEA,28,82,7,25,32
16,8481093,Rafael Harvey-Pinard,L,MTL,25,82,19,12,31
16,8483431,Logan Cooley,C,ARI,20,82,18,13,31
16,8481477,Nico Sturm,C,SJS,29,82,16,15,31
16,8482079,Marco Rossi,C,MIN,23,82,15,16,31
16,8479591,Michael Eyssimont,C,TBL,28,82,14,17,31
16,8480802,Ryan McLeod,C,EDM,25,82,14,17,31
16,8478413,Jordan Greenway,L,BUF,27,82,13,18,31
16,8481553,Bobby Brink,R,PHI,23,82,13,18,31
16,8477498,Darnell Nurse,D,EDM,29,82,10,21,31
16,8477015,Connor Brown,R,EDM,30,82,9,22,31
16,8479353,Brett Howden,C,VGK,26,82,9,22,31
16,8481014,Alexander Romanov,D,NYI,24,82,8,23,31
16,8478416,Erik Cernak,D,TBL,27,82,7,24,31
16,8477839,Conor Sheary,L,TBL,32,82,6,25,31
16,8477969,Marcus Pettersson,D,PIT,28,82,5,26,31
16,8480043,Timothy Liljegren,D,TOR,25,82,4,27,31
16,8478500,Ivan Provorov,D,CBJ,27,82,4,27,31
16,8476891,Matt Grzelcyk,D,BOS,30,82,4,27,31
16,8477998,Warren Foegele,L,EDM,28,82,17,13,30
16,8475218,Mattias Ekholm,D,EDM,34,82,13,17,30
16,8482702,Logan Stankoven,C,DAL,21,82,13,17,30
16,8476960,Andreas Athanasiou,C,CHI,30,82,11,19,30
16,8474053,Logan Couture,C,SJS,35,82,9,21,30
16,8479351,Sam Steel,C,DAL,26,82,8,22,30
16,8476979,Erik Gustafsson,D,NYR,32,82,6,24,30
16,8478507,John Marino,D,NJD,27,82,6,24,30
16,8474151,Ryan McDonagh,D,NSH,35,82,4,26,30
16,8482655,J.J. Moser,D,ARI,24,82,1,29,30
16,8481604,Pavel Dorofeyev,L,VGK,24,82,18,11,29
16,8481535,Nils Hoglander,L,VAN,24,82,16,13,29
16,8478508,Yakov Trenin,C,COL,27,82,16,13,29
16,8481517,Brett Leason,R,ANA,25,82,15,14,29
16,8477508,Curtis Lazar,C,NJD,29,82,14,15,29
16,8481481,Blake Lizotte,C,LAK,27,82,13,16,29
16,8477919,Frederick Gaudreau,C,MIN,31,82,12,17,29
16,8480074,Alexandre Texier,C,CBJ,25,82,12,17,29
16,8477989,Christian Dvorak,C,MTL,28,82,11,18,29
16,8483012,Logan Morrison,C,SEA,22,82,11,18,29
16,8480058,Pierre-Olivier Joseph,D,PIT,25,82,9,20,29
16,8475171,Oliver Ekman-Larsson,D,FLA,33,82,6,23,29
16,8479398,Samuel Girard,D,COL,26,82,5,24,29
16,8476331,Dylan DeMelo,D,WPG,31,82,5,24,29
16,8484911,Collin Graf,R,SJS,22,82,13,15,28
16,8477952,Robby Fabbri,C,DET,28,82,12,16,28
16,8474034,Pat Maroon,L,BOS,36,82,11,17,28
16,8477499,Rasmus Ristolainen,D,PHI,30,82,11,17,28
16,8480873,Rasmus Sandin,D,WSH,24,82,4,24,28
16,8474673,TJ Brodie,D,TOR,34,82,4,24,28
16,8470966,Mark Giordano,D,TOR,41,82,4,24,28
16,8482122,Brock Faber,D,MIN,22,82,4,24,28
16,8474013,Ian Cole,D,VAN,35,82,2,26,28
16,8480995,Pontus Holmberg,R,TOR,25,82,16,11,27
16,8481601,Simon Holmstrom,R,NYI,23,82,16,11,27
16,8479383,Boris Katchouk,L,OTT,26,82,15,12,27
16,8479346,Dillon Dube,C,CGY,26,82,14,13,27
16,8477392,Hudson Fasching,R,NYI,29,82,12,15,27
16,8482807,Ethan Del Mastro,D,CHI,21,82,12,15,27
16,8477450,Jason Dickinson,C,CHI,29,82,10,17,27
16,8478911,Matt Roy,D,LAK,29,82,9,18,27
16,8482245,Artem Zub,D,OTT,29,82,9,18,27
16,8482142,Jamie Drysdale,D,PHI,22,82,8,19,27
16,8477435,Ryan Graves,D,PIT,29,82,7,20,27
16,8480144,David Kampf,C,TOR,29,82,6,21,27
16,8480246,Nick Perbix,D,TBL,26,82,5,22,27
16,8476892,Colton Parayko,D,STL,31,82,4,23,27
16,8474166,Alec Martinez,D,VGK,37,82,4,23,27
16,8476917,Adam Pelech,D,NYI,30,82,3,24,27
16,8478399,Jonas Siegenthaler,D,NJD,27,82,2,25,27
16,8477944,Jakub Vrana,L,STL,28,82,14,12,26
16,8477330,Dominik Kubalik,L,OTT,29,82,14,12,26
16,8477505,Alexander Wennberg,C,NYR,30,82,13,13,26
16,8483457,Lane Hutson,D,MTL,20,82,10,16,26
16,8477335,Kyle Burroughs,D,SJS,29,82,6,20,26
16,8482145,Mavrik Bourque,C,DAL,22,82,6,20,26
16,8478430,Oliver Kylington,D,CGY,27,82,5,21,26
16,8476525,Colin Miller,D,WPG,32,82,4,22,26
16,8481059,Scott Perunovich,D,STL,26,82,2,24,26
16,8483524,Shane Wright,C,SEA,20,82,12,13,25
16,8480813,Joe Veleno,C,DET,24,82,11,14,25
16,8473422,Nick Foligno,L,CHI,37,82,10,15,25
16,8479983,Mario Ferraro,D,SJS,26,82,7,18,25
16,8478851,Alexandre Carrier,D,NSH,28,82,7,18,25
16,8481703,Valtteri Puustinen,R,PIT,25,82,5,20,25
16,8475279,Ben Chiarot,D,DET,33,82,5,20,25
16,8483565,Nick Blankenburg,D,CBJ,26,82,4,21,25
16,8480834,Ty Emberson,D,SJS,24,82,1,24,25
16,8484166,Adam Fantilli,C,CBJ,20,82,10,14,24
16,8473504,Cal Clutterbuck,R,NYI,37,82,10,14,24
16,8481013,Jonatan Berggren,R,DET,24,82,9,15,24
16,8483763,Maksymilian Szuber,D,ARI,22,82,9,15,24
16,8475200,Dmitry Orlov,D,CAR,33,82,6,18,24
16,8479371,Dante Fabbro,D,NSH,26,82,5,19,24
16,8484153,Leo Carlsson,C,ANA,20,82,5,19,24
16,8478882,Vladislav Gavrikov,D,LAK,29,82,5,19,24
16,8476422,Mike Reilly,D,NYI,31,82,4,20,24
16,8482073,Braden Schneider,D,NYR,23,82,4,20,24
16,8478443,Brandon Carlo,D,BOS,28,82,4,20,24
16,8479369,Andrew Peeke,D,BOS,26,82,2,22,24
16,8480807,Mattias Samuelsson,D,BUF,24,82,2,22,24
16,8479998,Mikey Anderson,D,LAK,25,82,2,22,24
16,8480893,Kirill Marchenko,R,CBJ,24,82,16,7,23
16,8479423,Alex Nylander,L,CBJ,26,82,15,8,23
16,8475231,Casey Cizikas,C,NYI,33,82,14,9,23
16,8474009,Nick Bonino,C,NYR,36,82,14,9,23
16,8479291,Kevin Rooney,C,CGY,31,82,11,12,23
16,8484203,Bradly Nadeau,L,CAR,19,82,9,14,23
16,8476624,Barclay Goodrow,C,NYR,31,82,8,15,23
16,8480796,Martin Fehervary,D,WSH,25,82,6,17,23
16,8481568,Alex Vlasic,D,CHI,23,82,3,20,23
16,8476457,Adam Larsson,D,SEA,32,82,3,20,23
16,8475455,Brenden Dillon,D,WPG,34,82,3,20,23
16,8475825,Jani Hakanpää,D,DAL,32,82,2,21,23
16,8481178,Egor Zamula,D,PHI,24,82,1,22,23
16,8476278,Colin Blackwell,C,CHI,31,82,12,10,22
16,8481028,Martin Pospisil,C,CGY,25,82,12,10,22
16,8470621,Corey Perry,R,EDM,39,82,11,11,22
16,8476442,Matt Nieto,L,PIT,32,82,10,12,22
16,8481016,Ruslan Iskhakov,C,NYI,24,82,10,12,22
16,8483505,Matthew Poitras,C,BOS,20,82,8,14,22
16,8478109,Victor Olofsson,L,BUF,29,82,7,15,22
16,8477506,Ryan Pulock,D,NYI,30,82,7,15,22
16,8475208,Brian Dumoulin,D,SEA,33,82,5,17,22
16,8477365,Connor Clifton,D,BUF,29,82,5,17,22
16,8475233,David Savard,D,MTL,34,82,5,17,22
16,8483495,Simon Nemec,D,NJD,20,82,5,17,22
16,8482733,Logan Mailloux,D,MTL,31,82,5,17,22
16,8477369,Carson Soucy,D,VAN,30,82,4,18,22
16,8476879,Cody Ceci,D,EDM,31,82,3,19,22
16,8470604,Jeff Carter,C,PIT,39,82,14,7,21
16,8482101,Danil Gushchin,L,SJS,22,82,9,12,21
16,8484145,Zach Benson,L,BUF,19,82,9,12,21
16,8482062,Cole Smith,L,NSH,29,82,7,14,21
16,8477406,Mattias Janmark,C,EDM,32,82,7,14,21
16,8482803,Olen Zellweger,D,ANA,21,82,7,14,21
16,8482809,Jackson Blake,R,CAR,21,82,6,15,21
16,8480035,Henri Jokiharju,D,BUF,25,82,5,16,21
16,8480448,Parker Kelly,L,OTT,25,82,4,17,21
16,8482087,Kaiden Guhle,D,MTL,22,82,4,17,21
16,8483490,Pavel Mintyukov,D,ANA,21,82,3,18,21
16,8479324,Ryan Lindgren,D,NYR,26,82,1,20,21
16,8476429,Scott Mayfield,D,NYI,32,82,0,21,21
16,8482155,Alex Laferriere,R,LAK,23,82,14,6,20
16,8480806,Isac Lundestrom,C,ANA,25,82,10,10,20
16,8478569,Noel Acciari,C,PIT,33,82,10,10,20
16,8482624,Daniil Miromanov,D,CGY,27,82,6,14,20
16,8476374,Sean Kuraly,C,CBJ,31,82,6,14,20
16,8482730,Brandt Clarke,D,LAK,21,82,6,14,20
16,8470600,Ryan Suter,D,DAL,39,82,5,15,20
16,8482858,Ryker Evans,D,SEA,23,82,5,15,20
16,8475790,Erik Gudbranson,D,CBJ,32,82,4,16,20
16,8477845,Trevor van Riemsdyk,D,WSH,33,82,3,17,20
16,8474574,Tyler Myers,D,VAN,34,82,3,17,20
16,8480860,Kevin Bahl,D,NJD,24,82,3,17,20
16,8475324,Nick Jensen,D,WSH,34,82,2,18,20
16,8478136,Jake Middleton,D,MIN,28,82,2,18,20
16,8480281,Alexey Toropchenko,R,STL,25,82,12,7,19
16,8477353,Tyler Motte,C,TBL,29,82,11,8,19
16,8479359,Beck Malenstyn,L,WSH,26,82,11,8,19
16,8482713,Mackie Samoskevich,R,FLA,22,82,9,10,19
16,8483468,Jiri Kulich,C,BUF,20,82,7,12,19
16,8483445,Cutter Gauthier,L,ANA,20,82,6,13,19
16,8477220,Nate Schmidt,D,WPG,33,82,4,15,19
16,8479980,Nicolas Hague,D,VGK,26,82,4,15,19
16,8475690,Chris Tanev,D,DAL,35,82,3,16,19
16,8475181,Nick Leddy,D,STL,33,82,1,18,19
16,8479661,Tanner Jeannot,L,TBL,27,82,12,6,18
16,8475842,Sam Carrick,C,EDM,32,82,9,9,18
16,8482762,Simon Edvinsson,D,DET,21,82,9,9,18
16,8483482,Tristan Luneau,D,ANA,20,82,9,9,18
16,8482666,Scott Morrow,D,CAR,22,82,6,12,18
16,8478451,Ethan Bear,D,WSH,27,82,4,14,18
16,8475762,Derek Forbort,D,BOS,32,82,4,14,18
16,8476372,Nick Seeler,D,PHI,31,82,3,15,18
16,8480172,Jan Rutta,D,SJS,34,82,0,18,18
16,8478831,Kevin Stenlund,C,FLA,28,82,13,4,17
16,8482679,Matt Coronato,R,CGY,22,82,10,7,17
16,8481537,Nikita Okhotiuk,D,CGY,24,82,9,8,17
16,8477931,Tomas Nosek,L,NJD,32,82,7,10,17
16,8482118,Sam Colangelo,R,ANA,23,82,5,12,17
16,8475462,Radko Gudas,D,ANA,34,82,5,12,17
16,8480879,Jacob Bernard-Docker,D,OTT,24,82,2,15,17
16,8475177,Calvin de Haan,D,TBL,33,82,2,15,17
16,8481524,Bowen Byram,D,BUF,23,82,9,7,16
16,8476878,Zemgus Girgensons,L,BUF,30,82,9,7,16
16,8473453,Trevor Lewis,C,LAK,37,82,8,8,16
16,8478468,Jeremy Lauzon,D,NSH,27,82,8,8,16
16,8483499,Liam Ohgren,L,MIN,20,82,8,8,16
16,8483491,Ivan Miroshnichenko,L,WSH,20,82,7,9,16
16,8481605,Jackson LaCombe,D,ANA,23,82,7,9,16
16,8481699,Aku Raty,R,ARI,23,82,4,12,16
16,8476967,Brett Kulak,D,EDM,30,82,0,16,16
16,8478178,Darren Raddysh,D,TBL,28,82,2,13,15
16,8478859,Niko Mikkola,D,FLA,28,82,1,14,15
16,8476312,Josh Manson,D,COL,33,82,7,7,14
16,8482470,Ilya Solovyov,D,CGY,24,82,6,8,14
16,8482177,Marat Khusnutdinov,C,MIN,22,82,6,8,14
16,8475188,Brayden McNabb,D,VGK,33,82,4,10,14
16,8481578,Graeme Clarke,R,NJD,23,82,4,10,14
16,8481599,Victor Soderstrom,D,ARI,23,82,4,10,14
16,8480990,Declan Chisholm,D,MIN,24,82,3,11,14
16,8476473,Connor Murphy,D,CHI,31,82,3,11,14
16,8475179,Dmitry Kulikov,D,FLA,34,82,2,12,14
16,8471677,Jack Johnson,D,COL,37,82,2,12,14
16,8477034,Jaycob Megna,D,CHI,32,82,1,13,14
16,8480031,Maxime Comtois,L,CAR,25,82,7,6,13
16,8481567,Henry Thrun,D,SJS,23,82,3,10,13
16,8474567,Zach Bogosian,D,MIN,34,82,1,12,13
16,8482859,Zack Ostapchuk,C,OTT,21,82,1,12,13
16,8478408,Travis Dermott,D,ARI,28,82,6,6,12
16,8476858,Phillip Di Giuseppe,L,VAN,31,82,8,3,11
16,8483397,Marc McLaughlin,C,BOS,25,82,7,4,11
16,8484149,Gavin Brindley,C,CBJ,20,82,3,8,11
16,8483466,Kevin Korchinski,D,CHI,20,82,3,8,11
16,8479442,Troy Stecher,D,EDM,30,82,2,9,11
16,8482737,Zack Bolduc,C,STL,21,82,9,1,10
16,8483489,Fraser Minten,C,TOR,31,82,5,5,10
16,8482712,Oskar Olausson,R,COL,22,82,4,6,10
16,8483493,Frank Nazar,C,CHI,20,82,4,6,10
16,8483471,Brad Lambert,C,WPG,31,82,2,8,10
16,8476822,Luke Glendening,C,TBL,35,82,6,3,9
16,8481030,Jack St. Ivany,D,PIT,25,82,1,8,9
16,8482516,Matthew Kessel,D,STL,24,82,0,9,9
16,8476915,Jujhar Khaira,L,MIN,30,82,1,6,7
16,8477950,Tony DeAngelo,D,CAR,29,0,0,0,0
16,8481577,Philip Tomasino,C,NSH,23,0,0,0,0
16,8482660,Kent Johnson,C,CBJ,22,0,0,0,0
16,8481019,David Gustafsson,C,WPG,24,0,0,0,0
16,8479348,Kale Clague,D,BUF,26,0,0,0,0
16,8482149,Cole Perfetti,C,WPG,22,0,0,0,0
16,8476952,Dominic Toninato,C,WPG,30,0,0,0,0
16,8473473,Milan Lucic,L,BOS,36,0,0,0,0
16,8480829,Jesperi Kotkaniemi,C,CAR,24,0,0,0,0
16,8474602,Justin Schultz,D,SEA,34,0,0,0,0
16,8480049,Dylan Samberg,D,WPG,25,0,0,0,0
16,8479372,Josh Mahura,D,FLA,26,0,0,0,0
16,8480878,Nils Lundkvist,D,DAL,24,0,0,0,0
16,8479982,Conor Timmins,D,TOR,26,0,0,0,0
16,8474031,Kevin Shattenkirk,D,BOS,35,0,0,0,0
16,8480835,Jack Drury,C,CAR,24,0,0,0,0
16,8480008,Adam Ruzicka,C,ARI,25,0,0,0,0
16,8479402,Jake Bean,D,CBJ,26,0,0,0,0
16,8476474,Stefan Noesen,R,CAR,31,0,0,0,0
16,8480884,Calen Addison,D,SJS,24,0,0,0,0
16,8476994,Vinnie Hinostroza,C,PIT,30,0,0,0,0
16,8477987,Ryan Donato,C,CHI,28,0,0,0,0
16,8481582,Nicholas Robertson,L,TOR,23,0,0,0,0
16,8478452,Caleb Jones,D,COL,27,0,0,0,0
16,8480157,Calle Rosen,D,STL,30,0,0,0,0
16,8481609,Vladislav Kolyachonok,D,ARI,23,0,0,0,0
16,8476919,Chris Tierney,C,NJD,30,0,0,0,0
16,8479639,Dylan Coghlan,D,CAR,26,0,0,0,0
16,8475193,Tomas Tatar,L,SEA,34,0,0,0,0
16,8480748,Kiefer Sherwood,L,NSH,29,0,0,0,0
16,8478146,Matthew Highmore,C,OTT,28,0,0,0,0
16,8478970,Jalen Chatfield,D,CAR,28,0,0,0,0
16,8480205,Emil Bemstrom,C,PIT,25,0,0,0,0
16,8471274,Alex Goligoski,D,MIN,39,0,0,0,0
16,8478104,Sammy Blais,L,STL,28,0,0,0,0
16,8476913,Devin Shore,C,SEA,30,0,0,0,0
16,8481708,Zac Jones,D,NYR,24,0,0,0,0
16,8480222,Sebastian Aho,D,NYI,28,0,0,0,0
16,8481598,Philip Broberg,D,EDM,23,0,0,0,0
16,8480789,Oliver Wahlstrom,R,NYI,24,0,0,0,0
16,8480891,Michael Kesselring,D,ARI,24,0,0,0,0
16,8477979,Nicolas Aube-Kubel,R,WSH,28,0,0,0,0
16,8476393,Nick Cousins,C,FLA,31,0,0,0,0
16,8480003,Jesper Boqvist,C,BOS,26,0,0,0,0
16,8479543,Michael Pezzetta,L,MTL,26,0,0,0,0
16,8475855,Jesper Fast,R,CAR,33,0,0,0,0
16,8477018,Ben Hutton,D,VGK,31,0,0,0,0
16,8480762,Eric Robinson,L,BUF,29,0,0,0,0
16,8481058,Jesse Ylönen,R,MTL,25,0,0,0,0
16,8481527,Kaedan Korczak,D,VGK,23,0,0,0,0
16,8482192,Isaak Phillips,D,CHI,23,0,0,0,0
16,8480727,Zach Whitecloud,D,VGK,28,0,0,0,0
16,8480001,Urho Vaakanainen,D,ANA,25,0,0,0,0
16,8480853,Liam Foudy,C,NSH,24,0,0,0,0
16,8475225,Craig Smith,C,DAL,35,0,0,0,0
16,8479972,Mason Shaw,C,MIN,26,0,0,0,0
16,8474040,Sam Gagner,C,EDM,35,0,0,0,0
16,8480196,Jacob Bryson,D,BUF,27,0,0,0,0
16,8475718,Justin Holl,D,DET,32,0,0,0,0
16,8479984,Cal Foote,D,NJD,26,0,0,0,0
16,8480011,Klim Kostin,C,SJS,25,0,0,0,0
16,8482176,Wyatt Kaiser,D,CHI,22,0,0,0,0
16,8476918,Jimmy Vesey,L,NYR,31,0,0,0,0
16,8476988,Matt Benning,D,SJS,30,0,0,0,0
16,8479370,Tyson Jost,C,BUF,26,0,0,0,0
16,8477464,Nic Petan,C,MIN,29,0,0,0,0
16,8477380,Jonny Brodzinski,C,NYR,31,0,0,0,0
16,8480070,Ian Mitchell,D,BOS,25,0,0,0,0
16,8479315,Joey Anderson,R,CHI,26,0,0,0,0
16,8478099,Kevin Labanc,R,SJS,29,0,0,0,0
16,8476874,Olli Maatta,D,DET,30,0,0,0,0
16,8479414,Nathan Bastian,R,NJD,27,0,0,0,0
16,8478434,Keegan Kolesar,R,VGK,27,0,0,0,0
16,8479536,Axel Jonsson-Fjallby,L,WPG,26,0,0,0,0
16,8479671,Mathieu Olivier,R,CBJ,27,0,0,0,0
16,8471709,Marc-Edouard Vlasic,D,SJS,37,0,0,0,0
16,8479328,Julien Gauthier,R,NYI,27,0,0,0,0
16,8478421,A.J. Greer,L,CGY,28,0,0,0,0
16,8477573,Nathan Walker,L,STL,30,0,0,0,0
16,8477478,William Carrier,L,VGK,30,0,0,0,0
16,8479344,Jesse Puljujarvi,R,PIT,26,0,0,0,0
16,8480887,Jordan Harris,D,MTL,24,0,0,0,0
16,8478502,Dennis Gilbert,D,CGY,28,0,0,0,0
16,8480355,Mark Kastelic,C,OTT,25,0,0,0,0
16,8475750,Jon Merrill,D,MIN,32,0,0,0,0
16,8476889,Radek Faksa,C,DAL,30,0,0,0,0
16,8478432,Christian Fischer,R,DET,27,0,0,0,0
16,8479439,Jacob MacDonald,D,SJS,31,0,0,0,0
16,8474568,Luke Schenn,D,NSH,35,0,0,0,0
16,8478454,Noah Juulsen,D,VAN,27,0,0,0,0
16,8475752,Tyler Pitlick,C,NYR,33,0,0,0,0
16,8482148,Hendrix Lapierre,C,WSH,22,0,0,0,0
16,8481167,Brayden Pachal,D,CGY,25,0,0,0,0
16,8478211,Dryden Hunt,L,CGY,29,0,0,0,0
16,8479321,Lucas Johansen,D,WSH,27,0,0,0,0
16,8480950,Ilya Lyubushkin,D,TOR,30,0,0,0,0
16,8479368,Max Jones,L,ANA,26,0,0,0,0
16,8471699,Andrew Cogliano,C,COL,37,0,0,0,0
16,8481521,Ronnie Attard,D,PHI,25,0,0,0,0
16,8481161,Jake Christiansen,D,CBJ,25,0,0,0,0
16,8479458,Nikita Zaitsev,D,CHI,33,0,0,0,0
16,8479619,Michael Carcone,L,ARI,28,0,0,0,0
16,8479026,Philippe Myers,D,TBL,27,0,0,0,0
16,8481617,Vasily Podkolzin,R,VAN,23,0,0,0,0
16,8481701,Santeri Hatakka,D,NJD,23,0,0,0,0
16,8477446,Michael McCarron,R,NSH,29,0,0,0,0
16,8483460,David Jiricek,D,CBJ,21,0,0,0,0
16,8474090,Brendan Smith,D,NJD,35,0,0,0,0
16,8482241,Radim Zohorna,L,PIT,28,0,0,0,0
16,8481032,Paul Cotter,C,VGK,25,0,0,0,0
16,8480289,Morgan Barron,C,WPG,26,0,0,0,0
16,8479379,Givani Smith,R,SJS,26,0,0,0,0
16,8480216,Jacob Peterson,C,SJS,25,0,0,0,0
16,8477851,Jordan Oesterle,D,CGY,32,0,0,0,0
16,8484258,Sam Malinski,D,COL,26,0,0,0,0
16,8478904,Steven Lorentz,C,FLA,28,0,0,0,0
16,8482095,Tyler Kleven,D,OTT,22,0,0,0,0
16,8480980,Connor Dewar,C,TOR,25,0,0,0,0
16,8480848,Ty Dellandrea,C,DAL,24,0,0,0,0
16,8476884,Derrick Pouliot,D,DAL,30,0,0,0,0
16,8480025,MacKenzie Entwistle,R,CHI,25,0,0,0,0
16,8474612,Travis Hamonic,D,OTT,34,0,0,0,0
16,8479336,Carl Grundstrom,R,LAK,27,0,0,0,0
16,8482964,Arber Xhekaj,D,MTL,23,0,0,0,0
16,8471686,Marc Staal,D,PHI,37,0,0,0,0
16,8477887,Patrick Brown,C,BOS,32,0,0,0,0
16,8478495,Denis Gurianov,R,PHI,27,0,0,0,0
16,8481550,Adam Beckman,L,MIN,23,0,0,0,0
16,8480845,Rasmus Kupari,C,WPG,24,0,0,0,0
16,8478585,Derek Ryan,C,EDM,38,0,0,0,0
16,8482141,Lukas Cormier,D,VGK,22,0,0,0,0
16,8477962,Brendan Lemieux,L,CAR,28,0,0,0,0
16,8482861,Vincent Iorio,D,WSH,22,0,0,0,0
16,8479378,Logan Stanley,D,WPG,26,0,0,0,0
16,8473446,Erik Johnson,D,PHI,36,0,0,0,0
16,8481743,Marc Del Gaizo,D,NSH,25,0,0,0,0
16,8478450,Parker Wotherspoon,D,BOS,27,0,0,0,0
16,8477384,Josh Brown,D,ARI,30,0,0,0,0
16,8482165,Yan Kuznetsov,D,CGY,22,0,0,0,0
16,8478424,Jansen Harkins,C,PIT,27,0,0,0,0
16,8482144,Jack Thompson,D,SJS,22,0,0,0,0
16,8479576,Vincent Desharnais,D,EDM,28,0,0,0,0
16,8478512,Austin Czarnik,C,DET,32,0,0,0,0
16,8477527,Ross Johnston,L,ANA,30,0,0,0,0
16,8482094,Daemon Hunt,D,MIN,22,0,0,0,0
16,8481719,Maxwell Crozier,D,TBL,24,0,0,0,0
16,8480192,Johnathan Kovacevic,D,MTL,27,0,0,0,0
16,8479376,Victor Mete,D,PHI,26,0,0,0,0
16,8482511,Mason Lohrei,D,BOS,23,0,0,0,0
16,8478021,William Lagesson,D,ANA,28,0,0,0,0
16,8475795,Dylan McIlrath,D,WSH,32,0,0,0,0
16,8477846,Ryan Carpenter,C,SJS,33,0,0,0,0
16,8481056,Spencer Stastney,D,NSH,24,0,0,0,0
16,8481564,Ryan Johnson,D,BUF,23,0,0,0,0
16,8478017,Mark Friedman,D,VAN,29,0,0,0,0
16,8479320,Max Lajoie,D,TOR,27,0,0,0,0
16,8480075,Cameron Crotty,D,ARI,25,0,0,0,0
16,8484287,Cole McWard,D,VAN,23,0,0,0,0
16,8484254,Akito Hirose,D,VAN,25,0,0,0,0
16,8483407,Brandon Scanlin,D,NYR,25,0,0,0,0
16,8480274,Philip Kemp,D,EDM,25,0,0,0,0
16,8479522,Hardy Haman Aktell,D,WSH,26,0,0,0,0
16,8480007,Jonas Rondbjerg,R,VGK,25,0,0,0,0
16,8477454,Adam Erne,L,EDM,29,0,0,0,0
16,8481679,Maxence Guenette,D,OTT,23,0,0,0,0
16,8477938,Haydn Fleury,D,TBL,28,0,0,0,0
16,8476441,Joel Edmundson,D,TOR,31,0,0,0,0
16,8477903,Garnet Hathaway,R,PHI,33,0,0,0,0
16,8480441,Trey Fix-Wolansky,R,CBJ,25,0,0,0,0
16,8483546,Marshall Rifai,D,TOR,26,0,0,0,0
16,8480084,Nick DeSimone,D,NJD,30,0,0,0,0
16,8481592,Jakob Pelletier,L,CGY,23,0,0,0,0
16,8478011,Louie Belpedio,D,PHI,28,0,0,0,0
16,8477930,Pierre-Edouard Bellemare,L,SEA,39,0,0,0,0
16,8484321,Nikolas Matinpalo,D,OTT,26,0,0,0,0
16,8482067,Connor Mackey,D,NYR,28,0,0,0,0
16,8481806,Louis Crevier,D,CHI,23,0,0,0,0
16,8484326,Patrik Koch,D,ARI,28,0,0,0,0
16,8477971,Andreas Englund,D,LAK,28,0,0,0,0
16,8481751,Lukas Rousek,R,BUF,25,0,0,0,0
16,8481006,Tyler Tucker,D,STL,24,0,0,0,0
16,8481641,Joel Kiviranta,L,COL,28,0,0,0,0
16,8476867,Brendan Gaunce,C,CBJ,30,0,0,0,0
16,8479520,Brandon Duhaime,R,COL,27,0,0,0,0
16,8477073,Kurtis MacDermid,L,NJD,30,0,0,0,0
16,8480874,Adam Ginning,D,PHI,24,0,0,0,0
16,8477473,Justin Bailey,R,SJS,29,0,0,0,0
16,8479066,Ryan Lomberg,L,FLA,30,0,0,0,0
16,8477070,Liam O'Brien,C,ARI,30,0,0,0,0
16,8474618,Marco Scandella,D,STL,34,0,0,0,0
16,8475797,Jarred Tinordi,D,CHI,32,0,0,0,0
16,8481441,Joe Snively,C,WSH,28,0,0,0,0
16,8477244,Chad Ruhwedel,D,NYR,34,0,0,0,0
16,8482077,Dylan Holloway,L,EDM,23,0,0,0,0
16,8479772,Zack MacEwen,R,OTT,28,0,0,0,0
16,8481147,Reese Johnson,C,CHI,26,0,0,0,0
16,8481043,Cole Koepke,L,TBL,26,0,0,0,0
16,8483619,Filip Roos,D,CHI,25,0,0,0,0
16,8481541,Samuel Bolduc,D,NYI,24,0,0,0,0
16,8477810,Joel Hanley,D,CGY,33,0,0,0,0
16,8476907,Mackenzie MacEachern,L,STL,30,0,0,0,0
16,8482652,Walker Duehr,R,CGY,27,0,0,0,0
16,8477126,Jayson Megna,C,BOS,34,0,0,0,0
16,8483398,Declan Carlile,D,TBL,31,0,0,0,0
16,8482929,Emil Lilleberg,D,TBL,23,0,0,0,0
16,8480880,Jakub Lauko,C,BOS,24,0,0,0,0
16,8478874,Adam Gaudette,C,STL,28,0,0,0,0
16,8480245,Olle Lycksell,R,PHI,25,0,0,0,0
16,8480252,Cole Guttman,C,CHI,25,0,0,0,0
16,8477467,Gustav Olofsson,D,SEA,30,0,0,0,0
16,8479968,Vinni Lettieri,C,MIN,29,0,0,0,0
16,8478400,Colin White,C,MTL,27,0,0,0,0
16,8475755,Alexander Petrovic,D,DAL,32,0,0,0,0
16,8481812,Nikolai Knyzhov,D,SJS,27,0,0,0,0
16,8481593,Jayden Struble,D,MTL,23,0,0,0,0
16,8481532,Alex Turcotte,C,LAK,23,0,0,0,0
16,8482126,Emil Andrae,D,PHI,31,0,0,0,0
16,8479944,Zach Aston-Reese,C,DET,30,0,0,0,0
16,8471817,Ryan Reaves,R,TOR,37,0,0,0,0
16,8481206,John Ludvig,D,PIT,24,0,0,0,0
16,8480292,Carson Meyer,R,CBJ,27,0,0,0,0
16,8482496,Nils Aman,C,VAN,24,0,0,0,0
16,8479718,Alex Barré-Boulet,C,TBL,27,0,0,0,0
16,8479994,Jaret Anderson-Dolan,C,NSH,25,0,0,0,0
16,8480184,Gustav Lindstrom,D,ANA,26,0,0,0,0
16,8480890,Jan Jenik,R,ARI,24,0,0,0,0
16,8478067,Oskar Lindblom,L,SJS,28,0,0,0,0
16,8476934,Brock McGinn,L,ANA,30,0,0,0,0
16,8479985,Cale Fleury,D,SEA,26,0,0,0,0
16,8482153,Brendan Brisson,C,VGK,23,0,0,0,0
16,8480021,Jack Studnicka,C,SJS,25,0,0,0,0
16,8484304,Uvis Balinskis,D,FLA,28,0,0,0,0
16,8479981,Jonah Gadjovich,L,FLA,26,0,0,0,0
16,8481716,Dmitri Voronkov,L,CBJ,24,0,0,0,0
16,8482659,Josh Doan,R,ARI,22,0,0,0,0
16,8481122,Simon Benoit,D,TOR,26,0,0,0,0
16,8474709,Matt Martin,L,NYI,35,0,0,0,0
16,8482634,Alex Steeves,C,TOR,25,0,0,0,0
16,8480823,Alexander Alexeyev,D,WSH,25,0,0,0,0
16,8477541,Dakota Mermis,D,MIN,30,0,0,0,0
16,8478477,Mitchell Stephens,C,MTL,27,0,0,0,0
16,8481543,Nikita Alexandrov,C,STL,24,0,0,0,0
16,8482451,Mikael Pyyhtia,L,CBJ,23,0,0,0,0
16,8480306,Grant Hutton,D,NYI,29,0,0,0,0
16,8478028,Fredrik Olofsson,L,COL,28,0,0,0,0
16,8477462,Robert Hagg,D,ANA,29,0,0,0,0
16,8477320,Anton Blidh,L,NYR,29,0,0,0,0
16,8482749,Joshua Roy,R,MTL,21,0,0,0,0
16,8482157,Will Cuylle,L,NYR,22,0,0,0,0
16,8481239,Samuel Fagemo,L,LAK,24,0,0,0,0
16,8481600,Tobias Bjornfot,D,FLA,23,0,0,0,0
16,8478409,Anthony Richard,C,BOS,28,0,0,0,0
16,8474145,Robert Bortuzzo,D,NYI,35,0,0,0,0
16,8475958,Michael Sgarbossa,C,WSH,32,0,0,0,0
16,8479986,Kole Lind,R,SEA,26,0,0,0,0
16,8479249,Andrew Poturalski,C,SEA,30,0,0,0,0
16,8479362,Riley Tufte,L,COL,26,0,0,0,0
16,8479991,Jake Leschyshyn,C,NYR,25,0,0,0,0
16,8479587,Rhett Gardner,C,PHI,28,0,0,0,0
16,8482744,James Malatesta,L,CBJ,21,0,0,0,0
16,8478854,Ryan Shea,D,PIT,27,0,0,0,0
16,8481591,Sam Poulin,R,PIT,23,0,0,0,0
16,8483512,Matt Savoie,C,BUF,20,0,0,0,0
16,8482102,Vasily Ponomarev,C,CAR,22,0,0,0,0
16,8482162,Roby Jarventie,L,OTT,22,0,0,0,0
16,8482172,Landon Slaggert,L,CHI,22,0,0,0,0
16,8482747,Brennan Othmann,L,NYR,21,0,0,0,0
16,8480226,Marián Studenic,R,SEA,26,0,0,0,0
16,8481518,Nolan Foote,L,NJD,24,0,0,0,0
16,8479419,Brett Murray,L,BUF,26,0,0,0,0
16,8482088,Justin Sourdif,R,FLA,22,0,0,0,0
16,8482201,Gage Goncalves,C,TBL,23,0,0,0,0
16,8481754,Nikita Nesterenko,C,ANA,23,0,0,0,0
16,8483531,Brian Halonen,L,NJD,25,0,0,0,0
16,8483920,Pierrick Dube,R,WSH,23,0,0,0,0
16,8480851,Akil Thomas,C,LAK,24,0,0,0,0
16,8475235,Nicolas Deslauriers,L,PHI,33,0,0,0,0
16,8482476,Emil Heineman,L,MTL,23,0,0,0,0
16,8477149,Scott Sabourin,R,SJS,32,0,0,0,0
16,8483549,Lucas Condotta,L,MTL,27,0,0,0,0
16,8483567,Georgii Merkulov,C,BOS,24,0,0,0,0
16,8482765,Isak Rosen,R,BUF,21,0,0,0,0
16,8481237,Kyle MacLean,C,NYI,25,0,0,0,0
16,8481024,Linus Karlsson,C,VAN,25,0,0,0,0
16,8481690,Tyler Angle,C,CBJ,24,0,0,0,0
16,8483570,Ben Meyers,C,ANA,26,0,0,0,0
16,8481655,Cole Schwindt,R,CGY,23,0,0,0,0
16,8481462,Mason Morelli,L,VGK,28,0,0,0,0
16,8483401,Marc Johnstone,R,PIT,28,0,0,0,0
16,8478956,Samuel Laberge,L,NJD,27,0,0,0,0
16,8479533,Joona Koppanen,L,PIT,26,0,0,0,0
16,8482197,Adam Raska,R,MIN,23,0,0,0,0
16,8482250,Callahan Burke,C,CAR,27,0,0,0,0
16,8482784,Zach Dean,C,STL,21,0,0,0,0
16,8484255,Jason Polin,R,COL,25,0,0,0,0
16,8481077,John Leonard,L,ARI,26,0,0,0,0
16,8481534,Raphael Lavoie,C,EDM,24,0,0,0,0
16,8483609,Adam Klapka,R,CGY,24,0,0,0,0
16,8482751,Ryan Winterton,C,SEA,21,0,0,0,0
16,8480267,Sammy Walker,C,MIN,25,0,0,0,0
16,8475766,Austin Watson,L,TBL,32,0,0,0,0
16,8482460,Matt Rempe,C,NYR,22,0,0,0,0
16,8482787,Nikita Chibrikov,R,WPG,31,0,0,0,0
16,8481065,Angus Crookshank,L,OTT,25,0,0,0,0
16,8481070,Hugh McGing,L,STL,26,0,0,0,0
16,8476323,Max McCormick,L,SEA,32,0,0,0,0
16,8483395,Arshdeep Bains,L,VAN,23,0,0,0,0
16,8484259,Ondrej Pavel,C,COL,31,0,0,0,0
16,8483432,Luca Del Bel Belluz,C,CBJ,31,0,0,0,0
16,8483045,Cameron Butler,R,CBJ,31,0,0,0,0
16,8482061,Brandon Biro,L,BUF,26,0,0,0,0
16,8477401,John Hayden,C,SEA,29,0,0,0,0
16,8475278,Byron Froese,C,VGK,33,0,0,0,0
16,8478446,Glenn Gawdin,C,ANA,27,0,0,0,0
16,8477993,Justin Kirkland,C,ARI,28,0,0,0,0
16,8482147,Jean-Luc Foudy,C,COL,22,0,0,0,0
16,8480032,Shane Bowers,C,NJD,25,0,0,0,0
16,8479330,Brandon Gignac,C,MTL,27,0,0,0,0
16,8480776,Sheldon Rempal,R,VGK,29,0,0,0,0
16,8475413,Justin Dowling,C,NJD,34,0,0,0,0
16,8481726,Adam Edstrom,C,NYR,24,0,0,0,0
16,8479638,Justin Brazeau,R,BOS,26,0,0,0,0
16,8480844,Grigori Denisenko,L,VGK,24,0,0,0,0
16,8474062,Riley Nash,C,NYR,35,0,0,0,0
16,8478147,Bokondji Imama,L,OTT,28,0,0,0,0
16,8478881,Brett Seney,L,CHI,28,0,0,0,0
16,8483630,Pavol Regenda,L,ANA,25,0,0,0,0
16,8480836,Jonathan Gruden,C,PIT,24,0,0,0,0
16,8484314,Jiri Smejkal,L,OTT,28,0,0,0,0
16,8475780,Chris Wagner,R,COL,33,0,0,0,0
16,8482070,Mitchell Chaffee,R,TBL,26,0,0,0,0
16,8479546,Oskar Steen,C,BOS,26,0,0,0,0
16,8483597,Milos Kelemen,L,ARI,25,0,0,0,0
16,8481789,Tye Kartye,L,SEA,23,0,0,0,0
16,8484325,Waltteri Merela,C,TBL,26,0,0,0,0
16,8479421,Jacob Moverare,D,LAK,26,0,0,0,0
16,8481585,Egor Afanasyev,L,NSH,23,0,0,0,0
16,8479547,Matthew Phillips,R,WSH,26,0,0,0,0
16,8479367,William Lockwood,R,FLA,26,0,0,0,0
16,8481422,Jacob Lucchini,C,MIN,29,0,0,0,0
16,8480468,James Hamblin,L,EDM,25,0,0,0,0
16,8480870,Bo Groulx,C,ANA,24,0,0,0,0
16,8478051,Max Willman,C,NJD,29,0,0,0,0
16,8481556,John Beecher,C,BOS,23,0,0,0,0
16,8478078,Rourke Chartier,C,OTT,28,0,0,0,0
17,8478402,Connor McDavid,C,EDM,27,82,45,112,157
17,8477492,Nathan MacKinnon,C,COL,29,82,48,75,123
17,8479318,Auston Matthews,C,TOR,27,82,68,54,122
17,8476453,Nikita Kucherov,R,TBL,31,82,36,84,120
17,8478420,Mikko Rantanen,R,COL,28,82,50,69,119
17,8477939,William Nylander,R,TOR,28,82,50,69,119
17,8477956,David Pastrnak,R,BOS,28,82,51,61,112
17,8471675,Sidney Crosby,C,PIT,37,82,45,65,110
17,8479314,Matthew Tkachuk,L,FLA,27,82,37,73,110
17,8478550,Artemi Panarin,L,NYR,33,82,32,75,107
17,8481559,Jack Hughes,C,NJD,23,82,43,62,105
17,8478864,Kirill Kaprizov,L,MIN,27,82,42,62,104
17,8476887,Filip Forsberg,L,NSH,30,82,48,53,101
17,8477934,Leon Draisaitl,C,EDM,29,82,36,65,101
17,8475913,Mark Stone,R,VGK,32,82,43,57,100
17,8480069,Cale Makar,D,COL,26,82,29,71,100
17,8478439,Travis Konecny,R,PHI,27,82,46,50,96
17,8477946,Dylan Larkin,C,DET,28,82,37,59,96
17,8476468,J.T. Miller,C,VAN,31,82,38,57,95
17,8480012,Elias Pettersson,C,VAN,26,82,34,61,95
17,8474600,Roman Josi,D,NSH,34,82,28,67,95
17,8474564,Steven Stamkos,C,TBL,34,82,35,58,93
17,8478398,Kyle Connor,L,WPG,28,82,43,49,92
17,8479385,Jordan Kyrou,C,STL,26,82,43,49,92
17,8474578,Erik Karlsson,D,PIT,34,82,16,74,90
17,8479343,Clayton Keller,R,ARI,26,82,43,46,89
17,8477951,Nick Schmaltz,C,ARI,28,82,29,60,89
17,8480023,Robert Thomas,C,STL,25,82,26,63,89
17,8481557,Matt Boldy,L,MIN,23,82,39,49,88
17,8476454,Ryan Nugent-Hopkins,C,EDM,31,82,25,63,88
17,8473419,Brad Marchand,L,BOS,36,82,22,66,88
17,8477933,Sam Reinhart,C,FLA,29,82,45,42,87
17,8471214,Alex Ovechkin,L,WSH,39,82,42,45,87
17,8475786,Zach Hyman,L,EDM,32,82,56,30,86
17,8478414,Timo Meier,R,NJD,28,82,39,47,86
17,8478403,Jack Eichel,C,VGK,28,82,37,49,86
17,8476459,Mika Zibanejad,C,NYR,31,82,35,51,86
17,8480027,Jason Robertson,L,DAL,25,82,33,53,86
17,8480800,Quinn Hughes,D,VAN,25,82,17,69,86
17,8478427,Sebastian Aho,C,CAR,27,82,36,49,85
17,8480801,Brady Tkachuk,L,OTT,25,82,42,42,84
17,8478010,Brayden Point,C,TBL,28,82,38,46,84
17,8477949,Alex Tuch,R,BUF,28,82,23,61,84
17,8479407,Jesper Bratt,L,NJD,26,82,21,63,84
17,8473994,Jamie Benn,L,DAL,35,82,31,52,83
17,8480208,Drake Batherson,R,OTT,26,82,31,52,83
17,8478449,Roope Hintz,C,DAL,28,82,38,44,82
17,8475158,Ryan O'Reilly,C,NSH,33,82,37,45,82
17,8477404,Jake Guentzel,C,CAR,30,82,33,49,82
17,8471215,Evgeni Malkin,C,PIT,38,82,31,51,82
17,8478440,Dylan Strome,C,WSH,27,82,27,55,82
17,8478444,Brock Boeser,R,VAN,27,82,46,35,81
17,8482116,Tim Stützle,C,OTT,22,82,32,49,81
17,8476460,Mark Scheifele,C,WPG,31,82,29,52,81
17,8474679,Gustav Nyquist,C,NSH,35,82,25,56,81
17,8476346,Johnny Gaudreau,L,CBJ,31,82,19,62,81
17,8477501,Valeri Nichushkin,R,COL,29,82,42,38,80
17,8475784,Jeff Skinner,C,BUF,32,82,37,43,80
17,8479323,Adam Fox,D,NYR,26,82,16,64,80
17,8475810,Bryan Rust,R,PIT,32,82,42,35,77
17,8477409,Carter Verhaeghe,C,FLA,29,82,37,39,76
17,8479420,Tage Thompson,C,BUF,27,82,37,39,76
17,8477402,Pavel Buchnevich,L,STL,29,82,30,45,75
17,8480036,Miro Heiskanen,D,DAL,25,82,20,55,75
17,8475169,Evander Kane,L,EDM,33,82,38,36,74
17,8477960,Adrian Kempe,R,LAK,28,82,30,44,74
17,8476389,Vincent Trocheck,C,NYR,31,82,29,45,74
17,8477942,Kevin Fiala,L,LAK,28,82,23,51,74
17,8475184,Chris Kreider,L,NYR,33,82,39,34,73
17,8477493,Aleksander Barkov,C,FLA,29,82,23,50,73
17,8479337,Alex DeBrincat,R,DET,27,82,26,46,72
17,8470794,Joe Pavelski,C,DAL,40,82,23,49,72
17,8480002,Nico Hischier,C,NJD,25,82,34,37,71
17,8478873,Troy Terry,R,ANA,27,82,30,41,71
17,8480830,Andrei Svechnikov,R,CAR,24,82,27,44,71
17,8473512,Claude Giroux,R,OTT,36,82,26,45,71
17,8474590,John Carlson,D,WSH,34,82,13,58,71
17,8477447,Shea Theodore,D,VGK,29,82,23,47,70
17,8475167,Victor Hedman,D,TBL,34,82,14,56,70
17,8478407,Vince Dunn,D,SEA,28,82,15,53,68
17,8480803,Evan Bouchard,D,EDM,25,82,15,53,68
17,8476905,Chandler Stephenson,C,VGK,30,82,23,44,67
17,8478462,Nicolas Roy,C,VGK,27,82,20,47,67
17,8482093,Seth Jarvis,C,CAR,22,82,39,27,66
17,8478493,Joel Eriksson Ek,C,MIN,27,82,34,32,66
17,8476432,Boone Jenner,C,CBJ,31,82,34,32,66
17,8481596,Shane Pinto,C,OTT,24,82,29,37,66
17,8481523,Kirby Dach,C,MTL,23,82,15,51,66
17,8481068,Yegor Sharangovich,C,CGY,26,82,30,35,65
17,8480797,Joel Farabee,L,PHI,24,82,29,36,65
17,8476462,Dougie Hamilton,D,NJD,31,82,25,40,65
17,8482665,Matty Beniers,C,SEA,22,82,23,42,65
17,8475172,Nazem Kadri,C,CGY,34,82,21,44,65
17,8480865,Noah Dobson,D,NYI,24,82,13,52,65
17,8479675,Trevor Moore,L,LAK,29,82,34,30,64
17,8482740,Wyatt Johnston,C,DAL,21,82,32,32,64
17,8482745,Mason McTavish,C,ANA,21,82,26,38,64
17,8481711,Matias Maccelli,L,ARI,24,82,18,46,64
17,8475798,Mikael Granlund,C,SJS,32,82,14,50,64
17,8478460,Zach Werenski,D,CBJ,27,82,13,51,64
17,8477479,Tyler Bertuzzi,L,TOR,29,82,32,31,63
17,8481528,Dylan Cozens,C,BUF,23,82,29,34,63
17,8474141,Patrick Kane,R,DET,36,82,26,37,63
17,8477940,Nikolaj Ehlers,L,WPG,28,82,25,38,63
17,8478047,Michael Bunting,L,PIT,29,82,24,39,63
17,8478445,Mathew Barzal,C,NYI,27,82,16,47,63
17,8475754,Brock Nelson,C,NYI,33,82,32,30,62
17,8479542,Brandon Hagel,L,TBL,26,82,31,31,62
17,8476483,Rickard Rakell,R,PIT,31,82,27,35,62
17,8480839,Rasmus Dahlin,D,BUF,24,82,14,48,62
17,8476456,Jonathan Huberdeau,C,CGY,31,82,14,48,62
17,8476539,Jonathan Marchessault,R,VGK,34,82,30,31,61
17,8476826,Yanni Gourde,C,SEA,33,82,23,38,61
17,8478438,Tommy Novak,C,NSH,27,82,19,42,61
17,8477494,Jonathan Drouin,L,COL,29,82,13,48,61
17,8474563,Drew Doughty,D,LAK,35,82,8,53,61
17,8479339,Patrik Laine,L,CBJ,26,82,28,32,60
17,8475170,Brayden Schenn,C,STL,33,82,19,41,60
17,8474565,Alex Pietrangelo,D,VGK,34,82,14,46,60
17,8477998,Warren Foegele,L,EDM,28,82,30,29,59
17,8475191,Reilly Smith,R,PIT,33,82,29,30,59
17,8475168,Matt Duchene,C,DAL,33,82,26,33,59
17,8475166,John Tavares,C,TOR,34,82,25,34,59
17,8480018,Nick Suzuki,C,MTL,25,82,24,35,59
17,8478519,Anthony Cirelli,C,TBL,27,82,22,37,59
17,8478396,Noah Hanifin,D,VGK,27,82,15,44,59
17,8477504,Josh Morrissey,D,WPG,29,82,12,47,59
17,8475692,Mats Zuccarello,R,MIN,37,82,10,49,59
17,8476881,Tomas Hertl,C,VGK,31,82,31,27,58
17,8480015,Owen Tippett,R,PHI,25,82,27,31,58
17,8478042,Viktor Arvidsson,R,LAK,31,82,26,32,58
17,8478233,Andrew Mangiapane,L,CGY,28,82,26,32,58
17,8477476,Artturi Lehkonen,L,COL,29,82,24,34,58
17,8479999,Casey Mittelstadt,C,COL,26,82,22,36,58
17,8479400,Pierre-Luc Dubois,L,LAK,26,82,22,36,58
17,8478469,Thomas Chabot,D,OTT,27,82,17,41,58
17,8478038,Devon Toews,D,COL,30,82,13,45,58
17,8476882,Teuvo Teravainen,L,CAR,30,82,30,27,57
17,8475765,Vladimir Tarasenko,R,FLA,33,82,25,32,57
17,8481533,Trevor Zegras,C,ANA,23,82,24,33,57
17,8482667,William Eklund,L,SJS,22,82,24,33,57
17,8476448,William Karlsson,C,VGK,31,82,23,34,57
17,8474641,Adam Henrique,C,EDM,34,82,21,36,57
17,8482124,Quinton Byfield,R,LAK,22,82,20,37,57
17,8471685,Anze Kopitar,C,LAK,37,82,19,38,57
17,8471724,Kris Letang,D,PIT,37,82,10,47,57
17,8477955,Jared McCann,L,SEA,28,82,27,29,56
17,8482078,Lucas Raymond,L,DET,22,82,23,33,56
17,8477444,Andre Burakovsky,L,SEA,29,82,23,33,56
17,8477416,Oliver Bjorkstrand,R,SEA,29,82,22,34,56
17,8480039,Martin Necas,C,CAR,25,82,22,34,56
17,8478055,Gustav Forsling,D,FLA,28,82,12,44,56
17,8482159,Tyson Foerster,R,PHI,22,82,31,24,55
17,8471698,T.J. Oshie,R,WSH,38,82,31,24,55
17,8475726,Tyler Toffoli,C,WPG,32,82,29,26,55
17,8475794,Tyler Seguin,C,DAL,32,82,29,26,55
17,8478856,Conor Garland,R,VAN,28,82,23,32,55
17,8484144,Connor Bedard,C,CHI,19,82,18,37,55
17,8475197,Tyson Barrie,D,NSH,33,82,11,44,55
17,8479325,Charlie McAvoy,D,BOS,27,82,10,45,55
17,8481540,Cole Caufield,R,MTL,23,82,31,23,54
17,8474102,David Perron,L,DET,36,82,22,32,54
17,8477021,Alex Kerfoot,C,ARI,30,82,22,32,54
17,8470613,Brent Burns,D,CAR,39,82,18,36,54
17,8480028,Morgan Frost,C,PHI,25,82,13,41,54
17,8479345,Jakob Chychrun,D,OTT,26,82,15,38,53
17,8480014,Gabriel Vilardi,C,WPG,25,82,30,22,52
17,8474157,Max Pacioretty,L,WSH,36,82,22,30,52
17,8477451,Ryan Hartman,R,MIN,30,82,21,31,52
17,8482110,Dawson Mercer,C,NJD,23,82,21,31,52
17,8474586,Jordan Eberle,R,SEA,34,82,18,34,52
17,8477932,Aaron Ekblad,D,FLA,28,82,17,35,52
17,8475753,Justin Faulk,D,STL,32,82,14,38,52
17,8478397,Rasmus Andersson,D,CGY,28,82,13,39,52
17,8476906,Shayne Gostisbehere,D,DET,31,82,9,43,52
17,8478498,Jake DeBrusk,L,BOS,28,82,31,20,51
17,8476880,Tom Wilson,R,WSH,30,82,29,22,51
17,8482699,Dylan Guenther,R,ARI,21,82,27,24,51
17,8478458,Jack Roslovic,C,NYR,27,82,19,32,51
17,8476458,Ryan Strome,C,ANA,31,82,16,35,51
17,8475200,Dmitry Orlov,D,CAR,33,82,14,37,51
17,8478474,Lawson Crouse,L,ARI,27,82,29,21,50
17,8475745,Charlie Coyle,C,BOS,32,82,22,28,50
17,8478401,Pavel Zacha,C,BOS,27,82,17,33,50
17,8478542,Evan Rodrigues,C,FLA,31,82,17,33,50
17,8479996,Cody Glass,C,NSH,25,82,16,34,50
17,8478975,Mason Marchment,L,DAL,29,82,15,35,50
17,8476875,Mike Matheson,D,MTL,30,82,15,35,50
17,8477346,MacKenzie Weegar,D,CGY,30,82,15,35,50
17,8476853,Morgan Rielly,D,TOR,30,82,11,39,50
17,8482109,Alexis Lafrenière,L,NYR,23,82,24,25,49
17,8477497,Sean Monahan,C,WPG,30,82,23,26,49
17,8476399,Blake Coleman,C,CGY,33,82,21,28,49
17,8478466,Daniel Sprong,R,DET,27,82,21,28,49
17,8477503,Max Domi,C,TOR,29,82,19,30,49
17,8482684,Luke Hughes,D,NJD,21,82,12,37,49
17,8475768,Jaden Schwartz,C,SEA,32,82,27,21,48
17,8473986,Alex Killorn,L,ANA,35,82,24,24,48
17,8475799,Nino Niederreiter,R,WPG,32,82,22,26,48
17,8479987,Morgan Geekie,C,BOS,26,82,20,28,48
17,8475791,Taylor Hall,L,CHI,33,82,20,28,48
17,8475218,Mattias Ekholm,D,EDM,34,82,19,29,48
17,8479992,Michael Rasmussen,C,DET,25,82,18,30,48
17,8474150,Mikael Backlund,C,CGY,35,82,16,32,48
17,8476927,Teddy Blueger,C,VAN,30,82,16,32,48
17,8479425,Filip Hronek,D,VAN,27,82,13,35,48
17,8477496,Elias Lindholm,C,VAN,30,82,13,35,48
17,8476479,Phillip Danault,C,LAK,31,82,12,36,48
17,8476869,Brady Skjei,D,CAR,30,82,9,39,48
17,8477498,Darnell Nurse,D,EDM,29,82,8,40,48
17,8476925,Colton Sissons,C,NSH,31,82,20,27,47
17,8482113,Anton Lundell,C,FLA,23,82,17,30,47
17,8483808,Andrei Kuzmenko,L,CGY,28,82,17,30,47
17,8476872,Scott Laughton,C,PHI,30,82,16,31,47
17,8479410,Mikhail Sergachev,D,TBL,26,82,11,36,47
17,8475764,Cam Fowler,D,ANA,33,82,7,40,47
17,8480434,Sean Durzi,D,ARI,26,82,6,41,47
17,8476438,Brandon Saad,L,STL,32,82,28,18,46
17,8474037,James van Riemsdyk,L,BOS,35,82,26,20,46
17,8480802,Ryan McLeod,C,EDM,25,82,16,30,46
17,8480064,Josh Norris,C,OTT,25,82,15,31,46
17,8481542,Moritz Seider,D,DET,23,82,3,43,46
17,8475722,Jason Zucker,L,NSH,32,82,29,16,45
17,8475314,Anders Lee,L,NYI,34,82,27,18,45
17,8482475,Yegor Chinakhov,R,CBJ,23,82,22,23,45
17,8477964,Ivan Barbashev,C,VGK,29,82,18,27,45
17,8475744,Evgeny Kuznetsov,C,CAR,32,82,17,28,45
17,8477456,J.T. Compher,L,DET,29,82,17,28,45
17,8473563,Nicklas Backstrom,C,WSH,37,82,15,30,45
17,8476792,Torey Krug,D,STL,33,82,12,33,45
17,8473422,Nick Foligno,L,CHI,37,82,12,33,45
17,8481581,Thomas Harley,D,DAL,23,82,11,34,45
17,8478366,Frank Vatrano,R,ANA,30,82,25,19,44
17,8480849,Barrett Hayton,C,ARI,24,82,24,20,44
17,8474870,Tyler Johnson,C,CHI,34,82,21,23,44
17,8477407,Anthony Duclair,L,TBL,29,82,20,24,44
17,8482146,Luke Evangelista,R,NSH,22,82,20,24,44
17,8481624,Ilya Mikheyev,R,VAN,30,82,15,29,44
17,8478891,Mason Appleton,C,WPG,28,82,14,30,44
17,8476854,Hampus Lindholm,D,BOS,30,82,10,34,44
17,8480145,Neal Pionk,D,WPG,29,82,6,38,44
17,8476329,Travis Boyd,C,ARI,31,82,6,38,44
17,8476958,Jaccob Slavin,D,CAR,30,82,4,40,44
17,8474715,Cam Atkinson,R,PHI,35,82,23,20,43
17,8477935,Sam Bennett,C,FLA,28,82,21,22,43
17,8482105,Jake Sanderson,D,OTT,22,82,12,31,43
17,8481546,Cam York,D,PHI,23,82,12,31,43
17,8477986,Brandon Montour,D,FLA,30,82,9,34,43
17,8477948,Travis Sanheim,D,PHI,28,82,8,35,43
17,8477426,Nicholas Paul,L,TBL,29,82,23,19,42
17,8480459,Pius Suter,C,VAN,28,82,21,21,42
17,8482079,Marco Rossi,C,MIN,23,82,21,21,42
17,8480078,Filip Chytil,C,NYR,25,82,20,22,42
17,8480009,Eeli Tolvanen,R,SEA,25,82,18,24,42
17,8474053,Logan Couture,C,SJS,35,82,14,28,42
17,8478472,Mathieu Joseph,R,OTT,27,82,13,29,42
17,8480798,Philipp Kurashev,C,CHI,25,82,13,29,42
17,8477511,Anthony Mantha,R,VGK,30,82,13,29,42
17,8477495,Seth Jones,D,CHI,30,82,9,33,42
17,8475906,John Klingberg,D,TOR,32,82,8,34,42
17,8482097,Jack Quinn,R,BUF,23,82,25,16,41
17,8478057,Dakota Joshua,C,VAN,28,82,21,20,41
17,8483431,Logan Cooley,C,ARI,20,82,20,21,41
17,8478115,Pierre Engvall,L,NYI,28,82,17,24,41
17,8475149,Marcus Johansson,L,MIN,34,82,14,27,41
17,8475760,Nick Bjugstad,C,ARI,32,82,21,19,40
17,8480185,Eetu Luostarinen,C,FLA,26,82,19,21,40
17,8476419,Jean-Gabriel Pageau,C,NYI,32,82,16,24,40
17,8475793,Ryan Johansen,C,PHI,32,82,14,26,40
17,8475151,Kyle Palmieri,C,NYI,33,82,17,22,39
17,8476392,Adam Lowry,C,WPG,31,82,13,26,39
17,8482671,Owen Power,D,BUF,22,82,8,31,39
17,8477500,Bo Horvat,C,NYI,29,82,27,11,38
17,8481554,Kaapo Kakko,R,NYR,23,82,22,16,38
17,8481560,Arthur Kaliyev,R,LAK,23,82,22,16,38
17,8482092,Ridly Greig,C,OTT,22,82,20,18,38
17,8474149,Evgenii Dadonov,R,DAL,35,82,13,25,38
17,8478413,Jordan Greenway,L,BUF,27,82,13,25,38
17,8476885,Jacob Trouba,D,NYR,30,82,10,28,38
17,8477953,Kasperi Kapanen,R,STL,28,82,7,31,38
17,8471218,Blake Wheeler,R,NYR,38,82,21,16,37
17,8475848,Brendan Gallagher,R,MTL,32,82,19,18,37
17,8479365,Trent Frederic,C,BOS,26,82,17,20,37
17,8476981,Josh Anderson,R,MTL,30,82,16,21,37
17,8481618,Alex Newhook,C,MTL,23,82,15,22,37
17,8482222,Alexander Barabanov,L,SJS,30,82,14,23,37
17,8482705,Cole Sillinger,C,CBJ,21,82,14,23,37
17,8482720,Matthew Knies,L,TOR,22,82,12,25,37
17,8480871,Adam Boqvist,D,CBJ,24,82,9,28,37
17,8478882,Vladislav Gavrikov,D,LAK,29,82,9,28,37
17,8476892,Colton Parayko,D,STL,31,82,5,32,37
17,8482089,Jake Neighbours,L,STL,22,82,22,14,36
17,8479415,Michael McLeod,C,NJD,26,82,19,17,36
17,8475714,Calle Jarnkrok,C,TOR,33,82,18,18,36
17,8475343,Nic Dowd,C,WSH,34,82,18,18,36
17,8479353,Brett Howden,C,VGK,26,82,17,19,36
17,8478569,Noel Acciari,C,PIT,33,82,17,19,36
17,8476292,Ondrej Palat,L,NJD,33,82,14,22,36
17,8482117,Lukas Reichel,L,CHI,22,82,14,22,36
17,8480893,Kirill Marchenko,R,CBJ,24,82,14,22,36
17,8476960,Andreas Athanasiou,C,CHI,30,82,12,24,36
17,8480817,K'Andre Miller,D,NYR,24,82,9,27,36
17,8481703,Valtteri Puustinen,R,PIT,25,82,8,28,36
17,8476923,Damon Severson,D,CBJ,30,82,7,29,36
17,8480873,Rasmus Sandin,D,WSH,24,82,6,30,36
17,8479423,Alex Nylander,L,CBJ,26,82,21,14,35
17,8479525,Ross Colton,C,COL,28,82,20,15,35
17,8478109,Victor Olofsson,L,BUF,29,82,19,16,35
17,8481580,Connor McMichael,C,WSH,23,82,17,18,35
17,8479591,Michael Eyssimont,C,TBL,28,82,17,18,35
17,8482055,Drew O'Connor,L,PIT,26,82,16,19,35
17,8470610,Zach Parise,L,COL,40,82,16,19,35
17,8480113,Alex Iafallo,L,WPG,31,82,16,19,35
17,8475220,Marcus Foligno,L,MIN,33,82,17,17,34
17,8480813,Joe Veleno,C,DET,24,82,17,17,34
17,8476278,Colin Blackwell,C,CHI,31,82,17,17,34
17,8478463,Anthony Beauvillier,L,NSH,27,82,16,18,34
17,8479316,Luke Kunin,C,SJS,27,82,16,18,34
17,8475763,Kevin Hayes,R,STL,32,82,15,19,34
17,8480220,Noah Cates,L,PHI,25,82,14,20,34
17,8478046,Danton Heinen,L,BOS,29,82,13,21,34
17,8481656,Aliaksei Protas,C,WSH,23,82,12,22,34
17,8475171,Oliver Ekman-Larsson,D,FLA,33,82,11,23,34
17,8476461,Sean Couturier,C,PHI,32,82,9,25,34
17,8480855,Jack McBain,C,ARI,24,82,9,25,34
17,8477506,Ryan Pulock,D,NYI,30,82,7,27,34
17,8476331,Dylan DeMelo,D,WPG,31,82,6,28,34
17,8474673,TJ Brodie,D,TOR,34,82,6,28,34
17,8481178,Egor Zamula,D,PHI,24,82,5,29,34
17,8481186,Logan O'Connor,R,COL,28,82,19,14,33
17,8480068,Ryan Poehling,C,PHI,25,82,16,17,33
17,8482062,Cole Smith,L,NSH,29,82,16,17,33
17,8477952,Robby Fabbri,C,DET,28,82,15,18,33
17,8475287,Erik Haula,L,NJD,33,82,14,19,33
17,8477425,Miles Wood,L,COL,29,82,12,21,33
17,8483515,Juraj Slafkovsky,L,MTL,20,82,12,21,33
17,8476624,Barclay Goodrow,C,NYR,31,82,11,22,33
17,8474716,Jared Spurgeon,D,MIN,35,82,7,26,33
17,8479976,Juuso Valimaki,D,ARI,26,82,3,30,33
17,8481535,Nils Hoglander,L,VAN,24,82,20,12,32
17,8478020,Michael Amadio,C,VGK,28,82,17,15,32
17,8481028,Martin Pospisil,C,CGY,25,82,15,17,32
17,8480806,Isac Lundestrom,C,ANA,25,82,13,19,32
17,8477435,Ryan Graves,D,PIT,29,82,6,26,32
17,8478851,Alexandre Carrier,D,NSH,28,82,3,29,32
17,8480821,Filip Zadina,R,SJS,25,82,18,13,31
17,8480188,Fabian Zetterlund,L,SJS,25,82,16,15,31
17,8470621,Corey Perry,R,EDM,39,82,15,16,31
17,8477450,Jason Dickinson,C,CHI,29,82,13,18,31
17,8474034,Pat Maroon,L,BOS,36,82,12,19,31
17,8477488,Brett Pesce,D,CAR,30,82,8,23,31
17,8480073,Erik Brannstrom,D,OTT,25,82,6,25,31
17,8479398,Samuel Girard,D,COL,26,82,4,27,31
17,8478840,Will Borgen,D,SEA,28,82,3,28,31
17,8476979,Erik Gustafsson,D,NYR,32,82,3,28,31
17,8474151,Ryan McDonagh,D,NSH,35,82,0,31,31
17,8479390,Taylor Raddysh,R,CHI,26,82,16,14,30
17,8482624,Daniil Miromanov,D,CGY,27,82,16,14,30
17,8479346,Dillon Dube,C,CGY,26,82,15,15,30
17,8477429,Andrew Copp,C,DET,30,82,14,16,30
17,8481604,Pavel Dorofeyev,L,VGK,24,82,13,17,30
17,8478013,Jake Walman,D,DET,28,82,12,18,30
17,8473449,Kyle Okposo,R,FLA,36,82,10,20,30
17,8477015,Connor Brown,R,EDM,30,82,10,20,30
17,8477989,Christian Dvorak,C,MTL,28,82,10,20,30
17,8480336,Sean Walker,D,COL,30,82,9,21,30
17,8473507,Jeff Petry,D,DET,37,82,8,22,30
17,8482655,J.J. Moser,D,ARI,24,82,5,25,30
17,8480043,Timothy Liljegren,D,TOR,25,82,1,29,30
17,8477330,Dominik Kubalik,L,OTT,29,82,16,13,29
17,8479661,Tanner Jeannot,L,TBL,27,82,16,13,29
17,8481704,Juuso Parssinen,C,NSH,23,82,15,14,29
17,8476897,Oskar Sundqvist,C,STL,30,82,14,15,29
17,8476312,Josh Manson,D,COL,33,82,10,19,29
17,8482175,JJ Peterka,R,BUF,22,82,9,20,29
17,8477969,Marcus Pettersson,D,PIT,28,82,5,24,29
17,8478507,John Marino,D,NJD,27,82,3,26,29
17,8474884,Mike Hoffman,C,SJS,35,82,14,14,28
17,8482125,Alexander Holtz,R,NJD,22,82,14,14,28
17,8477947,Sonny Milano,L,WSH,28,82,12,16,28
17,8479383,Boris Katchouk,L,OTT,26,82,12,16,28
17,8476871,Tanner Pearson,L,MTL,32,82,10,18,28
17,8480144,David Kampf,C,TOR,29,82,9,19,28
17,8483490,Pavel Mintyukov,D,ANA,21,82,8,20,28
17,8480035,Henri Jokiharju,D,BUF,25,82,7,21,28
17,8476902,Esa Lindell,D,DAL,30,82,6,22,28
17,8481014,Alexander Romanov,D,NYI,24,82,6,22,28
17,8476463,Jonas Brodin,D,MIN,31,82,5,23,28
17,8478043,Sam Lafferty,C,VAN,29,82,14,13,27
17,8479514,Rem Pitlick,C,CHI,27,82,13,14,27
17,8479351,Sam Steel,C,DAL,26,82,13,14,27
17,8482807,Ethan Del Mastro,D,CHI,21,82,13,14,27
17,8476480,Vladislav Namestnikov,C,WPG,32,82,12,15,27
17,8479393,Noah Gregor,C,TOR,26,82,12,15,27
17,8479977,Kailer Yamamoto,R,SEA,26,82,10,17,27
17,8476921,Jordan Martinook,L,CAR,32,82,8,19,27
17,8482122,Brock Faber,D,MIN,22,82,8,19,27
17,8480995,Pontus Holmberg,R,TOR,25,82,8,19,27
17,8478133,Jake Evans,C,MTL,28,82,7,20,27
17,8479983,Mario Ferraro,D,SJS,26,82,7,20,27
17,8481568,Alex Vlasic,D,CHI,23,82,4,23,27
17,8478136,Jake Middleton,D,MIN,28,82,4,23,27
17,8479998,Mikey Anderson,D,LAK,25,82,3,24,27
17,8478416,Erik Cernak,D,TBL,27,82,2,25,27
17,8479293,Brandon Tanev,L,SEA,33,82,16,10,26
17,8470604,Jeff Carter,C,PIT,39,82,16,10,26
17,8475842,Sam Carrick,C,EDM,32,82,13,13,26
17,8481524,Bowen Byram,D,BUF,23,82,13,13,26
17,8476469,Joel Armia,R,MTL,31,82,11,15,26
17,8481093,Rafael Harvey-Pinard,L,MTL,25,82,11,15,26
17,8477919,Frederick Gaudreau,C,MIN,31,82,11,15,26
17,8484203,Bradly Nadeau,L,CAR,19,82,10,16,26
17,8483468,Jiri Kulich,C,BUF,20,82,10,16,26
17,8475164,Jakob Silfverberg,R,ANA,34,82,8,18,26
17,8476457,Adam Larsson,D,SEA,32,82,4,22,26
17,8482259,Bobby McMann,C,TOR,28,82,15,10,25
17,8474189,Lars Eller,C,PIT,35,82,13,12,25
17,8481477,Nico Sturm,C,SJS,29,82,13,12,25
17,8477944,Jakub Vrana,L,STL,28,82,13,12,25
17,8482111,Justin Barron,D,MTL,23,82,10,15,25
17,8481522,Peyton Krebs,C,BUF,23,82,8,17,25
17,8477406,Mattias Janmark,C,EDM,32,82,8,17,25
17,8475762,Derek Forbort,D,BOS,32,82,8,17,25
17,8478451,Ethan Bear,D,WSH,27,82,7,18,25
17,8482142,Jamie Drysdale,D,PHI,22,82,6,19,25
17,8470966,Mark Giordano,D,TOR,41,82,4,21,25
17,8482245,Artem Zub,D,OTT,29,82,3,22,25
17,8479369,Andrew Peeke,D,BOS,26,82,3,22,25
17,8475324,Nick Jensen,D,WSH,34,82,3,22,25
17,8476873,Mark Jankowski,C,NSH,30,82,16,8,24
17,8484166,Adam Fantilli,C,CBJ,20,82,16,8,24
17,8478508,Yakov Trenin,C,COL,27,82,15,9,24
17,8482074,Connor Zary,C,CGY,23,82,13,11,24
17,8476374,Sean Kuraly,C,CBJ,31,82,12,12,24
17,8477839,Conor Sheary,L,TBL,32,82,11,13,24
17,8483505,Matthew Poitras,C,BOS,20,82,8,16,24
17,8478500,Ivan Provorov,D,CBJ,27,82,7,17,24
17,8474013,Ian Cole,D,VAN,35,82,5,19,24
17,8480807,Mattias Samuelsson,D,BUF,24,82,5,19,24
17,8480796,Martin Fehervary,D,WSH,25,82,3,21,24
17,8480281,Alexey Toropchenko,R,STL,25,82,17,6,23
17,8473533,Jordan Staal,C,CAR,36,82,11,12,23
17,8482133,Thomas Bordeleau,C,SJS,22,82,10,13,23
17,8482702,Logan Stankoven,C,DAL,21,82,10,13,23
17,8482730,Brandt Clarke,D,LAK,21,82,10,13,23
17,8480074,Alexandre Texier,C,CBJ,25,82,8,15,23
17,8477392,Hudson Fasching,R,NYI,29,82,8,15,23
17,8478430,Oliver Kylington,D,CGY,27,82,7,16,23
17,8483445,Cutter Gauthier,L,ANA,20,82,7,16,23
17,8479980,Nicolas Hague,D,VGK,26,82,6,17,23
17,8476931,Jake McCabe,D,TOR,31,82,5,18,23
17,8480246,Nick Perbix,D,TBL,26,82,3,20,23
17,8475790,Erik Gudbranson,D,CBJ,32,82,3,20,23
17,8481059,Scott Perunovich,D,STL,26,82,1,22,23
17,8481517,Brett Leason,R,ANA,25,82,14,8,22
17,8481013,Jonatan Berggren,R,DET,24,82,13,9,22
17,8476878,Zemgus Girgensons,L,BUF,30,82,9,13,22
17,8476442,Matt Nieto,L,PIT,32,82,8,14,22
17,8475825,Jani Hakanpää,D,DAL,32,82,7,15,22
17,8482087,Kaiden Guhle,D,MTL,22,82,6,16,22
17,8475181,Nick Leddy,D,STL,33,82,5,17,22
17,8480990,Declan Chisholm,D,MIN,24,82,5,17,22
17,8475233,David Savard,D,MTL,34,82,3,19,22
17,8480448,Parker Kelly,L,OTT,25,82,12,9,21
17,8483524,Shane Wright,C,SEA,20,82,11,10,21
17,8484153,Leo Carlsson,C,ANA,20,82,10,11,21
17,8484145,Zach Benson,L,BUF,19,82,10,11,21
17,8483499,Liam Ohgren,L,MIN,20,82,7,14,21
17,8483457,Lane Hutson,D,MTL,20,82,6,15,21
17,8478911,Matt Roy,D,LAK,29,82,5,16,21
17,8478859,Niko Mikkola,D,FLA,28,82,5,16,21
17,8470600,Ryan Suter,D,DAL,39,82,4,17,21
17,8475462,Radko Gudas,D,ANA,34,82,4,17,21
17,8475188,Brayden McNabb,D,VGK,33,82,4,17,21
17,8475279,Ben Chiarot,D,DET,33,82,2,19,21
17,8475690,Chris Tanev,D,DAL,35,82,2,19,21
17,8482155,Alex Laferriere,R,LAK,23,82,13,7,20
17,8479941,Justin Danforth,R,CBJ,31,82,12,8,20
17,8482762,Simon Edvinsson,D,DET,21,82,12,8,20
17,8477508,Curtis Lazar,C,NJD,29,82,9,11,20
17,8477353,Tyler Motte,C,TBL,29,82,9,11,20
17,8481537,Nikita Okhotiuk,D,CGY,24,82,7,13,20
17,8482145,Mavrik Bourque,C,DAL,22,82,6,14,20
17,8477507,Nikita Zadorov,D,VAN,29,82,5,15,20
17,8482166,Shakir Mukhamadullin,D,SJS,22,82,5,15,20
17,8476422,Mike Reilly,D,NYI,31,82,5,15,20
17,8481599,Victor Soderstrom,D,ARI,23,82,5,15,20
17,8477365,Connor Clifton,D,BUF,29,82,4,16,20
17,8482858,Ryker Evans,D,SEA,23,82,4,16,20
17,8480879,Jacob Bernard-Docker,D,OTT,24,82,4,16,20
17,8479371,Dante Fabbro,D,NSH,26,82,2,18,20
17,8476915,Jujhar Khaira,L,MIN,30,82,13,6,19
17,8481699,Aku Raty,R,ARI,23,82,6,13,19
17,8476967,Brett Kulak,D,EDM,30,82,6,13,19
17,8478178,Darren Raddysh,D,TBL,28,82,6,13,19
17,8478443,Brandon Carlo,D,BOS,28,82,5,14,19
17,8475208,Brian Dumoulin,D,SEA,33,82,5,14,19
17,8479359,Beck Malenstyn,L,WSH,26,82,5,14,19
17,8477845,Trevor van Riemsdyk,D,WSH,33,82,4,15,19
17,8482470,Ilya Solovyov,D,CGY,24,82,3,16,19
17,8476879,Cody Ceci,D,EDM,31,82,2,17,19
17,8473453,Trevor Lewis,C,LAK,37,82,13,5,18
17,8483493,Frank Nazar,C,CHI,20,82,9,9,18
17,8476822,Luke Glendening,C,TBL,35,82,9,9,18
17,8473504,Cal Clutterbuck,R,NYI,37,82,6,12,18
17,8480834,Ty Emberson,D,SJS,24,82,5,13,18
17,8478468,Jeremy Lauzon,D,NSH,27,82,5,13,18
17,8481553,Bobby Brink,R,PHI,23,82,4,14,18
17,8480058,Pierre-Olivier Joseph,D,PIT,25,82,4,14,18
17,8477220,Nate Schmidt,D,WPG,33,82,3,15,18
17,8475177,Calvin de Haan,D,TBL,33,82,3,15,18
17,8476429,Scott Mayfield,D,NYI,32,82,2,16,18
17,8474574,Tyler Myers,D,VAN,34,82,2,16,18
17,8478399,Jonas Siegenthaler,D,NJD,27,82,1,17,18
17,8482073,Braden Schneider,D,NYR,23,82,1,17,18
17,8479442,Troy Stecher,D,EDM,30,82,9,8,17
17,8483763,Maksymilian Szuber,D,ARI,22,82,8,9,17
17,8476467,Jamie Oleksiak,D,SEA,32,82,7,10,17
17,8482101,Danil Gushchin,L,SJS,22,82,7,10,17
17,8477499,Rasmus Ristolainen,D,PHI,30,82,6,11,17
17,8476917,Adam Pelech,D,NYI,30,82,6,11,17
17,8482733,Logan Mailloux,D,MTL,31,82,6,11,17
17,8483482,Tristan Luneau,D,ANA,20,82,6,11,17
17,8476891,Matt Grzelcyk,D,BOS,30,82,4,13,17
17,8474166,Alec Martinez,D,VGK,37,82,3,14,17
17,8476525,Colin Miller,D,WPG,32,82,1,16,17
17,8479291,Kevin Rooney,C,CGY,31,82,11,5,16
17,8474009,Nick Bonino,C,NYR,36,82,10,6,16
17,8477931,Tomas Nosek,L,NJD,32,82,8,8,16
17,8481606,Jordan Spence,D,LAK,23,82,7,9,16
17,8481481,Blake Lizotte,C,LAK,27,82,6,10,16
17,8482712,Oskar Olausson,R,COL,22,82,6,10,16
17,8483565,Nick Blankenburg,D,CBJ,26,82,4,12,16
17,8475231,Casey Cizikas,C,NYI,33,82,4,12,16
17,8477369,Carson Soucy,D,VAN,30,82,4,12,16
17,8482803,Olen Zellweger,D,ANA,21,82,3,13,16
17,8482118,Sam Colangelo,R,ANA,23,82,3,13,16
17,8481567,Henry Thrun,D,SJS,23,82,3,13,16
17,8480860,Kevin Bahl,D,NJD,24,82,2,14,16
17,8477505,Alexander Wennberg,C,NYR,30,82,10,5,15
17,8478831,Kevin Stenlund,C,FLA,28,82,10,5,15
17,8482666,Scott Morrow,D,CAR,22,82,7,8,15
17,8482737,Zack Bolduc,C,STL,21,82,7,8,15
17,8482713,Mackie Samoskevich,R,FLA,22,82,5,10,15
17,8477034,Jaycob Megna,D,CHI,32,82,5,10,15
17,8483495,Simon Nemec,D,NJD,20,82,2,13,15
17,8475455,Brenden Dillon,D,WPG,34,82,0,15,15
17,8481601,Simon Holmstrom,R,NYI,23,82,10,4,14
17,8483491,Ivan Miroshnichenko,L,WSH,20,82,6,8,14
17,8482809,Jackson Blake,R,CAR,21,82,4,10,14
17,8475179,Dmitry Kulikov,D,FLA,34,82,3,11,14
17,8481030,Jack St. Ivany,D,PIT,25,82,3,11,14
17,8482516,Matthew Kessel,D,STL,24,82,3,11,14
17,8479324,Ryan Lindgren,D,NYR,26,82,2,12,14
17,8480172,Jan Rutta,D,SJS,34,82,2,12,14
17,8484149,Gavin Brindley,C,CBJ,20,82,2,12,14
17,8476858,Phillip Di Giuseppe,L,VAN,31,82,8,5,13
17,8483397,Marc McLaughlin,C,BOS,25,82,8,5,13
17,8478408,Travis Dermott,D,ARI,28,82,6,7,13
17,8482859,Zack Ostapchuk,C,OTT,21,82,5,8,13
17,8483471,Brad Lambert,C,WPG,31,82,5,8,13
17,8480031,Maxime Comtois,L,CAR,25,82,4,9,13
17,8474567,Zach Bogosian,D,MIN,34,82,3,10,13
17,8484911,Collin Graf,R,SJS,22,82,6,6,12
17,8481016,Ruslan Iskhakov,C,NYI,24,82,3,9,12
17,8471677,Jack Johnson,D,COL,37,82,3,9,12
17,8476473,Connor Murphy,D,CHI,31,82,1,11,12
17,8482177,Marat Khusnutdinov,C,MIN,22,82,3,8,11
17,8483012,Logan Morrison,C,SEA,22,82,1,10,11
17,8482679,Matt Coronato,R,CGY,22,82,7,3,10
17,8476372,Nick Seeler,D,PHI,31,82,2,8,10
17,8477335,Kyle Burroughs,D,SJS,29,82,3,5,8
17,8481578,Graeme Clarke,R,NJD,23,82,2,6,8
17,8481605,Jackson LaCombe,D,ANA,23,82,1,7,8
17,8483489,Fraser Minten,C,TOR,31,82,1,7,8
17,8483466,Kevin Korchinski,D,CHI,20,82,2,3,5
17,8477950,Tony DeAngelo,D,CAR,29,0,0,0,0
17,8481577,Philip Tomasino,C,NSH,23,0,0,0,0
17,8482660,Kent Johnson,C,CBJ,22,0,0,0,0
17,8481019,David Gustafsson,C,WPG,24,0,0,0,0
17,8479348,Kale Clague,D,BUF,26,0,0,0,0
17,8482149,Cole Perfetti,C,WPG,22,0,0,0,0
17,8476952,Dominic Toninato,C,WPG,30,0,0,0,0
17,8473473,Milan Lucic,L,BOS,36,0,0,0,0
17,8480829,Jesperi Kotkaniemi,C,CAR,24,0,0,0,0
17,8474602,Justin Schultz,D,SEA,34,0,0,0,0
17,8480049,Dylan Samberg,D,WPG,25,0,0,0,0
17,8479372,Josh Mahura,D,FLA,26,0,0,0,0
17,8480878,Nils Lundkvist,D,DAL,24,0,0,0,0
17,8479982,Conor Timmins,D,TOR,26,0,0,0,0
17,8474031,Kevin Shattenkirk,D,BOS,35,0,0,0,0
17,8480835,Jack Drury,C,CAR,24,0,0,0,0
17,8480008,Adam Ruzicka,C,ARI,25,0,0,0,0
17,8479402,Jake Bean,D,CBJ,26,0,0,0,0
17,8476474,Stefan Noesen,R,CAR,31,0,0,0,0
17,8480884,Calen Addison,D,SJS,24,0,0,0,0
17,8476994,Vinnie Hinostroza,C,PIT,30,0,0,0,0
17,8477987,Ryan Donato,C,CHI,28,0,0,0,0
17,8481582,Nicholas Robertson,L,TOR,23,0,0,0,0
17,8478452,Caleb Jones,D,COL,27,0,0,0,0
17,8480157,Calle Rosen,D,STL,30,0,0,0,0
17,8481609,Vladislav Kolyachonok,D,ARI,23,0,0,0,0
17,8476919,Chris Tierney,C,NJD,30,0,0,0,0
17,8479639,Dylan Coghlan,D,CAR,26,0,0,0,0
17,8475193,Tomas Tatar,L,SEA,34,0,0,0,0
17,8480748,Kiefer Sherwood,L,NSH,29,0,0,0,0
17,8478146,Matthew Highmore,C,OTT,28,0,0,0,0
17,8478970,Jalen Chatfield,D,CAR,28,0,0,0,0
17,8480205,Emil Bemstrom,C,PIT,25,0,0,0,0
17,8471274,Alex Goligoski,D,MIN,39,0,0,0,0
17,8478104,Sammy Blais,L,STL,28,0,0,0,0
17,8476913,Devin Shore,C,SEA,30,0,0,0,0
17,8481708,Zac Jones,D,NYR,24,0,0,0,0
17,8480222,Sebastian Aho,D,NYI,28,0,0,0,0
17,8481598,Philip Broberg,D,EDM,23,0,0,0,0
17,8480789,Oliver Wahlstrom,R,NYI,24,0,0,0,0
17,8480891,Michael Kesselring,D,ARI,24,0,0,0,0
17,8477979,Nicolas Aube-Kubel,R,WSH,28,0,0,0,0
17,8476393,Nick Cousins,C,FLA,31,0,0,0,0
17,8480003,Jesper Boqvist,C,BOS,26,0,0,0,0
17,8479543,Michael Pezzetta,L,MTL,26,0,0,0,0
17,8475855,Jesper Fast,R,CAR,33,0,0,0,0
17,8477018,Ben Hutton,D,VGK,31,0,0,0,0
17,8480762,Eric Robinson,L,BUF,29,0,0,0,0
17,8481058,Jesse Ylönen,R,MTL,25,0,0,0,0
17,8481527,Kaedan Korczak,D,VGK,23,0,0,0,0
17,8482192,Isaak Phillips,D,CHI,23,0,0,0,0
17,8480727,Zach Whitecloud,D,VGK,28,0,0,0,0
17,8480001,Urho Vaakanainen,D,ANA,25,0,0,0,0
17,8480853,Liam Foudy,C,NSH,24,0,0,0,0
17,8475225,Craig Smith,C,DAL,35,0,0,0,0
17,8479972,Mason Shaw,C,MIN,26,0,0,0,0
17,8474040,Sam Gagner,C,EDM,35,0,0,0,0
17,8480196,Jacob Bryson,D,BUF,27,0,0,0,0
17,8475718,Justin Holl,D,DET,32,0,0,0,0
17,8479984,Cal Foote,D,NJD,26,0,0,0,0
17,8480011,Klim Kostin,C,SJS,25,0,0,0,0
17,8482176,Wyatt Kaiser,D,CHI,22,0,0,0,0
17,8476918,Jimmy Vesey,L,NYR,31,0,0,0,0
17,8476988,Matt Benning,D,SJS,30,0,0,0,0
17,8479370,Tyson Jost,C,BUF,26,0,0,0,0
17,8477464,Nic Petan,C,MIN,29,0,0,0,0
17,8477380,Jonny Brodzinski,C,NYR,31,0,0,0,0
17,8480070,Ian Mitchell,D,BOS,25,0,0,0,0
17,8479315,Joey Anderson,R,CHI,26,0,0,0,0
17,8478099,Kevin Labanc,R,SJS,29,0,0,0,0
17,8476874,Olli Maatta,D,DET,30,0,0,0,0
17,8479414,Nathan Bastian,R,NJD,27,0,0,0,0
17,8478434,Keegan Kolesar,R,VGK,27,0,0,0,0
17,8479536,Axel Jonsson-Fjallby,L,WPG,26,0,0,0,0
17,8479671,Mathieu Olivier,R,CBJ,27,0,0,0,0
17,8471709,Marc-Edouard Vlasic,D,SJS,37,0,0,0,0
17,8479328,Julien Gauthier,R,NYI,27,0,0,0,0
17,8478421,A.J. Greer,L,CGY,28,0,0,0,0
17,8477573,Nathan Walker,L,STL,30,0,0,0,0
17,8477478,William Carrier,L,VGK,30,0,0,0,0
17,8479344,Jesse Puljujarvi,R,PIT,26,0,0,0,0
17,8480887,Jordan Harris,D,MTL,24,0,0,0,0
17,8478502,Dennis Gilbert,D,CGY,28,0,0,0,0
17,8480355,Mark Kastelic,C,OTT,25,0,0,0,0
17,8475750,Jon Merrill,D,MIN,32,0,0,0,0
17,8476889,Radek Faksa,C,DAL,30,0,0,0,0
17,8478432,Christian Fischer,R,DET,27,0,0,0,0
17,8479439,Jacob MacDonald,D,SJS,31,0,0,0,0
17,8474568,Luke Schenn,D,NSH,35,0,0,0,0
17,8478454,Noah Juulsen,D,VAN,27,0,0,0,0
17,8475752,Tyler Pitlick,C,NYR,33,0,0,0,0
17,8482148,Hendrix Lapierre,C,WSH,22,0,0,0,0
17,8481167,Brayden Pachal,D,CGY,25,0,0,0,0
17,8478211,Dryden Hunt,L,CGY,29,0,0,0,0
17,8479321,Lucas Johansen,D,WSH,27,0,0,0,0
17,8480950,Ilya Lyubushkin,D,TOR,30,0,0,0,0
17,8479368,Max Jones,L,ANA,26,0,0,0,0
17,8471699,Andrew Cogliano,C,COL,37,0,0,0,0
17,8481521,Ronnie Attard,D,PHI,25,0,0,0,0
17,8481161,Jake Christiansen,D,CBJ,25,0,0,0,0
17,8479458,Nikita Zaitsev,D,CHI,33,0,0,0,0
17,8479619,Michael Carcone,L,ARI,28,0,0,0,0
17,8479026,Philippe Myers,D,TBL,27,0,0,0,0
17,8481617,Vasily Podkolzin,R,VAN,23,0,0,0,0
17,8481701,Santeri Hatakka,D,NJD,23,0,0,0,0
17,8477446,Michael McCarron,R,NSH,29,0,0,0,0
17,8483460,David Jiricek,D,CBJ,21,0,0,0,0
17,8474090,Brendan Smith,D,NJD,35,0,0,0,0
17,8482241,Radim Zohorna,L,PIT,28,0,0,0,0
17,8481032,Paul Cotter,C,VGK,25,0,0,0,0
17,8480289,Morgan Barron,C,WPG,26,0,0,0,0
17,8479379,Givani Smith,R,SJS,26,0,0,0,0
17,8480216,Jacob Peterson,C,SJS,25,0,0,0,0
17,8477851,Jordan Oesterle,D,CGY,32,0,0,0,0
17,8484258,Sam Malinski,D,COL,26,0,0,0,0
17,8478904,Steven Lorentz,C,FLA,28,0,0,0,0
17,8482095,Tyler Kleven,D,OTT,22,0,0,0,0
17,8480980,Connor Dewar,C,TOR,25,0,0,0,0
17,8480848,Ty Dellandrea,C,DAL,24,0,0,0,0
17,8476884,Derrick Pouliot,D,DAL,30,0,0,0,0
17,8480025,MacKenzie Entwistle,R,CHI,25,0,0,0,0
17,8474612,Travis Hamonic,D,OTT,34,0,0,0,0
17,8479336,Carl Grundstrom,R,LAK,27,0,0,0,0
17,8482964,Arber Xhekaj,D,MTL,23,0,0,0,0
17,8471686,Marc Staal,D,PHI,37,0,0,0,0
17,8477887,Patrick Brown,C,BOS,32,0,0,0,0
17,8478495,Denis Gurianov,R,PHI,27,0,0,0,0
17,8481550,Adam Beckman,L,MIN,23,0,0,0,0
17,8480845,Rasmus Kupari,C,WPG,24,0,0,0,0
17,8478585,Derek Ryan,C,EDM,38,0,0,0,0
17,8482141,Lukas Cormier,D,VGK,22,0,0,0,0
17,8477962,Brendan Lemieux,L,CAR,28,0,0,0,0
17,8482861,Vincent Iorio,D,WSH,22,0,0,0,0
17,8479378,Logan Stanley,D,WPG,26,0,0,0,0
17,8473446,Erik Johnson,D,PHI,36,0,0,0,0
17,8481743,Marc Del Gaizo,D,NSH,25,0,0,0,0
17,8478450,Parker Wotherspoon,D,BOS,27,0,0,0,0
17,8477384,Josh Brown,D,ARI,30,0,0,0,0
17,8482165,Yan Kuznetsov,D,CGY,22,0,0,0,0
17,8478424,Jansen Harkins,C,PIT,27,0,0,0,0
17,8482144,Jack Thompson,D,SJS,22,0,0,0,0
17,8479576,Vincent Desharnais,D,EDM,28,0,0,0,0
17,8478512,Austin Czarnik,C,DET,32,0,0,0,0
17,8477527,Ross Johnston,L,ANA,30,0,0,0,0
17,8482094,Daemon Hunt,D,MIN,22,0,0,0,0
17,8481719,Maxwell Crozier,D,TBL,24,0,0,0,0
17,8480192,Johnathan Kovacevic,D,MTL,27,0,0,0,0
17,8479376,Victor Mete,D,PHI,26,0,0,0,0
17,8482511,Mason Lohrei,D,BOS,23,0,0,0,0
17,8478021,William Lagesson,D,ANA,28,0,0,0,0
17,8475795,Dylan McIlrath,D,WSH,32,0,0,0,0
17,8477846,Ryan Carpenter,C,SJS,33,0,0,0,0
17,8481056,Spencer Stastney,D,NSH,24,0,0,0,0
17,8481564,Ryan Johnson,D,BUF,23,0,0,0,0
17,8478017,Mark Friedman,D,VAN,29,0,0,0,0
17,8479320,Max Lajoie,D,TOR,27,0,0,0,0
17,8480075,Cameron Crotty,D,ARI,25,0,0,0,0
17,8484287,Cole McWard,D,VAN,23,0,0,0,0
17,8484254,Akito Hirose,D,VAN,25,0,0,0,0
17,8483407,Brandon Scanlin,D,NYR,25,0,0,0,0
17,8480274,Philip Kemp,D,EDM,25,0,0,0,0
17,8479522,Hardy Haman Aktell,D,WSH,26,0,0,0,0
17,8480007,Jonas Rondbjerg,R,VGK,25,0,0,0,0
17,8477454,Adam Erne,L,EDM,29,0,0,0,0
17,8481679,Maxence Guenette,D,OTT,23,0,0,0,0
17,8477938,Haydn Fleury,D,TBL,28,0,0,0,0
17,8476441,Joel Edmundson,D,TOR,31,0,0,0,0
17,8477903,Garnet Hathaway,R,PHI,33,0,0,0,0
17,8480441,Trey Fix-Wolansky,R,CBJ,25,0,0,0,0
17,8483546,Marshall Rifai,D,TOR,26,0,0,0,0
17,8480084,Nick DeSimone,D,NJD,30,0,0,0,0
17,8481592,Jakob Pelletier,L,CGY,23,0,0,0,0
17,8478011,Louie Belpedio,D,PHI,28,0,0,0,0
17,8477930,Pierre-Edouard Bellemare,L,SEA,39,0,0,0,0
17,8484321,Nikolas Matinpalo,D,OTT,26,0,0,0,0
17,8482067,Connor Mackey,D,NYR,28,0,0,0,0
17,8481806,Louis Crevier,D,CHI,23,0,0,0,0
17,8484326,Patrik Koch,D,ARI,28,0,0,0,0
17,8477971,Andreas Englund,D,LAK,28,0,0,0,0
17,8481751,Lukas Rousek,R,BUF,25,0,0,0,0
17,8481006,Tyler Tucker,D,STL,24,0,0,0,0
17,8481641,Joel Kiviranta,L,COL,28,0,0,0,0
17,8476867,Brendan Gaunce,C,CBJ,30,0,0,0,0
17,8479520,Brandon Duhaime,R,COL,27,0,0,0,0
17,8477073,Kurtis MacDermid,L,NJD,30,0,0,0,0
17,8480874,Adam Ginning,D,PHI,24,0,0,0,0
17,8477473,Justin Bailey,R,SJS,29,0,0,0,0
17,8479066,Ryan Lomberg,L,FLA,30,0,0,0,0
17,8477070,Liam O'Brien,C,ARI,30,0,0,0,0
17,8474618,Marco Scandella,D,STL,34,0,0,0,0
17,8475797,Jarred Tinordi,D,CHI,32,0,0,0,0
17,8481441,Joe Snively,C,WSH,28,0,0,0,0
17,8477244,Chad Ruhwedel,D,NYR,34,0,0,0,0
17,8482077,Dylan Holloway,L,EDM,23,0,0,0,0
17,8479772,Zack MacEwen,R,OTT,28,0,0,0,0
17,8481147,Reese Johnson,C,CHI,26,0,0,0,0
17,8481043,Cole Koepke,L,TBL,26,0,0,0,0
17,8483619,Filip Roos,D,CHI,25,0,0,0,0
17,8481541,Samuel Bolduc,D,NYI,24,0,0,0,0
17,8477810,Joel Hanley,D,CGY,33,0,0,0,0
17,8476907,Mackenzie MacEachern,L,STL,30,0,0,0,0
17,8482652,Walker Duehr,R,CGY,27,0,0,0,0
17,8477126,Jayson Megna,C,BOS,34,0,0,0,0
17,8483398,Declan Carlile,D,TBL,31,0,0,0,0
17,8482929,Emil Lilleberg,D,TBL,23,0,0,0,0
17,8480880,Jakub Lauko,C,BOS,24,0,0,0,0
17,8478874,Adam Gaudette,C,STL,28,0,0,0,0
17,8480245,Olle Lycksell,R,PHI,25,0,0,0,0
17,8480252,Cole Guttman,C,CHI,25,0,0,0,0
17,8477467,Gustav Olofsson,D,SEA,30,0,0,0,0
17,8479968,Vinni Lettieri,C,MIN,29,0,0,0,0
17,8478400,Colin White,C,MTL,27,0,0,0,0
17,8475755,Alexander Petrovic,D,DAL,32,0,0,0,0
17,8481812,Nikolai Knyzhov,D,SJS,27,0,0,0,0
17,8481593,Jayden Struble,D,MTL,23,0,0,0,0
17,8481532,Alex Turcotte,C,LAK,23,0,0,0,0
17,8482126,Emil Andrae,D,PHI,31,0,0,0,0
17,8479944,Zach Aston-Reese,C,DET,30,0,0,0,0
17,8471817,Ryan Reaves,R,TOR,37,0,0,0,0
17,8481206,John Ludvig,D,PIT,24,0,0,0,0
17,8480292,Carson Meyer,R,CBJ,27,0,0,0,0
17,8482496,Nils Aman,C,VAN,24,0,0,0,0
17,8479718,Alex Barré-Boulet,C,TBL,27,0,0,0,0
17,8479994,Jaret Anderson-Dolan,C,NSH,25,0,0,0,0
17,8480184,Gustav Lindstrom,D,ANA,26,0,0,0,0
17,8480890,Jan Jenik,R,ARI,24,0,0,0,0
17,8478067,Oskar Lindblom,L,SJS,28,0,0,0,0
17,8476934,Brock McGinn,L,ANA,30,0,0,0,0
17,8479985,Cale Fleury,D,SEA,26,0,0,0,0
17,8482153,Brendan Brisson,C,VGK,23,0,0,0,0
17,8480021,Jack Studnicka,C,SJS,25,0,0,0,0
17,8484304,Uvis Balinskis,D,FLA,28,0,0,0,0
17,8479981,Jonah Gadjovich,L,FLA,26,0,0,0,0
17,8481716,Dmitri Voronkov,L,CBJ,24,0,0,0,0
17,8482659,Josh Doan,R,ARI,22,0,0,0,0
17,8481122,Simon Benoit,D,TOR,26,0,0,0,0
17,8474709,Matt Martin,L,NYI,35,0,0,0,0
17,8482634,Alex Steeves,C,TOR,25,0,0,0,0
17,8480823,Alexander Alexeyev,D,WSH,25,0,0,0,0
17,8477541,Dakota Mermis,D,MIN,30,0,0,0,0
17,8478477,Mitchell Stephens,C,MTL,27,0,0,0,0
17,8481543,Nikita Alexandrov,C,STL,24,0,0,0,0
17,8482451,Mikael Pyyhtia,L,CBJ,23,0,0,0,0
17,8480306,Grant Hutton,D,NYI,29,0,0,0,0
17,8478028,Fredrik Olofsson,L,COL,28,0,0,0,0
17,8477462,Robert Hagg,D,ANA,29,0,0,0,0
17,8477320,Anton Blidh,L,NYR,29,0,0,0,0
17,8482749,Joshua Roy,R,MTL,21,0,0,0,0
17,8482157,Will Cuylle,L,NYR,22,0,0,0,0
17,8481239,Samuel Fagemo,L,LAK,24,0,0,0,0
17,8481600,Tobias Bjornfot,D,FLA,23,0,0,0,0
17,8478409,Anthony Richard,C,BOS,28,0,0,0,0
17,8474145,Robert Bortuzzo,D,NYI,35,0,0,0,0
17,8475958,Michael Sgarbossa,C,WSH,32,0,0,0,0
17,8479986,Kole Lind,R,SEA,26,0,0,0,0
17,8479249,Andrew Poturalski,C,SEA,30,0,0,0,0
17,8479362,Riley Tufte,L,COL,26,0,0,0,0
17,8479991,Jake Leschyshyn,C,NYR,25,0,0,0,0
17,8479587,Rhett Gardner,C,PHI,28,0,0,0,0
17,8482744,James Malatesta,L,CBJ,21,0,0,0,0
17,8478854,Ryan Shea,D,PIT,27,0,0,0,0
17,8481591,Sam Poulin,R,PIT,23,0,0,0,0
17,8483512,Matt Savoie,C,BUF,20,0,0,0,0
17,8482102,Vasily Ponomarev,C,CAR,22,0,0,0,0
17,8482162,Roby Jarventie,L,OTT,22,0,0,0,0
17,8482172,Landon Slaggert,L,CHI,22,0,0,0,0
17,8482747,Brennan Othmann,L,NYR,21,0,0,0,0
17,8480226,Marián Studenic,R,SEA,26,0,0,0,0
17,8481518,Nolan Foote,L,NJD,24,0,0,0,0
17,8479419,Brett Murray,L,BUF,26,0,0,0,0
17,8482088,Justin Sourdif,R,FLA,22,0,0,0,0
17,8482201,Gage Goncalves,C,TBL,23,0,0,0,0
17,8481754,Nikita Nesterenko,C,ANA,23,0,0,0,0
17,8483531,Brian Halonen,L,NJD,25,0,0,0,0
17,8483920,Pierrick Dube,R,WSH,23,0,0,0,0
17,8480851,Akil Thomas,C,LAK,24,0,0,0,0
17,8475235,Nicolas Deslauriers,L,PHI,33,0,0,0,0
17,8482476,Emil Heineman,L,MTL,23,0,0,0,0
17,8477149,Scott Sabourin,R,SJS,32,0,0,0,0
17,8483549,Lucas Condotta,L,MTL,27,0,0,0,0
17,8483567,Georgii Merkulov,C,BOS,24,0,0,0,0
17,8482765,Isak Rosen,R,BUF,21,0,0,0,0
17,8481237,Kyle MacLean,C,NYI,25,0,0,0,0
17,8481024,Linus Karlsson,C,VAN,25,0,0,0,0
17,8481690,Tyler Angle,C,CBJ,24,0,0,0,0
17,8483570,Ben Meyers,C,ANA,26,0,0,0,0
17,8481655,Cole Schwindt,R,CGY,23,0,0,0,0
17,8481462,Mason Morelli,L,VGK,28,0,0,0,0
17,8483401,Marc Johnstone,R,PIT,28,0,0,0,0
17,8478956,Samuel Laberge,L,NJD,27,0,0,0,0
17,8479533,Joona Koppanen,L,PIT,26,0,0,0,0
17,8482197,Adam Raska,R,MIN,23,0,0,0,0
17,8482250,Callahan Burke,C,CAR,27,0,0,0,0
17,8482784,Zach Dean,C,STL,21,0,0,0,0
17,8484255,Jason Polin,R,COL,25,0,0,0,0
17,8481077,John Leonard,L,ARI,26,0,0,0,0
17,8481534,Raphael Lavoie,C,EDM,24,0,0,0,0
17,8483609,Adam Klapka,R,CGY,24,0,0,0,0
17,8482751,Ryan Winterton,C,SEA,21,0,0,0,0
17,8480267,Sammy Walker,C,MIN,25,0,0,0,0
17,8475766,Austin Watson,L,TBL,32,0,0,0,0
17,8482460,Matt Rempe,C,NYR,22,0,0,0,0
17,8482787,Nikita Chibrikov,R,WPG,31,0,0,0,0
17,8481065,Angus Crookshank,L,OTT,25,0,0,0,0
17,8481070,Hugh McGing,L,STL,26,0,0,0,0
17,8476323,Max McCormick,L,SEA,32,0,0,0,0
17,8483395,Arshdeep Bains,L,VAN,23,0,0,0,0
17,8484259,Ondrej Pavel,C,COL,31,0,0,0,0
17,8483432,Luca Del Bel Belluz,C,CBJ,31,0,0,0,0
17,8483045,Cameron Butler,R,CBJ,31,0,0,0,0
17,8482061,Brandon Biro,L,BUF,26,0,0,0,0
17,8477401,John Hayden,C,SEA,29,0,0,0,0
17,8475278,Byron Froese,C,VGK,33,0,0,0,0
17,8478446,Glenn Gawdin,C,ANA,27,0,0,0,0
17,8477993,Justin Kirkland,C,ARI,28,0,0,0,0
17,8482147,Jean-Luc Foudy,C,COL,22,0,0,0,0
17,8480032,Shane Bowers,C,NJD,25,0,0,0,0
17,8479330,Brandon Gignac,C,MTL,27,0,0,0,0
17,8480776,Sheldon Rempal,R,VGK,29,0,0,0,0
17,8475413,Justin Dowling,C,NJD,34,0,0,0,0
17,8481726,Adam Edstrom,C,NYR,24,0,0,0,0
17,8479638,Justin Brazeau,R,BOS,26,0,0,0,0
17,8480844,Grigori Denisenko,L,VGK,24,0,0,0,0
17,8474062,Riley Nash,C,NYR,35,0,0,0,0
17,8478147,Bokondji Imama,L,OTT,28,0,0,0,0
17,8478881,Brett Seney,L,CHI,28,0,0,0,0
17,8483630,Pavol Regenda,L,ANA,25,0,0,0,0
17,8480836,Jonathan Gruden,C,PIT,24,0,0,0,0
17,8484314,Jiri Smejkal,L,OTT,28,0,0,0,0
17,8475780,Chris Wagner,R,COL,33,0,0,0,0
17,8482070,Mitchell Chaffee,R,TBL,26,0,0,0,0
17,8479546,Oskar Steen,C,BOS,26,0,0,0,0
17,8483597,Milos Kelemen,L,ARI,25,0,0,0,0
17,8481789,Tye Kartye,L,SEA,23,0,0,0,0
17,8484325,Waltteri Merela,C,TBL,26,0,0,0,0
17,8479421,Jacob Moverare,D,LAK,26,0,0,0,0
17,8481585,Egor Afanasyev,L,NSH,23,0,0,0,0
17,8479547,Matthew Phillips,R,WSH,26,0,0,0,0
17,8479367,William Lockwood,R,FLA,26,0,0,0,0
17,8481422,Jacob Lucchini,C,MIN,29,0,0,0,0
17,8480468,James Hamblin,L,EDM,25,0,0,0,0
17,8480870,Bo Groulx,C,ANA,24,0,0,0,0
17,8478051,Max Willman,C,NJD,29,0,0,0,0
17,8481556,John Beecher,C,BOS,23,0,0,0,0
17,8478078,Rourke Chartier,C,OTT,28,0,0,0,0
18,8476453,Nikita Kucherov,R,TBL,31,82,58,93,151
18,8478402,Connor McDavid,C,EDM,27,82,44,101,145
18,8477492,Nathan MacKinnon,C,COL,29,82,58,77,135
18,8477934,Leon Draisaitl,C,EDM,29,82,56,78,134
18,8478864,Kirill Kaprizov,L,MIN,27,82,51,64,115
18,8477956,David Pastrnak,R,BOS,28,82,54,56,110
18,8480027,Jason Robertson,L,DAL,25,82,36,74,110
18,8479318,Auston Matthews,C,TOR,27,82,54,54,108
18,8481559,Jack Hughes,C,NJD,23,82,46,59,105
18,8477939,William Nylander,R,TOR,28,82,47,52,99
18,8474600,Roman Josi,D,NSH,34,82,30,68,98
18,8480800,Quinn Hughes,D,VAN,25,82,23,75,98
18,8478550,Artemi Panarin,L,NYR,33,82,38,59,97
18,8476887,Filip Forsberg,L,NSH,30,82,51,45,96
18,8478420,Mikko Rantanen,R,COL,28,82,49,47,96
18,8478010,Brayden Point,C,TBL,28,82,37,59,96
18,8476468,J.T. Miller,C,VAN,31,82,31,65,96
18,8471675,Sidney Crosby,C,PIT,37,82,37,57,94
18,8477493,Aleksander Barkov,C,FLA,29,82,30,64,94
18,8479314,Matthew Tkachuk,L,FLA,27,82,34,59,93
18,8474564,Steven Stamkos,C,TBL,34,82,38,54,92
18,8477404,Jake Guentzel,C,CAR,30,82,40,51,91
18,8476454,Ryan Nugent-Hopkins,C,EDM,31,82,32,59,91
18,8482116,Tim Stützle,C,OTT,22,82,29,61,90
18,8480801,Brady Tkachuk,L,OTT,25,82,37,50,87
18,8475172,Nazem Kadri,C,CGY,34,82,36,51,87
18,8480002,Nico Hischier,C,NJD,25,82,33,54,87
18,8480012,Elias Pettersson,C,VAN,26,82,33,53,86
18,8477942,Kevin Fiala,L,LAK,28,82,33,52,85
18,8478445,Mathew Barzal,C,NYI,27,82,19,66,85
18,8475754,Brock Nelson,C,NYI,33,82,42,42,84
18,8478403,Jack Eichel,C,VGK,28,82,38,46,84
18,8480036,Miro Heiskanen,D,DAL,25,82,23,61,84
18,8479542,Brandon Hagel,L,TBL,26,82,38,45,83
18,8476346,Johnny Gaudreau,L,CBJ,31,82,23,59,82
18,8478398,Kyle Connor,L,WPG,28,82,44,37,81
18,8477501,Valeri Nichushkin,R,COL,29,82,30,51,81
18,8480803,Evan Bouchard,D,EDM,25,82,18,63,81
18,8480865,Noah Dobson,D,NYI,24,82,8,73,81
18,8479420,Tage Thompson,C,BUF,27,82,43,37,80
18,8478427,Sebastian Aho,C,CAR,27,82,28,52,80
18,8479323,Adam Fox,D,NYR,26,82,14,66,80
18,8476389,Vincent Trocheck,C,NYR,31,82,37,42,79
18,8477409,Carter Verhaeghe,C,FLA,29,82,34,45,79
18,8477946,Dylan Larkin,C,DET,28,82,33,46,79
18,8475167,Victor Hedman,D,TBL,34,82,14,65,79
18,8478449,Roope Hintz,C,DAL,28,82,39,39,78
18,8475786,Zach Hyman,L,EDM,32,82,37,41,78
18,8477940,Nikolaj Ehlers,L,WPG,28,82,28,50,78
18,8476460,Mark Scheifele,C,WPG,31,82,27,51,78
18,8475810,Bryan Rust,R,PIT,32,82,42,35,77
18,8475913,Mark Stone,R,VGK,32,82,27,50,77
18,8477951,Nick Schmaltz,C,ARI,28,82,25,52,77
18,8479407,Jesper Bratt,L,NJD,26,82,24,53,77
18,8475168,Matt Duchene,C,DAL,33,82,38,38,76
18,8478439,Travis Konecny,R,PHI,27,82,36,40,76
18,8479343,Clayton Keller,R,ARI,26,82,31,45,76
18,8473419,Brad Marchand,L,BOS,36,82,29,47,76
18,8480208,Drake Batherson,R,OTT,26,82,29,47,76
18,8479337,Alex DeBrincat,R,DET,27,82,34,41,75
18,8476459,Mika Zibanejad,C,NYR,31,82,33,42,75
18,8476875,Mike Matheson,D,MTL,30,82,18,57,75
18,8475784,Jeff Skinner,C,BUF,32,82,34,40,74
18,8475184,Chris Kreider,L,NYR,33,82,37,36,73
18,8481557,Matt Boldy,L,MIN,23,82,34,39,73
18,8477402,Pavel Buchnevich,L,STL,29,82,30,43,73
18,8480023,Robert Thomas,C,STL,25,82,20,53,73
18,8475692,Mats Zuccarello,R,MIN,37,82,20,53,73
18,8480069,Cale Makar,D,COL,26,82,16,57,73
18,8480839,Rasmus Dahlin,D,BUF,24,82,18,54,72
18,8476456,Jonathan Huberdeau,C,CGY,31,82,12,60,72
18,8477933,Sam Reinhart,C,FLA,29,82,37,34,71
18,8477504,Josh Morrissey,D,WPG,29,82,8,63,71
18,8478042,Viktor Arvidsson,R,LAK,31,82,31,39,70
18,8475166,John Tavares,C,TOR,34,82,27,43,70
18,8477949,Alex Tuch,R,BUF,28,82,24,46,70
18,8479675,Trevor Moore,L,LAK,29,82,34,35,69
18,8481540,Cole Caufield,R,MTL,23,82,33,36,69
18,8474141,Patrick Kane,R,DET,36,82,29,40,69
18,8475726,Tyler Toffoli,C,WPG,32,82,29,40,69
18,8474679,Gustav Nyquist,C,NSH,35,82,18,51,69
18,8477494,Jonathan Drouin,L,COL,29,82,26,42,68
18,8480018,Nick Suzuki,C,MTL,25,82,24,44,68
18,8471685,Anze Kopitar,C,LAK,37,82,22,46,68
18,8481528,Dylan Cozens,C,BUF,23,82,21,47,68
18,8476853,Morgan Rielly,D,TOR,30,82,14,54,68
18,8474641,Adam Henrique,C,EDM,34,82,34,33,67
18,8470794,Joe Pavelski,C,DAL,40,82,30,37,67
18,8478444,Brock Boeser,R,VAN,27,82,26,41,67
18,8478047,Michael Bunting,L,PIT,29,82,25,42,67
18,8471214,Alex Ovechkin,L,WSH,39,82,32,33,65
18,8471215,Evgeni Malkin,C,PIT,38,82,26,39,65
18,8478460,Zach Werenski,D,CBJ,27,82,19,46,65
18,8477416,Oliver Bjorkstrand,R,SEA,29,82,30,34,64
18,8477496,Elias Lindholm,C,VAN,30,82,26,38,64
18,8480830,Andrei Svechnikov,R,CAR,24,82,25,39,64
18,8473512,Claude Giroux,R,OTT,36,82,18,46,64
18,8479325,Charlie McAvoy,D,BOS,27,82,14,50,64
18,8479410,Mikhail Sergachev,D,TBL,26,82,14,50,64
18,8479339,Patrik Laine,L,CBJ,26,82,36,27,63
18,8475169,Evander Kane,L,EDM,33,82,35,28,63
18,8476539,Jonathan Marchessault,R,VGK,34,82,34,29,63
18,8475794,Tyler Seguin,C,DAL,32,82,29,34,63
18,8482078,Lucas Raymond,L,DET,22,82,23,40,63
18,8478440,Dylan Strome,C,WSH,27,82,21,42,63
18,8478975,Mason Marchment,L,DAL,29,82,21,42,63
18,8482097,Jack Quinn,R,BUF,23,82,21,42,63
18,8478873,Troy Terry,R,ANA,27,82,26,36,62
18,8473994,Jamie Benn,L,DAL,35,82,24,38,62
18,8478407,Vince Dunn,D,SEA,28,82,16,46,62
18,8480078,Filip Chytil,C,NYR,25,82,27,34,61
18,8482665,Matty Beniers,C,SEA,22,82,23,38,61
18,8478401,Pavel Zacha,C,BOS,27,82,22,39,61
18,8475191,Reilly Smith,R,PIT,33,82,20,41,61
18,8474563,Drew Doughty,D,LAK,35,82,13,48,61
18,8475798,Mikael Granlund,C,SJS,32,82,12,49,61
18,8478414,Timo Meier,R,NJD,28,82,32,28,60
18,8478493,Joel Eriksson Ek,C,MIN,27,82,32,28,60
18,8481068,Yegor Sharangovich,C,CGY,26,82,29,31,60
18,8479385,Jordan Kyrou,C,STL,26,82,27,33,60
18,8478856,Conor Garland,R,VAN,28,82,27,33,60
18,8475170,Brayden Schenn,C,STL,33,82,26,34,60
18,8475158,Ryan O'Reilly,C,NSH,33,82,25,35,60
18,8474102,David Perron,L,DET,36,82,25,35,60
18,8475765,Vladimir Tarasenko,R,FLA,33,82,18,42,60
18,8478038,Devon Toews,D,COL,30,82,15,45,60
18,8474578,Erik Karlsson,D,PIT,34,82,12,48,60
18,8481523,Kirby Dach,C,MTL,23,82,10,50,60
18,8481618,Alex Newhook,C,MTL,23,82,24,35,59
18,8480014,Gabriel Vilardi,C,WPG,25,82,36,22,58
18,8481533,Trevor Zegras,C,ANA,23,82,23,35,58
18,8482667,William Eklund,L,SJS,22,82,20,38,58
18,8482093,Seth Jarvis,C,CAR,22,82,26,31,57
18,8477960,Adrian Kempe,R,LAK,28,82,23,34,57
18,8480039,Martin Necas,C,CAR,25,82,20,37,57
18,8482159,Tyson Foerster,R,PHI,22,82,24,32,56
18,8476882,Teuvo Teravainen,L,CAR,30,82,19,37,56
18,8480028,Morgan Frost,C,PHI,25,82,19,37,56
18,8476432,Boone Jenner,C,CBJ,31,82,30,25,55
18,8476881,Tomas Hertl,C,VGK,31,82,29,26,55
18,8475722,Jason Zucker,L,NSH,32,82,29,26,55
18,8477456,J.T. Compher,L,DET,29,82,27,28,55
18,8475287,Erik Haula,L,NJD,33,82,17,38,55
18,8477444,Andre Burakovsky,L,SEA,29,82,16,39,55
18,8479999,Casey Mittelstadt,C,COL,26,82,15,40,55
18,8478474,Lawson Crouse,L,ARI,27,82,28,26,54
18,8475151,Kyle Palmieri,C,NYI,33,82,28,26,54
18,8481596,Shane Pinto,C,OTT,24,82,26,28,54
18,8482175,JJ Peterka,R,BUF,22,82,26,28,54
18,8477500,Bo Horvat,C,NYI,29,82,23,31,54
18,8477955,Jared McCann,L,SEA,28,82,21,33,54
18,8476462,Dougie Hamilton,D,NJD,31,82,15,39,54
18,8479400,Pierre-Luc Dubois,L,LAK,26,82,25,28,53
18,8476826,Yanni Gourde,C,SEA,33,82,23,30,53
18,8482671,Owen Power,D,BUF,22,82,18,35,53
18,8478438,Tommy Novak,C,NSH,27,82,14,39,53
18,8474565,Alex Pietrangelo,D,VGK,34,82,11,42,53
18,8471724,Kris Letang,D,PIT,37,82,10,43,53
18,8481542,Moritz Seider,D,DET,23,82,8,45,53
18,8482109,Alexis Lafrenière,L,NYR,23,82,27,25,52
18,8476438,Brandon Saad,L,STL,32,82,27,25,52
18,8482745,Mason McTavish,C,ANA,21,82,26,26,52
18,8481711,Matias Maccelli,L,ARI,24,82,18,34,52
18,8478469,Thomas Chabot,D,OTT,27,82,17,35,52
18,8477447,Shea Theodore,D,VGK,29,82,5,47,52
18,8480015,Owen Tippett,R,PHI,25,82,27,24,51
18,8477476,Artturi Lehkonen,L,COL,29,82,26,25,51
18,8482740,Wyatt Johnston,C,DAL,21,82,24,27,51
18,8479345,Jakob Chychrun,D,OTT,26,82,21,30,51
18,8477935,Sam Bennett,C,FLA,28,82,20,31,51
18,8476792,Torey Krug,D,STL,33,82,13,38,51
18,8482110,Dawson Mercer,C,NJD,23,82,29,21,50
18,8482124,Quinton Byfield,R,LAK,22,82,23,27,50
18,8480797,Joel Farabee,L,PHI,24,82,21,29,50
18,8476392,Adam Lowry,C,WPG,31,82,20,30,50
18,8477451,Ryan Hartman,R,MIN,30,82,19,31,50
18,8474590,John Carlson,D,WSH,34,82,11,39,50
18,8478055,Gustav Forsling,D,FLA,28,82,10,40,50
18,8477479,Tyler Bertuzzi,L,TOR,29,82,26,23,49
18,8478519,Anthony Cirelli,C,TBL,27,82,24,25,49
18,8479525,Ross Colton,C,COL,28,82,23,26,49
18,8480188,Fabian Zetterlund,L,SJS,25,82,23,26,49
18,8475745,Charlie Coyle,C,BOS,32,82,18,31,49
18,8474157,Max Pacioretty,L,WSH,36,82,17,32,49
18,8479987,Morgan Geekie,C,BOS,26,82,17,32,49
18,8478466,Daniel Sprong,R,DET,27,82,15,34,49
18,8477503,Max Domi,C,TOR,29,82,15,34,49
18,8478396,Noah Hanifin,D,VGK,27,82,12,37,49
18,8482684,Luke Hughes,D,NJD,21,82,12,37,49
18,8479425,Filip Hronek,D,VAN,27,82,12,37,49
18,8476880,Tom Wilson,R,WSH,30,82,28,20,48
18,8475760,Nick Bjugstad,C,ARI,32,82,28,20,48
18,8478057,Dakota Joshua,C,VAN,28,82,26,22,48
18,8478542,Evan Rodrigues,C,FLA,31,82,23,25,48
18,8473986,Alex Killorn,L,ANA,35,82,22,26,48
18,8477998,Warren Foegele,L,EDM,28,82,21,27,48
18,8477407,Anthony Duclair,L,TBL,29,82,21,27,48
18,8483808,Andrei Kuzmenko,L,CGY,28,82,19,29,48
18,8474053,Logan Couture,C,SJS,35,82,18,30,48
18,8477429,Andrew Copp,C,DET,30,82,15,33,48
18,8476869,Brady Skjei,D,CAR,30,82,14,34,48
18,8476905,Chandler Stephenson,C,VGK,30,82,13,35,48
18,8477495,Seth Jones,D,CHI,30,82,11,37,48
18,8476927,Teddy Blueger,C,VAN,30,82,20,27,47
18,8478472,Mathieu Joseph,R,OTT,27,82,17,30,47
18,8476458,Ryan Strome,C,ANA,31,82,15,32,47
18,8476872,Scott Laughton,C,PHI,30,82,13,34,47
18,8477426,Nicholas Paul,L,TBL,29,82,20,26,46
18,8477497,Sean Monahan,C,WPG,30,82,19,27,46
18,8475744,Evgeny Kuznetsov,C,CAR,32,82,19,27,46
18,8477021,Alex Kerfoot,C,ARI,30,82,18,28,46
18,8476419,Jean-Gabriel Pageau,C,NYI,32,82,15,31,46
18,8480849,Barrett Hayton,C,ARI,24,82,14,32,46
18,8480434,Sean Durzi,D,ARI,26,82,8,38,46
18,8476448,William Karlsson,C,VGK,31,82,23,22,45
18,8476483,Rickard Rakell,R,PIT,31,82,22,23,45
18,8478046,Danton Heinen,L,BOS,29,82,20,25,45
18,8477952,Robby Fabbri,C,DET,28,82,17,28,45
18,8475768,Jaden Schwartz,C,SEA,32,82,16,29,45
18,8477964,Ivan Barbashev,C,VGK,29,82,16,29,45
18,8476479,Phillip Danault,C,LAK,31,82,15,30,45
18,8471218,Blake Wheeler,R,NYR,38,82,15,30,45
18,8477986,Brandon Montour,D,FLA,30,82,14,31,45
18,8470613,Brent Burns,D,CAR,39,82,12,33,45
18,8475197,Tyson Barrie,D,NSH,33,82,8,37,45
18,8482699,Dylan Guenther,R,ARI,21,82,27,17,44
18,8478366,Frank Vatrano,R,ANA,30,82,27,17,44
18,8481535,Nils Hoglander,L,VAN,24,82,22,22,44
18,8478498,Jake DeBrusk,L,BOS,28,82,21,23,44
18,8474150,Mikael Backlund,C,CGY,35,82,19,25,44
18,8475314,Anders Lee,L,NYI,34,82,28,15,43
18,8476399,Blake Coleman,C,CGY,33,82,23,20,43
18,8482146,Luke Evangelista,R,NSH,22,82,22,21,43
18,8480893,Kirill Marchenko,R,CBJ,24,82,22,21,43
18,8474586,Jordan Eberle,R,SEA,34,82,19,24,43
18,8481656,Aliaksei Protas,C,WSH,23,82,17,26,43
18,8480798,Philipp Kurashev,C,CHI,25,82,15,28,43
18,8475793,Ryan Johansen,C,PHI,32,82,15,28,43
18,8476885,Jacob Trouba,D,NYR,30,82,7,36,43
18,8476906,Shayne Gostisbehere,D,DET,31,82,4,39,43
18,8475791,Taylor Hall,L,CHI,33,82,22,20,42
18,8480064,Josh Norris,C,OTT,25,82,21,21,42
18,8480802,Ryan McLeod,C,EDM,25,82,15,27,42
18,8482105,Jake Sanderson,D,OTT,22,82,13,29,42
18,8476923,Damon Severson,D,CBJ,30,82,11,31,42
18,8475799,Nino Niederreiter,R,WPG,32,82,25,16,41
18,8481624,Ilya Mikheyev,R,VAN,30,82,23,18,41
18,8478463,Anthony Beauvillier,L,NSH,27,82,21,20,41
18,8477511,Anthony Mantha,R,VGK,30,82,19,22,41
18,8474189,Lars Eller,C,PIT,35,82,19,22,41
18,8471698,T.J. Oshie,R,WSH,38,82,18,23,41
18,8476329,Travis Boyd,C,ARI,31,82,18,23,41
18,8482222,Alexander Barabanov,L,SJS,30,82,17,24,41
18,8476925,Colton Sissons,C,NSH,31,82,16,25,41
18,8474149,Evgenii Dadonov,R,DAL,35,82,16,25,41
18,8480220,Noah Cates,L,PHI,25,82,15,26,41
18,8478397,Rasmus Andersson,D,CGY,28,82,8,33,41
18,8477346,MacKenzie Weegar,D,CGY,30,82,8,33,41
18,8474151,Ryan McDonagh,D,NSH,35,82,7,34,41
18,8478233,Andrew Mangiapane,L,CGY,28,82,19,21,40
18,8478462,Nicolas Roy,C,VGK,27,82,16,24,40
18,8478115,Pierre Engvall,L,NYI,28,82,16,24,40
18,8482122,Brock Faber,D,MIN,22,82,7,33,40
18,8480871,Adam Boqvist,D,CBJ,24,82,6,34,40
18,8475181,Nick Leddy,D,STL,33,82,6,34,40
18,8475764,Cam Fowler,D,ANA,33,82,5,35,40
18,8480873,Rasmus Sandin,D,WSH,24,82,2,38,40
18,8480009,Eeli Tolvanen,R,SEA,25,82,20,19,39
18,8482705,Cole Sillinger,C,CBJ,21,82,18,21,39
18,8480821,Filip Zadina,R,SJS,25,82,15,24,39
18,8477932,Aaron Ekblad,D,FLA,28,82,10,29,39
18,8475149,Marcus Johansson,L,MIN,34,82,17,21,38
18,8476292,Ondrej Palat,L,NJD,33,82,12,26,38
18,8475753,Justin Faulk,D,STL,32,82,11,27,38
18,8481554,Kaapo Kakko,R,NYR,23,82,23,14,37
18,8473449,Kyle Okposo,R,FLA,36,82,17,20,37
18,8476897,Oskar Sundqvist,C,STL,30,82,16,21,37
18,8481704,Juuso Parssinen,C,NSH,23,82,14,23,37
18,8479365,Trent Frederic,C,BOS,26,82,12,25,37
18,8476958,Jaccob Slavin,D,CAR,30,82,11,26,37
18,8482133,Thomas Bordeleau,C,SJS,22,82,9,28,37
18,8476854,Hampus Lindholm,D,BOS,30,82,8,29,37
18,8478500,Ivan Provorov,D,CBJ,27,82,8,29,37
18,8479398,Samuel Girard,D,COL,26,82,1,36,37
18,8476981,Josh Anderson,R,MTL,30,82,24,12,36
18,8482079,Marco Rossi,C,MIN,23,82,19,17,36
18,8482475,Yegor Chinakhov,R,CBJ,23,82,17,19,36
18,8476873,Mark Jankowski,C,NSH,30,82,14,22,36
18,8481186,Logan O'Connor,R,COL,28,82,13,23,36
18,8479351,Sam Steel,C,DAL,26,82,13,23,36
18,8476480,Vladislav Namestnikov,C,WPG,32,82,13,23,36
18,8476374,Sean Kuraly,C,CBJ,31,82,13,23,36
18,8481477,Nico Sturm,C,SJS,29,82,21,14,35
18,8482113,Anton Lundell,C,FLA,23,82,20,15,35
18,8475842,Sam Carrick,C,EDM,32,82,19,16,35
18,8482055,Drew O'Connor,L,PIT,26,82,16,19,35
18,8473422,Nick Foligno,L,CHI,37,82,15,20,35
18,8476461,Sean Couturier,C,PHI,32,82,15,20,35
18,8480185,Eetu Luostarinen,C,FLA,26,82,14,21,35
18,8475220,Marcus Foligno,L,MIN,33,82,10,25,35
18,8478458,Jack Roslovic,C,NYR,27,82,9,26,35
18,8478508,Yakov Trenin,C,COL,27,82,20,14,34
18,8482125,Alexander Holtz,R,NJD,22,82,18,16,34
18,8482111,Justin Barron,D,MTL,23,82,18,16,34
18,8475714,Calle Jarnkrok,C,TOR,33,82,17,17,34
18,8474884,Mike Hoffman,C,SJS,35,82,17,17,34
18,8475231,Casey Cizikas,C,NYI,33,82,17,17,34
18,8473563,Nicklas Backstrom,C,WSH,37,82,14,20,34
18,8477989,Christian Dvorak,C,MTL,28,82,13,21,34
18,8470604,Jeff Carter,C,PIT,39,82,13,21,34
18,8475171,Oliver Ekman-Larsson,D,FLA,33,82,10,24,34
18,8476979,Erik Gustafsson,D,NYR,32,82,7,27,34
18,8477948,Travis Sanheim,D,PHI,28,82,6,28,34
18,8475906,John Klingberg,D,TOR,32,82,6,28,34
18,8480807,Mattias Samuelsson,D,BUF,24,82,4,30,34
18,8479992,Michael Rasmussen,C,DET,25,82,22,11,33
18,8481560,Arthur Kaliyev,R,LAK,23,82,18,15,33
18,8479390,Taylor Raddysh,R,CHI,26,82,18,15,33
18,8478109,Victor Olofsson,L,BUF,29,82,15,18,33
18,8479316,Luke Kunin,C,SJS,27,82,15,18,33
18,8475763,Kevin Hayes,R,STL,32,82,15,18,33
18,8481703,Valtteri Puustinen,R,PIT,25,82,14,19,33
18,8484144,Connor Bedard,C,CHI,19,82,13,20,33
18,8478413,Jordan Greenway,L,BUF,27,82,13,20,33
18,8477919,Frederick Gaudreau,C,MIN,31,82,13,20,33
18,8482720,Matthew Knies,L,TOR,22,82,12,21,33
18,8480336,Sean Walker,D,COL,30,82,11,22,33
18,8477839,Conor Sheary,L,TBL,32,82,11,22,33
18,8481581,Thomas Harley,D,DAL,23,82,10,23,33
18,8480817,K'Andre Miller,D,NYR,24,82,10,23,33
18,8477498,Darnell Nurse,D,EDM,29,82,8,25,33
18,8477365,Connor Clifton,D,BUF,29,82,7,26,33
18,8481606,Jordan Spence,D,LAK,23,82,7,26,33
18,8474716,Jared Spurgeon,D,MIN,35,82,3,30,33
18,8483515,Juraj Slafkovsky,L,MTL,20,82,19,13,32
18,8481013,Jonatan Berggren,R,DET,24,82,15,17,32
18,8470610,Zach Parise,L,COL,40,82,13,19,32
18,8480855,Jack McBain,C,ARI,24,82,13,19,32
18,8479293,Brandon Tanev,L,SEA,33,82,12,20,32
18,8475218,Mattias Ekholm,D,EDM,34,82,11,21,32
18,8479415,Michael McLeod,C,NJD,26,82,11,21,32
18,8480113,Alex Iafallo,L,WPG,31,82,11,21,32
18,8482655,J.J. Moser,D,ARI,24,82,10,22,32
18,8481553,Bobby Brink,R,PHI,23,82,10,22,32
18,8476467,Jamie Oleksiak,D,SEA,32,82,9,23,32
18,8479369,Andrew Peeke,D,BOS,26,82,5,27,32
18,8477944,Jakub Vrana,L,STL,28,82,18,13,31
18,8482089,Jake Neighbours,L,STL,22,82,17,14,31
18,8480068,Ryan Poehling,C,PHI,25,82,15,16,31
18,8474715,Cam Atkinson,R,PHI,35,82,14,17,31
18,8479353,Brett Howden,C,VGK,26,82,13,18,31
18,8477015,Connor Brown,R,EDM,30,82,11,20,31
18,8483431,Logan Cooley,C,ARI,20,82,10,21,31
18,8475848,Brendan Gallagher,R,MTL,32,82,10,21,31
18,8477425,Miles Wood,L,COL,29,82,10,21,31
18,8478136,Jake Middleton,D,MIN,28,82,10,21,31
18,8481546,Cam York,D,PHI,23,82,9,22,31
18,8479983,Mario Ferraro,D,SJS,26,82,8,23,31
18,8478911,Matt Roy,D,LAK,29,82,7,24,31
18,8477969,Marcus Pettersson,D,PIT,28,82,4,27,31
18,8480043,Timothy Liljegren,D,TOR,25,82,2,29,31
18,8479941,Justin Danforth,R,CBJ,31,82,18,12,30
18,8474037,James van Riemsdyk,L,BOS,35,82,17,13,30
18,8480813,Joe Veleno,C,DET,24,82,17,13,30
18,8479996,Cody Glass,C,NSH,25,82,12,18,30
18,8476871,Tanner Pearson,L,MTL,32,82,12,18,30
18,8482166,Shakir Mukhamadullin,D,SJS,22,82,12,18,30
18,8483457,Lane Hutson,D,MTL,20,82,10,20,30
18,8477392,Hudson Fasching,R,NYI,29,82,9,21,30
18,8473507,Jeff Petry,D,DET,37,82,6,24,30
18,8475690,Chris Tanev,D,DAL,35,82,5,25,30
18,8481601,Simon Holmstrom,R,NYI,23,82,21,8,29
18,8481604,Pavel Dorofeyev,L,VGK,24,82,19,10,29
18,8483491,Ivan Miroshnichenko,L,WSH,20,82,17,12,29
18,8479661,Tanner Jeannot,L,TBL,27,82,15,14,29
18,8476469,Joel Armia,R,MTL,31,82,13,16,29
18,8474034,Pat Maroon,L,BOS,36,82,11,18,29
18,8475343,Nic Dowd,C,WSH,34,82,10,19,29
18,8476624,Barclay Goodrow,C,NYR,31,82,7,22,29
18,8482245,Artem Zub,D,OTT,29,82,6,23,29
18,8479976,Juuso Valimaki,D,ARI,26,82,1,28,29
18,8482259,Bobby McMann,C,TOR,28,82,15,13,28
18,8482092,Ridly Greig,C,OTT,22,82,14,14,28
18,8481522,Peyton Krebs,C,BUF,23,82,14,14,28
18,8483763,Maksymilian Szuber,D,ARI,22,82,13,15,28
18,8478020,Michael Amadio,C,VGK,28,82,12,16,28
18,8477450,Jason Dickinson,C,CHI,29,82,12,16,28
18,8475200,Dmitry Orlov,D,CAR,33,82,11,17,28
18,8476902,Esa Lindell,D,DAL,30,82,8,20,28
18,8478891,Mason Appleton,C,WPG,28,82,7,21,28
18,8477506,Ryan Pulock,D,NYI,30,82,6,22,28
18,8477488,Brett Pesce,D,CAR,30,82,5,23,28
18,8476463,Jonas Brodin,D,MIN,31,82,5,23,28
18,8478882,Vladislav Gavrikov,D,LAK,29,82,4,24,28
18,8475279,Ben Chiarot,D,DET,33,82,4,24,28
18,8481059,Scott Perunovich,D,STL,26,82,3,25,28
18,8479324,Ryan Lindgren,D,NYR,26,82,3,25,28
18,8476921,Jordan Martinook,L,CAR,32,82,15,12,27
18,8476278,Colin Blackwell,C,CHI,31,82,13,14,27
18,8484145,Zach Benson,L,BUF,19,82,13,14,27
18,8482624,Daniil Miromanov,D,CGY,27,82,12,15,27
18,8480144,David Kampf,C,TOR,29,82,11,16,27
18,8477508,Curtis Lazar,C,NJD,29,82,9,18,27
18,8484153,Leo Carlsson,C,ANA,20,82,8,19,27
18,8480145,Neal Pionk,D,WPG,29,82,6,21,27
18,8476960,Andreas Athanasiou,C,CHI,30,82,6,21,27
18,8480073,Erik Brannstrom,D,OTT,25,82,6,21,27
18,8476879,Cody Ceci,D,EDM,31,82,4,23,27
18,8476931,Jake McCabe,D,TOR,31,82,3,24,27
18,8482117,Lukas Reichel,L,CHI,22,82,16,10,26
18,8470621,Corey Perry,R,EDM,39,82,15,11,26
18,8479591,Michael Eyssimont,C,TBL,28,82,12,14,26
18,8479977,Kailer Yamamoto,R,SEA,26,82,12,14,26
18,8476442,Matt Nieto,L,PIT,32,82,12,14,26
18,8478043,Sam Lafferty,C,VAN,29,82,11,15,26
18,8479393,Noah Gregor,C,TOR,26,82,11,15,26
18,8477953,Kasperi Kapanen,R,STL,28,82,8,18,26
18,8481014,Alexander Romanov,D,NYI,24,82,8,18,26
18,8483468,Jiri Kulich,C,BUF,20,82,8,18,26
18,8476917,Adam Pelech,D,NYI,30,82,6,20,26
18,8478416,Erik Cernak,D,TBL,27,82,5,21,26
18,8476457,Adam Larsson,D,SEA,32,82,5,21,26
18,8474673,TJ Brodie,D,TOR,34,82,2,24,26
18,8478507,John Marino,D,NJD,27,82,2,24,26
18,8482155,Alex Laferriere,R,LAK,23,82,16,9,25
18,8477330,Dominik Kubalik,L,OTT,29,82,14,11,25
18,8479423,Alex Nylander,L,CBJ,26,82,11,14,25
18,8479359,Beck Malenstyn,L,WSH,26,82,11,14,25
18,8473504,Cal Clutterbuck,R,NYI,37,82,11,14,25
18,8470966,Mark Giordano,D,TOR,41,82,9,16,25
18,8476331,Dylan DeMelo,D,WPG,31,82,6,19,25
18,8476891,Matt Grzelcyk,D,BOS,30,82,4,21,25
18,8479371,Dante Fabbro,D,NSH,26,82,3,22,25
18,8480995,Pontus Holmberg,R,TOR,25,82,13,11,24
18,8480459,Pius Suter,C,VAN,28,82,11,13,24
18,8482730,Brandt Clarke,D,LAK,21,82,11,13,24
18,8483493,Frank Nazar,C,CHI,20,82,10,14,24
18,8477947,Sonny Milano,L,WSH,28,82,9,15,24
18,8477220,Nate Schmidt,D,WPG,33,82,9,15,24
18,8475164,Jakob Silfverberg,R,ANA,34,82,7,17,24
18,8477507,Nikita Zadorov,D,VAN,29,82,4,20,24
18,8479980,Nicolas Hague,D,VGK,26,82,3,21,24
18,8482666,Scott Morrow,D,CAR,22,82,11,12,23
18,8481580,Connor McMichael,C,WSH,23,82,10,13,23
18,8483524,Shane Wright,C,SEA,20,82,10,13,23
18,8481537,Nikita Okhotiuk,D,CGY,24,82,10,13,23
18,8482807,Ethan Del Mastro,D,CHI,21,82,9,14,23
18,8473533,Jordan Staal,C,CAR,36,82,9,14,23
18,8477353,Tyler Motte,C,TBL,29,82,9,14,23
18,8481481,Blake Lizotte,C,LAK,27,82,9,14,23
18,8481524,Bowen Byram,D,BUF,23,82,8,15,23
18,8481517,Brett Leason,R,ANA,25,82,8,15,23
18,8478013,Jake Walman,D,DET,28,82,7,16,23
18,8476892,Colton Parayko,D,STL,31,82,5,18,23
18,8481599,Victor Soderstrom,D,ARI,23,82,5,18,23
18,8475324,Nick Jensen,D,WSH,34,82,4,19,23
18,8475233,David Savard,D,MTL,34,82,3,20,23
18,8481178,Egor Zamula,D,PHI,24,82,1,22,23
18,8482073,Braden Schneider,D,NYR,23,82,0,23,23
18,8482062,Cole Smith,L,NSH,29,82,12,10,22
18,8480448,Parker Kelly,L,OTT,25,82,11,11,22
18,8480806,Isac Lundestrom,C,ANA,25,82,10,12,22
18,8482679,Matt Coronato,R,CGY,22,82,9,13,22
18,8474870,Tyler Johnson,C,CHI,34,82,8,14,22
18,8482142,Jamie Drysdale,D,PHI,22,82,8,14,22
18,8484166,Adam Fantilli,C,CBJ,20,82,8,14,22
18,8482762,Simon Edvinsson,D,DET,21,82,8,14,22
18,8478133,Jake Evans,C,MTL,28,82,7,15,22
18,8477406,Mattias Janmark,C,EDM,32,82,7,15,22
18,8480074,Alexandre Texier,C,CBJ,25,82,6,16,22
18,8482803,Olen Zellweger,D,ANA,21,82,6,16,22
18,8484203,Bradly Nadeau,L,CAR,19,82,5,17,22
18,8478859,Niko Mikkola,D,FLA,28,82,4,18,22
18,8475188,Brayden McNabb,D,VGK,33,82,4,18,22
18,8475208,Brian Dumoulin,D,SEA,33,82,3,19,22
18,8479998,Mikey Anderson,D,LAK,25,82,1,21,22
18,8476858,Phillip Di Giuseppe,L,VAN,31,82,14,7,21
18,8481093,Rafael Harvey-Pinard,L,MTL,25,82,10,11,21
18,8482702,Logan Stankoven,C,DAL,21,82,10,11,21
18,8479346,Dillon Dube,C,CGY,26,82,9,12,21
18,8483490,Pavel Mintyukov,D,ANA,21,82,7,14,21
18,8484911,Collin Graf,R,SJS,22,82,7,14,21
18,8476312,Josh Manson,D,COL,33,82,5,16,21
18,8473453,Trevor Lewis,C,LAK,37,82,5,16,21
18,8482470,Ilya Solovyov,D,CGY,24,82,4,17,21
18,8482733,Logan Mailloux,D,MTL,31,82,4,17,21
18,8476525,Colin Miller,D,WPG,32,82,4,17,21
18,8480035,Henri Jokiharju,D,BUF,25,82,3,18,21
18,8479514,Rem Pitlick,C,CHI,27,82,3,18,21
18,8480172,Jan Rutta,D,SJS,34,82,2,19,21
18,8478569,Noel Acciari,C,PIT,33,82,11,9,20
18,8475762,Derek Forbort,D,BOS,32,82,9,11,20
18,8481567,Henry Thrun,D,SJS,23,82,9,11,20
18,8483445,Cutter Gauthier,L,ANA,20,82,8,12,20
18,8478178,Darren Raddysh,D,TBL,28,82,8,12,20
18,8470600,Ryan Suter,D,DAL,39,82,5,15,20
18,8476422,Mike Reilly,D,NYI,31,82,5,15,20
18,8480246,Nick Perbix,D,TBL,26,82,3,17,20
18,8478399,Jonas Siegenthaler,D,NJD,27,82,3,17,20
18,8477499,Rasmus Ristolainen,D,PHI,30,82,3,17,20
18,8482087,Kaiden Guhle,D,MTL,22,82,2,18,20
18,8477931,Tomas Nosek,L,NJD,32,82,7,12,19
18,8481016,Ruslan Iskhakov,C,NYI,24,82,7,12,19
18,8478851,Alexandre Carrier,D,NSH,28,82,6,13,19
18,8480058,Pierre-Olivier Joseph,D,PIT,25,82,4,15,19
18,8478840,Will Borgen,D,SEA,28,82,2,17,19
18,8476967,Brett Kulak,D,EDM,30,82,2,17,19
18,8475790,Erik Gudbranson,D,CBJ,32,82,1,18,19
18,8475462,Radko Gudas,D,ANA,34,82,1,18,19
18,8474574,Tyler Myers,D,VAN,34,82,1,18,19
18,8477505,Alexander Wennberg,C,NYR,30,82,10,8,18
18,8475177,Calvin de Haan,D,TBL,33,82,6,12,18
18,8476429,Scott Mayfield,D,NYI,32,82,6,12,18
18,8481568,Alex Vlasic,D,CHI,23,82,4,14,18
18,8478443,Brandon Carlo,D,BOS,28,82,4,14,18
18,8477845,Trevor van Riemsdyk,D,WSH,33,82,2,16,18
18,8482809,Jackson Blake,R,CAR,21,82,6,11,17
18,8478451,Ethan Bear,D,WSH,27,82,5,12,17
18,8478468,Jeremy Lauzon,D,NSH,27,82,4,13,17
18,8483565,Nick Blankenburg,D,CBJ,26,82,2,15,17
18,8480879,Jacob Bernard-Docker,D,OTT,24,82,1,16,17
18,8474009,Nick Bonino,C,NYR,36,82,10,6,16
18,8478831,Kevin Stenlund,C,FLA,28,82,9,7,16
18,8482101,Danil Gushchin,L,SJS,22,82,8,8,16
18,8483482,Tristan Luneau,D,ANA,20,82,7,9,16
18,8479291,Kevin Rooney,C,CGY,31,82,7,9,16
18,8482516,Matthew Kessel,D,STL,24,82,6,10,16
18,8477335,Kyle Burroughs,D,SJS,29,82,4,12,16
18,8476372,Nick Seeler,D,PHI,31,82,3,13,16
18,8475455,Brenden Dillon,D,WPG,34,82,1,15,16
18,8482145,Mavrik Bourque,C,DAL,22,82,9,6,15
18,8481028,Martin Pospisil,C,CGY,25,82,8,7,15
18,8476878,Zemgus Girgensons,L,BUF,30,82,8,7,15
18,8476915,Jujhar Khaira,L,MIN,30,82,8,7,15
18,8483499,Liam Ohgren,L,MIN,20,82,7,8,15
18,8483012,Logan Morrison,C,SEA,22,82,7,8,15
18,8482074,Connor Zary,C,CGY,23,82,6,9,15
18,8479383,Boris Katchouk,L,OTT,26,82,5,10,15
18,8483505,Matthew Poitras,C,BOS,20,82,5,10,15
18,8483495,Simon Nemec,D,NJD,20,82,4,11,15
18,8479442,Troy Stecher,D,EDM,30,82,3,12,15
18,8483489,Fraser Minten,C,TOR,31,82,2,13,15
18,8480281,Alexey Toropchenko,R,STL,25,82,11,3,14
18,8483397,Marc McLaughlin,C,BOS,25,82,9,5,14
18,8475179,Dmitry Kulikov,D,FLA,34,82,2,12,14
18,8471677,Jack Johnson,D,COL,37,82,2,12,14
18,8476473,Connor Murphy,D,CHI,31,82,2,12,14
18,8482858,Ryker Evans,D,SEA,23,82,7,6,13
18,8477369,Carson Soucy,D,VAN,30,82,6,7,13
18,8477435,Ryan Graves,D,PIT,29,82,4,9,13
18,8482712,Oskar Olausson,R,COL,22,82,4,9,13
18,8474166,Alec Martinez,D,VGK,37,82,3,10,13
18,8482713,Mackie Samoskevich,R,FLA,22,82,3,10,13
18,8475825,Jani Hakanpää,D,DAL,32,82,2,11,13
18,8480860,Kevin Bahl,D,NJD,24,82,1,12,13
18,8481030,Jack St. Ivany,D,PIT,25,82,5,7,12
18,8480796,Martin Fehervary,D,WSH,25,82,3,9,12
18,8480834,Ty Emberson,D,SJS,24,82,3,9,12
18,8477034,Jaycob Megna,D,CHI,32,82,3,9,12
18,8474013,Ian Cole,D,VAN,35,82,2,10,12
18,8480990,Declan Chisholm,D,MIN,24,82,1,11,12
18,8484149,Gavin Brindley,C,CBJ,20,82,6,5,11
18,8482859,Zack Ostapchuk,C,OTT,21,82,3,8,11
18,8474567,Zach Bogosian,D,MIN,34,82,0,11,11
18,8476822,Luke Glendening,C,TBL,35,82,5,5,10
18,8480031,Maxime Comtois,L,CAR,25,82,5,5,10
18,8482737,Zack Bolduc,C,STL,21,82,3,7,10
18,8482118,Sam Colangelo,R,ANA,23,82,2,8,10
18,8483471,Brad Lambert,C,WPG,31,82,2,8,10
18,8478430,Oliver Kylington,D,CGY,27,82,1,9,10
18,8481699,Aku Raty,R,ARI,23,82,3,6,9
18,8481578,Graeme Clarke,R,NJD,23,82,5,3,8
18,8478408,Travis Dermott,D,ARI,28,82,4,4,8
18,8482177,Marat Khusnutdinov,C,MIN,22,82,3,5,8
18,8481605,Jackson LaCombe,D,ANA,23,82,2,5,7
18,8483466,Kevin Korchinski,D,CHI,20,82,1,4,5
18,8477950,Tony DeAngelo,D,CAR,29,0,0,0,0
18,8481577,Philip Tomasino,C,NSH,23,0,0,0,0
18,8482660,Kent Johnson,C,CBJ,22,0,0,0,0
18,8481019,David Gustafsson,C,WPG,24,0,0,0,0
18,8479348,Kale Clague,D,BUF,26,0,0,0,0
18,8482149,Cole Perfetti,C,WPG,22,0,0,0,0
18,8476952,Dominic Toninato,C,WPG,30,0,0,0,0
18,8473473,Milan Lucic,L,BOS,36,0,0,0,0
18,8480829,Jesperi Kotkaniemi,C,CAR,24,0,0,0,0
18,8474602,Justin Schultz,D,SEA,34,0,0,0,0
18,8480049,Dylan Samberg,D,WPG,25,0,0,0,0
18,8479372,Josh Mahura,D,FLA,26,0,0,0,0
18,8480878,Nils Lundkvist,D,DAL,24,0,0,0,0
18,8479982,Conor Timmins,D,TOR,26,0,0,0,0
18,8474031,Kevin Shattenkirk,D,BOS,35,0,0,0,0
18,8480835,Jack Drury,C,CAR,24,0,0,0,0
18,8480008,Adam Ruzicka,C,ARI,25,0,0,0,0
18,8479402,Jake Bean,D,CBJ,26,0,0,0,0
18,8476474,Stefan Noesen,R,CAR,31,0,0,0,0
18,8480884,Calen Addison,D,SJS,24,0,0,0,0
18,8476994,Vinnie Hinostroza,C,PIT,30,0,0,0,0
18,8477987,Ryan Donato,C,CHI,28,0,0,0,0
18,8481582,Nicholas Robertson,L,TOR,23,0,0,0,0
18,8478452,Caleb Jones,D,COL,27,0,0,0,0
18,8480157,Calle Rosen,D,STL,30,0,0,0,0
18,8481609,Vladislav Kolyachonok,D,ARI,23,0,0,0,0
18,8476919,Chris Tierney,C,NJD,30,0,0,0,0
18,8479639,Dylan Coghlan,D,CAR,26,0,0,0,0
18,8475193,Tomas Tatar,L,SEA,34,0,0,0,0
18,8480748,Kiefer Sherwood,L,NSH,29,0,0,0,0
18,8478146,Matthew Highmore,C,OTT,28,0,0,0,0
18,8478970,Jalen Chatfield,D,CAR,28,0,0,0,0
18,8480205,Emil Bemstrom,C,PIT,25,0,0,0,0
18,8471274,Alex Goligoski,D,MIN,39,0,0,0,0
18,8478104,Sammy Blais,L,STL,28,0,0,0,0
18,8476913,Devin Shore,C,SEA,30,0,0,0,0
18,8481708,Zac Jones,D,NYR,24,0,0,0,0
18,8480222,Sebastian Aho,D,NYI,28,0,0,0,0
18,8481598,Philip Broberg,D,EDM,23,0,0,0,0
18,8480789,Oliver Wahlstrom,R,NYI,24,0,0,0,0
18,8480891,Michael Kesselring,D,ARI,24,0,0,0,0
18,8477979,Nicolas Aube-Kubel,R,WSH,28,0,0,0,0
18,8476393,Nick Cousins,C,FLA,31,0,0,0,0
18,8480003,Jesper Boqvist,C,BOS,26,0,0,0,0
18,8479543,Michael Pezzetta,L,MTL,26,0,0,0,0
18,8475855,Jesper Fast,R,CAR,33,0,0,0,0
18,8477018,Ben Hutton,D,VGK,31,0,0,0,0
18,8480762,Eric Robinson,L,BUF,29,0,0,0,0
18,8481058,Jesse Ylönen,R,MTL,25,0,0,0,0
18,8481527,Kaedan Korczak,D,VGK,23,0,0,0,0
18,8482192,Isaak Phillips,D,CHI,23,0,0,0,0
18,8480727,Zach Whitecloud,D,VGK,28,0,0,0,0
18,8480001,Urho Vaakanainen,D,ANA,25,0,0,0,0
18,8480853,Liam Foudy,C,NSH,24,0,0,0,0
18,8475225,Craig Smith,C,DAL,35,0,0,0,0
18,8479972,Mason Shaw,C,MIN,26,0,0,0,0
18,8474040,Sam Gagner,C,EDM,35,0,0,0,0
18,8480196,Jacob Bryson,D,BUF,27,0,0,0,0
18,8475718,Justin Holl,D,DET,32,0,0,0,0
18,8479984,Cal Foote,D,NJD,26,0,0,0,0
18,8480011,Klim Kostin,C,SJS,25,0,0,0,0
18,8482176,Wyatt Kaiser,D,CHI,22,0,0,0,0
18,8476918,Jimmy Vesey,L,NYR,31,0,0,0,0
18,8476988,Matt Benning,D,SJS,30,0,0,0,0
18,8479370,Tyson Jost,C,BUF,26,0,0,0,0
18,8477464,Nic Petan,C,MIN,29,0,0,0,0
18,8477380,Jonny Brodzinski,C,NYR,31,0,0,0,0
18,8480070,Ian Mitchell,D,BOS,25,0,0,0,0
18,8479315,Joey Anderson,R,CHI,26,0,0,0,0
18,8478099,Kevin Labanc,R,SJS,29,0,0,0,0
18,8476874,Olli Maatta,D,DET,30,0,0,0,0
18,8479414,Nathan Bastian,R,NJD,27,0,0,0,0
18,8478434,Keegan Kolesar,R,VGK,27,0,0,0,0
18,8479536,Axel Jonsson-Fjallby,L,WPG,26,0,0,0,0
18,8479671,Mathieu Olivier,R,CBJ,27,0,0,0,0
18,8471709,Marc-Edouard Vlasic,D,SJS,37,0,0,0,0
18,8479328,Julien Gauthier,R,NYI,27,0,0,0,0
18,8478421,A.J. Greer,L,CGY,28,0,0,0,0
18,8477573,Nathan Walker,L,STL,30,0,0,0,0
18,8477478,William Carrier,L,VGK,30,0,0,0,0
18,8479344,Jesse Puljujarvi,R,PIT,26,0,0,0,0
18,8480887,Jordan Harris,D,MTL,24,0,0,0,0
18,8478502,Dennis Gilbert,D,CGY,28,0,0,0,0
18,8480355,Mark Kastelic,C,OTT,25,0,0,0,0
18,8475750,Jon Merrill,D,MIN,32,0,0,0,0
18,8476889,Radek Faksa,C,DAL,30,0,0,0,0
18,8478432,Christian Fischer,R,DET,27,0,0,0,0
18,8479439,Jacob MacDonald,D,SJS,31,0,0,0,0
18,8474568,Luke Schenn,D,NSH,35,0,0,0,0
18,8478454,Noah Juulsen,D,VAN,27,0,0,0,0
18,8475752,Tyler Pitlick,C,NYR,33,0,0,0,0
18,8482148,Hendrix Lapierre,C,WSH,22,0,0,0,0
18,8481167,Brayden Pachal,D,CGY,25,0,0,0,0
18,8478211,Dryden Hunt,L,CGY,29,0,0,0,0
18,8479321,Lucas Johansen,D,WSH,27,0,0,0,0
18,8480950,Ilya Lyubushkin,D,TOR,30,0,0,0,0
18,8479368,Max Jones,L,ANA,26,0,0,0,0
18,8471699,Andrew Cogliano,C,COL,37,0,0,0,0
18,8481521,Ronnie Attard,D,PHI,25,0,0,0,0
18,8481161,Jake Christiansen,D,CBJ,25,0,0,0,0
18,8479458,Nikita Zaitsev,D,CHI,33,0,0,0,0
18,8479619,Michael Carcone,L,ARI,28,0,0,0,0
18,8479026,Philippe Myers,D,TBL,27,0,0,0,0
18,8481617,Vasily Podkolzin,R,VAN,23,0,0,0,0
18,8481701,Santeri Hatakka,D,NJD,23,0,0,0,0
18,8477446,Michael McCarron,R,NSH,29,0,0,0,0
18,8483460,David Jiricek,D,CBJ,21,0,0,0,0
18,8474090,Brendan Smith,D,NJD,35,0,0,0,0
18,8482241,Radim Zohorna,L,PIT,28,0,0,0,0
18,8481032,Paul Cotter,C,VGK,25,0,0,0,0
18,8480289,Morgan Barron,C,WPG,26,0,0,0,0
18,8479379,Givani Smith,R,SJS,26,0,0,0,0
18,8480216,Jacob Peterson,C,SJS,25,0,0,0,0
18,8477851,Jordan Oesterle,D,CGY,32,0,0,0,0
18,8484258,Sam Malinski,D,COL,26,0,0,0,0
18,8478904,Steven Lorentz,C,FLA,28,0,0,0,0
18,8482095,Tyler Kleven,D,OTT,22,0,0,0,0
18,8480980,Connor Dewar,C,TOR,25,0,0,0,0
18,8480848,Ty Dellandrea,C,DAL,24,0,0,0,0
18,8476884,Derrick Pouliot,D,DAL,30,0,0,0,0
18,8480025,MacKenzie Entwistle,R,CHI,25,0,0,0,0
18,8474612,Travis Hamonic,D,OTT,34,0,0,0,0
18,8479336,Carl Grundstrom,R,LAK,27,0,0,0,0
18,8482964,Arber Xhekaj,D,MTL,23,0,0,0,0
18,8471686,Marc Staal,D,PHI,37,0,0,0,0
18,8477887,Patrick Brown,C,BOS,32,0,0,0,0
18,8478495,Denis Gurianov,R,PHI,27,0,0,0,0
18,8481550,Adam Beckman,L,MIN,23,0,0,0,0
18,8480845,Rasmus Kupari,C,WPG,24,0,0,0,0
18,8478585,Derek Ryan,C,EDM,38,0,0,0,0
18,8482141,Lukas Cormier,D,VGK,22,0,0,0,0
18,8477962,Brendan Lemieux,L,CAR,28,0,0,0,0
18,8482861,Vincent Iorio,D,WSH,22,0,0,0,0
18,8479378,Logan Stanley,D,WPG,26,0,0,0,0
18,8473446,Erik Johnson,D,PHI,36,0,0,0,0
18,8481743,Marc Del Gaizo,D,NSH,25,0,0,0,0
18,8478450,Parker Wotherspoon,D,BOS,27,0,0,0,0
18,8477384,Josh Brown,D,ARI,30,0,0,0,0
18,8482165,Yan Kuznetsov,D,CGY,22,0,0,0,0
18,8478424,Jansen Harkins,C,PIT,27,0,0,0,0
18,8482144,Jack Thompson,D,SJS,22,0,0,0,0
18,8479576,Vincent Desharnais,D,EDM,28,0,0,0,0
18,8478512,Austin Czarnik,C,DET,32,0,0,0,0
18,8477527,Ross Johnston,L,ANA,30,0,0,0,0
18,8482094,Daemon Hunt,D,MIN,22,0,0,0,0
18,8481719,Maxwell Crozier,D,TBL,24,0,0,0,0
18,8480192,Johnathan Kovacevic,D,MTL,27,0,0,0,0
18,8479376,Victor Mete,D,PHI,26,0,0,0,0
18,8482511,Mason Lohrei,D,BOS,23,0,0,0,0
18,8478021,William Lagesson,D,ANA,28,0,0,0,0
18,8475795,Dylan McIlrath,D,WSH,32,0,0,0,0
18,8477846,Ryan Carpenter,C,SJS,33,0,0,0,0
18,8481056,Spencer Stastney,D,NSH,24,0,0,0,0
18,8481564,Ryan Johnson,D,BUF,23,0,0,0,0
18,8478017,Mark Friedman,D,VAN,29,0,0,0,0
18,8479320,Max Lajoie,D,TOR,27,0,0,0,0
18,8480075,Cameron Crotty,D,ARI,25,0,0,0,0
18,8484287,Cole McWard,D,VAN,23,0,0,0,0
18,8484254,Akito Hirose,D,VAN,25,0,0,0,0
18,8483407,Brandon Scanlin,D,NYR,25,0,0,0,0
18,8480274,Philip Kemp,D,EDM,25,0,0,0,0
18,8479522,Hardy Haman Aktell,D,WSH,26,0,0,0,0
18,8480007,Jonas Rondbjerg,R,VGK,25,0,0,0,0
18,8477454,Adam Erne,L,EDM,29,0,0,0,0
18,8481679,Maxence Guenette,D,OTT,23,0,0,0,0
18,8477938,Haydn Fleury,D,TBL,28,0,0,0,0
18,8476441,Joel Edmundson,D,TOR,31,0,0,0,0
18,8477903,Garnet Hathaway,R,PHI,33,0,0,0,0
18,8480441,Trey Fix-Wolansky,R,CBJ,25,0,0,0,0
18,8483546,Marshall Rifai,D,TOR,26,0,0,0,0
18,8480084,Nick DeSimone,D,NJD,30,0,0,0,0
18,8481592,Jakob Pelletier,L,CGY,23,0,0,0,0
18,8478011,Louie Belpedio,D,PHI,28,0,0,0,0
18,8477930,Pierre-Edouard Bellemare,L,SEA,39,0,0,0,0
18,8484321,Nikolas Matinpalo,D,OTT,26,0,0,0,0
18,8482067,Connor Mackey,D,NYR,28,0,0,0,0
18,8481806,Louis Crevier,D,CHI,23,0,0,0,0
18,8484326,Patrik Koch,D,ARI,28,0,0,0,0
18,8477971,Andreas Englund,D,LAK,28,0,0,0,0
18,8481751,Lukas Rousek,R,BUF,25,0,0,0,0
18,8481006,Tyler Tucker,D,STL,24,0,0,0,0
18,8481641,Joel Kiviranta,L,COL,28,0,0,0,0
18,8476867,Brendan Gaunce,C,CBJ,30,0,0,0,0
18,8479520,Brandon Duhaime,R,COL,27,0,0,0,0
18,8477073,Kurtis MacDermid,L,NJD,30,0,0,0,0
18,8480874,Adam Ginning,D,PHI,24,0,0,0,0
18,8477473,Justin Bailey,R,SJS,29,0,0,0,0
18,8479066,Ryan Lomberg,L,FLA,30,0,0,0,0
18,8477070,Liam O'Brien,C,ARI,30,0,0,0,0
18,8474618,Marco Scandella,D,STL,34,0,0,0,0
18,8475797,Jarred Tinordi,D,CHI,32,0,0,0,0
18,8481441,Joe Snively,C,WSH,28,0,0,0,0
18,8477244,Chad Ruhwedel,D,NYR,34,0,0,0,0
18,8482077,Dylan Holloway,L,EDM,23,0,0,0,0
18,8479772,Zack MacEwen,R,OTT,28,0,0,0,0
18,8481147,Reese Johnson,C,CHI,26,0,0,0,0
18,8481043,Cole Koepke,L,TBL,26,0,0,0,0
18,8483619,Filip Roos,D,CHI,25,0,0,0,0
18,8481541,Samuel Bolduc,D,NYI,24,0,0,0,0
18,8477810,Joel Hanley,D,CGY,33,0,0,0,0
18,8476907,Mackenzie MacEachern,L,STL,30,0,0,0,0
18,8482652,Walker Duehr,R,CGY,27,0,0,0,0
18,8477126,Jayson Megna,C,BOS,34,0,0,0,0
18,8483398,Declan Carlile,D,TBL,31,0,0,0,0
18,8482929,Emil Lilleberg,D,TBL,23,0,0,0,0
18,8480880,Jakub Lauko,C,BOS,24,0,0,0,0
18,8478874,Adam Gaudette,C,STL,28,0,0,0,0
18,8480245,Olle Lycksell,R,PHI,25,0,0,0,0
18,8480252,Cole Guttman,C,CHI,25,0,0,0,0
18,8477467,Gustav Olofsson,D,SEA,30,0,0,0,0
18,8479968,Vinni Lettieri,C,MIN,29,0,0,0,0
18,8478400,Colin White,C,MTL,27,0,0,0,0
18,8475755,Alexander Petrovic,D,DAL,32,0,0,0,0
18,8481812,Nikolai Knyzhov,D,SJS,27,0,0,0,0
18,8481593,Jayden Struble,D,MTL,23,0,0,0,0
18,8481532,Alex Turcotte,C,LAK,23,0,0,0,0
18,8482126,Emil Andrae,D,PHI,31,0,0,0,0
18,8479944,Zach Aston-Reese,C,DET,30,0,0,0,0
18,8471817,Ryan Reaves,R,TOR,37,0,0,0,0
18,8481206,John Ludvig,D,PIT,24,0,0,0,0
18,8480292,Carson Meyer,R,CBJ,27,0,0,0,0
18,8482496,Nils Aman,C,VAN,24,0,0,0,0
18,8479718,Alex Barré-Boulet,C,TBL,27,0,0,0,0
18,8479994,Jaret Anderson-Dolan,C,NSH,25,0,0,0,0
18,8480184,Gustav Lindstrom,D,ANA,26,0,0,0,0
18,8480890,Jan Jenik,R,ARI,24,0,0,0,0
18,8478067,Oskar Lindblom,L,SJS,28,0,0,0,0
18,8476934,Brock McGinn,L,ANA,30,0,0,0,0
18,8479985,Cale Fleury,D,SEA,26,0,0,0,0
18,8482153,Brendan Brisson,C,VGK,23,0,0,0,0
18,8480021,Jack Studnicka,C,SJS,25,0,0,0,0
18,8484304,Uvis Balinskis,D,FLA,28,0,0,0,0
18,8479981,Jonah Gadjovich,L,FLA,26,0,0,0,0
18,8481716,Dmitri Voronkov,L,CBJ,24,0,0,0,0
18,8482659,Josh Doan,R,ARI,22,0,0,0,0
18,8481122,Simon Benoit,D,TOR,26,0,0,0,0
18,8474709,Matt Martin,L,NYI,35,0,0,0,0
18,8482634,Alex Steeves,C,TOR,25,0,0,0,0
18,8480823,Alexander Alexeyev,D,WSH,25,0,0,0,0
18,8477541,Dakota Mermis,D,MIN,30,0,0,0,0
18,8478477,Mitchell Stephens,C,MTL,27,0,0,0,0
18,8481543,Nikita Alexandrov,C,STL,24,0,0,0,0
18,8482451,Mikael Pyyhtia,L,CBJ,23,0,0,0,0
18,8480306,Grant Hutton,D,NYI,29,0,0,0,0
18,8478028,Fredrik Olofsson,L,COL,28,0,0,0,0
18,8477462,Robert Hagg,D,ANA,29,0,0,0,0
18,8477320,Anton Blidh,L,NYR,29,0,0,0,0
18,8482749,Joshua Roy,R,MTL,21,0,0,0,0
18,8482157,Will Cuylle,L,NYR,22,0,0,0,0
18,8481239,Samuel Fagemo,L,LAK,24,0,0,0,0
18,8481600,Tobias Bjornfot,D,FLA,23,0,0,0,0
18,8478409,Anthony Richard,C,BOS,28,0,0,0,0
18,8474145,Robert Bortuzzo,D,NYI,35,0,0,0,0
18,8475958,Michael Sgarbossa,C,WSH,32,0,0,0,0
18,8479986,Kole Lind,R,SEA,26,0,0,0,0
18,8479249,Andrew Poturalski,C,SEA,30,0,0,0,0
18,8479362,Riley Tufte,L,COL,26,0,0,0,0
18,8479991,Jake Leschyshyn,C,NYR,25,0,0,0,0
18,8479587,Rhett Gardner,C,PHI,28,0,0,0,0
18,8482744,James Malatesta,L,CBJ,21,0,0,0,0
18,8478854,Ryan Shea,D,PIT,27,0,0,0,0
18,8481591,Sam Poulin,R,PIT,23,0,0,0,0
18,8483512,Matt Savoie,C,BUF,20,0,0,0,0
18,8482102,Vasily Ponomarev,C,CAR,22,0,0,0,0
18,8482162,Roby Jarventie,L,OTT,22,0,0,0,0
18,8482172,Landon Slaggert,L,CHI,22,0,0,0,0
18,8482747,Brennan Othmann,L,NYR,21,0,0,0,0
18,8480226,Marián Studenic,R,SEA,26,0,0,0,0
18,8481518,Nolan Foote,L,NJD,24,0,0,0,0
18,8479419,Brett Murray,L,BUF,26,0,0,0,0
18,8482088,Justin Sourdif,R,FLA,22,0,0,0,0
18,8482201,Gage Goncalves,C,TBL,23,0,0,0,0
18,8481754,Nikita Nesterenko,C,ANA,23,0,0,0,0
18,8483531,Brian Halonen,L,NJD,25,0,0,0,0
18,8483920,Pierrick Dube,R,WSH,23,0,0,0,0
18,8480851,Akil Thomas,C,LAK,24,0,0,0,0
18,8475235,Nicolas Deslauriers,L,PHI,33,0,0,0,0
18,8482476,Emil Heineman,L,MTL,23,0,0,0,0
18,8477149,Scott Sabourin,R,SJS,32,0,0,0,0
18,8483549,Lucas Condotta,L,MTL,27,0,0,0,0
18,8483567,Georgii Merkulov,C,BOS,24,0,0,0,0
18,8482765,Isak Rosen,R,BUF,21,0,0,0,0
18,8481237,Kyle MacLean,C,NYI,25,0,0,0,0
18,8481024,Linus Karlsson,C,VAN,25,0,0,0,0
18,8481690,Tyler Angle,C,CBJ,24,0,0,0,0
18,8483570,Ben Meyers,C,ANA,26,0,0,0,0
18,8481655,Cole Schwindt,R,CGY,23,0,0,0,0
18,8481462,Mason Morelli,L,VGK,28,0,0,0,0
18,8483401,Marc Johnstone,R,PIT,28,0,0,0,0
18,8478956,Samuel Laberge,L,NJD,27,0,0,0,0
18,8479533,Joona Koppanen,L,PIT,26,0,0,0,0
18,8482197,Adam Raska,R,MIN,23,0,0,0,0
18,8482250,Callahan Burke,C,CAR,27,0,0,0,0
18,8482784,Zach Dean,C,STL,21,0,0,0,0
18,8484255,Jason Polin,R,COL,25,0,0,0,0
18,8481077,John Leonard,L,ARI,26,0,0,0,0
18,8481534,Raphael Lavoie,C,EDM,24,0,0,0,0
18,8483609,Adam Klapka,R,CGY,24,0,0,0,0
18,8482751,Ryan Winterton,C,SEA,21,0,0,0,0
18,8480267,Sammy Walker,C,MIN,25,0,0,0,0
18,8475766,Austin Watson,L,TBL,32,0,0,0,0
18,8482460,Matt Rempe,C,NYR,22,0,0,0,0
18,8482787,Nikita Chibrikov,R,WPG,31,0,0,0,0
18,8481065,Angus Crookshank,L,OTT,25,0,0,0,0
18,8481070,Hugh McGing,L,STL,26,0,0,0,0
18,8476323,Max McCormick,L,SEA,32,0,0,0,0
18,8483395,Arshdeep Bains,L,VAN,23,0,0,0,0
18,8484259,Ondrej Pavel,C,COL,31,0,0,0,0
18,8483432,Luca Del Bel Belluz,C,CBJ,31,0,0,0,0
18,8483045,Cameron Butler,R,CBJ,31,0,0,0,0
18,8482061,Brandon Biro,L,BUF,26,0,0,0,0
18,8477401,John Hayden,C,SEA,29,0,0,0,0
18,8475278,Byron Froese,C,VGK,33,0,0,0,0
18,8478446,Glenn Gawdin,C,ANA,27,0,0,0,0
18,8477993,Justin Kirkland,C,ARI,28,0,0,0,0
18,8482147,Jean-Luc Foudy,C,COL,22,0,0,0,0
18,8480032,Shane Bowers,C,NJD,25,0,0,0,0
18,8479330,Brandon Gignac,C,MTL,27,0,0,0,0
18,8480776,Sheldon Rempal,R,VGK,29,0,0,0,0
18,8475413,Justin Dowling,C,NJD,34,0,0,0,0
18,8481726,Adam Edstrom,C,NYR,24,0,0,0,0
18,8479638,Justin Brazeau,R,BOS,26,0,0,0,0
18,8480844,Grigori Denisenko,L,VGK,24,0,0,0,0
18,8474062,Riley Nash,C,NYR,35,0,0,0,0
18,8478147,Bokondji Imama,L,OTT,28,0,0,0,0
18,8478881,Brett Seney,L,CHI,28,0,0,0,0
18,8483630,Pavol Regenda,L,ANA,25,0,0,0,0
18,8480836,Jonathan Gruden,C,PIT,24,0,0,0,0
18,8484314,Jiri Smejkal,L,OTT,28,0,0,0,0
18,8475780,Chris Wagner,R,COL,33,0,0,0,0
18,8482070,Mitchell Chaffee,R,TBL,26,0,0,0,0
18,8479546,Oskar Steen,C,BOS,26,0,0,0,0
18,8483597,Milos Kelemen,L,ARI,25,0,0,0,0
18,8481789,Tye Kartye,L,SEA,23,0,0,0,0
18,8484325,Waltteri Merela,C,TBL,26,0,0,0,0
18,8479421,Jacob Moverare,D,LAK,26,0,0,0,0
18,8481585,Egor Afanasyev,L,NSH,23,0,0,0,0
18,8479547,Matthew Phillips,R,WSH,26,0,0,0,0
18,8479367,William Lockwood,R,FLA,26,0,0,0,0
18,8481422,Jacob Lucchini,C,MIN,29,0,0,0,0
18,8480468,James Hamblin,L,EDM,25,0,0,0,0
18,8480870,Bo Groulx,C,ANA,24,0,0,0,0
18,8478051,Max Willman,C,NJD,29,0,0,0,0
18,8481556,John Beecher,C,BOS,23,0,0,0,0
18,8478078,Rourke Chartier,C,OTT,28,0,0,0,0
19,8477492,Nathan MacKinnon,C,COL,29,82,60,98,158
19,8478402,Connor McDavid,C,EDM,27,82,53,89,142
19,8479318,Auston Matthews,C,TOR,27,82,60,61,121
19,8481559,Jack Hughes,C,NJD,23,82,41,77,118
19,8476453,Nikita Kucherov,R,TBL,31,82,39,78,117
19,8477956,David Pastrnak,R,BOS,28,82,51,61,112
19,8477934,Leon Draisaitl,C,EDM,29,82,45,64,109
19,8480069,Cale Makar,D,COL,26,82,33,76,109
19,8477939,William Nylander,R,TOR,28,82,47,61,108
19,8478864,Kirill Kaprizov,L,MIN,27,82,50,54,104
19,8471675,Sidney Crosby,C,PIT,37,82,39,65,104
19,8478398,Kyle Connor,L,WPG,28,82,62,37,99
19,8477493,Aleksander Barkov,C,FLA,29,82,27,70,97
19,8478403,Jack Eichel,C,VGK,28,82,46,50,96
19,8474600,Roman Josi,D,NSH,34,82,22,73,95
19,8475172,Nazem Kadri,C,CGY,34,82,36,58,94
19,8478420,Mikko Rantanen,R,COL,28,82,39,54,93
19,8480830,Andrei Svechnikov,R,CAR,24,82,34,59,93
19,8480023,Robert Thomas,C,STL,25,82,33,60,93
19,8478550,Artemi Panarin,L,NYR,33,82,28,65,93
19,8477933,Sam Reinhart,C,FLA,29,82,39,53,92
19,8478414,Timo Meier,R,NJD,28,82,52,39,91
19,8480027,Jason Robertson,L,DAL,25,82,39,52,91
19,8481557,Matt Boldy,L,MIN,23,82,39,52,91
19,8476887,Filip Forsberg,L,NSH,30,82,38,53,91
19,8479323,Adam Fox,D,NYR,26,82,16,75,91
19,8477409,Carter Verhaeghe,C,FLA,29,82,50,40,90
19,8477942,Kevin Fiala,L,LAK,28,82,42,48,90
19,8480002,Nico Hischier,C,NJD,25,82,35,55,90
19,8479385,Jordan Kyrou,C,STL,26,82,33,55,88
19,8476468,J.T. Miller,C,VAN,31,82,31,57,88
19,8481523,Kirby Dach,C,MTL,23,82,15,73,88
19,8478010,Brayden Point,C,TBL,28,82,41,46,87
19,8480012,Elias Pettersson,C,VAN,26,82,40,47,87
19,8479343,Clayton Keller,R,ARI,26,82,41,45,86
19,8477404,Jake Guentzel,C,CAR,30,82,38,48,86
19,8479407,Jesper Bratt,L,NJD,26,82,27,58,85
19,8477946,Dylan Larkin,C,DET,28,82,37,47,84
19,8476459,Mika Zibanejad,C,NYR,31,82,38,45,83
19,8482116,Tim Stützle,C,OTT,22,82,27,56,83
19,8476454,Ryan Nugent-Hopkins,C,EDM,31,82,24,58,82
19,8477501,Valeri Nichushkin,R,COL,29,82,45,36,81
19,8478439,Travis Konecny,R,PHI,27,82,24,57,81
19,8479314,Matthew Tkachuk,L,FLA,27,82,22,59,81
19,8476853,Morgan Rielly,D,TOR,30,82,17,64,81
19,8477402,Pavel Buchnevich,L,STL,29,82,40,40,80
19,8480801,Brady Tkachuk,L,OTT,25,82,33,47,80
19,8475184,Chris Kreider,L,NYR,33,82,49,30,79
19,8471214,Alex Ovechkin,L,WSH,39,82,42,37,79
19,8480800,Quinn Hughes,D,VAN,25,82,13,66,79
19,8478042,Viktor Arvidsson,R,LAK,31,82,35,43,78
19,8475166,John Tavares,C,TOR,34,82,29,48,77
19,8480036,Miro Heiskanen,D,DAL,25,82,19,58,77
19,8478427,Sebastian Aho,C,CAR,27,82,35,41,76
19,8482093,Seth Jarvis,C,CAR,22,82,35,41,76
19,8476389,Vincent Trocheck,C,NYR,31,82,31,44,75
19,8480208,Drake Batherson,R,OTT,26,82,28,47,75
19,8475798,Mikael Granlund,C,SJS,32,82,24,51,75
19,8479420,Tage Thompson,C,BUF,27,82,35,39,74
19,8474564,Steven Stamkos,C,TBL,34,82,30,44,74
19,8475692,Mats Zuccarello,R,MIN,37,82,18,55,73
19,8471698,T.J. Oshie,R,WSH,38,82,38,34,72
19,8475168,Matt Duchene,C,DAL,33,82,30,42,72
19,8477479,Tyler Bertuzzi,L,TOR,29,82,30,42,72
19,8477960,Adrian Kempe,R,LAK,28,82,30,41,71
19,8477949,Alex Tuch,R,BUF,28,82,23,48,71
19,8470794,Joe Pavelski,C,DAL,40,82,23,48,71
19,8480865,Noah Dobson,D,NYI,24,82,15,56,71
19,8475810,Bryan Rust,R,PIT,32,82,29,41,70
19,8476448,William Karlsson,C,VGK,31,82,29,41,70
19,8478445,Mathew Barzal,C,NYI,27,82,23,47,70
19,8471215,Evgeni Malkin,C,PIT,38,82,23,47,70
19,8480434,Sean Durzi,D,ARI,26,82,17,53,70
19,8475754,Brock Nelson,C,NYI,33,82,33,36,69
19,8480018,Nick Suzuki,C,MTL,25,82,30,39,69
19,8476346,Johnny Gaudreau,L,CBJ,31,82,21,48,69
19,8480803,Evan Bouchard,D,EDM,25,82,16,53,69
19,8475786,Zach Hyman,L,EDM,32,82,30,38,68
19,8481540,Cole Caufield,R,MTL,23,82,30,38,68
19,8478975,Mason Marchment,L,DAL,29,82,29,39,68
19,8471685,Anze Kopitar,C,LAK,37,82,28,40,68
19,8475158,Ryan O'Reilly,C,NSH,33,82,27,41,68
19,8476456,Jonathan Huberdeau,C,CGY,31,82,20,48,68
19,8473419,Brad Marchand,L,BOS,36,82,30,37,67
19,8477940,Nikolaj Ehlers,L,WPG,28,82,18,49,67
19,8478407,Vince Dunn,D,SEA,28,82,16,51,67
19,8478038,Devon Toews,D,COL,30,82,12,55,67
19,8480188,Fabian Zetterlund,L,SJS,25,82,30,36,66
19,8478440,Dylan Strome,C,WSH,27,82,24,42,66
19,8479400,Pierre-Luc Dubois,L,LAK,26,82,23,43,66
19,8476539,Jonathan Marchessault,R,VGK,34,82,35,30,65
19,8478449,Roope Hintz,C,DAL,28,82,33,32,65
19,8479542,Brandon Hagel,L,TBL,26,82,31,34,65
19,8477451,Ryan Hartman,R,MIN,30,82,27,38,65
19,8481528,Dylan Cozens,C,BUF,23,82,26,39,65
19,8476881,Tomas Hertl,C,VGK,31,82,26,39,65
19,8473512,Claude Giroux,R,OTT,36,82,25,40,65
19,8475765,Vladimir Tarasenko,R,FLA,33,82,27,37,64
19,8477951,Nick Schmaltz,C,ARI,28,82,21,43,64
19,8477494,Jonathan Drouin,L,COL,29,82,19,45,64
19,8477447,Shea Theodore,D,VGK,29,82,12,52,64
19,8476460,Mark Scheifele,C,WPG,31,82,31,32,63
19,8478401,Pavel Zacha,C,BOS,27,82,25,38,63
19,8479325,Charlie McAvoy,D,BOS,27,82,14,49,63
19,8475167,Victor Hedman,D,TBL,34,82,12,51,63
19,8482684,Luke Hughes,D,NJD,21,82,12,51,63
19,8474590,John Carlson,D,WSH,34,82,11,52,63
19,8477500,Bo Horvat,C,NYI,29,82,31,31,62
19,8474578,Erik Karlsson,D,PIT,34,82,19,43,62
19,8479425,Filip Hronek,D,VAN,27,82,18,44,62
19,8476432,Boone Jenner,C,CBJ,31,82,36,25,61
19,8477935,Sam Bennett,C,FLA,28,82,31,30,61
19,8474586,Jordan Eberle,R,SEA,34,82,26,35,61
19,8482475,Yegor Chinakhov,R,CBJ,23,82,24,37,61
19,8475913,Mark Stone,R,VGK,32,82,23,38,61
19,8474102,David Perron,L,DET,36,82,21,40,61
19,8478047,Michael Bunting,L,PIT,29,82,20,41,61
19,8476462,Dougie Hamilton,D,NJD,31,82,20,41,61
19,8479339,Patrik Laine,L,CBJ,26,82,26,34,60
19,8478873,Troy Terry,R,ANA,27,82,22,38,60
19,8480839,Rasmus Dahlin,D,BUF,24,82,15,45,60
19,8475170,Brayden Schenn,C,STL,33,82,27,32,59
19,8476880,Tom Wilson,R,WSH,30,82,27,32,59
19,8478493,Joel Eriksson Ek,C,MIN,27,82,22,37,59
19,8473994,Jamie Benn,L,DAL,35,82,21,38,59
19,8478055,Gustav Forsling,D,FLA,28,82,11,48,59
19,8480039,Martin Necas,C,CAR,25,82,31,27,58
19,8477955,Jared McCann,L,SEA,28,82,29,29,58
19,8478444,Brock Boeser,R,VAN,27,82,26,32,58
19,8478519,Anthony Cirelli,C,TBL,27,82,24,34,58
19,8479675,Trevor Moore,L,LAK,29,82,22,36,58
19,8482078,Lucas Raymond,L,DET,22,82,19,39,58
19,8482097,Jack Quinn,R,BUF,23,82,16,42,58
19,8478396,Noah Hanifin,D,VGK,27,82,11,47,58
19,8476875,Mike Matheson,D,MTL,30,82,8,50,58
19,8475793,Ryan Johansen,C,PHI,32,82,28,29,57
19,8475726,Tyler Toffoli,C,WPG,32,82,27,30,57
19,8482159,Tyson Foerster,R,PHI,22,82,27,30,57
19,8473986,Alex Killorn,L,ANA,35,82,26,31,57
19,8482124,Quinton Byfield,R,LAK,22,82,16,41,57
19,8476792,Torey Krug,D,STL,33,82,12,45,57
19,8481533,Trevor Zegras,C,ANA,23,82,29,27,56
19,8480185,Eetu Luostarinen,C,FLA,26,82,26,30,56
19,8478856,Conor Garland,R,VAN,28,82,24,32,56
19,8476882,Teuvo Teravainen,L,CAR,30,82,22,34,56
19,8474141,Patrick Kane,R,DET,36,82,19,37,56
19,8481711,Matias Maccelli,L,ARI,24,82,18,38,56
19,8477495,Seth Jones,D,CHI,30,82,17,39,56
19,8482699,Dylan Guenther,R,ARI,21,82,31,24,55
19,8478046,Danton Heinen,L,BOS,29,82,29,26,55
19,8480015,Owen Tippett,R,PHI,25,82,22,33,55
19,8480028,Morgan Frost,C,PHI,25,82,20,35,55
19,8474157,Max Pacioretty,L,WSH,36,82,19,36,55
19,8474679,Gustav Nyquist,C,NSH,35,82,15,40,55
19,8484144,Connor Bedard,C,CHI,19,82,24,30,54
19,8474641,Adam Henrique,C,EDM,34,82,23,31,54
19,8477496,Elias Lindholm,C,VAN,30,82,23,31,54
19,8480014,Gabriel Vilardi,C,WPG,25,82,30,23,53
19,8475314,Anders Lee,L,NYI,34,82,28,25,53
19,8482740,Wyatt Johnston,C,DAL,21,82,25,28,53
19,8482109,Alexis Lafrenière,L,NYR,23,82,23,30,53
19,8482667,William Eklund,L,SJS,22,82,20,33,53
19,8482665,Matty Beniers,C,SEA,22,82,19,34,53
19,8478469,Thomas Chabot,D,OTT,27,82,13,40,53
19,8478366,Frank Vatrano,R,ANA,30,82,28,24,52
19,8475784,Jeff Skinner,C,BUF,32,82,26,26,52
19,8483808,Andrei Kuzmenko,L,CGY,28,82,25,27,52
19,8480797,Joel Farabee,L,PHI,24,82,23,29,52
19,8478472,Mathieu Joseph,R,OTT,27,82,23,29,52
19,8477498,Darnell Nurse,D,EDM,29,82,20,32,52
19,8476905,Chandler Stephenson,C,VGK,30,82,18,34,52
19,8476872,Scott Laughton,C,PHI,30,82,18,34,52
19,8480849,Barrett Hayton,C,ARI,24,82,15,37,52
19,8481546,Cam York,D,PHI,23,82,15,37,52
19,8477504,Josh Morrissey,D,WPG,29,82,6,46,52
19,8477416,Oliver Bjorkstrand,R,SEA,29,82,23,28,51
19,8474563,Drew Doughty,D,LAK,35,82,15,36,51
19,8477986,Brandon Montour,D,FLA,30,82,14,37,51
19,8477932,Aaron Ekblad,D,FLA,28,82,12,39,51
19,8481596,Shane Pinto,C,OTT,24,82,30,20,50
19,8478498,Jake DeBrusk,L,BOS,28,82,27,23,50
19,8482113,Anton Lundell,C,FLA,23,82,20,30,50
19,8475799,Nino Niederreiter,R,WPG,32,82,28,21,49
19,8475714,Calle Jarnkrok,C,TOR,33,82,26,23,49
19,8478474,Lawson Crouse,L,ARI,27,82,24,25,49
19,8476399,Blake Coleman,C,CGY,33,82,24,25,49
19,8477964,Ivan Barbashev,C,VGK,29,82,20,29,49
19,8477476,Artturi Lehkonen,L,COL,29,82,18,31,49
19,8480078,Filip Chytil,C,NYR,25,82,17,32,49
19,8482222,Alexander Barabanov,L,SJS,30,82,16,33,49
19,8477947,Sonny Milano,L,WSH,28,82,16,33,49
19,8480798,Philipp Kurashev,C,CHI,25,82,12,37,49
19,8471724,Kris Letang,D,PIT,37,82,9,40,49
19,8478462,Nicolas Roy,C,VGK,27,82,22,26,48
19,8482745,Mason McTavish,C,ANA,21,82,19,29,48
19,8479999,Casey Mittelstadt,C,COL,26,82,14,34,48
19,8476958,Jaccob Slavin,D,CAR,30,82,10,38,48
19,8479525,Ross Colton,C,COL,28,82,23,24,47
19,8479345,Jakob Chychrun,D,OTT,26,82,14,33,47
19,8478911,Matt Roy,D,LAK,29,82,7,40,47
19,8480893,Kirill Marchenko,R,CBJ,24,82,25,21,46
19,8477511,Anthony Mantha,R,VGK,30,82,20,26,46
19,8478233,Andrew Mangiapane,L,CGY,28,82,18,28,46
19,8481656,Aliaksei Protas,C,WSH,23,82,17,29,46
19,8479415,Michael McLeod,C,NJD,26,82,16,30,46
19,8478460,Zach Werenski,D,CBJ,27,82,13,33,46
19,8477021,Alex Kerfoot,C,ARI,30,82,13,33,46
19,8475744,Evgeny Kuznetsov,C,CAR,32,82,12,34,46
19,8470613,Brent Burns,D,CAR,39,82,12,34,46
19,8475753,Justin Faulk,D,STL,32,82,9,37,46
19,8477998,Warren Foegele,L,EDM,28,82,22,23,45
19,8479992,Michael Rasmussen,C,DET,25,82,19,26,45
19,8474150,Mikael Backlund,C,CGY,35,82,18,27,45
19,8478413,Jordan Greenway,L,BUF,27,82,18,27,45
19,8478542,Evan Rodrigues,C,FLA,31,82,15,30,45
19,8478438,Tommy Novak,C,NSH,27,82,14,31,45
19,8476885,Jacob Trouba,D,NYR,30,82,14,31,45
19,8474565,Alex Pietrangelo,D,VGK,34,82,10,35,45
19,8475764,Cam Fowler,D,ANA,33,82,9,36,45
19,8477503,Max Domi,C,TOR,29,82,8,37,45
19,8480064,Josh Norris,C,OTT,25,82,27,17,44
19,8479337,Alex DeBrincat,R,DET,27,82,26,18,44
19,8481618,Alex Newhook,C,MTL,23,82,24,20,44
19,8482175,JJ Peterka,R,BUF,22,82,24,20,44
19,8475343,Nic Dowd,C,WSH,34,82,24,20,44
19,8482110,Dawson Mercer,C,NJD,23,82,23,21,44
19,8475794,Tyler Seguin,C,DAL,32,82,22,22,44
19,8475151,Kyle Palmieri,C,NYI,33,82,21,23,44
19,8475763,Kevin Hayes,R,STL,32,82,21,23,44
19,8477989,Christian Dvorak,C,MTL,28,82,19,25,44
19,8477429,Andrew Copp,C,DET,30,82,18,26,44
19,8477456,J.T. Compher,L,DET,29,82,17,27,44
19,8475149,Marcus Johansson,L,MIN,34,82,14,30,44
19,8477948,Travis Sanheim,D,PHI,28,82,10,34,44
19,8482671,Owen Power,D,BUF,22,82,5,39,44
19,8479410,Mikhail Sergachev,D,TBL,26,82,4,40,44
19,8475169,Evander Kane,L,EDM,33,82,26,17,43
19,8474715,Cam Atkinson,R,PHI,35,82,24,19,43
19,8475760,Nick Bjugstad,C,ARI,32,82,22,21,43
19,8475722,Jason Zucker,L,NSH,32,82,21,22,43
19,8481624,Ilya Mikheyev,R,VAN,30,82,20,23,43
19,8471218,Blake Wheeler,R,NYR,38,82,18,25,43
19,8480459,Pius Suter,C,VAN,28,82,18,25,43
19,8482705,Cole Sillinger,C,CBJ,21,82,17,26,43
19,8476479,Phillip Danault,C,LAK,31,82,16,27,43
19,8477444,Andre Burakovsky,L,SEA,29,82,15,28,43
19,8479987,Morgan Geekie,C,BOS,26,82,13,30,43
19,8478458,Jack Roslovic,C,NYR,27,82,12,31,43
19,8478397,Rasmus Andersson,D,CGY,28,82,7,36,43
19,8476483,Rickard Rakell,R,PIT,31,82,28,14,42
19,8482146,Luke Evangelista,R,NSH,22,82,25,17,42
19,8479996,Cody Glass,C,NSH,25,82,24,18,42
19,8473563,Nicklas Backstrom,C,WSH,37,82,20,22,42
19,8475218,Mattias Ekholm,D,EDM,34,82,10,32,42
19,8476854,Hampus Lindholm,D,BOS,30,82,5,37,42
19,8473422,Nick Foligno,L,CHI,37,82,20,21,41
19,8475791,Taylor Hall,L,CHI,33,82,19,22,41
19,8482720,Matthew Knies,L,TOR,22,82,18,23,41
19,8476826,Yanni Gourde,C,SEA,33,82,13,28,41
19,8482133,Thomas Bordeleau,C,SJS,22,82,11,30,41
19,8476869,Brady Skjei,D,CAR,30,82,9,32,41
19,8478057,Dakota Joshua,C,VAN,28,82,17,23,40
19,8480220,Noah Cates,L,PHI,25,82,17,23,40
19,8475745,Charlie Coyle,C,BOS,32,82,11,29,40
19,8476927,Teddy Blueger,C,VAN,30,82,10,30,40
19,8481542,Moritz Seider,D,DET,23,82,7,33,40
19,8481068,Yegor Sharangovich,C,CGY,26,82,22,17,39
19,8476921,Jordan Martinook,L,CAR,32,82,20,19,39
19,8475191,Reilly Smith,R,PIT,33,82,18,21,39
19,8474037,James van Riemsdyk,L,BOS,35,82,17,22,39
19,8481604,Pavel Dorofeyev,L,VGK,24,82,16,23,39
19,8477346,MacKenzie Weegar,D,CGY,30,82,13,26,39
19,8477497,Sean Monahan,C,WPG,30,82,12,27,39
19,8481703,Valtteri Puustinen,R,PIT,25,82,12,27,39
19,8481581,Thomas Harley,D,DAL,23,82,10,29,39
19,8480802,Ryan McLeod,C,EDM,25,82,8,31,39
19,8477407,Anthony Duclair,L,TBL,29,82,19,19,38
19,8481560,Arthur Kaliyev,R,LAK,23,82,19,19,38
19,8483515,Juraj Slafkovsky,L,MTL,20,82,18,20,38
19,8475287,Erik Haula,L,NJD,33,82,16,22,38
19,8476458,Ryan Strome,C,ANA,31,82,16,22,38
19,8479390,Taylor Raddysh,R,CHI,26,82,16,22,38
19,8476925,Colton Sissons,C,NSH,31,82,15,23,38
19,8482117,Lukas Reichel,L,CHI,22,82,15,23,38
19,8475768,Jaden Schwartz,C,SEA,32,82,14,24,38
19,8480113,Alex Iafallo,L,WPG,31,82,14,24,38
19,8475848,Brendan Gallagher,R,MTL,32,82,13,25,38
19,8477839,Conor Sheary,L,TBL,32,82,8,30,38
19,8477426,Nicholas Paul,L,TBL,29,82,25,12,37
19,8478109,Victor Olofsson,L,BUF,29,82,18,19,37
19,8479941,Justin Danforth,R,CBJ,31,82,18,19,37
19,8479977,Kailer Yamamoto,R,SEA,26,82,18,19,37
19,8476329,Travis Boyd,C,ARI,31,82,16,21,37
19,8477919,Frederick Gaudreau,C,MIN,31,82,16,21,37
19,8482105,Jake Sanderson,D,OTT,22,82,14,23,37
19,8483457,Lane Hutson,D,MTL,20,82,13,24,37
19,8478463,Anthony Beauvillier,L,NSH,27,82,12,25,37
19,8476906,Shayne Gostisbehere,D,DET,31,82,7,30,37
19,8476463,Jonas Brodin,D,MIN,31,82,4,33,37
19,8476438,Brandon Saad,L,STL,32,82,17,19,36
19,8477944,Jakub Vrana,L,STL,28,82,17,19,36
19,8476374,Sean Kuraly,C,CBJ,31,82,15,21,36
19,8474034,Pat Maroon,L,BOS,36,82,15,21,36
19,8474053,Logan Couture,C,SJS,35,82,14,22,36
19,8481013,Jonatan Berggren,R,DET,24,82,14,22,36
19,8476871,Tanner Pearson,L,MTL,32,82,13,23,36
19,8476292,Ondrej Palat,L,NJD,33,82,8,28,36
19,8476923,Damon Severson,D,CBJ,30,82,7,29,36
19,8476917,Adam Pelech,D,NYI,30,82,5,31,36
19,8480821,Filip Zadina,R,SJS,25,82,22,13,35
19,8477953,Kasperi Kapanen,R,STL,28,82,18,17,35
19,8479365,Trent Frederic,C,BOS,26,82,15,20,35
19,8473533,Jordan Staal,C,CAR,36,82,15,20,35
19,8479351,Sam Steel,C,DAL,26,82,13,22,35
19,8480145,Neal Pionk,D,WPG,29,82,8,27,35
19,8476902,Esa Lindell,D,DAL,30,82,6,29,35
19,8482055,Drew O'Connor,L,PIT,26,82,17,17,34
19,8481186,Logan O'Connor,R,COL,28,82,16,18,34
19,8480855,Jack McBain,C,ARI,24,82,15,19,34
19,8478891,Mason Appleton,C,WPG,28,82,12,22,34
19,8476331,Dylan DeMelo,D,WPG,31,82,4,30,34
19,8475324,Nick Jensen,D,WSH,34,82,3,31,34
19,8478020,Michael Amadio,C,VGK,28,82,21,12,33
19,8473449,Kyle Okposo,R,FLA,36,82,17,16,33
19,8480068,Ryan Poehling,C,PHI,25,82,17,16,33
19,8477450,Jason Dickinson,C,CHI,29,82,17,16,33
19,8481580,Connor McMichael,C,WSH,23,82,17,16,33
19,8476960,Andreas Athanasiou,C,CHI,30,82,13,20,33
19,8476419,Jean-Gabriel Pageau,C,NYI,32,82,12,21,33
19,8474884,Mike Hoffman,C,SJS,35,82,12,21,33
19,8478133,Jake Evans,C,MTL,28,82,11,22,33
19,8480817,K'Andre Miller,D,NYR,24,82,9,24,33
19,8470966,Mark Giordano,D,TOR,41,82,7,26,33
19,8480043,Timothy Liljegren,D,TOR,25,82,5,28,33
19,8476981,Josh Anderson,R,MTL,30,82,19,13,32
19,8482089,Jake Neighbours,L,STL,22,82,18,14,32
19,8479591,Michael Eyssimont,C,TBL,28,82,17,15,32
19,8479661,Tanner Jeannot,L,TBL,27,82,15,17,32
19,8474149,Evgenii Dadonov,R,DAL,35,82,13,19,32
19,8474870,Tyler Johnson,C,CHI,34,82,10,22,32
19,8476931,Jake McCabe,D,TOR,31,82,9,23,32
19,8476392,Adam Lowry,C,WPG,31,82,7,25,32
19,8474716,Jared Spurgeon,D,MIN,35,82,5,27,32
19,8480172,Jan Rutta,D,SJS,34,82,5,27,32
19,8475906,John Klingberg,D,TOR,32,82,4,28,32
19,8482125,Alexander Holtz,R,NJD,22,82,20,11,31
19,8470621,Corey Perry,R,EDM,39,82,18,13,31
19,8479393,Noah Gregor,C,TOR,26,82,15,16,31
19,8480009,Eeli Tolvanen,R,SEA,25,82,11,20,31
19,8476461,Sean Couturier,C,PHI,32,82,8,23,31
19,8480074,Alexandre Texier,C,CBJ,25,82,8,23,31
19,8479398,Samuel Girard,D,COL,26,82,6,25,31
19,8475171,Oliver Ekman-Larsson,D,FLA,33,82,6,25,31
19,8479976,Juuso Valimaki,D,ARI,26,82,5,26,31
19,8480073,Erik Brannstrom,D,OTT,25,82,5,26,31
19,8482655,J.J. Moser,D,ARI,24,82,1,30,31
19,8482259,Bobby McMann,C,TOR,28,82,20,10,30
19,8478508,Yakov Trenin,C,COL,27,82,18,12,30
19,8484153,Leo Carlsson,C,ANA,20,82,17,13,30
19,8478466,Daniel Sprong,R,DET,27,82,16,14,30
19,8476897,Oskar Sundqvist,C,STL,30,82,15,15,30
19,8477508,Curtis Lazar,C,NJD,29,82,14,16,30
19,8478115,Pierre Engvall,L,NYI,28,82,13,17,30
19,8482111,Justin Barron,D,MTL,23,82,12,18,30
19,8476467,Jamie Oleksiak,D,SEA,32,82,11,19,30
19,8475220,Marcus Foligno,L,MIN,33,82,10,20,30
19,8481481,Blake Lizotte,C,LAK,27,82,10,20,30
19,8476480,Vladislav Namestnikov,C,WPG,32,82,9,21,30
19,8474673,TJ Brodie,D,TOR,34,82,6,24,30
19,8479983,Mario Ferraro,D,SJS,26,82,5,25,30
19,8477969,Marcus Pettersson,D,PIT,28,82,5,25,30
19,8477845,Trevor van Riemsdyk,D,WSH,33,82,4,26,30
19,8481554,Kaapo Kakko,R,NYR,23,82,17,12,29
19,8482092,Ridly Greig,C,OTT,22,82,15,14,29
19,8476278,Colin Blackwell,C,CHI,31,82,14,15,29
19,8475164,Jakob Silfverberg,R,ANA,34,82,14,15,29
19,8476873,Mark Jankowski,C,NSH,30,82,13,16,29
19,8479316,Luke Kunin,C,SJS,27,82,13,16,29
19,8480995,Pontus Holmberg,R,TOR,25,82,10,19,29
19,8481522,Peyton Krebs,C,BUF,23,82,8,21,29
19,8475200,Dmitry Orlov,D,CAR,33,82,7,22,29
19,8480336,Sean Walker,D,COL,30,82,5,24,29
19,8478507,John Marino,D,NJD,27,82,5,24,29
19,8478840,Will Borgen,D,SEA,28,82,4,25,29
19,8481535,Nils Hoglander,L,VAN,24,82,17,11,28
19,8481704,Juuso Parssinen,C,NSH,23,82,17,11,28
19,8477952,Robby Fabbri,C,DET,28,82,16,12,28
19,8481517,Brett Leason,R,ANA,25,82,13,15,28
19,8481553,Bobby Brink,R,PHI,23,82,12,16,28
19,8480144,David Kampf,C,TOR,29,82,12,16,28
19,8484166,Adam Fantilli,C,CBJ,20,82,12,16,28
19,8476442,Matt Nieto,L,PIT,32,82,10,18,28
19,8482142,Jamie Drysdale,D,PHI,22,82,6,22,28
19,8478500,Ivan Provorov,D,CBJ,27,82,4,24,28
19,8478882,Vladislav Gavrikov,D,LAK,29,82,4,24,28
19,8481178,Egor Zamula,D,PHI,24,82,3,25,28
19,8479293,Brandon Tanev,L,SEA,33,82,15,12,27
19,8482702,Logan Stankoven,C,DAL,21,82,13,14,27
19,8481477,Nico Sturm,C,SJS,29,82,12,15,27
19,8484145,Zach Benson,L,BUF,19,82,12,15,27
19,8479353,Brett Howden,C,VGK,26,82,11,16,27
19,8475197,Tyson Barrie,D,NSH,33,82,6,21,27
19,8478851,Alexandre Carrier,D,NSH,28,82,6,21,27
19,8478443,Brandon Carlo,D,BOS,28,82,6,21,27
19,8476892,Colton Parayko,D,STL,31,82,4,23,27
19,8475181,Nick Leddy,D,STL,33,82,3,24,27
19,8480246,Nick Perbix,D,TBL,26,82,2,25,27
19,8483431,Logan Cooley,C,ARI,20,82,15,11,26
19,8482079,Marco Rossi,C,MIN,23,82,12,14,26
19,8476469,Joel Armia,R,MTL,31,82,12,14,26
19,8470610,Zach Parise,L,COL,40,82,11,15,26
19,8476624,Barclay Goodrow,C,NYR,31,82,11,15,26
19,8477425,Miles Wood,L,COL,29,82,10,16,26
19,8479514,Rem Pitlick,C,CHI,27,82,9,17,26
19,8483763,Maksymilian Szuber,D,ARI,22,82,8,18,26
19,8474151,Ryan McDonagh,D,NSH,35,82,5,21,26
19,8482245,Artem Zub,D,OTT,29,82,3,23,26
19,8476879,Cody Ceci,D,EDM,31,82,3,23,26
19,8473507,Jeff Petry,D,DET,37,82,2,24,26
19,8478043,Sam Lafferty,C,VAN,29,82,14,11,25
19,8474189,Lars Eller,C,PIT,35,82,13,12,25
19,8482062,Cole Smith,L,NSH,29,82,13,12,25
19,8477220,Nate Schmidt,D,WPG,33,82,7,18,25
19,8480873,Rasmus Sandin,D,WSH,24,82,3,22,25
19,8477488,Brett Pesce,D,CAR,30,82,3,22,25
19,8483490,Pavel Mintyukov,D,ANA,21,82,3,22,25
19,8477369,Carson Soucy,D,VAN,30,82,9,15,24
19,8480871,Adam Boqvist,D,CBJ,24,82,8,16,24
19,8482166,Shakir Mukhamadullin,D,SJS,22,82,6,18,24
19,8482679,Matt Coronato,R,CGY,22,82,6,18,24
19,8470600,Ryan Suter,D,DAL,39,82,5,19,24
19,8477931,Tomas Nosek,L,NJD,32,82,5,19,24
19,8483565,Nick Blankenburg,D,CBJ,26,82,5,19,24
19,8476979,Erik Gustafsson,D,NYR,32,82,4,20,24
19,8475790,Erik Gudbranson,D,CBJ,32,82,4,20,24
19,8478569,Noel Acciari,C,PIT,33,82,11,12,23
19,8477392,Hudson Fasching,R,NYI,29,82,10,13,23
19,8479346,Dillon Dube,C,CGY,26,82,10,13,23
19,8478013,Jake Walman,D,DET,28,82,9,14,23
19,8482713,Mackie Samoskevich,R,FLA,22,82,9,14,23
19,8477365,Connor Clifton,D,BUF,29,82,5,18,23
19,8478178,Darren Raddysh,D,TBL,28,82,5,18,23
19,8482807,Ethan Del Mastro,D,CHI,21,82,4,19,23
19,8474574,Tyler Myers,D,VAN,34,82,3,20,23
19,8475233,David Savard,D,MTL,34,82,2,21,23
19,8476525,Colin Miller,D,WPG,32,82,2,21,23
19,8470604,Jeff Carter,C,PIT,39,82,12,10,22
19,8481093,Rafael Harvey-Pinard,L,MTL,25,82,12,10,22
19,8482730,Brandt Clarke,D,LAK,21,82,10,12,22
19,8476422,Mike Reilly,D,NYI,31,82,10,12,22
19,8476457,Adam Larsson,D,SEA,32,82,8,14,22
19,8476312,Josh Manson,D,COL,33,82,8,14,22
19,8481028,Martin Pospisil,C,CGY,25,82,7,15,22
19,8482858,Ryker Evans,D,SEA,23,82,7,15,22
19,8474567,Zach Bogosian,D,MIN,34,82,7,15,22
19,8480796,Martin Fehervary,D,WSH,25,82,6,16,22
19,8475188,Brayden McNabb,D,VGK,33,82,1,21,22
19,8480281,Alexey Toropchenko,R,STL,25,82,15,6,21
19,8482101,Danil Gushchin,L,SJS,22,82,13,8,21
19,8483491,Ivan Miroshnichenko,L,WSH,20,82,9,12,21
19,8481567,Henry Thrun,D,SJS,23,82,9,12,21
19,8479359,Beck Malenstyn,L,WSH,26,82,8,13,21
19,8483012,Logan Morrison,C,SEA,22,82,7,14,21
19,8483482,Tristan Luneau,D,ANA,20,82,6,15,21
19,8477435,Ryan Graves,D,PIT,29,82,6,15,21
19,8480834,Ty Emberson,D,SJS,24,82,6,15,21
19,8475208,Brian Dumoulin,D,SEA,33,82,4,17,21
19,8476429,Scott Mayfield,D,NYI,32,82,3,18,21
19,8475462,Radko Gudas,D,ANA,34,82,2,19,21
19,8481059,Scott Perunovich,D,STL,26,82,1,20,21
19,8476891,Matt Grzelcyk,D,BOS,30,82,1,20,21
19,8475690,Chris Tanev,D,DAL,35,82,0,21,21
19,8477015,Connor Brown,R,EDM,30,82,12,8,20
19,8476878,Zemgus Girgensons,L,BUF,30,82,11,9,20
19,8479423,Alex Nylander,L,CBJ,26,82,10,10,20
19,8483468,Jiri Kulich,C,BUF,20,82,9,11,20
19,8477330,Dominik Kubalik,L,OTT,29,82,9,11,20
19,8483493,Frank Nazar,C,CHI,20,82,9,11,20
19,8481524,Bowen Byram,D,BUF,23,82,9,11,20
19,8480813,Joe Veleno,C,DET,24,82,8,12,20
19,8477406,Mattias Janmark,C,EDM,32,82,7,13,20
19,8483445,Cutter Gauthier,L,ANA,20,82,7,13,20
19,8477506,Ryan Pulock,D,NYI,30,82,5,15,20
19,8478430,Oliver Kylington,D,CGY,27,82,5,15,20
19,8481014,Alexander Romanov,D,NYI,24,82,4,16,20
19,8478136,Jake Middleton,D,MIN,28,82,3,17,20
19,8482073,Braden Schneider,D,NYR,23,82,3,17,20
19,8477353,Tyler Motte,C,TBL,29,82,14,5,19
19,8478831,Kevin Stenlund,C,FLA,28,82,11,8,19
19,8479383,Boris Katchouk,L,OTT,26,82,8,11,19
19,8481699,Aku Raty,R,ARI,23,82,8,11,19
19,8481601,Simon Holmstrom,R,NYI,23,82,6,13,19
19,8479980,Nicolas Hague,D,VGK,26,82,6,13,19
19,8482666,Scott Morrow,D,CAR,22,82,6,13,19
19,8483524,Shane Wright,C,SEA,20,82,6,13,19
19,8482762,Simon Edvinsson,D,DET,21,82,6,13,19
19,8480448,Parker Kelly,L,OTT,25,82,4,15,19
19,8480807,Mattias Samuelsson,D,BUF,24,82,3,16,19
19,8481606,Jordan Spence,D,LAK,23,82,3,16,19
19,8476915,Jujhar Khaira,L,MIN,30,82,11,7,18
19,8482074,Connor Zary,C,CGY,23,82,9,9,18
19,8479324,Ryan Lindgren,D,NYR,26,82,7,11,18
19,8483495,Simon Nemec,D,NJD,20,82,5,13,18
19,8483505,Matthew Poitras,C,BOS,20,82,4,14,18
19,8475279,Ben Chiarot,D,DET,33,82,3,15,18
19,8482624,Daniil Miromanov,D,CGY,27,82,3,15,18
19,8479371,Dante Fabbro,D,NSH,26,82,3,15,18
19,8480035,Henri Jokiharju,D,BUF,25,82,3,15,18
19,8474166,Alec Martinez,D,VGK,37,82,3,15,18
19,8475455,Brenden Dillon,D,WPG,34,82,1,17,18
19,8478399,Jonas Siegenthaler,D,NJD,27,82,0,18,18
19,8477505,Alexander Wennberg,C,NYR,30,82,12,5,17
19,8473453,Trevor Lewis,C,LAK,37,82,11,6,17
19,8476822,Luke Glendening,C,TBL,35,82,11,6,17
19,8475231,Casey Cizikas,C,NYI,33,82,9,8,17
19,8473504,Cal Clutterbuck,R,NYI,37,82,8,9,17
19,8477499,Rasmus Ristolainen,D,PHI,30,82,7,10,17
19,8477034,Jaycob Megna,D,CHI,32,82,7,10,17
19,8482122,Brock Faber,D,MIN,22,82,5,12,17
19,8482809,Jackson Blake,R,CAR,21,82,5,12,17
19,8478468,Jeremy Lauzon,D,NSH,27,82,5,12,17
19,8484911,Collin Graf,R,SJS,22,82,4,13,17
19,8479369,Andrew Peeke,D,BOS,26,82,0,17,17
19,8483397,Marc McLaughlin,C,BOS,25,82,12,4,16
19,8475842,Sam Carrick,C,EDM,32,82,7,9,16
19,8480806,Isac Lundestrom,C,ANA,25,82,6,10,16
19,8483499,Liam Ohgren,L,MIN,20,82,6,10,16
19,8484203,Bradly Nadeau,L,CAR,19,82,5,11,16
19,8475177,Calvin de Haan,D,TBL,33,82,4,12,16
19,8480860,Kevin Bahl,D,NJD,24,82,4,12,16
19,8481537,Nikita Okhotiuk,D,CGY,24,82,3,13,16
19,8482087,Kaiden Guhle,D,MTL,22,82,2,14,16
19,8478416,Erik Cernak,D,TBL,27,82,1,15,16
19,8476967,Brett Kulak,D,EDM,30,82,1,15,16
19,8481568,Alex Vlasic,D,CHI,23,82,0,16,16
19,8482155,Alex Laferriere,R,LAK,23,82,8,7,15
19,8474009,Nick Bonino,C,NYR,36,82,6,9,15
19,8482516,Matthew Kessel,D,STL,24,82,6,9,15
19,8479998,Mikey Anderson,D,LAK,25,82,5,10,15
19,8482859,Zack Ostapchuk,C,OTT,21,82,5,10,15
19,8482803,Olen Zellweger,D,ANA,21,82,4,11,15
19,8481599,Victor Soderstrom,D,ARI,23,82,3,12,15
19,8480058,Pierre-Olivier Joseph,D,PIT,25,82,3,12,15
19,8475179,Dmitry Kulikov,D,FLA,34,82,1,14,15
19,8481605,Jackson LaCombe,D,ANA,23,82,0,15,15
19,8479291,Kevin Rooney,C,CGY,31,82,8,6,14
19,8484149,Gavin Brindley,C,CBJ,20,82,7,7,14
19,8475825,Jani Hakanpää,D,DAL,32,82,5,9,14
19,8477507,Nikita Zadorov,D,VAN,29,82,4,10,14
19,8481016,Ruslan Iskhakov,C,NYI,24,82,4,10,14
19,8475762,Derek Forbort,D,BOS,32,82,3,11,14
19,8478451,Ethan Bear,D,WSH,27,82,3,11,14
19,8474013,Ian Cole,D,VAN,35,82,1,13,14
19,8482737,Zack Bolduc,C,STL,21,82,1,13,14
19,8480879,Jacob Bernard-Docker,D,OTT,24,82,0,14,14
19,8476858,Phillip Di Giuseppe,L,VAN,31,82,9,4,13
19,8482733,Logan Mailloux,D,MTL,31,82,6,7,13
19,8481030,Jack St. Ivany,D,PIT,25,82,4,9,13
19,8483471,Brad Lambert,C,WPG,31,82,4,9,13
19,8483489,Fraser Minten,C,TOR,31,82,6,6,12
19,8478408,Travis Dermott,D,ARI,28,82,5,7,12
19,8477335,Kyle Burroughs,D,SJS,29,82,3,9,12
19,8476473,Connor Murphy,D,CHI,31,82,2,10,12
19,8481578,Graeme Clarke,R,NJD,23,82,7,4,11
19,8482177,Marat Khusnutdinov,C,MIN,22,82,5,6,11
19,8482470,Ilya Solovyov,D,CGY,24,82,2,9,11
19,8480031,Maxime Comtois,L,CAR,25,82,2,9,11
19,8476372,Nick Seeler,D,PHI,31,82,1,10,11
19,8482145,Mavrik Bourque,C,DAL,22,82,6,4,10
19,8482118,Sam Colangelo,R,ANA,23,82,4,6,10
19,8479442,Troy Stecher,D,EDM,30,82,3,7,10
19,8482712,Oskar Olausson,R,COL,22,82,3,7,10
19,8480990,Declan Chisholm,D,MIN,24,82,3,7,10
19,8483466,Kevin Korchinski,D,CHI,20,82,2,8,10
19,8478859,Niko Mikkola,D,FLA,28,82,0,8,8
19,8471677,Jack Johnson,D,COL,37,82,4,3,7
19,8477950,Tony DeAngelo,D,CAR,29,0,0,0,0
19,8481577,Philip Tomasino,C,NSH,23,0,0,0,0
19,8482660,Kent Johnson,C,CBJ,22,0,0,0,0
19,8481019,David Gustafsson,C,WPG,24,0,0,0,0
19,8479348,Kale Clague,D,BUF,26,0,0,0,0
19,8482149,Cole Perfetti,C,WPG,22,0,0,0,0
19,8476952,Dominic Toninato,C,WPG,30,0,0,0,0
19,8473473,Milan Lucic,L,BOS,36,0,0,0,0
19,8480829,Jesperi Kotkaniemi,C,CAR,24,0,0,0,0
19,8474602,Justin Schultz,D,SEA,34,0,0,0,0
19,8480049,Dylan Samberg,D,WPG,25,0,0,0,0
19,8479372,Josh Mahura,D,FLA,26,0,0,0,0
19,8480878,Nils Lundkvist,D,DAL,24,0,0,0,0
19,8479982,Conor Timmins,D,TOR,26,0,0,0,0
19,8474031,Kevin Shattenkirk,D,BOS,35,0,0,0,0
19,8480835,Jack Drury,C,CAR,24,0,0,0,0
19,8480008,Adam Ruzicka,C,ARI,25,0,0,0,0
19,8479402,Jake Bean,D,CBJ,26,0,0,0,0
19,8476474,Stefan Noesen,R,CAR,31,0,0,0,0
19,8480884,Calen Addison,D,SJS,24,0,0,0,0
19,8476994,Vinnie Hinostroza,C,PIT,30,0,0,0,0
19,8477987,Ryan Donato,C,CHI,28,0,0,0,0
19,8481582,Nicholas Robertson,L,TOR,23,0,0,0,0
19,8478452,Caleb Jones,D,COL,27,0,0,0,0
19,8480157,Calle Rosen,D,STL,30,0,0,0,0
19,8481609,Vladislav Kolyachonok,D,ARI,23,0,0,0,0
19,8476919,Chris Tierney,C,NJD,30,0,0,0,0
19,8479639,Dylan Coghlan,D,CAR,26,0,0,0,0
19,8475193,Tomas Tatar,L,SEA,34,0,0,0,0
19,8480748,Kiefer Sherwood,L,NSH,29,0,0,0,0
19,8478146,Matthew Highmore,C,OTT,28,0,0,0,0
19,8478970,Jalen Chatfield,D,CAR,28,0,0,0,0
19,8480205,Emil Bemstrom,C,PIT,25,0,0,0,0
19,8471274,Alex Goligoski,D,MIN,39,0,0,0,0
19,8478104,Sammy Blais,L,STL,28,0,0,0,0
19,8476913,Devin Shore,C,SEA,30,0,0,0,0
19,8481708,Zac Jones,D,NYR,24,0,0,0,0
19,8480222,Sebastian Aho,D,NYI,28,0,0,0,0
19,8481598,Philip Broberg,D,EDM,23,0,0,0,0
19,8480789,Oliver Wahlstrom,R,NYI,24,0,0,0,0
19,8480891,Michael Kesselring,D,ARI,24,0,0,0,0
19,8477979,Nicolas Aube-Kubel,R,WSH,28,0,0,0,0
19,8476393,Nick Cousins,C,FLA,31,0,0,0,0
19,8480003,Jesper Boqvist,C,BOS,26,0,0,0,0
19,8479543,Michael Pezzetta,L,MTL,26,0,0,0,0
19,8475855,Jesper Fast,R,CAR,33,0,0,0,0
19,8477018,Ben Hutton,D,VGK,31,0,0,0,0
19,8480762,Eric Robinson,L,BUF,29,0,0,0,0
19,8481058,Jesse Ylönen,R,MTL,25,0,0,0,0
19,8481527,Kaedan Korczak,D,VGK,23,0,0,0,0
19,8482192,Isaak Phillips,D,CHI,23,0,0,0,0
19,8480727,Zach Whitecloud,D,VGK,28,0,0,0,0
19,8480001,Urho Vaakanainen,D,ANA,25,0,0,0,0
19,8480853,Liam Foudy,C,NSH,24,0,0,0,0
19,8475225,Craig Smith,C,DAL,35,0,0,0,0
19,8479972,Mason Shaw,C,MIN,26,0,0,0,0
19,8474040,Sam Gagner,C,EDM,35,0,0,0,0
19,8480196,Jacob Bryson,D,BUF,27,0,0,0,0
19,8475718,Justin Holl,D,DET,32,0,0,0,0
19,8479984,Cal Foote,D,NJD,26,0,0,0,0
19,8480011,Klim Kostin,C,SJS,25,0,0,0,0
19,8482176,Wyatt Kaiser,D,CHI,22,0,0,0,0
19,8476918,Jimmy Vesey,L,NYR,31,0,0,0,0
19,8476988,Matt Benning,D,SJS,30,0,0,0,0
19,8479370,Tyson Jost,C,BUF,26,0,0,0,0
19,8477464,Nic Petan,C,MIN,29,0,0,0,0
19,8477380,Jonny Brodzinski,C,NYR,31,0,0,0,0
19,8480070,Ian Mitchell,D,BOS,25,0,0,0,0
19,8479315,Joey Anderson,R,CHI,26,0,0,0,0
19,8478099,Kevin Labanc,R,SJS,29,0,0,0,0
19,8476874,Olli Maatta,D,DET,30,0,0,0,0
19,8479414,Nathan Bastian,R,NJD,27,0,0,0,0
19,8478434,Keegan Kolesar,R,VGK,27,0,0,0,0
19,8479536,Axel Jonsson-Fjallby,L,WPG,26,0,0,0,0
19,8479671,Mathieu Olivier,R,CBJ,27,0,0,0,0
19,8471709,Marc-Edouard Vlasic,D,SJS,37,0,0,0,0
19,8479328,Julien Gauthier,R,NYI,27,0,0,0,0
19,8478421,A.J. Greer,L,CGY,28,0,0,0,0
19,8477573,Nathan Walker,L,STL,30,0,0,0,0
19,8477478,William Carrier,L,VGK,30,0,0,0,0
19,8479344,Jesse Puljujarvi,R,PIT,26,0,0,0,0
19,8480887,Jordan Harris,D,MTL,24,0,0,0,0
19,8478502,Dennis Gilbert,D,CGY,28,0,0,0,0
19,8480355,Mark Kastelic,C,OTT,25,0,0,0,0
19,8475750,Jon Merrill,D,MIN,32,0,0,0,0
19,8476889,Radek Faksa,C,DAL,30,0,0,0,0
19,8478432,Christian Fischer,R,DET,27,0,0,0,0
19,8479439,Jacob MacDonald,D,SJS,31,0,0,0,0
19,8474568,Luke Schenn,D,NSH,35,0,0,0,0
19,8478454,Noah Juulsen,D,VAN,27,0,0,0,0
19,8475752,Tyler Pitlick,C,NYR,33,0,0,0,0
19,8482148,Hendrix Lapierre,C,WSH,22,0,0,0,0
19,8481167,Brayden Pachal,D,CGY,25,0,0,0,0
19,8478211,Dryden Hunt,L,CGY,29,0,0,0,0
19,8479321,Lucas Johansen,D,WSH,27,0,0,0,0
19,8480950,Ilya Lyubushkin,D,TOR,30,0,0,0,0
19,8479368,Max Jones,L,ANA,26,0,0,0,0
19,8471699,Andrew Cogliano,C,COL,37,0,0,0,0
19,8481521,Ronnie Attard,D,PHI,25,0,0,0,0
19,8481161,Jake Christiansen,D,CBJ,25,0,0,0,0
19,8479458,Nikita Zaitsev,D,CHI,33,0,0,0,0
19,8479619,Michael Carcone,L,ARI,28,0,0,0,0
19,8479026,Philippe Myers,D,TBL,27,0,0,0,0
19,8481617,Vasily Podkolzin,R,VAN,23,0,0,0,0
19,8481701,Santeri Hatakka,D,NJD,23,0,0,0,0
19,8477446,Michael McCarron,R,NSH,29,0,0,0,0
19,8483460,David Jiricek,D,CBJ,21,0,0,0,0
19,8474090,Brendan Smith,D,NJD,35,0,0,0,0
19,8482241,Radim Zohorna,L,PIT,28,0,0,0,0
19,8481032,Paul Cotter,C,VGK,25,0,0,0,0
19,8480289,Morgan Barron,C,WPG,26,0,0,0,0
19,8479379,Givani Smith,R,SJS,26,0,0,0,0
19,8480216,Jacob Peterson,C,SJS,25,0,0,0,0
19,8477851,Jordan Oesterle,D,CGY,32,0,0,0,0
19,8484258,Sam Malinski,D,COL,26,0,0,0,0
19,8478904,Steven Lorentz,C,FLA,28,0,0,0,0
19,8482095,Tyler Kleven,D,OTT,22,0,0,0,0
19,8480980,Connor Dewar,C,TOR,25,0,0,0,0
19,8480848,Ty Dellandrea,C,DAL,24,0,0,0,0
19,8476884,Derrick Pouliot,D,DAL,30,0,0,0,0
19,8480025,MacKenzie Entwistle,R,CHI,25,0,0,0,0
19,8474612,Travis Hamonic,D,OTT,34,0,0,0,0
19,8479336,Carl Grundstrom,R,LAK,27,0,0,0,0
19,8482964,Arber Xhekaj,D,MTL,23,0,0,0,0
19,8471686,Marc Staal,D,PHI,37,0,0,0,0
19,8477887,Patrick Brown,C,BOS,32,0,0,0,0
19,8478495,Denis Gurianov,R,PHI,27,0,0,0,0
19,8481550,Adam Beckman,L,MIN,23,0,0,0,0
19,8480845,Rasmus Kupari,C,WPG,24,0,0,0,0
19,8478585,Derek Ryan,C,EDM,38,0,0,0,0
19,8482141,Lukas Cormier,D,VGK,22,0,0,0,0
19,8477962,Brendan Lemieux,L,CAR,28,0,0,0,0
19,8482861,Vincent Iorio,D,WSH,22,0,0,0,0
19,8479378,Logan Stanley,D,WPG,26,0,0,0,0
19,8473446,Erik Johnson,D,PHI,36,0,0,0,0
19,8481743,Marc Del Gaizo,D,NSH,25,0,0,0,0
19,8478450,Parker Wotherspoon,D,BOS,27,0,0,0,0
19,8477384,Josh Brown,D,ARI,30,0,0,0,0
19,8482165,Yan Kuznetsov,D,CGY,22,0,0,0,0
19,8478424,Jansen Harkins,C,PIT,27,0,0,0,0
19,8482144,Jack Thompson,D,SJS,22,0,0,0,0
19,8479576,Vincent Desharnais,D,EDM,28,0,0,0,0
19,8478512,Austin Czarnik,C,DET,32,0,0,0,0
19,8477527,Ross Johnston,L,ANA,30,0,0,0,0
19,8482094,Daemon Hunt,D,MIN,22,0,0,0,0
19,8481719,Maxwell Crozier,D,TBL,24,0,0,0,0
19,8480192,Johnathan Kovacevic,D,MTL,27,0,0,0,0
19,8479376,Victor Mete,D,PHI,26,0,0,0,0
19,8482511,Mason Lohrei,D,BOS,23,0,0,0,0
19,8478021,William Lagesson,D,ANA,28,0,0,0,0
19,8475795,Dylan McIlrath,D,WSH,32,0,0,0,0
19,8477846,Ryan Carpenter,C,SJS,33,0,0,0,0
19,8481056,Spencer Stastney,D,NSH,24,0,0,0,0
19,8481564,Ryan Johnson,D,BUF,23,0,0,0,0
19,8478017,Mark Friedman,D,VAN,29,0,0,0,0
19,8479320,Max Lajoie,D,TOR,27,0,0,0,0
19,8480075,Cameron Crotty,D,ARI,25,0,0,0,0
19,8484287,Cole McWard,D,VAN,23,0,0,0,0
19,8484254,Akito Hirose,D,VAN,25,0,0,0,0
19,8483407,Brandon Scanlin,D,NYR,25,0,0,0,0
19,8480274,Philip Kemp,D,EDM,25,0,0,0,0
19,8479522,Hardy Haman Aktell,D,WSH,26,0,0,0,0
19,8480007,Jonas Rondbjerg,R,VGK,25,0,0,0,0
19,8477454,Adam Erne,L,EDM,29,0,0,0,0
19,8481679,Maxence Guenette,D,OTT,23,0,0,0,0
19,8477938,Haydn Fleury,D,TBL,28,0,0,0,0
19,8476441,Joel Edmundson,D,TOR,31,0,0,0,0
19,8477903,Garnet Hathaway,R,PHI,33,0,0,0,0
19,8480441,Trey Fix-Wolansky,R,CBJ,25,0,0,0,0
19,8483546,Marshall Rifai,D,TOR,26,0,0,0,0
19,8480084,Nick DeSimone,D,NJD,30,0,0,0,0
19,8481592,Jakob Pelletier,L,CGY,23,0,0,0,0
19,8478011,Louie Belpedio,D,PHI,28,0,0,0,0
19,8477930,Pierre-Edouard Bellemare,L,SEA,39,0,0,0,0
19,8484321,Nikolas Matinpalo,D,OTT,26,0,0,0,0
19,8482067,Connor Mackey,D,NYR,28,0,0,0,0
19,8481806,Louis Crevier,D,CHI,23,0,0,0,0
19,8484326,Patrik Koch,D,ARI,28,0,0,0,0
19,8477971,Andreas Englund,D,LAK,28,0,0,0,0
19,8481751,Lukas Rousek,R,BUF,25,0,0,0,0
19,8481006,Tyler Tucker,D,STL,24,0,0,0,0
19,8481641,Joel Kiviranta,L,COL,28,0,0,0,0
19,8476867,Brendan Gaunce,C,CBJ,30,0,0,0,0
19,8479520,Brandon Duhaime,R,COL,27,0,0,0,0
19,8477073,Kurtis MacDermid,L,NJD,30,0,0,0,0
19,8480874,Adam Ginning,D,PHI,24,0,0,0,0
19,8477473,Justin Bailey,R,SJS,29,0,0,0,0
19,8479066,Ryan Lomberg,L,FLA,30,0,0,0,0
19,8477070,Liam O'Brien,C,ARI,30,0,0,0,0
19,8474618,Marco Scandella,D,STL,34,0,0,0,0
19,8475797,Jarred Tinordi,D,CHI,32,0,0,0,0
19,8481441,Joe Snively,C,WSH,28,0,0,0,0
19,8477244,Chad Ruhwedel,D,NYR,34,0,0,0,0
19,8482077,Dylan Holloway,L,EDM,23,0,0,0,0
19,8479772,Zack MacEwen,R,OTT,28,0,0,0,0
19,8481147,Reese Johnson,C,CHI,26,0,0,0,0
19,8481043,Cole Koepke,L,TBL,26,0,0,0,0
19,8483619,Filip Roos,D,CHI,25,0,0,0,0
19,8481541,Samuel Bolduc,D,NYI,24,0,0,0,0
19,8477810,Joel Hanley,D,CGY,33,0,0,0,0
19,8476907,Mackenzie MacEachern,L,STL,30,0,0,0,0
19,8482652,Walker Duehr,R,CGY,27,0,0,0,0
19,8477126,Jayson Megna,C,BOS,34,0,0,0,0
19,8483398,Declan Carlile,D,TBL,31,0,0,0,0
19,8482929,Emil Lilleberg,D,TBL,23,0,0,0,0
19,8480880,Jakub Lauko,C,BOS,24,0,0,0,0
19,8478874,Adam Gaudette,C,STL,28,0,0,0,0
19,8480245,Olle Lycksell,R,PHI,25,0,0,0,0
19,8480252,Cole Guttman,C,CHI,25,0,0,0,0
19,8477467,Gustav Olofsson,D,SEA,30,0,0,0,0
19,8479968,Vinni Lettieri,C,MIN,29,0,0,0,0
19,8478400,Colin White,C,MTL,27,0,0,0,0
19,8475755,Alexander Petrovic,D,DAL,32,0,0,0,0
19,8481812,Nikolai Knyzhov,D,SJS,27,0,0,0,0
19,8481593,Jayden Struble,D,MTL,23,0,0,0,0
19,8481532,Alex Turcotte,C,LAK,23,0,0,0,0
19,8482126,Emil Andrae,D,PHI,31,0,0,0,0
19,8479944,Zach Aston-Reese,C,DET,30,0,0,0,0
19,8471817,Ryan Reaves,R,TOR,37,0,0,0,0
19,8481206,John Ludvig,D,PIT,24,0,0,0,0
19,8480292,Carson Meyer,R,CBJ,27,0,0,0,0
19,8482496,Nils Aman,C,VAN,24,0,0,0,0
19,8479718,Alex Barré-Boulet,C,TBL,27,0,0,0,0
19,8479994,Jaret Anderson-Dolan,C,NSH,25,0,0,0,0
19,8480184,Gustav Lindstrom,D,ANA,26,0,0,0,0
19,8480890,Jan Jenik,R,ARI,24,0,0,0,0
19,8478067,Oskar Lindblom,L,SJS,28,0,0,0,0
19,8476934,Brock McGinn,L,ANA,30,0,0,0,0
19,8479985,Cale Fleury,D,SEA,26,0,0,0,0
19,8482153,Brendan Brisson,C,VGK,23,0,0,0,0
19,8480021,Jack Studnicka,C,SJS,25,0,0,0,0
19,8484304,Uvis Balinskis,D,FLA,28,0,0,0,0
19,8479981,Jonah Gadjovich,L,FLA,26,0,0,0,0
19,8481716,Dmitri Voronkov,L,CBJ,24,0,0,0,0
19,8482659,Josh Doan,R,ARI,22,0,0,0,0
19,8481122,Simon Benoit,D,TOR,26,0,0,0,0
19,8474709,Matt Martin,L,NYI,35,0,0,0,0
19,8482634,Alex Steeves,C,TOR,25,0,0,0,0
19,8480823,Alexander Alexeyev,D,WSH,25,0,0,0,0
19,8477541,Dakota Mermis,D,MIN,30,0,0,0,0
19,8478477,Mitchell Stephens,C,MTL,27,0,0,0,0
19,8481543,Nikita Alexandrov,C,STL,24,0,0,0,0
19,8482451,Mikael Pyyhtia,L,CBJ,23,0,0,0,0
19,8480306,Grant Hutton,D,NYI,29,0,0,0,0
19,8478028,Fredrik Olofsson,L,COL,28,0,0,0,0
19,8477462,Robert Hagg,D,ANA,29,0,0,0,0
19,8477320,Anton Blidh,L,NYR,29,0,0,0,0
19,8482749,Joshua Roy,R,MTL,21,0,0,0,0
19,8482157,Will Cuylle,L,NYR,22,0,0,0,0
19,8481239,Samuel Fagemo,L,LAK,24,0,0,0,0
19,8481600,Tobias Bjornfot,D,FLA,23,0,0,0,0
19,8478409,Anthony Richard,C,BOS,28,0,0,0,0
19,8474145,Robert Bortuzzo,D,NYI,35,0,0,0,0
19,8475958,Michael Sgarbossa,C,WSH,32,0,0,0,0
19,8479986,Kole Lind,R,SEA,26,0,0,0,0
19,8479249,Andrew Poturalski,C,SEA,30,0,0,0,0
19,8479362,Riley Tufte,L,COL,26,0,0,0,0
19,8479991,Jake Leschyshyn,C,NYR,25,0,0,0,0
19,8479587,Rhett Gardner,C,PHI,28,0,0,0,0
19,8482744,James Malatesta,L,CBJ,21,0,0,0,0
19,8478854,Ryan Shea,D,PIT,27,0,0,0,0
19,8481591,Sam Poulin,R,PIT,23,0,0,0,0
19,8483512,Matt Savoie,C,BUF,20,0,0,0,0
19,8482102,Vasily Ponomarev,C,CAR,22,0,0,0,0
19,8482162,Roby Jarventie,L,OTT,22,0,0,0,0
19,8482172,Landon Slaggert,L,CHI,22,0,0,0,0
19,8482747,Brennan Othmann,L,NYR,21,0,0,0,0
19,8480226,Marián Studenic,R,SEA,26,0,0,0,0
19,8481518,Nolan Foote,L,NJD,24,0,0,0,0
19,8479419,Brett Murray,L,BUF,26,0,0,0,0
19,8482088,Justin Sourdif,R,FLA,22,0,0,0,0
19,8482201,Gage Goncalves,C,TBL,23,0,0,0,0
19,8481754,Nikita Nesterenko,C,ANA,23,0,0,0,0
19,8483531,Brian Halonen,L,NJD,25,0,0,0,0
19,8483920,Pierrick Dube,R,WSH,23,0,0,0,0
19,8480851,Akil Thomas,C,LAK,24,0,0,0,0
19,8475235,Nicolas Deslauriers,L,PHI,33,0,0,0,0
19,8482476,Emil Heineman,L,MTL,23,0,0,0,0
19,8477149,Scott Sabourin,R,SJS,32,0,0,0,0
19,8483549,Lucas Condotta,L,MTL,27,0,0,0,0
19,8483567,Georgii Merkulov,C,BOS,24,0,0,0,0
19,8482765,Isak Rosen,R,BUF,21,0,0,0,0
19,8481237,Kyle MacLean,C,NYI,25,0,0,0,0
19,8481024,Linus Karlsson,C,VAN,25,0,0,0,0
19,8481690,Tyler Angle,C,CBJ,24,0,0,0,0
19,8483570,Ben Meyers,C,ANA,26,0,0,0,0
19,8481655,Cole Schwindt,R,CGY,23,0,0,0,0
19,8481462,Mason Morelli,L,VGK,28,0,0,0,0
19,8483401,Marc Johnstone,R,PIT,28,0,0,0,0
19,8478956,Samuel Laberge,L,NJD,27,0,0,0,0
19,8479533,Joona Koppanen,L,PIT,26,0,0,0,0
19,8482197,Adam Raska,R,MIN,23,0,0,0,0
19,8482250,Callahan Burke,C,CAR,27,0,0,0,0
19,8482784,Zach Dean,C,STL,21,0,0,0,0
19,8484255,Jason Polin,R,COL,25,0,0,0,0
19,8481077,John Leonard,L,ARI,26,0,0,0,0
19,8481534,Raphael Lavoie,C,EDM,24,0,0,0,0
19,8483609,Adam Klapka,R,CGY,24,0,0,0,0
19,8482751,Ryan Winterton,C,SEA,21,0,0,0,0
19,8480267,Sammy Walker,C,MIN,25,0,0,0,0
19,8475766,Austin Watson,L,TBL,32,0,0,0,0
19,8482460,Matt Rempe,C,NYR,22,0,0,0,0
19,8482787,Nikita Chibrikov,R,WPG,31,0,0,0,0
19,8481065,Angus Crookshank,L,OTT,25,0,0,0,0
19,8481070,Hugh McGing,L,STL,26,0,0,0,0
19,8476323,Max McCormick,L,SEA,32,0,0,0,0
19,8483395,Arshdeep Bains,L,VAN,23,0,0,0,0
19,8484259,Ondrej Pavel,C,COL,31,0,0,0,0
19,8483432,Luca Del Bel Belluz,C,CBJ,31,0,0,0,0
19,8483045,Cameron Butler,R,CBJ,31,0,0,0,0
19,8482061,Brandon Biro,L,BUF,26,0,0,0,0
19,8477401,John Hayden,C,SEA,29,0,0,0,0
19,8475278,Byron Froese,C,VGK,33,0,0,0,0
19,8478446,Glenn Gawdin,C,ANA,27,0,0,0,0
19,8477993,Justin Kirkland,C,ARI,28,0,0,0,0
19,8482147,Jean-Luc Foudy,C,COL,22,0,0,0,0
19,8480032,Shane Bowers,C,NJD,25,0,0,0,0
19,8479330,Brandon Gignac,C,MTL,27,0,0,0,0
19,8480776,Sheldon Rempal,R,VGK,29,0,0,0,0
19,8475413,Justin Dowling,C,NJD,34,0,0,0,0
19,8481726,Adam Edstrom,C,NYR,24,0,0,0,0
19,8479638,Justin Brazeau,R,BOS,26,0,0,0,0
19,8480844,Grigori Denisenko,L,VGK,24,0,0,0,0
19,8474062,Riley Nash,C,NYR,35,0,0,0,0
19,8478147,Bokondji Imama,L,OTT,28,0,0,0,0
19,8478881,Brett Seney,L,CHI,28,0,0,0,0
19,8483630,Pavol Regenda,L,ANA,25,0,0,0,0
19,8480836,Jonathan Gruden,C,PIT,24,0,0,0,0
19,8484314,Jiri Smejkal,L,OTT,28,0,0,0,0
19,8475780,Chris Wagner,R,COL,33,0,0,0,0
19,8482070,Mitchell Chaffee,R,TBL,26,0,0,0,0
19,8479546,Oskar Steen,C,BOS,26,0,0,0,0
19,8483597,Milos Kelemen,L,ARI,25,0,0,0,0
19,8481789,Tye Kartye,L,SEA,23,0,0,0,0
19,8484325,Waltteri Merela,C,TBL,26,0,0,0,0
19,8479421,Jacob Moverare,D,LAK,26,0,0,0,0
19,8481585,Egor Afanasyev,L,NSH,23,0,0,0,0
19,8479547,Matthew Phillips,R,WSH,26,0,0,0,0
19,8479367,William Lockwood,R,FLA,26,0,0,0,0
19,8481422,Jacob Lucchini,C,MIN,29,0,0,0,0
19,8480468,James Hamblin,L,EDM,25,0,0,0,0
19,8480870,Bo Groulx,C,ANA,24,0,0,0,0
19,8478051,Max Willman,C,NJD,29,0,0,0,0
19,8481556,John Beecher,C,BOS,23,0,0,0,0
19,8478078,Rourke Chartier,C,OTT,28,0,0,0,0
20,8476453,Nikita Kucherov,R,TBL,31,82,47,87,134
20,8478402,Connor McDavid,C,EDM,27,82,37,90,127
20,8477492,Nathan MacKinnon,C,COL,29,82,52,72,124
20,8477956,David Pastrnak,R,BOS,28,82,50,73,123
20,8479318,Auston Matthews,C,TOR,27,82,54,56,110
20,8477939,William Nylander,R,TOR,28,82,43,65,108
20,8478864,Kirill Kaprizov,L,MIN,27,82,43,59,102
20,8477934,Leon Draisaitl,C,EDM,29,82,46,54,100
20,8480012,Elias Pettersson,C,VAN,26,82,46,54,100
20,8481559,Jack Hughes,C,NJD,23,82,40,60,100
20,8480801,Brady Tkachuk,L,OTT,25,82,37,62,99
20,8479314,Matthew Tkachuk,L,FLA,27,82,33,66,99
20,8478427,Sebastian Aho,C,CAR,27,82,38,58,96
20,8480023,Robert Thomas,C,STL,25,82,29,67,96
20,8477493,Aleksander Barkov,C,FLA,29,82,23,73,96
20,8476887,Filip Forsberg,L,NSH,30,82,42,52,94
20,8478403,Jack Eichel,C,VGK,28,82,42,51,93
20,8475166,John Tavares,C,TOR,34,82,38,54,92
20,8474564,Steven Stamkos,C,TBL,34,82,36,56,92
20,8482116,Tim Stützle,C,OTT,22,82,29,63,92
20,8471675,Sidney Crosby,C,PIT,37,82,43,48,91
20,8476468,J.T. Miller,C,VAN,31,82,25,66,91
20,8477402,Pavel Buchnevich,L,STL,29,82,31,57,88
20,8481557,Matt Boldy,L,MIN,23,82,41,46,87
20,8478420,Mikko Rantanen,R,COL,28,82,32,55,87
20,8478550,Artemi Panarin,L,NYR,33,82,27,60,87
20,8477404,Jake Guentzel,C,CAR,30,82,33,53,86
20,8480830,Andrei Svechnikov,R,CAR,24,82,33,52,85
20,8479385,Jordan Kyrou,C,STL,26,82,30,55,85
20,8480027,Jason Robertson,L,DAL,25,82,26,59,85
20,8476456,Jonathan Huberdeau,C,CGY,31,82,26,59,85
20,8478449,Roope Hintz,C,DAL,28,82,45,39,84
20,8479323,Adam Fox,D,NYR,26,82,24,60,84
20,8475913,Mark Stone,R,VGK,32,82,26,57,83
20,8477933,Sam Reinhart,C,FLA,29,82,42,40,82
20,8478444,Brock Boeser,R,VAN,27,82,39,43,82
20,8471214,Alex Ovechkin,L,WSH,39,82,41,40,81
20,8479420,Tage Thompson,C,BUF,27,82,46,34,80
20,8477942,Kevin Fiala,L,LAK,28,82,27,53,80
20,8479407,Jesper Bratt,L,NJD,26,82,26,54,80
20,8480069,Cale Makar,D,COL,26,82,21,59,80
20,8474590,John Carlson,D,WSH,34,82,18,62,80
20,8477501,Valeri Nichushkin,R,COL,29,82,43,36,79
20,8475172,Nazem Kadri,C,CGY,34,82,25,54,79
20,8480208,Drake Batherson,R,OTT,26,82,29,49,78
20,8480002,Nico Hischier,C,NJD,25,82,32,45,77
20,8481528,Dylan Cozens,C,BUF,23,82,31,46,77
20,8476454,Ryan Nugent-Hopkins,C,EDM,31,82,23,54,77
20,8475692,Mats Zuccarello,R,MIN,37,82,23,54,77
20,8481523,Kirby Dach,C,MTL,23,82,10,67,77
20,8477946,Dylan Larkin,C,DET,28,82,39,37,76
20,8477949,Alex Tuch,R,BUF,28,82,27,49,76
20,8475184,Chris Kreider,L,NYR,33,82,50,25,75
20,8479542,Brandon Hagel,L,TBL,26,82,30,45,75
20,8477951,Nick Schmaltz,C,ARI,28,82,27,48,75
20,8478460,Zach Werenski,D,CBJ,27,82,15,60,75
20,8476432,Boone Jenner,C,CBJ,31,82,45,29,74
20,8478498,Jake DeBrusk,L,BOS,28,82,41,33,74
20,8477409,Carter Verhaeghe,C,FLA,29,82,38,36,74
20,8479343,Clayton Keller,R,ARI,26,82,37,37,74
20,8475794,Tyler Seguin,C,DAL,32,82,30,44,74
20,8473419,Brad Marchand,L,BOS,36,82,23,51,74
20,8475786,Zach Hyman,L,EDM,32,82,38,35,73
20,8476346,Johnny Gaudreau,L,CBJ,31,82,19,54,73
20,8477960,Adrian Kempe,R,LAK,28,82,38,34,72
20,8478440,Dylan Strome,C,WSH,27,82,32,40,72
20,8476460,Mark Scheifele,C,WPG,31,82,28,44,72
20,8478873,Troy Terry,R,ANA,27,82,26,46,72
20,8478439,Travis Konecny,R,PHI,27,82,31,40,71
20,8481533,Trevor Zegras,C,ANA,23,82,25,46,71
20,8479425,Filip Hronek,D,VAN,27,82,16,55,71
20,8479325,Charlie McAvoy,D,BOS,27,82,15,56,71
20,8478010,Brayden Point,C,TBL,28,82,35,35,70
20,8477955,Jared McCann,L,SEA,28,82,34,36,70
20,8479337,Alex DeBrincat,R,DET,27,82,26,44,70
20,8471685,Anze Kopitar,C,LAK,37,82,20,50,70
20,8475167,Victor Hedman,D,TBL,34,82,14,56,70
20,8475784,Jeff Skinner,C,BUF,32,82,35,34,69
20,8476389,Vincent Trocheck,C,NYR,31,82,32,37,69
20,8480797,Joel Farabee,L,PHI,24,82,30,39,69
20,8478047,Michael Bunting,L,PIT,29,82,27,42,69
20,8476459,Mika Zibanejad,C,NYR,31,82,24,45,69
20,8474600,Roman Josi,D,NSH,34,82,19,50,69
20,8481068,Yegor Sharangovich,C,CGY,26,82,35,33,68
20,8478856,Conor Garland,R,VAN,28,82,33,35,68
20,8470794,Joe Pavelski,C,DAL,40,82,24,44,68
20,8471215,Evgeni Malkin,C,PIT,38,82,24,44,68
20,8477940,Nikolaj Ehlers,L,WPG,28,82,24,44,68
20,8474141,Patrick Kane,R,DET,36,82,21,47,68
20,8480800,Quinn Hughes,D,VAN,25,82,8,60,68
20,8477500,Bo Horvat,C,NYI,29,82,34,33,67
20,8482097,Jack Quinn,R,BUF,23,82,25,42,67
20,8482665,Matty Beniers,C,SEA,22,82,25,42,67
20,8482109,Alexis Lafrenière,L,NYR,23,82,33,33,66
20,8478975,Mason Marchment,L,DAL,29,82,30,36,66
20,8482745,Mason McTavish,C,ANA,21,82,33,32,65
20,8473986,Alex Killorn,L,ANA,35,82,26,39,65
20,8475158,Ryan O'Reilly,C,NSH,33,82,25,40,65
20,8482093,Seth Jarvis,C,CAR,22,82,37,27,64
20,8476882,Teuvo Teravainen,L,CAR,30,82,28,36,64
20,8480018,Nick Suzuki,C,MTL,25,82,25,39,64
20,8474586,Jordan Eberle,R,SEA,34,82,25,39,64
20,8473994,Jamie Benn,L,DAL,35,82,21,43,64
20,8478038,Devon Toews,D,COL,30,82,20,44,64
20,8476853,Morgan Rielly,D,TOR,30,82,10,54,64
20,8478414,Timo Meier,R,NJD,28,82,41,22,63
20,8478398,Kyle Connor,L,WPG,28,82,31,32,63
20,8474679,Gustav Nyquist,C,NSH,35,82,22,41,63
20,8474578,Erik Karlsson,D,PIT,34,82,15,48,63
20,8480803,Evan Bouchard,D,EDM,25,82,12,51,63
20,8478397,Rasmus Andersson,D,CGY,28,82,9,54,63
20,8475765,Vladimir Tarasenko,R,FLA,33,82,30,32,62
20,8473512,Claude Giroux,R,OTT,36,82,23,39,62
20,8478445,Mathew Barzal,C,NYI,27,82,14,48,62
20,8475754,Brock Nelson,C,NYI,33,82,30,31,61
20,8478042,Viktor Arvidsson,R,LAK,31,82,28,33,61
20,8475170,Brayden Schenn,C,STL,33,82,28,33,61
20,8475168,Matt Duchene,C,DAL,33,82,25,36,61
20,8475810,Bryan Rust,R,PIT,32,82,25,36,61
20,8481711,Matias Maccelli,L,ARI,24,82,18,43,61
20,8480865,Noah Dobson,D,NYI,24,82,17,44,61
20,8477496,Elias Lindholm,C,VAN,30,82,20,40,60
20,8479999,Casey Mittelstadt,C,COL,26,82,16,44,60
20,8477932,Aaron Ekblad,D,FLA,28,82,15,45,60
20,8480036,Miro Heiskanen,D,DAL,25,82,12,48,60
20,8482699,Dylan Guenther,R,ARI,21,82,30,29,59
20,8476881,Tomas Hertl,C,VGK,31,82,27,32,59
20,8480015,Owen Tippett,R,PHI,25,82,26,33,59
20,8478401,Pavel Zacha,C,BOS,27,82,24,35,59
20,8482078,Lucas Raymond,L,DET,22,82,23,36,59
20,8476905,Chandler Stephenson,C,VGK,30,82,23,36,59
20,8478493,Joel Eriksson Ek,C,MIN,27,82,22,37,59
20,8480434,Sean Durzi,D,ARI,26,82,18,41,59
20,8477935,Sam Bennett,C,FLA,28,82,32,26,58
20,8478233,Andrew Mangiapane,L,CGY,28,82,27,31,58
20,8477511,Anthony Mantha,R,VGK,30,82,23,35,58
20,8481596,Shane Pinto,C,OTT,24,82,22,36,58
20,8475744,Evgeny Kuznetsov,C,CAR,32,82,18,40,58
20,8475745,Charlie Coyle,C,BOS,32,82,15,43,58
20,8478407,Vince Dunn,D,SEA,28,82,10,48,58
20,8480839,Rasmus Dahlin,D,BUF,24,82,8,50,58
20,8475726,Tyler Toffoli,C,WPG,32,82,34,23,57
20,8482159,Tyson Foerster,R,PHI,22,82,27,30,57
20,8477447,Shea Theodore,D,VGK,29,82,11,46,57
20,8475753,Justin Faulk,D,STL,32,82,10,47,57
20,8477451,Ryan Hartman,R,MIN,30,82,28,28,56
20,8476458,Ryan Strome,C,ANA,31,82,18,38,56
20,8477494,Jonathan Drouin,L,COL,29,82,17,39,56
20,8477495,Seth Jones,D,CHI,30,82,17,39,56
20,8477346,MacKenzie Weegar,D,CGY,30,82,16,40,56
20,8475151,Kyle Palmieri,C,NYI,33,82,31,24,55
20,8476448,William Karlsson,C,VGK,31,82,27,28,55
20,8480039,Martin Necas,C,CAR,25,82,26,29,55
20,8477416,Oliver Bjorkstrand,R,SEA,29,82,26,29,55
20,8475798,Mikael Granlund,C,SJS,32,82,17,38,55
20,8477504,Josh Morrissey,D,WPG,29,82,14,41,55
20,8480028,Morgan Frost,C,PHI,25,82,13,42,55
20,8476906,Shayne Gostisbehere,D,DET,31,82,9,46,55
20,8475722,Jason Zucker,L,NSH,32,82,27,27,54
20,8479339,Patrik Laine,L,CBJ,26,82,25,29,54
20,8479675,Trevor Moore,L,LAK,29,82,25,29,54
20,8482110,Dawson Mercer,C,NJD,23,82,16,38,54
20,8477429,Andrew Copp,C,DET,30,82,16,38,54
20,8476539,Jonathan Marchessault,R,VGK,34,82,29,24,53
20,8480188,Fabian Zetterlund,L,SJS,25,82,23,30,53
20,8477476,Artturi Lehkonen,L,COL,29,82,20,33,53
20,8474150,Mikael Backlund,C,CGY,35,82,19,34,53
20,8480798,Philipp Kurashev,C,CHI,25,82,16,37,53
20,8476399,Blake Coleman,C,CGY,33,82,26,26,52
20,8482124,Quinton Byfield,R,LAK,22,82,21,31,52
20,8484144,Connor Bedard,C,CHI,19,82,20,32,52
20,8480220,Noah Cates,L,PHI,25,82,18,34,52
20,8478396,Noah Hanifin,D,VGK,27,82,12,40,52
20,8475764,Cam Fowler,D,ANA,33,82,3,49,52
20,8475768,Jaden Schwartz,C,SEA,32,82,30,21,51
20,8476872,Scott Laughton,C,PHI,30,82,25,26,51
20,8482667,William Eklund,L,SJS,22,82,24,27,51
20,8476925,Colton Sissons,C,NSH,31,82,24,27,51
20,8474037,James van Riemsdyk,L,BOS,35,82,23,28,51
20,8479400,Pierre-Luc Dubois,L,LAK,26,82,20,31,51
20,8480078,Filip Chytil,C,NYR,25,82,17,34,51
20,8476462,Dougie Hamilton,D,NJD,31,82,14,37,51
20,8471724,Kris Letang,D,PIT,37,82,14,37,51
20,8477503,Max Domi,C,TOR,29,82,14,37,51
20,8479410,Mikhail Sergachev,D,TBL,26,82,8,43,51
20,8477497,Sean Monahan,C,WPG,30,82,20,30,50
20,8474157,Max Pacioretty,L,WSH,36,82,19,31,50
20,8482705,Cole Sillinger,C,CBJ,21,82,19,31,50
20,8478438,Tommy Novak,C,NSH,27,82,16,34,50
20,8476792,Torey Krug,D,STL,33,82,8,42,50
20,8475314,Anders Lee,L,NYI,34,82,26,23,49
20,8477998,Warren Foegele,L,EDM,28,82,26,23,49
20,8480068,Ryan Poehling,C,PHI,25,82,25,24,49
20,8477479,Tyler Bertuzzi,L,TOR,29,82,22,27,49
20,8471698,T.J. Oshie,R,WSH,38,82,21,28,49
20,8475793,Ryan Johansen,C,PHI,32,82,20,29,49
20,8475169,Evander Kane,L,EDM,33,82,25,23,48
20,8477456,J.T. Compher,L,DET,29,82,23,25,48
20,8478519,Anthony Cirelli,C,TBL,27,82,20,28,48
20,8475218,Mattias Ekholm,D,EDM,34,82,14,34,48
20,8481540,Cole Caufield,R,MTL,23,82,30,17,47
20,8480064,Josh Norris,C,OTT,25,82,29,18,47
20,8476483,Rickard Rakell,R,PIT,31,82,25,22,47
20,8476880,Tom Wilson,R,WSH,30,82,23,24,47
20,8481618,Alex Newhook,C,MTL,23,82,23,24,47
20,8477426,Nicholas Paul,L,TBL,29,82,22,25,47
20,8482740,Wyatt Johnston,C,DAL,21,82,21,26,47
20,8478462,Nicolas Roy,C,VGK,27,82,20,27,47
20,8475287,Erik Haula,L,NJD,33,82,18,29,47
20,8479987,Morgan Geekie,C,BOS,26,82,16,31,47
20,8476869,Brady Skjei,D,CAR,30,82,14,33,47
20,8470613,Brent Burns,D,CAR,39,82,7,40,47
20,8474102,David Perron,L,DET,36,82,25,21,46
20,8478366,Frank Vatrano,R,ANA,30,82,24,22,46
20,8481656,Aliaksei Protas,C,WSH,23,82,21,25,46
20,8482113,Anton Lundell,C,FLA,23,82,20,26,46
20,8483808,Andrei Kuzmenko,L,CGY,28,82,17,29,46
20,8481581,Thomas Harley,D,DAL,23,82,13,33,46
20,8480014,Gabriel Vilardi,C,WPG,25,82,20,25,45
20,8482146,Luke Evangelista,R,NSH,22,82,20,25,45
20,8477986,Brandon Montour,D,FLA,30,82,18,27,45
20,8475197,Tyson Barrie,D,NSH,33,82,12,33,45
20,8482671,Owen Power,D,BUF,22,82,10,35,45
20,8475171,Oliver Ekman-Larsson,D,FLA,33,82,6,39,45
20,8482175,JJ Peterka,R,BUF,22,82,20,24,44
20,8478463,Anthony Beauvillier,L,NSH,27,82,19,25,44
20,8475791,Taylor Hall,L,CHI,33,82,18,26,44
20,8479365,Trent Frederic,C,BOS,26,82,18,26,44
20,8474563,Drew Doughty,D,LAK,35,82,10,34,44
20,8480893,Kirill Marchenko,R,CBJ,24,82,28,15,43
20,8474641,Adam Henrique,C,EDM,34,82,23,20,43
20,8478466,Daniel Sprong,R,DET,27,82,22,21,43
20,8475799,Nino Niederreiter,R,WPG,32,82,21,22,43
20,8478057,Dakota Joshua,C,VAN,28,82,21,22,43
20,8475848,Brendan Gallagher,R,MTL,32,82,19,24,43
20,8476292,Ondrej Palat,L,NJD,33,82,19,24,43
20,8479992,Michael Rasmussen,C,DET,25,82,15,28,43
20,8478469,Thomas Chabot,D,OTT,27,82,14,29,43
20,8479345,Jakob Chychrun,D,OTT,26,82,13,30,43
20,8480043,Timothy Liljegren,D,TOR,25,82,5,38,43
20,8476438,Brandon Saad,L,STL,32,82,25,17,42
20,8476469,Joel Armia,R,MTL,31,82,21,21,42
20,8481186,Logan O'Connor,R,COL,28,82,20,22,42
20,8479390,Taylor Raddysh,R,CHI,26,82,19,23,42
20,8477952,Robby Fabbri,C,DET,28,82,19,23,42
20,8480849,Barrett Hayton,C,ARI,24,82,15,27,42
20,8477964,Ivan Barbashev,C,VGK,29,82,13,29,42
20,8474565,Alex Pietrangelo,D,VGK,34,82,7,35,42
20,8481542,Moritz Seider,D,DET,23,82,6,36,42
20,8477947,Sonny Milano,L,WSH,28,82,17,24,41
20,8477407,Anthony Duclair,L,TBL,29,82,16,25,41
20,8471218,Blake Wheeler,R,NYR,38,82,15,26,41
20,8478911,Matt Roy,D,LAK,29,82,14,27,41
20,8474715,Cam Atkinson,R,PHI,35,82,13,28,41
20,8480802,Ryan McLeod,C,EDM,25,82,13,28,41
20,8476958,Jaccob Slavin,D,CAR,30,82,11,30,41
20,8480145,Neal Pionk,D,WPG,29,82,8,33,41
20,8475763,Kevin Hayes,R,STL,32,82,18,22,40
20,8480113,Alex Iafallo,L,WPG,31,82,12,28,40
20,8482684,Luke Hughes,D,NJD,21,82,10,30,40
20,8476461,Sean Couturier,C,PHI,32,82,18,21,39
20,8475191,Reilly Smith,R,PIT,33,82,17,22,39
20,8481560,Arthur Kaliyev,R,LAK,23,82,15,24,39
20,8482222,Alexander Barabanov,L,SJS,30,82,14,25,39
20,8478413,Jordan Greenway,L,BUF,27,82,13,26,39
20,8480185,Eetu Luostarinen,C,FLA,26,82,12,27,39
20,8477444,Andre Burakovsky,L,SEA,29,82,12,27,39
20,8476875,Mike Matheson,D,MTL,30,82,11,28,39
20,8476902,Esa Lindell,D,DAL,30,82,11,28,39
20,8478458,Jack Roslovic,C,NYR,27,82,10,29,39
20,8476419,Jean-Gabriel Pageau,C,NYI,32,82,9,30,39
20,8479293,Brandon Tanev,L,SEA,33,82,18,20,38
20,8474716,Jared Spurgeon,D,MIN,35,82,17,21,38
20,8478542,Evan Rodrigues,C,FLA,31,82,16,22,38
20,8477953,Kasperi Kapanen,R,STL,28,82,16,22,38
20,8473422,Nick Foligno,L,CHI,37,82,14,24,38
20,8476927,Teddy Blueger,C,VAN,30,82,14,24,38
20,8482624,Daniil Miromanov,D,CGY,27,82,14,24,38
20,8480459,Pius Suter,C,VAN,28,82,12,26,38
20,8476897,Oskar Sundqvist,C,STL,30,82,12,26,38
20,8481703,Valtteri Puustinen,R,PIT,25,82,10,28,38
20,8480817,K'Andre Miller,D,NYR,24,82,8,30,38
20,8480807,Mattias Samuelsson,D,BUF,24,82,7,31,38
20,8482089,Jake Neighbours,L,STL,22,82,23,14,37
20,8481554,Kaapo Kakko,R,NYR,23,82,20,17,37
20,8477944,Jakub Vrana,L,STL,28,82,18,19,37
20,8479996,Cody Glass,C,NSH,25,82,17,20,37
20,8482055,Drew O'Connor,L,PIT,26,82,16,21,37
20,8477498,Darnell Nurse,D,EDM,29,82,12,25,37
20,8480871,Adam Boqvist,D,CBJ,24,82,11,26,37
20,8474151,Ryan McDonagh,D,NSH,35,82,8,29,37
20,8476923,Damon Severson,D,CBJ,30,82,6,31,37
20,8474053,Logan Couture,C,SJS,35,82,19,17,36
20,8482117,Lukas Reichel,L,CHI,22,82,18,18,36
20,8474189,Lars Eller,C,PIT,35,82,17,19,36
20,8475760,Nick Bjugstad,C,ARI,32,82,15,21,36
20,8478046,Danton Heinen,L,BOS,29,82,14,22,36
20,8473533,Jordan Staal,C,CAR,36,82,14,22,36
20,8474870,Tyler Johnson,C,CHI,34,82,14,22,36
20,8481624,Ilya Mikheyev,R,VAN,30,82,12,24,36
20,8476854,Hampus Lindholm,D,BOS,30,82,8,28,36
20,8475906,John Klingberg,D,TOR,32,82,6,30,36
20,8479398,Samuel Girard,D,COL,26,82,5,31,36
20,8482655,J.J. Moser,D,ARI,24,82,4,32,36
20,8476873,Mark Jankowski,C,NSH,30,82,21,14,35
20,8480281,Alexey Toropchenko,R,STL,25,82,20,15,35
20,8482475,Yegor Chinakhov,R,CBJ,23,82,15,20,35
20,8476480,Vladislav Namestnikov,C,WPG,32,82,15,20,35
20,8476479,Phillip Danault,C,LAK,31,82,14,21,35
20,8477450,Jason Dickinson,C,CHI,29,82,12,23,35
20,8476979,Erik Gustafsson,D,NYR,32,82,8,27,35
20,8479941,Justin Danforth,R,CBJ,31,82,17,17,34
20,8481580,Connor McMichael,C,WSH,23,82,17,17,34
20,8483431,Logan Cooley,C,ARI,20,82,17,17,34
20,8479591,Michael Eyssimont,C,TBL,28,82,16,18,34
20,8476826,Yanni Gourde,C,SEA,33,82,14,20,34
20,8478472,Mathieu Joseph,R,OTT,27,82,12,22,34
20,8474884,Mike Hoffman,C,SJS,35,82,12,22,34
20,8479353,Brett Howden,C,VGK,26,82,12,22,34
20,8478474,Lawson Crouse,L,ARI,27,82,11,23,34
20,8476960,Andreas Athanasiou,C,CHI,30,82,9,25,34
20,8477021,Alex Kerfoot,C,ARI,30,82,7,27,34
20,8481553,Bobby Brink,R,PHI,23,82,7,27,34
20,8473507,Jeff Petry,D,DET,37,82,6,28,34
20,8481535,Nils Hoglander,L,VAN,24,82,24,9,33
20,8481604,Pavel Dorofeyev,L,VGK,24,82,23,10,33
20,8470610,Zach Parise,L,COL,40,82,21,12,33
20,8475714,Calle Jarnkrok,C,TOR,33,82,19,14,33
20,8480009,Eeli Tolvanen,R,SEA,25,82,16,17,33
20,8474149,Evgenii Dadonov,R,DAL,35,82,15,18,33
20,8476871,Tanner Pearson,L,MTL,32,82,14,19,33
20,8482074,Connor Zary,C,CGY,23,82,13,20,33
20,8480336,Sean Walker,D,COL,30,82,11,22,33
20,8478500,Ivan Provorov,D,CBJ,27,82,3,30,33
20,8480873,Rasmus Sandin,D,WSH,24,82,1,32,33
20,8476981,Josh Anderson,R,MTL,30,82,19,13,32
20,8475343,Nic Dowd,C,WSH,34,82,18,14,32
20,8476278,Colin Blackwell,C,CHI,31,82,15,17,32
20,8476329,Travis Boyd,C,ARI,31,82,13,19,32
20,8475188,Brayden McNabb,D,VGK,33,82,5,27,32
20,8476931,Jake McCabe,D,TOR,31,82,4,28,32
20,8482125,Alexander Holtz,R,NJD,22,82,20,11,31
20,8483515,Juraj Slafkovsky,L,MTL,20,82,16,15,31
20,8475220,Marcus Foligno,L,MIN,33,82,14,17,31
20,8478109,Victor Olofsson,L,BUF,29,82,11,20,31
20,8480074,Alexandre Texier,C,CBJ,25,82,11,20,31
20,8477989,Christian Dvorak,C,MTL,28,82,10,21,31
20,8476467,Jamie Oleksiak,D,SEA,32,82,8,23,31
20,8478136,Jake Middleton,D,MIN,28,82,6,25,31
20,8477839,Conor Sheary,L,TBL,32,82,18,12,30
20,8477948,Travis Sanheim,D,PHI,28,82,13,17,30
20,8476463,Jonas Brodin,D,MIN,31,82,6,24,30
20,8477969,Marcus Pettersson,D,PIT,28,82,6,24,30
20,8479977,Kailer Yamamoto,R,SEA,26,82,19,10,29
20,8484153,Leo Carlsson,C,ANA,20,82,15,14,29
20,8480144,David Kampf,C,TOR,29,82,15,14,29
20,8479525,Ross Colton,C,COL,28,82,14,15,29
20,8482079,Marco Rossi,C,MIN,23,82,14,15,29
20,8477425,Miles Wood,L,COL,29,82,13,16,29
20,8478013,Jake Walman,D,DET,28,82,13,16,29
20,8479423,Alex Nylander,L,CBJ,26,82,13,16,29
20,8481601,Simon Holmstrom,R,NYI,23,82,13,16,29
20,8479415,Michael McLeod,C,NJD,26,82,12,17,29
20,8481013,Jonatan Berggren,R,DET,24,82,12,17,29
20,8478055,Gustav Forsling,D,FLA,28,82,9,20,29
20,8476374,Sean Kuraly,C,CBJ,31,82,8,21,29
20,8476885,Jacob Trouba,D,NYR,30,82,7,22,29
20,8481522,Peyton Krebs,C,BUF,23,82,7,22,29
20,8476312,Josh Manson,D,COL,33,82,6,23,29
20,8476917,Adam Pelech,D,NYI,30,82,5,24,29
20,8475279,Ben Chiarot,D,DET,33,82,5,24,29
20,8478399,Jonas Siegenthaler,D,NJD,27,82,5,24,29
20,8477845,Trevor van Riemsdyk,D,WSH,33,82,4,25,29
20,8476892,Colton Parayko,D,STL,31,82,4,25,29
20,8481606,Jordan Spence,D,LAK,23,82,4,25,29
20,8480821,Filip Zadina,R,SJS,25,82,16,12,28
20,8482702,Logan Stankoven,C,DAL,21,82,16,12,28
20,8478043,Sam Lafferty,C,VAN,29,82,15,13,28
20,8478508,Yakov Trenin,C,COL,27,82,14,14,28
20,8482105,Jake Sanderson,D,OTT,22,82,12,16,28
20,8479393,Noah Gregor,C,TOR,26,82,12,16,28
20,8482092,Ridly Greig,C,OTT,22,82,11,17,28
20,8477365,Connor Clifton,D,BUF,29,82,10,18,28
20,8476525,Colin Miller,D,WPG,32,82,7,21,28
20,8483495,Simon Nemec,D,NJD,20,82,6,22,28
20,8475181,Nick Leddy,D,STL,33,82,4,24,28
20,8476457,Adam Larsson,D,SEA,32,82,4,24,28
20,8482720,Matthew Knies,L,TOR,22,82,15,12,27
20,8479983,Mario Ferraro,D,SJS,26,82,10,17,27
20,8478133,Jake Evans,C,MTL,28,82,8,19,27
20,8481481,Blake Lizotte,C,LAK,27,82,8,19,27
20,8475149,Marcus Johansson,L,MIN,34,82,6,21,27
20,8480796,Martin Fehervary,D,WSH,25,82,5,22,27
20,8475462,Radko Gudas,D,ANA,34,82,4,23,27
20,8477488,Brett Pesce,D,CAR,30,82,2,25,27
20,8481517,Brett Leason,R,ANA,25,82,14,12,26
20,8481028,Martin Pospisil,C,CGY,25,82,10,16,26
20,8483524,Shane Wright,C,SEA,20,82,8,18,26
20,8476429,Scott Mayfield,D,NYI,32,82,6,20,26
20,8481546,Cam York,D,PHI,23,82,5,21,26
20,8478882,Vladislav Gavrikov,D,LAK,29,82,5,21,26
20,8470600,Ryan Suter,D,DAL,39,82,4,22,26
20,8475233,David Savard,D,MTL,34,82,3,23,26
20,8476331,Dylan DeMelo,D,WPG,31,82,2,24,26
20,8483763,Maksymilian Szuber,D,ARI,22,82,17,8,25
20,8484145,Zach Benson,L,BUF,19,82,13,12,25
20,8478115,Pierre Engvall,L,NYI,28,82,12,13,25
20,8477508,Curtis Lazar,C,NJD,29,82,10,15,25
20,8481704,Juuso Parssinen,C,NSH,23,82,10,15,25
20,8476624,Barclay Goodrow,C,NYR,31,82,9,16,25
20,8480806,Isac Lundestrom,C,ANA,25,82,9,16,25
20,8480035,Henri Jokiharju,D,BUF,25,82,8,17,25
20,8482122,Brock Faber,D,MIN,22,82,5,20,25
20,8478468,Jeremy Lauzon,D,NSH,27,82,3,22,25
20,8482087,Kaiden Guhle,D,MTL,22,82,3,22,25
20,8470621,Corey Perry,R,EDM,39,82,14,10,24
20,8480813,Joe Veleno,C,DET,24,82,14,10,24
20,8482803,Olen Zellweger,D,ANA,21,82,14,10,24
20,8478020,Michael Amadio,C,VGK,28,82,13,11,24
20,8477330,Dominik Kubalik,L,OTT,29,82,12,12,24
20,8480448,Parker Kelly,L,OTT,25,82,10,14,24
20,8483457,Lane Hutson,D,MTL,20,82,9,15,24
20,8481093,Rafael Harvey-Pinard,L,MTL,25,82,9,15,24
20,8475231,Casey Cizikas,C,NYI,33,82,9,15,24
20,8479351,Sam Steel,C,DAL,26,82,8,16,24
20,8481014,Alexander Romanov,D,NYI,24,82,6,18,24
20,8482245,Artem Zub,D,OTT,29,82,3,21,24
20,8474673,TJ Brodie,D,TOR,34,82,2,22,24
20,8478851,Alexandre Carrier,D,NSH,28,82,2,22,24
20,8484166,Adam Fantilli,C,CBJ,20,82,15,8,23
20,8482155,Alex Laferriere,R,LAK,23,82,14,9,23
20,8479383,Boris Katchouk,L,OTT,26,82,13,10,23
20,8478891,Mason Appleton,C,WPG,28,82,12,11,23
20,8473449,Kyle Okposo,R,FLA,36,82,11,12,23
20,8483505,Matthew Poitras,C,BOS,20,82,10,13,23
20,8476392,Adam Lowry,C,WPG,31,82,9,14,23
20,8483445,Cutter Gauthier,L,ANA,20,82,9,14,23
20,8473563,Nicklas Backstrom,C,WSH,37,82,8,15,23
20,8477919,Frederick Gaudreau,C,MIN,31,82,8,15,23
20,8477015,Connor Brown,R,EDM,30,82,8,15,23
20,8479316,Luke Kunin,C,SJS,27,82,7,16,23
20,8482166,Shakir Mukhamadullin,D,SJS,22,82,7,16,23
20,8475200,Dmitry Orlov,D,CAR,33,82,6,17,23
20,8475164,Jakob Silfverberg,R,ANA,34,82,5,18,23
20,8478430,Oliver Kylington,D,CGY,27,82,5,18,23
20,8477499,Rasmus Ristolainen,D,PHI,30,82,4,19,23
20,8479976,Juuso Valimaki,D,ARI,26,82,3,20,23
20,8475690,Chris Tanev,D,DAL,35,82,3,20,23
20,8479346,Dillon Dube,C,CGY,26,82,16,6,22
20,8480855,Jack McBain,C,ARI,24,82,12,10,22
20,8478569,Noel Acciari,C,PIT,33,82,12,10,22
20,8479661,Tanner Jeannot,L,TBL,27,82,9,13,22
20,8477392,Hudson Fasching,R,NYI,29,82,9,13,22
20,8479359,Beck Malenstyn,L,WSH,26,82,9,13,22
20,8481477,Nico Sturm,C,SJS,29,82,7,15,22
20,8476879,Cody Ceci,D,EDM,31,82,5,17,22
20,8474574,Tyler Myers,D,VAN,34,82,4,18,22
20,8475455,Brenden Dillon,D,WPG,34,82,3,19,22
20,8475179,Dmitry Kulikov,D,FLA,34,82,2,20,22
20,8474034,Pat Maroon,L,BOS,36,82,13,8,21
20,8482807,Ethan Del Mastro,D,CHI,21,82,10,11,21
20,8476921,Jordan Martinook,L,CAR,32,82,9,12,21
20,8482111,Justin Barron,D,MTL,23,82,9,12,21
20,8479514,Rem Pitlick,C,CHI,27,82,9,12,21
20,8477353,Tyler Motte,C,TBL,29,82,9,12,21
20,8481016,Ruslan Iskhakov,C,NYI,24,82,9,12,21
20,8483490,Pavel Mintyukov,D,ANA,21,82,7,14,21
20,8483565,Nick Blankenburg,D,CBJ,26,82,6,15,21
20,8481537,Nikita Okhotiuk,D,CGY,24,82,6,15,21
20,8481178,Egor Zamula,D,PHI,24,82,5,16,21
20,8476422,Mike Reilly,D,NYI,31,82,5,16,21
20,8483499,Liam Ohgren,L,MIN,20,82,5,16,21
20,8475208,Brian Dumoulin,D,SEA,33,82,4,17,21
20,8483468,Jiri Kulich,C,BUF,20,82,4,17,21
20,8475324,Nick Jensen,D,WSH,34,82,3,18,21
20,8479998,Mikey Anderson,D,LAK,25,82,3,18,21
20,8478507,John Marino,D,NJD,27,82,2,19,21
20,8482142,Jamie Drysdale,D,PHI,22,82,2,19,21
20,8476891,Matt Grzelcyk,D,BOS,30,82,2,19,21
20,8480995,Pontus Holmberg,R,TOR,25,82,14,6,20
20,8482259,Bobby McMann,C,TOR,28,82,12,8,20
20,8482679,Matt Coronato,R,CGY,22,82,11,9,20
20,8470604,Jeff Carter,C,PIT,39,82,10,10,20
20,8482133,Thomas Bordeleau,C,SJS,22,82,9,11,20
20,8484149,Gavin Brindley,C,CBJ,20,82,9,11,20
20,8483482,Tristan Luneau,D,ANA,20,82,8,12,20
20,8483493,Frank Nazar,C,CHI,20,82,8,12,20
20,8470966,Mark Giordano,D,TOR,41,82,6,14,20
20,8477220,Nate Schmidt,D,WPG,33,82,5,15,20
20,8480073,Erik Brannstrom,D,OTT,25,82,4,16,20
20,8481059,Scott Perunovich,D,STL,26,82,4,16,20
20,8481568,Alex Vlasic,D,CHI,23,82,4,16,20
20,8475790,Erik Gudbranson,D,CBJ,32,82,3,17,20
20,8477435,Ryan Graves,D,PIT,29,82,3,17,20
20,8476967,Brett Kulak,D,EDM,30,82,2,18,20
20,8476878,Zemgus Girgensons,L,BUF,30,82,9,10,19
20,8484203,Bradly Nadeau,L,CAR,19,82,9,10,19
20,8483397,Marc McLaughlin,C,BOS,25,82,7,12,19
20,8482858,Ryker Evans,D,SEA,23,82,6,13,19
20,8482073,Braden Schneider,D,NYR,23,82,6,13,19
20,8477369,Carson Soucy,D,VAN,30,82,5,14,19
20,8477931,Tomas Nosek,L,NJD,32,82,5,14,19
20,8479324,Ryan Lindgren,D,NYR,26,82,4,15,19
20,8478840,Will Borgen,D,SEA,28,82,3,16,19
20,8473453,Trevor Lewis,C,LAK,37,82,12,6,18
20,8477505,Alexander Wennberg,C,NYR,30,82,10,8,18
20,8482762,Simon Edvinsson,D,DET,21,82,9,9,18
20,8482118,Sam Colangelo,R,ANA,23,82,7,11,18
20,8480246,Nick Perbix,D,TBL,26,82,6,12,18
20,8482733,Logan Mailloux,D,MTL,31,82,6,12,18
20,8482666,Scott Morrow,D,CAR,22,82,5,13,18
20,8476372,Nick Seeler,D,PHI,31,82,5,13,18
20,8477506,Ryan Pulock,D,NYI,30,82,4,14,18
20,8479980,Nicolas Hague,D,VGK,26,82,3,15,18
20,8478416,Erik Cernak,D,TBL,27,82,1,17,18
20,8481524,Bowen Byram,D,BUF,23,82,10,7,17
20,8478443,Brandon Carlo,D,BOS,28,82,5,12,17
20,8474013,Ian Cole,D,VAN,35,82,5,12,17
20,8478451,Ethan Bear,D,WSH,27,82,4,13,17
20,8478859,Niko Mikkola,D,FLA,28,82,4,13,17
20,8478178,Darren Raddysh,D,TBL,28,82,3,14,17
20,8475762,Derek Forbort,D,BOS,32,82,9,7,16
20,8483491,Ivan Miroshnichenko,L,WSH,20,82,7,9,16
20,8476442,Matt Nieto,L,PIT,32,82,6,10,16
20,8482470,Ilya Solovyov,D,CGY,24,82,5,11,16
20,8479369,Andrew Peeke,D,BOS,26,82,3,13,16
20,8479371,Dante Fabbro,D,NSH,26,82,2,14,16
20,8474166,Alec Martinez,D,VGK,37,82,2,14,16
20,8481599,Victor Soderstrom,D,ARI,23,82,2,14,16
20,8480860,Kevin Bahl,D,NJD,24,82,1,15,16
20,8476858,Phillip Di Giuseppe,L,VAN,31,82,9,6,15
20,8484911,Collin Graf,R,SJS,22,82,5,10,15
20,8477507,Nikita Zadorov,D,VAN,29,82,5,10,15
20,8479442,Troy Stecher,D,EDM,30,82,5,10,15
20,8480058,Pierre-Olivier Joseph,D,PIT,25,82,2,13,15
20,8471677,Jack Johnson,D,COL,37,82,1,14,15
20,8482859,Zack Ostapchuk,C,OTT,21,82,8,6,14
20,8476822,Luke Glendening,C,TBL,35,82,7,7,14
20,8473504,Cal Clutterbuck,R,NYI,37,82,7,7,14
20,8482713,Mackie Samoskevich,R,FLA,22,82,6,8,14
20,8480031,Maxime Comtois,L,CAR,25,82,6,8,14
20,8481699,Aku Raty,R,ARI,23,82,4,10,14
20,8482730,Brandt Clarke,D,LAK,21,82,3,11,14
20,8480172,Jan Rutta,D,SJS,34,82,0,14,14
20,8482737,Zack Bolduc,C,STL,21,82,11,2,13
20,8479291,Kevin Rooney,C,CGY,31,82,9,4,13
20,8482062,Cole Smith,L,NSH,29,82,7,6,13
20,8474009,Nick Bonino,C,NYR,36,82,7,6,13
20,8475177,Calvin de Haan,D,TBL,33,82,6,7,13
20,8482177,Marat Khusnutdinov,C,MIN,22,82,6,7,13
20,8481578,Graeme Clarke,R,NJD,23,82,5,8,13
20,8480834,Ty Emberson,D,SJS,24,82,4,9,13
20,8474567,Zach Bogosian,D,MIN,34,82,3,10,13
20,8475825,Jani Hakanpää,D,DAL,32,82,3,10,13
20,8476473,Connor Murphy,D,CHI,31,82,3,10,13
20,8481567,Henry Thrun,D,SJS,23,82,1,12,13
20,8477034,Jaycob Megna,D,CHI,32,82,1,12,13
20,8480879,Jacob Bernard-Docker,D,OTT,24,82,1,12,13
20,8482712,Oskar Olausson,R,COL,22,82,8,4,12
20,8478831,Kevin Stenlund,C,FLA,28,82,6,6,12
20,8482809,Jackson Blake,R,CAR,21,82,6,6,12
20,8481605,Jackson LaCombe,D,ANA,23,82,2,10,12
20,8480990,Declan Chisholm,D,MIN,24,82,3,8,11
20,8483012,Logan Morrison,C,SEA,22,82,1,10,11
20,8475842,Sam Carrick,C,EDM,32,82,6,4,10
20,8477406,Mattias Janmark,C,EDM,32,82,5,5,10
20,8478408,Travis Dermott,D,ARI,28,82,3,7,10
20,8482145,Mavrik Bourque,C,DAL,22,82,5,4,9
20,8483489,Fraser Minten,C,TOR,31,82,5,3,8
20,8477335,Kyle Burroughs,D,SJS,29,82,3,5,8
20,8482516,Matthew Kessel,D,STL,24,82,1,7,8
20,8481030,Jack St. Ivany,D,PIT,25,82,6,1,7
20,8482101,Danil Gushchin,L,SJS,22,82,3,3,6
20,8476915,Jujhar Khaira,L,MIN,30,82,3,3,6
20,8483466,Kevin Korchinski,D,CHI,20,82,0,6,6
20,8483471,Brad Lambert,C,WPG,31,82,2,3,5
20,8477950,Tony DeAngelo,D,CAR,29,0,0,0,0
20,8481577,Philip Tomasino,C,NSH,23,0,0,0,0
20,8482660,Kent Johnson,C,CBJ,22,0,0,0,0
20,8481019,David Gustafsson,C,WPG,24,0,0,0,0
20,8479348,Kale Clague,D,BUF,26,0,0,0,0
20,8482149,Cole Perfetti,C,WPG,22,0,0,0,0
20,8476952,Dominic Toninato,C,WPG,30,0,0,0,0
20,8473473,Milan Lucic,L,BOS,36,0,0,0,0
20,8480829,Jesperi Kotkaniemi,C,CAR,24,0,0,0,0
20,8474602,Justin Schultz,D,SEA,34,0,0,0,0
20,8480049,Dylan Samberg,D,WPG,25,0,0,0,0
20,8479372,Josh Mahura,D,FLA,26,0,0,0,0
20,8480878,Nils Lundkvist,D,DAL,24,0,0,0,0
20,8479982,Conor Timmins,D,TOR,26,0,0,0,0
20,8474031,Kevin Shattenkirk,D,BOS,35,0,0,0,0
20,8480835,Jack Drury,C,CAR,24,0,0,0,0
20,8480008,Adam Ruzicka,C,ARI,25,0,0,0,0
20,8479402,Jake Bean,D,CBJ,26,0,0,0,0
20,8476474,Stefan Noesen,R,CAR,31,0,0,0,0
20,8480884,Calen Addison,D,SJS,24,0,0,0,0
20,8476994,Vinnie Hinostroza,C,PIT,30,0,0,0,0
20,8477987,Ryan Donato,C,CHI,28,0,0,0,0
20,8481582,Nicholas Robertson,L,TOR,23,0,0,0,0
20,8478452,Caleb Jones,D,COL,27,0,0,0,0
20,8480157,Calle Rosen,D,STL,30,0,0,0,0
20,8481609,Vladislav Kolyachonok,D,ARI,23,0,0,0,0
20,8476919,Chris Tierney,C,NJD,30,0,0,0,0
20,8479639,Dylan Coghlan,D,CAR,26,0,0,0,0
20,8475193,Tomas Tatar,L,SEA,34,0,0,0,0
20,8480748,Kiefer Sherwood,L,NSH,29,0,0,0,0
20,8478146,Matthew Highmore,C,OTT,28,0,0,0,0
20,8478970,Jalen Chatfield,D,CAR,28,0,0,0,0
20,8480205,Emil Bemstrom,C,PIT,25,0,0,0,0
20,8471274,Alex Goligoski,D,MIN,39,0,0,0,0
20,8478104,Sammy Blais,L,STL,28,0,0,0,0
20,8476913,Devin Shore,C,SEA,30,0,0,0,0
20,8481708,Zac Jones,D,NYR,24,0,0,0,0
20,8480222,Sebastian Aho,D,NYI,28,0,0,0,0
20,8481598,Philip Broberg,D,EDM,23,0,0,0,0
20,8480789,Oliver Wahlstrom,R,NYI,24,0,0,0,0
20,8480891,Michael Kesselring,D,ARI,24,0,0,0,0
20,8477979,Nicolas Aube-Kubel,R,WSH,28,0,0,0,0
20,8476393,Nick Cousins,C,FLA,31,0,0,0,0
20,8480003,Jesper Boqvist,C,BOS,26,0,0,0,0
20,8479543,Michael Pezzetta,L,MTL,26,0,0,0,0
20,8475855,Jesper Fast,R,CAR,33,0,0,0,0
20,8477018,Ben Hutton,D,VGK,31,0,0,0,0
20,8480762,Eric Robinson,L,BUF,29,0,0,0,0
20,8481058,Jesse Ylönen,R,MTL,25,0,0,0,0
20,8481527,Kaedan Korczak,D,VGK,23,0,0,0,0
20,8482192,Isaak Phillips,D,CHI,23,0,0,0,0
20,8480727,Zach Whitecloud,D,VGK,28,0,0,0,0
20,8480001,Urho Vaakanainen,D,ANA,25,0,0,0,0
20,8480853,Liam Foudy,C,NSH,24,0,0,0,0
20,8475225,Craig Smith,C,DAL,35,0,0,0,0
20,8479972,Mason Shaw,C,MIN,26,0,0,0,0
20,8474040,Sam Gagner,C,EDM,35,0,0,0,0
20,8480196,Jacob Bryson,D,BUF,27,0,0,0,0
20,8475718,Justin Holl,D,DET,32,0,0,0,0
20,8479984,Cal Foote,D,NJD,26,0,0,0,0
20,8480011,Klim Kostin,C,SJS,25,0,0,0,0
20,8482176,Wyatt Kaiser,D,CHI,22,0,0,0,0
20,8476918,Jimmy Vesey,L,NYR,31,0,0,0,0
20,8476988,Matt Benning,D,SJS,30,0,0,0,0
20,8479370,Tyson Jost,C,BUF,26,0,0,0,0
20,8477464,Nic Petan,C,MIN,29,0,0,0,0
20,8477380,Jonny Brodzinski,C,NYR,31,0,0,0,0
20,8480070,Ian Mitchell,D,BOS,25,0,0,0,0
20,8479315,Joey Anderson,R,CHI,26,0,0,0,0
20,8478099,Kevin Labanc,R,SJS,29,0,0,0,0
20,8476874,Olli Maatta,D,DET,30,0,0,0,0
20,8479414,Nathan Bastian,R,NJD,27,0,0,0,0
20,8478434,Keegan Kolesar,R,VGK,27,0,0,0,0
20,8479536,Axel Jonsson-Fjallby,L,WPG,26,0,0,0,0
20,8479671,Mathieu Olivier,R,CBJ,27,0,0,0,0
20,8471709,Marc-Edouard Vlasic,D,SJS,37,0,0,0,0
20,8479328,Julien Gauthier,R,NYI,27,0,0,0,0
20,8478421,A.J. Greer,L,CGY,28,0,0,0,0
20,8477573,Nathan Walker,L,STL,30,0,0,0,0
20,8477478,William Carrier,L,VGK,30,0,0,0,0
20,8479344,Jesse Puljujarvi,R,PIT,26,0,0,0,0
20,8480887,Jordan Harris,D,MTL,24,0,0,0,0
20,8478502,Dennis Gilbert,D,CGY,28,0,0,0,0
20,8480355,Mark Kastelic,C,OTT,25,0,0,0,0
20,8475750,Jon Merrill,D,MIN,32,0,0,0,0
20,8476889,Radek Faksa,C,DAL,30,0,0,0,0
20,8478432,Christian Fischer,R,DET,27,0,0,0,0
20,8479439,Jacob MacDonald,D,SJS,31,0,0,0,0
20,8474568,Luke Schenn,D,NSH,35,0,0,0,0
20,8478454,Noah Juulsen,D,VAN,27,0,0,0,0
20,8475752,Tyler Pitlick,C,NYR,33,0,0,0,0
20,8482148,Hendrix Lapierre,C,WSH,22,0,0,0,0
20,8481167,Brayden Pachal,D,CGY,25,0,0,0,0
20,8478211,Dryden Hunt,L,CGY,29,0,0,0,0
20,8479321,Lucas Johansen,D,WSH,27,0,0,0,0
20,8480950,Ilya Lyubushkin,D,TOR,30,0,0,0,0
20,8479368,Max Jones,L,ANA,26,0,0,0,0
20,8471699,Andrew Cogliano,C,COL,37,0,0,0,0
20,8481521,Ronnie Attard,D,PHI,25,0,0,0,0
20,8481161,Jake Christiansen,D,CBJ,25,0,0,0,0
20,8479458,Nikita Zaitsev,D,CHI,33,0,0,0,0
20,8479619,Michael Carcone,L,ARI,28,0,0,0,0
20,8479026,Philippe Myers,D,TBL,27,0,0,0,0
20,8481617,Vasily Podkolzin,R,VAN,23,0,0,0,0
20,8481701,Santeri Hatakka,D,NJD,23,0,0,0,0
20,8477446,Michael McCarron,R,NSH,29,0,0,0,0
20,8483460,David Jiricek,D,CBJ,21,0,0,0,0
20,8474090,Brendan Smith,D,NJD,35,0,0,0,0
20,8482241,Radim Zohorna,L,PIT,28,0,0,0,0
20,8481032,Paul Cotter,C,VGK,25,0,0,0,0
20,8480289,Morgan Barron,C,WPG,26,0,0,0,0
20,8479379,Givani Smith,R,SJS,26,0,0,0,0
20,8480216,Jacob Peterson,C,SJS,25,0,0,0,0
20,8477851,Jordan Oesterle,D,CGY,32,0,0,0,0
20,8484258,Sam Malinski,D,COL,26,0,0,0,0
20,8478904,Steven Lorentz,C,FLA,28,0,0,0,0
20,8482095,Tyler Kleven,D,OTT,22,0,0,0,0
20,8480980,Connor Dewar,C,TOR,25,0,0,0,0
20,8480848,Ty Dellandrea,C,DAL,24,0,0,0,0
20,8476884,Derrick Pouliot,D,DAL,30,0,0,0,0
20,8480025,MacKenzie Entwistle,R,CHI,25,0,0,0,0
20,8474612,Travis Hamonic,D,OTT,34,0,0,0,0
20,8479336,Carl Grundstrom,R,LAK,27,0,0,0,0
20,8482964,Arber Xhekaj,D,MTL,23,0,0,0,0
20,8471686,Marc Staal,D,PHI,37,0,0,0,0
20,8477887,Patrick Brown,C,BOS,32,0,0,0,0
20,8478495,Denis Gurianov,R,PHI,27,0,0,0,0
20,8481550,Adam Beckman,L,MIN,23,0,0,0,0
20,8480845,Rasmus Kupari,C,WPG,24,0,0,0,0
20,8478585,Derek Ryan,C,EDM,38,0,0,0,0
20,8482141,Lukas Cormier,D,VGK,22,0,0,0,0
20,8477962,Brendan Lemieux,L,CAR,28,0,0,0,0
20,8482861,Vincent Iorio,D,WSH,22,0,0,0,0
20,8479378,Logan Stanley,D,WPG,26,0,0,0,0
20,8473446,Erik Johnson,D,PHI,36,0,0,0,0
20,8481743,Marc Del Gaizo,D,NSH,25,0,0,0,0
20,8478450,Parker Wotherspoon,D,BOS,27,0,0,0,0
20,8477384,Josh Brown,D,ARI,30,0,0,0,0
20,8482165,Yan Kuznetsov,D,CGY,22,0,0,0,0
20,8478424,Jansen Harkins,C,PIT,27,0,0,0,0
20,8482144,Jack Thompson,D,SJS,22,0,0,0,0
20,8479576,Vincent Desharnais,D,EDM,28,0,0,0,0
20,8478512,Austin Czarnik,C,DET,32,0,0,0,0
20,8477527,Ross Johnston,L,ANA,30,0,0,0,0
20,8482094,Daemon Hunt,D,MIN,22,0,0,0,0
20,8481719,Maxwell Crozier,D,TBL,24,0,0,0,0
20,8480192,Johnathan Kovacevic,D,MTL,27,0,0,0,0
20,8479376,Victor Mete,D,PHI,26,0,0,0,0
20,8482511,Mason Lohrei,D,BOS,23,0,0,0,0
20,8478021,William Lagesson,D,ANA,28,0,0,0,0
20,8475795,Dylan McIlrath,D,WSH,32,0,0,0,0
20,8477846,Ryan Carpenter,C,SJS,33,0,0,0,0
20,8481056,Spencer Stastney,D,NSH,24,0,0,0,0
20,8481564,Ryan Johnson,D,BUF,23,0,0,0,0
20,8478017,Mark Friedman,D,VAN,29,0,0,0,0
20,8479320,Max Lajoie,D,TOR,27,0,0,0,0
20,8480075,Cameron Crotty,D,ARI,25,0,0,0,0
20,8484287,Cole McWard,D,VAN,23,0,0,0,0
20,8484254,Akito Hirose,D,VAN,25,0,0,0,0
20,8483407,Brandon Scanlin,D,NYR,25,0,0,0,0
20,8480274,Philip Kemp,D,EDM,25,0,0,0,0
20,8479522,Hardy Haman Aktell,D,WSH,26,0,0,0,0
20,8480007,Jonas Rondbjerg,R,VGK,25,0,0,0,0
20,8477454,Adam Erne,L,EDM,29,0,0,0,0
20,8481679,Maxence Guenette,D,OTT,23,0,0,0,0
20,8477938,Haydn Fleury,D,TBL,28,0,0,0,0
20,8476441,Joel Edmundson,D,TOR,31,0,0,0,0
20,8477903,Garnet Hathaway,R,PHI,33,0,0,0,0
20,8480441,Trey Fix-Wolansky,R,CBJ,25,0,0,0,0
20,8483546,Marshall Rifai,D,TOR,26,0,0,0,0
20,8480084,Nick DeSimone,D,NJD,30,0,0,0,0
20,8481592,Jakob Pelletier,L,CGY,23,0,0,0,0
20,8478011,Louie Belpedio,D,PHI,28,0,0,0,0
20,8477930,Pierre-Edouard Bellemare,L,SEA,39,0,0,0,0
20,8484321,Nikolas Matinpalo,D,OTT,26,0,0,0,0
20,8482067,Connor Mackey,D,NYR,28,0,0,0,0
20,8481806,Louis Crevier,D,CHI,23,0,0,0,0
20,8484326,Patrik Koch,D,ARI,28,0,0,0,0
20,8477971,Andreas Englund,D,LAK,28,0,0,0,0
20,8481751,Lukas Rousek,R,BUF,25,0,0,0,0
20,8481006,Tyler Tucker,D,STL,24,0,0,0,0
20,8481641,Joel Kiviranta,L,COL,28,0,0,0,0
20,8476867,Brendan Gaunce,C,CBJ,30,0,0,0,0
20,8479520,Brandon Duhaime,R,COL,27,0,0,0,0
20,8477073,Kurtis MacDermid,L,NJD,30,0,0,0,0
20,8480874,Adam Ginning,D,PHI,24,0,0,0,0
20,8477473,Justin Bailey,R,SJS,29,0,0,0,0
20,8479066,Ryan Lomberg,L,FLA,30,0,0,0,0
20,8477070,Liam O'Brien,C,ARI,30,0,0,0,0
20,8474618,Marco Scandella,D,STL,34,0,0,0,0
20,8475797,Jarred Tinordi,D,CHI,32,0,0,0,0
20,8481441,Joe Snively,C,WSH,28,0,0,0,0
20,8477244,Chad Ruhwedel,D,NYR,34,0,0,0,0
20,8482077,Dylan Holloway,L,EDM,23,0,0,0,0
20,8479772,Zack MacEwen,R,OTT,28,0,0,0,0
20,8481147,Reese Johnson,C,CHI,26,0,0,0,0
20,8481043,Cole Koepke,L,TBL,26,0,0,0,0
20,8483619,Filip Roos,D,CHI,25,0,0,0,0
20,8481541,Samuel Bolduc,D,NYI,24,0,0,0,0
20,8477810,Joel Hanley,D,CGY,33,0,0,0,0
20,8476907,Mackenzie MacEachern,L,STL,30,0,0,0,0
20,8482652,Walker Duehr,R,CGY,27,0,0,0,0
20,8477126,Jayson Megna,C,BOS,34,0,0,0,0
20,8483398,Declan Carlile,D,TBL,31,0,0,0,0
20,8482929,Emil Lilleberg,D,TBL,23,0,0,0,0
20,8480880,Jakub Lauko,C,BOS,24,0,0,0,0
20,8478874,Adam Gaudette,C,STL,28,0,0,0,0
20,8480245,Olle Lycksell,R,PHI,25,0,0,0,0
20,8480252,Cole Guttman,C,CHI,25,0,0,0,0
20,8477467,Gustav Olofsson,D,SEA,30,0,0,0,0
20,8479968,Vinni Lettieri,C,MIN,29,0,0,0,0
20,8478400,Colin White,C,MTL,27,0,0,0,0
20,8475755,Alexander Petrovic,D,DAL,32,0,0,0,0
20,8481812,Nikolai Knyzhov,D,SJS,27,0,0,0,0
20,8481593,Jayden Struble,D,MTL,23,0,0,0,0
20,8481532,Alex Turcotte,C,LAK,23,0,0,0,0
20,8482126,Emil Andrae,D,PHI,31,0,0,0,0
20,8479944,Zach Aston-Reese,C,DET,30,0,0,0,0
20,8471817,Ryan Reaves,R,TOR,37,0,0,0,0
20,8481206,John Ludvig,D,PIT,24,0,0,0,0
20,8480292,Carson Meyer,R,CBJ,27,0,0,0,0
20,8482496,Nils Aman,C,VAN,24,0,0,0,0
20,8479718,Alex Barré-Boulet,C,TBL,27,0,0,0,0
20,8479994,Jaret Anderson-Dolan,C,NSH,25,0,0,0,0
20,8480184,Gustav Lindstrom,D,ANA,26,0,0,0,0
20,8480890,Jan Jenik,R,ARI,24,0,0,0,0
20,8478067,Oskar Lindblom,L,SJS,28,0,0,0,0
20,8476934,Brock McGinn,L,ANA,30,0,0,0,0
20,8479985,Cale Fleury,D,SEA,26,0,0,0,0
20,8482153,Brendan Brisson,C,VGK,23,0,0,0,0
20,8480021,Jack Studnicka,C,SJS,25,0,0,0,0
20,8484304,Uvis Balinskis,D,FLA,28,0,0,0,0
20,8479981,Jonah Gadjovich,L,FLA,26,0,0,0,0
20,8481716,Dmitri Voronkov,L,CBJ,24,0,0,0,0
20,8482659,Josh Doan,R,ARI,22,0,0,0,0
20,8481122,Simon Benoit,D,TOR,26,0,0,0,0
20,8474709,Matt Martin,L,NYI,35,0,0,0,0
20,8482634,Alex Steeves,C,TOR,25,0,0,0,0
20,8480823,Alexander Alexeyev,D,WSH,25,0,0,0,0
20,8477541,Dakota Mermis,D,MIN,30,0,0,0,0
20,8478477,Mitchell Stephens,C,MTL,27,0,0,0,0
20,8481543,Nikita Alexandrov,C,STL,24,0,0,0,0
20,8482451,Mikael Pyyhtia,L,CBJ,23,0,0,0,0
20,8480306,Grant Hutton,D,NYI,29,0,0,0,0
20,8478028,Fredrik Olofsson,L,COL,28,0,0,0,0
20,8477462,Robert Hagg,D,ANA,29,0,0,0,0
20,8477320,Anton Blidh,L,NYR,29,0,0,0,0
20,8482749,Joshua Roy,R,MTL,21,0,0,0,0
20,8482157,Will Cuylle,L,NYR,22,0,0,0,0
20,8481239,Samuel Fagemo,L,LAK,24,0,0,0,0
20,8481600,Tobias Bjornfot,D,FLA,23,0,0,0,0
20,8478409,Anthony Richard,C,BOS,28,0,0,0,0
20,8474145,Robert Bortuzzo,D,NYI,35,0,0,0,0
20,8475958,Michael Sgarbossa,C,WSH,32,0,0,0,0
20,8479986,Kole Lind,R,SEA,26,0,0,0,0
20,8479249,Andrew Poturalski,C,SEA,30,0,0,0,0
20,8479362,Riley Tufte,L,COL,26,0,0,0,0
20,8479991,Jake Leschyshyn,C,NYR,25,0,0,0,0
20,8479587,Rhett Gardner,C,PHI,28,0,0,0,0
20,8482744,James Malatesta,L,CBJ,21,0,0,0,0
20,8478854,Ryan Shea,D,PIT,27,0,0,0,0
20,8481591,Sam Poulin,R,PIT,23,0,0,0,0
20,8483512,Matt Savoie,C,BUF,20,0,0,0,0
20,8482102,Vasily Ponomarev,C,CAR,22,0,0,0,0
20,8482162,Roby Jarventie,L,OTT,22,0,0,0,0
20,8482172,Landon Slaggert,L,CHI,22,0,0,0,0
20,8482747,Brennan Othmann,L,NYR,21,0,0,0,0
20,8480226,Marián Studenic,R,SEA,26,0,0,0,0
20,8481518,Nolan Foote,L,NJD,24,0,0,0,0
20,8479419,Brett Murray,L,BUF,26,0,0,0,0
20,8482088,Justin Sourdif,R,FLA,22,0,0,0,0
20,8482201,Gage Goncalves,C,TBL,23,0,0,0,0
20,8481754,Nikita Nesterenko,C,ANA,23,0,0,0,0
20,8483531,Brian Halonen,L,NJD,25,0,0,0,0
20,8483920,Pierrick Dube,R,WSH,23,0,0,0,0
20,8480851,Akil Thomas,C,LAK,24,0,0,0,0
20,8475235,Nicolas Deslauriers,L,PHI,33,0,0,0,0
20,8482476,Emil Heineman,L,MTL,23,0,0,0,0
20,8477149,Scott Sabourin,R,SJS,32,0,0,0,0
20,8483549,Lucas Condotta,L,MTL,27,0,0,0,0
20,8483567,Georgii Merkulov,C,BOS,24,0,0,0,0
20,8482765,Isak Rosen,R,BUF,21,0,0,0,0
20,8481237,Kyle MacLean,C,NYI,25,0,0,0,0
20,8481024,Linus Karlsson,C,VAN,25,0,0,0,0
20,8481690,Tyler Angle,C,CBJ,24,0,0,0,0
20,8483570,Ben Meyers,C,ANA,26,0,0,0,0
20,8481655,Cole Schwindt,R,CGY,23,0,0,0,0
20,8481462,Mason Morelli,L,VGK,28,0,0,0,0
20,8483401,Marc Johnstone,R,PIT,28,0,0,0,0
20,8478956,Samuel Laberge,L,NJD,27,0,0,0,0
20,8479533,Joona Koppanen,L,PIT,26,0,0,0,0
20,8482197,Adam Raska,R,MIN,23,0,0,0,0
20,8482250,Callahan Burke,C,CAR,27,0,0,0,0
20,8482784,Zach Dean,C,STL,21,0,0,0,0
20,8484255,Jason Polin,R,COL,25,0,0,0,0
20,8481077,John Leonard,L,ARI,26,0,0,0,0
20,8481534,Raphael Lavoie,C,EDM,24,0,0,0,0
20,8483609,Adam Klapka,R,CGY,24,0,0,0,0
20,8482751,Ryan Winterton,C,SEA,21,0,0,0,0
20,8480267,Sammy Walker,C,MIN,25,0,0,0,0
20,8475766,Austin Watson,L,TBL,32,0,0,0,0
20,8482460,Matt Rempe,C,NYR,22,0,0,0,0
20,8482787,Nikita Chibrikov,R,WPG,31,0,0,0,0
20,8481065,Angus Crookshank,L,OTT,25,0,0,0,0
20,8481070,Hugh McGing,L,STL,26,0,0,0,0
20,8476323,Max McCormick,L,SEA,32,0,0,0,0
20,8483395,Arshdeep Bains,L,VAN,23,0,0,0,0
20,8484259,Ondrej Pavel,C,COL,31,0,0,0,0
20,8483432,Luca Del Bel Belluz,C,CBJ,31,0,0,0,0
20,8483045,Cameron Butler,R,CBJ,31,0,0,0,0
20,8482061,Brandon Biro,L,BUF,26,0,0,0,0
20,8477401,John Hayden,C,SEA,29,0,0,0,0
20,8475278,Byron Froese,C,VGK,33,0,0,0,0
20,8478446,Glenn Gawdin,C,ANA,27,0,0,0,0
20,8477993,Justin Kirkland,C,ARI,28,0,0,0,0
20,8482147,Jean-Luc Foudy,C,COL,22,0,0,0,0
20,8480032,Shane Bowers,C,NJD,25,0,0,0,0
20,8479330,Brandon Gignac,C,MTL,27,0,0,0,0
20,8480776,Sheldon Rempal,R,VGK,29,0,0,0,0
20,8475413,Justin Dowling,C,NJD,34,0,0,0,0
20,8481726,Adam Edstrom,C,NYR,24,0,0,0,0
20,8479638,Justin Brazeau,R,BOS,26,0,0,0,0
20,8480844,Grigori Denisenko,L,VGK,24,0,0,0,0
20,8474062,Riley Nash,C,NYR,35,0,0,0,0
20,8478147,Bokondji Imama,L,OTT,28,0,0,0,0
20,8478881,Brett Seney,L,CHI,28,0,0,0,0
20,8483630,Pavol Regenda,L,ANA,25,0,0,0,0
20,8480836,Jonathan Gruden,C,PIT,24,0,0,0,0
20,8484314,Jiri Smejkal,L,OTT,28,0,0,0,0
20,8475780,Chris Wagner,R,COL,33,0,0,0,0
20,8482070,Mitchell Chaffee,R,TBL,26,0,0,0,0
20,8479546,Oskar Steen,C,BOS,26,0,0,0,0
20,8483597,Milos Kelemen,L,ARI,25,0,0,0,0
20,8481789,Tye Kartye,L,SEA,23,0,0,0,0
20,8484325,Waltteri Merela,C,TBL,26,0,0,0,0
20,8479421,Jacob Moverare,D,LAK,26,0,0,0,0
20,8481585,Egor Afanasyev,L,NSH,23,0,0,0,0
20,8479547,Matthew Phillips,R,WSH,26,0,0,0,0
20,8479367,William Lockwood,R,FLA,26,0,0,0,0
20,8481422,Jacob Lucchini,C,MIN,29,0,0,0,0
20,8480468,James Hamblin,L,EDM,25,0,0,0,0
20,8480870,Bo Groulx,C,ANA,24,0,0,0,0
20,8478051,Max Willman,C,NJD,29,0,0,0,0
20,8481556,John Beecher,C,BOS,23,0,0,0,0
20,8478078,Rourke Chartier,C,OTT,28,0,0,0,0
21,8477492,Nathan MacKinnon,C,COL,29,82,52,91,143
21,8476453,Nikita Kucherov,R,TBL,31,82,34,102,136
21,8478402,Connor McDavid,C,EDM,27,82,48,87,135
21,8478864,Kirill Kaprizov,L,MIN,27,82,51,77,128
21,8479318,Auston Matthews,C,TOR,27,82,65,57,122
21,8477934,Leon Draisaitl,C,EDM,29,82,47,75,122
21,8479314,Matthew Tkachuk,L,FLA,27,82,27,86,113
21,8481559,Jack Hughes,C,NJD,23,82,46,66,112
21,8480069,Cale Makar,D,COL,26,82,33,79,112
21,8477942,Kevin Fiala,L,LAK,28,82,40,71,111
21,8478550,Artemi Panarin,L,NYR,33,82,37,71,108
21,8471675,Sidney Crosby,C,PIT,37,82,38,62,100
21,8478420,Mikko Rantanen,R,COL,28,82,43,56,99
21,8477946,Dylan Larkin,C,DET,28,82,37,62,99
21,8477933,Sam Reinhart,C,FLA,29,82,44,53,97
21,8477956,David Pastrnak,R,BOS,28,82,38,59,97
21,8476468,J.T. Miller,C,VAN,31,82,35,62,97
21,8474141,Patrick Kane,R,DET,36,82,37,59,96
21,8480027,Jason Robertson,L,DAL,25,82,33,62,95
21,8476454,Ryan Nugent-Hopkins,C,EDM,31,82,32,63,95
21,8477404,Jake Guentzel,C,CAR,30,82,37,57,94
21,8482116,Tim Stützle,C,OTT,22,82,40,53,93
21,8474564,Steven Stamkos,C,TBL,34,82,46,46,92
21,8481557,Matt Boldy,L,MIN,23,82,38,54,92
21,8479407,Jesper Bratt,L,NJD,26,82,31,60,91
21,8478403,Jack Eichel,C,VGK,28,82,41,49,90
21,8477949,Alex Tuch,R,BUF,28,82,29,61,90
21,8479420,Tage Thompson,C,BUF,27,82,43,46,89
21,8480012,Elias Pettersson,C,VAN,26,82,39,50,89
21,8475786,Zach Hyman,L,EDM,32,82,52,36,88
21,8482097,Jack Quinn,R,BUF,23,82,35,53,88
21,8478445,Mathew Barzal,C,NYI,27,82,32,56,88
21,8477493,Aleksander Barkov,C,FLA,29,82,29,59,88
21,8478010,Brayden Point,C,TBL,28,82,43,44,87
21,8479337,Alex DeBrincat,R,DET,27,82,36,51,87
21,8475172,Nazem Kadri,C,CGY,34,82,30,57,87
21,8480023,Robert Thomas,C,STL,25,82,27,60,87
21,8480800,Quinn Hughes,D,VAN,25,82,16,71,87
21,8476456,Jonathan Huberdeau,C,CGY,31,82,25,61,86
21,8479343,Clayton Keller,R,ARI,26,82,36,48,84
21,8476346,Johnny Gaudreau,L,CBJ,31,82,25,59,84
21,8476887,Filip Forsberg,L,NSH,30,82,45,38,83
21,8480801,Brady Tkachuk,L,OTT,25,82,38,44,82
21,8478493,Joel Eriksson Ek,C,MIN,27,82,38,44,82
21,8476459,Mika Zibanejad,C,NYR,31,82,28,54,82
21,8475754,Brock Nelson,C,NYI,33,82,44,37,81
21,8477939,William Nylander,R,TOR,28,82,39,42,81
21,8478042,Viktor Arvidsson,R,LAK,31,82,29,52,81
21,8477409,Carter Verhaeghe,C,FLA,29,82,41,39,80
21,8478444,Brock Boeser,R,VAN,27,82,33,47,80
21,8475913,Mark Stone,R,VGK,32,82,25,55,80
21,8475726,Tyler Toffoli,C,WPG,32,82,37,42,79
21,8475166,John Tavares,C,TOR,34,82,25,54,79
21,8479385,Jordan Kyrou,C,STL,26,82,41,37,78
21,8480036,Miro Heiskanen,D,DAL,25,82,17,61,78
21,8471214,Alex Ovechkin,L,WSH,39,82,45,32,77
21,8477501,Valeri Nichushkin,R,COL,29,82,39,38,77
21,8477402,Pavel Buchnevich,L,STL,29,82,30,47,77
21,8476462,Dougie Hamilton,D,NJD,31,82,21,56,77
21,8475784,Jeff Skinner,C,BUF,32,82,36,40,76
21,8480830,Andrei Svechnikov,R,CAR,24,82,34,41,75
21,8478440,Dylan Strome,C,WSH,27,82,33,42,75
21,8471215,Evgeni Malkin,C,PIT,38,82,24,51,75
21,8474600,Roman Josi,D,NSH,34,82,20,55,75
21,8480803,Evan Bouchard,D,EDM,25,82,15,60,75
21,8480002,Nico Hischier,C,NJD,25,82,35,39,74
21,8475184,Chris Kreider,L,NYR,33,82,35,39,74
21,8476389,Vincent Trocheck,C,NYR,31,82,31,43,74
21,8475798,Mikael Granlund,C,SJS,32,82,21,53,74
21,8476448,William Karlsson,C,VGK,31,82,35,38,73
21,8481533,Trevor Zegras,C,ANA,23,82,25,48,73
21,8477955,Jared McCann,L,SEA,28,82,38,34,72
21,8478449,Roope Hintz,C,DAL,28,82,37,35,72
21,8478038,Devon Toews,D,COL,30,82,14,58,72
21,8476853,Morgan Rielly,D,TOR,30,82,14,58,72
21,8479542,Brandon Hagel,L,TBL,26,82,28,43,71
21,8479323,Adam Fox,D,NYR,26,82,17,54,71
21,8480839,Rasmus Dahlin,D,BUF,24,82,12,59,71
21,8475810,Bryan Rust,R,PIT,32,82,37,33,70
21,8480208,Drake Batherson,R,OTT,26,82,26,44,70
21,8474586,Jordan Eberle,R,SEA,34,82,26,44,70
21,8478047,Michael Bunting,L,PIT,29,82,25,45,70
21,8478460,Zach Werenski,D,CBJ,27,82,20,50,70
21,8481523,Kirby Dach,C,MTL,23,82,9,61,70
21,8480865,Noah Dobson,D,NYI,24,82,9,61,70
21,8473419,Brad Marchand,L,BOS,36,82,32,37,69
21,8473512,Claude Giroux,R,OTT,36,82,26,42,68
21,8471685,Anze Kopitar,C,LAK,37,82,24,44,68
21,8476479,Phillip Danault,C,LAK,31,82,24,44,68
21,8474578,Erik Karlsson,D,PIT,34,82,12,56,68
21,8477500,Bo Horvat,C,NYI,29,82,33,34,67
21,8478398,Kyle Connor,L,WPG,28,82,30,37,67
21,8480018,Nick Suzuki,C,MTL,25,82,29,38,67
21,8478427,Sebastian Aho,C,CAR,27,82,28,39,67
21,8478873,Troy Terry,R,ANA,27,82,27,40,67
21,8478439,Travis Konecny,R,PHI,27,82,24,43,67
21,8477447,Shea Theodore,D,VGK,29,82,16,51,67
21,8474679,Gustav Nyquist,C,NSH,35,82,29,37,66
21,8476460,Mark Scheifele,C,WPG,31,82,24,42,66
21,8475692,Mats Zuccarello,R,MIN,37,82,17,49,66
21,8477496,Elias Lindholm,C,VAN,30,82,27,38,65
21,8477416,Oliver Bjorkstrand,R,SEA,29,82,27,38,65
21,8475158,Ryan O'Reilly,C,NSH,33,82,21,44,65
21,8475794,Tyler Seguin,C,DAL,32,82,29,35,64
21,8482093,Seth Jarvis,C,CAR,22,82,29,35,64
21,8479400,Pierre-Luc Dubois,L,LAK,26,82,22,42,64
21,8477021,Alex Kerfoot,C,ARI,30,82,18,46,64
21,8474590,John Carlson,D,WSH,34,82,12,52,64
21,8471724,Kris Letang,D,PIT,37,82,17,46,63
21,8478438,Tommy Novak,C,NSH,27,82,17,46,63
21,8475167,Victor Hedman,D,TBL,34,82,12,51,63
21,8478407,Vince Dunn,D,SEA,28,82,12,51,63
21,8475722,Jason Zucker,L,NSH,32,82,29,33,62
21,8476539,Jonathan Marchessault,R,VGK,34,82,35,26,61
21,8478414,Timo Meier,R,NJD,28,82,32,29,61
21,8480015,Owen Tippett,R,PHI,25,82,28,33,61
21,8475169,Evander Kane,L,EDM,33,82,27,34,61
21,8478519,Anthony Cirelli,C,TBL,27,82,27,34,61
21,8481540,Cole Caufield,R,MTL,23,82,27,34,61
21,8482665,Matty Beniers,C,SEA,22,82,23,38,61
21,8476881,Tomas Hertl,C,VGK,31,82,23,38,61
21,8478975,Mason Marchment,L,DAL,29,82,18,43,61
21,8479339,Patrik Laine,L,CBJ,26,82,23,37,60
21,8477940,Nikolaj Ehlers,L,WPG,28,82,18,42,60
21,8477495,Seth Jones,D,CHI,30,82,14,46,60
21,8478498,Jake DeBrusk,L,BOS,28,82,31,28,59
21,8475170,Brayden Schenn,C,STL,33,82,29,30,59
21,8477494,Jonathan Drouin,L,COL,29,82,16,43,59
21,8476432,Boone Jenner,C,CBJ,31,82,32,26,58
21,8478366,Frank Vatrano,R,ANA,30,82,32,26,58
21,8480188,Fabian Zetterlund,L,SJS,25,82,30,28,58
21,8470794,Joe Pavelski,C,DAL,40,82,25,33,58
21,8475765,Vladimir Tarasenko,R,FLA,33,82,25,33,58
21,8482124,Quinton Byfield,R,LAK,22,82,23,35,58
21,8477951,Nick Schmaltz,C,ARI,28,82,20,38,58
21,8477503,Max Domi,C,TOR,29,82,19,39,58
21,8482078,Lucas Raymond,L,DET,22,82,18,40,58
21,8481711,Matias Maccelli,L,ARI,24,82,14,44,58
21,8479675,Trevor Moore,L,LAK,29,82,25,32,57
21,8478401,Pavel Zacha,C,BOS,27,82,22,35,57
21,8473994,Jamie Benn,L,DAL,35,82,21,36,57
21,8478397,Rasmus Andersson,D,CGY,28,82,14,43,57
21,8481068,Yegor Sharangovich,C,CGY,26,82,34,22,56
21,8479525,Ross Colton,C,COL,28,82,29,27,56
21,8481528,Dylan Cozens,C,BUF,23,82,22,34,56
21,8477444,Andre Burakovsky,L,SEA,29,82,21,35,56
21,8479325,Charlie McAvoy,D,BOS,27,82,5,51,56
21,8482745,Mason McTavish,C,ANA,21,82,26,29,55
21,8477960,Adrian Kempe,R,LAK,28,82,24,31,55
21,8480797,Joel Farabee,L,PHI,24,82,20,35,55
21,8477504,Josh Morrissey,D,WPG,29,82,13,42,55
21,8477346,MacKenzie Weegar,D,CGY,30,82,12,43,55
21,8476875,Mike Matheson,D,MTL,30,82,12,43,55
21,8480014,Gabriel Vilardi,C,WPG,25,82,29,25,54
21,8475168,Matt Duchene,C,DAL,33,82,23,31,54
21,8477476,Artturi Lehkonen,L,COL,29,82,21,33,54
21,8482222,Alexander Barabanov,L,SJS,30,82,16,38,54
21,8479425,Filip Hronek,D,VAN,27,82,11,43,54
21,8483515,Juraj Slafkovsky,L,MTL,20,82,28,25,53
21,8474102,David Perron,L,DET,36,82,26,27,53
21,8477451,Ryan Hartman,R,MIN,30,82,23,30,53
21,8475287,Erik Haula,L,NJD,33,82,23,30,53
21,8474150,Mikael Backlund,C,CGY,35,82,19,34,53
21,8476792,Torey Krug,D,STL,33,82,16,37,53
21,8482667,William Eklund,L,SJS,22,82,14,39,53
21,8478055,Gustav Forsling,D,FLA,28,82,13,40,53
21,8477479,Tyler Bertuzzi,L,TOR,29,82,33,19,52
21,8482113,Anton Lundell,C,FLA,23,82,29,23,52
21,8482699,Dylan Guenther,R,ARI,21,82,24,28,52
21,8475745,Charlie Coyle,C,BOS,32,82,24,28,52
21,8480039,Martin Necas,C,CAR,25,82,23,29,52
21,8475791,Taylor Hall,L,CHI,33,82,22,30,52
21,8476880,Tom Wilson,R,WSH,30,82,19,33,52
21,8478466,Daniel Sprong,R,DET,27,82,19,33,52
21,8476906,Shayne Gostisbehere,D,DET,31,82,18,34,52
21,8477944,Jakub Vrana,L,STL,28,82,28,23,51
21,8477964,Ivan Barbashev,C,VGK,29,82,21,30,51
21,8481656,Aliaksei Protas,C,WSH,23,82,19,32,51
21,8477986,Brandon Montour,D,FLA,30,82,15,36,51
21,8476905,Chandler Stephenson,C,VGK,30,82,12,39,51
21,8481546,Cam York,D,PHI,23,82,10,41,51
21,8482475,Yegor Chinakhov,R,CBJ,23,82,30,20,50
21,8478474,Lawson Crouse,L,ARI,27,82,25,25,50
21,8482159,Tyson Foerster,R,PHI,22,82,24,26,50
21,8478046,Danton Heinen,L,BOS,29,82,23,27,50
21,8479999,Casey Mittelstadt,C,COL,26,82,21,29,50
21,8477407,Anthony Duclair,L,TBL,29,82,20,30,50
21,8479992,Michael Rasmussen,C,DET,25,82,17,33,50
21,8474565,Alex Pietrangelo,D,VGK,34,82,15,35,50
21,8480434,Sean Durzi,D,ARI,26,82,9,41,50
21,8479410,Mikhail Sergachev,D,TBL,26,82,8,42,50
21,8484144,Connor Bedard,C,CHI,19,82,24,25,49
21,8477511,Anthony Mantha,R,VGK,30,82,23,26,49
21,8477426,Nicholas Paul,L,TBL,29,82,23,26,49
21,8475151,Kyle Palmieri,C,NYI,33,82,21,28,49
21,8482089,Jake Neighbours,L,STL,22,82,21,28,49
21,8480220,Noah Cates,L,PHI,25,82,19,30,49
21,8482705,Cole Sillinger,C,CBJ,21,82,15,34,49
21,8482671,Owen Power,D,BUF,22,82,14,35,49
21,8478500,Ivan Provorov,D,CBJ,27,82,5,44,49
21,8476872,Scott Laughton,C,PHI,30,82,25,23,48
21,8474641,Adam Henrique,C,EDM,34,82,23,25,48
21,8475768,Jaden Schwartz,C,SEA,32,82,22,26,48
21,8478057,Dakota Joshua,C,VAN,28,82,22,26,48
21,8474157,Max Pacioretty,L,WSH,36,82,19,29,48
21,8478413,Jordan Greenway,L,BUF,27,82,19,29,48
21,8478458,Jack Roslovic,C,NYR,27,82,19,29,48
21,8471698,T.J. Oshie,R,WSH,38,82,17,31,48
21,8477456,J.T. Compher,L,DET,29,82,17,31,48
21,8475218,Mattias Ekholm,D,EDM,34,82,15,33,48
21,8482109,Alexis Lafrenière,L,NYR,23,82,25,22,47
21,8476483,Rickard Rakell,R,PIT,31,82,24,23,47
21,8477497,Sean Monahan,C,WPG,30,82,23,24,47
21,8476438,Brandon Saad,L,STL,32,82,21,26,47
21,8473422,Nick Foligno,L,CHI,37,82,21,26,47
21,8482110,Dawson Mercer,C,NJD,23,82,20,27,47
21,8480064,Josh Norris,C,OTT,25,82,19,28,47
21,8476854,Hampus Lindholm,D,BOS,30,82,8,39,47
21,8475764,Cam Fowler,D,ANA,33,82,6,41,47
21,8474053,Logan Couture,C,SJS,35,82,23,23,46
21,8471218,Blake Wheeler,R,NYR,38,82,20,26,46
21,8473986,Alex Killorn,L,ANA,35,82,16,30,46
21,8479987,Morgan Geekie,C,BOS,26,82,15,31,46
21,8480873,Rasmus Sandin,D,WSH,24,82,9,37,46
21,8475906,John Klingberg,D,TOR,32,82,3,43,46
21,8481596,Shane Pinto,C,OTT,24,82,21,24,45
21,8475191,Reilly Smith,R,PIT,33,82,21,24,45
21,8478463,Anthony Beauvillier,L,NSH,27,82,18,27,45
21,8474563,Drew Doughty,D,LAK,35,82,12,33,45
21,8482740,Wyatt Johnston,C,DAL,21,82,30,14,44
21,8478856,Conor Garland,R,VAN,28,82,21,23,44
21,8477947,Sonny Milano,L,WSH,28,82,21,23,44
21,8479365,Trent Frederic,C,BOS,26,82,19,25,44
21,8480798,Philipp Kurashev,C,CHI,25,82,17,27,44
21,8478462,Nicolas Roy,C,VGK,27,82,15,29,44
21,8476329,Travis Boyd,C,ARI,31,82,15,29,44
21,8476458,Ryan Strome,C,ANA,31,82,13,31,44
21,8482105,Jake Sanderson,D,OTT,22,82,13,31,44
21,8477429,Andrew Copp,C,DET,30,82,11,33,44
21,8481604,Pavel Dorofeyev,L,VGK,24,82,25,18,43
21,8476399,Blake Coleman,C,CGY,33,82,24,19,43
21,8483808,Andrei Kuzmenko,L,CGY,28,82,22,21,43
21,8480028,Morgan Frost,C,PHI,25,82,14,29,43
21,8475763,Kevin Hayes,R,STL,32,82,12,31,43
21,8480185,Eetu Luostarinen,C,FLA,26,82,22,20,42
21,8477932,Aaron Ekblad,D,FLA,28,82,16,26,42
21,8480078,Filip Chytil,C,NYR,25,82,13,29,42
21,8482684,Luke Hughes,D,NJD,21,82,12,30,42
21,8476826,Yanni Gourde,C,SEA,33,82,11,31,42
21,8470613,Brent Burns,D,CAR,39,82,8,34,42
21,8478469,Thomas Chabot,D,OTT,27,82,7,35,42
21,8481542,Moritz Seider,D,DET,23,82,6,36,42
21,8477998,Warren Foegele,L,EDM,28,82,22,19,41
21,8475793,Ryan Johansen,C,PHI,32,82,22,19,41
21,8480009,Eeli Tolvanen,R,SEA,25,82,22,19,41
21,8475314,Anders Lee,L,NYI,34,82,21,20,41
21,8482175,JJ Peterka,R,BUF,22,82,18,23,41
21,8481560,Arthur Kaliyev,R,LAK,23,82,18,23,41
21,8476292,Ondrej Palat,L,NJD,33,82,16,25,41
21,8474716,Jared Spurgeon,D,MIN,35,82,9,32,41
21,8476923,Damon Severson,D,CBJ,30,82,8,33,41
21,8475753,Justin Faulk,D,STL,32,82,6,35,41
21,8481554,Kaapo Kakko,R,NYR,23,82,27,13,40
21,8481535,Nils Hoglander,L,VAN,24,82,21,19,40
21,8478109,Victor Olofsson,L,BUF,29,82,19,21,40
21,8481624,Ilya Mikheyev,R,VAN,30,82,18,22,40
21,8474149,Evgenii Dadonov,R,DAL,35,82,16,24,40
21,8481581,Thomas Harley,D,DAL,23,82,15,25,40
21,8481186,Logan O'Connor,R,COL,28,82,15,25,40
21,8477935,Sam Bennett,C,FLA,28,82,14,26,40
21,8476882,Teuvo Teravainen,L,CAR,30,82,13,27,40
21,8477506,Ryan Pulock,D,NYI,30,82,10,30,40
21,8476927,Teddy Blueger,C,VAN,30,82,9,31,40
21,8477948,Travis Sanheim,D,PHI,28,82,5,35,40
21,8479514,Rem Pitlick,C,CHI,27,82,18,21,39
21,8478115,Pierre Engvall,L,NYI,28,82,12,27,39
21,8479345,Jakob Chychrun,D,OTT,26,82,9,30,39
21,8476979,Erik Gustafsson,D,NYR,32,82,8,31,39
21,8481704,Juuso Parssinen,C,NSH,23,82,21,17,38
21,8482146,Luke Evangelista,R,NSH,22,82,18,20,38
21,8482092,Ridly Greig,C,OTT,22,82,17,21,38
21,8475149,Marcus Johansson,L,MIN,34,82,15,23,38
21,8478891,Mason Appleton,C,WPG,28,82,15,23,38
21,8475714,Calle Jarnkrok,C,TOR,33,82,13,25,38
21,8477498,Darnell Nurse,D,EDM,29,82,7,31,38
21,8481013,Jonatan Berggren,R,DET,24,82,21,16,37
21,8480893,Kirill Marchenko,R,CBJ,24,82,20,17,37
21,8481580,Connor McMichael,C,WSH,23,82,20,17,37
21,8475848,Brendan Gallagher,R,MTL,32,82,17,20,37
21,8480068,Ryan Poehling,C,PHI,25,82,15,22,37
21,8482624,Daniil Miromanov,D,CGY,27,82,15,22,37
21,8474037,James van Riemsdyk,L,BOS,35,82,14,23,37
21,8477989,Christian Dvorak,C,MTL,28,82,11,26,37
21,8480817,K'Andre Miller,D,NYR,24,82,7,30,37
21,8480459,Pius Suter,C,VAN,28,82,24,12,36
21,8470610,Zach Parise,L,COL,40,82,18,18,36
21,8474189,Lars Eller,C,PIT,35,82,14,22,36
21,8476921,Jordan Martinook,L,CAR,32,82,14,22,36
21,8477953,Kasperi Kapanen,R,STL,28,82,13,23,36
21,8480871,Adam Boqvist,D,CBJ,24,82,13,23,36
21,8475197,Tyson Barrie,D,NSH,33,82,8,28,36
21,8478851,Alexandre Carrier,D,NSH,28,82,2,34,36
21,8479996,Cody Glass,C,NSH,25,82,24,11,35
21,8482055,Drew O'Connor,L,PIT,26,82,20,15,35
21,8482125,Alexander Holtz,R,NJD,22,82,18,17,35
21,8475799,Nino Niederreiter,R,WPG,32,82,17,18,35
21,8474884,Mike Hoffman,C,SJS,35,82,17,18,35
21,8475220,Marcus Foligno,L,MIN,33,82,17,18,35
21,8478911,Matt Roy,D,LAK,29,82,13,22,35
21,8480113,Alex Iafallo,L,WPG,31,82,11,24,35
21,8478472,Mathieu Joseph,R,OTT,27,82,11,24,35
21,8478396,Noah Hanifin,D,VGK,27,82,7,28,35
21,8477969,Marcus Pettersson,D,PIT,28,82,4,31,35
21,8481093,Rafael Harvey-Pinard,L,MTL,25,82,17,17,34
21,8478133,Jake Evans,C,MTL,28,82,16,18,34
21,8476897,Oskar Sundqvist,C,STL,30,82,14,20,34
21,8476960,Andreas Athanasiou,C,CHI,30,82,14,20,34
21,8479977,Kailer Yamamoto,R,SEA,26,82,11,23,34
21,8481606,Jordan Spence,D,LAK,23,82,11,23,34
21,8479976,Juuso Valimaki,D,ARI,26,82,11,23,34
21,8479415,Michael McLeod,C,NJD,26,82,10,24,34
21,8476422,Mike Reilly,D,NYI,31,82,8,26,34
21,8478233,Andrew Mangiapane,L,CGY,28,82,7,27,34
21,8481618,Alex Newhook,C,MTL,23,82,15,18,33
21,8476419,Jean-Gabriel Pageau,C,NYI,32,82,15,18,33
21,8481477,Nico Sturm,C,SJS,29,82,15,18,33
21,8482720,Matthew Knies,L,TOR,22,82,14,19,33
21,8479353,Brett Howden,C,VGK,26,82,12,21,33
21,8473563,Nicklas Backstrom,C,WSH,37,82,12,21,33
21,8475744,Evgeny Kuznetsov,C,CAR,32,82,10,23,33
21,8476467,Jamie Oleksiak,D,SEA,32,82,10,23,33
21,8475171,Oliver Ekman-Larsson,D,FLA,33,82,7,26,33
21,8480073,Erik Brannstrom,D,OTT,25,82,7,26,33
21,8476892,Colton Parayko,D,STL,31,82,6,27,33
21,8476461,Sean Couturier,C,PHI,32,82,21,11,32
21,8481601,Simon Holmstrom,R,NYI,23,82,20,12,32
21,8482117,Lukas Reichel,L,CHI,22,82,17,15,32
21,8476392,Adam Lowry,C,WPG,31,82,17,15,32
21,8480849,Barrett Hayton,C,ARI,24,82,16,16,32
21,8481703,Valtteri Puustinen,R,PIT,25,82,13,19,32
21,8480145,Neal Pionk,D,WPG,29,82,10,22,32
21,8477425,Miles Wood,L,COL,29,82,18,13,31
21,8480821,Filip Zadina,R,SJS,25,82,17,14,31
21,8477450,Jason Dickinson,C,CHI,29,82,15,16,31
21,8479591,Michael Eyssimont,C,TBL,28,82,14,17,31
21,8480074,Alexandre Texier,C,CBJ,25,82,14,17,31
21,8474870,Tyler Johnson,C,CHI,34,82,13,18,31
21,8473449,Kyle Okposo,R,FLA,36,82,13,18,31
21,8480336,Sean Walker,D,COL,30,82,7,24,31
21,8474673,TJ Brodie,D,TOR,34,82,2,29,31
21,8482079,Marco Rossi,C,MIN,23,82,20,10,30
21,8474715,Cam Atkinson,R,PHI,35,82,16,14,30
21,8478542,Evan Rodrigues,C,FLA,31,82,16,14,30
21,8475760,Nick Bjugstad,C,ARI,32,82,15,15,30
21,8476981,Josh Anderson,R,MTL,30,82,15,15,30
21,8476925,Colton Sissons,C,NSH,31,82,13,17,30
21,8476869,Brady Skjei,D,CAR,30,82,13,17,30
21,8476871,Tanner Pearson,L,MTL,32,82,13,17,30
21,8480043,Timothy Liljegren,D,TOR,25,82,7,23,30
21,8482259,Bobby McMann,C,TOR,28,82,17,12,29
21,8477015,Connor Brown,R,EDM,30,82,14,15,29
21,8478569,Noel Acciari,C,PIT,33,82,14,15,29
21,8481553,Bobby Brink,R,PHI,23,82,12,17,29
21,8482111,Justin Barron,D,MTL,23,82,9,20,29
21,8476958,Jaccob Slavin,D,CAR,30,82,6,23,29
21,8481537,Nikita Okhotiuk,D,CGY,24,82,6,23,29
21,8477220,Nate Schmidt,D,WPG,33,82,4,25,29
21,8482655,J.J. Moser,D,ARI,24,82,3,26,29
21,8478840,Will Borgen,D,SEA,28,82,3,26,29
21,8477952,Robby Fabbri,C,DET,28,82,18,10,28
21,8479393,Noah Gregor,C,TOR,26,82,17,11,28
21,8477330,Dominik Kubalik,L,OTT,29,82,14,14,28
21,8479661,Tanner Jeannot,L,TBL,27,82,12,16,28
21,8478013,Jake Walman,D,DET,28,82,11,17,28
21,8481517,Brett Leason,R,ANA,25,82,11,17,28
21,8482133,Thomas Bordeleau,C,SJS,22,82,9,19,28
21,8475181,Nick Leddy,D,STL,33,82,6,22,28
21,8476879,Cody Ceci,D,EDM,31,82,3,25,28
21,8475188,Brayden McNabb,D,VGK,33,82,1,27,28
21,8479346,Dillon Dube,C,CGY,26,82,16,11,27
21,8483524,Shane Wright,C,SEA,20,82,14,13,27
21,8483445,Cutter Gauthier,L,ANA,20,82,13,14,27
21,8477392,Hudson Fasching,R,NYI,29,82,13,14,27
21,8479293,Brandon Tanev,L,SEA,33,82,12,15,27
21,8479983,Mario Ferraro,D,SJS,26,82,12,15,27
21,8479390,Taylor Raddysh,R,CHI,26,82,9,18,27
21,8476278,Colin Blackwell,C,CHI,31,82,9,18,27
21,8479998,Mikey Anderson,D,LAK,25,82,8,19,27
21,8476885,Jacob Trouba,D,NYR,30,82,5,22,27
21,8482087,Kaiden Guhle,D,MTL,22,82,5,22,27
21,8475200,Dmitry Orlov,D,CAR,33,82,5,22,27
21,8479398,Samuel Girard,D,COL,26,82,4,23,27
21,8482122,Brock Faber,D,MIN,22,82,3,24,27
21,8475790,Erik Gudbranson,D,CBJ,32,82,1,26,27
21,8480855,Jack McBain,C,ARI,24,82,17,9,26
21,8470621,Corey Perry,R,EDM,39,82,11,15,26
21,8476873,Mark Jankowski,C,NSH,30,82,10,16,26
21,8480995,Pontus Holmberg,R,TOR,25,82,10,16,26
21,8483491,Ivan Miroshnichenko,L,WSH,20,82,10,16,26
21,8481481,Blake Lizotte,C,LAK,27,82,9,17,26
21,8479316,Luke Kunin,C,SJS,27,82,9,17,26
21,8483457,Lane Hutson,D,MTL,20,82,8,18,26
21,8482807,Ethan Del Mastro,D,CHI,21,82,6,20,26
21,8479980,Nicolas Hague,D,VGK,26,82,6,20,26
21,8474166,Alec Martinez,D,VGK,37,82,6,20,26
21,8480058,Pierre-Olivier Joseph,D,PIT,25,82,4,22,26
21,8476902,Esa Lindell,D,DAL,30,82,3,23,26
21,8477845,Trevor van Riemsdyk,D,WSH,33,82,2,24,26
21,8481178,Egor Zamula,D,PHI,24,82,2,24,26
21,8476469,Joel Armia,R,MTL,31,82,15,10,25
21,8473533,Jordan Staal,C,CAR,36,82,13,12,25
21,8480813,Joe Veleno,C,DET,24,82,13,12,25
21,8473453,Trevor Lewis,C,LAK,37,82,12,13,25
21,8484166,Adam Fantilli,C,CBJ,20,82,11,14,25
21,8476480,Vladislav Namestnikov,C,WPG,32,82,9,16,25
21,8484153,Leo Carlsson,C,ANA,20,82,9,16,25
21,8479351,Sam Steel,C,DAL,26,82,9,16,25
21,8477919,Frederick Gaudreau,C,MIN,31,82,9,16,25
21,8477839,Conor Sheary,L,TBL,32,82,7,18,25
21,8476917,Adam Pelech,D,NYI,30,82,4,21,25
21,8478507,John Marino,D,NJD,27,82,2,23,25
21,8477353,Tyler Motte,C,TBL,29,82,12,12,24
21,8482101,Danil Gushchin,L,SJS,22,82,8,16,24
21,8475279,Ben Chiarot,D,DET,33,82,6,18,24
21,8476429,Scott Mayfield,D,NYI,32,82,6,18,24
21,8477488,Brett Pesce,D,CAR,30,82,5,19,24
21,8482166,Shakir Mukhamadullin,D,SJS,22,82,5,19,24
21,8482142,Jamie Drysdale,D,PHI,22,82,5,19,24
21,8477365,Connor Clifton,D,BUF,29,82,4,20,24
21,8478882,Vladislav Gavrikov,D,LAK,29,82,4,20,24
21,8481568,Alex Vlasic,D,CHI,23,82,2,22,24
21,8482073,Braden Schneider,D,NYR,23,82,2,22,24
21,8476331,Dylan DeMelo,D,WPG,31,82,1,23,24
21,8475343,Nic Dowd,C,WSH,34,82,13,10,23
21,8480806,Isac Lundestrom,C,ANA,25,82,13,10,23
21,8478020,Michael Amadio,C,VGK,28,82,13,10,23
21,8482062,Cole Smith,L,NSH,29,82,12,11,23
21,8477931,Tomas Nosek,L,NJD,32,82,11,12,23
21,8484149,Gavin Brindley,C,CBJ,20,82,9,14,23
21,8477435,Ryan Graves,D,PIT,29,82,8,15,23
21,8477369,Carson Soucy,D,VAN,30,82,8,15,23
21,8476931,Jake McCabe,D,TOR,31,82,6,17,23
21,8482245,Artem Zub,D,OTT,29,82,6,17,23
21,8476312,Josh Manson,D,COL,33,82,5,18,23
21,8476457,Adam Larsson,D,SEA,32,82,4,19,23
21,8479369,Andrew Peeke,D,BOS,26,82,4,19,23
21,8475179,Dmitry Kulikov,D,FLA,34,82,3,20,23
21,8474567,Zach Bogosian,D,MIN,34,82,3,20,23
21,8475462,Radko Gudas,D,ANA,34,82,2,21,23
21,8479941,Justin Danforth,R,CBJ,31,82,14,8,22
21,8482155,Alex Laferriere,R,LAK,23,82,11,11,22
21,8481028,Martin Pospisil,C,CGY,25,82,10,12,22
21,8476442,Matt Nieto,L,PIT,32,82,10,12,22
21,8476463,Jonas Brodin,D,MIN,31,82,9,13,22
21,8476374,Sean Kuraly,C,CBJ,31,82,9,13,22
21,8470604,Jeff Carter,C,PIT,39,82,9,13,22
21,8475842,Sam Carrick,C,EDM,32,82,9,13,22
21,8482074,Connor Zary,C,CGY,23,82,7,15,22
21,8477507,Nikita Zadorov,D,VAN,29,82,6,16,22
21,8483763,Maksymilian Szuber,D,ARI,22,82,5,17,22
21,8479324,Ryan Lindgren,D,NYR,26,82,5,17,22
21,8479371,Dante Fabbro,D,NSH,26,82,1,21,22
21,8480281,Alexey Toropchenko,R,STL,25,82,13,8,21
21,8478508,Yakov Trenin,C,COL,27,82,13,8,21
21,8483468,Jiri Kulich,C,BUF,20,82,12,9,21
21,8479423,Alex Nylander,L,CBJ,26,82,11,10,21
21,8477508,Curtis Lazar,C,NJD,29,82,10,11,21
21,8475164,Jakob Silfverberg,R,ANA,34,82,10,11,21
21,8480802,Ryan McLeod,C,EDM,25,82,8,13,21
21,8476878,Zemgus Girgensons,L,BUF,30,82,8,13,21
21,8482730,Brandt Clarke,D,LAK,21,82,8,13,21
21,8480172,Jan Rutta,D,SJS,34,82,6,15,21
21,8480807,Mattias Samuelsson,D,BUF,24,82,5,16,21
21,8478178,Darren Raddysh,D,TBL,28,82,4,17,21
21,8478399,Jonas Siegenthaler,D,NJD,27,82,3,18,21
21,8480246,Nick Perbix,D,TBL,26,82,3,18,21
21,8481059,Scott Perunovich,D,STL,26,82,2,19,21
21,8474009,Nick Bonino,C,NYR,36,82,11,9,20
21,8479359,Beck Malenstyn,L,WSH,26,82,9,11,20
21,8478043,Sam Lafferty,C,VAN,29,82,7,13,20
21,8476624,Barclay Goodrow,C,NYR,31,82,7,13,20
21,8477499,Rasmus Ristolainen,D,PHI,30,82,6,14,20
21,8483493,Frank Nazar,C,CHI,20,82,6,14,20
21,8476891,Matt Grzelcyk,D,BOS,30,82,5,15,20
21,8480796,Martin Fehervary,D,WSH,25,82,4,16,20
21,8481014,Alexander Romanov,D,NYI,24,82,3,17,20
21,8484145,Zach Benson,L,BUF,19,82,11,8,19
21,8482702,Logan Stankoven,C,DAL,21,82,9,10,19
21,8483482,Tristan Luneau,D,ANA,20,82,8,11,19
21,8482679,Matt Coronato,R,CGY,22,82,7,12,19
21,8473504,Cal Clutterbuck,R,NYI,37,82,7,12,19
21,8474034,Pat Maroon,L,BOS,36,82,5,14,19
21,8483565,Nick Blankenburg,D,CBJ,26,82,5,14,19
21,8480879,Jacob Bernard-Docker,D,OTT,24,82,5,14,19
21,8475324,Nick Jensen,D,WSH,34,82,4,15,19
21,8470600,Ryan Suter,D,DAL,39,82,2,17,19
21,8475762,Derek Forbort,D,BOS,32,82,9,9,18
21,8483012,Logan Morrison,C,SEA,22,82,9,9,18
21,8479291,Kevin Rooney,C,CGY,31,82,8,10,18
21,8482858,Ryker Evans,D,SEA,23,82,7,11,18
21,8483495,Simon Nemec,D,NJD,20,82,5,13,18
21,8478468,Jeremy Lauzon,D,NSH,27,82,5,13,18
21,8481522,Peyton Krebs,C,BUF,23,82,4,14,18
21,8475455,Brenden Dillon,D,WPG,34,82,4,14,18
21,8479442,Troy Stecher,D,EDM,30,82,4,14,18
21,8480035,Henri Jokiharju,D,BUF,25,82,3,15,18
21,8475177,Calvin de Haan,D,TBL,33,82,3,15,18
21,8483490,Pavel Mintyukov,D,ANA,21,82,2,16,18
21,8478430,Oliver Kylington,D,CGY,27,82,1,17,18
21,8474151,Ryan McDonagh,D,NSH,35,82,0,18,18
21,8476858,Phillip Di Giuseppe,L,VAN,31,82,10,7,17
21,8483431,Logan Cooley,C,ARI,20,82,9,8,17
21,8480990,Declan Chisholm,D,MIN,24,82,9,8,17
21,8484203,Bradly Nadeau,L,CAR,19,82,6,11,17
21,8481567,Henry Thrun,D,SJS,23,82,5,12,17
21,8477335,Kyle Burroughs,D,SJS,29,82,5,12,17
21,8480834,Ty Emberson,D,SJS,24,82,4,13,17
21,8473507,Jeff Petry,D,DET,37,82,3,14,17
21,8470966,Mark Giordano,D,TOR,41,82,3,14,17
21,8476967,Brett Kulak,D,EDM,30,82,3,14,17
21,8478443,Brandon Carlo,D,BOS,28,82,2,15,17
21,8475690,Chris Tanev,D,DAL,35,82,1,16,17
21,8480448,Parker Kelly,L,OTT,25,82,10,6,16
21,8483397,Marc McLaughlin,C,BOS,25,82,8,8,16
21,8482762,Simon Edvinsson,D,DET,21,82,7,9,16
21,8483505,Matthew Poitras,C,BOS,20,82,6,10,16
21,8482470,Ilya Solovyov,D,CGY,24,82,6,10,16
21,8482118,Sam Colangelo,R,ANA,23,82,5,11,16
21,8478859,Niko Mikkola,D,FLA,28,82,5,11,16
21,8482177,Marat Khusnutdinov,C,MIN,22,82,5,11,16
21,8476372,Nick Seeler,D,PHI,31,82,4,12,16
21,8477406,Mattias Janmark,C,EDM,32,82,4,12,16
21,8475233,David Savard,D,MTL,34,82,3,13,16
21,8482713,Mackie Samoskevich,R,FLA,22,82,3,13,16
21,8474013,Ian Cole,D,VAN,35,82,2,14,16
21,8478136,Jake Middleton,D,MIN,28,82,1,15,16
21,8479383,Boris Katchouk,L,OTT,26,82,9,6,15
21,8480031,Maxime Comtois,L,CAR,25,82,9,6,15
21,8482803,Olen Zellweger,D,ANA,21,82,6,9,15
21,8475231,Casey Cizikas,C,NYI,33,82,5,10,15
21,8482516,Matthew Kessel,D,STL,24,82,5,10,15
21,8476525,Colin Miller,D,WPG,32,82,4,11,15
21,8478451,Ethan Bear,D,WSH,27,82,4,11,15
21,8483499,Liam Ohgren,L,MIN,20,82,3,12,15
21,8475208,Brian Dumoulin,D,SEA,33,82,1,14,15
21,8477505,Alexander Wennberg,C,NYR,30,82,11,3,14
21,8482809,Jackson Blake,R,CAR,21,82,10,4,14
21,8476915,Jujhar Khaira,L,MIN,30,82,9,5,14
21,8480144,David Kampf,C,TOR,29,82,7,7,14
21,8482733,Logan Mailloux,D,MTL,31,82,5,9,14
21,8481524,Bowen Byram,D,BUF,23,82,5,9,14
21,8481030,Jack St. Ivany,D,PIT,25,82,5,9,14
21,8478416,Erik Cernak,D,TBL,27,82,4,10,14
21,8483466,Kevin Korchinski,D,CHI,20,82,3,11,14
21,8480860,Kevin Bahl,D,NJD,24,82,2,12,14
21,8471677,Jack Johnson,D,COL,37,82,2,12,14
21,8481578,Graeme Clarke,R,NJD,23,82,6,7,13
21,8482145,Mavrik Bourque,C,DAL,22,82,5,8,13
21,8482859,Zack Ostapchuk,C,OTT,21,82,3,10,13
21,8476473,Connor Murphy,D,CHI,31,82,3,10,13
21,8477034,Jaycob Megna,D,CHI,32,82,3,10,13
21,8481699,Aku Raty,R,ARI,23,82,5,7,12
21,8478831,Kevin Stenlund,C,FLA,28,82,4,8,12
21,8474574,Tyler Myers,D,VAN,34,82,2,10,12
21,8482666,Scott Morrow,D,CAR,22,82,2,10,12
21,8482712,Oskar Olausson,R,COL,22,82,1,11,12
21,8475825,Jani Hakanpää,D,DAL,32,82,5,6,11
21,8483471,Brad Lambert,C,WPG,31,82,3,8,11
21,8476822,Luke Glendening,C,TBL,35,82,8,2,10
21,8484911,Collin Graf,R,SJS,22,82,5,5,10
21,8481605,Jackson LaCombe,D,ANA,23,82,2,8,10
21,8478408,Travis Dermott,D,ARI,28,82,4,5,9
21,8481016,Ruslan Iskhakov,C,NYI,24,82,2,7,9
21,8482737,Zack Bolduc,C,STL,21,82,3,5,8
21,8483489,Fraser Minten,C,TOR,31,82,3,5,8
21,8481599,Victor Soderstrom,D,ARI,23,82,1,6,7
21,8477950,Tony DeAngelo,D,CAR,29,0,0,0,0
21,8481577,Philip Tomasino,C,NSH,23,0,0,0,0
21,8482660,Kent Johnson,C,CBJ,22,0,0,0,0
21,8481019,David Gustafsson,C,WPG,24,0,0,0,0
21,8479348,Kale Clague,D,BUF,26,0,0,0,0
21,8482149,Cole Perfetti,C,WPG,22,0,0,0,0
21,8476952,Dominic Toninato,C,WPG,30,0,0,0,0
21,8473473,Milan Lucic,L,BOS,36,0,0,0,0
21,8480829,Jesperi Kotkaniemi,C,CAR,24,0,0,0,0
21,8474602,Justin Schultz,D,SEA,34,0,0,0,0
21,8480049,Dylan Samberg,D,WPG,25,0,0,0,0
21,8479372,Josh Mahura,D,FLA,26,0,0,0,0
21,8480878,Nils Lundkvist,D,DAL,24,0,0,0,0
21,8479982,Conor Timmins,D,TOR,26,0,0,0,0
21,8474031,Kevin Shattenkirk,D,BOS,35,0,0,0,0
21,8480835,Jack Drury,C,CAR,24,0,0,0,0
21,8480008,Adam Ruzicka,C,ARI,25,0,0,0,0
21,8479402,Jake Bean,D,CBJ,26,0,0,0,0
21,8476474,Stefan Noesen,R,CAR,31,0,0,0,0
21,8480884,Calen Addison,D,SJS,24,0,0,0,0
21,8476994,Vinnie Hinostroza,C,PIT,30,0,0,0,0
21,8477987,Ryan Donato,C,CHI,28,0,0,0,0
21,8481582,Nicholas Robertson,L,TOR,23,0,0,0,0
21,8478452,Caleb Jones,D,COL,27,0,0,0,0
21,8480157,Calle Rosen,D,STL,30,0,0,0,0
21,8481609,Vladislav Kolyachonok,D,ARI,23,0,0,0,0
21,8476919,Chris Tierney,C,NJD,30,0,0,0,0
21,8479639,Dylan Coghlan,D,CAR,26,0,0,0,0
21,8475193,Tomas Tatar,L,SEA,34,0,0,0,0
21,8480748,Kiefer Sherwood,L,NSH,29,0,0,0,0
21,8478146,Matthew Highmore,C,OTT,28,0,0,0,0
21,8478970,Jalen Chatfield,D,CAR,28,0,0,0,0
21,8480205,Emil Bemstrom,C,PIT,25,0,0,0,0
21,8471274,Alex Goligoski,D,MIN,39,0,0,0,0
21,8478104,Sammy Blais,L,STL,28,0,0,0,0
21,8476913,Devin Shore,C,SEA,30,0,0,0,0
21,8481708,Zac Jones,D,NYR,24,0,0,0,0
21,8480222,Sebastian Aho,D,NYI,28,0,0,0,0
21,8481598,Philip Broberg,D,EDM,23,0,0,0,0
21,8480789,Oliver Wahlstrom,R,NYI,24,0,0,0,0
21,8480891,Michael Kesselring,D,ARI,24,0,0,0,0
21,8477979,Nicolas Aube-Kubel,R,WSH,28,0,0,0,0
21,8476393,Nick Cousins,C,FLA,31,0,0,0,0
21,8480003,Jesper Boqvist,C,BOS,26,0,0,0,0
21,8479543,Michael Pezzetta,L,MTL,26,0,0,0,0
21,8475855,Jesper Fast,R,CAR,33,0,0,0,0
21,8477018,Ben Hutton,D,VGK,31,0,0,0,0
21,8480762,Eric Robinson,L,BUF,29,0,0,0,0
21,8481058,Jesse Ylönen,R,MTL,25,0,0,0,0
21,8481527,Kaedan Korczak,D,VGK,23,0,0,0,0
21,8482192,Isaak Phillips,D,CHI,23,0,0,0,0
21,8480727,Zach Whitecloud,D,VGK,28,0,0,0,0
21,8480001,Urho Vaakanainen,D,ANA,25,0,0,0,0
21,8480853,Liam Foudy,C,NSH,24,0,0,0,0
21,8475225,Craig Smith,C,DAL,35,0,0,0,0
21,8479972,Mason Shaw,C,MIN,26,0,0,0,0
21,8474040,Sam Gagner,C,EDM,35,0,0,0,0
21,8480196,Jacob Bryson,D,BUF,27,0,0,0,0
21,8475718,Justin Holl,D,DET,32,0,0,0,0
21,8479984,Cal Foote,D,NJD,26,0,0,0,0
21,8480011,Klim Kostin,C,SJS,25,0,0,0,0
21,8482176,Wyatt Kaiser,D,CHI,22,0,0,0,0
21,8476918,Jimmy Vesey,L,NYR,31,0,0,0,0
21,8476988,Matt Benning,D,SJS,30,0,0,0,0
21,8479370,Tyson Jost,C,BUF,26,0,0,0,0
21,8477464,Nic Petan,C,MIN,29,0,0,0,0
21,8477380,Jonny Brodzinski,C,NYR,31,0,0,0,0
21,8480070,Ian Mitchell,D,BOS,25,0,0,0,0
21,8479315,Joey Anderson,R,CHI,26,0,0,0,0
21,8478099,Kevin Labanc,R,SJS,29,0,0,0,0
21,8476874,Olli Maatta,D,DET,30,0,0,0,0
21,8479414,Nathan Bastian,R,NJD,27,0,0,0,0
21,8478434,Keegan Kolesar,R,VGK,27,0,0,0,0
21,8479536,Axel Jonsson-Fjallby,L,WPG,26,0,0,0,0
21,8479671,Mathieu Olivier,R,CBJ,27,0,0,0,0
21,8471709,Marc-Edouard Vlasic,D,SJS,37,0,0,0,0
21,8479328,Julien Gauthier,R,NYI,27,0,0,0,0
21,8478421,A.J. Greer,L,CGY,28,0,0,0,0
21,8477573,Nathan Walker,L,STL,30,0,0,0,0
21,8477478,William Carrier,L,VGK,30,0,0,0,0
21,8479344,Jesse Puljujarvi,R,PIT,26,0,0,0,0
21,8480887,Jordan Harris,D,MTL,24,0,0,0,0
21,8478502,Dennis Gilbert,D,CGY,28,0,0,0,0
21,8480355,Mark Kastelic,C,OTT,25,0,0,0,0
21,8475750,Jon Merrill,D,MIN,32,0,0,0,0
21,8476889,Radek Faksa,C,DAL,30,0,0,0,0
21,8478432,Christian Fischer,R,DET,27,0,0,0,0
21,8479439,Jacob MacDonald,D,SJS,31,0,0,0,0
21,8474568,Luke Schenn,D,NSH,35,0,0,0,0
21,8478454,Noah Juulsen,D,VAN,27,0,0,0,0
21,8475752,Tyler Pitlick,C,NYR,33,0,0,0,0
21,8482148,Hendrix Lapierre,C,WSH,22,0,0,0,0
21,8481167,Brayden Pachal,D,CGY,25,0,0,0,0
21,8478211,Dryden Hunt,L,CGY,29,0,0,0,0
21,8479321,Lucas Johansen,D,WSH,27,0,0,0,0
21,8480950,Ilya Lyubushkin,D,TOR,30,0,0,0,0
21,8479368,Max Jones,L,ANA,26,0,0,0,0
21,8471699,Andrew Cogliano,C,COL,37,0,0,0,0
21,8481521,Ronnie Attard,D,PHI,25,0,0,0,0
21,8481161,Jake Christiansen,D,CBJ,25,0,0,0,0
21,8479458,Nikita Zaitsev,D,CHI,33,0,0,0,0
21,8479619,Michael Carcone,L,ARI,28,0,0,0,0
21,8479026,Philippe Myers,D,TBL,27,0,0,0,0
21,8481617,Vasily Podkolzin,R,VAN,23,0,0,0,0
21,8481701,Santeri Hatakka,D,NJD,23,0,0,0,0
21,8477446,Michael McCarron,R,NSH,29,0,0,0,0
21,8483460,David Jiricek,D,CBJ,21,0,0,0,0
21,8474090,Brendan Smith,D,NJD,35,0,0,0,0
21,8482241,Radim Zohorna,L,PIT,28,0,0,0,0
21,8481032,Paul Cotter,C,VGK,25,0,0,0,0
21,8480289,Morgan Barron,C,WPG,26,0,0,0,0
21,8479379,Givani Smith,R,SJS,26,0,0,0,0
21,8480216,Jacob Peterson,C,SJS,25,0,0,0,0
21,8477851,Jordan Oesterle,D,CGY,32,0,0,0,0
21,8484258,Sam Malinski,D,COL,26,0,0,0,0
21,8478904,Steven Lorentz,C,FLA,28,0,0,0,0
21,8482095,Tyler Kleven,D,OTT,22,0,0,0,0
21,8480980,Connor Dewar,C,TOR,25,0,0,0,0
21,8480848,Ty Dellandrea,C,DAL,24,0,0,0,0
21,8476884,Derrick Pouliot,D,DAL,30,0,0,0,0
21,8480025,MacKenzie Entwistle,R,CHI,25,0,0,0,0
21,8474612,Travis Hamonic,D,OTT,34,0,0,0,0
21,8479336,Carl Grundstrom,R,LAK,27,0,0,0,0
21,8482964,Arber Xhekaj,D,MTL,23,0,0,0,0
21,8471686,Marc Staal,D,PHI,37,0,0,0,0
21,8477887,Patrick Brown,C,BOS,32,0,0,0,0
21,8478495,Denis Gurianov,R,PHI,27,0,0,0,0
21,8481550,Adam Beckman,L,MIN,23,0,0,0,0
21,8480845,Rasmus Kupari,C,WPG,24,0,0,0,0
21,8478585,Derek Ryan,C,EDM,38,0,0,0,0
21,8482141,Lukas Cormier,D,VGK,22,0,0,0,0
21,8477962,Brendan Lemieux,L,CAR,28,0,0,0,0
21,8482861,Vincent Iorio,D,WSH,22,0,0,0,0
21,8479378,Logan Stanley,D,WPG,26,0,0,0,0
21,8473446,Erik Johnson,D,PHI,36,0,0,0,0
21,8481743,Marc Del Gaizo,D,NSH,25,0,0,0,0
21,8478450,Parker Wotherspoon,D,BOS,27,0,0,0,0
21,8477384,Josh Brown,D,ARI,30,0,0,0,0
21,8482165,Yan Kuznetsov,D,CGY,22,0,0,0,0
21,8478424,Jansen Harkins,C,PIT,27,0,0,0,0
21,8482144,Jack Thompson,D,SJS,22,0,0,0,0
21,8479576,Vincent Desharnais,D,EDM,28,0,0,0,0
21,8478512,Austin Czarnik,C,DET,32,0,0,0,0
21,8477527,Ross Johnston,L,ANA,30,0,0,0,0
21,8482094,Daemon Hunt,D,MIN,22,0,0,0,0
21,8481719,Maxwell Crozier,D,TBL,24,0,0,0,0
21,8480192,Johnathan Kovacevic,D,MTL,27,0,0,0,0
21,8479376,Victor Mete,D,PHI,26,0,0,0,0
21,8482511,Mason Lohrei,D,BOS,23,0,0,0,0
21,8478021,William Lagesson,D,ANA,28,0,0,0,0
21,8475795,Dylan McIlrath,D,WSH,32,0,0,0,0
21,8477846,Ryan Carpenter,C,SJS,33,0,0,0,0
21,8481056,Spencer Stastney,D,NSH,24,0,0,0,0
21,8481564,Ryan Johnson,D,BUF,23,0,0,0,0
21,8478017,Mark Friedman,D,VAN,29,0,0,0,0
21,8479320,Max Lajoie,D,TOR,27,0,0,0,0
21,8480075,Cameron Crotty,D,ARI,25,0,0,0,0
21,8484287,Cole McWard,D,VAN,23,0,0,0,0
21,8484254,Akito Hirose,D,VAN,25,0,0,0,0
21,8483407,Brandon Scanlin,D,NYR,25,0,0,0,0
21,8480274,Philip Kemp,D,EDM,25,0,0,0,0
21,8479522,Hardy Haman Aktell,D,WSH,26,0,0,0,0
21,8480007,Jonas Rondbjerg,R,VGK,25,0,0,0,0
21,8477454,Adam Erne,L,EDM,29,0,0,0,0
21,8481679,Maxence Guenette,D,OTT,23,0,0,0,0
21,8477938,Haydn Fleury,D,TBL,28,0,0,0,0
21,8476441,Joel Edmundson,D,TOR,31,0,0,0,0
21,8477903,Garnet Hathaway,R,PHI,33,0,0,0,0
21,8480441,Trey Fix-Wolansky,R,CBJ,25,0,0,0,0
21,8483546,Marshall Rifai,D,TOR,26,0,0,0,0
21,8480084,Nick DeSimone,D,NJD,30,0,0,0,0
21,8481592,Jakob Pelletier,L,CGY,23,0,0,0,0
21,8478011,Louie Belpedio,D,PHI,28,0,0,0,0
21,8477930,Pierre-Edouard Bellemare,L,SEA,39,0,0,0,0
21,8484321,Nikolas Matinpalo,D,OTT,26,0,0,0,0
21,8482067,Connor Mackey,D,NYR,28,0,0,0,0
21,8481806,Louis Crevier,D,CHI,23,0,0,0,0
21,8484326,Patrik Koch,D,ARI,28,0,0,0,0
21,8477971,Andreas Englund,D,LAK,28,0,0,0,0
21,8481751,Lukas Rousek,R,BUF,25,0,0,0,0
21,8481006,Tyler Tucker,D,STL,24,0,0,0,0
21,8481641,Joel Kiviranta,L,COL,28,0,0,0,0
21,8476867,Brendan Gaunce,C,CBJ,30,0,0,0,0
21,8479520,Brandon Duhaime,R,COL,27,0,0,0,0
21,8477073,Kurtis MacDermid,L,NJD,30,0,0,0,0
21,8480874,Adam Ginning,D,PHI,24,0,0,0,0
21,8477473,Justin Bailey,R,SJS,29,0,0,0,0
21,8479066,Ryan Lomberg,L,FLA,30,0,0,0,0
21,8477070,Liam O'Brien,C,ARI,30,0,0,0,0
21,8474618,Marco Scandella,D,STL,34,0,0,0,0
21,8475797,Jarred Tinordi,D,CHI,32,0,0,0,0
21,8481441,Joe Snively,C,WSH,28,0,0,0,0
21,8477244,Chad Ruhwedel,D,NYR,34,0,0,0,0
21,8482077,Dylan Holloway,L,EDM,23,0,0,0,0
21,8479772,Zack MacEwen,R,OTT,28,0,0,0,0
21,8481147,Reese Johnson,C,CHI,26,0,0,0,0
21,8481043,Cole Koepke,L,TBL,26,0,0,0,0
21,8483619,Filip Roos,D,CHI,25,0,0,0,0
21,8481541,Samuel Bolduc,D,NYI,24,0,0,0,0
21,8477810,Joel Hanley,D,CGY,33,0,0,0,0
21,8476907,Mackenzie MacEachern,L,STL,30,0,0,0,0
21,8482652,Walker Duehr,R,CGY,27,0,0,0,0
21,8477126,Jayson Megna,C,BOS,34,0,0,0,0
21,8483398,Declan Carlile,D,TBL,31,0,0,0,0
21,8482929,Emil Lilleberg,D,TBL,23,0,0,0,0
21,8480880,Jakub Lauko,C,BOS,24,0,0,0,0
21,8478874,Adam Gaudette,C,STL,28,0,0,0,0
21,8480245,Olle Lycksell,R,PHI,25,0,0,0,0
21,8480252,Cole Guttman,C,CHI,25,0,0,0,0
21,8477467,Gustav Olofsson,D,SEA,30,0,0,0,0
21,8479968,Vinni Lettieri,C,MIN,29,0,0,0,0
21,8478400,Colin White,C,MTL,27,0,0,0,0
21,8475755,Alexander Petrovic,D,DAL,32,0,0,0,0
21,8481812,Nikolai Knyzhov,D,SJS,27,0,0,0,0
21,8481593,Jayden Struble,D,MTL,23,0,0,0,0
21,8481532,Alex Turcotte,C,LAK,23,0,0,0,0
21,8482126,Emil Andrae,D,PHI,31,0,0,0,0
21,8479944,Zach Aston-Reese,C,DET,30,0,0,0,0
21,8471817,Ryan Reaves,R,TOR,37,0,0,0,0
21,8481206,John Ludvig,D,PIT,24,0,0,0,0
21,8480292,Carson Meyer,R,CBJ,27,0,0,0,0
21,8482496,Nils Aman,C,VAN,24,0,0,0,0
21,8479718,Alex Barré-Boulet,C,TBL,27,0,0,0,0
21,8479994,Jaret Anderson-Dolan,C,NSH,25,0,0,0,0
21,8480184,Gustav Lindstrom,D,ANA,26,0,0,0,0
21,8480890,Jan Jenik,R,ARI,24,0,0,0,0
21,8478067,Oskar Lindblom,L,SJS,28,0,0,0,0
21,8476934,Brock McGinn,L,ANA,30,0,0,0,0
21,8479985,Cale Fleury,D,SEA,26,0,0,0,0
21,8482153,Brendan Brisson,C,VGK,23,0,0,0,0
21,8480021,Jack Studnicka,C,SJS,25,0,0,0,0
21,8484304,Uvis Balinskis,D,FLA,28,0,0,0,0
21,8479981,Jonah Gadjovich,L,FLA,26,0,0,0,0
21,8481716,Dmitri Voronkov,L,CBJ,24,0,0,0,0
21,8482659,Josh Doan,R,ARI,22,0,0,0,0
21,8481122,Simon Benoit,D,TOR,26,0,0,0,0
21,8474709,Matt Martin,L,NYI,35,0,0,0,0
21,8482634,Alex Steeves,C,TOR,25,0,0,0,0
21,8480823,Alexander Alexeyev,D,WSH,25,0,0,0,0
21,8477541,Dakota Mermis,D,MIN,30,0,0,0,0
21,8478477,Mitchell Stephens,C,MTL,27,0,0,0,0
21,8481543,Nikita Alexandrov,C,STL,24,0,0,0,0
21,8482451,Mikael Pyyhtia,L,CBJ,23,0,0,0,0
21,8480306,Grant Hutton,D,NYI,29,0,0,0,0
21,8478028,Fredrik Olofsson,L,COL,28,0,0,0,0
21,8477462,Robert Hagg,D,ANA,29,0,0,0,0
21,8477320,Anton Blidh,L,NYR,29,0,0,0,0
21,8482749,Joshua Roy,R,MTL,21,0,0,0,0
21,8482157,Will Cuylle,L,NYR,22,0,0,0,0
21,8481239,Samuel Fagemo,L,LAK,24,0,0,0,0
21,8481600,Tobias Bjornfot,D,FLA,23,0,0,0,0
21,8478409,Anthony Richard,C,BOS,28,0,0,0,0
21,8474145,Robert Bortuzzo,D,NYI,35,0,0,0,0
21,8475958,Michael Sgarbossa,C,WSH,32,0,0,0,0
21,8479986,Kole Lind,R,SEA,26,0,0,0,0
21,8479249,Andrew Poturalski,C,SEA,30,0,0,0,0
21,8479362,Riley Tufte,L,COL,26,0,0,0,0
21,8479991,Jake Leschyshyn,C,NYR,25,0,0,0,0
21,8479587,Rhett Gardner,C,PHI,28,0,0,0,0
21,8482744,James Malatesta,L,CBJ,21,0,0,0,0
21,8478854,Ryan Shea,D,PIT,27,0,0,0,0
21,8481591,Sam Poulin,R,PIT,23,0,0,0,0
21,8483512,Matt Savoie,C,BUF,20,0,0,0,0
21,8482102,Vasily Ponomarev,C,CAR,22,0,0,0,0
21,8482162,Roby Jarventie,L,OTT,22,0,0,0,0
21,8482172,Landon Slaggert,L,CHI,22,0,0,0,0
21,8482747,Brennan Othmann,L,NYR,21,0,0,0,0
21,8480226,Marián Studenic,R,SEA,26,0,0,0,0
21,8481518,Nolan Foote,L,NJD,24,0,0,0,0
21,8479419,Brett Murray,L,BUF,26,0,0,0,0
21,8482088,Justin Sourdif,R,FLA,22,0,0,0,0
21,8482201,Gage Goncalves,C,TBL,23,0,0,0,0
21,8481754,Nikita Nesterenko,C,ANA,23,0,0,0,0
21,8483531,Brian Halonen,L,NJD,25,0,0,0,0
21,8483920,Pierrick Dube,R,WSH,23,0,0,0,0
21,8480851,Akil Thomas,C,LAK,24,0,0,0,0
21,8475235,Nicolas Deslauriers,L,PHI,33,0,0,0,0
21,8482476,Emil Heineman,L,MTL,23,0,0,0,0
21,8477149,Scott Sabourin,R,SJS,32,0,0,0,0
21,8483549,Lucas Condotta,L,MTL,27,0,0,0,0
21,8483567,Georgii Merkulov,C,BOS,24,0,0,0,0
21,8482765,Isak Rosen,R,BUF,21,0,0,0,0
21,8481237,Kyle MacLean,C,NYI,25,0,0,0,0
21,8481024,Linus Karlsson,C,VAN,25,0,0,0,0
21,8481690,Tyler Angle,C,CBJ,24,0,0,0,0
21,8483570,Ben Meyers,C,ANA,26,0,0,0,0
21,8481655,Cole Schwindt,R,CGY,23,0,0,0,0
21,8481462,Mason Morelli,L,VGK,28,0,0,0,0
21,8483401,Marc Johnstone,R,PIT,28,0,0,0,0
21,8478956,Samuel Laberge,L,NJD,27,0,0,0,0
21,8479533,Joona Koppanen,L,PIT,26,0,0,0,0
21,8482197,Adam Raska,R,MIN,23,0,0,0,0
21,8482250,Callahan Burke,C,CAR,27,0,0,0,0
21,8482784,Zach Dean,C,STL,21,0,0,0,0
21,8484255,Jason Polin,R,COL,25,0,0,0,0
21,8481077,John Leonard,L,ARI,26,0,0,0,0
21,8481534,Raphael Lavoie,C,EDM,24,0,0,0,0
21,8483609,Adam Klapka,R,CGY,24,0,0,0,0
21,8482751,Ryan Winterton,C,SEA,21,0,0,0,0
21,8480267,Sammy Walker,C,MIN,25,0,0,0,0
21,8475766,Austin Watson,L,TBL,32,0,0,0,0
21,8482460,Matt Rempe,C,NYR,22,0,0,0,0
21,8482787,Nikita Chibrikov,R,WPG,31,0,0,0,0
21,8481065,Angus Crookshank,L,OTT,25,0,0,0,0
21,8481070,Hugh McGing,L,STL,26,0,0,0,0
21,8476323,Max McCormick,L,SEA,32,0,0,0,0
21,8483395,Arshdeep Bains,L,VAN,23,0,0,0,0
21,8484259,Ondrej Pavel,C,COL,31,0,0,0,0
21,8483432,Luca Del Bel Belluz,C,CBJ,31,0,0,0,0
21,8483045,Cameron Butler,R,CBJ,31,0,0,0,0
21,8482061,Brandon Biro,L,BUF,26,0,0,0,0
21,8477401,John Hayden,C,SEA,29,0,0,0,0
21,8475278,Byron Froese,C,VGK,33,0,0,0,0
21,8478446,Glenn Gawdin,C,ANA,27,0,0,0,0
21,8477993,Justin Kirkland,C,ARI,28,0,0,0,0
21,8482147,Jean-Luc Foudy,C,COL,22,0,0,0,0
21,8480032,Shane Bowers,C,NJD,25,0,0,0,0
21,8479330,Brandon Gignac,C,MTL,27,0,0,0,0
21,8480776,Sheldon Rempal,R,VGK,29,0,0,0,0
21,8475413,Justin Dowling,C,NJD,34,0,0,0,0
21,8481726,Adam Edstrom,C,NYR,24,0,0,0,0
21,8479638,Justin Brazeau,R,BOS,26,0,0,0,0
21,8480844,Grigori Denisenko,L,VGK,24,0,0,0,0
21,8474062,Riley Nash,C,NYR,35,0,0,0,0
21,8478147,Bokondji Imama,L,OTT,28,0,0,0,0
21,8478881,Brett Seney,L,CHI,28,0,0,0,0
21,8483630,Pavol Regenda,L,ANA,25,0,0,0,0
21,8480836,Jonathan Gruden,C,PIT,24,0,0,0,0
21,8484314,Jiri Smejkal,L,OTT,28,0,0,0,0
21,8475780,Chris Wagner,R,COL,33,0,0,0,0
21,8482070,Mitchell Chaffee,R,TBL,26,0,0,0,0
21,8479546,Oskar Steen,C,BOS,26,0,0,0,0
21,8483597,Milos Kelemen,L,ARI,25,0,0,0,0
21,8481789,Tye Kartye,L,SEA,23,0,0,0,0
21,8484325,Waltteri Merela,C,TBL,26,0,0,0,0
21,8479421,Jacob Moverare,D,LAK,26,0,0,0,0
21,8481585,Egor Afanasyev,L,NSH,23,0,0,0,0
21,8479547,Matthew Phillips,R,WSH,26,0,0,0,0
21,8479367,William Lockwood,R,FLA,26,0,0,0,0
21,8481422,Jacob Lucchini,C,MIN,29,0,0,0,0
21,8480468,James Hamblin,L,EDM,25,0,0,0,0
21,8480870,Bo Groulx,C,ANA,24,0,0,0,0
21,8478051,Max Willman,C,NJD,29,0,0,0,0
21,8481556,John Beecher,C,BOS,23,0,0,0,0
21,8478078,Rourke Chartier,C,OTT,28,0,0,0,0
22,8478402,Connor McDavid,C,EDM,27,82,45,97,142
22,8476453,Nikita Kucherov,R,TBL,31,82,40,93,133
22,8477492,Nathan MacKinnon,C,COL,29,82,49,82,131
22,8481559,Jack Hughes,C,NJD,23,82,53,72,125
22,8478550,Artemi Panarin,L,NYR,33,82,42,79,121
22,8479314,Matthew Tkachuk,L,FLA,27,82,42,73,115
22,8479318,Auston Matthews,C,TOR,27,82,58,52,110
22,8471675,Sidney Crosby,C,PIT,37,82,47,58,105
22,8478420,Mikko Rantanen,R,COL,28,82,50,54,104
22,8477934,Leon Draisaitl,C,EDM,29,82,39,64,103
22,8477942,Kevin Fiala,L,LAK,28,82,32,67,99
22,8479323,Adam Fox,D,NYR,26,82,14,85,99
22,8477946,Dylan Larkin,C,DET,28,82,52,46,98
22,8480801,Brady Tkachuk,L,OTT,25,82,46,52,98
22,8478010,Brayden Point,C,TBL,28,82,56,41,97
22,8477956,David Pastrnak,R,BOS,28,82,49,48,97
22,8477409,Carter Verhaeghe,C,FLA,29,82,38,59,97
22,8478427,Sebastian Aho,C,CAR,27,82,42,54,96
22,8477493,Aleksander Barkov,C,FLA,29,82,34,62,96
22,8480012,Elias Pettersson,C,VAN,26,82,38,56,94
22,8480002,Nico Hischier,C,NJD,25,82,35,59,94
22,8475692,Mats Zuccarello,R,MIN,37,82,19,73,92
22,8479407,Jesper Bratt,L,NJD,26,82,33,57,90
22,8477949,Alex Tuch,R,BUF,28,82,42,46,88
22,8482116,Tim Stützle,C,OTT,22,82,30,58,88
22,8474600,Roman Josi,D,NSH,34,82,17,71,88
22,8477951,Nick Schmaltz,C,ARI,28,82,25,62,87
22,8476468,J.T. Miller,C,VAN,31,82,24,63,87
22,8478445,Mathew Barzal,C,NYI,27,82,23,64,87
22,8480800,Quinn Hughes,D,VAN,25,82,7,80,87
22,8477939,William Nylander,R,TOR,28,82,33,53,86
22,8476887,Filip Forsberg,L,NSH,30,82,36,49,85
22,8480069,Cale Makar,D,COL,26,82,26,59,85
22,8480027,Jason Robertson,L,DAL,25,82,26,59,85
22,8478042,Viktor Arvidsson,R,LAK,31,82,26,59,85
22,8478864,Kirill Kaprizov,L,MIN,27,82,41,42,83
22,8477447,Shea Theodore,D,VGK,29,82,11,71,82
22,8479343,Clayton Keller,R,ARI,26,82,33,48,81
22,8478440,Dylan Strome,C,WSH,27,82,28,52,80
22,8481523,Kirby Dach,C,MTL,23,82,13,67,80
22,8477501,Valeri Nichushkin,R,COL,29,82,33,46,79
22,8481557,Matt Boldy,L,MIN,23,82,38,40,78
22,8477933,Sam Reinhart,C,FLA,29,82,32,46,78
22,8479542,Brandon Hagel,L,TBL,26,82,29,49,78
22,8478444,Brock Boeser,R,VAN,27,82,39,38,77
22,8475168,Matt Duchene,C,DAL,33,82,36,40,76
22,8474564,Steven Stamkos,C,TBL,34,82,33,43,76
22,8478403,Jack Eichel,C,VGK,28,82,36,39,75
22,8479339,Patrik Laine,L,CBJ,26,82,36,39,75
22,8476389,Vincent Trocheck,C,NYR,31,82,34,41,75
22,8476460,Mark Scheifele,C,WPG,31,82,27,48,75
22,8476346,Johnny Gaudreau,L,CBJ,31,82,13,62,75
22,8478398,Kyle Connor,L,WPG,28,82,33,41,74
22,8479420,Tage Thompson,C,BUF,27,82,32,42,74
22,8477402,Pavel Buchnevich,L,STL,29,82,30,44,74
22,8477960,Adrian Kempe,R,LAK,28,82,30,44,74
22,8471215,Evgeni Malkin,C,PIT,38,82,26,48,74
22,8471214,Alex Ovechkin,L,WSH,39,82,42,31,73
22,8477496,Elias Lindholm,C,VAN,30,82,33,40,73
22,8478493,Joel Eriksson Ek,C,MIN,27,82,30,43,73
22,8481711,Matias Maccelli,L,ARI,24,82,30,43,73
22,8478047,Michael Bunting,L,PIT,29,82,29,43,72
22,8476459,Mika Zibanejad,C,NYR,31,82,27,45,72
22,8482665,Matty Beniers,C,SEA,22,82,27,45,72
22,8473512,Claude Giroux,R,OTT,36,82,25,47,72
22,8482078,Lucas Raymond,L,DET,22,82,33,38,71
22,8478439,Travis Konecny,R,PHI,27,82,32,39,71
22,8482097,Jack Quinn,R,BUF,23,82,29,41,70
22,8480830,Andrei Svechnikov,R,CAR,24,82,29,41,70
22,8477404,Jake Guentzel,C,CAR,30,82,28,42,70
22,8481528,Dylan Cozens,C,BUF,23,82,27,43,70
22,8475172,Nazem Kadri,C,CGY,34,82,22,48,70
22,8479425,Filip Hronek,D,VAN,27,82,20,50,70
22,8480839,Rasmus Dahlin,D,BUF,24,82,15,55,70
22,8476479,Phillip Danault,C,LAK,31,82,25,44,69
22,8480039,Martin Necas,C,CAR,25,82,23,46,69
22,8471685,Anze Kopitar,C,LAK,37,82,22,47,69
22,8480803,Evan Bouchard,D,EDM,25,82,16,53,69
22,8475784,Jeff Skinner,C,BUF,32,82,33,35,68
22,8481540,Cole Caufield,R,MTL,23,82,32,36,68
22,8477940,Nikolaj Ehlers,L,WPG,28,82,29,39,68
22,8476454,Ryan Nugent-Hopkins,C,EDM,31,82,21,47,68
22,8475913,Mark Stone,R,VGK,32,82,34,33,67
22,8475166,John Tavares,C,TOR,34,82,27,40,67
22,8478438,Tommy Novak,C,NSH,27,82,27,40,67
22,8477500,Bo Horvat,C,NYI,29,82,26,41,67
22,8477456,J.T. Compher,L,DET,29,82,26,41,67
22,8479337,Alex DeBrincat,R,DET,27,82,25,42,67
22,8478414,Timo Meier,R,NJD,28,82,31,35,66
22,8475745,Charlie Coyle,C,BOS,32,82,31,35,66
22,8476448,William Karlsson,C,VGK,31,82,21,45,66
22,8476456,Jonathan Huberdeau,C,CGY,31,82,20,46,66
22,8480036,Miro Heiskanen,D,DAL,25,82,18,48,66
22,8478460,Zach Werenski,D,CBJ,27,82,13,53,66
22,8479410,Mikhail Sergachev,D,TBL,26,82,13,53,66
22,8475754,Brock Nelson,C,NYI,33,82,34,31,65
22,8475726,Tyler Toffoli,C,WPG,32,82,29,36,65
22,8478873,Troy Terry,R,ANA,27,82,27,38,65
22,8474141,Patrick Kane,R,DET,36,82,24,41,65
22,8475184,Chris Kreider,L,NYR,33,82,38,26,64
22,8482745,Mason McTavish,C,ANA,21,82,32,32,64
22,8477476,Artturi Lehkonen,L,COL,29,82,28,36,64
22,8473419,Brad Marchand,L,BOS,36,82,27,37,64
22,8478449,Roope Hintz,C,DAL,28,82,26,38,64
22,8480018,Nick Suzuki,C,MTL,25,82,23,41,64
22,8476853,Morgan Rielly,D,TOR,30,82,9,55,64
22,8479385,Jordan Kyrou,C,STL,26,82,32,31,63
22,8476483,Rickard Rakell,R,PIT,31,82,40,22,62
22,8470794,Joe Pavelski,C,DAL,40,82,23,39,62
22,8480208,Drake Batherson,R,OTT,26,82,19,43,62
22,8475167,Victor Hedman,D,TBL,34,82,13,49,62
22,8474102,David Perron,L,DET,36,82,24,37,61
22,8478469,Thomas Chabot,D,OTT,27,82,17,44,61
22,8476432,Boone Jenner,C,CBJ,31,82,39,21,60
22,8477955,Jared McCann,L,SEA,28,82,31,29,60
22,8478856,Conor Garland,R,VAN,28,82,30,30,60
22,8474586,Jordan Eberle,R,SEA,34,82,21,39,60
22,8474590,John Carlson,D,WSH,34,82,19,41,60
22,8474563,Drew Doughty,D,LAK,35,82,18,42,60
22,8476875,Mike Matheson,D,MTL,30,82,10,50,60
22,8480865,Noah Dobson,D,NYI,24,82,7,53,60
22,8475151,Kyle Palmieri,C,NYI,33,82,32,27,59
22,8475794,Tyler Seguin,C,DAL,32,82,30,29,59
22,8476881,Tomas Hertl,C,VGK,31,82,29,30,59
22,8477479,Tyler Bertuzzi,L,TOR,29,82,27,32,59
22,8475798,Mikael Granlund,C,SJS,32,82,17,42,59
22,8479325,Charlie McAvoy,D,BOS,27,82,10,49,59
22,8477935,Sam Bennett,C,FLA,28,82,30,28,58
22,8477451,Ryan Hartman,R,MIN,30,82,29,29,58
22,8478401,Pavel Zacha,C,BOS,27,82,23,35,58
22,8476462,Dougie Hamilton,D,NJD,31,82,21,37,58
22,8474679,Gustav Nyquist,C,NSH,35,82,17,41,58
22,8477416,Oliver Bjorkstrand,R,SEA,29,82,17,41,58
22,8477504,Josh Morrissey,D,WPG,29,82,14,44,58
22,8482684,Luke Hughes,D,NJD,21,82,9,49,58
22,8476539,Jonathan Marchessault,R,VGK,34,82,29,28,57
22,8477998,Warren Foegele,L,EDM,28,82,27,30,57
22,8476905,Chandler Stephenson,C,VGK,30,82,18,39,57
22,8478396,Noah Hanifin,D,VGK,27,82,17,40,57
22,8477407,Anthony Duclair,L,TBL,29,82,28,28,56
22,8475791,Taylor Hall,L,CHI,33,82,20,36,56
22,8475786,Zach Hyman,L,EDM,32,82,33,22,55
22,8479675,Trevor Moore,L,LAK,29,82,32,23,55
22,8478462,Nicolas Roy,C,VGK,27,82,22,33,55
22,8477497,Sean Monahan,C,WPG,30,82,19,36,55
22,8474157,Max Pacioretty,L,WSH,36,82,18,37,55
22,8477444,Andre Burakovsky,L,SEA,29,82,17,38,55
22,8480023,Robert Thomas,C,STL,25,82,16,39,55
22,8474578,Erik Karlsson,D,PIT,34,82,11,44,55
22,8471698,T.J. Oshie,R,WSH,38,82,26,28,54
22,8480015,Owen Tippett,R,PHI,25,82,23,31,54
22,8475158,Ryan O'Reilly,C,NSH,33,82,21,33,54
22,8478519,Anthony Cirelli,C,TBL,27,82,19,35,54
22,8479999,Casey Mittelstadt,C,COL,26,82,17,37,54
22,8477494,Jonathan Drouin,L,COL,29,82,14,40,54
22,8477986,Brandon Montour,D,FLA,30,82,12,42,54
22,8475810,Bryan Rust,R,PIT,32,82,23,30,53
22,8477021,Alex Kerfoot,C,ARI,30,82,18,35,53
22,8476906,Shayne Gostisbehere,D,DET,31,82,13,40,53
22,8478397,Rasmus Andersson,D,CGY,28,82,12,41,53
22,8478407,Vince Dunn,D,SEA,28,82,7,46,53
22,8482146,Luke Evangelista,R,NSH,22,82,25,27,52
22,8482093,Seth Jarvis,C,CAR,22,82,23,29,52
22,8480188,Fabian Zetterlund,L,SJS,25,82,23,29,52
22,8475744,Evgeny Kuznetsov,C,CAR,32,82,16,36,52
22,8478542,Evan Rodrigues,C,FLA,31,82,16,36,52
22,8480434,Sean Durzi,D,ARI,26,82,11,41,52
22,8478474,Lawson Crouse,L,ARI,27,82,33,18,51
22,8482110,Dawson Mercer,C,NJD,23,82,31,20,51
22,8475314,Anders Lee,L,NYI,34,82,31,20,51
22,8475169,Evander Kane,L,EDM,33,82,26,25,51
22,8478057,Dakota Joshua,C,VAN,28,82,24,27,51
22,8477511,Anthony Mantha,R,VGK,30,82,22,29,51
22,8474641,Adam Henrique,C,EDM,34,82,21,30,51
22,8478055,Gustav Forsling,D,FLA,28,82,11,40,51
22,8482124,Quinton Byfield,R,LAK,22,82,21,29,50
22,8476826,Yanni Gourde,C,SEA,33,82,21,29,50
22,8481533,Trevor Zegras,C,ANA,23,82,16,34,50
22,8473994,Jamie Benn,L,DAL,35,82,16,34,50
22,8477503,Max Domi,C,TOR,29,82,14,36,50
22,8475722,Jason Zucker,L,NSH,32,82,28,21,49
22,8474053,Logan Couture,C,SJS,35,82,24,25,49
22,8480064,Josh Norris,C,OTT,25,82,30,18,48
22,8482109,Alexis Lafrenière,L,NYR,23,82,24,24,48
22,8475170,Brayden Schenn,C,STL,33,82,23,25,48
22,8481596,Shane Pinto,C,OTT,24,82,22,26,48
22,8480009,Eeli Tolvanen,R,SEA,25,82,22,26,48
22,8480797,Joel Farabee,L,PHI,24,82,20,28,48
22,8476292,Ondrej Palat,L,NJD,33,82,19,29,48
22,8482475,Yegor Chinakhov,R,CBJ,23,82,17,31,48
22,8481581,Thomas Harley,D,DAL,23,82,17,31,48
22,8481542,Moritz Seider,D,DET,23,82,4,44,48
22,8481068,Yegor Sharangovich,C,CGY,26,82,23,24,47
22,8476882,Teuvo Teravainen,L,CAR,30,82,23,24,47
22,8479345,Jakob Chychrun,D,OTT,26,82,19,28,47
22,8477964,Ivan Barbashev,C,VGK,29,82,16,31,47
22,8476399,Blake Coleman,C,CGY,33,82,25,21,46
22,8475191,Reilly Smith,R,PIT,33,82,15,31,46
22,8471724,Kris Letang,D,PIT,37,82,11,35,46
22,8476923,Damon Severson,D,CBJ,30,82,9,37,46
22,8480014,Gabriel Vilardi,C,WPG,25,82,30,15,45
22,8482740,Wyatt Johnston,C,DAL,21,82,27,18,45
22,8475799,Nino Niederreiter,R,WPG,32,82,26,19,45
22,8474150,Mikael Backlund,C,CGY,35,82,22,23,45
22,8480028,Morgan Frost,C,PHI,25,82,20,25,45
22,8482720,Matthew Knies,L,TOR,22,82,20,25,45
22,8476880,Tom Wilson,R,WSH,30,82,19,26,45
22,8477346,MacKenzie Weegar,D,CGY,30,82,17,28,45
22,8478458,Jack Roslovic,C,NYR,27,82,17,28,45
22,8474870,Tyler Johnson,C,CHI,34,82,17,28,45
22,8470613,Brent Burns,D,CAR,39,82,14,31,45
22,8478038,Devon Toews,D,COL,30,82,8,37,45
22,8477969,Marcus Pettersson,D,PIT,28,82,8,37,45
22,8482113,Anton Lundell,C,FLA,23,82,21,23,44
22,8475287,Erik Haula,L,NJD,33,82,16,28,44
22,8477932,Aaron Ekblad,D,FLA,28,82,11,33,44
22,8477330,Dominik Kubalik,L,OTT,29,82,24,19,43
22,8479400,Pierre-Luc Dubois,L,LAK,26,82,23,20,43
22,8478498,Jake DeBrusk,L,BOS,28,82,22,21,43
22,8478366,Frank Vatrano,R,ANA,30,82,22,21,43
22,8482055,Drew O'Connor,L,PIT,26,82,22,21,43
22,8481535,Nils Hoglander,L,VAN,24,82,20,23,43
22,8475765,Vladimir Tarasenko,R,FLA,33,82,19,24,43
22,8482667,William Eklund,L,SJS,22,82,19,24,43
22,8478115,Pierre Engvall,L,NYI,28,82,19,24,43
22,8476480,Vladislav Namestnikov,C,WPG,32,82,19,24,43
22,8478975,Mason Marchment,L,DAL,29,82,18,25,43
22,8484144,Connor Bedard,C,CHI,19,82,18,25,43
22,8481618,Alex Newhook,C,MTL,23,82,17,26,43
22,8476329,Travis Boyd,C,ARI,31,82,11,32,43
22,8475753,Justin Faulk,D,STL,32,82,10,33,43
22,8477495,Seth Jones,D,CHI,30,82,9,34,43
22,8482159,Tyson Foerster,R,PHI,22,82,25,17,42
22,8474149,Evgenii Dadonov,R,DAL,35,82,23,19,42
22,8476438,Brandon Saad,L,STL,32,82,19,23,42
22,8478891,Mason Appleton,C,WPG,28,82,17,25,42
22,8476792,Torey Krug,D,STL,33,82,11,31,42
22,8481093,Rafael Harvey-Pinard,L,MTL,25,82,22,19,41
22,8471218,Blake Wheeler,R,NYR,38,82,20,21,41
22,8479525,Ross Colton,C,COL,28,82,19,22,41
22,8483515,Juraj Slafkovsky,L,MTL,20,82,19,22,41
22,8473422,Nick Foligno,L,CHI,37,82,18,23,41
22,8482092,Ridly Greig,C,OTT,22,82,15,26,41
22,8478233,Andrew Mangiapane,L,CGY,28,82,15,26,41
22,8478413,Jordan Greenway,L,BUF,27,82,13,28,41
22,8474565,Alex Pietrangelo,D,VGK,34,82,9,32,41
22,8474574,Tyler Myers,D,VAN,34,82,6,35,41
22,8482175,JJ Peterka,R,BUF,22,82,22,18,40
22,8480459,Pius Suter,C,VAN,28,82,21,19,40
22,8482705,Cole Sillinger,C,CBJ,21,82,20,20,40
22,8479977,Kailer Yamamoto,R,SEA,26,82,18,22,40
22,8479992,Michael Rasmussen,C,DET,25,82,17,23,40
22,8476458,Ryan Strome,C,ANA,31,82,17,23,40
22,8476925,Colton Sissons,C,NSH,31,82,17,23,40
22,8474037,James van Riemsdyk,L,BOS,35,82,16,24,40
22,8478911,Matt Roy,D,LAK,29,82,14,26,40
22,8480817,K'Andre Miller,D,NYR,24,82,11,29,40
22,8475714,Calle Jarnkrok,C,TOR,33,82,24,15,39
22,8475760,Nick Bjugstad,C,ARI,32,82,19,20,39
22,8478466,Daniel Sprong,R,DET,27,82,17,22,39
22,8481481,Blake Lizotte,C,LAK,27,82,12,27,39
22,8473563,Nicklas Backstrom,C,WSH,37,82,10,29,39
22,8482142,Jamie Drysdale,D,PHI,22,82,8,31,39
22,8480078,Filip Chytil,C,NYR,25,82,21,17,38
22,8475793,Ryan Johansen,C,PHI,32,82,18,20,38
22,8483808,Andrei Kuzmenko,L,CGY,28,82,16,22,38
22,8482111,Justin Barron,D,MTL,23,82,16,22,38
22,8478046,Danton Heinen,L,BOS,29,82,15,23,38
22,8477953,Kasperi Kapanen,R,STL,28,82,15,23,38
22,8479987,Morgan Geekie,C,BOS,26,82,12,26,38
22,8476960,Andreas Athanasiou,C,CHI,30,82,12,26,38
22,8476419,Jean-Gabriel Pageau,C,NYI,32,82,9,29,38
22,8482105,Jake Sanderson,D,OTT,22,82,8,30,38
22,8481606,Jordan Spence,D,LAK,23,82,7,31,38
22,8480873,Rasmus Sandin,D,WSH,24,82,6,32,38
22,8475906,John Klingberg,D,TOR,32,82,5,33,38
22,8473986,Alex Killorn,L,ANA,35,82,22,15,37
22,8481704,Juuso Parssinen,C,NSH,23,82,20,17,37
22,8481560,Arthur Kaliyev,R,LAK,23,82,19,18,37
22,8481554,Kaapo Kakko,R,NYR,23,82,17,20,37
22,8475149,Marcus Johansson,L,MIN,34,82,16,21,37
22,8481546,Cam York,D,PHI,23,82,15,22,37
22,8479996,Cody Glass,C,NSH,25,82,15,22,37
22,8477952,Robby Fabbri,C,DET,28,82,15,22,37
22,8482125,Alexander Holtz,R,NJD,22,82,14,23,37
22,8475218,Mattias Ekholm,D,EDM,34,82,11,26,37
22,8482671,Owen Power,D,BUF,22,82,10,27,37
22,8476461,Sean Couturier,C,PHI,32,82,10,27,37
22,8477839,Conor Sheary,L,TBL,32,82,10,27,37
22,8476872,Scott Laughton,C,PHI,30,82,8,29,37
22,8474716,Jared Spurgeon,D,MIN,35,82,7,30,37
22,8476869,Brady Skjei,D,CAR,30,82,7,30,37
22,8479398,Samuel Girard,D,COL,26,82,5,32,37
22,8478043,Sam Lafferty,C,VAN,29,82,19,17,36
22,8481624,Ilya Mikheyev,R,VAN,30,82,16,20,36
22,8476921,Jordan Martinook,L,CAR,32,82,16,20,36
22,8479365,Trent Frederic,C,BOS,26,82,15,21,36
22,8476392,Adam Lowry,C,WPG,31,82,15,21,36
22,8479351,Sam Steel,C,DAL,26,82,13,23,36
22,8481013,Jonatan Berggren,R,DET,24,82,12,24,36
22,8475763,Kevin Hayes,R,STL,32,82,11,25,36
22,8478133,Jake Evans,C,MTL,28,82,11,25,36
22,8475197,Tyson Barrie,D,NSH,33,82,9,27,36
22,8477429,Andrew Copp,C,DET,30,82,8,28,36
22,8476854,Hampus Lindholm,D,BOS,30,82,6,30,36
22,8476958,Jaccob Slavin,D,CAR,30,82,3,33,36
22,8480813,Joe Veleno,C,DET,24,82,23,12,35
22,8482062,Cole Smith,L,NSH,29,82,19,16,35
22,8482699,Dylan Guenther,R,ARI,21,82,17,18,35
22,8479346,Dillon Dube,C,CGY,26,82,17,18,35
22,8473533,Jordan Staal,C,CAR,36,82,17,18,35
22,8475768,Jaden Schwartz,C,SEA,32,82,16,19,35
22,8480798,Philipp Kurashev,C,CHI,25,82,15,20,35
22,8477947,Sonny Milano,L,WSH,28,82,13,22,35
22,8480802,Ryan McLeod,C,EDM,25,82,13,22,35
22,8476885,Jacob Trouba,D,NYR,30,82,12,23,35
22,8482222,Alexander Barabanov,L,SJS,30,82,9,26,35
22,8476902,Esa Lindell,D,DAL,30,82,5,30,35
22,8475200,Dmitry Orlov,D,CAR,33,82,4,31,35
22,8476981,Josh Anderson,R,MTL,30,82,22,12,34
22,8482079,Marco Rossi,C,MIN,23,82,19,15,34
22,8478020,Michael Amadio,C,VGK,28,82,19,15,34
22,8475848,Brendan Gallagher,R,MTL,32,82,16,18,34
22,8478463,Anthony Beauvillier,L,NSH,27,82,15,19,34
22,8480855,Jack McBain,C,ARI,24,82,15,19,34
22,8480849,Barrett Hayton,C,ARI,24,82,14,20,34
22,8477498,Darnell Nurse,D,EDM,29,82,11,23,34
22,8481522,Peyton Krebs,C,BUF,23,82,9,25,34
22,8477948,Travis Sanheim,D,PHI,28,82,6,28,34
22,8477426,Nicholas Paul,L,TBL,29,82,19,14,33
22,8480068,Ryan Poehling,C,PHI,25,82,17,16,33
22,8479390,Taylor Raddysh,R,CHI,26,82,17,16,33
22,8480185,Eetu Luostarinen,C,FLA,26,82,12,21,33
22,8476927,Teddy Blueger,C,VAN,30,82,12,21,33
22,8482133,Thomas Bordeleau,C,SJS,22,82,9,24,33
22,8481703,Valtteri Puustinen,R,PIT,25,82,6,27,33
22,8480807,Mattias Samuelsson,D,BUF,24,82,6,27,33
22,8474151,Ryan McDonagh,D,NSH,35,82,6,27,33
22,8475764,Cam Fowler,D,ANA,33,82,2,31,33
22,8481604,Pavel Dorofeyev,L,VGK,24,82,20,12,32
22,8482117,Lukas Reichel,L,CHI,22,82,14,18,32
22,8481656,Aliaksei Protas,C,WSH,23,82,13,19,32
22,8482624,Daniil Miromanov,D,CGY,27,82,13,19,32
22,8479353,Brett Howden,C,VGK,26,82,12,20,32
22,8477488,Brett Pesce,D,CAR,30,82,9,23,32
22,8476463,Jonas Brodin,D,MIN,31,82,7,25,32
22,8473507,Jeff Petry,D,DET,37,82,5,27,32
22,8476892,Colton Parayko,D,STL,31,82,4,28,32
22,8482089,Jake Neighbours,L,STL,22,82,20,11,31
22,8481601,Simon Holmstrom,R,NYI,23,82,20,11,31
22,8479293,Brandon Tanev,L,SEA,33,82,20,11,31
22,8476873,Mark Jankowski,C,NSH,30,82,16,15,31
22,8481553,Bobby Brink,R,PHI,23,82,15,16,31
22,8477989,Christian Dvorak,C,MTL,28,82,14,17,31
22,8474189,Lars Eller,C,PIT,35,82,14,17,31
22,8478109,Victor Olofsson,L,BUF,29,82,13,18,31
22,8479415,Michael McLeod,C,NJD,26,82,12,19,31
22,8476871,Tanner Pearson,L,MTL,32,82,12,19,31
22,8480113,Alex Iafallo,L,WPG,31,82,11,20,31
22,8481580,Connor McMichael,C,WSH,23,82,9,22,31
22,8480871,Adam Boqvist,D,CBJ,24,82,9,22,31
22,8483457,Lane Hutson,D,MTL,20,82,9,22,31
22,8477506,Ryan Pulock,D,NYI,30,82,7,24,31
22,8478472,Mathieu Joseph,R,OTT,27,82,6,25,31
22,8480043,Timothy Liljegren,D,TOR,25,82,5,26,31
22,8470604,Jeff Carter,C,PIT,39,82,19,11,30
22,8479514,Rem Pitlick,C,CHI,27,82,16,14,30
22,8477450,Jason Dickinson,C,CHI,29,82,15,15,30
22,8470610,Zach Parise,L,COL,40,82,14,16,30
22,8473504,Cal Clutterbuck,R,NYI,37,82,14,16,30
22,8481186,Logan O'Connor,R,COL,28,82,13,17,30
22,8480336,Sean Walker,D,COL,30,82,9,21,30
22,8478882,Vladislav Gavrikov,D,LAK,29,82,8,22,30
22,8478851,Alexandre Carrier,D,NSH,28,82,5,25,30
22,8480145,Neal Pionk,D,WPG,29,82,3,27,30
22,8480821,Filip Zadina,R,SJS,25,82,17,12,29
22,8475164,Jakob Silfverberg,R,ANA,34,82,15,14,29
22,8474884,Mike Hoffman,C,SJS,35,82,13,16,29
22,8478569,Noel Acciari,C,PIT,33,82,13,16,29
22,8476374,Sean Kuraly,C,CBJ,31,82,13,16,29
22,8477507,Nikita Zadorov,D,VAN,29,82,7,22,29
22,8484145,Zach Benson,L,BUF,19,82,16,12,28
22,8482259,Bobby McMann,C,TOR,28,82,15,13,28
22,8482074,Connor Zary,C,CGY,23,82,15,13,28
22,8479591,Michael Eyssimont,C,TBL,28,82,14,14,28
22,8475220,Marcus Foligno,L,MIN,33,82,10,18,28
22,8476897,Oskar Sundqvist,C,STL,30,82,10,18,28
22,8477406,Mattias Janmark,C,EDM,32,82,10,18,28
22,8482122,Brock Faber,D,MIN,22,82,6,22,28
22,8482803,Olen Zellweger,D,ANA,21,82,6,22,28
22,8476525,Colin Miller,D,WPG,32,82,6,22,28
22,8480073,Erik Brannstrom,D,OTT,25,82,5,23,28
22,8476469,Joel Armia,R,MTL,31,82,14,13,27
22,8475231,Casey Cizikas,C,NYI,33,82,13,14,27
22,8476878,Zemgus Girgensons,L,BUF,30,82,12,15,27
22,8480220,Noah Cates,L,PHI,25,82,11,16,27
22,8482730,Brandt Clarke,D,LAK,21,82,10,17,27
22,8481568,Alex Vlasic,D,CHI,23,82,3,24,27
22,8478840,Will Borgen,D,SEA,28,82,2,25,27
22,8477944,Jakub Vrana,L,STL,28,82,15,11,26
22,8479393,Noah Gregor,C,TOR,26,82,15,11,26
22,8479941,Justin Danforth,R,CBJ,31,82,15,11,26
22,8475343,Nic Dowd,C,WSH,34,82,14,12,26
22,8480995,Pontus Holmberg,R,TOR,25,82,13,13,26
22,8477220,Nate Schmidt,D,WPG,33,82,4,22,26
22,8481059,Scott Perunovich,D,STL,26,82,3,23,26
22,8480058,Pierre-Olivier Joseph,D,PIT,25,82,1,25,26
22,8476278,Colin Blackwell,C,CHI,31,82,16,9,25
22,8483431,Logan Cooley,C,ARI,20,82,16,9,25
22,8470621,Corey Perry,R,EDM,39,82,15,10,25
22,8480074,Alexandre Texier,C,CBJ,25,82,12,13,25
22,8480281,Alexey Toropchenko,R,STL,25,82,12,13,25
22,8484153,Leo Carlsson,C,ANA,20,82,11,14,25
22,8482166,Shakir Mukhamadullin,D,SJS,22,82,9,16,25
22,8476467,Jamie Oleksiak,D,SEA,32,82,7,18,25
22,8479983,Mario Ferraro,D,SJS,26,82,7,18,25
22,8475455,Brenden Dillon,D,WPG,34,82,4,21,25
22,8474673,TJ Brodie,D,TOR,34,82,3,22,25
22,8482655,J.J. Moser,D,ARI,24,82,3,22,25
22,8476917,Adam Pelech,D,NYI,30,82,3,22,25
22,8480035,Henri Jokiharju,D,BUF,25,82,1,24,25
22,8477919,Frederick Gaudreau,C,MIN,31,82,11,13,24
22,8482762,Simon Edvinsson,D,DET,21,82,11,13,24
22,8477425,Miles Wood,L,COL,29,82,10,14,24
22,8474715,Cam Atkinson,R,PHI,35,82,9,15,24
22,8476879,Cody Ceci,D,EDM,31,82,7,17,24
22,8474034,Pat Maroon,L,BOS,36,82,7,17,24
22,8475171,Oliver Ekman-Larsson,D,FLA,33,82,5,19,24
22,8482245,Artem Zub,D,OTT,29,82,3,21,24
22,8478507,John Marino,D,NJD,27,82,2,22,24
22,8484149,Gavin Brindley,C,CBJ,20,82,12,11,23
22,8480448,Parker Kelly,L,OTT,25,82,12,11,23
22,8481477,Nico Sturm,C,SJS,29,82,11,12,23
22,8473449,Kyle Okposo,R,FLA,36,82,11,12,23
22,8476624,Barclay Goodrow,C,NYR,31,82,10,13,23
22,8482858,Ryker Evans,D,SEA,23,82,10,13,23
22,8484166,Adam Fantilli,C,CBJ,20,82,8,15,23
22,8477015,Connor Brown,R,EDM,30,82,7,16,23
22,8484911,Collin Graf,R,SJS,22,82,6,17,23
22,8475790,Erik Gudbranson,D,CBJ,32,82,5,18,23
22,8478443,Brandon Carlo,D,BOS,28,82,5,18,23
22,8479980,Nicolas Hague,D,VGK,26,82,4,19,23
22,8475279,Ben Chiarot,D,DET,33,82,4,19,23
22,8470966,Mark Giordano,D,TOR,41,82,4,19,23
22,8478430,Oliver Kylington,D,CGY,27,82,3,20,23
22,8479371,Dante Fabbro,D,NSH,26,82,2,21,23
22,8478508,Yakov Trenin,C,COL,27,82,16,6,22
22,8482702,Logan Stankoven,C,DAL,21,82,8,14,22
22,8477369,Carson Soucy,D,VAN,30,82,7,15,22
22,8479369,Andrew Peeke,D,BOS,26,82,4,18,22
22,8483763,Maksymilian Szuber,D,ARI,22,82,4,18,22
22,8481178,Egor Zamula,D,PHI,24,82,3,19,22
22,8479324,Ryan Lindgren,D,NYR,26,82,3,19,22
22,8478178,Darren Raddysh,D,TBL,28,82,3,19,22
22,8477365,Connor Clifton,D,BUF,29,82,2,20,22
22,8475690,Chris Tanev,D,DAL,35,82,2,20,22
22,8478416,Erik Cernak,D,TBL,27,82,1,21,22
22,8476331,Dylan DeMelo,D,WPG,31,82,0,22,22
22,8479661,Tanner Jeannot,L,TBL,27,82,11,10,21
22,8480144,David Kampf,C,TOR,29,82,11,10,21
22,8474009,Nick Bonino,C,NYR,36,82,10,11,21
22,8479359,Beck Malenstyn,L,WSH,26,82,10,11,21
22,8481524,Bowen Byram,D,BUF,23,82,10,11,21
22,8481699,Aku Raty,R,ARI,23,82,10,11,21
22,8483490,Pavel Mintyukov,D,ANA,21,82,8,13,21
22,8484203,Bradly Nadeau,L,CAR,19,82,8,13,21
22,8481028,Martin Pospisil,C,CGY,25,82,6,15,21
22,8483493,Frank Nazar,C,CHI,20,82,6,15,21
22,8483565,Nick Blankenburg,D,CBJ,26,82,6,15,21
22,8478500,Ivan Provorov,D,CBJ,27,82,5,16,21
22,8476891,Matt Grzelcyk,D,BOS,30,82,5,16,21
22,8478136,Jake Middleton,D,MIN,28,82,5,16,21
22,8475181,Nick Leddy,D,STL,33,82,3,18,21
22,8479423,Alex Nylander,L,CBJ,26,82,12,8,20
22,8476858,Phillip Di Giuseppe,L,VAN,31,82,12,8,20
22,8480893,Kirill Marchenko,R,CBJ,24,82,11,9,20
22,8479291,Kevin Rooney,C,CGY,31,82,11,9,20
22,8483505,Matthew Poitras,C,BOS,20,82,7,13,20
22,8475188,Brayden McNabb,D,VGK,33,82,6,14,20
22,8476979,Erik Gustafsson,D,NYR,32,82,4,16,20
22,8480806,Isac Lundestrom,C,ANA,25,82,4,16,20
22,8479976,Juuso Valimaki,D,ARI,26,82,3,17,20
22,8482087,Kaiden Guhle,D,MTL,22,82,3,17,20
22,8476312,Josh Manson,D,COL,33,82,3,17,20
22,8480796,Martin Fehervary,D,WSH,25,82,3,17,20
22,8475233,David Savard,D,MTL,34,82,0,20,20
22,8482155,Alex Laferriere,R,LAK,23,82,17,2,19
22,8476822,Luke Glendening,C,TBL,35,82,14,5,19
22,8481517,Brett Leason,R,ANA,25,82,9,10,19
22,8482733,Logan Mailloux,D,MTL,31,82,9,10,19
22,8481537,Nikita Okhotiuk,D,CGY,24,82,7,12,19
22,8478013,Jake Walman,D,DET,28,82,6,13,19
22,8481016,Ruslan Iskhakov,C,NYI,24,82,6,13,19
22,8481567,Henry Thrun,D,SJS,23,82,5,14,19
22,8476457,Adam Larsson,D,SEA,32,82,4,15,19
22,8477931,Tomas Nosek,L,NJD,32,82,3,16,19
22,8475324,Nick Jensen,D,WSH,34,82,3,16,19
22,8470600,Ryan Suter,D,DAL,39,82,3,16,19
22,8475842,Sam Carrick,C,EDM,32,82,8,10,18
22,8477508,Curtis Lazar,C,NJD,29,82,7,11,18
22,8483445,Cutter Gauthier,L,ANA,20,82,5,13,18
22,8481014,Alexander Romanov,D,NYI,24,82,4,14,18
22,8480990,Declan Chisholm,D,MIN,24,82,3,15,18
22,8477499,Rasmus Ristolainen,D,PHI,30,82,2,16,18
22,8476429,Scott Mayfield,D,NYI,32,82,1,17,18
22,8476372,Nick Seeler,D,PHI,31,82,1,17,18
22,8482807,Ethan Del Mastro,D,CHI,21,82,9,8,17
22,8483524,Shane Wright,C,SEA,20,82,7,10,17
22,8476442,Matt Nieto,L,PIT,32,82,7,10,17
22,8483495,Simon Nemec,D,NJD,20,82,7,10,17
22,8475179,Dmitry Kulikov,D,FLA,34,82,6,11,17
22,8482679,Matt Coronato,R,CGY,22,82,6,11,17
22,8482809,Jackson Blake,R,CAR,21,82,6,11,17
22,8474013,Ian Cole,D,VAN,35,82,4,13,17
22,8477505,Alexander Wennberg,C,NYR,30,82,4,13,17
22,8476422,Mike Reilly,D,NYI,31,82,3,14,17
22,8477845,Trevor van Riemsdyk,D,WSH,33,82,3,14,17
22,8479998,Mikey Anderson,D,LAK,25,82,2,15,17
22,8480246,Nick Perbix,D,TBL,26,82,2,15,17
22,8474166,Alec Martinez,D,VGK,37,82,1,16,17
22,8479383,Boris Katchouk,L,OTT,26,82,12,4,16
22,8479442,Troy Stecher,D,EDM,30,82,6,10,16
22,8478451,Ethan Bear,D,WSH,27,82,6,10,16
22,8473453,Trevor Lewis,C,LAK,37,82,5,11,16
22,8480834,Ty Emberson,D,SJS,24,82,5,11,16
22,8482737,Zack Bolduc,C,STL,21,82,5,11,16
22,8475208,Brian Dumoulin,D,SEA,33,82,4,12,16
22,8478468,Jeremy Lauzon,D,NSH,27,82,3,13,16
22,8477353,Tyler Motte,C,TBL,29,82,6,9,15
22,8480031,Maxime Comtois,L,CAR,25,82,6,9,15
22,8474567,Zach Bogosian,D,MIN,34,82,5,10,15
22,8483468,Jiri Kulich,C,BUF,20,82,5,10,15
22,8482470,Ilya Solovyov,D,CGY,24,82,5,10,15
22,8478859,Niko Mikkola,D,FLA,28,82,5,10,15
22,8475177,Calvin de Haan,D,TBL,33,82,4,11,15
22,8476967,Brett Kulak,D,EDM,30,82,3,12,15
22,8476931,Jake McCabe,D,TOR,31,82,2,13,15
22,8475762,Derek Forbort,D,BOS,32,82,2,13,15
22,8480860,Kevin Bahl,D,NJD,24,82,2,13,15
22,8475462,Radko Gudas,D,ANA,34,82,1,14,15
22,8483482,Tristan Luneau,D,ANA,20,82,0,15,15
22,8483491,Ivan Miroshnichenko,L,WSH,20,82,8,6,14
22,8482666,Scott Morrow,D,CAR,22,82,8,6,14
22,8481578,Graeme Clarke,R,NJD,23,82,7,7,14
22,8479316,Luke Kunin,C,SJS,27,82,6,8,14
22,8482712,Oskar Olausson,R,COL,22,82,6,8,14
22,8482073,Braden Schneider,D,NYR,23,82,5,9,14
22,8477335,Kyle Burroughs,D,SJS,29,82,5,9,14
22,8482516,Matthew Kessel,D,STL,24,82,5,9,14
22,8482145,Mavrik Bourque,C,DAL,22,82,5,9,14
22,8481605,Jackson LaCombe,D,ANA,23,82,5,9,14
22,8483499,Liam Ohgren,L,MIN,20,82,3,11,14
22,8480172,Jan Rutta,D,SJS,34,82,2,12,14
22,8480879,Jacob Bernard-Docker,D,OTT,24,82,2,12,14
22,8478399,Jonas Siegenthaler,D,NJD,27,82,0,14,14
22,8478831,Kevin Stenlund,C,FLA,28,82,8,5,13
22,8477392,Hudson Fasching,R,NYI,29,82,6,7,13
22,8482859,Zack Ostapchuk,C,OTT,21,82,4,9,13
22,8476915,Jujhar Khaira,L,MIN,30,82,3,10,13
22,8477435,Ryan Graves,D,PIT,29,82,2,11,13
22,8471677,Jack Johnson,D,COL,37,82,1,12,13
22,8483397,Marc McLaughlin,C,BOS,25,82,5,7,12
22,8481599,Victor Soderstrom,D,ARI,23,82,5,7,12
22,8482101,Danil Gushchin,L,SJS,22,82,4,8,12
22,8482177,Marat Khusnutdinov,C,MIN,22,82,3,9,12
22,8483012,Logan Morrison,C,SEA,22,82,8,3,11
22,8475825,Jani Hakanpää,D,DAL,32,82,4,7,11
22,8483471,Brad Lambert,C,WPG,31,82,4,7,11
22,8482713,Mackie Samoskevich,R,FLA,22,82,3,8,11
22,8477034,Jaycob Megna,D,CHI,32,82,0,11,11
22,8483489,Fraser Minten,C,TOR,31,82,2,8,10
22,8476473,Connor Murphy,D,CHI,31,82,1,9,10
22,8483466,Kevin Korchinski,D,CHI,20,82,2,7,9
22,8482118,Sam Colangelo,R,ANA,23,82,3,5,8
22,8481030,Jack St. Ivany,D,PIT,25,82,1,7,8
22,8478408,Travis Dermott,D,ARI,28,82,0,7,7
22,8477950,Tony DeAngelo,D,CAR,29,0,0,0,0
22,8481577,Philip Tomasino,C,NSH,23,0,0,0,0
22,8482660,Kent Johnson,C,CBJ,22,0,0,0,0
22,8481019,David Gustafsson,C,WPG,24,0,0,0,0
22,8479348,Kale Clague,D,BUF,26,0,0,0,0
22,8482149,Cole Perfetti,C,WPG,22,0,0,0,0
22,8476952,Dominic Toninato,C,WPG,30,0,0,0,0
22,8473473,Milan Lucic,L,BOS,36,0,0,0,0
22,8480829,Jesperi Kotkaniemi,C,CAR,24,0,0,0,0
22,8474602,Justin Schultz,D,SEA,34,0,0,0,0
22,8480049,Dylan Samberg,D,WPG,25,0,0,0,0
22,8479372,Josh Mahura,D,FLA,26,0,0,0,0
22,8480878,Nils Lundkvist,D,DAL,24,0,0,0,0
22,8479982,Conor Timmins,D,TOR,26,0,0,0,0
22,8474031,Kevin Shattenkirk,D,BOS,35,0,0,0,0
22,8480835,Jack Drury,C,CAR,24,0,0,0,0
22,8480008,Adam Ruzicka,C,ARI,25,0,0,0,0
22,8479402,Jake Bean,D,CBJ,26,0,0,0,0
22,8476474,Stefan Noesen,R,CAR,31,0,0,0,0
22,8480884,Calen Addison,D,SJS,24,0,0,0,0
22,8476994,Vinnie Hinostroza,C,PIT,30,0,0,0,0
22,8477987,Ryan Donato,C,CHI,28,0,0,0,0
22,8481582,Nicholas Robertson,L,TOR,23,0,0,0,0
22,8478452,Caleb Jones,D,COL,27,0,0,0,0
22,8480157,Calle Rosen,D,STL,30,0,0,0,0
22,8481609,Vladislav Kolyachonok,D,ARI,23,0,0,0,0
22,8476919,Chris Tierney,C,NJD,30,0,0,0,0
22,8479639,Dylan Coghlan,D,CAR,26,0,0,0,0
22,8475193,Tomas Tatar,L,SEA,34,0,0,0,0
22,8480748,Kiefer Sherwood,L,NSH,29,0,0,0,0
22,8478146,Matthew Highmore,C,OTT,28,0,0,0,0
22,8478970,Jalen Chatfield,D,CAR,28,0,0,0,0
22,8480205,Emil Bemstrom,C,PIT,25,0,0,0,0
22,8471274,Alex Goligoski,D,MIN,39,0,0,0,0
22,8478104,Sammy Blais,L,STL,28,0,0,0,0
22,8476913,Devin Shore,C,SEA,30,0,0,0,0
22,8481708,Zac Jones,D,NYR,24,0,0,0,0
22,8480222,Sebastian Aho,D,NYI,28,0,0,0,0
22,8481598,Philip Broberg,D,EDM,23,0,0,0,0
22,8480789,Oliver Wahlstrom,R,NYI,24,0,0,0,0
22,8480891,Michael Kesselring,D,ARI,24,0,0,0,0
22,8477979,Nicolas Aube-Kubel,R,WSH,28,0,0,0,0
22,8476393,Nick Cousins,C,FLA,31,0,0,0,0
22,8480003,Jesper Boqvist,C,BOS,26,0,0,0,0
22,8479543,Michael Pezzetta,L,MTL,26,0,0,0,0
22,8475855,Jesper Fast,R,CAR,33,0,0,0,0
22,8477018,Ben Hutton,D,VGK,31,0,0,0,0
22,8480762,Eric Robinson,L,BUF,29,0,0,0,0
22,8481058,Jesse Ylönen,R,MTL,25,0,0,0,0
22,8481527,Kaedan Korczak,D,VGK,23,0,0,0,0
22,8482192,Isaak Phillips,D,CHI,23,0,0,0,0
22,8480727,Zach Whitecloud,D,VGK,28,0,0,0,0
22,8480001,Urho Vaakanainen,D,ANA,25,0,0,0,0
22,8480853,Liam Foudy,C,NSH,24,0,0,0,0
22,8475225,Craig Smith,C,DAL,35,0,0,0,0
22,8479972,Mason Shaw,C,MIN,26,0,0,0,0
22,8474040,Sam Gagner,C,EDM,35,0,0,0,0
22,8480196,Jacob Bryson,D,BUF,27,0,0,0,0
22,8475718,Justin Holl,D,DET,32,0,0,0,0
22,8479984,Cal Foote,D,NJD,26,0,0,0,0
22,8480011,Klim Kostin,C,SJS,25,0,0,0,0
22,8482176,Wyatt Kaiser,D,CHI,22,0,0,0,0
22,8476918,Jimmy Vesey,L,NYR,31,0,0,0,0
22,8476988,Matt Benning,D,SJS,30,0,0,0,0
22,8479370,Tyson Jost,C,BUF,26,0,0,0,0
22,8477464,Nic Petan,C,MIN,29,0,0,0,0
22,8477380,Jonny Brodzinski,C,NYR,31,0,0,0,0
22,8480070,Ian Mitchell,D,BOS,25,0,0,0,0
22,8479315,Joey Anderson,R,CHI,26,0,0,0,0
22,8478099,Kevin Labanc,R,SJS,29,0,0,0,0
22,8476874,Olli Maatta,D,DET,30,0,0,0,0
22,8479414,Nathan Bastian,R,NJD,27,0,0,0,0
22,8478434,Keegan Kolesar,R,VGK,27,0,0,0,0
22,8479536,Axel Jonsson-Fjallby,L,WPG,26,0,0,0,0
22,8479671,Mathieu Olivier,R,CBJ,27,0,0,0,0
22,8471709,Marc-Edouard Vlasic,D,SJS,37,0,0,0,0
22,8479328,Julien Gauthier,R,NYI,27,0,0,0,0
22,8478421,A.J. Greer,L,CGY,28,0,0,0,0
22,8477573,Nathan Walker,L,STL,30,0,0,0,0
22,8477478,William Carrier,L,VGK,30,0,0,0,0
22,8479344,Jesse Puljujarvi,R,PIT,26,0,0,0,0
22,8480887,Jordan Harris,D,MTL,24,0,0,0,0
22,8478502,Dennis Gilbert,D,CGY,28,0,0,0,0
22,8480355,Mark Kastelic,C,OTT,25,0,0,0,0
22,8475750,Jon Merrill,D,MIN,32,0,0,0,0
22,8476889,Radek Faksa,C,DAL,30,0,0,0,0
22,8478432,Christian Fischer,R,DET,27,0,0,0,0
22,8479439,Jacob MacDonald,D,SJS,31,0,0,0,0
22,8474568,Luke Schenn,D,NSH,35,0,0,0,0
22,8478454,Noah Juulsen,D,VAN,27,0,0,0,0
22,8475752,Tyler Pitlick,C,NYR,33,0,0,0,0
22,8482148,Hendrix Lapierre,C,WSH,22,0,0,0,0
22,8481167,Brayden Pachal,D,CGY,25,0,0,0,0
22,8478211,Dryden Hunt,L,CGY,29,0,0,0,0
22,8479321,Lucas Johansen,D,WSH,27,0,0,0,0
22,8480950,Ilya Lyubushkin,D,TOR,30,0,0,0,0
22,8479368,Max Jones,L,ANA,26,0,0,0,0
22,8471699,Andrew Cogliano,C,COL,37,0,0,0,0
22,8481521,Ronnie Attard,D,PHI,25,0,0,0,0
22,8481161,Jake Christiansen,D,CBJ,25,0,0,0,0
22,8479458,Nikita Zaitsev,D,CHI,33,0,0,0,0
22,8479619,Michael Carcone,L,ARI,28,0,0,0,0
22,8479026,Philippe Myers,D,TBL,27,0,0,0,0
22,8481617,Vasily Podkolzin,R,VAN,23,0,0,0,0
22,8481701,Santeri Hatakka,D,NJD,23,0,0,0,0
22,8477446,Michael McCarron,R,NSH,29,0,0,0,0
22,8483460,David Jiricek,D,CBJ,21,0,0,0,0
22,8474090,Brendan Smith,D,NJD,35,0,0,0,0
22,8482241,Radim Zohorna,L,PIT,28,0,0,0,0
22,8481032,Paul Cotter,C,VGK,25,0,0,0,0
22,8480289,Morgan Barron,C,WPG,26,0,0,0,0
22,8479379,Givani Smith,R,SJS,26,0,0,0,0
22,8480216,Jacob Peterson,C,SJS,25,0,0,0,0
22,8477851,Jordan Oesterle,D,CGY,32,0,0,0,0
22,8484258,Sam Malinski,D,COL,26,0,0,0,0
22,8478904,Steven Lorentz,C,FLA,28,0,0,0,0
22,8482095,Tyler Kleven,D,OTT,22,0,0,0,0
22,8480980,Connor Dewar,C,TOR,25,0,0,0,0
22,8480848,Ty Dellandrea,C,DAL,24,0,0,0,0
22,8476884,Derrick Pouliot,D,DAL,30,0,0,0,0
22,8480025,MacKenzie Entwistle,R,CHI,25,0,0,0,0
22,8474612,Travis Hamonic,D,OTT,34,0,0,0,0
22,8479336,Carl Grundstrom,R,LAK,27,0,0,0,0
22,8482964,Arber Xhekaj,D,MTL,23,0,0,0,0
22,8471686,Marc Staal,D,PHI,37,0,0,0,0
22,8477887,Patrick Brown,C,BOS,32,0,0,0,0
22,8478495,Denis Gurianov,R,PHI,27,0,0,0,0
22,8481550,Adam Beckman,L,MIN,23,0,0,0,0
22,8480845,Rasmus Kupari,C,WPG,24,0,0,0,0
22,8478585,Derek Ryan,C,EDM,38,0,0,0,0
22,8482141,Lukas Cormier,D,VGK,22,0,0,0,0
22,8477962,Brendan Lemieux,L,CAR,28,0,0,0,0
22,8482861,Vincent Iorio,D,WSH,22,0,0,0,0
22,8479378,Logan Stanley,D,WPG,26,0,0,0,0
22,8473446,Erik Johnson,D,PHI,36,0,0,0,0
22,8481743,Marc Del Gaizo,D,NSH,25,0,0,0,0
22,8478450,Parker Wotherspoon,D,BOS,27,0,0,0,0
22,8477384,Josh Brown,D,ARI,30,0,0,0,0
22,8482165,Yan Kuznetsov,D,CGY,22,0,0,0,0
22,8478424,Jansen Harkins,C,PIT,27,0,0,0,0
22,8482144,Jack Thompson,D,SJS,22,0,0,0,0
22,8479576,Vincent Desharnais,D,EDM,28,0,0,0,0
22,8478512,Austin Czarnik,C,DET,32,0,0,0,0
22,8477527,Ross Johnston,L,ANA,30,0,0,0,0
22,8482094,Daemon Hunt,D,MIN,22,0,0,0,0
22,8481719,Maxwell Crozier,D,TBL,24,0,0,0,0
22,8480192,Johnathan Kovacevic,D,MTL,27,0,0,0,0
22,8479376,Victor Mete,D,PHI,26,0,0,0,0
22,8482511,Mason Lohrei,D,BOS,23,0,0,0,0
22,8478021,William Lagesson,D,ANA,28,0,0,0,0
22,8475795,Dylan McIlrath,D,WSH,32,0,0,0,0
22,8477846,Ryan Carpenter,C,SJS,33,0,0,0,0
22,8481056,Spencer Stastney,D,NSH,24,0,0,0,0
22,8481564,Ryan Johnson,D,BUF,23,0,0,0,0
22,8478017,Mark Friedman,D,VAN,29,0,0,0,0
22,8479320,Max Lajoie,D,TOR,27,0,0,0,0
22,8480075,Cameron Crotty,D,ARI,25,0,0,0,0
22,8484287,Cole McWard,D,VAN,23,0,0,0,0
22,8484254,Akito Hirose,D,VAN,25,0,0,0,0
22,8483407,Brandon Scanlin,D,NYR,25,0,0,0,0
22,8480274,Philip Kemp,D,EDM,25,0,0,0,0
22,8479522,Hardy Haman Aktell,D,WSH,26,0,0,0,0
22,8480007,Jonas Rondbjerg,R,VGK,25,0,0,0,0
22,8477454,Adam Erne,L,EDM,29,0,0,0,0
22,8481679,Maxence Guenette,D,OTT,23,0,0,0,0
22,8477938,Haydn Fleury,D,TBL,28,0,0,0,0
22,8476441,Joel Edmundson,D,TOR,31,0,0,0,0
22,8477903,Garnet Hathaway,R,PHI,33,0,0,0,0
22,8480441,Trey Fix-Wolansky,R,CBJ,25,0,0,0,0
22,8483546,Marshall Rifai,D,TOR,26,0,0,0,0
22,8480084,Nick DeSimone,D,NJD,30,0,0,0,0
22,8481592,Jakob Pelletier,L,CGY,23,0,0,0,0
22,8478011,Louie Belpedio,D,PHI,28,0,0,0,0
22,8477930,Pierre-Edouard Bellemare,L,SEA,39,0,0,0,0
22,8484321,Nikolas Matinpalo,D,OTT,26,0,0,0,0
22,8482067,Connor Mackey,D,NYR,28,0,0,0,0
22,8481806,Louis Crevier,D,CHI,23,0,0,0,0
22,8484326,Patrik Koch,D,ARI,28,0,0,0,0
22,8477971,Andreas Englund,D,LAK,28,0,0,0,0
22,8481751,Lukas Rousek,R,BUF,25,0,0,0,0
22,8481006,Tyler Tucker,D,STL,24,0,0,0,0
22,8481641,Joel Kiviranta,L,COL,28,0,0,0,0
22,8476867,Brendan Gaunce,C,CBJ,30,0,0,0,0
22,8479520,Brandon Duhaime,R,COL,27,0,0,0,0
22,8477073,Kurtis MacDermid,L,NJD,30,0,0,0,0
22,8480874,Adam Ginning,D,PHI,24,0,0,0,0
22,8477473,Justin Bailey,R,SJS,29,0,0,0,0
22,8479066,Ryan Lomberg,L,FLA,30,0,0,0,0
22,8477070,Liam O'Brien,C,ARI,30,0,0,0,0
22,8474618,Marco Scandella,D,STL,34,0,0,0,0
22,8475797,Jarred Tinordi,D,CHI,32,0,0,0,0
22,8481441,Joe Snively,C,WSH,28,0,0,0,0
22,8477244,Chad Ruhwedel,D,NYR,34,0,0,0,0
22,8482077,Dylan Holloway,L,EDM,23,0,0,0,0
22,8479772,Zack MacEwen,R,OTT,28,0,0,0,0
22,8481147,Reese Johnson,C,CHI,26,0,0,0,0
22,8481043,Cole Koepke,L,TBL,26,0,0,0,0
22,8483619,Filip Roos,D,CHI,25,0,0,0,0
22,8481541,Samuel Bolduc,D,NYI,24,0,0,0,0
22,8477810,Joel Hanley,D,CGY,33,0,0,0,0
22,8476907,Mackenzie MacEachern,L,STL,30,0,0,0,0
22,8482652,Walker Duehr,R,CGY,27,0,0,0,0
22,8477126,Jayson Megna,C,BOS,34,0,0,0,0
22,8483398,Declan Carlile,D,TBL,31,0,0,0,0
22,8482929,Emil Lilleberg,D,TBL,23,0,0,0,0
22,8480880,Jakub Lauko,C,BOS,24,0,0,0,0
22,8478874,Adam Gaudette,C,STL,28,0,0,0,0
22,8480245,Olle Lycksell,R,PHI,25,0,0,0,0
22,8480252,Cole Guttman,C,CHI,25,0,0,0,0
22,8477467,Gustav Olofsson,D,SEA,30,0,0,0,0
22,8479968,Vinni Lettieri,C,MIN,29,0,0,0,0
22,8478400,Colin White,C,MTL,27,0,0,0,0
22,8475755,Alexander Petrovic,D,DAL,32,0,0,0,0
22,8481812,Nikolai Knyzhov,D,SJS,27,0,0,0,0
22,8481593,Jayden Struble,D,MTL,23,0,0,0,0
22,8481532,Alex Turcotte,C,LAK,23,0,0,0,0
22,8482126,Emil Andrae,D,PHI,31,0,0,0,0
22,8479944,Zach Aston-Reese,C,DET,30,0,0,0,0
22,8471817,Ryan Reaves,R,TOR,37,0,0,0,0
22,8481206,John Ludvig,D,PIT,24,0,0,0,0
22,8480292,Carson Meyer,R,CBJ,27,0,0,0,0
22,8482496,Nils Aman,C,VAN,24,0,0,0,0
22,8479718,Alex Barré-Boulet,C,TBL,27,0,0,0,0
22,8479994,Jaret Anderson-Dolan,C,NSH,25,0,0,0,0
22,8480184,Gustav Lindstrom,D,ANA,26,0,0,0,0
22,8480890,Jan Jenik,R,ARI,24,0,0,0,0
22,8478067,Oskar Lindblom,L,SJS,28,0,0,0,0
22,8476934,Brock McGinn,L,ANA,30,0,0,0,0
22,8479985,Cale Fleury,D,SEA,26,0,0,0,0
22,8482153,Brendan Brisson,C,VGK,23,0,0,0,0
22,8480021,Jack Studnicka,C,SJS,25,0,0,0,0
22,8484304,Uvis Balinskis,D,FLA,28,0,0,0,0
22,8479981,Jonah Gadjovich,L,FLA,26,0,0,0,0
22,8481716,Dmitri Voronkov,L,CBJ,24,0,0,0,0
22,8482659,Josh Doan,R,ARI,22,0,0,0,0
22,8481122,Simon Benoit,D,TOR,26,0,0,0,0
22,8474709,Matt Martin,L,NYI,35,0,0,0,0
22,8482634,Alex Steeves,C,TOR,25,0,0,0,0
22,8480823,Alexander Alexeyev,D,WSH,25,0,0,0,0
22,8477541,Dakota Mermis,D,MIN,30,0,0,0,0
22,8478477,Mitchell Stephens,C,MTL,27,0,0,0,0
22,8481543,Nikita Alexandrov,C,STL,24,0,0,0,0
22,8482451,Mikael Pyyhtia,L,CBJ,23,0,0,0,0
22,8480306,Grant Hutton,D,NYI,29,0,0,0,0
22,8478028,Fredrik Olofsson,L,COL,28,0,0,0,0
22,8477462,Robert Hagg,D,ANA,29,0,0,0,0
22,8477320,Anton Blidh,L,NYR,29,0,0,0,0
22,8482749,Joshua Roy,R,MTL,21,0,0,0,0
22,8482157,Will Cuylle,L,NYR,22,0,0,0,0
22,8481239,Samuel Fagemo,L,LAK,24,0,0,0,0
22,8481600,Tobias Bjornfot,D,FLA,23,0,0,0,0
22,8478409,Anthony Richard,C,BOS,28,0,0,0,0
22,8474145,Robert Bortuzzo,D,NYI,35,0,0,0,0
22,8475958,Michael Sgarbossa,C,WSH,32,0,0,0,0
22,8479986,Kole Lind,R,SEA,26,0,0,0,0
22,8479249,Andrew Poturalski,C,SEA,30,0,0,0,0
22,8479362,Riley Tufte,L,COL,26,0,0,0,0
22,8479991,Jake Leschyshyn,C,NYR,25,0,0,0,0
22,8479587,Rhett Gardner,C,PHI,28,0,0,0,0
22,8482744,James Malatesta,L,CBJ,21,0,0,0,0
22,8478854,Ryan Shea,D,PIT,27,0,0,0,0
22,8481591,Sam Poulin,R,PIT,23,0,0,0,0
22,8483512,Matt Savoie,C,BUF,20,0,0,0,0
22,8482102,Vasily Ponomarev,C,CAR,22,0,0,0,0
22,8482162,Roby Jarventie,L,OTT,22,0,0,0,0
22,8482172,Landon Slaggert,L,CHI,22,0,0,0,0
22,8482747,Brennan Othmann,L,NYR,21,0,0,0,0
22,8480226,Marián Studenic,R,SEA,26,0,0,0,0
22,8481518,Nolan Foote,L,NJD,24,0,0,0,0
22,8479419,Brett Murray,L,BUF,26,0,0,0,0
22,8482088,Justin Sourdif,R,FLA,22,0,0,0,0
22,8482201,Gage Goncalves,C,TBL,23,0,0,0,0
22,8481754,Nikita Nesterenko,C,ANA,23,0,0,0,0
22,8483531,Brian Halonen,L,NJD,25,0,0,0,0
22,8483920,Pierrick Dube,R,WSH,23,0,0,0,0
22,8480851,Akil Thomas,C,LAK,24,0,0,0,0
22,8475235,Nicolas Deslauriers,L,PHI,33,0,0,0,0
22,8482476,Emil Heineman,L,MTL,23,0,0,0,0
22,8477149,Scott Sabourin,R,SJS,32,0,0,0,0
22,8483549,Lucas Condotta,L,MTL,27,0,0,0,0
22,8483567,Georgii Merkulov,C,BOS,24,0,0,0,0
22,8482765,Isak Rosen,R,BUF,21,0,0,0,0
22,8481237,Kyle MacLean,C,NYI,25,0,0,0,0
22,8481024,Linus Karlsson,C,VAN,25,0,0,0,0
22,8481690,Tyler Angle,C,CBJ,24,0,0,0,0
22,8483570,Ben Meyers,C,ANA,26,0,0,0,0
22,8481655,Cole Schwindt,R,CGY,23,0,0,0,0
22,8481462,Mason Morelli,L,VGK,28,0,0,0,0
22,8483401,Marc Johnstone,R,PIT,28,0,0,0,0
22,8478956,Samuel Laberge,L,NJD,27,0,0,0,0
22,8479533,Joona Koppanen,L,PIT,26,0,0,0,0
22,8482197,Adam Raska,R,MIN,23,0,0,0,0
22,8482250,Callahan Burke,C,CAR,27,0,0,0,0
22,8482784,Zach Dean,C,STL,21,0,0,0,0
22,8484255,Jason Polin,R,COL,25,0,0,0,0
22,8481077,John Leonard,L,ARI,26,0,0,0,0
22,8481534,Raphael Lavoie,C,EDM,24,0,0,0,0
22,8483609,Adam Klapka,R,CGY,24,0,0,0,0
22,8482751,Ryan Winterton,C,SEA,21,0,0,0,0
22,8480267,Sammy Walker,C,MIN,25,0,0,0,0
22,8475766,Austin Watson,L,TBL,32,0,0,0,0
22,8482460,Matt Rempe,C,NYR,22,0,0,0,0
22,8482787,Nikita Chibrikov,R,WPG,31,0,0,0,0
22,8481065,Angus Crookshank,L,OTT,25,0,0,0,0
22,8481070,Hugh McGing,L,STL,26,0,0,0,0
22,8476323,Max McCormick,L,SEA,32,0,0,0,0
22,8483395,Arshdeep Bains,L,VAN,23,0,0,0,0
22,8484259,Ondrej Pavel,C,COL,31,0,0,0,0
22,8483432,Luca Del Bel Belluz,C,CBJ,31,0,0,0,0
22,8483045,Cameron Butler,R,CBJ,31,0,0,0,0
22,8482061,Brandon Biro,L,BUF,26,0,0,0,0
22,8477401,John Hayden,C,SEA,29,0,0,0,0
22,8475278,Byron Froese,C,VGK,33,0,0,0,0
22,8478446,Glenn Gawdin,C,ANA,27,0,0,0,0
22,8477993,Justin Kirkland,C,ARI,28,0,0,0,0
22,8482147,Jean-Luc Foudy,C,COL,22,0,0,0,0
22,8480032,Shane Bowers,C,NJD,25,0,0,0,0
22,8479330,Brandon Gignac,C,MTL,27,0,0,0,0
22,8480776,Sheldon Rempal,R,VGK,29,0,0,0,0
22,8475413,Justin Dowling,C,NJD,34,0,0,0,0
22,8481726,Adam Edstrom,C,NYR,24,0,0,0,0
22,8479638,Justin Brazeau,R,BOS,26,0,0,0,0
22,8480844,Grigori Denisenko,L,VGK,24,0,0,0,0
22,8474062,Riley Nash,C,NYR,35,0,0,0,0
22,8478147,Bokondji Imama,L,OTT,28,0,0,0,0
22,8478881,Brett Seney,L,CHI,28,0,0,0,0
22,8483630,Pavol Regenda,L,ANA,25,0,0,0,0
22,8480836,Jonathan Gruden,C,PIT,24,0,0,0,0
22,8484314,Jiri Smejkal,L,OTT,28,0,0,0,0
22,8475780,Chris Wagner,R,COL,33,0,0,0,0
22,8482070,Mitchell Chaffee,R,TBL,26,0,0,0,0
22,8479546,Oskar Steen,C,BOS,26,0,0,0,0
22,8483597,Milos Kelemen,L,ARI,25,0,0,0,0
22,8481789,Tye Kartye,L,SEA,23,0,0,0,0
22,8484325,Waltteri Merela,C,TBL,26,0,0,0,0
22,8479421,Jacob Moverare,D,LAK,26,0,0,0,0
22,8481585,Egor Afanasyev,L,NSH,23,0,0,0,0
22,8479547,Matthew Phillips,R,WSH,26,0,0,0,0
22,8479367,William Lockwood,R,FLA,26,0,0,0,0
22,8481422,Jacob Lucchini,C,MIN,29,0,0,0,0
22,8480468,James Hamblin,L,EDM,25,0,0,0,0
22,8480870,Bo Groulx,C,ANA,24,0,0,0,0
22,8478051,Max Willman,C,NJD,29,0,0,0,0
22,8481556,John Beecher,C,BOS,23,0,0,0,0
22,8478078,Rourke Chartier,C,OTT,28,0,0,0,0
23,8478402,Connor McDavid,C,EDM,27,82,49,95,144
23,8476453,Nikita Kucherov,R,TBL,31,82,42,94,136
23,8481559,Jack Hughes,C,NJD,23,82,49,76,125
23,8477492,Nathan MacKinnon,C,COL,29,82,42,83,125
23,8479318,Auston Matthews,C,TOR,27,82,62,61,123
23,8477956,David Pastrnak,R,BOS,28,82,56,66,122
23,8476887,Filip Forsberg,L,NSH,30,82,55,65,120
23,8477939,William Nylander,R,TOR,28,82,52,58,110
23,8478420,Mikko Rantanen,R,COL,28,82,43,65,108
23,8477934,Leon Draisaitl,C,EDM,29,82,45,60,105
23,8477942,Kevin Fiala,L,LAK,28,82,46,55,101
23,8479343,Clayton Keller,R,ARI,26,82,48,49,97
23,8477493,Aleksander Barkov,C,FLA,29,82,37,60,97
23,8476468,J.T. Miller,C,VAN,31,82,27,70,97
23,8477946,Dylan Larkin,C,DET,28,82,43,53,96
23,8481557,Matt Boldy,L,MIN,23,82,48,45,93
23,8477501,Valeri Nichushkin,R,COL,29,82,41,52,93
23,8478864,Kirill Kaprizov,L,MIN,27,82,32,61,93
23,8477933,Sam Reinhart,C,FLA,29,82,44,48,92
23,8480002,Nico Hischier,C,NJD,25,82,37,54,91
23,8480012,Elias Pettersson,C,VAN,26,82,38,52,90
23,8478439,Travis Konecny,R,PHI,27,82,36,54,90
23,8480023,Robert Thomas,C,STL,25,82,27,63,90
23,8471215,Evgeni Malkin,C,PIT,38,82,25,65,90
23,8477404,Jake Guentzel,C,CAR,30,82,35,54,89
23,8480036,Miro Heiskanen,D,DAL,25,82,19,70,89
23,8480027,Jason Robertson,L,DAL,25,82,34,53,87
23,8478550,Artemi Panarin,L,NYR,33,82,31,55,86
23,8479314,Matthew Tkachuk,L,FLA,27,82,24,62,86
23,8475184,Chris Kreider,L,NYR,33,82,45,40,85
23,8478427,Sebastian Aho,C,CAR,27,82,39,46,85
23,8474564,Steven Stamkos,C,TBL,34,82,33,52,85
23,8474600,Roman Josi,D,NSH,34,82,22,62,84
23,8480800,Quinn Hughes,D,VAN,25,82,14,70,84
23,8477500,Bo Horvat,C,NYI,29,82,43,40,83
23,8475166,John Tavares,C,TOR,34,82,39,44,83
23,8480069,Cale Makar,D,COL,26,82,27,56,83
23,8475172,Nazem Kadri,C,CGY,34,82,25,58,83
23,8476460,Mark Scheifele,C,WPG,31,82,35,47,82
23,8478414,Timo Meier,R,NJD,28,82,51,30,81
23,8479420,Tage Thompson,C,BUF,27,82,42,39,81
23,8482116,Tim Stützle,C,OTT,22,82,29,52,81
23,8478493,Joel Eriksson Ek,C,MIN,27,82,31,49,80
23,8480830,Andrei Svechnikov,R,CAR,24,82,39,40,79
23,8480208,Drake Batherson,R,OTT,26,82,32,46,78
23,8479407,Jesper Bratt,L,NJD,26,82,26,52,78
23,8476346,Johnny Gaudreau,L,CBJ,31,82,19,59,78
23,8478398,Kyle Connor,L,WPG,28,82,35,42,77
23,8477960,Adrian Kempe,R,LAK,28,82,36,40,76
23,8476459,Mika Zibanejad,C,NYR,31,82,32,44,76
23,8476456,Jonathan Huberdeau,C,CGY,31,82,18,58,76
23,8473419,Brad Marchand,L,BOS,36,82,24,51,75
23,8478445,Mathew Barzal,C,NYI,27,82,18,57,75
23,8480801,Brady Tkachuk,L,OTT,25,82,32,42,74
23,8477476,Artturi Lehkonen,L,COL,29,82,31,43,74
23,8478440,Dylan Strome,C,WSH,27,82,30,44,74
23,8475158,Ryan O'Reilly,C,NSH,33,82,30,44,74
23,8477949,Alex Tuch,R,BUF,28,82,24,50,74
23,8470794,Joe Pavelski,C,DAL,40,82,22,52,74
23,8479323,Adam Fox,D,NYR,26,82,19,55,74
23,8480839,Rasmus Dahlin,D,BUF,24,82,18,56,74
23,8478403,Jack Eichel,C,VGK,28,82,39,34,73
23,8478010,Brayden Point,C,TBL,28,82,29,44,73
23,8474590,John Carlson,D,WSH,34,82,17,56,73
23,8475726,Tyler Toffoli,C,WPG,32,82,37,35,72
23,8480803,Evan Bouchard,D,EDM,25,82,17,55,72
23,8480865,Noah Dobson,D,NYI,24,82,13,59,72
23,8479339,Patrik Laine,L,CBJ,26,82,39,32,71
23,8471685,Anze Kopitar,C,LAK,37,82,29,42,71
23,8477951,Nick Schmaltz,C,ARI,28,82,27,44,71
23,8479385,Jordan Kyrou,C,STL,26,82,24,47,71
23,8476853,Morgan Rielly,D,TOR,30,82,9,62,71
23,8475810,Bryan Rust,R,PIT,32,82,33,37,70
23,8478460,Zach Werenski,D,CBJ,27,82,14,56,70
23,8471675,Sidney Crosby,C,PIT,37,82,36,33,69
23,8482093,Seth Jarvis,C,CAR,22,82,36,33,69
23,8476389,Vincent Trocheck,C,NYR,31,82,35,34,69
23,8475170,Brayden Schenn,C,STL,33,82,35,34,69
23,8479337,Alex DeBrincat,R,DET,27,82,33,36,69
23,8475784,Jeff Skinner,C,BUF,32,82,29,40,69
23,8474141,Patrick Kane,R,DET,36,82,28,40,68
23,8476905,Chandler Stephenson,C,VGK,30,82,22,46,68
23,8476454,Ryan Nugent-Hopkins,C,EDM,31,82,21,47,68
23,8478407,Vince Dunn,D,SEA,28,82,11,57,68
23,8475754,Brock Nelson,C,NYI,33,82,41,26,67
23,8474679,Gustav Nyquist,C,NSH,35,82,20,47,67
23,8471214,Alex Ovechkin,L,WSH,39,82,34,32,66
23,8477940,Nikolaj Ehlers,L,WPG,28,82,23,43,66
23,8476462,Dougie Hamilton,D,NJD,31,82,21,45,66
23,8474578,Erik Karlsson,D,PIT,34,82,21,45,66
23,8475167,Victor Hedman,D,TBL,34,82,16,50,66
23,8473986,Alex Killorn,L,ANA,35,82,30,35,65
23,8476448,William Karlsson,C,VGK,31,82,27,38,65
23,8477479,Tyler Bertuzzi,L,TOR,29,82,27,38,65
23,8475765,Vladimir Tarasenko,R,FLA,33,82,25,40,65
23,8477504,Josh Morrissey,D,WPG,29,82,14,51,65
23,8481523,Kirby Dach,C,MTL,23,82,8,57,65
23,8475169,Evander Kane,L,EDM,33,82,34,30,64
23,8477402,Pavel Buchnevich,L,STL,29,82,26,38,64
23,8480015,Owen Tippett,R,PHI,25,82,26,38,64
23,8477494,Jonathan Drouin,L,COL,29,82,23,41,64
23,8471724,Kris Letang,D,PIT,37,82,11,53,64
23,8471698,T.J. Oshie,R,WSH,38,82,32,31,63
23,8477955,Jared McCann,L,SEA,28,82,31,32,63
23,8478449,Roope Hintz,C,DAL,28,82,28,35,63
23,8476539,Jonathan Marchessault,R,VGK,34,82,28,35,63
23,8480018,Nick Suzuki,C,MTL,25,82,21,42,63
23,8477447,Shea Theodore,D,VGK,29,82,12,51,63
23,8474563,Drew Doughty,D,LAK,35,82,12,51,63
23,8479325,Charlie McAvoy,D,BOS,27,82,11,52,63
23,8478444,Brock Boeser,R,VAN,27,82,35,27,62
23,8481540,Cole Caufield,R,MTL,23,82,30,32,62
23,8477409,Carter Verhaeghe,C,FLA,29,82,27,35,62
23,8474102,David Perron,L,DET,36,82,22,40,62
23,8476826,Yanni Gourde,C,SEA,33,82,21,41,62
23,8473512,Claude Giroux,R,OTT,36,82,20,42,62
23,8478873,Troy Terry,R,ANA,27,82,19,43,62
23,8470613,Brent Burns,D,CAR,39,82,13,49,62
23,8480039,Martin Necas,C,CAR,25,82,26,35,61
23,8479542,Brandon Hagel,L,TBL,26,82,24,37,61
23,8479675,Trevor Moore,L,LAK,29,82,24,37,61
23,8478975,Mason Marchment,L,DAL,29,82,21,40,61
23,8475913,Mark Stone,R,VGK,32,82,20,41,61
23,8482124,Quinton Byfield,R,LAK,22,82,27,33,60
23,8482078,Lucas Raymond,L,DET,22,82,24,36,60
23,8477496,Elias Lindholm,C,VAN,30,82,20,40,60
23,8474150,Mikael Backlund,C,CGY,35,82,18,41,59
23,8479999,Casey Mittelstadt,C,COL,26,82,11,48,59
23,8477495,Seth Jones,D,CHI,30,82,9,50,59
23,8475794,Tyler Seguin,C,DAL,32,82,31,27,58
23,8475692,Mats Zuccarello,R,MIN,37,82,15,43,58
23,8477416,Oliver Bjorkstrand,R,SEA,29,82,27,30,57
23,8478055,Gustav Forsling,D,FLA,28,82,18,39,57
23,8475798,Mikael Granlund,C,SJS,32,82,17,40,57
23,8478396,Noah Hanifin,D,VGK,27,82,15,42,57
23,8476399,Blake Coleman,C,CGY,33,82,33,23,56
23,8481068,Yegor Sharangovich,C,CGY,26,82,32,24,56
23,8475168,Matt Duchene,C,DAL,33,82,31,25,56
23,8476881,Tomas Hertl,C,VGK,31,82,29,27,56
23,8475786,Zach Hyman,L,EDM,32,82,29,27,56
23,8481528,Dylan Cozens,C,BUF,23,82,25,31,56
23,8482097,Jack Quinn,R,BUF,23,82,23,33,56
23,8481711,Matias Maccelli,L,ARI,24,82,13,43,56
23,8476432,Boone Jenner,C,CBJ,31,82,31,24,55
23,8478366,Frank Vatrano,R,ANA,30,82,27,28,55
23,8477497,Sean Monahan,C,WPG,30,82,18,37,55
23,8476880,Tom Wilson,R,WSH,30,82,28,26,54
23,8481618,Alex Newhook,C,MTL,23,82,28,26,54
23,8482146,Luke Evangelista,R,NSH,22,82,26,28,54
23,8474641,Adam Henrique,C,EDM,34,82,25,29,54
23,8483808,Andrei Kuzmenko,L,CGY,28,82,21,33,54
23,8480798,Philipp Kurashev,C,CHI,25,82,20,34,54
23,8474586,Jordan Eberle,R,SEA,34,82,19,35,54
23,8478469,Thomas Chabot,D,OTT,27,82,18,36,54
23,8476882,Teuvo Teravainen,L,CAR,30,82,15,39,54
23,8476875,Mike Matheson,D,MTL,30,82,13,41,54
23,8476906,Shayne Gostisbehere,D,DET,31,82,10,44,54
23,8482684,Luke Hughes,D,NJD,21,82,9,45,54
23,8478038,Devon Toews,D,COL,30,82,9,45,54
23,8477964,Ivan Barbashev,C,VGK,29,82,33,20,53
23,8482699,Dylan Guenther,R,ARI,21,82,28,25,53
23,8477935,Sam Bennett,C,FLA,28,82,27,26,53
23,8481560,Arthur Kaliyev,R,LAK,23,82,25,28,53
23,8473422,Nick Foligno,L,CHI,37,82,23,30,53
23,8478042,Viktor Arvidsson,R,LAK,31,82,21,32,53
23,8478047,Michael Bunting,L,PIT,29,82,20,33,53
23,8479400,Pierre-Luc Dubois,L,LAK,26,82,19,34,53
23,8480014,Gabriel Vilardi,C,WPG,25,82,33,19,52
23,8474037,James van Riemsdyk,L,BOS,35,82,27,25,52
23,8475760,Nick Bjugstad,C,ARI,32,82,27,25,52
23,8475722,Jason Zucker,L,NSH,32,82,24,28,52
23,8478438,Tommy Novak,C,NSH,27,82,21,31,52
23,8478401,Pavel Zacha,C,BOS,27,82,17,35,52
23,8476479,Phillip Danault,C,LAK,31,82,15,37,52
23,8479425,Filip Hronek,D,VAN,27,82,12,40,52
23,8482175,JJ Peterka,R,BUF,22,82,28,23,51
23,8477407,Anthony Duclair,L,TBL,29,82,25,26,51
23,8484144,Connor Bedard,C,CHI,19,82,20,31,51
23,8477986,Brandon Montour,D,FLA,30,82,18,33,51
23,8477947,Sonny Milano,L,WSH,28,82,17,34,51
23,8479345,Jakob Chychrun,D,OTT,26,82,15,36,51
23,8478397,Rasmus Andersson,D,CGY,28,82,14,37,51
23,8477021,Alex Kerfoot,C,ARI,30,82,11,40,51
23,8476958,Jaccob Slavin,D,CAR,30,82,11,40,51
23,8477346,MacKenzie Weegar,D,CGY,30,82,10,41,51
23,8478498,Jake DeBrusk,L,BOS,28,82,25,25,50
23,8478856,Conor Garland,R,VAN,28,82,23,27,50
23,8478466,Daniel Sprong,R,DET,27,82,23,27,50
23,8477456,J.T. Compher,L,DET,29,82,17,33,50
23,8473994,Jamie Benn,L,DAL,35,82,15,35,50
23,8481533,Trevor Zegras,C,ANA,23,82,14,36,50
23,8480064,Josh Norris,C,OTT,25,82,32,17,49
23,8482745,Mason McTavish,C,ANA,21,82,26,23,49
23,8477451,Ryan Hartman,R,MIN,30,82,21,28,49
23,8471218,Blake Wheeler,R,NYR,38,82,20,29,49
23,8477444,Andre Burakovsky,L,SEA,29,82,17,32,49
23,8477503,Max Domi,C,TOR,29,82,13,36,49
23,8477948,Travis Sanheim,D,PHI,28,82,9,40,49
23,8481542,Moritz Seider,D,DET,23,82,8,41,49
23,8482159,Tyson Foerster,R,PHI,22,82,25,23,48
23,8482665,Matty Beniers,C,SEA,22,82,23,25,48
23,8475191,Reilly Smith,R,PIT,33,82,20,28,48
23,8475745,Charlie Coyle,C,BOS,32,82,18,30,48
23,8475753,Justin Faulk,D,STL,32,82,15,33,48
23,8476792,Torey Krug,D,STL,33,82,11,37,48
23,8480434,Sean Durzi,D,ARI,26,82,10,38,48
23,8479410,Mikhail Sergachev,D,TBL,26,82,5,43,48
23,8482110,Dawson Mercer,C,NJD,23,82,26,21,47
23,8477998,Warren Foegele,L,EDM,28,82,21,26,47
23,8480078,Filip Chytil,C,NYR,25,82,19,28,47
23,8479987,Morgan Geekie,C,BOS,26,82,19,28,47
23,8475768,Jaden Schwartz,C,SEA,32,82,19,28,47
23,8480797,Joel Farabee,L,PHI,24,82,15,32,47
23,8475149,Marcus Johansson,L,MIN,34,82,15,32,47
23,8479365,Trent Frederic,C,BOS,26,82,24,22,46
23,8480028,Morgan Frost,C,PHI,25,82,20,26,46
23,8476872,Scott Laughton,C,PHI,30,82,13,33,46
23,8478519,Anthony Cirelli,C,TBL,27,82,23,22,45
23,8478462,Nicolas Roy,C,VGK,27,82,20,25,45
23,8482113,Anton Lundell,C,FLA,23,82,19,26,45
23,8479996,Cody Glass,C,NSH,25,82,19,26,45
23,8482109,Alexis Lafrenière,L,NYR,23,82,17,28,45
23,8475744,Evgeny Kuznetsov,C,CAR,32,82,13,32,45
23,8476869,Brady Skjei,D,CAR,30,82,13,32,45
23,8474157,Max Pacioretty,L,WSH,36,82,12,33,45
23,8478458,Jack Roslovic,C,NYR,27,82,15,29,44
23,8478472,Mathieu Joseph,R,OTT,27,82,9,35,44
23,8476979,Erik Gustafsson,D,NYR,32,82,7,37,44
23,8478233,Andrew Mangiapane,L,CGY,28,82,23,20,43
23,8481596,Shane Pinto,C,OTT,24,82,18,25,43
23,8481013,Jonatan Berggren,R,DET,24,82,16,27,43
23,8475791,Taylor Hall,L,CHI,33,82,15,28,43
23,8477932,Aaron Ekblad,D,FLA,28,82,9,34,43
23,8470621,Corey Perry,R,EDM,39,82,28,14,42
23,8478474,Lawson Crouse,L,ARI,27,82,24,18,42
23,8475314,Anders Lee,L,NYI,34,82,23,19,42
23,8475714,Calle Jarnkrok,C,TOR,33,82,22,20,42
23,8476438,Brandon Saad,L,STL,32,82,21,21,42
23,8481580,Connor McMichael,C,WSH,23,82,20,22,42
23,8475799,Nino Niederreiter,R,WPG,32,82,17,25,42
23,8475287,Erik Haula,L,NJD,33,82,17,25,42
23,8480113,Alex Iafallo,L,WPG,31,82,14,28,42
23,8476292,Ondrej Palat,L,NJD,33,82,11,31,42
23,8475906,John Klingberg,D,TOR,32,82,9,33,42
23,8476461,Sean Couturier,C,PHI,32,82,16,25,41
23,8480188,Fabian Zetterlund,L,SJS,25,82,14,27,41
23,8480849,Barrett Hayton,C,ARI,24,82,12,29,41
23,8482671,Owen Power,D,BUF,22,82,9,32,41
23,8482740,Wyatt Johnston,C,DAL,21,82,21,19,40
23,8482089,Jake Neighbours,L,STL,22,82,21,19,40
23,8480220,Noah Cates,L,PHI,25,82,21,19,40
23,8480185,Eetu Luostarinen,C,FLA,26,82,19,21,40
23,8475764,Cam Fowler,D,ANA,33,82,13,27,40
23,8480893,Kirill Marchenko,R,CBJ,24,82,25,14,39
23,8480813,Joe Veleno,C,DET,24,82,21,18,39
23,8478109,Victor Olofsson,L,BUF,29,82,18,21,39
23,8476374,Sean Kuraly,C,CBJ,31,82,16,23,39
23,8480009,Eeli Tolvanen,R,SEA,25,82,15,24,39
23,8475763,Kevin Hayes,R,STL,32,82,12,27,39
23,8477429,Andrew Copp,C,DET,30,82,11,28,39
23,8477511,Anthony Mantha,R,VGK,30,82,10,29,39
23,8476329,Travis Boyd,C,ARI,31,82,10,29,39
23,8475197,Tyson Barrie,D,NSH,33,82,10,29,39
23,8481581,Thomas Harley,D,DAL,23,82,8,31,39
23,8482122,Brock Faber,D,MIN,22,82,8,31,39
23,8482105,Jake Sanderson,D,OTT,22,82,6,33,39
23,8480459,Pius Suter,C,VAN,28,82,23,15,38
23,8475151,Kyle Palmieri,C,NYI,33,82,19,19,38
23,8482092,Ridly Greig,C,OTT,22,82,18,20,38
23,8475793,Ryan Johansen,C,PHI,32,82,17,21,38
23,8480855,Jack McBain,C,ARI,24,82,17,21,38
23,8481624,Ilya Mikheyev,R,VAN,30,82,16,22,38
23,8476960,Andreas Athanasiou,C,CHI,30,82,14,24,38
23,8477498,Darnell Nurse,D,EDM,29,82,10,28,38
23,8478911,Matt Roy,D,LAK,29,82,9,29,38
23,8481546,Cam York,D,PHI,23,82,9,29,38
23,8478500,Ivan Provorov,D,CBJ,27,82,9,29,38
23,8477353,Tyler Motte,C,TBL,29,82,24,13,37
23,8477952,Robby Fabbri,C,DET,28,82,21,16,37
23,8477450,Jason Dickinson,C,CHI,29,82,21,16,37
23,8474189,Lars Eller,C,PIT,35,82,20,17,37
23,8482667,William Eklund,L,SJS,22,82,18,19,37
23,8481186,Logan O'Connor,R,COL,28,82,18,19,37
23,8480995,Pontus Holmberg,R,TOR,25,82,18,19,37
23,8474715,Cam Atkinson,R,PHI,35,82,17,20,37
23,8482222,Alexander Barabanov,L,SJS,30,82,16,21,37
23,8478542,Evan Rodrigues,C,FLA,31,82,15,22,37
23,8482705,Cole Sillinger,C,CBJ,21,82,14,23,37
23,8474716,Jared Spurgeon,D,MIN,35,82,14,23,37
23,8482720,Matthew Knies,L,TOR,22,82,13,24,37
23,8474565,Alex Pietrangelo,D,VGK,34,82,7,30,37
23,8476925,Colton Sissons,C,NSH,31,82,20,16,36
23,8482055,Drew O'Connor,L,PIT,26,82,19,17,36
23,8475220,Marcus Foligno,L,MIN,33,82,19,17,36
23,8482125,Alexander Holtz,R,NJD,22,82,18,18,36
23,8476897,Oskar Sundqvist,C,STL,30,82,18,18,36
23,8480068,Ryan Poehling,C,PHI,25,82,17,19,36
23,8476483,Rickard Rakell,R,PIT,31,82,15,21,36
23,8474053,Logan Couture,C,SJS,35,82,14,22,36
23,8480336,Sean Walker,D,COL,30,82,12,24,36
23,8479976,Juuso Valimaki,D,ARI,26,82,9,27,36
23,8476923,Damon Severson,D,CBJ,30,82,7,29,36
23,8476854,Hampus Lindholm,D,BOS,30,82,7,29,36
23,8477969,Marcus Pettersson,D,PIT,28,82,3,33,36
23,8478115,Pierre Engvall,L,NYI,28,82,19,16,35
23,8483515,Juraj Slafkovsky,L,MTL,20,82,19,16,35
23,8478046,Danton Heinen,L,BOS,29,82,18,17,35
23,8477944,Jakub Vrana,L,STL,28,82,17,18,35
23,8481553,Bobby Brink,R,PHI,23,82,15,20,35
23,8477425,Miles Wood,L,COL,29,82,15,20,35
23,8476458,Ryan Strome,C,ANA,31,82,12,23,35
23,8476392,Adam Lowry,C,WPG,31,82,10,25,35
23,8482655,J.J. Moser,D,ARI,24,82,4,31,35
23,8480873,Rasmus Sandin,D,WSH,24,82,2,33,35
23,8474034,Pat Maroon,L,BOS,36,82,16,18,34
23,8481704,Juuso Parssinen,C,NSH,23,82,15,19,34
23,8481656,Aliaksei Protas,C,WSH,23,82,15,19,34
23,8479992,Michael Rasmussen,C,DET,25,82,13,21,34
23,8476419,Jean-Gabriel Pageau,C,NYI,32,82,10,24,34
23,8476917,Adam Pelech,D,NYI,30,82,9,25,34
23,8480871,Adam Boqvist,D,CBJ,24,82,8,26,34
23,8480043,Timothy Liljegren,D,TOR,25,82,5,29,34
23,8474151,Ryan McDonagh,D,NSH,35,82,3,31,34
23,8481535,Nils Hoglander,L,VAN,24,82,24,9,33
23,8476981,Josh Anderson,R,MTL,30,82,20,13,33
23,8476469,Joel Armia,R,MTL,31,82,19,14,33
23,8476921,Jordan Martinook,L,CAR,32,82,18,15,33
23,8477426,Nicholas Paul,L,TBL,29,82,17,16,33
23,8474870,Tyler Johnson,C,CHI,34,82,16,17,33
23,8479293,Brandon Tanev,L,SEA,33,82,16,17,33
23,8479591,Michael Eyssimont,C,TBL,28,82,15,18,33
23,8479941,Justin Danforth,R,CBJ,31,82,15,18,33
23,8482117,Lukas Reichel,L,CHI,22,82,12,21,33
23,8477506,Ryan Pulock,D,NYI,30,82,6,27,33
23,8478507,John Marino,D,NJD,27,82,5,28,33
23,8476278,Colin Blackwell,C,CHI,31,82,19,13,32
23,8482062,Cole Smith,L,NSH,29,82,18,14,32
23,8481093,Rafael Harvey-Pinard,L,MTL,25,82,17,15,32
23,8479525,Ross Colton,C,COL,28,82,17,15,32
23,8479977,Kailer Yamamoto,R,SEA,26,82,15,17,32
23,8473449,Kyle Okposo,R,FLA,36,82,14,18,32
23,8476480,Vladislav Namestnikov,C,WPG,32,82,13,19,32
23,8475343,Nic Dowd,C,WSH,34,82,13,19,32
23,8479390,Taylor Raddysh,R,CHI,26,82,12,20,32
23,8480802,Ryan McLeod,C,EDM,25,82,11,21,32
23,8477989,Christian Dvorak,C,MTL,28,82,11,21,32
23,8477919,Frederick Gaudreau,C,MIN,31,82,11,21,32
23,8473563,Nicklas Backstrom,C,WSH,37,82,10,22,32
23,8481606,Jordan Spence,D,LAK,23,82,8,24,32
23,8473507,Jeff Petry,D,DET,37,82,8,24,32
23,8483457,Lane Hutson,D,MTL,20,82,8,24,32
23,8482142,Jamie Drysdale,D,PHI,22,82,7,25,32
23,8475171,Oliver Ekman-Larsson,D,FLA,33,82,7,25,32
23,8478851,Alexandre Carrier,D,NSH,28,82,6,26,32
23,8480807,Mattias Samuelsson,D,BUF,24,82,5,27,32
23,8474673,TJ Brodie,D,TOR,34,82,5,27,32
23,8477330,Dominik Kubalik,L,OTT,29,82,15,16,31
23,8479346,Dillon Dube,C,CGY,26,82,15,16,31
23,8476871,Tanner Pearson,L,MTL,32,82,14,17,31
23,8482079,Marco Rossi,C,MIN,23,82,13,18,31
23,8481604,Pavel Dorofeyev,L,VGK,24,82,11,20,31
23,8481703,Valtteri Puustinen,R,PIT,25,82,8,23,31
23,8484166,Adam Fantilli,C,CBJ,20,82,19,11,30
23,8482475,Yegor Chinakhov,R,CBJ,23,82,15,15,30
23,8481554,Kaapo Kakko,R,NYR,23,82,14,16,30
23,8473533,Jordan Staal,C,CAR,36,82,12,18,30
23,8478133,Jake Evans,C,MTL,28,82,10,20,30
23,8480074,Alexandre Texier,C,CBJ,25,82,9,21,30
23,8478463,Anthony Beauvillier,L,NSH,27,82,8,22,30
23,8482624,Daniil Miromanov,D,CGY,27,82,8,22,30
23,8475200,Dmitry Orlov,D,CAR,33,82,7,23,30
23,8480817,K'Andre Miller,D,NYR,24,82,6,24,30
23,8476927,Teddy Blueger,C,VAN,30,82,6,24,30
23,8475218,Mattias Ekholm,D,EDM,34,82,5,25,30
23,8480860,Kevin Bahl,D,NJD,24,82,3,27,30
23,8470610,Zach Parise,L,COL,40,82,16,13,29
23,8478043,Sam Lafferty,C,VAN,29,82,15,14,29
23,8479423,Alex Nylander,L,CBJ,26,82,15,14,29
23,8478891,Mason Appleton,C,WPG,28,82,12,17,29
23,8476873,Mark Jankowski,C,NSH,30,82,12,17,29
23,8479415,Michael McLeod,C,NJD,26,82,12,17,29
23,8480073,Erik Brannstrom,D,OTT,25,82,7,22,29
23,8480796,Martin Fehervary,D,WSH,25,82,5,24,29
23,8478013,Jake Walman,D,DET,28,82,5,24,29
23,8483490,Pavel Mintyukov,D,ANA,21,82,1,28,29
23,8474149,Evgenii Dadonov,R,DAL,35,82,15,13,28
23,8480821,Filip Zadina,R,SJS,25,82,14,14,28
23,8481601,Simon Holmstrom,R,NYI,23,82,13,15,28
23,8477015,Connor Brown,R,EDM,30,82,12,16,28
23,8481481,Blake Lizotte,C,LAK,27,82,9,19,28
23,8476885,Jacob Trouba,D,NYR,30,82,7,21,28
23,8480145,Neal Pionk,D,WPG,29,82,6,22,28
23,8476463,Jonas Brodin,D,MIN,31,82,5,23,28
23,8475181,Nick Leddy,D,STL,33,82,3,25,28
23,8481517,Brett Leason,R,ANA,25,82,15,12,27
23,8479393,Noah Gregor,C,TOR,26,82,14,13,27
23,8477839,Conor Sheary,L,TBL,32,82,13,14,27
23,8475848,Brendan Gallagher,R,MTL,32,82,12,15,27
23,8473453,Trevor Lewis,C,LAK,37,82,12,15,27
23,8477953,Kasperi Kapanen,R,STL,28,82,11,16,27
23,8481522,Peyton Krebs,C,BUF,23,82,9,18,27
23,8476467,Jamie Oleksiak,D,SEA,32,82,8,19,27
23,8477845,Trevor van Riemsdyk,D,WSH,33,82,6,21,27
23,8482245,Artem Zub,D,OTT,29,82,5,22,27
23,8482087,Kaiden Guhle,D,MTL,22,82,5,22,27
23,8470604,Jeff Carter,C,PIT,39,82,17,9,26
23,8478057,Dakota Joshua,C,VAN,28,82,14,12,26
23,8475231,Casey Cizikas,C,NYI,33,82,13,13,26
23,8478413,Jordan Greenway,L,BUF,27,82,11,15,26
23,8479316,Luke Kunin,C,SJS,27,82,11,15,26
23,8484153,Leo Carlsson,C,ANA,20,82,10,16,26
23,8477392,Hudson Fasching,R,NYI,29,82,9,17,26
23,8476902,Esa Lindell,D,DAL,30,82,7,19,26
23,8476879,Cody Ceci,D,EDM,31,82,3,23,26
23,8480281,Alexey Toropchenko,R,STL,25,82,16,9,25
23,8479514,Rem Pitlick,C,CHI,27,82,14,11,25
23,8478569,Noel Acciari,C,PIT,33,82,12,13,25
23,8481477,Nico Sturm,C,SJS,29,82,11,14,25
23,8479359,Beck Malenstyn,L,WSH,26,82,11,14,25
23,8484203,Bradly Nadeau,L,CAR,19,82,10,15,25
23,8482807,Ethan Del Mastro,D,CHI,21,82,10,15,25
23,8483491,Ivan Miroshnichenko,L,WSH,20,82,9,16,25
23,8482111,Justin Barron,D,MTL,23,82,7,18,25
23,8477507,Nikita Zadorov,D,VAN,29,82,5,20,25
23,8479980,Nicolas Hague,D,VGK,26,82,5,20,25
23,8477369,Carson Soucy,D,VAN,30,82,5,20,25
23,8476892,Colton Parayko,D,STL,31,82,3,22,25
23,8476858,Phillip Di Giuseppe,L,VAN,31,82,17,7,24
23,8483763,Maksymilian Szuber,D,ARI,22,82,12,12,24
23,8479353,Brett Howden,C,VGK,26,82,11,13,24
23,8482730,Brandt Clarke,D,LAK,21,82,11,13,24
23,8482133,Thomas Bordeleau,C,SJS,22,82,9,15,24
23,8474884,Mike Hoffman,C,SJS,35,82,9,15,24
23,8474013,Ian Cole,D,VAN,35,82,8,16,24
23,8483495,Simon Nemec,D,NJD,20,82,7,17,24
23,8476422,Mike Reilly,D,NYI,31,82,6,18,24
23,8477435,Ryan Graves,D,PIT,29,82,5,19,24
23,8479398,Samuel Girard,D,COL,26,82,4,20,24
23,8478443,Brandon Carlo,D,BOS,28,82,4,20,24
23,8474166,Alec Martinez,D,VGK,37,82,4,20,24
23,8475455,Brenden Dillon,D,WPG,34,82,2,22,24
23,8481178,Egor Zamula,D,PHI,24,82,2,22,24
23,8476331,Dylan DeMelo,D,WPG,31,82,1,23,24
23,8478508,Yakov Trenin,C,COL,27,82,13,10,23
23,8475842,Sam Carrick,C,EDM,32,82,10,13,23
23,8482166,Shakir Mukhamadullin,D,SJS,22,82,8,15,23
23,8473504,Cal Clutterbuck,R,NYI,37,82,6,17,23
23,8477488,Brett Pesce,D,CAR,30,82,5,18,23
23,8480035,Henri Jokiharju,D,BUF,25,82,4,19,23
23,8475233,David Savard,D,MTL,34,82,4,19,23
23,8474567,Zach Bogosian,D,MIN,34,82,3,20,23
23,8478840,Will Borgen,D,SEA,28,82,2,21,23
23,8476442,Matt Nieto,L,PIT,32,82,17,5,22
23,8476878,Zemgus Girgensons,L,BUF,30,82,14,8,22
23,8481028,Martin Pospisil,C,CGY,25,82,13,9,22
23,8483431,Logan Cooley,C,ARI,20,82,11,11,22
23,8480448,Parker Kelly,L,OTT,25,82,11,11,22
23,8476312,Josh Manson,D,COL,33,82,9,13,22
23,8482679,Matt Coronato,R,CGY,22,82,9,13,22
23,8483445,Cutter Gauthier,L,ANA,20,82,7,15,22
23,8482803,Olen Zellweger,D,ANA,21,82,6,16,22
23,8479369,Andrew Peeke,D,BOS,26,82,6,16,22
23,8479983,Mario Ferraro,D,SJS,26,82,5,17,22
23,8475208,Brian Dumoulin,D,SEA,33,82,4,18,22
23,8482470,Ilya Solovyov,D,CGY,24,82,4,18,22
23,8477220,Nate Schmidt,D,WPG,33,82,3,19,22
23,8479351,Sam Steel,C,DAL,26,82,11,10,21
23,8482259,Bobby McMann,C,TOR,28,82,11,10,21
23,8476457,Adam Larsson,D,SEA,32,82,5,16,21
23,8477499,Rasmus Ristolainen,D,PHI,30,82,5,16,21
23,8476931,Jake McCabe,D,TOR,31,82,5,16,21
23,8481568,Alex Vlasic,D,CHI,23,82,4,17,21
23,8475790,Erik Gudbranson,D,CBJ,32,82,4,17,21
23,8483493,Frank Nazar,C,CHI,20,82,4,17,21
23,8483565,Nick Blankenburg,D,CBJ,26,82,4,17,21
23,8475324,Nick Jensen,D,WSH,34,82,4,17,21
23,8474009,Nick Bonino,C,NYR,36,82,11,9,20
23,8478020,Michael Amadio,C,VGK,28,82,10,10,20
23,8481537,Nikita Okhotiuk,D,CGY,24,82,10,10,20
23,8475164,Jakob Silfverberg,R,ANA,34,82,9,11,20
23,8477505,Alexander Wennberg,C,NYR,30,82,9,11,20
23,8478831,Kevin Stenlund,C,FLA,28,82,9,11,20
23,8478451,Ethan Bear,D,WSH,27,82,7,13,20
23,8480058,Pierre-Olivier Joseph,D,PIT,25,82,5,15,20
23,8479324,Ryan Lindgren,D,NYR,26,82,4,16,20
23,8480144,David Kampf,C,TOR,29,82,4,16,20
23,8476429,Scott Mayfield,D,NYI,32,82,4,16,20
23,8476967,Brett Kulak,D,EDM,30,82,4,16,20
23,8478430,Oliver Kylington,D,CGY,27,82,3,17,20
23,8475188,Brayden McNabb,D,VGK,33,82,3,17,20
23,8481014,Alexander Romanov,D,NYI,24,82,3,17,20
23,8478399,Jonas Siegenthaler,D,NJD,27,82,3,17,20
23,8475279,Ben Chiarot,D,DET,33,82,2,18,20
23,8475179,Dmitry Kulikov,D,FLA,34,82,1,19,20
23,8483524,Shane Wright,C,SEA,20,82,12,7,19
23,8479661,Tanner Jeannot,L,TBL,27,82,10,9,19
23,8477508,Curtis Lazar,C,NJD,29,82,8,11,19
23,8479998,Mikey Anderson,D,LAK,25,82,6,13,19
23,8478468,Jeremy Lauzon,D,NSH,27,82,6,13,19
23,8484145,Zach Benson,L,BUF,19,82,5,14,19
23,8478136,Jake Middleton,D,MIN,28,82,5,14,19
23,8477406,Mattias Janmark,C,EDM,32,82,4,15,19
23,8476525,Colin Miller,D,WPG,32,82,4,15,19
23,8478178,Darren Raddysh,D,TBL,28,82,4,15,19
23,8482858,Ryker Evans,D,SEA,23,82,8,10,18
23,8480806,Isac Lundestrom,C,ANA,25,82,8,10,18
23,8483482,Tristan Luneau,D,ANA,20,82,8,10,18
23,8479291,Kevin Rooney,C,CGY,31,82,4,14,18
23,8480246,Nick Perbix,D,TBL,26,82,4,14,18
23,8482073,Braden Schneider,D,NYR,23,82,4,14,18
23,8474574,Tyler Myers,D,VAN,34,82,2,16,18
23,8478882,Vladislav Gavrikov,D,LAK,29,82,2,16,18
23,8479383,Boris Katchouk,L,OTT,26,82,9,8,17
23,8483505,Matthew Poitras,C,BOS,20,82,6,11,17
23,8476624,Barclay Goodrow,C,NYR,31,82,5,12,17
23,8477931,Tomas Nosek,L,NJD,32,82,4,13,17
23,8478416,Erik Cernak,D,TBL,27,82,3,14,17
23,8470600,Ryan Suter,D,DAL,39,82,3,14,17
23,8477365,Connor Clifton,D,BUF,29,82,2,15,17
23,8482155,Alex Laferriere,R,LAK,23,82,8,8,16
23,8482712,Oskar Olausson,R,COL,22,82,7,9,16
23,8481524,Bowen Byram,D,BUF,23,82,5,11,16
23,8483468,Jiri Kulich,C,BUF,20,82,5,11,16
23,8482809,Jackson Blake,R,CAR,21,82,3,13,16
23,8478859,Niko Mikkola,D,FLA,28,82,3,13,16
23,8481059,Scott Perunovich,D,STL,26,82,2,14,16
23,8476473,Connor Murphy,D,CHI,31,82,2,14,16
23,8476891,Matt Grzelcyk,D,BOS,30,82,1,15,16
23,8483499,Liam Ohgren,L,MIN,20,82,9,6,15
23,8482733,Logan Mailloux,D,MTL,31,82,7,8,15
23,8482702,Logan Stankoven,C,DAL,21,82,5,10,15
23,8482145,Mavrik Bourque,C,DAL,22,82,5,10,15
23,8475825,Jani Hakanpää,D,DAL,32,82,4,11,15
23,8479371,Dante Fabbro,D,NSH,26,82,3,12,15
23,8475690,Chris Tanev,D,DAL,35,82,3,12,15
23,8480879,Jacob Bernard-Docker,D,OTT,24,82,3,12,15
23,8480172,Jan Rutta,D,SJS,34,82,2,13,15
23,8484911,Collin Graf,R,SJS,22,82,7,7,14
23,8480031,Maxime Comtois,L,CAR,25,82,6,8,14
23,8483471,Brad Lambert,C,WPG,31,82,6,8,14
23,8480990,Declan Chisholm,D,MIN,24,82,5,9,14
23,8481567,Henry Thrun,D,SJS,23,82,4,10,14
23,8479442,Troy Stecher,D,EDM,30,82,4,10,14
23,8482118,Sam Colangelo,R,ANA,23,82,2,12,14
23,8482074,Connor Zary,C,CGY,23,82,7,6,13
23,8482737,Zack Bolduc,C,STL,21,82,5,8,13
23,8481030,Jack St. Ivany,D,PIT,25,82,5,8,13
23,8482666,Scott Morrow,D,CAR,22,82,4,9,13
23,8482516,Matthew Kessel,D,STL,24,82,2,11,13
23,8475177,Calvin de Haan,D,TBL,33,82,1,12,13
23,8483489,Fraser Minten,C,TOR,31,82,6,6,12
23,8482177,Marat Khusnutdinov,C,MIN,22,82,5,7,12
23,8478408,Travis Dermott,D,ARI,28,82,5,7,12
23,8481599,Victor Soderstrom,D,ARI,23,82,4,8,12
23,8484149,Gavin Brindley,C,CBJ,20,82,3,9,12
23,8476372,Nick Seeler,D,PHI,31,82,3,9,12
23,8475462,Radko Gudas,D,ANA,34,82,3,9,12
23,8477034,Jaycob Megna,D,CHI,32,82,2,10,12
23,8483397,Marc McLaughlin,C,BOS,25,82,6,5,11
23,8481578,Graeme Clarke,R,NJD,23,82,5,6,11
23,8476915,Jujhar Khaira,L,MIN,30,82,5,6,11
23,8483012,Logan Morrison,C,SEA,22,82,5,6,11
23,8483466,Kevin Korchinski,D,CHI,20,82,5,6,11
23,8470966,Mark Giordano,D,TOR,41,82,2,9,11
23,8475762,Derek Forbort,D,BOS,32,82,2,9,11
23,8481699,Aku Raty,R,ARI,23,82,4,6,10
23,8480834,Ty Emberson,D,SJS,24,82,3,7,10
23,8482713,Mackie Samoskevich,R,FLA,22,82,3,7,10
23,8481605,Jackson LaCombe,D,ANA,23,82,2,8,10
23,8477335,Kyle Burroughs,D,SJS,29,82,1,9,10
23,8476822,Luke Glendening,C,TBL,35,82,4,4,8
23,8482101,Danil Gushchin,L,SJS,22,82,3,5,8
23,8481016,Ruslan Iskhakov,C,NYI,24,82,2,6,8
23,8471677,Jack Johnson,D,COL,37,82,2,6,8
23,8482762,Simon Edvinsson,D,DET,21,82,3,4,7
23,8482859,Zack Ostapchuk,C,OTT,21,82,0,5,5
23,8477950,Tony DeAngelo,D,CAR,29,0,0,0,0
23,8481577,Philip Tomasino,C,NSH,23,0,0,0,0
23,8482660,Kent Johnson,C,CBJ,22,0,0,0,0
23,8481019,David Gustafsson,C,WPG,24,0,0,0,0
23,8479348,Kale Clague,D,BUF,26,0,0,0,0
23,8482149,Cole Perfetti,C,WPG,22,0,0,0,0
23,8476952,Dominic Toninato,C,WPG,30,0,0,0,0
23,8473473,Milan Lucic,L,BOS,36,0,0,0,0
23,8480829,Jesperi Kotkaniemi,C,CAR,24,0,0,0,0
23,8474602,Justin Schultz,D,SEA,34,0,0,0,0
23,8480049,Dylan Samberg,D,WPG,25,0,0,0,0
23,8479372,Josh Mahura,D,FLA,26,0,0,0,0
23,8480878,Nils Lundkvist,D,DAL,24,0,0,0,0
23,8479982,Conor Timmins,D,TOR,26,0,0,0,0
23,8474031,Kevin Shattenkirk,D,BOS,35,0,0,0,0
23,8480835,Jack Drury,C,CAR,24,0,0,0,0
23,8480008,Adam Ruzicka,C,ARI,25,0,0,0,0
23,8479402,Jake Bean,D,CBJ,26,0,0,0,0
23,8476474,Stefan Noesen,R,CAR,31,0,0,0,0
23,8480884,Calen Addison,D,SJS,24,0,0,0,0
23,8476994,Vinnie Hinostroza,C,PIT,30,0,0,0,0
23,8477987,Ryan Donato,C,CHI,28,0,0,0,0
23,8481582,Nicholas Robertson,L,TOR,23,0,0,0,0
23,8478452,Caleb Jones,D,COL,27,0,0,0,0
23,8480157,Calle Rosen,D,STL,30,0,0,0,0
23,8481609,Vladislav Kolyachonok,D,ARI,23,0,0,0,0
23,8476919,Chris Tierney,C,NJD,30,0,0,0,0
23,8479639,Dylan Coghlan,D,CAR,26,0,0,0,0
23,8475193,Tomas Tatar,L,SEA,34,0,0,0,0
23,8480748,Kiefer Sherwood,L,NSH,29,0,0,0,0
23,8478146,Matthew Highmore,C,OTT,28,0,0,0,0
23,8478970,Jalen Chatfield,D,CAR,28,0,0,0,0
23,8480205,Emil Bemstrom,C,PIT,25,0,0,0,0
23,8471274,Alex Goligoski,D,MIN,39,0,0,0,0
23,8478104,Sammy Blais,L,STL,28,0,0,0,0
23,8476913,Devin Shore,C,SEA,30,0,0,0,0
23,8481708,Zac Jones,D,NYR,24,0,0,0,0
23,8480222,Sebastian Aho,D,NYI,28,0,0,0,0
23,8481598,Philip Broberg,D,EDM,23,0,0,0,0
23,8480789,Oliver Wahlstrom,R,NYI,24,0,0,0,0
23,8480891,Michael Kesselring,D,ARI,24,0,0,0,0
23,8477979,Nicolas Aube-Kubel,R,WSH,28,0,0,0,0
23,8476393,Nick Cousins,C,FLA,31,0,0,0,0
23,8480003,Jesper Boqvist,C,BOS,26,0,0,0,0
23,8479543,Michael Pezzetta,L,MTL,26,0,0,0,0
23,8475855,Jesper Fast,R,CAR,33,0,0,0,0
23,8477018,Ben Hutton,D,VGK,31,0,0,0,0
23,8480762,Eric Robinson,L,BUF,29,0,0,0,0
23,8481058,Jesse Ylönen,R,MTL,25,0,0,0,0
23,8481527,Kaedan Korczak,D,VGK,23,0,0,0,0
23,8482192,Isaak Phillips,D,CHI,23,0,0,0,0
23,8480727,Zach Whitecloud,D,VGK,28,0,0,0,0
23,8480001,Urho Vaakanainen,D,ANA,25,0,0,0,0
23,8480853,Liam Foudy,C,NSH,24,0,0,0,0
23,8475225,Craig Smith,C,DAL,35,0,0,0,0
23,8479972,Mason Shaw,C,MIN,26,0,0,0,0
23,8474040,Sam Gagner,C,EDM,35,0,0,0,0
23,8480196,Jacob Bryson,D,BUF,27,0,0,0,0
23,8475718,Justin Holl,D,DET,32,0,0,0,0
23,8479984,Cal Foote,D,NJD,26,0,0,0,0
23,8480011,Klim Kostin,C,SJS,25,0,0,0,0
23,8482176,Wyatt Kaiser,D,CHI,22,0,0,0,0
23,8476918,Jimmy Vesey,L,NYR,31,0,0,0,0
23,8476988,Matt Benning,D,SJS,30,0,0,0,0
23,8479370,Tyson Jost,C,BUF,26,0,0,0,0
23,8477464,Nic Petan,C,MIN,29,0,0,0,0
23,8477380,Jonny Brodzinski,C,NYR,31,0,0,0,0
23,8480070,Ian Mitchell,D,BOS,25,0,0,0,0
23,8479315,Joey Anderson,R,CHI,26,0,0,0,0
23,8478099,Kevin Labanc,R,SJS,29,0,0,0,0
23,8476874,Olli Maatta,D,DET,30,0,0,0,0
23,8479414,Nathan Bastian,R,NJD,27,0,0,0,0
23,8478434,Keegan Kolesar,R,VGK,27,0,0,0,0
23,8479536,Axel Jonsson-Fjallby,L,WPG,26,0,0,0,0
23,8479671,Mathieu Olivier,R,CBJ,27,0,0,0,0
23,8471709,Marc-Edouard Vlasic,D,SJS,37,0,0,0,0
23,8479328,Julien Gauthier,R,NYI,27,0,0,0,0
23,8478421,A.J. Greer,L,CGY,28,0,0,0,0
23,8477573,Nathan Walker,L,STL,30,0,0,0,0
23,8477478,William Carrier,L,VGK,30,0,0,0,0
23,8479344,Jesse Puljujarvi,R,PIT,26,0,0,0,0
23,8480887,Jordan Harris,D,MTL,24,0,0,0,0
23,8478502,Dennis Gilbert,D,CGY,28,0,0,0,0
23,8480355,Mark Kastelic,C,OTT,25,0,0,0,0
23,8475750,Jon Merrill,D,MIN,32,0,0,0,0
23,8476889,Radek Faksa,C,DAL,30,0,0,0,0
23,8478432,Christian Fischer,R,DET,27,0,0,0,0
23,8479439,Jacob MacDonald,D,SJS,31,0,0,0,0
23,8474568,Luke Schenn,D,NSH,35,0,0,0,0
23,8478454,Noah Juulsen,D,VAN,27,0,0,0,0
23,8475752,Tyler Pitlick,C,NYR,33,0,0,0,0
23,8482148,Hendrix Lapierre,C,WSH,22,0,0,0,0
23,8481167,Brayden Pachal,D,CGY,25,0,0,0,0
23,8478211,Dryden Hunt,L,CGY,29,0,0,0,0
23,8479321,Lucas Johansen,D,WSH,27,0,0,0,0
23,8480950,Ilya Lyubushkin,D,TOR,30,0,0,0,0
23,8479368,Max Jones,L,ANA,26,0,0,0,0
23,8471699,Andrew Cogliano,C,COL,37,0,0,0,0
23,8481521,Ronnie Attard,D,PHI,25,0,0,0,0
23,8481161,Jake Christiansen,D,CBJ,25,0,0,0,0
23,8479458,Nikita Zaitsev,D,CHI,33,0,0,0,0
23,8479619,Michael Carcone,L,ARI,28,0,0,0,0
23,8479026,Philippe Myers,D,TBL,27,0,0,0,0
23,8481617,Vasily Podkolzin,R,VAN,23,0,0,0,0
23,8481701,Santeri Hatakka,D,NJD,23,0,0,0,0
23,8477446,Michael McCarron,R,NSH,29,0,0,0,0
23,8483460,David Jiricek,D,CBJ,21,0,0,0,0
23,8474090,Brendan Smith,D,NJD,35,0,0,0,0
23,8482241,Radim Zohorna,L,PIT,28,0,0,0,0
23,8481032,Paul Cotter,C,VGK,25,0,0,0,0
23,8480289,Morgan Barron,C,WPG,26,0,0,0,0
23,8479379,Givani Smith,R,SJS,26,0,0,0,0
23,8480216,Jacob Peterson,C,SJS,25,0,0,0,0
23,8477851,Jordan Oesterle,D,CGY,32,0,0,0,0
23,8484258,Sam Malinski,D,COL,26,0,0,0,0
23,8478904,Steven Lorentz,C,FLA,28,0,0,0,0
23,8482095,Tyler Kleven,D,OTT,22,0,0,0,0
23,8480980,Connor Dewar,C,TOR,25,0,0,0,0
23,8480848,Ty Dellandrea,C,DAL,24,0,0,0,0
23,8476884,Derrick Pouliot,D,DAL,30,0,0,0,0
23,8480025,MacKenzie Entwistle,R,CHI,25,0,0,0,0
23,8474612,Travis Hamonic,D,OTT,34,0,0,0,0
23,8479336,Carl Grundstrom,R,LAK,27,0,0,0,0
23,8482964,Arber Xhekaj,D,MTL,23,0,0,0,0
23,8471686,Marc Staal,D,PHI,37,0,0,0,0
23,8477887,Patrick Brown,C,BOS,32,0,0,0,0
23,8478495,Denis Gurianov,R,PHI,27,0,0,0,0
23,8481550,Adam Beckman,L,MIN,23,0,0,0,0
23,8480845,Rasmus Kupari,C,WPG,24,0,0,0,0
23,8478585,Derek Ryan,C,EDM,38,0,0,0,0
23,8482141,Lukas Cormier,D,VGK,22,0,0,0,0
23,8477962,Brendan Lemieux,L,CAR,28,0,0,0,0
23,8482861,Vincent Iorio,D,WSH,22,0,0,0,0
23,8479378,Logan Stanley,D,WPG,26,0,0,0,0
23,8473446,Erik Johnson,D,PHI,36,0,0,0,0
23,8481743,Marc Del Gaizo,D,NSH,25,0,0,0,0
23,8478450,Parker Wotherspoon,D,BOS,27,0,0,0,0
23,8477384,Josh Brown,D,ARI,30,0,0,0,0
23,8482165,Yan Kuznetsov,D,CGY,22,0,0,0,0
23,8478424,Jansen Harkins,C,PIT,27,0,0,0,0
23,8482144,Jack Thompson,D,SJS,22,0,0,0,0
23,8479576,Vincent Desharnais,D,EDM,28,0,0,0,0
23,8478512,Austin Czarnik,C,DET,32,0,0,0,0
23,8477527,Ross Johnston,L,ANA,30,0,0,0,0
23,8482094,Daemon Hunt,D,MIN,22,0,0,0,0
23,8481719,Maxwell Crozier,D,TBL,24,0,0,0,0
23,8480192,Johnathan Kovacevic,D,MTL,27,0,0,0,0
23,8479376,Victor Mete,D,PHI,26,0,0,0,0
23,8482511,Mason Lohrei,D,BOS,23,0,0,0,0
23,8478021,William Lagesson,D,ANA,28,0,0,0,0
23,8475795,Dylan McIlrath,D,WSH,32,0,0,0,0
23,8477846,Ryan Carpenter,C,SJS,33,0,0,0,0
23,8481056,Spencer Stastney,D,NSH,24,0,0,0,0
23,8481564,Ryan Johnson,D,BUF,23,0,0,0,0
23,8478017,Mark Friedman,D,VAN,29,0,0,0,0
23,8479320,Max Lajoie,D,TOR,27,0,0,0,0
23,8480075,Cameron Crotty,D,ARI,25,0,0,0,0
23,8484287,Cole McWard,D,VAN,23,0,0,0,0
23,8484254,Akito Hirose,D,VAN,25,0,0,0,0
23,8483407,Brandon Scanlin,D,NYR,25,0,0,0,0
23,8480274,Philip Kemp,D,EDM,25,0,0,0,0
23,8479522,Hardy Haman Aktell,D,WSH,26,0,0,0,0
23,8480007,Jonas Rondbjerg,R,VGK,25,0,0,0,0
23,8477454,Adam Erne,L,EDM,29,0,0,0,0
23,8481679,Maxence Guenette,D,OTT,23,0,0,0,0
23,8477938,Haydn Fleury,D,TBL,28,0,0,0,0
23,8476441,Joel Edmundson,D,TOR,31,0,0,0,0
23,8477903,Garnet Hathaway,R,PHI,33,0,0,0,0
23,8480441,Trey Fix-Wolansky,R,CBJ,25,0,0,0,0
23,8483546,Marshall Rifai,D,TOR,26,0,0,0,0
23,8480084,Nick DeSimone,D,NJD,30,0,0,0,0
23,8481592,Jakob Pelletier,L,CGY,23,0,0,0,0
23,8478011,Louie Belpedio,D,PHI,28,0,0,0,0
23,8477930,Pierre-Edouard Bellemare,L,SEA,39,0,0,0,0
23,8484321,Nikolas Matinpalo,D,OTT,26,0,0,0,0
23,8482067,Connor Mackey,D,NYR,28,0,0,0,0
23,8481806,Louis Crevier,D,CHI,23,0,0,0,0
23,8484326,Patrik Koch,D,ARI,28,0,0,0,0
23,8477971,Andreas Englund,D,LAK,28,0,0,0,0
23,8481751,Lukas Rousek,R,BUF,25,0,0,0,0
23,8481006,Tyler Tucker,D,STL,24,0,0,0,0
23,8481641,Joel Kiviranta,L,COL,28,0,0,0,0
23,8476867,Brendan Gaunce,C,CBJ,30,0,0,0,0
23,8479520,Brandon Duhaime,R,COL,27,0,0,0,0
23,8477073,Kurtis MacDermid,L,NJD,30,0,0,0,0
23,8480874,Adam Ginning,D,PHI,24,0,0,0,0
23,8477473,Justin Bailey,R,SJS,29,0,0,0,0
23,8479066,Ryan Lomberg,L,FLA,30,0,0,0,0
23,8477070,Liam O'Brien,C,ARI,30,0,0,0,0
23,8474618,Marco Scandella,D,STL,34,0,0,0,0
23,8475797,Jarred Tinordi,D,CHI,32,0,0,0,0
23,8481441,Joe Snively,C,WSH,28,0,0,0,0
23,8477244,Chad Ruhwedel,D,NYR,34,0,0,0,0
23,8482077,Dylan Holloway,L,EDM,23,0,0,0,0
23,8479772,Zack MacEwen,R,OTT,28,0,0,0,0
23,8481147,Reese Johnson,C,CHI,26,0,0,0,0
23,8481043,Cole Koepke,L,TBL,26,0,0,0,0
23,8483619,Filip Roos,D,CHI,25,0,0,0,0
23,8481541,Samuel Bolduc,D,NYI,24,0,0,0,0
23,8477810,Joel Hanley,D,CGY,33,0,0,0,0
23,8476907,Mackenzie MacEachern,L,STL,30,0,0,0,0
23,8482652,Walker Duehr,R,CGY,27,0,0,0,0
23,8477126,Jayson Megna,C,BOS,34,0,0,0,0
23,8483398,Declan Carlile,D,TBL,31,0,0,0,0
23,8482929,Emil Lilleberg,D,TBL,23,0,0,0,0
23,8480880,Jakub Lauko,C,BOS,24,0,0,0,0
23,8478874,Adam Gaudette,C,STL,28,0,0,0,0
23,8480245,Olle Lycksell,R,PHI,25,0,0,0,0
23,8480252,Cole Guttman,C,CHI,25,0,0,0,0
23,8477467,Gustav Olofsson,D,SEA,30,0,0,0,0
23,8479968,Vinni Lettieri,C,MIN,29,0,0,0,0
23,8478400,Colin White,C,MTL,27,0,0,0,0
23,8475755,Alexander Petrovic,D,DAL,32,0,0,0,0
23,8481812,Nikolai Knyzhov,D,SJS,27,0,0,0,0
23,8481593,Jayden Struble,D,MTL,23,0,0,0,0
23,8481532,Alex Turcotte,C,LAK,23,0,0,0,0
23,8482126,Emil Andrae,D,PHI,31,0,0,0,0
23,8479944,Zach Aston-Reese,C,DET,30,0,0,0,0
23,8471817,Ryan Reaves,R,TOR,37,0,0,0,0
23,8481206,John Ludvig,D,PIT,24,0,0,0,0
23,8480292,Carson Meyer,R,CBJ,27,0,0,0,0
23,8482496,Nils Aman,C,VAN,24,0,0,0,0
23,8479718,Alex Barré-Boulet,C,TBL,27,0,0,0,0
23,8479994,Jaret Anderson-Dolan,C,NSH,25,0,0,0,0
23,8480184,Gustav Lindstrom,D,ANA,26,0,0,0,0
23,8480890,Jan Jenik,R,ARI,24,0,0,0,0
23,8478067,Oskar Lindblom,L,SJS,28,0,0,0,0
23,8476934,Brock McGinn,L,ANA,30,0,0,0,0
23,8479985,Cale Fleury,D,SEA,26,0,0,0,0
23,8482153,Brendan Brisson,C,VGK,23,0,0,0,0
23,8480021,Jack Studnicka,C,SJS,25,0,0,0,0
23,8484304,Uvis Balinskis,D,FLA,28,0,0,0,0
23,8479981,Jonah Gadjovich,L,FLA,26,0,0,0,0
23,8481716,Dmitri Voronkov,L,CBJ,24,0,0,0,0
23,8482659,Josh Doan,R,ARI,22,0,0,0,0
23,8481122,Simon Benoit,D,TOR,26,0,0,0,0
23,8474709,Matt Martin,L,NYI,35,0,0,0,0
23,8482634,Alex Steeves,C,TOR,25,0,0,0,0
23,8480823,Alexander Alexeyev,D,WSH,25,0,0,0,0
23,8477541,Dakota Mermis,D,MIN,30,0,0,0,0
23,8478477,Mitchell Stephens,C,MTL,27,0,0,0,0
23,8481543,Nikita Alexandrov,C,STL,24,0,0,0,0
23,8482451,Mikael Pyyhtia,L,CBJ,23,0,0,0,0
23,8480306,Grant Hutton,D,NYI,29,0,0,0,0
23,8478028,Fredrik Olofsson,L,COL,28,0,0,0,0
23,8477462,Robert Hagg,D,ANA,29,0,0,0,0
23,8477320,Anton Blidh,L,NYR,29,0,0,0,0
23,8482749,Joshua Roy,R,MTL,21,0,0,0,0
23,8482157,Will Cuylle,L,NYR,22,0,0,0,0
23,8481239,Samuel Fagemo,L,LAK,24,0,0,0,0
23,8481600,Tobias Bjornfot,D,FLA,23,0,0,0,0
23,8478409,Anthony Richard,C,BOS,28,0,0,0,0
23,8474145,Robert Bortuzzo,D,NYI,35,0,0,0,0
23,8475958,Michael Sgarbossa,C,WSH,32,0,0,0,0
23,8479986,Kole Lind,R,SEA,26,0,0,0,0
23,8479249,Andrew Poturalski,C,SEA,30,0,0,0,0
23,8479362,Riley Tufte,L,COL,26,0,0,0,0
23,8479991,Jake Leschyshyn,C,NYR,25,0,0,0,0
23,8479587,Rhett Gardner,C,PHI,28,0,0,0,0
23,8482744,James Malatesta,L,CBJ,21,0,0,0,0
23,8478854,Ryan Shea,D,PIT,27,0,0,0,0
23,8481591,Sam Poulin,R,PIT,23,0,0,0,0
23,8483512,Matt Savoie,C,BUF,20,0,0,0,0
23,8482102,Vasily Ponomarev,C,CAR,22,0,0,0,0
23,8482162,Roby Jarventie,L,OTT,22,0,0,0,0
23,8482172,Landon Slaggert,L,CHI,22,0,0,0,0
23,8482747,Brennan Othmann,L,NYR,21,0,0,0,0
23,8480226,Marián Studenic,R,SEA,26,0,0,0,0
23,8481518,Nolan Foote,L,NJD,24,0,0,0,0
23,8479419,Brett Murray,L,BUF,26,0,0,0,0
23,8482088,Justin Sourdif,R,FLA,22,0,0,0,0
23,8482201,Gage Goncalves,C,TBL,23,0,0,0,0
23,8481754,Nikita Nesterenko,C,ANA,23,0,0,0,0
23,8483531,Brian Halonen,L,NJD,25,0,0,0,0
23,8483920,Pierrick Dube,R,WSH,23,0,0,0,0
23,8480851,Akil Thomas,C,LAK,24,0,0,0,0
23,8475235,Nicolas Deslauriers,L,PHI,33,0,0,0,0
23,8482476,Emil Heineman,L,MTL,23,0,0,0,0
23,8477149,Scott Sabourin,R,SJS,32,0,0,0,0
23,8483549,Lucas Condotta,L,MTL,27,0,0,0,0
23,8483567,Georgii Merkulov,C,BOS,24,0,0,0,0
23,8482765,Isak Rosen,R,BUF,21,0,0,0,0
23,8481237,Kyle MacLean,C,NYI,25,0,0,0,0
23,8481024,Linus Karlsson,C,VAN,25,0,0,0,0
23,8481690,Tyler Angle,C,CBJ,24,0,0,0,0
23,8483570,Ben Meyers,C,ANA,26,0,0,0,0
23,8481655,Cole Schwindt,R,CGY,23,0,0,0,0
23,8481462,Mason Morelli,L,VGK,28,0,0,0,0
23,8483401,Marc Johnstone,R,PIT,28,0,0,0,0
23,8478956,Samuel Laberge,L,NJD,27,0,0,0,0
23,8479533,Joona Koppanen,L,PIT,26,0,0,0,0
23,8482197,Adam Raska,R,MIN,23,0,0,0,0
23,8482250,Callahan Burke,C,CAR,27,0,0,0,0
23,8482784,Zach Dean,C,STL,21,0,0,0,0
23,8484255,Jason Polin,R,COL,25,0,0,0,0
23,8481077,John Leonard,L,ARI,26,0,0,0,0
23,8481534,Raphael Lavoie,C,EDM,24,0,0,0,0
23,8483609,Adam Klapka,R,CGY,24,0,0,0,0
23,8482751,Ryan Winterton,C,SEA,21,0,0,0,0
23,8480267,Sammy Walker,C,MIN,25,0,0,0,0
23,8475766,Austin Watson,L,TBL,32,0,0,0,0
23,8482460,Matt Rempe,C,NYR,22,0,0,0,0
23,8482787,Nikita Chibrikov,R,WPG,31,0,0,0,0
23,8481065,Angus Crookshank,L,OTT,25,0,0,0,0
23,8481070,Hugh McGing,L,STL,26,0,0,0,0
23,8476323,Max McCormick,L,SEA,32,0,0,0,0
23,8483395,Arshdeep Bains,L,VAN,23,0,0,0,0
23,8484259,Ondrej Pavel,C,COL,31,0,0,0,0
23,8483432,Luca Del Bel Belluz,C,CBJ,31,0,0,0,0
23,8483045,Cameron Butler,R,CBJ,31,0,0,0,0
23,8482061,Brandon Biro,L,BUF,26,0,0,0,0
23,8477401,John Hayden,C,SEA,29,0,0,0,0
23,8475278,Byron Froese,C,VGK,33,0,0,0,0
23,8478446,Glenn Gawdin,C,ANA,27,0,0,0,0
23,8477993,Justin Kirkland,C,ARI,28,0,0,0,0
23,8482147,Jean-Luc Foudy,C,COL,22,0,0,0,0
23,8480032,Shane Bowers,C,NJD,25,0,0,0,0
23,8479330,Brandon Gignac,C,MTL,27,0,0,0,0
23,8480776,Sheldon Rempal,R,VGK,29,0,0,0,0
23,8475413,Justin Dowling,C,NJD,34,0,0,0,0
23,8481726,Adam Edstrom,C,NYR,24,0,0,0,0
23,8479638,Justin Brazeau,R,BOS,26,0,0,0,0
23,8480844,Grigori Denisenko,L,VGK,24,0,0,0,0
23,8474062,Riley Nash,C,NYR,35,0,0,0,0
23,8478147,Bokondji Imama,L,OTT,28,0,0,0,0
23,8478881,Brett Seney,L,CHI,28,0,0,0,0
23,8483630,Pavol Regenda,L,ANA,25,0,0,0,0
23,8480836,Jonathan Gruden,C,PIT,24,0,0,0,0
23,8484314,Jiri Smejkal,L,OTT,28,0,0,0,0
23,8475780,Chris Wagner,R,COL,33,0,0,0,0
23,8482070,Mitchell Chaffee,R,TBL,26,0,0,0,0
23,8479546,Oskar Steen,C,BOS,26,0,0,0,0
23,8483597,Milos Kelemen,L,ARI,25,0,0,0,0
23,8481789,Tye Kartye,L,SEA,23,0,0,0,0
23,8484325,Waltteri Merela,C,TBL,26,0,0,0,0
23,8479421,Jacob Moverare,D,LAK,26,0,0,0,0
23,8481585,Egor Afanasyev,L,NSH,23,0,0,0,0
23,8479547,Matthew Phillips,R,WSH,26,0,0,0,0
23,8479367,William Lockwood,R,FLA,26,0,0,0,0
23,8481422,Jacob Lucchini,C,MIN,29,0,0,0,0
23,8480468,James Hamblin,L,EDM,25,0,0,0,0
23,8480870,Bo Groulx,C,ANA,24,0,0,0,0
23,8478051,Max Willman,C,NJD,29,0,0,0,0
23,8481556,John Beecher,C,BOS,23,0,0,0,0
23,8478078,Rourke Chartier,C,OTT,28,0,0,0,0
