Simulation,PlayerID,Player,Position,Team,Age,Games Played,Goals,Assists,Points
1,8477956,David Pastrnak,R,BOS,28,80,53,84,137
1,8478402,Connor McDavid,C,EDM,27,82,37,99,136
1,8476453,Nikita Kucherov,R,TBL,31,82,39,87,126
1,8479318,Auston Matthews,C,TOR,27,82,59,58,117
1,8480012,Elias Pettersson,C,VAN,26,79,43,71,114
1,8477939,William Nylander,R,TOR,28,82,45,63,108
1,8481559,Jack Hughes,C,NJD,23,74,37,71,108
1,8477492,Nathan MacKinnon,C,COL,29,79,41,63,104
1,8477933,Sam Reinhart,C,FLA,29,78,45,58,103
1,8478420,Mikko Rantanen,R,COL,28,82,41,62,103
1,8477942,Kevin Fiala,L,LAK,28,80,31,71,102
1,8476468,J.T. Miller,C,VAN,31,71,35,64,99
1,8477493,Aleksander Barkov,C,FLA,29,79,37,60,97
1,8477934,Leon Draisaitl,C,EDM,29,77,32,65,97
1,8479314,Matthew Tkachuk,L,FLA,27,78,30,65,95
1,8480800,Quinn Hughes,D,VAN,25,78,18,75,93
1,8481557,Matt Boldy,L,MIN,23,73,32,60,92
1,8475166,John Tavares,C,TOR,34,82,47,43,90
1,8480027,Jason Robertson,L,DAL,25,82,28,61,89
1,8478398,Kyle Connor,L,WPG,28,69,41,47,88
1,8480830,Andrei Svechnikov,R,CAR,24,73,33,55,88
1,8473419,Brad Marchand,L,BOS,36,80,35,52,87
1,8479407,Jesper Bratt,L,NJD,26,78,24,63,87
1,8477951,Nick Schmaltz,C,UTA,28,79,24,63,87
1,8479542,Brandon Hagel,L,TBL,26,80,42,44,86
1,8482116,Tim Stützle,C,OTT,22,81,23,62,85
1,8477946,Dylan Larkin,C,DET,28,82,34,48,82
1,8480002,Nico Hischier,C,NJD,25,76,26,55,81
1,8477404,Jake Guentzel,C,TBL,30,82,32,47,79
1,8475913,Mark Stone,R,VGK,32,77,30,49,79
1,8478550,Artemi Panarin,L,NYR,33,78,26,53,79
1,8471675,Sidney Crosby,C,PIT,37,72,25,54,79
1,8484144,Connor Bedard,C,CHI,19,68,17,62,79
1,8478010,Brayden Point,C,TBL,28,82,46,32,78
1,8476460,Mark Scheifele,C,WPG,31,70,30,48,78
1,8481068,Yegor Sharangovich,C,CGY,26,78,42,35,77
1,8477409,Carter Verhaeghe,C,FLA,29,77,39,37,76
1,8471215,Evgeni Malkin,C,PIT,38,72,31,45,76
1,8480023,Robert Thomas,C,STL,25,72,23,53,76
1,8480865,Noah Dobson,D,NYI,24,80,12,64,76
1,8478449,Roope Hintz,C,DAL,28,82,40,35,75
1,8478493,Joel Eriksson Ek,C,MIN,27,67,31,44,75
1,8478445,Mathew Barzal,C,NYI,27,81,20,55,75
1,8476456,Jonathan Huberdeau,C,CGY,31,80,19,56,75
1,8475168,Matt Duchene,C,DAL,33,81,25,48,73
1,8480801,Brady Tkachuk,L,OTT,25,79,37,35,72
1,8479343,Clayton Keller,R,UTA,26,77,29,43,72
1,8474578,Erik Karlsson,D,PIT,34,77,21,51,72
1,8477940,Nikolaj Ehlers,L,WPG,28,78,29,42,71
1,8475765,Vladimir Tarasenko,R,DET,33,82,28,43,71
1,8482078,Lucas Raymond,L,DET,22,82,23,48,71
1,8477500,Bo Horvat,C,NYI,29,80,43,27,70
1,8475786,Zach Hyman,L,EDM,32,78,29,41,70
1,8476887,Filip Forsberg,L,NSH,30,68,27,43,70
1,8475794,Tyler Seguin,C,DAL,32,81,36,33,69
1,8474600,Roman Josi,D,NSH,34,72,25,44,69
1,8475692,Mats Zuccarello,R,MIN,37,70,22,47,69
1,8478427,Sebastian Aho,C,CAR,27,70,38,30,68
1,8475784,Jeff Skinner,C,EDM,32,77,31,37,68
1,8474141,Patrick Kane,R,DET,36,81,29,39,68
1,8478444,Brock Boeser,R,VAN,27,77,29,39,68
1,8475172,Nazem Kadri,C,CGY,34,76,28,40,68
1,8477496,Elias Lindholm,C,BOS,30,79,25,43,68
1,8478460,Zach Werenski,D,CBJ,27,81,18,50,68
1,8478403,Jack Eichel,C,VGK,28,80,38,29,67
1,8482093,Seth Jarvis,C,CAR,22,70,36,31,67
1,8478873,Troy Terry,R,ANA,27,73,35,32,67
1,8481540,Cole Caufield,R,MTL,23,78,34,33,67
1,8478439,Travis Konecny,R,PHI,27,75,32,35,67
1,8480039,Martin Necas,C,CAR,25,71,27,40,67
1,8476454,Ryan Nugent-Hopkins,C,EDM,31,80,23,44,67
1,8477949,Alex Tuch,R,BUF,28,75,23,44,67
1,8477402,Pavel Buchnevich,L,STL,29,66,27,39,66
1,8478440,Dylan Strome,C,WSH,27,74,25,41,66
1,8471214,Alex Ovechkin,L,WSH,39,72,25,41,66
1,8480839,Rasmus Dahlin,D,BUF,24,77,15,51,66
1,8474590,John Carlson,D,WSH,34,68,14,52,66
1,8478047,Michael Bunting,L,PIT,29,74,30,35,65
1,8476389,Vincent Trocheck,C,NYR,31,73,29,36,65
1,8478864,Kirill Kaprizov,L,MIN,27,66,28,37,65
1,8476459,Mika Zibanejad,C,NYR,31,73,23,42,65
1,8479385,Jordan Kyrou,C,STL,26,72,23,42,65
1,8477960,Adrian Kempe,R,LAK,28,80,36,28,64
1,8477501,Valeri Nichushkin,R,COL,29,82,32,32,64
1,8471685,Anze Kopitar,C,LAK,37,81,20,44,64
1,8482740,Wyatt Johnston,C,DAL,21,82,40,23,63
1,8477955,Jared McCann,L,SEA,28,73,29,34,63
1,8478401,Pavel Zacha,C,BOS,27,79,26,37,63
1,8480069,Cale Makar,D,COL,26,69,17,46,63
1,8479425,Filip Hronek,D,VAN,27,76,15,48,63
1,8479323,Adam Fox,D,NYR,26,70,10,53,63
1,8478414,Timo Meier,R,NJD,28,78,41,21,62
1,8477476,Artturi Lehkonen,L,COL,29,79,26,36,62
1,8482699,Dylan Guenther,R,UTA,21,73,24,38,62
1,8476881,Tomas Hertl,C,VGK,31,74,24,38,62
1,8480803,Evan Bouchard,D,EDM,25,76,6,56,62
1,8479420,Tage Thompson,C,BUF,27,69,36,25,61
1,8475726,Tyler Toffoli,C,SJS,32,68,32,29,61
1,8475810,Bryan Rust,R,PIT,32,74,31,30,61
1,8481528,Dylan Cozens,C,BUF,23,70,26,35,61
1,8479337,Alex DeBrincat,R,DET,27,79,21,40,61
1,8475754,Brock Nelson,C,NYI,33,80,28,32,60
1,8483431,Logan Cooley,C,UTA,20,77,23,37,60
1,8480036,Miro Heiskanen,D,DAL,25,80,14,46,60
1,8475184,Chris Kreider,L,NYR,33,77,34,25,59
1,8474564,Steven Stamkos,C,NSH,34,71,31,28,59
1,8479675,Trevor Moore,L,LAK,29,82,28,31,59
1,8474102,David Perron,L,OTT,36,80,27,32,59
1,8476539,Jonathan Marchessault,R,NSH,34,75,26,33,59
1,8475170,Brayden Schenn,C,STL,33,75,24,35,59
1,8478975,Mason Marchment,L,DAL,29,81,20,39,59
1,8476958,Jaccob Slavin,D,CAR,30,72,15,44,59
1,8475167,Victor Hedman,D,TBL,34,78,11,48,59
1,8482159,Tyson Foerster,R,PHI,22,76,29,29,58
1,8473986,Alex Killorn,L,ANA,35,70,25,33,58
1,8479400,Pierre-Luc Dubois,L,WSH,26,72,23,35,58
1,8473512,Claude Giroux,R,OTT,36,81,17,41,58
1,8477986,Brandon Montour,D,SEA,30,75,16,42,58
1,8478856,Conor Garland,R,VAN,28,75,30,27,57
1,8477494,Jonathan Drouin,L,COL,29,79,22,35,57
1,8476479,Phillip Danault,C,LAK,31,81,22,35,57
1,8480015,Owen Tippett,R,PHI,25,78,22,35,57
1,8478407,Vince Dunn,D,SEA,28,78,16,41,57
1,8475753,Justin Faulk,D,STL,32,77,21,35,56
1,8480018,Nick Suzuki,C,MTL,25,74,20,36,56
1,8480028,Morgan Frost,C,PHI,25,80,19,37,56
1,8473994,Jamie Benn,L,DAL,35,82,18,38,56
1,8474150,Mikael Backlund,C,CGY,35,78,17,39,56
1,8479987,Morgan Geekie,C,BOS,26,81,24,31,55
1,8478462,Nicolas Roy,C,VGK,27,75,23,32,55
1,8477504,Josh Morrissey,D,WPG,29,76,13,42,55
1,8476483,Rickard Rakell,R,PIT,31,69,28,26,54
1,8476448,William Karlsson,C,VGK,31,77,21,33,54
1,8476346,Johnny Gaudreau,L,CBJ,31,68,20,34,54
1,8478519,Anthony Cirelli,C,TBL,27,82,24,29,53
1,8481711,Matias Maccelli,L,UTA,24,74,19,34,53
1,8480798,Philipp Kurashev,C,CHI,25,68,18,35,53
1,8476853,Morgan Rielly,D,TOR,30,74,9,44,53
1,8475287,Erik Haula,L,NJD,33,71,26,26,52
1,8482665,Matty Beniers,C,SEA,22,77,23,29,52
1,8478542,Evan Rodrigues,C,FLA,31,76,23,29,52
1,8480208,Drake Batherson,R,OTT,26,79,22,30,52
1,8475218,Mattias Ekholm,D,EDM,34,75,16,36,52
1,8476462,Dougie Hamilton,D,NJD,31,71,14,38,52
1,8476906,Shayne Gostisbehere,D,CAR,31,78,12,40,52
1,8482149,Cole Perfetti,C,WPG,22,70,22,29,51
1,8484153,Leo Carlsson,C,ANA,20,75,19,32,51
1,8482745,Mason McTavish,C,ANA,21,73,18,33,51
1,8475151,Kyle Palmieri,C,NYI,33,76,28,22,50
1,8475169,Evander Kane,L,EDM,33,70,27,23,50
1,8477935,Sam Bennett,C,FLA,28,74,24,26,50
1,8477416,Oliver Bjorkstrand,R,SEA,29,74,20,30,50
1,8479325,Charlie McAvoy,D,BOS,27,73,8,42,50
1,8477479,Tyler Bertuzzi,L,CHI,29,66,21,28,49
1,8479345,Jakob Chychrun,D,WSH,26,66,15,34,49
1,8478397,Rasmus Andersson,D,CGY,28,75,14,35,49
1,8476875,Mike Matheson,D,MTL,30,73,12,37,49
1,8478396,Noah Hanifin,D,VGK,27,65,10,39,49
1,8477447,Shea Theodore,D,VGK,29,61,7,42,49
1,8481618,Alex Newhook,C,MTL,23,70,16,32,48
1,8484145,Zach Benson,L,BUF,19,66,15,33,48
1,8475798,Mikael Granlund,C,SJS,32,65,11,37,48
1,8470613,Brent Burns,D,CAR,39,77,10,38,48
1,8479525,Ross Colton,C,COL,28,82,25,22,47
1,8476432,Boone Jenner,C,CBJ,31,66,25,22,47
1,8475745,Charlie Coyle,C,BOS,32,78,22,25,47
1,8476882,Teuvo Teravainen,L,CHI,30,66,21,26,47
1,8477495,Seth Jones,D,CHI,30,65,18,29,47
1,8474563,Drew Doughty,D,LAK,35,72,15,32,47
1,8477456,J.T. Compher,L,DET,29,80,26,20,46
1,8478498,Jake DeBrusk,L,VAN,28,68,25,21,46
1,8482109,Alexis Lafrenière,L,NYR,23,70,23,23,46
1,8482702,Logan Stankoven,C,DAL,21,80,22,24,46
1,8474149,Evgenii Dadonov,R,DAL,35,80,20,26,46
1,8475768,Jaden Schwartz,C,SEA,32,68,19,27,46
1,8483505,Matthew Poitras,C,BOS,20,73,15,31,46
1,8476905,Chandler Stephenson,C,SEA,30,79,13,33,46
1,8478469,Thomas Chabot,D,OTT,27,75,10,36,46
1,8478055,Gustav Forsling,D,FLA,28,71,9,37,46
1,8474641,Adam Henrique,C,EDM,34,74,27,18,45
1,8481596,Shane Pinto,C,OTT,24,77,23,22,45
1,8478474,Lawson Crouse,L,UTA,27,73,22,23,45
1,8478233,Andrew Mangiapane,L,WSH,28,67,21,24,45
1,8478046,Danton Heinen,L,VAN,29,71,21,24,45
1,8475158,Ryan O'Reilly,C,NSH,33,68,19,26,45
1,8484166,Adam Fantilli,C,CBJ,20,65,18,27,45
1,8482684,Luke Hughes,D,NJD,21,73,12,33,45
1,8483515,Juraj Slafkovsky,L,MTL,20,77,11,34,45
1,8477346,MacKenzie Weegar,D,CGY,30,67,9,36,45
1,8471724,Kris Letang,D,PIT,37,78,8,37,45
1,8475191,Reilly Smith,R,NYR,33,72,24,20,44
1,8480188,Fabian Zetterlund,L,SJS,25,65,23,21,44
1,8482705,Cole Sillinger,C,CBJ,21,65,23,21,44
1,8477964,Ivan Barbashev,C,VGK,29,74,19,25,44
1,8471698,T.J. Oshie,R,WSH,38,63,19,25,44
1,8478115,Pierre Engvall,L,NYI,28,77,19,25,44
1,8478458,Jack Roslovic,C,CAR,27,69,15,29,44
1,8479410,Mikhail Sergachev,D,UTA,26,70,8,36,44
1,8475793,Ryan Johansen,C,PHI,32,71,25,18,43
1,8476461,Sean Couturier,C,PHI,32,80,22,21,43
1,8473422,Nick Foligno,L,CHI,37,71,21,22,43
1,8479999,Casey Mittelstadt,C,COL,26,82,16,27,43
1,8477021,Alex Kerfoot,C,UTA,30,75,16,27,43
1,8477948,Travis Sanheim,D,PHI,28,67,10,33,43
1,8481546,Cam York,D,PHI,23,69,7,36,43
1,8476880,Tom Wilson,R,WSH,30,70,24,18,42
1,8480849,Barrett Hayton,C,UTA,24,72,23,19,42
1,8482667,William Eklund,L,SJS,22,71,19,23,42
1,8476399,Blake Coleman,C,CGY,33,73,18,24,42
1,8481533,Trevor Zegras,C,ANA,23,74,16,26,42
1,8477497,Sean Monahan,C,CBJ,30,69,12,30,42
1,8476826,Yanni Gourde,C,SEA,33,74,11,31,42
1,8477503,Max Domi,C,TOR,29,79,8,34,42
1,8475722,Jason Zucker,L,BUF,32,68,24,17,41
1,8483808,Andrei Kuzmenko,L,CGY,28,74,21,20,41
1,8479992,Michael Rasmussen,C,DET,25,81,21,20,41
1,8477444,Andre Burakovsky,L,SEA,29,70,19,22,41
1,8481186,Logan O'Connor,R,COL,28,79,19,22,41
1,8477407,Anthony Duclair,L,NYI,29,76,18,23,41
1,8479339,Patrik Laine,L,CBJ,26,72,16,25,41
1,8477429,Andrew Copp,C,DET,30,79,16,25,41
1,8477451,Ryan Hartman,R,MIN,30,73,15,26,41
1,8476458,Ryan Strome,C,ANA,31,72,13,28,41
1,8474565,Alex Pietrangelo,D,VGK,34,67,12,29,41
1,8481581,Thomas Harley,D,DAL,23,81,9,32,41
1,8475314,Anders Lee,L,NYI,34,76,26,14,40
1,8477998,Warren Foegele,L,LAK,28,81,13,27,40
1,8480336,Sean Walker,D,CAR,30,80,13,27,40
1,8475763,Kevin Hayes,R,PIT,32,68,10,30,40
1,8475764,Cam Fowler,D,ANA,33,72,3,37,40
1,8480797,Joel Farabee,L,PHI,24,74,18,21,39
1,8478057,Dakota Joshua,C,VAN,28,66,18,21,39
1,8482113,Anton Lundell,C,FLA,23,76,17,22,39
1,8480829,Jesperi Kotkaniemi,C,CAR,24,70,17,22,39
1,8479365,Trent Frederic,C,BOS,26,71,17,22,39
1,8482110,Dawson Mercer,C,NJD,23,69,16,23,39
1,8477511,Anthony Mantha,R,CGY,30,71,15,24,39
1,8480064,Josh Norris,C,OTT,25,73,15,24,39
1,8476869,Brady Skjei,D,NSH,30,70,8,31,39
1,8482105,Jake Sanderson,D,OTT,22,76,6,33,39
1,8477426,Nicholas Paul,L,TBL,29,82,22,16,38
1,8481624,Ilya Mikheyev,R,CHI,30,63,16,22,38
1,8474053,Logan Couture,C,SJS,35,66,14,24,38
1,8483445,Cutter Gauthier,L,ANA,20,70,13,25,38
1,8476792,Torey Krug,D,STL,33,68,12,26,38
1,8480434,Sean Durzi,D,UTA,26,66,12,26,38
1,8481535,Nils Hoglander,L,VAN,24,72,12,26,38
1,8478413,Jordan Greenway,L,BUF,27,71,11,27,38
1,8476438,Brandon Saad,L,STL,32,68,23,14,37
1,8480014,Gabriel Vilardi,C,WPG,25,66,20,17,37
1,8475799,Nino Niederreiter,R,WPG,32,68,18,19,37
1,8480855,Jack McBain,C,UTA,24,70,17,20,37
1,8478438,Tommy Novak,C,NSH,27,69,15,22,37
1,8482097,Jack Quinn,R,BUF,23,63,15,22,37
1,8480220,Noah Cates,L,PHI,25,69,15,22,37
1,8482124,Quinton Byfield,R,LAK,22,75,12,25,37
1,8480817,K'Andre Miller,D,NYR,24,77,11,26,37
1,8477498,Darnell Nurse,D,EDM,29,77,11,26,37
1,8478038,Devon Toews,D,COL,30,71,10,27,37
1,8483490,Pavel Mintyukov,D,ANA,21,72,9,28,37
1,8477932,Aaron Ekblad,D,FLA,28,74,7,30,37
1,8478366,Frank Vatrano,R,ANA,30,72,28,8,36
1,8474586,Jordan Eberle,R,SEA,34,70,23,13,36
1,8482092,Ridly Greig,C,OTT,22,77,18,18,36
1,8482146,Luke Evangelista,R,NSH,22,73,17,19,36
1,8478042,Viktor Arvidsson,R,EDM,31,76,16,20,36
1,8478891,Mason Appleton,C,WPG,28,60,15,21,36
1,8478472,Mathieu Joseph,R,STL,27,71,13,23,36
1,8480113,Alex Iafallo,L,WPG,31,69,13,23,36
1,8475149,Marcus Johansson,L,MIN,34,68,11,25,36
1,8476419,Jean-Gabriel Pageau,C,NYI,32,73,10,26,36
1,8480068,Ryan Poehling,C,PHI,25,70,10,26,36
1,8481703,Valtteri Puustinen,R,PIT,25,66,9,27,36
1,8481582,Nicholas Robertson,L,TOR,23,76,17,18,35
1,8477989,Christian Dvorak,C,MTL,28,69,16,19,35
1,8477839,Conor Sheary,L,TBL,32,82,12,23,35
1,8474679,Gustav Nyquist,C,NSH,35,73,10,25,35
1,8482133,Thomas Bordeleau,C,SJS,22,64,10,25,35
1,8480073,Erik Brannstrom,D,COL,25,65,5,30,35
1,8480459,Pius Suter,C,VAN,28,69,20,14,34
1,8482175,JJ Peterka,R,BUF,22,68,19,15,34
1,8475848,Brendan Gallagher,R,MTL,32,72,15,19,34
1,8481656,Aliaksei Protas,C,WSH,23,64,11,23,34
1,8477952,Robby Fabbri,C,ANA,28,65,10,24,34
1,8482720,Matthew Knies,L,TOR,22,78,9,25,34
1,8476463,Jonas Brodin,D,MIN,31,79,7,27,34
1,8476891,Matt Grzelcyk,D,PIT,30,75,6,28,34
1,8481604,Pavel Dorofeyev,L,VGK,24,59,20,13,33
1,8474189,Lars Eller,C,PIT,35,67,17,16,33
1,8479941,Justin Danforth,R,CBJ,31,53,17,16,33
1,8476927,Teddy Blueger,C,VAN,30,66,16,17,33
1,8481523,Kirby Dach,C,MTL,23,66,15,18,33
1,8480009,Eeli Tolvanen,R,SEA,25,64,13,20,33
1,8480873,Rasmus Sandin,D,WSH,24,67,7,26,33
1,8477506,Ryan Pulock,D,NYI,30,73,4,29,33
1,8480893,Kirill Marchenko,R,CBJ,24,71,20,12,32
1,8482475,Yegor Chinakhov,R,CBJ,23,64,18,14,32
1,8482055,Drew O'Connor,L,PIT,26,68,16,16,32
1,8483524,Shane Wright,C,SEA,20,68,14,18,32
1,8480871,Adam Boqvist,D,FLA,24,69,12,20,32
1,8476872,Scott Laughton,C,PHI,30,67,10,22,32
1,8476917,Adam Pelech,D,NYI,30,75,4,28,32
1,8481542,Moritz Seider,D,DET,23,76,2,30,32
1,8477450,Jason Dickinson,C,CHI,29,63,17,14,31
1,8475714,Calle Jarnkrok,C,TOR,33,78,15,16,31
1,8482089,Jake Neighbours,L,STL,22,69,15,16,31
1,8476474,Stefan Noesen,R,NJD,31,73,14,17,31
1,8481577,Philip Tomasino,C,NSH,23,71,12,19,31
1,8473533,Jordan Staal,C,CAR,36,64,12,19,31
1,8477987,Ryan Donato,C,CHI,28,60,11,20,31
1,8484203,Bradly Nadeau,L,CAR,19,64,10,21,31
1,8480003,Jesper Boqvist,C,FLA,26,68,9,22,31
1,8482122,Brock Faber,D,MIN,22,77,7,24,31
1,8476854,Hampus Lindholm,D,BOS,30,67,6,25,31
1,8473507,Jeff Petry,D,DET,37,72,5,26,31
1,8476979,Erik Gustafsson,D,DET,32,76,2,29,31
1,8476469,Joel Armia,R,MTL,31,73,18,12,30
1,8480185,Eetu Luostarinen,C,FLA,26,73,15,15,30
1,8476278,Colin Blackwell,C,DAL,31,77,14,16,30
1,8475791,Taylor Hall,L,CHI,33,51,13,17,30
1,8479368,Max Jones,L,BOS,26,64,11,19,30
1,8482074,Connor Zary,C,CGY,23,68,11,19,30
1,8480145,Neal Pionk,D,WPG,29,70,10,20,30
1,8476292,Ondrej Palat,L,NJD,33,65,10,20,30
1,8479996,Cody Glass,C,NSH,25,58,10,20,30
1,8476923,Damon Severson,D,CBJ,30,76,8,22,30
1,8476892,Colton Parayko,D,STL,31,66,5,25,30
1,8475343,Nic Dowd,C,WSH,34,55,19,10,29
1,8478463,Anthony Beauvillier,L,PIT,27,65,12,17,29
1,8474715,Cam Atkinson,R,TBL,35,78,12,17,29
1,8480078,Filip Chytil,C,NYR,25,66,10,19,29
1,8482809,Jackson Blake,R,CAR,21,58,10,19,29
1,8482749,Joshua Roy,R,MTL,21,59,10,19,29
1,8477369,Carson Soucy,D,VAN,30,64,10,19,29
1,8479976,Juuso Valimaki,D,UTA,26,70,9,20,29
1,8476480,Vladislav Namestnikov,C,WPG,32,68,9,20,29
1,8476918,Jimmy Vesey,L,NYR,31,71,9,20,29
1,8478500,Ivan Provorov,D,CBJ,27,76,3,26,29
1,8470621,Corey Perry,R,EDM,39,72,18,10,28
1,8478020,Michael Amadio,C,OTT,28,72,16,12,28
1,8480802,Ryan McLeod,C,BUF,25,63,14,14,28
1,8477953,Kasperi Kapanen,R,STL,28,67,12,16,28
1,8474716,Jared Spurgeon,D,MIN,35,74,11,17,28
1,8480144,David Kampf,C,TOR,29,73,10,18,28
1,8476392,Adam Lowry,C,WPG,31,68,9,19,28
1,8473563,Nicklas Backstrom,C,WSH,37,58,7,21,28
1,8479983,Mario Ferraro,D,SJS,26,69,4,24,28
1,8478851,Alexandre Carrier,D,NSH,28,69,3,25,28
1,8482245,Artem Zub,D,OTT,29,71,1,27,28
1,8481554,Kaapo Kakko,R,NYR,23,70,15,12,27
1,8475760,Nick Bjugstad,C,UTA,32,73,14,13,27
1,8479293,Brandon Tanev,L,SEA,33,64,14,13,27
1,8475855,Jesper Fast,R,CAR,33,63,12,15,27
1,8477392,Hudson Fasching,R,NYI,29,62,12,15,27
1,8476897,Oskar Sundqvist,C,STL,30,63,10,17,27
1,8479351,Sam Steel,C,DAL,26,75,10,17,27
1,8482101,Danil Gushchin,L,SJS,22,58,9,18,27
1,8475231,Casey Cizikas,C,NYI,33,74,9,18,27
1,8475171,Oliver Ekman-Larsson,D,TOR,33,67,7,20,27
1,8477488,Brett Pesce,D,NJD,30,65,6,21,27
1,8476931,Jake McCabe,D,TOR,31,61,5,22,27
1,8478133,Jake Evans,C,MTL,28,64,4,23,27
1,8482671,Owen Power,D,BUF,22,67,2,25,27
1,8478507,John Marino,D,UTA,27,65,1,26,27
1,8482125,Alexander Holtz,R,VGK,22,73,20,6,26
1,8478508,Yakov Trenin,C,MIN,27,61,17,9,26
1,8475225,Craig Smith,C,CHI,35,43,16,10,26
1,8479390,Taylor Raddysh,R,WSH,26,66,15,11,26
1,8476921,Jordan Martinook,L,CAR,32,61,14,12,26
1,8480789,Oliver Wahlstrom,R,NYI,24,74,12,14,26
1,8475220,Marcus Foligno,L,MIN,33,55,12,14,26
1,8476960,Andreas Athanasiou,C,CHI,30,55,11,15,26
1,8477425,Miles Wood,L,COL,29,74,11,15,26
1,8476885,Jacob Trouba,D,NYR,30,71,8,18,26
1,8476429,Scott Mayfield,D,NYI,32,74,7,19,26
1,8480205,Emil Bemstrom,C,PIT,25,57,17,8,25
1,8480813,Joe Veleno,C,DET,24,71,16,9,25
1,8481560,Arthur Kaliyev,R,LAK,23,78,14,11,25
1,8476878,Zemgus Girgensons,L,TBL,30,81,14,11,25
1,8477446,Michael McCarron,R,NSH,29,53,13,12,25
1,8478434,Keegan Kolesar,R,VGK,27,67,12,13,25
1,8477070,Liam O'Brien,C,UTA,30,59,12,13,25
1,8478466,Daniel Sprong,R,VAN,27,71,9,16,25
1,8478970,Jalen Chatfield,D,CAR,28,73,8,17,25
1,8482624,Daniil Miromanov,D,CGY,27,65,8,17,25
1,8476374,Sean Kuraly,C,CBJ,31,65,8,17,25
1,8481521,Ronnie Attard,D,PHI,25,56,7,18,25
1,8476902,Esa Lindell,D,DAL,30,80,5,20,25
1,8478882,Vladislav Gavrikov,D,LAK,29,64,5,20,25
1,8479619,Michael Carcone,L,UTA,28,57,14,10,24
1,8481580,Connor McMichael,C,WSH,23,65,11,13,24
1,8483468,Jiri Kulich,C,BUF,20,62,10,14,24
1,8476981,Josh Anderson,R,MTL,30,68,10,14,24
1,8477508,Curtis Lazar,C,NJD,29,58,6,18,24
1,8480049,Dylan Samberg,D,WPG,25,64,3,21,24
1,8476331,Dylan DeMelo,D,WPG,31,69,3,21,24
1,8479353,Brett Howden,C,VGK,26,62,2,22,24
1,8479393,Noah Gregor,C,OTT,26,76,17,6,23
1,8482679,Matt Coronato,R,CGY,22,67,15,8,23
1,8479661,Tanner Jeannot,L,LAK,27,76,12,11,23
1,8477353,Tyler Motte,C,DET,29,75,11,12,23
1,8478421,A.J. Greer,L,FLA,28,64,10,13,23
1,8481601,Simon Holmstrom,R,NYI,23,65,10,13,23
1,8482155,Alex Laferriere,R,LAK,23,64,10,13,23
1,8482660,Kent Johnson,C,CBJ,22,59,9,14,23
1,8477947,Sonny Milano,L,WSH,28,59,8,15,23
1,8483482,Tristan Luneau,D,ANA,20,63,8,15,23
1,8477478,William Carrier,L,CAR,30,58,8,15,23
1,8482737,Zack Bolduc,C,STL,21,57,7,16,23
1,8477435,Ryan Graves,D,PIT,29,79,7,16,23
1,8475200,Dmitry Orlov,D,CAR,33,70,6,17,23
1,8478911,Matt Roy,D,WSH,29,65,6,17,23
1,8481553,Bobby Brink,R,PHI,23,61,5,18,23
1,8480001,Urho Vaakanainen,D,ANA,25,56,5,18,23
1,8480246,Nick Perbix,D,TBL,26,73,4,19,23
1,8482142,Jamie Drysdale,D,PHI,22,70,4,19,23
1,8482712,Oskar Olausson,R,COL,22,73,4,19,23
1,8474673,TJ Brodie,D,CHI,34,64,2,21,23
1,8480995,Pontus Holmberg,R,TOR,25,74,13,9,22
1,8478109,Victor Olofsson,L,VGK,29,71,10,12,22
1,8480011,Klim Kostin,C,SJS,25,49,9,13,22
1,8480835,Jack Drury,C,CAR,24,51,8,14,22
1,8480748,Kiefer Sherwood,L,VAN,29,59,8,14,22
1,8482079,Marco Rossi,C,MIN,23,59,8,14,22
1,8479591,Michael Eyssimont,C,TBL,28,81,7,15,22
1,8476925,Colton Sissons,C,NSH,31,71,7,15,22
1,8479026,Philippe Myers,D,TOR,27,55,6,16,22
1,8482087,Kaiden Guhle,D,MTL,22,62,6,16,22
1,8480980,Connor Dewar,C,TOR,25,73,6,16,22
1,8481606,Jordan Spence,D,LAK,23,66,5,17,22
1,8475181,Nick Leddy,D,STL,33,65,5,17,22
1,8475790,Erik Gudbranson,D,CBJ,32,76,5,17,22
1,8477969,Marcus Pettersson,D,PIT,28,78,4,18,22
1,8479398,Samuel Girard,D,COL,26,71,3,19,22
1,8476457,Adam Larsson,D,SEA,32,66,2,20,22
1,8479414,Nathan Bastian,R,NJD,27,52,14,7,21
1,8480762,Eric Robinson,L,CAR,29,57,11,10,21
1,8482259,Bobby McMann,C,TOR,28,74,11,10,21
1,8475193,Tomas Tatar,L,NJD,34,68,10,11,21
1,8482807,Ethan Del Mastro,D,CHI,21,63,10,11,21
1,8480289,Morgan Barron,C,WPG,26,58,10,11,21
1,8483565,Nick Blankenburg,D,NSH,26,58,9,12,21
1,8476422,Mike Reilly,D,NYI,31,78,8,13,21
1,8477220,Nate Schmidt,D,FLA,33,63,7,14,21
1,8478013,Jake Walman,D,SJS,28,68,7,14,21
1,8479982,Conor Timmins,D,TOR,26,60,5,16,21
1,8481014,Alexander Romanov,D,NYI,24,76,5,16,21
1,8480878,Nils Lundkvist,D,DAL,24,81,4,17,21
1,8474574,Tyler Myers,D,VAN,34,65,4,17,21
1,8478416,Erik Cernak,D,TBL,27,75,2,19,21
1,8479066,Ryan Lomberg,L,CGY,30,67,15,5,20
1,8478569,Noel Acciari,C,PIT,33,51,10,10,20
1,8480448,Parker Kelly,L,COL,25,76,10,10,20
1,8483499,Liam Ohgren,L,MIN,20,60,9,11,20
1,8481032,Paul Cotter,C,NJD,25,66,9,11,20
1,8479718,Alex Barré-Boulet,C,MTL,27,53,9,11,20
1,8477903,Garnet Hathaway,R,PHI,33,65,9,11,20
1,8474034,Pat Maroon,L,CHI,36,53,8,12,20
1,8482634,Alex Steeves,C,TOR,25,62,6,14,20
1,8475279,Ben Chiarot,D,DET,33,69,4,16,20
1,8480043,Timothy Liljegren,D,TOR,25,66,2,18,20
1,8481568,Alex Vlasic,D,CHI,23,50,2,18,20
1,8480222,Sebastian Aho,D,PIT,28,70,1,19,20
1,8476879,Cody Ceci,D,EDM,31,68,1,19,20
1,8482762,Simon Edvinsson,D,DET,21,58,13,6,19
1,8482117,Lukas Reichel,L,CHI,22,64,10,9,19
1,8477919,Frederick Gaudreau,C,MIN,31,60,10,9,19
1,8476329,Travis Boyd,C,MIN,31,57,8,11,19
1,8479639,Dylan Coghlan,D,WPG,26,67,8,11,19
1,8481093,Rafael Harvey-Pinard,L,MTL,25,60,8,11,19
1,8473453,Trevor Lewis,C,LAK,37,69,8,11,19
1,8481481,Blake Lizotte,C,PIT,27,59,7,12,19
1,8476467,Jamie Oleksiak,D,SEA,32,60,7,12,19
1,8481527,Kaedan Korczak,D,VGK,23,43,5,14,19
1,8477507,Nikita Zadorov,D,BOS,29,67,5,14,19
1,8479371,Dante Fabbro,D,NSH,26,67,4,15,19
1,8478399,Jonas Siegenthaler,D,NJD,27,60,4,15,19
1,8480950,Ilya Lyubushkin,D,DAL,30,78,3,16,19
1,8480891,Michael Kesselring,D,UTA,24,59,2,17,19
1,8471709,Marc-Edouard Vlasic,D,SJS,37,60,1,18,19
1,8476988,Matt Benning,D,SJS,30,57,9,9,18
1,8481716,Dmitri Voronkov,L,CBJ,24,49,6,12,18
1,8479543,Michael Pezzetta,L,MTL,26,59,5,13,18
1,8470600,Ryan Suter,D,STL,39,61,5,13,18
1,8479359,Beck Malenstyn,L,BUF,26,45,5,13,18
1,8482157,Will Cuylle,L,NYR,22,59,4,14,18
1,8480172,Jan Rutta,D,SJS,34,58,3,15,18
1,8478468,Jeremy Lauzon,D,NSH,27,59,3,15,18
1,8480252,Cole Guttman,C,CHI,25,50,11,6,17
1,8478043,Sam Lafferty,C,BUF,29,62,10,7,17
1,8483491,Ivan Miroshnichenko,L,WSH,20,48,7,10,17
1,8479315,Joey Anderson,R,CHI,26,51,7,10,17
1,8479402,Jake Bean,D,CGY,26,63,5,12,17
1,8482067,Connor Mackey,D,NYR,28,62,5,12,17
1,8476873,Mark Jankowski,C,NSH,30,56,5,12,17
1,8480727,Zach Whitecloud,D,VGK,28,48,4,13,17
1,8477499,Rasmus Ristolainen,D,PHI,30,57,4,13,17
1,8477015,Connor Brown,R,EDM,30,73,4,13,17
1,8478432,Christian Fischer,R,DET,27,77,4,13,17
1,8475455,Brenden Dillon,D,NJD,34,61,3,14,17
1,8481537,Nikita Okhotiuk,D,CGY,24,61,3,14,17
1,8483493,Frank Nazar,C,CHI,20,53,3,14,17
1,8481019,David Gustafsson,C,WPG,24,44,2,15,17
1,8482192,Isaak Phillips,D,CHI,23,52,2,15,17
1,8480860,Kevin Bahl,D,CGY,24,58,2,15,17
1,8478136,Jake Middleton,D,MIN,28,77,2,15,17
1,8481178,Egor Zamula,D,PHI,24,57,1,16,17
1,8477845,Trevor van Riemsdyk,D,WSH,33,66,1,16,17
1,8475690,Chris Tanev,D,TOR,35,58,1,16,17
1,8482148,Hendrix Lapierre,C,WSH,22,52,9,7,16
1,8479336,Carl Grundstrom,R,SJS,27,46,9,7,16
1,8481477,Nico Sturm,C,SJS,29,48,9,7,16
1,8479439,Jacob MacDonald,D,COL,31,50,8,8,16
1,8481517,Brett Leason,R,ANA,25,50,8,8,16
1,8479316,Luke Kunin,C,SJS,27,60,8,8,16
1,8476994,Vinnie Hinostroza,C,NSH,30,40,6,10,16
1,8478452,Caleb Jones,D,LAK,27,62,6,10,16
1,8477931,Tomas Nosek,L,FLA,32,63,6,10,16
1,8482859,Zack Ostapchuk,C,OTT,21,57,5,11,16
1,8482964,Arber Xhekaj,D,MTL,23,53,5,11,16
1,8481059,Scott Perunovich,D,STL,26,65,3,13,16
1,8476525,Colin Miller,D,WPG,32,63,3,13,16
1,8479370,Tyson Jost,C,CAR,26,48,3,13,16
1,8480796,Martin Fehervary,D,WSH,25,55,3,13,16
1,8475179,Dmitry Kulikov,D,FLA,34,64,2,14,16
1,8482176,Wyatt Kaiser,D,CHI,22,54,1,15,16
1,8478585,Derek Ryan,C,EDM,38,58,10,5,15
1,8477979,Nicolas Aube-Kubel,R,BUF,28,55,9,6,15
1,8479344,Jesse Puljujarvi,R,PIT,26,49,8,7,15
1,8478831,Kevin Stenlund,C,UTA,28,52,7,8,15
1,8478451,Ethan Bear,D,WSH,27,50,6,9,15
1,8482062,Cole Smith,L,NSH,29,61,6,9,15
1,8483460,David Jiricek,D,CBJ,21,63,5,10,15
1,8479671,Mathieu Olivier,R,CBJ,27,43,5,10,15
1,8481599,Victor Soderstrom,D,UTA,23,46,5,10,15
1,8476624,Barclay Goodrow,C,SJS,31,49,5,10,15
1,8480007,Jonas Rondbjerg,R,VGK,25,40,4,11,15
1,8478178,Darren Raddysh,D,TBL,28,67,1,14,15
1,8478840,Will Borgen,D,SEA,28,68,0,15,15
1,8475208,Brian Dumoulin,D,ANA,33,60,0,15,15
1,8481704,Juuso Parssinen,C,NSH,23,60,7,7,14
1,8475462,Radko Gudas,D,ANA,34,72,7,7,14
1,8475842,Sam Carrick,C,NYR,32,64,7,7,14
1,8477406,Mattias Janmark,C,EDM,32,62,6,8,14
1,8481751,Lukas Rousek,R,BUF,25,42,5,9,14
1,8475718,Justin Holl,D,DET,32,57,5,9,14
1,8480806,Isac Lundestrom,C,ANA,25,54,5,9,14
1,8482166,Shakir Mukhamadullin,D,SJS,22,62,5,9,14
1,8479998,Mikey Anderson,D,LAK,25,62,4,10,14
1,8480074,Alexandre Texier,C,STL,25,58,4,10,14
1,8483457,Lane Hutson,D,MTL,20,63,4,10,14
1,8481013,Jonatan Berggren,R,DET,24,62,4,10,14
1,8474151,Ryan McDonagh,D,TBL,35,73,3,11,14
1,8477018,Ben Hutton,D,VGK,31,50,3,11,14
1,8476874,Olli Maatta,D,DET,30,59,3,11,14
1,8479980,Nicolas Hague,D,VGK,26,54,2,12,14
1,8480035,Henri Jokiharju,D,BUF,25,59,1,13,14
1,8475188,Brayden McNabb,D,VGK,33,56,0,14,14
1,8482111,Justin Barron,D,MTL,23,68,9,4,13
1,8481641,Joel Kiviranta,L,COL,28,70,8,5,13
1,8484149,Gavin Brindley,C,CBJ,20,53,7,6,13
1,8480192,Johnathan Kovacevic,D,NJD,27,44,7,6,13
1,8476889,Radek Faksa,C,STL,30,64,6,7,13
1,8481028,Martin Pospisil,C,CGY,25,51,6,7,13
1,8479369,Andrew Peeke,D,BOS,26,62,5,8,13
1,8481524,Bowen Byram,D,BUF,23,48,5,8,13
1,8482666,Scott Morrow,D,CAR,22,42,5,8,13
1,8482659,Josh Doan,R,UTA,22,49,5,8,13
1,8482744,James Malatesta,L,CBJ,21,44,4,9,13
1,8476312,Josh Manson,D,COL,33,59,3,10,13
1,8477365,Connor Clifton,D,BUF,29,59,3,10,13
1,8474166,Alec Martinez,D,CHI,37,48,3,10,13
1,8478211,Dryden Hunt,L,CGY,29,61,3,10,13
1,8478443,Brandon Carlo,D,BOS,28,61,2,11,13
1,8474090,Brendan Smith,D,DAL,35,74,1,12,13
1,8471677,Jack Johnson,D,CBJ,37,61,1,12,13
1,8482655,J.J. Moser,D,TBL,24,80,0,13,13
1,8480281,Alexey Toropchenko,R,STL,25,57,9,3,12
1,8480355,Mark Kastelic,C,BOS,25,55,8,4,12
1,8482803,Olen Zellweger,D,ANA,21,65,6,6,12
1,8481161,Jake Christiansen,D,CBJ,25,59,6,6,12
1,8477887,Patrick Brown,C,BOS,32,47,6,6,12
1,8482511,Mason Lohrei,D,BOS,23,49,5,7,12
1,8480990,Declan Chisholm,D,MIN,24,45,5,7,12
1,8476442,Matt Nieto,L,PIT,32,50,5,7,12
1,8476473,Connor Murphy,D,CHI,31,43,4,8,12
1,8481522,Peyton Krebs,C,BUF,23,58,3,9,12
1,8477938,Haydn Fleury,D,WPG,28,37,3,9,12
1,8479324,Ryan Lindgren,D,NYR,26,66,2,10,12
1,8480887,Jordan Harris,D,MTL,24,51,2,10,12
1,8478859,Niko Mikkola,D,FLA,28,63,2,10,12
1,8480845,Rasmus Kupari,C,WPG,24,49,2,10,12
1,8480058,Pierre-Olivier Joseph,D,STL,25,59,1,11,12
1,8481441,Joe Snively,C,DET,28,53,7,4,11
1,8480848,Ty Dellandrea,C,SJS,24,50,7,4,11
1,8481147,Reese Johnson,C,MIN,26,39,7,4,11
1,8483763,Maksymilian Szuber,D,UTA,22,31,7,4,11
1,8480021,Jack Studnicka,C,LAK,25,55,6,5,11
1,8476913,Devin Shore,C,MIN,30,36,5,6,11
1,8482784,Zach Dean,C,STL,21,43,4,7,11
1,8479328,Julien Gauthier,R,NYI,27,57,4,7,11
1,8482077,Dylan Holloway,L,EDM,23,57,4,7,11
1,8477851,Jordan Oesterle,D,BOS,32,41,3,8,11
1,8479442,Troy Stecher,D,EDM,30,59,3,8,11
1,8479968,Vinni Lettieri,C,BOS,29,39,3,8,11
1,8484911,Collin Graf,R,SJS,22,47,3,8,11
1,8479372,Josh Mahura,D,SEA,26,52,2,9,11
1,8475233,David Savard,D,MTL,34,65,2,9,11
1,8475324,Nick Jensen,D,OTT,34,68,2,9,11
1,8475750,Jon Merrill,D,MIN,32,55,1,10,11
1,8474567,Zach Bogosian,D,MIN,34,61,1,10,11
1,8477380,Jonny Brodzinski,C,NYR,31,52,6,4,10
1,8481617,Vasily Podkolzin,R,VAN,23,48,6,4,10
1,8483630,Pavol Regenda,L,ANA,25,35,6,4,10
1,8481518,Nolan Foote,L,NJD,24,44,5,5,10
1,8479944,Zach Aston-Reese,C,VGK,30,51,5,5,10
1,8476822,Luke Glendening,C,TBL,35,76,5,5,10
1,8479520,Brandon Duhaime,R,WSH,27,54,4,6,10
1,8476858,Phillip Di Giuseppe,L,VAN,31,33,4,6,10
1,8474013,Ian Cole,D,UTA,35,50,3,7,10
1,8481592,Jakob Pelletier,L,CGY,23,47,3,7,10
1,8482730,Brandt Clarke,D,LAK,21,42,3,7,10
1,8481708,Zac Jones,D,NYR,24,52,2,8,10
1,8480807,Mattias Samuelsson,D,BUF,24,59,2,8,10
1,8480025,MacKenzie Entwistle,R,FLA,25,61,2,8,10
1,8481600,Tobias Bjornfot,D,FLA,23,42,1,9,10
1,8481567,Henry Thrun,D,SJS,23,60,1,9,10
1,8478450,Parker Wotherspoon,D,BOS,27,33,1,9,10
1,8479576,Vincent Desharnais,D,VAN,28,35,1,9,10
1,8483495,Simon Nemec,D,NJD,20,63,1,9,10
1,8482073,Braden Schneider,D,NYR,23,58,0,10,10
1,8475958,Michael Sgarbossa,C,WSH,32,34,0,10,10
1,8476934,Brock McGinn,L,ANA,30,43,5,4,9
1,8481556,John Beecher,C,BOS,23,40,4,5,9
1,8480070,Ian Mitchell,D,BOS,25,39,3,6,9
1,8477384,Josh Brown,D,EDM,30,41,3,6,9
1,8476967,Brett Kulak,D,EDM,30,59,2,7,9
1,8482765,Isak Rosen,R,BUF,21,33,2,7,9
1,8475177,Calvin de Haan,D,COL,33,46,2,7,9
1,8476441,Joel Edmundson,D,LAK,31,40,2,7,9
1,8481605,Jackson LaCombe,D,ANA,23,32,2,7,9
1,8477473,Justin Bailey,R,SJS,29,36,2,7,9
1,8479378,Logan Stanley,D,WPG,26,46,1,8,9
1,8482095,Tyler Kleven,D,OTT,22,49,0,9,9
1,8479536,Axel Jonsson-Fjallby,L,WPG,26,33,6,2,8
1,8476867,Brendan Gaunce,C,MIN,30,33,5,3,8
1,8479772,Zack MacEwen,R,OTT,28,50,5,3,8
1,8483397,Marc McLaughlin,C,BOS,25,26,5,3,8
1,8479994,Jaret Anderson-Dolan,C,WPG,25,41,4,4,8
1,8481598,Philip Broberg,D,EDM,23,36,3,5,8
1,8479320,Max Lajoie,D,SEA,27,21,3,5,8
1,8484287,Cole McWard,D,VAN,23,24,3,5,8
1,8483549,Lucas Condotta,L,MTL,27,24,3,5,8
1,8484254,Akito Hirose,D,VAN,25,35,2,6,8
1,8473446,Erik Johnson,D,PHI,36,44,2,6,8
1,8480292,Carson Meyer,R,ANA,27,35,2,6,8
1,8481609,Vladislav Kolyachonok,D,UTA,23,35,2,6,8
1,8477320,Anton Blidh,L,NYR,29,28,2,6,8
1,8478874,Adam Gaudette,C,OTT,28,40,2,6,8
1,8474612,Travis Hamonic,D,OTT,34,46,1,7,8
1,8482144,Jack Thompson,D,SJS,22,28,1,7,8
1,8480157,Calle Rosen,D,COL,30,44,0,8,8
1,8481167,Brayden Pachal,D,CGY,25,35,0,8,8
1,8480441,Trey Fix-Wolansky,R,CBJ,25,33,5,2,7
1,8477810,Joel Hanley,D,CGY,33,26,3,4,7
1,8482858,Ryker Evans,D,SEA,23,28,3,4,7
1,8477401,John Hayden,C,SEA,29,31,3,4,7
1,8477505,Alexander Wennberg,C,SJS,30,36,3,4,7
1,8477335,Kyle Burroughs,D,LAK,29,47,2,5,7
1,8481743,Marc Del Gaizo,D,NSH,25,20,2,5,7
1,8471817,Ryan Reaves,R,TOR,37,59,2,5,7
1,8481701,Santeri Hatakka,D,NJD,23,37,1,6,7
1,8478502,Dennis Gilbert,D,BUF,28,25,1,6,7
1,8474568,Luke Schenn,D,NSH,35,42,1,6,7
1,8477962,Brendan Lemieux,L,CAR,28,37,1,6,7
1,8477527,Ross Johnston,L,ANA,30,36,1,6,7
1,8482652,Walker Duehr,R,CGY,27,43,1,6,7
1,8479348,Kale Clague,D,BUF,26,39,0,7,7
1,8475762,Derek Forbort,D,VAN,32,43,0,7,7
1,8481679,Maxence Guenette,D,OTT,23,27,6,0,6
1,8477573,Nathan Walker,L,STL,30,51,4,2,6
1,8482177,Marat Khusnutdinov,C,MIN,22,38,4,2,6
1,8482070,Mitchell Chaffee,R,TBL,26,57,4,2,6
1,8481754,Nikita Nesterenko,C,ANA,23,37,3,3,6
1,8481550,Adam Beckman,L,NJD,23,38,2,4,6
1,8480196,Jacob Bryson,D,BUF,27,42,2,4,6
1,8480879,Jacob Bernard-Docker,D,OTT,24,42,2,4,6
1,8482751,Ryan Winterton,C,SEA,21,36,2,4,6
1,8480834,Ty Emberson,D,SJS,24,30,2,4,6
1,8479981,Jonah Gadjovich,L,FLA,26,44,2,4,6
1,8481122,Simon Benoit,D,TOR,26,40,2,4,6
1,8478454,Noah Juulsen,D,VAN,27,40,1,5,6
1,8482929,Emil Lilleberg,D,TBL,23,18,1,5,6
1,8481237,Kyle MacLean,C,NYI,25,33,1,5,6
1,8483012,Logan Morrison,C,SEA,22,30,1,5,6
1,8482141,Lukas Cormier,D,VGK,22,27,4,1,5
1,8481043,Cole Koepke,L,BOS,26,17,4,1,5
1,8482747,Brennan Othmann,L,NYR,21,29,3,2,5
1,8480245,Olle Lycksell,R,PHI,25,27,3,2,5
1,8478424,Jansen Harkins,C,ANA,27,34,3,2,5
1,8480851,Akil Thomas,C,LAK,24,28,3,2,5
1,8478051,Max Willman,C,NJD,29,17,3,2,5
1,8479362,Riley Tufte,L,BOS,26,22,3,2,5
1,8482145,Mavrik Bourque,C,DAL,22,58,3,2,5
1,8479587,Rhett Gardner,C,PHI,28,14,2,3,5
1,8476372,Nick Seeler,D,PHI,31,46,2,3,5
1,8478146,Matthew Highmore,C,OTT,28,34,2,3,5
1,8476952,Dominic Toninato,C,WPG,30,30,1,4,5
1,8483466,Kevin Korchinski,D,CHI,20,47,1,4,5
1,8478017,Mark Friedman,D,VAN,29,32,1,4,5
1,8479638,Justin Brazeau,R,BOS,26,43,1,4,5
1,8480880,Jakub Lauko,C,MIN,24,29,0,5,5
1,8481543,Nikita Alexandrov,C,STL,24,31,4,0,4
1,8480890,Jan Jenik,R,OTT,24,18,3,1,4
1,8479291,Kevin Rooney,C,CGY,31,43,3,1,4
1,8479249,Andrew Poturalski,C,SJS,30,30,2,2,4
1,8482861,Vincent Iorio,D,WSH,22,28,2,2,4
1,8481056,Spencer Stastney,D,NSH,24,35,2,2,4
1,8478477,Mitchell Stephens,C,SEA,27,13,2,2,4
1,8482470,Ilya Solovyov,D,CGY,24,21,2,2,4
1,8478409,Anthony Richard,C,PHI,28,27,2,2,4
1,8482496,Nils Aman,C,VAN,24,32,2,2,4
1,8475235,Nicolas Deslauriers,L,PHI,33,50,2,2,4
1,8481789,Tye Kartye,L,SEA,23,41,2,2,4
1,8482460,Matt Rempe,C,NYR,22,14,2,2,4
1,8477149,Scott Sabourin,R,SJS,32,24,1,3,4
1,8482733,Logan Mailloux,D,MTL,31,38,1,3,4
1,8481699,Aku Raty,R,UTA,23,15,1,3,4
1,8479972,Mason Shaw,C,WPG,26,27,0,4,4
1,8482451,Mikael Pyyhtia,L,CBJ,23,37,0,4,4
1,8477034,Jaycob Megna,D,FLA,32,42,0,4,4
1,8477244,Chad Ruhwedel,D,NYR,34,33,0,4,4
1,8481593,Jayden Struble,D,MTL,23,19,0,4,4
1,8483471,Brad Lambert,C,WPG,31,10,0,4,4
1,8480032,Shane Bowers,C,NJD,25,13,3,0,3
1,8477073,Kurtis MacDermid,L,NJD,30,27,2,1,3
1,8479991,Jake Leschyshyn,C,NYR,25,27,2,1,3
1,8475755,Alexander Petrovic,D,DAL,32,18,2,1,3
1,8481422,Jacob Lucchini,C,NSH,29,17,2,1,3
1,8480870,Bo Groulx,C,NYR,24,38,2,1,3
1,8483619,Filip Roos,D,OTT,25,37,1,2,3
1,8477462,Robert Hagg,D,VGK,29,21,1,2,3
1,8481532,Alex Turcotte,C,LAK,23,40,1,2,3
1,8481564,Ryan Johnson,D,BUF,23,17,1,2,3
1,8481541,Samuel Bolduc,D,NYI,24,26,1,2,3
1,8482094,Daemon Hunt,D,MIN,22,14,1,2,3
1,8482165,Yan Kuznetsov,D,CGY,22,21,1,2,3
1,8481030,Jack St. Ivany,D,PIT,25,17,1,2,3
1,8482250,Callahan Burke,C,VGK,27,31,1,2,3
1,8480267,Sammy Walker,C,MIN,25,27,1,2,3
1,8479421,Jacob Moverare,D,LAK,26,16,1,2,3
1,8483570,Ben Meyers,C,SEA,26,29,1,2,3
1,8481578,Graeme Clarke,R,MIN,23,10,1,2,3
1,8482713,Mackie Samoskevich,R,FLA,22,39,1,2,3
1,8479985,Cale Fleury,D,SEA,26,29,0,3,3
1,8482153,Brendan Brisson,C,VGK,23,31,0,3,3
1,8483512,Matt Savoie,C,EDM,20,21,1,1,2
1,8479986,Kole Lind,R,DAL,26,43,1,1,2
1,8480084,Nick DeSimone,D,NJD,30,18,1,1,2
1,8479419,Brett Murray,L,BUF,26,14,1,1,2
1,8478011,Louie Belpedio,D,PHI,28,13,1,1,2
1,8480844,Grigori Denisenko,L,VGK,24,27,1,1,2
1,8479367,William Lockwood,R,FLA,26,12,1,1,2
1,8484304,Uvis Balinskis,D,FLA,28,4,1,1,2
1,8482172,Landon Slaggert,L,CHI,22,27,1,1,2
1,8483597,Milos Kelemen,L,UTA,25,9,1,1,2
1,8478446,Glenn Gawdin,C,LAK,27,14,1,1,2
1,8483920,Pierrick Dube,R,WSH,23,11,1,1,2
1,8481585,Egor Afanasyev,L,SJS,23,21,1,1,2
1,8480468,James Hamblin,L,EDM,25,11,1,1,2
1,8484258,Sam Malinski,D,COL,26,17,0,2,2
1,8477971,Andreas Englund,D,LAK,28,21,0,2,2
1,8477467,Gustav Olofsson,D,SEA,30,15,0,2,2
1,8482102,Vasily Ponomarev,C,PIT,22,16,0,2,2
1,8482118,Sam Colangelo,R,ANA,23,16,0,2,2
1,8479379,Givani Smith,R,SJS,26,31,1,0,1
1,8480075,Cameron Crotty,D,MIN,25,10,1,0,1
1,8482126,Emil Andrae,D,PHI,31,3,1,0,1
1,8482162,Roby Jarventie,L,EDM,22,15,1,0,1
1,8482061,Brandon Biro,L,SEA,26,15,1,0,1
1,8482147,Jean-Luc Foudy,C,COL,22,23,1,0,1
1,8482476,Emil Heineman,L,MTL,23,7,1,0,1
1,8482201,Gage Goncalves,C,TBL,23,23,1,0,1
1,8479330,Brandon Gignac,C,MTL,27,11,1,0,1
1,8481006,Tyler Tucker,D,STL,24,12,0,1,1
1,8482516,Matthew Kessel,D,STL,24,19,0,1,1
1,8481719,Maxwell Crozier,D,TBL,24,21,0,1,1
1,8480823,Alexander Alexeyev,D,WSH,25,10,0,1,1
1,8481806,Louis Crevier,D,CHI,23,6,0,1,1
1,8476323,Max McCormick,L,SEA,32,8,0,1,1
1,8477541,Dakota Mermis,D,TOR,30,11,0,1,1
1,8480874,Adam Ginning,D,PHI,24,10,0,1,1
1,8474062,Riley Nash,C,NYR,35,18,0,1,1
1,8483398,Declan Carlile,D,TBL,31,7,0,1,1
1,8477993,Justin Kirkland,C,CGY,28,3,0,1,1
1,8484325,Waltteri Merela,C,TBL,26,16,0,1,1
1,8482787,Nikita Chibrikov,R,WPG,31,6,0,1,1
1,8478854,Ryan Shea,D,PIT,27,8,0,1,1
1,8484255,Jason Polin,R,COL,25,11,0,1,1
1,8483567,Georgii Merkulov,C,BOS,24,10,0,1,1
1,8481065,Angus Crookshank,L,OTT,25,10,0,1,1
1,8481462,Mason Morelli,L,VGK,28,15,0,1,1
1,8482088,Justin Sourdif,R,FLA,22,22,0,1,1
1,8481024,Linus Karlsson,C,VAN,25,13,0,1,1
1,8479321,Lucas Johansen,D,,27,0,0,0,0
1,8470794,Joe Pavelski,C,,40,0,0,0,0
1,8477950,Tony DeAngelo,D,,29,0,0,0,0
1,8471218,Blake Wheeler,R,,38,0,0,0,0
1,8475197,Tyson Barrie,D,,33,0,0,0,0
1,8475744,Evgeny Kuznetsov,C,,32,0,0,0,0
1,8474037,James van Riemsdyk,L,,35,0,0,0,0
1,8474602,Justin Schultz,D,,34,0,0,0,0
1,8482222,Alexander Barabanov,L,,30,0,0,0,0
1,8474157,Max Pacioretty,L,,36,0,0,0,0
1,8474031,Kevin Shattenkirk,D,,35,0,0,0,0
1,8480884,Calen Addison,D,,24,0,0,0,0
1,8480008,Adam Ruzicka,C,,25,0,0,0,0
1,8475906,John Klingberg,D,,32,0,0,0,0
1,8476884,Derrick Pouliot,D,,30,0,0,0,0
1,8476919,Chris Tierney,C,,30,0,0,0,0
1,8479415,Michael McLeod,C,,26,0,0,0,0
1,8474884,Mike Hoffman,C,,35,0,0,0,0
1,8478104,Sammy Blais,L,,28,0,0,0,0
1,8474870,Tyler Johnson,C,,34,0,0,0,0
1,8481591,Sam Poulin,R,,23,0,0,0,0
1,8479977,Kailer Yamamoto,R,,26,0,0,0,0
1,8476393,Nick Cousins,C,,31,0,0,0,0
1,8479376,Victor Mete,D,,26,0,0,0,0
1,8476871,Tanner Pearson,L,,32,0,0,0,0
1,8471274,Alex Goligoski,D,,39,0,0,0,0
1,8481058,Jesse Ylönen,R,,25,0,0,0,0
1,8477464,Nic Petan,C,,29,0,0,0,0
1,8473449,Kyle Okposo,R,,36,0,0,0,0
1,8475795,Dylan McIlrath,D,WSH,32,14,0,0,0
1,8480216,Jacob Peterson,C,,25,0,0,0,0
1,8479346,Dillon Dube,C,,26,0,0,0,0
1,8470966,Mark Giordano,D,,41,0,0,0,0
1,8480821,Filip Zadina,R,,25,0,0,0,0
1,8476907,Mackenzie MacEachern,L,,30,0,0,0,0
1,8478430,Oliver Kylington,D,,27,0,0,0,0
1,8479514,Rem Pitlick,C,,27,0,0,0,0
1,8478099,Kevin Labanc,R,,29,0,0,0,0
1,8482241,Radim Zohorna,L,,28,0,0,0,0
1,8474040,Sam Gagner,C,,35,0,0,0,0
1,8475164,Jakob Silfverberg,R,,34,0,0,0,0
1,8475752,Tyler Pitlick,C,,33,0,0,0,0
1,8479984,Cal Foote,D,,26,0,0,0,0
1,8478495,Denis Gurianov,R,,27,0,0,0,0
1,8479533,Joona Koppanen,L,,26,0,0,0,0
1,8479458,Nikita Zaitsev,D,,33,0,0,0,0
1,8471699,Andrew Cogliano,C,,37,0,0,0,0
1,8470604,Jeff Carter,C,,39,0,0,0,0
1,8477330,Dominik Kubalik,L,,29,0,0,0,0
1,8477944,Jakub Vrana,L,,28,0,0,0,0
1,8478904,Steven Lorentz,C,,28,0,0,0,0
1,8471686,Marc Staal,D,,37,0,0,0,0
1,8478512,Austin Czarnik,C,,32,0,0,0,0
1,8470610,Zach Parise,L,,40,0,0,0,0
1,8473504,Cal Clutterbuck,R,,37,0,0,0,0
1,8478021,William Lagesson,D,DET,28,25,0,0,0
1,8474009,Nick Bonino,C,,36,0,0,0,0
1,8477454,Adam Erne,L,,29,0,0,0,0
1,8477126,Jayson Megna,C,,34,0,0,0,0
1,8473473,Milan Lucic,L,,36,0,0,0,0
1,8478067,Oskar Lindblom,L,,28,0,0,0,0
1,8475825,Jani Hakanpää,D,,32,0,0,0,0
1,8479383,Boris Katchouk,L,,26,0,0,0,0
1,8478400,Colin White,C,,27,0,0,0,0
1,8477846,Ryan Carpenter,C,,33,0,0,0,0
1,8477930,Pierre-Edouard Bellemare,L,,39,0,0,0,0
1,8479423,Alex Nylander,L,,26,0,0,0,0
1,8475797,Jarred Tinordi,D,,32,0,0,0,0
1,8481239,Samuel Fagemo,L,,24,0,0,0,0
1,8474618,Marco Scandella,D,,34,0,0,0,0
1,8480853,Liam Foudy,C,,24,0,0,0,0
1,8478028,Fredrik Olofsson,L,,28,0,0,0,0
1,8474145,Robert Bortuzzo,D,,35,0,0,0,0
1,8474709,Matt Martin,L,,35,0,0,0,0
1,8480226,Marián Studenic,R,,26,0,0,0,0
1,8479522,Hardy Haman Aktell,D,WSH,26,3,0,0,0
1,8483407,Brandon Scanlin,D,NYR,25,3,0,0,0
1,8480274,Philip Kemp,D,EDM,25,1,0,0,0
1,8480184,Gustav Lindstrom,D,,26,0,0,0,0
1,8481077,John Leonard,L,,26,0,0,0,0
1,8479547,Matthew Phillips,R,,26,0,0,0,0
1,8476915,Jujhar Khaira,L,,30,0,0,0,0
1,8475413,Justin Dowling,C,NJD,34,16,0,0,0
1,8481070,Hugh McGing,L,,26,0,0,0,0
1,8483546,Marshall Rifai,D,TOR,26,0,0,0,0
1,8478408,Travis Dermott,D,,28,0,0,0,0
1,8484326,Patrik Koch,D,UTA,28,0,0,0,0
1,8481812,Nikolai Knyzhov,D,,27,0,0,0,0
1,8482197,Adam Raska,R,MIN,23,3,0,0,0
1,8484321,Nikolas Matinpalo,D,OTT,26,1,0,0,0
1,8480306,Grant Hutton,D,NYI,29,10,0,0,0
1,8475278,Byron Froese,C,,33,0,0,0,0
1,8475766,Austin Watson,L,,32,0,0,0,0
1,8481206,John Ludvig,D,PIT,24,10,0,0,0
1,8479546,Oskar Steen,C,,26,0,0,0,0
1,8480836,Jonathan Gruden,C,,24,0,0,0,0
1,8481690,Tyler Angle,C,,24,0,0,0,0
1,8480031,Maxime Comtois,L,,25,0,0,0,0
1,8483395,Arshdeep Bains,L,VAN,23,14,0,0,0
1,8483489,Fraser Minten,C,TOR,31,12,0,0,0
1,8483045,Cameron Butler,R,CBJ,31,0,0,0,0
1,8483432,Luca Del Bel Belluz,C,CBJ,31,8,0,0,0
1,8478078,Rourke Chartier,C,,28,0,0,0,0
1,8481016,Ruslan Iskhakov,C,,24,0,0,0,0
1,8481655,Cole Schwindt,R,CGY,23,4,0,0,0
1,8483609,Adam Klapka,R,CGY,24,0,0,0,0
1,8478881,Brett Seney,L,CHI,28,12,0,0,0
1,8481534,Raphael Lavoie,C,EDM,24,1,0,0,0
1,8484314,Jiri Smejkal,L,,28,0,0,0,0
1,8481726,Adam Edstrom,C,NYR,24,5,0,0,0
1,8478956,Samuel Laberge,L,NJD,27,0,0,0,0
1,8483401,Marc Johnstone,R,PIT,28,1,0,0,0
1,8483531,Brian Halonen,L,NJD,25,1,0,0,0
1,8484259,Ondrej Pavel,C,COL,31,5,0,0,0
1,8480776,Sheldon Rempal,R,,29,0,0,0,0
1,8478147,Bokondji Imama,L,PIT,28,6,0,0,0
1,8475780,Chris Wagner,R,COL,33,8,0,0,0
2,8478402,Connor McDavid,C,EDM,27,78,40,108,148
2,8477492,Nathan MacKinnon,C,COL,29,81,55,79,134
2,8478420,Mikko Rantanen,R,COL,28,81,56,64,120
2,8477934,Leon Draisaitl,C,EDM,29,80,47,69,116
2,8481559,Jack Hughes,C,NJD,23,72,35,81,116
2,8476453,Nikita Kucherov,R,TBL,31,82,33,79,112
2,8477956,David Pastrnak,R,BOS,28,77,45,58,103
2,8480012,Elias Pettersson,C,VAN,26,80,34,69,103
2,8484144,Connor Bedard,C,CHI,19,69,39,61,100
2,8478550,Artemi Panarin,L,NYR,33,75,30,70,100
2,8479318,Auston Matthews,C,TOR,27,79,58,40,98
2,8480027,Jason Robertson,L,DAL,25,82,37,60,97
2,8477942,Kevin Fiala,L,LAK,28,80,36,61,97
2,8479314,Matthew Tkachuk,L,FLA,27,79,35,62,97
2,8478445,Mathew Barzal,C,NYI,27,78,22,74,96
2,8480801,Brady Tkachuk,L,OTT,25,82,36,58,94
2,8478403,Jack Eichel,C,VGK,28,78,36,58,94
2,8478439,Travis Konecny,R,PHI,27,78,39,53,92
2,8478864,Kirill Kaprizov,L,MIN,27,71,35,57,92
2,8476468,J.T. Miller,C,VAN,31,77,31,61,92
2,8477939,William Nylander,R,TOR,28,80,38,53,91
2,8480800,Quinn Hughes,D,VAN,25,79,9,82,91
2,8477404,Jake Guentzel,C,TBL,30,81,45,42,87
2,8477501,Valeri Nichushkin,R,COL,29,82,44,42,86
2,8479343,Clayton Keller,R,UTA,26,71,39,46,85
2,8478010,Brayden Point,C,TBL,28,82,38,47,85
2,8473512,Claude Giroux,R,OTT,36,79,36,48,84
2,8481557,Matt Boldy,L,MIN,23,72,39,44,83
2,8475913,Mark Stone,R,VGK,32,78,36,47,83
2,8477951,Nick Schmaltz,C,UTA,28,74,33,50,83
2,8480069,Cale Makar,D,COL,26,72,23,60,83
2,8480023,Robert Thomas,C,STL,25,76,26,56,82
2,8480018,Nick Suzuki,C,MTL,25,78,27,54,81
2,8477493,Aleksander Barkov,C,FLA,29,80,22,59,81
2,8480036,Miro Heiskanen,D,DAL,25,81,21,60,81
2,8477946,Dylan Larkin,C,DET,28,82,44,36,80
2,8482740,Wyatt Johnston,C,DAL,21,81,41,39,80
2,8479385,Jordan Kyrou,C,STL,26,77,37,43,80
2,8477402,Pavel Buchnevich,L,STL,29,74,28,51,79
2,8482116,Tim Stützle,C,OTT,22,77,26,53,79
2,8471675,Sidney Crosby,C,PIT,37,78,39,38,77
2,8477933,Sam Reinhart,C,FLA,29,80,38,39,77
2,8479420,Tage Thompson,C,BUF,27,71,37,40,77
2,8480002,Nico Hischier,C,NJD,25,75,31,46,77
2,8477955,Jared McCann,L,SEA,28,75,36,40,76
2,8478427,Sebastian Aho,C,CAR,27,71,34,42,76
2,8476887,Filip Forsberg,L,NSH,30,75,30,46,76
2,8478444,Brock Boeser,R,VAN,27,75,37,38,75
2,8476460,Mark Scheifele,C,WPG,31,77,27,48,75
2,8476459,Mika Zibanejad,C,NYR,31,74,24,51,75
2,8471214,Alex Ovechkin,L,WSH,39,74,40,34,74
2,8474600,Roman Josi,D,NSH,34,71,13,61,74
2,8475166,John Tavares,C,TOR,34,81,29,44,73
2,8476454,Ryan Nugent-Hopkins,C,EDM,31,77,21,52,73
2,8477409,Carter Verhaeghe,C,FLA,29,76,33,38,71
2,8475784,Jeff Skinner,C,EDM,32,77,30,41,71
2,8482124,Quinton Byfield,R,LAK,22,78,26,45,71
2,8478414,Timo Meier,R,NJD,28,73,39,31,70
2,8480830,Andrei Svechnikov,R,CAR,24,70,38,32,70
2,8481540,Cole Caufield,R,MTL,23,81,34,36,70
2,8477407,Anthony Duclair,L,NYI,29,79,32,38,70
2,8474564,Steven Stamkos,C,NSH,34,71,25,45,70
2,8478398,Kyle Connor,L,WPG,28,76,29,40,69
2,8479323,Adam Fox,D,NYR,26,77,16,53,69
2,8475754,Brock Nelson,C,NYI,33,80,37,31,68
2,8479675,Trevor Moore,L,LAK,29,81,36,32,68
2,8473419,Brad Marchand,L,BOS,36,79,27,41,68
2,8481528,Dylan Cozens,C,BUF,23,74,25,43,68
2,8476389,Vincent Trocheck,C,NYR,31,76,28,39,67
2,8479407,Jesper Bratt,L,NJD,26,76,23,44,67
2,8471685,Anze Kopitar,C,LAK,37,77,22,45,67
2,8477500,Bo Horvat,C,NYI,29,80,30,36,66
2,8479542,Brandon Hagel,L,TBL,26,82,28,38,66
2,8475692,Mats Zuccarello,R,MIN,37,68,19,47,66
2,8477949,Alex Tuch,R,BUF,28,73,28,37,65
2,8476346,Johnny Gaudreau,L,CBJ,31,75,13,52,65
2,8478449,Roope Hintz,C,DAL,28,82,28,36,64
2,8475172,Nazem Kadri,C,CGY,34,72,28,36,64
2,8475168,Matt Duchene,C,DAL,33,81,23,41,64
2,8475786,Zach Hyman,L,EDM,32,77,39,24,63
2,8480208,Drake Batherson,R,OTT,26,79,30,33,63
2,8477960,Adrian Kempe,R,LAK,28,79,29,33,62
2,8479337,Alex DeBrincat,R,DET,27,78,25,37,62
2,8478873,Troy Terry,R,ANA,27,77,23,39,62
2,8475170,Brayden Schenn,C,STL,33,78,23,39,62
2,8476479,Phillip Danault,C,LAK,31,80,22,40,62
2,8479999,Casey Mittelstadt,C,COL,26,81,16,46,62
2,8482109,Alexis Lafrenière,L,NYR,23,76,31,30,61
2,8475158,Ryan O'Reilly,C,NSH,33,76,30,31,61
2,8482699,Dylan Guenther,R,UTA,21,77,27,34,61
2,8478493,Joel Eriksson Ek,C,MIN,27,74,26,35,61
2,8482093,Seth Jarvis,C,CAR,22,74,21,40,61
2,8477494,Jonathan Drouin,L,COL,29,79,20,40,60
2,8480865,Noah Dobson,D,NYI,24,79,10,50,60
2,8478401,Pavel Zacha,C,BOS,27,79,27,32,59
2,8477998,Warren Foegele,L,LAK,28,80,27,32,59
2,8484166,Adam Fantilli,C,CBJ,20,74,24,35,59
2,8482078,Lucas Raymond,L,DET,22,81,22,37,59
2,8477503,Max Domi,C,TOR,29,80,19,40,59
2,8475184,Chris Kreider,L,NYR,33,73,37,21,58
2,8476539,Jonathan Marchessault,R,NSH,34,72,34,24,58
2,8473994,Jamie Benn,L,DAL,35,81,23,35,58
2,8477496,Elias Lindholm,C,BOS,30,80,19,39,58
2,8477504,Josh Morrissey,D,WPG,29,74,12,46,58
2,8480798,Philipp Kurashev,C,CHI,25,71,18,39,57
2,8476448,William Karlsson,C,VGK,31,78,17,40,57
2,8482684,Luke Hughes,D,NJD,21,79,11,46,57
2,8477935,Sam Bennett,C,FLA,28,76,34,22,56
2,8480064,Josh Norris,C,OTT,25,78,29,27,56
2,8478466,Daniel Sprong,R,VAN,27,74,26,30,56
2,8482665,Matty Beniers,C,SEA,22,69,22,34,56
2,8471215,Evgeni Malkin,C,PIT,38,71,21,35,56
2,8477444,Andre Burakovsky,L,SEA,29,72,19,37,56
2,8476853,Morgan Rielly,D,TOR,30,71,5,51,56
2,8480015,Owen Tippett,R,PHI,25,74,33,22,55
2,8475794,Tyler Seguin,C,DAL,32,81,29,26,55
2,8476881,Tomas Hertl,C,VGK,31,77,25,30,55
2,8480839,Rasmus Dahlin,D,BUF,24,71,16,39,55
2,8480803,Evan Bouchard,D,EDM,25,77,16,39,55
2,8476462,Dougie Hamilton,D,NJD,31,64,16,39,55
2,8475167,Victor Hedman,D,TBL,34,80,9,46,55
2,8474102,David Perron,L,OTT,36,78,24,30,54
2,8478460,Zach Werenski,D,CBJ,27,81,19,35,54
2,8475798,Mikael Granlund,C,SJS,32,68,13,41,54
2,8475726,Tyler Toffoli,C,SJS,32,74,30,23,53
2,8475765,Vladimir Tarasenko,R,DET,33,79,17,36,53
2,8483515,Juraj Slafkovsky,L,MTL,20,76,24,28,52
2,8481560,Arthur Kaliyev,R,LAK,23,79,22,30,52
2,8477021,Alex Kerfoot,C,UTA,30,74,21,31,52
2,8478047,Michael Bunting,L,PIT,29,74,18,34,52
2,8479325,Charlie McAvoy,D,BOS,27,72,16,36,52
2,8477451,Ryan Hartman,R,MIN,30,72,22,29,51
2,8479987,Morgan Geekie,C,BOS,26,77,19,32,51
2,8476927,Teddy Blueger,C,VAN,30,72,17,34,51
2,8474141,Patrick Kane,R,DET,36,82,14,37,51
2,8474590,John Carlson,D,WSH,34,65,8,43,51
2,8475151,Kyle Palmieri,C,NYI,33,78,31,19,50
2,8478042,Viktor Arvidsson,R,EDM,31,78,26,24,50
2,8478440,Dylan Strome,C,WSH,27,74,23,27,50
2,8475810,Bryan Rust,R,PIT,32,64,20,30,50
2,8474150,Mikael Backlund,C,CGY,35,75,13,37,50
2,8482097,Jack Quinn,R,BUF,23,62,18,31,49
2,8478462,Nicolas Roy,C,VGK,27,75,16,33,49
2,8477986,Brandon Montour,D,SEA,30,76,12,37,49
2,8478498,Jake DeBrusk,L,VAN,28,70,22,26,48
2,8484145,Zach Benson,L,BUF,19,72,21,27,48
2,8474641,Adam Henrique,C,EDM,34,77,19,29,48
2,8477940,Nikolaj Ehlers,L,WPG,28,66,18,30,48
2,8481581,Thomas Harley,D,DAL,23,82,12,36,48
2,8471724,Kris Letang,D,PIT,37,80,11,37,48
2,8477932,Aaron Ekblad,D,FLA,28,69,10,38,48
2,8480434,Sean Durzi,D,UTA,26,72,9,39,48
2,8477497,Sean Monahan,C,CBJ,30,71,26,21,47
2,8481068,Yegor Sharangovich,C,CGY,26,78,22,25,47
2,8478474,Lawson Crouse,L,UTA,27,74,22,25,47
2,8484153,Leo Carlsson,C,ANA,20,71,16,31,47
2,8476882,Teuvo Teravainen,L,CHI,30,71,16,31,47
2,8476905,Chandler Stephenson,C,SEA,30,77,15,32,47
2,8479425,Filip Hronek,D,VAN,27,71,11,36,47
2,8476456,Jonathan Huberdeau,C,CGY,31,75,9,38,47
2,8478233,Andrew Mangiapane,L,WSH,28,69,18,28,46
2,8474578,Erik Karlsson,D,PIT,34,71,16,30,46
2,8478407,Vince Dunn,D,SEA,28,76,12,34,46
2,8474679,Gustav Nyquist,C,NSH,35,73,22,23,45
2,8478519,Anthony Cirelli,C,TBL,27,81,21,24,45
2,8478856,Conor Garland,R,VAN,28,70,20,25,45
2,8475745,Charlie Coyle,C,BOS,32,81,18,27,45
2,8480220,Noah Cates,L,PHI,25,77,17,28,45
2,8479400,Pierre-Luc Dubois,L,WSH,26,70,16,29,45
2,8477416,Oliver Bjorkstrand,R,SEA,29,71,13,32,45
2,8478469,Thomas Chabot,D,OTT,27,76,9,36,45
2,8476399,Blake Coleman,C,CGY,33,76,27,17,44
2,8482159,Tyson Foerster,R,PHI,22,76,18,26,44
2,8480188,Fabian Zetterlund,L,SJS,25,62,18,26,44
2,8479365,Trent Frederic,C,BOS,26,72,17,27,44
2,8477456,J.T. Compher,L,DET,29,78,16,28,44
2,8478038,Devon Toews,D,COL,30,63,9,35,44
2,8478397,Rasmus Andersson,D,CGY,28,72,7,37,44
2,8480014,Gabriel Vilardi,C,WPG,25,63,24,19,43
2,8476483,Rickard Rakell,R,PIT,31,69,22,21,43
2,8481618,Alex Newhook,C,MTL,23,70,22,21,43
2,8478057,Dakota Joshua,C,VAN,28,68,21,22,43
2,8474715,Cam Atkinson,R,TBL,35,81,20,23,43
2,8477476,Artturi Lehkonen,L,COL,29,79,18,25,43
2,8481711,Matias Maccelli,L,UTA,24,72,16,27,43
2,8480039,Martin Necas,C,CAR,25,66,15,28,43
2,8478046,Danton Heinen,L,VAN,29,71,15,28,43
2,8476875,Mike Matheson,D,MTL,30,68,9,34,43
2,8478366,Frank Vatrano,R,ANA,30,72,28,14,42
2,8476432,Boone Jenner,C,CBJ,31,65,25,17,42
2,8477964,Ivan Barbashev,C,VGK,29,75,20,22,42
2,8475169,Evander Kane,L,EDM,33,73,19,23,42
2,8482745,Mason McTavish,C,ANA,21,71,17,25,42
2,8475191,Reilly Smith,R,NYR,33,71,16,26,42
2,8474586,Jordan Eberle,R,SEA,34,71,16,26,42
2,8475753,Justin Faulk,D,STL,32,72,14,28,42
2,8481596,Shane Pinto,C,OTT,24,79,12,30,42
2,8482105,Jake Sanderson,D,OTT,22,70,11,31,42
2,8480336,Sean Walker,D,CAR,30,73,9,33,42
2,8480028,Morgan Frost,C,PHI,25,74,7,35,42
2,8483431,Logan Cooley,C,UTA,20,75,22,19,41
2,8475314,Anders Lee,L,NYI,34,78,22,19,41
2,8477511,Anthony Mantha,R,CGY,30,75,22,19,41
2,8475722,Jason Zucker,L,BUF,32,69,20,21,41
2,8483808,Andrei Kuzmenko,L,CGY,28,73,19,22,41
2,8478891,Mason Appleton,C,WPG,28,68,19,22,41
2,8482149,Cole Perfetti,C,WPG,22,69,18,23,41
2,8476792,Torey Krug,D,STL,33,69,15,26,41
2,8476419,Jean-Gabriel Pageau,C,NYI,32,73,15,26,41
2,8481523,Kirby Dach,C,MTL,23,66,13,28,41
2,8476872,Scott Laughton,C,PHI,30,75,13,28,41
2,8477447,Shea Theodore,D,VGK,29,57,4,37,41
2,8477426,Nicholas Paul,L,TBL,29,82,24,16,40
2,8479390,Taylor Raddysh,R,WSH,26,72,24,16,40
2,8473986,Alex Killorn,L,ANA,35,72,17,23,40
2,8479525,Ross Colton,C,COL,28,78,17,23,40
2,8482702,Logan Stankoven,C,DAL,21,82,17,23,40
2,8476826,Yanni Gourde,C,SEA,33,71,17,23,40
2,8477498,Darnell Nurse,D,EDM,29,73,15,25,40
2,8477346,MacKenzie Weegar,D,CGY,30,75,14,26,40
2,8479410,Mikhail Sergachev,D,UTA,26,71,11,29,40
2,8477948,Travis Sanheim,D,PHI,28,78,11,29,40
2,8477495,Seth Jones,D,CHI,30,67,10,30,40
2,8476880,Tom Wilson,R,WSH,30,64,10,30,40
2,8470613,Brent Burns,D,CAR,39,78,9,31,40
2,8479992,Michael Rasmussen,C,DET,25,80,17,22,39
2,8480078,Filip Chytil,C,NYR,25,71,16,23,39
2,8482667,William Eklund,L,SJS,22,68,15,24,39
2,8480797,Joel Farabee,L,PHI,24,74,15,24,39
2,8478472,Mathieu Joseph,R,STL,27,71,15,24,39
2,8480009,Eeli Tolvanen,R,SEA,25,66,15,24,39
2,8475768,Jaden Schwartz,C,SEA,32,68,13,26,39
2,8476480,Vladislav Namestnikov,C,WPG,32,70,13,26,39
2,8476958,Jaccob Slavin,D,CAR,30,76,10,29,39
2,8474563,Drew Doughty,D,LAK,35,69,7,32,39
2,8481577,Philip Tomasino,C,NSH,23,65,18,20,38
2,8476461,Sean Couturier,C,PHI,32,66,17,21,38
2,8474149,Evgenii Dadonov,R,DAL,35,81,16,22,38
2,8482110,Dawson Mercer,C,NJD,23,75,14,24,38
2,8481535,Nils Hoglander,L,VAN,24,69,23,14,37
2,8482175,JJ Peterka,R,BUF,22,66,19,18,37
2,8470621,Corey Perry,R,EDM,39,67,17,20,37
2,8475287,Erik Haula,L,NJD,33,66,15,22,37
2,8481656,Aliaksei Protas,C,WSH,23,65,15,22,37
2,8479345,Jakob Chychrun,D,WSH,26,70,12,25,37
2,8481533,Trevor Zegras,C,ANA,23,65,9,28,37
2,8477506,Ryan Pulock,D,NYI,30,76,7,30,37
2,8482705,Cole Sillinger,C,CBJ,21,71,20,16,36
2,8476438,Brandon Saad,L,STL,32,70,20,16,36
2,8475799,Nino Niederreiter,R,WPG,32,69,20,16,36
2,8478020,Michael Amadio,C,OTT,28,72,20,16,36
2,8475714,Calle Jarnkrok,C,TOR,33,77,15,21,36
2,8484203,Bradly Nadeau,L,CAR,19,65,12,24,36
2,8478542,Evan Rodrigues,C,FLA,31,78,11,25,36
2,8478396,Noah Hanifin,D,VGK,27,64,11,25,36
2,8476923,Damon Severson,D,CBJ,30,79,8,28,36
2,8482655,J.J. Moser,D,TBL,24,77,6,30,36
2,8476906,Shayne Gostisbehere,D,CAR,31,79,10,25,35
2,8478438,Tommy Novak,C,NSH,27,66,10,25,35
2,8478975,Mason Marchment,L,DAL,29,80,9,26,35
2,8482113,Anton Lundell,C,FLA,23,77,20,14,34
2,8477479,Tyler Bertuzzi,L,CHI,29,65,17,17,34
2,8473422,Nick Foligno,L,CHI,37,64,15,19,34
2,8479591,Michael Eyssimont,C,TBL,28,80,15,19,34
2,8482720,Matthew Knies,L,TOR,22,79,14,20,34
2,8474716,Jared Spurgeon,D,MIN,35,72,14,20,34
2,8480878,Nils Lundkvist,D,DAL,24,80,8,26,34
2,8481542,Moritz Seider,D,DET,23,73,4,30,34
2,8480813,Joe Veleno,C,DET,24,80,23,10,33
2,8480893,Kirill Marchenko,R,CBJ,24,67,20,13,33
2,8477425,Miles Wood,L,COL,29,82,17,16,33
2,8481553,Bobby Brink,R,PHI,23,56,17,16,33
2,8480185,Eetu Luostarinen,C,FLA,26,76,16,17,33
2,8483505,Matthew Poitras,C,BOS,20,69,15,18,33
2,8482089,Jake Neighbours,L,STL,22,67,15,18,33
2,8478463,Anthony Beauvillier,L,PIT,27,68,14,19,33
2,8479339,Patrik Laine,L,CBJ,26,60,12,21,33
2,8477987,Ryan Donato,C,CHI,28,66,12,21,33
2,8477953,Kasperi Kapanen,R,STL,28,69,11,22,33
2,8476392,Adam Lowry,C,WPG,31,63,10,23,33
2,8476869,Brady Skjei,D,NSH,30,70,8,25,33
2,8476979,Erik Gustafsson,D,DET,32,72,5,28,33
2,8480043,Timothy Liljegren,D,TOR,25,64,5,28,33
2,8478507,John Marino,D,UTA,27,61,4,29,33
2,8482092,Ridly Greig,C,OTT,22,74,13,19,32
2,8480113,Alex Iafallo,L,WPG,31,62,13,19,32
2,8476292,Ondrej Palat,L,NJD,33,72,13,19,32
2,8476921,Jordan Martinook,L,CAR,32,65,13,19,32
2,8478413,Jordan Greenway,L,BUF,27,66,12,20,32
2,8475193,Tomas Tatar,L,NJD,34,70,12,20,32
2,8479351,Sam Steel,C,DAL,26,78,11,21,32
2,8483490,Pavel Mintyukov,D,ANA,21,74,9,23,32
2,8481703,Valtteri Puustinen,R,PIT,25,65,9,23,32
2,8478911,Matt Roy,D,WSH,29,69,9,23,32
2,8482122,Brock Faber,D,MIN,22,78,5,27,32
2,8477969,Marcus Pettersson,D,PIT,28,81,5,27,32
2,8479976,Juuso Valimaki,D,UTA,26,64,3,29,32
2,8483524,Shane Wright,C,SEA,20,70,16,15,31
2,8476278,Colin Blackwell,C,DAL,31,78,16,15,31
2,8476474,Stefan Noesen,R,NJD,31,61,15,16,31
2,8480802,Ryan McLeod,C,BUF,25,68,13,18,31
2,8481624,Ilya Mikheyev,R,CHI,30,51,11,20,31
2,8482146,Luke Evangelista,R,NSH,22,70,11,20,31
2,8476885,Jacob Trouba,D,NYR,30,71,6,25,31
2,8479293,Brandon Tanev,L,SEA,33,61,21,9,30
2,8482259,Bobby McMann,C,TOR,28,72,18,12,30
2,8476469,Joel Armia,R,MTL,31,70,15,15,30
2,8477952,Robby Fabbri,C,ANA,28,67,14,16,30
2,8477508,Curtis Lazar,C,NJD,29,63,14,16,30
2,8480849,Barrett Hayton,C,UTA,24,68,12,18,30
2,8480829,Jesperi Kotkaniemi,C,CAR,24,69,12,18,30
2,8475218,Mattias Ekholm,D,EDM,34,75,10,20,30
2,8475149,Marcus Johansson,L,MIN,34,65,10,20,30
2,8481582,Nicholas Robertson,L,TOR,23,75,10,20,30
2,8482660,Kent Johnson,C,CBJ,22,63,8,22,30
2,8480145,Neal Pionk,D,WPG,29,71,6,24,30
2,8480871,Adam Boqvist,D,FLA,24,68,5,25,30
2,8482671,Owen Power,D,BUF,22,72,5,25,30
2,8476879,Cody Ceci,D,EDM,31,70,1,29,30
2,8471698,T.J. Oshie,R,WSH,38,66,17,12,29
2,8482133,Thomas Bordeleau,C,SJS,22,63,13,16,29
2,8481580,Connor McMichael,C,WSH,23,59,13,16,29
2,8475763,Kevin Hayes,R,PIT,32,73,12,17,29
2,8482737,Zack Bolduc,C,STL,21,59,12,17,29
2,8480835,Jack Drury,C,CAR,24,66,12,17,29
2,8476925,Colton Sissons,C,NSH,31,67,12,17,29
2,8475220,Marcus Foligno,L,MIN,33,59,11,18,29
2,8477947,Sonny Milano,L,WSH,28,60,10,19,29
2,8482079,Marco Rossi,C,MIN,23,60,10,19,29
2,8481546,Cam York,D,PHI,23,70,7,22,29
2,8475764,Cam Fowler,D,ANA,33,70,7,22,29
2,8476463,Jonas Brodin,D,MIN,31,77,7,22,29
2,8478055,Gustav Forsling,D,FLA,28,72,6,23,29
2,8478882,Vladislav Gavrikov,D,LAK,29,64,3,26,29
2,8479353,Brett Howden,C,VGK,26,70,14,14,28
2,8482055,Drew O'Connor,L,PIT,26,61,13,15,28
2,8477429,Andrew Copp,C,DET,30,80,11,17,28
2,8483457,Lane Hutson,D,MTL,20,69,11,17,28
2,8478458,Jack Roslovic,C,CAR,27,62,9,19,28
2,8480068,Ryan Poehling,C,PHI,25,70,9,19,28
2,8482634,Alex Steeves,C,TOR,25,63,9,19,28
2,8482475,Yegor Chinakhov,R,CBJ,23,59,7,21,28
2,8482111,Justin Barron,D,MTL,23,66,6,22,28
2,8476422,Mike Reilly,D,NYI,31,76,5,23,28
2,8476917,Adam Pelech,D,NYI,30,77,3,25,28
2,8480252,Cole Guttman,C,CHI,25,47,17,10,27
2,8482125,Alexander Holtz,R,VGK,22,68,16,11,27
2,8478115,Pierre Engvall,L,NYI,28,74,15,12,27
2,8476981,Josh Anderson,R,MTL,30,72,14,13,27
2,8473453,Trevor Lewis,C,LAK,37,74,14,13,27
2,8480459,Pius Suter,C,VAN,28,63,12,15,27
2,8475848,Brendan Gallagher,R,MTL,32,72,10,17,27
2,8475200,Dmitry Orlov,D,CAR,33,69,8,19,27
2,8476467,Jamie Oleksiak,D,SEA,32,71,8,19,27
2,8476458,Ryan Strome,C,ANA,31,70,7,20,27
2,8474151,Ryan McDonagh,D,TBL,35,76,3,24,27
2,8481186,Logan O'Connor,R,COL,28,78,15,11,26
2,8475343,Nic Dowd,C,WSH,34,62,14,12,26
2,8481093,Rafael Harvey-Pinard,L,MTL,25,62,14,12,26
2,8475793,Ryan Johansen,C,PHI,32,75,13,13,26
2,8473533,Jordan Staal,C,CAR,36,63,13,13,26
2,8477478,William Carrier,L,CAR,30,60,13,13,26
2,8480980,Connor Dewar,C,TOR,25,75,13,13,26
2,8481522,Peyton Krebs,C,BUF,23,66,13,13,26
2,8480003,Jesper Boqvist,C,FLA,26,65,12,14,26
2,8478109,Victor Olofsson,L,VGK,29,69,12,14,26
2,8477839,Conor Sheary,L,TBL,32,82,10,16,26
2,8482176,Wyatt Kaiser,D,CHI,22,54,10,16,26
2,8477989,Christian Dvorak,C,MTL,28,63,9,17,26
2,8483468,Jiri Kulich,C,BUF,20,58,9,17,26
2,8480817,K'Andre Miller,D,NYR,24,70,6,20,26
2,8482809,Jackson Blake,R,CAR,21,60,6,20,26
2,8476331,Dylan DeMelo,D,WPG,31,71,5,21,26
2,8474565,Alex Pietrangelo,D,VGK,34,56,4,22,26
2,8481014,Alexander Romanov,D,NYI,24,79,4,22,26
2,8480873,Rasmus Sandin,D,WSH,24,63,3,23,26
2,8479998,Mikey Anderson,D,LAK,25,66,3,23,26
2,8478508,Yakov Trenin,C,MIN,27,63,14,11,25
2,8482155,Alex Laferriere,R,LAK,23,66,14,11,25
2,8476960,Andreas Athanasiou,C,CHI,30,57,11,14,25
2,8479996,Cody Glass,C,NSH,25,57,10,15,25
2,8475760,Nick Bjugstad,C,UTA,32,75,10,15,25
2,8477406,Mattias Janmark,C,EDM,32,69,10,15,25
2,8480855,Jack McBain,C,UTA,24,70,9,16,25
2,8477450,Jason Dickinson,C,CHI,29,56,9,16,25
2,8476329,Travis Boyd,C,MIN,31,59,9,16,25
2,8475171,Oliver Ekman-Larsson,D,TOR,33,68,6,19,25
2,8481521,Ronnie Attard,D,PHI,25,61,6,19,25
2,8477435,Ryan Graves,D,PIT,29,79,5,20,25
2,8481606,Jordan Spence,D,LAK,23,57,5,20,25
2,8481032,Paul Cotter,C,NJD,25,61,15,9,24
2,8481554,Kaapo Kakko,R,NYR,23,67,13,11,24
2,8479661,Tanner Jeannot,L,LAK,27,75,12,12,24
2,8477353,Tyler Motte,C,DET,29,74,12,12,24
2,8483493,Frank Nazar,C,CHI,20,60,10,14,24
2,8474053,Logan Couture,C,SJS,35,56,9,15,24
2,8476889,Radek Faksa,C,STL,30,66,9,15,24
2,8478013,Jake Walman,D,SJS,28,68,8,16,24
2,8474574,Tyler Myers,D,VAN,34,70,6,18,24
2,8476892,Colton Parayko,D,STL,31,73,4,20,24
2,8478500,Ivan Provorov,D,CBJ,27,79,3,21,24
2,8477488,Brett Pesce,D,NJD,30,66,3,21,24
2,8479619,Michael Carcone,L,UTA,28,59,14,9,23
2,8477903,Garnet Hathaway,R,PHI,33,61,13,10,23
2,8477392,Hudson Fasching,R,NYI,29,66,12,11,23
2,8480748,Kiefer Sherwood,L,VAN,29,59,12,11,23
2,8480074,Alexandre Texier,C,STL,25,59,12,11,23
2,8479393,Noah Gregor,C,OTT,26,67,11,12,23
2,8479414,Nathan Bastian,R,NJD,27,58,11,12,23
2,8476897,Oskar Sundqvist,C,STL,30,64,10,13,23
2,8480021,Jack Studnicka,C,LAK,25,57,8,15,23
2,8482712,Oskar Olausson,R,COL,22,74,7,16,23
2,8473563,Nicklas Backstrom,C,WSH,37,49,4,19,23
2,8470600,Ryan Suter,D,STL,39,51,3,20,23
2,8480891,Michael Kesselring,D,UTA,24,60,2,21,23
2,8479398,Samuel Girard,D,COL,26,67,0,23,23
2,8482074,Connor Zary,C,CGY,23,68,17,5,22
2,8476918,Jimmy Vesey,L,NYR,31,67,15,7,22
2,8481604,Pavel Dorofeyev,L,VGK,24,71,13,9,22
2,8475791,Taylor Hall,L,CHI,33,52,11,11,22
2,8483499,Liam Ohgren,L,MIN,20,58,7,15,22
2,8475231,Casey Cizikas,C,NYI,33,71,6,16,22
2,8482142,Jamie Drysdale,D,PHI,22,66,5,17,22
2,8480157,Calle Rosen,D,COL,30,51,5,17,22
2,8476457,Adam Larsson,D,SEA,32,56,2,20,22
2,8478432,Christian Fischer,R,DET,27,69,10,11,21
2,8479980,Nicolas Hague,D,VGK,26,54,6,15,21
2,8476854,Hampus Lindholm,D,BOS,30,69,3,18,21
2,8477507,Nikita Zadorov,D,BOS,29,70,3,18,21
2,8478178,Darren Raddysh,D,TBL,28,69,3,18,21
2,8481059,Scott Perunovich,D,STL,26,60,2,19,21
2,8473507,Jeff Petry,D,DET,37,72,1,20,21
2,8478569,Noel Acciari,C,PIT,33,54,10,10,20
2,8482117,Lukas Reichel,L,CHI,22,63,8,12,20
2,8479368,Max Jones,L,BOS,26,66,7,13,20
2,8478133,Jake Evans,C,MTL,28,67,7,13,20
2,8480246,Nick Perbix,D,TBL,26,73,7,13,20
2,8479348,Kale Clague,D,BUF,26,46,7,13,20
2,8479324,Ryan Lindgren,D,NYR,26,58,6,14,20
2,8481481,Blake Lizotte,C,PIT,27,62,5,15,20
2,8476429,Scott Mayfield,D,NYI,32,76,4,16,20
2,8475279,Ben Chiarot,D,DET,33,71,4,16,20
2,8478136,Jake Middleton,D,MIN,28,74,4,16,20
2,8477220,Nate Schmidt,D,FLA,33,69,3,17,20
2,8479402,Jake Bean,D,CGY,26,66,3,17,20
2,8482245,Artem Zub,D,OTT,29,73,1,19,20
2,8477446,Michael McCarron,R,NSH,29,60,12,7,19
2,8480789,Oliver Wahlstrom,R,NYI,24,73,9,10,19
2,8483482,Tristan Luneau,D,ANA,20,70,7,12,19
2,8483495,Simon Nemec,D,NJD,20,62,7,12,19
2,8482101,Danil Gushchin,L,SJS,22,56,6,13,19
2,8476902,Esa Lindell,D,DAL,30,80,5,14,19
2,8477015,Connor Brown,R,EDM,30,63,5,14,19
2,8474673,TJ Brodie,D,CHI,34,61,3,16,19
2,8479639,Dylan Coghlan,D,WPG,26,54,3,16,19
2,8482192,Isaak Phillips,D,CHI,23,53,2,17,19
2,8481568,Alex Vlasic,D,CHI,23,50,1,18,19
2,8481704,Juuso Parssinen,C,NSH,23,60,12,6,18
2,8482157,Will Cuylle,L,NYR,22,60,9,9,18
2,8481524,Bowen Byram,D,BUF,23,47,8,10,18
2,8479718,Alex Barré-Boulet,C,MTL,27,51,7,11,18
2,8478043,Sam Lafferty,C,BUF,29,54,7,11,18
2,8477919,Frederick Gaudreau,C,MIN,31,52,6,12,18
2,8479370,Tyson Jost,C,CAR,26,42,6,12,18
2,8483445,Cutter Gauthier,L,ANA,20,64,5,13,18
2,8478970,Jalen Chatfield,D,CAR,28,68,5,13,18
2,8482624,Daniil Miromanov,D,CGY,27,67,5,13,18
2,8478452,Caleb Jones,D,LAK,27,60,5,13,18
2,8480796,Martin Fehervary,D,WSH,25,49,5,13,18
2,8476312,Josh Manson,D,COL,33,64,3,15,18
2,8478399,Jonas Siegenthaler,D,NJD,27,59,1,17,18
2,8479336,Carl Grundstrom,R,SJS,27,54,9,8,17
2,8476934,Brock McGinn,L,ANA,30,56,8,9,17
2,8477499,Rasmus Ristolainen,D,PHI,30,57,6,11,17
2,8481641,Joel Kiviranta,L,COL,28,67,6,11,17
2,8483491,Ivan Miroshnichenko,L,WSH,20,53,4,13,17
2,8481537,Nikita Okhotiuk,D,CGY,24,59,4,13,17
2,8482859,Zack Ostapchuk,C,OTT,21,56,4,13,17
2,8476931,Jake McCabe,D,TOR,31,69,3,14,17
2,8475324,Nick Jensen,D,OTT,34,65,3,14,17
2,8480860,Kevin Bahl,D,CGY,24,55,2,15,17
2,8475233,David Savard,D,MTL,34,64,2,15,17
2,8477369,Carson Soucy,D,VAN,30,65,1,16,17
2,8478851,Alexandre Carrier,D,NSH,28,66,1,16,17
2,8479982,Conor Timmins,D,TOR,26,55,1,16,17
2,8480049,Dylan Samberg,D,WPG,25,63,0,17,17
2,8479315,Joey Anderson,R,CHI,26,46,12,4,16
2,8476374,Sean Kuraly,C,CBJ,31,54,10,6,16
2,8474189,Lars Eller,C,PIT,35,66,9,7,16
2,8480289,Morgan Barron,C,WPG,26,55,9,7,16
2,8481716,Dmitri Voronkov,L,CBJ,24,49,9,7,16
2,8475225,Craig Smith,C,CHI,35,59,8,8,16
2,8478831,Kevin Stenlund,C,UTA,28,62,7,9,16
2,8480762,Eric Robinson,L,CAR,29,55,6,10,16
2,8480281,Alexey Toropchenko,R,STL,25,53,6,10,16
2,8482803,Olen Zellweger,D,ANA,21,61,6,10,16
2,8484149,Gavin Brindley,C,CBJ,20,48,5,11,16
2,8479983,Mario Ferraro,D,SJS,26,68,4,12,16
2,8475181,Nick Leddy,D,STL,33,67,4,12,16
2,8475179,Dmitry Kulikov,D,FLA,34,61,4,12,16
2,8478434,Keegan Kolesar,R,VGK,27,69,3,13,16
2,8481527,Kaedan Korczak,D,VGK,23,38,3,13,16
2,8482067,Connor Mackey,D,NYR,28,58,3,13,16
2,8475208,Brian Dumoulin,D,ANA,33,62,3,13,16
2,8481708,Zac Jones,D,NYR,24,54,3,13,16
2,8476988,Matt Benning,D,SJS,30,64,2,14,16
2,8476473,Connor Murphy,D,CHI,31,50,2,14,16
2,8475790,Erik Gudbranson,D,CBJ,32,77,1,15,16
2,8474568,Luke Schenn,D,NSH,35,55,1,15,16
2,8477845,Trevor van Riemsdyk,D,WSH,33,66,0,16,16
2,8480205,Emil Bemstrom,C,PIT,25,56,9,6,15
2,8480995,Pontus Holmberg,R,TOR,25,70,8,7,15
2,8480355,Mark Kastelic,C,BOS,25,66,8,7,15
2,8482807,Ethan Del Mastro,D,CHI,21,60,7,8,15
2,8474034,Pat Maroon,L,CHI,36,53,7,8,15
2,8481477,Nico Sturm,C,SJS,29,59,7,8,15
2,8477931,Tomas Nosek,L,FLA,32,55,5,10,15
2,8476822,Luke Glendening,C,TBL,35,80,5,10,15
2,8482087,Kaiden Guhle,D,MTL,22,68,4,11,15
2,8480073,Erik Brannstrom,D,COL,25,68,3,12,15
2,8477979,Nicolas Aube-Kubel,R,BUF,28,51,3,12,15
2,8479378,Logan Stanley,D,WPG,26,45,3,12,15
2,8480035,Henri Jokiharju,D,BUF,25,64,2,13,15
2,8475718,Justin Holl,D,DET,32,59,1,14,15
2,8479369,Andrew Peeke,D,BOS,26,56,1,14,15
2,8479520,Brandon Duhaime,R,WSH,27,63,10,4,14
2,8481601,Simon Holmstrom,R,NYI,23,69,9,5,14
2,8482062,Cole Smith,L,NSH,29,54,9,5,14
2,8480011,Klim Kostin,C,SJS,25,57,7,7,14
2,8478585,Derek Ryan,C,EDM,38,60,7,7,14
2,8481147,Reese Johnson,C,MIN,26,37,7,7,14
2,8480448,Parker Kelly,L,COL,25,76,6,8,14
2,8477018,Ben Hutton,D,VGK,31,50,6,8,14
2,8482749,Joshua Roy,R,MTL,21,62,5,9,14
2,8476878,Zemgus Girgensons,L,TBL,30,80,5,9,14
2,8479316,Luke Kunin,C,SJS,27,59,5,9,14
2,8482153,Brendan Brisson,C,VGK,23,31,5,9,14
2,8482679,Matt Coronato,R,CGY,22,70,4,10,14
2,8482166,Shakir Mukhamadullin,D,SJS,22,66,4,10,14
2,8481441,Joe Snively,C,DET,28,64,4,10,14
2,8475455,Brenden Dillon,D,NJD,34,62,3,11,14
2,8482148,Hendrix Lapierre,C,WSH,22,47,3,11,14
2,8480727,Zach Whitecloud,D,VGK,28,58,2,12,14
2,8482073,Braden Schneider,D,NYR,23,67,2,12,14
2,8479371,Dante Fabbro,D,NSH,26,61,1,13,14
2,8480950,Ilya Lyubushkin,D,DAL,30,72,1,13,14
2,8480807,Mattias Samuelsson,D,BUF,24,59,1,13,14
2,8479941,Justin Danforth,R,CBJ,31,65,9,4,13
2,8479066,Ryan Lomberg,L,CGY,30,62,7,6,13
2,8479359,Beck Malenstyn,L,BUF,26,50,7,6,13
2,8476873,Mark Jankowski,C,NSH,30,47,6,7,13
2,8479968,Vinni Lettieri,C,BOS,29,51,6,7,13
2,8475958,Michael Sgarbossa,C,WSH,32,34,6,7,13
2,8475855,Jesper Fast,R,CAR,33,58,5,8,13
2,8481599,Victor Soderstrom,D,UTA,23,45,5,8,13
2,8480848,Ty Dellandrea,C,SJS,24,48,5,8,13
2,8483565,Nick Blankenburg,D,NSH,26,60,4,9,13
2,8471709,Marc-Edouard Vlasic,D,SJS,37,56,4,9,13
2,8482744,James Malatesta,L,CBJ,21,38,4,9,13
2,8482964,Arber Xhekaj,D,MTL,23,47,3,10,13
2,8483460,David Jiricek,D,CBJ,21,58,2,11,13
2,8481122,Simon Benoit,D,TOR,26,50,2,11,13
2,8480172,Jan Rutta,D,SJS,34,63,1,12,13
2,8481178,Egor Zamula,D,PHI,24,60,1,12,13
2,8480887,Jordan Harris,D,MTL,24,55,0,13,13
2,8481518,Nolan Foote,L,NJD,24,47,8,4,12
2,8477070,Liam O'Brien,C,UTA,30,55,7,5,12
2,8481592,Jakob Pelletier,L,CGY,23,43,7,5,12
2,8479671,Mathieu Olivier,R,CBJ,27,45,6,6,12
2,8478211,Dryden Hunt,L,CGY,29,57,6,6,12
2,8480025,MacKenzie Entwistle,R,FLA,25,58,6,6,12
2,8479536,Axel Jonsson-Fjallby,L,WPG,26,42,6,6,12
2,8478416,Erik Cernak,D,TBL,27,66,5,7,12
2,8480806,Isac Lundestrom,C,ANA,25,58,5,7,12
2,8483763,Maksymilian Szuber,D,UTA,22,32,5,7,12
2,8481532,Alex Turcotte,C,LAK,23,48,5,7,12
2,8481751,Lukas Rousek,R,BUF,25,39,4,8,12
2,8475750,Jon Merrill,D,MIN,32,54,4,8,12
2,8480070,Ian Mitchell,D,BOS,25,45,4,8,12
2,8478454,Noah Juulsen,D,VAN,27,47,4,8,12
2,8477365,Connor Clifton,D,BUF,29,47,3,9,12
2,8480879,Jacob Bernard-Docker,D,OTT,24,48,3,9,12
2,8480870,Bo Groulx,C,NYR,24,35,3,9,12
2,8476967,Brett Kulak,D,EDM,30,62,2,10,12
2,8482730,Brandt Clarke,D,LAK,21,42,1,11,12
2,8478840,Will Borgen,D,SEA,28,59,0,12,12
2,8482762,Simon Edvinsson,D,DET,21,53,7,4,11
2,8480880,Jakub Lauko,C,MIN,24,35,7,4,11
2,8480144,David Kampf,C,TOR,29,75,6,5,11
2,8481517,Brett Leason,R,ANA,25,52,6,5,11
2,8481028,Martin Pospisil,C,CGY,25,52,5,6,11
2,8476442,Matt Nieto,L,PIT,32,51,5,6,11
2,8476874,Olli Maatta,D,DET,30,61,4,7,11
2,8478443,Brandon Carlo,D,BOS,28,62,4,7,11
2,8477851,Jordan Oesterle,D,BOS,32,40,4,7,11
2,8481701,Santeri Hatakka,D,NJD,23,39,4,7,11
2,8481550,Adam Beckman,L,NJD,23,36,4,7,11
2,8475462,Radko Gudas,D,ANA,34,59,3,8,11
2,8479372,Josh Mahura,D,SEA,26,58,3,8,11
2,8482070,Mitchell Chaffee,R,TBL,26,56,2,9,11
2,8476952,Dominic Toninato,C,WPG,30,41,2,9,11
2,8480001,Urho Vaakanainen,D,ANA,25,54,1,10,11
2,8479026,Philippe Myers,D,TOR,27,41,1,10,11
2,8480222,Sebastian Aho,D,PIT,28,72,1,10,11
2,8476525,Colin Miller,D,WPG,32,68,1,10,11
2,8477034,Jaycob Megna,D,FLA,32,49,1,10,11
2,8481013,Jonatan Berggren,R,DET,24,57,5,5,10
2,8477938,Haydn Fleury,D,WPG,28,46,5,5,10
2,8482659,Josh Doan,R,UTA,22,53,4,6,10
2,8471817,Ryan Reaves,R,TOR,37,64,4,6,10
2,8482141,Lukas Cormier,D,VGK,22,27,4,6,10
2,8479439,Jacob MacDonald,D,COL,31,50,3,7,10
2,8479344,Jesse Puljujarvi,R,PIT,26,49,3,7,10
2,8482666,Scott Morrow,D,CAR,22,49,3,7,10
2,8481161,Jake Christiansen,D,CBJ,25,47,3,7,10
2,8477380,Jonny Brodzinski,C,NYR,31,50,3,7,10
2,8482095,Tyler Kleven,D,OTT,22,47,3,7,10
2,8482145,Mavrik Bourque,C,DAL,22,51,3,7,10
2,8482511,Mason Lohrei,D,BOS,23,42,2,8,10
2,8474567,Zach Bogosian,D,MIN,34,56,2,8,10
2,8481617,Vasily Podkolzin,R,VAN,23,47,2,8,10
2,8474013,Ian Cole,D,UTA,35,52,1,9,10
2,8476441,Joel Edmundson,D,LAK,31,38,1,9,10
2,8476372,Nick Seeler,D,PHI,31,48,1,9,10
2,8478450,Parker Wotherspoon,D,BOS,27,36,0,10,10
2,8482451,Mikael Pyyhtia,L,CBJ,23,39,0,10,10
2,8482077,Dylan Holloway,L,EDM,23,48,7,2,9
2,8477573,Nathan Walker,L,STL,30,40,6,3,9
2,8482747,Brennan Othmann,L,NYR,21,51,6,3,9
2,8476624,Barclay Goodrow,C,SJS,31,56,5,4,9
2,8475842,Sam Carrick,C,NYR,32,62,5,4,9
2,8483397,Marc McLaughlin,C,BOS,25,27,5,4,9
2,8478424,Jansen Harkins,C,ANA,27,34,5,4,9
2,8478421,A.J. Greer,L,FLA,28,59,4,5,9
2,8482652,Walker Duehr,R,CGY,27,43,4,5,9
2,8482733,Logan Mailloux,D,MTL,31,36,4,5,9
2,8480192,Johnathan Kovacevic,D,NJD,27,50,3,6,9
2,8474166,Alec Martinez,D,CHI,37,42,3,6,9
2,8477887,Patrick Brown,C,BOS,32,44,3,6,9
2,8481609,Vladislav Kolyachonok,D,UTA,23,33,3,6,9
2,8474612,Travis Hamonic,D,OTT,34,50,3,6,9
2,8480441,Trey Fix-Wolansky,R,CBJ,25,40,3,6,9
2,8478146,Matthew Highmore,C,OTT,28,31,3,6,9
2,8478017,Mark Friedman,D,VAN,29,32,3,6,9
2,8476891,Matt Grzelcyk,D,PIT,30,73,2,7,9
2,8479543,Michael Pezzetta,L,MTL,26,51,2,7,9
2,8479328,Julien Gauthier,R,NYI,27,61,2,7,9
2,8478468,Jeremy Lauzon,D,NSH,27,50,1,8,9
2,8475690,Chris Tanev,D,TOR,35,63,1,8,9
2,8480196,Jacob Bryson,D,BUF,27,52,1,8,9
2,8480990,Declan Chisholm,D,MIN,24,51,0,9,9
2,8475235,Nicolas Deslauriers,L,PHI,33,50,6,2,8
2,8481789,Tye Kartye,L,SEA,23,38,6,2,8
2,8478451,Ethan Bear,D,WSH,27,47,4,4,8
2,8476867,Brendan Gaunce,C,MIN,30,43,4,4,8
2,8475762,Derek Forbort,D,VAN,32,42,4,4,8
2,8481567,Henry Thrun,D,SJS,23,49,3,5,8
2,8481605,Jackson LaCombe,D,ANA,23,42,3,5,8
2,8478859,Niko Mikkola,D,FLA,28,58,2,6,8
2,8479442,Troy Stecher,D,EDM,30,56,2,6,8
2,8484911,Collin Graf,R,SJS,22,39,2,6,8
2,8477335,Kyle Burroughs,D,LAK,29,55,2,6,8
2,8479981,Jonah Gadjovich,L,FLA,26,43,2,6,8
2,8483466,Kevin Korchinski,D,CHI,20,47,2,6,8
2,8483619,Filip Roos,D,OTT,25,36,2,6,8
2,8471677,Jack Johnson,D,CBJ,37,71,1,7,8
2,8474090,Brendan Smith,D,DAL,35,72,0,8,8
2,8477384,Josh Brown,D,EDM,30,39,0,8,8
2,8479249,Andrew Poturalski,C,SJS,30,31,0,8,8
2,8479994,Jaret Anderson-Dolan,C,WPG,25,34,5,2,7
2,8482144,Jack Thompson,D,SJS,22,24,5,2,7
2,8475188,Brayden McNabb,D,VGK,33,58,4,3,7
2,8476858,Phillip Di Giuseppe,L,VAN,31,40,4,3,7
2,8479772,Zack MacEwen,R,OTT,28,50,4,3,7
2,8477505,Alexander Wennberg,C,SJS,30,36,4,3,7
2,8481019,David Gustafsson,C,WPG,24,44,3,4,7
2,8480845,Rasmus Kupari,C,WPG,24,37,3,4,7
2,8479944,Zach Aston-Reese,C,VGK,30,44,3,4,7
2,8479320,Max Lajoie,D,SEA,27,25,3,4,7
2,8481743,Marc Del Gaizo,D,NSH,25,18,3,4,7
2,8476994,Vinnie Hinostroza,C,NSH,30,46,2,5,7
2,8477473,Justin Bailey,R,SJS,29,36,2,5,7
2,8479291,Kevin Rooney,C,CGY,31,45,2,5,7
2,8482118,Sam Colangelo,R,ANA,23,21,2,5,7
2,8480058,Pierre-Olivier Joseph,D,STL,25,55,1,6,7
2,8482861,Vincent Iorio,D,WSH,22,30,1,6,7
2,8482765,Isak Rosen,R,BUF,21,30,0,7,7
2,8481598,Philip Broberg,D,EDM,23,39,0,7,7
2,8481754,Nikita Nesterenko,C,ANA,23,42,6,0,6
2,8483570,Ben Meyers,C,SEA,26,43,5,1,6
2,8481556,John Beecher,C,BOS,23,37,3,3,6
2,8477962,Brendan Lemieux,L,CAR,28,38,3,3,6
2,8478409,Anthony Richard,C,PHI,28,28,3,3,6
2,8482713,Mackie Samoskevich,R,FLA,22,48,3,3,6
2,8476913,Devin Shore,C,MIN,30,30,2,4,6
2,8483630,Pavol Regenda,L,ANA,25,31,2,4,6
2,8475177,Calvin de Haan,D,COL,33,37,2,4,6
2,8479986,Kole Lind,R,DAL,26,46,2,4,6
2,8480292,Carson Meyer,R,ANA,27,29,1,5,6
2,8477810,Joel Hanley,D,CGY,33,26,1,5,6
2,8479972,Mason Shaw,C,WPG,26,30,1,5,6
2,8479991,Jake Leschyshyn,C,NYR,25,26,1,5,6
2,8479576,Vincent Desharnais,D,VAN,28,29,0,6,6
2,8482751,Ryan Winterton,C,SEA,21,37,4,1,5
2,8482496,Nils Aman,C,VAN,24,31,3,2,5
2,8478021,William Lagesson,D,DET,28,31,3,2,5
2,8482784,Zach Dean,C,STL,21,38,2,3,5
2,8481600,Tobias Bjornfot,D,FLA,23,35,2,3,5
2,8481167,Brayden Pachal,D,CGY,25,34,2,3,5
2,8477527,Ross Johnston,L,ANA,30,32,2,3,5
2,8479985,Cale Fleury,D,SEA,26,23,2,3,5
2,8482516,Matthew Kessel,D,STL,24,23,2,3,5
2,8480007,Jonas Rondbjerg,R,VGK,25,45,1,4,5
2,8484287,Cole McWard,D,VAN,23,28,1,4,5
2,8478502,Dennis Gilbert,D,BUF,28,19,1,4,5
2,8482470,Ilya Solovyov,D,CGY,24,19,1,4,5
2,8477467,Gustav Olofsson,D,SEA,30,19,1,4,5
2,8480834,Ty Emberson,D,SJS,24,34,0,5,5
2,8477401,John Hayden,C,SEA,29,24,3,1,4
2,8479421,Jacob Moverare,D,LAK,26,10,2,2,4
2,8473446,Erik Johnson,D,PHI,36,35,1,3,4
2,8482858,Ryker Evans,D,SEA,23,29,1,3,4
2,8482177,Marat Khusnutdinov,C,MIN,22,22,1,3,4
2,8479587,Rhett Gardner,C,PHI,28,18,1,3,4
2,8482094,Daemon Hunt,D,MIN,22,22,1,3,4
2,8482929,Emil Lilleberg,D,TBL,23,25,0,4,4
2,8481030,Jack St. Ivany,D,PIT,25,20,0,4,4
2,8479419,Brett Murray,L,BUF,26,15,0,4,4
2,8484254,Akito Hirose,D,VAN,25,29,3,0,3
2,8478051,Max Willman,C,NJD,29,15,3,0,3
2,8479379,Givani Smith,R,SJS,26,34,3,0,3
2,8481462,Mason Morelli,L,VGK,28,14,3,0,3
2,8483012,Logan Morrison,C,SEA,22,38,2,1,3
2,8479638,Justin Brazeau,R,BOS,26,35,2,1,3
2,8481543,Nikita Alexandrov,C,STL,24,23,2,1,3
2,8480844,Grigori Denisenko,L,VGK,24,27,2,1,3
2,8478874,Adam Gaudette,C,OTT,28,38,1,2,3
2,8481679,Maxence Guenette,D,OTT,23,23,1,2,3
2,8481237,Kyle MacLean,C,NYI,25,24,1,2,3
2,8478477,Mitchell Stephens,C,SEA,27,18,1,2,3
2,8477073,Kurtis MacDermid,L,NJD,30,31,1,2,3
2,8481578,Graeme Clarke,R,MIN,23,13,1,2,3
2,8482061,Brandon Biro,L,SEA,26,12,1,2,3
2,8480890,Jan Jenik,R,OTT,24,33,0,3,3
2,8477149,Scott Sabourin,R,SJS,32,16,0,3,3
2,8475755,Alexander Petrovic,D,DAL,32,25,0,3,3
2,8482165,Yan Kuznetsov,D,CGY,22,19,0,3,3
2,8480267,Sammy Walker,C,MIN,25,21,0,3,3
2,8481806,Louis Crevier,D,CHI,23,8,2,0,2
2,8482088,Justin Sourdif,R,FLA,22,18,2,0,2
2,8481043,Cole Koepke,L,BOS,26,16,1,1,2
2,8479362,Riley Tufte,L,BOS,26,17,1,1,2
2,8481056,Spencer Stastney,D,NSH,24,41,1,1,2
2,8481593,Jayden Struble,D,MTL,23,19,1,1,2
2,8483471,Brad Lambert,C,WPG,31,8,1,1,2
2,8481422,Jacob Lucchini,C,NSH,29,25,1,1,2
2,8477462,Robert Hagg,D,VGK,29,30,1,1,2
2,8479367,William Lockwood,R,FLA,26,16,1,1,2
2,8480823,Alexander Alexeyev,D,WSH,25,14,1,1,2
2,8478854,Ryan Shea,D,PIT,27,7,1,1,2
2,8477320,Anton Blidh,L,NYR,29,18,0,2,2
2,8482460,Matt Rempe,C,NYR,22,11,0,2,2
2,8481699,Aku Raty,R,UTA,23,15,0,2,2
2,8480032,Shane Bowers,C,NJD,25,16,0,2,2
2,8481541,Samuel Bolduc,D,NYI,24,25,0,2,2
2,8480084,Nick DeSimone,D,NJD,30,11,0,2,2
2,8482172,Landon Slaggert,L,CHI,22,25,0,2,2
2,8479330,Brandon Gignac,C,MTL,27,10,0,2,2
2,8484325,Waltteri Merela,C,TBL,26,22,0,2,2
2,8481065,Angus Crookshank,L,OTT,25,11,0,2,2
2,8480851,Akil Thomas,C,LAK,24,19,1,0,1
2,8483597,Milos Kelemen,L,UTA,25,10,1,0,1
2,8481585,Egor Afanasyev,L,SJS,23,12,1,0,1
2,8482147,Jean-Luc Foudy,C,COL,22,26,1,0,1
2,8482476,Emil Heineman,L,MTL,23,8,1,0,1
2,8482201,Gage Goncalves,C,TBL,23,13,1,0,1
2,8475413,Justin Dowling,C,NJD,34,12,1,0,1
2,8480245,Olle Lycksell,R,PHI,25,32,0,1,1
2,8477244,Chad Ruhwedel,D,NYR,34,29,0,1,1
2,8483512,Matt Savoie,C,EDM,20,31,0,1,1
2,8478011,Louie Belpedio,D,PHI,28,7,0,1,1
2,8483920,Pierrick Dube,R,WSH,23,3,0,1,1
2,8484258,Sam Malinski,D,COL,26,20,0,1,1
2,8477971,Andreas Englund,D,LAK,28,31,0,1,1
2,8477541,Dakota Mermis,D,TOR,30,8,0,1,1
2,8474062,Riley Nash,C,NYR,35,15,0,1,1
2,8483398,Declan Carlile,D,TBL,31,8,0,1,1
2,8477993,Justin Kirkland,C,CGY,28,8,0,1,1
2,8484255,Jason Polin,R,COL,25,6,0,1,1
2,8483567,Georgii Merkulov,C,BOS,24,11,0,1,1
2,8481024,Linus Karlsson,C,VAN,25,6,0,1,1
2,8475795,Dylan McIlrath,D,WSH,32,19,0,1,1
2,8483407,Brandon Scanlin,D,NYR,25,8,0,1,1
2,8482197,Adam Raska,R,MIN,23,10,0,1,1
2,8481206,John Ludvig,D,PIT,24,9,0,1,1
2,8483489,Fraser Minten,C,TOR,31,14,0,1,1
2,8478881,Brett Seney,L,CHI,28,9,0,1,1
2,8483531,Brian Halonen,L,NJD,25,4,0,1,1
2,8483549,Lucas Condotta,L,MTL,27,25,0,0,0
2,8481564,Ryan Johnson,D,BUF,23,15,0,0,0
2,8482250,Callahan Burke,C,VGK,27,15,0,0,0
2,8484304,Uvis Balinskis,D,FLA,28,11,0,0,0
2,8478446,Glenn Gawdin,C,LAK,27,11,0,0,0
2,8480468,James Hamblin,L,EDM,25,16,0,0,0
2,8482102,Vasily Ponomarev,C,PIT,22,19,0,0,0
2,8480075,Cameron Crotty,D,MIN,25,8,0,0,0
2,8482126,Emil Andrae,D,PHI,31,4,0,0,0
2,8482162,Roby Jarventie,L,EDM,22,12,0,0,0
2,8481006,Tyler Tucker,D,STL,24,22,0,0,0
2,8481719,Maxwell Crozier,D,TBL,24,18,0,0,0
2,8476323,Max McCormick,L,SEA,32,3,0,0,0
2,8480874,Adam Ginning,D,PHI,24,6,0,0,0
2,8482787,Nikita Chibrikov,R,WPG,31,10,0,0,0
2,8479321,Lucas Johansen,D,,27,0,0,0,0
2,8470794,Joe Pavelski,C,,40,0,0,0,0
2,8477950,Tony DeAngelo,D,,29,0,0,0,0
2,8471218,Blake Wheeler,R,,38,0,0,0,0
2,8475197,Tyson Barrie,D,,33,0,0,0,0
2,8475744,Evgeny Kuznetsov,C,,32,0,0,0,0
2,8474037,James van Riemsdyk,L,,35,0,0,0,0
2,8474602,Justin Schultz,D,,34,0,0,0,0
2,8482222,Alexander Barabanov,L,,30,0,0,0,0
2,8474157,Max Pacioretty,L,,36,0,0,0,0
2,8474031,Kevin Shattenkirk,D,,35,0,0,0,0
2,8480884,Calen Addison,D,,24,0,0,0,0
2,8480008,Adam Ruzicka,C,,25,0,0,0,0
2,8475906,John Klingberg,D,,32,0,0,0,0
2,8476884,Derrick Pouliot,D,,30,0,0,0,0
2,8476919,Chris Tierney,C,,30,0,0,0,0
2,8479415,Michael McLeod,C,,26,0,0,0,0
2,8474884,Mike Hoffman,C,,35,0,0,0,0
2,8478104,Sammy Blais,L,,28,0,0,0,0
2,8474870,Tyler Johnson,C,,34,0,0,0,0
2,8481591,Sam Poulin,R,,23,0,0,0,0
2,8479977,Kailer Yamamoto,R,,26,0,0,0,0
2,8476393,Nick Cousins,C,,31,0,0,0,0
2,8479376,Victor Mete,D,,26,0,0,0,0
2,8476871,Tanner Pearson,L,,32,0,0,0,0
2,8471274,Alex Goligoski,D,,39,0,0,0,0
2,8481058,Jesse Ylönen,R,,25,0,0,0,0
2,8477464,Nic Petan,C,,29,0,0,0,0
2,8473449,Kyle Okposo,R,,36,0,0,0,0
2,8480216,Jacob Peterson,C,,25,0,0,0,0
2,8479346,Dillon Dube,C,,26,0,0,0,0
2,8470966,Mark Giordano,D,,41,0,0,0,0
2,8480821,Filip Zadina,R,,25,0,0,0,0
2,8476907,Mackenzie MacEachern,L,,30,0,0,0,0
2,8478430,Oliver Kylington,D,,27,0,0,0,0
2,8479514,Rem Pitlick,C,,27,0,0,0,0
2,8478099,Kevin Labanc,R,,29,0,0,0,0
2,8482241,Radim Zohorna,L,,28,0,0,0,0
2,8474040,Sam Gagner,C,,35,0,0,0,0
2,8475164,Jakob Silfverberg,R,,34,0,0,0,0
2,8475752,Tyler Pitlick,C,,33,0,0,0,0
2,8479984,Cal Foote,D,,26,0,0,0,0
2,8478495,Denis Gurianov,R,,27,0,0,0,0
2,8479533,Joona Koppanen,L,,26,0,0,0,0
2,8479458,Nikita Zaitsev,D,,33,0,0,0,0
2,8471699,Andrew Cogliano,C,,37,0,0,0,0
2,8470604,Jeff Carter,C,,39,0,0,0,0
2,8477330,Dominik Kubalik,L,,29,0,0,0,0
2,8477944,Jakub Vrana,L,,28,0,0,0,0
2,8478904,Steven Lorentz,C,,28,0,0,0,0
2,8471686,Marc Staal,D,,37,0,0,0,0
2,8478512,Austin Czarnik,C,,32,0,0,0,0
2,8470610,Zach Parise,L,,40,0,0,0,0
2,8473504,Cal Clutterbuck,R,,37,0,0,0,0
2,8474009,Nick Bonino,C,,36,0,0,0,0
2,8477454,Adam Erne,L,,29,0,0,0,0
2,8477126,Jayson Megna,C,,34,0,0,0,0
2,8473473,Milan Lucic,L,,36,0,0,0,0
2,8478067,Oskar Lindblom,L,,28,0,0,0,0
2,8475825,Jani Hakanpää,D,,32,0,0,0,0
2,8479383,Boris Katchouk,L,,26,0,0,0,0
2,8478400,Colin White,C,,27,0,0,0,0
2,8477846,Ryan Carpenter,C,,33,0,0,0,0
2,8477930,Pierre-Edouard Bellemare,L,,39,0,0,0,0
2,8479423,Alex Nylander,L,,26,0,0,0,0
2,8475797,Jarred Tinordi,D,,32,0,0,0,0
2,8481239,Samuel Fagemo,L,,24,0,0,0,0
2,8474618,Marco Scandella,D,,34,0,0,0,0
2,8480853,Liam Foudy,C,,24,0,0,0,0
2,8478028,Fredrik Olofsson,L,,28,0,0,0,0
2,8474145,Robert Bortuzzo,D,,35,0,0,0,0
2,8474709,Matt Martin,L,,35,0,0,0,0
2,8480226,Marián Studenic,R,,26,0,0,0,0
2,8479522,Hardy Haman Aktell,D,WSH,26,0,0,0,0
2,8480274,Philip Kemp,D,EDM,25,1,0,0,0
2,8480184,Gustav Lindstrom,D,,26,0,0,0,0
2,8481077,John Leonard,L,,26,0,0,0,0
2,8479547,Matthew Phillips,R,,26,0,0,0,0
2,8476915,Jujhar Khaira,L,,30,0,0,0,0
2,8481070,Hugh McGing,L,,26,0,0,0,0
2,8483546,Marshall Rifai,D,TOR,26,3,0,0,0
2,8478408,Travis Dermott,D,,28,0,0,0,0
2,8484326,Patrik Koch,D,UTA,28,2,0,0,0
2,8481812,Nikolai Knyzhov,D,,27,0,0,0,0
2,8484321,Nikolas Matinpalo,D,OTT,26,4,0,0,0
2,8480306,Grant Hutton,D,NYI,29,4,0,0,0
2,8475278,Byron Froese,C,,33,0,0,0,0
2,8475766,Austin Watson,L,,32,0,0,0,0
2,8479546,Oskar Steen,C,,26,0,0,0,0
2,8480836,Jonathan Gruden,C,,24,0,0,0,0
2,8481690,Tyler Angle,C,,24,0,0,0,0
2,8480031,Maxime Comtois,L,,25,0,0,0,0
2,8483395,Arshdeep Bains,L,VAN,23,12,0,0,0
2,8483045,Cameron Butler,R,CBJ,31,0,0,0,0
2,8483432,Luca Del Bel Belluz,C,CBJ,31,1,0,0,0
2,8478078,Rourke Chartier,C,,28,0,0,0,0
2,8481016,Ruslan Iskhakov,C,,24,0,0,0,0
2,8481655,Cole Schwindt,R,CGY,23,9,0,0,0
2,8483609,Adam Klapka,R,CGY,24,3,0,0,0
2,8481534,Raphael Lavoie,C,EDM,24,1,0,0,0
2,8484314,Jiri Smejkal,L,,28,0,0,0,0
2,8481726,Adam Edstrom,C,NYR,24,6,0,0,0
2,8478956,Samuel Laberge,L,NJD,27,1,0,0,0
2,8483401,Marc Johnstone,R,PIT,28,2,0,0,0
2,8484259,Ondrej Pavel,C,COL,31,5,0,0,0
2,8480776,Sheldon Rempal,R,,29,0,0,0,0
2,8478147,Bokondji Imama,L,PIT,28,2,0,0,0
2,8475780,Chris Wagner,R,COL,33,9,0,0,0
3,8476453,Nikita Kucherov,R,TBL,31,82,45,101,146
3,8477492,Nathan MacKinnon,C,COL,29,82,59,74,133
3,8479318,Auston Matthews,C,TOR,27,81,68,60,128
3,8478402,Connor McDavid,C,EDM,27,78,29,99,128
3,8478864,Kirill Kaprizov,L,MIN,27,78,59,63,122
3,8477939,William Nylander,R,TOR,28,80,47,74,121
3,8477956,David Pastrnak,R,BOS,28,80,57,62,119
3,8478420,Mikko Rantanen,R,COL,28,82,53,66,119
3,8479314,Matthew Tkachuk,L,FLA,27,80,34,79,113
3,8481559,Jack Hughes,C,NJD,23,77,40,70,110
3,8477934,Leon Draisaitl,C,EDM,29,81,43,59,102
3,8478550,Artemi Panarin,L,NYR,33,77,29,70,99
3,8480027,Jason Robertson,L,DAL,25,81,39,59,98
3,8480023,Robert Thomas,C,STL,25,75,31,65,96
3,8478401,Pavel Zacha,C,BOS,27,76,33,60,93
3,8477933,Sam Reinhart,C,FLA,29,78,45,47,92
3,8480002,Nico Hischier,C,NJD,25,74,38,54,92
3,8479407,Jesper Bratt,L,NJD,26,79,30,62,92
3,8476468,J.T. Miller,C,VAN,31,78,32,58,90
3,8478010,Brayden Point,C,TBL,28,82,44,45,89
3,8477493,Aleksander Barkov,C,FLA,29,78,28,61,89
3,8471675,Sidney Crosby,C,PIT,37,66,39,49,88
3,8476346,Johnny Gaudreau,L,CBJ,31,72,25,63,88
3,8480801,Brady Tkachuk,L,OTT,25,81,41,45,86
3,8479420,Tage Thompson,C,BUF,27,78,46,38,84
3,8475172,Nazem Kadri,C,CGY,34,80,34,50,84
3,8477501,Valeri Nichushkin,R,COL,29,82,29,55,84
3,8475913,Mark Stone,R,VGK,32,79,25,59,84
3,8477946,Dylan Larkin,C,DET,28,80,41,42,83
3,8478439,Travis Konecny,R,PHI,27,77,38,45,83
3,8478398,Kyle Connor,L,WPG,28,75,35,48,83
3,8475166,John Tavares,C,TOR,34,82,33,50,83
3,8475184,Chris Kreider,L,NYR,33,75,57,25,82
3,8474564,Steven Stamkos,C,NSH,34,78,45,37,82
3,8481557,Matt Boldy,L,MIN,23,76,35,46,81
3,8482116,Tim Stützle,C,OTT,22,79,32,49,81
3,8480800,Quinn Hughes,D,VAN,25,73,13,68,81
3,8478440,Dylan Strome,C,WSH,27,68,33,47,80
3,8484144,Connor Bedard,C,CHI,19,67,26,54,80
3,8476459,Mika Zibanejad,C,NYR,31,79,26,54,80
3,8478445,Mathew Barzal,C,NYI,27,79,24,56,80
3,8478414,Timo Meier,R,NJD,28,76,40,39,79
3,8479343,Clayton Keller,R,UTA,26,74,36,43,79
3,8477504,Josh Morrissey,D,WPG,29,78,13,66,79
3,8482078,Lucas Raymond,L,DET,22,79,35,43,78
3,8476887,Filip Forsberg,L,NSH,30,78,34,44,78
3,8479337,Alex DeBrincat,R,DET,27,82,35,42,77
3,8482109,Alexis Lafrenière,L,NYR,23,78,35,42,77
3,8477404,Jake Guentzel,C,TBL,30,82,38,38,76
3,8481540,Cole Caufield,R,MTL,23,76,35,40,75
3,8474141,Patrick Kane,R,DET,36,80,27,48,75
3,8476456,Jonathan Huberdeau,C,CGY,31,78,20,55,75
3,8478427,Sebastian Aho,C,CAR,27,73,35,39,74
3,8474600,Roman Josi,D,NSH,34,76,11,63,74
3,8471215,Evgeni Malkin,C,PIT,38,75,32,41,73
3,8481068,Yegor Sharangovich,C,CGY,26,78,38,34,72
3,8476454,Ryan Nugent-Hopkins,C,EDM,31,77,30,42,72
3,8478460,Zach Werenski,D,CBJ,27,79,18,54,72
3,8478449,Roope Hintz,C,DAL,28,81,37,34,71
3,8479675,Trevor Moore,L,LAK,29,81,36,35,71
3,8476539,Jonathan Marchessault,R,NSH,34,74,33,38,71
3,8471214,Alex Ovechkin,L,WSH,39,71,31,40,71
3,8480069,Cale Makar,D,COL,26,73,22,49,71
3,8479542,Brandon Hagel,L,TBL,26,82,20,51,71
3,8477942,Kevin Fiala,L,LAK,28,80,18,53,71
3,8480036,Miro Heiskanen,D,DAL,25,82,15,56,71
3,8477494,Jonathan Drouin,L,COL,29,80,23,47,70
3,8478493,Joel Eriksson Ek,C,MIN,27,74,29,40,69
3,8479385,Jordan Kyrou,C,STL,26,77,39,29,68
3,8477951,Nick Schmaltz,C,UTA,28,77,28,40,68
3,8480012,Elias Pettersson,C,VAN,26,71,27,41,68
3,8475168,Matt Duchene,C,DAL,33,82,27,41,68
3,8475784,Jeff Skinner,C,EDM,32,77,29,38,67
3,8471685,Anze Kopitar,C,LAK,37,78,19,48,67
3,8479323,Adam Fox,D,NYR,26,71,11,56,67
3,8482740,Wyatt Johnston,C,DAL,21,82,33,33,66
3,8477955,Jared McCann,L,SEA,28,76,30,36,66
3,8475158,Ryan O'Reilly,C,NSH,33,73,22,44,66
3,8475167,Victor Hedman,D,TBL,34,77,15,51,66
3,8480865,Noah Dobson,D,NYI,24,80,11,55,66
3,8477960,Adrian Kempe,R,LAK,28,82,31,34,65
3,8477476,Artturi Lehkonen,L,COL,29,81,26,39,65
3,8476389,Vincent Trocheck,C,NYR,31,74,24,41,65
3,8475692,Mats Zuccarello,R,MIN,37,69,18,47,65
3,8475754,Brock Nelson,C,NYI,33,79,31,33,64
3,8477496,Elias Lindholm,C,BOS,30,78,26,38,64
3,8477451,Ryan Hartman,R,MIN,30,70,26,38,64
3,8479999,Casey Mittelstadt,C,COL,26,82,24,40,64
3,8478975,Mason Marchment,L,DAL,29,81,23,41,64
3,8478403,Jack Eichel,C,VGK,28,76,31,32,63
3,8476460,Mark Scheifele,C,WPG,31,74,27,36,63
3,8480208,Drake Batherson,R,OTT,26,77,27,36,63
3,8478469,Thomas Chabot,D,OTT,27,75,20,43,63
3,8473512,Claude Giroux,R,OTT,36,81,18,45,63
3,8477447,Shea Theodore,D,VGK,29,67,17,46,63
3,8481542,Moritz Seider,D,DET,23,77,5,58,63
3,8474578,Erik Karlsson,D,PIT,34,79,21,41,62
3,8474150,Mikael Backlund,C,CGY,35,76,19,43,62
3,8480015,Owen Tippett,R,PHI,25,78,37,24,61
3,8477940,Nikolaj Ehlers,L,WPG,28,77,22,39,61
3,8474679,Gustav Nyquist,C,NSH,35,70,21,40,61
3,8480803,Evan Bouchard,D,EDM,25,77,15,46,61
3,8480839,Rasmus Dahlin,D,BUF,24,74,10,51,61
3,8482110,Dawson Mercer,C,NJD,23,73,33,27,60
3,8477402,Pavel Buchnevich,L,STL,29,74,18,42,60
3,8475798,Mikael Granlund,C,SJS,32,64,18,42,60
3,8478407,Vince Dunn,D,SEA,28,74,17,43,60
3,8482684,Luke Hughes,D,NJD,21,71,13,47,60
3,8478055,Gustav Forsling,D,FLA,28,70,13,47,60
3,8480018,Nick Suzuki,C,MTL,25,76,24,35,59
3,8482699,Dylan Guenther,R,UTA,21,76,22,37,59
3,8478444,Brock Boeser,R,VAN,27,75,21,38,59
3,8475765,Vladimir Tarasenko,R,DET,33,80,20,39,59
3,8477409,Carter Verhaeghe,C,FLA,29,78,38,20,58
3,8475786,Zach Hyman,L,EDM,32,73,37,21,58
3,8477500,Bo Horvat,C,NYI,29,80,33,25,58
3,8475794,Tyler Seguin,C,DAL,32,81,30,28,58
3,8481528,Dylan Cozens,C,BUF,23,73,24,34,58
3,8473994,Jamie Benn,L,DAL,35,82,24,34,58
3,8483515,Juraj Slafkovsky,L,MTL,20,75,21,37,58
3,8482702,Logan Stankoven,C,DAL,21,82,21,37,58
3,8481581,Thomas Harley,D,DAL,23,82,9,49,58
3,8477935,Sam Bennett,C,FLA,28,77,28,29,57
3,8475810,Bryan Rust,R,PIT,32,70,25,32,57
3,8480830,Andrei Svechnikov,R,CAR,24,67,23,33,56
3,8474563,Drew Doughty,D,LAK,35,70,11,45,56
3,8475726,Tyler Toffoli,C,SJS,32,64,30,25,55
3,8477511,Anthony Mantha,R,CGY,30,75,30,25,55
3,8476881,Tomas Hertl,C,VGK,31,70,24,31,55
3,8477949,Alex Tuch,R,BUF,28,70,21,34,55
3,8476448,William Karlsson,C,VGK,31,74,24,30,54
3,8482745,Mason McTavish,C,ANA,21,70,24,30,54
3,8479400,Pierre-Luc Dubois,L,WSH,26,72,20,34,54
3,8476853,Morgan Rielly,D,TOR,30,66,7,47,54
3,8479425,Filip Hronek,D,VAN,27,73,6,48,54
3,8482093,Seth Jarvis,C,CAR,22,71,24,29,53
3,8478047,Michael Bunting,L,PIT,29,76,23,30,53
3,8476399,Blake Coleman,C,CGY,33,76,23,30,53
3,8478038,Devon Toews,D,COL,30,69,15,38,53
3,8481711,Matias Maccelli,L,UTA,24,78,15,38,53
3,8478873,Troy Terry,R,ANA,27,72,12,41,53
3,8480064,Josh Norris,C,OTT,25,76,30,22,52
3,8474641,Adam Henrique,C,EDM,34,78,24,28,52
3,8481533,Trevor Zegras,C,ANA,23,68,23,29,52
3,8479325,Charlie McAvoy,D,BOS,27,73,11,41,52
3,8476462,Dougie Hamilton,D,NJD,31,71,10,42,52
3,8471724,Kris Letang,D,PIT,37,78,6,46,52
3,8480039,Martin Necas,C,CAR,25,74,25,26,51
3,8474586,Jordan Eberle,R,SEA,34,75,25,26,51
3,8482665,Matty Beniers,C,SEA,22,72,22,29,51
3,8477416,Oliver Bjorkstrand,R,SEA,29,72,18,33,51
3,8476905,Chandler Stephenson,C,SEA,30,75,16,35,51
3,8477346,MacKenzie Weegar,D,CGY,30,74,12,39,51
3,8475745,Charlie Coyle,C,BOS,32,82,21,29,50
3,8477503,Max Domi,C,TOR,29,82,16,34,50
3,8475169,Evander Kane,L,EDM,33,77,24,25,49
3,8483808,Andrei Kuzmenko,L,CGY,28,79,24,25,49
3,8478856,Conor Garland,R,VAN,28,74,23,26,49
3,8473419,Brad Marchand,L,BOS,36,74,22,27,49
3,8476826,Yanni Gourde,C,SEA,33,68,16,33,49
3,8484166,Adam Fantilli,C,CBJ,20,67,19,29,48
3,8473986,Alex Killorn,L,ANA,35,74,25,22,47
3,8478366,Frank Vatrano,R,ANA,30,74,23,24,47
3,8479992,Michael Rasmussen,C,DET,25,78,21,26,47
3,8475768,Jaden Schwartz,C,SEA,32,74,21,26,47
3,8476458,Ryan Strome,C,ANA,31,79,20,27,47
3,8478519,Anthony Cirelli,C,TBL,27,81,17,30,47
3,8476875,Mike Matheson,D,MTL,30,73,11,36,47
3,8480188,Fabian Zetterlund,L,SJS,25,66,25,21,46
3,8482720,Matthew Knies,L,TOR,22,77,17,29,46
3,8478458,Jack Roslovic,C,CAR,27,74,16,30,46
3,8478397,Rasmus Andersson,D,CGY,28,72,14,32,46
3,8470613,Brent Burns,D,CAR,39,76,10,36,46
3,8477456,J.T. Compher,L,DET,29,79,26,19,45
3,8475170,Brayden Schenn,C,STL,33,66,21,24,45
3,8482149,Cole Perfetti,C,WPG,22,70,20,25,45
3,8482097,Jack Quinn,R,BUF,23,68,19,26,45
3,8477497,Sean Monahan,C,CBJ,30,66,14,31,45
3,8474590,John Carlson,D,WSH,34,69,8,37,45
3,8474565,Alex Pietrangelo,D,VGK,34,66,8,37,45
3,8483431,Logan Cooley,C,UTA,20,71,22,22,44
3,8475151,Kyle Palmieri,C,NYI,33,78,21,23,44
3,8476882,Teuvo Teravainen,L,CHI,30,67,20,24,44
3,8477479,Tyler Bertuzzi,L,CHI,29,69,20,24,44
3,8476479,Phillip Danault,C,LAK,31,79,17,27,44
3,8478462,Nicolas Roy,C,VGK,27,76,17,27,44
3,8477986,Brandon Montour,D,SEA,30,69,17,27,44
3,8481596,Shane Pinto,C,OTT,24,76,12,32,44
3,8476438,Brandon Saad,L,STL,32,67,22,21,43
3,8477407,Anthony Duclair,L,NYI,29,78,20,23,43
3,8474102,David Perron,L,OTT,36,79,18,25,43
3,8475753,Justin Faulk,D,STL,32,72,16,27,43
3,8482175,JJ Peterka,R,BUF,22,70,16,27,43
3,8475793,Ryan Johansen,C,PHI,32,76,15,28,43
3,8478542,Evan Rodrigues,C,FLA,31,76,12,31,43
3,8476872,Scott Laughton,C,PHI,30,74,11,32,43
3,8480014,Gabriel Vilardi,C,WPG,25,68,26,16,42
3,8478466,Daniel Sprong,R,VAN,27,70,22,20,42
3,8477429,Andrew Copp,C,DET,30,79,22,20,42
3,8479987,Morgan Geekie,C,BOS,26,76,21,21,42
3,8482667,William Eklund,L,SJS,22,66,17,25,42
3,8477932,Aaron Ekblad,D,FLA,28,73,14,28,42
3,8478233,Andrew Mangiapane,L,WSH,28,72,14,28,42
3,8478472,Mathieu Joseph,R,STL,27,69,9,33,42
3,8476432,Boone Jenner,C,CBJ,31,67,22,19,41
3,8478498,Jake DeBrusk,L,VAN,28,69,21,20,41
3,8475314,Anders Lee,L,NYI,34,79,21,20,41
3,8476483,Rickard Rakell,R,PIT,31,75,20,21,41
3,8476880,Tom Wilson,R,WSH,30,74,18,23,41
3,8484145,Zach Benson,L,BUF,19,68,17,24,41
3,8474149,Evgenii Dadonov,R,DAL,35,78,15,26,41
3,8478042,Viktor Arvidsson,R,EDM,31,69,14,27,41
3,8478438,Tommy Novak,C,NSH,27,70,13,28,41
3,8475714,Calle Jarnkrok,C,TOR,33,77,21,19,40
3,8479525,Ross Colton,C,COL,28,82,19,21,40
3,8484153,Leo Carlsson,C,ANA,20,72,16,24,40
3,8480798,Philipp Kurashev,C,CHI,25,60,12,28,40
3,8477021,Alex Kerfoot,C,UTA,30,71,11,29,40
3,8477964,Ivan Barbashev,C,VGK,29,73,11,29,40
3,8480028,Morgan Frost,C,PHI,25,75,9,31,40
3,8477498,Darnell Nurse,D,EDM,29,65,9,31,40
3,8481546,Cam York,D,PHI,23,72,8,32,40
3,8479410,Mikhail Sergachev,D,UTA,26,65,7,33,40
3,8482705,Cole Sillinger,C,CBJ,21,70,18,21,39
3,8481186,Logan O'Connor,R,COL,28,80,16,23,39
3,8476461,Sean Couturier,C,PHI,32,65,10,29,39
3,8480434,Sean Durzi,D,UTA,26,71,9,30,39
3,8482671,Owen Power,D,BUF,22,75,8,31,39
3,8480873,Rasmus Sandin,D,WSH,24,65,1,38,39
3,8481604,Pavel Dorofeyev,L,VGK,24,70,20,18,38
3,8482159,Tyson Foerster,R,PHI,22,71,18,20,38
3,8478474,Lawson Crouse,L,UTA,27,67,17,21,38
3,8477444,Andre Burakovsky,L,SEA,29,66,14,24,38
3,8480185,Eetu Luostarinen,C,FLA,26,80,14,24,38
3,8478891,Mason Appleton,C,WPG,28,64,12,26,38
3,8477353,Tyler Motte,C,DET,29,74,11,27,38
3,8476906,Shayne Gostisbehere,D,CAR,31,76,5,33,38
3,8481582,Nicholas Robertson,L,TOR,23,74,20,17,37
3,8482475,Yegor Chinakhov,R,CBJ,23,69,15,22,37
3,8474053,Logan Couture,C,SJS,35,69,12,25,37
3,8476923,Damon Severson,D,CBJ,30,79,9,28,37
3,8479351,Sam Steel,C,DAL,26,78,16,20,36
3,8475763,Kevin Hayes,R,PIT,32,74,16,20,36
3,8479591,Michael Eyssimont,C,TBL,28,81,15,21,36
3,8477998,Warren Foegele,L,LAK,28,81,12,24,36
3,8478396,Noah Hanifin,D,VGK,27,62,9,27,36
3,8480878,Nils Lundkvist,D,DAL,24,78,8,28,36
3,8475848,Brendan Gallagher,R,MTL,32,69,23,12,35
3,8481618,Alex Newhook,C,MTL,23,73,19,16,35
3,8477426,Nicholas Paul,L,TBL,29,81,18,17,35
3,8481624,Ilya Mikheyev,R,CHI,30,61,18,17,35
3,8477953,Kasperi Kapanen,R,STL,28,76,15,20,35
3,8482113,Anton Lundell,C,FLA,23,73,13,22,35
3,8482660,Kent Johnson,C,CBJ,22,67,10,25,35
3,8479345,Jakob Chychrun,D,WSH,26,70,6,29,35
3,8483445,Cutter Gauthier,L,ANA,20,64,6,29,35
3,8482105,Jake Sanderson,D,OTT,22,74,2,33,35
3,8476392,Adam Lowry,C,WPG,31,64,18,16,34
3,8482092,Ridly Greig,C,OTT,22,76,18,16,34
3,8480797,Joel Farabee,L,PHI,24,75,16,18,34
3,8481656,Aliaksei Protas,C,WSH,23,65,14,20,34
3,8475287,Erik Haula,L,NJD,33,73,12,22,34
3,8480113,Alex Iafallo,L,WPG,31,60,9,25,34
3,8480145,Neal Pionk,D,WPG,29,75,8,26,34
3,8476854,Hampus Lindholm,D,BOS,30,70,8,26,34
3,8476463,Jonas Brodin,D,MIN,31,79,5,29,34
3,8481560,Arthur Kaliyev,R,LAK,23,79,20,13,33
3,8480829,Jesperi Kotkaniemi,C,CAR,24,69,18,15,33
3,8477947,Sonny Milano,L,WSH,28,62,17,16,33
3,8480220,Noah Cates,L,PHI,25,70,14,19,33
3,8473533,Jordan Staal,C,CAR,36,64,14,19,33
3,8480871,Adam Boqvist,D,FLA,24,70,13,20,33
3,8471698,T.J. Oshie,R,WSH,38,72,13,20,33
3,8477495,Seth Jones,D,CHI,30,65,12,21,33
3,8477425,Miles Wood,L,COL,29,75,12,21,33
3,8475191,Reilly Smith,R,NYR,33,70,10,23,33
3,8476292,Ondrej Palat,L,NJD,33,70,10,23,33
3,8476958,Jaccob Slavin,D,CAR,30,74,8,25,33
3,8483490,Pavel Mintyukov,D,ANA,21,69,8,25,33
3,8480043,Timothy Liljegren,D,TOR,25,71,6,27,33
3,8474715,Cam Atkinson,R,TBL,35,79,20,12,32
3,8478020,Michael Amadio,C,OTT,28,71,16,16,32
3,8475760,Nick Bjugstad,C,UTA,32,74,16,16,32
3,8479365,Trent Frederic,C,BOS,26,76,15,17,32
3,8480009,Eeli Tolvanen,R,SEA,25,73,15,17,32
3,8480813,Joe Veleno,C,DET,24,77,14,18,32
3,8479339,Patrik Laine,L,CBJ,26,63,14,18,32
3,8476897,Oskar Sundqvist,C,STL,30,60,12,20,32
3,8480802,Ryan McLeod,C,BUF,25,68,11,21,32
3,8475218,Mattias Ekholm,D,EDM,34,70,7,25,32
3,8481703,Valtteri Puustinen,R,PIT,25,60,6,26,32
3,8476979,Erik Gustafsson,D,DET,32,72,4,28,32
3,8481554,Kaapo Kakko,R,NYR,23,71,16,15,31
3,8482146,Luke Evangelista,R,NSH,22,70,14,17,31
3,8482124,Quinton Byfield,R,LAK,22,77,12,19,31
3,8477987,Ryan Donato,C,CHI,28,68,12,19,31
3,8476892,Colton Parayko,D,STL,31,70,11,20,31
3,8476902,Esa Lindell,D,DAL,30,80,7,24,31
3,8482122,Brock Faber,D,MIN,22,76,5,26,31
3,8477969,Marcus Pettersson,D,PIT,28,76,5,26,31
3,8482712,Oskar Olausson,R,COL,22,71,4,27,31
3,8478046,Danton Heinen,L,VAN,29,70,21,9,30
3,8475722,Jason Zucker,L,BUF,32,66,18,12,30
3,8475149,Marcus Johansson,L,MIN,34,62,16,14,30
3,8475343,Nic Dowd,C,WSH,34,57,15,15,30
3,8478115,Pierre Engvall,L,NYI,28,76,14,16,30
3,8476925,Colton Sissons,C,NSH,31,70,12,18,30
3,8476960,Andreas Athanasiou,C,CHI,30,57,12,18,30
3,8477919,Frederick Gaudreau,C,MIN,31,59,12,18,30
3,8475193,Tomas Tatar,L,NJD,34,69,11,19,30
3,8476331,Dylan DeMelo,D,WPG,31,73,5,25,30
3,8480459,Pius Suter,C,VAN,28,72,16,13,29
3,8478057,Dakota Joshua,C,VAN,28,64,15,14,29
3,8481535,Nils Hoglander,L,VAN,24,65,15,14,29
3,8483468,Jiri Kulich,C,BUF,20,54,15,14,29
3,8482074,Connor Zary,C,CGY,23,66,14,15,29
3,8480078,Filip Chytil,C,NYR,25,70,13,16,29
3,8476921,Jordan Martinook,L,CAR,32,67,13,16,29
3,8480980,Connor Dewar,C,TOR,25,76,12,17,29
3,8482117,Lukas Reichel,L,CHI,22,55,10,19,29
3,8476457,Adam Larsson,D,SEA,32,70,5,24,29
3,8476792,Torey Krug,D,STL,33,74,4,25,29
3,8480849,Barrett Hayton,C,UTA,24,70,13,15,28
3,8470621,Corey Perry,R,EDM,39,72,12,16,28
3,8477488,Brett Pesce,D,NJD,30,69,12,16,28
3,8481032,Paul Cotter,C,NJD,25,66,11,17,28
3,8480995,Pontus Holmberg,R,TOR,25,73,11,17,28
3,8477979,Nicolas Aube-Kubel,R,BUF,28,63,9,19,28
3,8476927,Teddy Blueger,C,VAN,30,68,8,20,28
3,8474716,Jared Spurgeon,D,MIN,35,75,8,20,28
3,8480144,David Kampf,C,TOR,29,73,8,20,28
3,8473507,Jeff Petry,D,DET,37,78,7,21,28
3,8475171,Oliver Ekman-Larsson,D,TOR,33,68,5,23,28
3,8476278,Colin Blackwell,C,DAL,31,76,18,9,27
3,8479390,Taylor Raddysh,R,WSH,26,66,16,11,27
3,8480893,Kirill Marchenko,R,CBJ,24,58,15,12,27
3,8482089,Jake Neighbours,L,STL,22,71,15,12,27
3,8479393,Noah Gregor,C,OTT,26,73,15,12,27
3,8481580,Connor McMichael,C,WSH,23,63,14,13,27
3,8479293,Brandon Tanev,L,SEA,33,65,13,14,27
3,8479353,Brett Howden,C,VGK,26,69,12,15,27
3,8478432,Christian Fischer,R,DET,27,76,12,15,27
3,8480855,Jack McBain,C,UTA,24,67,11,16,27
3,8482133,Thomas Bordeleau,C,SJS,22,66,8,19,27
3,8483505,Matthew Poitras,C,BOS,20,76,5,22,27
3,8477989,Christian Dvorak,C,MTL,28,69,5,22,27
3,8480817,K'Andre Miller,D,NYR,24,68,5,22,27
3,8480035,Henri Jokiharju,D,BUF,25,60,4,23,27
3,8477948,Travis Sanheim,D,PHI,28,67,3,24,27
3,8478970,Jalen Chatfield,D,CAR,28,67,3,24,27
3,8478109,Victor Olofsson,L,VGK,29,77,18,8,26
3,8475799,Nino Niederreiter,R,WPG,32,64,17,9,26
3,8482055,Drew O'Connor,L,PIT,26,55,15,11,26
3,8477952,Robby Fabbri,C,ANA,28,58,13,13,26
3,8481577,Philip Tomasino,C,NSH,23,66,11,15,26
3,8473563,Nicklas Backstrom,C,WSH,37,52,10,16,26
3,8475231,Casey Cizikas,C,NYI,33,69,10,16,26
3,8477507,Nikita Zadorov,D,BOS,29,66,10,16,26
3,8478136,Jake Middleton,D,MIN,28,72,9,17,26
3,8476885,Jacob Trouba,D,NYR,30,68,8,18,26
3,8481606,Jordan Spence,D,LAK,23,67,8,18,26
3,8476869,Brady Skjei,D,NSH,30,68,6,20,26
3,8478133,Jake Evans,C,MTL,28,72,6,20,26
3,8476422,Mike Reilly,D,NYI,31,75,4,22,26
3,8474151,Ryan McDonagh,D,TBL,35,77,4,22,26
3,8482245,Artem Zub,D,OTT,29,76,3,23,26
3,8475764,Cam Fowler,D,ANA,33,71,2,24,26
3,8477450,Jason Dickinson,C,CHI,29,59,14,11,25
3,8482101,Danil Gushchin,L,SJS,22,63,14,11,25
3,8476474,Stefan Noesen,R,NJD,31,62,13,12,25
3,8476469,Joel Armia,R,MTL,31,68,9,16,25
3,8475791,Taylor Hall,L,CHI,33,62,8,17,25
3,8478911,Matt Roy,D,WSH,29,68,7,18,25
3,8482111,Justin Barron,D,MTL,23,66,7,18,25
3,8477506,Ryan Pulock,D,NYI,30,78,4,21,25
3,8478507,John Marino,D,UTA,27,68,4,21,25
3,8478500,Ivan Provorov,D,CBJ,27,78,4,21,25
3,8480748,Kiefer Sherwood,L,VAN,29,59,12,12,24
3,8479941,Justin Danforth,R,CBJ,31,59,11,13,24
3,8483565,Nick Blankenburg,D,NSH,26,56,10,14,24
3,8480336,Sean Walker,D,CAR,30,77,8,16,24
3,8475220,Marcus Foligno,L,MIN,33,64,8,16,24
3,8476312,Josh Manson,D,COL,33,69,7,17,24
3,8483499,Liam Ohgren,L,MIN,20,60,6,18,24
3,8482142,Jamie Drysdale,D,PHI,22,63,6,18,24
3,8476931,Jake McCabe,D,TOR,31,69,4,20,24
3,8479976,Juuso Valimaki,D,UTA,26,65,2,22,24
3,8480281,Alexey Toropchenko,R,STL,25,63,14,9,23
3,8478463,Anthony Beauvillier,L,PIT,27,65,13,10,23
3,8476981,Josh Anderson,R,MTL,30,70,13,10,23
3,8476918,Jimmy Vesey,L,NYR,31,71,13,10,23
3,8484203,Bradly Nadeau,L,CAR,19,60,10,13,23
3,8480068,Ryan Poehling,C,PHI,25,70,10,13,23
3,8474189,Lars Eller,C,PIT,35,67,10,13,23
3,8482679,Matt Coronato,R,CGY,22,63,10,13,23
3,8476480,Vladislav Namestnikov,C,WPG,32,64,9,14,23
3,8479316,Luke Kunin,C,SJS,27,63,9,14,23
3,8480003,Jesper Boqvist,C,FLA,26,66,7,16,23
3,8475279,Ben Chiarot,D,DET,33,73,6,17,23
3,8477369,Carson Soucy,D,VAN,30,66,6,17,23
3,8481523,Kirby Dach,C,MTL,23,70,4,19,23
3,8479398,Samuel Girard,D,COL,26,60,4,19,23
3,8476891,Matt Grzelcyk,D,PIT,30,77,3,20,23
3,8477903,Garnet Hathaway,R,PHI,33,71,15,7,22
3,8476374,Sean Kuraly,C,CBJ,31,63,11,11,22
3,8476419,Jean-Gabriel Pageau,C,NYI,32,74,10,12,22
3,8476329,Travis Boyd,C,MIN,31,55,9,13,22
3,8480025,MacKenzie Entwistle,R,FLA,25,60,9,13,22
3,8481553,Bobby Brink,R,PHI,23,55,8,14,22
3,8483524,Shane Wright,C,SEA,20,65,8,14,22
3,8477839,Conor Sheary,L,TBL,32,82,8,14,22
3,8483493,Frank Nazar,C,CHI,20,55,6,16,22
3,8482624,Daniil Miromanov,D,CGY,27,53,6,16,22
3,8477435,Ryan Graves,D,PIT,29,74,5,17,22
3,8478013,Jake Walman,D,SJS,28,75,4,18,22
3,8479982,Conor Timmins,D,TOR,26,62,4,18,22
3,8480049,Dylan Samberg,D,WPG,25,64,4,18,22
3,8480073,Erik Brannstrom,D,COL,25,60,3,19,22
3,8484149,Gavin Brindley,C,CBJ,20,50,9,12,21
3,8483457,Lane Hutson,D,MTL,20,66,8,13,21
3,8481617,Vasily Podkolzin,R,VAN,23,48,8,13,21
3,8477406,Mattias Janmark,C,EDM,32,67,5,16,21
3,8475455,Brenden Dillon,D,NJD,34,65,5,16,21
3,8480246,Nick Perbix,D,TBL,26,72,4,17,21
3,8476917,Adam Pelech,D,NYI,30,76,3,18,21
3,8478851,Alexandre Carrier,D,NSH,28,57,3,18,21
3,8482077,Dylan Holloway,L,EDM,23,59,15,5,20
3,8473453,Trevor Lewis,C,LAK,37,74,10,10,20
3,8481704,Juuso Parssinen,C,NSH,23,50,9,11,20
3,8481517,Brett Leason,R,ANA,25,55,9,11,20
3,8480205,Emil Bemstrom,C,PIT,25,58,8,12,20
3,8480355,Mark Kastelic,C,BOS,25,60,8,12,20
3,8480448,Parker Kelly,L,COL,25,75,8,12,20
3,8481592,Jakob Pelletier,L,CGY,23,44,8,12,20
3,8479996,Cody Glass,C,NSH,25,57,7,13,20
3,8482176,Wyatt Kaiser,D,CHI,22,57,6,14,20
3,8482148,Hendrix Lapierre,C,WSH,22,54,6,14,20
3,8481481,Blake Lizotte,C,PIT,27,66,5,15,20
3,8481014,Alexander Romanov,D,NYI,24,79,4,16,20
3,8475181,Nick Leddy,D,STL,33,65,4,16,20
3,8476467,Jamie Oleksiak,D,SEA,32,64,3,17,20
3,8475790,Erik Gudbranson,D,CBJ,32,79,3,17,20
3,8476879,Cody Ceci,D,EDM,31,69,1,19,20
3,8482259,Bobby McMann,C,TOR,28,70,12,7,19
3,8479368,Max Jones,L,BOS,26,66,11,8,19
3,8483491,Ivan Miroshnichenko,L,WSH,20,54,10,9,19
3,8481524,Bowen Byram,D,BUF,23,51,9,10,19
3,8475855,Jesper Fast,R,CAR,33,62,8,11,19
3,8477446,Michael McCarron,R,NSH,29,58,7,12,19
3,8482749,Joshua Roy,R,MTL,21,60,6,13,19
3,8480806,Isac Lundestrom,C,ANA,25,57,6,13,19
3,8482166,Shakir Mukhamadullin,D,SJS,22,56,5,14,19
3,8480192,Johnathan Kovacevic,D,NJD,27,53,5,14,19
3,8482655,J.J. Moser,D,TBL,24,72,4,15,19
3,8479324,Ryan Lindgren,D,NYR,26,68,4,15,19
3,8481178,Egor Zamula,D,PHI,24,53,4,15,19
3,8477845,Trevor van Riemsdyk,D,WSH,33,59,3,16,19
3,8482073,Braden Schneider,D,NYR,23,62,3,16,19
3,8474673,TJ Brodie,D,CHI,34,66,0,19,19
3,8479619,Michael Carcone,L,UTA,28,60,13,5,18
3,8476934,Brock McGinn,L,ANA,30,49,11,7,18
3,8479671,Mathieu Olivier,R,CBJ,27,50,11,7,18
3,8478413,Jordan Greenway,L,BUF,27,59,9,9,18
3,8473422,Nick Foligno,L,CHI,37,65,8,10,18
3,8480021,Jack Studnicka,C,LAK,25,63,8,10,18
3,8471817,Ryan Reaves,R,TOR,37,65,8,10,18
3,8477478,William Carrier,L,CAR,30,54,6,12,18
3,8481537,Nikita Okhotiuk,D,CGY,24,53,6,12,18
3,8478421,A.J. Greer,L,FLA,28,58,6,12,18
3,8476988,Matt Benning,D,SJS,30,62,5,13,18
3,8475200,Dmitry Orlov,D,CAR,33,66,3,15,18
3,8480222,Sebastian Aho,D,PIT,28,67,3,15,18
3,8479998,Mikey Anderson,D,LAK,25,60,2,16,18
3,8477220,Nate Schmidt,D,FLA,33,66,2,16,18
3,8479661,Tanner Jeannot,L,LAK,27,74,14,3,17
3,8480074,Alexandre Texier,C,STL,25,55,10,7,17
3,8481477,Nico Sturm,C,SJS,29,54,10,7,17
3,8480848,Ty Dellandrea,C,SJS,24,47,9,8,17
3,8479370,Tyson Jost,C,CAR,26,50,8,9,17
3,8477505,Alexander Wennberg,C,SJS,30,42,8,9,17
3,8482809,Jackson Blake,R,CAR,21,54,7,10,17
3,8480252,Cole Guttman,C,CHI,25,44,6,11,17
3,8478569,Noel Acciari,C,PIT,33,55,6,11,17
3,8480796,Martin Fehervary,D,WSH,25,46,5,12,17
3,8482964,Arber Xhekaj,D,MTL,23,59,5,12,17
3,8476429,Scott Mayfield,D,NYI,32,68,4,13,17
3,8480070,Ian Mitchell,D,BOS,25,53,4,13,17
3,8479348,Kale Clague,D,BUF,26,43,3,14,17
3,8476967,Brett Kulak,D,EDM,30,55,3,14,17
3,8482087,Kaiden Guhle,D,MTL,22,61,1,16,17
3,8475718,Justin Holl,D,DET,32,62,1,16,17
3,8478508,Yakov Trenin,C,MIN,27,55,10,6,16
3,8482155,Alex Laferriere,R,LAK,23,67,10,6,16
3,8483482,Tristan Luneau,D,ANA,20,61,9,7,16
3,8479639,Dylan Coghlan,D,WPG,26,60,9,7,16
3,8480289,Morgan Barron,C,WPG,26,59,9,7,16
3,8479439,Jacob MacDonald,D,COL,31,54,9,7,16
3,8476889,Radek Faksa,C,STL,30,56,8,8,16
3,8478043,Sam Lafferty,C,BUF,29,55,8,8,16
3,8478434,Keegan Kolesar,R,VGK,27,63,8,8,16
3,8479066,Ryan Lomberg,L,CGY,30,57,8,8,16
3,8483495,Simon Nemec,D,NJD,20,53,7,9,16
3,8479414,Nathan Bastian,R,NJD,27,50,6,10,16
3,8480762,Eric Robinson,L,CAR,29,63,6,10,16
3,8479980,Nicolas Hague,D,VGK,26,60,4,12,16
3,8477499,Rasmus Ristolainen,D,PHI,30,62,4,12,16
3,8478443,Brandon Carlo,D,BOS,28,54,4,12,16
3,8475188,Brayden McNabb,D,VGK,33,53,4,12,16
3,8481059,Scott Perunovich,D,STL,26,54,3,13,16
3,8482067,Connor Mackey,D,NYR,28,51,3,13,16
3,8480001,Urho Vaakanainen,D,ANA,25,62,3,13,16
3,8479402,Jake Bean,D,CGY,26,63,1,15,16
3,8479369,Andrew Peeke,D,BOS,26,62,1,15,16
3,8478831,Kevin Stenlund,C,UTA,28,57,11,4,15
3,8479336,Carl Grundstrom,R,SJS,27,49,9,6,15
3,8482125,Alexander Holtz,R,VGK,22,72,8,7,15
3,8478585,Derek Ryan,C,EDM,38,61,8,7,15
3,8481601,Simon Holmstrom,R,NYI,23,64,7,8,15
3,8479359,Beck Malenstyn,L,BUF,26,52,7,8,15
3,8476873,Mark Jankowski,C,NSH,30,50,6,9,15
3,8481522,Peyton Krebs,C,BUF,23,58,5,10,15
3,8482737,Zack Bolduc,C,STL,21,57,4,11,15
3,8478840,Will Borgen,D,SEA,28,66,4,11,15
3,8478859,Niko Mikkola,D,FLA,28,58,4,11,15
3,8478178,Darren Raddysh,D,TBL,28,64,3,12,15
3,8479371,Dante Fabbro,D,NSH,26,60,3,12,15
3,8480950,Ilya Lyubushkin,D,DAL,30,77,2,13,15
3,8478416,Erik Cernak,D,TBL,27,72,2,13,15
3,8474567,Zach Bogosian,D,MIN,34,60,2,13,15
3,8482634,Alex Steeves,C,TOR,25,62,1,14,15
3,8480860,Kevin Bahl,D,CGY,24,60,1,14,15
3,8480727,Zach Whitecloud,D,VGK,28,46,1,14,15
3,8479983,Mario Ferraro,D,SJS,26,69,0,15,15
3,8475235,Nicolas Deslauriers,L,PHI,33,53,9,5,14
3,8480835,Jack Drury,C,CAR,24,52,7,7,14
3,8479718,Alex Barré-Boulet,C,MTL,27,51,7,7,14
3,8481641,Joel Kiviranta,L,COL,28,71,7,7,14
3,8477392,Hudson Fasching,R,NYI,29,63,6,8,14
3,8474034,Pat Maroon,L,CHI,36,50,6,8,14
3,8482062,Cole Smith,L,NSH,29,55,6,8,14
3,8481518,Nolan Foote,L,NJD,24,40,6,8,14
3,8481013,Jonatan Berggren,R,DET,24,64,6,8,14
3,8477573,Nathan Walker,L,STL,30,60,6,8,14
3,8480011,Klim Kostin,C,SJS,25,45,5,9,14
3,8476858,Phillip Di Giuseppe,L,VAN,31,49,5,9,14
3,8479291,Kevin Rooney,C,CGY,31,52,5,9,14
3,8478882,Vladislav Gavrikov,D,LAK,29,72,4,10,14
3,8479328,Julien Gauthier,R,NYI,27,61,4,10,14
3,8481167,Brayden Pachal,D,CGY,25,43,4,10,14
3,8482859,Zack Ostapchuk,C,OTT,21,57,3,11,14
3,8481441,Joe Snively,C,DET,28,56,3,11,14
3,8476525,Colin Miller,D,WPG,32,57,3,11,14
3,8482192,Isaak Phillips,D,CHI,23,48,2,12,14
3,8481019,David Gustafsson,C,WPG,24,49,2,12,14
3,8481716,Dmitri Voronkov,L,CBJ,24,48,11,2,13
3,8480441,Trey Fix-Wolansky,R,CBJ,25,39,9,4,13
3,8482079,Marco Rossi,C,MIN,23,61,8,5,13
3,8480789,Oliver Wahlstrom,R,NYI,24,70,8,5,13
3,8476442,Matt Nieto,L,PIT,32,47,8,5,13
3,8479315,Joey Anderson,R,CHI,26,52,7,6,13
3,8475225,Craig Smith,C,CHI,35,59,7,6,13
3,8476822,Luke Glendening,C,TBL,35,78,7,6,13
3,8477508,Curtis Lazar,C,NJD,29,63,6,7,13
3,8482807,Ethan Del Mastro,D,CHI,21,51,5,8,13
3,8477938,Haydn Fleury,D,WPG,28,41,5,8,13
3,8481521,Ronnie Attard,D,PHI,25,54,4,9,13
3,8479378,Logan Stanley,D,WPG,26,44,4,9,13
3,8476994,Vinnie Hinostroza,C,NSH,30,44,4,9,13
3,8478452,Caleb Jones,D,LAK,27,58,2,11,13
3,8479543,Michael Pezzetta,L,MTL,26,58,2,11,13
3,8480807,Mattias Samuelsson,D,BUF,24,53,0,13,13
3,8480058,Pierre-Olivier Joseph,D,STL,25,51,0,13,13
3,8482157,Will Cuylle,L,NYR,22,61,8,4,12
3,8478424,Jansen Harkins,C,ANA,27,45,7,5,12
3,8479520,Brandon Duhaime,R,WSH,27,51,6,6,12
3,8482744,James Malatesta,L,CBJ,21,36,6,6,12
3,8481751,Lukas Rousek,R,BUF,25,33,6,6,12
3,8479344,Jesse Puljujarvi,R,PIT,26,50,6,6,12
3,8482666,Scott Morrow,D,CAR,22,56,6,6,12
3,8481093,Rafael Harvey-Pinard,L,MTL,25,50,5,7,12
3,8481532,Alex Turcotte,C,LAK,23,46,5,7,12
3,8474574,Tyler Myers,D,VAN,34,74,4,8,12
3,8482803,Olen Zellweger,D,ANA,21,64,4,8,12
3,8474568,Luke Schenn,D,NSH,35,61,4,8,12
3,8477931,Tomas Nosek,L,FLA,32,59,4,8,12
3,8481028,Martin Pospisil,C,CGY,25,51,4,8,12
3,8477034,Jaycob Megna,D,FLA,32,46,3,9,12
3,8483466,Kevin Korchinski,D,CHI,20,49,3,9,12
3,8470600,Ryan Suter,D,STL,39,66,2,10,12
3,8475208,Brian Dumoulin,D,ANA,33,61,2,10,12
3,8481708,Zac Jones,D,NYR,24,53,2,10,12
3,8482095,Tyler Kleven,D,OTT,22,43,2,10,12
3,8474013,Ian Cole,D,UTA,35,54,2,10,12
3,8481161,Jake Christiansen,D,CBJ,25,54,5,6,11
3,8481147,Reese Johnson,C,MIN,26,37,4,7,11
3,8476952,Dominic Toninato,C,WPG,30,40,4,7,11
3,8479442,Troy Stecher,D,EDM,30,62,4,7,11
3,8484911,Collin Graf,R,SJS,22,38,3,8,11
3,8475233,David Savard,D,MTL,34,61,2,9,11
3,8476473,Connor Murphy,D,CHI,31,48,2,9,11
3,8471709,Marc-Edouard Vlasic,D,SJS,37,57,2,9,11
3,8480887,Jordan Harris,D,MTL,24,53,2,9,11
3,8475762,Derek Forbort,D,VAN,32,45,2,9,11
3,8479986,Kole Lind,R,DAL,26,49,2,9,11
3,8475324,Nick Jensen,D,OTT,34,70,1,10,11
3,8477365,Connor Clifton,D,BUF,29,47,1,10,11
3,8477851,Jordan Oesterle,D,BOS,32,39,1,10,11
3,8477473,Justin Bailey,R,SJS,29,32,1,10,11
3,8476874,Olli Maatta,D,DET,30,54,0,11,11
3,8479536,Axel Jonsson-Fjallby,L,WPG,26,37,7,3,10
3,8475842,Sam Carrick,C,NYR,32,63,7,3,10
3,8482762,Simon Edvinsson,D,DET,21,54,6,4,10
3,8477015,Connor Brown,R,EDM,30,58,5,5,10
3,8476913,Devin Shore,C,MIN,30,31,5,5,10
3,8480870,Bo Groulx,C,NYR,24,38,4,6,10
3,8482747,Brennan Othmann,L,NYR,21,42,4,6,10
3,8478468,Jeremy Lauzon,D,NSH,27,53,4,6,10
3,8475690,Chris Tanev,D,TOR,35,58,4,6,10
3,8478211,Dryden Hunt,L,CGY,29,52,3,7,10
3,8479026,Philippe Myers,D,TOR,27,49,3,7,10
3,8481609,Vladislav Kolyachonok,D,UTA,23,44,2,8,10
3,8480990,Declan Chisholm,D,MIN,24,43,2,8,10
3,8481556,John Beecher,C,BOS,23,37,2,8,10
3,8481056,Spencer Stastney,D,NSH,24,47,2,8,10
3,8478399,Jonas Siegenthaler,D,NJD,27,54,1,9,10
3,8480172,Jan Rutta,D,SJS,34,55,1,9,10
3,8474090,Brendan Smith,D,DAL,35,76,1,9,10
3,8481598,Philip Broberg,D,EDM,23,54,1,9,10
3,8475177,Calvin de Haan,D,COL,33,45,1,9,10
3,8476878,Zemgus Girgensons,L,TBL,30,79,7,2,9
3,8482730,Brandt Clarke,D,LAK,21,44,5,4,9
3,8483630,Pavol Regenda,L,ANA,25,29,4,5,9
3,8482141,Lukas Cormier,D,VGK,22,32,3,6,9
3,8478451,Ethan Bear,D,WSH,27,50,3,6,9
3,8479249,Andrew Poturalski,C,SJS,30,30,3,6,9
3,8479985,Cale Fleury,D,SEA,26,29,3,6,9
3,8481122,Simon Benoit,D,TOR,26,40,2,7,9
3,8480196,Jacob Bryson,D,BUF,27,54,2,7,9
3,8481568,Alex Vlasic,D,CHI,23,53,1,8,9
3,8471677,Jack Johnson,D,CBJ,37,70,1,8,9
3,8484254,Akito Hirose,D,VAN,25,29,1,8,9
3,8482451,Mikael Pyyhtia,L,CBJ,23,39,0,9,9
3,8480834,Ty Emberson,D,SJS,24,46,0,9,9
3,8482659,Josh Doan,R,UTA,22,54,6,2,8
3,8481754,Nikita Nesterenko,C,ANA,23,30,6,2,8
3,8482153,Brendan Brisson,C,VGK,23,33,4,4,8
3,8481599,Victor Soderstrom,D,UTA,23,48,3,5,8
3,8478017,Mark Friedman,D,VAN,29,33,3,5,8
3,8480292,Carson Meyer,R,ANA,27,36,3,5,8
3,8483763,Maksymilian Szuber,D,UTA,22,32,2,6,8
3,8482145,Mavrik Bourque,C,DAL,22,51,2,6,8
3,8477887,Patrick Brown,C,BOS,32,38,2,6,8
3,8477018,Ben Hutton,D,VGK,31,47,1,7,8
3,8475750,Jon Merrill,D,MIN,32,60,1,7,8
3,8479372,Josh Mahura,D,SEA,26,51,1,7,8
3,8477335,Kyle Burroughs,D,LAK,29,45,1,7,8
3,8482751,Ryan Winterton,C,SEA,21,35,1,7,8
3,8482516,Matthew Kessel,D,STL,24,28,1,7,8
3,8475958,Michael Sgarbossa,C,WSH,32,25,0,8,8
3,8475462,Radko Gudas,D,ANA,34,67,0,8,8
3,8478450,Parker Wotherspoon,D,BOS,27,37,0,8,8
3,8481789,Tye Kartye,L,SEA,23,41,5,2,7
3,8479944,Zach Aston-Reese,C,VGK,30,47,5,2,7
3,8481422,Jacob Lucchini,C,NSH,29,21,5,2,7
3,8483397,Marc McLaughlin,C,BOS,25,33,4,3,7
3,8476867,Brendan Gaunce,C,MIN,30,37,4,3,7
3,8477962,Brendan Lemieux,L,CAR,28,30,4,3,7
3,8483012,Logan Morrison,C,SEA,22,31,4,3,7
3,8477462,Robert Hagg,D,VGK,29,20,4,3,7
3,8479379,Givani Smith,R,SJS,26,37,3,4,7
3,8481593,Jayden Struble,D,MTL,23,24,3,4,7
3,8475179,Dmitry Kulikov,D,FLA,34,61,2,5,7
3,8482070,Mitchell Chaffee,R,TBL,26,53,2,5,7
3,8484258,Sam Malinski,D,COL,26,24,2,5,7
3,8481701,Santeri Hatakka,D,NJD,23,37,1,6,7
3,8477384,Josh Brown,D,EDM,30,40,1,6,7
3,8477810,Joel Hanley,D,CGY,33,28,0,7,7
3,8482652,Walker Duehr,R,CGY,27,40,4,2,6
3,8483570,Ben Meyers,C,SEA,26,33,4,2,6
3,8479638,Justin Brazeau,R,BOS,26,43,4,2,6
3,8476624,Barclay Goodrow,C,SJS,31,49,3,3,6
3,8479981,Jonah Gadjovich,L,FLA,26,42,3,3,6
3,8484287,Cole McWard,D,VAN,23,21,3,3,6
3,8481679,Maxence Guenette,D,OTT,23,32,3,3,6
3,8480157,Calle Rosen,D,COL,30,38,2,4,6
3,8481527,Kaedan Korczak,D,VGK,23,39,2,4,6
3,8479968,Vinni Lettieri,C,BOS,29,46,2,4,6
3,8477070,Liam O'Brien,C,UTA,30,61,2,4,6
3,8480845,Rasmus Kupari,C,WPG,24,45,2,4,6
3,8479320,Max Lajoie,D,SEA,27,22,2,4,6
3,8482496,Nils Aman,C,VAN,24,35,2,4,6
3,8482784,Zach Dean,C,STL,21,40,2,4,6
3,8478874,Adam Gaudette,C,OTT,28,40,2,4,6
3,8483549,Lucas Condotta,L,MTL,27,27,2,4,6
3,8480891,Michael Kesselring,D,UTA,24,44,1,5,6
3,8480879,Jacob Bernard-Docker,D,OTT,24,50,1,5,6
3,8481567,Henry Thrun,D,SJS,23,45,1,5,6
3,8482118,Sam Colangelo,R,ANA,23,20,1,5,6
3,8481600,Tobias Bjornfot,D,FLA,23,38,1,5,6
3,8473446,Erik Johnson,D,PHI,36,42,1,5,6
3,8482858,Ryker Evans,D,SEA,23,32,1,5,6
3,8479772,Zack MacEwen,R,OTT,28,54,3,2,5
3,8478409,Anthony Richard,C,PHI,28,29,3,2,5
3,8482713,Mackie Samoskevich,R,FLA,22,34,3,2,5
3,8477527,Ross Johnston,L,ANA,30,32,3,2,5
3,8478051,Max Willman,C,NJD,29,17,3,2,5
3,8481550,Adam Beckman,L,NJD,23,39,2,3,5
3,8482177,Marat Khusnutdinov,C,MIN,22,26,2,3,5
3,8482061,Brandon Biro,L,SEA,26,17,2,3,5
3,8478881,Brett Seney,L,CHI,28,14,2,3,5
3,8483460,David Jiricek,D,CBJ,21,53,1,4,5
3,8480880,Jakub Lauko,C,MIN,24,33,1,4,5
3,8479991,Jake Leschyshyn,C,NYR,25,34,1,4,5
3,8479419,Brett Murray,L,BUF,26,19,1,4,5
3,8481541,Samuel Bolduc,D,NYI,24,32,1,4,5
3,8482511,Mason Lohrei,D,BOS,23,38,0,5,5
3,8483619,Filip Roos,D,OTT,25,31,0,5,5
3,8482094,Daemon Hunt,D,MIN,22,18,0,5,5
3,8480890,Jan Jenik,R,OTT,24,24,0,5,5
3,8477244,Chad Ruhwedel,D,NYR,34,45,0,5,5
3,8481605,Jackson LaCombe,D,ANA,23,37,3,1,4
3,8481719,Maxwell Crozier,D,TBL,24,28,3,1,4
3,8477380,Jonny Brodzinski,C,NYR,31,42,2,2,4
3,8474612,Travis Hamonic,D,OTT,34,39,2,2,4
3,8479994,Jaret Anderson-Dolan,C,WPG,25,25,2,2,4
3,8480007,Jonas Rondbjerg,R,VGK,25,45,2,2,4
3,8481462,Mason Morelli,L,VGK,28,11,2,2,4
3,8479362,Riley Tufte,L,BOS,26,14,2,2,4
3,8482147,Jean-Luc Foudy,C,COL,22,25,2,2,4
3,8474062,Riley Nash,C,NYR,35,14,2,2,4
3,8478454,Noah Juulsen,D,VAN,27,42,1,3,4
3,8479972,Mason Shaw,C,WPG,26,33,1,3,4
3,8480084,Nick DeSimone,D,NJD,30,19,1,3,4
3,8476441,Joel Edmundson,D,LAK,31,39,0,4,4
3,8479576,Vincent Desharnais,D,VAN,28,36,0,4,4
3,8482201,Gage Goncalves,C,TBL,23,20,0,4,4
3,8477149,Scott Sabourin,R,SJS,32,23,3,0,3
3,8481043,Cole Koepke,L,BOS,26,18,3,0,3
3,8482172,Landon Slaggert,L,CHI,22,20,3,0,3
3,8484325,Waltteri Merela,C,TBL,26,22,3,0,3
3,8481743,Marc Del Gaizo,D,NSH,25,14,2,1,3
3,8477401,John Hayden,C,SEA,29,25,2,1,3
3,8481030,Jack St. Ivany,D,PIT,25,22,2,1,3
3,8479522,Hardy Haman Aktell,D,WSH,26,2,2,1,3
3,8474166,Alec Martinez,D,CHI,37,43,1,2,3
3,8482144,Jack Thompson,D,SJS,22,27,1,2,3
3,8481543,Nikita Alexandrov,C,STL,24,18,1,2,3
3,8481237,Kyle MacLean,C,NYI,25,34,1,2,3
3,8481578,Graeme Clarke,R,MIN,23,11,1,2,3
3,8481806,Louis Crevier,D,CHI,23,12,1,2,3
3,8482088,Justin Sourdif,R,FLA,22,24,1,2,3
3,8480823,Alexander Alexeyev,D,WSH,25,18,1,2,3
3,8475413,Justin Dowling,C,NJD,34,14,1,2,3
3,8483512,Matt Savoie,C,EDM,20,19,1,2,3
3,8478146,Matthew Highmore,C,OTT,28,28,0,3,3
3,8482765,Isak Rosen,R,BUF,21,30,0,3,3
3,8479421,Jacob Moverare,D,LAK,26,14,0,3,3
3,8480245,Olle Lycksell,R,PHI,25,31,0,3,3
3,8482250,Callahan Burke,C,VGK,27,22,0,3,3
3,8477467,Gustav Olofsson,D,SEA,30,15,2,0,2
3,8483597,Milos Kelemen,L,UTA,25,7,2,0,2
3,8476372,Nick Seeler,D,PHI,31,50,1,1,2
3,8482861,Vincent Iorio,D,WSH,22,32,1,1,2
3,8478502,Dennis Gilbert,D,BUF,28,15,1,1,2
3,8482470,Ilya Solovyov,D,CGY,24,24,1,1,2
3,8479587,Rhett Gardner,C,PHI,28,14,1,1,2
3,8480267,Sammy Walker,C,MIN,25,19,1,1,2
3,8483471,Brad Lambert,C,WPG,31,12,1,1,2
3,8479367,William Lockwood,R,FLA,26,21,1,1,2
3,8478011,Louie Belpedio,D,PHI,28,16,1,1,2
3,8482162,Roby Jarventie,L,EDM,22,14,1,1,2
3,8481006,Tyler Tucker,D,STL,24,12,1,1,2
3,8475780,Chris Wagner,R,COL,33,12,1,1,2
3,8478477,Mitchell Stephens,C,SEA,27,16,0,2,2
3,8477073,Kurtis MacDermid,L,NJD,30,26,0,2,2
3,8478854,Ryan Shea,D,PIT,27,13,0,2,2
3,8481699,Aku Raty,R,UTA,23,20,0,2,2
3,8477971,Andreas Englund,D,LAK,28,23,0,2,2
3,8483398,Declan Carlile,D,TBL,31,11,0,2,2
3,8481564,Ryan Johnson,D,BUF,23,20,0,2,2
3,8484304,Uvis Balinskis,D,FLA,28,10,0,2,2
3,8480075,Cameron Crotty,D,MIN,25,9,0,2,2
3,8478021,William Lagesson,D,DET,28,22,1,0,1
3,8482929,Emil Lilleberg,D,TBL,23,19,1,0,1
3,8480844,Grigori Denisenko,L,VGK,24,27,1,0,1
3,8481065,Angus Crookshank,L,OTT,25,12,1,0,1
3,8477541,Dakota Mermis,D,TOR,30,5,1,0,1
3,8482197,Adam Raska,R,MIN,23,7,1,0,1
3,8481206,John Ludvig,D,PIT,24,6,1,0,1
3,8482102,Vasily Ponomarev,C,PIT,22,18,1,0,1
3,8483395,Arshdeep Bains,L,VAN,23,10,1,0,1
3,8481655,Cole Schwindt,R,CGY,23,7,1,0,1
3,8482733,Logan Mailloux,D,MTL,31,29,0,1,1
3,8482460,Matt Rempe,C,NYR,22,7,0,1,1
3,8480032,Shane Bowers,C,NJD,25,10,0,1,1
3,8481585,Egor Afanasyev,L,SJS,23,17,0,1,1
3,8483920,Pierrick Dube,R,WSH,23,6,0,1,1
3,8475795,Dylan McIlrath,D,WSH,32,13,0,1,1
3,8483407,Brandon Scanlin,D,NYR,25,6,0,1,1
3,8478446,Glenn Gawdin,C,LAK,27,9,0,1,1
3,8482126,Emil Andrae,D,PHI,31,6,0,1,1
3,8480874,Adam Ginning,D,PHI,24,7,0,1,1
3,8475755,Alexander Petrovic,D,DAL,32,17,0,0,0
3,8482165,Yan Kuznetsov,D,CGY,22,22,0,0,0
3,8477320,Anton Blidh,L,NYR,29,14,0,0,0
3,8479330,Brandon Gignac,C,MTL,27,14,0,0,0
3,8480851,Akil Thomas,C,LAK,24,14,0,0,0
3,8482476,Emil Heineman,L,MTL,23,6,0,0,0
3,8477993,Justin Kirkland,C,CGY,28,6,0,0,0
3,8484255,Jason Polin,R,COL,25,4,0,0,0
3,8483567,Georgii Merkulov,C,BOS,24,11,0,0,0
3,8481024,Linus Karlsson,C,VAN,25,7,0,0,0
3,8483489,Fraser Minten,C,TOR,31,12,0,0,0
3,8483531,Brian Halonen,L,NJD,25,3,0,0,0
3,8480468,James Hamblin,L,EDM,25,21,0,0,0
3,8476323,Max McCormick,L,SEA,32,5,0,0,0
3,8482787,Nikita Chibrikov,R,WPG,31,4,0,0,0
3,8479321,Lucas Johansen,D,,27,0,0,0,0
3,8470794,Joe Pavelski,C,,40,0,0,0,0
3,8477950,Tony DeAngelo,D,,29,0,0,0,0
3,8471218,Blake Wheeler,R,,38,0,0,0,0
3,8475197,Tyson Barrie,D,,33,0,0,0,0
3,8475744,Evgeny Kuznetsov,C,,32,0,0,0,0
3,8474037,James van Riemsdyk,L,,35,0,0,0,0
3,8474602,Justin Schultz,D,,34,0,0,0,0
3,8482222,Alexander Barabanov,L,,30,0,0,0,0
3,8474157,Max Pacioretty,L,,36,0,0,0,0
3,8474031,Kevin Shattenkirk,D,,35,0,0,0,0
3,8480884,Calen Addison,D,,24,0,0,0,0
3,8480008,Adam Ruzicka,C,,25,0,0,0,0
3,8475906,John Klingberg,D,,32,0,0,0,0
3,8476884,Derrick Pouliot,D,,30,0,0,0,0
3,8476919,Chris Tierney,C,,30,0,0,0,0
3,8479415,Michael McLeod,C,,26,0,0,0,0
3,8474884,Mike Hoffman,C,,35,0,0,0,0
3,8478104,Sammy Blais,L,,28,0,0,0,0
3,8474870,Tyler Johnson,C,,34,0,0,0,0
3,8481591,Sam Poulin,R,,23,0,0,0,0
3,8479977,Kailer Yamamoto,R,,26,0,0,0,0
3,8476393,Nick Cousins,C,,31,0,0,0,0
3,8479376,Victor Mete,D,,26,0,0,0,0
3,8476871,Tanner Pearson,L,,32,0,0,0,0
3,8471274,Alex Goligoski,D,,39,0,0,0,0
3,8481058,Jesse Ylönen,R,,25,0,0,0,0
3,8477464,Nic Petan,C,,29,0,0,0,0
3,8473449,Kyle Okposo,R,,36,0,0,0,0
3,8480216,Jacob Peterson,C,,25,0,0,0,0
3,8479346,Dillon Dube,C,,26,0,0,0,0
3,8470966,Mark Giordano,D,,41,0,0,0,0
3,8480821,Filip Zadina,R,,25,0,0,0,0
3,8476907,Mackenzie MacEachern,L,,30,0,0,0,0
3,8478430,Oliver Kylington,D,,27,0,0,0,0
3,8479514,Rem Pitlick,C,,27,0,0,0,0
3,8478099,Kevin Labanc,R,,29,0,0,0,0
3,8482241,Radim Zohorna,L,,28,0,0,0,0
3,8474040,Sam Gagner,C,,35,0,0,0,0
3,8475164,Jakob Silfverberg,R,,34,0,0,0,0
3,8475752,Tyler Pitlick,C,,33,0,0,0,0
3,8479984,Cal Foote,D,,26,0,0,0,0
3,8478495,Denis Gurianov,R,,27,0,0,0,0
3,8479533,Joona Koppanen,L,,26,0,0,0,0
3,8479458,Nikita Zaitsev,D,,33,0,0,0,0
3,8471699,Andrew Cogliano,C,,37,0,0,0,0
3,8470604,Jeff Carter,C,,39,0,0,0,0
3,8477330,Dominik Kubalik,L,,29,0,0,0,0
3,8477944,Jakub Vrana,L,,28,0,0,0,0
3,8478904,Steven Lorentz,C,,28,0,0,0,0
3,8471686,Marc Staal,D,,37,0,0,0,0
3,8478512,Austin Czarnik,C,,32,0,0,0,0
3,8470610,Zach Parise,L,,40,0,0,0,0
3,8473504,Cal Clutterbuck,R,,37,0,0,0,0
3,8474009,Nick Bonino,C,,36,0,0,0,0
3,8477454,Adam Erne,L,,29,0,0,0,0
3,8477126,Jayson Megna,C,,34,0,0,0,0
3,8473473,Milan Lucic,L,,36,0,0,0,0
3,8478067,Oskar Lindblom,L,,28,0,0,0,0
3,8475825,Jani Hakanpää,D,,32,0,0,0,0
3,8479383,Boris Katchouk,L,,26,0,0,0,0
3,8478400,Colin White,C,,27,0,0,0,0
3,8477846,Ryan Carpenter,C,,33,0,0,0,0
3,8477930,Pierre-Edouard Bellemare,L,,39,0,0,0,0
3,8479423,Alex Nylander,L,,26,0,0,0,0
3,8475797,Jarred Tinordi,D,,32,0,0,0,0
3,8481239,Samuel Fagemo,L,,24,0,0,0,0
3,8474618,Marco Scandella,D,,34,0,0,0,0
3,8480853,Liam Foudy,C,,24,0,0,0,0
3,8478028,Fredrik Olofsson,L,,28,0,0,0,0
3,8474145,Robert Bortuzzo,D,,35,0,0,0,0
3,8474709,Matt Martin,L,,35,0,0,0,0
3,8480226,Marián Studenic,R,,26,0,0,0,0
3,8480274,Philip Kemp,D,EDM,25,0,0,0,0
3,8480184,Gustav Lindstrom,D,,26,0,0,0,0
3,8481077,John Leonard,L,,26,0,0,0,0
3,8479547,Matthew Phillips,R,,26,0,0,0,0
3,8476915,Jujhar Khaira,L,,30,0,0,0,0
3,8481070,Hugh McGing,L,,26,0,0,0,0
3,8483546,Marshall Rifai,D,TOR,26,4,0,0,0
3,8478408,Travis Dermott,D,,28,0,0,0,0
3,8484326,Patrik Koch,D,UTA,28,1,0,0,0
3,8481812,Nikolai Knyzhov,D,,27,0,0,0,0
3,8484321,Nikolas Matinpalo,D,OTT,26,2,0,0,0
3,8480306,Grant Hutton,D,NYI,29,4,0,0,0
3,8475278,Byron Froese,C,,33,0,0,0,0
3,8475766,Austin Watson,L,,32,0,0,0,0
3,8479546,Oskar Steen,C,,26,0,0,0,0
3,8480836,Jonathan Gruden,C,,24,0,0,0,0
3,8481690,Tyler Angle,C,,24,0,0,0,0
3,8480031,Maxime Comtois,L,,25,0,0,0,0
3,8483045,Cameron Butler,R,CBJ,31,0,0,0,0
3,8483432,Luca Del Bel Belluz,C,CBJ,31,1,0,0,0
3,8478078,Rourke Chartier,C,,28,0,0,0,0
3,8481016,Ruslan Iskhakov,C,,24,0,0,0,0
3,8483609,Adam Klapka,R,CGY,24,4,0,0,0
3,8481534,Raphael Lavoie,C,EDM,24,3,0,0,0
3,8484314,Jiri Smejkal,L,,28,0,0,0,0
3,8481726,Adam Edstrom,C,NYR,24,4,0,0,0
3,8478956,Samuel Laberge,L,NJD,27,3,0,0,0
3,8483401,Marc Johnstone,R,PIT,28,0,0,0,0
3,8484259,Ondrej Pavel,C,COL,31,0,0,0,0
3,8480776,Sheldon Rempal,R,,29,0,0,0,0
3,8478147,Bokondji Imama,L,PIT,28,7,0,0,0
