Simulation,PlayerID,Player,Position,Team,Age,Games Played,Goals,Assists,Points
1,8477492,Nathan MacKinnon,C,COL,29,82,50,109,159
1,8476453,Nikita Kucherov,R,TBL,31,82,45,102,147
1,8479318,Auston Matthews,C,TOR,27,82,68,57,125
1,8478402,Connor McDavid,C,EDM,27,82,35,89,124
1,8481559,Jack Hughes,C,NJD,23,82,42,78,120
1,8477934,Leon Draisaitl,C,EDM,29,82,48,70,118
1,8479314,Matthew Tkachuk,L,FLA,27,82,39,75,114
1,8478445,Mathew Barzal,C,NYI,27,82,33,74,107
1,8480800,Quinn Hughes,D,VAN,25,82,19,87,106
1,8477933,Sam Reinhart,C,FLA,29,82,45,60,105
1,8477493,Aleksander Barkov,C,FLA,29,82,30,73,103
1,8477956,David Pastrnak,R,BOS,28,82,49,48,97
1,8478420,Mikko Rantanen,R,COL,28,82,40,57,97
1,8476887,Filip Forsberg,L,NSH,30,82,44,52,96
1,8476468,J.T. Miller,C,VAN,31,82,36,60,96
1,8480027,Jason Robertson,L,DAL,25,82,42,53,95
1,8480002,Nico Hischier,C,NJD,25,82,37,58,95
1,8480012,Elias Pettersson,C,VAN,26,82,36,59,95
1,8480069,Cale Makar,D,COL,26,82,26,68,94
1,8478550,Artemi Panarin,L,NYR,33,82,25,69,94
1,8479420,Tage Thompson,C,BUF,27,82,51,42,93
1,8476454,Ryan Nugent-Hopkins,C,EDM,31,82,29,64,93
1,8476460,Mark Scheifele,C,WPG,31,82,37,54,91
1,8480830,Andrei Svechnikov,R,CAR,24,82,42,48,90
1,8477501,Valeri Nichushkin,R,COL,29,82,43,46,89
1,8478864,Kirill Kaprizov,L,MIN,27,82,35,54,89
1,8481557,Matt Boldy,L,MIN,23,82,38,50,88
1,8477404,Jake Guentzel,C,TBL,30,82,50,36,86
1,8477942,Kevin Fiala,L,LAK,28,82,29,57,86
1,8481523,Kirby Dach,C,MTL,23,82,13,73,86
1,8478449,Roope Hintz,C,DAL,28,82,38,47,85
1,8479407,Jesper Bratt,L,NJD,26,82,34,51,85
1,8478403,Jack Eichel,C,VGK,28,82,41,43,84
1,8482116,Tim Stützle,C,OTT,22,82,36,48,84
1,8477939,William Nylander,R,TOR,28,82,30,54,84
1,8480023,Robert Thomas,C,STL,25,82,20,64,84
1,8474600,Roman Josi,D,NSH,34,82,13,71,84
1,8476539,Jonathan Marchessault,R,NSH,34,82,44,39,83
1,8471675,Sidney Crosby,C,PIT,37,82,37,46,83
1,8476459,Mika Zibanejad,C,NYR,31,82,28,55,83
1,8479323,Adam Fox,D,NYR,26,82,20,63,83
1,8478398,Kyle Connor,L,WPG,28,82,42,40,82
1,8478427,Sebastian Aho,C,CAR,27,82,33,49,82
1,8480801,Brady Tkachuk,L,OTT,25,82,42,39,81
1,8478414,Timo Meier,R,NJD,28,82,37,43,80
1,8478493,Joel Eriksson Ek,C,MIN,27,82,34,46,80
1,8478439,Travis Konecny,R,PHI,27,82,33,47,80
1,8475172,Nazem Kadri,C,CGY,34,82,28,52,80
1,8475184,Chris Kreider,L,NYR,33,82,50,29,79
1,8474564,Steven Stamkos,C,NSH,34,82,34,45,79
1,8480839,Rasmus Dahlin,D,BUF,24,82,21,58,79
1,8475786,Zach Hyman,L,EDM,32,82,41,36,77
1,8475692,Mats Zuccarello,R,MIN,37,82,19,58,77
1,8481540,Cole Caufield,R,MTL,23,82,43,33,76
1,8475166,John Tavares,C,TOR,34,82,36,40,76
1,8475168,Matt Duchene,C,DAL,33,82,32,43,75
1,8476905,Chandler Stephenson,C,SEA,30,82,26,49,75
1,8476346,Johnny Gaudreau,L,CBJ,31,82,20,55,75
1,8478010,Brayden Point,C,TBL,28,82,32,42,74
1,8478440,Dylan Strome,C,WSH,27,82,27,47,74
1,8476389,Vincent Trocheck,C,NYR,31,82,27,47,74
1,8479343,Clayton Keller,R,UTA,26,82,34,39,73
1,8476881,Tomas Hertl,C,VGK,31,82,33,40,73
1,8475158,Ryan O'Reilly,C,NSH,33,82,29,44,73
1,8482093,Seth Jarvis,C,CAR,22,82,35,37,72
1,8477940,Nikolaj Ehlers,L,WPG,28,82,30,42,72
1,8478444,Brock Boeser,R,VAN,27,82,28,44,72
1,8478873,Troy Terry,R,ANA,27,82,25,47,72
1,8478460,Zach Werenski,D,CBJ,27,82,20,52,72
1,8476853,Morgan Rielly,D,TOR,30,82,16,56,72
1,8473512,Claude Giroux,R,OTT,36,82,26,45,71
1,8475167,Victor Hedman,D,TBL,34,82,13,58,71
1,8479542,Brandon Hagel,L,TBL,26,82,33,37,70
1,8479339,Patrik Laine,L,CBJ,26,82,33,37,70
1,8477476,Artturi Lehkonen,L,COL,29,82,32,38,70
1,8477955,Jared McCann,L,SEA,28,82,30,40,70
1,8471215,Evgeni Malkin,C,PIT,38,82,25,45,70
1,8475784,Jeff Skinner,C,EDM,32,82,22,48,70
1,8477447,Shea Theodore,D,VGK,29,82,16,54,70
1,8478407,Vince Dunn,D,SEA,28,82,12,58,70
1,8477500,Bo Horvat,C,NYI,29,82,37,32,69
1,8477409,Carter Verhaeghe,C,FLA,29,82,35,34,69
1,8477960,Adrian Kempe,R,LAK,28,82,33,36,69
1,8475754,Brock Nelson,C,NYI,33,82,32,37,69
1,8474141,Patrick Kane,R,DET,36,82,31,38,69
1,8480803,Evan Bouchard,D,EDM,25,82,19,50,69
1,8477946,Dylan Larkin,C,DET,28,82,33,35,68
1,8474586,Jordan Eberle,R,SEA,34,82,33,35,68
1,8471214,Alex Ovechkin,L,WSH,39,82,27,41,68
1,8475287,Erik Haula,L,NJD,33,82,32,35,67
1,8477494,Jonathan Drouin,L,COL,29,82,28,39,67
1,8479325,Charlie McAvoy,D,BOS,27,82,8,59,67
1,8482109,Alexis Lafrenière,L,NYR,23,82,33,32,65
1,8477949,Alex Tuch,R,BUF,28,82,24,41,65
1,8475798,Mikael Granlund,C,SJS,32,82,18,47,65
1,8476456,Jonathan Huberdeau,C,CGY,31,82,16,49,65
1,8479410,Mikhail Sergachev,D,UTA,26,82,8,57,65
1,8478042,Viktor Arvidsson,R,EDM,31,82,26,38,64
1,8474679,Gustav Nyquist,C,NSH,35,82,20,44,64
1,8473419,Brad Marchand,L,BOS,36,82,19,45,64
1,8474578,Erik Karlsson,D,PIT,34,82,12,52,64
1,8476448,William Karlsson,C,VGK,31,82,24,39,63
1,8476462,Dougie Hamilton,D,NJD,31,82,14,49,63
1,8479675,Trevor Moore,L,LAK,29,82,27,35,62
1,8478401,Pavel Zacha,C,BOS,27,82,26,36,62
1,8473986,Alex Killorn,L,ANA,35,82,25,37,62
1,8482078,Lucas Raymond,L,DET,22,82,20,42,62
1,8476906,Shayne Gostisbehere,D,CAR,31,82,15,47,62
1,8477495,Seth Jones,D,CHI,30,82,11,51,62
1,8477935,Sam Bennett,C,FLA,28,82,30,31,61
1,8477416,Oliver Bjorkstrand,R,SEA,29,82,23,38,61
1,8477932,Aaron Ekblad,D,FLA,28,82,19,42,61
1,8478038,Devon Toews,D,COL,30,82,12,49,61
1,8477951,Nick Schmaltz,C,UTA,28,82,25,35,60
1,8475913,Mark Stone,R,VGK,32,82,16,44,60
1,8476869,Brady Skjei,D,NSH,30,82,14,46,60
1,8481533,Trevor Zegras,C,ANA,23,82,28,31,59
1,8477402,Pavel Buchnevich,L,STL,29,82,23,36,59
1,8480018,Nick Suzuki,C,MTL,25,82,17,42,59
1,8482667,William Eklund,L,SJS,22,82,16,43,59
1,8478396,Noah Hanifin,D,VGK,27,82,15,44,59
1,8475810,Bryan Rust,R,PIT,32,82,36,22,58
1,8474641,Adam Henrique,C,EDM,34,82,26,32,58
1,8480015,Owen Tippett,R,PHI,25,82,24,34,58
1,8477496,Elias Lindholm,C,BOS,30,82,23,35,58
1,8478233,Andrew Mangiapane,L,WSH,28,82,21,37,58
1,8475726,Tyler Toffoli,C,SJS,32,82,28,29,57
1,8478542,Evan Rodrigues,C,FLA,31,82,25,32,57
1,8478856,Conor Garland,R,VAN,28,82,23,34,57
1,8476479,Phillip Danault,C,LAK,31,82,19,38,57
1,8476875,Mike Matheson,D,MTL,30,82,15,42,57
1,8478469,Thomas Chabot,D,OTT,27,82,15,42,57
1,8475169,Evander Kane,L,EDM,33,82,32,24,56
1,8477407,Anthony Duclair,L,NYI,29,82,27,29,56
1,8481528,Dylan Cozens,C,BUF,23,82,20,36,56
1,8482113,Anton Lundell,C,FLA,23,82,20,36,56
1,8479425,Filip Hronek,D,VAN,27,82,17,39,56
1,8479345,Jakob Chychrun,D,WSH,26,82,16,40,56
1,8480865,Noah Dobson,D,NYI,24,82,14,42,56
1,8480208,Drake Batherson,R,OTT,26,82,14,42,56
1,8477504,Josh Morrissey,D,WPG,29,82,13,43,56
1,8477346,MacKenzie Weegar,D,CGY,30,82,13,43,56
1,8475768,Jaden Schwartz,C,SEA,32,82,30,25,55
1,8481068,Yegor Sharangovich,C,CGY,26,82,27,28,55
1,8478366,Frank Vatrano,R,ANA,30,82,26,29,55
1,8473994,Jamie Benn,L,DAL,35,82,21,34,55
1,8483808,Andrei Kuzmenko,L,CGY,28,82,20,35,55
1,8477497,Sean Monahan,C,CBJ,30,82,19,36,55
1,8480036,Miro Heiskanen,D,DAL,25,82,13,42,55
1,8478047,Michael Bunting,L,PIT,29,82,29,25,54
1,8479337,Alex DeBrincat,R,DET,27,82,25,29,54
1,8480039,Martin Necas,C,CAR,25,82,23,31,54
1,8482097,Jack Quinn,R,BUF,23,82,22,32,54
1,8478462,Nicolas Roy,C,VGK,27,82,22,32,54
1,8478975,Mason Marchment,L,DAL,29,82,21,33,54
1,8482665,Matty Beniers,C,SEA,22,82,18,36,54
1,8482684,Luke Hughes,D,NJD,21,82,15,39,54
1,8480064,Josh Norris,C,OTT,25,82,30,23,53
1,8475314,Anders Lee,L,NYI,34,82,29,24,53
1,8476483,Rickard Rakell,R,PIT,31,82,28,25,53
1,8475170,Brayden Schenn,C,STL,33,82,20,33,53
1,8476458,Ryan Strome,C,ANA,31,82,15,38,53
1,8475191,Reilly Smith,R,NYR,33,82,15,38,53
1,8480009,Eeli Tolvanen,R,SEA,25,82,25,27,52
1,8477426,Nicholas Paul,L,TBL,29,82,24,28,52
1,8477479,Tyler Bertuzzi,L,CHI,29,82,23,29,52
1,8479400,Pierre-Luc Dubois,L,WSH,26,82,22,30,52
1,8478474,Lawson Crouse,L,UTA,27,82,22,30,52
1,8482149,Cole Perfetti,C,WPG,22,82,18,34,52
1,8480078,Filip Chytil,C,NYR,25,82,26,25,51
1,8482110,Dawson Mercer,C,NJD,23,82,26,25,51
1,8475794,Tyler Seguin,C,DAL,32,82,25,26,51
1,8481618,Alex Newhook,C,MTL,23,82,24,27,51
1,8475791,Taylor Hall,L,CHI,33,82,18,33,51
1,8482124,Quinton Byfield,R,LAK,22,82,17,34,51
1,8476419,Jean-Gabriel Pageau,C,NYI,32,82,15,36,51
1,8479385,Jordan Kyrou,C,STL,26,82,27,23,50
1,8475760,Nick Bjugstad,C,UTA,32,82,25,25,50
1,8479987,Morgan Geekie,C,BOS,26,82,18,32,50
1,8471685,Anze Kopitar,C,LAK,37,82,16,34,50
1,8474565,Alex Pietrangelo,D,VGK,34,82,12,38,50
1,8480434,Sean Durzi,D,UTA,26,82,9,41,50
1,8475765,Vladimir Tarasenko,R,DET,33,82,29,20,49
1,8477964,Ivan Barbashev,C,VGK,29,82,20,28,48
1,8478133,Jake Evans,C,MTL,28,82,14,34,48
1,8477503,Max Domi,C,TOR,29,82,13,35,48
1,8474563,Drew Doughty,D,LAK,35,82,11,37,48
1,8474590,John Carlson,D,WSH,34,82,9,39,48
1,8481542,Moritz Seider,D,DET,23,82,7,41,48
1,8475764,Cam Fowler,D,ANA,33,82,7,41,48
1,8477444,Andre Burakovsky,L,SEA,29,82,22,25,47
1,8477511,Anthony Mantha,R,CGY,30,82,21,26,47
1,8479999,Casey Mittelstadt,C,COL,26,82,19,28,47
1,8475745,Charlie Coyle,C,BOS,32,82,17,30,47
1,8481596,Shane Pinto,C,OTT,24,82,17,30,47
1,8482720,Matthew Knies,L,TOR,22,82,17,30,47
1,8482745,Mason McTavish,C,ANA,21,82,16,31,47
1,8481711,Matias Maccelli,L,UTA,24,82,12,35,47
1,8480014,Gabriel Vilardi,C,WPG,25,82,26,20,46
1,8475848,Brendan Gallagher,R,MTL,32,82,25,21,46
1,8476432,Boone Jenner,C,CBJ,31,82,22,24,46
1,8477998,Warren Foegele,L,LAK,28,82,20,26,46
1,8476882,Teuvo Teravainen,L,CHI,30,82,17,29,46
1,8480798,Philipp Kurashev,C,CHI,25,82,13,33,46
1,8476958,Jaccob Slavin,D,CAR,30,82,7,39,46
1,8476399,Blake Coleman,C,CGY,33,82,22,23,45
1,8476792,Torey Krug,D,STL,33,82,11,34,45
1,8471724,Kris Letang,D,PIT,37,82,7,38,45
1,8481581,Thomas Harley,D,DAL,23,82,6,39,45
1,8479992,Michael Rasmussen,C,DET,25,82,21,23,44
1,8478458,Jack Roslovic,C,CAR,27,82,17,27,44
1,8478438,Tommy Novak,C,NSH,27,82,14,30,44
1,8476329,Travis Boyd,C,MIN,31,82,14,30,44
1,8476292,Ondrej Palat,L,NJD,33,82,11,33,44
1,8478397,Rasmus Andersson,D,CGY,28,82,8,36,44
1,8481535,Nils Hoglander,L,VAN,24,82,25,18,43
1,8474053,Logan Couture,C,SJS,35,82,24,19,43
1,8477952,Robby Fabbri,C,ANA,28,82,23,20,43
1,8476474,Stefan Noesen,R,NJD,31,82,22,21,43
1,8478498,Jake DeBrusk,L,VAN,28,82,22,21,43
1,8478055,Gustav Forsling,D,FLA,28,82,13,30,43
1,8470613,Brent Burns,D,CAR,39,82,7,36,43
1,8482105,Jake Sanderson,D,OTT,22,82,7,36,43
1,8474150,Mikael Backlund,C,CGY,35,82,19,23,42
1,8478519,Anthony Cirelli,C,TBL,27,82,18,24,42
1,8475151,Kyle Palmieri,C,NYI,33,82,18,24,42
1,8476925,Colton Sissons,C,NSH,31,82,18,24,42
1,8480829,Jesperi Kotkaniemi,C,CAR,24,82,16,26,42
1,8482740,Wyatt Johnston,C,DAL,21,82,16,26,42
1,8480028,Morgan Frost,C,PHI,25,82,14,28,42
1,8477021,Alex Kerfoot,C,UTA,30,82,13,29,42
1,8480802,Ryan McLeod,C,BUF,25,82,13,29,42
1,8477987,Ryan Donato,C,CHI,28,82,23,18,41
1,8480849,Barrett Hayton,C,UTA,24,82,23,18,41
1,8471698,T.J. Oshie,R,WSH,38,82,21,20,41
1,8482699,Dylan Guenther,R,UTA,21,82,21,20,41
1,8477451,Ryan Hartman,R,MIN,30,82,19,22,41
1,8480459,Pius Suter,C,VAN,28,82,19,22,41
1,8478046,Danton Heinen,L,VAN,29,82,18,23,41
1,8480797,Joel Farabee,L,PHI,24,82,17,24,41
1,8480185,Eetu Luostarinen,C,FLA,26,82,12,29,41
1,8474716,Jared Spurgeon,D,MIN,35,82,11,30,41
1,8479525,Ross Colton,C,COL,28,82,23,17,40
1,8476880,Tom Wilson,R,WSH,30,82,23,17,40
1,8484166,Adam Fantilli,C,CBJ,20,82,22,18,40
1,8475799,Nino Niederreiter,R,WPG,32,82,18,22,40
1,8475714,Calle Jarnkrok,C,TOR,33,82,17,23,40
1,8477986,Brandon Montour,D,SEA,30,82,16,24,40
1,8477919,Frederick Gaudreau,C,MIN,31,82,16,24,40
1,8475763,Kevin Hayes,R,PIT,32,82,14,26,40
1,8474102,David Perron,L,OTT,36,82,16,23,39
1,8475149,Marcus Johansson,L,MIN,34,82,16,23,39
1,8484144,Connor Bedard,C,CHI,19,82,16,23,39
1,8476885,Jacob Trouba,D,NYR,30,82,12,27,39
1,8475200,Dmitry Orlov,D,CAR,33,82,9,30,39
1,8476854,Hampus Lindholm,D,BOS,30,82,9,30,39
1,8476923,Damon Severson,D,CBJ,30,82,7,32,39
1,8476979,Erik Gustafsson,D,DET,32,82,3,36,39
1,8482146,Luke Evangelista,R,NSH,22,82,21,17,38
1,8482175,JJ Peterka,R,BUF,22,82,18,20,38
1,8476480,Vladislav Namestnikov,C,WPG,32,82,17,21,38
1,8473563,Nicklas Backstrom,C,WSH,37,82,16,22,38
1,8480748,Kiefer Sherwood,L,VAN,29,82,16,22,38
1,8477429,Andrew Copp,C,DET,30,82,14,24,38
1,8477989,Christian Dvorak,C,MTL,28,82,13,25,38
1,8476927,Teddy Blueger,C,VAN,30,82,12,26,38
1,8477456,J.T. Compher,L,DET,29,82,12,26,38
1,8477435,Ryan Graves,D,PIT,29,82,6,32,38
1,8476438,Brandon Saad,L,STL,32,82,25,12,37
1,8481186,Logan O'Connor,R,COL,28,82,19,18,37
1,8479293,Brandon Tanev,L,SEA,33,82,18,19,37
1,8482705,Cole Sillinger,C,CBJ,21,82,17,20,37
1,8482475,Yegor Chinakhov,R,CBJ,23,82,16,21,37
1,8478472,Mathieu Joseph,R,STL,27,82,15,22,37
1,8475722,Jason Zucker,L,BUF,32,82,15,22,37
1,8478413,Jordan Greenway,L,BUF,27,82,15,22,37
1,8482117,Lukas Reichel,L,CHI,22,82,15,22,37
1,8482133,Thomas Bordeleau,C,SJS,22,82,14,23,37
1,8476461,Sean Couturier,C,PHI,32,82,11,26,37
1,8475753,Justin Faulk,D,STL,32,82,8,29,37
1,8480188,Fabian Zetterlund,L,SJS,25,82,8,29,37
1,8479976,Juuso Valimaki,D,UTA,26,82,7,30,37
1,8476463,Jonas Brodin,D,MIN,31,82,4,33,37
1,8482159,Tyson Foerster,R,PHI,22,82,23,13,36
1,8474715,Cam Atkinson,R,TBL,35,82,21,15,36
1,8473533,Jordan Staal,C,CAR,36,82,20,16,36
1,8479941,Justin Danforth,R,CBJ,31,82,19,17,36
1,8476872,Scott Laughton,C,PHI,30,82,16,20,36
1,8481560,Arthur Kaliyev,R,LAK,23,82,15,21,36
1,8482660,Kent Johnson,C,CBJ,22,82,13,23,36
1,8481656,Aliaksei Protas,C,WSH,23,82,13,23,36
1,8476826,Yanni Gourde,C,SEA,33,82,12,24,36
1,8481546,Cam York,D,PHI,23,82,11,25,36
1,8476312,Josh Manson,D,COL,33,82,10,26,36
1,8475218,Mattias Ekholm,D,EDM,34,82,7,29,36
1,8480145,Neal Pionk,D,WPG,29,82,5,31,36
1,8481604,Pavel Dorofeyev,L,VGK,24,82,18,17,35
1,8480789,Oliver Wahlstrom,R,NYI,24,82,18,17,35
1,8481582,Nicholas Robertson,L,TOR,23,82,16,19,35
1,8481704,Juuso Parssinen,C,NSH,23,82,15,20,35
1,8479351,Sam Steel,C,DAL,26,82,12,23,35
1,8483457,Lane Hutson,D,MTL,20,82,11,24,35
1,8480817,K'Andre Miller,D,NYR,24,82,9,26,35
1,8477220,Nate Schmidt,D,FLA,33,82,9,26,35
1,8475171,Oliver Ekman-Larsson,D,TOR,33,82,8,27,35
1,8477947,Sonny Milano,L,WSH,28,82,17,17,34
1,8479365,Trent Frederic,C,BOS,26,82,16,18,34
1,8474189,Lars Eller,C,PIT,35,82,16,18,34
1,8477508,Curtis Lazar,C,NJD,29,82,16,18,34
1,8476960,Andreas Athanasiou,C,CHI,30,82,15,19,34
1,8479996,Cody Glass,C,NSH,25,82,15,19,34
1,8474149,Evgenii Dadonov,R,DAL,35,82,14,20,34
1,8476918,Jimmy Vesey,L,NYR,31,82,14,20,34
1,8482671,Owen Power,D,BUF,22,82,13,21,34
1,8480113,Alex Iafallo,L,WPG,31,82,12,22,34
1,8475343,Nic Dowd,C,WSH,34,82,12,22,34
1,8475193,Tomas Tatar,L,NJD,34,82,11,23,34
1,8477948,Travis Sanheim,D,PHI,28,82,7,27,34
1,8480835,Jack Drury,C,CAR,24,82,20,13,33
1,8476873,Mark Jankowski,C,NSH,30,82,19,14,33
1,8482055,Drew O'Connor,L,PIT,26,82,18,15,33
1,8478891,Mason Appleton,C,WPG,28,82,17,16,33
1,8476921,Jordan Martinook,L,CAR,32,82,17,16,33
1,8475220,Marcus Foligno,L,MIN,33,82,16,17,33
1,8482092,Ridly Greig,C,OTT,22,82,12,21,33
1,8478911,Matt Roy,D,WSH,29,82,9,24,33
1,8479983,Mario Ferraro,D,SJS,26,82,9,24,33
1,8475181,Nick Leddy,D,STL,33,82,4,29,33
1,8477506,Ryan Pulock,D,NYI,30,82,4,29,33
1,8483431,Logan Cooley,C,UTA,20,82,23,9,32
1,8482125,Alexander Holtz,R,VGK,22,82,20,12,32
1,8478109,Victor Olofsson,L,VGK,29,82,15,17,32
1,8480806,Isac Lundestrom,C,ANA,25,82,14,18,32
1,8476469,Joel Armia,R,MTL,31,82,14,18,32
1,8480220,Noah Cates,L,PHI,25,82,13,19,32
1,8478020,Michael Amadio,C,OTT,28,82,12,20,32
1,8479398,Samuel Girard,D,COL,26,82,6,26,32
1,8482089,Jake Neighbours,L,STL,22,82,20,11,31
1,8480893,Kirill Marchenko,R,CBJ,24,82,20,11,31
1,8481553,Bobby Brink,R,PHI,23,82,17,14,31
1,8476278,Colin Blackwell,C,DAL,31,82,17,14,31
1,8484153,Leo Carlsson,C,ANA,20,82,17,14,31
1,8481624,Ilya Mikheyev,R,CHI,30,82,16,15,31
1,8473422,Nick Foligno,L,CHI,37,82,16,15,31
1,8480025,MacKenzie Entwistle,R,FLA,25,82,13,18,31
1,8481517,Brett Leason,R,ANA,25,82,13,18,31
1,8480871,Adam Boqvist,D,FLA,24,82,11,20,31
1,8477488,Brett Pesce,D,NJD,30,82,8,23,31
1,8475793,Ryan Johansen,C,PHI,32,82,6,25,31
1,8481601,Simon Holmstrom,R,NYI,23,82,17,13,30
1,8476889,Radek Faksa,C,STL,30,82,16,14,30
1,8483515,Juraj Slafkovsky,L,MTL,20,82,14,16,30
1,8479661,Tanner Jeannot,L,LAK,27,82,14,16,30
1,8478057,Dakota Joshua,C,VAN,28,82,13,17,30
1,8476897,Oskar Sundqvist,C,STL,30,82,12,18,30
1,8480003,Jesper Boqvist,C,FLA,26,82,12,18,30
1,8480448,Parker Kelly,L,COL,25,82,12,18,30
1,8481522,Peyton Krebs,C,BUF,23,82,10,20,30
1,8481477,Nico Sturm,C,SJS,29,82,10,20,30
1,8478507,John Marino,D,UTA,27,82,6,24,30
1,8476331,Dylan DeMelo,D,WPG,31,82,5,25,30
1,8479324,Ryan Lindgren,D,NYR,26,82,5,25,30
1,8478500,Ivan Provorov,D,CBJ,27,82,4,26,30
1,8474151,Ryan McDonagh,D,TBL,35,82,3,27,30
1,8478463,Anthony Beauvillier,L,PIT,27,82,14,15,29
1,8477450,Jason Dickinson,C,CHI,29,82,14,15,29
1,8477392,Hudson Fasching,R,NYI,29,82,14,15,29
1,8482111,Justin Barron,D,MTL,23,82,12,17,29
1,8478569,Noel Acciari,C,PIT,33,82,10,19,29
1,8481606,Jordan Spence,D,LAK,23,82,9,20,29
1,8476467,Jamie Oleksiak,D,SEA,32,82,7,22,29
1,8478399,Jonas Siegenthaler,D,NJD,27,82,4,25,29
1,8482087,Kaiden Guhle,D,MTL,22,82,3,26,29
1,8479591,Michael Eyssimont,C,TBL,28,82,17,11,28
1,8476392,Adam Lowry,C,WPG,31,82,16,12,28
1,8481554,Kaapo Kakko,R,NYR,23,82,14,14,28
1,8478115,Pierre Engvall,L,NYI,28,82,9,19,28
1,8480035,Henri Jokiharju,D,BUF,25,82,8,20,28
1,8477953,Kasperi Kapanen,R,STL,28,82,7,21,28
1,8481481,Blake Lizotte,C,PIT,27,82,6,22,28
1,8478840,Will Borgen,D,SEA,28,82,3,25,28
1,8476931,Jake McCabe,D,TOR,31,82,3,25,28
1,8480049,Dylan Samberg,D,WPG,25,82,1,27,28
1,8480074,Alexandre Texier,C,STL,25,82,17,10,27
1,8476981,Josh Anderson,R,MTL,30,82,17,10,27
1,8480855,Jack McBain,C,UTA,24,82,13,14,27
1,8479390,Taylor Raddysh,R,WSH,26,82,12,15,27
1,8477498,Darnell Nurse,D,EDM,29,82,10,17,27
1,8480813,Joe Veleno,C,DET,24,82,10,17,27
1,8480873,Rasmus Sandin,D,WSH,24,82,7,20,27
1,8480043,Timothy Liljegren,D,TOR,25,82,5,22,27
1,8476902,Esa Lindell,D,DAL,30,82,5,22,27
1,8482655,J.J. Moser,D,TBL,24,82,4,23,27
1,8476457,Adam Larsson,D,SEA,32,82,4,23,27
1,8482142,Jamie Drysdale,D,PHI,22,82,2,25,27
1,8481032,Paul Cotter,C,NJD,25,82,13,13,26
1,8477406,Mattias Janmark,C,EDM,32,82,12,14,26
1,8480995,Pontus Holmberg,R,TOR,25,82,12,14,26
1,8478432,Christian Fischer,R,DET,27,82,12,14,26
1,8479393,Noah Gregor,C,OTT,26,82,12,14,26
1,8479359,Beck Malenstyn,L,BUF,26,82,10,16,26
1,8482803,Olen Zellweger,D,ANA,21,82,8,18,26
1,8479371,Dante Fabbro,D,NSH,26,82,6,20,26
1,8482122,Brock Faber,D,MIN,22,82,6,20,26
1,8477365,Connor Clifton,D,BUF,29,82,5,21,26
1,8480878,Nils Lundkvist,D,DAL,24,82,4,22,26
1,8481568,Alex Vlasic,D,CHI,23,82,3,23,26
1,8478443,Brandon Carlo,D,BOS,28,82,3,23,26
1,8477969,Marcus Pettersson,D,PIT,28,82,2,24,26
1,8475842,Sam Carrick,C,NYR,32,82,16,9,25
1,8482624,Daniil Miromanov,D,CGY,27,82,13,12,25
1,8479353,Brett Howden,C,VGK,26,82,12,13,25
1,8482702,Logan Stankoven,C,DAL,21,82,11,14,25
1,8482079,Marco Rossi,C,MIN,23,82,9,16,25
1,8484145,Zach Benson,L,BUF,19,82,8,17,25
1,8482073,Braden Schneider,D,NYR,23,82,7,18,25
1,8478136,Jake Middleton,D,MIN,28,82,7,18,25
1,8476422,Mike Reilly,D,NYI,31,82,5,20,25
1,8476917,Adam Pelech,D,NYI,30,82,3,22,25
1,8480281,Alexey Toropchenko,R,STL,25,82,13,11,24
1,8480144,David Kampf,C,TOR,29,82,10,14,24
1,8476374,Sean Kuraly,C,CBJ,31,82,10,14,24
1,8477353,Tyler Motte,C,DET,29,82,10,14,24
1,8470621,Corey Perry,R,EDM,39,82,9,15,24
1,8482245,Artem Zub,D,OTT,29,82,8,16,24
1,8474574,Tyler Myers,D,VAN,34,82,7,17,24
1,8481178,Egor Zamula,D,PHI,24,82,6,18,24
1,8478859,Niko Mikkola,D,FLA,28,82,6,18,24
1,8481013,Jonatan Berggren,R,DET,24,82,5,19,24
1,8483490,Pavel Mintyukov,D,ANA,21,82,5,19,24
1,8475462,Radko Gudas,D,ANA,34,82,3,21,24
1,8476892,Colton Parayko,D,STL,31,82,1,23,24
1,8479368,Max Jones,L,BOS,26,82,14,9,23
1,8482074,Connor Zary,C,CGY,23,82,12,11,23
1,8478211,Dryden Hunt,L,CGY,29,82,11,12,23
1,8482807,Ethan Del Mastro,D,CHI,21,82,11,12,23
1,8476858,Phillip Di Giuseppe,L,VAN,31,82,11,12,23
1,8481580,Connor McMichael,C,WSH,23,82,10,13,23
1,8484203,Bradly Nadeau,L,CAR,19,82,10,13,23
1,8478882,Vladislav Gavrikov,D,LAK,29,82,8,15,23
1,8477425,Miles Wood,L,COL,29,82,8,15,23
1,8481605,Jackson LaCombe,D,ANA,23,82,7,16,23
1,8477938,Haydn Fleury,D,WPG,28,82,5,18,23
1,8480246,Nick Perbix,D,TBL,26,82,4,19,23
1,8478178,Darren Raddysh,D,TBL,28,82,4,19,23
1,8480336,Sean Walker,D,CAR,30,82,3,20,23
1,8476429,Scott Mayfield,D,NYI,32,82,3,20,23
1,8477903,Garnet Hathaway,R,PHI,33,82,14,8,22
1,8477839,Conor Sheary,L,TBL,32,82,11,11,22
1,8484149,Gavin Brindley,C,CBJ,20,82,11,11,22
1,8482155,Alex Laferriere,R,LAK,23,82,11,11,22
1,8482101,Danil Gushchin,L,SJS,22,82,7,15,22
1,8480222,Sebastian Aho,D,PIT,28,82,6,16,22
1,8475855,Jesper Fast,R,CAR,33,82,6,16,22
1,8477335,Kyle Burroughs,D,LAK,29,82,5,17,22
1,8480073,Erik Brannstrom,D,COL,25,82,4,18,22
1,8475231,Casey Cizikas,C,NYI,33,82,4,18,22
1,8478508,Yakov Trenin,C,MIN,27,82,13,8,21
1,8483499,Liam Ohgren,L,MIN,20,82,10,11,21
1,8482679,Matt Coronato,R,CGY,22,82,9,12,21
1,8481014,Alexander Romanov,D,NYI,24,82,7,14,21
1,8482659,Josh Doan,R,UTA,22,82,7,14,21
1,8479402,Jake Bean,D,CGY,26,82,6,15,21
1,8480980,Connor Dewar,C,TOR,25,82,5,16,21
1,8483495,Simon Nemec,D,NJD,20,82,5,16,21
1,8475790,Erik Gudbranson,D,CBJ,32,82,4,17,21
1,8473453,Trevor Lewis,C,LAK,37,82,12,8,20
1,8482077,Dylan Holloway,L,EDM,23,82,10,10,20
1,8481708,Zac Jones,D,NYR,24,82,8,12,20
1,8473507,Jeff Petry,D,DET,37,82,7,13,20
1,8479369,Andrew Peeke,D,BOS,26,82,7,13,20
1,8477369,Carson Soucy,D,VAN,30,82,7,13,20
1,8477015,Connor Brown,R,EDM,30,82,6,14,20
1,8480834,Ty Emberson,D,SJS,24,82,5,15,20
1,8482141,Lukas Cormier,D,VGK,22,82,5,15,20
1,8478450,Parker Wotherspoon,D,BOS,27,82,4,16,20
1,8474567,Zach Bogosian,D,MIN,34,82,4,16,20
1,8475455,Brenden Dillon,D,NJD,34,82,3,17,20
1,8483524,Shane Wright,C,SEA,20,82,10,9,19
1,8477507,Nikita Zadorov,D,BOS,29,82,9,10,19
1,8483763,Maksymilian Szuber,D,UTA,22,82,9,10,19
1,8480021,Jack Studnicka,C,LAK,25,82,9,10,19
1,8483468,Jiri Kulich,C,BUF,20,82,8,11,19
1,8483493,Frank Nazar,C,CHI,20,82,8,11,19
1,8476525,Colin Miller,D,WPG,32,82,6,13,19
1,8478434,Keegan Kolesar,R,VGK,27,82,6,13,19
1,8482062,Cole Smith,L,NSH,29,82,6,13,19
1,8482166,Shakir Mukhamadullin,D,SJS,22,82,5,14,19
1,8482666,Scott Morrow,D,CAR,22,82,5,14,19
1,8482809,Jackson Blake,R,CAR,21,82,5,14,19
1,8475233,David Savard,D,MTL,34,82,4,15,19
1,8483565,Nick Blankenburg,D,NSH,26,82,4,15,19
1,8477499,Rasmus Ristolainen,D,PHI,30,82,4,15,19
1,8483471,Brad Lambert,C,WPG,31,82,4,15,19
1,8475690,Chris Tanev,D,TOR,35,82,3,16,19
1,8476967,Brett Kulak,D,EDM,30,82,2,17,19
1,8475188,Brayden McNabb,D,VGK,33,82,1,18,19
1,8479316,Luke Kunin,C,SJS,27,82,11,7,18
1,8477931,Tomas Nosek,L,FLA,32,82,9,9,18
1,8482712,Oskar Olausson,R,COL,22,82,8,10,18
1,8484911,Collin Graf,R,SJS,22,82,8,10,18
1,8480068,Ryan Poehling,C,PHI,25,82,7,11,18
1,8483445,Cutter Gauthier,L,ANA,20,82,7,11,18
1,8478851,Alexandre Carrier,D,NSH,28,82,6,12,18
1,8483505,Matthew Poitras,C,BOS,20,82,6,12,18
1,8476442,Matt Nieto,L,PIT,32,82,5,13,18
1,8479998,Mikey Anderson,D,LAK,25,82,4,14,18
1,8475177,Calvin de Haan,D,COL,33,82,4,14,18
1,8477034,Jaycob Megna,D,FLA,32,82,4,14,18
1,8476441,Joel Edmundson,D,LAK,31,82,4,14,18
1,8476879,Cody Ceci,D,EDM,31,82,2,16,18
1,8480807,Mattias Samuelsson,D,BUF,24,82,1,17,18
1,8477505,Alexander Wennberg,C,SJS,30,82,13,4,17
1,8479442,Troy Stecher,D,EDM,30,82,9,8,17
1,8482762,Simon Edvinsson,D,DET,21,82,9,8,17
1,8476878,Zemgus Girgensons,L,TBL,30,82,6,11,17
1,8482118,Sam Colangelo,R,ANA,23,82,6,11,17
1,8475324,Nick Jensen,D,OTT,34,82,4,13,17
1,8479980,Nicolas Hague,D,VGK,26,82,4,13,17
1,8479414,Nathan Bastian,R,NJD,27,82,11,5,16
1,8481093,Rafael Harvey-Pinard,L,MTL,25,82,9,7,16
1,8481028,Martin Pospisil,C,CGY,25,82,8,8,16
1,8478013,Jake Walman,D,SJS,28,82,6,10,16
1,8482733,Logan Mailloux,D,MTL,31,82,5,11,16
1,8480172,Jan Rutta,D,SJS,34,82,4,12,16
1,8475279,Ben Chiarot,D,DET,33,82,3,13,16
1,8480796,Martin Fehervary,D,WSH,25,82,3,13,16
1,8471677,Jack Johnson,D,CBJ,37,82,3,13,16
1,8476891,Matt Grzelcyk,D,PIT,30,82,2,14,16
1,8480990,Declan Chisholm,D,MIN,24,82,8,7,15
1,8481641,Joel Kiviranta,L,COL,28,82,8,7,15
1,8477845,Trevor van Riemsdyk,D,WSH,33,82,6,9,15
1,8481122,Simon Benoit,D,TOR,26,82,6,9,15
1,8481524,Bowen Byram,D,BUF,23,82,9,5,14
1,8479291,Kevin Rooney,C,CGY,31,82,6,8,14
1,8476624,Barclay Goodrow,C,SJS,31,82,5,9,14
1,8474013,Ian Cole,D,UTA,35,82,5,9,14
1,8482859,Zack Ostapchuk,C,OTT,21,82,5,9,14
1,8476822,Luke Glendening,C,TBL,35,82,5,9,14
1,8483482,Tristan Luneau,D,ANA,20,82,4,10,14
1,8482470,Ilya Solovyov,D,CGY,24,82,2,12,14
1,8475718,Justin Holl,D,DET,32,82,1,13,14
1,8478416,Erik Cernak,D,TBL,27,82,1,13,14
1,8480950,Ilya Lyubushkin,D,DAL,30,82,1,13,14
1,8483397,Marc McLaughlin,C,BOS,25,82,9,4,13
1,8482259,Bobby McMann,C,TOR,28,82,8,5,13
1,8482145,Mavrik Bourque,C,DAL,22,82,7,6,13
1,8480870,Bo Groulx,C,NYR,24,82,4,9,13
1,8483460,David Jiricek,D,CBJ,21,82,3,10,13
1,8474673,TJ Brodie,D,CHI,34,82,2,11,13
1,8474612,Travis Hamonic,D,OTT,34,82,2,11,13
1,8478468,Jeremy Lauzon,D,NSH,27,82,2,11,13
1,8482749,Joshua Roy,R,MTL,21,82,5,7,12
1,8478874,Adam Gaudette,C,OTT,28,82,4,8,12
1,8483012,Logan Morrison,C,SEA,22,82,4,8,12
1,8480879,Jacob Bernard-Docker,D,OTT,24,82,3,9,12
1,8476372,Nick Seeler,D,PHI,31,82,3,9,12
1,8481567,Henry Thrun,D,SJS,23,82,3,9,12
1,8475762,Derek Forbort,D,VAN,32,82,2,10,12
1,8482858,Ryker Evans,D,SEA,23,82,2,10,12
1,8474090,Brendan Smith,D,DAL,35,82,1,11,12
1,8482153,Brendan Brisson,C,VGK,23,82,4,7,11
1,8474062,Riley Nash,C,NYR,35,82,3,8,11
1,8480860,Kevin Bahl,D,CGY,24,82,0,11,11
1,8483489,Fraser Minten,C,TOR,31,82,6,4,10
1,8470600,Ryan Suter,D,STL,39,82,3,7,10
1,8476473,Connor Murphy,D,CHI,31,82,3,7,10
1,8482787,Nikita Chibrikov,R,WPG,31,82,4,5,9
1,8482516,Matthew Kessel,D,STL,24,82,2,7,9
1,8481699,Aku Raty,R,UTA,23,82,1,8,9
1,8482713,Mackie Samoskevich,R,FLA,22,82,3,5,8
1,8483466,Kevin Korchinski,D,CHI,20,82,2,6,8
1,8479576,Vincent Desharnais,D,VAN,28,82,1,6,7
1,8483567,Georgii Merkulov,C,BOS,24,82,1,6,7
1,8479638,Justin Brazeau,R,BOS,26,82,2,2,4
1,8482070,Mitchell Chaffee,R,TBL,26,82,2,2,4
1,8470794,Joe Pavelski,C,,40,0,0,0,0
1,8481703,Valtteri Puustinen,R,PIT,25,0,0,0,0
1,8477950,Tony DeAngelo,D,,29,0,0,0,0
1,8481577,Philip Tomasino,C,NSH,23,0,0,0,0
1,8475197,Tyson Barrie,D,,33,0,0,0,0
1,8471218,Blake Wheeler,R,,38,0,0,0,0
1,8474157,Max Pacioretty,L,,36,0,0,0,0
1,8478466,Daniel Sprong,R,VAN,27,0,0,0,0
1,8475744,Evgeny Kuznetsov,C,,32,0,0,0,0
1,8481019,David Gustafsson,C,WPG,24,0,0,0,0
1,8475906,John Klingberg,D,,32,0,0,0,0
1,8479348,Kale Clague,D,BUF,26,0,0,0,0
1,8476952,Dominic Toninato,C,WPG,30,0,0,0,0
1,8473473,Milan Lucic,L,,36,0,0,0,0
1,8474037,James van Riemsdyk,L,,35,0,0,0,0
1,8474602,Justin Schultz,D,,34,0,0,0,0
1,8482222,Alexander Barabanov,L,,30,0,0,0,0
1,8479372,Josh Mahura,D,SEA,26,0,0,0,0
1,8479982,Conor Timmins,D,TOR,26,0,0,0,0
1,8474031,Kevin Shattenkirk,D,,35,0,0,0,0
1,8480008,Adam Ruzicka,C,,25,0,0,0,0
1,8481059,Scott Perunovich,D,STL,26,0,0,0,0
1,8480884,Calen Addison,D,,24,0,0,0,0
1,8476994,Vinnie Hinostroza,C,NSH,30,0,0,0,0
1,8478452,Caleb Jones,D,LAK,27,0,0,0,0
1,8480157,Calle Rosen,D,COL,30,0,0,0,0
1,8481609,Vladislav Kolyachonok,D,UTA,23,0,0,0,0
1,8479415,Michael McLeod,C,,26,0,0,0,0
1,8476919,Chris Tierney,C,,30,0,0,0,0
1,8479639,Dylan Coghlan,D,WPG,26,0,0,0,0
1,8478146,Matthew Highmore,C,OTT,28,0,0,0,0
1,8478970,Jalen Chatfield,D,CAR,28,0,0,0,0
1,8480205,Emil Bemstrom,C,PIT,25,0,0,0,0
1,8474884,Mike Hoffman,C,,35,0,0,0,0
1,8471274,Alex Goligoski,D,,39,0,0,0,0
1,8478104,Sammy Blais,L,,28,0,0,0,0
1,8474870,Tyler Johnson,C,,34,0,0,0,0
1,8476913,Devin Shore,C,MIN,30,0,0,0,0
1,8481598,Philip Broberg,D,EDM,23,0,0,0,0
1,8480058,Pierre-Olivier Joseph,D,STL,25,0,0,0,0
1,8480891,Michael Kesselring,D,UTA,24,0,0,0,0
1,8477979,Nicolas Aube-Kubel,R,BUF,28,0,0,0,0
1,8476871,Tanner Pearson,L,,32,0,0,0,0
1,8476393,Nick Cousins,C,,31,0,0,0,0
1,8479977,Kailer Yamamoto,R,,26,0,0,0,0
1,8479543,Michael Pezzetta,L,MTL,26,0,0,0,0
1,8477018,Ben Hutton,D,VGK,31,0,0,0,0
1,8480762,Eric Robinson,L,CAR,29,0,0,0,0
1,8474034,Pat Maroon,L,CHI,36,0,0,0,0
1,8481058,Jesse Ylönen,R,,25,0,0,0,0
1,8475179,Dmitry Kulikov,D,FLA,34,0,0,0,0
1,8481527,Kaedan Korczak,D,VGK,23,0,0,0,0
1,8473449,Kyle Okposo,R,,36,0,0,0,0
1,8482192,Isaak Phillips,D,CHI,23,0,0,0,0
1,8480727,Zach Whitecloud,D,VGK,28,0,0,0,0
1,8479346,Dillon Dube,C,,26,0,0,0,0
1,8480821,Filip Zadina,R,,25,0,0,0,0
1,8480001,Urho Vaakanainen,D,ANA,25,0,0,0,0
1,8470966,Mark Giordano,D,,41,0,0,0,0
1,8480853,Liam Foudy,C,,24,0,0,0,0
1,8475225,Craig Smith,C,CHI,35,0,0,0,0
1,8479972,Mason Shaw,C,WPG,26,0,0,0,0
1,8478451,Ethan Bear,D,WSH,27,0,0,0,0
1,8474040,Sam Gagner,C,,35,0,0,0,0
1,8480196,Jacob Bryson,D,BUF,27,0,0,0,0
1,8479984,Cal Foote,D,,26,0,0,0,0
1,8480011,Klim Kostin,C,SJS,25,0,0,0,0
1,8482176,Wyatt Kaiser,D,CHI,22,0,0,0,0
1,8476988,Matt Benning,D,SJS,30,0,0,0,0
1,8479370,Tyson Jost,C,CAR,26,0,0,0,0
1,8477464,Nic Petan,C,,29,0,0,0,0
1,8477380,Jonny Brodzinski,C,NYR,31,0,0,0,0
1,8480070,Ian Mitchell,D,BOS,25,0,0,0,0
1,8479315,Joey Anderson,R,CHI,26,0,0,0,0
1,8478099,Kevin Labanc,R,,29,0,0,0,0
1,8476874,Olli Maatta,D,DET,30,0,0,0,0
1,8475208,Brian Dumoulin,D,ANA,33,0,0,0,0
1,8478430,Oliver Kylington,D,,27,0,0,0,0
1,8479536,Axel Jonsson-Fjallby,L,WPG,26,0,0,0,0
1,8479671,Mathieu Olivier,R,CBJ,27,0,0,0,0
1,8471709,Marc-Edouard Vlasic,D,SJS,37,0,0,0,0
1,8479328,Julien Gauthier,R,NYI,27,0,0,0,0
1,8478421,A.J. Greer,L,FLA,28,0,0,0,0
1,8477573,Nathan Walker,L,STL,30,0,0,0,0
1,8481537,Nikita Okhotiuk,D,CGY,24,0,0,0,0
1,8474166,Alec Martinez,D,CHI,37,0,0,0,0
1,8470610,Zach Parise,L,,40,0,0,0,0
1,8477478,William Carrier,L,CAR,30,0,0,0,0
1,8479344,Jesse Puljujarvi,R,PIT,26,0,0,0,0
1,8480887,Jordan Harris,D,MTL,24,0,0,0,0
1,8478502,Dennis Gilbert,D,BUF,28,0,0,0,0
1,8482730,Brandt Clarke,D,LAK,21,0,0,0,0
1,8480355,Mark Kastelic,C,BOS,25,0,0,0,0
1,8475750,Jon Merrill,D,MIN,32,0,0,0,0
1,8475164,Jakob Silfverberg,R,,34,0,0,0,0
1,8477944,Jakub Vrana,L,,28,0,0,0,0
1,8479439,Jacob MacDonald,D,COL,31,0,0,0,0
1,8474568,Luke Schenn,D,NSH,35,0,0,0,0
1,8478454,Noah Juulsen,D,VAN,27,0,0,0,0
1,8475752,Tyler Pitlick,C,,33,0,0,0,0
1,8482148,Hendrix Lapierre,C,WSH,22,0,0,0,0
1,8481167,Brayden Pachal,D,CGY,25,0,0,0,0
1,8478043,Sam Lafferty,C,BUF,29,0,0,0,0
1,8479321,Lucas Johansen,D,,27,0,0,0,0
1,8471699,Andrew Cogliano,C,,37,0,0,0,0
1,8481521,Ronnie Attard,D,PHI,25,0,0,0,0
1,8481161,Jake Christiansen,D,CBJ,25,0,0,0,0
1,8479458,Nikita Zaitsev,D,,33,0,0,0,0
1,8479619,Michael Carcone,L,UTA,28,0,0,0,0
1,8479026,Philippe Myers,D,TOR,27,0,0,0,0
1,8477330,Dominik Kubalik,L,,29,0,0,0,0
1,8481617,Vasily Podkolzin,R,VAN,23,0,0,0,0
1,8481701,Santeri Hatakka,D,NJD,23,0,0,0,0
1,8479514,Rem Pitlick,C,,27,0,0,0,0
1,8477446,Michael McCarron,R,NSH,29,0,0,0,0
1,8470604,Jeff Carter,C,,39,0,0,0,0
1,8482241,Radim Zohorna,L,,28,0,0,0,0
1,8480289,Morgan Barron,C,WPG,26,0,0,0,0
1,8479379,Givani Smith,R,SJS,26,0,0,0,0
1,8480216,Jacob Peterson,C,,25,0,0,0,0
1,8477851,Jordan Oesterle,D,BOS,32,0,0,0,0
1,8484258,Sam Malinski,D,COL,26,0,0,0,0
1,8478904,Steven Lorentz,C,,28,0,0,0,0
1,8482095,Tyler Kleven,D,OTT,22,0,0,0,0
1,8480848,Ty Dellandrea,C,SJS,24,0,0,0,0
1,8476884,Derrick Pouliot,D,,30,0,0,0,0
1,8479336,Carl Grundstrom,R,SJS,27,0,0,0,0
1,8482964,Arber Xhekaj,D,MTL,23,0,0,0,0
1,8471686,Marc Staal,D,,37,0,0,0,0
1,8477887,Patrick Brown,C,BOS,32,0,0,0,0
1,8478495,Denis Gurianov,R,,27,0,0,0,0
1,8473504,Cal Clutterbuck,R,,37,0,0,0,0
1,8481550,Adam Beckman,L,NJD,23,0,0,0,0
1,8480845,Rasmus Kupari,C,WPG,24,0,0,0,0
1,8474009,Nick Bonino,C,,36,0,0,0,0
1,8478585,Derek Ryan,C,EDM,38,0,0,0,0
1,8477962,Brendan Lemieux,L,CAR,28,0,0,0,0
1,8482861,Vincent Iorio,D,WSH,22,0,0,0,0
1,8479378,Logan Stanley,D,WPG,26,0,0,0,0
1,8473446,Erik Johnson,D,PHI,36,0,0,0,0
1,8481743,Marc Del Gaizo,D,NSH,25,0,0,0,0
1,8477384,Josh Brown,D,EDM,30,0,0,0,0
1,8482165,Yan Kuznetsov,D,CGY,22,0,0,0,0
1,8478424,Jansen Harkins,C,ANA,27,0,0,0,0
1,8482144,Jack Thompson,D,SJS,22,0,0,0,0
1,8478512,Austin Czarnik,C,,32,0,0,0,0
1,8477527,Ross Johnston,L,ANA,30,0,0,0,0
1,8479383,Boris Katchouk,L,,26,0,0,0,0
1,8482094,Daemon Hunt,D,MIN,22,0,0,0,0
1,8481719,Maxwell Crozier,D,TBL,24,0,0,0,0
1,8480192,Johnathan Kovacevic,D,NJD,27,0,0,0,0
1,8479376,Victor Mete,D,,26,0,0,0,0
1,8482511,Mason Lohrei,D,BOS,23,0,0,0,0
1,8475825,Jani Hakanpää,D,,32,0,0,0,0
1,8478021,William Lagesson,D,DET,28,0,0,0,0
1,8475795,Dylan McIlrath,D,WSH,32,0,0,0,0
1,8477846,Ryan Carpenter,C,,33,0,0,0,0
1,8481056,Spencer Stastney,D,NSH,24,0,0,0,0
1,8481564,Ryan Johnson,D,BUF,23,0,0,0,0
1,8478017,Mark Friedman,D,VAN,29,0,0,0,0
1,8479320,Max Lajoie,D,SEA,27,0,0,0,0
1,8480075,Cameron Crotty,D,MIN,25,0,0,0,0
1,8484287,Cole McWard,D,VAN,23,0,0,0,0
1,8484254,Akito Hirose,D,VAN,25,0,0,0,0
1,8483407,Brandon Scanlin,D,NYR,25,0,0,0,0
1,8480274,Philip Kemp,D,EDM,25,0,0,0,0
1,8479522,Hardy Haman Aktell,D,WSH,26,0,0,0,0
1,8480007,Jonas Rondbjerg,R,VGK,25,0,0,0,0
1,8477454,Adam Erne,L,,29,0,0,0,0
1,8481679,Maxence Guenette,D,OTT,23,0,0,0,0
1,8480441,Trey Fix-Wolansky,R,CBJ,25,0,0,0,0
1,8483546,Marshall Rifai,D,TOR,26,0,0,0,0
1,8480084,Nick DeSimone,D,NJD,30,0,0,0,0
1,8481030,Jack St. Ivany,D,PIT,25,0,0,0,0
1,8481592,Jakob Pelletier,L,CGY,23,0,0,0,0
1,8478011,Louie Belpedio,D,PHI,28,0,0,0,0
1,8477930,Pierre-Edouard Bellemare,L,,39,0,0,0,0
1,8484321,Nikolas Matinpalo,D,OTT,26,0,0,0,0
1,8482067,Connor Mackey,D,NYR,28,0,0,0,0
1,8481806,Louis Crevier,D,CHI,23,0,0,0,0
1,8484326,Patrik Koch,D,UTA,28,0,0,0,0
1,8477971,Andreas Englund,D,LAK,28,0,0,0,0
1,8481751,Lukas Rousek,R,BUF,25,0,0,0,0
1,8481006,Tyler Tucker,D,STL,24,0,0,0,0
1,8476867,Brendan Gaunce,C,MIN,30,0,0,0,0
1,8479520,Brandon Duhaime,R,WSH,27,0,0,0,0
1,8477073,Kurtis MacDermid,L,NJD,30,0,0,0,0
1,8480874,Adam Ginning,D,PHI,24,0,0,0,0
1,8477473,Justin Bailey,R,SJS,29,0,0,0,0
1,8479066,Ryan Lomberg,L,CGY,30,0,0,0,0
1,8477070,Liam O'Brien,C,UTA,30,0,0,0,0
1,8474618,Marco Scandella,D,,34,0,0,0,0
1,8475797,Jarred Tinordi,D,,32,0,0,0,0
1,8481441,Joe Snively,C,DET,28,0,0,0,0
1,8477244,Chad Ruhwedel,D,NYR,34,0,0,0,0
1,8479772,Zack MacEwen,R,OTT,28,0,0,0,0
1,8481147,Reese Johnson,C,MIN,26,0,0,0,0
1,8481043,Cole Koepke,L,BOS,26,0,0,0,0
1,8483619,Filip Roos,D,OTT,25,0,0,0,0
1,8481541,Samuel Bolduc,D,NYI,24,0,0,0,0
1,8477810,Joel Hanley,D,CGY,33,0,0,0,0
1,8476907,Mackenzie MacEachern,L,,30,0,0,0,0
1,8482652,Walker Duehr,R,CGY,27,0,0,0,0
1,8477126,Jayson Megna,C,,34,0,0,0,0
1,8483398,Declan Carlile,D,TBL,31,0,0,0,0
1,8482929,Emil Lilleberg,D,TBL,23,0,0,0,0
1,8480880,Jakub Lauko,C,MIN,24,0,0,0,0
1,8480245,Olle Lycksell,R,PHI,25,0,0,0,0
1,8480252,Cole Guttman,C,CHI,25,0,0,0,0
1,8477467,Gustav Olofsson,D,SEA,30,0,0,0,0
1,8479968,Vinni Lettieri,C,BOS,29,0,0,0,0
1,8478400,Colin White,C,,27,0,0,0,0
1,8475755,Alexander Petrovic,D,DAL,32,0,0,0,0
1,8481812,Nikolai Knyzhov,D,,27,0,0,0,0
1,8481593,Jayden Struble,D,MTL,23,0,0,0,0
1,8481532,Alex Turcotte,C,LAK,23,0,0,0,0
1,8482126,Emil Andrae,D,PHI,31,0,0,0,0
1,8479944,Zach Aston-Reese,C,VGK,30,0,0,0,0
1,8471817,Ryan Reaves,R,TOR,37,0,0,0,0
1,8481206,John Ludvig,D,PIT,24,0,0,0,0
1,8481599,Victor Soderstrom,D,UTA,23,0,0,0,0
1,8480292,Carson Meyer,R,ANA,27,0,0,0,0
1,8482496,Nils Aman,C,VAN,24,0,0,0,0
1,8479718,Alex Barré-Boulet,C,MTL,27,0,0,0,0
1,8479994,Jaret Anderson-Dolan,C,WPG,25,0,0,0,0
1,8480184,Gustav Lindstrom,D,,26,0,0,0,0
1,8480890,Jan Jenik,R,OTT,24,0,0,0,0
1,8478067,Oskar Lindblom,L,,28,0,0,0,0
1,8476934,Brock McGinn,L,ANA,30,0,0,0,0
1,8479985,Cale Fleury,D,SEA,26,0,0,0,0
1,8484304,Uvis Balinskis,D,FLA,28,0,0,0,0
1,8479981,Jonah Gadjovich,L,FLA,26,0,0,0,0
1,8481716,Dmitri Voronkov,L,CBJ,24,0,0,0,0
1,8474709,Matt Martin,L,,35,0,0,0,0
1,8482634,Alex Steeves,C,TOR,25,0,0,0,0
1,8480823,Alexander Alexeyev,D,WSH,25,0,0,0,0
1,8477541,Dakota Mermis,D,TOR,30,0,0,0,0
1,8483491,Ivan Miroshnichenko,L,WSH,20,0,0,0,0
1,8478477,Mitchell Stephens,C,SEA,27,0,0,0,0
1,8481543,Nikita Alexandrov,C,STL,24,0,0,0,0
1,8479423,Alex Nylander,L,,26,0,0,0,0
1,8482451,Mikael Pyyhtia,L,CBJ,23,0,0,0,0
1,8478831,Kevin Stenlund,C,UTA,28,0,0,0,0
1,8480306,Grant Hutton,D,NYI,29,0,0,0,0
1,8478028,Fredrik Olofsson,L,,28,0,0,0,0
1,8477462,Robert Hagg,D,VGK,29,0,0,0,0
1,8477320,Anton Blidh,L,NYR,29,0,0,0,0
1,8482157,Will Cuylle,L,NYR,22,0,0,0,0
1,8482737,Zack Bolduc,C,STL,21,0,0,0,0
1,8481239,Samuel Fagemo,L,,24,0,0,0,0
1,8481600,Tobias Bjornfot,D,FLA,23,0,0,0,0
1,8478409,Anthony Richard,C,PHI,28,0,0,0,0
1,8474145,Robert Bortuzzo,D,,35,0,0,0,0
1,8475958,Michael Sgarbossa,C,WSH,32,0,0,0,0
1,8479986,Kole Lind,R,DAL,26,0,0,0,0
1,8479249,Andrew Poturalski,C,SJS,30,0,0,0,0
1,8479362,Riley Tufte,L,BOS,26,0,0,0,0
1,8479991,Jake Leschyshyn,C,NYR,25,0,0,0,0
1,8479587,Rhett Gardner,C,PHI,28,0,0,0,0
1,8482744,James Malatesta,L,CBJ,21,0,0,0,0
1,8478854,Ryan Shea,D,PIT,27,0,0,0,0
1,8481591,Sam Poulin,R,,23,0,0,0,0
1,8483512,Matt Savoie,C,EDM,20,0,0,0,0
1,8482102,Vasily Ponomarev,C,PIT,22,0,0,0,0
1,8482162,Roby Jarventie,L,EDM,22,0,0,0,0
1,8481016,Ruslan Iskhakov,C,,24,0,0,0,0
1,8482172,Landon Slaggert,L,CHI,22,0,0,0,0
1,8482747,Brennan Othmann,L,NYR,21,0,0,0,0
1,8480031,Maxime Comtois,L,,25,0,0,0,0
1,8480226,Marián Studenic,R,,26,0,0,0,0
1,8478408,Travis Dermott,D,,28,0,0,0,0
1,8481518,Nolan Foote,L,NJD,24,0,0,0,0
1,8479419,Brett Murray,L,BUF,26,0,0,0,0
1,8482088,Justin Sourdif,R,FLA,22,0,0,0,0
1,8482201,Gage Goncalves,C,TBL,23,0,0,0,0
1,8481578,Graeme Clarke,R,MIN,23,0,0,0,0
1,8482177,Marat Khusnutdinov,C,MIN,22,0,0,0,0
1,8481754,Nikita Nesterenko,C,ANA,23,0,0,0,0
1,8483531,Brian Halonen,L,NJD,25,0,0,0,0
1,8483920,Pierrick Dube,R,WSH,23,0,0,0,0
1,8480851,Akil Thomas,C,LAK,24,0,0,0,0
1,8475235,Nicolas Deslauriers,L,PHI,33,0,0,0,0
1,8482476,Emil Heineman,L,MTL,23,0,0,0,0
1,8477149,Scott Sabourin,R,SJS,32,0,0,0,0
1,8483549,Lucas Condotta,L,MTL,27,0,0,0,0
1,8482765,Isak Rosen,R,BUF,21,0,0,0,0
1,8481237,Kyle MacLean,C,NYI,25,0,0,0,0
1,8481024,Linus Karlsson,C,VAN,25,0,0,0,0
1,8481690,Tyler Angle,C,,24,0,0,0,0
1,8483570,Ben Meyers,C,SEA,26,0,0,0,0
1,8481655,Cole Schwindt,R,CGY,23,0,0,0,0
1,8481462,Mason Morelli,L,VGK,28,0,0,0,0
1,8483401,Marc Johnstone,R,PIT,28,0,0,0,0
1,8478956,Samuel Laberge,L,NJD,27,0,0,0,0
1,8479533,Joona Koppanen,L,,26,0,0,0,0
1,8482197,Adam Raska,R,MIN,23,0,0,0,0
1,8482250,Callahan Burke,C,VGK,27,0,0,0,0
1,8482784,Zach Dean,C,STL,21,0,0,0,0
1,8484255,Jason Polin,R,COL,25,0,0,0,0
1,8481077,John Leonard,L,,26,0,0,0,0
1,8481534,Raphael Lavoie,C,EDM,24,0,0,0,0
1,8483609,Adam Klapka,R,CGY,24,0,0,0,0
1,8482751,Ryan Winterton,C,SEA,21,0,0,0,0
1,8480267,Sammy Walker,C,MIN,25,0,0,0,0
1,8475766,Austin Watson,L,,32,0,0,0,0
1,8482460,Matt Rempe,C,NYR,22,0,0,0,0
1,8481065,Angus Crookshank,L,OTT,25,0,0,0,0
1,8481070,Hugh McGing,L,,26,0,0,0,0
1,8476323,Max McCormick,L,SEA,32,0,0,0,0
1,8483395,Arshdeep Bains,L,VAN,23,0,0,0,0
1,8484259,Ondrej Pavel,C,COL,31,0,0,0,0
1,8483432,Luca Del Bel Belluz,C,CBJ,31,0,0,0,0
1,8483045,Cameron Butler,R,CBJ,31,0,0,0,0
1,8482061,Brandon Biro,L,SEA,26,0,0,0,0
1,8477401,John Hayden,C,SEA,29,0,0,0,0
1,8475278,Byron Froese,C,,33,0,0,0,0
1,8478446,Glenn Gawdin,C,LAK,27,0,0,0,0
1,8477993,Justin Kirkland,C,CGY,28,0,0,0,0
1,8482147,Jean-Luc Foudy,C,COL,22,0,0,0,0
1,8480032,Shane Bowers,C,NJD,25,0,0,0,0
1,8479330,Brandon Gignac,C,MTL,27,0,0,0,0
1,8480776,Sheldon Rempal,R,,29,0,0,0,0
1,8475413,Justin Dowling,C,NJD,34,0,0,0,0
1,8481726,Adam Edstrom,C,NYR,24,0,0,0,0
1,8480844,Grigori Denisenko,L,VGK,24,0,0,0,0
1,8478147,Bokondji Imama,L,PIT,28,0,0,0,0
1,8478881,Brett Seney,L,CHI,28,0,0,0,0
1,8483630,Pavol Regenda,L,ANA,25,0,0,0,0
1,8480836,Jonathan Gruden,C,,24,0,0,0,0
1,8484314,Jiri Smejkal,L,,28,0,0,0,0
1,8475780,Chris Wagner,R,COL,33,0,0,0,0
1,8479546,Oskar Steen,C,,26,0,0,0,0
1,8483597,Milos Kelemen,L,UTA,25,0,0,0,0
1,8481789,Tye Kartye,L,SEA,23,0,0,0,0
1,8484325,Waltteri Merela,C,TBL,26,0,0,0,0
1,8479421,Jacob Moverare,D,LAK,26,0,0,0,0
1,8481585,Egor Afanasyev,L,SJS,23,0,0,0,0
1,8479547,Matthew Phillips,R,,26,0,0,0,0
1,8479367,William Lockwood,R,FLA,26,0,0,0,0
1,8476915,Jujhar Khaira,L,,30,0,0,0,0
1,8481422,Jacob Lucchini,C,NSH,29,0,0,0,0
1,8480468,James Hamblin,L,EDM,25,0,0,0,0
1,8478051,Max Willman,C,NJD,29,0,0,0,0
1,8481556,John Beecher,C,BOS,23,0,0,0,0
1,8478078,Rourke Chartier,C,,28,0,0,0,0
2,8477492,Nathan MacKinnon,C,COL,29,82,67,82,149
2,8478402,Connor McDavid,C,EDM,27,82,41,95,136
2,8479318,Auston Matthews,C,TOR,27,82,70,56,126
2,8477493,Aleksander Barkov,C,FLA,29,82,42,76,118
2,8477939,William Nylander,R,TOR,28,82,47,68,115
2,8478420,Mikko Rantanen,R,COL,28,82,45,67,112
2,8481559,Jack Hughes,C,NJD,23,82,43,67,110
2,8478445,Mathew Barzal,C,NYI,27,82,24,85,109
2,8480023,Robert Thomas,C,STL,25,82,41,67,108
2,8479314,Matthew Tkachuk,L,FLA,27,82,31,76,107
2,8478550,Artemi Panarin,L,NYR,33,82,29,77,106
2,8479343,Clayton Keller,R,UTA,26,82,50,52,102
2,8476468,J.T. Miller,C,VAN,31,82,38,64,102
2,8471675,Sidney Crosby,C,PIT,37,82,42,59,101
2,8476453,Nikita Kucherov,R,TBL,31,82,30,71,101
2,8474600,Roman Josi,D,NSH,34,82,20,81,101
2,8478427,Sebastian Aho,C,CAR,27,82,38,62,100
2,8480012,Elias Pettersson,C,VAN,26,82,36,64,100
2,8477946,Dylan Larkin,C,DET,28,82,49,50,99
2,8481557,Matt Boldy,L,MIN,23,82,37,60,97
2,8478864,Kirill Kaprizov,L,MIN,27,82,50,46,96
2,8479407,Jesper Bratt,L,NJD,26,82,37,59,96
2,8480027,Jason Robertson,L,DAL,25,82,34,62,96
2,8477934,Leon Draisaitl,C,EDM,29,82,42,53,95
2,8477956,David Pastrnak,R,BOS,28,82,46,48,94
2,8477942,Kevin Fiala,L,LAK,28,82,32,62,94
2,8476887,Filip Forsberg,L,NSH,30,82,42,51,93
2,8473419,Brad Marchand,L,BOS,36,82,31,60,91
2,8480069,Cale Makar,D,COL,26,82,26,65,91
2,8476460,Mark Scheifele,C,WPG,31,82,33,56,89
2,8476539,Jonathan Marchessault,R,NSH,34,82,43,45,88
2,8475166,John Tavares,C,TOR,34,82,32,56,88
2,8477501,Valeri Nichushkin,R,COL,29,82,46,41,87
2,8476459,Mika Zibanejad,C,NYR,31,82,32,54,86
2,8476853,Morgan Rielly,D,TOR,30,82,15,71,86
2,8479385,Jordan Kyrou,C,STL,26,82,43,42,85
2,8480002,Nico Hischier,C,NJD,25,82,26,59,85
2,8479323,Adam Fox,D,NYR,26,82,16,69,85
2,8479337,Alex DeBrincat,R,DET,27,82,37,47,84
2,8476454,Ryan Nugent-Hopkins,C,EDM,31,82,26,58,84
2,8476346,Johnny Gaudreau,L,CBJ,31,82,15,69,84
2,8480801,Brady Tkachuk,L,OTT,25,82,39,44,83
2,8477402,Pavel Buchnevich,L,STL,29,82,28,55,83
2,8482116,Tim Stützle,C,OTT,22,82,27,55,82
2,8480800,Quinn Hughes,D,VAN,25,82,14,68,82
2,8480036,Miro Heiskanen,D,DAL,25,82,14,68,82
2,8477933,Sam Reinhart,C,FLA,29,82,37,44,81
2,8478010,Brayden Point,C,TBL,28,82,36,44,80
2,8474141,Patrick Kane,R,DET,36,82,32,48,80
2,8482097,Jack Quinn,R,BUF,23,82,31,49,80
2,8477951,Nick Schmaltz,C,UTA,28,82,36,43,79
2,8480803,Evan Bouchard,D,EDM,25,82,19,60,79
2,8478449,Roope Hintz,C,DAL,28,82,40,38,78
2,8479420,Tage Thompson,C,BUF,27,82,37,40,77
2,8475810,Bryan Rust,R,PIT,32,82,35,42,77
2,8475172,Nazem Kadri,C,CGY,34,82,33,44,77
2,8480208,Drake Batherson,R,OTT,26,82,33,44,77
2,8475765,Vladimir Tarasenko,R,DET,33,82,27,50,77
2,8476456,Jonathan Huberdeau,C,CGY,31,82,19,57,76
2,8481523,Kirby Dach,C,MTL,23,82,13,63,76
2,8474564,Steven Stamkos,C,NSH,34,82,38,37,75
2,8478403,Jack Eichel,C,VGK,28,82,36,39,75
2,8477949,Alex Tuch,R,BUF,28,82,28,47,75
2,8477494,Jonathan Drouin,L,COL,29,82,19,56,75
2,8475798,Mikael Granlund,C,SJS,32,82,16,59,75
2,8479542,Brandon Hagel,L,TBL,26,82,38,36,74
2,8478444,Brock Boeser,R,VAN,27,82,34,40,74
2,8475726,Tyler Toffoli,C,SJS,32,82,33,41,74
2,8477960,Adrian Kempe,R,LAK,28,82,31,43,74
2,8475692,Mats Zuccarello,R,MIN,37,82,17,56,73
2,8477504,Josh Morrissey,D,WPG,29,82,16,57,73
2,8474586,Jordan Eberle,R,SEA,34,82,28,44,72
2,8478460,Zach Werenski,D,CBJ,27,82,19,53,72
2,8480839,Rasmus Dahlin,D,BUF,24,82,17,55,72
2,8477409,Carter Verhaeghe,C,FLA,29,82,34,37,71
2,8475184,Chris Kreider,L,NYR,33,82,43,27,70
2,8478414,Timo Meier,R,NJD,28,82,39,31,70
2,8475754,Brock Nelson,C,NYI,33,82,33,37,70
2,8478873,Troy Terry,R,ANA,27,82,26,44,70
2,8471215,Evgeni Malkin,C,PIT,38,82,26,44,70
2,8476448,William Karlsson,C,VGK,31,82,26,44,70
2,8475158,Ryan O'Reilly,C,NSH,33,82,24,46,70
2,8480830,Andrei Svechnikov,R,CAR,24,82,23,47,70
2,8471724,Kris Letang,D,PIT,37,82,11,59,70
2,8480014,Gabriel Vilardi,C,WPG,25,82,37,32,69
2,8475168,Matt Duchene,C,DAL,33,82,30,39,69
2,8482093,Seth Jarvis,C,CAR,22,82,26,43,69
2,8477940,Nikolaj Ehlers,L,WPG,28,82,24,45,69
2,8475913,Mark Stone,R,VGK,32,82,21,48,69
2,8481540,Cole Caufield,R,MTL,23,82,38,30,68
2,8477500,Bo Horvat,C,NYI,29,82,37,31,68
2,8471214,Alex Ovechkin,L,WSH,39,82,35,33,68
2,8478398,Kyle Connor,L,WPG,28,82,31,37,68
2,8481528,Dylan Cozens,C,BUF,23,82,28,40,68
2,8475167,Victor Hedman,D,TBL,34,82,13,55,68
2,8482113,Anton Lundell,C,FLA,23,82,29,38,67
2,8477404,Jake Guentzel,C,TBL,30,82,25,42,67
2,8471685,Anze Kopitar,C,LAK,37,82,25,42,67
2,8474578,Erik Karlsson,D,PIT,34,82,19,48,67
2,8475786,Zach Hyman,L,EDM,32,82,31,35,66
2,8477935,Sam Bennett,C,FLA,28,82,29,37,66
2,8477497,Sean Monahan,C,CBJ,30,82,24,42,66
2,8479400,Pierre-Luc Dubois,L,WSH,26,82,24,42,66
2,8479999,Casey Mittelstadt,C,COL,26,82,17,49,66
2,8475784,Jeff Skinner,C,EDM,32,82,38,27,65
2,8477407,Anthony Duclair,L,NYI,29,82,32,33,65
2,8475170,Brayden Schenn,C,STL,33,82,30,35,65
2,8482078,Lucas Raymond,L,DET,22,82,28,37,65
2,8477496,Elias Lindholm,C,BOS,30,82,27,38,65
2,8476880,Tom Wilson,R,WSH,30,82,33,31,64
2,8476389,Vincent Trocheck,C,NYR,31,82,29,34,63
2,8482665,Matty Beniers,C,SEA,22,82,26,37,63
2,8478469,Thomas Chabot,D,OTT,27,82,19,44,63
2,8482124,Quinton Byfield,R,LAK,22,82,21,41,62
2,8478047,Michael Bunting,L,PIT,29,82,28,33,61
2,8478493,Joel Eriksson Ek,C,MIN,27,82,25,36,61
2,8478438,Tommy Novak,C,NSH,27,82,21,40,61
2,8477447,Shea Theodore,D,VGK,29,82,13,48,61
2,8480865,Noah Dobson,D,NYI,24,82,10,51,61
2,8475794,Tyler Seguin,C,DAL,32,82,26,34,60
2,8481596,Shane Pinto,C,OTT,24,82,21,39,60
2,8479325,Charlie McAvoy,D,BOS,27,82,17,43,60
2,8479410,Mikhail Sergachev,D,UTA,26,82,10,50,60
2,8480018,Nick Suzuki,C,MTL,25,82,19,40,59
2,8481542,Moritz Seider,D,DET,23,82,5,54,59
2,8482109,Alexis Lafrenière,L,NYR,23,82,35,23,58
2,8479675,Trevor Moore,L,LAK,29,82,33,25,58
2,8481068,Yegor Sharangovich,C,CGY,26,82,32,26,58
2,8480015,Owen Tippett,R,PHI,25,82,30,28,58
2,8478975,Mason Marchment,L,DAL,29,82,25,33,58
2,8480064,Josh Norris,C,OTT,25,82,24,34,58
2,8478439,Travis Konecny,R,PHI,27,82,23,35,58
2,8474150,Mikael Backlund,C,CGY,35,82,19,39,58
2,8474590,John Carlson,D,WSH,34,82,15,43,58
2,8475722,Jason Zucker,L,BUF,32,82,30,27,57
2,8476882,Teuvo Teravainen,L,CHI,30,82,27,30,57
2,8480188,Fabian Zetterlund,L,SJS,25,82,25,32,57
2,8479345,Jakob Chychrun,D,WSH,26,82,14,43,57
2,8478440,Dylan Strome,C,WSH,27,82,24,32,56
2,8475191,Reilly Smith,R,NYR,33,82,23,33,56
2,8478542,Evan Rodrigues,C,FLA,31,82,22,34,56
2,8478458,Jack Roslovic,C,CAR,27,82,18,38,56
2,8473986,Alex Killorn,L,ANA,35,82,17,39,56
2,8479339,Patrik Laine,L,CBJ,26,82,27,28,55
2,8478474,Lawson Crouse,L,UTA,27,82,26,29,55
2,8477955,Jared McCann,L,SEA,28,82,20,35,55
2,8480798,Philipp Kurashev,C,CHI,25,82,20,35,55
2,8473512,Claude Giroux,R,OTT,36,82,18,37,55
2,8477932,Aaron Ekblad,D,FLA,28,82,17,38,55
2,8478055,Gustav Forsling,D,FLA,28,82,17,38,55
2,8478407,Vince Dunn,D,SEA,28,82,10,45,55
2,8477476,Artturi Lehkonen,L,COL,29,82,29,25,54
2,8475151,Kyle Palmieri,C,NYI,33,82,29,25,54
2,8474053,Logan Couture,C,SJS,35,82,28,26,54
2,8481711,Matias Maccelli,L,UTA,24,82,23,31,54
2,8480797,Joel Farabee,L,PHI,24,82,19,35,54
2,8482684,Luke Hughes,D,NJD,21,82,17,37,54
2,8478401,Pavel Zacha,C,BOS,27,82,15,39,54
2,8478498,Jake DeBrusk,L,VAN,28,82,28,25,53
2,8483808,Andrei Kuzmenko,L,CGY,28,82,26,27,53
2,8482740,Wyatt Johnston,C,DAL,21,82,24,29,53
2,8480078,Filip Chytil,C,NYR,25,82,23,30,53
2,8476462,Dougie Hamilton,D,NJD,31,82,20,33,53
2,8478042,Viktor Arvidsson,R,EDM,31,82,17,36,53
2,8476881,Tomas Hertl,C,VGK,31,82,31,21,52
2,8477964,Ivan Barbashev,C,VGK,29,82,23,29,52
2,8476905,Chandler Stephenson,C,SEA,30,82,20,32,52
2,8476792,Torey Krug,D,STL,33,82,13,39,52
2,8480829,Jesperi Kotkaniemi,C,CAR,24,82,22,29,51
2,8477503,Max Domi,C,TOR,29,82,16,35,51
2,8476872,Scott Laughton,C,PHI,30,82,16,35,51
2,8480434,Sean Durzi,D,UTA,26,82,11,40,51
2,8477346,MacKenzie Weegar,D,CGY,30,82,9,42,51
2,8482149,Cole Perfetti,C,WPG,22,82,26,24,50
2,8477998,Warren Foegele,L,LAK,28,82,21,29,50
2,8477416,Oliver Bjorkstrand,R,SEA,29,82,18,32,50
2,8476875,Mike Matheson,D,MTL,30,82,8,42,50
2,8475764,Cam Fowler,D,ANA,33,82,8,42,50
2,8475314,Anders Lee,L,NYI,34,82,28,21,49
2,8475791,Taylor Hall,L,CHI,33,82,28,21,49
2,8474565,Alex Pietrangelo,D,VGK,34,82,8,41,49
2,8475799,Nino Niederreiter,R,WPG,32,82,32,16,48
2,8478366,Frank Vatrano,R,ANA,30,82,29,19,48
2,8482159,Tyson Foerster,R,PHI,22,82,27,21,48
2,8482175,JJ Peterka,R,BUF,22,82,21,27,48
2,8481533,Trevor Zegras,C,ANA,23,82,19,29,48
2,8478233,Andrew Mangiapane,L,WSH,28,82,19,29,48
2,8476906,Shayne Gostisbehere,D,CAR,31,82,13,35,48
2,8473994,Jamie Benn,L,DAL,35,82,13,35,48
2,8475745,Charlie Coyle,C,BOS,32,82,21,26,47
2,8477479,Tyler Bertuzzi,L,CHI,29,82,16,31,47
2,8478472,Mathieu Joseph,R,STL,27,82,10,37,47
2,8476479,Phillip Danault,C,LAK,31,82,24,22,46
2,8476399,Blake Coleman,C,CGY,33,82,24,22,46
2,8475714,Calle Jarnkrok,C,TOR,33,82,23,23,46
2,8475287,Erik Haula,L,NJD,33,82,21,25,46
2,8478413,Jordan Greenway,L,BUF,27,82,21,25,46
2,8479992,Michael Rasmussen,C,DET,25,82,19,27,46
2,8475763,Kevin Hayes,R,PIT,32,82,19,27,46
2,8473563,Nicklas Backstrom,C,WSH,37,82,17,29,46
2,8476927,Teddy Blueger,C,VAN,30,82,17,29,46
2,8475218,Mattias Ekholm,D,EDM,34,82,11,35,46
2,8477495,Seth Jones,D,CHI,30,82,10,36,46
2,8474563,Drew Doughty,D,LAK,35,82,9,37,46
2,8475169,Evander Kane,L,EDM,33,82,27,18,45
2,8478519,Anthony Cirelli,C,TBL,27,82,26,19,45
2,8481535,Nils Hoglander,L,VAN,24,82,21,24,45
2,8478856,Conor Garland,R,VAN,28,82,20,25,45
2,8480849,Barrett Hayton,C,UTA,24,82,17,28,45
2,8474679,Gustav Nyquist,C,NSH,35,82,15,30,45
2,8470613,Brent Burns,D,CAR,39,82,12,33,45
2,8476432,Boone Jenner,C,CBJ,31,82,33,11,44
2,8477511,Anthony Mantha,R,CGY,30,82,22,22,44
2,8480113,Alex Iafallo,L,WPG,31,82,20,24,44
2,8480220,Noah Cates,L,PHI,25,82,20,24,44
2,8479525,Ross Colton,C,COL,28,82,19,25,44
2,8478057,Dakota Joshua,C,VAN,28,82,17,27,44
2,8476458,Ryan Strome,C,ANA,31,82,16,28,44
2,8477021,Alex Kerfoot,C,UTA,30,82,16,28,44
2,8478462,Nicolas Roy,C,VGK,27,82,15,29,44
2,8475149,Marcus Johansson,L,MIN,34,82,14,30,44
2,8478911,Matt Roy,D,WSH,29,82,10,34,44
2,8476958,Jaccob Slavin,D,CAR,30,82,7,37,44
2,8480802,Ryan McLeod,C,BUF,25,82,23,20,43
2,8479996,Cody Glass,C,NSH,25,82,23,20,43
2,8476483,Rickard Rakell,R,PIT,31,82,22,21,43
2,8477444,Andre Burakovsky,L,SEA,29,82,22,21,43
2,8480459,Pius Suter,C,VAN,28,82,22,21,43
2,8482110,Dawson Mercer,C,NJD,23,82,21,22,43
2,8482705,Cole Sillinger,C,CBJ,21,82,21,22,43
2,8481186,Logan O'Connor,R,COL,28,82,17,26,43
2,8476292,Ondrej Palat,L,NJD,33,82,11,32,43
2,8481546,Cam York,D,PHI,23,82,11,32,43
2,8479425,Filip Hronek,D,VAN,27,82,8,35,43
2,8478397,Rasmus Andersson,D,CGY,28,82,7,36,43
2,8476917,Adam Pelech,D,NYI,30,82,6,37,43
2,8480039,Martin Necas,C,CAR,25,82,22,20,42
2,8482745,Mason McTavish,C,ANA,21,82,18,24,42
2,8482146,Luke Evangelista,R,NSH,22,82,18,24,42
2,8481656,Aliaksei Protas,C,WSH,23,82,11,31,42
2,8478396,Noah Hanifin,D,VGK,27,82,10,32,42
2,8482671,Owen Power,D,BUF,22,82,9,33,42
2,8476438,Brandon Saad,L,STL,32,82,23,18,41
2,8480835,Jack Drury,C,CAR,24,82,23,18,41
2,8482699,Dylan Guenther,R,UTA,21,82,19,22,41
2,8477451,Ryan Hartman,R,MIN,30,82,18,23,41
2,8481581,Thomas Harley,D,DAL,23,82,15,26,41
2,8476925,Colton Sissons,C,NSH,31,82,13,28,41
2,8480817,K'Andre Miller,D,NYR,24,82,7,34,41
2,8478038,Devon Toews,D,COL,30,82,5,36,41
2,8481582,Nicholas Robertson,L,TOR,23,82,22,18,40
2,8481560,Arthur Kaliyev,R,LAK,23,82,18,22,40
2,8477426,Nicholas Paul,L,TBL,29,82,17,23,40
2,8480028,Morgan Frost,C,PHI,25,82,17,23,40
2,8477986,Brandon Montour,D,SEA,30,82,11,29,40
2,8480145,Neal Pionk,D,WPG,29,82,4,36,40
2,8480043,Timothy Liljegren,D,TOR,25,82,4,36,40
2,8482089,Jake Neighbours,L,STL,22,82,26,13,39
2,8474641,Adam Henrique,C,EDM,34,82,22,17,39
2,8475768,Jaden Schwartz,C,SEA,32,82,22,17,39
2,8479987,Morgan Geekie,C,BOS,26,82,18,21,39
2,8484144,Connor Bedard,C,CHI,19,82,18,21,39
2,8478463,Anthony Beauvillier,L,PIT,27,82,17,22,39
2,8476826,Yanni Gourde,C,SEA,33,82,15,24,39
2,8476869,Brady Skjei,D,NSH,30,82,14,25,39
2,8476480,Vladislav Namestnikov,C,WPG,32,82,12,27,39
2,8482105,Jake Sanderson,D,OTT,22,82,11,28,39
2,8477429,Andrew Copp,C,DET,30,82,11,28,39
2,8475753,Justin Faulk,D,STL,32,82,10,29,39
2,8476931,Jake McCabe,D,TOR,31,82,6,33,39
2,8475848,Brendan Gallagher,R,MTL,32,82,19,19,38
2,8481553,Bobby Brink,R,PHI,23,82,12,26,38
2,8476885,Jacob Trouba,D,NYR,30,82,9,29,38
2,8473422,Nick Foligno,L,CHI,37,82,18,19,37
2,8478046,Danton Heinen,L,VAN,29,82,16,21,37
2,8475220,Marcus Foligno,L,MIN,33,82,15,22,37
2,8474716,Jared Spurgeon,D,MIN,35,82,11,26,37
2,8478891,Mason Appleton,C,WPG,28,82,9,28,37
2,8476979,Erik Gustafsson,D,DET,32,82,8,29,37
2,8479398,Samuel Girard,D,COL,26,82,6,31,37
2,8482475,Yegor Chinakhov,R,CBJ,23,82,26,10,36
2,8481618,Alex Newhook,C,MTL,23,82,18,18,36
2,8477952,Robby Fabbri,C,ANA,28,82,16,20,36
2,8471698,T.J. Oshie,R,WSH,38,82,16,20,36
2,8477987,Ryan Donato,C,CHI,28,82,15,21,36
2,8482720,Matthew Knies,L,TOR,22,82,14,22,36
2,8481624,Ilya Mikheyev,R,CHI,30,82,13,23,36
2,8475171,Oliver Ekman-Larsson,D,TOR,33,82,11,25,36
2,8477947,Sonny Milano,L,WSH,28,82,10,26,36
2,8475200,Dmitry Orlov,D,CAR,33,82,9,27,36
2,8480073,Erik Brannstrom,D,COL,25,82,7,29,36
2,8479390,Taylor Raddysh,R,WSH,26,82,22,13,35
2,8481013,Jonatan Berggren,R,DET,24,82,19,16,35
2,8477903,Garnet Hathaway,R,PHI,33,82,18,17,35
2,8476897,Oskar Sundqvist,C,STL,30,82,17,18,35
2,8480185,Eetu Luostarinen,C,FLA,26,82,15,20,35
2,8483515,Juraj Slafkovsky,L,MTL,20,82,15,20,35
2,8482667,William Eklund,L,SJS,22,82,14,21,35
2,8476461,Sean Couturier,C,PHI,32,82,10,25,35
2,8479351,Sam Steel,C,DAL,26,82,9,26,35
2,8480871,Adam Boqvist,D,FLA,24,82,8,27,35
2,8480873,Rasmus Sandin,D,WSH,24,82,3,32,35
2,8476474,Stefan Noesen,R,NJD,31,82,20,14,34
2,8481580,Connor McMichael,C,WSH,23,82,20,14,34
2,8480009,Eeli Tolvanen,R,SEA,25,82,19,15,34
2,8473533,Jordan Staal,C,CAR,36,82,16,18,34
2,8479365,Trent Frederic,C,BOS,26,82,15,19,34
2,8482117,Lukas Reichel,L,CHI,22,82,14,20,34
2,8474189,Lars Eller,C,PIT,35,82,13,21,34
2,8482092,Ridly Greig,C,OTT,22,82,13,21,34
2,8479941,Justin Danforth,R,CBJ,31,82,12,22,34
2,8478115,Pierre Engvall,L,NYI,28,82,12,22,34
2,8477456,J.T. Compher,L,DET,29,82,11,23,34
2,8479414,Nathan Bastian,R,NJD,27,82,11,23,34
2,8475181,Nick Leddy,D,STL,33,82,3,31,34
2,8476469,Joel Armia,R,MTL,31,82,20,13,33
2,8481032,Paul Cotter,C,NJD,25,82,18,15,33
2,8474149,Evgenii Dadonov,R,DAL,35,82,16,17,33
2,8470621,Corey Perry,R,EDM,39,82,16,17,33
2,8476419,Jean-Gabriel Pageau,C,NYI,32,82,14,19,33
2,8480806,Isac Lundestrom,C,ANA,25,82,14,19,33
2,8476624,Barclay Goodrow,C,SJS,31,82,14,19,33
2,8477508,Curtis Lazar,C,NJD,29,82,13,20,33
2,8477953,Kasperi Kapanen,R,STL,28,82,13,20,33
2,8476331,Dylan DeMelo,D,WPG,31,82,8,25,33
2,8476854,Hampus Lindholm,D,BOS,30,82,7,26,33
2,8478013,Jake Walman,D,SJS,28,82,6,27,33
2,8481178,Egor Zamula,D,PHI,24,82,5,28,33
2,8481093,Rafael Harvey-Pinard,L,MTL,25,82,21,11,32
2,8480893,Kirill Marchenko,R,CBJ,24,82,19,13,32
2,8481604,Pavel Dorofeyev,L,VGK,24,82,17,15,32
2,8479591,Michael Eyssimont,C,TBL,28,82,15,17,32
2,8475193,Tomas Tatar,L,NJD,34,82,13,19,32
2,8477498,Darnell Nurse,D,EDM,29,82,12,20,32
2,8477220,Nate Schmidt,D,FLA,33,82,11,21,32
2,8482133,Thomas Bordeleau,C,SJS,22,82,10,22,32
2,8476329,Travis Boyd,C,MIN,31,82,8,24,32
2,8477506,Ryan Pulock,D,NYI,30,82,6,26,32
2,8477969,Marcus Pettersson,D,PIT,28,82,5,27,32
2,8476923,Damon Severson,D,CBJ,30,82,3,29,32
2,8478507,John Marino,D,UTA,27,82,3,29,32
2,8482055,Drew O'Connor,L,PIT,26,82,18,13,31
2,8482259,Bobby McMann,C,TOR,28,82,17,14,31
2,8479293,Brandon Tanev,L,SEA,33,82,16,15,31
2,8483431,Logan Cooley,C,UTA,20,82,16,15,31
2,8479661,Tanner Jeannot,L,LAK,27,82,16,15,31
2,8475760,Nick Bjugstad,C,UTA,32,82,14,17,31
2,8476873,Mark Jankowski,C,NSH,30,82,9,22,31
2,8475793,Ryan Johansen,C,PHI,32,82,8,23,31
2,8476902,Esa Lindell,D,DAL,30,82,6,25,31
2,8480035,Henri Jokiharju,D,BUF,25,82,5,26,31
2,8478399,Jonas Siegenthaler,D,NJD,27,82,1,30,31
2,8476921,Jordan Martinook,L,CAR,32,82,20,10,30
2,8478508,Yakov Trenin,C,MIN,27,82,16,14,30
2,8474102,David Perron,L,OTT,36,82,15,15,30
2,8480748,Kiefer Sherwood,L,VAN,29,82,14,16,30
2,8480003,Jesper Boqvist,C,FLA,26,82,14,16,30
2,8481554,Kaapo Kakko,R,NYR,23,82,14,16,30
2,8480068,Ryan Poehling,C,PHI,25,82,14,16,30
2,8479316,Luke Kunin,C,SJS,27,82,13,17,30
2,8476392,Adam Lowry,C,WPG,31,82,11,19,30
2,8479371,Dante Fabbro,D,NSH,26,82,6,24,30
2,8476879,Cody Ceci,D,EDM,31,82,6,24,30
2,8478133,Jake Evans,C,MTL,28,82,5,25,30
2,8477488,Brett Pesce,D,NJD,30,82,4,26,30
2,8482073,Braden Schneider,D,NYR,23,82,3,27,30
2,8479402,Jake Bean,D,CGY,26,82,2,28,30
2,8474715,Cam Atkinson,R,TBL,35,82,23,6,29
2,8480789,Oliver Wahlstrom,R,NYI,24,82,15,14,29
2,8477450,Jason Dickinson,C,CHI,29,82,14,15,29
2,8481481,Blake Lizotte,C,PIT,27,82,14,15,29
2,8482125,Alexander Holtz,R,VGK,22,82,13,16,29
2,8481704,Juuso Parssinen,C,NSH,23,82,11,18,29
2,8482122,Brock Faber,D,MIN,22,82,10,19,29
2,8482245,Artem Zub,D,OTT,29,82,8,21,29
2,8479980,Nicolas Hague,D,VGK,26,82,7,22,29
2,8476967,Brett Kulak,D,EDM,30,82,6,23,29
2,8481606,Jordan Spence,D,LAK,23,82,4,25,29
2,8476422,Mike Reilly,D,NYI,31,82,4,25,29
2,8475231,Casey Cizikas,C,NYI,33,82,17,11,28
2,8477425,Miles Wood,L,COL,29,82,16,12,28
2,8476981,Josh Anderson,R,MTL,30,82,15,13,28
2,8479353,Brett Howden,C,VGK,26,82,15,13,28
2,8476960,Andreas Athanasiou,C,CHI,30,82,14,14,28
2,8480021,Jack Studnicka,C,LAK,25,82,12,16,28
2,8484166,Adam Fantilli,C,CBJ,20,82,11,17,28
2,8480878,Nils Lundkvist,D,DAL,24,82,11,17,28
2,8475343,Nic Dowd,C,WSH,34,82,10,18,28
2,8477435,Ryan Graves,D,PIT,29,82,8,20,28
2,8480074,Alexandre Texier,C,STL,25,82,8,20,28
2,8476457,Adam Larsson,D,SEA,32,82,3,25,28
2,8478020,Michael Amadio,C,OTT,28,82,19,8,27
2,8481477,Nico Sturm,C,SJS,29,82,14,13,27
2,8476442,Matt Nieto,L,PIT,32,82,12,15,27
2,8476278,Colin Blackwell,C,DAL,31,82,9,18,27
2,8481517,Brett Leason,R,ANA,25,82,9,18,27
2,8481522,Peyton Krebs,C,BUF,23,82,9,18,27
2,8479983,Mario Ferraro,D,SJS,26,82,8,19,27
2,8482166,Shakir Mukhamadullin,D,SJS,22,82,7,20,27
2,8476463,Jonas Brodin,D,MIN,31,82,5,22,27
2,8478882,Vladislav Gavrikov,D,LAK,29,82,4,23,27
2,8477948,Travis Sanheim,D,PHI,28,82,3,24,27
2,8482087,Kaiden Guhle,D,MTL,22,82,3,24,27
2,8481568,Alex Vlasic,D,CHI,23,82,3,24,27
2,8482655,J.J. Moser,D,TBL,24,82,2,25,27
2,8477353,Tyler Motte,C,DET,29,82,17,9,26
2,8480995,Pontus Holmberg,R,TOR,25,82,11,15,26
2,8475855,Jesper Fast,R,CAR,33,82,10,16,26
2,8476312,Josh Manson,D,COL,33,82,8,18,26
2,8477507,Nikita Zadorov,D,BOS,29,82,7,19,26
2,8478851,Alexandre Carrier,D,NSH,28,82,6,20,26
2,8470600,Ryan Suter,D,STL,39,82,5,21,26
2,8478500,Ivan Provorov,D,CBJ,27,82,4,22,26
2,8476892,Colton Parayko,D,STL,31,82,4,22,26
2,8479998,Mikey Anderson,D,LAK,25,82,0,26,26
2,8482079,Marco Rossi,C,MIN,23,82,16,9,25
2,8482077,Dylan Holloway,L,EDM,23,82,16,9,25
2,8476918,Jimmy Vesey,L,NYR,31,82,13,12,25
2,8477931,Tomas Nosek,L,FLA,32,82,9,16,25
2,8477989,Christian Dvorak,C,MTL,28,82,8,17,25
2,8482803,Olen Zellweger,D,ANA,21,82,8,17,25
2,8475279,Ben Chiarot,D,DET,33,82,8,17,25
2,8482666,Scott Morrow,D,CAR,22,82,6,19,25
2,8475324,Nick Jensen,D,OTT,34,82,5,20,25
2,8474574,Tyler Myers,D,VAN,34,82,3,22,25
2,8475690,Chris Tanev,D,TOR,35,82,3,22,25
2,8478432,Christian Fischer,R,DET,27,82,16,8,24
2,8482624,Daniil Miromanov,D,CGY,27,82,9,15,24
2,8482074,Connor Zary,C,CGY,23,82,9,15,24
2,8482660,Kent Johnson,C,CBJ,22,82,8,16,24
2,8482111,Justin Barron,D,MTL,23,82,7,17,24
2,8476467,Jamie Oleksiak,D,SEA,32,82,7,17,24
2,8479393,Noah Gregor,C,OTT,26,82,7,17,24
2,8482062,Cole Smith,L,NSH,29,82,7,17,24
2,8481567,Henry Thrun,D,SJS,23,82,7,17,24
2,8474013,Ian Cole,D,UTA,35,82,4,20,24
2,8477845,Trevor van Riemsdyk,D,WSH,33,82,3,21,24
2,8480049,Dylan Samberg,D,WPG,25,82,2,22,24
2,8480950,Ilya Lyubushkin,D,DAL,30,82,2,22,24
2,8473507,Jeff Petry,D,DET,37,82,1,23,24
2,8484153,Leo Carlsson,C,ANA,20,82,9,14,23
2,8482762,Simon Edvinsson,D,DET,21,82,9,14,23
2,8484203,Bradly Nadeau,L,CAR,19,82,8,15,23
2,8483490,Pavel Mintyukov,D,ANA,21,82,6,17,23
2,8475188,Brayden McNabb,D,VGK,33,82,5,18,23
2,8479576,Vincent Desharnais,D,VAN,28,82,3,20,23
2,8483445,Cutter Gauthier,L,ANA,20,82,12,10,22
2,8478109,Victor Olofsson,L,VGK,29,82,11,11,22
2,8482702,Logan Stankoven,C,DAL,21,82,9,13,22
2,8476374,Sean Kuraly,C,CBJ,31,82,8,14,22
2,8480855,Jack McBain,C,UTA,24,82,7,15,22
2,8477919,Frederick Gaudreau,C,MIN,31,82,6,16,22
2,8476889,Radek Faksa,C,STL,30,82,6,16,22
2,8482142,Jamie Drysdale,D,PHI,22,82,6,16,22
2,8478178,Darren Raddysh,D,TBL,28,82,6,16,22
2,8480879,Jacob Bernard-Docker,D,OTT,24,82,5,17,22
2,8483565,Nick Blankenburg,D,NSH,26,82,4,18,22
2,8474151,Ryan McDonagh,D,TBL,35,82,3,19,22
2,8478136,Jake Middleton,D,MIN,28,82,3,19,22
2,8479976,Juuso Valimaki,D,UTA,26,82,2,20,22
2,8476891,Matt Grzelcyk,D,PIT,30,82,2,20,22
2,8476858,Phillip Di Giuseppe,L,VAN,31,82,12,9,21
2,8477406,Mattias Janmark,C,EDM,32,82,10,11,21
2,8478434,Keegan Kolesar,R,VGK,27,82,10,11,21
2,8483457,Lane Hutson,D,MTL,20,82,9,12,21
2,8480336,Sean Walker,D,CAR,30,82,7,14,21
2,8480980,Connor Dewar,C,TOR,25,82,7,14,21
2,8481708,Zac Jones,D,NYR,24,82,5,16,21
2,8478840,Will Borgen,D,SEA,28,82,4,17,21
2,8480281,Alexey Toropchenko,R,STL,25,82,15,5,20
2,8482155,Alex Laferriere,R,LAK,23,82,15,5,20
2,8480144,David Kampf,C,TOR,29,82,11,9,20
2,8482809,Jackson Blake,R,CAR,21,82,11,9,20
2,8480796,Martin Fehervary,D,WSH,25,82,10,10,20
2,8478569,Noel Acciari,C,PIT,33,82,9,11,20
2,8484145,Zach Benson,L,BUF,19,82,8,12,20
2,8480025,MacKenzie Entwistle,R,FLA,25,82,7,13,20
2,8482858,Ryker Evans,D,SEA,23,82,7,13,20
2,8480860,Kevin Bahl,D,CGY,24,82,6,14,20
2,8484911,Collin Graf,R,SJS,22,82,5,15,20
2,8478443,Brandon Carlo,D,BOS,28,82,4,16,20
2,8477839,Conor Sheary,L,TBL,32,82,4,16,20
2,8480246,Nick Perbix,D,TBL,26,82,3,17,20
2,8475842,Sam Carrick,C,NYR,32,82,12,7,19
2,8483397,Marc McLaughlin,C,BOS,25,82,9,10,19
2,8481524,Bowen Byram,D,BUF,23,82,6,13,19
2,8483482,Tristan Luneau,D,ANA,20,82,6,13,19
2,8475233,David Savard,D,MTL,34,82,5,14,19
2,8483499,Liam Ohgren,L,MIN,20,82,4,15,19
2,8475455,Brenden Dillon,D,NJD,34,82,3,16,19
2,8483466,Kevin Korchinski,D,CHI,20,82,3,16,19
2,8480222,Sebastian Aho,D,PIT,28,82,1,18,19
2,8480807,Mattias Samuelsson,D,BUF,24,82,1,18,19
2,8480870,Bo Groulx,C,NYR,24,82,8,10,18
2,8482807,Ethan Del Mastro,D,CHI,21,82,7,11,18
2,8480813,Joe Veleno,C,DET,24,82,6,12,18
2,8475790,Erik Gudbranson,D,CBJ,32,82,3,15,18
2,8475718,Justin Holl,D,DET,32,82,1,17,18
2,8474673,TJ Brodie,D,CHI,34,82,1,17,18
2,8482141,Lukas Cormier,D,VGK,22,82,9,8,17
2,8479368,Max Jones,L,BOS,26,82,8,9,17
2,8483763,Maksymilian Szuber,D,UTA,22,82,7,10,17
2,8483468,Jiri Kulich,C,BUF,20,82,6,11,17
2,8482153,Brendan Brisson,C,VGK,23,82,6,11,17
2,8479369,Andrew Peeke,D,BOS,26,82,4,13,17
2,8476525,Colin Miller,D,WPG,32,82,4,13,17
2,8480834,Ty Emberson,D,SJS,24,82,3,14,17
2,8477034,Jaycob Megna,D,FLA,32,82,3,14,17
2,8479324,Ryan Lindgren,D,NYR,26,82,0,17,17
2,8482712,Oskar Olausson,R,COL,22,82,9,7,16
2,8478211,Dryden Hunt,L,CGY,29,82,6,10,16
2,8482101,Danil Gushchin,L,SJS,22,82,6,10,16
2,8483493,Frank Nazar,C,CHI,20,82,6,10,16
2,8484149,Gavin Brindley,C,CBJ,20,82,5,11,16
2,8483489,Fraser Minten,C,TOR,31,82,5,11,16
2,8477365,Connor Clifton,D,BUF,29,82,3,13,16
2,8478468,Jeremy Lauzon,D,NSH,27,82,2,14,16
2,8477015,Connor Brown,R,EDM,30,82,0,16,16
2,8480990,Declan Chisholm,D,MIN,24,82,9,6,15
2,8481028,Martin Pospisil,C,CGY,25,82,8,7,15
2,8482145,Mavrik Bourque,C,DAL,22,82,7,8,15
2,8477392,Hudson Fasching,R,NYI,29,82,6,9,15
2,8483471,Brad Lambert,C,WPG,31,82,6,9,15
2,8477335,Kyle Burroughs,D,LAK,29,82,5,10,15
2,8477499,Rasmus Ristolainen,D,PHI,30,82,5,10,15
2,8482733,Logan Mailloux,D,MTL,31,82,5,10,15
2,8481122,Simon Benoit,D,TOR,26,82,4,11,15
2,8476429,Scott Mayfield,D,NYI,32,82,3,12,15
2,8481014,Alexander Romanov,D,NYI,24,82,3,12,15
2,8483495,Simon Nemec,D,NJD,20,82,2,13,15
2,8473453,Trevor Lewis,C,LAK,37,82,8,6,14
2,8481641,Joel Kiviranta,L,COL,28,82,7,7,14
2,8480448,Parker Kelly,L,COL,25,82,6,8,14
2,8474090,Brendan Smith,D,DAL,35,82,6,8,14
2,8475177,Calvin de Haan,D,COL,33,82,5,9,14
2,8482749,Joshua Roy,R,MTL,21,82,5,9,14
2,8478859,Niko Mikkola,D,FLA,28,82,4,10,14
2,8483012,Logan Morrison,C,SEA,22,82,4,10,14
2,8482516,Matthew Kessel,D,STL,24,82,4,10,14
2,8479359,Beck Malenstyn,L,BUF,26,82,3,11,14
2,8477938,Haydn Fleury,D,WPG,28,82,3,11,14
2,8476473,Connor Murphy,D,CHI,31,82,0,14,14
2,8482659,Josh Doan,R,UTA,22,82,8,5,13
2,8482679,Matt Coronato,R,CGY,22,82,6,7,13
2,8475762,Derek Forbort,D,VAN,32,82,6,7,13
2,8482470,Ilya Solovyov,D,CGY,24,82,5,8,13
2,8476878,Zemgus Girgensons,L,TBL,30,82,4,9,13
2,8483460,David Jiricek,D,CBJ,21,82,4,9,13
2,8482713,Mackie Samoskevich,R,FLA,22,82,4,9,13
2,8483505,Matthew Poitras,C,BOS,20,82,3,10,13
2,8471677,Jack Johnson,D,CBJ,37,82,3,10,13
2,8479638,Justin Brazeau,R,BOS,26,82,6,6,12
2,8480172,Jan Rutta,D,SJS,34,82,4,8,12
2,8478450,Parker Wotherspoon,D,BOS,27,82,3,9,12
2,8481601,Simon Holmstrom,R,NYI,23,82,2,10,12
2,8477369,Carson Soucy,D,VAN,30,82,2,10,12
2,8476441,Joel Edmundson,D,LAK,31,82,2,10,12
2,8483524,Shane Wright,C,SEA,20,82,4,7,11
2,8482787,Nikita Chibrikov,R,WPG,31,82,4,7,11
2,8481605,Jackson LaCombe,D,ANA,23,82,3,8,11
2,8482118,Sam Colangelo,R,ANA,23,82,3,8,11
2,8474567,Zach Bogosian,D,MIN,34,82,2,9,11
2,8474612,Travis Hamonic,D,OTT,34,82,2,9,11
2,8476372,Nick Seeler,D,PHI,31,82,2,9,11
2,8477505,Alexander Wennberg,C,SJS,30,82,8,2,10
2,8483567,Georgii Merkulov,C,BOS,24,82,6,4,10
2,8482859,Zack Ostapchuk,C,OTT,21,82,4,6,10
2,8475462,Radko Gudas,D,ANA,34,82,2,8,10
2,8479442,Troy Stecher,D,EDM,30,82,2,8,10
2,8478416,Erik Cernak,D,TBL,27,82,0,10,10
2,8481699,Aku Raty,R,UTA,23,82,3,6,9
2,8474062,Riley Nash,C,NYR,35,82,3,5,8
2,8479291,Kevin Rooney,C,CGY,31,82,3,4,7
2,8482070,Mitchell Chaffee,R,TBL,26,82,3,4,7
2,8478874,Adam Gaudette,C,OTT,28,82,0,7,7
2,8476822,Luke Glendening,C,TBL,35,82,6,0,6
2,8470794,Joe Pavelski,C,,40,0,0,0,0
2,8481703,Valtteri Puustinen,R,PIT,25,0,0,0,0
2,8477950,Tony DeAngelo,D,,29,0,0,0,0
2,8481577,Philip Tomasino,C,NSH,23,0,0,0,0
2,8475197,Tyson Barrie,D,,33,0,0,0,0
2,8471218,Blake Wheeler,R,,38,0,0,0,0
2,8474157,Max Pacioretty,L,,36,0,0,0,0
2,8478466,Daniel Sprong,R,VAN,27,0,0,0,0
2,8475744,Evgeny Kuznetsov,C,,32,0,0,0,0
2,8481019,David Gustafsson,C,WPG,24,0,0,0,0
2,8475906,John Klingberg,D,,32,0,0,0,0
2,8479348,Kale Clague,D,BUF,26,0,0,0,0
2,8476952,Dominic Toninato,C,WPG,30,0,0,0,0
2,8473473,Milan Lucic,L,,36,0,0,0,0
2,8474037,James van Riemsdyk,L,,35,0,0,0,0
2,8474602,Justin Schultz,D,,34,0,0,0,0
2,8482222,Alexander Barabanov,L,,30,0,0,0,0
2,8479372,Josh Mahura,D,SEA,26,0,0,0,0
2,8479982,Conor Timmins,D,TOR,26,0,0,0,0
2,8474031,Kevin Shattenkirk,D,,35,0,0,0,0
2,8480008,Adam Ruzicka,C,,25,0,0,0,0
2,8481059,Scott Perunovich,D,STL,26,0,0,0,0
2,8480884,Calen Addison,D,,24,0,0,0,0
2,8476994,Vinnie Hinostroza,C,NSH,30,0,0,0,0
2,8478452,Caleb Jones,D,LAK,27,0,0,0,0
2,8480157,Calle Rosen,D,COL,30,0,0,0,0
2,8481609,Vladislav Kolyachonok,D,UTA,23,0,0,0,0
2,8479415,Michael McLeod,C,,26,0,0,0,0
2,8476919,Chris Tierney,C,,30,0,0,0,0
2,8479639,Dylan Coghlan,D,WPG,26,0,0,0,0
2,8478146,Matthew Highmore,C,OTT,28,0,0,0,0
2,8478970,Jalen Chatfield,D,CAR,28,0,0,0,0
2,8480205,Emil Bemstrom,C,PIT,25,0,0,0,0
2,8474884,Mike Hoffman,C,,35,0,0,0,0
2,8471274,Alex Goligoski,D,,39,0,0,0,0
2,8478104,Sammy Blais,L,,28,0,0,0,0
2,8474870,Tyler Johnson,C,,34,0,0,0,0
2,8476913,Devin Shore,C,MIN,30,0,0,0,0
2,8481598,Philip Broberg,D,EDM,23,0,0,0,0
2,8480058,Pierre-Olivier Joseph,D,STL,25,0,0,0,0
2,8480891,Michael Kesselring,D,UTA,24,0,0,0,0
2,8477979,Nicolas Aube-Kubel,R,BUF,28,0,0,0,0
2,8476871,Tanner Pearson,L,,32,0,0,0,0
2,8476393,Nick Cousins,C,,31,0,0,0,0
2,8479977,Kailer Yamamoto,R,,26,0,0,0,0
2,8479543,Michael Pezzetta,L,MTL,26,0,0,0,0
2,8477018,Ben Hutton,D,VGK,31,0,0,0,0
2,8480762,Eric Robinson,L,CAR,29,0,0,0,0
2,8474034,Pat Maroon,L,CHI,36,0,0,0,0
2,8481058,Jesse Ylönen,R,,25,0,0,0,0
2,8475179,Dmitry Kulikov,D,FLA,34,0,0,0,0
2,8481527,Kaedan Korczak,D,VGK,23,0,0,0,0
2,8473449,Kyle Okposo,R,,36,0,0,0,0
2,8482192,Isaak Phillips,D,CHI,23,0,0,0,0
2,8480727,Zach Whitecloud,D,VGK,28,0,0,0,0
2,8479346,Dillon Dube,C,,26,0,0,0,0
2,8480821,Filip Zadina,R,,25,0,0,0,0
2,8480001,Urho Vaakanainen,D,ANA,25,0,0,0,0
2,8470966,Mark Giordano,D,,41,0,0,0,0
2,8480853,Liam Foudy,C,,24,0,0,0,0
2,8475225,Craig Smith,C,CHI,35,0,0,0,0
2,8479972,Mason Shaw,C,WPG,26,0,0,0,0
2,8478451,Ethan Bear,D,WSH,27,0,0,0,0
2,8474040,Sam Gagner,C,,35,0,0,0,0
2,8480196,Jacob Bryson,D,BUF,27,0,0,0,0
2,8479984,Cal Foote,D,,26,0,0,0,0
2,8480011,Klim Kostin,C,SJS,25,0,0,0,0
2,8482176,Wyatt Kaiser,D,CHI,22,0,0,0,0
2,8476988,Matt Benning,D,SJS,30,0,0,0,0
2,8479370,Tyson Jost,C,CAR,26,0,0,0,0
2,8477464,Nic Petan,C,,29,0,0,0,0
2,8477380,Jonny Brodzinski,C,NYR,31,0,0,0,0
2,8480070,Ian Mitchell,D,BOS,25,0,0,0,0
2,8479315,Joey Anderson,R,CHI,26,0,0,0,0
2,8478099,Kevin Labanc,R,,29,0,0,0,0
2,8476874,Olli Maatta,D,DET,30,0,0,0,0
2,8475208,Brian Dumoulin,D,ANA,33,0,0,0,0
2,8478430,Oliver Kylington,D,,27,0,0,0,0
2,8479536,Axel Jonsson-Fjallby,L,WPG,26,0,0,0,0
2,8479671,Mathieu Olivier,R,CBJ,27,0,0,0,0
2,8471709,Marc-Edouard Vlasic,D,SJS,37,0,0,0,0
2,8479328,Julien Gauthier,R,NYI,27,0,0,0,0
2,8478421,A.J. Greer,L,FLA,28,0,0,0,0
2,8477573,Nathan Walker,L,STL,30,0,0,0,0
2,8481537,Nikita Okhotiuk,D,CGY,24,0,0,0,0
2,8474166,Alec Martinez,D,CHI,37,0,0,0,0
2,8470610,Zach Parise,L,,40,0,0,0,0
2,8477478,William Carrier,L,CAR,30,0,0,0,0
2,8479344,Jesse Puljujarvi,R,PIT,26,0,0,0,0
2,8480887,Jordan Harris,D,MTL,24,0,0,0,0
2,8478502,Dennis Gilbert,D,BUF,28,0,0,0,0
2,8482730,Brandt Clarke,D,LAK,21,0,0,0,0
2,8480355,Mark Kastelic,C,BOS,25,0,0,0,0
2,8475750,Jon Merrill,D,MIN,32,0,0,0,0
2,8475164,Jakob Silfverberg,R,,34,0,0,0,0
2,8477944,Jakub Vrana,L,,28,0,0,0,0
2,8479439,Jacob MacDonald,D,COL,31,0,0,0,0
2,8474568,Luke Schenn,D,NSH,35,0,0,0,0
2,8478454,Noah Juulsen,D,VAN,27,0,0,0,0
2,8475752,Tyler Pitlick,C,,33,0,0,0,0
2,8482148,Hendrix Lapierre,C,WSH,22,0,0,0,0
2,8481167,Brayden Pachal,D,CGY,25,0,0,0,0
2,8478043,Sam Lafferty,C,BUF,29,0,0,0,0
2,8479321,Lucas Johansen,D,,27,0,0,0,0
2,8471699,Andrew Cogliano,C,,37,0,0,0,0
2,8481521,Ronnie Attard,D,PHI,25,0,0,0,0
2,8481161,Jake Christiansen,D,CBJ,25,0,0,0,0
2,8479458,Nikita Zaitsev,D,,33,0,0,0,0
2,8479619,Michael Carcone,L,UTA,28,0,0,0,0
2,8479026,Philippe Myers,D,TOR,27,0,0,0,0
2,8477330,Dominik Kubalik,L,,29,0,0,0,0
2,8481617,Vasily Podkolzin,R,VAN,23,0,0,0,0
2,8481701,Santeri Hatakka,D,NJD,23,0,0,0,0
2,8479514,Rem Pitlick,C,,27,0,0,0,0
2,8477446,Michael McCarron,R,NSH,29,0,0,0,0
2,8470604,Jeff Carter,C,,39,0,0,0,0
2,8482241,Radim Zohorna,L,,28,0,0,0,0
2,8480289,Morgan Barron,C,WPG,26,0,0,0,0
2,8479379,Givani Smith,R,SJS,26,0,0,0,0
2,8480216,Jacob Peterson,C,,25,0,0,0,0
2,8477851,Jordan Oesterle,D,BOS,32,0,0,0,0
2,8484258,Sam Malinski,D,COL,26,0,0,0,0
2,8478904,Steven Lorentz,C,,28,0,0,0,0
2,8482095,Tyler Kleven,D,OTT,22,0,0,0,0
2,8480848,Ty Dellandrea,C,SJS,24,0,0,0,0
2,8476884,Derrick Pouliot,D,,30,0,0,0,0
2,8479336,Carl Grundstrom,R,SJS,27,0,0,0,0
2,8482964,Arber Xhekaj,D,MTL,23,0,0,0,0
2,8471686,Marc Staal,D,,37,0,0,0,0
2,8477887,Patrick Brown,C,BOS,32,0,0,0,0
2,8478495,Denis Gurianov,R,,27,0,0,0,0
2,8473504,Cal Clutterbuck,R,,37,0,0,0,0
2,8481550,Adam Beckman,L,NJD,23,0,0,0,0
2,8480845,Rasmus Kupari,C,WPG,24,0,0,0,0
2,8474009,Nick Bonino,C,,36,0,0,0,0
2,8478585,Derek Ryan,C,EDM,38,0,0,0,0
2,8477962,Brendan Lemieux,L,CAR,28,0,0,0,0
2,8482861,Vincent Iorio,D,WSH,22,0,0,0,0
2,8479378,Logan Stanley,D,WPG,26,0,0,0,0
2,8473446,Erik Johnson,D,PHI,36,0,0,0,0
2,8481743,Marc Del Gaizo,D,NSH,25,0,0,0,0
2,8477384,Josh Brown,D,EDM,30,0,0,0,0
2,8482165,Yan Kuznetsov,D,CGY,22,0,0,0,0
2,8478424,Jansen Harkins,C,ANA,27,0,0,0,0
2,8482144,Jack Thompson,D,SJS,22,0,0,0,0
2,8478512,Austin Czarnik,C,,32,0,0,0,0
2,8477527,Ross Johnston,L,ANA,30,0,0,0,0
2,8479383,Boris Katchouk,L,,26,0,0,0,0
2,8482094,Daemon Hunt,D,MIN,22,0,0,0,0
2,8481719,Maxwell Crozier,D,TBL,24,0,0,0,0
2,8480192,Johnathan Kovacevic,D,NJD,27,0,0,0,0
2,8479376,Victor Mete,D,,26,0,0,0,0
2,8482511,Mason Lohrei,D,BOS,23,0,0,0,0
2,8475825,Jani Hakanpää,D,,32,0,0,0,0
2,8478021,William Lagesson,D,DET,28,0,0,0,0
2,8475795,Dylan McIlrath,D,WSH,32,0,0,0,0
2,8477846,Ryan Carpenter,C,,33,0,0,0,0
2,8481056,Spencer Stastney,D,NSH,24,0,0,0,0
2,8481564,Ryan Johnson,D,BUF,23,0,0,0,0
2,8478017,Mark Friedman,D,VAN,29,0,0,0,0
2,8479320,Max Lajoie,D,SEA,27,0,0,0,0
2,8480075,Cameron Crotty,D,MIN,25,0,0,0,0
2,8484287,Cole McWard,D,VAN,23,0,0,0,0
2,8484254,Akito Hirose,D,VAN,25,0,0,0,0
2,8483407,Brandon Scanlin,D,NYR,25,0,0,0,0
2,8480274,Philip Kemp,D,EDM,25,0,0,0,0
2,8479522,Hardy Haman Aktell,D,WSH,26,0,0,0,0
2,8480007,Jonas Rondbjerg,R,VGK,25,0,0,0,0
2,8477454,Adam Erne,L,,29,0,0,0,0
2,8481679,Maxence Guenette,D,OTT,23,0,0,0,0
2,8480441,Trey Fix-Wolansky,R,CBJ,25,0,0,0,0
2,8483546,Marshall Rifai,D,TOR,26,0,0,0,0
2,8480084,Nick DeSimone,D,NJD,30,0,0,0,0
2,8481030,Jack St. Ivany,D,PIT,25,0,0,0,0
2,8481592,Jakob Pelletier,L,CGY,23,0,0,0,0
2,8478011,Louie Belpedio,D,PHI,28,0,0,0,0
2,8477930,Pierre-Edouard Bellemare,L,,39,0,0,0,0
2,8484321,Nikolas Matinpalo,D,OTT,26,0,0,0,0
2,8482067,Connor Mackey,D,NYR,28,0,0,0,0
2,8481806,Louis Crevier,D,CHI,23,0,0,0,0
2,8484326,Patrik Koch,D,UTA,28,0,0,0,0
2,8477971,Andreas Englund,D,LAK,28,0,0,0,0
2,8481751,Lukas Rousek,R,BUF,25,0,0,0,0
2,8481006,Tyler Tucker,D,STL,24,0,0,0,0
2,8476867,Brendan Gaunce,C,MIN,30,0,0,0,0
2,8479520,Brandon Duhaime,R,WSH,27,0,0,0,0
2,8477073,Kurtis MacDermid,L,NJD,30,0,0,0,0
2,8480874,Adam Ginning,D,PHI,24,0,0,0,0
2,8477473,Justin Bailey,R,SJS,29,0,0,0,0
2,8479066,Ryan Lomberg,L,CGY,30,0,0,0,0
2,8477070,Liam O'Brien,C,UTA,30,0,0,0,0
2,8474618,Marco Scandella,D,,34,0,0,0,0
2,8475797,Jarred Tinordi,D,,32,0,0,0,0
2,8481441,Joe Snively,C,DET,28,0,0,0,0
2,8477244,Chad Ruhwedel,D,NYR,34,0,0,0,0
2,8479772,Zack MacEwen,R,OTT,28,0,0,0,0
2,8481147,Reese Johnson,C,MIN,26,0,0,0,0
2,8481043,Cole Koepke,L,BOS,26,0,0,0,0
2,8483619,Filip Roos,D,OTT,25,0,0,0,0
2,8481541,Samuel Bolduc,D,NYI,24,0,0,0,0
2,8477810,Joel Hanley,D,CGY,33,0,0,0,0
2,8476907,Mackenzie MacEachern,L,,30,0,0,0,0
2,8482652,Walker Duehr,R,CGY,27,0,0,0,0
2,8477126,Jayson Megna,C,,34,0,0,0,0
2,8483398,Declan Carlile,D,TBL,31,0,0,0,0
2,8482929,Emil Lilleberg,D,TBL,23,0,0,0,0
2,8480880,Jakub Lauko,C,MIN,24,0,0,0,0
2,8480245,Olle Lycksell,R,PHI,25,0,0,0,0
2,8480252,Cole Guttman,C,CHI,25,0,0,0,0
2,8477467,Gustav Olofsson,D,SEA,30,0,0,0,0
2,8479968,Vinni Lettieri,C,BOS,29,0,0,0,0
2,8478400,Colin White,C,,27,0,0,0,0
2,8475755,Alexander Petrovic,D,DAL,32,0,0,0,0
2,8481812,Nikolai Knyzhov,D,,27,0,0,0,0
2,8481593,Jayden Struble,D,MTL,23,0,0,0,0
2,8481532,Alex Turcotte,C,LAK,23,0,0,0,0
2,8482126,Emil Andrae,D,PHI,31,0,0,0,0
2,8479944,Zach Aston-Reese,C,VGK,30,0,0,0,0
2,8471817,Ryan Reaves,R,TOR,37,0,0,0,0
2,8481206,John Ludvig,D,PIT,24,0,0,0,0
2,8481599,Victor Soderstrom,D,UTA,23,0,0,0,0
2,8480292,Carson Meyer,R,ANA,27,0,0,0,0
2,8482496,Nils Aman,C,VAN,24,0,0,0,0
2,8479718,Alex Barré-Boulet,C,MTL,27,0,0,0,0
2,8479994,Jaret Anderson-Dolan,C,WPG,25,0,0,0,0
2,8480184,Gustav Lindstrom,D,,26,0,0,0,0
2,8480890,Jan Jenik,R,OTT,24,0,0,0,0
2,8478067,Oskar Lindblom,L,,28,0,0,0,0
2,8476934,Brock McGinn,L,ANA,30,0,0,0,0
2,8479985,Cale Fleury,D,SEA,26,0,0,0,0
2,8484304,Uvis Balinskis,D,FLA,28,0,0,0,0
2,8479981,Jonah Gadjovich,L,FLA,26,0,0,0,0
2,8481716,Dmitri Voronkov,L,CBJ,24,0,0,0,0
2,8474709,Matt Martin,L,,35,0,0,0,0
2,8482634,Alex Steeves,C,TOR,25,0,0,0,0
2,8480823,Alexander Alexeyev,D,WSH,25,0,0,0,0
2,8477541,Dakota Mermis,D,TOR,30,0,0,0,0
2,8483491,Ivan Miroshnichenko,L,WSH,20,0,0,0,0
2,8478477,Mitchell Stephens,C,SEA,27,0,0,0,0
2,8481543,Nikita Alexandrov,C,STL,24,0,0,0,0
2,8479423,Alex Nylander,L,,26,0,0,0,0
2,8482451,Mikael Pyyhtia,L,CBJ,23,0,0,0,0
2,8478831,Kevin Stenlund,C,UTA,28,0,0,0,0
2,8480306,Grant Hutton,D,NYI,29,0,0,0,0
2,8478028,Fredrik Olofsson,L,,28,0,0,0,0
2,8477462,Robert Hagg,D,VGK,29,0,0,0,0
2,8477320,Anton Blidh,L,NYR,29,0,0,0,0
2,8482157,Will Cuylle,L,NYR,22,0,0,0,0
2,8482737,Zack Bolduc,C,STL,21,0,0,0,0
2,8481239,Samuel Fagemo,L,,24,0,0,0,0
2,8481600,Tobias Bjornfot,D,FLA,23,0,0,0,0
2,8478409,Anthony Richard,C,PHI,28,0,0,0,0
2,8474145,Robert Bortuzzo,D,,35,0,0,0,0
2,8475958,Michael Sgarbossa,C,WSH,32,0,0,0,0
2,8479986,Kole Lind,R,DAL,26,0,0,0,0
2,8479249,Andrew Poturalski,C,SJS,30,0,0,0,0
2,8479362,Riley Tufte,L,BOS,26,0,0,0,0
2,8479991,Jake Leschyshyn,C,NYR,25,0,0,0,0
2,8479587,Rhett Gardner,C,PHI,28,0,0,0,0
2,8482744,James Malatesta,L,CBJ,21,0,0,0,0
2,8478854,Ryan Shea,D,PIT,27,0,0,0,0
2,8481591,Sam Poulin,R,,23,0,0,0,0
2,8483512,Matt Savoie,C,EDM,20,0,0,0,0
2,8482102,Vasily Ponomarev,C,PIT,22,0,0,0,0
2,8482162,Roby Jarventie,L,EDM,22,0,0,0,0
2,8481016,Ruslan Iskhakov,C,,24,0,0,0,0
2,8482172,Landon Slaggert,L,CHI,22,0,0,0,0
2,8482747,Brennan Othmann,L,NYR,21,0,0,0,0
2,8480031,Maxime Comtois,L,,25,0,0,0,0
2,8480226,Marián Studenic,R,,26,0,0,0,0
2,8478408,Travis Dermott,D,,28,0,0,0,0
2,8481518,Nolan Foote,L,NJD,24,0,0,0,0
2,8479419,Brett Murray,L,BUF,26,0,0,0,0
2,8482088,Justin Sourdif,R,FLA,22,0,0,0,0
2,8482201,Gage Goncalves,C,TBL,23,0,0,0,0
2,8481578,Graeme Clarke,R,MIN,23,0,0,0,0
2,8482177,Marat Khusnutdinov,C,MIN,22,0,0,0,0
2,8481754,Nikita Nesterenko,C,ANA,23,0,0,0,0
2,8483531,Brian Halonen,L,NJD,25,0,0,0,0
2,8483920,Pierrick Dube,R,WSH,23,0,0,0,0
2,8480851,Akil Thomas,C,LAK,24,0,0,0,0
2,8475235,Nicolas Deslauriers,L,PHI,33,0,0,0,0
2,8482476,Emil Heineman,L,MTL,23,0,0,0,0
2,8477149,Scott Sabourin,R,SJS,32,0,0,0,0
2,8483549,Lucas Condotta,L,MTL,27,0,0,0,0
2,8482765,Isak Rosen,R,BUF,21,0,0,0,0
2,8481237,Kyle MacLean,C,NYI,25,0,0,0,0
2,8481024,Linus Karlsson,C,VAN,25,0,0,0,0
2,8481690,Tyler Angle,C,,24,0,0,0,0
2,8483570,Ben Meyers,C,SEA,26,0,0,0,0
2,8481655,Cole Schwindt,R,CGY,23,0,0,0,0
2,8481462,Mason Morelli,L,VGK,28,0,0,0,0
2,8483401,Marc Johnstone,R,PIT,28,0,0,0,0
2,8478956,Samuel Laberge,L,NJD,27,0,0,0,0
2,8479533,Joona Koppanen,L,,26,0,0,0,0
2,8482197,Adam Raska,R,MIN,23,0,0,0,0
2,8482250,Callahan Burke,C,VGK,27,0,0,0,0
2,8482784,Zach Dean,C,STL,21,0,0,0,0
2,8484255,Jason Polin,R,COL,25,0,0,0,0
2,8481077,John Leonard,L,,26,0,0,0,0
2,8481534,Raphael Lavoie,C,EDM,24,0,0,0,0
2,8483609,Adam Klapka,R,CGY,24,0,0,0,0
2,8482751,Ryan Winterton,C,SEA,21,0,0,0,0
2,8480267,Sammy Walker,C,MIN,25,0,0,0,0
2,8475766,Austin Watson,L,,32,0,0,0,0
2,8482460,Matt Rempe,C,NYR,22,0,0,0,0
2,8481065,Angus Crookshank,L,OTT,25,0,0,0,0
2,8481070,Hugh McGing,L,,26,0,0,0,0
2,8476323,Max McCormick,L,SEA,32,0,0,0,0
2,8483395,Arshdeep Bains,L,VAN,23,0,0,0,0
2,8484259,Ondrej Pavel,C,COL,31,0,0,0,0
2,8483432,Luca Del Bel Belluz,C,CBJ,31,0,0,0,0
2,8483045,Cameron Butler,R,CBJ,31,0,0,0,0
2,8482061,Brandon Biro,L,SEA,26,0,0,0,0
2,8477401,John Hayden,C,SEA,29,0,0,0,0
2,8475278,Byron Froese,C,,33,0,0,0,0
2,8478446,Glenn Gawdin,C,LAK,27,0,0,0,0
2,8477993,Justin Kirkland,C,CGY,28,0,0,0,0
2,8482147,Jean-Luc Foudy,C,COL,22,0,0,0,0
2,8480032,Shane Bowers,C,NJD,25,0,0,0,0
2,8479330,Brandon Gignac,C,MTL,27,0,0,0,0
2,8480776,Sheldon Rempal,R,,29,0,0,0,0
2,8475413,Justin Dowling,C,NJD,34,0,0,0,0
2,8481726,Adam Edstrom,C,NYR,24,0,0,0,0
2,8480844,Grigori Denisenko,L,VGK,24,0,0,0,0
2,8478147,Bokondji Imama,L,PIT,28,0,0,0,0
2,8478881,Brett Seney,L,CHI,28,0,0,0,0
2,8483630,Pavol Regenda,L,ANA,25,0,0,0,0
2,8480836,Jonathan Gruden,C,,24,0,0,0,0
2,8484314,Jiri Smejkal,L,,28,0,0,0,0
2,8475780,Chris Wagner,R,COL,33,0,0,0,0
2,8479546,Oskar Steen,C,,26,0,0,0,0
2,8483597,Milos Kelemen,L,UTA,25,0,0,0,0
2,8481789,Tye Kartye,L,SEA,23,0,0,0,0
2,8484325,Waltteri Merela,C,TBL,26,0,0,0,0
2,8479421,Jacob Moverare,D,LAK,26,0,0,0,0
2,8481585,Egor Afanasyev,L,SJS,23,0,0,0,0
2,8479547,Matthew Phillips,R,,26,0,0,0,0
2,8479367,William Lockwood,R,FLA,26,0,0,0,0
2,8476915,Jujhar Khaira,L,,30,0,0,0,0
2,8481422,Jacob Lucchini,C,NSH,29,0,0,0,0
2,8480468,James Hamblin,L,EDM,25,0,0,0,0
2,8478051,Max Willman,C,NJD,29,0,0,0,0
2,8481556,John Beecher,C,BOS,23,0,0,0,0
2,8478078,Rourke Chartier,C,,28,0,0,0,0
3,8478402,Connor McDavid,C,EDM,27,82,50,101,151
3,8476453,Nikita Kucherov,R,TBL,31,82,40,92,132
3,8477492,Nathan MacKinnon,C,COL,29,82,49,81,130
3,8477934,Leon Draisaitl,C,EDM,29,82,44,82,126
3,8479318,Auston Matthews,C,TOR,27,82,64,51,115
3,8478420,Mikko Rantanen,R,COL,28,82,47,66,113
3,8480069,Cale Makar,D,COL,26,82,33,76,109
3,8476468,J.T. Miller,C,VAN,31,82,38,68,106
3,8480012,Elias Pettersson,C,VAN,26,82,38,68,106
3,8479314,Matthew Tkachuk,L,FLA,27,82,33,70,103
3,8477939,William Nylander,R,TOR,28,82,40,62,102
3,8480023,Robert Thomas,C,STL,25,82,25,77,102
3,8478864,Kirill Kaprizov,L,MIN,27,82,45,55,100
3,8481559,Jack Hughes,C,NJD,23,82,38,61,99
3,8471675,Sidney Crosby,C,PIT,37,82,41,57,98
3,8480027,Jason Robertson,L,DAL,25,82,36,62,98
3,8477493,Aleksander Barkov,C,FLA,29,82,32,66,98
3,8478010,Brayden Point,C,TBL,28,82,44,51,95
3,8479420,Tage Thompson,C,BUF,27,82,42,53,95
3,8477942,Kevin Fiala,L,LAK,28,82,33,62,95
3,8482116,Tim Stützle,C,OTT,22,82,32,63,95
3,8480036,Miro Heiskanen,D,DAL,25,82,25,70,95
3,8471215,Evgeni Malkin,C,PIT,38,82,32,61,93
3,8477956,David Pastrnak,R,BOS,28,82,37,54,91
3,8476459,Mika Zibanejad,C,NYR,31,82,32,59,91
3,8477409,Carter Verhaeghe,C,FLA,29,82,43,46,89
3,8477402,Pavel Buchnevich,L,STL,29,82,41,46,87
3,8478550,Artemi Panarin,L,NYR,33,82,32,55,87
3,8479343,Clayton Keller,R,UTA,26,82,36,50,86
3,8477949,Alex Tuch,R,BUF,28,82,30,56,86
3,8479407,Jesper Bratt,L,NJD,26,82,24,62,86
3,8480801,Brady Tkachuk,L,OTT,25,82,37,47,84
3,8474600,Roman Josi,D,NSH,34,82,22,62,84
3,8481557,Matt Boldy,L,MIN,23,82,45,38,83
3,8478444,Brock Boeser,R,VAN,27,82,39,44,83
3,8479385,Jordan Kyrou,C,STL,26,82,35,48,83
3,8480208,Drake Batherson,R,OTT,26,82,30,53,83
3,8480865,Noah Dobson,D,NYI,24,82,21,62,83
3,8478449,Roope Hintz,C,DAL,28,82,38,44,82
3,8474564,Steven Stamkos,C,NSH,34,82,36,46,82
3,8480800,Quinn Hughes,D,VAN,25,82,11,71,82
3,8477946,Dylan Larkin,C,DET,28,82,38,43,81
3,8477404,Jake Guentzel,C,TBL,30,82,38,43,81
3,8477933,Sam Reinhart,C,FLA,29,82,37,44,81
3,8475913,Mark Stone,R,VGK,32,82,32,49,81
3,8476454,Ryan Nugent-Hopkins,C,EDM,31,82,23,58,81
3,8477501,Valeri Nichushkin,R,COL,29,82,41,39,80
3,8477940,Nikolaj Ehlers,L,WPG,28,82,32,48,80
3,8473512,Claude Giroux,R,OTT,36,82,27,53,80
3,8479323,Adam Fox,D,NYR,26,82,23,57,80
3,8478427,Sebastian Aho,C,CAR,27,82,28,51,79
3,8476389,Vincent Trocheck,C,NYR,31,82,28,51,79
3,8475810,Bryan Rust,R,PIT,32,82,38,40,78
3,8475166,John Tavares,C,TOR,34,82,33,45,78
3,8478439,Travis Konecny,R,PHI,27,82,28,49,77
3,8471685,Anze Kopitar,C,LAK,37,82,25,51,76
3,8477960,Adrian Kempe,R,LAK,28,82,37,38,75
3,8473419,Brad Marchand,L,BOS,36,82,26,49,75
3,8475784,Jeff Skinner,C,EDM,32,82,36,38,74
3,8475168,Matt Duchene,C,DAL,33,82,27,47,74
3,8476346,Johnny Gaudreau,L,CBJ,31,82,14,60,74
3,8476853,Morgan Rielly,D,TOR,30,82,9,65,74
3,8475184,Chris Kreider,L,NYR,33,82,42,31,73
3,8479339,Patrik Laine,L,CBJ,26,82,37,36,73
3,8479425,Filip Hronek,D,VAN,27,82,9,64,73
3,8478403,Jack Eichel,C,VGK,28,82,37,35,72
3,8478414,Timo Meier,R,NJD,28,82,36,36,72
3,8475172,Nazem Kadri,C,CGY,34,82,31,41,72
3,8478398,Kyle Connor,L,WPG,28,82,30,42,72
3,8476882,Teuvo Teravainen,L,CHI,30,82,27,45,72
3,8478440,Dylan Strome,C,WSH,27,82,29,42,71
3,8473994,Jamie Benn,L,DAL,35,82,28,43,71
3,8477494,Jonathan Drouin,L,COL,29,82,20,51,71
3,8471214,Alex Ovechkin,L,WSH,39,82,38,32,70
3,8481540,Cole Caufield,R,MTL,23,82,37,33,70
3,8479675,Trevor Moore,L,LAK,29,82,33,37,70
3,8478975,Mason Marchment,L,DAL,29,82,33,37,70
3,8480002,Nico Hischier,C,NJD,25,82,28,42,70
3,8474102,David Perron,L,OTT,36,82,26,44,70
3,8475798,Mikael Granlund,C,SJS,32,82,18,52,70
3,8477500,Bo Horvat,C,NYI,29,82,43,26,69
3,8476887,Filip Forsberg,L,NSH,30,82,31,38,69
3,8480839,Rasmus Dahlin,D,BUF,24,82,18,51,69
3,8475692,Mats Zuccarello,R,MIN,37,82,15,54,69
3,8475786,Zach Hyman,L,EDM,32,82,37,31,68
3,8475167,Victor Hedman,D,TBL,34,82,16,52,68
3,8474141,Patrick Kane,R,DET,36,82,31,36,67
3,8481523,Kirby Dach,C,MTL,23,82,16,51,67
3,8476539,Jonathan Marchessault,R,NSH,34,82,34,32,66
3,8476460,Mark Scheifele,C,WPG,31,82,30,36,66
3,8478042,Viktor Arvidsson,R,EDM,31,82,30,36,66
3,8482124,Quinton Byfield,R,LAK,22,82,21,45,66
3,8478445,Mathew Barzal,C,NYI,27,82,12,54,66
3,8480015,Owen Tippett,R,PHI,25,82,38,27,65
3,8477951,Nick Schmaltz,C,UTA,28,82,22,43,65
3,8478469,Thomas Chabot,D,OTT,27,82,14,51,65
3,8474590,John Carlson,D,WSH,34,82,14,51,65
3,8482078,Lucas Raymond,L,DET,22,82,22,42,64
3,8475765,Vladimir Tarasenko,R,DET,33,82,18,46,64
3,8482740,Wyatt Johnston,C,DAL,21,82,37,26,63
3,8476399,Blake Coleman,C,CGY,33,82,35,28,63
3,8477476,Artturi Lehkonen,L,COL,29,82,30,33,63
3,8480798,Philipp Kurashev,C,CHI,25,82,23,40,63
3,8478873,Troy Terry,R,ANA,27,82,22,40,62
3,8478407,Vince Dunn,D,SEA,28,82,21,41,62
3,8477935,Sam Bennett,C,FLA,28,82,33,28,61
3,8482097,Jack Quinn,R,BUF,23,82,28,33,61
3,8481528,Dylan Cozens,C,BUF,23,82,27,34,61
3,8477496,Elias Lindholm,C,BOS,30,82,27,34,61
3,8478401,Pavel Zacha,C,BOS,27,82,27,34,61
3,8475726,Tyler Toffoli,C,SJS,32,82,24,37,61
3,8478047,Michael Bunting,L,PIT,29,82,21,40,61
3,8476462,Dougie Hamilton,D,NJD,31,82,18,43,61
3,8474565,Alex Pietrangelo,D,VGK,34,82,14,47,61
3,8482093,Seth Jarvis,C,CAR,22,82,33,27,60
3,8480028,Morgan Frost,C,PHI,25,82,21,39,60
3,8479325,Charlie McAvoy,D,BOS,27,82,11,49,60
3,8477447,Shea Theodore,D,VGK,29,82,6,54,60
3,8477416,Oliver Bjorkstrand,R,SEA,29,82,25,34,59
3,8482159,Tyson Foerster,R,PHI,22,82,26,32,58
3,8481533,Trevor Zegras,C,ANA,23,82,25,33,58
3,8475794,Tyler Seguin,C,DAL,32,82,23,35,58
3,8477497,Sean Monahan,C,CBJ,30,82,21,37,58
3,8475170,Brayden Schenn,C,STL,33,82,21,37,58
3,8476792,Torey Krug,D,STL,33,82,19,39,58
3,8478460,Zach Werenski,D,CBJ,27,82,15,43,58
3,8474578,Erik Karlsson,D,PIT,34,82,13,45,58
3,8478055,Gustav Forsling,D,FLA,28,82,12,46,58
3,8474563,Drew Doughty,D,LAK,35,82,12,46,58
3,8478366,Frank Vatrano,R,ANA,30,82,29,28,57
3,8478498,Jake DeBrusk,L,VAN,28,82,28,29,57
3,8478856,Conor Garland,R,VAN,28,82,28,29,57
3,8479542,Brandon Hagel,L,TBL,26,82,27,30,57
3,8475169,Evander Kane,L,EDM,33,82,27,30,57
3,8482667,William Eklund,L,SJS,22,82,13,44,57
3,8480803,Evan Bouchard,D,EDM,25,82,10,47,57
3,8476448,William Karlsson,C,VGK,31,82,30,26,56
3,8476432,Boone Jenner,C,CBJ,31,82,30,26,56
3,8475754,Brock Nelson,C,NYI,33,82,27,29,56
3,8478519,Anthony Cirelli,C,TBL,27,82,26,30,56
3,8481596,Shane Pinto,C,OTT,24,82,20,36,56
3,8474679,Gustav Nyquist,C,NSH,35,82,15,41,56
3,8480830,Andrei Svechnikov,R,CAR,24,82,29,26,55
3,8476479,Phillip Danault,C,LAK,31,82,20,35,55
3,8477346,MacKenzie Weegar,D,CGY,30,82,8,47,55
3,8481711,Matias Maccelli,L,UTA,24,82,17,37,54
3,8476456,Jonathan Huberdeau,C,CGY,31,82,15,39,54
3,8479999,Casey Mittelstadt,C,COL,26,82,12,42,54
3,8479345,Jakob Chychrun,D,WSH,26,82,12,42,54
3,8480064,Josh Norris,C,OTT,25,82,29,24,53
3,8475287,Erik Haula,L,NJD,33,82,28,25,53
3,8476483,Rickard Rakell,R,PIT,31,82,23,30,53
3,8476881,Tomas Hertl,C,VGK,31,82,20,33,53
3,8476880,Tom Wilson,R,WSH,30,82,28,24,52
3,8478413,Jordan Greenway,L,BUF,27,82,26,26,52
3,8482109,Alexis Lafrenière,L,NYR,23,82,22,30,52
3,8482149,Cole Perfetti,C,WPG,22,82,22,30,52
3,8479337,Alex DeBrincat,R,DET,27,82,20,32,52
3,8473986,Alex Killorn,L,ANA,35,82,19,33,52
3,8474150,Mikael Backlund,C,CGY,35,82,18,34,52
3,8480039,Martin Necas,C,CAR,25,82,18,34,52
3,8476458,Ryan Strome,C,ANA,31,82,13,39,52
3,8475314,Anders Lee,L,NYI,34,82,36,15,51
3,8477021,Alex Kerfoot,C,UTA,30,82,26,25,51
3,8477955,Jared McCann,L,SEA,28,82,22,29,51
3,8479351,Sam Steel,C,DAL,26,82,17,34,51
3,8478397,Rasmus Andersson,D,CGY,28,82,13,38,51
3,8479410,Mikhail Sergachev,D,UTA,26,82,3,48,51
3,8475151,Kyle Palmieri,C,NYI,33,82,26,24,50
3,8482745,Mason McTavish,C,ANA,21,82,24,26,50
3,8477479,Tyler Bertuzzi,L,CHI,29,82,23,27,50
3,8475722,Jason Zucker,L,BUF,32,82,21,29,50
3,8475791,Taylor Hall,L,CHI,33,82,20,30,50
3,8476826,Yanni Gourde,C,SEA,33,82,19,31,50
3,8480018,Nick Suzuki,C,MTL,25,82,18,32,50
3,8478493,Joel Eriksson Ek,C,MIN,27,82,14,36,50
3,8476905,Chandler Stephenson,C,SEA,30,82,14,36,50
3,8478038,Devon Toews,D,COL,30,82,14,36,50
3,8477932,Aaron Ekblad,D,FLA,28,82,12,38,50
3,8475753,Justin Faulk,D,STL,32,82,11,39,50
3,8482105,Jake Sanderson,D,OTT,22,82,10,40,50
3,8476438,Brandon Saad,L,STL,32,82,30,19,49
3,8480797,Joel Farabee,L,PHI,24,82,27,22,49
3,8481068,Yegor Sharangovich,C,CGY,26,82,26,23,49
3,8473422,Nick Foligno,L,CHI,37,82,26,23,49
3,8479365,Trent Frederic,C,BOS,26,82,25,24,49
3,8482475,Yegor Chinakhov,R,CBJ,23,82,21,28,49
3,8478046,Danton Heinen,L,VAN,29,82,20,29,49
3,8482665,Matty Beniers,C,SEA,22,82,19,30,49
3,8480078,Filip Chytil,C,NYR,25,82,18,31,49
3,8477504,Josh Morrissey,D,WPG,29,82,14,35,49
3,8471724,Kris Letang,D,PIT,37,82,13,36,49
3,8477947,Sonny Milano,L,WSH,28,82,27,21,48
3,8480188,Fabian Zetterlund,L,SJS,25,82,24,24,48
3,8474641,Adam Henrique,C,EDM,34,82,21,27,48
3,8479400,Pierre-Luc Dubois,L,WSH,26,82,20,28,48
3,8474053,Logan Couture,C,SJS,35,82,19,29,48
3,8477964,Ivan Barbashev,C,VGK,29,82,15,33,48
3,8481581,Thomas Harley,D,DAL,23,82,14,34,48
3,8479987,Morgan Geekie,C,BOS,26,82,25,22,47
3,8480009,Eeli Tolvanen,R,SEA,25,82,25,22,47
3,8475158,Ryan O'Reilly,C,NSH,33,82,21,26,47
3,8475745,Charlie Coyle,C,BOS,32,82,21,26,47
3,8478057,Dakota Joshua,C,VAN,28,82,21,26,47
3,8477444,Andre Burakovsky,L,SEA,29,82,20,27,47
3,8480185,Eetu Luostarinen,C,FLA,26,82,17,30,47
3,8478438,Tommy Novak,C,NSH,27,82,14,33,47
3,8477986,Brandon Montour,D,SEA,30,82,12,35,47
3,8480014,Gabriel Vilardi,C,WPG,25,82,27,19,46
3,8478474,Lawson Crouse,L,UTA,27,82,25,21,46
3,8475768,Jaden Schwartz,C,SEA,32,82,25,21,46
3,8478542,Evan Rodrigues,C,FLA,31,82,24,22,46
3,8482110,Dawson Mercer,C,NJD,23,82,24,22,46
3,8477998,Warren Foegele,L,LAK,28,82,22,24,46
3,8479992,Michael Rasmussen,C,DET,25,82,18,28,46
3,8478458,Jack Roslovic,C,CAR,27,82,16,30,46
3,8473563,Nicklas Backstrom,C,WSH,37,82,15,31,46
3,8476869,Brady Skjei,D,NSH,30,82,14,32,46
3,8482705,Cole Sillinger,C,CBJ,21,82,19,26,45
3,8471698,T.J. Oshie,R,WSH,38,82,17,28,45
3,8482175,JJ Peterka,R,BUF,22,82,15,30,45
3,8476885,Jacob Trouba,D,NYR,30,82,14,31,45
3,8480893,Kirill Marchenko,R,CBJ,24,82,26,18,44
3,8477426,Nicholas Paul,L,TBL,29,82,25,19,44
3,8482699,Dylan Guenther,R,UTA,21,82,22,22,44
3,8482113,Anton Lundell,C,FLA,23,82,17,27,44
3,8478233,Andrew Mangiapane,L,WSH,28,82,17,27,44
3,8476292,Ondrej Palat,L,NJD,33,82,16,28,44
3,8478396,Noah Hanifin,D,VGK,27,82,15,29,44
3,8477919,Frederick Gaudreau,C,MIN,31,82,13,31,44
3,8481546,Cam York,D,PHI,23,82,9,35,44
3,8476906,Shayne Gostisbehere,D,CAR,31,82,8,36,44
3,8482089,Jake Neighbours,L,STL,22,82,26,17,43
3,8477456,J.T. Compher,L,DET,29,82,23,20,43
3,8484144,Connor Bedard,C,CHI,19,82,22,21,43
3,8478462,Nicolas Roy,C,VGK,27,82,17,26,43
3,8477969,Marcus Pettersson,D,PIT,28,82,10,33,43
3,8473533,Jordan Staal,C,CAR,36,82,21,21,42
3,8478891,Mason Appleton,C,WPG,28,82,20,22,42
3,8477407,Anthony Duclair,L,NYI,29,82,17,25,42
3,8474149,Evgenii Dadonov,R,DAL,35,82,14,28,42
3,8481542,Moritz Seider,D,DET,23,82,8,34,42
3,8476958,Jaccob Slavin,D,CAR,30,82,8,34,42
3,8474586,Jordan Eberle,R,SEA,34,82,19,22,41
3,8475793,Ryan Johansen,C,PHI,32,82,17,24,41
3,8477495,Seth Jones,D,CHI,30,82,11,30,41
3,8482671,Owen Power,D,BUF,22,82,10,31,41
3,8482684,Luke Hughes,D,NJD,21,82,7,34,41
3,8482092,Ridly Greig,C,OTT,22,82,20,20,40
3,8483515,Juraj Slafkovsky,L,MTL,20,82,17,23,40
3,8476872,Scott Laughton,C,PHI,30,82,12,28,40
3,8475181,Nick Leddy,D,STL,33,82,9,31,40
3,8476392,Adam Lowry,C,WPG,31,82,9,31,40
3,8480855,Jack McBain,C,UTA,24,82,18,21,39
3,8480802,Ryan McLeod,C,BUF,25,82,17,22,39
3,8475218,Mattias Ekholm,D,EDM,34,82,15,24,39
3,8477451,Ryan Hartman,R,MIN,30,82,14,25,39
3,8476923,Damon Severson,D,CBJ,30,82,9,30,39
3,8470613,Brent Burns,D,CAR,39,82,6,33,39
3,8480849,Barrett Hayton,C,UTA,24,82,21,17,38
3,8482079,Marco Rossi,C,MIN,23,82,20,18,38
3,8479591,Michael Eyssimont,C,TBL,28,82,17,21,38
3,8481618,Alex Newhook,C,MTL,23,82,16,22,38
3,8476480,Vladislav Namestnikov,C,WPG,32,82,15,23,38
3,8475149,Marcus Johansson,L,MIN,34,82,13,25,38
3,8477429,Andrew Copp,C,DET,30,82,13,25,38
3,8477953,Kasperi Kapanen,R,STL,28,82,13,25,38
3,8478472,Mathieu Joseph,R,STL,27,82,12,26,38
3,8478115,Pierre Engvall,L,NYI,28,82,12,26,38
3,8481013,Jonatan Berggren,R,DET,24,82,11,27,38
3,8480434,Sean Durzi,D,UTA,26,82,10,28,38
3,8476875,Mike Matheson,D,MTL,30,82,8,30,38
3,8480817,K'Andre Miller,D,NYR,24,82,8,30,38
3,8475764,Cam Fowler,D,ANA,33,82,7,31,38
3,8475171,Oliver Ekman-Larsson,D,TOR,33,82,7,31,38
3,8479398,Samuel Girard,D,COL,26,82,5,33,38
3,8482146,Luke Evangelista,R,NSH,22,82,23,14,37
3,8482055,Drew O'Connor,L,PIT,26,82,20,17,37
3,8475714,Calle Jarnkrok,C,TOR,33,82,18,19,37
3,8481560,Arthur Kaliyev,R,LAK,23,82,18,19,37
3,8481656,Aliaksei Protas,C,WSH,23,82,12,25,37
3,8477503,Max Domi,C,TOR,29,82,11,26,37
3,8475799,Nino Niederreiter,R,WPG,32,82,18,18,36
3,8480459,Pius Suter,C,VAN,28,82,18,18,36
3,8481582,Nicholas Robertson,L,TOR,23,82,18,18,36
3,8481554,Kaapo Kakko,R,NYR,23,82,18,18,36
3,8476461,Sean Couturier,C,PHI,32,82,16,20,36
3,8475763,Kevin Hayes,R,PIT,32,82,15,21,36
3,8475191,Reilly Smith,R,NYR,33,82,14,22,36
3,8480220,Noah Cates,L,PHI,25,82,11,25,36
3,8476329,Travis Boyd,C,MIN,31,82,11,25,36
3,8479976,Juuso Valimaki,D,UTA,26,82,11,25,36
3,8476419,Jean-Gabriel Pageau,C,NYI,32,82,9,27,36
3,8480873,Rasmus Sandin,D,WSH,24,82,8,28,36
3,8477498,Darnell Nurse,D,EDM,29,82,7,29,36
3,8478020,Michael Amadio,C,OTT,28,82,22,13,35
3,8479525,Ross Colton,C,COL,28,82,19,16,35
3,8475760,Nick Bjugstad,C,UTA,32,82,19,16,35
3,8481186,Logan O'Connor,R,COL,28,82,18,17,35
3,8477952,Robby Fabbri,C,ANA,28,82,18,17,35
3,8481535,Nils Hoglander,L,VAN,24,82,17,18,35
3,8484145,Zach Benson,L,BUF,19,82,17,18,35
3,8478463,Anthony Beauvillier,L,PIT,27,82,14,21,35
3,8479390,Taylor Raddysh,R,WSH,26,82,13,22,35
3,8480336,Sean Walker,D,CAR,30,82,13,22,35
3,8477987,Ryan Donato,C,CHI,28,82,12,23,35
3,8482660,Kent Johnson,C,CBJ,22,82,12,23,35
3,8480043,Timothy Liljegren,D,TOR,25,82,8,27,35
3,8477511,Anthony Mantha,R,CGY,30,82,21,13,34
3,8479353,Brett Howden,C,VGK,26,82,15,19,34
3,8479996,Cody Glass,C,NSH,25,82,14,20,34
3,8482117,Lukas Reichel,L,CHI,22,82,12,22,34
3,8480068,Ryan Poehling,C,PHI,25,82,11,23,34
3,8481704,Juuso Parssinen,C,NSH,23,82,11,23,34
3,8474716,Jared Spurgeon,D,MIN,35,82,9,25,34
3,8477839,Conor Sheary,L,TBL,32,82,8,26,34
3,8477488,Brett Pesce,D,NJD,30,82,5,29,34
3,8470621,Corey Perry,R,EDM,39,82,19,14,33
3,8476918,Jimmy Vesey,L,NYR,31,82,18,15,33
3,8481580,Connor McMichael,C,WSH,23,82,17,16,33
3,8480074,Alexandre Texier,C,STL,25,82,13,20,33
3,8476921,Jordan Martinook,L,CAR,32,82,12,21,33
3,8480073,Erik Brannstrom,D,COL,25,82,7,26,33
3,8476854,Hampus Lindholm,D,BOS,30,82,6,27,33
3,8481624,Ilya Mikheyev,R,CHI,30,82,17,15,32
3,8479393,Noah Gregor,C,OTT,26,82,16,16,32
3,8476474,Stefan Noesen,R,NJD,31,82,15,17,32
3,8479402,Jake Bean,D,CGY,26,82,5,27,32
3,8476463,Jonas Brodin,D,MIN,31,82,4,28,32
3,8476902,Esa Lindell,D,DAL,30,82,2,30,32
3,8477425,Miles Wood,L,COL,29,82,19,12,31
3,8479316,Luke Kunin,C,SJS,27,82,18,13,31
3,8481032,Paul Cotter,C,NJD,25,82,14,17,31
3,8484153,Leo Carlsson,C,ANA,20,82,14,17,31
3,8477507,Nikita Zadorov,D,BOS,29,82,12,19,31
3,8482720,Matthew Knies,L,TOR,22,82,11,20,31
3,8477450,Jason Dickinson,C,CHI,29,82,11,20,31
3,8477989,Christian Dvorak,C,MTL,28,82,11,20,31
3,8480145,Neal Pionk,D,WPG,29,82,8,23,31
3,8476312,Josh Manson,D,COL,33,82,8,23,31
3,8476979,Erik Gustafsson,D,DET,32,82,5,26,31
3,8482245,Artem Zub,D,OTT,29,82,4,27,31
3,8477506,Ryan Pulock,D,NYI,30,82,2,29,31
3,8478851,Alexandre Carrier,D,NSH,28,82,1,30,31
3,8480835,Jack Drury,C,CAR,24,82,15,15,30
3,8474189,Lars Eller,C,PIT,35,82,15,15,30
3,8483431,Logan Cooley,C,UTA,20,82,12,18,30
3,8484203,Bradly Nadeau,L,CAR,19,82,12,18,30
3,8476925,Colton Sissons,C,NSH,31,82,11,19,30
3,8476897,Oskar Sundqvist,C,STL,30,82,11,19,30
3,8480871,Adam Boqvist,D,FLA,24,82,10,20,30
3,8481604,Pavel Dorofeyev,L,VGK,24,82,10,20,30
3,8474715,Cam Atkinson,R,TBL,35,82,10,20,30
3,8476927,Teddy Blueger,C,VAN,30,82,9,21,30
3,8483468,Jiri Kulich,C,BUF,20,82,9,21,30
3,8477220,Nate Schmidt,D,FLA,33,82,7,23,30
3,8482133,Thomas Bordeleau,C,SJS,22,82,7,23,30
3,8476981,Josh Anderson,R,MTL,30,82,17,12,29
3,8480448,Parker Kelly,L,COL,25,82,17,12,29
3,8476873,Mark Jankowski,C,NSH,30,82,15,14,29
3,8480748,Kiefer Sherwood,L,VAN,29,82,14,15,29
3,8478569,Noel Acciari,C,PIT,33,82,14,15,29
3,8483808,Andrei Kuzmenko,L,CGY,28,82,13,16,29
3,8475343,Nic Dowd,C,WSH,34,82,13,16,29
3,8480113,Alex Iafallo,L,WPG,31,82,12,17,29
3,8477508,Curtis Lazar,C,NJD,29,82,12,17,29
3,8480829,Jesperi Kotkaniemi,C,CAR,24,82,10,19,29
3,8480789,Oliver Wahlstrom,R,NYI,24,82,10,19,29
3,8478013,Jake Walman,D,SJS,28,82,9,20,29
3,8478500,Ivan Provorov,D,CBJ,27,82,5,24,29
3,8476931,Jake McCabe,D,TOR,31,82,4,25,29
3,8478416,Erik Cernak,D,TBL,27,82,4,25,29
3,8482125,Alexander Holtz,R,VGK,22,82,15,13,28
3,8478109,Victor Olofsson,L,VGK,29,82,15,13,28
3,8484166,Adam Fantilli,C,CBJ,20,82,14,14,28
3,8480995,Pontus Holmberg,R,TOR,25,82,11,17,28
3,8482733,Logan Mailloux,D,MTL,31,82,11,17,28
3,8475200,Dmitry Orlov,D,CAR,33,82,9,19,28
3,8481522,Peyton Krebs,C,BUF,23,82,8,20,28
3,8480878,Nils Lundkvist,D,DAL,24,82,7,21,28
3,8481606,Jordan Spence,D,LAK,23,82,5,23,28
3,8477845,Trevor van Riemsdyk,D,WSH,33,82,5,23,28
3,8476967,Brett Kulak,D,EDM,30,82,0,28,28
3,8482259,Bobby McMann,C,TOR,28,82,14,13,27
3,8476960,Andreas Athanasiou,C,CHI,30,82,13,14,27
3,8476278,Colin Blackwell,C,DAL,31,82,12,15,27
3,8478434,Keegan Kolesar,R,VGK,27,82,12,15,27
3,8475848,Brendan Gallagher,R,MTL,32,82,11,16,27
3,8475231,Casey Cizikas,C,NYI,33,82,11,16,27
3,8480003,Jesper Boqvist,C,FLA,26,82,10,17,27
3,8477015,Connor Brown,R,EDM,30,82,9,18,27
3,8479293,Brandon Tanev,L,SEA,33,82,8,19,27
3,8482062,Cole Smith,L,NSH,29,82,7,20,27
3,8480049,Dylan Samberg,D,WPG,25,82,5,22,27
3,8480796,Martin Fehervary,D,WSH,25,82,5,22,27
3,8482655,J.J. Moser,D,TBL,24,82,4,23,27
3,8480281,Alexey Toropchenko,R,STL,25,82,17,9,26
3,8482155,Alex Laferriere,R,LAK,23,82,14,12,26
3,8475220,Marcus Foligno,L,MIN,33,82,12,14,26
3,8478211,Dryden Hunt,L,CGY,29,82,12,14,26
3,8481481,Blake Lizotte,C,PIT,27,82,10,16,26
3,8477931,Tomas Nosek,L,FLA,32,82,10,16,26
3,8479368,Max Jones,L,BOS,26,82,8,18,26
3,8476879,Cody Ceci,D,EDM,31,82,7,19,26
3,8478911,Matt Roy,D,WSH,29,82,6,20,26
3,8477948,Travis Sanheim,D,PHI,28,82,6,20,26
3,8475193,Tomas Tatar,L,NJD,34,82,12,13,25
3,8482141,Lukas Cormier,D,VGK,22,82,11,14,25
3,8477903,Garnet Hathaway,R,PHI,33,82,10,15,25
3,8482122,Brock Faber,D,MIN,22,82,8,17,25
3,8476917,Adam Pelech,D,NYI,30,82,5,20,25
3,8479998,Mikey Anderson,D,LAK,25,82,5,20,25
3,8482111,Justin Barron,D,MTL,23,82,4,21,25
3,8481014,Alexander Romanov,D,NYI,24,82,1,24,25
3,8478508,Yakov Trenin,C,MIN,27,82,16,8,24
3,8481093,Rafael Harvey-Pinard,L,MTL,25,82,15,9,24
3,8477353,Tyler Motte,C,DET,29,82,14,10,24
3,8476624,Barclay Goodrow,C,SJS,31,82,13,11,24
3,8476374,Sean Kuraly,C,CBJ,31,82,12,12,24
3,8476889,Radek Faksa,C,STL,30,82,12,12,24
3,8479941,Justin Danforth,R,CBJ,31,82,10,14,24
3,8480144,David Kampf,C,TOR,29,82,10,14,24
3,8481553,Bobby Brink,R,PHI,23,82,8,16,24
3,8480806,Isac Lundestrom,C,ANA,25,82,8,16,24
3,8474574,Tyler Myers,D,VAN,34,82,8,16,24
3,8474151,Ryan McDonagh,D,TBL,35,82,5,19,24
3,8478882,Vladislav Gavrikov,D,LAK,29,82,4,20,24
3,8475690,Chris Tanev,D,TOR,35,82,3,21,24
3,8476469,Joel Armia,R,MTL,31,82,14,9,23
3,8481601,Simon Holmstrom,R,NYI,23,82,11,12,23
3,8477369,Carson Soucy,D,VAN,30,82,11,12,23
3,8480021,Jack Studnicka,C,LAK,25,82,9,14,23
3,8473453,Trevor Lewis,C,LAK,37,82,9,14,23
3,8475855,Jesper Fast,R,CAR,33,82,8,15,23
3,8483493,Frank Nazar,C,CHI,20,82,7,16,23
3,8479371,Dante Fabbro,D,NSH,26,82,6,17,23
3,8478136,Jake Middleton,D,MIN,28,82,5,18,23
3,8480950,Ilya Lyubushkin,D,DAL,30,82,4,19,23
3,8479324,Ryan Lindgren,D,NYR,26,82,4,19,23
3,8475188,Brayden McNabb,D,VGK,33,82,3,20,23
3,8476892,Colton Parayko,D,STL,31,82,2,21,23
3,8480860,Kevin Bahl,D,CGY,24,82,2,21,23
3,8478507,John Marino,D,UTA,27,82,1,22,23
3,8475842,Sam Carrick,C,NYR,32,82,13,9,22
3,8479661,Tanner Jeannot,L,LAK,27,82,10,12,22
3,8482074,Connor Zary,C,CGY,23,82,8,14,22
3,8483505,Matthew Poitras,C,BOS,20,82,8,14,22
3,8483565,Nick Blankenburg,D,NSH,26,82,7,15,22
3,8478133,Jake Evans,C,MTL,28,82,5,17,22
3,8482142,Jamie Drysdale,D,PHI,22,82,5,17,22
3,8482087,Kaiden Guhle,D,MTL,22,82,4,18,22
3,8480807,Mattias Samuelsson,D,BUF,24,82,4,18,22
3,8481178,Egor Zamula,D,PHI,24,82,3,19,22
3,8474090,Brendan Smith,D,DAL,35,82,3,19,22
3,8473507,Jeff Petry,D,DET,37,82,1,21,22
3,8476858,Phillip Di Giuseppe,L,VAN,31,82,15,6,21
3,8481028,Martin Pospisil,C,CGY,25,82,14,7,21
3,8476822,Luke Glendening,C,TBL,35,82,14,7,21
3,8481517,Brett Leason,R,ANA,25,82,8,13,21
3,8482807,Ethan Del Mastro,D,CHI,21,82,7,14,21
3,8482624,Daniil Miromanov,D,CGY,27,82,6,15,21
3,8479359,Beck Malenstyn,L,BUF,26,82,6,15,21
3,8480035,Henri Jokiharju,D,BUF,25,82,5,16,21
3,8479983,Mario Ferraro,D,SJS,26,82,4,17,21
3,8475324,Nick Jensen,D,OTT,34,82,4,17,21
3,8475233,David Savard,D,MTL,34,82,4,17,21
3,8478859,Niko Mikkola,D,FLA,28,82,3,18,21
3,8475462,Radko Gudas,D,ANA,34,82,3,18,21
3,8476331,Dylan DeMelo,D,WPG,31,82,2,19,21
3,8480246,Nick Perbix,D,TBL,26,82,2,19,21
3,8476891,Matt Grzelcyk,D,PIT,30,82,1,20,21
3,8479414,Nathan Bastian,R,NJD,27,82,12,8,20
3,8480025,MacKenzie Entwistle,R,FLA,25,82,11,9,20
3,8483524,Shane Wright,C,SEA,20,82,10,10,20
3,8477392,Hudson Fasching,R,NYI,29,82,9,11,20
3,8476878,Zemgus Girgensons,L,TBL,30,82,9,11,20
3,8482166,Shakir Mukhamadullin,D,SJS,22,82,6,14,20
3,8483457,Lane Hutson,D,MTL,20,82,6,14,20
3,8481524,Bowen Byram,D,BUF,23,82,6,14,20
3,8475455,Brenden Dillon,D,NJD,34,82,6,14,20
3,8479369,Andrew Peeke,D,BOS,26,82,4,16,20
3,8482073,Braden Schneider,D,NYR,23,82,3,17,20
3,8477435,Ryan Graves,D,PIT,29,82,3,17,20
3,8475790,Erik Gudbranson,D,CBJ,32,82,2,18,20
3,8477406,Mattias Janmark,C,EDM,32,82,12,7,19
3,8480813,Joe Veleno,C,DET,24,82,12,7,19
3,8482101,Danil Gushchin,L,SJS,22,82,10,9,19
3,8482762,Simon Edvinsson,D,DET,21,82,9,10,19
3,8476442,Matt Nieto,L,PIT,32,82,8,11,19
3,8475279,Ben Chiarot,D,DET,33,82,7,12,19
3,8483490,Pavel Mintyukov,D,ANA,21,82,7,12,19
3,8480222,Sebastian Aho,D,PIT,28,82,7,12,19
3,8476457,Adam Larsson,D,SEA,32,82,6,13,19
3,8477938,Haydn Fleury,D,WPG,28,82,3,16,19
3,8481568,Alex Vlasic,D,CHI,23,82,2,17,19
3,8480879,Jacob Bernard-Docker,D,OTT,24,82,1,18,19
3,8478840,Will Borgen,D,SEA,28,82,0,19,19
3,8477505,Alexander Wennberg,C,SJS,30,82,15,3,18
3,8482077,Dylan Holloway,L,EDM,23,82,12,6,18
3,8481477,Nico Sturm,C,SJS,29,82,10,8,18
3,8480980,Connor Dewar,C,TOR,25,82,9,9,18
3,8482666,Scott Morrow,D,CAR,22,82,8,10,18
3,8483012,Logan Morrison,C,SEA,22,82,7,11,18
3,8483763,Maksymilian Szuber,D,UTA,22,82,6,12,18
3,8478443,Brandon Carlo,D,BOS,28,82,5,13,18
3,8470600,Ryan Suter,D,STL,39,82,4,14,18
3,8483466,Kevin Korchinski,D,CHI,20,82,4,14,18
3,8474673,TJ Brodie,D,CHI,34,82,1,17,18
3,8476525,Colin Miller,D,WPG,32,82,1,17,18
3,8479638,Justin Brazeau,R,BOS,26,82,6,11,17
3,8476467,Jamie Oleksiak,D,SEA,32,82,4,13,17
3,8477335,Kyle Burroughs,D,LAK,29,82,4,13,17
3,8480172,Jan Rutta,D,SJS,34,82,4,13,17
3,8478450,Parker Wotherspoon,D,BOS,27,82,1,16,17
3,8482145,Mavrik Bourque,C,DAL,22,82,9,7,16
3,8482809,Jackson Blake,R,CAR,21,82,8,8,16
3,8476441,Joel Edmundson,D,LAK,31,82,8,8,16
3,8478432,Christian Fischer,R,DET,27,82,7,9,16
3,8483445,Cutter Gauthier,L,ANA,20,82,7,9,16
3,8483499,Liam Ohgren,L,MIN,20,82,7,9,16
3,8483489,Fraser Minten,C,TOR,31,82,6,10,16
3,8480990,Declan Chisholm,D,MIN,24,82,6,10,16
3,8482858,Ryker Evans,D,SEA,23,82,5,11,16
3,8481605,Jackson LaCombe,D,ANA,23,82,5,11,16
3,8482712,Oskar Olausson,R,COL,22,82,4,12,16
3,8476429,Scott Mayfield,D,NYI,32,82,4,12,16
3,8471677,Jack Johnson,D,CBJ,37,82,4,12,16
3,8479442,Troy Stecher,D,EDM,30,82,3,13,16
3,8475177,Calvin de Haan,D,COL,33,82,2,14,16
3,8482749,Joshua Roy,R,MTL,21,82,8,7,15
3,8480870,Bo Groulx,C,NYR,24,82,7,8,15
3,8482803,Olen Zellweger,D,ANA,21,82,5,10,15
3,8481708,Zac Jones,D,NYR,24,82,5,10,15
3,8479980,Nicolas Hague,D,VGK,26,82,4,11,15
3,8476422,Mike Reilly,D,NYI,31,82,4,11,15
3,8475718,Justin Holl,D,DET,32,82,4,11,15
3,8474013,Ian Cole,D,UTA,35,82,3,12,15
3,8478178,Darren Raddysh,D,TBL,28,82,3,12,15
3,8477365,Connor Clifton,D,BUF,29,82,2,13,15
3,8478468,Jeremy Lauzon,D,NSH,27,82,2,13,15
3,8477034,Jaycob Megna,D,FLA,32,82,1,14,15
3,8482679,Matt Coronato,R,CGY,22,82,5,9,14
3,8480834,Ty Emberson,D,SJS,24,82,3,11,14
3,8483495,Simon Nemec,D,NJD,20,82,3,11,14
3,8482470,Ilya Solovyov,D,CGY,24,82,3,11,14
3,8484911,Collin Graf,R,SJS,22,82,7,6,13
3,8483397,Marc McLaughlin,C,BOS,25,82,7,6,13
3,8482713,Mackie Samoskevich,R,FLA,22,82,6,7,13
3,8482787,Nikita Chibrikov,R,WPG,31,82,4,9,13
3,8483460,David Jiricek,D,CBJ,21,82,3,10,13
3,8474567,Zach Bogosian,D,MIN,34,82,3,10,13
3,8478399,Jonas Siegenthaler,D,NJD,27,82,2,11,13
3,8483482,Tristan Luneau,D,ANA,20,82,2,11,13
3,8483471,Brad Lambert,C,WPG,31,82,2,11,13
3,8479291,Kevin Rooney,C,CGY,31,82,6,6,12
3,8484149,Gavin Brindley,C,CBJ,20,82,5,7,12
3,8482702,Logan Stankoven,C,DAL,21,82,4,8,12
3,8477499,Rasmus Ristolainen,D,PHI,30,82,4,8,12
3,8481567,Henry Thrun,D,SJS,23,82,3,9,12
3,8481122,Simon Benoit,D,TOR,26,82,3,9,12
3,8482859,Zack Ostapchuk,C,OTT,21,82,7,4,11
3,8476473,Connor Murphy,D,CHI,31,82,3,8,11
3,8475762,Derek Forbort,D,VAN,32,82,3,8,11
3,8476372,Nick Seeler,D,PHI,31,82,2,9,11
3,8478874,Adam Gaudette,C,OTT,28,82,2,9,11
3,8482516,Matthew Kessel,D,STL,24,82,1,10,11
3,8481641,Joel Kiviranta,L,COL,28,82,4,6,10
3,8482118,Sam Colangelo,R,ANA,23,82,4,6,10
3,8481699,Aku Raty,R,UTA,23,82,4,6,10
3,8474612,Travis Hamonic,D,OTT,34,82,2,8,10
3,8483567,Georgii Merkulov,C,BOS,24,82,1,9,10
3,8482070,Mitchell Chaffee,R,TBL,26,82,5,4,9
3,8482153,Brendan Brisson,C,VGK,23,82,6,2,8
3,8479576,Vincent Desharnais,D,VAN,28,82,2,6,8
3,8482659,Josh Doan,R,UTA,22,82,3,3,6
3,8474062,Riley Nash,C,NYR,35,82,0,5,5
3,8470794,Joe Pavelski,C,,40,0,0,0,0
3,8481703,Valtteri Puustinen,R,PIT,25,0,0,0,0
3,8477950,Tony DeAngelo,D,,29,0,0,0,0
3,8481577,Philip Tomasino,C,NSH,23,0,0,0,0
3,8475197,Tyson Barrie,D,,33,0,0,0,0
3,8471218,Blake Wheeler,R,,38,0,0,0,0
3,8474157,Max Pacioretty,L,,36,0,0,0,0
3,8478466,Daniel Sprong,R,VAN,27,0,0,0,0
3,8475744,Evgeny Kuznetsov,C,,32,0,0,0,0
3,8481019,David Gustafsson,C,WPG,24,0,0,0,0
3,8475906,John Klingberg,D,,32,0,0,0,0
3,8479348,Kale Clague,D,BUF,26,0,0,0,0
3,8476952,Dominic Toninato,C,WPG,30,0,0,0,0
3,8473473,Milan Lucic,L,,36,0,0,0,0
3,8474037,James van Riemsdyk,L,,35,0,0,0,0
3,8474602,Justin Schultz,D,,34,0,0,0,0
3,8482222,Alexander Barabanov,L,,30,0,0,0,0
3,8479372,Josh Mahura,D,SEA,26,0,0,0,0
3,8479982,Conor Timmins,D,TOR,26,0,0,0,0
3,8474031,Kevin Shattenkirk,D,,35,0,0,0,0
3,8480008,Adam Ruzicka,C,,25,0,0,0,0
3,8481059,Scott Perunovich,D,STL,26,0,0,0,0
3,8480884,Calen Addison,D,,24,0,0,0,0
3,8476994,Vinnie Hinostroza,C,NSH,30,0,0,0,0
3,8478452,Caleb Jones,D,LAK,27,0,0,0,0
3,8480157,Calle Rosen,D,COL,30,0,0,0,0
3,8481609,Vladislav Kolyachonok,D,UTA,23,0,0,0,0
3,8479415,Michael McLeod,C,,26,0,0,0,0
3,8476919,Chris Tierney,C,,30,0,0,0,0
3,8479639,Dylan Coghlan,D,WPG,26,0,0,0,0
3,8478146,Matthew Highmore,C,OTT,28,0,0,0,0
3,8478970,Jalen Chatfield,D,CAR,28,0,0,0,0
3,8480205,Emil Bemstrom,C,PIT,25,0,0,0,0
3,8474884,Mike Hoffman,C,,35,0,0,0,0
3,8471274,Alex Goligoski,D,,39,0,0,0,0
3,8478104,Sammy Blais,L,,28,0,0,0,0
3,8474870,Tyler Johnson,C,,34,0,0,0,0
3,8476913,Devin Shore,C,MIN,30,0,0,0,0
3,8481598,Philip Broberg,D,EDM,23,0,0,0,0
3,8480058,Pierre-Olivier Joseph,D,STL,25,0,0,0,0
3,8480891,Michael Kesselring,D,UTA,24,0,0,0,0
3,8477979,Nicolas Aube-Kubel,R,BUF,28,0,0,0,0
3,8476871,Tanner Pearson,L,,32,0,0,0,0
3,8476393,Nick Cousins,C,,31,0,0,0,0
3,8479977,Kailer Yamamoto,R,,26,0,0,0,0
3,8479543,Michael Pezzetta,L,MTL,26,0,0,0,0
3,8477018,Ben Hutton,D,VGK,31,0,0,0,0
3,8480762,Eric Robinson,L,CAR,29,0,0,0,0
3,8474034,Pat Maroon,L,CHI,36,0,0,0,0
3,8481058,Jesse Ylönen,R,,25,0,0,0,0
3,8475179,Dmitry Kulikov,D,FLA,34,0,0,0,0
3,8481527,Kaedan Korczak,D,VGK,23,0,0,0,0
3,8473449,Kyle Okposo,R,,36,0,0,0,0
3,8482192,Isaak Phillips,D,CHI,23,0,0,0,0
3,8480727,Zach Whitecloud,D,VGK,28,0,0,0,0
3,8479346,Dillon Dube,C,,26,0,0,0,0
3,8480821,Filip Zadina,R,,25,0,0,0,0
3,8480001,Urho Vaakanainen,D,ANA,25,0,0,0,0
3,8470966,Mark Giordano,D,,41,0,0,0,0
3,8480853,Liam Foudy,C,,24,0,0,0,0
3,8475225,Craig Smith,C,CHI,35,0,0,0,0
3,8479972,Mason Shaw,C,WPG,26,0,0,0,0
3,8478451,Ethan Bear,D,WSH,27,0,0,0,0
3,8474040,Sam Gagner,C,,35,0,0,0,0
3,8480196,Jacob Bryson,D,BUF,27,0,0,0,0
3,8479984,Cal Foote,D,,26,0,0,0,0
3,8480011,Klim Kostin,C,SJS,25,0,0,0,0
3,8482176,Wyatt Kaiser,D,CHI,22,0,0,0,0
3,8476988,Matt Benning,D,SJS,30,0,0,0,0
3,8479370,Tyson Jost,C,CAR,26,0,0,0,0
3,8477464,Nic Petan,C,,29,0,0,0,0
3,8477380,Jonny Brodzinski,C,NYR,31,0,0,0,0
3,8480070,Ian Mitchell,D,BOS,25,0,0,0,0
3,8479315,Joey Anderson,R,CHI,26,0,0,0,0
3,8478099,Kevin Labanc,R,,29,0,0,0,0
3,8476874,Olli Maatta,D,DET,30,0,0,0,0
3,8475208,Brian Dumoulin,D,ANA,33,0,0,0,0
3,8478430,Oliver Kylington,D,,27,0,0,0,0
3,8479536,Axel Jonsson-Fjallby,L,WPG,26,0,0,0,0
3,8479671,Mathieu Olivier,R,CBJ,27,0,0,0,0
3,8471709,Marc-Edouard Vlasic,D,SJS,37,0,0,0,0
3,8479328,Julien Gauthier,R,NYI,27,0,0,0,0
3,8478421,A.J. Greer,L,FLA,28,0,0,0,0
3,8477573,Nathan Walker,L,STL,30,0,0,0,0
3,8481537,Nikita Okhotiuk,D,CGY,24,0,0,0,0
3,8474166,Alec Martinez,D,CHI,37,0,0,0,0
3,8470610,Zach Parise,L,,40,0,0,0,0
3,8477478,William Carrier,L,CAR,30,0,0,0,0
3,8479344,Jesse Puljujarvi,R,PIT,26,0,0,0,0
3,8480887,Jordan Harris,D,MTL,24,0,0,0,0
3,8478502,Dennis Gilbert,D,BUF,28,0,0,0,0
3,8482730,Brandt Clarke,D,LAK,21,0,0,0,0
3,8480355,Mark Kastelic,C,BOS,25,0,0,0,0
3,8475750,Jon Merrill,D,MIN,32,0,0,0,0
3,8475164,Jakob Silfverberg,R,,34,0,0,0,0
3,8477944,Jakub Vrana,L,,28,0,0,0,0
3,8479439,Jacob MacDonald,D,COL,31,0,0,0,0
3,8474568,Luke Schenn,D,NSH,35,0,0,0,0
3,8478454,Noah Juulsen,D,VAN,27,0,0,0,0
3,8475752,Tyler Pitlick,C,,33,0,0,0,0
3,8482148,Hendrix Lapierre,C,WSH,22,0,0,0,0
3,8481167,Brayden Pachal,D,CGY,25,0,0,0,0
3,8478043,Sam Lafferty,C,BUF,29,0,0,0,0
3,8479321,Lucas Johansen,D,,27,0,0,0,0
3,8471699,Andrew Cogliano,C,,37,0,0,0,0
3,8481521,Ronnie Attard,D,PHI,25,0,0,0,0
3,8481161,Jake Christiansen,D,CBJ,25,0,0,0,0
3,8479458,Nikita Zaitsev,D,,33,0,0,0,0
3,8479619,Michael Carcone,L,UTA,28,0,0,0,0
3,8479026,Philippe Myers,D,TOR,27,0,0,0,0
3,8477330,Dominik Kubalik,L,,29,0,0,0,0
3,8481617,Vasily Podkolzin,R,VAN,23,0,0,0,0
3,8481701,Santeri Hatakka,D,NJD,23,0,0,0,0
3,8479514,Rem Pitlick,C,,27,0,0,0,0
3,8477446,Michael McCarron,R,NSH,29,0,0,0,0
3,8470604,Jeff Carter,C,,39,0,0,0,0
3,8482241,Radim Zohorna,L,,28,0,0,0,0
3,8480289,Morgan Barron,C,WPG,26,0,0,0,0
3,8479379,Givani Smith,R,SJS,26,0,0,0,0
3,8480216,Jacob Peterson,C,,25,0,0,0,0
3,8477851,Jordan Oesterle,D,BOS,32,0,0,0,0
3,8484258,Sam Malinski,D,COL,26,0,0,0,0
3,8478904,Steven Lorentz,C,,28,0,0,0,0
3,8482095,Tyler Kleven,D,OTT,22,0,0,0,0
3,8480848,Ty Dellandrea,C,SJS,24,0,0,0,0
3,8476884,Derrick Pouliot,D,,30,0,0,0,0
3,8479336,Carl Grundstrom,R,SJS,27,0,0,0,0
3,8482964,Arber Xhekaj,D,MTL,23,0,0,0,0
3,8471686,Marc Staal,D,,37,0,0,0,0
3,8477887,Patrick Brown,C,BOS,32,0,0,0,0
3,8478495,Denis Gurianov,R,,27,0,0,0,0
3,8473504,Cal Clutterbuck,R,,37,0,0,0,0
3,8481550,Adam Beckman,L,NJD,23,0,0,0,0
3,8480845,Rasmus Kupari,C,WPG,24,0,0,0,0
3,8474009,Nick Bonino,C,,36,0,0,0,0
3,8478585,Derek Ryan,C,EDM,38,0,0,0,0
3,8477962,Brendan Lemieux,L,CAR,28,0,0,0,0
3,8482861,Vincent Iorio,D,WSH,22,0,0,0,0
3,8479378,Logan Stanley,D,WPG,26,0,0,0,0
3,8473446,Erik Johnson,D,PHI,36,0,0,0,0
3,8481743,Marc Del Gaizo,D,NSH,25,0,0,0,0
3,8477384,Josh Brown,D,EDM,30,0,0,0,0
3,8482165,Yan Kuznetsov,D,CGY,22,0,0,0,0
3,8478424,Jansen Harkins,C,ANA,27,0,0,0,0
3,8482144,Jack Thompson,D,SJS,22,0,0,0,0
3,8478512,Austin Czarnik,C,,32,0,0,0,0
3,8477527,Ross Johnston,L,ANA,30,0,0,0,0
3,8479383,Boris Katchouk,L,,26,0,0,0,0
3,8482094,Daemon Hunt,D,MIN,22,0,0,0,0
3,8481719,Maxwell Crozier,D,TBL,24,0,0,0,0
3,8480192,Johnathan Kovacevic,D,NJD,27,0,0,0,0
3,8479376,Victor Mete,D,,26,0,0,0,0
3,8482511,Mason Lohrei,D,BOS,23,0,0,0,0
3,8475825,Jani Hakanpää,D,,32,0,0,0,0
3,8478021,William Lagesson,D,DET,28,0,0,0,0
3,8475795,Dylan McIlrath,D,WSH,32,0,0,0,0
3,8477846,Ryan Carpenter,C,,33,0,0,0,0
3,8481056,Spencer Stastney,D,NSH,24,0,0,0,0
3,8481564,Ryan Johnson,D,BUF,23,0,0,0,0
3,8478017,Mark Friedman,D,VAN,29,0,0,0,0
3,8479320,Max Lajoie,D,SEA,27,0,0,0,0
3,8480075,Cameron Crotty,D,MIN,25,0,0,0,0
3,8484287,Cole McWard,D,VAN,23,0,0,0,0
3,8484254,Akito Hirose,D,VAN,25,0,0,0,0
3,8483407,Brandon Scanlin,D,NYR,25,0,0,0,0
3,8480274,Philip Kemp,D,EDM,25,0,0,0,0
3,8479522,Hardy Haman Aktell,D,WSH,26,0,0,0,0
3,8480007,Jonas Rondbjerg,R,VGK,25,0,0,0,0
3,8477454,Adam Erne,L,,29,0,0,0,0
3,8481679,Maxence Guenette,D,OTT,23,0,0,0,0
3,8480441,Trey Fix-Wolansky,R,CBJ,25,0,0,0,0
3,8483546,Marshall Rifai,D,TOR,26,0,0,0,0
3,8480084,Nick DeSimone,D,NJD,30,0,0,0,0
3,8481030,Jack St. Ivany,D,PIT,25,0,0,0,0
3,8481592,Jakob Pelletier,L,CGY,23,0,0,0,0
3,8478011,Louie Belpedio,D,PHI,28,0,0,0,0
3,8477930,Pierre-Edouard Bellemare,L,,39,0,0,0,0
3,8484321,Nikolas Matinpalo,D,OTT,26,0,0,0,0
3,8482067,Connor Mackey,D,NYR,28,0,0,0,0
3,8481806,Louis Crevier,D,CHI,23,0,0,0,0
3,8484326,Patrik Koch,D,UTA,28,0,0,0,0
3,8477971,Andreas Englund,D,LAK,28,0,0,0,0
3,8481751,Lukas Rousek,R,BUF,25,0,0,0,0
3,8481006,Tyler Tucker,D,STL,24,0,0,0,0
3,8476867,Brendan Gaunce,C,MIN,30,0,0,0,0
3,8479520,Brandon Duhaime,R,WSH,27,0,0,0,0
3,8477073,Kurtis MacDermid,L,NJD,30,0,0,0,0
3,8480874,Adam Ginning,D,PHI,24,0,0,0,0
3,8477473,Justin Bailey,R,SJS,29,0,0,0,0
3,8479066,Ryan Lomberg,L,CGY,30,0,0,0,0
3,8477070,Liam O'Brien,C,UTA,30,0,0,0,0
3,8474618,Marco Scandella,D,,34,0,0,0,0
3,8475797,Jarred Tinordi,D,,32,0,0,0,0
3,8481441,Joe Snively,C,DET,28,0,0,0,0
3,8477244,Chad Ruhwedel,D,NYR,34,0,0,0,0
3,8479772,Zack MacEwen,R,OTT,28,0,0,0,0
3,8481147,Reese Johnson,C,MIN,26,0,0,0,0
3,8481043,Cole Koepke,L,BOS,26,0,0,0,0
3,8483619,Filip Roos,D,OTT,25,0,0,0,0
3,8481541,Samuel Bolduc,D,NYI,24,0,0,0,0
3,8477810,Joel Hanley,D,CGY,33,0,0,0,0
3,8476907,Mackenzie MacEachern,L,,30,0,0,0,0
3,8482652,Walker Duehr,R,CGY,27,0,0,0,0
3,8477126,Jayson Megna,C,,34,0,0,0,0
3,8483398,Declan Carlile,D,TBL,31,0,0,0,0
3,8482929,Emil Lilleberg,D,TBL,23,0,0,0,0
3,8480880,Jakub Lauko,C,MIN,24,0,0,0,0
3,8480245,Olle Lycksell,R,PHI,25,0,0,0,0
3,8480252,Cole Guttman,C,CHI,25,0,0,0,0
3,8477467,Gustav Olofsson,D,SEA,30,0,0,0,0
3,8479968,Vinni Lettieri,C,BOS,29,0,0,0,0
3,8478400,Colin White,C,,27,0,0,0,0
3,8475755,Alexander Petrovic,D,DAL,32,0,0,0,0
3,8481812,Nikolai Knyzhov,D,,27,0,0,0,0
3,8481593,Jayden Struble,D,MTL,23,0,0,0,0
3,8481532,Alex Turcotte,C,LAK,23,0,0,0,0
3,8482126,Emil Andrae,D,PHI,31,0,0,0,0
3,8479944,Zach Aston-Reese,C,VGK,30,0,0,0,0
3,8471817,Ryan Reaves,R,TOR,37,0,0,0,0
3,8481206,John Ludvig,D,PIT,24,0,0,0,0
3,8481599,Victor Soderstrom,D,UTA,23,0,0,0,0
3,8480292,Carson Meyer,R,ANA,27,0,0,0,0
3,8482496,Nils Aman,C,VAN,24,0,0,0,0
3,8479718,Alex Barré-Boulet,C,MTL,27,0,0,0,0
3,8479994,Jaret Anderson-Dolan,C,WPG,25,0,0,0,0
3,8480184,Gustav Lindstrom,D,,26,0,0,0,0
3,8480890,Jan Jenik,R,OTT,24,0,0,0,0
3,8478067,Oskar Lindblom,L,,28,0,0,0,0
3,8476934,Brock McGinn,L,ANA,30,0,0,0,0
3,8479985,Cale Fleury,D,SEA,26,0,0,0,0
3,8484304,Uvis Balinskis,D,FLA,28,0,0,0,0
3,8479981,Jonah Gadjovich,L,FLA,26,0,0,0,0
3,8481716,Dmitri Voronkov,L,CBJ,24,0,0,0,0
3,8474709,Matt Martin,L,,35,0,0,0,0
3,8482634,Alex Steeves,C,TOR,25,0,0,0,0
3,8480823,Alexander Alexeyev,D,WSH,25,0,0,0,0
3,8477541,Dakota Mermis,D,TOR,30,0,0,0,0
3,8483491,Ivan Miroshnichenko,L,WSH,20,0,0,0,0
3,8478477,Mitchell Stephens,C,SEA,27,0,0,0,0
3,8481543,Nikita Alexandrov,C,STL,24,0,0,0,0
3,8479423,Alex Nylander,L,,26,0,0,0,0
3,8482451,Mikael Pyyhtia,L,CBJ,23,0,0,0,0
3,8478831,Kevin Stenlund,C,UTA,28,0,0,0,0
3,8480306,Grant Hutton,D,NYI,29,0,0,0,0
3,8478028,Fredrik Olofsson,L,,28,0,0,0,0
3,8477462,Robert Hagg,D,VGK,29,0,0,0,0
3,8477320,Anton Blidh,L,NYR,29,0,0,0,0
3,8482157,Will Cuylle,L,NYR,22,0,0,0,0
3,8482737,Zack Bolduc,C,STL,21,0,0,0,0
3,8481239,Samuel Fagemo,L,,24,0,0,0,0
3,8481600,Tobias Bjornfot,D,FLA,23,0,0,0,0
3,8478409,Anthony Richard,C,PHI,28,0,0,0,0
3,8474145,Robert Bortuzzo,D,,35,0,0,0,0
3,8475958,Michael Sgarbossa,C,WSH,32,0,0,0,0
3,8479986,Kole Lind,R,DAL,26,0,0,0,0
3,8479249,Andrew Poturalski,C,SJS,30,0,0,0,0
3,8479362,Riley Tufte,L,BOS,26,0,0,0,0
3,8479991,Jake Leschyshyn,C,NYR,25,0,0,0,0
3,8479587,Rhett Gardner,C,PHI,28,0,0,0,0
3,8482744,James Malatesta,L,CBJ,21,0,0,0,0
3,8478854,Ryan Shea,D,PIT,27,0,0,0,0
3,8481591,Sam Poulin,R,,23,0,0,0,0
3,8483512,Matt Savoie,C,EDM,20,0,0,0,0
3,8482102,Vasily Ponomarev,C,PIT,22,0,0,0,0
3,8482162,Roby Jarventie,L,EDM,22,0,0,0,0
3,8481016,Ruslan Iskhakov,C,,24,0,0,0,0
3,8482172,Landon Slaggert,L,CHI,22,0,0,0,0
3,8482747,Brennan Othmann,L,NYR,21,0,0,0,0
3,8480031,Maxime Comtois,L,,25,0,0,0,0
3,8480226,Marián Studenic,R,,26,0,0,0,0
3,8478408,Travis Dermott,D,,28,0,0,0,0
3,8481518,Nolan Foote,L,NJD,24,0,0,0,0
3,8479419,Brett Murray,L,BUF,26,0,0,0,0
3,8482088,Justin Sourdif,R,FLA,22,0,0,0,0
3,8482201,Gage Goncalves,C,TBL,23,0,0,0,0
3,8481578,Graeme Clarke,R,MIN,23,0,0,0,0
3,8482177,Marat Khusnutdinov,C,MIN,22,0,0,0,0
3,8481754,Nikita Nesterenko,C,ANA,23,0,0,0,0
3,8483531,Brian Halonen,L,NJD,25,0,0,0,0
3,8483920,Pierrick Dube,R,WSH,23,0,0,0,0
3,8480851,Akil Thomas,C,LAK,24,0,0,0,0
3,8475235,Nicolas Deslauriers,L,PHI,33,0,0,0,0
3,8482476,Emil Heineman,L,MTL,23,0,0,0,0
3,8477149,Scott Sabourin,R,SJS,32,0,0,0,0
3,8483549,Lucas Condotta,L,MTL,27,0,0,0,0
3,8482765,Isak Rosen,R,BUF,21,0,0,0,0
3,8481237,Kyle MacLean,C,NYI,25,0,0,0,0
3,8481024,Linus Karlsson,C,VAN,25,0,0,0,0
3,8481690,Tyler Angle,C,,24,0,0,0,0
3,8483570,Ben Meyers,C,SEA,26,0,0,0,0
3,8481655,Cole Schwindt,R,CGY,23,0,0,0,0
3,8481462,Mason Morelli,L,VGK,28,0,0,0,0
3,8483401,Marc Johnstone,R,PIT,28,0,0,0,0
3,8478956,Samuel Laberge,L,NJD,27,0,0,0,0
3,8479533,Joona Koppanen,L,,26,0,0,0,0
3,8482197,Adam Raska,R,MIN,23,0,0,0,0
3,8482250,Callahan Burke,C,VGK,27,0,0,0,0
3,8482784,Zach Dean,C,STL,21,0,0,0,0
3,8484255,Jason Polin,R,COL,25,0,0,0,0
3,8481077,John Leonard,L,,26,0,0,0,0
3,8481534,Raphael Lavoie,C,EDM,24,0,0,0,0
3,8483609,Adam Klapka,R,CGY,24,0,0,0,0
3,8482751,Ryan Winterton,C,SEA,21,0,0,0,0
3,8480267,Sammy Walker,C,MIN,25,0,0,0,0
3,8475766,Austin Watson,L,,32,0,0,0,0
3,8482460,Matt Rempe,C,NYR,22,0,0,0,0
3,8481065,Angus Crookshank,L,OTT,25,0,0,0,0
3,8481070,Hugh McGing,L,,26,0,0,0,0
3,8476323,Max McCormick,L,SEA,32,0,0,0,0
3,8483395,Arshdeep Bains,L,VAN,23,0,0,0,0
3,8484259,Ondrej Pavel,C,COL,31,0,0,0,0
3,8483432,Luca Del Bel Belluz,C,CBJ,31,0,0,0,0
3,8483045,Cameron Butler,R,CBJ,31,0,0,0,0
3,8482061,Brandon Biro,L,SEA,26,0,0,0,0
3,8477401,John Hayden,C,SEA,29,0,0,0,0
3,8475278,Byron Froese,C,,33,0,0,0,0
3,8478446,Glenn Gawdin,C,LAK,27,0,0,0,0
3,8477993,Justin Kirkland,C,CGY,28,0,0,0,0
3,8482147,Jean-Luc Foudy,C,COL,22,0,0,0,0
3,8480032,Shane Bowers,C,NJD,25,0,0,0,0
3,8479330,Brandon Gignac,C,MTL,27,0,0,0,0
3,8480776,Sheldon Rempal,R,,29,0,0,0,0
3,8475413,Justin Dowling,C,NJD,34,0,0,0,0
3,8481726,Adam Edstrom,C,NYR,24,0,0,0,0
3,8480844,Grigori Denisenko,L,VGK,24,0,0,0,0
3,8478147,Bokondji Imama,L,PIT,28,0,0,0,0
3,8478881,Brett Seney,L,CHI,28,0,0,0,0
3,8483630,Pavol Regenda,L,ANA,25,0,0,0,0
3,8480836,Jonathan Gruden,C,,24,0,0,0,0
3,8484314,Jiri Smejkal,L,,28,0,0,0,0
3,8475780,Chris Wagner,R,COL,33,0,0,0,0
3,8479546,Oskar Steen,C,,26,0,0,0,0
3,8483597,Milos Kelemen,L,UTA,25,0,0,0,0
3,8481789,Tye Kartye,L,SEA,23,0,0,0,0
3,8484325,Waltteri Merela,C,TBL,26,0,0,0,0
3,8479421,Jacob Moverare,D,LAK,26,0,0,0,0
3,8481585,Egor Afanasyev,L,SJS,23,0,0,0,0
3,8479547,Matthew Phillips,R,,26,0,0,0,0
3,8479367,William Lockwood,R,FLA,26,0,0,0,0
3,8476915,Jujhar Khaira,L,,30,0,0,0,0
3,8481422,Jacob Lucchini,C,NSH,29,0,0,0,0
3,8480468,James Hamblin,L,EDM,25,0,0,0,0
3,8478051,Max Willman,C,NJD,29,0,0,0,0
3,8481556,John Beecher,C,BOS,23,0,0,0,0
3,8478078,Rourke Chartier,C,,28,0,0,0,0
4,8478402,Connor McDavid,C,EDM,27,82,43,100,143
4,8477492,Nathan MacKinnon,C,COL,29,82,60,77,137
4,8476453,Nikita Kucherov,R,TBL,31,82,41,94,135
4,8479318,Auston Matthews,C,TOR,27,82,77,57,134
4,8478420,Mikko Rantanen,R,COL,28,82,53,76,129
4,8477956,David Pastrnak,R,BOS,28,82,68,58,126
4,8478550,Artemi Panarin,L,NYR,33,82,45,80,125
4,8479314,Matthew Tkachuk,L,FLA,27,82,36,82,118
4,8477939,William Nylander,R,TOR,28,82,48,68,116
4,8478864,Kirill Kaprizov,L,MIN,27,82,51,61,112
4,8477493,Aleksander Barkov,C,FLA,29,82,33,78,111
4,8477933,Sam Reinhart,C,FLA,29,82,55,55,110
4,8477934,Leon Draisaitl,C,EDM,29,82,42,68,110
4,8480069,Cale Makar,D,COL,26,82,29,80,109
4,8476468,J.T. Miller,C,VAN,31,82,35,73,108
4,8476887,Filip Forsberg,L,NSH,30,82,45,59,104
4,8471675,Sidney Crosby,C,PIT,37,82,36,67,103
4,8482116,Tim Stützle,C,OTT,22,82,33,70,103
4,8476389,Vincent Trocheck,C,NYR,31,82,37,63,100
4,8477946,Dylan Larkin,C,DET,28,82,41,57,98
4,8479323,Adam Fox,D,NYR,26,82,14,84,98
4,8480800,Quinn Hughes,D,VAN,25,82,16,80,96
4,8480027,Jason Robertson,L,DAL,25,82,38,57,95
4,8481559,Jack Hughes,C,NJD,23,82,40,53,93
4,8479337,Alex DeBrincat,R,DET,27,82,38,55,93
4,8477942,Kevin Fiala,L,LAK,28,82,36,57,93
4,8480012,Elias Pettersson,C,VAN,26,82,45,47,92
4,8477409,Carter Verhaeghe,C,FLA,29,82,51,39,90
4,8475166,John Tavares,C,TOR,34,82,43,47,90
4,8479343,Clayton Keller,R,UTA,26,82,37,53,90
4,8474564,Steven Stamkos,C,NSH,34,82,33,57,90
4,8477404,Jake Guentzel,C,TBL,30,82,47,42,89
4,8475913,Mark Stone,R,VGK,32,82,32,57,89
4,8480002,Nico Hischier,C,NJD,25,82,31,58,89
4,8478403,Jack Eichel,C,VGK,28,82,38,50,88
4,8480801,Brady Tkachuk,L,OTT,25,82,32,56,88
4,8478398,Kyle Connor,L,WPG,28,82,41,45,86
4,8473512,Claude Giroux,R,OTT,36,82,32,54,86
4,8475167,Victor Hedman,D,TBL,34,82,17,69,86
4,8480208,Drake Batherson,R,OTT,26,82,30,55,85
4,8479420,Tage Thompson,C,BUF,27,82,39,45,84
4,8480830,Andrei Svechnikov,R,CAR,24,82,26,58,84
4,8481557,Matt Boldy,L,MIN,23,82,34,49,83
4,8477501,Valeri Nichushkin,R,COL,29,82,32,51,83
4,8475184,Chris Kreider,L,NYR,33,82,47,35,82
4,8480023,Robert Thomas,C,STL,25,82,25,57,82
4,8476454,Ryan Nugent-Hopkins,C,EDM,31,82,33,48,81
4,8479385,Jordan Kyrou,C,STL,26,82,36,44,80
4,8476459,Mika Zibanejad,C,NYR,31,82,35,45,80
4,8477940,Nikolaj Ehlers,L,WPG,28,82,35,45,80
4,8476346,Johnny Gaudreau,L,CBJ,31,82,17,63,80
4,8478427,Sebastian Aho,C,CAR,27,82,38,41,79
4,8477504,Josh Morrissey,D,WPG,29,82,14,65,79
4,8479407,Jesper Bratt,L,NJD,26,82,34,44,78
4,8478047,Michael Bunting,L,PIT,29,82,32,46,78
4,8474600,Roman Josi,D,NSH,34,82,18,60,78
4,8471214,Alex Ovechkin,L,WSH,39,82,39,38,77
4,8478042,Viktor Arvidsson,R,EDM,31,82,32,45,77
4,8476460,Mark Scheifele,C,WPG,31,82,28,49,77
4,8475172,Nazem Kadri,C,CGY,34,82,22,55,77
4,8477447,Shea Theodore,D,VGK,29,82,15,62,77
4,8477949,Alex Tuch,R,BUF,28,82,29,47,76
4,8471685,Anze Kopitar,C,LAK,37,82,23,53,76
4,8478445,Mathew Barzal,C,NYI,27,82,21,55,76
4,8476853,Morgan Rielly,D,TOR,30,82,11,65,76
4,8475726,Tyler Toffoli,C,SJS,32,82,38,37,75
4,8477496,Elias Lindholm,C,BOS,30,82,31,44,75
4,8478873,Troy Terry,R,ANA,27,82,24,51,75
4,8471215,Evgeni Malkin,C,PIT,38,82,23,52,75
4,8476539,Jonathan Marchessault,R,NSH,34,82,38,36,74
4,8477494,Jonathan Drouin,L,COL,29,82,20,54,74
4,8480839,Rasmus Dahlin,D,BUF,24,82,15,59,74
4,8478449,Roope Hintz,C,DAL,28,82,38,35,73
4,8477960,Adrian Kempe,R,LAK,28,82,36,37,73
4,8482093,Seth Jarvis,C,CAR,22,82,34,39,73
4,8482097,Jack Quinn,R,BUF,23,82,33,40,73
4,8476448,William Karlsson,C,VGK,31,82,37,35,72
4,8480036,Miro Heiskanen,D,DAL,25,82,15,57,72
4,8474590,John Carlson,D,WSH,34,82,14,58,72
4,8475168,Matt Duchene,C,DAL,33,82,35,36,71
4,8477407,Anthony Duclair,L,NYI,29,82,32,39,71
4,8481523,Kirby Dach,C,MTL,23,82,16,55,71
4,8475786,Zach Hyman,L,EDM,32,82,43,27,70
4,8475692,Mats Zuccarello,R,MIN,37,82,18,52,70
4,8477500,Bo Horvat,C,NYI,29,82,26,43,69
4,8477964,Ivan Barbashev,C,VGK,29,82,26,43,69
4,8478460,Zach Werenski,D,CBJ,27,82,22,47,69
4,8478444,Brock Boeser,R,VAN,27,82,31,37,68
4,8478055,Gustav Forsling,D,FLA,28,82,20,48,68
4,8478462,Nicolas Roy,C,VGK,27,82,38,29,67
4,8478439,Travis Konecny,R,PHI,27,82,36,31,67
4,8477951,Nick Schmaltz,C,UTA,28,82,32,35,67
4,8478414,Timo Meier,R,NJD,28,82,30,37,67
4,8477402,Pavel Buchnevich,L,STL,29,82,29,38,67
4,8475798,Mikael Granlund,C,SJS,32,82,20,47,67
4,8476456,Jonathan Huberdeau,C,CGY,31,82,17,50,67
4,8478038,Devon Toews,D,COL,30,82,16,51,67
4,8481540,Cole Caufield,R,MTL,23,82,42,24,66
4,8480014,Gabriel Vilardi,C,WPG,25,82,37,29,66
4,8480064,Josh Norris,C,OTT,25,82,34,32,66
4,8478396,Noah Hanifin,D,VGK,27,82,21,45,66
4,8475784,Jeff Skinner,C,EDM,32,82,30,35,65
4,8478493,Joel Eriksson Ek,C,MIN,27,82,29,36,65
4,8478975,Mason Marchment,L,DAL,29,82,28,37,65
4,8481533,Trevor Zegras,C,ANA,23,82,27,38,65
4,8479999,Casey Mittelstadt,C,COL,26,82,23,42,65
4,8476462,Dougie Hamilton,D,NJD,31,82,22,43,65
4,8474578,Erik Karlsson,D,PIT,34,82,16,49,65
4,8480803,Evan Bouchard,D,EDM,25,82,16,49,65
4,8475765,Vladimir Tarasenko,R,DET,33,82,28,36,64
4,8476881,Tomas Hertl,C,VGK,31,82,22,42,64
4,8474141,Patrick Kane,R,DET,36,82,19,45,64
4,8475810,Bryan Rust,R,PIT,32,82,30,33,63
4,8479542,Brandon Hagel,L,TBL,26,82,30,33,63
4,8476882,Teuvo Teravainen,L,CHI,30,82,29,34,63
4,8473419,Brad Marchand,L,BOS,36,82,19,44,63
4,8478498,Jake DeBrusk,L,VAN,28,82,33,29,62
4,8479339,Patrik Laine,L,CBJ,26,82,28,34,62
4,8478440,Dylan Strome,C,WSH,27,82,23,39,62
4,8481528,Dylan Cozens,C,BUF,23,82,23,39,62
4,8478407,Vince Dunn,D,SEA,28,82,10,52,62
4,8478010,Brayden Point,C,TBL,28,82,32,29,61
4,8482740,Wyatt Johnston,C,DAL,21,82,31,30,61
4,8482078,Lucas Raymond,L,DET,22,82,28,33,61
4,8480018,Nick Suzuki,C,MTL,25,82,19,42,61
4,8479410,Mikhail Sergachev,D,UTA,26,82,16,45,61
4,8474679,Gustav Nyquist,C,NSH,35,82,13,48,61
4,8474563,Drew Doughty,D,LAK,35,82,12,49,61
4,8479675,Trevor Moore,L,LAK,29,82,32,28,60
4,8477426,Nicholas Paul,L,TBL,29,82,30,30,60
4,8477476,Artturi Lehkonen,L,COL,29,82,27,33,60
4,8481596,Shane Pinto,C,OTT,24,82,25,35,60
4,8479325,Charlie McAvoy,D,BOS,27,82,10,50,60
4,8478469,Thomas Chabot,D,OTT,27,82,15,44,59
4,8477955,Jared McCann,L,SEA,28,82,31,27,58
4,8475754,Brock Nelson,C,NYI,33,82,27,31,58
4,8481711,Matias Maccelli,L,UTA,24,82,26,32,58
4,8482699,Dylan Guenther,R,UTA,21,82,25,33,58
4,8477986,Brandon Montour,D,SEA,30,82,15,43,58
4,8482665,Matty Beniers,C,SEA,22,82,28,29,57
4,8474586,Jordan Eberle,R,SEA,34,82,24,33,57
4,8482113,Anton Lundell,C,FLA,23,82,23,34,57
4,8475169,Evander Kane,L,EDM,33,82,26,30,56
4,8477456,J.T. Compher,L,DET,29,82,26,30,56
4,8478401,Pavel Zacha,C,BOS,27,82,20,36,56
4,8475745,Charlie Coyle,C,BOS,32,82,20,36,56
4,8477503,Max Domi,C,TOR,29,82,13,43,56
4,8471724,Kris Letang,D,PIT,37,82,12,44,56
4,8475768,Jaden Schwartz,C,SEA,32,82,24,31,55
4,8475791,Taylor Hall,L,CHI,33,82,22,33,55
4,8474565,Alex Pietrangelo,D,VGK,34,82,13,42,55
4,8480865,Noah Dobson,D,NYI,24,82,12,43,55
4,8482149,Cole Perfetti,C,WPG,22,82,20,34,54
4,8478542,Evan Rodrigues,C,FLA,31,82,20,34,54
4,8473994,Jamie Benn,L,DAL,35,82,16,38,54
4,8476792,Torey Krug,D,STL,33,82,10,44,54
4,8482109,Alexis Lafrenière,L,NYR,23,82,30,23,53
4,8476432,Boone Jenner,C,CBJ,31,82,29,24,53
4,8478519,Anthony Cirelli,C,TBL,27,82,26,27,53
4,8473986,Alex Killorn,L,ANA,35,82,26,27,53
4,8478115,Pierre Engvall,L,NYI,28,82,23,30,53
4,8481618,Alex Newhook,C,MTL,23,82,22,31,53
4,8482124,Quinton Byfield,R,LAK,22,82,20,33,53
4,8481542,Moritz Seider,D,DET,23,82,10,43,53
4,8480078,Filip Chytil,C,NYR,25,82,27,25,52
4,8477416,Oliver Bjorkstrand,R,SEA,29,82,26,26,52
4,8475170,Brayden Schenn,C,STL,33,82,23,29,52
4,8476458,Ryan Strome,C,ANA,31,82,21,31,52
4,8476480,Vladislav Namestnikov,C,WPG,32,82,16,36,52
4,8477495,Seth Jones,D,CHI,30,82,14,38,52
4,8482684,Luke Hughes,D,NJD,21,82,7,45,52
4,8479400,Pierre-Luc Dubois,L,WSH,26,82,27,24,51
4,8475794,Tyler Seguin,C,DAL,32,82,22,29,51
4,8482671,Owen Power,D,BUF,22,82,17,34,51
4,8477935,Sam Bennett,C,FLA,28,82,28,22,50
4,8480039,Martin Necas,C,CAR,25,82,23,27,50
4,8483808,Andrei Kuzmenko,L,CGY,28,82,22,28,50
4,8478856,Conor Garland,R,VAN,28,82,21,29,50
4,8479425,Filip Hronek,D,VAN,27,82,7,43,50
4,8482159,Tyson Foerster,R,PHI,22,82,31,18,49
4,8475191,Reilly Smith,R,NYR,33,82,25,24,49
4,8475760,Nick Bjugstad,C,UTA,32,82,25,24,49
4,8475158,Ryan O'Reilly,C,NSH,33,82,19,30,49
4,8470613,Brent Burns,D,CAR,39,82,18,31,49
4,8476826,Yanni Gourde,C,SEA,33,82,17,32,49
4,8478438,Tommy Novak,C,NSH,27,82,17,32,49
4,8479345,Jakob Chychrun,D,WSH,26,82,14,35,49
4,8476958,Jaccob Slavin,D,CAR,30,82,9,40,49
4,8482092,Ridly Greig,C,OTT,22,82,23,25,48
4,8484144,Connor Bedard,C,CHI,19,82,17,31,48
4,8475753,Justin Faulk,D,STL,32,82,11,37,48
4,8476399,Blake Coleman,C,CGY,33,82,32,15,47
4,8475799,Nino Niederreiter,R,WPG,32,82,26,21,47
4,8480015,Owen Tippett,R,PHI,25,82,22,25,47
4,8478233,Andrew Mangiapane,L,WSH,28,82,18,29,47
4,8477998,Warren Foegele,L,LAK,28,82,16,31,47
4,8478397,Rasmus Andersson,D,CGY,28,82,13,34,47
4,8477346,MacKenzie Weegar,D,CGY,30,82,12,35,47
4,8474716,Jared Spurgeon,D,MIN,35,82,10,37,47
4,8477948,Travis Sanheim,D,PHI,28,82,9,38,47
4,8478366,Frank Vatrano,R,ANA,30,82,29,17,46
4,8477479,Tyler Bertuzzi,L,CHI,29,82,21,25,46
4,8477497,Sean Monahan,C,CBJ,30,82,20,26,46
4,8476880,Tom Wilson,R,WSH,30,82,20,26,46
4,8476927,Teddy Blueger,C,VAN,30,82,19,27,46
4,8480829,Jesperi Kotkaniemi,C,CAR,24,82,19,27,46
4,8480871,Adam Boqvist,D,FLA,24,82,12,34,46
4,8483515,Juraj Slafkovsky,L,MTL,20,82,27,18,45
4,8476918,Jimmy Vesey,L,NYR,31,82,21,24,45
4,8482110,Dawson Mercer,C,NJD,23,82,19,26,45
4,8474102,David Perron,L,OTT,36,82,18,27,45
4,8475714,Calle Jarnkrok,C,TOR,33,82,18,27,45
4,8476925,Colton Sissons,C,NSH,31,82,15,30,45
4,8480817,K'Andre Miller,D,NYR,24,82,6,39,45
4,8479525,Ross Colton,C,COL,28,82,25,19,44
4,8474641,Adam Henrique,C,EDM,34,82,22,22,44
4,8480802,Ryan McLeod,C,BUF,25,82,22,22,44
4,8479591,Michael Eyssimont,C,TBL,28,82,21,23,44
4,8477451,Ryan Hartman,R,MIN,30,82,19,25,44
4,8481580,Connor McMichael,C,WSH,23,82,19,25,44
4,8474053,Logan Couture,C,SJS,35,82,18,26,44
4,8482745,Mason McTavish,C,ANA,21,82,17,27,44
4,8477429,Andrew Copp,C,DET,30,82,16,28,44
4,8476905,Chandler Stephenson,C,SEA,30,82,14,30,44
4,8476479,Phillip Danault,C,LAK,31,82,13,31,44
4,8481656,Aliaksei Protas,C,WSH,23,82,13,31,44
4,8480145,Neal Pionk,D,WPG,29,82,11,33,44
4,8476329,Travis Boyd,C,MIN,31,82,10,34,44
4,8476854,Hampus Lindholm,D,BOS,30,82,8,36,44
4,8478020,Michael Amadio,C,OTT,28,82,25,18,43
4,8481068,Yegor Sharangovich,C,CGY,26,82,24,19,43
4,8482667,William Eklund,L,SJS,22,82,19,24,43
4,8478891,Mason Appleton,C,WPG,28,82,18,25,43
4,8477021,Alex Kerfoot,C,UTA,30,82,12,31,43
4,8479987,Morgan Geekie,C,BOS,26,82,11,32,43
4,8476885,Jacob Trouba,D,NYR,30,82,8,35,43
4,8481560,Arthur Kaliyev,R,LAK,23,82,27,15,42
4,8481704,Juuso Parssinen,C,NSH,23,82,19,23,42
4,8474150,Mikael Backlund,C,CGY,35,82,17,25,42
4,8482055,Drew O'Connor,L,PIT,26,82,16,26,42
4,8475763,Kevin Hayes,R,PIT,32,82,16,26,42
4,8480028,Morgan Frost,C,PHI,25,82,15,27,42
4,8480188,Fabian Zetterlund,L,SJS,25,82,15,27,42
4,8478472,Mathieu Joseph,R,STL,27,82,15,27,42
4,8479398,Samuel Girard,D,COL,26,82,10,32,42
4,8478133,Jake Evans,C,MTL,28,82,9,33,42
4,8482079,Marco Rossi,C,MIN,23,82,28,13,41
4,8476438,Brandon Saad,L,STL,32,82,22,19,41
4,8478057,Dakota Joshua,C,VAN,28,82,19,22,41
4,8478413,Jordan Greenway,L,BUF,27,82,18,23,41
4,8479992,Michael Rasmussen,C,DET,25,82,16,25,41
4,8477444,Andre Burakovsky,L,SEA,29,82,14,27,41
4,8476292,Ondrej Palat,L,NJD,33,82,14,27,41
4,8476906,Shayne Gostisbehere,D,CAR,31,82,9,32,41
4,8475764,Cam Fowler,D,ANA,33,82,7,34,41
4,8482175,JJ Peterka,R,BUF,22,82,19,21,40
4,8479293,Brandon Tanev,L,SEA,33,82,18,22,40
4,8480849,Barrett Hayton,C,UTA,24,82,17,23,40
4,8477932,Aaron Ekblad,D,FLA,28,82,15,25,40
4,8475149,Marcus Johansson,L,MIN,34,82,15,25,40
4,8479390,Taylor Raddysh,R,WSH,26,82,15,25,40
4,8476474,Stefan Noesen,R,NJD,31,82,14,26,40
4,8480185,Eetu Luostarinen,C,FLA,26,82,12,28,40
4,8477220,Nate Schmidt,D,FLA,33,82,9,31,40
4,8481606,Jordan Spence,D,LAK,23,82,8,32,40
4,8476875,Mike Matheson,D,MTL,30,82,6,34,40
4,8477511,Anthony Mantha,R,CGY,30,82,21,18,39
4,8478474,Lawson Crouse,L,UTA,27,82,20,19,39
4,8481554,Kaapo Kakko,R,NYR,23,82,20,19,39
4,8475793,Ryan Johansen,C,PHI,32,82,19,20,39
4,8476483,Rickard Rakell,R,PIT,31,82,18,21,39
4,8481186,Logan O'Connor,R,COL,28,82,15,24,39
4,8484153,Leo Carlsson,C,ANA,20,82,13,26,39
4,8478458,Jack Roslovic,C,CAR,27,82,12,27,39
4,8479393,Noah Gregor,C,OTT,26,82,24,14,38
4,8475151,Kyle Palmieri,C,NYI,33,82,23,15,38
4,8471698,T.J. Oshie,R,WSH,38,82,21,17,38
4,8476981,Josh Anderson,R,MTL,30,82,19,19,38
4,8479365,Trent Frederic,C,BOS,26,82,18,20,38
4,8481535,Nils Hoglander,L,VAN,24,82,18,20,38
4,8475287,Erik Haula,L,NJD,33,82,17,21,38
4,8473422,Nick Foligno,L,CHI,37,82,17,21,38
4,8473563,Nicklas Backstrom,C,WSH,37,82,17,21,38
4,8482117,Lukas Reichel,L,CHI,22,82,17,21,38
4,8481624,Ilya Mikheyev,R,CHI,30,82,16,22,38
4,8476419,Jean-Gabriel Pageau,C,NYI,32,82,15,23,38
4,8481013,Jonatan Berggren,R,DET,24,82,14,24,38
4,8480220,Noah Cates,L,PHI,25,82,12,26,38
4,8475722,Jason Zucker,L,BUF,32,82,10,28,38
4,8480434,Sean Durzi,D,UTA,26,82,10,28,38
4,8476979,Erik Gustafsson,D,DET,32,82,10,28,38
4,8476923,Damon Severson,D,CBJ,30,82,9,29,38
4,8480043,Timothy Liljegren,D,TOR,25,82,4,34,38
4,8475314,Anders Lee,L,NYI,34,82,24,13,37
4,8482146,Luke Evangelista,R,NSH,22,82,21,16,37
4,8481604,Pavel Dorofeyev,L,VGK,24,82,16,21,37
4,8477987,Ryan Donato,C,CHI,28,82,15,22,37
4,8480113,Alex Iafallo,L,WPG,31,82,10,27,37
4,8480009,Eeli Tolvanen,R,SEA,25,82,19,17,36
4,8482475,Yegor Chinakhov,R,CBJ,23,82,18,18,36
4,8478508,Yakov Trenin,C,MIN,27,82,18,18,36
4,8476873,Mark Jankowski,C,NSH,30,82,16,20,36
4,8480797,Joel Farabee,L,PHI,24,82,15,21,36
4,8480798,Philipp Kurashev,C,CHI,25,82,14,22,36
4,8480068,Ryan Poehling,C,PHI,25,82,14,22,36
4,8479351,Sam Steel,C,DAL,26,82,12,24,36
4,8476422,Mike Reilly,D,NYI,31,82,12,24,36
4,8476869,Brady Skjei,D,NSH,30,82,10,26,36
4,8476931,Jake McCabe,D,TOR,31,82,5,31,36
4,8475193,Tomas Tatar,L,NJD,34,82,20,15,35
4,8479353,Brett Howden,C,VGK,26,82,17,18,35
4,8475343,Nic Dowd,C,WSH,34,82,15,20,35
4,8477947,Sonny Milano,L,WSH,28,82,14,21,35
4,8482133,Thomas Bordeleau,C,SJS,22,82,13,22,35
4,8476960,Andreas Athanasiou,C,CHI,30,82,11,24,35
4,8478882,Vladislav Gavrikov,D,LAK,29,82,10,25,35
4,8475218,Mattias Ekholm,D,EDM,34,82,9,26,35
4,8475200,Dmitry Orlov,D,CAR,33,82,4,31,35
4,8480459,Pius Suter,C,VAN,28,82,17,17,34
4,8481481,Blake Lizotte,C,PIT,27,82,17,17,34
4,8479941,Justin Danforth,R,CBJ,31,82,16,18,34
4,8480748,Kiefer Sherwood,L,VAN,29,82,12,22,34
4,8482105,Jake Sanderson,D,OTT,22,82,7,27,34
4,8479976,Juuso Valimaki,D,UTA,26,82,4,30,34
4,8482089,Jake Neighbours,L,STL,22,82,19,14,33
4,8481582,Nicholas Robertson,L,TOR,23,82,18,15,33
4,8482705,Cole Sillinger,C,CBJ,21,82,16,17,33
4,8475220,Marcus Foligno,L,MIN,33,82,15,18,33
4,8478046,Danton Heinen,L,VAN,29,82,14,19,33
4,8482660,Kent Johnson,C,CBJ,22,82,14,19,33
4,8480855,Jack McBain,C,UTA,24,82,13,20,33
4,8474715,Cam Atkinson,R,TBL,35,82,11,22,33
4,8481581,Thomas Harley,D,DAL,23,82,10,23,33
4,8482122,Brock Faber,D,MIN,22,82,9,24,33
4,8477498,Darnell Nurse,D,EDM,29,82,7,26,33
4,8477365,Connor Clifton,D,BUF,29,82,7,26,33
4,8477969,Marcus Pettersson,D,PIT,28,82,3,30,33
4,8473533,Jordan Staal,C,CAR,36,82,16,16,32
4,8476921,Jordan Martinook,L,CAR,32,82,16,16,32
4,8477425,Miles Wood,L,COL,29,82,11,21,32
4,8477919,Frederick Gaudreau,C,MIN,31,82,9,23,32
4,8477488,Brett Pesce,D,NJD,30,82,8,24,32
4,8476872,Scott Laughton,C,PHI,30,82,7,25,32
4,8480873,Rasmus Sandin,D,WSH,24,82,7,25,32
4,8475181,Nick Leddy,D,STL,33,82,5,27,32
4,8474189,Lars Eller,C,PIT,35,82,22,9,31
4,8476392,Adam Lowry,C,WPG,31,82,18,13,31
4,8480813,Joe Veleno,C,DET,24,82,18,13,31
4,8475842,Sam Carrick,C,NYR,32,82,15,16,31
4,8474149,Evgenii Dadonov,R,DAL,35,82,12,19,31
4,8480003,Jesper Boqvist,C,FLA,26,82,12,19,31
4,8478911,Matt Roy,D,WSH,29,82,9,22,31
4,8482166,Shakir Mukhamadullin,D,SJS,22,82,9,22,31
4,8481546,Cam York,D,PHI,23,82,6,25,31
4,8482245,Artem Zub,D,OTT,29,82,5,26,31
4,8480246,Nick Perbix,D,TBL,26,82,5,26,31
4,8478178,Darren Raddysh,D,TBL,28,82,5,26,31
4,8481178,Egor Zamula,D,PHI,24,82,4,27,31
4,8476331,Dylan DeMelo,D,WPG,31,82,4,27,31
4,8478840,Will Borgen,D,SEA,28,82,4,27,31
4,8474673,TJ Brodie,D,CHI,34,82,4,27,31
4,8477845,Trevor van Riemsdyk,D,WSH,33,82,3,28,31
4,8477952,Robby Fabbri,C,ANA,28,82,17,13,30
4,8480144,David Kampf,C,TOR,29,82,16,14,30
4,8481553,Bobby Brink,R,PHI,23,82,13,17,30
4,8483565,Nick Blankenburg,D,NSH,26,82,10,20,30
4,8481522,Peyton Krebs,C,BUF,23,82,8,22,30
4,8478211,Dryden Hunt,L,CGY,29,82,8,22,30
4,8480893,Kirill Marchenko,R,CBJ,24,82,19,10,29
4,8480835,Jack Drury,C,CAR,24,82,17,12,29
4,8481032,Paul Cotter,C,NJD,25,82,16,13,29
4,8479996,Cody Glass,C,NSH,25,82,15,14,29
4,8479414,Nathan Bastian,R,NJD,27,82,14,15,29
4,8482062,Cole Smith,L,NSH,29,82,13,16,29
4,8477953,Kasperi Kapanen,R,STL,28,82,12,17,29
4,8481708,Zac Jones,D,NYR,24,82,7,22,29
4,8475188,Brayden McNabb,D,VGK,33,82,5,24,29
4,8473507,Jeff Petry,D,DET,37,82,5,24,29
4,8482679,Matt Coronato,R,CGY,22,82,5,24,29
4,8475171,Oliver Ekman-Larsson,D,TOR,33,82,3,26,29
4,8479359,Beck Malenstyn,L,BUF,26,82,19,9,28
4,8481477,Nico Sturm,C,SJS,29,82,14,14,28
4,8483431,Logan Cooley,C,UTA,20,82,13,15,28
4,8476889,Radek Faksa,C,STL,30,82,13,15,28
4,8482720,Matthew Knies,L,TOR,22,82,12,16,28
4,8482125,Alexander Holtz,R,VGK,22,82,12,16,28
4,8478463,Anthony Beauvillier,L,PIT,27,82,11,17,28
4,8482087,Kaiden Guhle,D,MTL,22,82,8,20,28
4,8483457,Lane Hutson,D,MTL,20,82,8,20,28
4,8482803,Olen Zellweger,D,ANA,21,82,7,21,28
4,8480878,Nils Lundkvist,D,DAL,24,82,6,22,28
4,8476917,Adam Pelech,D,NYI,30,82,6,22,28
4,8479983,Mario Ferraro,D,SJS,26,82,6,22,28
4,8482259,Bobby McMann,C,TOR,28,82,16,11,27
4,8482624,Daniil Miromanov,D,CGY,27,82,16,11,27
4,8475855,Jesper Fast,R,CAR,33,82,10,17,27
4,8476374,Sean Kuraly,C,CBJ,31,82,8,19,27
4,8477506,Ryan Pulock,D,NYI,30,82,6,21,27
4,8480049,Dylan Samberg,D,WPG,25,82,4,23,27
4,8478109,Victor Olofsson,L,VGK,29,82,15,11,26
4,8477903,Garnet Hathaway,R,PHI,33,82,13,13,26
4,8477989,Christian Dvorak,C,MTL,28,82,12,14,26
4,8482074,Connor Zary,C,CGY,23,82,12,14,26
4,8478569,Noel Acciari,C,PIT,33,82,11,15,26
4,8479316,Luke Kunin,C,SJS,27,82,10,16,26
4,8477450,Jason Dickinson,C,CHI,29,82,9,17,26
4,8480995,Pontus Holmberg,R,TOR,25,82,9,17,26
4,8476278,Colin Blackwell,C,DAL,31,82,9,17,26
4,8482073,Braden Schneider,D,NYR,23,82,7,19,26
4,8477507,Nikita Zadorov,D,BOS,29,82,5,21,26
4,8478500,Ivan Provorov,D,CBJ,27,82,5,21,26
4,8475279,Ben Chiarot,D,DET,33,82,5,21,26
4,8480035,Henri Jokiharju,D,BUF,25,82,3,23,26
4,8484166,Adam Fantilli,C,CBJ,20,82,15,10,25
4,8476624,Barclay Goodrow,C,SJS,31,82,11,14,25
4,8484145,Zach Benson,L,BUF,19,82,10,15,25
4,8482111,Justin Barron,D,MTL,23,82,10,15,25
4,8477499,Rasmus Ristolainen,D,PHI,30,82,9,16,25
4,8477931,Tomas Nosek,L,FLA,32,82,8,17,25
4,8477015,Connor Brown,R,EDM,30,82,6,19,25
4,8475690,Chris Tanev,D,TOR,35,82,5,20,25
4,8482655,J.J. Moser,D,TBL,24,82,2,23,25
4,8475848,Brendan Gallagher,R,MTL,32,82,13,11,24
4,8477839,Conor Sheary,L,TBL,32,82,11,13,24
4,8476897,Oskar Sundqvist,C,STL,30,82,10,14,24
4,8480336,Sean Walker,D,CAR,30,82,8,16,24
4,8476463,Jonas Brodin,D,MIN,31,82,7,17,24
4,8482702,Logan Stankoven,C,DAL,21,82,7,17,24
4,8470621,Corey Perry,R,EDM,39,82,6,18,24
4,8479980,Nicolas Hague,D,VGK,26,82,6,18,24
4,8482142,Jamie Drysdale,D,PHI,22,82,4,20,24
4,8476525,Colin Miller,D,WPG,32,82,3,21,24
4,8479402,Jake Bean,D,CGY,26,82,2,22,24
4,8478851,Alexandre Carrier,D,NSH,28,82,2,22,24
4,8480980,Connor Dewar,C,TOR,25,82,9,14,23
4,8474574,Tyler Myers,D,VAN,34,82,6,17,23
4,8481568,Alex Vlasic,D,CHI,23,82,6,17,23
4,8476891,Matt Grzelcyk,D,PIT,30,82,5,18,23
4,8479371,Dante Fabbro,D,NSH,26,82,4,19,23
4,8478136,Jake Middleton,D,MIN,28,82,3,20,23
4,8482155,Alex Laferriere,R,LAK,23,82,14,8,22
4,8479368,Max Jones,L,BOS,26,82,14,8,22
4,8480074,Alexandre Texier,C,STL,25,82,11,11,22
4,8480448,Parker Kelly,L,COL,25,82,10,12,22
4,8479661,Tanner Jeannot,L,LAK,27,82,10,12,22
4,8478432,Christian Fischer,R,DET,27,82,10,12,22
4,8480806,Isac Lundestrom,C,ANA,25,82,9,13,22
4,8476442,Matt Nieto,L,PIT,32,82,9,13,22
4,8475231,Casey Cizikas,C,NYI,33,82,8,14,22
4,8477353,Tyler Motte,C,DET,29,82,8,14,22
4,8477938,Haydn Fleury,D,WPG,28,82,8,14,22
4,8482858,Ryker Evans,D,SEA,23,82,8,14,22
4,8476312,Josh Manson,D,COL,33,82,7,15,22
4,8476461,Sean Couturier,C,PHI,32,82,6,16,22
4,8482809,Jackson Blake,R,CAR,21,82,6,16,22
4,8480073,Erik Brannstrom,D,COL,25,82,3,19,22
4,8476457,Adam Larsson,D,SEA,32,82,3,19,22
4,8476467,Jamie Oleksiak,D,SEA,32,82,3,19,22
4,8476902,Esa Lindell,D,DAL,30,82,2,20,22
4,8476879,Cody Ceci,D,EDM,31,82,2,20,22
4,8474151,Ryan McDonagh,D,TBL,35,82,1,21,22
4,8480281,Alexey Toropchenko,R,STL,25,82,10,11,21
4,8481524,Bowen Byram,D,BUF,23,82,10,11,21
4,8477406,Mattias Janmark,C,EDM,32,82,10,11,21
4,8482762,Simon Edvinsson,D,DET,21,82,9,12,21
4,8481605,Jackson LaCombe,D,ANA,23,82,8,13,21
4,8480789,Oliver Wahlstrom,R,NYI,24,82,7,14,21
4,8476469,Joel Armia,R,MTL,31,82,7,14,21
4,8484911,Collin Graf,R,SJS,22,82,6,15,21
4,8483482,Tristan Luneau,D,ANA,20,82,6,15,21
4,8480950,Ilya Lyubushkin,D,DAL,30,82,5,16,21
4,8475790,Erik Gudbranson,D,CBJ,32,82,5,16,21
4,8483460,David Jiricek,D,CBJ,21,82,3,18,21
4,8483490,Pavel Mintyukov,D,ANA,21,82,2,19,21
4,8476878,Zemgus Girgensons,L,TBL,30,82,11,9,20
4,8480990,Declan Chisholm,D,MIN,24,82,7,13,20
4,8477508,Curtis Lazar,C,NJD,29,82,6,14,20
4,8484149,Gavin Brindley,C,CBJ,20,82,6,14,20
4,8482733,Logan Mailloux,D,MTL,31,82,5,15,20
4,8477435,Ryan Graves,D,PIT,29,82,5,15,20
4,8483445,Cutter Gauthier,L,ANA,20,82,4,16,20
4,8479324,Ryan Lindgren,D,NYR,26,82,3,17,20
4,8481014,Alexander Romanov,D,NYI,24,82,2,18,20
4,8483495,Simon Nemec,D,NJD,20,82,2,18,20
4,8475462,Radko Gudas,D,ANA,34,82,0,20,20
4,8481641,Joel Kiviranta,L,COL,28,82,14,5,19
4,8478434,Keegan Kolesar,R,VGK,27,82,10,9,19
4,8481517,Brett Leason,R,ANA,25,82,10,9,19
4,8477392,Hudson Fasching,R,NYI,29,82,9,10,19
4,8476441,Joel Edmundson,D,LAK,31,82,7,12,19
4,8478013,Jake Walman,D,SJS,28,82,6,13,19
4,8478507,John Marino,D,UTA,27,82,4,15,19
4,8475233,David Savard,D,MTL,34,82,4,15,19
4,8480807,Mattias Samuelsson,D,BUF,24,82,3,16,19
4,8482516,Matthew Kessel,D,STL,24,82,3,16,19
4,8478874,Adam Gaudette,C,OTT,28,82,1,18,19
4,8482077,Dylan Holloway,L,EDM,23,82,10,8,18
4,8482749,Joshua Roy,R,MTL,21,82,10,8,18
4,8484203,Bradly Nadeau,L,CAR,19,82,9,9,18
4,8477034,Jaycob Megna,D,FLA,32,82,5,13,18
4,8477335,Kyle Burroughs,D,LAK,29,82,4,14,18
4,8480860,Kevin Bahl,D,CGY,24,82,3,15,18
4,8480021,Jack Studnicka,C,LAK,25,82,8,9,17
4,8483505,Matthew Poitras,C,BOS,20,82,8,9,17
4,8476822,Luke Glendening,C,TBL,35,82,8,9,17
4,8482807,Ethan Del Mastro,D,CHI,21,82,7,10,17
4,8482101,Danil Gushchin,L,SJS,22,82,6,11,17
4,8480025,MacKenzie Entwistle,R,FLA,25,82,5,12,17
4,8483468,Jiri Kulich,C,BUF,20,82,4,13,17
4,8478859,Niko Mikkola,D,FLA,28,82,3,14,17
4,8478399,Jonas Siegenthaler,D,NJD,27,82,1,16,17
4,8482118,Sam Colangelo,R,ANA,23,82,8,8,16
4,8479291,Kevin Rooney,C,CGY,31,82,7,9,16
4,8481093,Rafael Harvey-Pinard,L,MTL,25,82,6,10,16
4,8477369,Carson Soucy,D,VAN,30,82,6,10,16
4,8478468,Jeremy Lauzon,D,NSH,27,82,6,10,16
4,8483763,Maksymilian Szuber,D,UTA,22,82,4,12,16
4,8476967,Brett Kulak,D,EDM,30,82,3,13,16
4,8479442,Troy Stecher,D,EDM,30,82,3,13,16
4,8476429,Scott Mayfield,D,NYI,32,82,1,15,16
4,8475718,Justin Holl,D,DET,32,82,1,15,16
4,8482141,Lukas Cormier,D,VGK,22,82,0,16,16
4,8474013,Ian Cole,D,UTA,35,82,0,16,16
4,8473453,Trevor Lewis,C,LAK,37,82,9,6,15
4,8481028,Martin Pospisil,C,CGY,25,82,8,7,15
4,8483524,Shane Wright,C,SEA,20,82,8,7,15
4,8477505,Alexander Wennberg,C,SJS,30,82,8,7,15
4,8480870,Bo Groulx,C,NYR,24,82,7,8,15
4,8482145,Mavrik Bourque,C,DAL,22,82,6,9,15
4,8480222,Sebastian Aho,D,PIT,28,82,5,10,15
4,8474612,Travis Hamonic,D,OTT,34,82,4,11,15
4,8483499,Liam Ohgren,L,MIN,20,82,3,12,15
4,8475177,Calvin de Haan,D,COL,33,82,3,12,15
4,8482153,Brendan Brisson,C,VGK,23,82,2,13,15
4,8480172,Jan Rutta,D,SJS,34,82,1,14,15
4,8476858,Phillip Di Giuseppe,L,VAN,31,82,8,6,14
4,8482666,Scott Morrow,D,CAR,22,82,5,9,14
4,8483471,Brad Lambert,C,WPG,31,82,5,9,14
4,8475762,Derek Forbort,D,VAN,32,82,5,9,14
4,8476892,Colton Parayko,D,STL,31,82,4,10,14
4,8481699,Aku Raty,R,UTA,23,82,4,10,14
4,8475455,Brenden Dillon,D,NJD,34,82,2,12,14
4,8478450,Parker Wotherspoon,D,BOS,27,82,2,12,14
4,8481601,Simon Holmstrom,R,NYI,23,82,9,4,13
4,8482712,Oskar Olausson,R,COL,22,82,7,6,13
4,8483397,Marc McLaughlin,C,BOS,25,82,7,6,13
4,8480796,Martin Fehervary,D,WSH,25,82,6,7,13
4,8483493,Frank Nazar,C,CHI,20,82,4,9,13
4,8474090,Brendan Smith,D,DAL,35,82,4,9,13
4,8481567,Henry Thrun,D,SJS,23,82,4,9,13
4,8478416,Erik Cernak,D,TBL,27,82,3,10,13
4,8475324,Nick Jensen,D,OTT,34,82,2,11,13
4,8480834,Ty Emberson,D,SJS,24,82,2,11,13
4,8481122,Simon Benoit,D,TOR,26,82,1,12,13
4,8483012,Logan Morrison,C,SEA,22,82,5,7,12
4,8479369,Andrew Peeke,D,BOS,26,82,3,9,12
4,8478443,Brandon Carlo,D,BOS,28,82,3,9,12
4,8476473,Connor Murphy,D,CHI,31,82,3,9,12
4,8470600,Ryan Suter,D,STL,39,82,2,10,12
4,8479998,Mikey Anderson,D,LAK,25,82,1,11,12
4,8483489,Fraser Minten,C,TOR,31,82,4,7,11
4,8482713,Mackie Samoskevich,R,FLA,22,82,4,7,11
4,8483466,Kevin Korchinski,D,CHI,20,82,3,8,11
4,8476372,Nick Seeler,D,PHI,31,82,2,9,11
4,8479638,Justin Brazeau,R,BOS,26,82,7,3,10
4,8483567,Georgii Merkulov,C,BOS,24,82,4,6,10
4,8482070,Mitchell Chaffee,R,TBL,26,82,3,7,10
4,8482659,Josh Doan,R,UTA,22,82,2,8,10
4,8482787,Nikita Chibrikov,R,WPG,31,82,4,5,9
4,8474567,Zach Bogosian,D,MIN,34,82,3,6,9
4,8480879,Jacob Bernard-Docker,D,OTT,24,82,2,7,9
4,8482859,Zack Ostapchuk,C,OTT,21,82,2,7,9
4,8479576,Vincent Desharnais,D,VAN,28,82,0,9,9
4,8482470,Ilya Solovyov,D,CGY,24,82,2,6,8
4,8471677,Jack Johnson,D,CBJ,37,82,1,5,6
4,8474062,Riley Nash,C,NYR,35,82,1,3,4
4,8470794,Joe Pavelski,C,,40,0,0,0,0
4,8481703,Valtteri Puustinen,R,PIT,25,0,0,0,0
4,8477950,Tony DeAngelo,D,,29,0,0,0,0
4,8481577,Philip Tomasino,C,NSH,23,0,0,0,0
4,8475197,Tyson Barrie,D,,33,0,0,0,0
4,8471218,Blake Wheeler,R,,38,0,0,0,0
4,8474157,Max Pacioretty,L,,36,0,0,0,0
4,8478466,Daniel Sprong,R,VAN,27,0,0,0,0
4,8475744,Evgeny Kuznetsov,C,,32,0,0,0,0
4,8481019,David Gustafsson,C,WPG,24,0,0,0,0
4,8475906,John Klingberg,D,,32,0,0,0,0
4,8479348,Kale Clague,D,BUF,26,0,0,0,0
4,8476952,Dominic Toninato,C,WPG,30,0,0,0,0
4,8473473,Milan Lucic,L,,36,0,0,0,0
4,8474037,James van Riemsdyk,L,,35,0,0,0,0
4,8474602,Justin Schultz,D,,34,0,0,0,0
4,8482222,Alexander Barabanov,L,,30,0,0,0,0
4,8479372,Josh Mahura,D,SEA,26,0,0,0,0
4,8479982,Conor Timmins,D,TOR,26,0,0,0,0
4,8474031,Kevin Shattenkirk,D,,35,0,0,0,0
4,8480008,Adam Ruzicka,C,,25,0,0,0,0
4,8481059,Scott Perunovich,D,STL,26,0,0,0,0
4,8480884,Calen Addison,D,,24,0,0,0,0
4,8476994,Vinnie Hinostroza,C,NSH,30,0,0,0,0
4,8478452,Caleb Jones,D,LAK,27,0,0,0,0
4,8480157,Calle Rosen,D,COL,30,0,0,0,0
4,8481609,Vladislav Kolyachonok,D,UTA,23,0,0,0,0
4,8479415,Michael McLeod,C,,26,0,0,0,0
4,8476919,Chris Tierney,C,,30,0,0,0,0
4,8479639,Dylan Coghlan,D,WPG,26,0,0,0,0
4,8478146,Matthew Highmore,C,OTT,28,0,0,0,0
4,8478970,Jalen Chatfield,D,CAR,28,0,0,0,0
4,8480205,Emil Bemstrom,C,PIT,25,0,0,0,0
4,8474884,Mike Hoffman,C,,35,0,0,0,0
4,8471274,Alex Goligoski,D,,39,0,0,0,0
4,8478104,Sammy Blais,L,,28,0,0,0,0
4,8474870,Tyler Johnson,C,,34,0,0,0,0
4,8476913,Devin Shore,C,MIN,30,0,0,0,0
4,8481598,Philip Broberg,D,EDM,23,0,0,0,0
4,8480058,Pierre-Olivier Joseph,D,STL,25,0,0,0,0
4,8480891,Michael Kesselring,D,UTA,24,0,0,0,0
4,8477979,Nicolas Aube-Kubel,R,BUF,28,0,0,0,0
4,8476871,Tanner Pearson,L,,32,0,0,0,0
4,8476393,Nick Cousins,C,,31,0,0,0,0
4,8479977,Kailer Yamamoto,R,,26,0,0,0,0
4,8479543,Michael Pezzetta,L,MTL,26,0,0,0,0
4,8477018,Ben Hutton,D,VGK,31,0,0,0,0
4,8480762,Eric Robinson,L,CAR,29,0,0,0,0
4,8474034,Pat Maroon,L,CHI,36,0,0,0,0
4,8481058,Jesse Ylönen,R,,25,0,0,0,0
4,8475179,Dmitry Kulikov,D,FLA,34,0,0,0,0
4,8481527,Kaedan Korczak,D,VGK,23,0,0,0,0
4,8473449,Kyle Okposo,R,,36,0,0,0,0
4,8482192,Isaak Phillips,D,CHI,23,0,0,0,0
4,8480727,Zach Whitecloud,D,VGK,28,0,0,0,0
4,8479346,Dillon Dube,C,,26,0,0,0,0
4,8480821,Filip Zadina,R,,25,0,0,0,0
4,8480001,Urho Vaakanainen,D,ANA,25,0,0,0,0
4,8470966,Mark Giordano,D,,41,0,0,0,0
4,8480853,Liam Foudy,C,,24,0,0,0,0
4,8475225,Craig Smith,C,CHI,35,0,0,0,0
4,8479972,Mason Shaw,C,WPG,26,0,0,0,0
4,8478451,Ethan Bear,D,WSH,27,0,0,0,0
4,8474040,Sam Gagner,C,,35,0,0,0,0
4,8480196,Jacob Bryson,D,BUF,27,0,0,0,0
4,8479984,Cal Foote,D,,26,0,0,0,0
4,8480011,Klim Kostin,C,SJS,25,0,0,0,0
4,8482176,Wyatt Kaiser,D,CHI,22,0,0,0,0
4,8476988,Matt Benning,D,SJS,30,0,0,0,0
4,8479370,Tyson Jost,C,CAR,26,0,0,0,0
4,8477464,Nic Petan,C,,29,0,0,0,0
4,8477380,Jonny Brodzinski,C,NYR,31,0,0,0,0
4,8480070,Ian Mitchell,D,BOS,25,0,0,0,0
4,8479315,Joey Anderson,R,CHI,26,0,0,0,0
4,8478099,Kevin Labanc,R,,29,0,0,0,0
4,8476874,Olli Maatta,D,DET,30,0,0,0,0
4,8475208,Brian Dumoulin,D,ANA,33,0,0,0,0
4,8478430,Oliver Kylington,D,,27,0,0,0,0
4,8479536,Axel Jonsson-Fjallby,L,WPG,26,0,0,0,0
4,8479671,Mathieu Olivier,R,CBJ,27,0,0,0,0
4,8471709,Marc-Edouard Vlasic,D,SJS,37,0,0,0,0
4,8479328,Julien Gauthier,R,NYI,27,0,0,0,0
4,8478421,A.J. Greer,L,FLA,28,0,0,0,0
4,8477573,Nathan Walker,L,STL,30,0,0,0,0
4,8481537,Nikita Okhotiuk,D,CGY,24,0,0,0,0
4,8474166,Alec Martinez,D,CHI,37,0,0,0,0
4,8470610,Zach Parise,L,,40,0,0,0,0
4,8477478,William Carrier,L,CAR,30,0,0,0,0
4,8479344,Jesse Puljujarvi,R,PIT,26,0,0,0,0
4,8480887,Jordan Harris,D,MTL,24,0,0,0,0
4,8478502,Dennis Gilbert,D,BUF,28,0,0,0,0
4,8482730,Brandt Clarke,D,LAK,21,0,0,0,0
4,8480355,Mark Kastelic,C,BOS,25,0,0,0,0
4,8475750,Jon Merrill,D,MIN,32,0,0,0,0
4,8475164,Jakob Silfverberg,R,,34,0,0,0,0
4,8477944,Jakub Vrana,L,,28,0,0,0,0
4,8479439,Jacob MacDonald,D,COL,31,0,0,0,0
4,8474568,Luke Schenn,D,NSH,35,0,0,0,0
4,8478454,Noah Juulsen,D,VAN,27,0,0,0,0
4,8475752,Tyler Pitlick,C,,33,0,0,0,0
4,8482148,Hendrix Lapierre,C,WSH,22,0,0,0,0
4,8481167,Brayden Pachal,D,CGY,25,0,0,0,0
4,8478043,Sam Lafferty,C,BUF,29,0,0,0,0
4,8479321,Lucas Johansen,D,,27,0,0,0,0
4,8471699,Andrew Cogliano,C,,37,0,0,0,0
4,8481521,Ronnie Attard,D,PHI,25,0,0,0,0
4,8481161,Jake Christiansen,D,CBJ,25,0,0,0,0
4,8479458,Nikita Zaitsev,D,,33,0,0,0,0
4,8479619,Michael Carcone,L,UTA,28,0,0,0,0
4,8479026,Philippe Myers,D,TOR,27,0,0,0,0
4,8477330,Dominik Kubalik,L,,29,0,0,0,0
4,8481617,Vasily Podkolzin,R,VAN,23,0,0,0,0
4,8481701,Santeri Hatakka,D,NJD,23,0,0,0,0
4,8479514,Rem Pitlick,C,,27,0,0,0,0
4,8477446,Michael McCarron,R,NSH,29,0,0,0,0
4,8470604,Jeff Carter,C,,39,0,0,0,0
4,8482241,Radim Zohorna,L,,28,0,0,0,0
4,8480289,Morgan Barron,C,WPG,26,0,0,0,0
4,8479379,Givani Smith,R,SJS,26,0,0,0,0
4,8480216,Jacob Peterson,C,,25,0,0,0,0
4,8477851,Jordan Oesterle,D,BOS,32,0,0,0,0
4,8484258,Sam Malinski,D,COL,26,0,0,0,0
4,8478904,Steven Lorentz,C,,28,0,0,0,0
4,8482095,Tyler Kleven,D,OTT,22,0,0,0,0
4,8480848,Ty Dellandrea,C,SJS,24,0,0,0,0
4,8476884,Derrick Pouliot,D,,30,0,0,0,0
4,8479336,Carl Grundstrom,R,SJS,27,0,0,0,0
4,8482964,Arber Xhekaj,D,MTL,23,0,0,0,0
4,8471686,Marc Staal,D,,37,0,0,0,0
4,8477887,Patrick Brown,C,BOS,32,0,0,0,0
4,8478495,Denis Gurianov,R,,27,0,0,0,0
4,8473504,Cal Clutterbuck,R,,37,0,0,0,0
4,8481550,Adam Beckman,L,NJD,23,0,0,0,0
4,8480845,Rasmus Kupari,C,WPG,24,0,0,0,0
4,8474009,Nick Bonino,C,,36,0,0,0,0
4,8478585,Derek Ryan,C,EDM,38,0,0,0,0
4,8477962,Brendan Lemieux,L,CAR,28,0,0,0,0
4,8482861,Vincent Iorio,D,WSH,22,0,0,0,0
4,8479378,Logan Stanley,D,WPG,26,0,0,0,0
4,8473446,Erik Johnson,D,PHI,36,0,0,0,0
4,8481743,Marc Del Gaizo,D,NSH,25,0,0,0,0
4,8477384,Josh Brown,D,EDM,30,0,0,0,0
4,8482165,Yan Kuznetsov,D,CGY,22,0,0,0,0
4,8478424,Jansen Harkins,C,ANA,27,0,0,0,0
4,8482144,Jack Thompson,D,SJS,22,0,0,0,0
4,8478512,Austin Czarnik,C,,32,0,0,0,0
4,8477527,Ross Johnston,L,ANA,30,0,0,0,0
4,8479383,Boris Katchouk,L,,26,0,0,0,0
4,8482094,Daemon Hunt,D,MIN,22,0,0,0,0
4,8481719,Maxwell Crozier,D,TBL,24,0,0,0,0
4,8480192,Johnathan Kovacevic,D,NJD,27,0,0,0,0
4,8479376,Victor Mete,D,,26,0,0,0,0
4,8482511,Mason Lohrei,D,BOS,23,0,0,0,0
4,8475825,Jani Hakanpää,D,,32,0,0,0,0
4,8478021,William Lagesson,D,DET,28,0,0,0,0
4,8475795,Dylan McIlrath,D,WSH,32,0,0,0,0
4,8477846,Ryan Carpenter,C,,33,0,0,0,0
4,8481056,Spencer Stastney,D,NSH,24,0,0,0,0
4,8481564,Ryan Johnson,D,BUF,23,0,0,0,0
4,8478017,Mark Friedman,D,VAN,29,0,0,0,0
4,8479320,Max Lajoie,D,SEA,27,0,0,0,0
4,8480075,Cameron Crotty,D,MIN,25,0,0,0,0
4,8484287,Cole McWard,D,VAN,23,0,0,0,0
4,8484254,Akito Hirose,D,VAN,25,0,0,0,0
4,8483407,Brandon Scanlin,D,NYR,25,0,0,0,0
4,8480274,Philip Kemp,D,EDM,25,0,0,0,0
4,8479522,Hardy Haman Aktell,D,WSH,26,0,0,0,0
4,8480007,Jonas Rondbjerg,R,VGK,25,0,0,0,0
4,8477454,Adam Erne,L,,29,0,0,0,0
4,8481679,Maxence Guenette,D,OTT,23,0,0,0,0
4,8480441,Trey Fix-Wolansky,R,CBJ,25,0,0,0,0
4,8483546,Marshall Rifai,D,TOR,26,0,0,0,0
4,8480084,Nick DeSimone,D,NJD,30,0,0,0,0
4,8481030,Jack St. Ivany,D,PIT,25,0,0,0,0
4,8481592,Jakob Pelletier,L,CGY,23,0,0,0,0
4,8478011,Louie Belpedio,D,PHI,28,0,0,0,0
4,8477930,Pierre-Edouard Bellemare,L,,39,0,0,0,0
4,8484321,Nikolas Matinpalo,D,OTT,26,0,0,0,0
4,8482067,Connor Mackey,D,NYR,28,0,0,0,0
4,8481806,Louis Crevier,D,CHI,23,0,0,0,0
4,8484326,Patrik Koch,D,UTA,28,0,0,0,0
4,8477971,Andreas Englund,D,LAK,28,0,0,0,0
4,8481751,Lukas Rousek,R,BUF,25,0,0,0,0
4,8481006,Tyler Tucker,D,STL,24,0,0,0,0
4,8476867,Brendan Gaunce,C,MIN,30,0,0,0,0
4,8479520,Brandon Duhaime,R,WSH,27,0,0,0,0
4,8477073,Kurtis MacDermid,L,NJD,30,0,0,0,0
4,8480874,Adam Ginning,D,PHI,24,0,0,0,0
4,8477473,Justin Bailey,R,SJS,29,0,0,0,0
4,8479066,Ryan Lomberg,L,CGY,30,0,0,0,0
4,8477070,Liam O'Brien,C,UTA,30,0,0,0,0
4,8474618,Marco Scandella,D,,34,0,0,0,0
4,8475797,Jarred Tinordi,D,,32,0,0,0,0
4,8481441,Joe Snively,C,DET,28,0,0,0,0
4,8477244,Chad Ruhwedel,D,NYR,34,0,0,0,0
4,8479772,Zack MacEwen,R,OTT,28,0,0,0,0
4,8481147,Reese Johnson,C,MIN,26,0,0,0,0
4,8481043,Cole Koepke,L,BOS,26,0,0,0,0
4,8483619,Filip Roos,D,OTT,25,0,0,0,0
4,8481541,Samuel Bolduc,D,NYI,24,0,0,0,0
4,8477810,Joel Hanley,D,CGY,33,0,0,0,0
4,8476907,Mackenzie MacEachern,L,,30,0,0,0,0
4,8482652,Walker Duehr,R,CGY,27,0,0,0,0
4,8477126,Jayson Megna,C,,34,0,0,0,0
4,8483398,Declan Carlile,D,TBL,31,0,0,0,0
4,8482929,Emil Lilleberg,D,TBL,23,0,0,0,0
4,8480880,Jakub Lauko,C,MIN,24,0,0,0,0
4,8480245,Olle Lycksell,R,PHI,25,0,0,0,0
4,8480252,Cole Guttman,C,CHI,25,0,0,0,0
4,8477467,Gustav Olofsson,D,SEA,30,0,0,0,0
4,8479968,Vinni Lettieri,C,BOS,29,0,0,0,0
4,8478400,Colin White,C,,27,0,0,0,0
4,8475755,Alexander Petrovic,D,DAL,32,0,0,0,0
4,8481812,Nikolai Knyzhov,D,,27,0,0,0,0
4,8481593,Jayden Struble,D,MTL,23,0,0,0,0
4,8481532,Alex Turcotte,C,LAK,23,0,0,0,0
4,8482126,Emil Andrae,D,PHI,31,0,0,0,0
4,8479944,Zach Aston-Reese,C,VGK,30,0,0,0,0
4,8471817,Ryan Reaves,R,TOR,37,0,0,0,0
4,8481206,John Ludvig,D,PIT,24,0,0,0,0
4,8481599,Victor Soderstrom,D,UTA,23,0,0,0,0
4,8480292,Carson Meyer,R,ANA,27,0,0,0,0
4,8482496,Nils Aman,C,VAN,24,0,0,0,0
4,8479718,Alex Barré-Boulet,C,MTL,27,0,0,0,0
4,8479994,Jaret Anderson-Dolan,C,WPG,25,0,0,0,0
4,8480184,Gustav Lindstrom,D,,26,0,0,0,0
4,8480890,Jan Jenik,R,OTT,24,0,0,0,0
4,8478067,Oskar Lindblom,L,,28,0,0,0,0
4,8476934,Brock McGinn,L,ANA,30,0,0,0,0
4,8479985,Cale Fleury,D,SEA,26,0,0,0,0
4,8484304,Uvis Balinskis,D,FLA,28,0,0,0,0
4,8479981,Jonah Gadjovich,L,FLA,26,0,0,0,0
4,8481716,Dmitri Voronkov,L,CBJ,24,0,0,0,0
4,8474709,Matt Martin,L,,35,0,0,0,0
4,8482634,Alex Steeves,C,TOR,25,0,0,0,0
4,8480823,Alexander Alexeyev,D,WSH,25,0,0,0,0
4,8477541,Dakota Mermis,D,TOR,30,0,0,0,0
4,8483491,Ivan Miroshnichenko,L,WSH,20,0,0,0,0
4,8478477,Mitchell Stephens,C,SEA,27,0,0,0,0
4,8481543,Nikita Alexandrov,C,STL,24,0,0,0,0
4,8479423,Alex Nylander,L,,26,0,0,0,0
4,8482451,Mikael Pyyhtia,L,CBJ,23,0,0,0,0
4,8478831,Kevin Stenlund,C,UTA,28,0,0,0,0
4,8480306,Grant Hutton,D,NYI,29,0,0,0,0
4,8478028,Fredrik Olofsson,L,,28,0,0,0,0
4,8477462,Robert Hagg,D,VGK,29,0,0,0,0
4,8477320,Anton Blidh,L,NYR,29,0,0,0,0
4,8482157,Will Cuylle,L,NYR,22,0,0,0,0
4,8482737,Zack Bolduc,C,STL,21,0,0,0,0
4,8481239,Samuel Fagemo,L,,24,0,0,0,0
4,8481600,Tobias Bjornfot,D,FLA,23,0,0,0,0
4,8478409,Anthony Richard,C,PHI,28,0,0,0,0
4,8474145,Robert Bortuzzo,D,,35,0,0,0,0
4,8475958,Michael Sgarbossa,C,WSH,32,0,0,0,0
4,8479986,Kole Lind,R,DAL,26,0,0,0,0
4,8479249,Andrew Poturalski,C,SJS,30,0,0,0,0
4,8479362,Riley Tufte,L,BOS,26,0,0,0,0
4,8479991,Jake Leschyshyn,C,NYR,25,0,0,0,0
4,8479587,Rhett Gardner,C,PHI,28,0,0,0,0
4,8482744,James Malatesta,L,CBJ,21,0,0,0,0
4,8478854,Ryan Shea,D,PIT,27,0,0,0,0
4,8481591,Sam Poulin,R,,23,0,0,0,0
4,8483512,Matt Savoie,C,EDM,20,0,0,0,0
4,8482102,Vasily Ponomarev,C,PIT,22,0,0,0,0
4,8482162,Roby Jarventie,L,EDM,22,0,0,0,0
4,8481016,Ruslan Iskhakov,C,,24,0,0,0,0
4,8482172,Landon Slaggert,L,CHI,22,0,0,0,0
4,8482747,Brennan Othmann,L,NYR,21,0,0,0,0
4,8480031,Maxime Comtois,L,,25,0,0,0,0
4,8480226,Marián Studenic,R,,26,0,0,0,0
4,8478408,Travis Dermott,D,,28,0,0,0,0
4,8481518,Nolan Foote,L,NJD,24,0,0,0,0
4,8479419,Brett Murray,L,BUF,26,0,0,0,0
4,8482088,Justin Sourdif,R,FLA,22,0,0,0,0
4,8482201,Gage Goncalves,C,TBL,23,0,0,0,0
4,8481578,Graeme Clarke,R,MIN,23,0,0,0,0
4,8482177,Marat Khusnutdinov,C,MIN,22,0,0,0,0
4,8481754,Nikita Nesterenko,C,ANA,23,0,0,0,0
4,8483531,Brian Halonen,L,NJD,25,0,0,0,0
4,8483920,Pierrick Dube,R,WSH,23,0,0,0,0
4,8480851,Akil Thomas,C,LAK,24,0,0,0,0
4,8475235,Nicolas Deslauriers,L,PHI,33,0,0,0,0
4,8482476,Emil Heineman,L,MTL,23,0,0,0,0
4,8477149,Scott Sabourin,R,SJS,32,0,0,0,0
4,8483549,Lucas Condotta,L,MTL,27,0,0,0,0
4,8482765,Isak Rosen,R,BUF,21,0,0,0,0
4,8481237,Kyle MacLean,C,NYI,25,0,0,0,0
4,8481024,Linus Karlsson,C,VAN,25,0,0,0,0
4,8481690,Tyler Angle,C,,24,0,0,0,0
4,8483570,Ben Meyers,C,SEA,26,0,0,0,0
4,8481655,Cole Schwindt,R,CGY,23,0,0,0,0
4,8481462,Mason Morelli,L,VGK,28,0,0,0,0
4,8483401,Marc Johnstone,R,PIT,28,0,0,0,0
4,8478956,Samuel Laberge,L,NJD,27,0,0,0,0
4,8479533,Joona Koppanen,L,,26,0,0,0,0
4,8482197,Adam Raska,R,MIN,23,0,0,0,0
4,8482250,Callahan Burke,C,VGK,27,0,0,0,0
4,8482784,Zach Dean,C,STL,21,0,0,0,0
4,8484255,Jason Polin,R,COL,25,0,0,0,0
4,8481077,John Leonard,L,,26,0,0,0,0
4,8481534,Raphael Lavoie,C,EDM,24,0,0,0,0
4,8483609,Adam Klapka,R,CGY,24,0,0,0,0
4,8482751,Ryan Winterton,C,SEA,21,0,0,0,0
4,8480267,Sammy Walker,C,MIN,25,0,0,0,0
4,8475766,Austin Watson,L,,32,0,0,0,0
4,8482460,Matt Rempe,C,NYR,22,0,0,0,0
4,8481065,Angus Crookshank,L,OTT,25,0,0,0,0
4,8481070,Hugh McGing,L,,26,0,0,0,0
4,8476323,Max McCormick,L,SEA,32,0,0,0,0
4,8483395,Arshdeep Bains,L,VAN,23,0,0,0,0
4,8484259,Ondrej Pavel,C,COL,31,0,0,0,0
4,8483432,Luca Del Bel Belluz,C,CBJ,31,0,0,0,0
4,8483045,Cameron Butler,R,CBJ,31,0,0,0,0
4,8482061,Brandon Biro,L,SEA,26,0,0,0,0
4,8477401,John Hayden,C,SEA,29,0,0,0,0
4,8475278,Byron Froese,C,,33,0,0,0,0
4,8478446,Glenn Gawdin,C,LAK,27,0,0,0,0
4,8477993,Justin Kirkland,C,CGY,28,0,0,0,0
4,8482147,Jean-Luc Foudy,C,COL,22,0,0,0,0
4,8480032,Shane Bowers,C,NJD,25,0,0,0,0
4,8479330,Brandon Gignac,C,MTL,27,0,0,0,0
4,8480776,Sheldon Rempal,R,,29,0,0,0,0
4,8475413,Justin Dowling,C,NJD,34,0,0,0,0
4,8481726,Adam Edstrom,C,NYR,24,0,0,0,0
4,8480844,Grigori Denisenko,L,VGK,24,0,0,0,0
4,8478147,Bokondji Imama,L,PIT,28,0,0,0,0
4,8478881,Brett Seney,L,CHI,28,0,0,0,0
4,8483630,Pavol Regenda,L,ANA,25,0,0,0,0
4,8480836,Jonathan Gruden,C,,24,0,0,0,0
4,8484314,Jiri Smejkal,L,,28,0,0,0,0
4,8475780,Chris Wagner,R,COL,33,0,0,0,0
4,8479546,Oskar Steen,C,,26,0,0,0,0
4,8483597,Milos Kelemen,L,UTA,25,0,0,0,0
4,8481789,Tye Kartye,L,SEA,23,0,0,0,0
4,8484325,Waltteri Merela,C,TBL,26,0,0,0,0
4,8479421,Jacob Moverare,D,LAK,26,0,0,0,0
4,8481585,Egor Afanasyev,L,SJS,23,0,0,0,0
4,8479547,Matthew Phillips,R,,26,0,0,0,0
4,8479367,William Lockwood,R,FLA,26,0,0,0,0
4,8476915,Jujhar Khaira,L,,30,0,0,0,0
4,8481422,Jacob Lucchini,C,NSH,29,0,0,0,0
4,8480468,James Hamblin,L,EDM,25,0,0,0,0
4,8478051,Max Willman,C,NJD,29,0,0,0,0
4,8481556,John Beecher,C,BOS,23,0,0,0,0
4,8478078,Rourke Chartier,C,,28,0,0,0,0
5,8478402,Connor McDavid,C,EDM,27,82,46,99,145
5,8479318,Auston Matthews,C,TOR,27,82,66,59,125
5,8477956,David Pastrnak,R,BOS,28,82,50,70,120
5,8477492,Nathan MacKinnon,C,COL,29,82,55,63,118
5,8477493,Aleksander Barkov,C,FLA,29,82,42,75,117
5,8477934,Leon Draisaitl,C,EDM,29,82,42,74,116
5,8476453,Nikita Kucherov,R,TBL,31,82,31,82,113
5,8476887,Filip Forsberg,L,NSH,30,82,53,54,107
5,8480069,Cale Makar,D,COL,26,82,27,76,103
5,8477939,William Nylander,R,TOR,28,82,42,58,100
5,8478550,Artemi Panarin,L,NYR,33,82,27,73,100
5,8477942,Kevin Fiala,L,LAK,28,82,36,62,98
5,8480027,Jason Robertson,L,DAL,25,82,32,66,98
5,8477404,Jake Guentzel,C,TBL,30,82,47,50,97
5,8475166,John Tavares,C,TOR,34,82,40,56,96
5,8481559,Jack Hughes,C,NJD,23,82,31,65,96
5,8478420,Mikko Rantanen,R,COL,28,82,49,45,94
5,8471675,Sidney Crosby,C,PIT,37,82,43,51,94
5,8480012,Elias Pettersson,C,VAN,26,82,30,64,94
5,8479323,Adam Fox,D,NYR,26,82,21,73,94
5,8478864,Kirill Kaprizov,L,MIN,27,82,38,55,93
5,8479314,Matthew Tkachuk,L,FLA,27,82,29,64,93
5,8477933,Sam Reinhart,C,FLA,29,82,35,56,91
5,8475172,Nazem Kadri,C,CGY,34,82,35,55,90
5,8480023,Robert Thomas,C,STL,25,82,23,66,89
5,8478398,Kyle Connor,L,WPG,28,82,38,50,88
5,8478403,Jack Eichel,C,VGK,28,82,33,55,88
5,8480803,Evan Bouchard,D,EDM,25,82,18,70,88
5,8476468,J.T. Miller,C,VAN,31,82,39,48,87
5,8480830,Andrei Svechnikov,R,CAR,24,82,40,46,86
5,8474564,Steven Stamkos,C,NSH,34,82,39,47,86
5,8477402,Pavel Buchnevich,L,STL,29,82,35,51,86
5,8478010,Brayden Point,C,TBL,28,82,48,37,85
5,8481557,Matt Boldy,L,MIN,23,82,36,49,85
5,8479385,Jordan Kyrou,C,STL,26,82,34,50,84
5,8481523,Kirby Dach,C,MTL,23,82,13,71,84
5,8471215,Evgeni Malkin,C,PIT,38,82,32,51,83
5,8476459,Mika Zibanejad,C,NYR,31,82,28,55,83
5,8480800,Quinn Hughes,D,VAN,25,82,12,70,82
5,8478427,Sebastian Aho,C,CAR,27,82,28,53,81
5,8479407,Jesper Bratt,L,NJD,26,82,28,53,81
5,8477946,Dylan Larkin,C,DET,28,82,38,42,80
5,8478444,Brock Boeser,R,VAN,27,82,38,42,80
5,8480801,Brady Tkachuk,L,OTT,25,82,37,42,79
5,8478439,Travis Konecny,R,PHI,27,82,36,43,79
5,8479343,Clayton Keller,R,UTA,26,82,33,46,79
5,8477951,Nick Schmaltz,C,UTA,28,82,32,47,79
5,8477949,Alex Tuch,R,BUF,28,82,26,53,79
5,8475692,Mats Zuccarello,R,MIN,37,82,24,55,79
5,8477504,Josh Morrissey,D,WPG,29,82,15,64,79
5,8478414,Timo Meier,R,NJD,28,82,40,38,78
5,8477496,Elias Lindholm,C,BOS,30,82,32,46,78
5,8480002,Nico Hischier,C,NJD,25,82,27,50,77
5,8478445,Mathew Barzal,C,NYI,27,82,21,56,77
5,8476456,Jonathan Huberdeau,C,CGY,31,82,18,59,77
5,8482116,Tim Stützle,C,OTT,22,82,31,45,76
5,8477960,Adrian Kempe,R,LAK,28,82,29,47,76
5,8478440,Dylan Strome,C,WSH,27,82,24,52,76
5,8476853,Morgan Rielly,D,TOR,30,82,19,57,76
5,8475167,Victor Hedman,D,TBL,34,82,15,61,76
5,8474578,Erik Karlsson,D,PIT,34,82,9,67,76
5,8479337,Alex DeBrincat,R,DET,27,82,29,46,75
5,8480036,Miro Heiskanen,D,DAL,25,82,15,60,75
5,8477501,Valeri Nichushkin,R,COL,29,82,39,35,74
5,8479420,Tage Thompson,C,BUF,27,82,38,36,74
5,8481596,Shane Pinto,C,OTT,24,82,28,46,74
5,8473419,Brad Marchand,L,BOS,36,82,29,44,73
5,8482665,Matty Beniers,C,SEA,22,82,29,44,73
5,8479325,Charlie McAvoy,D,BOS,27,82,17,56,73
5,8480839,Rasmus Dahlin,D,BUF,24,82,16,57,73
5,8476399,Blake Coleman,C,CGY,33,82,34,38,72
5,8476389,Vincent Trocheck,C,NYR,31,82,33,39,72
5,8475913,Mark Stone,R,VGK,32,82,25,47,72
5,8475170,Brayden Schenn,C,STL,33,82,21,51,72
5,8477447,Shea Theodore,D,VGK,29,82,16,56,72
5,8475184,Chris Kreider,L,NYR,33,82,42,29,71
5,8477500,Bo Horvat,C,NYI,29,82,35,36,71
5,8471214,Alex Ovechkin,L,WSH,39,82,34,37,71
5,8475810,Bryan Rust,R,PIT,32,82,32,39,71
5,8477955,Jared McCann,L,SEA,28,82,31,40,71
5,8474600,Roman Josi,D,NSH,34,82,13,58,71
5,8477940,Nikolaj Ehlers,L,WPG,28,82,34,36,70
5,8476460,Mark Scheifele,C,WPG,31,82,30,40,70
5,8473994,Jamie Benn,L,DAL,35,82,27,43,70
5,8475754,Brock Nelson,C,NYI,33,82,31,38,69
5,8478873,Troy Terry,R,ANA,27,82,27,42,69
5,8480018,Nick Suzuki,C,MTL,25,82,25,44,69
5,8476539,Jonathan Marchessault,R,NSH,34,82,33,35,68
5,8476905,Chandler Stephenson,C,SEA,30,82,20,48,68
5,8477409,Carter Verhaeghe,C,FLA,29,82,40,27,67
5,8478975,Mason Marchment,L,DAL,29,82,32,35,67
5,8475798,Mikael Granlund,C,SJS,32,82,18,49,67
5,8475786,Zach Hyman,L,EDM,32,82,41,25,66
5,8479339,Patrik Laine,L,CBJ,26,82,38,28,66
5,8479542,Brandon Hagel,L,TBL,26,82,31,35,66
5,8480208,Drake Batherson,R,OTT,26,82,28,38,66
5,8475158,Ryan O'Reilly,C,NSH,33,82,24,42,66
5,8481711,Matias Maccelli,L,UTA,24,82,21,45,66
5,8483808,Andrei Kuzmenko,L,CGY,28,82,38,27,65
5,8482078,Lucas Raymond,L,DET,22,82,31,34,65
5,8480015,Owen Tippett,R,PHI,25,82,30,35,65
5,8475794,Tyler Seguin,C,DAL,32,82,28,37,65
5,8478042,Viktor Arvidsson,R,EDM,31,82,20,45,65
5,8482109,Alexis Lafrenière,L,NYR,23,82,35,29,64
5,8474141,Patrick Kane,R,DET,36,82,26,38,64
5,8477476,Artturi Lehkonen,L,COL,29,82,24,40,64
5,8478396,Noah Hanifin,D,VGK,27,82,19,45,64
5,8476869,Brady Skjei,D,NSH,30,82,12,52,64
5,8482093,Seth Jarvis,C,CAR,22,82,28,35,63
5,8473512,Claude Giroux,R,OTT,36,82,27,36,63
5,8478401,Pavel Zacha,C,BOS,27,82,26,37,63
5,8481533,Trevor Zegras,C,ANA,23,82,19,44,63
5,8474679,Gustav Nyquist,C,NSH,35,82,18,45,63
5,8477346,MacKenzie Weegar,D,CGY,30,82,12,51,63
5,8477494,Jonathan Drouin,L,COL,29,82,11,52,63
5,8481068,Yegor Sharangovich,C,CGY,26,82,30,32,62
5,8482097,Jack Quinn,R,BUF,23,82,28,34,62
5,8482113,Anton Lundell,C,FLA,23,82,27,35,62
5,8476454,Ryan Nugent-Hopkins,C,EDM,31,82,25,37,62
5,8478856,Conor Garland,R,VAN,28,82,24,38,62
5,8478449,Roope Hintz,C,DAL,28,82,31,30,61
5,8482740,Wyatt Johnston,C,DAL,21,82,31,30,61
5,8475784,Jeff Skinner,C,EDM,32,82,28,33,61
5,8477503,Max Domi,C,TOR,29,82,17,44,61
5,8476881,Tomas Hertl,C,VGK,31,82,28,32,60
5,8478462,Nicolas Roy,C,VGK,27,82,27,33,60
5,8480064,Josh Norris,C,OTT,25,82,27,33,60
5,8482159,Tyson Foerster,R,PHI,22,82,27,33,60
5,8477964,Ivan Barbashev,C,VGK,29,82,24,36,60
5,8476448,William Karlsson,C,VGK,31,82,21,39,60
5,8480188,Fabian Zetterlund,L,SJS,25,82,20,40,60
5,8480865,Noah Dobson,D,NYI,24,82,13,47,60
5,8479675,Trevor Moore,L,LAK,29,82,31,28,59
5,8475745,Charlie Coyle,C,BOS,32,82,27,32,59
5,8473422,Nick Foligno,L,CHI,37,82,22,37,59
5,8480028,Morgan Frost,C,PHI,25,82,19,39,58
5,8478055,Gustav Forsling,D,FLA,28,82,15,43,58
5,8476346,Johnny Gaudreau,L,CBJ,31,82,13,45,58
5,8478397,Rasmus Andersson,D,CGY,28,82,10,48,58
5,8478460,Zach Werenski,D,CBJ,27,82,7,51,58
5,8475726,Tyler Toffoli,C,SJS,32,82,27,30,57
5,8471685,Anze Kopitar,C,LAK,37,82,17,40,57
5,8476882,Teuvo Teravainen,L,CHI,30,82,15,42,57
5,8480014,Gabriel Vilardi,C,WPG,25,82,29,27,56
5,8470613,Brent Burns,D,CAR,39,82,13,43,56
5,8481542,Moritz Seider,D,DET,23,82,12,44,56
5,8475168,Matt Duchene,C,DAL,33,82,27,28,55
5,8481540,Cole Caufield,R,MTL,23,82,27,28,55
5,8474102,David Perron,L,OTT,36,82,25,30,55
5,8477932,Aaron Ekblad,D,FLA,28,82,18,37,55
5,8473986,Alex Killorn,L,ANA,35,82,22,32,54
5,8480113,Alex Iafallo,L,WPG,31,82,22,32,54
5,8480039,Martin Necas,C,CAR,25,82,20,34,54
5,8477495,Seth Jones,D,CHI,30,82,16,38,54
5,8478407,Vince Dunn,D,SEA,28,82,11,43,54
5,8475151,Kyle Palmieri,C,NYI,33,82,28,25,53
5,8478233,Andrew Mangiapane,L,WSH,28,82,21,32,53
5,8476461,Sean Couturier,C,PHI,32,82,19,34,53
5,8476462,Dougie Hamilton,D,NJD,31,82,17,36,53
5,8478438,Tommy Novak,C,NSH,27,82,17,36,53
5,8482684,Luke Hughes,D,NJD,21,82,10,43,53
5,8478469,Thomas Chabot,D,OTT,27,82,8,45,53
5,8476483,Rickard Rakell,R,PIT,31,82,26,26,52
5,8478519,Anthony Cirelli,C,TBL,27,82,20,32,52
5,8477451,Ryan Hartman,R,MIN,30,82,20,32,52
5,8478458,Jack Roslovic,C,CAR,27,82,20,32,52
5,8479400,Pierre-Luc Dubois,L,WSH,26,82,16,36,52
5,8476875,Mike Matheson,D,MTL,30,82,14,38,52
5,8475169,Evander Kane,L,EDM,33,82,26,25,51
5,8476432,Boone Jenner,C,CBJ,31,82,24,27,51
5,8477407,Anthony Duclair,L,NYI,29,82,22,29,51
5,8478047,Michael Bunting,L,PIT,29,82,21,30,51
5,8476479,Phillip Danault,C,LAK,31,82,18,33,51
5,8477021,Alex Kerfoot,C,UTA,30,82,14,37,51
5,8477444,Andre Burakovsky,L,SEA,29,82,11,40,51
5,8475793,Ryan Johansen,C,PHI,32,82,30,20,50
5,8482699,Dylan Guenther,R,UTA,21,82,24,26,50
5,8474150,Mikael Backlund,C,CGY,35,82,23,27,50
5,8480078,Filip Chytil,C,NYR,25,82,21,29,50
5,8478498,Jake DeBrusk,L,VAN,28,82,18,32,50
5,8480798,Philipp Kurashev,C,CHI,25,82,16,34,50
5,8477986,Brandon Montour,D,SEA,30,82,15,35,50
5,8478038,Devon Toews,D,COL,30,82,14,36,50
5,8471724,Kris Letang,D,PIT,37,82,12,38,50
5,8480817,K'Andre Miller,D,NYR,24,82,9,41,50
5,8476438,Brandon Saad,L,STL,32,82,32,17,49
5,8471698,T.J. Oshie,R,WSH,38,82,29,20,49
5,8474565,Alex Pietrangelo,D,VGK,34,82,14,35,49
5,8476880,Tom Wilson,R,WSH,30,82,24,24,48
5,8477456,J.T. Compher,L,DET,29,82,21,27,48
5,8475287,Erik Haula,L,NJD,33,82,21,27,48
5,8479410,Mikhail Sergachev,D,UTA,26,82,5,43,48
5,8478474,Lawson Crouse,L,UTA,27,82,28,19,47
5,8482110,Dawson Mercer,C,NJD,23,82,23,24,47
5,8479996,Cody Glass,C,NSH,25,82,23,24,47
5,8474586,Jordan Eberle,R,SEA,34,82,21,26,47
5,8475791,Taylor Hall,L,CHI,33,82,21,26,47
5,8482667,William Eklund,L,SJS,22,82,20,27,47
5,8478046,Danton Heinen,L,VAN,29,82,19,28,47
5,8475191,Reilly Smith,R,NYR,33,82,17,30,47
5,8479999,Casey Mittelstadt,C,COL,26,82,11,36,47
5,8482124,Quinton Byfield,R,LAK,22,82,11,36,47
5,8476792,Torey Krug,D,STL,33,82,9,38,47
5,8478493,Joel Eriksson Ek,C,MIN,27,82,28,18,46
5,8475314,Anders Lee,L,NYI,34,82,26,20,46
5,8481528,Dylan Cozens,C,BUF,23,82,25,21,46
5,8477416,Oliver Bjorkstrand,R,SEA,29,82,24,22,46
5,8481535,Nils Hoglander,L,VAN,24,82,21,25,46
5,8480220,Noah Cates,L,PHI,25,82,18,28,46
5,8477935,Sam Bennett,C,FLA,28,82,15,31,46
5,8475765,Vladimir Tarasenko,R,DET,33,82,11,35,46
5,8476906,Shayne Gostisbehere,D,CAR,31,82,8,38,46
5,8474590,John Carlson,D,WSH,34,82,6,40,46
5,8481618,Alex Newhook,C,MTL,23,82,21,24,45
5,8478472,Mathieu Joseph,R,STL,27,82,19,26,45
5,8480797,Joel Farabee,L,PHI,24,82,17,28,45
5,8474149,Evgenii Dadonov,R,DAL,35,82,17,28,45
5,8474563,Drew Doughty,D,LAK,35,82,13,32,45
5,8482671,Owen Power,D,BUF,22,82,13,32,45
5,8482055,Drew O'Connor,L,PIT,26,82,24,20,44
5,8477479,Tyler Bertuzzi,L,CHI,29,82,21,23,44
5,8477511,Anthony Mantha,R,CGY,30,82,21,23,44
5,8482149,Cole Perfetti,C,WPG,22,82,20,24,44
5,8479365,Trent Frederic,C,BOS,26,82,20,24,44
5,8476960,Andreas Athanasiou,C,CHI,30,82,19,25,44
5,8474641,Adam Henrique,C,EDM,34,82,18,26,44
5,8482660,Kent Johnson,C,CBJ,22,82,14,30,44
5,8479425,Filip Hronek,D,VAN,27,82,3,41,44
5,8480009,Eeli Tolvanen,R,SEA,25,82,26,17,43
5,8474053,Logan Couture,C,SJS,35,82,20,23,43
5,8477429,Andrew Copp,C,DET,30,82,17,26,43
5,8481186,Logan O'Connor,R,COL,28,82,16,27,43
5,8476826,Yanni Gourde,C,SEA,33,82,13,30,43
5,8476872,Scott Laughton,C,PHI,30,82,13,30,43
5,8480434,Sean Durzi,D,UTA,26,82,12,31,43
5,8480043,Timothy Liljegren,D,TOR,25,82,8,35,43
5,8480893,Kirill Marchenko,R,CBJ,24,82,23,19,42
5,8482175,JJ Peterka,R,BUF,22,82,22,20,42
5,8475763,Kevin Hayes,R,PIT,32,82,20,22,42
5,8482146,Luke Evangelista,R,NSH,22,82,20,22,42
5,8475799,Nino Niederreiter,R,WPG,32,82,19,23,42
5,8480829,Jesperi Kotkaniemi,C,CAR,24,82,16,26,42
5,8479345,Jakob Chychrun,D,WSH,26,82,13,29,42
5,8476925,Colton Sissons,C,NSH,31,82,9,33,42
5,8477948,Travis Sanheim,D,PHI,28,82,6,36,42
5,8482092,Ridly Greig,C,OTT,22,82,22,19,41
5,8478366,Frank Vatrano,R,ANA,30,82,22,19,41
5,8473533,Jordan Staal,C,CAR,36,82,18,23,41
5,8481656,Aliaksei Protas,C,WSH,23,82,13,28,41
5,8475200,Dmitry Orlov,D,CAR,33,82,8,33,41
5,8475764,Cam Fowler,D,ANA,33,82,7,34,41
5,8480459,Pius Suter,C,VAN,28,82,27,13,40
5,8482745,Mason McTavish,C,ANA,21,82,26,14,40
5,8482089,Jake Neighbours,L,STL,22,82,19,21,40
5,8479992,Michael Rasmussen,C,DET,25,82,15,25,40
5,8476458,Ryan Strome,C,ANA,31,82,13,27,40
5,8479525,Ross Colton,C,COL,28,82,13,27,40
5,8475753,Justin Faulk,D,STL,32,82,6,34,40
5,8481704,Juuso Parssinen,C,NSH,23,82,24,15,39
5,8480802,Ryan McLeod,C,BUF,25,82,22,17,39
5,8481604,Pavel Dorofeyev,L,VGK,24,82,21,18,39
5,8478463,Anthony Beauvillier,L,PIT,27,82,16,23,39
5,8476885,Jacob Trouba,D,NYR,30,82,15,24,39
5,8478542,Evan Rodrigues,C,FLA,31,82,11,28,39
5,8476923,Damon Severson,D,CBJ,30,82,10,29,39
5,8477969,Marcus Pettersson,D,PIT,28,82,10,29,39
5,8482720,Matthew Knies,L,TOR,22,82,10,29,39
5,8476958,Jaccob Slavin,D,CAR,30,82,9,30,39
5,8481624,Ilya Mikheyev,R,CHI,30,82,23,15,38
5,8479987,Morgan Geekie,C,BOS,26,82,20,18,38
5,8480068,Ryan Poehling,C,PHI,25,82,19,19,38
5,8478413,Jordan Greenway,L,BUF,27,82,18,20,38
5,8474189,Lars Eller,C,PIT,35,82,18,20,38
5,8478057,Dakota Joshua,C,VAN,28,82,16,22,38
5,8479353,Brett Howden,C,VGK,26,82,16,22,38
5,8476329,Travis Boyd,C,MIN,31,82,13,25,38
5,8477998,Warren Foegele,L,LAK,28,82,12,26,38
5,8481560,Arthur Kaliyev,R,LAK,23,82,19,18,37
5,8476918,Jimmy Vesey,L,NYR,31,82,17,20,37
5,8477953,Kasperi Kapanen,R,STL,28,82,16,21,37
5,8477497,Sean Monahan,C,CBJ,30,82,14,23,37
5,8475149,Marcus Johansson,L,MIN,34,82,12,25,37
5,8477498,Darnell Nurse,D,EDM,29,82,12,25,37
5,8480871,Adam Boqvist,D,FLA,24,82,11,26,37
5,8479390,Taylor Raddysh,R,WSH,26,82,21,15,36
5,8482117,Lukas Reichel,L,CHI,22,82,18,18,36
5,8480835,Jack Drury,C,CAR,24,82,16,20,36
5,8480074,Alexandre Texier,C,STL,25,82,16,20,36
5,8476292,Ondrej Palat,L,NJD,33,82,15,21,36
5,8482079,Marco Rossi,C,MIN,23,82,14,22,36
5,8481093,Rafael Harvey-Pinard,L,MTL,25,82,13,23,36
5,8473563,Nicklas Backstrom,C,WSH,37,82,10,26,36
5,8475218,Mattias Ekholm,D,EDM,34,82,8,28,36
5,8478507,John Marino,D,UTA,27,82,6,30,36
5,8480049,Dylan Samberg,D,WPG,25,82,4,32,36
5,8481554,Kaapo Kakko,R,NYR,23,82,23,12,35
5,8482475,Yegor Chinakhov,R,CBJ,23,82,17,18,35
5,8476474,Stefan Noesen,R,NJD,31,82,15,20,35
5,8481582,Nicholas Robertson,L,TOR,23,82,15,20,35
5,8475768,Jaden Schwartz,C,SEA,32,82,14,21,35
5,8484144,Connor Bedard,C,CHI,19,82,14,21,35
5,8481580,Connor McMichael,C,WSH,23,82,12,23,35
5,8477989,Christian Dvorak,C,MTL,28,82,11,24,35
5,8476927,Teddy Blueger,C,VAN,30,82,10,25,35
5,8479941,Justin Danforth,R,CBJ,31,82,18,16,34
5,8482705,Cole Sillinger,C,CBJ,21,82,18,16,34
5,8481601,Simon Holmstrom,R,NYI,23,82,18,16,34
5,8475714,Calle Jarnkrok,C,TOR,33,82,16,18,34
5,8475722,Jason Zucker,L,BUF,32,82,13,21,34
5,8477987,Ryan Donato,C,CHI,28,82,10,24,34
5,8480789,Oliver Wahlstrom,R,NYI,24,82,10,24,34
5,8478911,Matt Roy,D,WSH,29,82,7,27,34
5,8476917,Adam Pelech,D,NYI,30,82,5,29,34
5,8476981,Josh Anderson,R,MTL,30,82,21,12,33
5,8482125,Alexander Holtz,R,VGK,22,82,19,14,33
5,8479661,Tanner Jeannot,L,LAK,27,82,19,14,33
5,8477425,Miles Wood,L,COL,29,82,18,15,33
5,8478109,Victor Olofsson,L,VGK,29,82,18,15,33
5,8475343,Nic Dowd,C,WSH,34,82,15,18,33
5,8479293,Brandon Tanev,L,SEA,33,82,14,19,33
5,8475848,Brendan Gallagher,R,MTL,32,82,11,22,33
5,8476902,Esa Lindell,D,DAL,30,82,11,22,33
5,8476392,Adam Lowry,C,WPG,31,82,8,25,33
5,8476892,Colton Parayko,D,STL,31,82,6,27,33
5,8480873,Rasmus Sandin,D,WSH,24,82,4,29,33
5,8481546,Cam York,D,PHI,23,82,4,29,33
5,8482245,Artem Zub,D,OTT,29,82,1,32,33
5,8476921,Jordan Martinook,L,CAR,32,82,20,12,32
5,8479591,Michael Eyssimont,C,TBL,28,82,18,14,32
5,8477947,Sonny Milano,L,WSH,28,82,18,14,32
5,8476897,Oskar Sundqvist,C,STL,30,82,11,21,32
5,8480806,Isac Lundestrom,C,ANA,25,82,10,22,32
5,8480336,Sean Walker,D,CAR,30,82,8,24,32
5,8477220,Nate Schmidt,D,FLA,33,82,6,26,32
5,8476931,Jake McCabe,D,TOR,31,82,5,27,32
5,8477903,Garnet Hathaway,R,PHI,33,82,17,14,31
5,8477426,Nicholas Paul,L,TBL,29,82,16,15,31
5,8478569,Noel Acciari,C,PIT,33,82,16,15,31
5,8477952,Robby Fabbri,C,ANA,28,82,15,16,31
5,8470621,Corey Perry,R,EDM,39,82,15,16,31
5,8480855,Jack McBain,C,UTA,24,82,14,17,31
5,8476419,Jean-Gabriel Pageau,C,NYI,32,82,12,19,31
5,8481553,Bobby Brink,R,PHI,23,82,12,19,31
5,8480185,Eetu Luostarinen,C,FLA,26,82,11,20,31
5,8478891,Mason Appleton,C,WPG,28,82,10,21,31
5,8475220,Marcus Foligno,L,MIN,33,82,9,22,31
5,8474716,Jared Spurgeon,D,MIN,35,82,8,23,31
5,8483515,Juraj Slafkovsky,L,MTL,20,82,8,23,31
5,8482624,Daniil Miromanov,D,CGY,27,82,6,25,31
5,8482655,J.J. Moser,D,TBL,24,82,3,28,31
5,8476873,Mark Jankowski,C,NSH,30,82,19,11,30
5,8480995,Pontus Holmberg,R,TOR,25,82,16,14,30
5,8476469,Joel Armia,R,MTL,31,82,16,14,30
5,8482133,Thomas Bordeleau,C,SJS,22,82,14,16,30
5,8474715,Cam Atkinson,R,TBL,35,82,14,16,30
5,8481013,Jonatan Berggren,R,DET,24,82,13,17,30
5,8482074,Connor Zary,C,CGY,23,82,13,17,30
5,8482105,Jake Sanderson,D,OTT,22,82,9,21,30
5,8475171,Oliver Ekman-Larsson,D,TOR,33,82,7,23,30
5,8476854,Hampus Lindholm,D,BOS,30,82,6,24,30
5,8475181,Nick Leddy,D,STL,33,82,6,24,30
5,8480748,Kiefer Sherwood,L,VAN,29,82,17,12,29
5,8476480,Vladislav Namestnikov,C,WPG,32,82,13,16,29
5,8483763,Maksymilian Szuber,D,UTA,22,82,13,16,29
5,8480878,Nils Lundkvist,D,DAL,24,82,7,22,29
5,8479976,Juuso Valimaki,D,UTA,26,82,5,24,29
5,8475455,Brenden Dillon,D,NJD,34,82,4,25,29
5,8478851,Alexandre Carrier,D,NSH,28,82,1,28,29
5,8475760,Nick Bjugstad,C,UTA,32,82,15,13,28
5,8475231,Casey Cizikas,C,NYI,33,82,12,16,28
5,8481481,Blake Lizotte,C,PIT,27,82,11,17,28
5,8482166,Shakir Mukhamadullin,D,SJS,22,82,11,17,28
5,8477450,Jason Dickinson,C,CHI,29,82,11,17,28
5,8479393,Noah Gregor,C,OTT,26,82,10,18,28
5,8475193,Tomas Tatar,L,NJD,34,82,9,19,28
5,8479351,Sam Steel,C,DAL,26,82,8,20,28
5,8480145,Neal Pionk,D,WPG,29,82,7,21,28
5,8475188,Brayden McNabb,D,VGK,33,82,6,22,28
5,8476331,Dylan DeMelo,D,WPG,31,82,4,24,28
5,8474151,Ryan McDonagh,D,TBL,35,82,4,24,28
5,8479398,Samuel Girard,D,COL,26,82,2,26,28
5,8476979,Erik Gustafsson,D,DET,32,82,2,26,28
5,8480813,Joe Veleno,C,DET,24,82,16,11,27
5,8481028,Martin Pospisil,C,CGY,25,82,16,11,27
5,8478115,Pierre Engvall,L,NYI,28,82,13,14,27
5,8478508,Yakov Trenin,C,MIN,27,82,13,14,27
5,8477353,Tyler Motte,C,DET,29,82,13,14,27
5,8479368,Max Jones,L,BOS,26,82,12,15,27
5,8478133,Jake Evans,C,MTL,28,82,11,16,27
5,8484153,Leo Carlsson,C,ANA,20,82,10,17,27
5,8481567,Henry Thrun,D,SJS,23,82,9,18,27
5,8477488,Brett Pesce,D,NJD,30,82,8,19,27
5,8481477,Nico Sturm,C,SJS,29,82,14,12,26
5,8481032,Paul Cotter,C,NJD,25,82,13,13,26
5,8482259,Bobby McMann,C,TOR,28,82,13,13,26
5,8478432,Christian Fischer,R,DET,27,82,13,13,26
5,8477931,Tomas Nosek,L,FLA,32,82,12,14,26
5,8482762,Simon Edvinsson,D,DET,21,82,12,14,26
5,8477369,Carson Soucy,D,VAN,30,82,9,17,26
5,8480796,Martin Fehervary,D,WSH,25,82,8,18,26
5,8482803,Olen Zellweger,D,ANA,21,82,6,20,26
5,8479402,Jake Bean,D,CGY,26,82,6,20,26
5,8482470,Ilya Solovyov,D,CGY,24,82,6,20,26
5,8474673,TJ Brodie,D,CHI,34,82,5,21,26
5,8475324,Nick Jensen,D,OTT,34,82,3,23,26
5,8480281,Alexey Toropchenko,R,STL,25,82,17,8,25
5,8479414,Nathan Bastian,R,NJD,27,82,15,10,25
5,8479291,Kevin Rooney,C,CGY,31,82,14,11,25
5,8482062,Cole Smith,L,NSH,29,82,11,14,25
5,8484166,Adam Fantilli,C,CBJ,20,82,11,14,25
5,8473453,Trevor Lewis,C,LAK,37,82,11,14,25
5,8477406,Mattias Janmark,C,EDM,32,82,8,17,25
5,8481581,Thomas Harley,D,DAL,23,82,7,18,25
5,8481522,Peyton Krebs,C,BUF,23,82,7,18,25
5,8478500,Ivan Provorov,D,CBJ,27,82,6,19,25
5,8482142,Jamie Drysdale,D,PHI,22,82,6,19,25
5,8482073,Braden Schneider,D,NYR,23,82,4,21,25
5,8481708,Zac Jones,D,NYR,24,82,0,25,25
5,8475842,Sam Carrick,C,NYR,32,82,13,11,24
5,8477015,Connor Brown,R,EDM,30,82,13,11,24
5,8480980,Connor Dewar,C,TOR,25,82,13,11,24
5,8482077,Dylan Holloway,L,EDM,23,82,13,11,24
5,8480849,Barrett Hayton,C,UTA,24,82,11,13,24
5,8482141,Lukas Cormier,D,VGK,22,82,11,13,24
5,8479359,Beck Malenstyn,L,BUF,26,82,10,14,24
5,8477919,Frederick Gaudreau,C,MIN,31,82,7,17,24
5,8477499,Rasmus Ristolainen,D,PHI,30,82,7,17,24
5,8476463,Jonas Brodin,D,MIN,31,82,6,18,24
5,8483468,Jiri Kulich,C,BUF,20,82,6,18,24
5,8473507,Jeff Petry,D,DET,37,82,2,22,24
5,8478399,Jonas Siegenthaler,D,NJD,27,82,2,22,24
5,8476879,Cody Ceci,D,EDM,31,82,1,23,24
5,8478020,Michael Amadio,C,OTT,28,82,12,11,23
5,8476858,Phillip Di Giuseppe,L,VAN,31,82,12,11,23
5,8481517,Brett Leason,R,ANA,25,82,11,12,23
5,8482087,Kaiden Guhle,D,MTL,22,82,9,14,23
5,8479316,Luke Kunin,C,SJS,27,82,9,14,23
5,8479638,Justin Brazeau,R,BOS,26,82,9,14,23
5,8484145,Zach Benson,L,BUF,19,82,8,15,23
5,8476312,Josh Manson,D,COL,33,82,8,15,23
5,8478013,Jake Walman,D,SJS,28,82,8,15,23
5,8476278,Colin Blackwell,C,DAL,31,82,7,16,23
5,8479983,Mario Ferraro,D,SJS,26,82,6,17,23
5,8477839,Conor Sheary,L,TBL,32,82,6,17,23
5,8475279,Ben Chiarot,D,DET,33,82,5,18,23
5,8479980,Nicolas Hague,D,VGK,26,82,4,19,23
5,8479371,Dante Fabbro,D,NSH,26,82,4,19,23
5,8480172,Jan Rutta,D,SJS,34,82,4,19,23
5,8478882,Vladislav Gavrikov,D,LAK,29,82,3,20,23
5,8480035,Henri Jokiharju,D,BUF,25,82,3,20,23
5,8478840,Will Borgen,D,SEA,28,82,1,22,23
5,8480003,Jesper Boqvist,C,FLA,26,82,13,9,22
5,8477392,Hudson Fasching,R,NYI,29,82,9,13,22
5,8483457,Lane Hutson,D,MTL,20,82,7,15,22
5,8476467,Jamie Oleksiak,D,SEA,32,82,7,15,22
5,8482122,Brock Faber,D,MIN,22,82,6,16,22
5,8480144,David Kampf,C,TOR,29,82,6,16,22
5,8477435,Ryan Graves,D,PIT,29,82,6,16,22
5,8478434,Keegan Kolesar,R,VGK,27,82,6,16,22
5,8482111,Justin Barron,D,MTL,23,82,13,8,21
5,8482809,Jackson Blake,R,CAR,21,82,11,10,21
5,8482101,Danil Gushchin,L,SJS,22,82,11,10,21
5,8484203,Bradly Nadeau,L,CAR,19,82,9,12,21
5,8476889,Radek Faksa,C,STL,30,82,7,14,21
5,8483482,Tristan Luneau,D,ANA,20,82,7,14,21
5,8476624,Barclay Goodrow,C,SJS,31,82,6,15,21
5,8480807,Mattias Samuelsson,D,BUF,24,82,6,15,21
5,8478443,Brandon Carlo,D,BOS,28,82,5,16,21
5,8474574,Tyler Myers,D,VAN,34,82,4,17,21
5,8480879,Jacob Bernard-Docker,D,OTT,24,82,4,17,21
5,8481568,Alex Vlasic,D,CHI,23,82,3,18,21
5,8476891,Matt Grzelcyk,D,PIT,30,82,1,20,21
5,8480860,Kevin Bahl,D,CGY,24,82,0,21,21
5,8475855,Jesper Fast,R,CAR,33,82,12,8,20
5,8482155,Alex Laferriere,R,LAK,23,82,12,8,20
5,8482749,Joshua Roy,R,MTL,21,82,12,8,20
5,8477508,Curtis Lazar,C,NJD,29,82,10,10,20
5,8481606,Jordan Spence,D,LAK,23,82,9,11,20
5,8483445,Cutter Gauthier,L,ANA,20,82,9,11,20
5,8480021,Jack Studnicka,C,LAK,25,82,9,11,20
5,8476457,Adam Larsson,D,SEA,32,82,8,12,20
5,8476422,Mike Reilly,D,NYI,31,82,6,14,20
5,8477505,Alexander Wennberg,C,SJS,30,82,6,14,20
5,8475177,Calvin de Haan,D,COL,33,82,5,15,20
5,8478416,Erik Cernak,D,TBL,27,82,4,16,20
5,8479369,Andrew Peeke,D,BOS,26,82,4,16,20
5,8481178,Egor Zamula,D,PHI,24,82,2,18,20
5,8475462,Radko Gudas,D,ANA,34,82,2,18,20
5,8480448,Parker Kelly,L,COL,25,82,9,10,19
5,8483431,Logan Cooley,C,UTA,20,82,8,11,19
5,8482733,Logan Mailloux,D,MTL,31,82,8,11,19
5,8476878,Zemgus Girgensons,L,TBL,30,82,7,12,19
5,8482858,Ryker Evans,D,SEA,23,82,6,13,19
5,8481524,Bowen Byram,D,BUF,23,82,6,13,19
5,8484911,Collin Graf,R,SJS,22,82,6,13,19
5,8474013,Ian Cole,D,UTA,35,82,5,14,19
5,8477507,Nikita Zadorov,D,BOS,29,82,4,15,19
5,8481014,Alexander Romanov,D,NYI,24,82,3,16,19
5,8480222,Sebastian Aho,D,PIT,28,82,3,16,19
5,8477365,Connor Clifton,D,BUF,29,82,2,17,19
5,8475233,David Savard,D,MTL,34,82,2,17,19
5,8482516,Matthew Kessel,D,STL,24,82,6,12,18
5,8478211,Dryden Hunt,L,CGY,29,82,5,13,18
5,8483565,Nick Blankenburg,D,NSH,26,82,4,14,18
5,8483505,Matthew Poitras,C,BOS,20,82,4,14,18
5,8479998,Mikey Anderson,D,LAK,25,82,4,14,18
5,8477506,Ryan Pulock,D,NYI,30,82,3,15,18
5,8475762,Derek Forbort,D,VAN,32,82,3,15,18
5,8476372,Nick Seeler,D,PHI,31,82,1,17,18
5,8481641,Joel Kiviranta,L,COL,28,82,11,6,17
5,8480073,Erik Brannstrom,D,COL,25,82,6,11,17
5,8476525,Colin Miller,D,WPG,32,82,5,12,17
5,8482153,Brendan Brisson,C,VGK,23,82,5,12,17
5,8478450,Parker Wotherspoon,D,BOS,27,82,5,12,17
5,8483493,Frank Nazar,C,CHI,20,82,9,7,16
5,8480025,MacKenzie Entwistle,R,FLA,25,82,8,8,16
5,8484149,Gavin Brindley,C,CBJ,20,82,7,9,16
5,8481699,Aku Raty,R,UTA,23,82,7,9,16
5,8476441,Joel Edmundson,D,LAK,31,82,3,13,16
5,8483466,Kevin Korchinski,D,CHI,20,82,3,13,16
5,8475690,Chris Tanev,D,TOR,35,82,1,15,16
5,8482702,Logan Stankoven,C,DAL,21,82,9,6,15
5,8483499,Liam Ohgren,L,MIN,20,82,7,8,15
5,8482712,Oskar Olausson,R,COL,22,82,7,8,15
5,8476374,Sean Kuraly,C,CBJ,31,82,6,9,15
5,8480990,Declan Chisholm,D,MIN,24,82,6,9,15
5,8482666,Scott Morrow,D,CAR,22,82,6,9,15
5,8481605,Jackson LaCombe,D,ANA,23,82,5,10,15
5,8483490,Pavel Mintyukov,D,ANA,21,82,5,10,15
5,8483495,Simon Nemec,D,NJD,20,82,5,10,15
5,8475790,Erik Gudbranson,D,CBJ,32,82,4,11,15
5,8478178,Darren Raddysh,D,TBL,28,82,3,12,15
5,8478468,Jeremy Lauzon,D,NSH,27,82,3,12,15
5,8474567,Zach Bogosian,D,MIN,34,82,3,12,15
5,8477335,Kyle Burroughs,D,LAK,29,82,2,13,15
5,8470600,Ryan Suter,D,STL,39,82,1,14,15
5,8476822,Luke Glendening,C,TBL,35,82,9,5,14
5,8482713,Mackie Samoskevich,R,FLA,22,82,9,5,14
5,8477034,Jaycob Megna,D,FLA,32,82,3,11,14
5,8482145,Mavrik Bourque,C,DAL,22,82,3,11,14
5,8477845,Trevor van Riemsdyk,D,WSH,33,82,2,12,14
5,8478874,Adam Gaudette,C,OTT,28,82,2,12,14
5,8478859,Niko Mikkola,D,FLA,28,82,2,12,14
5,8474612,Travis Hamonic,D,OTT,34,82,2,12,14
5,8479324,Ryan Lindgren,D,NYR,26,82,1,13,14
5,8476429,Scott Mayfield,D,NYI,32,82,1,13,14
5,8478136,Jake Middleton,D,MIN,28,82,0,14,14
5,8479442,Troy Stecher,D,EDM,30,82,6,7,13
5,8482118,Sam Colangelo,R,ANA,23,82,5,8,13
5,8483567,Georgii Merkulov,C,BOS,24,82,4,9,13
5,8474090,Brendan Smith,D,DAL,35,82,2,11,13
5,8482679,Matt Coronato,R,CGY,22,82,5,7,12
5,8482807,Ethan Del Mastro,D,CHI,21,82,3,9,12
5,8480950,Ilya Lyubushkin,D,DAL,30,82,2,10,12
5,8483460,David Jiricek,D,CBJ,21,82,2,10,12
5,8480834,Ty Emberson,D,SJS,24,82,2,10,12
5,8479576,Vincent Desharnais,D,VAN,28,82,1,11,12
5,8477938,Haydn Fleury,D,WPG,28,82,7,4,11
5,8482787,Nikita Chibrikov,R,WPG,31,82,7,4,11
5,8482659,Josh Doan,R,UTA,22,82,6,5,11
5,8483489,Fraser Minten,C,TOR,31,82,4,7,11
5,8476473,Connor Murphy,D,CHI,31,82,3,8,11
5,8476967,Brett Kulak,D,EDM,30,82,1,10,11
5,8482070,Mitchell Chaffee,R,TBL,26,82,6,4,10
5,8471677,Jack Johnson,D,CBJ,37,82,5,5,10
5,8480246,Nick Perbix,D,TBL,26,82,1,9,10
5,8483012,Logan Morrison,C,SEA,22,82,6,3,9
5,8483524,Shane Wright,C,SEA,20,82,3,6,9
5,8482859,Zack Ostapchuk,C,OTT,21,82,3,6,9
5,8483471,Brad Lambert,C,WPG,31,82,2,7,9
5,8474062,Riley Nash,C,NYR,35,82,1,8,9
5,8475718,Justin Holl,D,DET,32,82,0,9,9
5,8480870,Bo Groulx,C,NYR,24,82,5,3,8
5,8476442,Matt Nieto,L,PIT,32,82,3,5,8
5,8481122,Simon Benoit,D,TOR,26,82,2,6,8
5,8483397,Marc McLaughlin,C,BOS,25,82,1,6,7
5,8470794,Joe Pavelski,C,,40,0,0,0,0
5,8481703,Valtteri Puustinen,R,PIT,25,0,0,0,0
5,8477950,Tony DeAngelo,D,,29,0,0,0,0
5,8481577,Philip Tomasino,C,NSH,23,0,0,0,0
5,8475197,Tyson Barrie,D,,33,0,0,0,0
5,8471218,Blake Wheeler,R,,38,0,0,0,0
5,8474157,Max Pacioretty,L,,36,0,0,0,0
5,8478466,Daniel Sprong,R,VAN,27,0,0,0,0
5,8475744,Evgeny Kuznetsov,C,,32,0,0,0,0
5,8481019,David Gustafsson,C,WPG,24,0,0,0,0
5,8475906,John Klingberg,D,,32,0,0,0,0
5,8479348,Kale Clague,D,BUF,26,0,0,0,0
5,8476952,Dominic Toninato,C,WPG,30,0,0,0,0
5,8473473,Milan Lucic,L,,36,0,0,0,0
5,8474037,James van Riemsdyk,L,,35,0,0,0,0
5,8474602,Justin Schultz,D,,34,0,0,0,0
5,8482222,Alexander Barabanov,L,,30,0,0,0,0
5,8479372,Josh Mahura,D,SEA,26,0,0,0,0
5,8479982,Conor Timmins,D,TOR,26,0,0,0,0
5,8474031,Kevin Shattenkirk,D,,35,0,0,0,0
5,8480008,Adam Ruzicka,C,,25,0,0,0,0
5,8481059,Scott Perunovich,D,STL,26,0,0,0,0
5,8480884,Calen Addison,D,,24,0,0,0,0
5,8476994,Vinnie Hinostroza,C,NSH,30,0,0,0,0
5,8478452,Caleb Jones,D,LAK,27,0,0,0,0
5,8480157,Calle Rosen,D,COL,30,0,0,0,0
5,8481609,Vladislav Kolyachonok,D,UTA,23,0,0,0,0
5,8479415,Michael McLeod,C,,26,0,0,0,0
5,8476919,Chris Tierney,C,,30,0,0,0,0
5,8479639,Dylan Coghlan,D,WPG,26,0,0,0,0
5,8478146,Matthew Highmore,C,OTT,28,0,0,0,0
5,8478970,Jalen Chatfield,D,CAR,28,0,0,0,0
5,8480205,Emil Bemstrom,C,PIT,25,0,0,0,0
5,8474884,Mike Hoffman,C,,35,0,0,0,0
5,8471274,Alex Goligoski,D,,39,0,0,0,0
5,8478104,Sammy Blais,L,,28,0,0,0,0
5,8474870,Tyler Johnson,C,,34,0,0,0,0
5,8476913,Devin Shore,C,MIN,30,0,0,0,0
5,8481598,Philip Broberg,D,EDM,23,0,0,0,0
5,8480058,Pierre-Olivier Joseph,D,STL,25,0,0,0,0
5,8480891,Michael Kesselring,D,UTA,24,0,0,0,0
5,8477979,Nicolas Aube-Kubel,R,BUF,28,0,0,0,0
5,8476871,Tanner Pearson,L,,32,0,0,0,0
5,8476393,Nick Cousins,C,,31,0,0,0,0
5,8479977,Kailer Yamamoto,R,,26,0,0,0,0
5,8479543,Michael Pezzetta,L,MTL,26,0,0,0,0
5,8477018,Ben Hutton,D,VGK,31,0,0,0,0
5,8480762,Eric Robinson,L,CAR,29,0,0,0,0
5,8474034,Pat Maroon,L,CHI,36,0,0,0,0
5,8481058,Jesse Ylönen,R,,25,0,0,0,0
5,8475179,Dmitry Kulikov,D,FLA,34,0,0,0,0
5,8481527,Kaedan Korczak,D,VGK,23,0,0,0,0
5,8473449,Kyle Okposo,R,,36,0,0,0,0
5,8482192,Isaak Phillips,D,CHI,23,0,0,0,0
5,8480727,Zach Whitecloud,D,VGK,28,0,0,0,0
5,8479346,Dillon Dube,C,,26,0,0,0,0
5,8480821,Filip Zadina,R,,25,0,0,0,0
5,8480001,Urho Vaakanainen,D,ANA,25,0,0,0,0
5,8470966,Mark Giordano,D,,41,0,0,0,0
5,8480853,Liam Foudy,C,,24,0,0,0,0
5,8475225,Craig Smith,C,CHI,35,0,0,0,0
5,8479972,Mason Shaw,C,WPG,26,0,0,0,0
5,8478451,Ethan Bear,D,WSH,27,0,0,0,0
5,8474040,Sam Gagner,C,,35,0,0,0,0
5,8480196,Jacob Bryson,D,BUF,27,0,0,0,0
5,8479984,Cal Foote,D,,26,0,0,0,0
5,8480011,Klim Kostin,C,SJS,25,0,0,0,0
5,8482176,Wyatt Kaiser,D,CHI,22,0,0,0,0
5,8476988,Matt Benning,D,SJS,30,0,0,0,0
5,8479370,Tyson Jost,C,CAR,26,0,0,0,0
5,8477464,Nic Petan,C,,29,0,0,0,0
5,8477380,Jonny Brodzinski,C,NYR,31,0,0,0,0
5,8480070,Ian Mitchell,D,BOS,25,0,0,0,0
5,8479315,Joey Anderson,R,CHI,26,0,0,0,0
5,8478099,Kevin Labanc,R,,29,0,0,0,0
5,8476874,Olli Maatta,D,DET,30,0,0,0,0
5,8475208,Brian Dumoulin,D,ANA,33,0,0,0,0
5,8478430,Oliver Kylington,D,,27,0,0,0,0
5,8479536,Axel Jonsson-Fjallby,L,WPG,26,0,0,0,0
5,8479671,Mathieu Olivier,R,CBJ,27,0,0,0,0
5,8471709,Marc-Edouard Vlasic,D,SJS,37,0,0,0,0
5,8479328,Julien Gauthier,R,NYI,27,0,0,0,0
5,8478421,A.J. Greer,L,FLA,28,0,0,0,0
5,8477573,Nathan Walker,L,STL,30,0,0,0,0
5,8481537,Nikita Okhotiuk,D,CGY,24,0,0,0,0
5,8474166,Alec Martinez,D,CHI,37,0,0,0,0
5,8470610,Zach Parise,L,,40,0,0,0,0
5,8477478,William Carrier,L,CAR,30,0,0,0,0
5,8479344,Jesse Puljujarvi,R,PIT,26,0,0,0,0
5,8480887,Jordan Harris,D,MTL,24,0,0,0,0
5,8478502,Dennis Gilbert,D,BUF,28,0,0,0,0
5,8482730,Brandt Clarke,D,LAK,21,0,0,0,0
5,8480355,Mark Kastelic,C,BOS,25,0,0,0,0
5,8475750,Jon Merrill,D,MIN,32,0,0,0,0
5,8475164,Jakob Silfverberg,R,,34,0,0,0,0
5,8477944,Jakub Vrana,L,,28,0,0,0,0
5,8479439,Jacob MacDonald,D,COL,31,0,0,0,0
5,8474568,Luke Schenn,D,NSH,35,0,0,0,0
5,8478454,Noah Juulsen,D,VAN,27,0,0,0,0
5,8475752,Tyler Pitlick,C,,33,0,0,0,0
5,8482148,Hendrix Lapierre,C,WSH,22,0,0,0,0
5,8481167,Brayden Pachal,D,CGY,25,0,0,0,0
5,8478043,Sam Lafferty,C,BUF,29,0,0,0,0
5,8479321,Lucas Johansen,D,,27,0,0,0,0
5,8471699,Andrew Cogliano,C,,37,0,0,0,0
5,8481521,Ronnie Attard,D,PHI,25,0,0,0,0
5,8481161,Jake Christiansen,D,CBJ,25,0,0,0,0
5,8479458,Nikita Zaitsev,D,,33,0,0,0,0
5,8479619,Michael Carcone,L,UTA,28,0,0,0,0
5,8479026,Philippe Myers,D,TOR,27,0,0,0,0
5,8477330,Dominik Kubalik,L,,29,0,0,0,0
5,8481617,Vasily Podkolzin,R,VAN,23,0,0,0,0
5,8481701,Santeri Hatakka,D,NJD,23,0,0,0,0
5,8479514,Rem Pitlick,C,,27,0,0,0,0
5,8477446,Michael McCarron,R,NSH,29,0,0,0,0
5,8470604,Jeff Carter,C,,39,0,0,0,0
5,8482241,Radim Zohorna,L,,28,0,0,0,0
5,8480289,Morgan Barron,C,WPG,26,0,0,0,0
5,8479379,Givani Smith,R,SJS,26,0,0,0,0
5,8480216,Jacob Peterson,C,,25,0,0,0,0
5,8477851,Jordan Oesterle,D,BOS,32,0,0,0,0
5,8484258,Sam Malinski,D,COL,26,0,0,0,0
5,8478904,Steven Lorentz,C,,28,0,0,0,0
5,8482095,Tyler Kleven,D,OTT,22,0,0,0,0
5,8480848,Ty Dellandrea,C,SJS,24,0,0,0,0
5,8476884,Derrick Pouliot,D,,30,0,0,0,0
5,8479336,Carl Grundstrom,R,SJS,27,0,0,0,0
5,8482964,Arber Xhekaj,D,MTL,23,0,0,0,0
5,8471686,Marc Staal,D,,37,0,0,0,0
5,8477887,Patrick Brown,C,BOS,32,0,0,0,0
5,8478495,Denis Gurianov,R,,27,0,0,0,0
5,8473504,Cal Clutterbuck,R,,37,0,0,0,0
5,8481550,Adam Beckman,L,NJD,23,0,0,0,0
5,8480845,Rasmus Kupari,C,WPG,24,0,0,0,0
5,8474009,Nick Bonino,C,,36,0,0,0,0
5,8478585,Derek Ryan,C,EDM,38,0,0,0,0
5,8477962,Brendan Lemieux,L,CAR,28,0,0,0,0
5,8482861,Vincent Iorio,D,WSH,22,0,0,0,0
5,8479378,Logan Stanley,D,WPG,26,0,0,0,0
5,8473446,Erik Johnson,D,PHI,36,0,0,0,0
5,8481743,Marc Del Gaizo,D,NSH,25,0,0,0,0
5,8477384,Josh Brown,D,EDM,30,0,0,0,0
5,8482165,Yan Kuznetsov,D,CGY,22,0,0,0,0
5,8478424,Jansen Harkins,C,ANA,27,0,0,0,0
5,8482144,Jack Thompson,D,SJS,22,0,0,0,0
5,8478512,Austin Czarnik,C,,32,0,0,0,0
5,8477527,Ross Johnston,L,ANA,30,0,0,0,0
5,8479383,Boris Katchouk,L,,26,0,0,0,0
5,8482094,Daemon Hunt,D,MIN,22,0,0,0,0
5,8481719,Maxwell Crozier,D,TBL,24,0,0,0,0
5,8480192,Johnathan Kovacevic,D,NJD,27,0,0,0,0
5,8479376,Victor Mete,D,,26,0,0,0,0
5,8482511,Mason Lohrei,D,BOS,23,0,0,0,0
5,8475825,Jani Hakanpää,D,,32,0,0,0,0
5,8478021,William Lagesson,D,DET,28,0,0,0,0
5,8475795,Dylan McIlrath,D,WSH,32,0,0,0,0
5,8477846,Ryan Carpenter,C,,33,0,0,0,0
5,8481056,Spencer Stastney,D,NSH,24,0,0,0,0
5,8481564,Ryan Johnson,D,BUF,23,0,0,0,0
5,8478017,Mark Friedman,D,VAN,29,0,0,0,0
5,8479320,Max Lajoie,D,SEA,27,0,0,0,0
5,8480075,Cameron Crotty,D,MIN,25,0,0,0,0
5,8484287,Cole McWard,D,VAN,23,0,0,0,0
5,8484254,Akito Hirose,D,VAN,25,0,0,0,0
5,8483407,Brandon Scanlin,D,NYR,25,0,0,0,0
5,8480274,Philip Kemp,D,EDM,25,0,0,0,0
5,8479522,Hardy Haman Aktell,D,WSH,26,0,0,0,0
5,8480007,Jonas Rondbjerg,R,VGK,25,0,0,0,0
5,8477454,Adam Erne,L,,29,0,0,0,0
5,8481679,Maxence Guenette,D,OTT,23,0,0,0,0
5,8480441,Trey Fix-Wolansky,R,CBJ,25,0,0,0,0
5,8483546,Marshall Rifai,D,TOR,26,0,0,0,0
5,8480084,Nick DeSimone,D,NJD,30,0,0,0,0
5,8481030,Jack St. Ivany,D,PIT,25,0,0,0,0
5,8481592,Jakob Pelletier,L,CGY,23,0,0,0,0
5,8478011,Louie Belpedio,D,PHI,28,0,0,0,0
5,8477930,Pierre-Edouard Bellemare,L,,39,0,0,0,0
5,8484321,Nikolas Matinpalo,D,OTT,26,0,0,0,0
5,8482067,Connor Mackey,D,NYR,28,0,0,0,0
5,8481806,Louis Crevier,D,CHI,23,0,0,0,0
5,8484326,Patrik Koch,D,UTA,28,0,0,0,0
5,8477971,Andreas Englund,D,LAK,28,0,0,0,0
5,8481751,Lukas Rousek,R,BUF,25,0,0,0,0
5,8481006,Tyler Tucker,D,STL,24,0,0,0,0
5,8476867,Brendan Gaunce,C,MIN,30,0,0,0,0
5,8479520,Brandon Duhaime,R,WSH,27,0,0,0,0
5,8477073,Kurtis MacDermid,L,NJD,30,0,0,0,0
5,8480874,Adam Ginning,D,PHI,24,0,0,0,0
5,8477473,Justin Bailey,R,SJS,29,0,0,0,0
5,8479066,Ryan Lomberg,L,CGY,30,0,0,0,0
5,8477070,Liam O'Brien,C,UTA,30,0,0,0,0
5,8474618,Marco Scandella,D,,34,0,0,0,0
5,8475797,Jarred Tinordi,D,,32,0,0,0,0
5,8481441,Joe Snively,C,DET,28,0,0,0,0
5,8477244,Chad Ruhwedel,D,NYR,34,0,0,0,0
5,8479772,Zack MacEwen,R,OTT,28,0,0,0,0
5,8481147,Reese Johnson,C,MIN,26,0,0,0,0
5,8481043,Cole Koepke,L,BOS,26,0,0,0,0
5,8483619,Filip Roos,D,OTT,25,0,0,0,0
5,8481541,Samuel Bolduc,D,NYI,24,0,0,0,0
5,8477810,Joel Hanley,D,CGY,33,0,0,0,0
5,8476907,Mackenzie MacEachern,L,,30,0,0,0,0
5,8482652,Walker Duehr,R,CGY,27,0,0,0,0
5,8477126,Jayson Megna,C,,34,0,0,0,0
5,8483398,Declan Carlile,D,TBL,31,0,0,0,0
5,8482929,Emil Lilleberg,D,TBL,23,0,0,0,0
5,8480880,Jakub Lauko,C,MIN,24,0,0,0,0
5,8480245,Olle Lycksell,R,PHI,25,0,0,0,0
5,8480252,Cole Guttman,C,CHI,25,0,0,0,0
5,8477467,Gustav Olofsson,D,SEA,30,0,0,0,0
5,8479968,Vinni Lettieri,C,BOS,29,0,0,0,0
5,8478400,Colin White,C,,27,0,0,0,0
5,8475755,Alexander Petrovic,D,DAL,32,0,0,0,0
5,8481812,Nikolai Knyzhov,D,,27,0,0,0,0
5,8481593,Jayden Struble,D,MTL,23,0,0,0,0
5,8481532,Alex Turcotte,C,LAK,23,0,0,0,0
5,8482126,Emil Andrae,D,PHI,31,0,0,0,0
5,8479944,Zach Aston-Reese,C,VGK,30,0,0,0,0
5,8471817,Ryan Reaves,R,TOR,37,0,0,0,0
5,8481206,John Ludvig,D,PIT,24,0,0,0,0
5,8481599,Victor Soderstrom,D,UTA,23,0,0,0,0
5,8480292,Carson Meyer,R,ANA,27,0,0,0,0
5,8482496,Nils Aman,C,VAN,24,0,0,0,0
5,8479718,Alex Barré-Boulet,C,MTL,27,0,0,0,0
5,8479994,Jaret Anderson-Dolan,C,WPG,25,0,0,0,0
5,8480184,Gustav Lindstrom,D,,26,0,0,0,0
5,8480890,Jan Jenik,R,OTT,24,0,0,0,0
5,8478067,Oskar Lindblom,L,,28,0,0,0,0
5,8476934,Brock McGinn,L,ANA,30,0,0,0,0
5,8479985,Cale Fleury,D,SEA,26,0,0,0,0
5,8484304,Uvis Balinskis,D,FLA,28,0,0,0,0
5,8479981,Jonah Gadjovich,L,FLA,26,0,0,0,0
5,8481716,Dmitri Voronkov,L,CBJ,24,0,0,0,0
5,8474709,Matt Martin,L,,35,0,0,0,0
5,8482634,Alex Steeves,C,TOR,25,0,0,0,0
5,8480823,Alexander Alexeyev,D,WSH,25,0,0,0,0
5,8477541,Dakota Mermis,D,TOR,30,0,0,0,0
5,8483491,Ivan Miroshnichenko,L,WSH,20,0,0,0,0
5,8478477,Mitchell Stephens,C,SEA,27,0,0,0,0
5,8481543,Nikita Alexandrov,C,STL,24,0,0,0,0
5,8479423,Alex Nylander,L,,26,0,0,0,0
5,8482451,Mikael Pyyhtia,L,CBJ,23,0,0,0,0
5,8478831,Kevin Stenlund,C,UTA,28,0,0,0,0
5,8480306,Grant Hutton,D,NYI,29,0,0,0,0
5,8478028,Fredrik Olofsson,L,,28,0,0,0,0
5,8477462,Robert Hagg,D,VGK,29,0,0,0,0
5,8477320,Anton Blidh,L,NYR,29,0,0,0,0
5,8482157,Will Cuylle,L,NYR,22,0,0,0,0
5,8482737,Zack Bolduc,C,STL,21,0,0,0,0
5,8481239,Samuel Fagemo,L,,24,0,0,0,0
5,8481600,Tobias Bjornfot,D,FLA,23,0,0,0,0
5,8478409,Anthony Richard,C,PHI,28,0,0,0,0
5,8474145,Robert Bortuzzo,D,,35,0,0,0,0
5,8475958,Michael Sgarbossa,C,WSH,32,0,0,0,0
5,8479986,Kole Lind,R,DAL,26,0,0,0,0
5,8479249,Andrew Poturalski,C,SJS,30,0,0,0,0
5,8479362,Riley Tufte,L,BOS,26,0,0,0,0
5,8479991,Jake Leschyshyn,C,NYR,25,0,0,0,0
5,8479587,Rhett Gardner,C,PHI,28,0,0,0,0
5,8482744,James Malatesta,L,CBJ,21,0,0,0,0
5,8478854,Ryan Shea,D,PIT,27,0,0,0,0
5,8481591,Sam Poulin,R,,23,0,0,0,0
5,8483512,Matt Savoie,C,EDM,20,0,0,0,0
5,8482102,Vasily Ponomarev,C,PIT,22,0,0,0,0
5,8482162,Roby Jarventie,L,EDM,22,0,0,0,0
5,8481016,Ruslan Iskhakov,C,,24,0,0,0,0
5,8482172,Landon Slaggert,L,CHI,22,0,0,0,0
5,8482747,Brennan Othmann,L,NYR,21,0,0,0,0
5,8480031,Maxime Comtois,L,,25,0,0,0,0
5,8480226,Marián Studenic,R,,26,0,0,0,0
5,8478408,Travis Dermott,D,,28,0,0,0,0
5,8481518,Nolan Foote,L,NJD,24,0,0,0,0
5,8479419,Brett Murray,L,BUF,26,0,0,0,0
5,8482088,Justin Sourdif,R,FLA,22,0,0,0,0
5,8482201,Gage Goncalves,C,TBL,23,0,0,0,0
5,8481578,Graeme Clarke,R,MIN,23,0,0,0,0
5,8482177,Marat Khusnutdinov,C,MIN,22,0,0,0,0
5,8481754,Nikita Nesterenko,C,ANA,23,0,0,0,0
5,8483531,Brian Halonen,L,NJD,25,0,0,0,0
5,8483920,Pierrick Dube,R,WSH,23,0,0,0,0
5,8480851,Akil Thomas,C,LAK,24,0,0,0,0
5,8475235,Nicolas Deslauriers,L,PHI,33,0,0,0,0
5,8482476,Emil Heineman,L,MTL,23,0,0,0,0
5,8477149,Scott Sabourin,R,SJS,32,0,0,0,0
5,8483549,Lucas Condotta,L,MTL,27,0,0,0,0
5,8482765,Isak Rosen,R,BUF,21,0,0,0,0
5,8481237,Kyle MacLean,C,NYI,25,0,0,0,0
5,8481024,Linus Karlsson,C,VAN,25,0,0,0,0
5,8481690,Tyler Angle,C,,24,0,0,0,0
5,8483570,Ben Meyers,C,SEA,26,0,0,0,0
5,8481655,Cole Schwindt,R,CGY,23,0,0,0,0
5,8481462,Mason Morelli,L,VGK,28,0,0,0,0
5,8483401,Marc Johnstone,R,PIT,28,0,0,0,0
5,8478956,Samuel Laberge,L,NJD,27,0,0,0,0
5,8479533,Joona Koppanen,L,,26,0,0,0,0
5,8482197,Adam Raska,R,MIN,23,0,0,0,0
5,8482250,Callahan Burke,C,VGK,27,0,0,0,0
5,8482784,Zach Dean,C,STL,21,0,0,0,0
5,8484255,Jason Polin,R,COL,25,0,0,0,0
5,8481077,John Leonard,L,,26,0,0,0,0
5,8481534,Raphael Lavoie,C,EDM,24,0,0,0,0
5,8483609,Adam Klapka,R,CGY,24,0,0,0,0
5,8482751,Ryan Winterton,C,SEA,21,0,0,0,0
5,8480267,Sammy Walker,C,MIN,25,0,0,0,0
5,8475766,Austin Watson,L,,32,0,0,0,0
5,8482460,Matt Rempe,C,NYR,22,0,0,0,0
5,8481065,Angus Crookshank,L,OTT,25,0,0,0,0
5,8481070,Hugh McGing,L,,26,0,0,0,0
5,8476323,Max McCormick,L,SEA,32,0,0,0,0
5,8483395,Arshdeep Bains,L,VAN,23,0,0,0,0
5,8484259,Ondrej Pavel,C,COL,31,0,0,0,0
5,8483432,Luca Del Bel Belluz,C,CBJ,31,0,0,0,0
5,8483045,Cameron Butler,R,CBJ,31,0,0,0,0
5,8482061,Brandon Biro,L,SEA,26,0,0,0,0
5,8477401,John Hayden,C,SEA,29,0,0,0,0
5,8475278,Byron Froese,C,,33,0,0,0,0
5,8478446,Glenn Gawdin,C,LAK,27,0,0,0,0
5,8477993,Justin Kirkland,C,CGY,28,0,0,0,0
5,8482147,Jean-Luc Foudy,C,COL,22,0,0,0,0
5,8480032,Shane Bowers,C,NJD,25,0,0,0,0
5,8479330,Brandon Gignac,C,MTL,27,0,0,0,0
5,8480776,Sheldon Rempal,R,,29,0,0,0,0
5,8475413,Justin Dowling,C,NJD,34,0,0,0,0
5,8481726,Adam Edstrom,C,NYR,24,0,0,0,0
5,8480844,Grigori Denisenko,L,VGK,24,0,0,0,0
5,8478147,Bokondji Imama,L,PIT,28,0,0,0,0
5,8478881,Brett Seney,L,CHI,28,0,0,0,0
5,8483630,Pavol Regenda,L,ANA,25,0,0,0,0
5,8480836,Jonathan Gruden,C,,24,0,0,0,0
5,8484314,Jiri Smejkal,L,,28,0,0,0,0
5,8475780,Chris Wagner,R,COL,33,0,0,0,0
5,8479546,Oskar Steen,C,,26,0,0,0,0
5,8483597,Milos Kelemen,L,UTA,25,0,0,0,0
5,8481789,Tye Kartye,L,SEA,23,0,0,0,0
5,8484325,Waltteri Merela,C,TBL,26,0,0,0,0
5,8479421,Jacob Moverare,D,LAK,26,0,0,0,0
5,8481585,Egor Afanasyev,L,SJS,23,0,0,0,0
5,8479547,Matthew Phillips,R,,26,0,0,0,0
5,8479367,William Lockwood,R,FLA,26,0,0,0,0
5,8476915,Jujhar Khaira,L,,30,0,0,0,0
5,8481422,Jacob Lucchini,C,NSH,29,0,0,0,0
5,8480468,James Hamblin,L,EDM,25,0,0,0,0
5,8478051,Max Willman,C,NJD,29,0,0,0,0
5,8481556,John Beecher,C,BOS,23,0,0,0,0
5,8478078,Rourke Chartier,C,,28,0,0,0,0
6,8478402,Connor McDavid,C,EDM,27,82,47,95,142
6,8477492,Nathan MacKinnon,C,COL,29,82,46,90,136
6,8478864,Kirill Kaprizov,L,MIN,27,82,53,69,122
6,8477934,Leon Draisaitl,C,EDM,29,82,52,70,122
6,8479318,Auston Matthews,C,TOR,27,82,55,66,121
6,8477956,David Pastrnak,R,BOS,28,82,39,79,118
6,8481559,Jack Hughes,C,NJD,23,82,46,70,116
6,8479314,Matthew Tkachuk,L,FLA,27,82,33,76,109
6,8476453,Nikita Kucherov,R,TBL,31,82,30,74,104
6,8477493,Aleksander Barkov,C,FLA,29,82,24,77,101
6,8480069,Cale Makar,D,COL,26,82,25,74,99
6,8474564,Steven Stamkos,C,NSH,34,82,46,52,98
6,8481557,Matt Boldy,L,MIN,23,82,36,62,98
6,8480800,Quinn Hughes,D,VAN,25,82,18,80,98
6,8480801,Brady Tkachuk,L,OTT,25,82,42,55,97
6,8476468,J.T. Miller,C,VAN,31,82,36,61,97
6,8480208,Drake Batherson,R,OTT,26,82,27,70,97
6,8477939,William Nylander,R,TOR,28,82,44,52,96
6,8478420,Mikko Rantanen,R,COL,28,82,37,59,96
6,8474600,Roman Josi,D,NSH,34,82,21,75,96
6,8478550,Artemi Panarin,L,NYR,33,82,32,63,95
6,8480023,Robert Thomas,C,STL,25,82,26,68,94
6,8471675,Sidney Crosby,C,PIT,37,82,44,49,93
6,8476887,Filip Forsberg,L,NSH,30,82,52,40,92
6,8480002,Nico Hischier,C,NJD,25,82,46,46,92
6,8476346,Johnny Gaudreau,L,CBJ,31,82,25,67,92
6,8477960,Adrian Kempe,R,LAK,28,82,44,47,91
6,8482116,Tim Stützle,C,OTT,22,82,32,59,91
6,8477946,Dylan Larkin,C,DET,28,82,46,42,88
6,8477404,Jake Guentzel,C,TBL,30,82,41,46,87
6,8476460,Mark Scheifele,C,WPG,31,82,38,49,87
6,8480027,Jason Robertson,L,DAL,25,82,29,58,87
6,8477933,Sam Reinhart,C,FLA,29,82,44,42,86
6,8477951,Nick Schmaltz,C,UTA,28,82,37,49,86
6,8478427,Sebastian Aho,C,CAR,27,82,41,44,85
6,8478398,Kyle Connor,L,WPG,28,82,39,45,84
6,8475172,Nazem Kadri,C,CGY,34,82,34,50,84
6,8480012,Elias Pettersson,C,VAN,26,82,36,47,83
6,8479337,Alex DeBrincat,R,DET,27,82,27,56,83
6,8478414,Timo Meier,R,NJD,28,82,40,42,82
6,8477496,Elias Lindholm,C,BOS,30,82,38,44,82
6,8478042,Viktor Arvidsson,R,EDM,31,82,40,41,81
6,8479385,Jordan Kyrou,C,STL,26,82,39,42,81
6,8475168,Matt Duchene,C,DAL,33,82,30,51,81
6,8477402,Pavel Buchnevich,L,STL,29,82,29,52,81
6,8479420,Tage Thompson,C,BUF,27,82,42,38,80
6,8477955,Jared McCann,L,SEA,28,82,40,40,80
6,8478010,Brayden Point,C,TBL,28,82,38,42,80
6,8479343,Clayton Keller,R,UTA,26,82,37,42,79
6,8475170,Brayden Schenn,C,STL,33,82,37,42,79
6,8480830,Andrei Svechnikov,R,CAR,24,82,22,57,79
6,8479323,Adam Fox,D,NYR,26,82,13,66,79
6,8476853,Morgan Rielly,D,TOR,30,82,13,66,79
6,8475726,Tyler Toffoli,C,SJS,32,82,35,43,78
6,8477942,Kevin Fiala,L,LAK,28,82,22,56,78
6,8478445,Mathew Barzal,C,NYI,27,82,22,56,78
6,8478460,Zach Werenski,D,CBJ,27,82,16,62,78
6,8477504,Josh Morrissey,D,WPG,29,82,14,64,78
6,8478439,Travis Konecny,R,PHI,27,82,35,42,77
6,8473419,Brad Marchand,L,BOS,36,82,31,46,77
6,8478401,Pavel Zacha,C,BOS,27,82,30,47,77
6,8475913,Mark Stone,R,VGK,32,82,26,51,77
6,8481523,Kirby Dach,C,MTL,23,82,9,67,76
6,8473512,Claude Giroux,R,OTT,36,82,26,49,75
6,8475184,Chris Kreider,L,NYR,33,82,45,29,74
6,8477935,Sam Bennett,C,FLA,28,82,41,32,73
6,8482078,Lucas Raymond,L,DET,22,82,28,45,73
6,8479407,Jesper Bratt,L,NJD,26,82,27,46,73
6,8474141,Patrick Kane,R,DET,36,82,26,47,73
6,8480803,Evan Bouchard,D,EDM,25,82,14,59,73
6,8475754,Brock Nelson,C,NYI,33,82,36,36,72
6,8482097,Jack Quinn,R,BUF,23,82,24,48,72
6,8474590,John Carlson,D,WSH,34,82,18,54,72
6,8475692,Mats Zuccarello,R,MIN,37,82,17,55,72
6,8471214,Alex Ovechkin,L,WSH,39,82,34,37,71
6,8474586,Jordan Eberle,R,SEA,34,82,31,40,71
6,8476459,Mika Zibanejad,C,NYR,31,82,28,43,71
6,8478449,Roope Hintz,C,DAL,28,82,26,45,71
6,8478038,Devon Toews,D,COL,30,82,13,58,71
6,8477501,Valeri Nichushkin,R,COL,29,82,43,27,70
6,8481540,Cole Caufield,R,MTL,23,82,34,36,70
6,8478403,Jack Eichel,C,VGK,28,82,32,38,70
6,8476389,Vincent Trocheck,C,NYR,31,82,28,42,70
6,8477940,Nikolaj Ehlers,L,WPG,28,82,26,44,70
6,8475798,Mikael Granlund,C,SJS,32,82,15,55,70
6,8479542,Brandon Hagel,L,TBL,26,82,33,36,69
6,8478493,Joel Eriksson Ek,C,MIN,27,82,32,37,69
6,8475166,John Tavares,C,TOR,34,82,28,41,69
6,8478440,Dylan Strome,C,WSH,27,82,22,47,69
6,8480839,Rasmus Dahlin,D,BUF,24,82,20,49,69
6,8476456,Jonathan Huberdeau,C,CGY,31,82,18,51,69
6,8478975,Mason Marchment,L,DAL,29,82,26,42,68
6,8471215,Evgeni Malkin,C,PIT,38,82,33,34,67
6,8475191,Reilly Smith,R,NYR,33,82,27,40,67
6,8480036,Miro Heiskanen,D,DAL,25,82,18,49,67
6,8478396,Noah Hanifin,D,VGK,27,82,16,51,67
6,8477949,Alex Tuch,R,BUF,28,82,14,53,67
6,8479339,Patrik Laine,L,CBJ,26,82,33,33,66
6,8477497,Sean Monahan,C,CBJ,30,82,31,35,66
6,8480018,Nick Suzuki,C,MTL,25,82,28,38,66
6,8475765,Vladimir Tarasenko,R,DET,33,82,25,41,66
6,8479400,Pierre-Luc Dubois,L,WSH,26,82,32,33,65
6,8476881,Tomas Hertl,C,VGK,31,82,31,34,65
6,8475753,Justin Faulk,D,STL,32,82,17,48,65
6,8480865,Noah Dobson,D,NYI,24,82,12,53,65
6,8477409,Carter Verhaeghe,C,FLA,29,82,40,24,64
6,8481068,Yegor Sharangovich,C,CGY,26,82,28,36,64
6,8477500,Bo Horvat,C,NYI,29,82,27,37,64
6,8477447,Shea Theodore,D,VGK,29,82,12,52,64
6,8482093,Seth Jarvis,C,CAR,22,82,29,34,63
6,8477407,Anthony Duclair,L,NYI,29,82,27,36,63
6,8479999,Casey Mittelstadt,C,COL,26,82,25,38,63
6,8475158,Ryan O'Reilly,C,NSH,33,82,21,42,63
6,8476454,Ryan Nugent-Hopkins,C,EDM,31,82,12,51,63
6,8479325,Charlie McAvoy,D,BOS,27,82,15,47,62
6,8478047,Michael Bunting,L,PIT,29,82,20,41,61
6,8477416,Oliver Bjorkstrand,R,SEA,29,82,20,41,61
6,8474150,Mikael Backlund,C,CGY,35,82,15,46,61
6,8473994,Jamie Benn,L,DAL,35,82,25,35,60
6,8476462,Dougie Hamilton,D,NJD,31,82,17,43,60
6,8482684,Luke Hughes,D,NJD,21,82,12,48,60
6,8479410,Mikhail Sergachev,D,UTA,26,82,7,53,60
6,8480028,Morgan Frost,C,PHI,25,82,27,32,59
6,8480039,Martin Necas,C,CAR,25,82,23,36,59
6,8476882,Teuvo Teravainen,L,CHI,30,82,19,40,59
6,8477986,Brandon Montour,D,SEA,30,82,18,41,59
6,8474563,Drew Doughty,D,LAK,35,82,15,44,59
6,8475167,Victor Hedman,D,TBL,34,82,14,45,59
6,8478397,Rasmus Andersson,D,CGY,28,82,13,46,59
6,8480434,Sean Durzi,D,UTA,26,82,9,50,59
6,8482109,Alexis Lafrenière,L,NYR,23,82,30,28,58
6,8476539,Jonathan Marchessault,R,NSH,34,82,28,30,58
6,8471685,Anze Kopitar,C,LAK,37,82,26,32,58
6,8475810,Bryan Rust,R,PIT,32,82,25,33,58
6,8476875,Mike Matheson,D,MTL,30,82,11,47,58
6,8474578,Erik Karlsson,D,PIT,34,82,9,49,58
6,8478498,Jake DeBrusk,L,VAN,28,82,28,29,57
6,8479345,Jakob Chychrun,D,WSH,26,82,14,43,57
6,8475786,Zach Hyman,L,EDM,32,82,35,21,56
6,8475794,Tyler Seguin,C,DAL,32,82,33,23,56
6,8476880,Tom Wilson,R,WSH,30,82,28,28,56
6,8475287,Erik Haula,L,NJD,33,82,24,32,56
6,8479425,Filip Hronek,D,VAN,27,82,14,42,56
6,8477476,Artturi Lehkonen,L,COL,29,82,26,29,55
6,8481528,Dylan Cozens,C,BUF,23,82,20,35,55
6,8478873,Troy Terry,R,ANA,27,82,26,28,54
6,8482667,William Eklund,L,SJS,22,82,23,31,54
6,8482124,Quinton Byfield,R,LAK,22,82,21,33,54
6,8484144,Connor Bedard,C,CHI,19,82,18,36,54
6,8476792,Torey Krug,D,STL,33,82,13,41,54
6,8471724,Kris Letang,D,PIT,37,82,11,43,54
6,8482175,JJ Peterka,R,BUF,22,82,27,26,53
6,8482149,Cole Perfetti,C,WPG,22,82,26,27,53
6,8481711,Matias Maccelli,L,UTA,24,82,21,32,53
6,8477494,Jonathan Drouin,L,COL,29,82,19,34,53
6,8478407,Vince Dunn,D,SEA,28,82,12,41,53
6,8482113,Anton Lundell,C,FLA,23,82,28,24,52
6,8475768,Jaden Schwartz,C,SEA,32,82,27,25,52
6,8476448,William Karlsson,C,VGK,31,82,26,26,52
6,8477511,Anthony Mantha,R,CGY,30,82,25,27,52
6,8481596,Shane Pinto,C,OTT,24,82,23,29,52
6,8480064,Josh Norris,C,OTT,25,82,23,29,52
6,8474679,Gustav Nyquist,C,NSH,35,82,22,30,52
6,8483808,Andrei Kuzmenko,L,CGY,28,82,28,23,51
6,8478109,Victor Olofsson,L,VGK,29,82,28,23,51
6,8480015,Owen Tippett,R,PHI,25,82,26,25,51
6,8478856,Conor Garland,R,VAN,28,82,22,29,51
6,8478542,Evan Rodrigues,C,FLA,31,82,22,29,51
6,8475784,Jeff Skinner,C,EDM,32,82,21,30,51
6,8481581,Thomas Harley,D,DAL,23,82,14,37,51
6,8477503,Max Domi,C,TOR,29,82,13,38,51
6,8477346,MacKenzie Weegar,D,CGY,30,82,12,39,51
6,8478472,Mathieu Joseph,R,STL,27,82,12,39,51
6,8476923,Damon Severson,D,CBJ,30,82,10,41,51
6,8478055,Gustav Forsling,D,FLA,28,82,9,42,51
6,8482159,Tyson Foerster,R,PHI,22,82,29,21,50
6,8475314,Anders Lee,L,NYI,34,82,29,21,50
6,8476292,Ondrej Palat,L,NJD,33,82,25,25,50
6,8476399,Blake Coleman,C,CGY,33,82,24,26,50
6,8481618,Alex Newhook,C,MTL,23,82,24,26,50
6,8478519,Anthony Cirelli,C,TBL,27,82,20,30,50
6,8480078,Filip Chytil,C,NYR,25,82,18,32,50
6,8477444,Andre Burakovsky,L,SEA,29,82,17,33,50
6,8476906,Shayne Gostisbehere,D,CAR,31,82,15,35,50
6,8478438,Tommy Novak,C,NSH,27,82,14,36,50
6,8478462,Nicolas Roy,C,VGK,27,82,13,37,50
6,8481542,Moritz Seider,D,DET,23,82,8,42,50
6,8475151,Kyle Palmieri,C,NYI,33,82,28,21,49
6,8480797,Joel Farabee,L,PHI,24,82,24,25,49
6,8474641,Adam Henrique,C,EDM,34,82,23,26,49
6,8482665,Matty Beniers,C,SEA,22,82,17,32,49
6,8482110,Dawson Mercer,C,NJD,23,82,16,33,49
6,8477021,Alex Kerfoot,C,UTA,30,82,15,34,49
6,8478469,Thomas Chabot,D,OTT,27,82,13,36,49
6,8480014,Gabriel Vilardi,C,WPG,25,82,30,18,48
6,8476432,Boone Jenner,C,CBJ,31,82,29,19,48
6,8482055,Drew O'Connor,L,PIT,26,82,23,25,48
6,8476483,Rickard Rakell,R,PIT,31,82,21,27,48
6,8478444,Brock Boeser,R,VAN,27,82,19,29,48
6,8477964,Ivan Barbashev,C,VGK,29,82,19,29,48
6,8478458,Jack Roslovic,C,CAR,27,82,17,31,48
6,8482660,Kent Johnson,C,CBJ,22,82,14,34,48
6,8480188,Fabian Zetterlund,L,SJS,25,82,22,25,47
6,8480849,Barrett Hayton,C,UTA,24,82,22,25,47
6,8479987,Morgan Geekie,C,BOS,26,82,21,26,47
6,8481533,Trevor Zegras,C,ANA,23,82,19,28,47
6,8477456,J.T. Compher,L,DET,29,82,17,30,47
6,8477932,Aaron Ekblad,D,FLA,28,82,14,33,47
6,8470613,Brent Burns,D,CAR,39,82,13,34,47
6,8478057,Dakota Joshua,C,VAN,28,82,25,21,46
6,8476474,Stefan Noesen,R,NJD,31,82,21,25,46
6,8474053,Logan Couture,C,SJS,35,82,20,26,46
6,8475763,Kevin Hayes,R,PIT,32,82,20,26,46
6,8482146,Luke Evangelista,R,NSH,22,82,20,26,46
6,8482705,Cole Sillinger,C,CBJ,21,82,19,27,46
6,8481546,Cam York,D,PHI,23,82,11,35,46
6,8478366,Frank Vatrano,R,ANA,30,82,26,19,45
6,8482740,Wyatt Johnston,C,DAL,21,82,24,21,45
6,8480829,Jesperi Kotkaniemi,C,CAR,24,82,24,21,45
6,8476438,Brandon Saad,L,STL,32,82,21,24,45
6,8480003,Jesper Boqvist,C,FLA,26,82,21,24,45
6,8482475,Yegor Chinakhov,R,CBJ,23,82,19,26,45
6,8478115,Pierre Engvall,L,NYI,28,82,19,26,45
6,8476885,Jacob Trouba,D,NYR,30,82,18,27,45
6,8475169,Evander Kane,L,EDM,33,82,16,29,45
6,8476905,Chandler Stephenson,C,SEA,30,82,9,36,45
6,8479525,Ross Colton,C,COL,28,82,21,23,44
6,8480459,Pius Suter,C,VAN,28,82,18,26,44
6,8476461,Sean Couturier,C,PHI,32,82,13,31,44
6,8476479,Phillip Danault,C,LAK,31,82,11,33,44
6,8474102,David Perron,L,OTT,36,82,21,22,43
6,8482074,Connor Zary,C,CGY,23,82,21,22,43
6,8476419,Jean-Gabriel Pageau,C,NYI,32,82,15,28,43
6,8482699,Dylan Guenther,R,UTA,21,82,24,18,42
6,8478233,Andrew Mangiapane,L,WSH,28,82,19,23,42
6,8480798,Philipp Kurashev,C,CHI,25,82,19,23,42
6,8471698,T.J. Oshie,R,WSH,38,82,17,25,42
6,8476458,Ryan Strome,C,ANA,31,82,12,30,42
6,8476869,Brady Skjei,D,NSH,30,82,9,33,42
6,8479675,Trevor Moore,L,LAK,29,82,23,18,41
6,8475722,Jason Zucker,L,BUF,32,82,22,19,41
6,8478474,Lawson Crouse,L,UTA,27,82,19,22,41
6,8481580,Connor McMichael,C,WSH,23,82,19,22,41
6,8477953,Kasperi Kapanen,R,STL,28,82,18,23,41
6,8480220,Noah Cates,L,PHI,25,82,17,24,41
6,8477479,Tyler Bertuzzi,L,CHI,29,82,17,24,41
6,8476826,Yanni Gourde,C,SEA,33,82,16,25,41
6,8476872,Scott Laughton,C,PHI,30,82,11,30,41
6,8476958,Jaccob Slavin,D,CAR,30,82,10,31,41
6,8477495,Seth Jones,D,CHI,30,82,8,33,41
6,8477947,Sonny Milano,L,WSH,28,82,22,18,40
6,8482092,Ridly Greig,C,OTT,22,82,20,20,40
6,8480813,Joe Veleno,C,DET,24,82,20,20,40
6,8482745,Mason McTavish,C,ANA,21,82,18,22,40
6,8476329,Travis Boyd,C,MIN,31,82,15,25,40
6,8475343,Nic Dowd,C,WSH,34,82,14,26,40
6,8480817,K'Andre Miller,D,NYR,24,82,11,29,40
6,8475218,Mattias Ekholm,D,EDM,34,82,11,29,40
6,8480878,Nils Lundkvist,D,DAL,24,82,10,30,40
6,8474565,Alex Pietrangelo,D,VGK,34,82,5,35,40
6,8475799,Nino Niederreiter,R,WPG,32,82,22,17,39
6,8476921,Jordan Martinook,L,CAR,32,82,20,19,39
6,8481656,Aliaksei Protas,C,WSH,23,82,19,20,39
6,8475791,Taylor Hall,L,CHI,33,82,17,22,39
6,8477426,Nicholas Paul,L,TBL,29,82,15,24,39
6,8475745,Charlie Coyle,C,BOS,32,82,14,25,39
6,8478891,Mason Appleton,C,WPG,28,82,12,27,39
6,8475149,Marcus Johansson,L,MIN,34,82,20,18,38
6,8477451,Ryan Hartman,R,MIN,30,82,18,20,38
6,8477989,Christian Dvorak,C,MTL,28,82,17,21,38
6,8482624,Daniil Miromanov,D,CGY,27,82,15,23,38
6,8481560,Arthur Kaliyev,R,LAK,23,82,12,26,38
6,8476927,Teddy Blueger,C,VAN,30,82,12,26,38
6,8478911,Matt Roy,D,WSH,29,82,11,27,38
6,8475193,Tomas Tatar,L,NJD,34,82,11,27,38
6,8474149,Evgenii Dadonov,R,DAL,35,82,18,19,37
6,8477952,Robby Fabbri,C,ANA,28,82,18,19,37
6,8475760,Nick Bjugstad,C,UTA,32,82,18,19,37
6,8478413,Jordan Greenway,L,BUF,27,82,17,20,37
6,8478046,Danton Heinen,L,VAN,29,82,15,22,37
6,8477498,Darnell Nurse,D,EDM,29,82,15,22,37
6,8478211,Dryden Hunt,L,CGY,29,82,15,22,37
6,8473986,Alex Killorn,L,ANA,35,82,14,23,37
6,8475793,Ryan Johansen,C,PHI,32,82,14,23,37
6,8483515,Juraj Slafkovsky,L,MTL,20,82,14,23,37
6,8482720,Matthew Knies,L,TOR,22,82,13,24,37
6,8480336,Sean Walker,D,CAR,30,82,11,26,37
6,8482671,Owen Power,D,BUF,22,82,10,27,37
6,8475200,Dmitry Orlov,D,CAR,33,82,10,27,37
6,8480185,Eetu Luostarinen,C,FLA,26,82,9,28,37
6,8482089,Jake Neighbours,L,STL,22,82,21,15,36
6,8481604,Pavel Dorofeyev,L,VGK,24,82,21,15,36
6,8473422,Nick Foligno,L,CHI,37,82,20,16,36
6,8479996,Cody Glass,C,NSH,25,82,17,19,36
6,8477987,Ryan Donato,C,CHI,28,82,17,19,36
6,8479293,Brandon Tanev,L,SEA,33,82,16,20,36
6,8476422,Mike Reilly,D,NYI,31,82,14,22,36
6,8483457,Lane Hutson,D,MTL,20,82,11,25,36
6,8477429,Andrew Copp,C,DET,30,82,9,27,36
6,8476892,Colton Parayko,D,STL,31,82,9,27,36
6,8473563,Nicklas Backstrom,C,WSH,37,82,8,28,36
6,8480893,Kirill Marchenko,R,CBJ,24,82,24,11,35
6,8479941,Justin Danforth,R,CBJ,31,82,17,18,35
6,8476392,Adam Lowry,C,WPG,31,82,17,18,35
6,8480113,Alex Iafallo,L,WPG,31,82,16,19,35
6,8479353,Brett Howden,C,VGK,26,82,16,19,35
6,8484166,Adam Fantilli,C,CBJ,20,82,16,19,35
6,8479390,Taylor Raddysh,R,WSH,26,82,14,21,35
6,8480009,Eeli Tolvanen,R,SEA,25,82,13,22,35
6,8475714,Calle Jarnkrok,C,TOR,33,82,13,22,35
6,8480835,Jack Drury,C,CAR,24,82,12,23,35
6,8480043,Timothy Liljegren,D,TOR,25,82,7,28,35
6,8481186,Logan O'Connor,R,COL,28,82,19,15,34
6,8477998,Warren Foegele,L,LAK,28,82,19,15,34
6,8481582,Nicholas Robertson,L,TOR,23,82,19,15,34
6,8476278,Colin Blackwell,C,DAL,31,82,18,16,34
6,8483431,Logan Cooley,C,UTA,20,82,18,16,34
6,8476897,Oskar Sundqvist,C,STL,30,82,16,18,34
6,8481013,Jonatan Berggren,R,DET,24,82,16,18,34
6,8480748,Kiefer Sherwood,L,VAN,29,82,16,18,34
6,8480789,Oliver Wahlstrom,R,NYI,24,82,15,19,34
6,8478020,Michael Amadio,C,OTT,28,82,14,20,34
6,8476925,Colton Sissons,C,NSH,31,82,13,21,34
6,8478463,Anthony Beauvillier,L,PIT,27,82,13,21,34
6,8478500,Ivan Provorov,D,CBJ,27,82,2,32,34
6,8479992,Michael Rasmussen,C,DET,25,82,20,13,33
6,8479591,Michael Eyssimont,C,TBL,28,82,12,21,33
6,8482133,Thomas Bordeleau,C,SJS,22,82,11,22,33
6,8475171,Oliver Ekman-Larsson,D,TOR,33,82,10,23,33
6,8476624,Barclay Goodrow,C,SJS,31,82,9,24,33
6,8477506,Ryan Pulock,D,NYI,30,82,9,24,33
6,8480145,Neal Pionk,D,WPG,29,82,8,25,33
6,8476917,Adam Pelech,D,NYI,30,82,7,26,33
6,8482122,Brock Faber,D,MIN,22,82,7,26,33
6,8481567,Henry Thrun,D,SJS,23,82,6,27,33
6,8477948,Travis Sanheim,D,PHI,28,82,3,30,33
6,8482111,Justin Barron,D,MTL,23,82,15,17,32
6,8479980,Nicolas Hague,D,VGK,26,82,11,21,32
6,8474716,Jared Spurgeon,D,MIN,35,82,10,22,32
6,8476457,Adam Larsson,D,SEA,32,82,9,23,32
6,8480873,Rasmus Sandin,D,WSH,24,82,5,27,32
6,8476525,Colin Miller,D,WPG,32,82,4,28,32
6,8474151,Ryan McDonagh,D,TBL,35,82,1,31,32
6,8481481,Blake Lizotte,C,PIT,27,82,14,17,31
6,8480144,David Kampf,C,TOR,29,82,14,17,31
6,8475220,Marcus Foligno,L,MIN,33,82,12,19,31
6,8478133,Jake Evans,C,MTL,28,82,11,20,31
6,8480448,Parker Kelly,L,COL,25,82,11,20,31
6,8476918,Jimmy Vesey,L,NYR,31,82,10,21,31
6,8476312,Josh Manson,D,COL,33,82,7,24,31
6,8473507,Jeff Petry,D,DET,37,82,6,25,31
6,8474013,Ian Cole,D,UTA,35,82,6,25,31
6,8479324,Ryan Lindgren,D,NYR,26,82,6,25,31
6,8476429,Scott Mayfield,D,NYI,32,82,5,26,31
6,8479393,Noah Gregor,C,OTT,26,82,21,9,30
6,8475848,Brendan Gallagher,R,MTL,32,82,18,12,30
6,8481554,Kaapo Kakko,R,NYR,23,82,16,14,30
6,8482117,Lukas Reichel,L,CHI,22,82,15,15,30
6,8476981,Josh Anderson,R,MTL,30,82,14,16,30
6,8476480,Vladislav Namestnikov,C,WPG,32,82,11,19,30
6,8478434,Keegan Kolesar,R,VGK,27,82,11,19,30
6,8482105,Jake Sanderson,D,OTT,22,82,10,20,30
6,8480871,Adam Boqvist,D,FLA,24,82,8,22,30
6,8475764,Cam Fowler,D,ANA,33,82,5,25,30
6,8477488,Brett Pesce,D,NJD,30,82,5,25,30
6,8476979,Erik Gustafsson,D,DET,32,82,3,27,30
6,8478882,Vladislav Gavrikov,D,LAK,29,82,3,27,30
6,8481032,Paul Cotter,C,NJD,25,82,17,12,29
6,8470621,Corey Perry,R,EDM,39,82,13,16,29
6,8481535,Nils Hoglander,L,VAN,24,82,12,17,29
6,8477369,Carson Soucy,D,VAN,30,82,10,19,29
6,8479402,Jake Bean,D,CGY,26,82,6,23,29
6,8479371,Dante Fabbro,D,NSH,26,82,6,23,29
6,8477969,Marcus Pettersson,D,PIT,28,82,5,24,29
6,8478507,John Marino,D,UTA,27,82,5,24,29
6,8479976,Juuso Valimaki,D,UTA,26,82,5,24,29
6,8482142,Jamie Drysdale,D,PHI,22,82,4,25,29
6,8478399,Jonas Siegenthaler,D,NJD,27,82,4,25,29
6,8481014,Alexander Romanov,D,NYI,24,82,4,25,29
6,8480281,Alexey Toropchenko,R,STL,25,82,20,8,28
6,8476469,Joel Armia,R,MTL,31,82,17,11,28
6,8482077,Dylan Holloway,L,EDM,23,82,16,12,28
6,8476858,Phillip Di Giuseppe,L,VAN,31,82,16,12,28
6,8480802,Ryan McLeod,C,BUF,25,82,14,14,28
6,8482125,Alexander Holtz,R,VGK,22,82,14,14,28
6,8481704,Juuso Parssinen,C,NSH,23,82,12,16,28
6,8474189,Lars Eller,C,PIT,35,82,12,16,28
6,8479661,Tanner Jeannot,L,LAK,27,82,12,16,28
6,8477220,Nate Schmidt,D,FLA,33,82,8,20,28
6,8474574,Tyler Myers,D,VAN,34,82,8,20,28
6,8476854,Hampus Lindholm,D,BOS,30,82,6,22,28
6,8479351,Sam Steel,C,DAL,26,82,6,22,28
6,8476463,Jonas Brodin,D,MIN,31,82,4,24,28
6,8475842,Sam Carrick,C,NYR,32,82,20,7,27
6,8479368,Max Jones,L,BOS,26,82,15,12,27
6,8476374,Sean Kuraly,C,CBJ,31,82,12,15,27
6,8479365,Trent Frederic,C,BOS,26,82,11,16,27
6,8480068,Ryan Poehling,C,PHI,25,82,10,17,27
6,8477425,Miles Wood,L,COL,29,82,10,17,27
6,8477505,Alexander Wennberg,C,SJS,30,82,18,8,26
6,8484149,Gavin Brindley,C,CBJ,20,82,15,11,26
6,8481624,Ilya Mikheyev,R,CHI,30,82,13,13,26
6,8479316,Luke Kunin,C,SJS,27,82,13,13,26
6,8477353,Tyler Motte,C,DET,29,82,11,15,26
6,8481553,Bobby Brink,R,PHI,23,82,10,16,26
6,8482062,Cole Smith,L,NSH,29,82,10,16,26
6,8482141,Lukas Cormier,D,VGK,22,82,10,16,26
6,8477919,Frederick Gaudreau,C,MIN,31,82,9,17,26
6,8476873,Mark Jankowski,C,NSH,30,82,8,18,26
6,8477839,Conor Sheary,L,TBL,32,82,8,18,26
6,8475324,Nick Jensen,D,OTT,34,82,7,19,26
6,8477508,Curtis Lazar,C,NJD,29,82,7,19,26
6,8476931,Jake McCabe,D,TOR,31,82,5,21,26
6,8475231,Casey Cizikas,C,NYI,33,82,5,21,26
6,8476879,Cody Ceci,D,EDM,31,82,3,23,26
6,8480049,Dylan Samberg,D,WPG,25,82,1,25,26
6,8480073,Erik Brannstrom,D,COL,25,82,10,15,25
6,8475855,Jesper Fast,R,CAR,33,82,9,16,25
6,8480074,Alexandre Texier,C,STL,25,82,7,18,25
6,8477435,Ryan Graves,D,PIT,29,82,7,18,25
6,8483495,Simon Nemec,D,NJD,20,82,7,18,25
6,8482470,Ilya Solovyov,D,CGY,24,82,6,19,25
6,8476331,Dylan DeMelo,D,WPG,31,82,4,21,25
6,8475455,Brenden Dillon,D,NJD,34,82,3,22,25
6,8476960,Andreas Athanasiou,C,CHI,30,82,15,9,24
6,8474715,Cam Atkinson,R,TBL,35,82,15,9,24
6,8481601,Simon Holmstrom,R,NYI,23,82,14,10,24
6,8484145,Zach Benson,L,BUF,19,82,13,11,24
6,8480995,Pontus Holmberg,R,TOR,25,82,12,12,24
6,8479414,Nathan Bastian,R,NJD,27,82,12,12,24
6,8484911,Collin Graf,R,SJS,22,82,10,14,24
6,8476442,Matt Nieto,L,PIT,32,82,10,14,24
6,8483763,Maksymilian Szuber,D,UTA,22,82,9,15,24
6,8477406,Mattias Janmark,C,EDM,32,82,9,15,24
6,8475181,Nick Leddy,D,STL,33,82,3,21,24
6,8478840,Will Borgen,D,SEA,28,82,3,21,24
6,8481568,Alex Vlasic,D,CHI,23,82,3,21,24
6,8479369,Andrew Peeke,D,BOS,26,82,3,21,24
6,8482079,Marco Rossi,C,MIN,23,82,14,9,23
6,8477450,Jason Dickinson,C,CHI,29,82,14,9,23
6,8481028,Martin Pospisil,C,CGY,25,82,11,12,23
6,8482666,Scott Morrow,D,CAR,22,82,7,16,23
6,8477507,Nikita Zadorov,D,BOS,29,82,6,17,23
6,8481708,Zac Jones,D,NYR,24,82,5,18,23
6,8481606,Jordan Spence,D,LAK,23,82,5,18,23
6,8480980,Connor Dewar,C,TOR,25,82,4,19,23
6,8477499,Rasmus Ristolainen,D,PHI,30,82,4,19,23
6,8481178,Egor Zamula,D,PHI,24,82,4,19,23
6,8480807,Mattias Samuelsson,D,BUF,24,82,3,20,23
6,8480860,Kevin Bahl,D,CGY,24,82,3,20,23
6,8476967,Brett Kulak,D,EDM,30,82,3,20,23
6,8480035,Henri Jokiharju,D,BUF,25,82,1,22,23
6,8480855,Jack McBain,C,UTA,24,82,12,10,22
6,8478508,Yakov Trenin,C,MIN,27,82,11,11,22
6,8478013,Jake Walman,D,SJS,28,82,10,12,22
6,8480021,Jack Studnicka,C,LAK,25,82,9,13,22
6,8482087,Kaiden Guhle,D,MTL,22,82,6,16,22
6,8476467,Jamie Oleksiak,D,SEA,32,82,6,16,22
6,8477392,Hudson Fasching,R,NYI,29,82,5,17,22
6,8479998,Mikey Anderson,D,LAK,25,82,4,18,22
6,8477845,Trevor van Riemsdyk,D,WSH,33,82,4,18,22
6,8478859,Niko Mikkola,D,FLA,28,82,3,19,22
6,8480246,Nick Perbix,D,TBL,26,82,3,19,22
6,8482655,J.J. Moser,D,TBL,24,82,1,21,22
6,8481517,Brett Leason,R,ANA,25,82,12,9,21
6,8473533,Jordan Staal,C,CAR,36,82,11,10,21
6,8481093,Rafael Harvey-Pinard,L,MTL,25,82,10,11,21
6,8484203,Bradly Nadeau,L,CAR,19,82,8,13,21
6,8476372,Nick Seeler,D,PHI,31,82,8,13,21
6,8482807,Ethan Del Mastro,D,CHI,21,82,8,13,21
6,8479398,Samuel Girard,D,COL,26,82,5,16,21
6,8479983,Mario Ferraro,D,SJS,26,82,5,16,21
6,8476902,Esa Lindell,D,DAL,30,82,4,17,21
6,8474673,TJ Brodie,D,CHI,34,82,3,18,21
6,8482245,Artem Zub,D,OTT,29,82,2,19,21
6,8478851,Alexandre Carrier,D,NSH,28,82,2,19,21
6,8480222,Sebastian Aho,D,PIT,28,82,2,19,21
6,8478468,Jeremy Lauzon,D,NSH,27,82,2,19,21
6,8480879,Jacob Bernard-Docker,D,OTT,24,82,1,20,21
6,8476878,Zemgus Girgensons,L,TBL,30,82,14,6,20
6,8483397,Marc McLaughlin,C,BOS,25,82,13,7,20
6,8482259,Bobby McMann,C,TOR,28,82,12,8,20
6,8476822,Luke Glendening,C,TBL,35,82,11,9,20
6,8478569,Noel Acciari,C,PIT,33,82,9,11,20
6,8484153,Leo Carlsson,C,ANA,20,82,6,14,20
6,8483493,Frank Nazar,C,CHI,20,82,6,14,20
6,8480025,MacKenzie Entwistle,R,FLA,25,82,5,15,20
6,8475790,Erik Gudbranson,D,CBJ,32,82,2,18,20
6,8475188,Brayden McNabb,D,VGK,33,82,0,20,20
6,8482762,Simon Edvinsson,D,DET,21,82,10,9,19
6,8481522,Peyton Krebs,C,BUF,23,82,7,12,19
6,8482101,Danil Gushchin,L,SJS,22,82,7,12,19
6,8475279,Ben Chiarot,D,DET,33,82,6,13,19
6,8480172,Jan Rutta,D,SJS,34,82,6,13,19
6,8480796,Martin Fehervary,D,WSH,25,82,5,14,19
6,8474567,Zach Bogosian,D,MIN,34,82,5,14,19
6,8476891,Matt Grzelcyk,D,PIT,30,82,3,16,19
6,8475462,Radko Gudas,D,ANA,34,82,2,17,19
6,8477365,Connor Clifton,D,BUF,29,82,2,17,19
6,8473453,Trevor Lewis,C,LAK,37,82,11,7,18
6,8483468,Jiri Kulich,C,BUF,20,82,10,8,18
6,8480806,Isac Lundestrom,C,ANA,25,82,9,9,18
6,8483012,Logan Morrison,C,SEA,22,82,9,9,18
6,8482702,Logan Stankoven,C,DAL,21,82,8,10,18
6,8478432,Christian Fischer,R,DET,27,82,7,11,18
6,8481641,Joel Kiviranta,L,COL,28,82,7,11,18
6,8478178,Darren Raddysh,D,TBL,28,82,5,13,18
6,8483490,Pavel Mintyukov,D,ANA,21,82,3,15,18
6,8470600,Ryan Suter,D,STL,39,82,3,15,18
6,8477931,Tomas Nosek,L,FLA,32,82,1,17,18
6,8482155,Alex Laferriere,R,LAK,23,82,10,7,17
6,8482679,Matt Coronato,R,CGY,22,82,10,7,17
6,8477015,Connor Brown,R,EDM,30,82,8,9,17
6,8481477,Nico Sturm,C,SJS,29,82,6,11,17
6,8482809,Jackson Blake,R,CAR,21,82,5,12,17
6,8482073,Braden Schneider,D,NYR,23,82,4,13,17
6,8483445,Cutter Gauthier,L,ANA,20,82,4,13,17
6,8483565,Nick Blankenburg,D,NSH,26,82,3,14,17
6,8478450,Parker Wotherspoon,D,BOS,27,82,3,14,17
6,8477903,Garnet Hathaway,R,PHI,33,82,10,6,16
6,8476889,Radek Faksa,C,STL,30,82,8,8,16
6,8483567,Georgii Merkulov,C,BOS,24,82,8,8,16
6,8482166,Shakir Mukhamadullin,D,SJS,22,82,4,12,16
6,8475690,Chris Tanev,D,TOR,35,82,4,12,16
6,8482733,Logan Mailloux,D,MTL,31,82,3,13,16
6,8483460,David Jiricek,D,CBJ,21,82,3,13,16
6,8476473,Connor Murphy,D,CHI,31,82,1,15,16
6,8475233,David Savard,D,MTL,34,82,0,16,16
6,8475718,Justin Holl,D,DET,32,82,0,16,16
6,8482712,Oskar Olausson,R,COL,22,82,8,7,15
6,8481524,Bowen Byram,D,BUF,23,82,6,9,15
6,8480870,Bo Groulx,C,NYR,24,82,6,9,15
6,8475762,Derek Forbort,D,VAN,32,82,5,10,15
6,8482153,Brendan Brisson,C,VGK,23,82,5,10,15
6,8480834,Ty Emberson,D,SJS,24,82,5,10,15
6,8483499,Liam Ohgren,L,MIN,20,82,3,12,15
6,8481605,Jackson LaCombe,D,ANA,23,82,3,12,15
6,8482803,Olen Zellweger,D,ANA,21,82,1,14,15
6,8479359,Beck Malenstyn,L,BUF,26,82,8,6,14
6,8483524,Shane Wright,C,SEA,20,82,8,6,14
6,8483482,Tristan Luneau,D,ANA,20,82,4,10,14
6,8480990,Declan Chisholm,D,MIN,24,82,4,10,14
6,8479442,Troy Stecher,D,EDM,30,82,4,10,14
6,8478416,Erik Cernak,D,TBL,27,82,2,12,14
6,8482659,Josh Doan,R,UTA,22,82,6,7,13
6,8478443,Brandon Carlo,D,BOS,28,82,4,9,13
6,8482516,Matthew Kessel,D,STL,24,82,4,9,13
6,8482145,Mavrik Bourque,C,DAL,22,82,4,9,13
6,8481122,Simon Benoit,D,TOR,26,82,2,11,13
6,8481699,Aku Raty,R,UTA,23,82,8,4,12
6,8483505,Matthew Poitras,C,BOS,20,82,6,6,12
6,8475177,Calvin de Haan,D,COL,33,82,3,9,12
6,8480950,Ilya Lyubushkin,D,DAL,30,82,1,11,12
6,8479638,Justin Brazeau,R,BOS,26,82,6,5,11
6,8482713,Mackie Samoskevich,R,FLA,22,82,6,5,11
6,8477938,Haydn Fleury,D,WPG,28,82,6,5,11
6,8482749,Joshua Roy,R,MTL,21,82,4,7,11
6,8477034,Jaycob Megna,D,FLA,32,82,3,8,11
6,8474090,Brendan Smith,D,DAL,35,82,3,8,11
6,8478136,Jake Middleton,D,MIN,28,82,2,9,11
6,8476441,Joel Edmundson,D,LAK,31,82,1,10,11
6,8478874,Adam Gaudette,C,OTT,28,82,1,10,11
6,8479291,Kevin Rooney,C,CGY,31,82,6,4,10
6,8482858,Ryker Evans,D,SEA,23,82,4,6,10
6,8482787,Nikita Chibrikov,R,WPG,31,82,4,6,10
6,8474612,Travis Hamonic,D,OTT,34,82,2,8,10
6,8471677,Jack Johnson,D,CBJ,37,82,1,9,10
6,8482859,Zack Ostapchuk,C,OTT,21,82,5,4,9
6,8474062,Riley Nash,C,NYR,35,82,2,7,9
6,8482118,Sam Colangelo,R,ANA,23,82,1,8,9
6,8477335,Kyle Burroughs,D,LAK,29,82,3,5,8
6,8483466,Kevin Korchinski,D,CHI,20,82,2,6,8
6,8483489,Fraser Minten,C,TOR,31,82,5,2,7
6,8479576,Vincent Desharnais,D,VAN,28,82,1,6,7
6,8482070,Mitchell Chaffee,R,TBL,26,82,3,3,6
6,8483471,Brad Lambert,C,WPG,31,82,1,5,6
6,8470794,Joe Pavelski,C,,40,0,0,0,0
6,8481703,Valtteri Puustinen,R,PIT,25,0,0,0,0
6,8477950,Tony DeAngelo,D,,29,0,0,0,0
6,8481577,Philip Tomasino,C,NSH,23,0,0,0,0
6,8475197,Tyson Barrie,D,,33,0,0,0,0
6,8471218,Blake Wheeler,R,,38,0,0,0,0
6,8474157,Max Pacioretty,L,,36,0,0,0,0
6,8478466,Daniel Sprong,R,VAN,27,0,0,0,0
6,8475744,Evgeny Kuznetsov,C,,32,0,0,0,0
6,8481019,David Gustafsson,C,WPG,24,0,0,0,0
6,8475906,John Klingberg,D,,32,0,0,0,0
6,8479348,Kale Clague,D,BUF,26,0,0,0,0
6,8476952,Dominic Toninato,C,WPG,30,0,0,0,0
6,8473473,Milan Lucic,L,,36,0,0,0,0
6,8474037,James van Riemsdyk,L,,35,0,0,0,0
6,8474602,Justin Schultz,D,,34,0,0,0,0
6,8482222,Alexander Barabanov,L,,30,0,0,0,0
6,8479372,Josh Mahura,D,SEA,26,0,0,0,0
6,8479982,Conor Timmins,D,TOR,26,0,0,0,0
6,8474031,Kevin Shattenkirk,D,,35,0,0,0,0
6,8480008,Adam Ruzicka,C,,25,0,0,0,0
6,8481059,Scott Perunovich,D,STL,26,0,0,0,0
6,8480884,Calen Addison,D,,24,0,0,0,0
6,8476994,Vinnie Hinostroza,C,NSH,30,0,0,0,0
6,8478452,Caleb Jones,D,LAK,27,0,0,0,0
6,8480157,Calle Rosen,D,COL,30,0,0,0,0
6,8481609,Vladislav Kolyachonok,D,UTA,23,0,0,0,0
6,8479415,Michael McLeod,C,,26,0,0,0,0
6,8476919,Chris Tierney,C,,30,0,0,0,0
6,8479639,Dylan Coghlan,D,WPG,26,0,0,0,0
6,8478146,Matthew Highmore,C,OTT,28,0,0,0,0
6,8478970,Jalen Chatfield,D,CAR,28,0,0,0,0
6,8480205,Emil Bemstrom,C,PIT,25,0,0,0,0
6,8474884,Mike Hoffman,C,,35,0,0,0,0
6,8471274,Alex Goligoski,D,,39,0,0,0,0
6,8478104,Sammy Blais,L,,28,0,0,0,0
6,8474870,Tyler Johnson,C,,34,0,0,0,0
6,8476913,Devin Shore,C,MIN,30,0,0,0,0
6,8481598,Philip Broberg,D,EDM,23,0,0,0,0
6,8480058,Pierre-Olivier Joseph,D,STL,25,0,0,0,0
6,8480891,Michael Kesselring,D,UTA,24,0,0,0,0
6,8477979,Nicolas Aube-Kubel,R,BUF,28,0,0,0,0
6,8476871,Tanner Pearson,L,,32,0,0,0,0
6,8476393,Nick Cousins,C,,31,0,0,0,0
6,8479977,Kailer Yamamoto,R,,26,0,0,0,0
6,8479543,Michael Pezzetta,L,MTL,26,0,0,0,0
6,8477018,Ben Hutton,D,VGK,31,0,0,0,0
6,8480762,Eric Robinson,L,CAR,29,0,0,0,0
6,8474034,Pat Maroon,L,CHI,36,0,0,0,0
6,8481058,Jesse Ylönen,R,,25,0,0,0,0
6,8475179,Dmitry Kulikov,D,FLA,34,0,0,0,0
6,8481527,Kaedan Korczak,D,VGK,23,0,0,0,0
6,8473449,Kyle Okposo,R,,36,0,0,0,0
6,8482192,Isaak Phillips,D,CHI,23,0,0,0,0
6,8480727,Zach Whitecloud,D,VGK,28,0,0,0,0
6,8479346,Dillon Dube,C,,26,0,0,0,0
6,8480821,Filip Zadina,R,,25,0,0,0,0
6,8480001,Urho Vaakanainen,D,ANA,25,0,0,0,0
6,8470966,Mark Giordano,D,,41,0,0,0,0
6,8480853,Liam Foudy,C,,24,0,0,0,0
6,8475225,Craig Smith,C,CHI,35,0,0,0,0
6,8479972,Mason Shaw,C,WPG,26,0,0,0,0
6,8478451,Ethan Bear,D,WSH,27,0,0,0,0
6,8474040,Sam Gagner,C,,35,0,0,0,0
6,8480196,Jacob Bryson,D,BUF,27,0,0,0,0
6,8479984,Cal Foote,D,,26,0,0,0,0
6,8480011,Klim Kostin,C,SJS,25,0,0,0,0
6,8482176,Wyatt Kaiser,D,CHI,22,0,0,0,0
6,8476988,Matt Benning,D,SJS,30,0,0,0,0
6,8479370,Tyson Jost,C,CAR,26,0,0,0,0
6,8477464,Nic Petan,C,,29,0,0,0,0
6,8477380,Jonny Brodzinski,C,NYR,31,0,0,0,0
6,8480070,Ian Mitchell,D,BOS,25,0,0,0,0
6,8479315,Joey Anderson,R,CHI,26,0,0,0,0
6,8478099,Kevin Labanc,R,,29,0,0,0,0
6,8476874,Olli Maatta,D,DET,30,0,0,0,0
6,8475208,Brian Dumoulin,D,ANA,33,0,0,0,0
6,8478430,Oliver Kylington,D,,27,0,0,0,0
6,8479536,Axel Jonsson-Fjallby,L,WPG,26,0,0,0,0
6,8479671,Mathieu Olivier,R,CBJ,27,0,0,0,0
6,8471709,Marc-Edouard Vlasic,D,SJS,37,0,0,0,0
6,8479328,Julien Gauthier,R,NYI,27,0,0,0,0
6,8478421,A.J. Greer,L,FLA,28,0,0,0,0
6,8477573,Nathan Walker,L,STL,30,0,0,0,0
6,8481537,Nikita Okhotiuk,D,CGY,24,0,0,0,0
6,8474166,Alec Martinez,D,CHI,37,0,0,0,0
6,8470610,Zach Parise,L,,40,0,0,0,0
6,8477478,William Carrier,L,CAR,30,0,0,0,0
6,8479344,Jesse Puljujarvi,R,PIT,26,0,0,0,0
6,8480887,Jordan Harris,D,MTL,24,0,0,0,0
6,8478502,Dennis Gilbert,D,BUF,28,0,0,0,0
6,8482730,Brandt Clarke,D,LAK,21,0,0,0,0
6,8480355,Mark Kastelic,C,BOS,25,0,0,0,0
6,8475750,Jon Merrill,D,MIN,32,0,0,0,0
6,8475164,Jakob Silfverberg,R,,34,0,0,0,0
6,8477944,Jakub Vrana,L,,28,0,0,0,0
6,8479439,Jacob MacDonald,D,COL,31,0,0,0,0
6,8474568,Luke Schenn,D,NSH,35,0,0,0,0
6,8478454,Noah Juulsen,D,VAN,27,0,0,0,0
6,8475752,Tyler Pitlick,C,,33,0,0,0,0
6,8482148,Hendrix Lapierre,C,WSH,22,0,0,0,0
6,8481167,Brayden Pachal,D,CGY,25,0,0,0,0
6,8478043,Sam Lafferty,C,BUF,29,0,0,0,0
6,8479321,Lucas Johansen,D,,27,0,0,0,0
6,8471699,Andrew Cogliano,C,,37,0,0,0,0
6,8481521,Ronnie Attard,D,PHI,25,0,0,0,0
6,8481161,Jake Christiansen,D,CBJ,25,0,0,0,0
6,8479458,Nikita Zaitsev,D,,33,0,0,0,0
6,8479619,Michael Carcone,L,UTA,28,0,0,0,0
6,8479026,Philippe Myers,D,TOR,27,0,0,0,0
6,8477330,Dominik Kubalik,L,,29,0,0,0,0
6,8481617,Vasily Podkolzin,R,VAN,23,0,0,0,0
6,8481701,Santeri Hatakka,D,NJD,23,0,0,0,0
6,8479514,Rem Pitlick,C,,27,0,0,0,0
6,8477446,Michael McCarron,R,NSH,29,0,0,0,0
6,8470604,Jeff Carter,C,,39,0,0,0,0
6,8482241,Radim Zohorna,L,,28,0,0,0,0
6,8480289,Morgan Barron,C,WPG,26,0,0,0,0
6,8479379,Givani Smith,R,SJS,26,0,0,0,0
6,8480216,Jacob Peterson,C,,25,0,0,0,0
6,8477851,Jordan Oesterle,D,BOS,32,0,0,0,0
6,8484258,Sam Malinski,D,COL,26,0,0,0,0
6,8478904,Steven Lorentz,C,,28,0,0,0,0
6,8482095,Tyler Kleven,D,OTT,22,0,0,0,0
6,8480848,Ty Dellandrea,C,SJS,24,0,0,0,0
6,8476884,Derrick Pouliot,D,,30,0,0,0,0
6,8479336,Carl Grundstrom,R,SJS,27,0,0,0,0
6,8482964,Arber Xhekaj,D,MTL,23,0,0,0,0
6,8471686,Marc Staal,D,,37,0,0,0,0
6,8477887,Patrick Brown,C,BOS,32,0,0,0,0
6,8478495,Denis Gurianov,R,,27,0,0,0,0
6,8473504,Cal Clutterbuck,R,,37,0,0,0,0
6,8481550,Adam Beckman,L,NJD,23,0,0,0,0
6,8480845,Rasmus Kupari,C,WPG,24,0,0,0,0
6,8474009,Nick Bonino,C,,36,0,0,0,0
6,8478585,Derek Ryan,C,EDM,38,0,0,0,0
6,8477962,Brendan Lemieux,L,CAR,28,0,0,0,0
6,8482861,Vincent Iorio,D,WSH,22,0,0,0,0
6,8479378,Logan Stanley,D,WPG,26,0,0,0,0
6,8473446,Erik Johnson,D,PHI,36,0,0,0,0
6,8481743,Marc Del Gaizo,D,NSH,25,0,0,0,0
6,8477384,Josh Brown,D,EDM,30,0,0,0,0
6,8482165,Yan Kuznetsov,D,CGY,22,0,0,0,0
6,8478424,Jansen Harkins,C,ANA,27,0,0,0,0
6,8482144,Jack Thompson,D,SJS,22,0,0,0,0
6,8478512,Austin Czarnik,C,,32,0,0,0,0
6,8477527,Ross Johnston,L,ANA,30,0,0,0,0
6,8479383,Boris Katchouk,L,,26,0,0,0,0
6,8482094,Daemon Hunt,D,MIN,22,0,0,0,0
6,8481719,Maxwell Crozier,D,TBL,24,0,0,0,0
6,8480192,Johnathan Kovacevic,D,NJD,27,0,0,0,0
6,8479376,Victor Mete,D,,26,0,0,0,0
6,8482511,Mason Lohrei,D,BOS,23,0,0,0,0
6,8475825,Jani Hakanpää,D,,32,0,0,0,0
6,8478021,William Lagesson,D,DET,28,0,0,0,0
6,8475795,Dylan McIlrath,D,WSH,32,0,0,0,0
6,8477846,Ryan Carpenter,C,,33,0,0,0,0
6,8481056,Spencer Stastney,D,NSH,24,0,0,0,0
6,8481564,Ryan Johnson,D,BUF,23,0,0,0,0
6,8478017,Mark Friedman,D,VAN,29,0,0,0,0
6,8479320,Max Lajoie,D,SEA,27,0,0,0,0
6,8480075,Cameron Crotty,D,MIN,25,0,0,0,0
6,8484287,Cole McWard,D,VAN,23,0,0,0,0
6,8484254,Akito Hirose,D,VAN,25,0,0,0,0
6,8483407,Brandon Scanlin,D,NYR,25,0,0,0,0
6,8480274,Philip Kemp,D,EDM,25,0,0,0,0
6,8479522,Hardy Haman Aktell,D,WSH,26,0,0,0,0
6,8480007,Jonas Rondbjerg,R,VGK,25,0,0,0,0
6,8477454,Adam Erne,L,,29,0,0,0,0
6,8481679,Maxence Guenette,D,OTT,23,0,0,0,0
6,8480441,Trey Fix-Wolansky,R,CBJ,25,0,0,0,0
6,8483546,Marshall Rifai,D,TOR,26,0,0,0,0
6,8480084,Nick DeSimone,D,NJD,30,0,0,0,0
6,8481030,Jack St. Ivany,D,PIT,25,0,0,0,0
6,8481592,Jakob Pelletier,L,CGY,23,0,0,0,0
6,8478011,Louie Belpedio,D,PHI,28,0,0,0,0
6,8477930,Pierre-Edouard Bellemare,L,,39,0,0,0,0
6,8484321,Nikolas Matinpalo,D,OTT,26,0,0,0,0
6,8482067,Connor Mackey,D,NYR,28,0,0,0,0
6,8481806,Louis Crevier,D,CHI,23,0,0,0,0
6,8484326,Patrik Koch,D,UTA,28,0,0,0,0
6,8477971,Andreas Englund,D,LAK,28,0,0,0,0
6,8481751,Lukas Rousek,R,BUF,25,0,0,0,0
6,8481006,Tyler Tucker,D,STL,24,0,0,0,0
6,8476867,Brendan Gaunce,C,MIN,30,0,0,0,0
6,8479520,Brandon Duhaime,R,WSH,27,0,0,0,0
6,8477073,Kurtis MacDermid,L,NJD,30,0,0,0,0
6,8480874,Adam Ginning,D,PHI,24,0,0,0,0
6,8477473,Justin Bailey,R,SJS,29,0,0,0,0
6,8479066,Ryan Lomberg,L,CGY,30,0,0,0,0
6,8477070,Liam O'Brien,C,UTA,30,0,0,0,0
6,8474618,Marco Scandella,D,,34,0,0,0,0
6,8475797,Jarred Tinordi,D,,32,0,0,0,0
6,8481441,Joe Snively,C,DET,28,0,0,0,0
6,8477244,Chad Ruhwedel,D,NYR,34,0,0,0,0
6,8479772,Zack MacEwen,R,OTT,28,0,0,0,0
6,8481147,Reese Johnson,C,MIN,26,0,0,0,0
6,8481043,Cole Koepke,L,BOS,26,0,0,0,0
6,8483619,Filip Roos,D,OTT,25,0,0,0,0
6,8481541,Samuel Bolduc,D,NYI,24,0,0,0,0
6,8477810,Joel Hanley,D,CGY,33,0,0,0,0
6,8476907,Mackenzie MacEachern,L,,30,0,0,0,0
6,8482652,Walker Duehr,R,CGY,27,0,0,0,0
6,8477126,Jayson Megna,C,,34,0,0,0,0
6,8483398,Declan Carlile,D,TBL,31,0,0,0,0
6,8482929,Emil Lilleberg,D,TBL,23,0,0,0,0
6,8480880,Jakub Lauko,C,MIN,24,0,0,0,0
6,8480245,Olle Lycksell,R,PHI,25,0,0,0,0
6,8480252,Cole Guttman,C,CHI,25,0,0,0,0
6,8477467,Gustav Olofsson,D,SEA,30,0,0,0,0
6,8479968,Vinni Lettieri,C,BOS,29,0,0,0,0
6,8478400,Colin White,C,,27,0,0,0,0
6,8475755,Alexander Petrovic,D,DAL,32,0,0,0,0
6,8481812,Nikolai Knyzhov,D,,27,0,0,0,0
6,8481593,Jayden Struble,D,MTL,23,0,0,0,0
6,8481532,Alex Turcotte,C,LAK,23,0,0,0,0
6,8482126,Emil Andrae,D,PHI,31,0,0,0,0
6,8479944,Zach Aston-Reese,C,VGK,30,0,0,0,0
6,8471817,Ryan Reaves,R,TOR,37,0,0,0,0
6,8481206,John Ludvig,D,PIT,24,0,0,0,0
6,8481599,Victor Soderstrom,D,UTA,23,0,0,0,0
6,8480292,Carson Meyer,R,ANA,27,0,0,0,0
6,8482496,Nils Aman,C,VAN,24,0,0,0,0
6,8479718,Alex Barré-Boulet,C,MTL,27,0,0,0,0
6,8479994,Jaret Anderson-Dolan,C,WPG,25,0,0,0,0
6,8480184,Gustav Lindstrom,D,,26,0,0,0,0
6,8480890,Jan Jenik,R,OTT,24,0,0,0,0
6,8478067,Oskar Lindblom,L,,28,0,0,0,0
6,8476934,Brock McGinn,L,ANA,30,0,0,0,0
6,8479985,Cale Fleury,D,SEA,26,0,0,0,0
6,8484304,Uvis Balinskis,D,FLA,28,0,0,0,0
6,8479981,Jonah Gadjovich,L,FLA,26,0,0,0,0
6,8481716,Dmitri Voronkov,L,CBJ,24,0,0,0,0
6,8474709,Matt Martin,L,,35,0,0,0,0
6,8482634,Alex Steeves,C,TOR,25,0,0,0,0
6,8480823,Alexander Alexeyev,D,WSH,25,0,0,0,0
6,8477541,Dakota Mermis,D,TOR,30,0,0,0,0
6,8483491,Ivan Miroshnichenko,L,WSH,20,0,0,0,0
6,8478477,Mitchell Stephens,C,SEA,27,0,0,0,0
6,8481543,Nikita Alexandrov,C,STL,24,0,0,0,0
6,8479423,Alex Nylander,L,,26,0,0,0,0
6,8482451,Mikael Pyyhtia,L,CBJ,23,0,0,0,0
6,8478831,Kevin Stenlund,C,UTA,28,0,0,0,0
6,8480306,Grant Hutton,D,NYI,29,0,0,0,0
6,8478028,Fredrik Olofsson,L,,28,0,0,0,0
6,8477462,Robert Hagg,D,VGK,29,0,0,0,0
6,8477320,Anton Blidh,L,NYR,29,0,0,0,0
6,8482157,Will Cuylle,L,NYR,22,0,0,0,0
6,8482737,Zack Bolduc,C,STL,21,0,0,0,0
6,8481239,Samuel Fagemo,L,,24,0,0,0,0
6,8481600,Tobias Bjornfot,D,FLA,23,0,0,0,0
6,8478409,Anthony Richard,C,PHI,28,0,0,0,0
6,8474145,Robert Bortuzzo,D,,35,0,0,0,0
6,8475958,Michael Sgarbossa,C,WSH,32,0,0,0,0
6,8479986,Kole Lind,R,DAL,26,0,0,0,0
6,8479249,Andrew Poturalski,C,SJS,30,0,0,0,0
6,8479362,Riley Tufte,L,BOS,26,0,0,0,0
6,8479991,Jake Leschyshyn,C,NYR,25,0,0,0,0
6,8479587,Rhett Gardner,C,PHI,28,0,0,0,0
6,8482744,James Malatesta,L,CBJ,21,0,0,0,0
6,8478854,Ryan Shea,D,PIT,27,0,0,0,0
6,8481591,Sam Poulin,R,,23,0,0,0,0
6,8483512,Matt Savoie,C,EDM,20,0,0,0,0
6,8482102,Vasily Ponomarev,C,PIT,22,0,0,0,0
6,8482162,Roby Jarventie,L,EDM,22,0,0,0,0
6,8481016,Ruslan Iskhakov,C,,24,0,0,0,0
6,8482172,Landon Slaggert,L,CHI,22,0,0,0,0
6,8482747,Brennan Othmann,L,NYR,21,0,0,0,0
6,8480031,Maxime Comtois,L,,25,0,0,0,0
6,8480226,Marián Studenic,R,,26,0,0,0,0
6,8478408,Travis Dermott,D,,28,0,0,0,0
6,8481518,Nolan Foote,L,NJD,24,0,0,0,0
6,8479419,Brett Murray,L,BUF,26,0,0,0,0
6,8482088,Justin Sourdif,R,FLA,22,0,0,0,0
6,8482201,Gage Goncalves,C,TBL,23,0,0,0,0
6,8481578,Graeme Clarke,R,MIN,23,0,0,0,0
6,8482177,Marat Khusnutdinov,C,MIN,22,0,0,0,0
6,8481754,Nikita Nesterenko,C,ANA,23,0,0,0,0
6,8483531,Brian Halonen,L,NJD,25,0,0,0,0
6,8483920,Pierrick Dube,R,WSH,23,0,0,0,0
6,8480851,Akil Thomas,C,LAK,24,0,0,0,0
6,8475235,Nicolas Deslauriers,L,PHI,33,0,0,0,0
6,8482476,Emil Heineman,L,MTL,23,0,0,0,0
6,8477149,Scott Sabourin,R,SJS,32,0,0,0,0
6,8483549,Lucas Condotta,L,MTL,27,0,0,0,0
6,8482765,Isak Rosen,R,BUF,21,0,0,0,0
6,8481237,Kyle MacLean,C,NYI,25,0,0,0,0
6,8481024,Linus Karlsson,C,VAN,25,0,0,0,0
6,8481690,Tyler Angle,C,,24,0,0,0,0
6,8483570,Ben Meyers,C,SEA,26,0,0,0,0
6,8481655,Cole Schwindt,R,CGY,23,0,0,0,0
6,8481462,Mason Morelli,L,VGK,28,0,0,0,0
6,8483401,Marc Johnstone,R,PIT,28,0,0,0,0
6,8478956,Samuel Laberge,L,NJD,27,0,0,0,0
6,8479533,Joona Koppanen,L,,26,0,0,0,0
6,8482197,Adam Raska,R,MIN,23,0,0,0,0
6,8482250,Callahan Burke,C,VGK,27,0,0,0,0
6,8482784,Zach Dean,C,STL,21,0,0,0,0
6,8484255,Jason Polin,R,COL,25,0,0,0,0
6,8481077,John Leonard,L,,26,0,0,0,0
6,8481534,Raphael Lavoie,C,EDM,24,0,0,0,0
6,8483609,Adam Klapka,R,CGY,24,0,0,0,0
6,8482751,Ryan Winterton,C,SEA,21,0,0,0,0
6,8480267,Sammy Walker,C,MIN,25,0,0,0,0
6,8475766,Austin Watson,L,,32,0,0,0,0
6,8482460,Matt Rempe,C,NYR,22,0,0,0,0
6,8481065,Angus Crookshank,L,OTT,25,0,0,0,0
6,8481070,Hugh McGing,L,,26,0,0,0,0
6,8476323,Max McCormick,L,SEA,32,0,0,0,0
6,8483395,Arshdeep Bains,L,VAN,23,0,0,0,0
6,8484259,Ondrej Pavel,C,COL,31,0,0,0,0
6,8483432,Luca Del Bel Belluz,C,CBJ,31,0,0,0,0
6,8483045,Cameron Butler,R,CBJ,31,0,0,0,0
6,8482061,Brandon Biro,L,SEA,26,0,0,0,0
6,8477401,John Hayden,C,SEA,29,0,0,0,0
6,8475278,Byron Froese,C,,33,0,0,0,0
6,8478446,Glenn Gawdin,C,LAK,27,0,0,0,0
6,8477993,Justin Kirkland,C,CGY,28,0,0,0,0
6,8482147,Jean-Luc Foudy,C,COL,22,0,0,0,0
6,8480032,Shane Bowers,C,NJD,25,0,0,0,0
6,8479330,Brandon Gignac,C,MTL,27,0,0,0,0
6,8480776,Sheldon Rempal,R,,29,0,0,0,0
6,8475413,Justin Dowling,C,NJD,34,0,0,0,0
6,8481726,Adam Edstrom,C,NYR,24,0,0,0,0
6,8480844,Grigori Denisenko,L,VGK,24,0,0,0,0
6,8478147,Bokondji Imama,L,PIT,28,0,0,0,0
6,8478881,Brett Seney,L,CHI,28,0,0,0,0
6,8483630,Pavol Regenda,L,ANA,25,0,0,0,0
6,8480836,Jonathan Gruden,C,,24,0,0,0,0
6,8484314,Jiri Smejkal,L,,28,0,0,0,0
6,8475780,Chris Wagner,R,COL,33,0,0,0,0
6,8479546,Oskar Steen,C,,26,0,0,0,0
6,8483597,Milos Kelemen,L,UTA,25,0,0,0,0
6,8481789,Tye Kartye,L,SEA,23,0,0,0,0
6,8484325,Waltteri Merela,C,TBL,26,0,0,0,0
6,8479421,Jacob Moverare,D,LAK,26,0,0,0,0
6,8481585,Egor Afanasyev,L,SJS,23,0,0,0,0
6,8479547,Matthew Phillips,R,,26,0,0,0,0
6,8479367,William Lockwood,R,FLA,26,0,0,0,0
6,8476915,Jujhar Khaira,L,,30,0,0,0,0
6,8481422,Jacob Lucchini,C,NSH,29,0,0,0,0
6,8480468,James Hamblin,L,EDM,25,0,0,0,0
6,8478051,Max Willman,C,NJD,29,0,0,0,0
6,8481556,John Beecher,C,BOS,23,0,0,0,0
6,8478078,Rourke Chartier,C,,28,0,0,0,0
7,8478402,Connor McDavid,C,EDM,27,82,45,109,154
7,8477492,Nathan MacKinnon,C,COL,29,82,57,87,144
7,8476453,Nikita Kucherov,R,TBL,31,82,29,104,133
7,8481559,Jack Hughes,C,NJD,23,82,48,79,127
7,8471675,Sidney Crosby,C,PIT,37,82,45,76,121
7,8479318,Auston Matthews,C,TOR,27,82,69,51,120
7,8478420,Mikko Rantanen,R,COL,28,82,56,59,115
7,8477934,Leon Draisaitl,C,EDM,29,82,48,67,115
7,8478864,Kirill Kaprizov,L,MIN,27,82,52,59,111
7,8478550,Artemi Panarin,L,NYR,33,82,42,67,109
7,8476887,Filip Forsberg,L,NSH,30,82,47,60,107
7,8477493,Aleksander Barkov,C,FLA,29,82,29,76,105
7,8477956,David Pastrnak,R,BOS,28,82,46,58,104
7,8477946,Dylan Larkin,C,DET,28,82,44,60,104
7,8480069,Cale Makar,D,COL,26,82,36,67,103
7,8479314,Matthew Tkachuk,L,FLA,27,82,33,66,99
7,8477939,William Nylander,R,TOR,28,82,38,60,98
7,8480002,Nico Hischier,C,NJD,25,82,40,55,95
7,8478398,Kyle Connor,L,WPG,28,82,36,58,94
7,8478427,Sebastian Aho,C,CAR,27,82,44,49,93
7,8474564,Steven Stamkos,C,NSH,34,82,43,50,93
7,8475166,John Tavares,C,TOR,34,82,41,52,93
7,8478010,Brayden Point,C,TBL,28,82,47,45,92
7,8476468,J.T. Miller,C,VAN,31,82,30,60,90
7,8480012,Elias Pettersson,C,VAN,26,82,29,61,90
7,8476389,Vincent Trocheck,C,NYR,31,82,29,59,88
7,8477402,Pavel Buchnevich,L,STL,29,82,39,48,87
7,8480036,Miro Heiskanen,D,DAL,25,82,17,70,87
7,8473419,Brad Marchand,L,BOS,36,82,37,49,86
7,8478403,Jack Eichel,C,VGK,28,82,37,49,86
7,8474600,Roman Josi,D,NSH,34,82,21,65,86
7,8480801,Brady Tkachuk,L,OTT,25,82,38,47,85
7,8478444,Brock Boeser,R,VAN,27,82,34,50,84
7,8479407,Jesper Bratt,L,NJD,26,82,32,52,84
7,8477942,Kevin Fiala,L,LAK,28,82,29,54,83
7,8480023,Robert Thomas,C,STL,25,82,24,59,83
7,8475810,Bryan Rust,R,PIT,32,82,43,39,82
7,8482078,Lucas Raymond,L,DET,22,82,24,58,82
7,8475692,Mats Zuccarello,R,MIN,37,82,21,61,82
7,8479385,Jordan Kyrou,C,STL,26,82,37,44,81
7,8477404,Jake Guentzel,C,TBL,30,82,36,45,81
7,8479325,Charlie McAvoy,D,BOS,27,82,14,67,81
7,8480800,Quinn Hughes,D,VAN,25,82,12,68,80
7,8477933,Sam Reinhart,C,FLA,29,82,42,37,79
7,8477960,Adrian Kempe,R,LAK,28,82,39,40,79
7,8471215,Evgeni Malkin,C,PIT,38,82,33,46,79
7,8482116,Tim Stützle,C,OTT,22,82,30,49,79
7,8478445,Mathew Barzal,C,NYI,27,82,17,62,79
7,8475167,Victor Hedman,D,TBL,34,82,22,56,78
7,8476454,Ryan Nugent-Hopkins,C,EDM,31,82,20,58,78
7,8481523,Kirby Dach,C,MTL,23,82,11,67,78
7,8479420,Tage Thompson,C,BUF,27,82,39,38,77
7,8477501,Valeri Nichushkin,R,COL,29,82,33,44,77
7,8480027,Jason Robertson,L,DAL,25,82,29,48,77
7,8475172,Nazem Kadri,C,CGY,34,82,25,52,77
7,8479343,Clayton Keller,R,UTA,26,82,37,39,76
7,8476539,Jonathan Marchessault,R,NSH,34,82,32,44,76
7,8481557,Matt Boldy,L,MIN,23,82,32,43,75
7,8477940,Nikolaj Ehlers,L,WPG,28,82,32,43,75
7,8474141,Patrick Kane,R,DET,36,82,20,55,75
7,8476853,Morgan Rielly,D,TOR,30,82,10,65,75
7,8476459,Mika Zibanejad,C,NYR,31,82,31,43,74
7,8477409,Carter Verhaeghe,C,FLA,29,82,43,30,73
7,8478493,Joel Eriksson Ek,C,MIN,27,82,34,39,73
7,8476460,Mark Scheifele,C,WPG,31,82,33,40,73
7,8477951,Nick Schmaltz,C,UTA,28,82,29,44,73
7,8474679,Gustav Nyquist,C,NSH,35,82,29,44,73
7,8480208,Drake Batherson,R,OTT,26,82,28,45,73
7,8473512,Claude Giroux,R,OTT,36,82,22,51,73
7,8477447,Shea Theodore,D,VGK,29,82,16,57,73
7,8482093,Seth Jarvis,C,CAR,22,82,33,39,72
7,8473994,Jamie Benn,L,DAL,35,82,33,39,72
7,8475184,Chris Kreider,L,NYR,33,82,40,31,71
7,8478047,Michael Bunting,L,PIT,29,82,29,42,71
7,8479323,Adam Fox,D,NYR,26,82,21,50,71
7,8475798,Mikael Granlund,C,SJS,32,82,17,54,71
7,8475786,Zach Hyman,L,EDM,32,82,34,36,70
7,8480039,Martin Necas,C,CAR,25,82,28,42,70
7,8477500,Bo Horvat,C,NYI,29,82,38,31,69
7,8475754,Brock Nelson,C,NYI,33,82,33,36,69
7,8475765,Vladimir Tarasenko,R,DET,33,82,32,37,69
7,8476881,Tomas Hertl,C,VGK,31,82,29,40,69
7,8477949,Alex Tuch,R,BUF,28,82,25,44,69
7,8475913,Mark Stone,R,VGK,32,82,30,38,68
7,8478438,Tommy Novak,C,NSH,27,82,24,44,68
7,8474578,Erik Karlsson,D,PIT,34,82,9,59,68
7,8479542,Brandon Hagel,L,TBL,26,82,35,32,67
7,8479337,Alex DeBrincat,R,DET,27,82,33,34,67
7,8478449,Roope Hintz,C,DAL,28,82,33,34,67
7,8471685,Anze Kopitar,C,LAK,37,82,31,36,67
7,8471724,Kris Letang,D,PIT,37,82,16,51,67
7,8471214,Alex Ovechkin,L,WSH,39,82,40,26,66
7,8478439,Travis Konecny,R,PHI,27,82,28,38,66
7,8481533,Trevor Zegras,C,ANA,23,82,20,46,66
7,8480014,Gabriel Vilardi,C,WPG,25,82,33,32,65
7,8475168,Matt Duchene,C,DAL,33,82,30,35,65
7,8480839,Rasmus Dahlin,D,BUF,24,82,19,46,65
7,8477504,Josh Morrissey,D,WPG,29,82,14,51,65
7,8480865,Noah Dobson,D,NYI,24,82,12,53,65
7,8478401,Pavel Zacha,C,BOS,27,82,29,35,64
7,8481711,Matias Maccelli,L,UTA,24,82,21,43,64
7,8475158,Ryan O'Reilly,C,NSH,33,82,19,45,64
7,8478407,Vince Dunn,D,SEA,28,82,15,49,64
7,8476346,Johnny Gaudreau,L,CBJ,31,82,13,51,64
7,8477955,Jared McCann,L,SEA,28,82,33,30,63
7,8476448,William Karlsson,C,VGK,31,82,31,32,63
7,8475784,Jeff Skinner,C,EDM,32,82,32,30,62
7,8478414,Timo Meier,R,NJD,28,82,30,32,62
7,8474102,David Perron,L,OTT,36,82,29,33,62
7,8477503,Max Domi,C,TOR,29,82,14,48,62
7,8478366,Frank Vatrano,R,ANA,30,82,32,29,61
7,8480830,Andrei Svechnikov,R,CAR,24,82,27,34,61
7,8481596,Shane Pinto,C,OTT,24,82,24,37,61
7,8476882,Teuvo Teravainen,L,CHI,30,82,23,38,61
7,8482110,Dawson Mercer,C,NJD,23,82,23,38,61
7,8475745,Charlie Coyle,C,BOS,32,82,22,39,61
7,8480803,Evan Bouchard,D,EDM,25,82,17,44,61
7,8474149,Evgenii Dadonov,R,DAL,35,82,30,30,60
7,8476826,Yanni Gourde,C,SEA,33,82,26,34,60
7,8482097,Jack Quinn,R,BUF,23,82,25,35,60
7,8479675,Trevor Moore,L,LAK,29,82,23,37,60
7,8479999,Casey Mittelstadt,C,COL,26,82,18,42,60
7,8478440,Dylan Strome,C,WSH,27,82,17,43,60
7,8477986,Brandon Montour,D,SEA,30,82,16,44,60
7,8478396,Noah Hanifin,D,VGK,27,82,13,47,60
7,8475151,Kyle Palmieri,C,NYI,33,82,37,22,59
7,8477496,Elias Lindholm,C,BOS,30,82,27,32,59
7,8482149,Cole Perfetti,C,WPG,22,82,22,37,59
7,8482665,Matty Beniers,C,SEA,22,82,17,42,59
7,8474563,Drew Doughty,D,LAK,35,82,16,43,59
7,8478460,Zach Werenski,D,CBJ,27,82,11,48,59
7,8480078,Filip Chytil,C,NYR,25,82,25,33,58
7,8482159,Tyson Foerster,R,PHI,22,82,20,38,58
7,8478397,Rasmus Andersson,D,CGY,28,82,16,42,58
7,8476456,Jonathan Huberdeau,C,CGY,31,82,15,43,58
7,8475753,Justin Faulk,D,STL,32,82,17,40,57
7,8481540,Cole Caufield,R,MTL,23,82,33,23,56
7,8478856,Conor Garland,R,VAN,28,82,25,31,56
7,8478519,Anthony Cirelli,C,TBL,27,82,23,33,56
7,8473986,Alex Killorn,L,ANA,35,82,23,33,56
7,8477476,Artturi Lehkonen,L,COL,29,82,22,34,56
7,8479987,Morgan Geekie,C,BOS,26,82,21,35,56
7,8477932,Aaron Ekblad,D,FLA,28,82,19,37,56
7,8481542,Moritz Seider,D,DET,23,82,5,51,56
7,8475314,Anders Lee,L,NYI,34,82,31,24,55
7,8475169,Evander Kane,L,EDM,33,82,29,26,55
7,8480797,Joel Farabee,L,PHI,24,82,23,32,55
7,8478975,Mason Marchment,L,DAL,29,82,22,33,55
7,8478038,Devon Toews,D,COL,30,82,18,37,55
7,8475799,Nino Niederreiter,R,WPG,32,82,30,24,54
7,8482089,Jake Neighbours,L,STL,22,82,27,27,54
7,8477497,Sean Monahan,C,CBJ,30,82,25,29,54
7,8475287,Erik Haula,L,NJD,33,82,25,29,54
7,8479525,Ross Colton,C,COL,28,82,25,29,54
7,8477021,Alex Kerfoot,C,UTA,30,82,14,40,54
7,8474565,Alex Pietrangelo,D,VGK,34,82,14,40,54
7,8476432,Boone Jenner,C,CBJ,31,82,31,22,53
7,8478498,Jake DeBrusk,L,VAN,28,82,29,24,53
7,8474586,Jordan Eberle,R,SEA,34,82,27,26,53
7,8477451,Ryan Hartman,R,MIN,30,82,27,26,53
7,8483808,Andrei Kuzmenko,L,CGY,28,82,23,30,53
7,8480015,Owen Tippett,R,PHI,25,82,22,31,53
7,8478042,Viktor Arvidsson,R,EDM,31,82,21,32,53
7,8476479,Phillip Danault,C,LAK,31,82,14,39,53
7,8476462,Dougie Hamilton,D,NJD,31,82,12,41,53
7,8478469,Thomas Chabot,D,OTT,27,82,12,41,53
7,8477511,Anthony Mantha,R,CGY,30,82,28,24,52
7,8478474,Lawson Crouse,L,UTA,27,82,28,24,52
7,8477416,Oliver Bjorkstrand,R,SEA,29,82,24,28,52
7,8478891,Mason Appleton,C,WPG,28,82,22,30,52
7,8478873,Troy Terry,R,ANA,27,82,21,31,52
7,8482113,Anton Lundell,C,FLA,23,82,20,32,52
7,8477494,Jonathan Drouin,L,COL,29,82,12,40,52
7,8476872,Scott Laughton,C,PHI,30,82,12,40,52
7,8479425,Filip Hronek,D,VAN,27,82,9,43,52
7,8480064,Josh Norris,C,OTT,25,82,28,23,51
7,8475794,Tyler Seguin,C,DAL,32,82,23,28,51
7,8482699,Dylan Guenther,R,UTA,21,82,21,30,51
7,8477429,Andrew Copp,C,DET,30,82,21,30,51
7,8479339,Patrik Laine,L,CBJ,26,82,20,31,51
7,8480018,Nick Suzuki,C,MTL,25,82,16,35,51
7,8476905,Chandler Stephenson,C,SEA,30,82,16,35,51
7,8470613,Brent Burns,D,CAR,39,82,12,39,51
7,8476438,Brandon Saad,L,STL,32,82,31,19,50
7,8480185,Eetu Luostarinen,C,FLA,26,82,28,22,50
7,8476483,Rickard Rakell,R,PIT,31,82,25,25,50
7,8482109,Alexis Lafrenière,L,NYR,23,82,23,27,50
7,8479400,Pierre-Luc Dubois,L,WSH,26,82,21,29,50
7,8477964,Ivan Barbashev,C,VGK,29,82,16,34,50
7,8478233,Andrew Mangiapane,L,WSH,28,82,16,34,50
7,8482092,Ridly Greig,C,OTT,22,82,22,27,49
7,8481528,Dylan Cozens,C,BUF,23,82,21,28,49
7,8474053,Logan Couture,C,SJS,35,82,21,28,49
7,8474150,Mikael Backlund,C,CGY,35,82,20,29,49
7,8476292,Ondrej Palat,L,NJD,33,82,17,32,49
7,8477444,Andre Burakovsky,L,SEA,29,82,17,32,49
7,8476792,Torey Krug,D,STL,33,82,10,39,49
7,8477935,Sam Bennett,C,FLA,28,82,20,28,48
7,8478458,Jack Roslovic,C,CAR,27,82,15,33,48
7,8480434,Sean Durzi,D,UTA,26,82,9,39,48
7,8476875,Mike Matheson,D,MTL,30,82,8,40,48
7,8475726,Tyler Toffoli,C,SJS,32,82,24,23,47
7,8482720,Matthew Knies,L,TOR,22,82,23,24,47
7,8477407,Anthony Duclair,L,NYI,29,82,20,27,47
7,8475170,Brayden Schenn,C,STL,33,82,13,34,47
7,8476869,Brady Skjei,D,NSH,30,82,9,38,47
7,8482175,JJ Peterka,R,BUF,22,82,23,23,46
7,8477456,J.T. Compher,L,DET,29,82,19,27,46
7,8482105,Jake Sanderson,D,OTT,22,82,14,32,46
7,8477346,MacKenzie Weegar,D,CGY,30,82,9,37,46
7,8474590,John Carlson,D,WSH,34,82,8,38,46
7,8482740,Wyatt Johnston,C,DAL,21,82,19,26,45
7,8482124,Quinton Byfield,R,LAK,22,82,18,27,45
7,8480459,Pius Suter,C,VAN,28,82,18,27,45
7,8479345,Jakob Chychrun,D,WSH,26,82,17,28,45
7,8477479,Tyler Bertuzzi,L,CHI,29,82,16,29,45
7,8479365,Trent Frederic,C,BOS,26,82,16,29,45
7,8482684,Luke Hughes,D,NJD,21,82,12,33,45
7,8476923,Damon Severson,D,CBJ,30,82,7,38,45
7,8478055,Gustav Forsling,D,FLA,28,82,6,39,45
7,8476906,Shayne Gostisbehere,D,CAR,31,82,6,39,45
7,8481618,Alex Newhook,C,MTL,23,82,20,24,44
7,8474641,Adam Henrique,C,EDM,34,82,20,24,44
7,8481560,Arthur Kaliyev,R,LAK,23,82,19,25,44
7,8477953,Kasperi Kapanen,R,STL,28,82,17,27,44
7,8475763,Kevin Hayes,R,PIT,32,82,16,28,44
7,8481581,Thomas Harley,D,DAL,23,82,8,36,44
7,8475768,Jaden Schwartz,C,SEA,32,82,28,15,43
7,8480748,Kiefer Sherwood,L,VAN,29,82,21,22,43
7,8481582,Nicholas Robertson,L,TOR,23,82,20,23,43
7,8476392,Adam Lowry,C,WPG,31,82,19,24,43
7,8478472,Mathieu Joseph,R,STL,27,82,15,28,43
7,8480817,K'Andre Miller,D,NYR,24,82,9,34,43
7,8477998,Warren Foegele,L,LAK,28,82,25,17,42
7,8480188,Fabian Zetterlund,L,SJS,25,82,24,18,42
7,8480849,Barrett Hayton,C,UTA,24,82,22,20,42
7,8476399,Blake Coleman,C,CGY,33,82,21,21,42
7,8478046,Danton Heinen,L,VAN,29,82,21,21,42
7,8484144,Connor Bedard,C,CHI,19,82,19,23,42
7,8475791,Taylor Hall,L,CHI,33,82,19,23,42
7,8475760,Nick Bjugstad,C,UTA,32,82,18,24,42
7,8480074,Alexandre Texier,C,STL,25,82,18,24,42
7,8477498,Darnell Nurse,D,EDM,29,82,11,31,42
7,8479410,Mikhail Sergachev,D,UTA,26,82,6,36,42
7,8480009,Eeli Tolvanen,R,SEA,25,82,22,19,41
7,8476854,Hampus Lindholm,D,BOS,30,82,11,30,41
7,8476979,Erik Gustafsson,D,DET,32,82,10,31,41
7,8475764,Cam Fowler,D,ANA,33,82,3,38,41
7,8481013,Jonatan Berggren,R,DET,24,82,25,15,40
7,8477987,Ryan Donato,C,CHI,28,82,21,19,40
7,8479992,Michael Rasmussen,C,DET,25,82,20,20,40
7,8481068,Yegor Sharangovich,C,CGY,26,82,18,22,40
7,8476458,Ryan Strome,C,ANA,31,82,18,22,40
7,8476419,Jean-Gabriel Pageau,C,NYI,32,82,12,28,40
7,8476329,Travis Boyd,C,MIN,31,82,7,33,40
7,8477426,Nicholas Paul,L,TBL,29,82,20,19,39
7,8473422,Nick Foligno,L,CHI,37,82,20,19,39
7,8480220,Noah Cates,L,PHI,25,82,18,21,39
7,8478462,Nicolas Roy,C,VGK,27,82,16,23,39
7,8476958,Jaccob Slavin,D,CAR,30,82,6,33,39
7,8480028,Morgan Frost,C,PHI,25,82,24,14,38
7,8480829,Jesperi Kotkaniemi,C,CAR,24,82,18,20,38
7,8473563,Nicklas Backstrom,C,WSH,37,82,16,22,38
7,8481704,Juuso Parssinen,C,NSH,23,82,15,23,38
7,8478109,Victor Olofsson,L,VGK,29,82,14,24,38
7,8476925,Colton Sissons,C,NSH,31,82,13,25,38
7,8480798,Philipp Kurashev,C,CHI,25,82,12,26,38
7,8477220,Nate Schmidt,D,FLA,33,82,12,26,38
7,8477948,Travis Sanheim,D,PHI,28,82,9,29,38
7,8477952,Robby Fabbri,C,ANA,28,82,19,18,37
7,8481554,Kaapo Kakko,R,NYR,23,82,17,20,37
7,8476474,Stefan Noesen,R,NJD,31,82,16,21,37
7,8482667,William Eklund,L,SJS,22,82,15,22,37
7,8482745,Mason McTavish,C,ANA,21,82,14,23,37
7,8479996,Cody Glass,C,NSH,25,82,14,23,37
7,8475191,Reilly Smith,R,NYR,33,82,12,25,37
7,8482133,Thomas Bordeleau,C,SJS,22,82,8,29,37
7,8475855,Jesper Fast,R,CAR,33,82,8,29,37
7,8477919,Frederick Gaudreau,C,MIN,31,82,6,31,37
7,8478416,Erik Cernak,D,TBL,27,82,3,34,37
7,8480813,Joe Veleno,C,DET,24,82,19,17,36
7,8478413,Jordan Greenway,L,BUF,27,82,14,22,36
7,8482705,Cole Sillinger,C,CBJ,21,82,13,23,36
7,8476917,Adam Pelech,D,NYI,30,82,7,29,36
7,8481535,Nils Hoglander,L,VAN,24,82,21,14,35
7,8482475,Yegor Chinakhov,R,CBJ,23,82,20,15,35
7,8471698,T.J. Oshie,R,WSH,38,82,20,15,35
7,8478057,Dakota Joshua,C,VAN,28,82,18,17,35
7,8476880,Tom Wilson,R,WSH,30,82,16,19,35
7,8479293,Brandon Tanev,L,SEA,33,82,16,19,35
7,8482055,Drew O'Connor,L,PIT,26,82,12,23,35
7,8475722,Jason Zucker,L,BUF,32,82,12,23,35
7,8474716,Jared Spurgeon,D,MIN,35,82,9,26,35
7,8480043,Timothy Liljegren,D,TOR,25,82,5,30,35
7,8475171,Oliver Ekman-Larsson,D,TOR,33,82,5,30,35
7,8480802,Ryan McLeod,C,BUF,25,82,15,19,34
7,8482660,Kent Johnson,C,CBJ,22,82,13,21,34
7,8475714,Calle Jarnkrok,C,TOR,33,82,13,21,34
7,8475231,Casey Cizikas,C,NYI,33,82,13,21,34
7,8482079,Marco Rossi,C,MIN,23,82,13,21,34
7,8476461,Sean Couturier,C,PHI,32,82,12,22,34
7,8481656,Aliaksei Protas,C,WSH,23,82,12,22,34
7,8475193,Tomas Tatar,L,NJD,34,82,12,22,34
7,8476897,Oskar Sundqvist,C,STL,30,82,12,22,34
7,8475200,Dmitry Orlov,D,CAR,33,82,10,24,34
7,8481606,Jordan Spence,D,LAK,23,82,10,24,34
7,8480878,Nils Lundkvist,D,DAL,24,82,8,26,34
7,8477506,Ryan Pulock,D,NYI,30,82,6,28,34
7,8473507,Jeff Petry,D,DET,37,82,6,28,34
7,8480873,Rasmus Sandin,D,WSH,24,82,3,31,34
7,8481604,Pavel Dorofeyev,L,VGK,24,82,21,12,33
7,8470621,Corey Perry,R,EDM,39,82,18,15,33
7,8478463,Anthony Beauvillier,L,PIT,27,82,17,16,33
7,8474189,Lars Eller,C,PIT,35,82,16,17,33
7,8476960,Andreas Athanasiou,C,CHI,30,82,16,17,33
7,8476981,Josh Anderson,R,MTL,30,82,15,18,33
7,8476278,Colin Blackwell,C,DAL,31,82,14,19,33
7,8481580,Connor McMichael,C,WSH,23,82,13,20,33
7,8481546,Cam York,D,PHI,23,82,11,22,33
7,8476902,Esa Lindell,D,DAL,30,82,11,22,33
7,8476312,Josh Manson,D,COL,33,82,7,26,33
7,8476892,Colton Parayko,D,STL,31,82,4,29,33
7,8477969,Marcus Pettersson,D,PIT,28,82,4,29,33
7,8475181,Nick Leddy,D,STL,33,82,4,29,33
7,8477425,Miles Wood,L,COL,29,82,17,15,32
7,8476927,Teddy Blueger,C,VAN,30,82,11,21,32
7,8480145,Neal Pionk,D,WPG,29,82,7,25,32
7,8480871,Adam Boqvist,D,FLA,24,82,7,25,32
7,8479398,Samuel Girard,D,COL,26,82,4,28,32
7,8482245,Artem Zub,D,OTT,29,82,4,28,32
7,8475848,Brendan Gallagher,R,MTL,32,82,17,14,31
7,8481624,Ilya Mikheyev,R,CHI,30,82,16,15,31
7,8476442,Matt Nieto,L,PIT,32,82,16,15,31
7,8482259,Bobby McMann,C,TOR,28,82,16,15,31
7,8481032,Paul Cotter,C,NJD,25,82,15,16,31
7,8474715,Cam Atkinson,R,TBL,35,82,15,16,31
7,8480068,Ryan Poehling,C,PHI,25,82,11,20,31
7,8478542,Evan Rodrigues,C,FLA,31,82,10,21,31
7,8477495,Seth Jones,D,CHI,30,82,9,22,31
7,8475218,Mattias Ekholm,D,EDM,34,82,7,24,31
7,8480113,Alex Iafallo,L,WPG,31,82,7,24,31
7,8475324,Nick Jensen,D,OTT,34,82,7,24,31
7,8479998,Mikey Anderson,D,LAK,25,82,6,25,31
7,8478882,Vladislav Gavrikov,D,LAK,29,82,5,26,31
7,8475188,Brayden McNabb,D,VGK,33,82,4,27,31
7,8479351,Sam Steel,C,DAL,26,82,13,17,30
7,8481186,Logan O'Connor,R,COL,28,82,11,19,30
7,8478500,Ivan Provorov,D,CBJ,27,82,3,27,30
7,8479941,Justin Danforth,R,CBJ,31,82,15,14,29
7,8479661,Tanner Jeannot,L,LAK,27,82,14,15,29
7,8482117,Lukas Reichel,L,CHI,22,82,12,17,29
7,8481481,Blake Lizotte,C,PIT,27,82,11,18,29
7,8480855,Jack McBain,C,UTA,24,82,10,19,29
7,8477508,Curtis Lazar,C,NJD,29,82,9,20,29
7,8482122,Brock Faber,D,MIN,22,82,7,22,29
7,8482671,Owen Power,D,BUF,22,82,6,23,29
7,8476463,Jonas Brodin,D,MIN,31,82,6,23,29
7,8477488,Brett Pesce,D,NJD,30,82,5,24,29
7,8477507,Nikita Zadorov,D,BOS,29,82,5,24,29
7,8482146,Luke Evangelista,R,NSH,22,82,15,13,28
7,8477839,Conor Sheary,L,TBL,32,82,14,14,28
7,8484203,Bradly Nadeau,L,CAR,19,82,14,14,28
7,8475149,Marcus Johansson,L,MIN,34,82,13,15,28
7,8481553,Bobby Brink,R,PHI,23,82,12,16,28
7,8483565,Nick Blankenburg,D,NSH,26,82,12,16,28
7,8480336,Sean Walker,D,CAR,30,82,11,17,28
7,8475220,Marcus Foligno,L,MIN,33,82,11,17,28
7,8477947,Sonny Milano,L,WSH,28,82,10,18,28
7,8480222,Sebastian Aho,D,PIT,28,82,8,20,28
7,8482166,Shakir Mukhamadullin,D,SJS,22,82,7,21,28
7,8478911,Matt Roy,D,WSH,29,82,6,22,28
7,8476879,Cody Ceci,D,EDM,31,82,6,22,28
7,8478851,Alexandre Carrier,D,NSH,28,82,4,24,28
7,8480049,Dylan Samberg,D,WPG,25,82,1,27,28
7,8480281,Alexey Toropchenko,R,STL,25,82,20,7,27
7,8476921,Jordan Martinook,L,CAR,32,82,16,11,27
7,8476918,Jimmy Vesey,L,NYR,31,82,15,12,27
7,8482125,Alexander Holtz,R,VGK,22,82,15,12,27
7,8480835,Jack Drury,C,CAR,24,82,14,13,27
7,8480789,Oliver Wahlstrom,R,NYI,24,82,14,13,27
7,8475343,Nic Dowd,C,WSH,34,82,13,14,27
7,8473533,Jordan Staal,C,CAR,36,82,12,15,27
7,8479591,Michael Eyssimont,C,TBL,28,82,11,16,27
7,8480144,David Kampf,C,TOR,29,82,11,16,27
7,8476480,Vladislav Namestnikov,C,WPG,32,82,11,16,27
7,8477392,Hudson Fasching,R,NYI,29,82,11,16,27
7,8482155,Alex Laferriere,R,LAK,23,82,11,16,27
7,8478133,Jake Evans,C,MTL,28,82,10,17,27
7,8477406,Mattias Janmark,C,EDM,32,82,9,18,27
7,8477015,Connor Brown,R,EDM,30,82,8,19,27
7,8475279,Ben Chiarot,D,DET,33,82,5,22,27
7,8483490,Pavel Mintyukov,D,ANA,21,82,5,22,27
7,8476331,Dylan DeMelo,D,WPG,31,82,2,25,27
7,8483515,Juraj Slafkovsky,L,MTL,20,82,16,10,26
7,8481093,Rafael Harvey-Pinard,L,MTL,25,82,13,13,26
7,8473453,Trevor Lewis,C,LAK,37,82,13,13,26
7,8479353,Brett Howden,C,VGK,26,82,10,16,26
7,8482062,Cole Smith,L,NSH,29,82,10,16,26
7,8477450,Jason Dickinson,C,CHI,29,82,10,16,26
7,8482762,Simon Edvinsson,D,DET,21,82,10,16,26
7,8478507,John Marino,D,UTA,27,82,3,23,26
7,8474574,Tyler Myers,D,VAN,34,82,2,24,26
7,8483431,Logan Cooley,C,UTA,20,82,18,7,25
7,8482077,Dylan Holloway,L,EDM,23,82,16,9,25
7,8478020,Michael Amadio,C,OTT,28,82,13,12,25
7,8478115,Pierre Engvall,L,NYI,28,82,12,13,25
7,8482624,Daniil Miromanov,D,CGY,27,82,12,13,25
7,8480003,Jesper Boqvist,C,FLA,26,82,11,14,25
7,8480995,Pontus Holmberg,R,TOR,25,82,11,14,25
7,8480025,MacKenzie Entwistle,R,FLA,25,82,9,16,25
7,8483471,Brad Lambert,C,WPG,31,82,7,18,25
7,8476422,Mike Reilly,D,NYI,31,82,6,19,25
7,8476891,Matt Grzelcyk,D,PIT,30,82,5,20,25
7,8480893,Kirill Marchenko,R,CBJ,24,82,17,7,24
7,8476469,Joel Armia,R,MTL,31,82,13,11,24
7,8479368,Max Jones,L,BOS,26,82,13,11,24
7,8475793,Ryan Johansen,C,PHI,32,82,11,13,24
7,8482803,Olen Zellweger,D,ANA,21,82,10,14,24
7,8478432,Christian Fischer,R,DET,27,82,9,15,24
7,8483499,Liam Ohgren,L,MIN,20,82,8,16,24
7,8480021,Jack Studnicka,C,LAK,25,82,7,17,24
7,8476885,Jacob Trouba,D,NYR,30,82,6,18,24
7,8481178,Egor Zamula,D,PHI,24,82,6,18,24
7,8479402,Jake Bean,D,CGY,26,82,4,20,24
7,8481568,Alex Vlasic,D,CHI,23,82,4,20,24
7,8476467,Jamie Oleksiak,D,SEA,32,82,4,20,24
7,8479976,Juuso Valimaki,D,UTA,26,82,2,22,24
7,8478508,Yakov Trenin,C,MIN,27,82,14,9,23
7,8478569,Noel Acciari,C,PIT,33,82,14,9,23
7,8481477,Nico Sturm,C,SJS,29,82,12,11,23
7,8479390,Taylor Raddysh,R,WSH,26,82,11,12,23
7,8476878,Zemgus Girgensons,L,TBL,30,82,10,13,23
7,8482101,Danil Gushchin,L,SJS,22,82,9,14,23
7,8481601,Simon Holmstrom,R,NYI,23,82,8,15,23
7,8477845,Trevor van Riemsdyk,D,WSH,33,82,8,15,23
7,8482142,Jamie Drysdale,D,PHI,22,82,7,16,23
7,8481014,Alexander Romanov,D,NYI,24,82,4,19,23
7,8474673,TJ Brodie,D,CHI,34,82,0,23,23
7,8481517,Brett Leason,R,ANA,25,82,11,11,22
7,8483505,Matthew Poitras,C,BOS,20,82,11,11,22
7,8479442,Troy Stecher,D,EDM,30,82,10,12,22
7,8479980,Nicolas Hague,D,VGK,26,82,9,13,22
7,8476873,Mark Jankowski,C,NSH,30,82,9,13,22
7,8483457,Lane Hutson,D,MTL,20,82,7,15,22
7,8481567,Henry Thrun,D,SJS,23,82,7,15,22
7,8477499,Rasmus Ristolainen,D,PHI,30,82,6,16,22
7,8479983,Mario Ferraro,D,SJS,26,82,6,16,22
7,8480073,Erik Brannstrom,D,COL,25,82,5,17,22
7,8474151,Ryan McDonagh,D,TBL,35,82,3,19,22
7,8476931,Jake McCabe,D,TOR,31,82,3,19,22
7,8482655,J.J. Moser,D,TBL,24,82,3,19,22
7,8476429,Scott Mayfield,D,NYI,32,82,2,20,22
7,8483495,Simon Nemec,D,NJD,20,82,2,20,22
7,8480807,Mattias Samuelsson,D,BUF,24,82,1,21,22
7,8476624,Barclay Goodrow,C,SJS,31,82,11,10,21
7,8483763,Maksymilian Szuber,D,UTA,22,82,11,10,21
7,8481641,Joel Kiviranta,L,COL,28,82,11,10,21
7,8476889,Radek Faksa,C,STL,30,82,10,11,21
7,8478434,Keegan Kolesar,R,VGK,27,82,9,12,21
7,8476374,Sean Kuraly,C,CBJ,31,82,9,12,21
7,8480980,Connor Dewar,C,TOR,25,82,9,12,21
7,8482470,Ilya Solovyov,D,CGY,24,82,8,13,21
7,8478013,Jake Walman,D,SJS,28,82,8,13,21
7,8482679,Matt Coronato,R,CGY,22,82,7,14,21
7,8476525,Colin Miller,D,WPG,32,82,5,16,21
7,8475718,Justin Holl,D,DET,32,82,5,16,21
7,8483524,Shane Wright,C,SEA,20,82,5,16,21
7,8474013,Ian Cole,D,UTA,35,82,4,17,21
7,8475462,Radko Gudas,D,ANA,34,82,4,17,21
7,8474612,Travis Hamonic,D,OTT,34,82,3,18,21
7,8476967,Brett Kulak,D,EDM,30,82,0,21,21
7,8479414,Nathan Bastian,R,NJD,27,82,12,8,20
7,8479359,Beck Malenstyn,L,BUF,26,82,9,11,20
7,8478468,Jeremy Lauzon,D,NSH,27,82,8,12,20
7,8480172,Jan Rutta,D,SJS,34,82,6,14,20
7,8476457,Adam Larsson,D,SEA,32,82,5,15,20
7,8481699,Aku Raty,R,UTA,23,82,4,16,20
7,8477938,Haydn Fleury,D,WPG,28,82,4,16,20
7,8479324,Ryan Lindgren,D,NYR,26,82,3,17,20
7,8475177,Calvin de Haan,D,COL,33,82,2,18,20
7,8479369,Andrew Peeke,D,BOS,26,82,1,19,20
7,8484153,Leo Carlsson,C,ANA,20,82,13,6,19
7,8484166,Adam Fantilli,C,CBJ,20,82,12,7,19
7,8483397,Marc McLaughlin,C,BOS,25,82,12,7,19
7,8477989,Christian Dvorak,C,MTL,28,82,11,8,19
7,8477353,Tyler Motte,C,DET,29,82,11,8,19
7,8478211,Dryden Hunt,L,CGY,29,82,9,10,19
7,8479393,Noah Gregor,C,OTT,26,82,9,10,19
7,8482074,Connor Zary,C,CGY,23,82,8,11,19
7,8477505,Alexander Wennberg,C,SJS,30,82,8,11,19
7,8482809,Jackson Blake,R,CAR,21,82,8,11,19
7,8479316,Luke Kunin,C,SJS,27,82,6,13,19
7,8482111,Justin Barron,D,MTL,23,82,5,14,19
7,8482087,Kaiden Guhle,D,MTL,22,82,2,17,19
7,8470600,Ryan Suter,D,STL,39,82,2,17,19
7,8482073,Braden Schneider,D,NYR,23,82,2,17,19
7,8475842,Sam Carrick,C,NYR,32,82,9,9,18
7,8482807,Ethan Del Mastro,D,CHI,21,82,4,14,18
7,8476441,Joel Edmundson,D,LAK,31,82,4,14,18
7,8477365,Connor Clifton,D,BUF,29,82,1,17,18
7,8477903,Garnet Hathaway,R,PHI,33,82,10,7,17
7,8480448,Parker Kelly,L,COL,25,82,9,8,17
7,8484145,Zach Benson,L,BUF,19,82,7,10,17
7,8483468,Jiri Kulich,C,BUF,20,82,6,11,17
7,8478136,Jake Middleton,D,MIN,28,82,6,11,17
7,8480796,Martin Fehervary,D,WSH,25,82,5,12,17
7,8478443,Brandon Carlo,D,BOS,28,82,5,12,17
7,8481028,Martin Pospisil,C,CGY,25,82,4,13,17
7,8480860,Kevin Bahl,D,CGY,24,82,4,13,17
7,8478840,Will Borgen,D,SEA,28,82,2,15,17
7,8483466,Kevin Korchinski,D,CHI,20,82,2,15,17
7,8479638,Justin Brazeau,R,BOS,26,82,9,7,16
7,8481522,Peyton Krebs,C,BUF,23,82,7,9,16
7,8477931,Tomas Nosek,L,FLA,32,82,7,9,16
7,8477435,Ryan Graves,D,PIT,29,82,6,10,16
7,8482141,Lukas Cormier,D,VGK,22,82,5,11,16
7,8480990,Declan Chisholm,D,MIN,24,82,5,11,16
7,8476822,Luke Glendening,C,TBL,35,82,11,4,15
7,8477369,Carson Soucy,D,VAN,30,82,7,8,15
7,8482702,Logan Stankoven,C,DAL,21,82,7,8,15
7,8480806,Isac Lundestrom,C,ANA,25,82,6,9,15
7,8483012,Logan Morrison,C,SEA,22,82,5,10,15
7,8478178,Darren Raddysh,D,TBL,28,82,5,10,15
7,8483460,David Jiricek,D,CBJ,21,82,5,10,15
7,8479371,Dante Fabbro,D,NSH,26,82,4,11,15
7,8477335,Kyle Burroughs,D,LAK,29,82,4,11,15
7,8482858,Ryker Evans,D,SEA,23,82,1,14,15
7,8480950,Ilya Lyubushkin,D,DAL,30,82,0,15,15
7,8476858,Phillip Di Giuseppe,L,VAN,31,82,9,5,14
7,8482145,Mavrik Bourque,C,DAL,22,82,6,8,14
7,8478399,Jonas Siegenthaler,D,NJD,27,82,4,10,14
7,8480035,Henri Jokiharju,D,BUF,25,82,4,10,14
7,8478859,Niko Mikkola,D,FLA,28,82,3,11,14
7,8475790,Erik Gudbranson,D,CBJ,32,82,2,12,14
7,8476372,Nick Seeler,D,PHI,31,82,1,13,14
7,8481605,Jackson LaCombe,D,ANA,23,82,1,13,14
7,8474090,Brendan Smith,D,DAL,35,82,1,13,14
7,8481708,Zac Jones,D,NYR,24,82,0,14,14
7,8482749,Joshua Roy,R,MTL,21,82,7,6,13
7,8479291,Kevin Rooney,C,CGY,31,82,5,8,13
7,8482516,Matthew Kessel,D,STL,24,82,3,10,13
7,8477034,Jaycob Megna,D,FLA,32,82,3,10,13
7,8482118,Sam Colangelo,R,ANA,23,82,3,10,13
7,8480246,Nick Perbix,D,TBL,26,82,2,11,13
7,8475233,David Savard,D,MTL,34,82,0,13,13
7,8480870,Bo Groulx,C,NYR,24,82,5,7,12
7,8475455,Brenden Dillon,D,NJD,34,82,4,8,12
7,8484911,Collin Graf,R,SJS,22,82,4,8,12
7,8484149,Gavin Brindley,C,CBJ,20,82,3,9,12
7,8474567,Zach Bogosian,D,MIN,34,82,3,9,12
7,8480834,Ty Emberson,D,SJS,24,82,3,9,12
7,8482666,Scott Morrow,D,CAR,22,82,2,10,12
7,8478874,Adam Gaudette,C,OTT,28,82,2,10,12
7,8475690,Chris Tanev,D,TOR,35,82,1,11,12
7,8483493,Frank Nazar,C,CHI,20,82,7,4,11
7,8482070,Mitchell Chaffee,R,TBL,26,82,7,4,11
7,8483445,Cutter Gauthier,L,ANA,20,82,5,6,11
7,8480879,Jacob Bernard-Docker,D,OTT,24,82,4,7,11
7,8478450,Parker Wotherspoon,D,BOS,27,82,4,7,11
7,8482712,Oskar Olausson,R,COL,22,82,4,7,11
7,8482859,Zack Ostapchuk,C,OTT,21,82,2,9,11
7,8479576,Vincent Desharnais,D,VAN,28,82,5,5,10
7,8476473,Connor Murphy,D,CHI,31,82,3,7,10
7,8481122,Simon Benoit,D,TOR,26,82,2,8,10
7,8475762,Derek Forbort,D,VAN,32,82,1,9,10
7,8471677,Jack Johnson,D,CBJ,37,82,3,6,9
7,8483482,Tristan Luneau,D,ANA,20,82,2,7,9
7,8482153,Brendan Brisson,C,VGK,23,82,1,8,9
7,8482787,Nikita Chibrikov,R,WPG,31,82,6,2,8
7,8481524,Bowen Byram,D,BUF,23,82,5,3,8
7,8483489,Fraser Minten,C,TOR,31,82,3,5,8
7,8482733,Logan Mailloux,D,MTL,31,82,2,6,8
7,8483567,Georgii Merkulov,C,BOS,24,82,2,5,7
7,8482713,Mackie Samoskevich,R,FLA,22,82,1,6,7
7,8482659,Josh Doan,R,UTA,22,82,4,1,5
7,8474062,Riley Nash,C,NYR,35,82,1,4,5
7,8470794,Joe Pavelski,C,,40,0,0,0,0
7,8481703,Valtteri Puustinen,R,PIT,25,0,0,0,0
7,8477950,Tony DeAngelo,D,,29,0,0,0,0
7,8481577,Philip Tomasino,C,NSH,23,0,0,0,0
7,8475197,Tyson Barrie,D,,33,0,0,0,0
7,8471218,Blake Wheeler,R,,38,0,0,0,0
7,8474157,Max Pacioretty,L,,36,0,0,0,0
7,8478466,Daniel Sprong,R,VAN,27,0,0,0,0
7,8475744,Evgeny Kuznetsov,C,,32,0,0,0,0
7,8481019,David Gustafsson,C,WPG,24,0,0,0,0
7,8475906,John Klingberg,D,,32,0,0,0,0
7,8479348,Kale Clague,D,BUF,26,0,0,0,0
7,8476952,Dominic Toninato,C,WPG,30,0,0,0,0
7,8473473,Milan Lucic,L,,36,0,0,0,0
7,8474037,James van Riemsdyk,L,,35,0,0,0,0
7,8474602,Justin Schultz,D,,34,0,0,0,0
7,8482222,Alexander Barabanov,L,,30,0,0,0,0
7,8479372,Josh Mahura,D,SEA,26,0,0,0,0
7,8479982,Conor Timmins,D,TOR,26,0,0,0,0
7,8474031,Kevin Shattenkirk,D,,35,0,0,0,0
7,8480008,Adam Ruzicka,C,,25,0,0,0,0
7,8481059,Scott Perunovich,D,STL,26,0,0,0,0
7,8480884,Calen Addison,D,,24,0,0,0,0
7,8476994,Vinnie Hinostroza,C,NSH,30,0,0,0,0
7,8478452,Caleb Jones,D,LAK,27,0,0,0,0
7,8480157,Calle Rosen,D,COL,30,0,0,0,0
7,8481609,Vladislav Kolyachonok,D,UTA,23,0,0,0,0
7,8479415,Michael McLeod,C,,26,0,0,0,0
7,8476919,Chris Tierney,C,,30,0,0,0,0
7,8479639,Dylan Coghlan,D,WPG,26,0,0,0,0
7,8478146,Matthew Highmore,C,OTT,28,0,0,0,0
7,8478970,Jalen Chatfield,D,CAR,28,0,0,0,0
7,8480205,Emil Bemstrom,C,PIT,25,0,0,0,0
7,8474884,Mike Hoffman,C,,35,0,0,0,0
7,8471274,Alex Goligoski,D,,39,0,0,0,0
7,8478104,Sammy Blais,L,,28,0,0,0,0
7,8474870,Tyler Johnson,C,,34,0,0,0,0
7,8476913,Devin Shore,C,MIN,30,0,0,0,0
7,8481598,Philip Broberg,D,EDM,23,0,0,0,0
7,8480058,Pierre-Olivier Joseph,D,STL,25,0,0,0,0
7,8480891,Michael Kesselring,D,UTA,24,0,0,0,0
7,8477979,Nicolas Aube-Kubel,R,BUF,28,0,0,0,0
7,8476871,Tanner Pearson,L,,32,0,0,0,0
7,8476393,Nick Cousins,C,,31,0,0,0,0
7,8479977,Kailer Yamamoto,R,,26,0,0,0,0
7,8479543,Michael Pezzetta,L,MTL,26,0,0,0,0
7,8477018,Ben Hutton,D,VGK,31,0,0,0,0
7,8480762,Eric Robinson,L,CAR,29,0,0,0,0
7,8474034,Pat Maroon,L,CHI,36,0,0,0,0
7,8481058,Jesse Ylönen,R,,25,0,0,0,0
7,8475179,Dmitry Kulikov,D,FLA,34,0,0,0,0
7,8481527,Kaedan Korczak,D,VGK,23,0,0,0,0
7,8473449,Kyle Okposo,R,,36,0,0,0,0
7,8482192,Isaak Phillips,D,CHI,23,0,0,0,0
7,8480727,Zach Whitecloud,D,VGK,28,0,0,0,0
7,8479346,Dillon Dube,C,,26,0,0,0,0
7,8480821,Filip Zadina,R,,25,0,0,0,0
7,8480001,Urho Vaakanainen,D,ANA,25,0,0,0,0
7,8470966,Mark Giordano,D,,41,0,0,0,0
7,8480853,Liam Foudy,C,,24,0,0,0,0
7,8475225,Craig Smith,C,CHI,35,0,0,0,0
7,8479972,Mason Shaw,C,WPG,26,0,0,0,0
7,8478451,Ethan Bear,D,WSH,27,0,0,0,0
7,8474040,Sam Gagner,C,,35,0,0,0,0
7,8480196,Jacob Bryson,D,BUF,27,0,0,0,0
7,8479984,Cal Foote,D,,26,0,0,0,0
7,8480011,Klim Kostin,C,SJS,25,0,0,0,0
7,8482176,Wyatt Kaiser,D,CHI,22,0,0,0,0
7,8476988,Matt Benning,D,SJS,30,0,0,0,0
7,8479370,Tyson Jost,C,CAR,26,0,0,0,0
7,8477464,Nic Petan,C,,29,0,0,0,0
7,8477380,Jonny Brodzinski,C,NYR,31,0,0,0,0
7,8480070,Ian Mitchell,D,BOS,25,0,0,0,0
7,8479315,Joey Anderson,R,CHI,26,0,0,0,0
7,8478099,Kevin Labanc,R,,29,0,0,0,0
7,8476874,Olli Maatta,D,DET,30,0,0,0,0
7,8475208,Brian Dumoulin,D,ANA,33,0,0,0,0
7,8478430,Oliver Kylington,D,,27,0,0,0,0
7,8479536,Axel Jonsson-Fjallby,L,WPG,26,0,0,0,0
7,8479671,Mathieu Olivier,R,CBJ,27,0,0,0,0
7,8471709,Marc-Edouard Vlasic,D,SJS,37,0,0,0,0
7,8479328,Julien Gauthier,R,NYI,27,0,0,0,0
7,8478421,A.J. Greer,L,FLA,28,0,0,0,0
7,8477573,Nathan Walker,L,STL,30,0,0,0,0
7,8481537,Nikita Okhotiuk,D,CGY,24,0,0,0,0
7,8474166,Alec Martinez,D,CHI,37,0,0,0,0
7,8470610,Zach Parise,L,,40,0,0,0,0
7,8477478,William Carrier,L,CAR,30,0,0,0,0
7,8479344,Jesse Puljujarvi,R,PIT,26,0,0,0,0
7,8480887,Jordan Harris,D,MTL,24,0,0,0,0
7,8478502,Dennis Gilbert,D,BUF,28,0,0,0,0
7,8482730,Brandt Clarke,D,LAK,21,0,0,0,0
7,8480355,Mark Kastelic,C,BOS,25,0,0,0,0
7,8475750,Jon Merrill,D,MIN,32,0,0,0,0
7,8475164,Jakob Silfverberg,R,,34,0,0,0,0
7,8477944,Jakub Vrana,L,,28,0,0,0,0
7,8479439,Jacob MacDonald,D,COL,31,0,0,0,0
7,8474568,Luke Schenn,D,NSH,35,0,0,0,0
7,8478454,Noah Juulsen,D,VAN,27,0,0,0,0
7,8475752,Tyler Pitlick,C,,33,0,0,0,0
7,8482148,Hendrix Lapierre,C,WSH,22,0,0,0,0
7,8481167,Brayden Pachal,D,CGY,25,0,0,0,0
7,8478043,Sam Lafferty,C,BUF,29,0,0,0,0
7,8479321,Lucas Johansen,D,,27,0,0,0,0
7,8471699,Andrew Cogliano,C,,37,0,0,0,0
7,8481521,Ronnie Attard,D,PHI,25,0,0,0,0
7,8481161,Jake Christiansen,D,CBJ,25,0,0,0,0
7,8479458,Nikita Zaitsev,D,,33,0,0,0,0
7,8479619,Michael Carcone,L,UTA,28,0,0,0,0
7,8479026,Philippe Myers,D,TOR,27,0,0,0,0
7,8477330,Dominik Kubalik,L,,29,0,0,0,0
7,8481617,Vasily Podkolzin,R,VAN,23,0,0,0,0
7,8481701,Santeri Hatakka,D,NJD,23,0,0,0,0
7,8479514,Rem Pitlick,C,,27,0,0,0,0
7,8477446,Michael McCarron,R,NSH,29,0,0,0,0
7,8470604,Jeff Carter,C,,39,0,0,0,0
7,8482241,Radim Zohorna,L,,28,0,0,0,0
7,8480289,Morgan Barron,C,WPG,26,0,0,0,0
7,8479379,Givani Smith,R,SJS,26,0,0,0,0
7,8480216,Jacob Peterson,C,,25,0,0,0,0
7,8477851,Jordan Oesterle,D,BOS,32,0,0,0,0
7,8484258,Sam Malinski,D,COL,26,0,0,0,0
7,8478904,Steven Lorentz,C,,28,0,0,0,0
7,8482095,Tyler Kleven,D,OTT,22,0,0,0,0
7,8480848,Ty Dellandrea,C,SJS,24,0,0,0,0
7,8476884,Derrick Pouliot,D,,30,0,0,0,0
7,8479336,Carl Grundstrom,R,SJS,27,0,0,0,0
7,8482964,Arber Xhekaj,D,MTL,23,0,0,0,0
7,8471686,Marc Staal,D,,37,0,0,0,0
7,8477887,Patrick Brown,C,BOS,32,0,0,0,0
7,8478495,Denis Gurianov,R,,27,0,0,0,0
7,8473504,Cal Clutterbuck,R,,37,0,0,0,0
7,8481550,Adam Beckman,L,NJD,23,0,0,0,0
7,8480845,Rasmus Kupari,C,WPG,24,0,0,0,0
7,8474009,Nick Bonino,C,,36,0,0,0,0
7,8478585,Derek Ryan,C,EDM,38,0,0,0,0
7,8477962,Brendan Lemieux,L,CAR,28,0,0,0,0
7,8482861,Vincent Iorio,D,WSH,22,0,0,0,0
7,8479378,Logan Stanley,D,WPG,26,0,0,0,0
7,8473446,Erik Johnson,D,PHI,36,0,0,0,0
7,8481743,Marc Del Gaizo,D,NSH,25,0,0,0,0
7,8477384,Josh Brown,D,EDM,30,0,0,0,0
7,8482165,Yan Kuznetsov,D,CGY,22,0,0,0,0
7,8478424,Jansen Harkins,C,ANA,27,0,0,0,0
7,8482144,Jack Thompson,D,SJS,22,0,0,0,0
7,8478512,Austin Czarnik,C,,32,0,0,0,0
7,8477527,Ross Johnston,L,ANA,30,0,0,0,0
7,8479383,Boris Katchouk,L,,26,0,0,0,0
7,8482094,Daemon Hunt,D,MIN,22,0,0,0,0
7,8481719,Maxwell Crozier,D,TBL,24,0,0,0,0
7,8480192,Johnathan Kovacevic,D,NJD,27,0,0,0,0
7,8479376,Victor Mete,D,,26,0,0,0,0
7,8482511,Mason Lohrei,D,BOS,23,0,0,0,0
7,8475825,Jani Hakanpää,D,,32,0,0,0,0
7,8478021,William Lagesson,D,DET,28,0,0,0,0
7,8475795,Dylan McIlrath,D,WSH,32,0,0,0,0
7,8477846,Ryan Carpenter,C,,33,0,0,0,0
7,8481056,Spencer Stastney,D,NSH,24,0,0,0,0
7,8481564,Ryan Johnson,D,BUF,23,0,0,0,0
7,8478017,Mark Friedman,D,VAN,29,0,0,0,0
7,8479320,Max Lajoie,D,SEA,27,0,0,0,0
7,8480075,Cameron Crotty,D,MIN,25,0,0,0,0
7,8484287,Cole McWard,D,VAN,23,0,0,0,0
7,8484254,Akito Hirose,D,VAN,25,0,0,0,0
7,8483407,Brandon Scanlin,D,NYR,25,0,0,0,0
7,8480274,Philip Kemp,D,EDM,25,0,0,0,0
7,8479522,Hardy Haman Aktell,D,WSH,26,0,0,0,0
7,8480007,Jonas Rondbjerg,R,VGK,25,0,0,0,0
7,8477454,Adam Erne,L,,29,0,0,0,0
7,8481679,Maxence Guenette,D,OTT,23,0,0,0,0
7,8480441,Trey Fix-Wolansky,R,CBJ,25,0,0,0,0
7,8483546,Marshall Rifai,D,TOR,26,0,0,0,0
7,8480084,Nick DeSimone,D,NJD,30,0,0,0,0
7,8481030,Jack St. Ivany,D,PIT,25,0,0,0,0
7,8481592,Jakob Pelletier,L,CGY,23,0,0,0,0
7,8478011,Louie Belpedio,D,PHI,28,0,0,0,0
7,8477930,Pierre-Edouard Bellemare,L,,39,0,0,0,0
7,8484321,Nikolas Matinpalo,D,OTT,26,0,0,0,0
7,8482067,Connor Mackey,D,NYR,28,0,0,0,0
7,8481806,Louis Crevier,D,CHI,23,0,0,0,0
7,8484326,Patrik Koch,D,UTA,28,0,0,0,0
7,8477971,Andreas Englund,D,LAK,28,0,0,0,0
7,8481751,Lukas Rousek,R,BUF,25,0,0,0,0
7,8481006,Tyler Tucker,D,STL,24,0,0,0,0
7,8476867,Brendan Gaunce,C,MIN,30,0,0,0,0
7,8479520,Brandon Duhaime,R,WSH,27,0,0,0,0
7,8477073,Kurtis MacDermid,L,NJD,30,0,0,0,0
7,8480874,Adam Ginning,D,PHI,24,0,0,0,0
7,8477473,Justin Bailey,R,SJS,29,0,0,0,0
7,8479066,Ryan Lomberg,L,CGY,30,0,0,0,0
7,8477070,Liam O'Brien,C,UTA,30,0,0,0,0
7,8474618,Marco Scandella,D,,34,0,0,0,0
7,8475797,Jarred Tinordi,D,,32,0,0,0,0
7,8481441,Joe Snively,C,DET,28,0,0,0,0
7,8477244,Chad Ruhwedel,D,NYR,34,0,0,0,0
7,8479772,Zack MacEwen,R,OTT,28,0,0,0,0
7,8481147,Reese Johnson,C,MIN,26,0,0,0,0
7,8481043,Cole Koepke,L,BOS,26,0,0,0,0
7,8483619,Filip Roos,D,OTT,25,0,0,0,0
7,8481541,Samuel Bolduc,D,NYI,24,0,0,0,0
7,8477810,Joel Hanley,D,CGY,33,0,0,0,0
7,8476907,Mackenzie MacEachern,L,,30,0,0,0,0
7,8482652,Walker Duehr,R,CGY,27,0,0,0,0
7,8477126,Jayson Megna,C,,34,0,0,0,0
7,8483398,Declan Carlile,D,TBL,31,0,0,0,0
7,8482929,Emil Lilleberg,D,TBL,23,0,0,0,0
7,8480880,Jakub Lauko,C,MIN,24,0,0,0,0
7,8480245,Olle Lycksell,R,PHI,25,0,0,0,0
7,8480252,Cole Guttman,C,CHI,25,0,0,0,0
7,8477467,Gustav Olofsson,D,SEA,30,0,0,0,0
7,8479968,Vinni Lettieri,C,BOS,29,0,0,0,0
7,8478400,Colin White,C,,27,0,0,0,0
7,8475755,Alexander Petrovic,D,DAL,32,0,0,0,0
7,8481812,Nikolai Knyzhov,D,,27,0,0,0,0
7,8481593,Jayden Struble,D,MTL,23,0,0,0,0
7,8481532,Alex Turcotte,C,LAK,23,0,0,0,0
7,8482126,Emil Andrae,D,PHI,31,0,0,0,0
7,8479944,Zach Aston-Reese,C,VGK,30,0,0,0,0
7,8471817,Ryan Reaves,R,TOR,37,0,0,0,0
7,8481206,John Ludvig,D,PIT,24,0,0,0,0
7,8481599,Victor Soderstrom,D,UTA,23,0,0,0,0
7,8480292,Carson Meyer,R,ANA,27,0,0,0,0
7,8482496,Nils Aman,C,VAN,24,0,0,0,0
7,8479718,Alex Barré-Boulet,C,MTL,27,0,0,0,0
7,8479994,Jaret Anderson-Dolan,C,WPG,25,0,0,0,0
7,8480184,Gustav Lindstrom,D,,26,0,0,0,0
7,8480890,Jan Jenik,R,OTT,24,0,0,0,0
7,8478067,Oskar Lindblom,L,,28,0,0,0,0
7,8476934,Brock McGinn,L,ANA,30,0,0,0,0
7,8479985,Cale Fleury,D,SEA,26,0,0,0,0
7,8484304,Uvis Balinskis,D,FLA,28,0,0,0,0
7,8479981,Jonah Gadjovich,L,FLA,26,0,0,0,0
7,8481716,Dmitri Voronkov,L,CBJ,24,0,0,0,0
7,8474709,Matt Martin,L,,35,0,0,0,0
7,8482634,Alex Steeves,C,TOR,25,0,0,0,0
7,8480823,Alexander Alexeyev,D,WSH,25,0,0,0,0
7,8477541,Dakota Mermis,D,TOR,30,0,0,0,0
7,8483491,Ivan Miroshnichenko,L,WSH,20,0,0,0,0
7,8478477,Mitchell Stephens,C,SEA,27,0,0,0,0
7,8481543,Nikita Alexandrov,C,STL,24,0,0,0,0
7,8479423,Alex Nylander,L,,26,0,0,0,0
7,8482451,Mikael Pyyhtia,L,CBJ,23,0,0,0,0
7,8478831,Kevin Stenlund,C,UTA,28,0,0,0,0
7,8480306,Grant Hutton,D,NYI,29,0,0,0,0
7,8478028,Fredrik Olofsson,L,,28,0,0,0,0
7,8477462,Robert Hagg,D,VGK,29,0,0,0,0
7,8477320,Anton Blidh,L,NYR,29,0,0,0,0
7,8482157,Will Cuylle,L,NYR,22,0,0,0,0
7,8482737,Zack Bolduc,C,STL,21,0,0,0,0
7,8481239,Samuel Fagemo,L,,24,0,0,0,0
7,8481600,Tobias Bjornfot,D,FLA,23,0,0,0,0
7,8478409,Anthony Richard,C,PHI,28,0,0,0,0
7,8474145,Robert Bortuzzo,D,,35,0,0,0,0
7,8475958,Michael Sgarbossa,C,WSH,32,0,0,0,0
7,8479986,Kole Lind,R,DAL,26,0,0,0,0
7,8479249,Andrew Poturalski,C,SJS,30,0,0,0,0
7,8479362,Riley Tufte,L,BOS,26,0,0,0,0
7,8479991,Jake Leschyshyn,C,NYR,25,0,0,0,0
7,8479587,Rhett Gardner,C,PHI,28,0,0,0,0
7,8482744,James Malatesta,L,CBJ,21,0,0,0,0
7,8478854,Ryan Shea,D,PIT,27,0,0,0,0
7,8481591,Sam Poulin,R,,23,0,0,0,0
7,8483512,Matt Savoie,C,EDM,20,0,0,0,0
7,8482102,Vasily Ponomarev,C,PIT,22,0,0,0,0
7,8482162,Roby Jarventie,L,EDM,22,0,0,0,0
7,8481016,Ruslan Iskhakov,C,,24,0,0,0,0
7,8482172,Landon Slaggert,L,CHI,22,0,0,0,0
7,8482747,Brennan Othmann,L,NYR,21,0,0,0,0
7,8480031,Maxime Comtois,L,,25,0,0,0,0
7,8480226,Marián Studenic,R,,26,0,0,0,0
7,8478408,Travis Dermott,D,,28,0,0,0,0
7,8481518,Nolan Foote,L,NJD,24,0,0,0,0
7,8479419,Brett Murray,L,BUF,26,0,0,0,0
7,8482088,Justin Sourdif,R,FLA,22,0,0,0,0
7,8482201,Gage Goncalves,C,TBL,23,0,0,0,0
7,8481578,Graeme Clarke,R,MIN,23,0,0,0,0
7,8482177,Marat Khusnutdinov,C,MIN,22,0,0,0,0
7,8481754,Nikita Nesterenko,C,ANA,23,0,0,0,0
7,8483531,Brian Halonen,L,NJD,25,0,0,0,0
7,8483920,Pierrick Dube,R,WSH,23,0,0,0,0
7,8480851,Akil Thomas,C,LAK,24,0,0,0,0
7,8475235,Nicolas Deslauriers,L,PHI,33,0,0,0,0
7,8482476,Emil Heineman,L,MTL,23,0,0,0,0
7,8477149,Scott Sabourin,R,SJS,32,0,0,0,0
7,8483549,Lucas Condotta,L,MTL,27,0,0,0,0
7,8482765,Isak Rosen,R,BUF,21,0,0,0,0
7,8481237,Kyle MacLean,C,NYI,25,0,0,0,0
7,8481024,Linus Karlsson,C,VAN,25,0,0,0,0
7,8481690,Tyler Angle,C,,24,0,0,0,0
7,8483570,Ben Meyers,C,SEA,26,0,0,0,0
7,8481655,Cole Schwindt,R,CGY,23,0,0,0,0
7,8481462,Mason Morelli,L,VGK,28,0,0,0,0
7,8483401,Marc Johnstone,R,PIT,28,0,0,0,0
7,8478956,Samuel Laberge,L,NJD,27,0,0,0,0
7,8479533,Joona Koppanen,L,,26,0,0,0,0
7,8482197,Adam Raska,R,MIN,23,0,0,0,0
7,8482250,Callahan Burke,C,VGK,27,0,0,0,0
7,8482784,Zach Dean,C,STL,21,0,0,0,0
7,8484255,Jason Polin,R,COL,25,0,0,0,0
7,8481077,John Leonard,L,,26,0,0,0,0
7,8481534,Raphael Lavoie,C,EDM,24,0,0,0,0
7,8483609,Adam Klapka,R,CGY,24,0,0,0,0
7,8482751,Ryan Winterton,C,SEA,21,0,0,0,0
7,8480267,Sammy Walker,C,MIN,25,0,0,0,0
7,8475766,Austin Watson,L,,32,0,0,0,0
7,8482460,Matt Rempe,C,NYR,22,0,0,0,0
7,8481065,Angus Crookshank,L,OTT,25,0,0,0,0
7,8481070,Hugh McGing,L,,26,0,0,0,0
7,8476323,Max McCormick,L,SEA,32,0,0,0,0
7,8483395,Arshdeep Bains,L,VAN,23,0,0,0,0
7,8484259,Ondrej Pavel,C,COL,31,0,0,0,0
7,8483432,Luca Del Bel Belluz,C,CBJ,31,0,0,0,0
7,8483045,Cameron Butler,R,CBJ,31,0,0,0,0
7,8482061,Brandon Biro,L,SEA,26,0,0,0,0
7,8477401,John Hayden,C,SEA,29,0,0,0,0
7,8475278,Byron Froese,C,,33,0,0,0,0
7,8478446,Glenn Gawdin,C,LAK,27,0,0,0,0
7,8477993,Justin Kirkland,C,CGY,28,0,0,0,0
7,8482147,Jean-Luc Foudy,C,COL,22,0,0,0,0
7,8480032,Shane Bowers,C,NJD,25,0,0,0,0
7,8479330,Brandon Gignac,C,MTL,27,0,0,0,0
7,8480776,Sheldon Rempal,R,,29,0,0,0,0
7,8475413,Justin Dowling,C,NJD,34,0,0,0,0
7,8481726,Adam Edstrom,C,NYR,24,0,0,0,0
7,8480844,Grigori Denisenko,L,VGK,24,0,0,0,0
7,8478147,Bokondji Imama,L,PIT,28,0,0,0,0
7,8478881,Brett Seney,L,CHI,28,0,0,0,0
7,8483630,Pavol Regenda,L,ANA,25,0,0,0,0
7,8480836,Jonathan Gruden,C,,24,0,0,0,0
7,8484314,Jiri Smejkal,L,,28,0,0,0,0
7,8475780,Chris Wagner,R,COL,33,0,0,0,0
7,8479546,Oskar Steen,C,,26,0,0,0,0
7,8483597,Milos Kelemen,L,UTA,25,0,0,0,0
7,8481789,Tye Kartye,L,SEA,23,0,0,0,0
7,8484325,Waltteri Merela,C,TBL,26,0,0,0,0
7,8479421,Jacob Moverare,D,LAK,26,0,0,0,0
7,8481585,Egor Afanasyev,L,SJS,23,0,0,0,0
7,8479547,Matthew Phillips,R,,26,0,0,0,0
7,8479367,William Lockwood,R,FLA,26,0,0,0,0
7,8476915,Jujhar Khaira,L,,30,0,0,0,0
7,8481422,Jacob Lucchini,C,NSH,29,0,0,0,0
7,8480468,James Hamblin,L,EDM,25,0,0,0,0
7,8478051,Max Willman,C,NJD,29,0,0,0,0
7,8481556,John Beecher,C,BOS,23,0,0,0,0
7,8478078,Rourke Chartier,C,,28,0,0,0,0
8,8479318,Auston Matthews,C,TOR,27,82,64,66,130
8,8477492,Nathan MacKinnon,C,COL,29,82,52,77,129
8,8481559,Jack Hughes,C,NJD,23,82,40,82,122
8,8478864,Kirill Kaprizov,L,MIN,27,82,52,69,121
8,8478402,Connor McDavid,C,EDM,27,82,36,84,120
8,8476453,Nikita Kucherov,R,TBL,31,82,32,86,118
8,8479314,Matthew Tkachuk,L,FLA,27,82,39,76,115
8,8477934,Leon Draisaitl,C,EDM,29,82,43,70,113
8,8479407,Jesper Bratt,L,NJD,26,82,41,68,109
8,8477493,Aleksander Barkov,C,FLA,29,82,29,80,109
8,8478550,Artemi Panarin,L,NYR,33,82,44,64,108
8,8476468,J.T. Miller,C,VAN,31,82,35,73,108
8,8477956,David Pastrnak,R,BOS,28,82,57,50,107
8,8471675,Sidney Crosby,C,PIT,37,82,48,56,104
8,8482116,Tim Stützle,C,OTT,22,82,40,62,102
8,8480012,Elias Pettersson,C,VAN,26,82,38,61,99
8,8480027,Jason Robertson,L,DAL,25,82,37,62,99
8,8481557,Matt Boldy,L,MIN,23,82,34,64,98
8,8476887,Filip Forsberg,L,NSH,30,82,44,53,97
8,8480023,Robert Thomas,C,STL,25,82,35,62,97
8,8477404,Jake Guentzel,C,TBL,30,82,48,46,94
8,8475166,John Tavares,C,TOR,34,82,43,51,94
8,8480002,Nico Hischier,C,NJD,25,82,36,58,94
8,8478445,Mathew Barzal,C,NYI,27,82,24,70,94
8,8478439,Travis Konecny,R,PHI,27,82,44,49,93
8,8476454,Ryan Nugent-Hopkins,C,EDM,31,82,32,61,93
8,8478493,Joel Eriksson Ek,C,MIN,27,82,45,47,92
8,8479343,Clayton Keller,R,UTA,26,82,33,58,91
8,8480069,Cale Makar,D,COL,26,82,22,69,91
8,8477939,William Nylander,R,TOR,28,82,41,49,90
8,8477933,Sam Reinhart,C,FLA,29,82,48,41,89
8,8480801,Brady Tkachuk,L,OTT,25,82,38,51,89
8,8475172,Nazem Kadri,C,CGY,34,82,38,51,89
8,8475692,Mats Zuccarello,R,MIN,37,82,24,65,89
8,8478010,Brayden Point,C,TBL,28,82,51,35,86
8,8480800,Quinn Hughes,D,VAN,25,82,7,78,85
8,8480830,Andrei Svechnikov,R,CAR,24,82,29,55,84
8,8477409,Carter Verhaeghe,C,FLA,29,82,51,32,83
8,8478398,Kyle Connor,L,WPG,28,82,43,39,82
8,8477500,Bo Horvat,C,NYI,29,82,41,41,82
8,8478427,Sebastian Aho,C,CAR,27,82,40,42,82
8,8474564,Steven Stamkos,C,NSH,34,82,40,42,82
8,8477501,Valeri Nichushkin,R,COL,29,82,39,42,81
8,8478420,Mikko Rantanen,R,COL,28,82,35,46,81
8,8478449,Roope Hintz,C,DAL,28,82,34,47,81
8,8479323,Adam Fox,D,NYR,26,82,15,66,81
8,8475167,Victor Hedman,D,TBL,34,82,14,67,81
8,8475184,Chris Kreider,L,NYR,33,82,43,37,80
8,8477402,Pavel Buchnevich,L,STL,29,82,31,49,80
8,8474600,Roman Josi,D,NSH,34,82,21,59,80
8,8477942,Kevin Fiala,L,LAK,28,82,33,46,79
8,8478047,Michael Bunting,L,PIT,29,82,28,50,78
8,8478460,Zach Werenski,D,CBJ,27,82,22,56,78
8,8474141,Patrick Kane,R,DET,36,82,33,44,77
8,8477447,Shea Theodore,D,VGK,29,82,18,58,76
8,8476346,Johnny Gaudreau,L,CBJ,31,82,22,53,75
8,8480803,Evan Bouchard,D,EDM,25,82,20,55,75
8,8476459,Mika Zibanejad,C,NYR,31,82,37,37,74
8,8478403,Jack Eichel,C,VGK,28,82,30,44,74
8,8474578,Erik Karlsson,D,PIT,34,82,24,50,74
8,8480208,Drake Batherson,R,OTT,26,82,22,52,74
8,8476853,Morgan Rielly,D,TOR,30,82,18,56,74
8,8478414,Timo Meier,R,NJD,28,82,42,31,73
8,8475726,Tyler Toffoli,C,SJS,32,82,38,35,73
8,8477946,Dylan Larkin,C,DET,28,82,37,36,73
8,8475810,Bryan Rust,R,PIT,32,82,36,37,73
8,8479385,Jordan Kyrou,C,STL,26,82,30,43,73
8,8476389,Vincent Trocheck,C,NYR,31,82,28,45,73
8,8478401,Pavel Zacha,C,BOS,27,82,24,49,73
8,8480865,Noah Dobson,D,NYI,24,82,19,54,73
8,8481528,Dylan Cozens,C,BUF,23,82,28,44,72
8,8475913,Mark Stone,R,VGK,32,82,27,45,72
8,8477949,Alex Tuch,R,BUF,28,82,25,47,72
8,8477960,Adrian Kempe,R,LAK,28,82,32,39,71
8,8476460,Mark Scheifele,C,WPG,31,82,32,39,71
8,8474102,David Perron,L,OTT,36,82,30,41,71
8,8475170,Brayden Schenn,C,STL,33,82,30,40,70
8,8482078,Lucas Raymond,L,DET,22,82,29,40,69
8,8476905,Chandler Stephenson,C,SEA,30,82,15,54,69
8,8478444,Brock Boeser,R,VAN,27,82,34,34,68
8,8479420,Tage Thompson,C,BUF,27,82,30,38,68
8,8475786,Zach Hyman,L,EDM,32,82,30,38,68
8,8471215,Evgeni Malkin,C,PIT,38,82,28,40,68
8,8477951,Nick Schmaltz,C,UTA,28,82,24,44,68
8,8482097,Jack Quinn,R,BUF,23,82,24,44,68
8,8479337,Alex DeBrincat,R,DET,27,82,19,49,68
8,8478519,Anthony Cirelli,C,TBL,27,82,35,32,67
8,8479542,Brandon Hagel,L,TBL,26,82,30,37,67
8,8478975,Mason Marchment,L,DAL,29,82,29,38,67
8,8475745,Charlie Coyle,C,BOS,32,82,23,44,67
8,8476881,Tomas Hertl,C,VGK,31,82,35,31,66
8,8481540,Cole Caufield,R,MTL,23,82,34,32,66
8,8475765,Vladimir Tarasenko,R,DET,33,82,31,35,66
8,8481711,Matias Maccelli,L,UTA,24,82,25,41,66
8,8475798,Mikael Granlund,C,SJS,32,82,19,47,66
8,8476456,Jonathan Huberdeau,C,CGY,31,82,14,52,66
8,8482684,Luke Hughes,D,NJD,21,82,13,52,65
8,8480036,Miro Heiskanen,D,DAL,25,82,11,54,65
8,8477504,Josh Morrissey,D,WPG,29,82,11,54,65
8,8476539,Jonathan Marchessault,R,NSH,34,82,34,30,64
8,8475168,Matt Duchene,C,DAL,33,82,28,35,63
8,8477416,Oliver Bjorkstrand,R,SEA,29,82,24,39,63
8,8478407,Vince Dunn,D,SEA,28,82,16,47,63
8,8479675,Trevor Moore,L,LAK,29,82,27,35,62
8,8480188,Fabian Zetterlund,L,SJS,25,82,23,39,62
8,8474150,Mikael Backlund,C,CGY,35,82,22,40,62
8,8481068,Yegor Sharangovich,C,CGY,26,82,37,24,61
8,8475754,Brock Nelson,C,NYI,33,82,33,28,61
8,8482109,Alexis Lafrenière,L,NYR,23,82,29,32,61
8,8477955,Jared McCann,L,SEA,28,82,27,34,61
8,8475151,Kyle Palmieri,C,NYI,33,82,27,34,61
8,8471214,Alex Ovechkin,L,WSH,39,82,26,35,61
8,8478440,Dylan Strome,C,WSH,27,82,26,35,61
8,8476462,Dougie Hamilton,D,NJD,31,82,22,39,61
8,8473512,Claude Giroux,R,OTT,36,82,20,41,61
8,8474563,Drew Doughty,D,LAK,35,82,9,52,61
8,8479339,Patrik Laine,L,CBJ,26,82,29,31,60
8,8473994,Jamie Benn,L,DAL,35,82,28,32,60
8,8481596,Shane Pinto,C,OTT,24,82,28,32,60
8,8473419,Brad Marchand,L,BOS,36,82,23,37,60
8,8477456,J.T. Compher,L,DET,29,82,19,41,60
8,8476448,William Karlsson,C,VGK,31,82,27,32,59
8,8474641,Adam Henrique,C,EDM,34,82,25,34,59
8,8478498,Jake DeBrusk,L,VAN,28,82,34,24,58
8,8477940,Nikolaj Ehlers,L,WPG,28,82,24,34,58
8,8475158,Ryan O'Reilly,C,NSH,33,82,22,36,58
8,8478397,Rasmus Andersson,D,CGY,28,82,13,45,58
8,8481523,Kirby Dach,C,MTL,23,82,12,46,58
8,8471724,Kris Letang,D,PIT,37,82,12,46,58
8,8478542,Evan Rodrigues,C,FLA,31,82,24,33,57
8,8482665,Matty Beniers,C,SEA,22,82,21,36,57
8,8477346,MacKenzie Weegar,D,CGY,30,82,15,42,57
8,8471685,Anze Kopitar,C,LAK,37,82,14,43,57
8,8477932,Aaron Ekblad,D,FLA,28,82,12,45,57
8,8474565,Alex Pietrangelo,D,VGK,34,82,10,47,57
8,8482093,Seth Jarvis,C,CAR,22,82,26,30,56
8,8482740,Wyatt Johnston,C,DAL,21,82,26,30,56
8,8478873,Troy Terry,R,ANA,27,82,23,33,56
8,8477021,Alex Kerfoot,C,UTA,30,82,16,40,56
8,8478366,Frank Vatrano,R,ANA,30,82,31,24,55
8,8482110,Dawson Mercer,C,NJD,23,82,25,30,55
8,8476906,Shayne Gostisbehere,D,CAR,31,82,21,34,55
8,8479400,Pierre-Luc Dubois,L,WSH,26,82,20,35,55
8,8479410,Mikhail Sergachev,D,UTA,26,82,18,37,55
8,8478038,Devon Toews,D,COL,30,82,12,43,55
8,8480064,Josh Norris,C,OTT,25,82,29,25,54
8,8476880,Tom Wilson,R,WSH,30,82,28,26,54
8,8483808,Andrei Kuzmenko,L,CGY,28,82,27,27,54
8,8480015,Owen Tippett,R,PHI,25,82,26,28,54
8,8477496,Elias Lindholm,C,BOS,30,82,19,35,54
8,8482124,Quinton Byfield,R,LAK,22,82,17,37,54
8,8475191,Reilly Smith,R,NYR,33,82,16,38,54
8,8479325,Charlie McAvoy,D,BOS,27,82,15,39,54
8,8479345,Jakob Chychrun,D,WSH,26,82,14,40,54
8,8478396,Noah Hanifin,D,VGK,27,82,12,42,54
8,8477935,Sam Bennett,C,FLA,28,82,26,27,53
8,8482745,Mason McTavish,C,ANA,21,82,26,27,53
8,8480018,Nick Suzuki,C,MTL,25,82,22,31,53
8,8476483,Rickard Rakell,R,PIT,31,82,22,31,53
8,8480839,Rasmus Dahlin,D,BUF,24,82,11,42,53
8,8478055,Gustav Forsling,D,FLA,28,82,10,43,53
8,8477998,Warren Foegele,L,LAK,28,82,25,27,52
8,8480039,Martin Necas,C,CAR,25,82,21,31,52
8,8476479,Phillip Danault,C,LAK,31,82,19,33,52
8,8477451,Ryan Hartman,R,MIN,30,82,18,34,52
8,8477497,Sean Monahan,C,CBJ,30,82,14,38,52
8,8474679,Gustav Nyquist,C,NSH,35,82,13,39,52
8,8481542,Moritz Seider,D,DET,23,82,13,39,52
8,8475784,Jeff Skinner,C,EDM,32,82,26,25,51
8,8475768,Jaden Schwartz,C,SEA,32,82,26,25,51
8,8478042,Viktor Arvidsson,R,EDM,31,82,21,30,51
8,8474053,Logan Couture,C,SJS,35,82,17,34,51
8,8480078,Filip Chytil,C,NYR,25,82,16,35,51
8,8477495,Seth Jones,D,CHI,30,82,15,36,51
8,8481581,Thomas Harley,D,DAL,23,82,7,44,51
8,8476438,Brandon Saad,L,STL,32,82,25,25,50
8,8480014,Gabriel Vilardi,C,WPG,25,82,24,26,50
8,8480798,Philipp Kurashev,C,CHI,25,82,22,28,50
8,8482667,William Eklund,L,SJS,22,82,22,28,50
8,8480797,Joel Farabee,L,PHI,24,82,21,29,50
8,8477426,Nicholas Paul,L,TBL,29,82,21,29,50
8,8475287,Erik Haula,L,NJD,33,82,19,31,50
8,8480871,Adam Boqvist,D,FLA,24,82,14,36,50
8,8477986,Brandon Montour,D,SEA,30,82,12,38,50
8,8470613,Brent Burns,D,CAR,39,82,8,42,50
8,8480893,Kirill Marchenko,R,CBJ,24,82,32,17,49
8,8473986,Alex Killorn,L,ANA,35,82,23,26,49
8,8476399,Blake Coleman,C,CGY,33,82,22,27,49
8,8482699,Dylan Guenther,R,UTA,21,82,21,28,49
8,8479987,Morgan Geekie,C,BOS,26,82,19,30,49
8,8478469,Thomas Chabot,D,OTT,27,82,16,33,49
8,8480185,Eetu Luostarinen,C,FLA,26,82,16,33,49
8,8480009,Eeli Tolvanen,R,SEA,25,82,23,25,48
8,8482475,Yegor Chinakhov,R,CBJ,23,82,23,25,48
8,8471698,T.J. Oshie,R,WSH,38,82,20,28,48
8,8482149,Cole Perfetti,C,WPG,22,82,18,30,48
8,8479999,Casey Mittelstadt,C,COL,26,82,15,33,48
8,8479425,Filip Hronek,D,VAN,27,82,8,40,48
8,8482089,Jake Neighbours,L,STL,22,82,35,12,47
8,8477407,Anthony Duclair,L,NYI,29,82,28,19,47
8,8475169,Evander Kane,L,EDM,33,82,27,20,47
8,8475314,Anders Lee,L,NYI,34,82,26,21,47
8,8474586,Jordan Eberle,R,SEA,34,82,26,21,47
8,8482175,JJ Peterka,R,BUF,22,82,26,21,47
8,8475794,Tyler Seguin,C,DAL,32,82,25,22,47
8,8481533,Trevor Zegras,C,ANA,23,82,14,33,47
8,8475763,Kevin Hayes,R,PIT,32,82,19,27,46
8,8477947,Sonny Milano,L,WSH,28,82,18,28,46
8,8475220,Marcus Foligno,L,MIN,33,82,16,30,46
8,8475753,Justin Faulk,D,STL,32,82,12,34,46
8,8476458,Ryan Strome,C,ANA,31,82,11,35,46
8,8476869,Brady Skjei,D,NSH,30,82,6,40,46
8,8476461,Sean Couturier,C,PHI,32,82,20,25,45
8,8476882,Teuvo Teravainen,L,CHI,30,82,19,26,45
8,8477479,Tyler Bertuzzi,L,CHI,29,82,18,27,45
8,8474590,John Carlson,D,WSH,34,82,8,37,45
8,8476875,Mike Matheson,D,MTL,30,82,6,39,45
8,8476432,Boone Jenner,C,CBJ,31,82,24,20,44
8,8480835,Jack Drury,C,CAR,24,82,24,20,44
8,8481582,Nicholas Robertson,L,TOR,23,82,21,23,44
8,8477952,Robby Fabbri,C,ANA,28,82,21,23,44
8,8478856,Conor Garland,R,VAN,28,82,20,24,44
8,8477964,Ivan Barbashev,C,VGK,29,82,20,24,44
8,8480459,Pius Suter,C,VAN,28,82,17,27,44
8,8474149,Evgenii Dadonov,R,DAL,35,82,14,30,44
8,8476872,Scott Laughton,C,PHI,30,82,13,31,44
8,8478911,Matt Roy,D,WSH,29,82,12,32,44
8,8476854,Hampus Lindholm,D,BOS,30,82,11,33,44
8,8476923,Damon Severson,D,CBJ,30,82,10,34,44
8,8477511,Anthony Mantha,R,CGY,30,82,20,23,43
8,8478474,Lawson Crouse,L,UTA,27,82,20,23,43
8,8481554,Kaapo Kakko,R,NYR,23,82,20,23,43
8,8476278,Colin Blackwell,C,DAL,31,82,20,23,43
8,8482720,Matthew Knies,L,TOR,22,82,19,24,43
8,8478462,Nicolas Roy,C,VGK,27,82,15,28,43
8,8476329,Travis Boyd,C,MIN,31,82,13,30,43
8,8478472,Mathieu Joseph,R,STL,27,82,10,33,43
8,8478233,Andrew Mangiapane,L,WSH,28,82,18,24,42
8,8476826,Yanni Gourde,C,SEA,33,82,15,27,42
8,8481546,Cam York,D,PHI,23,82,14,28,42
8,8479992,Michael Rasmussen,C,DET,25,82,12,30,42
8,8475218,Mattias Ekholm,D,EDM,34,82,7,35,42
8,8470621,Corey Perry,R,EDM,39,82,25,16,41
8,8481560,Arthur Kaliyev,R,LAK,23,82,21,20,41
8,8478458,Jack Roslovic,C,CAR,27,82,15,26,41
8,8476927,Teddy Blueger,C,VAN,30,82,14,27,41
8,8478438,Tommy Novak,C,NSH,27,82,13,28,41
8,8482113,Anton Lundell,C,FLA,23,82,13,28,41
8,8476419,Jean-Gabriel Pageau,C,NYI,32,82,13,28,41
8,8482671,Owen Power,D,BUF,22,82,12,29,41
8,8479293,Brandon Tanev,L,SEA,33,82,20,20,40
8,8478109,Victor Olofsson,L,VGK,29,82,17,23,40
8,8477444,Andre Burakovsky,L,SEA,29,82,14,26,40
8,8482660,Kent Johnson,C,CBJ,22,82,12,28,40
8,8475799,Nino Niederreiter,R,WPG,32,82,26,13,39
8,8481535,Nils Hoglander,L,VAN,24,82,26,13,39
8,8477476,Artturi Lehkonen,L,COL,29,82,21,18,39
8,8476480,Vladislav Namestnikov,C,WPG,32,82,19,20,39
8,8484144,Connor Bedard,C,CHI,19,82,17,22,39
8,8481656,Aliaksei Protas,C,WSH,23,82,17,22,39
8,8478463,Anthony Beauvillier,L,PIT,27,82,17,22,39
8,8477498,Darnell Nurse,D,EDM,29,82,13,26,39
8,8483515,Juraj Slafkovsky,L,MTL,20,82,13,26,39
8,8480817,K'Andre Miller,D,NYR,24,82,8,31,39
8,8476892,Colton Parayko,D,STL,31,82,7,32,39
8,8480043,Timothy Liljegren,D,TOR,25,82,6,33,39
8,8481604,Pavel Dorofeyev,L,VGK,24,82,26,12,38
8,8478115,Pierre Engvall,L,NYI,28,82,24,14,38
8,8480028,Morgan Frost,C,PHI,25,82,19,19,38
8,8481013,Jonatan Berggren,R,DET,24,82,18,20,38
8,8476918,Jimmy Vesey,L,NYR,31,82,18,20,38
8,8482705,Cole Sillinger,C,CBJ,21,82,15,23,38
8,8475764,Cam Fowler,D,ANA,33,82,7,31,38
8,8478057,Dakota Joshua,C,VAN,28,82,20,17,37
8,8480802,Ryan McLeod,C,BUF,25,82,17,20,37
8,8481618,Alex Newhook,C,MTL,23,82,16,21,37
8,8481477,Nico Sturm,C,SJS,29,82,14,23,37
8,8480220,Noah Cates,L,PHI,25,82,11,26,37
8,8477503,Max Domi,C,TOR,29,82,9,28,37
8,8475171,Oliver Ekman-Larsson,D,TOR,33,82,8,29,37
8,8474151,Ryan McDonagh,D,TBL,35,82,4,33,37
8,8475793,Ryan Johansen,C,PHI,32,82,17,19,36
8,8473533,Jordan Staal,C,CAR,36,82,16,20,36
8,8473563,Nicklas Backstrom,C,WSH,37,82,15,21,36
8,8476292,Ondrej Palat,L,NJD,33,82,12,24,36
8,8480434,Sean Durzi,D,UTA,26,82,11,25,36
8,8477953,Kasperi Kapanen,R,STL,28,82,10,26,36
8,8476792,Torey Krug,D,STL,33,82,8,28,36
8,8481032,Paul Cotter,C,NJD,25,82,19,16,35
8,8482117,Lukas Reichel,L,CHI,22,82,16,19,35
8,8475722,Jason Zucker,L,BUF,32,82,14,21,35
8,8476885,Jacob Trouba,D,NYR,30,82,13,22,35
8,8478046,Danton Heinen,L,VAN,29,82,11,24,35
8,8474716,Jared Spurgeon,D,MIN,35,82,11,24,35
8,8475200,Dmitry Orlov,D,CAR,33,82,9,26,35
8,8476979,Erik Gustafsson,D,DET,32,82,5,30,35
8,8481014,Alexander Romanov,D,NYI,24,82,3,32,35
8,8475760,Nick Bjugstad,C,UTA,32,82,17,17,34
8,8481580,Connor McMichael,C,WSH,23,82,17,17,34
8,8480113,Alex Iafallo,L,WPG,31,82,17,17,34
8,8481624,Ilya Mikheyev,R,CHI,30,82,16,18,34
8,8482146,Luke Evangelista,R,NSH,22,82,16,18,34
8,8475343,Nic Dowd,C,WSH,34,82,15,19,34
8,8477494,Jonathan Drouin,L,COL,29,82,13,21,34
8,8475149,Marcus Johansson,L,MIN,34,82,12,22,34
8,8477488,Brett Pesce,D,NJD,30,82,9,25,34
8,8477948,Travis Sanheim,D,PHI,28,82,7,27,34
8,8476958,Jaccob Slavin,D,CAR,30,82,6,28,34
8,8478500,Ivan Provorov,D,CBJ,27,82,3,31,34
8,8479402,Jake Bean,D,CGY,26,82,2,32,34
8,8479365,Trent Frederic,C,BOS,26,82,15,18,33
8,8481186,Logan O'Connor,R,COL,28,82,15,18,33
8,8475791,Taylor Hall,L,CHI,33,82,12,21,33
8,8476960,Andreas Athanasiou,C,CHI,30,82,10,23,33
8,8478416,Erik Cernak,D,TBL,27,82,3,30,33
8,8479525,Ross Colton,C,COL,28,82,17,15,32
8,8479941,Justin Danforth,R,CBJ,31,82,17,15,32
8,8474189,Lars Eller,C,PIT,35,82,15,17,32
8,8473422,Nick Foligno,L,CHI,37,82,14,18,32
8,8480849,Barrett Hayton,C,UTA,24,82,13,19,32
8,8478013,Jake Walman,D,SJS,28,82,10,22,32
8,8482122,Brock Faber,D,MIN,22,82,6,26,32
8,8482087,Kaiden Guhle,D,MTL,22,82,6,26,32
8,8477969,Marcus Pettersson,D,PIT,28,82,4,28,32
8,8478507,John Marino,D,UTA,27,82,4,28,32
8,8477425,Miles Wood,L,COL,29,82,18,13,31
8,8482055,Drew O'Connor,L,PIT,26,82,14,17,31
8,8480855,Jack McBain,C,UTA,24,82,13,18,31
8,8484166,Adam Fantilli,C,CBJ,20,82,13,18,31
8,8482092,Ridly Greig,C,OTT,22,82,10,21,31
8,8482624,Daniil Miromanov,D,CGY,27,82,9,22,31
8,8479351,Sam Steel,C,DAL,26,82,8,23,31
8,8480145,Neal Pionk,D,WPG,29,82,7,24,31
8,8476331,Dylan DeMelo,D,WPG,31,82,4,27,31
8,8475188,Brayden McNabb,D,VGK,33,82,2,29,31
8,8480049,Dylan Samberg,D,WPG,25,82,0,31,31
8,8476469,Joel Armia,R,MTL,31,82,21,9,30
8,8477987,Ryan Donato,C,CHI,28,82,19,11,30
8,8479414,Nathan Bastian,R,NJD,27,82,16,14,30
8,8480068,Ryan Poehling,C,PHI,25,82,15,15,30
8,8480336,Sean Walker,D,CAR,30,82,15,15,30
8,8480829,Jesperi Kotkaniemi,C,CAR,24,82,13,17,30
8,8477353,Tyler Motte,C,DET,29,82,13,17,30
8,8481606,Jordan Spence,D,LAK,23,82,12,18,30
8,8479353,Brett Howden,C,VGK,26,82,12,18,30
8,8482159,Tyson Foerster,R,PHI,22,82,11,19,30
8,8475714,Calle Jarnkrok,C,TOR,33,82,11,19,30
8,8478882,Vladislav Gavrikov,D,LAK,29,82,9,21,30
8,8477435,Ryan Graves,D,PIT,29,82,6,24,30
8,8473507,Jeff Petry,D,DET,37,82,5,25,30
8,8476463,Jonas Brodin,D,MIN,31,82,5,25,30
8,8479976,Juuso Valimaki,D,UTA,26,82,4,26,30
8,8477845,Trevor van Riemsdyk,D,WSH,33,82,3,27,30
8,8483431,Logan Cooley,C,UTA,20,82,17,12,29
8,8476981,Josh Anderson,R,MTL,30,82,16,13,29
8,8480748,Kiefer Sherwood,L,VAN,29,82,15,14,29
8,8475848,Brendan Gallagher,R,MTL,32,82,13,16,29
8,8480144,David Kampf,C,TOR,29,82,12,17,29
8,8476624,Barclay Goodrow,C,SJS,31,82,12,17,29
8,8478413,Jordan Greenway,L,BUF,27,82,11,18,29
8,8476925,Colton Sissons,C,NSH,31,82,10,19,29
8,8477839,Conor Sheary,L,TBL,32,82,10,19,29
8,8482166,Shakir Mukhamadullin,D,SJS,22,82,10,19,29
8,8482105,Jake Sanderson,D,OTT,22,82,9,20,29
8,8482133,Thomas Bordeleau,C,SJS,22,82,9,20,29
8,8479980,Nicolas Hague,D,VGK,26,82,8,21,29
8,8477220,Nate Schmidt,D,FLA,33,82,7,22,29
8,8482073,Braden Schneider,D,NYR,23,82,6,23,29
8,8474673,TJ Brodie,D,CHI,34,82,4,25,29
8,8479393,Noah Gregor,C,OTT,26,82,15,13,28
8,8481704,Juuso Parssinen,C,NSH,23,82,14,14,28
8,8479996,Cody Glass,C,NSH,25,82,14,14,28
8,8482702,Logan Stankoven,C,DAL,21,82,14,14,28
8,8479591,Michael Eyssimont,C,TBL,28,82,13,15,28
8,8479390,Taylor Raddysh,R,WSH,26,82,13,15,28
8,8482074,Connor Zary,C,CGY,23,82,12,16,28
8,8476392,Adam Lowry,C,WPG,31,82,11,17,28
8,8475855,Jesper Fast,R,CAR,33,82,10,18,28
8,8475193,Tomas Tatar,L,NJD,34,82,7,21,28
8,8480873,Rasmus Sandin,D,WSH,24,82,4,24,28
8,8482079,Marco Rossi,C,MIN,23,82,19,8,27
8,8478432,Christian Fischer,R,DET,27,82,17,10,27
8,8484145,Zach Benson,L,BUF,19,82,13,14,27
8,8476897,Oskar Sundqvist,C,STL,30,82,12,15,27
8,8477919,Frederick Gaudreau,C,MIN,31,82,11,16,27
8,8479316,Luke Kunin,C,SJS,27,82,10,17,27
8,8482141,Lukas Cormier,D,VGK,22,82,9,18,27
8,8477392,Hudson Fasching,R,NYI,29,82,8,19,27
8,8482245,Artem Zub,D,OTT,29,82,6,21,27
8,8478840,Will Borgen,D,SEA,28,82,6,21,27
8,8480878,Nils Lundkvist,D,DAL,24,82,5,22,27
8,8478399,Jonas Siegenthaler,D,NJD,27,82,4,23,27
8,8476422,Mike Reilly,D,NYI,31,82,3,24,27
8,8483495,Simon Nemec,D,NJD,20,82,3,24,27
8,8480813,Joe Veleno,C,DET,24,82,14,12,26
8,8476921,Jordan Martinook,L,CAR,32,82,14,12,26
8,8478569,Noel Acciari,C,PIT,33,82,12,14,26
8,8476474,Stefan Noesen,R,NJD,31,82,11,15,26
8,8479359,Beck Malenstyn,L,BUF,26,82,10,16,26
8,8476312,Josh Manson,D,COL,33,82,8,18,26
8,8481553,Bobby Brink,R,PHI,23,82,8,18,26
8,8478211,Dryden Hunt,L,CGY,29,82,8,18,26
8,8477507,Nikita Zadorov,D,BOS,29,82,7,19,26
8,8478851,Alexandre Carrier,D,NSH,28,82,6,20,26
8,8478136,Jake Middleton,D,MIN,28,82,6,20,26
8,8479398,Samuel Girard,D,COL,26,82,2,24,26
8,8480222,Sebastian Aho,D,PIT,28,82,1,25,26
8,8473453,Trevor Lewis,C,LAK,37,82,14,11,25
8,8476858,Phillip Di Giuseppe,L,VAN,31,82,14,11,25
8,8480995,Pontus Holmberg,R,TOR,25,82,13,12,25
8,8477508,Curtis Lazar,C,NJD,29,82,12,13,25
8,8475231,Casey Cizikas,C,NYI,33,82,11,14,25
8,8478020,Michael Amadio,C,OTT,28,82,11,14,25
8,8477989,Christian Dvorak,C,MTL,28,82,11,14,25
8,8476374,Sean Kuraly,C,CBJ,31,82,9,16,25
8,8476902,Esa Lindell,D,DAL,30,82,5,20,25
8,8484203,Bradly Nadeau,L,CAR,19,82,5,20,25
8,8480860,Kevin Bahl,D,CGY,24,82,5,20,25
8,8479324,Ryan Lindgren,D,NYR,26,82,4,21,25
8,8475690,Chris Tanev,D,TOR,35,82,4,21,25
8,8474574,Tyler Myers,D,VAN,34,82,3,22,25
8,8479998,Mikey Anderson,D,LAK,25,82,2,23,25
8,8482655,J.J. Moser,D,TBL,24,82,2,23,25
8,8477429,Andrew Copp,C,DET,30,82,14,10,24
8,8482155,Alex Laferriere,R,LAK,23,82,14,10,24
8,8478508,Yakov Trenin,C,MIN,27,82,12,12,24
8,8480980,Connor Dewar,C,TOR,25,82,12,12,24
8,8477015,Connor Brown,R,EDM,30,82,11,13,24
8,8481601,Simon Holmstrom,R,NYI,23,82,8,16,24
8,8483482,Tristan Luneau,D,ANA,20,82,8,16,24
8,8478133,Jake Evans,C,MTL,28,82,7,17,24
8,8482666,Scott Morrow,D,CAR,22,82,7,17,24
8,8482142,Jamie Drysdale,D,PHI,22,82,6,18,24
8,8476525,Colin Miller,D,WPG,32,82,5,19,24
8,8476879,Cody Ceci,D,EDM,31,82,2,22,24
8,8478434,Keegan Kolesar,R,VGK,27,82,14,9,23
8,8481028,Martin Pospisil,C,CGY,25,82,13,10,23
8,8479661,Tanner Jeannot,L,LAK,27,82,12,11,23
8,8481481,Blake Lizotte,C,PIT,27,82,11,12,23
8,8480003,Jesper Boqvist,C,FLA,26,82,11,12,23
8,8477931,Tomas Nosek,L,FLA,32,82,10,13,23
8,8478891,Mason Appleton,C,WPG,28,82,9,14,23
8,8477406,Mattias Janmark,C,EDM,32,82,8,15,23
8,8482111,Justin Barron,D,MTL,23,82,8,15,23
8,8484153,Leo Carlsson,C,ANA,20,82,7,16,23
8,8476878,Zemgus Girgensons,L,TBL,30,82,15,7,22
8,8480281,Alexey Toropchenko,R,STL,25,82,14,8,22
8,8474715,Cam Atkinson,R,TBL,35,82,11,11,22
8,8481093,Rafael Harvey-Pinard,L,MTL,25,82,11,11,22
8,8476889,Radek Faksa,C,STL,30,82,10,12,22
8,8482259,Bobby McMann,C,TOR,28,82,7,15,22
8,8480074,Alexandre Texier,C,STL,25,82,6,16,22
8,8474013,Ian Cole,D,UTA,35,82,5,17,22
8,8483012,Logan Morrison,C,SEA,22,82,5,17,22
8,8480035,Henri Jokiharju,D,BUF,25,82,4,18,22
8,8477506,Ryan Pulock,D,NYI,30,82,3,19,22
8,8477365,Connor Clifton,D,BUF,29,82,3,19,22
8,8475233,David Savard,D,MTL,34,82,3,19,22
8,8481517,Brett Leason,R,ANA,25,82,11,10,21
8,8483457,Lane Hutson,D,MTL,20,82,10,11,21
8,8484911,Collin Graf,R,SJS,22,82,10,11,21
8,8482125,Alexander Holtz,R,VGK,22,82,9,12,21
8,8482153,Brendan Brisson,C,VGK,23,82,9,12,21
8,8480021,Jack Studnicka,C,LAK,25,82,6,15,21
8,8477499,Rasmus Ristolainen,D,PHI,30,82,6,15,21
8,8480789,Oliver Wahlstrom,R,NYI,24,82,5,16,21
8,8476467,Jamie Oleksiak,D,SEA,32,82,5,16,21
8,8482809,Jackson Blake,R,CAR,21,82,5,16,21
8,8476917,Adam Pelech,D,NYI,30,82,4,17,21
8,8480073,Erik Brannstrom,D,COL,25,82,4,17,21
8,8477369,Carson Soucy,D,VAN,30,82,4,17,21
8,8480879,Jacob Bernard-Docker,D,OTT,24,82,4,17,21
8,8475181,Nick Leddy,D,STL,33,82,3,18,21
8,8477450,Jason Dickinson,C,CHI,29,82,11,9,20
8,8483524,Shane Wright,C,SEA,20,82,11,9,20
8,8475842,Sam Carrick,C,NYR,32,82,9,11,20
8,8480796,Martin Fehervary,D,WSH,25,82,5,15,20
8,8481568,Alex Vlasic,D,CHI,23,82,4,16,20
8,8483505,Matthew Poitras,C,BOS,20,82,10,9,19
8,8482062,Cole Smith,L,NSH,29,82,9,10,19
8,8475177,Calvin de Haan,D,COL,33,82,9,10,19
8,8476442,Matt Nieto,L,PIT,32,82,8,11,19
8,8479368,Max Jones,L,BOS,26,82,8,11,19
8,8477903,Garnet Hathaway,R,PHI,33,82,7,12,19
8,8477335,Kyle Burroughs,D,LAK,29,82,6,13,19
8,8475462,Radko Gudas,D,ANA,34,82,5,14,19
8,8482807,Ethan Del Mastro,D,CHI,21,82,4,15,19
8,8482470,Ilya Solovyov,D,CGY,24,82,3,16,19
8,8479369,Andrew Peeke,D,BOS,26,82,3,16,19
8,8480246,Nick Perbix,D,TBL,26,82,3,16,19
8,8476931,Jake McCabe,D,TOR,31,82,2,17,19
8,8479371,Dante Fabbro,D,NSH,26,82,2,17,19
8,8482679,Matt Coronato,R,CGY,22,82,12,6,18
8,8476873,Mark Jankowski,C,NSH,30,82,10,8,18
8,8482077,Dylan Holloway,L,EDM,23,82,8,10,18
8,8483763,Maksymilian Szuber,D,UTA,22,82,7,11,18
8,8482858,Ryker Evans,D,SEA,23,82,6,12,18
8,8475279,Ben Chiarot,D,DET,33,82,4,14,18
8,8480172,Jan Rutta,D,SJS,34,82,4,14,18
8,8478443,Brandon Carlo,D,BOS,28,82,4,14,18
8,8475762,Derek Forbort,D,VAN,32,82,4,14,18
8,8476891,Matt Grzelcyk,D,PIT,30,82,3,15,18
8,8479983,Mario Ferraro,D,SJS,26,82,3,15,18
8,8483445,Cutter Gauthier,L,ANA,20,82,3,15,18
8,8481178,Egor Zamula,D,PHI,24,82,0,18,18
8,8482733,Logan Mailloux,D,MTL,31,82,4,13,17
8,8480807,Mattias Samuelsson,D,BUF,24,82,3,14,17
8,8478859,Niko Mikkola,D,FLA,28,82,3,14,17
8,8483490,Pavel Mintyukov,D,ANA,21,82,2,15,17
8,8475718,Justin Holl,D,DET,32,82,2,15,17
8,8477938,Haydn Fleury,D,WPG,28,82,2,15,17
8,8481708,Zac Jones,D,NYR,24,82,2,15,17
8,8476967,Brett Kulak,D,EDM,30,82,0,17,17
8,8480990,Declan Chisholm,D,MIN,24,82,8,8,16
8,8482749,Joshua Roy,R,MTL,21,82,8,8,16
8,8481605,Jackson LaCombe,D,ANA,23,82,6,10,16
8,8477034,Jaycob Megna,D,FLA,32,82,6,10,16
8,8478178,Darren Raddysh,D,TBL,28,82,5,11,16
8,8474090,Brendan Smith,D,DAL,35,82,4,12,16
8,8482516,Matthew Kessel,D,STL,24,82,4,12,16
8,8483493,Frank Nazar,C,CHI,20,82,4,12,16
8,8483565,Nick Blankenburg,D,NSH,26,82,3,13,16
8,8476429,Scott Mayfield,D,NYI,32,82,3,13,16
8,8481122,Simon Benoit,D,TOR,26,82,3,13,16
8,8476457,Adam Larsson,D,SEA,32,82,2,14,16
8,8470600,Ryan Suter,D,STL,39,82,2,14,16
8,8475790,Erik Gudbranson,D,CBJ,32,82,1,15,16
8,8481699,Aku Raty,R,UTA,23,82,9,6,15
8,8479291,Kevin Rooney,C,CGY,31,82,9,6,15
8,8481524,Bowen Byram,D,BUF,23,82,7,8,15
8,8479442,Troy Stecher,D,EDM,30,82,6,9,15
8,8480806,Isac Lundestrom,C,ANA,25,82,6,9,15
8,8475455,Brenden Dillon,D,NJD,34,82,5,10,15
8,8480950,Ilya Lyubushkin,D,DAL,30,82,4,11,15
8,8481567,Henry Thrun,D,SJS,23,82,3,12,15
8,8482118,Sam Colangelo,R,ANA,23,82,2,13,15
8,8477505,Alexander Wennberg,C,SJS,30,82,7,7,14
8,8482803,Olen Zellweger,D,ANA,21,82,6,8,14
8,8483468,Jiri Kulich,C,BUF,20,82,6,8,14
8,8482762,Simon Edvinsson,D,DET,21,82,5,9,14
8,8483499,Liam Ohgren,L,MIN,20,82,3,11,14
8,8482101,Danil Gushchin,L,SJS,22,82,3,11,14
8,8483460,David Jiricek,D,CBJ,21,82,2,12,14
8,8480025,MacKenzie Entwistle,R,FLA,25,82,8,5,13
8,8480448,Parker Kelly,L,COL,25,82,8,5,13
8,8478450,Parker Wotherspoon,D,BOS,27,82,3,10,13
8,8479576,Vincent Desharnais,D,VAN,28,82,3,10,13
8,8481641,Joel Kiviranta,L,COL,28,82,6,6,12
8,8481522,Peyton Krebs,C,BUF,23,82,5,7,12
8,8482712,Oskar Olausson,R,COL,22,82,4,8,12
8,8482787,Nikita Chibrikov,R,WPG,31,82,4,8,12
8,8475324,Nick Jensen,D,OTT,34,82,1,11,12
8,8478874,Adam Gaudette,C,OTT,28,82,1,11,12
8,8482859,Zack Ostapchuk,C,OTT,21,82,5,6,11
8,8483471,Brad Lambert,C,WPG,31,82,4,7,11
8,8480870,Bo Groulx,C,NYR,24,82,4,7,11
8,8482713,Mackie Samoskevich,R,FLA,22,82,4,7,11
8,8474062,Riley Nash,C,NYR,35,82,2,9,11
8,8476372,Nick Seeler,D,PHI,31,82,1,10,11
8,8476473,Connor Murphy,D,CHI,31,82,1,10,11
8,8482145,Mavrik Bourque,C,DAL,22,82,7,3,10
8,8484149,Gavin Brindley,C,CBJ,20,82,6,4,10
8,8474612,Travis Hamonic,D,OTT,34,82,3,7,10
8,8482070,Mitchell Chaffee,R,TBL,26,82,3,7,10
8,8483567,Georgii Merkulov,C,BOS,24,82,3,7,10
8,8478468,Jeremy Lauzon,D,NSH,27,82,1,9,10
8,8482659,Josh Doan,R,UTA,22,82,7,2,9
8,8479638,Justin Brazeau,R,BOS,26,82,6,3,9
8,8483466,Kevin Korchinski,D,CHI,20,82,3,6,9
8,8471677,Jack Johnson,D,CBJ,37,82,3,6,9
8,8476822,Luke Glendening,C,TBL,35,82,5,3,8
8,8483489,Fraser Minten,C,TOR,31,82,3,5,8
8,8474567,Zach Bogosian,D,MIN,34,82,1,7,8
8,8483397,Marc McLaughlin,C,BOS,25,82,4,3,7
8,8480834,Ty Emberson,D,SJS,24,82,2,5,7
8,8476441,Joel Edmundson,D,LAK,31,82,1,6,7
8,8470794,Joe Pavelski,C,,40,0,0,0,0
8,8481703,Valtteri Puustinen,R,PIT,25,0,0,0,0
8,8477950,Tony DeAngelo,D,,29,0,0,0,0
8,8481577,Philip Tomasino,C,NSH,23,0,0,0,0
8,8475197,Tyson Barrie,D,,33,0,0,0,0
8,8471218,Blake Wheeler,R,,38,0,0,0,0
8,8474157,Max Pacioretty,L,,36,0,0,0,0
8,8478466,Daniel Sprong,R,VAN,27,0,0,0,0
8,8475744,Evgeny Kuznetsov,C,,32,0,0,0,0
8,8481019,David Gustafsson,C,WPG,24,0,0,0,0
8,8475906,John Klingberg,D,,32,0,0,0,0
8,8479348,Kale Clague,D,BUF,26,0,0,0,0
8,8476952,Dominic Toninato,C,WPG,30,0,0,0,0
8,8473473,Milan Lucic,L,,36,0,0,0,0
8,8474037,James van Riemsdyk,L,,35,0,0,0,0
8,8474602,Justin Schultz,D,,34,0,0,0,0
8,8482222,Alexander Barabanov,L,,30,0,0,0,0
8,8479372,Josh Mahura,D,SEA,26,0,0,0,0
8,8479982,Conor Timmins,D,TOR,26,0,0,0,0
8,8474031,Kevin Shattenkirk,D,,35,0,0,0,0
8,8480008,Adam Ruzicka,C,,25,0,0,0,0
8,8481059,Scott Perunovich,D,STL,26,0,0,0,0
8,8480884,Calen Addison,D,,24,0,0,0,0
8,8476994,Vinnie Hinostroza,C,NSH,30,0,0,0,0
8,8478452,Caleb Jones,D,LAK,27,0,0,0,0
8,8480157,Calle Rosen,D,COL,30,0,0,0,0
8,8481609,Vladislav Kolyachonok,D,UTA,23,0,0,0,0
8,8479415,Michael McLeod,C,,26,0,0,0,0
8,8476919,Chris Tierney,C,,30,0,0,0,0
8,8479639,Dylan Coghlan,D,WPG,26,0,0,0,0
8,8478146,Matthew Highmore,C,OTT,28,0,0,0,0
8,8478970,Jalen Chatfield,D,CAR,28,0,0,0,0
8,8480205,Emil Bemstrom,C,PIT,25,0,0,0,0
8,8474884,Mike Hoffman,C,,35,0,0,0,0
8,8471274,Alex Goligoski,D,,39,0,0,0,0
8,8478104,Sammy Blais,L,,28,0,0,0,0
8,8474870,Tyler Johnson,C,,34,0,0,0,0
8,8476913,Devin Shore,C,MIN,30,0,0,0,0
8,8481598,Philip Broberg,D,EDM,23,0,0,0,0
8,8480058,Pierre-Olivier Joseph,D,STL,25,0,0,0,0
8,8480891,Michael Kesselring,D,UTA,24,0,0,0,0
8,8477979,Nicolas Aube-Kubel,R,BUF,28,0,0,0,0
8,8476871,Tanner Pearson,L,,32,0,0,0,0
8,8476393,Nick Cousins,C,,31,0,0,0,0
8,8479977,Kailer Yamamoto,R,,26,0,0,0,0
8,8479543,Michael Pezzetta,L,MTL,26,0,0,0,0
8,8477018,Ben Hutton,D,VGK,31,0,0,0,0
8,8480762,Eric Robinson,L,CAR,29,0,0,0,0
8,8474034,Pat Maroon,L,CHI,36,0,0,0,0
8,8481058,Jesse Ylönen,R,,25,0,0,0,0
8,8475179,Dmitry Kulikov,D,FLA,34,0,0,0,0
8,8481527,Kaedan Korczak,D,VGK,23,0,0,0,0
8,8473449,Kyle Okposo,R,,36,0,0,0,0
8,8482192,Isaak Phillips,D,CHI,23,0,0,0,0
8,8480727,Zach Whitecloud,D,VGK,28,0,0,0,0
8,8479346,Dillon Dube,C,,26,0,0,0,0
8,8480821,Filip Zadina,R,,25,0,0,0,0
8,8480001,Urho Vaakanainen,D,ANA,25,0,0,0,0
8,8470966,Mark Giordano,D,,41,0,0,0,0
8,8480853,Liam Foudy,C,,24,0,0,0,0
8,8475225,Craig Smith,C,CHI,35,0,0,0,0
8,8479972,Mason Shaw,C,WPG,26,0,0,0,0
8,8478451,Ethan Bear,D,WSH,27,0,0,0,0
8,8474040,Sam Gagner,C,,35,0,0,0,0
8,8480196,Jacob Bryson,D,BUF,27,0,0,0,0
8,8479984,Cal Foote,D,,26,0,0,0,0
8,8480011,Klim Kostin,C,SJS,25,0,0,0,0
8,8482176,Wyatt Kaiser,D,CHI,22,0,0,0,0
8,8476988,Matt Benning,D,SJS,30,0,0,0,0
8,8479370,Tyson Jost,C,CAR,26,0,0,0,0
8,8477464,Nic Petan,C,,29,0,0,0,0
8,8477380,Jonny Brodzinski,C,NYR,31,0,0,0,0
8,8480070,Ian Mitchell,D,BOS,25,0,0,0,0
8,8479315,Joey Anderson,R,CHI,26,0,0,0,0
8,8478099,Kevin Labanc,R,,29,0,0,0,0
8,8476874,Olli Maatta,D,DET,30,0,0,0,0
8,8475208,Brian Dumoulin,D,ANA,33,0,0,0,0
8,8478430,Oliver Kylington,D,,27,0,0,0,0
8,8479536,Axel Jonsson-Fjallby,L,WPG,26,0,0,0,0
8,8479671,Mathieu Olivier,R,CBJ,27,0,0,0,0
8,8471709,Marc-Edouard Vlasic,D,SJS,37,0,0,0,0
8,8479328,Julien Gauthier,R,NYI,27,0,0,0,0
8,8478421,A.J. Greer,L,FLA,28,0,0,0,0
8,8477573,Nathan Walker,L,STL,30,0,0,0,0
8,8481537,Nikita Okhotiuk,D,CGY,24,0,0,0,0
8,8474166,Alec Martinez,D,CHI,37,0,0,0,0
8,8470610,Zach Parise,L,,40,0,0,0,0
8,8477478,William Carrier,L,CAR,30,0,0,0,0
8,8479344,Jesse Puljujarvi,R,PIT,26,0,0,0,0
8,8480887,Jordan Harris,D,MTL,24,0,0,0,0
8,8478502,Dennis Gilbert,D,BUF,28,0,0,0,0
8,8482730,Brandt Clarke,D,LAK,21,0,0,0,0
8,8480355,Mark Kastelic,C,BOS,25,0,0,0,0
8,8475750,Jon Merrill,D,MIN,32,0,0,0,0
8,8475164,Jakob Silfverberg,R,,34,0,0,0,0
8,8477944,Jakub Vrana,L,,28,0,0,0,0
8,8479439,Jacob MacDonald,D,COL,31,0,0,0,0
8,8474568,Luke Schenn,D,NSH,35,0,0,0,0
8,8478454,Noah Juulsen,D,VAN,27,0,0,0,0
8,8475752,Tyler Pitlick,C,,33,0,0,0,0
8,8482148,Hendrix Lapierre,C,WSH,22,0,0,0,0
8,8481167,Brayden Pachal,D,CGY,25,0,0,0,0
8,8478043,Sam Lafferty,C,BUF,29,0,0,0,0
8,8479321,Lucas Johansen,D,,27,0,0,0,0
8,8471699,Andrew Cogliano,C,,37,0,0,0,0
8,8481521,Ronnie Attard,D,PHI,25,0,0,0,0
8,8481161,Jake Christiansen,D,CBJ,25,0,0,0,0
8,8479458,Nikita Zaitsev,D,,33,0,0,0,0
8,8479619,Michael Carcone,L,UTA,28,0,0,0,0
8,8479026,Philippe Myers,D,TOR,27,0,0,0,0
8,8477330,Dominik Kubalik,L,,29,0,0,0,0
8,8481617,Vasily Podkolzin,R,VAN,23,0,0,0,0
8,8481701,Santeri Hatakka,D,NJD,23,0,0,0,0
8,8479514,Rem Pitlick,C,,27,0,0,0,0
8,8477446,Michael McCarron,R,NSH,29,0,0,0,0
8,8470604,Jeff Carter,C,,39,0,0,0,0
8,8482241,Radim Zohorna,L,,28,0,0,0,0
8,8480289,Morgan Barron,C,WPG,26,0,0,0,0
8,8479379,Givani Smith,R,SJS,26,0,0,0,0
8,8480216,Jacob Peterson,C,,25,0,0,0,0
8,8477851,Jordan Oesterle,D,BOS,32,0,0,0,0
8,8484258,Sam Malinski,D,COL,26,0,0,0,0
8,8478904,Steven Lorentz,C,,28,0,0,0,0
8,8482095,Tyler Kleven,D,OTT,22,0,0,0,0
8,8480848,Ty Dellandrea,C,SJS,24,0,0,0,0
8,8476884,Derrick Pouliot,D,,30,0,0,0,0
8,8479336,Carl Grundstrom,R,SJS,27,0,0,0,0
8,8482964,Arber Xhekaj,D,MTL,23,0,0,0,0
8,8471686,Marc Staal,D,,37,0,0,0,0
8,8477887,Patrick Brown,C,BOS,32,0,0,0,0
8,8478495,Denis Gurianov,R,,27,0,0,0,0
8,8473504,Cal Clutterbuck,R,,37,0,0,0,0
8,8481550,Adam Beckman,L,NJD,23,0,0,0,0
8,8480845,Rasmus Kupari,C,WPG,24,0,0,0,0
8,8474009,Nick Bonino,C,,36,0,0,0,0
8,8478585,Derek Ryan,C,EDM,38,0,0,0,0
8,8477962,Brendan Lemieux,L,CAR,28,0,0,0,0
8,8482861,Vincent Iorio,D,WSH,22,0,0,0,0
8,8479378,Logan Stanley,D,WPG,26,0,0,0,0
8,8473446,Erik Johnson,D,PHI,36,0,0,0,0
8,8481743,Marc Del Gaizo,D,NSH,25,0,0,0,0
8,8477384,Josh Brown,D,EDM,30,0,0,0,0
8,8482165,Yan Kuznetsov,D,CGY,22,0,0,0,0
8,8478424,Jansen Harkins,C,ANA,27,0,0,0,0
8,8482144,Jack Thompson,D,SJS,22,0,0,0,0
8,8478512,Austin Czarnik,C,,32,0,0,0,0
8,8477527,Ross Johnston,L,ANA,30,0,0,0,0
8,8479383,Boris Katchouk,L,,26,0,0,0,0
8,8482094,Daemon Hunt,D,MIN,22,0,0,0,0
8,8481719,Maxwell Crozier,D,TBL,24,0,0,0,0
8,8480192,Johnathan Kovacevic,D,NJD,27,0,0,0,0
8,8479376,Victor Mete,D,,26,0,0,0,0
8,8482511,Mason Lohrei,D,BOS,23,0,0,0,0
8,8475825,Jani Hakanpää,D,,32,0,0,0,0
8,8478021,William Lagesson,D,DET,28,0,0,0,0
8,8475795,Dylan McIlrath,D,WSH,32,0,0,0,0
8,8477846,Ryan Carpenter,C,,33,0,0,0,0
8,8481056,Spencer Stastney,D,NSH,24,0,0,0,0
8,8481564,Ryan Johnson,D,BUF,23,0,0,0,0
8,8478017,Mark Friedman,D,VAN,29,0,0,0,0
8,8479320,Max Lajoie,D,SEA,27,0,0,0,0
8,8480075,Cameron Crotty,D,MIN,25,0,0,0,0
8,8484287,Cole McWard,D,VAN,23,0,0,0,0
8,8484254,Akito Hirose,D,VAN,25,0,0,0,0
8,8483407,Brandon Scanlin,D,NYR,25,0,0,0,0
8,8480274,Philip Kemp,D,EDM,25,0,0,0,0
8,8479522,Hardy Haman Aktell,D,WSH,26,0,0,0,0
8,8480007,Jonas Rondbjerg,R,VGK,25,0,0,0,0
8,8477454,Adam Erne,L,,29,0,0,0,0
8,8481679,Maxence Guenette,D,OTT,23,0,0,0,0
8,8480441,Trey Fix-Wolansky,R,CBJ,25,0,0,0,0
8,8483546,Marshall Rifai,D,TOR,26,0,0,0,0
8,8480084,Nick DeSimone,D,NJD,30,0,0,0,0
8,8481030,Jack St. Ivany,D,PIT,25,0,0,0,0
8,8481592,Jakob Pelletier,L,CGY,23,0,0,0,0
8,8478011,Louie Belpedio,D,PHI,28,0,0,0,0
8,8477930,Pierre-Edouard Bellemare,L,,39,0,0,0,0
8,8484321,Nikolas Matinpalo,D,OTT,26,0,0,0,0
8,8482067,Connor Mackey,D,NYR,28,0,0,0,0
8,8481806,Louis Crevier,D,CHI,23,0,0,0,0
8,8484326,Patrik Koch,D,UTA,28,0,0,0,0
8,8477971,Andreas Englund,D,LAK,28,0,0,0,0
8,8481751,Lukas Rousek,R,BUF,25,0,0,0,0
8,8481006,Tyler Tucker,D,STL,24,0,0,0,0
8,8476867,Brendan Gaunce,C,MIN,30,0,0,0,0
8,8479520,Brandon Duhaime,R,WSH,27,0,0,0,0
8,8477073,Kurtis MacDermid,L,NJD,30,0,0,0,0
8,8480874,Adam Ginning,D,PHI,24,0,0,0,0
8,8477473,Justin Bailey,R,SJS,29,0,0,0,0
8,8479066,Ryan Lomberg,L,CGY,30,0,0,0,0
8,8477070,Liam O'Brien,C,UTA,30,0,0,0,0
8,8474618,Marco Scandella,D,,34,0,0,0,0
8,8475797,Jarred Tinordi,D,,32,0,0,0,0
8,8481441,Joe Snively,C,DET,28,0,0,0,0
8,8477244,Chad Ruhwedel,D,NYR,34,0,0,0,0
8,8479772,Zack MacEwen,R,OTT,28,0,0,0,0
8,8481147,Reese Johnson,C,MIN,26,0,0,0,0
8,8481043,Cole Koepke,L,BOS,26,0,0,0,0
8,8483619,Filip Roos,D,OTT,25,0,0,0,0
8,8481541,Samuel Bolduc,D,NYI,24,0,0,0,0
8,8477810,Joel Hanley,D,CGY,33,0,0,0,0
8,8476907,Mackenzie MacEachern,L,,30,0,0,0,0
8,8482652,Walker Duehr,R,CGY,27,0,0,0,0
8,8477126,Jayson Megna,C,,34,0,0,0,0
8,8483398,Declan Carlile,D,TBL,31,0,0,0,0
8,8482929,Emil Lilleberg,D,TBL,23,0,0,0,0
8,8480880,Jakub Lauko,C,MIN,24,0,0,0,0
8,8480245,Olle Lycksell,R,PHI,25,0,0,0,0
8,8480252,Cole Guttman,C,CHI,25,0,0,0,0
8,8477467,Gustav Olofsson,D,SEA,30,0,0,0,0
8,8479968,Vinni Lettieri,C,BOS,29,0,0,0,0
8,8478400,Colin White,C,,27,0,0,0,0
8,8475755,Alexander Petrovic,D,DAL,32,0,0,0,0
8,8481812,Nikolai Knyzhov,D,,27,0,0,0,0
8,8481593,Jayden Struble,D,MTL,23,0,0,0,0
8,8481532,Alex Turcotte,C,LAK,23,0,0,0,0
8,8482126,Emil Andrae,D,PHI,31,0,0,0,0
8,8479944,Zach Aston-Reese,C,VGK,30,0,0,0,0
8,8471817,Ryan Reaves,R,TOR,37,0,0,0,0
8,8481206,John Ludvig,D,PIT,24,0,0,0,0
8,8481599,Victor Soderstrom,D,UTA,23,0,0,0,0
8,8480292,Carson Meyer,R,ANA,27,0,0,0,0
8,8482496,Nils Aman,C,VAN,24,0,0,0,0
8,8479718,Alex Barré-Boulet,C,MTL,27,0,0,0,0
8,8479994,Jaret Anderson-Dolan,C,WPG,25,0,0,0,0
8,8480184,Gustav Lindstrom,D,,26,0,0,0,0
8,8480890,Jan Jenik,R,OTT,24,0,0,0,0
8,8478067,Oskar Lindblom,L,,28,0,0,0,0
8,8476934,Brock McGinn,L,ANA,30,0,0,0,0
8,8479985,Cale Fleury,D,SEA,26,0,0,0,0
8,8484304,Uvis Balinskis,D,FLA,28,0,0,0,0
8,8479981,Jonah Gadjovich,L,FLA,26,0,0,0,0
8,8481716,Dmitri Voronkov,L,CBJ,24,0,0,0,0
8,8474709,Matt Martin,L,,35,0,0,0,0
8,8482634,Alex Steeves,C,TOR,25,0,0,0,0
8,8480823,Alexander Alexeyev,D,WSH,25,0,0,0,0
8,8477541,Dakota Mermis,D,TOR,30,0,0,0,0
8,8483491,Ivan Miroshnichenko,L,WSH,20,0,0,0,0
8,8478477,Mitchell Stephens,C,SEA,27,0,0,0,0
8,8481543,Nikita Alexandrov,C,STL,24,0,0,0,0
8,8479423,Alex Nylander,L,,26,0,0,0,0
8,8482451,Mikael Pyyhtia,L,CBJ,23,0,0,0,0
8,8478831,Kevin Stenlund,C,UTA,28,0,0,0,0
8,8480306,Grant Hutton,D,NYI,29,0,0,0,0
8,8478028,Fredrik Olofsson,L,,28,0,0,0,0
8,8477462,Robert Hagg,D,VGK,29,0,0,0,0
8,8477320,Anton Blidh,L,NYR,29,0,0,0,0
8,8482157,Will Cuylle,L,NYR,22,0,0,0,0
8,8482737,Zack Bolduc,C,STL,21,0,0,0,0
8,8481239,Samuel Fagemo,L,,24,0,0,0,0
8,8481600,Tobias Bjornfot,D,FLA,23,0,0,0,0
8,8478409,Anthony Richard,C,PHI,28,0,0,0,0
8,8474145,Robert Bortuzzo,D,,35,0,0,0,0
8,8475958,Michael Sgarbossa,C,WSH,32,0,0,0,0
8,8479986,Kole Lind,R,DAL,26,0,0,0,0
8,8479249,Andrew Poturalski,C,SJS,30,0,0,0,0
8,8479362,Riley Tufte,L,BOS,26,0,0,0,0
8,8479991,Jake Leschyshyn,C,NYR,25,0,0,0,0
8,8479587,Rhett Gardner,C,PHI,28,0,0,0,0
8,8482744,James Malatesta,L,CBJ,21,0,0,0,0
8,8478854,Ryan Shea,D,PIT,27,0,0,0,0
8,8481591,Sam Poulin,R,,23,0,0,0,0
8,8483512,Matt Savoie,C,EDM,20,0,0,0,0
8,8482102,Vasily Ponomarev,C,PIT,22,0,0,0,0
8,8482162,Roby Jarventie,L,EDM,22,0,0,0,0
8,8481016,Ruslan Iskhakov,C,,24,0,0,0,0
8,8482172,Landon Slaggert,L,CHI,22,0,0,0,0
8,8482747,Brennan Othmann,L,NYR,21,0,0,0,0
8,8480031,Maxime Comtois,L,,25,0,0,0,0
8,8480226,Marián Studenic,R,,26,0,0,0,0
8,8478408,Travis Dermott,D,,28,0,0,0,0
8,8481518,Nolan Foote,L,NJD,24,0,0,0,0
8,8479419,Brett Murray,L,BUF,26,0,0,0,0
8,8482088,Justin Sourdif,R,FLA,22,0,0,0,0
8,8482201,Gage Goncalves,C,TBL,23,0,0,0,0
8,8481578,Graeme Clarke,R,MIN,23,0,0,0,0
8,8482177,Marat Khusnutdinov,C,MIN,22,0,0,0,0
8,8481754,Nikita Nesterenko,C,ANA,23,0,0,0,0
8,8483531,Brian Halonen,L,NJD,25,0,0,0,0
8,8483920,Pierrick Dube,R,WSH,23,0,0,0,0
8,8480851,Akil Thomas,C,LAK,24,0,0,0,0
8,8475235,Nicolas Deslauriers,L,PHI,33,0,0,0,0
8,8482476,Emil Heineman,L,MTL,23,0,0,0,0
8,8477149,Scott Sabourin,R,SJS,32,0,0,0,0
8,8483549,Lucas Condotta,L,MTL,27,0,0,0,0
8,8482765,Isak Rosen,R,BUF,21,0,0,0,0
8,8481237,Kyle MacLean,C,NYI,25,0,0,0,0
8,8481024,Linus Karlsson,C,VAN,25,0,0,0,0
8,8481690,Tyler Angle,C,,24,0,0,0,0
8,8483570,Ben Meyers,C,SEA,26,0,0,0,0
8,8481655,Cole Schwindt,R,CGY,23,0,0,0,0
8,8481462,Mason Morelli,L,VGK,28,0,0,0,0
8,8483401,Marc Johnstone,R,PIT,28,0,0,0,0
8,8478956,Samuel Laberge,L,NJD,27,0,0,0,0
8,8479533,Joona Koppanen,L,,26,0,0,0,0
8,8482197,Adam Raska,R,MIN,23,0,0,0,0
8,8482250,Callahan Burke,C,VGK,27,0,0,0,0
8,8482784,Zach Dean,C,STL,21,0,0,0,0
8,8484255,Jason Polin,R,COL,25,0,0,0,0
8,8481077,John Leonard,L,,26,0,0,0,0
8,8481534,Raphael Lavoie,C,EDM,24,0,0,0,0
8,8483609,Adam Klapka,R,CGY,24,0,0,0,0
8,8482751,Ryan Winterton,C,SEA,21,0,0,0,0
8,8480267,Sammy Walker,C,MIN,25,0,0,0,0
8,8475766,Austin Watson,L,,32,0,0,0,0
8,8482460,Matt Rempe,C,NYR,22,0,0,0,0
8,8481065,Angus Crookshank,L,OTT,25,0,0,0,0
8,8481070,Hugh McGing,L,,26,0,0,0,0
8,8476323,Max McCormick,L,SEA,32,0,0,0,0
8,8483395,Arshdeep Bains,L,VAN,23,0,0,0,0
8,8484259,Ondrej Pavel,C,COL,31,0,0,0,0
8,8483432,Luca Del Bel Belluz,C,CBJ,31,0,0,0,0
8,8483045,Cameron Butler,R,CBJ,31,0,0,0,0
8,8482061,Brandon Biro,L,SEA,26,0,0,0,0
8,8477401,John Hayden,C,SEA,29,0,0,0,0
8,8475278,Byron Froese,C,,33,0,0,0,0
8,8478446,Glenn Gawdin,C,LAK,27,0,0,0,0
8,8477993,Justin Kirkland,C,CGY,28,0,0,0,0
8,8482147,Jean-Luc Foudy,C,COL,22,0,0,0,0
8,8480032,Shane Bowers,C,NJD,25,0,0,0,0
8,8479330,Brandon Gignac,C,MTL,27,0,0,0,0
8,8480776,Sheldon Rempal,R,,29,0,0,0,0
8,8475413,Justin Dowling,C,NJD,34,0,0,0,0
8,8481726,Adam Edstrom,C,NYR,24,0,0,0,0
8,8480844,Grigori Denisenko,L,VGK,24,0,0,0,0
8,8478147,Bokondji Imama,L,PIT,28,0,0,0,0
8,8478881,Brett Seney,L,CHI,28,0,0,0,0
8,8483630,Pavol Regenda,L,ANA,25,0,0,0,0
8,8480836,Jonathan Gruden,C,,24,0,0,0,0
8,8484314,Jiri Smejkal,L,,28,0,0,0,0
8,8475780,Chris Wagner,R,COL,33,0,0,0,0
8,8479546,Oskar Steen,C,,26,0,0,0,0
8,8483597,Milos Kelemen,L,UTA,25,0,0,0,0
8,8481789,Tye Kartye,L,SEA,23,0,0,0,0
8,8484325,Waltteri Merela,C,TBL,26,0,0,0,0
8,8479421,Jacob Moverare,D,LAK,26,0,0,0,0
8,8481585,Egor Afanasyev,L,SJS,23,0,0,0,0
8,8479547,Matthew Phillips,R,,26,0,0,0,0
8,8479367,William Lockwood,R,FLA,26,0,0,0,0
8,8476915,Jujhar Khaira,L,,30,0,0,0,0
8,8481422,Jacob Lucchini,C,NSH,29,0,0,0,0
8,8480468,James Hamblin,L,EDM,25,0,0,0,0
8,8478051,Max Willman,C,NJD,29,0,0,0,0
8,8481556,John Beecher,C,BOS,23,0,0,0,0
8,8478078,Rourke Chartier,C,,28,0,0,0,0
9,8478402,Connor McDavid,C,EDM,27,82,42,120,162
9,8479318,Auston Matthews,C,TOR,27,82,73,66,139
9,8477956,David Pastrnak,R,BOS,28,82,70,64,134
9,8477492,Nathan MacKinnon,C,COL,29,82,54,77,131
9,8477934,Leon Draisaitl,C,EDM,29,82,50,66,116
9,8478420,Mikko Rantanen,R,COL,28,82,49,59,108
9,8478550,Artemi Panarin,L,NYR,33,82,40,65,105
9,8478427,Sebastian Aho,C,CAR,27,82,38,66,104
9,8481557,Matt Boldy,L,MIN,23,82,44,58,102
9,8476453,Nikita Kucherov,R,TBL,31,82,29,72,101
9,8477942,Kevin Fiala,L,LAK,28,82,38,62,100
9,8477939,William Nylander,R,TOR,28,82,43,56,99
9,8476887,Filip Forsberg,L,NSH,30,82,45,53,98
9,8471675,Sidney Crosby,C,PIT,37,82,46,51,97
9,8475913,Mark Stone,R,VGK,32,82,34,62,96
9,8478445,Mathew Barzal,C,NYI,27,82,27,69,96
9,8480800,Quinn Hughes,D,VAN,25,82,17,79,96
9,8476468,J.T. Miller,C,VAN,31,82,33,62,95
9,8478864,Kirill Kaprizov,L,MIN,27,82,37,57,94
9,8475172,Nazem Kadri,C,CGY,34,82,40,53,93
9,8480023,Robert Thomas,C,STL,25,82,28,65,93
9,8479420,Tage Thompson,C,BUF,27,82,41,51,92
9,8477404,Jake Guentzel,C,TBL,30,82,42,49,91
9,8479407,Jesper Bratt,L,NJD,26,82,35,55,90
9,8480012,Elias Pettersson,C,VAN,26,82,39,50,89
9,8480027,Jason Robertson,L,DAL,25,82,34,55,89
9,8480069,Cale Makar,D,COL,26,82,30,59,89
9,8480801,Brady Tkachuk,L,OTT,25,82,41,47,88
9,8478398,Kyle Connor,L,WPG,28,82,38,50,88
9,8473419,Brad Marchand,L,BOS,36,82,31,57,88
9,8479314,Matthew Tkachuk,L,FLA,27,82,20,68,88
9,8478010,Brayden Point,C,TBL,28,82,42,45,87
9,8478403,Jack Eichel,C,VGK,28,82,39,48,87
9,8476346,Johnny Gaudreau,L,CBJ,31,82,27,60,87
9,8476881,Tomas Hertl,C,VGK,31,82,40,46,86
9,8476459,Mika Zibanejad,C,NYR,31,82,33,52,85
9,8481559,Jack Hughes,C,NJD,23,82,36,48,84
9,8474564,Steven Stamkos,C,NSH,34,82,35,48,83
9,8479337,Alex DeBrincat,R,DET,27,82,31,52,83
9,8477493,Aleksander Barkov,C,FLA,29,82,24,58,82
9,8475810,Bryan Rust,R,PIT,32,82,43,38,81
9,8480830,Andrei Svechnikov,R,CAR,24,82,35,46,81
9,8482116,Tim Stützle,C,OTT,22,82,34,47,81
9,8474600,Roman Josi,D,NSH,34,82,18,63,81
9,8476539,Jonathan Marchessault,R,NSH,34,82,39,41,80
9,8476448,William Karlsson,C,VGK,31,82,42,37,79
9,8477946,Dylan Larkin,C,DET,28,82,39,40,79
9,8477402,Pavel Buchnevich,L,STL,29,82,35,44,79
9,8477501,Valeri Nichushkin,R,COL,29,82,34,45,79
9,8471215,Evgeni Malkin,C,PIT,38,82,26,53,79
9,8478449,Roope Hintz,C,DAL,28,82,36,42,78
9,8477955,Jared McCann,L,SEA,28,82,39,38,77
9,8476389,Vincent Trocheck,C,NYR,31,82,26,51,77
9,8476454,Ryan Nugent-Hopkins,C,EDM,31,82,23,54,77
9,8477409,Carter Verhaeghe,C,FLA,29,82,43,33,76
9,8477935,Sam Bennett,C,FLA,28,82,41,35,76
9,8478493,Joel Eriksson Ek,C,MIN,27,82,31,45,76
9,8475784,Jeff Skinner,C,EDM,32,82,30,46,76
9,8481523,Kirby Dach,C,MTL,23,82,15,61,76
9,8479325,Charlie McAvoy,D,BOS,27,82,13,63,76
9,8480039,Martin Necas,C,CAR,25,82,41,34,75
9,8475158,Ryan O'Reilly,C,NSH,33,82,30,44,74
9,8475166,John Tavares,C,TOR,34,82,29,45,74
9,8479323,Adam Fox,D,NYR,26,82,17,57,74
9,8482093,Seth Jarvis,C,CAR,22,82,36,37,73
9,8478444,Brock Boeser,R,VAN,27,82,28,45,73
9,8471214,Alex Ovechkin,L,WSH,39,82,26,47,73
9,8481533,Trevor Zegras,C,ANA,23,82,26,47,73
9,8480803,Evan Bouchard,D,EDM,25,82,17,56,73
9,8475798,Mikael Granlund,C,SJS,32,82,17,56,73
9,8480208,Drake Batherson,R,OTT,26,82,28,44,72
9,8479542,Brandon Hagel,L,TBL,26,82,30,41,71
9,8471685,Anze Kopitar,C,LAK,37,82,19,52,71
9,8475167,Victor Hedman,D,TBL,34,82,13,58,71
9,8478414,Timo Meier,R,NJD,28,82,37,33,70
9,8477933,Sam Reinhart,C,FLA,29,82,33,37,70
9,8479343,Clayton Keller,R,UTA,26,82,32,38,70
9,8478401,Pavel Zacha,C,BOS,27,82,31,39,70
9,8478498,Jake DeBrusk,L,VAN,28,82,33,36,69
9,8480002,Nico Hischier,C,NJD,25,82,31,38,69
9,8479385,Jordan Kyrou,C,STL,26,82,28,41,69
9,8480036,Miro Heiskanen,D,DAL,25,82,14,55,69
9,8475184,Chris Kreider,L,NYR,33,82,39,29,68
9,8481540,Cole Caufield,R,MTL,23,82,34,34,68
9,8475765,Vladimir Tarasenko,R,DET,33,82,27,41,68
9,8478042,Viktor Arvidsson,R,EDM,31,82,22,46,68
9,8476875,Mike Matheson,D,MTL,30,82,13,55,68
9,8477447,Shea Theodore,D,VGK,29,82,12,56,68
9,8475169,Evander Kane,L,EDM,33,82,42,25,67
9,8478439,Travis Konecny,R,PHI,27,82,28,39,67
9,8480018,Nick Suzuki,C,MTL,25,82,24,43,67
9,8477500,Bo Horvat,C,NYI,29,82,34,32,66
9,8477416,Oliver Bjorkstrand,R,SEA,29,82,28,38,66
9,8474141,Patrick Kane,R,DET,36,82,23,43,66
9,8475726,Tyler Toffoli,C,SJS,32,82,30,35,65
9,8482078,Lucas Raymond,L,DET,22,82,23,41,64
9,8475692,Mats Zuccarello,R,MIN,37,82,18,46,64
9,8480865,Noah Dobson,D,NYI,24,82,16,48,64
9,8477495,Seth Jones,D,CHI,30,82,16,48,64
9,8478469,Thomas Chabot,D,OTT,27,82,13,51,64
9,8476853,Morgan Rielly,D,TOR,30,82,10,54,64
9,8476460,Mark Scheifele,C,WPG,31,82,32,31,63
9,8473994,Jamie Benn,L,DAL,35,82,27,36,63
9,8478396,Noah Hanifin,D,VGK,27,82,19,44,63
9,8479999,Casey Mittelstadt,C,COL,26,82,18,45,63
9,8482745,Mason McTavish,C,ANA,21,82,29,33,62
9,8477951,Nick Schmaltz,C,UTA,28,82,19,43,62
9,8475753,Justin Faulk,D,STL,32,82,18,44,62
9,8476869,Brady Skjei,D,NSH,30,82,14,48,62
9,8475786,Zach Hyman,L,EDM,32,82,33,28,61
9,8477949,Alex Tuch,R,BUF,28,82,23,38,61
9,8475151,Kyle Palmieri,C,NYI,33,82,23,38,61
9,8477940,Nikolaj Ehlers,L,WPG,28,82,23,38,61
9,8480798,Philipp Kurashev,C,CHI,25,82,22,39,61
9,8477496,Elias Lindholm,C,BOS,30,82,19,42,61
9,8475168,Matt Duchene,C,DAL,33,82,30,30,60
9,8476882,Teuvo Teravainen,L,CHI,30,82,25,35,60
9,8482665,Matty Beniers,C,SEA,22,82,24,36,60
9,8476479,Phillip Danault,C,LAK,31,82,24,36,60
9,8474565,Alex Pietrangelo,D,VGK,34,82,13,47,60
9,8480078,Filip Chytil,C,NYR,25,82,25,34,59
9,8474679,Gustav Nyquist,C,NSH,35,82,16,43,59
9,8476432,Boone Jenner,C,CBJ,31,82,33,25,58
9,8475754,Brock Nelson,C,NYI,33,82,30,28,58
9,8473986,Alex Killorn,L,ANA,35,82,23,35,58
9,8474586,Jordan Eberle,R,SEA,34,82,23,35,58
9,8479339,Patrik Laine,L,CBJ,26,82,18,40,58
9,8477494,Jonathan Drouin,L,COL,29,82,18,40,58
9,8474590,John Carlson,D,WSH,34,82,13,45,58
9,8479675,Trevor Moore,L,LAK,29,82,31,26,57
9,8482159,Tyson Foerster,R,PHI,22,82,29,28,57
9,8479400,Pierre-Luc Dubois,L,WSH,26,82,27,30,57
9,8477964,Ivan Barbashev,C,VGK,29,82,25,32,57
9,8478873,Troy Terry,R,ANA,27,82,23,34,57
9,8478458,Jack Roslovic,C,CAR,27,82,23,34,57
9,8477479,Tyler Bertuzzi,L,CHI,29,82,22,35,57
9,8476826,Yanni Gourde,C,SEA,33,82,21,36,57
9,8478460,Zach Werenski,D,CBJ,27,82,16,41,57
9,8476905,Chandler Stephenson,C,SEA,30,82,16,41,57
9,8480839,Rasmus Dahlin,D,BUF,24,82,16,41,57
9,8474641,Adam Henrique,C,EDM,34,82,32,24,56
9,8478519,Anthony Cirelli,C,TBL,27,82,26,30,56
9,8481528,Dylan Cozens,C,BUF,23,82,21,35,56
9,8478975,Mason Marchment,L,DAL,29,82,21,35,56
9,8475170,Brayden Schenn,C,STL,33,82,18,38,56
9,8480028,Morgan Frost,C,PHI,25,82,16,40,56
9,8477504,Josh Morrissey,D,WPG,29,82,10,46,56
9,8477407,Anthony Duclair,L,NYI,29,82,25,30,55
9,8477960,Adrian Kempe,R,LAK,28,82,24,31,55
9,8480188,Fabian Zetterlund,L,SJS,25,82,24,31,55
9,8475794,Tyler Seguin,C,DAL,32,82,22,33,55
9,8474578,Erik Karlsson,D,PIT,34,82,16,39,55
9,8478397,Rasmus Andersson,D,CGY,28,82,7,48,55
9,8476880,Tom Wilson,R,WSH,30,82,24,30,54
9,8478115,Pierre Engvall,L,NYI,28,82,24,30,54
9,8476462,Dougie Hamilton,D,NJD,31,82,15,39,54
9,8482105,Jake Sanderson,D,OTT,22,82,12,42,54
9,8476958,Jaccob Slavin,D,CAR,30,82,8,46,54
9,8476399,Blake Coleman,C,CGY,33,82,28,25,53
9,8482146,Luke Evangelista,R,NSH,22,82,27,26,53
9,8477451,Ryan Hartman,R,MIN,30,82,25,28,53
9,8477476,Artturi Lehkonen,L,COL,29,82,23,30,53
9,8474102,David Perron,L,OTT,36,82,20,33,53
9,8477021,Alex Kerfoot,C,UTA,30,82,17,36,53
9,8479410,Mikhail Sergachev,D,UTA,26,82,11,42,53
9,8477932,Aaron Ekblad,D,FLA,28,82,23,29,52
9,8478856,Conor Garland,R,VAN,28,82,21,31,52
9,8478462,Nicolas Roy,C,VGK,27,82,20,32,52
9,8473512,Claude Giroux,R,OTT,36,82,16,36,52
9,8477503,Max Domi,C,TOR,29,82,14,38,52
9,8478407,Vince Dunn,D,SEA,28,82,9,43,52
9,8478366,Frank Vatrano,R,ANA,30,82,28,23,51
9,8477987,Ryan Donato,C,CHI,28,82,25,26,51
9,8480009,Eeli Tolvanen,R,SEA,25,82,20,31,51
9,8484144,Connor Bedard,C,CHI,19,82,20,31,51
9,8476456,Jonathan Huberdeau,C,CGY,31,82,11,40,51
9,8482684,Luke Hughes,D,NJD,21,82,10,41,51
9,8470613,Brent Burns,D,CAR,39,82,7,44,51
9,8480014,Gabriel Vilardi,C,WPG,25,82,27,23,50
9,8481068,Yegor Sharangovich,C,CGY,26,82,24,26,50
9,8482109,Alexis Lafrenière,L,NYR,23,82,20,30,50
9,8477456,J.T. Compher,L,DET,29,82,25,24,49
9,8478542,Evan Rodrigues,C,FLA,31,82,21,28,49
9,8478233,Andrew Mangiapane,L,WSH,28,82,21,28,49
9,8471724,Kris Letang,D,PIT,37,82,18,31,49
9,8482113,Anton Lundell,C,FLA,23,82,13,36,49
9,8476906,Shayne Gostisbehere,D,CAR,31,82,11,38,49
9,8478038,Devon Toews,D,COL,30,82,9,40,49
9,8481542,Moritz Seider,D,DET,23,82,9,40,49
9,8483808,Andrei Kuzmenko,L,CGY,28,82,25,23,48
9,8482667,William Eklund,L,SJS,22,82,24,24,48
9,8474053,Logan Couture,C,SJS,35,82,23,25,48
9,8480185,Eetu Luostarinen,C,FLA,26,82,21,27,48
9,8475799,Nino Niederreiter,R,WPG,32,82,27,20,47
9,8480797,Joel Farabee,L,PHI,24,82,25,22,47
9,8477497,Sean Monahan,C,CBJ,30,82,22,25,47
9,8470621,Corey Perry,R,EDM,39,82,22,25,47
9,8482740,Wyatt Johnston,C,DAL,21,82,21,26,47
9,8478046,Danton Heinen,L,VAN,29,82,18,29,47
9,8478438,Tommy Novak,C,NSH,27,82,16,31,47
9,8476458,Ryan Strome,C,ANA,31,82,15,32,47
9,8471698,T.J. Oshie,R,WSH,38,82,26,20,46
9,8475791,Taylor Hall,L,CHI,33,82,24,22,46
9,8481604,Pavel Dorofeyev,L,VGK,24,82,18,28,46
9,8478440,Dylan Strome,C,WSH,27,82,17,29,46
9,8481711,Matias Maccelli,L,UTA,24,82,15,31,46
9,8477498,Darnell Nurse,D,EDM,29,82,14,32,46
9,8480434,Sean Durzi,D,UTA,26,82,12,34,46
9,8477346,MacKenzie Weegar,D,CGY,30,82,11,35,46
9,8476854,Hampus Lindholm,D,BOS,30,82,8,38,46
9,8476438,Brandon Saad,L,STL,32,82,28,17,45
9,8480893,Kirill Marchenko,R,CBJ,24,82,27,18,45
9,8482124,Quinton Byfield,R,LAK,22,82,21,24,45
9,8479987,Morgan Geekie,C,BOS,26,82,21,24,45
9,8480015,Owen Tippett,R,PHI,25,82,20,25,45
9,8478047,Michael Bunting,L,PIT,29,82,15,30,45
9,8482097,Jack Quinn,R,BUF,23,82,13,32,45
9,8478055,Gustav Forsling,D,FLA,28,82,11,34,45
9,8475218,Mattias Ekholm,D,EDM,34,82,7,38,45
9,8482110,Dawson Mercer,C,NJD,23,82,25,19,44
9,8480064,Josh Norris,C,OTT,25,82,25,19,44
9,8479345,Jakob Chychrun,D,WSH,26,82,14,30,44
9,8478472,Mathieu Joseph,R,STL,27,82,13,31,44
9,8479525,Ross Colton,C,COL,28,82,26,17,43
9,8476483,Rickard Rakell,R,PIT,31,82,22,21,43
9,8482175,JJ Peterka,R,BUF,22,82,22,21,43
9,8480829,Jesperi Kotkaniemi,C,CAR,24,82,20,23,43
9,8481618,Alex Newhook,C,MTL,23,82,19,24,43
9,8481186,Logan O'Connor,R,COL,28,82,19,24,43
9,8476925,Colton Sissons,C,NSH,31,82,17,26,43
9,8482660,Kent Johnson,C,CBJ,22,82,9,34,43
9,8475760,Nick Bjugstad,C,UTA,32,82,21,21,42
9,8480145,Neal Pionk,D,WPG,29,82,15,27,42
9,8475745,Charlie Coyle,C,BOS,32,82,14,28,42
9,8476792,Torey Krug,D,STL,33,82,12,30,42
9,8479425,Filip Hronek,D,VAN,27,82,11,31,42
9,8480817,K'Andre Miller,D,NYR,24,82,8,34,42
9,8474563,Drew Doughty,D,LAK,35,82,7,35,42
9,8480043,Timothy Liljegren,D,TOR,25,82,7,35,42
9,8477998,Warren Foegele,L,LAK,28,82,20,21,41
9,8482699,Dylan Guenther,R,UTA,21,82,18,23,41
9,8481596,Shane Pinto,C,OTT,24,82,17,24,41
9,8476872,Scott Laughton,C,PHI,30,82,14,27,41
9,8475763,Kevin Hayes,R,PIT,32,82,12,29,41
9,8477948,Travis Sanheim,D,PHI,28,82,11,30,41
9,8477986,Brandon Montour,D,SEA,30,82,10,31,41
9,8477488,Brett Pesce,D,NJD,30,82,2,39,41
9,8477511,Anthony Mantha,R,CGY,30,82,21,19,40
9,8480113,Alex Iafallo,L,WPG,31,82,20,20,40
9,8479365,Trent Frederic,C,BOS,26,82,20,20,40
9,8476419,Jean-Gabriel Pageau,C,NYI,32,82,19,21,40
9,8475768,Jaden Schwartz,C,SEA,32,82,18,22,40
9,8481656,Aliaksei Protas,C,WSH,23,82,17,23,40
9,8482055,Drew O'Connor,L,PIT,26,82,17,23,40
9,8480748,Kiefer Sherwood,L,VAN,29,82,17,23,40
9,8480871,Adam Boqvist,D,FLA,24,82,15,25,40
9,8474150,Mikael Backlund,C,CGY,35,82,13,27,40
9,8477444,Andre Burakovsky,L,SEA,29,82,13,27,40
9,8481581,Thomas Harley,D,DAL,23,82,10,30,40
9,8482720,Matthew Knies,L,TOR,22,82,20,19,39
9,8474149,Evgenii Dadonov,R,DAL,35,82,19,20,39
9,8478891,Mason Appleton,C,WPG,28,82,17,22,39
9,8476461,Sean Couturier,C,PHI,32,82,14,25,39
9,8473422,Nick Foligno,L,CHI,37,82,11,28,39
9,8482142,Jamie Drysdale,D,PHI,22,82,8,31,39
9,8475171,Oliver Ekman-Larsson,D,TOR,33,82,7,32,39
9,8480459,Pius Suter,C,VAN,28,82,22,16,38
9,8480802,Ryan McLeod,C,BUF,25,82,21,17,38
9,8479996,Cody Glass,C,NSH,25,82,19,19,38
9,8475191,Reilly Smith,R,NYR,33,82,17,21,38
9,8482475,Yegor Chinakhov,R,CBJ,23,82,16,22,38
9,8478057,Dakota Joshua,C,VAN,28,82,16,22,38
9,8482149,Cole Perfetti,C,WPG,22,82,15,23,38
9,8477429,Andrew Copp,C,DET,30,82,15,23,38
9,8475220,Marcus Foligno,L,MIN,33,82,14,24,38
9,8475149,Marcus Johansson,L,MIN,34,82,13,25,38
9,8482133,Thomas Bordeleau,C,SJS,22,82,9,29,38
9,8479992,Michael Rasmussen,C,DET,25,82,23,14,37
9,8478474,Lawson Crouse,L,UTA,27,82,22,15,37
9,8477952,Robby Fabbri,C,ANA,28,82,17,20,37
9,8476923,Damon Severson,D,CBJ,30,82,9,28,37
9,8478851,Alexandre Carrier,D,NSH,28,82,7,30,37
9,8477426,Nicholas Paul,L,TBL,29,82,18,18,36
9,8476474,Stefan Noesen,R,NJD,31,82,18,18,36
9,8477425,Miles Wood,L,COL,29,82,17,19,36
9,8482092,Ridly Greig,C,OTT,22,82,17,19,36
9,8473533,Jordan Staal,C,CAR,36,82,16,20,36
9,8480220,Noah Cates,L,PHI,25,82,13,23,36
9,8475793,Ryan Johansen,C,PHI,32,82,13,23,36
9,8478463,Anthony Beauvillier,L,PIT,27,82,12,24,36
9,8476422,Mike Reilly,D,NYI,31,82,6,30,36
9,8482089,Jake Neighbours,L,STL,22,82,22,13,35
9,8480835,Jack Drury,C,CAR,24,82,21,14,35
9,8476981,Josh Anderson,R,MTL,30,82,21,14,35
9,8475722,Jason Zucker,L,BUF,32,82,20,15,35
9,8482079,Marco Rossi,C,MIN,23,82,18,17,35
9,8481535,Nils Hoglander,L,VAN,24,82,17,18,35
9,8479941,Justin Danforth,R,CBJ,31,82,17,18,35
9,8476329,Travis Boyd,C,MIN,31,82,10,25,35
9,8473563,Nicklas Backstrom,C,WSH,37,82,10,25,35
9,8475764,Cam Fowler,D,ANA,33,82,7,28,35
9,8476892,Colton Parayko,D,STL,31,82,6,29,35
9,8478500,Ivan Provorov,D,CBJ,27,82,6,29,35
9,8477969,Marcus Pettersson,D,PIT,28,82,6,29,35
9,8481554,Kaapo Kakko,R,NYR,23,82,24,10,34
9,8475314,Anders Lee,L,NYI,34,82,19,15,34
9,8481032,Paul Cotter,C,NJD,25,82,18,16,34
9,8482117,Lukas Reichel,L,CHI,22,82,18,16,34
9,8481704,Juuso Parssinen,C,NSH,23,82,16,18,34
9,8475287,Erik Haula,L,NJD,33,82,14,20,34
9,8480068,Ryan Poehling,C,PHI,25,82,14,20,34
9,8477450,Jason Dickinson,C,CHI,29,82,14,20,34
9,8482705,Cole Sillinger,C,CBJ,21,82,11,23,34
9,8481606,Jordan Spence,D,LAK,23,82,11,23,34
9,8476931,Jake McCabe,D,TOR,31,82,10,24,34
9,8476457,Adam Larsson,D,SEA,32,82,10,24,34
9,8475200,Dmitry Orlov,D,CAR,33,82,7,27,34
9,8481546,Cam York,D,PHI,23,82,6,28,34
9,8478882,Vladislav Gavrikov,D,LAK,29,82,6,28,34
9,8480849,Barrett Hayton,C,UTA,24,82,18,15,33
9,8483515,Juraj Slafkovsky,L,MTL,20,82,15,18,33
9,8479293,Brandon Tanev,L,SEA,33,82,14,19,33
9,8474189,Lars Eller,C,PIT,35,82,14,19,33
9,8475714,Calle Jarnkrok,C,TOR,33,82,14,19,33
9,8475848,Brendan Gallagher,R,MTL,32,82,13,20,33
9,8480144,David Kampf,C,TOR,29,82,13,20,33
9,8476921,Jordan Martinook,L,CAR,32,82,12,21,33
9,8476927,Teddy Blueger,C,VAN,30,82,11,22,33
9,8476292,Ondrej Palat,L,NJD,33,82,9,24,33
9,8476885,Jacob Trouba,D,NYR,30,82,7,26,33
9,8477919,Frederick Gaudreau,C,MIN,31,82,5,28,33
9,8480873,Rasmus Sandin,D,WSH,24,82,4,29,33
9,8480035,Henri Jokiharju,D,BUF,25,82,3,30,33
9,8479353,Brett Howden,C,VGK,26,82,17,15,32
9,8483431,Logan Cooley,C,UTA,20,82,16,16,32
9,8477947,Sonny Milano,L,WSH,28,82,14,18,32
9,8475193,Tomas Tatar,L,NJD,34,82,14,18,32
9,8482111,Justin Barron,D,MTL,23,82,13,19,32
9,8478413,Jordan Greenway,L,BUF,27,82,12,20,32
9,8480336,Sean Walker,D,CAR,30,82,11,21,32
9,8476392,Adam Lowry,C,WPG,31,82,11,21,32
9,8480789,Oliver Wahlstrom,R,NYI,24,82,11,21,32
9,8480021,Jack Studnicka,C,LAK,25,82,10,22,32
9,8475855,Jesper Fast,R,CAR,33,82,7,25,32
9,8476312,Josh Manson,D,COL,33,82,6,26,32
9,8482122,Brock Faber,D,MIN,22,82,5,27,32
9,8478508,Yakov Trenin,C,MIN,27,82,23,8,31
9,8482141,Lukas Cormier,D,VGK,22,82,14,17,31
9,8481013,Jonatan Berggren,R,DET,24,82,13,18,31
9,8481522,Peyton Krebs,C,BUF,23,82,13,18,31
9,8478133,Jake Evans,C,MTL,28,82,12,19,31
9,8477989,Christian Dvorak,C,MTL,28,82,8,23,31
9,8476897,Oskar Sundqvist,C,STL,30,82,7,24,31
9,8477506,Ryan Pulock,D,NYI,30,82,7,24,31
9,8482077,Dylan Holloway,L,EDM,23,82,18,12,30
9,8482125,Alexander Holtz,R,VGK,22,82,13,17,30
9,8477015,Connor Brown,R,EDM,30,82,11,19,30
9,8476873,Mark Jankowski,C,NSH,30,82,11,19,30
9,8482671,Owen Power,D,BUF,22,82,10,20,30
9,8476979,Erik Gustafsson,D,DET,32,82,5,25,30
9,8476331,Dylan DeMelo,D,WPG,31,82,4,26,30
9,8476879,Cody Ceci,D,EDM,31,82,4,26,30
9,8476917,Adam Pelech,D,NYI,30,82,4,26,30
9,8479316,Luke Kunin,C,SJS,27,82,19,10,29
9,8484166,Adam Fantilli,C,CBJ,20,82,12,17,29
9,8479661,Tanner Jeannot,L,LAK,27,82,12,17,29
9,8480003,Jesper Boqvist,C,FLA,26,82,12,17,29
9,8480813,Joe Veleno,C,DET,24,82,9,20,29
9,8476902,Esa Lindell,D,DAL,30,82,5,24,29
9,8482073,Braden Schneider,D,NYR,23,82,4,25,29
9,8481601,Simon Holmstrom,R,NYI,23,82,17,11,28
9,8483457,Lane Hutson,D,MTL,20,82,13,15,28
9,8481624,Ilya Mikheyev,R,CHI,30,82,12,16,28
9,8478020,Michael Amadio,C,OTT,28,82,12,16,28
9,8475343,Nic Dowd,C,WSH,34,82,11,17,28
9,8476889,Radek Faksa,C,STL,30,82,10,18,28
9,8477953,Kasperi Kapanen,R,STL,28,82,9,19,28
9,8482655,J.J. Moser,D,TBL,24,82,9,19,28
9,8476624,Barclay Goodrow,C,SJS,31,82,6,22,28
9,8480073,Erik Brannstrom,D,COL,25,82,6,22,28
9,8479398,Samuel Girard,D,COL,26,82,3,25,28
9,8474716,Jared Spurgeon,D,MIN,35,82,2,26,28
9,8479393,Noah Gregor,C,OTT,26,82,19,8,27
9,8481553,Bobby Brink,R,PHI,23,82,16,11,27
9,8481093,Rafael Harvey-Pinard,L,MTL,25,82,15,12,27
9,8480855,Jack McBain,C,UTA,24,82,14,13,27
9,8480074,Alexandre Texier,C,STL,25,82,12,15,27
9,8478013,Jake Walman,D,SJS,28,82,11,16,27
9,8475842,Sam Carrick,C,NYR,32,82,11,16,27
9,8481477,Nico Sturm,C,SJS,29,82,10,17,27
9,8484203,Bradly Nadeau,L,CAR,19,82,10,17,27
9,8478109,Victor Olofsson,L,VGK,29,82,9,18,27
9,8481481,Blake Lizotte,C,PIT,27,82,8,19,27
9,8475181,Nick Leddy,D,STL,33,82,6,21,27
9,8479980,Nicolas Hague,D,VGK,26,82,4,23,27
9,8475455,Brenden Dillon,D,NJD,34,82,3,24,27
9,8481582,Nicholas Robertson,L,TOR,23,82,10,16,26
9,8476480,Vladislav Namestnikov,C,WPG,32,82,9,17,26
9,8481568,Alex Vlasic,D,CHI,23,82,7,19,26
9,8478399,Jonas Siegenthaler,D,NJD,27,82,6,20,26
9,8474673,TJ Brodie,D,CHI,34,82,5,21,26
9,8475462,Radko Gudas,D,ANA,34,82,5,21,26
9,8477369,Carson Soucy,D,VAN,30,82,4,22,26
9,8478859,Niko Mikkola,D,FLA,28,82,4,22,26
9,8476374,Sean Kuraly,C,CBJ,31,82,17,8,25
9,8479390,Taylor Raddysh,R,WSH,26,82,15,10,25
9,8476918,Jimmy Vesey,L,NYR,31,82,13,12,25
9,8481028,Martin Pospisil,C,CGY,25,82,13,12,25
9,8482155,Alex Laferriere,R,LAK,23,82,12,13,25
9,8482259,Bobby McMann,C,TOR,28,82,11,14,25
9,8479368,Max Jones,L,BOS,26,82,10,15,25
9,8483493,Frank Nazar,C,CHI,20,82,10,15,25
9,8482762,Simon Edvinsson,D,DET,21,82,10,15,25
9,8483763,Maksymilian Szuber,D,UTA,22,82,9,16,25
9,8480980,Connor Dewar,C,TOR,25,82,8,17,25
9,8476960,Andreas Athanasiou,C,CHI,30,82,6,19,25
9,8480878,Nils Lundkvist,D,DAL,24,82,6,19,25
9,8475324,Nick Jensen,D,OTT,34,82,4,21,25
9,8478507,John Marino,D,UTA,27,82,2,23,25
9,8473453,Trevor Lewis,C,LAK,37,82,12,12,24
9,8482807,Ethan Del Mastro,D,CHI,21,82,11,13,24
9,8479351,Sam Steel,C,DAL,26,82,10,14,24
9,8476463,Jonas Brodin,D,MIN,31,82,10,14,24
9,8476278,Colin Blackwell,C,DAL,31,82,9,15,24
9,8477508,Curtis Lazar,C,NJD,29,82,9,15,24
9,8483565,Nick Blankenburg,D,NSH,26,82,8,16,24
9,8482145,Mavrik Bourque,C,DAL,22,82,8,16,24
9,8480879,Jacob Bernard-Docker,D,OTT,24,82,4,20,24
9,8474151,Ryan McDonagh,D,TBL,35,82,3,21,24
9,8478569,Noel Acciari,C,PIT,33,82,13,10,23
9,8477406,Mattias Janmark,C,EDM,32,82,12,11,23
9,8481580,Connor McMichael,C,WSH,23,82,11,12,23
9,8477392,Hudson Fasching,R,NYI,29,82,9,14,23
9,8480806,Isac Lundestrom,C,ANA,25,82,8,15,23
9,8480796,Martin Fehervary,D,WSH,25,82,7,16,23
9,8477435,Ryan Graves,D,PIT,29,82,6,17,23
9,8481524,Bowen Byram,D,BUF,23,82,6,17,23
9,8482803,Olen Zellweger,D,ANA,21,82,6,17,23
9,8479976,Juuso Valimaki,D,UTA,26,82,5,18,23
9,8478136,Jake Middleton,D,MIN,28,82,5,18,23
9,8475690,Chris Tanev,D,TOR,35,82,5,18,23
9,8476967,Brett Kulak,D,EDM,30,82,5,18,23
9,8478911,Matt Roy,D,WSH,29,82,4,19,23
9,8479369,Andrew Peeke,D,BOS,26,82,4,19,23
9,8479371,Dante Fabbro,D,NSH,26,82,4,19,23
9,8475790,Erik Gudbranson,D,CBJ,32,82,4,19,23
9,8480222,Sebastian Aho,D,PIT,28,82,3,20,23
9,8475233,David Savard,D,MTL,34,82,2,21,23
9,8482666,Scott Morrow,D,CAR,22,82,13,9,22
9,8481517,Brett Leason,R,ANA,25,82,13,9,22
9,8484145,Zach Benson,L,BUF,19,82,10,12,22
9,8477353,Tyler Motte,C,DET,29,82,9,13,22
9,8479359,Beck Malenstyn,L,BUF,26,82,9,13,22
9,8482624,Daniil Miromanov,D,CGY,27,82,8,14,22
9,8477499,Rasmus Ristolainen,D,PHI,30,82,6,16,22
9,8477938,Haydn Fleury,D,WPG,28,82,6,16,22
9,8480172,Jan Rutta,D,SJS,34,82,5,17,22
9,8475177,Calvin de Haan,D,COL,33,82,4,18,22
9,8474574,Tyler Myers,D,VAN,34,82,1,21,22
9,8476469,Joel Armia,R,MTL,31,82,14,7,21
9,8481560,Arthur Kaliyev,R,LAK,23,82,12,9,21
9,8479414,Nathan Bastian,R,NJD,27,82,9,12,21
9,8483499,Liam Ohgren,L,MIN,20,82,9,12,21
9,8482702,Logan Stankoven,C,DAL,21,82,8,13,21
9,8478468,Jeremy Lauzon,D,NSH,27,82,8,13,21
9,8475231,Casey Cizikas,C,NYI,33,82,7,14,21
9,8482062,Cole Smith,L,NSH,29,82,7,14,21
9,8477507,Nikita Zadorov,D,BOS,29,82,6,15,21
9,8475718,Justin Holl,D,DET,32,82,6,15,21
9,8478840,Will Borgen,D,SEA,28,82,4,17,21
9,8480834,Ty Emberson,D,SJS,24,82,3,18,21
9,8478432,Christian Fischer,R,DET,27,82,9,11,20
9,8484911,Collin Graf,R,SJS,22,82,9,11,20
9,8480025,MacKenzie Entwistle,R,FLA,25,82,9,11,20
9,8477220,Nate Schmidt,D,FLA,33,82,6,14,20
9,8483445,Cutter Gauthier,L,ANA,20,82,6,14,20
9,8481708,Zac Jones,D,NYR,24,82,6,14,20
9,8470600,Ryan Suter,D,STL,39,82,6,14,20
9,8479983,Mario Ferraro,D,SJS,26,82,5,15,20
9,8481178,Egor Zamula,D,PHI,24,82,5,15,20
9,8482809,Jackson Blake,R,CAR,21,82,4,16,20
9,8483490,Pavel Mintyukov,D,ANA,21,82,4,16,20
9,8482087,Kaiden Guhle,D,MTL,22,82,3,17,20
9,8479442,Troy Stecher,D,EDM,30,82,1,19,20
9,8478178,Darren Raddysh,D,TBL,28,82,0,20,20
9,8476467,Jamie Oleksiak,D,SEA,32,82,8,11,19
9,8480448,Parker Kelly,L,COL,25,82,8,11,19
9,8477839,Conor Sheary,L,TBL,32,82,7,12,19
9,8479591,Michael Eyssimont,C,TBL,28,82,7,12,19
9,8480995,Pontus Holmberg,R,TOR,25,82,7,12,19
9,8478211,Dryden Hunt,L,CGY,29,82,6,13,19
9,8484153,Leo Carlsson,C,ANA,20,82,6,13,19
9,8483505,Matthew Poitras,C,BOS,20,82,6,13,19
9,8482858,Ryker Evans,D,SEA,23,82,6,13,19
9,8481567,Henry Thrun,D,SJS,23,82,6,13,19
9,8483495,Simon Nemec,D,NJD,20,82,5,14,19
9,8479998,Mikey Anderson,D,LAK,25,82,5,14,19
9,8480807,Mattias Samuelsson,D,BUF,24,82,4,15,19
9,8481014,Alexander Romanov,D,NYI,24,82,3,16,19
9,8477845,Trevor van Riemsdyk,D,WSH,33,82,3,16,19
9,8476891,Matt Grzelcyk,D,PIT,30,82,2,17,19
9,8483524,Shane Wright,C,SEA,20,82,13,5,18
9,8476878,Zemgus Girgensons,L,TBL,30,82,12,6,18
9,8479638,Justin Brazeau,R,BOS,26,82,10,8,18
9,8482074,Connor Zary,C,CGY,23,82,9,9,18
9,8482712,Oskar Olausson,R,COL,22,82,8,10,18
9,8480870,Bo Groulx,C,NYR,24,82,8,10,18
9,8474715,Cam Atkinson,R,TBL,35,82,6,12,18
9,8477365,Connor Clifton,D,BUF,29,82,6,12,18
9,8480246,Nick Perbix,D,TBL,26,82,6,12,18
9,8473507,Jeff Petry,D,DET,37,82,5,13,18
9,8475188,Brayden McNabb,D,VGK,33,82,3,15,18
9,8478443,Brandon Carlo,D,BOS,28,82,3,15,18
9,8476858,Phillip Di Giuseppe,L,VAN,31,82,13,4,17
9,8480281,Alexey Toropchenko,R,STL,25,82,11,6,17
9,8477903,Garnet Hathaway,R,PHI,33,82,10,7,17
9,8476442,Matt Nieto,L,PIT,32,82,8,9,17
9,8483397,Marc McLaughlin,C,BOS,25,82,8,9,17
9,8480860,Kevin Bahl,D,CGY,24,82,6,11,17
9,8482679,Matt Coronato,R,CGY,22,82,6,11,17
9,8482749,Joshua Roy,R,MTL,21,82,6,11,17
9,8482245,Artem Zub,D,OTT,29,82,5,12,17
9,8480990,Declan Chisholm,D,MIN,24,82,5,12,17
9,8477335,Kyle Burroughs,D,LAK,29,82,3,14,17
9,8479402,Jake Bean,D,CGY,26,82,2,15,17
9,8480049,Dylan Samberg,D,WPG,25,82,1,16,17
9,8482733,Logan Mailloux,D,MTL,31,82,7,9,16
9,8482713,Mackie Samoskevich,R,FLA,22,82,6,10,16
9,8483482,Tristan Luneau,D,ANA,20,82,5,11,16
9,8483468,Jiri Kulich,C,BUF,20,82,3,13,16
9,8476372,Nick Seeler,D,PHI,31,82,3,13,16
9,8481641,Joel Kiviranta,L,COL,28,82,8,7,15
9,8482659,Josh Doan,R,UTA,22,82,6,9,15
9,8482101,Danil Gushchin,L,SJS,22,82,5,10,15
9,8478416,Erik Cernak,D,TBL,27,82,4,11,15
9,8482470,Ilya Solovyov,D,CGY,24,82,4,11,15
9,8474090,Brendan Smith,D,DAL,35,82,4,11,15
9,8481699,Aku Raty,R,UTA,23,82,4,11,15
9,8471677,Jack Johnson,D,CBJ,37,82,4,11,15
9,8475279,Ben Chiarot,D,DET,33,82,3,12,15
9,8476525,Colin Miller,D,WPG,32,82,2,13,15
9,8482118,Sam Colangelo,R,ANA,23,82,7,7,14
9,8481605,Jackson LaCombe,D,ANA,23,82,6,8,14
9,8477931,Tomas Nosek,L,FLA,32,82,4,10,14
9,8482166,Shakir Mukhamadullin,D,SJS,22,82,3,11,14
9,8483012,Logan Morrison,C,SEA,22,82,3,11,14
9,8478434,Keegan Kolesar,R,VGK,27,82,2,12,14
9,8478450,Parker Wotherspoon,D,BOS,27,82,2,12,14
9,8479291,Kevin Rooney,C,CGY,31,82,8,5,13
9,8482516,Matthew Kessel,D,STL,24,82,6,7,13
9,8484149,Gavin Brindley,C,CBJ,20,82,6,7,13
9,8477034,Jaycob Megna,D,FLA,32,82,4,9,13
9,8483567,Georgii Merkulov,C,BOS,24,82,4,9,13
9,8482787,Nikita Chibrikov,R,WPG,31,82,3,10,13
9,8474013,Ian Cole,D,UTA,35,82,2,11,13
9,8476429,Scott Mayfield,D,NYI,32,82,0,13,13
9,8477505,Alexander Wennberg,C,SJS,30,82,7,5,12
9,8482153,Brendan Brisson,C,VGK,23,82,6,6,12
9,8478874,Adam Gaudette,C,OTT,28,82,2,10,12
9,8480950,Ilya Lyubushkin,D,DAL,30,82,1,11,12
9,8483466,Kevin Korchinski,D,CHI,20,82,1,11,12
9,8476822,Luke Glendening,C,TBL,35,82,8,3,11
9,8482859,Zack Ostapchuk,C,OTT,21,82,6,5,11
9,8483471,Brad Lambert,C,WPG,31,82,4,7,11
9,8476473,Connor Murphy,D,CHI,31,82,4,7,11
9,8475762,Derek Forbort,D,VAN,32,82,3,8,11
9,8483460,David Jiricek,D,CBJ,21,82,2,9,11
9,8474567,Zach Bogosian,D,MIN,34,82,2,8,10
9,8479324,Ryan Lindgren,D,NYR,26,82,1,9,10
9,8482070,Mitchell Chaffee,R,TBL,26,82,5,4,9
9,8479576,Vincent Desharnais,D,VAN,28,82,3,6,9
9,8476441,Joel Edmundson,D,LAK,31,82,2,7,9
9,8474612,Travis Hamonic,D,OTT,34,82,1,8,9
9,8474062,Riley Nash,C,NYR,35,82,1,7,8
9,8483489,Fraser Minten,C,TOR,31,82,2,3,5
9,8481122,Simon Benoit,D,TOR,26,82,0,5,5
9,8470794,Joe Pavelski,C,,40,0,0,0,0
9,8481703,Valtteri Puustinen,R,PIT,25,0,0,0,0
9,8477950,Tony DeAngelo,D,,29,0,0,0,0
9,8481577,Philip Tomasino,C,NSH,23,0,0,0,0
9,8475197,Tyson Barrie,D,,33,0,0,0,0
9,8471218,Blake Wheeler,R,,38,0,0,0,0
9,8474157,Max Pacioretty,L,,36,0,0,0,0
9,8478466,Daniel Sprong,R,VAN,27,0,0,0,0
9,8475744,Evgeny Kuznetsov,C,,32,0,0,0,0
9,8481019,David Gustafsson,C,WPG,24,0,0,0,0
9,8475906,John Klingberg,D,,32,0,0,0,0
9,8479348,Kale Clague,D,BUF,26,0,0,0,0
9,8476952,Dominic Toninato,C,WPG,30,0,0,0,0
9,8473473,Milan Lucic,L,,36,0,0,0,0
9,8474037,James van Riemsdyk,L,,35,0,0,0,0
9,8474602,Justin Schultz,D,,34,0,0,0,0
9,8482222,Alexander Barabanov,L,,30,0,0,0,0
9,8479372,Josh Mahura,D,SEA,26,0,0,0,0
9,8479982,Conor Timmins,D,TOR,26,0,0,0,0
9,8474031,Kevin Shattenkirk,D,,35,0,0,0,0
9,8480008,Adam Ruzicka,C,,25,0,0,0,0
9,8481059,Scott Perunovich,D,STL,26,0,0,0,0
9,8480884,Calen Addison,D,,24,0,0,0,0
9,8476994,Vinnie Hinostroza,C,NSH,30,0,0,0,0
9,8478452,Caleb Jones,D,LAK,27,0,0,0,0
9,8480157,Calle Rosen,D,COL,30,0,0,0,0
9,8481609,Vladislav Kolyachonok,D,UTA,23,0,0,0,0
9,8479415,Michael McLeod,C,,26,0,0,0,0
9,8476919,Chris Tierney,C,,30,0,0,0,0
9,8479639,Dylan Coghlan,D,WPG,26,0,0,0,0
9,8478146,Matthew Highmore,C,OTT,28,0,0,0,0
9,8478970,Jalen Chatfield,D,CAR,28,0,0,0,0
9,8480205,Emil Bemstrom,C,PIT,25,0,0,0,0
9,8474884,Mike Hoffman,C,,35,0,0,0,0
9,8471274,Alex Goligoski,D,,39,0,0,0,0
9,8478104,Sammy Blais,L,,28,0,0,0,0
9,8474870,Tyler Johnson,C,,34,0,0,0,0
9,8476913,Devin Shore,C,MIN,30,0,0,0,0
9,8481598,Philip Broberg,D,EDM,23,0,0,0,0
9,8480058,Pierre-Olivier Joseph,D,STL,25,0,0,0,0
9,8480891,Michael Kesselring,D,UTA,24,0,0,0,0
9,8477979,Nicolas Aube-Kubel,R,BUF,28,0,0,0,0
9,8476871,Tanner Pearson,L,,32,0,0,0,0
9,8476393,Nick Cousins,C,,31,0,0,0,0
9,8479977,Kailer Yamamoto,R,,26,0,0,0,0
9,8479543,Michael Pezzetta,L,MTL,26,0,0,0,0
9,8477018,Ben Hutton,D,VGK,31,0,0,0,0
9,8480762,Eric Robinson,L,CAR,29,0,0,0,0
9,8474034,Pat Maroon,L,CHI,36,0,0,0,0
9,8481058,Jesse Ylönen,R,,25,0,0,0,0
9,8475179,Dmitry Kulikov,D,FLA,34,0,0,0,0
9,8481527,Kaedan Korczak,D,VGK,23,0,0,0,0
9,8473449,Kyle Okposo,R,,36,0,0,0,0
9,8482192,Isaak Phillips,D,CHI,23,0,0,0,0
9,8480727,Zach Whitecloud,D,VGK,28,0,0,0,0
9,8479346,Dillon Dube,C,,26,0,0,0,0
9,8480821,Filip Zadina,R,,25,0,0,0,0
9,8480001,Urho Vaakanainen,D,ANA,25,0,0,0,0
9,8470966,Mark Giordano,D,,41,0,0,0,0
9,8480853,Liam Foudy,C,,24,0,0,0,0
9,8475225,Craig Smith,C,CHI,35,0,0,0,0
9,8479972,Mason Shaw,C,WPG,26,0,0,0,0
9,8478451,Ethan Bear,D,WSH,27,0,0,0,0
9,8474040,Sam Gagner,C,,35,0,0,0,0
9,8480196,Jacob Bryson,D,BUF,27,0,0,0,0
9,8479984,Cal Foote,D,,26,0,0,0,0
9,8480011,Klim Kostin,C,SJS,25,0,0,0,0
9,8482176,Wyatt Kaiser,D,CHI,22,0,0,0,0
9,8476988,Matt Benning,D,SJS,30,0,0,0,0
9,8479370,Tyson Jost,C,CAR,26,0,0,0,0
9,8477464,Nic Petan,C,,29,0,0,0,0
9,8477380,Jonny Brodzinski,C,NYR,31,0,0,0,0
9,8480070,Ian Mitchell,D,BOS,25,0,0,0,0
9,8479315,Joey Anderson,R,CHI,26,0,0,0,0
9,8478099,Kevin Labanc,R,,29,0,0,0,0
9,8476874,Olli Maatta,D,DET,30,0,0,0,0
9,8475208,Brian Dumoulin,D,ANA,33,0,0,0,0
9,8478430,Oliver Kylington,D,,27,0,0,0,0
9,8479536,Axel Jonsson-Fjallby,L,WPG,26,0,0,0,0
9,8479671,Mathieu Olivier,R,CBJ,27,0,0,0,0
9,8471709,Marc-Edouard Vlasic,D,SJS,37,0,0,0,0
9,8479328,Julien Gauthier,R,NYI,27,0,0,0,0
9,8478421,A.J. Greer,L,FLA,28,0,0,0,0
9,8477573,Nathan Walker,L,STL,30,0,0,0,0
9,8481537,Nikita Okhotiuk,D,CGY,24,0,0,0,0
9,8474166,Alec Martinez,D,CHI,37,0,0,0,0
9,8470610,Zach Parise,L,,40,0,0,0,0
9,8477478,William Carrier,L,CAR,30,0,0,0,0
9,8479344,Jesse Puljujarvi,R,PIT,26,0,0,0,0
9,8480887,Jordan Harris,D,MTL,24,0,0,0,0
9,8478502,Dennis Gilbert,D,BUF,28,0,0,0,0
9,8482730,Brandt Clarke,D,LAK,21,0,0,0,0
9,8480355,Mark Kastelic,C,BOS,25,0,0,0,0
9,8475750,Jon Merrill,D,MIN,32,0,0,0,0
9,8475164,Jakob Silfverberg,R,,34,0,0,0,0
9,8477944,Jakub Vrana,L,,28,0,0,0,0
9,8479439,Jacob MacDonald,D,COL,31,0,0,0,0
9,8474568,Luke Schenn,D,NSH,35,0,0,0,0
9,8478454,Noah Juulsen,D,VAN,27,0,0,0,0
9,8475752,Tyler Pitlick,C,,33,0,0,0,0
9,8482148,Hendrix Lapierre,C,WSH,22,0,0,0,0
9,8481167,Brayden Pachal,D,CGY,25,0,0,0,0
9,8478043,Sam Lafferty,C,BUF,29,0,0,0,0
9,8479321,Lucas Johansen,D,,27,0,0,0,0
9,8471699,Andrew Cogliano,C,,37,0,0,0,0
9,8481521,Ronnie Attard,D,PHI,25,0,0,0,0
9,8481161,Jake Christiansen,D,CBJ,25,0,0,0,0
9,8479458,Nikita Zaitsev,D,,33,0,0,0,0
9,8479619,Michael Carcone,L,UTA,28,0,0,0,0
9,8479026,Philippe Myers,D,TOR,27,0,0,0,0
9,8477330,Dominik Kubalik,L,,29,0,0,0,0
9,8481617,Vasily Podkolzin,R,VAN,23,0,0,0,0
9,8481701,Santeri Hatakka,D,NJD,23,0,0,0,0
9,8479514,Rem Pitlick,C,,27,0,0,0,0
9,8477446,Michael McCarron,R,NSH,29,0,0,0,0
9,8470604,Jeff Carter,C,,39,0,0,0,0
9,8482241,Radim Zohorna,L,,28,0,0,0,0
9,8480289,Morgan Barron,C,WPG,26,0,0,0,0
9,8479379,Givani Smith,R,SJS,26,0,0,0,0
9,8480216,Jacob Peterson,C,,25,0,0,0,0
9,8477851,Jordan Oesterle,D,BOS,32,0,0,0,0
9,8484258,Sam Malinski,D,COL,26,0,0,0,0
9,8478904,Steven Lorentz,C,,28,0,0,0,0
9,8482095,Tyler Kleven,D,OTT,22,0,0,0,0
9,8480848,Ty Dellandrea,C,SJS,24,0,0,0,0
9,8476884,Derrick Pouliot,D,,30,0,0,0,0
9,8479336,Carl Grundstrom,R,SJS,27,0,0,0,0
9,8482964,Arber Xhekaj,D,MTL,23,0,0,0,0
9,8471686,Marc Staal,D,,37,0,0,0,0
9,8477887,Patrick Brown,C,BOS,32,0,0,0,0
9,8478495,Denis Gurianov,R,,27,0,0,0,0
9,8473504,Cal Clutterbuck,R,,37,0,0,0,0
9,8481550,Adam Beckman,L,NJD,23,0,0,0,0
9,8480845,Rasmus Kupari,C,WPG,24,0,0,0,0
9,8474009,Nick Bonino,C,,36,0,0,0,0
9,8478585,Derek Ryan,C,EDM,38,0,0,0,0
9,8477962,Brendan Lemieux,L,CAR,28,0,0,0,0
9,8482861,Vincent Iorio,D,WSH,22,0,0,0,0
9,8479378,Logan Stanley,D,WPG,26,0,0,0,0
9,8473446,Erik Johnson,D,PHI,36,0,0,0,0
9,8481743,Marc Del Gaizo,D,NSH,25,0,0,0,0
9,8477384,Josh Brown,D,EDM,30,0,0,0,0
9,8482165,Yan Kuznetsov,D,CGY,22,0,0,0,0
9,8478424,Jansen Harkins,C,ANA,27,0,0,0,0
9,8482144,Jack Thompson,D,SJS,22,0,0,0,0
9,8478512,Austin Czarnik,C,,32,0,0,0,0
9,8477527,Ross Johnston,L,ANA,30,0,0,0,0
9,8479383,Boris Katchouk,L,,26,0,0,0,0
9,8482094,Daemon Hunt,D,MIN,22,0,0,0,0
9,8481719,Maxwell Crozier,D,TBL,24,0,0,0,0
9,8480192,Johnathan Kovacevic,D,NJD,27,0,0,0,0
9,8479376,Victor Mete,D,,26,0,0,0,0
9,8482511,Mason Lohrei,D,BOS,23,0,0,0,0
9,8475825,Jani Hakanpää,D,,32,0,0,0,0
9,8478021,William Lagesson,D,DET,28,0,0,0,0
9,8475795,Dylan McIlrath,D,WSH,32,0,0,0,0
9,8477846,Ryan Carpenter,C,,33,0,0,0,0
9,8481056,Spencer Stastney,D,NSH,24,0,0,0,0
9,8481564,Ryan Johnson,D,BUF,23,0,0,0,0
9,8478017,Mark Friedman,D,VAN,29,0,0,0,0
9,8479320,Max Lajoie,D,SEA,27,0,0,0,0
9,8480075,Cameron Crotty,D,MIN,25,0,0,0,0
9,8484287,Cole McWard,D,VAN,23,0,0,0,0
9,8484254,Akito Hirose,D,VAN,25,0,0,0,0
9,8483407,Brandon Scanlin,D,NYR,25,0,0,0,0
9,8480274,Philip Kemp,D,EDM,25,0,0,0,0
9,8479522,Hardy Haman Aktell,D,WSH,26,0,0,0,0
9,8480007,Jonas Rondbjerg,R,VGK,25,0,0,0,0
9,8477454,Adam Erne,L,,29,0,0,0,0
9,8481679,Maxence Guenette,D,OTT,23,0,0,0,0
9,8480441,Trey Fix-Wolansky,R,CBJ,25,0,0,0,0
9,8483546,Marshall Rifai,D,TOR,26,0,0,0,0
9,8480084,Nick DeSimone,D,NJD,30,0,0,0,0
9,8481030,Jack St. Ivany,D,PIT,25,0,0,0,0
9,8481592,Jakob Pelletier,L,CGY,23,0,0,0,0
9,8478011,Louie Belpedio,D,PHI,28,0,0,0,0
9,8477930,Pierre-Edouard Bellemare,L,,39,0,0,0,0
9,8484321,Nikolas Matinpalo,D,OTT,26,0,0,0,0
9,8482067,Connor Mackey,D,NYR,28,0,0,0,0
9,8481806,Louis Crevier,D,CHI,23,0,0,0,0
9,8484326,Patrik Koch,D,UTA,28,0,0,0,0
9,8477971,Andreas Englund,D,LAK,28,0,0,0,0
9,8481751,Lukas Rousek,R,BUF,25,0,0,0,0
9,8481006,Tyler Tucker,D,STL,24,0,0,0,0
9,8476867,Brendan Gaunce,C,MIN,30,0,0,0,0
9,8479520,Brandon Duhaime,R,WSH,27,0,0,0,0
9,8477073,Kurtis MacDermid,L,NJD,30,0,0,0,0
9,8480874,Adam Ginning,D,PHI,24,0,0,0,0
9,8477473,Justin Bailey,R,SJS,29,0,0,0,0
9,8479066,Ryan Lomberg,L,CGY,30,0,0,0,0
9,8477070,Liam O'Brien,C,UTA,30,0,0,0,0
9,8474618,Marco Scandella,D,,34,0,0,0,0
9,8475797,Jarred Tinordi,D,,32,0,0,0,0
9,8481441,Joe Snively,C,DET,28,0,0,0,0
9,8477244,Chad Ruhwedel,D,NYR,34,0,0,0,0
9,8479772,Zack MacEwen,R,OTT,28,0,0,0,0
9,8481147,Reese Johnson,C,MIN,26,0,0,0,0
9,8481043,Cole Koepke,L,BOS,26,0,0,0,0
9,8483619,Filip Roos,D,OTT,25,0,0,0,0
9,8481541,Samuel Bolduc,D,NYI,24,0,0,0,0
9,8477810,Joel Hanley,D,CGY,33,0,0,0,0
9,8476907,Mackenzie MacEachern,L,,30,0,0,0,0
9,8482652,Walker Duehr,R,CGY,27,0,0,0,0
9,8477126,Jayson Megna,C,,34,0,0,0,0
9,8483398,Declan Carlile,D,TBL,31,0,0,0,0
9,8482929,Emil Lilleberg,D,TBL,23,0,0,0,0
9,8480880,Jakub Lauko,C,MIN,24,0,0,0,0
9,8480245,Olle Lycksell,R,PHI,25,0,0,0,0
9,8480252,Cole Guttman,C,CHI,25,0,0,0,0
9,8477467,Gustav Olofsson,D,SEA,30,0,0,0,0
9,8479968,Vinni Lettieri,C,BOS,29,0,0,0,0
9,8478400,Colin White,C,,27,0,0,0,0
9,8475755,Alexander Petrovic,D,DAL,32,0,0,0,0
9,8481812,Nikolai Knyzhov,D,,27,0,0,0,0
9,8481593,Jayden Struble,D,MTL,23,0,0,0,0
9,8481532,Alex Turcotte,C,LAK,23,0,0,0,0
9,8482126,Emil Andrae,D,PHI,31,0,0,0,0
9,8479944,Zach Aston-Reese,C,VGK,30,0,0,0,0
9,8471817,Ryan Reaves,R,TOR,37,0,0,0,0
9,8481206,John Ludvig,D,PIT,24,0,0,0,0
9,8481599,Victor Soderstrom,D,UTA,23,0,0,0,0
9,8480292,Carson Meyer,R,ANA,27,0,0,0,0
9,8482496,Nils Aman,C,VAN,24,0,0,0,0
9,8479718,Alex Barré-Boulet,C,MTL,27,0,0,0,0
9,8479994,Jaret Anderson-Dolan,C,WPG,25,0,0,0,0
9,8480184,Gustav Lindstrom,D,,26,0,0,0,0
9,8480890,Jan Jenik,R,OTT,24,0,0,0,0
9,8478067,Oskar Lindblom,L,,28,0,0,0,0
9,8476934,Brock McGinn,L,ANA,30,0,0,0,0
9,8479985,Cale Fleury,D,SEA,26,0,0,0,0
9,8484304,Uvis Balinskis,D,FLA,28,0,0,0,0
9,8479981,Jonah Gadjovich,L,FLA,26,0,0,0,0
9,8481716,Dmitri Voronkov,L,CBJ,24,0,0,0,0
9,8474709,Matt Martin,L,,35,0,0,0,0
9,8482634,Alex Steeves,C,TOR,25,0,0,0,0
9,8480823,Alexander Alexeyev,D,WSH,25,0,0,0,0
9,8477541,Dakota Mermis,D,TOR,30,0,0,0,0
9,8483491,Ivan Miroshnichenko,L,WSH,20,0,0,0,0
9,8478477,Mitchell Stephens,C,SEA,27,0,0,0,0
9,8481543,Nikita Alexandrov,C,STL,24,0,0,0,0
9,8479423,Alex Nylander,L,,26,0,0,0,0
9,8482451,Mikael Pyyhtia,L,CBJ,23,0,0,0,0
9,8478831,Kevin Stenlund,C,UTA,28,0,0,0,0
9,8480306,Grant Hutton,D,NYI,29,0,0,0,0
9,8478028,Fredrik Olofsson,L,,28,0,0,0,0
9,8477462,Robert Hagg,D,VGK,29,0,0,0,0
9,8477320,Anton Blidh,L,NYR,29,0,0,0,0
9,8482157,Will Cuylle,L,NYR,22,0,0,0,0
9,8482737,Zack Bolduc,C,STL,21,0,0,0,0
9,8481239,Samuel Fagemo,L,,24,0,0,0,0
9,8481600,Tobias Bjornfot,D,FLA,23,0,0,0,0
9,8478409,Anthony Richard,C,PHI,28,0,0,0,0
9,8474145,Robert Bortuzzo,D,,35,0,0,0,0
9,8475958,Michael Sgarbossa,C,WSH,32,0,0,0,0
9,8479986,Kole Lind,R,DAL,26,0,0,0,0
9,8479249,Andrew Poturalski,C,SJS,30,0,0,0,0
9,8479362,Riley Tufte,L,BOS,26,0,0,0,0
9,8479991,Jake Leschyshyn,C,NYR,25,0,0,0,0
9,8479587,Rhett Gardner,C,PHI,28,0,0,0,0
9,8482744,James Malatesta,L,CBJ,21,0,0,0,0
9,8478854,Ryan Shea,D,PIT,27,0,0,0,0
9,8481591,Sam Poulin,R,,23,0,0,0,0
9,8483512,Matt Savoie,C,EDM,20,0,0,0,0
9,8482102,Vasily Ponomarev,C,PIT,22,0,0,0,0
9,8482162,Roby Jarventie,L,EDM,22,0,0,0,0
9,8481016,Ruslan Iskhakov,C,,24,0,0,0,0
9,8482172,Landon Slaggert,L,CHI,22,0,0,0,0
9,8482747,Brennan Othmann,L,NYR,21,0,0,0,0
9,8480031,Maxime Comtois,L,,25,0,0,0,0
9,8480226,Marián Studenic,R,,26,0,0,0,0
9,8478408,Travis Dermott,D,,28,0,0,0,0
9,8481518,Nolan Foote,L,NJD,24,0,0,0,0
9,8479419,Brett Murray,L,BUF,26,0,0,0,0
9,8482088,Justin Sourdif,R,FLA,22,0,0,0,0
9,8482201,Gage Goncalves,C,TBL,23,0,0,0,0
9,8481578,Graeme Clarke,R,MIN,23,0,0,0,0
9,8482177,Marat Khusnutdinov,C,MIN,22,0,0,0,0
9,8481754,Nikita Nesterenko,C,ANA,23,0,0,0,0
9,8483531,Brian Halonen,L,NJD,25,0,0,0,0
9,8483920,Pierrick Dube,R,WSH,23,0,0,0,0
9,8480851,Akil Thomas,C,LAK,24,0,0,0,0
9,8475235,Nicolas Deslauriers,L,PHI,33,0,0,0,0
9,8482476,Emil Heineman,L,MTL,23,0,0,0,0
9,8477149,Scott Sabourin,R,SJS,32,0,0,0,0
9,8483549,Lucas Condotta,L,MTL,27,0,0,0,0
9,8482765,Isak Rosen,R,BUF,21,0,0,0,0
9,8481237,Kyle MacLean,C,NYI,25,0,0,0,0
9,8481024,Linus Karlsson,C,VAN,25,0,0,0,0
9,8481690,Tyler Angle,C,,24,0,0,0,0
9,8483570,Ben Meyers,C,SEA,26,0,0,0,0
9,8481655,Cole Schwindt,R,CGY,23,0,0,0,0
9,8481462,Mason Morelli,L,VGK,28,0,0,0,0
9,8483401,Marc Johnstone,R,PIT,28,0,0,0,0
9,8478956,Samuel Laberge,L,NJD,27,0,0,0,0
9,8479533,Joona Koppanen,L,,26,0,0,0,0
9,8482197,Adam Raska,R,MIN,23,0,0,0,0
9,8482250,Callahan Burke,C,VGK,27,0,0,0,0
9,8482784,Zach Dean,C,STL,21,0,0,0,0
9,8484255,Jason Polin,R,COL,25,0,0,0,0
9,8481077,John Leonard,L,,26,0,0,0,0
9,8481534,Raphael Lavoie,C,EDM,24,0,0,0,0
9,8483609,Adam Klapka,R,CGY,24,0,0,0,0
9,8482751,Ryan Winterton,C,SEA,21,0,0,0,0
9,8480267,Sammy Walker,C,MIN,25,0,0,0,0
9,8475766,Austin Watson,L,,32,0,0,0,0
9,8482460,Matt Rempe,C,NYR,22,0,0,0,0
9,8481065,Angus Crookshank,L,OTT,25,0,0,0,0
9,8481070,Hugh McGing,L,,26,0,0,0,0
9,8476323,Max McCormick,L,SEA,32,0,0,0,0
9,8483395,Arshdeep Bains,L,VAN,23,0,0,0,0
9,8484259,Ondrej Pavel,C,COL,31,0,0,0,0
9,8483432,Luca Del Bel Belluz,C,CBJ,31,0,0,0,0
9,8483045,Cameron Butler,R,CBJ,31,0,0,0,0
9,8482061,Brandon Biro,L,SEA,26,0,0,0,0
9,8477401,John Hayden,C,SEA,29,0,0,0,0
9,8475278,Byron Froese,C,,33,0,0,0,0
9,8478446,Glenn Gawdin,C,LAK,27,0,0,0,0
9,8477993,Justin Kirkland,C,CGY,28,0,0,0,0
9,8482147,Jean-Luc Foudy,C,COL,22,0,0,0,0
9,8480032,Shane Bowers,C,NJD,25,0,0,0,0
9,8479330,Brandon Gignac,C,MTL,27,0,0,0,0
9,8480776,Sheldon Rempal,R,,29,0,0,0,0
9,8475413,Justin Dowling,C,NJD,34,0,0,0,0
9,8481726,Adam Edstrom,C,NYR,24,0,0,0,0
9,8480844,Grigori Denisenko,L,VGK,24,0,0,0,0
9,8478147,Bokondji Imama,L,PIT,28,0,0,0,0
9,8478881,Brett Seney,L,CHI,28,0,0,0,0
9,8483630,Pavol Regenda,L,ANA,25,0,0,0,0
9,8480836,Jonathan Gruden,C,,24,0,0,0,0
9,8484314,Jiri Smejkal,L,,28,0,0,0,0
9,8475780,Chris Wagner,R,COL,33,0,0,0,0
9,8479546,Oskar Steen,C,,26,0,0,0,0
9,8483597,Milos Kelemen,L,UTA,25,0,0,0,0
9,8481789,Tye Kartye,L,SEA,23,0,0,0,0
9,8484325,Waltteri Merela,C,TBL,26,0,0,0,0
9,8479421,Jacob Moverare,D,LAK,26,0,0,0,0
9,8481585,Egor Afanasyev,L,SJS,23,0,0,0,0
9,8479547,Matthew Phillips,R,,26,0,0,0,0
9,8479367,William Lockwood,R,FLA,26,0,0,0,0
9,8476915,Jujhar Khaira,L,,30,0,0,0,0
9,8481422,Jacob Lucchini,C,NSH,29,0,0,0,0
9,8480468,James Hamblin,L,EDM,25,0,0,0,0
9,8478051,Max Willman,C,NJD,29,0,0,0,0
9,8481556,John Beecher,C,BOS,23,0,0,0,0
9,8478078,Rourke Chartier,C,,28,0,0,0,0
10,8478402,Connor McDavid,C,EDM,27,82,44,119,163
10,8476453,Nikita Kucherov,R,TBL,31,82,32,113,145
10,8477492,Nathan MacKinnon,C,COL,29,82,60,80,140
10,8481559,Jack Hughes,C,NJD,23,82,52,66,118
10,8478864,Kirill Kaprizov,L,MIN,27,82,49,67,116
10,8479318,Auston Matthews,C,TOR,27,82,66,47,113
10,8477934,Leon Draisaitl,C,EDM,29,82,42,70,112
10,8478550,Artemi Panarin,L,NYR,33,82,38,71,109
10,8478420,Mikko Rantanen,R,COL,28,82,48,57,105
10,8480012,Elias Pettersson,C,VAN,26,82,43,62,105
10,8476468,J.T. Miller,C,VAN,31,82,33,71,104
10,8480023,Robert Thomas,C,STL,25,82,29,75,104
10,8480027,Jason Robertson,L,DAL,25,82,29,75,104
10,8477956,David Pastrnak,R,BOS,28,82,49,53,102
10,8477939,William Nylander,R,TOR,28,82,41,59,100
10,8476887,Filip Forsberg,L,NSH,30,82,48,51,99
10,8477942,Kevin Fiala,L,LAK,28,82,36,61,97
10,8477493,Aleksander Barkov,C,FLA,29,82,35,62,97
10,8479314,Matthew Tkachuk,L,FLA,27,82,24,73,97
10,8479323,Adam Fox,D,NYR,26,82,15,82,97
10,8477933,Sam Reinhart,C,FLA,29,82,48,48,96
10,8478010,Brayden Point,C,TBL,28,82,47,48,95
10,8480069,Cale Makar,D,COL,26,82,20,75,95
10,8475786,Zach Hyman,L,EDM,32,82,52,42,94
10,8480801,Brady Tkachuk,L,OTT,25,82,40,54,94
10,8475172,Nazem Kadri,C,CGY,34,82,39,55,94
10,8474564,Steven Stamkos,C,NSH,34,82,44,49,93
10,8476346,Johnny Gaudreau,L,CBJ,31,82,21,71,92
10,8476389,Vincent Trocheck,C,NYR,31,82,31,60,91
10,8476454,Ryan Nugent-Hopkins,C,EDM,31,82,33,57,90
10,8479343,Clayton Keller,R,UTA,26,82,36,53,89
10,8478403,Jack Eichel,C,VGK,28,82,36,52,88
10,8477404,Jake Guentzel,C,TBL,30,82,44,43,87
10,8476459,Mika Zibanejad,C,NYR,31,82,37,50,87
10,8476456,Jonathan Huberdeau,C,CGY,31,82,20,67,87
10,8477501,Valeri Nichushkin,R,COL,29,82,40,46,86
10,8479407,Jesper Bratt,L,NJD,26,82,36,50,86
10,8478427,Sebastian Aho,C,CAR,27,82,31,55,86
10,8477946,Dylan Larkin,C,DET,28,82,42,42,84
10,8477951,Nick Schmaltz,C,UTA,28,82,30,54,84
10,8480800,Quinn Hughes,D,VAN,25,82,14,70,84
10,8477402,Pavel Buchnevich,L,STL,29,82,31,52,83
10,8478398,Kyle Connor,L,WPG,28,82,44,38,82
10,8471675,Sidney Crosby,C,PIT,37,82,35,47,82
10,8473419,Brad Marchand,L,BOS,36,82,35,47,82
10,8479385,Jordan Kyrou,C,STL,26,82,31,51,82
10,8482116,Tim Stützle,C,OTT,22,82,24,58,82
10,8478445,Mathew Barzal,C,NYI,27,82,22,59,81
10,8471215,Evgeni Malkin,C,PIT,38,82,26,54,80
10,8476539,Jonathan Marchessault,R,NSH,34,82,41,38,79
10,8475170,Brayden Schenn,C,STL,33,82,39,40,79
10,8481523,Kirby Dach,C,MTL,23,82,22,57,79
10,8475692,Mats Zuccarello,R,MIN,37,82,15,64,79
10,8475166,John Tavares,C,TOR,34,82,37,41,78
10,8481557,Matt Boldy,L,MIN,23,82,34,44,78
10,8480830,Andrei Svechnikov,R,CAR,24,82,31,47,78
10,8475184,Chris Kreider,L,NYR,33,82,45,32,77
10,8478414,Timo Meier,R,NJD,28,82,37,40,77
10,8476460,Mark Scheifele,C,WPG,31,82,32,45,77
10,8475810,Bryan Rust,R,PIT,32,82,37,39,76
10,8475784,Jeff Skinner,C,EDM,32,82,37,39,76
10,8479337,Alex DeBrincat,R,DET,27,82,32,43,75
10,8477940,Nikolaj Ehlers,L,WPG,28,82,29,46,75
10,8480002,Nico Hischier,C,NJD,25,82,28,46,74
10,8474600,Roman Josi,D,NSH,34,82,21,53,74
10,8477496,Elias Lindholm,C,BOS,30,82,20,54,74
10,8480865,Noah Dobson,D,NYI,24,82,9,65,74
10,8471214,Alex Ovechkin,L,WSH,39,82,35,38,73
10,8477409,Carter Verhaeghe,C,FLA,29,82,36,36,72
10,8478401,Pavel Zacha,C,BOS,27,82,31,41,72
10,8477497,Sean Monahan,C,CBJ,30,82,24,48,72
10,8478460,Zach Werenski,D,CBJ,27,82,21,51,72
10,8480036,Miro Heiskanen,D,DAL,25,82,13,59,72
10,8480018,Nick Suzuki,C,MTL,25,82,29,42,71
10,8475158,Ryan O'Reilly,C,NSH,33,82,24,47,71
10,8478449,Roope Hintz,C,DAL,28,82,34,36,70
10,8478444,Brock Boeser,R,VAN,27,82,33,37,70
10,8480803,Evan Bouchard,D,EDM,25,82,13,57,70
10,8478493,Joel Eriksson Ek,C,MIN,27,82,35,34,69
10,8478440,Dylan Strome,C,WSH,27,82,29,40,69
10,8477504,Josh Morrissey,D,WPG,29,82,11,58,69
10,8475913,Mark Stone,R,VGK,32,82,34,34,68
10,8478439,Travis Konecny,R,PHI,27,82,28,40,68
10,8476853,Morgan Rielly,D,TOR,30,82,11,57,68
10,8480039,Martin Necas,C,CAR,25,82,31,36,67
10,8481711,Matias Maccelli,L,UTA,24,82,18,49,67
10,8482093,Seth Jarvis,C,CAR,22,82,32,34,66
10,8480208,Drake Batherson,R,OTT,26,82,28,38,66
10,8475754,Brock Nelson,C,NYI,33,82,27,39,66
10,8479542,Brandon Hagel,L,TBL,26,82,31,34,65
10,8478042,Viktor Arvidsson,R,EDM,31,82,27,38,65
10,8477949,Alex Tuch,R,BUF,28,82,25,40,65
10,8474150,Mikael Backlund,C,CGY,35,82,21,44,65
10,8479420,Tage Thompson,C,BUF,27,82,31,33,64
10,8477960,Adrian Kempe,R,LAK,28,82,30,34,64
10,8477500,Bo Horvat,C,NYI,29,82,29,35,64
10,8474578,Erik Karlsson,D,PIT,34,82,13,51,64
10,8482078,Lucas Raymond,L,DET,22,82,24,39,63
10,8470613,Brent Burns,D,CAR,39,82,23,40,63
10,8476432,Boone Jenner,C,CBJ,31,82,34,28,62
10,8478519,Anthony Cirelli,C,TBL,27,82,32,30,62
10,8475167,Victor Hedman,D,TBL,34,82,13,49,62
10,8479325,Charlie McAvoy,D,BOS,27,82,11,51,62
10,8478047,Michael Bunting,L,PIT,29,82,30,31,61
10,8478873,Troy Terry,R,ANA,27,82,26,35,61
10,8477476,Artturi Lehkonen,L,COL,29,82,26,35,61
10,8476448,William Karlsson,C,VGK,31,82,25,36,61
10,8477447,Shea Theodore,D,VGK,29,82,19,42,61
10,8480188,Fabian Zetterlund,L,SJS,25,82,29,31,60
10,8471685,Anze Kopitar,C,LAK,37,82,22,38,60
10,8473994,Jamie Benn,L,DAL,35,82,22,38,60
10,8475798,Mikael Granlund,C,SJS,32,82,12,48,60
10,8478474,Lawson Crouse,L,UTA,27,82,32,27,59
10,8481068,Yegor Sharangovich,C,CGY,26,82,30,29,59
10,8473986,Alex Killorn,L,ANA,35,82,28,31,59
10,8482665,Matty Beniers,C,SEA,22,82,27,32,59
10,8477986,Brandon Montour,D,SEA,30,82,22,37,59
10,8480078,Filip Chytil,C,NYR,25,82,19,40,59
10,8474141,Patrick Kane,R,DET,36,82,18,41,59
10,8471724,Kris Letang,D,PIT,37,82,16,43,59
10,8471698,T.J. Oshie,R,WSH,38,82,27,31,58
10,8481528,Dylan Cozens,C,BUF,23,82,24,34,58
10,8482110,Dawson Mercer,C,NJD,23,82,24,34,58
10,8476905,Chandler Stephenson,C,SEA,30,82,21,37,58
10,8476479,Phillip Danault,C,LAK,31,82,18,40,58
10,8478038,Devon Toews,D,COL,30,82,16,42,58
10,8474641,Adam Henrique,C,EDM,34,82,22,35,57
10,8479675,Trevor Moore,L,LAK,29,82,29,27,56
10,8476399,Blake Coleman,C,CGY,33,82,27,29,56
10,8475191,Reilly Smith,R,NYR,33,82,24,32,56
10,8473512,Claude Giroux,R,OTT,36,82,22,34,56
10,8480797,Joel Farabee,L,PHI,24,82,19,37,56
10,8480014,Gabriel Vilardi,C,WPG,25,82,33,22,55
10,8478975,Mason Marchment,L,DAL,29,82,24,31,55
10,8475168,Matt Duchene,C,DAL,33,82,23,32,55
10,8478856,Conor Garland,R,VAN,28,82,23,32,55
10,8478233,Andrew Mangiapane,L,WSH,28,82,23,32,55
10,8480798,Philipp Kurashev,C,CHI,25,82,20,35,55
10,8479999,Casey Mittelstadt,C,COL,26,82,18,37,55
10,8476462,Dougie Hamilton,D,NJD,31,82,18,37,55
10,8482667,William Eklund,L,SJS,22,82,18,37,55
10,8476875,Mike Matheson,D,MTL,30,82,9,46,55
10,8479339,Patrik Laine,L,CBJ,26,82,26,28,54
10,8476881,Tomas Hertl,C,VGK,31,82,25,29,54
10,8481540,Cole Caufield,R,MTL,23,82,25,29,54
10,8480015,Owen Tippett,R,PHI,25,82,25,29,54
10,8482745,Mason McTavish,C,ANA,21,82,21,33,54
10,8481596,Shane Pinto,C,OTT,24,82,21,33,54
10,8482097,Jack Quinn,R,BUF,23,82,20,34,54
10,8481533,Trevor Zegras,C,ANA,23,82,18,36,54
10,8474565,Alex Pietrangelo,D,VGK,34,82,17,37,54
10,8479410,Mikhail Sergachev,D,UTA,26,82,6,48,54
10,8474679,Gustav Nyquist,C,NSH,35,82,21,32,53
10,8477935,Sam Bennett,C,FLA,28,82,20,33,53
10,8478462,Nicolas Roy,C,VGK,27,82,14,39,53
10,8474586,Jordan Eberle,R,SEA,34,82,25,27,52
10,8475169,Evander Kane,L,EDM,33,82,24,28,52
10,8476882,Teuvo Teravainen,L,CHI,30,82,18,34,52
10,8477932,Aaron Ekblad,D,FLA,28,82,13,39,52
10,8482105,Jake Sanderson,D,OTT,22,82,11,41,52
10,8477955,Jared McCann,L,SEA,28,82,28,23,51
10,8478498,Jake DeBrusk,L,VAN,28,82,25,26,51
10,8482109,Alexis Lafrenière,L,NYR,23,82,25,26,51
10,8475726,Tyler Toffoli,C,SJS,32,82,22,29,51
10,8482149,Cole Perfetti,C,WPG,22,82,18,33,51
10,8482124,Quinton Byfield,R,LAK,22,82,17,34,51
10,8476792,Torey Krug,D,STL,33,82,17,34,51
10,8476292,Ondrej Palat,L,NJD,33,82,14,37,51
10,8479345,Jakob Chychrun,D,WSH,26,82,13,38,51
10,8480064,Josh Norris,C,OTT,25,82,33,17,50
10,8475151,Kyle Palmieri,C,NYI,33,82,26,24,50
10,8476880,Tom Wilson,R,WSH,30,82,24,26,50
10,8479365,Trent Frederic,C,BOS,26,82,21,29,50
10,8480839,Rasmus Dahlin,D,BUF,24,82,13,37,50
10,8478407,Vince Dunn,D,SEA,28,82,12,38,50
10,8474590,John Carlson,D,WSH,34,82,11,39,50
10,8475794,Tyler Seguin,C,DAL,32,82,25,24,49
10,8483808,Andrei Kuzmenko,L,CGY,28,82,24,25,49
10,8480028,Morgan Frost,C,PHI,25,82,20,29,49
10,8481618,Alex Newhook,C,MTL,23,82,20,29,49
10,8478396,Noah Hanifin,D,VGK,27,82,13,36,49
10,8476458,Ryan Strome,C,ANA,31,82,13,36,49
10,8478397,Rasmus Andersson,D,CGY,28,82,7,42,49
10,8481032,Paul Cotter,C,NJD,25,82,28,20,48
10,8477426,Nicholas Paul,L,TBL,29,82,26,22,48
10,8477407,Anthony Duclair,L,NYI,29,82,21,27,48
10,8479987,Morgan Geekie,C,BOS,26,82,19,29,48
10,8478458,Jack Roslovic,C,CAR,27,82,17,31,48
10,8477903,Garnet Hathaway,R,PHI,33,82,16,32,48
10,8477494,Jonathan Drouin,L,COL,29,82,14,34,48
10,8477495,Seth Jones,D,CHI,30,82,13,35,48
10,8477456,J.T. Compher,L,DET,29,82,13,35,48
10,8479425,Filip Hronek,D,VAN,27,82,10,38,48
10,8481581,Thomas Harley,D,DAL,23,82,10,38,48
10,8481542,Moritz Seider,D,DET,23,82,9,39,48
10,8482113,Anton Lundell,C,FLA,23,82,23,24,47
10,8475287,Erik Haula,L,NJD,33,82,17,30,47
10,8478055,Gustav Forsling,D,FLA,28,82,16,31,47
10,8482684,Luke Hughes,D,NJD,21,82,12,35,47
10,8473563,Nicklas Backstrom,C,WSH,37,82,12,35,47
10,8478366,Frank Vatrano,R,ANA,30,82,26,20,46
10,8481535,Nils Hoglander,L,VAN,24,82,26,20,46
10,8478046,Danton Heinen,L,VAN,29,82,23,23,46
10,8480849,Barrett Hayton,C,UTA,24,82,21,25,46
10,8476826,Yanni Gourde,C,SEA,33,82,20,26,46
10,8480220,Noah Cates,L,PHI,25,82,20,26,46
10,8475745,Charlie Coyle,C,BOS,32,82,19,27,46
10,8482475,Yegor Chinakhov,R,CBJ,23,82,19,27,46
10,8476329,Travis Boyd,C,MIN,31,82,18,28,46
10,8477498,Darnell Nurse,D,EDM,29,82,16,30,46
10,8477346,MacKenzie Weegar,D,CGY,30,82,15,31,46
10,8481554,Kaapo Kakko,R,NYR,23,82,26,19,45
10,8476438,Brandon Saad,L,STL,32,82,25,20,45
10,8482740,Wyatt Johnston,C,DAL,21,82,23,22,45
10,8477964,Ivan Barbashev,C,VGK,29,82,17,28,45
10,8475765,Vladimir Tarasenko,R,DET,33,82,16,29,45
10,8479400,Pierre-Luc Dubois,L,WSH,26,82,15,30,45
10,8477503,Max Domi,C,TOR,29,82,14,31,45
10,8476892,Colton Parayko,D,STL,31,82,6,39,45
10,8477511,Anthony Mantha,R,CGY,30,82,20,24,44
10,8478438,Tommy Novak,C,NSH,27,82,17,27,44
10,8477998,Warren Foegele,L,LAK,28,82,16,28,44
10,8478542,Evan Rodrigues,C,FLA,31,82,15,29,44
10,8477444,Andre Burakovsky,L,SEA,29,82,15,29,44
10,8478472,Mathieu Joseph,R,STL,27,82,14,30,44
10,8476906,Shayne Gostisbehere,D,CAR,31,82,10,34,44
10,8476923,Damon Severson,D,CBJ,30,82,8,36,44
10,8475799,Nino Niederreiter,R,WPG,32,82,22,21,43
10,8478109,Victor Olofsson,L,VGK,29,82,20,23,43
10,8477989,Christian Dvorak,C,MTL,28,82,19,24,43
10,8477416,Oliver Bjorkstrand,R,SEA,29,82,14,29,43
10,8480434,Sean Durzi,D,UTA,26,82,14,29,43
10,8475768,Jaden Schwartz,C,SEA,32,82,13,30,43
10,8482146,Luke Evangelista,R,NSH,22,82,22,20,42
10,8478115,Pierre Engvall,L,NYI,28,82,21,21,42
10,8475848,Brendan Gallagher,R,MTL,32,82,20,22,42
10,8481656,Aliaksei Protas,C,WSH,23,82,17,25,42
10,8475714,Calle Jarnkrok,C,TOR,33,82,17,25,42
10,8477429,Andrew Copp,C,DET,30,82,16,26,42
10,8475764,Cam Fowler,D,ANA,33,82,11,31,42
10,8481580,Connor McMichael,C,WSH,23,82,18,23,41
10,8482660,Kent Johnson,C,CBJ,22,82,17,24,41
10,8474189,Lars Eller,C,PIT,35,82,17,24,41
10,8480835,Jack Drury,C,CAR,24,82,15,26,41
10,8475753,Justin Faulk,D,STL,32,82,9,32,41
10,8482720,Matthew Knies,L,TOR,22,82,9,32,41
10,8477948,Travis Sanheim,D,PHI,28,82,6,35,41
10,8479525,Ross Colton,C,COL,28,82,25,15,40
10,8474102,David Perron,L,OTT,36,82,18,22,40
10,8476483,Rickard Rakell,R,PIT,31,82,18,22,40
10,8478891,Mason Appleton,C,WPG,28,82,16,24,40
10,8476927,Teddy Blueger,C,VAN,30,82,11,29,40
10,8478469,Thomas Chabot,D,OTT,27,82,10,30,40
10,8476869,Brady Skjei,D,NSH,30,82,7,33,40
10,8475200,Dmitry Orlov,D,CAR,33,82,7,33,40
10,8476854,Hampus Lindholm,D,BOS,30,82,6,34,40
10,8480893,Kirill Marchenko,R,CBJ,24,82,28,11,39
10,8482159,Tyson Foerster,R,PHI,22,82,23,16,39
10,8482175,JJ Peterka,R,BUF,22,82,21,18,39
10,8482079,Marco Rossi,C,MIN,23,82,20,19,39
10,8479390,Taylor Raddysh,R,WSH,26,82,19,20,39
10,8480068,Ryan Poehling,C,PHI,25,82,16,23,39
10,8482705,Cole Sillinger,C,CBJ,21,82,15,24,39
10,8476981,Josh Anderson,R,MTL,30,82,13,26,39
10,8478507,John Marino,D,UTA,27,82,5,34,39
10,8478500,Ivan Provorov,D,CBJ,27,82,4,35,39
10,8481560,Arthur Kaliyev,R,LAK,23,82,20,18,38
10,8475760,Nick Bjugstad,C,UTA,32,82,19,19,38
10,8478057,Dakota Joshua,C,VAN,28,82,18,20,38
10,8477947,Sonny Milano,L,WSH,28,82,18,20,38
10,8477451,Ryan Hartman,R,MIN,30,82,17,21,38
10,8482055,Drew O'Connor,L,PIT,26,82,17,21,38
10,8479316,Luke Kunin,C,SJS,27,82,17,21,38
10,8477479,Tyler Bertuzzi,L,CHI,29,82,16,22,38
10,8477021,Alex Kerfoot,C,UTA,30,82,15,23,38
10,8480871,Adam Boqvist,D,FLA,24,82,15,23,38
10,8476925,Colton Sissons,C,NSH,31,82,14,24,38
10,8476461,Sean Couturier,C,PHI,32,82,14,24,38
10,8480113,Alex Iafallo,L,WPG,31,82,13,25,38
10,8474563,Drew Doughty,D,LAK,35,82,7,31,38
10,8480873,Rasmus Sandin,D,WSH,24,82,3,35,38
10,8475314,Anders Lee,L,NYI,34,82,21,16,37
10,8482125,Alexander Holtz,R,VGK,22,82,18,19,37
10,8475722,Jason Zucker,L,BUF,32,82,15,22,37
10,8475218,Mattias Ekholm,D,EDM,34,82,14,23,37
10,8474716,Jared Spurgeon,D,MIN,35,82,8,29,37
10,8477969,Marcus Pettersson,D,PIT,28,82,5,32,37
10,8476469,Joel Armia,R,MTL,31,82,25,11,36
10,8476392,Adam Lowry,C,WPG,31,82,15,21,36
10,8475220,Marcus Foligno,L,MIN,33,82,13,23,36
10,8484144,Connor Bedard,C,CHI,19,82,11,25,36
10,8480817,K'Andre Miller,D,NYR,24,82,9,27,36
10,8477507,Nikita Zadorov,D,BOS,29,82,8,28,36
10,8476979,Erik Gustafsson,D,DET,32,82,4,32,36
10,8480281,Alexey Toropchenko,R,STL,25,82,24,11,35
10,8475791,Taylor Hall,L,CHI,33,82,20,15,35
10,8482089,Jake Neighbours,L,STL,22,82,20,15,35
10,8475793,Ryan Johansen,C,PHI,32,82,17,18,35
10,8479591,Michael Eyssimont,C,TBL,28,82,17,18,35
10,8476872,Scott Laughton,C,PHI,30,82,15,20,35
10,8477953,Kasperi Kapanen,R,STL,28,82,13,22,35
10,8476917,Adam Pelech,D,NYI,30,82,5,30,35
10,8480459,Pius Suter,C,VAN,28,82,15,19,34
10,8473533,Jordan Staal,C,CAR,36,82,15,19,34
10,8482699,Dylan Guenther,R,UTA,21,82,14,20,34
10,8475763,Kevin Hayes,R,PIT,32,82,13,21,34
10,8483468,Jiri Kulich,C,BUF,20,82,12,22,34
10,8478911,Matt Roy,D,WSH,29,82,9,25,34
10,8482655,J.J. Moser,D,TBL,24,82,5,29,34
10,8479941,Justin Danforth,R,CBJ,31,82,18,15,33
10,8474149,Evgenii Dadonov,R,DAL,35,82,17,16,33
10,8478211,Dryden Hunt,L,CGY,29,82,16,17,33
10,8477425,Miles Wood,L,COL,29,82,15,18,33
10,8481624,Ilya Mikheyev,R,CHI,30,82,15,18,33
10,8479992,Michael Rasmussen,C,DET,25,82,14,19,33
10,8478413,Jordan Greenway,L,BUF,27,82,14,19,33
10,8478133,Jake Evans,C,MTL,28,82,12,21,33
10,8481553,Bobby Brink,R,PHI,23,82,12,21,33
10,8480049,Dylan Samberg,D,WPG,25,82,1,32,33
10,8480829,Jesperi Kotkaniemi,C,CAR,24,82,18,14,32
10,8480813,Joe Veleno,C,DET,24,82,17,15,32
10,8481604,Pavel Dorofeyev,L,VGK,24,82,16,16,32
10,8478463,Anthony Beauvillier,L,PIT,27,82,16,16,32
10,8475842,Sam Carrick,C,NYR,32,82,14,18,32
10,8480009,Eeli Tolvanen,R,SEA,25,82,13,19,32
10,8474053,Logan Couture,C,SJS,35,82,13,19,32
10,8476885,Jacob Trouba,D,NYR,30,82,12,20,32
10,8476312,Josh Manson,D,COL,33,82,5,27,32
10,8483515,Juraj Slafkovsky,L,MTL,20,82,18,13,31
10,8482259,Bobby McMann,C,TOR,28,82,17,14,31
10,8473422,Nick Foligno,L,CHI,37,82,16,15,31
10,8470621,Corey Perry,R,EDM,39,82,15,16,31
10,8477952,Robby Fabbri,C,ANA,28,82,14,17,31
10,8480185,Eetu Luostarinen,C,FLA,26,82,13,18,31
10,8482092,Ridly Greig,C,OTT,22,82,13,18,31
10,8481186,Logan O'Connor,R,COL,28,82,12,19,31
10,8483431,Logan Cooley,C,UTA,20,82,12,19,31
10,8484145,Zach Benson,L,BUF,19,82,12,19,31
10,8481546,Cam York,D,PHI,23,82,11,20,31
10,8476902,Esa Lindell,D,DAL,30,82,11,20,31
10,8477919,Frederick Gaudreau,C,MIN,31,82,10,21,31
10,8476960,Andreas Athanasiou,C,CHI,30,82,10,21,31
10,8482671,Owen Power,D,BUF,22,82,6,25,31
10,8479398,Samuel Girard,D,COL,26,82,6,25,31
10,8476958,Jaccob Slavin,D,CAR,30,82,3,28,31
10,8478020,Michael Amadio,C,OTT,28,82,19,11,30
10,8476873,Mark Jankowski,C,NSH,30,82,15,15,30
10,8475149,Marcus Johansson,L,MIN,34,82,13,17,30
10,8481582,Nicholas Robertson,L,TOR,23,82,13,17,30
10,8478432,Christian Fischer,R,DET,27,82,13,17,30
10,8477450,Jason Dickinson,C,CHI,29,82,12,18,30
10,8481704,Juuso Parssinen,C,NSH,23,82,10,20,30
10,8475855,Jesper Fast,R,CAR,33,82,10,20,30
10,8475343,Nic Dowd,C,WSH,34,82,10,20,30
10,8484149,Gavin Brindley,C,CBJ,20,82,10,20,30
10,8475193,Tomas Tatar,L,NJD,34,82,9,21,30
10,8482624,Daniil Miromanov,D,CGY,27,82,9,21,30
10,8480073,Erik Brannstrom,D,COL,25,82,7,23,30
10,8476467,Jamie Oleksiak,D,SEA,32,82,7,23,30
10,8483495,Simon Nemec,D,NJD,20,82,7,23,30
10,8476897,Oskar Sundqvist,C,STL,30,82,5,25,30
10,8479402,Jake Bean,D,CGY,26,82,3,27,30
10,8482087,Kaiden Guhle,D,MTL,22,82,1,29,30
10,8476278,Colin Blackwell,C,DAL,31,82,18,11,29
10,8482133,Thomas Bordeleau,C,SJS,22,82,13,16,29
10,8480855,Jack McBain,C,UTA,24,82,13,16,29
10,8477406,Mattias Janmark,C,EDM,32,82,13,16,29
10,8476918,Jimmy Vesey,L,NYR,31,82,12,17,29
10,8476480,Vladislav Namestnikov,C,WPG,32,82,11,18,29
10,8476419,Jean-Gabriel Pageau,C,NYI,32,82,9,20,29
10,8481568,Alex Vlasic,D,CHI,23,82,6,23,29
10,8480043,Timothy Liljegren,D,TOR,25,82,2,27,29
10,8482245,Artem Zub,D,OTT,29,82,2,27,29
10,8476474,Stefan Noesen,R,NJD,31,82,13,15,28
10,8480003,Jesper Boqvist,C,FLA,26,82,13,15,28
10,8479393,Noah Gregor,C,OTT,26,82,13,15,28
10,8483763,Maksymilian Szuber,D,UTA,22,82,13,15,28
10,8477015,Connor Brown,R,EDM,30,82,12,16,28
10,8476374,Sean Kuraly,C,CBJ,31,82,11,17,28
10,8480336,Sean Walker,D,CAR,30,82,10,18,28
10,8481606,Jordan Spence,D,LAK,23,82,4,24,28
10,8478851,Alexandre Carrier,D,NSH,28,82,2,26,28
10,8477987,Ryan Donato,C,CHI,28,82,13,14,27
10,8482117,Lukas Reichel,L,CHI,22,82,12,15,27
10,8480074,Alexandre Texier,C,STL,25,82,12,15,27
10,8483499,Liam Ohgren,L,MIN,20,82,10,17,27
10,8479351,Sam Steel,C,DAL,26,82,7,20,27
10,8470600,Ryan Suter,D,STL,39,82,7,20,27
10,8479976,Juuso Valimaki,D,UTA,26,82,6,21,27
10,8479371,Dante Fabbro,D,NSH,26,82,6,21,27
10,8480860,Kevin Bahl,D,CGY,24,82,6,21,27
10,8480145,Neal Pionk,D,WPG,29,82,5,22,27
10,8480035,Henri Jokiharju,D,BUF,25,82,5,22,27
10,8475171,Oliver Ekman-Larsson,D,TOR,33,82,3,24,27
10,8478468,Jeremy Lauzon,D,NSH,27,82,3,24,27
10,8481517,Brett Leason,R,ANA,25,82,17,9,26
10,8484166,Adam Fantilli,C,CBJ,20,82,15,11,26
10,8479368,Max Jones,L,BOS,26,82,15,11,26
10,8479661,Tanner Jeannot,L,LAK,27,82,13,13,26
10,8482141,Lukas Cormier,D,VGK,22,82,9,17,26
10,8483565,Nick Blankenburg,D,NSH,26,82,8,18,26
10,8475181,Nick Leddy,D,STL,33,82,6,20,26
10,8475188,Brayden McNabb,D,VGK,33,82,6,20,26
10,8477488,Brett Pesce,D,NJD,30,82,5,21,26
10,8482142,Jamie Drysdale,D,PHI,22,82,3,23,26
10,8482111,Justin Barron,D,MTL,23,82,15,10,25
10,8476858,Phillip Di Giuseppe,L,VAN,31,82,15,10,25
10,8481477,Nico Sturm,C,SJS,29,82,13,12,25
10,8481028,Martin Pospisil,C,CGY,25,82,13,12,25
10,8477353,Tyler Motte,C,DET,29,82,12,13,25
10,8482166,Shakir Mukhamadullin,D,SJS,22,82,12,13,25
10,8479293,Brandon Tanev,L,SEA,33,82,11,14,25
10,8481013,Jonatan Berggren,R,DET,24,82,10,15,25
10,8478569,Noel Acciari,C,PIT,33,82,9,16,25
10,8484153,Leo Carlsson,C,ANA,20,82,6,19,25
10,8479996,Cody Glass,C,NSH,25,82,4,21,25
10,8477506,Ryan Pulock,D,NYI,30,82,4,21,25
10,8473507,Jeff Petry,D,DET,37,82,4,21,25
10,8476878,Zemgus Girgensons,L,TBL,30,82,14,10,24
10,8476921,Jordan Martinook,L,CAR,32,82,12,12,24
10,8478508,Yakov Trenin,C,MIN,27,82,12,12,24
10,8484203,Bradly Nadeau,L,CAR,19,82,11,13,24
10,8479291,Kevin Rooney,C,CGY,31,82,11,13,24
10,8480748,Kiefer Sherwood,L,VAN,29,82,10,14,24
10,8480995,Pontus Holmberg,R,TOR,25,82,8,16,24
10,8476879,Cody Ceci,D,EDM,31,82,6,18,24
10,8479983,Mario Ferraro,D,SJS,26,82,6,18,24
10,8476331,Dylan DeMelo,D,WPG,31,82,4,20,24
10,8479980,Nicolas Hague,D,VGK,26,82,3,21,24
10,8475462,Radko Gudas,D,ANA,34,82,1,23,24
10,8477392,Hudson Fasching,R,NYI,29,82,12,11,23
10,8480789,Oliver Wahlstrom,R,NYI,24,82,11,12,23
10,8481481,Blake Lizotte,C,PIT,27,82,11,12,23
10,8481093,Rafael Harvey-Pinard,L,MTL,25,82,10,13,23
10,8482666,Scott Morrow,D,CAR,22,82,10,13,23
10,8481524,Bowen Byram,D,BUF,23,82,9,14,23
10,8476457,Adam Larsson,D,SEA,32,82,8,15,23
10,8478882,Vladislav Gavrikov,D,LAK,29,82,8,15,23
10,8476429,Scott Mayfield,D,NYI,32,82,8,15,23
10,8481708,Zac Jones,D,NYR,24,82,5,18,23
10,8480246,Nick Perbix,D,TBL,26,82,5,18,23
10,8477839,Conor Sheary,L,TBL,32,82,4,19,23
10,8479998,Mikey Anderson,D,LAK,25,82,4,19,23
10,8477365,Connor Clifton,D,BUF,29,82,4,19,23
10,8475455,Brenden Dillon,D,NJD,34,82,2,21,23
10,8480222,Sebastian Aho,D,PIT,28,82,2,21,23
10,8480980,Connor Dewar,C,TOR,25,82,13,9,22
10,8482062,Cole Smith,L,NSH,29,82,12,10,22
10,8477508,Curtis Lazar,C,NJD,29,82,11,11,22
10,8482122,Brock Faber,D,MIN,22,82,6,16,22
10,8480878,Nils Lundkvist,D,DAL,24,82,4,18,22
10,8476931,Jake McCabe,D,TOR,31,82,2,20,22
10,8479324,Ryan Lindgren,D,NYR,26,82,1,21,22
10,8481601,Simon Holmstrom,R,NYI,23,82,11,10,21
10,8480144,David Kampf,C,TOR,29,82,10,11,21
10,8479359,Beck Malenstyn,L,BUF,26,82,8,13,21
10,8474715,Cam Atkinson,R,TBL,35,82,8,13,21
10,8483457,Lane Hutson,D,MTL,20,82,6,15,21
10,8480950,Ilya Lyubushkin,D,DAL,30,82,5,16,21
10,8478136,Jake Middleton,D,MIN,28,82,4,17,21
10,8478178,Darren Raddysh,D,TBL,28,82,4,17,21
10,8476891,Matt Grzelcyk,D,PIT,30,82,4,17,21
10,8483445,Cutter Gauthier,L,ANA,20,82,3,18,21
10,8478840,Will Borgen,D,SEA,28,82,2,19,21
10,8473453,Trevor Lewis,C,LAK,37,82,11,9,20
10,8480448,Parker Kelly,L,COL,25,82,11,9,20
10,8480802,Ryan McLeod,C,BUF,25,82,9,11,20
10,8480796,Martin Fehervary,D,WSH,25,82,8,12,20
10,8477435,Ryan Graves,D,PIT,29,82,8,12,20
10,8479353,Brett Howden,C,VGK,26,82,7,13,20
10,8483524,Shane Wright,C,SEA,20,82,7,13,20
10,8480870,Bo Groulx,C,NYR,24,82,7,13,20
10,8476442,Matt Nieto,L,PIT,32,82,7,13,20
10,8483505,Matthew Poitras,C,BOS,20,82,6,14,20
10,8482073,Braden Schneider,D,NYR,23,82,5,15,20
10,8478013,Jake Walman,D,SJS,28,82,5,15,20
10,8476967,Brett Kulak,D,EDM,30,82,5,15,20
10,8479576,Vincent Desharnais,D,VAN,28,82,5,15,20
10,8474612,Travis Hamonic,D,OTT,34,82,5,15,20
10,8478434,Keegan Kolesar,R,VGK,27,82,4,16,20
10,8474151,Ryan McDonagh,D,TBL,35,82,1,19,20
10,8482702,Logan Stankoven,C,DAL,21,82,10,9,19
10,8479369,Andrew Peeke,D,BOS,26,82,6,13,19
10,8478859,Niko Mikkola,D,FLA,28,82,5,14,19
10,8480806,Isac Lundestrom,C,ANA,25,82,5,14,19
10,8477499,Rasmus Ristolainen,D,PHI,30,82,4,15,19
10,8481567,Henry Thrun,D,SJS,23,82,3,16,19
10,8475233,David Savard,D,MTL,34,82,2,17,19
10,8481014,Alexander Romanov,D,NYI,24,82,2,17,19
10,8482762,Simon Edvinsson,D,DET,21,82,11,7,18
10,8483493,Frank Nazar,C,CHI,20,82,9,9,18
10,8475231,Casey Cizikas,C,NYI,33,82,9,9,18
10,8476889,Radek Faksa,C,STL,30,82,8,10,18
10,8482807,Ethan Del Mastro,D,CHI,21,82,7,11,18
10,8476624,Barclay Goodrow,C,SJS,31,82,5,13,18
10,8481522,Peyton Krebs,C,BUF,23,82,4,14,18
10,8477369,Carson Soucy,D,VAN,30,82,3,15,18
10,8476463,Jonas Brodin,D,MIN,31,82,3,15,18
10,8477938,Haydn Fleury,D,WPG,28,82,3,15,18
10,8480172,Jan Rutta,D,SJS,34,82,3,15,18
10,8478450,Parker Wotherspoon,D,BOS,27,82,3,15,18
10,8481178,Egor Zamula,D,PHI,24,82,2,16,18
10,8478399,Jonas Siegenthaler,D,NJD,27,82,0,18,18
10,8479414,Nathan Bastian,R,NJD,27,82,9,8,17
10,8480025,MacKenzie Entwistle,R,FLA,25,82,7,10,17
10,8477220,Nate Schmidt,D,FLA,33,82,7,10,17
10,8483482,Tristan Luneau,D,ANA,20,82,7,10,17
10,8482809,Jackson Blake,R,CAR,21,82,6,11,17
10,8483490,Pavel Mintyukov,D,ANA,21,82,6,11,17
10,8478416,Erik Cernak,D,TBL,27,82,4,13,17
10,8474574,Tyler Myers,D,VAN,34,82,3,14,17
10,8478443,Brandon Carlo,D,BOS,28,82,3,14,17
10,8480807,Mattias Samuelsson,D,BUF,24,82,1,16,17
10,8482659,Josh Doan,R,UTA,22,82,9,7,16
10,8480021,Jack Studnicka,C,LAK,25,82,7,9,16
10,8482074,Connor Zary,C,CGY,23,82,7,9,16
10,8481699,Aku Raty,R,UTA,23,82,7,9,16
10,8476422,Mike Reilly,D,NYI,31,82,6,10,16
10,8475718,Justin Holl,D,DET,32,82,6,10,16
10,8477505,Alexander Wennberg,C,SJS,30,82,6,10,16
10,8471677,Jack Johnson,D,CBJ,37,82,4,12,16
10,8476525,Colin Miller,D,WPG,32,82,4,12,16
10,8474567,Zach Bogosian,D,MIN,34,82,4,12,16
10,8480879,Jacob Bernard-Docker,D,OTT,24,82,3,13,16
10,8477845,Trevor van Riemsdyk,D,WSH,33,82,3,13,16
10,8477931,Tomas Nosek,L,FLA,32,82,3,13,16
10,8474673,TJ Brodie,D,CHI,34,82,2,14,16
10,8479638,Justin Brazeau,R,BOS,26,82,8,7,15
10,8482516,Matthew Kessel,D,STL,24,82,5,10,15
10,8483466,Kevin Korchinski,D,CHI,20,82,5,10,15
10,8476473,Connor Murphy,D,CHI,31,82,1,14,15
10,8475790,Erik Gudbranson,D,CBJ,32,82,0,15,15
10,8482712,Oskar Olausson,R,COL,22,82,7,7,14
10,8483489,Fraser Minten,C,TOR,31,82,6,8,14
10,8482858,Ryker Evans,D,SEA,23,82,4,10,14
10,8475690,Chris Tanev,D,TOR,35,82,3,11,14
10,8474013,Ian Cole,D,UTA,35,82,3,11,14
10,8479442,Troy Stecher,D,EDM,30,82,0,14,14
10,8483397,Marc McLaughlin,C,BOS,25,82,9,4,13
10,8482470,Ilya Solovyov,D,CGY,24,82,8,5,13
10,8482118,Sam Colangelo,R,ANA,23,82,7,6,13
10,8475762,Derek Forbort,D,VAN,32,82,5,8,13
10,8482803,Olen Zellweger,D,ANA,21,82,3,10,13
10,8482713,Mackie Samoskevich,R,FLA,22,82,3,10,13
10,8478874,Adam Gaudette,C,OTT,28,82,3,10,13
10,8480990,Declan Chisholm,D,MIN,24,82,2,11,13
10,8474090,Brendan Smith,D,DAL,35,82,2,11,13
10,8476372,Nick Seeler,D,PHI,31,82,1,12,13
10,8477034,Jaycob Megna,D,FLA,32,82,1,12,13
10,8482077,Dylan Holloway,L,EDM,23,82,7,5,12
10,8482101,Danil Gushchin,L,SJS,22,82,6,6,12
10,8482749,Joshua Roy,R,MTL,21,82,5,7,12
10,8477335,Kyle Burroughs,D,LAK,29,82,5,7,12
10,8482733,Logan Mailloux,D,MTL,31,82,5,7,12
10,8483567,Georgii Merkulov,C,BOS,24,82,5,7,12
10,8482145,Mavrik Bourque,C,DAL,22,82,3,9,12
10,8481605,Jackson LaCombe,D,ANA,23,82,3,9,12
10,8483460,David Jiricek,D,CBJ,21,82,3,9,12
10,8483012,Logan Morrison,C,SEA,22,82,2,10,12
10,8482155,Alex Laferriere,R,LAK,23,82,5,6,11
10,8475177,Calvin de Haan,D,COL,33,82,2,9,11
10,8482070,Mitchell Chaffee,R,TBL,26,82,7,3,10
10,8482679,Matt Coronato,R,CGY,22,82,6,4,10
10,8482787,Nikita Chibrikov,R,WPG,31,82,5,5,10
10,8483471,Brad Lambert,C,WPG,31,82,5,5,10
10,8482859,Zack Ostapchuk,C,OTT,21,82,3,7,10
10,8480834,Ty Emberson,D,SJS,24,82,2,8,10
10,8475279,Ben Chiarot,D,DET,33,82,2,8,10
10,8475324,Nick Jensen,D,OTT,34,82,1,9,10
10,8481122,Simon Benoit,D,TOR,26,82,1,9,10
10,8484911,Collin Graf,R,SJS,22,82,5,4,9
10,8481641,Joel Kiviranta,L,COL,28,82,4,5,9
10,8476441,Joel Edmundson,D,LAK,31,82,3,6,9
10,8482153,Brendan Brisson,C,VGK,23,82,2,6,8
10,8476822,Luke Glendening,C,TBL,35,82,3,4,7
10,8474062,Riley Nash,C,NYR,35,82,3,1,4
10,8470794,Joe Pavelski,C,,40,0,0,0,0
10,8481703,Valtteri Puustinen,R,PIT,25,0,0,0,0
10,8477950,Tony DeAngelo,D,,29,0,0,0,0
10,8481577,Philip Tomasino,C,NSH,23,0,0,0,0
10,8475197,Tyson Barrie,D,,33,0,0,0,0
10,8471218,Blake Wheeler,R,,38,0,0,0,0
10,8474157,Max Pacioretty,L,,36,0,0,0,0
10,8478466,Daniel Sprong,R,VAN,27,0,0,0,0
10,8475744,Evgeny Kuznetsov,C,,32,0,0,0,0
10,8481019,David Gustafsson,C,WPG,24,0,0,0,0
10,8475906,John Klingberg,D,,32,0,0,0,0
10,8479348,Kale Clague,D,BUF,26,0,0,0,0
10,8476952,Dominic Toninato,C,WPG,30,0,0,0,0
10,8473473,Milan Lucic,L,,36,0,0,0,0
10,8474037,James van Riemsdyk,L,,35,0,0,0,0
10,8474602,Justin Schultz,D,,34,0,0,0,0
10,8482222,Alexander Barabanov,L,,30,0,0,0,0
10,8479372,Josh Mahura,D,SEA,26,0,0,0,0
10,8479982,Conor Timmins,D,TOR,26,0,0,0,0
10,8474031,Kevin Shattenkirk,D,,35,0,0,0,0
10,8480008,Adam Ruzicka,C,,25,0,0,0,0
10,8481059,Scott Perunovich,D,STL,26,0,0,0,0
10,8480884,Calen Addison,D,,24,0,0,0,0
10,8476994,Vinnie Hinostroza,C,NSH,30,0,0,0,0
10,8478452,Caleb Jones,D,LAK,27,0,0,0,0
10,8480157,Calle Rosen,D,COL,30,0,0,0,0
10,8481609,Vladislav Kolyachonok,D,UTA,23,0,0,0,0
10,8479415,Michael McLeod,C,,26,0,0,0,0
10,8476919,Chris Tierney,C,,30,0,0,0,0
10,8479639,Dylan Coghlan,D,WPG,26,0,0,0,0
10,8478146,Matthew Highmore,C,OTT,28,0,0,0,0
10,8478970,Jalen Chatfield,D,CAR,28,0,0,0,0
10,8480205,Emil Bemstrom,C,PIT,25,0,0,0,0
10,8474884,Mike Hoffman,C,,35,0,0,0,0
10,8471274,Alex Goligoski,D,,39,0,0,0,0
10,8478104,Sammy Blais,L,,28,0,0,0,0
10,8474870,Tyler Johnson,C,,34,0,0,0,0
10,8476913,Devin Shore,C,MIN,30,0,0,0,0
10,8481598,Philip Broberg,D,EDM,23,0,0,0,0
10,8480058,Pierre-Olivier Joseph,D,STL,25,0,0,0,0
10,8480891,Michael Kesselring,D,UTA,24,0,0,0,0
10,8477979,Nicolas Aube-Kubel,R,BUF,28,0,0,0,0
10,8476871,Tanner Pearson,L,,32,0,0,0,0
10,8476393,Nick Cousins,C,,31,0,0,0,0
10,8479977,Kailer Yamamoto,R,,26,0,0,0,0
10,8479543,Michael Pezzetta,L,MTL,26,0,0,0,0
10,8477018,Ben Hutton,D,VGK,31,0,0,0,0
10,8480762,Eric Robinson,L,CAR,29,0,0,0,0
10,8474034,Pat Maroon,L,CHI,36,0,0,0,0
10,8481058,Jesse Ylönen,R,,25,0,0,0,0
10,8475179,Dmitry Kulikov,D,FLA,34,0,0,0,0
10,8481527,Kaedan Korczak,D,VGK,23,0,0,0,0
10,8473449,Kyle Okposo,R,,36,0,0,0,0
10,8482192,Isaak Phillips,D,CHI,23,0,0,0,0
10,8480727,Zach Whitecloud,D,VGK,28,0,0,0,0
10,8479346,Dillon Dube,C,,26,0,0,0,0
10,8480821,Filip Zadina,R,,25,0,0,0,0
10,8480001,Urho Vaakanainen,D,ANA,25,0,0,0,0
10,8470966,Mark Giordano,D,,41,0,0,0,0
10,8480853,Liam Foudy,C,,24,0,0,0,0
10,8475225,Craig Smith,C,CHI,35,0,0,0,0
10,8479972,Mason Shaw,C,WPG,26,0,0,0,0
10,8478451,Ethan Bear,D,WSH,27,0,0,0,0
10,8474040,Sam Gagner,C,,35,0,0,0,0
10,8480196,Jacob Bryson,D,BUF,27,0,0,0,0
10,8479984,Cal Foote,D,,26,0,0,0,0
10,8480011,Klim Kostin,C,SJS,25,0,0,0,0
10,8482176,Wyatt Kaiser,D,CHI,22,0,0,0,0
10,8476988,Matt Benning,D,SJS,30,0,0,0,0
10,8479370,Tyson Jost,C,CAR,26,0,0,0,0
10,8477464,Nic Petan,C,,29,0,0,0,0
10,8477380,Jonny Brodzinski,C,NYR,31,0,0,0,0
10,8480070,Ian Mitchell,D,BOS,25,0,0,0,0
10,8479315,Joey Anderson,R,CHI,26,0,0,0,0
10,8478099,Kevin Labanc,R,,29,0,0,0,0
10,8476874,Olli Maatta,D,DET,30,0,0,0,0
10,8475208,Brian Dumoulin,D,ANA,33,0,0,0,0
10,8478430,Oliver Kylington,D,,27,0,0,0,0
10,8479536,Axel Jonsson-Fjallby,L,WPG,26,0,0,0,0
10,8479671,Mathieu Olivier,R,CBJ,27,0,0,0,0
10,8471709,Marc-Edouard Vlasic,D,SJS,37,0,0,0,0
10,8479328,Julien Gauthier,R,NYI,27,0,0,0,0
10,8478421,A.J. Greer,L,FLA,28,0,0,0,0
10,8477573,Nathan Walker,L,STL,30,0,0,0,0
10,8481537,Nikita Okhotiuk,D,CGY,24,0,0,0,0
10,8474166,Alec Martinez,D,CHI,37,0,0,0,0
10,8470610,Zach Parise,L,,40,0,0,0,0
10,8477478,William Carrier,L,CAR,30,0,0,0,0
10,8479344,Jesse Puljujarvi,R,PIT,26,0,0,0,0
10,8480887,Jordan Harris,D,MTL,24,0,0,0,0
10,8478502,Dennis Gilbert,D,BUF,28,0,0,0,0
10,8482730,Brandt Clarke,D,LAK,21,0,0,0,0
10,8480355,Mark Kastelic,C,BOS,25,0,0,0,0
10,8475750,Jon Merrill,D,MIN,32,0,0,0,0
10,8475164,Jakob Silfverberg,R,,34,0,0,0,0
10,8477944,Jakub Vrana,L,,28,0,0,0,0
10,8479439,Jacob MacDonald,D,COL,31,0,0,0,0
10,8474568,Luke Schenn,D,NSH,35,0,0,0,0
10,8478454,Noah Juulsen,D,VAN,27,0,0,0,0
10,8475752,Tyler Pitlick,C,,33,0,0,0,0
10,8482148,Hendrix Lapierre,C,WSH,22,0,0,0,0
10,8481167,Brayden Pachal,D,CGY,25,0,0,0,0
10,8478043,Sam Lafferty,C,BUF,29,0,0,0,0
10,8479321,Lucas Johansen,D,,27,0,0,0,0
10,8471699,Andrew Cogliano,C,,37,0,0,0,0
10,8481521,Ronnie Attard,D,PHI,25,0,0,0,0
10,8481161,Jake Christiansen,D,CBJ,25,0,0,0,0
10,8479458,Nikita Zaitsev,D,,33,0,0,0,0
10,8479619,Michael Carcone,L,UTA,28,0,0,0,0
10,8479026,Philippe Myers,D,TOR,27,0,0,0,0
10,8477330,Dominik Kubalik,L,,29,0,0,0,0
10,8481617,Vasily Podkolzin,R,VAN,23,0,0,0,0
10,8481701,Santeri Hatakka,D,NJD,23,0,0,0,0
10,8479514,Rem Pitlick,C,,27,0,0,0,0
10,8477446,Michael McCarron,R,NSH,29,0,0,0,0
10,8470604,Jeff Carter,C,,39,0,0,0,0
10,8482241,Radim Zohorna,L,,28,0,0,0,0
10,8480289,Morgan Barron,C,WPG,26,0,0,0,0
10,8479379,Givani Smith,R,SJS,26,0,0,0,0
10,8480216,Jacob Peterson,C,,25,0,0,0,0
10,8477851,Jordan Oesterle,D,BOS,32,0,0,0,0
10,8484258,Sam Malinski,D,COL,26,0,0,0,0
10,8478904,Steven Lorentz,C,,28,0,0,0,0
10,8482095,Tyler Kleven,D,OTT,22,0,0,0,0
10,8480848,Ty Dellandrea,C,SJS,24,0,0,0,0
10,8476884,Derrick Pouliot,D,,30,0,0,0,0
10,8479336,Carl Grundstrom,R,SJS,27,0,0,0,0
10,8482964,Arber Xhekaj,D,MTL,23,0,0,0,0
10,8471686,Marc Staal,D,,37,0,0,0,0
10,8477887,Patrick Brown,C,BOS,32,0,0,0,0
10,8478495,Denis Gurianov,R,,27,0,0,0,0
10,8473504,Cal Clutterbuck,R,,37,0,0,0,0
10,8481550,Adam Beckman,L,NJD,23,0,0,0,0
10,8480845,Rasmus Kupari,C,WPG,24,0,0,0,0
10,8474009,Nick Bonino,C,,36,0,0,0,0
10,8478585,Derek Ryan,C,EDM,38,0,0,0,0
10,8477962,Brendan Lemieux,L,CAR,28,0,0,0,0
10,8482861,Vincent Iorio,D,WSH,22,0,0,0,0
10,8479378,Logan Stanley,D,WPG,26,0,0,0,0
10,8473446,Erik Johnson,D,PHI,36,0,0,0,0
10,8481743,Marc Del Gaizo,D,NSH,25,0,0,0,0
10,8477384,Josh Brown,D,EDM,30,0,0,0,0
10,8482165,Yan Kuznetsov,D,CGY,22,0,0,0,0
10,8478424,Jansen Harkins,C,ANA,27,0,0,0,0
10,8482144,Jack Thompson,D,SJS,22,0,0,0,0
10,8478512,Austin Czarnik,C,,32,0,0,0,0
10,8477527,Ross Johnston,L,ANA,30,0,0,0,0
10,8479383,Boris Katchouk,L,,26,0,0,0,0
10,8482094,Daemon Hunt,D,MIN,22,0,0,0,0
10,8481719,Maxwell Crozier,D,TBL,24,0,0,0,0
10,8480192,Johnathan Kovacevic,D,NJD,27,0,0,0,0
10,8479376,Victor Mete,D,,26,0,0,0,0
10,8482511,Mason Lohrei,D,BOS,23,0,0,0,0
10,8475825,Jani Hakanpää,D,,32,0,0,0,0
10,8478021,William Lagesson,D,DET,28,0,0,0,0
10,8475795,Dylan McIlrath,D,WSH,32,0,0,0,0
10,8477846,Ryan Carpenter,C,,33,0,0,0,0
10,8481056,Spencer Stastney,D,NSH,24,0,0,0,0
10,8481564,Ryan Johnson,D,BUF,23,0,0,0,0
10,8478017,Mark Friedman,D,VAN,29,0,0,0,0
10,8479320,Max Lajoie,D,SEA,27,0,0,0,0
10,8480075,Cameron Crotty,D,MIN,25,0,0,0,0
10,8484287,Cole McWard,D,VAN,23,0,0,0,0
10,8484254,Akito Hirose,D,VAN,25,0,0,0,0
10,8483407,Brandon Scanlin,D,NYR,25,0,0,0,0
10,8480274,Philip Kemp,D,EDM,25,0,0,0,0
10,8479522,Hardy Haman Aktell,D,WSH,26,0,0,0,0
10,8480007,Jonas Rondbjerg,R,VGK,25,0,0,0,0
10,8477454,Adam Erne,L,,29,0,0,0,0
10,8481679,Maxence Guenette,D,OTT,23,0,0,0,0
10,8480441,Trey Fix-Wolansky,R,CBJ,25,0,0,0,0
10,8483546,Marshall Rifai,D,TOR,26,0,0,0,0
10,8480084,Nick DeSimone,D,NJD,30,0,0,0,0
10,8481030,Jack St. Ivany,D,PIT,25,0,0,0,0
10,8481592,Jakob Pelletier,L,CGY,23,0,0,0,0
10,8478011,Louie Belpedio,D,PHI,28,0,0,0,0
10,8477930,Pierre-Edouard Bellemare,L,,39,0,0,0,0
10,8484321,Nikolas Matinpalo,D,OTT,26,0,0,0,0
10,8482067,Connor Mackey,D,NYR,28,0,0,0,0
10,8481806,Louis Crevier,D,CHI,23,0,0,0,0
10,8484326,Patrik Koch,D,UTA,28,0,0,0,0
10,8477971,Andreas Englund,D,LAK,28,0,0,0,0
10,8481751,Lukas Rousek,R,BUF,25,0,0,0,0
10,8481006,Tyler Tucker,D,STL,24,0,0,0,0
10,8476867,Brendan Gaunce,C,MIN,30,0,0,0,0
10,8479520,Brandon Duhaime,R,WSH,27,0,0,0,0
10,8477073,Kurtis MacDermid,L,NJD,30,0,0,0,0
10,8480874,Adam Ginning,D,PHI,24,0,0,0,0
10,8477473,Justin Bailey,R,SJS,29,0,0,0,0
10,8479066,Ryan Lomberg,L,CGY,30,0,0,0,0
10,8477070,Liam O'Brien,C,UTA,30,0,0,0,0
10,8474618,Marco Scandella,D,,34,0,0,0,0
10,8475797,Jarred Tinordi,D,,32,0,0,0,0
10,8481441,Joe Snively,C,DET,28,0,0,0,0
10,8477244,Chad Ruhwedel,D,NYR,34,0,0,0,0
10,8479772,Zack MacEwen,R,OTT,28,0,0,0,0
10,8481147,Reese Johnson,C,MIN,26,0,0,0,0
10,8481043,Cole Koepke,L,BOS,26,0,0,0,0
10,8483619,Filip Roos,D,OTT,25,0,0,0,0
10,8481541,Samuel Bolduc,D,NYI,24,0,0,0,0
10,8477810,Joel Hanley,D,CGY,33,0,0,0,0
10,8476907,Mackenzie MacEachern,L,,30,0,0,0,0
10,8482652,Walker Duehr,R,CGY,27,0,0,0,0
10,8477126,Jayson Megna,C,,34,0,0,0,0
10,8483398,Declan Carlile,D,TBL,31,0,0,0,0
10,8482929,Emil Lilleberg,D,TBL,23,0,0,0,0
10,8480880,Jakub Lauko,C,MIN,24,0,0,0,0
10,8480245,Olle Lycksell,R,PHI,25,0,0,0,0
10,8480252,Cole Guttman,C,CHI,25,0,0,0,0
10,8477467,Gustav Olofsson,D,SEA,30,0,0,0,0
10,8479968,Vinni Lettieri,C,BOS,29,0,0,0,0
10,8478400,Colin White,C,,27,0,0,0,0
10,8475755,Alexander Petrovic,D,DAL,32,0,0,0,0
10,8481812,Nikolai Knyzhov,D,,27,0,0,0,0
10,8481593,Jayden Struble,D,MTL,23,0,0,0,0
10,8481532,Alex Turcotte,C,LAK,23,0,0,0,0
10,8482126,Emil Andrae,D,PHI,31,0,0,0,0
10,8479944,Zach Aston-Reese,C,VGK,30,0,0,0,0
10,8471817,Ryan Reaves,R,TOR,37,0,0,0,0
10,8481206,John Ludvig,D,PIT,24,0,0,0,0
10,8481599,Victor Soderstrom,D,UTA,23,0,0,0,0
10,8480292,Carson Meyer,R,ANA,27,0,0,0,0
10,8482496,Nils Aman,C,VAN,24,0,0,0,0
10,8479718,Alex Barré-Boulet,C,MTL,27,0,0,0,0
10,8479994,Jaret Anderson-Dolan,C,WPG,25,0,0,0,0
10,8480184,Gustav Lindstrom,D,,26,0,0,0,0
10,8480890,Jan Jenik,R,OTT,24,0,0,0,0
10,8478067,Oskar Lindblom,L,,28,0,0,0,0
10,8476934,Brock McGinn,L,ANA,30,0,0,0,0
10,8479985,Cale Fleury,D,SEA,26,0,0,0,0
10,8484304,Uvis Balinskis,D,FLA,28,0,0,0,0
10,8479981,Jonah Gadjovich,L,FLA,26,0,0,0,0
10,8481716,Dmitri Voronkov,L,CBJ,24,0,0,0,0
10,8474709,Matt Martin,L,,35,0,0,0,0
10,8482634,Alex Steeves,C,TOR,25,0,0,0,0
10,8480823,Alexander Alexeyev,D,WSH,25,0,0,0,0
10,8477541,Dakota Mermis,D,TOR,30,0,0,0,0
10,8483491,Ivan Miroshnichenko,L,WSH,20,0,0,0,0
10,8478477,Mitchell Stephens,C,SEA,27,0,0,0,0
10,8481543,Nikita Alexandrov,C,STL,24,0,0,0,0
10,8479423,Alex Nylander,L,,26,0,0,0,0
10,8482451,Mikael Pyyhtia,L,CBJ,23,0,0,0,0
10,8478831,Kevin Stenlund,C,UTA,28,0,0,0,0
10,8480306,Grant Hutton,D,NYI,29,0,0,0,0
10,8478028,Fredrik Olofsson,L,,28,0,0,0,0
10,8477462,Robert Hagg,D,VGK,29,0,0,0,0
10,8477320,Anton Blidh,L,NYR,29,0,0,0,0
10,8482157,Will Cuylle,L,NYR,22,0,0,0,0
10,8482737,Zack Bolduc,C,STL,21,0,0,0,0
10,8481239,Samuel Fagemo,L,,24,0,0,0,0
10,8481600,Tobias Bjornfot,D,FLA,23,0,0,0,0
10,8478409,Anthony Richard,C,PHI,28,0,0,0,0
10,8474145,Robert Bortuzzo,D,,35,0,0,0,0
10,8475958,Michael Sgarbossa,C,WSH,32,0,0,0,0
10,8479986,Kole Lind,R,DAL,26,0,0,0,0
10,8479249,Andrew Poturalski,C,SJS,30,0,0,0,0
10,8479362,Riley Tufte,L,BOS,26,0,0,0,0
10,8479991,Jake Leschyshyn,C,NYR,25,0,0,0,0
10,8479587,Rhett Gardner,C,PHI,28,0,0,0,0
10,8482744,James Malatesta,L,CBJ,21,0,0,0,0
10,8478854,Ryan Shea,D,PIT,27,0,0,0,0
10,8481591,Sam Poulin,R,,23,0,0,0,0
10,8483512,Matt Savoie,C,EDM,20,0,0,0,0
10,8482102,Vasily Ponomarev,C,PIT,22,0,0,0,0
10,8482162,Roby Jarventie,L,EDM,22,0,0,0,0
10,8481016,Ruslan Iskhakov,C,,24,0,0,0,0
10,8482172,Landon Slaggert,L,CHI,22,0,0,0,0
10,8482747,Brennan Othmann,L,NYR,21,0,0,0,0
10,8480031,Maxime Comtois,L,,25,0,0,0,0
10,8480226,Marián Studenic,R,,26,0,0,0,0
10,8478408,Travis Dermott,D,,28,0,0,0,0
10,8481518,Nolan Foote,L,NJD,24,0,0,0,0
10,8479419,Brett Murray,L,BUF,26,0,0,0,0
10,8482088,Justin Sourdif,R,FLA,22,0,0,0,0
10,8482201,Gage Goncalves,C,TBL,23,0,0,0,0
10,8481578,Graeme Clarke,R,MIN,23,0,0,0,0
10,8482177,Marat Khusnutdinov,C,MIN,22,0,0,0,0
10,8481754,Nikita Nesterenko,C,ANA,23,0,0,0,0
10,8483531,Brian Halonen,L,NJD,25,0,0,0,0
10,8483920,Pierrick Dube,R,WSH,23,0,0,0,0
10,8480851,Akil Thomas,C,LAK,24,0,0,0,0
10,8475235,Nicolas Deslauriers,L,PHI,33,0,0,0,0
10,8482476,Emil Heineman,L,MTL,23,0,0,0,0
10,8477149,Scott Sabourin,R,SJS,32,0,0,0,0
10,8483549,Lucas Condotta,L,MTL,27,0,0,0,0
10,8482765,Isak Rosen,R,BUF,21,0,0,0,0
10,8481237,Kyle MacLean,C,NYI,25,0,0,0,0
10,8481024,Linus Karlsson,C,VAN,25,0,0,0,0
10,8481690,Tyler Angle,C,,24,0,0,0,0
10,8483570,Ben Meyers,C,SEA,26,0,0,0,0
10,8481655,Cole Schwindt,R,CGY,23,0,0,0,0
10,8481462,Mason Morelli,L,VGK,28,0,0,0,0
10,8483401,Marc Johnstone,R,PIT,28,0,0,0,0
10,8478956,Samuel Laberge,L,NJD,27,0,0,0,0
10,8479533,Joona Koppanen,L,,26,0,0,0,0
10,8482197,Adam Raska,R,MIN,23,0,0,0,0
10,8482250,Callahan Burke,C,VGK,27,0,0,0,0
10,8482784,Zach Dean,C,STL,21,0,0,0,0
10,8484255,Jason Polin,R,COL,25,0,0,0,0
10,8481077,John Leonard,L,,26,0,0,0,0
10,8481534,Raphael Lavoie,C,EDM,24,0,0,0,0
10,8483609,Adam Klapka,R,CGY,24,0,0,0,0
10,8482751,Ryan Winterton,C,SEA,21,0,0,0,0
10,8480267,Sammy Walker,C,MIN,25,0,0,0,0
10,8475766,Austin Watson,L,,32,0,0,0,0
10,8482460,Matt Rempe,C,NYR,22,0,0,0,0
10,8481065,Angus Crookshank,L,OTT,25,0,0,0,0
10,8481070,Hugh McGing,L,,26,0,0,0,0
10,8476323,Max McCormick,L,SEA,32,0,0,0,0
10,8483395,Arshdeep Bains,L,VAN,23,0,0,0,0
10,8484259,Ondrej Pavel,C,COL,31,0,0,0,0
10,8483432,Luca Del Bel Belluz,C,CBJ,31,0,0,0,0
10,8483045,Cameron Butler,R,CBJ,31,0,0,0,0
10,8482061,Brandon Biro,L,SEA,26,0,0,0,0
10,8477401,John Hayden,C,SEA,29,0,0,0,0
10,8475278,Byron Froese,C,,33,0,0,0,0
10,8478446,Glenn Gawdin,C,LAK,27,0,0,0,0
10,8477993,Justin Kirkland,C,CGY,28,0,0,0,0
10,8482147,Jean-Luc Foudy,C,COL,22,0,0,0,0
10,8480032,Shane Bowers,C,NJD,25,0,0,0,0
10,8479330,Brandon Gignac,C,MTL,27,0,0,0,0
10,8480776,Sheldon Rempal,R,,29,0,0,0,0
10,8475413,Justin Dowling,C,NJD,34,0,0,0,0
10,8481726,Adam Edstrom,C,NYR,24,0,0,0,0
10,8480844,Grigori Denisenko,L,VGK,24,0,0,0,0
10,8478147,Bokondji Imama,L,PIT,28,0,0,0,0
10,8478881,Brett Seney,L,CHI,28,0,0,0,0
10,8483630,Pavol Regenda,L,ANA,25,0,0,0,0
10,8480836,Jonathan Gruden,C,,24,0,0,0,0
10,8484314,Jiri Smejkal,L,,28,0,0,0,0
10,8475780,Chris Wagner,R,COL,33,0,0,0,0
10,8479546,Oskar Steen,C,,26,0,0,0,0
10,8483597,Milos Kelemen,L,UTA,25,0,0,0,0
10,8481789,Tye Kartye,L,SEA,23,0,0,0,0
10,8484325,Waltteri Merela,C,TBL,26,0,0,0,0
10,8479421,Jacob Moverare,D,LAK,26,0,0,0,0
10,8481585,Egor Afanasyev,L,SJS,23,0,0,0,0
10,8479547,Matthew Phillips,R,,26,0,0,0,0
10,8479367,William Lockwood,R,FLA,26,0,0,0,0
10,8476915,Jujhar Khaira,L,,30,0,0,0,0
10,8481422,Jacob Lucchini,C,NSH,29,0,0,0,0
10,8480468,James Hamblin,L,EDM,25,0,0,0,0
10,8478051,Max Willman,C,NJD,29,0,0,0,0
10,8481556,John Beecher,C,BOS,23,0,0,0,0
10,8478078,Rourke Chartier,C,,28,0,0,0,0
11,8477956,David Pastrnak,R,BOS,28,82,67,79,146
11,8478420,Mikko Rantanen,R,COL,28,82,56,70,126
11,8479318,Auston Matthews,C,TOR,27,82,61,59,120
11,8476453,Nikita Kucherov,R,TBL,31,82,42,78,120
11,8477939,William Nylander,R,TOR,28,82,48,69,117
11,8477492,Nathan MacKinnon,C,COL,29,82,41,73,114
11,8477946,Dylan Larkin,C,DET,28,82,57,55,112
11,8479314,Matthew Tkachuk,L,FLA,27,82,36,75,111
11,8476468,J.T. Miller,C,VAN,31,82,43,66,109
11,8478864,Kirill Kaprizov,L,MIN,27,82,41,67,108
11,8477934,Leon Draisaitl,C,EDM,29,82,39,68,107
11,8478402,Connor McDavid,C,EDM,27,82,30,77,107
11,8478550,Artemi Panarin,L,NYR,33,82,26,81,107
11,8477933,Sam Reinhart,C,FLA,29,82,59,46,105
11,8479323,Adam Fox,D,NYR,26,82,25,79,104
11,8481559,Jack Hughes,C,NJD,23,82,36,66,102
11,8477493,Aleksander Barkov,C,FLA,29,82,30,69,99
11,8480069,Cale Makar,D,COL,26,82,24,75,99
11,8475692,Mats Zuccarello,R,MIN,37,82,27,70,97
11,8478010,Brayden Point,C,TBL,28,82,40,56,96
11,8480012,Elias Pettersson,C,VAN,26,82,36,60,96
11,8478398,Kyle Connor,L,WPG,28,82,39,55,94
11,8477949,Alex Tuch,R,BUF,28,82,38,55,93
11,8480800,Quinn Hughes,D,VAN,25,82,11,82,93
11,8478444,Brock Boeser,R,VAN,27,82,48,43,91
11,8481557,Matt Boldy,L,MIN,23,82,42,48,90
11,8480027,Jason Robertson,L,DAL,25,82,36,54,90
11,8477942,Kevin Fiala,L,LAK,28,82,30,57,87
11,8471675,Sidney Crosby,C,PIT,37,82,30,57,87
11,8474141,Patrick Kane,R,DET,36,82,28,59,87
11,8482116,Tim Stützle,C,OTT,22,82,27,60,87
11,8480023,Robert Thomas,C,STL,25,82,25,62,87
11,8473419,Brad Marchand,L,BOS,36,82,39,47,86
11,8481523,Kirby Dach,C,MTL,23,82,15,71,86
11,8475810,Bryan Rust,R,PIT,32,82,39,46,85
11,8478403,Jack Eichel,C,VGK,28,82,42,42,84
11,8477404,Jake Guentzel,C,TBL,30,82,37,46,83
11,8479407,Jesper Bratt,L,NJD,26,82,31,52,83
11,8478427,Sebastian Aho,C,CAR,27,82,30,53,83
11,8477501,Valeri Nichushkin,R,COL,29,82,47,35,82
11,8475172,Nazem Kadri,C,CGY,34,82,33,49,82
11,8475913,Mark Stone,R,VGK,32,82,35,46,81
11,8479343,Clayton Keller,R,UTA,26,82,30,51,81
11,8475745,Charlie Coyle,C,BOS,32,82,26,55,81
11,8480830,Andrei Svechnikov,R,CAR,24,82,37,42,79
11,8478449,Roope Hintz,C,DAL,28,82,37,42,79
11,8476346,Johnny Gaudreau,L,CBJ,31,82,22,57,79
11,8476881,Tomas Hertl,C,VGK,31,82,27,51,78
11,8474564,Steven Stamkos,C,NSH,34,82,33,43,76
11,8477504,Josh Morrissey,D,WPG,29,82,17,59,76
11,8475184,Chris Kreider,L,NYR,33,82,46,29,75
11,8476389,Vincent Trocheck,C,NYR,31,82,32,43,75
11,8480208,Drake Batherson,R,OTT,26,82,24,51,75
11,8476454,Ryan Nugent-Hopkins,C,EDM,31,82,17,58,75
11,8477940,Nikolaj Ehlers,L,WPG,28,82,32,42,74
11,8475167,Victor Hedman,D,TBL,34,82,16,58,74
11,8475754,Brock Nelson,C,NYI,33,82,41,32,73
11,8476456,Jonathan Huberdeau,C,CGY,31,82,14,59,73
11,8478439,Travis Konecny,R,PHI,27,82,37,35,72
11,8476887,Filip Forsberg,L,NSH,30,82,36,36,72
11,8476539,Jonathan Marchessault,R,NSH,34,82,34,38,72
11,8480002,Nico Hischier,C,NJD,25,82,26,46,72
11,8476853,Morgan Rielly,D,TOR,30,82,9,63,72
11,8475784,Jeff Skinner,C,EDM,32,82,33,38,71
11,8475158,Ryan O'Reilly,C,NSH,33,82,32,39,71
11,8479542,Brandon Hagel,L,TBL,26,82,31,40,71
11,8477402,Pavel Buchnevich,L,STL,29,82,20,51,71
11,8480801,Brady Tkachuk,L,OTT,25,82,40,30,70
11,8471215,Evgeni Malkin,C,PIT,38,82,26,44,70
11,8476459,Mika Zibanejad,C,NYR,31,82,23,47,70
11,8479325,Charlie McAvoy,D,BOS,27,82,17,53,70
11,8479675,Trevor Moore,L,LAK,29,82,36,33,69
11,8476460,Mark Scheifele,C,WPG,31,82,32,37,69
11,8475166,John Tavares,C,TOR,34,82,31,38,69
11,8479337,Alex DeBrincat,R,DET,27,82,28,41,69
11,8478440,Dylan Strome,C,WSH,27,82,23,46,69
11,8474578,Erik Karlsson,D,PIT,34,82,19,50,69
11,8480036,Miro Heiskanen,D,DAL,25,82,12,57,69
11,8480865,Noah Dobson,D,NYI,24,82,11,58,69
11,8475794,Tyler Seguin,C,DAL,32,82,35,33,68
11,8477960,Adrian Kempe,R,LAK,28,82,31,37,68
11,8482093,Seth Jarvis,C,CAR,22,82,30,38,68
11,8477496,Elias Lindholm,C,BOS,30,82,23,45,68
11,8476875,Mike Matheson,D,MTL,30,82,18,50,68
11,8471214,Alex Ovechkin,L,WSH,39,82,33,34,67
11,8477416,Oliver Bjorkstrand,R,SEA,29,82,27,40,67
11,8478445,Mathew Barzal,C,NYI,27,82,23,44,67
11,8474600,Roman Josi,D,NSH,34,82,19,48,67
11,8478407,Vince Dunn,D,SEA,28,82,8,59,67
11,8477409,Carter Verhaeghe,C,FLA,29,82,31,35,66
11,8471685,Anze Kopitar,C,LAK,37,82,23,43,66
11,8482097,Jack Quinn,R,BUF,23,82,26,39,65
11,8478460,Zach Werenski,D,CBJ,27,82,19,46,65
11,8480839,Rasmus Dahlin,D,BUF,24,82,11,54,65
11,8475786,Zach Hyman,L,EDM,32,82,31,33,64
11,8475168,Matt Duchene,C,DAL,33,82,23,41,64
11,8478873,Troy Terry,R,ANA,27,82,19,45,64
11,8477476,Artturi Lehkonen,L,COL,29,82,32,31,63
11,8478047,Michael Bunting,L,PIT,29,82,29,34,63
11,8478042,Viktor Arvidsson,R,EDM,31,82,25,38,63
11,8479400,Pierre-Luc Dubois,L,WSH,26,82,24,39,63
11,8477503,Max Domi,C,TOR,29,82,16,47,63
11,8480803,Evan Bouchard,D,EDM,25,82,12,51,63
11,8479420,Tage Thompson,C,BUF,27,82,36,26,62
11,8479385,Jordan Kyrou,C,STL,26,82,31,31,62
11,8478493,Joel Eriksson Ek,C,MIN,27,82,31,31,62
11,8475726,Tyler Toffoli,C,SJS,32,82,29,33,62
11,8478462,Nicolas Roy,C,VGK,27,82,24,38,62
11,8482078,Lucas Raymond,L,DET,22,82,20,42,62
11,8479999,Casey Mittelstadt,C,COL,26,82,19,43,62
11,8473994,Jamie Benn,L,DAL,35,82,23,38,61
11,8480078,Filip Chytil,C,NYR,25,82,18,43,61
11,8471724,Kris Letang,D,PIT,37,82,17,44,61
11,8475753,Justin Faulk,D,STL,32,82,15,46,61
11,8475798,Mikael Granlund,C,SJS,32,82,14,47,61
11,8482109,Alexis Lafrenière,L,NYR,23,82,33,27,60
11,8481540,Cole Caufield,R,MTL,23,82,32,28,60
11,8478856,Conor Garland,R,VAN,28,82,28,32,60
11,8480015,Owen Tippett,R,PHI,25,82,24,36,60
11,8481533,Trevor Zegras,C,ANA,23,82,21,39,60
11,8477456,J.T. Compher,L,DET,29,82,21,39,60
11,8476448,William Karlsson,C,VGK,31,82,27,32,59
11,8476479,Phillip Danault,C,LAK,31,82,22,37,59
11,8481711,Matias Maccelli,L,UTA,24,82,16,43,59
11,8474563,Drew Doughty,D,LAK,35,82,10,49,59
11,8477500,Bo Horvat,C,NYI,29,82,30,28,58
11,8477951,Nick Schmaltz,C,UTA,28,82,27,31,58
11,8480798,Philipp Kurashev,C,CHI,25,82,21,37,58
11,8482665,Matty Beniers,C,SEA,22,82,26,31,57
11,8482740,Wyatt Johnston,C,DAL,21,82,26,31,57
11,8473512,Claude Giroux,R,OTT,36,82,17,40,57
11,8476462,Dougie Hamilton,D,NJD,31,82,13,44,57
11,8480018,Nick Suzuki,C,MTL,25,82,25,31,56
11,8482745,Mason McTavish,C,ANA,21,82,23,33,56
11,8474102,David Perron,L,OTT,36,82,20,36,56
11,8476792,Torey Krug,D,STL,33,82,14,42,56
11,8477494,Jonathan Drouin,L,COL,29,82,14,42,56
11,8481604,Pavel Dorofeyev,L,VGK,24,82,29,26,55
11,8475170,Brayden Schenn,C,STL,33,82,23,32,55
11,8475791,Taylor Hall,L,CHI,33,82,22,33,55
11,8478038,Devon Toews,D,COL,30,82,21,34,55
11,8479410,Mikhail Sergachev,D,UTA,26,82,12,43,55
11,8477447,Shea Theodore,D,VGK,29,82,9,46,55
11,8477935,Sam Bennett,C,FLA,28,82,30,24,54
11,8474150,Mikael Backlund,C,CGY,35,82,27,27,54
11,8477955,Jared McCann,L,SEA,28,82,22,32,54
11,8478401,Pavel Zacha,C,BOS,27,82,20,34,54
11,8482124,Quinton Byfield,R,LAK,22,82,20,34,54
11,8481596,Shane Pinto,C,OTT,24,82,19,35,54
11,8474679,Gustav Nyquist,C,NSH,35,82,16,38,54
11,8476882,Teuvo Teravainen,L,CHI,30,82,22,31,53
11,8476432,Boone Jenner,C,CBJ,31,82,33,19,52
11,8477998,Warren Foegele,L,LAK,28,82,25,27,52
11,8482149,Cole Perfetti,C,WPG,22,82,24,28,52
11,8477479,Tyler Bertuzzi,L,CHI,29,82,24,28,52
11,8480028,Morgan Frost,C,PHI,25,82,23,29,52
11,8477497,Sean Monahan,C,CBJ,30,82,21,31,52
11,8474565,Alex Pietrangelo,D,VGK,34,82,6,46,52
11,8481068,Yegor Sharangovich,C,CGY,26,82,31,20,51
11,8480064,Josh Norris,C,OTT,25,82,30,21,51
11,8479339,Patrik Laine,L,CBJ,26,82,25,26,51
11,8473986,Alex Killorn,L,ANA,35,82,24,27,51
11,8481528,Dylan Cozens,C,BUF,23,82,23,28,51
11,8481542,Moritz Seider,D,DET,23,82,12,39,51
11,8478469,Thomas Chabot,D,OTT,27,82,10,41,51
11,8480014,Gabriel Vilardi,C,WPG,25,82,26,24,50
11,8480829,Jesperi Kotkaniemi,C,CAR,24,82,22,28,50
11,8478498,Jake DeBrusk,L,VAN,28,82,18,32,50
11,8474715,Cam Atkinson,R,TBL,35,82,26,23,49
11,8480113,Alex Iafallo,L,WPG,31,82,20,29,49
11,8480188,Fabian Zetterlund,L,SJS,25,82,18,31,49
11,8477495,Seth Jones,D,CHI,30,82,15,34,49
11,8478519,Anthony Cirelli,C,TBL,27,82,14,35,49
11,8474053,Logan Couture,C,SJS,35,82,12,37,49
11,8476906,Shayne Gostisbehere,D,CAR,31,82,11,38,49
11,8478414,Timo Meier,R,NJD,28,82,25,23,48
11,8475191,Reilly Smith,R,NYR,33,82,24,24,48
11,8477932,Aaron Ekblad,D,FLA,28,82,22,26,48
11,8474586,Jordan Eberle,R,SEA,34,82,19,29,48
11,8482667,William Eklund,L,SJS,22,82,18,30,48
11,8481581,Thomas Harley,D,DAL,23,82,15,33,48
11,8476905,Chandler Stephenson,C,SEA,30,82,14,34,48
11,8474590,John Carlson,D,WSH,34,82,12,36,48
11,8476958,Jaccob Slavin,D,CAR,30,82,6,42,48
11,8480813,Joe Veleno,C,DET,24,82,26,21,47
11,8474641,Adam Henrique,C,EDM,34,82,24,23,47
11,8475314,Anders Lee,L,NYI,34,82,22,25,47
11,8480797,Joel Farabee,L,PHI,24,82,21,26,47
11,8479992,Michael Rasmussen,C,DET,25,82,21,26,47
11,8480039,Martin Necas,C,CAR,25,82,19,28,47
11,8475765,Vladimir Tarasenko,R,DET,33,82,19,28,47
11,8482475,Yegor Chinakhov,R,CBJ,23,82,15,32,47
11,8470613,Brent Burns,D,CAR,39,82,10,37,47
11,8478397,Rasmus Andersson,D,CGY,28,82,10,37,47
11,8477426,Nicholas Paul,L,TBL,29,82,27,19,46
11,8476483,Rickard Rakell,R,PIT,31,82,23,23,46
11,8478975,Mason Marchment,L,DAL,29,82,19,27,46
11,8477964,Ivan Barbashev,C,VGK,29,82,19,27,46
11,8479987,Morgan Geekie,C,BOS,26,82,18,28,46
11,8480185,Eetu Luostarinen,C,FLA,26,82,16,30,46
11,8477346,MacKenzie Weegar,D,CGY,30,82,11,35,46
11,8476869,Brady Skjei,D,NSH,30,82,9,37,46
11,8475169,Evander Kane,L,EDM,33,82,33,12,45
11,8482110,Dawson Mercer,C,NJD,23,82,27,18,45
11,8477429,Andrew Copp,C,DET,30,82,13,32,45
11,8480434,Sean Durzi,D,UTA,26,82,7,38,45
11,8478055,Gustav Forsling,D,FLA,28,82,6,39,45
11,8481554,Kaapo Kakko,R,NYR,23,82,25,19,44
11,8475760,Nick Bjugstad,C,UTA,32,82,25,19,44
11,8476826,Yanni Gourde,C,SEA,33,82,22,22,44
11,8477451,Ryan Hartman,R,MIN,30,82,22,22,44
11,8476880,Tom Wilson,R,WSH,30,82,20,24,44
11,8479525,Ross Colton,C,COL,28,82,19,25,44
11,8476329,Travis Boyd,C,MIN,31,82,12,32,44
11,8482684,Luke Hughes,D,NJD,21,82,11,33,44
11,8476854,Hampus Lindholm,D,BOS,30,82,11,33,44
11,8478474,Lawson Crouse,L,UTA,27,82,24,19,43
11,8481535,Nils Hoglander,L,VAN,24,82,24,19,43
11,8482089,Jake Neighbours,L,STL,22,82,24,19,43
11,8482055,Drew O'Connor,L,PIT,26,82,22,21,43
11,8482146,Luke Evangelista,R,NSH,22,82,20,23,43
11,8476419,Jean-Gabriel Pageau,C,NYI,32,82,18,25,43
11,8478458,Jack Roslovic,C,CAR,27,82,15,28,43
11,8475763,Kevin Hayes,R,PIT,32,82,15,28,43
11,8476927,Teddy Blueger,C,VAN,30,82,9,34,43
11,8480849,Barrett Hayton,C,UTA,24,82,26,16,42
11,8482699,Dylan Guenther,R,UTA,21,82,22,20,42
11,8475151,Kyle Palmieri,C,NYI,33,82,20,22,42
11,8479365,Trent Frederic,C,BOS,26,82,18,24,42
11,8478542,Evan Rodrigues,C,FLA,31,82,16,26,42
11,8475793,Ryan Johansen,C,PHI,32,82,16,26,42
11,8482660,Kent Johnson,C,CBJ,22,82,13,29,42
11,8478396,Noah Hanifin,D,VGK,27,82,12,30,42
11,8478366,Frank Vatrano,R,ANA,30,82,25,16,41
11,8475714,Calle Jarnkrok,C,TOR,33,82,24,17,41
11,8482159,Tyson Foerster,R,PHI,22,82,23,18,41
11,8476399,Blake Coleman,C,CGY,33,82,21,20,41
11,8476981,Josh Anderson,R,MTL,30,82,20,21,41
11,8471698,T.J. Oshie,R,WSH,38,82,19,22,41
11,8477511,Anthony Mantha,R,CGY,30,82,16,25,41
11,8481560,Arthur Kaliyev,R,LAK,23,82,15,26,41
11,8478438,Tommy Novak,C,NSH,27,82,13,28,41
11,8479425,Filip Hronek,D,VAN,27,82,8,33,41
11,8478057,Dakota Joshua,C,VAN,28,82,24,16,40
11,8482175,JJ Peterka,R,BUF,22,82,22,18,40
11,8481013,Jonatan Berggren,R,DET,24,82,22,18,40
11,8481186,Logan O'Connor,R,COL,28,82,18,22,40
11,8477407,Anthony Duclair,L,NYI,29,82,14,26,40
11,8477444,Andre Burakovsky,L,SEA,29,82,13,27,40
11,8476923,Damon Severson,D,CBJ,30,82,11,29,40
11,8477948,Travis Sanheim,D,PHI,28,82,8,32,40
11,8473507,Jeff Petry,D,DET,37,82,7,33,40
11,8480459,Pius Suter,C,VAN,28,82,22,17,39
11,8475799,Nino Niederreiter,R,WPG,32,82,16,23,39
11,8482113,Anton Lundell,C,FLA,23,82,14,25,39
11,8478472,Mathieu Joseph,R,STL,27,82,14,25,39
11,8480220,Noah Cates,L,PHI,25,82,12,27,39
11,8482105,Jake Sanderson,D,OTT,22,82,10,29,39
11,8474716,Jared Spurgeon,D,MIN,35,82,10,29,39
11,8477506,Ryan Pulock,D,NYI,30,82,5,34,39
11,8476438,Brandon Saad,L,STL,32,82,24,14,38
11,8482079,Marco Rossi,C,MIN,23,82,23,15,38
11,8481032,Paul Cotter,C,NJD,25,82,22,16,38
11,8479941,Justin Danforth,R,CBJ,31,82,15,23,38
11,8481580,Connor McMichael,C,WSH,23,82,14,24,38
11,8476292,Ondrej Palat,L,NJD,33,82,12,26,38
11,8476461,Sean Couturier,C,PHI,32,82,12,26,38
11,8481656,Aliaksei Protas,C,WSH,23,82,11,27,38
11,8475218,Mattias Ekholm,D,EDM,34,82,11,27,38
11,8476458,Ryan Strome,C,ANA,31,82,10,28,38
11,8480043,Timothy Liljegren,D,TOR,25,82,9,29,38
11,8476979,Erik Gustafsson,D,DET,32,82,7,31,38
11,8473533,Jordan Staal,C,CAR,36,82,20,17,37
11,8478046,Danton Heinen,L,VAN,29,82,14,23,37
11,8482133,Thomas Bordeleau,C,SJS,22,82,12,25,37
11,8478891,Mason Appleton,C,WPG,28,82,9,28,37
11,8480145,Neal Pionk,D,WPG,29,82,6,31,37
11,8482122,Brock Faber,D,MIN,22,82,4,33,37
11,8483808,Andrei Kuzmenko,L,CGY,28,82,17,19,36
11,8473563,Nicklas Backstrom,C,WSH,37,82,17,19,36
11,8481618,Alex Newhook,C,MTL,23,82,16,20,36
11,8475768,Jaden Schwartz,C,SEA,32,82,16,20,36
11,8484144,Connor Bedard,C,CHI,19,82,16,20,36
11,8477986,Brandon Montour,D,SEA,30,82,14,22,36
11,8477488,Brett Pesce,D,NJD,30,82,11,25,36
11,8482671,Owen Power,D,BUF,22,82,8,28,36
11,8474151,Ryan McDonagh,D,TBL,35,82,4,32,36
11,8478020,Michael Amadio,C,OTT,28,82,20,15,35
11,8480893,Kirill Marchenko,R,CBJ,24,82,19,16,35
11,8481624,Ilya Mikheyev,R,CHI,30,82,18,17,35
11,8473422,Nick Foligno,L,CHI,37,82,17,18,35
11,8478233,Andrew Mangiapane,L,WSH,28,82,16,19,35
11,8482720,Matthew Knies,L,TOR,22,82,15,20,35
11,8478463,Anthony Beauvillier,L,PIT,27,82,15,20,35
11,8482092,Ridly Greig,C,OTT,22,82,15,20,35
11,8482117,Lukas Reichel,L,CHI,22,82,15,20,35
11,8482074,Connor Zary,C,CGY,23,82,15,20,35
11,8479345,Jakob Chychrun,D,WSH,26,82,11,24,35
11,8481606,Jordan Spence,D,LAK,23,82,10,25,35
11,8477498,Darnell Nurse,D,EDM,29,82,8,27,35
11,8475171,Oliver Ekman-Larsson,D,TOR,33,82,7,28,35
11,8477969,Marcus Pettersson,D,PIT,28,82,5,30,35
11,8482259,Bobby McMann,C,TOR,28,82,19,15,34
11,8480835,Jack Drury,C,CAR,24,82,17,17,34
11,8477953,Kasperi Kapanen,R,STL,28,82,16,18,34
11,8475848,Brendan Gallagher,R,MTL,32,82,15,19,34
11,8477450,Jason Dickinson,C,CHI,29,82,15,19,34
11,8477021,Alex Kerfoot,C,UTA,30,82,14,20,34
11,8477952,Robby Fabbri,C,ANA,28,82,14,20,34
11,8476392,Adam Lowry,C,WPG,31,82,13,21,34
11,8480068,Ryan Poehling,C,PHI,25,82,12,22,34
11,8482125,Alexander Holtz,R,VGK,22,82,12,22,34
11,8475220,Marcus Foligno,L,MIN,33,82,12,22,34
11,8474149,Evgenii Dadonov,R,DAL,35,82,11,23,34
11,8480035,Henri Jokiharju,D,BUF,25,82,8,26,34
11,8476429,Scott Mayfield,D,NYI,32,82,6,28,34
11,8480873,Rasmus Sandin,D,WSH,24,82,5,29,34
11,8478507,John Marino,D,UTA,27,82,3,31,34
11,8481582,Nicholas Robertson,L,TOR,23,82,18,15,33
11,8476474,Stefan Noesen,R,NJD,31,82,18,15,33
11,8479353,Brett Howden,C,VGK,26,82,16,17,33
11,8477425,Miles Wood,L,COL,29,82,15,18,33
11,8480009,Eeli Tolvanen,R,SEA,25,82,15,18,33
11,8480802,Ryan McLeod,C,BUF,25,82,11,22,33
11,8476872,Scott Laughton,C,PHI,30,82,8,25,33
11,8475200,Dmitry Orlov,D,CAR,33,82,7,26,33
11,8478413,Jordan Greenway,L,BUF,27,82,7,26,33
11,8481546,Cam York,D,PHI,23,82,6,27,33
11,8481014,Alexander Romanov,D,NYI,24,82,5,28,33
11,8479393,Noah Gregor,C,OTT,26,82,22,10,32
11,8482705,Cole Sillinger,C,CBJ,21,82,16,16,32
11,8479390,Taylor Raddysh,R,WSH,26,82,14,18,32
11,8483515,Juraj Slafkovsky,L,MTL,20,82,13,19,32
11,8482624,Daniil Miromanov,D,CGY,27,82,12,20,32
11,8475722,Jason Zucker,L,BUF,32,82,11,21,32
11,8479661,Tanner Jeannot,L,LAK,27,82,11,21,32
11,8480817,K'Andre Miller,D,NYR,24,82,8,24,32
11,8475855,Jesper Fast,R,CAR,33,82,8,24,32
11,8479398,Samuel Girard,D,COL,26,82,5,27,32
11,8482142,Jamie Drysdale,D,PHI,22,82,5,27,32
11,8479293,Brandon Tanev,L,SEA,33,82,21,10,31
11,8481093,Rafael Harvey-Pinard,L,MTL,25,82,16,15,31
11,8476960,Andreas Athanasiou,C,CHI,30,82,14,17,31
11,8476480,Vladislav Namestnikov,C,WPG,32,82,14,17,31
11,8480336,Sean Walker,D,CAR,30,82,12,19,31
11,8480748,Kiefer Sherwood,L,VAN,29,82,12,19,31
11,8478133,Jake Evans,C,MTL,28,82,8,23,31
11,8475287,Erik Haula,L,NJD,33,82,7,24,31
11,8478508,Yakov Trenin,C,MIN,27,82,19,11,30
11,8483457,Lane Hutson,D,MTL,20,82,16,14,30
11,8470621,Corey Perry,R,EDM,39,82,15,15,30
11,8483431,Logan Cooley,C,UTA,20,82,15,15,30
11,8476278,Colin Blackwell,C,DAL,31,82,15,15,30
11,8479996,Cody Glass,C,NSH,25,82,15,15,30
11,8477947,Sonny Milano,L,WSH,28,82,14,16,30
11,8476897,Oskar Sundqvist,C,STL,30,82,14,16,30
11,8477987,Ryan Donato,C,CHI,28,82,14,16,30
11,8480995,Pontus Holmberg,R,TOR,25,82,14,16,30
11,8476374,Sean Kuraly,C,CBJ,31,82,13,17,30
11,8477406,Mattias Janmark,C,EDM,32,82,8,22,30
11,8476885,Jacob Trouba,D,NYR,30,82,7,23,30
11,8474673,TJ Brodie,D,CHI,34,82,5,25,30
11,8476917,Adam Pelech,D,NYI,30,82,4,26,30
11,8476331,Dylan DeMelo,D,WPG,31,82,4,26,30
11,8476931,Jake McCabe,D,TOR,31,82,2,28,30
11,8480789,Oliver Wahlstrom,R,NYI,24,82,19,10,29
11,8481601,Simon Holmstrom,R,NYI,23,82,15,14,29
11,8477989,Christian Dvorak,C,MTL,28,82,11,18,29
11,8478911,Matt Roy,D,WSH,29,82,8,21,29
11,8479351,Sam Steel,C,DAL,26,82,8,21,29
11,8481522,Peyton Krebs,C,BUF,23,82,6,23,29
11,8476463,Jonas Brodin,D,MIN,31,82,3,26,29
11,8480281,Alexey Toropchenko,R,STL,25,82,17,11,28
11,8481477,Nico Sturm,C,SJS,29,82,13,15,28
11,8476469,Joel Armia,R,MTL,31,82,12,16,28
11,8481553,Bobby Brink,R,PHI,23,82,12,16,28
11,8479368,Max Jones,L,BOS,26,82,12,16,28
11,8478109,Victor Olofsson,L,VGK,29,82,11,17,28
11,8480855,Jack McBain,C,UTA,24,82,11,17,28
11,8482141,Lukas Cormier,D,VGK,22,82,10,18,28
11,8480144,David Kampf,C,TOR,29,82,10,18,28
11,8477220,Nate Schmidt,D,FLA,33,82,8,20,28
11,8482655,J.J. Moser,D,TBL,24,82,5,23,28
11,8479983,Mario Ferraro,D,SJS,26,82,5,23,28
11,8480871,Adam Boqvist,D,FLA,24,82,4,24,28
11,8479976,Juuso Valimaki,D,UTA,26,82,3,25,28
11,8484145,Zach Benson,L,BUF,19,82,16,11,27
11,8484203,Bradly Nadeau,L,CAR,19,82,14,13,27
11,8479591,Michael Eyssimont,C,TBL,28,82,13,14,27
11,8475193,Tomas Tatar,L,NJD,34,82,12,15,27
11,8476925,Colton Sissons,C,NSH,31,82,11,16,27
11,8477919,Frederick Gaudreau,C,MIN,31,82,11,16,27
11,8481704,Juuso Parssinen,C,NSH,23,82,11,16,27
11,8475343,Nic Dowd,C,WSH,34,82,10,17,27
11,8480049,Dylan Samberg,D,WPG,25,82,5,22,27
11,8477839,Conor Sheary,L,TBL,32,82,14,12,26
11,8482733,Logan Mailloux,D,MTL,31,82,14,12,26
11,8475842,Sam Carrick,C,NYR,32,82,13,13,26
11,8482702,Logan Stankoven,C,DAL,21,82,13,13,26
11,8476889,Radek Faksa,C,STL,30,82,13,13,26
11,8477353,Tyler Motte,C,DET,29,82,12,14,26
11,8478434,Keegan Kolesar,R,VGK,27,82,11,15,26
11,8473453,Trevor Lewis,C,LAK,37,82,10,16,26
11,8480074,Alexandre Texier,C,STL,25,82,9,17,26
11,8483490,Pavel Mintyukov,D,ANA,21,82,9,17,26
11,8476422,Mike Reilly,D,NYI,31,82,7,19,26
11,8478500,Ivan Provorov,D,CBJ,27,82,6,20,26
11,8477435,Ryan Graves,D,PIT,29,82,6,20,26
11,8476525,Colin Miller,D,WPG,32,82,6,20,26
11,8475181,Nick Leddy,D,STL,33,82,5,21,26
11,8479316,Luke Kunin,C,SJS,27,82,17,8,25
11,8478115,Pierre Engvall,L,NYI,28,82,14,11,25
11,8477505,Alexander Wennberg,C,SJS,30,82,13,12,25
11,8480448,Parker Kelly,L,COL,25,82,9,16,25
11,8478013,Jake Walman,D,SJS,28,82,8,17,25
11,8476902,Esa Lindell,D,DAL,30,82,7,18,25
11,8476892,Colton Parayko,D,STL,31,82,6,19,25
11,8477507,Nikita Zadorov,D,BOS,29,82,5,20,25
11,8480878,Nils Lundkvist,D,DAL,24,82,4,21,25
11,8479402,Jake Bean,D,CGY,26,82,3,22,25
11,8481568,Alex Vlasic,D,CHI,23,82,2,23,25
11,8482166,Shakir Mukhamadullin,D,SJS,22,82,14,10,24
11,8478432,Christian Fischer,R,DET,27,82,13,11,24
11,8484911,Collin Graf,R,SJS,22,82,13,11,24
11,8478569,Noel Acciari,C,PIT,33,82,12,12,24
11,8480980,Connor Dewar,C,TOR,25,82,10,14,24
11,8483495,Simon Nemec,D,NJD,20,82,8,16,24
11,8477508,Curtis Lazar,C,NJD,29,82,7,17,24
11,8476873,Mark Jankowski,C,NSH,30,82,6,18,24
11,8480003,Jesper Boqvist,C,FLA,26,82,5,19,24
11,8479324,Ryan Lindgren,D,NYR,26,82,4,20,24
11,8480860,Kevin Bahl,D,CGY,24,82,3,21,24
11,8475790,Erik Gudbranson,D,CBJ,32,82,3,21,24
11,8480806,Isac Lundestrom,C,ANA,25,82,15,8,23
11,8476921,Jordan Martinook,L,CAR,32,82,14,9,23
11,8484153,Leo Carlsson,C,ANA,20,82,10,13,23
11,8475149,Marcus Johansson,L,MIN,34,82,8,15,23
11,8481517,Brett Leason,R,ANA,25,82,8,15,23
11,8479291,Kevin Rooney,C,CGY,31,82,8,15,23
11,8477015,Connor Brown,R,EDM,30,82,7,16,23
11,8475764,Cam Fowler,D,ANA,33,82,2,21,23
11,8477903,Garnet Hathaway,R,PHI,33,82,13,9,22
11,8477369,Carson Soucy,D,VAN,30,82,12,10,22
11,8474189,Lars Eller,C,PIT,35,82,11,11,22
11,8476918,Jimmy Vesey,L,NYR,31,82,10,12,22
11,8481481,Blake Lizotte,C,PIT,27,82,10,12,22
11,8476858,Phillip Di Giuseppe,L,VAN,31,82,9,13,22
11,8483505,Matthew Poitras,C,BOS,20,82,9,13,22
11,8479414,Nathan Bastian,R,NJD,27,82,9,13,22
11,8484166,Adam Fantilli,C,CBJ,20,82,8,14,22
11,8476467,Jamie Oleksiak,D,SEA,32,82,7,15,22
11,8478443,Brandon Carlo,D,BOS,28,82,7,15,22
11,8482111,Justin Barron,D,MTL,23,82,6,16,22
11,8479980,Nicolas Hague,D,VGK,26,82,6,16,22
11,8477365,Connor Clifton,D,BUF,29,82,6,16,22
11,8478882,Vladislav Gavrikov,D,LAK,29,82,5,17,22
11,8475279,Ben Chiarot,D,DET,33,82,0,22,22
11,8482077,Dylan Holloway,L,EDM,23,82,11,10,21
11,8476442,Matt Nieto,L,PIT,32,82,7,14,21
11,8475231,Casey Cizikas,C,NYI,33,82,7,14,21
11,8474567,Zach Bogosian,D,MIN,34,82,7,14,21
11,8476312,Josh Manson,D,COL,33,82,6,15,21
11,8478211,Dryden Hunt,L,CGY,29,82,5,16,21
11,8482073,Braden Schneider,D,NYR,23,82,5,16,21
11,8476891,Matt Grzelcyk,D,PIT,30,82,4,17,21
11,8479371,Dante Fabbro,D,NSH,26,82,2,19,21
11,8478136,Jake Middleton,D,MIN,28,82,2,19,21
11,8479359,Beck Malenstyn,L,BUF,26,82,10,10,20
11,8481567,Henry Thrun,D,SJS,23,82,7,13,20
11,8480073,Erik Brannstrom,D,COL,25,82,4,16,20
11,8482245,Artem Zub,D,OTT,29,82,4,16,20
11,8480246,Nick Perbix,D,TBL,26,82,4,16,20
11,8482087,Kaiden Guhle,D,MTL,22,82,2,18,20
11,8474574,Tyler Myers,D,VAN,34,82,2,18,20
11,8482155,Alex Laferriere,R,LAK,23,82,13,6,19
11,8476878,Zemgus Girgensons,L,TBL,30,82,11,8,19
11,8480021,Jack Studnicka,C,LAK,25,82,11,8,19
11,8481028,Martin Pospisil,C,CGY,25,82,10,9,19
11,8477392,Hudson Fasching,R,NYI,29,82,9,10,19
11,8482762,Simon Edvinsson,D,DET,21,82,9,10,19
11,8475690,Chris Tanev,D,TOR,35,82,5,14,19
11,8480834,Ty Emberson,D,SJS,24,82,5,14,19
11,8478178,Darren Raddysh,D,TBL,28,82,3,16,19
11,8478399,Jonas Siegenthaler,D,NJD,27,82,3,16,19
11,8475233,David Savard,D,MTL,34,82,2,17,19
11,8478416,Erik Cernak,D,TBL,27,82,2,17,19
11,8477845,Trevor van Riemsdyk,D,WSH,33,82,2,17,19
11,8484149,Gavin Brindley,C,CBJ,20,82,8,10,18
11,8476624,Barclay Goodrow,C,SJS,31,82,8,10,18
11,8483482,Tristan Luneau,D,ANA,20,82,8,10,18
11,8482145,Mavrik Bourque,C,DAL,22,82,8,10,18
11,8483468,Jiri Kulich,C,BUF,20,82,7,11,18
11,8481524,Bowen Byram,D,BUF,23,82,7,11,18
11,8476457,Adam Larsson,D,SEA,32,82,6,12,18
11,8476967,Brett Kulak,D,EDM,30,82,5,13,18
11,8479369,Andrew Peeke,D,BOS,26,82,5,13,18
11,8483493,Frank Nazar,C,CHI,20,82,5,13,18
11,8478450,Parker Wotherspoon,D,BOS,27,82,4,14,18
11,8481699,Aku Raty,R,UTA,23,82,3,15,18
11,8480222,Sebastian Aho,D,PIT,28,82,2,16,18
11,8480807,Mattias Samuelsson,D,BUF,24,82,2,16,18
11,8477931,Tomas Nosek,L,FLA,32,82,10,7,17
11,8481641,Joel Kiviranta,L,COL,28,82,8,9,17
11,8482101,Danil Gushchin,L,SJS,22,82,7,10,17
11,8483012,Logan Morrison,C,SEA,22,82,7,10,17
11,8483763,Maksymilian Szuber,D,UTA,22,82,6,11,17
11,8481605,Jackson LaCombe,D,ANA,23,82,5,12,17
11,8477335,Kyle Burroughs,D,LAK,29,82,4,13,17
11,8475188,Brayden McNabb,D,VGK,33,82,3,14,17
11,8479998,Mikey Anderson,D,LAK,25,82,2,15,17
11,8475324,Nick Jensen,D,OTT,34,82,2,15,17
11,8478851,Alexandre Carrier,D,NSH,28,82,1,16,17
11,8475462,Radko Gudas,D,ANA,34,82,1,16,17
11,8478468,Jeremy Lauzon,D,NSH,27,82,7,9,16
11,8480990,Declan Chisholm,D,MIN,24,82,7,9,16
11,8483445,Cutter Gauthier,L,ANA,20,82,6,10,16
11,8482712,Oskar Olausson,R,COL,22,82,6,10,16
11,8482470,Ilya Solovyov,D,CGY,24,82,6,10,16
11,8482062,Cole Smith,L,NSH,29,82,5,11,16
11,8478859,Niko Mikkola,D,FLA,28,82,4,12,16
11,8474013,Ian Cole,D,UTA,35,82,3,13,16
11,8477034,Jaycob Megna,D,FLA,32,82,3,13,16
11,8478840,Will Borgen,D,SEA,28,82,2,14,16
11,8480172,Jan Rutta,D,SJS,34,82,2,14,16
11,8481178,Egor Zamula,D,PHI,24,82,2,14,16
11,8480025,MacKenzie Entwistle,R,FLA,25,82,11,4,15
11,8482787,Nikita Chibrikov,R,WPG,31,82,8,7,15
11,8483524,Shane Wright,C,SEA,20,82,7,8,15
11,8470600,Ryan Suter,D,STL,39,82,5,10,15
11,8483565,Nick Blankenburg,D,NSH,26,82,5,10,15
11,8479576,Vincent Desharnais,D,VAN,28,82,5,10,15
11,8477938,Haydn Fleury,D,WPG,28,82,5,10,15
11,8482713,Mackie Samoskevich,R,FLA,22,82,4,11,15
11,8475177,Calvin de Haan,D,COL,33,82,3,12,15
11,8474090,Brendan Smith,D,DAL,35,82,6,8,14
11,8482749,Joshua Roy,R,MTL,21,82,6,8,14
11,8483397,Marc McLaughlin,C,BOS,25,82,5,9,14
11,8482666,Scott Morrow,D,CAR,22,82,4,10,14
11,8481708,Zac Jones,D,NYR,24,82,4,10,14
11,8475718,Justin Holl,D,DET,32,82,2,12,14
11,8475762,Derek Forbort,D,VAN,32,82,2,12,14
11,8482679,Matt Coronato,R,CGY,22,82,8,5,13
11,8479638,Justin Brazeau,R,BOS,26,82,7,6,13
11,8482153,Brendan Brisson,C,VGK,23,82,5,8,13
11,8482809,Jackson Blake,R,CAR,21,82,4,9,13
11,8482858,Ryker Evans,D,SEA,23,82,3,10,13
11,8476372,Nick Seeler,D,PHI,31,82,2,11,13
11,8481122,Simon Benoit,D,TOR,26,82,2,11,13
11,8475455,Brenden Dillon,D,NJD,34,82,1,12,13
11,8480950,Ilya Lyubushkin,D,DAL,30,82,1,12,13
11,8478874,Adam Gaudette,C,OTT,28,82,1,12,13
11,8483499,Liam Ohgren,L,MIN,20,82,5,7,12
11,8482807,Ethan Del Mastro,D,CHI,21,82,2,10,12
11,8476879,Cody Ceci,D,EDM,31,82,1,11,12
11,8480879,Jacob Bernard-Docker,D,OTT,24,82,1,11,12
11,8483466,Kevin Korchinski,D,CHI,20,82,0,12,12
11,8482659,Josh Doan,R,UTA,22,82,8,3,11
11,8483471,Brad Lambert,C,WPG,31,82,6,5,11
11,8480870,Bo Groulx,C,NYR,24,82,4,7,11
11,8477499,Rasmus Ristolainen,D,PHI,30,82,4,7,11
11,8480796,Martin Fehervary,D,WSH,25,82,1,10,11
11,8483567,Georgii Merkulov,C,BOS,24,82,7,3,10
11,8482859,Zack Ostapchuk,C,OTT,21,82,4,6,10
11,8482803,Olen Zellweger,D,ANA,21,82,3,7,10
11,8476441,Joel Edmundson,D,LAK,31,82,3,7,10
11,8474612,Travis Hamonic,D,OTT,34,82,2,8,10
11,8471677,Jack Johnson,D,CBJ,37,82,1,8,9
11,8482070,Mitchell Chaffee,R,TBL,26,82,5,3,8
11,8483489,Fraser Minten,C,TOR,31,82,5,2,7
11,8483460,David Jiricek,D,CBJ,21,82,3,4,7
11,8482516,Matthew Kessel,D,STL,24,82,1,6,7
11,8479442,Troy Stecher,D,EDM,30,82,4,2,6
11,8482118,Sam Colangelo,R,ANA,23,82,3,3,6
11,8476473,Connor Murphy,D,CHI,31,82,1,5,6
11,8476822,Luke Glendening,C,TBL,35,82,2,3,5
11,8474062,Riley Nash,C,NYR,35,82,2,2,4
11,8470794,Joe Pavelski,C,,40,0,0,0,0
11,8481703,Valtteri Puustinen,R,PIT,25,0,0,0,0
11,8477950,Tony DeAngelo,D,,29,0,0,0,0
11,8481577,Philip Tomasino,C,NSH,23,0,0,0,0
11,8475197,Tyson Barrie,D,,33,0,0,0,0
11,8471218,Blake Wheeler,R,,38,0,0,0,0
11,8474157,Max Pacioretty,L,,36,0,0,0,0
11,8478466,Daniel Sprong,R,VAN,27,0,0,0,0
11,8475744,Evgeny Kuznetsov,C,,32,0,0,0,0
11,8481019,David Gustafsson,C,WPG,24,0,0,0,0
11,8475906,John Klingberg,D,,32,0,0,0,0
11,8479348,Kale Clague,D,BUF,26,0,0,0,0
11,8476952,Dominic Toninato,C,WPG,30,0,0,0,0
11,8473473,Milan Lucic,L,,36,0,0,0,0
11,8474037,James van Riemsdyk,L,,35,0,0,0,0
11,8474602,Justin Schultz,D,,34,0,0,0,0
11,8482222,Alexander Barabanov,L,,30,0,0,0,0
11,8479372,Josh Mahura,D,SEA,26,0,0,0,0
11,8479982,Conor Timmins,D,TOR,26,0,0,0,0
11,8474031,Kevin Shattenkirk,D,,35,0,0,0,0
11,8480008,Adam Ruzicka,C,,25,0,0,0,0
11,8481059,Scott Perunovich,D,STL,26,0,0,0,0
11,8480884,Calen Addison,D,,24,0,0,0,0
11,8476994,Vinnie Hinostroza,C,NSH,30,0,0,0,0
11,8478452,Caleb Jones,D,LAK,27,0,0,0,0
11,8480157,Calle Rosen,D,COL,30,0,0,0,0
11,8481609,Vladislav Kolyachonok,D,UTA,23,0,0,0,0
11,8479415,Michael McLeod,C,,26,0,0,0,0
11,8476919,Chris Tierney,C,,30,0,0,0,0
11,8479639,Dylan Coghlan,D,WPG,26,0,0,0,0
11,8478146,Matthew Highmore,C,OTT,28,0,0,0,0
11,8478970,Jalen Chatfield,D,CAR,28,0,0,0,0
11,8480205,Emil Bemstrom,C,PIT,25,0,0,0,0
11,8474884,Mike Hoffman,C,,35,0,0,0,0
11,8471274,Alex Goligoski,D,,39,0,0,0,0
11,8478104,Sammy Blais,L,,28,0,0,0,0
11,8474870,Tyler Johnson,C,,34,0,0,0,0
11,8476913,Devin Shore,C,MIN,30,0,0,0,0
11,8481598,Philip Broberg,D,EDM,23,0,0,0,0
11,8480058,Pierre-Olivier Joseph,D,STL,25,0,0,0,0
11,8480891,Michael Kesselring,D,UTA,24,0,0,0,0
11,8477979,Nicolas Aube-Kubel,R,BUF,28,0,0,0,0
11,8476871,Tanner Pearson,L,,32,0,0,0,0
11,8476393,Nick Cousins,C,,31,0,0,0,0
11,8479977,Kailer Yamamoto,R,,26,0,0,0,0
11,8479543,Michael Pezzetta,L,MTL,26,0,0,0,0
11,8477018,Ben Hutton,D,VGK,31,0,0,0,0
11,8480762,Eric Robinson,L,CAR,29,0,0,0,0
11,8474034,Pat Maroon,L,CHI,36,0,0,0,0
11,8481058,Jesse Ylönen,R,,25,0,0,0,0
11,8475179,Dmitry Kulikov,D,FLA,34,0,0,0,0
11,8481527,Kaedan Korczak,D,VGK,23,0,0,0,0
11,8473449,Kyle Okposo,R,,36,0,0,0,0
11,8482192,Isaak Phillips,D,CHI,23,0,0,0,0
11,8480727,Zach Whitecloud,D,VGK,28,0,0,0,0
11,8479346,Dillon Dube,C,,26,0,0,0,0
11,8480821,Filip Zadina,R,,25,0,0,0,0
11,8480001,Urho Vaakanainen,D,ANA,25,0,0,0,0
11,8470966,Mark Giordano,D,,41,0,0,0,0
11,8480853,Liam Foudy,C,,24,0,0,0,0
11,8475225,Craig Smith,C,CHI,35,0,0,0,0
11,8479972,Mason Shaw,C,WPG,26,0,0,0,0
11,8478451,Ethan Bear,D,WSH,27,0,0,0,0
11,8474040,Sam Gagner,C,,35,0,0,0,0
11,8480196,Jacob Bryson,D,BUF,27,0,0,0,0
11,8479984,Cal Foote,D,,26,0,0,0,0
11,8480011,Klim Kostin,C,SJS,25,0,0,0,0
11,8482176,Wyatt Kaiser,D,CHI,22,0,0,0,0
11,8476988,Matt Benning,D,SJS,30,0,0,0,0
11,8479370,Tyson Jost,C,CAR,26,0,0,0,0
11,8477464,Nic Petan,C,,29,0,0,0,0
11,8477380,Jonny Brodzinski,C,NYR,31,0,0,0,0
11,8480070,Ian Mitchell,D,BOS,25,0,0,0,0
11,8479315,Joey Anderson,R,CHI,26,0,0,0,0
11,8478099,Kevin Labanc,R,,29,0,0,0,0
11,8476874,Olli Maatta,D,DET,30,0,0,0,0
11,8475208,Brian Dumoulin,D,ANA,33,0,0,0,0
11,8478430,Oliver Kylington,D,,27,0,0,0,0
11,8479536,Axel Jonsson-Fjallby,L,WPG,26,0,0,0,0
11,8479671,Mathieu Olivier,R,CBJ,27,0,0,0,0
11,8471709,Marc-Edouard Vlasic,D,SJS,37,0,0,0,0
11,8479328,Julien Gauthier,R,NYI,27,0,0,0,0
11,8478421,A.J. Greer,L,FLA,28,0,0,0,0
11,8477573,Nathan Walker,L,STL,30,0,0,0,0
11,8481537,Nikita Okhotiuk,D,CGY,24,0,0,0,0
11,8474166,Alec Martinez,D,CHI,37,0,0,0,0
11,8470610,Zach Parise,L,,40,0,0,0,0
11,8477478,William Carrier,L,CAR,30,0,0,0,0
11,8479344,Jesse Puljujarvi,R,PIT,26,0,0,0,0
11,8480887,Jordan Harris,D,MTL,24,0,0,0,0
11,8478502,Dennis Gilbert,D,BUF,28,0,0,0,0
11,8482730,Brandt Clarke,D,LAK,21,0,0,0,0
11,8480355,Mark Kastelic,C,BOS,25,0,0,0,0
11,8475750,Jon Merrill,D,MIN,32,0,0,0,0
11,8475164,Jakob Silfverberg,R,,34,0,0,0,0
11,8477944,Jakub Vrana,L,,28,0,0,0,0
11,8479439,Jacob MacDonald,D,COL,31,0,0,0,0
11,8474568,Luke Schenn,D,NSH,35,0,0,0,0
11,8478454,Noah Juulsen,D,VAN,27,0,0,0,0
11,8475752,Tyler Pitlick,C,,33,0,0,0,0
11,8482148,Hendrix Lapierre,C,WSH,22,0,0,0,0
11,8481167,Brayden Pachal,D,CGY,25,0,0,0,0
11,8478043,Sam Lafferty,C,BUF,29,0,0,0,0
11,8479321,Lucas Johansen,D,,27,0,0,0,0
11,8471699,Andrew Cogliano,C,,37,0,0,0,0
11,8481521,Ronnie Attard,D,PHI,25,0,0,0,0
11,8481161,Jake Christiansen,D,CBJ,25,0,0,0,0
11,8479458,Nikita Zaitsev,D,,33,0,0,0,0
11,8479619,Michael Carcone,L,UTA,28,0,0,0,0
11,8479026,Philippe Myers,D,TOR,27,0,0,0,0
11,8477330,Dominik Kubalik,L,,29,0,0,0,0
11,8481617,Vasily Podkolzin,R,VAN,23,0,0,0,0
11,8481701,Santeri Hatakka,D,NJD,23,0,0,0,0
11,8479514,Rem Pitlick,C,,27,0,0,0,0
11,8477446,Michael McCarron,R,NSH,29,0,0,0,0
11,8470604,Jeff Carter,C,,39,0,0,0,0
11,8482241,Radim Zohorna,L,,28,0,0,0,0
11,8480289,Morgan Barron,C,WPG,26,0,0,0,0
11,8479379,Givani Smith,R,SJS,26,0,0,0,0
11,8480216,Jacob Peterson,C,,25,0,0,0,0
11,8477851,Jordan Oesterle,D,BOS,32,0,0,0,0
11,8484258,Sam Malinski,D,COL,26,0,0,0,0
11,8478904,Steven Lorentz,C,,28,0,0,0,0
11,8482095,Tyler Kleven,D,OTT,22,0,0,0,0
11,8480848,Ty Dellandrea,C,SJS,24,0,0,0,0
11,8476884,Derrick Pouliot,D,,30,0,0,0,0
11,8479336,Carl Grundstrom,R,SJS,27,0,0,0,0
11,8482964,Arber Xhekaj,D,MTL,23,0,0,0,0
11,8471686,Marc Staal,D,,37,0,0,0,0
11,8477887,Patrick Brown,C,BOS,32,0,0,0,0
11,8478495,Denis Gurianov,R,,27,0,0,0,0
11,8473504,Cal Clutterbuck,R,,37,0,0,0,0
11,8481550,Adam Beckman,L,NJD,23,0,0,0,0
11,8480845,Rasmus Kupari,C,WPG,24,0,0,0,0
11,8474009,Nick Bonino,C,,36,0,0,0,0
11,8478585,Derek Ryan,C,EDM,38,0,0,0,0
11,8477962,Brendan Lemieux,L,CAR,28,0,0,0,0
11,8482861,Vincent Iorio,D,WSH,22,0,0,0,0
11,8479378,Logan Stanley,D,WPG,26,0,0,0,0
11,8473446,Erik Johnson,D,PHI,36,0,0,0,0
11,8481743,Marc Del Gaizo,D,NSH,25,0,0,0,0
11,8477384,Josh Brown,D,EDM,30,0,0,0,0
11,8482165,Yan Kuznetsov,D,CGY,22,0,0,0,0
11,8478424,Jansen Harkins,C,ANA,27,0,0,0,0
11,8482144,Jack Thompson,D,SJS,22,0,0,0,0
11,8478512,Austin Czarnik,C,,32,0,0,0,0
11,8477527,Ross Johnston,L,ANA,30,0,0,0,0
11,8479383,Boris Katchouk,L,,26,0,0,0,0
11,8482094,Daemon Hunt,D,MIN,22,0,0,0,0
11,8481719,Maxwell Crozier,D,TBL,24,0,0,0,0
11,8480192,Johnathan Kovacevic,D,NJD,27,0,0,0,0
11,8479376,Victor Mete,D,,26,0,0,0,0
11,8482511,Mason Lohrei,D,BOS,23,0,0,0,0
11,8475825,Jani Hakanpää,D,,32,0,0,0,0
11,8478021,William Lagesson,D,DET,28,0,0,0,0
11,8475795,Dylan McIlrath,D,WSH,32,0,0,0,0
11,8477846,Ryan Carpenter,C,,33,0,0,0,0
11,8481056,Spencer Stastney,D,NSH,24,0,0,0,0
11,8481564,Ryan Johnson,D,BUF,23,0,0,0,0
11,8478017,Mark Friedman,D,VAN,29,0,0,0,0
11,8479320,Max Lajoie,D,SEA,27,0,0,0,0
11,8480075,Cameron Crotty,D,MIN,25,0,0,0,0
11,8484287,Cole McWard,D,VAN,23,0,0,0,0
11,8484254,Akito Hirose,D,VAN,25,0,0,0,0
11,8483407,Brandon Scanlin,D,NYR,25,0,0,0,0
11,8480274,Philip Kemp,D,EDM,25,0,0,0,0
11,8479522,Hardy Haman Aktell,D,WSH,26,0,0,0,0
11,8480007,Jonas Rondbjerg,R,VGK,25,0,0,0,0
11,8477454,Adam Erne,L,,29,0,0,0,0
11,8481679,Maxence Guenette,D,OTT,23,0,0,0,0
11,8480441,Trey Fix-Wolansky,R,CBJ,25,0,0,0,0
11,8483546,Marshall Rifai,D,TOR,26,0,0,0,0
11,8480084,Nick DeSimone,D,NJD,30,0,0,0,0
11,8481030,Jack St. Ivany,D,PIT,25,0,0,0,0
11,8481592,Jakob Pelletier,L,CGY,23,0,0,0,0
11,8478011,Louie Belpedio,D,PHI,28,0,0,0,0
11,8477930,Pierre-Edouard Bellemare,L,,39,0,0,0,0
11,8484321,Nikolas Matinpalo,D,OTT,26,0,0,0,0
11,8482067,Connor Mackey,D,NYR,28,0,0,0,0
11,8481806,Louis Crevier,D,CHI,23,0,0,0,0
11,8484326,Patrik Koch,D,UTA,28,0,0,0,0
11,8477971,Andreas Englund,D,LAK,28,0,0,0,0
11,8481751,Lukas Rousek,R,BUF,25,0,0,0,0
11,8481006,Tyler Tucker,D,STL,24,0,0,0,0
11,8476867,Brendan Gaunce,C,MIN,30,0,0,0,0
11,8479520,Brandon Duhaime,R,WSH,27,0,0,0,0
11,8477073,Kurtis MacDermid,L,NJD,30,0,0,0,0
11,8480874,Adam Ginning,D,PHI,24,0,0,0,0
11,8477473,Justin Bailey,R,SJS,29,0,0,0,0
11,8479066,Ryan Lomberg,L,CGY,30,0,0,0,0
11,8477070,Liam O'Brien,C,UTA,30,0,0,0,0
11,8474618,Marco Scandella,D,,34,0,0,0,0
11,8475797,Jarred Tinordi,D,,32,0,0,0,0
11,8481441,Joe Snively,C,DET,28,0,0,0,0
11,8477244,Chad Ruhwedel,D,NYR,34,0,0,0,0
11,8479772,Zack MacEwen,R,OTT,28,0,0,0,0
11,8481147,Reese Johnson,C,MIN,26,0,0,0,0
11,8481043,Cole Koepke,L,BOS,26,0,0,0,0
11,8483619,Filip Roos,D,OTT,25,0,0,0,0
11,8481541,Samuel Bolduc,D,NYI,24,0,0,0,0
11,8477810,Joel Hanley,D,CGY,33,0,0,0,0
11,8476907,Mackenzie MacEachern,L,,30,0,0,0,0
11,8482652,Walker Duehr,R,CGY,27,0,0,0,0
11,8477126,Jayson Megna,C,,34,0,0,0,0
11,8483398,Declan Carlile,D,TBL,31,0,0,0,0
11,8482929,Emil Lilleberg,D,TBL,23,0,0,0,0
11,8480880,Jakub Lauko,C,MIN,24,0,0,0,0
11,8480245,Olle Lycksell,R,PHI,25,0,0,0,0
11,8480252,Cole Guttman,C,CHI,25,0,0,0,0
11,8477467,Gustav Olofsson,D,SEA,30,0,0,0,0
11,8479968,Vinni Lettieri,C,BOS,29,0,0,0,0
11,8478400,Colin White,C,,27,0,0,0,0
11,8475755,Alexander Petrovic,D,DAL,32,0,0,0,0
11,8481812,Nikolai Knyzhov,D,,27,0,0,0,0
11,8481593,Jayden Struble,D,MTL,23,0,0,0,0
11,8481532,Alex Turcotte,C,LAK,23,0,0,0,0
11,8482126,Emil Andrae,D,PHI,31,0,0,0,0
11,8479944,Zach Aston-Reese,C,VGK,30,0,0,0,0
11,8471817,Ryan Reaves,R,TOR,37,0,0,0,0
11,8481206,John Ludvig,D,PIT,24,0,0,0,0
11,8481599,Victor Soderstrom,D,UTA,23,0,0,0,0
11,8480292,Carson Meyer,R,ANA,27,0,0,0,0
11,8482496,Nils Aman,C,VAN,24,0,0,0,0
11,8479718,Alex Barré-Boulet,C,MTL,27,0,0,0,0
11,8479994,Jaret Anderson-Dolan,C,WPG,25,0,0,0,0
11,8480184,Gustav Lindstrom,D,,26,0,0,0,0
11,8480890,Jan Jenik,R,OTT,24,0,0,0,0
11,8478067,Oskar Lindblom,L,,28,0,0,0,0
11,8476934,Brock McGinn,L,ANA,30,0,0,0,0
11,8479985,Cale Fleury,D,SEA,26,0,0,0,0
11,8484304,Uvis Balinskis,D,FLA,28,0,0,0,0
11,8479981,Jonah Gadjovich,L,FLA,26,0,0,0,0
11,8481716,Dmitri Voronkov,L,CBJ,24,0,0,0,0
11,8474709,Matt Martin,L,,35,0,0,0,0
11,8482634,Alex Steeves,C,TOR,25,0,0,0,0
11,8480823,Alexander Alexeyev,D,WSH,25,0,0,0,0
11,8477541,Dakota Mermis,D,TOR,30,0,0,0,0
11,8483491,Ivan Miroshnichenko,L,WSH,20,0,0,0,0
11,8478477,Mitchell Stephens,C,SEA,27,0,0,0,0
11,8481543,Nikita Alexandrov,C,STL,24,0,0,0,0
11,8479423,Alex Nylander,L,,26,0,0,0,0
11,8482451,Mikael Pyyhtia,L,CBJ,23,0,0,0,0
11,8478831,Kevin Stenlund,C,UTA,28,0,0,0,0
11,8480306,Grant Hutton,D,NYI,29,0,0,0,0
11,8478028,Fredrik Olofsson,L,,28,0,0,0,0
11,8477462,Robert Hagg,D,VGK,29,0,0,0,0
11,8477320,Anton Blidh,L,NYR,29,0,0,0,0
11,8482157,Will Cuylle,L,NYR,22,0,0,0,0
11,8482737,Zack Bolduc,C,STL,21,0,0,0,0
11,8481239,Samuel Fagemo,L,,24,0,0,0,0
11,8481600,Tobias Bjornfot,D,FLA,23,0,0,0,0
11,8478409,Anthony Richard,C,PHI,28,0,0,0,0
11,8474145,Robert Bortuzzo,D,,35,0,0,0,0
11,8475958,Michael Sgarbossa,C,WSH,32,0,0,0,0
11,8479986,Kole Lind,R,DAL,26,0,0,0,0
11,8479249,Andrew Poturalski,C,SJS,30,0,0,0,0
11,8479362,Riley Tufte,L,BOS,26,0,0,0,0
11,8479991,Jake Leschyshyn,C,NYR,25,0,0,0,0
11,8479587,Rhett Gardner,C,PHI,28,0,0,0,0
11,8482744,James Malatesta,L,CBJ,21,0,0,0,0
11,8478854,Ryan Shea,D,PIT,27,0,0,0,0
11,8481591,Sam Poulin,R,,23,0,0,0,0
11,8483512,Matt Savoie,C,EDM,20,0,0,0,0
11,8482102,Vasily Ponomarev,C,PIT,22,0,0,0,0
11,8482162,Roby Jarventie,L,EDM,22,0,0,0,0
11,8481016,Ruslan Iskhakov,C,,24,0,0,0,0
11,8482172,Landon Slaggert,L,CHI,22,0,0,0,0
11,8482747,Brennan Othmann,L,NYR,21,0,0,0,0
11,8480031,Maxime Comtois,L,,25,0,0,0,0
11,8480226,Marián Studenic,R,,26,0,0,0,0
11,8478408,Travis Dermott,D,,28,0,0,0,0
11,8481518,Nolan Foote,L,NJD,24,0,0,0,0
11,8479419,Brett Murray,L,BUF,26,0,0,0,0
11,8482088,Justin Sourdif,R,FLA,22,0,0,0,0
11,8482201,Gage Goncalves,C,TBL,23,0,0,0,0
11,8481578,Graeme Clarke,R,MIN,23,0,0,0,0
11,8482177,Marat Khusnutdinov,C,MIN,22,0,0,0,0
11,8481754,Nikita Nesterenko,C,ANA,23,0,0,0,0
11,8483531,Brian Halonen,L,NJD,25,0,0,0,0
11,8483920,Pierrick Dube,R,WSH,23,0,0,0,0
11,8480851,Akil Thomas,C,LAK,24,0,0,0,0
11,8475235,Nicolas Deslauriers,L,PHI,33,0,0,0,0
11,8482476,Emil Heineman,L,MTL,23,0,0,0,0
11,8477149,Scott Sabourin,R,SJS,32,0,0,0,0
11,8483549,Lucas Condotta,L,MTL,27,0,0,0,0
11,8482765,Isak Rosen,R,BUF,21,0,0,0,0
11,8481237,Kyle MacLean,C,NYI,25,0,0,0,0
11,8481024,Linus Karlsson,C,VAN,25,0,0,0,0
11,8481690,Tyler Angle,C,,24,0,0,0,0
11,8483570,Ben Meyers,C,SEA,26,0,0,0,0
11,8481655,Cole Schwindt,R,CGY,23,0,0,0,0
11,8481462,Mason Morelli,L,VGK,28,0,0,0,0
11,8483401,Marc Johnstone,R,PIT,28,0,0,0,0
11,8478956,Samuel Laberge,L,NJD,27,0,0,0,0
11,8479533,Joona Koppanen,L,,26,0,0,0,0
11,8482197,Adam Raska,R,MIN,23,0,0,0,0
11,8482250,Callahan Burke,C,VGK,27,0,0,0,0
11,8482784,Zach Dean,C,STL,21,0,0,0,0
11,8484255,Jason Polin,R,COL,25,0,0,0,0
11,8481077,John Leonard,L,,26,0,0,0,0
11,8481534,Raphael Lavoie,C,EDM,24,0,0,0,0
11,8483609,Adam Klapka,R,CGY,24,0,0,0,0
11,8482751,Ryan Winterton,C,SEA,21,0,0,0,0
11,8480267,Sammy Walker,C,MIN,25,0,0,0,0
11,8475766,Austin Watson,L,,32,0,0,0,0
11,8482460,Matt Rempe,C,NYR,22,0,0,0,0
11,8481065,Angus Crookshank,L,OTT,25,0,0,0,0
11,8481070,Hugh McGing,L,,26,0,0,0,0
11,8476323,Max McCormick,L,SEA,32,0,0,0,0
11,8483395,Arshdeep Bains,L,VAN,23,0,0,0,0
11,8484259,Ondrej Pavel,C,COL,31,0,0,0,0
11,8483432,Luca Del Bel Belluz,C,CBJ,31,0,0,0,0
11,8483045,Cameron Butler,R,CBJ,31,0,0,0,0
11,8482061,Brandon Biro,L,SEA,26,0,0,0,0
11,8477401,John Hayden,C,SEA,29,0,0,0,0
11,8475278,Byron Froese,C,,33,0,0,0,0
11,8478446,Glenn Gawdin,C,LAK,27,0,0,0,0
11,8477993,Justin Kirkland,C,CGY,28,0,0,0,0
11,8482147,Jean-Luc Foudy,C,COL,22,0,0,0,0
11,8480032,Shane Bowers,C,NJD,25,0,0,0,0
11,8479330,Brandon Gignac,C,MTL,27,0,0,0,0
11,8480776,Sheldon Rempal,R,,29,0,0,0,0
11,8475413,Justin Dowling,C,NJD,34,0,0,0,0
11,8481726,Adam Edstrom,C,NYR,24,0,0,0,0
11,8480844,Grigori Denisenko,L,VGK,24,0,0,0,0
11,8478147,Bokondji Imama,L,PIT,28,0,0,0,0
11,8478881,Brett Seney,L,CHI,28,0,0,0,0
11,8483630,Pavol Regenda,L,ANA,25,0,0,0,0
11,8480836,Jonathan Gruden,C,,24,0,0,0,0
11,8484314,Jiri Smejkal,L,,28,0,0,0,0
11,8475780,Chris Wagner,R,COL,33,0,0,0,0
11,8479546,Oskar Steen,C,,26,0,0,0,0
11,8483597,Milos Kelemen,L,UTA,25,0,0,0,0
11,8481789,Tye Kartye,L,SEA,23,0,0,0,0
11,8484325,Waltteri Merela,C,TBL,26,0,0,0,0
11,8479421,Jacob Moverare,D,LAK,26,0,0,0,0
11,8481585,Egor Afanasyev,L,SJS,23,0,0,0,0
11,8479547,Matthew Phillips,R,,26,0,0,0,0
11,8479367,William Lockwood,R,FLA,26,0,0,0,0
11,8476915,Jujhar Khaira,L,,30,0,0,0,0
11,8481422,Jacob Lucchini,C,NSH,29,0,0,0,0
11,8480468,James Hamblin,L,EDM,25,0,0,0,0
11,8478051,Max Willman,C,NJD,29,0,0,0,0
11,8481556,John Beecher,C,BOS,23,0,0,0,0
11,8478078,Rourke Chartier,C,,28,0,0,0,0
12,8478402,Connor McDavid,C,EDM,27,82,46,109,155
12,8477956,David Pastrnak,R,BOS,28,82,59,76,135
12,8476453,Nikita Kucherov,R,TBL,31,82,42,92,134
12,8477492,Nathan MacKinnon,C,COL,29,82,56,73,129
12,8479318,Auston Matthews,C,TOR,27,82,63,59,122
12,8477934,Leon Draisaitl,C,EDM,29,82,45,70,115
12,8477933,Sam Reinhart,C,FLA,29,82,57,52,109
12,8479314,Matthew Tkachuk,L,FLA,27,82,38,70,108
12,8476468,J.T. Miller,C,VAN,31,82,30,78,108
12,8478550,Artemi Panarin,L,NYR,33,82,35,71,106
12,8477939,William Nylander,R,TOR,28,82,46,56,102
12,8480012,Elias Pettersson,C,VAN,26,82,47,52,99
12,8477493,Aleksander Barkov,C,FLA,29,82,22,76,98
12,8474564,Steven Stamkos,C,NSH,34,82,43,54,97
12,8471675,Sidney Crosby,C,PIT,37,82,41,56,97
12,8477404,Jake Guentzel,C,TBL,30,82,45,51,96
12,8478420,Mikko Rantanen,R,COL,28,82,37,59,96
12,8476887,Filip Forsberg,L,NSH,30,82,49,46,95
12,8476459,Mika Zibanejad,C,NYR,31,82,32,63,95
12,8480800,Quinn Hughes,D,VAN,25,82,12,83,95
12,8478864,Kirill Kaprizov,L,MIN,27,82,41,53,94
12,8475158,Ryan O'Reilly,C,NSH,33,82,39,55,94
12,8474600,Roman Josi,D,NSH,34,82,25,69,94
12,8477951,Nick Schmaltz,C,UTA,28,82,40,53,93
12,8478427,Sebastian Aho,C,CAR,27,82,40,52,92
12,8480023,Robert Thomas,C,STL,25,82,22,70,92
12,8479343,Clayton Keller,R,UTA,26,82,47,43,90
12,8480002,Nico Hischier,C,NJD,25,82,31,57,88
12,8482093,Seth Jarvis,C,CAR,22,82,40,47,87
12,8478398,Kyle Connor,L,WPG,28,82,38,49,87
12,8480801,Brady Tkachuk,L,OTT,25,82,38,49,87
12,8477942,Kevin Fiala,L,LAK,28,82,34,53,87
12,8477402,Pavel Buchnevich,L,STL,29,82,31,56,87
12,8480069,Cale Makar,D,COL,26,82,22,65,87
12,8481559,Jack Hughes,C,NJD,23,82,33,53,86
12,8477960,Adrian Kempe,R,LAK,28,82,31,55,86
12,8476454,Ryan Nugent-Hopkins,C,EDM,31,82,28,58,86
12,8475166,John Tavares,C,TOR,34,82,43,42,85
12,8478403,Jack Eichel,C,VGK,28,82,42,43,85
12,8475913,Mark Stone,R,VGK,32,82,32,53,85
12,8477949,Alex Tuch,R,BUF,28,82,31,54,85
12,8477501,Valeri Nichushkin,R,COL,29,82,49,35,84
12,8479420,Tage Thompson,C,BUF,27,82,42,42,84
12,8479407,Jesper Bratt,L,NJD,26,82,36,48,84
12,8480027,Jason Robertson,L,DAL,25,82,33,51,84
12,8476389,Vincent Trocheck,C,NYR,31,82,39,44,83
12,8479675,Trevor Moore,L,LAK,29,82,43,38,81
12,8477409,Carter Verhaeghe,C,FLA,29,82,41,40,81
12,8471214,Alex Ovechkin,L,WSH,39,82,40,40,80
12,8478873,Troy Terry,R,ANA,27,82,32,48,80
12,8476346,Johnny Gaudreau,L,CBJ,31,82,24,55,79
12,8480036,Miro Heiskanen,D,DAL,25,82,19,60,79
12,8477447,Shea Theodore,D,VGK,29,82,17,62,79
12,8479339,Patrik Laine,L,CBJ,26,82,38,40,78
12,8477940,Nikolaj Ehlers,L,WPG,28,82,34,43,77
12,8477946,Dylan Larkin,C,DET,28,82,31,46,77
12,8471215,Evgeni Malkin,C,PIT,38,82,29,48,77
12,8475172,Nazem Kadri,C,CGY,34,82,36,40,76
12,8481528,Dylan Cozens,C,BUF,23,82,21,55,76
12,8475184,Chris Kreider,L,NYR,33,82,36,39,75
12,8475692,Mats Zuccarello,R,MIN,37,82,20,55,75
12,8474578,Erik Karlsson,D,PIT,34,82,14,61,75
12,8478440,Dylan Strome,C,WSH,27,82,33,41,74
12,8476853,Morgan Rielly,D,TOR,30,82,10,64,74
12,8473419,Brad Marchand,L,BOS,36,82,32,41,73
12,8474141,Patrick Kane,R,DET,36,82,30,43,73
12,8477496,Elias Lindholm,C,BOS,30,82,27,46,73
12,8481533,Trevor Zegras,C,ANA,23,82,27,46,73
12,8479425,Filip Hronek,D,VAN,27,82,13,60,73
12,8475810,Bryan Rust,R,PIT,32,82,37,35,72
12,8481557,Matt Boldy,L,MIN,23,82,35,37,72
12,8480830,Andrei Svechnikov,R,CAR,24,82,26,46,72
12,8481523,Kirby Dach,C,MTL,23,82,11,61,72
12,8475794,Tyler Seguin,C,DAL,32,82,38,33,71
12,8482665,Matty Beniers,C,SEA,22,82,30,41,71
12,8478449,Roope Hintz,C,DAL,28,82,29,42,71
12,8480018,Nick Suzuki,C,MTL,25,82,28,43,71
12,8477504,Josh Morrissey,D,WPG,29,82,14,57,71
12,8476539,Jonathan Marchessault,R,NSH,34,82,41,29,70
12,8478445,Mathew Barzal,C,NYI,27,82,17,53,70
12,8480803,Evan Bouchard,D,EDM,25,82,17,53,70
12,8478460,Zach Werenski,D,CBJ,27,82,16,54,70
12,8474565,Alex Pietrangelo,D,VGK,34,82,16,54,70
12,8480839,Rasmus Dahlin,D,BUF,24,82,13,57,70
12,8475786,Zach Hyman,L,EDM,32,82,39,30,69
12,8478439,Travis Konecny,R,PHI,27,82,35,34,69
12,8476460,Mark Scheifele,C,WPG,31,82,34,35,69
12,8474150,Mikael Backlund,C,CGY,35,82,29,40,69
12,8475745,Charlie Coyle,C,BOS,32,82,26,43,69
12,8475798,Mikael Granlund,C,SJS,32,82,18,51,69
12,8479323,Adam Fox,D,NYR,26,82,14,55,69
12,8479325,Charlie McAvoy,D,BOS,27,82,11,58,69
12,8478010,Brayden Point,C,TBL,28,82,35,33,68
12,8475754,Brock Nelson,C,NYI,33,82,30,38,68
12,8479385,Jordan Kyrou,C,STL,26,82,28,40,68
12,8482097,Jack Quinn,R,BUF,23,82,27,41,68
12,8480865,Noah Dobson,D,NYI,24,82,17,51,68
12,8478444,Brock Boeser,R,VAN,27,82,26,41,67
12,8476456,Jonathan Huberdeau,C,CGY,31,82,20,47,67
12,8480208,Drake Batherson,R,OTT,26,82,30,36,66
12,8478498,Jake DeBrusk,L,VAN,28,82,30,36,66
12,8471685,Anze Kopitar,C,LAK,37,82,26,40,66
12,8476448,William Karlsson,C,VGK,31,82,25,41,66
12,8475784,Jeff Skinner,C,EDM,32,82,30,35,65
12,8475167,Victor Hedman,D,TBL,34,82,21,44,65
12,8478407,Vince Dunn,D,SEA,28,82,16,49,65
12,8478493,Joel Eriksson Ek,C,MIN,27,82,33,31,64
12,8473994,Jamie Benn,L,DAL,35,82,27,37,64
12,8480039,Martin Necas,C,CAR,25,82,24,40,64
12,8478042,Viktor Arvidsson,R,EDM,31,82,22,42,64
12,8477500,Bo Horvat,C,NYI,29,82,31,32,63
12,8479337,Alex DeBrincat,R,DET,27,82,26,37,63
12,8482078,Lucas Raymond,L,DET,22,82,19,44,63
12,8478414,Timo Meier,R,NJD,28,82,34,28,62
12,8480015,Owen Tippett,R,PHI,25,82,26,36,62
12,8474679,Gustav Nyquist,C,NSH,35,82,21,41,62
12,8481711,Matias Maccelli,L,UTA,24,82,19,43,62
12,8479542,Brandon Hagel,L,TBL,26,82,28,33,61
12,8482116,Tim Stützle,C,OTT,22,82,25,36,61
12,8478397,Rasmus Andersson,D,CGY,28,82,14,47,61
12,8481540,Cole Caufield,R,MTL,23,82,29,31,60
12,8471724,Kris Letang,D,PIT,37,82,22,38,60
12,8476432,Boone Jenner,C,CBJ,31,82,34,25,59
12,8475726,Tyler Toffoli,C,SJS,32,82,29,30,59
12,8482667,William Eklund,L,SJS,22,82,23,36,59
12,8482113,Anton Lundell,C,FLA,23,82,20,39,59
12,8478438,Tommy Novak,C,NSH,27,82,19,40,59
12,8478038,Devon Toews,D,COL,30,82,11,48,59
12,8476399,Blake Coleman,C,CGY,33,82,27,31,58
12,8475170,Brayden Schenn,C,STL,33,82,26,32,58
12,8476905,Chandler Stephenson,C,SEA,30,82,20,38,58
12,8476875,Mike Matheson,D,MTL,30,82,13,45,58
12,8474102,David Perron,L,OTT,36,82,30,27,57
12,8475191,Reilly Smith,R,NYR,33,82,26,31,57
12,8475168,Matt Duchene,C,DAL,33,82,21,36,57
12,8478856,Conor Garland,R,VAN,28,82,20,37,57
12,8477503,Max Domi,C,TOR,29,82,16,41,57
12,8476882,Teuvo Teravainen,L,CHI,30,82,16,41,57
12,8475765,Vladimir Tarasenko,R,DET,33,82,28,28,56
12,8477416,Oliver Bjorkstrand,R,SEA,29,82,26,30,56
12,8478975,Mason Marchment,L,DAL,29,82,23,33,56
12,8476881,Tomas Hertl,C,VGK,31,82,22,34,56
12,8480797,Joel Farabee,L,PHI,24,82,22,34,56
12,8482745,Mason McTavish,C,ANA,21,82,26,29,55
12,8476880,Tom Wilson,R,WSH,30,82,25,30,55
12,8477407,Anthony Duclair,L,NYI,29,82,25,30,55
12,8480188,Fabian Zetterlund,L,SJS,25,82,24,31,55
12,8477511,Anthony Mantha,R,CGY,30,82,24,31,55
12,8480798,Philipp Kurashev,C,CHI,25,82,23,32,55
12,8477494,Jonathan Drouin,L,COL,29,82,18,37,55
12,8477476,Artturi Lehkonen,L,COL,29,82,30,24,54
12,8477955,Jared McCann,L,SEA,28,82,27,27,54
12,8478462,Nicolas Roy,C,VGK,27,82,25,29,54
12,8478472,Mathieu Joseph,R,STL,27,82,20,34,54
12,8476792,Torey Krug,D,STL,33,82,18,36,54
12,8474563,Drew Doughty,D,LAK,35,82,14,40,54
12,8474586,Jordan Eberle,R,SEA,34,82,11,43,54
12,8477346,MacKenzie Weegar,D,CGY,30,82,7,47,54
12,8482159,Tyson Foerster,R,PHI,22,82,22,31,53
12,8480078,Filip Chytil,C,NYR,25,82,18,35,53
12,8474590,John Carlson,D,WSH,34,82,16,37,53
12,8478401,Pavel Zacha,C,BOS,27,82,15,38,53
12,8479345,Jakob Chychrun,D,WSH,26,82,12,41,53
12,8479410,Mikhail Sergachev,D,UTA,26,82,10,43,53
12,8481068,Yegor Sharangovich,C,CGY,26,82,29,23,52
12,8478366,Frank Vatrano,R,ANA,30,82,28,24,52
12,8477998,Warren Foegele,L,LAK,28,82,24,28,52
12,8477444,Andre Burakovsky,L,SEA,29,82,23,29,52
12,8477935,Sam Bennett,C,FLA,28,82,21,31,52
12,8482699,Dylan Guenther,R,UTA,21,82,21,31,52
12,8475791,Taylor Hall,L,CHI,33,82,18,34,52
12,8479999,Casey Mittelstadt,C,COL,26,82,17,35,52
12,8473512,Claude Giroux,R,OTT,36,82,16,36,52
12,8482175,JJ Peterka,R,BUF,22,82,23,28,51
12,8478458,Jack Roslovic,C,CAR,27,82,21,30,51
12,8478396,Noah Hanifin,D,VGK,27,82,17,34,51
12,8476854,Hampus Lindholm,D,BOS,30,82,14,37,51
12,8480064,Josh Norris,C,OTT,25,82,23,27,50
12,8478047,Michael Bunting,L,PIT,29,82,21,29,50
12,8476479,Phillip Danault,C,LAK,31,82,20,30,50
12,8477021,Alex Kerfoot,C,UTA,30,82,19,31,50
12,8470613,Brent Burns,D,CAR,39,82,16,34,50
12,8476869,Brady Skjei,D,NSH,30,82,13,37,50
12,8475151,Kyle Palmieri,C,NYI,33,82,23,26,49
12,8475169,Evander Kane,L,EDM,33,82,22,27,49
12,8482705,Cole Sillinger,C,CBJ,21,82,22,27,49
12,8481618,Alex Newhook,C,MTL,23,82,20,29,49
12,8482124,Quinton Byfield,R,LAK,22,82,19,30,49
12,8478469,Thomas Chabot,D,OTT,27,82,17,32,49
12,8482475,Yegor Chinakhov,R,CBJ,23,82,17,32,49
12,8476906,Shayne Gostisbehere,D,CAR,31,82,14,35,49
12,8476462,Dougie Hamilton,D,NJD,31,82,12,37,49
12,8482740,Wyatt Johnston,C,DAL,21,82,26,22,48
12,8478519,Anthony Cirelli,C,TBL,27,82,19,29,48
12,8473986,Alex Killorn,L,ANA,35,82,14,34,48
12,8477986,Brandon Montour,D,SEA,30,82,14,34,48
12,8476958,Jaccob Slavin,D,CAR,30,82,9,39,48
12,8478474,Lawson Crouse,L,UTA,27,82,30,17,47
12,8476438,Brandon Saad,L,STL,32,82,30,17,47
12,8477456,J.T. Compher,L,DET,29,82,23,24,47
12,8480185,Eetu Luostarinen,C,FLA,26,82,22,25,47
12,8477451,Ryan Hartman,R,MIN,30,82,21,26,47
12,8482720,Matthew Knies,L,TOR,22,82,16,31,47
12,8477495,Seth Jones,D,CHI,30,82,15,32,47
12,8476483,Rickard Rakell,R,PIT,31,82,27,19,46
12,8475722,Jason Zucker,L,BUF,32,82,22,24,46
12,8482109,Alexis Lafrenière,L,NYR,23,82,19,27,46
12,8482149,Cole Perfetti,C,WPG,22,82,18,28,46
12,8477932,Aaron Ekblad,D,FLA,28,82,13,33,46
12,8476885,Jacob Trouba,D,NYR,30,82,11,35,46
12,8475753,Justin Faulk,D,STL,32,82,10,36,46
12,8478055,Gustav Forsling,D,FLA,28,82,9,37,46
12,8478057,Dakota Joshua,C,VAN,28,82,29,16,45
12,8477964,Ivan Barbashev,C,VGK,29,82,21,24,45
12,8478046,Danton Heinen,L,VAN,29,82,21,24,45
12,8477479,Tyler Bertuzzi,L,CHI,29,82,19,26,45
12,8482110,Dawson Mercer,C,NJD,23,82,19,26,45
12,8484144,Connor Bedard,C,CHI,19,82,19,26,45
12,8479400,Pierre-Luc Dubois,L,WSH,26,82,18,27,45
12,8479987,Morgan Geekie,C,BOS,26,82,16,29,45
12,8480014,Gabriel Vilardi,C,WPG,25,82,26,18,44
12,8475314,Anders Lee,L,NYI,34,82,25,19,44
12,8477987,Ryan Donato,C,CHI,28,82,25,19,44
12,8479525,Ross Colton,C,COL,28,82,24,20,44
12,8482055,Drew O'Connor,L,PIT,26,82,22,22,44
12,8476458,Ryan Strome,C,ANA,31,82,21,23,44
12,8481560,Arthur Kaliyev,R,LAK,23,82,20,24,44
12,8480028,Morgan Frost,C,PHI,25,82,19,25,44
12,8482146,Luke Evangelista,R,NSH,22,82,18,26,44
12,8475848,Brendan Gallagher,R,MTL,32,82,18,26,44
12,8478463,Anthony Beauvillier,L,PIT,27,82,12,32,44
12,8476923,Damon Severson,D,CBJ,30,82,11,33,44
12,8480434,Sean Durzi,D,UTA,26,82,9,35,44
12,8480873,Rasmus Sandin,D,WSH,24,82,4,40,44
12,8475764,Cam Fowler,D,ANA,33,82,4,40,44
12,8477426,Nicholas Paul,L,TBL,29,82,20,23,43
12,8478233,Andrew Mangiapane,L,WSH,28,82,19,24,43
12,8482660,Kent Johnson,C,CBJ,22,82,17,26,43
12,8475714,Calle Jarnkrok,C,TOR,33,82,16,27,43
12,8471698,T.J. Oshie,R,WSH,38,82,16,27,43
12,8478891,Mason Appleton,C,WPG,28,82,9,34,43
12,8475793,Ryan Johansen,C,PHI,32,82,21,21,42
12,8474053,Logan Couture,C,SJS,35,82,17,25,42
12,8476419,Jean-Gabriel Pageau,C,NYI,32,82,17,25,42
12,8479996,Cody Glass,C,NSH,25,82,17,25,42
12,8479365,Trent Frederic,C,BOS,26,82,16,26,42
12,8475171,Oliver Ekman-Larsson,D,TOR,33,82,14,28,42
12,8477919,Frederick Gaudreau,C,MIN,31,82,14,28,42
12,8481546,Cam York,D,PHI,23,82,13,29,42
12,8476329,Travis Boyd,C,MIN,31,82,12,30,42
12,8475799,Nino Niederreiter,R,WPG,32,82,24,17,41
12,8476873,Mark Jankowski,C,NSH,30,82,13,28,41
12,8480009,Eeli Tolvanen,R,SEA,25,82,23,17,40
12,8475768,Jaden Schwartz,C,SEA,32,82,21,19,40
12,8476474,Stefan Noesen,R,NJD,31,82,17,23,40
12,8482105,Jake Sanderson,D,OTT,22,82,15,25,40
12,8474716,Jared Spurgeon,D,MIN,35,82,14,26,40
12,8483515,Juraj Slafkovsky,L,MTL,20,82,14,26,40
12,8476826,Yanni Gourde,C,SEA,33,82,13,27,40
12,8477948,Travis Sanheim,D,PHI,28,82,11,29,40
12,8481656,Aliaksei Protas,C,WSH,23,82,11,29,40
12,8477952,Robby Fabbri,C,ANA,28,82,23,16,39
12,8481624,Ilya Mikheyev,R,CHI,30,82,18,21,39
12,8474149,Evgenii Dadonov,R,DAL,35,82,16,23,39
12,8478542,Evan Rodrigues,C,FLA,31,82,15,24,39
12,8475287,Erik Haula,L,NJD,33,82,15,24,39
12,8478115,Pierre Engvall,L,NYI,28,82,15,24,39
12,8475149,Marcus Johansson,L,MIN,34,82,14,25,39
12,8476292,Ondrej Palat,L,NJD,33,82,13,26,39
12,8475200,Dmitry Orlov,D,CAR,33,82,12,27,39
12,8475218,Mattias Ekholm,D,EDM,34,82,10,29,39
12,8482671,Owen Power,D,BUF,22,82,9,30,39
12,8481535,Nils Hoglander,L,VAN,24,82,22,16,38
12,8482089,Jake Neighbours,L,STL,22,82,22,16,38
12,8480459,Pius Suter,C,VAN,28,82,22,16,38
12,8481604,Pavel Dorofeyev,L,VGK,24,82,20,18,38
12,8479661,Tanner Jeannot,L,LAK,27,82,19,19,38
12,8479316,Luke Kunin,C,SJS,27,82,18,20,38
12,8480849,Barrett Hayton,C,UTA,24,82,17,21,38
12,8479390,Taylor Raddysh,R,WSH,26,82,17,21,38
12,8475760,Nick Bjugstad,C,UTA,32,82,14,24,38
12,8479992,Michael Rasmussen,C,DET,25,82,11,27,38
12,8477497,Sean Monahan,C,CBJ,30,82,9,29,38
12,8480871,Adam Boqvist,D,FLA,24,82,8,30,38
12,8477507,Nikita Zadorov,D,BOS,29,82,7,31,38
12,8481704,Juuso Parssinen,C,NSH,23,82,18,19,37
12,8480829,Jesperi Kotkaniemi,C,CAR,24,82,17,20,37
12,8478133,Jake Evans,C,MTL,28,82,14,23,37
12,8474641,Adam Henrique,C,EDM,34,82,12,25,37
12,8479591,Michael Eyssimont,C,TBL,28,82,10,27,37
12,8479398,Samuel Girard,D,COL,26,82,2,35,37
12,8483808,Andrei Kuzmenko,L,CGY,28,82,22,14,36
12,8479941,Justin Danforth,R,CBJ,31,82,21,15,36
12,8481093,Rafael Harvey-Pinard,L,MTL,25,82,21,15,36
12,8476918,Jimmy Vesey,L,NYR,31,82,21,15,36
12,8482079,Marco Rossi,C,MIN,23,82,20,16,36
12,8482117,Lukas Reichel,L,CHI,22,82,14,22,36
12,8477947,Sonny Milano,L,WSH,28,82,14,22,36
12,8480220,Noah Cates,L,PHI,25,82,13,23,36
12,8476925,Colton Sissons,C,NSH,31,82,13,23,36
12,8480336,Sean Walker,D,CAR,30,82,10,26,36
12,8482133,Thomas Bordeleau,C,SJS,22,82,9,27,36
12,8482684,Luke Hughes,D,NJD,21,82,7,29,36
12,8481554,Kaapo Kakko,R,NYR,23,82,20,15,35
12,8481013,Jonatan Berggren,R,DET,24,82,18,17,35
12,8476392,Adam Lowry,C,WPG,31,82,17,18,35
12,8477953,Kasperi Kapanen,R,STL,28,82,16,19,35
12,8482111,Justin Barron,D,MTL,23,82,14,21,35
12,8473563,Nicklas Backstrom,C,WSH,37,82,12,23,35
12,8482092,Ridly Greig,C,OTT,22,82,11,24,35
12,8475181,Nick Leddy,D,STL,33,82,5,30,35
12,8476897,Oskar Sundqvist,C,STL,30,82,16,18,34
12,8480835,Jack Drury,C,CAR,24,82,15,19,34
12,8481481,Blake Lizotte,C,PIT,27,82,15,19,34
12,8477429,Andrew Copp,C,DET,30,82,12,22,34
12,8477498,Darnell Nurse,D,EDM,29,82,12,22,34
12,8478413,Jordan Greenway,L,BUF,27,82,12,22,34
12,8481581,Thomas Harley,D,DAL,23,82,11,23,34
12,8476960,Andreas Athanasiou,C,CHI,30,82,11,23,34
12,8481596,Shane Pinto,C,OTT,24,82,10,24,34
12,8476461,Sean Couturier,C,PHI,32,82,10,24,34
12,8478507,John Marino,D,UTA,27,82,10,24,34
12,8482073,Braden Schneider,D,NYR,23,82,7,27,34
12,8481606,Jordan Spence,D,LAK,23,82,4,30,34
12,8476892,Colton Parayko,D,STL,31,82,4,30,34
12,8480893,Kirill Marchenko,R,CBJ,24,82,19,14,33
12,8474189,Lars Eller,C,PIT,35,82,15,18,33
12,8476872,Scott Laughton,C,PHI,30,82,14,19,33
12,8479368,Max Jones,L,BOS,26,82,14,19,33
12,8476374,Sean Kuraly,C,CBJ,31,82,11,22,33
12,8481542,Moritz Seider,D,DET,23,82,6,27,33
12,8478109,Victor Olofsson,L,VGK,29,82,19,13,32
12,8484166,Adam Fantilli,C,CBJ,20,82,17,15,32
12,8481186,Logan O'Connor,R,COL,28,82,16,16,32
12,8475343,Nic Dowd,C,WSH,34,82,16,16,32
12,8484203,Bradly Nadeau,L,CAR,19,82,12,20,32
12,8475763,Kevin Hayes,R,PIT,32,82,11,21,32
12,8480113,Alex Iafallo,L,WPG,31,82,10,22,32
12,8480145,Neal Pionk,D,WPG,29,82,5,27,32
12,8480043,Timothy Liljegren,D,TOR,25,82,2,30,32
12,8481580,Connor McMichael,C,WSH,23,82,21,10,31
12,8473422,Nick Foligno,L,CHI,37,82,17,14,31
12,8476278,Colin Blackwell,C,DAL,31,82,15,16,31
12,8477015,Connor Brown,R,EDM,30,82,12,19,31
12,8481517,Brett Leason,R,ANA,25,82,11,20,31
12,8476463,Jonas Brodin,D,MIN,31,82,8,23,31
12,8480817,K'Andre Miller,D,NYR,24,82,6,25,31
12,8480813,Joe Veleno,C,DET,24,82,15,15,30
12,8480748,Kiefer Sherwood,L,VAN,29,82,15,15,30
12,8475193,Tomas Tatar,L,NJD,34,82,14,16,30
12,8476927,Teddy Blueger,C,VAN,30,82,11,19,30
12,8480802,Ryan McLeod,C,BUF,25,82,11,19,30
12,8479369,Andrew Peeke,D,BOS,26,82,10,20,30
12,8479351,Sam Steel,C,DAL,26,82,8,22,30
12,8475855,Jesper Fast,R,CAR,33,82,7,23,30
12,8479983,Mario Ferraro,D,SJS,26,82,7,23,30
12,8477506,Ryan Pulock,D,NYI,30,82,6,24,30
12,8481014,Alexander Romanov,D,NYI,24,82,5,25,30
12,8474673,TJ Brodie,D,CHI,34,82,3,27,30
12,8480860,Kevin Bahl,D,CGY,24,82,3,27,30
12,8480448,Parker Kelly,L,COL,25,82,17,12,29
12,8477406,Mattias Janmark,C,EDM,32,82,16,13,29
12,8478020,Michael Amadio,C,OTT,28,82,14,15,29
12,8476469,Joel Armia,R,MTL,31,82,14,15,29
12,8480003,Jesper Boqvist,C,FLA,26,82,13,16,29
12,8476979,Erik Gustafsson,D,DET,32,82,8,21,29
12,8482245,Artem Zub,D,OTT,29,82,6,23,29
12,8478416,Erik Cernak,D,TBL,27,82,5,24,29
12,8479976,Juuso Valimaki,D,UTA,26,82,2,27,29
12,8483431,Logan Cooley,C,UTA,20,82,14,14,28
12,8481477,Nico Sturm,C,SJS,29,82,14,14,28
12,8476878,Zemgus Girgensons,L,TBL,30,82,14,14,28
12,8470621,Corey Perry,R,EDM,39,82,13,15,28
12,8478569,Noel Acciari,C,PIT,33,82,12,16,28
12,8481032,Paul Cotter,C,NJD,25,82,11,17,28
12,8473533,Jordan Staal,C,CAR,36,82,10,18,28
12,8479353,Brett Howden,C,VGK,26,82,10,18,28
12,8481522,Peyton Krebs,C,BUF,23,82,9,19,28
12,8475220,Marcus Foligno,L,MIN,33,82,7,21,28
12,8474574,Tyler Myers,D,VAN,34,82,5,23,28
12,8477969,Marcus Pettersson,D,PIT,28,82,4,24,28
12,8478851,Alexandre Carrier,D,NSH,28,82,4,24,28
12,8474151,Ryan McDonagh,D,TBL,35,82,2,26,28
12,8480074,Alexandre Texier,C,STL,25,82,13,14,27
12,8480144,David Kampf,C,TOR,29,82,12,15,27
12,8476480,Vladislav Namestnikov,C,WPG,32,82,11,16,27
12,8477392,Hudson Fasching,R,NYI,29,82,11,16,27
12,8484153,Leo Carlsson,C,ANA,20,82,9,18,27
12,8480807,Mattias Samuelsson,D,BUF,24,82,9,18,27
12,8482122,Brock Faber,D,MIN,22,82,7,20,27
12,8477369,Carson Soucy,D,VAN,30,82,7,20,27
12,8478882,Vladislav Gavrikov,D,LAK,29,82,7,20,27
12,8482142,Jamie Drysdale,D,PHI,22,82,6,21,27
12,8478399,Jonas Siegenthaler,D,NJD,27,82,5,22,27
12,8475188,Brayden McNabb,D,VGK,33,82,4,23,27
12,8477488,Brett Pesce,D,NJD,30,82,2,25,27
12,8484145,Zach Benson,L,BUF,19,82,16,10,26
12,8482077,Dylan Holloway,L,EDM,23,82,14,12,26
12,8480789,Oliver Wahlstrom,R,NYI,24,82,13,13,26
12,8477353,Tyler Motte,C,DET,29,82,13,13,26
12,8476921,Jordan Martinook,L,CAR,32,82,12,14,26
12,8477505,Alexander Wennberg,C,SJS,30,82,11,15,26
12,8481553,Bobby Brink,R,PHI,23,82,10,16,26
12,8476624,Barclay Goodrow,C,SJS,31,82,8,18,26
12,8482624,Daniil Miromanov,D,CGY,27,82,7,19,26
12,8478911,Matt Roy,D,WSH,29,82,7,19,26
12,8480806,Isac Lundestrom,C,ANA,25,82,6,20,26
12,8476917,Adam Pelech,D,NYI,30,82,4,22,26
12,8476931,Jake McCabe,D,TOR,31,82,2,24,26
12,8477989,Christian Dvorak,C,MTL,28,82,14,11,25
12,8478508,Yakov Trenin,C,MIN,27,82,10,15,25
12,8480980,Connor Dewar,C,TOR,25,82,10,15,25
12,8475231,Casey Cizikas,C,NYI,33,82,10,15,25
12,8476467,Jamie Oleksiak,D,SEA,32,82,8,17,25
12,8476331,Dylan DeMelo,D,WPG,31,82,7,18,25
12,8480878,Nils Lundkvist,D,DAL,24,82,5,20,25
12,8478500,Ivan Provorov,D,CBJ,27,82,3,22,25
12,8480073,Erik Brannstrom,D,COL,25,82,2,23,25
12,8476429,Scott Mayfield,D,NYI,32,82,1,24,25
12,8481028,Martin Pospisil,C,CGY,25,82,13,11,24
12,8477425,Miles Wood,L,COL,29,82,7,17,24
12,8476312,Josh Manson,D,COL,33,82,7,17,24
12,8478136,Jake Middleton,D,MIN,28,82,7,17,24
12,8480246,Nick Perbix,D,TBL,26,82,6,18,24
12,8480222,Sebastian Aho,D,PIT,28,82,6,18,24
12,8480995,Pontus Holmberg,R,TOR,25,82,5,19,24
12,8476525,Colin Miller,D,WPG,32,82,4,20,24
12,8473507,Jeff Petry,D,DET,37,82,3,21,24
12,8481178,Egor Zamula,D,PHI,24,82,3,21,24
12,8476891,Matt Grzelcyk,D,PIT,30,82,2,22,24
12,8474715,Cam Atkinson,R,TBL,35,82,13,10,23
12,8476981,Josh Anderson,R,MTL,30,82,13,10,23
12,8481582,Nicholas Robertson,L,TOR,23,82,12,11,23
12,8479293,Brandon Tanev,L,SEA,33,82,10,13,23
12,8482762,Simon Edvinsson,D,DET,21,82,10,13,23
12,8479359,Beck Malenstyn,L,BUF,26,82,9,14,23
12,8483445,Cutter Gauthier,L,ANA,20,82,7,16,23
12,8482679,Matt Coronato,R,CGY,22,82,7,16,23
12,8483457,Lane Hutson,D,MTL,20,82,6,17,23
12,8477845,Trevor van Riemsdyk,D,WSH,33,82,6,17,23
12,8477220,Nate Schmidt,D,FLA,33,82,5,18,23
12,8476457,Adam Larsson,D,SEA,32,82,5,18,23
12,8479998,Mikey Anderson,D,LAK,25,82,5,18,23
12,8480796,Martin Fehervary,D,WSH,25,82,4,19,23
12,8482087,Kaiden Guhle,D,MTL,22,82,3,20,23
12,8475690,Chris Tanev,D,TOR,35,82,3,20,23
12,8476902,Esa Lindell,D,DAL,30,82,2,21,23
12,8480049,Dylan Samberg,D,WPG,25,82,1,22,23
12,8475842,Sam Carrick,C,NYR,32,82,13,9,22
12,8480855,Jack McBain,C,UTA,24,82,11,11,22
12,8482733,Logan Mailloux,D,MTL,31,82,10,12,22
12,8482749,Joshua Roy,R,MTL,21,82,10,12,22
12,8482809,Jackson Blake,R,CAR,21,82,10,12,22
12,8482141,Lukas Cormier,D,VGK,22,82,9,13,22
12,8483468,Jiri Kulich,C,BUF,20,82,9,13,22
12,8484911,Collin Graf,R,SJS,22,82,8,14,22
12,8477450,Jason Dickinson,C,CHI,29,82,6,16,22
12,8483495,Simon Nemec,D,NJD,20,82,6,16,22
12,8475279,Ben Chiarot,D,DET,33,82,4,18,22
12,8475462,Radko Gudas,D,ANA,34,82,2,20,22
12,8479393,Noah Gregor,C,OTT,26,82,13,8,21
12,8476858,Phillip Di Giuseppe,L,VAN,31,82,12,9,21
12,8480281,Alexey Toropchenko,R,STL,25,82,11,10,21
12,8482101,Danil Gushchin,L,SJS,22,82,9,12,21
12,8483524,Shane Wright,C,SEA,20,82,9,12,21
12,8482666,Scott Morrow,D,CAR,22,82,9,12,21
12,8482803,Olen Zellweger,D,ANA,21,82,9,12,21
12,8478432,Christian Fischer,R,DET,27,82,7,14,21
12,8483493,Frank Nazar,C,CHI,20,82,7,14,21
12,8479980,Nicolas Hague,D,VGK,26,82,5,16,21
12,8478468,Jeremy Lauzon,D,NSH,27,82,5,16,21
12,8476442,Matt Nieto,L,PIT,32,82,4,17,21
12,8480021,Jack Studnicka,C,LAK,25,82,4,17,21
12,8479371,Dante Fabbro,D,NSH,26,82,3,18,21
12,8475233,David Savard,D,MTL,34,82,0,21,21
12,8482074,Connor Zary,C,CGY,23,82,10,10,20
12,8479291,Kevin Rooney,C,CGY,31,82,9,11,20
12,8477839,Conor Sheary,L,TBL,32,82,7,13,20
12,8478211,Dryden Hunt,L,CGY,29,82,7,13,20
12,8478859,Niko Mikkola,D,FLA,28,82,7,13,20
12,8482125,Alexander Holtz,R,VGK,22,82,6,14,20
12,8481568,Alex Vlasic,D,CHI,23,82,6,14,20
12,8483490,Pavel Mintyukov,D,ANA,21,82,4,16,20
12,8480990,Declan Chisholm,D,MIN,24,82,4,16,20
12,8483565,Nick Blankenburg,D,NSH,26,82,2,18,20
12,8479324,Ryan Lindgren,D,NYR,26,82,1,19,20
12,8475790,Erik Gudbranson,D,CBJ,32,82,0,20,20
12,8481601,Simon Holmstrom,R,NYI,23,82,11,8,19
12,8479414,Nathan Bastian,R,NJD,27,82,11,8,19
12,8477931,Tomas Nosek,L,FLA,32,82,11,8,19
12,8476889,Radek Faksa,C,STL,30,82,10,9,19
12,8477508,Curtis Lazar,C,NJD,29,82,8,11,19
12,8478013,Jake Walman,D,SJS,28,82,7,12,19
12,8477365,Connor Clifton,D,BUF,29,82,6,13,19
12,8484149,Gavin Brindley,C,CBJ,20,82,5,14,19
12,8480025,MacKenzie Entwistle,R,FLA,25,82,5,14,19
12,8479402,Jake Bean,D,CGY,26,82,3,16,19
12,8481699,Aku Raty,R,UTA,23,82,3,16,19
12,8476967,Brett Kulak,D,EDM,30,82,2,17,19
12,8476879,Cody Ceci,D,EDM,31,82,2,17,19
12,8480035,Henri Jokiharju,D,BUF,25,82,1,18,19
12,8476441,Joel Edmundson,D,LAK,31,82,1,18,19
12,8482155,Alex Laferriere,R,LAK,23,82,12,6,18
12,8480068,Ryan Poehling,C,PHI,25,82,8,10,18
12,8476372,Nick Seeler,D,PHI,31,82,7,11,18
12,8477435,Ryan Graves,D,PIT,29,82,4,14,18
12,8478178,Darren Raddysh,D,TBL,28,82,4,14,18
12,8480172,Jan Rutta,D,SJS,34,82,4,14,18
12,8477499,Rasmus Ristolainen,D,PHI,30,82,4,14,18
12,8478840,Will Borgen,D,SEA,28,82,1,17,18
12,8482259,Bobby McMann,C,TOR,28,82,14,3,17
12,8478443,Brandon Carlo,D,BOS,28,82,8,9,17
12,8482702,Logan Stankoven,C,DAL,21,82,7,10,17
12,8482659,Josh Doan,R,UTA,22,82,7,10,17
12,8483482,Tristan Luneau,D,ANA,20,82,6,11,17
12,8482062,Cole Smith,L,NSH,29,82,6,11,17
12,8477938,Haydn Fleury,D,WPG,28,82,5,12,17
12,8477903,Garnet Hathaway,R,PHI,33,82,4,13,17
12,8481605,Jackson LaCombe,D,ANA,23,82,4,13,17
12,8475324,Nick Jensen,D,OTT,34,82,3,14,17
12,8470600,Ryan Suter,D,STL,39,82,3,14,17
12,8480879,Jacob Bernard-Docker,D,OTT,24,82,0,17,17
12,8476822,Luke Glendening,C,TBL,35,82,10,6,16
12,8478434,Keegan Kolesar,R,VGK,27,82,9,7,16
12,8482807,Ethan Del Mastro,D,CHI,21,82,8,8,16
12,8482166,Shakir Mukhamadullin,D,SJS,22,82,7,9,16
12,8476422,Mike Reilly,D,NYI,31,82,4,12,16
12,8482712,Oskar Olausson,R,COL,22,82,3,13,16
12,8482655,J.J. Moser,D,TBL,24,82,1,15,16
12,8479638,Justin Brazeau,R,BOS,26,82,11,4,15
12,8483763,Maksymilian Szuber,D,UTA,22,82,6,9,15
12,8479442,Troy Stecher,D,EDM,30,82,5,10,15
12,8481567,Henry Thrun,D,SJS,23,82,4,11,15
12,8475455,Brenden Dillon,D,NJD,34,82,4,11,15
12,8483499,Liam Ohgren,L,MIN,20,82,4,11,15
12,8479576,Vincent Desharnais,D,VAN,28,82,2,13,15
12,8477335,Kyle Burroughs,D,LAK,29,82,5,9,14
12,8481524,Bowen Byram,D,BUF,23,82,4,10,14
12,8481708,Zac Jones,D,NYR,24,82,4,10,14
12,8482153,Brendan Brisson,C,VGK,23,82,4,10,14
12,8475762,Derek Forbort,D,VAN,32,82,3,11,14
12,8482858,Ryker Evans,D,SEA,23,82,3,11,14
12,8480834,Ty Emberson,D,SJS,24,82,1,13,14
12,8482145,Mavrik Bourque,C,DAL,22,82,6,7,13
12,8483466,Kevin Korchinski,D,CHI,20,82,6,7,13
12,8482859,Zack Ostapchuk,C,OTT,21,82,3,10,13
12,8471677,Jack Johnson,D,CBJ,37,82,3,10,13
12,8483460,David Jiricek,D,CBJ,21,82,3,10,13
12,8474612,Travis Hamonic,D,OTT,34,82,0,13,13
12,8483567,Georgii Merkulov,C,BOS,24,82,7,5,12
12,8482516,Matthew Kessel,D,STL,24,82,4,8,12
12,8483489,Fraser Minten,C,TOR,31,82,2,10,12
12,8474567,Zach Bogosian,D,MIN,34,82,1,11,12
12,8477034,Jaycob Megna,D,FLA,32,82,1,11,12
12,8483505,Matthew Poitras,C,BOS,20,82,6,5,11
12,8481641,Joel Kiviranta,L,COL,28,82,4,7,11
12,8482470,Ilya Solovyov,D,CGY,24,82,3,8,11
12,8478450,Parker Wotherspoon,D,BOS,27,82,2,9,11
12,8475718,Justin Holl,D,DET,32,82,2,9,11
12,8480950,Ilya Lyubushkin,D,DAL,30,82,2,9,11
12,8483397,Marc McLaughlin,C,BOS,25,82,6,4,10
12,8473453,Trevor Lewis,C,LAK,37,82,5,5,10
12,8482713,Mackie Samoskevich,R,FLA,22,82,5,5,10
12,8475177,Calvin de Haan,D,COL,33,82,3,7,10
12,8476473,Connor Murphy,D,CHI,31,82,2,8,10
12,8478874,Adam Gaudette,C,OTT,28,82,0,10,10
12,8483471,Brad Lambert,C,WPG,31,82,6,3,9
12,8480870,Bo Groulx,C,NYR,24,82,3,6,9
12,8482118,Sam Colangelo,R,ANA,23,82,2,6,8
12,8482787,Nikita Chibrikov,R,WPG,31,82,0,8,8
12,8474090,Brendan Smith,D,DAL,35,82,0,8,8
12,8474013,Ian Cole,D,UTA,35,82,0,7,7
12,8483012,Logan Morrison,C,SEA,22,82,4,2,6
12,8481122,Simon Benoit,D,TOR,26,82,2,4,6
12,8474062,Riley Nash,C,NYR,35,82,2,3,5
12,8482070,Mitchell Chaffee,R,TBL,26,82,2,1,3
12,8470794,Joe Pavelski,C,,40,0,0,0,0
12,8481703,Valtteri Puustinen,R,PIT,25,0,0,0,0
12,8477950,Tony DeAngelo,D,,29,0,0,0,0
12,8481577,Philip Tomasino,C,NSH,23,0,0,0,0
12,8475197,Tyson Barrie,D,,33,0,0,0,0
12,8471218,Blake Wheeler,R,,38,0,0,0,0
12,8474157,Max Pacioretty,L,,36,0,0,0,0
12,8478466,Daniel Sprong,R,VAN,27,0,0,0,0
12,8475744,Evgeny Kuznetsov,C,,32,0,0,0,0
12,8481019,David Gustafsson,C,WPG,24,0,0,0,0
12,8475906,John Klingberg,D,,32,0,0,0,0
12,8479348,Kale Clague,D,BUF,26,0,0,0,0
12,8476952,Dominic Toninato,C,WPG,30,0,0,0,0
12,8473473,Milan Lucic,L,,36,0,0,0,0
12,8474037,James van Riemsdyk,L,,35,0,0,0,0
12,8474602,Justin Schultz,D,,34,0,0,0,0
12,8482222,Alexander Barabanov,L,,30,0,0,0,0
12,8479372,Josh Mahura,D,SEA,26,0,0,0,0
12,8479982,Conor Timmins,D,TOR,26,0,0,0,0
12,8474031,Kevin Shattenkirk,D,,35,0,0,0,0
12,8480008,Adam Ruzicka,C,,25,0,0,0,0
12,8481059,Scott Perunovich,D,STL,26,0,0,0,0
12,8480884,Calen Addison,D,,24,0,0,0,0
12,8476994,Vinnie Hinostroza,C,NSH,30,0,0,0,0
12,8478452,Caleb Jones,D,LAK,27,0,0,0,0
12,8480157,Calle Rosen,D,COL,30,0,0,0,0
12,8481609,Vladislav Kolyachonok,D,UTA,23,0,0,0,0
12,8479415,Michael McLeod,C,,26,0,0,0,0
12,8476919,Chris Tierney,C,,30,0,0,0,0
12,8479639,Dylan Coghlan,D,WPG,26,0,0,0,0
12,8478146,Matthew Highmore,C,OTT,28,0,0,0,0
12,8478970,Jalen Chatfield,D,CAR,28,0,0,0,0
12,8480205,Emil Bemstrom,C,PIT,25,0,0,0,0
12,8474884,Mike Hoffman,C,,35,0,0,0,0
12,8471274,Alex Goligoski,D,,39,0,0,0,0
12,8478104,Sammy Blais,L,,28,0,0,0,0
12,8474870,Tyler Johnson,C,,34,0,0,0,0
12,8476913,Devin Shore,C,MIN,30,0,0,0,0
12,8481598,Philip Broberg,D,EDM,23,0,0,0,0
12,8480058,Pierre-Olivier Joseph,D,STL,25,0,0,0,0
12,8480891,Michael Kesselring,D,UTA,24,0,0,0,0
12,8477979,Nicolas Aube-Kubel,R,BUF,28,0,0,0,0
12,8476871,Tanner Pearson,L,,32,0,0,0,0
12,8476393,Nick Cousins,C,,31,0,0,0,0
12,8479977,Kailer Yamamoto,R,,26,0,0,0,0
12,8479543,Michael Pezzetta,L,MTL,26,0,0,0,0
12,8477018,Ben Hutton,D,VGK,31,0,0,0,0
12,8480762,Eric Robinson,L,CAR,29,0,0,0,0
12,8474034,Pat Maroon,L,CHI,36,0,0,0,0
12,8481058,Jesse Ylönen,R,,25,0,0,0,0
12,8475179,Dmitry Kulikov,D,FLA,34,0,0,0,0
12,8481527,Kaedan Korczak,D,VGK,23,0,0,0,0
12,8473449,Kyle Okposo,R,,36,0,0,0,0
12,8482192,Isaak Phillips,D,CHI,23,0,0,0,0
12,8480727,Zach Whitecloud,D,VGK,28,0,0,0,0
12,8479346,Dillon Dube,C,,26,0,0,0,0
12,8480821,Filip Zadina,R,,25,0,0,0,0
12,8480001,Urho Vaakanainen,D,ANA,25,0,0,0,0
12,8470966,Mark Giordano,D,,41,0,0,0,0
12,8480853,Liam Foudy,C,,24,0,0,0,0
12,8475225,Craig Smith,C,CHI,35,0,0,0,0
12,8479972,Mason Shaw,C,WPG,26,0,0,0,0
12,8478451,Ethan Bear,D,WSH,27,0,0,0,0
12,8474040,Sam Gagner,C,,35,0,0,0,0
12,8480196,Jacob Bryson,D,BUF,27,0,0,0,0
12,8479984,Cal Foote,D,,26,0,0,0,0
12,8480011,Klim Kostin,C,SJS,25,0,0,0,0
12,8482176,Wyatt Kaiser,D,CHI,22,0,0,0,0
12,8476988,Matt Benning,D,SJS,30,0,0,0,0
12,8479370,Tyson Jost,C,CAR,26,0,0,0,0
12,8477464,Nic Petan,C,,29,0,0,0,0
12,8477380,Jonny Brodzinski,C,NYR,31,0,0,0,0
12,8480070,Ian Mitchell,D,BOS,25,0,0,0,0
12,8479315,Joey Anderson,R,CHI,26,0,0,0,0
12,8478099,Kevin Labanc,R,,29,0,0,0,0
12,8476874,Olli Maatta,D,DET,30,0,0,0,0
12,8475208,Brian Dumoulin,D,ANA,33,0,0,0,0
12,8478430,Oliver Kylington,D,,27,0,0,0,0
12,8479536,Axel Jonsson-Fjallby,L,WPG,26,0,0,0,0
12,8479671,Mathieu Olivier,R,CBJ,27,0,0,0,0
12,8471709,Marc-Edouard Vlasic,D,SJS,37,0,0,0,0
12,8479328,Julien Gauthier,R,NYI,27,0,0,0,0
12,8478421,A.J. Greer,L,FLA,28,0,0,0,0
12,8477573,Nathan Walker,L,STL,30,0,0,0,0
12,8481537,Nikita Okhotiuk,D,CGY,24,0,0,0,0
12,8474166,Alec Martinez,D,CHI,37,0,0,0,0
12,8470610,Zach Parise,L,,40,0,0,0,0
12,8477478,William Carrier,L,CAR,30,0,0,0,0
12,8479344,Jesse Puljujarvi,R,PIT,26,0,0,0,0
12,8480887,Jordan Harris,D,MTL,24,0,0,0,0
12,8478502,Dennis Gilbert,D,BUF,28,0,0,0,0
12,8482730,Brandt Clarke,D,LAK,21,0,0,0,0
12,8480355,Mark Kastelic,C,BOS,25,0,0,0,0
12,8475750,Jon Merrill,D,MIN,32,0,0,0,0
12,8475164,Jakob Silfverberg,R,,34,0,0,0,0
12,8477944,Jakub Vrana,L,,28,0,0,0,0
12,8479439,Jacob MacDonald,D,COL,31,0,0,0,0
12,8474568,Luke Schenn,D,NSH,35,0,0,0,0
12,8478454,Noah Juulsen,D,VAN,27,0,0,0,0
12,8475752,Tyler Pitlick,C,,33,0,0,0,0
12,8482148,Hendrix Lapierre,C,WSH,22,0,0,0,0
12,8481167,Brayden Pachal,D,CGY,25,0,0,0,0
12,8478043,Sam Lafferty,C,BUF,29,0,0,0,0
12,8479321,Lucas Johansen,D,,27,0,0,0,0
12,8471699,Andrew Cogliano,C,,37,0,0,0,0
12,8481521,Ronnie Attard,D,PHI,25,0,0,0,0
12,8481161,Jake Christiansen,D,CBJ,25,0,0,0,0
12,8479458,Nikita Zaitsev,D,,33,0,0,0,0
12,8479619,Michael Carcone,L,UTA,28,0,0,0,0
12,8479026,Philippe Myers,D,TOR,27,0,0,0,0
12,8477330,Dominik Kubalik,L,,29,0,0,0,0
12,8481617,Vasily Podkolzin,R,VAN,23,0,0,0,0
12,8481701,Santeri Hatakka,D,NJD,23,0,0,0,0
12,8479514,Rem Pitlick,C,,27,0,0,0,0
12,8477446,Michael McCarron,R,NSH,29,0,0,0,0
12,8470604,Jeff Carter,C,,39,0,0,0,0
12,8482241,Radim Zohorna,L,,28,0,0,0,0
12,8480289,Morgan Barron,C,WPG,26,0,0,0,0
12,8479379,Givani Smith,R,SJS,26,0,0,0,0
12,8480216,Jacob Peterson,C,,25,0,0,0,0
12,8477851,Jordan Oesterle,D,BOS,32,0,0,0,0
12,8484258,Sam Malinski,D,COL,26,0,0,0,0
12,8478904,Steven Lorentz,C,,28,0,0,0,0
12,8482095,Tyler Kleven,D,OTT,22,0,0,0,0
12,8480848,Ty Dellandrea,C,SJS,24,0,0,0,0
12,8476884,Derrick Pouliot,D,,30,0,0,0,0
12,8479336,Carl Grundstrom,R,SJS,27,0,0,0,0
12,8482964,Arber Xhekaj,D,MTL,23,0,0,0,0
12,8471686,Marc Staal,D,,37,0,0,0,0
12,8477887,Patrick Brown,C,BOS,32,0,0,0,0
12,8478495,Denis Gurianov,R,,27,0,0,0,0
12,8473504,Cal Clutterbuck,R,,37,0,0,0,0
12,8481550,Adam Beckman,L,NJD,23,0,0,0,0
12,8480845,Rasmus Kupari,C,WPG,24,0,0,0,0
12,8474009,Nick Bonino,C,,36,0,0,0,0
12,8478585,Derek Ryan,C,EDM,38,0,0,0,0
12,8477962,Brendan Lemieux,L,CAR,28,0,0,0,0
12,8482861,Vincent Iorio,D,WSH,22,0,0,0,0
12,8479378,Logan Stanley,D,WPG,26,0,0,0,0
12,8473446,Erik Johnson,D,PHI,36,0,0,0,0
12,8481743,Marc Del Gaizo,D,NSH,25,0,0,0,0
12,8477384,Josh Brown,D,EDM,30,0,0,0,0
12,8482165,Yan Kuznetsov,D,CGY,22,0,0,0,0
12,8478424,Jansen Harkins,C,ANA,27,0,0,0,0
12,8482144,Jack Thompson,D,SJS,22,0,0,0,0
12,8478512,Austin Czarnik,C,,32,0,0,0,0
12,8477527,Ross Johnston,L,ANA,30,0,0,0,0
12,8479383,Boris Katchouk,L,,26,0,0,0,0
12,8482094,Daemon Hunt,D,MIN,22,0,0,0,0
12,8481719,Maxwell Crozier,D,TBL,24,0,0,0,0
12,8480192,Johnathan Kovacevic,D,NJD,27,0,0,0,0
12,8479376,Victor Mete,D,,26,0,0,0,0
12,8482511,Mason Lohrei,D,BOS,23,0,0,0,0
12,8475825,Jani Hakanpää,D,,32,0,0,0,0
12,8478021,William Lagesson,D,DET,28,0,0,0,0
12,8475795,Dylan McIlrath,D,WSH,32,0,0,0,0
12,8477846,Ryan Carpenter,C,,33,0,0,0,0
12,8481056,Spencer Stastney,D,NSH,24,0,0,0,0
12,8481564,Ryan Johnson,D,BUF,23,0,0,0,0
12,8478017,Mark Friedman,D,VAN,29,0,0,0,0
12,8479320,Max Lajoie,D,SEA,27,0,0,0,0
12,8480075,Cameron Crotty,D,MIN,25,0,0,0,0
12,8484287,Cole McWard,D,VAN,23,0,0,0,0
12,8484254,Akito Hirose,D,VAN,25,0,0,0,0
12,8483407,Brandon Scanlin,D,NYR,25,0,0,0,0
12,8480274,Philip Kemp,D,EDM,25,0,0,0,0
12,8479522,Hardy Haman Aktell,D,WSH,26,0,0,0,0
12,8480007,Jonas Rondbjerg,R,VGK,25,0,0,0,0
12,8477454,Adam Erne,L,,29,0,0,0,0
12,8481679,Maxence Guenette,D,OTT,23,0,0,0,0
12,8480441,Trey Fix-Wolansky,R,CBJ,25,0,0,0,0
12,8483546,Marshall Rifai,D,TOR,26,0,0,0,0
12,8480084,Nick DeSimone,D,NJD,30,0,0,0,0
12,8481030,Jack St. Ivany,D,PIT,25,0,0,0,0
12,8481592,Jakob Pelletier,L,CGY,23,0,0,0,0
12,8478011,Louie Belpedio,D,PHI,28,0,0,0,0
12,8477930,Pierre-Edouard Bellemare,L,,39,0,0,0,0
12,8484321,Nikolas Matinpalo,D,OTT,26,0,0,0,0
12,8482067,Connor Mackey,D,NYR,28,0,0,0,0
12,8481806,Louis Crevier,D,CHI,23,0,0,0,0
12,8484326,Patrik Koch,D,UTA,28,0,0,0,0
12,8477971,Andreas Englund,D,LAK,28,0,0,0,0
12,8481751,Lukas Rousek,R,BUF,25,0,0,0,0
12,8481006,Tyler Tucker,D,STL,24,0,0,0,0
12,8476867,Brendan Gaunce,C,MIN,30,0,0,0,0
12,8479520,Brandon Duhaime,R,WSH,27,0,0,0,0
12,8477073,Kurtis MacDermid,L,NJD,30,0,0,0,0
12,8480874,Adam Ginning,D,PHI,24,0,0,0,0
12,8477473,Justin Bailey,R,SJS,29,0,0,0,0
12,8479066,Ryan Lomberg,L,CGY,30,0,0,0,0
12,8477070,Liam O'Brien,C,UTA,30,0,0,0,0
12,8474618,Marco Scandella,D,,34,0,0,0,0
12,8475797,Jarred Tinordi,D,,32,0,0,0,0
12,8481441,Joe Snively,C,DET,28,0,0,0,0
12,8477244,Chad Ruhwedel,D,NYR,34,0,0,0,0
12,8479772,Zack MacEwen,R,OTT,28,0,0,0,0
12,8481147,Reese Johnson,C,MIN,26,0,0,0,0
12,8481043,Cole Koepke,L,BOS,26,0,0,0,0
12,8483619,Filip Roos,D,OTT,25,0,0,0,0
12,8481541,Samuel Bolduc,D,NYI,24,0,0,0,0
12,8477810,Joel Hanley,D,CGY,33,0,0,0,0
12,8476907,Mackenzie MacEachern,L,,30,0,0,0,0
12,8482652,Walker Duehr,R,CGY,27,0,0,0,0
12,8477126,Jayson Megna,C,,34,0,0,0,0
12,8483398,Declan Carlile,D,TBL,31,0,0,0,0
12,8482929,Emil Lilleberg,D,TBL,23,0,0,0,0
12,8480880,Jakub Lauko,C,MIN,24,0,0,0,0
12,8480245,Olle Lycksell,R,PHI,25,0,0,0,0
12,8480252,Cole Guttman,C,CHI,25,0,0,0,0
12,8477467,Gustav Olofsson,D,SEA,30,0,0,0,0
12,8479968,Vinni Lettieri,C,BOS,29,0,0,0,0
12,8478400,Colin White,C,,27,0,0,0,0
12,8475755,Alexander Petrovic,D,DAL,32,0,0,0,0
12,8481812,Nikolai Knyzhov,D,,27,0,0,0,0
12,8481593,Jayden Struble,D,MTL,23,0,0,0,0
12,8481532,Alex Turcotte,C,LAK,23,0,0,0,0
12,8482126,Emil Andrae,D,PHI,31,0,0,0,0
12,8479944,Zach Aston-Reese,C,VGK,30,0,0,0,0
12,8471817,Ryan Reaves,R,TOR,37,0,0,0,0
12,8481206,John Ludvig,D,PIT,24,0,0,0,0
12,8481599,Victor Soderstrom,D,UTA,23,0,0,0,0
12,8480292,Carson Meyer,R,ANA,27,0,0,0,0
12,8482496,Nils Aman,C,VAN,24,0,0,0,0
12,8479718,Alex Barré-Boulet,C,MTL,27,0,0,0,0
12,8479994,Jaret Anderson-Dolan,C,WPG,25,0,0,0,0
12,8480184,Gustav Lindstrom,D,,26,0,0,0,0
12,8480890,Jan Jenik,R,OTT,24,0,0,0,0
12,8478067,Oskar Lindblom,L,,28,0,0,0,0
12,8476934,Brock McGinn,L,ANA,30,0,0,0,0
12,8479985,Cale Fleury,D,SEA,26,0,0,0,0
12,8484304,Uvis Balinskis,D,FLA,28,0,0,0,0
12,8479981,Jonah Gadjovich,L,FLA,26,0,0,0,0
12,8481716,Dmitri Voronkov,L,CBJ,24,0,0,0,0
12,8474709,Matt Martin,L,,35,0,0,0,0
12,8482634,Alex Steeves,C,TOR,25,0,0,0,0
12,8480823,Alexander Alexeyev,D,WSH,25,0,0,0,0
12,8477541,Dakota Mermis,D,TOR,30,0,0,0,0
12,8483491,Ivan Miroshnichenko,L,WSH,20,0,0,0,0
12,8478477,Mitchell Stephens,C,SEA,27,0,0,0,0
12,8481543,Nikita Alexandrov,C,STL,24,0,0,0,0
12,8479423,Alex Nylander,L,,26,0,0,0,0
12,8482451,Mikael Pyyhtia,L,CBJ,23,0,0,0,0
12,8478831,Kevin Stenlund,C,UTA,28,0,0,0,0
12,8480306,Grant Hutton,D,NYI,29,0,0,0,0
12,8478028,Fredrik Olofsson,L,,28,0,0,0,0
12,8477462,Robert Hagg,D,VGK,29,0,0,0,0
12,8477320,Anton Blidh,L,NYR,29,0,0,0,0
12,8482157,Will Cuylle,L,NYR,22,0,0,0,0
12,8482737,Zack Bolduc,C,STL,21,0,0,0,0
12,8481239,Samuel Fagemo,L,,24,0,0,0,0
12,8481600,Tobias Bjornfot,D,FLA,23,0,0,0,0
12,8478409,Anthony Richard,C,PHI,28,0,0,0,0
12,8474145,Robert Bortuzzo,D,,35,0,0,0,0
12,8475958,Michael Sgarbossa,C,WSH,32,0,0,0,0
12,8479986,Kole Lind,R,DAL,26,0,0,0,0
12,8479249,Andrew Poturalski,C,SJS,30,0,0,0,0
12,8479362,Riley Tufte,L,BOS,26,0,0,0,0
12,8479991,Jake Leschyshyn,C,NYR,25,0,0,0,0
12,8479587,Rhett Gardner,C,PHI,28,0,0,0,0
12,8482744,James Malatesta,L,CBJ,21,0,0,0,0
12,8478854,Ryan Shea,D,PIT,27,0,0,0,0
12,8481591,Sam Poulin,R,,23,0,0,0,0
12,8483512,Matt Savoie,C,EDM,20,0,0,0,0
12,8482102,Vasily Ponomarev,C,PIT,22,0,0,0,0
12,8482162,Roby Jarventie,L,EDM,22,0,0,0,0
12,8481016,Ruslan Iskhakov,C,,24,0,0,0,0
12,8482172,Landon Slaggert,L,CHI,22,0,0,0,0
12,8482747,Brennan Othmann,L,NYR,21,0,0,0,0
12,8480031,Maxime Comtois,L,,25,0,0,0,0
12,8480226,Marián Studenic,R,,26,0,0,0,0
12,8478408,Travis Dermott,D,,28,0,0,0,0
12,8481518,Nolan Foote,L,NJD,24,0,0,0,0
12,8479419,Brett Murray,L,BUF,26,0,0,0,0
12,8482088,Justin Sourdif,R,FLA,22,0,0,0,0
12,8482201,Gage Goncalves,C,TBL,23,0,0,0,0
12,8481578,Graeme Clarke,R,MIN,23,0,0,0,0
12,8482177,Marat Khusnutdinov,C,MIN,22,0,0,0,0
12,8481754,Nikita Nesterenko,C,ANA,23,0,0,0,0
12,8483531,Brian Halonen,L,NJD,25,0,0,0,0
12,8483920,Pierrick Dube,R,WSH,23,0,0,0,0
12,8480851,Akil Thomas,C,LAK,24,0,0,0,0
12,8475235,Nicolas Deslauriers,L,PHI,33,0,0,0,0
12,8482476,Emil Heineman,L,MTL,23,0,0,0,0
12,8477149,Scott Sabourin,R,SJS,32,0,0,0,0
12,8483549,Lucas Condotta,L,MTL,27,0,0,0,0
12,8482765,Isak Rosen,R,BUF,21,0,0,0,0
12,8481237,Kyle MacLean,C,NYI,25,0,0,0,0
12,8481024,Linus Karlsson,C,VAN,25,0,0,0,0
12,8481690,Tyler Angle,C,,24,0,0,0,0
12,8483570,Ben Meyers,C,SEA,26,0,0,0,0
12,8481655,Cole Schwindt,R,CGY,23,0,0,0,0
12,8481462,Mason Morelli,L,VGK,28,0,0,0,0
12,8483401,Marc Johnstone,R,PIT,28,0,0,0,0
12,8478956,Samuel Laberge,L,NJD,27,0,0,0,0
12,8479533,Joona Koppanen,L,,26,0,0,0,0
12,8482197,Adam Raska,R,MIN,23,0,0,0,0
12,8482250,Callahan Burke,C,VGK,27,0,0,0,0
12,8482784,Zach Dean,C,STL,21,0,0,0,0
12,8484255,Jason Polin,R,COL,25,0,0,0,0
12,8481077,John Leonard,L,,26,0,0,0,0
12,8481534,Raphael Lavoie,C,EDM,24,0,0,0,0
12,8483609,Adam Klapka,R,CGY,24,0,0,0,0
12,8482751,Ryan Winterton,C,SEA,21,0,0,0,0
12,8480267,Sammy Walker,C,MIN,25,0,0,0,0
12,8475766,Austin Watson,L,,32,0,0,0,0
12,8482460,Matt Rempe,C,NYR,22,0,0,0,0
12,8481065,Angus Crookshank,L,OTT,25,0,0,0,0
12,8481070,Hugh McGing,L,,26,0,0,0,0
12,8476323,Max McCormick,L,SEA,32,0,0,0,0
12,8483395,Arshdeep Bains,L,VAN,23,0,0,0,0
12,8484259,Ondrej Pavel,C,COL,31,0,0,0,0
12,8483432,Luca Del Bel Belluz,C,CBJ,31,0,0,0,0
12,8483045,Cameron Butler,R,CBJ,31,0,0,0,0
12,8482061,Brandon Biro,L,SEA,26,0,0,0,0
12,8477401,John Hayden,C,SEA,29,0,0,0,0
12,8475278,Byron Froese,C,,33,0,0,0,0
12,8478446,Glenn Gawdin,C,LAK,27,0,0,0,0
12,8477993,Justin Kirkland,C,CGY,28,0,0,0,0
12,8482147,Jean-Luc Foudy,C,COL,22,0,0,0,0
12,8480032,Shane Bowers,C,NJD,25,0,0,0,0
12,8479330,Brandon Gignac,C,MTL,27,0,0,0,0
12,8480776,Sheldon Rempal,R,,29,0,0,0,0
12,8475413,Justin Dowling,C,NJD,34,0,0,0,0
12,8481726,Adam Edstrom,C,NYR,24,0,0,0,0
12,8480844,Grigori Denisenko,L,VGK,24,0,0,0,0
12,8478147,Bokondji Imama,L,PIT,28,0,0,0,0
12,8478881,Brett Seney,L,CHI,28,0,0,0,0
12,8483630,Pavol Regenda,L,ANA,25,0,0,0,0
12,8480836,Jonathan Gruden,C,,24,0,0,0,0
12,8484314,Jiri Smejkal,L,,28,0,0,0,0
12,8475780,Chris Wagner,R,COL,33,0,0,0,0
12,8479546,Oskar Steen,C,,26,0,0,0,0
12,8483597,Milos Kelemen,L,UTA,25,0,0,0,0
12,8481789,Tye Kartye,L,SEA,23,0,0,0,0
12,8484325,Waltteri Merela,C,TBL,26,0,0,0,0
12,8479421,Jacob Moverare,D,LAK,26,0,0,0,0
12,8481585,Egor Afanasyev,L,SJS,23,0,0,0,0
12,8479547,Matthew Phillips,R,,26,0,0,0,0
12,8479367,William Lockwood,R,FLA,26,0,0,0,0
12,8476915,Jujhar Khaira,L,,30,0,0,0,0
12,8481422,Jacob Lucchini,C,NSH,29,0,0,0,0
12,8480468,James Hamblin,L,EDM,25,0,0,0,0
12,8478051,Max Willman,C,NJD,29,0,0,0,0
12,8481556,John Beecher,C,BOS,23,0,0,0,0
12,8478078,Rourke Chartier,C,,28,0,0,0,0
13,8479318,Auston Matthews,C,TOR,27,82,72,61,133
13,8478402,Connor McDavid,C,EDM,27,82,38,90,128
13,8481559,Jack Hughes,C,NJD,23,82,53,65,118
13,8476453,Nikita Kucherov,R,TBL,31,82,36,77,113
13,8478864,Kirill Kaprizov,L,MIN,27,82,48,64,112
13,8478550,Artemi Panarin,L,NYR,33,82,35,75,110
13,8477939,William Nylander,R,TOR,28,82,36,73,109
13,8477492,Nathan MacKinnon,C,COL,29,82,39,69,108
13,8476887,Filip Forsberg,L,NSH,30,82,55,52,107
13,8480012,Elias Pettersson,C,VAN,26,82,39,67,106
13,8481557,Matt Boldy,L,MIN,23,82,51,54,105
13,8477946,Dylan Larkin,C,DET,28,82,52,52,104
13,8477409,Carter Verhaeghe,C,FLA,29,82,44,60,104
13,8476468,J.T. Miller,C,VAN,31,82,34,70,104
13,8478427,Sebastian Aho,C,CAR,27,82,46,57,103
13,8477934,Leon Draisaitl,C,EDM,29,82,45,57,102
13,8480002,Nico Hischier,C,NJD,25,82,43,59,102
13,8479314,Matthew Tkachuk,L,FLA,27,82,35,65,100
13,8477956,David Pastrnak,R,BOS,28,82,43,56,99
13,8475765,Vladimir Tarasenko,R,DET,33,82,40,59,99
13,8474141,Patrick Kane,R,DET,36,82,37,62,99
13,8480800,Quinn Hughes,D,VAN,25,82,19,79,98
13,8478420,Mikko Rantanen,R,COL,28,82,43,54,97
13,8477493,Aleksander Barkov,C,FLA,29,82,29,66,95
13,8482116,Tim Stützle,C,OTT,22,82,29,65,94
13,8479323,Adam Fox,D,NYR,26,82,20,73,93
13,8471675,Sidney Crosby,C,PIT,37,82,41,50,91
13,8479337,Alex DeBrincat,R,DET,27,82,35,56,91
13,8480036,Miro Heiskanen,D,DAL,25,82,19,72,91
13,8474564,Steven Stamkos,C,NSH,34,82,32,58,90
13,8478449,Roope Hintz,C,DAL,28,82,48,41,89
13,8480801,Brady Tkachuk,L,OTT,25,82,45,44,89
13,8475692,Mats Zuccarello,R,MIN,37,82,22,67,89
13,8480027,Jason Robertson,L,DAL,25,82,36,52,88
13,8471215,Evgeni Malkin,C,PIT,38,82,29,59,88
13,8477960,Adrian Kempe,R,LAK,28,82,39,48,87
13,8480830,Andrei Svechnikov,R,CAR,24,82,37,48,85
13,8475913,Mark Stone,R,VGK,32,82,32,53,85
13,8480023,Robert Thomas,C,STL,25,82,24,61,85
13,8478445,Mathew Barzal,C,NYI,27,82,13,72,85
13,8477942,Kevin Fiala,L,LAK,28,82,37,47,84
13,8475172,Nazem Kadri,C,CGY,34,82,30,54,84
13,8475166,John Tavares,C,TOR,34,82,42,41,83
13,8478398,Kyle Connor,L,WPG,28,82,36,47,83
13,8476459,Mika Zibanejad,C,NYR,31,82,27,56,83
13,8480069,Cale Makar,D,COL,26,82,20,63,83
13,8480803,Evan Bouchard,D,EDM,25,82,17,66,83
13,8481523,Kirby Dach,C,MTL,23,82,13,70,83
13,8475184,Chris Kreider,L,NYR,33,82,55,27,82
13,8478403,Jack Eichel,C,VGK,28,82,42,40,82
13,8476346,Johnny Gaudreau,L,CBJ,31,82,28,54,82
13,8476456,Jonathan Huberdeau,C,CGY,31,82,24,58,82
13,8477933,Sam Reinhart,C,FLA,29,82,42,39,81
13,8479385,Jordan Kyrou,C,STL,26,82,36,45,81
13,8478444,Brock Boeser,R,VAN,27,82,35,46,81
13,8478414,Timo Meier,R,NJD,28,82,34,47,81
13,8474600,Roman Josi,D,NSH,34,82,13,68,81
13,8476454,Ryan Nugent-Hopkins,C,EDM,31,82,30,50,80
13,8471214,Alex Ovechkin,L,WSH,39,82,45,34,79
13,8478439,Travis Konecny,R,PHI,27,82,36,43,79
13,8475158,Ryan O'Reilly,C,NSH,33,82,30,49,79
13,8478010,Brayden Point,C,TBL,28,82,40,37,77
13,8482078,Lucas Raymond,L,DET,22,82,32,45,77
13,8474679,Gustav Nyquist,C,NSH,35,82,24,52,76
13,8471685,Anze Kopitar,C,LAK,37,82,27,48,75
13,8479343,Clayton Keller,R,UTA,26,82,29,45,74
13,8477402,Pavel Buchnevich,L,STL,29,82,34,39,73
13,8474578,Erik Karlsson,D,PIT,34,82,21,52,73
13,8478366,Frank Vatrano,R,ANA,30,82,39,33,72
13,8476460,Mark Scheifele,C,WPG,31,82,35,37,72
13,8479420,Tage Thompson,C,BUF,27,82,34,38,72
13,8478440,Dylan Strome,C,WSH,27,82,26,46,72
13,8477501,Valeri Nichushkin,R,COL,29,82,40,31,71
13,8478042,Viktor Arvidsson,R,EDM,31,82,26,45,71
13,8475168,Matt Duchene,C,DAL,33,82,22,49,71
13,8475786,Zach Hyman,L,EDM,32,82,38,32,70
13,8477951,Nick Schmaltz,C,UTA,28,82,33,37,70
13,8477404,Jake Guentzel,C,TBL,30,82,32,38,70
13,8479407,Jesper Bratt,L,NJD,26,82,29,41,70
13,8480208,Drake Batherson,R,OTT,26,82,22,48,70
13,8477346,MacKenzie Weegar,D,CGY,30,82,20,50,70
13,8481528,Dylan Cozens,C,BUF,23,82,31,38,69
13,8474150,Mikael Backlund,C,CGY,35,82,19,50,69
13,8476881,Tomas Hertl,C,VGK,31,82,33,35,68
13,8478873,Troy Terry,R,ANA,27,82,25,43,68
13,8476389,Vincent Trocheck,C,NYR,31,82,23,45,68
13,8477447,Shea Theodore,D,VGK,29,82,13,55,68
13,8478460,Zach Werenski,D,CBJ,27,82,12,56,68
13,8476539,Jonathan Marchessault,R,NSH,34,82,31,36,67
13,8477949,Alex Tuch,R,BUF,28,82,28,39,67
13,8475794,Tyler Seguin,C,DAL,32,82,27,40,67
13,8477504,Josh Morrissey,D,WPG,29,82,9,58,67
13,8477500,Bo Horvat,C,NYI,29,82,36,30,66
13,8475798,Mikael Granlund,C,SJS,32,82,14,52,66
13,8480014,Gabriel Vilardi,C,WPG,25,82,40,25,65
13,8481596,Shane Pinto,C,OTT,24,82,22,42,64
13,8476882,Teuvo Teravainen,L,CHI,30,82,21,43,64
13,8477964,Ivan Barbashev,C,VGK,29,82,20,44,64
13,8476432,Boone Jenner,C,CBJ,31,82,34,29,63
13,8476448,William Karlsson,C,VGK,31,82,33,30,63
13,8477986,Brandon Montour,D,SEA,30,82,29,34,63
13,8482093,Seth Jarvis,C,CAR,22,82,28,35,63
13,8479339,Patrik Laine,L,CBJ,26,82,28,35,63
13,8479675,Trevor Moore,L,LAK,29,82,27,36,63
13,8478493,Joel Eriksson Ek,C,MIN,27,82,27,36,63
13,8480039,Martin Necas,C,CAR,25,82,26,37,63
13,8475726,Tyler Toffoli,C,SJS,32,82,25,38,63
13,8477456,J.T. Compher,L,DET,29,82,25,38,63
13,8473512,Claude Giroux,R,OTT,36,82,27,35,62
13,8473419,Brad Marchand,L,BOS,36,82,21,41,62
13,8475170,Brayden Schenn,C,STL,33,82,21,41,62
13,8475754,Brock Nelson,C,NYI,33,82,32,29,61
13,8475784,Jeff Skinner,C,EDM,32,82,29,32,61
13,8482113,Anton Lundell,C,FLA,23,82,28,33,61
13,8482665,Matty Beniers,C,SEA,22,82,24,37,61
13,8475810,Bryan Rust,R,PIT,32,82,22,39,61
13,8482740,Wyatt Johnston,C,DAL,21,82,33,27,60
13,8482159,Tyson Foerster,R,PHI,22,82,25,35,60
13,8477940,Nikolaj Ehlers,L,WPG,28,82,20,40,60
13,8478856,Conor Garland,R,VAN,28,82,20,40,60
13,8475745,Charlie Coyle,C,BOS,32,82,18,42,60
13,8478407,Vince Dunn,D,SEA,28,82,16,44,60
13,8477955,Jared McCann,L,SEA,28,82,32,26,58
13,8481540,Cole Caufield,R,MTL,23,82,29,29,58
13,8479542,Brandon Hagel,L,TBL,26,82,27,31,58
13,8478047,Michael Bunting,L,PIT,29,82,27,31,58
13,8482667,William Eklund,L,SJS,22,82,23,35,58
13,8476880,Tom Wilson,R,WSH,30,82,20,38,58
13,8480798,Philipp Kurashev,C,CHI,25,82,19,39,58
13,8476292,Ondrej Palat,L,NJD,33,82,17,41,58
13,8481542,Moritz Seider,D,DET,23,82,5,53,58
13,8477935,Sam Bennett,C,FLA,28,82,22,35,57
13,8478438,Tommy Novak,C,NSH,27,82,17,40,57
13,8482684,Luke Hughes,D,NJD,21,82,15,42,57
13,8480064,Josh Norris,C,OTT,25,82,34,22,56
13,8477476,Artturi Lehkonen,L,COL,29,82,33,23,56
13,8482699,Dylan Guenther,R,UTA,21,82,30,26,56
13,8477416,Oliver Bjorkstrand,R,SEA,29,82,29,27,56
13,8479400,Pierre-Luc Dubois,L,WSH,26,82,28,28,56
13,8474586,Jordan Eberle,R,SEA,34,82,27,29,56
13,8480018,Nick Suzuki,C,MTL,25,82,23,33,56
13,8479345,Jakob Chychrun,D,WSH,26,82,22,34,56
13,8478975,Mason Marchment,L,DAL,29,82,21,35,56
13,8482124,Quinton Byfield,R,LAK,22,82,19,37,56
13,8482149,Cole Perfetti,C,WPG,22,82,18,38,56
13,8475167,Victor Hedman,D,TBL,34,82,15,41,56
13,8476462,Dougie Hamilton,D,NJD,31,82,15,41,56
13,8478038,Devon Toews,D,COL,30,82,13,43,56
13,8476853,Morgan Rielly,D,TOR,30,82,9,47,56
13,8480188,Fabian Zetterlund,L,SJS,25,82,25,30,55
13,8480015,Owen Tippett,R,PHI,25,82,21,34,55
13,8479410,Mikhail Sergachev,D,UTA,26,82,14,41,55
13,8477503,Max Domi,C,TOR,29,82,11,44,55
13,8473994,Jamie Benn,L,DAL,35,82,23,31,54
13,8477496,Elias Lindholm,C,BOS,30,82,19,35,54
13,8477495,Seth Jones,D,CHI,30,82,15,39,54
13,8479425,Filip Hronek,D,VAN,27,82,9,45,54
13,8475314,Anders Lee,L,NYI,34,82,25,28,53
13,8474102,David Perron,L,OTT,36,82,22,31,53
13,8477407,Anthony Duclair,L,NYI,29,82,22,31,53
13,8477497,Sean Monahan,C,CBJ,30,82,19,34,53
13,8474565,Alex Pietrangelo,D,VGK,34,82,13,40,53
13,8477444,Andre Burakovsky,L,SEA,29,82,11,42,53
13,8481618,Alex Newhook,C,MTL,23,82,30,22,52
13,8477451,Ryan Hartman,R,MIN,30,82,24,28,52
13,8475191,Reilly Smith,R,NYR,33,82,19,33,52
13,8476905,Chandler Stephenson,C,SEA,30,82,15,37,52
13,8476875,Mike Matheson,D,MTL,30,82,11,41,52
13,8471724,Kris Letang,D,PIT,37,82,10,42,52
13,8482745,Mason McTavish,C,ANA,21,82,29,22,51
13,8480797,Joel Farabee,L,PHI,24,82,26,25,51
13,8475169,Evander Kane,L,EDM,33,82,21,30,51
13,8478474,Lawson Crouse,L,UTA,27,82,20,31,51
13,8476826,Yanni Gourde,C,SEA,33,82,14,37,51
13,8482109,Alexis Lafrenière,L,NYR,23,82,25,25,50
13,8475791,Taylor Hall,L,CHI,33,82,24,26,50
13,8478498,Jake DeBrusk,L,VAN,28,82,20,30,50
13,8474641,Adam Henrique,C,EDM,34,82,19,31,50
13,8473986,Alex Killorn,L,ANA,35,82,18,32,50
13,8481711,Matias Maccelli,L,UTA,24,82,17,33,50
13,8474563,Drew Doughty,D,LAK,35,82,11,39,50
13,8470613,Brent Burns,D,CAR,39,82,9,41,50
13,8481533,Trevor Zegras,C,ANA,23,82,24,25,49
13,8476399,Blake Coleman,C,CGY,33,82,24,25,49
13,8477479,Tyler Bertuzzi,L,CHI,29,82,23,26,49
13,8476461,Sean Couturier,C,PHI,32,82,19,30,49
13,8480839,Rasmus Dahlin,D,BUF,24,82,14,35,49
13,8474590,John Carlson,D,WSH,34,82,9,39,48
13,8478469,Thomas Chabot,D,OTT,27,82,9,39,48
13,8476958,Jaccob Slavin,D,CAR,30,82,9,39,48
13,8475151,Kyle Palmieri,C,NYI,33,82,24,23,47
13,8475799,Nino Niederreiter,R,WPG,32,82,23,24,47
13,8482055,Drew O'Connor,L,PIT,26,82,22,25,47
13,8478401,Pavel Zacha,C,BOS,27,82,18,29,47
13,8476479,Phillip Danault,C,LAK,31,82,17,30,47
13,8477998,Warren Foegele,L,LAK,28,82,16,31,47
13,8478396,Noah Hanifin,D,VGK,27,82,14,33,47
13,8481581,Thomas Harley,D,DAL,23,82,11,36,47
13,8476792,Torey Krug,D,STL,33,82,9,38,47
13,8481624,Ilya Mikheyev,R,CHI,30,82,24,22,46
13,8476869,Brady Skjei,D,NSH,30,82,13,33,46
13,8479325,Charlie McAvoy,D,BOS,27,82,12,34,46
13,8481068,Yegor Sharangovich,C,CGY,26,82,27,18,45
13,8476483,Rickard Rakell,R,PIT,31,82,20,25,45
13,8479996,Cody Glass,C,NSH,25,82,19,26,45
13,8480113,Alex Iafallo,L,WPG,31,82,19,26,45
13,8480078,Filip Chytil,C,NYR,25,82,16,29,45
13,8475287,Erik Haula,L,NJD,33,82,14,31,45
13,8482105,Jake Sanderson,D,OTT,22,82,13,32,45
13,8473563,Nicklas Backstrom,C,WSH,37,82,13,32,45
13,8477969,Marcus Pettersson,D,PIT,28,82,9,36,45
13,8479365,Trent Frederic,C,BOS,26,82,24,20,44
13,8477511,Anthony Mantha,R,CGY,30,82,21,23,44
13,8475793,Ryan Johansen,C,PHI,32,82,21,23,44
13,8478233,Andrew Mangiapane,L,WSH,28,82,19,25,44
13,8471698,T.J. Oshie,R,WSH,38,82,18,26,44
13,8477498,Darnell Nurse,D,EDM,29,82,17,27,44
13,8475763,Kevin Hayes,R,PIT,32,82,15,29,44
13,8478055,Gustav Forsling,D,FLA,28,82,13,31,44
13,8479992,Michael Rasmussen,C,DET,25,82,13,31,44
13,8478397,Rasmus Andersson,D,CGY,28,82,12,32,44
13,8479999,Casey Mittelstadt,C,COL,26,82,12,32,44
13,8480865,Noah Dobson,D,NYI,24,82,8,36,44
13,8475753,Justin Faulk,D,STL,32,82,7,37,44
13,8476438,Brandon Saad,L,STL,32,82,26,17,43
13,8474053,Logan Couture,C,SJS,35,82,20,23,43
13,8482097,Jack Quinn,R,BUF,23,82,18,25,43
13,8477987,Ryan Donato,C,CHI,28,82,18,25,43
13,8477426,Nicholas Paul,L,TBL,29,82,16,27,43
13,8477494,Jonathan Drouin,L,COL,29,82,15,28,43
13,8476463,Jonas Brodin,D,MIN,31,82,11,32,43
13,8476854,Hampus Lindholm,D,BOS,30,82,9,34,43
13,8480459,Pius Suter,C,VAN,28,82,27,15,42
13,8475714,Calle Jarnkrok,C,TOR,33,82,26,16,42
13,8476474,Stefan Noesen,R,NJD,31,82,18,24,42
13,8476392,Adam Lowry,C,WPG,31,82,17,25,42
13,8480220,Noah Cates,L,PHI,25,82,15,27,42
13,8478472,Mathieu Joseph,R,STL,27,82,14,28,42
13,8483808,Andrei Kuzmenko,L,CGY,28,82,14,28,42
13,8476906,Shayne Gostisbehere,D,CAR,31,82,10,32,42
13,8477952,Robby Fabbri,C,ANA,28,82,21,20,41
13,8481582,Nicholas Robertson,L,TOR,23,82,21,20,41
13,8479525,Ross Colton,C,COL,28,82,18,23,41
13,8480009,Eeli Tolvanen,R,SEA,25,82,14,27,41
13,8479987,Morgan Geekie,C,BOS,26,82,21,19,40
13,8475760,Nick Bjugstad,C,UTA,32,82,20,20,40
13,8478462,Nicolas Roy,C,VGK,27,82,19,21,40
13,8479591,Michael Eyssimont,C,TBL,28,82,19,21,40
13,8483515,Juraj Slafkovsky,L,MTL,20,82,18,22,40
13,8478542,Evan Rodrigues,C,FLA,31,82,15,25,40
13,8475768,Jaden Schwartz,C,SEA,32,82,12,28,40
13,8479351,Sam Steel,C,DAL,26,82,12,28,40
13,8474716,Jared Spurgeon,D,MIN,35,82,9,31,40
13,8482146,Luke Evangelista,R,NSH,22,82,24,15,39
13,8477450,Jason Dickinson,C,CHI,29,82,21,18,39
13,8482110,Dawson Mercer,C,NJD,23,82,17,22,39
13,8481013,Jonatan Berggren,R,DET,24,82,17,22,39
13,8474149,Evgenii Dadonov,R,DAL,35,82,16,23,39
13,8478046,Danton Heinen,L,VAN,29,82,13,26,39
13,8482671,Owen Power,D,BUF,22,82,11,28,39
13,8480434,Sean Durzi,D,UTA,26,82,10,29,39
13,8475764,Cam Fowler,D,ANA,33,82,5,34,39
13,8482175,JJ Peterka,R,BUF,22,82,28,10,38
13,8480829,Jesperi Kotkaniemi,C,CAR,24,82,24,14,38
13,8478020,Michael Amadio,C,OTT,28,82,24,14,38
13,8477429,Andrew Copp,C,DET,30,82,19,19,38
13,8481704,Juuso Parssinen,C,NSH,23,82,18,20,38
13,8476925,Colton Sissons,C,NSH,31,82,15,23,38
13,8476419,Jean-Gabriel Pageau,C,NYI,32,82,14,24,38
13,8476927,Teddy Blueger,C,VAN,30,82,14,24,38
13,8476960,Andreas Athanasiou,C,CHI,30,82,13,25,38
13,8480893,Kirill Marchenko,R,CBJ,24,82,27,10,37
13,8478057,Dakota Joshua,C,VAN,28,82,22,15,37
13,8479941,Justin Danforth,R,CBJ,31,82,18,19,37
13,8480849,Barrett Hayton,C,UTA,24,82,17,20,37
13,8481560,Arthur Kaliyev,R,LAK,23,82,16,21,37
13,8482475,Yegor Chinakhov,R,CBJ,23,82,15,22,37
13,8478519,Anthony Cirelli,C,TBL,27,82,14,23,37
13,8477932,Aaron Ekblad,D,FLA,28,82,9,28,37
13,8481546,Cam York,D,PHI,23,82,7,30,37
13,8480873,Rasmus Sandin,D,WSH,24,82,3,34,37
13,8481580,Connor McMichael,C,WSH,23,82,20,16,36
13,8484144,Connor Bedard,C,CHI,19,82,15,21,36
13,8473422,Nick Foligno,L,CHI,37,82,15,21,36
13,8480185,Eetu Luostarinen,C,FLA,26,82,14,22,36
13,8482720,Matthew Knies,L,TOR,22,82,14,22,36
13,8476458,Ryan Strome,C,ANA,31,82,9,27,36
13,8480145,Neal Pionk,D,WPG,29,82,7,29,36
13,8482117,Lukas Reichel,L,CHI,22,82,17,18,35
13,8476872,Scott Laughton,C,PHI,30,82,15,20,35
13,8478458,Jack Roslovic,C,CAR,27,82,13,22,35
13,8476480,Vladislav Namestnikov,C,WPG,32,82,13,22,35
13,8477508,Curtis Lazar,C,NJD,29,82,11,24,35
13,8480871,Adam Boqvist,D,FLA,24,82,10,25,35
13,8476329,Travis Boyd,C,MIN,31,82,9,26,35
13,8477506,Ryan Pulock,D,NYI,30,82,8,27,35
13,8482089,Jake Neighbours,L,STL,22,82,19,15,34
13,8480748,Kiefer Sherwood,L,VAN,29,82,19,15,34
13,8481535,Nils Hoglander,L,VAN,24,82,18,16,34
13,8481554,Kaapo Kakko,R,NYR,23,82,17,17,34
13,8480068,Ryan Poehling,C,PHI,25,82,17,17,34
13,8475193,Tomas Tatar,L,NJD,34,82,16,18,34
13,8475722,Jason Zucker,L,BUF,32,82,14,20,34
13,8475149,Marcus Johansson,L,MIN,34,82,14,20,34
13,8478432,Christian Fischer,R,DET,27,82,14,20,34
13,8482125,Alexander Holtz,R,VGK,22,82,14,20,34
13,8477947,Sonny Milano,L,WSH,28,82,13,21,34
13,8480855,Jack McBain,C,UTA,24,82,12,22,34
13,8481186,Logan O'Connor,R,COL,28,82,11,23,34
13,8475220,Marcus Foligno,L,MIN,33,82,11,23,34
13,8477989,Christian Dvorak,C,MTL,28,82,11,23,34
13,8481522,Peyton Krebs,C,BUF,23,82,10,24,34
13,8476979,Erik Gustafsson,D,DET,32,82,5,29,34
13,8482655,J.J. Moser,D,TBL,24,82,4,30,34
13,8474189,Lars Eller,C,PIT,35,82,20,13,33
13,8481604,Pavel Dorofeyev,L,VGK,24,82,19,14,33
13,8483457,Lane Hutson,D,MTL,20,82,16,17,33
13,8478463,Anthony Beauvillier,L,PIT,27,82,13,20,33
13,8477953,Kasperi Kapanen,R,STL,28,82,11,22,33
13,8480813,Joe Veleno,C,DET,24,82,11,22,33
13,8480336,Sean Walker,D,CAR,30,82,10,23,33
13,8475171,Oliver Ekman-Larsson,D,TOR,33,82,9,24,33
13,8477021,Alex Kerfoot,C,UTA,30,82,8,25,33
13,8473507,Jeff Petry,D,DET,37,82,8,25,33
13,8477220,Nate Schmidt,D,FLA,33,82,8,25,33
13,8482122,Brock Faber,D,MIN,22,82,7,26,33
13,8475188,Brayden McNabb,D,VGK,33,82,4,29,33
13,8478115,Pierre Engvall,L,NYI,28,82,18,14,32
13,8478109,Victor Olofsson,L,VGK,29,82,14,18,32
13,8476278,Colin Blackwell,C,DAL,31,82,14,18,32
13,8479353,Brett Howden,C,VGK,26,82,13,19,32
13,8482133,Thomas Bordeleau,C,SJS,22,82,12,20,32
13,8478891,Mason Appleton,C,WPG,28,82,11,21,32
13,8476885,Jacob Trouba,D,NYR,30,82,9,23,32
13,8477948,Travis Sanheim,D,PHI,28,82,3,29,32
13,8479398,Samuel Girard,D,COL,26,82,2,30,32
13,8481601,Simon Holmstrom,R,NYI,23,82,18,13,31
13,8480028,Morgan Frost,C,PHI,25,82,15,16,31
13,8482111,Justin Barron,D,MTL,23,82,15,16,31
13,8475231,Casey Cizikas,C,NYI,33,82,15,16,31
13,8478569,Noel Acciari,C,PIT,33,82,13,18,31
13,8476921,Jordan Martinook,L,CAR,32,82,9,22,31
13,8476422,Mike Reilly,D,NYI,31,82,9,22,31
13,8480817,K'Andre Miller,D,NYR,24,82,7,24,31
13,8478133,Jake Evans,C,MTL,28,82,6,25,31
13,8482142,Jamie Drysdale,D,PHI,22,82,6,25,31
13,8478500,Ivan Provorov,D,CBJ,27,82,2,29,31
13,8481481,Blake Lizotte,C,PIT,27,82,16,14,30
13,8476873,Mark Jankowski,C,NSH,30,82,15,15,30
13,8484166,Adam Fantilli,C,CBJ,20,82,14,16,30
13,8480003,Jesper Boqvist,C,FLA,26,82,12,18,30
13,8475848,Brendan Gallagher,R,MTL,32,82,11,19,30
13,8482705,Cole Sillinger,C,CBJ,21,82,10,20,30
13,8482660,Kent Johnson,C,CBJ,22,82,9,21,30
13,8481656,Aliaksei Protas,C,WSH,23,82,9,21,30
13,8479976,Juuso Valimaki,D,UTA,26,82,6,24,30
13,8480043,Timothy Liljegren,D,TOR,25,82,1,29,30
13,8479390,Taylor Raddysh,R,WSH,26,82,13,16,29
13,8480878,Nils Lundkvist,D,DAL,24,82,13,16,29
13,8479293,Brandon Tanev,L,SEA,33,82,13,16,29
13,8475218,Mattias Ekholm,D,EDM,34,82,11,18,29
13,8475200,Dmitry Orlov,D,CAR,33,82,9,20,29
13,8478507,John Marino,D,UTA,27,82,6,23,29
13,8476878,Zemgus Girgensons,L,TBL,30,82,17,11,28
13,8477353,Tyler Motte,C,DET,29,82,16,12,28
13,8478508,Yakov Trenin,C,MIN,27,82,14,14,28
13,8478013,Jake Walman,D,SJS,28,82,13,15,28
13,8473453,Trevor Lewis,C,LAK,37,82,12,16,28
13,8475855,Jesper Fast,R,CAR,33,82,11,17,28
13,8483431,Logan Cooley,C,UTA,20,82,11,17,28
13,8482624,Daniil Miromanov,D,CGY,27,82,9,19,28
13,8476892,Colton Parayko,D,STL,31,82,5,23,28
13,8476312,Josh Manson,D,COL,33,82,5,23,28
13,8476891,Matt Grzelcyk,D,PIT,30,82,5,23,28
13,8470621,Corey Perry,R,EDM,39,82,12,15,27
13,8473533,Jordan Staal,C,CAR,36,82,11,16,27
13,8479316,Luke Kunin,C,SJS,27,82,10,17,27
13,8482803,Olen Zellweger,D,ANA,21,82,10,17,27
13,8482259,Bobby McMann,C,TOR,28,82,10,17,27
13,8475343,Nic Dowd,C,WSH,34,82,9,18,27
13,8477425,Miles Wood,L,COL,29,82,9,18,27
13,8480789,Oliver Wahlstrom,R,NYI,24,82,7,20,27
13,8476923,Damon Severson,D,CBJ,30,82,6,21,27
13,8475462,Radko Gudas,D,ANA,34,82,4,23,27
13,8476981,Josh Anderson,R,MTL,30,82,15,11,26
13,8481093,Rafael Harvey-Pinard,L,MTL,25,82,14,12,26
13,8479368,Max Jones,L,BOS,26,82,13,13,26
13,8477919,Frederick Gaudreau,C,MIN,31,82,12,14,26
13,8480835,Jack Drury,C,CAR,24,82,11,15,26
13,8483445,Cutter Gauthier,L,ANA,20,82,10,16,26
13,8482166,Shakir Mukhamadullin,D,SJS,22,82,9,17,26
13,8476331,Dylan DeMelo,D,WPG,31,82,5,21,26
13,8476931,Jake McCabe,D,TOR,31,82,4,22,26
13,8477845,Trevor van Riemsdyk,D,WSH,33,82,4,22,26
13,8479402,Jake Bean,D,CGY,26,82,4,22,26
13,8481178,Egor Zamula,D,PHI,24,82,1,25,26
13,8479414,Nathan Bastian,R,NJD,27,82,14,11,25
13,8481477,Nico Sturm,C,SJS,29,82,13,12,25
13,8479661,Tanner Jeannot,L,LAK,27,82,12,13,25
13,8480802,Ryan McLeod,C,BUF,25,82,11,14,25
13,8482079,Marco Rossi,C,MIN,23,82,10,15,25
13,8482092,Ridly Greig,C,OTT,22,82,9,16,25
13,8482087,Kaiden Guhle,D,MTL,22,82,6,19,25
13,8474574,Tyler Myers,D,VAN,34,82,4,21,25
13,8476902,Esa Lindell,D,DAL,30,82,4,21,25
13,8475233,David Savard,D,MTL,34,82,4,21,25
13,8479369,Andrew Peeke,D,BOS,26,82,3,22,25
13,8476879,Cody Ceci,D,EDM,31,82,0,25,25
13,8482077,Dylan Holloway,L,EDM,23,82,17,7,24
13,8476858,Phillip Di Giuseppe,L,VAN,31,82,16,8,24
13,8474715,Cam Atkinson,R,TBL,35,82,13,11,24
13,8482702,Logan Stankoven,C,DAL,21,82,11,13,24
13,8481553,Bobby Brink,R,PHI,23,82,9,15,24
13,8476624,Barclay Goodrow,C,SJS,31,82,9,15,24
13,8483490,Pavel Mintyukov,D,ANA,21,82,8,16,24
13,8482470,Ilya Solovyov,D,CGY,24,82,8,16,24
13,8475181,Nick Leddy,D,STL,33,82,7,17,24
13,8477392,Hudson Fasching,R,NYI,29,82,6,18,24
13,8478136,Jake Middleton,D,MIN,28,82,5,19,24
13,8475279,Ben Chiarot,D,DET,33,82,5,19,24
13,8480860,Kevin Bahl,D,CGY,24,82,4,20,24
13,8477488,Brett Pesce,D,NJD,30,82,4,20,24
13,8477839,Conor Sheary,L,TBL,32,82,4,20,24
13,8483482,Tristan Luneau,D,ANA,20,82,4,20,24
13,8475324,Nick Jensen,D,OTT,34,82,4,20,24
13,8482245,Artem Zub,D,OTT,29,82,3,21,24
13,8481032,Paul Cotter,C,NJD,25,82,13,10,23
13,8479393,Noah Gregor,C,OTT,26,82,13,10,23
13,8482062,Cole Smith,L,NSH,29,82,12,11,23
13,8478413,Jordan Greenway,L,BUF,27,82,10,13,23
13,8483524,Shane Wright,C,SEA,20,82,10,13,23
13,8482074,Connor Zary,C,CGY,23,82,10,13,23
13,8477931,Tomas Nosek,L,FLA,32,82,9,14,23
13,8482155,Alex Laferriere,R,LAK,23,82,9,14,23
13,8483468,Jiri Kulich,C,BUF,20,82,8,15,23
13,8478911,Matt Roy,D,WSH,29,82,7,16,23
13,8481567,Henry Thrun,D,SJS,23,82,7,16,23
13,8480995,Pontus Holmberg,R,TOR,25,82,6,17,23
13,8477499,Rasmus Ristolainen,D,PHI,30,82,6,17,23
13,8478851,Alexandre Carrier,D,NSH,28,82,5,18,23
13,8480049,Dylan Samberg,D,WPG,25,82,4,19,23
13,8476917,Adam Pelech,D,NYI,30,82,3,20,23
13,8474673,TJ Brodie,D,CHI,34,82,1,22,23
13,8481708,Zac Jones,D,NYR,24,82,1,22,23
13,8476918,Jimmy Vesey,L,NYR,31,82,14,8,22
13,8480281,Alexey Toropchenko,R,STL,25,82,14,8,22
13,8476897,Oskar Sundqvist,C,STL,30,82,10,12,22
13,8476889,Radek Faksa,C,STL,30,82,9,13,22
13,8480448,Parker Kelly,L,COL,25,82,8,14,22
13,8482733,Logan Mailloux,D,MTL,31,82,8,14,22
13,8476525,Colin Miller,D,WPG,32,82,7,15,22
13,8482762,Simon Edvinsson,D,DET,21,82,6,16,22
13,8477435,Ryan Graves,D,PIT,29,82,6,16,22
13,8482073,Braden Schneider,D,NYR,23,82,5,17,22
13,8479371,Dante Fabbro,D,NSH,26,82,5,17,22
13,8480807,Mattias Samuelsson,D,BUF,24,82,3,19,22
13,8475690,Chris Tanev,D,TOR,35,82,2,20,22
13,8481568,Alex Vlasic,D,CHI,23,82,2,20,22
13,8480074,Alexandre Texier,C,STL,25,82,11,10,21
13,8483499,Liam Ohgren,L,MIN,20,82,10,11,21
13,8477903,Garnet Hathaway,R,PHI,33,82,9,12,21
13,8477507,Nikita Zadorov,D,BOS,29,82,8,13,21
13,8476374,Sean Kuraly,C,CBJ,31,82,8,13,21
13,8480144,David Kampf,C,TOR,29,82,8,13,21
13,8482858,Ryker Evans,D,SEA,23,82,8,13,21
13,8484145,Zach Benson,L,BUF,19,82,7,14,21
13,8480073,Erik Brannstrom,D,COL,25,82,7,14,21
13,8478416,Erik Cernak,D,TBL,27,82,6,15,21
13,8482141,Lukas Cormier,D,VGK,22,82,6,15,21
13,8481606,Jordan Spence,D,LAK,23,82,5,16,21
13,8479324,Ryan Lindgren,D,NYR,26,82,5,16,21
13,8481122,Simon Benoit,D,TOR,26,82,5,16,21
13,8480246,Nick Perbix,D,TBL,26,82,4,17,21
13,8479980,Nicolas Hague,D,VGK,26,82,3,18,21
13,8476442,Matt Nieto,L,PIT,32,82,13,7,20
13,8480021,Jack Studnicka,C,LAK,25,82,10,10,20
13,8477015,Connor Brown,R,EDM,30,82,9,11,20
13,8484203,Bradly Nadeau,L,CAR,19,82,8,12,20
13,8481517,Brett Leason,R,ANA,25,82,8,12,20
13,8482666,Scott Morrow,D,CAR,22,82,8,12,20
13,8477505,Alexander Wennberg,C,SJS,30,82,7,13,20
13,8477406,Mattias Janmark,C,EDM,32,82,6,14,20
13,8478882,Vladislav Gavrikov,D,LAK,29,82,4,16,20
13,8476467,Jamie Oleksiak,D,SEA,32,82,4,16,20
13,8480990,Declan Chisholm,D,MIN,24,82,4,16,20
13,8478840,Will Borgen,D,SEA,28,82,2,18,20
13,8480950,Ilya Lyubushkin,D,DAL,30,82,2,18,20
13,8483493,Frank Nazar,C,CHI,20,82,9,10,19
13,8480806,Isac Lundestrom,C,ANA,25,82,7,12,19
13,8478468,Jeremy Lauzon,D,NSH,27,82,4,15,19
13,8474151,Ryan McDonagh,D,TBL,35,82,3,16,19
13,8483495,Simon Nemec,D,NJD,20,82,3,16,19
13,8483565,Nick Blankenburg,D,NSH,26,82,2,17,19
13,8480172,Jan Rutta,D,SJS,34,82,1,18,19
13,8475455,Brenden Dillon,D,NJD,34,82,1,18,19
13,8476469,Joel Armia,R,MTL,31,82,9,9,18
13,8482809,Jackson Blake,R,CAR,21,82,9,9,18
13,8484153,Leo Carlsson,C,ANA,20,82,8,10,18
13,8482101,Danil Gushchin,L,SJS,22,82,7,11,18
13,8480980,Connor Dewar,C,TOR,25,82,6,12,18
13,8480025,MacKenzie Entwistle,R,FLA,25,82,5,13,18
13,8479998,Mikey Anderson,D,LAK,25,82,4,14,18
13,8477034,Jaycob Megna,D,FLA,32,82,4,14,18
13,8475790,Erik Gudbranson,D,CBJ,32,82,3,15,18
13,8470600,Ryan Suter,D,STL,39,82,3,15,18
13,8477365,Connor Clifton,D,BUF,29,82,2,16,18
13,8481028,Martin Pospisil,C,CGY,25,82,10,7,17
13,8478211,Dryden Hunt,L,CGY,29,82,9,8,17
13,8482749,Joshua Roy,R,MTL,21,82,8,9,17
13,8477938,Haydn Fleury,D,WPG,28,82,7,10,17
13,8480870,Bo Groulx,C,NYR,24,82,6,11,17
13,8484911,Collin Graf,R,SJS,22,82,5,12,17
13,8476372,Nick Seeler,D,PHI,31,82,5,12,17
13,8482145,Mavrik Bourque,C,DAL,22,82,5,12,17
13,8479983,Mario Ferraro,D,SJS,26,82,4,13,17
13,8481014,Alexander Romanov,D,NYI,24,82,4,13,17
13,8476429,Scott Mayfield,D,NYI,32,82,4,13,17
13,8482153,Brendan Brisson,C,VGK,23,82,3,14,17
13,8482713,Mackie Samoskevich,R,FLA,22,82,3,14,17
13,8481699,Aku Raty,R,UTA,23,82,2,15,17
13,8480035,Henri Jokiharju,D,BUF,25,82,2,15,17
13,8481605,Jackson LaCombe,D,ANA,23,82,2,15,17
13,8480222,Sebastian Aho,D,PIT,28,82,0,17,17
13,8483763,Maksymilian Szuber,D,UTA,22,82,8,8,16
13,8481524,Bowen Byram,D,BUF,23,82,7,9,16
13,8483012,Logan Morrison,C,SEA,22,82,7,9,16
13,8474013,Ian Cole,D,UTA,35,82,6,10,16
13,8476457,Adam Larsson,D,SEA,32,82,3,13,16
13,8483466,Kevin Korchinski,D,CHI,20,82,3,13,16
13,8478399,Jonas Siegenthaler,D,NJD,27,82,2,14,16
13,8474612,Travis Hamonic,D,OTT,34,82,1,15,16
13,8475842,Sam Carrick,C,NYR,32,82,11,4,15
13,8479291,Kevin Rooney,C,CGY,31,82,8,7,15
13,8478434,Keegan Kolesar,R,VGK,27,82,7,8,15
13,8477369,Carson Soucy,D,VAN,30,82,6,9,15
13,8476441,Joel Edmundson,D,LAK,31,82,4,11,15
13,8479576,Vincent Desharnais,D,VAN,28,82,3,12,15
13,8479442,Troy Stecher,D,EDM,30,82,2,13,15
13,8482679,Matt Coronato,R,CGY,22,82,10,4,14
13,8481641,Joel Kiviranta,L,COL,28,82,9,5,14
13,8482807,Ethan Del Mastro,D,CHI,21,82,7,7,14
13,8478859,Niko Mikkola,D,FLA,28,82,5,9,14
13,8483471,Brad Lambert,C,WPG,31,82,4,10,14
13,8476967,Brett Kulak,D,EDM,30,82,2,12,14
13,8480796,Martin Fehervary,D,WSH,25,82,1,13,14
13,8483505,Matthew Poitras,C,BOS,20,82,6,7,13
13,8484149,Gavin Brindley,C,CBJ,20,82,4,9,13
13,8477335,Kyle Burroughs,D,LAK,29,82,3,10,13
13,8476473,Connor Murphy,D,CHI,31,82,3,10,13
13,8480879,Jacob Bernard-Docker,D,OTT,24,82,2,11,13
13,8475718,Justin Holl,D,DET,32,82,2,11,13
13,8476822,Luke Glendening,C,TBL,35,82,6,6,12
13,8483397,Marc McLaughlin,C,BOS,25,82,5,7,12
13,8471677,Jack Johnson,D,CBJ,37,82,4,8,12
13,8478178,Darren Raddysh,D,TBL,28,82,3,9,12
13,8482516,Matthew Kessel,D,STL,24,82,3,9,12
13,8478874,Adam Gaudette,C,OTT,28,82,0,12,12
13,8482659,Josh Doan,R,UTA,22,82,6,5,11
13,8474062,Riley Nash,C,NYR,35,82,6,5,11
13,8479638,Justin Brazeau,R,BOS,26,82,5,6,11
13,8475177,Calvin de Haan,D,COL,33,82,5,6,11
13,8482787,Nikita Chibrikov,R,WPG,31,82,5,6,11
13,8480834,Ty Emberson,D,SJS,24,82,4,7,11
13,8479359,Beck Malenstyn,L,BUF,26,82,3,8,11
13,8482118,Sam Colangelo,R,ANA,23,82,3,8,11
13,8478443,Brandon Carlo,D,BOS,28,82,1,10,11
13,8475762,Derek Forbort,D,VAN,32,82,1,10,11
13,8482712,Oskar Olausson,R,COL,22,82,4,6,10
13,8474567,Zach Bogosian,D,MIN,34,82,2,8,10
13,8482070,Mitchell Chaffee,R,TBL,26,82,2,8,10
13,8483567,Georgii Merkulov,C,BOS,24,82,5,4,9
13,8482859,Zack Ostapchuk,C,OTT,21,82,3,6,9
13,8483460,David Jiricek,D,CBJ,21,82,1,8,9
13,8474090,Brendan Smith,D,DAL,35,82,0,9,9
13,8483489,Fraser Minten,C,TOR,31,82,4,4,8
13,8478450,Parker Wotherspoon,D,BOS,27,82,3,5,8
13,8470794,Joe Pavelski,C,,40,0,0,0,0
13,8481703,Valtteri Puustinen,R,PIT,25,0,0,0,0
13,8477950,Tony DeAngelo,D,,29,0,0,0,0
13,8481577,Philip Tomasino,C,NSH,23,0,0,0,0
13,8475197,Tyson Barrie,D,,33,0,0,0,0
13,8471218,Blake Wheeler,R,,38,0,0,0,0
13,8474157,Max Pacioretty,L,,36,0,0,0,0
13,8478466,Daniel Sprong,R,VAN,27,0,0,0,0
13,8475744,Evgeny Kuznetsov,C,,32,0,0,0,0
13,8481019,David Gustafsson,C,WPG,24,0,0,0,0
13,8475906,John Klingberg,D,,32,0,0,0,0
13,8479348,Kale Clague,D,BUF,26,0,0,0,0
13,8476952,Dominic Toninato,C,WPG,30,0,0,0,0
13,8473473,Milan Lucic,L,,36,0,0,0,0
13,8474037,James van Riemsdyk,L,,35,0,0,0,0
13,8474602,Justin Schultz,D,,34,0,0,0,0
13,8482222,Alexander Barabanov,L,,30,0,0,0,0
13,8479372,Josh Mahura,D,SEA,26,0,0,0,0
13,8479982,Conor Timmins,D,TOR,26,0,0,0,0
13,8474031,Kevin Shattenkirk,D,,35,0,0,0,0
13,8480008,Adam Ruzicka,C,,25,0,0,0,0
13,8481059,Scott Perunovich,D,STL,26,0,0,0,0
13,8480884,Calen Addison,D,,24,0,0,0,0
13,8476994,Vinnie Hinostroza,C,NSH,30,0,0,0,0
13,8478452,Caleb Jones,D,LAK,27,0,0,0,0
13,8480157,Calle Rosen,D,COL,30,0,0,0,0
13,8481609,Vladislav Kolyachonok,D,UTA,23,0,0,0,0
13,8479415,Michael McLeod,C,,26,0,0,0,0
13,8476919,Chris Tierney,C,,30,0,0,0,0
13,8479639,Dylan Coghlan,D,WPG,26,0,0,0,0
13,8478146,Matthew Highmore,C,OTT,28,0,0,0,0
13,8478970,Jalen Chatfield,D,CAR,28,0,0,0,0
13,8480205,Emil Bemstrom,C,PIT,25,0,0,0,0
13,8474884,Mike Hoffman,C,,35,0,0,0,0
13,8471274,Alex Goligoski,D,,39,0,0,0,0
13,8478104,Sammy Blais,L,,28,0,0,0,0
13,8474870,Tyler Johnson,C,,34,0,0,0,0
13,8476913,Devin Shore,C,MIN,30,0,0,0,0
13,8481598,Philip Broberg,D,EDM,23,0,0,0,0
13,8480058,Pierre-Olivier Joseph,D,STL,25,0,0,0,0
13,8480891,Michael Kesselring,D,UTA,24,0,0,0,0
13,8477979,Nicolas Aube-Kubel,R,BUF,28,0,0,0,0
13,8476871,Tanner Pearson,L,,32,0,0,0,0
13,8476393,Nick Cousins,C,,31,0,0,0,0
13,8479977,Kailer Yamamoto,R,,26,0,0,0,0
13,8479543,Michael Pezzetta,L,MTL,26,0,0,0,0
13,8477018,Ben Hutton,D,VGK,31,0,0,0,0
13,8480762,Eric Robinson,L,CAR,29,0,0,0,0
13,8474034,Pat Maroon,L,CHI,36,0,0,0,0
13,8481058,Jesse Ylönen,R,,25,0,0,0,0
13,8475179,Dmitry Kulikov,D,FLA,34,0,0,0,0
13,8481527,Kaedan Korczak,D,VGK,23,0,0,0,0
13,8473449,Kyle Okposo,R,,36,0,0,0,0
13,8482192,Isaak Phillips,D,CHI,23,0,0,0,0
13,8480727,Zach Whitecloud,D,VGK,28,0,0,0,0
13,8479346,Dillon Dube,C,,26,0,0,0,0
13,8480821,Filip Zadina,R,,25,0,0,0,0
13,8480001,Urho Vaakanainen,D,ANA,25,0,0,0,0
13,8470966,Mark Giordano,D,,41,0,0,0,0
13,8480853,Liam Foudy,C,,24,0,0,0,0
13,8475225,Craig Smith,C,CHI,35,0,0,0,0
13,8479972,Mason Shaw,C,WPG,26,0,0,0,0
13,8478451,Ethan Bear,D,WSH,27,0,0,0,0
13,8474040,Sam Gagner,C,,35,0,0,0,0
13,8480196,Jacob Bryson,D,BUF,27,0,0,0,0
13,8479984,Cal Foote,D,,26,0,0,0,0
13,8480011,Klim Kostin,C,SJS,25,0,0,0,0
13,8482176,Wyatt Kaiser,D,CHI,22,0,0,0,0
13,8476988,Matt Benning,D,SJS,30,0,0,0,0
13,8479370,Tyson Jost,C,CAR,26,0,0,0,0
13,8477464,Nic Petan,C,,29,0,0,0,0
13,8477380,Jonny Brodzinski,C,NYR,31,0,0,0,0
13,8480070,Ian Mitchell,D,BOS,25,0,0,0,0
13,8479315,Joey Anderson,R,CHI,26,0,0,0,0
13,8478099,Kevin Labanc,R,,29,0,0,0,0
13,8476874,Olli Maatta,D,DET,30,0,0,0,0
13,8475208,Brian Dumoulin,D,ANA,33,0,0,0,0
13,8478430,Oliver Kylington,D,,27,0,0,0,0
13,8479536,Axel Jonsson-Fjallby,L,WPG,26,0,0,0,0
13,8479671,Mathieu Olivier,R,CBJ,27,0,0,0,0
13,8471709,Marc-Edouard Vlasic,D,SJS,37,0,0,0,0
13,8479328,Julien Gauthier,R,NYI,27,0,0,0,0
13,8478421,A.J. Greer,L,FLA,28,0,0,0,0
13,8477573,Nathan Walker,L,STL,30,0,0,0,0
13,8481537,Nikita Okhotiuk,D,CGY,24,0,0,0,0
13,8474166,Alec Martinez,D,CHI,37,0,0,0,0
13,8470610,Zach Parise,L,,40,0,0,0,0
13,8477478,William Carrier,L,CAR,30,0,0,0,0
13,8479344,Jesse Puljujarvi,R,PIT,26,0,0,0,0
13,8480887,Jordan Harris,D,MTL,24,0,0,0,0
13,8478502,Dennis Gilbert,D,BUF,28,0,0,0,0
13,8482730,Brandt Clarke,D,LAK,21,0,0,0,0
13,8480355,Mark Kastelic,C,BOS,25,0,0,0,0
13,8475750,Jon Merrill,D,MIN,32,0,0,0,0
13,8475164,Jakob Silfverberg,R,,34,0,0,0,0
13,8477944,Jakub Vrana,L,,28,0,0,0,0
13,8479439,Jacob MacDonald,D,COL,31,0,0,0,0
13,8474568,Luke Schenn,D,NSH,35,0,0,0,0
13,8478454,Noah Juulsen,D,VAN,27,0,0,0,0
13,8475752,Tyler Pitlick,C,,33,0,0,0,0
13,8482148,Hendrix Lapierre,C,WSH,22,0,0,0,0
13,8481167,Brayden Pachal,D,CGY,25,0,0,0,0
13,8478043,Sam Lafferty,C,BUF,29,0,0,0,0
13,8479321,Lucas Johansen,D,,27,0,0,0,0
13,8471699,Andrew Cogliano,C,,37,0,0,0,0
13,8481521,Ronnie Attard,D,PHI,25,0,0,0,0
13,8481161,Jake Christiansen,D,CBJ,25,0,0,0,0
13,8479458,Nikita Zaitsev,D,,33,0,0,0,0
13,8479619,Michael Carcone,L,UTA,28,0,0,0,0
13,8479026,Philippe Myers,D,TOR,27,0,0,0,0
13,8477330,Dominik Kubalik,L,,29,0,0,0,0
13,8481617,Vasily Podkolzin,R,VAN,23,0,0,0,0
13,8481701,Santeri Hatakka,D,NJD,23,0,0,0,0
13,8479514,Rem Pitlick,C,,27,0,0,0,0
13,8477446,Michael McCarron,R,NSH,29,0,0,0,0
13,8470604,Jeff Carter,C,,39,0,0,0,0
13,8482241,Radim Zohorna,L,,28,0,0,0,0
13,8480289,Morgan Barron,C,WPG,26,0,0,0,0
13,8479379,Givani Smith,R,SJS,26,0,0,0,0
13,8480216,Jacob Peterson,C,,25,0,0,0,0
13,8477851,Jordan Oesterle,D,BOS,32,0,0,0,0
13,8484258,Sam Malinski,D,COL,26,0,0,0,0
13,8478904,Steven Lorentz,C,,28,0,0,0,0
13,8482095,Tyler Kleven,D,OTT,22,0,0,0,0
13,8480848,Ty Dellandrea,C,SJS,24,0,0,0,0
13,8476884,Derrick Pouliot,D,,30,0,0,0,0
13,8479336,Carl Grundstrom,R,SJS,27,0,0,0,0
13,8482964,Arber Xhekaj,D,MTL,23,0,0,0,0
13,8471686,Marc Staal,D,,37,0,0,0,0
13,8477887,Patrick Brown,C,BOS,32,0,0,0,0
13,8478495,Denis Gurianov,R,,27,0,0,0,0
13,8473504,Cal Clutterbuck,R,,37,0,0,0,0
13,8481550,Adam Beckman,L,NJD,23,0,0,0,0
13,8480845,Rasmus Kupari,C,WPG,24,0,0,0,0
13,8474009,Nick Bonino,C,,36,0,0,0,0
13,8478585,Derek Ryan,C,EDM,38,0,0,0,0
13,8477962,Brendan Lemieux,L,CAR,28,0,0,0,0
13,8482861,Vincent Iorio,D,WSH,22,0,0,0,0
13,8479378,Logan Stanley,D,WPG,26,0,0,0,0
13,8473446,Erik Johnson,D,PHI,36,0,0,0,0
13,8481743,Marc Del Gaizo,D,NSH,25,0,0,0,0
13,8477384,Josh Brown,D,EDM,30,0,0,0,0
13,8482165,Yan Kuznetsov,D,CGY,22,0,0,0,0
13,8478424,Jansen Harkins,C,ANA,27,0,0,0,0
13,8482144,Jack Thompson,D,SJS,22,0,0,0,0
13,8478512,Austin Czarnik,C,,32,0,0,0,0
13,8477527,Ross Johnston,L,ANA,30,0,0,0,0
13,8479383,Boris Katchouk,L,,26,0,0,0,0
13,8482094,Daemon Hunt,D,MIN,22,0,0,0,0
13,8481719,Maxwell Crozier,D,TBL,24,0,0,0,0
13,8480192,Johnathan Kovacevic,D,NJD,27,0,0,0,0
13,8479376,Victor Mete,D,,26,0,0,0,0
13,8482511,Mason Lohrei,D,BOS,23,0,0,0,0
13,8475825,Jani Hakanpää,D,,32,0,0,0,0
13,8478021,William Lagesson,D,DET,28,0,0,0,0
13,8475795,Dylan McIlrath,D,WSH,32,0,0,0,0
13,8477846,Ryan Carpenter,C,,33,0,0,0,0
13,8481056,Spencer Stastney,D,NSH,24,0,0,0,0
13,8481564,Ryan Johnson,D,BUF,23,0,0,0,0
13,8478017,Mark Friedman,D,VAN,29,0,0,0,0
13,8479320,Max Lajoie,D,SEA,27,0,0,0,0
13,8480075,Cameron Crotty,D,MIN,25,0,0,0,0
13,8484287,Cole McWard,D,VAN,23,0,0,0,0
13,8484254,Akito Hirose,D,VAN,25,0,0,0,0
13,8483407,Brandon Scanlin,D,NYR,25,0,0,0,0
13,8480274,Philip Kemp,D,EDM,25,0,0,0,0
13,8479522,Hardy Haman Aktell,D,WSH,26,0,0,0,0
13,8480007,Jonas Rondbjerg,R,VGK,25,0,0,0,0
13,8477454,Adam Erne,L,,29,0,0,0,0
13,8481679,Maxence Guenette,D,OTT,23,0,0,0,0
13,8480441,Trey Fix-Wolansky,R,CBJ,25,0,0,0,0
13,8483546,Marshall Rifai,D,TOR,26,0,0,0,0
13,8480084,Nick DeSimone,D,NJD,30,0,0,0,0
13,8481030,Jack St. Ivany,D,PIT,25,0,0,0,0
13,8481592,Jakob Pelletier,L,CGY,23,0,0,0,0
13,8478011,Louie Belpedio,D,PHI,28,0,0,0,0
13,8477930,Pierre-Edouard Bellemare,L,,39,0,0,0,0
13,8484321,Nikolas Matinpalo,D,OTT,26,0,0,0,0
13,8482067,Connor Mackey,D,NYR,28,0,0,0,0
13,8481806,Louis Crevier,D,CHI,23,0,0,0,0
13,8484326,Patrik Koch,D,UTA,28,0,0,0,0
13,8477971,Andreas Englund,D,LAK,28,0,0,0,0
13,8481751,Lukas Rousek,R,BUF,25,0,0,0,0
13,8481006,Tyler Tucker,D,STL,24,0,0,0,0
13,8476867,Brendan Gaunce,C,MIN,30,0,0,0,0
13,8479520,Brandon Duhaime,R,WSH,27,0,0,0,0
13,8477073,Kurtis MacDermid,L,NJD,30,0,0,0,0
13,8480874,Adam Ginning,D,PHI,24,0,0,0,0
13,8477473,Justin Bailey,R,SJS,29,0,0,0,0
13,8479066,Ryan Lomberg,L,CGY,30,0,0,0,0
13,8477070,Liam O'Brien,C,UTA,30,0,0,0,0
13,8474618,Marco Scandella,D,,34,0,0,0,0
13,8475797,Jarred Tinordi,D,,32,0,0,0,0
13,8481441,Joe Snively,C,DET,28,0,0,0,0
13,8477244,Chad Ruhwedel,D,NYR,34,0,0,0,0
13,8479772,Zack MacEwen,R,OTT,28,0,0,0,0
13,8481147,Reese Johnson,C,MIN,26,0,0,0,0
13,8481043,Cole Koepke,L,BOS,26,0,0,0,0
13,8483619,Filip Roos,D,OTT,25,0,0,0,0
13,8481541,Samuel Bolduc,D,NYI,24,0,0,0,0
13,8477810,Joel Hanley,D,CGY,33,0,0,0,0
13,8476907,Mackenzie MacEachern,L,,30,0,0,0,0
13,8482652,Walker Duehr,R,CGY,27,0,0,0,0
13,8477126,Jayson Megna,C,,34,0,0,0,0
13,8483398,Declan Carlile,D,TBL,31,0,0,0,0
13,8482929,Emil Lilleberg,D,TBL,23,0,0,0,0
13,8480880,Jakub Lauko,C,MIN,24,0,0,0,0
13,8480245,Olle Lycksell,R,PHI,25,0,0,0,0
13,8480252,Cole Guttman,C,CHI,25,0,0,0,0
13,8477467,Gustav Olofsson,D,SEA,30,0,0,0,0
13,8479968,Vinni Lettieri,C,BOS,29,0,0,0,0
13,8478400,Colin White,C,,27,0,0,0,0
13,8475755,Alexander Petrovic,D,DAL,32,0,0,0,0
13,8481812,Nikolai Knyzhov,D,,27,0,0,0,0
13,8481593,Jayden Struble,D,MTL,23,0,0,0,0
13,8481532,Alex Turcotte,C,LAK,23,0,0,0,0
13,8482126,Emil Andrae,D,PHI,31,0,0,0,0
13,8479944,Zach Aston-Reese,C,VGK,30,0,0,0,0
13,8471817,Ryan Reaves,R,TOR,37,0,0,0,0
13,8481206,John Ludvig,D,PIT,24,0,0,0,0
13,8481599,Victor Soderstrom,D,UTA,23,0,0,0,0
13,8480292,Carson Meyer,R,ANA,27,0,0,0,0
13,8482496,Nils Aman,C,VAN,24,0,0,0,0
13,8479718,Alex Barré-Boulet,C,MTL,27,0,0,0,0
13,8479994,Jaret Anderson-Dolan,C,WPG,25,0,0,0,0
13,8480184,Gustav Lindstrom,D,,26,0,0,0,0
13,8480890,Jan Jenik,R,OTT,24,0,0,0,0
13,8478067,Oskar Lindblom,L,,28,0,0,0,0
13,8476934,Brock McGinn,L,ANA,30,0,0,0,0
13,8479985,Cale Fleury,D,SEA,26,0,0,0,0
13,8484304,Uvis Balinskis,D,FLA,28,0,0,0,0
13,8479981,Jonah Gadjovich,L,FLA,26,0,0,0,0
13,8481716,Dmitri Voronkov,L,CBJ,24,0,0,0,0
13,8474709,Matt Martin,L,,35,0,0,0,0
13,8482634,Alex Steeves,C,TOR,25,0,0,0,0
13,8480823,Alexander Alexeyev,D,WSH,25,0,0,0,0
13,8477541,Dakota Mermis,D,TOR,30,0,0,0,0
13,8483491,Ivan Miroshnichenko,L,WSH,20,0,0,0,0
13,8478477,Mitchell Stephens,C,SEA,27,0,0,0,0
13,8481543,Nikita Alexandrov,C,STL,24,0,0,0,0
13,8479423,Alex Nylander,L,,26,0,0,0,0
13,8482451,Mikael Pyyhtia,L,CBJ,23,0,0,0,0
13,8478831,Kevin Stenlund,C,UTA,28,0,0,0,0
13,8480306,Grant Hutton,D,NYI,29,0,0,0,0
13,8478028,Fredrik Olofsson,L,,28,0,0,0,0
13,8477462,Robert Hagg,D,VGK,29,0,0,0,0
13,8477320,Anton Blidh,L,NYR,29,0,0,0,0
13,8482157,Will Cuylle,L,NYR,22,0,0,0,0
13,8482737,Zack Bolduc,C,STL,21,0,0,0,0
13,8481239,Samuel Fagemo,L,,24,0,0,0,0
13,8481600,Tobias Bjornfot,D,FLA,23,0,0,0,0
13,8478409,Anthony Richard,C,PHI,28,0,0,0,0
13,8474145,Robert Bortuzzo,D,,35,0,0,0,0
13,8475958,Michael Sgarbossa,C,WSH,32,0,0,0,0
13,8479986,Kole Lind,R,DAL,26,0,0,0,0
13,8479249,Andrew Poturalski,C,SJS,30,0,0,0,0
13,8479362,Riley Tufte,L,BOS,26,0,0,0,0
13,8479991,Jake Leschyshyn,C,NYR,25,0,0,0,0
13,8479587,Rhett Gardner,C,PHI,28,0,0,0,0
13,8482744,James Malatesta,L,CBJ,21,0,0,0,0
13,8478854,Ryan Shea,D,PIT,27,0,0,0,0
13,8481591,Sam Poulin,R,,23,0,0,0,0
13,8483512,Matt Savoie,C,EDM,20,0,0,0,0
13,8482102,Vasily Ponomarev,C,PIT,22,0,0,0,0
13,8482162,Roby Jarventie,L,EDM,22,0,0,0,0
13,8481016,Ruslan Iskhakov,C,,24,0,0,0,0
13,8482172,Landon Slaggert,L,CHI,22,0,0,0,0
13,8482747,Brennan Othmann,L,NYR,21,0,0,0,0
13,8480031,Maxime Comtois,L,,25,0,0,0,0
13,8480226,Marián Studenic,R,,26,0,0,0,0
13,8478408,Travis Dermott,D,,28,0,0,0,0
13,8481518,Nolan Foote,L,NJD,24,0,0,0,0
13,8479419,Brett Murray,L,BUF,26,0,0,0,0
13,8482088,Justin Sourdif,R,FLA,22,0,0,0,0
13,8482201,Gage Goncalves,C,TBL,23,0,0,0,0
13,8481578,Graeme Clarke,R,MIN,23,0,0,0,0
13,8482177,Marat Khusnutdinov,C,MIN,22,0,0,0,0
13,8481754,Nikita Nesterenko,C,ANA,23,0,0,0,0
13,8483531,Brian Halonen,L,NJD,25,0,0,0,0
13,8483920,Pierrick Dube,R,WSH,23,0,0,0,0
13,8480851,Akil Thomas,C,LAK,24,0,0,0,0
13,8475235,Nicolas Deslauriers,L,PHI,33,0,0,0,0
13,8482476,Emil Heineman,L,MTL,23,0,0,0,0
13,8477149,Scott Sabourin,R,SJS,32,0,0,0,0
13,8483549,Lucas Condotta,L,MTL,27,0,0,0,0
13,8482765,Isak Rosen,R,BUF,21,0,0,0,0
13,8481237,Kyle MacLean,C,NYI,25,0,0,0,0
13,8481024,Linus Karlsson,C,VAN,25,0,0,0,0
13,8481690,Tyler Angle,C,,24,0,0,0,0
13,8483570,Ben Meyers,C,SEA,26,0,0,0,0
13,8481655,Cole Schwindt,R,CGY,23,0,0,0,0
13,8481462,Mason Morelli,L,VGK,28,0,0,0,0
13,8483401,Marc Johnstone,R,PIT,28,0,0,0,0
13,8478956,Samuel Laberge,L,NJD,27,0,0,0,0
13,8479533,Joona Koppanen,L,,26,0,0,0,0
13,8482197,Adam Raska,R,MIN,23,0,0,0,0
13,8482250,Callahan Burke,C,VGK,27,0,0,0,0
13,8482784,Zach Dean,C,STL,21,0,0,0,0
13,8484255,Jason Polin,R,COL,25,0,0,0,0
13,8481077,John Leonard,L,,26,0,0,0,0
13,8481534,Raphael Lavoie,C,EDM,24,0,0,0,0
13,8483609,Adam Klapka,R,CGY,24,0,0,0,0
13,8482751,Ryan Winterton,C,SEA,21,0,0,0,0
13,8480267,Sammy Walker,C,MIN,25,0,0,0,0
13,8475766,Austin Watson,L,,32,0,0,0,0
13,8482460,Matt Rempe,C,NYR,22,0,0,0,0
13,8481065,Angus Crookshank,L,OTT,25,0,0,0,0
13,8481070,Hugh McGing,L,,26,0,0,0,0
13,8476323,Max McCormick,L,SEA,32,0,0,0,0
13,8483395,Arshdeep Bains,L,VAN,23,0,0,0,0
13,8484259,Ondrej Pavel,C,COL,31,0,0,0,0
13,8483432,Luca Del Bel Belluz,C,CBJ,31,0,0,0,0
13,8483045,Cameron Butler,R,CBJ,31,0,0,0,0
13,8482061,Brandon Biro,L,SEA,26,0,0,0,0
13,8477401,John Hayden,C,SEA,29,0,0,0,0
13,8475278,Byron Froese,C,,33,0,0,0,0
13,8478446,Glenn Gawdin,C,LAK,27,0,0,0,0
13,8477993,Justin Kirkland,C,CGY,28,0,0,0,0
13,8482147,Jean-Luc Foudy,C,COL,22,0,0,0,0
13,8480032,Shane Bowers,C,NJD,25,0,0,0,0
13,8479330,Brandon Gignac,C,MTL,27,0,0,0,0
13,8480776,Sheldon Rempal,R,,29,0,0,0,0
13,8475413,Justin Dowling,C,NJD,34,0,0,0,0
13,8481726,Adam Edstrom,C,NYR,24,0,0,0,0
13,8480844,Grigori Denisenko,L,VGK,24,0,0,0,0
13,8478147,Bokondji Imama,L,PIT,28,0,0,0,0
13,8478881,Brett Seney,L,CHI,28,0,0,0,0
13,8483630,Pavol Regenda,L,ANA,25,0,0,0,0
13,8480836,Jonathan Gruden,C,,24,0,0,0,0
13,8484314,Jiri Smejkal,L,,28,0,0,0,0
13,8475780,Chris Wagner,R,COL,33,0,0,0,0
13,8479546,Oskar Steen,C,,26,0,0,0,0
13,8483597,Milos Kelemen,L,UTA,25,0,0,0,0
13,8481789,Tye Kartye,L,SEA,23,0,0,0,0
13,8484325,Waltteri Merela,C,TBL,26,0,0,0,0
13,8479421,Jacob Moverare,D,LAK,26,0,0,0,0
13,8481585,Egor Afanasyev,L,SJS,23,0,0,0,0
13,8479547,Matthew Phillips,R,,26,0,0,0,0
13,8479367,William Lockwood,R,FLA,26,0,0,0,0
13,8476915,Jujhar Khaira,L,,30,0,0,0,0
13,8481422,Jacob Lucchini,C,NSH,29,0,0,0,0
13,8480468,James Hamblin,L,EDM,25,0,0,0,0
13,8478051,Max Willman,C,NJD,29,0,0,0,0
13,8481556,John Beecher,C,BOS,23,0,0,0,0
13,8478078,Rourke Chartier,C,,28,0,0,0,0
14,8478402,Connor McDavid,C,EDM,27,82,47,98,145
14,8477934,Leon Draisaitl,C,EDM,29,82,53,78,131
14,8478550,Artemi Panarin,L,NYR,33,82,47,79,126
14,8479314,Matthew Tkachuk,L,FLA,27,82,42,83,125
14,8477492,Nathan MacKinnon,C,COL,29,82,40,84,124
14,8476468,J.T. Miller,C,VAN,31,82,44,75,119
14,8481559,Jack Hughes,C,NJD,23,82,46,70,116
14,8479318,Auston Matthews,C,TOR,27,82,46,66,112
14,8477956,David Pastrnak,R,BOS,28,82,41,68,109
14,8480027,Jason Robertson,L,DAL,25,82,41,68,109
14,8476453,Nikita Kucherov,R,TBL,31,82,32,77,109
14,8478445,Mathew Barzal,C,NYI,27,82,23,85,108
14,8477404,Jake Guentzel,C,TBL,30,82,42,58,100
14,8479407,Jesper Bratt,L,NJD,26,82,32,68,100
14,8477942,Kevin Fiala,L,LAK,28,82,29,69,98
14,8471675,Sidney Crosby,C,PIT,37,82,49,48,97
14,8475172,Nazem Kadri,C,CGY,34,82,35,61,96
14,8476460,Mark Scheifele,C,WPG,31,82,35,61,96
14,8478864,Kirill Kaprizov,L,MIN,27,82,47,48,95
14,8478439,Travis Konecny,R,PHI,27,82,47,48,95
14,8476887,Filip Forsberg,L,NSH,30,82,43,51,94
14,8477949,Alex Tuch,R,BUF,28,82,37,56,93
14,8477493,Aleksander Barkov,C,FLA,29,82,34,59,93
14,8479343,Clayton Keller,R,UTA,26,82,41,51,92
14,8478449,Roope Hintz,C,DAL,28,82,41,50,91
14,8474564,Steven Stamkos,C,NSH,34,82,38,53,91
14,8474600,Roman Josi,D,NSH,34,82,19,71,90
14,8477939,William Nylander,R,TOR,28,82,47,42,89
14,8480012,Elias Pettersson,C,VAN,26,82,37,52,89
14,8478420,Mikko Rantanen,R,COL,28,82,37,52,89
14,8481557,Matt Boldy,L,MIN,23,82,39,49,88
14,8480023,Robert Thomas,C,STL,25,82,14,73,87
14,8479420,Tage Thompson,C,BUF,27,82,37,49,86
14,8480069,Cale Makar,D,COL,26,82,25,61,86
14,8475913,Mark Stone,R,VGK,32,82,35,50,85
14,8477409,Carter Verhaeghe,C,FLA,29,82,42,42,84
14,8477960,Adrian Kempe,R,LAK,28,82,38,46,84
14,8480018,Nick Suzuki,C,MTL,25,82,27,57,84
14,8476539,Jonathan Marchessault,R,NSH,34,82,45,38,83
14,8479337,Alex DeBrincat,R,DET,27,82,42,41,83
14,8475158,Ryan O'Reilly,C,NSH,33,82,31,52,83
14,8482116,Tim Stützle,C,OTT,22,82,25,58,83
14,8478427,Sebastian Aho,C,CAR,27,82,37,45,82
14,8480803,Evan Bouchard,D,EDM,25,82,20,62,82
14,8480800,Quinn Hughes,D,VAN,25,82,13,69,82
14,8477500,Bo Horvat,C,NYI,29,82,46,34,80
14,8475166,John Tavares,C,TOR,34,82,44,36,80
14,8478403,Jack Eichel,C,VGK,28,82,35,45,80
14,8474141,Patrick Kane,R,DET,36,82,33,47,80
14,8475786,Zach Hyman,L,EDM,32,82,41,38,79
14,8479542,Brandon Hagel,L,TBL,26,82,40,39,79
14,8477933,Sam Reinhart,C,FLA,29,82,39,40,79
14,8478047,Michael Bunting,L,PIT,29,82,27,52,79
14,8476346,Johnny Gaudreau,L,CBJ,31,82,23,56,79
14,8476456,Jonathan Huberdeau,C,CGY,31,82,23,56,79
14,8481523,Kirby Dach,C,MTL,23,82,14,65,79
14,8478010,Brayden Point,C,TBL,28,82,38,40,78
14,8480002,Nico Hischier,C,NJD,25,82,27,51,78
14,8471685,Anze Kopitar,C,LAK,37,82,26,52,78
14,8471215,Evgeni Malkin,C,PIT,38,82,32,44,76
14,8478975,Mason Marchment,L,DAL,29,82,31,44,75
14,8478440,Dylan Strome,C,WSH,27,82,25,50,75
14,8479323,Adam Fox,D,NYR,26,82,14,61,75
14,8482745,Mason McTavish,C,ANA,21,82,45,29,74
14,8471214,Alex Ovechkin,L,WSH,39,82,36,38,74
14,8480801,Brady Tkachuk,L,OTT,25,82,35,39,74
14,8475810,Bryan Rust,R,PIT,32,82,35,39,74
14,8477946,Dylan Larkin,C,DET,28,82,31,43,74
14,8478873,Troy Terry,R,ANA,27,82,28,46,74
14,8475784,Jeff Skinner,C,EDM,32,82,31,42,73
14,8477940,Nikolaj Ehlers,L,WPG,28,82,31,42,73
14,8475692,Mats Zuccarello,R,MIN,37,82,29,44,73
14,8476389,Vincent Trocheck,C,NYR,31,82,29,44,73
14,8475168,Matt Duchene,C,DAL,33,82,28,45,73
14,8473512,Claude Giroux,R,OTT,36,82,26,47,73
14,8477447,Shea Theodore,D,VGK,29,82,25,48,73
14,8478398,Kyle Connor,L,WPG,28,82,38,34,72
14,8480036,Miro Heiskanen,D,DAL,25,82,15,57,72
14,8479675,Trevor Moore,L,LAK,29,82,29,42,71
14,8482078,Lucas Raymond,L,DET,22,82,38,32,70
14,8478414,Timo Meier,R,NJD,28,82,35,35,70
14,8477402,Pavel Buchnevich,L,STL,29,82,34,36,70
14,8474563,Drew Doughty,D,LAK,35,82,15,55,70
14,8476454,Ryan Nugent-Hopkins,C,EDM,31,82,14,56,70
14,8477504,Josh Morrissey,D,WPG,29,82,15,54,69
14,8482159,Tyson Foerster,R,PHI,22,82,30,38,68
14,8475798,Mikael Granlund,C,SJS,32,82,25,43,68
14,8478444,Brock Boeser,R,VAN,27,82,35,32,67
14,8477501,Valeri Nichushkin,R,COL,29,82,34,33,67
14,8476448,William Karlsson,C,VGK,31,82,24,43,67
14,8473419,Brad Marchand,L,BOS,36,82,24,43,67
14,8477951,Nick Schmaltz,C,UTA,28,82,21,46,67
14,8474590,John Carlson,D,WSH,34,82,18,49,67
14,8480865,Noah Dobson,D,NYI,24,82,12,55,67
14,8474578,Erik Karlsson,D,PIT,34,82,11,56,67
14,8476853,Morgan Rielly,D,TOR,30,82,9,58,67
14,8475184,Chris Kreider,L,NYR,33,82,43,23,66
14,8478519,Anthony Cirelli,C,TBL,27,82,23,43,66
14,8478460,Zach Werenski,D,CBJ,27,82,17,49,66
14,8475794,Tyler Seguin,C,DAL,32,82,33,32,65
14,8482699,Dylan Guenther,R,UTA,21,82,32,33,65
14,8476881,Tomas Hertl,C,VGK,31,82,30,35,65
14,8477964,Ivan Barbashev,C,VGK,29,82,29,36,65
14,8480188,Fabian Zetterlund,L,SJS,25,82,29,36,65
14,8480015,Owen Tippett,R,PHI,25,82,26,39,65
14,8476459,Mika Zibanejad,C,NYR,31,82,23,42,65
14,8476905,Chandler Stephenson,C,SEA,30,82,18,47,65
14,8474679,Gustav Nyquist,C,NSH,35,82,16,49,65
14,8479339,Patrik Laine,L,CBJ,26,82,31,33,64
14,8478042,Viktor Arvidsson,R,EDM,31,82,30,34,64
14,8481533,Trevor Zegras,C,ANA,23,82,23,41,64
14,8474102,David Perron,L,OTT,36,82,25,38,63
14,8473994,Jamie Benn,L,DAL,35,82,20,43,63
14,8478396,Noah Hanifin,D,VGK,27,82,8,55,63
14,8477955,Jared McCann,L,SEA,28,82,35,27,62
14,8481540,Cole Caufield,R,MTL,23,82,31,31,62
14,8475169,Evander Kane,L,EDM,33,82,31,31,62
14,8476483,Rickard Rakell,R,PIT,31,82,30,32,62
14,8481528,Dylan Cozens,C,BUF,23,82,26,36,62
14,8475765,Vladimir Tarasenko,R,DET,33,82,18,44,62
14,8479410,Mikhail Sergachev,D,UTA,26,82,8,53,61
14,8480014,Gabriel Vilardi,C,WPG,25,82,37,23,60
14,8475754,Brock Nelson,C,NYI,33,82,28,32,60
14,8476432,Boone Jenner,C,CBJ,31,82,30,29,59
14,8480797,Joel Farabee,L,PHI,24,82,24,35,59
14,8477416,Oliver Bjorkstrand,R,SEA,29,82,22,37,59
14,8482097,Jack Quinn,R,BUF,23,82,20,39,59
14,8475167,Victor Hedman,D,TBL,34,82,11,48,59
14,8476875,Mike Matheson,D,MTL,30,82,11,48,59
14,8481711,Matias Maccelli,L,UTA,24,82,24,34,58
14,8477494,Jonathan Drouin,L,COL,29,82,23,35,58
14,8478469,Thomas Chabot,D,OTT,27,82,12,46,58
14,8480830,Andrei Svechnikov,R,CAR,24,82,29,28,57
14,8478493,Joel Eriksson Ek,C,MIN,27,82,29,28,57
14,8477496,Elias Lindholm,C,BOS,30,82,29,28,57
14,8476826,Yanni Gourde,C,SEA,33,82,26,31,57
14,8476462,Dougie Hamilton,D,NJD,31,82,18,39,57
14,8483808,Andrei Kuzmenko,L,CGY,28,82,26,30,56
14,8474149,Evgenii Dadonov,R,DAL,35,82,22,34,56
14,8477451,Ryan Hartman,R,MIN,30,82,18,38,56
14,8480839,Rasmus Dahlin,D,BUF,24,82,17,39,56
14,8475151,Kyle Palmieri,C,NYI,33,82,28,27,55
14,8480039,Martin Necas,C,CAR,25,82,27,28,55
14,8482124,Quinton Byfield,R,LAK,22,82,20,35,55
14,8478542,Evan Rodrigues,C,FLA,31,82,20,35,55
14,8471724,Kris Letang,D,PIT,37,82,6,49,55
14,8476399,Blake Coleman,C,CGY,33,82,30,24,54
14,8478401,Pavel Zacha,C,BOS,27,82,25,29,54
14,8482667,William Eklund,L,SJS,22,82,24,30,54
14,8480220,Noah Cates,L,PHI,25,82,22,32,54
14,8479999,Casey Mittelstadt,C,COL,26,82,20,34,54
14,8478438,Tommy Novak,C,NSH,27,82,18,36,54
14,8473986,Alex Killorn,L,ANA,35,82,18,36,54
14,8477932,Aaron Ekblad,D,FLA,28,82,14,40,54
14,8478366,Frank Vatrano,R,ANA,30,82,30,23,53
14,8475799,Nino Niederreiter,R,WPG,32,82,28,25,53
14,8481618,Alex Newhook,C,MTL,23,82,19,34,53
14,8480078,Filip Chytil,C,NYR,25,82,19,34,53
14,8477346,MacKenzie Weegar,D,CGY,30,82,15,38,53
14,8477503,Max Domi,C,TOR,29,82,15,38,53
14,8479425,Filip Hronek,D,VAN,27,82,10,43,53
14,8476869,Brady Skjei,D,NSH,30,82,10,43,53
14,8481546,Cam York,D,PHI,23,82,9,44,53
14,8475791,Taylor Hall,L,CHI,33,82,19,33,52
14,8476479,Phillip Danault,C,LAK,31,82,15,37,52
14,8481542,Moritz Seider,D,DET,23,82,6,46,52
14,8480208,Drake Batherson,R,OTT,26,82,24,27,51
14,8482113,Anton Lundell,C,FLA,23,82,24,27,51
14,8482093,Seth Jarvis,C,CAR,22,82,21,30,51
14,8474641,Adam Henrique,C,EDM,34,82,21,30,51
14,8482109,Alexis Lafrenière,L,NYR,23,82,20,31,51
14,8477511,Anthony Mantha,R,CGY,30,82,19,32,51
14,8477444,Andre Burakovsky,L,SEA,29,82,17,34,51
14,8480434,Sean Durzi,D,UTA,26,82,8,43,51
14,8474586,Jordan Eberle,R,SEA,34,82,23,27,50
14,8482149,Cole Perfetti,C,WPG,22,82,23,27,50
14,8483515,Juraj Slafkovsky,L,MTL,20,82,23,27,50
14,8475763,Kevin Hayes,R,PIT,32,82,21,29,50
14,8475726,Tyler Toffoli,C,SJS,32,82,16,34,50
14,8478038,Devon Toews,D,COL,30,82,15,35,50
14,8476882,Teuvo Teravainen,L,CHI,30,82,13,37,50
14,8476906,Shayne Gostisbehere,D,CAR,31,82,10,40,50
14,8476438,Brandon Saad,L,STL,32,82,34,15,49
14,8475314,Anders Lee,L,NYI,34,82,26,23,49
14,8477476,Artturi Lehkonen,L,COL,29,82,25,24,49
14,8478474,Lawson Crouse,L,UTA,27,82,25,24,49
14,8476880,Tom Wilson,R,WSH,30,82,24,25,49
14,8477998,Warren Foegele,L,LAK,28,82,24,25,49
14,8475170,Brayden Schenn,C,STL,33,82,21,28,49
14,8482665,Matty Beniers,C,SEA,22,82,20,29,49
14,8479992,Michael Rasmussen,C,DET,25,82,19,30,49
14,8477479,Tyler Bertuzzi,L,CHI,29,82,17,32,49
14,8475218,Mattias Ekholm,D,EDM,34,82,16,33,49
14,8482671,Owen Power,D,BUF,22,82,11,38,49
14,8474565,Alex Pietrangelo,D,VGK,34,82,10,39,49
14,8478397,Rasmus Andersson,D,CGY,28,82,10,39,49
14,8482740,Wyatt Johnston,C,DAL,21,82,29,19,48
14,8480064,Josh Norris,C,OTT,25,82,27,21,48
14,8481596,Shane Pinto,C,OTT,24,82,20,28,48
14,8475793,Ryan Johansen,C,PHI,32,82,19,29,48
14,8477497,Sean Monahan,C,CBJ,30,82,18,30,48
14,8476458,Ryan Strome,C,ANA,31,82,12,36,48
14,8479325,Charlie McAvoy,D,BOS,27,82,8,40,48
14,8482110,Dawson Mercer,C,NJD,23,82,25,22,47
14,8478498,Jake DeBrusk,L,VAN,28,82,23,24,47
14,8475714,Calle Jarnkrok,C,TOR,33,82,23,24,47
14,8478462,Nicolas Roy,C,VGK,27,82,23,24,47
14,8476872,Scott Laughton,C,PHI,30,82,19,28,47
14,8480798,Philipp Kurashev,C,CHI,25,82,21,25,46
14,8478472,Mathieu Joseph,R,STL,27,82,19,27,46
14,8484144,Connor Bedard,C,CHI,19,82,19,27,46
14,8477986,Brandon Montour,D,SEA,30,82,11,35,46
14,8478407,Vince Dunn,D,SEA,28,82,10,36,46
14,8475191,Reilly Smith,R,NYR,33,82,23,22,45
14,8480829,Jesperi Kotkaniemi,C,CAR,24,82,19,26,45
14,8480028,Morgan Frost,C,PHI,25,82,18,27,45
14,8477498,Darnell Nurse,D,EDM,29,82,12,33,45
14,8479385,Jordan Kyrou,C,STL,26,82,23,21,44
14,8482055,Drew O'Connor,L,PIT,26,82,21,23,44
14,8481582,Nicholas Robertson,L,TOR,23,82,18,26,44
14,8482705,Cole Sillinger,C,CBJ,21,82,17,27,44
14,8478055,Gustav Forsling,D,FLA,28,82,16,28,44
14,8475753,Justin Faulk,D,STL,32,82,11,33,44
14,8476392,Adam Lowry,C,WPG,31,82,11,33,44
14,8474150,Mikael Backlund,C,CGY,35,82,10,34,44
14,8475193,Tomas Tatar,L,NJD,34,82,24,19,43
14,8477426,Nicholas Paul,L,TBL,29,82,20,23,43
14,8479987,Morgan Geekie,C,BOS,26,82,19,24,43
14,8477456,J.T. Compher,L,DET,29,82,17,26,43
14,8478463,Anthony Beauvillier,L,PIT,27,82,16,27,43
14,8478458,Jack Roslovic,C,CAR,27,82,15,28,43
14,8477495,Seth Jones,D,CHI,30,82,12,31,43
14,8482105,Jake Sanderson,D,OTT,22,82,12,31,43
14,8475764,Cam Fowler,D,ANA,33,82,4,39,43
14,8481560,Arthur Kaliyev,R,LAK,23,82,26,16,42
14,8475848,Brendan Gallagher,R,MTL,32,82,26,16,42
14,8478046,Danton Heinen,L,VAN,29,82,24,18,42
14,8475722,Jason Zucker,L,BUF,32,82,23,19,42
14,8477407,Anthony Duclair,L,NYI,29,82,22,20,42
14,8471698,T.J. Oshie,R,WSH,38,82,19,23,42
14,8479400,Pierre-Luc Dubois,L,WSH,26,82,18,24,42
14,8478891,Mason Appleton,C,WPG,28,82,18,24,42
14,8481554,Kaapo Kakko,R,NYR,23,82,17,25,42
14,8475287,Erik Haula,L,NJD,33,82,15,27,42
14,8482720,Matthew Knies,L,TOR,22,82,15,27,42
14,8478413,Jordan Greenway,L,BUF,27,82,13,29,42
14,8474716,Jared Spurgeon,D,MIN,35,82,10,32,42
14,8476923,Damon Severson,D,CBJ,30,82,6,36,42
14,8480893,Kirill Marchenko,R,CBJ,24,82,27,14,41
14,8477952,Robby Fabbri,C,ANA,28,82,20,21,41
14,8475768,Jaden Schwartz,C,SEA,32,82,20,21,41
14,8479390,Taylor Raddysh,R,WSH,26,82,19,22,41
14,8478233,Andrew Mangiapane,L,WSH,28,82,16,25,41
14,8479345,Jakob Chychrun,D,WSH,26,82,13,28,41
14,8475149,Marcus Johansson,L,MIN,34,82,12,29,41
14,8474189,Lars Eller,C,PIT,35,82,12,29,41
14,8478856,Conor Garland,R,VAN,28,82,11,30,41
14,8476885,Jacob Trouba,D,NYR,30,82,9,32,41
14,8474053,Logan Couture,C,SJS,35,82,19,21,40
14,8477021,Alex Kerfoot,C,UTA,30,82,18,22,40
14,8482133,Thomas Bordeleau,C,SJS,22,82,13,27,40
14,8476792,Torey Krug,D,STL,33,82,12,28,40
14,8477948,Travis Sanheim,D,PHI,28,82,5,35,40
14,8483431,Logan Cooley,C,UTA,20,82,27,12,39
14,8481580,Connor McMichael,C,WSH,23,82,25,14,39
14,8482089,Jake Neighbours,L,STL,22,82,25,14,39
14,8481553,Bobby Brink,R,PHI,23,82,19,20,39
14,8476292,Ondrej Palat,L,NJD,33,82,14,25,39
14,8470613,Brent Burns,D,CAR,39,82,12,27,39
14,8480871,Adam Boqvist,D,FLA,24,82,12,27,39
14,8476979,Erik Gustafsson,D,DET,32,82,9,30,39
14,8478500,Ivan Provorov,D,CBJ,27,82,4,35,39
14,8479661,Tanner Jeannot,L,LAK,27,82,22,16,38
14,8479365,Trent Frederic,C,BOS,26,82,18,20,38
14,8476419,Jean-Gabriel Pageau,C,NYI,32,82,17,21,38
14,8482475,Yegor Chinakhov,R,CBJ,23,82,16,22,38
14,8470621,Corey Perry,R,EDM,39,82,16,22,38
14,8476927,Teddy Blueger,C,VAN,30,82,14,24,38
14,8476958,Jaccob Slavin,D,CAR,30,82,4,34,38
14,8479293,Brandon Tanev,L,SEA,33,82,20,17,37
14,8479996,Cody Glass,C,NSH,25,82,19,18,37
14,8473422,Nick Foligno,L,CHI,37,82,18,19,37
14,8478115,Pierre Engvall,L,NYI,28,82,18,19,37
14,8476854,Hampus Lindholm,D,BOS,30,82,8,29,37
14,8481581,Thomas Harley,D,DAL,23,82,7,30,37
14,8477987,Ryan Donato,C,CHI,28,82,17,19,36
14,8478432,Christian Fischer,R,DET,27,82,17,19,36
14,8480459,Pius Suter,C,VAN,28,82,16,20,36
14,8476918,Jimmy Vesey,L,NYR,31,82,16,20,36
14,8480789,Oliver Wahlstrom,R,NYI,24,82,14,22,36
14,8475745,Charlie Coyle,C,BOS,32,82,13,23,36
14,8481535,Nils Hoglander,L,VAN,24,82,13,23,36
14,8482660,Kent Johnson,C,CBJ,22,82,12,24,36
14,8482684,Luke Hughes,D,NJD,21,82,6,30,36
14,8480873,Rasmus Sandin,D,WSH,24,82,2,34,36
14,8481068,Yegor Sharangovich,C,CGY,26,82,19,16,35
14,8482117,Lukas Reichel,L,CHI,22,82,19,16,35
14,8478057,Dakota Joshua,C,VAN,28,82,17,18,35
14,8477947,Sonny Milano,L,WSH,28,82,16,19,35
14,8476897,Oskar Sundqvist,C,STL,30,82,15,20,35
14,8477935,Sam Bennett,C,FLA,28,82,14,21,35
14,8475760,Nick Bjugstad,C,UTA,32,82,14,21,35
14,8480074,Alexandre Texier,C,STL,25,82,14,21,35
14,8483457,Lane Hutson,D,MTL,20,82,10,25,35
14,8478133,Jake Evans,C,MTL,28,82,9,26,35
14,8476917,Adam Pelech,D,NYI,30,82,9,26,35
14,8480043,Timothy Liljegren,D,TOR,25,82,7,28,35
14,8478882,Vladislav Gavrikov,D,LAK,29,82,6,29,35
14,8482259,Bobby McMann,C,TOR,28,82,21,13,34
14,8476474,Stefan Noesen,R,NJD,31,82,15,19,34
14,8476461,Sean Couturier,C,PHI,32,82,14,20,34
14,8480113,Alex Iafallo,L,WPG,31,82,14,20,34
14,8480185,Eetu Luostarinen,C,FLA,26,82,14,20,34
14,8481522,Peyton Krebs,C,BUF,23,82,13,21,34
14,8478013,Jake Walman,D,SJS,28,82,13,21,34
14,8476925,Colton Sissons,C,NSH,31,82,10,24,34
14,8475171,Oliver Ekman-Larsson,D,TOR,33,82,9,25,34
14,8476902,Esa Lindell,D,DAL,30,82,7,27,34
14,8475181,Nick Leddy,D,STL,33,82,4,30,34
14,8482146,Luke Evangelista,R,NSH,22,82,19,14,33
14,8481624,Ilya Mikheyev,R,CHI,30,82,18,15,33
14,8480009,Eeli Tolvanen,R,SEA,25,82,17,16,33
14,8479591,Michael Eyssimont,C,TBL,28,82,16,17,33
14,8482079,Marco Rossi,C,MIN,23,82,16,17,33
14,8482175,JJ Peterka,R,BUF,22,82,14,19,33
14,8481186,Logan O'Connor,R,COL,28,82,12,21,33
14,8480817,K'Andre Miller,D,NYR,24,82,7,26,33
14,8478911,Matt Roy,D,WSH,29,82,5,28,33
14,8476457,Adam Larsson,D,SEA,32,82,5,28,33
14,8482122,Brock Faber,D,MIN,22,82,4,29,33
14,8481604,Pavel Dorofeyev,L,VGK,24,82,21,11,32
14,8484166,Adam Fantilli,C,CBJ,20,82,16,16,32
14,8476624,Barclay Goodrow,C,SJS,31,82,15,17,32
14,8476480,Vladislav Namestnikov,C,WPG,32,82,9,23,32
14,8476329,Travis Boyd,C,MIN,31,82,9,23,32
14,8475188,Brayden McNabb,D,VGK,33,82,8,24,32
14,8475200,Dmitry Orlov,D,CAR,33,82,8,24,32
14,8479398,Samuel Girard,D,COL,26,82,5,27,32
14,8480145,Neal Pionk,D,WPG,29,82,3,29,32
14,8482245,Artem Zub,D,OTT,29,82,2,30,32
14,8482092,Ridly Greig,C,OTT,22,82,19,12,31
14,8480849,Barrett Hayton,C,UTA,24,82,16,15,31
14,8478109,Victor Olofsson,L,VGK,29,82,14,17,31
14,8477425,Miles Wood,L,COL,29,82,14,17,31
14,8480802,Ryan McLeod,C,BUF,25,82,12,19,31
14,8475231,Casey Cizikas,C,NYI,33,82,9,22,31
14,8476892,Colton Parayko,D,STL,31,82,5,26,31
14,8483490,Pavel Mintyukov,D,ANA,21,82,3,28,31
14,8482142,Jamie Drysdale,D,PHI,22,82,2,29,31
14,8478569,Noel Acciari,C,PIT,33,82,20,10,30
14,8482125,Alexander Holtz,R,VGK,22,82,18,12,30
14,8476469,Joel Armia,R,MTL,31,82,18,12,30
14,8476981,Josh Anderson,R,MTL,30,82,17,13,30
14,8479525,Ross Colton,C,COL,28,82,15,15,30
14,8476278,Colin Blackwell,C,DAL,31,82,15,15,30
14,8482702,Logan Stankoven,C,DAL,21,82,15,15,30
14,8477839,Conor Sheary,L,TBL,32,82,13,17,30
14,8480068,Ryan Poehling,C,PHI,25,82,11,19,30
14,8476422,Mike Reilly,D,NYI,31,82,8,22,30
14,8475855,Jesper Fast,R,CAR,33,82,8,22,30
14,8477429,Andrew Copp,C,DET,30,82,7,23,30
14,8477506,Ryan Pulock,D,NYI,30,82,7,23,30
14,8479980,Nicolas Hague,D,VGK,26,82,2,28,30
14,8477450,Jason Dickinson,C,CHI,29,82,17,12,29
14,8477903,Garnet Hathaway,R,PHI,33,82,17,12,29
14,8475842,Sam Carrick,C,NYR,32,82,14,15,29
14,8481656,Aliaksei Protas,C,WSH,23,82,12,17,29
14,8473533,Jordan Staal,C,CAR,36,82,11,18,29
14,8479316,Luke Kunin,C,SJS,27,82,11,18,29
14,8482111,Justin Barron,D,MTL,23,82,9,20,29
14,8473563,Nicklas Backstrom,C,WSH,37,82,6,23,29
14,8478136,Jake Middleton,D,MIN,28,82,2,27,29
14,8479393,Noah Gregor,C,OTT,26,82,19,9,28
14,8481032,Paul Cotter,C,NJD,25,82,15,13,28
14,8476374,Sean Kuraly,C,CBJ,31,82,15,13,28
14,8481093,Rafael Harvey-Pinard,L,MTL,25,82,13,15,28
14,8480995,Pontus Holmberg,R,TOR,25,82,13,15,28
14,8476873,Mark Jankowski,C,NSH,30,82,10,18,28
14,8477015,Connor Brown,R,EDM,30,82,10,18,28
14,8483495,Simon Nemec,D,NJD,20,82,9,19,28
14,8476463,Jonas Brodin,D,MIN,31,82,8,20,28
14,8480336,Sean Walker,D,CAR,30,82,7,21,28
14,8477969,Marcus Pettersson,D,PIT,28,82,3,25,28
14,8474151,Ryan McDonagh,D,TBL,35,82,3,25,28
14,8480172,Jan Rutta,D,SJS,34,82,2,26,28
14,8476931,Jake McCabe,D,TOR,31,82,1,27,28
14,8482077,Dylan Holloway,L,EDM,23,82,15,12,27
14,8479941,Justin Danforth,R,CBJ,31,82,14,13,27
14,8480855,Jack McBain,C,UTA,24,82,14,13,27
14,8473453,Trevor Lewis,C,LAK,37,82,14,13,27
14,8477989,Christian Dvorak,C,MTL,28,82,12,15,27
14,8484153,Leo Carlsson,C,ANA,20,82,12,15,27
14,8482166,Shakir Mukhamadullin,D,SJS,22,82,11,16,27
14,8481704,Juuso Parssinen,C,NSH,23,82,10,17,27
14,8477953,Kasperi Kapanen,R,STL,28,82,10,17,27
14,8474715,Cam Atkinson,R,TBL,35,82,10,17,27
14,8480748,Kiefer Sherwood,L,VAN,29,82,8,19,27
14,8481708,Zac Jones,D,NYR,24,82,7,20,27
14,8476891,Matt Grzelcyk,D,PIT,30,82,3,24,27
14,8478020,Michael Amadio,C,OTT,28,82,16,10,26
14,8482624,Daniil Miromanov,D,CGY,27,82,16,10,26
14,8481477,Nico Sturm,C,SJS,29,82,14,12,26
14,8484145,Zach Benson,L,BUF,19,82,14,12,26
14,8481481,Blake Lizotte,C,PIT,27,82,12,14,26
14,8477919,Frederick Gaudreau,C,MIN,31,82,11,15,26
14,8477931,Tomas Nosek,L,FLA,32,82,11,15,26
14,8480813,Joe Veleno,C,DET,24,82,10,16,26
14,8479353,Brett Howden,C,VGK,26,82,8,18,26
14,8476921,Jordan Martinook,L,CAR,32,82,8,18,26
14,8483763,Maksymilian Szuber,D,UTA,22,82,5,21,26
14,8478507,John Marino,D,UTA,27,82,3,23,26
14,8476467,Jamie Oleksiak,D,SEA,32,82,3,23,26
14,8475324,Nick Jensen,D,OTT,34,82,2,24,26
14,8475455,Brenden Dillon,D,NJD,34,82,1,25,26
14,8481013,Jonatan Berggren,R,DET,24,82,14,11,25
14,8477508,Curtis Lazar,C,NJD,29,82,12,13,25
14,8475343,Nic Dowd,C,WSH,34,82,12,13,25
14,8475220,Marcus Foligno,L,MIN,33,82,9,16,25
14,8480980,Connor Dewar,C,TOR,25,82,7,18,25
14,8477220,Nate Schmidt,D,FLA,33,82,5,20,25
14,8480003,Jesper Boqvist,C,FLA,26,82,5,20,25
14,8474574,Tyler Myers,D,VAN,34,82,5,20,25
14,8480222,Sebastian Aho,D,PIT,28,82,4,21,25
14,8479983,Mario Ferraro,D,SJS,26,82,3,22,25
14,8480049,Dylan Samberg,D,WPG,25,82,2,23,25
14,8476858,Phillip Di Giuseppe,L,VAN,31,82,17,7,24
14,8480448,Parker Kelly,L,COL,25,82,12,12,24
14,8480806,Isac Lundestrom,C,ANA,25,82,12,12,24
14,8477353,Tyler Motte,C,DET,29,82,11,13,24
14,8480835,Jack Drury,C,CAR,24,82,10,14,24
14,8477507,Nikita Zadorov,D,BOS,29,82,10,14,24
14,8483445,Cutter Gauthier,L,ANA,20,82,9,15,24
14,8482733,Logan Mailloux,D,MTL,31,82,9,15,24
14,8481517,Brett Leason,R,ANA,25,82,8,16,24
14,8475718,Justin Holl,D,DET,32,82,5,19,24
14,8475462,Radko Gudas,D,ANA,34,82,4,20,24
14,8473507,Jeff Petry,D,DET,37,82,3,21,24
14,8478840,Will Borgen,D,SEA,28,82,3,21,24
14,8483524,Shane Wright,C,SEA,20,82,11,12,23
14,8476442,Matt Nieto,L,PIT,32,82,11,12,23
14,8481606,Jordan Spence,D,LAK,23,82,10,13,23
14,8482858,Ryker Evans,D,SEA,23,82,7,16,23
14,8482141,Lukas Cormier,D,VGK,22,82,6,17,23
14,8476372,Nick Seeler,D,PHI,31,82,5,18,23
14,8476967,Brett Kulak,D,EDM,30,82,5,18,23
14,8481568,Alex Vlasic,D,CHI,23,82,3,20,23
14,8480073,Erik Brannstrom,D,COL,25,82,3,20,23
14,8479368,Max Jones,L,BOS,26,82,16,6,22
14,8481601,Simon Holmstrom,R,NYI,23,82,14,8,22
14,8480281,Alexey Toropchenko,R,STL,25,82,13,9,22
14,8480025,MacKenzie Entwistle,R,FLA,25,82,9,13,22
14,8478434,Keegan Kolesar,R,VGK,27,82,8,14,22
14,8480878,Nils Lundkvist,D,DAL,24,82,7,15,22
14,8477369,Carson Soucy,D,VAN,30,82,6,16,22
14,8480834,Ty Emberson,D,SJS,24,82,5,17,22
14,8477435,Ryan Graves,D,PIT,29,82,3,19,22
14,8481014,Alexander Romanov,D,NYI,24,82,2,20,22
14,8481028,Martin Pospisil,C,CGY,25,82,11,10,21
14,8483012,Logan Morrison,C,SEA,22,82,10,11,21
14,8476960,Andreas Athanasiou,C,CHI,30,82,9,12,21
14,8482666,Scott Morrow,D,CAR,22,82,8,13,21
14,8483505,Matthew Poitras,C,BOS,20,82,8,13,21
14,8479351,Sam Steel,C,DAL,26,82,7,14,21
14,8482073,Braden Schneider,D,NYR,23,82,6,15,21
14,8479324,Ryan Lindgren,D,NYR,26,82,6,15,21
14,8481178,Egor Zamula,D,PHI,24,82,5,16,21
14,8478443,Brandon Carlo,D,BOS,28,82,5,16,21
14,8482655,J.J. Moser,D,TBL,24,82,4,17,21
14,8483468,Jiri Kulich,C,BUF,20,82,4,17,21
14,8476889,Radek Faksa,C,STL,30,82,4,17,21
14,8479976,Juuso Valimaki,D,UTA,26,82,3,18,21
14,8480860,Kevin Bahl,D,CGY,24,82,3,18,21
14,8480796,Martin Fehervary,D,WSH,25,82,3,18,21
14,8474673,TJ Brodie,D,CHI,34,82,2,19,21
14,8476822,Luke Glendening,C,TBL,35,82,10,10,20
14,8482659,Josh Doan,R,UTA,22,82,10,10,20
14,8484149,Gavin Brindley,C,CBJ,20,82,7,13,20
14,8480144,David Kampf,C,TOR,29,82,6,14,20
14,8477392,Hudson Fasching,R,NYI,29,82,5,15,20
14,8475279,Ben Chiarot,D,DET,33,82,5,15,20
14,8480035,Henri Jokiharju,D,BUF,25,82,5,15,20
14,8479402,Jake Bean,D,CGY,26,82,4,16,20
14,8479369,Andrew Peeke,D,BOS,26,82,4,16,20
14,8475790,Erik Gudbranson,D,CBJ,32,82,4,16,20
14,8483482,Tristan Luneau,D,ANA,20,82,3,17,20
14,8476429,Scott Mayfield,D,NYI,32,82,3,17,20
14,8476331,Dylan DeMelo,D,WPG,31,82,2,18,20
14,8477488,Brett Pesce,D,NJD,30,82,2,18,20
14,8476878,Zemgus Girgensons,L,TBL,30,82,9,10,19
14,8482803,Olen Zellweger,D,ANA,21,82,9,10,19
14,8477505,Alexander Wennberg,C,SJS,30,82,9,10,19
14,8482153,Brendan Brisson,C,VGK,23,82,8,11,19
14,8478450,Parker Wotherspoon,D,BOS,27,82,7,12,19
14,8479442,Troy Stecher,D,EDM,30,82,6,13,19
14,8480246,Nick Perbix,D,TBL,26,82,4,15,19
14,8482101,Danil Gushchin,L,SJS,22,82,4,15,19
14,8477335,Kyle Burroughs,D,LAK,29,82,4,15,19
14,8477845,Trevor van Riemsdyk,D,WSH,33,82,3,16,19
14,8478859,Niko Mikkola,D,FLA,28,82,1,18,19
14,8482074,Connor Zary,C,CGY,23,82,13,5,18
14,8478508,Yakov Trenin,C,MIN,27,82,12,6,18
14,8479414,Nathan Bastian,R,NJD,27,82,9,9,18
14,8483493,Frank Nazar,C,CHI,20,82,8,10,18
14,8481567,Henry Thrun,D,SJS,23,82,7,11,18
14,8479371,Dante Fabbro,D,NSH,26,82,6,12,18
14,8478211,Dryden Hunt,L,CGY,29,82,5,13,18
14,8480807,Mattias Samuelsson,D,BUF,24,82,4,14,18
14,8476879,Cody Ceci,D,EDM,31,82,2,16,18
14,8478851,Alexandre Carrier,D,NSH,28,82,2,16,18
14,8482762,Simon Edvinsson,D,DET,21,82,8,9,17
14,8481641,Joel Kiviranta,L,COL,28,82,8,9,17
14,8480021,Jack Studnicka,C,LAK,25,82,7,10,17
14,8482470,Ilya Solovyov,D,CGY,24,82,6,11,17
14,8479291,Kevin Rooney,C,CGY,31,82,6,11,17
14,8481605,Jackson LaCombe,D,ANA,23,82,5,12,17
14,8483460,David Jiricek,D,CBJ,21,82,4,13,17
14,8482516,Matthew Kessel,D,STL,24,82,3,14,17
14,8480879,Jacob Bernard-Docker,D,OTT,24,82,2,15,17
14,8476525,Colin Miller,D,WPG,32,82,1,16,17
14,8479998,Mikey Anderson,D,LAK,25,82,1,16,17
14,8476312,Josh Manson,D,COL,33,82,8,8,16
14,8477406,Mattias Janmark,C,EDM,32,82,8,8,16
14,8482062,Cole Smith,L,NSH,29,82,7,9,16
14,8481699,Aku Raty,R,UTA,23,82,6,10,16
14,8482087,Kaiden Guhle,D,MTL,22,82,4,12,16
14,8483565,Nick Blankenburg,D,NSH,26,82,4,12,16
14,8477365,Connor Clifton,D,BUF,29,82,4,12,16
14,8483471,Brad Lambert,C,WPG,31,82,4,12,16
14,8482145,Mavrik Bourque,C,DAL,22,82,3,13,16
14,8474567,Zach Bogosian,D,MIN,34,82,3,13,16
14,8478416,Erik Cernak,D,TBL,27,82,1,15,16
14,8482809,Jackson Blake,R,CAR,21,82,8,7,15
14,8484203,Bradly Nadeau,L,CAR,19,82,7,8,15
14,8471677,Jack Johnson,D,CBJ,37,82,7,8,15
14,8478399,Jonas Siegenthaler,D,NJD,27,82,4,11,15
14,8475233,David Savard,D,MTL,34,82,3,12,15
14,8480990,Declan Chisholm,D,MIN,24,82,3,12,15
14,8477499,Rasmus Ristolainen,D,PHI,30,82,2,13,15
14,8480950,Ilya Lyubushkin,D,DAL,30,82,2,13,15
14,8475690,Chris Tanev,D,TOR,35,82,1,14,15
14,8482070,Mitchell Chaffee,R,TBL,26,82,8,6,14
14,8482118,Sam Colangelo,R,ANA,23,82,7,7,14
14,8482155,Alex Laferriere,R,LAK,23,82,6,8,14
14,8484911,Collin Graf,R,SJS,22,82,6,8,14
14,8481122,Simon Benoit,D,TOR,26,82,4,10,14
14,8478468,Jeremy Lauzon,D,NSH,27,82,4,10,14
14,8470600,Ryan Suter,D,STL,39,82,0,14,14
14,8482749,Joshua Roy,R,MTL,21,82,8,5,13
14,8482679,Matt Coronato,R,CGY,22,82,7,6,13
14,8479359,Beck Malenstyn,L,BUF,26,82,6,7,13
14,8475762,Derek Forbort,D,VAN,32,82,4,9,13
14,8474013,Ian Cole,D,UTA,35,82,0,13,13
14,8483397,Marc McLaughlin,C,BOS,25,82,7,5,12
14,8482712,Oskar Olausson,R,COL,22,82,6,6,12
14,8481524,Bowen Byram,D,BUF,23,82,4,8,12
14,8483499,Liam Ohgren,L,MIN,20,82,3,9,12
14,8474090,Brendan Smith,D,DAL,35,82,2,10,12
14,8482859,Zack Ostapchuk,C,OTT,21,82,4,7,11
14,8474612,Travis Hamonic,D,OTT,34,82,3,8,11
14,8476441,Joel Edmundson,D,LAK,31,82,3,8,11
14,8482807,Ethan Del Mastro,D,CHI,21,82,3,8,11
14,8480870,Bo Groulx,C,NYR,24,82,2,9,11
14,8476473,Connor Murphy,D,CHI,31,82,2,9,11
14,8475177,Calvin de Haan,D,COL,33,82,2,9,11
14,8482787,Nikita Chibrikov,R,WPG,31,82,5,5,10
14,8479638,Justin Brazeau,R,BOS,26,82,4,6,10
14,8477034,Jaycob Megna,D,FLA,32,82,1,9,10
14,8479576,Vincent Desharnais,D,VAN,28,82,1,9,10
14,8478178,Darren Raddysh,D,TBL,28,82,0,10,10
14,8478874,Adam Gaudette,C,OTT,28,82,0,10,10
14,8483489,Fraser Minten,C,TOR,31,82,4,5,9
14,8477938,Haydn Fleury,D,WPG,28,82,3,6,9
14,8483567,Georgii Merkulov,C,BOS,24,82,2,7,9
14,8483466,Kevin Korchinski,D,CHI,20,82,1,6,7
14,8482713,Mackie Samoskevich,R,FLA,22,82,3,3,6
14,8474062,Riley Nash,C,NYR,35,82,1,5,6
14,8470794,Joe Pavelski,C,,40,0,0,0,0
14,8481703,Valtteri Puustinen,R,PIT,25,0,0,0,0
14,8477950,Tony DeAngelo,D,,29,0,0,0,0
14,8481577,Philip Tomasino,C,NSH,23,0,0,0,0
14,8475197,Tyson Barrie,D,,33,0,0,0,0
14,8471218,Blake Wheeler,R,,38,0,0,0,0
14,8474157,Max Pacioretty,L,,36,0,0,0,0
14,8478466,Daniel Sprong,R,VAN,27,0,0,0,0
14,8475744,Evgeny Kuznetsov,C,,32,0,0,0,0
14,8481019,David Gustafsson,C,WPG,24,0,0,0,0
14,8475906,John Klingberg,D,,32,0,0,0,0
14,8479348,Kale Clague,D,BUF,26,0,0,0,0
14,8476952,Dominic Toninato,C,WPG,30,0,0,0,0
14,8473473,Milan Lucic,L,,36,0,0,0,0
14,8474037,James van Riemsdyk,L,,35,0,0,0,0
14,8474602,Justin Schultz,D,,34,0,0,0,0
14,8482222,Alexander Barabanov,L,,30,0,0,0,0
14,8479372,Josh Mahura,D,SEA,26,0,0,0,0
14,8479982,Conor Timmins,D,TOR,26,0,0,0,0
14,8474031,Kevin Shattenkirk,D,,35,0,0,0,0
14,8480008,Adam Ruzicka,C,,25,0,0,0,0
14,8481059,Scott Perunovich,D,STL,26,0,0,0,0
14,8480884,Calen Addison,D,,24,0,0,0,0
14,8476994,Vinnie Hinostroza,C,NSH,30,0,0,0,0
14,8478452,Caleb Jones,D,LAK,27,0,0,0,0
14,8480157,Calle Rosen,D,COL,30,0,0,0,0
14,8481609,Vladislav Kolyachonok,D,UTA,23,0,0,0,0
14,8479415,Michael McLeod,C,,26,0,0,0,0
14,8476919,Chris Tierney,C,,30,0,0,0,0
14,8479639,Dylan Coghlan,D,WPG,26,0,0,0,0
14,8478146,Matthew Highmore,C,OTT,28,0,0,0,0
14,8478970,Jalen Chatfield,D,CAR,28,0,0,0,0
14,8480205,Emil Bemstrom,C,PIT,25,0,0,0,0
14,8474884,Mike Hoffman,C,,35,0,0,0,0
14,8471274,Alex Goligoski,D,,39,0,0,0,0
14,8478104,Sammy Blais,L,,28,0,0,0,0
14,8474870,Tyler Johnson,C,,34,0,0,0,0
14,8476913,Devin Shore,C,MIN,30,0,0,0,0
14,8481598,Philip Broberg,D,EDM,23,0,0,0,0
14,8480058,Pierre-Olivier Joseph,D,STL,25,0,0,0,0
14,8480891,Michael Kesselring,D,UTA,24,0,0,0,0
14,8477979,Nicolas Aube-Kubel,R,BUF,28,0,0,0,0
14,8476871,Tanner Pearson,L,,32,0,0,0,0
14,8476393,Nick Cousins,C,,31,0,0,0,0
14,8479977,Kailer Yamamoto,R,,26,0,0,0,0
14,8479543,Michael Pezzetta,L,MTL,26,0,0,0,0
14,8477018,Ben Hutton,D,VGK,31,0,0,0,0
14,8480762,Eric Robinson,L,CAR,29,0,0,0,0
14,8474034,Pat Maroon,L,CHI,36,0,0,0,0
14,8481058,Jesse Ylönen,R,,25,0,0,0,0
14,8475179,Dmitry Kulikov,D,FLA,34,0,0,0,0
14,8481527,Kaedan Korczak,D,VGK,23,0,0,0,0
14,8473449,Kyle Okposo,R,,36,0,0,0,0
14,8482192,Isaak Phillips,D,CHI,23,0,0,0,0
14,8480727,Zach Whitecloud,D,VGK,28,0,0,0,0
14,8479346,Dillon Dube,C,,26,0,0,0,0
14,8480821,Filip Zadina,R,,25,0,0,0,0
14,8480001,Urho Vaakanainen,D,ANA,25,0,0,0,0
14,8470966,Mark Giordano,D,,41,0,0,0,0
14,8480853,Liam Foudy,C,,24,0,0,0,0
14,8475225,Craig Smith,C,CHI,35,0,0,0,0
14,8479972,Mason Shaw,C,WPG,26,0,0,0,0
14,8478451,Ethan Bear,D,WSH,27,0,0,0,0
14,8474040,Sam Gagner,C,,35,0,0,0,0
14,8480196,Jacob Bryson,D,BUF,27,0,0,0,0
14,8479984,Cal Foote,D,,26,0,0,0,0
14,8480011,Klim Kostin,C,SJS,25,0,0,0,0
14,8482176,Wyatt Kaiser,D,CHI,22,0,0,0,0
14,8476988,Matt Benning,D,SJS,30,0,0,0,0
14,8479370,Tyson Jost,C,CAR,26,0,0,0,0
14,8477464,Nic Petan,C,,29,0,0,0,0
14,8477380,Jonny Brodzinski,C,NYR,31,0,0,0,0
14,8480070,Ian Mitchell,D,BOS,25,0,0,0,0
14,8479315,Joey Anderson,R,CHI,26,0,0,0,0
14,8478099,Kevin Labanc,R,,29,0,0,0,0
14,8476874,Olli Maatta,D,DET,30,0,0,0,0
14,8475208,Brian Dumoulin,D,ANA,33,0,0,0,0
14,8478430,Oliver Kylington,D,,27,0,0,0,0
14,8479536,Axel Jonsson-Fjallby,L,WPG,26,0,0,0,0
14,8479671,Mathieu Olivier,R,CBJ,27,0,0,0,0
14,8471709,Marc-Edouard Vlasic,D,SJS,37,0,0,0,0
14,8479328,Julien Gauthier,R,NYI,27,0,0,0,0
14,8478421,A.J. Greer,L,FLA,28,0,0,0,0
14,8477573,Nathan Walker,L,STL,30,0,0,0,0
14,8481537,Nikita Okhotiuk,D,CGY,24,0,0,0,0
14,8474166,Alec Martinez,D,CHI,37,0,0,0,0
14,8470610,Zach Parise,L,,40,0,0,0,0
14,8477478,William Carrier,L,CAR,30,0,0,0,0
14,8479344,Jesse Puljujarvi,R,PIT,26,0,0,0,0
14,8480887,Jordan Harris,D,MTL,24,0,0,0,0
14,8478502,Dennis Gilbert,D,BUF,28,0,0,0,0
14,8482730,Brandt Clarke,D,LAK,21,0,0,0,0
14,8480355,Mark Kastelic,C,BOS,25,0,0,0,0
14,8475750,Jon Merrill,D,MIN,32,0,0,0,0
14,8475164,Jakob Silfverberg,R,,34,0,0,0,0
14,8477944,Jakub Vrana,L,,28,0,0,0,0
14,8479439,Jacob MacDonald,D,COL,31,0,0,0,0
14,8474568,Luke Schenn,D,NSH,35,0,0,0,0
14,8478454,Noah Juulsen,D,VAN,27,0,0,0,0
14,8475752,Tyler Pitlick,C,,33,0,0,0,0
14,8482148,Hendrix Lapierre,C,WSH,22,0,0,0,0
14,8481167,Brayden Pachal,D,CGY,25,0,0,0,0
14,8478043,Sam Lafferty,C,BUF,29,0,0,0,0
14,8479321,Lucas Johansen,D,,27,0,0,0,0
14,8471699,Andrew Cogliano,C,,37,0,0,0,0
14,8481521,Ronnie Attard,D,PHI,25,0,0,0,0
14,8481161,Jake Christiansen,D,CBJ,25,0,0,0,0
14,8479458,Nikita Zaitsev,D,,33,0,0,0,0
14,8479619,Michael Carcone,L,UTA,28,0,0,0,0
14,8479026,Philippe Myers,D,TOR,27,0,0,0,0
14,8477330,Dominik Kubalik,L,,29,0,0,0,0
14,8481617,Vasily Podkolzin,R,VAN,23,0,0,0,0
14,8481701,Santeri Hatakka,D,NJD,23,0,0,0,0
14,8479514,Rem Pitlick,C,,27,0,0,0,0
14,8477446,Michael McCarron,R,NSH,29,0,0,0,0
14,8470604,Jeff Carter,C,,39,0,0,0,0
14,8482241,Radim Zohorna,L,,28,0,0,0,0
14,8480289,Morgan Barron,C,WPG,26,0,0,0,0
14,8479379,Givani Smith,R,SJS,26,0,0,0,0
14,8480216,Jacob Peterson,C,,25,0,0,0,0
14,8477851,Jordan Oesterle,D,BOS,32,0,0,0,0
14,8484258,Sam Malinski,D,COL,26,0,0,0,0
14,8478904,Steven Lorentz,C,,28,0,0,0,0
14,8482095,Tyler Kleven,D,OTT,22,0,0,0,0
14,8480848,Ty Dellandrea,C,SJS,24,0,0,0,0
14,8476884,Derrick Pouliot,D,,30,0,0,0,0
14,8479336,Carl Grundstrom,R,SJS,27,0,0,0,0
14,8482964,Arber Xhekaj,D,MTL,23,0,0,0,0
14,8471686,Marc Staal,D,,37,0,0,0,0
14,8477887,Patrick Brown,C,BOS,32,0,0,0,0
14,8478495,Denis Gurianov,R,,27,0,0,0,0
14,8473504,Cal Clutterbuck,R,,37,0,0,0,0
14,8481550,Adam Beckman,L,NJD,23,0,0,0,0
14,8480845,Rasmus Kupari,C,WPG,24,0,0,0,0
14,8474009,Nick Bonino,C,,36,0,0,0,0
14,8478585,Derek Ryan,C,EDM,38,0,0,0,0
14,8477962,Brendan Lemieux,L,CAR,28,0,0,0,0
14,8482861,Vincent Iorio,D,WSH,22,0,0,0,0
14,8479378,Logan Stanley,D,WPG,26,0,0,0,0
14,8473446,Erik Johnson,D,PHI,36,0,0,0,0
14,8481743,Marc Del Gaizo,D,NSH,25,0,0,0,0
14,8477384,Josh Brown,D,EDM,30,0,0,0,0
14,8482165,Yan Kuznetsov,D,CGY,22,0,0,0,0
14,8478424,Jansen Harkins,C,ANA,27,0,0,0,0
14,8482144,Jack Thompson,D,SJS,22,0,0,0,0
14,8478512,Austin Czarnik,C,,32,0,0,0,0
14,8477527,Ross Johnston,L,ANA,30,0,0,0,0
14,8479383,Boris Katchouk,L,,26,0,0,0,0
14,8482094,Daemon Hunt,D,MIN,22,0,0,0,0
14,8481719,Maxwell Crozier,D,TBL,24,0,0,0,0
14,8480192,Johnathan Kovacevic,D,NJD,27,0,0,0,0
14,8479376,Victor Mete,D,,26,0,0,0,0
14,8482511,Mason Lohrei,D,BOS,23,0,0,0,0
14,8475825,Jani Hakanpää,D,,32,0,0,0,0
14,8478021,William Lagesson,D,DET,28,0,0,0,0
14,8475795,Dylan McIlrath,D,WSH,32,0,0,0,0
14,8477846,Ryan Carpenter,C,,33,0,0,0,0
14,8481056,Spencer Stastney,D,NSH,24,0,0,0,0
14,8481564,Ryan Johnson,D,BUF,23,0,0,0,0
14,8478017,Mark Friedman,D,VAN,29,0,0,0,0
14,8479320,Max Lajoie,D,SEA,27,0,0,0,0
14,8480075,Cameron Crotty,D,MIN,25,0,0,0,0
14,8484287,Cole McWard,D,VAN,23,0,0,0,0
14,8484254,Akito Hirose,D,VAN,25,0,0,0,0
14,8483407,Brandon Scanlin,D,NYR,25,0,0,0,0
14,8480274,Philip Kemp,D,EDM,25,0,0,0,0
14,8479522,Hardy Haman Aktell,D,WSH,26,0,0,0,0
14,8480007,Jonas Rondbjerg,R,VGK,25,0,0,0,0
14,8477454,Adam Erne,L,,29,0,0,0,0
14,8481679,Maxence Guenette,D,OTT,23,0,0,0,0
14,8480441,Trey Fix-Wolansky,R,CBJ,25,0,0,0,0
14,8483546,Marshall Rifai,D,TOR,26,0,0,0,0
14,8480084,Nick DeSimone,D,NJD,30,0,0,0,0
14,8481030,Jack St. Ivany,D,PIT,25,0,0,0,0
14,8481592,Jakob Pelletier,L,CGY,23,0,0,0,0
14,8478011,Louie Belpedio,D,PHI,28,0,0,0,0
14,8477930,Pierre-Edouard Bellemare,L,,39,0,0,0,0
14,8484321,Nikolas Matinpalo,D,OTT,26,0,0,0,0
14,8482067,Connor Mackey,D,NYR,28,0,0,0,0
14,8481806,Louis Crevier,D,CHI,23,0,0,0,0
14,8484326,Patrik Koch,D,UTA,28,0,0,0,0
14,8477971,Andreas Englund,D,LAK,28,0,0,0,0
14,8481751,Lukas Rousek,R,BUF,25,0,0,0,0
14,8481006,Tyler Tucker,D,STL,24,0,0,0,0
14,8476867,Brendan Gaunce,C,MIN,30,0,0,0,0
14,8479520,Brandon Duhaime,R,WSH,27,0,0,0,0
14,8477073,Kurtis MacDermid,L,NJD,30,0,0,0,0
14,8480874,Adam Ginning,D,PHI,24,0,0,0,0
14,8477473,Justin Bailey,R,SJS,29,0,0,0,0
14,8479066,Ryan Lomberg,L,CGY,30,0,0,0,0
14,8477070,Liam O'Brien,C,UTA,30,0,0,0,0
14,8474618,Marco Scandella,D,,34,0,0,0,0
14,8475797,Jarred Tinordi,D,,32,0,0,0,0
14,8481441,Joe Snively,C,DET,28,0,0,0,0
14,8477244,Chad Ruhwedel,D,NYR,34,0,0,0,0
14,8479772,Zack MacEwen,R,OTT,28,0,0,0,0
14,8481147,Reese Johnson,C,MIN,26,0,0,0,0
14,8481043,Cole Koepke,L,BOS,26,0,0,0,0
14,8483619,Filip Roos,D,OTT,25,0,0,0,0
14,8481541,Samuel Bolduc,D,NYI,24,0,0,0,0
14,8477810,Joel Hanley,D,CGY,33,0,0,0,0
14,8476907,Mackenzie MacEachern,L,,30,0,0,0,0
14,8482652,Walker Duehr,R,CGY,27,0,0,0,0
14,8477126,Jayson Megna,C,,34,0,0,0,0
14,8483398,Declan Carlile,D,TBL,31,0,0,0,0
14,8482929,Emil Lilleberg,D,TBL,23,0,0,0,0
14,8480880,Jakub Lauko,C,MIN,24,0,0,0,0
14,8480245,Olle Lycksell,R,PHI,25,0,0,0,0
14,8480252,Cole Guttman,C,CHI,25,0,0,0,0
14,8477467,Gustav Olofsson,D,SEA,30,0,0,0,0
14,8479968,Vinni Lettieri,C,BOS,29,0,0,0,0
14,8478400,Colin White,C,,27,0,0,0,0
14,8475755,Alexander Petrovic,D,DAL,32,0,0,0,0
14,8481812,Nikolai Knyzhov,D,,27,0,0,0,0
14,8481593,Jayden Struble,D,MTL,23,0,0,0,0
14,8481532,Alex Turcotte,C,LAK,23,0,0,0,0
14,8482126,Emil Andrae,D,PHI,31,0,0,0,0
14,8479944,Zach Aston-Reese,C,VGK,30,0,0,0,0
14,8471817,Ryan Reaves,R,TOR,37,0,0,0,0
14,8481206,John Ludvig,D,PIT,24,0,0,0,0
14,8481599,Victor Soderstrom,D,UTA,23,0,0,0,0
14,8480292,Carson Meyer,R,ANA,27,0,0,0,0
14,8482496,Nils Aman,C,VAN,24,0,0,0,0
14,8479718,Alex Barré-Boulet,C,MTL,27,0,0,0,0
14,8479994,Jaret Anderson-Dolan,C,WPG,25,0,0,0,0
14,8480184,Gustav Lindstrom,D,,26,0,0,0,0
14,8480890,Jan Jenik,R,OTT,24,0,0,0,0
14,8478067,Oskar Lindblom,L,,28,0,0,0,0
14,8476934,Brock McGinn,L,ANA,30,0,0,0,0
14,8479985,Cale Fleury,D,SEA,26,0,0,0,0
14,8484304,Uvis Balinskis,D,FLA,28,0,0,0,0
14,8479981,Jonah Gadjovich,L,FLA,26,0,0,0,0
14,8481716,Dmitri Voronkov,L,CBJ,24,0,0,0,0
14,8474709,Matt Martin,L,,35,0,0,0,0
14,8482634,Alex Steeves,C,TOR,25,0,0,0,0
14,8480823,Alexander Alexeyev,D,WSH,25,0,0,0,0
14,8477541,Dakota Mermis,D,TOR,30,0,0,0,0
14,8483491,Ivan Miroshnichenko,L,WSH,20,0,0,0,0
14,8478477,Mitchell Stephens,C,SEA,27,0,0,0,0
14,8481543,Nikita Alexandrov,C,STL,24,0,0,0,0
14,8479423,Alex Nylander,L,,26,0,0,0,0
14,8482451,Mikael Pyyhtia,L,CBJ,23,0,0,0,0
14,8478831,Kevin Stenlund,C,UTA,28,0,0,0,0
14,8480306,Grant Hutton,D,NYI,29,0,0,0,0
14,8478028,Fredrik Olofsson,L,,28,0,0,0,0
14,8477462,Robert Hagg,D,VGK,29,0,0,0,0
14,8477320,Anton Blidh,L,NYR,29,0,0,0,0
14,8482157,Will Cuylle,L,NYR,22,0,0,0,0
14,8482737,Zack Bolduc,C,STL,21,0,0,0,0
14,8481239,Samuel Fagemo,L,,24,0,0,0,0
14,8481600,Tobias Bjornfot,D,FLA,23,0,0,0,0
14,8478409,Anthony Richard,C,PHI,28,0,0,0,0
14,8474145,Robert Bortuzzo,D,,35,0,0,0,0
14,8475958,Michael Sgarbossa,C,WSH,32,0,0,0,0
14,8479986,Kole Lind,R,DAL,26,0,0,0,0
14,8479249,Andrew Poturalski,C,SJS,30,0,0,0,0
14,8479362,Riley Tufte,L,BOS,26,0,0,0,0
14,8479991,Jake Leschyshyn,C,NYR,25,0,0,0,0
14,8479587,Rhett Gardner,C,PHI,28,0,0,0,0
14,8482744,James Malatesta,L,CBJ,21,0,0,0,0
14,8478854,Ryan Shea,D,PIT,27,0,0,0,0
14,8481591,Sam Poulin,R,,23,0,0,0,0
14,8483512,Matt Savoie,C,EDM,20,0,0,0,0
14,8482102,Vasily Ponomarev,C,PIT,22,0,0,0,0
14,8482162,Roby Jarventie,L,EDM,22,0,0,0,0
14,8481016,Ruslan Iskhakov,C,,24,0,0,0,0
14,8482172,Landon Slaggert,L,CHI,22,0,0,0,0
14,8482747,Brennan Othmann,L,NYR,21,0,0,0,0
14,8480031,Maxime Comtois,L,,25,0,0,0,0
14,8480226,Marián Studenic,R,,26,0,0,0,0
14,8478408,Travis Dermott,D,,28,0,0,0,0
14,8481518,Nolan Foote,L,NJD,24,0,0,0,0
14,8479419,Brett Murray,L,BUF,26,0,0,0,0
14,8482088,Justin Sourdif,R,FLA,22,0,0,0,0
14,8482201,Gage Goncalves,C,TBL,23,0,0,0,0
14,8481578,Graeme Clarke,R,MIN,23,0,0,0,0
14,8482177,Marat Khusnutdinov,C,MIN,22,0,0,0,0
14,8481754,Nikita Nesterenko,C,ANA,23,0,0,0,0
14,8483531,Brian Halonen,L,NJD,25,0,0,0,0
14,8483920,Pierrick Dube,R,WSH,23,0,0,0,0
14,8480851,Akil Thomas,C,LAK,24,0,0,0,0
14,8475235,Nicolas Deslauriers,L,PHI,33,0,0,0,0
14,8482476,Emil Heineman,L,MTL,23,0,0,0,0
14,8477149,Scott Sabourin,R,SJS,32,0,0,0,0
14,8483549,Lucas Condotta,L,MTL,27,0,0,0,0
14,8482765,Isak Rosen,R,BUF,21,0,0,0,0
14,8481237,Kyle MacLean,C,NYI,25,0,0,0,0
14,8481024,Linus Karlsson,C,VAN,25,0,0,0,0
14,8481690,Tyler Angle,C,,24,0,0,0,0
14,8483570,Ben Meyers,C,SEA,26,0,0,0,0
14,8481655,Cole Schwindt,R,CGY,23,0,0,0,0
14,8481462,Mason Morelli,L,VGK,28,0,0,0,0
14,8483401,Marc Johnstone,R,PIT,28,0,0,0,0
14,8478956,Samuel Laberge,L,NJD,27,0,0,0,0
14,8479533,Joona Koppanen,L,,26,0,0,0,0
14,8482197,Adam Raska,R,MIN,23,0,0,0,0
14,8482250,Callahan Burke,C,VGK,27,0,0,0,0
14,8482784,Zach Dean,C,STL,21,0,0,0,0
14,8484255,Jason Polin,R,COL,25,0,0,0,0
14,8481077,John Leonard,L,,26,0,0,0,0
14,8481534,Raphael Lavoie,C,EDM,24,0,0,0,0
14,8483609,Adam Klapka,R,CGY,24,0,0,0,0
14,8482751,Ryan Winterton,C,SEA,21,0,0,0,0
14,8480267,Sammy Walker,C,MIN,25,0,0,0,0
14,8475766,Austin Watson,L,,32,0,0,0,0
14,8482460,Matt Rempe,C,NYR,22,0,0,0,0
14,8481065,Angus Crookshank,L,OTT,25,0,0,0,0
14,8481070,Hugh McGing,L,,26,0,0,0,0
14,8476323,Max McCormick,L,SEA,32,0,0,0,0
14,8483395,Arshdeep Bains,L,VAN,23,0,0,0,0
14,8484259,Ondrej Pavel,C,COL,31,0,0,0,0
14,8483432,Luca Del Bel Belluz,C,CBJ,31,0,0,0,0
14,8483045,Cameron Butler,R,CBJ,31,0,0,0,0
14,8482061,Brandon Biro,L,SEA,26,0,0,0,0
14,8477401,John Hayden,C,SEA,29,0,0,0,0
14,8475278,Byron Froese,C,,33,0,0,0,0
14,8478446,Glenn Gawdin,C,LAK,27,0,0,0,0
14,8477993,Justin Kirkland,C,CGY,28,0,0,0,0
14,8482147,Jean-Luc Foudy,C,COL,22,0,0,0,0
14,8480032,Shane Bowers,C,NJD,25,0,0,0,0
14,8479330,Brandon Gignac,C,MTL,27,0,0,0,0
14,8480776,Sheldon Rempal,R,,29,0,0,0,0
14,8475413,Justin Dowling,C,NJD,34,0,0,0,0
14,8481726,Adam Edstrom,C,NYR,24,0,0,0,0
14,8480844,Grigori Denisenko,L,VGK,24,0,0,0,0
14,8478147,Bokondji Imama,L,PIT,28,0,0,0,0
14,8478881,Brett Seney,L,CHI,28,0,0,0,0
14,8483630,Pavol Regenda,L,ANA,25,0,0,0,0
14,8480836,Jonathan Gruden,C,,24,0,0,0,0
14,8484314,Jiri Smejkal,L,,28,0,0,0,0
14,8475780,Chris Wagner,R,COL,33,0,0,0,0
14,8479546,Oskar Steen,C,,26,0,0,0,0
14,8483597,Milos Kelemen,L,UTA,25,0,0,0,0
14,8481789,Tye Kartye,L,SEA,23,0,0,0,0
14,8484325,Waltteri Merela,C,TBL,26,0,0,0,0
14,8479421,Jacob Moverare,D,LAK,26,0,0,0,0
14,8481585,Egor Afanasyev,L,SJS,23,0,0,0,0
14,8479547,Matthew Phillips,R,,26,0,0,0,0
14,8479367,William Lockwood,R,FLA,26,0,0,0,0
14,8476915,Jujhar Khaira,L,,30,0,0,0,0
14,8481422,Jacob Lucchini,C,NSH,29,0,0,0,0
14,8480468,James Hamblin,L,EDM,25,0,0,0,0
14,8478051,Max Willman,C,NJD,29,0,0,0,0
14,8481556,John Beecher,C,BOS,23,0,0,0,0
14,8478078,Rourke Chartier,C,,28,0,0,0,0
15,8478402,Connor McDavid,C,EDM,27,82,47,94,141
15,8477492,Nathan MacKinnon,C,COL,29,82,49,82,131
15,8476453,Nikita Kucherov,R,TBL,31,82,42,77,119
15,8477956,David Pastrnak,R,BOS,28,82,61,57,118
15,8476887,Filip Forsberg,L,NSH,30,82,52,64,116
15,8477934,Leon Draisaitl,C,EDM,29,82,38,75,113
15,8479314,Matthew Tkachuk,L,FLA,27,82,34,76,110
15,8478010,Brayden Point,C,TBL,28,82,54,55,109
15,8481559,Jack Hughes,C,NJD,23,82,39,69,108
15,8477493,Aleksander Barkov,C,FLA,29,82,32,76,108
15,8477939,William Nylander,R,TOR,28,82,42,64,106
15,8478864,Kirill Kaprizov,L,MIN,27,82,42,62,104
15,8478398,Kyle Connor,L,WPG,28,82,45,57,102
15,8479318,Auston Matthews,C,TOR,27,82,57,44,101
15,8477933,Sam Reinhart,C,FLA,29,82,50,50,100
15,8471675,Sidney Crosby,C,PIT,37,82,36,64,100
15,8478550,Artemi Panarin,L,NYR,33,82,32,67,99
15,8480801,Brady Tkachuk,L,OTT,25,82,41,57,98
15,8476454,Ryan Nugent-Hopkins,C,EDM,31,82,35,63,98
15,8478420,Mikko Rantanen,R,COL,28,82,44,53,97
15,8478445,Mathew Barzal,C,NYI,27,82,21,73,94
15,8479385,Jordan Kyrou,C,STL,26,82,45,48,93
15,8477946,Dylan Larkin,C,DET,28,82,38,55,93
15,8478427,Sebastian Aho,C,CAR,27,82,36,57,93
15,8474600,Roman Josi,D,NSH,34,82,21,72,93
15,8480027,Jason Robertson,L,DAL,25,82,36,55,91
15,8477404,Jake Guentzel,C,TBL,30,82,48,42,90
15,8479420,Tage Thompson,C,BUF,27,82,50,39,89
15,8475172,Nazem Kadri,C,CGY,34,82,44,45,89
15,8478403,Jack Eichel,C,VGK,28,82,42,47,89
15,8480800,Quinn Hughes,D,VAN,25,82,20,69,89
15,8480865,Noah Dobson,D,NYI,24,82,15,74,89
15,8474564,Steven Stamkos,C,NSH,34,82,31,57,88
15,8481523,Kirby Dach,C,MTL,23,82,22,66,88
15,8482116,Tim Stützle,C,OTT,22,82,34,53,87
15,8476389,Vincent Trocheck,C,NYR,31,82,34,53,87
15,8471215,Evgeni Malkin,C,PIT,38,82,31,54,85
15,8481557,Matt Boldy,L,MIN,23,82,42,42,84
15,8480208,Drake Batherson,R,OTT,26,82,31,53,84
15,8474578,Erik Karlsson,D,PIT,34,82,26,58,84
15,8478439,Travis Konecny,R,PHI,27,82,41,42,83
15,8476459,Mika Zibanejad,C,NYR,31,82,31,52,83
15,8477942,Kevin Fiala,L,LAK,28,82,30,53,83
15,8477960,Adrian Kempe,R,LAK,28,82,38,44,82
15,8476468,J.T. Miller,C,VAN,31,82,36,46,82
15,8478047,Michael Bunting,L,PIT,29,82,36,46,82
15,8479337,Alex DeBrincat,R,DET,27,82,33,49,82
15,8480069,Cale Makar,D,COL,26,82,22,60,82
15,8475167,Victor Hedman,D,TBL,34,82,15,67,82
15,8475166,John Tavares,C,TOR,34,82,35,46,81
15,8479407,Jesper Bratt,L,NJD,26,82,26,55,81
15,8479323,Adam Fox,D,NYR,26,82,16,65,81
15,8477500,Bo Horvat,C,NYI,29,82,36,44,80
15,8480023,Robert Thomas,C,STL,25,82,18,62,80
15,8480830,Andrei Svechnikov,R,CAR,24,82,30,49,79
15,8477409,Carter Verhaeghe,C,FLA,29,82,26,53,79
15,8475913,Mark Stone,R,VGK,32,82,30,48,78
15,8480012,Elias Pettersson,C,VAN,26,82,28,50,78
15,8471685,Anze Kopitar,C,LAK,37,82,25,53,78
15,8479343,Clayton Keller,R,UTA,26,82,39,38,77
15,8475754,Brock Nelson,C,NYI,33,82,44,32,76
15,8478493,Joel Eriksson Ek,C,MIN,27,82,30,46,76
15,8477496,Elias Lindholm,C,BOS,30,82,36,39,75
15,8473419,Brad Marchand,L,BOS,36,82,27,48,75
15,8477402,Pavel Buchnevich,L,STL,29,82,26,49,75
15,8475692,Mats Zuccarello,R,MIN,37,82,23,52,75
15,8476346,Johnny Gaudreau,L,CBJ,31,82,16,59,75
15,8478873,Troy Terry,R,ANA,27,82,34,40,74
15,8475784,Jeff Skinner,C,EDM,32,82,33,41,74
15,8479325,Charlie McAvoy,D,BOS,27,82,19,55,74
15,8476539,Jonathan Marchessault,R,NSH,34,82,49,24,73
15,8478440,Dylan Strome,C,WSH,27,82,21,51,72
15,8477504,Josh Morrissey,D,WPG,29,82,19,53,72
15,8477447,Shea Theodore,D,VGK,29,82,14,58,72
15,8475810,Bryan Rust,R,PIT,32,82,36,35,71
15,8477955,Jared McCann,L,SEA,28,82,32,39,71
15,8475786,Zach Hyman,L,EDM,32,82,40,30,70
15,8476853,Morgan Rielly,D,TOR,30,82,7,63,70
15,8478414,Timo Meier,R,NJD,28,82,35,34,69
15,8482665,Matty Beniers,C,SEA,22,82,32,37,69
15,8477949,Alex Tuch,R,BUF,28,82,29,40,69
15,8478444,Brock Boeser,R,VAN,27,82,26,43,69
15,8473512,Claude Giroux,R,OTT,36,82,24,45,69
15,8479339,Patrik Laine,L,CBJ,26,82,38,30,68
15,8477951,Nick Schmaltz,C,UTA,28,82,31,37,68
15,8482113,Anton Lundell,C,FLA,23,82,30,38,68
15,8478401,Pavel Zacha,C,BOS,27,82,26,42,68
15,8475184,Chris Kreider,L,NYR,33,82,42,25,67
15,8471214,Alex Ovechkin,L,WSH,39,82,31,36,67
15,8481533,Trevor Zegras,C,ANA,23,82,20,47,67
15,8480036,Miro Heiskanen,D,DAL,25,82,17,50,67
15,8478460,Zach Werenski,D,CBJ,27,82,15,52,67
15,8480803,Evan Bouchard,D,EDM,25,82,13,54,67
15,8476881,Tomas Hertl,C,VGK,31,82,30,36,66
15,8476882,Teuvo Teravainen,L,CHI,30,82,29,37,66
15,8480039,Martin Necas,C,CAR,25,82,27,39,66
15,8475158,Ryan O'Reilly,C,NSH,33,82,22,44,66
15,8478396,Noah Hanifin,D,VGK,27,82,15,51,66
15,8475168,Matt Duchene,C,DAL,33,82,33,32,65
15,8480002,Nico Hischier,C,NJD,25,82,30,35,65
15,8474586,Jordan Eberle,R,SEA,34,82,25,40,65
15,8471724,Kris Letang,D,PIT,37,82,18,47,65
15,8480434,Sean Durzi,D,UTA,26,82,11,54,65
15,8481528,Dylan Cozens,C,BUF,23,82,25,39,64
15,8474590,John Carlson,D,WSH,34,82,18,46,64
15,8477501,Valeri Nichushkin,R,COL,29,82,34,29,63
15,8477935,Sam Bennett,C,FLA,28,82,34,29,63
15,8478975,Mason Marchment,L,DAL,29,82,29,34,63
15,8479542,Brandon Hagel,L,TBL,26,82,28,35,63
15,8482078,Lucas Raymond,L,DET,22,82,28,35,63
15,8482097,Jack Quinn,R,BUF,23,82,27,36,63
15,8477451,Ryan Hartman,R,MIN,30,82,20,43,63
15,8476462,Dougie Hamilton,D,NJD,31,82,18,45,63
15,8475798,Mikael Granlund,C,SJS,32,82,14,49,63
15,8476432,Boone Jenner,C,CBJ,31,82,40,22,62
15,8478498,Jake DeBrusk,L,VAN,28,82,32,30,62
15,8479675,Trevor Moore,L,LAK,29,82,30,32,62
15,8477476,Artturi Lehkonen,L,COL,29,82,30,32,62
15,8480015,Owen Tippett,R,PHI,25,82,27,35,62
15,8478042,Viktor Arvidsson,R,EDM,31,82,27,35,62
15,8476479,Phillip Danault,C,LAK,31,82,27,35,62
15,8474141,Patrick Kane,R,DET,36,82,22,40,62
15,8476906,Shayne Gostisbehere,D,CAR,31,82,18,44,62
15,8478449,Roope Hintz,C,DAL,28,82,29,32,61
15,8476460,Mark Scheifele,C,WPG,31,82,25,36,61
15,8477494,Jonathan Drouin,L,COL,29,82,21,40,61
15,8476875,Mike Matheson,D,MTL,30,82,11,50,61
15,8475170,Brayden Schenn,C,STL,33,82,29,31,60
15,8480798,Philipp Kurashev,C,CHI,25,82,21,39,60
15,8477932,Aaron Ekblad,D,FLA,28,82,17,43,60
15,8481540,Cole Caufield,R,MTL,23,82,31,28,59
15,8481068,Yegor Sharangovich,C,CGY,26,82,29,30,59
15,8476448,William Karlsson,C,VGK,31,82,27,32,59
15,8474102,David Perron,L,OTT,36,82,24,35,59
15,8477495,Seth Jones,D,CHI,30,82,18,41,59
15,8482684,Luke Hughes,D,NJD,21,82,11,48,59
15,8475765,Vladimir Tarasenko,R,DET,33,82,29,29,58
15,8475722,Jason Zucker,L,BUF,32,82,26,32,58
15,8481711,Matias Maccelli,L,UTA,24,82,22,36,58
15,8480018,Nick Suzuki,C,MTL,25,82,20,38,58
15,8477429,Andrew Copp,C,DET,30,82,17,41,58
15,8474679,Gustav Nyquist,C,NSH,35,82,16,42,58
15,8476905,Chandler Stephenson,C,SEA,30,82,14,44,58
15,8480839,Rasmus Dahlin,D,BUF,24,82,14,44,58
15,8482093,Seth Jarvis,C,CAR,22,82,30,27,57
15,8478519,Anthony Cirelli,C,TBL,27,82,24,32,56
15,8478542,Evan Rodrigues,C,FLA,31,82,22,34,56
15,8475151,Kyle Palmieri,C,NYI,33,82,21,35,56
15,8478038,Devon Toews,D,COL,30,82,9,47,56
15,8478366,Frank Vatrano,R,ANA,30,82,33,22,55
15,8477998,Warren Foegele,L,LAK,28,82,29,26,55
15,8477444,Andre Burakovsky,L,SEA,29,82,27,28,55
15,8482699,Dylan Guenther,R,UTA,21,82,21,34,55
15,8475745,Charlie Coyle,C,BOS,32,82,16,39,55
15,8477021,Alex Kerfoot,C,UTA,30,82,15,40,55
15,8474150,Mikael Backlund,C,CGY,35,82,14,41,55
15,8475726,Tyler Toffoli,C,SJS,32,82,31,23,54
15,8478462,Nicolas Roy,C,VGK,27,82,28,26,54
15,8477416,Oliver Bjorkstrand,R,SEA,29,82,23,31,54
15,8482110,Dawson Mercer,C,NJD,23,82,21,33,54
15,8474563,Drew Doughty,D,LAK,35,82,11,43,54
15,8475169,Evander Kane,L,EDM,33,82,32,21,53
15,8477987,Ryan Donato,C,CHI,28,82,26,27,53
15,8482146,Luke Evangelista,R,NSH,22,82,21,32,53
15,8477940,Nikolaj Ehlers,L,WPG,28,82,19,34,53
15,8478407,Vince Dunn,D,SEA,28,82,12,41,53
15,8479999,Casey Mittelstadt,C,COL,26,82,20,32,52
15,8481581,Thomas Harley,D,DAL,23,82,8,44,52
15,8480014,Gabriel Vilardi,C,WPG,25,82,33,18,51
15,8473986,Alex Killorn,L,ANA,35,82,28,23,51
15,8479400,Pierre-Luc Dubois,L,WSH,26,82,20,31,51
15,8480188,Fabian Zetterlund,L,SJS,25,82,14,37,51
15,8478055,Gustav Forsling,D,FLA,28,82,15,35,50
15,8477964,Ivan Barbashev,C,VGK,29,82,14,36,50
15,8478438,Tommy Novak,C,NSH,27,82,12,38,50
15,8479425,Filip Hronek,D,VAN,27,82,5,45,50
15,8471698,T.J. Oshie,R,WSH,38,82,23,26,49
15,8480064,Josh Norris,C,OTT,25,82,21,28,49
15,8480009,Eeli Tolvanen,R,SEA,25,82,20,29,49
15,8475768,Jaden Schwartz,C,SEA,32,82,19,30,49
15,8480145,Neal Pionk,D,WPG,29,82,16,33,49
15,8481542,Moritz Seider,D,DET,23,82,11,38,49
15,8479410,Mikhail Sergachev,D,UTA,26,82,9,40,49
15,8482109,Alexis Lafrenière,L,NYR,23,82,28,20,48
15,8475794,Tyler Seguin,C,DAL,32,82,23,25,48
15,8478458,Jack Roslovic,C,CAR,27,82,19,29,48
15,8476869,Brady Skjei,D,NSH,30,82,10,38,48
15,8470613,Brent Burns,D,CAR,39,82,10,38,48
15,8474053,Logan Couture,C,SJS,35,82,21,26,47
15,8474149,Evgenii Dadonov,R,DAL,35,82,18,29,47
15,8480028,Morgan Frost,C,PHI,25,82,17,30,47
15,8482124,Quinton Byfield,R,LAK,22,82,13,34,47
15,8477346,MacKenzie Weegar,D,CGY,30,82,9,38,47
15,8481596,Shane Pinto,C,OTT,24,82,27,19,46
15,8477407,Anthony Duclair,L,NYI,29,82,19,27,46
15,8478856,Conor Garland,R,VAN,28,82,19,27,46
15,8475791,Taylor Hall,L,CHI,33,82,18,28,46
15,8484144,Connor Bedard,C,CHI,19,82,17,29,46
15,8477948,Travis Sanheim,D,PHI,28,82,11,35,46
15,8482740,Wyatt Johnston,C,DAL,21,82,24,21,45
15,8478233,Andrew Mangiapane,L,WSH,28,82,24,21,45
15,8476483,Rickard Rakell,R,PIT,31,82,21,24,45
15,8476872,Scott Laughton,C,PHI,30,82,21,24,45
15,8480113,Alex Iafallo,L,WPG,31,82,20,25,45
15,8481624,Ilya Mikheyev,R,CHI,30,82,19,26,45
15,8475191,Reilly Smith,R,NYR,33,82,18,27,45
15,8477456,J.T. Compher,L,DET,29,82,16,29,45
15,8475763,Kevin Hayes,R,PIT,32,82,14,31,45
15,8476792,Torey Krug,D,STL,33,82,14,31,45
15,8483808,Andrei Kuzmenko,L,CGY,28,82,26,18,44
15,8475799,Nino Niederreiter,R,WPG,32,82,26,18,44
15,8482720,Matthew Knies,L,TOR,22,82,22,22,44
15,8477511,Anthony Mantha,R,CGY,30,82,21,23,44
15,8482745,Mason McTavish,C,ANA,21,82,19,25,44
15,8476927,Teddy Blueger,C,VAN,30,82,15,29,44
15,8475171,Oliver Ekman-Larsson,D,TOR,33,82,11,33,44
15,8476456,Jonathan Huberdeau,C,CGY,31,82,9,35,44
15,8481560,Arthur Kaliyev,R,LAK,23,82,24,19,43
15,8477392,Hudson Fasching,R,NYI,29,82,23,20,43
15,8477426,Nicholas Paul,L,TBL,29,82,20,23,43
15,8476292,Ondrej Palat,L,NJD,33,82,19,24,43
15,8476419,Jean-Gabriel Pageau,C,NYI,32,82,18,25,43
15,8482667,William Eklund,L,SJS,22,82,16,27,43
15,8479987,Morgan Geekie,C,BOS,26,82,15,28,43
15,8477986,Brandon Montour,D,SEA,30,82,12,31,43
15,8477503,Max Domi,C,TOR,29,82,11,32,43
15,8478397,Rasmus Andersson,D,CGY,28,82,10,33,43
15,8476923,Damon Severson,D,CBJ,30,82,8,35,43
15,8474565,Alex Pietrangelo,D,VGK,34,82,7,36,43
15,8480849,Barrett Hayton,C,UTA,24,82,25,17,42
15,8475848,Brendan Gallagher,R,MTL,32,82,19,23,42
15,8475287,Erik Haula,L,NJD,33,82,18,24,42
15,8482159,Tyson Foerster,R,PHI,22,82,17,25,42
15,8476880,Tom Wilson,R,WSH,30,82,17,25,42
15,8475793,Ryan Johansen,C,PHI,32,82,16,26,42
15,8476329,Travis Boyd,C,MIN,31,82,16,26,42
15,8473994,Jamie Benn,L,DAL,35,82,15,27,42
15,8477479,Tyler Bertuzzi,L,CHI,29,82,15,27,42
15,8478469,Thomas Chabot,D,OTT,27,82,13,29,42
15,8476458,Ryan Strome,C,ANA,31,82,13,29,42
15,8475200,Dmitry Orlov,D,CAR,33,82,10,32,42
15,8475764,Cam Fowler,D,ANA,33,82,8,34,42
15,8476854,Hampus Lindholm,D,BOS,30,82,8,34,42
15,8476438,Brandon Saad,L,STL,32,82,26,15,41
15,8476399,Blake Coleman,C,CGY,33,82,19,22,41
15,8474641,Adam Henrique,C,EDM,34,82,16,25,41
15,8482092,Ridly Greig,C,OTT,22,82,16,25,41
15,8480871,Adam Boqvist,D,FLA,24,82,14,27,41
15,8480078,Filip Chytil,C,NYR,25,82,13,28,41
15,8479345,Jakob Chychrun,D,WSH,26,82,12,29,41
15,8476392,Adam Lowry,C,WPG,31,82,10,31,41
15,8480893,Kirill Marchenko,R,CBJ,24,82,25,15,40
15,8476918,Jimmy Vesey,L,NYR,31,82,21,19,40
15,8477497,Sean Monahan,C,CBJ,30,82,18,22,40
15,8479365,Trent Frederic,C,BOS,26,82,16,24,40
15,8481604,Pavel Dorofeyev,L,VGK,24,82,22,17,39
15,8480220,Noah Cates,L,PHI,25,82,21,18,39
15,8478115,Pierre Engvall,L,NYI,28,82,19,20,39
15,8478020,Michael Amadio,C,OTT,28,82,19,20,39
15,8476826,Yanni Gourde,C,SEA,33,82,17,22,39
15,8483515,Juraj Slafkovsky,L,MTL,20,82,17,22,39
15,8479390,Taylor Raddysh,R,WSH,26,82,15,24,39
15,8476461,Sean Couturier,C,PHI,32,82,15,24,39
15,8477919,Frederick Gaudreau,C,MIN,31,82,14,25,39
15,8475218,Mattias Ekholm,D,EDM,34,82,13,26,39
15,8481656,Aliaksei Protas,C,WSH,23,82,12,27,39
15,8474716,Jared Spurgeon,D,MIN,35,82,10,29,39
15,8482105,Jake Sanderson,D,OTT,22,82,6,33,39
15,8481606,Jordan Spence,D,LAK,23,82,4,35,39
15,8478474,Lawson Crouse,L,UTA,27,82,25,13,38
15,8476960,Andreas Athanasiou,C,CHI,30,82,20,18,38
15,8476480,Vladislav Namestnikov,C,WPG,32,82,18,20,38
15,8478046,Danton Heinen,L,VAN,29,82,17,21,38
15,8480185,Eetu Luostarinen,C,FLA,26,82,17,21,38
15,8476925,Colton Sissons,C,NSH,31,82,17,21,38
15,8482175,JJ Peterka,R,BUF,22,82,17,21,38
15,8482149,Cole Perfetti,C,WPG,22,82,14,24,38
15,8478911,Matt Roy,D,WSH,29,82,13,25,38
15,8475188,Brayden McNabb,D,VGK,33,82,8,30,38
15,8477969,Marcus Pettersson,D,PIT,28,82,7,31,38
15,8475753,Justin Faulk,D,STL,32,82,5,33,38
15,8482089,Jake Neighbours,L,STL,22,82,26,11,37
15,8480459,Pius Suter,C,VAN,28,82,22,15,37
15,8473533,Jordan Staal,C,CAR,36,82,20,17,37
15,8479941,Justin Danforth,R,CBJ,31,82,20,17,37
15,8481186,Logan O'Connor,R,COL,28,82,19,18,37
15,8480748,Kiefer Sherwood,L,VAN,29,82,18,19,37
15,8480074,Alexandre Texier,C,STL,25,82,17,20,37
15,8475314,Anders Lee,L,NYI,34,82,16,21,37
15,8481618,Alex Newhook,C,MTL,23,82,15,22,37
15,8476979,Erik Gustafsson,D,DET,32,82,10,27,37
15,8475231,Casey Cizikas,C,NYI,33,82,23,13,36
15,8478109,Victor Olofsson,L,VGK,29,82,21,15,36
15,8481580,Connor McMichael,C,WSH,23,82,19,17,36
15,8479992,Michael Rasmussen,C,DET,25,82,15,21,36
15,8477952,Robby Fabbri,C,ANA,28,82,15,21,36
15,8480797,Joel Farabee,L,PHI,24,82,14,22,36
15,8478891,Mason Appleton,C,WPG,28,82,13,23,36
15,8476885,Jacob Trouba,D,NYR,30,82,12,24,36
15,8482660,Kent Johnson,C,CBJ,22,82,12,24,36
15,8477989,Christian Dvorak,C,MTL,28,82,12,24,36
15,8479351,Sam Steel,C,DAL,26,82,11,25,36
15,8478472,Mathieu Joseph,R,STL,27,82,9,27,36
15,8481178,Egor Zamula,D,PHI,24,82,6,30,36
15,8479525,Ross Colton,C,COL,28,82,18,17,35
15,8478413,Jordan Greenway,L,BUF,27,82,17,18,35
15,8482475,Yegor Chinakhov,R,CBJ,23,82,17,18,35
15,8481704,Juuso Parssinen,C,NSH,23,82,17,18,35
15,8477508,Curtis Lazar,C,NJD,29,82,17,18,35
15,8482125,Alexander Holtz,R,VGK,22,82,15,20,35
15,8475714,Calle Jarnkrok,C,TOR,33,82,14,21,35
15,8477953,Kasperi Kapanen,R,STL,28,82,14,21,35
15,8482705,Cole Sillinger,C,CBJ,21,82,10,25,35
15,8476917,Adam Pelech,D,NYI,30,82,6,29,35
15,8479371,Dante Fabbro,D,NSH,26,82,6,29,35
15,8481014,Alexander Romanov,D,NYI,24,82,2,33,35
15,8476873,Mark Jankowski,C,NSH,30,82,18,16,34
15,8480789,Oliver Wahlstrom,R,NYI,24,82,17,17,34
15,8482671,Owen Power,D,BUF,22,82,10,24,34
15,8476897,Oskar Sundqvist,C,STL,30,82,10,24,34
15,8477498,Darnell Nurse,D,EDM,29,82,4,30,34
15,8475343,Nic Dowd,C,WSH,34,82,18,15,33
15,8482055,Drew O'Connor,L,PIT,26,82,17,16,33
15,8481535,Nils Hoglander,L,VAN,24,82,17,16,33
15,8473422,Nick Foligno,L,CHI,37,82,13,20,33
15,8481013,Jonatan Berggren,R,DET,24,82,13,20,33
15,8481546,Cam York,D,PHI,23,82,11,22,33
15,8477220,Nate Schmidt,D,FLA,33,82,8,25,33
15,8479983,Mario Ferraro,D,SJS,26,82,7,26,33
15,8476892,Colton Parayko,D,STL,31,82,5,28,33
15,8475233,David Savard,D,MTL,34,82,5,28,33
15,8481481,Blake Lizotte,C,PIT,27,82,18,14,32
15,8480003,Jesper Boqvist,C,FLA,26,82,16,16,32
15,8477353,Tyler Motte,C,DET,29,82,16,16,32
15,8480068,Ryan Poehling,C,PHI,25,82,15,17,32
15,8480855,Jack McBain,C,UTA,24,82,15,17,32
15,8482117,Lukas Reichel,L,CHI,22,82,13,19,32
15,8474189,Lars Eller,C,PIT,35,82,12,20,32
15,8482133,Thomas Bordeleau,C,SJS,22,82,11,21,32
15,8475855,Jesper Fast,R,CAR,33,82,11,21,32
15,8473563,Nicklas Backstrom,C,WSH,37,82,10,22,32
15,8480817,K'Andre Miller,D,NYR,24,82,7,25,32
15,8474151,Ryan McDonagh,D,TBL,35,82,4,28,32
15,8476879,Cody Ceci,D,EDM,31,82,4,28,32
15,8482655,J.J. Moser,D,TBL,24,82,3,29,32
15,8481524,Bowen Byram,D,BUF,23,82,15,16,31
15,8481553,Bobby Brink,R,PHI,23,82,13,18,31
15,8478013,Jake Walman,D,SJS,28,82,13,18,31
15,8480829,Jesperi Kotkaniemi,C,CAR,24,82,12,19,31
15,8483431,Logan Cooley,C,UTA,20,82,12,19,31
15,8484153,Leo Carlsson,C,ANA,20,82,12,19,31
15,8474715,Cam Atkinson,R,TBL,35,82,11,20,31
15,8480802,Ryan McLeod,C,BUF,25,82,9,22,31
15,8479661,Tanner Jeannot,L,LAK,27,82,7,24,31
15,8476931,Jake McCabe,D,TOR,31,82,5,26,31
15,8473507,Jeff Petry,D,DET,37,82,5,26,31
15,8476469,Joel Armia,R,MTL,31,82,17,13,30
15,8475193,Tomas Tatar,L,NJD,34,82,16,14,30
15,8478432,Christian Fischer,R,DET,27,82,14,16,30
15,8475220,Marcus Foligno,L,MIN,33,82,13,17,30
15,8481554,Kaapo Kakko,R,NYR,23,82,10,20,30
15,8476374,Sean Kuraly,C,CBJ,31,82,10,20,30
15,8478882,Vladislav Gavrikov,D,LAK,29,82,6,24,30
15,8482245,Artem Zub,D,OTT,29,82,3,27,30
15,8479976,Juuso Valimaki,D,UTA,26,82,0,30,30
15,8481582,Nicholas Robertson,L,TOR,23,82,17,12,29
15,8481032,Paul Cotter,C,NJD,25,82,15,14,29
15,8475760,Nick Bjugstad,C,UTA,32,82,14,15,29
15,8482111,Justin Barron,D,MTL,23,82,14,15,29
15,8477947,Sonny Milano,L,WSH,28,82,13,16,29
15,8479591,Michael Eyssimont,C,TBL,28,82,13,16,29
15,8478057,Dakota Joshua,C,VAN,28,82,12,17,29
15,8477450,Jason Dickinson,C,CHI,29,82,12,17,29
15,8477505,Alexander Wennberg,C,SJS,30,82,11,18,29
15,8478133,Jake Evans,C,MTL,28,82,10,19,29
15,8482666,Scott Morrow,D,CAR,22,82,7,22,29
15,8476958,Jaccob Slavin,D,CAR,30,82,6,23,29
15,8480043,Timothy Liljegren,D,TOR,25,82,6,23,29
15,8477506,Ryan Pulock,D,NYI,30,82,6,23,29
15,8482142,Jamie Drysdale,D,PHI,22,82,4,25,29
15,8479293,Brandon Tanev,L,SEA,33,82,15,13,28
15,8482166,Shakir Mukhamadullin,D,SJS,22,82,15,13,28
15,8484166,Adam Fantilli,C,CBJ,20,82,14,14,28
15,8479393,Noah Gregor,C,OTT,26,82,13,15,28
15,8480336,Sean Walker,D,CAR,30,82,10,18,28
15,8476422,Mike Reilly,D,NYI,31,82,9,19,28
15,8475181,Nick Leddy,D,STL,33,82,1,27,28
15,8479398,Samuel Girard,D,COL,26,82,1,27,28
15,8480835,Jack Drury,C,CAR,24,82,16,11,27
15,8476878,Zemgus Girgensons,L,TBL,30,82,15,12,27
15,8477903,Garnet Hathaway,R,PHI,33,82,12,15,27
15,8481477,Nico Sturm,C,SJS,29,82,11,16,27
15,8476921,Jordan Martinook,L,CAR,32,82,11,16,27
15,8482624,Daniil Miromanov,D,CGY,27,82,9,18,27
15,8480073,Erik Brannstrom,D,COL,25,82,6,21,27
15,8476331,Dylan DeMelo,D,WPG,31,82,5,22,27
15,8477435,Ryan Graves,D,PIT,29,82,4,23,27
15,8478500,Ivan Provorov,D,CBJ,27,82,3,24,27
15,8478463,Anthony Beauvillier,L,PIT,27,82,15,11,26
15,8479996,Cody Glass,C,NSH,25,82,14,12,26
15,8479316,Luke Kunin,C,SJS,27,82,14,12,26
15,8480281,Alexey Toropchenko,R,STL,25,82,14,12,26
15,8481093,Rafael Harvey-Pinard,L,MTL,25,82,13,13,26
15,8480025,MacKenzie Entwistle,R,FLA,25,82,11,15,26
15,8476429,Scott Mayfield,D,NYI,32,82,7,19,26
15,8478851,Alexandre Carrier,D,NSH,28,82,6,20,26
15,8478840,Will Borgen,D,SEA,28,82,5,21,26
15,8482073,Braden Schneider,D,NYR,23,82,5,21,26
15,8476902,Esa Lindell,D,DAL,30,82,4,22,26
15,8475690,Chris Tanev,D,TOR,35,82,4,22,26
15,8476463,Jonas Brodin,D,MIN,31,82,3,23,26
15,8477365,Connor Clifton,D,BUF,29,82,2,24,26
15,8479414,Nathan Bastian,R,NJD,27,82,15,10,25
15,8478508,Yakov Trenin,C,MIN,27,82,14,11,25
15,8480813,Joe Veleno,C,DET,24,82,12,13,25
15,8482079,Marco Rossi,C,MIN,23,82,11,14,25
15,8482062,Cole Smith,L,NSH,29,82,11,14,25
15,8480448,Parker Kelly,L,COL,25,82,9,16,25
15,8476474,Stefan Noesen,R,NJD,31,82,8,17,25
15,8482141,Lukas Cormier,D,VGK,22,82,8,17,25
15,8478507,John Marino,D,UTA,27,82,5,20,25
15,8482087,Kaiden Guhle,D,MTL,22,82,4,21,25
15,8480035,Henri Jokiharju,D,BUF,25,82,3,22,25
15,8477488,Brett Pesce,D,NJD,30,82,3,22,25
15,8476457,Adam Larsson,D,SEA,32,82,2,23,25
15,8480246,Nick Perbix,D,TBL,26,82,2,23,25
15,8483490,Pavel Mintyukov,D,ANA,21,82,1,24,25
15,8470621,Corey Perry,R,EDM,39,82,13,11,24
15,8483505,Matthew Poitras,C,BOS,20,82,12,12,24
15,8475149,Marcus Johansson,L,MIN,34,82,10,14,24
15,8480980,Connor Dewar,C,TOR,25,82,10,14,24
15,8483524,Shane Wright,C,SEA,20,82,10,14,24
15,8481517,Brett Leason,R,ANA,25,82,9,15,24
15,8479359,Beck Malenstyn,L,BUF,26,82,7,17,24
15,8477507,Nikita Zadorov,D,BOS,29,82,5,19,24
15,8480878,Nils Lundkvist,D,DAL,24,82,4,20,24
15,8479402,Jake Bean,D,CGY,26,82,3,21,24
15,8480873,Rasmus Sandin,D,WSH,24,82,1,23,24
15,8481568,Alex Vlasic,D,CHI,23,82,0,24,24
15,8477425,Miles Wood,L,COL,29,82,13,10,23
15,8479353,Brett Howden,C,VGK,26,82,12,11,23
15,8476278,Colin Blackwell,C,DAL,31,82,10,13,23
15,8476442,Matt Nieto,L,PIT,32,82,10,13,23
15,8476624,Barclay Goodrow,C,SJS,31,82,9,14,23
15,8478569,Noel Acciari,C,PIT,33,82,9,14,23
15,8477839,Conor Sheary,L,TBL,32,82,9,14,23
15,8477369,Carson Soucy,D,VAN,30,82,9,14,23
15,8482803,Olen Zellweger,D,ANA,21,82,9,14,23
15,8480995,Pontus Holmberg,R,TOR,25,82,7,16,23
15,8478434,Keegan Kolesar,R,VGK,27,82,7,16,23
15,8476525,Colin Miller,D,WPG,32,82,7,16,23
15,8477845,Trevor van Riemsdyk,D,WSH,33,82,6,17,23
15,8482122,Brock Faber,D,MIN,22,82,5,18,23
15,8477406,Mattias Janmark,C,EDM,32,82,5,18,23
15,8482809,Jackson Blake,R,CAR,21,82,5,18,23
15,8480049,Dylan Samberg,D,WPG,25,82,1,22,23
15,8476981,Josh Anderson,R,MTL,30,82,16,6,22
15,8477015,Connor Brown,R,EDM,30,82,10,12,22
15,8476889,Radek Faksa,C,STL,30,82,9,13,22
15,8482659,Josh Doan,R,UTA,22,82,8,14,22
15,8483482,Tristan Luneau,D,ANA,20,82,8,14,22
15,8483565,Nick Blankenburg,D,NSH,26,82,7,15,22
15,8480806,Isac Lundestrom,C,ANA,25,82,6,16,22
15,8483468,Jiri Kulich,C,BUF,20,82,6,16,22
15,8476467,Jamie Oleksiak,D,SEA,32,82,5,17,22
15,8478859,Niko Mikkola,D,FLA,28,82,4,18,22
15,8480860,Kevin Bahl,D,CGY,24,82,3,19,22
15,8479369,Andrew Peeke,D,BOS,26,82,3,19,22
15,8478416,Erik Cernak,D,TBL,27,82,2,20,22
15,8483457,Lane Hutson,D,MTL,20,82,9,12,21
15,8479368,Max Jones,L,BOS,26,82,9,12,21
15,8482118,Sam Colangelo,R,ANA,23,82,9,12,21
15,8484911,Collin Graf,R,SJS,22,82,8,13,21
15,8484203,Bradly Nadeau,L,CAR,19,82,7,14,21
15,8476858,Phillip Di Giuseppe,L,VAN,31,82,6,15,21
15,8477938,Haydn Fleury,D,WPG,28,82,5,16,21
15,8476891,Matt Grzelcyk,D,PIT,30,82,3,18,21
15,8476312,Josh Manson,D,COL,33,82,3,18,21
15,8479980,Nicolas Hague,D,VGK,26,82,2,19,21
15,8480807,Mattias Samuelsson,D,BUF,24,82,1,20,21
15,8483763,Maksymilian Szuber,D,UTA,22,82,10,10,20
15,8479442,Troy Stecher,D,EDM,30,82,8,12,20
15,8480144,David Kampf,C,TOR,29,82,7,13,20
15,8482153,Brendan Brisson,C,VGK,23,82,6,14,20
15,8475279,Ben Chiarot,D,DET,33,82,2,18,20
15,8481567,Henry Thrun,D,SJS,23,82,2,18,20
15,8478399,Jonas Siegenthaler,D,NJD,27,82,1,19,20
15,8483493,Frank Nazar,C,CHI,20,82,7,12,19
15,8482101,Danil Gushchin,L,SJS,22,82,6,13,19
15,8478468,Jeremy Lauzon,D,NSH,27,82,5,14,19
15,8474673,TJ Brodie,D,CHI,34,82,4,15,19
15,8479324,Ryan Lindgren,D,NYR,26,82,3,16,19
15,8480796,Martin Fehervary,D,WSH,25,82,3,16,19
15,8475462,Radko Gudas,D,ANA,34,82,2,17,19
15,8482259,Bobby McMann,C,TOR,28,82,12,6,18
15,8480021,Jack Studnicka,C,LAK,25,82,11,7,18
15,8479291,Kevin Rooney,C,CGY,31,82,9,9,18
15,8477931,Tomas Nosek,L,FLA,32,82,7,11,18
15,8483397,Marc McLaughlin,C,BOS,25,82,7,11,18
15,8484145,Zach Benson,L,BUF,19,82,6,12,18
15,8478443,Brandon Carlo,D,BOS,28,82,5,13,18
15,8480222,Sebastian Aho,D,PIT,28,82,4,14,18
15,8477499,Rasmus Ristolainen,D,PHI,30,82,4,14,18
15,8475177,Calvin de Haan,D,COL,33,82,3,15,18
15,8480172,Jan Rutta,D,SJS,34,82,2,16,18
15,8483460,David Jiricek,D,CBJ,21,82,1,17,18
15,8483499,Liam Ohgren,L,MIN,20,82,12,5,17
15,8482077,Dylan Holloway,L,EDM,23,82,10,7,17
15,8482155,Alex Laferriere,R,LAK,23,82,10,7,17
15,8478211,Dryden Hunt,L,CGY,29,82,9,8,17
15,8482702,Logan Stankoven,C,DAL,21,82,8,9,17
15,8482470,Ilya Solovyov,D,CGY,24,82,8,9,17
15,8483445,Cutter Gauthier,L,ANA,20,82,7,10,17
15,8481028,Martin Pospisil,C,CGY,25,82,7,10,17
15,8474013,Ian Cole,D,UTA,35,82,7,10,17
15,8482074,Connor Zary,C,CGY,23,82,6,11,17
15,8479998,Mikey Anderson,D,LAK,25,82,6,11,17
15,8475718,Justin Holl,D,DET,32,82,5,12,17
15,8475790,Erik Gudbranson,D,CBJ,32,82,5,12,17
15,8483495,Simon Nemec,D,NJD,20,82,3,14,17
15,8475324,Nick Jensen,D,OTT,34,82,3,14,17
15,8474574,Tyler Myers,D,VAN,34,82,3,14,17
15,8478136,Jake Middleton,D,MIN,28,82,2,15,17
15,8481708,Zac Jones,D,NYR,24,82,2,15,17
15,8481601,Simon Holmstrom,R,NYI,23,82,12,4,16
15,8481641,Joel Kiviranta,L,COL,28,82,6,10,16
15,8481122,Simon Benoit,D,TOR,26,82,6,10,16
15,8478178,Darren Raddysh,D,TBL,28,82,5,11,16
15,8481522,Peyton Krebs,C,BUF,23,82,3,13,16
15,8476967,Brett Kulak,D,EDM,30,82,1,15,16
15,8483012,Logan Morrison,C,SEA,22,82,8,7,15
15,8482749,Joshua Roy,R,MTL,21,82,5,10,15
15,8482807,Ethan Del Mastro,D,CHI,21,82,4,11,15
15,8483466,Kevin Korchinski,D,CHI,20,82,4,11,15
15,8477335,Kyle Burroughs,D,LAK,29,82,3,12,15
15,8474567,Zach Bogosian,D,MIN,34,82,2,13,15
15,8475842,Sam Carrick,C,NYR,32,82,9,5,14
15,8473453,Trevor Lewis,C,LAK,37,82,9,5,14
15,8476822,Luke Glendening,C,TBL,35,82,9,5,14
15,8482787,Nikita Chibrikov,R,WPG,31,82,6,8,14
15,8482713,Mackie Samoskevich,R,FLA,22,82,6,8,14
15,8477034,Jaycob Megna,D,FLA,32,82,5,9,14
15,8481605,Jackson LaCombe,D,ANA,23,82,2,12,14
15,8470600,Ryan Suter,D,STL,39,82,2,12,14
15,8480990,Declan Chisholm,D,MIN,24,82,7,6,13
15,8482679,Matt Coronato,R,CGY,22,82,7,6,13
15,8480870,Bo Groulx,C,NYR,24,82,6,7,13
15,8481699,Aku Raty,R,UTA,23,82,5,8,13
15,8471677,Jack Johnson,D,CBJ,37,82,2,11,13
15,8475762,Derek Forbort,D,VAN,32,82,4,8,12
15,8479576,Vincent Desharnais,D,VAN,28,82,3,9,12
15,8482858,Ryker Evans,D,SEA,23,82,2,10,12
15,8476473,Connor Murphy,D,CHI,31,82,2,10,12
15,8475455,Brenden Dillon,D,NJD,34,82,1,11,12
15,8482859,Zack Ostapchuk,C,OTT,21,82,6,5,11
15,8483567,Georgii Merkulov,C,BOS,24,82,6,5,11
15,8482712,Oskar Olausson,R,COL,22,82,4,7,11
15,8476372,Nick Seeler,D,PHI,31,82,3,8,11
15,8484149,Gavin Brindley,C,CBJ,20,82,2,9,11
15,8476441,Joel Edmundson,D,LAK,31,82,1,10,11
15,8482516,Matthew Kessel,D,STL,24,82,4,6,10
15,8479638,Justin Brazeau,R,BOS,26,82,4,6,10
15,8478874,Adam Gaudette,C,OTT,28,82,4,6,10
15,8482145,Mavrik Bourque,C,DAL,22,82,3,7,10
15,8480834,Ty Emberson,D,SJS,24,82,2,8,10
15,8478450,Parker Wotherspoon,D,BOS,27,82,2,8,10
15,8480879,Jacob Bernard-Docker,D,OTT,24,82,2,8,10
15,8474090,Brendan Smith,D,DAL,35,82,2,8,10
15,8474612,Travis Hamonic,D,OTT,34,82,1,9,10
15,8482762,Simon Edvinsson,D,DET,21,82,3,6,9
15,8480950,Ilya Lyubushkin,D,DAL,30,82,2,7,9
15,8482733,Logan Mailloux,D,MTL,31,82,1,8,9
15,8483471,Brad Lambert,C,WPG,31,82,1,8,9
15,8483489,Fraser Minten,C,TOR,31,82,6,2,8
15,8482070,Mitchell Chaffee,R,TBL,26,82,2,6,8
15,8474062,Riley Nash,C,NYR,35,82,5,2,7
15,8470794,Joe Pavelski,C,,40,0,0,0,0
15,8481703,Valtteri Puustinen,R,PIT,25,0,0,0,0
15,8477950,Tony DeAngelo,D,,29,0,0,0,0
15,8481577,Philip Tomasino,C,NSH,23,0,0,0,0
15,8475197,Tyson Barrie,D,,33,0,0,0,0
15,8471218,Blake Wheeler,R,,38,0,0,0,0
15,8474157,Max Pacioretty,L,,36,0,0,0,0
15,8478466,Daniel Sprong,R,VAN,27,0,0,0,0
15,8475744,Evgeny Kuznetsov,C,,32,0,0,0,0
15,8481019,David Gustafsson,C,WPG,24,0,0,0,0
15,8475906,John Klingberg,D,,32,0,0,0,0
15,8479348,Kale Clague,D,BUF,26,0,0,0,0
15,8476952,Dominic Toninato,C,WPG,30,0,0,0,0
15,8473473,Milan Lucic,L,,36,0,0,0,0
15,8474037,James van Riemsdyk,L,,35,0,0,0,0
15,8474602,Justin Schultz,D,,34,0,0,0,0
15,8482222,Alexander Barabanov,L,,30,0,0,0,0
15,8479372,Josh Mahura,D,SEA,26,0,0,0,0
15,8479982,Conor Timmins,D,TOR,26,0,0,0,0
15,8474031,Kevin Shattenkirk,D,,35,0,0,0,0
15,8480008,Adam Ruzicka,C,,25,0,0,0,0
15,8481059,Scott Perunovich,D,STL,26,0,0,0,0
15,8480884,Calen Addison,D,,24,0,0,0,0
15,8476994,Vinnie Hinostroza,C,NSH,30,0,0,0,0
15,8478452,Caleb Jones,D,LAK,27,0,0,0,0
15,8480157,Calle Rosen,D,COL,30,0,0,0,0
15,8481609,Vladislav Kolyachonok,D,UTA,23,0,0,0,0
15,8479415,Michael McLeod,C,,26,0,0,0,0
15,8476919,Chris Tierney,C,,30,0,0,0,0
15,8479639,Dylan Coghlan,D,WPG,26,0,0,0,0
15,8478146,Matthew Highmore,C,OTT,28,0,0,0,0
15,8478970,Jalen Chatfield,D,CAR,28,0,0,0,0
15,8480205,Emil Bemstrom,C,PIT,25,0,0,0,0
15,8474884,Mike Hoffman,C,,35,0,0,0,0
15,8471274,Alex Goligoski,D,,39,0,0,0,0
15,8478104,Sammy Blais,L,,28,0,0,0,0
15,8474870,Tyler Johnson,C,,34,0,0,0,0
15,8476913,Devin Shore,C,MIN,30,0,0,0,0
15,8481598,Philip Broberg,D,EDM,23,0,0,0,0
15,8480058,Pierre-Olivier Joseph,D,STL,25,0,0,0,0
15,8480891,Michael Kesselring,D,UTA,24,0,0,0,0
15,8477979,Nicolas Aube-Kubel,R,BUF,28,0,0,0,0
15,8476871,Tanner Pearson,L,,32,0,0,0,0
15,8476393,Nick Cousins,C,,31,0,0,0,0
15,8479977,Kailer Yamamoto,R,,26,0,0,0,0
15,8479543,Michael Pezzetta,L,MTL,26,0,0,0,0
15,8477018,Ben Hutton,D,VGK,31,0,0,0,0
15,8480762,Eric Robinson,L,CAR,29,0,0,0,0
15,8474034,Pat Maroon,L,CHI,36,0,0,0,0
15,8481058,Jesse Ylönen,R,,25,0,0,0,0
15,8475179,Dmitry Kulikov,D,FLA,34,0,0,0,0
15,8481527,Kaedan Korczak,D,VGK,23,0,0,0,0
15,8473449,Kyle Okposo,R,,36,0,0,0,0
15,8482192,Isaak Phillips,D,CHI,23,0,0,0,0
15,8480727,Zach Whitecloud,D,VGK,28,0,0,0,0
15,8479346,Dillon Dube,C,,26,0,0,0,0
15,8480821,Filip Zadina,R,,25,0,0,0,0
15,8480001,Urho Vaakanainen,D,ANA,25,0,0,0,0
15,8470966,Mark Giordano,D,,41,0,0,0,0
15,8480853,Liam Foudy,C,,24,0,0,0,0
15,8475225,Craig Smith,C,CHI,35,0,0,0,0
15,8479972,Mason Shaw,C,WPG,26,0,0,0,0
15,8478451,Ethan Bear,D,WSH,27,0,0,0,0
15,8474040,Sam Gagner,C,,35,0,0,0,0
15,8480196,Jacob Bryson,D,BUF,27,0,0,0,0
15,8479984,Cal Foote,D,,26,0,0,0,0
15,8480011,Klim Kostin,C,SJS,25,0,0,0,0
15,8482176,Wyatt Kaiser,D,CHI,22,0,0,0,0
15,8476988,Matt Benning,D,SJS,30,0,0,0,0
15,8479370,Tyson Jost,C,CAR,26,0,0,0,0
15,8477464,Nic Petan,C,,29,0,0,0,0
15,8477380,Jonny Brodzinski,C,NYR,31,0,0,0,0
15,8480070,Ian Mitchell,D,BOS,25,0,0,0,0
15,8479315,Joey Anderson,R,CHI,26,0,0,0,0
15,8478099,Kevin Labanc,R,,29,0,0,0,0
15,8476874,Olli Maatta,D,DET,30,0,0,0,0
15,8475208,Brian Dumoulin,D,ANA,33,0,0,0,0
15,8478430,Oliver Kylington,D,,27,0,0,0,0
15,8479536,Axel Jonsson-Fjallby,L,WPG,26,0,0,0,0
15,8479671,Mathieu Olivier,R,CBJ,27,0,0,0,0
15,8471709,Marc-Edouard Vlasic,D,SJS,37,0,0,0,0
15,8479328,Julien Gauthier,R,NYI,27,0,0,0,0
15,8478421,A.J. Greer,L,FLA,28,0,0,0,0
15,8477573,Nathan Walker,L,STL,30,0,0,0,0
15,8481537,Nikita Okhotiuk,D,CGY,24,0,0,0,0
15,8474166,Alec Martinez,D,CHI,37,0,0,0,0
15,8470610,Zach Parise,L,,40,0,0,0,0
15,8477478,William Carrier,L,CAR,30,0,0,0,0
15,8479344,Jesse Puljujarvi,R,PIT,26,0,0,0,0
15,8480887,Jordan Harris,D,MTL,24,0,0,0,0
15,8478502,Dennis Gilbert,D,BUF,28,0,0,0,0
15,8482730,Brandt Clarke,D,LAK,21,0,0,0,0
15,8480355,Mark Kastelic,C,BOS,25,0,0,0,0
15,8475750,Jon Merrill,D,MIN,32,0,0,0,0
15,8475164,Jakob Silfverberg,R,,34,0,0,0,0
15,8477944,Jakub Vrana,L,,28,0,0,0,0
15,8479439,Jacob MacDonald,D,COL,31,0,0,0,0
15,8474568,Luke Schenn,D,NSH,35,0,0,0,0
15,8478454,Noah Juulsen,D,VAN,27,0,0,0,0
15,8475752,Tyler Pitlick,C,,33,0,0,0,0
15,8482148,Hendrix Lapierre,C,WSH,22,0,0,0,0
15,8481167,Brayden Pachal,D,CGY,25,0,0,0,0
15,8478043,Sam Lafferty,C,BUF,29,0,0,0,0
15,8479321,Lucas Johansen,D,,27,0,0,0,0
15,8471699,Andrew Cogliano,C,,37,0,0,0,0
15,8481521,Ronnie Attard,D,PHI,25,0,0,0,0
15,8481161,Jake Christiansen,D,CBJ,25,0,0,0,0
15,8479458,Nikita Zaitsev,D,,33,0,0,0,0
15,8479619,Michael Carcone,L,UTA,28,0,0,0,0
15,8479026,Philippe Myers,D,TOR,27,0,0,0,0
15,8477330,Dominik Kubalik,L,,29,0,0,0,0
15,8481617,Vasily Podkolzin,R,VAN,23,0,0,0,0
15,8481701,Santeri Hatakka,D,NJD,23,0,0,0,0
15,8479514,Rem Pitlick,C,,27,0,0,0,0
15,8477446,Michael McCarron,R,NSH,29,0,0,0,0
15,8470604,Jeff Carter,C,,39,0,0,0,0
15,8482241,Radim Zohorna,L,,28,0,0,0,0
15,8480289,Morgan Barron,C,WPG,26,0,0,0,0
15,8479379,Givani Smith,R,SJS,26,0,0,0,0
15,8480216,Jacob Peterson,C,,25,0,0,0,0
15,8477851,Jordan Oesterle,D,BOS,32,0,0,0,0
15,8484258,Sam Malinski,D,COL,26,0,0,0,0
15,8478904,Steven Lorentz,C,,28,0,0,0,0
15,8482095,Tyler Kleven,D,OTT,22,0,0,0,0
15,8480848,Ty Dellandrea,C,SJS,24,0,0,0,0
15,8476884,Derrick Pouliot,D,,30,0,0,0,0
15,8479336,Carl Grundstrom,R,SJS,27,0,0,0,0
15,8482964,Arber Xhekaj,D,MTL,23,0,0,0,0
15,8471686,Marc Staal,D,,37,0,0,0,0
15,8477887,Patrick Brown,C,BOS,32,0,0,0,0
15,8478495,Denis Gurianov,R,,27,0,0,0,0
15,8473504,Cal Clutterbuck,R,,37,0,0,0,0
15,8481550,Adam Beckman,L,NJD,23,0,0,0,0
15,8480845,Rasmus Kupari,C,WPG,24,0,0,0,0
15,8474009,Nick Bonino,C,,36,0,0,0,0
15,8478585,Derek Ryan,C,EDM,38,0,0,0,0
15,8477962,Brendan Lemieux,L,CAR,28,0,0,0,0
15,8482861,Vincent Iorio,D,WSH,22,0,0,0,0
15,8479378,Logan Stanley,D,WPG,26,0,0,0,0
15,8473446,Erik Johnson,D,PHI,36,0,0,0,0
15,8481743,Marc Del Gaizo,D,NSH,25,0,0,0,0
15,8477384,Josh Brown,D,EDM,30,0,0,0,0
15,8482165,Yan Kuznetsov,D,CGY,22,0,0,0,0
15,8478424,Jansen Harkins,C,ANA,27,0,0,0,0
15,8482144,Jack Thompson,D,SJS,22,0,0,0,0
15,8478512,Austin Czarnik,C,,32,0,0,0,0
15,8477527,Ross Johnston,L,ANA,30,0,0,0,0
15,8479383,Boris Katchouk,L,,26,0,0,0,0
15,8482094,Daemon Hunt,D,MIN,22,0,0,0,0
15,8481719,Maxwell Crozier,D,TBL,24,0,0,0,0
15,8480192,Johnathan Kovacevic,D,NJD,27,0,0,0,0
15,8479376,Victor Mete,D,,26,0,0,0,0
15,8482511,Mason Lohrei,D,BOS,23,0,0,0,0
15,8475825,Jani Hakanpää,D,,32,0,0,0,0
15,8478021,William Lagesson,D,DET,28,0,0,0,0
15,8475795,Dylan McIlrath,D,WSH,32,0,0,0,0
15,8477846,Ryan Carpenter,C,,33,0,0,0,0
15,8481056,Spencer Stastney,D,NSH,24,0,0,0,0
15,8481564,Ryan Johnson,D,BUF,23,0,0,0,0
15,8478017,Mark Friedman,D,VAN,29,0,0,0,0
15,8479320,Max Lajoie,D,SEA,27,0,0,0,0
15,8480075,Cameron Crotty,D,MIN,25,0,0,0,0
15,8484287,Cole McWard,D,VAN,23,0,0,0,0
15,8484254,Akito Hirose,D,VAN,25,0,0,0,0
15,8483407,Brandon Scanlin,D,NYR,25,0,0,0,0
15,8480274,Philip Kemp,D,EDM,25,0,0,0,0
15,8479522,Hardy Haman Aktell,D,WSH,26,0,0,0,0
15,8480007,Jonas Rondbjerg,R,VGK,25,0,0,0,0
15,8477454,Adam Erne,L,,29,0,0,0,0
15,8481679,Maxence Guenette,D,OTT,23,0,0,0,0
15,8480441,Trey Fix-Wolansky,R,CBJ,25,0,0,0,0
15,8483546,Marshall Rifai,D,TOR,26,0,0,0,0
15,8480084,Nick DeSimone,D,NJD,30,0,0,0,0
15,8481030,Jack St. Ivany,D,PIT,25,0,0,0,0
15,8481592,Jakob Pelletier,L,CGY,23,0,0,0,0
15,8478011,Louie Belpedio,D,PHI,28,0,0,0,0
15,8477930,Pierre-Edouard Bellemare,L,,39,0,0,0,0
15,8484321,Nikolas Matinpalo,D,OTT,26,0,0,0,0
15,8482067,Connor Mackey,D,NYR,28,0,0,0,0
15,8481806,Louis Crevier,D,CHI,23,0,0,0,0
15,8484326,Patrik Koch,D,UTA,28,0,0,0,0
15,8477971,Andreas Englund,D,LAK,28,0,0,0,0
15,8481751,Lukas Rousek,R,BUF,25,0,0,0,0
15,8481006,Tyler Tucker,D,STL,24,0,0,0,0
15,8476867,Brendan Gaunce,C,MIN,30,0,0,0,0
15,8479520,Brandon Duhaime,R,WSH,27,0,0,0,0
15,8477073,Kurtis MacDermid,L,NJD,30,0,0,0,0
15,8480874,Adam Ginning,D,PHI,24,0,0,0,0
15,8477473,Justin Bailey,R,SJS,29,0,0,0,0
15,8479066,Ryan Lomberg,L,CGY,30,0,0,0,0
15,8477070,Liam O'Brien,C,UTA,30,0,0,0,0
15,8474618,Marco Scandella,D,,34,0,0,0,0
15,8475797,Jarred Tinordi,D,,32,0,0,0,0
15,8481441,Joe Snively,C,DET,28,0,0,0,0
15,8477244,Chad Ruhwedel,D,NYR,34,0,0,0,0
15,8479772,Zack MacEwen,R,OTT,28,0,0,0,0
15,8481147,Reese Johnson,C,MIN,26,0,0,0,0
15,8481043,Cole Koepke,L,BOS,26,0,0,0,0
15,8483619,Filip Roos,D,OTT,25,0,0,0,0
15,8481541,Samuel Bolduc,D,NYI,24,0,0,0,0
15,8477810,Joel Hanley,D,CGY,33,0,0,0,0
15,8476907,Mackenzie MacEachern,L,,30,0,0,0,0
15,8482652,Walker Duehr,R,CGY,27,0,0,0,0
15,8477126,Jayson Megna,C,,34,0,0,0,0
15,8483398,Declan Carlile,D,TBL,31,0,0,0,0
15,8482929,Emil Lilleberg,D,TBL,23,0,0,0,0
15,8480880,Jakub Lauko,C,MIN,24,0,0,0,0
15,8480245,Olle Lycksell,R,PHI,25,0,0,0,0
15,8480252,Cole Guttman,C,CHI,25,0,0,0,0
15,8477467,Gustav Olofsson,D,SEA,30,0,0,0,0
15,8479968,Vinni Lettieri,C,BOS,29,0,0,0,0
15,8478400,Colin White,C,,27,0,0,0,0
15,8475755,Alexander Petrovic,D,DAL,32,0,0,0,0
15,8481812,Nikolai Knyzhov,D,,27,0,0,0,0
15,8481593,Jayden Struble,D,MTL,23,0,0,0,0
15,8481532,Alex Turcotte,C,LAK,23,0,0,0,0
15,8482126,Emil Andrae,D,PHI,31,0,0,0,0
15,8479944,Zach Aston-Reese,C,VGK,30,0,0,0,0
15,8471817,Ryan Reaves,R,TOR,37,0,0,0,0
15,8481206,John Ludvig,D,PIT,24,0,0,0,0
15,8481599,Victor Soderstrom,D,UTA,23,0,0,0,0
15,8480292,Carson Meyer,R,ANA,27,0,0,0,0
15,8482496,Nils Aman,C,VAN,24,0,0,0,0
15,8479718,Alex Barré-Boulet,C,MTL,27,0,0,0,0
15,8479994,Jaret Anderson-Dolan,C,WPG,25,0,0,0,0
15,8480184,Gustav Lindstrom,D,,26,0,0,0,0
15,8480890,Jan Jenik,R,OTT,24,0,0,0,0
15,8478067,Oskar Lindblom,L,,28,0,0,0,0
15,8476934,Brock McGinn,L,ANA,30,0,0,0,0
15,8479985,Cale Fleury,D,SEA,26,0,0,0,0
15,8484304,Uvis Balinskis,D,FLA,28,0,0,0,0
15,8479981,Jonah Gadjovich,L,FLA,26,0,0,0,0
15,8481716,Dmitri Voronkov,L,CBJ,24,0,0,0,0
15,8474709,Matt Martin,L,,35,0,0,0,0
15,8482634,Alex Steeves,C,TOR,25,0,0,0,0
15,8480823,Alexander Alexeyev,D,WSH,25,0,0,0,0
15,8477541,Dakota Mermis,D,TOR,30,0,0,0,0
15,8483491,Ivan Miroshnichenko,L,WSH,20,0,0,0,0
15,8478477,Mitchell Stephens,C,SEA,27,0,0,0,0
15,8481543,Nikita Alexandrov,C,STL,24,0,0,0,0
15,8479423,Alex Nylander,L,,26,0,0,0,0
15,8482451,Mikael Pyyhtia,L,CBJ,23,0,0,0,0
15,8478831,Kevin Stenlund,C,UTA,28,0,0,0,0
15,8480306,Grant Hutton,D,NYI,29,0,0,0,0
15,8478028,Fredrik Olofsson,L,,28,0,0,0,0
15,8477462,Robert Hagg,D,VGK,29,0,0,0,0
15,8477320,Anton Blidh,L,NYR,29,0,0,0,0
15,8482157,Will Cuylle,L,NYR,22,0,0,0,0
15,8482737,Zack Bolduc,C,STL,21,0,0,0,0
15,8481239,Samuel Fagemo,L,,24,0,0,0,0
15,8481600,Tobias Bjornfot,D,FLA,23,0,0,0,0
15,8478409,Anthony Richard,C,PHI,28,0,0,0,0
15,8474145,Robert Bortuzzo,D,,35,0,0,0,0
15,8475958,Michael Sgarbossa,C,WSH,32,0,0,0,0
15,8479986,Kole Lind,R,DAL,26,0,0,0,0
15,8479249,Andrew Poturalski,C,SJS,30,0,0,0,0
15,8479362,Riley Tufte,L,BOS,26,0,0,0,0
15,8479991,Jake Leschyshyn,C,NYR,25,0,0,0,0
15,8479587,Rhett Gardner,C,PHI,28,0,0,0,0
15,8482744,James Malatesta,L,CBJ,21,0,0,0,0
15,8478854,Ryan Shea,D,PIT,27,0,0,0,0
15,8481591,Sam Poulin,R,,23,0,0,0,0
15,8483512,Matt Savoie,C,EDM,20,0,0,0,0
15,8482102,Vasily Ponomarev,C,PIT,22,0,0,0,0
15,8482162,Roby Jarventie,L,EDM,22,0,0,0,0
15,8481016,Ruslan Iskhakov,C,,24,0,0,0,0
15,8482172,Landon Slaggert,L,CHI,22,0,0,0,0
15,8482747,Brennan Othmann,L,NYR,21,0,0,0,0
15,8480031,Maxime Comtois,L,,25,0,0,0,0
15,8480226,Marián Studenic,R,,26,0,0,0,0
15,8478408,Travis Dermott,D,,28,0,0,0,0
15,8481518,Nolan Foote,L,NJD,24,0,0,0,0
15,8479419,Brett Murray,L,BUF,26,0,0,0,0
15,8482088,Justin Sourdif,R,FLA,22,0,0,0,0
15,8482201,Gage Goncalves,C,TBL,23,0,0,0,0
15,8481578,Graeme Clarke,R,MIN,23,0,0,0,0
15,8482177,Marat Khusnutdinov,C,MIN,22,0,0,0,0
15,8481754,Nikita Nesterenko,C,ANA,23,0,0,0,0
15,8483531,Brian Halonen,L,NJD,25,0,0,0,0
15,8483920,Pierrick Dube,R,WSH,23,0,0,0,0
15,8480851,Akil Thomas,C,LAK,24,0,0,0,0
15,8475235,Nicolas Deslauriers,L,PHI,33,0,0,0,0
15,8482476,Emil Heineman,L,MTL,23,0,0,0,0
15,8477149,Scott Sabourin,R,SJS,32,0,0,0,0
15,8483549,Lucas Condotta,L,MTL,27,0,0,0,0
15,8482765,Isak Rosen,R,BUF,21,0,0,0,0
15,8481237,Kyle MacLean,C,NYI,25,0,0,0,0
15,8481024,Linus Karlsson,C,VAN,25,0,0,0,0
15,8481690,Tyler Angle,C,,24,0,0,0,0
15,8483570,Ben Meyers,C,SEA,26,0,0,0,0
15,8481655,Cole Schwindt,R,CGY,23,0,0,0,0
15,8481462,Mason Morelli,L,VGK,28,0,0,0,0
15,8483401,Marc Johnstone,R,PIT,28,0,0,0,0
15,8478956,Samuel Laberge,L,NJD,27,0,0,0,0
15,8479533,Joona Koppanen,L,,26,0,0,0,0
15,8482197,Adam Raska,R,MIN,23,0,0,0,0
15,8482250,Callahan Burke,C,VGK,27,0,0,0,0
15,8482784,Zach Dean,C,STL,21,0,0,0,0
15,8484255,Jason Polin,R,COL,25,0,0,0,0
15,8481077,John Leonard,L,,26,0,0,0,0
15,8481534,Raphael Lavoie,C,EDM,24,0,0,0,0
15,8483609,Adam Klapka,R,CGY,24,0,0,0,0
15,8482751,Ryan Winterton,C,SEA,21,0,0,0,0
15,8480267,Sammy Walker,C,MIN,25,0,0,0,0
15,8475766,Austin Watson,L,,32,0,0,0,0
15,8482460,Matt Rempe,C,NYR,22,0,0,0,0
15,8481065,Angus Crookshank,L,OTT,25,0,0,0,0
15,8481070,Hugh McGing,L,,26,0,0,0,0
15,8476323,Max McCormick,L,SEA,32,0,0,0,0
15,8483395,Arshdeep Bains,L,VAN,23,0,0,0,0
15,8484259,Ondrej Pavel,C,COL,31,0,0,0,0
15,8483432,Luca Del Bel Belluz,C,CBJ,31,0,0,0,0
15,8483045,Cameron Butler,R,CBJ,31,0,0,0,0
15,8482061,Brandon Biro,L,SEA,26,0,0,0,0
15,8477401,John Hayden,C,SEA,29,0,0,0,0
15,8475278,Byron Froese,C,,33,0,0,0,0
15,8478446,Glenn Gawdin,C,LAK,27,0,0,0,0
15,8477993,Justin Kirkland,C,CGY,28,0,0,0,0
15,8482147,Jean-Luc Foudy,C,COL,22,0,0,0,0
15,8480032,Shane Bowers,C,NJD,25,0,0,0,0
15,8479330,Brandon Gignac,C,MTL,27,0,0,0,0
15,8480776,Sheldon Rempal,R,,29,0,0,0,0
15,8475413,Justin Dowling,C,NJD,34,0,0,0,0
15,8481726,Adam Edstrom,C,NYR,24,0,0,0,0
15,8480844,Grigori Denisenko,L,VGK,24,0,0,0,0
15,8478147,Bokondji Imama,L,PIT,28,0,0,0,0
15,8478881,Brett Seney,L,CHI,28,0,0,0,0
15,8483630,Pavol Regenda,L,ANA,25,0,0,0,0
15,8480836,Jonathan Gruden,C,,24,0,0,0,0
15,8484314,Jiri Smejkal,L,,28,0,0,0,0
15,8475780,Chris Wagner,R,COL,33,0,0,0,0
15,8479546,Oskar Steen,C,,26,0,0,0,0
15,8483597,Milos Kelemen,L,UTA,25,0,0,0,0
15,8481789,Tye Kartye,L,SEA,23,0,0,0,0
15,8484325,Waltteri Merela,C,TBL,26,0,0,0,0
15,8479421,Jacob Moverare,D,LAK,26,0,0,0,0
15,8481585,Egor Afanasyev,L,SJS,23,0,0,0,0
15,8479547,Matthew Phillips,R,,26,0,0,0,0
15,8479367,William Lockwood,R,FLA,26,0,0,0,0
15,8476915,Jujhar Khaira,L,,30,0,0,0,0
15,8481422,Jacob Lucchini,C,NSH,29,0,0,0,0
15,8480468,James Hamblin,L,EDM,25,0,0,0,0
15,8478051,Max Willman,C,NJD,29,0,0,0,0
15,8481556,John Beecher,C,BOS,23,0,0,0,0
15,8478078,Rourke Chartier,C,,28,0,0,0,0
16,8478402,Connor McDavid,C,EDM,27,82,39,110,149
16,8477492,Nathan MacKinnon,C,COL,29,82,45,98,143
16,8476453,Nikita Kucherov,R,TBL,31,82,39,85,124
16,8477956,David Pastrnak,R,BOS,28,82,62,61,123
16,8471675,Sidney Crosby,C,PIT,37,82,54,64,118
16,8481559,Jack Hughes,C,NJD,23,82,50,65,115
16,8479314,Matthew Tkachuk,L,FLA,27,82,41,73,114
16,8480069,Cale Makar,D,COL,26,82,31,83,114
16,8478420,Mikko Rantanen,R,COL,28,82,59,54,113
16,8477934,Leon Draisaitl,C,EDM,29,82,48,65,113
16,8480012,Elias Pettersson,C,VAN,26,82,51,58,109
16,8478864,Kirill Kaprizov,L,MIN,27,82,44,65,109
16,8477942,Kevin Fiala,L,LAK,28,82,40,66,106
16,8477493,Aleksander Barkov,C,FLA,29,82,31,74,105
16,8479318,Auston Matthews,C,TOR,27,82,56,47,103
16,8477939,William Nylander,R,TOR,28,82,44,58,102
16,8477404,Jake Guentzel,C,TBL,30,82,44,57,101
16,8476468,J.T. Miller,C,VAN,31,82,37,63,100
16,8477402,Pavel Buchnevich,L,STL,29,82,37,62,99
16,8482116,Tim Stützle,C,OTT,22,82,38,60,98
16,8477946,Dylan Larkin,C,DET,28,82,47,50,97
16,8474564,Steven Stamkos,C,NSH,34,82,39,58,97
16,8480830,Andrei Svechnikov,R,CAR,24,82,36,61,97
16,8480002,Nico Hischier,C,NJD,25,82,35,62,97
16,8480027,Jason Robertson,L,DAL,25,82,33,64,97
16,8478427,Sebastian Aho,C,CAR,27,82,38,57,95
16,8479343,Clayton Keller,R,UTA,26,82,40,54,94
16,8480023,Robert Thomas,C,STL,25,82,21,73,94
16,8477409,Carter Verhaeghe,C,FLA,29,82,50,43,93
16,8478414,Timo Meier,R,NJD,28,82,47,45,92
16,8477501,Valeri Nichushkin,R,COL,29,82,44,48,92
16,8476460,Mark Scheifele,C,WPG,31,82,39,50,89
16,8479407,Jesper Bratt,L,NJD,26,82,29,60,89
16,8476346,Johnny Gaudreau,L,CBJ,31,82,28,59,87
16,8476887,Filip Forsberg,L,NSH,30,82,32,54,86
16,8477949,Alex Tuch,R,BUF,28,82,31,54,85
16,8477951,Nick Schmaltz,C,UTA,28,82,30,55,85
16,8478550,Artemi Panarin,L,NYR,33,82,24,61,85
16,8475754,Brock Nelson,C,NYI,33,82,51,32,83
16,8481557,Matt Boldy,L,MIN,23,82,34,49,83
16,8477933,Sam Reinhart,C,FLA,29,82,27,56,83
16,8471214,Alex Ovechkin,L,WSH,39,82,38,44,82
16,8475168,Matt Duchene,C,DAL,33,82,33,49,82
16,8476459,Mika Zibanejad,C,NYR,31,82,31,51,82
16,8480800,Quinn Hughes,D,VAN,25,82,16,66,82
16,8478010,Brayden Point,C,TBL,28,82,40,41,81
16,8476389,Vincent Trocheck,C,NYR,31,82,38,43,81
16,8477496,Elias Lindholm,C,BOS,30,82,35,46,81
16,8481068,Yegor Sharangovich,C,CGY,26,82,45,35,80
16,8478445,Mathew Barzal,C,NYI,27,82,23,57,80
16,8474600,Roman Josi,D,NSH,34,82,18,62,80
16,8478398,Kyle Connor,L,WPG,28,82,35,44,79
16,8478873,Troy Terry,R,ANA,27,82,29,50,79
16,8477504,Josh Morrissey,D,WPG,29,82,17,62,79
16,8477940,Nikolaj Ehlers,L,WPG,28,82,34,44,78
16,8478449,Roope Hintz,C,DAL,28,82,30,47,77
16,8476454,Ryan Nugent-Hopkins,C,EDM,31,82,19,58,77
16,8480865,Noah Dobson,D,NYI,24,82,16,61,77
16,8474578,Erik Karlsson,D,PIT,34,82,12,64,76
16,8476539,Jonathan Marchessault,R,NSH,34,82,35,40,75
16,8480036,Miro Heiskanen,D,DAL,25,82,24,51,75
16,8476456,Jonathan Huberdeau,C,CGY,31,82,21,54,75
16,8475172,Nazem Kadri,C,CGY,34,82,34,40,74
16,8471685,Anze Kopitar,C,LAK,37,82,24,50,74
16,8476448,William Karlsson,C,VGK,31,82,28,45,73
16,8478047,Michael Bunting,L,PIT,29,82,25,48,73
16,8475170,Brayden Schenn,C,STL,33,82,23,50,73
16,8476853,Morgan Rielly,D,TOR,30,82,12,61,73
16,8479420,Tage Thompson,C,BUF,27,82,30,41,71
16,8478440,Dylan Strome,C,WSH,27,82,26,45,71
16,8480803,Evan Bouchard,D,EDM,25,82,20,51,71
16,8479339,Patrik Laine,L,CBJ,26,82,36,34,70
16,8474141,Patrick Kane,R,DET,36,82,34,36,70
16,8475810,Bryan Rust,R,PIT,32,82,31,39,70
16,8473419,Brad Marchand,L,BOS,36,82,26,44,70
16,8481540,Cole Caufield,R,MTL,23,82,39,30,69
16,8475786,Zach Hyman,L,EDM,32,82,37,32,69
16,8480208,Drake Batherson,R,OTT,26,82,28,41,69
16,8482093,Seth Jarvis,C,CAR,22,82,26,43,69
16,8480801,Brady Tkachuk,L,OTT,25,82,37,31,68
16,8479542,Brandon Hagel,L,TBL,26,82,33,35,68
16,8478444,Brock Boeser,R,VAN,27,82,30,38,68
16,8478042,Viktor Arvidsson,R,EDM,31,82,27,41,68
16,8478856,Conor Garland,R,VAN,28,82,22,46,68
16,8476462,Dougie Hamilton,D,NJD,31,82,19,49,68
16,8475167,Victor Hedman,D,TBL,34,82,14,54,68
16,8479385,Jordan Kyrou,C,STL,26,82,29,38,67
16,8478439,Travis Konecny,R,PHI,27,82,25,42,67
16,8475913,Mark Stone,R,VGK,32,82,22,45,67
16,8478396,Noah Hanifin,D,VGK,27,82,17,50,67
16,8474590,John Carlson,D,WSH,34,82,14,53,67
16,8477960,Adrian Kempe,R,LAK,28,82,33,33,66
16,8479337,Alex DeBrincat,R,DET,27,82,29,37,66
16,8481523,Kirby Dach,C,MTL,23,82,17,49,66
16,8479325,Charlie McAvoy,D,BOS,27,82,11,55,66
16,8475784,Jeff Skinner,C,EDM,32,82,35,30,65
16,8476880,Tom Wilson,R,WSH,30,82,33,32,65
16,8482665,Matty Beniers,C,SEA,22,82,24,41,65
16,8479675,Trevor Moore,L,LAK,29,82,39,25,64
16,8478403,Jack Eichel,C,VGK,28,82,34,30,64
16,8478460,Zach Werenski,D,CBJ,27,82,15,49,64
16,8480839,Rasmus Dahlin,D,BUF,24,82,13,51,64
16,8478493,Joel Eriksson Ek,C,MIN,27,82,34,29,63
16,8480039,Martin Necas,C,CAR,25,82,31,32,63
16,8477479,Tyler Bertuzzi,L,CHI,29,82,28,35,63
16,8477416,Oliver Bjorkstrand,R,SEA,29,82,26,37,63
16,8477346,MacKenzie Weegar,D,CGY,30,82,16,47,63
16,8477955,Jared McCann,L,SEA,28,82,35,27,62
16,8480018,Nick Suzuki,C,MTL,25,82,29,33,62
16,8478975,Mason Marchment,L,DAL,29,82,16,46,62
16,8475692,Mats Zuccarello,R,MIN,37,82,12,50,62
16,8476881,Tomas Hertl,C,VGK,31,82,30,31,61
16,8476483,Rickard Rakell,R,PIT,31,82,27,34,61
16,8475166,John Tavares,C,TOR,34,82,25,36,61
16,8479999,Casey Mittelstadt,C,COL,26,82,24,37,61
16,8474679,Gustav Nyquist,C,NSH,35,82,18,43,61
16,8476905,Chandler Stephenson,C,SEA,30,82,16,45,61
16,8477447,Shea Theodore,D,VGK,29,82,14,47,61
16,8471724,Kris Letang,D,PIT,37,82,12,49,61
16,8479323,Adam Fox,D,NYR,26,82,10,51,61
16,8479425,Filip Hronek,D,VAN,27,82,9,52,61
16,8475184,Chris Kreider,L,NYR,33,82,40,20,60
16,8482159,Tyson Foerster,R,PHI,22,82,36,24,60
16,8476432,Boone Jenner,C,CBJ,31,82,31,29,60
16,8475151,Kyle Palmieri,C,NYI,33,82,30,30,60
16,8482097,Jack Quinn,R,BUF,23,82,29,31,60
16,8482745,Mason McTavish,C,ANA,21,82,26,34,60
16,8471215,Evgeni Malkin,C,PIT,38,82,25,35,60
16,8475765,Vladimir Tarasenko,R,DET,33,82,24,36,60
16,8478397,Rasmus Andersson,D,CGY,28,82,18,42,60
16,8480014,Gabriel Vilardi,C,WPG,25,82,41,18,59
16,8473986,Alex Killorn,L,ANA,35,82,27,32,59
16,8482078,Lucas Raymond,L,DET,22,82,23,36,59
16,8478401,Pavel Zacha,C,BOS,27,82,17,42,59
16,8480871,Adam Boqvist,D,FLA,24,82,10,49,59
16,8478366,Frank Vatrano,R,ANA,30,82,29,29,58
16,8482113,Anton Lundell,C,FLA,23,82,28,30,58
16,8480797,Joel Farabee,L,PHI,24,82,26,32,58
16,8482740,Wyatt Johnston,C,DAL,21,82,23,34,57
16,8476826,Yanni Gourde,C,SEA,33,82,23,34,57
16,8477494,Jonathan Drouin,L,COL,29,82,21,36,57
16,8477021,Alex Kerfoot,C,UTA,30,82,21,36,57
16,8475791,Taylor Hall,L,CHI,33,82,19,38,57
16,8477497,Sean Monahan,C,CBJ,30,82,19,38,57
16,8477495,Seth Jones,D,CHI,30,82,17,40,57
16,8474563,Drew Doughty,D,LAK,35,82,15,42,57
16,8475798,Mikael Granlund,C,SJS,32,82,13,44,57
16,8478498,Jake DeBrusk,L,VAN,28,82,29,27,56
16,8484144,Connor Bedard,C,CHI,19,82,29,27,56
16,8477500,Bo Horvat,C,NYI,29,82,27,29,56
16,8477935,Sam Bennett,C,FLA,28,82,27,29,56
16,8481624,Ilya Mikheyev,R,CHI,30,82,25,31,56
16,8481533,Trevor Zegras,C,ANA,23,82,20,36,56
16,8473994,Jamie Benn,L,DAL,35,82,20,36,56
16,8475794,Tyler Seguin,C,DAL,32,82,33,22,55
16,8476438,Brandon Saad,L,STL,32,82,28,27,55
16,8480015,Owen Tippett,R,PHI,25,82,26,29,55
16,8474102,David Perron,L,OTT,36,82,26,29,55
16,8482110,Dawson Mercer,C,NJD,23,82,26,29,55
16,8475745,Charlie Coyle,C,BOS,32,82,22,33,55
16,8477451,Ryan Hartman,R,MIN,30,82,18,37,55
16,8478038,Devon Toews,D,COL,30,82,14,41,55
16,8474150,Mikael Backlund,C,CGY,35,82,23,31,54
16,8479987,Morgan Geekie,C,BOS,26,82,21,33,54
16,8478458,Jack Roslovic,C,CAR,27,82,20,34,54
16,8473512,Claude Giroux,R,OTT,36,82,19,35,54
16,8476875,Mike Matheson,D,MTL,30,82,10,44,54
16,8479345,Jakob Chychrun,D,WSH,26,82,21,32,53
16,8476479,Phillip Danault,C,LAK,31,82,19,34,53
16,8482175,JJ Peterka,R,BUF,22,82,28,24,52
16,8478463,Anthony Beauvillier,L,PIT,27,82,26,26,52
16,8477456,J.T. Compher,L,DET,29,82,22,30,52
16,8475726,Tyler Toffoli,C,SJS,32,82,20,32,52
16,8478438,Tommy Novak,C,NSH,27,82,20,32,52
16,8480434,Sean Durzi,D,UTA,26,82,14,38,52
16,8475753,Justin Faulk,D,STL,32,82,13,39,52
16,8475764,Cam Fowler,D,ANA,33,82,9,43,52
16,8481542,Moritz Seider,D,DET,23,82,8,44,52
16,8477444,Andre Burakovsky,L,SEA,29,82,30,21,51
16,8482149,Cole Perfetti,C,WPG,22,82,23,28,51
16,8479400,Pierre-Luc Dubois,L,WSH,26,82,18,33,51
16,8477986,Brandon Montour,D,SEA,30,82,18,33,51
16,8482684,Luke Hughes,D,NJD,21,82,11,40,51
16,8478519,Anthony Cirelli,C,TBL,27,82,25,25,50
16,8477503,Max Domi,C,TOR,29,82,13,37,50
16,8480798,Philipp Kurashev,C,CHI,25,82,11,39,50
16,8483808,Andrei Kuzmenko,L,CGY,28,82,27,22,49
16,8481711,Matias Maccelli,L,UTA,24,82,19,30,49
16,8481618,Alex Newhook,C,MTL,23,82,19,30,49
16,8480078,Filip Chytil,C,NYR,25,82,15,34,49
16,8478472,Mathieu Joseph,R,STL,27,82,15,34,49
16,8476854,Hampus Lindholm,D,BOS,30,82,12,37,49
16,8482109,Alexis Lafrenière,L,NYR,23,82,23,25,48
16,8482146,Luke Evangelista,R,NSH,22,82,22,26,48
16,8480185,Eetu Luostarinen,C,FLA,26,82,22,26,48
16,8475158,Ryan O'Reilly,C,NSH,33,82,20,28,48
16,8476925,Colton Sissons,C,NSH,31,82,18,30,48
16,8479410,Mikhail Sergachev,D,UTA,26,82,9,39,48
16,8476869,Brady Skjei,D,NSH,30,82,9,39,48
16,8476399,Blake Coleman,C,CGY,33,82,26,21,47
16,8480113,Alex Iafallo,L,WPG,31,82,24,23,47
16,8477998,Warren Foegele,L,LAK,28,82,21,26,47
16,8477476,Artturi Lehkonen,L,COL,29,82,20,27,47
16,8480829,Jesperi Kotkaniemi,C,CAR,24,82,20,27,47
16,8478233,Andrew Mangiapane,L,WSH,28,82,17,30,47
16,8482124,Quinton Byfield,R,LAK,22,82,16,31,47
16,8480849,Barrett Hayton,C,UTA,24,82,21,25,46
16,8478046,Danton Heinen,L,VAN,29,82,21,25,46
16,8474641,Adam Henrique,C,EDM,34,82,20,26,46
16,8477511,Anthony Mantha,R,CGY,30,82,18,28,46
16,8477407,Anthony Duclair,L,NYI,29,82,17,29,46
16,8481528,Dylan Cozens,C,BUF,23,82,13,33,46
16,8476923,Damon Severson,D,CBJ,30,82,11,35,46
16,8480064,Josh Norris,C,OTT,25,82,23,22,45
16,8471698,T.J. Oshie,R,WSH,38,82,21,24,45
16,8479992,Michael Rasmussen,C,DET,25,82,20,25,45
16,8473422,Nick Foligno,L,CHI,37,82,20,25,45
16,8481546,Cam York,D,PHI,23,82,15,30,45
16,8477498,Darnell Nurse,D,EDM,29,82,14,31,45
16,8477932,Aaron Ekblad,D,FLA,28,82,11,34,45
16,8476458,Ryan Strome,C,ANA,31,82,10,35,45
16,8480028,Morgan Frost,C,PHI,25,82,7,38,45
16,8474149,Evgenii Dadonov,R,DAL,35,82,23,21,44
16,8475191,Reilly Smith,R,NYR,33,82,20,24,44
16,8476882,Teuvo Teravainen,L,CHI,30,82,18,26,44
16,8476872,Scott Laughton,C,PHI,30,82,18,26,44
16,8482055,Drew O'Connor,L,PIT,26,82,18,26,44
16,8476292,Ondrej Palat,L,NJD,33,82,15,29,44
16,8482660,Kent Johnson,C,CBJ,22,82,15,29,44
16,8476792,Torey Krug,D,STL,33,82,13,31,44
16,8477969,Marcus Pettersson,D,PIT,28,82,13,31,44
16,8478407,Vince Dunn,D,SEA,28,82,12,32,44
16,8474565,Alex Pietrangelo,D,VGK,34,82,11,33,44
16,8476885,Jacob Trouba,D,NYR,30,82,11,33,44
16,8476958,Jaccob Slavin,D,CAR,30,82,10,34,44
16,8475169,Evander Kane,L,EDM,33,82,32,11,43
16,8481560,Arthur Kaliyev,R,LAK,23,82,23,20,43
16,8477952,Robby Fabbri,C,ANA,28,82,23,20,43
16,8477987,Ryan Donato,C,CHI,28,82,20,23,43
16,8477426,Nicholas Paul,L,TBL,29,82,19,24,43
16,8478462,Nicolas Roy,C,VGK,27,82,17,26,43
16,8476921,Jordan Martinook,L,CAR,32,82,14,29,43
16,8480220,Noah Cates,L,PHI,25,82,12,31,43
16,8475218,Mattias Ekholm,D,EDM,34,82,11,32,43
16,8482671,Owen Power,D,BUF,22,82,11,32,43
16,8479525,Ross Colton,C,COL,28,82,24,18,42
16,8476461,Sean Couturier,C,PHI,32,82,22,20,42
16,8481580,Connor McMichael,C,WSH,23,82,22,20,42
16,8477964,Ivan Barbashev,C,VGK,29,82,21,21,42
16,8481186,Logan O'Connor,R,COL,28,82,18,24,42
16,8475760,Nick Bjugstad,C,UTA,32,82,18,24,42
16,8479591,Michael Eyssimont,C,TBL,28,82,17,25,42
16,8481596,Shane Pinto,C,OTT,24,82,15,27,42
16,8476419,Jean-Gabriel Pageau,C,NYI,32,82,14,28,42
16,8476906,Shayne Gostisbehere,D,CAR,31,82,10,32,42
16,8482475,Yegor Chinakhov,R,CBJ,23,82,15,26,41
16,8478542,Evan Rodrigues,C,FLA,31,82,14,27,41
16,8476329,Travis Boyd,C,MIN,31,82,11,30,41
16,8481581,Thomas Harley,D,DAL,23,82,8,33,41
16,8470613,Brent Burns,D,CAR,39,82,8,33,41
16,8480145,Neal Pionk,D,WPG,29,82,7,34,41
16,8480873,Rasmus Sandin,D,WSH,24,82,3,38,41
16,8482079,Marco Rossi,C,MIN,23,82,25,15,40
16,8480835,Jack Drury,C,CAR,24,82,13,27,40
16,8478055,Gustav Forsling,D,FLA,28,82,12,28,40
16,8476892,Colton Parayko,D,STL,31,82,5,35,40
16,8480893,Kirill Marchenko,R,CBJ,24,82,25,14,39
16,8481554,Kaapo Kakko,R,NYR,23,82,25,14,39
16,8478569,Noel Acciari,C,PIT,33,82,22,17,39
16,8482699,Dylan Guenther,R,UTA,21,82,20,19,39
16,8480003,Jesper Boqvist,C,FLA,26,82,19,20,39
16,8476480,Vladislav Namestnikov,C,WPG,32,82,17,22,39
16,8476927,Teddy Blueger,C,VAN,30,82,16,23,39
16,8478911,Matt Roy,D,WSH,29,82,10,29,39
16,8475722,Jason Zucker,L,BUF,32,82,19,19,38
16,8480188,Fabian Zetterlund,L,SJS,25,82,19,19,38
16,8478057,Dakota Joshua,C,VAN,28,82,19,19,38
16,8479996,Cody Glass,C,NSH,25,82,18,20,38
16,8474053,Logan Couture,C,SJS,35,82,17,21,38
16,8474189,Lars Eller,C,PIT,35,82,17,21,38
16,8480009,Eeli Tolvanen,R,SEA,25,82,16,22,38
16,8477989,Christian Dvorak,C,MTL,28,82,15,23,38
16,8475763,Kevin Hayes,R,PIT,32,82,12,26,38
16,8475287,Erik Haula,L,NJD,33,82,10,28,38
16,8476392,Adam Lowry,C,WPG,31,82,10,28,38
16,8478882,Vladislav Gavrikov,D,LAK,29,82,7,31,38
16,8481535,Nils Hoglander,L,VAN,24,82,19,18,37
16,8480021,Jack Studnicka,C,LAK,25,82,19,18,37
16,8475768,Jaden Schwartz,C,SEA,32,82,16,21,37
16,8473563,Nicklas Backstrom,C,WSH,37,82,16,21,37
16,8482667,William Eklund,L,SJS,22,82,15,22,37
16,8475855,Jesper Fast,R,CAR,33,82,15,22,37
16,8474586,Jordan Eberle,R,SEA,34,82,14,23,37
16,8476960,Andreas Athanasiou,C,CHI,30,82,13,24,37
16,8477435,Ryan Graves,D,PIT,29,82,8,29,37
16,8470621,Corey Perry,R,EDM,39,82,20,16,36
16,8481032,Paul Cotter,C,NJD,25,82,18,18,36
16,8477953,Kasperi Kapanen,R,STL,28,82,17,19,36
16,8477947,Sonny Milano,L,WSH,28,82,16,20,36
16,8478469,Thomas Chabot,D,OTT,27,82,7,29,36
16,8482105,Jake Sanderson,D,OTT,22,82,7,29,36
16,8473507,Jeff Petry,D,DET,37,82,5,31,36
16,8478474,Lawson Crouse,L,UTA,27,82,17,18,35
16,8477425,Miles Wood,L,COL,29,82,17,18,35
16,8480459,Pius Suter,C,VAN,28,82,15,20,35
16,8480068,Ryan Poehling,C,PHI,25,82,13,22,35
16,8481656,Aliaksei Protas,C,WSH,23,82,8,27,35
16,8477015,Connor Brown,R,EDM,30,82,8,27,35
16,8479402,Jake Bean,D,CGY,26,82,6,29,35
16,8480073,Erik Brannstrom,D,COL,25,82,4,31,35
16,8476331,Dylan DeMelo,D,WPG,31,82,3,32,35
16,8479941,Justin Danforth,R,CBJ,31,82,20,14,34
16,8480074,Alexandre Texier,C,STL,25,82,18,16,34
16,8475314,Anders Lee,L,NYI,34,82,18,16,34
16,8480813,Joe Veleno,C,DET,24,82,15,19,34
16,8481553,Bobby Brink,R,PHI,23,82,13,21,34
16,8478115,Pierre Engvall,L,NYI,28,82,11,23,34
16,8475149,Marcus Johansson,L,MIN,34,82,11,23,34
16,8478133,Jake Evans,C,MTL,28,82,10,24,34
16,8481582,Nicholas Robertson,L,TOR,23,82,17,16,33
16,8475793,Ryan Johansen,C,PHI,32,82,16,17,33
16,8482705,Cole Sillinger,C,CBJ,21,82,16,17,33
16,8476469,Joel Armia,R,MTL,31,82,15,18,33
16,8480789,Oliver Wahlstrom,R,NYI,24,82,11,22,33
16,8477948,Travis Sanheim,D,PHI,28,82,10,23,33
16,8475171,Oliver Ekman-Larsson,D,TOR,33,82,8,25,33
16,8480855,Jack McBain,C,UTA,24,82,14,18,32
16,8475193,Tomas Tatar,L,NJD,34,82,14,18,32
16,8482720,Matthew Knies,L,TOR,22,82,12,20,32
16,8480748,Kiefer Sherwood,L,VAN,29,82,12,20,32
16,8480802,Ryan McLeod,C,BUF,25,82,12,20,32
16,8475848,Brendan Gallagher,R,MTL,32,82,11,21,32
16,8479293,Brandon Tanev,L,SEA,33,82,10,22,32
16,8477429,Andrew Copp,C,DET,30,82,9,23,32
16,8478891,Mason Appleton,C,WPG,28,82,9,23,32
16,8480878,Nils Lundkvist,D,DAL,24,82,7,25,32
16,8478500,Ivan Provorov,D,CBJ,27,82,6,26,32
16,8482122,Brock Faber,D,MIN,22,82,6,26,32
16,8480043,Timothy Liljegren,D,TOR,25,82,4,28,32
16,8481606,Jordan Spence,D,LAK,23,82,3,29,32
16,8483431,Logan Cooley,C,UTA,20,82,17,14,31
16,8480806,Isac Lundestrom,C,ANA,25,82,15,16,31
16,8479365,Trent Frederic,C,BOS,26,82,14,17,31
16,8475799,Nino Niederreiter,R,WPG,32,82,12,19,31
16,8483515,Juraj Slafkovsky,L,MTL,20,82,12,19,31
16,8479351,Sam Steel,C,DAL,26,82,12,19,31
16,8476422,Mike Reilly,D,NYI,31,82,11,20,31
16,8475181,Nick Leddy,D,STL,33,82,10,21,31
16,8477488,Brett Pesce,D,NJD,30,82,5,26,31
16,8480281,Alexey Toropchenko,R,STL,25,82,19,11,30
16,8481704,Juuso Parssinen,C,NSH,23,82,17,13,30
16,8481477,Nico Sturm,C,SJS,29,82,17,13,30
16,8479353,Brett Howden,C,VGK,26,82,16,14,30
16,8479390,Taylor Raddysh,R,WSH,26,82,15,15,30
16,8484166,Adam Fantilli,C,CBJ,20,82,14,16,30
16,8477508,Curtis Lazar,C,NJD,29,82,12,18,30
16,8475343,Nic Dowd,C,WSH,34,82,12,18,30
16,8479414,Nathan Bastian,R,NJD,27,82,11,19,30
16,8482111,Justin Barron,D,MTL,23,82,10,20,30
16,8476902,Esa Lindell,D,DAL,30,82,7,23,30
16,8476917,Adam Pelech,D,NYI,30,82,6,24,30
16,8482245,Artem Zub,D,OTT,29,82,5,25,30
16,8476897,Oskar Sundqvist,C,STL,30,82,15,14,29
16,8476873,Mark Jankowski,C,NSH,30,82,14,15,29
16,8476474,Stefan Noesen,R,NJD,31,82,13,16,29
16,8482092,Ridly Greig,C,OTT,22,82,11,18,29
16,8476442,Matt Nieto,L,PIT,32,82,11,18,29
16,8483457,Lane Hutson,D,MTL,20,82,9,20,29
16,8481522,Peyton Krebs,C,BUF,23,82,8,21,29
16,8478507,John Marino,D,UTA,27,82,6,23,29
16,8475200,Dmitry Orlov,D,CAR,33,82,5,24,29
16,8482655,J.J. Moser,D,TBL,24,82,4,25,29
16,8473533,Jordan Staal,C,CAR,36,82,22,6,28
16,8480025,MacKenzie Entwistle,R,FLA,25,82,18,10,28
16,8478508,Yakov Trenin,C,MIN,27,82,17,11,28
16,8476889,Radek Faksa,C,STL,30,82,14,14,28
16,8480980,Connor Dewar,C,TOR,25,82,13,15,28
16,8479368,Max Jones,L,BOS,26,82,11,17,28
16,8477392,Hudson Fasching,R,NYI,29,82,8,20,28
16,8476624,Barclay Goodrow,C,SJS,31,82,7,21,28
16,8477406,Mattias Janmark,C,EDM,32,82,7,21,28
16,8479398,Samuel Girard,D,COL,26,82,3,25,28
16,8480860,Kevin Bahl,D,CGY,24,82,2,26,28
16,8482089,Jake Neighbours,L,STL,22,82,18,9,27
16,8479316,Luke Kunin,C,SJS,27,82,17,10,27
16,8476278,Colin Blackwell,C,DAL,31,82,17,10,27
16,8474715,Cam Atkinson,R,TBL,35,82,15,12,27
16,8475714,Calle Jarnkrok,C,TOR,33,82,14,13,27
16,8475220,Marcus Foligno,L,MIN,33,82,14,13,27
16,8481481,Blake Lizotte,C,PIT,27,82,12,15,27
16,8479661,Tanner Jeannot,L,LAK,27,82,12,15,27
16,8475231,Casey Cizikas,C,NYI,33,82,11,16,27
16,8477919,Frederick Gaudreau,C,MIN,31,82,10,17,27
16,8477839,Conor Sheary,L,TBL,32,82,8,19,27
16,8475279,Ben Chiarot,D,DET,33,82,8,19,27
16,8476931,Jake McCabe,D,TOR,31,82,5,22,27
16,8479976,Juuso Valimaki,D,UTA,26,82,5,22,27
16,8476429,Scott Mayfield,D,NYI,32,82,4,23,27
16,8476879,Cody Ceci,D,EDM,31,82,3,24,27
16,8476981,Josh Anderson,R,MTL,30,82,18,8,26
16,8482259,Bobby McMann,C,TOR,28,82,17,9,26
16,8476858,Phillip Di Giuseppe,L,VAN,31,82,16,10,26
16,8481601,Simon Holmstrom,R,NYI,23,82,16,10,26
16,8480995,Pontus Holmberg,R,TOR,25,82,13,13,26
16,8478413,Jordan Greenway,L,BUF,27,82,10,16,26
16,8476463,Jonas Brodin,D,MIN,31,82,10,16,26
16,8479371,Dante Fabbro,D,NSH,26,82,7,19,26
16,8474574,Tyler Myers,D,VAN,34,82,7,19,26
16,8480817,K'Andre Miller,D,NYR,24,82,4,22,26
16,8478399,Jonas Siegenthaler,D,NJD,27,82,4,22,26
16,8470600,Ryan Suter,D,STL,39,82,4,22,26
16,8480049,Dylan Samberg,D,WPG,25,82,3,23,26
16,8474151,Ryan McDonagh,D,TBL,35,82,1,25,26
16,8478840,Will Borgen,D,SEA,28,82,1,25,26
16,8484145,Zach Benson,L,BUF,19,82,14,11,25
16,8482077,Dylan Holloway,L,EDM,23,82,14,11,25
16,8477450,Jason Dickinson,C,CHI,29,82,13,12,25
16,8478013,Jake Walman,D,SJS,28,82,12,13,25
16,8484153,Leo Carlsson,C,ANA,20,82,12,13,25
16,8479359,Beck Malenstyn,L,BUF,26,82,12,13,25
16,8476312,Josh Manson,D,COL,33,82,12,13,25
16,8481013,Jonatan Berggren,R,DET,24,82,11,14,25
16,8480144,David Kampf,C,TOR,29,82,11,14,25
16,8478020,Michael Amadio,C,OTT,28,82,10,15,25
16,8481517,Brett Leason,R,ANA,25,82,9,16,25
16,8478211,Dryden Hunt,L,CGY,29,82,8,17,25
16,8479983,Mario Ferraro,D,SJS,26,82,4,21,25
16,8475233,David Savard,D,MTL,34,82,3,22,25
16,8481178,Egor Zamula,D,PHI,24,82,2,23,25
16,8478434,Keegan Kolesar,R,VGK,27,82,11,13,24
16,8482117,Lukas Reichel,L,CHI,22,82,8,16,24
16,8482803,Olen Zellweger,D,ANA,21,82,7,17,24
16,8476374,Sean Kuraly,C,CBJ,31,82,6,18,24
16,8476979,Erik Gustafsson,D,DET,32,82,5,19,24
16,8476457,Adam Larsson,D,SEA,32,82,5,19,24
16,8477369,Carson Soucy,D,VAN,30,82,4,20,24
16,8477845,Trevor van Riemsdyk,D,WSH,33,82,4,20,24
16,8474673,TJ Brodie,D,CHI,34,82,4,20,24
16,8475188,Brayden McNabb,D,VGK,33,82,3,21,24
16,8479998,Mikey Anderson,D,LAK,25,82,3,21,24
16,8482073,Braden Schneider,D,NYR,23,82,0,24,24
16,8477353,Tyler Motte,C,DET,29,82,12,11,23
16,8481028,Martin Pospisil,C,CGY,25,82,10,13,23
16,8482166,Shakir Mukhamadullin,D,SJS,22,82,9,14,23
16,8478851,Alexandre Carrier,D,NSH,28,82,8,15,23
16,8482074,Connor Zary,C,CGY,23,82,8,15,23
16,8484149,Gavin Brindley,C,CBJ,20,82,8,15,23
16,8483490,Pavel Mintyukov,D,ANA,21,82,7,16,23
16,8478109,Victor Olofsson,L,VGK,29,82,6,17,23
16,8474090,Brendan Smith,D,DAL,35,82,6,17,23
16,8475462,Radko Gudas,D,ANA,34,82,4,19,23
16,8474716,Jared Spurgeon,D,MIN,35,82,3,20,23
16,8475690,Chris Tanev,D,TOR,35,82,3,20,23
16,8477220,Nate Schmidt,D,FLA,33,82,2,21,23
16,8481604,Pavel Dorofeyev,L,VGK,24,82,14,8,22
16,8475842,Sam Carrick,C,NYR,32,82,14,8,22
16,8476822,Luke Glendening,C,TBL,35,82,14,8,22
16,8482809,Jackson Blake,R,CAR,21,82,13,9,22
16,8479393,Noah Gregor,C,OTT,26,82,10,12,22
16,8482155,Alex Laferriere,R,LAK,23,82,10,12,22
16,8483468,Jiri Kulich,C,BUF,20,82,7,15,22
16,8483445,Cutter Gauthier,L,ANA,20,82,7,15,22
16,8480336,Sean Walker,D,CAR,30,82,5,17,22
16,8478178,Darren Raddysh,D,TBL,28,82,5,17,22
16,8480035,Henri Jokiharju,D,BUF,25,82,2,20,22
16,8476441,Joel Edmundson,D,LAK,31,82,2,20,22
16,8477903,Garnet Hathaway,R,PHI,33,82,12,9,21
16,8482062,Cole Smith,L,NSH,29,82,12,9,21
16,8482702,Logan Stankoven,C,DAL,21,82,11,10,21
16,8480834,Ty Emberson,D,SJS,24,82,9,12,21
16,8483493,Frank Nazar,C,CHI,20,82,8,13,21
16,8481641,Joel Kiviranta,L,COL,28,82,8,13,21
16,8484911,Collin Graf,R,SJS,22,82,7,14,21
16,8482624,Daniil Miromanov,D,CGY,27,82,6,15,21
16,8480222,Sebastian Aho,D,PIT,28,82,6,15,21
16,8475324,Nick Jensen,D,OTT,34,82,5,16,21
16,8480246,Nick Perbix,D,TBL,26,82,4,17,21
16,8479980,Nicolas Hague,D,VGK,26,82,2,19,21
16,8481014,Alexander Romanov,D,NYI,24,82,1,20,21
16,8476918,Jimmy Vesey,L,NYR,31,82,8,12,20
16,8476525,Colin Miller,D,WPG,32,82,8,12,20
16,8482133,Thomas Bordeleau,C,SJS,22,82,4,16,20
16,8483482,Tristan Luneau,D,ANA,20,82,4,16,20
16,8480796,Martin Fehervary,D,WSH,25,82,4,16,20
16,8481122,Simon Benoit,D,TOR,26,82,2,18,20
16,8478416,Erik Cernak,D,TBL,27,82,1,19,20
16,8480807,Mattias Samuelsson,D,BUF,24,82,1,19,20
16,8479291,Kevin Rooney,C,CGY,31,82,11,8,19
16,8477505,Alexander Wennberg,C,SJS,30,82,10,9,19
16,8481093,Rafael Harvey-Pinard,L,MTL,25,82,9,10,19
16,8479324,Ryan Lindgren,D,NYR,26,82,9,10,19
16,8478432,Christian Fischer,R,DET,27,82,8,11,19
16,8484203,Bradly Nadeau,L,CAR,19,82,6,13,19
16,8482666,Scott Morrow,D,CAR,22,82,5,14,19
16,8483565,Nick Blankenburg,D,NSH,26,82,5,14,19
16,8478443,Brandon Carlo,D,BOS,28,82,5,14,19
16,8482087,Kaiden Guhle,D,MTL,22,82,4,15,19
16,8476891,Matt Grzelcyk,D,PIT,30,82,2,17,19
16,8481568,Alex Vlasic,D,CHI,23,82,1,18,19
16,8473453,Trevor Lewis,C,LAK,37,82,9,9,18
16,8481708,Zac Jones,D,NYR,24,82,7,11,18
16,8483012,Logan Morrison,C,SEA,22,82,7,11,18
16,8482145,Mavrik Bourque,C,DAL,22,82,6,12,18
16,8482807,Ethan Del Mastro,D,CHI,21,82,5,13,18
16,8482125,Alexander Holtz,R,VGK,22,82,4,14,18
16,8482713,Mackie Samoskevich,R,FLA,22,82,4,14,18
16,8482142,Jamie Drysdale,D,PHI,22,82,2,16,18
16,8478136,Jake Middleton,D,MIN,28,82,2,16,18
16,8479576,Vincent Desharnais,D,VAN,28,82,2,16,18
16,8475455,Brenden Dillon,D,NJD,34,82,2,16,18
16,8482679,Matt Coronato,R,CGY,22,82,1,17,18
16,8475790,Erik Gudbranson,D,CBJ,32,82,0,18,18
16,8477506,Ryan Pulock,D,NYI,30,82,6,11,17
16,8483763,Maksymilian Szuber,D,UTA,22,82,6,11,17
16,8483524,Shane Wright,C,SEA,20,82,5,12,17
16,8482118,Sam Colangelo,R,ANA,23,82,5,12,17
16,8477034,Jaycob Megna,D,FLA,32,82,5,12,17
16,8480879,Jacob Bernard-Docker,D,OTT,24,82,5,12,17
16,8478859,Niko Mikkola,D,FLA,28,82,4,13,17
16,8482101,Danil Gushchin,L,SJS,22,82,4,13,17
16,8482762,Simon Edvinsson,D,DET,21,82,4,13,17
16,8476967,Brett Kulak,D,EDM,30,82,3,14,17
16,8481605,Jackson LaCombe,D,ANA,23,82,3,14,17
16,8483397,Marc McLaughlin,C,BOS,25,82,11,5,16
16,8480448,Parker Kelly,L,COL,25,82,9,7,16
16,8482141,Lukas Cormier,D,VGK,22,82,8,8,16
16,8477507,Nikita Zadorov,D,BOS,29,82,7,9,16
16,8480172,Jan Rutta,D,SJS,34,82,7,9,16
16,8477365,Connor Clifton,D,BUF,29,82,6,10,16
16,8476473,Connor Murphy,D,CHI,31,82,5,11,16
16,8482470,Ilya Solovyov,D,CGY,24,82,4,12,16
16,8477499,Rasmus Ristolainen,D,PHI,30,82,2,14,16
16,8482749,Joshua Roy,R,MTL,21,82,8,7,15
16,8483505,Matthew Poitras,C,BOS,20,82,4,11,15
16,8479369,Andrew Peeke,D,BOS,26,82,1,14,15
16,8476878,Zemgus Girgensons,L,TBL,30,82,9,5,14
16,8477931,Tomas Nosek,L,FLA,32,82,8,6,14
16,8483495,Simon Nemec,D,NJD,20,82,8,6,14
16,8483460,David Jiricek,D,CBJ,21,82,4,10,14
16,8482858,Ryker Evans,D,SEA,23,82,4,10,14
16,8482516,Matthew Kessel,D,STL,24,82,4,10,14
16,8475177,Calvin de Haan,D,COL,33,82,3,11,14
16,8477938,Haydn Fleury,D,WPG,28,82,2,12,14
16,8478450,Parker Wotherspoon,D,BOS,27,82,2,12,14
16,8478874,Adam Gaudette,C,OTT,28,82,0,14,14
16,8482659,Josh Doan,R,UTA,22,82,9,4,13
16,8479638,Justin Brazeau,R,BOS,26,82,7,6,13
16,8478468,Jeremy Lauzon,D,NSH,27,82,3,10,13
16,8474612,Travis Hamonic,D,OTT,34,82,3,10,13
16,8481567,Henry Thrun,D,SJS,23,82,2,11,13
16,8476372,Nick Seeler,D,PHI,31,82,2,11,13
16,8481524,Bowen Byram,D,BUF,23,82,9,3,12
16,8483466,Kevin Korchinski,D,CHI,20,82,5,7,12
16,8483499,Liam Ohgren,L,MIN,20,82,4,8,12
16,8482153,Brendan Brisson,C,VGK,23,82,3,9,12
16,8475762,Derek Forbort,D,VAN,32,82,3,9,12
16,8482733,Logan Mailloux,D,MTL,31,82,3,9,12
16,8477335,Kyle Burroughs,D,LAK,29,82,2,10,12
16,8475718,Justin Holl,D,DET,32,82,1,11,12
16,8471677,Jack Johnson,D,CBJ,37,82,1,11,12
16,8480990,Declan Chisholm,D,MIN,24,82,4,7,11
16,8480870,Bo Groulx,C,NYR,24,82,4,7,11
16,8483471,Brad Lambert,C,WPG,31,82,4,7,11
16,8483489,Fraser Minten,C,TOR,31,82,6,4,10
16,8479442,Troy Stecher,D,EDM,30,82,5,5,10
16,8482787,Nikita Chibrikov,R,WPG,31,82,4,6,10
16,8476467,Jamie Oleksiak,D,SEA,32,82,3,7,10
16,8474013,Ian Cole,D,UTA,35,82,2,8,10
16,8480950,Ilya Lyubushkin,D,DAL,30,82,2,8,10
16,8481699,Aku Raty,R,UTA,23,82,1,9,10
16,8483567,Georgii Merkulov,C,BOS,24,82,3,6,9
16,8482712,Oskar Olausson,R,COL,22,82,3,6,9
16,8482859,Zack Ostapchuk,C,OTT,21,82,1,8,9
16,8474567,Zach Bogosian,D,MIN,34,82,1,7,8
16,8474062,Riley Nash,C,NYR,35,82,1,5,6
16,8482070,Mitchell Chaffee,R,TBL,26,82,1,1,2
16,8470794,Joe Pavelski,C,,40,0,0,0,0
16,8481703,Valtteri Puustinen,R,PIT,25,0,0,0,0
16,8477950,Tony DeAngelo,D,,29,0,0,0,0
16,8481577,Philip Tomasino,C,NSH,23,0,0,0,0
16,8475197,Tyson Barrie,D,,33,0,0,0,0
16,8471218,Blake Wheeler,R,,38,0,0,0,0
16,8474157,Max Pacioretty,L,,36,0,0,0,0
16,8478466,Daniel Sprong,R,VAN,27,0,0,0,0
16,8475744,Evgeny Kuznetsov,C,,32,0,0,0,0
16,8481019,David Gustafsson,C,WPG,24,0,0,0,0
16,8475906,John Klingberg,D,,32,0,0,0,0
16,8479348,Kale Clague,D,BUF,26,0,0,0,0
16,8476952,Dominic Toninato,C,WPG,30,0,0,0,0
16,8473473,Milan Lucic,L,,36,0,0,0,0
16,8474037,James van Riemsdyk,L,,35,0,0,0,0
16,8474602,Justin Schultz,D,,34,0,0,0,0
16,8482222,Alexander Barabanov,L,,30,0,0,0,0
16,8479372,Josh Mahura,D,SEA,26,0,0,0,0
16,8479982,Conor Timmins,D,TOR,26,0,0,0,0
16,8474031,Kevin Shattenkirk,D,,35,0,0,0,0
16,8480008,Adam Ruzicka,C,,25,0,0,0,0
16,8481059,Scott Perunovich,D,STL,26,0,0,0,0
16,8480884,Calen Addison,D,,24,0,0,0,0
16,8476994,Vinnie Hinostroza,C,NSH,30,0,0,0,0
16,8478452,Caleb Jones,D,LAK,27,0,0,0,0
16,8480157,Calle Rosen,D,COL,30,0,0,0,0
16,8481609,Vladislav Kolyachonok,D,UTA,23,0,0,0,0
16,8479415,Michael McLeod,C,,26,0,0,0,0
16,8476919,Chris Tierney,C,,30,0,0,0,0
16,8479639,Dylan Coghlan,D,WPG,26,0,0,0,0
16,8478146,Matthew Highmore,C,OTT,28,0,0,0,0
16,8478970,Jalen Chatfield,D,CAR,28,0,0,0,0
16,8480205,Emil Bemstrom,C,PIT,25,0,0,0,0
16,8474884,Mike Hoffman,C,,35,0,0,0,0
16,8471274,Alex Goligoski,D,,39,0,0,0,0
16,8478104,Sammy Blais,L,,28,0,0,0,0
16,8474870,Tyler Johnson,C,,34,0,0,0,0
16,8476913,Devin Shore,C,MIN,30,0,0,0,0
16,8481598,Philip Broberg,D,EDM,23,0,0,0,0
16,8480058,Pierre-Olivier Joseph,D,STL,25,0,0,0,0
16,8480891,Michael Kesselring,D,UTA,24,0,0,0,0
16,8477979,Nicolas Aube-Kubel,R,BUF,28,0,0,0,0
16,8476871,Tanner Pearson,L,,32,0,0,0,0
16,8476393,Nick Cousins,C,,31,0,0,0,0
16,8479977,Kailer Yamamoto,R,,26,0,0,0,0
16,8479543,Michael Pezzetta,L,MTL,26,0,0,0,0
16,8477018,Ben Hutton,D,VGK,31,0,0,0,0
16,8480762,Eric Robinson,L,CAR,29,0,0,0,0
16,8474034,Pat Maroon,L,CHI,36,0,0,0,0
16,8481058,Jesse Ylönen,R,,25,0,0,0,0
16,8475179,Dmitry Kulikov,D,FLA,34,0,0,0,0
16,8481527,Kaedan Korczak,D,VGK,23,0,0,0,0
16,8473449,Kyle Okposo,R,,36,0,0,0,0
16,8482192,Isaak Phillips,D,CHI,23,0,0,0,0
16,8480727,Zach Whitecloud,D,VGK,28,0,0,0,0
16,8479346,Dillon Dube,C,,26,0,0,0,0
16,8480821,Filip Zadina,R,,25,0,0,0,0
16,8480001,Urho Vaakanainen,D,ANA,25,0,0,0,0
16,8470966,Mark Giordano,D,,41,0,0,0,0
16,8480853,Liam Foudy,C,,24,0,0,0,0
16,8475225,Craig Smith,C,CHI,35,0,0,0,0
16,8479972,Mason Shaw,C,WPG,26,0,0,0,0
16,8478451,Ethan Bear,D,WSH,27,0,0,0,0
16,8474040,Sam Gagner,C,,35,0,0,0,0
16,8480196,Jacob Bryson,D,BUF,27,0,0,0,0
16,8479984,Cal Foote,D,,26,0,0,0,0
16,8480011,Klim Kostin,C,SJS,25,0,0,0,0
16,8482176,Wyatt Kaiser,D,CHI,22,0,0,0,0
16,8476988,Matt Benning,D,SJS,30,0,0,0,0
16,8479370,Tyson Jost,C,CAR,26,0,0,0,0
16,8477464,Nic Petan,C,,29,0,0,0,0
16,8477380,Jonny Brodzinski,C,NYR,31,0,0,0,0
16,8480070,Ian Mitchell,D,BOS,25,0,0,0,0
16,8479315,Joey Anderson,R,CHI,26,0,0,0,0
16,8478099,Kevin Labanc,R,,29,0,0,0,0
16,8476874,Olli Maatta,D,DET,30,0,0,0,0
16,8475208,Brian Dumoulin,D,ANA,33,0,0,0,0
16,8478430,Oliver Kylington,D,,27,0,0,0,0
16,8479536,Axel Jonsson-Fjallby,L,WPG,26,0,0,0,0
16,8479671,Mathieu Olivier,R,CBJ,27,0,0,0,0
16,8471709,Marc-Edouard Vlasic,D,SJS,37,0,0,0,0
16,8479328,Julien Gauthier,R,NYI,27,0,0,0,0
16,8478421,A.J. Greer,L,FLA,28,0,0,0,0
16,8477573,Nathan Walker,L,STL,30,0,0,0,0
16,8481537,Nikita Okhotiuk,D,CGY,24,0,0,0,0
16,8474166,Alec Martinez,D,CHI,37,0,0,0,0
16,8470610,Zach Parise,L,,40,0,0,0,0
16,8477478,William Carrier,L,CAR,30,0,0,0,0
16,8479344,Jesse Puljujarvi,R,PIT,26,0,0,0,0
16,8480887,Jordan Harris,D,MTL,24,0,0,0,0
16,8478502,Dennis Gilbert,D,BUF,28,0,0,0,0
16,8482730,Brandt Clarke,D,LAK,21,0,0,0,0
16,8480355,Mark Kastelic,C,BOS,25,0,0,0,0
16,8475750,Jon Merrill,D,MIN,32,0,0,0,0
16,8475164,Jakob Silfverberg,R,,34,0,0,0,0
16,8477944,Jakub Vrana,L,,28,0,0,0,0
16,8479439,Jacob MacDonald,D,COL,31,0,0,0,0
16,8474568,Luke Schenn,D,NSH,35,0,0,0,0
16,8478454,Noah Juulsen,D,VAN,27,0,0,0,0
16,8475752,Tyler Pitlick,C,,33,0,0,0,0
16,8482148,Hendrix Lapierre,C,WSH,22,0,0,0,0
16,8481167,Brayden Pachal,D,CGY,25,0,0,0,0
16,8478043,Sam Lafferty,C,BUF,29,0,0,0,0
16,8479321,Lucas Johansen,D,,27,0,0,0,0
16,8471699,Andrew Cogliano,C,,37,0,0,0,0
16,8481521,Ronnie Attard,D,PHI,25,0,0,0,0
16,8481161,Jake Christiansen,D,CBJ,25,0,0,0,0
16,8479458,Nikita Zaitsev,D,,33,0,0,0,0
16,8479619,Michael Carcone,L,UTA,28,0,0,0,0
16,8479026,Philippe Myers,D,TOR,27,0,0,0,0
16,8477330,Dominik Kubalik,L,,29,0,0,0,0
16,8481617,Vasily Podkolzin,R,VAN,23,0,0,0,0
16,8481701,Santeri Hatakka,D,NJD,23,0,0,0,0
16,8479514,Rem Pitlick,C,,27,0,0,0,0
16,8477446,Michael McCarron,R,NSH,29,0,0,0,0
16,8470604,Jeff Carter,C,,39,0,0,0,0
16,8482241,Radim Zohorna,L,,28,0,0,0,0
16,8480289,Morgan Barron,C,WPG,26,0,0,0,0
16,8479379,Givani Smith,R,SJS,26,0,0,0,0
16,8480216,Jacob Peterson,C,,25,0,0,0,0
16,8477851,Jordan Oesterle,D,BOS,32,0,0,0,0
16,8484258,Sam Malinski,D,COL,26,0,0,0,0
16,8478904,Steven Lorentz,C,,28,0,0,0,0
16,8482095,Tyler Kleven,D,OTT,22,0,0,0,0
16,8480848,Ty Dellandrea,C,SJS,24,0,0,0,0
16,8476884,Derrick Pouliot,D,,30,0,0,0,0
16,8479336,Carl Grundstrom,R,SJS,27,0,0,0,0
16,8482964,Arber Xhekaj,D,MTL,23,0,0,0,0
16,8471686,Marc Staal,D,,37,0,0,0,0
16,8477887,Patrick Brown,C,BOS,32,0,0,0,0
16,8478495,Denis Gurianov,R,,27,0,0,0,0
16,8473504,Cal Clutterbuck,R,,37,0,0,0,0
16,8481550,Adam Beckman,L,NJD,23,0,0,0,0
16,8480845,Rasmus Kupari,C,WPG,24,0,0,0,0
16,8474009,Nick Bonino,C,,36,0,0,0,0
16,8478585,Derek Ryan,C,EDM,38,0,0,0,0
16,8477962,Brendan Lemieux,L,CAR,28,0,0,0,0
16,8482861,Vincent Iorio,D,WSH,22,0,0,0,0
16,8479378,Logan Stanley,D,WPG,26,0,0,0,0
16,8473446,Erik Johnson,D,PHI,36,0,0,0,0
16,8481743,Marc Del Gaizo,D,NSH,25,0,0,0,0
16,8477384,Josh Brown,D,EDM,30,0,0,0,0
16,8482165,Yan Kuznetsov,D,CGY,22,0,0,0,0
16,8478424,Jansen Harkins,C,ANA,27,0,0,0,0
16,8482144,Jack Thompson,D,SJS,22,0,0,0,0
16,8478512,Austin Czarnik,C,,32,0,0,0,0
16,8477527,Ross Johnston,L,ANA,30,0,0,0,0
16,8479383,Boris Katchouk,L,,26,0,0,0,0
16,8482094,Daemon Hunt,D,MIN,22,0,0,0,0
16,8481719,Maxwell Crozier,D,TBL,24,0,0,0,0
16,8480192,Johnathan Kovacevic,D,NJD,27,0,0,0,0
16,8479376,Victor Mete,D,,26,0,0,0,0
16,8482511,Mason Lohrei,D,BOS,23,0,0,0,0
16,8475825,Jani Hakanpää,D,,32,0,0,0,0
16,8478021,William Lagesson,D,DET,28,0,0,0,0
16,8475795,Dylan McIlrath,D,WSH,32,0,0,0,0
16,8477846,Ryan Carpenter,C,,33,0,0,0,0
16,8481056,Spencer Stastney,D,NSH,24,0,0,0,0
16,8481564,Ryan Johnson,D,BUF,23,0,0,0,0
16,8478017,Mark Friedman,D,VAN,29,0,0,0,0
16,8479320,Max Lajoie,D,SEA,27,0,0,0,0
16,8480075,Cameron Crotty,D,MIN,25,0,0,0,0
16,8484287,Cole McWard,D,VAN,23,0,0,0,0
16,8484254,Akito Hirose,D,VAN,25,0,0,0,0
16,8483407,Brandon Scanlin,D,NYR,25,0,0,0,0
16,8480274,Philip Kemp,D,EDM,25,0,0,0,0
16,8479522,Hardy Haman Aktell,D,WSH,26,0,0,0,0
16,8480007,Jonas Rondbjerg,R,VGK,25,0,0,0,0
16,8477454,Adam Erne,L,,29,0,0,0,0
16,8481679,Maxence Guenette,D,OTT,23,0,0,0,0
16,8480441,Trey Fix-Wolansky,R,CBJ,25,0,0,0,0
16,8483546,Marshall Rifai,D,TOR,26,0,0,0,0
16,8480084,Nick DeSimone,D,NJD,30,0,0,0,0
16,8481030,Jack St. Ivany,D,PIT,25,0,0,0,0
16,8481592,Jakob Pelletier,L,CGY,23,0,0,0,0
16,8478011,Louie Belpedio,D,PHI,28,0,0,0,0
16,8477930,Pierre-Edouard Bellemare,L,,39,0,0,0,0
16,8484321,Nikolas Matinpalo,D,OTT,26,0,0,0,0
16,8482067,Connor Mackey,D,NYR,28,0,0,0,0
16,8481806,Louis Crevier,D,CHI,23,0,0,0,0
16,8484326,Patrik Koch,D,UTA,28,0,0,0,0
16,8477971,Andreas Englund,D,LAK,28,0,0,0,0
16,8481751,Lukas Rousek,R,BUF,25,0,0,0,0
16,8481006,Tyler Tucker,D,STL,24,0,0,0,0
16,8476867,Brendan Gaunce,C,MIN,30,0,0,0,0
16,8479520,Brandon Duhaime,R,WSH,27,0,0,0,0
16,8477073,Kurtis MacDermid,L,NJD,30,0,0,0,0
16,8480874,Adam Ginning,D,PHI,24,0,0,0,0
16,8477473,Justin Bailey,R,SJS,29,0,0,0,0
16,8479066,Ryan Lomberg,L,CGY,30,0,0,0,0
16,8477070,Liam O'Brien,C,UTA,30,0,0,0,0
16,8474618,Marco Scandella,D,,34,0,0,0,0
16,8475797,Jarred Tinordi,D,,32,0,0,0,0
16,8481441,Joe Snively,C,DET,28,0,0,0,0
16,8477244,Chad Ruhwedel,D,NYR,34,0,0,0,0
16,8479772,Zack MacEwen,R,OTT,28,0,0,0,0
16,8481147,Reese Johnson,C,MIN,26,0,0,0,0
16,8481043,Cole Koepke,L,BOS,26,0,0,0,0
16,8483619,Filip Roos,D,OTT,25,0,0,0,0
16,8481541,Samuel Bolduc,D,NYI,24,0,0,0,0
16,8477810,Joel Hanley,D,CGY,33,0,0,0,0
16,8476907,Mackenzie MacEachern,L,,30,0,0,0,0
16,8482652,Walker Duehr,R,CGY,27,0,0,0,0
16,8477126,Jayson Megna,C,,34,0,0,0,0
16,8483398,Declan Carlile,D,TBL,31,0,0,0,0
16,8482929,Emil Lilleberg,D,TBL,23,0,0,0,0
16,8480880,Jakub Lauko,C,MIN,24,0,0,0,0
16,8480245,Olle Lycksell,R,PHI,25,0,0,0,0
16,8480252,Cole Guttman,C,CHI,25,0,0,0,0
16,8477467,Gustav Olofsson,D,SEA,30,0,0,0,0
16,8479968,Vinni Lettieri,C,BOS,29,0,0,0,0
16,8478400,Colin White,C,,27,0,0,0,0
16,8475755,Alexander Petrovic,D,DAL,32,0,0,0,0
16,8481812,Nikolai Knyzhov,D,,27,0,0,0,0
16,8481593,Jayden Struble,D,MTL,23,0,0,0,0
16,8481532,Alex Turcotte,C,LAK,23,0,0,0,0
16,8482126,Emil Andrae,D,PHI,31,0,0,0,0
16,8479944,Zach Aston-Reese,C,VGK,30,0,0,0,0
16,8471817,Ryan Reaves,R,TOR,37,0,0,0,0
16,8481206,John Ludvig,D,PIT,24,0,0,0,0
16,8481599,Victor Soderstrom,D,UTA,23,0,0,0,0
16,8480292,Carson Meyer,R,ANA,27,0,0,0,0
16,8482496,Nils Aman,C,VAN,24,0,0,0,0
16,8479718,Alex Barré-Boulet,C,MTL,27,0,0,0,0
16,8479994,Jaret Anderson-Dolan,C,WPG,25,0,0,0,0
16,8480184,Gustav Lindstrom,D,,26,0,0,0,0
16,8480890,Jan Jenik,R,OTT,24,0,0,0,0
16,8478067,Oskar Lindblom,L,,28,0,0,0,0
16,8476934,Brock McGinn,L,ANA,30,0,0,0,0
16,8479985,Cale Fleury,D,SEA,26,0,0,0,0
16,8484304,Uvis Balinskis,D,FLA,28,0,0,0,0
16,8479981,Jonah Gadjovich,L,FLA,26,0,0,0,0
16,8481716,Dmitri Voronkov,L,CBJ,24,0,0,0,0
16,8474709,Matt Martin,L,,35,0,0,0,0
16,8482634,Alex Steeves,C,TOR,25,0,0,0,0
16,8480823,Alexander Alexeyev,D,WSH,25,0,0,0,0
16,8477541,Dakota Mermis,D,TOR,30,0,0,0,0
16,8483491,Ivan Miroshnichenko,L,WSH,20,0,0,0,0
16,8478477,Mitchell Stephens,C,SEA,27,0,0,0,0
16,8481543,Nikita Alexandrov,C,STL,24,0,0,0,0
16,8479423,Alex Nylander,L,,26,0,0,0,0
16,8482451,Mikael Pyyhtia,L,CBJ,23,0,0,0,0
16,8478831,Kevin Stenlund,C,UTA,28,0,0,0,0
16,8480306,Grant Hutton,D,NYI,29,0,0,0,0
16,8478028,Fredrik Olofsson,L,,28,0,0,0,0
16,8477462,Robert Hagg,D,VGK,29,0,0,0,0
16,8477320,Anton Blidh,L,NYR,29,0,0,0,0
16,8482157,Will Cuylle,L,NYR,22,0,0,0,0
16,8482737,Zack Bolduc,C,STL,21,0,0,0,0
16,8481239,Samuel Fagemo,L,,24,0,0,0,0
16,8481600,Tobias Bjornfot,D,FLA,23,0,0,0,0
16,8478409,Anthony Richard,C,PHI,28,0,0,0,0
16,8474145,Robert Bortuzzo,D,,35,0,0,0,0
16,8475958,Michael Sgarbossa,C,WSH,32,0,0,0,0
16,8479986,Kole Lind,R,DAL,26,0,0,0,0
16,8479249,Andrew Poturalski,C,SJS,30,0,0,0,0
16,8479362,Riley Tufte,L,BOS,26,0,0,0,0
16,8479991,Jake Leschyshyn,C,NYR,25,0,0,0,0
16,8479587,Rhett Gardner,C,PHI,28,0,0,0,0
16,8482744,James Malatesta,L,CBJ,21,0,0,0,0
16,8478854,Ryan Shea,D,PIT,27,0,0,0,0
16,8481591,Sam Poulin,R,,23,0,0,0,0
16,8483512,Matt Savoie,C,EDM,20,0,0,0,0
16,8482102,Vasily Ponomarev,C,PIT,22,0,0,0,0
16,8482162,Roby Jarventie,L,EDM,22,0,0,0,0
16,8481016,Ruslan Iskhakov,C,,24,0,0,0,0
16,8482172,Landon Slaggert,L,CHI,22,0,0,0,0
16,8482747,Brennan Othmann,L,NYR,21,0,0,0,0
16,8480031,Maxime Comtois,L,,25,0,0,0,0
16,8480226,Marián Studenic,R,,26,0,0,0,0
16,8478408,Travis Dermott,D,,28,0,0,0,0
16,8481518,Nolan Foote,L,NJD,24,0,0,0,0
16,8479419,Brett Murray,L,BUF,26,0,0,0,0
16,8482088,Justin Sourdif,R,FLA,22,0,0,0,0
16,8482201,Gage Goncalves,C,TBL,23,0,0,0,0
16,8481578,Graeme Clarke,R,MIN,23,0,0,0,0
16,8482177,Marat Khusnutdinov,C,MIN,22,0,0,0,0
16,8481754,Nikita Nesterenko,C,ANA,23,0,0,0,0
16,8483531,Brian Halonen,L,NJD,25,0,0,0,0
16,8483920,Pierrick Dube,R,WSH,23,0,0,0,0
16,8480851,Akil Thomas,C,LAK,24,0,0,0,0
16,8475235,Nicolas Deslauriers,L,PHI,33,0,0,0,0
16,8482476,Emil Heineman,L,MTL,23,0,0,0,0
16,8477149,Scott Sabourin,R,SJS,32,0,0,0,0
16,8483549,Lucas Condotta,L,MTL,27,0,0,0,0
16,8482765,Isak Rosen,R,BUF,21,0,0,0,0
16,8481237,Kyle MacLean,C,NYI,25,0,0,0,0
16,8481024,Linus Karlsson,C,VAN,25,0,0,0,0
16,8481690,Tyler Angle,C,,24,0,0,0,0
16,8483570,Ben Meyers,C,SEA,26,0,0,0,0
16,8481655,Cole Schwindt,R,CGY,23,0,0,0,0
16,8481462,Mason Morelli,L,VGK,28,0,0,0,0
16,8483401,Marc Johnstone,R,PIT,28,0,0,0,0
16,8478956,Samuel Laberge,L,NJD,27,0,0,0,0
16,8479533,Joona Koppanen,L,,26,0,0,0,0
16,8482197,Adam Raska,R,MIN,23,0,0,0,0
16,8482250,Callahan Burke,C,VGK,27,0,0,0,0
16,8482784,Zach Dean,C,STL,21,0,0,0,0
16,8484255,Jason Polin,R,COL,25,0,0,0,0
16,8481077,John Leonard,L,,26,0,0,0,0
16,8481534,Raphael Lavoie,C,EDM,24,0,0,0,0
16,8483609,Adam Klapka,R,CGY,24,0,0,0,0
16,8482751,Ryan Winterton,C,SEA,21,0,0,0,0
16,8480267,Sammy Walker,C,MIN,25,0,0,0,0
16,8475766,Austin Watson,L,,32,0,0,0,0
16,8482460,Matt Rempe,C,NYR,22,0,0,0,0
16,8481065,Angus Crookshank,L,OTT,25,0,0,0,0
16,8481070,Hugh McGing,L,,26,0,0,0,0
16,8476323,Max McCormick,L,SEA,32,0,0,0,0
16,8483395,Arshdeep Bains,L,VAN,23,0,0,0,0
16,8484259,Ondrej Pavel,C,COL,31,0,0,0,0
16,8483432,Luca Del Bel Belluz,C,CBJ,31,0,0,0,0
16,8483045,Cameron Butler,R,CBJ,31,0,0,0,0
16,8482061,Brandon Biro,L,SEA,26,0,0,0,0
16,8477401,John Hayden,C,SEA,29,0,0,0,0
16,8475278,Byron Froese,C,,33,0,0,0,0
16,8478446,Glenn Gawdin,C,LAK,27,0,0,0,0
16,8477993,Justin Kirkland,C,CGY,28,0,0,0,0
16,8482147,Jean-Luc Foudy,C,COL,22,0,0,0,0
16,8480032,Shane Bowers,C,NJD,25,0,0,0,0
16,8479330,Brandon Gignac,C,MTL,27,0,0,0,0
16,8480776,Sheldon Rempal,R,,29,0,0,0,0
16,8475413,Justin Dowling,C,NJD,34,0,0,0,0
16,8481726,Adam Edstrom,C,NYR,24,0,0,0,0
16,8480844,Grigori Denisenko,L,VGK,24,0,0,0,0
16,8478147,Bokondji Imama,L,PIT,28,0,0,0,0
16,8478881,Brett Seney,L,CHI,28,0,0,0,0
16,8483630,Pavol Regenda,L,ANA,25,0,0,0,0
16,8480836,Jonathan Gruden,C,,24,0,0,0,0
16,8484314,Jiri Smejkal,L,,28,0,0,0,0
16,8475780,Chris Wagner,R,COL,33,0,0,0,0
16,8479546,Oskar Steen,C,,26,0,0,0,0
16,8483597,Milos Kelemen,L,UTA,25,0,0,0,0
16,8481789,Tye Kartye,L,SEA,23,0,0,0,0
16,8484325,Waltteri Merela,C,TBL,26,0,0,0,0
16,8479421,Jacob Moverare,D,LAK,26,0,0,0,0
16,8481585,Egor Afanasyev,L,SJS,23,0,0,0,0
16,8479547,Matthew Phillips,R,,26,0,0,0,0
16,8479367,William Lockwood,R,FLA,26,0,0,0,0
16,8476915,Jujhar Khaira,L,,30,0,0,0,0
16,8481422,Jacob Lucchini,C,NSH,29,0,0,0,0
16,8480468,James Hamblin,L,EDM,25,0,0,0,0
16,8478051,Max Willman,C,NJD,29,0,0,0,0
16,8481556,John Beecher,C,BOS,23,0,0,0,0
16,8478078,Rourke Chartier,C,,28,0,0,0,0
17,8476453,Nikita Kucherov,R,TBL,31,82,47,99,146
17,8478402,Connor McDavid,C,EDM,27,82,42,103,145
17,8477492,Nathan MacKinnon,C,COL,29,82,47,91,138
17,8471675,Sidney Crosby,C,PIT,37,82,56,76,132
17,8479318,Auston Matthews,C,TOR,27,82,69,53,122
17,8478864,Kirill Kaprizov,L,MIN,27,82,55,65,120
17,8479314,Matthew Tkachuk,L,FLA,27,82,40,78,118
17,8477493,Aleksander Barkov,C,FLA,29,82,34,84,118
17,8477942,Kevin Fiala,L,LAK,28,82,42,74,116
17,8477939,William Nylander,R,TOR,28,82,56,59,115
17,8478420,Mikko Rantanen,R,COL,28,82,45,69,114
17,8481559,Jack Hughes,C,NJD,23,82,50,62,112
17,8477934,Leon Draisaitl,C,EDM,29,82,37,67,104
17,8476887,Filip Forsberg,L,NSH,30,82,39,64,103
17,8478550,Artemi Panarin,L,NYR,33,82,29,72,101
17,8477956,David Pastrnak,R,BOS,28,82,49,51,100
17,8477933,Sam Reinhart,C,FLA,29,82,44,56,100
17,8480023,Robert Thomas,C,STL,25,82,29,71,100
17,8478398,Kyle Connor,L,WPG,28,82,48,49,97
17,8482116,Tim Stützle,C,OTT,22,82,33,63,96
17,8478445,Mathew Barzal,C,NYI,27,82,29,66,95
17,8475166,John Tavares,C,TOR,34,82,43,51,94
17,8480801,Brady Tkachuk,L,OTT,25,82,35,59,94
17,8477404,Jake Guentzel,C,TBL,30,82,30,61,91
17,8480012,Elias Pettersson,C,VAN,26,82,34,56,90
17,8480069,Cale Makar,D,COL,26,82,26,64,90
17,8476468,J.T. Miller,C,VAN,31,82,25,64,89
17,8477949,Alex Tuch,R,BUF,28,82,25,64,89
17,8478439,Travis Konecny,R,PHI,27,82,34,53,87
17,8480830,Andrei Svechnikov,R,CAR,24,82,32,55,87
17,8476454,Ryan Nugent-Hopkins,C,EDM,31,82,25,61,86
17,8476539,Jonathan Marchessault,R,NSH,34,82,48,37,85
17,8479420,Tage Thompson,C,BUF,27,82,43,42,85
17,8480027,Jason Robertson,L,DAL,25,82,38,47,85
17,8479385,Jordan Kyrou,C,STL,26,82,37,48,85
17,8480800,Quinn Hughes,D,VAN,25,82,21,64,85
17,8478010,Brayden Point,C,TBL,28,82,43,41,84
17,8478427,Sebastian Aho,C,CAR,27,82,37,46,83
17,8477409,Carter Verhaeghe,C,FLA,29,82,39,43,82
17,8480018,Nick Suzuki,C,MTL,25,82,32,50,82
17,8471685,Anze Kopitar,C,LAK,37,82,30,51,81
17,8476459,Mika Zibanejad,C,NYR,31,82,38,42,80
17,8479343,Clayton Keller,R,UTA,26,82,31,49,80
17,8479337,Alex DeBrincat,R,DET,27,82,30,50,80
17,8481523,Kirby Dach,C,MTL,23,82,15,65,80
17,8475810,Bryan Rust,R,PIT,32,82,43,36,79
17,8476460,Mark Scheifele,C,WPG,31,82,36,43,79
17,8471214,Alex Ovechkin,L,WSH,39,82,36,43,79
17,8475913,Mark Stone,R,VGK,32,82,30,49,79
17,8471215,Evgeni Malkin,C,PIT,38,82,29,50,79
17,8477504,Josh Morrissey,D,WPG,29,82,17,62,79
17,8477501,Valeri Nichushkin,R,COL,29,82,42,36,78
17,8478449,Roope Hintz,C,DAL,28,82,41,37,78
17,8477402,Pavel Buchnevich,L,STL,29,82,31,47,78
17,8477955,Jared McCann,L,SEA,28,82,36,41,77
17,8478460,Zach Werenski,D,CBJ,27,82,22,55,77
17,8477960,Adrian Kempe,R,LAK,28,82,34,42,76
17,8481557,Matt Boldy,L,MIN,23,82,27,49,76
17,8475784,Jeff Skinner,C,EDM,32,82,35,40,75
17,8475692,Mats Zuccarello,R,MIN,37,82,19,56,75
17,8477946,Dylan Larkin,C,DET,28,82,38,36,74
17,8477500,Bo Horvat,C,NYI,29,82,37,37,74
17,8480208,Drake Batherson,R,OTT,26,82,30,44,74
17,8477935,Sam Bennett,C,FLA,28,82,38,35,73
17,8475158,Ryan O'Reilly,C,NSH,33,82,34,39,73
17,8475172,Nazem Kadri,C,CGY,34,82,30,43,73
17,8479407,Jesper Bratt,L,NJD,26,82,26,47,73
17,8482665,Matty Beniers,C,SEA,22,82,23,50,73
17,8476456,Jonathan Huberdeau,C,CGY,31,82,18,55,73
17,8476853,Morgan Rielly,D,TOR,30,82,8,65,73
17,8475786,Zach Hyman,L,EDM,32,82,34,38,72
17,8477496,Elias Lindholm,C,BOS,30,82,27,45,72
17,8475765,Vladimir Tarasenko,R,DET,33,82,26,46,72
17,8480839,Rasmus Dahlin,D,BUF,24,82,24,48,72
17,8473512,Claude Giroux,R,OTT,36,82,21,51,72
17,8482093,Seth Jarvis,C,CAR,22,82,28,43,71
17,8476389,Vincent Trocheck,C,NYR,31,82,27,44,71
17,8477951,Nick Schmaltz,C,UTA,28,82,23,48,71
17,8478403,Jack Eichel,C,VGK,28,82,35,35,70
17,8473419,Brad Marchand,L,BOS,36,82,27,43,70
17,8480865,Noah Dobson,D,NYI,24,82,16,54,70
17,8474600,Roman Josi,D,NSH,34,82,14,56,70
17,8475184,Chris Kreider,L,NYR,33,82,35,34,69
17,8480036,Miro Heiskanen,D,DAL,25,82,18,51,69
17,8474141,Patrick Kane,R,DET,36,82,30,38,68
17,8480002,Nico Hischier,C,NJD,25,82,29,38,67
17,8482113,Anton Lundell,C,FLA,23,82,21,46,67
17,8479323,Adam Fox,D,NYR,26,82,11,56,67
17,8481540,Cole Caufield,R,MTL,23,82,36,30,66
17,8476432,Boone Jenner,C,CBJ,31,82,36,30,66
17,8475798,Mikael Granlund,C,SJS,32,82,20,46,66
17,8474564,Steven Stamkos,C,NSH,34,82,26,39,65
17,8478414,Timo Meier,R,NJD,28,82,24,41,65
17,8477940,Nikolaj Ehlers,L,WPG,28,82,23,42,65
17,8476346,Johnny Gaudreau,L,CBJ,31,82,15,50,65
17,8481596,Shane Pinto,C,OTT,24,82,28,36,64
17,8478856,Conor Garland,R,VAN,28,82,27,37,64
17,8478493,Joel Eriksson Ek,C,MIN,27,82,27,37,64
17,8478440,Dylan Strome,C,WSH,27,82,24,40,64
17,8474586,Jordan Eberle,R,SEA,34,82,22,42,64
17,8480803,Evan Bouchard,D,EDM,25,82,15,49,64
17,8471724,Kris Letang,D,PIT,37,82,14,50,64
17,8479339,Patrik Laine,L,CBJ,26,82,32,31,63
17,8479675,Trevor Moore,L,LAK,29,82,25,38,63
17,8482124,Quinton Byfield,R,LAK,22,82,22,40,62
17,8478462,Nicolas Roy,C,VGK,27,82,20,42,62
17,8475167,Victor Hedman,D,TBL,34,82,18,44,62
17,8474578,Erik Karlsson,D,PIT,34,82,14,48,62
17,8478042,Viktor Arvidsson,R,EDM,31,82,31,30,61
17,8480064,Josh Norris,C,OTT,25,82,30,31,61
17,8474563,Drew Doughty,D,LAK,35,82,13,48,61
17,8481068,Yegor Sharangovich,C,CGY,26,82,35,25,60
17,8478444,Brock Boeser,R,VAN,27,82,25,35,60
17,8481533,Trevor Zegras,C,ANA,23,82,24,36,60
17,8482699,Dylan Guenther,R,UTA,21,82,24,36,60
17,8475763,Kevin Hayes,R,PIT,32,82,23,37,60
17,8478975,Mason Marchment,L,DAL,29,82,20,40,60
17,8473986,Alex Killorn,L,ANA,35,82,18,42,60
17,8474679,Gustav Nyquist,C,NSH,35,82,14,46,60
17,8477451,Ryan Hartman,R,MIN,30,82,30,29,59
17,8478873,Troy Terry,R,ANA,27,82,25,34,59
17,8477407,Anthony Duclair,L,NYI,29,82,23,36,59
17,8475168,Matt Duchene,C,DAL,33,82,21,38,59
17,8478038,Devon Toews,D,COL,30,82,14,45,59
17,8474590,John Carlson,D,WSH,34,82,12,47,59
17,8482109,Alexis Lafrenière,L,NYR,23,82,34,24,58
17,8475170,Brayden Schenn,C,STL,33,82,27,31,58
17,8477497,Sean Monahan,C,CBJ,30,82,26,32,58
17,8477511,Anthony Mantha,R,CGY,30,82,23,35,58
17,8474102,David Perron,L,OTT,36,82,22,36,58
17,8475754,Brock Nelson,C,NYI,33,82,28,29,57
17,8480078,Filip Chytil,C,NYR,25,82,25,32,57
17,8473994,Jamie Benn,L,DAL,35,82,22,35,57
17,8476462,Dougie Hamilton,D,NJD,31,82,20,37,57
17,8477948,Travis Sanheim,D,PHI,28,82,19,38,57
17,8476875,Mike Matheson,D,MTL,30,82,16,41,57
17,8476792,Torey Krug,D,STL,33,82,15,42,57
17,8477503,Max Domi,C,TOR,29,82,13,44,57
17,8476483,Rickard Rakell,R,PIT,31,82,28,28,56
17,8479542,Brandon Hagel,L,TBL,26,82,25,31,56
17,8481528,Dylan Cozens,C,BUF,23,82,25,31,56
17,8480459,Pius Suter,C,VAN,28,82,24,32,56
17,8478472,Mathieu Joseph,R,STL,27,82,22,34,56
17,8482667,William Eklund,L,SJS,22,82,21,35,56
17,8479999,Casey Mittelstadt,C,COL,26,82,18,38,56
17,8478047,Michael Bunting,L,PIT,29,82,17,38,55
17,8474150,Mikael Backlund,C,CGY,35,82,16,39,55
17,8477346,MacKenzie Weegar,D,CGY,30,82,13,42,55
17,8479425,Filip Hronek,D,VAN,27,82,12,43,55
17,8482078,Lucas Raymond,L,DET,22,82,23,31,54
17,8477416,Oliver Bjorkstrand,R,SEA,29,82,22,32,54
17,8476880,Tom Wilson,R,WSH,30,82,20,34,54
17,8476882,Teuvo Teravainen,L,CHI,30,82,14,40,54
17,8479410,Mikhail Sergachev,D,UTA,26,82,12,42,54
17,8478366,Frank Vatrano,R,ANA,30,82,34,19,53
17,8480014,Gabriel Vilardi,C,WPG,25,82,32,21,53
17,8482475,Yegor Chinakhov,R,CBJ,23,82,28,25,53
17,8480039,Martin Necas,C,CAR,25,82,27,26,53
17,8475794,Tyler Seguin,C,DAL,32,82,23,30,53
17,8478438,Tommy Novak,C,NSH,27,82,20,33,53
17,8477021,Alex Kerfoot,C,UTA,30,82,18,35,53
17,8478542,Evan Rodrigues,C,FLA,31,82,18,35,53
17,8476438,Brandon Saad,L,STL,32,82,27,25,52
17,8475287,Erik Haula,L,NJD,33,82,23,29,52
17,8474565,Alex Pietrangelo,D,VGK,34,82,9,43,52
17,8479525,Ross Colton,C,COL,28,82,28,23,51
17,8475714,Calle Jarnkrok,C,TOR,33,82,28,23,51
17,8481711,Matias Maccelli,L,UTA,24,82,19,32,51
17,8477476,Artturi Lehkonen,L,COL,29,82,16,35,51
17,8478396,Noah Hanifin,D,VGK,27,82,15,36,51
17,8482684,Luke Hughes,D,NJD,21,82,6,45,51
17,8476881,Tomas Hertl,C,VGK,31,82,29,21,50
17,8477932,Aaron Ekblad,D,FLA,28,82,23,27,50
17,8476448,William Karlsson,C,VGK,31,82,20,30,50
17,8477494,Jonathan Drouin,L,COL,29,82,18,32,50
17,8480798,Philipp Kurashev,C,CHI,25,82,17,33,50
17,8476872,Scott Laughton,C,PHI,30,82,16,34,50
17,8476885,Jacob Trouba,D,NYR,30,82,13,37,50
17,8474641,Adam Henrique,C,EDM,34,82,23,26,49
17,8482149,Cole Perfetti,C,WPG,22,82,20,29,49
17,8478046,Danton Heinen,L,VAN,29,82,20,29,49
17,8482705,Cole Sillinger,C,CBJ,21,82,18,31,49
17,8478055,Gustav Forsling,D,FLA,28,82,17,32,49
17,8478397,Rasmus Andersson,D,CGY,28,82,16,33,49
17,8476419,Jean-Gabriel Pageau,C,NYI,32,82,14,35,49
17,8478407,Vince Dunn,D,SEA,28,82,10,39,49
17,8478498,Jake DeBrusk,L,VAN,28,82,26,22,48
17,8480015,Owen Tippett,R,PHI,25,82,25,23,48
17,8477456,J.T. Compher,L,DET,29,82,22,26,48
17,8480829,Jesperi Kotkaniemi,C,CAR,24,82,17,31,48
17,8479400,Pierre-Luc Dubois,L,WSH,26,82,16,32,48
17,8475745,Charlie Coyle,C,BOS,32,82,15,33,48
17,8470613,Brent Burns,D,CAR,39,82,14,34,48
17,8476906,Shayne Gostisbehere,D,CAR,31,82,10,38,48
17,8476399,Blake Coleman,C,CGY,33,82,35,12,47
17,8482110,Dawson Mercer,C,NJD,23,82,24,23,47
17,8480849,Barrett Hayton,C,UTA,24,82,23,24,47
17,8482740,Wyatt Johnston,C,DAL,21,82,22,25,47
17,8479987,Morgan Geekie,C,BOS,26,82,21,26,47
17,8477479,Tyler Bertuzzi,L,CHI,29,82,20,27,47
17,8478469,Thomas Chabot,D,OTT,27,82,14,33,47
17,8479325,Charlie McAvoy,D,BOS,27,82,11,36,47
17,8475218,Mattias Ekholm,D,EDM,34,82,10,37,47
17,8481560,Arthur Kaliyev,R,LAK,23,82,28,18,46
17,8475314,Anders Lee,L,NYI,34,82,28,18,46
17,8475791,Taylor Hall,L,CHI,33,82,21,25,46
17,8480009,Eeli Tolvanen,R,SEA,25,82,19,27,46
17,8481546,Cam York,D,PHI,23,82,17,29,46
17,8479345,Jakob Chychrun,D,WSH,26,82,13,33,46
17,8480434,Sean Durzi,D,UTA,26,82,11,35,46
17,8477447,Shea Theodore,D,VGK,29,82,9,37,46
17,8477495,Seth Jones,D,CHI,30,82,7,39,46
17,8476923,Damon Severson,D,CBJ,30,82,7,39,46
17,8476958,Jaccob Slavin,D,CAR,30,82,2,44,46
17,8475799,Nino Niederreiter,R,WPG,32,82,29,16,45
17,8479365,Trent Frederic,C,BOS,26,82,26,19,45
17,8475169,Evander Kane,L,EDM,33,82,24,21,45
17,8478057,Dakota Joshua,C,VAN,28,82,23,22,45
17,8477444,Andre Burakovsky,L,SEA,29,82,22,23,45
17,8478474,Lawson Crouse,L,UTA,27,82,22,23,45
17,8473533,Jordan Staal,C,CAR,36,82,19,26,45
17,8480748,Kiefer Sherwood,L,VAN,29,82,18,27,45
17,8476479,Phillip Danault,C,LAK,31,82,17,28,45
17,8476905,Chandler Stephenson,C,SEA,30,82,14,31,45
17,8476869,Brady Skjei,D,NSH,30,82,8,37,45
17,8480873,Rasmus Sandin,D,WSH,24,82,4,41,45
17,8475151,Kyle Palmieri,C,NYI,33,82,28,16,44
17,8478233,Andrew Mangiapane,L,WSH,28,82,21,23,44
17,8482097,Jack Quinn,R,BUF,23,82,15,29,44
17,8480188,Fabian Zetterlund,L,SJS,25,82,14,30,44
17,8480336,Sean Walker,D,CAR,30,82,13,31,44
17,8480817,K'Andre Miller,D,NYR,24,82,8,36,44
17,8475793,Ryan Johansen,C,PHI,32,82,22,21,43
17,8475726,Tyler Toffoli,C,SJS,32,82,21,22,43
17,8476960,Andreas Athanasiou,C,CHI,30,82,18,25,43
17,8478115,Pierre Engvall,L,NYI,28,82,15,28,43
17,8480185,Eetu Luostarinen,C,FLA,26,82,13,30,43
17,8480145,Neal Pionk,D,WPG,29,82,8,35,43
17,8482175,JJ Peterka,R,BUF,22,82,25,17,42
17,8481186,Logan O'Connor,R,COL,28,82,21,21,42
17,8481618,Alex Newhook,C,MTL,23,82,20,22,42
17,8481704,Juuso Parssinen,C,NSH,23,82,20,22,42
17,8480855,Jack McBain,C,UTA,24,82,18,24,42
17,8480028,Morgan Frost,C,PHI,25,82,15,27,42
17,8477953,Kasperi Kapanen,R,STL,28,82,13,29,42
17,8475753,Justin Faulk,D,STL,32,82,9,33,42
17,8475149,Marcus Johansson,L,MIN,34,82,9,33,42
17,8481604,Pavel Dorofeyev,L,VGK,24,82,24,17,41
17,8483808,Andrei Kuzmenko,L,CGY,28,82,21,20,41
17,8475768,Jaden Schwartz,C,SEA,32,82,21,20,41
17,8477987,Ryan Donato,C,CHI,28,82,20,21,41
17,8482159,Tyson Foerster,R,PHI,22,82,19,22,41
17,8482142,Jamie Drysdale,D,PHI,22,82,9,32,41
17,8476921,Jordan Martinook,L,CAR,32,82,20,20,40
17,8477986,Brandon Montour,D,SEA,30,82,18,22,40
17,8479293,Brandon Tanev,L,SEA,33,82,17,23,40
17,8480220,Noah Cates,L,PHI,25,82,16,24,40
17,8476392,Adam Lowry,C,WPG,31,82,14,26,40
17,8478401,Pavel Zacha,C,BOS,27,82,12,28,40
17,8477429,Andrew Copp,C,DET,30,82,12,28,40
17,8482660,Kent Johnson,C,CBJ,22,82,11,29,40
17,8475200,Dmitry Orlov,D,CAR,33,82,9,31,40
17,8482089,Jake Neighbours,L,STL,22,82,28,11,39
17,8476474,Stefan Noesen,R,NJD,31,82,19,20,39
17,8484144,Connor Bedard,C,CHI,19,82,18,21,39
17,8482055,Drew O'Connor,L,PIT,26,82,17,22,39
17,8477964,Ivan Barbashev,C,VGK,29,82,17,22,39
17,8480802,Ryan McLeod,C,BUF,25,82,17,22,39
17,8476889,Radek Faksa,C,STL,30,82,16,23,39
17,8478519,Anthony Cirelli,C,TBL,27,82,15,24,39
17,8481542,Moritz Seider,D,DET,23,82,7,32,39
17,8473422,Nick Foligno,L,CHI,37,82,22,16,38
17,8482146,Luke Evangelista,R,NSH,22,82,17,21,38
17,8483515,Juraj Slafkovsky,L,MTL,20,82,17,21,38
17,8482745,Mason McTavish,C,ANA,21,82,15,23,38
17,8477998,Warren Foegele,L,LAK,28,82,15,23,38
17,8476854,Hampus Lindholm,D,BOS,30,82,13,25,38
17,8481581,Thomas Harley,D,DAL,23,82,13,25,38
17,8473563,Nicklas Backstrom,C,WSH,37,82,13,25,38
17,8482117,Lukas Reichel,L,CHI,22,82,13,25,38
17,8481656,Aliaksei Protas,C,WSH,23,82,11,27,38
17,8475171,Oliver Ekman-Larsson,D,TOR,33,82,11,27,38
17,8476292,Ondrej Palat,L,NJD,33,82,9,29,38
17,8482671,Owen Power,D,BUF,22,82,9,29,38
17,8478133,Jake Evans,C,MTL,28,82,6,32,38
17,8480043,Timothy Liljegren,D,TOR,25,82,5,33,38
17,8478463,Anthony Beauvillier,L,PIT,27,82,26,11,37
17,8481535,Nils Hoglander,L,VAN,24,82,23,14,37
17,8471698,T.J. Oshie,R,WSH,38,82,22,15,37
17,8481580,Connor McMichael,C,WSH,23,82,22,15,37
17,8478508,Yakov Trenin,C,MIN,27,82,20,17,37
17,8479941,Justin Danforth,R,CBJ,31,82,18,19,37
17,8475722,Jason Zucker,L,BUF,32,82,15,22,37
17,8480789,Oliver Wahlstrom,R,NYI,24,82,15,22,37
17,8474053,Logan Couture,C,SJS,35,82,14,23,37
17,8476897,Oskar Sundqvist,C,STL,30,82,12,25,37
17,8479996,Cody Glass,C,NSH,25,82,24,12,36
17,8475231,Casey Cizikas,C,NYI,33,82,19,17,36
17,8479390,Taylor Raddysh,R,WSH,26,82,17,19,36
17,8480797,Joel Farabee,L,PHI,24,82,15,21,36
17,8482092,Ridly Greig,C,OTT,22,82,15,21,36
17,8478013,Jake Walman,D,SJS,28,82,15,21,36
17,8476925,Colton Sissons,C,NSH,31,82,13,23,36
17,8478413,Jordan Greenway,L,BUF,27,82,12,24,36
17,8475191,Reilly Smith,R,NYR,33,82,10,26,36
17,8480871,Adam Boqvist,D,FLA,24,82,8,28,36
17,8476918,Jimmy Vesey,L,NYR,31,82,21,14,35
17,8474189,Lars Eller,C,PIT,35,82,17,18,35
17,8481554,Kaapo Kakko,R,NYR,23,82,16,19,35
17,8476927,Teddy Blueger,C,VAN,30,82,14,21,35
17,8476826,Yanni Gourde,C,SEA,33,82,12,23,35
17,8481553,Bobby Brink,R,PHI,23,82,12,23,35
17,8476461,Sean Couturier,C,PHI,32,82,11,24,35
17,8478911,Matt Roy,D,WSH,29,82,8,27,35
17,8480893,Kirill Marchenko,R,CBJ,24,82,21,13,34
17,8477426,Nicholas Paul,L,TBL,29,82,20,14,34
17,8481624,Ilya Mikheyev,R,CHI,30,82,18,16,34
17,8475760,Nick Bjugstad,C,UTA,32,82,16,18,34
17,8477919,Frederick Gaudreau,C,MIN,31,82,14,20,34
17,8474149,Evgenii Dadonov,R,DAL,35,82,13,21,34
17,8476463,Jonas Brodin,D,MIN,31,82,7,27,34
17,8476891,Matt Grzelcyk,D,PIT,30,82,6,28,34
17,8477952,Robby Fabbri,C,ANA,28,82,20,13,33
17,8479992,Michael Rasmussen,C,DET,25,82,18,15,33
17,8482079,Marco Rossi,C,MIN,23,82,17,16,33
17,8476873,Mark Jankowski,C,NSH,30,82,16,17,33
17,8476480,Vladislav Namestnikov,C,WPG,32,82,12,21,33
17,8476458,Ryan Strome,C,ANA,31,82,9,24,33
17,8476457,Adam Larsson,D,SEA,32,82,8,25,33
17,8476981,Josh Anderson,R,MTL,30,82,21,11,32
17,8481601,Simon Holmstrom,R,NYI,23,82,18,14,32
17,8477947,Sonny Milano,L,WSH,28,82,17,15,32
17,8480813,Joe Veleno,C,DET,24,82,14,18,32
17,8480144,David Kampf,C,TOR,29,82,13,19,32
17,8484153,Leo Carlsson,C,ANA,20,82,11,21,32
17,8478458,Jack Roslovic,C,CAR,27,82,10,22,32
17,8478500,Ivan Provorov,D,CBJ,27,82,6,26,32
17,8482655,J.J. Moser,D,TBL,24,82,6,26,32
17,8475764,Cam Fowler,D,ANA,33,82,4,28,32
17,8476331,Dylan DeMelo,D,WPG,31,82,3,29,32
17,8476931,Jake McCabe,D,TOR,31,82,1,31,32
17,8470621,Corey Perry,R,EDM,39,82,20,11,31
17,8481032,Paul Cotter,C,NJD,25,82,19,12,31
17,8480021,Jack Studnicka,C,LAK,25,82,16,15,31
17,8477839,Conor Sheary,L,TBL,32,82,15,16,31
17,8478109,Victor Olofsson,L,VGK,29,82,14,17,31
17,8480113,Alex Iafallo,L,WPG,31,82,13,18,31
17,8481517,Brett Leason,R,ANA,25,82,11,20,31
17,8479398,Samuel Girard,D,COL,26,82,6,25,31
17,8476979,Erik Gustafsson,D,DET,32,82,6,25,31
17,8480073,Erik Brannstrom,D,COL,25,82,2,29,31
17,8478020,Michael Amadio,C,OTT,28,82,18,12,30
17,8483457,Lane Hutson,D,MTL,20,82,15,15,30
17,8475855,Jesper Fast,R,CAR,33,82,12,18,30
17,8477450,Jason Dickinson,C,CHI,29,82,12,18,30
17,8477220,Nate Schmidt,D,FLA,33,82,9,21,30
17,8481178,Egor Zamula,D,PHI,24,82,4,26,30
17,8477506,Ryan Pulock,D,NYI,30,82,4,26,30
17,8478882,Vladislav Gavrikov,D,LAK,29,82,3,27,30
17,8477969,Marcus Pettersson,D,PIT,28,82,1,29,30
17,8477392,Hudson Fasching,R,NYI,29,82,18,11,29
17,8479393,Noah Gregor,C,OTT,26,82,18,11,29
17,8476469,Joel Armia,R,MTL,31,82,16,13,29
17,8481477,Nico Sturm,C,SJS,29,82,14,15,29
17,8482659,Josh Doan,R,UTA,22,82,13,16,29
17,8480003,Jesper Boqvist,C,FLA,26,82,11,18,29
17,8481606,Jordan Spence,D,LAK,23,82,10,19,29
17,8481013,Jonatan Berggren,R,DET,24,82,8,21,29
17,8474716,Jared Spurgeon,D,MIN,35,82,7,22,29
17,8481568,Alex Vlasic,D,CHI,23,82,5,24,29
17,8479976,Juuso Valimaki,D,UTA,26,82,4,25,29
17,8477365,Connor Clifton,D,BUF,29,82,4,25,29
17,8479402,Jake Bean,D,CGY,26,82,3,26,29
17,8476879,Cody Ceci,D,EDM,31,82,3,26,29
17,8482807,Ethan Del Mastro,D,CHI,21,82,16,12,28
17,8479316,Luke Kunin,C,SJS,27,82,14,14,28
17,8479661,Tanner Jeannot,L,LAK,27,82,14,14,28
17,8482720,Matthew Knies,L,TOR,22,82,12,16,28
17,8482624,Daniil Miromanov,D,CGY,27,82,12,16,28
17,8483763,Maksymilian Szuber,D,UTA,22,82,12,16,28
17,8482105,Jake Sanderson,D,OTT,22,82,11,17,28
17,8481093,Rafael Harvey-Pinard,L,MTL,25,82,11,17,28
17,8480074,Alexandre Texier,C,STL,25,82,10,18,28
17,8476329,Travis Boyd,C,MIN,31,82,9,19,28
17,8476442,Matt Nieto,L,PIT,32,82,9,19,28
17,8481481,Blake Lizotte,C,PIT,27,82,9,19,28
17,8477498,Darnell Nurse,D,EDM,29,82,8,20,28
17,8477989,Christian Dvorak,C,MTL,28,82,8,20,28
17,8479351,Sam Steel,C,DAL,26,82,8,20,28
17,8483482,Tristan Luneau,D,ANA,20,82,7,21,28
17,8473507,Jeff Petry,D,DET,37,82,4,24,28
17,8475233,David Savard,D,MTL,34,82,4,24,28
17,8474673,TJ Brodie,D,CHI,34,82,2,26,28
17,8480835,Jack Drury,C,CAR,24,82,15,12,27
17,8475343,Nic Dowd,C,WSH,34,82,13,14,27
17,8484203,Bradly Nadeau,L,CAR,19,82,13,14,27
17,8478434,Keegan Kolesar,R,VGK,27,82,11,16,27
17,8481582,Nicholas Robertson,L,TOR,23,82,10,17,27
17,8482803,Olen Zellweger,D,ANA,21,82,10,17,27
17,8482087,Kaiden Guhle,D,MTL,22,82,9,18,27
17,8476892,Colton Parayko,D,STL,31,82,3,24,27
17,8476429,Scott Mayfield,D,NYI,32,82,3,24,27
17,8474574,Tyler Myers,D,VAN,34,82,2,25,27
17,8481014,Alexander Romanov,D,NYI,24,82,2,25,27
17,8482259,Bobby McMann,C,TOR,28,82,15,11,26
17,8474715,Cam Atkinson,R,TBL,35,82,14,12,26
17,8480025,MacKenzie Entwistle,R,FLA,25,82,13,13,26
17,8479368,Max Jones,L,BOS,26,82,12,14,26
17,8482122,Brock Faber,D,MIN,22,82,10,16,26
17,8480806,Isac Lundestrom,C,ANA,25,82,10,16,26
17,8478891,Mason Appleton,C,WPG,28,82,9,17,26
17,8477015,Connor Brown,R,EDM,30,82,8,18,26
17,8477353,Tyler Motte,C,DET,29,82,7,19,26
17,8476902,Esa Lindell,D,DAL,30,82,1,25,26
17,8483431,Logan Cooley,C,UTA,20,82,14,11,25
17,8477425,Miles Wood,L,COL,29,82,13,12,25
17,8481522,Peyton Krebs,C,BUF,23,82,10,15,25
17,8476878,Zemgus Girgensons,L,TBL,30,82,10,15,25
17,8475220,Marcus Foligno,L,MIN,33,82,9,16,25
17,8480068,Ryan Poehling,C,PHI,25,82,6,19,25
17,8482111,Justin Barron,D,MTL,23,82,6,19,25
17,8470600,Ryan Suter,D,STL,39,82,6,19,25
17,8482073,Braden Schneider,D,NYR,23,82,6,19,25
17,8478851,Alexandre Carrier,D,NSH,28,82,5,20,25
17,8482666,Scott Morrow,D,CAR,22,82,15,9,24
17,8479591,Michael Eyssimont,C,TBL,28,82,14,10,24
17,8479359,Beck Malenstyn,L,BUF,26,82,11,13,24
17,8477507,Nikita Zadorov,D,BOS,29,82,4,20,24
17,8476525,Colin Miller,D,WPG,32,82,1,23,24
17,8476374,Sean Kuraly,C,CBJ,31,82,12,11,23
17,8482809,Jackson Blake,R,CAR,21,82,12,11,23
17,8480870,Bo Groulx,C,NYR,24,82,11,12,23
17,8483490,Pavel Mintyukov,D,ANA,21,82,8,15,23
17,8475848,Brendan Gallagher,R,MTL,32,82,7,16,23
17,8475462,Radko Gudas,D,ANA,34,82,6,17,23
17,8479983,Mario Ferraro,D,SJS,26,82,4,19,23
17,8476917,Adam Pelech,D,NYI,30,82,3,20,23
17,8474151,Ryan McDonagh,D,TBL,35,82,3,20,23
17,8475188,Brayden McNabb,D,VGK,33,82,2,21,23
17,8478840,Will Borgen,D,SEA,28,82,1,22,23
17,8480049,Dylan Samberg,D,WPG,25,82,0,23,23
17,8484145,Zach Benson,L,BUF,19,82,13,9,22
17,8481028,Martin Pospisil,C,CGY,25,82,10,12,22
17,8482733,Logan Mailloux,D,MTL,31,82,10,12,22
17,8476312,Josh Manson,D,COL,33,82,9,13,22
17,8482062,Cole Smith,L,NSH,29,82,9,13,22
17,8480796,Martin Fehervary,D,WSH,25,82,9,13,22
17,8477488,Brett Pesce,D,NJD,30,82,8,14,22
17,8483445,Cutter Gauthier,L,ANA,20,82,8,14,22
17,8475193,Tomas Tatar,L,NJD,34,82,7,15,22
17,8480980,Connor Dewar,C,TOR,25,82,7,15,22
17,8476624,Barclay Goodrow,C,SJS,31,82,7,15,22
17,8480990,Declan Chisholm,D,MIN,24,82,7,15,22
17,8482133,Thomas Bordeleau,C,SJS,22,82,5,17,22
17,8478507,John Marino,D,UTA,27,82,2,20,22
17,8475181,Nick Leddy,D,STL,33,82,0,22,22
17,8480281,Alexey Toropchenko,R,STL,25,82,14,7,21
17,8475842,Sam Carrick,C,NYR,32,82,12,9,21
17,8478432,Christian Fischer,R,DET,27,82,12,9,21
17,8483397,Marc McLaughlin,C,BOS,25,82,12,9,21
17,8478569,Noel Acciari,C,PIT,33,82,11,10,21
17,8479353,Brett Howden,C,VGK,26,82,11,10,21
17,8480995,Pontus Holmberg,R,TOR,25,82,10,11,21
17,8482074,Connor Zary,C,CGY,23,82,9,12,21
17,8482516,Matthew Kessel,D,STL,24,82,9,12,21
17,8482679,Matt Coronato,R,CGY,22,82,7,14,21
17,8483505,Matthew Poitras,C,BOS,20,82,7,14,21
17,8480878,Nils Lundkvist,D,DAL,24,82,6,15,21
17,8480172,Jan Rutta,D,SJS,34,82,6,15,21
17,8477499,Rasmus Ristolainen,D,PHI,30,82,6,15,21
17,8476467,Jamie Oleksiak,D,SEA,32,82,6,15,21
17,8474013,Ian Cole,D,UTA,35,82,6,15,21
17,8479980,Nicolas Hague,D,VGK,26,82,4,17,21
17,8476422,Mike Reilly,D,NYI,31,82,3,18,21
17,8475324,Nick Jensen,D,OTT,34,82,3,18,21
17,8479324,Ryan Lindgren,D,NYR,26,82,3,18,21
17,8478136,Jake Middleton,D,MIN,28,82,3,18,21
17,8482245,Artem Zub,D,OTT,29,82,2,19,21
17,8479371,Dante Fabbro,D,NSH,26,82,2,19,21
17,8479998,Mikey Anderson,D,LAK,25,82,2,19,21
17,8483495,Simon Nemec,D,NJD,20,82,2,19,21
17,8482166,Shakir Mukhamadullin,D,SJS,22,82,13,7,20
17,8476278,Colin Blackwell,C,DAL,31,82,11,9,20
17,8483524,Shane Wright,C,SEA,20,82,11,9,20
17,8479414,Nathan Bastian,R,NJD,27,82,10,10,20
17,8477406,Mattias Janmark,C,EDM,32,82,9,11,20
17,8483493,Frank Nazar,C,CHI,20,82,9,11,20
17,8477931,Tomas Nosek,L,FLA,32,82,9,11,20
17,8475279,Ben Chiarot,D,DET,33,82,5,15,20
17,8478178,Darren Raddysh,D,TBL,28,82,4,16,20
17,8480246,Nick Perbix,D,TBL,26,82,3,17,20
17,8479442,Troy Stecher,D,EDM,30,82,3,17,20
17,8480860,Kevin Bahl,D,CGY,24,82,1,19,20
17,8477903,Garnet Hathaway,R,PHI,33,82,14,5,19
17,8482762,Simon Edvinsson,D,DET,21,82,13,6,19
17,8484911,Collin Graf,R,SJS,22,82,12,7,19
17,8484166,Adam Fantilli,C,CBJ,20,82,11,8,19
17,8482125,Alexander Holtz,R,VGK,22,82,9,10,19
17,8477938,Haydn Fleury,D,WPG,28,82,9,10,19
17,8473453,Trevor Lewis,C,LAK,37,82,7,12,19
17,8478859,Niko Mikkola,D,FLA,28,82,7,12,19
17,8477369,Carson Soucy,D,VAN,30,82,6,13,19
17,8477505,Alexander Wennberg,C,SJS,30,82,6,13,19
17,8479291,Kevin Rooney,C,CGY,31,82,5,14,19
17,8475455,Brenden Dillon,D,NJD,34,82,3,16,19
17,8480879,Jacob Bernard-Docker,D,OTT,24,82,3,16,19
17,8482858,Ryker Evans,D,SEA,23,82,2,17,19
17,8480448,Parker Kelly,L,COL,25,82,8,10,18
17,8481699,Aku Raty,R,UTA,23,82,7,11,18
17,8481524,Bowen Byram,D,BUF,23,82,6,12,18
17,8478399,Jonas Siegenthaler,D,NJD,27,82,4,14,18
17,8475177,Calvin de Haan,D,COL,33,82,4,14,18
17,8480807,Mattias Samuelsson,D,BUF,24,82,2,16,18
17,8475690,Chris Tanev,D,TOR,35,82,1,17,18
17,8476967,Brett Kulak,D,EDM,30,82,1,17,18
17,8479369,Andrew Peeke,D,BOS,26,82,1,17,18
17,8477508,Curtis Lazar,C,NJD,29,82,7,10,17
17,8478211,Dryden Hunt,L,CGY,29,82,7,10,17
17,8482141,Lukas Cormier,D,VGK,22,82,7,10,17
17,8476441,Joel Edmundson,D,LAK,31,82,6,11,17
17,8483499,Liam Ohgren,L,MIN,20,82,6,11,17
17,8482702,Logan Stankoven,C,DAL,21,82,5,12,17
17,8483468,Jiri Kulich,C,BUF,20,82,4,13,17
17,8477845,Trevor van Riemsdyk,D,WSH,33,82,3,14,17
17,8478443,Brandon Carlo,D,BOS,28,82,3,14,17
17,8483460,David Jiricek,D,CBJ,21,82,3,14,17
17,8480035,Henri Jokiharju,D,BUF,25,82,2,15,17
17,8480222,Sebastian Aho,D,PIT,28,82,2,15,17
17,8477435,Ryan Graves,D,PIT,29,82,1,16,17
17,8482077,Dylan Holloway,L,EDM,23,82,14,2,16
17,8482155,Alex Laferriere,R,LAK,23,82,12,4,16
17,8476858,Phillip Di Giuseppe,L,VAN,31,82,10,6,16
17,8482749,Joshua Roy,R,MTL,21,82,5,11,16
17,8478450,Parker Wotherspoon,D,BOS,27,82,5,11,16
17,8481708,Zac Jones,D,NYR,24,82,3,13,16
17,8481605,Jackson LaCombe,D,ANA,23,82,3,13,16
17,8481567,Henry Thrun,D,SJS,23,82,3,13,16
17,8476473,Connor Murphy,D,CHI,31,82,2,14,16
17,8474612,Travis Hamonic,D,OTT,34,82,2,14,16
17,8475790,Erik Gudbranson,D,CBJ,32,82,1,15,16
17,8475762,Derek Forbort,D,VAN,32,82,4,11,15
17,8478416,Erik Cernak,D,TBL,27,82,3,12,15
17,8482153,Brendan Brisson,C,VGK,23,82,1,14,15
17,8475718,Justin Holl,D,DET,32,82,1,14,15
17,8474567,Zach Bogosian,D,MIN,34,82,6,8,14
17,8483489,Fraser Minten,C,TOR,31,82,5,9,14
17,8483565,Nick Blankenburg,D,NSH,26,82,1,13,14
17,8483012,Logan Morrison,C,SEA,22,82,5,8,13
17,8483471,Brad Lambert,C,WPG,31,82,5,8,13
17,8471677,Jack Johnson,D,CBJ,37,82,4,9,13
17,8482712,Oskar Olausson,R,COL,22,82,4,9,13
17,8476372,Nick Seeler,D,PHI,31,82,2,11,13
17,8480950,Ilya Lyubushkin,D,DAL,30,82,1,12,13
17,8484149,Gavin Brindley,C,CBJ,20,82,7,5,12
17,8482713,Mackie Samoskevich,R,FLA,22,82,7,5,12
17,8482118,Sam Colangelo,R,ANA,23,82,7,5,12
17,8482145,Mavrik Bourque,C,DAL,22,82,6,6,12
17,8478468,Jeremy Lauzon,D,NSH,27,82,4,8,12
17,8477335,Kyle Burroughs,D,LAK,29,82,2,10,12
17,8481641,Joel Kiviranta,L,COL,28,82,9,2,11
17,8483567,Georgii Merkulov,C,BOS,24,82,6,5,11
17,8482470,Ilya Solovyov,D,CGY,24,82,4,7,11
17,8481122,Simon Benoit,D,TOR,26,82,0,11,11
17,8477034,Jaycob Megna,D,FLA,32,82,0,11,11
17,8478874,Adam Gaudette,C,OTT,28,82,0,11,11
17,8476822,Luke Glendening,C,TBL,35,82,5,5,10
17,8482101,Danil Gushchin,L,SJS,22,82,2,8,10
17,8479638,Justin Brazeau,R,BOS,26,82,4,5,9
17,8482859,Zack Ostapchuk,C,OTT,21,82,4,5,9
17,8474090,Brendan Smith,D,DAL,35,82,2,7,9
17,8480834,Ty Emberson,D,SJS,24,82,2,7,9
17,8483466,Kevin Korchinski,D,CHI,20,82,1,8,9
17,8482787,Nikita Chibrikov,R,WPG,31,82,2,5,7
17,8479576,Vincent Desharnais,D,VAN,28,82,1,6,7
17,8482070,Mitchell Chaffee,R,TBL,26,82,3,3,6
17,8474062,Riley Nash,C,NYR,35,82,2,3,5
17,8470794,Joe Pavelski,C,,40,0,0,0,0
17,8481703,Valtteri Puustinen,R,PIT,25,0,0,0,0
17,8477950,Tony DeAngelo,D,,29,0,0,0,0
17,8481577,Philip Tomasino,C,NSH,23,0,0,0,0
17,8475197,Tyson Barrie,D,,33,0,0,0,0
17,8471218,Blake Wheeler,R,,38,0,0,0,0
17,8474157,Max Pacioretty,L,,36,0,0,0,0
17,8478466,Daniel Sprong,R,VAN,27,0,0,0,0
17,8475744,Evgeny Kuznetsov,C,,32,0,0,0,0
17,8481019,David Gustafsson,C,WPG,24,0,0,0,0
17,8475906,John Klingberg,D,,32,0,0,0,0
17,8479348,Kale Clague,D,BUF,26,0,0,0,0
17,8476952,Dominic Toninato,C,WPG,30,0,0,0,0
17,8473473,Milan Lucic,L,,36,0,0,0,0
17,8474037,James van Riemsdyk,L,,35,0,0,0,0
17,8474602,Justin Schultz,D,,34,0,0,0,0
17,8482222,Alexander Barabanov,L,,30,0,0,0,0
17,8479372,Josh Mahura,D,SEA,26,0,0,0,0
17,8479982,Conor Timmins,D,TOR,26,0,0,0,0
17,8474031,Kevin Shattenkirk,D,,35,0,0,0,0
17,8480008,Adam Ruzicka,C,,25,0,0,0,0
17,8481059,Scott Perunovich,D,STL,26,0,0,0,0
17,8480884,Calen Addison,D,,24,0,0,0,0
17,8476994,Vinnie Hinostroza,C,NSH,30,0,0,0,0
17,8478452,Caleb Jones,D,LAK,27,0,0,0,0
17,8480157,Calle Rosen,D,COL,30,0,0,0,0
17,8481609,Vladislav Kolyachonok,D,UTA,23,0,0,0,0
17,8479415,Michael McLeod,C,,26,0,0,0,0
17,8476919,Chris Tierney,C,,30,0,0,0,0
17,8479639,Dylan Coghlan,D,WPG,26,0,0,0,0
17,8478146,Matthew Highmore,C,OTT,28,0,0,0,0
17,8478970,Jalen Chatfield,D,CAR,28,0,0,0,0
17,8480205,Emil Bemstrom,C,PIT,25,0,0,0,0
17,8474884,Mike Hoffman,C,,35,0,0,0,0
17,8471274,Alex Goligoski,D,,39,0,0,0,0
17,8478104,Sammy Blais,L,,28,0,0,0,0
17,8474870,Tyler Johnson,C,,34,0,0,0,0
17,8476913,Devin Shore,C,MIN,30,0,0,0,0
17,8481598,Philip Broberg,D,EDM,23,0,0,0,0
17,8480058,Pierre-Olivier Joseph,D,STL,25,0,0,0,0
17,8480891,Michael Kesselring,D,UTA,24,0,0,0,0
17,8477979,Nicolas Aube-Kubel,R,BUF,28,0,0,0,0
17,8476871,Tanner Pearson,L,,32,0,0,0,0
17,8476393,Nick Cousins,C,,31,0,0,0,0
17,8479977,Kailer Yamamoto,R,,26,0,0,0,0
17,8479543,Michael Pezzetta,L,MTL,26,0,0,0,0
17,8477018,Ben Hutton,D,VGK,31,0,0,0,0
17,8480762,Eric Robinson,L,CAR,29,0,0,0,0
17,8474034,Pat Maroon,L,CHI,36,0,0,0,0
17,8481058,Jesse Ylönen,R,,25,0,0,0,0
17,8475179,Dmitry Kulikov,D,FLA,34,0,0,0,0
17,8481527,Kaedan Korczak,D,VGK,23,0,0,0,0
17,8473449,Kyle Okposo,R,,36,0,0,0,0
17,8482192,Isaak Phillips,D,CHI,23,0,0,0,0
17,8480727,Zach Whitecloud,D,VGK,28,0,0,0,0
17,8479346,Dillon Dube,C,,26,0,0,0,0
17,8480821,Filip Zadina,R,,25,0,0,0,0
17,8480001,Urho Vaakanainen,D,ANA,25,0,0,0,0
17,8470966,Mark Giordano,D,,41,0,0,0,0
17,8480853,Liam Foudy,C,,24,0,0,0,0
17,8475225,Craig Smith,C,CHI,35,0,0,0,0
17,8479972,Mason Shaw,C,WPG,26,0,0,0,0
17,8478451,Ethan Bear,D,WSH,27,0,0,0,0
17,8474040,Sam Gagner,C,,35,0,0,0,0
17,8480196,Jacob Bryson,D,BUF,27,0,0,0,0
17,8479984,Cal Foote,D,,26,0,0,0,0
17,8480011,Klim Kostin,C,SJS,25,0,0,0,0
17,8482176,Wyatt Kaiser,D,CHI,22,0,0,0,0
17,8476988,Matt Benning,D,SJS,30,0,0,0,0
17,8479370,Tyson Jost,C,CAR,26,0,0,0,0
17,8477464,Nic Petan,C,,29,0,0,0,0
17,8477380,Jonny Brodzinski,C,NYR,31,0,0,0,0
17,8480070,Ian Mitchell,D,BOS,25,0,0,0,0
17,8479315,Joey Anderson,R,CHI,26,0,0,0,0
17,8478099,Kevin Labanc,R,,29,0,0,0,0
17,8476874,Olli Maatta,D,DET,30,0,0,0,0
17,8475208,Brian Dumoulin,D,ANA,33,0,0,0,0
17,8478430,Oliver Kylington,D,,27,0,0,0,0
17,8479536,Axel Jonsson-Fjallby,L,WPG,26,0,0,0,0
17,8479671,Mathieu Olivier,R,CBJ,27,0,0,0,0
17,8471709,Marc-Edouard Vlasic,D,SJS,37,0,0,0,0
17,8479328,Julien Gauthier,R,NYI,27,0,0,0,0
17,8478421,A.J. Greer,L,FLA,28,0,0,0,0
17,8477573,Nathan Walker,L,STL,30,0,0,0,0
17,8481537,Nikita Okhotiuk,D,CGY,24,0,0,0,0
17,8474166,Alec Martinez,D,CHI,37,0,0,0,0
17,8470610,Zach Parise,L,,40,0,0,0,0
17,8477478,William Carrier,L,CAR,30,0,0,0,0
17,8479344,Jesse Puljujarvi,R,PIT,26,0,0,0,0
17,8480887,Jordan Harris,D,MTL,24,0,0,0,0
17,8478502,Dennis Gilbert,D,BUF,28,0,0,0,0
17,8482730,Brandt Clarke,D,LAK,21,0,0,0,0
17,8480355,Mark Kastelic,C,BOS,25,0,0,0,0
17,8475750,Jon Merrill,D,MIN,32,0,0,0,0
17,8475164,Jakob Silfverberg,R,,34,0,0,0,0
17,8477944,Jakub Vrana,L,,28,0,0,0,0
17,8479439,Jacob MacDonald,D,COL,31,0,0,0,0
17,8474568,Luke Schenn,D,NSH,35,0,0,0,0
17,8478454,Noah Juulsen,D,VAN,27,0,0,0,0
17,8475752,Tyler Pitlick,C,,33,0,0,0,0
17,8482148,Hendrix Lapierre,C,WSH,22,0,0,0,0
17,8481167,Brayden Pachal,D,CGY,25,0,0,0,0
17,8478043,Sam Lafferty,C,BUF,29,0,0,0,0
17,8479321,Lucas Johansen,D,,27,0,0,0,0
17,8471699,Andrew Cogliano,C,,37,0,0,0,0
17,8481521,Ronnie Attard,D,PHI,25,0,0,0,0
17,8481161,Jake Christiansen,D,CBJ,25,0,0,0,0
17,8479458,Nikita Zaitsev,D,,33,0,0,0,0
17,8479619,Michael Carcone,L,UTA,28,0,0,0,0
17,8479026,Philippe Myers,D,TOR,27,0,0,0,0
17,8477330,Dominik Kubalik,L,,29,0,0,0,0
17,8481617,Vasily Podkolzin,R,VAN,23,0,0,0,0
17,8481701,Santeri Hatakka,D,NJD,23,0,0,0,0
17,8479514,Rem Pitlick,C,,27,0,0,0,0
17,8477446,Michael McCarron,R,NSH,29,0,0,0,0
17,8470604,Jeff Carter,C,,39,0,0,0,0
17,8482241,Radim Zohorna,L,,28,0,0,0,0
17,8480289,Morgan Barron,C,WPG,26,0,0,0,0
17,8479379,Givani Smith,R,SJS,26,0,0,0,0
17,8480216,Jacob Peterson,C,,25,0,0,0,0
17,8477851,Jordan Oesterle,D,BOS,32,0,0,0,0
17,8484258,Sam Malinski,D,COL,26,0,0,0,0
17,8478904,Steven Lorentz,C,,28,0,0,0,0
17,8482095,Tyler Kleven,D,OTT,22,0,0,0,0
17,8480848,Ty Dellandrea,C,SJS,24,0,0,0,0
17,8476884,Derrick Pouliot,D,,30,0,0,0,0
17,8479336,Carl Grundstrom,R,SJS,27,0,0,0,0
17,8482964,Arber Xhekaj,D,MTL,23,0,0,0,0
17,8471686,Marc Staal,D,,37,0,0,0,0
17,8477887,Patrick Brown,C,BOS,32,0,0,0,0
17,8478495,Denis Gurianov,R,,27,0,0,0,0
17,8473504,Cal Clutterbuck,R,,37,0,0,0,0
17,8481550,Adam Beckman,L,NJD,23,0,0,0,0
17,8480845,Rasmus Kupari,C,WPG,24,0,0,0,0
17,8474009,Nick Bonino,C,,36,0,0,0,0
17,8478585,Derek Ryan,C,EDM,38,0,0,0,0
17,8477962,Brendan Lemieux,L,CAR,28,0,0,0,0
17,8482861,Vincent Iorio,D,WSH,22,0,0,0,0
17,8479378,Logan Stanley,D,WPG,26,0,0,0,0
17,8473446,Erik Johnson,D,PHI,36,0,0,0,0
17,8481743,Marc Del Gaizo,D,NSH,25,0,0,0,0
17,8477384,Josh Brown,D,EDM,30,0,0,0,0
17,8482165,Yan Kuznetsov,D,CGY,22,0,0,0,0
17,8478424,Jansen Harkins,C,ANA,27,0,0,0,0
17,8482144,Jack Thompson,D,SJS,22,0,0,0,0
17,8478512,Austin Czarnik,C,,32,0,0,0,0
17,8477527,Ross Johnston,L,ANA,30,0,0,0,0
17,8479383,Boris Katchouk,L,,26,0,0,0,0
17,8482094,Daemon Hunt,D,MIN,22,0,0,0,0
17,8481719,Maxwell Crozier,D,TBL,24,0,0,0,0
17,8480192,Johnathan Kovacevic,D,NJD,27,0,0,0,0
17,8479376,Victor Mete,D,,26,0,0,0,0
17,8482511,Mason Lohrei,D,BOS,23,0,0,0,0
17,8475825,Jani Hakanpää,D,,32,0,0,0,0
17,8478021,William Lagesson,D,DET,28,0,0,0,0
17,8475795,Dylan McIlrath,D,WSH,32,0,0,0,0
17,8477846,Ryan Carpenter,C,,33,0,0,0,0
17,8481056,Spencer Stastney,D,NSH,24,0,0,0,0
17,8481564,Ryan Johnson,D,BUF,23,0,0,0,0
17,8478017,Mark Friedman,D,VAN,29,0,0,0,0
17,8479320,Max Lajoie,D,SEA,27,0,0,0,0
17,8480075,Cameron Crotty,D,MIN,25,0,0,0,0
17,8484287,Cole McWard,D,VAN,23,0,0,0,0
17,8484254,Akito Hirose,D,VAN,25,0,0,0,0
17,8483407,Brandon Scanlin,D,NYR,25,0,0,0,0
17,8480274,Philip Kemp,D,EDM,25,0,0,0,0
17,8479522,Hardy Haman Aktell,D,WSH,26,0,0,0,0
17,8480007,Jonas Rondbjerg,R,VGK,25,0,0,0,0
17,8477454,Adam Erne,L,,29,0,0,0,0
17,8481679,Maxence Guenette,D,OTT,23,0,0,0,0
17,8480441,Trey Fix-Wolansky,R,CBJ,25,0,0,0,0
17,8483546,Marshall Rifai,D,TOR,26,0,0,0,0
17,8480084,Nick DeSimone,D,NJD,30,0,0,0,0
17,8481030,Jack St. Ivany,D,PIT,25,0,0,0,0
17,8481592,Jakob Pelletier,L,CGY,23,0,0,0,0
17,8478011,Louie Belpedio,D,PHI,28,0,0,0,0
17,8477930,Pierre-Edouard Bellemare,L,,39,0,0,0,0
17,8484321,Nikolas Matinpalo,D,OTT,26,0,0,0,0
17,8482067,Connor Mackey,D,NYR,28,0,0,0,0
17,8481806,Louis Crevier,D,CHI,23,0,0,0,0
17,8484326,Patrik Koch,D,UTA,28,0,0,0,0
17,8477971,Andreas Englund,D,LAK,28,0,0,0,0
17,8481751,Lukas Rousek,R,BUF,25,0,0,0,0
17,8481006,Tyler Tucker,D,STL,24,0,0,0,0
17,8476867,Brendan Gaunce,C,MIN,30,0,0,0,0
17,8479520,Brandon Duhaime,R,WSH,27,0,0,0,0
17,8477073,Kurtis MacDermid,L,NJD,30,0,0,0,0
17,8480874,Adam Ginning,D,PHI,24,0,0,0,0
17,8477473,Justin Bailey,R,SJS,29,0,0,0,0
17,8479066,Ryan Lomberg,L,CGY,30,0,0,0,0
17,8477070,Liam O'Brien,C,UTA,30,0,0,0,0
17,8474618,Marco Scandella,D,,34,0,0,0,0
17,8475797,Jarred Tinordi,D,,32,0,0,0,0
17,8481441,Joe Snively,C,DET,28,0,0,0,0
17,8477244,Chad Ruhwedel,D,NYR,34,0,0,0,0
17,8479772,Zack MacEwen,R,OTT,28,0,0,0,0
17,8481147,Reese Johnson,C,MIN,26,0,0,0,0
17,8481043,Cole Koepke,L,BOS,26,0,0,0,0
17,8483619,Filip Roos,D,OTT,25,0,0,0,0
17,8481541,Samuel Bolduc,D,NYI,24,0,0,0,0
17,8477810,Joel Hanley,D,CGY,33,0,0,0,0
17,8476907,Mackenzie MacEachern,L,,30,0,0,0,0
17,8482652,Walker Duehr,R,CGY,27,0,0,0,0
17,8477126,Jayson Megna,C,,34,0,0,0,0
17,8483398,Declan Carlile,D,TBL,31,0,0,0,0
17,8482929,Emil Lilleberg,D,TBL,23,0,0,0,0
17,8480880,Jakub Lauko,C,MIN,24,0,0,0,0
17,8480245,Olle Lycksell,R,PHI,25,0,0,0,0
17,8480252,Cole Guttman,C,CHI,25,0,0,0,0
17,8477467,Gustav Olofsson,D,SEA,30,0,0,0,0
17,8479968,Vinni Lettieri,C,BOS,29,0,0,0,0
17,8478400,Colin White,C,,27,0,0,0,0
17,8475755,Alexander Petrovic,D,DAL,32,0,0,0,0
17,8481812,Nikolai Knyzhov,D,,27,0,0,0,0
17,8481593,Jayden Struble,D,MTL,23,0,0,0,0
17,8481532,Alex Turcotte,C,LAK,23,0,0,0,0
17,8482126,Emil Andrae,D,PHI,31,0,0,0,0
17,8479944,Zach Aston-Reese,C,VGK,30,0,0,0,0
17,8471817,Ryan Reaves,R,TOR,37,0,0,0,0
17,8481206,John Ludvig,D,PIT,24,0,0,0,0
17,8481599,Victor Soderstrom,D,UTA,23,0,0,0,0
17,8480292,Carson Meyer,R,ANA,27,0,0,0,0
17,8482496,Nils Aman,C,VAN,24,0,0,0,0
17,8479718,Alex Barré-Boulet,C,MTL,27,0,0,0,0
17,8479994,Jaret Anderson-Dolan,C,WPG,25,0,0,0,0
17,8480184,Gustav Lindstrom,D,,26,0,0,0,0
17,8480890,Jan Jenik,R,OTT,24,0,0,0,0
17,8478067,Oskar Lindblom,L,,28,0,0,0,0
17,8476934,Brock McGinn,L,ANA,30,0,0,0,0
17,8479985,Cale Fleury,D,SEA,26,0,0,0,0
17,8484304,Uvis Balinskis,D,FLA,28,0,0,0,0
17,8479981,Jonah Gadjovich,L,FLA,26,0,0,0,0
17,8481716,Dmitri Voronkov,L,CBJ,24,0,0,0,0
17,8474709,Matt Martin,L,,35,0,0,0,0
17,8482634,Alex Steeves,C,TOR,25,0,0,0,0
17,8480823,Alexander Alexeyev,D,WSH,25,0,0,0,0
17,8477541,Dakota Mermis,D,TOR,30,0,0,0,0
17,8483491,Ivan Miroshnichenko,L,WSH,20,0,0,0,0
17,8478477,Mitchell Stephens,C,SEA,27,0,0,0,0
17,8481543,Nikita Alexandrov,C,STL,24,0,0,0,0
17,8479423,Alex Nylander,L,,26,0,0,0,0
17,8482451,Mikael Pyyhtia,L,CBJ,23,0,0,0,0
17,8478831,Kevin Stenlund,C,UTA,28,0,0,0,0
17,8480306,Grant Hutton,D,NYI,29,0,0,0,0
17,8478028,Fredrik Olofsson,L,,28,0,0,0,0
17,8477462,Robert Hagg,D,VGK,29,0,0,0,0
17,8477320,Anton Blidh,L,NYR,29,0,0,0,0
17,8482157,Will Cuylle,L,NYR,22,0,0,0,0
17,8482737,Zack Bolduc,C,STL,21,0,0,0,0
17,8481239,Samuel Fagemo,L,,24,0,0,0,0
17,8481600,Tobias Bjornfot,D,FLA,23,0,0,0,0
17,8478409,Anthony Richard,C,PHI,28,0,0,0,0
17,8474145,Robert Bortuzzo,D,,35,0,0,0,0
17,8475958,Michael Sgarbossa,C,WSH,32,0,0,0,0
17,8479986,Kole Lind,R,DAL,26,0,0,0,0
17,8479249,Andrew Poturalski,C,SJS,30,0,0,0,0
17,8479362,Riley Tufte,L,BOS,26,0,0,0,0
17,8479991,Jake Leschyshyn,C,NYR,25,0,0,0,0
17,8479587,Rhett Gardner,C,PHI,28,0,0,0,0
17,8482744,James Malatesta,L,CBJ,21,0,0,0,0
17,8478854,Ryan Shea,D,PIT,27,0,0,0,0
17,8481591,Sam Poulin,R,,23,0,0,0,0
17,8483512,Matt Savoie,C,EDM,20,0,0,0,0
17,8482102,Vasily Ponomarev,C,PIT,22,0,0,0,0
17,8482162,Roby Jarventie,L,EDM,22,0,0,0,0
17,8481016,Ruslan Iskhakov,C,,24,0,0,0,0
17,8482172,Landon Slaggert,L,CHI,22,0,0,0,0
17,8482747,Brennan Othmann,L,NYR,21,0,0,0,0
17,8480031,Maxime Comtois,L,,25,0,0,0,0
17,8480226,Marián Studenic,R,,26,0,0,0,0
17,8478408,Travis Dermott,D,,28,0,0,0,0
17,8481518,Nolan Foote,L,NJD,24,0,0,0,0
17,8479419,Brett Murray,L,BUF,26,0,0,0,0
17,8482088,Justin Sourdif,R,FLA,22,0,0,0,0
17,8482201,Gage Goncalves,C,TBL,23,0,0,0,0
17,8481578,Graeme Clarke,R,MIN,23,0,0,0,0
17,8482177,Marat Khusnutdinov,C,MIN,22,0,0,0,0
17,8481754,Nikita Nesterenko,C,ANA,23,0,0,0,0
17,8483531,Brian Halonen,L,NJD,25,0,0,0,0
17,8483920,Pierrick Dube,R,WSH,23,0,0,0,0
17,8480851,Akil Thomas,C,LAK,24,0,0,0,0
17,8475235,Nicolas Deslauriers,L,PHI,33,0,0,0,0
17,8482476,Emil Heineman,L,MTL,23,0,0,0,0
17,8477149,Scott Sabourin,R,SJS,32,0,0,0,0
17,8483549,Lucas Condotta,L,MTL,27,0,0,0,0
17,8482765,Isak Rosen,R,BUF,21,0,0,0,0
17,8481237,Kyle MacLean,C,NYI,25,0,0,0,0
17,8481024,Linus Karlsson,C,VAN,25,0,0,0,0
17,8481690,Tyler Angle,C,,24,0,0,0,0
17,8483570,Ben Meyers,C,SEA,26,0,0,0,0
17,8481655,Cole Schwindt,R,CGY,23,0,0,0,0
17,8481462,Mason Morelli,L,VGK,28,0,0,0,0
17,8483401,Marc Johnstone,R,PIT,28,0,0,0,0
17,8478956,Samuel Laberge,L,NJD,27,0,0,0,0
17,8479533,Joona Koppanen,L,,26,0,0,0,0
17,8482197,Adam Raska,R,MIN,23,0,0,0,0
17,8482250,Callahan Burke,C,VGK,27,0,0,0,0
17,8482784,Zach Dean,C,STL,21,0,0,0,0
17,8484255,Jason Polin,R,COL,25,0,0,0,0
17,8481077,John Leonard,L,,26,0,0,0,0
17,8481534,Raphael Lavoie,C,EDM,24,0,0,0,0
17,8483609,Adam Klapka,R,CGY,24,0,0,0,0
17,8482751,Ryan Winterton,C,SEA,21,0,0,0,0
17,8480267,Sammy Walker,C,MIN,25,0,0,0,0
17,8475766,Austin Watson,L,,32,0,0,0,0
17,8482460,Matt Rempe,C,NYR,22,0,0,0,0
17,8481065,Angus Crookshank,L,OTT,25,0,0,0,0
17,8481070,Hugh McGing,L,,26,0,0,0,0
17,8476323,Max McCormick,L,SEA,32,0,0,0,0
17,8483395,Arshdeep Bains,L,VAN,23,0,0,0,0
17,8484259,Ondrej Pavel,C,COL,31,0,0,0,0
17,8483432,Luca Del Bel Belluz,C,CBJ,31,0,0,0,0
17,8483045,Cameron Butler,R,CBJ,31,0,0,0,0
17,8482061,Brandon Biro,L,SEA,26,0,0,0,0
17,8477401,John Hayden,C,SEA,29,0,0,0,0
17,8475278,Byron Froese,C,,33,0,0,0,0
17,8478446,Glenn Gawdin,C,LAK,27,0,0,0,0
17,8477993,Justin Kirkland,C,CGY,28,0,0,0,0
17,8482147,Jean-Luc Foudy,C,COL,22,0,0,0,0
17,8480032,Shane Bowers,C,NJD,25,0,0,0,0
17,8479330,Brandon Gignac,C,MTL,27,0,0,0,0
17,8480776,Sheldon Rempal,R,,29,0,0,0,0
17,8475413,Justin Dowling,C,NJD,34,0,0,0,0
17,8481726,Adam Edstrom,C,NYR,24,0,0,0,0
17,8480844,Grigori Denisenko,L,VGK,24,0,0,0,0
17,8478147,Bokondji Imama,L,PIT,28,0,0,0,0
17,8478881,Brett Seney,L,CHI,28,0,0,0,0
17,8483630,Pavol Regenda,L,ANA,25,0,0,0,0
17,8480836,Jonathan Gruden,C,,24,0,0,0,0
17,8484314,Jiri Smejkal,L,,28,0,0,0,0
17,8475780,Chris Wagner,R,COL,33,0,0,0,0
17,8479546,Oskar Steen,C,,26,0,0,0,0
17,8483597,Milos Kelemen,L,UTA,25,0,0,0,0
17,8481789,Tye Kartye,L,SEA,23,0,0,0,0
17,8484325,Waltteri Merela,C,TBL,26,0,0,0,0
17,8479421,Jacob Moverare,D,LAK,26,0,0,0,0
17,8481585,Egor Afanasyev,L,SJS,23,0,0,0,0
17,8479547,Matthew Phillips,R,,26,0,0,0,0
17,8479367,William Lockwood,R,FLA,26,0,0,0,0
17,8476915,Jujhar Khaira,L,,30,0,0,0,0
17,8481422,Jacob Lucchini,C,NSH,29,0,0,0,0
17,8480468,James Hamblin,L,EDM,25,0,0,0,0
17,8478051,Max Willman,C,NJD,29,0,0,0,0
17,8481556,John Beecher,C,BOS,23,0,0,0,0
17,8478078,Rourke Chartier,C,,28,0,0,0,0
18,8477492,Nathan MacKinnon,C,COL,29,82,60,81,141
18,8478402,Connor McDavid,C,EDM,27,82,43,98,141
18,8476453,Nikita Kucherov,R,TBL,31,82,29,99,128
18,8481559,Jack Hughes,C,NJD,23,82,50,67,117
18,8477934,Leon Draisaitl,C,EDM,29,82,37,70,107
18,8477939,William Nylander,R,TOR,28,82,46,59,105
18,8480002,Nico Hischier,C,NJD,25,82,46,58,104
18,8479318,Auston Matthews,C,TOR,27,82,51,52,103
18,8478420,Mikko Rantanen,R,COL,28,82,43,59,102
18,8476468,J.T. Miller,C,VAN,31,82,37,65,102
18,8480069,Cale Makar,D,COL,26,82,20,82,102
18,8477956,David Pastrnak,R,BOS,28,82,52,47,99
18,8478398,Kyle Connor,L,WPG,28,82,49,48,97
18,8478403,Jack Eichel,C,VGK,28,82,49,47,96
18,8477946,Dylan Larkin,C,DET,28,82,38,58,96
18,8477942,Kevin Fiala,L,LAK,28,82,32,64,96
18,8477493,Aleksander Barkov,C,FLA,29,82,29,67,96
18,8476887,Filip Forsberg,L,NSH,30,82,47,47,94
18,8478427,Sebastian Aho,C,CAR,27,82,46,47,93
18,8479407,Jesper Bratt,L,NJD,26,82,35,58,93
18,8474564,Steven Stamkos,C,NSH,34,82,39,52,91
18,8478550,Artemi Panarin,L,NYR,33,82,37,53,90
18,8480023,Robert Thomas,C,STL,25,82,28,62,90
18,8481540,Cole Caufield,R,MTL,23,82,50,39,89
18,8471675,Sidney Crosby,C,PIT,37,82,42,47,89
18,8480801,Brady Tkachuk,L,OTT,25,82,41,46,87
18,8479314,Matthew Tkachuk,L,FLA,27,82,31,56,87
18,8477960,Adrian Kempe,R,LAK,28,82,30,57,87
18,8475172,Nazem Kadri,C,CGY,34,82,27,60,87
18,8480800,Quinn Hughes,D,VAN,25,82,12,75,87
18,8480027,Jason Robertson,L,DAL,25,82,33,51,84
18,8478440,Dylan Strome,C,WSH,27,82,24,60,84
18,8477409,Carter Verhaeghe,C,FLA,29,82,41,42,83
18,8476539,Jonathan Marchessault,R,NSH,34,82,39,44,83
18,8478864,Kirill Kaprizov,L,MIN,27,82,38,45,83
18,8478445,Mathew Barzal,C,NYI,27,82,20,63,83
18,8477949,Alex Tuch,R,BUF,28,82,28,53,81
18,8478414,Timo Meier,R,NJD,28,82,38,42,80
18,8477940,Nikolaj Ehlers,L,WPG,28,82,30,50,80
18,8482116,Tim Stützle,C,OTT,22,82,24,56,80
18,8474600,Roman Josi,D,NSH,34,82,24,56,80
18,8480012,Elias Pettersson,C,VAN,26,82,41,38,79
18,8479343,Clayton Keller,R,UTA,26,82,30,49,79
18,8476346,Johnny Gaudreau,L,CBJ,31,82,21,58,79
18,8473512,Claude Giroux,R,OTT,36,82,20,59,79
18,8477404,Jake Guentzel,C,TBL,30,82,33,45,78
18,8477933,Sam Reinhart,C,FLA,29,82,31,47,78
18,8478010,Brayden Point,C,TBL,28,82,42,35,77
18,8477402,Pavel Buchnevich,L,STL,29,82,35,41,76
18,8477500,Bo Horvat,C,NYI,29,82,36,39,75
18,8476459,Mika Zibanejad,C,NYR,31,82,29,46,75
18,8476853,Morgan Rielly,D,TOR,30,82,13,62,75
18,8477504,Josh Morrissey,D,WPG,29,82,11,64,75
18,8478449,Roope Hintz,C,DAL,28,82,39,35,74
18,8471214,Alex Ovechkin,L,WSH,39,82,29,45,74
18,8480208,Drake Batherson,R,OTT,26,82,28,46,74
18,8482665,Matty Beniers,C,SEA,22,82,27,47,74
18,8471685,Anze Kopitar,C,LAK,37,82,26,48,74
18,8479385,Jordan Kyrou,C,STL,26,82,39,34,73
18,8479337,Alex DeBrincat,R,DET,27,82,37,36,73
18,8477501,Valeri Nichushkin,R,COL,29,82,32,41,73
18,8479420,Tage Thompson,C,BUF,27,82,31,42,73
18,8475913,Mark Stone,R,VGK,32,82,24,49,73
18,8476456,Jonathan Huberdeau,C,CGY,31,82,17,56,73
18,8478439,Travis Konecny,R,PHI,27,82,34,38,72
18,8476881,Tomas Hertl,C,VGK,31,82,32,40,72
18,8478042,Viktor Arvidsson,R,EDM,31,82,28,44,72
18,8476460,Mark Scheifele,C,WPG,31,82,26,46,72
18,8480865,Noah Dobson,D,NYI,24,82,19,53,72
18,8481523,Kirby Dach,C,MTL,23,82,11,61,72
18,8475158,Ryan O'Reilly,C,NSH,33,82,36,35,71
18,8479542,Brandon Hagel,L,TBL,26,82,34,37,71
18,8480018,Nick Suzuki,C,MTL,25,82,29,42,71
18,8476454,Ryan Nugent-Hopkins,C,EDM,31,82,20,51,71
18,8476389,Vincent Trocheck,C,NYR,31,82,27,43,70
18,8475166,John Tavares,C,TOR,34,82,35,34,69
18,8480830,Andrei Svechnikov,R,CAR,24,82,32,37,69
18,8480803,Evan Bouchard,D,EDM,25,82,16,53,69
18,8477951,Nick Schmaltz,C,UTA,28,82,28,40,68
18,8476880,Tom Wilson,R,WSH,30,82,38,29,67
18,8475798,Mikael Granlund,C,SJS,32,82,17,50,67
18,8479400,Pierre-Luc Dubois,L,WSH,26,82,37,29,66
18,8475784,Jeff Skinner,C,EDM,32,82,34,32,66
18,8474641,Adam Henrique,C,EDM,34,82,33,33,66
18,8475170,Brayden Schenn,C,STL,33,82,26,40,66
18,8471215,Evgeni Malkin,C,PIT,38,82,25,41,66
18,8478873,Troy Terry,R,ANA,27,82,21,45,66
18,8479323,Adam Fox,D,NYR,26,82,18,48,66
18,8475786,Zach Hyman,L,EDM,32,82,31,34,65
18,8475765,Vladimir Tarasenko,R,DET,33,82,25,40,65
18,8478401,Pavel Zacha,C,BOS,27,82,21,44,65
18,8476432,Boone Jenner,C,CBJ,31,82,37,27,64
18,8474141,Patrick Kane,R,DET,36,82,31,33,64
18,8478498,Jake DeBrusk,L,VAN,28,82,29,35,64
18,8481528,Dylan Cozens,C,BUF,23,82,24,40,64
18,8476875,Mike Matheson,D,MTL,30,82,9,55,64
18,8475754,Brock Nelson,C,NYI,33,82,32,31,63
18,8477955,Jared McCann,L,SEA,28,82,26,37,63
18,8475167,Victor Hedman,D,TBL,34,82,17,46,63
18,8475169,Evander Kane,L,EDM,33,82,30,32,62
18,8481533,Trevor Zegras,C,ANA,23,82,29,33,62
18,8482093,Seth Jarvis,C,CAR,22,82,28,34,62
18,8475168,Matt Duchene,C,DAL,33,82,26,36,62
18,8476448,William Karlsson,C,VGK,31,82,26,36,62
18,8478366,Frank Vatrano,R,ANA,30,82,34,27,61
18,8479339,Patrik Laine,L,CBJ,26,82,28,33,61
18,8482110,Dawson Mercer,C,NJD,23,82,26,35,61
18,8477496,Elias Lindholm,C,BOS,30,82,24,37,61
18,8476905,Chandler Stephenson,C,SEA,30,82,19,42,61
18,8478444,Brock Boeser,R,VAN,27,82,29,31,60
18,8476479,Phillip Danault,C,LAK,31,82,29,31,60
18,8482097,Jack Quinn,R,BUF,23,82,24,36,60
18,8479325,Charlie McAvoy,D,BOS,27,82,8,52,60
18,8475184,Chris Kreider,L,NYR,33,82,32,27,59
18,8478460,Zach Werenski,D,CBJ,27,82,10,49,59
18,8475799,Nino Niederreiter,R,WPG,32,82,32,26,58
18,8475793,Ryan Johansen,C,PHI,32,82,32,26,58
18,8478047,Michael Bunting,L,PIT,29,82,21,37,58
18,8478975,Mason Marchment,L,DAL,29,82,18,40,58
18,8477494,Jonathan Drouin,L,COL,29,82,17,41,58
18,8480839,Rasmus Dahlin,D,BUF,24,82,14,44,58
18,8474578,Erik Karlsson,D,PIT,34,82,14,44,58
18,8478397,Rasmus Andersson,D,CGY,28,82,9,49,58
18,8478474,Lawson Crouse,L,UTA,27,82,33,24,57
18,8479675,Trevor Moore,L,LAK,29,82,31,26,57
18,8475794,Tyler Seguin,C,DAL,32,82,29,28,57
18,8482699,Dylan Guenther,R,UTA,21,82,28,29,57
18,8481557,Matt Boldy,L,MIN,23,82,27,30,57
18,8480039,Martin Necas,C,CAR,25,82,19,38,57
18,8477495,Seth Jones,D,CHI,30,82,10,47,57
18,8481068,Yegor Sharangovich,C,CGY,26,82,27,29,56
18,8473986,Alex Killorn,L,ANA,35,82,27,29,56
18,8473419,Brad Marchand,L,BOS,36,82,21,35,56
18,8478407,Vince Dunn,D,SEA,28,82,10,46,56
18,8480014,Gabriel Vilardi,C,WPG,25,82,30,25,55
18,8476483,Rickard Rakell,R,PIT,31,82,24,31,55
18,8482078,Lucas Raymond,L,DET,22,82,19,36,55
18,8478438,Tommy Novak,C,NSH,27,82,13,42,55
18,8476923,Damon Severson,D,CBJ,30,82,11,44,55
18,8475726,Tyler Toffoli,C,SJS,32,82,29,25,54
18,8475151,Kyle Palmieri,C,NYI,33,82,23,31,54
18,8480797,Joel Farabee,L,PHI,24,82,19,35,54
18,8477998,Warren Foegele,L,LAK,28,82,18,36,54
18,8480078,Filip Chytil,C,NYR,25,82,17,37,54
18,8480064,Josh Norris,C,OTT,25,82,26,27,53
18,8477407,Anthony Duclair,L,NYI,29,82,23,30,53
18,8475692,Mats Zuccarello,R,MIN,37,82,16,37,53
18,8478038,Devon Toews,D,COL,30,82,12,41,53
18,8475768,Jaden Schwartz,C,SEA,32,82,29,23,52
18,8478519,Anthony Cirelli,C,TBL,27,82,28,24,52
18,8475722,Jason Zucker,L,BUF,32,82,23,29,52
18,8475810,Bryan Rust,R,PIT,32,82,22,30,52
18,8479345,Jakob Chychrun,D,WSH,26,82,17,35,52
18,8480188,Fabian Zetterlund,L,SJS,25,82,17,35,52
18,8477447,Shea Theodore,D,VGK,29,82,7,45,52
18,8474586,Jordan Eberle,R,SEA,34,82,26,25,51
18,8475314,Anders Lee,L,NYI,34,82,24,27,51
18,8477416,Oliver Bjorkstrand,R,SEA,29,82,23,28,51
18,8478115,Pierre Engvall,L,NYI,28,82,23,28,51
18,8482159,Tyson Foerster,R,PHI,22,82,22,29,51
18,8481618,Alex Newhook,C,MTL,23,82,21,30,51
18,8478856,Conor Garland,R,VAN,28,82,20,31,51
18,8480028,Morgan Frost,C,PHI,25,82,19,32,51
18,8474679,Gustav Nyquist,C,NSH,35,82,14,37,51
18,8481581,Thomas Harley,D,DAL,23,82,13,38,51
18,8482671,Owen Power,D,BUF,22,82,13,38,51
18,8477935,Sam Bennett,C,FLA,28,82,26,24,50
18,8479999,Casey Mittelstadt,C,COL,26,82,24,26,50
18,8475191,Reilly Smith,R,NYR,33,82,23,27,50
18,8473994,Jamie Benn,L,DAL,35,82,19,31,50
18,8483515,Juraj Slafkovsky,L,MTL,20,82,17,33,50
18,8475218,Mattias Ekholm,D,EDM,34,82,15,35,50
18,8471724,Kris Letang,D,PIT,37,82,14,36,50
18,8481711,Matias Maccelli,L,UTA,24,82,14,36,50
18,8479410,Mikhail Sergachev,D,UTA,26,82,12,38,50
18,8480036,Miro Heiskanen,D,DAL,25,82,11,39,50
18,8479425,Filip Hronek,D,VAN,27,82,10,40,50
18,8478233,Andrew Mangiapane,L,WSH,28,82,22,27,49
18,8482745,Mason McTavish,C,ANA,21,82,18,31,49
18,8477964,Ivan Barbashev,C,VGK,29,82,17,32,49
18,8474563,Drew Doughty,D,LAK,35,82,14,35,49
18,8474590,John Carlson,D,WSH,34,82,14,35,49
18,8480802,Ryan McLeod,C,BUF,25,82,20,28,48
18,8474102,David Perron,L,OTT,36,82,18,30,48
18,8482684,Luke Hughes,D,NJD,21,82,9,39,48
18,8477476,Artturi Lehkonen,L,COL,29,82,28,19,47
18,8476882,Teuvo Teravainen,L,CHI,30,82,23,24,47
18,8482109,Alexis Lafrenière,L,NYR,23,82,19,28,47
18,8477456,J.T. Compher,L,DET,29,82,19,28,47
18,8477932,Aaron Ekblad,D,FLA,28,82,15,32,47
18,8478458,Jack Roslovic,C,CAR,27,82,15,32,47
18,8476462,Dougie Hamilton,D,NJD,31,82,14,33,47
18,8475791,Taylor Hall,L,CHI,33,82,23,23,46
18,8477497,Sean Monahan,C,CBJ,30,82,21,25,46
18,8482667,William Eklund,L,SJS,22,82,20,26,46
18,8477479,Tyler Bertuzzi,L,CHI,29,82,19,27,46
18,8480015,Owen Tippett,R,PHI,25,82,18,28,46
18,8478462,Nicolas Roy,C,VGK,27,82,16,30,46
18,8480798,Philipp Kurashev,C,CHI,25,82,16,30,46
18,8476892,Colton Parayko,D,STL,31,82,8,38,46
18,8482475,Yegor Chinakhov,R,CBJ,23,82,20,25,45
18,8475287,Erik Haula,L,NJD,33,82,19,26,45
18,8474565,Alex Pietrangelo,D,VGK,34,82,13,32,45
18,8477346,MacKenzie Weegar,D,CGY,30,82,11,34,45
18,8476958,Jaccob Slavin,D,CAR,30,82,8,37,45
18,8476399,Blake Coleman,C,CGY,33,82,23,21,44
18,8479525,Ross Colton,C,COL,28,82,20,24,44
18,8475745,Charlie Coyle,C,BOS,32,82,19,25,44
18,8471698,T.J. Oshie,R,WSH,38,82,19,25,44
18,8477503,Max Domi,C,TOR,29,82,15,29,44
18,8476438,Brandon Saad,L,STL,32,82,14,30,44
18,8477948,Travis Sanheim,D,PHI,28,82,9,35,44
18,8476906,Shayne Gostisbehere,D,CAR,31,82,8,36,44
18,8475753,Justin Faulk,D,STL,32,82,8,36,44
18,8482720,Matthew Knies,L,TOR,22,82,20,23,43
18,8477511,Anthony Mantha,R,CGY,30,82,18,25,43
18,8474149,Evgenii Dadonov,R,DAL,35,82,18,25,43
18,8482124,Quinton Byfield,R,LAK,22,82,17,26,43
18,8480459,Pius Suter,C,VAN,28,82,17,26,43
18,8478046,Danton Heinen,L,VAN,29,82,17,26,43
18,8478413,Jordan Greenway,L,BUF,27,82,17,26,43
18,8480829,Jesperi Kotkaniemi,C,CAR,24,82,16,27,43
18,8473563,Nicklas Backstrom,C,WSH,37,82,12,31,43
18,8477498,Darnell Nurse,D,EDM,29,82,11,32,43
18,8478396,Noah Hanifin,D,VGK,27,82,10,33,43
18,8477986,Brandon Montour,D,SEA,30,82,9,34,43
18,8476458,Ryan Strome,C,ANA,31,82,9,34,43
18,8470613,Brent Burns,D,CAR,39,82,8,35,43
18,8476854,Hampus Lindholm,D,BOS,30,82,7,36,43
18,8482740,Wyatt Johnston,C,DAL,21,82,25,17,42
18,8483808,Andrei Kuzmenko,L,CGY,28,82,23,19,42
18,8481522,Peyton Krebs,C,BUF,23,82,19,23,42
18,8474150,Mikael Backlund,C,CGY,35,82,14,28,42
18,8482133,Thomas Bordeleau,C,SJS,22,82,13,29,42
18,8475343,Nic Dowd,C,WSH,34,82,12,30,42
18,8480817,K'Andre Miller,D,NYR,24,82,10,32,42
18,8480145,Neal Pionk,D,WPG,29,82,9,33,42
18,8481542,Moritz Seider,D,DET,23,82,3,39,42
18,8481604,Pavel Dorofeyev,L,VGK,24,82,25,16,41
18,8482705,Cole Sillinger,C,CBJ,21,82,20,21,41
18,8477426,Nicholas Paul,L,TBL,29,82,19,22,41
18,8478891,Mason Appleton,C,WPG,28,82,19,22,41
18,8481596,Shane Pinto,C,OTT,24,82,18,23,41
18,8476469,Joel Armia,R,MTL,31,82,18,23,41
18,8480009,Eeli Tolvanen,R,SEA,25,82,17,24,41
18,8480849,Barrett Hayton,C,UTA,24,82,14,27,41
18,8481186,Logan O'Connor,R,COL,28,82,13,28,41
18,8479398,Samuel Girard,D,COL,26,82,6,35,41
18,8482055,Drew O'Connor,L,PIT,26,82,20,20,40
18,8478463,Anthony Beauvillier,L,PIT,27,82,20,20,40
18,8477987,Ryan Donato,C,CHI,28,82,19,21,40
18,8477425,Miles Wood,L,COL,29,82,18,22,40
18,8476419,Jean-Gabriel Pageau,C,NYI,32,82,17,23,40
18,8481624,Ilya Mikheyev,R,CHI,30,82,17,23,40
18,8477429,Andrew Copp,C,DET,30,82,16,24,40
18,8484144,Connor Bedard,C,CHI,19,82,16,24,40
18,8476826,Yanni Gourde,C,SEA,33,82,16,24,40
18,8480113,Alex Iafallo,L,WPG,31,82,16,24,40
18,8479353,Brett Howden,C,VGK,26,82,13,27,40
18,8476461,Sean Couturier,C,PHI,32,82,12,28,40
18,8482105,Jake Sanderson,D,OTT,22,82,11,29,40
18,8478500,Ivan Provorov,D,CBJ,27,82,2,38,40
18,8481580,Connor McMichael,C,WSH,23,82,22,17,39
18,8478493,Joel Eriksson Ek,C,MIN,27,82,20,19,39
18,8481560,Arthur Kaliyev,R,LAK,23,82,20,19,39
18,8475848,Brendan Gallagher,R,MTL,32,82,20,19,39
18,8473422,Nick Foligno,L,CHI,37,82,18,21,39
18,8477444,Andre Burakovsky,L,SEA,29,82,15,24,39
18,8482117,Lukas Reichel,L,CHI,22,82,15,24,39
18,8481554,Kaapo Kakko,R,NYR,23,82,15,24,39
18,8482113,Anton Lundell,C,FLA,23,82,14,25,39
18,8476792,Torey Krug,D,STL,33,82,12,27,39
18,8480434,Sean Durzi,D,UTA,26,82,11,28,39
18,8476869,Brady Skjei,D,NSH,30,82,11,28,39
18,8475763,Kevin Hayes,R,PIT,32,82,10,29,39
18,8475764,Cam Fowler,D,ANA,33,82,5,34,39
18,8484166,Adam Fantilli,C,CBJ,20,82,22,16,38
18,8482146,Luke Evangelista,R,NSH,22,82,20,18,38
18,8478469,Thomas Chabot,D,OTT,27,82,18,20,38
18,8482175,JJ Peterka,R,BUF,22,82,17,21,38
18,8479996,Cody Glass,C,NSH,25,82,16,22,38
18,8476927,Teddy Blueger,C,VAN,30,82,16,22,38
18,8481535,Nils Hoglander,L,VAN,24,82,20,17,37
18,8477451,Ryan Hartman,R,MIN,30,82,17,20,37
18,8477947,Sonny Milano,L,WSH,28,82,16,21,37
18,8476392,Adam Lowry,C,WPG,31,82,15,22,37
18,8476474,Stefan Noesen,R,NJD,31,82,13,24,37
18,8476925,Colton Sissons,C,NSH,31,82,12,25,37
18,8475149,Marcus Johansson,L,MIN,34,82,11,26,37
18,8480873,Rasmus Sandin,D,WSH,24,82,2,35,37
18,8479987,Morgan Geekie,C,BOS,26,82,18,18,36
18,8478057,Dakota Joshua,C,VAN,28,82,16,20,36
18,8473533,Jordan Staal,C,CAR,36,82,15,21,36
18,8477450,Jason Dickinson,C,CHI,29,82,15,21,36
18,8479591,Michael Eyssimont,C,TBL,28,82,14,22,36
18,8477021,Alex Kerfoot,C,UTA,30,82,13,23,36
18,8482149,Cole Perfetti,C,WPG,22,82,13,23,36
18,8476960,Andreas Athanasiou,C,CHI,30,82,13,23,36
18,8476292,Ondrej Palat,L,NJD,33,82,9,27,36
18,8478055,Gustav Forsling,D,FLA,28,82,6,30,36
18,8479941,Justin Danforth,R,CBJ,31,82,22,13,35
18,8475760,Nick Bjugstad,C,UTA,32,82,22,13,35
18,8482092,Ridly Greig,C,OTT,22,82,18,17,35
18,8481656,Aliaksei Protas,C,WSH,23,82,17,18,35
18,8481481,Blake Lizotte,C,PIT,27,82,17,18,35
18,8474189,Lars Eller,C,PIT,35,82,16,19,35
18,8482624,Daniil Miromanov,D,CGY,27,82,14,21,35
18,8478542,Evan Rodrigues,C,FLA,31,82,13,22,35
18,8482660,Kent Johnson,C,CBJ,22,82,8,27,35
18,8479365,Trent Frederic,C,BOS,26,82,15,19,34
18,8479992,Michael Rasmussen,C,DET,25,82,12,22,34
18,8476872,Scott Laughton,C,PHI,30,82,11,23,34
18,8480871,Adam Boqvist,D,FLA,24,82,11,23,34
18,8482089,Jake Neighbours,L,STL,22,82,21,12,33
18,8482074,Connor Zary,C,CGY,23,82,18,15,33
18,8481032,Paul Cotter,C,NJD,25,82,16,17,33
18,8477989,Christian Dvorak,C,MTL,28,82,16,17,33
18,8477952,Robby Fabbri,C,ANA,28,82,15,18,33
18,8481601,Simon Holmstrom,R,NYI,23,82,15,18,33
18,8474715,Cam Atkinson,R,TBL,35,82,15,18,33
18,8478472,Mathieu Joseph,R,STL,27,82,13,20,33
18,8479390,Taylor Raddysh,R,WSH,26,82,13,20,33
18,8476624,Barclay Goodrow,C,SJS,31,82,11,22,33
18,8481546,Cam York,D,PHI,23,82,7,26,33
18,8475181,Nick Leddy,D,STL,33,82,6,27,33
18,8476422,Mike Reilly,D,NYI,31,82,6,27,33
18,8480220,Noah Cates,L,PHI,25,82,16,16,32
18,8481477,Nico Sturm,C,SJS,29,82,15,17,32
18,8482702,Logan Stankoven,C,DAL,21,82,14,18,32
18,8479661,Tanner Jeannot,L,LAK,27,82,13,19,32
18,8476480,Vladislav Namestnikov,C,WPG,32,82,12,20,32
18,8480995,Pontus Holmberg,R,TOR,25,82,12,20,32
18,8475231,Casey Cizikas,C,NYI,33,82,11,21,32
18,8477839,Conor Sheary,L,TBL,32,82,10,22,32
18,8481582,Nicholas Robertson,L,TOR,23,82,10,22,32
18,8478911,Matt Roy,D,WSH,29,82,9,23,32
18,8478882,Vladislav Gavrikov,D,LAK,29,82,8,24,32
18,8480336,Sean Walker,D,CAR,30,82,6,26,32
18,8479983,Mario Ferraro,D,SJS,26,82,4,28,32
18,8477506,Ryan Pulock,D,NYI,30,82,2,30,32
18,8475714,Calle Jarnkrok,C,TOR,33,82,16,15,31
18,8480806,Isac Lundestrom,C,ANA,25,82,15,16,31
18,8481093,Rafael Harvey-Pinard,L,MTL,25,82,14,17,31
18,8483457,Lane Hutson,D,MTL,20,82,12,19,31
18,8476312,Josh Manson,D,COL,33,82,12,19,31
18,8481606,Jordan Spence,D,LAK,23,82,7,24,31
18,8476525,Colin Miller,D,WPG,32,82,6,25,31
18,8478399,Jonas Siegenthaler,D,NJD,27,82,3,28,31
18,8481014,Alexander Romanov,D,NYI,24,82,2,29,31
18,8482125,Alexander Holtz,R,VGK,22,82,19,11,30
18,8483431,Logan Cooley,C,UTA,20,82,17,13,30
18,8475855,Jesper Fast,R,CAR,33,82,16,14,30
18,8481028,Martin Pospisil,C,CGY,25,82,15,15,30
18,8480835,Jack Drury,C,CAR,24,82,14,16,30
18,8476921,Jordan Martinook,L,CAR,32,82,13,17,30
18,8478109,Victor Olofsson,L,VGK,29,82,13,17,30
18,8475171,Oliver Ekman-Larsson,D,TOR,33,82,11,19,30
18,8477015,Connor Brown,R,EDM,30,82,11,19,30
18,8476885,Jacob Trouba,D,NYR,30,82,9,21,30
18,8474151,Ryan McDonagh,D,TBL,35,82,6,24,30
18,8475200,Dmitry Orlov,D,CAR,33,82,4,26,30
18,8476902,Esa Lindell,D,DAL,30,82,4,26,30
18,8479293,Brandon Tanev,L,SEA,33,82,18,11,29
18,8479393,Noah Gregor,C,OTT,26,82,16,13,29
18,8474053,Logan Couture,C,SJS,35,82,14,15,29
18,8480068,Ryan Poehling,C,PHI,25,82,14,15,29
18,8477406,Mattias Janmark,C,EDM,32,82,14,15,29
18,8478013,Jake Walman,D,SJS,28,82,11,18,29
18,8479351,Sam Steel,C,DAL,26,82,10,19,29
18,8482166,Shakir Mukhamadullin,D,SJS,22,82,10,19,29
18,8476457,Adam Larsson,D,SEA,32,82,9,20,29
18,8474716,Jared Spurgeon,D,MIN,35,82,8,21,29
18,8476979,Erik Gustafsson,D,DET,32,82,6,23,29
18,8481568,Alex Vlasic,D,CHI,23,82,6,23,29
18,8475790,Erik Gudbranson,D,CBJ,32,82,3,26,29
18,8478508,Yakov Trenin,C,MIN,27,82,14,14,28
18,8477508,Curtis Lazar,C,NJD,29,82,13,15,28
18,8482111,Justin Barron,D,MTL,23,82,12,16,28
18,8481704,Juuso Parssinen,C,NSH,23,82,11,17,28
18,8483445,Cutter Gauthier,L,ANA,20,82,11,17,28
18,8482142,Jamie Drysdale,D,PHI,22,82,9,19,28
18,8480049,Dylan Samberg,D,WPG,25,82,7,21,28
18,8483565,Nick Blankenburg,D,NSH,26,82,5,23,28
18,8476463,Jonas Brodin,D,MIN,31,82,4,24,28
18,8474574,Tyler Myers,D,VAN,34,82,1,27,28
18,8482077,Dylan Holloway,L,EDM,23,82,19,8,27
18,8477392,Hudson Fasching,R,NYI,29,82,17,10,27
18,8482079,Marco Rossi,C,MIN,23,82,15,12,27
18,8477903,Garnet Hathaway,R,PHI,33,82,14,13,27
18,8482062,Cole Smith,L,NSH,29,82,12,15,27
18,8478507,John Marino,D,UTA,27,82,4,23,27
18,8480878,Nils Lundkvist,D,DAL,24,82,3,24,27
18,8478851,Alexandre Carrier,D,NSH,28,82,2,25,27
18,8480893,Kirill Marchenko,R,CBJ,24,82,19,7,26
18,8479316,Luke Kunin,C,SJS,27,82,15,11,26
18,8475193,Tomas Tatar,L,NJD,34,82,15,11,26
18,8480074,Alexandre Texier,C,STL,25,82,14,12,26
18,8477953,Kasperi Kapanen,R,STL,28,82,12,14,26
18,8470621,Corey Perry,R,EDM,39,82,12,14,26
18,8482259,Bobby McMann,C,TOR,28,82,12,14,26
18,8476442,Matt Nieto,L,PIT,32,82,11,15,26
18,8478020,Michael Amadio,C,OTT,28,82,9,17,26
18,8477369,Carson Soucy,D,VAN,30,82,9,17,26
18,8483763,Maksymilian Szuber,D,UTA,22,82,8,18,26
18,8478133,Jake Evans,C,MTL,28,82,7,19,26
18,8479998,Mikey Anderson,D,LAK,25,82,5,21,26
18,8483490,Pavel Mintyukov,D,ANA,21,82,4,22,26
18,8476879,Cody Ceci,D,EDM,31,82,3,23,26
18,8482087,Kaiden Guhle,D,MTL,22,82,3,23,26
18,8474013,Ian Cole,D,UTA,35,82,3,23,26
18,8477969,Marcus Pettersson,D,PIT,28,82,2,24,26
18,8479976,Juuso Valimaki,D,UTA,26,82,1,25,26
18,8473507,Jeff Petry,D,DET,37,82,1,25,26
18,8479371,Dante Fabbro,D,NSH,26,82,1,25,26
18,8480813,Joe Veleno,C,DET,24,82,16,9,25
18,8476981,Josh Anderson,R,MTL,30,82,14,11,25
18,8480748,Kiefer Sherwood,L,VAN,29,82,10,15,25
18,8476918,Jimmy Vesey,L,NYR,31,82,10,15,25
18,8480144,David Kampf,C,TOR,29,82,10,15,25
18,8480980,Connor Dewar,C,TOR,25,82,10,15,25
18,8476931,Jake McCabe,D,TOR,31,82,6,19,25
18,8481553,Bobby Brink,R,PHI,23,82,4,21,25
18,8480043,Timothy Liljegren,D,TOR,25,82,3,22,25
18,8475690,Chris Tanev,D,TOR,35,82,3,22,25
18,8480035,Henri Jokiharju,D,BUF,25,82,3,22,25
18,8476331,Dylan DeMelo,D,WPG,31,82,2,23,25
18,8484145,Zach Benson,L,BUF,19,82,16,8,24
18,8478211,Dryden Hunt,L,CGY,29,82,15,9,24
18,8476897,Oskar Sundqvist,C,STL,30,82,12,12,24
18,8475220,Marcus Foligno,L,MIN,33,82,9,15,24
18,8477220,Nate Schmidt,D,FLA,33,82,6,18,24
18,8478178,Darren Raddysh,D,TBL,28,82,6,18,24
18,8475188,Brayden McNabb,D,VGK,33,82,5,19,24
18,8476329,Travis Boyd,C,MIN,31,82,4,20,24
18,8478840,Will Borgen,D,SEA,28,82,4,20,24
18,8475279,Ben Chiarot,D,DET,33,82,4,20,24
18,8470600,Ryan Suter,D,STL,39,82,1,23,24
18,8480281,Alexey Toropchenko,R,STL,25,82,16,7,23
18,8479368,Max Jones,L,BOS,26,82,15,8,23
18,8479359,Beck Malenstyn,L,BUF,26,82,12,11,23
18,8476278,Colin Blackwell,C,DAL,31,82,12,11,23
18,8473453,Trevor Lewis,C,LAK,37,82,11,12,23
18,8480003,Jesper Boqvist,C,FLA,26,82,10,13,23
18,8480855,Jack McBain,C,UTA,24,82,9,14,23
18,8476873,Mark Jankowski,C,NSH,30,82,9,14,23
18,8482807,Ethan Del Mastro,D,CHI,21,82,9,14,23
18,8484149,Gavin Brindley,C,CBJ,20,82,9,14,23
18,8477919,Frederick Gaudreau,C,MIN,31,82,8,15,23
18,8477499,Rasmus Ristolainen,D,PHI,30,82,8,15,23
18,8479402,Jake Bean,D,CGY,26,82,6,17,23
18,8482122,Brock Faber,D,MIN,22,82,6,17,23
18,8480222,Sebastian Aho,D,PIT,28,82,6,17,23
18,8479324,Ryan Lindgren,D,NYR,26,82,5,18,23
18,8480950,Ilya Lyubushkin,D,DAL,30,82,3,20,23
18,8474673,TJ Brodie,D,CHI,34,82,2,21,23
18,8480789,Oliver Wahlstrom,R,NYI,24,82,10,12,22
18,8481013,Jonatan Berggren,R,DET,24,82,10,12,22
18,8482733,Logan Mailloux,D,MTL,31,82,10,12,22
18,8483493,Frank Nazar,C,CHI,20,82,10,12,22
18,8475842,Sam Carrick,C,NYR,32,82,9,13,22
18,8476878,Zemgus Girgensons,L,TBL,30,82,8,14,22
18,8482470,Ilya Solovyov,D,CGY,24,82,7,15,22
18,8480796,Martin Fehervary,D,WSH,25,82,3,19,22
18,8475455,Brenden Dillon,D,NJD,34,82,2,20,22
18,8480025,MacKenzie Entwistle,R,FLA,25,82,13,8,21
18,8484153,Leo Carlsson,C,ANA,20,82,9,12,21
18,8477353,Tyler Motte,C,DET,29,82,9,12,21
18,8482073,Braden Schneider,D,NYR,23,82,5,16,21
18,8482858,Ryker Evans,D,SEA,23,82,5,16,21
18,8483482,Tristan Luneau,D,ANA,20,82,4,17,21
18,8477845,Trevor van Riemsdyk,D,WSH,33,82,4,17,21
18,8480073,Erik Brannstrom,D,COL,25,82,3,18,21
18,8477365,Connor Clifton,D,BUF,29,82,3,18,21
18,8480246,Nick Perbix,D,TBL,26,82,3,18,21
18,8480807,Mattias Samuelsson,D,BUF,24,82,2,19,21
18,8478432,Christian Fischer,R,DET,27,82,10,10,20
18,8477931,Tomas Nosek,L,FLA,32,82,8,12,20
18,8480172,Jan Rutta,D,SJS,34,82,7,13,20
18,8483460,David Jiricek,D,CBJ,21,82,7,13,20
18,8477505,Alexander Wennberg,C,SJS,30,82,6,14,20
18,8477488,Brett Pesce,D,NJD,30,82,5,15,20
18,8478443,Brandon Carlo,D,BOS,28,82,5,15,20
18,8480021,Jack Studnicka,C,LAK,25,82,10,9,19
18,8482679,Matt Coronato,R,CGY,22,82,9,10,19
18,8482666,Scott Morrow,D,CAR,22,82,8,11,19
18,8483495,Simon Nemec,D,NJD,20,82,7,12,19
18,8482141,Lukas Cormier,D,VGK,22,82,7,12,19
18,8482655,J.J. Moser,D,TBL,24,82,5,14,19
18,8475718,Justin Holl,D,DET,32,82,5,14,19
18,8475233,David Savard,D,MTL,34,82,3,16,19
18,8481708,Zac Jones,D,NYR,24,82,3,16,19
18,8478569,Noel Acciari,C,PIT,33,82,8,10,18
18,8483524,Shane Wright,C,SEA,20,82,8,10,18
18,8480185,Eetu Luostarinen,C,FLA,26,82,7,11,18
18,8481517,Brett Leason,R,ANA,25,82,7,11,18
18,8478434,Keegan Kolesar,R,VGK,27,82,6,12,18
18,8478136,Jake Middleton,D,MIN,28,82,6,12,18
18,8481605,Jackson LaCombe,D,ANA,23,82,6,12,18
18,8477507,Nikita Zadorov,D,BOS,29,82,5,13,18
18,8479980,Nicolas Hague,D,VGK,26,82,3,15,18
18,8482155,Alex Laferriere,R,LAK,23,82,12,5,17
18,8476858,Phillip Di Giuseppe,L,VAN,31,82,8,9,17
18,8484911,Collin Graf,R,SJS,22,82,7,10,17
18,8477938,Haydn Fleury,D,WPG,28,82,7,10,17
18,8475177,Calvin de Haan,D,COL,33,82,6,11,17
18,8482101,Danil Gushchin,L,SJS,22,82,6,11,17
18,8476889,Radek Faksa,C,STL,30,82,4,13,17
18,8476372,Nick Seeler,D,PHI,31,82,4,13,17
18,8477034,Jaycob Megna,D,FLA,32,82,4,13,17
18,8475462,Radko Gudas,D,ANA,34,82,3,14,17
18,8482245,Artem Zub,D,OTT,29,82,2,15,17
18,8483397,Marc McLaughlin,C,BOS,25,82,10,6,16
18,8476822,Luke Glendening,C,TBL,35,82,9,7,16
18,8484203,Bradly Nadeau,L,CAR,19,82,7,9,16
18,8483468,Jiri Kulich,C,BUF,20,82,5,11,16
18,8482145,Mavrik Bourque,C,DAL,22,82,5,11,16
18,8476891,Matt Grzelcyk,D,PIT,30,82,4,12,16
18,8477435,Ryan Graves,D,PIT,29,82,4,12,16
18,8481178,Egor Zamula,D,PHI,24,82,3,13,16
18,8483505,Matthew Poitras,C,BOS,20,82,3,13,16
18,8482762,Simon Edvinsson,D,DET,21,82,8,7,15
18,8479291,Kevin Rooney,C,CGY,31,82,8,7,15
18,8479442,Troy Stecher,D,EDM,30,82,6,9,15
18,8476374,Sean Kuraly,C,CBJ,31,82,5,10,15
18,8480834,Ty Emberson,D,SJS,24,82,5,10,15
18,8481567,Henry Thrun,D,SJS,23,82,4,11,15
18,8479576,Vincent Desharnais,D,VAN,28,82,4,11,15
18,8475324,Nick Jensen,D,OTT,34,82,3,12,15
18,8480860,Kevin Bahl,D,CGY,24,82,2,13,15
18,8476473,Connor Murphy,D,CHI,31,82,2,13,15
18,8477335,Kyle Burroughs,D,LAK,29,82,2,13,15
18,8483466,Kevin Korchinski,D,CHI,20,82,2,13,15
18,8476917,Adam Pelech,D,NYI,30,82,1,14,15
18,8474090,Brendan Smith,D,DAL,35,82,1,14,15
18,8479369,Andrew Peeke,D,BOS,26,82,0,15,15
18,8479638,Justin Brazeau,R,BOS,26,82,8,6,14
18,8482809,Jackson Blake,R,CAR,21,82,6,8,14
18,8481122,Simon Benoit,D,TOR,26,82,3,11,14
18,8478859,Niko Mikkola,D,FLA,28,82,1,13,14
18,8478416,Erik Cernak,D,TBL,27,82,1,13,14
18,8480870,Bo Groulx,C,NYR,24,82,7,6,13
18,8479414,Nathan Bastian,R,NJD,27,82,6,7,13
18,8483471,Brad Lambert,C,WPG,31,82,6,7,13
18,8475762,Derek Forbort,D,VAN,32,82,5,8,13
18,8476467,Jamie Oleksiak,D,SEA,32,82,4,9,13
18,8483499,Liam Ohgren,L,MIN,20,82,4,9,13
18,8476967,Brett Kulak,D,EDM,30,82,1,12,13
18,8478450,Parker Wotherspoon,D,BOS,27,82,1,12,13
18,8480448,Parker Kelly,L,COL,25,82,9,3,12
18,8480990,Declan Chisholm,D,MIN,24,82,8,4,12
18,8481524,Bowen Byram,D,BUF,23,82,8,4,12
18,8471677,Jack Johnson,D,CBJ,37,82,6,6,12
18,8483012,Logan Morrison,C,SEA,22,82,5,7,12
18,8482659,Josh Doan,R,UTA,22,82,4,8,12
18,8482859,Zack Ostapchuk,C,OTT,21,82,3,9,12
18,8482787,Nikita Chibrikov,R,WPG,31,82,3,9,12
18,8474567,Zach Bogosian,D,MIN,34,82,2,10,12
18,8481699,Aku Raty,R,UTA,23,82,6,5,11
18,8480879,Jacob Bernard-Docker,D,OTT,24,82,5,6,11
18,8482803,Olen Zellweger,D,ANA,21,82,4,7,11
18,8476429,Scott Mayfield,D,NYI,32,82,1,10,11
18,8482712,Oskar Olausson,R,COL,22,82,0,11,11
18,8481641,Joel Kiviranta,L,COL,28,82,5,5,10
18,8476441,Joel Edmundson,D,LAK,31,82,2,8,10
18,8482749,Joshua Roy,R,MTL,21,82,7,2,9
18,8482713,Mackie Samoskevich,R,FLA,22,82,5,4,9
18,8478468,Jeremy Lauzon,D,NSH,27,82,5,4,9
18,8482516,Matthew Kessel,D,STL,24,82,3,6,9
18,8482118,Sam Colangelo,R,ANA,23,82,3,6,9
18,8474612,Travis Hamonic,D,OTT,34,82,1,8,9
18,8474062,Riley Nash,C,NYR,35,82,3,5,8
18,8482153,Brendan Brisson,C,VGK,23,82,3,4,7
18,8483489,Fraser Minten,C,TOR,31,82,3,4,7
18,8478874,Adam Gaudette,C,OTT,28,82,0,6,6
18,8482070,Mitchell Chaffee,R,TBL,26,82,3,2,5
18,8483567,Georgii Merkulov,C,BOS,24,82,2,2,4
18,8470794,Joe Pavelski,C,,40,0,0,0,0
18,8481703,Valtteri Puustinen,R,PIT,25,0,0,0,0
18,8477950,Tony DeAngelo,D,,29,0,0,0,0
18,8481577,Philip Tomasino,C,NSH,23,0,0,0,0
18,8475197,Tyson Barrie,D,,33,0,0,0,0
18,8471218,Blake Wheeler,R,,38,0,0,0,0
18,8474157,Max Pacioretty,L,,36,0,0,0,0
18,8478466,Daniel Sprong,R,VAN,27,0,0,0,0
18,8475744,Evgeny Kuznetsov,C,,32,0,0,0,0
18,8481019,David Gustafsson,C,WPG,24,0,0,0,0
18,8475906,John Klingberg,D,,32,0,0,0,0
18,8479348,Kale Clague,D,BUF,26,0,0,0,0
18,8476952,Dominic Toninato,C,WPG,30,0,0,0,0
18,8473473,Milan Lucic,L,,36,0,0,0,0
18,8474037,James van Riemsdyk,L,,35,0,0,0,0
18,8474602,Justin Schultz,D,,34,0,0,0,0
18,8482222,Alexander Barabanov,L,,30,0,0,0,0
18,8479372,Josh Mahura,D,SEA,26,0,0,0,0
18,8479982,Conor Timmins,D,TOR,26,0,0,0,0
18,8474031,Kevin Shattenkirk,D,,35,0,0,0,0
18,8480008,Adam Ruzicka,C,,25,0,0,0,0
18,8481059,Scott Perunovich,D,STL,26,0,0,0,0
18,8480884,Calen Addison,D,,24,0,0,0,0
18,8476994,Vinnie Hinostroza,C,NSH,30,0,0,0,0
18,8478452,Caleb Jones,D,LAK,27,0,0,0,0
18,8480157,Calle Rosen,D,COL,30,0,0,0,0
18,8481609,Vladislav Kolyachonok,D,UTA,23,0,0,0,0
18,8479415,Michael McLeod,C,,26,0,0,0,0
18,8476919,Chris Tierney,C,,30,0,0,0,0
18,8479639,Dylan Coghlan,D,WPG,26,0,0,0,0
18,8478146,Matthew Highmore,C,OTT,28,0,0,0,0
18,8478970,Jalen Chatfield,D,CAR,28,0,0,0,0
18,8480205,Emil Bemstrom,C,PIT,25,0,0,0,0
18,8474884,Mike Hoffman,C,,35,0,0,0,0
18,8471274,Alex Goligoski,D,,39,0,0,0,0
18,8478104,Sammy Blais,L,,28,0,0,0,0
18,8474870,Tyler Johnson,C,,34,0,0,0,0
18,8476913,Devin Shore,C,MIN,30,0,0,0,0
18,8481598,Philip Broberg,D,EDM,23,0,0,0,0
18,8480058,Pierre-Olivier Joseph,D,STL,25,0,0,0,0
18,8480891,Michael Kesselring,D,UTA,24,0,0,0,0
18,8477979,Nicolas Aube-Kubel,R,BUF,28,0,0,0,0
18,8476871,Tanner Pearson,L,,32,0,0,0,0
18,8476393,Nick Cousins,C,,31,0,0,0,0
18,8479977,Kailer Yamamoto,R,,26,0,0,0,0
18,8479543,Michael Pezzetta,L,MTL,26,0,0,0,0
18,8477018,Ben Hutton,D,VGK,31,0,0,0,0
18,8480762,Eric Robinson,L,CAR,29,0,0,0,0
18,8474034,Pat Maroon,L,CHI,36,0,0,0,0
18,8481058,Jesse Ylönen,R,,25,0,0,0,0
18,8475179,Dmitry Kulikov,D,FLA,34,0,0,0,0
18,8481527,Kaedan Korczak,D,VGK,23,0,0,0,0
18,8473449,Kyle Okposo,R,,36,0,0,0,0
18,8482192,Isaak Phillips,D,CHI,23,0,0,0,0
18,8480727,Zach Whitecloud,D,VGK,28,0,0,0,0
18,8479346,Dillon Dube,C,,26,0,0,0,0
18,8480821,Filip Zadina,R,,25,0,0,0,0
18,8480001,Urho Vaakanainen,D,ANA,25,0,0,0,0
18,8470966,Mark Giordano,D,,41,0,0,0,0
18,8480853,Liam Foudy,C,,24,0,0,0,0
18,8475225,Craig Smith,C,CHI,35,0,0,0,0
18,8479972,Mason Shaw,C,WPG,26,0,0,0,0
18,8478451,Ethan Bear,D,WSH,27,0,0,0,0
18,8474040,Sam Gagner,C,,35,0,0,0,0
18,8480196,Jacob Bryson,D,BUF,27,0,0,0,0
18,8479984,Cal Foote,D,,26,0,0,0,0
18,8480011,Klim Kostin,C,SJS,25,0,0,0,0
18,8482176,Wyatt Kaiser,D,CHI,22,0,0,0,0
18,8476988,Matt Benning,D,SJS,30,0,0,0,0
18,8479370,Tyson Jost,C,CAR,26,0,0,0,0
18,8477464,Nic Petan,C,,29,0,0,0,0
18,8477380,Jonny Brodzinski,C,NYR,31,0,0,0,0
18,8480070,Ian Mitchell,D,BOS,25,0,0,0,0
18,8479315,Joey Anderson,R,CHI,26,0,0,0,0
18,8478099,Kevin Labanc,R,,29,0,0,0,0
18,8476874,Olli Maatta,D,DET,30,0,0,0,0
18,8475208,Brian Dumoulin,D,ANA,33,0,0,0,0
18,8478430,Oliver Kylington,D,,27,0,0,0,0
18,8479536,Axel Jonsson-Fjallby,L,WPG,26,0,0,0,0
18,8479671,Mathieu Olivier,R,CBJ,27,0,0,0,0
18,8471709,Marc-Edouard Vlasic,D,SJS,37,0,0,0,0
18,8479328,Julien Gauthier,R,NYI,27,0,0,0,0
18,8478421,A.J. Greer,L,FLA,28,0,0,0,0
18,8477573,Nathan Walker,L,STL,30,0,0,0,0
18,8481537,Nikita Okhotiuk,D,CGY,24,0,0,0,0
18,8474166,Alec Martinez,D,CHI,37,0,0,0,0
18,8470610,Zach Parise,L,,40,0,0,0,0
18,8477478,William Carrier,L,CAR,30,0,0,0,0
18,8479344,Jesse Puljujarvi,R,PIT,26,0,0,0,0
18,8480887,Jordan Harris,D,MTL,24,0,0,0,0
18,8478502,Dennis Gilbert,D,BUF,28,0,0,0,0
18,8482730,Brandt Clarke,D,LAK,21,0,0,0,0
18,8480355,Mark Kastelic,C,BOS,25,0,0,0,0
18,8475750,Jon Merrill,D,MIN,32,0,0,0,0
18,8475164,Jakob Silfverberg,R,,34,0,0,0,0
18,8477944,Jakub Vrana,L,,28,0,0,0,0
18,8479439,Jacob MacDonald,D,COL,31,0,0,0,0
18,8474568,Luke Schenn,D,NSH,35,0,0,0,0
18,8478454,Noah Juulsen,D,VAN,27,0,0,0,0
18,8475752,Tyler Pitlick,C,,33,0,0,0,0
18,8482148,Hendrix Lapierre,C,WSH,22,0,0,0,0
18,8481167,Brayden Pachal,D,CGY,25,0,0,0,0
18,8478043,Sam Lafferty,C,BUF,29,0,0,0,0
18,8479321,Lucas Johansen,D,,27,0,0,0,0
18,8471699,Andrew Cogliano,C,,37,0,0,0,0
18,8481521,Ronnie Attard,D,PHI,25,0,0,0,0
18,8481161,Jake Christiansen,D,CBJ,25,0,0,0,0
18,8479458,Nikita Zaitsev,D,,33,0,0,0,0
18,8479619,Michael Carcone,L,UTA,28,0,0,0,0
18,8479026,Philippe Myers,D,TOR,27,0,0,0,0
18,8477330,Dominik Kubalik,L,,29,0,0,0,0
18,8481617,Vasily Podkolzin,R,VAN,23,0,0,0,0
18,8481701,Santeri Hatakka,D,NJD,23,0,0,0,0
18,8479514,Rem Pitlick,C,,27,0,0,0,0
18,8477446,Michael McCarron,R,NSH,29,0,0,0,0
18,8470604,Jeff Carter,C,,39,0,0,0,0
18,8482241,Radim Zohorna,L,,28,0,0,0,0
18,8480289,Morgan Barron,C,WPG,26,0,0,0,0
18,8479379,Givani Smith,R,SJS,26,0,0,0,0
18,8480216,Jacob Peterson,C,,25,0,0,0,0
18,8477851,Jordan Oesterle,D,BOS,32,0,0,0,0
18,8484258,Sam Malinski,D,COL,26,0,0,0,0
18,8478904,Steven Lorentz,C,,28,0,0,0,0
18,8482095,Tyler Kleven,D,OTT,22,0,0,0,0
18,8480848,Ty Dellandrea,C,SJS,24,0,0,0,0
18,8476884,Derrick Pouliot,D,,30,0,0,0,0
18,8479336,Carl Grundstrom,R,SJS,27,0,0,0,0
18,8482964,Arber Xhekaj,D,MTL,23,0,0,0,0
18,8471686,Marc Staal,D,,37,0,0,0,0
18,8477887,Patrick Brown,C,BOS,32,0,0,0,0
18,8478495,Denis Gurianov,R,,27,0,0,0,0
18,8473504,Cal Clutterbuck,R,,37,0,0,0,0
18,8481550,Adam Beckman,L,NJD,23,0,0,0,0
18,8480845,Rasmus Kupari,C,WPG,24,0,0,0,0
18,8474009,Nick Bonino,C,,36,0,0,0,0
18,8478585,Derek Ryan,C,EDM,38,0,0,0,0
18,8477962,Brendan Lemieux,L,CAR,28,0,0,0,0
18,8482861,Vincent Iorio,D,WSH,22,0,0,0,0
18,8479378,Logan Stanley,D,WPG,26,0,0,0,0
18,8473446,Erik Johnson,D,PHI,36,0,0,0,0
18,8481743,Marc Del Gaizo,D,NSH,25,0,0,0,0
18,8477384,Josh Brown,D,EDM,30,0,0,0,0
18,8482165,Yan Kuznetsov,D,CGY,22,0,0,0,0
18,8478424,Jansen Harkins,C,ANA,27,0,0,0,0
18,8482144,Jack Thompson,D,SJS,22,0,0,0,0
18,8478512,Austin Czarnik,C,,32,0,0,0,0
18,8477527,Ross Johnston,L,ANA,30,0,0,0,0
18,8479383,Boris Katchouk,L,,26,0,0,0,0
18,8482094,Daemon Hunt,D,MIN,22,0,0,0,0
18,8481719,Maxwell Crozier,D,TBL,24,0,0,0,0
18,8480192,Johnathan Kovacevic,D,NJD,27,0,0,0,0
18,8479376,Victor Mete,D,,26,0,0,0,0
18,8482511,Mason Lohrei,D,BOS,23,0,0,0,0
18,8475825,Jani Hakanpää,D,,32,0,0,0,0
18,8478021,William Lagesson,D,DET,28,0,0,0,0
18,8475795,Dylan McIlrath,D,WSH,32,0,0,0,0
18,8477846,Ryan Carpenter,C,,33,0,0,0,0
18,8481056,Spencer Stastney,D,NSH,24,0,0,0,0
18,8481564,Ryan Johnson,D,BUF,23,0,0,0,0
18,8478017,Mark Friedman,D,VAN,29,0,0,0,0
18,8479320,Max Lajoie,D,SEA,27,0,0,0,0
18,8480075,Cameron Crotty,D,MIN,25,0,0,0,0
18,8484287,Cole McWard,D,VAN,23,0,0,0,0
18,8484254,Akito Hirose,D,VAN,25,0,0,0,0
18,8483407,Brandon Scanlin,D,NYR,25,0,0,0,0
18,8480274,Philip Kemp,D,EDM,25,0,0,0,0
18,8479522,Hardy Haman Aktell,D,WSH,26,0,0,0,0
18,8480007,Jonas Rondbjerg,R,VGK,25,0,0,0,0
18,8477454,Adam Erne,L,,29,0,0,0,0
18,8481679,Maxence Guenette,D,OTT,23,0,0,0,0
18,8480441,Trey Fix-Wolansky,R,CBJ,25,0,0,0,0
18,8483546,Marshall Rifai,D,TOR,26,0,0,0,0
18,8480084,Nick DeSimone,D,NJD,30,0,0,0,0
18,8481030,Jack St. Ivany,D,PIT,25,0,0,0,0
18,8481592,Jakob Pelletier,L,CGY,23,0,0,0,0
18,8478011,Louie Belpedio,D,PHI,28,0,0,0,0
18,8477930,Pierre-Edouard Bellemare,L,,39,0,0,0,0
18,8484321,Nikolas Matinpalo,D,OTT,26,0,0,0,0
18,8482067,Connor Mackey,D,NYR,28,0,0,0,0
18,8481806,Louis Crevier,D,CHI,23,0,0,0,0
18,8484326,Patrik Koch,D,UTA,28,0,0,0,0
18,8477971,Andreas Englund,D,LAK,28,0,0,0,0
18,8481751,Lukas Rousek,R,BUF,25,0,0,0,0
18,8481006,Tyler Tucker,D,STL,24,0,0,0,0
18,8476867,Brendan Gaunce,C,MIN,30,0,0,0,0
18,8479520,Brandon Duhaime,R,WSH,27,0,0,0,0
18,8477073,Kurtis MacDermid,L,NJD,30,0,0,0,0
18,8480874,Adam Ginning,D,PHI,24,0,0,0,0
18,8477473,Justin Bailey,R,SJS,29,0,0,0,0
18,8479066,Ryan Lomberg,L,CGY,30,0,0,0,0
18,8477070,Liam O'Brien,C,UTA,30,0,0,0,0
18,8474618,Marco Scandella,D,,34,0,0,0,0
18,8475797,Jarred Tinordi,D,,32,0,0,0,0
18,8481441,Joe Snively,C,DET,28,0,0,0,0
18,8477244,Chad Ruhwedel,D,NYR,34,0,0,0,0
18,8479772,Zack MacEwen,R,OTT,28,0,0,0,0
18,8481147,Reese Johnson,C,MIN,26,0,0,0,0
18,8481043,Cole Koepke,L,BOS,26,0,0,0,0
18,8483619,Filip Roos,D,OTT,25,0,0,0,0
18,8481541,Samuel Bolduc,D,NYI,24,0,0,0,0
18,8477810,Joel Hanley,D,CGY,33,0,0,0,0
18,8476907,Mackenzie MacEachern,L,,30,0,0,0,0
18,8482652,Walker Duehr,R,CGY,27,0,0,0,0
18,8477126,Jayson Megna,C,,34,0,0,0,0
18,8483398,Declan Carlile,D,TBL,31,0,0,0,0
18,8482929,Emil Lilleberg,D,TBL,23,0,0,0,0
18,8480880,Jakub Lauko,C,MIN,24,0,0,0,0
18,8480245,Olle Lycksell,R,PHI,25,0,0,0,0
18,8480252,Cole Guttman,C,CHI,25,0,0,0,0
18,8477467,Gustav Olofsson,D,SEA,30,0,0,0,0
18,8479968,Vinni Lettieri,C,BOS,29,0,0,0,0
18,8478400,Colin White,C,,27,0,0,0,0
18,8475755,Alexander Petrovic,D,DAL,32,0,0,0,0
18,8481812,Nikolai Knyzhov,D,,27,0,0,0,0
18,8481593,Jayden Struble,D,MTL,23,0,0,0,0
18,8481532,Alex Turcotte,C,LAK,23,0,0,0,0
18,8482126,Emil Andrae,D,PHI,31,0,0,0,0
18,8479944,Zach Aston-Reese,C,VGK,30,0,0,0,0
18,8471817,Ryan Reaves,R,TOR,37,0,0,0,0
18,8481206,John Ludvig,D,PIT,24,0,0,0,0
18,8481599,Victor Soderstrom,D,UTA,23,0,0,0,0
18,8480292,Carson Meyer,R,ANA,27,0,0,0,0
18,8482496,Nils Aman,C,VAN,24,0,0,0,0
18,8479718,Alex Barré-Boulet,C,MTL,27,0,0,0,0
18,8479994,Jaret Anderson-Dolan,C,WPG,25,0,0,0,0
18,8480184,Gustav Lindstrom,D,,26,0,0,0,0
18,8480890,Jan Jenik,R,OTT,24,0,0,0,0
18,8478067,Oskar Lindblom,L,,28,0,0,0,0
18,8476934,Brock McGinn,L,ANA,30,0,0,0,0
18,8479985,Cale Fleury,D,SEA,26,0,0,0,0
18,8484304,Uvis Balinskis,D,FLA,28,0,0,0,0
18,8479981,Jonah Gadjovich,L,FLA,26,0,0,0,0
18,8481716,Dmitri Voronkov,L,CBJ,24,0,0,0,0
18,8474709,Matt Martin,L,,35,0,0,0,0
18,8482634,Alex Steeves,C,TOR,25,0,0,0,0
18,8480823,Alexander Alexeyev,D,WSH,25,0,0,0,0
18,8477541,Dakota Mermis,D,TOR,30,0,0,0,0
18,8483491,Ivan Miroshnichenko,L,WSH,20,0,0,0,0
18,8478477,Mitchell Stephens,C,SEA,27,0,0,0,0
18,8481543,Nikita Alexandrov,C,STL,24,0,0,0,0
18,8479423,Alex Nylander,L,,26,0,0,0,0
18,8482451,Mikael Pyyhtia,L,CBJ,23,0,0,0,0
18,8478831,Kevin Stenlund,C,UTA,28,0,0,0,0
18,8480306,Grant Hutton,D,NYI,29,0,0,0,0
18,8478028,Fredrik Olofsson,L,,28,0,0,0,0
18,8477462,Robert Hagg,D,VGK,29,0,0,0,0
18,8477320,Anton Blidh,L,NYR,29,0,0,0,0
18,8482157,Will Cuylle,L,NYR,22,0,0,0,0
18,8482737,Zack Bolduc,C,STL,21,0,0,0,0
18,8481239,Samuel Fagemo,L,,24,0,0,0,0
18,8481600,Tobias Bjornfot,D,FLA,23,0,0,0,0
18,8478409,Anthony Richard,C,PHI,28,0,0,0,0
18,8474145,Robert Bortuzzo,D,,35,0,0,0,0
18,8475958,Michael Sgarbossa,C,WSH,32,0,0,0,0
18,8479986,Kole Lind,R,DAL,26,0,0,0,0
18,8479249,Andrew Poturalski,C,SJS,30,0,0,0,0
18,8479362,Riley Tufte,L,BOS,26,0,0,0,0
18,8479991,Jake Leschyshyn,C,NYR,25,0,0,0,0
18,8479587,Rhett Gardner,C,PHI,28,0,0,0,0
18,8482744,James Malatesta,L,CBJ,21,0,0,0,0
18,8478854,Ryan Shea,D,PIT,27,0,0,0,0
18,8481591,Sam Poulin,R,,23,0,0,0,0
18,8483512,Matt Savoie,C,EDM,20,0,0,0,0
18,8482102,Vasily Ponomarev,C,PIT,22,0,0,0,0
18,8482162,Roby Jarventie,L,EDM,22,0,0,0,0
18,8481016,Ruslan Iskhakov,C,,24,0,0,0,0
18,8482172,Landon Slaggert,L,CHI,22,0,0,0,0
18,8482747,Brennan Othmann,L,NYR,21,0,0,0,0
18,8480031,Maxime Comtois,L,,25,0,0,0,0
18,8480226,Marián Studenic,R,,26,0,0,0,0
18,8478408,Travis Dermott,D,,28,0,0,0,0
18,8481518,Nolan Foote,L,NJD,24,0,0,0,0
18,8479419,Brett Murray,L,BUF,26,0,0,0,0
18,8482088,Justin Sourdif,R,FLA,22,0,0,0,0
18,8482201,Gage Goncalves,C,TBL,23,0,0,0,0
18,8481578,Graeme Clarke,R,MIN,23,0,0,0,0
18,8482177,Marat Khusnutdinov,C,MIN,22,0,0,0,0
18,8481754,Nikita Nesterenko,C,ANA,23,0,0,0,0
18,8483531,Brian Halonen,L,NJD,25,0,0,0,0
18,8483920,Pierrick Dube,R,WSH,23,0,0,0,0
18,8480851,Akil Thomas,C,LAK,24,0,0,0,0
18,8475235,Nicolas Deslauriers,L,PHI,33,0,0,0,0
18,8482476,Emil Heineman,L,MTL,23,0,0,0,0
18,8477149,Scott Sabourin,R,SJS,32,0,0,0,0
18,8483549,Lucas Condotta,L,MTL,27,0,0,0,0
18,8482765,Isak Rosen,R,BUF,21,0,0,0,0
18,8481237,Kyle MacLean,C,NYI,25,0,0,0,0
18,8481024,Linus Karlsson,C,VAN,25,0,0,0,0
18,8481690,Tyler Angle,C,,24,0,0,0,0
18,8483570,Ben Meyers,C,SEA,26,0,0,0,0
18,8481655,Cole Schwindt,R,CGY,23,0,0,0,0
18,8481462,Mason Morelli,L,VGK,28,0,0,0,0
18,8483401,Marc Johnstone,R,PIT,28,0,0,0,0
18,8478956,Samuel Laberge,L,NJD,27,0,0,0,0
18,8479533,Joona Koppanen,L,,26,0,0,0,0
18,8482197,Adam Raska,R,MIN,23,0,0,0,0
18,8482250,Callahan Burke,C,VGK,27,0,0,0,0
18,8482784,Zach Dean,C,STL,21,0,0,0,0
18,8484255,Jason Polin,R,COL,25,0,0,0,0
18,8481077,John Leonard,L,,26,0,0,0,0
18,8481534,Raphael Lavoie,C,EDM,24,0,0,0,0
18,8483609,Adam Klapka,R,CGY,24,0,0,0,0
18,8482751,Ryan Winterton,C,SEA,21,0,0,0,0
18,8480267,Sammy Walker,C,MIN,25,0,0,0,0
18,8475766,Austin Watson,L,,32,0,0,0,0
18,8482460,Matt Rempe,C,NYR,22,0,0,0,0
18,8481065,Angus Crookshank,L,OTT,25,0,0,0,0
18,8481070,Hugh McGing,L,,26,0,0,0,0
18,8476323,Max McCormick,L,SEA,32,0,0,0,0
18,8483395,Arshdeep Bains,L,VAN,23,0,0,0,0
18,8484259,Ondrej Pavel,C,COL,31,0,0,0,0
18,8483432,Luca Del Bel Belluz,C,CBJ,31,0,0,0,0
18,8483045,Cameron Butler,R,CBJ,31,0,0,0,0
18,8482061,Brandon Biro,L,SEA,26,0,0,0,0
18,8477401,John Hayden,C,SEA,29,0,0,0,0
18,8475278,Byron Froese,C,,33,0,0,0,0
18,8478446,Glenn Gawdin,C,LAK,27,0,0,0,0
18,8477993,Justin Kirkland,C,CGY,28,0,0,0,0
18,8482147,Jean-Luc Foudy,C,COL,22,0,0,0,0
18,8480032,Shane Bowers,C,NJD,25,0,0,0,0
18,8479330,Brandon Gignac,C,MTL,27,0,0,0,0
18,8480776,Sheldon Rempal,R,,29,0,0,0,0
18,8475413,Justin Dowling,C,NJD,34,0,0,0,0
18,8481726,Adam Edstrom,C,NYR,24,0,0,0,0
18,8480844,Grigori Denisenko,L,VGK,24,0,0,0,0
18,8478147,Bokondji Imama,L,PIT,28,0,0,0,0
18,8478881,Brett Seney,L,CHI,28,0,0,0,0
18,8483630,Pavol Regenda,L,ANA,25,0,0,0,0
18,8480836,Jonathan Gruden,C,,24,0,0,0,0
18,8484314,Jiri Smejkal,L,,28,0,0,0,0
18,8475780,Chris Wagner,R,COL,33,0,0,0,0
18,8479546,Oskar Steen,C,,26,0,0,0,0
18,8483597,Milos Kelemen,L,UTA,25,0,0,0,0
18,8481789,Tye Kartye,L,SEA,23,0,0,0,0
18,8484325,Waltteri Merela,C,TBL,26,0,0,0,0
18,8479421,Jacob Moverare,D,LAK,26,0,0,0,0
18,8481585,Egor Afanasyev,L,SJS,23,0,0,0,0
18,8479547,Matthew Phillips,R,,26,0,0,0,0
18,8479367,William Lockwood,R,FLA,26,0,0,0,0
18,8476915,Jujhar Khaira,L,,30,0,0,0,0
18,8481422,Jacob Lucchini,C,NSH,29,0,0,0,0
18,8480468,James Hamblin,L,EDM,25,0,0,0,0
18,8478051,Max Willman,C,NJD,29,0,0,0,0
18,8481556,John Beecher,C,BOS,23,0,0,0,0
18,8478078,Rourke Chartier,C,,28,0,0,0,0
19,8478402,Connor McDavid,C,EDM,27,82,35,107,142
19,8477492,Nathan MacKinnon,C,COL,29,82,50,77,127
19,8476453,Nikita Kucherov,R,TBL,31,82,41,86,127
19,8478864,Kirill Kaprizov,L,MIN,27,82,53,64,117
19,8477934,Leon Draisaitl,C,EDM,29,82,52,58,110
19,8477956,David Pastrnak,R,BOS,28,82,52,57,109
19,8478403,Jack Eichel,C,VGK,28,82,46,62,108
19,8479314,Matthew Tkachuk,L,FLA,27,82,31,75,106
19,8471675,Sidney Crosby,C,PIT,37,82,40,63,103
19,8478550,Artemi Panarin,L,NYR,33,82,36,65,101
19,8481559,Jack Hughes,C,NJD,23,82,39,61,100
19,8476468,J.T. Miller,C,VAN,31,82,28,72,100
19,8480069,Cale Makar,D,COL,26,82,34,65,99
19,8476454,Ryan Nugent-Hopkins,C,EDM,31,82,29,70,99
19,8477493,Aleksander Barkov,C,FLA,29,82,23,76,99
19,8480002,Nico Hischier,C,NJD,25,82,37,60,97
19,8480023,Robert Thomas,C,STL,25,82,22,75,97
19,8477939,William Nylander,R,TOR,28,82,46,49,95
19,8480012,Elias Pettersson,C,VAN,26,82,31,63,94
19,8482116,Tim Stützle,C,OTT,22,82,30,64,94
19,8480801,Brady Tkachuk,L,OTT,25,82,40,53,93
19,8477960,Adrian Kempe,R,LAK,28,82,49,43,92
19,8479385,Jordan Kyrou,C,STL,26,82,45,47,92
19,8476389,Vincent Trocheck,C,NYR,31,82,38,54,92
19,8478398,Kyle Connor,L,WPG,28,82,40,51,91
19,8478420,Mikko Rantanen,R,COL,28,82,37,54,91
19,8476887,Filip Forsberg,L,NSH,30,82,47,43,90
19,8479343,Clayton Keller,R,UTA,26,82,39,50,89
19,8479407,Jesper Bratt,L,NJD,26,82,27,62,89
19,8478414,Timo Meier,R,NJD,28,82,44,44,88
19,8479318,Auston Matthews,C,TOR,27,82,43,44,87
19,8477946,Dylan Larkin,C,DET,28,82,35,51,86
19,8477402,Pavel Buchnevich,L,STL,29,82,31,55,86
19,8478439,Travis Konecny,R,PHI,27,82,38,47,85
19,8477409,Carter Verhaeghe,C,FLA,29,82,37,48,85
19,8480027,Jason Robertson,L,DAL,25,82,35,50,85
19,8477504,Josh Morrissey,D,WPG,29,82,18,67,85
19,8480800,Quinn Hughes,D,VAN,25,82,11,74,85
19,8479323,Adam Fox,D,NYR,26,82,8,77,85
19,8474564,Steven Stamkos,C,NSH,34,82,37,47,84
19,8475692,Mats Zuccarello,R,MIN,37,82,21,63,84
19,8481523,Kirby Dach,C,MTL,23,82,12,72,84
19,8476539,Jonathan Marchessault,R,NSH,34,82,42,41,83
19,8479420,Tage Thompson,C,BUF,27,82,42,40,82
19,8475172,Nazem Kadri,C,CGY,34,82,31,51,82
19,8475913,Mark Stone,R,VGK,32,82,24,58,82
19,8476460,Mark Scheifele,C,WPG,31,82,36,45,81
19,8477933,Sam Reinhart,C,FLA,29,82,34,47,81
19,8474600,Roman Josi,D,NSH,34,82,17,64,81
19,8476881,Tomas Hertl,C,VGK,31,82,37,43,80
19,8482093,Seth Jarvis,C,CAR,22,82,37,43,80
19,8477942,Kevin Fiala,L,LAK,28,82,31,48,79
19,8474590,John Carlson,D,WSH,34,82,12,67,79
19,8478427,Sebastian Aho,C,CAR,27,82,36,42,78
19,8477951,Nick Schmaltz,C,UTA,28,82,31,47,78
19,8478445,Mathew Barzal,C,NYI,27,82,11,67,78
19,8471214,Alex Ovechkin,L,WSH,39,82,39,38,77
19,8476346,Johnny Gaudreau,L,CBJ,31,82,15,62,77
19,8480015,Owen Tippett,R,PHI,25,82,35,41,76
19,8480208,Drake Batherson,R,OTT,26,82,35,40,75
19,8481528,Dylan Cozens,C,BUF,23,82,33,42,75
19,8475184,Chris Kreider,L,NYR,33,82,51,23,74
19,8475166,John Tavares,C,TOR,34,82,33,41,74
19,8478449,Roope Hintz,C,DAL,28,82,32,42,74
19,8474141,Patrick Kane,R,DET,36,82,32,42,74
19,8475810,Bryan Rust,R,PIT,32,82,33,40,73
19,8478010,Brayden Point,C,TBL,28,82,30,43,73
19,8480830,Andrei Svechnikov,R,CAR,24,82,28,45,73
19,8475798,Mikael Granlund,C,SJS,32,82,16,57,73
19,8477404,Jake Guentzel,C,TBL,30,82,37,35,72
19,8477949,Alex Tuch,R,BUF,28,82,32,40,72
19,8479337,Alex DeBrincat,R,DET,27,82,30,42,72
19,8478042,Viktor Arvidsson,R,EDM,31,82,27,45,72
19,8473419,Brad Marchand,L,BOS,36,82,25,47,72
19,8474578,Erik Karlsson,D,PIT,34,82,21,51,72
19,8478460,Zach Werenski,D,CBJ,27,82,19,53,72
19,8482684,Luke Hughes,D,NJD,21,82,13,59,72
19,8477501,Valeri Nichushkin,R,COL,29,82,37,34,71
19,8481557,Matt Boldy,L,MIN,23,82,32,39,71
19,8477476,Artturi Lehkonen,L,COL,29,82,31,40,71
19,8478047,Michael Bunting,L,PIT,29,82,28,43,71
19,8477940,Nikolaj Ehlers,L,WPG,28,82,23,48,71
19,8479410,Mikhail Sergachev,D,UTA,26,82,13,58,71
19,8475784,Jeff Skinner,C,EDM,32,82,38,32,70
19,8478975,Mason Marchment,L,DAL,29,82,29,41,70
19,8478038,Devon Toews,D,COL,30,82,23,47,70
19,8477500,Bo Horvat,C,NYI,29,82,33,35,68
19,8479542,Brandon Hagel,L,TBL,26,82,33,35,68
19,8475170,Brayden Schenn,C,STL,33,82,27,41,68
19,8480839,Rasmus Dahlin,D,BUF,24,82,24,44,68
19,8471685,Anze Kopitar,C,LAK,37,82,21,47,68
19,8476853,Morgan Rielly,D,TOR,30,82,6,62,68
19,8477935,Sam Bennett,C,FLA,28,82,35,32,67
19,8478873,Troy Terry,R,ANA,27,82,28,39,67
19,8471215,Evgeni Malkin,C,PIT,38,82,26,41,67
19,8478440,Dylan Strome,C,WSH,27,82,23,44,67
19,8477497,Sean Monahan,C,CBJ,30,82,23,44,67
19,8480014,Gabriel Vilardi,C,WPG,25,82,43,23,66
19,8475726,Tyler Toffoli,C,SJS,32,82,28,38,66
19,8475158,Ryan O'Reilly,C,NSH,33,82,27,39,66
19,8478856,Conor Garland,R,VAN,28,82,25,41,66
19,8481533,Trevor Zegras,C,ANA,23,82,25,40,65
19,8476456,Jonathan Huberdeau,C,CGY,31,82,18,47,65
19,8475786,Zach Hyman,L,EDM,32,82,30,34,64
19,8482113,Anton Lundell,C,FLA,23,82,27,37,64
19,8473512,Claude Giroux,R,OTT,36,82,23,41,64
19,8476459,Mika Zibanejad,C,NYR,31,82,23,41,64
19,8478444,Brock Boeser,R,VAN,27,82,21,43,64
19,8474565,Alex Pietrangelo,D,VGK,34,82,16,48,64
19,8480803,Evan Bouchard,D,EDM,25,82,15,49,64
19,8477955,Jared McCann,L,SEA,28,82,34,29,63
19,8476448,William Karlsson,C,VGK,31,82,28,34,62
19,8477447,Shea Theodore,D,VGK,29,82,7,55,62
19,8476432,Boone Jenner,C,CBJ,31,82,33,28,61
19,8482097,Jack Quinn,R,BUF,23,82,25,36,61
19,8478407,Vince Dunn,D,SEA,28,82,8,53,61
19,8475169,Evander Kane,L,EDM,33,82,34,26,60
19,8475754,Brock Nelson,C,NYI,33,82,28,32,60
19,8471698,T.J. Oshie,R,WSH,38,82,27,33,60
19,8478401,Pavel Zacha,C,BOS,27,82,23,37,60
19,8481711,Matias Maccelli,L,UTA,24,82,17,43,60
19,8478493,Joel Eriksson Ek,C,MIN,27,82,25,34,59
19,8480039,Martin Necas,C,CAR,25,82,23,36,59
19,8477494,Jonathan Drouin,L,COL,29,82,14,45,59
19,8477407,Anthony Duclair,L,NYI,29,82,31,27,58
19,8473986,Alex Killorn,L,ANA,35,82,30,28,58
19,8479400,Pierre-Luc Dubois,L,WSH,26,82,25,33,58
19,8482665,Matty Beniers,C,SEA,22,82,23,35,58
19,8475765,Vladimir Tarasenko,R,DET,33,82,23,35,58
19,8473994,Jamie Benn,L,DAL,35,82,23,35,58
19,8482109,Alexis Lafrenière,L,NYR,23,82,22,36,58
19,8475763,Kevin Hayes,R,PIT,32,82,22,36,58
19,8480865,Noah Dobson,D,NYI,24,82,7,51,58
19,8478542,Evan Rodrigues,C,FLA,31,82,31,26,57
19,8476875,Mike Matheson,D,MTL,30,82,19,38,57
19,8480018,Nick Suzuki,C,MTL,25,82,17,40,57
19,8476880,Tom Wilson,R,WSH,30,82,31,25,56
19,8480064,Josh Norris,C,OTT,25,82,28,28,56
19,8479999,Casey Mittelstadt,C,COL,26,82,23,33,56
19,8478233,Andrew Mangiapane,L,WSH,28,82,18,38,56
19,8475167,Victor Hedman,D,TBL,34,82,13,43,56
19,8478519,Anthony Cirelli,C,TBL,27,82,26,29,55
19,8482078,Lucas Raymond,L,DET,22,82,19,36,55
19,8478438,Tommy Novak,C,NSH,27,82,18,37,55
19,8477932,Aaron Ekblad,D,FLA,28,82,18,37,55
19,8476872,Scott Laughton,C,PHI,30,82,18,37,55
19,8476792,Torey Krug,D,STL,33,82,17,38,55
19,8482124,Quinton Byfield,R,LAK,22,82,15,40,55
19,8470613,Brent Burns,D,CAR,39,82,14,41,55
19,8476906,Shayne Gostisbehere,D,CAR,31,82,13,42,55
19,8476483,Rickard Rakell,R,PIT,31,82,31,23,54
19,8479339,Patrik Laine,L,CBJ,26,82,30,24,54
19,8477964,Ivan Barbashev,C,VGK,29,82,28,26,54
19,8476882,Teuvo Teravainen,L,CHI,30,82,23,31,54
19,8480835,Jack Drury,C,CAR,24,82,23,31,54
19,8480028,Morgan Frost,C,PHI,25,82,20,34,54
19,8482159,Tyson Foerster,R,PHI,22,82,19,35,54
19,8477495,Seth Jones,D,CHI,30,82,17,37,54
19,8480036,Miro Heiskanen,D,DAL,25,82,8,46,54
19,8478498,Jake DeBrusk,L,VAN,28,82,30,23,53
19,8481068,Yegor Sharangovich,C,CGY,26,82,27,26,53
19,8482745,Mason McTavish,C,ANA,21,82,26,27,53
19,8478366,Frank Vatrano,R,ANA,30,82,23,30,53
19,8479675,Trevor Moore,L,LAK,29,82,23,30,53
19,8480188,Fabian Zetterlund,L,SJS,25,82,22,31,53
19,8476479,Phillip Danault,C,LAK,31,82,21,32,53
19,8475168,Matt Duchene,C,DAL,33,82,20,33,53
19,8474586,Jordan Eberle,R,SEA,34,82,20,33,53
19,8480078,Filip Chytil,C,NYR,25,82,18,35,53
19,8477498,Darnell Nurse,D,EDM,29,82,16,37,53
19,8474563,Drew Doughty,D,LAK,35,82,15,38,53
19,8481546,Cam York,D,PHI,23,82,14,39,53
19,8479425,Filip Hronek,D,VAN,27,82,12,41,53
19,8474679,Gustav Nyquist,C,NSH,35,82,10,43,53
19,8477479,Tyler Bertuzzi,L,CHI,29,82,28,24,52
19,8478462,Nicolas Roy,C,VGK,27,82,24,28,52
19,8474641,Adam Henrique,C,EDM,34,82,20,32,52
19,8480798,Philipp Kurashev,C,CHI,25,82,18,34,52
19,8477416,Oliver Bjorkstrand,R,SEA,29,82,17,35,52
19,8476399,Blake Coleman,C,CGY,33,82,25,26,51
19,8475794,Tyler Seguin,C,DAL,32,82,22,29,51
19,8474102,David Perron,L,OTT,36,82,18,33,51
19,8478396,Noah Hanifin,D,VGK,27,82,15,36,51
19,8476458,Ryan Strome,C,ANA,31,82,13,38,51
19,8478469,Thomas Chabot,D,OTT,27,82,11,40,51
19,8482740,Wyatt Johnston,C,DAL,21,82,31,19,50
19,8477021,Alex Kerfoot,C,UTA,30,82,26,24,50
19,8475191,Reilly Smith,R,NYR,33,82,23,27,50
19,8474150,Mikael Backlund,C,CGY,35,82,13,37,50
19,8482671,Owen Power,D,BUF,22,82,11,39,50
19,8482699,Dylan Guenther,R,UTA,21,82,25,24,49
19,8480459,Pius Suter,C,VAN,28,82,24,25,49
19,8484144,Connor Bedard,C,CHI,19,82,23,26,49
19,8480434,Sean Durzi,D,UTA,26,82,12,37,49
19,8476905,Chandler Stephenson,C,SEA,30,82,9,40,49
19,8480748,Kiefer Sherwood,L,VAN,29,82,26,22,48
19,8478474,Lawson Crouse,L,UTA,27,82,23,25,48
19,8482667,William Eklund,L,SJS,22,82,22,26,48
19,8482146,Luke Evangelista,R,NSH,22,82,20,28,48
19,8476292,Ondrej Palat,L,NJD,33,82,16,32,48
19,8481542,Moritz Seider,D,DET,23,82,4,44,48
19,8474189,Lars Eller,C,PIT,35,82,24,23,47
19,8482110,Dawson Mercer,C,NJD,23,82,23,24,47
19,8480797,Joel Farabee,L,PHI,24,82,22,25,47
19,8478458,Jack Roslovic,C,CAR,27,82,19,28,47
19,8477444,Andre Burakovsky,L,SEA,29,82,18,29,47
19,8476462,Dougie Hamilton,D,NJD,31,82,15,32,47
19,8477429,Andrew Copp,C,DET,30,82,14,33,47
19,8482149,Cole Perfetti,C,WPG,22,82,14,33,47
19,8479345,Jakob Chychrun,D,WSH,26,82,12,35,47
19,8477969,Marcus Pettersson,D,PIT,28,82,3,44,47
19,8475799,Nino Niederreiter,R,WPG,32,82,28,18,46
19,8476438,Brandon Saad,L,STL,32,82,27,19,46
19,8475768,Jaden Schwartz,C,SEA,32,82,22,24,46
19,8480849,Barrett Hayton,C,UTA,24,82,22,24,46
19,8478115,Pierre Engvall,L,NYI,28,82,21,25,46
19,8475722,Jason Zucker,L,BUF,32,82,19,27,46
19,8477496,Elias Lindholm,C,BOS,30,82,16,30,46
19,8475287,Erik Haula,L,NJD,33,82,15,31,46
19,8479390,Taylor Raddysh,R,WSH,26,82,14,32,46
19,8476869,Brady Skjei,D,NSH,30,82,13,33,46
19,8476960,Andreas Athanasiou,C,CHI,30,82,19,26,45
19,8481596,Shane Pinto,C,OTT,24,82,16,29,45
19,8477987,Ryan Donato,C,CHI,28,82,15,30,45
19,8476958,Jaccob Slavin,D,CAR,30,82,6,39,45
19,8476892,Colton Parayko,D,STL,31,82,5,40,45
19,8475760,Nick Bjugstad,C,UTA,32,82,21,23,44
19,8481618,Alex Newhook,C,MTL,23,82,19,25,44
19,8482055,Drew O'Connor,L,PIT,26,82,19,25,44
19,8482660,Kent Johnson,C,CBJ,22,82,19,25,44
19,8475745,Charlie Coyle,C,BOS,32,82,18,26,44
19,8477986,Brandon Montour,D,SEA,30,82,15,29,44
19,8475218,Mattias Ekholm,D,EDM,34,82,13,31,44
19,8478891,Mason Appleton,C,WPG,28,82,13,31,44
19,8471724,Kris Letang,D,PIT,37,82,8,36,44
19,8479525,Ross Colton,C,COL,28,82,24,19,43
19,8481540,Cole Caufield,R,MTL,23,82,19,24,43
19,8479325,Charlie McAvoy,D,BOS,27,82,15,28,43
19,8473563,Nicklas Backstrom,C,WSH,37,82,15,28,43
19,8482705,Cole Sillinger,C,CBJ,21,82,14,29,43
19,8474716,Jared Spurgeon,D,MIN,35,82,13,30,43
19,8478397,Rasmus Andersson,D,CGY,28,82,11,32,43
19,8483808,Andrei Kuzmenko,L,CGY,28,82,19,23,42
19,8477426,Nicholas Paul,L,TBL,29,82,19,23,42
19,8480185,Eetu Luostarinen,C,FLA,26,82,18,24,42
19,8476927,Teddy Blueger,C,VAN,30,82,17,25,42
19,8476925,Colton Sissons,C,NSH,31,82,17,25,42
19,8477456,J.T. Compher,L,DET,29,82,16,26,42
19,8476826,Yanni Gourde,C,SEA,33,82,16,26,42
19,8478472,Mathieu Joseph,R,STL,27,82,14,28,42
19,8480145,Neal Pionk,D,WPG,29,82,10,32,42
19,8477503,Max Domi,C,TOR,29,82,8,34,42
19,8481032,Paul Cotter,C,NJD,25,82,25,16,41
19,8478020,Michael Amadio,C,OTT,28,82,20,21,41
19,8477451,Ryan Hartman,R,MIN,30,82,18,23,41
19,8479987,Morgan Geekie,C,BOS,26,82,18,23,41
19,8481553,Bobby Brink,R,PHI,23,82,18,23,41
19,8480220,Noah Cates,L,PHI,25,82,17,24,41
19,8476419,Jean-Gabriel Pageau,C,NYI,32,82,15,26,41
19,8478055,Gustav Forsling,D,FLA,28,82,12,29,41
19,8477346,MacKenzie Weegar,D,CGY,30,82,5,36,41
19,8480893,Kirill Marchenko,R,CBJ,24,82,24,16,40
19,8480009,Eeli Tolvanen,R,SEA,25,82,18,22,40
19,8481656,Aliaksei Protas,C,WSH,23,82,18,22,40
19,8481582,Nicholas Robertson,L,TOR,23,82,18,22,40
19,8479992,Michael Rasmussen,C,DET,25,82,16,24,40
19,8481581,Thomas Harley,D,DAL,23,82,15,25,40
19,8476461,Sean Couturier,C,PHI,32,82,12,28,40
19,8482089,Jake Neighbours,L,STL,22,82,27,12,39
19,8477511,Anthony Mantha,R,CGY,30,82,17,22,39
19,8480802,Ryan McLeod,C,BUF,25,82,16,23,39
19,8475753,Justin Faulk,D,STL,32,82,12,27,39
19,8475764,Cam Fowler,D,ANA,33,82,5,34,39
19,8475151,Kyle Palmieri,C,NYI,33,82,24,14,38
19,8478046,Danton Heinen,L,VAN,29,82,23,15,38
19,8482125,Alexander Holtz,R,VGK,22,82,21,17,38
19,8482475,Yegor Chinakhov,R,CBJ,23,82,19,19,38
19,8479996,Cody Glass,C,NSH,25,82,18,20,38
19,8481013,Jonatan Berggren,R,DET,24,82,18,20,38
19,8481560,Arthur Kaliyev,R,LAK,23,82,17,21,38
19,8476918,Jimmy Vesey,L,NYR,31,82,17,21,38
19,8482133,Thomas Bordeleau,C,SJS,22,82,13,25,38
19,8476480,Vladislav Namestnikov,C,WPG,32,82,13,25,38
19,8478911,Matt Roy,D,WSH,29,82,12,26,38
19,8484145,Zach Benson,L,BUF,19,82,10,28,38
19,8478500,Ivan Provorov,D,CBJ,27,82,3,35,38
19,8480068,Ryan Poehling,C,PHI,25,82,22,15,37
19,8480113,Alex Iafallo,L,WPG,31,82,18,19,37
19,8475714,Calle Jarnkrok,C,TOR,33,82,18,19,37
19,8477989,Christian Dvorak,C,MTL,28,82,17,20,37
19,8476921,Jordan Martinook,L,CAR,32,82,17,20,37
19,8475314,Anders Lee,L,NYI,34,82,16,21,37
19,8482105,Jake Sanderson,D,OTT,22,82,13,24,37
19,8475149,Marcus Johansson,L,MIN,34,82,12,25,37
19,8480871,Adam Boqvist,D,FLA,24,82,11,26,37
19,8476979,Erik Gustafsson,D,DET,32,82,6,31,37
19,8477952,Robby Fabbri,C,ANA,28,82,18,18,36
19,8482175,JJ Peterka,R,BUF,22,82,17,19,36
19,8481624,Ilya Mikheyev,R,CHI,30,82,16,20,36
19,8478413,Jordan Greenway,L,BUF,27,82,15,21,36
19,8479365,Trent Frederic,C,BOS,26,82,14,22,36
19,8475200,Dmitry Orlov,D,CAR,33,82,12,24,36
19,8476463,Jonas Brodin,D,MIN,31,82,10,26,36
19,8476923,Damon Severson,D,CBJ,30,82,6,30,36
19,8475793,Ryan Johansen,C,PHI,32,82,14,21,35
19,8473422,Nick Foligno,L,CHI,37,82,14,21,35
19,8474149,Evgenii Dadonov,R,DAL,35,82,10,25,35
19,8476885,Jacob Trouba,D,NYR,30,82,8,27,35
19,8482142,Jamie Drysdale,D,PHI,22,82,8,27,35
19,8481535,Nils Hoglander,L,VAN,24,82,22,12,34
19,8479941,Justin Danforth,R,CBJ,31,82,21,13,34
19,8480829,Jesperi Kotkaniemi,C,CAR,24,82,18,16,34
19,8480003,Jesper Boqvist,C,FLA,26,82,16,18,34
19,8478057,Dakota Joshua,C,VAN,28,82,15,19,34
19,8475220,Marcus Foligno,L,MIN,33,82,14,20,34
19,8476474,Stefan Noesen,R,NJD,31,82,13,21,34
19,8482122,Brock Faber,D,MIN,22,82,8,26,34
19,8481604,Pavel Dorofeyev,L,VGK,24,82,19,14,33
19,8475791,Taylor Hall,L,CHI,33,82,15,18,33
19,8483431,Logan Cooley,C,UTA,20,82,14,19,33
19,8481606,Jordan Spence,D,LAK,23,82,9,24,33
19,8484203,Bradly Nadeau,L,CAR,19,82,7,26,33
19,8476917,Adam Pelech,D,NYI,30,82,7,26,33
19,8477998,Warren Foegele,L,LAK,28,82,18,14,32
19,8481481,Blake Lizotte,C,PIT,27,82,18,14,32
19,8478508,Yakov Trenin,C,MIN,27,82,16,16,32
19,8475193,Tomas Tatar,L,NJD,34,82,16,16,32
19,8475231,Casey Cizikas,C,NYI,33,82,15,17,32
19,8481186,Logan O'Connor,R,COL,28,82,14,18,32
19,8482117,Lukas Reichel,L,CHI,22,82,13,19,32
19,8480855,Jack McBain,C,UTA,24,82,13,19,32
19,8475848,Brendan Gallagher,R,MTL,32,82,12,20,32
19,8473533,Jordan Staal,C,CAR,36,82,12,20,32
19,8475171,Oliver Ekman-Larsson,D,TOR,33,82,6,26,32
19,8474151,Ryan McDonagh,D,TBL,35,82,4,28,32
19,8479976,Juuso Valimaki,D,UTA,26,82,4,28,32
19,8479398,Samuel Girard,D,COL,26,82,2,30,32
19,8476469,Joel Armia,R,MTL,31,82,18,13,31
19,8476624,Barclay Goodrow,C,SJS,31,82,16,15,31
19,8482074,Connor Zary,C,CGY,23,82,15,16,31
19,8477353,Tyler Motte,C,DET,29,82,14,17,31
19,8481522,Peyton Krebs,C,BUF,23,82,13,18,31
19,8479353,Brett Howden,C,VGK,26,82,12,19,31
19,8478013,Jake Walman,D,SJS,28,82,10,21,31
19,8480336,Sean Walker,D,CAR,30,82,8,23,31
19,8481178,Egor Zamula,D,PHI,24,82,1,30,31
19,8477947,Sonny Milano,L,WSH,28,82,15,15,30
19,8474053,Logan Couture,C,SJS,35,82,13,17,30
19,8476897,Oskar Sundqvist,C,STL,30,82,13,17,30
19,8477425,Miles Wood,L,COL,29,82,11,19,30
19,8477948,Travis Sanheim,D,PHI,28,82,9,21,30
19,8483457,Lane Hutson,D,MTL,20,82,7,23,30
19,8473507,Jeff Petry,D,DET,37,82,6,24,30
19,8480817,K'Andre Miller,D,NYR,24,82,3,27,30
19,8480049,Dylan Samberg,D,WPG,25,82,2,28,30
19,8475842,Sam Carrick,C,NYR,32,82,21,8,29
19,8481554,Kaapo Kakko,R,NYR,23,82,16,13,29
19,8478109,Victor Olofsson,L,VGK,29,82,16,13,29
19,8478432,Christian Fischer,R,DET,27,82,15,14,29
19,8476278,Colin Blackwell,C,DAL,31,82,14,15,29
19,8477015,Connor Brown,R,EDM,30,82,12,17,29
19,8480144,David Kampf,C,TOR,29,82,12,17,29
19,8476329,Travis Boyd,C,MIN,31,82,11,18,29
19,8482141,Lukas Cormier,D,VGK,22,82,11,18,29
19,8480043,Timothy Liljegren,D,TOR,25,82,5,24,29
19,8477506,Ryan Pulock,D,NYI,30,82,3,26,29
19,8476879,Cody Ceci,D,EDM,31,82,3,26,29
19,8479402,Jake Bean,D,CGY,26,82,3,26,29
19,8479980,Nicolas Hague,D,VGK,26,82,2,27,29
19,8480281,Alexey Toropchenko,R,STL,25,82,21,7,28
19,8483515,Juraj Slafkovsky,L,MTL,20,82,18,10,28
19,8480074,Alexandre Texier,C,STL,25,82,14,14,28
19,8483763,Maksymilian Szuber,D,UTA,22,82,14,14,28
19,8478569,Noel Acciari,C,PIT,33,82,14,14,28
19,8476392,Adam Lowry,C,WPG,31,82,11,17,28
19,8479591,Michael Eyssimont,C,TBL,28,82,10,18,28
19,8481704,Juuso Parssinen,C,NSH,23,82,10,18,28
19,8479316,Luke Kunin,C,SJS,27,82,10,18,28
19,8476422,Mike Reilly,D,NYI,31,82,8,20,28
19,8478133,Jake Evans,C,MTL,28,82,8,20,28
19,8476854,Hampus Lindholm,D,BOS,30,82,6,22,28
19,8480807,Mattias Samuelsson,D,BUF,24,82,5,23,28
19,8474673,TJ Brodie,D,CHI,34,82,2,26,28
19,8481568,Alex Vlasic,D,CHI,23,82,1,27,28
19,8475343,Nic Dowd,C,WSH,34,82,13,14,27
19,8480813,Joe Veleno,C,DET,24,82,13,14,27
19,8484153,Leo Carlsson,C,ANA,20,82,12,15,27
19,8478463,Anthony Beauvillier,L,PIT,27,82,11,16,27
19,8479351,Sam Steel,C,DAL,26,82,10,17,27
19,8482062,Cole Smith,L,NSH,29,82,10,17,27
19,8476873,Mark Jankowski,C,NSH,30,82,9,18,27
19,8482807,Ethan Del Mastro,D,CHI,21,82,9,18,27
19,8477499,Rasmus Ristolainen,D,PHI,30,82,8,19,27
19,8483482,Tristan Luneau,D,ANA,20,82,8,19,27
19,8480073,Erik Brannstrom,D,COL,25,82,6,21,27
19,8476467,Jamie Oleksiak,D,SEA,32,82,6,21,27
19,8476525,Colin Miller,D,WPG,32,82,5,22,27
19,8480035,Henri Jokiharju,D,BUF,25,82,3,24,27
19,8480873,Rasmus Sandin,D,WSH,24,82,1,26,27
19,8482079,Marco Rossi,C,MIN,23,82,18,8,26
19,8482092,Ridly Greig,C,OTT,22,82,14,12,26
19,8477953,Kasperi Kapanen,R,STL,28,82,13,13,26
19,8482809,Jackson Blake,R,CAR,21,82,10,16,26
19,8482720,Matthew Knies,L,TOR,22,82,9,17,26
19,8474715,Cam Atkinson,R,TBL,35,82,9,17,26
19,8482111,Justin Barron,D,MTL,23,82,9,17,26
19,8477220,Nate Schmidt,D,FLA,33,82,7,19,26
19,8483490,Pavel Mintyukov,D,ANA,21,82,5,21,26
19,8477845,Trevor van Riemsdyk,D,WSH,33,82,5,21,26
19,8476331,Dylan DeMelo,D,WPG,31,82,4,22,26
19,8477365,Connor Clifton,D,BUF,29,82,2,24,26
19,8475188,Brayden McNabb,D,VGK,33,82,1,25,26
19,8482259,Bobby McMann,C,TOR,28,82,16,9,25
19,8475855,Jesper Fast,R,CAR,33,82,15,10,25
19,8480789,Oliver Wahlstrom,R,NYI,24,82,15,10,25
19,8479414,Nathan Bastian,R,NJD,27,82,14,11,25
19,8479368,Max Jones,L,BOS,26,82,13,12,25
19,8481580,Connor McMichael,C,WSH,23,82,12,13,25
19,8477508,Curtis Lazar,C,NJD,29,82,12,13,25
19,8479393,Noah Gregor,C,OTT,26,82,11,14,25
19,8481524,Bowen Byram,D,BUF,23,82,11,14,25
19,8482624,Daniil Miromanov,D,CGY,27,82,10,15,25
19,8482803,Olen Zellweger,D,ANA,21,82,10,15,25
19,8477450,Jason Dickinson,C,CHI,29,82,9,16,25
19,8476312,Josh Manson,D,COL,33,82,9,16,25
19,8482077,Dylan Holloway,L,EDM,23,82,9,16,25
19,8477488,Brett Pesce,D,NJD,30,82,6,19,25
19,8477435,Ryan Graves,D,PIT,29,82,5,20,25
19,8480878,Nils Lundkvist,D,DAL,24,82,4,21,25
19,8482073,Braden Schneider,D,NYR,23,82,3,22,25
19,8484166,Adam Fantilli,C,CBJ,20,82,13,11,24
19,8480025,MacKenzie Entwistle,R,FLA,25,82,10,14,24
19,8482666,Scott Morrow,D,CAR,22,82,7,17,24
19,8483468,Jiri Kulich,C,BUF,20,82,7,17,24
19,8480246,Nick Perbix,D,TBL,26,82,4,20,24
19,8478136,Jake Middleton,D,MIN,28,82,2,22,24
19,8479293,Brandon Tanev,L,SEA,33,82,12,11,23
19,8478211,Dryden Hunt,L,CGY,29,82,11,12,23
19,8476902,Esa Lindell,D,DAL,30,82,7,16,23
19,8476889,Radek Faksa,C,STL,30,82,7,16,23
19,8476931,Jake McCabe,D,TOR,31,82,5,18,23
19,8479983,Mario Ferraro,D,SJS,26,82,3,20,23
19,8481014,Alexander Romanov,D,NYI,24,82,2,21,23
19,8470600,Ryan Suter,D,STL,39,82,2,21,23
19,8476891,Matt Grzelcyk,D,PIT,30,82,1,22,23
19,8476981,Josh Anderson,R,MTL,30,82,13,9,22
19,8477406,Mattias Janmark,C,EDM,32,82,12,10,22
19,8477903,Garnet Hathaway,R,PHI,33,82,12,10,22
19,8480980,Connor Dewar,C,TOR,25,82,9,13,22
19,8484149,Gavin Brindley,C,CBJ,20,82,8,14,22
19,8475279,Ben Chiarot,D,DET,33,82,6,16,22
19,8478840,Will Borgen,D,SEA,28,82,4,18,22
19,8480950,Ilya Lyubushkin,D,DAL,30,82,4,18,22
19,8478882,Vladislav Gavrikov,D,LAK,29,82,3,19,22
19,8482245,Artem Zub,D,OTT,29,82,3,19,22
19,8480879,Jacob Bernard-Docker,D,OTT,24,82,3,19,22
19,8482655,J.J. Moser,D,TBL,24,82,1,21,22
19,8481477,Nico Sturm,C,SJS,29,82,14,7,21
19,8470621,Corey Perry,R,EDM,39,82,10,11,21
19,8482733,Logan Mailloux,D,MTL,31,82,10,11,21
19,8481517,Brett Leason,R,ANA,25,82,10,11,21
19,8480806,Isac Lundestrom,C,ANA,25,82,9,12,21
19,8481093,Rafael Harvey-Pinard,L,MTL,25,82,9,12,21
19,8477369,Carson Soucy,D,VAN,30,82,8,13,21
19,8481699,Aku Raty,R,UTA,23,82,8,13,21
19,8482713,Mackie Samoskevich,R,FLA,22,82,8,13,21
19,8480448,Parker Kelly,L,COL,25,82,7,14,21
19,8477919,Frederick Gaudreau,C,MIN,31,82,6,15,21
19,8483495,Simon Nemec,D,NJD,20,82,6,15,21
19,8477839,Conor Sheary,L,TBL,32,82,5,16,21
19,8480222,Sebastian Aho,D,PIT,28,82,5,16,21
19,8475790,Erik Gudbranson,D,CBJ,32,82,4,17,21
19,8474013,Ian Cole,D,UTA,35,82,4,17,21
19,8478443,Brandon Carlo,D,BOS,28,82,4,17,21
19,8479324,Ryan Lindgren,D,NYR,26,82,3,18,21
19,8479369,Andrew Peeke,D,BOS,26,82,3,18,21
19,8475181,Nick Leddy,D,STL,33,82,1,20,21
19,8475462,Radko Gudas,D,ANA,34,82,1,20,21
19,8481601,Simon Holmstrom,R,NYI,23,82,14,6,20
19,8475177,Calvin de Haan,D,COL,33,82,8,12,20
19,8477931,Tomas Nosek,L,FLA,32,82,7,13,20
19,8479442,Troy Stecher,D,EDM,30,82,7,13,20
19,8476457,Adam Larsson,D,SEA,32,82,6,14,20
19,8475233,David Savard,D,MTL,34,82,4,16,20
19,8474567,Zach Bogosian,D,MIN,34,82,4,16,20
19,8479998,Mikey Anderson,D,LAK,25,82,2,18,20
19,8479371,Dante Fabbro,D,NSH,26,82,2,18,20
19,8478507,John Marino,D,UTA,27,82,1,19,20
19,8483471,Brad Lambert,C,WPG,31,82,11,8,19
19,8473453,Trevor Lewis,C,LAK,37,82,9,10,19
19,8482858,Ryker Evans,D,SEA,23,82,9,10,19
19,8478434,Keegan Kolesar,R,VGK,27,82,9,10,19
19,8482702,Logan Stankoven,C,DAL,21,82,8,11,19
19,8482166,Shakir Mukhamadullin,D,SJS,22,82,7,12,19
19,8479291,Kevin Rooney,C,CGY,31,82,7,12,19
19,8483499,Liam Ohgren,L,MIN,20,82,6,13,19
19,8476441,Joel Edmundson,D,LAK,31,82,5,14,19
19,8478416,Erik Cernak,D,TBL,27,82,0,19,19
19,8482679,Matt Coronato,R,CGY,22,82,13,5,18
19,8477505,Alexander Wennberg,C,SJS,30,82,11,7,18
19,8483493,Frank Nazar,C,CHI,20,82,10,8,18
19,8483524,Shane Wright,C,SEA,20,82,10,8,18
19,8479359,Beck Malenstyn,L,BUF,26,82,9,9,18
19,8477392,Hudson Fasching,R,NYI,29,82,8,10,18
19,8476442,Matt Nieto,L,PIT,32,82,8,10,18
19,8480796,Martin Fehervary,D,WSH,25,82,8,10,18
19,8482659,Josh Doan,R,UTA,22,82,8,10,18
19,8483445,Cutter Gauthier,L,ANA,20,82,7,11,18
19,8476372,Nick Seeler,D,PHI,31,82,6,12,18
19,8477507,Nikita Zadorov,D,BOS,29,82,5,13,18
19,8484911,Collin Graf,R,SJS,22,82,5,13,18
19,8474574,Tyler Myers,D,VAN,34,82,4,14,18
19,8482087,Kaiden Guhle,D,MTL,22,82,4,14,18
19,8475324,Nick Jensen,D,OTT,34,82,4,14,18
19,8478859,Niko Mikkola,D,FLA,28,82,3,15,18
19,8478399,Jonas Siegenthaler,D,NJD,27,82,2,16,18
19,8476878,Zemgus Girgensons,L,TBL,30,82,13,4,17
19,8476374,Sean Kuraly,C,CBJ,31,82,10,7,17
19,8481028,Martin Pospisil,C,CGY,25,82,9,8,17
19,8481708,Zac Jones,D,NYR,24,82,8,9,17
19,8483565,Nick Blankenburg,D,NSH,26,82,5,12,17
19,8480172,Jan Rutta,D,SJS,34,82,4,13,17
19,8474090,Brendan Smith,D,DAL,35,82,4,13,17
19,8482153,Brendan Brisson,C,VGK,23,82,4,13,17
19,8475455,Brenden Dillon,D,NJD,34,82,2,15,17
19,8478851,Alexandre Carrier,D,NSH,28,82,1,16,17
19,8480870,Bo Groulx,C,NYR,24,82,12,4,16
19,8480021,Jack Studnicka,C,LAK,25,82,9,7,16
19,8482762,Simon Edvinsson,D,DET,21,82,9,7,16
19,8477034,Jaycob Megna,D,FLA,32,82,7,9,16
19,8479661,Tanner Jeannot,L,LAK,27,82,6,10,16
19,8477938,Haydn Fleury,D,WPG,28,82,6,10,16
19,8475718,Justin Holl,D,DET,32,82,2,14,16
19,8477335,Kyle Burroughs,D,LAK,29,82,2,14,16
19,8481605,Jackson LaCombe,D,ANA,23,82,0,16,16
19,8482749,Joshua Roy,R,MTL,21,82,10,5,15
19,8479638,Justin Brazeau,R,BOS,26,82,8,7,15
19,8482145,Mavrik Bourque,C,DAL,22,82,7,8,15
19,8480990,Declan Chisholm,D,MIN,24,82,6,9,15
19,8480995,Pontus Holmberg,R,TOR,25,82,5,10,15
19,8475690,Chris Tanev,D,TOR,35,82,5,10,15
19,8478178,Darren Raddysh,D,TBL,28,82,5,10,15
19,8478450,Parker Wotherspoon,D,BOS,27,82,5,10,15
19,8476967,Brett Kulak,D,EDM,30,82,3,12,15
19,8483489,Fraser Minten,C,TOR,31,82,7,7,14
19,8483567,Georgii Merkulov,C,BOS,24,82,6,8,14
19,8483397,Marc McLaughlin,C,BOS,25,82,5,9,14
19,8481567,Henry Thrun,D,SJS,23,82,4,10,14
19,8479576,Vincent Desharnais,D,VAN,28,82,3,11,14
19,8478468,Jeremy Lauzon,D,NSH,27,82,3,11,14
19,8476429,Scott Mayfield,D,NYI,32,82,2,12,14
19,8480860,Kevin Bahl,D,CGY,24,82,1,13,14
19,8483505,Matthew Poitras,C,BOS,20,82,5,8,13
19,8478874,Adam Gaudette,C,OTT,28,82,2,11,13
19,8480834,Ty Emberson,D,SJS,24,82,1,12,13
19,8482516,Matthew Kessel,D,STL,24,82,1,12,13
19,8483012,Logan Morrison,C,SEA,22,82,5,7,12
19,8482470,Ilya Solovyov,D,CGY,24,82,4,8,12
19,8475762,Derek Forbort,D,VAN,32,82,3,9,12
19,8482155,Alex Laferriere,R,LAK,23,82,7,4,11
19,8482118,Sam Colangelo,R,ANA,23,82,6,5,11
19,8482859,Zack Ostapchuk,C,OTT,21,82,4,7,11
19,8482712,Oskar Olausson,R,COL,22,82,4,7,11
19,8483460,David Jiricek,D,CBJ,21,82,3,8,11
19,8476858,Phillip Di Giuseppe,L,VAN,31,82,8,2,10
19,8482787,Nikita Chibrikov,R,WPG,31,82,4,6,10
19,8481641,Joel Kiviranta,L,COL,28,82,4,6,10
19,8476473,Connor Murphy,D,CHI,31,82,2,8,10
19,8474612,Travis Hamonic,D,OTT,34,82,1,9,10
19,8482101,Danil Gushchin,L,SJS,22,82,5,4,9
19,8471677,Jack Johnson,D,CBJ,37,82,2,7,9
19,8481122,Simon Benoit,D,TOR,26,82,2,6,8
19,8483466,Kevin Korchinski,D,CHI,20,82,1,7,8
19,8482070,Mitchell Chaffee,R,TBL,26,82,4,3,7
19,8476822,Luke Glendening,C,TBL,35,82,3,4,7
19,8474062,Riley Nash,C,NYR,35,82,0,0,0
19,8470794,Joe Pavelski,C,,40,0,0,0,0
19,8481703,Valtteri Puustinen,R,PIT,25,0,0,0,0
19,8477950,Tony DeAngelo,D,,29,0,0,0,0
19,8481577,Philip Tomasino,C,NSH,23,0,0,0,0
19,8475197,Tyson Barrie,D,,33,0,0,0,0
19,8471218,Blake Wheeler,R,,38,0,0,0,0
19,8474157,Max Pacioretty,L,,36,0,0,0,0
19,8478466,Daniel Sprong,R,VAN,27,0,0,0,0
19,8475744,Evgeny Kuznetsov,C,,32,0,0,0,0
19,8481019,David Gustafsson,C,WPG,24,0,0,0,0
19,8475906,John Klingberg,D,,32,0,0,0,0
19,8479348,Kale Clague,D,BUF,26,0,0,0,0
19,8476952,Dominic Toninato,C,WPG,30,0,0,0,0
19,8473473,Milan Lucic,L,,36,0,0,0,0
19,8474037,James van Riemsdyk,L,,35,0,0,0,0
19,8474602,Justin Schultz,D,,34,0,0,0,0
19,8482222,Alexander Barabanov,L,,30,0,0,0,0
19,8479372,Josh Mahura,D,SEA,26,0,0,0,0
19,8479982,Conor Timmins,D,TOR,26,0,0,0,0
19,8474031,Kevin Shattenkirk,D,,35,0,0,0,0
19,8480008,Adam Ruzicka,C,,25,0,0,0,0
19,8481059,Scott Perunovich,D,STL,26,0,0,0,0
19,8480884,Calen Addison,D,,24,0,0,0,0
19,8476994,Vinnie Hinostroza,C,NSH,30,0,0,0,0
19,8478452,Caleb Jones,D,LAK,27,0,0,0,0
19,8480157,Calle Rosen,D,COL,30,0,0,0,0
19,8481609,Vladislav Kolyachonok,D,UTA,23,0,0,0,0
19,8479415,Michael McLeod,C,,26,0,0,0,0
19,8476919,Chris Tierney,C,,30,0,0,0,0
19,8479639,Dylan Coghlan,D,WPG,26,0,0,0,0
19,8478146,Matthew Highmore,C,OTT,28,0,0,0,0
19,8478970,Jalen Chatfield,D,CAR,28,0,0,0,0
19,8480205,Emil Bemstrom,C,PIT,25,0,0,0,0
19,8474884,Mike Hoffman,C,,35,0,0,0,0
19,8471274,Alex Goligoski,D,,39,0,0,0,0
19,8478104,Sammy Blais,L,,28,0,0,0,0
19,8474870,Tyler Johnson,C,,34,0,0,0,0
19,8476913,Devin Shore,C,MIN,30,0,0,0,0
19,8481598,Philip Broberg,D,EDM,23,0,0,0,0
19,8480058,Pierre-Olivier Joseph,D,STL,25,0,0,0,0
19,8480891,Michael Kesselring,D,UTA,24,0,0,0,0
19,8477979,Nicolas Aube-Kubel,R,BUF,28,0,0,0,0
19,8476871,Tanner Pearson,L,,32,0,0,0,0
19,8476393,Nick Cousins,C,,31,0,0,0,0
19,8479977,Kailer Yamamoto,R,,26,0,0,0,0
19,8479543,Michael Pezzetta,L,MTL,26,0,0,0,0
19,8477018,Ben Hutton,D,VGK,31,0,0,0,0
19,8480762,Eric Robinson,L,CAR,29,0,0,0,0
19,8474034,Pat Maroon,L,CHI,36,0,0,0,0
19,8481058,Jesse Ylönen,R,,25,0,0,0,0
19,8475179,Dmitry Kulikov,D,FLA,34,0,0,0,0
19,8481527,Kaedan Korczak,D,VGK,23,0,0,0,0
19,8473449,Kyle Okposo,R,,36,0,0,0,0
19,8482192,Isaak Phillips,D,CHI,23,0,0,0,0
19,8480727,Zach Whitecloud,D,VGK,28,0,0,0,0
19,8479346,Dillon Dube,C,,26,0,0,0,0
19,8480821,Filip Zadina,R,,25,0,0,0,0
19,8480001,Urho Vaakanainen,D,ANA,25,0,0,0,0
19,8470966,Mark Giordano,D,,41,0,0,0,0
19,8480853,Liam Foudy,C,,24,0,0,0,0
19,8475225,Craig Smith,C,CHI,35,0,0,0,0
19,8479972,Mason Shaw,C,WPG,26,0,0,0,0
19,8478451,Ethan Bear,D,WSH,27,0,0,0,0
19,8474040,Sam Gagner,C,,35,0,0,0,0
19,8480196,Jacob Bryson,D,BUF,27,0,0,0,0
19,8479984,Cal Foote,D,,26,0,0,0,0
19,8480011,Klim Kostin,C,SJS,25,0,0,0,0
19,8482176,Wyatt Kaiser,D,CHI,22,0,0,0,0
19,8476988,Matt Benning,D,SJS,30,0,0,0,0
19,8479370,Tyson Jost,C,CAR,26,0,0,0,0
19,8477464,Nic Petan,C,,29,0,0,0,0
19,8477380,Jonny Brodzinski,C,NYR,31,0,0,0,0
19,8480070,Ian Mitchell,D,BOS,25,0,0,0,0
19,8479315,Joey Anderson,R,CHI,26,0,0,0,0
19,8478099,Kevin Labanc,R,,29,0,0,0,0
19,8476874,Olli Maatta,D,DET,30,0,0,0,0
19,8475208,Brian Dumoulin,D,ANA,33,0,0,0,0
19,8478430,Oliver Kylington,D,,27,0,0,0,0
19,8479536,Axel Jonsson-Fjallby,L,WPG,26,0,0,0,0
19,8479671,Mathieu Olivier,R,CBJ,27,0,0,0,0
19,8471709,Marc-Edouard Vlasic,D,SJS,37,0,0,0,0
19,8479328,Julien Gauthier,R,NYI,27,0,0,0,0
19,8478421,A.J. Greer,L,FLA,28,0,0,0,0
19,8477573,Nathan Walker,L,STL,30,0,0,0,0
19,8481537,Nikita Okhotiuk,D,CGY,24,0,0,0,0
19,8474166,Alec Martinez,D,CHI,37,0,0,0,0
19,8470610,Zach Parise,L,,40,0,0,0,0
19,8477478,William Carrier,L,CAR,30,0,0,0,0
19,8479344,Jesse Puljujarvi,R,PIT,26,0,0,0,0
19,8480887,Jordan Harris,D,MTL,24,0,0,0,0
19,8478502,Dennis Gilbert,D,BUF,28,0,0,0,0
19,8482730,Brandt Clarke,D,LAK,21,0,0,0,0
19,8480355,Mark Kastelic,C,BOS,25,0,0,0,0
19,8475750,Jon Merrill,D,MIN,32,0,0,0,0
19,8475164,Jakob Silfverberg,R,,34,0,0,0,0
19,8477944,Jakub Vrana,L,,28,0,0,0,0
19,8479439,Jacob MacDonald,D,COL,31,0,0,0,0
19,8474568,Luke Schenn,D,NSH,35,0,0,0,0
19,8478454,Noah Juulsen,D,VAN,27,0,0,0,0
19,8475752,Tyler Pitlick,C,,33,0,0,0,0
19,8482148,Hendrix Lapierre,C,WSH,22,0,0,0,0
19,8481167,Brayden Pachal,D,CGY,25,0,0,0,0
19,8478043,Sam Lafferty,C,BUF,29,0,0,0,0
19,8479321,Lucas Johansen,D,,27,0,0,0,0
19,8471699,Andrew Cogliano,C,,37,0,0,0,0
19,8481521,Ronnie Attard,D,PHI,25,0,0,0,0
19,8481161,Jake Christiansen,D,CBJ,25,0,0,0,0
19,8479458,Nikita Zaitsev,D,,33,0,0,0,0
19,8479619,Michael Carcone,L,UTA,28,0,0,0,0
19,8479026,Philippe Myers,D,TOR,27,0,0,0,0
19,8477330,Dominik Kubalik,L,,29,0,0,0,0
19,8481617,Vasily Podkolzin,R,VAN,23,0,0,0,0
19,8481701,Santeri Hatakka,D,NJD,23,0,0,0,0
19,8479514,Rem Pitlick,C,,27,0,0,0,0
19,8477446,Michael McCarron,R,NSH,29,0,0,0,0
19,8470604,Jeff Carter,C,,39,0,0,0,0
19,8482241,Radim Zohorna,L,,28,0,0,0,0
19,8480289,Morgan Barron,C,WPG,26,0,0,0,0
19,8479379,Givani Smith,R,SJS,26,0,0,0,0
19,8480216,Jacob Peterson,C,,25,0,0,0,0
19,8477851,Jordan Oesterle,D,BOS,32,0,0,0,0
19,8484258,Sam Malinski,D,COL,26,0,0,0,0
19,8478904,Steven Lorentz,C,,28,0,0,0,0
19,8482095,Tyler Kleven,D,OTT,22,0,0,0,0
19,8480848,Ty Dellandrea,C,SJS,24,0,0,0,0
19,8476884,Derrick Pouliot,D,,30,0,0,0,0
19,8479336,Carl Grundstrom,R,SJS,27,0,0,0,0
19,8482964,Arber Xhekaj,D,MTL,23,0,0,0,0
19,8471686,Marc Staal,D,,37,0,0,0,0
19,8477887,Patrick Brown,C,BOS,32,0,0,0,0
19,8478495,Denis Gurianov,R,,27,0,0,0,0
19,8473504,Cal Clutterbuck,R,,37,0,0,0,0
19,8481550,Adam Beckman,L,NJD,23,0,0,0,0
19,8480845,Rasmus Kupari,C,WPG,24,0,0,0,0
19,8474009,Nick Bonino,C,,36,0,0,0,0
19,8478585,Derek Ryan,C,EDM,38,0,0,0,0
19,8477962,Brendan Lemieux,L,CAR,28,0,0,0,0
19,8482861,Vincent Iorio,D,WSH,22,0,0,0,0
19,8479378,Logan Stanley,D,WPG,26,0,0,0,0
19,8473446,Erik Johnson,D,PHI,36,0,0,0,0
19,8481743,Marc Del Gaizo,D,NSH,25,0,0,0,0
19,8477384,Josh Brown,D,EDM,30,0,0,0,0
19,8482165,Yan Kuznetsov,D,CGY,22,0,0,0,0
19,8478424,Jansen Harkins,C,ANA,27,0,0,0,0
19,8482144,Jack Thompson,D,SJS,22,0,0,0,0
19,8478512,Austin Czarnik,C,,32,0,0,0,0
19,8477527,Ross Johnston,L,ANA,30,0,0,0,0
19,8479383,Boris Katchouk,L,,26,0,0,0,0
19,8482094,Daemon Hunt,D,MIN,22,0,0,0,0
19,8481719,Maxwell Crozier,D,TBL,24,0,0,0,0
19,8480192,Johnathan Kovacevic,D,NJD,27,0,0,0,0
19,8479376,Victor Mete,D,,26,0,0,0,0
19,8482511,Mason Lohrei,D,BOS,23,0,0,0,0
19,8475825,Jani Hakanpää,D,,32,0,0,0,0
19,8478021,William Lagesson,D,DET,28,0,0,0,0
19,8475795,Dylan McIlrath,D,WSH,32,0,0,0,0
19,8477846,Ryan Carpenter,C,,33,0,0,0,0
19,8481056,Spencer Stastney,D,NSH,24,0,0,0,0
19,8481564,Ryan Johnson,D,BUF,23,0,0,0,0
19,8478017,Mark Friedman,D,VAN,29,0,0,0,0
19,8479320,Max Lajoie,D,SEA,27,0,0,0,0
19,8480075,Cameron Crotty,D,MIN,25,0,0,0,0
19,8484287,Cole McWard,D,VAN,23,0,0,0,0
19,8484254,Akito Hirose,D,VAN,25,0,0,0,0
19,8483407,Brandon Scanlin,D,NYR,25,0,0,0,0
19,8480274,Philip Kemp,D,EDM,25,0,0,0,0
19,8479522,Hardy Haman Aktell,D,WSH,26,0,0,0,0
19,8480007,Jonas Rondbjerg,R,VGK,25,0,0,0,0
19,8477454,Adam Erne,L,,29,0,0,0,0
19,8481679,Maxence Guenette,D,OTT,23,0,0,0,0
19,8480441,Trey Fix-Wolansky,R,CBJ,25,0,0,0,0
19,8483546,Marshall Rifai,D,TOR,26,0,0,0,0
19,8480084,Nick DeSimone,D,NJD,30,0,0,0,0
19,8481030,Jack St. Ivany,D,PIT,25,0,0,0,0
19,8481592,Jakob Pelletier,L,CGY,23,0,0,0,0
19,8478011,Louie Belpedio,D,PHI,28,0,0,0,0
19,8477930,Pierre-Edouard Bellemare,L,,39,0,0,0,0
19,8484321,Nikolas Matinpalo,D,OTT,26,0,0,0,0
19,8482067,Connor Mackey,D,NYR,28,0,0,0,0
19,8481806,Louis Crevier,D,CHI,23,0,0,0,0
19,8484326,Patrik Koch,D,UTA,28,0,0,0,0
19,8477971,Andreas Englund,D,LAK,28,0,0,0,0
19,8481751,Lukas Rousek,R,BUF,25,0,0,0,0
19,8481006,Tyler Tucker,D,STL,24,0,0,0,0
19,8476867,Brendan Gaunce,C,MIN,30,0,0,0,0
19,8479520,Brandon Duhaime,R,WSH,27,0,0,0,0
19,8477073,Kurtis MacDermid,L,NJD,30,0,0,0,0
19,8480874,Adam Ginning,D,PHI,24,0,0,0,0
19,8477473,Justin Bailey,R,SJS,29,0,0,0,0
19,8479066,Ryan Lomberg,L,CGY,30,0,0,0,0
19,8477070,Liam O'Brien,C,UTA,30,0,0,0,0
19,8474618,Marco Scandella,D,,34,0,0,0,0
19,8475797,Jarred Tinordi,D,,32,0,0,0,0
19,8481441,Joe Snively,C,DET,28,0,0,0,0
19,8477244,Chad Ruhwedel,D,NYR,34,0,0,0,0
19,8479772,Zack MacEwen,R,OTT,28,0,0,0,0
19,8481147,Reese Johnson,C,MIN,26,0,0,0,0
19,8481043,Cole Koepke,L,BOS,26,0,0,0,0
19,8483619,Filip Roos,D,OTT,25,0,0,0,0
19,8481541,Samuel Bolduc,D,NYI,24,0,0,0,0
19,8477810,Joel Hanley,D,CGY,33,0,0,0,0
19,8476907,Mackenzie MacEachern,L,,30,0,0,0,0
19,8482652,Walker Duehr,R,CGY,27,0,0,0,0
19,8477126,Jayson Megna,C,,34,0,0,0,0
19,8483398,Declan Carlile,D,TBL,31,0,0,0,0
19,8482929,Emil Lilleberg,D,TBL,23,0,0,0,0
19,8480880,Jakub Lauko,C,MIN,24,0,0,0,0
19,8480245,Olle Lycksell,R,PHI,25,0,0,0,0
19,8480252,Cole Guttman,C,CHI,25,0,0,0,0
19,8477467,Gustav Olofsson,D,SEA,30,0,0,0,0
19,8479968,Vinni Lettieri,C,BOS,29,0,0,0,0
19,8478400,Colin White,C,,27,0,0,0,0
19,8475755,Alexander Petrovic,D,DAL,32,0,0,0,0
19,8481812,Nikolai Knyzhov,D,,27,0,0,0,0
19,8481593,Jayden Struble,D,MTL,23,0,0,0,0
19,8481532,Alex Turcotte,C,LAK,23,0,0,0,0
19,8482126,Emil Andrae,D,PHI,31,0,0,0,0
19,8479944,Zach Aston-Reese,C,VGK,30,0,0,0,0
19,8471817,Ryan Reaves,R,TOR,37,0,0,0,0
19,8481206,John Ludvig,D,PIT,24,0,0,0,0
19,8481599,Victor Soderstrom,D,UTA,23,0,0,0,0
19,8480292,Carson Meyer,R,ANA,27,0,0,0,0
19,8482496,Nils Aman,C,VAN,24,0,0,0,0
19,8479718,Alex Barré-Boulet,C,MTL,27,0,0,0,0
19,8479994,Jaret Anderson-Dolan,C,WPG,25,0,0,0,0
19,8480184,Gustav Lindstrom,D,,26,0,0,0,0
19,8480890,Jan Jenik,R,OTT,24,0,0,0,0
19,8478067,Oskar Lindblom,L,,28,0,0,0,0
19,8476934,Brock McGinn,L,ANA,30,0,0,0,0
19,8479985,Cale Fleury,D,SEA,26,0,0,0,0
19,8484304,Uvis Balinskis,D,FLA,28,0,0,0,0
19,8479981,Jonah Gadjovich,L,FLA,26,0,0,0,0
19,8481716,Dmitri Voronkov,L,CBJ,24,0,0,0,0
19,8474709,Matt Martin,L,,35,0,0,0,0
19,8482634,Alex Steeves,C,TOR,25,0,0,0,0
19,8480823,Alexander Alexeyev,D,WSH,25,0,0,0,0
19,8477541,Dakota Mermis,D,TOR,30,0,0,0,0
19,8483491,Ivan Miroshnichenko,L,WSH,20,0,0,0,0
19,8478477,Mitchell Stephens,C,SEA,27,0,0,0,0
19,8481543,Nikita Alexandrov,C,STL,24,0,0,0,0
19,8479423,Alex Nylander,L,,26,0,0,0,0
19,8482451,Mikael Pyyhtia,L,CBJ,23,0,0,0,0
19,8478831,Kevin Stenlund,C,UTA,28,0,0,0,0
19,8480306,Grant Hutton,D,NYI,29,0,0,0,0
19,8478028,Fredrik Olofsson,L,,28,0,0,0,0
19,8477462,Robert Hagg,D,VGK,29,0,0,0,0
19,8477320,Anton Blidh,L,NYR,29,0,0,0,0
19,8482157,Will Cuylle,L,NYR,22,0,0,0,0
19,8482737,Zack Bolduc,C,STL,21,0,0,0,0
19,8481239,Samuel Fagemo,L,,24,0,0,0,0
19,8481600,Tobias Bjornfot,D,FLA,23,0,0,0,0
19,8478409,Anthony Richard,C,PHI,28,0,0,0,0
19,8474145,Robert Bortuzzo,D,,35,0,0,0,0
19,8475958,Michael Sgarbossa,C,WSH,32,0,0,0,0
19,8479986,Kole Lind,R,DAL,26,0,0,0,0
19,8479249,Andrew Poturalski,C,SJS,30,0,0,0,0
19,8479362,Riley Tufte,L,BOS,26,0,0,0,0
19,8479991,Jake Leschyshyn,C,NYR,25,0,0,0,0
19,8479587,Rhett Gardner,C,PHI,28,0,0,0,0
19,8482744,James Malatesta,L,CBJ,21,0,0,0,0
19,8478854,Ryan Shea,D,PIT,27,0,0,0,0
19,8481591,Sam Poulin,R,,23,0,0,0,0
19,8483512,Matt Savoie,C,EDM,20,0,0,0,0
19,8482102,Vasily Ponomarev,C,PIT,22,0,0,0,0
19,8482162,Roby Jarventie,L,EDM,22,0,0,0,0
19,8481016,Ruslan Iskhakov,C,,24,0,0,0,0
19,8482172,Landon Slaggert,L,CHI,22,0,0,0,0
19,8482747,Brennan Othmann,L,NYR,21,0,0,0,0
19,8480031,Maxime Comtois,L,,25,0,0,0,0
19,8480226,Marián Studenic,R,,26,0,0,0,0
19,8478408,Travis Dermott,D,,28,0,0,0,0
19,8481518,Nolan Foote,L,NJD,24,0,0,0,0
19,8479419,Brett Murray,L,BUF,26,0,0,0,0
19,8482088,Justin Sourdif,R,FLA,22,0,0,0,0
19,8482201,Gage Goncalves,C,TBL,23,0,0,0,0
19,8481578,Graeme Clarke,R,MIN,23,0,0,0,0
19,8482177,Marat Khusnutdinov,C,MIN,22,0,0,0,0
19,8481754,Nikita Nesterenko,C,ANA,23,0,0,0,0
19,8483531,Brian Halonen,L,NJD,25,0,0,0,0
19,8483920,Pierrick Dube,R,WSH,23,0,0,0,0
19,8480851,Akil Thomas,C,LAK,24,0,0,0,0
19,8475235,Nicolas Deslauriers,L,PHI,33,0,0,0,0
19,8482476,Emil Heineman,L,MTL,23,0,0,0,0
19,8477149,Scott Sabourin,R,SJS,32,0,0,0,0
19,8483549,Lucas Condotta,L,MTL,27,0,0,0,0
19,8482765,Isak Rosen,R,BUF,21,0,0,0,0
19,8481237,Kyle MacLean,C,NYI,25,0,0,0,0
19,8481024,Linus Karlsson,C,VAN,25,0,0,0,0
19,8481690,Tyler Angle,C,,24,0,0,0,0
19,8483570,Ben Meyers,C,SEA,26,0,0,0,0
19,8481655,Cole Schwindt,R,CGY,23,0,0,0,0
19,8481462,Mason Morelli,L,VGK,28,0,0,0,0
19,8483401,Marc Johnstone,R,PIT,28,0,0,0,0
19,8478956,Samuel Laberge,L,NJD,27,0,0,0,0
19,8479533,Joona Koppanen,L,,26,0,0,0,0
19,8482197,Adam Raska,R,MIN,23,0,0,0,0
19,8482250,Callahan Burke,C,VGK,27,0,0,0,0
19,8482784,Zach Dean,C,STL,21,0,0,0,0
19,8484255,Jason Polin,R,COL,25,0,0,0,0
19,8481077,John Leonard,L,,26,0,0,0,0
19,8481534,Raphael Lavoie,C,EDM,24,0,0,0,0
19,8483609,Adam Klapka,R,CGY,24,0,0,0,0
19,8482751,Ryan Winterton,C,SEA,21,0,0,0,0
19,8480267,Sammy Walker,C,MIN,25,0,0,0,0
19,8475766,Austin Watson,L,,32,0,0,0,0
19,8482460,Matt Rempe,C,NYR,22,0,0,0,0
19,8481065,Angus Crookshank,L,OTT,25,0,0,0,0
19,8481070,Hugh McGing,L,,26,0,0,0,0
19,8476323,Max McCormick,L,SEA,32,0,0,0,0
19,8483395,Arshdeep Bains,L,VAN,23,0,0,0,0
19,8484259,Ondrej Pavel,C,COL,31,0,0,0,0
19,8483432,Luca Del Bel Belluz,C,CBJ,31,0,0,0,0
19,8483045,Cameron Butler,R,CBJ,31,0,0,0,0
19,8482061,Brandon Biro,L,SEA,26,0,0,0,0
19,8477401,John Hayden,C,SEA,29,0,0,0,0
19,8475278,Byron Froese,C,,33,0,0,0,0
19,8478446,Glenn Gawdin,C,LAK,27,0,0,0,0
19,8477993,Justin Kirkland,C,CGY,28,0,0,0,0
19,8482147,Jean-Luc Foudy,C,COL,22,0,0,0,0
19,8480032,Shane Bowers,C,NJD,25,0,0,0,0
19,8479330,Brandon Gignac,C,MTL,27,0,0,0,0
19,8480776,Sheldon Rempal,R,,29,0,0,0,0
19,8475413,Justin Dowling,C,NJD,34,0,0,0,0
19,8481726,Adam Edstrom,C,NYR,24,0,0,0,0
19,8480844,Grigori Denisenko,L,VGK,24,0,0,0,0
19,8478147,Bokondji Imama,L,PIT,28,0,0,0,0
19,8478881,Brett Seney,L,CHI,28,0,0,0,0
19,8483630,Pavol Regenda,L,ANA,25,0,0,0,0
19,8480836,Jonathan Gruden,C,,24,0,0,0,0
19,8484314,Jiri Smejkal,L,,28,0,0,0,0
19,8475780,Chris Wagner,R,COL,33,0,0,0,0
19,8479546,Oskar Steen,C,,26,0,0,0,0
19,8483597,Milos Kelemen,L,UTA,25,0,0,0,0
19,8481789,Tye Kartye,L,SEA,23,0,0,0,0
19,8484325,Waltteri Merela,C,TBL,26,0,0,0,0
19,8479421,Jacob Moverare,D,LAK,26,0,0,0,0
19,8481585,Egor Afanasyev,L,SJS,23,0,0,0,0
19,8479547,Matthew Phillips,R,,26,0,0,0,0
19,8479367,William Lockwood,R,FLA,26,0,0,0,0
19,8476915,Jujhar Khaira,L,,30,0,0,0,0
19,8481422,Jacob Lucchini,C,NSH,29,0,0,0,0
19,8480468,James Hamblin,L,EDM,25,0,0,0,0
19,8478051,Max Willman,C,NJD,29,0,0,0,0
19,8481556,John Beecher,C,BOS,23,0,0,0,0
19,8478078,Rourke Chartier,C,,28,0,0,0,0
20,8477492,Nathan MacKinnon,C,COL,29,82,57,90,147
20,8479318,Auston Matthews,C,TOR,27,82,73,72,145
20,8478402,Connor McDavid,C,EDM,27,82,40,104,144
20,8481559,Jack Hughes,C,NJD,23,82,47,80,127
20,8476453,Nikita Kucherov,R,TBL,31,82,37,88,125
20,8480027,Jason Robertson,L,DAL,25,82,48,71,119
20,8477939,William Nylander,R,TOR,28,82,61,55,116
20,8477956,David Pastrnak,R,BOS,28,82,52,62,114
20,8477493,Aleksander Barkov,C,FLA,29,82,32,81,113
20,8479314,Matthew Tkachuk,L,FLA,27,82,46,66,112
20,8478420,Mikko Rantanen,R,COL,28,82,39,71,110
20,8478550,Artemi Panarin,L,NYR,33,82,41,68,109
20,8476468,J.T. Miller,C,VAN,31,82,36,72,108
20,8471675,Sidney Crosby,C,PIT,37,82,53,54,107
20,8477934,Leon Draisaitl,C,EDM,29,82,36,71,107
20,8477404,Jake Guentzel,C,TBL,30,82,56,49,105
20,8479343,Clayton Keller,R,UTA,26,82,52,53,105
20,8474600,Roman Josi,D,NSH,34,82,28,76,104
20,8480069,Cale Makar,D,COL,26,82,25,78,103
20,8480023,Robert Thomas,C,STL,25,82,37,65,102
20,8480801,Brady Tkachuk,L,OTT,25,82,48,53,101
20,8479407,Jesper Bratt,L,NJD,26,82,43,58,101
20,8480002,Nico Hischier,C,NJD,25,82,39,60,99
20,8478864,Kirill Kaprizov,L,MIN,27,82,44,54,98
20,8480012,Elias Pettersson,C,VAN,26,82,40,56,96
20,8477942,Kevin Fiala,L,LAK,28,82,38,58,96
20,8478445,Mathew Barzal,C,NYI,27,82,23,73,96
20,8476887,Filip Forsberg,L,NSH,30,82,42,52,94
20,8479323,Adam Fox,D,NYR,26,82,18,75,93
20,8478427,Sebastian Aho,C,CAR,27,82,39,52,91
20,8475172,Nazem Kadri,C,CGY,34,82,31,60,91
20,8477946,Dylan Larkin,C,DET,28,82,38,52,90
20,8482116,Tim Stützle,C,OTT,22,82,33,57,90
20,8474564,Steven Stamkos,C,NSH,34,82,49,39,88
20,8477409,Carter Verhaeghe,C,FLA,29,82,40,48,88
20,8478403,Jack Eichel,C,VGK,28,82,39,49,88
20,8481557,Matt Boldy,L,MIN,23,82,35,51,86
20,8478439,Travis Konecny,R,PHI,27,82,38,47,85
20,8480800,Quinn Hughes,D,VAN,25,82,11,74,85
20,8480830,Andrei Svechnikov,R,CAR,24,82,33,51,84
20,8479420,Tage Thompson,C,BUF,27,82,45,38,83
20,8478449,Roope Hintz,C,DAL,28,82,39,44,83
20,8471215,Evgeni Malkin,C,PIT,38,82,33,50,83
20,8477501,Valeri Nichushkin,R,COL,29,82,45,37,82
20,8478398,Kyle Connor,L,WPG,28,82,35,47,82
20,8476456,Jonathan Huberdeau,C,CGY,31,82,23,59,82
20,8475166,John Tavares,C,TOR,34,82,35,46,81
20,8478010,Brayden Point,C,TBL,28,82,34,47,81
20,8479325,Charlie McAvoy,D,BOS,27,82,14,66,80
20,8481523,Kirby Dach,C,MTL,23,82,12,68,80
20,8476454,Ryan Nugent-Hopkins,C,EDM,31,82,27,52,79
20,8475692,Mats Zuccarello,R,MIN,37,82,13,66,79
20,8477933,Sam Reinhart,C,FLA,29,82,33,45,78
20,8476389,Vincent Trocheck,C,NYR,31,82,31,47,78
20,8475786,Zach Hyman,L,EDM,32,82,43,34,77
20,8478042,Viktor Arvidsson,R,EDM,31,82,30,47,77
20,8478444,Brock Boeser,R,VAN,27,82,28,49,77
20,8478460,Zach Werenski,D,CBJ,27,82,20,57,77
20,8474578,Erik Karlsson,D,PIT,34,82,13,64,77
20,8476460,Mark Scheifele,C,WPG,31,82,31,45,76
20,8474141,Patrick Kane,R,DET,36,82,30,46,76
20,8476459,Mika Zibanejad,C,NYR,31,82,21,55,76
20,8475810,Bryan Rust,R,PIT,32,82,35,40,75
20,8477940,Nikolaj Ehlers,L,WPG,28,82,32,43,75
20,8471685,Anze Kopitar,C,LAK,37,82,24,51,75
20,8478414,Timo Meier,R,NJD,28,82,36,38,74
20,8477949,Alex Tuch,R,BUF,28,82,25,49,74
20,8480208,Drake Batherson,R,OTT,26,82,20,53,73
20,8483808,Andrei Kuzmenko,L,CGY,28,82,36,36,72
20,8477402,Pavel Buchnevich,L,STL,29,82,30,42,72
20,8482078,Lucas Raymond,L,DET,22,82,22,50,72
20,8478873,Troy Terry,R,ANA,27,82,21,51,72
20,8477504,Josh Morrissey,D,WPG,29,82,17,55,72
20,8475913,Mark Stone,R,VGK,32,82,21,50,71
20,8475151,Kyle Palmieri,C,NYI,33,82,37,33,70
20,8476881,Tomas Hertl,C,VGK,31,82,33,37,70
20,8475726,Tyler Toffoli,C,SJS,32,82,32,38,70
20,8478396,Noah Hanifin,D,VGK,27,82,15,55,70
20,8477447,Shea Theodore,D,VGK,29,82,10,60,70
20,8476539,Jonathan Marchessault,R,NSH,34,82,33,36,69
20,8482093,Seth Jarvis,C,CAR,22,82,33,36,69
20,8479337,Alex DeBrincat,R,DET,27,82,26,43,69
20,8476346,Johnny Gaudreau,L,CBJ,31,82,15,54,69
20,8476853,Morgan Rielly,D,TOR,30,82,4,65,69
20,8476399,Blake Coleman,C,CGY,33,82,32,36,68
20,8478440,Dylan Strome,C,WSH,27,82,31,37,68
20,8481068,Yegor Sharangovich,C,CGY,26,82,31,37,68
20,8479385,Jordan Kyrou,C,STL,26,82,27,41,68
20,8479542,Brandon Hagel,L,TBL,26,82,27,41,68
20,8477496,Elias Lindholm,C,BOS,30,82,26,42,68
20,8477951,Nick Schmaltz,C,UTA,28,82,24,44,68
20,8479675,Trevor Moore,L,LAK,29,82,38,29,67
20,8475754,Brock Nelson,C,NYI,33,82,37,30,67
20,8475784,Jeff Skinner,C,EDM,32,82,32,35,67
20,8478047,Michael Bunting,L,PIT,29,82,28,39,67
20,8475158,Ryan O'Reilly,C,NSH,33,82,27,40,67
20,8480036,Miro Heiskanen,D,DAL,25,82,17,50,67
20,8477346,MacKenzie Weegar,D,CGY,30,82,12,55,67
20,8477416,Oliver Bjorkstrand,R,SEA,29,82,26,40,66
20,8473994,Jamie Benn,L,DAL,35,82,22,44,66
20,8475170,Brayden Schenn,C,STL,33,82,27,38,65
20,8475798,Mikael Granlund,C,SJS,32,82,22,43,65
20,8473512,Claude Giroux,R,OTT,36,82,22,43,65
20,8475168,Matt Duchene,C,DAL,33,82,20,45,65
20,8475167,Victor Hedman,D,TBL,34,82,18,47,65
20,8473419,Brad Marchand,L,BOS,36,82,29,35,64
20,8479339,Patrik Laine,L,CBJ,26,82,29,35,64
20,8476880,Tom Wilson,R,WSH,30,82,27,37,64
20,8474590,John Carlson,D,WSH,34,82,15,49,64
20,8479425,Filip Hronek,D,VAN,27,82,10,54,64
20,8482110,Dawson Mercer,C,NJD,23,82,31,32,63
20,8480188,Fabian Zetterlund,L,SJS,25,82,30,33,63
20,8475765,Vladimir Tarasenko,R,DET,33,82,23,40,63
20,8474150,Mikael Backlund,C,CGY,35,82,22,41,63
20,8478438,Tommy Novak,C,NSH,27,82,20,43,63
20,8482124,Quinton Byfield,R,LAK,22,82,19,44,63
20,8474679,Gustav Nyquist,C,NSH,35,82,17,46,63
20,8475184,Chris Kreider,L,NYR,33,82,43,19,62
20,8471214,Alex Ovechkin,L,WSH,39,82,36,26,62
20,8479999,Casey Mittelstadt,C,COL,26,82,20,42,62
20,8477476,Artturi Lehkonen,L,COL,29,82,33,28,61
20,8477960,Adrian Kempe,R,LAK,28,82,27,34,61
20,8478401,Pavel Zacha,C,BOS,27,82,24,37,61
20,8482684,Luke Hughes,D,NJD,21,82,14,47,61
20,8478498,Jake DeBrusk,L,VAN,28,82,27,33,60
20,8480039,Martin Necas,C,CAR,25,82,25,35,60
20,8478975,Mason Marchment,L,DAL,29,82,19,41,60
20,8480018,Nick Suzuki,C,MTL,25,82,18,42,60
20,8481542,Moritz Seider,D,DET,23,82,16,44,60
20,8481533,Trevor Zegras,C,ANA,23,82,28,31,59
20,8482665,Matty Beniers,C,SEA,22,82,28,31,59
20,8478493,Joel Eriksson Ek,C,MIN,27,82,26,33,59
20,8476882,Teuvo Teravainen,L,CHI,30,82,23,36,59
20,8479400,Pierre-Luc Dubois,L,WSH,26,82,15,44,59
20,8480014,Gabriel Vilardi,C,WPG,25,82,37,21,58
20,8480865,Noah Dobson,D,NYI,24,82,8,49,57
20,8480064,Josh Norris,C,OTT,25,82,34,22,56
20,8478856,Conor Garland,R,VAN,28,82,25,31,56
20,8477964,Ivan Barbashev,C,VGK,29,82,21,35,56
20,8480839,Rasmus Dahlin,D,BUF,24,82,16,40,56
20,8478407,Vince Dunn,D,SEA,28,82,10,46,56
20,8481540,Cole Caufield,R,MTL,23,82,28,27,55
20,8477444,Andre Burakovsky,L,SEA,29,82,26,29,55
20,8478542,Evan Rodrigues,C,FLA,31,82,24,31,55
20,8482097,Jack Quinn,R,BUF,23,82,23,32,55
20,8482667,William Eklund,L,SJS,22,82,22,33,55
20,8480803,Evan Bouchard,D,EDM,25,82,13,42,55
20,8474563,Drew Doughty,D,LAK,35,82,13,42,55
20,8476432,Boone Jenner,C,CBJ,31,82,36,18,54
20,8482740,Wyatt Johnston,C,DAL,21,82,31,23,54
20,8478366,Frank Vatrano,R,ANA,30,82,29,25,54
20,8480797,Joel Farabee,L,PHI,24,82,29,25,54
20,8477500,Bo Horvat,C,NYI,29,82,28,26,54
20,8475745,Charlie Coyle,C,BOS,32,82,28,26,54
20,8482159,Tyson Foerster,R,PHI,22,82,22,32,54
20,8477407,Anthony Duclair,L,NYI,29,82,19,35,54
20,8476479,Phillip Danault,C,LAK,31,82,18,36,54
20,8476875,Mike Matheson,D,MTL,30,82,14,40,54
20,8476792,Torey Krug,D,STL,33,82,12,42,54
20,8479410,Mikhail Sergachev,D,UTA,26,82,11,43,54
20,8471724,Kris Letang,D,PIT,37,82,9,45,54
20,8477479,Tyler Bertuzzi,L,CHI,29,82,24,29,53
20,8476905,Chandler Stephenson,C,SEA,30,82,11,42,53
20,8478397,Rasmus Andersson,D,CGY,28,82,8,45,53
20,8475314,Anders Lee,L,NYI,34,82,30,22,52
20,8473986,Alex Killorn,L,ANA,35,82,25,27,52
20,8477451,Ryan Hartman,R,MIN,30,82,24,28,52
20,8482149,Cole Perfetti,C,WPG,22,82,22,30,52
20,8477494,Jonathan Drouin,L,COL,29,82,20,32,52
20,8477955,Jared McCann,L,SEA,28,82,19,33,52
20,8475191,Reilly Smith,R,NYR,33,82,18,34,52
20,8477935,Sam Bennett,C,FLA,28,82,26,25,51
20,8481560,Arthur Kaliyev,R,LAK,23,82,26,25,51
20,8483515,Juraj Slafkovsky,L,MTL,20,82,25,26,51
20,8484144,Connor Bedard,C,CHI,19,82,24,27,51
20,8482475,Yegor Chinakhov,R,CBJ,23,82,23,28,51
20,8474102,David Perron,L,OTT,36,82,22,29,51
20,8480015,Owen Tippett,R,PHI,25,82,26,24,50
20,8477497,Sean Monahan,C,CBJ,30,82,21,29,50
20,8475799,Nino Niederreiter,R,WPG,32,82,21,29,50
20,8477986,Brandon Montour,D,SEA,30,82,18,32,50
20,8478055,Gustav Forsling,D,FLA,28,82,16,34,50
20,8475169,Evander Kane,L,EDM,33,82,24,25,49
20,8476483,Rickard Rakell,R,PIT,31,82,21,28,49
20,8475794,Tyler Seguin,C,DAL,32,82,21,28,49
20,8473563,Nicklas Backstrom,C,WSH,37,82,20,29,49
20,8477021,Alex Kerfoot,C,UTA,30,82,19,30,49
20,8481618,Alex Newhook,C,MTL,23,82,18,31,49
20,8479345,Jakob Chychrun,D,WSH,26,82,16,33,49
20,8481596,Shane Pinto,C,OTT,24,82,15,34,49
20,8482089,Jake Neighbours,L,STL,22,82,32,16,48
20,8471698,T.J. Oshie,R,WSH,38,82,22,26,48
20,8478233,Andrew Mangiapane,L,WSH,28,82,21,27,48
20,8477947,Sonny Milano,L,WSH,28,82,21,27,48
20,8481528,Dylan Cozens,C,BUF,23,82,19,29,48
20,8480185,Eetu Luostarinen,C,FLA,26,82,17,31,48
20,8475753,Justin Faulk,D,STL,32,82,14,34,48
20,8475763,Kevin Hayes,R,PIT,32,82,13,35,48
20,8481624,Ilya Mikheyev,R,CHI,30,82,13,35,48
20,8476462,Dougie Hamilton,D,NJD,31,82,11,37,48
20,8477495,Seth Jones,D,CHI,30,82,10,38,48
20,8476927,Teddy Blueger,C,VAN,30,82,21,26,47
20,8478463,Anthony Beauvillier,L,PIT,27,82,19,28,47
20,8477511,Anthony Mantha,R,CGY,30,82,18,29,47
20,8480798,Philipp Kurashev,C,CHI,25,82,16,31,47
20,8476869,Brady Skjei,D,NSH,30,82,15,32,47
20,8478038,Devon Toews,D,COL,30,82,7,40,47
20,8474149,Evgenii Dadonov,R,DAL,35,82,24,22,46
20,8476448,William Karlsson,C,VGK,31,82,19,27,46
20,8479525,Ross Colton,C,COL,28,82,19,27,46
20,8479365,Trent Frederic,C,BOS,26,82,19,27,46
20,8475714,Calle Jarnkrok,C,TOR,33,82,18,28,46
20,8478057,Dakota Joshua,C,VAN,28,82,25,20,45
20,8480849,Barrett Hayton,C,UTA,24,82,23,22,45
20,8476873,Mark Jankowski,C,NSH,30,82,22,23,45
20,8482113,Anton Lundell,C,FLA,23,82,19,26,45
20,8478458,Jack Roslovic,C,CAR,27,82,18,27,45
20,8477503,Max Domi,C,TOR,29,82,12,33,45
20,8480078,Filip Chytil,C,NYR,25,82,10,35,45
20,8480434,Sean Durzi,D,UTA,26,82,9,36,45
20,8478046,Danton Heinen,L,VAN,29,82,27,17,44
20,8482699,Dylan Guenther,R,UTA,21,82,20,24,44
20,8476438,Brandon Saad,L,STL,32,82,20,24,44
20,8476419,Jean-Gabriel Pageau,C,NYI,32,82,18,26,44
20,8474565,Alex Pietrangelo,D,VGK,34,82,11,33,44
20,8477948,Travis Sanheim,D,PHI,28,82,7,37,44
20,8482109,Alexis Lafrenière,L,NYR,23,82,24,19,43
20,8478474,Lawson Crouse,L,UTA,27,82,23,20,43
20,8474586,Jordan Eberle,R,SEA,34,82,20,23,43
20,8480028,Morgan Frost,C,PHI,25,82,18,25,43
20,8475791,Taylor Hall,L,CHI,33,82,16,27,43
20,8476925,Colton Sissons,C,NSH,31,82,15,28,43
20,8480220,Noah Cates,L,PHI,25,82,14,29,43
20,8476897,Oskar Sundqvist,C,STL,30,82,13,30,43
20,8480145,Neal Pionk,D,WPG,29,82,10,33,43
20,8470613,Brent Burns,D,CAR,39,82,9,34,43
20,8481656,Aliaksei Protas,C,WSH,23,82,8,35,43
20,8477456,J.T. Compher,L,DET,29,82,22,20,42
20,8482745,Mason McTavish,C,ANA,21,82,21,21,42
20,8477998,Warren Foegele,L,LAK,28,82,21,21,42
20,8476826,Yanni Gourde,C,SEA,33,82,14,28,42
20,8482671,Owen Power,D,BUF,22,82,11,31,42
20,8481604,Pavel Dorofeyev,L,VGK,24,82,24,17,41
20,8481013,Jonatan Berggren,R,DET,24,82,23,18,41
20,8480835,Jack Drury,C,CAR,24,82,18,23,41
20,8478462,Nicolas Roy,C,VGK,27,82,18,23,41
20,8478519,Anthony Cirelli,C,TBL,27,82,16,25,41
20,8478472,Mathieu Joseph,R,STL,27,82,14,27,41
20,8476458,Ryan Strome,C,ANA,31,82,12,29,41
20,8480817,K'Andre Miller,D,NYR,24,82,11,30,41
20,8474641,Adam Henrique,C,EDM,34,82,24,16,40
20,8482175,JJ Peterka,R,BUF,22,82,21,19,40
20,8480009,Eeli Tolvanen,R,SEA,25,82,19,21,40
20,8478469,Thomas Chabot,D,OTT,27,82,14,26,40
20,8477429,Andrew Copp,C,DET,30,82,13,27,40
20,8477498,Darnell Nurse,D,EDM,29,82,5,35,40
20,8478500,Ivan Provorov,D,CBJ,27,82,4,36,40
20,8479996,Cody Glass,C,NSH,25,82,15,24,39
20,8481580,Connor McMichael,C,WSH,23,82,14,25,39
20,8479393,Noah Gregor,C,OTT,26,82,14,25,39
20,8479987,Morgan Geekie,C,BOS,26,82,13,26,39
20,8476906,Shayne Gostisbehere,D,CAR,31,82,11,28,39
20,8482705,Cole Sillinger,C,CBJ,21,82,10,29,39
20,8480873,Rasmus Sandin,D,WSH,24,82,5,34,39
20,8476960,Andreas Athanasiou,C,CHI,30,82,18,20,38
20,8482117,Lukas Reichel,L,CHI,22,82,18,20,38
20,8477426,Nicholas Paul,L,TBL,29,82,17,21,38
20,8474053,Logan Couture,C,SJS,35,82,16,22,38
20,8476480,Vladislav Namestnikov,C,WPG,32,82,14,24,38
20,8475149,Marcus Johansson,L,MIN,34,82,14,24,38
20,8480829,Jesperi Kotkaniemi,C,CAR,24,82,13,25,38
20,8477932,Aaron Ekblad,D,FLA,28,82,8,30,38
20,8482105,Jake Sanderson,D,OTT,22,82,8,30,38
20,8474574,Tyler Myers,D,VAN,34,82,7,31,38
20,8475848,Brendan Gallagher,R,MTL,32,82,22,15,37
20,8480113,Alex Iafallo,L,WPG,31,82,19,18,37
20,8476921,Jordan Martinook,L,CAR,32,82,16,21,37
20,8476292,Ondrej Palat,L,NJD,33,82,15,22,37
20,8480003,Jesper Boqvist,C,FLA,26,82,12,25,37
20,8476329,Travis Boyd,C,MIN,31,82,12,25,37
20,8477839,Conor Sheary,L,TBL,32,82,11,26,37
20,8481581,Thomas Harley,D,DAL,23,82,10,27,37
20,8477220,Nate Schmidt,D,FLA,33,82,9,28,37
20,8478882,Vladislav Gavrikov,D,LAK,29,82,4,33,37
20,8478020,Michael Amadio,C,OTT,28,82,23,13,36
20,8481535,Nils Hoglander,L,VAN,24,82,22,14,36
20,8481186,Logan O'Connor,R,COL,28,82,18,18,36
20,8479941,Justin Danforth,R,CBJ,31,82,17,19,36
20,8476461,Sean Couturier,C,PHI,32,82,16,20,36
20,8474716,Jared Spurgeon,D,MIN,35,82,14,22,36
20,8481711,Matias Maccelli,L,UTA,24,82,11,25,36
20,8476854,Hampus Lindholm,D,BOS,30,82,7,29,36
20,8482245,Artem Zub,D,OTT,29,82,4,32,36
20,8477987,Ryan Donato,C,CHI,28,82,19,16,35
20,8475722,Jason Zucker,L,BUF,32,82,17,18,35
20,8482146,Luke Evangelista,R,NSH,22,82,15,20,35
20,8475768,Jaden Schwartz,C,SEA,32,82,15,20,35
20,8477425,Miles Wood,L,COL,29,82,15,20,35
20,8480813,Joe Veleno,C,DET,24,82,13,22,35
20,8477369,Carson Soucy,D,VAN,30,82,12,23,35
20,8476474,Stefan Noesen,R,NJD,31,82,9,26,35
20,8482122,Brock Faber,D,MIN,22,82,9,26,35
20,8479992,Michael Rasmussen,C,DET,25,82,16,18,34
20,8474189,Lars Eller,C,PIT,35,82,15,19,34
20,8480855,Jack McBain,C,UTA,24,82,15,19,34
20,8479661,Tanner Jeannot,L,LAK,27,82,14,20,34
20,8473533,Jordan Staal,C,CAR,36,82,13,21,34
20,8476278,Colin Blackwell,C,DAL,31,82,12,22,34
20,8476885,Jacob Trouba,D,NYR,30,82,10,24,34
20,8475200,Dmitry Orlov,D,CAR,33,82,9,25,34
20,8475218,Mattias Ekholm,D,EDM,34,82,8,26,34
20,8476918,Jimmy Vesey,L,NYR,31,82,22,11,33
20,8480459,Pius Suter,C,VAN,28,82,17,16,33
20,8480980,Connor Dewar,C,TOR,25,82,17,16,33
20,8481554,Kaapo Kakko,R,NYR,23,82,16,17,33
20,8479980,Nicolas Hague,D,VGK,26,82,14,19,33
20,8476872,Scott Laughton,C,PHI,30,82,11,22,33
20,8481553,Bobby Brink,R,PHI,23,82,10,23,33
20,8475171,Oliver Ekman-Larsson,D,TOR,33,82,9,24,33
20,8478013,Jake Walman,D,SJS,28,82,7,26,33
20,8475764,Cam Fowler,D,ANA,33,82,6,27,33
20,8476463,Jonas Brodin,D,MIN,31,82,3,30,33
20,8480049,Dylan Samberg,D,WPG,25,82,3,30,33
20,8476331,Dylan DeMelo,D,WPG,31,82,3,30,33
20,8479293,Brandon Tanev,L,SEA,33,82,20,12,32
20,8476392,Adam Lowry,C,WPG,31,82,17,15,32
20,8482133,Thomas Bordeleau,C,SJS,22,82,16,16,32
20,8482111,Justin Barron,D,MTL,23,82,15,17,32
20,8475193,Tomas Tatar,L,NJD,34,82,13,19,32
20,8480806,Isac Lundestrom,C,ANA,25,82,10,22,32
20,8483490,Pavel Mintyukov,D,ANA,21,82,8,24,32
20,8478133,Jake Evans,C,MTL,28,82,7,25,32
20,8474673,TJ Brodie,D,CHI,34,82,4,28,32
20,8480043,Timothy Liljegren,D,TOR,25,82,1,31,32
20,8482125,Alexander Holtz,R,VGK,22,82,22,9,31
20,8482079,Marco Rossi,C,MIN,23,82,17,14,31
20,8475287,Erik Haula,L,NJD,33,82,16,15,31
20,8481582,Nicholas Robertson,L,TOR,23,82,15,16,31
20,8475793,Ryan Johansen,C,PHI,32,82,15,16,31
20,8475231,Casey Cizikas,C,NYI,33,82,14,17,31
20,8480068,Ryan Poehling,C,PHI,25,82,13,18,31
20,8484145,Zach Benson,L,BUF,19,82,12,19,31
20,8479353,Brett Howden,C,VGK,26,82,12,19,31
20,8480802,Ryan McLeod,C,BUF,25,82,11,20,31
20,8480748,Kiefer Sherwood,L,VAN,29,82,9,22,31
20,8482660,Kent Johnson,C,CBJ,22,82,9,22,31
20,8483457,Lane Hutson,D,MTL,20,82,9,22,31
20,8481704,Juuso Parssinen,C,NSH,23,82,8,23,31
20,8480878,Nils Lundkvist,D,DAL,24,82,8,23,31
20,8476958,Jaccob Slavin,D,CAR,30,82,7,24,31
20,8479398,Samuel Girard,D,COL,26,82,6,25,31
20,8476891,Matt Grzelcyk,D,PIT,30,82,2,29,31
20,8475760,Nick Bjugstad,C,UTA,32,82,17,13,30
20,8481032,Paul Cotter,C,NJD,25,82,16,14,30
20,8477903,Garnet Hathaway,R,PHI,33,82,16,14,30
20,8477392,Hudson Fasching,R,NYI,29,82,15,15,30
20,8479351,Sam Steel,C,DAL,26,82,14,16,30
20,8482762,Simon Edvinsson,D,DET,21,82,14,16,30
20,8482624,Daniil Miromanov,D,CGY,27,82,13,17,30
20,8477450,Jason Dickinson,C,CHI,29,82,13,17,30
20,8478115,Pierre Engvall,L,NYI,28,82,10,20,30
20,8476457,Adam Larsson,D,SEA,32,82,10,20,30
20,8482807,Ethan Del Mastro,D,CHI,21,82,8,22,30
20,8479983,Mario Ferraro,D,SJS,26,82,8,22,30
20,8476902,Esa Lindell,D,DAL,30,82,4,26,30
20,8478507,John Marino,D,UTA,27,82,1,29,30
20,8482055,Drew O'Connor,L,PIT,26,82,19,10,29
20,8476374,Sean Kuraly,C,CBJ,31,82,13,16,29
20,8477353,Tyler Motte,C,DET,29,82,12,17,29
20,8481481,Blake Lizotte,C,PIT,27,82,11,18,29
20,8480995,Pontus Holmberg,R,TOR,25,82,10,19,29
20,8478413,Jordan Greenway,L,BUF,27,82,7,22,29
20,8474151,Ryan McDonagh,D,TBL,35,82,7,22,29
20,8473507,Jeff Petry,D,DET,37,82,7,22,29
20,8474013,Ian Cole,D,UTA,35,82,6,23,29
20,8476923,Damon Severson,D,CBJ,30,82,5,24,29
20,8475690,Chris Tanev,D,TOR,35,82,0,29,29
20,8476878,Zemgus Girgensons,L,TBL,30,82,18,10,28
20,8473422,Nick Foligno,L,CHI,37,82,16,12,28
20,8481601,Simon Holmstrom,R,NYI,23,82,16,12,28
20,8482092,Ridly Greig,C,OTT,22,82,14,14,28
20,8479390,Taylor Raddysh,R,WSH,26,82,13,15,28
20,8470621,Corey Perry,R,EDM,39,82,11,17,28
20,8477952,Robby Fabbri,C,ANA,28,82,10,18,28
20,8477015,Connor Brown,R,EDM,30,82,10,18,28
20,8482720,Matthew Knies,L,TOR,22,82,9,19,28
20,8476312,Josh Manson,D,COL,33,82,9,19,28
20,8478911,Matt Roy,D,WSH,29,82,8,20,28
20,8477931,Tomas Nosek,L,FLA,32,82,8,20,28
20,8480073,Erik Brannstrom,D,COL,25,82,4,24,28
20,8481014,Alexander Romanov,D,NYI,24,82,3,25,28
20,8476931,Jake McCabe,D,TOR,31,82,1,27,28
20,8481093,Rafael Harvey-Pinard,L,MTL,25,82,15,12,27
20,8476469,Joel Armia,R,MTL,31,82,14,13,27
20,8475855,Jesper Fast,R,CAR,33,82,14,13,27
20,8473453,Trevor Lewis,C,LAK,37,82,14,13,27
20,8475842,Sam Carrick,C,NYR,32,82,13,14,27
20,8477435,Ryan Graves,D,PIT,29,82,10,17,27
20,8481477,Nico Sturm,C,SJS,29,82,10,17,27
20,8477507,Nikita Zadorov,D,BOS,29,82,10,17,27
20,8479371,Dante Fabbro,D,NSH,26,82,5,22,27
20,8477506,Ryan Pulock,D,NYI,30,82,4,23,27
20,8477969,Marcus Pettersson,D,PIT,28,82,2,25,27
20,8476979,Erik Gustafsson,D,DET,32,82,2,25,27
20,8475220,Marcus Foligno,L,MIN,33,82,16,10,26
20,8482074,Connor Zary,C,CGY,23,82,15,11,26
20,8481028,Martin Pospisil,C,CGY,25,82,15,11,26
20,8482062,Cole Smith,L,NSH,29,82,14,12,26
20,8480021,Jack Studnicka,C,LAK,25,82,14,12,26
20,8483431,Logan Cooley,C,UTA,20,82,13,13,26
20,8480789,Oliver Wahlstrom,R,NYI,24,82,12,14,26
20,8474715,Cam Atkinson,R,TBL,35,82,10,16,26
20,8476467,Jamie Oleksiak,D,SEA,32,82,8,18,26
20,8482803,Olen Zellweger,D,ANA,21,82,8,18,26
20,8481546,Cam York,D,PHI,23,82,7,19,26
20,8482166,Shakir Mukhamadullin,D,SJS,22,82,6,20,26
20,8480893,Kirill Marchenko,R,CBJ,24,82,18,7,25
20,8484166,Adam Fantilli,C,CBJ,20,82,16,9,25
20,8478109,Victor Olofsson,L,VGK,29,82,12,13,25
20,8479316,Luke Kunin,C,SJS,27,82,11,14,25
20,8477919,Frederick Gaudreau,C,MIN,31,82,9,16,25
20,8477989,Christian Dvorak,C,MTL,28,82,8,17,25
20,8482733,Logan Mailloux,D,MTL,31,82,8,17,25
20,8483499,Liam Ohgren,L,MIN,20,82,8,17,25
20,8479368,Max Jones,L,BOS,26,82,7,18,25
20,8475324,Nick Jensen,D,OTT,34,82,6,19,25
20,8481606,Jordan Spence,D,LAK,23,82,5,20,25
20,8479976,Juuso Valimaki,D,UTA,26,82,3,22,25
20,8481178,Egor Zamula,D,PHI,24,82,3,22,25
20,8476981,Josh Anderson,R,MTL,30,82,17,7,24
20,8478508,Yakov Trenin,C,MIN,27,82,13,11,24
20,8482666,Scott Morrow,D,CAR,22,82,13,11,24
20,8478569,Noel Acciari,C,PIT,33,82,12,12,24
20,8477406,Mattias Janmark,C,EDM,32,82,12,12,24
20,8480871,Adam Boqvist,D,FLA,24,82,9,15,24
20,8480336,Sean Walker,D,CAR,30,82,7,17,24
20,8479291,Kevin Rooney,C,CGY,31,82,7,17,24
20,8477845,Trevor van Riemsdyk,D,WSH,33,82,5,19,24
20,8480172,Jan Rutta,D,SJS,34,82,5,19,24
20,8478136,Jake Middleton,D,MIN,28,82,3,21,24
20,8477488,Brett Pesce,D,NJD,30,82,2,22,24
20,8478851,Alexandre Carrier,D,NSH,28,82,0,24,24
20,8482702,Logan Stankoven,C,DAL,21,82,11,12,23
20,8476858,Phillip Di Giuseppe,L,VAN,31,82,11,12,23
20,8482470,Ilya Solovyov,D,CGY,24,82,10,13,23
20,8483565,Nick Blankenburg,D,NSH,26,82,9,14,23
20,8479402,Jake Bean,D,CGY,26,82,6,17,23
20,8476967,Brett Kulak,D,EDM,30,82,6,17,23
20,8480074,Alexandre Texier,C,STL,25,82,5,18,23
20,8479998,Mikey Anderson,D,LAK,25,82,5,18,23
20,8475462,Radko Gudas,D,ANA,34,82,3,20,23
20,8476917,Adam Pelech,D,NYI,30,82,2,21,23
20,8478468,Jeremy Lauzon,D,NSH,27,82,2,21,23
20,8478434,Keegan Kolesar,R,VGK,27,82,13,9,22
20,8477508,Curtis Lazar,C,NJD,29,82,11,11,22
20,8476442,Matt Nieto,L,PIT,32,82,11,11,22
20,8475343,Nic Dowd,C,WSH,34,82,10,12,22
20,8484203,Bradly Nadeau,L,CAR,19,82,9,13,22
20,8480144,David Kampf,C,TOR,29,82,9,13,22
20,8484153,Leo Carlsson,C,ANA,20,82,9,13,22
20,8478891,Mason Appleton,C,WPG,28,82,7,15,22
20,8475718,Justin Holl,D,DET,32,82,4,18,22
20,8480246,Nick Perbix,D,TBL,26,82,3,19,22
20,8480807,Mattias Samuelsson,D,BUF,24,82,1,21,22
20,8477953,Kasperi Kapanen,R,STL,28,82,10,11,21
20,8476889,Radek Faksa,C,STL,30,82,9,12,21
20,8479359,Beck Malenstyn,L,BUF,26,82,9,12,21
20,8474567,Zach Bogosian,D,MIN,34,82,8,13,21
20,8482101,Danil Gushchin,L,SJS,22,82,7,14,21
20,8479414,Nathan Bastian,R,NJD,27,82,6,15,21
20,8475790,Erik Gudbranson,D,CBJ,32,82,6,15,21
20,8482679,Matt Coronato,R,CGY,22,82,6,15,21
20,8478178,Darren Raddysh,D,TBL,28,82,6,15,21
20,8483445,Cutter Gauthier,L,ANA,20,82,5,16,21
20,8482073,Braden Schneider,D,NYR,23,82,4,17,21
20,8476879,Cody Ceci,D,EDM,31,82,2,19,21
20,8478211,Dryden Hunt,L,CGY,29,82,13,7,20
20,8482809,Jackson Blake,R,CAR,21,82,9,11,20
20,8479591,Michael Eyssimont,C,TBL,28,82,8,12,20
20,8476624,Barclay Goodrow,C,SJS,31,82,7,13,20
20,8478432,Christian Fischer,R,DET,27,82,6,14,20
20,8480222,Sebastian Aho,D,PIT,28,82,5,15,20
20,8480990,Declan Chisholm,D,MIN,24,82,4,16,20
20,8478840,Will Borgen,D,SEA,28,82,3,17,20
20,8482655,J.J. Moser,D,TBL,24,82,2,18,20
20,8475181,Nick Leddy,D,STL,33,82,2,18,20
20,8483493,Frank Nazar,C,CHI,20,82,9,10,19
20,8483763,Maksymilian Szuber,D,UTA,22,82,7,12,19
20,8479638,Justin Brazeau,R,BOS,26,82,6,13,19
20,8481567,Henry Thrun,D,SJS,23,82,6,13,19
20,8481517,Brett Leason,R,ANA,25,82,5,14,19
20,8478399,Jonas Siegenthaler,D,NJD,27,82,4,15,19
20,8482142,Jamie Drysdale,D,PHI,22,82,1,18,19
20,8479369,Andrew Peeke,D,BOS,26,82,1,18,19
20,8482259,Bobby McMann,C,TOR,28,82,14,4,18
20,8482118,Sam Colangelo,R,ANA,23,82,12,6,18
20,8476822,Luke Glendening,C,TBL,35,82,11,7,18
20,8477505,Alexander Wennberg,C,SJS,30,82,8,10,18
20,8483012,Logan Morrison,C,SEA,22,82,8,10,18
20,8482659,Josh Doan,R,UTA,22,82,7,11,18
20,8475279,Ben Chiarot,D,DET,33,82,6,12,18
20,8477499,Rasmus Ristolainen,D,PHI,30,82,5,13,18
20,8476525,Colin Miller,D,WPG,32,82,5,13,18
20,8483495,Simon Nemec,D,NJD,20,82,5,13,18
20,8470600,Ryan Suter,D,STL,39,82,4,14,18
20,8480796,Martin Fehervary,D,WSH,25,82,4,14,18
20,8476372,Nick Seeler,D,PHI,31,82,3,15,18
20,8476473,Connor Murphy,D,CHI,31,82,3,15,18
20,8475188,Brayden McNabb,D,VGK,33,82,2,16,18
20,8480879,Jacob Bernard-Docker,D,OTT,24,82,2,16,18
20,8482087,Kaiden Guhle,D,MTL,22,82,1,17,18
20,8482155,Alex Laferriere,R,LAK,23,82,9,8,17
20,8482077,Dylan Holloway,L,EDM,23,82,8,9,17
20,8481522,Peyton Krebs,C,BUF,23,82,7,10,17
20,8476422,Mike Reilly,D,NYI,31,82,6,11,17
20,8482787,Nikita Chibrikov,R,WPG,31,82,6,11,17
20,8479324,Ryan Lindgren,D,NYR,26,82,4,13,17
20,8483460,David Jiricek,D,CBJ,21,82,4,13,17
20,8479576,Vincent Desharnais,D,VAN,28,82,3,14,17
20,8477365,Connor Clifton,D,BUF,29,82,2,15,17
20,8476429,Scott Mayfield,D,NYI,32,82,2,15,17
20,8478416,Erik Cernak,D,TBL,27,82,1,16,17
20,8481568,Alex Vlasic,D,CHI,23,82,0,17,17
20,8480281,Alexey Toropchenko,R,STL,25,82,13,3,16
20,8481605,Jackson LaCombe,D,ANA,23,82,7,9,16
20,8482141,Lukas Cormier,D,VGK,22,82,6,10,16
20,8482859,Zack Ostapchuk,C,OTT,21,82,6,10,16
20,8476892,Colton Parayko,D,STL,31,82,5,11,16
20,8481699,Aku Raty,R,UTA,23,82,5,11,16
20,8481708,Zac Jones,D,NYR,24,82,5,11,16
20,8483468,Jiri Kulich,C,BUF,20,82,4,12,16
20,8482516,Matthew Kessel,D,STL,24,82,3,13,16
20,8480035,Henri Jokiharju,D,BUF,25,82,2,14,16
20,8475455,Brenden Dillon,D,NJD,34,82,2,14,16
20,8477938,Haydn Fleury,D,WPG,28,82,2,14,16
20,8481524,Bowen Byram,D,BUF,23,82,9,6,15
20,8481641,Joel Kiviranta,L,COL,28,82,6,9,15
20,8481122,Simon Benoit,D,TOR,26,82,6,9,15
20,8484911,Collin Graf,R,SJS,22,82,5,10,15
20,8483482,Tristan Luneau,D,ANA,20,82,4,11,15
20,8475177,Calvin de Haan,D,COL,33,82,4,11,15
20,8482153,Brendan Brisson,C,VGK,23,82,4,11,15
20,8475762,Derek Forbort,D,VAN,32,82,4,11,15
20,8484149,Gavin Brindley,C,CBJ,20,82,3,12,15
20,8478443,Brandon Carlo,D,BOS,28,82,3,12,15
20,8482858,Ryker Evans,D,SEA,23,82,3,12,15
20,8480448,Parker Kelly,L,COL,25,82,6,8,14
20,8483489,Fraser Minten,C,TOR,31,82,5,9,14
20,8478859,Niko Mikkola,D,FLA,28,82,4,10,14
20,8474090,Brendan Smith,D,DAL,35,82,4,10,14
20,8480860,Kevin Bahl,D,CGY,24,82,3,11,14
20,8483397,Marc McLaughlin,C,BOS,25,82,7,6,13
20,8483505,Matthew Poitras,C,BOS,20,82,7,6,13
20,8482749,Joshua Roy,R,MTL,21,82,4,9,13
20,8482713,Mackie Samoskevich,R,FLA,22,82,3,10,13
20,8479442,Troy Stecher,D,EDM,30,82,3,10,13
20,8477335,Kyle Burroughs,D,LAK,29,82,1,12,13
20,8480870,Bo Groulx,C,NYR,24,82,3,9,12
20,8478874,Adam Gaudette,C,OTT,28,82,2,10,12
20,8476441,Joel Edmundson,D,LAK,31,82,1,11,12
20,8480025,MacKenzie Entwistle,R,FLA,25,82,5,6,11
20,8478450,Parker Wotherspoon,D,BOS,27,82,5,6,11
20,8475233,David Savard,D,MTL,34,82,2,9,11
20,8480950,Ilya Lyubushkin,D,DAL,30,82,1,10,11
20,8482712,Oskar Olausson,R,COL,22,82,5,5,10
20,8483567,Georgii Merkulov,C,BOS,24,82,4,6,10
20,8480834,Ty Emberson,D,SJS,24,82,3,7,10
20,8483471,Brad Lambert,C,WPG,31,82,2,8,10
20,8483524,Shane Wright,C,SEA,20,82,2,8,10
20,8471677,Jack Johnson,D,CBJ,37,82,2,8,10
20,8477034,Jaycob Megna,D,FLA,32,82,4,5,9
20,8482145,Mavrik Bourque,C,DAL,22,82,4,5,9
20,8483466,Kevin Korchinski,D,CHI,20,82,1,8,9
20,8482070,Mitchell Chaffee,R,TBL,26,82,6,2,8
20,8474062,Riley Nash,C,NYR,35,82,3,5,8
20,8474612,Travis Hamonic,D,OTT,34,82,2,4,6
20,8470794,Joe Pavelski,C,,40,0,0,0,0
20,8481703,Valtteri Puustinen,R,PIT,25,0,0,0,0
20,8477950,Tony DeAngelo,D,,29,0,0,0,0
20,8481577,Philip Tomasino,C,NSH,23,0,0,0,0
20,8475197,Tyson Barrie,D,,33,0,0,0,0
20,8471218,Blake Wheeler,R,,38,0,0,0,0
20,8474157,Max Pacioretty,L,,36,0,0,0,0
20,8478466,Daniel Sprong,R,VAN,27,0,0,0,0
20,8475744,Evgeny Kuznetsov,C,,32,0,0,0,0
20,8481019,David Gustafsson,C,WPG,24,0,0,0,0
20,8475906,John Klingberg,D,,32,0,0,0,0
20,8479348,Kale Clague,D,BUF,26,0,0,0,0
20,8476952,Dominic Toninato,C,WPG,30,0,0,0,0
20,8473473,Milan Lucic,L,,36,0,0,0,0
20,8474037,James van Riemsdyk,L,,35,0,0,0,0
20,8474602,Justin Schultz,D,,34,0,0,0,0
20,8482222,Alexander Barabanov,L,,30,0,0,0,0
20,8479372,Josh Mahura,D,SEA,26,0,0,0,0
20,8479982,Conor Timmins,D,TOR,26,0,0,0,0
20,8474031,Kevin Shattenkirk,D,,35,0,0,0,0
20,8480008,Adam Ruzicka,C,,25,0,0,0,0
20,8481059,Scott Perunovich,D,STL,26,0,0,0,0
20,8480884,Calen Addison,D,,24,0,0,0,0
20,8476994,Vinnie Hinostroza,C,NSH,30,0,0,0,0
20,8478452,Caleb Jones,D,LAK,27,0,0,0,0
20,8480157,Calle Rosen,D,COL,30,0,0,0,0
20,8481609,Vladislav Kolyachonok,D,UTA,23,0,0,0,0
20,8479415,Michael McLeod,C,,26,0,0,0,0
20,8476919,Chris Tierney,C,,30,0,0,0,0
20,8479639,Dylan Coghlan,D,WPG,26,0,0,0,0
20,8478146,Matthew Highmore,C,OTT,28,0,0,0,0
20,8478970,Jalen Chatfield,D,CAR,28,0,0,0,0
20,8480205,Emil Bemstrom,C,PIT,25,0,0,0,0
20,8474884,Mike Hoffman,C,,35,0,0,0,0
20,8471274,Alex Goligoski,D,,39,0,0,0,0
20,8478104,Sammy Blais,L,,28,0,0,0,0
20,8474870,Tyler Johnson,C,,34,0,0,0,0
20,8476913,Devin Shore,C,MIN,30,0,0,0,0
20,8481598,Philip Broberg,D,EDM,23,0,0,0,0
20,8480058,Pierre-Olivier Joseph,D,STL,25,0,0,0,0
20,8480891,Michael Kesselring,D,UTA,24,0,0,0,0
20,8477979,Nicolas Aube-Kubel,R,BUF,28,0,0,0,0
20,8476871,Tanner Pearson,L,,32,0,0,0,0
20,8476393,Nick Cousins,C,,31,0,0,0,0
20,8479977,Kailer Yamamoto,R,,26,0,0,0,0
20,8479543,Michael Pezzetta,L,MTL,26,0,0,0,0
20,8477018,Ben Hutton,D,VGK,31,0,0,0,0
20,8480762,Eric Robinson,L,CAR,29,0,0,0,0
20,8474034,Pat Maroon,L,CHI,36,0,0,0,0
20,8481058,Jesse Ylönen,R,,25,0,0,0,0
20,8475179,Dmitry Kulikov,D,FLA,34,0,0,0,0
20,8481527,Kaedan Korczak,D,VGK,23,0,0,0,0
20,8473449,Kyle Okposo,R,,36,0,0,0,0
20,8482192,Isaak Phillips,D,CHI,23,0,0,0,0
20,8480727,Zach Whitecloud,D,VGK,28,0,0,0,0
20,8479346,Dillon Dube,C,,26,0,0,0,0
20,8480821,Filip Zadina,R,,25,0,0,0,0
20,8480001,Urho Vaakanainen,D,ANA,25,0,0,0,0
20,8470966,Mark Giordano,D,,41,0,0,0,0
20,8480853,Liam Foudy,C,,24,0,0,0,0
20,8475225,Craig Smith,C,CHI,35,0,0,0,0
20,8479972,Mason Shaw,C,WPG,26,0,0,0,0
20,8478451,Ethan Bear,D,WSH,27,0,0,0,0
20,8474040,Sam Gagner,C,,35,0,0,0,0
20,8480196,Jacob Bryson,D,BUF,27,0,0,0,0
20,8479984,Cal Foote,D,,26,0,0,0,0
20,8480011,Klim Kostin,C,SJS,25,0,0,0,0
20,8482176,Wyatt Kaiser,D,CHI,22,0,0,0,0
20,8476988,Matt Benning,D,SJS,30,0,0,0,0
20,8479370,Tyson Jost,C,CAR,26,0,0,0,0
20,8477464,Nic Petan,C,,29,0,0,0,0
20,8477380,Jonny Brodzinski,C,NYR,31,0,0,0,0
20,8480070,Ian Mitchell,D,BOS,25,0,0,0,0
20,8479315,Joey Anderson,R,CHI,26,0,0,0,0
20,8478099,Kevin Labanc,R,,29,0,0,0,0
20,8476874,Olli Maatta,D,DET,30,0,0,0,0
20,8475208,Brian Dumoulin,D,ANA,33,0,0,0,0
20,8478430,Oliver Kylington,D,,27,0,0,0,0
20,8479536,Axel Jonsson-Fjallby,L,WPG,26,0,0,0,0
20,8479671,Mathieu Olivier,R,CBJ,27,0,0,0,0
20,8471709,Marc-Edouard Vlasic,D,SJS,37,0,0,0,0
20,8479328,Julien Gauthier,R,NYI,27,0,0,0,0
20,8478421,A.J. Greer,L,FLA,28,0,0,0,0
20,8477573,Nathan Walker,L,STL,30,0,0,0,0
20,8481537,Nikita Okhotiuk,D,CGY,24,0,0,0,0
20,8474166,Alec Martinez,D,CHI,37,0,0,0,0
20,8470610,Zach Parise,L,,40,0,0,0,0
20,8477478,William Carrier,L,CAR,30,0,0,0,0
20,8479344,Jesse Puljujarvi,R,PIT,26,0,0,0,0
20,8480887,Jordan Harris,D,MTL,24,0,0,0,0
20,8478502,Dennis Gilbert,D,BUF,28,0,0,0,0
20,8482730,Brandt Clarke,D,LAK,21,0,0,0,0
20,8480355,Mark Kastelic,C,BOS,25,0,0,0,0
20,8475750,Jon Merrill,D,MIN,32,0,0,0,0
20,8475164,Jakob Silfverberg,R,,34,0,0,0,0
20,8477944,Jakub Vrana,L,,28,0,0,0,0
20,8479439,Jacob MacDonald,D,COL,31,0,0,0,0
20,8474568,Luke Schenn,D,NSH,35,0,0,0,0
20,8478454,Noah Juulsen,D,VAN,27,0,0,0,0
20,8475752,Tyler Pitlick,C,,33,0,0,0,0
20,8482148,Hendrix Lapierre,C,WSH,22,0,0,0,0
20,8481167,Brayden Pachal,D,CGY,25,0,0,0,0
20,8478043,Sam Lafferty,C,BUF,29,0,0,0,0
20,8479321,Lucas Johansen,D,,27,0,0,0,0
20,8471699,Andrew Cogliano,C,,37,0,0,0,0
20,8481521,Ronnie Attard,D,PHI,25,0,0,0,0
20,8481161,Jake Christiansen,D,CBJ,25,0,0,0,0
20,8479458,Nikita Zaitsev,D,,33,0,0,0,0
20,8479619,Michael Carcone,L,UTA,28,0,0,0,0
20,8479026,Philippe Myers,D,TOR,27,0,0,0,0
20,8477330,Dominik Kubalik,L,,29,0,0,0,0
20,8481617,Vasily Podkolzin,R,VAN,23,0,0,0,0
20,8481701,Santeri Hatakka,D,NJD,23,0,0,0,0
20,8479514,Rem Pitlick,C,,27,0,0,0,0
20,8477446,Michael McCarron,R,NSH,29,0,0,0,0
20,8470604,Jeff Carter,C,,39,0,0,0,0
20,8482241,Radim Zohorna,L,,28,0,0,0,0
20,8480289,Morgan Barron,C,WPG,26,0,0,0,0
20,8479379,Givani Smith,R,SJS,26,0,0,0,0
20,8480216,Jacob Peterson,C,,25,0,0,0,0
20,8477851,Jordan Oesterle,D,BOS,32,0,0,0,0
20,8484258,Sam Malinski,D,COL,26,0,0,0,0
20,8478904,Steven Lorentz,C,,28,0,0,0,0
20,8482095,Tyler Kleven,D,OTT,22,0,0,0,0
20,8480848,Ty Dellandrea,C,SJS,24,0,0,0,0
20,8476884,Derrick Pouliot,D,,30,0,0,0,0
20,8479336,Carl Grundstrom,R,SJS,27,0,0,0,0
20,8482964,Arber Xhekaj,D,MTL,23,0,0,0,0
20,8471686,Marc Staal,D,,37,0,0,0,0
20,8477887,Patrick Brown,C,BOS,32,0,0,0,0
20,8478495,Denis Gurianov,R,,27,0,0,0,0
20,8473504,Cal Clutterbuck,R,,37,0,0,0,0
20,8481550,Adam Beckman,L,NJD,23,0,0,0,0
20,8480845,Rasmus Kupari,C,WPG,24,0,0,0,0
20,8474009,Nick Bonino,C,,36,0,0,0,0
20,8478585,Derek Ryan,C,EDM,38,0,0,0,0
20,8477962,Brendan Lemieux,L,CAR,28,0,0,0,0
20,8482861,Vincent Iorio,D,WSH,22,0,0,0,0
20,8479378,Logan Stanley,D,WPG,26,0,0,0,0
20,8473446,Erik Johnson,D,PHI,36,0,0,0,0
20,8481743,Marc Del Gaizo,D,NSH,25,0,0,0,0
20,8477384,Josh Brown,D,EDM,30,0,0,0,0
20,8482165,Yan Kuznetsov,D,CGY,22,0,0,0,0
20,8478424,Jansen Harkins,C,ANA,27,0,0,0,0
20,8482144,Jack Thompson,D,SJS,22,0,0,0,0
20,8478512,Austin Czarnik,C,,32,0,0,0,0
20,8477527,Ross Johnston,L,ANA,30,0,0,0,0
20,8479383,Boris Katchouk,L,,26,0,0,0,0
20,8482094,Daemon Hunt,D,MIN,22,0,0,0,0
20,8481719,Maxwell Crozier,D,TBL,24,0,0,0,0
20,8480192,Johnathan Kovacevic,D,NJD,27,0,0,0,0
20,8479376,Victor Mete,D,,26,0,0,0,0
20,8482511,Mason Lohrei,D,BOS,23,0,0,0,0
20,8475825,Jani Hakanpää,D,,32,0,0,0,0
20,8478021,William Lagesson,D,DET,28,0,0,0,0
20,8475795,Dylan McIlrath,D,WSH,32,0,0,0,0
20,8477846,Ryan Carpenter,C,,33,0,0,0,0
20,8481056,Spencer Stastney,D,NSH,24,0,0,0,0
20,8481564,Ryan Johnson,D,BUF,23,0,0,0,0
20,8478017,Mark Friedman,D,VAN,29,0,0,0,0
20,8479320,Max Lajoie,D,SEA,27,0,0,0,0
20,8480075,Cameron Crotty,D,MIN,25,0,0,0,0
20,8484287,Cole McWard,D,VAN,23,0,0,0,0
20,8484254,Akito Hirose,D,VAN,25,0,0,0,0
20,8483407,Brandon Scanlin,D,NYR,25,0,0,0,0
20,8480274,Philip Kemp,D,EDM,25,0,0,0,0
20,8479522,Hardy Haman Aktell,D,WSH,26,0,0,0,0
20,8480007,Jonas Rondbjerg,R,VGK,25,0,0,0,0
20,8477454,Adam Erne,L,,29,0,0,0,0
20,8481679,Maxence Guenette,D,OTT,23,0,0,0,0
20,8480441,Trey Fix-Wolansky,R,CBJ,25,0,0,0,0
20,8483546,Marshall Rifai,D,TOR,26,0,0,0,0
20,8480084,Nick DeSimone,D,NJD,30,0,0,0,0
20,8481030,Jack St. Ivany,D,PIT,25,0,0,0,0
20,8481592,Jakob Pelletier,L,CGY,23,0,0,0,0
20,8478011,Louie Belpedio,D,PHI,28,0,0,0,0
20,8477930,Pierre-Edouard Bellemare,L,,39,0,0,0,0
20,8484321,Nikolas Matinpalo,D,OTT,26,0,0,0,0
20,8482067,Connor Mackey,D,NYR,28,0,0,0,0
20,8481806,Louis Crevier,D,CHI,23,0,0,0,0
20,8484326,Patrik Koch,D,UTA,28,0,0,0,0
20,8477971,Andreas Englund,D,LAK,28,0,0,0,0
20,8481751,Lukas Rousek,R,BUF,25,0,0,0,0
20,8481006,Tyler Tucker,D,STL,24,0,0,0,0
20,8476867,Brendan Gaunce,C,MIN,30,0,0,0,0
20,8479520,Brandon Duhaime,R,WSH,27,0,0,0,0
20,8477073,Kurtis MacDermid,L,NJD,30,0,0,0,0
20,8480874,Adam Ginning,D,PHI,24,0,0,0,0
20,8477473,Justin Bailey,R,SJS,29,0,0,0,0
20,8479066,Ryan Lomberg,L,CGY,30,0,0,0,0
20,8477070,Liam O'Brien,C,UTA,30,0,0,0,0
20,8474618,Marco Scandella,D,,34,0,0,0,0
20,8475797,Jarred Tinordi,D,,32,0,0,0,0
20,8481441,Joe Snively,C,DET,28,0,0,0,0
20,8477244,Chad Ruhwedel,D,NYR,34,0,0,0,0
20,8479772,Zack MacEwen,R,OTT,28,0,0,0,0
20,8481147,Reese Johnson,C,MIN,26,0,0,0,0
20,8481043,Cole Koepke,L,BOS,26,0,0,0,0
20,8483619,Filip Roos,D,OTT,25,0,0,0,0
20,8481541,Samuel Bolduc,D,NYI,24,0,0,0,0
20,8477810,Joel Hanley,D,CGY,33,0,0,0,0
20,8476907,Mackenzie MacEachern,L,,30,0,0,0,0
20,8482652,Walker Duehr,R,CGY,27,0,0,0,0
20,8477126,Jayson Megna,C,,34,0,0,0,0
20,8483398,Declan Carlile,D,TBL,31,0,0,0,0
20,8482929,Emil Lilleberg,D,TBL,23,0,0,0,0
20,8480880,Jakub Lauko,C,MIN,24,0,0,0,0
20,8480245,Olle Lycksell,R,PHI,25,0,0,0,0
20,8480252,Cole Guttman,C,CHI,25,0,0,0,0
20,8477467,Gustav Olofsson,D,SEA,30,0,0,0,0
20,8479968,Vinni Lettieri,C,BOS,29,0,0,0,0
20,8478400,Colin White,C,,27,0,0,0,0
20,8475755,Alexander Petrovic,D,DAL,32,0,0,0,0
20,8481812,Nikolai Knyzhov,D,,27,0,0,0,0
20,8481593,Jayden Struble,D,MTL,23,0,0,0,0
20,8481532,Alex Turcotte,C,LAK,23,0,0,0,0
20,8482126,Emil Andrae,D,PHI,31,0,0,0,0
20,8479944,Zach Aston-Reese,C,VGK,30,0,0,0,0
20,8471817,Ryan Reaves,R,TOR,37,0,0,0,0
20,8481206,John Ludvig,D,PIT,24,0,0,0,0
20,8481599,Victor Soderstrom,D,UTA,23,0,0,0,0
20,8480292,Carson Meyer,R,ANA,27,0,0,0,0
20,8482496,Nils Aman,C,VAN,24,0,0,0,0
20,8479718,Alex Barré-Boulet,C,MTL,27,0,0,0,0
20,8479994,Jaret Anderson-Dolan,C,WPG,25,0,0,0,0
20,8480184,Gustav Lindstrom,D,,26,0,0,0,0
20,8480890,Jan Jenik,R,OTT,24,0,0,0,0
20,8478067,Oskar Lindblom,L,,28,0,0,0,0
20,8476934,Brock McGinn,L,ANA,30,0,0,0,0
20,8479985,Cale Fleury,D,SEA,26,0,0,0,0
20,8484304,Uvis Balinskis,D,FLA,28,0,0,0,0
20,8479981,Jonah Gadjovich,L,FLA,26,0,0,0,0
20,8481716,Dmitri Voronkov,L,CBJ,24,0,0,0,0
20,8474709,Matt Martin,L,,35,0,0,0,0
20,8482634,Alex Steeves,C,TOR,25,0,0,0,0
20,8480823,Alexander Alexeyev,D,WSH,25,0,0,0,0
20,8477541,Dakota Mermis,D,TOR,30,0,0,0,0
20,8483491,Ivan Miroshnichenko,L,WSH,20,0,0,0,0
20,8478477,Mitchell Stephens,C,SEA,27,0,0,0,0
20,8481543,Nikita Alexandrov,C,STL,24,0,0,0,0
20,8479423,Alex Nylander,L,,26,0,0,0,0
20,8482451,Mikael Pyyhtia,L,CBJ,23,0,0,0,0
20,8478831,Kevin Stenlund,C,UTA,28,0,0,0,0
20,8480306,Grant Hutton,D,NYI,29,0,0,0,0
20,8478028,Fredrik Olofsson,L,,28,0,0,0,0
20,8477462,Robert Hagg,D,VGK,29,0,0,0,0
20,8477320,Anton Blidh,L,NYR,29,0,0,0,0
20,8482157,Will Cuylle,L,NYR,22,0,0,0,0
20,8482737,Zack Bolduc,C,STL,21,0,0,0,0
20,8481239,Samuel Fagemo,L,,24,0,0,0,0
20,8481600,Tobias Bjornfot,D,FLA,23,0,0,0,0
20,8478409,Anthony Richard,C,PHI,28,0,0,0,0
20,8474145,Robert Bortuzzo,D,,35,0,0,0,0
20,8475958,Michael Sgarbossa,C,WSH,32,0,0,0,0
20,8479986,Kole Lind,R,DAL,26,0,0,0,0
20,8479249,Andrew Poturalski,C,SJS,30,0,0,0,0
20,8479362,Riley Tufte,L,BOS,26,0,0,0,0
20,8479991,Jake Leschyshyn,C,NYR,25,0,0,0,0
20,8479587,Rhett Gardner,C,PHI,28,0,0,0,0
20,8482744,James Malatesta,L,CBJ,21,0,0,0,0
20,8478854,Ryan Shea,D,PIT,27,0,0,0,0
20,8481591,Sam Poulin,R,,23,0,0,0,0
20,8483512,Matt Savoie,C,EDM,20,0,0,0,0
20,8482102,Vasily Ponomarev,C,PIT,22,0,0,0,0
20,8482162,Roby Jarventie,L,EDM,22,0,0,0,0
20,8481016,Ruslan Iskhakov,C,,24,0,0,0,0
20,8482172,Landon Slaggert,L,CHI,22,0,0,0,0
20,8482747,Brennan Othmann,L,NYR,21,0,0,0,0
20,8480031,Maxime Comtois,L,,25,0,0,0,0
20,8480226,Marián Studenic,R,,26,0,0,0,0
20,8478408,Travis Dermott,D,,28,0,0,0,0
20,8481518,Nolan Foote,L,NJD,24,0,0,0,0
20,8479419,Brett Murray,L,BUF,26,0,0,0,0
20,8482088,Justin Sourdif,R,FLA,22,0,0,0,0
20,8482201,Gage Goncalves,C,TBL,23,0,0,0,0
20,8481578,Graeme Clarke,R,MIN,23,0,0,0,0
20,8482177,Marat Khusnutdinov,C,MIN,22,0,0,0,0
20,8481754,Nikita Nesterenko,C,ANA,23,0,0,0,0
20,8483531,Brian Halonen,L,NJD,25,0,0,0,0
20,8483920,Pierrick Dube,R,WSH,23,0,0,0,0
20,8480851,Akil Thomas,C,LAK,24,0,0,0,0
20,8475235,Nicolas Deslauriers,L,PHI,33,0,0,0,0
20,8482476,Emil Heineman,L,MTL,23,0,0,0,0
20,8477149,Scott Sabourin,R,SJS,32,0,0,0,0
20,8483549,Lucas Condotta,L,MTL,27,0,0,0,0
20,8482765,Isak Rosen,R,BUF,21,0,0,0,0
20,8481237,Kyle MacLean,C,NYI,25,0,0,0,0
20,8481024,Linus Karlsson,C,VAN,25,0,0,0,0
20,8481690,Tyler Angle,C,,24,0,0,0,0
20,8483570,Ben Meyers,C,SEA,26,0,0,0,0
20,8481655,Cole Schwindt,R,CGY,23,0,0,0,0
20,8481462,Mason Morelli,L,VGK,28,0,0,0,0
20,8483401,Marc Johnstone,R,PIT,28,0,0,0,0
20,8478956,Samuel Laberge,L,NJD,27,0,0,0,0
20,8479533,Joona Koppanen,L,,26,0,0,0,0
20,8482197,Adam Raska,R,MIN,23,0,0,0,0
20,8482250,Callahan Burke,C,VGK,27,0,0,0,0
20,8482784,Zach Dean,C,STL,21,0,0,0,0
20,8484255,Jason Polin,R,COL,25,0,0,0,0
20,8481077,John Leonard,L,,26,0,0,0,0
20,8481534,Raphael Lavoie,C,EDM,24,0,0,0,0
20,8483609,Adam Klapka,R,CGY,24,0,0,0,0
20,8482751,Ryan Winterton,C,SEA,21,0,0,0,0
20,8480267,Sammy Walker,C,MIN,25,0,0,0,0
20,8475766,Austin Watson,L,,32,0,0,0,0
20,8482460,Matt Rempe,C,NYR,22,0,0,0,0
20,8481065,Angus Crookshank,L,OTT,25,0,0,0,0
20,8481070,Hugh McGing,L,,26,0,0,0,0
20,8476323,Max McCormick,L,SEA,32,0,0,0,0
20,8483395,Arshdeep Bains,L,VAN,23,0,0,0,0
20,8484259,Ondrej Pavel,C,COL,31,0,0,0,0
20,8483432,Luca Del Bel Belluz,C,CBJ,31,0,0,0,0
20,8483045,Cameron Butler,R,CBJ,31,0,0,0,0
20,8482061,Brandon Biro,L,SEA,26,0,0,0,0
20,8477401,John Hayden,C,SEA,29,0,0,0,0
20,8475278,Byron Froese,C,,33,0,0,0,0
20,8478446,Glenn Gawdin,C,LAK,27,0,0,0,0
20,8477993,Justin Kirkland,C,CGY,28,0,0,0,0
20,8482147,Jean-Luc Foudy,C,COL,22,0,0,0,0
20,8480032,Shane Bowers,C,NJD,25,0,0,0,0
20,8479330,Brandon Gignac,C,MTL,27,0,0,0,0
20,8480776,Sheldon Rempal,R,,29,0,0,0,0
20,8475413,Justin Dowling,C,NJD,34,0,0,0,0
20,8481726,Adam Edstrom,C,NYR,24,0,0,0,0
20,8480844,Grigori Denisenko,L,VGK,24,0,0,0,0
20,8478147,Bokondji Imama,L,PIT,28,0,0,0,0
20,8478881,Brett Seney,L,CHI,28,0,0,0,0
20,8483630,Pavol Regenda,L,ANA,25,0,0,0,0
20,8480836,Jonathan Gruden,C,,24,0,0,0,0
20,8484314,Jiri Smejkal,L,,28,0,0,0,0
20,8475780,Chris Wagner,R,COL,33,0,0,0,0
20,8479546,Oskar Steen,C,,26,0,0,0,0
20,8483597,Milos Kelemen,L,UTA,25,0,0,0,0
20,8481789,Tye Kartye,L,SEA,23,0,0,0,0
20,8484325,Waltteri Merela,C,TBL,26,0,0,0,0
20,8479421,Jacob Moverare,D,LAK,26,0,0,0,0
20,8481585,Egor Afanasyev,L,SJS,23,0,0,0,0
20,8479547,Matthew Phillips,R,,26,0,0,0,0
20,8479367,William Lockwood,R,FLA,26,0,0,0,0
20,8476915,Jujhar Khaira,L,,30,0,0,0,0
20,8481422,Jacob Lucchini,C,NSH,29,0,0,0,0
20,8480468,James Hamblin,L,EDM,25,0,0,0,0
20,8478051,Max Willman,C,NJD,29,0,0,0,0
20,8481556,John Beecher,C,BOS,23,0,0,0,0
20,8478078,Rourke Chartier,C,,28,0,0,0,0
21,8479318,Auston Matthews,C,TOR,27,82,72,72,144
21,8478402,Connor McDavid,C,EDM,27,82,45,98,143
21,8476453,Nikita Kucherov,R,TBL,31,82,38,103,141
21,8477956,David Pastrnak,R,BOS,28,82,58,75,133
21,8477492,Nathan MacKinnon,C,COL,29,82,47,78,125
21,8477493,Aleksander Barkov,C,FLA,29,82,28,94,122
21,8478864,Kirill Kaprizov,L,MIN,27,82,54,65,119
21,8476468,J.T. Miller,C,VAN,31,82,37,77,114
21,8478550,Artemi Panarin,L,NYR,33,82,31,83,114
21,8481559,Jack Hughes,C,NJD,23,82,39,67,106
21,8480027,Jason Robertson,L,DAL,25,82,39,66,105
21,8479314,Matthew Tkachuk,L,FLA,27,82,33,71,104
21,8477946,Dylan Larkin,C,DET,28,82,53,50,103
21,8477404,Jake Guentzel,C,TBL,30,82,49,53,102
21,8476887,Filip Forsberg,L,NSH,30,82,45,57,102
21,8480800,Quinn Hughes,D,VAN,25,82,9,93,102
21,8471675,Sidney Crosby,C,PIT,37,82,45,56,101
21,8477934,Leon Draisaitl,C,EDM,29,82,38,63,101
21,8477939,William Nylander,R,TOR,28,82,37,64,101
21,8482116,Tim Stützle,C,OTT,22,82,31,68,99
21,8478398,Kyle Connor,L,WPG,28,82,53,45,98
21,8478420,Mikko Rantanen,R,COL,28,82,47,51,98
21,8476459,Mika Zibanejad,C,NYR,31,82,36,62,98
21,8474564,Steven Stamkos,C,NSH,34,82,41,56,97
21,8474600,Roman Josi,D,NSH,34,82,24,71,95
21,8479343,Clayton Keller,R,UTA,26,82,38,56,94
21,8478010,Brayden Point,C,TBL,28,82,45,47,92
21,8475172,Nazem Kadri,C,CGY,34,82,27,64,91
21,8478403,Jack Eichel,C,VGK,28,82,42,48,90
21,8477409,Carter Verhaeghe,C,FLA,29,82,41,49,90
21,8480069,Cale Makar,D,COL,26,82,24,64,88
21,8477501,Valeri Nichushkin,R,COL,29,82,51,36,87
21,8477933,Sam Reinhart,C,FLA,29,82,46,41,87
21,8478414,Timo Meier,R,NJD,28,82,30,57,87
21,8480023,Robert Thomas,C,STL,25,82,15,72,87
21,8479323,Adam Fox,D,NYR,26,82,14,73,87
21,8476389,Vincent Trocheck,C,NYR,31,82,33,53,86
21,8480208,Drake Batherson,R,OTT,26,82,27,59,86
21,8479337,Alex DeBrincat,R,DET,27,82,35,50,85
21,8477500,Bo Horvat,C,NYI,29,82,44,40,84
21,8479385,Jordan Kyrou,C,STL,26,82,31,53,84
21,8473512,Claude Giroux,R,OTT,36,82,28,56,84
21,8480801,Brady Tkachuk,L,OTT,25,82,42,41,83
21,8475784,Jeff Skinner,C,EDM,32,82,36,47,83
21,8479407,Jesper Bratt,L,NJD,26,82,30,53,83
21,8475166,John Tavares,C,TOR,34,82,30,53,83
21,8478427,Sebastian Aho,C,CAR,27,82,37,45,82
21,8480012,Elias Pettersson,C,VAN,26,82,33,49,82
21,8479420,Tage Thompson,C,BUF,27,82,36,45,81
21,8471685,Anze Kopitar,C,LAK,37,82,24,57,81
21,8475692,Mats Zuccarello,R,MIN,37,82,19,62,81
21,8471214,Alex Ovechkin,L,WSH,39,82,39,41,80
21,8473419,Brad Marchand,L,BOS,36,82,31,49,80
21,8477416,Oliver Bjorkstrand,R,SEA,29,82,33,45,78
21,8474578,Erik Karlsson,D,PIT,34,82,14,63,77
21,8478449,Roope Hintz,C,DAL,28,82,41,35,76
21,8482093,Seth Jarvis,C,CAR,22,82,39,36,75
21,8475158,Ryan O'Reilly,C,NSH,33,82,31,44,75
21,8480002,Nico Hischier,C,NJD,25,82,29,46,75
21,8477960,Adrian Kempe,R,LAK,28,82,33,41,74
21,8478439,Travis Konecny,R,PHI,27,82,31,43,74
21,8476460,Mark Scheifele,C,WPG,31,82,30,44,74
21,8477949,Alex Tuch,R,BUF,28,82,30,43,73
21,8481557,Matt Boldy,L,MIN,23,82,28,45,73
21,8477942,Kevin Fiala,L,LAK,28,82,24,49,73
21,8473994,Jamie Benn,L,DAL,35,82,22,51,73
21,8478445,Mathew Barzal,C,NYI,27,82,18,55,73
21,8481523,Kirby Dach,C,MTL,23,82,15,58,73
21,8476346,Johnny Gaudreau,L,CBJ,31,82,14,59,73
21,8477402,Pavel Buchnevich,L,STL,29,82,31,41,72
21,8478975,Mason Marchment,L,DAL,29,82,29,43,72
21,8475913,Mark Stone,R,VGK,32,82,28,44,72
21,8475184,Chris Kreider,L,NYR,33,82,49,22,71
21,8475810,Bryan Rust,R,PIT,32,82,32,39,71
21,8477951,Nick Schmaltz,C,UTA,28,82,32,39,71
21,8475798,Mikael Granlund,C,SJS,32,82,18,53,71
21,8481528,Dylan Cozens,C,BUF,23,82,34,36,70
21,8477955,Jared McCann,L,SEA,28,82,31,39,70
21,8478493,Joel Eriksson Ek,C,MIN,27,82,30,40,70
21,8477503,Max Domi,C,TOR,29,82,26,44,70
21,8476454,Ryan Nugent-Hopkins,C,EDM,31,82,21,49,70
21,8471724,Kris Letang,D,PIT,37,82,14,56,70
21,8480865,Noah Dobson,D,NYI,24,82,8,62,70
21,8474679,Gustav Nyquist,C,NSH,35,82,24,45,69
21,8477935,Sam Bennett,C,FLA,28,82,30,38,68
21,8476456,Jonathan Huberdeau,C,CGY,31,82,23,45,68
21,8478407,Vince Dunn,D,SEA,28,82,19,49,68
21,8480036,Miro Heiskanen,D,DAL,25,82,13,55,68
21,8481540,Cole Caufield,R,MTL,23,82,37,30,67
21,8480015,Owen Tippett,R,PHI,25,82,33,34,67
21,8479542,Brandon Hagel,L,TBL,26,82,30,37,67
21,8478440,Dylan Strome,C,WSH,27,82,24,43,67
21,8478498,Jake DeBrusk,L,VAN,28,82,37,29,66
21,8475170,Brayden Schenn,C,STL,33,82,30,36,66
21,8476905,Chandler Stephenson,C,SEA,30,82,15,51,66
21,8480839,Rasmus Dahlin,D,BUF,24,82,13,53,66
21,8477504,Josh Morrissey,D,WPG,29,82,9,57,66
21,8474141,Patrick Kane,R,DET,36,82,31,34,65
21,8479675,Trevor Moore,L,LAK,29,82,25,40,65
21,8475765,Vladimir Tarasenko,R,DET,33,82,24,41,65
21,8480830,Andrei Svechnikov,R,CAR,24,82,22,43,65
21,8476875,Mike Matheson,D,MTL,30,82,15,50,65
21,8478444,Brock Boeser,R,VAN,27,82,33,31,64
21,8476880,Tom Wilson,R,WSH,30,82,32,32,64
21,8478401,Pavel Zacha,C,BOS,27,82,24,40,64
21,8480039,Martin Necas,C,CAR,25,82,22,42,64
21,8480803,Evan Bouchard,D,EDM,25,82,11,53,64
21,8480893,Kirill Marchenko,R,CBJ,24,82,38,25,63
21,8475151,Kyle Palmieri,C,NYI,33,82,34,29,63
21,8475754,Brock Nelson,C,NYI,33,82,23,40,63
21,8475794,Tyler Seguin,C,DAL,32,82,23,40,63
21,8475753,Justin Faulk,D,STL,32,82,14,49,63
21,8475167,Victor Hedman,D,TBL,34,82,9,54,63
21,8476539,Jonathan Marchessault,R,NSH,34,82,32,30,62
21,8479339,Patrik Laine,L,CBJ,26,82,27,35,62
21,8476448,William Karlsson,C,VGK,31,82,23,39,62
21,8477447,Shea Theodore,D,VGK,29,82,12,50,62
21,8482110,Dawson Mercer,C,NJD,23,82,35,26,61
21,8476483,Rickard Rakell,R,PIT,31,82,32,29,61
21,8477451,Ryan Hartman,R,MIN,30,82,31,30,61
21,8476881,Tomas Hertl,C,VGK,31,82,30,31,61
21,8478366,Frank Vatrano,R,ANA,30,82,28,33,61
21,8477476,Artturi Lehkonen,L,COL,29,82,26,35,61
21,8474150,Mikael Backlund,C,CGY,35,82,24,37,61
21,8477986,Brandon Montour,D,SEA,30,82,16,45,61
21,8481068,Yegor Sharangovich,C,CGY,26,82,28,32,60
21,8482124,Quinton Byfield,R,LAK,22,82,25,35,60
21,8475745,Charlie Coyle,C,BOS,32,82,24,36,60
21,8477496,Elias Lindholm,C,BOS,30,82,23,37,60
21,8478047,Michael Bunting,L,PIT,29,82,24,35,59
21,8474586,Jordan Eberle,R,SEA,34,82,23,36,59
21,8478873,Troy Terry,R,ANA,27,82,22,37,59
21,8476462,Dougie Hamilton,D,NJD,31,82,19,40,59
21,8474563,Drew Doughty,D,LAK,35,82,13,46,59
21,8476853,Morgan Rielly,D,TOR,30,82,10,49,59
21,8475786,Zach Hyman,L,EDM,32,82,32,26,58
21,8475168,Matt Duchene,C,DAL,33,82,27,31,58
21,8478042,Viktor Arvidsson,R,EDM,31,82,26,32,58
21,8477998,Warren Foegele,L,LAK,28,82,25,33,58
21,8471215,Evgeni Malkin,C,PIT,38,82,19,39,58
21,8476869,Brady Skjei,D,NSH,30,82,15,43,58
21,8478460,Zach Werenski,D,CBJ,27,82,11,47,58
21,8478397,Rasmus Andersson,D,CGY,28,82,9,49,58
21,8477940,Nikolaj Ehlers,L,WPG,28,82,25,32,57
21,8482078,Lucas Raymond,L,DET,22,82,22,35,57
21,8478055,Gustav Forsling,D,FLA,28,82,20,37,57
21,8475726,Tyler Toffoli,C,SJS,32,82,25,31,56
21,8478438,Tommy Novak,C,NSH,27,82,21,35,56
21,8477964,Ivan Barbashev,C,VGK,29,82,21,35,56
21,8477456,J.T. Compher,L,DET,29,82,20,36,56
21,8478233,Andrew Mangiapane,L,WSH,28,82,16,40,56
21,8479325,Charlie McAvoy,D,BOS,27,82,9,47,56
21,8476432,Boone Jenner,C,CBJ,31,82,30,25,55
21,8482665,Matty Beniers,C,SEA,22,82,23,32,55
21,8478519,Anthony Cirelli,C,TBL,27,82,22,33,55
21,8476479,Phillip Danault,C,LAK,31,82,21,34,55
21,8474641,Adam Henrique,C,EDM,34,82,20,35,55
21,8478396,Noah Hanifin,D,VGK,27,82,14,41,55
21,8477495,Seth Jones,D,CHI,30,82,13,42,55
21,8482684,Luke Hughes,D,NJD,21,82,10,45,55
21,8481542,Moritz Seider,D,DET,23,82,6,49,55
21,8474102,David Perron,L,OTT,36,82,26,28,54
21,8479425,Filip Hronek,D,VAN,27,82,11,43,54
21,8482097,Jack Quinn,R,BUF,23,82,27,26,53
21,8481711,Matias Maccelli,L,UTA,24,82,21,32,53
21,8474565,Alex Pietrangelo,D,VGK,34,82,15,38,53
21,8480434,Sean Durzi,D,UTA,26,82,14,39,53
21,8478038,Devon Toews,D,COL,30,82,11,42,53
21,8477407,Anthony Duclair,L,NYI,29,82,27,25,52
21,8481596,Shane Pinto,C,OTT,24,82,26,26,52
21,8482113,Anton Lundell,C,FLA,23,82,24,28,52
21,8473986,Alex Killorn,L,ANA,35,82,21,31,52
21,8480018,Nick Suzuki,C,MTL,25,82,18,34,52
21,8476458,Ryan Strome,C,ANA,31,82,18,34,52
21,8479992,Michael Rasmussen,C,DET,25,82,18,34,52
21,8476882,Teuvo Teravainen,L,CHI,30,82,21,30,51
21,8482745,Mason McTavish,C,ANA,21,82,21,30,51
21,8477497,Sean Monahan,C,CBJ,30,82,20,31,51
21,8475791,Taylor Hall,L,CHI,33,82,20,31,51
21,8478472,Mathieu Joseph,R,STL,27,82,20,31,51
21,8476927,Teddy Blueger,C,VAN,30,82,19,32,51
21,8479999,Casey Mittelstadt,C,COL,26,82,17,34,51
21,8480014,Gabriel Vilardi,C,WPG,25,82,31,19,50
21,8476872,Scott Laughton,C,PHI,30,82,18,32,50
21,8477444,Andre Burakovsky,L,SEA,29,82,16,34,50
21,8482109,Alexis Lafrenière,L,NYR,23,82,29,20,49
21,8475314,Anders Lee,L,NYI,34,82,28,21,49
21,8480078,Filip Chytil,C,NYR,25,82,24,25,49
21,8475763,Kevin Hayes,R,PIT,32,82,21,28,49
21,8476826,Yanni Gourde,C,SEA,33,82,21,28,49
21,8479987,Morgan Geekie,C,BOS,26,82,20,29,49
21,8482667,William Eklund,L,SJS,22,82,19,30,49
21,8482149,Cole Perfetti,C,WPG,22,82,18,31,49
21,8479400,Pierre-Luc Dubois,L,WSH,26,82,17,32,49
21,8470613,Brent Burns,D,CAR,39,82,17,32,49
21,8481546,Cam York,D,PHI,23,82,14,35,49
21,8478469,Thomas Chabot,D,OTT,27,82,12,37,49
21,8479410,Mikhail Sergachev,D,UTA,26,82,9,40,49
21,8482175,JJ Peterka,R,BUF,22,82,34,14,48
21,8476438,Brandon Saad,L,STL,32,82,27,21,48
21,8481554,Kaapo Kakko,R,NYR,23,82,25,23,48
21,8480459,Pius Suter,C,VAN,28,82,24,24,48
21,8479525,Ross Colton,C,COL,28,82,21,27,48
21,8478057,Dakota Joshua,C,VAN,28,82,17,31,48
21,8480028,Morgan Frost,C,PHI,25,82,17,31,48
21,8479345,Jakob Chychrun,D,WSH,26,82,12,36,48
21,8477426,Nicholas Paul,L,TBL,29,82,25,22,47
21,8482740,Wyatt Johnston,C,DAL,21,82,24,23,47
21,8482475,Yegor Chinakhov,R,CBJ,23,82,19,28,47
21,8481533,Trevor Zegras,C,ANA,23,82,18,29,47
21,8480798,Philipp Kurashev,C,CHI,25,82,12,35,47
21,8476854,Hampus Lindholm,D,BOS,30,82,10,37,47
21,8477346,MacKenzie Weegar,D,CGY,30,82,9,38,47
21,8482671,Owen Power,D,BUF,22,82,8,39,47
21,8480873,Rasmus Sandin,D,WSH,24,82,7,40,47
21,8477932,Aaron Ekblad,D,FLA,28,82,6,41,47
21,8476399,Blake Coleman,C,CGY,33,82,26,20,46
21,8478856,Conor Garland,R,VAN,28,82,24,22,46
21,8475149,Marcus Johansson,L,MIN,34,82,20,26,46
21,8482117,Lukas Reichel,L,CHI,22,82,18,28,46
21,8484144,Connor Bedard,C,CHI,19,82,17,29,46
21,8476925,Colton Sissons,C,NSH,31,82,14,32,46
21,8477494,Jonathan Drouin,L,COL,29,82,12,34,46
21,8478500,Ivan Provorov,D,CBJ,27,82,7,39,46
21,8471698,T.J. Oshie,R,WSH,38,82,25,20,45
21,8480829,Jesperi Kotkaniemi,C,CAR,24,82,15,30,45
21,8474590,John Carlson,D,WSH,34,82,9,36,45
21,8476958,Jaccob Slavin,D,CAR,30,82,8,37,45
21,8482705,Cole Sillinger,C,CBJ,21,82,19,25,44
21,8481013,Jonatan Berggren,R,DET,24,82,16,28,44
21,8476329,Travis Boyd,C,MIN,31,82,14,30,44
21,8482660,Kent Johnson,C,CBJ,22,82,14,30,44
21,8475218,Mattias Ekholm,D,EDM,34,82,13,31,44
21,8475191,Reilly Smith,R,NYR,33,82,12,32,44
21,8476419,Jean-Gabriel Pageau,C,NYI,32,82,12,32,44
21,8476392,Adam Lowry,C,WPG,31,82,18,25,43
21,8474053,Logan Couture,C,SJS,35,82,17,26,43
21,8480009,Eeli Tolvanen,R,SEA,25,82,16,27,43
21,8476792,Torey Krug,D,STL,33,82,12,31,43
21,8478458,Jack Roslovic,C,CAR,27,82,11,32,43
21,8480064,Josh Norris,C,OTT,25,82,25,17,42
21,8473563,Nicklas Backstrom,C,WSH,37,82,22,20,42
21,8478542,Evan Rodrigues,C,FLA,31,82,21,21,42
21,8479591,Michael Eyssimont,C,TBL,28,82,17,25,42
21,8477429,Andrew Copp,C,DET,30,82,15,27,42
21,8480145,Neal Pionk,D,WPG,29,82,13,29,42
21,8478462,Nicolas Roy,C,VGK,27,82,13,29,42
21,8476885,Jacob Trouba,D,NYR,30,82,11,31,42
21,8483808,Andrei Kuzmenko,L,CGY,28,82,28,13,41
21,8479293,Brandon Tanev,L,SEA,33,82,27,14,41
21,8483431,Logan Cooley,C,UTA,20,82,23,18,41
21,8480849,Barrett Hayton,C,UTA,24,82,21,20,41
21,8475169,Evander Kane,L,EDM,33,82,20,21,41
21,8481560,Arthur Kaliyev,R,LAK,23,82,17,24,41
21,8480797,Joel Farabee,L,PHI,24,82,15,26,41
21,8475714,Calle Jarnkrok,C,TOR,33,82,21,19,40
21,8479390,Taylor Raddysh,R,WSH,26,82,20,20,40
21,8477021,Alex Kerfoot,C,UTA,30,82,17,23,40
21,8478474,Lawson Crouse,L,UTA,27,82,14,26,40
21,8474716,Jared Spurgeon,D,MIN,35,82,13,27,40
21,8476906,Shayne Gostisbehere,D,CAR,31,82,12,28,40
21,8480220,Noah Cates,L,PHI,25,82,10,30,40
21,8481656,Aliaksei Protas,C,WSH,23,82,15,24,39
21,8476480,Vladislav Namestnikov,C,WPG,32,82,13,26,39
21,8479996,Cody Glass,C,NSH,25,82,11,28,39
21,8476463,Jonas Brodin,D,MIN,31,82,4,35,39
21,8481604,Pavel Dorofeyev,L,VGK,24,82,26,12,38
21,8482055,Drew O'Connor,L,PIT,26,82,24,14,38
21,8481618,Alex Newhook,C,MTL,23,82,18,20,38
21,8479941,Justin Danforth,R,CBJ,31,82,18,20,38
21,8482146,Luke Evangelista,R,NSH,22,82,18,20,38
21,8475768,Jaden Schwartz,C,SEA,32,82,18,20,38
21,8481704,Juuso Parssinen,C,NSH,23,82,18,20,38
21,8477987,Ryan Donato,C,CHI,28,82,15,23,38
21,8481581,Thomas Harley,D,DAL,23,82,13,25,38
21,8481582,Nicholas Robertson,L,TOR,23,82,21,16,37
21,8482159,Tyson Foerster,R,PHI,22,82,20,17,37
21,8477952,Robby Fabbri,C,ANA,28,82,20,17,37
21,8475287,Erik Haula,L,NJD,33,82,19,18,37
21,8478463,Anthony Beauvillier,L,PIT,27,82,17,20,37
21,8477511,Anthony Mantha,R,CGY,30,82,17,20,37
21,8478046,Danton Heinen,L,VAN,29,82,17,20,37
21,8480188,Fabian Zetterlund,L,SJS,25,82,13,24,37
21,8477989,Christian Dvorak,C,MTL,28,82,10,27,37
21,8480855,Jack McBain,C,UTA,24,82,20,16,36
21,8478115,Pierre Engvall,L,NYI,28,82,20,16,36
21,8475799,Nino Niederreiter,R,WPG,32,82,19,17,36
21,8481553,Bobby Brink,R,PHI,23,82,19,17,36
21,8479365,Trent Frederic,C,BOS,26,82,16,20,36
21,8474149,Evgenii Dadonov,R,DAL,35,82,14,22,36
21,8476979,Erik Gustafsson,D,DET,32,82,7,29,36
21,8482089,Jake Neighbours,L,STL,22,82,19,16,35
21,8477953,Kasperi Kapanen,R,STL,28,82,17,18,35
21,8482699,Dylan Guenther,R,UTA,21,82,16,19,35
21,8482720,Matthew Knies,L,TOR,22,82,15,20,35
21,8477479,Tyler Bertuzzi,L,CHI,29,82,14,21,35
21,8476624,Barclay Goodrow,C,SJS,31,82,13,22,35
21,8480185,Eetu Luostarinen,C,FLA,26,82,12,23,35
21,8480817,K'Andre Miller,D,NYR,24,82,12,23,35
21,8478413,Jordan Greenway,L,BUF,27,82,11,24,35
21,8481580,Connor McMichael,C,WSH,23,82,19,15,34
21,8483515,Juraj Slafkovsky,L,MTL,20,82,18,16,34
21,8481535,Nils Hoglander,L,VAN,24,82,17,17,34
21,8480113,Alex Iafallo,L,WPG,31,82,15,19,34
21,8482092,Ridly Greig,C,OTT,22,82,15,19,34
21,8475722,Jason Zucker,L,BUF,32,82,14,20,34
21,8473422,Nick Foligno,L,CHI,37,82,14,20,34
21,8476461,Sean Couturier,C,PHI,32,82,13,21,34
21,8482133,Thomas Bordeleau,C,SJS,22,82,9,25,34
21,8477498,Darnell Nurse,D,EDM,29,82,7,27,34
21,8482142,Jamie Drysdale,D,PHI,22,82,6,28,34
21,8479976,Juuso Valimaki,D,UTA,26,82,5,29,34
21,8481624,Ilya Mikheyev,R,CHI,30,82,20,13,33
21,8475848,Brendan Gallagher,R,MTL,32,82,18,15,33
21,8476921,Jordan Martinook,L,CAR,32,82,17,16,33
21,8476873,Mark Jankowski,C,NSH,30,82,15,18,33
21,8474715,Cam Atkinson,R,TBL,35,82,15,18,33
21,8475793,Ryan Johansen,C,PHI,32,82,14,19,33
21,8476897,Oskar Sundqvist,C,STL,30,82,13,20,33
21,8484153,Leo Carlsson,C,ANA,20,82,13,20,33
21,8481186,Logan O'Connor,R,COL,28,82,12,21,33
21,8479353,Brett Howden,C,VGK,26,82,10,23,33
21,8480871,Adam Boqvist,D,FLA,24,82,8,25,33
21,8477948,Travis Sanheim,D,PHI,28,82,6,27,33
21,8476292,Ondrej Palat,L,NJD,33,82,14,18,32
21,8476474,Stefan Noesen,R,NJD,31,82,14,18,32
21,8479661,Tanner Jeannot,L,LAK,27,82,14,18,32
21,8480748,Kiefer Sherwood,L,VAN,29,82,14,18,32
21,8475760,Nick Bjugstad,C,UTA,32,82,13,19,32
21,8479351,Sam Steel,C,DAL,26,82,12,20,32
21,8480802,Ryan McLeod,C,BUF,25,82,11,21,32
21,8481606,Jordan Spence,D,LAK,23,82,9,23,32
21,8473507,Jeff Petry,D,DET,37,82,8,24,32
21,8477969,Marcus Pettersson,D,PIT,28,82,5,27,32
21,8477353,Tyler Motte,C,DET,29,82,17,14,31
21,8478020,Michael Amadio,C,OTT,28,82,16,15,31
21,8478109,Victor Olofsson,L,VGK,29,82,15,16,31
21,8480074,Alexandre Texier,C,STL,25,82,15,16,31
21,8474189,Lars Eller,C,PIT,35,82,14,17,31
21,8475193,Tomas Tatar,L,NJD,34,82,13,18,31
21,8480068,Ryan Poehling,C,PHI,25,82,12,19,31
21,8477919,Frederick Gaudreau,C,MIN,31,82,10,21,31
21,8480878,Nils Lundkvist,D,DAL,24,82,8,23,31
21,8477435,Ryan Graves,D,PIT,29,82,7,24,31
21,8475171,Oliver Ekman-Larsson,D,TOR,33,82,6,25,31
21,8480043,Timothy Liljegren,D,TOR,25,82,5,26,31
21,8483505,Matthew Poitras,C,BOS,20,82,17,13,30
21,8476374,Sean Kuraly,C,CBJ,31,82,16,14,30
21,8476981,Josh Anderson,R,MTL,30,82,16,14,30
21,8477220,Nate Schmidt,D,FLA,33,82,9,21,30
21,8481522,Peyton Krebs,C,BUF,23,82,8,22,30
21,8481014,Alexander Romanov,D,NYI,24,82,6,24,30
21,8476902,Esa Lindell,D,DAL,30,82,5,25,30
21,8476923,Damon Severson,D,CBJ,30,82,5,25,30
21,8479398,Samuel Girard,D,COL,26,82,4,26,30
21,8480807,Mattias Samuelsson,D,BUF,24,82,4,26,30
21,8475764,Cam Fowler,D,ANA,33,82,3,27,30
21,8480835,Jack Drury,C,CAR,24,82,16,13,29
21,8480003,Jesper Boqvist,C,FLA,26,82,13,16,29
21,8480806,Isac Lundestrom,C,ANA,25,82,12,17,29
21,8482105,Jake Sanderson,D,OTT,22,82,9,20,29
21,8474574,Tyler Myers,D,VAN,34,82,7,22,29
21,8480144,David Kampf,C,TOR,29,82,7,22,29
21,8475343,Nic Dowd,C,WSH,34,82,16,12,28
21,8478434,Keegan Kolesar,R,VGK,27,82,15,13,28
21,8470621,Corey Perry,R,EDM,39,82,14,14,28
21,8482079,Marco Rossi,C,MIN,23,82,11,17,28
21,8482702,Logan Stankoven,C,DAL,21,82,11,17,28
21,8477499,Rasmus Ristolainen,D,PHI,30,82,11,17,28
21,8478133,Jake Evans,C,MTL,28,82,10,18,28
21,8478911,Matt Roy,D,WSH,29,82,7,21,28
21,8480073,Erik Brannstrom,D,COL,25,82,5,23,28
21,8476917,Adam Pelech,D,NYI,30,82,5,23,28
21,8480222,Sebastian Aho,D,PIT,28,82,5,23,28
21,8478507,John Marino,D,UTA,27,82,3,25,28
21,8475690,Chris Tanev,D,TOR,35,82,2,26,28
21,8481477,Nico Sturm,C,SJS,29,82,17,10,27
21,8480025,MacKenzie Entwistle,R,FLA,25,82,16,11,27
21,8480995,Pontus Holmberg,R,TOR,25,82,14,13,27
21,8478569,Noel Acciari,C,PIT,33,82,14,13,27
21,8477947,Sonny Milano,L,WSH,28,82,10,17,27
21,8482125,Alexander Holtz,R,VGK,22,82,9,18,27
21,8480990,Declan Chisholm,D,MIN,24,82,8,19,27
21,8482122,Brock Faber,D,MIN,22,82,7,20,27
21,8477488,Brett Pesce,D,NJD,30,82,5,22,27
21,8480336,Sean Walker,D,CAR,30,82,4,23,27
21,8482655,J.J. Moser,D,TBL,24,82,3,24,27
21,8479393,Noah Gregor,C,OTT,26,82,15,11,26
21,8477425,Miles Wood,L,COL,29,82,15,11,26
21,8478508,Yakov Trenin,C,MIN,27,82,13,13,26
21,8482666,Scott Morrow,D,CAR,22,82,11,15,26
21,8475200,Dmitry Orlov,D,CAR,33,82,9,17,26
21,8480789,Oliver Wahlstrom,R,NYI,24,82,9,17,26
21,8476467,Jamie Oleksiak,D,SEA,32,82,8,18,26
21,8478891,Mason Appleton,C,WPG,28,82,8,18,26
21,8476879,Cody Ceci,D,EDM,31,82,7,19,26
21,8478882,Vladislav Gavrikov,D,LAK,29,82,6,20,26
21,8474673,TJ Brodie,D,CHI,34,82,4,22,26
21,8476931,Jake McCabe,D,TOR,31,82,4,22,26
21,8479402,Jake Bean,D,CGY,26,82,4,22,26
21,8479369,Andrew Peeke,D,BOS,26,82,4,22,26
21,8476891,Matt Grzelcyk,D,PIT,30,82,3,23,26
21,8475324,Nick Jensen,D,OTT,34,82,2,24,26
21,8478851,Alexandre Carrier,D,NSH,28,82,1,25,26
21,8481032,Paul Cotter,C,NJD,25,82,15,10,25
21,8482624,Daniil Miromanov,D,CGY,27,82,13,12,25
21,8476442,Matt Nieto,L,PIT,32,82,13,12,25
21,8477839,Conor Sheary,L,TBL,32,82,11,14,25
21,8482111,Justin Barron,D,MTL,23,82,11,14,25
21,8473533,Jordan Staal,C,CAR,36,82,10,15,25
21,8478013,Jake Walman,D,SJS,28,82,10,15,25
21,8484145,Zach Benson,L,BUF,19,82,10,15,25
21,8477450,Jason Dickinson,C,CHI,29,82,10,15,25
21,8484203,Bradly Nadeau,L,CAR,19,82,9,16,25
21,8481708,Zac Jones,D,NYR,24,82,8,17,25
21,8479980,Nicolas Hague,D,VGK,26,82,7,18,25
21,8483457,Lane Hutson,D,MTL,20,82,7,18,25
21,8483445,Cutter Gauthier,L,ANA,20,82,7,18,25
21,8478468,Jeremy Lauzon,D,NSH,27,82,6,19,25
21,8476892,Colton Parayko,D,STL,31,82,6,19,25
21,8479324,Ryan Lindgren,D,NYR,26,82,3,22,25
21,8474151,Ryan McDonagh,D,TBL,35,82,0,25,25
21,8481601,Simon Holmstrom,R,NYI,23,82,19,5,24
21,8476960,Andreas Athanasiou,C,CHI,30,82,13,11,24
21,8479316,Luke Kunin,C,SJS,27,82,13,11,24
21,8476889,Radek Faksa,C,STL,30,82,11,13,24
21,8482166,Shakir Mukhamadullin,D,SJS,22,82,10,14,24
21,8484166,Adam Fantilli,C,CBJ,20,82,10,14,24
21,8479368,Max Jones,L,BOS,26,82,10,14,24
21,8478432,Christian Fischer,R,DET,27,82,9,15,24
21,8479371,Dante Fabbro,D,NSH,26,82,5,19,24
21,8480049,Dylan Samberg,D,WPG,25,82,4,20,24
21,8477506,Ryan Pulock,D,NYI,30,82,4,20,24
21,8475718,Justin Holl,D,DET,32,82,4,20,24
21,8475181,Nick Leddy,D,STL,33,82,3,21,24
21,8475233,David Savard,D,MTL,34,82,3,21,24
21,8482073,Braden Schneider,D,NYR,23,82,2,22,24
21,8480035,Henri Jokiharju,D,BUF,25,82,1,23,24
21,8482259,Bobby McMann,C,TOR,28,82,16,7,23
21,8476278,Colin Blackwell,C,DAL,31,82,13,10,23
21,8480813,Joe Veleno,C,DET,24,82,11,12,23
21,8476918,Jimmy Vesey,L,NYR,31,82,11,12,23
21,8477508,Curtis Lazar,C,NJD,29,82,11,12,23
21,8478211,Dryden Hunt,L,CGY,29,82,11,12,23
21,8477392,Hudson Fasching,R,NYI,29,82,9,14,23
21,8482118,Sam Colangelo,R,ANA,23,82,8,15,23
21,8478399,Jonas Siegenthaler,D,NJD,27,82,7,16,23
21,8482087,Kaiden Guhle,D,MTL,22,82,6,17,23
21,8480950,Ilya Lyubushkin,D,DAL,30,82,6,17,23
21,8477365,Connor Clifton,D,BUF,29,82,5,18,23
21,8476457,Adam Larsson,D,SEA,32,82,4,19,23
21,8476422,Mike Reilly,D,NYI,31,82,4,19,23
21,8479998,Mikey Anderson,D,LAK,25,82,3,20,23
21,8475231,Casey Cizikas,C,NYI,33,82,2,21,23
21,8475188,Brayden McNabb,D,VGK,33,82,1,22,23
21,8479359,Beck Malenstyn,L,BUF,26,82,12,10,22
21,8475220,Marcus Foligno,L,MIN,33,82,11,11,22
21,8477406,Mattias Janmark,C,EDM,32,82,11,11,22
21,8477015,Connor Brown,R,EDM,30,82,10,12,22
21,8481699,Aku Raty,R,UTA,23,82,10,12,22
21,8473453,Trevor Lewis,C,LAK,37,82,9,13,22
21,8479414,Nathan Bastian,R,NJD,27,82,9,13,22
21,8481641,Joel Kiviranta,L,COL,28,82,9,13,22
21,8476312,Josh Manson,D,COL,33,82,6,16,22
21,8477507,Nikita Zadorov,D,BOS,29,82,6,16,22
21,8482470,Ilya Solovyov,D,CGY,24,82,6,16,22
21,8476331,Dylan DeMelo,D,WPG,31,82,0,22,22
21,8482077,Dylan Holloway,L,EDM,23,82,16,5,21
21,8477505,Alexander Wennberg,C,SJS,30,82,13,8,21
21,8480980,Connor Dewar,C,TOR,25,82,10,11,21
21,8481481,Blake Lizotte,C,PIT,27,82,9,12,21
21,8482679,Matt Coronato,R,CGY,22,82,9,12,21
21,8481524,Bowen Byram,D,BUF,23,82,9,12,21
21,8482659,Josh Doan,R,UTA,22,82,8,13,21
21,8477938,Haydn Fleury,D,WPG,28,82,8,13,21
21,8477335,Kyle Burroughs,D,LAK,29,82,8,13,21
21,8477369,Carson Soucy,D,VAN,30,82,7,14,21
21,8483012,Logan Morrison,C,SEA,22,82,6,15,21
21,8479983,Mario Ferraro,D,SJS,26,82,5,16,21
21,8475279,Ben Chiarot,D,DET,33,82,5,16,21
21,8483468,Jiri Kulich,C,BUF,20,82,5,16,21
21,8481093,Rafael Harvey-Pinard,L,MTL,25,82,13,7,20
21,8477903,Garnet Hathaway,R,PHI,33,82,9,11,20
21,8482074,Connor Zary,C,CGY,23,82,9,11,20
21,8480281,Alexey Toropchenko,R,STL,25,82,9,11,20
21,8484911,Collin Graf,R,SJS,22,82,9,11,20
21,8483499,Liam Ohgren,L,MIN,20,82,8,12,20
21,8482858,Ryker Evans,D,SEA,23,82,8,12,20
21,8475855,Jesper Fast,R,CAR,33,82,7,13,20
21,8483565,Nick Blankenburg,D,NSH,26,82,6,14,20
21,8483460,David Jiricek,D,CBJ,21,82,5,15,20
21,8475462,Radko Gudas,D,ANA,34,82,3,17,20
21,8475455,Brenden Dillon,D,NJD,34,82,2,18,20
21,8481178,Egor Zamula,D,PHI,24,82,0,20,20
21,8482062,Cole Smith,L,NSH,29,82,13,6,19
21,8480021,Jack Studnicka,C,LAK,25,82,12,7,19
21,8475842,Sam Carrick,C,NYR,32,82,10,9,19
21,8476469,Joel Armia,R,MTL,31,82,9,10,19
21,8481028,Martin Pospisil,C,CGY,25,82,9,10,19
21,8479291,Kevin Rooney,C,CGY,31,82,9,10,19
21,8483490,Pavel Mintyukov,D,ANA,21,82,5,14,19
21,8478136,Jake Middleton,D,MIN,28,82,4,15,19
21,8480246,Nick Perbix,D,TBL,26,82,4,15,19
21,8481567,Henry Thrun,D,SJS,23,82,4,15,19
21,8478840,Will Borgen,D,SEA,28,82,3,16,19
21,8477845,Trevor van Riemsdyk,D,WSH,33,82,2,17,19
21,8476429,Scott Mayfield,D,NYI,32,82,0,19,19
21,8484149,Gavin Brindley,C,CBJ,20,82,13,5,18
21,8479638,Justin Brazeau,R,BOS,26,82,10,8,18
21,8476878,Zemgus Girgensons,L,TBL,30,82,8,10,18
21,8482145,Mavrik Bourque,C,DAL,22,82,8,10,18
21,8482807,Ethan Del Mastro,D,CHI,21,82,7,11,18
21,8483763,Maksymilian Szuber,D,UTA,22,82,7,11,18
21,8482245,Artem Zub,D,OTT,29,82,5,13,18
21,8478416,Erik Cernak,D,TBL,27,82,5,13,18
21,8480796,Martin Fehervary,D,WSH,25,82,3,15,18
21,8481568,Alex Vlasic,D,CHI,23,82,2,16,18
21,8483524,Shane Wright,C,SEA,20,82,11,6,17
21,8480448,Parker Kelly,L,COL,25,82,10,7,17
21,8476858,Phillip Di Giuseppe,L,VAN,31,82,9,8,17
21,8481517,Brett Leason,R,ANA,25,82,9,8,17
21,8482712,Oskar Olausson,R,COL,22,82,8,9,17
21,8483466,Kevin Korchinski,D,CHI,20,82,8,9,17
21,8476967,Brett Kulak,D,EDM,30,82,4,13,17
21,8482141,Lukas Cormier,D,VGK,22,82,3,14,17
21,8479442,Troy Stecher,D,EDM,30,82,3,14,17
21,8478450,Parker Wotherspoon,D,BOS,27,82,3,14,17
21,8475177,Calvin de Haan,D,COL,33,82,2,15,17
21,8480860,Kevin Bahl,D,CGY,24,82,2,15,17
21,8476441,Joel Edmundson,D,LAK,31,82,2,15,17
21,8476822,Luke Glendening,C,TBL,35,82,8,8,16
21,8482762,Simon Edvinsson,D,DET,21,82,7,9,16
21,8477931,Tomas Nosek,L,FLA,32,82,6,10,16
21,8482101,Danil Gushchin,L,SJS,22,82,6,10,16
21,8483493,Frank Nazar,C,CHI,20,82,6,10,16
21,8470600,Ryan Suter,D,STL,39,82,5,11,16
21,8481122,Simon Benoit,D,TOR,26,82,4,12,16
21,8480879,Jacob Bernard-Docker,D,OTT,24,82,1,15,16
21,8482733,Logan Mailloux,D,MTL,31,82,6,9,15
21,8481605,Jackson LaCombe,D,ANA,23,82,6,9,15
21,8482803,Olen Zellweger,D,ANA,21,82,5,10,15
21,8478178,Darren Raddysh,D,TBL,28,82,2,13,15
21,8476372,Nick Seeler,D,PHI,31,82,2,13,15
21,8482155,Alex Laferriere,R,LAK,23,82,11,3,14
21,8480870,Bo Groulx,C,NYR,24,82,9,5,14
21,8482809,Jackson Blake,R,CAR,21,82,6,8,14
21,8474013,Ian Cole,D,UTA,35,82,3,11,14
21,8483495,Simon Nemec,D,NJD,20,82,3,11,14
21,8474090,Brendan Smith,D,DAL,35,82,3,11,14
21,8476525,Colin Miller,D,WPG,32,82,2,12,14
21,8483397,Marc McLaughlin,C,BOS,25,82,6,7,13
21,8483567,Georgii Merkulov,C,BOS,24,82,6,7,13
21,8475762,Derek Forbort,D,VAN,32,82,4,9,13
21,8478859,Niko Mikkola,D,FLA,28,82,4,9,13
21,8471677,Jack Johnson,D,CBJ,37,82,4,9,13
21,8482153,Brendan Brisson,C,VGK,23,82,7,5,12
21,8482516,Matthew Kessel,D,STL,24,82,5,7,12
21,8478443,Brandon Carlo,D,BOS,28,82,5,7,12
21,8482713,Mackie Samoskevich,R,FLA,22,82,5,7,12
21,8483482,Tristan Luneau,D,ANA,20,82,4,8,12
21,8480172,Jan Rutta,D,SJS,34,82,1,11,12
21,8482070,Mitchell Chaffee,R,TBL,26,82,5,6,11
21,8482859,Zack Ostapchuk,C,OTT,21,82,4,7,11
21,8483489,Fraser Minten,C,TOR,31,82,4,7,11
21,8483471,Brad Lambert,C,WPG,31,82,4,7,11
21,8475790,Erik Gudbranson,D,CBJ,32,82,2,9,11
21,8474567,Zach Bogosian,D,MIN,34,82,1,10,11
21,8474612,Travis Hamonic,D,OTT,34,82,0,11,11
21,8476473,Connor Murphy,D,CHI,31,82,2,8,10
21,8478874,Adam Gaudette,C,OTT,28,82,0,10,10
21,8482787,Nikita Chibrikov,R,WPG,31,82,3,6,9
21,8477034,Jaycob Megna,D,FLA,32,82,3,6,9
21,8479576,Vincent Desharnais,D,VAN,28,82,2,7,9
21,8480834,Ty Emberson,D,SJS,24,82,2,7,9
21,8482749,Joshua Roy,R,MTL,21,82,6,2,8
21,8474062,Riley Nash,C,NYR,35,82,0,5,5
21,8470794,Joe Pavelski,C,,40,0,0,0,0
21,8481703,Valtteri Puustinen,R,PIT,25,0,0,0,0
21,8477950,Tony DeAngelo,D,,29,0,0,0,0
21,8481577,Philip Tomasino,C,NSH,23,0,0,0,0
21,8475197,Tyson Barrie,D,,33,0,0,0,0
21,8471218,Blake Wheeler,R,,38,0,0,0,0
21,8474157,Max Pacioretty,L,,36,0,0,0,0
21,8478466,Daniel Sprong,R,VAN,27,0,0,0,0
21,8475744,Evgeny Kuznetsov,C,,32,0,0,0,0
21,8481019,David Gustafsson,C,WPG,24,0,0,0,0
21,8475906,John Klingberg,D,,32,0,0,0,0
21,8479348,Kale Clague,D,BUF,26,0,0,0,0
21,8476952,Dominic Toninato,C,WPG,30,0,0,0,0
21,8473473,Milan Lucic,L,,36,0,0,0,0
21,8474037,James van Riemsdyk,L,,35,0,0,0,0
21,8474602,Justin Schultz,D,,34,0,0,0,0
21,8482222,Alexander Barabanov,L,,30,0,0,0,0
21,8479372,Josh Mahura,D,SEA,26,0,0,0,0
21,8479982,Conor Timmins,D,TOR,26,0,0,0,0
21,8474031,Kevin Shattenkirk,D,,35,0,0,0,0
21,8480008,Adam Ruzicka,C,,25,0,0,0,0
21,8481059,Scott Perunovich,D,STL,26,0,0,0,0
21,8480884,Calen Addison,D,,24,0,0,0,0
21,8476994,Vinnie Hinostroza,C,NSH,30,0,0,0,0
21,8478452,Caleb Jones,D,LAK,27,0,0,0,0
21,8480157,Calle Rosen,D,COL,30,0,0,0,0
21,8481609,Vladislav Kolyachonok,D,UTA,23,0,0,0,0
21,8479415,Michael McLeod,C,,26,0,0,0,0
21,8476919,Chris Tierney,C,,30,0,0,0,0
21,8479639,Dylan Coghlan,D,WPG,26,0,0,0,0
21,8478146,Matthew Highmore,C,OTT,28,0,0,0,0
21,8478970,Jalen Chatfield,D,CAR,28,0,0,0,0
21,8480205,Emil Bemstrom,C,PIT,25,0,0,0,0
21,8474884,Mike Hoffman,C,,35,0,0,0,0
21,8471274,Alex Goligoski,D,,39,0,0,0,0
21,8478104,Sammy Blais,L,,28,0,0,0,0
21,8474870,Tyler Johnson,C,,34,0,0,0,0
21,8476913,Devin Shore,C,MIN,30,0,0,0,0
21,8481598,Philip Broberg,D,EDM,23,0,0,0,0
21,8480058,Pierre-Olivier Joseph,D,STL,25,0,0,0,0
21,8480891,Michael Kesselring,D,UTA,24,0,0,0,0
21,8477979,Nicolas Aube-Kubel,R,BUF,28,0,0,0,0
21,8476871,Tanner Pearson,L,,32,0,0,0,0
21,8476393,Nick Cousins,C,,31,0,0,0,0
21,8479977,Kailer Yamamoto,R,,26,0,0,0,0
21,8479543,Michael Pezzetta,L,MTL,26,0,0,0,0
21,8477018,Ben Hutton,D,VGK,31,0,0,0,0
21,8480762,Eric Robinson,L,CAR,29,0,0,0,0
21,8474034,Pat Maroon,L,CHI,36,0,0,0,0
21,8481058,Jesse Ylönen,R,,25,0,0,0,0
21,8475179,Dmitry Kulikov,D,FLA,34,0,0,0,0
21,8481527,Kaedan Korczak,D,VGK,23,0,0,0,0
21,8473449,Kyle Okposo,R,,36,0,0,0,0
21,8482192,Isaak Phillips,D,CHI,23,0,0,0,0
21,8480727,Zach Whitecloud,D,VGK,28,0,0,0,0
21,8479346,Dillon Dube,C,,26,0,0,0,0
21,8480821,Filip Zadina,R,,25,0,0,0,0
21,8480001,Urho Vaakanainen,D,ANA,25,0,0,0,0
21,8470966,Mark Giordano,D,,41,0,0,0,0
21,8480853,Liam Foudy,C,,24,0,0,0,0
21,8475225,Craig Smith,C,CHI,35,0,0,0,0
21,8479972,Mason Shaw,C,WPG,26,0,0,0,0
21,8478451,Ethan Bear,D,WSH,27,0,0,0,0
21,8474040,Sam Gagner,C,,35,0,0,0,0
21,8480196,Jacob Bryson,D,BUF,27,0,0,0,0
21,8479984,Cal Foote,D,,26,0,0,0,0
21,8480011,Klim Kostin,C,SJS,25,0,0,0,0
21,8482176,Wyatt Kaiser,D,CHI,22,0,0,0,0
21,8476988,Matt Benning,D,SJS,30,0,0,0,0
21,8479370,Tyson Jost,C,CAR,26,0,0,0,0
21,8477464,Nic Petan,C,,29,0,0,0,0
21,8477380,Jonny Brodzinski,C,NYR,31,0,0,0,0
21,8480070,Ian Mitchell,D,BOS,25,0,0,0,0
21,8479315,Joey Anderson,R,CHI,26,0,0,0,0
21,8478099,Kevin Labanc,R,,29,0,0,0,0
21,8476874,Olli Maatta,D,DET,30,0,0,0,0
21,8475208,Brian Dumoulin,D,ANA,33,0,0,0,0
21,8478430,Oliver Kylington,D,,27,0,0,0,0
21,8479536,Axel Jonsson-Fjallby,L,WPG,26,0,0,0,0
21,8479671,Mathieu Olivier,R,CBJ,27,0,0,0,0
21,8471709,Marc-Edouard Vlasic,D,SJS,37,0,0,0,0
21,8479328,Julien Gauthier,R,NYI,27,0,0,0,0
21,8478421,A.J. Greer,L,FLA,28,0,0,0,0
21,8477573,Nathan Walker,L,STL,30,0,0,0,0
21,8481537,Nikita Okhotiuk,D,CGY,24,0,0,0,0
21,8474166,Alec Martinez,D,CHI,37,0,0,0,0
21,8470610,Zach Parise,L,,40,0,0,0,0
21,8477478,William Carrier,L,CAR,30,0,0,0,0
21,8479344,Jesse Puljujarvi,R,PIT,26,0,0,0,0
21,8480887,Jordan Harris,D,MTL,24,0,0,0,0
21,8478502,Dennis Gilbert,D,BUF,28,0,0,0,0
21,8482730,Brandt Clarke,D,LAK,21,0,0,0,0
21,8480355,Mark Kastelic,C,BOS,25,0,0,0,0
21,8475750,Jon Merrill,D,MIN,32,0,0,0,0
21,8475164,Jakob Silfverberg,R,,34,0,0,0,0
21,8477944,Jakub Vrana,L,,28,0,0,0,0
21,8479439,Jacob MacDonald,D,COL,31,0,0,0,0
21,8474568,Luke Schenn,D,NSH,35,0,0,0,0
21,8478454,Noah Juulsen,D,VAN,27,0,0,0,0
21,8475752,Tyler Pitlick,C,,33,0,0,0,0
21,8482148,Hendrix Lapierre,C,WSH,22,0,0,0,0
21,8481167,Brayden Pachal,D,CGY,25,0,0,0,0
21,8478043,Sam Lafferty,C,BUF,29,0,0,0,0
21,8479321,Lucas Johansen,D,,27,0,0,0,0
21,8471699,Andrew Cogliano,C,,37,0,0,0,0
21,8481521,Ronnie Attard,D,PHI,25,0,0,0,0
21,8481161,Jake Christiansen,D,CBJ,25,0,0,0,0
21,8479458,Nikita Zaitsev,D,,33,0,0,0,0
21,8479619,Michael Carcone,L,UTA,28,0,0,0,0
21,8479026,Philippe Myers,D,TOR,27,0,0,0,0
21,8477330,Dominik Kubalik,L,,29,0,0,0,0
21,8481617,Vasily Podkolzin,R,VAN,23,0,0,0,0
21,8481701,Santeri Hatakka,D,NJD,23,0,0,0,0
21,8479514,Rem Pitlick,C,,27,0,0,0,0
21,8477446,Michael McCarron,R,NSH,29,0,0,0,0
21,8470604,Jeff Carter,C,,39,0,0,0,0
21,8482241,Radim Zohorna,L,,28,0,0,0,0
21,8480289,Morgan Barron,C,WPG,26,0,0,0,0
21,8479379,Givani Smith,R,SJS,26,0,0,0,0
21,8480216,Jacob Peterson,C,,25,0,0,0,0
21,8477851,Jordan Oesterle,D,BOS,32,0,0,0,0
21,8484258,Sam Malinski,D,COL,26,0,0,0,0
21,8478904,Steven Lorentz,C,,28,0,0,0,0
21,8482095,Tyler Kleven,D,OTT,22,0,0,0,0
21,8480848,Ty Dellandrea,C,SJS,24,0,0,0,0
21,8476884,Derrick Pouliot,D,,30,0,0,0,0
21,8479336,Carl Grundstrom,R,SJS,27,0,0,0,0
21,8482964,Arber Xhekaj,D,MTL,23,0,0,0,0
21,8471686,Marc Staal,D,,37,0,0,0,0
21,8477887,Patrick Brown,C,BOS,32,0,0,0,0
21,8478495,Denis Gurianov,R,,27,0,0,0,0
21,8473504,Cal Clutterbuck,R,,37,0,0,0,0
21,8481550,Adam Beckman,L,NJD,23,0,0,0,0
21,8480845,Rasmus Kupari,C,WPG,24,0,0,0,0
21,8474009,Nick Bonino,C,,36,0,0,0,0
21,8478585,Derek Ryan,C,EDM,38,0,0,0,0
21,8477962,Brendan Lemieux,L,CAR,28,0,0,0,0
21,8482861,Vincent Iorio,D,WSH,22,0,0,0,0
21,8479378,Logan Stanley,D,WPG,26,0,0,0,0
21,8473446,Erik Johnson,D,PHI,36,0,0,0,0
21,8481743,Marc Del Gaizo,D,NSH,25,0,0,0,0
21,8477384,Josh Brown,D,EDM,30,0,0,0,0
21,8482165,Yan Kuznetsov,D,CGY,22,0,0,0,0
21,8478424,Jansen Harkins,C,ANA,27,0,0,0,0
21,8482144,Jack Thompson,D,SJS,22,0,0,0,0
21,8478512,Austin Czarnik,C,,32,0,0,0,0
21,8477527,Ross Johnston,L,ANA,30,0,0,0,0
21,8479383,Boris Katchouk,L,,26,0,0,0,0
21,8482094,Daemon Hunt,D,MIN,22,0,0,0,0
21,8481719,Maxwell Crozier,D,TBL,24,0,0,0,0
21,8480192,Johnathan Kovacevic,D,NJD,27,0,0,0,0
21,8479376,Victor Mete,D,,26,0,0,0,0
21,8482511,Mason Lohrei,D,BOS,23,0,0,0,0
21,8475825,Jani Hakanpää,D,,32,0,0,0,0
21,8478021,William Lagesson,D,DET,28,0,0,0,0
21,8475795,Dylan McIlrath,D,WSH,32,0,0,0,0
21,8477846,Ryan Carpenter,C,,33,0,0,0,0
21,8481056,Spencer Stastney,D,NSH,24,0,0,0,0
21,8481564,Ryan Johnson,D,BUF,23,0,0,0,0
21,8478017,Mark Friedman,D,VAN,29,0,0,0,0
21,8479320,Max Lajoie,D,SEA,27,0,0,0,0
21,8480075,Cameron Crotty,D,MIN,25,0,0,0,0
21,8484287,Cole McWard,D,VAN,23,0,0,0,0
21,8484254,Akito Hirose,D,VAN,25,0,0,0,0
21,8483407,Brandon Scanlin,D,NYR,25,0,0,0,0
21,8480274,Philip Kemp,D,EDM,25,0,0,0,0
21,8479522,Hardy Haman Aktell,D,WSH,26,0,0,0,0
21,8480007,Jonas Rondbjerg,R,VGK,25,0,0,0,0
21,8477454,Adam Erne,L,,29,0,0,0,0
21,8481679,Maxence Guenette,D,OTT,23,0,0,0,0
21,8480441,Trey Fix-Wolansky,R,CBJ,25,0,0,0,0
21,8483546,Marshall Rifai,D,TOR,26,0,0,0,0
21,8480084,Nick DeSimone,D,NJD,30,0,0,0,0
21,8481030,Jack St. Ivany,D,PIT,25,0,0,0,0
21,8481592,Jakob Pelletier,L,CGY,23,0,0,0,0
21,8478011,Louie Belpedio,D,PHI,28,0,0,0,0
21,8477930,Pierre-Edouard Bellemare,L,,39,0,0,0,0
21,8484321,Nikolas Matinpalo,D,OTT,26,0,0,0,0
21,8482067,Connor Mackey,D,NYR,28,0,0,0,0
21,8481806,Louis Crevier,D,CHI,23,0,0,0,0
21,8484326,Patrik Koch,D,UTA,28,0,0,0,0
21,8477971,Andreas Englund,D,LAK,28,0,0,0,0
21,8481751,Lukas Rousek,R,BUF,25,0,0,0,0
21,8481006,Tyler Tucker,D,STL,24,0,0,0,0
21,8476867,Brendan Gaunce,C,MIN,30,0,0,0,0
21,8479520,Brandon Duhaime,R,WSH,27,0,0,0,0
21,8477073,Kurtis MacDermid,L,NJD,30,0,0,0,0
21,8480874,Adam Ginning,D,PHI,24,0,0,0,0
21,8477473,Justin Bailey,R,SJS,29,0,0,0,0
21,8479066,Ryan Lomberg,L,CGY,30,0,0,0,0
21,8477070,Liam O'Brien,C,UTA,30,0,0,0,0
21,8474618,Marco Scandella,D,,34,0,0,0,0
21,8475797,Jarred Tinordi,D,,32,0,0,0,0
21,8481441,Joe Snively,C,DET,28,0,0,0,0
21,8477244,Chad Ruhwedel,D,NYR,34,0,0,0,0
21,8479772,Zack MacEwen,R,OTT,28,0,0,0,0
21,8481147,Reese Johnson,C,MIN,26,0,0,0,0
21,8481043,Cole Koepke,L,BOS,26,0,0,0,0
21,8483619,Filip Roos,D,OTT,25,0,0,0,0
21,8481541,Samuel Bolduc,D,NYI,24,0,0,0,0
21,8477810,Joel Hanley,D,CGY,33,0,0,0,0
21,8476907,Mackenzie MacEachern,L,,30,0,0,0,0
21,8482652,Walker Duehr,R,CGY,27,0,0,0,0
21,8477126,Jayson Megna,C,,34,0,0,0,0
21,8483398,Declan Carlile,D,TBL,31,0,0,0,0
21,8482929,Emil Lilleberg,D,TBL,23,0,0,0,0
21,8480880,Jakub Lauko,C,MIN,24,0,0,0,0
21,8480245,Olle Lycksell,R,PHI,25,0,0,0,0
21,8480252,Cole Guttman,C,CHI,25,0,0,0,0
21,8477467,Gustav Olofsson,D,SEA,30,0,0,0,0
21,8479968,Vinni Lettieri,C,BOS,29,0,0,0,0
21,8478400,Colin White,C,,27,0,0,0,0
21,8475755,Alexander Petrovic,D,DAL,32,0,0,0,0
21,8481812,Nikolai Knyzhov,D,,27,0,0,0,0
21,8481593,Jayden Struble,D,MTL,23,0,0,0,0
21,8481532,Alex Turcotte,C,LAK,23,0,0,0,0
21,8482126,Emil Andrae,D,PHI,31,0,0,0,0
21,8479944,Zach Aston-Reese,C,VGK,30,0,0,0,0
21,8471817,Ryan Reaves,R,TOR,37,0,0,0,0
21,8481206,John Ludvig,D,PIT,24,0,0,0,0
21,8481599,Victor Soderstrom,D,UTA,23,0,0,0,0
21,8480292,Carson Meyer,R,ANA,27,0,0,0,0
21,8482496,Nils Aman,C,VAN,24,0,0,0,0
21,8479718,Alex Barré-Boulet,C,MTL,27,0,0,0,0
21,8479994,Jaret Anderson-Dolan,C,WPG,25,0,0,0,0
21,8480184,Gustav Lindstrom,D,,26,0,0,0,0
21,8480890,Jan Jenik,R,OTT,24,0,0,0,0
21,8478067,Oskar Lindblom,L,,28,0,0,0,0
21,8476934,Brock McGinn,L,ANA,30,0,0,0,0
21,8479985,Cale Fleury,D,SEA,26,0,0,0,0
21,8484304,Uvis Balinskis,D,FLA,28,0,0,0,0
21,8479981,Jonah Gadjovich,L,FLA,26,0,0,0,0
21,8481716,Dmitri Voronkov,L,CBJ,24,0,0,0,0
21,8474709,Matt Martin,L,,35,0,0,0,0
21,8482634,Alex Steeves,C,TOR,25,0,0,0,0
21,8480823,Alexander Alexeyev,D,WSH,25,0,0,0,0
21,8477541,Dakota Mermis,D,TOR,30,0,0,0,0
21,8483491,Ivan Miroshnichenko,L,WSH,20,0,0,0,0
21,8478477,Mitchell Stephens,C,SEA,27,0,0,0,0
21,8481543,Nikita Alexandrov,C,STL,24,0,0,0,0
21,8479423,Alex Nylander,L,,26,0,0,0,0
21,8482451,Mikael Pyyhtia,L,CBJ,23,0,0,0,0
21,8478831,Kevin Stenlund,C,UTA,28,0,0,0,0
21,8480306,Grant Hutton,D,NYI,29,0,0,0,0
21,8478028,Fredrik Olofsson,L,,28,0,0,0,0
21,8477462,Robert Hagg,D,VGK,29,0,0,0,0
21,8477320,Anton Blidh,L,NYR,29,0,0,0,0
21,8482157,Will Cuylle,L,NYR,22,0,0,0,0
21,8482737,Zack Bolduc,C,STL,21,0,0,0,0
21,8481239,Samuel Fagemo,L,,24,0,0,0,0
21,8481600,Tobias Bjornfot,D,FLA,23,0,0,0,0
21,8478409,Anthony Richard,C,PHI,28,0,0,0,0
21,8474145,Robert Bortuzzo,D,,35,0,0,0,0
21,8475958,Michael Sgarbossa,C,WSH,32,0,0,0,0
21,8479986,Kole Lind,R,DAL,26,0,0,0,0
21,8479249,Andrew Poturalski,C,SJS,30,0,0,0,0
21,8479362,Riley Tufte,L,BOS,26,0,0,0,0
21,8479991,Jake Leschyshyn,C,NYR,25,0,0,0,0
21,8479587,Rhett Gardner,C,PHI,28,0,0,0,0
21,8482744,James Malatesta,L,CBJ,21,0,0,0,0
21,8478854,Ryan Shea,D,PIT,27,0,0,0,0
21,8481591,Sam Poulin,R,,23,0,0,0,0
21,8483512,Matt Savoie,C,EDM,20,0,0,0,0
21,8482102,Vasily Ponomarev,C,PIT,22,0,0,0,0
21,8482162,Roby Jarventie,L,EDM,22,0,0,0,0
21,8481016,Ruslan Iskhakov,C,,24,0,0,0,0
21,8482172,Landon Slaggert,L,CHI,22,0,0,0,0
21,8482747,Brennan Othmann,L,NYR,21,0,0,0,0
21,8480031,Maxime Comtois,L,,25,0,0,0,0
21,8480226,Marián Studenic,R,,26,0,0,0,0
21,8478408,Travis Dermott,D,,28,0,0,0,0
21,8481518,Nolan Foote,L,NJD,24,0,0,0,0
21,8479419,Brett Murray,L,BUF,26,0,0,0,0
21,8482088,Justin Sourdif,R,FLA,22,0,0,0,0
21,8482201,Gage Goncalves,C,TBL,23,0,0,0,0
21,8481578,Graeme Clarke,R,MIN,23,0,0,0,0
21,8482177,Marat Khusnutdinov,C,MIN,22,0,0,0,0
21,8481754,Nikita Nesterenko,C,ANA,23,0,0,0,0
21,8483531,Brian Halonen,L,NJD,25,0,0,0,0
21,8483920,Pierrick Dube,R,WSH,23,0,0,0,0
21,8480851,Akil Thomas,C,LAK,24,0,0,0,0
21,8475235,Nicolas Deslauriers,L,PHI,33,0,0,0,0
21,8482476,Emil Heineman,L,MTL,23,0,0,0,0
21,8477149,Scott Sabourin,R,SJS,32,0,0,0,0
21,8483549,Lucas Condotta,L,MTL,27,0,0,0,0
21,8482765,Isak Rosen,R,BUF,21,0,0,0,0
21,8481237,Kyle MacLean,C,NYI,25,0,0,0,0
21,8481024,Linus Karlsson,C,VAN,25,0,0,0,0
21,8481690,Tyler Angle,C,,24,0,0,0,0
21,8483570,Ben Meyers,C,SEA,26,0,0,0,0
21,8481655,Cole Schwindt,R,CGY,23,0,0,0,0
21,8481462,Mason Morelli,L,VGK,28,0,0,0,0
21,8483401,Marc Johnstone,R,PIT,28,0,0,0,0
21,8478956,Samuel Laberge,L,NJD,27,0,0,0,0
21,8479533,Joona Koppanen,L,,26,0,0,0,0
21,8482197,Adam Raska,R,MIN,23,0,0,0,0
21,8482250,Callahan Burke,C,VGK,27,0,0,0,0
21,8482784,Zach Dean,C,STL,21,0,0,0,0
21,8484255,Jason Polin,R,COL,25,0,0,0,0
21,8481077,John Leonard,L,,26,0,0,0,0
21,8481534,Raphael Lavoie,C,EDM,24,0,0,0,0
21,8483609,Adam Klapka,R,CGY,24,0,0,0,0
21,8482751,Ryan Winterton,C,SEA,21,0,0,0,0
21,8480267,Sammy Walker,C,MIN,25,0,0,0,0
21,8475766,Austin Watson,L,,32,0,0,0,0
21,8482460,Matt Rempe,C,NYR,22,0,0,0,0
21,8481065,Angus Crookshank,L,OTT,25,0,0,0,0
21,8481070,Hugh McGing,L,,26,0,0,0,0
21,8476323,Max McCormick,L,SEA,32,0,0,0,0
21,8483395,Arshdeep Bains,L,VAN,23,0,0,0,0
21,8484259,Ondrej Pavel,C,COL,31,0,0,0,0
21,8483432,Luca Del Bel Belluz,C,CBJ,31,0,0,0,0
21,8483045,Cameron Butler,R,CBJ,31,0,0,0,0
21,8482061,Brandon Biro,L,SEA,26,0,0,0,0
21,8477401,John Hayden,C,SEA,29,0,0,0,0
21,8475278,Byron Froese,C,,33,0,0,0,0
21,8478446,Glenn Gawdin,C,LAK,27,0,0,0,0
21,8477993,Justin Kirkland,C,CGY,28,0,0,0,0
21,8482147,Jean-Luc Foudy,C,COL,22,0,0,0,0
21,8480032,Shane Bowers,C,NJD,25,0,0,0,0
21,8479330,Brandon Gignac,C,MTL,27,0,0,0,0
21,8480776,Sheldon Rempal,R,,29,0,0,0,0
21,8475413,Justin Dowling,C,NJD,34,0,0,0,0
21,8481726,Adam Edstrom,C,NYR,24,0,0,0,0
21,8480844,Grigori Denisenko,L,VGK,24,0,0,0,0
21,8478147,Bokondji Imama,L,PIT,28,0,0,0,0
21,8478881,Brett Seney,L,CHI,28,0,0,0,0
21,8483630,Pavol Regenda,L,ANA,25,0,0,0,0
21,8480836,Jonathan Gruden,C,,24,0,0,0,0
21,8484314,Jiri Smejkal,L,,28,0,0,0,0
21,8475780,Chris Wagner,R,COL,33,0,0,0,0
21,8479546,Oskar Steen,C,,26,0,0,0,0
21,8483597,Milos Kelemen,L,UTA,25,0,0,0,0
21,8481789,Tye Kartye,L,SEA,23,0,0,0,0
21,8484325,Waltteri Merela,C,TBL,26,0,0,0,0
21,8479421,Jacob Moverare,D,LAK,26,0,0,0,0
21,8481585,Egor Afanasyev,L,SJS,23,0,0,0,0
21,8479547,Matthew Phillips,R,,26,0,0,0,0
21,8479367,William Lockwood,R,FLA,26,0,0,0,0
21,8476915,Jujhar Khaira,L,,30,0,0,0,0
21,8481422,Jacob Lucchini,C,NSH,29,0,0,0,0
21,8480468,James Hamblin,L,EDM,25,0,0,0,0
21,8478051,Max Willman,C,NJD,29,0,0,0,0
21,8481556,John Beecher,C,BOS,23,0,0,0,0
21,8478078,Rourke Chartier,C,,28,0,0,0,0
22,8476453,Nikita Kucherov,R,TBL,31,82,37,100,137
22,8478402,Connor McDavid,C,EDM,27,82,47,85,132
22,8477492,Nathan MacKinnon,C,COL,29,82,54,76,130
22,8481559,Jack Hughes,C,NJD,23,82,53,74,127
22,8477934,Leon Draisaitl,C,EDM,29,82,32,93,125
22,8479318,Auston Matthews,C,TOR,27,82,63,50,113
22,8480012,Elias Pettersson,C,VAN,26,82,45,68,113
22,8476887,Filip Forsberg,L,NSH,30,82,53,59,112
22,8476468,J.T. Miller,C,VAN,31,82,38,68,106
22,8478550,Artemi Panarin,L,NYR,33,82,33,73,106
22,8477956,David Pastrnak,R,BOS,28,82,50,51,101
22,8477942,Kevin Fiala,L,LAK,28,82,33,68,101
22,8471675,Sidney Crosby,C,PIT,37,82,45,55,100
22,8479314,Matthew Tkachuk,L,FLA,27,82,35,65,100
22,8478864,Kirill Kaprizov,L,MIN,27,82,52,46,98
22,8477501,Valeri Nichushkin,R,COL,29,82,53,43,96
22,8478449,Roope Hintz,C,DAL,28,82,45,49,94
22,8480002,Nico Hischier,C,NJD,25,82,39,54,93
22,8480027,Jason Robertson,L,DAL,25,82,35,58,93
22,8481523,Kirby Dach,C,MTL,23,82,17,75,92
22,8478427,Sebastian Aho,C,CAR,27,82,34,57,91
22,8477493,Aleksander Barkov,C,FLA,29,82,27,64,91
22,8477939,William Nylander,R,TOR,28,82,33,57,90
22,8476459,Mika Zibanejad,C,NYR,31,82,33,55,88
22,8478010,Brayden Point,C,TBL,28,82,55,32,87
22,8477940,Nikolaj Ehlers,L,WPG,28,82,35,52,87
22,8480023,Robert Thomas,C,STL,25,82,30,57,87
22,8482116,Tim Stützle,C,OTT,22,82,26,61,87
22,8480800,Quinn Hughes,D,VAN,25,82,10,77,87
22,8478873,Troy Terry,R,ANA,27,82,35,51,86
22,8478398,Kyle Connor,L,WPG,28,82,41,44,85
22,8476460,Mark Scheifele,C,WPG,31,82,35,50,85
22,8482093,Seth Jarvis,C,CAR,22,82,34,50,84
22,8477447,Shea Theodore,D,VGK,29,82,16,68,84
22,8477949,Alex Tuch,R,BUF,28,82,33,50,83
22,8475158,Ryan O'Reilly,C,NSH,33,82,33,49,82
22,8475172,Nazem Kadri,C,CGY,34,82,37,44,81
22,8480830,Andrei Svechnikov,R,CAR,24,82,37,44,81
22,8477946,Dylan Larkin,C,DET,28,82,32,49,81
22,8476346,Johnny Gaudreau,L,CBJ,31,82,18,63,81
22,8477933,Sam Reinhart,C,FLA,29,82,34,45,79
22,8480208,Drake Batherson,R,OTT,26,82,30,49,79
22,8476462,Dougie Hamilton,D,NJD,31,82,16,63,79
22,8480801,Brady Tkachuk,L,OTT,25,82,38,40,78
22,8480015,Owen Tippett,R,PHI,25,82,35,43,78
22,8480036,Miro Heiskanen,D,DAL,25,82,14,64,78
22,8478403,Jack Eichel,C,VGK,28,82,40,37,77
22,8479385,Jordan Kyrou,C,STL,26,82,32,45,77
22,8473419,Brad Marchand,L,BOS,36,82,22,55,77
22,8474600,Roman Josi,D,NSH,34,82,20,57,77
22,8475167,Victor Hedman,D,TBL,34,82,13,64,77
22,8474564,Steven Stamkos,C,NSH,34,82,31,45,76
22,8474679,Gustav Nyquist,C,NSH,35,82,25,51,76
22,8479337,Alex DeBrincat,R,DET,27,82,29,46,75
22,8476454,Ryan Nugent-Hopkins,C,EDM,31,82,26,49,75
22,8471685,Anze Kopitar,C,LAK,37,82,25,50,75
22,8479323,Adam Fox,D,NYR,26,82,13,62,75
22,8475184,Chris Kreider,L,NYR,33,82,44,30,74
22,8478439,Travis Konecny,R,PHI,27,82,36,38,74
22,8479420,Tage Thompson,C,BUF,27,82,34,40,74
22,8477404,Jake Guentzel,C,TBL,30,82,25,49,74
22,8476432,Boone Jenner,C,CBJ,31,82,39,34,73
22,8475170,Brayden Schenn,C,STL,33,82,31,42,73
22,8478445,Mathew Barzal,C,NYI,27,82,18,55,73
22,8476456,Jonathan Huberdeau,C,CGY,31,82,17,56,73
22,8477409,Carter Verhaeghe,C,FLA,29,82,42,30,72
22,8479675,Trevor Moore,L,LAK,29,82,37,35,72
22,8478366,Frank Vatrano,R,ANA,30,82,37,35,72
22,8480839,Rasmus Dahlin,D,BUF,24,82,18,54,72
22,8478460,Zach Werenski,D,CBJ,27,82,17,55,72
22,8480803,Evan Bouchard,D,EDM,25,82,15,57,72
22,8480014,Gabriel Vilardi,C,WPG,25,82,37,34,71
22,8478414,Timo Meier,R,NJD,28,82,36,35,71
22,8480018,Nick Suzuki,C,MTL,25,82,35,36,71
22,8475913,Mark Stone,R,VGK,32,82,25,46,71
22,8479407,Jesper Bratt,L,NJD,26,82,22,49,71
22,8479339,Patrik Laine,L,CBJ,26,82,33,37,70
22,8478401,Pavel Zacha,C,BOS,27,82,32,38,70
22,8475810,Bryan Rust,R,PIT,32,82,33,36,69
22,8476539,Jonathan Marchessault,R,NSH,34,82,29,40,69
22,8482665,Matty Beniers,C,SEA,22,82,28,41,69
22,8478420,Mikko Rantanen,R,COL,28,82,26,43,69
22,8475692,Mats Zuccarello,R,MIN,37,82,20,49,69
22,8477494,Jonathan Drouin,L,COL,29,82,17,52,69
22,8480865,Noah Dobson,D,NYI,24,82,12,57,69
22,8474586,Jordan Eberle,R,SEA,34,82,32,36,68
22,8479542,Brandon Hagel,L,TBL,26,82,28,40,68
22,8481557,Matt Boldy,L,MIN,23,82,27,41,68
22,8477402,Pavel Buchnevich,L,STL,29,82,24,44,68
22,8476853,Morgan Rielly,D,TOR,30,82,15,53,68
22,8479343,Clayton Keller,R,UTA,26,82,31,36,67
22,8477960,Adrian Kempe,R,LAK,28,82,31,36,67
22,8480797,Joel Farabee,L,PHI,24,82,29,38,67
22,8473512,Claude Giroux,R,OTT,36,82,27,40,67
22,8475754,Brock Nelson,C,NYI,33,82,27,40,67
22,8475798,Mikael Granlund,C,SJS,32,82,19,48,67
22,8477496,Elias Lindholm,C,BOS,30,82,19,48,67
22,8477500,Bo Horvat,C,NYI,29,82,37,29,66
22,8482740,Wyatt Johnston,C,DAL,21,82,36,30,66
22,8480039,Martin Necas,C,CAR,25,82,25,41,66
22,8481533,Trevor Zegras,C,ANA,23,82,23,43,66
22,8477504,Josh Morrissey,D,WPG,29,82,13,53,66
22,8474563,Drew Doughty,D,LAK,35,82,13,53,66
22,8475726,Tyler Toffoli,C,SJS,32,82,30,35,65
22,8471215,Evgeni Malkin,C,PIT,38,82,25,40,65
22,8478440,Dylan Strome,C,WSH,27,82,23,42,65
22,8473994,Jamie Benn,L,DAL,35,82,22,43,65
22,8474590,John Carlson,D,WSH,34,82,18,47,65
22,8480069,Cale Makar,D,COL,26,82,10,55,65
22,8477955,Jared McCann,L,SEA,28,82,33,31,64
22,8476389,Vincent Trocheck,C,NYR,31,82,23,41,64
22,8482684,Luke Hughes,D,NJD,21,82,18,46,64
22,8471214,Alex Ovechkin,L,WSH,39,82,28,35,63
22,8478975,Mason Marchment,L,DAL,29,82,26,37,63
22,8475794,Tyler Seguin,C,DAL,32,82,23,40,63
22,8476792,Torey Krug,D,STL,33,82,15,48,63
22,8474578,Erik Karlsson,D,PIT,34,82,13,50,63
22,8478444,Brock Boeser,R,VAN,27,82,31,31,62
22,8475166,John Tavares,C,TOR,34,82,25,37,62
22,8478047,Michael Bunting,L,PIT,29,82,22,40,62
22,8479325,Charlie McAvoy,D,BOS,27,82,9,53,62
22,8475786,Zach Hyman,L,EDM,32,82,38,23,61
22,8476483,Rickard Rakell,R,PIT,31,82,31,30,61
22,8477951,Nick Schmaltz,C,UTA,28,82,22,39,61
22,8473986,Alex Killorn,L,ANA,35,82,22,39,61
22,8480188,Fabian Zetterlund,L,SJS,25,82,20,41,61
22,8476399,Blake Coleman,C,CGY,33,82,25,35,60
22,8482078,Lucas Raymond,L,DET,22,82,23,37,60
22,8476826,Yanni Gourde,C,SEA,33,82,18,42,60
22,8479425,Filip Hronek,D,VAN,27,82,13,47,60
22,8481596,Shane Pinto,C,OTT,24,82,26,33,59
22,8480078,Filip Chytil,C,NYR,25,82,25,34,59
22,8476881,Tomas Hertl,C,VGK,31,82,23,36,59
22,8477416,Oliver Bjorkstrand,R,SEA,29,82,22,37,59
22,8475168,Matt Duchene,C,DAL,33,82,21,38,59
22,8480798,Philipp Kurashev,C,CHI,25,82,19,40,59
22,8475169,Evander Kane,L,EDM,33,82,33,25,58
22,8478498,Jake DeBrusk,L,VAN,28,82,27,31,58
22,8477935,Sam Bennett,C,FLA,28,82,26,32,58
22,8477456,J.T. Compher,L,DET,29,82,24,34,58
22,8482097,Jack Quinn,R,BUF,23,82,24,34,58
22,8478469,Thomas Chabot,D,OTT,27,82,20,38,58
22,8478438,Tommy Novak,C,NSH,27,82,18,40,58
22,8475753,Justin Faulk,D,STL,32,82,14,44,58
22,8478407,Vince Dunn,D,SEA,28,82,11,47,58
22,8482159,Tyson Foerster,R,PHI,22,82,33,24,57
22,8471698,T.J. Oshie,R,WSH,38,82,32,25,57
22,8481540,Cole Caufield,R,MTL,23,82,30,27,57
22,8481528,Dylan Cozens,C,BUF,23,82,29,28,57
22,8477964,Ivan Barbashev,C,VGK,29,82,28,29,57
22,8482110,Dawson Mercer,C,NJD,23,82,26,31,57
22,8478856,Conor Garland,R,VAN,28,82,22,35,57
22,8471724,Kris Letang,D,PIT,37,82,15,42,57
22,8477503,Max Domi,C,TOR,29,82,13,44,57
22,8477511,Anthony Mantha,R,CGY,30,82,29,27,56
22,8482667,William Eklund,L,SJS,22,82,23,33,56
22,8477479,Tyler Bertuzzi,L,CHI,29,82,21,35,56
22,8477497,Sean Monahan,C,CBJ,30,82,19,37,56
22,8480028,Morgan Frost,C,PHI,25,82,17,39,56
22,8477495,Seth Jones,D,CHI,30,82,13,43,56
22,8478397,Rasmus Andersson,D,CGY,28,82,12,44,56
22,8475764,Cam Fowler,D,ANA,33,82,5,51,56
22,8481068,Yegor Sharangovich,C,CGY,26,82,31,24,55
22,8477451,Ryan Hartman,R,MIN,30,82,26,29,55
22,8478493,Joel Eriksson Ek,C,MIN,27,82,24,31,55
22,8476479,Phillip Danault,C,LAK,31,82,22,33,55
22,8474150,Mikael Backlund,C,CGY,35,82,17,38,55
22,8478038,Devon Toews,D,COL,30,82,13,42,55
22,8474141,Patrick Kane,R,DET,36,82,25,29,54
22,8480064,Josh Norris,C,OTT,25,82,21,32,53
22,8476869,Brady Skjei,D,NSH,30,82,14,39,53
22,8477932,Aaron Ekblad,D,FLA,28,82,13,40,53
22,8477948,Travis Sanheim,D,PHI,28,82,10,43,53
22,8477476,Artturi Lehkonen,L,COL,29,82,26,26,52
22,8478519,Anthony Cirelli,C,TBL,27,82,23,29,52
22,8476882,Teuvo Teravainen,L,CHI,30,82,18,34,52
22,8477444,Andre Burakovsky,L,SEA,29,82,18,34,52
22,8476905,Chandler Stephenson,C,SEA,30,82,15,37,52
22,8478396,Noah Hanifin,D,VGK,27,82,15,37,52
22,8476448,William Karlsson,C,VGK,31,82,14,38,52
22,8476875,Mike Matheson,D,MTL,30,82,13,39,52
22,8478458,Jack Roslovic,C,CAR,27,82,12,40,52
22,8475784,Jeff Skinner,C,EDM,32,82,25,26,51
22,8474102,David Perron,L,OTT,36,82,22,29,51
22,8482109,Alexis Lafrenière,L,NYR,23,82,22,29,51
22,8477407,Anthony Duclair,L,NYI,29,82,20,31,51
22,8477429,Andrew Copp,C,DET,30,82,15,36,51
22,8475768,Jaden Schwartz,C,SEA,32,82,24,26,50
22,8479987,Morgan Geekie,C,BOS,26,82,21,29,50
22,8475722,Jason Zucker,L,BUF,32,82,21,29,50
22,8477426,Nicholas Paul,L,TBL,29,82,20,30,50
22,8474565,Alex Pietrangelo,D,VGK,34,82,13,37,50
22,8483515,Juraj Slafkovsky,L,MTL,20,82,29,20,49
22,8478042,Viktor Arvidsson,R,EDM,31,82,23,26,49
22,8482475,Yegor Chinakhov,R,CBJ,23,82,21,28,49
22,8482124,Quinton Byfield,R,LAK,22,82,18,31,49
22,8480829,Jesperi Kotkaniemi,C,CAR,24,82,18,31,49
22,8481656,Aliaksei Protas,C,WSH,23,82,17,32,49
22,8478115,Pierre Engvall,L,NYI,28,82,25,23,48
22,8477986,Brandon Montour,D,SEA,30,82,16,32,48
22,8479400,Pierre-Luc Dubois,L,WSH,26,82,16,32,48
22,8476906,Shayne Gostisbehere,D,CAR,31,82,15,33,48
22,8477021,Alex Kerfoot,C,UTA,30,82,12,36,48
22,8478474,Lawson Crouse,L,UTA,27,82,31,16,47
22,8475151,Kyle Palmieri,C,NYI,33,82,19,28,47
22,8479345,Jakob Chychrun,D,WSH,26,82,18,29,47
22,8479999,Casey Mittelstadt,C,COL,26,82,13,34,47
22,8470613,Brent Burns,D,CAR,39,82,12,35,47
22,8482113,Anton Lundell,C,FLA,23,82,21,25,46
22,8475191,Reilly Smith,R,NYR,33,82,19,27,46
22,8475745,Charlie Coyle,C,BOS,32,82,18,28,46
22,8482149,Cole Perfetti,C,WPG,22,82,15,31,46
22,8478462,Nicolas Roy,C,VGK,27,82,15,31,46
22,8476458,Ryan Strome,C,ANA,31,82,13,33,46
22,8476927,Teddy Blueger,C,VAN,30,82,11,35,46
22,8481546,Cam York,D,PHI,23,82,6,40,46
22,8482745,Mason McTavish,C,ANA,21,82,28,17,45
22,8480220,Noah Cates,L,PHI,25,82,21,24,45
22,8480813,Joe Veleno,C,DET,24,82,20,25,45
22,8481554,Kaapo Kakko,R,NYR,23,82,19,26,45
22,8477346,MacKenzie Weegar,D,CGY,30,82,15,30,45
22,8481581,Thomas Harley,D,DAL,23,82,12,33,45
22,8476438,Brandon Saad,L,STL,32,82,27,17,44
22,8479365,Trent Frederic,C,BOS,26,82,25,19,44
22,8475791,Taylor Hall,L,CHI,33,82,23,21,44
22,8477989,Christian Dvorak,C,MTL,28,82,19,25,44
22,8482699,Dylan Guenther,R,UTA,21,82,19,25,44
22,8476480,Vladislav Namestnikov,C,WPG,32,82,18,26,44
22,8476872,Scott Laughton,C,PHI,30,82,16,28,44
22,8482092,Ridly Greig,C,OTT,22,82,15,29,44
22,8476885,Jacob Trouba,D,NYR,30,82,13,31,44
22,8476329,Travis Boyd,C,MIN,31,82,11,33,44
22,8482105,Jake Sanderson,D,OTT,22,82,11,33,44
22,8473563,Nicklas Backstrom,C,WSH,37,82,10,34,44
22,8478055,Gustav Forsling,D,FLA,28,82,9,35,44
22,8481542,Moritz Seider,D,DET,23,82,5,39,44
22,8475314,Anders Lee,L,NYI,34,82,27,16,43
22,8477998,Warren Foegele,L,LAK,28,82,22,21,43
22,8477987,Ryan Donato,C,CHI,28,82,22,21,43
22,8475799,Nino Niederreiter,R,WPG,32,82,20,23,43
22,8475765,Vladimir Tarasenko,R,DET,33,82,18,25,43
22,8480068,Ryan Poehling,C,PHI,25,82,18,25,43
22,8475193,Tomas Tatar,L,NJD,34,82,13,30,43
22,8481711,Matias Maccelli,L,UTA,24,82,10,33,43
22,8476958,Jaccob Slavin,D,CAR,30,82,7,36,43
22,8479410,Mikhail Sergachev,D,UTA,26,82,4,39,43
22,8480893,Kirill Marchenko,R,CBJ,24,82,23,19,42
22,8484144,Connor Bedard,C,CHI,19,82,20,22,42
22,8479992,Michael Rasmussen,C,DET,25,82,19,23,42
22,8476880,Tom Wilson,R,WSH,30,82,18,24,42
22,8474641,Adam Henrique,C,EDM,34,82,18,24,42
22,8478233,Andrew Mangiapane,L,WSH,28,82,17,25,42
22,8474053,Logan Couture,C,SJS,35,82,15,27,42
22,8480113,Alex Iafallo,L,WPG,31,82,13,29,42
22,8479525,Ross Colton,C,COL,28,82,24,17,41
22,8482089,Jake Neighbours,L,STL,22,82,20,21,41
22,8475714,Calle Jarnkrok,C,TOR,33,82,18,23,41
22,8473422,Nick Foligno,L,CHI,37,82,17,24,41
22,8481618,Alex Newhook,C,MTL,23,82,13,28,41
22,8478911,Matt Roy,D,WSH,29,82,13,28,41
22,8476923,Damon Severson,D,CBJ,30,82,10,31,41
22,8476278,Colin Blackwell,C,DAL,31,82,26,14,40
22,8480459,Pius Suter,C,VAN,28,82,21,19,40
22,8481604,Pavel Dorofeyev,L,VGK,24,82,20,20,40
22,8480074,Alexandre Texier,C,STL,25,82,16,24,40
22,8481522,Peyton Krebs,C,BUF,23,82,9,31,40
22,8482146,Luke Evangelista,R,NSH,22,82,22,17,39
22,8475760,Nick Bjugstad,C,UTA,32,82,21,18,39
22,8478891,Mason Appleton,C,WPG,28,82,19,20,39
22,8478057,Dakota Joshua,C,VAN,28,82,14,25,39
22,8474716,Jared Spurgeon,D,MIN,35,82,14,25,39
22,8476461,Sean Couturier,C,PHI,32,82,11,28,39
22,8477488,Brett Pesce,D,NJD,30,82,11,28,39
22,8482111,Justin Barron,D,MTL,23,82,9,30,39
22,8477969,Marcus Pettersson,D,PIT,28,82,8,31,39
22,8480145,Neal Pionk,D,WPG,29,82,7,32,39
22,8480849,Barrett Hayton,C,UTA,24,82,21,17,38
22,8483808,Andrei Kuzmenko,L,CGY,28,82,18,20,38
22,8474149,Evgenii Dadonov,R,DAL,35,82,17,21,38
22,8481624,Ilya Mikheyev,R,CHI,30,82,17,21,38
22,8475287,Erik Haula,L,NJD,33,82,16,22,38
22,8482660,Kent Johnson,C,CBJ,22,82,15,23,38
22,8478463,Anthony Beauvillier,L,PIT,27,82,15,23,38
22,8480802,Ryan McLeod,C,BUF,25,82,13,25,38
22,8477498,Darnell Nurse,D,EDM,29,82,8,30,38
22,8482175,JJ Peterka,R,BUF,22,82,24,13,37
22,8478046,Danton Heinen,L,VAN,29,82,24,13,37
22,8479941,Justin Danforth,R,CBJ,31,82,20,17,37
22,8476392,Adam Lowry,C,WPG,31,82,13,24,37
22,8480434,Sean Durzi,D,UTA,26,82,9,28,37
22,8478020,Michael Amadio,C,OTT,28,82,22,14,36
22,8470621,Corey Perry,R,EDM,39,82,22,14,36
22,8473533,Jordan Staal,C,CAR,36,82,22,14,36
22,8482055,Drew O'Connor,L,PIT,26,82,18,18,36
22,8481582,Nicholas Robertson,L,TOR,23,82,17,19,36
22,8478542,Evan Rodrigues,C,FLA,31,82,16,20,36
22,8480748,Kiefer Sherwood,L,VAN,29,82,16,20,36
22,8479996,Cody Glass,C,NSH,25,82,13,23,36
22,8478013,Jake Walman,D,SJS,28,82,13,23,36
22,8478133,Jake Evans,C,MTL,28,82,11,25,36
22,8478472,Mathieu Joseph,R,STL,27,82,10,26,36
22,8482624,Daniil Miromanov,D,CGY,27,82,9,27,36
22,8476892,Colton Parayko,D,STL,31,82,5,31,36
22,8480835,Jack Drury,C,CAR,24,82,22,13,35
22,8479390,Taylor Raddysh,R,WSH,26,82,21,14,35
22,8477425,Miles Wood,L,COL,29,82,21,14,35
22,8474715,Cam Atkinson,R,TBL,35,82,20,15,35
22,8481560,Arthur Kaliyev,R,LAK,23,82,18,17,35
22,8476469,Joel Armia,R,MTL,31,82,17,18,35
22,8482259,Bobby McMann,C,TOR,28,82,16,19,35
22,8475763,Kevin Hayes,R,PIT,32,82,14,21,35
22,8481535,Nils Hoglander,L,VAN,24,82,14,21,35
22,8475149,Marcus Johansson,L,MIN,34,82,12,23,35
22,8482671,Owen Power,D,BUF,22,82,11,24,35
22,8480871,Adam Boqvist,D,FLA,24,82,9,26,35
22,8481013,Jonatan Berggren,R,DET,24,82,18,16,34
22,8482125,Alexander Holtz,R,VGK,22,82,18,16,34
22,8481477,Nico Sturm,C,SJS,29,82,17,17,34
22,8476918,Jimmy Vesey,L,NYR,31,82,17,17,34
22,8478569,Noel Acciari,C,PIT,33,82,15,19,34
22,8479316,Luke Kunin,C,SJS,27,82,14,20,34
22,8480817,K'Andre Miller,D,NYR,24,82,9,25,34
22,8473507,Jeff Petry,D,DET,37,82,7,27,34
22,8475218,Mattias Ekholm,D,EDM,34,82,6,28,34
22,8477953,Kasperi Kapanen,R,STL,28,82,20,13,33
22,8475848,Brendan Gallagher,R,MTL,32,82,17,16,33
22,8479591,Michael Eyssimont,C,TBL,28,82,15,18,33
22,8476960,Andreas Athanasiou,C,CHI,30,82,14,19,33
22,8480185,Eetu Luostarinen,C,FLA,26,82,13,20,33
22,8476374,Sean Kuraly,C,CBJ,31,82,13,20,33
22,8476422,Mike Reilly,D,NYI,31,82,13,20,33
22,8482062,Cole Smith,L,NSH,29,82,12,21,33
22,8482122,Brock Faber,D,MIN,22,82,8,25,33
22,8482245,Artem Zub,D,OTT,29,82,6,27,33
22,8480043,Timothy Liljegren,D,TOR,25,82,4,29,33
22,8481580,Connor McMichael,C,WSH,23,82,22,10,32
22,8476925,Colton Sissons,C,NSH,31,82,19,13,32
22,8474189,Lars Eller,C,PIT,35,82,17,15,32
22,8482079,Marco Rossi,C,MIN,23,82,15,17,32
22,8480995,Pontus Holmberg,R,TOR,25,82,14,18,32
22,8479293,Brandon Tanev,L,SEA,33,82,12,20,32
22,8482720,Matthew Knies,L,TOR,22,82,12,20,32
22,8477507,Nikita Zadorov,D,BOS,29,82,10,22,32
22,8475200,Dmitry Orlov,D,CAR,33,82,7,25,32
22,8480009,Eeli Tolvanen,R,SEA,25,82,19,12,31
22,8475793,Ryan Johansen,C,PHI,32,82,17,14,31
22,8483457,Lane Hutson,D,MTL,20,82,14,17,31
22,8480855,Jack McBain,C,UTA,24,82,13,18,31
22,8479351,Sam Steel,C,DAL,26,82,12,19,31
22,8481606,Jordan Spence,D,LAK,23,82,9,22,31
22,8484203,Bradly Nadeau,L,CAR,19,82,8,23,31
22,8478500,Ivan Provorov,D,CBJ,27,82,3,28,31
22,8480873,Rasmus Sandin,D,WSH,24,82,2,29,31
22,8476419,Jean-Gabriel Pageau,C,NYI,32,82,15,15,30
22,8482117,Lukas Reichel,L,CHI,22,82,13,17,30
22,8482705,Cole Sillinger,C,CBJ,21,82,13,17,30
22,8477919,Frederick Gaudreau,C,MIN,31,82,13,17,30
22,8476873,Mark Jankowski,C,NSH,30,82,12,18,30
22,8477392,Hudson Fasching,R,NYI,29,82,9,21,30
22,8482166,Shakir Mukhamadullin,D,SJS,22,82,7,23,30
22,8480246,Nick Perbix,D,TBL,26,82,7,23,30
22,8479393,Noah Gregor,C,OTT,26,82,17,12,29
22,8476981,Josh Anderson,R,MTL,30,82,15,14,29
22,8475855,Jesper Fast,R,CAR,33,82,15,14,29
22,8484153,Leo Carlsson,C,ANA,20,82,10,19,29
22,8475171,Oliver Ekman-Larsson,D,TOR,33,82,7,22,29
22,8475279,Ben Chiarot,D,DET,33,82,6,23,29
22,8481014,Alexander Romanov,D,NYI,24,82,5,24,29
22,8474673,TJ Brodie,D,CHI,34,82,3,26,29
22,8477952,Robby Fabbri,C,ANA,28,82,20,8,28
22,8477508,Curtis Lazar,C,NJD,29,82,15,13,28
22,8475231,Casey Cizikas,C,NYI,33,82,15,13,28
22,8481028,Martin Pospisil,C,CGY,25,82,15,13,28
22,8476897,Oskar Sundqvist,C,STL,30,82,12,16,28
22,8477947,Sonny Milano,L,WSH,28,82,12,16,28
22,8481704,Juuso Parssinen,C,NSH,23,82,11,17,28
22,8480336,Sean Walker,D,CAR,30,82,10,18,28
22,8482074,Connor Zary,C,CGY,23,82,10,18,28
22,8476624,Barclay Goodrow,C,SJS,31,82,9,19,28
22,8482133,Thomas Bordeleau,C,SJS,22,82,6,22,28
22,8476979,Erik Gustafsson,D,DET,32,82,5,23,28
22,8475188,Brayden McNabb,D,VGK,33,82,5,23,28
22,8478507,John Marino,D,UTA,27,82,4,24,28
22,8478443,Brandon Carlo,D,BOS,28,82,4,24,28
22,8481553,Bobby Brink,R,PHI,23,82,12,15,27
22,8476474,Stefan Noesen,R,NJD,31,82,10,17,27
22,8480878,Nils Lundkvist,D,DAL,24,82,8,19,27
22,8478882,Vladislav Gavrikov,D,LAK,29,82,6,21,27
22,8481568,Alex Vlasic,D,CHI,23,82,5,22,27
22,8476917,Adam Pelech,D,NYI,30,82,4,23,27
22,8477435,Ryan Graves,D,PIT,29,82,3,24,27
22,8480049,Dylan Samberg,D,WPG,25,82,3,24,27
22,8475181,Nick Leddy,D,STL,33,82,3,24,27
22,8479414,Nathan Bastian,R,NJD,27,82,14,12,26
22,8478109,Victor Olofsson,L,VGK,29,82,13,13,26
22,8477903,Garnet Hathaway,R,PHI,33,82,13,13,26
22,8476889,Radek Faksa,C,STL,30,82,12,14,26
22,8478413,Jordan Greenway,L,BUF,27,82,7,19,26
22,8481186,Logan O'Connor,R,COL,28,82,7,19,26
22,8483565,Nick Blankenburg,D,NSH,26,82,7,19,26
22,8475462,Radko Gudas,D,ANA,34,82,7,19,26
22,8480035,Henri Jokiharju,D,BUF,25,82,4,22,26
22,8479661,Tanner Jeannot,L,LAK,27,82,13,12,25
22,8480144,David Kampf,C,TOR,29,82,11,14,25
22,8476921,Jordan Martinook,L,CAR,32,82,10,15,25
22,8480003,Jesper Boqvist,C,FLA,26,82,10,15,25
22,8480021,Jack Studnicka,C,LAK,25,82,8,17,25
22,8476902,Esa Lindell,D,DAL,30,82,7,18,25
22,8479398,Samuel Girard,D,COL,26,82,7,18,25
22,8480025,MacKenzie Entwistle,R,FLA,25,82,7,18,25
22,8479998,Mikey Anderson,D,LAK,25,82,4,21,25
22,8476463,Jonas Brodin,D,MIN,31,82,3,22,25
22,8477506,Ryan Pulock,D,NYI,30,82,3,22,25
22,8477406,Mattias Janmark,C,EDM,32,82,15,9,24
22,8480281,Alexey Toropchenko,R,STL,25,82,14,10,24
22,8484166,Adam Fantilli,C,CBJ,20,82,12,12,24
22,8478432,Christian Fischer,R,DET,27,82,12,12,24
22,8482077,Dylan Holloway,L,EDM,23,82,12,12,24
22,8481032,Paul Cotter,C,NJD,25,82,11,13,24
22,8478468,Jeremy Lauzon,D,NSH,27,82,9,15,24
22,8476854,Hampus Lindholm,D,BOS,30,82,5,19,24
22,8480807,Mattias Samuelsson,D,BUF,24,82,4,20,24
22,8478416,Erik Cernak,D,TBL,27,82,4,20,24
22,8479371,Dante Fabbro,D,NSH,26,82,2,22,24
22,8480950,Ilya Lyubushkin,D,DAL,30,82,2,22,24
22,8481178,Egor Zamula,D,PHI,24,82,1,23,24
22,8483431,Logan Cooley,C,UTA,20,82,13,10,23
22,8478434,Keegan Kolesar,R,VGK,27,82,12,11,23
22,8477931,Tomas Nosek,L,FLA,32,82,11,12,23
22,8482118,Sam Colangelo,R,ANA,23,82,8,15,23
22,8481481,Blake Lizotte,C,PIT,27,82,8,15,23
22,8476931,Jake McCabe,D,TOR,31,82,7,16,23
22,8478211,Dryden Hunt,L,CGY,29,82,7,16,23
22,8479402,Jake Bean,D,CGY,26,82,6,17,23
22,8476891,Matt Grzelcyk,D,PIT,30,82,5,18,23
22,8470600,Ryan Suter,D,STL,39,82,4,19,23
22,8474151,Ryan McDonagh,D,TBL,35,82,2,21,23
22,8477450,Jason Dickinson,C,CHI,29,82,13,9,22
22,8483524,Shane Wright,C,SEA,20,82,13,9,22
22,8479353,Brett Howden,C,VGK,26,82,11,11,22
22,8477353,Tyler Motte,C,DET,29,82,11,11,22
22,8481093,Rafael Harvey-Pinard,L,MTL,25,82,11,11,22
22,8482702,Logan Stankoven,C,DAL,21,82,10,12,22
22,8477839,Conor Sheary,L,TBL,32,82,9,13,22
22,8484145,Zach Benson,L,BUF,19,82,9,13,22
22,8475455,Brenden Dillon,D,NJD,34,82,7,15,22
22,8476292,Ondrej Palat,L,NJD,33,82,6,16,22
22,8479980,Nicolas Hague,D,VGK,26,82,6,16,22
22,8482666,Scott Morrow,D,CAR,22,82,4,18,22
22,8478851,Alexandre Carrier,D,NSH,28,82,4,18,22
22,8474612,Travis Hamonic,D,OTT,34,82,4,18,22
22,8479976,Juuso Valimaki,D,UTA,26,82,3,19,22
22,8476879,Cody Ceci,D,EDM,31,82,1,21,22
22,8482155,Alex Laferriere,R,LAK,23,82,15,6,21
22,8477505,Alexander Wennberg,C,SJS,30,82,13,8,21
22,8476878,Zemgus Girgensons,L,TBL,30,82,12,9,21
22,8480789,Oliver Wahlstrom,R,NYI,24,82,10,11,21
22,8475220,Marcus Foligno,L,MIN,33,82,10,11,21
22,8481524,Bowen Byram,D,BUF,23,82,10,11,21
22,8478508,Yakov Trenin,C,MIN,27,82,9,12,21
22,8480806,Isac Lundestrom,C,ANA,25,82,8,13,21
22,8473453,Trevor Lewis,C,LAK,37,82,8,13,21
22,8483763,Maksymilian Szuber,D,UTA,22,82,8,13,21
22,8479442,Troy Stecher,D,EDM,30,82,8,13,21
22,8477015,Connor Brown,R,EDM,30,82,5,16,21
22,8482733,Logan Mailloux,D,MTL,31,82,5,16,21
22,8478859,Niko Mikkola,D,FLA,28,82,5,16,21
22,8483490,Pavel Mintyukov,D,ANA,21,82,4,17,21
22,8477499,Rasmus Ristolainen,D,PHI,30,82,3,18,21
22,8476331,Dylan DeMelo,D,WPG,31,82,3,18,21
22,8480796,Martin Fehervary,D,WSH,25,82,3,18,21
22,8477365,Connor Clifton,D,BUF,29,82,2,19,21
22,8476312,Josh Manson,D,COL,33,82,2,19,21
22,8475233,David Savard,D,MTL,34,82,1,20,21
22,8474090,Brendan Smith,D,DAL,35,82,1,20,21
22,8477845,Trevor van Riemsdyk,D,WSH,33,82,0,21,21
22,8480980,Connor Dewar,C,TOR,25,82,11,9,20
22,8476442,Matt Nieto,L,PIT,32,82,10,10,20
22,8481517,Brett Leason,R,ANA,25,82,9,11,20
22,8483505,Matthew Poitras,C,BOS,20,82,8,12,20
22,8479983,Mario Ferraro,D,SJS,26,82,8,12,20
22,8482762,Simon Edvinsson,D,DET,21,82,7,13,20
22,8482142,Jamie Drysdale,D,PHI,22,82,5,15,20
22,8478450,Parker Wotherspoon,D,BOS,27,82,5,15,20
22,8476525,Colin Miller,D,WPG,32,82,5,15,20
22,8480073,Erik Brannstrom,D,COL,25,82,4,16,20
22,8475324,Nick Jensen,D,OTT,34,82,4,16,20
22,8476457,Adam Larsson,D,SEA,32,82,4,16,20
22,8479359,Beck Malenstyn,L,BUF,26,82,8,11,19
22,8483495,Simon Nemec,D,NJD,20,82,8,11,19
22,8475343,Nic Dowd,C,WSH,34,82,7,12,19
22,8482145,Mavrik Bourque,C,DAL,22,82,7,12,19
22,8478399,Jonas Siegenthaler,D,NJD,27,82,5,14,19
22,8471677,Jack Johnson,D,CBJ,37,82,5,14,19
22,8483482,Tristan Luneau,D,ANA,20,82,4,15,19
22,8476858,Phillip Di Giuseppe,L,VAN,31,82,13,5,18
22,8483471,Brad Lambert,C,WPG,31,82,9,9,18
22,8481601,Simon Holmstrom,R,NYI,23,82,8,10,18
22,8482073,Braden Schneider,D,NYR,23,82,6,12,18
22,8481605,Jackson LaCombe,D,ANA,23,82,6,12,18
22,8482803,Olen Zellweger,D,ANA,21,82,6,12,18
22,8481708,Zac Jones,D,NYR,24,82,4,14,18
22,8475718,Justin Holl,D,DET,32,82,4,14,18
22,8480990,Declan Chisholm,D,MIN,24,82,3,15,18
22,8478840,Will Borgen,D,SEA,28,82,3,15,18
22,8476967,Brett Kulak,D,EDM,30,82,3,15,18
22,8479369,Andrew Peeke,D,BOS,26,82,2,16,18
22,8480860,Kevin Bahl,D,CGY,24,82,2,16,18
22,8480879,Jacob Bernard-Docker,D,OTT,24,82,1,17,18
22,8476441,Joel Edmundson,D,LAK,31,82,0,18,18
22,8475790,Erik Gudbranson,D,CBJ,32,82,0,18,18
22,8479368,Max Jones,L,BOS,26,82,12,5,17
22,8484911,Collin Graf,R,SJS,22,82,11,6,17
22,8479291,Kevin Rooney,C,CGY,31,82,11,6,17
22,8483499,Liam Ohgren,L,MIN,20,82,7,10,17
22,8483445,Cutter Gauthier,L,ANA,20,82,6,11,17
22,8483468,Jiri Kulich,C,BUF,20,82,6,11,17
22,8482655,J.J. Moser,D,TBL,24,82,3,14,17
22,8482087,Kaiden Guhle,D,MTL,22,82,3,14,17
22,8483460,David Jiricek,D,CBJ,21,82,3,14,17
22,8476429,Scott Mayfield,D,NYI,32,82,3,14,17
22,8480222,Sebastian Aho,D,PIT,28,82,2,15,17
22,8482470,Ilya Solovyov,D,CGY,24,82,1,16,17
22,8481641,Joel Kiviranta,L,COL,28,82,10,6,16
22,8483493,Frank Nazar,C,CHI,20,82,7,9,16
22,8482713,Mackie Samoskevich,R,FLA,22,82,7,9,16
22,8482749,Joshua Roy,R,MTL,21,82,7,9,16
22,8476467,Jamie Oleksiak,D,SEA,32,82,6,10,16
22,8477369,Carson Soucy,D,VAN,30,82,6,10,16
22,8482807,Ethan Del Mastro,D,CHI,21,82,4,12,16
22,8478178,Darren Raddysh,D,TBL,28,82,4,12,16
22,8478136,Jake Middleton,D,MIN,28,82,3,13,16
22,8476372,Nick Seeler,D,PHI,31,82,3,13,16
22,8474567,Zach Bogosian,D,MIN,34,82,3,13,16
22,8475842,Sam Carrick,C,NYR,32,82,9,6,15
22,8482659,Josh Doan,R,UTA,22,82,6,9,15
22,8482141,Lukas Cormier,D,VGK,22,82,6,9,15
22,8482679,Matt Coronato,R,CGY,22,82,5,10,15
22,8477938,Haydn Fleury,D,WPG,28,82,5,10,15
22,8481567,Henry Thrun,D,SJS,23,82,5,10,15
22,8476473,Connor Murphy,D,CHI,31,82,4,11,15
22,8477034,Jaycob Megna,D,FLA,32,82,3,12,15
22,8477220,Nate Schmidt,D,FLA,33,82,2,13,15
22,8484149,Gavin Brindley,C,CBJ,20,82,8,6,14
22,8482858,Ryker Evans,D,SEA,23,82,6,8,14
22,8481699,Aku Raty,R,UTA,23,82,5,9,14
22,8475690,Chris Tanev,D,TOR,35,82,3,11,14
22,8477335,Kyle Burroughs,D,LAK,29,82,3,11,14
22,8480172,Jan Rutta,D,SJS,34,82,3,11,14
22,8479638,Justin Brazeau,R,BOS,26,82,10,3,13
22,8483397,Marc McLaughlin,C,BOS,25,82,9,4,13
22,8482809,Jackson Blake,R,CAR,21,82,6,7,13
22,8480834,Ty Emberson,D,SJS,24,82,4,9,13
22,8474574,Tyler Myers,D,VAN,34,82,3,10,13
22,8483012,Logan Morrison,C,SEA,22,82,6,6,12
22,8480448,Parker Kelly,L,COL,25,82,6,6,12
22,8479576,Vincent Desharnais,D,VAN,28,82,4,8,12
22,8479324,Ryan Lindgren,D,NYR,26,82,2,10,12
22,8482516,Matthew Kessel,D,STL,24,82,2,10,12
22,8478874,Adam Gaudette,C,OTT,28,82,1,11,12
22,8481122,Simon Benoit,D,TOR,26,82,0,12,12
22,8483489,Fraser Minten,C,TOR,31,82,6,5,11
22,8483567,Georgii Merkulov,C,BOS,24,82,4,7,11
22,8482101,Danil Gushchin,L,SJS,22,82,3,8,11
22,8474013,Ian Cole,D,UTA,35,82,2,9,11
22,8482859,Zack Ostapchuk,C,OTT,21,82,5,5,10
22,8482712,Oskar Olausson,R,COL,22,82,3,7,10
22,8475177,Calvin de Haan,D,COL,33,82,2,8,10
22,8475762,Derek Forbort,D,VAN,32,82,1,9,10
22,8480870,Bo Groulx,C,NYR,24,82,2,6,8
22,8482153,Brendan Brisson,C,VGK,23,82,2,6,8
22,8476822,Luke Glendening,C,TBL,35,82,3,4,7
22,8482070,Mitchell Chaffee,R,TBL,26,82,3,4,7
22,8483466,Kevin Korchinski,D,CHI,20,82,1,6,7
22,8482787,Nikita Chibrikov,R,WPG,31,82,1,5,6
22,8474062,Riley Nash,C,NYR,35,82,0,6,6
22,8470794,Joe Pavelski,C,,40,0,0,0,0
22,8481703,Valtteri Puustinen,R,PIT,25,0,0,0,0
22,8477950,Tony DeAngelo,D,,29,0,0,0,0
22,8481577,Philip Tomasino,C,NSH,23,0,0,0,0
22,8475197,Tyson Barrie,D,,33,0,0,0,0
22,8471218,Blake Wheeler,R,,38,0,0,0,0
22,8474157,Max Pacioretty,L,,36,0,0,0,0
22,8478466,Daniel Sprong,R,VAN,27,0,0,0,0
22,8475744,Evgeny Kuznetsov,C,,32,0,0,0,0
22,8481019,David Gustafsson,C,WPG,24,0,0,0,0
22,8475906,John Klingberg,D,,32,0,0,0,0
22,8479348,Kale Clague,D,BUF,26,0,0,0,0
22,8476952,Dominic Toninato,C,WPG,30,0,0,0,0
22,8473473,Milan Lucic,L,,36,0,0,0,0
22,8474037,James van Riemsdyk,L,,35,0,0,0,0
22,8474602,Justin Schultz,D,,34,0,0,0,0
22,8482222,Alexander Barabanov,L,,30,0,0,0,0
22,8479372,Josh Mahura,D,SEA,26,0,0,0,0
22,8479982,Conor Timmins,D,TOR,26,0,0,0,0
22,8474031,Kevin Shattenkirk,D,,35,0,0,0,0
22,8480008,Adam Ruzicka,C,,25,0,0,0,0
22,8481059,Scott Perunovich,D,STL,26,0,0,0,0
22,8480884,Calen Addison,D,,24,0,0,0,0
22,8476994,Vinnie Hinostroza,C,NSH,30,0,0,0,0
22,8478452,Caleb Jones,D,LAK,27,0,0,0,0
22,8480157,Calle Rosen,D,COL,30,0,0,0,0
22,8481609,Vladislav Kolyachonok,D,UTA,23,0,0,0,0
22,8479415,Michael McLeod,C,,26,0,0,0,0
22,8476919,Chris Tierney,C,,30,0,0,0,0
22,8479639,Dylan Coghlan,D,WPG,26,0,0,0,0
22,8478146,Matthew Highmore,C,OTT,28,0,0,0,0
22,8478970,Jalen Chatfield,D,CAR,28,0,0,0,0
22,8480205,Emil Bemstrom,C,PIT,25,0,0,0,0
22,8474884,Mike Hoffman,C,,35,0,0,0,0
22,8471274,Alex Goligoski,D,,39,0,0,0,0
22,8478104,Sammy Blais,L,,28,0,0,0,0
22,8474870,Tyler Johnson,C,,34,0,0,0,0
22,8476913,Devin Shore,C,MIN,30,0,0,0,0
22,8481598,Philip Broberg,D,EDM,23,0,0,0,0
22,8480058,Pierre-Olivier Joseph,D,STL,25,0,0,0,0
22,8480891,Michael Kesselring,D,UTA,24,0,0,0,0
22,8477979,Nicolas Aube-Kubel,R,BUF,28,0,0,0,0
22,8476871,Tanner Pearson,L,,32,0,0,0,0
22,8476393,Nick Cousins,C,,31,0,0,0,0
22,8479977,Kailer Yamamoto,R,,26,0,0,0,0
22,8479543,Michael Pezzetta,L,MTL,26,0,0,0,0
22,8477018,Ben Hutton,D,VGK,31,0,0,0,0
22,8480762,Eric Robinson,L,CAR,29,0,0,0,0
22,8474034,Pat Maroon,L,CHI,36,0,0,0,0
22,8481058,Jesse Ylönen,R,,25,0,0,0,0
22,8475179,Dmitry Kulikov,D,FLA,34,0,0,0,0
22,8481527,Kaedan Korczak,D,VGK,23,0,0,0,0
22,8473449,Kyle Okposo,R,,36,0,0,0,0
22,8482192,Isaak Phillips,D,CHI,23,0,0,0,0
22,8480727,Zach Whitecloud,D,VGK,28,0,0,0,0
22,8479346,Dillon Dube,C,,26,0,0,0,0
22,8480821,Filip Zadina,R,,25,0,0,0,0
22,8480001,Urho Vaakanainen,D,ANA,25,0,0,0,0
22,8470966,Mark Giordano,D,,41,0,0,0,0
22,8480853,Liam Foudy,C,,24,0,0,0,0
22,8475225,Craig Smith,C,CHI,35,0,0,0,0
22,8479972,Mason Shaw,C,WPG,26,0,0,0,0
22,8478451,Ethan Bear,D,WSH,27,0,0,0,0
22,8474040,Sam Gagner,C,,35,0,0,0,0
22,8480196,Jacob Bryson,D,BUF,27,0,0,0,0
22,8479984,Cal Foote,D,,26,0,0,0,0
22,8480011,Klim Kostin,C,SJS,25,0,0,0,0
22,8482176,Wyatt Kaiser,D,CHI,22,0,0,0,0
22,8476988,Matt Benning,D,SJS,30,0,0,0,0
22,8479370,Tyson Jost,C,CAR,26,0,0,0,0
22,8477464,Nic Petan,C,,29,0,0,0,0
22,8477380,Jonny Brodzinski,C,NYR,31,0,0,0,0
22,8480070,Ian Mitchell,D,BOS,25,0,0,0,0
22,8479315,Joey Anderson,R,CHI,26,0,0,0,0
22,8478099,Kevin Labanc,R,,29,0,0,0,0
22,8476874,Olli Maatta,D,DET,30,0,0,0,0
22,8475208,Brian Dumoulin,D,ANA,33,0,0,0,0
22,8478430,Oliver Kylington,D,,27,0,0,0,0
22,8479536,Axel Jonsson-Fjallby,L,WPG,26,0,0,0,0
22,8479671,Mathieu Olivier,R,CBJ,27,0,0,0,0
22,8471709,Marc-Edouard Vlasic,D,SJS,37,0,0,0,0
22,8479328,Julien Gauthier,R,NYI,27,0,0,0,0
22,8478421,A.J. Greer,L,FLA,28,0,0,0,0
22,8477573,Nathan Walker,L,STL,30,0,0,0,0
22,8481537,Nikita Okhotiuk,D,CGY,24,0,0,0,0
22,8474166,Alec Martinez,D,CHI,37,0,0,0,0
22,8470610,Zach Parise,L,,40,0,0,0,0
22,8477478,William Carrier,L,CAR,30,0,0,0,0
22,8479344,Jesse Puljujarvi,R,PIT,26,0,0,0,0
22,8480887,Jordan Harris,D,MTL,24,0,0,0,0
22,8478502,Dennis Gilbert,D,BUF,28,0,0,0,0
22,8482730,Brandt Clarke,D,LAK,21,0,0,0,0
22,8480355,Mark Kastelic,C,BOS,25,0,0,0,0
22,8475750,Jon Merrill,D,MIN,32,0,0,0,0
22,8475164,Jakob Silfverberg,R,,34,0,0,0,0
22,8477944,Jakub Vrana,L,,28,0,0,0,0
22,8479439,Jacob MacDonald,D,COL,31,0,0,0,0
22,8474568,Luke Schenn,D,NSH,35,0,0,0,0
22,8478454,Noah Juulsen,D,VAN,27,0,0,0,0
22,8475752,Tyler Pitlick,C,,33,0,0,0,0
22,8482148,Hendrix Lapierre,C,WSH,22,0,0,0,0
22,8481167,Brayden Pachal,D,CGY,25,0,0,0,0
22,8478043,Sam Lafferty,C,BUF,29,0,0,0,0
22,8479321,Lucas Johansen,D,,27,0,0,0,0
22,8471699,Andrew Cogliano,C,,37,0,0,0,0
22,8481521,Ronnie Attard,D,PHI,25,0,0,0,0
22,8481161,Jake Christiansen,D,CBJ,25,0,0,0,0
22,8479458,Nikita Zaitsev,D,,33,0,0,0,0
22,8479619,Michael Carcone,L,UTA,28,0,0,0,0
22,8479026,Philippe Myers,D,TOR,27,0,0,0,0
22,8477330,Dominik Kubalik,L,,29,0,0,0,0
22,8481617,Vasily Podkolzin,R,VAN,23,0,0,0,0
22,8481701,Santeri Hatakka,D,NJD,23,0,0,0,0
22,8479514,Rem Pitlick,C,,27,0,0,0,0
22,8477446,Michael McCarron,R,NSH,29,0,0,0,0
22,8470604,Jeff Carter,C,,39,0,0,0,0
22,8482241,Radim Zohorna,L,,28,0,0,0,0
22,8480289,Morgan Barron,C,WPG,26,0,0,0,0
22,8479379,Givani Smith,R,SJS,26,0,0,0,0
22,8480216,Jacob Peterson,C,,25,0,0,0,0
22,8477851,Jordan Oesterle,D,BOS,32,0,0,0,0
22,8484258,Sam Malinski,D,COL,26,0,0,0,0
22,8478904,Steven Lorentz,C,,28,0,0,0,0
22,8482095,Tyler Kleven,D,OTT,22,0,0,0,0
22,8480848,Ty Dellandrea,C,SJS,24,0,0,0,0
22,8476884,Derrick Pouliot,D,,30,0,0,0,0
22,8479336,Carl Grundstrom,R,SJS,27,0,0,0,0
22,8482964,Arber Xhekaj,D,MTL,23,0,0,0,0
22,8471686,Marc Staal,D,,37,0,0,0,0
22,8477887,Patrick Brown,C,BOS,32,0,0,0,0
22,8478495,Denis Gurianov,R,,27,0,0,0,0
22,8473504,Cal Clutterbuck,R,,37,0,0,0,0
22,8481550,Adam Beckman,L,NJD,23,0,0,0,0
22,8480845,Rasmus Kupari,C,WPG,24,0,0,0,0
22,8474009,Nick Bonino,C,,36,0,0,0,0
22,8478585,Derek Ryan,C,EDM,38,0,0,0,0
22,8477962,Brendan Lemieux,L,CAR,28,0,0,0,0
22,8482861,Vincent Iorio,D,WSH,22,0,0,0,0
22,8479378,Logan Stanley,D,WPG,26,0,0,0,0
22,8473446,Erik Johnson,D,PHI,36,0,0,0,0
22,8481743,Marc Del Gaizo,D,NSH,25,0,0,0,0
22,8477384,Josh Brown,D,EDM,30,0,0,0,0
22,8482165,Yan Kuznetsov,D,CGY,22,0,0,0,0
22,8478424,Jansen Harkins,C,ANA,27,0,0,0,0
22,8482144,Jack Thompson,D,SJS,22,0,0,0,0
22,8478512,Austin Czarnik,C,,32,0,0,0,0
22,8477527,Ross Johnston,L,ANA,30,0,0,0,0
22,8479383,Boris Katchouk,L,,26,0,0,0,0
22,8482094,Daemon Hunt,D,MIN,22,0,0,0,0
22,8481719,Maxwell Crozier,D,TBL,24,0,0,0,0
22,8480192,Johnathan Kovacevic,D,NJD,27,0,0,0,0
22,8479376,Victor Mete,D,,26,0,0,0,0
22,8482511,Mason Lohrei,D,BOS,23,0,0,0,0
22,8475825,Jani Hakanpää,D,,32,0,0,0,0
22,8478021,William Lagesson,D,DET,28,0,0,0,0
22,8475795,Dylan McIlrath,D,WSH,32,0,0,0,0
22,8477846,Ryan Carpenter,C,,33,0,0,0,0
22,8481056,Spencer Stastney,D,NSH,24,0,0,0,0
22,8481564,Ryan Johnson,D,BUF,23,0,0,0,0
22,8478017,Mark Friedman,D,VAN,29,0,0,0,0
22,8479320,Max Lajoie,D,SEA,27,0,0,0,0
22,8480075,Cameron Crotty,D,MIN,25,0,0,0,0
22,8484287,Cole McWard,D,VAN,23,0,0,0,0
22,8484254,Akito Hirose,D,VAN,25,0,0,0,0
22,8483407,Brandon Scanlin,D,NYR,25,0,0,0,0
22,8480274,Philip Kemp,D,EDM,25,0,0,0,0
22,8479522,Hardy Haman Aktell,D,WSH,26,0,0,0,0
22,8480007,Jonas Rondbjerg,R,VGK,25,0,0,0,0
22,8477454,Adam Erne,L,,29,0,0,0,0
22,8481679,Maxence Guenette,D,OTT,23,0,0,0,0
22,8480441,Trey Fix-Wolansky,R,CBJ,25,0,0,0,0
22,8483546,Marshall Rifai,D,TOR,26,0,0,0,0
22,8480084,Nick DeSimone,D,NJD,30,0,0,0,0
22,8481030,Jack St. Ivany,D,PIT,25,0,0,0,0
22,8481592,Jakob Pelletier,L,CGY,23,0,0,0,0
22,8478011,Louie Belpedio,D,PHI,28,0,0,0,0
22,8477930,Pierre-Edouard Bellemare,L,,39,0,0,0,0
22,8484321,Nikolas Matinpalo,D,OTT,26,0,0,0,0
22,8482067,Connor Mackey,D,NYR,28,0,0,0,0
22,8481806,Louis Crevier,D,CHI,23,0,0,0,0
22,8484326,Patrik Koch,D,UTA,28,0,0,0,0
22,8477971,Andreas Englund,D,LAK,28,0,0,0,0
22,8481751,Lukas Rousek,R,BUF,25,0,0,0,0
22,8481006,Tyler Tucker,D,STL,24,0,0,0,0
22,8476867,Brendan Gaunce,C,MIN,30,0,0,0,0
22,8479520,Brandon Duhaime,R,WSH,27,0,0,0,0
22,8477073,Kurtis MacDermid,L,NJD,30,0,0,0,0
22,8480874,Adam Ginning,D,PHI,24,0,0,0,0
22,8477473,Justin Bailey,R,SJS,29,0,0,0,0
22,8479066,Ryan Lomberg,L,CGY,30,0,0,0,0
22,8477070,Liam O'Brien,C,UTA,30,0,0,0,0
22,8474618,Marco Scandella,D,,34,0,0,0,0
22,8475797,Jarred Tinordi,D,,32,0,0,0,0
22,8481441,Joe Snively,C,DET,28,0,0,0,0
22,8477244,Chad Ruhwedel,D,NYR,34,0,0,0,0
22,8479772,Zack MacEwen,R,OTT,28,0,0,0,0
22,8481147,Reese Johnson,C,MIN,26,0,0,0,0
22,8481043,Cole Koepke,L,BOS,26,0,0,0,0
22,8483619,Filip Roos,D,OTT,25,0,0,0,0
22,8481541,Samuel Bolduc,D,NYI,24,0,0,0,0
22,8477810,Joel Hanley,D,CGY,33,0,0,0,0
22,8476907,Mackenzie MacEachern,L,,30,0,0,0,0
22,8482652,Walker Duehr,R,CGY,27,0,0,0,0
22,8477126,Jayson Megna,C,,34,0,0,0,0
22,8483398,Declan Carlile,D,TBL,31,0,0,0,0
22,8482929,Emil Lilleberg,D,TBL,23,0,0,0,0
22,8480880,Jakub Lauko,C,MIN,24,0,0,0,0
22,8480245,Olle Lycksell,R,PHI,25,0,0,0,0
22,8480252,Cole Guttman,C,CHI,25,0,0,0,0
22,8477467,Gustav Olofsson,D,SEA,30,0,0,0,0
22,8479968,Vinni Lettieri,C,BOS,29,0,0,0,0
22,8478400,Colin White,C,,27,0,0,0,0
22,8475755,Alexander Petrovic,D,DAL,32,0,0,0,0
22,8481812,Nikolai Knyzhov,D,,27,0,0,0,0
22,8481593,Jayden Struble,D,MTL,23,0,0,0,0
22,8481532,Alex Turcotte,C,LAK,23,0,0,0,0
22,8482126,Emil Andrae,D,PHI,31,0,0,0,0
22,8479944,Zach Aston-Reese,C,VGK,30,0,0,0,0
22,8471817,Ryan Reaves,R,TOR,37,0,0,0,0
22,8481206,John Ludvig,D,PIT,24,0,0,0,0
22,8481599,Victor Soderstrom,D,UTA,23,0,0,0,0
22,8480292,Carson Meyer,R,ANA,27,0,0,0,0
22,8482496,Nils Aman,C,VAN,24,0,0,0,0
22,8479718,Alex Barré-Boulet,C,MTL,27,0,0,0,0
22,8479994,Jaret Anderson-Dolan,C,WPG,25,0,0,0,0
22,8480184,Gustav Lindstrom,D,,26,0,0,0,0
22,8480890,Jan Jenik,R,OTT,24,0,0,0,0
22,8478067,Oskar Lindblom,L,,28,0,0,0,0
22,8476934,Brock McGinn,L,ANA,30,0,0,0,0
22,8479985,Cale Fleury,D,SEA,26,0,0,0,0
22,8484304,Uvis Balinskis,D,FLA,28,0,0,0,0
22,8479981,Jonah Gadjovich,L,FLA,26,0,0,0,0
22,8481716,Dmitri Voronkov,L,CBJ,24,0,0,0,0
22,8474709,Matt Martin,L,,35,0,0,0,0
22,8482634,Alex Steeves,C,TOR,25,0,0,0,0
22,8480823,Alexander Alexeyev,D,WSH,25,0,0,0,0
22,8477541,Dakota Mermis,D,TOR,30,0,0,0,0
22,8483491,Ivan Miroshnichenko,L,WSH,20,0,0,0,0
22,8478477,Mitchell Stephens,C,SEA,27,0,0,0,0
22,8481543,Nikita Alexandrov,C,STL,24,0,0,0,0
22,8479423,Alex Nylander,L,,26,0,0,0,0
22,8482451,Mikael Pyyhtia,L,CBJ,23,0,0,0,0
22,8478831,Kevin Stenlund,C,UTA,28,0,0,0,0
22,8480306,Grant Hutton,D,NYI,29,0,0,0,0
22,8478028,Fredrik Olofsson,L,,28,0,0,0,0
22,8477462,Robert Hagg,D,VGK,29,0,0,0,0
22,8477320,Anton Blidh,L,NYR,29,0,0,0,0
22,8482157,Will Cuylle,L,NYR,22,0,0,0,0
22,8482737,Zack Bolduc,C,STL,21,0,0,0,0
22,8481239,Samuel Fagemo,L,,24,0,0,0,0
22,8481600,Tobias Bjornfot,D,FLA,23,0,0,0,0
22,8478409,Anthony Richard,C,PHI,28,0,0,0,0
22,8474145,Robert Bortuzzo,D,,35,0,0,0,0
22,8475958,Michael Sgarbossa,C,WSH,32,0,0,0,0
22,8479986,Kole Lind,R,DAL,26,0,0,0,0
22,8479249,Andrew Poturalski,C,SJS,30,0,0,0,0
22,8479362,Riley Tufte,L,BOS,26,0,0,0,0
22,8479991,Jake Leschyshyn,C,NYR,25,0,0,0,0
22,8479587,Rhett Gardner,C,PHI,28,0,0,0,0
22,8482744,James Malatesta,L,CBJ,21,0,0,0,0
22,8478854,Ryan Shea,D,PIT,27,0,0,0,0
22,8481591,Sam Poulin,R,,23,0,0,0,0
22,8483512,Matt Savoie,C,EDM,20,0,0,0,0
22,8482102,Vasily Ponomarev,C,PIT,22,0,0,0,0
22,8482162,Roby Jarventie,L,EDM,22,0,0,0,0
22,8481016,Ruslan Iskhakov,C,,24,0,0,0,0
22,8482172,Landon Slaggert,L,CHI,22,0,0,0,0
22,8482747,Brennan Othmann,L,NYR,21,0,0,0,0
22,8480031,Maxime Comtois,L,,25,0,0,0,0
22,8480226,Marián Studenic,R,,26,0,0,0,0
22,8478408,Travis Dermott,D,,28,0,0,0,0
22,8481518,Nolan Foote,L,NJD,24,0,0,0,0
22,8479419,Brett Murray,L,BUF,26,0,0,0,0
22,8482088,Justin Sourdif,R,FLA,22,0,0,0,0
22,8482201,Gage Goncalves,C,TBL,23,0,0,0,0
22,8481578,Graeme Clarke,R,MIN,23,0,0,0,0
22,8482177,Marat Khusnutdinov,C,MIN,22,0,0,0,0
22,8481754,Nikita Nesterenko,C,ANA,23,0,0,0,0
22,8483531,Brian Halonen,L,NJD,25,0,0,0,0
22,8483920,Pierrick Dube,R,WSH,23,0,0,0,0
22,8480851,Akil Thomas,C,LAK,24,0,0,0,0
22,8475235,Nicolas Deslauriers,L,PHI,33,0,0,0,0
22,8482476,Emil Heineman,L,MTL,23,0,0,0,0
22,8477149,Scott Sabourin,R,SJS,32,0,0,0,0
22,8483549,Lucas Condotta,L,MTL,27,0,0,0,0
22,8482765,Isak Rosen,R,BUF,21,0,0,0,0
22,8481237,Kyle MacLean,C,NYI,25,0,0,0,0
22,8481024,Linus Karlsson,C,VAN,25,0,0,0,0
22,8481690,Tyler Angle,C,,24,0,0,0,0
22,8483570,Ben Meyers,C,SEA,26,0,0,0,0
22,8481655,Cole Schwindt,R,CGY,23,0,0,0,0
22,8481462,Mason Morelli,L,VGK,28,0,0,0,0
22,8483401,Marc Johnstone,R,PIT,28,0,0,0,0
22,8478956,Samuel Laberge,L,NJD,27,0,0,0,0
22,8479533,Joona Koppanen,L,,26,0,0,0,0
22,8482197,Adam Raska,R,MIN,23,0,0,0,0
22,8482250,Callahan Burke,C,VGK,27,0,0,0,0
22,8482784,Zach Dean,C,STL,21,0,0,0,0
22,8484255,Jason Polin,R,COL,25,0,0,0,0
22,8481077,John Leonard,L,,26,0,0,0,0
22,8481534,Raphael Lavoie,C,EDM,24,0,0,0,0
22,8483609,Adam Klapka,R,CGY,24,0,0,0,0
22,8482751,Ryan Winterton,C,SEA,21,0,0,0,0
22,8480267,Sammy Walker,C,MIN,25,0,0,0,0
22,8475766,Austin Watson,L,,32,0,0,0,0
22,8482460,Matt Rempe,C,NYR,22,0,0,0,0
22,8481065,Angus Crookshank,L,OTT,25,0,0,0,0
22,8481070,Hugh McGing,L,,26,0,0,0,0
22,8476323,Max McCormick,L,SEA,32,0,0,0,0
22,8483395,Arshdeep Bains,L,VAN,23,0,0,0,0
22,8484259,Ondrej Pavel,C,COL,31,0,0,0,0
22,8483432,Luca Del Bel Belluz,C,CBJ,31,0,0,0,0
22,8483045,Cameron Butler,R,CBJ,31,0,0,0,0
22,8482061,Brandon Biro,L,SEA,26,0,0,0,0
22,8477401,John Hayden,C,SEA,29,0,0,0,0
22,8475278,Byron Froese,C,,33,0,0,0,0
22,8478446,Glenn Gawdin,C,LAK,27,0,0,0,0
22,8477993,Justin Kirkland,C,CGY,28,0,0,0,0
22,8482147,Jean-Luc Foudy,C,COL,22,0,0,0,0
22,8480032,Shane Bowers,C,NJD,25,0,0,0,0
22,8479330,Brandon Gignac,C,MTL,27,0,0,0,0
22,8480776,Sheldon Rempal,R,,29,0,0,0,0
22,8475413,Justin Dowling,C,NJD,34,0,0,0,0
22,8481726,Adam Edstrom,C,NYR,24,0,0,0,0
22,8480844,Grigori Denisenko,L,VGK,24,0,0,0,0
22,8478147,Bokondji Imama,L,PIT,28,0,0,0,0
22,8478881,Brett Seney,L,CHI,28,0,0,0,0
22,8483630,Pavol Regenda,L,ANA,25,0,0,0,0
22,8480836,Jonathan Gruden,C,,24,0,0,0,0
22,8484314,Jiri Smejkal,L,,28,0,0,0,0
22,8475780,Chris Wagner,R,COL,33,0,0,0,0
22,8479546,Oskar Steen,C,,26,0,0,0,0
22,8483597,Milos Kelemen,L,UTA,25,0,0,0,0
22,8481789,Tye Kartye,L,SEA,23,0,0,0,0
22,8484325,Waltteri Merela,C,TBL,26,0,0,0,0
22,8479421,Jacob Moverare,D,LAK,26,0,0,0,0
22,8481585,Egor Afanasyev,L,SJS,23,0,0,0,0
22,8479547,Matthew Phillips,R,,26,0,0,0,0
22,8479367,William Lockwood,R,FLA,26,0,0,0,0
22,8476915,Jujhar Khaira,L,,30,0,0,0,0
22,8481422,Jacob Lucchini,C,NSH,29,0,0,0,0
22,8480468,James Hamblin,L,EDM,25,0,0,0,0
22,8478051,Max Willman,C,NJD,29,0,0,0,0
22,8481556,John Beecher,C,BOS,23,0,0,0,0
22,8478078,Rourke Chartier,C,,28,0,0,0,0
23,8478402,Connor McDavid,C,EDM,27,82,44,103,147
23,8476453,Nikita Kucherov,R,TBL,31,82,45,88,133
23,8477492,Nathan MacKinnon,C,COL,29,82,51,77,128
23,8477493,Aleksander Barkov,C,FLA,29,82,40,82,122
23,8479318,Auston Matthews,C,TOR,27,82,67,50,117
23,8477956,David Pastrnak,R,BOS,28,82,59,56,115
23,8478864,Kirill Kaprizov,L,MIN,27,82,50,63,113
23,8477934,Leon Draisaitl,C,EDM,29,82,42,70,112
23,8479314,Matthew Tkachuk,L,FLA,27,82,46,63,109
23,8471675,Sidney Crosby,C,PIT,37,82,44,64,108
23,8478550,Artemi Panarin,L,NYR,33,82,33,74,107
23,8480012,Elias Pettersson,C,VAN,26,82,41,63,104
23,8478420,Mikko Rantanen,R,COL,28,82,49,53,102
23,8480027,Jason Robertson,L,DAL,25,82,42,60,102
23,8476468,J.T. Miller,C,VAN,31,82,33,69,102
23,8479337,Alex DeBrincat,R,DET,27,82,43,58,101
23,8481559,Jack Hughes,C,NJD,23,82,46,49,95
23,8477501,Valeri Nichushkin,R,COL,29,82,46,49,95
23,8477939,William Nylander,R,TOR,28,82,43,51,94
23,8477402,Pavel Buchnevich,L,STL,29,82,36,58,94
23,8480801,Brady Tkachuk,L,OTT,25,82,42,51,93
23,8479343,Clayton Keller,R,UTA,26,82,41,52,93
23,8477946,Dylan Larkin,C,DET,28,82,41,51,92
23,8479385,Jordan Kyrou,C,STL,26,82,41,51,92
23,8481557,Matt Boldy,L,MIN,23,82,38,54,92
23,8478403,Jack Eichel,C,VGK,28,82,36,56,92
23,8475166,John Tavares,C,TOR,34,82,33,59,92
23,8480069,Cale Makar,D,COL,26,82,23,69,92
23,8476887,Filip Forsberg,L,NSH,30,82,42,49,91
23,8475913,Mark Stone,R,VGK,32,82,35,55,90
23,8477409,Carter Verhaeghe,C,FLA,29,82,53,36,89
23,8478010,Brayden Point,C,TBL,28,82,42,46,88
23,8474564,Steven Stamkos,C,NSH,34,82,32,56,88
23,8473512,Claude Giroux,R,OTT,36,82,30,57,87
23,8480023,Robert Thomas,C,STL,25,82,25,61,86
23,8479407,Jesper Bratt,L,NJD,26,82,23,63,86
23,8478398,Kyle Connor,L,WPG,28,82,34,51,85
23,8480002,Nico Hischier,C,NJD,25,82,33,52,85
23,8475168,Matt Duchene,C,DAL,33,82,31,54,85
23,8480800,Quinn Hughes,D,VAN,25,82,11,74,85
23,8478414,Timo Meier,R,NJD,28,82,39,45,84
23,8480208,Drake Batherson,R,OTT,26,82,35,49,84
23,8480839,Rasmus Dahlin,D,BUF,24,82,21,63,84
23,8478427,Sebastian Aho,C,CAR,27,82,33,50,83
23,8473419,Brad Marchand,L,BOS,36,82,33,50,83
23,8477942,Kevin Fiala,L,LAK,28,82,33,49,82
23,8476459,Mika Zibanejad,C,NYR,31,82,27,55,82
23,8482116,Tim Stützle,C,OTT,22,82,23,59,82
23,8476454,Ryan Nugent-Hopkins,C,EDM,31,82,21,61,82
23,8477933,Sam Reinhart,C,FLA,29,82,36,45,81
23,8475170,Brayden Schenn,C,STL,33,82,22,59,81
23,8474600,Roman Josi,D,NSH,34,82,19,62,81
23,8479323,Adam Fox,D,NYR,26,82,12,68,80
23,8475172,Nazem Kadri,C,CGY,34,82,32,47,79
23,8476456,Jonathan Huberdeau,C,CGY,31,82,19,59,78
23,8478445,Mathew Barzal,C,NYI,27,82,16,62,78
23,8476881,Tomas Hertl,C,VGK,31,82,40,35,75
23,8478975,Mason Marchment,L,DAL,29,82,34,41,75
23,8482078,Lucas Raymond,L,DET,22,82,32,43,75
23,8477951,Nick Schmaltz,C,UTA,28,82,24,51,75
23,8480830,Andrei Svechnikov,R,CAR,24,82,30,43,73
23,8476539,Jonathan Marchessault,R,NSH,34,82,41,31,72
23,8471214,Alex Ovechkin,L,WSH,39,82,40,32,72
23,8478439,Travis Konecny,R,PHI,27,82,37,35,72
23,8479542,Brandon Hagel,L,TBL,26,82,35,37,72
23,8478444,Brock Boeser,R,VAN,27,82,32,40,72
23,8476853,Morgan Rielly,D,TOR,30,82,13,59,72
23,8480014,Gabriel Vilardi,C,WPG,25,82,37,34,71
23,8475765,Vladimir Tarasenko,R,DET,33,82,31,40,71
23,8474141,Patrick Kane,R,DET,36,82,25,46,71
23,8478449,Roope Hintz,C,DAL,28,82,33,37,70
23,8477503,Max Domi,C,TOR,29,82,19,51,70
23,8478460,Zach Werenski,D,CBJ,27,82,20,49,69
23,8479325,Charlie McAvoy,D,BOS,27,82,8,61,69
23,8481540,Cole Caufield,R,MTL,23,82,36,32,68
23,8482110,Dawson Mercer,C,NJD,23,82,30,38,68
23,8477949,Alex Tuch,R,BUF,28,82,23,45,68
23,8477494,Jonathan Drouin,L,COL,29,82,13,55,68
23,8479420,Tage Thompson,C,BUF,27,82,38,29,67
23,8480018,Nick Suzuki,C,MTL,25,82,29,38,67
23,8476389,Vincent Trocheck,C,NYR,31,82,21,46,67
23,8475692,Mats Zuccarello,R,MIN,37,82,17,50,67
23,8478042,Viktor Arvidsson,R,EDM,31,82,31,35,66
23,8478440,Dylan Strome,C,WSH,27,82,29,37,66
23,8473994,Jamie Benn,L,DAL,35,82,27,39,66
23,8482093,Seth Jarvis,C,CAR,22,82,23,43,66
23,8481711,Matias Maccelli,L,UTA,24,82,20,46,66
23,8475810,Bryan Rust,R,PIT,32,82,33,32,65
23,8477960,Adrian Kempe,R,LAK,28,82,32,33,65
23,8477496,Elias Lindholm,C,BOS,30,82,27,38,65
23,8471685,Anze Kopitar,C,LAK,37,82,24,41,65
23,8474578,Erik Karlsson,D,PIT,34,82,23,42,65
23,8481523,Kirby Dach,C,MTL,23,82,14,51,65
23,8477955,Jared McCann,L,SEA,28,82,30,34,64
23,8476460,Mark Scheifele,C,WPG,31,82,23,41,64
23,8480803,Evan Bouchard,D,EDM,25,82,14,50,64
23,8477447,Shea Theodore,D,VGK,29,82,7,57,64
23,8475754,Brock Nelson,C,NYI,33,82,33,30,63
23,8476882,Teuvo Teravainen,L,CHI,30,82,24,39,63
23,8478469,Thomas Chabot,D,OTT,27,82,14,49,63
23,8475184,Chris Kreider,L,NYR,33,82,45,17,62
23,8477404,Jake Guentzel,C,TBL,30,82,28,34,62
23,8479675,Trevor Moore,L,LAK,29,82,28,34,62
23,8477497,Sean Monahan,C,CBJ,30,82,28,34,62
23,8481596,Shane Pinto,C,OTT,24,82,26,36,62
23,8474679,Gustav Nyquist,C,NSH,35,82,23,39,62
23,8480798,Philipp Kurashev,C,CHI,25,82,19,43,62
23,8477504,Josh Morrissey,D,WPG,29,82,15,47,62
23,8476346,Johnny Gaudreau,L,CBJ,31,82,12,50,62
23,8480036,Miro Heiskanen,D,DAL,25,82,9,53,62
23,8478407,Vince Dunn,D,SEA,28,82,8,54,62
23,8476826,Yanni Gourde,C,SEA,33,82,23,38,61
23,8476462,Dougie Hamilton,D,NJD,31,82,19,42,61
23,8475158,Ryan O'Reilly,C,NSH,33,82,23,37,60
23,8478046,Danton Heinen,L,VAN,29,82,23,37,60
23,8475794,Tyler Seguin,C,DAL,32,82,22,38,60
23,8480039,Martin Necas,C,CAR,25,82,21,39,60
23,8477935,Sam Bennett,C,FLA,28,82,21,39,60
23,8476448,William Karlsson,C,VGK,31,82,25,34,59
23,8482665,Matty Beniers,C,SEA,22,82,23,36,59
23,8477416,Oliver Bjorkstrand,R,SEA,29,82,20,39,59
23,8478396,Noah Hanifin,D,VGK,27,82,13,46,59
23,8476875,Mike Matheson,D,MTL,30,82,9,50,59
23,8482159,Tyson Foerster,R,PHI,22,82,29,29,58
23,8482097,Jack Quinn,R,BUF,23,82,28,30,58
23,8482109,Alexis Lafrenière,L,NYR,23,82,28,30,58
23,8480015,Owen Tippett,R,PHI,25,82,27,31,58
23,8477940,Nikolaj Ehlers,L,WPG,28,82,26,32,58
23,8476792,Torey Krug,D,STL,33,82,21,37,58
23,8476905,Chandler Stephenson,C,SEA,30,82,21,37,58
23,8477407,Anthony Duclair,L,NYI,29,82,21,37,58
23,8475745,Charlie Coyle,C,BOS,32,82,20,38,58
23,8478856,Conor Garland,R,VAN,28,82,26,31,57
23,8475763,Kevin Hayes,R,PIT,32,82,26,31,57
23,8478472,Mathieu Joseph,R,STL,27,82,24,32,56
23,8478458,Jack Roslovic,C,CAR,27,82,23,33,56
23,8480188,Fabian Zetterlund,L,SJS,25,82,22,34,56
23,8482113,Anton Lundell,C,FLA,23,82,22,34,56
23,8474586,Jordan Eberle,R,SEA,34,82,21,35,56
23,8481533,Trevor Zegras,C,ANA,23,82,18,38,56
23,8480865,Noah Dobson,D,NYI,24,82,12,44,56
23,8475726,Tyler Toffoli,C,SJS,32,82,28,27,55
23,8484144,Connor Bedard,C,CHI,19,82,23,32,55
23,8478047,Michael Bunting,L,PIT,29,82,20,35,55
23,8478401,Pavel Zacha,C,BOS,27,82,18,37,55
23,8476399,Blake Coleman,C,CGY,33,82,31,23,54
23,8478498,Jake DeBrusk,L,VAN,28,82,31,23,54
23,8475784,Jeff Skinner,C,EDM,32,82,28,26,54
23,8482720,Matthew Knies,L,TOR,22,82,22,32,54
23,8478873,Troy Terry,R,ANA,27,82,15,39,54
23,8476906,Shayne Gostisbehere,D,CAR,31,82,15,39,54
23,8475798,Mikael Granlund,C,SJS,32,82,14,40,54
23,8480028,Morgan Frost,C,PHI,25,82,14,40,54
23,8478055,Gustav Forsling,D,FLA,28,82,14,40,54
23,8477500,Bo Horvat,C,NYI,29,82,28,25,53
23,8482740,Wyatt Johnston,C,DAL,21,82,27,26,53
23,8477964,Ivan Barbashev,C,VGK,29,82,26,27,53
23,8481528,Dylan Cozens,C,BUF,23,82,24,29,53
23,8482149,Cole Perfetti,C,WPG,22,82,22,31,53
23,8471215,Evgeni Malkin,C,PIT,38,82,16,37,53
23,8478438,Tommy Novak,C,NSH,27,82,15,38,53
23,8482684,Luke Hughes,D,NJD,21,82,12,41,53
23,8479339,Patrik Laine,L,CBJ,26,82,27,25,52
23,8477476,Artturi Lehkonen,L,COL,29,82,23,29,52
23,8478233,Andrew Mangiapane,L,WSH,28,82,18,34,52
23,8477948,Travis Sanheim,D,PHI,28,82,14,38,52
23,8482124,Quinton Byfield,R,LAK,22,82,12,40,52
23,8475167,Victor Hedman,D,TBL,34,82,8,44,52
23,8482699,Dylan Guenther,R,UTA,21,82,30,21,51
23,8476483,Rickard Rakell,R,PIT,31,82,27,24,51
23,8475169,Evander Kane,L,EDM,33,82,25,26,51
23,8475768,Jaden Schwartz,C,SEA,32,82,25,26,51
23,8478493,Joel Eriksson Ek,C,MIN,27,82,20,31,51
23,8476292,Ondrej Palat,L,NJD,33,82,20,31,51
23,8480434,Sean Durzi,D,UTA,26,82,14,37,51
23,8471724,Kris Letang,D,PIT,37,82,12,39,51
23,8479410,Mikhail Sergachev,D,UTA,26,82,8,43,51
23,8475191,Reilly Smith,R,NYR,33,82,27,23,50
23,8477479,Tyler Bertuzzi,L,CHI,29,82,21,29,50
23,8479400,Pierre-Luc Dubois,L,WSH,26,82,21,29,50
23,8482475,Yegor Chinakhov,R,CBJ,23,82,20,30,50
23,8477456,J.T. Compher,L,DET,29,82,19,31,50
23,8475753,Justin Faulk,D,STL,32,82,14,36,50
23,8477932,Aaron Ekblad,D,FLA,28,82,12,38,50
23,8477346,MacKenzie Weegar,D,CGY,30,82,11,39,50
23,8479425,Filip Hronek,D,VAN,27,82,10,40,50
23,8478366,Frank Vatrano,R,ANA,30,82,32,17,49
23,8475786,Zach Hyman,L,EDM,32,82,26,23,49
23,8477998,Warren Foegele,L,LAK,28,82,23,26,49
23,8481560,Arthur Kaliyev,R,LAK,23,82,21,28,49
23,8477429,Andrew Copp,C,DET,30,82,20,29,49
23,8480829,Jesperi Kotkaniemi,C,CAR,24,82,18,31,49
23,8477986,Brandon Montour,D,SEA,30,82,15,34,49
23,8480078,Filip Chytil,C,NYR,25,82,14,35,49
23,8479365,Trent Frederic,C,BOS,26,82,13,36,49
23,8477495,Seth Jones,D,CHI,30,82,11,38,49
23,8474590,John Carlson,D,WSH,34,82,5,44,49
23,8480064,Josh Norris,C,OTT,25,82,29,19,48
23,8482092,Ridly Greig,C,OTT,22,82,28,20,48
23,8478057,Dakota Joshua,C,VAN,28,82,18,30,48
23,8476479,Phillip Danault,C,LAK,31,82,15,33,48
23,8481542,Moritz Seider,D,DET,23,82,6,42,48
23,8478474,Lawson Crouse,L,UTA,27,82,24,23,47
23,8477953,Kasperi Kapanen,R,STL,28,82,24,23,47
23,8478519,Anthony Cirelli,C,TBL,27,82,23,24,47
23,8475793,Ryan Johansen,C,PHI,32,82,23,24,47
23,8481535,Nils Hoglander,L,VAN,24,82,22,25,47
23,8474102,David Perron,L,OTT,36,82,19,28,47
23,8478397,Rasmus Andersson,D,CGY,28,82,14,33,47
23,8481656,Aliaksei Protas,C,WSH,23,82,14,33,47
23,8480145,Neal Pionk,D,WPG,29,82,9,38,47
23,8475218,Mattias Ekholm,D,EDM,34,82,9,38,47
23,8476432,Boone Jenner,C,CBJ,31,82,23,23,46
23,8477444,Andre Burakovsky,L,SEA,29,82,22,24,46
23,8479987,Morgan Geekie,C,BOS,26,82,22,24,46
23,8480797,Joel Farabee,L,PHI,24,82,19,27,46
23,8476921,Jordan Martinook,L,CAR,32,82,19,27,46
23,8478542,Evan Rodrigues,C,FLA,31,82,18,28,46
23,8477511,Anthony Mantha,R,CGY,30,82,15,31,46
23,8476869,Brady Skjei,D,NSH,30,82,15,31,46
23,8479999,Casey Mittelstadt,C,COL,26,82,15,31,46
23,8476854,Hampus Lindholm,D,BOS,30,82,12,34,46
23,8470613,Brent Burns,D,CAR,39,82,10,36,46
23,8476885,Jacob Trouba,D,NYR,30,82,10,36,46
23,8474565,Alex Pietrangelo,D,VGK,34,82,8,38,46
23,8474641,Adam Henrique,C,EDM,34,82,25,20,45
23,8481580,Connor McMichael,C,WSH,23,82,24,21,45
23,8477451,Ryan Hartman,R,MIN,30,82,22,23,45
23,8471698,T.J. Oshie,R,WSH,38,82,19,26,45
23,8474150,Mikael Backlund,C,CGY,35,82,19,26,45
23,8477919,Frederick Gaudreau,C,MIN,31,82,18,27,45
23,8482671,Owen Power,D,BUF,22,82,9,36,45
23,8475151,Kyle Palmieri,C,NYI,33,82,25,19,44
23,8476438,Brandon Saad,L,STL,32,82,20,24,44
23,8474053,Logan Couture,C,SJS,35,82,18,26,44
23,8476458,Ryan Strome,C,ANA,31,82,17,27,44
23,8482660,Kent Johnson,C,CBJ,22,82,15,29,44
23,8481618,Alex Newhook,C,MTL,23,82,14,30,44
23,8481581,Thomas Harley,D,DAL,23,82,13,31,44
23,8479351,Sam Steel,C,DAL,26,82,11,33,44
23,8481554,Kaapo Kakko,R,NYR,23,82,24,19,43
23,8480893,Kirill Marchenko,R,CBJ,24,82,24,19,43
23,8483808,Andrei Kuzmenko,L,CGY,28,82,22,21,43
23,8482745,Mason McTavish,C,ANA,21,82,18,25,43
23,8476872,Scott Laughton,C,PHI,30,82,18,25,43
23,8481546,Cam York,D,PHI,23,82,10,33,43
23,8475799,Nino Niederreiter,R,WPG,32,82,26,16,42
23,8477947,Sonny Milano,L,WSH,28,82,22,20,42
23,8481068,Yegor Sharangovich,C,CGY,26,82,20,22,42
23,8476880,Tom Wilson,R,WSH,30,82,19,23,42
23,8480871,Adam Boqvist,D,FLA,24,82,13,29,42
23,8478891,Mason Appleton,C,WPG,28,82,12,30,42
23,8478038,Devon Toews,D,COL,30,82,8,34,42
23,8480074,Alexandre Texier,C,STL,25,82,18,23,41
23,8473986,Alex Killorn,L,ANA,35,82,17,24,41
23,8474563,Drew Doughty,D,LAK,35,82,10,31,41
23,8475171,Oliver Ekman-Larsson,D,TOR,33,82,10,31,41
23,8474149,Evgenii Dadonov,R,DAL,35,82,22,18,40
23,8477987,Ryan Donato,C,CHI,28,82,19,21,40
23,8475722,Jason Zucker,L,BUF,32,82,18,22,40
23,8476461,Sean Couturier,C,PHI,32,82,18,22,40
23,8479992,Michael Rasmussen,C,DET,25,82,15,25,40
23,8480849,Barrett Hayton,C,UTA,24,82,15,25,40
23,8476958,Jaccob Slavin,D,CAR,30,82,12,28,40
23,8478882,Vladislav Gavrikov,D,LAK,29,82,8,32,40
23,8480043,Timothy Liljegren,D,TOR,25,82,1,39,40
23,8480835,Jack Drury,C,CAR,24,82,25,14,39
23,8478508,Yakov Trenin,C,MIN,27,82,23,16,39
23,8476981,Josh Anderson,R,MTL,30,82,20,19,39
23,8477989,Christian Dvorak,C,MTL,28,82,18,21,39
23,8475193,Tomas Tatar,L,NJD,34,82,18,21,39
23,8480220,Noah Cates,L,PHI,25,82,15,24,39
23,8477021,Alex Kerfoot,C,UTA,30,82,17,21,38
23,8483515,Juraj Slafkovsky,L,MTL,20,82,16,22,38
23,8473563,Nicklas Backstrom,C,WSH,37,82,16,22,38
23,8475287,Erik Haula,L,NJD,33,82,16,22,38
23,8482667,William Eklund,L,SJS,22,82,15,23,38
23,8481624,Ilya Mikheyev,R,CHI,30,82,14,24,38
23,8480113,Alex Iafallo,L,WPG,31,82,12,26,38
23,8479345,Jakob Chychrun,D,WSH,26,82,6,32,38
23,8478507,John Marino,D,UTA,27,82,4,34,38
23,8476979,Erik Gustafsson,D,DET,32,82,3,35,38
23,8481013,Jonatan Berggren,R,DET,24,82,21,16,37
23,8480009,Eeli Tolvanen,R,SEA,25,82,20,17,37
23,8482117,Lukas Reichel,L,CHI,22,82,20,17,37
23,8476918,Jimmy Vesey,L,NYR,31,82,16,21,37
23,8481481,Blake Lizotte,C,PIT,27,82,14,23,37
23,8477507,Nikita Zadorov,D,BOS,29,82,7,30,37
23,8481606,Jordan Spence,D,LAK,23,82,6,31,37
23,8479976,Juuso Valimaki,D,UTA,26,82,6,31,37
23,8473507,Jeff Petry,D,DET,37,82,5,32,37
23,8470621,Corey Perry,R,EDM,39,82,21,15,36
23,8476480,Vladislav Namestnikov,C,WPG,32,82,20,16,36
23,8476897,Oskar Sundqvist,C,STL,30,82,16,20,36
23,8475791,Taylor Hall,L,CHI,33,82,13,23,36
23,8476925,Colton Sissons,C,NSH,31,82,11,25,36
23,8480817,K'Andre Miller,D,NYR,24,82,8,28,36
23,8480459,Pius Suter,C,VAN,28,82,21,14,35
23,8481186,Logan O'Connor,R,COL,28,82,20,15,35
23,8481604,Pavel Dorofeyev,L,VGK,24,82,18,17,35
23,8481582,Nicholas Robertson,L,TOR,23,82,18,17,35
23,8477952,Robby Fabbri,C,ANA,28,82,17,18,35
23,8478115,Pierre Engvall,L,NYI,28,82,16,19,35
23,8475714,Calle Jarnkrok,C,TOR,33,82,13,22,35
23,8476931,Jake McCabe,D,TOR,31,82,9,26,35
23,8478500,Ivan Provorov,D,CBJ,27,82,5,30,35
23,8473422,Nick Foligno,L,CHI,37,82,17,17,34
23,8478462,Nicolas Roy,C,VGK,27,82,16,18,34
23,8478463,Anthony Beauvillier,L,PIT,27,82,16,18,34
23,8475149,Marcus Johansson,L,MIN,34,82,15,19,34
23,8480144,David Kampf,C,TOR,29,82,15,19,34
23,8479316,Luke Kunin,C,SJS,27,82,14,20,34
23,8480068,Ryan Poehling,C,PHI,25,82,12,22,34
23,8479293,Brandon Tanev,L,SEA,33,82,18,15,33
23,8476927,Teddy Blueger,C,VAN,30,82,14,19,33
23,8476419,Jean-Gabriel Pageau,C,NYI,32,82,14,19,33
23,8476960,Andreas Athanasiou,C,CHI,30,82,10,23,33
23,8474716,Jared Spurgeon,D,MIN,35,82,4,29,33
23,8477498,Darnell Nurse,D,EDM,29,82,4,29,33
23,8482705,Cole Sillinger,C,CBJ,21,82,20,12,32
23,8476278,Colin Blackwell,C,DAL,31,82,19,13,32
23,8479996,Cody Glass,C,NSH,25,82,17,15,32
23,8482089,Jake Neighbours,L,STL,22,82,16,16,32
23,8478020,Michael Amadio,C,OTT,28,82,16,16,32
23,8476873,Mark Jankowski,C,NSH,30,82,16,16,32
23,8484145,Zach Benson,L,BUF,19,82,15,17,32
23,8478911,Matt Roy,D,WSH,29,82,12,20,32
23,8475848,Brendan Gallagher,R,MTL,32,82,10,22,32
23,8482807,Ethan Del Mastro,D,CHI,21,82,10,22,32
23,8476329,Travis Boyd,C,MIN,31,82,8,24,32
23,8475200,Dmitry Orlov,D,CAR,33,82,8,24,32
23,8480878,Nils Lundkvist,D,DAL,24,82,8,24,32
23,8475764,Cam Fowler,D,ANA,33,82,4,28,32
23,8480281,Alexey Toropchenko,R,STL,25,82,22,9,31
23,8479525,Ross Colton,C,COL,28,82,19,12,31
23,8481704,Juuso Parssinen,C,NSH,23,82,17,14,31
23,8477426,Nicholas Paul,L,TBL,29,82,16,15,31
23,8479393,Noah Gregor,C,OTT,26,82,16,15,31
23,8477450,Jason Dickinson,C,CHI,29,82,16,15,31
23,8477392,Hudson Fasching,R,NYI,29,82,15,16,31
23,8479941,Justin Danforth,R,CBJ,31,82,14,17,31
23,8484203,Bradly Nadeau,L,CAR,19,82,13,18,31
23,8478109,Victor Olofsson,L,VGK,29,82,13,18,31
23,8479390,Taylor Raddysh,R,WSH,26,82,12,19,31
23,8482133,Thomas Bordeleau,C,SJS,22,82,10,21,31
23,8483431,Logan Cooley,C,UTA,20,82,17,13,30
23,8480802,Ryan McLeod,C,BUF,25,82,15,15,30
23,8482055,Drew O'Connor,L,PIT,26,82,15,15,30
23,8475842,Sam Carrick,C,NYR,32,82,15,15,30
23,8478413,Jordan Greenway,L,BUF,27,82,14,16,30
23,8480748,Kiefer Sherwood,L,VAN,29,82,13,17,30
23,8474189,Lars Eller,C,PIT,35,82,13,17,30
23,8476474,Stefan Noesen,R,NJD,31,82,13,17,30
23,8482702,Logan Stankoven,C,DAL,21,82,11,19,30
23,8475343,Nic Dowd,C,WSH,34,82,11,19,30
23,8481708,Zac Jones,D,NYR,24,82,11,19,30
23,8476392,Adam Lowry,C,WPG,31,82,10,20,30
23,8480336,Sean Walker,D,CAR,30,82,10,20,30
23,8476902,Esa Lindell,D,DAL,30,82,5,25,30
23,8475690,Chris Tanev,D,TOR,35,82,5,25,30
23,8482105,Jake Sanderson,D,OTT,22,82,4,26,30
23,8475181,Nick Leddy,D,STL,33,82,4,26,30
23,8477488,Brett Pesce,D,NJD,30,82,3,27,30
23,8482655,J.J. Moser,D,TBL,24,82,1,29,30
23,8482624,Daniil Miromanov,D,CGY,27,82,12,17,29
23,8480789,Oliver Wahlstrom,R,NYI,24,82,12,17,29
23,8476457,Adam Larsson,D,SEA,32,82,9,20,29
23,8476422,Mike Reilly,D,NYI,31,82,8,21,29
23,8476331,Dylan DeMelo,D,WPG,31,82,8,21,29
23,8476923,Damon Severson,D,CBJ,30,82,7,22,29
23,8482470,Ilya Solovyov,D,CGY,24,82,6,23,29
23,8479402,Jake Bean,D,CGY,26,82,3,26,29
23,8481093,Rafael Harvey-Pinard,L,MTL,25,82,16,12,28
23,8479414,Nathan Bastian,R,NJD,27,82,14,14,28
23,8482146,Luke Evangelista,R,NSH,22,82,12,16,28
23,8484166,Adam Fantilli,C,CBJ,20,82,11,17,28
23,8481517,Brett Leason,R,ANA,25,82,11,17,28
23,8480813,Joe Veleno,C,DET,24,82,10,18,28
23,8481477,Nico Sturm,C,SJS,29,82,10,18,28
23,8480185,Eetu Luostarinen,C,FLA,26,82,9,19,28
23,8476463,Jonas Brodin,D,MIN,31,82,9,19,28
23,8483468,Jiri Kulich,C,BUF,20,82,8,20,28
23,8478133,Jake Evans,C,MTL,28,82,7,21,28
23,8478443,Brandon Carlo,D,BOS,28,82,7,21,28
23,8481553,Bobby Brink,R,PHI,23,82,7,21,28
23,8480873,Rasmus Sandin,D,WSH,24,82,5,23,28
23,8483490,Pavel Mintyukov,D,ANA,21,82,4,24,28
23,8482155,Alex Laferriere,R,LAK,23,82,21,6,27
23,8481032,Paul Cotter,C,NJD,25,82,15,12,27
23,8477425,Miles Wood,L,COL,29,82,14,13,27
23,8479591,Michael Eyssimont,C,TBL,28,82,14,13,27
23,8473533,Jordan Staal,C,CAR,36,82,13,14,27
23,8477839,Conor Sheary,L,TBL,32,82,13,14,27
23,8482175,JJ Peterka,R,BUF,22,82,12,15,27
23,8480855,Jack McBain,C,UTA,24,82,12,15,27
23,8475855,Jesper Fast,R,CAR,33,82,12,15,27
23,8482111,Justin Barron,D,MTL,23,82,11,16,27
23,8483457,Lane Hutson,D,MTL,20,82,10,17,27
23,8478450,Parker Wotherspoon,D,BOS,27,82,9,18,27
23,8478569,Noel Acciari,C,PIT,33,82,8,19,27
23,8477931,Tomas Nosek,L,FLA,32,82,8,19,27
23,8480073,Erik Brannstrom,D,COL,25,82,8,19,27
23,8482141,Lukas Cormier,D,VGK,22,82,8,19,27
23,8477969,Marcus Pettersson,D,PIT,28,82,5,22,27
23,8483495,Simon Nemec,D,NJD,20,82,4,23,27
23,8482122,Brock Faber,D,MIN,22,82,3,24,27
23,8480049,Dylan Samberg,D,WPG,25,82,3,24,27
23,8481178,Egor Zamula,D,PHI,24,82,2,25,27
23,8479398,Samuel Girard,D,COL,26,82,1,26,27
23,8476878,Zemgus Girgensons,L,TBL,30,82,15,11,26
23,8476469,Joel Armia,R,MTL,31,82,14,12,26
23,8476624,Barclay Goodrow,C,SJS,31,82,13,13,26
23,8481028,Martin Pospisil,C,CGY,25,82,11,15,26
23,8481568,Alex Vlasic,D,CHI,23,82,10,16,26
23,8483763,Maksymilian Szuber,D,UTA,22,82,8,18,26
23,8480796,Martin Fehervary,D,WSH,25,82,7,19,26
23,8476892,Colton Parayko,D,STL,31,82,5,21,26
23,8476525,Colin Miller,D,WPG,32,82,5,21,26
23,8476312,Josh Manson,D,COL,33,82,4,22,26
23,8475314,Anders Lee,L,NYI,34,82,13,12,25
23,8482762,Simon Edvinsson,D,DET,21,82,12,13,25
23,8482259,Bobby McMann,C,TOR,28,82,10,15,25
23,8476374,Sean Kuraly,C,CBJ,31,82,10,15,25
23,8479368,Max Jones,L,BOS,26,82,10,15,25
23,8475760,Nick Bjugstad,C,UTA,32,82,8,17,25
23,8481014,Alexander Romanov,D,NYI,24,82,6,19,25
23,8476891,Matt Grzelcyk,D,PIT,30,82,6,19,25
23,8480035,Henri Jokiharju,D,BUF,25,82,4,21,25
23,8482073,Braden Schneider,D,NYR,23,82,4,21,25
23,8478840,Will Borgen,D,SEA,28,82,4,21,25
23,8479324,Ryan Lindgren,D,NYR,26,82,4,21,25
23,8476917,Adam Pelech,D,NYI,30,82,2,23,25
23,8478851,Alexandre Carrier,D,NSH,28,82,2,23,25
23,8480246,Nick Perbix,D,TBL,26,82,1,24,25
23,8483397,Marc McLaughlin,C,BOS,25,82,15,9,24
23,8480995,Pontus Holmberg,R,TOR,25,82,14,10,24
23,8483493,Frank Nazar,C,CHI,20,82,14,10,24
23,8483482,Tristan Luneau,D,ANA,20,82,13,11,24
23,8482125,Alexander Holtz,R,VGK,22,82,12,12,24
23,8477903,Garnet Hathaway,R,PHI,33,82,12,12,24
23,8477015,Connor Brown,R,EDM,30,82,12,12,24
23,8476889,Radek Faksa,C,STL,30,82,10,14,24
23,8478432,Christian Fischer,R,DET,27,82,10,14,24
23,8478416,Erik Cernak,D,TBL,27,82,7,17,24
23,8477506,Ryan Pulock,D,NYI,30,82,4,20,24
23,8482142,Jamie Drysdale,D,PHI,22,82,4,20,24
23,8482659,Josh Doan,R,UTA,22,82,14,9,23
23,8480806,Isac Lundestrom,C,ANA,25,82,13,10,23
23,8482074,Connor Zary,C,CGY,23,82,12,11,23
23,8479661,Tanner Jeannot,L,LAK,27,82,11,12,23
23,8479353,Brett Howden,C,VGK,26,82,10,13,23
23,8482733,Logan Mailloux,D,MTL,31,82,9,14,23
23,8480003,Jesper Boqvist,C,FLA,26,82,8,15,23
23,8475188,Brayden McNabb,D,VGK,33,82,2,21,23
23,8474574,Tyler Myers,D,VAN,34,82,1,22,23
23,8482079,Marco Rossi,C,MIN,23,82,12,10,22
23,8473453,Trevor Lewis,C,LAK,37,82,9,13,22
23,8475231,Casey Cizikas,C,NYI,33,82,8,14,22
23,8477220,Nate Schmidt,D,FLA,33,82,7,15,22
23,8479369,Andrew Peeke,D,BOS,26,82,6,16,22
23,8482809,Jackson Blake,R,CAR,21,82,6,16,22
23,8482062,Cole Smith,L,NSH,29,82,5,17,22
23,8479980,Nicolas Hague,D,VGK,26,82,3,19,22
23,8478399,Jonas Siegenthaler,D,NJD,27,82,3,19,22
23,8476429,Scott Mayfield,D,NYI,32,82,3,19,22
23,8482077,Dylan Holloway,L,EDM,23,82,13,8,21
23,8477353,Tyler Motte,C,DET,29,82,12,9,21
23,8478211,Dryden Hunt,L,CGY,29,82,10,11,21
23,8482679,Matt Coronato,R,CGY,22,82,9,12,21
23,8474715,Cam Atkinson,R,TBL,35,82,8,13,21
23,8482166,Shakir Mukhamadullin,D,SJS,22,82,8,13,21
23,8478468,Jeremy Lauzon,D,NSH,27,82,7,14,21
23,8478013,Jake Walman,D,SJS,28,82,6,15,21
23,8479442,Troy Stecher,D,EDM,30,82,5,16,21
23,8475455,Brenden Dillon,D,NJD,34,82,4,17,21
23,8482245,Artem Zub,D,OTT,29,82,3,18,21
23,8477365,Connor Clifton,D,BUF,29,82,3,18,21
23,8478136,Jake Middleton,D,MIN,28,82,2,19,21
23,8477845,Trevor van Riemsdyk,D,WSH,33,82,0,21,21
23,8475220,Marcus Foligno,L,MIN,33,82,9,11,20
23,8481522,Peyton Krebs,C,BUF,23,82,6,14,20
23,8475279,Ben Chiarot,D,DET,33,82,6,14,20
23,8483565,Nick Blankenburg,D,NSH,26,82,6,14,20
23,8476442,Matt Nieto,L,PIT,32,82,6,14,20
23,8479983,Mario Ferraro,D,SJS,26,82,5,15,20
23,8482803,Olen Zellweger,D,ANA,21,82,5,15,20
23,8480222,Sebastian Aho,D,PIT,28,82,4,16,20
23,8477369,Carson Soucy,D,VAN,30,82,4,16,20
23,8475324,Nick Jensen,D,OTT,34,82,3,17,20
23,8477406,Mattias Janmark,C,EDM,32,82,12,7,19
23,8481641,Joel Kiviranta,L,COL,28,82,11,8,19
23,8479998,Mikey Anderson,D,LAK,25,82,5,14,19
23,8476372,Nick Seeler,D,PHI,31,82,5,14,19
23,8481605,Jackson LaCombe,D,ANA,23,82,4,15,19
23,8475718,Justin Holl,D,DET,32,82,1,18,19
23,8474673,TJ Brodie,D,CHI,34,82,0,19,19
23,8481601,Simon Holmstrom,R,NYI,23,82,10,8,18
23,8481567,Henry Thrun,D,SJS,23,82,9,9,18
23,8478434,Keegan Kolesar,R,VGK,27,82,8,10,18
23,8480448,Parker Kelly,L,COL,25,82,8,10,18
23,8482666,Scott Morrow,D,CAR,22,82,6,12,18
23,8483445,Cutter Gauthier,L,ANA,20,82,5,13,18
23,8482087,Kaiden Guhle,D,MTL,22,82,4,14,18
23,8474151,Ryan McDonagh,D,TBL,35,82,3,15,18
23,8484911,Collin Graf,R,SJS,22,82,3,15,18
23,8480950,Ilya Lyubushkin,D,DAL,30,82,2,16,18
23,8480879,Jacob Bernard-Docker,D,OTT,24,82,2,16,18
23,8477034,Jaycob Megna,D,FLA,32,82,2,16,18
23,8476879,Cody Ceci,D,EDM,31,82,1,17,18
23,8477508,Curtis Lazar,C,NJD,29,82,12,5,17
23,8482101,Danil Gushchin,L,SJS,22,82,9,8,17
23,8484153,Leo Carlsson,C,ANA,20,82,8,9,17
23,8482712,Oskar Olausson,R,COL,22,82,7,10,17
23,8480807,Mattias Samuelsson,D,BUF,24,82,6,11,17
23,8481524,Bowen Byram,D,BUF,23,82,6,11,17
23,8479359,Beck Malenstyn,L,BUF,26,82,6,11,17
23,8480860,Kevin Bahl,D,CGY,24,82,4,13,17
23,8480834,Ty Emberson,D,SJS,24,82,4,13,17
23,8483012,Logan Morrison,C,SEA,22,82,4,13,17
23,8481122,Simon Benoit,D,TOR,26,82,4,13,17
23,8477435,Ryan Graves,D,PIT,29,82,3,14,17
23,8478859,Niko Mikkola,D,FLA,28,82,3,14,17
23,8474612,Travis Hamonic,D,OTT,34,82,2,15,17
23,8475790,Erik Gudbranson,D,CBJ,32,82,2,15,17
23,8476858,Phillip Di Giuseppe,L,VAN,31,82,11,5,16
23,8483524,Shane Wright,C,SEA,20,82,8,8,16
23,8480980,Connor Dewar,C,TOR,25,82,8,8,16
23,8482145,Mavrik Bourque,C,DAL,22,82,8,8,16
23,8479291,Kevin Rooney,C,CGY,31,82,7,9,16
23,8482118,Sam Colangelo,R,ANA,23,82,6,10,16
23,8476441,Joel Edmundson,D,LAK,31,82,3,13,16
23,8475762,Derek Forbort,D,VAN,32,82,3,13,16
23,8475233,David Savard,D,MTL,34,82,2,14,16
23,8480172,Jan Rutta,D,SJS,34,82,2,14,16
23,8483460,David Jiricek,D,CBJ,21,82,1,15,16
23,8470600,Ryan Suter,D,STL,39,82,0,16,16
23,8483567,Georgii Merkulov,C,BOS,24,82,10,5,15
23,8480870,Bo Groulx,C,NYR,24,82,8,7,15
23,8483471,Brad Lambert,C,WPG,31,82,6,9,15
23,8481699,Aku Raty,R,UTA,23,82,6,9,15
23,8477499,Rasmus Ristolainen,D,PHI,30,82,3,12,15
23,8483499,Liam Ohgren,L,MIN,20,82,3,12,15
23,8476467,Jamie Oleksiak,D,SEA,32,82,3,12,15
23,8474013,Ian Cole,D,UTA,35,82,3,12,15
23,8478178,Darren Raddysh,D,TBL,28,82,2,13,15
23,8479371,Dante Fabbro,D,NSH,26,82,1,14,15
23,8480025,MacKenzie Entwistle,R,FLA,25,82,10,4,14
23,8482153,Brendan Brisson,C,VGK,23,82,8,6,14
23,8480990,Declan Chisholm,D,MIN,24,82,7,7,14
23,8474090,Brendan Smith,D,DAL,35,82,5,9,14
23,8475177,Calvin de Haan,D,COL,33,82,3,11,14
23,8483466,Kevin Korchinski,D,CHI,20,82,2,12,14
23,8476967,Brett Kulak,D,EDM,30,82,1,13,14
23,8483505,Matthew Poitras,C,BOS,20,82,6,7,13
23,8480021,Jack Studnicka,C,LAK,25,82,4,9,13
23,8475462,Radko Gudas,D,ANA,34,82,1,12,13
23,8482749,Joshua Roy,R,MTL,21,82,6,6,12
23,8477505,Alexander Wennberg,C,SJS,30,82,5,7,12
23,8474567,Zach Bogosian,D,MIN,34,82,5,7,12
23,8476473,Connor Murphy,D,CHI,31,82,5,7,12
23,8479638,Justin Brazeau,R,BOS,26,82,6,5,11
23,8471677,Jack Johnson,D,CBJ,37,82,4,7,11
23,8484149,Gavin Brindley,C,CBJ,20,82,4,7,11
23,8477335,Kyle Burroughs,D,LAK,29,82,3,8,11
23,8479576,Vincent Desharnais,D,VAN,28,82,2,9,11
23,8478874,Adam Gaudette,C,OTT,28,82,2,9,11
23,8482858,Ryker Evans,D,SEA,23,82,1,10,11
23,8482070,Mitchell Chaffee,R,TBL,26,82,2,8,10
23,8482516,Matthew Kessel,D,STL,24,82,1,9,10
23,8483489,Fraser Minten,C,TOR,31,82,5,4,9
23,8482713,Mackie Samoskevich,R,FLA,22,82,4,5,9
23,8477938,Haydn Fleury,D,WPG,28,82,1,8,9
23,8474062,Riley Nash,C,NYR,35,82,4,3,7
23,8482859,Zack Ostapchuk,C,OTT,21,82,3,4,7
23,8476822,Luke Glendening,C,TBL,35,82,3,3,6
23,8482787,Nikita Chibrikov,R,WPG,31,82,1,3,4
23,8470794,Joe Pavelski,C,,40,0,0,0,0
23,8481703,Valtteri Puustinen,R,PIT,25,0,0,0,0
23,8477950,Tony DeAngelo,D,,29,0,0,0,0
23,8481577,Philip Tomasino,C,NSH,23,0,0,0,0
23,8475197,Tyson Barrie,D,,33,0,0,0,0
23,8471218,Blake Wheeler,R,,38,0,0,0,0
23,8474157,Max Pacioretty,L,,36,0,0,0,0
23,8478466,Daniel Sprong,R,VAN,27,0,0,0,0
23,8475744,Evgeny Kuznetsov,C,,32,0,0,0,0
23,8481019,David Gustafsson,C,WPG,24,0,0,0,0
23,8475906,John Klingberg,D,,32,0,0,0,0
23,8479348,Kale Clague,D,BUF,26,0,0,0,0
23,8476952,Dominic Toninato,C,WPG,30,0,0,0,0
23,8473473,Milan Lucic,L,,36,0,0,0,0
23,8474037,James van Riemsdyk,L,,35,0,0,0,0
23,8474602,Justin Schultz,D,,34,0,0,0,0
23,8482222,Alexander Barabanov,L,,30,0,0,0,0
23,8479372,Josh Mahura,D,SEA,26,0,0,0,0
23,8479982,Conor Timmins,D,TOR,26,0,0,0,0
23,8474031,Kevin Shattenkirk,D,,35,0,0,0,0
23,8480008,Adam Ruzicka,C,,25,0,0,0,0
23,8481059,Scott Perunovich,D,STL,26,0,0,0,0
23,8480884,Calen Addison,D,,24,0,0,0,0
23,8476994,Vinnie Hinostroza,C,NSH,30,0,0,0,0
23,8478452,Caleb Jones,D,LAK,27,0,0,0,0
23,8480157,Calle Rosen,D,COL,30,0,0,0,0
23,8481609,Vladislav Kolyachonok,D,UTA,23,0,0,0,0
23,8479415,Michael McLeod,C,,26,0,0,0,0
23,8476919,Chris Tierney,C,,30,0,0,0,0
23,8479639,Dylan Coghlan,D,WPG,26,0,0,0,0
23,8478146,Matthew Highmore,C,OTT,28,0,0,0,0
23,8478970,Jalen Chatfield,D,CAR,28,0,0,0,0
23,8480205,Emil Bemstrom,C,PIT,25,0,0,0,0
23,8474884,Mike Hoffman,C,,35,0,0,0,0
23,8471274,Alex Goligoski,D,,39,0,0,0,0
23,8478104,Sammy Blais,L,,28,0,0,0,0
23,8474870,Tyler Johnson,C,,34,0,0,0,0
23,8476913,Devin Shore,C,MIN,30,0,0,0,0
23,8481598,Philip Broberg,D,EDM,23,0,0,0,0
23,8480058,Pierre-Olivier Joseph,D,STL,25,0,0,0,0
23,8480891,Michael Kesselring,D,UTA,24,0,0,0,0
23,8477979,Nicolas Aube-Kubel,R,BUF,28,0,0,0,0
23,8476871,Tanner Pearson,L,,32,0,0,0,0
23,8476393,Nick Cousins,C,,31,0,0,0,0
23,8479977,Kailer Yamamoto,R,,26,0,0,0,0
23,8479543,Michael Pezzetta,L,MTL,26,0,0,0,0
23,8477018,Ben Hutton,D,VGK,31,0,0,0,0
23,8480762,Eric Robinson,L,CAR,29,0,0,0,0
23,8474034,Pat Maroon,L,CHI,36,0,0,0,0
23,8481058,Jesse Ylönen,R,,25,0,0,0,0
23,8475179,Dmitry Kulikov,D,FLA,34,0,0,0,0
23,8481527,Kaedan Korczak,D,VGK,23,0,0,0,0
23,8473449,Kyle Okposo,R,,36,0,0,0,0
23,8482192,Isaak Phillips,D,CHI,23,0,0,0,0
23,8480727,Zach Whitecloud,D,VGK,28,0,0,0,0
23,8479346,Dillon Dube,C,,26,0,0,0,0
23,8480821,Filip Zadina,R,,25,0,0,0,0
23,8480001,Urho Vaakanainen,D,ANA,25,0,0,0,0
23,8470966,Mark Giordano,D,,41,0,0,0,0
23,8480853,Liam Foudy,C,,24,0,0,0,0
23,8475225,Craig Smith,C,CHI,35,0,0,0,0
23,8479972,Mason Shaw,C,WPG,26,0,0,0,0
23,8478451,Ethan Bear,D,WSH,27,0,0,0,0
23,8474040,Sam Gagner,C,,35,0,0,0,0
23,8480196,Jacob Bryson,D,BUF,27,0,0,0,0
23,8479984,Cal Foote,D,,26,0,0,0,0
23,8480011,Klim Kostin,C,SJS,25,0,0,0,0
23,8482176,Wyatt Kaiser,D,CHI,22,0,0,0,0
23,8476988,Matt Benning,D,SJS,30,0,0,0,0
23,8479370,Tyson Jost,C,CAR,26,0,0,0,0
23,8477464,Nic Petan,C,,29,0,0,0,0
23,8477380,Jonny Brodzinski,C,NYR,31,0,0,0,0
23,8480070,Ian Mitchell,D,BOS,25,0,0,0,0
23,8479315,Joey Anderson,R,CHI,26,0,0,0,0
23,8478099,Kevin Labanc,R,,29,0,0,0,0
23,8476874,Olli Maatta,D,DET,30,0,0,0,0
23,8475208,Brian Dumoulin,D,ANA,33,0,0,0,0
23,8478430,Oliver Kylington,D,,27,0,0,0,0
23,8479536,Axel Jonsson-Fjallby,L,WPG,26,0,0,0,0
23,8479671,Mathieu Olivier,R,CBJ,27,0,0,0,0
23,8471709,Marc-Edouard Vlasic,D,SJS,37,0,0,0,0
23,8479328,Julien Gauthier,R,NYI,27,0,0,0,0
23,8478421,A.J. Greer,L,FLA,28,0,0,0,0
23,8477573,Nathan Walker,L,STL,30,0,0,0,0
23,8481537,Nikita Okhotiuk,D,CGY,24,0,0,0,0
23,8474166,Alec Martinez,D,CHI,37,0,0,0,0
23,8470610,Zach Parise,L,,40,0,0,0,0
23,8477478,William Carrier,L,CAR,30,0,0,0,0
23,8479344,Jesse Puljujarvi,R,PIT,26,0,0,0,0
23,8480887,Jordan Harris,D,MTL,24,0,0,0,0
23,8478502,Dennis Gilbert,D,BUF,28,0,0,0,0
23,8482730,Brandt Clarke,D,LAK,21,0,0,0,0
23,8480355,Mark Kastelic,C,BOS,25,0,0,0,0
23,8475750,Jon Merrill,D,MIN,32,0,0,0,0
23,8475164,Jakob Silfverberg,R,,34,0,0,0,0
23,8477944,Jakub Vrana,L,,28,0,0,0,0
23,8479439,Jacob MacDonald,D,COL,31,0,0,0,0
23,8474568,Luke Schenn,D,NSH,35,0,0,0,0
23,8478454,Noah Juulsen,D,VAN,27,0,0,0,0
23,8475752,Tyler Pitlick,C,,33,0,0,0,0
23,8482148,Hendrix Lapierre,C,WSH,22,0,0,0,0
23,8481167,Brayden Pachal,D,CGY,25,0,0,0,0
23,8478043,Sam Lafferty,C,BUF,29,0,0,0,0
23,8479321,Lucas Johansen,D,,27,0,0,0,0
23,8471699,Andrew Cogliano,C,,37,0,0,0,0
23,8481521,Ronnie Attard,D,PHI,25,0,0,0,0
23,8481161,Jake Christiansen,D,CBJ,25,0,0,0,0
23,8479458,Nikita Zaitsev,D,,33,0,0,0,0
23,8479619,Michael Carcone,L,UTA,28,0,0,0,0
23,8479026,Philippe Myers,D,TOR,27,0,0,0,0
23,8477330,Dominik Kubalik,L,,29,0,0,0,0
23,8481617,Vasily Podkolzin,R,VAN,23,0,0,0,0
23,8481701,Santeri Hatakka,D,NJD,23,0,0,0,0
23,8479514,Rem Pitlick,C,,27,0,0,0,0
23,8477446,Michael McCarron,R,NSH,29,0,0,0,0
23,8470604,Jeff Carter,C,,39,0,0,0,0
23,8482241,Radim Zohorna,L,,28,0,0,0,0
23,8480289,Morgan Barron,C,WPG,26,0,0,0,0
23,8479379,Givani Smith,R,SJS,26,0,0,0,0
23,8480216,Jacob Peterson,C,,25,0,0,0,0
23,8477851,Jordan Oesterle,D,BOS,32,0,0,0,0
23,8484258,Sam Malinski,D,COL,26,0,0,0,0
23,8478904,Steven Lorentz,C,,28,0,0,0,0
23,8482095,Tyler Kleven,D,OTT,22,0,0,0,0
23,8480848,Ty Dellandrea,C,SJS,24,0,0,0,0
23,8476884,Derrick Pouliot,D,,30,0,0,0,0
23,8479336,Carl Grundstrom,R,SJS,27,0,0,0,0
23,8482964,Arber Xhekaj,D,MTL,23,0,0,0,0
23,8471686,Marc Staal,D,,37,0,0,0,0
23,8477887,Patrick Brown,C,BOS,32,0,0,0,0
23,8478495,Denis Gurianov,R,,27,0,0,0,0
23,8473504,Cal Clutterbuck,R,,37,0,0,0,0
23,8481550,Adam Beckman,L,NJD,23,0,0,0,0
23,8480845,Rasmus Kupari,C,WPG,24,0,0,0,0
23,8474009,Nick Bonino,C,,36,0,0,0,0
23,8478585,Derek Ryan,C,EDM,38,0,0,0,0
23,8477962,Brendan Lemieux,L,CAR,28,0,0,0,0
23,8482861,Vincent Iorio,D,WSH,22,0,0,0,0
23,8479378,Logan Stanley,D,WPG,26,0,0,0,0
23,8473446,Erik Johnson,D,PHI,36,0,0,0,0
23,8481743,Marc Del Gaizo,D,NSH,25,0,0,0,0
23,8477384,Josh Brown,D,EDM,30,0,0,0,0
23,8482165,Yan Kuznetsov,D,CGY,22,0,0,0,0
23,8478424,Jansen Harkins,C,ANA,27,0,0,0,0
23,8482144,Jack Thompson,D,SJS,22,0,0,0,0
23,8478512,Austin Czarnik,C,,32,0,0,0,0
23,8477527,Ross Johnston,L,ANA,30,0,0,0,0
23,8479383,Boris Katchouk,L,,26,0,0,0,0
23,8482094,Daemon Hunt,D,MIN,22,0,0,0,0
23,8481719,Maxwell Crozier,D,TBL,24,0,0,0,0
23,8480192,Johnathan Kovacevic,D,NJD,27,0,0,0,0
23,8479376,Victor Mete,D,,26,0,0,0,0
23,8482511,Mason Lohrei,D,BOS,23,0,0,0,0
23,8475825,Jani Hakanpää,D,,32,0,0,0,0
23,8478021,William Lagesson,D,DET,28,0,0,0,0
23,8475795,Dylan McIlrath,D,WSH,32,0,0,0,0
23,8477846,Ryan Carpenter,C,,33,0,0,0,0
23,8481056,Spencer Stastney,D,NSH,24,0,0,0,0
23,8481564,Ryan Johnson,D,BUF,23,0,0,0,0
23,8478017,Mark Friedman,D,VAN,29,0,0,0,0
23,8479320,Max Lajoie,D,SEA,27,0,0,0,0
23,8480075,Cameron Crotty,D,MIN,25,0,0,0,0
23,8484287,Cole McWard,D,VAN,23,0,0,0,0
23,8484254,Akito Hirose,D,VAN,25,0,0,0,0
23,8483407,Brandon Scanlin,D,NYR,25,0,0,0,0
23,8480274,Philip Kemp,D,EDM,25,0,0,0,0
23,8479522,Hardy Haman Aktell,D,WSH,26,0,0,0,0
23,8480007,Jonas Rondbjerg,R,VGK,25,0,0,0,0
23,8477454,Adam Erne,L,,29,0,0,0,0
23,8481679,Maxence Guenette,D,OTT,23,0,0,0,0
23,8480441,Trey Fix-Wolansky,R,CBJ,25,0,0,0,0
23,8483546,Marshall Rifai,D,TOR,26,0,0,0,0
23,8480084,Nick DeSimone,D,NJD,30,0,0,0,0
23,8481030,Jack St. Ivany,D,PIT,25,0,0,0,0
23,8481592,Jakob Pelletier,L,CGY,23,0,0,0,0
23,8478011,Louie Belpedio,D,PHI,28,0,0,0,0
23,8477930,Pierre-Edouard Bellemare,L,,39,0,0,0,0
23,8484321,Nikolas Matinpalo,D,OTT,26,0,0,0,0
23,8482067,Connor Mackey,D,NYR,28,0,0,0,0
23,8481806,Louis Crevier,D,CHI,23,0,0,0,0
23,8484326,Patrik Koch,D,UTA,28,0,0,0,0
23,8477971,Andreas Englund,D,LAK,28,0,0,0,0
23,8481751,Lukas Rousek,R,BUF,25,0,0,0,0
23,8481006,Tyler Tucker,D,STL,24,0,0,0,0
23,8476867,Brendan Gaunce,C,MIN,30,0,0,0,0
23,8479520,Brandon Duhaime,R,WSH,27,0,0,0,0
23,8477073,Kurtis MacDermid,L,NJD,30,0,0,0,0
23,8480874,Adam Ginning,D,PHI,24,0,0,0,0
23,8477473,Justin Bailey,R,SJS,29,0,0,0,0
23,8479066,Ryan Lomberg,L,CGY,30,0,0,0,0
23,8477070,Liam O'Brien,C,UTA,30,0,0,0,0
23,8474618,Marco Scandella,D,,34,0,0,0,0
23,8475797,Jarred Tinordi,D,,32,0,0,0,0
23,8481441,Joe Snively,C,DET,28,0,0,0,0
23,8477244,Chad Ruhwedel,D,NYR,34,0,0,0,0
23,8479772,Zack MacEwen,R,OTT,28,0,0,0,0
23,8481147,Reese Johnson,C,MIN,26,0,0,0,0
23,8481043,Cole Koepke,L,BOS,26,0,0,0,0
23,8483619,Filip Roos,D,OTT,25,0,0,0,0
23,8481541,Samuel Bolduc,D,NYI,24,0,0,0,0
23,8477810,Joel Hanley,D,CGY,33,0,0,0,0
23,8476907,Mackenzie MacEachern,L,,30,0,0,0,0
23,8482652,Walker Duehr,R,CGY,27,0,0,0,0
23,8477126,Jayson Megna,C,,34,0,0,0,0
23,8483398,Declan Carlile,D,TBL,31,0,0,0,0
23,8482929,Emil Lilleberg,D,TBL,23,0,0,0,0
23,8480880,Jakub Lauko,C,MIN,24,0,0,0,0
23,8480245,Olle Lycksell,R,PHI,25,0,0,0,0
23,8480252,Cole Guttman,C,CHI,25,0,0,0,0
23,8477467,Gustav Olofsson,D,SEA,30,0,0,0,0
23,8479968,Vinni Lettieri,C,BOS,29,0,0,0,0
23,8478400,Colin White,C,,27,0,0,0,0
23,8475755,Alexander Petrovic,D,DAL,32,0,0,0,0
23,8481812,Nikolai Knyzhov,D,,27,0,0,0,0
23,8481593,Jayden Struble,D,MTL,23,0,0,0,0
23,8481532,Alex Turcotte,C,LAK,23,0,0,0,0
23,8482126,Emil Andrae,D,PHI,31,0,0,0,0
23,8479944,Zach Aston-Reese,C,VGK,30,0,0,0,0
23,8471817,Ryan Reaves,R,TOR,37,0,0,0,0
23,8481206,John Ludvig,D,PIT,24,0,0,0,0
23,8481599,Victor Soderstrom,D,UTA,23,0,0,0,0
23,8480292,Carson Meyer,R,ANA,27,0,0,0,0
23,8482496,Nils Aman,C,VAN,24,0,0,0,0
23,8479718,Alex Barré-Boulet,C,MTL,27,0,0,0,0
23,8479994,Jaret Anderson-Dolan,C,WPG,25,0,0,0,0
23,8480184,Gustav Lindstrom,D,,26,0,0,0,0
23,8480890,Jan Jenik,R,OTT,24,0,0,0,0
23,8478067,Oskar Lindblom,L,,28,0,0,0,0
23,8476934,Brock McGinn,L,ANA,30,0,0,0,0
23,8479985,Cale Fleury,D,SEA,26,0,0,0,0
23,8484304,Uvis Balinskis,D,FLA,28,0,0,0,0
23,8479981,Jonah Gadjovich,L,FLA,26,0,0,0,0
23,8481716,Dmitri Voronkov,L,CBJ,24,0,0,0,0
23,8474709,Matt Martin,L,,35,0,0,0,0
23,8482634,Alex Steeves,C,TOR,25,0,0,0,0
23,8480823,Alexander Alexeyev,D,WSH,25,0,0,0,0
23,8477541,Dakota Mermis,D,TOR,30,0,0,0,0
23,8483491,Ivan Miroshnichenko,L,WSH,20,0,0,0,0
23,8478477,Mitchell Stephens,C,SEA,27,0,0,0,0
23,8481543,Nikita Alexandrov,C,STL,24,0,0,0,0
23,8479423,Alex Nylander,L,,26,0,0,0,0
23,8482451,Mikael Pyyhtia,L,CBJ,23,0,0,0,0
23,8478831,Kevin Stenlund,C,UTA,28,0,0,0,0
23,8480306,Grant Hutton,D,NYI,29,0,0,0,0
23,8478028,Fredrik Olofsson,L,,28,0,0,0,0
23,8477462,Robert Hagg,D,VGK,29,0,0,0,0
23,8477320,Anton Blidh,L,NYR,29,0,0,0,0
23,8482157,Will Cuylle,L,NYR,22,0,0,0,0
23,8482737,Zack Bolduc,C,STL,21,0,0,0,0
23,8481239,Samuel Fagemo,L,,24,0,0,0,0
23,8481600,Tobias Bjornfot,D,FLA,23,0,0,0,0
23,8478409,Anthony Richard,C,PHI,28,0,0,0,0
23,8474145,Robert Bortuzzo,D,,35,0,0,0,0
23,8475958,Michael Sgarbossa,C,WSH,32,0,0,0,0
23,8479986,Kole Lind,R,DAL,26,0,0,0,0
23,8479249,Andrew Poturalski,C,SJS,30,0,0,0,0
23,8479362,Riley Tufte,L,BOS,26,0,0,0,0
23,8479991,Jake Leschyshyn,C,NYR,25,0,0,0,0
23,8479587,Rhett Gardner,C,PHI,28,0,0,0,0
23,8482744,James Malatesta,L,CBJ,21,0,0,0,0
23,8478854,Ryan Shea,D,PIT,27,0,0,0,0
23,8481591,Sam Poulin,R,,23,0,0,0,0
23,8483512,Matt Savoie,C,EDM,20,0,0,0,0
23,8482102,Vasily Ponomarev,C,PIT,22,0,0,0,0
23,8482162,Roby Jarventie,L,EDM,22,0,0,0,0
23,8481016,Ruslan Iskhakov,C,,24,0,0,0,0
23,8482172,Landon Slaggert,L,CHI,22,0,0,0,0
23,8482747,Brennan Othmann,L,NYR,21,0,0,0,0
23,8480031,Maxime Comtois,L,,25,0,0,0,0
23,8480226,Marián Studenic,R,,26,0,0,0,0
23,8478408,Travis Dermott,D,,28,0,0,0,0
23,8481518,Nolan Foote,L,NJD,24,0,0,0,0
23,8479419,Brett Murray,L,BUF,26,0,0,0,0
23,8482088,Justin Sourdif,R,FLA,22,0,0,0,0
23,8482201,Gage Goncalves,C,TBL,23,0,0,0,0
23,8481578,Graeme Clarke,R,MIN,23,0,0,0,0
23,8482177,Marat Khusnutdinov,C,MIN,22,0,0,0,0
23,8481754,Nikita Nesterenko,C,ANA,23,0,0,0,0
23,8483531,Brian Halonen,L,NJD,25,0,0,0,0
23,8483920,Pierrick Dube,R,WSH,23,0,0,0,0
23,8480851,Akil Thomas,C,LAK,24,0,0,0,0
23,8475235,Nicolas Deslauriers,L,PHI,33,0,0,0,0
23,8482476,Emil Heineman,L,MTL,23,0,0,0,0
23,8477149,Scott Sabourin,R,SJS,32,0,0,0,0
23,8483549,Lucas Condotta,L,MTL,27,0,0,0,0
23,8482765,Isak Rosen,R,BUF,21,0,0,0,0
23,8481237,Kyle MacLean,C,NYI,25,0,0,0,0
23,8481024,Linus Karlsson,C,VAN,25,0,0,0,0
23,8481690,Tyler Angle,C,,24,0,0,0,0
23,8483570,Ben Meyers,C,SEA,26,0,0,0,0
23,8481655,Cole Schwindt,R,CGY,23,0,0,0,0
23,8481462,Mason Morelli,L,VGK,28,0,0,0,0
23,8483401,Marc Johnstone,R,PIT,28,0,0,0,0
23,8478956,Samuel Laberge,L,NJD,27,0,0,0,0
23,8479533,Joona Koppanen,L,,26,0,0,0,0
23,8482197,Adam Raska,R,MIN,23,0,0,0,0
23,8482250,Callahan Burke,C,VGK,27,0,0,0,0
23,8482784,Zach Dean,C,STL,21,0,0,0,0
23,8484255,Jason Polin,R,COL,25,0,0,0,0
23,8481077,John Leonard,L,,26,0,0,0,0
23,8481534,Raphael Lavoie,C,EDM,24,0,0,0,0
23,8483609,Adam Klapka,R,CGY,24,0,0,0,0
23,8482751,Ryan Winterton,C,SEA,21,0,0,0,0
23,8480267,Sammy Walker,C,MIN,25,0,0,0,0
23,8475766,Austin Watson,L,,32,0,0,0,0
23,8482460,Matt Rempe,C,NYR,22,0,0,0,0
23,8481065,Angus Crookshank,L,OTT,25,0,0,0,0
23,8481070,Hugh McGing,L,,26,0,0,0,0
23,8476323,Max McCormick,L,SEA,32,0,0,0,0
23,8483395,Arshdeep Bains,L,VAN,23,0,0,0,0
23,8484259,Ondrej Pavel,C,COL,31,0,0,0,0
23,8483432,Luca Del Bel Belluz,C,CBJ,31,0,0,0,0
23,8483045,Cameron Butler,R,CBJ,31,0,0,0,0
23,8482061,Brandon Biro,L,SEA,26,0,0,0,0
23,8477401,John Hayden,C,SEA,29,0,0,0,0
23,8475278,Byron Froese,C,,33,0,0,0,0
23,8478446,Glenn Gawdin,C,LAK,27,0,0,0,0
23,8477993,Justin Kirkland,C,CGY,28,0,0,0,0
23,8482147,Jean-Luc Foudy,C,COL,22,0,0,0,0
23,8480032,Shane Bowers,C,NJD,25,0,0,0,0
23,8479330,Brandon Gignac,C,MTL,27,0,0,0,0
23,8480776,Sheldon Rempal,R,,29,0,0,0,0
23,8475413,Justin Dowling,C,NJD,34,0,0,0,0
23,8481726,Adam Edstrom,C,NYR,24,0,0,0,0
23,8480844,Grigori Denisenko,L,VGK,24,0,0,0,0
23,8478147,Bokondji Imama,L,PIT,28,0,0,0,0
23,8478881,Brett Seney,L,CHI,28,0,0,0,0
23,8483630,Pavol Regenda,L,ANA,25,0,0,0,0
23,8480836,Jonathan Gruden,C,,24,0,0,0,0
23,8484314,Jiri Smejkal,L,,28,0,0,0,0
23,8475780,Chris Wagner,R,COL,33,0,0,0,0
23,8479546,Oskar Steen,C,,26,0,0,0,0
23,8483597,Milos Kelemen,L,UTA,25,0,0,0,0
23,8481789,Tye Kartye,L,SEA,23,0,0,0,0
23,8484325,Waltteri Merela,C,TBL,26,0,0,0,0
23,8479421,Jacob Moverare,D,LAK,26,0,0,0,0
23,8481585,Egor Afanasyev,L,SJS,23,0,0,0,0
23,8479547,Matthew Phillips,R,,26,0,0,0,0
23,8479367,William Lockwood,R,FLA,26,0,0,0,0
23,8476915,Jujhar Khaira,L,,30,0,0,0,0
23,8481422,Jacob Lucchini,C,NSH,29,0,0,0,0
23,8480468,James Hamblin,L,EDM,25,0,0,0,0
23,8478051,Max Willman,C,NJD,29,0,0,0,0
23,8481556,John Beecher,C,BOS,23,0,0,0,0
23,8478078,Rourke Chartier,C,,28,0,0,0,0
24,8478402,Connor McDavid,C,EDM,27,82,48,109,157
24,8476453,Nikita Kucherov,R,TBL,31,82,37,98,135
24,8479318,Auston Matthews,C,TOR,27,82,78,48,126
24,8480027,Jason Robertson,L,DAL,25,82,44,76,120
24,8481559,Jack Hughes,C,NJD,23,82,51,67,118
24,8477946,Dylan Larkin,C,DET,28,82,58,55,113
24,8477492,Nathan MacKinnon,C,COL,29,82,38,73,111
24,8477493,Aleksander Barkov,C,FLA,29,82,35,76,111
24,8478445,Mathew Barzal,C,NYI,27,82,28,83,111
24,8478420,Mikko Rantanen,R,COL,28,82,49,60,109
24,8471675,Sidney Crosby,C,PIT,37,82,50,58,108
24,8480012,Elias Pettersson,C,VAN,26,82,44,63,107
24,8478864,Kirill Kaprizov,L,MIN,27,82,39,68,107
24,8477939,William Nylander,R,TOR,28,82,38,68,106
24,8476468,J.T. Miller,C,VAN,31,82,40,65,105
24,8478550,Artemi Panarin,L,NYR,33,82,34,71,105
24,8478010,Brayden Point,C,TBL,28,82,62,42,104
24,8477956,David Pastrnak,R,BOS,28,82,53,46,99
24,8479314,Matthew Tkachuk,L,FLA,27,82,33,64,97
24,8477934,Leon Draisaitl,C,EDM,29,82,39,56,95
24,8478398,Kyle Connor,L,WPG,28,82,39,56,95
24,8478403,Jack Eichel,C,VGK,28,82,50,44,94
24,8476887,Filip Forsberg,L,NSH,30,82,39,54,93
24,8477409,Carter Verhaeghe,C,FLA,29,82,45,47,92
24,8475172,Nazem Kadri,C,CGY,34,82,41,50,91
24,8474564,Steven Stamkos,C,NSH,34,82,40,51,91
24,8476459,Mika Zibanejad,C,NYR,31,82,35,55,90
24,8480830,Andrei Svechnikov,R,CAR,24,82,30,60,90
24,8479407,Jesper Bratt,L,NJD,26,82,32,57,89
24,8475913,Mark Stone,R,VGK,32,82,31,58,89
24,8480023,Robert Thomas,C,STL,25,82,28,61,89
24,8477501,Valeri Nichushkin,R,COL,29,82,42,46,88
24,8478439,Travis Konecny,R,PHI,27,82,34,54,88
24,8476346,Johnny Gaudreau,L,CBJ,31,82,25,63,88
24,8474600,Roman Josi,D,NSH,34,82,18,70,88
24,8477933,Sam Reinhart,C,FLA,29,82,41,46,87
24,8480800,Quinn Hughes,D,VAN,25,82,13,74,87
24,8479343,Clayton Keller,R,UTA,26,82,42,44,86
24,8479323,Adam Fox,D,NYR,26,82,14,71,85
24,8481557,Matt Boldy,L,MIN,23,82,33,51,84
24,8475765,Vladimir Tarasenko,R,DET,33,82,31,53,84
24,8475692,Mats Zuccarello,R,MIN,37,82,19,65,84
24,8480069,Cale Makar,D,COL,26,82,21,62,83
24,8477447,Shea Theodore,D,VGK,29,82,19,64,83
24,8480036,Miro Heiskanen,D,DAL,25,82,17,65,82
24,8478427,Sebastian Aho,C,CAR,27,82,33,48,81
24,8477942,Kevin Fiala,L,LAK,28,82,26,55,81
24,8471214,Alex Ovechkin,L,WSH,39,82,40,40,80
24,8481523,Kirby Dach,C,MTL,23,82,21,59,80
24,8476460,Mark Scheifele,C,WPG,31,82,38,41,79
24,8477404,Jake Guentzel,C,TBL,30,82,32,47,79
24,8477935,Sam Bennett,C,FLA,28,82,31,47,78
24,8482116,Tim Stützle,C,OTT,22,82,24,54,78
24,8478460,Zach Werenski,D,CBJ,27,82,19,59,78
24,8474590,John Carlson,D,WSH,34,82,14,64,78
24,8481068,Yegor Sharangovich,C,CGY,26,82,46,31,77
24,8479420,Tage Thompson,C,BUF,27,82,44,33,77
24,8479337,Alex DeBrincat,R,DET,27,82,33,44,77
24,8477402,Pavel Buchnevich,L,STL,29,82,29,48,77
24,8476454,Ryan Nugent-Hopkins,C,EDM,31,82,25,52,77
24,8474578,Erik Karlsson,D,PIT,34,82,12,65,77
24,8473419,Brad Marchand,L,BOS,36,82,31,45,76
24,8480018,Nick Suzuki,C,MTL,25,82,29,46,75
24,8474141,Patrick Kane,R,DET,36,82,25,50,75
24,8475158,Ryan O'Reilly,C,NSH,33,82,25,50,75
24,8477500,Bo Horvat,C,NYI,29,82,45,29,74
24,8475184,Chris Kreider,L,NYR,33,82,51,22,73
24,8478444,Brock Boeser,R,VAN,27,82,38,35,73
24,8475168,Matt Duchene,C,DAL,33,82,34,39,73
24,8482684,Luke Hughes,D,NJD,21,82,15,58,73
24,8478449,Roope Hintz,C,DAL,28,82,33,39,72
24,8475754,Brock Nelson,C,NYI,33,82,29,43,72
24,8471215,Evgeni Malkin,C,PIT,38,82,28,44,72
24,8480002,Nico Hischier,C,NJD,25,82,23,49,72
24,8471724,Kris Letang,D,PIT,37,82,11,61,72
24,8478493,Joel Eriksson Ek,C,MIN,27,82,30,41,71
24,8480208,Drake Batherson,R,OTT,26,82,25,46,71
24,8479385,Jordan Kyrou,C,STL,26,82,34,36,70
24,8478975,Mason Marchment,L,DAL,29,82,27,43,70
24,8477949,Alex Tuch,R,BUF,28,82,27,43,70
24,8475798,Mikael Granlund,C,SJS,32,82,20,50,70
24,8481533,Trevor Zegras,C,ANA,23,82,27,42,69
24,8471685,Anze Kopitar,C,LAK,37,82,25,44,69
24,8479542,Brandon Hagel,L,TBL,26,82,29,39,68
24,8476456,Jonathan Huberdeau,C,CGY,31,82,12,56,68
24,8479339,Patrik Laine,L,CBJ,26,82,40,27,67
24,8478414,Timo Meier,R,NJD,28,82,36,31,67
24,8482093,Seth Jarvis,C,CAR,22,82,31,36,67
24,8477955,Jared McCann,L,SEA,28,82,31,36,67
24,8480801,Brady Tkachuk,L,OTT,25,82,29,38,67
24,8477951,Nick Schmaltz,C,UTA,28,82,22,45,67
24,8474150,Mikael Backlund,C,CGY,35,82,21,46,67
24,8475786,Zach Hyman,L,EDM,32,82,36,30,66
24,8477496,Elias Lindholm,C,BOS,30,82,35,31,66
24,8479675,Trevor Moore,L,LAK,29,82,29,37,66
24,8478440,Dylan Strome,C,WSH,27,82,26,40,66
24,8476875,Mike Matheson,D,MTL,30,82,16,50,66
24,8475167,Victor Hedman,D,TBL,34,82,13,53,66
24,8480014,Gabriel Vilardi,C,WPG,25,82,35,30,65
24,8473986,Alex Killorn,L,ANA,35,82,28,37,65
24,8476389,Vincent Trocheck,C,NYR,31,82,24,41,65
24,8475166,John Tavares,C,TOR,34,82,18,47,65
24,8477504,Josh Morrissey,D,WPG,29,82,13,52,65
24,8475794,Tyler Seguin,C,DAL,32,82,30,34,64
24,8482109,Alexis Lafrenière,L,NYR,23,82,29,35,64
24,8477940,Nikolaj Ehlers,L,WPG,28,82,28,36,64
24,8478366,Frank Vatrano,R,ANA,30,82,28,36,64
24,8477497,Sean Monahan,C,CBJ,30,82,20,44,64
24,8482665,Matty Beniers,C,SEA,22,82,20,44,64
24,8476462,Dougie Hamilton,D,NJD,31,82,19,45,64
24,8480865,Noah Dobson,D,NYI,24,82,13,51,64
24,8474586,Jordan Eberle,R,SEA,34,82,24,39,63
24,8477986,Brandon Montour,D,SEA,30,82,23,40,63
24,8475810,Bryan Rust,R,PIT,32,82,34,28,62
24,8480064,Josh Norris,C,OTT,25,82,34,28,62
24,8480039,Martin Necas,C,CAR,25,82,28,34,62
24,8478042,Viktor Arvidsson,R,EDM,31,82,27,35,62
24,8477960,Adrian Kempe,R,LAK,28,82,27,35,62
24,8475784,Jeff Skinner,C,EDM,32,82,25,37,62
24,8474679,Gustav Nyquist,C,NSH,35,82,16,46,62
24,8478396,Noah Hanifin,D,VGK,27,82,9,53,62
24,8478873,Troy Terry,R,ANA,27,82,25,36,61
24,8478401,Pavel Zacha,C,BOS,27,82,22,39,61
24,8478469,Thomas Chabot,D,OTT,27,82,20,41,61
24,8476905,Chandler Stephenson,C,SEA,30,82,13,48,61
24,8476853,Morgan Rielly,D,TOR,30,82,6,55,61
24,8475726,Tyler Toffoli,C,SJS,32,82,32,28,60
24,8477416,Oliver Bjorkstrand,R,SEA,29,82,29,31,60
24,8475191,Reilly Smith,R,NYR,33,82,27,33,60
24,8480188,Fabian Zetterlund,L,SJS,25,82,26,34,60
24,8474102,David Perron,L,OTT,36,82,24,36,60
24,8476869,Brady Skjei,D,NSH,30,82,16,44,60
24,8478397,Rasmus Andersson,D,CGY,28,82,9,51,60
24,8476432,Boone Jenner,C,CBJ,31,82,35,24,59
24,8481528,Dylan Cozens,C,BUF,23,82,29,30,59
24,8475169,Evander Kane,L,EDM,33,82,29,30,59
24,8477444,Andre Burakovsky,L,SEA,29,82,26,33,59
24,8478438,Tommy Novak,C,NSH,27,82,24,35,59
24,8480839,Rasmus Dahlin,D,BUF,24,82,19,40,59
24,8482149,Cole Perfetti,C,WPG,22,82,16,43,59
24,8482078,Lucas Raymond,L,DET,22,82,25,33,58
24,8473994,Jamie Benn,L,DAL,35,82,21,37,58
24,8481711,Matias Maccelli,L,UTA,24,82,15,43,58
24,8479425,Filip Hronek,D,VAN,27,82,7,51,58
24,8481540,Cole Caufield,R,MTL,23,82,28,29,57
24,8478519,Anthony Cirelli,C,TBL,27,82,27,30,57
24,8476881,Tomas Hertl,C,VGK,31,82,23,34,57
24,8478407,Vince Dunn,D,SEA,28,82,20,37,57
24,8475314,Anders Lee,L,NYI,34,82,36,20,56
24,8482124,Quinton Byfield,R,LAK,22,82,30,26,56
24,8481596,Shane Pinto,C,OTT,24,82,28,28,56
24,8478047,Michael Bunting,L,PIT,29,82,23,33,56
24,8476448,William Karlsson,C,VGK,31,82,17,39,56
24,8477511,Anthony Mantha,R,CGY,30,82,29,26,55
24,8482159,Tyson Foerster,R,PHI,22,82,28,27,55
24,8477451,Ryan Hartman,R,MIN,30,82,26,29,55
24,8482745,Mason McTavish,C,ANA,21,82,26,29,55
24,8480078,Filip Chytil,C,NYR,25,82,21,34,55
24,8476882,Teuvo Teravainen,L,CHI,30,82,19,36,55
24,8481604,Pavel Dorofeyev,L,VGK,24,82,29,25,54
24,8476399,Blake Coleman,C,CGY,33,82,27,27,54
24,8479400,Pierre-Luc Dubois,L,WSH,26,82,27,27,54
24,8480015,Owen Tippett,R,PHI,25,82,26,28,54
24,8475170,Brayden Schenn,C,STL,33,82,24,30,54
24,8477476,Artturi Lehkonen,L,COL,29,82,24,30,54
24,8475287,Erik Haula,L,NJD,33,82,20,34,54
24,8478458,Jack Roslovic,C,CAR,27,82,19,35,54
24,8477479,Tyler Bertuzzi,L,CHI,29,82,18,36,54
24,8479325,Charlie McAvoy,D,BOS,27,82,7,47,54
24,8478046,Danton Heinen,L,VAN,29,82,28,25,53
24,8475791,Taylor Hall,L,CHI,33,82,27,26,53
24,8477407,Anthony Duclair,L,NYI,29,82,22,31,53
24,8480798,Philipp Kurashev,C,CHI,25,82,19,34,53
24,8480797,Joel Farabee,L,PHI,24,82,18,35,53
24,8473512,Claude Giroux,R,OTT,36,82,16,37,53
24,8478856,Conor Garland,R,VAN,28,82,16,37,53
24,8471698,T.J. Oshie,R,WSH,38,82,29,23,52
24,8482740,Wyatt Johnston,C,DAL,21,82,25,27,52
24,8482113,Anton Lundell,C,FLA,23,82,23,29,52
24,8476479,Phillip Danault,C,LAK,31,82,21,31,52
24,8477456,J.T. Compher,L,DET,29,82,18,34,52
24,8482699,Dylan Guenther,R,UTA,21,82,22,29,51
24,8476539,Jonathan Marchessault,R,NSH,34,82,31,19,50
24,8474641,Adam Henrique,C,EDM,34,82,24,26,50
24,8475714,Calle Jarnkrok,C,TOR,33,82,24,26,50
24,8482705,Cole Sillinger,C,CBJ,21,82,23,27,50
24,8480829,Jesperi Kotkaniemi,C,CAR,24,82,16,34,50
24,8480871,Adam Boqvist,D,FLA,24,82,16,34,50
24,8477346,MacKenzie Weegar,D,CGY,30,82,13,37,50
24,8475745,Charlie Coyle,C,BOS,32,82,11,39,50
24,8474565,Alex Pietrangelo,D,VGK,34,82,11,39,50
24,8482146,Luke Evangelista,R,NSH,22,82,26,23,49
24,8480009,Eeli Tolvanen,R,SEA,25,82,22,27,49
24,8481618,Alex Newhook,C,MTL,23,82,20,29,49
24,8480434,Sean Durzi,D,UTA,26,82,19,30,49
24,8477503,Max Domi,C,TOR,29,82,14,35,49
24,8480803,Evan Bouchard,D,EDM,25,82,7,42,49
24,8478498,Jake DeBrusk,L,VAN,28,82,32,16,48
24,8475799,Nino Niederreiter,R,WPG,32,82,29,19,48
24,8476461,Sean Couturier,C,PHI,32,82,23,25,48
24,8475763,Kevin Hayes,R,PIT,32,82,22,26,48
24,8479987,Morgan Geekie,C,BOS,26,82,18,30,48
24,8478115,Pierre Engvall,L,NYI,28,82,17,31,48
24,8477932,Aaron Ekblad,D,FLA,28,82,13,35,48
24,8475764,Cam Fowler,D,ANA,33,82,9,39,48
24,8474563,Drew Doughty,D,LAK,35,82,8,40,48
24,8476923,Damon Severson,D,CBJ,30,82,4,44,48
24,8482667,William Eklund,L,SJS,22,82,21,26,47
24,8478233,Andrew Mangiapane,L,WSH,28,82,18,29,47
24,8474053,Logan Couture,C,SJS,35,82,18,29,47
24,8479999,Casey Mittelstadt,C,COL,26,82,14,33,47
24,8476826,Yanni Gourde,C,SEA,33,82,12,35,47
24,8470613,Brent Burns,D,CAR,39,82,8,39,47
24,8476392,Adam Lowry,C,WPG,31,82,16,30,46
24,8476792,Torey Krug,D,STL,33,82,8,38,46
24,8479410,Mikhail Sergachev,D,UTA,26,82,7,39,46
24,8478474,Lawson Crouse,L,UTA,27,82,27,18,45
24,8476483,Rickard Rakell,R,PIT,31,82,23,22,45
24,8476458,Ryan Strome,C,ANA,31,82,18,27,45
24,8478462,Nicolas Roy,C,VGK,27,82,17,28,45
24,8477953,Kasperi Kapanen,R,STL,28,82,16,29,45
24,8479345,Jakob Chychrun,D,WSH,26,82,14,31,45
24,8476927,Teddy Blueger,C,VAN,30,82,12,33,45
24,8478055,Gustav Forsling,D,FLA,28,82,10,35,45
24,8477495,Seth Jones,D,CHI,30,82,10,35,45
24,8483808,Andrei Kuzmenko,L,CGY,28,82,22,22,44
24,8482097,Jack Quinn,R,BUF,23,82,19,25,44
24,8476880,Tom Wilson,R,WSH,30,82,18,26,44
24,8482720,Matthew Knies,L,TOR,22,82,15,29,44
24,8475793,Ryan Johansen,C,PHI,32,82,15,29,44
24,8477021,Alex Kerfoot,C,UTA,30,82,14,30,44
24,8476885,Jacob Trouba,D,NYR,30,82,10,34,44
24,8481542,Moritz Seider,D,DET,23,82,6,38,44
24,8481546,Cam York,D,PHI,23,82,5,39,44
24,8476958,Jaccob Slavin,D,CAR,30,82,5,39,44
24,8476419,Jean-Gabriel Pageau,C,NYI,32,82,21,22,43
24,8481624,Ilya Mikheyev,R,CHI,30,82,18,25,43
24,8477964,Ivan Barbashev,C,VGK,29,82,16,27,43
24,8480028,Morgan Frost,C,PHI,25,82,15,28,43
24,8477494,Jonathan Drouin,L,COL,29,82,11,32,43
24,8480873,Rasmus Sandin,D,WSH,24,82,8,35,43
24,8482175,JJ Peterka,R,BUF,22,82,21,21,42
24,8477426,Nicholas Paul,L,TBL,29,82,17,25,42
24,8477987,Ryan Donato,C,CHI,28,82,16,26,42
24,8479351,Sam Steel,C,DAL,26,82,15,27,42
24,8482089,Jake Neighbours,L,STL,22,82,27,14,41
24,8475151,Kyle Palmieri,C,NYI,33,82,22,19,41
24,8473422,Nick Foligno,L,CHI,37,82,21,20,41
24,8474149,Evgenii Dadonov,R,DAL,35,82,20,21,41
24,8479661,Tanner Jeannot,L,LAK,27,82,20,21,41
24,8480459,Pius Suter,C,VAN,28,82,16,25,41
24,8475171,Oliver Ekman-Larsson,D,TOR,33,82,15,26,41
24,8476292,Ondrej Palat,L,NJD,33,82,14,27,41
24,8475218,Mattias Ekholm,D,EDM,34,82,12,29,41
24,8478038,Devon Toews,D,COL,30,82,12,29,41
24,8476906,Shayne Gostisbehere,D,CAR,31,82,8,33,41
24,8476979,Erik Gustafsson,D,DET,32,82,6,35,41
24,8480849,Barrett Hayton,C,UTA,24,82,23,17,40
24,8475149,Marcus Johansson,L,MIN,34,82,21,19,40
24,8481554,Kaapo Kakko,R,NYR,23,82,19,21,40
24,8476981,Josh Anderson,R,MTL,30,82,18,22,40
24,8475768,Jaden Schwartz,C,SEA,32,82,17,23,40
24,8478472,Mathieu Joseph,R,STL,27,82,16,24,40
24,8477429,Andrew Copp,C,DET,30,82,15,25,40
24,8474716,Jared Spurgeon,D,MIN,35,82,15,25,40
24,8482105,Jake Sanderson,D,OTT,22,82,12,28,40
24,8476331,Dylan DeMelo,D,WPG,31,82,4,36,40
24,8476438,Brandon Saad,L,STL,32,82,24,15,39
24,8475760,Nick Bjugstad,C,UTA,32,82,24,15,39
24,8480893,Kirill Marchenko,R,CBJ,24,82,23,16,39
24,8480336,Sean Walker,D,CAR,30,82,16,23,39
24,8476925,Colton Sissons,C,NSH,31,82,15,24,39
24,8478891,Mason Appleton,C,WPG,28,82,12,27,39
24,8482671,Owen Power,D,BUF,22,82,10,29,39
24,8480145,Neal Pionk,D,WPG,29,82,8,31,39
24,8482110,Dawson Mercer,C,NJD,23,82,21,17,38
24,8480748,Kiefer Sherwood,L,VAN,29,82,21,17,38
24,8481013,Jonatan Berggren,R,DET,24,82,18,20,38
24,8473533,Jordan Staal,C,CAR,36,82,18,20,38
24,8482092,Ridly Greig,C,OTT,22,82,17,21,38
24,8484144,Connor Bedard,C,CHI,19,82,15,23,38
24,8481581,Thomas Harley,D,DAL,23,82,11,27,38
24,8482660,Kent Johnson,C,CBJ,22,82,10,28,38
24,8475753,Justin Faulk,D,STL,32,82,8,30,38
24,8479525,Ross Colton,C,COL,28,82,20,17,37
24,8481032,Paul Cotter,C,NJD,25,82,19,18,37
24,8480185,Eetu Luostarinen,C,FLA,26,82,18,19,37
24,8480802,Ryan McLeod,C,BUF,25,82,17,20,37
24,8478057,Dakota Joshua,C,VAN,28,82,16,21,37
24,8476960,Andreas Athanasiou,C,CHI,30,82,16,21,37
24,8475200,Dmitry Orlov,D,CAR,33,82,15,22,37
24,8478463,Anthony Beauvillier,L,PIT,27,82,14,23,37
24,8477919,Frederick Gaudreau,C,MIN,31,82,10,27,37
24,8479293,Brandon Tanev,L,SEA,33,82,21,15,36
24,8482475,Yegor Chinakhov,R,CBJ,23,82,20,16,36
24,8476374,Sean Kuraly,C,CBJ,31,82,17,19,36
24,8476921,Jordan Martinook,L,CAR,32,82,15,21,36
24,8481656,Aliaksei Protas,C,WSH,23,82,13,23,36
24,8479992,Michael Rasmussen,C,DET,25,82,13,23,36
24,8476873,Mark Jankowski,C,NSH,30,82,12,24,36
24,8480043,Timothy Liljegren,D,TOR,25,82,8,28,36
24,8477969,Marcus Pettersson,D,PIT,28,82,6,30,36
24,8476872,Scott Laughton,C,PHI,30,82,18,17,35
24,8478542,Evan Rodrigues,C,FLA,31,82,15,20,35
24,8483515,Juraj Slafkovsky,L,MTL,20,82,14,21,35
24,8481481,Blake Lizotte,C,PIT,27,82,14,21,35
24,8478413,Jordan Greenway,L,BUF,27,82,14,21,35
24,8481580,Connor McMichael,C,WSH,23,82,13,22,35
24,8484166,Adam Fantilli,C,CBJ,20,82,12,23,35
24,8480113,Alex Iafallo,L,WPG,31,82,20,14,34
24,8482055,Drew O'Connor,L,PIT,26,82,19,15,34
24,8478020,Michael Amadio,C,OTT,28,82,18,16,34
24,8481704,Juuso Parssinen,C,NSH,23,82,18,16,34
24,8479353,Brett Howden,C,VGK,26,82,18,16,34
24,8473563,Nicklas Backstrom,C,WSH,37,82,13,21,34
24,8478133,Jake Evans,C,MTL,28,82,10,24,34
24,8478136,Jake Middleton,D,MIN,28,82,9,25,34
24,8481606,Jordan Spence,D,LAK,23,82,5,29,34
24,8480835,Jack Drury,C,CAR,24,82,22,11,33
24,8481560,Arthur Kaliyev,R,LAK,23,82,19,14,33
24,8481535,Nils Hoglander,L,VAN,24,82,18,15,33
24,8475193,Tomas Tatar,L,NJD,34,82,17,16,33
24,8480220,Noah Cates,L,PHI,25,82,13,20,33
24,8479591,Michael Eyssimont,C,TBL,28,82,11,22,33
24,8477989,Christian Dvorak,C,MTL,28,82,6,27,33
24,8479402,Jake Bean,D,CGY,26,82,6,27,33
24,8476917,Adam Pelech,D,NYI,30,82,4,29,33
24,8478569,Noel Acciari,C,PIT,33,82,16,16,32
24,8477998,Warren Foegele,L,LAK,28,82,11,21,32
24,8478911,Matt Roy,D,WSH,29,82,8,24,32
24,8482122,Brock Faber,D,MIN,22,82,8,24,32
24,8480817,K'Andre Miller,D,NYR,24,82,7,25,32
24,8476854,Hampus Lindholm,D,BOS,30,82,6,26,32
24,8475848,Brendan Gallagher,R,MTL,32,82,18,13,31
24,8478508,Yakov Trenin,C,MIN,27,82,17,14,31
24,8477952,Robby Fabbri,C,ANA,28,82,15,16,31
24,8479996,Cody Glass,C,NSH,25,82,14,17,31
24,8476457,Adam Larsson,D,SEA,32,82,4,27,31
24,8477506,Ryan Pulock,D,NYI,30,82,0,31,31
24,8474715,Cam Atkinson,R,TBL,35,82,19,11,30
24,8479365,Trent Frederic,C,BOS,26,82,16,14,30
24,8477425,Miles Wood,L,COL,29,82,16,14,30
24,8476474,Stefan Noesen,R,NJD,31,82,15,15,30
24,8481186,Logan O'Connor,R,COL,28,82,14,16,30
24,8480855,Jack McBain,C,UTA,24,82,14,16,30
24,8476329,Travis Boyd,C,MIN,31,82,13,17,30
24,8476897,Oskar Sundqvist,C,STL,30,82,12,18,30
24,8480796,Martin Fehervary,D,WSH,25,82,12,18,30
24,8483431,Logan Cooley,C,UTA,20,82,9,21,30
24,8476467,Jamie Oleksiak,D,SEA,32,82,7,23,30
24,8478500,Ivan Provorov,D,CBJ,27,82,4,26,30
24,8476879,Cody Ceci,D,EDM,31,82,4,26,30
24,8479398,Samuel Girard,D,COL,26,82,3,27,30
24,8480068,Ryan Poehling,C,PHI,25,82,18,11,29
24,8480813,Joe Veleno,C,DET,24,82,12,17,29
24,8479414,Nathan Bastian,R,NJD,27,82,11,18,29
24,8477839,Conor Sheary,L,TBL,32,82,10,19,29
24,8482111,Justin Barron,D,MTL,23,82,9,20,29
24,8483565,Nick Blankenburg,D,NSH,26,82,9,20,29
24,8477435,Ryan Graves,D,PIT,29,82,9,20,29
24,8480074,Alexandre Texier,C,STL,25,82,8,21,29
24,8477507,Nikita Zadorov,D,BOS,29,82,8,21,29
24,8478851,Alexandre Carrier,D,NSH,28,82,8,21,29
24,8474574,Tyler Myers,D,VAN,34,82,6,23,29
24,8475279,Ben Chiarot,D,DET,33,82,5,24,29
24,8479976,Juuso Valimaki,D,UTA,26,82,3,26,29
24,8475790,Erik Gudbranson,D,CBJ,32,82,2,27,29
24,8481582,Nicholas Robertson,L,TOR,23,82,18,10,28
24,8479393,Noah Gregor,C,OTT,26,82,14,14,28
24,8479316,Luke Kunin,C,SJS,27,82,13,15,28
24,8477947,Sonny Milano,L,WSH,28,82,12,16,28
24,8476878,Zemgus Girgensons,L,TBL,30,82,12,16,28
24,8476278,Colin Blackwell,C,DAL,31,82,11,17,28
24,8479390,Taylor Raddysh,R,WSH,26,82,11,17,28
24,8477931,Tomas Nosek,L,FLA,32,82,11,17,28
24,8475220,Marcus Foligno,L,MIN,33,82,8,20,28
24,8481708,Zac Jones,D,NYR,24,82,5,23,28
24,8479998,Mikey Anderson,D,LAK,25,82,5,23,28
24,8479371,Dante Fabbro,D,NSH,26,82,5,23,28
24,8477948,Travis Sanheim,D,PHI,28,82,4,24,28
24,8477498,Darnell Nurse,D,EDM,29,82,4,24,28
24,8482087,Kaiden Guhle,D,MTL,22,82,4,24,28
24,8476892,Colton Parayko,D,STL,31,82,3,25,28
24,8484153,Leo Carlsson,C,ANA,20,82,16,11,27
24,8478109,Victor Olofsson,L,VGK,29,82,15,12,27
24,8482079,Marco Rossi,C,MIN,23,82,15,12,27
24,8470621,Corey Perry,R,EDM,39,82,14,13,27
24,8477450,Jason Dickinson,C,CHI,29,82,13,14,27
24,8480980,Connor Dewar,C,TOR,25,82,13,14,27
24,8482133,Thomas Bordeleau,C,SJS,22,82,11,16,27
24,8480789,Oliver Wahlstrom,R,NYI,24,82,11,16,27
24,8475343,Nic Dowd,C,WSH,34,82,10,17,27
24,8482624,Daniil Miromanov,D,CGY,27,82,10,17,27
24,8478211,Dryden Hunt,L,CGY,29,82,10,17,27
24,8476480,Vladislav Namestnikov,C,WPG,32,82,9,18,27
24,8478434,Keegan Kolesar,R,VGK,27,82,7,20,27
24,8482073,Braden Schneider,D,NYR,23,82,6,21,27
24,8473507,Jeff Petry,D,DET,37,82,5,22,27
24,8476902,Esa Lindell,D,DAL,30,82,4,23,27
24,8482245,Artem Zub,D,OTT,29,82,4,23,27
24,8480222,Sebastian Aho,D,PIT,28,82,4,23,27
24,8479941,Justin Danforth,R,CBJ,31,82,17,9,26
24,8481093,Rafael Harvey-Pinard,L,MTL,25,82,15,11,26
24,8482702,Logan Stankoven,C,DAL,21,82,13,13,26
24,8479368,Max Jones,L,BOS,26,82,13,13,26
24,8482074,Connor Zary,C,CGY,23,82,12,14,26
24,8482062,Cole Smith,L,NSH,29,82,11,15,26
24,8475722,Jason Zucker,L,BUF,32,82,10,16,26
24,8476422,Mike Reilly,D,NYI,31,82,10,16,26
24,8475855,Jesper Fast,R,CAR,33,82,10,16,26
24,8483457,Lane Hutson,D,MTL,20,82,10,16,26
24,8482166,Shakir Mukhamadullin,D,SJS,22,82,9,17,26
24,8483763,Maksymilian Szuber,D,UTA,22,82,8,18,26
24,8477499,Rasmus Ristolainen,D,PHI,30,82,5,21,26
24,8478882,Vladislav Gavrikov,D,LAK,29,82,3,23,26
24,8476918,Jimmy Vesey,L,NYR,31,82,14,11,25
24,8476889,Radek Faksa,C,STL,30,82,12,13,25
24,8482749,Joshua Roy,R,MTL,21,82,12,13,25
24,8480878,Nils Lundkvist,D,DAL,24,82,10,15,25
24,8481517,Brett Leason,R,ANA,25,82,10,15,25
24,8480806,Isac Lundestrom,C,ANA,25,82,9,16,25
24,8477220,Nate Schmidt,D,FLA,33,82,8,17,25
24,8477488,Brett Pesce,D,NJD,30,82,7,18,25
24,8480246,Nick Perbix,D,TBL,26,82,6,19,25
24,8479980,Nicolas Hague,D,VGK,26,82,5,20,25
24,8482655,J.J. Moser,D,TBL,24,82,4,21,25
24,8481178,Egor Zamula,D,PHI,24,82,2,23,25
24,8481477,Nico Sturm,C,SJS,29,82,10,14,24
24,8476624,Barclay Goodrow,C,SJS,31,82,10,14,24
24,8481553,Bobby Brink,R,PHI,23,82,9,15,24
24,8482803,Olen Zellweger,D,ANA,21,82,8,16,24
24,8481601,Simon Holmstrom,R,NYI,23,82,8,16,24
24,8480003,Jesper Boqvist,C,FLA,26,82,6,18,24
24,8476463,Jonas Brodin,D,MIN,31,82,4,20,24
24,8477369,Carson Soucy,D,VAN,30,82,4,20,24
24,8481568,Alex Vlasic,D,CHI,23,82,3,21,24
24,8474673,TJ Brodie,D,CHI,34,82,3,21,24
24,8481567,Henry Thrun,D,SJS,23,82,3,21,24
24,8476931,Jake McCabe,D,TOR,31,82,2,22,24
24,8482125,Alexander Holtz,R,VGK,22,82,15,8,23
24,8478432,Christian Fischer,R,DET,27,82,13,10,23
24,8484145,Zach Benson,L,BUF,19,82,8,15,23
24,8484203,Bradly Nadeau,L,CAR,19,82,7,16,23
24,8479983,Mario Ferraro,D,SJS,26,82,6,17,23
24,8478840,Will Borgen,D,SEA,28,82,4,19,23
24,8480049,Dylan Samberg,D,WPG,25,82,3,20,23
24,8475188,Brayden McNabb,D,VGK,33,82,3,20,23
24,8475455,Brenden Dillon,D,NJD,34,82,2,21,23
24,8480950,Ilya Lyubushkin,D,DAL,30,82,2,21,23
24,8482807,Ethan Del Mastro,D,CHI,21,82,12,10,22
24,8477903,Garnet Hathaway,R,PHI,33,82,12,10,22
24,8477353,Tyler Motte,C,DET,29,82,11,11,22
24,8477508,Curtis Lazar,C,NJD,29,82,11,11,22
24,8483524,Shane Wright,C,SEA,20,82,11,11,22
24,8477392,Hudson Fasching,R,NYI,29,82,10,12,22
24,8482141,Lukas Cormier,D,VGK,22,82,10,12,22
24,8478013,Jake Walman,D,SJS,28,82,10,12,22
24,8474567,Zach Bogosian,D,MIN,34,82,8,14,22
24,8480073,Erik Brannstrom,D,COL,25,82,5,17,22
24,8476312,Josh Manson,D,COL,33,82,4,18,22
24,8479359,Beck Malenstyn,L,BUF,26,82,3,19,22
24,8478416,Erik Cernak,D,TBL,27,82,2,20,22
24,8474189,Lars Eller,C,PIT,35,82,12,9,21
24,8482117,Lukas Reichel,L,CHI,22,82,10,11,21
24,8481522,Peyton Krebs,C,BUF,23,82,8,13,21
24,8483495,Simon Nemec,D,NJD,20,82,7,14,21
24,8480990,Declan Chisholm,D,MIN,24,82,7,14,21
24,8478507,John Marino,D,UTA,27,82,4,17,21
24,8481605,Jackson LaCombe,D,ANA,23,82,4,17,21
24,8482101,Danil Gushchin,L,SJS,22,82,4,17,21
24,8476967,Brett Kulak,D,EDM,30,82,4,17,21
24,8479324,Ryan Lindgren,D,NYR,26,82,3,18,21
24,8474151,Ryan McDonagh,D,TBL,35,82,3,18,21
24,8474013,Ian Cole,D,UTA,35,82,3,18,21
24,8475324,Nick Jensen,D,OTT,34,82,1,20,21
24,8475690,Chris Tanev,D,TOR,35,82,0,21,21
24,8476469,Joel Armia,R,MTL,31,82,12,8,20
24,8480995,Pontus Holmberg,R,TOR,25,82,11,9,20
24,8482762,Simon Edvinsson,D,DET,21,82,10,10,20
24,8475231,Casey Cizikas,C,NYI,33,82,9,11,20
24,8483505,Matthew Poitras,C,BOS,20,82,9,11,20
24,8479442,Troy Stecher,D,EDM,30,82,7,13,20
24,8480834,Ty Emberson,D,SJS,24,82,7,13,20
24,8477938,Haydn Fleury,D,WPG,28,82,6,14,20
24,8480172,Jan Rutta,D,SJS,34,82,5,15,20
24,8480807,Mattias Samuelsson,D,BUF,24,82,4,16,20
24,8481014,Alexander Romanov,D,NYI,24,82,3,17,20
24,8476891,Matt Grzelcyk,D,PIT,30,82,2,18,20
24,8477365,Connor Clifton,D,BUF,29,82,2,18,20
24,8475462,Radko Gudas,D,ANA,34,82,1,19,20
24,8475842,Sam Carrick,C,NYR,32,82,11,8,19
24,8482155,Alex Laferriere,R,LAK,23,82,11,8,19
24,8482858,Ryker Evans,D,SEA,23,82,8,11,19
24,8475233,David Savard,D,MTL,34,82,5,14,19
24,8470600,Ryan Suter,D,STL,39,82,3,16,19
24,8480035,Henri Jokiharju,D,BUF,25,82,2,17,19
24,8475181,Nick Leddy,D,STL,33,82,1,18,19
24,8480281,Alexey Toropchenko,R,STL,25,82,13,5,18
24,8480448,Parker Kelly,L,COL,25,82,10,8,18
24,8482712,Oskar Olausson,R,COL,22,82,9,9,18
24,8482145,Mavrik Bourque,C,DAL,22,82,9,9,18
24,8481028,Martin Pospisil,C,CGY,25,82,8,10,18
24,8484911,Collin Graf,R,SJS,22,82,8,10,18
24,8482470,Ilya Solovyov,D,CGY,24,82,7,11,18
24,8479291,Kevin Rooney,C,CGY,31,82,7,11,18
24,8482153,Brendan Brisson,C,VGK,23,82,7,11,18
24,8477015,Connor Brown,R,EDM,30,82,6,12,18
24,8477406,Mattias Janmark,C,EDM,32,82,6,12,18
24,8476372,Nick Seeler,D,PHI,31,82,6,12,18
24,8477335,Kyle Burroughs,D,LAK,29,82,5,13,18
24,8483490,Pavel Mintyukov,D,ANA,21,82,4,14,18
24,8474612,Travis Hamonic,D,OTT,34,82,4,14,18
24,8477845,Trevor van Riemsdyk,D,WSH,33,82,3,15,18
24,8478443,Brandon Carlo,D,BOS,28,82,2,16,18
24,8481641,Joel Kiviranta,L,COL,28,82,8,9,17
24,8482659,Josh Doan,R,UTA,22,82,7,10,17
24,8479369,Andrew Peeke,D,BOS,26,82,5,12,17
24,8478468,Jeremy Lauzon,D,NSH,27,82,5,12,17
24,8478178,Darren Raddysh,D,TBL,28,82,4,13,17
24,8483445,Cutter Gauthier,L,ANA,20,82,3,14,17
24,8483493,Frank Nazar,C,CHI,20,82,7,9,16
24,8476525,Colin Miller,D,WPG,32,82,5,11,16
24,8477505,Alexander Wennberg,C,SJS,30,82,5,11,16
24,8480144,David Kampf,C,TOR,29,82,8,7,15
24,8482787,Nikita Chibrikov,R,WPG,31,82,8,7,15
24,8476442,Matt Nieto,L,PIT,32,82,7,8,15
24,8473453,Trevor Lewis,C,LAK,37,82,5,10,15
24,8475762,Derek Forbort,D,VAN,32,82,5,10,15
24,8478450,Parker Wotherspoon,D,BOS,27,82,3,12,15
24,8482516,Matthew Kessel,D,STL,24,82,3,12,15
24,8480879,Jacob Bernard-Docker,D,OTT,24,82,2,13,15
24,8476429,Scott Mayfield,D,NYI,32,82,1,14,15
24,8475718,Justin Holl,D,DET,32,82,1,14,15
24,8480021,Jack Studnicka,C,LAK,25,82,9,5,14
24,8482666,Scott Morrow,D,CAR,22,82,7,7,14
24,8480025,MacKenzie Entwistle,R,FLA,25,82,7,7,14
24,8479638,Justin Brazeau,R,BOS,26,82,7,7,14
24,8483482,Tristan Luneau,D,ANA,20,82,3,11,14
24,8483471,Brad Lambert,C,WPG,31,82,3,11,14
24,8475177,Calvin de Haan,D,COL,33,82,3,11,14
24,8482713,Mackie Samoskevich,R,FLA,22,82,3,11,14
24,8480870,Bo Groulx,C,NYR,24,82,7,6,13
24,8482259,Bobby McMann,C,TOR,28,82,6,7,13
24,8482679,Matt Coronato,R,CGY,22,82,6,7,13
24,8483499,Liam Ohgren,L,MIN,20,82,6,7,13
24,8481699,Aku Raty,R,UTA,23,82,5,8,13
24,8481524,Bowen Byram,D,BUF,23,82,4,9,13
24,8482142,Jamie Drysdale,D,PHI,22,82,2,11,13
24,8478859,Niko Mikkola,D,FLA,28,82,2,11,13
24,8476473,Connor Murphy,D,CHI,31,82,2,11,13
24,8478399,Jonas Siegenthaler,D,NJD,27,82,1,12,13
24,8477034,Jaycob Megna,D,FLA,32,82,0,13,13
24,8482077,Dylan Holloway,L,EDM,23,82,9,3,12
24,8476858,Phillip Di Giuseppe,L,VAN,31,82,9,3,12
24,8482859,Zack Ostapchuk,C,OTT,21,82,7,5,12
24,8482733,Logan Mailloux,D,MTL,31,82,6,6,12
24,8483012,Logan Morrison,C,SEA,22,82,6,6,12
24,8484149,Gavin Brindley,C,CBJ,20,82,6,6,12
24,8483468,Jiri Kulich,C,BUF,20,82,4,8,12
24,8474090,Brendan Smith,D,DAL,35,82,2,10,12
24,8482809,Jackson Blake,R,CAR,21,82,1,11,12
24,8483466,Kevin Korchinski,D,CHI,20,82,1,11,12
24,8476822,Luke Glendening,C,TBL,35,82,9,2,11
24,8483460,David Jiricek,D,CBJ,21,82,4,7,11
24,8483397,Marc McLaughlin,C,BOS,25,82,3,8,11
24,8483489,Fraser Minten,C,TOR,31,82,3,8,11
24,8476441,Joel Edmundson,D,LAK,31,82,0,11,11
24,8479576,Vincent Desharnais,D,VAN,28,82,3,7,10
24,8471677,Jack Johnson,D,CBJ,37,82,1,9,10
24,8480860,Kevin Bahl,D,CGY,24,82,0,10,10
24,8478874,Adam Gaudette,C,OTT,28,82,0,10,10
24,8482118,Sam Colangelo,R,ANA,23,82,4,5,9
24,8482070,Mitchell Chaffee,R,TBL,26,82,4,3,7
24,8483567,Georgii Merkulov,C,BOS,24,82,3,4,7
24,8481122,Simon Benoit,D,TOR,26,82,1,3,4
24,8474062,Riley Nash,C,NYR,35,82,1,3,4
24,8470794,Joe Pavelski,C,,40,0,0,0,0
24,8481703,Valtteri Puustinen,R,PIT,25,0,0,0,0
24,8477950,Tony DeAngelo,D,,29,0,0,0,0
24,8481577,Philip Tomasino,C,NSH,23,0,0,0,0
24,8475197,Tyson Barrie,D,,33,0,0,0,0
24,8471218,Blake Wheeler,R,,38,0,0,0,0
24,8474157,Max Pacioretty,L,,36,0,0,0,0
24,8478466,Daniel Sprong,R,VAN,27,0,0,0,0
24,8475744,Evgeny Kuznetsov,C,,32,0,0,0,0
24,8481019,David Gustafsson,C,WPG,24,0,0,0,0
24,8475906,John Klingberg,D,,32,0,0,0,0
24,8479348,Kale Clague,D,BUF,26,0,0,0,0
24,8476952,Dominic Toninato,C,WPG,30,0,0,0,0
24,8473473,Milan Lucic,L,,36,0,0,0,0
24,8474037,James van Riemsdyk,L,,35,0,0,0,0
24,8474602,Justin Schultz,D,,34,0,0,0,0
24,8482222,Alexander Barabanov,L,,30,0,0,0,0
24,8479372,Josh Mahura,D,SEA,26,0,0,0,0
24,8479982,Conor Timmins,D,TOR,26,0,0,0,0
24,8474031,Kevin Shattenkirk,D,,35,0,0,0,0
24,8480008,Adam Ruzicka,C,,25,0,0,0,0
24,8481059,Scott Perunovich,D,STL,26,0,0,0,0
24,8480884,Calen Addison,D,,24,0,0,0,0
24,8476994,Vinnie Hinostroza,C,NSH,30,0,0,0,0
24,8478452,Caleb Jones,D,LAK,27,0,0,0,0
24,8480157,Calle Rosen,D,COL,30,0,0,0,0
24,8481609,Vladislav Kolyachonok,D,UTA,23,0,0,0,0
24,8479415,Michael McLeod,C,,26,0,0,0,0
24,8476919,Chris Tierney,C,,30,0,0,0,0
24,8479639,Dylan Coghlan,D,WPG,26,0,0,0,0
24,8478146,Matthew Highmore,C,OTT,28,0,0,0,0
24,8478970,Jalen Chatfield,D,CAR,28,0,0,0,0
24,8480205,Emil Bemstrom,C,PIT,25,0,0,0,0
24,8474884,Mike Hoffman,C,,35,0,0,0,0
24,8471274,Alex Goligoski,D,,39,0,0,0,0
24,8478104,Sammy Blais,L,,28,0,0,0,0
24,8474870,Tyler Johnson,C,,34,0,0,0,0
24,8476913,Devin Shore,C,MIN,30,0,0,0,0
24,8481598,Philip Broberg,D,EDM,23,0,0,0,0
24,8480058,Pierre-Olivier Joseph,D,STL,25,0,0,0,0
24,8480891,Michael Kesselring,D,UTA,24,0,0,0,0
24,8477979,Nicolas Aube-Kubel,R,BUF,28,0,0,0,0
24,8476871,Tanner Pearson,L,,32,0,0,0,0
24,8476393,Nick Cousins,C,,31,0,0,0,0
24,8479977,Kailer Yamamoto,R,,26,0,0,0,0
24,8479543,Michael Pezzetta,L,MTL,26,0,0,0,0
24,8477018,Ben Hutton,D,VGK,31,0,0,0,0
24,8480762,Eric Robinson,L,CAR,29,0,0,0,0
24,8474034,Pat Maroon,L,CHI,36,0,0,0,0
24,8481058,Jesse Ylönen,R,,25,0,0,0,0
24,8475179,Dmitry Kulikov,D,FLA,34,0,0,0,0
24,8481527,Kaedan Korczak,D,VGK,23,0,0,0,0
24,8473449,Kyle Okposo,R,,36,0,0,0,0
24,8482192,Isaak Phillips,D,CHI,23,0,0,0,0
24,8480727,Zach Whitecloud,D,VGK,28,0,0,0,0
24,8479346,Dillon Dube,C,,26,0,0,0,0
24,8480821,Filip Zadina,R,,25,0,0,0,0
24,8480001,Urho Vaakanainen,D,ANA,25,0,0,0,0
24,8470966,Mark Giordano,D,,41,0,0,0,0
24,8480853,Liam Foudy,C,,24,0,0,0,0
24,8475225,Craig Smith,C,CHI,35,0,0,0,0
24,8479972,Mason Shaw,C,WPG,26,0,0,0,0
24,8478451,Ethan Bear,D,WSH,27,0,0,0,0
24,8474040,Sam Gagner,C,,35,0,0,0,0
24,8480196,Jacob Bryson,D,BUF,27,0,0,0,0
24,8479984,Cal Foote,D,,26,0,0,0,0
24,8480011,Klim Kostin,C,SJS,25,0,0,0,0
24,8482176,Wyatt Kaiser,D,CHI,22,0,0,0,0
24,8476988,Matt Benning,D,SJS,30,0,0,0,0
24,8479370,Tyson Jost,C,CAR,26,0,0,0,0
24,8477464,Nic Petan,C,,29,0,0,0,0
24,8477380,Jonny Brodzinski,C,NYR,31,0,0,0,0
24,8480070,Ian Mitchell,D,BOS,25,0,0,0,0
24,8479315,Joey Anderson,R,CHI,26,0,0,0,0
24,8478099,Kevin Labanc,R,,29,0,0,0,0
24,8476874,Olli Maatta,D,DET,30,0,0,0,0
24,8475208,Brian Dumoulin,D,ANA,33,0,0,0,0
24,8478430,Oliver Kylington,D,,27,0,0,0,0
24,8479536,Axel Jonsson-Fjallby,L,WPG,26,0,0,0,0
24,8479671,Mathieu Olivier,R,CBJ,27,0,0,0,0
24,8471709,Marc-Edouard Vlasic,D,SJS,37,0,0,0,0
24,8479328,Julien Gauthier,R,NYI,27,0,0,0,0
24,8478421,A.J. Greer,L,FLA,28,0,0,0,0
24,8477573,Nathan Walker,L,STL,30,0,0,0,0
24,8481537,Nikita Okhotiuk,D,CGY,24,0,0,0,0
24,8474166,Alec Martinez,D,CHI,37,0,0,0,0
24,8470610,Zach Parise,L,,40,0,0,0,0
24,8477478,William Carrier,L,CAR,30,0,0,0,0
24,8479344,Jesse Puljujarvi,R,PIT,26,0,0,0,0
24,8480887,Jordan Harris,D,MTL,24,0,0,0,0
24,8478502,Dennis Gilbert,D,BUF,28,0,0,0,0
24,8482730,Brandt Clarke,D,LAK,21,0,0,0,0
24,8480355,Mark Kastelic,C,BOS,25,0,0,0,0
24,8475750,Jon Merrill,D,MIN,32,0,0,0,0
24,8475164,Jakob Silfverberg,R,,34,0,0,0,0
24,8477944,Jakub Vrana,L,,28,0,0,0,0
24,8479439,Jacob MacDonald,D,COL,31,0,0,0,0
24,8474568,Luke Schenn,D,NSH,35,0,0,0,0
24,8478454,Noah Juulsen,D,VAN,27,0,0,0,0
24,8475752,Tyler Pitlick,C,,33,0,0,0,0
24,8482148,Hendrix Lapierre,C,WSH,22,0,0,0,0
24,8481167,Brayden Pachal,D,CGY,25,0,0,0,0
24,8478043,Sam Lafferty,C,BUF,29,0,0,0,0
24,8479321,Lucas Johansen,D,,27,0,0,0,0
24,8471699,Andrew Cogliano,C,,37,0,0,0,0
24,8481521,Ronnie Attard,D,PHI,25,0,0,0,0
24,8481161,Jake Christiansen,D,CBJ,25,0,0,0,0
24,8479458,Nikita Zaitsev,D,,33,0,0,0,0
24,8479619,Michael Carcone,L,UTA,28,0,0,0,0
24,8479026,Philippe Myers,D,TOR,27,0,0,0,0
24,8477330,Dominik Kubalik,L,,29,0,0,0,0
24,8481617,Vasily Podkolzin,R,VAN,23,0,0,0,0
24,8481701,Santeri Hatakka,D,NJD,23,0,0,0,0
24,8479514,Rem Pitlick,C,,27,0,0,0,0
24,8477446,Michael McCarron,R,NSH,29,0,0,0,0
24,8470604,Jeff Carter,C,,39,0,0,0,0
24,8482241,Radim Zohorna,L,,28,0,0,0,0
24,8480289,Morgan Barron,C,WPG,26,0,0,0,0
24,8479379,Givani Smith,R,SJS,26,0,0,0,0
24,8480216,Jacob Peterson,C,,25,0,0,0,0
24,8477851,Jordan Oesterle,D,BOS,32,0,0,0,0
24,8484258,Sam Malinski,D,COL,26,0,0,0,0
24,8478904,Steven Lorentz,C,,28,0,0,0,0
24,8482095,Tyler Kleven,D,OTT,22,0,0,0,0
24,8480848,Ty Dellandrea,C,SJS,24,0,0,0,0
24,8476884,Derrick Pouliot,D,,30,0,0,0,0
24,8479336,Carl Grundstrom,R,SJS,27,0,0,0,0
24,8482964,Arber Xhekaj,D,MTL,23,0,0,0,0
24,8471686,Marc Staal,D,,37,0,0,0,0
24,8477887,Patrick Brown,C,BOS,32,0,0,0,0
24,8478495,Denis Gurianov,R,,27,0,0,0,0
24,8473504,Cal Clutterbuck,R,,37,0,0,0,0
24,8481550,Adam Beckman,L,NJD,23,0,0,0,0
24,8480845,Rasmus Kupari,C,WPG,24,0,0,0,0
24,8474009,Nick Bonino,C,,36,0,0,0,0
24,8478585,Derek Ryan,C,EDM,38,0,0,0,0
24,8477962,Brendan Lemieux,L,CAR,28,0,0,0,0
24,8482861,Vincent Iorio,D,WSH,22,0,0,0,0
24,8479378,Logan Stanley,D,WPG,26,0,0,0,0
24,8473446,Erik Johnson,D,PHI,36,0,0,0,0
24,8481743,Marc Del Gaizo,D,NSH,25,0,0,0,0
24,8477384,Josh Brown,D,EDM,30,0,0,0,0
24,8482165,Yan Kuznetsov,D,CGY,22,0,0,0,0
24,8478424,Jansen Harkins,C,ANA,27,0,0,0,0
24,8482144,Jack Thompson,D,SJS,22,0,0,0,0
24,8478512,Austin Czarnik,C,,32,0,0,0,0
24,8477527,Ross Johnston,L,ANA,30,0,0,0,0
24,8479383,Boris Katchouk,L,,26,0,0,0,0
24,8482094,Daemon Hunt,D,MIN,22,0,0,0,0
24,8481719,Maxwell Crozier,D,TBL,24,0,0,0,0
24,8480192,Johnathan Kovacevic,D,NJD,27,0,0,0,0
24,8479376,Victor Mete,D,,26,0,0,0,0
24,8482511,Mason Lohrei,D,BOS,23,0,0,0,0
24,8475825,Jani Hakanpää,D,,32,0,0,0,0
24,8478021,William Lagesson,D,DET,28,0,0,0,0
24,8475795,Dylan McIlrath,D,WSH,32,0,0,0,0
24,8477846,Ryan Carpenter,C,,33,0,0,0,0
24,8481056,Spencer Stastney,D,NSH,24,0,0,0,0
24,8481564,Ryan Johnson,D,BUF,23,0,0,0,0
24,8478017,Mark Friedman,D,VAN,29,0,0,0,0
24,8479320,Max Lajoie,D,SEA,27,0,0,0,0
24,8480075,Cameron Crotty,D,MIN,25,0,0,0,0
24,8484287,Cole McWard,D,VAN,23,0,0,0,0
24,8484254,Akito Hirose,D,VAN,25,0,0,0,0
24,8483407,Brandon Scanlin,D,NYR,25,0,0,0,0
24,8480274,Philip Kemp,D,EDM,25,0,0,0,0
24,8479522,Hardy Haman Aktell,D,WSH,26,0,0,0,0
24,8480007,Jonas Rondbjerg,R,VGK,25,0,0,0,0
24,8477454,Adam Erne,L,,29,0,0,0,0
24,8481679,Maxence Guenette,D,OTT,23,0,0,0,0
24,8480441,Trey Fix-Wolansky,R,CBJ,25,0,0,0,0
24,8483546,Marshall Rifai,D,TOR,26,0,0,0,0
24,8480084,Nick DeSimone,D,NJD,30,0,0,0,0
24,8481030,Jack St. Ivany,D,PIT,25,0,0,0,0
24,8481592,Jakob Pelletier,L,CGY,23,0,0,0,0
24,8478011,Louie Belpedio,D,PHI,28,0,0,0,0
24,8477930,Pierre-Edouard Bellemare,L,,39,0,0,0,0
24,8484321,Nikolas Matinpalo,D,OTT,26,0,0,0,0
24,8482067,Connor Mackey,D,NYR,28,0,0,0,0
24,8481806,Louis Crevier,D,CHI,23,0,0,0,0
24,8484326,Patrik Koch,D,UTA,28,0,0,0,0
24,8477971,Andreas Englund,D,LAK,28,0,0,0,0
24,8481751,Lukas Rousek,R,BUF,25,0,0,0,0
24,8481006,Tyler Tucker,D,STL,24,0,0,0,0
24,8476867,Brendan Gaunce,C,MIN,30,0,0,0,0
24,8479520,Brandon Duhaime,R,WSH,27,0,0,0,0
24,8477073,Kurtis MacDermid,L,NJD,30,0,0,0,0
24,8480874,Adam Ginning,D,PHI,24,0,0,0,0
24,8477473,Justin Bailey,R,SJS,29,0,0,0,0
24,8479066,Ryan Lomberg,L,CGY,30,0,0,0,0
24,8477070,Liam O'Brien,C,UTA,30,0,0,0,0
24,8474618,Marco Scandella,D,,34,0,0,0,0
24,8475797,Jarred Tinordi,D,,32,0,0,0,0
24,8481441,Joe Snively,C,DET,28,0,0,0,0
24,8477244,Chad Ruhwedel,D,NYR,34,0,0,0,0
24,8479772,Zack MacEwen,R,OTT,28,0,0,0,0
24,8481147,Reese Johnson,C,MIN,26,0,0,0,0
24,8481043,Cole Koepke,L,BOS,26,0,0,0,0
24,8483619,Filip Roos,D,OTT,25,0,0,0,0
24,8481541,Samuel Bolduc,D,NYI,24,0,0,0,0
24,8477810,Joel Hanley,D,CGY,33,0,0,0,0
24,8476907,Mackenzie MacEachern,L,,30,0,0,0,0
24,8482652,Walker Duehr,R,CGY,27,0,0,0,0
24,8477126,Jayson Megna,C,,34,0,0,0,0
24,8483398,Declan Carlile,D,TBL,31,0,0,0,0
24,8482929,Emil Lilleberg,D,TBL,23,0,0,0,0
24,8480880,Jakub Lauko,C,MIN,24,0,0,0,0
24,8480245,Olle Lycksell,R,PHI,25,0,0,0,0
24,8480252,Cole Guttman,C,CHI,25,0,0,0,0
24,8477467,Gustav Olofsson,D,SEA,30,0,0,0,0
24,8479968,Vinni Lettieri,C,BOS,29,0,0,0,0
24,8478400,Colin White,C,,27,0,0,0,0
24,8475755,Alexander Petrovic,D,DAL,32,0,0,0,0
24,8481812,Nikolai Knyzhov,D,,27,0,0,0,0
24,8481593,Jayden Struble,D,MTL,23,0,0,0,0
24,8481532,Alex Turcotte,C,LAK,23,0,0,0,0
24,8482126,Emil Andrae,D,PHI,31,0,0,0,0
24,8479944,Zach Aston-Reese,C,VGK,30,0,0,0,0
24,8471817,Ryan Reaves,R,TOR,37,0,0,0,0
24,8481206,John Ludvig,D,PIT,24,0,0,0,0
24,8481599,Victor Soderstrom,D,UTA,23,0,0,0,0
24,8480292,Carson Meyer,R,ANA,27,0,0,0,0
24,8482496,Nils Aman,C,VAN,24,0,0,0,0
24,8479718,Alex Barré-Boulet,C,MTL,27,0,0,0,0
24,8479994,Jaret Anderson-Dolan,C,WPG,25,0,0,0,0
24,8480184,Gustav Lindstrom,D,,26,0,0,0,0
24,8480890,Jan Jenik,R,OTT,24,0,0,0,0
24,8478067,Oskar Lindblom,L,,28,0,0,0,0
24,8476934,Brock McGinn,L,ANA,30,0,0,0,0
24,8479985,Cale Fleury,D,SEA,26,0,0,0,0
24,8484304,Uvis Balinskis,D,FLA,28,0,0,0,0
24,8479981,Jonah Gadjovich,L,FLA,26,0,0,0,0
24,8481716,Dmitri Voronkov,L,CBJ,24,0,0,0,0
24,8474709,Matt Martin,L,,35,0,0,0,0
24,8482634,Alex Steeves,C,TOR,25,0,0,0,0
24,8480823,Alexander Alexeyev,D,WSH,25,0,0,0,0
24,8477541,Dakota Mermis,D,TOR,30,0,0,0,0
24,8483491,Ivan Miroshnichenko,L,WSH,20,0,0,0,0
24,8478477,Mitchell Stephens,C,SEA,27,0,0,0,0
24,8481543,Nikita Alexandrov,C,STL,24,0,0,0,0
24,8479423,Alex Nylander,L,,26,0,0,0,0
24,8482451,Mikael Pyyhtia,L,CBJ,23,0,0,0,0
24,8478831,Kevin Stenlund,C,UTA,28,0,0,0,0
24,8480306,Grant Hutton,D,NYI,29,0,0,0,0
24,8478028,Fredrik Olofsson,L,,28,0,0,0,0
24,8477462,Robert Hagg,D,VGK,29,0,0,0,0
24,8477320,Anton Blidh,L,NYR,29,0,0,0,0
24,8482157,Will Cuylle,L,NYR,22,0,0,0,0
24,8482737,Zack Bolduc,C,STL,21,0,0,0,0
24,8481239,Samuel Fagemo,L,,24,0,0,0,0
24,8481600,Tobias Bjornfot,D,FLA,23,0,0,0,0
24,8478409,Anthony Richard,C,PHI,28,0,0,0,0
24,8474145,Robert Bortuzzo,D,,35,0,0,0,0
24,8475958,Michael Sgarbossa,C,WSH,32,0,0,0,0
24,8479986,Kole Lind,R,DAL,26,0,0,0,0
24,8479249,Andrew Poturalski,C,SJS,30,0,0,0,0
24,8479362,Riley Tufte,L,BOS,26,0,0,0,0
24,8479991,Jake Leschyshyn,C,NYR,25,0,0,0,0
24,8479587,Rhett Gardner,C,PHI,28,0,0,0,0
24,8482744,James Malatesta,L,CBJ,21,0,0,0,0
24,8478854,Ryan Shea,D,PIT,27,0,0,0,0
24,8481591,Sam Poulin,R,,23,0,0,0,0
24,8483512,Matt Savoie,C,EDM,20,0,0,0,0
24,8482102,Vasily Ponomarev,C,PIT,22,0,0,0,0
24,8482162,Roby Jarventie,L,EDM,22,0,0,0,0
24,8481016,Ruslan Iskhakov,C,,24,0,0,0,0
24,8482172,Landon Slaggert,L,CHI,22,0,0,0,0
24,8482747,Brennan Othmann,L,NYR,21,0,0,0,0
24,8480031,Maxime Comtois,L,,25,0,0,0,0
24,8480226,Marián Studenic,R,,26,0,0,0,0
24,8478408,Travis Dermott,D,,28,0,0,0,0
24,8481518,Nolan Foote,L,NJD,24,0,0,0,0
24,8479419,Brett Murray,L,BUF,26,0,0,0,0
24,8482088,Justin Sourdif,R,FLA,22,0,0,0,0
24,8482201,Gage Goncalves,C,TBL,23,0,0,0,0
24,8481578,Graeme Clarke,R,MIN,23,0,0,0,0
24,8482177,Marat Khusnutdinov,C,MIN,22,0,0,0,0
24,8481754,Nikita Nesterenko,C,ANA,23,0,0,0,0
24,8483531,Brian Halonen,L,NJD,25,0,0,0,0
24,8483920,Pierrick Dube,R,WSH,23,0,0,0,0
24,8480851,Akil Thomas,C,LAK,24,0,0,0,0
24,8475235,Nicolas Deslauriers,L,PHI,33,0,0,0,0
24,8482476,Emil Heineman,L,MTL,23,0,0,0,0
24,8477149,Scott Sabourin,R,SJS,32,0,0,0,0
24,8483549,Lucas Condotta,L,MTL,27,0,0,0,0
24,8482765,Isak Rosen,R,BUF,21,0,0,0,0
24,8481237,Kyle MacLean,C,NYI,25,0,0,0,0
24,8481024,Linus Karlsson,C,VAN,25,0,0,0,0
24,8481690,Tyler Angle,C,,24,0,0,0,0
24,8483570,Ben Meyers,C,SEA,26,0,0,0,0
24,8481655,Cole Schwindt,R,CGY,23,0,0,0,0
24,8481462,Mason Morelli,L,VGK,28,0,0,0,0
24,8483401,Marc Johnstone,R,PIT,28,0,0,0,0
24,8478956,Samuel Laberge,L,NJD,27,0,0,0,0
24,8479533,Joona Koppanen,L,,26,0,0,0,0
24,8482197,Adam Raska,R,MIN,23,0,0,0,0
24,8482250,Callahan Burke,C,VGK,27,0,0,0,0
24,8482784,Zach Dean,C,STL,21,0,0,0,0
24,8484255,Jason Polin,R,COL,25,0,0,0,0
24,8481077,John Leonard,L,,26,0,0,0,0
24,8481534,Raphael Lavoie,C,EDM,24,0,0,0,0
24,8483609,Adam Klapka,R,CGY,24,0,0,0,0
24,8482751,Ryan Winterton,C,SEA,21,0,0,0,0
24,8480267,Sammy Walker,C,MIN,25,0,0,0,0
24,8475766,Austin Watson,L,,32,0,0,0,0
24,8482460,Matt Rempe,C,NYR,22,0,0,0,0
24,8481065,Angus Crookshank,L,OTT,25,0,0,0,0
24,8481070,Hugh McGing,L,,26,0,0,0,0
24,8476323,Max McCormick,L,SEA,32,0,0,0,0
24,8483395,Arshdeep Bains,L,VAN,23,0,0,0,0
24,8484259,Ondrej Pavel,C,COL,31,0,0,0,0
24,8483432,Luca Del Bel Belluz,C,CBJ,31,0,0,0,0
24,8483045,Cameron Butler,R,CBJ,31,0,0,0,0
24,8482061,Brandon Biro,L,SEA,26,0,0,0,0
24,8477401,John Hayden,C,SEA,29,0,0,0,0
24,8475278,Byron Froese,C,,33,0,0,0,0
24,8478446,Glenn Gawdin,C,LAK,27,0,0,0,0
24,8477993,Justin Kirkland,C,CGY,28,0,0,0,0
24,8482147,Jean-Luc Foudy,C,COL,22,0,0,0,0
24,8480032,Shane Bowers,C,NJD,25,0,0,0,0
24,8479330,Brandon Gignac,C,MTL,27,0,0,0,0
24,8480776,Sheldon Rempal,R,,29,0,0,0,0
24,8475413,Justin Dowling,C,NJD,34,0,0,0,0
24,8481726,Adam Edstrom,C,NYR,24,0,0,0,0
24,8480844,Grigori Denisenko,L,VGK,24,0,0,0,0
24,8478147,Bokondji Imama,L,PIT,28,0,0,0,0
24,8478881,Brett Seney,L,CHI,28,0,0,0,0
24,8483630,Pavol Regenda,L,ANA,25,0,0,0,0
24,8480836,Jonathan Gruden,C,,24,0,0,0,0
24,8484314,Jiri Smejkal,L,,28,0,0,0,0
24,8475780,Chris Wagner,R,COL,33,0,0,0,0
24,8479546,Oskar Steen,C,,26,0,0,0,0
24,8483597,Milos Kelemen,L,UTA,25,0,0,0,0
24,8481789,Tye Kartye,L,SEA,23,0,0,0,0
24,8484325,Waltteri Merela,C,TBL,26,0,0,0,0
24,8479421,Jacob Moverare,D,LAK,26,0,0,0,0
24,8481585,Egor Afanasyev,L,SJS,23,0,0,0,0
24,8479547,Matthew Phillips,R,,26,0,0,0,0
24,8479367,William Lockwood,R,FLA,26,0,0,0,0
24,8476915,Jujhar Khaira,L,,30,0,0,0,0
24,8481422,Jacob Lucchini,C,NSH,29,0,0,0,0
24,8480468,James Hamblin,L,EDM,25,0,0,0,0
24,8478051,Max Willman,C,NJD,29,0,0,0,0
24,8481556,John Beecher,C,BOS,23,0,0,0,0
24,8478078,Rourke Chartier,C,,28,0,0,0,0
25,8478402,Connor McDavid,C,EDM,27,82,61,119,180
25,8477492,Nathan MacKinnon,C,COL,29,82,62,69,131
25,8476453,Nikita Kucherov,R,TBL,31,82,33,86,119
25,8480012,Elias Pettersson,C,VAN,26,82,46,70,116
25,8477934,Leon Draisaitl,C,EDM,29,82,44,71,115
25,8479318,Auston Matthews,C,TOR,27,82,63,51,114
25,8478403,Jack Eichel,C,VGK,28,82,54,58,112
25,8481559,Jack Hughes,C,NJD,23,82,36,72,108
25,8480027,Jason Robertson,L,DAL,25,82,40,65,105
25,8479314,Matthew Tkachuk,L,FLA,27,82,39,66,105
25,8477956,David Pastrnak,R,BOS,28,82,52,52,104
25,8471675,Sidney Crosby,C,PIT,37,82,43,59,102
25,8476468,J.T. Miller,C,VAN,31,82,34,68,102
25,8478550,Artemi Panarin,L,NYR,33,82,31,71,102
25,8482116,Tim Stützle,C,OTT,22,82,39,60,99
25,8479407,Jesper Bratt,L,NJD,26,82,36,63,99
25,8480801,Brady Tkachuk,L,OTT,25,82,39,59,98
25,8475172,Nazem Kadri,C,CGY,34,82,41,55,96
25,8480023,Robert Thomas,C,STL,25,82,24,67,91
25,8477493,Aleksander Barkov,C,FLA,29,82,28,62,90
25,8478444,Brock Boeser,R,VAN,27,82,42,47,89
25,8477939,William Nylander,R,TOR,28,82,34,55,89
25,8480002,Nico Hischier,C,NJD,25,82,25,64,89
25,8474564,Steven Stamkos,C,NSH,34,82,38,50,88
25,8479385,Jordan Kyrou,C,STL,26,82,37,51,88
25,8479323,Adam Fox,D,NYR,26,82,21,67,88
25,8478864,Kirill Kaprizov,L,MIN,27,82,46,40,86
25,8477942,Kevin Fiala,L,LAK,28,82,27,59,86
25,8481540,Cole Caufield,R,MTL,23,82,45,40,85
25,8480069,Cale Makar,D,COL,26,82,17,68,85
25,8479420,Tage Thompson,C,BUF,27,82,40,44,84
25,8479343,Clayton Keller,R,UTA,26,82,37,47,84
25,8475913,Mark Stone,R,VGK,32,82,30,54,84
25,8478420,Mikko Rantanen,R,COL,28,82,41,40,81
25,8477933,Sam Reinhart,C,FLA,29,82,28,53,81
25,8478445,Mathew Barzal,C,NYI,27,82,19,62,81
25,8477447,Shea Theodore,D,VGK,29,82,7,74,81
25,8478449,Roope Hintz,C,DAL,28,82,37,43,80
25,8476459,Mika Zibanejad,C,NYR,31,82,32,48,80
25,8477409,Carter Verhaeghe,C,FLA,29,82,44,35,79
25,8478010,Brayden Point,C,TBL,28,82,35,44,79
25,8478440,Dylan Strome,C,WSH,27,82,33,46,79
25,8476389,Vincent Trocheck,C,NYR,31,82,33,46,79
25,8476887,Filip Forsberg,L,NSH,30,82,37,41,78
25,8471215,Evgeni Malkin,C,PIT,38,82,28,50,78
25,8480800,Quinn Hughes,D,VAN,25,82,3,75,78
25,8477946,Dylan Larkin,C,DET,28,82,36,41,77
25,8480839,Rasmus Dahlin,D,BUF,24,82,21,56,77
25,8480830,Andrei Svechnikov,R,CAR,24,82,34,42,76
25,8482665,Matty Beniers,C,SEA,22,82,34,42,76
25,8478427,Sebastian Aho,C,CAR,27,82,31,45,76
25,8475786,Zach Hyman,L,EDM,32,82,28,48,76
25,8477940,Nikolaj Ehlers,L,WPG,28,82,28,48,76
25,8475158,Ryan O'Reilly,C,NSH,33,82,24,52,76
25,8481523,Kirby Dach,C,MTL,23,82,9,67,76
25,8478439,Travis Konecny,R,PHI,27,82,31,44,75
25,8471685,Anze Kopitar,C,LAK,37,82,26,49,75
25,8474600,Roman Josi,D,NSH,34,82,17,58,75
25,8471214,Alex Ovechkin,L,WSH,39,82,38,36,74
25,8476448,William Karlsson,C,VGK,31,82,33,41,74
25,8477404,Jake Guentzel,C,TBL,30,82,35,38,73
25,8480208,Drake Batherson,R,OTT,26,82,28,45,73
25,8476539,Jonathan Marchessault,R,NSH,34,82,40,32,72
25,8476399,Blake Coleman,C,CGY,33,82,39,33,72
25,8477951,Nick Schmaltz,C,UTA,28,82,28,44,72
25,8481557,Matt Boldy,L,MIN,23,82,27,45,72
25,8478414,Timo Meier,R,NJD,28,82,39,32,71
25,8479542,Brandon Hagel,L,TBL,26,82,32,39,71
25,8477949,Alex Tuch,R,BUF,28,82,19,52,71
25,8476456,Jonathan Huberdeau,C,CGY,31,82,18,53,71
25,8478873,Troy Terry,R,ANA,27,82,24,45,69
25,8475167,Victor Hedman,D,TBL,34,82,19,50,69
25,8475166,John Tavares,C,TOR,34,82,40,28,68
25,8475726,Tyler Toffoli,C,SJS,32,82,35,33,68
25,8477955,Jared McCann,L,SEA,28,82,36,31,67
25,8476460,Mark Scheifele,C,WPG,31,82,30,37,67
25,8482078,Lucas Raymond,L,DET,22,82,25,42,67
25,8481711,Matias Maccelli,L,UTA,24,82,20,47,67
25,8482684,Luke Hughes,D,NJD,21,82,14,53,67
25,8475170,Brayden Schenn,C,STL,33,82,33,33,66
25,8475794,Tyler Seguin,C,DAL,32,82,31,35,66
25,8479339,Patrik Laine,L,CBJ,26,82,26,40,66
25,8474578,Erik Karlsson,D,PIT,34,82,10,56,66
25,8478407,Vince Dunn,D,SEA,28,82,9,57,66
25,8478975,Mason Marchment,L,DAL,29,82,31,34,65
25,8473512,Claude Giroux,R,OTT,36,82,25,40,65
25,8476454,Ryan Nugent-Hopkins,C,EDM,31,82,21,44,65
25,8476462,Dougie Hamilton,D,NJD,31,82,21,44,65
25,8474590,John Carlson,D,WSH,34,82,15,50,65
25,8476432,Boone Jenner,C,CBJ,31,82,36,28,64
25,8473419,Brad Marchand,L,BOS,36,82,29,35,64
25,8480018,Nick Suzuki,C,MTL,25,82,26,38,64
25,8477960,Adrian Kempe,R,LAK,28,82,37,26,63
25,8475184,Chris Kreider,L,NYR,33,82,35,28,63
25,8475168,Matt Duchene,C,DAL,33,82,30,33,63
25,8481068,Yegor Sharangovich,C,CGY,26,82,29,34,63
25,8475810,Bryan Rust,R,PIT,32,82,26,37,63
25,8480865,Noah Dobson,D,NYI,24,82,9,54,63
25,8476881,Tomas Hertl,C,VGK,31,82,27,35,62
25,8476853,Morgan Rielly,D,TOR,30,82,13,49,62
25,8477416,Oliver Bjorkstrand,R,SEA,29,82,33,28,61
25,8478398,Kyle Connor,L,WPG,28,82,32,29,61
25,8475692,Mats Zuccarello,R,MIN,37,82,16,45,61
25,8476875,Mike Matheson,D,MTL,30,82,10,51,61
25,8475754,Brock Nelson,C,NYI,33,82,31,29,60
25,8481533,Trevor Zegras,C,ANA,23,82,29,31,60
25,8478042,Viktor Arvidsson,R,EDM,31,82,29,31,60
25,8480188,Fabian Zetterlund,L,SJS,25,82,25,35,60
25,8474141,Patrick Kane,R,DET,36,82,22,38,60
25,8480434,Sean Durzi,D,UTA,26,82,19,41,60
25,8478460,Zach Werenski,D,CBJ,27,82,17,43,60
25,8477496,Elias Lindholm,C,BOS,30,82,16,44,60
25,8475798,Mikael Granlund,C,SJS,32,82,12,48,60
25,8477501,Valeri Nichushkin,R,COL,29,82,28,31,59
25,8481528,Dylan Cozens,C,BUF,23,82,24,35,59
25,8479337,Alex DeBrincat,R,DET,27,82,20,39,59
25,8477402,Pavel Buchnevich,L,STL,29,82,19,40,59
25,8477504,Josh Morrissey,D,WPG,29,82,17,42,59
25,8480028,Morgan Frost,C,PHI,25,82,13,46,59
25,8482740,Wyatt Johnston,C,DAL,21,82,28,30,58
25,8473986,Alex Killorn,L,ANA,35,82,24,34,58
25,8477476,Artturi Lehkonen,L,COL,29,82,22,36,58
25,8478038,Devon Toews,D,COL,30,82,13,45,58
25,8475784,Jeff Skinner,C,EDM,32,82,31,26,57
25,8475791,Taylor Hall,L,CHI,33,82,22,35,57
25,8478519,Anthony Cirelli,C,TBL,27,82,21,36,57
25,8482113,Anton Lundell,C,FLA,23,82,20,37,57
25,8476479,Phillip Danault,C,LAK,31,82,20,37,57
25,8476905,Chandler Stephenson,C,SEA,30,82,17,40,57
25,8476346,Johnny Gaudreau,L,CBJ,31,82,15,42,57
25,8474565,Alex Pietrangelo,D,VGK,34,82,14,43,57
25,8479425,Filip Hronek,D,VAN,27,82,13,44,57
25,8482055,Drew O'Connor,L,PIT,26,82,34,22,56
25,8480078,Filip Chytil,C,NYR,25,82,25,31,56
25,8475765,Vladimir Tarasenko,R,DET,33,82,23,33,56
25,8477407,Anthony Duclair,L,NYI,29,82,22,34,56
25,8477021,Alex Kerfoot,C,UTA,30,82,21,35,56
25,8479999,Casey Mittelstadt,C,COL,26,82,19,37,56
25,8482097,Jack Quinn,R,BUF,23,82,16,40,56
25,8477494,Jonathan Drouin,L,COL,29,82,16,40,56
25,8482667,William Eklund,L,SJS,22,82,14,42,56
25,8471724,Kris Letang,D,PIT,37,82,13,43,56
25,8475722,Jason Zucker,L,BUF,32,82,25,30,55
25,8482745,Mason McTavish,C,ANA,21,82,23,32,55
25,8479410,Mikhail Sergachev,D,UTA,26,82,11,44,55
25,8480036,Miro Heiskanen,D,DAL,25,82,9,46,55
25,8479675,Trevor Moore,L,LAK,29,82,27,27,54
25,8480015,Owen Tippett,R,PHI,25,82,27,27,54
25,8478856,Conor Garland,R,VAN,28,82,22,32,54
25,8477964,Ivan Barbashev,C,VGK,29,82,22,32,54
25,8478542,Evan Rodrigues,C,FLA,31,82,22,32,54
25,8482093,Seth Jarvis,C,CAR,22,82,20,34,54
25,8479325,Charlie McAvoy,D,BOS,27,82,8,46,54
25,8478366,Frank Vatrano,R,ANA,30,82,29,24,53
25,8480064,Josh Norris,C,OTT,25,82,29,24,53
25,8478493,Joel Eriksson Ek,C,MIN,27,82,24,29,53
25,8474586,Jordan Eberle,R,SEA,34,82,22,31,53
25,8478438,Tommy Novak,C,NSH,27,82,18,35,53
25,8476882,Teuvo Teravainen,L,CHI,30,82,16,37,53
25,8477346,MacKenzie Weegar,D,CGY,30,82,11,42,53
25,8480803,Evan Bouchard,D,EDM,25,82,8,45,53
25,8475169,Evander Kane,L,EDM,33,82,29,23,52
25,8481596,Shane Pinto,C,OTT,24,82,24,28,52
25,8474150,Mikael Backlund,C,CGY,35,82,21,31,52
25,8475763,Kevin Hayes,R,PIT,32,82,21,31,52
25,8477935,Sam Bennett,C,FLA,28,82,18,34,52
25,8473563,Nicklas Backstrom,C,WSH,37,82,18,34,52
25,8478047,Michael Bunting,L,PIT,29,82,16,36,52
25,8473994,Jamie Benn,L,DAL,35,82,15,37,52
25,8477986,Brandon Montour,D,SEA,30,82,12,40,52
25,8476880,Tom Wilson,R,WSH,30,82,29,22,51
25,8474053,Logan Couture,C,SJS,35,82,21,30,51
25,8474102,David Perron,L,OTT,36,82,18,33,51
25,8474563,Drew Doughty,D,LAK,35,82,11,40,51
25,8477500,Bo Horvat,C,NYI,29,82,32,18,50
25,8478498,Jake DeBrusk,L,VAN,28,82,26,24,50
25,8477511,Anthony Mantha,R,CGY,30,82,16,34,50
25,8478401,Pavel Zacha,C,BOS,27,82,14,36,50
25,8482110,Dawson Mercer,C,NJD,23,82,27,22,49
25,8484144,Connor Bedard,C,CHI,19,82,26,23,49
25,8482699,Dylan Guenther,R,UTA,21,82,20,29,49
25,8474641,Adam Henrique,C,EDM,34,82,20,29,49
25,8478463,Anthony Beauvillier,L,PIT,27,82,20,29,49
25,8476869,Brady Skjei,D,NSH,30,82,15,34,49
25,8482159,Tyson Foerster,R,PHI,22,82,27,21,48
25,8481535,Nils Hoglander,L,VAN,24,82,27,21,48
25,8476483,Rickard Rakell,R,PIT,31,82,26,22,48
25,8482705,Cole Sillinger,C,CBJ,21,82,25,23,48
25,8471698,T.J. Oshie,R,WSH,38,82,20,28,48
25,8478233,Andrew Mangiapane,L,WSH,28,82,20,28,48
25,8478396,Noah Hanifin,D,VGK,27,82,13,35,48
25,8480220,Noah Cates,L,PHI,25,82,12,36,48
25,8475768,Jaden Schwartz,C,SEA,32,82,24,23,47
25,8480797,Joel Farabee,L,PHI,24,82,20,27,47
25,8482109,Alexis Lafrenière,L,NYR,23,82,19,28,47
25,8474679,Gustav Nyquist,C,NSH,35,82,18,29,47
25,8476292,Ondrej Palat,L,NJD,33,82,18,29,47
25,8477952,Robby Fabbri,C,ANA,28,82,18,29,47
25,8482105,Jake Sanderson,D,OTT,22,82,12,35,47
25,8478397,Rasmus Andersson,D,CGY,28,82,10,37,47
25,8477932,Aaron Ekblad,D,FLA,28,82,6,41,47
25,8478046,Danton Heinen,L,VAN,29,82,28,18,46
25,8475799,Nino Niederreiter,R,WPG,32,82,26,20,46
25,8475793,Ryan Johansen,C,PHI,32,82,24,22,46
25,8482124,Quinton Byfield,R,LAK,22,82,17,29,46
25,8476458,Ryan Strome,C,ANA,31,82,16,30,46
25,8482720,Matthew Knies,L,TOR,22,82,15,31,46
25,8475191,Reilly Smith,R,NYR,33,82,14,32,46
25,8477495,Seth Jones,D,CHI,30,82,13,33,46
25,8478469,Thomas Chabot,D,OTT,27,82,11,35,46
25,8470613,Brent Burns,D,CAR,39,82,8,38,46
25,8477426,Nicholas Paul,L,TBL,29,82,25,20,45
25,8482175,JJ Peterka,R,BUF,22,82,23,22,45
25,8479525,Ross Colton,C,COL,28,82,22,23,45
25,8480185,Eetu Luostarinen,C,FLA,26,82,22,23,45
25,8480802,Ryan McLeod,C,BUF,25,82,20,25,45
25,8476826,Yanni Gourde,C,SEA,33,82,19,26,45
25,8478891,Mason Appleton,C,WPG,28,82,16,29,45
25,8482149,Cole Perfetti,C,WPG,22,82,13,32,45
25,8476923,Damon Severson,D,CBJ,30,82,13,32,45
25,8482089,Jake Neighbours,L,STL,22,82,25,19,44
25,8476438,Brandon Saad,L,STL,32,82,25,19,44
25,8480074,Alexandre Texier,C,STL,25,82,23,21,44
25,8478474,Lawson Crouse,L,UTA,27,82,21,23,44
25,8478472,Mathieu Joseph,R,STL,27,82,17,27,44
25,8477497,Sean Monahan,C,CBJ,30,82,16,28,44
25,8480748,Kiefer Sherwood,L,VAN,29,82,16,28,44
25,8482660,Kent Johnson,C,CBJ,22,82,12,32,44
25,8475151,Kyle Palmieri,C,NYI,33,82,25,18,43
25,8480039,Martin Necas,C,CAR,25,82,22,21,43
25,8478109,Victor Olofsson,L,VGK,29,82,21,22,43
25,8477451,Ryan Hartman,R,MIN,30,82,20,23,43
25,8477444,Andre Burakovsky,L,SEA,29,82,13,30,43
25,8477503,Max Domi,C,TOR,29,82,13,30,43
25,8476854,Hampus Lindholm,D,BOS,30,82,11,32,43
25,8475764,Cam Fowler,D,ANA,33,82,6,37,43
25,8481604,Pavel Dorofeyev,L,VGK,24,82,26,16,42
25,8479400,Pierre-Luc Dubois,L,WSH,26,82,18,24,42
25,8478115,Pierre Engvall,L,NYI,28,82,18,24,42
25,8478462,Nicolas Roy,C,VGK,27,82,18,24,42
25,8481618,Alex Newhook,C,MTL,23,82,16,26,42
25,8478055,Gustav Forsling,D,FLA,28,82,15,27,42
25,8475218,Mattias Ekholm,D,EDM,34,82,15,27,42
25,8477479,Tyler Bertuzzi,L,CHI,29,82,14,28,42
25,8478057,Dakota Joshua,C,VAN,28,82,13,29,42
25,8476792,Torey Krug,D,STL,33,82,9,33,42
25,8475753,Justin Faulk,D,STL,32,82,7,35,42
25,8475314,Anders Lee,L,NYI,34,82,22,19,41
25,8479992,Michael Rasmussen,C,DET,25,82,22,19,41
25,8480014,Gabriel Vilardi,C,WPG,25,82,19,22,41
25,8477987,Ryan Donato,C,CHI,28,82,18,23,41
25,8482133,Thomas Bordeleau,C,SJS,22,82,18,23,41
25,8476419,Jean-Gabriel Pageau,C,NYI,32,82,16,25,41
25,8482671,Owen Power,D,BUF,22,82,15,26,41
25,8480009,Eeli Tolvanen,R,SEA,25,82,14,27,41
25,8478507,John Marino,D,UTA,27,82,9,32,41
25,8481542,Moritz Seider,D,DET,23,82,7,34,41
25,8475714,Calle Jarnkrok,C,TOR,33,82,21,19,40
25,8481704,Juuso Parssinen,C,NSH,23,82,19,21,40
25,8477456,J.T. Compher,L,DET,29,82,18,22,40
25,8480798,Philipp Kurashev,C,CHI,25,82,14,26,40
25,8476461,Sean Couturier,C,PHI,32,82,13,27,40
25,8479987,Morgan Geekie,C,BOS,26,82,12,28,40
25,8480459,Pius Suter,C,VAN,28,82,18,21,39
25,8478413,Jordan Greenway,L,BUF,27,82,16,23,39
25,8481554,Kaapo Kakko,R,NYR,23,82,21,17,38
25,8477998,Warren Foegele,L,LAK,28,82,21,17,38
25,8480068,Ryan Poehling,C,PHI,25,82,18,20,38
25,8483808,Andrei Kuzmenko,L,CGY,28,82,17,21,38
25,8476329,Travis Boyd,C,MIN,31,82,16,22,38
25,8477953,Kasperi Kapanen,R,STL,28,82,14,24,38
25,8477948,Travis Sanheim,D,PHI,28,82,13,25,38
25,8478458,Jack Roslovic,C,CAR,27,82,12,26,38
25,8477969,Marcus Pettersson,D,PIT,28,82,10,28,38
25,8475171,Oliver Ekman-Larsson,D,TOR,33,82,9,29,38
25,8473533,Jordan Staal,C,CAR,36,82,22,15,37
25,8474189,Lars Eller,C,PIT,35,82,19,18,37
25,8476480,Vladislav Namestnikov,C,WPG,32,82,17,20,37
25,8475745,Charlie Coyle,C,BOS,32,82,16,21,37
25,8476872,Scott Laughton,C,PHI,30,82,13,24,37
25,8479345,Jakob Chychrun,D,WSH,26,82,10,27,37
25,8479996,Cody Glass,C,NSH,25,82,18,18,36
25,8475760,Nick Bjugstad,C,UTA,32,82,17,19,36
25,8482475,Yegor Chinakhov,R,CBJ,23,82,16,20,36
25,8477392,Hudson Fasching,R,NYI,29,82,16,20,36
25,8476897,Oskar Sundqvist,C,STL,30,82,14,22,36
25,8476927,Teddy Blueger,C,VAN,30,82,13,23,36
25,8477498,Darnell Nurse,D,EDM,29,82,12,24,36
25,8476463,Jonas Brodin,D,MIN,31,82,12,24,36
25,8480113,Alex Iafallo,L,WPG,31,82,7,29,36
25,8480893,Kirill Marchenko,R,CBJ,24,82,21,14,35
25,8479393,Noah Gregor,C,OTT,26,82,20,15,35
25,8473422,Nick Foligno,L,CHI,37,82,18,17,35
25,8475287,Erik Haula,L,NJD,33,82,17,18,35
25,8478013,Jake Walman,D,SJS,28,82,12,23,35
25,8481581,Thomas Harley,D,DAL,23,82,8,27,35
25,8480835,Jack Drury,C,CAR,24,82,19,15,34
25,8481186,Logan O'Connor,R,COL,28,82,17,17,34
25,8481013,Jonatan Berggren,R,DET,24,82,15,19,34
25,8481517,Brett Leason,R,ANA,25,82,15,19,34
25,8481560,Arthur Kaliyev,R,LAK,23,82,14,20,34
25,8476906,Shayne Gostisbehere,D,CAR,31,82,11,23,34
25,8475343,Nic Dowd,C,WSH,34,82,9,25,34
25,8476958,Jaccob Slavin,D,CAR,30,82,7,27,34
25,8477450,Jason Dickinson,C,CHI,29,82,20,13,33
25,8479941,Justin Danforth,R,CBJ,31,82,20,13,33
25,8476873,Mark Jankowski,C,NSH,30,82,19,14,33
25,8481624,Ilya Mikheyev,R,CHI,30,82,16,17,33
25,8477989,Christian Dvorak,C,MTL,28,82,15,18,33
25,8481477,Nico Sturm,C,SJS,29,82,15,18,33
25,8482146,Luke Evangelista,R,NSH,22,82,13,20,33
25,8477429,Andrew Copp,C,DET,30,82,13,20,33
25,8484145,Zach Benson,L,BUF,19,82,12,21,33
25,8478911,Matt Roy,D,WSH,29,82,9,24,33
25,8476902,Esa Lindell,D,DAL,30,82,6,27,33
25,8476979,Erik Gustafsson,D,DET,32,82,4,29,33
25,8483431,Logan Cooley,C,UTA,20,82,19,13,32
25,8477425,Miles Wood,L,COL,29,82,17,15,32
25,8482125,Alexander Holtz,R,VGK,22,82,17,15,32
25,8480871,Adam Boqvist,D,FLA,24,82,15,17,32
25,8479591,Michael Eyssimont,C,TBL,28,82,15,17,32
25,8476925,Colton Sissons,C,NSH,31,82,12,20,32
25,8481522,Peyton Krebs,C,BUF,23,82,10,22,32
25,8476457,Adam Larsson,D,SEA,32,82,5,27,32
25,8474574,Tyler Myers,D,VAN,34,82,1,31,32
25,8476981,Josh Anderson,R,MTL,30,82,18,13,31
25,8479293,Brandon Tanev,L,SEA,33,82,17,14,31
25,8479390,Taylor Raddysh,R,WSH,26,82,15,16,31
25,8482166,Shakir Mukhamadullin,D,SJS,22,82,15,16,31
25,8482092,Ridly Greig,C,OTT,22,82,13,18,31
25,8476960,Andreas Athanasiou,C,CHI,30,82,12,19,31
25,8476392,Adam Lowry,C,WPG,31,82,11,20,31
25,8475231,Casey Cizikas,C,NYI,33,82,10,21,31
25,8483482,Tristan Luneau,D,ANA,20,82,10,21,31
25,8477220,Nate Schmidt,D,FLA,33,82,9,22,31
25,8482142,Jamie Drysdale,D,PHI,22,82,8,23,31
25,8475200,Dmitry Orlov,D,CAR,33,82,7,24,31
25,8476931,Jake McCabe,D,TOR,31,82,6,25,31
25,8482122,Brock Faber,D,MIN,22,82,5,26,31
25,8474151,Ryan McDonagh,D,TBL,35,82,3,28,31
25,8480855,Jack McBain,C,UTA,24,82,15,15,30
25,8481580,Connor McMichael,C,WSH,23,82,14,16,30
25,8482117,Lukas Reichel,L,CHI,22,82,14,16,30
25,8482624,Daniil Miromanov,D,CGY,27,82,13,17,30
25,8475848,Brendan Gallagher,R,MTL,32,82,12,18,30
25,8479365,Trent Frederic,C,BOS,26,82,12,18,30
25,8481582,Nicholas Robertson,L,TOR,23,82,11,19,30
25,8482679,Matt Coronato,R,CGY,22,82,10,20,30
25,8476278,Colin Blackwell,C,DAL,31,82,9,21,30
25,8481546,Cam York,D,PHI,23,82,8,22,30
25,8480829,Jesperi Kotkaniemi,C,CAR,24,82,7,23,30
25,8482803,Olen Zellweger,D,ANA,21,82,6,24,30
25,8480817,K'Andre Miller,D,NYR,24,82,5,25,30
25,8479398,Samuel Girard,D,COL,26,82,4,26,30
25,8479402,Jake Bean,D,CGY,26,82,2,28,30
25,8474149,Evgenii Dadonov,R,DAL,35,82,17,12,29
25,8480849,Barrett Hayton,C,UTA,24,82,17,12,29
25,8476918,Jimmy Vesey,L,NYR,31,82,17,12,29
25,8481093,Rafael Harvey-Pinard,L,MTL,25,82,16,13,29
25,8479359,Beck Malenstyn,L,BUF,26,82,16,13,29
25,8483515,Juraj Slafkovsky,L,MTL,20,82,14,15,29
25,8481028,Martin Pospisil,C,CGY,25,82,14,15,29
25,8478020,Michael Amadio,C,OTT,28,82,12,17,29
25,8478434,Keegan Kolesar,R,VGK,27,82,12,17,29
25,8479351,Sam Steel,C,DAL,26,82,9,20,29
25,8480995,Pontus Holmberg,R,TOR,25,82,9,20,29
25,8480336,Sean Walker,D,CAR,30,82,8,21,29
25,8480145,Neal Pionk,D,WPG,29,82,6,23,29
25,8475324,Nick Jensen,D,OTT,34,82,6,23,29
25,8475181,Nick Leddy,D,STL,33,82,6,23,29
25,8478851,Alexandre Carrier,D,NSH,28,82,5,24,29
25,8482245,Artem Zub,D,OTT,29,82,5,24,29
25,8481606,Jordan Spence,D,LAK,23,82,4,25,29
25,8478500,Ivan Provorov,D,CBJ,27,82,4,25,29
25,8476892,Colton Parayko,D,STL,31,82,4,25,29
25,8476917,Adam Pelech,D,NYI,30,82,3,26,29
25,8479976,Juuso Valimaki,D,UTA,26,82,2,27,29
25,8474673,TJ Brodie,D,CHI,34,82,1,28,29
25,8475149,Marcus Johansson,L,MIN,34,82,14,14,28
25,8481656,Aliaksei Protas,C,WSH,23,82,12,16,28
25,8478133,Jake Evans,C,MTL,28,82,12,16,28
25,8474715,Cam Atkinson,R,TBL,35,82,10,18,28
25,8478882,Vladislav Gavrikov,D,LAK,29,82,10,18,28
25,8477919,Frederick Gaudreau,C,MIN,31,82,9,19,28
25,8474716,Jared Spurgeon,D,MIN,35,82,6,22,28
25,8479368,Max Jones,L,BOS,26,82,16,11,27
25,8477508,Curtis Lazar,C,NJD,29,82,15,12,27
25,8476474,Stefan Noesen,R,NJD,31,82,14,13,27
25,8477903,Garnet Hathaway,R,PHI,33,82,12,15,27
25,8476921,Jordan Martinook,L,CAR,32,82,11,16,27
25,8480789,Oliver Wahlstrom,R,NYI,24,82,11,16,27
25,8482062,Cole Smith,L,NSH,29,82,8,19,27
25,8480035,Henri Jokiharju,D,BUF,25,82,3,24,27
25,8481032,Paul Cotter,C,NJD,25,82,16,10,26
25,8481553,Bobby Brink,R,PHI,23,82,14,12,26
25,8479414,Nathan Bastian,R,NJD,27,82,13,13,26
25,8475193,Tomas Tatar,L,NJD,34,82,11,15,26
25,8476374,Sean Kuraly,C,CBJ,31,82,10,16,26
25,8477947,Sonny Milano,L,WSH,28,82,8,18,26
25,8483490,Pavel Mintyukov,D,ANA,21,82,7,19,26
25,8479980,Nicolas Hague,D,VGK,26,82,5,21,26
25,8477506,Ryan Pulock,D,NYI,30,82,4,22,26
25,8479324,Ryan Lindgren,D,NYR,26,82,4,22,26
25,8476879,Cody Ceci,D,EDM,31,82,3,23,26
25,8479371,Dante Fabbro,D,NSH,26,82,1,25,26
25,8483468,Jiri Kulich,C,BUF,20,82,13,12,25
25,8478508,Yakov Trenin,C,MIN,27,82,11,14,25
25,8482733,Logan Mailloux,D,MTL,31,82,11,14,25
25,8480003,Jesper Boqvist,C,FLA,26,82,9,16,25
25,8473507,Jeff Petry,D,DET,37,82,7,18,25
25,8478432,Christian Fischer,R,DET,27,82,7,18,25
25,8480860,Kevin Bahl,D,CGY,24,82,6,19,25
25,8477435,Ryan Graves,D,PIT,29,82,5,20,25
25,8480222,Sebastian Aho,D,PIT,28,82,5,20,25
25,8481568,Alex Vlasic,D,CHI,23,82,5,20,25
25,8475462,Radko Gudas,D,ANA,34,82,5,20,25
25,8477845,Trevor van Riemsdyk,D,WSH,33,82,4,21,25
25,8475279,Ben Chiarot,D,DET,33,82,3,22,25
25,8475188,Brayden McNabb,D,VGK,33,82,2,23,25
25,8479353,Brett Howden,C,VGK,26,82,12,12,24
25,8484153,Leo Carlsson,C,ANA,20,82,12,12,24
25,8473453,Trevor Lewis,C,LAK,37,82,12,12,24
25,8482079,Marco Rossi,C,MIN,23,82,11,13,24
25,8483012,Logan Morrison,C,SEA,22,82,11,13,24
25,8476889,Radek Faksa,C,STL,30,82,9,15,24
25,8470621,Corey Perry,R,EDM,39,82,7,17,24
25,8480980,Connor Dewar,C,TOR,25,82,7,17,24
25,8476885,Jacob Trouba,D,NYR,30,82,6,18,24
25,8480246,Nick Perbix,D,TBL,26,82,6,18,24
25,8478136,Jake Middleton,D,MIN,28,82,5,19,24
25,8480873,Rasmus Sandin,D,WSH,24,82,2,22,24
25,8484166,Adam Fantilli,C,CBJ,20,82,13,10,23
25,8480813,Joe Veleno,C,DET,24,82,12,11,23
25,8480144,David Kampf,C,TOR,29,82,9,14,23
25,8477015,Connor Brown,R,EDM,30,82,8,15,23
25,8479576,Vincent Desharnais,D,VAN,28,82,8,15,23
25,8481708,Zac Jones,D,NYR,24,82,6,17,23
25,8477369,Carson Soucy,D,VAN,30,82,6,17,23
25,8483565,Nick Blankenburg,D,NSH,26,82,4,19,23
25,8478416,Erik Cernak,D,TBL,27,82,4,19,23
25,8477488,Brett Pesce,D,NJD,30,82,1,22,23
25,8480043,Timothy Liljegren,D,TOR,25,82,0,23,23
25,8476469,Joel Armia,R,MTL,31,82,14,8,22
25,8482101,Danil Gushchin,L,SJS,22,82,12,10,22
25,8481601,Simon Holmstrom,R,NYI,23,82,10,12,22
25,8482111,Justin Barron,D,MTL,23,82,9,13,22
25,8479316,Luke Kunin,C,SJS,27,82,9,13,22
25,8483763,Maksymilian Szuber,D,UTA,22,82,8,14,22
25,8480049,Dylan Samberg,D,WPG,25,82,6,16,22
25,8482470,Ilya Solovyov,D,CGY,24,82,6,16,22
25,8476331,Dylan DeMelo,D,WPG,31,82,5,17,22
25,8481567,Henry Thrun,D,SJS,23,82,5,17,22
25,8476624,Barclay Goodrow,C,SJS,31,82,4,18,22
25,8480807,Mattias Samuelsson,D,BUF,24,82,4,18,22
25,8481014,Alexander Romanov,D,NYI,24,82,4,18,22
25,8479998,Mikey Anderson,D,LAK,25,82,2,20,22
25,8478840,Will Borgen,D,SEA,28,82,1,21,22
25,8478399,Jonas Siegenthaler,D,NJD,27,82,1,21,22
25,8482074,Connor Zary,C,CGY,23,82,12,9,21
25,8475842,Sam Carrick,C,NYR,32,82,12,9,21
25,8482809,Jackson Blake,R,CAR,21,82,9,12,21
25,8477353,Tyler Motte,C,DET,29,82,8,13,21
25,8482141,Lukas Cormier,D,VGK,22,82,8,13,21
25,8482259,Bobby McMann,C,TOR,28,82,8,13,21
25,8481481,Blake Lizotte,C,PIT,27,82,7,14,21
25,8479983,Mario Ferraro,D,SJS,26,82,7,14,21
25,8483457,Lane Hutson,D,MTL,20,82,6,15,21
25,8483493,Frank Nazar,C,CHI,20,82,6,15,21
25,8476429,Scott Mayfield,D,NYI,32,82,5,16,21
25,8481178,Egor Zamula,D,PHI,24,82,4,17,21
25,8482087,Kaiden Guhle,D,MTL,22,82,3,18,21
25,8475690,Chris Tanev,D,TOR,35,82,3,18,21
25,8475233,David Savard,D,MTL,34,82,3,18,21
25,8479638,Justin Brazeau,R,BOS,26,82,14,6,20
25,8482762,Simon Edvinsson,D,DET,21,82,13,7,20
25,8477406,Mattias Janmark,C,EDM,32,82,11,9,20
25,8477507,Nikita Zadorov,D,BOS,29,82,8,12,20
25,8476422,Mike Reilly,D,NYI,31,82,8,12,20
25,8479661,Tanner Jeannot,L,LAK,27,82,7,13,20
25,8480806,Isac Lundestrom,C,ANA,25,82,7,13,20
25,8484203,Bradly Nadeau,L,CAR,19,82,7,13,20
25,8483495,Simon Nemec,D,NJD,20,82,6,14,20
25,8480878,Nils Lundkvist,D,DAL,24,82,5,15,20
25,8480448,Parker Kelly,L,COL,25,82,5,15,20
25,8482655,J.J. Moser,D,TBL,24,82,4,16,20
25,8470600,Ryan Suter,D,STL,39,82,4,16,20
25,8476967,Brett Kulak,D,EDM,30,82,2,18,20
25,8476525,Colin Miller,D,WPG,32,82,2,18,20
25,8482749,Joshua Roy,R,MTL,21,82,12,7,19
25,8477931,Tomas Nosek,L,FLA,32,82,11,8,19
25,8483499,Liam Ohgren,L,MIN,20,82,11,8,19
25,8479291,Kevin Rooney,C,CGY,31,82,10,9,19
25,8480021,Jack Studnicka,C,LAK,25,82,9,10,19
25,8477839,Conor Sheary,L,TBL,32,82,7,12,19
25,8482118,Sam Colangelo,R,ANA,23,82,7,12,19
25,8475220,Marcus Foligno,L,MIN,33,82,6,13,19
25,8476467,Jamie Oleksiak,D,SEA,32,82,5,14,19
25,8478178,Darren Raddysh,D,TBL,28,82,5,14,19
25,8476312,Josh Manson,D,COL,33,82,4,15,19
25,8476891,Matt Grzelcyk,D,PIT,30,82,4,15,19
25,8480879,Jacob Bernard-Docker,D,OTT,24,82,2,17,19
25,8475790,Erik Gudbranson,D,CBJ,32,82,1,18,19
25,8480073,Erik Brannstrom,D,COL,25,82,1,18,19
25,8480281,Alexey Toropchenko,R,STL,25,82,12,6,18
25,8476442,Matt Nieto,L,PIT,32,82,8,10,18
25,8480990,Declan Chisholm,D,MIN,24,82,5,13,18
25,8482659,Josh Doan,R,UTA,22,82,4,14,18
25,8480172,Jan Rutta,D,SJS,34,82,2,16,18
25,8475855,Jesper Fast,R,CAR,33,82,8,9,17
25,8482666,Scott Morrow,D,CAR,22,82,8,9,17
25,8483445,Cutter Gauthier,L,ANA,20,82,6,11,17
25,8480796,Martin Fehervary,D,WSH,25,82,5,12,17
25,8484911,Collin Graf,R,SJS,22,82,5,12,17
25,8474567,Zach Bogosian,D,MIN,34,82,4,13,17
25,8477335,Kyle Burroughs,D,LAK,29,82,4,13,17
25,8474090,Brendan Smith,D,DAL,35,82,4,13,17
25,8477365,Connor Clifton,D,BUF,29,82,3,14,17
25,8484149,Gavin Brindley,C,CBJ,20,82,3,14,17
25,8477505,Alexander Wennberg,C,SJS,30,82,10,6,16
25,8480025,MacKenzie Entwistle,R,FLA,25,82,6,10,16
25,8481524,Bowen Byram,D,BUF,23,82,6,10,16
25,8482153,Brendan Brisson,C,VGK,23,82,5,11,16
25,8481605,Jackson LaCombe,D,ANA,23,82,3,13,16
25,8475455,Brenden Dillon,D,NJD,34,82,1,15,16
25,8480950,Ilya Lyubushkin,D,DAL,30,82,0,16,16
25,8478211,Dryden Hunt,L,CGY,29,82,10,5,15
25,8482077,Dylan Holloway,L,EDM,23,82,10,5,15
25,8478569,Noel Acciari,C,PIT,33,82,5,10,15
25,8483466,Kevin Korchinski,D,CHI,20,82,5,10,15
25,8479369,Andrew Peeke,D,BOS,26,82,3,12,15
25,8482073,Braden Schneider,D,NYR,23,82,2,13,15
25,8480834,Ty Emberson,D,SJS,24,82,2,13,15
25,8482858,Ryker Evans,D,SEA,23,82,2,13,15
25,8483471,Brad Lambert,C,WPG,31,82,2,13,15
25,8477034,Jaycob Megna,D,FLA,32,82,2,13,15
25,8482155,Alex Laferriere,R,LAK,23,82,7,7,14
25,8480870,Bo Groulx,C,NYR,24,82,6,8,14
25,8482702,Logan Stankoven,C,DAL,21,82,5,9,14
25,8482807,Ethan Del Mastro,D,CHI,21,82,5,9,14
25,8483567,Georgii Merkulov,C,BOS,24,82,5,9,14
25,8481699,Aku Raty,R,UTA,23,82,4,10,14
25,8475762,Derek Forbort,D,VAN,32,82,2,12,14
25,8476473,Connor Murphy,D,CHI,31,82,1,13,14
25,8474612,Travis Hamonic,D,OTT,34,82,0,14,14
25,8476878,Zemgus Girgensons,L,TBL,30,82,9,4,13
25,8476858,Phillip Di Giuseppe,L,VAN,31,82,9,4,13
25,8482859,Zack Ostapchuk,C,OTT,21,82,7,6,13
25,8483505,Matthew Poitras,C,BOS,20,82,6,7,13
25,8482145,Mavrik Bourque,C,DAL,22,82,6,7,13
25,8481641,Joel Kiviranta,L,COL,28,82,6,7,13
25,8483397,Marc McLaughlin,C,BOS,25,82,6,7,13
25,8474013,Ian Cole,D,UTA,35,82,5,8,13
25,8482712,Oskar Olausson,R,COL,22,82,5,8,13
25,8478468,Jeremy Lauzon,D,NSH,27,82,4,9,13
25,8476441,Joel Edmundson,D,LAK,31,82,4,9,13
25,8478443,Brandon Carlo,D,BOS,28,82,3,10,13
25,8481122,Simon Benoit,D,TOR,26,82,3,10,13
25,8477499,Rasmus Ristolainen,D,PHI,30,82,2,11,13
25,8476372,Nick Seeler,D,PHI,31,82,1,12,13
25,8477938,Haydn Fleury,D,WPG,28,82,4,8,12
25,8475718,Justin Holl,D,DET,32,82,3,9,12
25,8475177,Calvin de Haan,D,COL,33,82,3,9,12
25,8478859,Niko Mikkola,D,FLA,28,82,2,9,11
25,8483460,David Jiricek,D,CBJ,21,82,2,9,11
25,8483524,Shane Wright,C,SEA,20,82,5,5,10
25,8479442,Troy Stecher,D,EDM,30,82,5,5,10
25,8478450,Parker Wotherspoon,D,BOS,27,82,5,5,10
25,8482713,Mackie Samoskevich,R,FLA,22,82,3,7,10
25,8478874,Adam Gaudette,C,OTT,28,82,2,8,10
25,8483489,Fraser Minten,C,TOR,31,82,5,4,9
25,8476822,Luke Glendening,C,TBL,35,82,4,5,9
25,8482070,Mitchell Chaffee,R,TBL,26,82,4,5,9
25,8482516,Matthew Kessel,D,STL,24,82,1,8,9
25,8471677,Jack Johnson,D,CBJ,37,82,0,9,9
25,8474062,Riley Nash,C,NYR,35,82,4,3,7
25,8482787,Nikita Chibrikov,R,WPG,31,82,3,4,7
25,8470794,Joe Pavelski,C,,40,0,0,0,0
25,8481703,Valtteri Puustinen,R,PIT,25,0,0,0,0
25,8477950,Tony DeAngelo,D,,29,0,0,0,0
25,8481577,Philip Tomasino,C,NSH,23,0,0,0,0
25,8475197,Tyson Barrie,D,,33,0,0,0,0
25,8471218,Blake Wheeler,R,,38,0,0,0,0
25,8474157,Max Pacioretty,L,,36,0,0,0,0
25,8478466,Daniel Sprong,R,VAN,27,0,0,0,0
25,8475744,Evgeny Kuznetsov,C,,32,0,0,0,0
25,8481019,David Gustafsson,C,WPG,24,0,0,0,0
25,8475906,John Klingberg,D,,32,0,0,0,0
25,8479348,Kale Clague,D,BUF,26,0,0,0,0
25,8476952,Dominic Toninato,C,WPG,30,0,0,0,0
25,8473473,Milan Lucic,L,,36,0,0,0,0
25,8474037,James van Riemsdyk,L,,35,0,0,0,0
25,8474602,Justin Schultz,D,,34,0,0,0,0
25,8482222,Alexander Barabanov,L,,30,0,0,0,0
25,8479372,Josh Mahura,D,SEA,26,0,0,0,0
25,8479982,Conor Timmins,D,TOR,26,0,0,0,0
25,8474031,Kevin Shattenkirk,D,,35,0,0,0,0
25,8480008,Adam Ruzicka,C,,25,0,0,0,0
25,8481059,Scott Perunovich,D,STL,26,0,0,0,0
25,8480884,Calen Addison,D,,24,0,0,0,0
25,8476994,Vinnie Hinostroza,C,NSH,30,0,0,0,0
25,8478452,Caleb Jones,D,LAK,27,0,0,0,0
25,8480157,Calle Rosen,D,COL,30,0,0,0,0
25,8481609,Vladislav Kolyachonok,D,UTA,23,0,0,0,0
25,8479415,Michael McLeod,C,,26,0,0,0,0
25,8476919,Chris Tierney,C,,30,0,0,0,0
25,8479639,Dylan Coghlan,D,WPG,26,0,0,0,0
25,8478146,Matthew Highmore,C,OTT,28,0,0,0,0
25,8478970,Jalen Chatfield,D,CAR,28,0,0,0,0
25,8480205,Emil Bemstrom,C,PIT,25,0,0,0,0
25,8474884,Mike Hoffman,C,,35,0,0,0,0
25,8471274,Alex Goligoski,D,,39,0,0,0,0
25,8478104,Sammy Blais,L,,28,0,0,0,0
25,8474870,Tyler Johnson,C,,34,0,0,0,0
25,8476913,Devin Shore,C,MIN,30,0,0,0,0
25,8481598,Philip Broberg,D,EDM,23,0,0,0,0
25,8480058,Pierre-Olivier Joseph,D,STL,25,0,0,0,0
25,8480891,Michael Kesselring,D,UTA,24,0,0,0,0
25,8477979,Nicolas Aube-Kubel,R,BUF,28,0,0,0,0
25,8476871,Tanner Pearson,L,,32,0,0,0,0
25,8476393,Nick Cousins,C,,31,0,0,0,0
25,8479977,Kailer Yamamoto,R,,26,0,0,0,0
25,8479543,Michael Pezzetta,L,MTL,26,0,0,0,0
25,8477018,Ben Hutton,D,VGK,31,0,0,0,0
25,8480762,Eric Robinson,L,CAR,29,0,0,0,0
25,8474034,Pat Maroon,L,CHI,36,0,0,0,0
25,8481058,Jesse Ylönen,R,,25,0,0,0,0
25,8475179,Dmitry Kulikov,D,FLA,34,0,0,0,0
25,8481527,Kaedan Korczak,D,VGK,23,0,0,0,0
25,8473449,Kyle Okposo,R,,36,0,0,0,0
25,8482192,Isaak Phillips,D,CHI,23,0,0,0,0
25,8480727,Zach Whitecloud,D,VGK,28,0,0,0,0
25,8479346,Dillon Dube,C,,26,0,0,0,0
25,8480821,Filip Zadina,R,,25,0,0,0,0
25,8480001,Urho Vaakanainen,D,ANA,25,0,0,0,0
25,8470966,Mark Giordano,D,,41,0,0,0,0
25,8480853,Liam Foudy,C,,24,0,0,0,0
25,8475225,Craig Smith,C,CHI,35,0,0,0,0
25,8479972,Mason Shaw,C,WPG,26,0,0,0,0
25,8478451,Ethan Bear,D,WSH,27,0,0,0,0
25,8474040,Sam Gagner,C,,35,0,0,0,0
25,8480196,Jacob Bryson,D,BUF,27,0,0,0,0
25,8479984,Cal Foote,D,,26,0,0,0,0
25,8480011,Klim Kostin,C,SJS,25,0,0,0,0
25,8482176,Wyatt Kaiser,D,CHI,22,0,0,0,0
25,8476988,Matt Benning,D,SJS,30,0,0,0,0
25,8479370,Tyson Jost,C,CAR,26,0,0,0,0
25,8477464,Nic Petan,C,,29,0,0,0,0
25,8477380,Jonny Brodzinski,C,NYR,31,0,0,0,0
25,8480070,Ian Mitchell,D,BOS,25,0,0,0,0
25,8479315,Joey Anderson,R,CHI,26,0,0,0,0
25,8478099,Kevin Labanc,R,,29,0,0,0,0
25,8476874,Olli Maatta,D,DET,30,0,0,0,0
25,8475208,Brian Dumoulin,D,ANA,33,0,0,0,0
25,8478430,Oliver Kylington,D,,27,0,0,0,0
25,8479536,Axel Jonsson-Fjallby,L,WPG,26,0,0,0,0
25,8479671,Mathieu Olivier,R,CBJ,27,0,0,0,0
25,8471709,Marc-Edouard Vlasic,D,SJS,37,0,0,0,0
25,8479328,Julien Gauthier,R,NYI,27,0,0,0,0
25,8478421,A.J. Greer,L,FLA,28,0,0,0,0
25,8477573,Nathan Walker,L,STL,30,0,0,0,0
25,8481537,Nikita Okhotiuk,D,CGY,24,0,0,0,0
25,8474166,Alec Martinez,D,CHI,37,0,0,0,0
25,8470610,Zach Parise,L,,40,0,0,0,0
25,8477478,William Carrier,L,CAR,30,0,0,0,0
25,8479344,Jesse Puljujarvi,R,PIT,26,0,0,0,0
25,8480887,Jordan Harris,D,MTL,24,0,0,0,0
25,8478502,Dennis Gilbert,D,BUF,28,0,0,0,0
25,8482730,Brandt Clarke,D,LAK,21,0,0,0,0
25,8480355,Mark Kastelic,C,BOS,25,0,0,0,0
25,8475750,Jon Merrill,D,MIN,32,0,0,0,0
25,8475164,Jakob Silfverberg,R,,34,0,0,0,0
25,8477944,Jakub Vrana,L,,28,0,0,0,0
25,8479439,Jacob MacDonald,D,COL,31,0,0,0,0
25,8474568,Luke Schenn,D,NSH,35,0,0,0,0
25,8478454,Noah Juulsen,D,VAN,27,0,0,0,0
25,8475752,Tyler Pitlick,C,,33,0,0,0,0
25,8482148,Hendrix Lapierre,C,WSH,22,0,0,0,0
25,8481167,Brayden Pachal,D,CGY,25,0,0,0,0
25,8478043,Sam Lafferty,C,BUF,29,0,0,0,0
25,8479321,Lucas Johansen,D,,27,0,0,0,0
25,8471699,Andrew Cogliano,C,,37,0,0,0,0
25,8481521,Ronnie Attard,D,PHI,25,0,0,0,0
25,8481161,Jake Christiansen,D,CBJ,25,0,0,0,0
25,8479458,Nikita Zaitsev,D,,33,0,0,0,0
25,8479619,Michael Carcone,L,UTA,28,0,0,0,0
25,8479026,Philippe Myers,D,TOR,27,0,0,0,0
25,8477330,Dominik Kubalik,L,,29,0,0,0,0
25,8481617,Vasily Podkolzin,R,VAN,23,0,0,0,0
25,8481701,Santeri Hatakka,D,NJD,23,0,0,0,0
25,8479514,Rem Pitlick,C,,27,0,0,0,0
25,8477446,Michael McCarron,R,NSH,29,0,0,0,0
25,8470604,Jeff Carter,C,,39,0,0,0,0
25,8482241,Radim Zohorna,L,,28,0,0,0,0
25,8480289,Morgan Barron,C,WPG,26,0,0,0,0
25,8479379,Givani Smith,R,SJS,26,0,0,0,0
25,8480216,Jacob Peterson,C,,25,0,0,0,0
25,8477851,Jordan Oesterle,D,BOS,32,0,0,0,0
25,8484258,Sam Malinski,D,COL,26,0,0,0,0
25,8478904,Steven Lorentz,C,,28,0,0,0,0
25,8482095,Tyler Kleven,D,OTT,22,0,0,0,0
25,8480848,Ty Dellandrea,C,SJS,24,0,0,0,0
25,8476884,Derrick Pouliot,D,,30,0,0,0,0
25,8479336,Carl Grundstrom,R,SJS,27,0,0,0,0
25,8482964,Arber Xhekaj,D,MTL,23,0,0,0,0
25,8471686,Marc Staal,D,,37,0,0,0,0
25,8477887,Patrick Brown,C,BOS,32,0,0,0,0
25,8478495,Denis Gurianov,R,,27,0,0,0,0
25,8473504,Cal Clutterbuck,R,,37,0,0,0,0
25,8481550,Adam Beckman,L,NJD,23,0,0,0,0
25,8480845,Rasmus Kupari,C,WPG,24,0,0,0,0
25,8474009,Nick Bonino,C,,36,0,0,0,0
25,8478585,Derek Ryan,C,EDM,38,0,0,0,0
25,8477962,Brendan Lemieux,L,CAR,28,0,0,0,0
25,8482861,Vincent Iorio,D,WSH,22,0,0,0,0
25,8479378,Logan Stanley,D,WPG,26,0,0,0,0
25,8473446,Erik Johnson,D,PHI,36,0,0,0,0
25,8481743,Marc Del Gaizo,D,NSH,25,0,0,0,0
25,8477384,Josh Brown,D,EDM,30,0,0,0,0
25,8482165,Yan Kuznetsov,D,CGY,22,0,0,0,0
25,8478424,Jansen Harkins,C,ANA,27,0,0,0,0
25,8482144,Jack Thompson,D,SJS,22,0,0,0,0
25,8478512,Austin Czarnik,C,,32,0,0,0,0
25,8477527,Ross Johnston,L,ANA,30,0,0,0,0
25,8479383,Boris Katchouk,L,,26,0,0,0,0
25,8482094,Daemon Hunt,D,MIN,22,0,0,0,0
25,8481719,Maxwell Crozier,D,TBL,24,0,0,0,0
25,8480192,Johnathan Kovacevic,D,NJD,27,0,0,0,0
25,8479376,Victor Mete,D,,26,0,0,0,0
25,8482511,Mason Lohrei,D,BOS,23,0,0,0,0
25,8475825,Jani Hakanpää,D,,32,0,0,0,0
25,8478021,William Lagesson,D,DET,28,0,0,0,0
25,8475795,Dylan McIlrath,D,WSH,32,0,0,0,0
25,8477846,Ryan Carpenter,C,,33,0,0,0,0
25,8481056,Spencer Stastney,D,NSH,24,0,0,0,0
25,8481564,Ryan Johnson,D,BUF,23,0,0,0,0
25,8478017,Mark Friedman,D,VAN,29,0,0,0,0
25,8479320,Max Lajoie,D,SEA,27,0,0,0,0
25,8480075,Cameron Crotty,D,MIN,25,0,0,0,0
25,8484287,Cole McWard,D,VAN,23,0,0,0,0
25,8484254,Akito Hirose,D,VAN,25,0,0,0,0
25,8483407,Brandon Scanlin,D,NYR,25,0,0,0,0
25,8480274,Philip Kemp,D,EDM,25,0,0,0,0
25,8479522,Hardy Haman Aktell,D,WSH,26,0,0,0,0
25,8480007,Jonas Rondbjerg,R,VGK,25,0,0,0,0
25,8477454,Adam Erne,L,,29,0,0,0,0
25,8481679,Maxence Guenette,D,OTT,23,0,0,0,0
25,8480441,Trey Fix-Wolansky,R,CBJ,25,0,0,0,0
25,8483546,Marshall Rifai,D,TOR,26,0,0,0,0
25,8480084,Nick DeSimone,D,NJD,30,0,0,0,0
25,8481030,Jack St. Ivany,D,PIT,25,0,0,0,0
25,8481592,Jakob Pelletier,L,CGY,23,0,0,0,0
25,8478011,Louie Belpedio,D,PHI,28,0,0,0,0
25,8477930,Pierre-Edouard Bellemare,L,,39,0,0,0,0
25,8484321,Nikolas Matinpalo,D,OTT,26,0,0,0,0
25,8482067,Connor Mackey,D,NYR,28,0,0,0,0
25,8481806,Louis Crevier,D,CHI,23,0,0,0,0
25,8484326,Patrik Koch,D,UTA,28,0,0,0,0
25,8477971,Andreas Englund,D,LAK,28,0,0,0,0
25,8481751,Lukas Rousek,R,BUF,25,0,0,0,0
25,8481006,Tyler Tucker,D,STL,24,0,0,0,0
25,8476867,Brendan Gaunce,C,MIN,30,0,0,0,0
25,8479520,Brandon Duhaime,R,WSH,27,0,0,0,0
25,8477073,Kurtis MacDermid,L,NJD,30,0,0,0,0
25,8480874,Adam Ginning,D,PHI,24,0,0,0,0
25,8477473,Justin Bailey,R,SJS,29,0,0,0,0
25,8479066,Ryan Lomberg,L,CGY,30,0,0,0,0
25,8477070,Liam O'Brien,C,UTA,30,0,0,0,0
25,8474618,Marco Scandella,D,,34,0,0,0,0
25,8475797,Jarred Tinordi,D,,32,0,0,0,0
25,8481441,Joe Snively,C,DET,28,0,0,0,0
25,8477244,Chad Ruhwedel,D,NYR,34,0,0,0,0
25,8479772,Zack MacEwen,R,OTT,28,0,0,0,0
25,8481147,Reese Johnson,C,MIN,26,0,0,0,0
25,8481043,Cole Koepke,L,BOS,26,0,0,0,0
25,8483619,Filip Roos,D,OTT,25,0,0,0,0
25,8481541,Samuel Bolduc,D,NYI,24,0,0,0,0
25,8477810,Joel Hanley,D,CGY,33,0,0,0,0
25,8476907,Mackenzie MacEachern,L,,30,0,0,0,0
25,8482652,Walker Duehr,R,CGY,27,0,0,0,0
25,8477126,Jayson Megna,C,,34,0,0,0,0
25,8483398,Declan Carlile,D,TBL,31,0,0,0,0
25,8482929,Emil Lilleberg,D,TBL,23,0,0,0,0
25,8480880,Jakub Lauko,C,MIN,24,0,0,0,0
25,8480245,Olle Lycksell,R,PHI,25,0,0,0,0
25,8480252,Cole Guttman,C,CHI,25,0,0,0,0
25,8477467,Gustav Olofsson,D,SEA,30,0,0,0,0
25,8479968,Vinni Lettieri,C,BOS,29,0,0,0,0
25,8478400,Colin White,C,,27,0,0,0,0
25,8475755,Alexander Petrovic,D,DAL,32,0,0,0,0
25,8481812,Nikolai Knyzhov,D,,27,0,0,0,0
25,8481593,Jayden Struble,D,MTL,23,0,0,0,0
25,8481532,Alex Turcotte,C,LAK,23,0,0,0,0
25,8482126,Emil Andrae,D,PHI,31,0,0,0,0
25,8479944,Zach Aston-Reese,C,VGK,30,0,0,0,0
25,8471817,Ryan Reaves,R,TOR,37,0,0,0,0
25,8481206,John Ludvig,D,PIT,24,0,0,0,0
25,8481599,Victor Soderstrom,D,UTA,23,0,0,0,0
25,8480292,Carson Meyer,R,ANA,27,0,0,0,0
25,8482496,Nils Aman,C,VAN,24,0,0,0,0
25,8479718,Alex Barré-Boulet,C,MTL,27,0,0,0,0
25,8479994,Jaret Anderson-Dolan,C,WPG,25,0,0,0,0
25,8480184,Gustav Lindstrom,D,,26,0,0,0,0
25,8480890,Jan Jenik,R,OTT,24,0,0,0,0
25,8478067,Oskar Lindblom,L,,28,0,0,0,0
25,8476934,Brock McGinn,L,ANA,30,0,0,0,0
25,8479985,Cale Fleury,D,SEA,26,0,0,0,0
25,8484304,Uvis Balinskis,D,FLA,28,0,0,0,0
25,8479981,Jonah Gadjovich,L,FLA,26,0,0,0,0
25,8481716,Dmitri Voronkov,L,CBJ,24,0,0,0,0
25,8474709,Matt Martin,L,,35,0,0,0,0
25,8482634,Alex Steeves,C,TOR,25,0,0,0,0
25,8480823,Alexander Alexeyev,D,WSH,25,0,0,0,0
25,8477541,Dakota Mermis,D,TOR,30,0,0,0,0
25,8483491,Ivan Miroshnichenko,L,WSH,20,0,0,0,0
25,8478477,Mitchell Stephens,C,SEA,27,0,0,0,0
25,8481543,Nikita Alexandrov,C,STL,24,0,0,0,0
25,8479423,Alex Nylander,L,,26,0,0,0,0
25,8482451,Mikael Pyyhtia,L,CBJ,23,0,0,0,0
25,8478831,Kevin Stenlund,C,UTA,28,0,0,0,0
25,8480306,Grant Hutton,D,NYI,29,0,0,0,0
25,8478028,Fredrik Olofsson,L,,28,0,0,0,0
25,8477462,Robert Hagg,D,VGK,29,0,0,0,0
25,8477320,Anton Blidh,L,NYR,29,0,0,0,0
25,8482157,Will Cuylle,L,NYR,22,0,0,0,0
25,8482737,Zack Bolduc,C,STL,21,0,0,0,0
25,8481239,Samuel Fagemo,L,,24,0,0,0,0
25,8481600,Tobias Bjornfot,D,FLA,23,0,0,0,0
25,8478409,Anthony Richard,C,PHI,28,0,0,0,0
25,8474145,Robert Bortuzzo,D,,35,0,0,0,0
25,8475958,Michael Sgarbossa,C,WSH,32,0,0,0,0
25,8479986,Kole Lind,R,DAL,26,0,0,0,0
25,8479249,Andrew Poturalski,C,SJS,30,0,0,0,0
25,8479362,Riley Tufte,L,BOS,26,0,0,0,0
25,8479991,Jake Leschyshyn,C,NYR,25,0,0,0,0
25,8479587,Rhett Gardner,C,PHI,28,0,0,0,0
25,8482744,James Malatesta,L,CBJ,21,0,0,0,0
25,8478854,Ryan Shea,D,PIT,27,0,0,0,0
25,8481591,Sam Poulin,R,,23,0,0,0,0
25,8483512,Matt Savoie,C,EDM,20,0,0,0,0
25,8482102,Vasily Ponomarev,C,PIT,22,0,0,0,0
25,8482162,Roby Jarventie,L,EDM,22,0,0,0,0
25,8481016,Ruslan Iskhakov,C,,24,0,0,0,0
25,8482172,Landon Slaggert,L,CHI,22,0,0,0,0
25,8482747,Brennan Othmann,L,NYR,21,0,0,0,0
25,8480031,Maxime Comtois,L,,25,0,0,0,0
25,8480226,Marián Studenic,R,,26,0,0,0,0
25,8478408,Travis Dermott,D,,28,0,0,0,0
25,8481518,Nolan Foote,L,NJD,24,0,0,0,0
25,8479419,Brett Murray,L,BUF,26,0,0,0,0
25,8482088,Justin Sourdif,R,FLA,22,0,0,0,0
25,8482201,Gage Goncalves,C,TBL,23,0,0,0,0
25,8481578,Graeme Clarke,R,MIN,23,0,0,0,0
25,8482177,Marat Khusnutdinov,C,MIN,22,0,0,0,0
25,8481754,Nikita Nesterenko,C,ANA,23,0,0,0,0
25,8483531,Brian Halonen,L,NJD,25,0,0,0,0
25,8483920,Pierrick Dube,R,WSH,23,0,0,0,0
25,8480851,Akil Thomas,C,LAK,24,0,0,0,0
25,8475235,Nicolas Deslauriers,L,PHI,33,0,0,0,0
25,8482476,Emil Heineman,L,MTL,23,0,0,0,0
25,8477149,Scott Sabourin,R,SJS,32,0,0,0,0
25,8483549,Lucas Condotta,L,MTL,27,0,0,0,0
25,8482765,Isak Rosen,R,BUF,21,0,0,0,0
25,8481237,Kyle MacLean,C,NYI,25,0,0,0,0
25,8481024,Linus Karlsson,C,VAN,25,0,0,0,0
25,8481690,Tyler Angle,C,,24,0,0,0,0
25,8483570,Ben Meyers,C,SEA,26,0,0,0,0
25,8481655,Cole Schwindt,R,CGY,23,0,0,0,0
25,8481462,Mason Morelli,L,VGK,28,0,0,0,0
25,8483401,Marc Johnstone,R,PIT,28,0,0,0,0
25,8478956,Samuel Laberge,L,NJD,27,0,0,0,0
25,8479533,Joona Koppanen,L,,26,0,0,0,0
25,8482197,Adam Raska,R,MIN,23,0,0,0,0
25,8482250,Callahan Burke,C,VGK,27,0,0,0,0
25,8482784,Zach Dean,C,STL,21,0,0,0,0
25,8484255,Jason Polin,R,COL,25,0,0,0,0
25,8481077,John Leonard,L,,26,0,0,0,0
25,8481534,Raphael Lavoie,C,EDM,24,0,0,0,0
25,8483609,Adam Klapka,R,CGY,24,0,0,0,0
25,8482751,Ryan Winterton,C,SEA,21,0,0,0,0
25,8480267,Sammy Walker,C,MIN,25,0,0,0,0
25,8475766,Austin Watson,L,,32,0,0,0,0
25,8482460,Matt Rempe,C,NYR,22,0,0,0,0
25,8481065,Angus Crookshank,L,OTT,25,0,0,0,0
25,8481070,Hugh McGing,L,,26,0,0,0,0
25,8476323,Max McCormick,L,SEA,32,0,0,0,0
25,8483395,Arshdeep Bains,L,VAN,23,0,0,0,0
25,8484259,Ondrej Pavel,C,COL,31,0,0,0,0
25,8483432,Luca Del Bel Belluz,C,CBJ,31,0,0,0,0
25,8483045,Cameron Butler,R,CBJ,31,0,0,0,0
25,8482061,Brandon Biro,L,SEA,26,0,0,0,0
25,8477401,John Hayden,C,SEA,29,0,0,0,0
25,8475278,Byron Froese,C,,33,0,0,0,0
25,8478446,Glenn Gawdin,C,LAK,27,0,0,0,0
25,8477993,Justin Kirkland,C,CGY,28,0,0,0,0
25,8482147,Jean-Luc Foudy,C,COL,22,0,0,0,0
25,8480032,Shane Bowers,C,NJD,25,0,0,0,0
25,8479330,Brandon Gignac,C,MTL,27,0,0,0,0
25,8480776,Sheldon Rempal,R,,29,0,0,0,0
25,8475413,Justin Dowling,C,NJD,34,0,0,0,0
25,8481726,Adam Edstrom,C,NYR,24,0,0,0,0
25,8480844,Grigori Denisenko,L,VGK,24,0,0,0,0
25,8478147,Bokondji Imama,L,PIT,28,0,0,0,0
25,8478881,Brett Seney,L,CHI,28,0,0,0,0
25,8483630,Pavol Regenda,L,ANA,25,0,0,0,0
25,8480836,Jonathan Gruden,C,,24,0,0,0,0
25,8484314,Jiri Smejkal,L,,28,0,0,0,0
25,8475780,Chris Wagner,R,COL,33,0,0,0,0
25,8479546,Oskar Steen,C,,26,0,0,0,0
25,8483597,Milos Kelemen,L,UTA,25,0,0,0,0
25,8481789,Tye Kartye,L,SEA,23,0,0,0,0
25,8484325,Waltteri Merela,C,TBL,26,0,0,0,0
25,8479421,Jacob Moverare,D,LAK,26,0,0,0,0
25,8481585,Egor Afanasyev,L,SJS,23,0,0,0,0
25,8479547,Matthew Phillips,R,,26,0,0,0,0
25,8479367,William Lockwood,R,FLA,26,0,0,0,0
25,8476915,Jujhar Khaira,L,,30,0,0,0,0
25,8481422,Jacob Lucchini,C,NSH,29,0,0,0,0
25,8480468,James Hamblin,L,EDM,25,0,0,0,0
25,8478051,Max Willman,C,NJD,29,0,0,0,0
25,8481556,John Beecher,C,BOS,23,0,0,0,0
25,8478078,Rourke Chartier,C,,28,0,0,0,0
26,8478402,Connor McDavid,C,EDM,27,82,51,95,146
26,8476453,Nikita Kucherov,R,TBL,31,82,40,88,128
26,8479318,Auston Matthews,C,TOR,27,82,60,57,117
26,8477492,Nathan MacKinnon,C,COL,29,82,47,69,116
26,8477939,William Nylander,R,TOR,28,82,48,67,115
26,8481559,Jack Hughes,C,NJD,23,82,42,70,112
26,8479314,Matthew Tkachuk,L,FLA,27,82,39,73,112
26,8476468,J.T. Miller,C,VAN,31,82,25,84,109
26,8476887,Filip Forsberg,L,NSH,30,82,52,55,107
26,8480069,Cale Makar,D,COL,26,82,26,81,107
26,8478420,Mikko Rantanen,R,COL,28,82,39,66,105
26,8477934,Leon Draisaitl,C,EDM,29,82,36,68,104
26,8477946,Dylan Larkin,C,DET,28,82,46,57,103
26,8478864,Kirill Kaprizov,L,MIN,27,82,38,65,103
26,8477956,David Pastrnak,R,BOS,28,82,56,46,102
26,8477493,Aleksander Barkov,C,FLA,29,82,40,62,102
26,8478550,Artemi Panarin,L,NYR,33,82,29,71,100
26,8476460,Mark Scheifele,C,WPG,31,82,42,54,96
26,8477942,Kevin Fiala,L,LAK,28,82,29,66,95
26,8478398,Kyle Connor,L,WPG,28,82,36,58,94
26,8478414,Timo Meier,R,NJD,28,82,47,46,93
26,8480002,Nico Hischier,C,NJD,25,82,40,53,93
26,8474564,Steven Stamkos,C,NSH,34,82,34,58,92
26,8480012,Elias Pettersson,C,VAN,26,82,43,47,90
26,8475172,Nazem Kadri,C,CGY,34,82,30,60,90
26,8480801,Brady Tkachuk,L,OTT,25,82,44,44,88
26,8481523,Kirby Dach,C,MTL,23,82,18,70,88
26,8475166,John Tavares,C,TOR,34,82,44,43,87
26,8480830,Andrei Svechnikov,R,CAR,24,82,37,50,87
26,8478445,Mathew Barzal,C,NYI,27,82,28,59,87
26,8478427,Sebastian Aho,C,CAR,27,82,33,53,86
26,8480208,Drake Batherson,R,OTT,26,82,31,55,86
26,8477501,Valeri Nichushkin,R,COL,29,82,43,41,84
26,8477933,Sam Reinhart,C,FLA,29,82,36,48,84
26,8480800,Quinn Hughes,D,VAN,25,82,13,70,83
26,8471675,Sidney Crosby,C,PIT,37,82,42,40,82
26,8479343,Clayton Keller,R,UTA,26,82,41,41,82
26,8471685,Anze Kopitar,C,LAK,37,82,23,59,82
26,8480036,Miro Heiskanen,D,DAL,25,82,17,65,82
26,8478010,Brayden Point,C,TBL,28,82,38,42,80
26,8471214,Alex Ovechkin,L,WSH,39,82,36,44,80
26,8479385,Jordan Kyrou,C,STL,26,82,33,47,80
26,8476389,Vincent Trocheck,C,NYR,31,82,33,47,80
26,8480027,Jason Robertson,L,DAL,25,82,24,56,80
26,8479420,Tage Thompson,C,BUF,27,82,42,37,79
26,8475810,Bryan Rust,R,PIT,32,82,33,46,79
26,8475184,Chris Kreider,L,NYR,33,82,49,29,78
26,8475726,Tyler Toffoli,C,SJS,32,82,38,40,78
26,8481557,Matt Boldy,L,MIN,23,82,25,53,78
26,8477949,Alex Tuch,R,BUF,28,82,25,53,78
26,8476346,Johnny Gaudreau,L,CBJ,31,82,20,58,78
26,8478403,Jack Eichel,C,VGK,28,82,35,42,77
26,8478401,Pavel Zacha,C,BOS,27,82,29,48,77
26,8480023,Robert Thomas,C,STL,25,82,23,54,77
26,8477951,Nick Schmaltz,C,UTA,28,82,23,54,77
26,8479407,Jesper Bratt,L,NJD,26,82,22,55,77
26,8474600,Roman Josi,D,NSH,34,82,20,57,77
26,8476881,Tomas Hertl,C,VGK,31,82,37,39,76
26,8477404,Jake Guentzel,C,TBL,30,82,33,43,76
26,8478439,Travis Konecny,R,PHI,27,82,27,49,76
26,8474141,Patrick Kane,R,DET,36,82,24,52,76
26,8475765,Vladimir Tarasenko,R,DET,33,82,36,39,75
26,8482745,Mason McTavish,C,ANA,21,82,32,43,75
26,8475692,Mats Zuccarello,R,MIN,37,82,20,55,75
26,8480839,Rasmus Dahlin,D,BUF,24,82,18,57,75
26,8477940,Nikolaj Ehlers,L,WPG,28,82,29,45,74
26,8478975,Mason Marchment,L,DAL,29,82,36,37,73
26,8482665,Matty Beniers,C,SEA,22,82,31,42,73
26,8477496,Elias Lindholm,C,BOS,30,82,29,44,73
26,8473419,Brad Marchand,L,BOS,36,82,27,46,73
26,8482116,Tim Stützle,C,OTT,22,82,25,48,73
26,8476454,Ryan Nugent-Hopkins,C,EDM,31,82,23,50,73
26,8475786,Zach Hyman,L,EDM,32,82,38,34,72
26,8479325,Charlie McAvoy,D,BOS,27,82,22,50,72
26,8477504,Josh Morrissey,D,WPG,29,82,19,53,72
26,8478498,Jake DeBrusk,L,VAN,28,82,38,33,71
26,8478449,Roope Hintz,C,DAL,28,82,34,37,71
26,8482093,Seth Jarvis,C,CAR,22,82,34,37,71
26,8476456,Jonathan Huberdeau,C,CGY,31,82,15,56,71
26,8476459,Mika Zibanejad,C,NYR,31,82,28,42,70
26,8473994,Jamie Benn,L,DAL,35,82,28,42,70
26,8476853,Morgan Rielly,D,TOR,30,82,8,62,70
26,8475169,Evander Kane,L,EDM,33,82,34,35,69
26,8475754,Brock Nelson,C,NYI,33,82,27,42,69
26,8475913,Mark Stone,R,VGK,32,82,21,48,69
26,8476539,Jonathan Marchessault,R,NSH,34,82,38,30,68
26,8475168,Matt Duchene,C,DAL,33,82,32,36,68
26,8477497,Sean Monahan,C,CBJ,30,82,20,48,68
26,8479323,Adam Fox,D,NYR,26,82,12,56,68
26,8480803,Evan Bouchard,D,EDM,25,82,9,59,68
26,8480014,Gabriel Vilardi,C,WPG,25,82,41,26,67
26,8477503,Max Domi,C,TOR,29,82,17,50,67
26,8475170,Brayden Schenn,C,STL,33,82,36,30,66
26,8477960,Adrian Kempe,R,LAK,28,82,32,34,66
26,8475784,Jeff Skinner,C,EDM,32,82,31,35,66
26,8477407,Anthony Duclair,L,NYI,29,82,28,38,66
26,8476462,Dougie Hamilton,D,NJD,31,82,26,40,66
26,8475794,Tyler Seguin,C,DAL,32,82,25,41,66
26,8481542,Moritz Seider,D,DET,23,82,9,57,66
26,8478042,Viktor Arvidsson,R,EDM,31,82,34,31,65
26,8477447,Shea Theodore,D,VGK,29,82,17,48,65
26,8479675,Trevor Moore,L,LAK,29,82,36,28,64
26,8479337,Alex DeBrincat,R,DET,27,82,32,32,64
26,8477402,Pavel Buchnevich,L,STL,29,82,25,39,64
26,8481711,Matias Maccelli,L,UTA,24,82,24,40,64
26,8481068,Yegor Sharangovich,C,CGY,26,82,39,24,63
26,8477500,Bo Horvat,C,NYI,29,82,33,30,63
26,8479339,Patrik Laine,L,CBJ,26,82,31,32,63
26,8475798,Mikael Granlund,C,SJS,32,82,17,46,63
26,8480865,Noah Dobson,D,NYI,24,82,14,49,63
26,8477955,Jared McCann,L,SEA,28,82,36,26,62
26,8481533,Trevor Zegras,C,ANA,23,82,27,35,62
26,8480039,Martin Necas,C,CAR,25,82,20,42,62
26,8474590,John Carlson,D,WSH,34,82,13,49,62
26,8474679,Gustav Nyquist,C,NSH,35,82,5,57,62
26,8476448,William Karlsson,C,VGK,31,82,30,31,61
26,8478873,Troy Terry,R,ANA,27,82,22,39,61
26,8475191,Reilly Smith,R,NYR,33,82,22,39,61
26,8480018,Nick Suzuki,C,MTL,25,82,21,40,61
26,8475745,Charlie Coyle,C,BOS,32,82,21,40,61
26,8474578,Erik Karlsson,D,PIT,34,82,16,45,61
26,8478047,Michael Bunting,L,PIT,29,82,30,30,60
26,8478444,Brock Boeser,R,VAN,27,82,29,31,60
26,8473512,Claude Giroux,R,OTT,36,82,27,33,60
26,8482124,Quinton Byfield,R,LAK,22,82,20,40,60
26,8478038,Devon Toews,D,COL,30,82,16,44,60
26,8482109,Alexis Lafrenière,L,NYR,23,82,33,26,59
26,8481540,Cole Caufield,R,MTL,23,82,30,29,59
26,8475158,Ryan O'Reilly,C,NSH,33,82,30,29,59
26,8478519,Anthony Cirelli,C,TBL,27,82,25,34,59
26,8471215,Evgeni Malkin,C,PIT,38,82,20,39,59
26,8476869,Brady Skjei,D,NSH,30,82,15,44,59
26,8470613,Brent Burns,D,CAR,39,82,13,46,59
26,8476483,Rickard Rakell,R,PIT,31,82,31,27,58
26,8479542,Brandon Hagel,L,TBL,26,82,27,31,58
26,8482078,Lucas Raymond,L,DET,22,82,26,32,58
26,8474053,Logan Couture,C,SJS,35,82,25,33,58
26,8478407,Vince Dunn,D,SEA,28,82,10,48,58
26,8474565,Alex Pietrangelo,D,VGK,34,82,8,50,58
26,8479425,Filip Hronek,D,VAN,27,82,8,50,58
26,8478493,Joel Eriksson Ek,C,MIN,27,82,30,27,57
26,8481560,Arthur Kaliyev,R,LAK,23,82,30,27,57
26,8478462,Nicolas Roy,C,VGK,27,82,24,33,57
26,8478856,Conor Garland,R,VAN,28,82,20,37,57
26,8473986,Alex Killorn,L,ANA,35,82,19,38,57
26,8476432,Boone Jenner,C,CBJ,31,82,38,18,56
26,8477998,Warren Foegele,L,LAK,28,82,25,31,56
26,8480798,Philipp Kurashev,C,CHI,25,82,22,34,56
26,8475167,Victor Hedman,D,TBL,34,82,11,45,56
26,8476906,Shayne Gostisbehere,D,CAR,31,82,10,46,56
26,8481528,Dylan Cozens,C,BUF,23,82,27,28,55
26,8481624,Ilya Mikheyev,R,CHI,30,82,27,28,55
26,8477409,Carter Verhaeghe,C,FLA,29,82,25,30,55
26,8482740,Wyatt Johnston,C,DAL,21,82,25,30,55
26,8478413,Jordan Greenway,L,BUF,27,82,24,31,55
26,8476479,Phillip Danault,C,LAK,31,82,21,34,55
26,8480078,Filip Chytil,C,NYR,25,82,17,38,55
26,8482159,Tyson Foerster,R,PHI,22,82,27,27,54
26,8476872,Scott Laughton,C,PHI,30,82,24,30,54
26,8480220,Noah Cates,L,PHI,25,82,20,34,54
26,8481596,Shane Pinto,C,OTT,24,82,15,39,54
26,8482684,Luke Hughes,D,NJD,21,82,14,40,54
26,8478460,Zach Werenski,D,CBJ,27,82,12,42,54
26,8476905,Chandler Stephenson,C,SEA,30,82,11,43,54
26,8475314,Anders Lee,L,NYI,34,82,30,23,53
26,8478366,Frank Vatrano,R,ANA,30,82,27,26,53
26,8478057,Dakota Joshua,C,VAN,28,82,27,26,53
26,8477451,Ryan Hartman,R,MIN,30,82,26,27,53
26,8478474,Lawson Crouse,L,UTA,27,82,25,28,53
26,8482097,Jack Quinn,R,BUF,23,82,24,29,53
26,8474586,Jordan Eberle,R,SEA,34,82,23,30,53
26,8482699,Dylan Guenther,R,UTA,21,82,22,31,53
26,8482149,Cole Perfetti,C,WPG,22,82,20,33,53
26,8475287,Erik Haula,L,NJD,33,82,20,33,53
26,8479999,Casey Mittelstadt,C,COL,26,82,19,34,53
26,8476461,Sean Couturier,C,PHI,32,82,18,35,53
26,8478440,Dylan Strome,C,WSH,27,82,14,39,53
26,8474102,David Perron,L,OTT,36,82,24,28,52
26,8478458,Jack Roslovic,C,CAR,27,82,18,34,52
26,8480015,Owen Tippett,R,PHI,25,82,20,31,51
26,8477964,Ivan Barbashev,C,VGK,29,82,20,31,51
26,8480028,Morgan Frost,C,PHI,25,82,19,32,51
26,8477498,Darnell Nurse,D,EDM,29,82,10,41,51
26,8476399,Blake Coleman,C,CGY,33,82,31,19,50
26,8477416,Oliver Bjorkstrand,R,SEA,29,82,22,28,50
26,8478438,Tommy Novak,C,NSH,27,82,22,28,50
26,8478542,Evan Rodrigues,C,FLA,31,82,19,31,50
26,8475753,Justin Faulk,D,STL,32,82,14,36,50
26,8481618,Alex Newhook,C,MTL,23,82,22,27,49
26,8480188,Fabian Zetterlund,L,SJS,25,82,20,29,49
26,8479987,Morgan Geekie,C,BOS,26,82,19,30,49
26,8480797,Joel Farabee,L,PHI,24,82,17,32,49
26,8477479,Tyler Bertuzzi,L,CHI,29,82,17,32,49
26,8477021,Alex Kerfoot,C,UTA,30,82,16,33,49
26,8478055,Gustav Forsling,D,FLA,28,82,14,35,49
26,8476875,Mike Matheson,D,MTL,30,82,12,37,49
26,8478397,Rasmus Andersson,D,CGY,28,82,11,38,49
26,8479410,Mikhail Sergachev,D,UTA,26,82,9,40,49
26,8477476,Artturi Lehkonen,L,COL,29,82,26,22,48
26,8473533,Jordan Staal,C,CAR,36,82,25,22,47
26,8474641,Adam Henrique,C,EDM,34,82,24,23,47
26,8480849,Barrett Hayton,C,UTA,24,82,22,25,47
26,8479996,Cody Glass,C,NSH,25,82,21,26,47
26,8476882,Teuvo Teravainen,L,CHI,30,82,20,27,47
26,8484144,Connor Bedard,C,CHI,19,82,20,27,47
26,8478233,Andrew Mangiapane,L,WSH,28,82,18,29,47
26,8476458,Ryan Strome,C,ANA,31,82,14,33,47
26,8477429,Andrew Copp,C,DET,30,82,14,33,47
26,8478396,Noah Hanifin,D,VGK,27,82,7,40,47
26,8475151,Kyle Palmieri,C,NYI,33,82,23,23,46
26,8476438,Brandon Saad,L,STL,32,82,21,25,46
26,8477953,Kasperi Kapanen,R,STL,28,82,18,28,46
26,8482660,Kent Johnson,C,CBJ,22,82,14,32,46
26,8482105,Jake Sanderson,D,OTT,22,82,12,34,46
26,8477935,Sam Bennett,C,FLA,28,82,25,20,45
26,8482705,Cole Sillinger,C,CBJ,21,82,22,23,45
26,8475722,Jason Zucker,L,BUF,32,82,21,24,45
26,8477511,Anthony Mantha,R,CGY,30,82,21,24,45
26,8482720,Matthew Knies,L,TOR,22,82,19,26,45
26,8477456,J.T. Compher,L,DET,29,82,19,26,45
26,8482667,William Eklund,L,SJS,22,82,17,28,45
26,8479345,Jakob Chychrun,D,WSH,26,82,17,28,45
26,8477495,Seth Jones,D,CHI,30,82,10,35,45
26,8481535,Nils Hoglander,L,VAN,24,82,28,16,44
26,8480064,Josh Norris,C,OTT,25,82,25,19,44
26,8480829,Jesperi Kotkaniemi,C,CAR,24,82,24,20,44
26,8482146,Luke Evangelista,R,NSH,22,82,22,22,44
26,8479992,Michael Rasmussen,C,DET,25,82,21,23,44
26,8476292,Ondrej Palat,L,NJD,33,82,20,24,44
26,8475714,Calle Jarnkrok,C,TOR,33,82,16,28,44
26,8478469,Thomas Chabot,D,OTT,27,82,11,33,44
26,8477494,Jonathan Drouin,L,COL,29,82,10,34,44
26,8476923,Damon Severson,D,CBJ,30,82,10,34,44
26,8471724,Kris Letang,D,PIT,37,82,6,38,44
26,8482113,Anton Lundell,C,FLA,23,82,19,24,43
26,8483808,Andrei Kuzmenko,L,CGY,28,82,19,24,43
26,8480802,Ryan McLeod,C,BUF,25,82,15,28,43
26,8474150,Mikael Backlund,C,CGY,35,82,14,29,43
26,8478472,Mathieu Joseph,R,STL,27,82,9,34,43
26,8480009,Eeli Tolvanen,R,SEA,25,82,25,17,42
26,8481604,Pavel Dorofeyev,L,VGK,24,82,20,22,42
26,8475799,Nino Niederreiter,R,WPG,32,82,19,23,42
26,8476826,Yanni Gourde,C,SEA,33,82,19,23,42
26,8478891,Mason Appleton,C,WPG,28,82,19,23,42
26,8475791,Taylor Hall,L,CHI,33,82,15,27,42
26,8477986,Brandon Montour,D,SEA,30,82,15,27,42
26,8477948,Travis Sanheim,D,PHI,28,82,12,30,42
26,8480434,Sean Durzi,D,UTA,26,82,10,32,42
26,8477932,Aaron Ekblad,D,FLA,28,82,9,33,42
26,8471698,T.J. Oshie,R,WSH,38,82,21,20,41
26,8477987,Ryan Donato,C,CHI,28,82,17,24,41
26,8482475,Yegor Chinakhov,R,CBJ,23,82,17,24,41
26,8475768,Jaden Schwartz,C,SEA,32,82,14,27,41
26,8476792,Torey Krug,D,STL,33,82,14,27,41
26,8478133,Jake Evans,C,MTL,28,82,12,29,41
26,8481546,Cam York,D,PHI,23,82,10,31,41
26,8476885,Jacob Trouba,D,NYR,30,82,9,32,41
26,8480873,Rasmus Sandin,D,WSH,24,82,7,34,41
26,8474563,Drew Doughty,D,LAK,35,82,2,39,41
26,8475848,Brendan Gallagher,R,MTL,32,82,21,19,40
26,8479365,Trent Frederic,C,BOS,26,82,18,22,40
26,8477903,Garnet Hathaway,R,PHI,33,82,17,23,40
26,8477444,Andre Burakovsky,L,SEA,29,82,16,24,40
26,8481554,Kaapo Kakko,R,NYR,23,82,16,24,40
26,8483515,Juraj Slafkovsky,L,MTL,20,82,11,29,40
26,8476854,Hampus Lindholm,D,BOS,30,82,6,34,40
26,8476958,Jaccob Slavin,D,CAR,30,82,6,34,40
26,8475760,Nick Bjugstad,C,UTA,32,82,22,17,39
26,8480893,Kirill Marchenko,R,CBJ,24,82,21,18,39
26,8476880,Tom Wilson,R,WSH,30,82,20,19,39
26,8479353,Brett Howden,C,VGK,26,82,19,20,39
26,8477947,Sonny Milano,L,WSH,28,82,18,21,39
26,8482110,Dawson Mercer,C,NJD,23,82,15,24,39
26,8479400,Pierre-Luc Dubois,L,WSH,26,82,14,25,39
26,8476474,Stefan Noesen,R,NJD,31,82,14,25,39
26,8477952,Robby Fabbri,C,ANA,28,82,24,14,38
26,8474149,Evgenii Dadonov,R,DAL,35,82,20,18,38
26,8480074,Alexandre Texier,C,STL,25,82,18,20,38
26,8480113,Alex Iafallo,L,WPG,31,82,18,20,38
26,8474716,Jared Spurgeon,D,MIN,35,82,7,31,38
26,8477969,Marcus Pettersson,D,PIT,28,82,6,32,38
26,8481581,Thomas Harley,D,DAL,23,82,5,33,38
26,8478046,Danton Heinen,L,VAN,29,82,21,16,37
26,8482092,Ridly Greig,C,OTT,22,82,17,20,37
26,8477426,Nicholas Paul,L,TBL,29,82,16,21,37
26,8481013,Jonatan Berggren,R,DET,24,82,16,21,37
26,8479293,Brandon Tanev,L,SEA,33,82,16,21,37
26,8476392,Adam Lowry,C,WPG,31,82,14,23,37
26,8480145,Neal Pionk,D,WPG,29,82,9,28,37
26,8476902,Esa Lindell,D,DAL,30,82,8,29,37
26,8481582,Nicholas Robertson,L,TOR,23,82,21,15,36
26,8480748,Kiefer Sherwood,L,VAN,29,82,20,16,36
26,8479390,Taylor Raddysh,R,WSH,26,82,19,17,36
26,8473422,Nick Foligno,L,CHI,37,82,15,21,36
26,8481656,Aliaksei Protas,C,WSH,23,82,13,23,36
26,8476329,Travis Boyd,C,MIN,31,82,12,24,36
26,8482671,Owen Power,D,BUF,22,82,7,29,36
26,8474151,Ryan McDonagh,D,TBL,35,82,5,31,36
26,8477506,Ryan Pulock,D,NYI,30,82,5,31,36
26,8482089,Jake Neighbours,L,STL,22,82,20,15,35
26,8482175,JJ Peterka,R,BUF,22,82,17,18,35
26,8482055,Drew O'Connor,L,PIT,26,82,16,19,35
26,8478115,Pierre Engvall,L,NYI,28,82,16,19,35
26,8480336,Sean Walker,D,CAR,30,82,10,25,35
26,8480871,Adam Boqvist,D,FLA,24,82,9,26,35
26,8481606,Jordan Spence,D,LAK,23,82,9,26,35
26,8480144,David Kampf,C,TOR,29,82,9,26,35
26,8479983,Mario Ferraro,D,SJS,26,82,5,30,35
26,8479525,Ross Colton,C,COL,28,82,19,15,34
26,8479941,Justin Danforth,R,CBJ,31,82,18,16,34
26,8475149,Marcus Johansson,L,MIN,34,82,18,16,34
26,8475793,Ryan Johansen,C,PHI,32,82,17,17,34
26,8482079,Marco Rossi,C,MIN,23,82,17,17,34
26,8475181,Nick Leddy,D,STL,33,82,7,27,34
26,8476979,Erik Gustafsson,D,DET,32,82,5,29,34
26,8476931,Jake McCabe,D,TOR,31,82,3,31,34
26,8475764,Cam Fowler,D,ANA,33,82,2,32,34
26,8478109,Victor Olofsson,L,VGK,29,82,19,14,33
26,8483457,Lane Hutson,D,MTL,20,82,18,15,33
26,8480068,Ryan Poehling,C,PHI,25,82,17,16,33
26,8479661,Tanner Jeannot,L,LAK,27,82,17,16,33
26,8476960,Andreas Athanasiou,C,CHI,30,82,16,17,33
26,8483431,Logan Cooley,C,UTA,20,82,15,18,33
26,8474189,Lars Eller,C,PIT,35,82,14,19,33
26,8476927,Teddy Blueger,C,VAN,30,82,12,21,33
26,8475763,Kevin Hayes,R,PIT,32,82,11,22,33
26,8475218,Mattias Ekholm,D,EDM,34,82,9,24,33
26,8476925,Colton Sissons,C,NSH,31,82,8,25,33
26,8476917,Adam Pelech,D,NYI,30,82,4,29,33
26,8480459,Pius Suter,C,VAN,28,82,17,15,32
26,8480835,Jack Drury,C,CAR,24,82,16,16,32
26,8476921,Jordan Martinook,L,CAR,32,82,16,16,32
26,8482125,Alexander Holtz,R,VGK,22,82,15,17,32
26,8480789,Oliver Wahlstrom,R,NYI,24,82,15,17,32
26,8484153,Leo Carlsson,C,ANA,20,82,13,19,32
26,8476419,Jean-Gabriel Pageau,C,NYI,32,82,10,22,32
26,8480817,K'Andre Miller,D,NYR,24,82,9,23,32
26,8477346,MacKenzie Weegar,D,CGY,30,82,6,26,32
26,8481186,Logan O'Connor,R,COL,28,82,17,14,31
26,8477931,Tomas Nosek,L,FLA,32,82,15,16,31
26,8482117,Lukas Reichel,L,CHI,22,82,14,17,31
26,8474715,Cam Atkinson,R,TBL,35,82,14,17,31
26,8477353,Tyler Motte,C,DET,29,82,14,17,31
26,8476374,Sean Kuraly,C,CBJ,31,82,13,18,31
26,8475343,Nic Dowd,C,WSH,34,82,12,19,31
26,8481522,Peyton Krebs,C,BUF,23,82,12,19,31
26,8479414,Nathan Bastian,R,NJD,27,82,12,19,31
26,8482807,Ethan Del Mastro,D,CHI,21,82,12,19,31
26,8481517,Brett Leason,R,ANA,25,82,11,20,31
26,8477406,Mattias Janmark,C,EDM,32,82,10,21,31
26,8475171,Oliver Ekman-Larsson,D,TOR,33,82,8,23,31
26,8478882,Vladislav Gavrikov,D,LAK,29,82,5,26,31
26,8482245,Artem Zub,D,OTT,29,82,3,28,31
26,8478020,Michael Amadio,C,OTT,28,82,15,15,30
26,8476918,Jimmy Vesey,L,NYR,31,82,13,17,30
26,8481028,Martin Pospisil,C,CGY,25,82,13,17,30
26,8482133,Thomas Bordeleau,C,SJS,22,82,10,20,30
26,8478136,Jake Middleton,D,MIN,28,82,9,21,30
26,8477488,Brett Pesce,D,NJD,30,82,9,21,30
26,8480185,Eetu Luostarinen,C,FLA,26,82,8,22,30
26,8479398,Samuel Girard,D,COL,26,82,7,23,30
26,8479402,Jake Bean,D,CGY,26,82,5,25,30
26,8480049,Dylan Samberg,D,WPG,25,82,1,29,30
26,8482259,Bobby McMann,C,TOR,28,82,18,11,29
26,8477989,Christian Dvorak,C,MTL,28,82,17,12,29
26,8475855,Jesper Fast,R,CAR,33,82,15,14,29
26,8476873,Mark Jankowski,C,NSH,30,82,12,17,29
26,8480806,Isac Lundestrom,C,ANA,25,82,12,17,29
26,8476981,Josh Anderson,R,MTL,30,82,11,18,29
26,8484166,Adam Fantilli,C,CBJ,20,82,11,18,29
26,8478911,Matt Roy,D,WSH,29,82,5,24,29
26,8482166,Shakir Mukhamadullin,D,SJS,22,82,4,25,29
26,8475188,Brayden McNabb,D,VGK,33,82,4,25,29
26,8482155,Alex Laferriere,R,LAK,23,82,15,13,28
26,8479393,Noah Gregor,C,OTT,26,82,13,15,28
26,8476480,Vladislav Namestnikov,C,WPG,32,82,12,16,28
26,8477450,Jason Dickinson,C,CHI,29,82,12,16,28
26,8481553,Bobby Brink,R,PHI,23,82,12,16,28
26,8475200,Dmitry Orlov,D,CAR,33,82,10,18,28
26,8475193,Tomas Tatar,L,NJD,34,82,9,19,28
26,8477499,Rasmus Ristolainen,D,PHI,30,82,7,21,28
26,8475790,Erik Gudbranson,D,CBJ,32,82,4,24,28
26,8470600,Ryan Suter,D,STL,39,82,3,25,28
26,8479369,Andrew Peeke,D,BOS,26,82,3,25,28
26,8477839,Conor Sheary,L,TBL,32,82,16,11,27
26,8482077,Dylan Holloway,L,EDM,23,82,16,11,27
26,8481601,Simon Holmstrom,R,NYI,23,82,15,12,27
26,8478211,Dryden Hunt,L,CGY,29,82,14,13,27
26,8479368,Max Jones,L,BOS,26,82,13,14,27
26,8477508,Curtis Lazar,C,NJD,29,82,12,15,27
26,8483468,Jiri Kulich,C,BUF,20,82,11,16,27
26,8473563,Nicklas Backstrom,C,WSH,37,82,10,17,27
26,8478463,Anthony Beauvillier,L,PIT,27,82,10,17,27
26,8479359,Beck Malenstyn,L,BUF,26,82,9,18,27
26,8479351,Sam Steel,C,DAL,26,82,9,18,27
26,8476897,Oskar Sundqvist,C,STL,30,82,7,20,27
26,8480222,Sebastian Aho,D,PIT,28,82,6,21,27
26,8476422,Mike Reilly,D,NYI,31,82,6,21,27
26,8477365,Connor Clifton,D,BUF,29,82,6,21,27
26,8473507,Jeff Petry,D,DET,37,82,5,22,27
26,8476457,Adam Larsson,D,SEA,32,82,4,23,27
26,8481568,Alex Vlasic,D,CHI,23,82,4,23,27
26,8480043,Timothy Liljegren,D,TOR,25,82,4,23,27
26,8475233,David Savard,D,MTL,34,82,3,24,27
26,8481093,Rafael Harvey-Pinard,L,MTL,25,82,19,7,26
26,8481580,Connor McMichael,C,WSH,23,82,18,8,26
26,8470621,Corey Perry,R,EDM,39,82,16,10,26
26,8477425,Miles Wood,L,COL,29,82,13,13,26
26,8475220,Marcus Foligno,L,MIN,33,82,13,13,26
26,8481477,Nico Sturm,C,SJS,29,82,12,14,26
26,8475231,Casey Cizikas,C,NYI,33,82,12,14,26
26,8481032,Paul Cotter,C,NJD,25,82,12,14,26
26,8477015,Connor Brown,R,EDM,30,82,9,17,26
26,8477335,Kyle Burroughs,D,LAK,29,82,8,18,26
26,8477507,Nikita Zadorov,D,BOS,29,82,6,20,26
26,8476892,Colton Parayko,D,STL,31,82,4,22,26
26,8479976,Juuso Valimaki,D,UTA,26,82,4,22,26
26,8479998,Mikey Anderson,D,LAK,25,82,3,23,26
26,8480878,Nils Lundkvist,D,DAL,24,82,2,24,26
26,8480995,Pontus Holmberg,R,TOR,25,82,13,12,25
26,8478508,Yakov Trenin,C,MIN,27,82,13,12,25
26,8479316,Luke Kunin,C,SJS,27,82,12,13,25
26,8481704,Juuso Parssinen,C,NSH,23,82,11,14,25
26,8480021,Jack Studnicka,C,LAK,25,82,11,14,25
26,8482111,Justin Barron,D,MTL,23,82,9,16,25
26,8482122,Brock Faber,D,MIN,22,82,5,20,25
26,8475718,Justin Holl,D,DET,32,82,5,20,25
26,8475690,Chris Tanev,D,TOR,35,82,3,22,25
26,8478432,Christian Fischer,R,DET,27,82,12,12,24
26,8480281,Alexey Toropchenko,R,STL,25,82,12,12,24
26,8479591,Michael Eyssimont,C,TBL,28,82,11,13,24
26,8480813,Joe Veleno,C,DET,24,82,10,14,24
26,8481481,Blake Lizotte,C,PIT,27,82,10,14,24
26,8480855,Jack McBain,C,UTA,24,82,9,15,24
26,8478434,Keegan Kolesar,R,VGK,27,82,8,16,24
26,8483495,Simon Nemec,D,NJD,20,82,7,17,24
26,8482803,Olen Zellweger,D,ANA,21,82,6,18,24
26,8477369,Carson Soucy,D,VAN,30,82,6,18,24
26,8480073,Erik Brannstrom,D,COL,25,82,5,19,24
26,8480172,Jan Rutta,D,SJS,34,82,5,19,24
26,8480807,Mattias Samuelsson,D,BUF,24,82,4,20,24
26,8484203,Bradly Nadeau,L,CAR,19,82,4,20,24
26,8475462,Radko Gudas,D,ANA,34,82,3,21,24
26,8481014,Alexander Romanov,D,NYI,24,82,3,21,24
26,8481178,Egor Zamula,D,PHI,24,82,3,21,24
26,8479371,Dante Fabbro,D,NSH,26,82,2,22,24
26,8482679,Matt Coronato,R,CGY,22,82,13,10,23
26,8476463,Jonas Brodin,D,MIN,31,82,8,15,23
26,8479980,Nicolas Hague,D,VGK,26,82,7,16,23
26,8483490,Pavel Mintyukov,D,ANA,21,82,6,17,23
26,8482666,Scott Morrow,D,CAR,22,82,6,17,23
26,8477845,Trevor van Riemsdyk,D,WSH,33,82,4,19,23
26,8482624,Daniil Miromanov,D,CGY,27,82,3,20,23
26,8482073,Braden Schneider,D,NYR,23,82,3,20,23
26,8482142,Jamie Drysdale,D,PHI,22,82,2,21,23
26,8482655,J.J. Moser,D,TBL,24,82,2,21,23
26,8478507,John Marino,D,UTA,27,82,0,23,23
26,8476889,Radek Faksa,C,STL,30,82,16,6,22
26,8476469,Joel Armia,R,MTL,31,82,11,11,22
26,8476878,Zemgus Girgensons,L,TBL,30,82,11,11,22
26,8477919,Frederick Gaudreau,C,MIN,31,82,9,13,22
26,8480980,Connor Dewar,C,TOR,25,82,8,14,22
26,8482470,Ilya Solovyov,D,CGY,24,82,7,15,22
26,8476467,Jamie Oleksiak,D,SEA,32,82,7,15,22
26,8478399,Jonas Siegenthaler,D,NJD,27,82,2,20,22
26,8474673,TJ Brodie,D,CHI,34,82,1,21,22
26,8475842,Sam Carrick,C,NYR,32,82,13,8,21
26,8478569,Noel Acciari,C,PIT,33,82,12,9,21
26,8476624,Barclay Goodrow,C,SJS,31,82,11,10,21
26,8480003,Jesper Boqvist,C,FLA,26,82,8,13,21
26,8478178,Darren Raddysh,D,TBL,28,82,7,14,21
26,8483471,Brad Lambert,C,WPG,31,82,5,16,21
26,8478500,Ivan Provorov,D,CBJ,27,82,2,19,21
26,8476331,Dylan DeMelo,D,WPG,31,82,2,19,21
26,8475455,Brenden Dillon,D,NJD,34,82,2,19,21
26,8476429,Scott Mayfield,D,NYI,32,82,1,20,21
26,8476891,Matt Grzelcyk,D,PIT,30,82,1,20,21
26,8482074,Connor Zary,C,CGY,23,82,10,10,20
26,8483493,Frank Nazar,C,CHI,20,82,8,12,20
26,8482062,Cole Smith,L,NSH,29,82,6,14,20
26,8476372,Nick Seeler,D,PHI,31,82,5,15,20
26,8482733,Logan Mailloux,D,MTL,31,82,4,16,20
26,8476967,Brett Kulak,D,EDM,30,82,3,17,20
26,8483763,Maksymilian Szuber,D,UTA,22,82,10,9,19
26,8476442,Matt Nieto,L,PIT,32,82,9,10,19
26,8476858,Phillip Di Giuseppe,L,VAN,31,82,9,10,19
26,8483505,Matthew Poitras,C,BOS,20,82,8,11,19
26,8481524,Bowen Byram,D,BUF,23,82,7,12,19
26,8483482,Tristan Luneau,D,ANA,20,82,6,13,19
26,8482749,Joshua Roy,R,MTL,21,82,6,13,19
26,8477034,Jaycob Megna,D,FLA,32,82,6,13,19
26,8483567,Georgii Merkulov,C,BOS,24,82,6,13,19
26,8477220,Nate Schmidt,D,FLA,33,82,5,14,19
26,8478851,Alexandre Carrier,D,NSH,28,82,4,15,19
26,8477435,Ryan Graves,D,PIT,29,82,3,16,19
26,8476525,Colin Miller,D,WPG,32,82,3,16,19
26,8476278,Colin Blackwell,C,DAL,31,82,12,6,18
26,8478013,Jake Walman,D,SJS,28,82,11,7,18
26,8482702,Logan Stankoven,C,DAL,21,82,10,8,18
26,8482101,Danil Gushchin,L,SJS,22,82,7,11,18
26,8478468,Jeremy Lauzon,D,NSH,27,82,7,11,18
26,8475324,Nick Jensen,D,OTT,34,82,6,12,18
26,8481567,Henry Thrun,D,SJS,23,82,6,12,18
26,8479324,Ryan Lindgren,D,NYR,26,82,4,14,18
26,8482762,Simon Edvinsson,D,DET,21,82,4,14,18
26,8483524,Shane Wright,C,SEA,20,82,4,14,18
26,8478416,Erik Cernak,D,TBL,27,82,3,15,18
26,8481708,Zac Jones,D,NYR,24,82,2,16,18
26,8484145,Zach Benson,L,BUF,19,82,8,9,17
26,8473453,Trevor Lewis,C,LAK,37,82,8,9,17
26,8482858,Ryker Evans,D,SEA,23,82,8,9,17
26,8476822,Luke Glendening,C,TBL,35,82,8,9,17
26,8482712,Oskar Olausson,R,COL,22,82,6,11,17
26,8476312,Josh Manson,D,COL,33,82,5,12,17
26,8480035,Henri Jokiharju,D,BUF,25,82,4,13,17
26,8480834,Ty Emberson,D,SJS,24,82,4,13,17
26,8480860,Kevin Bahl,D,CGY,24,82,3,14,17
26,8476879,Cody Ceci,D,EDM,31,82,2,15,17
26,8474612,Travis Hamonic,D,OTT,34,82,2,15,17
26,8478859,Niko Mikkola,D,FLA,28,82,1,16,17
26,8481641,Joel Kiviranta,L,COL,28,82,10,6,16
26,8482809,Jackson Blake,R,CAR,21,82,6,10,16
26,8482141,Lukas Cormier,D,VGK,22,82,6,10,16
26,8480246,Nick Perbix,D,TBL,26,82,5,11,16
26,8480448,Parker Kelly,L,COL,25,82,5,11,16
26,8476441,Joel Edmundson,D,LAK,31,82,5,11,16
26,8474574,Tyler Myers,D,VAN,34,82,4,12,16
26,8482087,Kaiden Guhle,D,MTL,22,82,4,12,16
26,8483445,Cutter Gauthier,L,ANA,20,82,4,12,16
26,8477392,Hudson Fasching,R,NYI,29,82,3,13,16
26,8478840,Will Borgen,D,SEA,28,82,0,16,16
26,8480025,MacKenzie Entwistle,R,FLA,25,82,8,7,15
26,8484149,Gavin Brindley,C,CBJ,20,82,7,8,15
26,8480870,Bo Groulx,C,NYR,24,82,6,9,15
26,8480990,Declan Chisholm,D,MIN,24,82,5,10,15
26,8482153,Brendan Brisson,C,VGK,23,82,4,11,15
26,8483565,Nick Blankenburg,D,NSH,26,82,3,12,15
26,8475177,Calvin de Haan,D,COL,33,82,3,12,15
26,8477505,Alexander Wennberg,C,SJS,30,82,9,5,14
26,8483397,Marc McLaughlin,C,BOS,25,82,8,6,14
26,8483499,Liam Ohgren,L,MIN,20,82,5,9,14
26,8483460,David Jiricek,D,CBJ,21,82,5,9,14
26,8475279,Ben Chiarot,D,DET,33,82,4,10,14
26,8481605,Jackson LaCombe,D,ANA,23,82,4,10,14
26,8482145,Mavrik Bourque,C,DAL,22,82,4,10,14
26,8474013,Ian Cole,D,UTA,35,82,3,11,14
26,8481122,Simon Benoit,D,TOR,26,82,3,11,14
26,8471677,Jack Johnson,D,CBJ,37,82,2,12,14
26,8480879,Jacob Bernard-Docker,D,OTT,24,82,1,13,14
26,8475762,Derek Forbort,D,VAN,32,82,1,13,14
26,8474090,Brendan Smith,D,DAL,35,82,7,6,13
26,8481699,Aku Raty,R,UTA,23,82,7,6,13
26,8480796,Martin Fehervary,D,WSH,25,82,5,8,13
26,8474567,Zach Bogosian,D,MIN,34,82,5,8,13
26,8482659,Josh Doan,R,UTA,22,82,3,10,13
26,8484911,Collin Graf,R,SJS,22,82,3,10,13
26,8477938,Haydn Fleury,D,WPG,28,82,1,12,13
26,8479638,Justin Brazeau,R,BOS,26,82,7,5,12
26,8483466,Kevin Korchinski,D,CHI,20,82,4,8,12
26,8479442,Troy Stecher,D,EDM,30,82,4,8,12
26,8482713,Mackie Samoskevich,R,FLA,22,82,3,9,12
26,8482516,Matthew Kessel,D,STL,24,82,2,10,12
26,8478443,Brandon Carlo,D,BOS,28,82,1,11,12
26,8482859,Zack Ostapchuk,C,OTT,21,82,7,4,11
26,8478874,Adam Gaudette,C,OTT,28,82,1,10,11
26,8479291,Kevin Rooney,C,CGY,31,82,5,5,10
26,8476473,Connor Murphy,D,CHI,31,82,0,10,10
26,8482787,Nikita Chibrikov,R,WPG,31,82,4,5,9
26,8478450,Parker Wotherspoon,D,BOS,27,82,2,7,9
26,8482070,Mitchell Chaffee,R,TBL,26,82,3,5,8
26,8483012,Logan Morrison,C,SEA,22,82,2,6,8
26,8474062,Riley Nash,C,NYR,35,82,1,6,7
26,8480950,Ilya Lyubushkin,D,DAL,30,82,0,7,7
26,8482118,Sam Colangelo,R,ANA,23,82,5,1,6
26,8479576,Vincent Desharnais,D,VAN,28,82,0,6,6
26,8483489,Fraser Minten,C,TOR,31,82,1,2,3
26,8470794,Joe Pavelski,C,,40,0,0,0,0
26,8481703,Valtteri Puustinen,R,PIT,25,0,0,0,0
26,8477950,Tony DeAngelo,D,,29,0,0,0,0
26,8481577,Philip Tomasino,C,NSH,23,0,0,0,0
26,8475197,Tyson Barrie,D,,33,0,0,0,0
26,8471218,Blake Wheeler,R,,38,0,0,0,0
26,8474157,Max Pacioretty,L,,36,0,0,0,0
26,8478466,Daniel Sprong,R,VAN,27,0,0,0,0
26,8475744,Evgeny Kuznetsov,C,,32,0,0,0,0
26,8481019,David Gustafsson,C,WPG,24,0,0,0,0
26,8475906,John Klingberg,D,,32,0,0,0,0
26,8479348,Kale Clague,D,BUF,26,0,0,0,0
26,8476952,Dominic Toninato,C,WPG,30,0,0,0,0
26,8473473,Milan Lucic,L,,36,0,0,0,0
26,8474037,James van Riemsdyk,L,,35,0,0,0,0
26,8474602,Justin Schultz,D,,34,0,0,0,0
26,8482222,Alexander Barabanov,L,,30,0,0,0,0
26,8479372,Josh Mahura,D,SEA,26,0,0,0,0
26,8479982,Conor Timmins,D,TOR,26,0,0,0,0
26,8474031,Kevin Shattenkirk,D,,35,0,0,0,0
26,8480008,Adam Ruzicka,C,,25,0,0,0,0
26,8481059,Scott Perunovich,D,STL,26,0,0,0,0
26,8480884,Calen Addison,D,,24,0,0,0,0
26,8476994,Vinnie Hinostroza,C,NSH,30,0,0,0,0
26,8478452,Caleb Jones,D,LAK,27,0,0,0,0
26,8480157,Calle Rosen,D,COL,30,0,0,0,0
26,8481609,Vladislav Kolyachonok,D,UTA,23,0,0,0,0
26,8479415,Michael McLeod,C,,26,0,0,0,0
26,8476919,Chris Tierney,C,,30,0,0,0,0
26,8479639,Dylan Coghlan,D,WPG,26,0,0,0,0
26,8478146,Matthew Highmore,C,OTT,28,0,0,0,0
26,8478970,Jalen Chatfield,D,CAR,28,0,0,0,0
26,8480205,Emil Bemstrom,C,PIT,25,0,0,0,0
26,8474884,Mike Hoffman,C,,35,0,0,0,0
26,8471274,Alex Goligoski,D,,39,0,0,0,0
26,8478104,Sammy Blais,L,,28,0,0,0,0
26,8474870,Tyler Johnson,C,,34,0,0,0,0
26,8476913,Devin Shore,C,MIN,30,0,0,0,0
26,8481598,Philip Broberg,D,EDM,23,0,0,0,0
26,8480058,Pierre-Olivier Joseph,D,STL,25,0,0,0,0
26,8480891,Michael Kesselring,D,UTA,24,0,0,0,0
26,8477979,Nicolas Aube-Kubel,R,BUF,28,0,0,0,0
26,8476871,Tanner Pearson,L,,32,0,0,0,0
26,8476393,Nick Cousins,C,,31,0,0,0,0
26,8479977,Kailer Yamamoto,R,,26,0,0,0,0
26,8479543,Michael Pezzetta,L,MTL,26,0,0,0,0
26,8477018,Ben Hutton,D,VGK,31,0,0,0,0
26,8480762,Eric Robinson,L,CAR,29,0,0,0,0
26,8474034,Pat Maroon,L,CHI,36,0,0,0,0
26,8481058,Jesse Ylönen,R,,25,0,0,0,0
26,8475179,Dmitry Kulikov,D,FLA,34,0,0,0,0
26,8481527,Kaedan Korczak,D,VGK,23,0,0,0,0
26,8473449,Kyle Okposo,R,,36,0,0,0,0
26,8482192,Isaak Phillips,D,CHI,23,0,0,0,0
26,8480727,Zach Whitecloud,D,VGK,28,0,0,0,0
26,8479346,Dillon Dube,C,,26,0,0,0,0
26,8480821,Filip Zadina,R,,25,0,0,0,0
26,8480001,Urho Vaakanainen,D,ANA,25,0,0,0,0
26,8470966,Mark Giordano,D,,41,0,0,0,0
26,8480853,Liam Foudy,C,,24,0,0,0,0
26,8475225,Craig Smith,C,CHI,35,0,0,0,0
26,8479972,Mason Shaw,C,WPG,26,0,0,0,0
26,8478451,Ethan Bear,D,WSH,27,0,0,0,0
26,8474040,Sam Gagner,C,,35,0,0,0,0
26,8480196,Jacob Bryson,D,BUF,27,0,0,0,0
26,8479984,Cal Foote,D,,26,0,0,0,0
26,8480011,Klim Kostin,C,SJS,25,0,0,0,0
26,8482176,Wyatt Kaiser,D,CHI,22,0,0,0,0
26,8476988,Matt Benning,D,SJS,30,0,0,0,0
26,8479370,Tyson Jost,C,CAR,26,0,0,0,0
26,8477464,Nic Petan,C,,29,0,0,0,0
26,8477380,Jonny Brodzinski,C,NYR,31,0,0,0,0
26,8480070,Ian Mitchell,D,BOS,25,0,0,0,0
26,8479315,Joey Anderson,R,CHI,26,0,0,0,0
26,8478099,Kevin Labanc,R,,29,0,0,0,0
26,8476874,Olli Maatta,D,DET,30,0,0,0,0
26,8475208,Brian Dumoulin,D,ANA,33,0,0,0,0
26,8478430,Oliver Kylington,D,,27,0,0,0,0
26,8479536,Axel Jonsson-Fjallby,L,WPG,26,0,0,0,0
26,8479671,Mathieu Olivier,R,CBJ,27,0,0,0,0
26,8471709,Marc-Edouard Vlasic,D,SJS,37,0,0,0,0
26,8479328,Julien Gauthier,R,NYI,27,0,0,0,0
26,8478421,A.J. Greer,L,FLA,28,0,0,0,0
26,8477573,Nathan Walker,L,STL,30,0,0,0,0
26,8481537,Nikita Okhotiuk,D,CGY,24,0,0,0,0
26,8474166,Alec Martinez,D,CHI,37,0,0,0,0
26,8470610,Zach Parise,L,,40,0,0,0,0
26,8477478,William Carrier,L,CAR,30,0,0,0,0
26,8479344,Jesse Puljujarvi,R,PIT,26,0,0,0,0
26,8480887,Jordan Harris,D,MTL,24,0,0,0,0
26,8478502,Dennis Gilbert,D,BUF,28,0,0,0,0
26,8482730,Brandt Clarke,D,LAK,21,0,0,0,0
26,8480355,Mark Kastelic,C,BOS,25,0,0,0,0
26,8475750,Jon Merrill,D,MIN,32,0,0,0,0
26,8475164,Jakob Silfverberg,R,,34,0,0,0,0
26,8477944,Jakub Vrana,L,,28,0,0,0,0
26,8479439,Jacob MacDonald,D,COL,31,0,0,0,0
26,8474568,Luke Schenn,D,NSH,35,0,0,0,0
26,8478454,Noah Juulsen,D,VAN,27,0,0,0,0
26,8475752,Tyler Pitlick,C,,33,0,0,0,0
26,8482148,Hendrix Lapierre,C,WSH,22,0,0,0,0
26,8481167,Brayden Pachal,D,CGY,25,0,0,0,0
26,8478043,Sam Lafferty,C,BUF,29,0,0,0,0
26,8479321,Lucas Johansen,D,,27,0,0,0,0
26,8471699,Andrew Cogliano,C,,37,0,0,0,0
26,8481521,Ronnie Attard,D,PHI,25,0,0,0,0
26,8481161,Jake Christiansen,D,CBJ,25,0,0,0,0
26,8479458,Nikita Zaitsev,D,,33,0,0,0,0
26,8479619,Michael Carcone,L,UTA,28,0,0,0,0
26,8479026,Philippe Myers,D,TOR,27,0,0,0,0
26,8477330,Dominik Kubalik,L,,29,0,0,0,0
26,8481617,Vasily Podkolzin,R,VAN,23,0,0,0,0
26,8481701,Santeri Hatakka,D,NJD,23,0,0,0,0
26,8479514,Rem Pitlick,C,,27,0,0,0,0
26,8477446,Michael McCarron,R,NSH,29,0,0,0,0
26,8470604,Jeff Carter,C,,39,0,0,0,0
26,8482241,Radim Zohorna,L,,28,0,0,0,0
26,8480289,Morgan Barron,C,WPG,26,0,0,0,0
26,8479379,Givani Smith,R,SJS,26,0,0,0,0
26,8480216,Jacob Peterson,C,,25,0,0,0,0
26,8477851,Jordan Oesterle,D,BOS,32,0,0,0,0
26,8484258,Sam Malinski,D,COL,26,0,0,0,0
26,8478904,Steven Lorentz,C,,28,0,0,0,0
26,8482095,Tyler Kleven,D,OTT,22,0,0,0,0
26,8480848,Ty Dellandrea,C,SJS,24,0,0,0,0
26,8476884,Derrick Pouliot,D,,30,0,0,0,0
26,8479336,Carl Grundstrom,R,SJS,27,0,0,0,0
26,8482964,Arber Xhekaj,D,MTL,23,0,0,0,0
26,8471686,Marc Staal,D,,37,0,0,0,0
26,8477887,Patrick Brown,C,BOS,32,0,0,0,0
26,8478495,Denis Gurianov,R,,27,0,0,0,0
26,8473504,Cal Clutterbuck,R,,37,0,0,0,0
26,8481550,Adam Beckman,L,NJD,23,0,0,0,0
26,8480845,Rasmus Kupari,C,WPG,24,0,0,0,0
26,8474009,Nick Bonino,C,,36,0,0,0,0
26,8478585,Derek Ryan,C,EDM,38,0,0,0,0
26,8477962,Brendan Lemieux,L,CAR,28,0,0,0,0
26,8482861,Vincent Iorio,D,WSH,22,0,0,0,0
26,8479378,Logan Stanley,D,WPG,26,0,0,0,0
26,8473446,Erik Johnson,D,PHI,36,0,0,0,0
26,8481743,Marc Del Gaizo,D,NSH,25,0,0,0,0
26,8477384,Josh Brown,D,EDM,30,0,0,0,0
26,8482165,Yan Kuznetsov,D,CGY,22,0,0,0,0
26,8478424,Jansen Harkins,C,ANA,27,0,0,0,0
26,8482144,Jack Thompson,D,SJS,22,0,0,0,0
26,8478512,Austin Czarnik,C,,32,0,0,0,0
26,8477527,Ross Johnston,L,ANA,30,0,0,0,0
26,8479383,Boris Katchouk,L,,26,0,0,0,0
26,8482094,Daemon Hunt,D,MIN,22,0,0,0,0
26,8481719,Maxwell Crozier,D,TBL,24,0,0,0,0
26,8480192,Johnathan Kovacevic,D,NJD,27,0,0,0,0
26,8479376,Victor Mete,D,,26,0,0,0,0
26,8482511,Mason Lohrei,D,BOS,23,0,0,0,0
26,8475825,Jani Hakanpää,D,,32,0,0,0,0
26,8478021,William Lagesson,D,DET,28,0,0,0,0
26,8475795,Dylan McIlrath,D,WSH,32,0,0,0,0
26,8477846,Ryan Carpenter,C,,33,0,0,0,0
26,8481056,Spencer Stastney,D,NSH,24,0,0,0,0
26,8481564,Ryan Johnson,D,BUF,23,0,0,0,0
26,8478017,Mark Friedman,D,VAN,29,0,0,0,0
26,8479320,Max Lajoie,D,SEA,27,0,0,0,0
26,8480075,Cameron Crotty,D,MIN,25,0,0,0,0
26,8484287,Cole McWard,D,VAN,23,0,0,0,0
26,8484254,Akito Hirose,D,VAN,25,0,0,0,0
26,8483407,Brandon Scanlin,D,NYR,25,0,0,0,0
26,8480274,Philip Kemp,D,EDM,25,0,0,0,0
26,8479522,Hardy Haman Aktell,D,WSH,26,0,0,0,0
26,8480007,Jonas Rondbjerg,R,VGK,25,0,0,0,0
26,8477454,Adam Erne,L,,29,0,0,0,0
26,8481679,Maxence Guenette,D,OTT,23,0,0,0,0
26,8480441,Trey Fix-Wolansky,R,CBJ,25,0,0,0,0
26,8483546,Marshall Rifai,D,TOR,26,0,0,0,0
26,8480084,Nick DeSimone,D,NJD,30,0,0,0,0
26,8481030,Jack St. Ivany,D,PIT,25,0,0,0,0
26,8481592,Jakob Pelletier,L,CGY,23,0,0,0,0
26,8478011,Louie Belpedio,D,PHI,28,0,0,0,0
26,8477930,Pierre-Edouard Bellemare,L,,39,0,0,0,0
26,8484321,Nikolas Matinpalo,D,OTT,26,0,0,0,0
26,8482067,Connor Mackey,D,NYR,28,0,0,0,0
26,8481806,Louis Crevier,D,CHI,23,0,0,0,0
26,8484326,Patrik Koch,D,UTA,28,0,0,0,0
26,8477971,Andreas Englund,D,LAK,28,0,0,0,0
26,8481751,Lukas Rousek,R,BUF,25,0,0,0,0
26,8481006,Tyler Tucker,D,STL,24,0,0,0,0
26,8476867,Brendan Gaunce,C,MIN,30,0,0,0,0
26,8479520,Brandon Duhaime,R,WSH,27,0,0,0,0
26,8477073,Kurtis MacDermid,L,NJD,30,0,0,0,0
26,8480874,Adam Ginning,D,PHI,24,0,0,0,0
26,8477473,Justin Bailey,R,SJS,29,0,0,0,0
26,8479066,Ryan Lomberg,L,CGY,30,0,0,0,0
26,8477070,Liam O'Brien,C,UTA,30,0,0,0,0
26,8474618,Marco Scandella,D,,34,0,0,0,0
26,8475797,Jarred Tinordi,D,,32,0,0,0,0
26,8481441,Joe Snively,C,DET,28,0,0,0,0
26,8477244,Chad Ruhwedel,D,NYR,34,0,0,0,0
26,8479772,Zack MacEwen,R,OTT,28,0,0,0,0
26,8481147,Reese Johnson,C,MIN,26,0,0,0,0
26,8481043,Cole Koepke,L,BOS,26,0,0,0,0
26,8483619,Filip Roos,D,OTT,25,0,0,0,0
26,8481541,Samuel Bolduc,D,NYI,24,0,0,0,0
26,8477810,Joel Hanley,D,CGY,33,0,0,0,0
26,8476907,Mackenzie MacEachern,L,,30,0,0,0,0
26,8482652,Walker Duehr,R,CGY,27,0,0,0,0
26,8477126,Jayson Megna,C,,34,0,0,0,0
26,8483398,Declan Carlile,D,TBL,31,0,0,0,0
26,8482929,Emil Lilleberg,D,TBL,23,0,0,0,0
26,8480880,Jakub Lauko,C,MIN,24,0,0,0,0
26,8480245,Olle Lycksell,R,PHI,25,0,0,0,0
26,8480252,Cole Guttman,C,CHI,25,0,0,0,0
26,8477467,Gustav Olofsson,D,SEA,30,0,0,0,0
26,8479968,Vinni Lettieri,C,BOS,29,0,0,0,0
26,8478400,Colin White,C,,27,0,0,0,0
26,8475755,Alexander Petrovic,D,DAL,32,0,0,0,0
26,8481812,Nikolai Knyzhov,D,,27,0,0,0,0
26,8481593,Jayden Struble,D,MTL,23,0,0,0,0
26,8481532,Alex Turcotte,C,LAK,23,0,0,0,0
26,8482126,Emil Andrae,D,PHI,31,0,0,0,0
26,8479944,Zach Aston-Reese,C,VGK,30,0,0,0,0
26,8471817,Ryan Reaves,R,TOR,37,0,0,0,0
26,8481206,John Ludvig,D,PIT,24,0,0,0,0
26,8481599,Victor Soderstrom,D,UTA,23,0,0,0,0
26,8480292,Carson Meyer,R,ANA,27,0,0,0,0
26,8482496,Nils Aman,C,VAN,24,0,0,0,0
26,8479718,Alex Barré-Boulet,C,MTL,27,0,0,0,0
26,8479994,Jaret Anderson-Dolan,C,WPG,25,0,0,0,0
26,8480184,Gustav Lindstrom,D,,26,0,0,0,0
26,8480890,Jan Jenik,R,OTT,24,0,0,0,0
26,8478067,Oskar Lindblom,L,,28,0,0,0,0
26,8476934,Brock McGinn,L,ANA,30,0,0,0,0
26,8479985,Cale Fleury,D,SEA,26,0,0,0,0
26,8484304,Uvis Balinskis,D,FLA,28,0,0,0,0
26,8479981,Jonah Gadjovich,L,FLA,26,0,0,0,0
26,8481716,Dmitri Voronkov,L,CBJ,24,0,0,0,0
26,8474709,Matt Martin,L,,35,0,0,0,0
26,8482634,Alex Steeves,C,TOR,25,0,0,0,0
26,8480823,Alexander Alexeyev,D,WSH,25,0,0,0,0
26,8477541,Dakota Mermis,D,TOR,30,0,0,0,0
26,8483491,Ivan Miroshnichenko,L,WSH,20,0,0,0,0
26,8478477,Mitchell Stephens,C,SEA,27,0,0,0,0
26,8481543,Nikita Alexandrov,C,STL,24,0,0,0,0
26,8479423,Alex Nylander,L,,26,0,0,0,0
26,8482451,Mikael Pyyhtia,L,CBJ,23,0,0,0,0
26,8478831,Kevin Stenlund,C,UTA,28,0,0,0,0
26,8480306,Grant Hutton,D,NYI,29,0,0,0,0
26,8478028,Fredrik Olofsson,L,,28,0,0,0,0
26,8477462,Robert Hagg,D,VGK,29,0,0,0,0
26,8477320,Anton Blidh,L,NYR,29,0,0,0,0
26,8482157,Will Cuylle,L,NYR,22,0,0,0,0
26,8482737,Zack Bolduc,C,STL,21,0,0,0,0
26,8481239,Samuel Fagemo,L,,24,0,0,0,0
26,8481600,Tobias Bjornfot,D,FLA,23,0,0,0,0
26,8478409,Anthony Richard,C,PHI,28,0,0,0,0
26,8474145,Robert Bortuzzo,D,,35,0,0,0,0
26,8475958,Michael Sgarbossa,C,WSH,32,0,0,0,0
26,8479986,Kole Lind,R,DAL,26,0,0,0,0
26,8479249,Andrew Poturalski,C,SJS,30,0,0,0,0
26,8479362,Riley Tufte,L,BOS,26,0,0,0,0
26,8479991,Jake Leschyshyn,C,NYR,25,0,0,0,0
26,8479587,Rhett Gardner,C,PHI,28,0,0,0,0
26,8482744,James Malatesta,L,CBJ,21,0,0,0,0
26,8478854,Ryan Shea,D,PIT,27,0,0,0,0
26,8481591,Sam Poulin,R,,23,0,0,0,0
26,8483512,Matt Savoie,C,EDM,20,0,0,0,0
26,8482102,Vasily Ponomarev,C,PIT,22,0,0,0,0
26,8482162,Roby Jarventie,L,EDM,22,0,0,0,0
26,8481016,Ruslan Iskhakov,C,,24,0,0,0,0
26,8482172,Landon Slaggert,L,CHI,22,0,0,0,0
26,8482747,Brennan Othmann,L,NYR,21,0,0,0,0
26,8480031,Maxime Comtois,L,,25,0,0,0,0
26,8480226,Marián Studenic,R,,26,0,0,0,0
26,8478408,Travis Dermott,D,,28,0,0,0,0
26,8481518,Nolan Foote,L,NJD,24,0,0,0,0
26,8479419,Brett Murray,L,BUF,26,0,0,0,0
26,8482088,Justin Sourdif,R,FLA,22,0,0,0,0
26,8482201,Gage Goncalves,C,TBL,23,0,0,0,0
26,8481578,Graeme Clarke,R,MIN,23,0,0,0,0
26,8482177,Marat Khusnutdinov,C,MIN,22,0,0,0,0
26,8481754,Nikita Nesterenko,C,ANA,23,0,0,0,0
26,8483531,Brian Halonen,L,NJD,25,0,0,0,0
26,8483920,Pierrick Dube,R,WSH,23,0,0,0,0
26,8480851,Akil Thomas,C,LAK,24,0,0,0,0
26,8475235,Nicolas Deslauriers,L,PHI,33,0,0,0,0
26,8482476,Emil Heineman,L,MTL,23,0,0,0,0
26,8477149,Scott Sabourin,R,SJS,32,0,0,0,0
26,8483549,Lucas Condotta,L,MTL,27,0,0,0,0
26,8482765,Isak Rosen,R,BUF,21,0,0,0,0
26,8481237,Kyle MacLean,C,NYI,25,0,0,0,0
26,8481024,Linus Karlsson,C,VAN,25,0,0,0,0
26,8481690,Tyler Angle,C,,24,0,0,0,0
26,8483570,Ben Meyers,C,SEA,26,0,0,0,0
26,8481655,Cole Schwindt,R,CGY,23,0,0,0,0
26,8481462,Mason Morelli,L,VGK,28,0,0,0,0
26,8483401,Marc Johnstone,R,PIT,28,0,0,0,0
26,8478956,Samuel Laberge,L,NJD,27,0,0,0,0
26,8479533,Joona Koppanen,L,,26,0,0,0,0
26,8482197,Adam Raska,R,MIN,23,0,0,0,0
26,8482250,Callahan Burke,C,VGK,27,0,0,0,0
26,8482784,Zach Dean,C,STL,21,0,0,0,0
26,8484255,Jason Polin,R,COL,25,0,0,0,0
26,8481077,John Leonard,L,,26,0,0,0,0
26,8481534,Raphael Lavoie,C,EDM,24,0,0,0,0
26,8483609,Adam Klapka,R,CGY,24,0,0,0,0
26,8482751,Ryan Winterton,C,SEA,21,0,0,0,0
26,8480267,Sammy Walker,C,MIN,25,0,0,0,0
26,8475766,Austin Watson,L,,32,0,0,0,0
26,8482460,Matt Rempe,C,NYR,22,0,0,0,0
26,8481065,Angus Crookshank,L,OTT,25,0,0,0,0
26,8481070,Hugh McGing,L,,26,0,0,0,0
26,8476323,Max McCormick,L,SEA,32,0,0,0,0
26,8483395,Arshdeep Bains,L,VAN,23,0,0,0,0
26,8484259,Ondrej Pavel,C,COL,31,0,0,0,0
26,8483432,Luca Del Bel Belluz,C,CBJ,31,0,0,0,0
26,8483045,Cameron Butler,R,CBJ,31,0,0,0,0
26,8482061,Brandon Biro,L,SEA,26,0,0,0,0
26,8477401,John Hayden,C,SEA,29,0,0,0,0
26,8475278,Byron Froese,C,,33,0,0,0,0
26,8478446,Glenn Gawdin,C,LAK,27,0,0,0,0
26,8477993,Justin Kirkland,C,CGY,28,0,0,0,0
26,8482147,Jean-Luc Foudy,C,COL,22,0,0,0,0
26,8480032,Shane Bowers,C,NJD,25,0,0,0,0
26,8479330,Brandon Gignac,C,MTL,27,0,0,0,0
26,8480776,Sheldon Rempal,R,,29,0,0,0,0
26,8475413,Justin Dowling,C,NJD,34,0,0,0,0
26,8481726,Adam Edstrom,C,NYR,24,0,0,0,0
26,8480844,Grigori Denisenko,L,VGK,24,0,0,0,0
26,8478147,Bokondji Imama,L,PIT,28,0,0,0,0
26,8478881,Brett Seney,L,CHI,28,0,0,0,0
26,8483630,Pavol Regenda,L,ANA,25,0,0,0,0
26,8480836,Jonathan Gruden,C,,24,0,0,0,0
26,8484314,Jiri Smejkal,L,,28,0,0,0,0
26,8475780,Chris Wagner,R,COL,33,0,0,0,0
26,8479546,Oskar Steen,C,,26,0,0,0,0
26,8483597,Milos Kelemen,L,UTA,25,0,0,0,0
26,8481789,Tye Kartye,L,SEA,23,0,0,0,0
26,8484325,Waltteri Merela,C,TBL,26,0,0,0,0
26,8479421,Jacob Moverare,D,LAK,26,0,0,0,0
26,8481585,Egor Afanasyev,L,SJS,23,0,0,0,0
26,8479547,Matthew Phillips,R,,26,0,0,0,0
26,8479367,William Lockwood,R,FLA,26,0,0,0,0
26,8476915,Jujhar Khaira,L,,30,0,0,0,0
26,8481422,Jacob Lucchini,C,NSH,29,0,0,0,0
26,8480468,James Hamblin,L,EDM,25,0,0,0,0
26,8478051,Max Willman,C,NJD,29,0,0,0,0
26,8481556,John Beecher,C,BOS,23,0,0,0,0
26,8478078,Rourke Chartier,C,,28,0,0,0,0
27,8478402,Connor McDavid,C,EDM,27,82,37,92,129
27,8479318,Auston Matthews,C,TOR,27,82,58,65,123
27,8477492,Nathan MacKinnon,C,COL,29,82,50,72,122
27,8478420,Mikko Rantanen,R,COL,28,82,44,75,119
27,8482116,Tim Stützle,C,OTT,22,82,40,79,119
27,8476468,J.T. Miller,C,VAN,31,82,46,69,115
27,8476453,Nikita Kucherov,R,TBL,31,82,36,76,112
27,8480027,Jason Robertson,L,DAL,25,82,35,77,112
27,8480800,Quinn Hughes,D,VAN,25,82,17,83,100
27,8481559,Jack Hughes,C,NJD,23,82,42,57,99
27,8481523,Kirby Dach,C,MTL,23,82,22,76,98
27,8481557,Matt Boldy,L,MIN,23,82,34,63,97
27,8477493,Aleksander Barkov,C,FLA,29,82,25,71,96
27,8478010,Brayden Point,C,TBL,28,82,56,39,95
27,8478864,Kirill Kaprizov,L,MIN,27,82,48,47,95
27,8477956,David Pastrnak,R,BOS,28,82,37,58,95
27,8480002,Nico Hischier,C,NJD,25,82,30,64,94
27,8479323,Adam Fox,D,NYR,26,82,19,75,94
27,8476456,Jonathan Huberdeau,C,CGY,31,82,22,71,93
27,8476346,Johnny Gaudreau,L,CBJ,31,82,15,78,93
27,8477946,Dylan Larkin,C,DET,28,82,44,48,92
27,8477940,Nikolaj Ehlers,L,WPG,28,82,45,46,91
27,8477933,Sam Reinhart,C,FLA,29,82,38,52,90
27,8477939,William Nylander,R,TOR,28,82,36,54,90
27,8477404,Jake Guentzel,C,TBL,30,82,41,48,89
27,8477942,Kevin Fiala,L,LAK,28,82,35,54,89
27,8474564,Steven Stamkos,C,NSH,34,82,39,49,88
27,8471675,Sidney Crosby,C,PIT,37,82,39,49,88
27,8475172,Nazem Kadri,C,CGY,34,82,32,56,88
27,8480801,Brady Tkachuk,L,OTT,25,82,33,54,87
27,8479314,Matthew Tkachuk,L,FLA,27,82,27,60,87
27,8476460,Mark Scheifele,C,WPG,31,82,27,60,87
27,8478550,Artemi Panarin,L,NYR,33,82,26,61,87
27,8478427,Sebastian Aho,C,CAR,27,82,36,50,86
27,8476887,Filip Forsberg,L,NSH,30,82,33,53,86
27,8478449,Roope Hintz,C,DAL,28,82,33,53,86
27,8477934,Leon Draisaitl,C,EDM,29,82,30,56,86
27,8474600,Roman Josi,D,NSH,34,82,25,61,86
27,8480069,Cale Makar,D,COL,26,82,24,62,86
27,8478445,Mathew Barzal,C,NYI,27,82,21,65,86
27,8479420,Tage Thompson,C,BUF,27,82,45,40,85
27,8478398,Kyle Connor,L,WPG,28,82,36,49,85
27,8476459,Mika Zibanejad,C,NYR,31,82,33,51,84
27,8478403,Jack Eichel,C,VGK,28,82,39,44,83
27,8477949,Alex Tuch,R,BUF,28,82,29,54,83
27,8478439,Travis Konecny,R,PHI,27,82,38,44,82
27,8480012,Elias Pettersson,C,VAN,26,82,28,54,82
27,8477501,Valeri Nichushkin,R,COL,29,82,41,39,80
27,8475166,John Tavares,C,TOR,34,82,33,47,80
27,8477402,Pavel Buchnevich,L,STL,29,82,33,47,80
27,8479542,Brandon Hagel,L,TBL,26,82,30,49,79
27,8475167,Victor Hedman,D,TBL,34,82,9,70,79
27,8477500,Bo Horvat,C,NYI,29,82,40,38,78
27,8477409,Carter Verhaeghe,C,FLA,29,82,38,40,78
27,8481540,Cole Caufield,R,MTL,23,82,35,43,78
27,8480023,Robert Thomas,C,STL,25,82,26,52,78
27,8477504,Josh Morrissey,D,WPG,29,82,22,56,78
27,8474150,Mikael Backlund,C,CGY,35,82,26,51,77
27,8478873,Troy Terry,R,ANA,27,82,20,56,76
27,8471215,Evgeni Malkin,C,PIT,38,82,28,47,75
27,8475692,Mats Zuccarello,R,MIN,37,82,13,62,75
27,8477955,Jared McCann,L,SEA,28,82,45,29,74
27,8479337,Alex DeBrincat,R,DET,27,82,31,43,74
27,8477951,Nick Schmaltz,C,UTA,28,82,30,44,74
27,8475786,Zach Hyman,L,EDM,32,82,42,30,72
27,8476539,Jonathan Marchessault,R,NSH,34,82,35,37,72
27,8477496,Elias Lindholm,C,BOS,30,82,27,45,72
27,8478440,Dylan Strome,C,WSH,27,82,26,46,72
27,8480865,Noah Dobson,D,NYI,24,82,12,60,72
27,8481528,Dylan Cozens,C,BUF,23,82,29,42,71
27,8479407,Jesper Bratt,L,NJD,26,82,26,45,71
27,8482665,Matty Beniers,C,SEA,22,82,26,45,71
27,8475810,Bryan Rust,R,PIT,32,82,40,30,70
27,8480018,Nick Suzuki,C,MTL,25,82,27,43,70
27,8476881,Tomas Hertl,C,VGK,31,82,25,45,70
27,8475168,Matt Duchene,C,DAL,33,82,25,45,70
27,8480208,Drake Batherson,R,OTT,26,82,24,46,70
27,8476853,Morgan Rielly,D,TOR,30,82,8,62,70
27,8478401,Pavel Zacha,C,BOS,27,82,26,43,69
27,8473419,Brad Marchand,L,BOS,36,82,26,43,69
27,8473512,Claude Giroux,R,OTT,36,82,24,45,69
27,8476454,Ryan Nugent-Hopkins,C,EDM,31,82,18,51,69
27,8474578,Erik Karlsson,D,PIT,34,82,16,53,69
27,8476432,Boone Jenner,C,CBJ,31,82,46,22,68
27,8478366,Frank Vatrano,R,ANA,30,82,41,27,68
27,8475726,Tyler Toffoli,C,SJS,32,82,32,36,68
27,8474141,Patrick Kane,R,DET,36,82,29,39,68
27,8478444,Brock Boeser,R,VAN,27,82,29,39,68
27,8478414,Timo Meier,R,NJD,28,82,28,40,68
27,8478460,Zach Werenski,D,CBJ,27,82,14,54,68
27,8480014,Gabriel Vilardi,C,WPG,25,82,34,33,67
27,8476448,William Karlsson,C,VGK,31,82,27,40,67
27,8480036,Miro Heiskanen,D,DAL,25,82,13,54,67
27,8477960,Adrian Kempe,R,LAK,28,82,34,32,66
27,8477479,Tyler Bertuzzi,L,CHI,29,82,32,34,66
27,8482078,Lucas Raymond,L,DET,22,82,19,47,66
27,8480839,Rasmus Dahlin,D,BUF,24,82,17,49,66
27,8474565,Alex Pietrangelo,D,VGK,34,82,16,50,66
27,8475794,Tyler Seguin,C,DAL,32,82,45,20,65
27,8474641,Adam Henrique,C,EDM,34,82,35,30,65
27,8479343,Clayton Keller,R,UTA,26,82,29,36,65
27,8475784,Jeff Skinner,C,EDM,32,82,24,41,65
27,8475913,Mark Stone,R,VGK,32,82,37,27,64
27,8478493,Joel Eriksson Ek,C,MIN,27,82,35,29,64
27,8475158,Ryan O'Reilly,C,NSH,33,82,26,38,64
27,8474679,Gustav Nyquist,C,NSH,35,82,21,43,64
27,8476882,Teuvo Teravainen,L,CHI,30,82,21,43,64
27,8475798,Mikael Granlund,C,SJS,32,82,18,46,64
27,8475753,Justin Faulk,D,STL,32,82,17,47,64
27,8478397,Rasmus Andersson,D,CGY,28,82,15,49,64
27,8475184,Chris Kreider,L,NYR,33,82,37,26,63
27,8479675,Trevor Moore,L,LAK,29,82,34,29,63
27,8480015,Owen Tippett,R,PHI,25,82,33,30,63
27,8479385,Jordan Kyrou,C,STL,26,82,29,34,63
27,8478975,Mason Marchment,L,DAL,29,82,28,35,63
27,8481533,Trevor Zegras,C,ANA,23,82,27,36,63
27,8474102,David Perron,L,OTT,36,82,23,40,63
27,8471685,Anze Kopitar,C,LAK,37,82,21,42,63
27,8474053,Logan Couture,C,SJS,35,82,21,42,63
27,8476389,Vincent Trocheck,C,NYR,31,82,19,44,63
27,8471214,Alex Ovechkin,L,WSH,39,82,30,32,62
27,8475170,Brayden Schenn,C,STL,33,82,30,32,62
27,8480830,Andrei Svechnikov,R,CAR,24,82,24,38,62
27,8480803,Evan Bouchard,D,EDM,25,82,13,49,62
27,8481068,Yegor Sharangovich,C,CGY,26,82,41,20,61
27,8479999,Casey Mittelstadt,C,COL,26,82,21,40,61
27,8477346,MacKenzie Weegar,D,CGY,30,82,20,41,61
27,8474563,Drew Doughty,D,LAK,35,82,16,45,61
27,8479339,Patrik Laine,L,CBJ,26,82,30,30,60
27,8483808,Andrei Kuzmenko,L,CGY,28,82,27,33,60
27,8480039,Martin Necas,C,CAR,25,82,23,37,60
27,8477476,Artturi Lehkonen,L,COL,29,82,36,23,59
27,8478047,Michael Bunting,L,PIT,29,82,21,38,59
27,8476875,Mike Matheson,D,MTL,30,82,16,43,59
27,8482093,Seth Jarvis,C,CAR,22,82,32,26,58
27,8482159,Tyson Foerster,R,PHI,22,82,30,28,58
27,8476399,Blake Coleman,C,CGY,33,82,28,30,58
27,8477407,Anthony Duclair,L,NYI,29,82,24,34,58
27,8478856,Conor Garland,R,VAN,28,82,20,38,58
27,8481596,Shane Pinto,C,OTT,24,82,20,38,58
27,8478396,Noah Hanifin,D,VGK,27,82,14,44,58
27,8480064,Josh Norris,C,OTT,25,82,36,21,57
27,8475191,Reilly Smith,R,NYR,33,82,28,29,57
27,8475765,Vladimir Tarasenko,R,DET,33,82,26,31,57
27,8473994,Jamie Benn,L,DAL,35,82,18,39,57
27,8478438,Tommy Novak,C,NSH,27,82,15,42,57
27,8478519,Anthony Cirelli,C,TBL,27,82,29,27,56
27,8478042,Viktor Arvidsson,R,EDM,31,82,24,32,56
27,8476458,Ryan Strome,C,ANA,31,82,16,40,56
27,8474590,John Carlson,D,WSH,34,82,13,43,56
27,8475314,Anders Lee,L,NYI,34,82,40,15,55
27,8475722,Jason Zucker,L,BUF,32,82,29,26,55
27,8473986,Alex Killorn,L,ANA,35,82,25,30,55
27,8474673,TJ Brodie,D,CHI,34,82,7,48,55
27,8477935,Sam Bennett,C,FLA,28,82,30,24,54
27,8482109,Alexis Lafrenière,L,NYR,23,82,29,25,54
27,8482745,Mason McTavish,C,ANA,21,82,27,27,54
27,8477495,Seth Jones,D,CHI,30,82,17,37,54
27,8477932,Aaron Ekblad,D,FLA,28,82,15,39,54
27,8481581,Thomas Harley,D,DAL,23,82,7,47,54
27,8475745,Charlie Coyle,C,BOS,32,82,26,27,53
27,8480078,Filip Chytil,C,NYR,25,82,26,27,53
27,8477511,Anthony Mantha,R,CGY,30,82,23,30,53
27,8478407,Vince Dunn,D,SEA,28,82,12,41,53
27,8478038,Devon Toews,D,COL,30,82,11,42,53
27,8478498,Jake DeBrusk,L,VAN,28,82,23,29,52
27,8475169,Evander Kane,L,EDM,33,82,23,29,52
27,8481618,Alex Newhook,C,MTL,23,82,22,30,52
27,8479400,Pierre-Luc Dubois,L,WSH,26,82,21,31,52
27,8479325,Charlie McAvoy,D,BOS,27,82,17,35,52
27,8481711,Matias Maccelli,L,UTA,24,82,11,41,52
27,8477986,Brandon Montour,D,SEA,30,82,11,41,52
27,8475754,Brock Nelson,C,NYI,33,82,28,23,51
27,8482740,Wyatt Johnston,C,DAL,21,82,27,24,51
27,8482175,JJ Peterka,R,BUF,22,82,25,26,51
27,8474586,Jordan Eberle,R,SEA,34,82,19,32,51
27,8471724,Kris Letang,D,PIT,37,82,17,34,51
27,8482113,Anton Lundell,C,FLA,23,82,17,34,51
27,8476479,Phillip Danault,C,LAK,31,82,16,35,51
27,8478469,Thomas Chabot,D,OTT,27,82,14,37,51
27,8477447,Shea Theodore,D,VGK,29,82,7,44,51
27,8479365,Trent Frederic,C,BOS,26,82,27,23,50
27,8475768,Jaden Schwartz,C,SEA,32,82,26,24,50
27,8480185,Eetu Luostarinen,C,FLA,26,82,25,25,50
27,8480797,Joel Farabee,L,PHI,24,82,19,31,50
27,8476905,Chandler Stephenson,C,SEA,30,82,13,37,50
27,8482699,Dylan Guenther,R,UTA,21,82,29,20,49
27,8477426,Nicholas Paul,L,TBL,29,82,24,25,49
27,8482097,Jack Quinn,R,BUF,23,82,21,28,49
27,8480188,Fabian Zetterlund,L,SJS,25,82,21,28,49
27,8476462,Dougie Hamilton,D,NJD,31,82,14,35,49
27,8482149,Cole Perfetti,C,WPG,22,82,21,27,48
27,8480028,Morgan Frost,C,PHI,25,82,17,31,48
27,8478458,Jack Roslovic,C,CAR,27,82,15,33,48
27,8477021,Alex Kerfoot,C,UTA,30,82,13,35,48
27,8477494,Jonathan Drouin,L,COL,29,82,10,38,48
27,8476792,Torey Krug,D,STL,33,82,8,40,48
27,8482475,Yegor Chinakhov,R,CBJ,23,82,28,19,47
27,8481604,Pavel Dorofeyev,L,VGK,24,82,23,24,47
27,8474715,Cam Atkinson,R,TBL,35,82,21,26,47
27,8476483,Rickard Rakell,R,PIT,31,82,20,27,47
27,8475848,Brendan Gallagher,R,MTL,32,82,14,33,47
27,8478055,Gustav Forsling,D,FLA,28,82,12,35,47
27,8475151,Kyle Palmieri,C,NYI,33,82,27,19,46
27,8476826,Yanni Gourde,C,SEA,33,82,21,25,46
27,8477497,Sean Monahan,C,CBJ,30,82,19,27,46
27,8477964,Ivan Barbashev,C,VGK,29,82,19,27,46
27,8478891,Mason Appleton,C,WPG,28,82,19,27,46
27,8477416,Oliver Bjorkstrand,R,SEA,29,82,18,28,46
27,8484144,Connor Bedard,C,CHI,19,82,18,28,46
27,8479987,Morgan Geekie,C,BOS,26,82,14,32,46
27,8474716,Jared Spurgeon,D,MIN,35,82,13,33,46
27,8470613,Brent Burns,D,CAR,39,82,12,34,46
27,8482667,William Eklund,L,SJS,22,82,11,35,46
27,8479410,Mikhail Sergachev,D,UTA,26,82,7,39,46
27,8471698,T.J. Oshie,R,WSH,38,82,24,21,45
27,8475793,Ryan Johansen,C,PHI,32,82,22,23,45
27,8477953,Kasperi Kapanen,R,STL,28,82,19,26,45
27,8482124,Quinton Byfield,R,LAK,22,82,16,29,45
27,8478233,Andrew Mangiapane,L,WSH,28,82,16,29,45
27,8478472,Mathieu Joseph,R,STL,27,82,15,30,45
27,8480871,Adam Boqvist,D,FLA,24,82,14,31,45
27,8478413,Jordan Greenway,L,BUF,27,82,13,32,45
27,8482684,Luke Hughes,D,NJD,21,82,10,35,45
27,8477952,Robby Fabbri,C,ANA,28,82,27,17,44
27,8477444,Andre Burakovsky,L,SEA,29,82,19,25,44
27,8478462,Nicolas Roy,C,VGK,27,82,18,26,44
27,8480434,Sean Durzi,D,UTA,26,82,9,35,44
27,8480459,Pius Suter,C,VAN,28,82,23,20,43
27,8476392,Adam Lowry,C,WPG,31,82,17,26,43
27,8482705,Cole Sillinger,C,CBJ,21,82,15,28,43
27,8479525,Ross Colton,C,COL,28,82,15,28,43
27,8476906,Shayne Gostisbehere,D,CAR,31,82,9,34,43
27,8478507,John Marino,D,UTA,27,82,6,37,43
27,8475760,Nick Bjugstad,C,UTA,32,82,22,20,42
27,8475287,Erik Haula,L,NJD,33,82,19,23,42
27,8481624,Ilya Mikheyev,R,CHI,30,82,17,25,42
27,8475791,Taylor Hall,L,CHI,33,82,17,25,42
27,8480802,Ryan McLeod,C,BUF,25,82,16,26,42
27,8483515,Juraj Slafkovsky,L,MTL,20,82,15,27,42
27,8479345,Jakob Chychrun,D,WSH,26,82,14,28,42
27,8481560,Arthur Kaliyev,R,LAK,23,82,12,30,42
27,8476869,Brady Skjei,D,NSH,30,82,10,32,42
27,8480145,Neal Pionk,D,WPG,29,82,5,37,42
27,8481093,Rafael Harvey-Pinard,L,MTL,25,82,28,13,41
27,8473422,Nick Foligno,L,CHI,37,82,25,16,41
27,8479316,Luke Kunin,C,SJS,27,82,23,18,41
27,8482110,Dawson Mercer,C,NJD,23,82,21,20,41
27,8477989,Christian Dvorak,C,MTL,28,82,21,20,41
27,8475799,Nino Niederreiter,R,WPG,32,82,20,21,41
27,8482720,Matthew Knies,L,TOR,22,82,18,23,41
27,8481522,Peyton Krebs,C,BUF,23,82,18,23,41
27,8477998,Warren Foegele,L,LAK,28,82,17,24,41
27,8480798,Philipp Kurashev,C,CHI,25,82,17,24,41
27,8482105,Jake Sanderson,D,OTT,22,82,14,27,41
27,8477456,J.T. Compher,L,DET,29,82,11,30,41
27,8476854,Hampus Lindholm,D,BOS,30,82,7,34,41
27,8481535,Nils Hoglander,L,VAN,24,82,25,15,40
27,8476880,Tom Wilson,R,WSH,30,82,21,19,40
27,8475763,Kevin Hayes,R,PIT,32,82,15,25,40
27,8476872,Scott Laughton,C,PHI,30,82,14,26,40
27,8481554,Kaapo Kakko,R,NYR,23,82,14,26,40
27,8477503,Max Domi,C,TOR,29,82,12,28,40
27,8477429,Andrew Copp,C,DET,30,82,12,28,40
27,8476958,Jaccob Slavin,D,CAR,30,82,9,31,40
27,8482671,Owen Power,D,BUF,22,82,8,32,40
27,8476892,Colton Parayko,D,STL,31,82,4,36,40
27,8478474,Lawson Crouse,L,UTA,27,82,23,16,39
27,8480113,Alex Iafallo,L,WPG,31,82,18,21,39
27,8476292,Ondrej Palat,L,NJD,33,82,17,22,39
27,8478542,Evan Rodrigues,C,FLA,31,82,13,26,39
27,8473563,Nicklas Backstrom,C,WSH,37,82,9,30,39
27,8476923,Damon Severson,D,CBJ,30,82,8,31,39
27,8482089,Jake Neighbours,L,STL,22,82,28,10,38
27,8481186,Logan O'Connor,R,COL,28,82,21,17,38
27,8481013,Jonatan Berggren,R,DET,24,82,19,19,38
27,8482055,Drew O'Connor,L,PIT,26,82,19,19,38
27,8480893,Kirill Marchenko,R,CBJ,24,82,17,21,38
27,8478463,Anthony Beauvillier,L,PIT,27,82,16,22,38
27,8476329,Travis Boyd,C,MIN,31,82,12,26,38
27,8477948,Travis Sanheim,D,PHI,28,82,10,28,38
27,8481546,Cam York,D,PHI,23,82,10,28,38
27,8476885,Jacob Trouba,D,NYR,30,82,10,28,38
27,8481542,Moritz Seider,D,DET,23,82,8,30,38
27,8479992,Michael Rasmussen,C,DET,25,82,19,18,37
27,8475149,Marcus Johansson,L,MIN,34,82,14,23,37
27,8475193,Tomas Tatar,L,NJD,34,82,14,23,37
27,8474189,Lars Eller,C,PIT,35,82,12,25,37
27,8476925,Colton Sissons,C,NSH,31,82,12,25,37
27,8478211,Dryden Hunt,L,CGY,29,82,10,27,37
27,8476461,Sean Couturier,C,PHI,32,82,16,20,36
27,8477450,Jason Dickinson,C,CHI,29,82,15,21,36
27,8474149,Evgenii Dadonov,R,DAL,35,82,13,23,36
27,8476897,Oskar Sundqvist,C,STL,30,82,13,23,36
27,8477498,Darnell Nurse,D,EDM,29,82,10,26,36
27,8473533,Jordan Staal,C,CAR,36,82,19,16,35
27,8479996,Cody Glass,C,NSH,25,82,18,17,35
27,8477987,Ryan Donato,C,CHI,28,82,16,19,35
27,8479425,Filip Hronek,D,VAN,27,82,7,28,35
27,8479976,Juuso Valimaki,D,UTA,26,82,5,30,35
27,8475764,Cam Fowler,D,ANA,33,82,3,32,35
27,8484166,Adam Fantilli,C,CBJ,20,82,20,14,34
27,8477451,Ryan Hartman,R,MIN,30,82,19,15,34
27,8478109,Victor Olofsson,L,VGK,29,82,18,16,34
27,8475231,Casey Cizikas,C,NYI,33,82,17,17,34
27,8476474,Stefan Noesen,R,NJD,31,82,16,18,34
27,8480220,Noah Cates,L,PHI,25,82,14,20,34
27,8480748,Kiefer Sherwood,L,VAN,29,82,14,20,34
27,8476438,Brandon Saad,L,STL,32,82,12,22,34
27,8475855,Jesper Fast,R,CAR,33,82,12,22,34
27,8480003,Jesper Boqvist,C,FLA,26,82,11,23,34
27,8475200,Dmitry Orlov,D,CAR,33,82,7,27,34
27,8478057,Dakota Joshua,C,VAN,28,82,20,13,33
27,8477931,Tomas Nosek,L,FLA,32,82,19,14,33
27,8475714,Calle Jarnkrok,C,TOR,33,82,16,17,33
27,8481580,Connor McMichael,C,WSH,23,82,16,17,33
27,8480009,Eeli Tolvanen,R,SEA,25,82,14,19,33
27,8476480,Vladislav Namestnikov,C,WPG,32,82,14,19,33
27,8478432,Christian Fischer,R,DET,27,82,14,19,33
27,8481656,Aliaksei Protas,C,WSH,23,82,13,20,33
27,8478115,Pierre Engvall,L,NYI,28,82,12,21,33
27,8477392,Hudson Fasching,R,NYI,29,82,11,22,33
27,8476927,Teddy Blueger,C,VAN,30,82,7,26,33
27,8480817,K'Andre Miller,D,NYR,24,82,7,26,33
27,8477506,Ryan Pulock,D,NYI,30,82,6,27,33
27,8479402,Jake Bean,D,CGY,26,82,6,27,33
27,8480873,Rasmus Sandin,D,WSH,24,82,4,29,33
27,8480043,Timothy Liljegren,D,TOR,25,82,4,29,33
27,8476469,Joel Armia,R,MTL,31,82,18,14,32
27,8480995,Pontus Holmberg,R,TOR,25,82,16,16,32
27,8476918,Jimmy Vesey,L,NYR,31,82,15,17,32
27,8479353,Brett Howden,C,VGK,26,82,14,18,32
27,8482660,Kent Johnson,C,CBJ,22,82,13,19,32
27,8480806,Isac Lundestrom,C,ANA,25,82,12,20,32
27,8479661,Tanner Jeannot,L,LAK,27,82,10,22,32
27,8476419,Jean-Gabriel Pageau,C,NYI,32,82,9,23,32
27,8478911,Matt Roy,D,WSH,29,82,9,23,32
27,8479591,Michael Eyssimont,C,TBL,28,82,9,23,32
27,8475171,Oliver Ekman-Larsson,D,TOR,33,82,7,25,32
27,8477488,Brett Pesce,D,NJD,30,82,7,25,32
27,8482142,Jamie Drysdale,D,PHI,22,82,6,26,32
27,8480073,Erik Brannstrom,D,COL,25,82,5,27,32
27,8476463,Jonas Brodin,D,MIN,31,82,4,28,32
27,8478500,Ivan Provorov,D,CBJ,27,82,4,28,32
27,8480281,Alexey Toropchenko,R,STL,25,82,22,9,31
27,8480829,Jesperi Kotkaniemi,C,CAR,24,82,20,11,31
27,8480835,Jack Drury,C,CAR,24,82,16,15,31
27,8482125,Alexander Holtz,R,VGK,22,82,15,16,31
27,8479390,Taylor Raddysh,R,WSH,26,82,13,18,31
27,8481481,Blake Lizotte,C,PIT,27,82,13,18,31
27,8475218,Mattias Ekholm,D,EDM,34,82,11,20,31
27,8480878,Nils Lundkvist,D,DAL,24,82,11,20,31
27,8478133,Jake Evans,C,MTL,28,82,8,23,31
27,8475188,Brayden McNabb,D,VGK,33,82,7,24,31
27,8481477,Nico Sturm,C,SJS,29,82,18,12,30
27,8478020,Michael Amadio,C,OTT,28,82,17,13,30
27,8481028,Martin Pospisil,C,CGY,25,82,16,14,30
27,8476981,Josh Anderson,R,MTL,30,82,14,16,30
27,8476979,Erik Gustafsson,D,DET,32,82,8,22,30
27,8477969,Marcus Pettersson,D,PIT,28,82,3,27,30
27,8476879,Cody Ceci,D,EDM,31,82,3,27,30
27,8481601,Simon Holmstrom,R,NYI,23,82,19,10,29
27,8481582,Nicholas Robertson,L,TOR,23,82,17,12,29
27,8470621,Corey Perry,R,EDM,39,82,17,12,29
27,8480144,David Kampf,C,TOR,29,82,13,16,29
27,8481517,Brett Leason,R,ANA,25,82,12,17,29
27,8476921,Jordan Martinook,L,CAR,32,82,10,19,29
27,8477938,Haydn Fleury,D,WPG,28,82,10,19,29
27,8484153,Leo Carlsson,C,ANA,20,82,9,20,29
27,8479351,Sam Steel,C,DAL,26,82,9,20,29
27,8474151,Ryan McDonagh,D,TBL,35,82,6,23,29
27,8476917,Adam Pelech,D,NYI,30,82,0,29,29
27,8482146,Luke Evangelista,R,NSH,22,82,18,10,28
27,8482259,Bobby McMann,C,TOR,28,82,16,12,28
27,8479393,Noah Gregor,C,OTT,26,82,16,12,28
27,8476442,Matt Nieto,L,PIT,32,82,15,13,28
27,8482079,Marco Rossi,C,MIN,23,82,14,14,28
27,8478046,Danton Heinen,L,VAN,29,82,13,15,28
27,8477839,Conor Sheary,L,TBL,32,82,13,15,28
27,8477919,Frederick Gaudreau,C,MIN,31,82,13,15,28
27,8480789,Oliver Wahlstrom,R,NYI,24,82,11,17,28
27,8476960,Andreas Athanasiou,C,CHI,30,82,10,18,28
27,8480980,Connor Dewar,C,TOR,25,82,9,19,28
27,8479293,Brandon Tanev,L,SEA,33,82,7,21,28
27,8476902,Esa Lindell,D,DAL,30,82,7,21,28
27,8478399,Jonas Siegenthaler,D,NJD,27,82,6,22,28
27,8477435,Ryan Graves,D,PIT,29,82,6,22,28
27,8482087,Kaiden Guhle,D,MTL,22,82,5,23,28
27,8482655,J.J. Moser,D,TBL,24,82,3,25,28
27,8483431,Logan Cooley,C,UTA,20,82,19,8,27
27,8482117,Lukas Reichel,L,CHI,22,82,14,13,27
27,8479359,Beck Malenstyn,L,BUF,26,82,13,14,27
27,8478013,Jake Walman,D,SJS,28,82,11,16,27
27,8484203,Bradly Nadeau,L,CAR,19,82,9,18,27
27,8481606,Jordan Spence,D,LAK,23,82,8,19,27
27,8481553,Bobby Brink,R,PHI,23,82,8,19,27
27,8475790,Erik Gudbranson,D,CBJ,32,82,5,22,27
27,8476331,Dylan DeMelo,D,WPG,31,82,5,22,27
27,8477845,Trevor van Riemsdyk,D,WSH,33,82,4,23,27
27,8477220,Nate Schmidt,D,FLA,33,82,3,24,27
27,8475343,Nic Dowd,C,WSH,34,82,14,12,26
27,8476873,Mark Jankowski,C,NSH,30,82,13,13,26
27,8476278,Colin Blackwell,C,DAL,31,82,11,15,26
27,8476374,Sean Kuraly,C,CBJ,31,82,10,16,26
27,8482111,Justin Barron,D,MTL,23,82,10,16,26
27,8481524,Bowen Byram,D,BUF,23,82,10,16,26
27,8482624,Daniil Miromanov,D,CGY,27,82,8,18,26
27,8475324,Nick Jensen,D,OTT,34,82,5,21,26
27,8475233,David Savard,D,MTL,34,82,3,23,26
27,8477507,Nikita Zadorov,D,BOS,29,82,3,23,26
27,8478178,Darren Raddysh,D,TBL,28,82,2,24,26
27,8475220,Marcus Foligno,L,MIN,33,82,14,11,25
27,8477947,Sonny Milano,L,WSH,28,82,10,15,25
27,8481704,Juuso Parssinen,C,NSH,23,82,9,16,25
27,8478434,Keegan Kolesar,R,VGK,27,82,9,16,25
27,8476624,Barclay Goodrow,C,SJS,31,82,7,18,25
27,8476422,Mike Reilly,D,NYI,31,82,6,19,25
27,8477369,Carson Soucy,D,VAN,30,82,6,19,25
27,8476931,Jake McCabe,D,TOR,31,82,3,22,25
27,8481568,Alex Vlasic,D,CHI,23,82,3,22,25
27,8480049,Dylan Samberg,D,WPG,25,82,1,24,25
27,8480855,Jack McBain,C,UTA,24,82,14,10,24
27,8479368,Max Jones,L,BOS,26,82,13,11,24
27,8476878,Zemgus Girgensons,L,TBL,30,82,12,12,24
27,8481032,Paul Cotter,C,NJD,25,82,11,13,24
27,8477903,Garnet Hathaway,R,PHI,33,82,8,16,24
27,8480336,Sean Walker,D,CAR,30,82,7,17,24
27,8482803,Olen Zellweger,D,ANA,21,82,5,19,24
27,8484145,Zach Benson,L,BUF,19,82,5,19,24
27,8476312,Josh Manson,D,COL,33,82,5,19,24
27,8478882,Vladislav Gavrikov,D,LAK,29,82,4,20,24
27,8479398,Samuel Girard,D,COL,26,82,2,22,24
27,8480025,MacKenzie Entwistle,R,FLA,25,82,13,10,23
27,8482679,Matt Coronato,R,CGY,22,82,12,11,23
27,8482062,Cole Smith,L,NSH,29,82,12,11,23
27,8477425,Miles Wood,L,COL,29,82,10,13,23
27,8478569,Noel Acciari,C,PIT,33,82,10,13,23
27,8480074,Alexandre Texier,C,STL,25,82,8,15,23
27,8479941,Justin Danforth,R,CBJ,31,82,7,16,23
27,8482133,Thomas Bordeleau,C,SJS,22,82,5,18,23
27,8483565,Nick Blankenburg,D,NSH,26,82,5,18,23
27,8479369,Andrew Peeke,D,BOS,26,82,4,19,23
27,8479371,Dante Fabbro,D,NSH,26,82,4,19,23
27,8478508,Yakov Trenin,C,MIN,27,82,16,6,22
27,8482712,Oskar Olausson,R,COL,22,82,14,8,22
27,8480068,Ryan Poehling,C,PHI,25,82,9,13,22
27,8476889,Radek Faksa,C,STL,30,82,8,14,22
27,8483763,Maksymilian Szuber,D,UTA,22,82,8,14,22
27,8482702,Logan Stankoven,C,DAL,21,82,8,14,22
27,8480796,Martin Fehervary,D,WSH,25,82,7,15,22
27,8477508,Curtis Lazar,C,NJD,29,82,6,16,22
27,8480172,Jan Rutta,D,SJS,34,82,6,16,22
27,8479324,Ryan Lindgren,D,NYR,26,82,5,17,22
27,8475177,Calvin de Haan,D,COL,33,82,5,17,22
27,8478851,Alexandre Carrier,D,NSH,28,82,4,18,22
27,8478416,Erik Cernak,D,TBL,27,82,4,18,22
27,8481014,Alexander Romanov,D,NYI,24,82,3,19,22
27,8480807,Mattias Samuelsson,D,BUF,24,82,2,20,22
27,8475842,Sam Carrick,C,NYR,32,82,11,10,21
27,8477505,Alexander Wennberg,C,SJS,30,82,9,12,21
27,8482807,Ethan Del Mastro,D,CHI,21,82,8,13,21
27,8476467,Jamie Oleksiak,D,SEA,32,82,8,13,21
27,8482245,Artem Zub,D,OTT,29,82,5,16,21
27,8474574,Tyler Myers,D,VAN,34,82,4,17,21
27,8477365,Connor Clifton,D,BUF,29,82,3,18,21
27,8481567,Henry Thrun,D,SJS,23,82,3,18,21
27,8481178,Egor Zamula,D,PHI,24,82,1,20,21
27,8482073,Braden Schneider,D,NYR,23,82,1,20,21
27,8479638,Justin Brazeau,R,BOS,26,82,10,10,20
27,8483482,Tristan Luneau,D,ANA,20,82,9,11,20
27,8483445,Cutter Gauthier,L,ANA,20,82,8,12,20
27,8482092,Ridly Greig,C,OTT,22,82,6,14,20
27,8482141,Lukas Cormier,D,VGK,22,82,6,14,20
27,8483457,Lane Hutson,D,MTL,20,82,5,15,20
27,8476967,Brett Kulak,D,EDM,30,82,4,16,20
27,8478840,Will Borgen,D,SEA,28,82,2,18,20
27,8481605,Jackson LaCombe,D,ANA,23,82,2,18,20
27,8476429,Scott Mayfield,D,NYI,32,82,1,19,20
27,8479414,Nathan Bastian,R,NJD,27,82,11,8,19
27,8480448,Parker Kelly,L,COL,25,82,10,9,19
27,8480813,Joe Veleno,C,DET,24,82,9,10,19
27,8482762,Simon Edvinsson,D,DET,21,82,9,10,19
27,8480849,Barrett Hayton,C,UTA,24,82,8,11,19
27,8484149,Gavin Brindley,C,CBJ,20,82,7,12,19
27,8477015,Connor Brown,R,EDM,30,82,6,13,19
27,8482101,Danil Gushchin,L,SJS,22,82,6,13,19
27,8483499,Liam Ohgren,L,MIN,20,82,6,13,19
27,8483490,Pavel Mintyukov,D,ANA,21,82,5,14,19
27,8482074,Connor Zary,C,CGY,23,82,5,14,19
27,8475455,Brenden Dillon,D,NJD,34,82,4,15,19
27,8480990,Declan Chisholm,D,MIN,24,82,3,16,19
27,8482122,Brock Faber,D,MIN,22,82,2,17,19
27,8480035,Henri Jokiharju,D,BUF,25,82,2,17,19
27,8482155,Alex Laferriere,R,LAK,23,82,12,6,18
27,8473453,Trevor Lewis,C,LAK,37,82,12,6,18
27,8483012,Logan Morrison,C,SEA,22,82,8,10,18
27,8477353,Tyler Motte,C,DET,29,82,7,11,18
27,8482733,Logan Mailloux,D,MTL,31,82,7,11,18
27,8479983,Mario Ferraro,D,SJS,26,82,5,13,18
27,8483468,Jiri Kulich,C,BUF,20,82,5,13,18
27,8475718,Justin Holl,D,DET,32,82,4,14,18
27,8476372,Nick Seeler,D,PHI,31,82,4,14,18
27,8478468,Jeremy Lauzon,D,NSH,27,82,3,15,18
27,8478136,Jake Middleton,D,MIN,28,82,2,16,18
27,8479998,Mikey Anderson,D,LAK,25,82,2,16,18
27,8478859,Niko Mikkola,D,FLA,28,82,2,16,18
27,8479291,Kevin Rooney,C,CGY,31,82,8,9,17
27,8482809,Jackson Blake,R,CAR,21,82,6,11,17
27,8474090,Brendan Smith,D,DAL,35,82,5,12,17
27,8480950,Ilya Lyubushkin,D,DAL,30,82,5,12,17
27,8480222,Sebastian Aho,D,PIT,28,82,4,13,17
27,8477034,Jaycob Megna,D,FLA,32,82,3,14,17
27,8476525,Colin Miller,D,WPG,32,82,3,14,17
27,8482858,Ryker Evans,D,SEA,23,82,3,14,17
27,8482153,Brendan Brisson,C,VGK,23,82,3,14,17
27,8471677,Jack Johnson,D,CBJ,37,82,3,14,17
27,8474567,Zach Bogosian,D,MIN,34,82,2,15,17
27,8476891,Matt Grzelcyk,D,PIT,30,82,0,17,17
27,8482659,Josh Doan,R,UTA,22,82,11,5,16
27,8477406,Mattias Janmark,C,EDM,32,82,10,6,16
27,8482077,Dylan Holloway,L,EDM,23,82,9,7,16
27,8482145,Mavrik Bourque,C,DAL,22,82,7,9,16
27,8478443,Brandon Carlo,D,BOS,28,82,7,9,16
27,8482166,Shakir Mukhamadullin,D,SJS,22,82,6,10,16
27,8482713,Mackie Samoskevich,R,FLA,22,82,5,11,16
27,8480246,Nick Perbix,D,TBL,26,82,3,13,16
27,8475181,Nick Leddy,D,STL,33,82,2,14,16
27,8477335,Kyle Burroughs,D,LAK,29,82,2,14,16
27,8475462,Radko Gudas,D,ANA,34,82,2,14,16
27,8480860,Kevin Bahl,D,CGY,24,82,1,15,16
27,8476473,Connor Murphy,D,CHI,31,82,1,15,16
27,8476858,Phillip Di Giuseppe,L,VAN,31,82,11,4,15
27,8480021,Jack Studnicka,C,LAK,25,82,8,7,15
27,8484911,Collin Graf,R,SJS,22,82,8,7,15
27,8483471,Brad Lambert,C,WPG,31,82,7,8,15
27,8477499,Rasmus Ristolainen,D,PHI,30,82,6,9,15
27,8482666,Scott Morrow,D,CAR,22,82,6,9,15
27,8483493,Frank Nazar,C,CHI,20,82,5,10,15
27,8481708,Zac Jones,D,NYR,24,82,5,10,15
27,8482859,Zack Ostapchuk,C,OTT,21,82,5,10,15
27,8483495,Simon Nemec,D,NJD,20,82,4,11,15
27,8474013,Ian Cole,D,UTA,35,82,3,12,15
27,8483466,Kevin Korchinski,D,CHI,20,82,3,12,15
27,8480879,Jacob Bernard-Docker,D,OTT,24,82,0,15,15
27,8483397,Marc McLaughlin,C,BOS,25,82,8,6,14
27,8483505,Matthew Poitras,C,BOS,20,82,4,10,14
27,8475279,Ben Chiarot,D,DET,33,82,3,11,14
27,8483460,David Jiricek,D,CBJ,21,82,2,12,14
27,8482070,Mitchell Chaffee,R,TBL,26,82,7,6,13
27,8476457,Adam Larsson,D,SEA,32,82,5,8,13
27,8479980,Nicolas Hague,D,VGK,26,82,3,10,13
27,8476441,Joel Edmundson,D,LAK,31,82,2,11,13
27,8475690,Chris Tanev,D,TOR,35,82,1,12,13
27,8482749,Joshua Roy,R,MTL,21,82,6,6,12
27,8483524,Shane Wright,C,SEA,20,82,5,7,12
27,8470600,Ryan Suter,D,STL,39,82,3,9,12
27,8478874,Adam Gaudette,C,OTT,28,82,3,9,12
27,8482118,Sam Colangelo,R,ANA,23,82,3,9,12
27,8479576,Vincent Desharnais,D,VAN,28,82,3,9,12
27,8482470,Ilya Solovyov,D,CGY,24,82,2,10,12
27,8478450,Parker Wotherspoon,D,BOS,27,82,2,10,12
27,8473507,Jeff Petry,D,DET,37,82,1,11,12
27,8480834,Ty Emberson,D,SJS,24,82,4,7,11
27,8475762,Derek Forbort,D,VAN,32,82,4,7,11
27,8479442,Troy Stecher,D,EDM,30,82,3,8,11
27,8481641,Joel Kiviranta,L,COL,28,82,7,3,10
27,8480870,Bo Groulx,C,NYR,24,82,6,4,10
27,8482516,Matthew Kessel,D,STL,24,82,5,5,10
27,8476822,Luke Glendening,C,TBL,35,82,5,4,9
27,8481122,Simon Benoit,D,TOR,26,82,5,4,9
27,8474612,Travis Hamonic,D,OTT,34,82,3,5,8
27,8483567,Georgii Merkulov,C,BOS,24,82,2,6,8
27,8481699,Aku Raty,R,UTA,23,82,2,6,8
27,8483489,Fraser Minten,C,TOR,31,82,4,3,7
27,8482787,Nikita Chibrikov,R,WPG,31,82,3,2,5
27,8474062,Riley Nash,C,NYR,35,82,1,1,2
27,8470794,Joe Pavelski,C,,40,0,0,0,0
27,8481703,Valtteri Puustinen,R,PIT,25,0,0,0,0
27,8477950,Tony DeAngelo,D,,29,0,0,0,0
27,8481577,Philip Tomasino,C,NSH,23,0,0,0,0
27,8475197,Tyson Barrie,D,,33,0,0,0,0
27,8471218,Blake Wheeler,R,,38,0,0,0,0
27,8474157,Max Pacioretty,L,,36,0,0,0,0
27,8478466,Daniel Sprong,R,VAN,27,0,0,0,0
27,8475744,Evgeny Kuznetsov,C,,32,0,0,0,0
27,8481019,David Gustafsson,C,WPG,24,0,0,0,0
27,8475906,John Klingberg,D,,32,0,0,0,0
27,8479348,Kale Clague,D,BUF,26,0,0,0,0
27,8476952,Dominic Toninato,C,WPG,30,0,0,0,0
27,8473473,Milan Lucic,L,,36,0,0,0,0
27,8474037,James van Riemsdyk,L,,35,0,0,0,0
27,8474602,Justin Schultz,D,,34,0,0,0,0
27,8482222,Alexander Barabanov,L,,30,0,0,0,0
27,8479372,Josh Mahura,D,SEA,26,0,0,0,0
27,8479982,Conor Timmins,D,TOR,26,0,0,0,0
27,8474031,Kevin Shattenkirk,D,,35,0,0,0,0
27,8480008,Adam Ruzicka,C,,25,0,0,0,0
27,8481059,Scott Perunovich,D,STL,26,0,0,0,0
27,8480884,Calen Addison,D,,24,0,0,0,0
27,8476994,Vinnie Hinostroza,C,NSH,30,0,0,0,0
27,8478452,Caleb Jones,D,LAK,27,0,0,0,0
27,8480157,Calle Rosen,D,COL,30,0,0,0,0
27,8481609,Vladislav Kolyachonok,D,UTA,23,0,0,0,0
27,8479415,Michael McLeod,C,,26,0,0,0,0
27,8476919,Chris Tierney,C,,30,0,0,0,0
27,8479639,Dylan Coghlan,D,WPG,26,0,0,0,0
27,8478146,Matthew Highmore,C,OTT,28,0,0,0,0
27,8478970,Jalen Chatfield,D,CAR,28,0,0,0,0
27,8480205,Emil Bemstrom,C,PIT,25,0,0,0,0
27,8474884,Mike Hoffman,C,,35,0,0,0,0
27,8471274,Alex Goligoski,D,,39,0,0,0,0
27,8478104,Sammy Blais,L,,28,0,0,0,0
27,8474870,Tyler Johnson,C,,34,0,0,0,0
27,8476913,Devin Shore,C,MIN,30,0,0,0,0
27,8481598,Philip Broberg,D,EDM,23,0,0,0,0
27,8480058,Pierre-Olivier Joseph,D,STL,25,0,0,0,0
27,8480891,Michael Kesselring,D,UTA,24,0,0,0,0
27,8477979,Nicolas Aube-Kubel,R,BUF,28,0,0,0,0
27,8476871,Tanner Pearson,L,,32,0,0,0,0
27,8476393,Nick Cousins,C,,31,0,0,0,0
27,8479977,Kailer Yamamoto,R,,26,0,0,0,0
27,8479543,Michael Pezzetta,L,MTL,26,0,0,0,0
27,8477018,Ben Hutton,D,VGK,31,0,0,0,0
27,8480762,Eric Robinson,L,CAR,29,0,0,0,0
27,8474034,Pat Maroon,L,CHI,36,0,0,0,0
27,8481058,Jesse Ylönen,R,,25,0,0,0,0
27,8475179,Dmitry Kulikov,D,FLA,34,0,0,0,0
27,8481527,Kaedan Korczak,D,VGK,23,0,0,0,0
27,8473449,Kyle Okposo,R,,36,0,0,0,0
27,8482192,Isaak Phillips,D,CHI,23,0,0,0,0
27,8480727,Zach Whitecloud,D,VGK,28,0,0,0,0
27,8479346,Dillon Dube,C,,26,0,0,0,0
27,8480821,Filip Zadina,R,,25,0,0,0,0
27,8480001,Urho Vaakanainen,D,ANA,25,0,0,0,0
27,8470966,Mark Giordano,D,,41,0,0,0,0
27,8480853,Liam Foudy,C,,24,0,0,0,0
27,8475225,Craig Smith,C,CHI,35,0,0,0,0
27,8479972,Mason Shaw,C,WPG,26,0,0,0,0
27,8478451,Ethan Bear,D,WSH,27,0,0,0,0
27,8474040,Sam Gagner,C,,35,0,0,0,0
27,8480196,Jacob Bryson,D,BUF,27,0,0,0,0
27,8479984,Cal Foote,D,,26,0,0,0,0
27,8480011,Klim Kostin,C,SJS,25,0,0,0,0
27,8482176,Wyatt Kaiser,D,CHI,22,0,0,0,0
27,8476988,Matt Benning,D,SJS,30,0,0,0,0
27,8479370,Tyson Jost,C,CAR,26,0,0,0,0
27,8477464,Nic Petan,C,,29,0,0,0,0
27,8477380,Jonny Brodzinski,C,NYR,31,0,0,0,0
27,8480070,Ian Mitchell,D,BOS,25,0,0,0,0
27,8479315,Joey Anderson,R,CHI,26,0,0,0,0
27,8478099,Kevin Labanc,R,,29,0,0,0,0
27,8476874,Olli Maatta,D,DET,30,0,0,0,0
27,8475208,Brian Dumoulin,D,ANA,33,0,0,0,0
27,8478430,Oliver Kylington,D,,27,0,0,0,0
27,8479536,Axel Jonsson-Fjallby,L,WPG,26,0,0,0,0
27,8479671,Mathieu Olivier,R,CBJ,27,0,0,0,0
27,8471709,Marc-Edouard Vlasic,D,SJS,37,0,0,0,0
27,8479328,Julien Gauthier,R,NYI,27,0,0,0,0
27,8478421,A.J. Greer,L,FLA,28,0,0,0,0
27,8477573,Nathan Walker,L,STL,30,0,0,0,0
27,8481537,Nikita Okhotiuk,D,CGY,24,0,0,0,0
27,8474166,Alec Martinez,D,CHI,37,0,0,0,0
27,8470610,Zach Parise,L,,40,0,0,0,0
27,8477478,William Carrier,L,CAR,30,0,0,0,0
27,8479344,Jesse Puljujarvi,R,PIT,26,0,0,0,0
27,8480887,Jordan Harris,D,MTL,24,0,0,0,0
27,8478502,Dennis Gilbert,D,BUF,28,0,0,0,0
27,8482730,Brandt Clarke,D,LAK,21,0,0,0,0
27,8480355,Mark Kastelic,C,BOS,25,0,0,0,0
27,8475750,Jon Merrill,D,MIN,32,0,0,0,0
27,8475164,Jakob Silfverberg,R,,34,0,0,0,0
27,8477944,Jakub Vrana,L,,28,0,0,0,0
27,8479439,Jacob MacDonald,D,COL,31,0,0,0,0
27,8474568,Luke Schenn,D,NSH,35,0,0,0,0
27,8478454,Noah Juulsen,D,VAN,27,0,0,0,0
27,8475752,Tyler Pitlick,C,,33,0,0,0,0
27,8482148,Hendrix Lapierre,C,WSH,22,0,0,0,0
27,8481167,Brayden Pachal,D,CGY,25,0,0,0,0
27,8478043,Sam Lafferty,C,BUF,29,0,0,0,0
27,8479321,Lucas Johansen,D,,27,0,0,0,0
27,8471699,Andrew Cogliano,C,,37,0,0,0,0
27,8481521,Ronnie Attard,D,PHI,25,0,0,0,0
27,8481161,Jake Christiansen,D,CBJ,25,0,0,0,0
27,8479458,Nikita Zaitsev,D,,33,0,0,0,0
27,8479619,Michael Carcone,L,UTA,28,0,0,0,0
27,8479026,Philippe Myers,D,TOR,27,0,0,0,0
27,8477330,Dominik Kubalik,L,,29,0,0,0,0
27,8481617,Vasily Podkolzin,R,VAN,23,0,0,0,0
27,8481701,Santeri Hatakka,D,NJD,23,0,0,0,0
27,8479514,Rem Pitlick,C,,27,0,0,0,0
27,8477446,Michael McCarron,R,NSH,29,0,0,0,0
27,8470604,Jeff Carter,C,,39,0,0,0,0
27,8482241,Radim Zohorna,L,,28,0,0,0,0
27,8480289,Morgan Barron,C,WPG,26,0,0,0,0
27,8479379,Givani Smith,R,SJS,26,0,0,0,0
27,8480216,Jacob Peterson,C,,25,0,0,0,0
27,8477851,Jordan Oesterle,D,BOS,32,0,0,0,0
27,8484258,Sam Malinski,D,COL,26,0,0,0,0
27,8478904,Steven Lorentz,C,,28,0,0,0,0
27,8482095,Tyler Kleven,D,OTT,22,0,0,0,0
27,8480848,Ty Dellandrea,C,SJS,24,0,0,0,0
27,8476884,Derrick Pouliot,D,,30,0,0,0,0
27,8479336,Carl Grundstrom,R,SJS,27,0,0,0,0
27,8482964,Arber Xhekaj,D,MTL,23,0,0,0,0
27,8471686,Marc Staal,D,,37,0,0,0,0
27,8477887,Patrick Brown,C,BOS,32,0,0,0,0
27,8478495,Denis Gurianov,R,,27,0,0,0,0
27,8473504,Cal Clutterbuck,R,,37,0,0,0,0
27,8481550,Adam Beckman,L,NJD,23,0,0,0,0
27,8480845,Rasmus Kupari,C,WPG,24,0,0,0,0
27,8474009,Nick Bonino,C,,36,0,0,0,0
27,8478585,Derek Ryan,C,EDM,38,0,0,0,0
27,8477962,Brendan Lemieux,L,CAR,28,0,0,0,0
27,8482861,Vincent Iorio,D,WSH,22,0,0,0,0
27,8479378,Logan Stanley,D,WPG,26,0,0,0,0
27,8473446,Erik Johnson,D,PHI,36,0,0,0,0
27,8481743,Marc Del Gaizo,D,NSH,25,0,0,0,0
27,8477384,Josh Brown,D,EDM,30,0,0,0,0
27,8482165,Yan Kuznetsov,D,CGY,22,0,0,0,0
27,8478424,Jansen Harkins,C,ANA,27,0,0,0,0
27,8482144,Jack Thompson,D,SJS,22,0,0,0,0
27,8478512,Austin Czarnik,C,,32,0,0,0,0
27,8477527,Ross Johnston,L,ANA,30,0,0,0,0
27,8479383,Boris Katchouk,L,,26,0,0,0,0
27,8482094,Daemon Hunt,D,MIN,22,0,0,0,0
27,8481719,Maxwell Crozier,D,TBL,24,0,0,0,0
27,8480192,Johnathan Kovacevic,D,NJD,27,0,0,0,0
27,8479376,Victor Mete,D,,26,0,0,0,0
27,8482511,Mason Lohrei,D,BOS,23,0,0,0,0
27,8475825,Jani Hakanpää,D,,32,0,0,0,0
27,8478021,William Lagesson,D,DET,28,0,0,0,0
27,8475795,Dylan McIlrath,D,WSH,32,0,0,0,0
27,8477846,Ryan Carpenter,C,,33,0,0,0,0
27,8481056,Spencer Stastney,D,NSH,24,0,0,0,0
27,8481564,Ryan Johnson,D,BUF,23,0,0,0,0
27,8478017,Mark Friedman,D,VAN,29,0,0,0,0
27,8479320,Max Lajoie,D,SEA,27,0,0,0,0
27,8480075,Cameron Crotty,D,MIN,25,0,0,0,0
27,8484287,Cole McWard,D,VAN,23,0,0,0,0
27,8484254,Akito Hirose,D,VAN,25,0,0,0,0
27,8483407,Brandon Scanlin,D,NYR,25,0,0,0,0
27,8480274,Philip Kemp,D,EDM,25,0,0,0,0
27,8479522,Hardy Haman Aktell,D,WSH,26,0,0,0,0
27,8480007,Jonas Rondbjerg,R,VGK,25,0,0,0,0
27,8477454,Adam Erne,L,,29,0,0,0,0
27,8481679,Maxence Guenette,D,OTT,23,0,0,0,0
27,8480441,Trey Fix-Wolansky,R,CBJ,25,0,0,0,0
27,8483546,Marshall Rifai,D,TOR,26,0,0,0,0
27,8480084,Nick DeSimone,D,NJD,30,0,0,0,0
27,8481030,Jack St. Ivany,D,PIT,25,0,0,0,0
27,8481592,Jakob Pelletier,L,CGY,23,0,0,0,0
27,8478011,Louie Belpedio,D,PHI,28,0,0,0,0
27,8477930,Pierre-Edouard Bellemare,L,,39,0,0,0,0
27,8484321,Nikolas Matinpalo,D,OTT,26,0,0,0,0
27,8482067,Connor Mackey,D,NYR,28,0,0,0,0
27,8481806,Louis Crevier,D,CHI,23,0,0,0,0
27,8484326,Patrik Koch,D,UTA,28,0,0,0,0
27,8477971,Andreas Englund,D,LAK,28,0,0,0,0
27,8481751,Lukas Rousek,R,BUF,25,0,0,0,0
27,8481006,Tyler Tucker,D,STL,24,0,0,0,0
27,8476867,Brendan Gaunce,C,MIN,30,0,0,0,0
27,8479520,Brandon Duhaime,R,WSH,27,0,0,0,0
27,8477073,Kurtis MacDermid,L,NJD,30,0,0,0,0
27,8480874,Adam Ginning,D,PHI,24,0,0,0,0
27,8477473,Justin Bailey,R,SJS,29,0,0,0,0
27,8479066,Ryan Lomberg,L,CGY,30,0,0,0,0
27,8477070,Liam O'Brien,C,UTA,30,0,0,0,0
27,8474618,Marco Scandella,D,,34,0,0,0,0
27,8475797,Jarred Tinordi,D,,32,0,0,0,0
27,8481441,Joe Snively,C,DET,28,0,0,0,0
27,8477244,Chad Ruhwedel,D,NYR,34,0,0,0,0
27,8479772,Zack MacEwen,R,OTT,28,0,0,0,0
27,8481147,Reese Johnson,C,MIN,26,0,0,0,0
27,8481043,Cole Koepke,L,BOS,26,0,0,0,0
27,8483619,Filip Roos,D,OTT,25,0,0,0,0
27,8481541,Samuel Bolduc,D,NYI,24,0,0,0,0
27,8477810,Joel Hanley,D,CGY,33,0,0,0,0
27,8476907,Mackenzie MacEachern,L,,30,0,0,0,0
27,8482652,Walker Duehr,R,CGY,27,0,0,0,0
27,8477126,Jayson Megna,C,,34,0,0,0,0
27,8483398,Declan Carlile,D,TBL,31,0,0,0,0
27,8482929,Emil Lilleberg,D,TBL,23,0,0,0,0
27,8480880,Jakub Lauko,C,MIN,24,0,0,0,0
27,8480245,Olle Lycksell,R,PHI,25,0,0,0,0
27,8480252,Cole Guttman,C,CHI,25,0,0,0,0
27,8477467,Gustav Olofsson,D,SEA,30,0,0,0,0
27,8479968,Vinni Lettieri,C,BOS,29,0,0,0,0
27,8478400,Colin White,C,,27,0,0,0,0
27,8475755,Alexander Petrovic,D,DAL,32,0,0,0,0
27,8481812,Nikolai Knyzhov,D,,27,0,0,0,0
27,8481593,Jayden Struble,D,MTL,23,0,0,0,0
27,8481532,Alex Turcotte,C,LAK,23,0,0,0,0
27,8482126,Emil Andrae,D,PHI,31,0,0,0,0
27,8479944,Zach Aston-Reese,C,VGK,30,0,0,0,0
27,8471817,Ryan Reaves,R,TOR,37,0,0,0,0
27,8481206,John Ludvig,D,PIT,24,0,0,0,0
27,8481599,Victor Soderstrom,D,UTA,23,0,0,0,0
27,8480292,Carson Meyer,R,ANA,27,0,0,0,0
27,8482496,Nils Aman,C,VAN,24,0,0,0,0
27,8479718,Alex Barré-Boulet,C,MTL,27,0,0,0,0
27,8479994,Jaret Anderson-Dolan,C,WPG,25,0,0,0,0
27,8480184,Gustav Lindstrom,D,,26,0,0,0,0
27,8480890,Jan Jenik,R,OTT,24,0,0,0,0
27,8478067,Oskar Lindblom,L,,28,0,0,0,0
27,8476934,Brock McGinn,L,ANA,30,0,0,0,0
27,8479985,Cale Fleury,D,SEA,26,0,0,0,0
27,8484304,Uvis Balinskis,D,FLA,28,0,0,0,0
27,8479981,Jonah Gadjovich,L,FLA,26,0,0,0,0
27,8481716,Dmitri Voronkov,L,CBJ,24,0,0,0,0
27,8474709,Matt Martin,L,,35,0,0,0,0
27,8482634,Alex Steeves,C,TOR,25,0,0,0,0
27,8480823,Alexander Alexeyev,D,WSH,25,0,0,0,0
27,8477541,Dakota Mermis,D,TOR,30,0,0,0,0
27,8483491,Ivan Miroshnichenko,L,WSH,20,0,0,0,0
27,8478477,Mitchell Stephens,C,SEA,27,0,0,0,0
27,8481543,Nikita Alexandrov,C,STL,24,0,0,0,0
27,8479423,Alex Nylander,L,,26,0,0,0,0
27,8482451,Mikael Pyyhtia,L,CBJ,23,0,0,0,0
27,8478831,Kevin Stenlund,C,UTA,28,0,0,0,0
27,8480306,Grant Hutton,D,NYI,29,0,0,0,0
27,8478028,Fredrik Olofsson,L,,28,0,0,0,0
27,8477462,Robert Hagg,D,VGK,29,0,0,0,0
27,8477320,Anton Blidh,L,NYR,29,0,0,0,0
27,8482157,Will Cuylle,L,NYR,22,0,0,0,0
27,8482737,Zack Bolduc,C,STL,21,0,0,0,0
27,8481239,Samuel Fagemo,L,,24,0,0,0,0
27,8481600,Tobias Bjornfot,D,FLA,23,0,0,0,0
27,8478409,Anthony Richard,C,PHI,28,0,0,0,0
27,8474145,Robert Bortuzzo,D,,35,0,0,0,0
27,8475958,Michael Sgarbossa,C,WSH,32,0,0,0,0
27,8479986,Kole Lind,R,DAL,26,0,0,0,0
27,8479249,Andrew Poturalski,C,SJS,30,0,0,0,0
27,8479362,Riley Tufte,L,BOS,26,0,0,0,0
27,8479991,Jake Leschyshyn,C,NYR,25,0,0,0,0
27,8479587,Rhett Gardner,C,PHI,28,0,0,0,0
27,8482744,James Malatesta,L,CBJ,21,0,0,0,0
27,8478854,Ryan Shea,D,PIT,27,0,0,0,0
27,8481591,Sam Poulin,R,,23,0,0,0,0
27,8483512,Matt Savoie,C,EDM,20,0,0,0,0
27,8482102,Vasily Ponomarev,C,PIT,22,0,0,0,0
27,8482162,Roby Jarventie,L,EDM,22,0,0,0,0
27,8481016,Ruslan Iskhakov,C,,24,0,0,0,0
27,8482172,Landon Slaggert,L,CHI,22,0,0,0,0
27,8482747,Brennan Othmann,L,NYR,21,0,0,0,0
27,8480031,Maxime Comtois,L,,25,0,0,0,0
27,8480226,Marián Studenic,R,,26,0,0,0,0
27,8478408,Travis Dermott,D,,28,0,0,0,0
27,8481518,Nolan Foote,L,NJD,24,0,0,0,0
27,8479419,Brett Murray,L,BUF,26,0,0,0,0
27,8482088,Justin Sourdif,R,FLA,22,0,0,0,0
27,8482201,Gage Goncalves,C,TBL,23,0,0,0,0
27,8481578,Graeme Clarke,R,MIN,23,0,0,0,0
27,8482177,Marat Khusnutdinov,C,MIN,22,0,0,0,0
27,8481754,Nikita Nesterenko,C,ANA,23,0,0,0,0
27,8483531,Brian Halonen,L,NJD,25,0,0,0,0
27,8483920,Pierrick Dube,R,WSH,23,0,0,0,0
27,8480851,Akil Thomas,C,LAK,24,0,0,0,0
27,8475235,Nicolas Deslauriers,L,PHI,33,0,0,0,0
27,8482476,Emil Heineman,L,MTL,23,0,0,0,0
27,8477149,Scott Sabourin,R,SJS,32,0,0,0,0
27,8483549,Lucas Condotta,L,MTL,27,0,0,0,0
27,8482765,Isak Rosen,R,BUF,21,0,0,0,0
27,8481237,Kyle MacLean,C,NYI,25,0,0,0,0
27,8481024,Linus Karlsson,C,VAN,25,0,0,0,0
27,8481690,Tyler Angle,C,,24,0,0,0,0
27,8483570,Ben Meyers,C,SEA,26,0,0,0,0
27,8481655,Cole Schwindt,R,CGY,23,0,0,0,0
27,8481462,Mason Morelli,L,VGK,28,0,0,0,0
27,8483401,Marc Johnstone,R,PIT,28,0,0,0,0
27,8478956,Samuel Laberge,L,NJD,27,0,0,0,0
27,8479533,Joona Koppanen,L,,26,0,0,0,0
27,8482197,Adam Raska,R,MIN,23,0,0,0,0
27,8482250,Callahan Burke,C,VGK,27,0,0,0,0
27,8482784,Zach Dean,C,STL,21,0,0,0,0
27,8484255,Jason Polin,R,COL,25,0,0,0,0
27,8481077,John Leonard,L,,26,0,0,0,0
27,8481534,Raphael Lavoie,C,EDM,24,0,0,0,0
27,8483609,Adam Klapka,R,CGY,24,0,0,0,0
27,8482751,Ryan Winterton,C,SEA,21,0,0,0,0
27,8480267,Sammy Walker,C,MIN,25,0,0,0,0
27,8475766,Austin Watson,L,,32,0,0,0,0
27,8482460,Matt Rempe,C,NYR,22,0,0,0,0
27,8481065,Angus Crookshank,L,OTT,25,0,0,0,0
27,8481070,Hugh McGing,L,,26,0,0,0,0
27,8476323,Max McCormick,L,SEA,32,0,0,0,0
27,8483395,Arshdeep Bains,L,VAN,23,0,0,0,0
27,8484259,Ondrej Pavel,C,COL,31,0,0,0,0
27,8483432,Luca Del Bel Belluz,C,CBJ,31,0,0,0,0
27,8483045,Cameron Butler,R,CBJ,31,0,0,0,0
27,8482061,Brandon Biro,L,SEA,26,0,0,0,0
27,8477401,John Hayden,C,SEA,29,0,0,0,0
27,8475278,Byron Froese,C,,33,0,0,0,0
27,8478446,Glenn Gawdin,C,LAK,27,0,0,0,0
27,8477993,Justin Kirkland,C,CGY,28,0,0,0,0
27,8482147,Jean-Luc Foudy,C,COL,22,0,0,0,0
27,8480032,Shane Bowers,C,NJD,25,0,0,0,0
27,8479330,Brandon Gignac,C,MTL,27,0,0,0,0
27,8480776,Sheldon Rempal,R,,29,0,0,0,0
27,8475413,Justin Dowling,C,NJD,34,0,0,0,0
27,8481726,Adam Edstrom,C,NYR,24,0,0,0,0
27,8480844,Grigori Denisenko,L,VGK,24,0,0,0,0
27,8478147,Bokondji Imama,L,PIT,28,0,0,0,0
27,8478881,Brett Seney,L,CHI,28,0,0,0,0
27,8483630,Pavol Regenda,L,ANA,25,0,0,0,0
27,8480836,Jonathan Gruden,C,,24,0,0,0,0
27,8484314,Jiri Smejkal,L,,28,0,0,0,0
27,8475780,Chris Wagner,R,COL,33,0,0,0,0
27,8479546,Oskar Steen,C,,26,0,0,0,0
27,8483597,Milos Kelemen,L,UTA,25,0,0,0,0
27,8481789,Tye Kartye,L,SEA,23,0,0,0,0
27,8484325,Waltteri Merela,C,TBL,26,0,0,0,0
27,8479421,Jacob Moverare,D,LAK,26,0,0,0,0
27,8481585,Egor Afanasyev,L,SJS,23,0,0,0,0
27,8479547,Matthew Phillips,R,,26,0,0,0,0
27,8479367,William Lockwood,R,FLA,26,0,0,0,0
27,8476915,Jujhar Khaira,L,,30,0,0,0,0
27,8481422,Jacob Lucchini,C,NSH,29,0,0,0,0
27,8480468,James Hamblin,L,EDM,25,0,0,0,0
27,8478051,Max Willman,C,NJD,29,0,0,0,0
27,8481556,John Beecher,C,BOS,23,0,0,0,0
27,8478078,Rourke Chartier,C,,28,0,0,0,0
28,8477492,Nathan MacKinnon,C,COL,29,82,64,85,149
28,8478402,Connor McDavid,C,EDM,27,82,41,93,134
28,8479318,Auston Matthews,C,TOR,27,82,63,58,121
28,8476453,Nikita Kucherov,R,TBL,31,82,43,78,121
28,8478420,Mikko Rantanen,R,COL,28,82,50,67,117
28,8476887,Filip Forsberg,L,NSH,30,82,56,60,116
28,8476468,J.T. Miller,C,VAN,31,82,38,74,112
28,8477939,William Nylander,R,TOR,28,82,34,77,111
28,8477956,David Pastrnak,R,BOS,28,82,55,55,110
28,8481559,Jack Hughes,C,NJD,23,82,46,63,109
28,8478864,Kirill Kaprizov,L,MIN,27,82,57,50,107
28,8480012,Elias Pettersson,C,VAN,26,82,43,63,106
28,8477946,Dylan Larkin,C,DET,28,82,49,55,104
28,8477942,Kevin Fiala,L,LAK,28,82,38,66,104
28,8479314,Matthew Tkachuk,L,FLA,27,82,34,70,104
28,8477493,Aleksander Barkov,C,FLA,29,82,34,68,102
28,8477934,Leon Draisaitl,C,EDM,29,82,39,61,100
28,8478439,Travis Konecny,R,PHI,27,82,44,54,98
28,8480069,Cale Makar,D,COL,26,82,24,73,97
28,8480800,Quinn Hughes,D,VAN,25,82,15,82,97
28,8480027,Jason Robertson,L,DAL,25,82,30,66,96
28,8478398,Kyle Connor,L,WPG,28,82,46,49,95
28,8477409,Carter Verhaeghe,C,FLA,29,82,45,49,94
28,8478550,Artemi Panarin,L,NYR,33,82,26,67,93
28,8474564,Steven Stamkos,C,NSH,34,82,41,51,92
28,8480002,Nico Hischier,C,NJD,25,82,38,51,89
28,8477404,Jake Guentzel,C,TBL,30,82,40,48,88
28,8476539,Jonathan Marchessault,R,NSH,34,82,49,38,87
28,8482116,Tim Stützle,C,OTT,22,82,30,57,87
28,8478445,Mathew Barzal,C,NYI,27,82,26,61,87
28,8479407,Jesper Bratt,L,NJD,26,82,27,59,86
28,8480830,Andrei Svechnikov,R,CAR,24,82,37,48,85
28,8471675,Sidney Crosby,C,PIT,37,82,36,49,85
28,8476459,Mika Zibanejad,C,NYR,31,82,36,49,85
28,8481557,Matt Boldy,L,MIN,23,82,42,42,84
28,8478427,Sebastian Aho,C,CAR,27,82,36,48,84
28,8476346,Johnny Gaudreau,L,CBJ,31,82,18,66,84
28,8476389,Vincent Trocheck,C,NYR,31,82,36,47,83
28,8476460,Mark Scheifele,C,WPG,31,82,35,48,83
28,8476454,Ryan Nugent-Hopkins,C,EDM,31,82,29,54,83
28,8475810,Bryan Rust,R,PIT,32,82,43,39,82
28,8474600,Roman Josi,D,NSH,34,82,18,64,82
28,8475786,Zach Hyman,L,EDM,32,82,41,40,81
28,8475172,Nazem Kadri,C,CGY,34,82,25,56,81
28,8479323,Adam Fox,D,NYR,26,82,22,59,81
28,8478444,Brock Boeser,R,VAN,27,82,44,36,80
28,8480023,Robert Thomas,C,STL,25,82,21,59,80
28,8477933,Sam Reinhart,C,FLA,29,82,46,33,79
28,8480036,Miro Heiskanen,D,DAL,25,82,22,57,79
28,8480803,Evan Bouchard,D,EDM,25,82,18,61,79
28,8477951,Nick Schmaltz,C,UTA,28,82,27,51,78
28,8478010,Brayden Point,C,TBL,28,82,39,38,77
28,8475184,Chris Kreider,L,NYR,33,82,42,34,76
28,8479343,Clayton Keller,R,UTA,26,82,37,39,76
28,8480801,Brady Tkachuk,L,OTT,25,82,35,41,76
28,8477940,Nikolaj Ehlers,L,WPG,28,82,24,52,76
28,8475798,Mikael Granlund,C,SJS,32,82,18,58,76
28,8481523,Kirby Dach,C,MTL,23,82,15,60,75
28,8478403,Jack Eichel,C,VGK,28,82,32,42,74
28,8477949,Alex Tuch,R,BUF,28,82,29,45,74
28,8475168,Matt Duchene,C,DAL,33,82,26,48,74
28,8482097,Jack Quinn,R,BUF,23,82,26,48,74
28,8477960,Adrian Kempe,R,LAK,28,82,25,49,74
28,8474679,Gustav Nyquist,C,NSH,35,82,23,50,73
28,8477504,Josh Morrissey,D,WPG,29,82,22,51,73
28,8479542,Brandon Hagel,L,TBL,26,82,40,32,72
28,8478414,Timo Meier,R,NJD,28,82,33,39,72
28,8480018,Nick Suzuki,C,MTL,25,82,30,42,72
28,8477402,Pavel Buchnevich,L,STL,29,82,23,49,72
28,8480208,Drake Batherson,R,OTT,26,82,32,39,71
28,8482665,Matty Beniers,C,SEA,22,82,24,47,71
28,8475692,Mats Zuccarello,R,MIN,37,82,16,55,71
28,8475913,Mark Stone,R,VGK,32,82,25,45,70
28,8471215,Evgeni Malkin,C,PIT,38,82,20,50,70
28,8479420,Tage Thompson,C,BUF,27,82,37,32,69
28,8477496,Elias Lindholm,C,BOS,30,82,29,40,69
28,8476881,Tomas Hertl,C,VGK,31,82,28,41,69
28,8476853,Morgan Rielly,D,TOR,30,82,11,58,69
28,8471214,Alex Ovechkin,L,WSH,39,82,35,33,68
28,8475754,Brock Nelson,C,NYI,33,82,35,33,68
28,8475166,John Tavares,C,TOR,34,82,34,34,68
28,8478493,Joel Eriksson Ek,C,MIN,27,82,28,40,68
28,8474102,David Perron,L,OTT,36,82,28,40,68
28,8478975,Mason Marchment,L,DAL,29,82,25,43,68
28,8480797,Joel Farabee,L,PHI,24,82,25,43,68
28,8476399,Blake Coleman,C,CGY,33,82,39,28,67
28,8478460,Zach Werenski,D,CBJ,27,82,15,52,67
28,8480839,Rasmus Dahlin,D,BUF,24,82,10,57,67
28,8471685,Anze Kopitar,C,LAK,37,82,21,45,66
28,8478438,Tommy Novak,C,NSH,27,82,21,45,66
28,8478449,Roope Hintz,C,DAL,28,82,35,30,65
28,8475784,Jeff Skinner,C,EDM,32,82,33,32,65
28,8480015,Owen Tippett,R,PHI,25,82,32,33,65
28,8477416,Oliver Bjorkstrand,R,SEA,29,82,29,36,65
28,8481528,Dylan Cozens,C,BUF,23,82,27,38,65
28,8479400,Pierre-Luc Dubois,L,WSH,26,82,27,38,65
28,8479337,Alex DeBrincat,R,DET,27,82,23,42,65
28,8474141,Patrick Kane,R,DET,36,82,31,33,64
28,8473986,Alex Killorn,L,ANA,35,82,27,37,64
28,8478407,Vince Dunn,D,SEA,28,82,13,51,64
28,8475167,Victor Hedman,D,TBL,34,82,10,54,64
28,8477500,Bo Horvat,C,NYI,29,82,38,25,63
28,8481540,Cole Caufield,R,MTL,23,82,27,36,63
28,8478042,Viktor Arvidsson,R,EDM,31,82,26,36,62
28,8476479,Phillip Danault,C,LAK,31,82,23,39,62
28,8477021,Alex Kerfoot,C,UTA,30,82,22,40,62
28,8476456,Jonathan Huberdeau,C,CGY,31,82,12,50,62
28,8482684,Luke Hughes,D,NJD,21,82,12,50,62
28,8479339,Patrik Laine,L,CBJ,26,82,32,29,61
28,8473512,Claude Giroux,R,OTT,36,82,26,35,61
28,8476882,Teuvo Teravainen,L,CHI,30,82,21,40,61
28,8476905,Chandler Stephenson,C,SEA,30,82,16,45,61
28,8477955,Jared McCann,L,SEA,28,82,32,28,60
28,8482159,Tyson Foerster,R,PHI,22,82,30,30,60
28,8477501,Valeri Nichushkin,R,COL,29,82,28,32,60
28,8473994,Jamie Benn,L,DAL,35,82,24,36,60
28,8478498,Jake DeBrusk,L,VAN,28,82,33,26,59
28,8479675,Trevor Moore,L,LAK,29,82,28,31,59
28,8475169,Evander Kane,L,EDM,33,82,27,32,59
28,8481711,Matias Maccelli,L,UTA,24,82,23,36,59
28,8474590,John Carlson,D,WSH,34,82,17,42,59
28,8481068,Yegor Sharangovich,C,CGY,26,82,33,25,58
28,8482109,Alexis Lafrenière,L,NYR,23,82,27,31,58
28,8478873,Troy Terry,R,ANA,27,82,21,37,58
28,8482093,Seth Jarvis,C,CAR,22,82,21,37,58
28,8473419,Brad Marchand,L,BOS,36,82,20,38,58
28,8479325,Charlie McAvoy,D,BOS,27,82,19,39,58
28,8478038,Devon Toews,D,COL,30,82,16,42,58
28,8480014,Gabriel Vilardi,C,WPG,25,82,28,29,57
28,8475765,Vladimir Tarasenko,R,DET,33,82,27,30,57
28,8480064,Josh Norris,C,OTT,25,82,25,32,57
28,8478401,Pavel Zacha,C,BOS,27,82,23,34,57
28,8479999,Casey Mittelstadt,C,COL,26,82,12,45,57
28,8479425,Filip Hronek,D,VAN,27,82,9,48,57
28,8474150,Mikael Backlund,C,CGY,35,82,23,33,56
28,8477986,Brandon Montour,D,SEA,30,82,17,39,56
28,8479385,Jordan Kyrou,C,STL,26,82,23,32,55
28,8482149,Cole Perfetti,C,WPG,22,82,23,32,55
28,8478440,Dylan Strome,C,WSH,27,82,19,36,55
28,8477447,Shea Theodore,D,VGK,29,82,6,49,55
28,8482667,William Eklund,L,SJS,22,82,27,27,54
28,8475158,Ryan O'Reilly,C,NSH,33,82,25,29,54
28,8480188,Fabian Zetterlund,L,SJS,25,82,23,31,54
28,8480078,Filip Chytil,C,NYR,25,82,22,32,54
28,8478047,Michael Bunting,L,PIT,29,82,21,33,54
28,8475170,Brayden Schenn,C,STL,33,82,20,34,54
28,8475191,Reilly Smith,R,NYR,33,82,20,34,54
28,8477503,Max Domi,C,TOR,29,82,12,42,54
28,8480865,Noah Dobson,D,NYI,24,82,6,48,54
28,8482740,Wyatt Johnston,C,DAL,21,82,34,19,53
28,8477476,Artturi Lehkonen,L,COL,29,82,28,25,53
28,8482113,Anton Lundell,C,FLA,23,82,22,31,53
28,8474586,Jordan Eberle,R,SEA,34,82,21,32,53
28,8477494,Jonathan Drouin,L,COL,29,82,16,37,53
28,8471724,Kris Letang,D,PIT,37,82,15,38,53
28,8474565,Alex Pietrangelo,D,VGK,34,82,14,39,53
28,8478396,Noah Hanifin,D,VGK,27,82,14,39,53
28,8477479,Tyler Bertuzzi,L,CHI,29,82,27,25,52
28,8476880,Tom Wilson,R,WSH,30,82,26,26,52
28,8478856,Conor Garland,R,VAN,28,82,24,28,52
28,8475149,Marcus Johansson,L,MIN,34,82,17,35,52
28,8477932,Aaron Ekblad,D,FLA,28,82,10,42,52
28,8475151,Kyle Palmieri,C,NYI,33,82,26,25,51
28,8476925,Colton Sissons,C,NSH,31,82,23,28,51
28,8478462,Nicolas Roy,C,VGK,27,82,21,30,51
28,8478458,Jack Roslovic,C,CAR,27,82,19,32,51
28,8477346,MacKenzie Weegar,D,CGY,30,82,16,35,51
28,8478233,Andrew Mangiapane,L,WSH,28,82,14,37,51
28,8475799,Nino Niederreiter,R,WPG,32,82,27,23,50
28,8474641,Adam Henrique,C,EDM,34,82,22,28,50
28,8477497,Sean Monahan,C,CBJ,30,82,20,30,50
28,8475745,Charlie Coyle,C,BOS,32,82,19,31,50
28,8477429,Andrew Copp,C,DET,30,82,19,31,50
28,8474053,Logan Couture,C,SJS,35,82,13,37,50
28,8478469,Thomas Chabot,D,OTT,27,82,11,39,50
28,8478366,Frank Vatrano,R,ANA,30,82,37,12,49
28,8482078,Lucas Raymond,L,DET,22,82,22,27,49
28,8481618,Alex Newhook,C,MTL,23,82,22,27,49
28,8476826,Yanni Gourde,C,SEA,33,82,17,32,49
28,8479345,Jakob Chychrun,D,WSH,26,82,17,32,49
28,8477451,Ryan Hartman,R,MIN,30,82,17,32,49
28,8482124,Quinton Byfield,R,LAK,22,82,16,33,49
28,8477407,Anthony Duclair,L,NYI,29,82,14,35,49
28,8475794,Tyler Seguin,C,DAL,32,82,27,21,48
28,8480039,Martin Necas,C,CAR,25,82,25,23,48
28,8476432,Boone Jenner,C,CBJ,31,82,24,24,48
28,8477935,Sam Bennett,C,FLA,28,82,23,25,48
28,8474578,Erik Karlsson,D,PIT,34,82,14,34,48
28,8478474,Lawson Crouse,L,UTA,27,82,24,23,47
28,8477456,J.T. Compher,L,DET,29,82,22,25,47
28,8478046,Danton Heinen,L,VAN,29,82,21,26,47
28,8475793,Ryan Johansen,C,PHI,32,82,20,27,47
28,8476875,Mike Matheson,D,MTL,30,82,9,38,47
28,8482175,JJ Peterka,R,BUF,22,82,25,21,46
28,8477952,Robby Fabbri,C,ANA,28,82,23,23,46
28,8480835,Jack Drury,C,CAR,24,82,23,23,46
28,8480113,Alex Iafallo,L,WPG,31,82,17,29,46
28,8478397,Rasmus Andersson,D,CGY,28,82,14,32,46
28,8476462,Dougie Hamilton,D,NJD,31,82,14,32,46
28,8474563,Drew Doughty,D,LAK,35,82,8,38,46
28,8481581,Thomas Harley,D,DAL,23,82,8,38,46
28,8471698,T.J. Oshie,R,WSH,38,82,27,18,45
28,8476483,Rickard Rakell,R,PIT,31,82,24,21,45
28,8475726,Tyler Toffoli,C,SJS,32,82,22,23,45
28,8481554,Kaapo Kakko,R,NYR,23,82,20,25,45
28,8477998,Warren Foegele,L,LAK,28,82,19,26,45
28,8479941,Justin Danforth,R,CBJ,31,82,19,26,45
28,8480028,Morgan Frost,C,PHI,25,82,17,28,45
28,8477444,Andre Burakovsky,L,SEA,29,82,15,30,45
28,8476869,Brady Skjei,D,NSH,30,82,8,37,45
28,8476438,Brandon Saad,L,STL,32,82,29,15,44
28,8480009,Eeli Tolvanen,R,SEA,25,82,27,17,44
28,8476448,William Karlsson,C,VGK,31,82,22,22,44
28,8481533,Trevor Zegras,C,ANA,23,82,18,26,44
28,8482745,Mason McTavish,C,ANA,21,82,16,28,44
28,8480849,Barrett Hayton,C,UTA,24,82,15,29,44
28,8480185,Eetu Luostarinen,C,FLA,26,82,14,30,44
28,8476792,Torey Krug,D,STL,33,82,13,31,44
28,8475314,Anders Lee,L,NYI,34,82,26,17,43
28,8481535,Nils Hoglander,L,VAN,24,82,24,19,43
28,8479987,Morgan Geekie,C,BOS,26,82,20,23,43
28,8482110,Dawson Mercer,C,NJD,23,82,19,24,43
28,8477964,Ivan Barbashev,C,VGK,29,82,18,25,43
28,8482705,Cole Sillinger,C,CBJ,21,82,17,26,43
28,8476458,Ryan Strome,C,ANA,31,82,15,28,43
28,8476923,Damon Severson,D,CBJ,30,82,9,34,43
28,8480434,Sean Durzi,D,UTA,26,82,8,35,43
28,8476906,Shayne Gostisbehere,D,CAR,31,82,7,36,43
28,8481542,Moritz Seider,D,DET,23,82,4,39,43
28,8481560,Arthur Kaliyev,R,LAK,23,82,23,19,42
28,8483808,Andrei Kuzmenko,L,CGY,28,82,19,23,42
28,8482055,Drew O'Connor,L,PIT,26,82,19,23,42
28,8479293,Brandon Tanev,L,SEA,33,82,19,23,42
28,8475763,Kevin Hayes,R,PIT,32,82,15,27,42
28,8476927,Teddy Blueger,C,VAN,30,82,15,27,42
28,8476872,Scott Laughton,C,PHI,30,82,14,28,42
28,8474149,Evgenii Dadonov,R,DAL,35,82,14,28,42
28,8475753,Justin Faulk,D,STL,32,82,13,29,42
28,8478542,Evan Rodrigues,C,FLA,31,82,12,30,42
28,8476329,Travis Boyd,C,MIN,31,82,11,31,42
28,8480145,Neal Pionk,D,WPG,29,82,7,35,42
28,8482092,Ridly Greig,C,OTT,22,82,20,21,41
28,8480802,Ryan McLeod,C,BUF,25,82,18,23,41
28,8475722,Jason Zucker,L,BUF,32,82,17,24,41
28,8475287,Erik Haula,L,NJD,33,82,17,24,41
28,8482660,Kent Johnson,C,CBJ,22,82,15,26,41
28,8480068,Ryan Poehling,C,PHI,25,82,15,26,41
28,8477948,Travis Sanheim,D,PHI,28,82,14,27,41
28,8477498,Darnell Nurse,D,EDM,29,82,11,30,41
28,8479410,Mikhail Sergachev,D,UTA,26,82,10,31,41
28,8478413,Jordan Greenway,L,BUF,27,82,10,31,41
28,8470613,Brent Burns,D,CAR,39,82,8,33,41
28,8482089,Jake Neighbours,L,STL,22,82,25,15,40
28,8481186,Logan O'Connor,R,COL,28,82,23,17,40
28,8481604,Pavel Dorofeyev,L,VGK,24,82,20,20,40
28,8481596,Shane Pinto,C,OTT,24,82,19,21,40
28,8482720,Matthew Knies,L,TOR,22,82,18,22,40
28,8478472,Mathieu Joseph,R,STL,27,82,17,23,40
28,8475791,Taylor Hall,L,CHI,33,82,16,24,40
28,8477987,Ryan Donato,C,CHI,28,82,14,26,40
28,8476958,Jaccob Slavin,D,CAR,30,82,4,36,40
28,8480893,Kirill Marchenko,R,CBJ,24,82,24,15,39
28,8479525,Ross Colton,C,COL,28,82,21,18,39
28,8483515,Juraj Slafkovsky,L,MTL,20,82,20,19,39
28,8475714,Calle Jarnkrok,C,TOR,33,82,16,23,39
28,8478057,Dakota Joshua,C,VAN,28,82,14,25,39
28,8481656,Aliaksei Protas,C,WSH,23,82,14,25,39
28,8477495,Seth Jones,D,CHI,30,82,8,31,39
28,8480873,Rasmus Sandin,D,WSH,24,82,5,34,39
28,8482699,Dylan Guenther,R,UTA,21,82,16,22,38
28,8480798,Philipp Kurashev,C,CHI,25,82,13,25,38
28,8476461,Sean Couturier,C,PHI,32,82,9,29,38
28,8480459,Pius Suter,C,VAN,28,82,17,20,37
28,8476885,Jacob Trouba,D,NYR,30,82,13,24,37
28,8482146,Luke Evangelista,R,NSH,22,82,13,24,37
28,8480878,Nils Lundkvist,D,DAL,24,82,9,28,37
28,8482105,Jake Sanderson,D,OTT,22,82,5,32,37
28,8476331,Dylan DeMelo,D,WPG,31,82,3,34,37
28,8484144,Connor Bedard,C,CHI,19,82,18,18,36
28,8477953,Kasperi Kapanen,R,STL,28,82,15,21,36
28,8478020,Michael Amadio,C,OTT,28,82,12,24,36
28,8480817,K'Andre Miller,D,NYR,24,82,8,28,36
28,8476854,Hampus Lindholm,D,BOS,30,82,7,29,36
28,8479398,Samuel Girard,D,COL,26,82,6,30,36
28,8475760,Nick Bjugstad,C,UTA,32,82,18,17,35
28,8479996,Cody Glass,C,NSH,25,82,18,17,35
28,8475768,Jaden Schwartz,C,SEA,32,82,17,18,35
28,8482671,Owen Power,D,BUF,22,82,17,18,35
28,8470621,Corey Perry,R,EDM,39,82,17,18,35
28,8473422,Nick Foligno,L,CHI,37,82,16,19,35
28,8482475,Yegor Chinakhov,R,CBJ,23,82,14,21,35
28,8478891,Mason Appleton,C,WPG,28,82,14,21,35
28,8479992,Michael Rasmussen,C,DET,25,82,14,21,35
28,8481704,Juuso Parssinen,C,NSH,23,82,13,22,35
28,8476292,Ondrej Palat,L,NJD,33,82,12,23,35
28,8476480,Vladislav Namestnikov,C,WPG,32,82,12,23,35
28,8480748,Kiefer Sherwood,L,VAN,29,82,11,24,35
28,8478911,Matt Roy,D,WSH,29,82,10,25,35
28,8477220,Nate Schmidt,D,FLA,33,82,9,26,35
28,8476892,Colton Parayko,D,STL,31,82,3,32,35
28,8481032,Paul Cotter,C,NJD,25,82,21,13,34
28,8480144,David Kampf,C,TOR,29,82,15,19,34
28,8483763,Maksymilian Szuber,D,UTA,22,82,15,19,34
28,8474716,Jared Spurgeon,D,MIN,35,82,14,20,34
28,8477989,Christian Dvorak,C,MTL,28,82,14,20,34
28,8476419,Jean-Gabriel Pageau,C,NYI,32,82,13,21,34
28,8477919,Frederick Gaudreau,C,MIN,31,82,13,21,34
28,8475218,Mattias Ekholm,D,EDM,34,82,12,22,34
28,8478519,Anthony Cirelli,C,TBL,27,82,11,23,34
28,8478133,Jake Evans,C,MTL,28,82,8,26,34
28,8477425,Miles Wood,L,COL,29,82,18,15,33
28,8474715,Cam Atkinson,R,TBL,35,82,17,16,33
28,8474189,Lars Eller,C,PIT,35,82,17,16,33
28,8473563,Nicklas Backstrom,C,WSH,37,82,15,18,33
28,8475848,Brendan Gallagher,R,MTL,32,82,14,19,33
28,8478115,Pierre Engvall,L,NYI,28,82,14,19,33
28,8476469,Joel Armia,R,MTL,31,82,13,20,33
28,8480871,Adam Boqvist,D,FLA,24,82,9,24,33
28,8475220,Marcus Foligno,L,MIN,33,82,9,24,33
28,8477947,Sonny Milano,L,WSH,28,82,8,25,33
28,8475764,Cam Fowler,D,ANA,33,82,4,29,33
28,8479371,Dante Fabbro,D,NSH,26,82,4,29,33
28,8482079,Marco Rossi,C,MIN,23,82,21,11,32
28,8476374,Sean Kuraly,C,CBJ,31,82,19,13,32
28,8476981,Josh Anderson,R,MTL,30,82,18,14,32
28,8481580,Connor McMichael,C,WSH,23,82,17,15,32
28,8476474,Stefan Noesen,R,NJD,31,82,16,16,32
28,8477903,Garnet Hathaway,R,PHI,33,82,16,16,32
28,8479316,Luke Kunin,C,SJS,27,82,15,17,32
28,8478109,Victor Olofsson,L,VGK,29,82,15,17,32
28,8480829,Jesperi Kotkaniemi,C,CAR,24,82,15,17,32
28,8477015,Connor Brown,R,EDM,30,82,15,17,32
28,8476897,Oskar Sundqvist,C,STL,30,82,14,18,32
28,8477511,Anthony Mantha,R,CGY,30,82,13,19,32
28,8476873,Mark Jankowski,C,NSH,30,82,12,20,32
28,8482117,Lukas Reichel,L,CHI,22,82,11,21,32
28,8478882,Vladislav Gavrikov,D,LAK,29,82,11,21,32
28,8478055,Gustav Forsling,D,FLA,28,82,10,22,32
28,8482122,Brock Faber,D,MIN,22,82,9,23,32
28,8475343,Nic Dowd,C,WSH,34,82,8,24,32
28,8477969,Marcus Pettersson,D,PIT,28,82,3,29,32
28,8481582,Nicholas Robertson,L,TOR,23,82,19,12,31
28,8484145,Zach Benson,L,BUF,19,82,19,12,31
28,8476921,Jordan Martinook,L,CAR,32,82,17,14,31
28,8477353,Tyler Motte,C,DET,29,82,17,14,31
28,8477392,Hudson Fasching,R,NYI,29,82,15,16,31
28,8479365,Trent Frederic,C,BOS,26,82,14,17,31
28,8476918,Jimmy Vesey,L,NYR,31,82,14,17,31
28,8479390,Taylor Raddysh,R,WSH,26,82,14,17,31
28,8477426,Nicholas Paul,L,TBL,29,82,13,18,31
28,8481013,Jonatan Berggren,R,DET,24,82,13,18,31
28,8480855,Jack McBain,C,UTA,24,82,13,18,31
28,8476889,Radek Faksa,C,STL,30,82,12,19,31
28,8475200,Dmitry Orlov,D,CAR,33,82,11,20,31
28,8480336,Sean Walker,D,CAR,30,82,11,20,31
28,8478463,Anthony Beauvillier,L,PIT,27,82,10,21,31
28,8475171,Oliver Ekman-Larsson,D,TOR,33,82,7,24,31
28,8477506,Ryan Pulock,D,NYI,30,82,5,26,31
28,8474151,Ryan McDonagh,D,TBL,35,82,5,26,31
28,8476979,Erik Gustafsson,D,DET,32,82,4,27,31
28,8480860,Kevin Bahl,D,CGY,24,82,4,27,31
28,8481624,Ilya Mikheyev,R,CHI,30,82,19,11,30
28,8476392,Adam Lowry,C,WPG,31,82,12,18,30
28,8482624,Daniil Miromanov,D,CGY,27,82,12,18,30
28,8478569,Noel Acciari,C,PIT,33,82,12,18,30
28,8477406,Mattias Janmark,C,EDM,32,82,12,18,30
28,8478500,Ivan Provorov,D,CBJ,27,82,6,24,30
28,8482245,Artem Zub,D,OTT,29,82,6,24,30
28,8478851,Alexandre Carrier,D,NSH,28,82,5,25,30
28,8479976,Juuso Valimaki,D,UTA,26,82,4,26,30
28,8483431,Logan Cooley,C,UTA,20,82,13,16,29
28,8484203,Bradly Nadeau,L,CAR,19,82,10,19,29
28,8476931,Jake McCabe,D,TOR,31,82,7,22,29
28,8473507,Jeff Petry,D,DET,37,82,2,27,29
28,8479393,Noah Gregor,C,OTT,26,82,18,10,28
28,8479353,Brett Howden,C,VGK,26,82,16,12,28
28,8484153,Leo Carlsson,C,ANA,20,82,14,14,28
28,8476525,Colin Miller,D,WPG,32,82,11,17,28
28,8476442,Matt Nieto,L,PIT,32,82,10,18,28
28,8480220,Noah Cates,L,PHI,25,82,9,19,28
28,8477839,Conor Sheary,L,TBL,32,82,9,19,28
28,8481546,Cam York,D,PHI,23,82,6,22,28
28,8479351,Sam Steel,C,DAL,26,82,6,22,28
28,8481708,Zac Jones,D,NYR,24,82,4,24,28
28,8476879,Cody Ceci,D,EDM,31,82,3,25,28
28,8479324,Ryan Lindgren,D,NYR,26,82,1,27,28
28,8479661,Tanner Jeannot,L,LAK,27,82,16,11,27
28,8476960,Andreas Athanasiou,C,CHI,30,82,13,14,27
28,8477450,Jason Dickinson,C,CHI,29,82,12,15,27
28,8477931,Tomas Nosek,L,FLA,32,82,9,18,27
28,8482133,Thomas Bordeleau,C,SJS,22,82,8,19,27
28,8481606,Jordan Spence,D,LAK,23,82,7,20,27
28,8477508,Curtis Lazar,C,NJD,29,82,7,20,27
28,8479402,Jake Bean,D,CGY,26,82,6,21,27
28,8476902,Esa Lindell,D,DAL,30,82,5,22,27
28,8477488,Brett Pesce,D,NJD,30,82,3,24,27
28,8480021,Jack Studnicka,C,LAK,25,82,16,10,26
28,8475231,Casey Cizikas,C,NYI,33,82,15,11,26
28,8478508,Yakov Trenin,C,MIN,27,82,15,11,26
28,8473533,Jordan Staal,C,CAR,36,82,13,13,26
28,8480806,Isac Lundestrom,C,ANA,25,82,11,15,26
28,8480074,Alexandre Texier,C,STL,25,82,11,15,26
28,8479291,Kevin Rooney,C,CGY,31,82,11,15,26
28,8483495,Simon Nemec,D,NJD,20,82,11,15,26
28,8480813,Joe Veleno,C,DET,24,82,10,16,26
28,8480043,Timothy Liljegren,D,TOR,25,82,5,21,26
28,8482142,Jamie Drysdale,D,PHI,22,82,5,21,26
28,8475181,Nick Leddy,D,STL,33,82,3,23,26
28,8481567,Henry Thrun,D,SJS,23,82,9,16,25
28,8475193,Tomas Tatar,L,NJD,34,82,8,17,25
28,8480980,Connor Dewar,C,TOR,25,82,7,18,25
28,8480448,Parker Kelly,L,COL,25,82,7,18,25
28,8475855,Jesper Fast,R,CAR,33,82,6,19,25
28,8476312,Josh Manson,D,COL,33,82,6,19,25
28,8478399,Jonas Siegenthaler,D,NJD,27,82,4,21,25
28,8476422,Mike Reilly,D,NYI,31,82,4,21,25
28,8479998,Mikey Anderson,D,LAK,25,82,3,22,25
28,8477507,Nikita Zadorov,D,BOS,29,82,2,23,25
28,8475842,Sam Carrick,C,NYR,32,82,17,7,24
28,8482155,Alex Laferriere,R,LAK,23,82,14,10,24
28,8479591,Michael Eyssimont,C,TBL,28,82,9,15,24
28,8480789,Oliver Wahlstrom,R,NYI,24,82,8,16,24
28,8482062,Cole Smith,L,NSH,29,82,8,16,24
28,8481522,Peyton Krebs,C,BUF,23,82,7,17,24
28,8476457,Adam Larsson,D,SEA,32,82,6,18,24
28,8475690,Chris Tanev,D,TOR,35,82,6,18,24
28,8476463,Jonas Brodin,D,MIN,31,82,5,19,24
28,8479980,Nicolas Hague,D,VGK,26,82,4,20,24
28,8470600,Ryan Suter,D,STL,39,82,4,20,24
28,8476967,Brett Kulak,D,EDM,30,82,3,21,24
28,8481014,Alexander Romanov,D,NYI,24,82,1,23,24
28,8481093,Rafael Harvey-Pinard,L,MTL,25,82,16,7,23
28,8481477,Nico Sturm,C,SJS,29,82,16,7,23
28,8476858,Phillip Di Giuseppe,L,VAN,31,82,13,10,23
28,8480995,Pontus Holmberg,R,TOR,25,82,10,13,23
28,8478013,Jake Walman,D,SJS,28,82,10,13,23
28,8480003,Jesper Boqvist,C,FLA,26,82,6,17,23
28,8477938,Haydn Fleury,D,WPG,28,82,6,17,23
28,8478468,Jeremy Lauzon,D,NSH,27,82,3,20,23
28,8480049,Dylan Samberg,D,WPG,25,82,2,21,23
28,8474673,TJ Brodie,D,CHI,34,82,1,22,23
28,8480172,Jan Rutta,D,SJS,34,82,1,22,23
28,8482259,Bobby McMann,C,TOR,28,82,18,4,22
28,8482111,Justin Barron,D,MTL,23,82,11,11,22
28,8484166,Adam Fantilli,C,CBJ,20,82,10,12,22
28,8482166,Shakir Mukhamadullin,D,SJS,22,82,10,12,22
28,8481553,Bobby Brink,R,PHI,23,82,9,13,22
28,8483468,Jiri Kulich,C,BUF,20,82,9,13,22
28,8475188,Brayden McNabb,D,VGK,33,82,7,15,22
28,8480025,MacKenzie Entwistle,R,FLA,25,82,6,16,22
28,8482679,Matt Coronato,R,CGY,22,82,6,16,22
28,8483490,Pavel Mintyukov,D,ANA,21,82,6,16,22
28,8480246,Nick Perbix,D,TBL,26,82,6,16,22
28,8482073,Braden Schneider,D,NYR,23,82,4,18,22
28,8476917,Adam Pelech,D,NYI,30,82,3,19,22
28,8478840,Will Borgen,D,SEA,28,82,1,21,22
28,8478136,Jake Middleton,D,MIN,28,82,1,21,22
28,8475279,Ben Chiarot,D,DET,33,82,1,21,22
28,8476278,Colin Blackwell,C,DAL,31,82,17,4,21
28,8478432,Christian Fischer,R,DET,27,82,11,10,21
28,8482125,Alexander Holtz,R,VGK,22,82,9,12,21
28,8481641,Joel Kiviranta,L,COL,28,82,9,12,21
28,8476467,Jamie Oleksiak,D,SEA,32,82,7,14,21
28,8483457,Lane Hutson,D,MTL,20,82,6,15,21
28,8480073,Erik Brannstrom,D,COL,25,82,5,16,21
28,8482666,Scott Morrow,D,CAR,22,82,5,16,21
28,8481517,Brett Leason,R,ANA,25,82,4,17,21
28,8474574,Tyler Myers,D,VAN,34,82,4,17,21
28,8477499,Rasmus Ristolainen,D,PHI,30,82,4,17,21
28,8476441,Joel Edmundson,D,LAK,31,82,4,17,21
28,8482087,Kaiden Guhle,D,MTL,22,82,3,18,21
28,8478178,Darren Raddysh,D,TBL,28,82,3,18,21
28,8479983,Mario Ferraro,D,SJS,26,82,3,18,21
28,8475462,Radko Gudas,D,ANA,34,82,2,19,21
28,8477845,Trevor van Riemsdyk,D,WSH,33,82,1,20,21
28,8477365,Connor Clifton,D,BUF,29,82,1,20,21
28,8483397,Marc McLaughlin,C,BOS,25,82,12,8,20
28,8481601,Simon Holmstrom,R,NYI,23,82,11,9,20
28,8482077,Dylan Holloway,L,EDM,23,82,11,9,20
28,8480281,Alexey Toropchenko,R,STL,25,82,10,10,20
28,8478211,Dryden Hunt,L,CGY,29,82,8,12,20
28,8479359,Beck Malenstyn,L,BUF,26,82,8,12,20
28,8483524,Shane Wright,C,SEA,20,82,8,12,20
28,8477369,Carson Soucy,D,VAN,30,82,6,14,20
28,8483499,Liam Ohgren,L,MIN,20,82,5,15,20
28,8480950,Ilya Lyubushkin,D,DAL,30,82,5,15,20
28,8483460,David Jiricek,D,CBJ,21,82,5,15,20
28,8480796,Martin Fehervary,D,WSH,25,82,4,16,20
28,8480035,Henri Jokiharju,D,BUF,25,82,3,17,20
28,8478443,Brandon Carlo,D,BOS,28,82,2,18,20
28,8482659,Josh Doan,R,UTA,22,82,11,8,19
28,8479414,Nathan Bastian,R,NJD,27,82,9,10,19
28,8482101,Danil Gushchin,L,SJS,22,82,6,13,19
28,8474612,Travis Hamonic,D,OTT,34,82,6,13,19
28,8477435,Ryan Graves,D,PIT,29,82,5,14,19
28,8480222,Sebastian Aho,D,PIT,28,82,5,14,19
28,8483505,Matthew Poitras,C,BOS,20,82,3,16,19
28,8479369,Andrew Peeke,D,BOS,26,82,2,17,19
28,8476624,Barclay Goodrow,C,SJS,31,82,11,7,18
28,8478434,Keegan Kolesar,R,VGK,27,82,9,9,18
28,8476878,Zemgus Girgensons,L,TBL,30,82,9,9,18
28,8483493,Frank Nazar,C,CHI,20,82,7,11,18
28,8482803,Olen Zellweger,D,ANA,21,82,6,12,18
28,8482762,Simon Edvinsson,D,DET,21,82,6,12,18
28,8482470,Ilya Solovyov,D,CGY,24,82,6,12,18
28,8475762,Derek Forbort,D,VAN,32,82,6,12,18
28,8483482,Tristan Luneau,D,ANA,20,82,5,13,18
28,8481568,Alex Vlasic,D,CHI,23,82,4,14,18
28,8473453,Trevor Lewis,C,LAK,37,82,4,14,18
28,8475718,Justin Holl,D,DET,32,82,4,14,18
28,8471677,Jack Johnson,D,CBJ,37,82,4,14,18
28,8475233,David Savard,D,MTL,34,82,3,15,18
28,8476429,Scott Mayfield,D,NYI,32,82,3,15,18
28,8474090,Brendan Smith,D,DAL,35,82,3,15,18
28,8478874,Adam Gaudette,C,OTT,28,82,3,15,18
28,8481605,Jackson LaCombe,D,ANA,23,82,2,16,18
28,8482749,Joshua Roy,R,MTL,21,82,9,8,17
28,8482858,Ryker Evans,D,SEA,23,82,8,9,17
28,8479638,Justin Brazeau,R,BOS,26,82,7,10,17
28,8477505,Alexander Wennberg,C,SJS,30,82,5,12,17
28,8480990,Declan Chisholm,D,MIN,24,82,5,12,17
28,8481481,Blake Lizotte,C,PIT,27,82,3,14,17
28,8475455,Brenden Dillon,D,NJD,34,82,3,14,17
28,8480834,Ty Emberson,D,SJS,24,82,3,14,17
28,8475324,Nick Jensen,D,OTT,34,82,1,16,17
28,8478416,Erik Cernak,D,TBL,27,82,1,16,17
28,8478859,Niko Mikkola,D,FLA,28,82,9,7,16
28,8481028,Martin Pospisil,C,CGY,25,82,7,9,16
28,8479368,Max Jones,L,BOS,26,82,7,9,16
28,8482141,Lukas Cormier,D,VGK,22,82,7,9,16
28,8482733,Logan Mailloux,D,MTL,31,82,7,9,16
28,8480807,Mattias Samuelsson,D,BUF,24,82,5,11,16
28,8476372,Nick Seeler,D,PHI,31,82,4,12,16
28,8480879,Jacob Bernard-Docker,D,OTT,24,82,3,13,16
28,8482655,J.J. Moser,D,TBL,24,82,2,14,16
28,8482702,Logan Stankoven,C,DAL,21,82,2,14,16
28,8481178,Egor Zamula,D,PHI,24,82,1,15,16
28,8481122,Simon Benoit,D,TOR,26,82,1,15,16
28,8479442,Troy Stecher,D,EDM,30,82,7,8,15
28,8477034,Jaycob Megna,D,FLA,32,82,6,9,15
28,8482809,Jackson Blake,R,CAR,21,82,4,11,15
28,8476891,Matt Grzelcyk,D,PIT,30,82,3,12,15
28,8478507,John Marino,D,UTA,27,82,2,13,15
28,8483466,Kevin Korchinski,D,CHI,20,82,1,14,15
28,8474013,Ian Cole,D,UTA,35,82,0,15,15
28,8482145,Mavrik Bourque,C,DAL,22,82,8,6,14
28,8483012,Logan Morrison,C,SEA,22,82,5,9,14
28,8482118,Sam Colangelo,R,ANA,23,82,4,10,14
28,8475177,Calvin de Haan,D,COL,33,82,3,11,14
28,8484911,Collin Graf,R,SJS,22,82,3,11,14
28,8475790,Erik Gudbranson,D,CBJ,32,82,1,13,14
28,8474567,Zach Bogosian,D,MIN,34,82,1,13,14
28,8484149,Gavin Brindley,C,CBJ,20,82,6,7,13
28,8482074,Connor Zary,C,CGY,23,82,6,7,13
28,8477335,Kyle Burroughs,D,LAK,29,82,5,8,13
28,8476822,Luke Glendening,C,TBL,35,82,5,8,13
28,8483565,Nick Blankenburg,D,NSH,26,82,4,9,13
28,8483471,Brad Lambert,C,WPG,31,82,4,9,13
28,8481699,Aku Raty,R,UTA,23,82,4,9,13
28,8482516,Matthew Kessel,D,STL,24,82,3,10,13
28,8483445,Cutter Gauthier,L,ANA,20,82,5,7,12
28,8478450,Parker Wotherspoon,D,BOS,27,82,4,8,12
28,8483567,Georgii Merkulov,C,BOS,24,82,4,8,12
28,8479576,Vincent Desharnais,D,VAN,28,82,3,9,12
28,8482712,Oskar Olausson,R,COL,22,82,5,6,11
28,8482859,Zack Ostapchuk,C,OTT,21,82,5,5,10
28,8482070,Mitchell Chaffee,R,TBL,26,82,5,5,10
28,8482787,Nikita Chibrikov,R,WPG,31,82,4,6,10
28,8481524,Bowen Byram,D,BUF,23,82,3,7,10
28,8482807,Ethan Del Mastro,D,CHI,21,82,2,8,10
28,8482153,Brendan Brisson,C,VGK,23,82,2,8,10
28,8480870,Bo Groulx,C,NYR,24,82,6,3,9
28,8482713,Mackie Samoskevich,R,FLA,22,82,5,4,9
28,8476473,Connor Murphy,D,CHI,31,82,1,7,8
28,8483489,Fraser Minten,C,TOR,31,82,0,5,5
28,8474062,Riley Nash,C,NYR,35,82,1,3,4
28,8470794,Joe Pavelski,C,,40,0,0,0,0
28,8481703,Valtteri Puustinen,R,PIT,25,0,0,0,0
28,8477950,Tony DeAngelo,D,,29,0,0,0,0
28,8481577,Philip Tomasino,C,NSH,23,0,0,0,0
28,8475197,Tyson Barrie,D,,33,0,0,0,0
28,8471218,Blake Wheeler,R,,38,0,0,0,0
28,8474157,Max Pacioretty,L,,36,0,0,0,0
28,8478466,Daniel Sprong,R,VAN,27,0,0,0,0
28,8475744,Evgeny Kuznetsov,C,,32,0,0,0,0
28,8481019,David Gustafsson,C,WPG,24,0,0,0,0
28,8475906,John Klingberg,D,,32,0,0,0,0
28,8479348,Kale Clague,D,BUF,26,0,0,0,0
28,8476952,Dominic Toninato,C,WPG,30,0,0,0,0
28,8473473,Milan Lucic,L,,36,0,0,0,0
28,8474037,James van Riemsdyk,L,,35,0,0,0,0
28,8474602,Justin Schultz,D,,34,0,0,0,0
28,8482222,Alexander Barabanov,L,,30,0,0,0,0
28,8479372,Josh Mahura,D,SEA,26,0,0,0,0
28,8479982,Conor Timmins,D,TOR,26,0,0,0,0
28,8474031,Kevin Shattenkirk,D,,35,0,0,0,0
28,8480008,Adam Ruzicka,C,,25,0,0,0,0
28,8481059,Scott Perunovich,D,STL,26,0,0,0,0
28,8480884,Calen Addison,D,,24,0,0,0,0
28,8476994,Vinnie Hinostroza,C,NSH,30,0,0,0,0
28,8478452,Caleb Jones,D,LAK,27,0,0,0,0
28,8480157,Calle Rosen,D,COL,30,0,0,0,0
28,8481609,Vladislav Kolyachonok,D,UTA,23,0,0,0,0
28,8479415,Michael McLeod,C,,26,0,0,0,0
28,8476919,Chris Tierney,C,,30,0,0,0,0
28,8479639,Dylan Coghlan,D,WPG,26,0,0,0,0
28,8478146,Matthew Highmore,C,OTT,28,0,0,0,0
28,8478970,Jalen Chatfield,D,CAR,28,0,0,0,0
28,8480205,Emil Bemstrom,C,PIT,25,0,0,0,0
28,8474884,Mike Hoffman,C,,35,0,0,0,0
28,8471274,Alex Goligoski,D,,39,0,0,0,0
28,8478104,Sammy Blais,L,,28,0,0,0,0
28,8474870,Tyler Johnson,C,,34,0,0,0,0
28,8476913,Devin Shore,C,MIN,30,0,0,0,0
28,8481598,Philip Broberg,D,EDM,23,0,0,0,0
28,8480058,Pierre-Olivier Joseph,D,STL,25,0,0,0,0
28,8480891,Michael Kesselring,D,UTA,24,0,0,0,0
28,8477979,Nicolas Aube-Kubel,R,BUF,28,0,0,0,0
28,8476871,Tanner Pearson,L,,32,0,0,0,0
28,8476393,Nick Cousins,C,,31,0,0,0,0
28,8479977,Kailer Yamamoto,R,,26,0,0,0,0
28,8479543,Michael Pezzetta,L,MTL,26,0,0,0,0
28,8477018,Ben Hutton,D,VGK,31,0,0,0,0
28,8480762,Eric Robinson,L,CAR,29,0,0,0,0
28,8474034,Pat Maroon,L,CHI,36,0,0,0,0
28,8481058,Jesse Ylönen,R,,25,0,0,0,0
28,8475179,Dmitry Kulikov,D,FLA,34,0,0,0,0
28,8481527,Kaedan Korczak,D,VGK,23,0,0,0,0
28,8473449,Kyle Okposo,R,,36,0,0,0,0
28,8482192,Isaak Phillips,D,CHI,23,0,0,0,0
28,8480727,Zach Whitecloud,D,VGK,28,0,0,0,0
28,8479346,Dillon Dube,C,,26,0,0,0,0
28,8480821,Filip Zadina,R,,25,0,0,0,0
28,8480001,Urho Vaakanainen,D,ANA,25,0,0,0,0
28,8470966,Mark Giordano,D,,41,0,0,0,0
28,8480853,Liam Foudy,C,,24,0,0,0,0
28,8475225,Craig Smith,C,CHI,35,0,0,0,0
28,8479972,Mason Shaw,C,WPG,26,0,0,0,0
28,8478451,Ethan Bear,D,WSH,27,0,0,0,0
28,8474040,Sam Gagner,C,,35,0,0,0,0
28,8480196,Jacob Bryson,D,BUF,27,0,0,0,0
28,8479984,Cal Foote,D,,26,0,0,0,0
28,8480011,Klim Kostin,C,SJS,25,0,0,0,0
28,8482176,Wyatt Kaiser,D,CHI,22,0,0,0,0
28,8476988,Matt Benning,D,SJS,30,0,0,0,0
28,8479370,Tyson Jost,C,CAR,26,0,0,0,0
28,8477464,Nic Petan,C,,29,0,0,0,0
28,8477380,Jonny Brodzinski,C,NYR,31,0,0,0,0
28,8480070,Ian Mitchell,D,BOS,25,0,0,0,0
28,8479315,Joey Anderson,R,CHI,26,0,0,0,0
28,8478099,Kevin Labanc,R,,29,0,0,0,0
28,8476874,Olli Maatta,D,DET,30,0,0,0,0
28,8475208,Brian Dumoulin,D,ANA,33,0,0,0,0
28,8478430,Oliver Kylington,D,,27,0,0,0,0
28,8479536,Axel Jonsson-Fjallby,L,WPG,26,0,0,0,0
28,8479671,Mathieu Olivier,R,CBJ,27,0,0,0,0
28,8471709,Marc-Edouard Vlasic,D,SJS,37,0,0,0,0
28,8479328,Julien Gauthier,R,NYI,27,0,0,0,0
28,8478421,A.J. Greer,L,FLA,28,0,0,0,0
28,8477573,Nathan Walker,L,STL,30,0,0,0,0
28,8481537,Nikita Okhotiuk,D,CGY,24,0,0,0,0
28,8474166,Alec Martinez,D,CHI,37,0,0,0,0
28,8470610,Zach Parise,L,,40,0,0,0,0
28,8477478,William Carrier,L,CAR,30,0,0,0,0
28,8479344,Jesse Puljujarvi,R,PIT,26,0,0,0,0
28,8480887,Jordan Harris,D,MTL,24,0,0,0,0
28,8478502,Dennis Gilbert,D,BUF,28,0,0,0,0
28,8482730,Brandt Clarke,D,LAK,21,0,0,0,0
28,8480355,Mark Kastelic,C,BOS,25,0,0,0,0
28,8475750,Jon Merrill,D,MIN,32,0,0,0,0
28,8475164,Jakob Silfverberg,R,,34,0,0,0,0
28,8477944,Jakub Vrana,L,,28,0,0,0,0
28,8479439,Jacob MacDonald,D,COL,31,0,0,0,0
28,8474568,Luke Schenn,D,NSH,35,0,0,0,0
28,8478454,Noah Juulsen,D,VAN,27,0,0,0,0
28,8475752,Tyler Pitlick,C,,33,0,0,0,0
28,8482148,Hendrix Lapierre,C,WSH,22,0,0,0,0
28,8481167,Brayden Pachal,D,CGY,25,0,0,0,0
28,8478043,Sam Lafferty,C,BUF,29,0,0,0,0
28,8479321,Lucas Johansen,D,,27,0,0,0,0
28,8471699,Andrew Cogliano,C,,37,0,0,0,0
28,8481521,Ronnie Attard,D,PHI,25,0,0,0,0
28,8481161,Jake Christiansen,D,CBJ,25,0,0,0,0
28,8479458,Nikita Zaitsev,D,,33,0,0,0,0
28,8479619,Michael Carcone,L,UTA,28,0,0,0,0
28,8479026,Philippe Myers,D,TOR,27,0,0,0,0
28,8477330,Dominik Kubalik,L,,29,0,0,0,0
28,8481617,Vasily Podkolzin,R,VAN,23,0,0,0,0
28,8481701,Santeri Hatakka,D,NJD,23,0,0,0,0
28,8479514,Rem Pitlick,C,,27,0,0,0,0
28,8477446,Michael McCarron,R,NSH,29,0,0,0,0
28,8470604,Jeff Carter,C,,39,0,0,0,0
28,8482241,Radim Zohorna,L,,28,0,0,0,0
28,8480289,Morgan Barron,C,WPG,26,0,0,0,0
28,8479379,Givani Smith,R,SJS,26,0,0,0,0
28,8480216,Jacob Peterson,C,,25,0,0,0,0
28,8477851,Jordan Oesterle,D,BOS,32,0,0,0,0
28,8484258,Sam Malinski,D,COL,26,0,0,0,0
28,8478904,Steven Lorentz,C,,28,0,0,0,0
28,8482095,Tyler Kleven,D,OTT,22,0,0,0,0
28,8480848,Ty Dellandrea,C,SJS,24,0,0,0,0
28,8476884,Derrick Pouliot,D,,30,0,0,0,0
28,8479336,Carl Grundstrom,R,SJS,27,0,0,0,0
28,8482964,Arber Xhekaj,D,MTL,23,0,0,0,0
28,8471686,Marc Staal,D,,37,0,0,0,0
28,8477887,Patrick Brown,C,BOS,32,0,0,0,0
28,8478495,Denis Gurianov,R,,27,0,0,0,0
28,8473504,Cal Clutterbuck,R,,37,0,0,0,0
28,8481550,Adam Beckman,L,NJD,23,0,0,0,0
28,8480845,Rasmus Kupari,C,WPG,24,0,0,0,0
28,8474009,Nick Bonino,C,,36,0,0,0,0
28,8478585,Derek Ryan,C,EDM,38,0,0,0,0
28,8477962,Brendan Lemieux,L,CAR,28,0,0,0,0
28,8482861,Vincent Iorio,D,WSH,22,0,0,0,0
28,8479378,Logan Stanley,D,WPG,26,0,0,0,0
28,8473446,Erik Johnson,D,PHI,36,0,0,0,0
28,8481743,Marc Del Gaizo,D,NSH,25,0,0,0,0
28,8477384,Josh Brown,D,EDM,30,0,0,0,0
28,8482165,Yan Kuznetsov,D,CGY,22,0,0,0,0
28,8478424,Jansen Harkins,C,ANA,27,0,0,0,0
28,8482144,Jack Thompson,D,SJS,22,0,0,0,0
28,8478512,Austin Czarnik,C,,32,0,0,0,0
28,8477527,Ross Johnston,L,ANA,30,0,0,0,0
28,8479383,Boris Katchouk,L,,26,0,0,0,0
28,8482094,Daemon Hunt,D,MIN,22,0,0,0,0
28,8481719,Maxwell Crozier,D,TBL,24,0,0,0,0
28,8480192,Johnathan Kovacevic,D,NJD,27,0,0,0,0
28,8479376,Victor Mete,D,,26,0,0,0,0
28,8482511,Mason Lohrei,D,BOS,23,0,0,0,0
28,8475825,Jani Hakanpää,D,,32,0,0,0,0
28,8478021,William Lagesson,D,DET,28,0,0,0,0
28,8475795,Dylan McIlrath,D,WSH,32,0,0,0,0
28,8477846,Ryan Carpenter,C,,33,0,0,0,0
28,8481056,Spencer Stastney,D,NSH,24,0,0,0,0
28,8481564,Ryan Johnson,D,BUF,23,0,0,0,0
28,8478017,Mark Friedman,D,VAN,29,0,0,0,0
28,8479320,Max Lajoie,D,SEA,27,0,0,0,0
28,8480075,Cameron Crotty,D,MIN,25,0,0,0,0
28,8484287,Cole McWard,D,VAN,23,0,0,0,0
28,8484254,Akito Hirose,D,VAN,25,0,0,0,0
28,8483407,Brandon Scanlin,D,NYR,25,0,0,0,0
28,8480274,Philip Kemp,D,EDM,25,0,0,0,0
28,8479522,Hardy Haman Aktell,D,WSH,26,0,0,0,0
28,8480007,Jonas Rondbjerg,R,VGK,25,0,0,0,0
28,8477454,Adam Erne,L,,29,0,0,0,0
28,8481679,Maxence Guenette,D,OTT,23,0,0,0,0
28,8480441,Trey Fix-Wolansky,R,CBJ,25,0,0,0,0
28,8483546,Marshall Rifai,D,TOR,26,0,0,0,0
28,8480084,Nick DeSimone,D,NJD,30,0,0,0,0
28,8481030,Jack St. Ivany,D,PIT,25,0,0,0,0
28,8481592,Jakob Pelletier,L,CGY,23,0,0,0,0
28,8478011,Louie Belpedio,D,PHI,28,0,0,0,0
28,8477930,Pierre-Edouard Bellemare,L,,39,0,0,0,0
28,8484321,Nikolas Matinpalo,D,OTT,26,0,0,0,0
28,8482067,Connor Mackey,D,NYR,28,0,0,0,0
28,8481806,Louis Crevier,D,CHI,23,0,0,0,0
28,8484326,Patrik Koch,D,UTA,28,0,0,0,0
28,8477971,Andreas Englund,D,LAK,28,0,0,0,0
28,8481751,Lukas Rousek,R,BUF,25,0,0,0,0
28,8481006,Tyler Tucker,D,STL,24,0,0,0,0
28,8476867,Brendan Gaunce,C,MIN,30,0,0,0,0
28,8479520,Brandon Duhaime,R,WSH,27,0,0,0,0
28,8477073,Kurtis MacDermid,L,NJD,30,0,0,0,0
28,8480874,Adam Ginning,D,PHI,24,0,0,0,0
28,8477473,Justin Bailey,R,SJS,29,0,0,0,0
28,8479066,Ryan Lomberg,L,CGY,30,0,0,0,0
28,8477070,Liam O'Brien,C,UTA,30,0,0,0,0
28,8474618,Marco Scandella,D,,34,0,0,0,0
28,8475797,Jarred Tinordi,D,,32,0,0,0,0
28,8481441,Joe Snively,C,DET,28,0,0,0,0
28,8477244,Chad Ruhwedel,D,NYR,34,0,0,0,0
28,8479772,Zack MacEwen,R,OTT,28,0,0,0,0
28,8481147,Reese Johnson,C,MIN,26,0,0,0,0
28,8481043,Cole Koepke,L,BOS,26,0,0,0,0
28,8483619,Filip Roos,D,OTT,25,0,0,0,0
28,8481541,Samuel Bolduc,D,NYI,24,0,0,0,0
28,8477810,Joel Hanley,D,CGY,33,0,0,0,0
28,8476907,Mackenzie MacEachern,L,,30,0,0,0,0
28,8482652,Walker Duehr,R,CGY,27,0,0,0,0
28,8477126,Jayson Megna,C,,34,0,0,0,0
28,8483398,Declan Carlile,D,TBL,31,0,0,0,0
28,8482929,Emil Lilleberg,D,TBL,23,0,0,0,0
28,8480880,Jakub Lauko,C,MIN,24,0,0,0,0
28,8480245,Olle Lycksell,R,PHI,25,0,0,0,0
28,8480252,Cole Guttman,C,CHI,25,0,0,0,0
28,8477467,Gustav Olofsson,D,SEA,30,0,0,0,0
28,8479968,Vinni Lettieri,C,BOS,29,0,0,0,0
28,8478400,Colin White,C,,27,0,0,0,0
28,8475755,Alexander Petrovic,D,DAL,32,0,0,0,0
28,8481812,Nikolai Knyzhov,D,,27,0,0,0,0
28,8481593,Jayden Struble,D,MTL,23,0,0,0,0
28,8481532,Alex Turcotte,C,LAK,23,0,0,0,0
28,8482126,Emil Andrae,D,PHI,31,0,0,0,0
28,8479944,Zach Aston-Reese,C,VGK,30,0,0,0,0
28,8471817,Ryan Reaves,R,TOR,37,0,0,0,0
28,8481206,John Ludvig,D,PIT,24,0,0,0,0
28,8481599,Victor Soderstrom,D,UTA,23,0,0,0,0
28,8480292,Carson Meyer,R,ANA,27,0,0,0,0
28,8482496,Nils Aman,C,VAN,24,0,0,0,0
28,8479718,Alex Barré-Boulet,C,MTL,27,0,0,0,0
28,8479994,Jaret Anderson-Dolan,C,WPG,25,0,0,0,0
28,8480184,Gustav Lindstrom,D,,26,0,0,0,0
28,8480890,Jan Jenik,R,OTT,24,0,0,0,0
28,8478067,Oskar Lindblom,L,,28,0,0,0,0
28,8476934,Brock McGinn,L,ANA,30,0,0,0,0
28,8479985,Cale Fleury,D,SEA,26,0,0,0,0
28,8484304,Uvis Balinskis,D,FLA,28,0,0,0,0
28,8479981,Jonah Gadjovich,L,FLA,26,0,0,0,0
28,8481716,Dmitri Voronkov,L,CBJ,24,0,0,0,0
28,8474709,Matt Martin,L,,35,0,0,0,0
28,8482634,Alex Steeves,C,TOR,25,0,0,0,0
28,8480823,Alexander Alexeyev,D,WSH,25,0,0,0,0
28,8477541,Dakota Mermis,D,TOR,30,0,0,0,0
28,8483491,Ivan Miroshnichenko,L,WSH,20,0,0,0,0
28,8478477,Mitchell Stephens,C,SEA,27,0,0,0,0
28,8481543,Nikita Alexandrov,C,STL,24,0,0,0,0
28,8479423,Alex Nylander,L,,26,0,0,0,0
28,8482451,Mikael Pyyhtia,L,CBJ,23,0,0,0,0
28,8478831,Kevin Stenlund,C,UTA,28,0,0,0,0
28,8480306,Grant Hutton,D,NYI,29,0,0,0,0
28,8478028,Fredrik Olofsson,L,,28,0,0,0,0
28,8477462,Robert Hagg,D,VGK,29,0,0,0,0
28,8477320,Anton Blidh,L,NYR,29,0,0,0,0
28,8482157,Will Cuylle,L,NYR,22,0,0,0,0
28,8482737,Zack Bolduc,C,STL,21,0,0,0,0
28,8481239,Samuel Fagemo,L,,24,0,0,0,0
28,8481600,Tobias Bjornfot,D,FLA,23,0,0,0,0
28,8478409,Anthony Richard,C,PHI,28,0,0,0,0
28,8474145,Robert Bortuzzo,D,,35,0,0,0,0
28,8475958,Michael Sgarbossa,C,WSH,32,0,0,0,0
28,8479986,Kole Lind,R,DAL,26,0,0,0,0
28,8479249,Andrew Poturalski,C,SJS,30,0,0,0,0
28,8479362,Riley Tufte,L,BOS,26,0,0,0,0
28,8479991,Jake Leschyshyn,C,NYR,25,0,0,0,0
28,8479587,Rhett Gardner,C,PHI,28,0,0,0,0
28,8482744,James Malatesta,L,CBJ,21,0,0,0,0
28,8478854,Ryan Shea,D,PIT,27,0,0,0,0
28,8481591,Sam Poulin,R,,23,0,0,0,0
28,8483512,Matt Savoie,C,EDM,20,0,0,0,0
28,8482102,Vasily Ponomarev,C,PIT,22,0,0,0,0
28,8482162,Roby Jarventie,L,EDM,22,0,0,0,0
28,8481016,Ruslan Iskhakov,C,,24,0,0,0,0
28,8482172,Landon Slaggert,L,CHI,22,0,0,0,0
28,8482747,Brennan Othmann,L,NYR,21,0,0,0,0
28,8480031,Maxime Comtois,L,,25,0,0,0,0
28,8480226,Marián Studenic,R,,26,0,0,0,0
28,8478408,Travis Dermott,D,,28,0,0,0,0
28,8481518,Nolan Foote,L,NJD,24,0,0,0,0
28,8479419,Brett Murray,L,BUF,26,0,0,0,0
28,8482088,Justin Sourdif,R,FLA,22,0,0,0,0
28,8482201,Gage Goncalves,C,TBL,23,0,0,0,0
28,8481578,Graeme Clarke,R,MIN,23,0,0,0,0
28,8482177,Marat Khusnutdinov,C,MIN,22,0,0,0,0
28,8481754,Nikita Nesterenko,C,ANA,23,0,0,0,0
28,8483531,Brian Halonen,L,NJD,25,0,0,0,0
28,8483920,Pierrick Dube,R,WSH,23,0,0,0,0
28,8480851,Akil Thomas,C,LAK,24,0,0,0,0
28,8475235,Nicolas Deslauriers,L,PHI,33,0,0,0,0
28,8482476,Emil Heineman,L,MTL,23,0,0,0,0
28,8477149,Scott Sabourin,R,SJS,32,0,0,0,0
28,8483549,Lucas Condotta,L,MTL,27,0,0,0,0
28,8482765,Isak Rosen,R,BUF,21,0,0,0,0
28,8481237,Kyle MacLean,C,NYI,25,0,0,0,0
28,8481024,Linus Karlsson,C,VAN,25,0,0,0,0
28,8481690,Tyler Angle,C,,24,0,0,0,0
28,8483570,Ben Meyers,C,SEA,26,0,0,0,0
28,8481655,Cole Schwindt,R,CGY,23,0,0,0,0
28,8481462,Mason Morelli,L,VGK,28,0,0,0,0
28,8483401,Marc Johnstone,R,PIT,28,0,0,0,0
28,8478956,Samuel Laberge,L,NJD,27,0,0,0,0
28,8479533,Joona Koppanen,L,,26,0,0,0,0
28,8482197,Adam Raska,R,MIN,23,0,0,0,0
28,8482250,Callahan Burke,C,VGK,27,0,0,0,0
28,8482784,Zach Dean,C,STL,21,0,0,0,0
28,8484255,Jason Polin,R,COL,25,0,0,0,0
28,8481077,John Leonard,L,,26,0,0,0,0
28,8481534,Raphael Lavoie,C,EDM,24,0,0,0,0
28,8483609,Adam Klapka,R,CGY,24,0,0,0,0
28,8482751,Ryan Winterton,C,SEA,21,0,0,0,0
28,8480267,Sammy Walker,C,MIN,25,0,0,0,0
28,8475766,Austin Watson,L,,32,0,0,0,0
28,8482460,Matt Rempe,C,NYR,22,0,0,0,0
28,8481065,Angus Crookshank,L,OTT,25,0,0,0,0
28,8481070,Hugh McGing,L,,26,0,0,0,0
28,8476323,Max McCormick,L,SEA,32,0,0,0,0
28,8483395,Arshdeep Bains,L,VAN,23,0,0,0,0
28,8484259,Ondrej Pavel,C,COL,31,0,0,0,0
28,8483432,Luca Del Bel Belluz,C,CBJ,31,0,0,0,0
28,8483045,Cameron Butler,R,CBJ,31,0,0,0,0
28,8482061,Brandon Biro,L,SEA,26,0,0,0,0
28,8477401,John Hayden,C,SEA,29,0,0,0,0
28,8475278,Byron Froese,C,,33,0,0,0,0
28,8478446,Glenn Gawdin,C,LAK,27,0,0,0,0
28,8477993,Justin Kirkland,C,CGY,28,0,0,0,0
28,8482147,Jean-Luc Foudy,C,COL,22,0,0,0,0
28,8480032,Shane Bowers,C,NJD,25,0,0,0,0
28,8479330,Brandon Gignac,C,MTL,27,0,0,0,0
28,8480776,Sheldon Rempal,R,,29,0,0,0,0
28,8475413,Justin Dowling,C,NJD,34,0,0,0,0
28,8481726,Adam Edstrom,C,NYR,24,0,0,0,0
28,8480844,Grigori Denisenko,L,VGK,24,0,0,0,0
28,8478147,Bokondji Imama,L,PIT,28,0,0,0,0
28,8478881,Brett Seney,L,CHI,28,0,0,0,0
28,8483630,Pavol Regenda,L,ANA,25,0,0,0,0
28,8480836,Jonathan Gruden,C,,24,0,0,0,0
28,8484314,Jiri Smejkal,L,,28,0,0,0,0
28,8475780,Chris Wagner,R,COL,33,0,0,0,0
28,8479546,Oskar Steen,C,,26,0,0,0,0
28,8483597,Milos Kelemen,L,UTA,25,0,0,0,0
28,8481789,Tye Kartye,L,SEA,23,0,0,0,0
28,8484325,Waltteri Merela,C,TBL,26,0,0,0,0
28,8479421,Jacob Moverare,D,LAK,26,0,0,0,0
28,8481585,Egor Afanasyev,L,SJS,23,0,0,0,0
28,8479547,Matthew Phillips,R,,26,0,0,0,0
28,8479367,William Lockwood,R,FLA,26,0,0,0,0
28,8476915,Jujhar Khaira,L,,30,0,0,0,0
28,8481422,Jacob Lucchini,C,NSH,29,0,0,0,0
28,8480468,James Hamblin,L,EDM,25,0,0,0,0
28,8478051,Max Willman,C,NJD,29,0,0,0,0
28,8481556,John Beecher,C,BOS,23,0,0,0,0
28,8478078,Rourke Chartier,C,,28,0,0,0,0
29,8477492,Nathan MacKinnon,C,COL,29,82,59,76,135
29,8478420,Mikko Rantanen,R,COL,28,82,52,67,119
29,8478550,Artemi Panarin,L,NYR,33,82,43,74,117
29,8478402,Connor McDavid,C,EDM,27,82,37,79,116
29,8476453,Nikita Kucherov,R,TBL,31,82,32,83,115
29,8479318,Auston Matthews,C,TOR,27,82,71,42,113
29,8481559,Jack Hughes,C,NJD,23,82,43,70,113
29,8479314,Matthew Tkachuk,L,FLA,27,82,30,74,104
29,8477939,William Nylander,R,TOR,28,82,49,54,103
29,8478445,Mathew Barzal,C,NYI,27,82,24,77,101
29,8480069,Cale Makar,D,COL,26,82,24,76,100
29,8477942,Kevin Fiala,L,LAK,28,82,42,57,99
29,8475692,Mats Zuccarello,R,MIN,37,82,25,74,99
29,8477956,David Pastrnak,R,BOS,28,82,50,48,98
29,8480027,Jason Robertson,L,DAL,25,82,45,53,98
29,8476468,J.T. Miller,C,VAN,31,82,35,63,98
29,8480002,Nico Hischier,C,NJD,25,82,32,65,97
29,8479323,Adam Fox,D,NYR,26,82,15,82,97
29,8478864,Kirill Kaprizov,L,MIN,27,82,42,54,96
29,8477934,Leon Draisaitl,C,EDM,29,82,40,56,96
29,8480012,Elias Pettersson,C,VAN,26,82,38,58,96
29,8471675,Sidney Crosby,C,PIT,37,82,37,59,96
29,8480801,Brady Tkachuk,L,OTT,25,82,45,50,95
29,8480036,Miro Heiskanen,D,DAL,25,82,17,78,95
29,8478403,Jack Eichel,C,VGK,28,82,40,52,92
29,8478493,Joel Eriksson Ek,C,MIN,27,82,44,46,90
29,8474564,Steven Stamkos,C,NSH,34,82,36,53,89
29,8477493,Aleksander Barkov,C,FLA,29,82,29,60,89
29,8481523,Kirby Dach,C,MTL,23,82,19,70,89
29,8477933,Sam Reinhart,C,FLA,29,82,46,42,88
29,8479343,Clayton Keller,R,UTA,26,82,43,45,88
29,8480800,Quinn Hughes,D,VAN,25,82,13,74,87
29,8476887,Filip Forsberg,L,NSH,30,82,34,51,85
29,8473419,Brad Marchand,L,BOS,36,82,26,59,85
29,8477946,Dylan Larkin,C,DET,28,82,40,44,84
29,8481557,Matt Boldy,L,MIN,23,82,39,45,84
29,8475172,Nazem Kadri,C,CGY,34,82,26,58,84
29,8480023,Robert Thomas,C,STL,25,82,23,61,84
29,8479385,Jordan Kyrou,C,STL,26,82,36,46,82
29,8474141,Patrick Kane,R,DET,36,82,26,56,82
29,8478010,Brayden Point,C,TBL,28,82,40,40,80
29,8477404,Jake Guentzel,C,TBL,30,82,37,43,80
29,8476454,Ryan Nugent-Hopkins,C,EDM,31,82,28,52,80
29,8480839,Rasmus Dahlin,D,BUF,24,82,18,62,80
29,8476882,Teuvo Teravainen,L,CHI,30,82,26,53,79
29,8479420,Tage Thompson,C,BUF,27,82,37,41,78
29,8477402,Pavel Buchnevich,L,STL,29,82,29,49,78
29,8476456,Jonathan Huberdeau,C,CGY,31,82,21,57,78
29,8478439,Travis Konecny,R,PHI,27,82,36,41,77
29,8476459,Mika Zibanejad,C,NYR,31,82,32,45,77
29,8477940,Nikolaj Ehlers,L,WPG,28,82,32,45,77
29,8480830,Andrei Svechnikov,R,CAR,24,82,31,46,77
29,8471685,Anze Kopitar,C,LAK,37,82,24,53,77
29,8478398,Kyle Connor,L,WPG,28,82,38,38,76
29,8476853,Morgan Rielly,D,TOR,30,82,9,67,76
29,8476389,Vincent Trocheck,C,NYR,31,82,36,39,75
29,8480208,Drake Batherson,R,OTT,26,82,27,48,75
29,8476346,Johnny Gaudreau,L,CBJ,31,82,21,53,74
29,8475167,Victor Hedman,D,TBL,34,82,14,60,74
29,8477501,Valeri Nichushkin,R,COL,29,82,40,33,73
29,8482116,Tim Stützle,C,OTT,22,82,28,45,73
29,8476460,Mark Scheifele,C,WPG,31,82,27,46,73
29,8480865,Noah Dobson,D,NYI,24,82,14,59,73
29,8477935,Sam Bennett,C,FLA,28,82,43,29,72
29,8475166,John Tavares,C,TOR,34,82,34,38,72
29,8478444,Brock Boeser,R,VAN,27,82,33,39,72
29,8477456,J.T. Compher,L,DET,29,82,30,42,72
29,8482665,Matty Beniers,C,SEA,22,82,28,44,72
29,8475184,Chris Kreider,L,NYR,33,82,38,33,71
29,8477949,Alex Tuch,R,BUF,28,82,19,52,71
29,8482093,Seth Jarvis,C,CAR,22,82,29,41,70
29,8478873,Troy Terry,R,ANA,27,82,19,51,70
29,8474600,Roman Josi,D,NSH,34,82,17,53,70
29,8478414,Timo Meier,R,NJD,28,82,32,37,69
29,8477409,Carter Verhaeghe,C,FLA,29,82,30,39,69
29,8479675,Trevor Moore,L,LAK,29,82,30,39,69
29,8478975,Mason Marchment,L,DAL,29,82,25,44,69
29,8475786,Zach Hyman,L,EDM,32,82,36,31,67
29,8478427,Sebastian Aho,C,CAR,27,82,29,38,67
29,8478440,Dylan Strome,C,WSH,27,82,27,40,67
29,8471215,Evgeni Malkin,C,PIT,38,82,23,44,67
29,8475754,Brock Nelson,C,NYI,33,82,37,29,66
29,8477951,Nick Schmaltz,C,UTA,28,82,29,37,66
29,8477960,Adrian Kempe,R,LAK,28,82,29,36,65
29,8479407,Jesper Bratt,L,NJD,26,82,18,47,65
29,8479325,Charlie McAvoy,D,BOS,27,82,9,56,65
29,8478449,Roope Hintz,C,DAL,28,82,29,35,64
29,8477496,Elias Lindholm,C,BOS,30,82,28,36,64
29,8475794,Tyler Seguin,C,DAL,32,82,27,37,64
29,8479999,Casey Mittelstadt,C,COL,26,82,19,45,64
29,8479542,Brandon Hagel,L,TBL,26,82,33,30,63
29,8475170,Brayden Schenn,C,STL,33,82,29,34,63
29,8471214,Alex Ovechkin,L,WSH,39,82,28,35,63
29,8478401,Pavel Zacha,C,BOS,27,82,23,40,63
29,8474102,David Perron,L,OTT,36,82,21,42,63
29,8481711,Matias Maccelli,L,UTA,24,82,14,49,63
29,8478460,Zach Werenski,D,CBJ,27,82,11,52,63
29,8478407,Vince Dunn,D,SEA,28,82,11,52,63
29,8482097,Jack Quinn,R,BUF,23,82,29,33,62
29,8475765,Vladimir Tarasenko,R,DET,33,82,26,36,62
29,8475745,Charlie Coyle,C,BOS,32,82,24,38,62
29,8478438,Tommy Novak,C,NSH,27,82,23,39,62
29,8479339,Patrik Laine,L,CBJ,26,82,23,39,62
29,8479337,Alex DeBrincat,R,DET,27,82,21,41,62
29,8482124,Quinton Byfield,R,LAK,22,82,21,41,62
29,8476432,Boone Jenner,C,CBJ,31,82,35,26,61
29,8478498,Jake DeBrusk,L,VAN,28,82,33,28,61
29,8477476,Artturi Lehkonen,L,COL,29,82,28,33,61
29,8481528,Dylan Cozens,C,BUF,23,82,25,36,61
29,8478397,Rasmus Andersson,D,CGY,28,82,13,48,61
29,8480803,Evan Bouchard,D,EDM,25,82,9,52,61
29,8476479,Phillip Danault,C,LAK,31,82,28,32,60
29,8477511,Anthony Mantha,R,CGY,30,82,28,32,60
29,8479987,Morgan Geekie,C,BOS,26,82,21,39,60
29,8475913,Mark Stone,R,VGK,32,82,20,40,60
29,8480018,Nick Suzuki,C,MTL,25,82,16,44,60
29,8476906,Shayne Gostisbehere,D,CAR,31,82,16,44,60
29,8480014,Gabriel Vilardi,C,WPG,25,82,33,26,59
29,8480039,Martin Necas,C,CAR,25,82,27,32,59
29,8473994,Jamie Benn,L,DAL,35,82,25,34,59
29,8482684,Luke Hughes,D,NJD,21,82,16,43,59
29,8477964,Ivan Barbashev,C,VGK,29,82,29,29,58
29,8475158,Ryan O'Reilly,C,NSH,33,82,21,37,58
29,8473512,Claude Giroux,R,OTT,36,82,15,43,58
29,8476875,Mike Matheson,D,MTL,30,82,13,45,58
29,8475784,Jeff Skinner,C,EDM,32,82,27,30,57
29,8482109,Alexis Lafrenière,L,NYR,23,82,26,31,57
29,8481068,Yegor Sharangovich,C,CGY,26,82,24,33,57
29,8480798,Philipp Kurashev,C,CHI,25,82,16,41,57
29,8478038,Devon Toews,D,COL,30,82,12,45,57
29,8475169,Evander Kane,L,EDM,33,82,33,23,56
29,8477500,Bo Horvat,C,NYI,29,82,30,26,56
29,8477479,Tyler Bertuzzi,L,CHI,29,82,25,31,56
29,8480078,Filip Chytil,C,NYR,25,82,21,35,56
29,8474053,Logan Couture,C,SJS,35,82,18,38,56
29,8477444,Andre Burakovsky,L,SEA,29,82,18,38,56
29,8478055,Gustav Forsling,D,FLA,28,82,14,42,56
29,8475798,Mikael Granlund,C,SJS,32,82,13,43,56
29,8478233,Andrew Mangiapane,L,WSH,28,82,26,29,55
29,8478458,Jack Roslovic,C,CAR,27,82,20,35,55
29,8478856,Conor Garland,R,VAN,28,82,18,37,55
29,8476792,Torey Krug,D,STL,33,82,18,37,55
29,8477955,Jared McCann,L,SEA,28,82,26,28,54
29,8475151,Kyle Palmieri,C,NYI,33,82,25,29,54
29,8482149,Cole Perfetti,C,WPG,22,82,24,30,54
29,8484144,Connor Bedard,C,CHI,19,82,24,30,54
29,8477497,Sean Monahan,C,CBJ,30,82,23,31,54
29,8476462,Dougie Hamilton,D,NJD,31,82,16,38,54
29,8474590,John Carlson,D,WSH,34,82,13,41,54
29,8479425,Filip Hronek,D,VAN,27,82,11,43,54
29,8475722,Jason Zucker,L,BUF,32,82,25,28,53
29,8476881,Tomas Hertl,C,VGK,31,82,19,34,53
29,8477494,Jonathan Drouin,L,COL,29,82,17,36,53
29,8474578,Erik Karlsson,D,PIT,34,82,15,38,53
29,8477495,Seth Jones,D,CHI,30,82,14,39,53
29,8474563,Drew Doughty,D,LAK,35,82,12,41,53
29,8477447,Shea Theodore,D,VGK,29,82,10,43,53
29,8478366,Frank Vatrano,R,ANA,30,82,29,23,52
29,8481540,Cole Caufield,R,MTL,23,82,28,24,52
29,8482699,Dylan Guenther,R,UTA,21,82,28,24,52
29,8482110,Dawson Mercer,C,NJD,23,82,26,26,52
29,8476483,Rickard Rakell,R,PIT,31,82,23,29,52
29,8475168,Matt Duchene,C,DAL,33,82,22,30,52
29,8477429,Andrew Copp,C,DET,30,82,21,31,52
29,8476448,William Karlsson,C,VGK,31,82,21,31,52
29,8482113,Anton Lundell,C,FLA,23,82,20,32,52
29,8478042,Viktor Arvidsson,R,EDM,31,82,19,33,52
29,8474150,Mikael Backlund,C,CGY,35,82,17,35,52
29,8477346,MacKenzie Weegar,D,CGY,30,82,13,39,52
29,8474565,Alex Pietrangelo,D,VGK,34,82,10,42,52
29,8483808,Andrei Kuzmenko,L,CGY,28,82,25,26,51
29,8480829,Jesperi Kotkaniemi,C,CAR,24,82,21,30,51
29,8482078,Lucas Raymond,L,DET,22,82,19,32,51
29,8481581,Thomas Harley,D,DAL,23,82,14,37,51
29,8478396,Noah Hanifin,D,VGK,27,82,11,40,51
29,8479345,Jakob Chychrun,D,WSH,26,82,7,44,51
29,8479400,Pierre-Luc Dubois,L,WSH,26,82,24,26,50
29,8482667,William Eklund,L,SJS,22,82,24,26,50
29,8480188,Fabian Zetterlund,L,SJS,25,82,23,27,50
29,8476880,Tom Wilson,R,WSH,30,82,23,27,50
29,8481618,Alex Newhook,C,MTL,23,82,21,29,50
29,8477416,Oliver Bjorkstrand,R,SEA,29,82,20,30,50
29,8476461,Sean Couturier,C,PHI,32,82,18,32,50
29,8477021,Alex Kerfoot,C,UTA,30,82,13,37,50
29,8476438,Brandon Saad,L,STL,32,82,31,18,49
29,8475810,Bryan Rust,R,PIT,32,82,29,20,49
29,8476399,Blake Coleman,C,CGY,33,82,26,23,49
29,8478047,Michael Bunting,L,PIT,29,82,24,25,49
29,8476925,Colton Sissons,C,NSH,31,82,23,26,49
29,8477451,Ryan Hartman,R,MIN,30,82,21,28,49
29,8470613,Brent Burns,D,CAR,39,82,12,37,49
29,8471724,Kris Letang,D,PIT,37,82,9,40,49
29,8480849,Barrett Hayton,C,UTA,24,82,21,27,48
29,8482105,Jake Sanderson,D,OTT,22,82,16,32,48
29,8480434,Sean Durzi,D,UTA,26,82,11,37,48
29,8476854,Hampus Lindholm,D,BOS,30,82,10,38,48
29,8477952,Robby Fabbri,C,ANA,28,82,23,24,47
29,8475793,Ryan Johansen,C,PHI,32,82,22,25,47
29,8480835,Jack Drury,C,CAR,24,82,19,28,47
29,8478542,Evan Rodrigues,C,FLA,31,82,18,29,47
29,8476539,Jonathan Marchessault,R,NSH,34,82,17,30,47
29,8476905,Chandler Stephenson,C,SEA,30,82,17,30,47
29,8478472,Mathieu Joseph,R,STL,27,82,14,33,47
29,8481533,Trevor Zegras,C,ANA,23,82,12,35,47
29,8477948,Travis Sanheim,D,PHI,28,82,12,35,47
29,8477503,Max Domi,C,TOR,29,82,11,36,47
29,8477998,Warren Foegele,L,LAK,28,82,23,23,46
29,8473986,Alex Killorn,L,ANA,35,82,22,24,46
29,8480459,Pius Suter,C,VAN,28,82,21,25,46
29,8481580,Connor McMichael,C,WSH,23,82,21,25,46
29,8479365,Trent Frederic,C,BOS,26,82,21,25,46
29,8475314,Anders Lee,L,NYI,34,82,20,26,46
29,8475726,Tyler Toffoli,C,SJS,32,82,19,27,46
29,8481596,Shane Pinto,C,OTT,24,82,19,27,46
29,8474586,Jordan Eberle,R,SEA,34,82,18,28,46
29,8480802,Ryan McLeod,C,BUF,25,82,15,31,46
29,8475791,Taylor Hall,L,CHI,33,82,15,31,46
29,8476958,Jaccob Slavin,D,CAR,30,82,11,35,46
29,8482175,JJ Peterka,R,BUF,22,82,22,23,45
29,8480009,Eeli Tolvanen,R,SEA,25,82,22,23,45
29,8475768,Jaden Schwartz,C,SEA,32,82,21,24,45
29,8471698,T.J. Oshie,R,WSH,38,82,18,27,45
29,8482705,Cole Sillinger,C,CBJ,21,82,17,28,45
29,8477426,Nicholas Paul,L,TBL,29,82,16,29,45
29,8475191,Reilly Smith,R,NYR,33,82,15,30,45
29,8477986,Brandon Montour,D,SEA,30,82,13,32,45
29,8476292,Ondrej Palat,L,NJD,33,82,12,33,45
29,8478469,Thomas Chabot,D,OTT,27,82,10,35,45
29,8476869,Brady Skjei,D,NSH,30,82,8,37,45
29,8479410,Mikhail Sergachev,D,UTA,26,82,8,37,45
29,8480064,Josh Norris,C,OTT,25,82,27,17,44
29,8477987,Ryan Donato,C,CHI,28,82,24,20,44
29,8477407,Anthony Duclair,L,NYI,29,82,22,22,44
29,8476826,Yanni Gourde,C,SEA,33,82,20,24,44
29,8475753,Justin Faulk,D,STL,32,82,10,34,44
29,8477504,Josh Morrissey,D,WPG,29,82,9,35,44
29,8481546,Cam York,D,PHI,23,82,8,36,44
29,8481542,Moritz Seider,D,DET,23,82,6,38,44
29,8479525,Ross Colton,C,COL,28,82,24,19,43
29,8475760,Nick Bjugstad,C,UTA,32,82,19,24,43
29,8480185,Eetu Luostarinen,C,FLA,26,82,12,31,43
29,8480893,Kirill Marchenko,R,CBJ,24,82,29,13,42
29,8474679,Gustav Nyquist,C,NSH,35,82,16,26,42
29,8480015,Owen Tippett,R,PHI,25,82,16,26,42
29,8480871,Adam Boqvist,D,FLA,24,82,15,27,42
29,8482671,Owen Power,D,BUF,22,82,14,28,42
29,8478519,Anthony Cirelli,C,TBL,27,82,22,19,41
29,8478474,Lawson Crouse,L,UTA,27,82,18,23,41
29,8480797,Joel Farabee,L,PHI,24,82,17,24,41
29,8476458,Ryan Strome,C,ANA,31,82,16,25,41
29,8475763,Kevin Hayes,R,PIT,32,82,13,28,41
29,8476463,Jonas Brodin,D,MIN,31,82,9,32,41
29,8482055,Drew O'Connor,L,PIT,26,82,24,16,40
29,8482740,Wyatt Johnston,C,DAL,21,82,22,18,40
29,8482720,Matthew Knies,L,TOR,22,82,15,25,40
29,8475714,Calle Jarnkrok,C,TOR,33,82,15,25,40
29,8480336,Sean Walker,D,CAR,30,82,15,25,40
29,8480028,Morgan Frost,C,PHI,25,82,12,28,40
29,8477498,Darnell Nurse,D,EDM,29,82,12,28,40
29,8476480,Vladislav Namestnikov,C,WPG,32,82,12,28,40
29,8476923,Damon Severson,D,CBJ,30,82,11,29,40
29,8481535,Nils Hoglander,L,VAN,24,82,25,14,39
29,8482159,Tyson Foerster,R,PHI,22,82,21,18,39
29,8476918,Jimmy Vesey,L,NYR,31,82,19,20,39
29,8479351,Sam Steel,C,DAL,26,82,15,24,39
29,8482745,Mason McTavish,C,ANA,21,82,14,25,39
29,8476885,Jacob Trouba,D,NYR,30,82,13,26,39
29,8475149,Marcus Johansson,L,MIN,34,82,11,28,39
29,8482475,Yegor Chinakhov,R,CBJ,23,82,9,30,39
29,8479398,Samuel Girard,D,COL,26,82,6,33,39
29,8475799,Nino Niederreiter,R,WPG,32,82,21,17,38
29,8476474,Stefan Noesen,R,NJD,31,82,19,19,38
29,8478057,Dakota Joshua,C,VAN,28,82,18,20,38
29,8480748,Kiefer Sherwood,L,VAN,29,82,15,23,38
29,8474641,Adam Henrique,C,EDM,34,82,13,25,38
29,8481656,Aliaksei Protas,C,WSH,23,82,13,25,38
29,8474189,Lars Eller,C,PIT,35,82,13,25,38
29,8477839,Conor Sheary,L,TBL,32,82,13,25,38
29,8474149,Evgenii Dadonov,R,DAL,35,82,11,27,38
29,8480873,Rasmus Sandin,D,WSH,24,82,4,34,38
29,8481554,Kaapo Kakko,R,NYR,23,82,19,18,37
29,8478046,Danton Heinen,L,VAN,29,82,17,20,37
29,8477989,Christian Dvorak,C,MTL,28,82,17,20,37
29,8477450,Jason Dickinson,C,CHI,29,82,16,21,37
29,8475171,Oliver Ekman-Larsson,D,TOR,33,82,9,28,37
29,8477932,Aaron Ekblad,D,FLA,28,82,8,29,37
29,8476979,Erik Gustafsson,D,DET,32,82,8,29,37
29,8476892,Colton Parayko,D,STL,31,82,4,33,37
29,8482125,Alexander Holtz,R,VGK,22,82,24,12,36
29,8478020,Michael Amadio,C,OTT,28,82,20,16,36
29,8473563,Nicklas Backstrom,C,WSH,37,82,17,19,36
29,8476872,Scott Laughton,C,PHI,30,82,16,20,36
29,8477947,Sonny Milano,L,WSH,28,82,16,20,36
29,8482079,Marco Rossi,C,MIN,23,82,15,21,36
29,8481606,Jordan Spence,D,LAK,23,82,8,28,36
29,8475764,Cam Fowler,D,ANA,33,82,4,32,36
29,8478507,John Marino,D,UTA,27,82,4,32,36
29,8481032,Paul Cotter,C,NJD,25,82,19,16,35
29,8480855,Jack McBain,C,UTA,24,82,16,19,35
29,8478463,Anthony Beauvillier,L,PIT,27,82,15,20,35
29,8482092,Ridly Greig,C,OTT,22,82,14,21,35
29,8479992,Michael Rasmussen,C,DET,25,82,14,21,35
29,8480220,Noah Cates,L,PHI,25,82,13,22,35
29,8482133,Thomas Bordeleau,C,SJS,22,82,13,22,35
29,8480074,Alexandre Texier,C,STL,25,82,13,22,35
29,8481522,Peyton Krebs,C,BUF,23,82,10,25,35
29,8482089,Jake Neighbours,L,STL,22,82,24,10,34
29,8481186,Logan O'Connor,R,COL,28,82,19,15,34
29,8473422,Nick Foligno,L,CHI,37,82,19,15,34
29,8482146,Luke Evangelista,R,NSH,22,82,18,16,34
29,8481553,Bobby Brink,R,PHI,23,82,17,17,34
29,8476927,Teddy Blueger,C,VAN,30,82,14,20,34
29,8476329,Travis Boyd,C,MIN,31,82,11,23,34
29,8480878,Nils Lundkvist,D,DAL,24,82,11,23,34
29,8482122,Brock Faber,D,MIN,22,82,10,24,34
29,8478508,Yakov Trenin,C,MIN,27,82,20,13,33
29,8476921,Jordan Martinook,L,CAR,32,82,16,17,33
29,8478013,Jake Walman,D,SJS,28,82,15,18,33
29,8481013,Jonatan Berggren,R,DET,24,82,14,19,33
29,8483457,Lane Hutson,D,MTL,20,82,14,19,33
29,8478891,Mason Appleton,C,WPG,28,82,11,22,33
29,8480144,David Kampf,C,TOR,29,82,10,23,33
29,8476419,Jean-Gabriel Pageau,C,NYI,32,82,9,24,33
29,8475188,Brayden McNabb,D,VGK,33,82,7,26,33
29,8475200,Dmitry Orlov,D,CAR,33,82,6,27,33
29,8480817,K'Andre Miller,D,NYR,24,82,4,29,33
29,8482074,Connor Zary,C,CGY,23,82,21,11,32
29,8478413,Jordan Greenway,L,BUF,27,82,20,12,32
29,8483431,Logan Cooley,C,UTA,20,82,18,14,32
29,8481560,Arthur Kaliyev,R,LAK,23,82,17,15,32
29,8484145,Zach Benson,L,BUF,19,82,17,15,32
29,8482111,Justin Barron,D,MTL,23,82,16,16,32
29,8479591,Michael Eyssimont,C,TBL,28,82,15,17,32
29,8475848,Brendan Gallagher,R,MTL,32,82,13,19,32
29,8476873,Mark Jankowski,C,NSH,30,82,13,19,32
29,8476960,Andreas Athanasiou,C,CHI,30,82,9,23,32
29,8478882,Vladislav Gavrikov,D,LAK,29,82,8,24,32
29,8476917,Adam Pelech,D,NYI,30,82,6,26,32
29,8480043,Timothy Liljegren,D,TOR,25,82,2,30,32
29,8477425,Miles Wood,L,COL,29,82,16,15,31
29,8483515,Juraj Slafkovsky,L,MTL,20,82,13,18,31
29,8478133,Jake Evans,C,MTL,28,82,11,20,31
29,8477488,Brett Pesce,D,NJD,30,82,11,20,31
29,8475287,Erik Haula,L,NJD,33,82,10,21,31
29,8483763,Maksymilian Szuber,D,UTA,22,82,10,21,31
29,8474716,Jared Spurgeon,D,MIN,35,82,9,22,31
29,8479998,Mikey Anderson,D,LAK,25,82,6,25,31
29,8477506,Ryan Pulock,D,NYI,30,82,5,26,31
29,8474673,TJ Brodie,D,CHI,34,82,4,27,31
29,8477931,Tomas Nosek,L,FLA,32,82,16,14,30
29,8474715,Cam Atkinson,R,TBL,35,82,14,16,30
29,8478911,Matt Roy,D,WSH,29,82,11,19,30
29,8480980,Connor Dewar,C,TOR,25,82,11,19,30
29,8476467,Jamie Oleksiak,D,SEA,32,82,11,19,30
29,8480113,Alex Iafallo,L,WPG,31,82,10,20,30
29,8482660,Kent Johnson,C,CBJ,22,82,10,20,30
29,8480068,Ryan Poehling,C,PHI,25,82,9,21,30
29,8476902,Esa Lindell,D,DAL,30,82,9,21,30
29,8481708,Zac Jones,D,NYR,24,82,6,24,30
29,8474574,Tyler Myers,D,VAN,34,82,4,26,30
29,8481704,Juuso Parssinen,C,NSH,23,82,20,9,29
29,8479393,Noah Gregor,C,OTT,26,82,17,12,29
29,8478115,Pierre Engvall,L,NYI,28,82,16,13,29
29,8476981,Josh Anderson,R,MTL,30,82,16,13,29
29,8476469,Joel Armia,R,MTL,31,82,14,15,29
29,8482117,Lukas Reichel,L,CHI,22,82,13,16,29
29,8478109,Victor Olofsson,L,VGK,29,82,12,17,29
29,8482624,Daniil Miromanov,D,CGY,27,82,12,17,29
29,8480789,Oliver Wahlstrom,R,NYI,24,82,12,17,29
29,8473533,Jordan Staal,C,CAR,36,82,11,18,29
29,8479390,Taylor Raddysh,R,WSH,26,82,10,19,29
29,8481624,Ilya Mikheyev,R,CHI,30,82,10,19,29
29,8480145,Neal Pionk,D,WPG,29,82,7,22,29
29,8475218,Mattias Ekholm,D,EDM,34,82,7,22,29
29,8477220,Nate Schmidt,D,FLA,33,82,5,24,29
29,8478500,Ivan Provorov,D,CBJ,27,82,5,24,29
29,8479402,Jake Bean,D,CGY,26,82,5,24,29
29,8476931,Jake McCabe,D,TOR,31,82,4,25,29
29,8477969,Marcus Pettersson,D,PIT,28,82,3,26,29
29,8474151,Ryan McDonagh,D,TBL,35,82,3,26,29
29,8480073,Erik Brannstrom,D,COL,25,82,3,26,29
29,8481481,Blake Lizotte,C,PIT,27,82,17,11,28
29,8475193,Tomas Tatar,L,NJD,34,82,15,13,28
29,8476891,Matt Grzelcyk,D,PIT,30,82,7,21,28
29,8481568,Alex Vlasic,D,CHI,23,82,6,22,28
29,8482655,J.J. Moser,D,TBL,24,82,6,22,28
29,8477903,Garnet Hathaway,R,PHI,33,82,16,11,27
29,8476278,Colin Blackwell,C,DAL,31,82,16,11,27
29,8479941,Justin Danforth,R,CBJ,31,82,14,13,27
29,8484153,Leo Carlsson,C,ANA,20,82,10,17,27
29,8477953,Kasperi Kapanen,R,STL,28,82,9,18,27
29,8479359,Beck Malenstyn,L,BUF,26,82,9,18,27
29,8483490,Pavel Mintyukov,D,ANA,21,82,6,21,27
29,8475231,Casey Cizikas,C,NYI,33,82,15,11,26
29,8479368,Max Jones,L,BOS,26,82,15,11,26
29,8482155,Alex Laferriere,R,LAK,23,82,13,13,26
29,8478432,Christian Fischer,R,DET,27,82,13,13,26
29,8483493,Frank Nazar,C,CHI,20,82,13,13,26
29,8479316,Luke Kunin,C,SJS,27,82,10,16,26
29,8481582,Nicholas Robertson,L,TOR,23,82,10,16,26
29,8475220,Marcus Foligno,L,MIN,33,82,8,18,26
29,8482809,Jackson Blake,R,CAR,21,82,8,18,26
29,8476312,Josh Manson,D,COL,33,82,4,22,26
29,8475279,Ben Chiarot,D,DET,33,82,4,22,26
29,8479293,Brandon Tanev,L,SEA,33,82,16,9,25
29,8481517,Brett Leason,R,ANA,25,82,16,9,25
29,8476878,Zemgus Girgensons,L,TBL,30,82,14,11,25
29,8484166,Adam Fantilli,C,CBJ,20,82,13,12,25
29,8475343,Nic Dowd,C,WSH,34,82,11,14,25
29,8476889,Radek Faksa,C,STL,30,82,11,14,25
29,8475855,Jesper Fast,R,CAR,33,82,10,15,25
29,8482803,Olen Zellweger,D,ANA,21,82,8,17,25
29,8478569,Noel Acciari,C,PIT,33,82,7,18,25
29,8473507,Jeff Petry,D,DET,37,82,7,18,25
29,8475181,Nick Leddy,D,STL,33,82,4,21,25
29,8478178,Darren Raddysh,D,TBL,28,82,4,21,25
29,8479324,Ryan Lindgren,D,NYR,26,82,3,22,25
29,8478840,Will Borgen,D,SEA,28,82,2,23,25
29,8482087,Kaiden Guhle,D,MTL,22,82,2,23,25
29,8481604,Pavel Dorofeyev,L,VGK,24,82,13,11,24
29,8479996,Cody Glass,C,NSH,25,82,13,11,24
29,8477919,Frederick Gaudreau,C,MIN,31,82,13,11,24
29,8478462,Nicolas Roy,C,VGK,27,82,12,12,24
29,8477353,Tyler Motte,C,DET,29,82,12,12,24
29,8480813,Joe Veleno,C,DET,24,82,12,12,24
29,8483482,Tristan Luneau,D,ANA,20,82,12,12,24
29,8480003,Jesper Boqvist,C,FLA,26,82,10,14,24
29,8477507,Nikita Zadorov,D,BOS,29,82,9,15,24
29,8482062,Cole Smith,L,NSH,29,82,9,15,24
29,8481641,Joel Kiviranta,L,COL,28,82,9,15,24
29,8479291,Kevin Rooney,C,CGY,31,82,8,16,24
29,8482858,Ryker Evans,D,SEA,23,82,8,16,24
29,8470621,Corey Perry,R,EDM,39,82,7,17,24
29,8482073,Braden Schneider,D,NYR,23,82,6,18,24
29,8476331,Dylan DeMelo,D,WPG,31,82,3,21,24
29,8478859,Niko Mikkola,D,FLA,28,82,3,21,24
29,8482077,Dylan Holloway,L,EDM,23,82,15,8,23
29,8479353,Brett Howden,C,VGK,26,82,14,9,23
29,8476897,Oskar Sundqvist,C,STL,30,82,11,12,23
29,8484203,Bradly Nadeau,L,CAR,19,82,11,12,23
29,8476858,Phillip Di Giuseppe,L,VAN,31,82,10,13,23
29,8482807,Ethan Del Mastro,D,CHI,21,82,10,13,23
29,8476374,Sean Kuraly,C,CBJ,31,82,9,14,23
29,8479976,Juuso Valimaki,D,UTA,26,82,9,14,23
29,8480448,Parker Kelly,L,COL,25,82,9,14,23
29,8482166,Shakir Mukhamadullin,D,SJS,22,82,8,15,23
29,8482666,Scott Morrow,D,CAR,22,82,8,15,23
29,8476624,Barclay Goodrow,C,SJS,31,82,8,15,23
29,8476392,Adam Lowry,C,WPG,31,82,6,17,23
29,8479371,Dante Fabbro,D,NSH,26,82,4,19,23
29,8475790,Erik Gudbranson,D,CBJ,32,82,4,19,23
29,8475455,Brenden Dillon,D,NJD,34,82,3,20,23
29,8481093,Rafael Harvey-Pinard,L,MTL,25,82,15,7,22
29,8475842,Sam Carrick,C,NYR,32,82,13,9,22
29,8478211,Dryden Hunt,L,CGY,29,82,13,9,22
29,8483495,Simon Nemec,D,NJD,20,82,11,11,22
29,8477505,Alexander Wennberg,C,SJS,30,82,8,14,22
29,8480049,Dylan Samberg,D,WPG,25,82,7,15,22
29,8482153,Brendan Brisson,C,VGK,23,82,7,15,22
29,8476457,Adam Larsson,D,SEA,32,82,6,16,22
29,8476879,Cody Ceci,D,EDM,31,82,5,17,22
29,8482142,Jamie Drysdale,D,PHI,22,82,4,18,22
29,8475762,Derek Forbort,D,VAN,32,82,4,18,22
29,8480035,Henri Jokiharju,D,BUF,25,82,3,19,22
29,8475324,Nick Jensen,D,OTT,34,82,3,19,22
29,8482245,Artem Zub,D,OTT,29,82,2,20,22
29,8481178,Egor Zamula,D,PHI,24,82,2,20,22
29,8478136,Jake Middleton,D,MIN,28,82,1,21,22
29,8481477,Nico Sturm,C,SJS,29,82,11,10,21
29,8481028,Martin Pospisil,C,CGY,25,82,11,10,21
29,8477508,Curtis Lazar,C,NJD,29,82,10,11,21
29,8483505,Matthew Poitras,C,BOS,20,82,9,12,21
29,8482702,Logan Stankoven,C,DAL,21,82,9,12,21
29,8480806,Isac Lundestrom,C,ANA,25,82,8,13,21
29,8477435,Ryan Graves,D,PIT,29,82,7,14,21
29,8481524,Bowen Byram,D,BUF,23,82,7,14,21
29,8474013,Ian Cole,D,UTA,35,82,5,16,21
29,8481567,Henry Thrun,D,SJS,23,82,4,17,21
29,8479661,Tanner Jeannot,L,LAK,27,82,11,9,20
29,8480021,Jack Studnicka,C,LAK,25,82,9,11,20
29,8479414,Nathan Bastian,R,NJD,27,82,9,11,20
29,8480995,Pontus Holmberg,R,TOR,25,82,7,13,20
29,8483499,Liam Ohgren,L,MIN,20,82,6,14,20
29,8476422,Mike Reilly,D,NYI,31,82,5,15,20
29,8475233,David Savard,D,MTL,34,82,5,15,20
29,8478399,Jonas Siegenthaler,D,NJD,27,82,4,16,20
29,8480222,Sebastian Aho,D,PIT,28,82,4,16,20
29,8479369,Andrew Peeke,D,BOS,26,82,4,16,20
29,8475690,Chris Tanev,D,TOR,35,82,3,17,20
29,8481014,Alexander Romanov,D,NYI,24,82,2,18,20
29,8480807,Mattias Samuelsson,D,BUF,24,82,2,18,20
29,8476822,Luke Glendening,C,TBL,35,82,14,5,19
29,8477015,Connor Brown,R,EDM,30,82,9,10,19
29,8476442,Matt Nieto,L,PIT,32,82,9,10,19
29,8473453,Trevor Lewis,C,LAK,37,82,8,11,19
29,8477369,Carson Soucy,D,VAN,30,82,6,13,19
29,8480950,Ilya Lyubushkin,D,DAL,30,82,6,13,19
29,8478443,Brandon Carlo,D,BOS,28,82,3,16,19
29,8474090,Brendan Smith,D,DAL,35,82,3,16,19
29,8480172,Jan Rutta,D,SJS,34,82,2,17,19
29,8477845,Trevor van Riemsdyk,D,WSH,33,82,2,17,19
29,8483397,Marc McLaughlin,C,BOS,25,82,13,5,18
29,8480281,Alexey Toropchenko,R,STL,25,82,11,7,18
29,8482762,Simon Edvinsson,D,DET,21,82,10,8,18
29,8476372,Nick Seeler,D,PHI,31,82,8,10,18
29,8478434,Keegan Kolesar,R,VGK,27,82,7,11,18
29,8483466,Kevin Korchinski,D,CHI,20,82,7,11,18
29,8478874,Adam Gaudette,C,OTT,28,82,5,13,18
29,8476429,Scott Mayfield,D,NYI,32,82,4,14,18
29,8477034,Jaycob Megna,D,FLA,32,82,4,14,18
29,8477365,Connor Clifton,D,BUF,29,82,3,15,18
29,8478450,Parker Wotherspoon,D,BOS,27,82,2,16,18
29,8479980,Nicolas Hague,D,VGK,26,82,1,17,18
29,8479638,Justin Brazeau,R,BOS,26,82,14,3,17
29,8484149,Gavin Brindley,C,CBJ,20,82,9,8,17
29,8482713,Mackie Samoskevich,R,FLA,22,82,9,8,17
29,8480025,MacKenzie Entwistle,R,FLA,25,82,8,9,17
29,8483524,Shane Wright,C,SEA,20,82,8,9,17
29,8480870,Bo Groulx,C,NYR,24,82,8,9,17
29,8477392,Hudson Fasching,R,NYI,29,82,7,10,17
29,8482470,Ilya Solovyov,D,CGY,24,82,7,10,17
29,8482733,Logan Mailloux,D,MTL,31,82,7,10,17
29,8484911,Collin Graf,R,SJS,22,82,6,11,17
29,8482679,Matt Coronato,R,CGY,22,82,5,12,17
29,8470600,Ryan Suter,D,STL,39,82,2,15,17
29,8475718,Justin Holl,D,DET,32,82,2,15,17
29,8482259,Bobby McMann,C,TOR,28,82,11,5,16
29,8481601,Simon Holmstrom,R,NYI,23,82,7,9,16
29,8482659,Josh Doan,R,UTA,22,82,7,9,16
29,8482070,Mitchell Chaffee,R,TBL,26,82,6,10,16
29,8478851,Alexandre Carrier,D,NSH,28,82,5,11,16
29,8483567,Georgii Merkulov,C,BOS,24,82,5,11,16
29,8479983,Mario Ferraro,D,SJS,26,82,4,12,16
29,8483565,Nick Blankenburg,D,NSH,26,82,3,13,16
29,8478416,Erik Cernak,D,TBL,27,82,2,14,16
29,8480879,Jacob Bernard-Docker,D,OTT,24,82,2,14,16
29,8482749,Joshua Roy,R,MTL,21,82,7,8,15
29,8482141,Lukas Cormier,D,VGK,22,82,7,8,15
29,8480990,Declan Chisholm,D,MIN,24,82,6,9,15
29,8477406,Mattias Janmark,C,EDM,32,82,5,10,15
29,8483445,Cutter Gauthier,L,ANA,20,82,5,10,15
29,8477335,Kyle Burroughs,D,LAK,29,82,1,14,15
29,8483460,David Jiricek,D,CBJ,21,82,6,8,14
29,8482118,Sam Colangelo,R,ANA,23,82,6,8,14
29,8474612,Travis Hamonic,D,OTT,34,82,5,9,14
29,8483012,Logan Morrison,C,SEA,22,82,5,9,14
29,8476967,Brett Kulak,D,EDM,30,82,0,14,14
29,8482859,Zack Ostapchuk,C,OTT,21,82,8,5,13
29,8480834,Ty Emberson,D,SJS,24,82,4,9,13
29,8481122,Simon Benoit,D,TOR,26,82,4,9,13
29,8476525,Colin Miller,D,WPG,32,82,2,11,13
29,8477938,Haydn Fleury,D,WPG,28,82,2,11,13
29,8476441,Joel Edmundson,D,LAK,31,82,2,11,13
29,8477499,Rasmus Ristolainen,D,PHI,30,82,1,12,13
29,8475462,Radko Gudas,D,ANA,34,82,1,12,13
29,8478468,Jeremy Lauzon,D,NSH,27,82,4,8,12
29,8482145,Mavrik Bourque,C,DAL,22,82,4,8,12
29,8474567,Zach Bogosian,D,MIN,34,82,4,8,12
29,8481605,Jackson LaCombe,D,ANA,23,82,3,9,12
29,8479442,Troy Stecher,D,EDM,30,82,3,9,12
29,8480246,Nick Perbix,D,TBL,26,82,2,10,12
29,8475177,Calvin de Haan,D,COL,33,82,6,5,11
29,8481699,Aku Raty,R,UTA,23,82,6,5,11
29,8482712,Oskar Olausson,R,COL,22,82,3,8,11
29,8479576,Vincent Desharnais,D,VAN,28,82,2,9,11
29,8482101,Danil Gushchin,L,SJS,22,82,9,1,10
29,8483468,Jiri Kulich,C,BUF,20,82,6,4,10
29,8480860,Kevin Bahl,D,CGY,24,82,3,7,10
29,8482516,Matthew Kessel,D,STL,24,82,3,6,9
29,8476473,Connor Murphy,D,CHI,31,82,2,7,9
29,8474062,Riley Nash,C,NYR,35,82,2,7,9
29,8480796,Martin Fehervary,D,WSH,25,82,3,5,8
29,8483471,Brad Lambert,C,WPG,31,82,3,5,8
29,8482787,Nikita Chibrikov,R,WPG,31,82,3,5,8
29,8483489,Fraser Minten,C,TOR,31,82,3,5,8
29,8471677,Jack Johnson,D,CBJ,37,82,0,8,8
29,8470794,Joe Pavelski,C,,40,0,0,0,0
29,8481703,Valtteri Puustinen,R,PIT,25,0,0,0,0
29,8477950,Tony DeAngelo,D,,29,0,0,0,0
29,8481577,Philip Tomasino,C,NSH,23,0,0,0,0
29,8475197,Tyson Barrie,D,,33,0,0,0,0
29,8471218,Blake Wheeler,R,,38,0,0,0,0
29,8474157,Max Pacioretty,L,,36,0,0,0,0
29,8478466,Daniel Sprong,R,VAN,27,0,0,0,0
29,8475744,Evgeny Kuznetsov,C,,32,0,0,0,0
29,8481019,David Gustafsson,C,WPG,24,0,0,0,0
29,8475906,John Klingberg,D,,32,0,0,0,0
29,8479348,Kale Clague,D,BUF,26,0,0,0,0
29,8476952,Dominic Toninato,C,WPG,30,0,0,0,0
29,8473473,Milan Lucic,L,,36,0,0,0,0
29,8474037,James van Riemsdyk,L,,35,0,0,0,0
29,8474602,Justin Schultz,D,,34,0,0,0,0
29,8482222,Alexander Barabanov,L,,30,0,0,0,0
29,8479372,Josh Mahura,D,SEA,26,0,0,0,0
29,8479982,Conor Timmins,D,TOR,26,0,0,0,0
29,8474031,Kevin Shattenkirk,D,,35,0,0,0,0
29,8480008,Adam Ruzicka,C,,25,0,0,0,0
29,8481059,Scott Perunovich,D,STL,26,0,0,0,0
29,8480884,Calen Addison,D,,24,0,0,0,0
29,8476994,Vinnie Hinostroza,C,NSH,30,0,0,0,0
29,8478452,Caleb Jones,D,LAK,27,0,0,0,0
29,8480157,Calle Rosen,D,COL,30,0,0,0,0
29,8481609,Vladislav Kolyachonok,D,UTA,23,0,0,0,0
29,8479415,Michael McLeod,C,,26,0,0,0,0
29,8476919,Chris Tierney,C,,30,0,0,0,0
29,8479639,Dylan Coghlan,D,WPG,26,0,0,0,0
29,8478146,Matthew Highmore,C,OTT,28,0,0,0,0
29,8478970,Jalen Chatfield,D,CAR,28,0,0,0,0
29,8480205,Emil Bemstrom,C,PIT,25,0,0,0,0
29,8474884,Mike Hoffman,C,,35,0,0,0,0
29,8471274,Alex Goligoski,D,,39,0,0,0,0
29,8478104,Sammy Blais,L,,28,0,0,0,0
29,8474870,Tyler Johnson,C,,34,0,0,0,0
29,8476913,Devin Shore,C,MIN,30,0,0,0,0
29,8481598,Philip Broberg,D,EDM,23,0,0,0,0
29,8480058,Pierre-Olivier Joseph,D,STL,25,0,0,0,0
29,8480891,Michael Kesselring,D,UTA,24,0,0,0,0
29,8477979,Nicolas Aube-Kubel,R,BUF,28,0,0,0,0
29,8476871,Tanner Pearson,L,,32,0,0,0,0
29,8476393,Nick Cousins,C,,31,0,0,0,0
29,8479977,Kailer Yamamoto,R,,26,0,0,0,0
29,8479543,Michael Pezzetta,L,MTL,26,0,0,0,0
29,8477018,Ben Hutton,D,VGK,31,0,0,0,0
29,8480762,Eric Robinson,L,CAR,29,0,0,0,0
29,8474034,Pat Maroon,L,CHI,36,0,0,0,0
29,8481058,Jesse Ylönen,R,,25,0,0,0,0
29,8475179,Dmitry Kulikov,D,FLA,34,0,0,0,0
29,8481527,Kaedan Korczak,D,VGK,23,0,0,0,0
29,8473449,Kyle Okposo,R,,36,0,0,0,0
29,8482192,Isaak Phillips,D,CHI,23,0,0,0,0
29,8480727,Zach Whitecloud,D,VGK,28,0,0,0,0
29,8479346,Dillon Dube,C,,26,0,0,0,0
29,8480821,Filip Zadina,R,,25,0,0,0,0
29,8480001,Urho Vaakanainen,D,ANA,25,0,0,0,0
29,8470966,Mark Giordano,D,,41,0,0,0,0
29,8480853,Liam Foudy,C,,24,0,0,0,0
29,8475225,Craig Smith,C,CHI,35,0,0,0,0
29,8479972,Mason Shaw,C,WPG,26,0,0,0,0
29,8478451,Ethan Bear,D,WSH,27,0,0,0,0
29,8474040,Sam Gagner,C,,35,0,0,0,0
29,8480196,Jacob Bryson,D,BUF,27,0,0,0,0
29,8479984,Cal Foote,D,,26,0,0,0,0
29,8480011,Klim Kostin,C,SJS,25,0,0,0,0
29,8482176,Wyatt Kaiser,D,CHI,22,0,0,0,0
29,8476988,Matt Benning,D,SJS,30,0,0,0,0
29,8479370,Tyson Jost,C,CAR,26,0,0,0,0
29,8477464,Nic Petan,C,,29,0,0,0,0
29,8477380,Jonny Brodzinski,C,NYR,31,0,0,0,0
29,8480070,Ian Mitchell,D,BOS,25,0,0,0,0
29,8479315,Joey Anderson,R,CHI,26,0,0,0,0
29,8478099,Kevin Labanc,R,,29,0,0,0,0
29,8476874,Olli Maatta,D,DET,30,0,0,0,0
29,8475208,Brian Dumoulin,D,ANA,33,0,0,0,0
29,8478430,Oliver Kylington,D,,27,0,0,0,0
29,8479536,Axel Jonsson-Fjallby,L,WPG,26,0,0,0,0
29,8479671,Mathieu Olivier,R,CBJ,27,0,0,0,0
29,8471709,Marc-Edouard Vlasic,D,SJS,37,0,0,0,0
29,8479328,Julien Gauthier,R,NYI,27,0,0,0,0
29,8478421,A.J. Greer,L,FLA,28,0,0,0,0
29,8477573,Nathan Walker,L,STL,30,0,0,0,0
29,8481537,Nikita Okhotiuk,D,CGY,24,0,0,0,0
29,8474166,Alec Martinez,D,CHI,37,0,0,0,0
29,8470610,Zach Parise,L,,40,0,0,0,0
29,8477478,William Carrier,L,CAR,30,0,0,0,0
29,8479344,Jesse Puljujarvi,R,PIT,26,0,0,0,0
29,8480887,Jordan Harris,D,MTL,24,0,0,0,0
29,8478502,Dennis Gilbert,D,BUF,28,0,0,0,0
29,8482730,Brandt Clarke,D,LAK,21,0,0,0,0
29,8480355,Mark Kastelic,C,BOS,25,0,0,0,0
29,8475750,Jon Merrill,D,MIN,32,0,0,0,0
29,8475164,Jakob Silfverberg,R,,34,0,0,0,0
29,8477944,Jakub Vrana,L,,28,0,0,0,0
29,8479439,Jacob MacDonald,D,COL,31,0,0,0,0
29,8474568,Luke Schenn,D,NSH,35,0,0,0,0
29,8478454,Noah Juulsen,D,VAN,27,0,0,0,0
29,8475752,Tyler Pitlick,C,,33,0,0,0,0
29,8482148,Hendrix Lapierre,C,WSH,22,0,0,0,0
29,8481167,Brayden Pachal,D,CGY,25,0,0,0,0
29,8478043,Sam Lafferty,C,BUF,29,0,0,0,0
29,8479321,Lucas Johansen,D,,27,0,0,0,0
29,8471699,Andrew Cogliano,C,,37,0,0,0,0
29,8481521,Ronnie Attard,D,PHI,25,0,0,0,0
29,8481161,Jake Christiansen,D,CBJ,25,0,0,0,0
29,8479458,Nikita Zaitsev,D,,33,0,0,0,0
29,8479619,Michael Carcone,L,UTA,28,0,0,0,0
29,8479026,Philippe Myers,D,TOR,27,0,0,0,0
29,8477330,Dominik Kubalik,L,,29,0,0,0,0
29,8481617,Vasily Podkolzin,R,VAN,23,0,0,0,0
29,8481701,Santeri Hatakka,D,NJD,23,0,0,0,0
29,8479514,Rem Pitlick,C,,27,0,0,0,0
29,8477446,Michael McCarron,R,NSH,29,0,0,0,0
29,8470604,Jeff Carter,C,,39,0,0,0,0
29,8482241,Radim Zohorna,L,,28,0,0,0,0
29,8480289,Morgan Barron,C,WPG,26,0,0,0,0
29,8479379,Givani Smith,R,SJS,26,0,0,0,0
29,8480216,Jacob Peterson,C,,25,0,0,0,0
29,8477851,Jordan Oesterle,D,BOS,32,0,0,0,0
29,8484258,Sam Malinski,D,COL,26,0,0,0,0
29,8478904,Steven Lorentz,C,,28,0,0,0,0
29,8482095,Tyler Kleven,D,OTT,22,0,0,0,0
29,8480848,Ty Dellandrea,C,SJS,24,0,0,0,0
29,8476884,Derrick Pouliot,D,,30,0,0,0,0
29,8479336,Carl Grundstrom,R,SJS,27,0,0,0,0
29,8482964,Arber Xhekaj,D,MTL,23,0,0,0,0
29,8471686,Marc Staal,D,,37,0,0,0,0
29,8477887,Patrick Brown,C,BOS,32,0,0,0,0
29,8478495,Denis Gurianov,R,,27,0,0,0,0
29,8473504,Cal Clutterbuck,R,,37,0,0,0,0
29,8481550,Adam Beckman,L,NJD,23,0,0,0,0
29,8480845,Rasmus Kupari,C,WPG,24,0,0,0,0
29,8474009,Nick Bonino,C,,36,0,0,0,0
29,8478585,Derek Ryan,C,EDM,38,0,0,0,0
29,8477962,Brendan Lemieux,L,CAR,28,0,0,0,0
29,8482861,Vincent Iorio,D,WSH,22,0,0,0,0
29,8479378,Logan Stanley,D,WPG,26,0,0,0,0
29,8473446,Erik Johnson,D,PHI,36,0,0,0,0
29,8481743,Marc Del Gaizo,D,NSH,25,0,0,0,0
29,8477384,Josh Brown,D,EDM,30,0,0,0,0
29,8482165,Yan Kuznetsov,D,CGY,22,0,0,0,0
29,8478424,Jansen Harkins,C,ANA,27,0,0,0,0
29,8482144,Jack Thompson,D,SJS,22,0,0,0,0
29,8478512,Austin Czarnik,C,,32,0,0,0,0
29,8477527,Ross Johnston,L,ANA,30,0,0,0,0
29,8479383,Boris Katchouk,L,,26,0,0,0,0
29,8482094,Daemon Hunt,D,MIN,22,0,0,0,0
29,8481719,Maxwell Crozier,D,TBL,24,0,0,0,0
29,8480192,Johnathan Kovacevic,D,NJD,27,0,0,0,0
29,8479376,Victor Mete,D,,26,0,0,0,0
29,8482511,Mason Lohrei,D,BOS,23,0,0,0,0
29,8475825,Jani Hakanpää,D,,32,0,0,0,0
29,8478021,William Lagesson,D,DET,28,0,0,0,0
29,8475795,Dylan McIlrath,D,WSH,32,0,0,0,0
29,8477846,Ryan Carpenter,C,,33,0,0,0,0
29,8481056,Spencer Stastney,D,NSH,24,0,0,0,0
29,8481564,Ryan Johnson,D,BUF,23,0,0,0,0
29,8478017,Mark Friedman,D,VAN,29,0,0,0,0
29,8479320,Max Lajoie,D,SEA,27,0,0,0,0
29,8480075,Cameron Crotty,D,MIN,25,0,0,0,0
29,8484287,Cole McWard,D,VAN,23,0,0,0,0
29,8484254,Akito Hirose,D,VAN,25,0,0,0,0
29,8483407,Brandon Scanlin,D,NYR,25,0,0,0,0
29,8480274,Philip Kemp,D,EDM,25,0,0,0,0
29,8479522,Hardy Haman Aktell,D,WSH,26,0,0,0,0
29,8480007,Jonas Rondbjerg,R,VGK,25,0,0,0,0
29,8477454,Adam Erne,L,,29,0,0,0,0
29,8481679,Maxence Guenette,D,OTT,23,0,0,0,0
29,8480441,Trey Fix-Wolansky,R,CBJ,25,0,0,0,0
29,8483546,Marshall Rifai,D,TOR,26,0,0,0,0
29,8480084,Nick DeSimone,D,NJD,30,0,0,0,0
29,8481030,Jack St. Ivany,D,PIT,25,0,0,0,0
29,8481592,Jakob Pelletier,L,CGY,23,0,0,0,0
29,8478011,Louie Belpedio,D,PHI,28,0,0,0,0
29,8477930,Pierre-Edouard Bellemare,L,,39,0,0,0,0
29,8484321,Nikolas Matinpalo,D,OTT,26,0,0,0,0
29,8482067,Connor Mackey,D,NYR,28,0,0,0,0
29,8481806,Louis Crevier,D,CHI,23,0,0,0,0
29,8484326,Patrik Koch,D,UTA,28,0,0,0,0
29,8477971,Andreas Englund,D,LAK,28,0,0,0,0
29,8481751,Lukas Rousek,R,BUF,25,0,0,0,0
29,8481006,Tyler Tucker,D,STL,24,0,0,0,0
29,8476867,Brendan Gaunce,C,MIN,30,0,0,0,0
29,8479520,Brandon Duhaime,R,WSH,27,0,0,0,0
29,8477073,Kurtis MacDermid,L,NJD,30,0,0,0,0
29,8480874,Adam Ginning,D,PHI,24,0,0,0,0
29,8477473,Justin Bailey,R,SJS,29,0,0,0,0
29,8479066,Ryan Lomberg,L,CGY,30,0,0,0,0
29,8477070,Liam O'Brien,C,UTA,30,0,0,0,0
29,8474618,Marco Scandella,D,,34,0,0,0,0
29,8475797,Jarred Tinordi,D,,32,0,0,0,0
29,8481441,Joe Snively,C,DET,28,0,0,0,0
29,8477244,Chad Ruhwedel,D,NYR,34,0,0,0,0
29,8479772,Zack MacEwen,R,OTT,28,0,0,0,0
29,8481147,Reese Johnson,C,MIN,26,0,0,0,0
29,8481043,Cole Koepke,L,BOS,26,0,0,0,0
29,8483619,Filip Roos,D,OTT,25,0,0,0,0
29,8481541,Samuel Bolduc,D,NYI,24,0,0,0,0
29,8477810,Joel Hanley,D,CGY,33,0,0,0,0
29,8476907,Mackenzie MacEachern,L,,30,0,0,0,0
29,8482652,Walker Duehr,R,CGY,27,0,0,0,0
29,8477126,Jayson Megna,C,,34,0,0,0,0
29,8483398,Declan Carlile,D,TBL,31,0,0,0,0
29,8482929,Emil Lilleberg,D,TBL,23,0,0,0,0
29,8480880,Jakub Lauko,C,MIN,24,0,0,0,0
29,8480245,Olle Lycksell,R,PHI,25,0,0,0,0
29,8480252,Cole Guttman,C,CHI,25,0,0,0,0
29,8477467,Gustav Olofsson,D,SEA,30,0,0,0,0
29,8479968,Vinni Lettieri,C,BOS,29,0,0,0,0
29,8478400,Colin White,C,,27,0,0,0,0
29,8475755,Alexander Petrovic,D,DAL,32,0,0,0,0
29,8481812,Nikolai Knyzhov,D,,27,0,0,0,0
29,8481593,Jayden Struble,D,MTL,23,0,0,0,0
29,8481532,Alex Turcotte,C,LAK,23,0,0,0,0
29,8482126,Emil Andrae,D,PHI,31,0,0,0,0
29,8479944,Zach Aston-Reese,C,VGK,30,0,0,0,0
29,8471817,Ryan Reaves,R,TOR,37,0,0,0,0
29,8481206,John Ludvig,D,PIT,24,0,0,0,0
29,8481599,Victor Soderstrom,D,UTA,23,0,0,0,0
29,8480292,Carson Meyer,R,ANA,27,0,0,0,0
29,8482496,Nils Aman,C,VAN,24,0,0,0,0
29,8479718,Alex Barré-Boulet,C,MTL,27,0,0,0,0
29,8479994,Jaret Anderson-Dolan,C,WPG,25,0,0,0,0
29,8480184,Gustav Lindstrom,D,,26,0,0,0,0
29,8480890,Jan Jenik,R,OTT,24,0,0,0,0
29,8478067,Oskar Lindblom,L,,28,0,0,0,0
29,8476934,Brock McGinn,L,ANA,30,0,0,0,0
29,8479985,Cale Fleury,D,SEA,26,0,0,0,0
29,8484304,Uvis Balinskis,D,FLA,28,0,0,0,0
29,8479981,Jonah Gadjovich,L,FLA,26,0,0,0,0
29,8481716,Dmitri Voronkov,L,CBJ,24,0,0,0,0
29,8474709,Matt Martin,L,,35,0,0,0,0
29,8482634,Alex Steeves,C,TOR,25,0,0,0,0
29,8480823,Alexander Alexeyev,D,WSH,25,0,0,0,0
29,8477541,Dakota Mermis,D,TOR,30,0,0,0,0
29,8483491,Ivan Miroshnichenko,L,WSH,20,0,0,0,0
29,8478477,Mitchell Stephens,C,SEA,27,0,0,0,0
29,8481543,Nikita Alexandrov,C,STL,24,0,0,0,0
29,8479423,Alex Nylander,L,,26,0,0,0,0
29,8482451,Mikael Pyyhtia,L,CBJ,23,0,0,0,0
29,8478831,Kevin Stenlund,C,UTA,28,0,0,0,0
29,8480306,Grant Hutton,D,NYI,29,0,0,0,0
29,8478028,Fredrik Olofsson,L,,28,0,0,0,0
29,8477462,Robert Hagg,D,VGK,29,0,0,0,0
29,8477320,Anton Blidh,L,NYR,29,0,0,0,0
29,8482157,Will Cuylle,L,NYR,22,0,0,0,0
29,8482737,Zack Bolduc,C,STL,21,0,0,0,0
29,8481239,Samuel Fagemo,L,,24,0,0,0,0
29,8481600,Tobias Bjornfot,D,FLA,23,0,0,0,0
29,8478409,Anthony Richard,C,PHI,28,0,0,0,0
29,8474145,Robert Bortuzzo,D,,35,0,0,0,0
29,8475958,Michael Sgarbossa,C,WSH,32,0,0,0,0
29,8479986,Kole Lind,R,DAL,26,0,0,0,0
29,8479249,Andrew Poturalski,C,SJS,30,0,0,0,0
29,8479362,Riley Tufte,L,BOS,26,0,0,0,0
29,8479991,Jake Leschyshyn,C,NYR,25,0,0,0,0
29,8479587,Rhett Gardner,C,PHI,28,0,0,0,0
29,8482744,James Malatesta,L,CBJ,21,0,0,0,0
29,8478854,Ryan Shea,D,PIT,27,0,0,0,0
29,8481591,Sam Poulin,R,,23,0,0,0,0
29,8483512,Matt Savoie,C,EDM,20,0,0,0,0
29,8482102,Vasily Ponomarev,C,PIT,22,0,0,0,0
29,8482162,Roby Jarventie,L,EDM,22,0,0,0,0
29,8481016,Ruslan Iskhakov,C,,24,0,0,0,0
29,8482172,Landon Slaggert,L,CHI,22,0,0,0,0
29,8482747,Brennan Othmann,L,NYR,21,0,0,0,0
29,8480031,Maxime Comtois,L,,25,0,0,0,0
29,8480226,Marián Studenic,R,,26,0,0,0,0
29,8478408,Travis Dermott,D,,28,0,0,0,0
29,8481518,Nolan Foote,L,NJD,24,0,0,0,0
29,8479419,Brett Murray,L,BUF,26,0,0,0,0
29,8482088,Justin Sourdif,R,FLA,22,0,0,0,0
29,8482201,Gage Goncalves,C,TBL,23,0,0,0,0
29,8481578,Graeme Clarke,R,MIN,23,0,0,0,0
29,8482177,Marat Khusnutdinov,C,MIN,22,0,0,0,0
29,8481754,Nikita Nesterenko,C,ANA,23,0,0,0,0
29,8483531,Brian Halonen,L,NJD,25,0,0,0,0
29,8483920,Pierrick Dube,R,WSH,23,0,0,0,0
29,8480851,Akil Thomas,C,LAK,24,0,0,0,0
29,8475235,Nicolas Deslauriers,L,PHI,33,0,0,0,0
29,8482476,Emil Heineman,L,MTL,23,0,0,0,0
29,8477149,Scott Sabourin,R,SJS,32,0,0,0,0
29,8483549,Lucas Condotta,L,MTL,27,0,0,0,0
29,8482765,Isak Rosen,R,BUF,21,0,0,0,0
29,8481237,Kyle MacLean,C,NYI,25,0,0,0,0
29,8481024,Linus Karlsson,C,VAN,25,0,0,0,0
29,8481690,Tyler Angle,C,,24,0,0,0,0
29,8483570,Ben Meyers,C,SEA,26,0,0,0,0
29,8481655,Cole Schwindt,R,CGY,23,0,0,0,0
29,8481462,Mason Morelli,L,VGK,28,0,0,0,0
29,8483401,Marc Johnstone,R,PIT,28,0,0,0,0
29,8478956,Samuel Laberge,L,NJD,27,0,0,0,0
29,8479533,Joona Koppanen,L,,26,0,0,0,0
29,8482197,Adam Raska,R,MIN,23,0,0,0,0
29,8482250,Callahan Burke,C,VGK,27,0,0,0,0
29,8482784,Zach Dean,C,STL,21,0,0,0,0
29,8484255,Jason Polin,R,COL,25,0,0,0,0
29,8481077,John Leonard,L,,26,0,0,0,0
29,8481534,Raphael Lavoie,C,EDM,24,0,0,0,0
29,8483609,Adam Klapka,R,CGY,24,0,0,0,0
29,8482751,Ryan Winterton,C,SEA,21,0,0,0,0
29,8480267,Sammy Walker,C,MIN,25,0,0,0,0
29,8475766,Austin Watson,L,,32,0,0,0,0
29,8482460,Matt Rempe,C,NYR,22,0,0,0,0
29,8481065,Angus Crookshank,L,OTT,25,0,0,0,0
29,8481070,Hugh McGing,L,,26,0,0,0,0
29,8476323,Max McCormick,L,SEA,32,0,0,0,0
29,8483395,Arshdeep Bains,L,VAN,23,0,0,0,0
29,8484259,Ondrej Pavel,C,COL,31,0,0,0,0
29,8483432,Luca Del Bel Belluz,C,CBJ,31,0,0,0,0
29,8483045,Cameron Butler,R,CBJ,31,0,0,0,0
29,8482061,Brandon Biro,L,SEA,26,0,0,0,0
29,8477401,John Hayden,C,SEA,29,0,0,0,0
29,8475278,Byron Froese,C,,33,0,0,0,0
29,8478446,Glenn Gawdin,C,LAK,27,0,0,0,0
29,8477993,Justin Kirkland,C,CGY,28,0,0,0,0
29,8482147,Jean-Luc Foudy,C,COL,22,0,0,0,0
29,8480032,Shane Bowers,C,NJD,25,0,0,0,0
29,8479330,Brandon Gignac,C,MTL,27,0,0,0,0
29,8480776,Sheldon Rempal,R,,29,0,0,0,0
29,8475413,Justin Dowling,C,NJD,34,0,0,0,0
29,8481726,Adam Edstrom,C,NYR,24,0,0,0,0
29,8480844,Grigori Denisenko,L,VGK,24,0,0,0,0
29,8478147,Bokondji Imama,L,PIT,28,0,0,0,0
29,8478881,Brett Seney,L,CHI,28,0,0,0,0
29,8483630,Pavol Regenda,L,ANA,25,0,0,0,0
29,8480836,Jonathan Gruden,C,,24,0,0,0,0
29,8484314,Jiri Smejkal,L,,28,0,0,0,0
29,8475780,Chris Wagner,R,COL,33,0,0,0,0
29,8479546,Oskar Steen,C,,26,0,0,0,0
29,8483597,Milos Kelemen,L,UTA,25,0,0,0,0
29,8481789,Tye Kartye,L,SEA,23,0,0,0,0
29,8484325,Waltteri Merela,C,TBL,26,0,0,0,0
29,8479421,Jacob Moverare,D,LAK,26,0,0,0,0
29,8481585,Egor Afanasyev,L,SJS,23,0,0,0,0
29,8479547,Matthew Phillips,R,,26,0,0,0,0
29,8479367,William Lockwood,R,FLA,26,0,0,0,0
29,8476915,Jujhar Khaira,L,,30,0,0,0,0
29,8481422,Jacob Lucchini,C,NSH,29,0,0,0,0
29,8480468,James Hamblin,L,EDM,25,0,0,0,0
29,8478051,Max Willman,C,NJD,29,0,0,0,0
29,8481556,John Beecher,C,BOS,23,0,0,0,0
29,8478078,Rourke Chartier,C,,28,0,0,0,0
30,8477492,Nathan MacKinnon,C,COL,29,82,59,92,151
30,8476453,Nikita Kucherov,R,TBL,31,82,45,96,141
30,8478402,Connor McDavid,C,EDM,27,82,39,92,131
30,8471675,Sidney Crosby,C,PIT,37,82,50,64,114
30,8477939,William Nylander,R,TOR,28,82,40,74,114
30,8478864,Kirill Kaprizov,L,MIN,27,82,45,68,113
30,8478420,Mikko Rantanen,R,COL,28,82,43,63,106
30,8478403,Jack Eichel,C,VGK,28,82,40,66,106
30,8480069,Cale Makar,D,COL,26,82,29,76,105
30,8480023,Robert Thomas,C,STL,25,82,27,78,105
30,8478550,Artemi Panarin,L,NYR,33,82,34,70,104
30,8478427,Sebastian Aho,C,CAR,27,82,39,64,103
30,8481559,Jack Hughes,C,NJD,23,82,34,69,103
30,8477956,David Pastrnak,R,BOS,28,82,49,53,102
30,8477934,Leon Draisaitl,C,EDM,29,82,39,58,97
30,8476459,Mika Zibanejad,C,NYR,31,82,29,68,97
30,8482116,Tim Stützle,C,OTT,22,82,28,69,97
30,8476468,J.T. Miller,C,VAN,31,82,30,66,96
30,8479407,Jesper Bratt,L,NJD,26,82,26,70,96
30,8476887,Filip Forsberg,L,NSH,30,82,43,52,95
30,8477946,Dylan Larkin,C,DET,28,82,39,56,95
30,8479314,Matthew Tkachuk,L,FLA,27,82,37,58,95
30,8473419,Brad Marchand,L,BOS,36,82,40,54,94
30,8479318,Auston Matthews,C,TOR,27,82,51,41,92
30,8480801,Brady Tkachuk,L,OTT,25,82,45,47,92
30,8478398,Kyle Connor,L,WPG,28,82,45,46,91
30,8480027,Jason Robertson,L,DAL,25,82,29,62,91
30,8477404,Jake Guentzel,C,TBL,30,82,45,45,90
30,8478445,Mathew Barzal,C,NYI,27,82,24,65,89
30,8479323,Adam Fox,D,NYR,26,82,22,67,89
30,8479343,Clayton Keller,R,UTA,26,82,40,47,87
30,8479420,Tage Thompson,C,BUF,27,82,39,48,87
30,8480865,Noah Dobson,D,NYI,24,82,20,67,87
30,8480036,Miro Heiskanen,D,DAL,25,82,17,69,86
30,8474600,Roman Josi,D,NSH,34,82,14,72,86
30,8480830,Andrei Svechnikov,R,CAR,24,82,36,49,85
30,8474564,Steven Stamkos,C,NSH,34,82,38,46,84
30,8477933,Sam Reinhart,C,FLA,29,82,36,48,84
30,8480012,Elias Pettersson,C,VAN,26,82,28,56,84
30,8475167,Victor Hedman,D,TBL,34,82,12,72,84
30,8478010,Brayden Point,C,TBL,28,82,42,40,82
30,8477501,Valeri Nichushkin,R,COL,29,82,42,40,82
30,8475172,Nazem Kadri,C,CGY,34,82,31,51,82
30,8475798,Mikael Granlund,C,SJS,32,82,16,66,82
30,8477493,Aleksander Barkov,C,FLA,29,82,27,54,81
30,8480018,Nick Suzuki,C,MTL,25,82,27,54,81
30,8477942,Kevin Fiala,L,LAK,28,82,17,64,81
30,8471214,Alex Ovechkin,L,WSH,39,82,37,42,79
30,8477949,Alex Tuch,R,BUF,28,82,31,48,79
30,8474578,Erik Karlsson,D,PIT,34,82,16,63,79
30,8479542,Brandon Hagel,L,TBL,26,82,41,37,78
30,8475166,John Tavares,C,TOR,34,82,31,47,78
30,8471215,Evgeni Malkin,C,PIT,38,82,30,47,77
30,8476389,Vincent Trocheck,C,NYR,31,82,27,50,77
30,8475754,Brock Nelson,C,NYI,33,82,40,36,76
30,8478449,Roope Hintz,C,DAL,28,82,37,39,76
30,8477986,Brandon Montour,D,SEA,30,82,31,45,76
30,8477409,Carter Verhaeghe,C,FLA,29,82,38,37,75
30,8476460,Mark Scheifele,C,WPG,31,82,31,44,75
30,8478439,Travis Konecny,R,PHI,27,82,29,46,75
30,8477940,Nikolaj Ehlers,L,WPG,28,82,28,47,75
30,8480839,Rasmus Dahlin,D,BUF,24,82,24,51,75
30,8480002,Nico Hischier,C,NJD,25,82,34,40,74
30,8479385,Jordan Kyrou,C,STL,26,82,32,42,74
30,8474590,John Carlson,D,WSH,34,82,17,57,74
30,8474141,Patrick Kane,R,DET,36,82,30,43,73
30,8475168,Matt Duchene,C,DAL,33,82,22,51,73
30,8475184,Chris Kreider,L,NYR,33,82,42,30,72
30,8480208,Drake Batherson,R,OTT,26,82,28,44,72
30,8477951,Nick Schmaltz,C,UTA,28,82,28,43,71
30,8477451,Ryan Hartman,R,MIN,30,82,27,44,71
30,8481557,Matt Boldy,L,MIN,23,82,25,46,71
30,8479337,Alex DeBrincat,R,DET,27,82,29,41,70
30,8476346,Johnny Gaudreau,L,CBJ,31,82,12,58,70
30,8475913,Mark Stone,R,VGK,32,82,30,39,69
30,8478873,Troy Terry,R,ANA,27,82,29,40,69
30,8479325,Charlie McAvoy,D,BOS,27,82,16,53,69
30,8476881,Tomas Hertl,C,VGK,31,82,32,36,68
30,8477402,Pavel Buchnevich,L,STL,29,82,30,38,68
30,8475692,Mats Zuccarello,R,MIN,37,82,26,42,68
30,8480800,Quinn Hughes,D,VAN,25,82,8,60,68
30,8475810,Bryan Rust,R,PIT,32,82,35,32,67
30,8479339,Patrik Laine,L,CBJ,26,82,34,33,67
30,8478047,Michael Bunting,L,PIT,29,82,34,33,67
30,8477960,Adrian Kempe,R,LAK,28,82,31,36,67
30,8476454,Ryan Nugent-Hopkins,C,EDM,31,82,25,42,67
30,8477496,Elias Lindholm,C,BOS,30,82,24,43,67
30,8476456,Jonathan Huberdeau,C,CGY,31,82,17,50,67
30,8476853,Morgan Rielly,D,TOR,30,82,13,54,67
30,8477447,Shea Theodore,D,VGK,29,82,13,54,67
30,8477500,Bo Horvat,C,NYI,29,82,30,36,66
30,8477407,Anthony Duclair,L,NYI,29,82,27,39,66
30,8479999,Casey Mittelstadt,C,COL,26,82,24,42,66
30,8478042,Viktor Arvidsson,R,EDM,31,82,26,39,65
30,8476462,Dougie Hamilton,D,NJD,31,82,23,42,65
30,8475170,Brayden Schenn,C,STL,33,82,22,43,65
30,8471685,Anze Kopitar,C,LAK,37,82,21,44,65
30,8480014,Gabriel Vilardi,C,WPG,25,82,33,31,64
30,8482078,Lucas Raymond,L,DET,22,82,25,39,64
30,8476448,William Karlsson,C,VGK,31,82,22,42,64
30,8478414,Timo Meier,R,NJD,28,82,35,28,63
30,8478401,Pavel Zacha,C,BOS,27,82,22,41,63
30,8481533,Trevor Zegras,C,ANA,23,82,22,41,63
30,8476792,Torey Krug,D,STL,33,82,17,46,63
30,8474565,Alex Pietrangelo,D,VGK,34,82,17,46,63
30,8477504,Josh Morrissey,D,WPG,29,82,12,51,63
30,8481528,Dylan Cozens,C,BUF,23,82,29,33,62
30,8477955,Jared McCann,L,SEA,28,82,28,34,62
30,8475784,Jeff Skinner,C,EDM,32,82,27,35,62
30,8477021,Alex Kerfoot,C,UTA,30,82,20,42,62
30,8481523,Kirby Dach,C,MTL,23,82,11,51,62
30,8476539,Jonathan Marchessault,R,NSH,34,82,28,33,61
30,8475314,Anders Lee,L,NYI,34,82,34,26,60
30,8482093,Seth Jarvis,C,CAR,22,82,28,32,60
30,8474586,Jordan Eberle,R,SEA,34,82,28,32,60
30,8475765,Vladimir Tarasenko,R,DET,33,82,22,38,60
30,8478407,Vince Dunn,D,SEA,28,82,13,47,60
30,8482159,Tyson Foerster,R,PHI,22,82,34,25,59
30,8476483,Rickard Rakell,R,PIT,31,82,30,29,59
30,8478519,Anthony Cirelli,C,TBL,27,82,21,38,59
30,8474679,Gustav Nyquist,C,NSH,35,82,19,40,59
30,8478460,Zach Werenski,D,CBJ,27,82,13,46,59
30,8478444,Brock Boeser,R,VAN,27,82,23,35,58
30,8482124,Quinton Byfield,R,LAK,22,82,19,39,58
30,8479400,Pierre-Luc Dubois,L,WSH,26,82,18,40,58
30,8476432,Boone Jenner,C,CBJ,31,82,32,25,57
30,8475151,Kyle Palmieri,C,NYI,33,82,31,26,57
30,8481540,Cole Caufield,R,MTL,23,82,30,27,57
30,8473986,Alex Killorn,L,ANA,35,82,27,30,57
30,8479675,Trevor Moore,L,LAK,29,82,25,32,57
30,8480039,Martin Necas,C,CAR,25,82,23,34,57
30,8482110,Dawson Mercer,C,NJD,23,82,21,36,57
30,8482097,Jack Quinn,R,BUF,23,82,25,31,56
30,8481618,Alex Newhook,C,MTL,23,82,25,31,56
30,8475786,Zach Hyman,L,EDM,32,82,22,34,56
30,8475753,Justin Faulk,D,STL,32,82,13,42,55
30,8476880,Tom Wilson,R,WSH,30,82,32,22,54
30,8480015,Owen Tippett,R,PHI,25,82,29,25,54
30,8480188,Fabian Zetterlund,L,SJS,25,82,24,30,54
30,8474150,Mikael Backlund,C,CGY,35,82,23,31,54
30,8480797,Joel Farabee,L,PHI,24,82,23,31,54
30,8476905,Chandler Stephenson,C,SEA,30,82,21,33,54
30,8477935,Sam Bennett,C,FLA,28,82,29,24,53
30,8475158,Ryan O'Reilly,C,NSH,33,82,29,24,53
30,8479365,Trent Frederic,C,BOS,26,82,23,30,53
30,8477456,J.T. Compher,L,DET,29,82,22,31,53
30,8477964,Ivan Barbashev,C,VGK,29,82,22,31,53
30,8473994,Jamie Benn,L,DAL,35,82,19,34,53
30,8478440,Dylan Strome,C,WSH,27,82,18,35,53
30,8477494,Jonathan Drouin,L,COL,29,82,17,36,53
30,8478396,Noah Hanifin,D,VGK,27,82,11,42,53
30,8478038,Devon Toews,D,COL,30,82,9,44,53
30,8471724,Kris Letang,D,PIT,37,82,9,44,53
30,8479987,Morgan Geekie,C,BOS,26,82,25,27,52
30,8478493,Joel Eriksson Ek,C,MIN,27,82,24,28,52
30,8477416,Oliver Bjorkstrand,R,SEA,29,82,21,31,52
30,8476882,Teuvo Teravainen,L,CHI,30,82,18,34,52
30,8476906,Shayne Gostisbehere,D,CAR,31,82,16,36,52
30,8477346,MacKenzie Weegar,D,CGY,30,82,16,36,52
30,8476438,Brandon Saad,L,STL,32,82,29,22,51
30,8478366,Frank Vatrano,R,ANA,30,82,24,27,51
30,8478975,Mason Marchment,L,DAL,29,82,21,30,51
30,8477444,Andre Burakovsky,L,SEA,29,82,21,30,51
30,8482665,Matty Beniers,C,SEA,22,82,20,31,51
30,8482113,Anton Lundell,C,FLA,23,82,20,31,51
30,8481596,Shane Pinto,C,OTT,24,82,26,24,50
30,8475726,Tyler Toffoli,C,SJS,32,82,25,25,50
30,8482745,Mason McTavish,C,ANA,21,82,20,30,50
30,8476875,Mike Matheson,D,MTL,30,82,14,36,50
30,8479410,Mikhail Sergachev,D,UTA,26,82,7,43,50
30,8475745,Charlie Coyle,C,BOS,32,82,24,25,49
30,8476872,Scott Laughton,C,PHI,30,82,23,26,49
30,8475169,Evander Kane,L,EDM,33,82,22,27,49
30,8475287,Erik Haula,L,NJD,33,82,21,28,49
30,8482667,William Eklund,L,SJS,22,82,17,32,49
30,8480078,Filip Chytil,C,NYR,25,82,15,34,49
30,8478458,Jack Roslovic,C,CAR,27,82,15,34,49
30,8480434,Sean Durzi,D,UTA,26,82,7,42,49
30,8475794,Tyler Seguin,C,DAL,32,82,25,23,48
30,8478498,Jake DeBrusk,L,VAN,28,82,25,23,48
30,8474102,David Perron,L,OTT,36,82,21,27,48
30,8478462,Nicolas Roy,C,VGK,27,82,20,28,48
30,8481711,Matias Maccelli,L,UTA,24,82,18,30,48
30,8477932,Aaron Ekblad,D,FLA,28,82,15,33,48
30,8478469,Thomas Chabot,D,OTT,27,82,13,35,48
30,8479345,Jakob Chychrun,D,WSH,26,82,11,37,48
30,8482684,Luke Hughes,D,NJD,21,82,9,39,48
30,8476923,Damon Severson,D,CBJ,30,82,8,40,48
30,8479525,Ross Colton,C,COL,28,82,20,27,47
30,8477503,Max Domi,C,TOR,29,82,19,28,47
30,8480798,Philipp Kurashev,C,CHI,25,82,18,29,47
30,8482149,Cole Perfetti,C,WPG,22,82,17,30,47
30,8478542,Evan Rodrigues,C,FLA,31,82,14,33,47
30,8476479,Phillip Danault,C,LAK,31,82,26,20,46
30,8480064,Josh Norris,C,OTT,25,82,25,21,46
30,8476399,Blake Coleman,C,CGY,33,82,23,23,46
30,8475714,Calle Jarnkrok,C,TOR,33,82,23,23,46
30,8480113,Alex Iafallo,L,WPG,31,82,23,23,46
30,8477952,Robby Fabbri,C,ANA,28,82,22,24,46
30,8477497,Sean Monahan,C,CBJ,30,82,21,25,46
30,8477511,Anthony Mantha,R,CGY,30,82,17,29,46
30,8476458,Ryan Strome,C,ANA,31,82,15,31,46
30,8475768,Jaden Schwartz,C,SEA,32,82,14,32,46
30,8478397,Rasmus Andersson,D,CGY,28,82,9,37,46
30,8479425,Filip Hronek,D,VAN,27,82,8,38,46
30,8477969,Marcus Pettersson,D,PIT,28,82,8,38,46
30,8478474,Lawson Crouse,L,UTA,27,82,27,18,45
30,8478057,Dakota Joshua,C,VAN,28,82,26,19,45
30,8482740,Wyatt Johnston,C,DAL,21,82,24,21,45
30,8475722,Jason Zucker,L,BUF,32,82,16,29,45
30,8475191,Reilly Smith,R,NYR,33,82,16,29,45
30,8476869,Brady Skjei,D,NSH,30,82,15,30,45
30,8473512,Claude Giroux,R,OTT,36,82,14,31,45
30,8478115,Pierre Engvall,L,NYI,28,82,13,32,45
30,8480893,Kirill Marchenko,R,CBJ,24,82,29,15,44
30,8482699,Dylan Guenther,R,UTA,21,82,25,19,44
30,8483515,Juraj Slafkovsky,L,MTL,20,82,20,24,44
30,8475171,Oliver Ekman-Larsson,D,TOR,33,82,19,25,44
30,8481068,Yegor Sharangovich,C,CGY,26,82,18,26,44
30,8482475,Yegor Chinakhov,R,CBJ,23,82,17,27,44
30,8477987,Ryan Donato,C,CHI,28,82,15,29,44
30,8470613,Brent Burns,D,CAR,39,82,13,31,44
30,8480028,Morgan Frost,C,PHI,25,82,13,31,44
30,8477476,Artturi Lehkonen,L,COL,29,82,23,20,43
30,8474641,Adam Henrique,C,EDM,34,82,23,20,43
30,8480829,Jesperi Kotkaniemi,C,CAR,24,82,21,22,43
30,8478856,Conor Garland,R,VAN,28,82,19,24,43
30,8475791,Taylor Hall,L,CHI,33,82,17,26,43
30,8476419,Jean-Gabriel Pageau,C,NYI,32,82,16,27,43
30,8478055,Gustav Forsling,D,FLA,28,82,15,28,43
30,8476826,Yanni Gourde,C,SEA,33,82,14,29,43
30,8477495,Seth Jones,D,CHI,30,82,13,30,43
30,8481581,Thomas Harley,D,DAL,23,82,13,30,43
30,8475763,Kevin Hayes,R,PIT,32,82,12,31,43
30,8480803,Evan Bouchard,D,EDM,25,82,11,32,43
30,8477948,Travis Sanheim,D,PHI,28,82,8,35,43
30,8478233,Andrew Mangiapane,L,WSH,28,82,22,20,42
30,8477479,Tyler Bertuzzi,L,CHI,29,82,20,22,42
30,8477426,Nicholas Paul,L,TBL,29,82,18,24,42
30,8474149,Evgenii Dadonov,R,DAL,35,82,18,24,42
30,8476461,Sean Couturier,C,PHI,32,82,14,28,42
30,8476854,Hampus Lindholm,D,BOS,30,82,12,30,42
30,8480145,Neal Pionk,D,WPG,29,82,9,33,42
30,8481542,Moritz Seider,D,DET,23,82,4,38,42
30,8480009,Eeli Tolvanen,R,SEA,25,82,19,22,41
30,8480074,Alexandre Texier,C,STL,25,82,16,25,41
30,8477429,Andrew Copp,C,DET,30,82,15,26,41
30,8481656,Aliaksei Protas,C,WSH,23,82,12,29,41
30,8474563,Drew Doughty,D,LAK,35,82,11,30,41
30,8478911,Matt Roy,D,WSH,29,82,8,33,41
30,8475764,Cam Fowler,D,ANA,33,82,6,35,41
30,8479941,Justin Danforth,R,CBJ,31,82,23,17,40
30,8477989,Christian Dvorak,C,MTL,28,82,18,22,40
30,8477998,Warren Foegele,L,LAK,28,82,26,13,39
30,8476278,Colin Blackwell,C,DAL,31,82,23,16,39
30,8481535,Nils Hoglander,L,VAN,24,82,21,18,39
30,8479390,Taylor Raddysh,R,WSH,26,82,20,19,39
30,8479992,Michael Rasmussen,C,DET,25,82,19,20,39
30,8475193,Tomas Tatar,L,NJD,34,82,15,24,39
30,8477953,Kasperi Kapanen,R,STL,28,82,15,24,39
30,8476958,Jaccob Slavin,D,CAR,30,82,8,31,39
30,8480871,Adam Boqvist,D,FLA,24,82,6,33,39
30,8481604,Pavel Dorofeyev,L,VGK,24,82,23,15,38
30,8470621,Corey Perry,R,EDM,39,82,22,16,38
30,8482055,Drew O'Connor,L,PIT,26,82,20,18,38
30,8481580,Connor McMichael,C,WSH,23,82,19,19,38
30,8478046,Danton Heinen,L,VAN,29,82,19,19,38
30,8482146,Luke Evangelista,R,NSH,22,82,18,20,38
30,8483808,Andrei Kuzmenko,L,CGY,28,82,16,22,38
30,8476329,Travis Boyd,C,MIN,31,82,14,24,38
30,8482660,Kent Johnson,C,CBJ,22,82,14,24,38
30,8480068,Ryan Poehling,C,PHI,25,82,14,24,38
30,8478413,Jordan Greenway,L,BUF,27,82,12,26,38
30,8484153,Leo Carlsson,C,ANA,20,82,12,26,38
30,8471698,T.J. Oshie,R,WSH,38,82,22,15,37
30,8480789,Oliver Wahlstrom,R,NYI,24,82,22,15,37
30,8476474,Stefan Noesen,R,NJD,31,82,18,19,37
30,8480220,Noah Cates,L,PHI,25,82,14,23,37
30,8478472,Mathieu Joseph,R,STL,27,82,11,26,37
30,8481606,Jordan Spence,D,LAK,23,82,10,27,37
30,8482671,Owen Power,D,BUF,22,82,8,29,37
30,8474151,Ryan McDonagh,D,TBL,35,82,5,32,37
30,8480073,Erik Brannstrom,D,COL,25,82,5,32,37
30,8475799,Nino Niederreiter,R,WPG,32,82,21,15,36
30,8478020,Michael Amadio,C,OTT,28,82,17,19,36
30,8484144,Connor Bedard,C,CHI,19,82,16,20,36
30,8477947,Sonny Milano,L,WSH,28,82,16,20,36
30,8482720,Matthew Knies,L,TOR,22,82,13,23,36
30,8478463,Anthony Beauvillier,L,PIT,27,82,13,23,36
30,8480835,Jack Drury,C,CAR,24,82,12,24,36
30,8478891,Mason Appleton,C,WPG,28,82,12,24,36
30,8480281,Alexey Toropchenko,R,STL,25,82,26,9,35
30,8482705,Cole Sillinger,C,CBJ,21,82,18,17,35
30,8482125,Alexander Holtz,R,VGK,22,82,18,17,35
30,8480855,Jack McBain,C,UTA,24,82,18,17,35
30,8481554,Kaapo Kakko,R,NYR,23,82,17,18,35
30,8478438,Tommy Novak,C,NSH,27,82,13,22,35
30,8478013,Jake Walman,D,SJS,28,82,13,22,35
30,8482111,Justin Barron,D,MTL,23,82,13,22,35
30,8480995,Pontus Holmberg,R,TOR,25,82,13,22,35
30,8480459,Pius Suter,C,VAN,28,82,12,23,35
30,8480185,Eetu Luostarinen,C,FLA,26,82,11,24,35
30,8475793,Ryan Johansen,C,PHI,32,82,10,25,35
30,8473507,Jeff Petry,D,DET,37,82,7,28,35
30,8482655,J.J. Moser,D,TBL,24,82,6,29,35
30,8479398,Samuel Girard,D,COL,26,82,5,30,35
30,8482087,Kaiden Guhle,D,MTL,22,82,5,30,35
30,8477506,Ryan Pulock,D,NYI,30,82,3,32,35
30,8481032,Paul Cotter,C,NJD,25,82,20,14,34
30,8474053,Logan Couture,C,SJS,35,82,18,16,34
30,8482175,JJ Peterka,R,BUF,22,82,18,16,34
30,8476981,Josh Anderson,R,MTL,30,82,18,16,34
30,8479353,Brett Howden,C,VGK,26,82,18,16,34
30,8474715,Cam Atkinson,R,TBL,35,82,17,17,34
30,8479293,Brandon Tanev,L,SEA,33,82,17,17,34
30,8481582,Nicholas Robertson,L,TOR,23,82,16,18,34
30,8481624,Ilya Mikheyev,R,CHI,30,82,15,19,34
30,8473563,Nicklas Backstrom,C,WSH,37,82,14,20,34
30,8481481,Blake Lizotte,C,PIT,27,82,14,20,34
30,8474716,Jared Spurgeon,D,MIN,35,82,10,24,34
30,8481546,Cam York,D,PHI,23,82,8,26,34
30,8476979,Erik Gustafsson,D,DET,32,82,4,30,34
30,8482079,Marco Rossi,C,MIN,23,82,21,12,33
30,8482109,Alexis Lafrenière,L,NYR,23,82,15,18,33
30,8476925,Colton Sissons,C,NSH,31,82,14,19,33
30,8475218,Mattias Ekholm,D,EDM,34,82,14,19,33
30,8475343,Nic Dowd,C,WSH,34,82,14,19,33
30,8476960,Andreas Athanasiou,C,CHI,30,82,13,20,33
30,8482133,Thomas Bordeleau,C,SJS,22,82,11,22,33
30,8481560,Arthur Kaliyev,R,LAK,23,82,11,22,33
30,8480336,Sean Walker,D,CAR,30,82,9,24,33
30,8481522,Peyton Krebs,C,BUF,23,82,8,25,33
30,8480817,K'Andre Miller,D,NYR,24,82,7,26,33
30,8479369,Andrew Peeke,D,BOS,26,82,7,26,33
30,8476463,Jonas Brodin,D,MIN,31,82,6,27,33
30,8482089,Jake Neighbours,L,STL,22,82,23,9,32
30,8482074,Connor Zary,C,CGY,23,82,18,14,32
30,8483431,Logan Cooley,C,UTA,20,82,17,15,32
30,8473533,Jordan Staal,C,CAR,36,82,17,15,32
30,8474189,Lars Eller,C,PIT,35,82,16,16,32
30,8476392,Adam Lowry,C,WPG,31,82,13,19,32
30,8476292,Ondrej Palat,L,NJD,33,82,11,21,32
30,8476921,Jordan Martinook,L,CAR,32,82,9,23,32
30,8481601,Simon Holmstrom,R,NYI,23,82,9,23,32
30,8479976,Juuso Valimaki,D,UTA,26,82,7,25,32
30,8479316,Luke Kunin,C,SJS,27,82,19,12,31
30,8476889,Radek Faksa,C,STL,30,82,16,15,31
30,8476480,Vladislav Namestnikov,C,WPG,32,82,15,16,31
30,8479983,Mario Ferraro,D,SJS,26,82,12,19,31
30,8473422,Nick Foligno,L,CHI,37,82,10,21,31
30,8479591,Michael Eyssimont,C,TBL,28,82,10,21,31
30,8477488,Brett Pesce,D,NJD,30,82,7,24,31
30,8478508,Yakov Trenin,C,MIN,27,82,20,10,30
30,8477450,Jason Dickinson,C,CHI,29,82,18,12,30
30,8475848,Brendan Gallagher,R,MTL,32,82,16,14,30
30,8479393,Noah Gregor,C,OTT,26,82,13,17,30
30,8480003,Jesper Boqvist,C,FLA,26,82,13,17,30
30,8483482,Tristan Luneau,D,ANA,20,82,12,18,30
30,8482092,Ridly Greig,C,OTT,22,82,10,20,30
30,8478569,Noel Acciari,C,PIT,33,82,10,20,30
30,8477498,Darnell Nurse,D,EDM,29,82,9,21,30
30,8482073,Braden Schneider,D,NYR,23,82,8,22,30
30,8476892,Colton Parayko,D,STL,31,82,6,24,30
30,8476917,Adam Pelech,D,NYI,30,82,6,24,30
30,8476457,Adam Larsson,D,SEA,32,82,6,24,30
30,8478882,Vladislav Gavrikov,D,LAK,29,82,4,26,30
30,8480748,Kiefer Sherwood,L,VAN,29,82,16,13,29
30,8481093,Rafael Harvey-Pinard,L,MTL,25,82,16,13,29
30,8479414,Nathan Bastian,R,NJD,27,82,16,13,29
30,8476873,Mark Jankowski,C,NSH,30,82,14,15,29
30,8480806,Isac Lundestrom,C,ANA,25,82,13,16,29
30,8475760,Nick Bjugstad,C,UTA,32,82,12,17,29
30,8476312,Josh Manson,D,COL,33,82,12,17,29
30,8482105,Jake Sanderson,D,OTT,22,82,10,19,29
30,8476902,Esa Lindell,D,DAL,30,82,10,19,29
30,8481708,Zac Jones,D,NYR,24,82,9,20,29
30,8478133,Jake Evans,C,MTL,28,82,8,21,29
30,8483457,Lane Hutson,D,MTL,20,82,7,22,29
30,8480873,Rasmus Sandin,D,WSH,24,82,4,25,29
30,8477220,Nate Schmidt,D,FLA,33,82,3,26,29
30,8477425,Miles Wood,L,COL,29,82,20,8,28
30,8482259,Bobby McMann,C,TOR,28,82,19,9,28
30,8481013,Jonatan Berggren,R,DET,24,82,13,15,28
30,8477931,Tomas Nosek,L,FLA,32,82,12,16,28
30,8482062,Cole Smith,L,NSH,29,82,12,16,28
30,8482666,Scott Morrow,D,CAR,22,82,9,19,28
30,8478136,Jake Middleton,D,MIN,28,82,8,20,28
30,8475200,Dmitry Orlov,D,CAR,33,82,6,22,28
30,8483495,Simon Nemec,D,NJD,20,82,6,22,28
30,8482142,Jamie Drysdale,D,PHI,22,82,5,23,28
30,8475181,Nick Leddy,D,STL,33,82,4,24,28
30,8478851,Alexandre Carrier,D,NSH,28,82,3,25,28
30,8477903,Garnet Hathaway,R,PHI,33,82,14,13,27
30,8475149,Marcus Johansson,L,MIN,34,82,12,15,27
30,8481186,Logan O'Connor,R,COL,28,82,12,15,27
30,8480813,Joe Veleno,C,DET,24,82,12,15,27
30,8477919,Frederick Gaudreau,C,MIN,31,82,11,16,27
30,8476885,Jacob Trouba,D,NYR,30,82,9,18,27
30,8477435,Ryan Graves,D,PIT,29,82,9,18,27
30,8476469,Joel Armia,R,MTL,31,82,8,19,27
30,8481178,Egor Zamula,D,PHI,24,82,5,22,27
30,8478507,John Marino,D,UTA,27,82,3,24,27
30,8475690,Chris Tanev,D,TOR,35,82,3,24,27
30,8475188,Brayden McNabb,D,VGK,33,82,2,25,27
30,8478500,Ivan Provorov,D,CBJ,27,82,2,25,27
30,8476331,Dylan DeMelo,D,WPG,31,82,2,25,27
30,8479351,Sam Steel,C,DAL,26,82,13,13,26
30,8476878,Zemgus Girgensons,L,TBL,30,82,13,13,26
30,8478109,Victor Olofsson,L,VGK,29,82,12,14,26
30,8479368,Max Jones,L,BOS,26,82,12,14,26
30,8484145,Zach Benson,L,BUF,19,82,10,16,26
30,8480849,Barrett Hayton,C,UTA,24,82,9,17,26
30,8477839,Conor Sheary,L,TBL,32,82,9,17,26
30,8482117,Lukas Reichel,L,CHI,22,82,9,17,26
30,8483505,Matthew Poitras,C,BOS,20,82,7,19,26
30,8476897,Oskar Sundqvist,C,STL,30,82,6,20,26
30,8481568,Alex Vlasic,D,CHI,23,82,5,21,26
30,8475455,Brenden Dillon,D,NJD,34,82,4,22,26
30,8480049,Dylan Samberg,D,WPG,25,82,4,22,26
30,8477845,Trevor van Riemsdyk,D,WSH,33,82,3,23,26
30,8480043,Timothy Liljegren,D,TOR,25,82,2,24,26
30,8475842,Sam Carrick,C,NYR,32,82,16,9,25
30,8477392,Hudson Fasching,R,NYI,29,82,13,12,25
30,8481704,Juuso Parssinen,C,NSH,23,82,12,13,25
30,8479996,Cody Glass,C,NSH,25,82,12,13,25
30,8475855,Jesper Fast,R,CAR,33,82,10,15,25
30,8476927,Teddy Blueger,C,VAN,30,82,9,16,25
30,8475231,Casey Cizikas,C,NYI,33,82,9,16,25
30,8480980,Connor Dewar,C,TOR,25,82,7,18,25
30,8482702,Logan Stankoven,C,DAL,21,82,5,20,25
30,8482122,Brock Faber,D,MIN,22,82,4,21,25
30,8476891,Matt Grzelcyk,D,PIT,30,82,4,21,25
30,8480222,Sebastian Aho,D,PIT,28,82,4,21,25
30,8479402,Jake Bean,D,CGY,26,82,3,22,25
30,8480802,Ryan McLeod,C,BUF,25,82,15,9,24
30,8477353,Tyler Motte,C,DET,29,82,13,11,24
30,8484203,Bradly Nadeau,L,CAR,19,82,11,13,24
30,8481553,Bobby Brink,R,PHI,23,82,8,16,24
30,8476931,Jake McCabe,D,TOR,31,82,5,19,24
30,8475279,Ben Chiarot,D,DET,33,82,5,19,24
30,8477015,Connor Brown,R,EDM,30,82,5,19,24
30,8478416,Erik Cernak,D,TBL,27,82,4,20,24
30,8476858,Phillip Di Giuseppe,L,VAN,31,82,17,6,23
30,8476918,Jimmy Vesey,L,NYR,31,82,14,9,23
30,8479291,Kevin Rooney,C,CGY,31,82,14,9,23
30,8479661,Tanner Jeannot,L,LAK,27,82,12,11,23
30,8480144,David Kampf,C,TOR,29,82,5,18,23
30,8477507,Nikita Zadorov,D,BOS,29,82,4,19,23
30,8481567,Henry Thrun,D,SJS,23,82,4,19,23
30,8479980,Nicolas Hague,D,VGK,26,82,4,19,23
30,8481517,Brett Leason,R,ANA,25,82,13,9,22
30,8481477,Nico Sturm,C,SJS,29,82,11,11,22
30,8480448,Parker Kelly,L,COL,25,82,10,12,22
30,8482807,Ethan Del Mastro,D,CHI,21,82,8,14,22
30,8479359,Beck Malenstyn,L,BUF,26,82,7,15,22
30,8476624,Barclay Goodrow,C,SJS,31,82,7,15,22
30,8480035,Henri Jokiharju,D,BUF,25,82,3,19,22
30,8476429,Scott Mayfield,D,NYI,32,82,3,19,22
30,8474574,Tyler Myers,D,VAN,34,82,2,20,22
30,8480021,Jack Studnicka,C,LAK,25,82,11,10,21
30,8482101,Danil Gushchin,L,SJS,22,82,9,12,21
30,8477406,Mattias Janmark,C,EDM,32,82,8,13,21
30,8482166,Shakir Mukhamadullin,D,SJS,22,82,7,14,21
30,8478178,Darren Raddysh,D,TBL,28,82,6,15,21
30,8475718,Justin Holl,D,DET,32,82,5,16,21
30,8477365,Connor Clifton,D,BUF,29,82,4,17,21
30,8479371,Dante Fabbro,D,NSH,26,82,2,19,21
30,8482245,Artem Zub,D,OTT,29,82,1,20,21
30,8482624,Daniil Miromanov,D,CGY,27,82,10,10,20
30,8480025,MacKenzie Entwistle,R,FLA,25,82,10,10,20
30,8476442,Matt Nieto,L,PIT,32,82,9,11,20
30,8482762,Simon Edvinsson,D,DET,21,82,8,12,20
30,8479442,Troy Stecher,D,EDM,30,82,8,12,20
30,8476374,Sean Kuraly,C,CBJ,31,82,7,13,20
30,8482659,Josh Doan,R,UTA,22,82,7,13,20
30,8479998,Mikey Anderson,D,LAK,25,82,5,15,20
30,8483499,Liam Ohgren,L,MIN,20,82,5,15,20
30,8478399,Jonas Siegenthaler,D,NJD,27,82,5,15,20
30,8482803,Olen Zellweger,D,ANA,21,82,4,16,20
30,8470600,Ryan Suter,D,STL,39,82,4,16,20
30,8483490,Pavel Mintyukov,D,ANA,21,82,3,17,20
30,8481014,Alexander Romanov,D,NYI,24,82,2,18,20
30,8477508,Curtis Lazar,C,NJD,29,82,11,8,19
30,8478434,Keegan Kolesar,R,VGK,27,82,10,9,19
30,8482809,Jackson Blake,R,CAR,21,82,9,10,19
30,8484166,Adam Fantilli,C,CBJ,20,82,9,10,19
30,8481028,Martin Pospisil,C,CGY,25,82,8,11,19
30,8483763,Maksymilian Szuber,D,UTA,22,82,7,12,19
30,8475220,Marcus Foligno,L,MIN,33,82,7,12,19
30,8482858,Ryker Evans,D,SEA,23,82,7,12,19
30,8480246,Nick Perbix,D,TBL,26,82,7,12,19
30,8480878,Nils Lundkvist,D,DAL,24,82,4,15,19
30,8476467,Jamie Oleksiak,D,SEA,32,82,3,16,19
30,8476422,Mike Reilly,D,NYI,31,82,3,16,19
30,8476967,Brett Kulak,D,EDM,30,82,1,18,19
30,8475462,Radko Gudas,D,ANA,34,82,1,18,19
30,8474673,TJ Brodie,D,CHI,34,82,0,19,19
30,8476822,Luke Glendening,C,TBL,35,82,13,5,18
30,8473453,Trevor Lewis,C,LAK,37,82,11,7,18
30,8477505,Alexander Wennberg,C,SJS,30,82,8,10,18
30,8482733,Logan Mailloux,D,MTL,31,82,8,10,18
30,8482153,Brendan Brisson,C,VGK,23,82,7,11,18
30,8481524,Bowen Byram,D,BUF,23,82,6,12,18
30,8477369,Carson Soucy,D,VAN,30,82,5,13,18
30,8471677,Jack Johnson,D,CBJ,37,82,4,14,18
30,8480834,Ty Emberson,D,SJS,24,82,3,15,18
30,8476525,Colin Miller,D,WPG,32,82,2,16,18
30,8478840,Will Borgen,D,SEA,28,82,0,18,18
30,8477938,Haydn Fleury,D,WPG,28,82,6,11,17
30,8478859,Niko Mikkola,D,FLA,28,82,5,12,17
30,8480950,Ilya Lyubushkin,D,DAL,30,82,5,12,17
30,8483445,Cutter Gauthier,L,ANA,20,82,4,13,17
30,8477499,Rasmus Ristolainen,D,PHI,30,82,4,13,17
30,8480807,Mattias Samuelsson,D,BUF,24,82,3,14,17
30,8478443,Brandon Carlo,D,BOS,28,82,3,14,17
30,8475177,Calvin de Haan,D,COL,33,82,1,16,17
30,8478432,Christian Fischer,R,DET,27,82,9,7,16
30,8478211,Dryden Hunt,L,CGY,29,82,9,7,16
30,8482713,Mackie Samoskevich,R,FLA,22,82,7,9,16
30,8483524,Shane Wright,C,SEA,20,82,6,10,16
30,8483466,Kevin Korchinski,D,CHI,20,82,4,12,16
30,8482155,Alex Laferriere,R,LAK,23,82,11,4,15
30,8480870,Bo Groulx,C,NYR,24,82,8,7,15
30,8474090,Brendan Smith,D,DAL,35,82,5,10,15
30,8484911,Collin Graf,R,SJS,22,82,5,10,15
30,8482679,Matt Coronato,R,CGY,22,82,5,10,15
30,8482141,Lukas Cormier,D,VGK,22,82,4,11,15
30,8480990,Declan Chisholm,D,MIN,24,82,4,11,15
30,8482470,Ilya Solovyov,D,CGY,24,82,3,12,15
30,8475233,David Savard,D,MTL,34,82,2,13,15
30,8475790,Erik Gudbranson,D,CBJ,32,82,1,14,15
30,8480879,Jacob Bernard-Docker,D,OTT,24,82,1,14,15
30,8482077,Dylan Holloway,L,EDM,23,82,9,5,14
30,8479324,Ryan Lindgren,D,NYR,26,82,5,9,14
30,8478468,Jeremy Lauzon,D,NSH,27,82,5,9,14
30,8474013,Ian Cole,D,UTA,35,82,3,11,14
30,8480172,Jan Rutta,D,SJS,34,82,3,11,14
30,8477335,Kyle Burroughs,D,LAK,29,82,3,11,14
30,8480860,Kevin Bahl,D,CGY,24,82,3,11,14
30,8475324,Nick Jensen,D,OTT,34,82,1,13,14
30,8483565,Nick Blankenburg,D,NSH,26,82,1,13,14
30,8481641,Joel Kiviranta,L,COL,28,82,7,6,13
30,8483012,Logan Morrison,C,SEA,22,82,6,7,13
30,8484149,Gavin Brindley,C,CBJ,20,82,4,9,13
30,8476441,Joel Edmundson,D,LAK,31,82,4,9,13
30,8483471,Brad Lambert,C,WPG,31,82,3,10,13
30,8480796,Martin Fehervary,D,WSH,25,82,1,12,13
30,8482070,Mitchell Chaffee,R,TBL,26,82,8,4,12
30,8479638,Justin Brazeau,R,BOS,26,82,7,5,12
30,8483567,Georgii Merkulov,C,BOS,24,82,5,7,12
30,8482749,Joshua Roy,R,MTL,21,82,5,7,12
30,8482787,Nikita Chibrikov,R,WPG,31,82,5,7,12
30,8482145,Mavrik Bourque,C,DAL,22,82,4,8,12
30,8483397,Marc McLaughlin,C,BOS,25,82,3,9,12
30,8474612,Travis Hamonic,D,OTT,34,82,3,9,12
30,8476879,Cody Ceci,D,EDM,31,82,0,12,12
30,8483493,Frank Nazar,C,CHI,20,82,5,6,11
30,8478450,Parker Wotherspoon,D,BOS,27,82,2,9,11
30,8481605,Jackson LaCombe,D,ANA,23,82,2,9,11
30,8476372,Nick Seeler,D,PHI,31,82,1,10,11
30,8482118,Sam Colangelo,R,ANA,23,82,6,4,10
30,8481699,Aku Raty,R,UTA,23,82,6,4,10
30,8483468,Jiri Kulich,C,BUF,20,82,6,4,10
30,8477034,Jaycob Megna,D,FLA,32,82,3,7,10
30,8475762,Derek Forbort,D,VAN,32,82,2,8,10
30,8478874,Adam Gaudette,C,OTT,28,82,2,8,10
30,8483460,David Jiricek,D,CBJ,21,82,1,9,10
30,8479576,Vincent Desharnais,D,VAN,28,82,4,5,9
30,8482859,Zack Ostapchuk,C,OTT,21,82,3,6,9
30,8482712,Oskar Olausson,R,COL,22,82,3,6,9
30,8483489,Fraser Minten,C,TOR,31,82,3,6,9
30,8474567,Zach Bogosian,D,MIN,34,82,1,8,9
30,8482516,Matthew Kessel,D,STL,24,82,1,7,8
30,8481122,Simon Benoit,D,TOR,26,82,0,8,8
30,8474062,Riley Nash,C,NYR,35,82,3,2,5
30,8476473,Connor Murphy,D,CHI,31,82,1,3,4
30,8470794,Joe Pavelski,C,,40,0,0,0,0
30,8481703,Valtteri Puustinen,R,PIT,25,0,0,0,0
30,8477950,Tony DeAngelo,D,,29,0,0,0,0
30,8481577,Philip Tomasino,C,NSH,23,0,0,0,0
30,8475197,Tyson Barrie,D,,33,0,0,0,0
30,8471218,Blake Wheeler,R,,38,0,0,0,0
30,8474157,Max Pacioretty,L,,36,0,0,0,0
30,8478466,Daniel Sprong,R,VAN,27,0,0,0,0
30,8475744,Evgeny Kuznetsov,C,,32,0,0,0,0
30,8481019,David Gustafsson,C,WPG,24,0,0,0,0
30,8475906,John Klingberg,D,,32,0,0,0,0
30,8479348,Kale Clague,D,BUF,26,0,0,0,0
30,8476952,Dominic Toninato,C,WPG,30,0,0,0,0
30,8473473,Milan Lucic,L,,36,0,0,0,0
30,8474037,James van Riemsdyk,L,,35,0,0,0,0
30,8474602,Justin Schultz,D,,34,0,0,0,0
30,8482222,Alexander Barabanov,L,,30,0,0,0,0
30,8479372,Josh Mahura,D,SEA,26,0,0,0,0
30,8479982,Conor Timmins,D,TOR,26,0,0,0,0
30,8474031,Kevin Shattenkirk,D,,35,0,0,0,0
30,8480008,Adam Ruzicka,C,,25,0,0,0,0
30,8481059,Scott Perunovich,D,STL,26,0,0,0,0
30,8480884,Calen Addison,D,,24,0,0,0,0
30,8476994,Vinnie Hinostroza,C,NSH,30,0,0,0,0
30,8478452,Caleb Jones,D,LAK,27,0,0,0,0
30,8480157,Calle Rosen,D,COL,30,0,0,0,0
30,8481609,Vladislav Kolyachonok,D,UTA,23,0,0,0,0
30,8479415,Michael McLeod,C,,26,0,0,0,0
30,8476919,Chris Tierney,C,,30,0,0,0,0
30,8479639,Dylan Coghlan,D,WPG,26,0,0,0,0
30,8478146,Matthew Highmore,C,OTT,28,0,0,0,0
30,8478970,Jalen Chatfield,D,CAR,28,0,0,0,0
30,8480205,Emil Bemstrom,C,PIT,25,0,0,0,0
30,8474884,Mike Hoffman,C,,35,0,0,0,0
30,8471274,Alex Goligoski,D,,39,0,0,0,0
30,8478104,Sammy Blais,L,,28,0,0,0,0
30,8474870,Tyler Johnson,C,,34,0,0,0,0
30,8476913,Devin Shore,C,MIN,30,0,0,0,0
30,8481598,Philip Broberg,D,EDM,23,0,0,0,0
30,8480058,Pierre-Olivier Joseph,D,STL,25,0,0,0,0
30,8480891,Michael Kesselring,D,UTA,24,0,0,0,0
30,8477979,Nicolas Aube-Kubel,R,BUF,28,0,0,0,0
30,8476871,Tanner Pearson,L,,32,0,0,0,0
30,8476393,Nick Cousins,C,,31,0,0,0,0
30,8479977,Kailer Yamamoto,R,,26,0,0,0,0
30,8479543,Michael Pezzetta,L,MTL,26,0,0,0,0
30,8477018,Ben Hutton,D,VGK,31,0,0,0,0
30,8480762,Eric Robinson,L,CAR,29,0,0,0,0
30,8474034,Pat Maroon,L,CHI,36,0,0,0,0
30,8481058,Jesse Ylönen,R,,25,0,0,0,0
30,8475179,Dmitry Kulikov,D,FLA,34,0,0,0,0
30,8481527,Kaedan Korczak,D,VGK,23,0,0,0,0
30,8473449,Kyle Okposo,R,,36,0,0,0,0
30,8482192,Isaak Phillips,D,CHI,23,0,0,0,0
30,8480727,Zach Whitecloud,D,VGK,28,0,0,0,0
30,8479346,Dillon Dube,C,,26,0,0,0,0
30,8480821,Filip Zadina,R,,25,0,0,0,0
30,8480001,Urho Vaakanainen,D,ANA,25,0,0,0,0
30,8470966,Mark Giordano,D,,41,0,0,0,0
30,8480853,Liam Foudy,C,,24,0,0,0,0
30,8475225,Craig Smith,C,CHI,35,0,0,0,0
30,8479972,Mason Shaw,C,WPG,26,0,0,0,0
30,8478451,Ethan Bear,D,WSH,27,0,0,0,0
30,8474040,Sam Gagner,C,,35,0,0,0,0
30,8480196,Jacob Bryson,D,BUF,27,0,0,0,0
30,8479984,Cal Foote,D,,26,0,0,0,0
30,8480011,Klim Kostin,C,SJS,25,0,0,0,0
30,8482176,Wyatt Kaiser,D,CHI,22,0,0,0,0
30,8476988,Matt Benning,D,SJS,30,0,0,0,0
30,8479370,Tyson Jost,C,CAR,26,0,0,0,0
30,8477464,Nic Petan,C,,29,0,0,0,0
30,8477380,Jonny Brodzinski,C,NYR,31,0,0,0,0
30,8480070,Ian Mitchell,D,BOS,25,0,0,0,0
30,8479315,Joey Anderson,R,CHI,26,0,0,0,0
30,8478099,Kevin Labanc,R,,29,0,0,0,0
30,8476874,Olli Maatta,D,DET,30,0,0,0,0
30,8475208,Brian Dumoulin,D,ANA,33,0,0,0,0
30,8478430,Oliver Kylington,D,,27,0,0,0,0
30,8479536,Axel Jonsson-Fjallby,L,WPG,26,0,0,0,0
30,8479671,Mathieu Olivier,R,CBJ,27,0,0,0,0
30,8471709,Marc-Edouard Vlasic,D,SJS,37,0,0,0,0
30,8479328,Julien Gauthier,R,NYI,27,0,0,0,0
30,8478421,A.J. Greer,L,FLA,28,0,0,0,0
30,8477573,Nathan Walker,L,STL,30,0,0,0,0
30,8481537,Nikita Okhotiuk,D,CGY,24,0,0,0,0
30,8474166,Alec Martinez,D,CHI,37,0,0,0,0
30,8470610,Zach Parise,L,,40,0,0,0,0
30,8477478,William Carrier,L,CAR,30,0,0,0,0
30,8479344,Jesse Puljujarvi,R,PIT,26,0,0,0,0
30,8480887,Jordan Harris,D,MTL,24,0,0,0,0
30,8478502,Dennis Gilbert,D,BUF,28,0,0,0,0
30,8482730,Brandt Clarke,D,LAK,21,0,0,0,0
30,8480355,Mark Kastelic,C,BOS,25,0,0,0,0
30,8475750,Jon Merrill,D,MIN,32,0,0,0,0
30,8475164,Jakob Silfverberg,R,,34,0,0,0,0
30,8477944,Jakub Vrana,L,,28,0,0,0,0
30,8479439,Jacob MacDonald,D,COL,31,0,0,0,0
30,8474568,Luke Schenn,D,NSH,35,0,0,0,0
30,8478454,Noah Juulsen,D,VAN,27,0,0,0,0
30,8475752,Tyler Pitlick,C,,33,0,0,0,0
30,8482148,Hendrix Lapierre,C,WSH,22,0,0,0,0
30,8481167,Brayden Pachal,D,CGY,25,0,0,0,0
30,8478043,Sam Lafferty,C,BUF,29,0,0,0,0
30,8479321,Lucas Johansen,D,,27,0,0,0,0
30,8471699,Andrew Cogliano,C,,37,0,0,0,0
30,8481521,Ronnie Attard,D,PHI,25,0,0,0,0
30,8481161,Jake Christiansen,D,CBJ,25,0,0,0,0
30,8479458,Nikita Zaitsev,D,,33,0,0,0,0
30,8479619,Michael Carcone,L,UTA,28,0,0,0,0
30,8479026,Philippe Myers,D,TOR,27,0,0,0,0
30,8477330,Dominik Kubalik,L,,29,0,0,0,0
30,8481617,Vasily Podkolzin,R,VAN,23,0,0,0,0
30,8481701,Santeri Hatakka,D,NJD,23,0,0,0,0
30,8479514,Rem Pitlick,C,,27,0,0,0,0
30,8477446,Michael McCarron,R,NSH,29,0,0,0,0
30,8470604,Jeff Carter,C,,39,0,0,0,0
30,8482241,Radim Zohorna,L,,28,0,0,0,0
30,8480289,Morgan Barron,C,WPG,26,0,0,0,0
30,8479379,Givani Smith,R,SJS,26,0,0,0,0
30,8480216,Jacob Peterson,C,,25,0,0,0,0
30,8477851,Jordan Oesterle,D,BOS,32,0,0,0,0
30,8484258,Sam Malinski,D,COL,26,0,0,0,0
30,8478904,Steven Lorentz,C,,28,0,0,0,0
30,8482095,Tyler Kleven,D,OTT,22,0,0,0,0
30,8480848,Ty Dellandrea,C,SJS,24,0,0,0,0
30,8476884,Derrick Pouliot,D,,30,0,0,0,0
30,8479336,Carl Grundstrom,R,SJS,27,0,0,0,0
30,8482964,Arber Xhekaj,D,MTL,23,0,0,0,0
30,8471686,Marc Staal,D,,37,0,0,0,0
30,8477887,Patrick Brown,C,BOS,32,0,0,0,0
30,8478495,Denis Gurianov,R,,27,0,0,0,0
30,8473504,Cal Clutterbuck,R,,37,0,0,0,0
30,8481550,Adam Beckman,L,NJD,23,0,0,0,0
30,8480845,Rasmus Kupari,C,WPG,24,0,0,0,0
30,8474009,Nick Bonino,C,,36,0,0,0,0
30,8478585,Derek Ryan,C,EDM,38,0,0,0,0
30,8477962,Brendan Lemieux,L,CAR,28,0,0,0,0
30,8482861,Vincent Iorio,D,WSH,22,0,0,0,0
30,8479378,Logan Stanley,D,WPG,26,0,0,0,0
30,8473446,Erik Johnson,D,PHI,36,0,0,0,0
30,8481743,Marc Del Gaizo,D,NSH,25,0,0,0,0
30,8477384,Josh Brown,D,EDM,30,0,0,0,0
30,8482165,Yan Kuznetsov,D,CGY,22,0,0,0,0
30,8478424,Jansen Harkins,C,ANA,27,0,0,0,0
30,8482144,Jack Thompson,D,SJS,22,0,0,0,0
30,8478512,Austin Czarnik,C,,32,0,0,0,0
30,8477527,Ross Johnston,L,ANA,30,0,0,0,0
30,8479383,Boris Katchouk,L,,26,0,0,0,0
30,8482094,Daemon Hunt,D,MIN,22,0,0,0,0
30,8481719,Maxwell Crozier,D,TBL,24,0,0,0,0
30,8480192,Johnathan Kovacevic,D,NJD,27,0,0,0,0
30,8479376,Victor Mete,D,,26,0,0,0,0
30,8482511,Mason Lohrei,D,BOS,23,0,0,0,0
30,8475825,Jani Hakanpää,D,,32,0,0,0,0
30,8478021,William Lagesson,D,DET,28,0,0,0,0
30,8475795,Dylan McIlrath,D,WSH,32,0,0,0,0
30,8477846,Ryan Carpenter,C,,33,0,0,0,0
30,8481056,Spencer Stastney,D,NSH,24,0,0,0,0
30,8481564,Ryan Johnson,D,BUF,23,0,0,0,0
30,8478017,Mark Friedman,D,VAN,29,0,0,0,0
30,8479320,Max Lajoie,D,SEA,27,0,0,0,0
30,8480075,Cameron Crotty,D,MIN,25,0,0,0,0
30,8484287,Cole McWard,D,VAN,23,0,0,0,0
30,8484254,Akito Hirose,D,VAN,25,0,0,0,0
30,8483407,Brandon Scanlin,D,NYR,25,0,0,0,0
30,8480274,Philip Kemp,D,EDM,25,0,0,0,0
30,8479522,Hardy Haman Aktell,D,WSH,26,0,0,0,0
30,8480007,Jonas Rondbjerg,R,VGK,25,0,0,0,0
30,8477454,Adam Erne,L,,29,0,0,0,0
30,8481679,Maxence Guenette,D,OTT,23,0,0,0,0
30,8480441,Trey Fix-Wolansky,R,CBJ,25,0,0,0,0
30,8483546,Marshall Rifai,D,TOR,26,0,0,0,0
30,8480084,Nick DeSimone,D,NJD,30,0,0,0,0
30,8481030,Jack St. Ivany,D,PIT,25,0,0,0,0
30,8481592,Jakob Pelletier,L,CGY,23,0,0,0,0
30,8478011,Louie Belpedio,D,PHI,28,0,0,0,0
30,8477930,Pierre-Edouard Bellemare,L,,39,0,0,0,0
30,8484321,Nikolas Matinpalo,D,OTT,26,0,0,0,0
30,8482067,Connor Mackey,D,NYR,28,0,0,0,0
30,8481806,Louis Crevier,D,CHI,23,0,0,0,0
30,8484326,Patrik Koch,D,UTA,28,0,0,0,0
30,8477971,Andreas Englund,D,LAK,28,0,0,0,0
30,8481751,Lukas Rousek,R,BUF,25,0,0,0,0
30,8481006,Tyler Tucker,D,STL,24,0,0,0,0
30,8476867,Brendan Gaunce,C,MIN,30,0,0,0,0
30,8479520,Brandon Duhaime,R,WSH,27,0,0,0,0
30,8477073,Kurtis MacDermid,L,NJD,30,0,0,0,0
30,8480874,Adam Ginning,D,PHI,24,0,0,0,0
30,8477473,Justin Bailey,R,SJS,29,0,0,0,0
30,8479066,Ryan Lomberg,L,CGY,30,0,0,0,0
30,8477070,Liam O'Brien,C,UTA,30,0,0,0,0
30,8474618,Marco Scandella,D,,34,0,0,0,0
30,8475797,Jarred Tinordi,D,,32,0,0,0,0
30,8481441,Joe Snively,C,DET,28,0,0,0,0
30,8477244,Chad Ruhwedel,D,NYR,34,0,0,0,0
30,8479772,Zack MacEwen,R,OTT,28,0,0,0,0
30,8481147,Reese Johnson,C,MIN,26,0,0,0,0
30,8481043,Cole Koepke,L,BOS,26,0,0,0,0
30,8483619,Filip Roos,D,OTT,25,0,0,0,0
30,8481541,Samuel Bolduc,D,NYI,24,0,0,0,0
30,8477810,Joel Hanley,D,CGY,33,0,0,0,0
30,8476907,Mackenzie MacEachern,L,,30,0,0,0,0
30,8482652,Walker Duehr,R,CGY,27,0,0,0,0
30,8477126,Jayson Megna,C,,34,0,0,0,0
30,8483398,Declan Carlile,D,TBL,31,0,0,0,0
30,8482929,Emil Lilleberg,D,TBL,23,0,0,0,0
30,8480880,Jakub Lauko,C,MIN,24,0,0,0,0
30,8480245,Olle Lycksell,R,PHI,25,0,0,0,0
30,8480252,Cole Guttman,C,CHI,25,0,0,0,0
30,8477467,Gustav Olofsson,D,SEA,30,0,0,0,0
30,8479968,Vinni Lettieri,C,BOS,29,0,0,0,0
30,8478400,Colin White,C,,27,0,0,0,0
30,8475755,Alexander Petrovic,D,DAL,32,0,0,0,0
30,8481812,Nikolai Knyzhov,D,,27,0,0,0,0
30,8481593,Jayden Struble,D,MTL,23,0,0,0,0
30,8481532,Alex Turcotte,C,LAK,23,0,0,0,0
30,8482126,Emil Andrae,D,PHI,31,0,0,0,0
30,8479944,Zach Aston-Reese,C,VGK,30,0,0,0,0
30,8471817,Ryan Reaves,R,TOR,37,0,0,0,0
30,8481206,John Ludvig,D,PIT,24,0,0,0,0
30,8481599,Victor Soderstrom,D,UTA,23,0,0,0,0
30,8480292,Carson Meyer,R,ANA,27,0,0,0,0
30,8482496,Nils Aman,C,VAN,24,0,0,0,0
30,8479718,Alex Barré-Boulet,C,MTL,27,0,0,0,0
30,8479994,Jaret Anderson-Dolan,C,WPG,25,0,0,0,0
30,8480184,Gustav Lindstrom,D,,26,0,0,0,0
30,8480890,Jan Jenik,R,OTT,24,0,0,0,0
30,8478067,Oskar Lindblom,L,,28,0,0,0,0
30,8476934,Brock McGinn,L,ANA,30,0,0,0,0
30,8479985,Cale Fleury,D,SEA,26,0,0,0,0
30,8484304,Uvis Balinskis,D,FLA,28,0,0,0,0
30,8479981,Jonah Gadjovich,L,FLA,26,0,0,0,0
30,8481716,Dmitri Voronkov,L,CBJ,24,0,0,0,0
30,8474709,Matt Martin,L,,35,0,0,0,0
30,8482634,Alex Steeves,C,TOR,25,0,0,0,0
30,8480823,Alexander Alexeyev,D,WSH,25,0,0,0,0
30,8477541,Dakota Mermis,D,TOR,30,0,0,0,0
30,8483491,Ivan Miroshnichenko,L,WSH,20,0,0,0,0
30,8478477,Mitchell Stephens,C,SEA,27,0,0,0,0
30,8481543,Nikita Alexandrov,C,STL,24,0,0,0,0
30,8479423,Alex Nylander,L,,26,0,0,0,0
30,8482451,Mikael Pyyhtia,L,CBJ,23,0,0,0,0
30,8478831,Kevin Stenlund,C,UTA,28,0,0,0,0
30,8480306,Grant Hutton,D,NYI,29,0,0,0,0
30,8478028,Fredrik Olofsson,L,,28,0,0,0,0
30,8477462,Robert Hagg,D,VGK,29,0,0,0,0
30,8477320,Anton Blidh,L,NYR,29,0,0,0,0
30,8482157,Will Cuylle,L,NYR,22,0,0,0,0
30,8482737,Zack Bolduc,C,STL,21,0,0,0,0
30,8481239,Samuel Fagemo,L,,24,0,0,0,0
30,8481600,Tobias Bjornfot,D,FLA,23,0,0,0,0
30,8478409,Anthony Richard,C,PHI,28,0,0,0,0
30,8474145,Robert Bortuzzo,D,,35,0,0,0,0
30,8475958,Michael Sgarbossa,C,WSH,32,0,0,0,0
30,8479986,Kole Lind,R,DAL,26,0,0,0,0
30,8479249,Andrew Poturalski,C,SJS,30,0,0,0,0
30,8479362,Riley Tufte,L,BOS,26,0,0,0,0
30,8479991,Jake Leschyshyn,C,NYR,25,0,0,0,0
30,8479587,Rhett Gardner,C,PHI,28,0,0,0,0
30,8482744,James Malatesta,L,CBJ,21,0,0,0,0
30,8478854,Ryan Shea,D,PIT,27,0,0,0,0
30,8481591,Sam Poulin,R,,23,0,0,0,0
30,8483512,Matt Savoie,C,EDM,20,0,0,0,0
30,8482102,Vasily Ponomarev,C,PIT,22,0,0,0,0
30,8482162,Roby Jarventie,L,EDM,22,0,0,0,0
30,8481016,Ruslan Iskhakov,C,,24,0,0,0,0
30,8482172,Landon Slaggert,L,CHI,22,0,0,0,0
30,8482747,Brennan Othmann,L,NYR,21,0,0,0,0
30,8480031,Maxime Comtois,L,,25,0,0,0,0
30,8480226,Marián Studenic,R,,26,0,0,0,0
30,8478408,Travis Dermott,D,,28,0,0,0,0
30,8481518,Nolan Foote,L,NJD,24,0,0,0,0
30,8479419,Brett Murray,L,BUF,26,0,0,0,0
30,8482088,Justin Sourdif,R,FLA,22,0,0,0,0
30,8482201,Gage Goncalves,C,TBL,23,0,0,0,0
30,8481578,Graeme Clarke,R,MIN,23,0,0,0,0
30,8482177,Marat Khusnutdinov,C,MIN,22,0,0,0,0
30,8481754,Nikita Nesterenko,C,ANA,23,0,0,0,0
30,8483531,Brian Halonen,L,NJD,25,0,0,0,0
30,8483920,Pierrick Dube,R,WSH,23,0,0,0,0
30,8480851,Akil Thomas,C,LAK,24,0,0,0,0
30,8475235,Nicolas Deslauriers,L,PHI,33,0,0,0,0
30,8482476,Emil Heineman,L,MTL,23,0,0,0,0
30,8477149,Scott Sabourin,R,SJS,32,0,0,0,0
30,8483549,Lucas Condotta,L,MTL,27,0,0,0,0
30,8482765,Isak Rosen,R,BUF,21,0,0,0,0
30,8481237,Kyle MacLean,C,NYI,25,0,0,0,0
30,8481024,Linus Karlsson,C,VAN,25,0,0,0,0
30,8481690,Tyler Angle,C,,24,0,0,0,0
30,8483570,Ben Meyers,C,SEA,26,0,0,0,0
30,8481655,Cole Schwindt,R,CGY,23,0,0,0,0
30,8481462,Mason Morelli,L,VGK,28,0,0,0,0
30,8483401,Marc Johnstone,R,PIT,28,0,0,0,0
30,8478956,Samuel Laberge,L,NJD,27,0,0,0,0
30,8479533,Joona Koppanen,L,,26,0,0,0,0
30,8482197,Adam Raska,R,MIN,23,0,0,0,0
30,8482250,Callahan Burke,C,VGK,27,0,0,0,0
30,8482784,Zach Dean,C,STL,21,0,0,0,0
30,8484255,Jason Polin,R,COL,25,0,0,0,0
30,8481077,John Leonard,L,,26,0,0,0,0
30,8481534,Raphael Lavoie,C,EDM,24,0,0,0,0
30,8483609,Adam Klapka,R,CGY,24,0,0,0,0
30,8482751,Ryan Winterton,C,SEA,21,0,0,0,0
30,8480267,Sammy Walker,C,MIN,25,0,0,0,0
30,8475766,Austin Watson,L,,32,0,0,0,0
30,8482460,Matt Rempe,C,NYR,22,0,0,0,0
30,8481065,Angus Crookshank,L,OTT,25,0,0,0,0
30,8481070,Hugh McGing,L,,26,0,0,0,0
30,8476323,Max McCormick,L,SEA,32,0,0,0,0
30,8483395,Arshdeep Bains,L,VAN,23,0,0,0,0
30,8484259,Ondrej Pavel,C,COL,31,0,0,0,0
30,8483432,Luca Del Bel Belluz,C,CBJ,31,0,0,0,0
30,8483045,Cameron Butler,R,CBJ,31,0,0,0,0
30,8482061,Brandon Biro,L,SEA,26,0,0,0,0
30,8477401,John Hayden,C,SEA,29,0,0,0,0
30,8475278,Byron Froese,C,,33,0,0,0,0
30,8478446,Glenn Gawdin,C,LAK,27,0,0,0,0
30,8477993,Justin Kirkland,C,CGY,28,0,0,0,0
30,8482147,Jean-Luc Foudy,C,COL,22,0,0,0,0
30,8480032,Shane Bowers,C,NJD,25,0,0,0,0
30,8479330,Brandon Gignac,C,MTL,27,0,0,0,0
30,8480776,Sheldon Rempal,R,,29,0,0,0,0
30,8475413,Justin Dowling,C,NJD,34,0,0,0,0
30,8481726,Adam Edstrom,C,NYR,24,0,0,0,0
30,8480844,Grigori Denisenko,L,VGK,24,0,0,0,0
30,8478147,Bokondji Imama,L,PIT,28,0,0,0,0
30,8478881,Brett Seney,L,CHI,28,0,0,0,0
30,8483630,Pavol Regenda,L,ANA,25,0,0,0,0
30,8480836,Jonathan Gruden,C,,24,0,0,0,0
30,8484314,Jiri Smejkal,L,,28,0,0,0,0
30,8475780,Chris Wagner,R,COL,33,0,0,0,0
30,8479546,Oskar Steen,C,,26,0,0,0,0
30,8483597,Milos Kelemen,L,UTA,25,0,0,0,0
30,8481789,Tye Kartye,L,SEA,23,0,0,0,0
30,8484325,Waltteri Merela,C,TBL,26,0,0,0,0
30,8479421,Jacob Moverare,D,LAK,26,0,0,0,0
30,8481585,Egor Afanasyev,L,SJS,23,0,0,0,0
30,8479547,Matthew Phillips,R,,26,0,0,0,0
30,8479367,William Lockwood,R,FLA,26,0,0,0,0
30,8476915,Jujhar Khaira,L,,30,0,0,0,0
30,8481422,Jacob Lucchini,C,NSH,29,0,0,0,0
30,8480468,James Hamblin,L,EDM,25,0,0,0,0
30,8478051,Max Willman,C,NJD,29,0,0,0,0
30,8481556,John Beecher,C,BOS,23,0,0,0,0
30,8478078,Rourke Chartier,C,,28,0,0,0,0
31,8478402,Connor McDavid,C,EDM,27,82,48,94,142
31,8477492,Nathan MacKinnon,C,COL,29,82,54,85,139
31,8479318,Auston Matthews,C,TOR,27,82,62,61,123
31,8477934,Leon Draisaitl,C,EDM,29,82,41,75,116
31,8481559,Jack Hughes,C,NJD,23,82,43,69,112
31,8476453,Nikita Kucherov,R,TBL,31,82,27,81,108
31,8477493,Aleksander Barkov,C,FLA,29,82,27,80,107
31,8480012,Elias Pettersson,C,VAN,26,82,37,67,104
31,8477939,William Nylander,R,TOR,28,82,45,57,102
31,8478420,Mikko Rantanen,R,COL,28,82,44,56,100
31,8475172,Nazem Kadri,C,CGY,34,82,36,64,100
31,8477956,David Pastrnak,R,BOS,28,82,53,42,95
31,8478550,Artemi Panarin,L,NYR,33,82,30,65,95
31,8480800,Quinn Hughes,D,VAN,25,82,7,88,95
31,8478398,Kyle Connor,L,WPG,28,82,49,45,94
31,8476468,J.T. Miller,C,VAN,31,82,35,59,94
31,8479407,Jesper Bratt,L,NJD,26,82,42,51,93
31,8476887,Filip Forsberg,L,NSH,30,82,39,53,92
31,8475166,John Tavares,C,TOR,34,82,37,55,92
31,8477946,Dylan Larkin,C,DET,28,82,43,48,91
31,8477404,Jake Guentzel,C,TBL,30,82,40,51,91
31,8480830,Andrei Svechnikov,R,CAR,24,82,36,54,90
31,8474578,Erik Karlsson,D,PIT,34,82,17,73,90
31,8480069,Cale Makar,D,COL,26,82,23,66,89
31,8479323,Adam Fox,D,NYR,26,82,23,66,89
31,8474564,Steven Stamkos,C,NSH,34,82,43,45,88
31,8477949,Alex Tuch,R,BUF,28,82,31,57,88
31,8478403,Jack Eichel,C,VGK,28,82,44,43,87
31,8480801,Brady Tkachuk,L,OTT,25,82,38,49,87
31,8479343,Clayton Keller,R,UTA,26,82,38,49,87
31,8479314,Matthew Tkachuk,L,FLA,27,82,22,65,87
31,8481523,Kirby Dach,C,MTL,23,82,16,70,86
31,8471675,Sidney Crosby,C,PIT,37,82,36,49,85
31,8477942,Kevin Fiala,L,LAK,28,82,27,58,85
31,8480002,Nico Hischier,C,NJD,25,82,37,47,84
31,8477402,Pavel Buchnevich,L,STL,29,82,30,54,84
31,8480036,Miro Heiskanen,D,DAL,25,82,24,60,84
31,8475692,Mats Zuccarello,R,MIN,37,82,24,60,84
31,8477504,Josh Morrissey,D,WPG,29,82,14,69,83
31,8479420,Tage Thompson,C,BUF,27,82,44,38,82
31,8478010,Brayden Point,C,TBL,28,82,39,43,82
31,8471215,Evgeni Malkin,C,PIT,38,82,34,48,82
31,8478873,Troy Terry,R,ANA,27,82,30,52,82
31,8473419,Brad Marchand,L,BOS,36,82,25,57,82
31,8479339,Patrik Laine,L,CBJ,26,82,41,40,81
31,8482093,Seth Jarvis,C,CAR,22,82,38,43,81
31,8479337,Alex DeBrincat,R,DET,27,82,33,48,81
31,8471214,Alex Ovechkin,L,WSH,39,82,32,49,81
31,8475913,Mark Stone,R,VGK,32,82,31,50,81
31,8476389,Vincent Trocheck,C,NYR,31,82,36,44,80
31,8478427,Sebastian Aho,C,CAR,27,82,31,49,80
31,8479385,Jordan Kyrou,C,STL,26,82,30,50,80
31,8482116,Tim Stützle,C,OTT,22,82,24,56,80
31,8475168,Matt Duchene,C,DAL,33,82,38,41,79
31,8477933,Sam Reinhart,C,FLA,29,82,36,43,79
31,8477960,Adrian Kempe,R,LAK,28,82,43,35,78
31,8478864,Kirill Kaprizov,L,MIN,27,82,28,50,78
31,8478445,Mathew Barzal,C,NYI,27,82,25,53,78
31,8474600,Roman Josi,D,NSH,34,82,17,61,78
31,8478401,Pavel Zacha,C,BOS,27,82,36,41,77
31,8480027,Jason Robertson,L,DAL,25,82,31,45,76
31,8476454,Ryan Nugent-Hopkins,C,EDM,31,82,21,55,76
31,8478444,Brock Boeser,R,VAN,27,82,34,41,75
31,8476460,Mark Scheifele,C,WPG,31,82,28,47,75
31,8478439,Travis Konecny,R,PHI,27,82,27,48,75
31,8480023,Robert Thomas,C,STL,25,82,23,52,75
31,8482078,Lucas Raymond,L,DET,22,82,34,40,74
31,8478449,Roope Hintz,C,DAL,28,82,29,45,74
31,8476459,Mika Zibanejad,C,NYR,31,82,26,48,74
31,8474590,John Carlson,D,WSH,34,82,19,55,74
31,8477447,Shea Theodore,D,VGK,29,82,15,59,74
31,8478414,Timo Meier,R,NJD,28,82,36,37,73
31,8477940,Nikolaj Ehlers,L,WPG,28,82,24,48,72
31,8478440,Dylan Strome,C,WSH,27,82,23,49,72
31,8480014,Gabriel Vilardi,C,WPG,25,82,48,23,71
31,8475784,Jeff Skinner,C,EDM,32,82,42,29,71
31,8481557,Matt Boldy,L,MIN,23,82,32,39,71
31,8475786,Zach Hyman,L,EDM,32,82,30,41,71
31,8474150,Mikael Backlund,C,CGY,35,82,26,45,71
31,8477951,Nick Schmaltz,C,UTA,28,82,23,48,71
31,8476875,Mike Matheson,D,MTL,30,82,19,52,71
31,8480803,Evan Bouchard,D,EDM,25,82,15,56,71
31,8476483,Rickard Rakell,R,PIT,31,82,35,35,70
31,8476448,William Karlsson,C,VGK,31,82,27,43,70
31,8480018,Nick Suzuki,C,MTL,25,82,26,44,70
31,8476346,Johnny Gaudreau,L,CBJ,31,82,12,58,70
31,8476399,Blake Coleman,C,CGY,33,82,41,28,69
31,8477409,Carter Verhaeghe,C,FLA,29,82,36,32,68
31,8478460,Zach Werenski,D,CBJ,27,82,21,47,68
31,8476853,Morgan Rielly,D,TOR,30,82,10,58,68
31,8478493,Joel Eriksson Ek,C,MIN,27,82,30,37,67
31,8476881,Tomas Hertl,C,VGK,31,82,24,43,67
31,8476539,Jonathan Marchessault,R,NSH,34,82,21,46,67
31,8478042,Viktor Arvidsson,R,EDM,31,82,26,40,66
31,8476905,Chandler Stephenson,C,SEA,30,82,24,42,66
31,8475167,Victor Hedman,D,TBL,34,82,15,51,66
31,8475754,Brock Nelson,C,NYI,33,82,28,37,65
31,8474141,Patrick Kane,R,DET,36,82,25,40,65
31,8481581,Thomas Harley,D,DAL,23,82,20,45,65
31,8480865,Noah Dobson,D,NYI,24,82,8,57,65
31,8475191,Reilly Smith,R,NYR,33,82,30,34,64
31,8482124,Quinton Byfield,R,LAK,22,82,25,39,64
31,8479542,Brandon Hagel,L,TBL,26,82,30,33,63
31,8480208,Drake Batherson,R,OTT,26,82,27,36,63
31,8479675,Trevor Moore,L,LAK,29,82,27,36,63
31,8478047,Michael Bunting,L,PIT,29,82,23,40,63
31,8479425,Filip Hronek,D,VAN,27,82,16,47,63
31,8477501,Valeri Nichushkin,R,COL,29,82,36,26,62
31,8477955,Jared McCann,L,SEA,28,82,33,29,62
31,8480459,Pius Suter,C,VAN,28,82,28,34,62
31,8480028,Morgan Frost,C,PHI,25,82,24,38,62
31,8475765,Vladimir Tarasenko,R,DET,33,82,22,40,62
31,8471685,Anze Kopitar,C,LAK,37,82,17,45,62
31,8480839,Rasmus Dahlin,D,BUF,24,82,16,46,62
31,8476456,Jonathan Huberdeau,C,CGY,31,82,14,48,62
31,8474565,Alex Pietrangelo,D,VGK,34,82,14,48,62
31,8477497,Sean Monahan,C,CBJ,30,82,27,34,61
31,8478397,Rasmus Andersson,D,CGY,28,82,11,50,61
31,8477416,Oliver Bjorkstrand,R,SEA,29,82,33,27,60
31,8481540,Cole Caufield,R,MTL,23,82,32,28,60
31,8478542,Evan Rodrigues,C,FLA,31,82,28,32,60
31,8482665,Matty Beniers,C,SEA,22,82,24,36,60
31,8481528,Dylan Cozens,C,BUF,23,82,23,37,60
31,8475158,Ryan O'Reilly,C,NSH,33,82,23,37,60
31,8478498,Jake DeBrusk,L,VAN,28,82,35,24,59
31,8480015,Owen Tippett,R,PHI,25,82,34,25,59
31,8474102,David Perron,L,OTT,36,82,21,38,59
31,8482109,Alexis Lafrenière,L,NYR,23,82,29,29,58
31,8477496,Elias Lindholm,C,BOS,30,82,21,37,58
31,8473512,Claude Giroux,R,OTT,36,82,18,40,58
31,8479410,Mikhail Sergachev,D,UTA,26,82,10,48,58
31,8475745,Charlie Coyle,C,BOS,32,82,21,36,57
31,8481711,Matias Maccelli,L,UTA,24,82,20,37,57
31,8475798,Mikael Granlund,C,SJS,32,82,16,41,57
31,8480798,Philipp Kurashev,C,CHI,25,82,15,42,57
31,8481533,Trevor Zegras,C,ANA,23,82,12,45,57
31,8477503,Max Domi,C,TOR,29,82,12,45,57
31,8475184,Chris Kreider,L,NYR,33,82,34,22,56
31,8476880,Tom Wilson,R,WSH,30,82,34,22,56
31,8473986,Alex Killorn,L,ANA,35,82,28,28,56
31,8478458,Jack Roslovic,C,CAR,27,82,26,30,56
31,8480829,Jesperi Kotkaniemi,C,CAR,24,82,26,30,56
31,8481596,Shane Pinto,C,OTT,24,82,22,34,56
31,8477511,Anthony Mantha,R,CGY,30,82,21,35,56
31,8478975,Mason Marchment,L,DAL,29,82,18,38,56
31,8478856,Conor Garland,R,VAN,28,82,18,38,56
31,8478407,Vince Dunn,D,SEA,28,82,9,47,56
31,8478519,Anthony Cirelli,C,TBL,27,82,26,29,55
31,8475810,Bryan Rust,R,PIT,32,82,24,31,55
31,8476479,Phillip Danault,C,LAK,31,82,24,31,55
31,8478057,Dakota Joshua,C,VAN,28,82,22,33,55
31,8477500,Bo Horvat,C,NYI,29,82,32,22,54
31,8471698,T.J. Oshie,R,WSH,38,82,29,25,54
31,8476826,Yanni Gourde,C,SEA,33,82,18,36,54
31,8477494,Jonathan Drouin,L,COL,29,82,17,37,54
31,8482159,Tyson Foerster,R,PHI,22,82,28,25,53
31,8481618,Alex Newhook,C,MTL,23,82,22,31,53
31,8473994,Jamie Benn,L,DAL,35,82,22,31,53
31,8476958,Jaccob Slavin,D,CAR,30,82,9,44,53
31,8480039,Martin Necas,C,CAR,25,82,25,27,52
31,8477479,Tyler Bertuzzi,L,CHI,29,82,24,28,52
31,8480078,Filip Chytil,C,NYR,25,82,20,32,52
31,8477986,Brandon Montour,D,SEA,30,82,17,35,52
31,8479999,Casey Mittelstadt,C,COL,26,82,15,37,52
31,8479325,Charlie McAvoy,D,BOS,27,82,10,42,52
31,8481542,Moritz Seider,D,DET,23,82,7,45,52
31,8476432,Boone Jenner,C,CBJ,31,82,25,26,51
31,8482740,Wyatt Johnston,C,DAL,21,82,25,26,51
31,8478462,Nicolas Roy,C,VGK,27,82,22,29,51
31,8480797,Joel Farabee,L,PHI,24,82,20,31,51
31,8477932,Aaron Ekblad,D,FLA,28,82,20,31,51
31,8483515,Juraj Slafkovsky,L,MTL,20,82,19,32,51
31,8474679,Gustav Nyquist,C,NSH,35,82,16,35,51
31,8478038,Devon Toews,D,COL,30,82,15,36,51
31,8478396,Noah Hanifin,D,VGK,27,82,14,37,51
31,8475169,Evander Kane,L,EDM,33,82,26,24,50
31,8478463,Anthony Beauvillier,L,PIT,27,82,25,25,50
31,8479987,Morgan Geekie,C,BOS,26,82,22,28,50
31,8479525,Ross Colton,C,COL,28,82,22,28,50
31,8477451,Ryan Hartman,R,MIN,30,82,21,29,50
31,8479400,Pierre-Luc Dubois,L,WSH,26,82,19,31,50
31,8476458,Ryan Strome,C,ANA,31,82,18,32,50
31,8476882,Teuvo Teravainen,L,CHI,30,82,16,34,50
31,8475218,Mattias Ekholm,D,EDM,34,82,16,34,50
31,8477346,MacKenzie Weegar,D,CGY,30,82,15,35,50
31,8474563,Drew Doughty,D,LAK,35,82,13,37,50
31,8474716,Jared Spurgeon,D,MIN,35,82,12,38,50
31,8476923,Damon Severson,D,CBJ,30,82,11,39,50
31,8476462,Dougie Hamilton,D,NJD,31,82,8,42,50
31,8484144,Connor Bedard,C,CHI,19,82,23,26,49
31,8477407,Anthony Duclair,L,NYI,29,82,22,27,49
31,8477935,Sam Bennett,C,FLA,28,82,22,27,49
31,8477476,Artturi Lehkonen,L,COL,29,82,22,27,49
31,8478233,Andrew Mangiapane,L,WSH,28,82,22,27,49
31,8482092,Ridly Greig,C,OTT,22,82,19,30,49
31,8482097,Jack Quinn,R,BUF,23,82,13,36,49
31,8470613,Brent Burns,D,CAR,39,82,11,38,49
31,8475768,Jaden Schwartz,C,SEA,32,82,23,25,48
31,8482705,Cole Sillinger,C,CBJ,21,82,22,26,48
31,8478438,Tommy Novak,C,NSH,27,82,22,26,48
31,8482110,Dawson Mercer,C,NJD,23,82,21,27,48
31,8475287,Erik Haula,L,NJD,33,82,20,28,48
31,8477444,Andre Burakovsky,L,SEA,29,82,16,32,48
31,8479345,Jakob Chychrun,D,WSH,26,82,16,32,48
31,8482089,Jake Neighbours,L,STL,22,82,28,19,47
31,8477952,Robby Fabbri,C,ANA,28,82,27,20,47
31,8475799,Nino Niederreiter,R,WPG,32,82,26,21,47
31,8475151,Kyle Palmieri,C,NYI,33,82,24,23,47
31,8478474,Lawson Crouse,L,UTA,27,82,22,25,47
31,8478115,Pierre Engvall,L,NYI,28,82,20,27,47
31,8480009,Eeli Tolvanen,R,SEA,25,82,20,27,47
31,8477021,Alex Kerfoot,C,UTA,30,82,18,29,47
31,8482113,Anton Lundell,C,FLA,23,82,17,30,47
31,8482055,Drew O'Connor,L,PIT,26,82,16,31,47
31,8481656,Aliaksei Protas,C,WSH,23,82,15,32,47
31,8474586,Jordan Eberle,R,SEA,34,82,13,34,47
31,8476792,Torey Krug,D,STL,33,82,12,35,47
31,8471724,Kris Letang,D,PIT,37,82,8,39,47
31,8482684,Luke Hughes,D,NJD,21,82,8,39,47
31,8480064,Josh Norris,C,OTT,25,82,25,21,46
31,8474641,Adam Henrique,C,EDM,34,82,23,23,46
31,8483808,Andrei Kuzmenko,L,CGY,28,82,22,24,46
31,8474149,Evgenii Dadonov,R,DAL,35,82,21,25,46
31,8477964,Ivan Barbashev,C,VGK,29,82,20,26,46
31,8479992,Michael Rasmussen,C,DET,25,82,18,28,46
31,8475764,Cam Fowler,D,ANA,33,82,8,38,46
31,8481068,Yegor Sharangovich,C,CGY,26,82,26,19,45
31,8475722,Jason Zucker,L,BUF,32,82,22,23,45
31,8475726,Tyler Toffoli,C,SJS,32,82,21,24,45
31,8481624,Ilya Mikheyev,R,CHI,30,82,18,27,45
31,8482720,Matthew Knies,L,TOR,22,82,15,30,45
31,8481582,Nicholas Robertson,L,TOR,23,82,15,30,45
31,8477495,Seth Jones,D,CHI,30,82,12,33,45
31,8477998,Warren Foegele,L,LAK,28,82,26,18,44
31,8482146,Luke Evangelista,R,NSH,22,82,23,21,44
31,8475170,Brayden Schenn,C,STL,33,82,22,22,44
31,8475794,Tyler Seguin,C,DAL,32,82,22,22,44
31,8482175,JJ Peterka,R,BUF,22,82,19,25,44
31,8474053,Logan Couture,C,SJS,35,82,18,26,44
31,8480434,Sean Durzi,D,UTA,26,82,14,30,44
31,8481535,Nils Hoglander,L,VAN,24,82,30,13,43
31,8475791,Taylor Hall,L,CHI,33,82,16,27,43
31,8476869,Brady Skjei,D,NSH,30,82,13,30,43
31,8482699,Dylan Guenther,R,UTA,21,82,21,21,42
31,8476474,Stefan Noesen,R,NJD,31,82,21,21,42
31,8476419,Jean-Gabriel Pageau,C,NYI,32,82,19,23,42
31,8480849,Barrett Hayton,C,UTA,24,82,18,24,42
31,8478133,Jake Evans,C,MTL,28,82,17,25,42
31,8481013,Jonatan Berggren,R,DET,24,82,15,27,42
31,8477947,Sonny Milano,L,WSH,28,82,12,30,42
31,8482624,Daniil Miromanov,D,CGY,27,82,11,31,42
31,8476854,Hampus Lindholm,D,BOS,30,82,3,39,42
31,8482745,Mason McTavish,C,ANA,21,82,21,20,41
31,8478109,Victor Olofsson,L,VGK,29,82,20,21,41
31,8478366,Frank Vatrano,R,ANA,30,82,18,23,41
31,8482667,William Eklund,L,SJS,22,82,17,24,41
31,8475314,Anders Lee,L,NYI,34,82,24,16,40
31,8482475,Yegor Chinakhov,R,CBJ,23,82,18,22,40
31,8478472,Mathieu Joseph,R,STL,27,82,18,22,40
31,8478891,Mason Appleton,C,WPG,28,82,12,28,40
31,8476885,Jacob Trouba,D,NYR,30,82,8,32,40
31,8474151,Ryan McDonagh,D,TBL,35,82,3,37,40
31,8480188,Fabian Zetterlund,L,SJS,25,82,18,21,39
31,8476872,Scott Laughton,C,PHI,30,82,15,24,39
31,8473533,Jordan Staal,C,CAR,36,82,14,25,39
31,8476906,Shayne Gostisbehere,D,CAR,31,82,13,26,39
31,8475848,Brendan Gallagher,R,MTL,32,82,13,26,39
31,8482105,Jake Sanderson,D,OTT,22,82,13,26,39
31,8482671,Owen Power,D,BUF,22,82,12,27,39
31,8475171,Oliver Ekman-Larsson,D,TOR,33,82,10,29,39
31,8480145,Neal Pionk,D,WPG,29,82,10,29,39
31,8476480,Vladislav Namestnikov,C,WPG,32,82,10,29,39
31,8475793,Ryan Johansen,C,PHI,32,82,19,19,38
31,8481553,Bobby Brink,R,PHI,23,82,19,19,38
31,8475714,Calle Jarnkrok,C,TOR,33,82,18,20,38
31,8480068,Ryan Poehling,C,PHI,25,82,18,20,38
31,8480802,Ryan McLeod,C,BUF,25,82,17,21,38
31,8482149,Cole Perfetti,C,WPG,22,82,11,27,38
31,8477969,Marcus Pettersson,D,PIT,28,82,10,28,38
31,8477506,Ryan Pulock,D,NYI,30,82,5,33,38
31,8482259,Bobby McMann,C,TOR,28,82,26,11,37
31,8476438,Brandon Saad,L,STL,32,82,23,14,37
31,8481580,Connor McMichael,C,WSH,23,82,22,15,37
31,8479365,Trent Frederic,C,BOS,26,82,19,18,37
31,8481554,Kaapo Kakko,R,NYR,23,82,18,19,37
31,8476981,Josh Anderson,R,MTL,30,82,17,20,37
31,8473422,Nick Foligno,L,CHI,37,82,17,20,37
31,8478046,Danton Heinen,L,VAN,29,82,16,21,37
31,8482660,Kent Johnson,C,CBJ,22,82,16,21,37
31,8480813,Joe Veleno,C,DET,24,82,16,21,37
31,8475763,Kevin Hayes,R,PIT,32,82,15,22,37
31,8479390,Taylor Raddysh,R,WSH,26,82,14,23,37
31,8480748,Kiefer Sherwood,L,VAN,29,82,14,23,37
31,8481546,Cam York,D,PHI,23,82,7,30,37
31,8480873,Rasmus Sandin,D,WSH,24,82,3,34,37
31,8481604,Pavel Dorofeyev,L,VGK,24,82,23,13,36
31,8478020,Michael Amadio,C,OTT,28,82,21,15,36
31,8480893,Kirill Marchenko,R,CBJ,24,82,20,16,36
31,8475760,Nick Bjugstad,C,UTA,32,82,19,17,36
31,8477429,Andrew Copp,C,DET,30,82,18,18,36
31,8479351,Sam Steel,C,DAL,26,82,11,25,36
31,8478469,Thomas Chabot,D,OTT,27,82,6,30,36
31,8476979,Erik Gustafsson,D,DET,32,82,6,30,36
31,8480113,Alex Iafallo,L,WPG,31,82,20,15,35
31,8480220,Noah Cates,L,PHI,25,82,13,22,35
31,8475149,Marcus Johansson,L,MIN,34,82,12,23,35
31,8480336,Sean Walker,D,CAR,30,82,8,27,35
31,8475200,Dmitry Orlov,D,CAR,33,82,6,29,35
31,8478500,Ivan Provorov,D,CBJ,27,82,4,31,35
31,8477919,Frederick Gaudreau,C,MIN,31,82,19,15,34
31,8476960,Andreas Athanasiou,C,CHI,30,82,16,18,34
31,8477508,Curtis Lazar,C,NJD,29,82,15,19,34
31,8482074,Connor Zary,C,CGY,23,82,14,20,34
31,8473563,Nicklas Backstrom,C,WSH,37,82,11,23,34
31,8475753,Justin Faulk,D,STL,32,82,10,24,34
31,8478851,Alexandre Carrier,D,NSH,28,82,6,28,34
31,8479398,Samuel Girard,D,COL,26,82,2,32,34
31,8479591,Michael Eyssimont,C,TBL,28,82,18,15,33
31,8477456,J.T. Compher,L,DET,29,82,16,17,33
31,8482117,Lukas Reichel,L,CHI,22,82,16,17,33
31,8476392,Adam Lowry,C,WPG,31,82,13,20,33
31,8482062,Cole Smith,L,NSH,29,82,13,20,33
31,8480817,K'Andre Miller,D,NYR,24,82,10,23,33
31,8476329,Travis Boyd,C,MIN,31,82,9,24,33
31,8480835,Jack Drury,C,CAR,24,82,19,13,32
31,8483431,Logan Cooley,C,UTA,20,82,18,14,32
31,8476278,Colin Blackwell,C,DAL,31,82,17,15,32
31,8481032,Paul Cotter,C,NJD,25,82,16,16,32
31,8481481,Blake Lizotte,C,PIT,27,82,16,16,32
31,8479983,Mario Ferraro,D,SJS,26,82,12,20,32
31,8482133,Thomas Bordeleau,C,SJS,22,82,10,22,32
31,8477948,Travis Sanheim,D,PHI,28,82,8,24,32
31,8481606,Jordan Spence,D,LAK,23,82,4,28,32
31,8479402,Jake Bean,D,CGY,26,82,4,28,32
31,8478508,Yakov Trenin,C,MIN,27,82,21,10,31
31,8476925,Colton Sissons,C,NSH,31,82,17,14,31
31,8479941,Justin Danforth,R,CBJ,31,82,16,15,31
31,8474189,Lars Eller,C,PIT,35,82,16,15,31
31,8482079,Marco Rossi,C,MIN,23,82,15,16,31
31,8477406,Mattias Janmark,C,EDM,32,82,15,16,31
31,8476897,Oskar Sundqvist,C,STL,30,82,13,18,31
31,8479996,Cody Glass,C,NSH,25,82,12,19,31
31,8479661,Tanner Jeannot,L,LAK,27,82,12,19,31
31,8483457,Lane Hutson,D,MTL,20,82,11,20,31
31,8478055,Gustav Forsling,D,FLA,28,82,10,21,31
31,8481708,Zac Jones,D,NYR,24,82,6,25,31
31,8476892,Colton Parayko,D,STL,31,82,5,26,31
31,8476461,Sean Couturier,C,PHI,32,82,14,16,30
31,8476921,Jordan Martinook,L,CAR,32,82,14,16,30
31,8477987,Ryan Donato,C,CHI,28,82,13,17,30
31,8484153,Leo Carlsson,C,ANA,20,82,12,18,30
31,8480185,Eetu Luostarinen,C,FLA,26,82,12,18,30
31,8476292,Ondrej Palat,L,NJD,33,82,12,18,30
31,8477989,Christian Dvorak,C,MTL,28,82,11,19,30
31,8477953,Kasperi Kapanen,R,STL,28,82,11,19,30
31,8481704,Juuso Parssinen,C,NSH,23,82,11,19,30
31,8470621,Corey Perry,R,EDM,39,82,10,20,30
31,8479359,Beck Malenstyn,L,BUF,26,82,9,21,30
31,8477498,Darnell Nurse,D,EDM,29,82,7,23,30
31,8482655,J.J. Moser,D,TBL,24,82,6,24,30
31,8482142,Jamie Drysdale,D,PHI,22,82,1,29,30
31,8477426,Nicholas Paul,L,TBL,29,82,18,11,29
31,8475343,Nic Dowd,C,WSH,34,82,16,13,29
31,8479368,Max Jones,L,BOS,26,82,15,14,29
31,8480144,David Kampf,C,TOR,29,82,12,17,29
31,8481601,Simon Holmstrom,R,NYI,23,82,11,18,29
31,8477839,Conor Sheary,L,TBL,32,82,11,18,29
31,8475193,Tomas Tatar,L,NJD,34,82,8,21,29
31,8476902,Esa Lindell,D,DAL,30,82,8,21,29
31,8480871,Adam Boqvist,D,FLA,24,82,7,22,29
31,8477488,Brett Pesce,D,NJD,30,82,6,23,29
31,8480043,Timothy Liljegren,D,TOR,25,82,6,23,29
31,8479316,Luke Kunin,C,SJS,27,82,16,12,28
31,8476918,Jimmy Vesey,L,NYR,31,82,15,13,28
31,8477450,Jason Dickinson,C,CHI,29,82,12,16,28
31,8479353,Brett Howden,C,VGK,26,82,11,17,28
31,8476927,Teddy Blueger,C,VAN,30,82,11,17,28
31,8478911,Matt Roy,D,WSH,29,82,10,18,28
31,8475855,Jesper Fast,R,CAR,33,82,10,18,28
31,8480073,Erik Brannstrom,D,COL,25,82,8,20,28
31,8482122,Brock Faber,D,MIN,22,82,7,21,28
31,8476917,Adam Pelech,D,NYI,30,82,6,22,28
31,8475690,Chris Tanev,D,TOR,35,82,1,27,28
31,8476873,Mark Jankowski,C,NSH,30,82,16,11,27
31,8476469,Joel Armia,R,MTL,31,82,15,12,27
31,8481560,Arthur Kaliyev,R,LAK,23,82,13,14,27
31,8484145,Zach Benson,L,BUF,19,82,13,14,27
31,8482141,Lukas Cormier,D,VGK,22,82,12,15,27
31,8476467,Jamie Oleksiak,D,SEA,32,82,10,17,27
31,8477220,Nate Schmidt,D,FLA,33,82,8,19,27
31,8481517,Brett Leason,R,ANA,25,82,8,19,27
31,8483445,Cutter Gauthier,L,ANA,20,82,7,20,27
31,8481014,Alexander Romanov,D,NYI,24,82,2,25,27
31,8479293,Brandon Tanev,L,SEA,33,82,14,12,26
31,8477425,Miles Wood,L,COL,29,82,13,13,26
31,8483524,Shane Wright,C,SEA,20,82,12,14,26
31,8478013,Jake Walman,D,SJS,28,82,11,15,26
31,8480003,Jesper Boqvist,C,FLA,26,82,11,15,26
31,8480806,Isac Lundestrom,C,ANA,25,82,11,15,26
31,8476889,Radek Faksa,C,STL,30,82,10,16,26
31,8480855,Jack McBain,C,UTA,24,82,8,18,26
31,8483495,Simon Nemec,D,NJD,20,82,7,19,26
31,8476463,Jonas Brodin,D,MIN,31,82,5,21,26
31,8476931,Jake McCabe,D,TOR,31,82,5,21,26
31,8477507,Nikita Zadorov,D,BOS,29,82,5,21,26
31,8479324,Ryan Lindgren,D,NYR,26,82,5,21,26
31,8478882,Vladislav Gavrikov,D,LAK,29,82,4,22,26
31,8477845,Trevor van Riemsdyk,D,WSH,33,82,4,22,26
31,8478399,Jonas Siegenthaler,D,NJD,27,82,3,23,26
31,8480980,Connor Dewar,C,TOR,25,82,14,11,25
31,8480789,Oliver Wahlstrom,R,NYI,24,82,12,13,25
31,8482125,Alexander Holtz,R,VGK,22,82,12,13,25
31,8481522,Peyton Krebs,C,BUF,23,82,12,13,25
31,8478432,Christian Fischer,R,DET,27,82,12,13,25
31,8477015,Connor Brown,R,EDM,30,82,11,14,25
31,8481477,Nico Sturm,C,SJS,29,82,11,14,25
31,8484166,Adam Fantilli,C,CBJ,20,82,11,14,25
31,8478413,Jordan Greenway,L,BUF,27,82,10,15,25
31,8481524,Bowen Byram,D,BUF,23,82,10,15,25
31,8478211,Dryden Hunt,L,CGY,29,82,10,15,25
31,8480878,Nils Lundkvist,D,DAL,24,82,7,18,25
31,8476331,Dylan DeMelo,D,WPG,31,82,5,20,25
31,8476457,Adam Larsson,D,SEA,32,82,3,22,25
31,8482073,Braden Schneider,D,NYR,23,82,2,23,25
31,8481186,Logan O'Connor,R,COL,28,82,14,10,24
31,8473453,Trevor Lewis,C,LAK,37,82,14,10,24
31,8482679,Matt Coronato,R,CGY,22,82,11,13,24
31,8480995,Pontus Holmberg,R,TOR,25,82,10,14,24
31,8474715,Cam Atkinson,R,TBL,35,82,10,14,24
31,8484203,Bradly Nadeau,L,CAR,19,82,9,15,24
31,8474574,Tyler Myers,D,VAN,34,82,8,16,24
31,8479371,Dante Fabbro,D,NSH,26,82,8,16,24
31,8476525,Colin Miller,D,WPG,32,82,7,17,24
31,8480222,Sebastian Aho,D,PIT,28,82,6,18,24
31,8478507,John Marino,D,UTA,27,82,3,21,24
31,8478840,Will Borgen,D,SEA,28,82,3,21,24
31,8478443,Brandon Carlo,D,BOS,28,82,2,22,24
31,8480049,Dylan Samberg,D,WPG,25,82,1,23,24
31,8481028,Martin Pospisil,C,CGY,25,82,13,10,23
31,8477353,Tyler Motte,C,DET,29,82,12,11,23
31,8482803,Olen Zellweger,D,ANA,21,82,11,12,23
31,8475718,Justin Holl,D,DET,32,82,5,18,23
31,8477435,Ryan Graves,D,PIT,29,82,4,19,23
31,8482111,Justin Barron,D,MTL,23,82,14,8,22
31,8477392,Hudson Fasching,R,NYI,29,82,11,11,22
31,8475231,Casey Cizikas,C,NYI,33,82,11,11,22
31,8482807,Ethan Del Mastro,D,CHI,21,82,11,11,22
31,8483505,Matthew Poitras,C,BOS,20,82,10,12,22
31,8475177,Calvin de Haan,D,COL,33,82,10,12,22
31,8475220,Marcus Foligno,L,MIN,33,82,9,13,22
31,8475279,Ben Chiarot,D,DET,33,82,8,14,22
31,8480074,Alexandre Texier,C,STL,25,82,7,15,22
31,8482166,Shakir Mukhamadullin,D,SJS,22,82,6,16,22
31,8480834,Ty Emberson,D,SJS,24,82,6,16,22
31,8480796,Martin Fehervary,D,WSH,25,82,4,18,22
31,8480035,Henri Jokiharju,D,BUF,25,82,3,19,22
31,8476429,Scott Mayfield,D,NYI,32,82,3,19,22
31,8475181,Nick Leddy,D,STL,33,82,1,21,22
31,8480448,Parker Kelly,L,COL,25,82,9,12,21
31,8477369,Carson Soucy,D,VAN,30,82,9,12,21
31,8477931,Tomas Nosek,L,FLA,32,82,7,14,21
31,8482245,Artem Zub,D,OTT,29,82,4,17,21
31,8475233,David Savard,D,MTL,34,82,4,17,21
31,8479976,Juuso Valimaki,D,UTA,26,82,3,18,21
31,8483565,Nick Blankenburg,D,NSH,26,82,3,18,21
31,8475324,Nick Jensen,D,OTT,34,82,2,19,21
31,8480281,Alexey Toropchenko,R,STL,25,82,16,4,20
31,8482077,Dylan Holloway,L,EDM,23,82,14,6,20
31,8478569,Noel Acciari,C,PIT,33,82,12,8,20
31,8476624,Barclay Goodrow,C,SJS,31,82,8,12,20
31,8482809,Jackson Blake,R,CAR,21,82,8,12,20
31,8482733,Logan Mailloux,D,MTL,31,82,7,13,20
31,8480807,Mattias Samuelsson,D,BUF,24,82,7,13,20
31,8478416,Erik Cernak,D,TBL,27,82,5,15,20
31,8481568,Alex Vlasic,D,CHI,23,82,4,16,20
31,8476312,Josh Manson,D,COL,33,82,3,17,20
31,8479998,Mikey Anderson,D,LAK,25,82,2,18,20
31,8480172,Jan Rutta,D,SJS,34,82,2,18,20
31,8474673,TJ Brodie,D,CHI,34,82,0,20,20
31,8475790,Erik Gudbranson,D,CBJ,32,82,0,20,20
31,8479393,Noah Gregor,C,OTT,26,82,11,8,19
31,8475842,Sam Carrick,C,NYR,32,82,11,8,19
31,8482155,Alex Laferriere,R,LAK,23,82,9,10,19
31,8482749,Joshua Roy,R,MTL,21,82,9,10,19
31,8483490,Pavel Mintyukov,D,ANA,21,82,7,12,19
31,8480021,Jack Studnicka,C,LAK,25,82,6,13,19
31,8479369,Andrew Peeke,D,BOS,26,82,5,14,19
31,8475762,Derek Forbort,D,VAN,32,82,5,14,19
31,8478178,Darren Raddysh,D,TBL,28,82,4,15,19
31,8477365,Connor Clifton,D,BUF,29,82,4,15,19
31,8482101,Danil Gushchin,L,SJS,22,82,3,16,19
31,8482666,Scott Morrow,D,CAR,22,82,2,17,19
31,8473507,Jeff Petry,D,DET,37,82,1,18,19
31,8476858,Phillip Di Giuseppe,L,VAN,31,82,9,9,18
31,8483493,Frank Nazar,C,CHI,20,82,7,11,18
31,8482087,Kaiden Guhle,D,MTL,22,82,6,12,18
31,8476374,Sean Kuraly,C,CBJ,31,82,6,12,18
31,8482470,Ilya Solovyov,D,CGY,24,82,6,12,18
31,8479576,Vincent Desharnais,D,VAN,28,82,5,13,18
31,8476422,Mike Reilly,D,NYI,31,82,4,14,18
31,8477335,Kyle Burroughs,D,LAK,29,82,4,14,18
31,8478450,Parker Wotherspoon,D,BOS,27,82,4,14,18
31,8481605,Jackson LaCombe,D,ANA,23,82,4,14,18
31,8479980,Nicolas Hague,D,VGK,26,82,2,16,18
31,8476372,Nick Seeler,D,PHI,31,82,2,16,18
31,8475462,Radko Gudas,D,ANA,34,82,1,17,18
31,8481093,Rafael Harvey-Pinard,L,MTL,25,82,10,7,17
31,8476878,Zemgus Girgensons,L,TBL,30,82,8,9,17
31,8483763,Maksymilian Szuber,D,UTA,22,82,7,10,17
31,8477505,Alexander Wennberg,C,SJS,30,82,7,10,17
31,8480990,Declan Chisholm,D,MIN,24,82,5,12,17
31,8483468,Jiri Kulich,C,BUF,20,82,3,14,17
31,8475455,Brenden Dillon,D,NJD,34,82,2,15,17
31,8480879,Jacob Bernard-Docker,D,OTT,24,82,2,15,17
31,8475188,Brayden McNabb,D,VGK,33,82,0,17,17
31,8476442,Matt Nieto,L,PIT,32,82,8,8,16
31,8478434,Keegan Kolesar,R,VGK,27,82,8,8,16
31,8484149,Gavin Brindley,C,CBJ,20,82,6,10,16
31,8477903,Garnet Hathaway,R,PHI,33,82,5,11,16
31,8480246,Nick Perbix,D,TBL,26,82,5,11,16
31,8481641,Joel Kiviranta,L,COL,28,82,5,11,16
31,8476473,Connor Murphy,D,CHI,31,82,5,11,16
31,8482702,Logan Stankoven,C,DAL,21,82,3,13,16
31,8481567,Henry Thrun,D,SJS,23,82,3,13,16
31,8470600,Ryan Suter,D,STL,39,82,3,13,16
31,8480950,Ilya Lyubushkin,D,DAL,30,82,3,13,16
31,8474013,Ian Cole,D,UTA,35,82,3,13,16
31,8480860,Kevin Bahl,D,CGY,24,82,2,14,16
31,8483012,Logan Morrison,C,SEA,22,82,9,6,15
31,8482762,Simon Edvinsson,D,DET,21,82,5,10,15
31,8483466,Kevin Korchinski,D,CHI,20,82,5,10,15
31,8481699,Aku Raty,R,UTA,23,82,5,10,15
31,8481122,Simon Benoit,D,TOR,26,82,5,10,15
31,8483482,Tristan Luneau,D,ANA,20,82,4,11,15
31,8478136,Jake Middleton,D,MIN,28,82,4,11,15
31,8482153,Brendan Brisson,C,VGK,23,82,4,11,15
31,8478859,Niko Mikkola,D,FLA,28,82,4,11,15
31,8474567,Zach Bogosian,D,MIN,34,82,4,11,15
31,8479442,Troy Stecher,D,EDM,30,82,3,12,15
31,8481178,Egor Zamula,D,PHI,24,82,2,13,15
31,8477499,Rasmus Ristolainen,D,PHI,30,82,2,13,15
31,8483471,Brad Lambert,C,WPG,31,82,2,13,15
31,8476967,Brett Kulak,D,EDM,30,82,0,15,15
31,8482713,Mackie Samoskevich,R,FLA,22,82,9,5,14
31,8484911,Collin Graf,R,SJS,22,82,7,7,14
31,8479638,Justin Brazeau,R,BOS,26,82,7,7,14
31,8479414,Nathan Bastian,R,NJD,27,82,6,8,14
31,8483460,David Jiricek,D,CBJ,21,82,6,8,14
31,8480870,Bo Groulx,C,NYR,24,82,5,9,14
31,8482145,Mavrik Bourque,C,DAL,22,82,3,11,14
31,8482516,Matthew Kessel,D,STL,24,82,3,11,14
31,8476441,Joel Edmundson,D,LAK,31,82,2,12,14
31,8479291,Kevin Rooney,C,CGY,31,82,8,5,13
31,8477938,Haydn Fleury,D,WPG,28,82,6,7,13
31,8478468,Jeremy Lauzon,D,NSH,27,82,2,11,13
31,8474090,Brendan Smith,D,DAL,35,82,1,12,13
31,8482659,Josh Doan,R,UTA,22,82,8,4,12
31,8474612,Travis Hamonic,D,OTT,34,82,4,8,12
31,8476879,Cody Ceci,D,EDM,31,82,0,12,12
31,8483489,Fraser Minten,C,TOR,31,82,8,3,11
31,8476822,Luke Glendening,C,TBL,35,82,5,6,11
31,8483499,Liam Ohgren,L,MIN,20,82,4,7,11
31,8480025,MacKenzie Entwistle,R,FLA,25,82,7,3,10
31,8483397,Marc McLaughlin,C,BOS,25,82,5,5,10
31,8482858,Ryker Evans,D,SEA,23,82,3,7,10
31,8476891,Matt Grzelcyk,D,PIT,30,82,0,10,10
31,8477034,Jaycob Megna,D,FLA,32,82,0,10,10
31,8482070,Mitchell Chaffee,R,TBL,26,82,6,3,9
31,8482787,Nikita Chibrikov,R,WPG,31,82,4,5,9
31,8471677,Jack Johnson,D,CBJ,37,82,2,7,9
31,8482118,Sam Colangelo,R,ANA,23,82,4,4,8
31,8482859,Zack Ostapchuk,C,OTT,21,82,3,5,8
31,8482712,Oskar Olausson,R,COL,22,82,3,4,7
31,8474062,Riley Nash,C,NYR,35,82,2,5,7
31,8478874,Adam Gaudette,C,OTT,28,82,1,6,7
31,8483567,Georgii Merkulov,C,BOS,24,82,2,4,6
31,8470794,Joe Pavelski,C,,40,0,0,0,0
31,8481703,Valtteri Puustinen,R,PIT,25,0,0,0,0
31,8477950,Tony DeAngelo,D,,29,0,0,0,0
31,8481577,Philip Tomasino,C,NSH,23,0,0,0,0
31,8475197,Tyson Barrie,D,,33,0,0,0,0
31,8471218,Blake Wheeler,R,,38,0,0,0,0
31,8474157,Max Pacioretty,L,,36,0,0,0,0
31,8478466,Daniel Sprong,R,VAN,27,0,0,0,0
31,8475744,Evgeny Kuznetsov,C,,32,0,0,0,0
31,8481019,David Gustafsson,C,WPG,24,0,0,0,0
31,8475906,John Klingberg,D,,32,0,0,0,0
31,8479348,Kale Clague,D,BUF,26,0,0,0,0
31,8476952,Dominic Toninato,C,WPG,30,0,0,0,0
31,8473473,Milan Lucic,L,,36,0,0,0,0
31,8474037,James van Riemsdyk,L,,35,0,0,0,0
31,8474602,Justin Schultz,D,,34,0,0,0,0
31,8482222,Alexander Barabanov,L,,30,0,0,0,0
31,8479372,Josh Mahura,D,SEA,26,0,0,0,0
31,8479982,Conor Timmins,D,TOR,26,0,0,0,0
31,8474031,Kevin Shattenkirk,D,,35,0,0,0,0
31,8480008,Adam Ruzicka,C,,25,0,0,0,0
31,8481059,Scott Perunovich,D,STL,26,0,0,0,0
31,8480884,Calen Addison,D,,24,0,0,0,0
31,8476994,Vinnie Hinostroza,C,NSH,30,0,0,0,0
31,8478452,Caleb Jones,D,LAK,27,0,0,0,0
31,8480157,Calle Rosen,D,COL,30,0,0,0,0
31,8481609,Vladislav Kolyachonok,D,UTA,23,0,0,0,0
31,8479415,Michael McLeod,C,,26,0,0,0,0
31,8476919,Chris Tierney,C,,30,0,0,0,0
31,8479639,Dylan Coghlan,D,WPG,26,0,0,0,0
31,8478146,Matthew Highmore,C,OTT,28,0,0,0,0
31,8478970,Jalen Chatfield,D,CAR,28,0,0,0,0
31,8480205,Emil Bemstrom,C,PIT,25,0,0,0,0
31,8474884,Mike Hoffman,C,,35,0,0,0,0
31,8471274,Alex Goligoski,D,,39,0,0,0,0
31,8478104,Sammy Blais,L,,28,0,0,0,0
31,8474870,Tyler Johnson,C,,34,0,0,0,0
31,8476913,Devin Shore,C,MIN,30,0,0,0,0
31,8481598,Philip Broberg,D,EDM,23,0,0,0,0
31,8480058,Pierre-Olivier Joseph,D,STL,25,0,0,0,0
31,8480891,Michael Kesselring,D,UTA,24,0,0,0,0
31,8477979,Nicolas Aube-Kubel,R,BUF,28,0,0,0,0
31,8476871,Tanner Pearson,L,,32,0,0,0,0
31,8476393,Nick Cousins,C,,31,0,0,0,0
31,8479977,Kailer Yamamoto,R,,26,0,0,0,0
31,8479543,Michael Pezzetta,L,MTL,26,0,0,0,0
31,8477018,Ben Hutton,D,VGK,31,0,0,0,0
31,8480762,Eric Robinson,L,CAR,29,0,0,0,0
31,8474034,Pat Maroon,L,CHI,36,0,0,0,0
31,8481058,Jesse Ylönen,R,,25,0,0,0,0
31,8475179,Dmitry Kulikov,D,FLA,34,0,0,0,0
31,8481527,Kaedan Korczak,D,VGK,23,0,0,0,0
31,8473449,Kyle Okposo,R,,36,0,0,0,0
31,8482192,Isaak Phillips,D,CHI,23,0,0,0,0
31,8480727,Zach Whitecloud,D,VGK,28,0,0,0,0
31,8479346,Dillon Dube,C,,26,0,0,0,0
31,8480821,Filip Zadina,R,,25,0,0,0,0
31,8480001,Urho Vaakanainen,D,ANA,25,0,0,0,0
31,8470966,Mark Giordano,D,,41,0,0,0,0
31,8480853,Liam Foudy,C,,24,0,0,0,0
31,8475225,Craig Smith,C,CHI,35,0,0,0,0
31,8479972,Mason Shaw,C,WPG,26,0,0,0,0
31,8478451,Ethan Bear,D,WSH,27,0,0,0,0
31,8474040,Sam Gagner,C,,35,0,0,0,0
31,8480196,Jacob Bryson,D,BUF,27,0,0,0,0
31,8479984,Cal Foote,D,,26,0,0,0,0
31,8480011,Klim Kostin,C,SJS,25,0,0,0,0
31,8482176,Wyatt Kaiser,D,CHI,22,0,0,0,0
31,8476988,Matt Benning,D,SJS,30,0,0,0,0
31,8479370,Tyson Jost,C,CAR,26,0,0,0,0
31,8477464,Nic Petan,C,,29,0,0,0,0
31,8477380,Jonny Brodzinski,C,NYR,31,0,0,0,0
31,8480070,Ian Mitchell,D,BOS,25,0,0,0,0
31,8479315,Joey Anderson,R,CHI,26,0,0,0,0
31,8478099,Kevin Labanc,R,,29,0,0,0,0
31,8476874,Olli Maatta,D,DET,30,0,0,0,0
31,8475208,Brian Dumoulin,D,ANA,33,0,0,0,0
31,8478430,Oliver Kylington,D,,27,0,0,0,0
31,8479536,Axel Jonsson-Fjallby,L,WPG,26,0,0,0,0
31,8479671,Mathieu Olivier,R,CBJ,27,0,0,0,0
31,8471709,Marc-Edouard Vlasic,D,SJS,37,0,0,0,0
31,8479328,Julien Gauthier,R,NYI,27,0,0,0,0
31,8478421,A.J. Greer,L,FLA,28,0,0,0,0
31,8477573,Nathan Walker,L,STL,30,0,0,0,0
31,8481537,Nikita Okhotiuk,D,CGY,24,0,0,0,0
31,8474166,Alec Martinez,D,CHI,37,0,0,0,0
31,8470610,Zach Parise,L,,40,0,0,0,0
31,8477478,William Carrier,L,CAR,30,0,0,0,0
31,8479344,Jesse Puljujarvi,R,PIT,26,0,0,0,0
31,8480887,Jordan Harris,D,MTL,24,0,0,0,0
31,8478502,Dennis Gilbert,D,BUF,28,0,0,0,0
31,8482730,Brandt Clarke,D,LAK,21,0,0,0,0
31,8480355,Mark Kastelic,C,BOS,25,0,0,0,0
31,8475750,Jon Merrill,D,MIN,32,0,0,0,0
31,8475164,Jakob Silfverberg,R,,34,0,0,0,0
31,8477944,Jakub Vrana,L,,28,0,0,0,0
31,8479439,Jacob MacDonald,D,COL,31,0,0,0,0
31,8474568,Luke Schenn,D,NSH,35,0,0,0,0
31,8478454,Noah Juulsen,D,VAN,27,0,0,0,0
31,8475752,Tyler Pitlick,C,,33,0,0,0,0
31,8482148,Hendrix Lapierre,C,WSH,22,0,0,0,0
31,8481167,Brayden Pachal,D,CGY,25,0,0,0,0
31,8478043,Sam Lafferty,C,BUF,29,0,0,0,0
31,8479321,Lucas Johansen,D,,27,0,0,0,0
31,8471699,Andrew Cogliano,C,,37,0,0,0,0
31,8481521,Ronnie Attard,D,PHI,25,0,0,0,0
31,8481161,Jake Christiansen,D,CBJ,25,0,0,0,0
31,8479458,Nikita Zaitsev,D,,33,0,0,0,0
31,8479619,Michael Carcone,L,UTA,28,0,0,0,0
31,8479026,Philippe Myers,D,TOR,27,0,0,0,0
31,8477330,Dominik Kubalik,L,,29,0,0,0,0
31,8481617,Vasily Podkolzin,R,VAN,23,0,0,0,0
31,8481701,Santeri Hatakka,D,NJD,23,0,0,0,0
31,8479514,Rem Pitlick,C,,27,0,0,0,0
31,8477446,Michael McCarron,R,NSH,29,0,0,0,0
31,8470604,Jeff Carter,C,,39,0,0,0,0
31,8482241,Radim Zohorna,L,,28,0,0,0,0
31,8480289,Morgan Barron,C,WPG,26,0,0,0,0
31,8479379,Givani Smith,R,SJS,26,0,0,0,0
31,8480216,Jacob Peterson,C,,25,0,0,0,0
31,8477851,Jordan Oesterle,D,BOS,32,0,0,0,0
31,8484258,Sam Malinski,D,COL,26,0,0,0,0
31,8478904,Steven Lorentz,C,,28,0,0,0,0
31,8482095,Tyler Kleven,D,OTT,22,0,0,0,0
31,8480848,Ty Dellandrea,C,SJS,24,0,0,0,0
31,8476884,Derrick Pouliot,D,,30,0,0,0,0
31,8479336,Carl Grundstrom,R,SJS,27,0,0,0,0
31,8482964,Arber Xhekaj,D,MTL,23,0,0,0,0
31,8471686,Marc Staal,D,,37,0,0,0,0
31,8477887,Patrick Brown,C,BOS,32,0,0,0,0
31,8478495,Denis Gurianov,R,,27,0,0,0,0
31,8473504,Cal Clutterbuck,R,,37,0,0,0,0
31,8481550,Adam Beckman,L,NJD,23,0,0,0,0
31,8480845,Rasmus Kupari,C,WPG,24,0,0,0,0
31,8474009,Nick Bonino,C,,36,0,0,0,0
31,8478585,Derek Ryan,C,EDM,38,0,0,0,0
31,8477962,Brendan Lemieux,L,CAR,28,0,0,0,0
31,8482861,Vincent Iorio,D,WSH,22,0,0,0,0
31,8479378,Logan Stanley,D,WPG,26,0,0,0,0
31,8473446,Erik Johnson,D,PHI,36,0,0,0,0
31,8481743,Marc Del Gaizo,D,NSH,25,0,0,0,0
31,8477384,Josh Brown,D,EDM,30,0,0,0,0
31,8482165,Yan Kuznetsov,D,CGY,22,0,0,0,0
31,8478424,Jansen Harkins,C,ANA,27,0,0,0,0
31,8482144,Jack Thompson,D,SJS,22,0,0,0,0
31,8478512,Austin Czarnik,C,,32,0,0,0,0
31,8477527,Ross Johnston,L,ANA,30,0,0,0,0
31,8479383,Boris Katchouk,L,,26,0,0,0,0
31,8482094,Daemon Hunt,D,MIN,22,0,0,0,0
31,8481719,Maxwell Crozier,D,TBL,24,0,0,0,0
31,8480192,Johnathan Kovacevic,D,NJD,27,0,0,0,0
31,8479376,Victor Mete,D,,26,0,0,0,0
31,8482511,Mason Lohrei,D,BOS,23,0,0,0,0
31,8475825,Jani Hakanpää,D,,32,0,0,0,0
31,8478021,William Lagesson,D,DET,28,0,0,0,0
31,8475795,Dylan McIlrath,D,WSH,32,0,0,0,0
31,8477846,Ryan Carpenter,C,,33,0,0,0,0
31,8481056,Spencer Stastney,D,NSH,24,0,0,0,0
31,8481564,Ryan Johnson,D,BUF,23,0,0,0,0
31,8478017,Mark Friedman,D,VAN,29,0,0,0,0
31,8479320,Max Lajoie,D,SEA,27,0,0,0,0
31,8480075,Cameron Crotty,D,MIN,25,0,0,0,0
31,8484287,Cole McWard,D,VAN,23,0,0,0,0
31,8484254,Akito Hirose,D,VAN,25,0,0,0,0
31,8483407,Brandon Scanlin,D,NYR,25,0,0,0,0
31,8480274,Philip Kemp,D,EDM,25,0,0,0,0
31,8479522,Hardy Haman Aktell,D,WSH,26,0,0,0,0
31,8480007,Jonas Rondbjerg,R,VGK,25,0,0,0,0
31,8477454,Adam Erne,L,,29,0,0,0,0
31,8481679,Maxence Guenette,D,OTT,23,0,0,0,0
31,8480441,Trey Fix-Wolansky,R,CBJ,25,0,0,0,0
31,8483546,Marshall Rifai,D,TOR,26,0,0,0,0
31,8480084,Nick DeSimone,D,NJD,30,0,0,0,0
31,8481030,Jack St. Ivany,D,PIT,25,0,0,0,0
31,8481592,Jakob Pelletier,L,CGY,23,0,0,0,0
31,8478011,Louie Belpedio,D,PHI,28,0,0,0,0
31,8477930,Pierre-Edouard Bellemare,L,,39,0,0,0,0
31,8484321,Nikolas Matinpalo,D,OTT,26,0,0,0,0
31,8482067,Connor Mackey,D,NYR,28,0,0,0,0
31,8481806,Louis Crevier,D,CHI,23,0,0,0,0
31,8484326,Patrik Koch,D,UTA,28,0,0,0,0
31,8477971,Andreas Englund,D,LAK,28,0,0,0,0
31,8481751,Lukas Rousek,R,BUF,25,0,0,0,0
31,8481006,Tyler Tucker,D,STL,24,0,0,0,0
31,8476867,Brendan Gaunce,C,MIN,30,0,0,0,0
31,8479520,Brandon Duhaime,R,WSH,27,0,0,0,0
31,8477073,Kurtis MacDermid,L,NJD,30,0,0,0,0
31,8480874,Adam Ginning,D,PHI,24,0,0,0,0
31,8477473,Justin Bailey,R,SJS,29,0,0,0,0
31,8479066,Ryan Lomberg,L,CGY,30,0,0,0,0
31,8477070,Liam O'Brien,C,UTA,30,0,0,0,0
31,8474618,Marco Scandella,D,,34,0,0,0,0
31,8475797,Jarred Tinordi,D,,32,0,0,0,0
31,8481441,Joe Snively,C,DET,28,0,0,0,0
31,8477244,Chad Ruhwedel,D,NYR,34,0,0,0,0
31,8479772,Zack MacEwen,R,OTT,28,0,0,0,0
31,8481147,Reese Johnson,C,MIN,26,0,0,0,0
31,8481043,Cole Koepke,L,BOS,26,0,0,0,0
31,8483619,Filip Roos,D,OTT,25,0,0,0,0
31,8481541,Samuel Bolduc,D,NYI,24,0,0,0,0
31,8477810,Joel Hanley,D,CGY,33,0,0,0,0
31,8476907,Mackenzie MacEachern,L,,30,0,0,0,0
31,8482652,Walker Duehr,R,CGY,27,0,0,0,0
31,8477126,Jayson Megna,C,,34,0,0,0,0
31,8483398,Declan Carlile,D,TBL,31,0,0,0,0
31,8482929,Emil Lilleberg,D,TBL,23,0,0,0,0
31,8480880,Jakub Lauko,C,MIN,24,0,0,0,0
31,8480245,Olle Lycksell,R,PHI,25,0,0,0,0
31,8480252,Cole Guttman,C,CHI,25,0,0,0,0
31,8477467,Gustav Olofsson,D,SEA,30,0,0,0,0
31,8479968,Vinni Lettieri,C,BOS,29,0,0,0,0
31,8478400,Colin White,C,,27,0,0,0,0
31,8475755,Alexander Petrovic,D,DAL,32,0,0,0,0
31,8481812,Nikolai Knyzhov,D,,27,0,0,0,0
31,8481593,Jayden Struble,D,MTL,23,0,0,0,0
31,8481532,Alex Turcotte,C,LAK,23,0,0,0,0
31,8482126,Emil Andrae,D,PHI,31,0,0,0,0
31,8479944,Zach Aston-Reese,C,VGK,30,0,0,0,0
31,8471817,Ryan Reaves,R,TOR,37,0,0,0,0
31,8481206,John Ludvig,D,PIT,24,0,0,0,0
31,8481599,Victor Soderstrom,D,UTA,23,0,0,0,0
31,8480292,Carson Meyer,R,ANA,27,0,0,0,0
31,8482496,Nils Aman,C,VAN,24,0,0,0,0
31,8479718,Alex Barré-Boulet,C,MTL,27,0,0,0,0
31,8479994,Jaret Anderson-Dolan,C,WPG,25,0,0,0,0
31,8480184,Gustav Lindstrom,D,,26,0,0,0,0
31,8480890,Jan Jenik,R,OTT,24,0,0,0,0
31,8478067,Oskar Lindblom,L,,28,0,0,0,0
31,8476934,Brock McGinn,L,ANA,30,0,0,0,0
31,8479985,Cale Fleury,D,SEA,26,0,0,0,0
31,8484304,Uvis Balinskis,D,FLA,28,0,0,0,0
31,8479981,Jonah Gadjovich,L,FLA,26,0,0,0,0
31,8481716,Dmitri Voronkov,L,CBJ,24,0,0,0,0
31,8474709,Matt Martin,L,,35,0,0,0,0
31,8482634,Alex Steeves,C,TOR,25,0,0,0,0
31,8480823,Alexander Alexeyev,D,WSH,25,0,0,0,0
31,8477541,Dakota Mermis,D,TOR,30,0,0,0,0
31,8483491,Ivan Miroshnichenko,L,WSH,20,0,0,0,0
31,8478477,Mitchell Stephens,C,SEA,27,0,0,0,0
31,8481543,Nikita Alexandrov,C,STL,24,0,0,0,0
31,8479423,Alex Nylander,L,,26,0,0,0,0
31,8482451,Mikael Pyyhtia,L,CBJ,23,0,0,0,0
31,8478831,Kevin Stenlund,C,UTA,28,0,0,0,0
31,8480306,Grant Hutton,D,NYI,29,0,0,0,0
31,8478028,Fredrik Olofsson,L,,28,0,0,0,0
31,8477462,Robert Hagg,D,VGK,29,0,0,0,0
31,8477320,Anton Blidh,L,NYR,29,0,0,0,0
31,8482157,Will Cuylle,L,NYR,22,0,0,0,0
31,8482737,Zack Bolduc,C,STL,21,0,0,0,0
31,8481239,Samuel Fagemo,L,,24,0,0,0,0
31,8481600,Tobias Bjornfot,D,FLA,23,0,0,0,0
31,8478409,Anthony Richard,C,PHI,28,0,0,0,0
31,8474145,Robert Bortuzzo,D,,35,0,0,0,0
31,8475958,Michael Sgarbossa,C,WSH,32,0,0,0,0
31,8479986,Kole Lind,R,DAL,26,0,0,0,0
31,8479249,Andrew Poturalski,C,SJS,30,0,0,0,0
31,8479362,Riley Tufte,L,BOS,26,0,0,0,0
31,8479991,Jake Leschyshyn,C,NYR,25,0,0,0,0
31,8479587,Rhett Gardner,C,PHI,28,0,0,0,0
31,8482744,James Malatesta,L,CBJ,21,0,0,0,0
31,8478854,Ryan Shea,D,PIT,27,0,0,0,0
31,8481591,Sam Poulin,R,,23,0,0,0,0
31,8483512,Matt Savoie,C,EDM,20,0,0,0,0
31,8482102,Vasily Ponomarev,C,PIT,22,0,0,0,0
31,8482162,Roby Jarventie,L,EDM,22,0,0,0,0
31,8481016,Ruslan Iskhakov,C,,24,0,0,0,0
31,8482172,Landon Slaggert,L,CHI,22,0,0,0,0
31,8482747,Brennan Othmann,L,NYR,21,0,0,0,0
31,8480031,Maxime Comtois,L,,25,0,0,0,0
31,8480226,Marián Studenic,R,,26,0,0,0,0
31,8478408,Travis Dermott,D,,28,0,0,0,0
31,8481518,Nolan Foote,L,NJD,24,0,0,0,0
31,8479419,Brett Murray,L,BUF,26,0,0,0,0
31,8482088,Justin Sourdif,R,FLA,22,0,0,0,0
31,8482201,Gage Goncalves,C,TBL,23,0,0,0,0
31,8481578,Graeme Clarke,R,MIN,23,0,0,0,0
31,8482177,Marat Khusnutdinov,C,MIN,22,0,0,0,0
31,8481754,Nikita Nesterenko,C,ANA,23,0,0,0,0
31,8483531,Brian Halonen,L,NJD,25,0,0,0,0
31,8483920,Pierrick Dube,R,WSH,23,0,0,0,0
31,8480851,Akil Thomas,C,LAK,24,0,0,0,0
31,8475235,Nicolas Deslauriers,L,PHI,33,0,0,0,0
31,8482476,Emil Heineman,L,MTL,23,0,0,0,0
31,8477149,Scott Sabourin,R,SJS,32,0,0,0,0
31,8483549,Lucas Condotta,L,MTL,27,0,0,0,0
31,8482765,Isak Rosen,R,BUF,21,0,0,0,0
31,8481237,Kyle MacLean,C,NYI,25,0,0,0,0
31,8481024,Linus Karlsson,C,VAN,25,0,0,0,0
31,8481690,Tyler Angle,C,,24,0,0,0,0
31,8483570,Ben Meyers,C,SEA,26,0,0,0,0
31,8481655,Cole Schwindt,R,CGY,23,0,0,0,0
31,8481462,Mason Morelli,L,VGK,28,0,0,0,0
31,8483401,Marc Johnstone,R,PIT,28,0,0,0,0
31,8478956,Samuel Laberge,L,NJD,27,0,0,0,0
31,8479533,Joona Koppanen,L,,26,0,0,0,0
31,8482197,Adam Raska,R,MIN,23,0,0,0,0
31,8482250,Callahan Burke,C,VGK,27,0,0,0,0
31,8482784,Zach Dean,C,STL,21,0,0,0,0
31,8484255,Jason Polin,R,COL,25,0,0,0,0
31,8481077,John Leonard,L,,26,0,0,0,0
31,8481534,Raphael Lavoie,C,EDM,24,0,0,0,0
31,8483609,Adam Klapka,R,CGY,24,0,0,0,0
31,8482751,Ryan Winterton,C,SEA,21,0,0,0,0
31,8480267,Sammy Walker,C,MIN,25,0,0,0,0
31,8475766,Austin Watson,L,,32,0,0,0,0
31,8482460,Matt Rempe,C,NYR,22,0,0,0,0
31,8481065,Angus Crookshank,L,OTT,25,0,0,0,0
31,8481070,Hugh McGing,L,,26,0,0,0,0
31,8476323,Max McCormick,L,SEA,32,0,0,0,0
31,8483395,Arshdeep Bains,L,VAN,23,0,0,0,0
31,8484259,Ondrej Pavel,C,COL,31,0,0,0,0
31,8483432,Luca Del Bel Belluz,C,CBJ,31,0,0,0,0
31,8483045,Cameron Butler,R,CBJ,31,0,0,0,0
31,8482061,Brandon Biro,L,SEA,26,0,0,0,0
31,8477401,John Hayden,C,SEA,29,0,0,0,0
31,8475278,Byron Froese,C,,33,0,0,0,0
31,8478446,Glenn Gawdin,C,LAK,27,0,0,0,0
31,8477993,Justin Kirkland,C,CGY,28,0,0,0,0
31,8482147,Jean-Luc Foudy,C,COL,22,0,0,0,0
31,8480032,Shane Bowers,C,NJD,25,0,0,0,0
31,8479330,Brandon Gignac,C,MTL,27,0,0,0,0
31,8480776,Sheldon Rempal,R,,29,0,0,0,0
31,8475413,Justin Dowling,C,NJD,34,0,0,0,0
31,8481726,Adam Edstrom,C,NYR,24,0,0,0,0
31,8480844,Grigori Denisenko,L,VGK,24,0,0,0,0
31,8478147,Bokondji Imama,L,PIT,28,0,0,0,0
31,8478881,Brett Seney,L,CHI,28,0,0,0,0
31,8483630,Pavol Regenda,L,ANA,25,0,0,0,0
31,8480836,Jonathan Gruden,C,,24,0,0,0,0
31,8484314,Jiri Smejkal,L,,28,0,0,0,0
31,8475780,Chris Wagner,R,COL,33,0,0,0,0
31,8479546,Oskar Steen,C,,26,0,0,0,0
31,8483597,Milos Kelemen,L,UTA,25,0,0,0,0
31,8481789,Tye Kartye,L,SEA,23,0,0,0,0
31,8484325,Waltteri Merela,C,TBL,26,0,0,0,0
31,8479421,Jacob Moverare,D,LAK,26,0,0,0,0
31,8481585,Egor Afanasyev,L,SJS,23,0,0,0,0
31,8479547,Matthew Phillips,R,,26,0,0,0,0
31,8479367,William Lockwood,R,FLA,26,0,0,0,0
31,8476915,Jujhar Khaira,L,,30,0,0,0,0
31,8481422,Jacob Lucchini,C,NSH,29,0,0,0,0
31,8480468,James Hamblin,L,EDM,25,0,0,0,0
31,8478051,Max Willman,C,NJD,29,0,0,0,0
31,8481556,John Beecher,C,BOS,23,0,0,0,0
31,8478078,Rourke Chartier,C,,28,0,0,0,0
32,8476453,Nikita Kucherov,R,TBL,31,82,46,94,140
32,8481559,Jack Hughes,C,NJD,23,82,49,76,125
32,8478402,Connor McDavid,C,EDM,27,82,44,81,125
32,8478550,Artemi Panarin,L,NYR,33,82,47,74,121
32,8476468,J.T. Miller,C,VAN,31,82,37,84,121
32,8477934,Leon Draisaitl,C,EDM,29,82,48,66,114
32,8477492,Nathan MacKinnon,C,COL,29,82,44,70,114
32,8478420,Mikko Rantanen,R,COL,28,82,57,55,112
32,8479407,Jesper Bratt,L,NJD,26,82,39,73,112
32,8479318,Auston Matthews,C,TOR,27,82,60,50,110
32,8476887,Filip Forsberg,L,NSH,30,82,49,61,110
32,8477956,David Pastrnak,R,BOS,28,82,54,53,107
32,8479343,Clayton Keller,R,UTA,26,82,45,61,106
32,8480069,Cale Makar,D,COL,26,82,25,80,105
32,8477939,William Nylander,R,TOR,28,82,38,66,104
32,8480800,Quinn Hughes,D,VAN,25,82,14,89,103
32,8477409,Carter Verhaeghe,C,FLA,29,82,48,53,101
32,8478398,Kyle Connor,L,WPG,28,82,45,56,101
32,8477942,Kevin Fiala,L,LAK,28,82,34,67,101
32,8478864,Kirill Kaprizov,L,MIN,27,82,43,57,100
32,8478010,Brayden Point,C,TBL,28,82,47,49,96
32,8480012,Elias Pettersson,C,VAN,26,82,44,50,94
32,8477493,Aleksander Barkov,C,FLA,29,82,35,59,94
32,8476454,Ryan Nugent-Hopkins,C,EDM,31,82,29,65,94
32,8480027,Jason Robertson,L,DAL,25,82,37,56,93
32,8478403,Jack Eichel,C,VGK,28,82,46,45,91
32,8479675,Trevor Moore,L,LAK,29,82,41,50,91
32,8478427,Sebastian Aho,C,CAR,27,82,37,53,90
32,8477946,Dylan Larkin,C,DET,28,82,36,54,90
32,8474564,Steven Stamkos,C,NSH,34,82,39,50,89
32,8481557,Matt Boldy,L,MIN,23,82,35,54,89
32,8474600,Roman Josi,D,NSH,34,82,19,70,89
32,8480801,Brady Tkachuk,L,OTT,25,82,40,48,88
32,8476389,Vincent Trocheck,C,NYR,31,82,38,49,87
32,8479314,Matthew Tkachuk,L,FLA,27,82,24,63,87
32,8471675,Sidney Crosby,C,PIT,37,82,37,49,86
32,8480002,Nico Hischier,C,NJD,25,82,31,55,86
32,8478439,Travis Konecny,R,PHI,27,82,41,44,85
32,8477402,Pavel Buchnevich,L,STL,29,82,32,53,85
32,8480023,Robert Thomas,C,STL,25,82,32,53,85
32,8482116,Tim Stützle,C,OTT,22,82,30,55,85
32,8477949,Alex Tuch,R,BUF,28,82,33,51,84
32,8476346,Johnny Gaudreau,L,CBJ,31,82,24,60,84
32,8476479,Phillip Danault,C,LAK,31,82,24,60,84
32,8479339,Patrik Laine,L,CBJ,26,82,38,45,83
32,8479323,Adam Fox,D,NYR,26,82,10,73,83
32,8478414,Timo Meier,R,NJD,28,82,38,44,82
32,8479420,Tage Thompson,C,BUF,27,82,36,46,82
32,8480018,Nick Suzuki,C,MTL,25,82,36,43,79
32,8476460,Mark Scheifele,C,WPG,31,82,33,46,79
32,8476459,Mika Zibanejad,C,NYR,31,82,29,50,79
32,8481523,Kirby Dach,C,MTL,23,82,13,66,79
32,8477940,Nikolaj Ehlers,L,WPG,28,82,29,49,78
32,8471685,Anze Kopitar,C,LAK,37,82,26,52,78
32,8477960,Adrian Kempe,R,LAK,28,82,41,36,77
32,8475184,Chris Kreider,L,NYR,33,82,39,38,77
32,8477951,Nick Schmaltz,C,UTA,28,82,28,49,77
32,8477404,Jake Guentzel,C,TBL,30,82,36,40,76
32,8471215,Evgeni Malkin,C,PIT,38,82,31,44,75
32,8478445,Mathew Barzal,C,NYI,27,82,23,52,75
32,8475913,Mark Stone,R,VGK,32,82,21,54,75
32,8482093,Seth Jarvis,C,CAR,22,82,38,36,74
32,8476881,Tomas Hertl,C,VGK,31,82,35,39,74
32,8477447,Shea Theodore,D,VGK,29,82,12,62,74
32,8475168,Matt Duchene,C,DAL,33,82,36,37,73
32,8479385,Jordan Kyrou,C,STL,26,82,35,38,73
32,8471214,Alex Ovechkin,L,WSH,39,82,34,39,73
32,8478449,Roope Hintz,C,DAL,28,82,34,39,73
32,8474141,Patrick Kane,R,DET,36,82,33,40,73
32,8475167,Victor Hedman,D,TBL,34,82,12,61,73
32,8473419,Brad Marchand,L,BOS,36,82,24,48,72
32,8479542,Brandon Hagel,L,TBL,26,82,22,50,72
32,8481540,Cole Caufield,R,MTL,23,82,33,38,71
32,8476448,William Karlsson,C,VGK,31,82,31,40,71
32,8475166,John Tavares,C,TOR,34,82,30,41,71
32,8475786,Zach Hyman,L,EDM,32,82,34,36,70
32,8475170,Brayden Schenn,C,STL,33,82,31,39,70
32,8477998,Warren Foegele,L,LAK,28,82,30,40,70
32,8479337,Alex DeBrincat,R,DET,27,82,29,41,70
32,8475172,Nazem Kadri,C,CGY,34,82,25,45,70
32,8477504,Josh Morrissey,D,WPG,29,82,15,55,70
32,8480839,Rasmus Dahlin,D,BUF,24,82,14,56,70
32,8480036,Miro Heiskanen,D,DAL,25,82,11,59,70
32,8475784,Jeff Skinner,C,EDM,32,82,33,35,68
32,8478042,Viktor Arvidsson,R,EDM,31,82,22,46,68
32,8480803,Evan Bouchard,D,EDM,25,82,10,58,68
32,8477933,Sam Reinhart,C,FLA,29,82,31,36,67
32,8475810,Bryan Rust,R,PIT,32,82,31,36,67
32,8480830,Andrei Svechnikov,R,CAR,24,82,27,40,67
32,8478440,Dylan Strome,C,WSH,27,82,26,41,67
32,8473512,Claude Giroux,R,OTT,36,82,25,42,67
32,8473994,Jamie Benn,L,DAL,35,82,20,47,67
32,8478460,Zach Werenski,D,CBJ,27,82,19,48,67
32,8476853,Morgan Rielly,D,TOR,30,82,7,60,67
32,8477501,Valeri Nichushkin,R,COL,29,82,34,32,66
32,8476539,Jonathan Marchessault,R,NSH,34,82,33,33,66
32,8477497,Sean Monahan,C,CBJ,30,82,20,44,64
32,8475798,Mikael Granlund,C,SJS,32,82,14,50,64
32,8480865,Noah Dobson,D,NYI,24,82,12,52,64
32,8476462,Dougie Hamilton,D,NJD,31,82,12,52,64
32,8475726,Tyler Toffoli,C,SJS,32,82,40,23,63
32,8478498,Jake DeBrusk,L,VAN,28,82,38,25,63
32,8475794,Tyler Seguin,C,DAL,32,82,28,35,63
32,8475765,Vladimir Tarasenko,R,DET,33,82,25,38,63
32,8476456,Jonathan Huberdeau,C,CGY,31,82,16,47,63
32,8479325,Charlie McAvoy,D,BOS,27,82,14,49,63
32,8478873,Troy Terry,R,ANA,27,82,20,42,62
32,8478469,Thomas Chabot,D,OTT,27,82,18,44,62
32,8475692,Mats Zuccarello,R,MIN,37,82,14,48,62
32,8476399,Blake Coleman,C,CGY,33,82,43,18,61
32,8477955,Jared McCann,L,SEA,28,82,35,26,61
32,8477500,Bo Horvat,C,NYI,29,82,27,34,61
32,8477496,Elias Lindholm,C,BOS,30,82,24,37,61
32,8477494,Jonathan Drouin,L,COL,29,82,23,38,61
32,8482124,Quinton Byfield,R,LAK,22,82,21,40,61
32,8476882,Teuvo Teravainen,L,CHI,30,82,25,35,60
32,8481528,Dylan Cozens,C,BUF,23,82,21,39,60
32,8480208,Drake Batherson,R,OTT,26,82,20,40,60
32,8481711,Matias Maccelli,L,UTA,24,82,18,42,60
32,8480015,Owen Tippett,R,PHI,25,82,29,30,59
32,8482745,Mason McTavish,C,ANA,21,82,28,31,59
32,8478444,Brock Boeser,R,VAN,27,82,21,38,59
32,8475158,Ryan O'Reilly,C,NSH,33,82,21,38,59
32,8479999,Casey Mittelstadt,C,COL,26,82,20,39,59
32,8474563,Drew Doughty,D,LAK,35,82,17,42,59
32,8477451,Ryan Hartman,R,MIN,30,82,31,27,58
32,8478975,Mason Marchment,L,DAL,29,82,28,30,58
32,8482078,Lucas Raymond,L,DET,22,82,23,35,58
32,8476905,Chandler Stephenson,C,SEA,30,82,22,36,58
32,8477498,Darnell Nurse,D,EDM,29,82,20,38,58
32,8478542,Evan Rodrigues,C,FLA,31,82,19,39,58
32,8474578,Erik Karlsson,D,PIT,34,82,18,40,58
32,8479425,Filip Hronek,D,VAN,27,82,15,43,58
32,8482475,Yegor Chinakhov,R,CBJ,23,82,30,27,57
32,8475791,Taylor Hall,L,CHI,33,82,22,35,57
32,8474679,Gustav Nyquist,C,NSH,35,82,17,40,57
32,8478407,Vince Dunn,D,SEA,28,82,13,44,57
32,8478366,Frank Vatrano,R,ANA,30,82,33,23,56
32,8482699,Dylan Guenther,R,UTA,21,82,27,29,56
32,8481533,Trevor Zegras,C,ANA,23,82,22,34,56
32,8478401,Pavel Zacha,C,BOS,27,82,20,36,56
32,8476872,Scott Laughton,C,PHI,30,82,17,39,56
32,8478038,Devon Toews,D,COL,30,82,9,47,56
32,8478493,Joel Eriksson Ek,C,MIN,27,82,28,27,55
32,8475754,Brock Nelson,C,NYI,33,82,28,27,55
32,8480039,Martin Necas,C,CAR,25,82,23,32,55
32,8482097,Jack Quinn,R,BUF,23,82,23,32,55
32,8482665,Matty Beniers,C,SEA,22,82,16,39,55
32,8482740,Wyatt Johnston,C,DAL,21,82,26,28,54
32,8480797,Joel Farabee,L,PHI,24,82,26,28,54
32,8482109,Alexis Lafrenière,L,NYR,23,82,25,29,54
32,8478462,Nicolas Roy,C,VGK,27,82,25,29,54
32,8477964,Ivan Barbashev,C,VGK,29,82,22,32,54
32,8474150,Mikael Backlund,C,CGY,35,82,21,33,54
32,8477986,Brandon Montour,D,SEA,30,82,14,40,54
32,8476906,Shayne Gostisbehere,D,CAR,31,82,13,41,54
32,8478396,Noah Hanifin,D,VGK,27,82,12,42,54
32,8474590,John Carlson,D,WSH,34,82,6,48,54
32,8482110,Dawson Mercer,C,NJD,23,82,26,27,53
32,8480188,Fabian Zetterlund,L,SJS,25,82,21,32,53
32,8476923,Damon Severson,D,CBJ,30,82,9,44,53
32,8480064,Josh Norris,C,OTT,25,82,34,18,52
32,8477476,Artturi Lehkonen,L,COL,29,82,31,21,52
32,8482175,JJ Peterka,R,BUF,22,82,28,24,52
32,8476438,Brandon Saad,L,STL,32,82,27,25,52
32,8482684,Luke Hughes,D,NJD,21,82,15,37,52
32,8479400,Pierre-Luc Dubois,L,WSH,26,82,28,23,51
32,8474586,Jordan Eberle,R,SEA,34,82,28,23,51
32,8480829,Jesperi Kotkaniemi,C,CAR,24,82,24,27,51
32,8480028,Morgan Frost,C,PHI,25,82,22,29,51
32,8477932,Aaron Ekblad,D,FLA,28,82,18,33,51
32,8477444,Andre Burakovsky,L,SEA,29,82,16,35,51
32,8473422,Nick Foligno,L,CHI,37,82,16,35,51
32,8477495,Seth Jones,D,CHI,30,82,13,38,51
32,8471724,Kris Letang,D,PIT,37,82,11,40,51
32,8480014,Gabriel Vilardi,C,WPG,25,82,30,20,50
32,8475287,Erik Haula,L,NJD,33,82,27,23,50
32,8480849,Barrett Hayton,C,UTA,24,82,24,26,50
32,8473986,Alex Killorn,L,ANA,35,82,22,28,50
32,8478046,Danton Heinen,L,VAN,29,82,22,28,50
32,8480068,Ryan Poehling,C,PHI,25,82,18,32,50
32,8481596,Shane Pinto,C,OTT,24,82,12,38,50
32,8477935,Sam Bennett,C,FLA,28,82,23,26,49
32,8475799,Nino Niederreiter,R,WPG,32,82,22,27,49
32,8475745,Charlie Coyle,C,BOS,32,82,20,29,49
32,8474102,David Perron,L,OTT,36,82,17,32,49
32,8478397,Rasmus Andersson,D,CGY,28,82,12,37,49
32,8478055,Gustav Forsling,D,FLA,28,82,11,38,49
32,8477948,Travis Sanheim,D,PHI,28,82,10,39,49
32,8475169,Evander Kane,L,EDM,33,82,25,23,48
32,8476432,Boone Jenner,C,CBJ,31,82,23,25,48
32,8474149,Evgenii Dadonov,R,DAL,35,82,23,25,48
32,8475714,Calle Jarnkrok,C,TOR,33,82,22,26,48
32,8477456,J.T. Compher,L,DET,29,82,20,28,48
32,8475191,Reilly Smith,R,NYR,33,82,19,29,48
32,8480798,Philipp Kurashev,C,CHI,25,82,14,34,48
32,8476792,Torey Krug,D,STL,33,82,11,37,48
32,8478472,Mathieu Joseph,R,STL,27,82,11,37,48
32,8476875,Mike Matheson,D,MTL,30,82,7,41,48
32,8482089,Jake Neighbours,L,STL,22,82,25,22,47
32,8478458,Jack Roslovic,C,CAR,27,82,20,27,47
32,8477479,Tyler Bertuzzi,L,CHI,29,82,20,27,47
32,8476483,Rickard Rakell,R,PIT,31,82,18,29,47
32,8481618,Alex Newhook,C,MTL,23,82,18,29,47
32,8477416,Oliver Bjorkstrand,R,SEA,29,82,17,30,47
32,8481542,Moritz Seider,D,DET,23,82,9,38,47
32,8480434,Sean Durzi,D,UTA,26,82,6,41,47
32,8475314,Anders Lee,L,NYI,34,82,21,25,46
32,8476461,Sean Couturier,C,PHI,32,82,19,27,46
32,8483808,Andrei Kuzmenko,L,CGY,28,82,15,31,46
32,8477407,Anthony Duclair,L,NYI,29,82,23,22,45
32,8481560,Arthur Kaliyev,R,LAK,23,82,23,22,45
32,8480113,Alex Iafallo,L,WPG,31,82,18,27,45
32,8479345,Jakob Chychrun,D,WSH,26,82,14,31,45
32,8475218,Mattias Ekholm,D,EDM,34,82,12,33,45
32,8470613,Brent Burns,D,CAR,39,82,9,36,45
32,8476292,Ondrej Palat,L,NJD,33,82,7,38,45
32,8481624,Ilya Mikheyev,R,CHI,30,82,23,21,44
32,8476826,Yanni Gourde,C,SEA,33,82,21,23,44
32,8476480,Vladislav Namestnikov,C,WPG,32,82,21,23,44
32,8475722,Jason Zucker,L,BUF,32,82,20,24,44
32,8477987,Ryan Donato,C,CHI,28,82,20,24,44
32,8476458,Ryan Strome,C,ANA,31,82,14,30,44
32,8477021,Alex Kerfoot,C,UTA,30,82,14,30,44
32,8476960,Andreas Athanasiou,C,CHI,30,82,24,19,43
32,8478856,Conor Garland,R,VAN,28,82,22,21,43
32,8479987,Morgan Geekie,C,BOS,26,82,22,21,43
32,8475151,Kyle Palmieri,C,NYI,33,82,22,21,43
32,8483515,Juraj Slafkovsky,L,MTL,20,82,21,22,43
32,8482113,Anton Lundell,C,FLA,23,82,20,23,43
32,8482705,Cole Sillinger,C,CBJ,21,82,18,25,43
32,8482149,Cole Perfetti,C,WPG,22,82,17,26,43
32,8482720,Matthew Knies,L,TOR,22,82,14,29,43
32,8476329,Travis Boyd,C,MIN,31,82,12,31,43
32,8479410,Mikhail Sergachev,D,UTA,26,82,8,35,43
32,8480043,Timothy Liljegren,D,TOR,25,82,7,36,43
32,8479365,Trent Frederic,C,BOS,26,82,17,25,42
32,8478519,Anthony Cirelli,C,TBL,27,82,15,27,42
32,8474053,Logan Couture,C,SJS,35,82,14,28,42
32,8480078,Filip Chytil,C,NYR,25,82,13,29,42
32,8477503,Max Domi,C,TOR,29,82,12,30,42
32,8475753,Justin Faulk,D,STL,32,82,8,34,42
32,8477346,MacKenzie Weegar,D,CGY,30,82,5,37,42
32,8480893,Kirill Marchenko,R,CBJ,24,82,27,14,41
32,8479525,Ross Colton,C,COL,28,82,17,24,41
32,8480835,Jack Drury,C,CAR,24,82,17,24,41
32,8478047,Michael Bunting,L,PIT,29,82,16,25,41
32,8476392,Adam Lowry,C,WPG,31,82,16,25,41
32,8480459,Pius Suter,C,VAN,28,82,15,26,41
32,8476885,Jacob Trouba,D,NYR,30,82,12,29,41
32,8476958,Jaccob Slavin,D,CAR,30,82,7,34,41
32,8481554,Kaapo Kakko,R,NYR,23,82,28,12,40
32,8481604,Pavel Dorofeyev,L,VGK,24,82,24,16,40
32,8479992,Michael Rasmussen,C,DET,25,82,22,18,40
32,8481582,Nicholas Robertson,L,TOR,23,82,19,21,40
32,8474641,Adam Henrique,C,EDM,34,82,18,22,40
32,8471698,T.J. Oshie,R,WSH,38,82,11,29,40
32,8474565,Alex Pietrangelo,D,VGK,34,82,3,37,40
32,8482159,Tyson Foerster,R,PHI,22,82,26,13,39
32,8477511,Anthony Mantha,R,CGY,30,82,21,18,39
32,8478233,Andrew Mangiapane,L,WSH,28,82,21,18,39
32,8478474,Lawson Crouse,L,UTA,27,82,21,18,39
32,8482146,Luke Evangelista,R,NSH,22,82,21,18,39
32,8481068,Yegor Sharangovich,C,CGY,26,82,17,22,39
32,8482117,Lukas Reichel,L,CHI,22,82,17,22,39
32,8479941,Justin Danforth,R,CBJ,31,82,17,22,39
32,8478413,Jordan Greenway,L,BUF,27,82,17,22,39
32,8477429,Andrew Copp,C,DET,30,82,10,29,39
32,8482671,Owen Power,D,BUF,22,82,9,30,39
32,8480185,Eetu Luostarinen,C,FLA,26,82,9,30,39
32,8476854,Hampus Lindholm,D,BOS,30,82,5,34,39
32,8477426,Nicholas Paul,L,TBL,29,82,20,18,38
32,8481704,Juuso Parssinen,C,NSH,23,82,18,20,38
32,8480789,Oliver Wahlstrom,R,NYI,24,82,15,23,38
32,8481656,Aliaksei Protas,C,WSH,23,82,14,24,38
32,8473507,Jeff Petry,D,DET,37,82,9,29,38
32,8476869,Brady Skjei,D,NSH,30,82,8,30,38
32,8480873,Rasmus Sandin,D,WSH,24,82,7,31,38
32,8479591,Michael Eyssimont,C,TBL,28,82,27,10,37
32,8478057,Dakota Joshua,C,VAN,28,82,19,18,37
32,8476925,Colton Sissons,C,NSH,31,82,19,18,37
32,8480748,Kiefer Sherwood,L,VAN,29,82,18,19,37
32,8476419,Jean-Gabriel Pageau,C,NYI,32,82,15,22,37
32,8475763,Kevin Hayes,R,PIT,32,82,15,22,37
32,8479390,Taylor Raddysh,R,WSH,26,82,14,23,37
32,8477839,Conor Sheary,L,TBL,32,82,13,24,37
32,8482660,Kent Johnson,C,CBJ,22,82,11,26,37
32,8479353,Brett Howden,C,VGK,26,82,10,27,37
32,8477450,Jason Dickinson,C,CHI,29,82,20,16,36
32,8484144,Connor Bedard,C,CHI,19,82,17,19,36
32,8475760,Nick Bjugstad,C,UTA,32,82,17,19,36
32,8481535,Nils Hoglander,L,VAN,24,82,16,20,36
32,8478463,Anthony Beauvillier,L,PIT,27,82,15,21,36
32,8480220,Noah Cates,L,PHI,25,82,15,21,36
32,8480802,Ryan McLeod,C,BUF,25,82,14,22,36
32,8480145,Neal Pionk,D,WPG,29,82,10,26,36
32,8481606,Jordan Spence,D,LAK,23,82,9,27,36
32,8481581,Thomas Harley,D,DAL,23,82,8,28,36
32,8477488,Brett Pesce,D,NJD,30,82,6,30,36
32,8481546,Cam York,D,PHI,23,82,5,31,36
32,8482259,Bobby McMann,C,TOR,28,82,23,12,35
32,8480855,Jack McBain,C,UTA,24,82,21,14,35
32,8477953,Kasperi Kapanen,R,STL,28,82,16,19,35
32,8473533,Jordan Staal,C,CAR,36,82,14,21,35
32,8481186,Logan O'Connor,R,COL,28,82,14,21,35
32,8475768,Jaden Schwartz,C,SEA,32,82,13,22,35
32,8480807,Mattias Samuelsson,D,BUF,24,82,6,29,35
32,8475764,Cam Fowler,D,ANA,33,82,4,31,35
32,8481580,Connor McMichael,C,WSH,23,82,18,16,34
32,8477952,Robby Fabbri,C,ANA,28,82,16,18,34
32,8484203,Bradly Nadeau,L,CAR,19,82,16,18,34
32,8480009,Eeli Tolvanen,R,SEA,25,82,13,21,34
32,8482667,William Eklund,L,SJS,22,82,11,23,34
32,8478438,Tommy Novak,C,NSH,27,82,10,24,34
32,8474716,Jared Spurgeon,D,MIN,35,82,8,26,34
32,8475200,Dmitry Orlov,D,CAR,33,82,7,27,34
32,8478115,Pierre Engvall,L,NYI,28,82,23,10,33
32,8480144,David Kampf,C,TOR,29,82,17,16,33
32,8482062,Cole Smith,L,NSH,29,82,14,19,33
32,8482133,Thomas Bordeleau,C,SJS,22,82,14,19,33
32,8484153,Leo Carlsson,C,ANA,20,82,14,19,33
32,8476921,Jordan Martinook,L,CAR,32,82,13,20,33
32,8477947,Sonny Milano,L,WSH,28,82,12,21,33
32,8475855,Jesper Fast,R,CAR,33,82,12,21,33
32,8482092,Ridly Greig,C,OTT,22,82,11,22,33
32,8478911,Matt Roy,D,WSH,29,82,11,22,33
32,8482055,Drew O'Connor,L,PIT,26,82,10,23,33
32,8475171,Oliver Ekman-Larsson,D,TOR,33,82,10,23,33
32,8480817,K'Andre Miller,D,NYR,24,82,7,26,33
32,8482122,Brock Faber,D,MIN,22,82,6,27,33
32,8481178,Egor Zamula,D,PHI,24,82,1,32,33
32,8481013,Jonatan Berggren,R,DET,24,82,17,15,32
32,8474189,Lars Eller,C,PIT,35,82,15,17,32
32,8476374,Sean Kuraly,C,CBJ,31,82,14,18,32
32,8476897,Oskar Sundqvist,C,STL,30,82,13,19,32
32,8482655,J.J. Moser,D,TBL,24,82,8,24,32
32,8477969,Marcus Pettersson,D,PIT,28,82,7,25,32
32,8479976,Juuso Valimaki,D,UTA,26,82,5,27,32
32,8477506,Ryan Pulock,D,NYI,30,82,4,28,32
32,8481568,Alex Vlasic,D,CHI,23,82,1,31,32
32,8478508,Yakov Trenin,C,MIN,27,82,19,12,31
32,8477406,Mattias Janmark,C,EDM,32,82,19,12,31
32,8479661,Tanner Jeannot,L,LAK,27,82,17,14,31
32,8478891,Mason Appleton,C,WPG,28,82,16,15,31
32,8473563,Nicklas Backstrom,C,WSH,37,82,13,18,31
32,8475343,Nic Dowd,C,WSH,34,82,13,18,31
32,8480003,Jesper Boqvist,C,FLA,26,82,13,18,31
32,8476889,Radek Faksa,C,STL,30,82,13,18,31
32,8478109,Victor Olofsson,L,VGK,29,82,10,21,31
32,8479351,Sam Steel,C,DAL,26,82,10,21,31
32,8480073,Erik Brannstrom,D,COL,25,82,5,26,31
32,8478882,Vladislav Gavrikov,D,LAK,29,82,5,26,31
32,8474151,Ryan McDonagh,D,TBL,35,82,2,29,31
32,8476331,Dylan DeMelo,D,WPG,31,82,2,29,31
32,8481032,Paul Cotter,C,NJD,25,82,16,14,30
32,8483431,Logan Cooley,C,UTA,20,82,14,16,30
32,8475193,Tomas Tatar,L,NJD,34,82,14,16,30
32,8481517,Brett Leason,R,ANA,25,82,13,17,30
32,8482105,Jake Sanderson,D,OTT,22,82,11,19,30
32,8480074,Alexandre Texier,C,STL,25,82,11,19,30
32,8476474,Stefan Noesen,R,NJD,31,82,10,20,30
32,8475149,Marcus Johansson,L,MIN,34,82,10,20,30
32,8474574,Tyler Myers,D,VAN,34,82,10,20,30
32,8482111,Justin Barron,D,MTL,23,82,8,22,30
32,8482807,Ethan Del Mastro,D,CHI,21,82,7,23,30
32,8480049,Dylan Samberg,D,WPG,25,82,3,27,30
32,8476880,Tom Wilson,R,WSH,30,82,15,14,29
32,8481481,Blake Lizotte,C,PIT,27,82,15,14,29
32,8478432,Christian Fischer,R,DET,27,82,14,15,29
32,8480871,Adam Boqvist,D,FLA,24,82,13,16,29
32,8475793,Ryan Johansen,C,PHI,32,82,12,17,29
32,8478133,Jake Evans,C,MTL,28,82,10,19,29
32,8477989,Christian Dvorak,C,MTL,28,82,10,19,29
32,8477369,Carson Soucy,D,VAN,30,82,9,20,29
32,8476927,Teddy Blueger,C,VAN,30,82,5,24,29
32,8479371,Dante Fabbro,D,NSH,26,82,4,25,29
32,8476469,Joel Armia,R,MTL,31,82,17,11,28
32,8474715,Cam Atkinson,R,TBL,35,82,14,14,28
32,8479393,Noah Gregor,C,OTT,26,82,14,14,28
32,8482702,Logan Stankoven,C,DAL,21,82,14,14,28
32,8476981,Josh Anderson,R,MTL,30,82,13,15,28
32,8477335,Kyle Burroughs,D,LAK,29,82,10,18,28
32,8479983,Mario Ferraro,D,SJS,26,82,8,20,28
32,8478013,Jake Walman,D,SJS,28,82,8,20,28
32,8474673,TJ Brodie,D,CHI,34,82,4,24,28
32,8475188,Brayden McNabb,D,VGK,33,82,4,24,28
32,8482079,Marco Rossi,C,MIN,23,82,15,12,27
32,8480995,Pontus Holmberg,R,TOR,25,82,15,12,27
32,8481093,Rafael Harvey-Pinard,L,MTL,25,82,15,12,27
32,8479368,Max Jones,L,BOS,26,82,14,13,27
32,8481477,Nico Sturm,C,SJS,29,82,13,14,27
32,8475848,Brendan Gallagher,R,MTL,32,82,12,15,27
32,8479996,Cody Glass,C,NSH,25,82,12,15,27
32,8478020,Michael Amadio,C,OTT,28,82,11,16,27
32,8482624,Daniil Miromanov,D,CGY,27,82,8,19,27
32,8476624,Barclay Goodrow,C,SJS,31,82,8,19,27
32,8480336,Sean Walker,D,CAR,30,82,7,20,27
32,8476463,Jonas Brodin,D,MIN,31,82,6,21,27
32,8481522,Peyton Krebs,C,BUF,23,82,6,21,27
32,8482073,Braden Schneider,D,NYR,23,82,5,22,27
32,8478507,John Marino,D,UTA,27,82,4,23,27
32,8480035,Henri Jokiharju,D,BUF,25,82,4,23,27
32,8479369,Andrew Peeke,D,BOS,26,82,4,23,27
32,8476979,Erik Gustafsson,D,DET,32,82,2,25,27
32,8482125,Alexander Holtz,R,VGK,22,82,16,10,26
32,8476918,Jimmy Vesey,L,NYR,31,82,13,13,26
32,8482074,Connor Zary,C,CGY,23,82,12,14,26
32,8470621,Corey Perry,R,EDM,39,82,12,14,26
32,8476278,Colin Blackwell,C,DAL,31,82,10,16,26
32,8476312,Josh Manson,D,COL,33,82,9,17,26
32,8478851,Alexandre Carrier,D,NSH,28,82,5,21,26
32,8476917,Adam Pelech,D,NYI,30,82,4,22,26
32,8478500,Ivan Provorov,D,CBJ,27,82,3,23,26
32,8479398,Samuel Girard,D,COL,26,82,3,23,26
32,8476931,Jake McCabe,D,TOR,31,82,1,25,26
32,8482141,Lukas Cormier,D,VGK,22,82,13,12,25
32,8477015,Connor Brown,R,EDM,30,82,10,15,25
32,8479402,Jake Bean,D,CGY,26,82,7,18,25
32,8477499,Rasmus Ristolainen,D,PHI,30,82,6,19,25
32,8479998,Mikey Anderson,D,LAK,25,82,5,20,25
32,8478840,Will Borgen,D,SEA,28,82,4,21,25
32,8476902,Esa Lindell,D,DAL,30,82,3,22,25
32,8476441,Joel Edmundson,D,LAK,31,82,3,22,25
32,8476892,Colton Parayko,D,STL,31,82,2,23,25
32,8482077,Dylan Holloway,L,EDM,23,82,14,10,24
32,8477508,Curtis Lazar,C,NJD,29,82,10,14,24
32,8484166,Adam Fantilli,C,CBJ,20,82,10,14,24
32,8484145,Zach Benson,L,BUF,19,82,9,15,24
32,8477392,Hudson Fasching,R,NYI,29,82,9,15,24
32,8483468,Jiri Kulich,C,BUF,20,82,9,15,24
32,8477903,Garnet Hathaway,R,PHI,33,82,8,16,24
32,8475324,Nick Jensen,D,OTT,34,82,7,17,24
32,8477435,Ryan Graves,D,PIT,29,82,6,18,24
32,8474090,Brendan Smith,D,DAL,35,82,6,18,24
32,8476422,Mike Reilly,D,NYI,31,82,5,19,24
32,8482142,Jamie Drysdale,D,PHI,22,82,3,21,24
32,8476873,Mark Jankowski,C,NSH,30,82,17,6,23
32,8476442,Matt Nieto,L,PIT,32,82,13,10,23
32,8480021,Jack Studnicka,C,LAK,25,82,11,12,23
32,8481553,Bobby Brink,R,PHI,23,82,7,16,23
32,8477919,Frederick Gaudreau,C,MIN,31,82,7,16,23
32,8480806,Isac Lundestrom,C,ANA,25,82,6,17,23
32,8480980,Connor Dewar,C,TOR,25,82,6,17,23
32,8481567,Henry Thrun,D,SJS,23,82,6,17,23
32,8479324,Ryan Lindgren,D,NYR,26,82,4,19,23
32,8476879,Cody Ceci,D,EDM,31,82,4,19,23
32,8483565,Nick Blankenburg,D,NSH,26,82,3,20,23
32,8476967,Brett Kulak,D,EDM,30,82,3,20,23
32,8479359,Beck Malenstyn,L,BUF,26,82,11,11,22
32,8480025,MacKenzie Entwistle,R,FLA,25,82,11,11,22
32,8476878,Zemgus Girgensons,L,TBL,30,82,10,12,22
32,8483495,Simon Nemec,D,NJD,20,82,9,13,22
32,8475231,Casey Cizikas,C,NYI,33,82,8,14,22
32,8477931,Tomas Nosek,L,FLA,32,82,7,15,22
32,8480796,Martin Fehervary,D,WSH,25,82,6,16,22
32,8483457,Lane Hutson,D,MTL,20,82,5,17,22
32,8478443,Brandon Carlo,D,BOS,28,82,4,18,22
32,8480222,Sebastian Aho,D,PIT,28,82,2,20,22
32,8481601,Simon Holmstrom,R,NYI,23,82,11,10,21
32,8479414,Nathan Bastian,R,NJD,27,82,11,10,21
32,8482101,Danil Gushchin,L,SJS,22,82,10,11,21
32,8477425,Miles Wood,L,COL,29,82,9,12,21
32,8478569,Noel Acciari,C,PIT,33,82,9,12,21
32,8478434,Keegan Kolesar,R,VGK,27,82,8,13,21
32,8478178,Darren Raddysh,D,TBL,28,82,7,14,21
32,8477938,Haydn Fleury,D,WPG,28,82,5,16,21
32,8475181,Nick Leddy,D,STL,33,82,4,17,21
32,8482087,Kaiden Guhle,D,MTL,22,82,4,17,21
32,8475790,Erik Gudbranson,D,CBJ,32,82,3,18,21
32,8483466,Kevin Korchinski,D,CHI,20,82,3,18,21
32,8480172,Jan Rutta,D,SJS,34,82,2,19,21
32,8481708,Zac Jones,D,NYR,24,82,1,20,21
32,8477845,Trevor van Riemsdyk,D,WSH,33,82,1,20,21
32,8479293,Brandon Tanev,L,SEA,33,82,13,7,20
32,8473453,Trevor Lewis,C,LAK,37,82,12,8,20
32,8480813,Joe Veleno,C,DET,24,82,8,12,20
32,8483505,Matthew Poitras,C,BOS,20,82,8,12,20
32,8483763,Maksymilian Szuber,D,UTA,22,82,7,13,20
32,8475462,Radko Gudas,D,ANA,34,82,6,14,20
32,8475220,Marcus Foligno,L,MIN,33,82,4,16,20
32,8475279,Ben Chiarot,D,DET,33,82,4,16,20
32,8480246,Nick Perbix,D,TBL,26,82,4,16,20
32,8480878,Nils Lundkvist,D,DAL,24,82,3,17,20
32,8477220,Nate Schmidt,D,FLA,33,82,2,18,20
32,8481014,Alexander Romanov,D,NYI,24,82,2,18,20
32,8477507,Nikita Zadorov,D,BOS,29,82,1,19,20
32,8482666,Scott Morrow,D,CAR,22,82,11,8,19
32,8479638,Justin Brazeau,R,BOS,26,82,11,8,19
32,8480281,Alexey Toropchenko,R,STL,25,82,10,9,19
32,8477353,Tyler Motte,C,DET,29,82,9,10,19
32,8478211,Dryden Hunt,L,CGY,29,82,7,12,19
32,8482166,Shakir Mukhamadullin,D,SJS,22,82,7,12,19
32,8478136,Jake Middleton,D,MIN,28,82,3,16,19
32,8475455,Brenden Dillon,D,NJD,34,82,2,17,19
32,8481028,Martin Pospisil,C,CGY,25,82,9,9,18
32,8475842,Sam Carrick,C,NYR,32,82,9,9,18
32,8482659,Josh Doan,R,UTA,22,82,8,10,18
32,8483493,Frank Nazar,C,CHI,20,82,7,11,18
32,8476457,Adam Larsson,D,SEA,32,82,6,12,18
32,8480990,Declan Chisholm,D,MIN,24,82,6,12,18
32,8478399,Jonas Siegenthaler,D,NJD,27,82,5,13,18
32,8482245,Artem Zub,D,OTT,29,82,4,14,18
32,8476467,Jamie Oleksiak,D,SEA,32,82,3,15,18
32,8475718,Justin Holl,D,DET,32,82,3,15,18
32,8475177,Calvin de Haan,D,COL,33,82,3,15,18
32,8475233,David Savard,D,MTL,34,82,3,15,18
32,8481605,Jackson LaCombe,D,ANA,23,82,3,15,18
32,8470600,Ryan Suter,D,STL,39,82,3,15,18
32,8482155,Alex Laferriere,R,LAK,23,82,8,9,17
32,8482153,Brendan Brisson,C,VGK,23,82,6,11,17
32,8480950,Ilya Lyubushkin,D,DAL,30,82,4,13,17
32,8474013,Ian Cole,D,UTA,35,82,4,13,17
32,8483482,Tristan Luneau,D,ANA,20,82,3,14,17
32,8483567,Georgii Merkulov,C,BOS,24,82,11,5,16
32,8477505,Alexander Wennberg,C,SJS,30,82,9,7,16
32,8479291,Kevin Rooney,C,CGY,31,82,9,7,16
32,8479316,Luke Kunin,C,SJS,27,82,6,10,16
32,8484149,Gavin Brindley,C,CBJ,20,82,6,10,16
32,8476372,Nick Seeler,D,PHI,31,82,5,11,16
32,8480860,Kevin Bahl,D,CGY,24,82,5,11,16
32,8476525,Colin Miller,D,WPG,32,82,4,12,16
32,8478450,Parker Wotherspoon,D,BOS,27,82,4,12,16
32,8478416,Erik Cernak,D,TBL,27,82,2,14,16
32,8475690,Chris Tanev,D,TOR,35,82,1,15,16
32,8482679,Matt Coronato,R,CGY,22,82,9,6,15
32,8482145,Mavrik Bourque,C,DAL,22,82,7,8,15
32,8482809,Jackson Blake,R,CAR,21,82,6,9,15
32,8481524,Bowen Byram,D,BUF,23,82,5,10,15
32,8483490,Pavel Mintyukov,D,ANA,21,82,3,12,15
32,8483460,David Jiricek,D,CBJ,21,82,3,12,15
32,8482470,Ilya Solovyov,D,CGY,24,82,1,14,15
32,8482762,Simon Edvinsson,D,DET,21,82,7,7,14
32,8484911,Collin Graf,R,SJS,22,82,7,7,14
32,8483445,Cutter Gauthier,L,ANA,20,82,5,9,14
32,8482118,Sam Colangelo,R,ANA,23,82,5,9,14
32,8479980,Nicolas Hague,D,VGK,26,82,3,11,14
32,8479442,Troy Stecher,D,EDM,30,82,3,11,14
32,8480834,Ty Emberson,D,SJS,24,82,2,12,14
32,8476429,Scott Mayfield,D,NYI,32,82,1,13,14
32,8482787,Nikita Chibrikov,R,WPG,31,82,1,13,14
32,8482733,Logan Mailloux,D,MTL,31,82,10,3,13
32,8476858,Phillip Di Giuseppe,L,VAN,31,82,9,4,13
32,8480448,Parker Kelly,L,COL,25,82,6,7,13
32,8474612,Travis Hamonic,D,OTT,34,82,3,10,13
32,8481122,Simon Benoit,D,TOR,26,82,1,12,13
32,8471677,Jack Johnson,D,CBJ,37,82,1,12,13
32,8482712,Oskar Olausson,R,COL,22,82,9,3,12
32,8483012,Logan Morrison,C,SEA,22,82,7,5,12
32,8482070,Mitchell Chaffee,R,TBL,26,82,6,6,12
32,8482749,Joshua Roy,R,MTL,21,82,5,7,12
32,8477365,Connor Clifton,D,BUF,29,82,5,7,12
32,8475762,Derek Forbort,D,VAN,32,82,3,9,12
32,8477034,Jaycob Megna,D,FLA,32,82,3,9,12
32,8482803,Olen Zellweger,D,ANA,21,82,2,10,12
32,8474567,Zach Bogosian,D,MIN,34,82,2,10,12
32,8482858,Ryker Evans,D,SEA,23,82,1,11,12
32,8476891,Matt Grzelcyk,D,PIT,30,82,0,12,12
32,8480870,Bo Groulx,C,NYR,24,82,8,3,11
32,8483499,Liam Ohgren,L,MIN,20,82,6,5,11
32,8482859,Zack Ostapchuk,C,OTT,21,82,6,5,11
32,8481641,Joel Kiviranta,L,COL,28,82,5,6,11
32,8483397,Marc McLaughlin,C,BOS,25,82,4,7,11
32,8476473,Connor Murphy,D,CHI,31,82,3,8,11
32,8479576,Vincent Desharnais,D,VAN,28,82,4,6,10
32,8482713,Mackie Samoskevich,R,FLA,22,82,3,7,10
32,8483524,Shane Wright,C,SEA,20,82,3,6,9
32,8478859,Niko Mikkola,D,FLA,28,82,2,7,9
32,8476822,Luke Glendening,C,TBL,35,82,5,3,8
32,8481699,Aku Raty,R,UTA,23,82,3,5,8
32,8483489,Fraser Minten,C,TOR,31,82,3,5,8
32,8483471,Brad Lambert,C,WPG,31,82,2,6,8
32,8478874,Adam Gaudette,C,OTT,28,82,1,7,8
32,8474062,Riley Nash,C,NYR,35,82,4,3,7
32,8482516,Matthew Kessel,D,STL,24,82,1,6,7
32,8478468,Jeremy Lauzon,D,NSH,27,82,0,7,7
32,8480879,Jacob Bernard-Docker,D,OTT,24,82,1,3,4
32,8470794,Joe Pavelski,C,,40,0,0,0,0
32,8481703,Valtteri Puustinen,R,PIT,25,0,0,0,0
32,8477950,Tony DeAngelo,D,,29,0,0,0,0
32,8481577,Philip Tomasino,C,NSH,23,0,0,0,0
32,8475197,Tyson Barrie,D,,33,0,0,0,0
32,8471218,Blake Wheeler,R,,38,0,0,0,0
32,8474157,Max Pacioretty,L,,36,0,0,0,0
32,8478466,Daniel Sprong,R,VAN,27,0,0,0,0
32,8475744,Evgeny Kuznetsov,C,,32,0,0,0,0
32,8481019,David Gustafsson,C,WPG,24,0,0,0,0
32,8475906,John Klingberg,D,,32,0,0,0,0
32,8479348,Kale Clague,D,BUF,26,0,0,0,0
32,8476952,Dominic Toninato,C,WPG,30,0,0,0,0
32,8473473,Milan Lucic,L,,36,0,0,0,0
32,8474037,James van Riemsdyk,L,,35,0,0,0,0
32,8474602,Justin Schultz,D,,34,0,0,0,0
32,8482222,Alexander Barabanov,L,,30,0,0,0,0
32,8479372,Josh Mahura,D,SEA,26,0,0,0,0
32,8479982,Conor Timmins,D,TOR,26,0,0,0,0
32,8474031,Kevin Shattenkirk,D,,35,0,0,0,0
32,8480008,Adam Ruzicka,C,,25,0,0,0,0
32,8481059,Scott Perunovich,D,STL,26,0,0,0,0
32,8480884,Calen Addison,D,,24,0,0,0,0
32,8476994,Vinnie Hinostroza,C,NSH,30,0,0,0,0
32,8478452,Caleb Jones,D,LAK,27,0,0,0,0
32,8480157,Calle Rosen,D,COL,30,0,0,0,0
32,8481609,Vladislav Kolyachonok,D,UTA,23,0,0,0,0
32,8479415,Michael McLeod,C,,26,0,0,0,0
32,8476919,Chris Tierney,C,,30,0,0,0,0
32,8479639,Dylan Coghlan,D,WPG,26,0,0,0,0
32,8478146,Matthew Highmore,C,OTT,28,0,0,0,0
32,8478970,Jalen Chatfield,D,CAR,28,0,0,0,0
32,8480205,Emil Bemstrom,C,PIT,25,0,0,0,0
32,8474884,Mike Hoffman,C,,35,0,0,0,0
32,8471274,Alex Goligoski,D,,39,0,0,0,0
32,8478104,Sammy Blais,L,,28,0,0,0,0
32,8474870,Tyler Johnson,C,,34,0,0,0,0
32,8476913,Devin Shore,C,MIN,30,0,0,0,0
32,8481598,Philip Broberg,D,EDM,23,0,0,0,0
32,8480058,Pierre-Olivier Joseph,D,STL,25,0,0,0,0
32,8480891,Michael Kesselring,D,UTA,24,0,0,0,0
32,8477979,Nicolas Aube-Kubel,R,BUF,28,0,0,0,0
32,8476871,Tanner Pearson,L,,32,0,0,0,0
32,8476393,Nick Cousins,C,,31,0,0,0,0
32,8479977,Kailer Yamamoto,R,,26,0,0,0,0
32,8479543,Michael Pezzetta,L,MTL,26,0,0,0,0
32,8477018,Ben Hutton,D,VGK,31,0,0,0,0
32,8480762,Eric Robinson,L,CAR,29,0,0,0,0
32,8474034,Pat Maroon,L,CHI,36,0,0,0,0
32,8481058,Jesse Ylönen,R,,25,0,0,0,0
32,8475179,Dmitry Kulikov,D,FLA,34,0,0,0,0
32,8481527,Kaedan Korczak,D,VGK,23,0,0,0,0
32,8473449,Kyle Okposo,R,,36,0,0,0,0
32,8482192,Isaak Phillips,D,CHI,23,0,0,0,0
32,8480727,Zach Whitecloud,D,VGK,28,0,0,0,0
32,8479346,Dillon Dube,C,,26,0,0,0,0
32,8480821,Filip Zadina,R,,25,0,0,0,0
32,8480001,Urho Vaakanainen,D,ANA,25,0,0,0,0
32,8470966,Mark Giordano,D,,41,0,0,0,0
32,8480853,Liam Foudy,C,,24,0,0,0,0
32,8475225,Craig Smith,C,CHI,35,0,0,0,0
32,8479972,Mason Shaw,C,WPG,26,0,0,0,0
32,8478451,Ethan Bear,D,WSH,27,0,0,0,0
32,8474040,Sam Gagner,C,,35,0,0,0,0
32,8480196,Jacob Bryson,D,BUF,27,0,0,0,0
32,8479984,Cal Foote,D,,26,0,0,0,0
32,8480011,Klim Kostin,C,SJS,25,0,0,0,0
32,8482176,Wyatt Kaiser,D,CHI,22,0,0,0,0
32,8476988,Matt Benning,D,SJS,30,0,0,0,0
32,8479370,Tyson Jost,C,CAR,26,0,0,0,0
32,8477464,Nic Petan,C,,29,0,0,0,0
32,8477380,Jonny Brodzinski,C,NYR,31,0,0,0,0
32,8480070,Ian Mitchell,D,BOS,25,0,0,0,0
32,8479315,Joey Anderson,R,CHI,26,0,0,0,0
32,8478099,Kevin Labanc,R,,29,0,0,0,0
32,8476874,Olli Maatta,D,DET,30,0,0,0,0
32,8475208,Brian Dumoulin,D,ANA,33,0,0,0,0
32,8478430,Oliver Kylington,D,,27,0,0,0,0
32,8479536,Axel Jonsson-Fjallby,L,WPG,26,0,0,0,0
32,8479671,Mathieu Olivier,R,CBJ,27,0,0,0,0
32,8471709,Marc-Edouard Vlasic,D,SJS,37,0,0,0,0
32,8479328,Julien Gauthier,R,NYI,27,0,0,0,0
32,8478421,A.J. Greer,L,FLA,28,0,0,0,0
32,8477573,Nathan Walker,L,STL,30,0,0,0,0
32,8481537,Nikita Okhotiuk,D,CGY,24,0,0,0,0
32,8474166,Alec Martinez,D,CHI,37,0,0,0,0
32,8470610,Zach Parise,L,,40,0,0,0,0
32,8477478,William Carrier,L,CAR,30,0,0,0,0
32,8479344,Jesse Puljujarvi,R,PIT,26,0,0,0,0
32,8480887,Jordan Harris,D,MTL,24,0,0,0,0
32,8478502,Dennis Gilbert,D,BUF,28,0,0,0,0
32,8482730,Brandt Clarke,D,LAK,21,0,0,0,0
32,8480355,Mark Kastelic,C,BOS,25,0,0,0,0
32,8475750,Jon Merrill,D,MIN,32,0,0,0,0
32,8475164,Jakob Silfverberg,R,,34,0,0,0,0
32,8477944,Jakub Vrana,L,,28,0,0,0,0
32,8479439,Jacob MacDonald,D,COL,31,0,0,0,0
32,8474568,Luke Schenn,D,NSH,35,0,0,0,0
32,8478454,Noah Juulsen,D,VAN,27,0,0,0,0
32,8475752,Tyler Pitlick,C,,33,0,0,0,0
32,8482148,Hendrix Lapierre,C,WSH,22,0,0,0,0
32,8481167,Brayden Pachal,D,CGY,25,0,0,0,0
32,8478043,Sam Lafferty,C,BUF,29,0,0,0,0
32,8479321,Lucas Johansen,D,,27,0,0,0,0
32,8471699,Andrew Cogliano,C,,37,0,0,0,0
32,8481521,Ronnie Attard,D,PHI,25,0,0,0,0
32,8481161,Jake Christiansen,D,CBJ,25,0,0,0,0
32,8479458,Nikita Zaitsev,D,,33,0,0,0,0
32,8479619,Michael Carcone,L,UTA,28,0,0,0,0
32,8479026,Philippe Myers,D,TOR,27,0,0,0,0
32,8477330,Dominik Kubalik,L,,29,0,0,0,0
32,8481617,Vasily Podkolzin,R,VAN,23,0,0,0,0
32,8481701,Santeri Hatakka,D,NJD,23,0,0,0,0
32,8479514,Rem Pitlick,C,,27,0,0,0,0
32,8477446,Michael McCarron,R,NSH,29,0,0,0,0
32,8470604,Jeff Carter,C,,39,0,0,0,0
32,8482241,Radim Zohorna,L,,28,0,0,0,0
32,8480289,Morgan Barron,C,WPG,26,0,0,0,0
32,8479379,Givani Smith,R,SJS,26,0,0,0,0
32,8480216,Jacob Peterson,C,,25,0,0,0,0
32,8477851,Jordan Oesterle,D,BOS,32,0,0,0,0
32,8484258,Sam Malinski,D,COL,26,0,0,0,0
32,8478904,Steven Lorentz,C,,28,0,0,0,0
32,8482095,Tyler Kleven,D,OTT,22,0,0,0,0
32,8480848,Ty Dellandrea,C,SJS,24,0,0,0,0
32,8476884,Derrick Pouliot,D,,30,0,0,0,0
32,8479336,Carl Grundstrom,R,SJS,27,0,0,0,0
32,8482964,Arber Xhekaj,D,MTL,23,0,0,0,0
32,8471686,Marc Staal,D,,37,0,0,0,0
32,8477887,Patrick Brown,C,BOS,32,0,0,0,0
32,8478495,Denis Gurianov,R,,27,0,0,0,0
32,8473504,Cal Clutterbuck,R,,37,0,0,0,0
32,8481550,Adam Beckman,L,NJD,23,0,0,0,0
32,8480845,Rasmus Kupari,C,WPG,24,0,0,0,0
32,8474009,Nick Bonino,C,,36,0,0,0,0
32,8478585,Derek Ryan,C,EDM,38,0,0,0,0
32,8477962,Brendan Lemieux,L,CAR,28,0,0,0,0
32,8482861,Vincent Iorio,D,WSH,22,0,0,0,0
32,8479378,Logan Stanley,D,WPG,26,0,0,0,0
32,8473446,Erik Johnson,D,PHI,36,0,0,0,0
32,8481743,Marc Del Gaizo,D,NSH,25,0,0,0,0
32,8477384,Josh Brown,D,EDM,30,0,0,0,0
32,8482165,Yan Kuznetsov,D,CGY,22,0,0,0,0
32,8478424,Jansen Harkins,C,ANA,27,0,0,0,0
32,8482144,Jack Thompson,D,SJS,22,0,0,0,0
32,8478512,Austin Czarnik,C,,32,0,0,0,0
32,8477527,Ross Johnston,L,ANA,30,0,0,0,0
32,8479383,Boris Katchouk,L,,26,0,0,0,0
32,8482094,Daemon Hunt,D,MIN,22,0,0,0,0
32,8481719,Maxwell Crozier,D,TBL,24,0,0,0,0
32,8480192,Johnathan Kovacevic,D,NJD,27,0,0,0,0
32,8479376,Victor Mete,D,,26,0,0,0,0
32,8482511,Mason Lohrei,D,BOS,23,0,0,0,0
32,8475825,Jani Hakanpää,D,,32,0,0,0,0
32,8478021,William Lagesson,D,DET,28,0,0,0,0
32,8475795,Dylan McIlrath,D,WSH,32,0,0,0,0
32,8477846,Ryan Carpenter,C,,33,0,0,0,0
32,8481056,Spencer Stastney,D,NSH,24,0,0,0,0
32,8481564,Ryan Johnson,D,BUF,23,0,0,0,0
32,8478017,Mark Friedman,D,VAN,29,0,0,0,0
32,8479320,Max Lajoie,D,SEA,27,0,0,0,0
32,8480075,Cameron Crotty,D,MIN,25,0,0,0,0
32,8484287,Cole McWard,D,VAN,23,0,0,0,0
32,8484254,Akito Hirose,D,VAN,25,0,0,0,0
32,8483407,Brandon Scanlin,D,NYR,25,0,0,0,0
32,8480274,Philip Kemp,D,EDM,25,0,0,0,0
32,8479522,Hardy Haman Aktell,D,WSH,26,0,0,0,0
32,8480007,Jonas Rondbjerg,R,VGK,25,0,0,0,0
32,8477454,Adam Erne,L,,29,0,0,0,0
32,8481679,Maxence Guenette,D,OTT,23,0,0,0,0
32,8480441,Trey Fix-Wolansky,R,CBJ,25,0,0,0,0
32,8483546,Marshall Rifai,D,TOR,26,0,0,0,0
32,8480084,Nick DeSimone,D,NJD,30,0,0,0,0
32,8481030,Jack St. Ivany,D,PIT,25,0,0,0,0
32,8481592,Jakob Pelletier,L,CGY,23,0,0,0,0
32,8478011,Louie Belpedio,D,PHI,28,0,0,0,0
32,8477930,Pierre-Edouard Bellemare,L,,39,0,0,0,0
32,8484321,Nikolas Matinpalo,D,OTT,26,0,0,0,0
32,8482067,Connor Mackey,D,NYR,28,0,0,0,0
32,8481806,Louis Crevier,D,CHI,23,0,0,0,0
32,8484326,Patrik Koch,D,UTA,28,0,0,0,0
32,8477971,Andreas Englund,D,LAK,28,0,0,0,0
32,8481751,Lukas Rousek,R,BUF,25,0,0,0,0
32,8481006,Tyler Tucker,D,STL,24,0,0,0,0
32,8476867,Brendan Gaunce,C,MIN,30,0,0,0,0
32,8479520,Brandon Duhaime,R,WSH,27,0,0,0,0
32,8477073,Kurtis MacDermid,L,NJD,30,0,0,0,0
32,8480874,Adam Ginning,D,PHI,24,0,0,0,0
32,8477473,Justin Bailey,R,SJS,29,0,0,0,0
32,8479066,Ryan Lomberg,L,CGY,30,0,0,0,0
32,8477070,Liam O'Brien,C,UTA,30,0,0,0,0
32,8474618,Marco Scandella,D,,34,0,0,0,0
32,8475797,Jarred Tinordi,D,,32,0,0,0,0
32,8481441,Joe Snively,C,DET,28,0,0,0,0
32,8477244,Chad Ruhwedel,D,NYR,34,0,0,0,0
32,8479772,Zack MacEwen,R,OTT,28,0,0,0,0
32,8481147,Reese Johnson,C,MIN,26,0,0,0,0
32,8481043,Cole Koepke,L,BOS,26,0,0,0,0
32,8483619,Filip Roos,D,OTT,25,0,0,0,0
32,8481541,Samuel Bolduc,D,NYI,24,0,0,0,0
32,8477810,Joel Hanley,D,CGY,33,0,0,0,0
32,8476907,Mackenzie MacEachern,L,,30,0,0,0,0
32,8482652,Walker Duehr,R,CGY,27,0,0,0,0
32,8477126,Jayson Megna,C,,34,0,0,0,0
32,8483398,Declan Carlile,D,TBL,31,0,0,0,0
32,8482929,Emil Lilleberg,D,TBL,23,0,0,0,0
32,8480880,Jakub Lauko,C,MIN,24,0,0,0,0
32,8480245,Olle Lycksell,R,PHI,25,0,0,0,0
32,8480252,Cole Guttman,C,CHI,25,0,0,0,0
32,8477467,Gustav Olofsson,D,SEA,30,0,0,0,0
32,8479968,Vinni Lettieri,C,BOS,29,0,0,0,0
32,8478400,Colin White,C,,27,0,0,0,0
32,8475755,Alexander Petrovic,D,DAL,32,0,0,0,0
32,8481812,Nikolai Knyzhov,D,,27,0,0,0,0
32,8481593,Jayden Struble,D,MTL,23,0,0,0,0
32,8481532,Alex Turcotte,C,LAK,23,0,0,0,0
32,8482126,Emil Andrae,D,PHI,31,0,0,0,0
32,8479944,Zach Aston-Reese,C,VGK,30,0,0,0,0
32,8471817,Ryan Reaves,R,TOR,37,0,0,0,0
32,8481206,John Ludvig,D,PIT,24,0,0,0,0
32,8481599,Victor Soderstrom,D,UTA,23,0,0,0,0
32,8480292,Carson Meyer,R,ANA,27,0,0,0,0
32,8482496,Nils Aman,C,VAN,24,0,0,0,0
32,8479718,Alex Barré-Boulet,C,MTL,27,0,0,0,0
32,8479994,Jaret Anderson-Dolan,C,WPG,25,0,0,0,0
32,8480184,Gustav Lindstrom,D,,26,0,0,0,0
32,8480890,Jan Jenik,R,OTT,24,0,0,0,0
32,8478067,Oskar Lindblom,L,,28,0,0,0,0
32,8476934,Brock McGinn,L,ANA,30,0,0,0,0
32,8479985,Cale Fleury,D,SEA,26,0,0,0,0
32,8484304,Uvis Balinskis,D,FLA,28,0,0,0,0
32,8479981,Jonah Gadjovich,L,FLA,26,0,0,0,0
32,8481716,Dmitri Voronkov,L,CBJ,24,0,0,0,0
32,8474709,Matt Martin,L,,35,0,0,0,0
32,8482634,Alex Steeves,C,TOR,25,0,0,0,0
32,8480823,Alexander Alexeyev,D,WSH,25,0,0,0,0
32,8477541,Dakota Mermis,D,TOR,30,0,0,0,0
32,8483491,Ivan Miroshnichenko,L,WSH,20,0,0,0,0
32,8478477,Mitchell Stephens,C,SEA,27,0,0,0,0
32,8481543,Nikita Alexandrov,C,STL,24,0,0,0,0
32,8479423,Alex Nylander,L,,26,0,0,0,0
32,8482451,Mikael Pyyhtia,L,CBJ,23,0,0,0,0
32,8478831,Kevin Stenlund,C,UTA,28,0,0,0,0
32,8480306,Grant Hutton,D,NYI,29,0,0,0,0
32,8478028,Fredrik Olofsson,L,,28,0,0,0,0
32,8477462,Robert Hagg,D,VGK,29,0,0,0,0
32,8477320,Anton Blidh,L,NYR,29,0,0,0,0
32,8482157,Will Cuylle,L,NYR,22,0,0,0,0
32,8482737,Zack Bolduc,C,STL,21,0,0,0,0
32,8481239,Samuel Fagemo,L,,24,0,0,0,0
32,8481600,Tobias Bjornfot,D,FLA,23,0,0,0,0
32,8478409,Anthony Richard,C,PHI,28,0,0,0,0
32,8474145,Robert Bortuzzo,D,,35,0,0,0,0
32,8475958,Michael Sgarbossa,C,WSH,32,0,0,0,0
32,8479986,Kole Lind,R,DAL,26,0,0,0,0
32,8479249,Andrew Poturalski,C,SJS,30,0,0,0,0
32,8479362,Riley Tufte,L,BOS,26,0,0,0,0
32,8479991,Jake Leschyshyn,C,NYR,25,0,0,0,0
32,8479587,Rhett Gardner,C,PHI,28,0,0,0,0
32,8482744,James Malatesta,L,CBJ,21,0,0,0,0
32,8478854,Ryan Shea,D,PIT,27,0,0,0,0
32,8481591,Sam Poulin,R,,23,0,0,0,0
32,8483512,Matt Savoie,C,EDM,20,0,0,0,0
32,8482102,Vasily Ponomarev,C,PIT,22,0,0,0,0
32,8482162,Roby Jarventie,L,EDM,22,0,0,0,0
32,8481016,Ruslan Iskhakov,C,,24,0,0,0,0
32,8482172,Landon Slaggert,L,CHI,22,0,0,0,0
32,8482747,Brennan Othmann,L,NYR,21,0,0,0,0
32,8480031,Maxime Comtois,L,,25,0,0,0,0
32,8480226,Marián Studenic,R,,26,0,0,0,0
32,8478408,Travis Dermott,D,,28,0,0,0,0
32,8481518,Nolan Foote,L,NJD,24,0,0,0,0
32,8479419,Brett Murray,L,BUF,26,0,0,0,0
32,8482088,Justin Sourdif,R,FLA,22,0,0,0,0
32,8482201,Gage Goncalves,C,TBL,23,0,0,0,0
32,8481578,Graeme Clarke,R,MIN,23,0,0,0,0
32,8482177,Marat Khusnutdinov,C,MIN,22,0,0,0,0
32,8481754,Nikita Nesterenko,C,ANA,23,0,0,0,0
32,8483531,Brian Halonen,L,NJD,25,0,0,0,0
32,8483920,Pierrick Dube,R,WSH,23,0,0,0,0
32,8480851,Akil Thomas,C,LAK,24,0,0,0,0
32,8475235,Nicolas Deslauriers,L,PHI,33,0,0,0,0
32,8482476,Emil Heineman,L,MTL,23,0,0,0,0
32,8477149,Scott Sabourin,R,SJS,32,0,0,0,0
32,8483549,Lucas Condotta,L,MTL,27,0,0,0,0
32,8482765,Isak Rosen,R,BUF,21,0,0,0,0
32,8481237,Kyle MacLean,C,NYI,25,0,0,0,0
32,8481024,Linus Karlsson,C,VAN,25,0,0,0,0
32,8481690,Tyler Angle,C,,24,0,0,0,0
32,8483570,Ben Meyers,C,SEA,26,0,0,0,0
32,8481655,Cole Schwindt,R,CGY,23,0,0,0,0
32,8481462,Mason Morelli,L,VGK,28,0,0,0,0
32,8483401,Marc Johnstone,R,PIT,28,0,0,0,0
32,8478956,Samuel Laberge,L,NJD,27,0,0,0,0
32,8479533,Joona Koppanen,L,,26,0,0,0,0
32,8482197,Adam Raska,R,MIN,23,0,0,0,0
32,8482250,Callahan Burke,C,VGK,27,0,0,0,0
32,8482784,Zach Dean,C,STL,21,0,0,0,0
32,8484255,Jason Polin,R,COL,25,0,0,0,0
32,8481077,John Leonard,L,,26,0,0,0,0
32,8481534,Raphael Lavoie,C,EDM,24,0,0,0,0
32,8483609,Adam Klapka,R,CGY,24,0,0,0,0
32,8482751,Ryan Winterton,C,SEA,21,0,0,0,0
32,8480267,Sammy Walker,C,MIN,25,0,0,0,0
32,8475766,Austin Watson,L,,32,0,0,0,0
32,8482460,Matt Rempe,C,NYR,22,0,0,0,0
32,8481065,Angus Crookshank,L,OTT,25,0,0,0,0
32,8481070,Hugh McGing,L,,26,0,0,0,0
32,8476323,Max McCormick,L,SEA,32,0,0,0,0
32,8483395,Arshdeep Bains,L,VAN,23,0,0,0,0
32,8484259,Ondrej Pavel,C,COL,31,0,0,0,0
32,8483432,Luca Del Bel Belluz,C,CBJ,31,0,0,0,0
32,8483045,Cameron Butler,R,CBJ,31,0,0,0,0
32,8482061,Brandon Biro,L,SEA,26,0,0,0,0
32,8477401,John Hayden,C,SEA,29,0,0,0,0
32,8475278,Byron Froese,C,,33,0,0,0,0
32,8478446,Glenn Gawdin,C,LAK,27,0,0,0,0
32,8477993,Justin Kirkland,C,CGY,28,0,0,0,0
32,8482147,Jean-Luc Foudy,C,COL,22,0,0,0,0
32,8480032,Shane Bowers,C,NJD,25,0,0,0,0
32,8479330,Brandon Gignac,C,MTL,27,0,0,0,0
32,8480776,Sheldon Rempal,R,,29,0,0,0,0
32,8475413,Justin Dowling,C,NJD,34,0,0,0,0
32,8481726,Adam Edstrom,C,NYR,24,0,0,0,0
32,8480844,Grigori Denisenko,L,VGK,24,0,0,0,0
32,8478147,Bokondji Imama,L,PIT,28,0,0,0,0
32,8478881,Brett Seney,L,CHI,28,0,0,0,0
32,8483630,Pavol Regenda,L,ANA,25,0,0,0,0
32,8480836,Jonathan Gruden,C,,24,0,0,0,0
32,8484314,Jiri Smejkal,L,,28,0,0,0,0
32,8475780,Chris Wagner,R,COL,33,0,0,0,0
32,8479546,Oskar Steen,C,,26,0,0,0,0
32,8483597,Milos Kelemen,L,UTA,25,0,0,0,0
32,8481789,Tye Kartye,L,SEA,23,0,0,0,0
32,8484325,Waltteri Merela,C,TBL,26,0,0,0,0
32,8479421,Jacob Moverare,D,LAK,26,0,0,0,0
32,8481585,Egor Afanasyev,L,SJS,23,0,0,0,0
32,8479547,Matthew Phillips,R,,26,0,0,0,0
32,8479367,William Lockwood,R,FLA,26,0,0,0,0
32,8476915,Jujhar Khaira,L,,30,0,0,0,0
32,8481422,Jacob Lucchini,C,NSH,29,0,0,0,0
32,8480468,James Hamblin,L,EDM,25,0,0,0,0
32,8478051,Max Willman,C,NJD,29,0,0,0,0
32,8481556,John Beecher,C,BOS,23,0,0,0,0
32,8478078,Rourke Chartier,C,,28,0,0,0,0
33,8479318,Auston Matthews,C,TOR,27,82,62,66,128
33,8477492,Nathan MacKinnon,C,COL,29,82,49,78,127
33,8478402,Connor McDavid,C,EDM,27,82,35,90,125
33,8476453,Nikita Kucherov,R,TBL,31,82,42,79,121
33,8478864,Kirill Kaprizov,L,MIN,27,82,44,69,113
33,8477956,David Pastrnak,R,BOS,28,82,49,62,111
33,8476468,J.T. Miller,C,VAN,31,82,37,71,108
33,8479314,Matthew Tkachuk,L,FLA,27,82,37,70,107
33,8480012,Elias Pettersson,C,VAN,26,82,48,56,104
33,8474564,Steven Stamkos,C,NSH,34,82,44,60,104
33,8477939,William Nylander,R,TOR,28,82,40,63,103
33,8478420,Mikko Rantanen,R,COL,28,82,39,63,102
33,8481559,Jack Hughes,C,NJD,23,82,36,66,102
33,8479407,Jesper Bratt,L,NJD,26,82,34,68,102
33,8475166,John Tavares,C,TOR,34,82,47,52,99
33,8477934,Leon Draisaitl,C,EDM,29,82,42,57,99
33,8477942,Kevin Fiala,L,LAK,28,82,28,69,97
33,8476459,Mika Zibanejad,C,NYR,31,82,31,64,95
33,8480027,Jason Robertson,L,DAL,25,82,33,61,94
33,8479343,Clayton Keller,R,UTA,26,82,41,52,93
33,8480023,Robert Thomas,C,STL,25,82,30,63,93
33,8478445,Mathew Barzal,C,NYI,27,82,27,66,93
33,8471675,Sidney Crosby,C,PIT,37,82,48,43,91
33,8478449,Roope Hintz,C,DAL,28,82,40,49,89
33,8476460,Mark Scheifele,C,WPG,31,82,35,53,88
33,8481557,Matt Boldy,L,MIN,23,82,32,56,88
33,8475810,Bryan Rust,R,PIT,32,82,45,42,87
33,8480801,Brady Tkachuk,L,OTT,25,82,43,43,86
33,8475692,Mats Zuccarello,R,MIN,37,82,22,64,86
33,8478427,Sebastian Aho,C,CAR,27,82,34,51,85
33,8477933,Sam Reinhart,C,FLA,29,82,40,44,84
33,8480830,Andrei Svechnikov,R,CAR,24,82,27,57,84
33,8478550,Artemi Panarin,L,NYR,33,82,24,60,84
33,8474600,Roman Josi,D,NSH,34,82,19,65,84
33,8477500,Bo Horvat,C,NYI,29,82,45,38,83
33,8476887,Filip Forsberg,L,NSH,30,82,34,49,83
33,8477940,Nikolaj Ehlers,L,WPG,28,82,33,50,83
33,8478398,Kyle Connor,L,WPG,28,82,40,42,82
33,8477402,Pavel Buchnevich,L,STL,29,82,31,50,81
33,8482116,Tim Stützle,C,OTT,22,82,25,56,81
33,8471215,Evgeni Malkin,C,PIT,38,82,25,56,81
33,8477951,Nick Schmaltz,C,UTA,28,82,23,58,81
33,8480069,Cale Makar,D,COL,26,82,22,59,81
33,8481523,Kirby Dach,C,MTL,23,82,18,63,81
33,8478403,Jack Eichel,C,VGK,28,82,47,33,80
33,8475172,Nazem Kadri,C,CGY,34,82,37,43,80
33,8480800,Quinn Hughes,D,VAN,25,82,11,69,80
33,8481540,Cole Caufield,R,MTL,23,82,38,41,79
33,8476454,Ryan Nugent-Hopkins,C,EDM,31,82,37,42,79
33,8479385,Jordan Kyrou,C,STL,26,82,36,43,79
33,8477946,Dylan Larkin,C,DET,28,82,33,46,79
33,8475168,Matt Duchene,C,DAL,33,82,33,46,79
33,8477960,Adrian Kempe,R,LAK,28,82,32,47,79
33,8478010,Brayden Point,C,TBL,28,82,31,48,79
33,8478439,Travis Konecny,R,PHI,27,82,35,43,78
33,8475913,Mark Stone,R,VGK,32,82,27,51,78
33,8478414,Timo Meier,R,NJD,28,82,38,39,77
33,8476881,Tomas Hertl,C,VGK,31,82,33,44,77
33,8479345,Jakob Chychrun,D,WSH,26,82,22,55,77
33,8479323,Adam Fox,D,NYR,26,82,21,56,77
33,8471685,Anze Kopitar,C,LAK,37,82,36,40,76
33,8479420,Tage Thompson,C,BUF,27,82,34,42,76
33,8478493,Joel Eriksson Ek,C,MIN,27,82,33,43,76
33,8481528,Dylan Cozens,C,BUF,23,82,31,45,76
33,8477949,Alex Tuch,R,BUF,28,82,29,46,75
33,8480839,Rasmus Dahlin,D,BUF,24,82,15,60,75
33,8476389,Vincent Trocheck,C,NYR,31,82,33,41,74
33,8477494,Jonathan Drouin,L,COL,29,82,24,50,74
33,8480002,Nico Hischier,C,NJD,25,82,33,40,73
33,8476479,Phillip Danault,C,LAK,31,82,31,42,73
33,8477493,Aleksander Barkov,C,FLA,29,82,26,47,73
33,8475184,Chris Kreider,L,NYR,33,82,40,32,72
33,8477504,Josh Morrissey,D,WPG,29,82,21,51,72
33,8476539,Jonathan Marchessault,R,NSH,34,82,43,28,71
33,8477955,Jared McCann,L,SEA,28,82,37,34,71
33,8478047,Michael Bunting,L,PIT,29,82,26,45,71
33,8477496,Elias Lindholm,C,BOS,30,82,25,46,71
33,8473994,Jamie Benn,L,DAL,35,82,22,48,70
33,8474578,Erik Karlsson,D,PIT,34,82,17,53,70
33,8480036,Miro Heiskanen,D,DAL,25,82,13,57,70
33,8479325,Charlie McAvoy,D,BOS,27,82,13,57,70
33,8480865,Noah Dobson,D,NYI,24,82,12,58,70
33,8477409,Carter Verhaeghe,C,FLA,29,82,38,31,69
33,8476456,Jonathan Huberdeau,C,CGY,31,82,21,48,69
33,8471214,Alex Ovechkin,L,WSH,39,82,32,35,67
33,8478444,Brock Boeser,R,VAN,27,82,29,38,67
33,8475754,Brock Nelson,C,NYI,33,82,38,28,66
33,8482109,Alexis Lafrenière,L,NYR,23,82,35,31,66
33,8479542,Brandon Hagel,L,TBL,26,82,20,46,66
33,8482093,Seth Jarvis,C,CAR,22,82,36,29,65
33,8482110,Dawson Mercer,C,NJD,23,82,35,30,65
33,8475786,Zach Hyman,L,EDM,32,82,31,34,65
33,8475765,Vladimir Tarasenko,R,DET,33,82,28,37,65
33,8482097,Jack Quinn,R,BUF,23,82,30,34,64
33,8477404,Jake Guentzel,C,TBL,30,82,22,42,64
33,8473419,Brad Marchand,L,BOS,36,82,19,45,64
33,8475784,Jeff Skinner,C,EDM,32,82,28,35,63
33,8479675,Trevor Moore,L,LAK,29,82,27,36,63
33,8478856,Conor Garland,R,VAN,28,82,25,38,63
33,8476882,Teuvo Teravainen,L,CHI,30,82,21,42,63
33,8482124,Quinton Byfield,R,LAK,22,82,19,44,63
33,8478396,Noah Hanifin,D,VGK,27,82,18,45,63
33,8474565,Alex Pietrangelo,D,VGK,34,82,17,46,63
33,8478407,Vince Dunn,D,SEA,28,82,11,52,63
33,8478460,Zach Werenski,D,CBJ,27,82,6,57,63
33,8475794,Tyler Seguin,C,DAL,32,82,36,26,62
33,8478498,Jake DeBrusk,L,VAN,28,82,34,28,62
33,8479337,Alex DeBrincat,R,DET,27,82,30,32,62
33,8481068,Yegor Sharangovich,C,CGY,26,82,28,34,62
33,8480798,Philipp Kurashev,C,CHI,25,82,19,43,62
33,8475798,Mikael Granlund,C,SJS,32,82,17,45,62
33,8479339,Patrik Laine,L,CBJ,26,82,29,32,61
33,8478440,Dylan Strome,C,WSH,27,82,24,37,61
33,8482665,Matty Beniers,C,SEA,22,82,23,38,61
33,8473512,Claude Giroux,R,OTT,36,82,22,39,61
33,8477447,Shea Theodore,D,VGK,29,82,12,49,61
33,8479410,Mikhail Sergachev,D,UTA,26,82,9,52,61
33,8477501,Valeri Nichushkin,R,COL,29,82,33,27,60
33,8478873,Troy Terry,R,ANA,27,82,25,35,60
33,8482175,JJ Peterka,R,BUF,22,82,24,36,60
33,8475158,Ryan O'Reilly,C,NSH,33,82,22,38,60
33,8481596,Shane Pinto,C,OTT,24,82,21,39,60
33,8476792,Torey Krug,D,STL,33,82,17,43,60
33,8477503,Max Domi,C,TOR,29,82,16,44,60
33,8476869,Brady Skjei,D,NSH,30,82,16,44,60
33,8476853,Morgan Rielly,D,TOR,30,82,15,45,60
33,8475726,Tyler Toffoli,C,SJS,32,82,28,31,59
33,8476448,William Karlsson,C,VGK,31,82,24,35,59
33,8481711,Matias Maccelli,L,UTA,24,82,24,35,59
33,8480039,Martin Necas,C,CAR,25,82,22,37,59
33,8480078,Filip Chytil,C,NYR,25,82,18,40,58
33,8476875,Mike Matheson,D,MTL,30,82,15,43,58
33,8476346,Johnny Gaudreau,L,CBJ,31,82,13,45,58
33,8476432,Boone Jenner,C,CBJ,31,82,40,17,57
33,8477986,Brandon Montour,D,SEA,30,82,25,32,57
33,8477476,Artturi Lehkonen,L,COL,29,82,25,32,57
33,8477497,Sean Monahan,C,CBJ,30,82,22,35,57
33,8482113,Anton Lundell,C,FLA,23,82,21,36,57
33,8476905,Chandler Stephenson,C,SEA,30,82,20,37,57
33,8477407,Anthony Duclair,L,NYI,29,82,19,38,57
33,8474590,John Carlson,D,WSH,34,82,11,46,57
33,8480803,Evan Bouchard,D,EDM,25,82,9,48,57
33,8474563,Drew Doughty,D,LAK,35,82,9,48,57
33,8481618,Alex Newhook,C,MTL,23,82,28,28,56
33,8482745,Mason McTavish,C,ANA,21,82,23,33,56
33,8475170,Brayden Schenn,C,STL,33,82,20,36,56
33,8482684,Luke Hughes,D,NJD,21,82,15,41,56
33,8480014,Gabriel Vilardi,C,WPG,25,82,36,19,55
33,8475722,Jason Zucker,L,BUF,32,82,28,27,55
33,8478042,Viktor Arvidsson,R,EDM,31,82,22,33,55
33,8473986,Alex Killorn,L,ANA,35,82,22,33,55
33,8479400,Pierre-Luc Dubois,L,WSH,26,82,21,34,55
33,8480018,Nick Suzuki,C,MTL,25,82,17,38,55
33,8480434,Sean Durzi,D,UTA,26,82,14,41,55
33,8475793,Ryan Johansen,C,PHI,32,82,25,29,54
33,8480208,Drake Batherson,R,OTT,26,82,17,37,54
33,8475167,Victor Hedman,D,TBL,34,82,14,40,54
33,8478233,Andrew Mangiapane,L,WSH,28,82,24,29,53
33,8481533,Trevor Zegras,C,ANA,23,82,21,32,53
33,8475169,Evander Kane,L,EDM,33,82,21,32,53
33,8478038,Devon Toews,D,COL,30,82,12,41,53
33,8474679,Gustav Nyquist,C,NSH,35,82,11,42,53
33,8478474,Lawson Crouse,L,UTA,27,82,31,21,52
33,8475799,Nino Niederreiter,R,WPG,32,82,28,24,52
33,8475760,Nick Bjugstad,C,UTA,32,82,26,26,52
33,8477416,Oliver Bjorkstrand,R,SEA,29,82,25,27,52
33,8476483,Rickard Rakell,R,PIT,31,82,22,30,52
33,8477479,Tyler Bertuzzi,L,CHI,29,82,18,34,52
33,8474141,Patrick Kane,R,DET,36,82,17,35,52
33,8478542,Evan Rodrigues,C,FLA,31,82,17,35,52
33,8478469,Thomas Chabot,D,OTT,27,82,15,37,52
33,8482671,Owen Power,D,BUF,22,82,11,41,52
33,8477998,Warren Foegele,L,LAK,28,82,28,23,51
33,8482699,Dylan Guenther,R,UTA,21,82,27,24,51
33,8478401,Pavel Zacha,C,BOS,27,82,25,26,51
33,8477932,Aaron Ekblad,D,FLA,28,82,17,34,51
33,8474150,Mikael Backlund,C,CGY,35,82,16,35,51
33,8476906,Shayne Gostisbehere,D,CAR,31,82,15,36,51
33,8481581,Thomas Harley,D,DAL,23,82,13,38,51
33,8482740,Wyatt Johnston,C,DAL,21,82,27,23,50
33,8474102,David Perron,L,OTT,36,82,20,30,50
33,8477456,J.T. Compher,L,DET,29,82,19,31,50
33,8477935,Sam Bennett,C,FLA,28,82,18,32,50
33,8478055,Gustav Forsling,D,FLA,28,82,17,33,50
33,8482660,Kent Johnson,C,CBJ,22,82,14,36,50
33,8475745,Charlie Coyle,C,BOS,32,82,24,25,49
33,8478975,Mason Marchment,L,DAL,29,82,23,26,49
33,8482667,William Eklund,L,SJS,22,82,22,27,49
33,8481560,Arthur Kaliyev,R,LAK,23,82,21,28,49
33,8474586,Jordan Eberle,R,SEA,34,82,20,29,49
33,8475768,Jaden Schwartz,C,SEA,32,82,19,30,49
33,8478438,Tommy Novak,C,NSH,27,82,18,31,49
33,8477451,Ryan Hartman,R,MIN,30,82,17,32,49
33,8477021,Alex Kerfoot,C,UTA,30,82,17,32,49
33,8479425,Filip Hronek,D,VAN,27,82,8,41,49
33,8477948,Travis Sanheim,D,PHI,28,82,8,41,49
33,8474641,Adam Henrique,C,EDM,34,82,28,20,48
33,8476880,Tom Wilson,R,WSH,30,82,26,22,48
33,8482149,Cole Perfetti,C,WPG,22,82,22,26,48
33,8478462,Nicolas Roy,C,VGK,27,82,21,27,48
33,8477989,Christian Dvorak,C,MTL,28,82,21,27,48
33,8484144,Connor Bedard,C,CHI,19,82,18,30,48
33,8476419,Jean-Gabriel Pageau,C,NYI,32,82,14,34,48
33,8480797,Joel Farabee,L,PHI,24,82,11,37,48
33,8473563,Nicklas Backstrom,C,WSH,37,82,22,25,47
33,8475191,Reilly Smith,R,NYR,33,82,19,28,47
33,8482146,Luke Evangelista,R,NSH,22,82,16,31,47
33,8477964,Ivan Barbashev,C,VGK,29,82,15,32,47
33,8475314,Anders Lee,L,NYI,34,82,23,23,46
33,8476399,Blake Coleman,C,CGY,33,82,19,27,46
33,8476461,Sean Couturier,C,PHI,32,82,18,28,46
33,8471724,Kris Letang,D,PIT,37,82,11,35,46
33,8483808,Andrei Kuzmenko,L,CGY,28,82,27,18,45
33,8480064,Josh Norris,C,OTT,25,82,25,20,45
33,8480220,Noah Cates,L,PHI,25,82,22,23,45
33,8479525,Ross Colton,C,COL,28,82,20,25,45
33,8475791,Taylor Hall,L,CHI,33,82,19,26,45
33,8477953,Kasperi Kapanen,R,STL,28,82,15,30,45
33,8482078,Lucas Raymond,L,DET,22,82,14,31,45
33,8476462,Dougie Hamilton,D,NJD,31,82,13,32,45
33,8477495,Seth Jones,D,CHI,30,82,11,34,45
33,8478397,Rasmus Andersson,D,CGY,28,82,11,34,45
33,8477346,MacKenzie Weegar,D,CGY,30,82,11,34,45
33,8476438,Brandon Saad,L,STL,32,82,25,19,44
33,8480015,Owen Tippett,R,PHI,25,82,22,22,44
33,8475151,Kyle Palmieri,C,NYI,33,82,22,22,44
33,8482159,Tyson Foerster,R,PHI,22,82,22,22,44
33,8476329,Travis Boyd,C,MIN,31,82,20,24,44
33,8475763,Kevin Hayes,R,PIT,32,82,19,25,44
33,8477511,Anthony Mantha,R,CGY,30,82,17,27,44
33,8480028,Morgan Frost,C,PHI,25,82,14,30,44
33,8481656,Aliaksei Protas,C,WSH,23,82,14,30,44
33,8475218,Mattias Ekholm,D,EDM,34,82,12,32,44
33,8481554,Kaapo Kakko,R,NYR,23,82,25,18,43
33,8480893,Kirill Marchenko,R,CBJ,24,82,24,19,43
33,8480188,Fabian Zetterlund,L,SJS,25,82,23,20,43
33,8478057,Dakota Joshua,C,VAN,28,82,22,21,43
33,8478519,Anthony Cirelli,C,TBL,27,82,20,23,43
33,8476469,Joel Armia,R,MTL,31,82,19,24,43
33,8482720,Matthew Knies,L,TOR,22,82,17,26,43
33,8471698,T.J. Oshie,R,WSH,38,82,17,26,43
33,8482117,Lukas Reichel,L,CHI,22,82,17,26,43
33,8476872,Scott Laughton,C,PHI,30,82,16,27,43
33,8479999,Casey Mittelstadt,C,COL,26,82,11,32,43
33,8477444,Andre Burakovsky,L,SEA,29,82,23,19,42
33,8476960,Andreas Athanasiou,C,CHI,30,82,18,24,42
33,8480009,Eeli Tolvanen,R,SEA,25,82,17,25,42
33,8477987,Ryan Donato,C,CHI,28,82,16,26,42
33,8482105,Jake Sanderson,D,OTT,22,82,16,26,42
33,8478891,Mason Appleton,C,WPG,28,82,12,30,42
33,8476923,Damon Severson,D,CBJ,30,82,10,32,42
33,8480817,K'Andre Miller,D,NYR,24,82,10,32,42
33,8480336,Sean Walker,D,CAR,30,82,7,35,42
33,8473422,Nick Foligno,L,CHI,37,82,22,19,41
33,8478413,Jordan Greenway,L,BUF,27,82,20,21,41
33,8477429,Andrew Copp,C,DET,30,82,17,24,41
33,8478463,Anthony Beauvillier,L,PIT,27,82,16,25,41
33,8482055,Drew O'Connor,L,PIT,26,82,14,27,41
33,8475753,Justin Faulk,D,STL,32,82,11,30,41
33,8480145,Neal Pionk,D,WPG,29,82,9,32,41
33,8481582,Nicholas Robertson,L,TOR,23,82,16,24,40
33,8478472,Mathieu Joseph,R,STL,27,82,14,26,40
33,8478458,Jack Roslovic,C,CAR,27,82,11,29,40
33,8481546,Cam York,D,PHI,23,82,7,33,40
33,8480855,Jack McBain,C,UTA,24,82,22,17,39
33,8478366,Frank Vatrano,R,ANA,30,82,20,19,39
33,8479987,Morgan Geekie,C,BOS,26,82,19,20,39
33,8482705,Cole Sillinger,C,CBJ,21,82,18,21,39
33,8480849,Barrett Hayton,C,UTA,24,82,17,22,39
33,8480113,Alex Iafallo,L,WPG,31,82,16,23,39
33,8476292,Ondrej Palat,L,NJD,33,82,10,29,39
33,8478046,Danton Heinen,L,VAN,29,82,21,17,38
33,8479365,Trent Frederic,C,BOS,26,82,20,18,38
33,8477952,Robby Fabbri,C,ANA,28,82,19,19,38
33,8476474,Stefan Noesen,R,NJD,31,82,19,19,38
33,8478115,Pierre Engvall,L,NYI,28,82,15,23,38
33,8481013,Jonatan Berggren,R,DET,24,82,15,23,38
33,8482475,Yegor Chinakhov,R,CBJ,23,82,14,24,38
33,8475714,Calle Jarnkrok,C,TOR,33,82,13,25,38
33,8478133,Jake Evans,C,MTL,28,82,10,28,38
33,8470613,Brent Burns,D,CAR,39,82,9,29,38
33,8476854,Hampus Lindholm,D,BOS,30,82,9,29,38
33,8481542,Moritz Seider,D,DET,23,82,5,33,38
33,8480043,Timothy Liljegren,D,TOR,25,82,5,33,38
33,8480802,Ryan McLeod,C,BUF,25,82,12,25,37
33,8476885,Jacob Trouba,D,NYR,30,82,9,28,37
33,8476927,Teddy Blueger,C,VAN,30,82,8,29,37
33,8479976,Juuso Valimaki,D,UTA,26,82,7,30,37
33,8478508,Yakov Trenin,C,MIN,27,82,23,13,36
33,8479992,Michael Rasmussen,C,DET,25,82,20,16,36
33,8482092,Ridly Greig,C,OTT,22,82,17,19,36
33,8481186,Logan O'Connor,R,COL,28,82,16,20,36
33,8476918,Jimmy Vesey,L,NYR,31,82,14,22,36
33,8481704,Juuso Parssinen,C,NSH,23,82,17,18,35
33,8481624,Ilya Mikheyev,R,CHI,30,82,16,19,35
33,8474053,Logan Couture,C,SJS,35,82,16,19,35
33,8475848,Brendan Gallagher,R,MTL,32,82,16,19,35
33,8476392,Adam Lowry,C,WPG,31,82,15,20,35
33,8481093,Rafael Harvey-Pinard,L,MTL,25,82,15,20,35
33,8476826,Yanni Gourde,C,SEA,33,82,13,22,35
33,8476480,Vladislav Namestnikov,C,WPG,32,82,11,24,35
33,8476458,Ryan Strome,C,ANA,31,82,9,26,35
33,8480871,Adam Boqvist,D,FLA,24,82,9,26,35
33,8476902,Esa Lindell,D,DAL,30,82,7,28,35
33,8474574,Tyler Myers,D,VAN,34,82,5,30,35
33,8482125,Alexander Holtz,R,VGK,22,82,21,13,34
33,8476921,Jordan Martinook,L,CAR,32,82,17,17,34
33,8475149,Marcus Johansson,L,MIN,34,82,14,20,34
33,8475220,Marcus Foligno,L,MIN,33,82,12,22,34
33,8483515,Juraj Slafkovsky,L,MTL,20,82,19,14,33
33,8478020,Michael Amadio,C,OTT,28,82,17,16,33
33,8475287,Erik Haula,L,NJD,33,82,14,19,33
33,8477947,Sonny Milano,L,WSH,28,82,14,19,33
33,8479368,Max Jones,L,BOS,26,82,14,19,33
33,8482624,Daniil Miromanov,D,CGY,27,82,14,19,33
33,8484166,Adam Fantilli,C,CBJ,20,82,11,22,33
33,8479293,Brandon Tanev,L,SEA,33,82,11,22,33
33,8475200,Dmitry Orlov,D,CAR,33,82,10,23,33
33,8479353,Brett Howden,C,VGK,26,82,9,24,33
33,8474716,Jared Spurgeon,D,MIN,35,82,6,27,33
33,8482087,Kaiden Guhle,D,MTL,22,82,6,27,33
33,8476979,Erik Gustafsson,D,DET,32,82,5,28,33
33,8476981,Josh Anderson,R,MTL,30,82,23,9,32
33,8481604,Pavel Dorofeyev,L,VGK,24,82,20,12,32
33,8484203,Bradly Nadeau,L,CAR,19,82,18,14,32
33,8480068,Ryan Poehling,C,PHI,25,82,15,17,32
33,8474189,Lars Eller,C,PIT,35,82,14,18,32
33,8479996,Cody Glass,C,NSH,25,82,13,19,32
33,8481032,Paul Cotter,C,NJD,25,82,9,23,32
33,8480878,Nils Lundkvist,D,DAL,24,82,9,23,32
33,8477488,Brett Pesce,D,NJD,30,82,7,25,32
33,8475171,Oliver Ekman-Larsson,D,TOR,33,82,7,25,32
33,8480074,Alexandre Texier,C,STL,25,82,7,25,32
33,8475764,Cam Fowler,D,ANA,33,82,6,26,32
33,8475181,Nick Leddy,D,STL,33,82,4,28,32
33,8480829,Jesperi Kotkaniemi,C,CAR,24,82,17,14,31
33,8473533,Jordan Staal,C,CAR,36,82,16,15,31
33,8480980,Connor Dewar,C,TOR,25,82,16,15,31
33,8477903,Garnet Hathaway,R,PHI,33,82,15,16,31
33,8480835,Jack Drury,C,CAR,24,82,14,17,31
33,8477919,Frederick Gaudreau,C,MIN,31,82,14,17,31
33,8480748,Kiefer Sherwood,L,VAN,29,82,13,18,31
33,8480459,Pius Suter,C,VAN,28,82,12,19,31
33,8476925,Colton Sissons,C,NSH,31,82,11,20,31
33,8479351,Sam Steel,C,DAL,26,82,7,24,31
33,8478882,Vladislav Gavrikov,D,LAK,29,82,5,26,31
33,8474151,Ryan McDonagh,D,TBL,35,82,5,26,31
33,8476422,Mike Reilly,D,NYI,31,82,4,27,31
33,8477426,Nicholas Paul,L,TBL,29,82,21,9,30
33,8480995,Pontus Holmberg,R,TOR,25,82,15,15,30
33,8474149,Evgenii Dadonov,R,DAL,35,82,11,19,30
33,8477392,Hudson Fasching,R,NYI,29,82,11,19,30
33,8483457,Lane Hutson,D,MTL,20,82,10,20,30
33,8481606,Jordan Spence,D,LAK,23,82,8,22,30
33,8478500,Ivan Provorov,D,CBJ,27,82,6,24,30
33,8477507,Nikita Zadorov,D,BOS,29,82,6,24,30
33,8473507,Jeff Petry,D,DET,37,82,4,26,30
33,8476891,Matt Grzelcyk,D,PIT,30,82,3,27,30
33,8476958,Jaccob Slavin,D,CAR,30,82,2,28,30
33,8477508,Curtis Lazar,C,NJD,29,82,14,15,29
33,8480448,Parker Kelly,L,COL,25,82,13,16,29
33,8480789,Oliver Wahlstrom,R,NYI,24,82,12,17,29
33,8476312,Josh Manson,D,COL,33,82,10,19,29
33,8482111,Justin Barron,D,MTL,23,82,7,22,29
33,8482079,Marco Rossi,C,MIN,23,82,18,10,28
33,8481535,Nils Hoglander,L,VAN,24,82,16,12,28
33,8479393,Noah Gregor,C,OTT,26,82,16,12,28
33,8480003,Jesper Boqvist,C,FLA,26,82,10,18,28
33,8480185,Eetu Luostarinen,C,FLA,26,82,9,19,28
33,8480025,MacKenzie Entwistle,R,FLA,25,82,8,20,28
33,8476892,Colton Parayko,D,STL,31,82,7,21,28
33,8477220,Nate Schmidt,D,FLA,33,82,6,22,28
33,8478507,John Marino,D,UTA,27,82,4,24,28
33,8481708,Zac Jones,D,NYR,24,82,4,24,28
33,8480873,Rasmus Sandin,D,WSH,24,82,1,27,28
33,8480813,Joe Veleno,C,DET,24,82,18,9,27
33,8480281,Alexey Toropchenko,R,STL,25,82,18,9,27
33,8479390,Taylor Raddysh,R,WSH,26,82,16,11,27
33,8483431,Logan Cooley,C,UTA,20,82,14,13,27
33,8478569,Noel Acciari,C,PIT,33,82,13,14,27
33,8476897,Oskar Sundqvist,C,STL,30,82,12,15,27
33,8475842,Sam Carrick,C,NYR,32,82,12,15,27
33,8481553,Bobby Brink,R,PHI,23,82,11,16,27
33,8477931,Tomas Nosek,L,FLA,32,82,10,17,27
33,8482803,Olen Zellweger,D,ANA,21,82,10,17,27
33,8478911,Matt Roy,D,WSH,29,82,9,18,27
33,8480796,Martin Fehervary,D,WSH,25,82,9,18,27
33,8482142,Jamie Drysdale,D,PHI,22,82,5,22,27
33,8481178,Egor Zamula,D,PHI,24,82,3,24,27
33,8476331,Dylan DeMelo,D,WPG,31,82,2,25,27
33,8475193,Tomas Tatar,L,NJD,34,82,15,11,26
33,8479591,Michael Eyssimont,C,TBL,28,82,12,14,26
33,8481524,Bowen Byram,D,BUF,23,82,12,14,26
33,8475343,Nic Dowd,C,WSH,34,82,11,15,26
33,8474090,Brendan Smith,D,DAL,35,82,9,17,26
33,8477498,Darnell Nurse,D,EDM,29,82,8,18,26
33,8482166,Shakir Mukhamadullin,D,SJS,22,82,7,19,26
33,8479980,Nicolas Hague,D,VGK,26,82,6,20,26
33,8480073,Erik Brannstrom,D,COL,25,82,5,21,26
33,8475188,Brayden McNabb,D,VGK,33,82,5,21,26
33,8478851,Alexandre Carrier,D,NSH,28,82,5,21,26
33,8475233,David Savard,D,MTL,34,82,3,23,26
33,8481601,Simon Holmstrom,R,NYI,23,82,14,11,25
33,8476374,Sean Kuraly,C,CBJ,31,82,13,12,25
33,8482141,Lukas Cormier,D,VGK,22,82,12,13,25
33,8479359,Beck Malenstyn,L,BUF,26,82,12,13,25
33,8477425,Miles Wood,L,COL,29,82,12,13,25
33,8477353,Tyler Motte,C,DET,29,82,10,15,25
33,8476917,Adam Pelech,D,NYI,30,82,7,18,25
33,8482122,Brock Faber,D,MIN,22,82,6,19,25
33,8477506,Ryan Pulock,D,NYI,30,82,5,20,25
33,8475279,Ben Chiarot,D,DET,33,82,4,21,25
33,8474673,TJ Brodie,D,CHI,34,82,3,22,25
33,8475324,Nick Jensen,D,OTT,34,82,2,23,25
33,8480049,Dylan Samberg,D,WPG,25,82,1,24,25
33,8479983,Mario Ferraro,D,SJS,26,82,1,24,25
33,8482089,Jake Neighbours,L,STL,22,82,18,6,24
33,8477450,Jason Dickinson,C,CHI,29,82,18,6,24
33,8476858,Phillip Di Giuseppe,L,VAN,31,82,14,10,24
33,8482259,Bobby McMann,C,TOR,28,82,13,11,24
33,8482062,Cole Smith,L,NSH,29,82,13,11,24
33,8484153,Leo Carlsson,C,ANA,20,82,9,15,24
33,8476873,Mark Jankowski,C,NSH,30,82,9,15,24
33,8476467,Jamie Oleksiak,D,SEA,32,82,8,16,24
33,8483763,Maksymilian Szuber,D,UTA,22,82,7,17,24
33,8480834,Ty Emberson,D,SJS,24,82,6,18,24
33,8480222,Sebastian Aho,D,PIT,28,82,5,19,24
33,8475462,Radko Gudas,D,ANA,34,82,1,23,24
33,8474715,Cam Atkinson,R,TBL,35,82,15,8,23
33,8479661,Tanner Jeannot,L,LAK,27,82,12,11,23
33,8481580,Connor McMichael,C,WSH,23,82,11,12,23
33,8470621,Corey Perry,R,EDM,39,82,11,12,23
33,8481477,Nico Sturm,C,SJS,29,82,9,14,23
33,8477015,Connor Brown,R,EDM,30,82,9,14,23
33,8483499,Liam Ohgren,L,MIN,20,82,9,14,23
33,8478443,Brandon Carlo,D,BOS,28,82,8,15,23
33,8483490,Pavel Mintyukov,D,ANA,21,82,7,16,23
33,8480172,Jan Rutta,D,SJS,34,82,6,17,23
33,8478840,Will Borgen,D,SEA,28,82,2,21,23
33,8476967,Brett Kulak,D,EDM,30,82,2,21,23
33,8482762,Simon Edvinsson,D,DET,21,82,12,10,22
33,8479941,Justin Danforth,R,CBJ,31,82,10,12,22
33,8478109,Victor Olofsson,L,VGK,29,82,9,13,22
33,8476278,Colin Blackwell,C,DAL,31,82,9,13,22
33,8482733,Logan Mailloux,D,MTL,31,82,9,13,22
33,8477406,Mattias Janmark,C,EDM,32,82,8,14,22
33,8476889,Radek Faksa,C,STL,30,82,7,15,22
33,8483468,Jiri Kulich,C,BUF,20,82,7,15,22
33,8475231,Casey Cizikas,C,NYI,33,82,6,16,22
33,8470600,Ryan Suter,D,STL,39,82,6,16,22
33,8479998,Mikey Anderson,D,LAK,25,82,5,17,22
33,8479324,Ryan Lindgren,D,NYR,26,82,5,17,22
33,8476525,Colin Miller,D,WPG,32,82,4,18,22
33,8483565,Nick Blankenburg,D,NSH,26,82,3,19,22
33,8477969,Marcus Pettersson,D,PIT,28,82,2,20,22
33,8479398,Samuel Girard,D,COL,26,82,2,20,22
33,8473453,Trevor Lewis,C,LAK,37,82,10,11,21
33,8484145,Zach Benson,L,BUF,19,82,9,12,21
33,8479414,Nathan Bastian,R,NJD,27,82,9,12,21
33,8481481,Blake Lizotte,C,PIT,27,82,8,13,21
33,8482666,Scott Morrow,D,CAR,22,82,8,13,21
33,8482859,Zack Ostapchuk,C,OTT,21,82,8,13,21
33,8477435,Ryan Graves,D,PIT,29,82,6,15,21
33,8476463,Jonas Brodin,D,MIN,31,82,5,16,21
33,8479369,Andrew Peeke,D,BOS,26,82,5,16,21
33,8478434,Keegan Kolesar,R,VGK,27,82,5,16,21
33,8478399,Jonas Siegenthaler,D,NJD,27,82,5,16,21
33,8475690,Chris Tanev,D,TOR,35,82,4,17,21
33,8476879,Cody Ceci,D,EDM,31,82,2,19,21
33,8482245,Artem Zub,D,OTT,29,82,2,19,21
33,8480246,Nick Perbix,D,TBL,26,82,1,20,21
33,8479291,Kevin Rooney,C,CGY,31,82,9,11,20
33,8478432,Christian Fischer,R,DET,27,82,8,12,20
33,8476624,Barclay Goodrow,C,SJS,31,82,8,12,20
33,8480021,Jack Studnicka,C,LAK,25,82,8,12,20
33,8482702,Logan Stankoven,C,DAL,21,82,7,13,20
33,8478468,Jeremy Lauzon,D,NSH,27,82,7,13,20
33,8481014,Alexander Romanov,D,NYI,24,82,3,17,20
33,8475718,Justin Holl,D,DET,32,82,3,17,20
33,8480035,Henri Jokiharju,D,BUF,25,82,2,18,20
33,8482155,Alex Laferriere,R,LAK,23,82,13,6,19
33,8476878,Zemgus Girgensons,L,TBL,30,82,12,7,19
33,8484149,Gavin Brindley,C,CBJ,20,82,11,8,19
33,8482809,Jackson Blake,R,CAR,21,82,11,8,19
33,8482712,Oskar Olausson,R,COL,22,82,10,9,19
33,8480144,David Kampf,C,TOR,29,82,9,10,19
33,8481517,Brett Leason,R,ANA,25,82,8,11,19
33,8480806,Isac Lundestrom,C,ANA,25,82,8,11,19
33,8483505,Matthew Poitras,C,BOS,20,82,7,12,19
33,8482858,Ryker Evans,D,SEA,23,82,7,12,19
33,8482133,Thomas Bordeleau,C,SJS,22,82,4,15,19
33,8481522,Peyton Krebs,C,BUF,23,82,4,15,19
33,8474013,Ian Cole,D,UTA,35,82,4,15,19
33,8478416,Erik Cernak,D,TBL,27,82,4,15,19
33,8478211,Dryden Hunt,L,CGY,29,82,3,16,19
33,8482655,J.J. Moser,D,TBL,24,82,2,17,19
33,8475855,Jesper Fast,R,CAR,33,82,9,9,18
33,8477505,Alexander Wennberg,C,SJS,30,82,7,11,18
33,8483482,Tristan Luneau,D,ANA,20,82,6,12,18
33,8482807,Ethan Del Mastro,D,CHI,21,82,5,13,18
33,8482074,Connor Zary,C,CGY,23,82,5,13,18
33,8477369,Carson Soucy,D,VAN,30,82,4,14,18
33,8477845,Trevor van Riemsdyk,D,WSH,33,82,2,16,18
33,8476457,Adam Larsson,D,SEA,32,82,2,16,18
33,8477839,Conor Sheary,L,TBL,32,82,7,10,17
33,8482118,Sam Colangelo,R,ANA,23,82,7,10,17
33,8482470,Ilya Solovyov,D,CGY,24,82,6,11,17
33,8479371,Dante Fabbro,D,NSH,26,82,5,12,17
33,8481605,Jackson LaCombe,D,ANA,23,82,5,12,17
33,8479442,Troy Stecher,D,EDM,30,82,5,12,17
33,8482073,Braden Schneider,D,NYR,23,82,4,13,17
33,8476931,Jake McCabe,D,TOR,31,82,4,13,17
33,8483445,Cutter Gauthier,L,ANA,20,82,4,13,17
33,8478136,Jake Middleton,D,MIN,28,82,3,14,17
33,8480990,Declan Chisholm,D,MIN,24,82,3,14,17
33,8481568,Alex Vlasic,D,CHI,23,82,1,16,17
33,8475455,Brenden Dillon,D,NJD,34,82,0,17,17
33,8479316,Luke Kunin,C,SJS,27,82,10,6,16
33,8482679,Matt Coronato,R,CGY,22,82,9,7,16
33,8482077,Dylan Holloway,L,EDM,23,82,8,8,16
33,8482516,Matthew Kessel,D,STL,24,82,8,8,16
33,8476372,Nick Seeler,D,PHI,31,82,5,11,16
33,8479402,Jake Bean,D,CGY,26,82,4,12,16
33,8475177,Calvin de Haan,D,COL,33,82,4,12,16
33,8478178,Darren Raddysh,D,TBL,28,82,3,13,16
33,8480879,Jacob Bernard-Docker,D,OTT,24,82,1,15,16
33,8481641,Joel Kiviranta,L,COL,28,82,7,8,15
33,8477938,Haydn Fleury,D,WPG,28,82,4,11,15
33,8483495,Simon Nemec,D,NJD,20,82,3,12,15
33,8476441,Joel Edmundson,D,LAK,31,82,2,13,15
33,8481122,Simon Benoit,D,TOR,26,82,2,13,15
33,8483471,Brad Lambert,C,WPG,31,82,2,13,15
33,8480860,Kevin Bahl,D,CGY,24,82,1,14,15
33,8482070,Mitchell Chaffee,R,TBL,26,82,10,4,14
33,8477499,Rasmus Ristolainen,D,PHI,30,82,9,5,14
33,8482659,Josh Doan,R,UTA,22,82,9,5,14
33,8483524,Shane Wright,C,SEA,20,82,7,7,14
33,8480870,Bo Groulx,C,NYR,24,82,6,8,14
33,8482101,Danil Gushchin,L,SJS,22,82,5,9,14
33,8477335,Kyle Burroughs,D,LAK,29,82,3,11,14
33,8480950,Ilya Lyubushkin,D,DAL,30,82,3,11,14
33,8480807,Mattias Samuelsson,D,BUF,24,82,2,12,14
33,8475790,Erik Gudbranson,D,CBJ,32,82,2,12,14
33,8477034,Jaycob Megna,D,FLA,32,82,2,12,14
33,8478859,Niko Mikkola,D,FLA,28,82,2,12,14
33,8478013,Jake Walman,D,SJS,28,82,8,5,13
33,8476442,Matt Nieto,L,PIT,32,82,6,7,13
33,8483493,Frank Nazar,C,CHI,20,82,4,9,13
33,8482749,Joshua Roy,R,MTL,21,82,4,9,13
33,8483489,Fraser Minten,C,TOR,31,82,2,11,13
33,8483397,Marc McLaughlin,C,BOS,25,82,8,4,12
33,8481028,Martin Pospisil,C,CGY,25,82,6,6,12
33,8481567,Henry Thrun,D,SJS,23,82,5,7,12
33,8474612,Travis Hamonic,D,OTT,34,82,5,7,12
33,8484911,Collin Graf,R,SJS,22,82,4,8,12
33,8476429,Scott Mayfield,D,NYI,32,82,4,8,12
33,8482153,Brendan Brisson,C,VGK,23,82,3,9,12
33,8475762,Derek Forbort,D,VAN,32,82,3,9,12
33,8483466,Kevin Korchinski,D,CHI,20,82,2,10,12
33,8483012,Logan Morrison,C,SEA,22,82,2,10,12
33,8476822,Luke Glendening,C,TBL,35,82,9,2,11
33,8482787,Nikita Chibrikov,R,WPG,31,82,5,6,11
33,8477365,Connor Clifton,D,BUF,29,82,2,9,11
33,8474567,Zach Bogosian,D,MIN,34,82,5,5,10
33,8482145,Mavrik Bourque,C,DAL,22,82,4,6,10
33,8481699,Aku Raty,R,UTA,23,82,2,8,10
33,8476473,Connor Murphy,D,CHI,31,82,6,3,9
33,8482713,Mackie Samoskevich,R,FLA,22,82,4,5,9
33,8479638,Justin Brazeau,R,BOS,26,82,2,7,9
33,8478450,Parker Wotherspoon,D,BOS,27,82,2,7,9
33,8483567,Georgii Merkulov,C,BOS,24,82,3,4,7
33,8474062,Riley Nash,C,NYR,35,82,3,3,6
33,8471677,Jack Johnson,D,CBJ,37,82,2,4,6
33,8478874,Adam Gaudette,C,OTT,28,82,1,5,6
33,8479576,Vincent Desharnais,D,VAN,28,82,0,6,6
33,8483460,David Jiricek,D,CBJ,21,82,1,4,5
33,8470794,Joe Pavelski,C,,40,0,0,0,0
33,8481703,Valtteri Puustinen,R,PIT,25,0,0,0,0
33,8477950,Tony DeAngelo,D,,29,0,0,0,0
33,8481577,Philip Tomasino,C,NSH,23,0,0,0,0
33,8475197,Tyson Barrie,D,,33,0,0,0,0
33,8471218,Blake Wheeler,R,,38,0,0,0,0
33,8474157,Max Pacioretty,L,,36,0,0,0,0
33,8478466,Daniel Sprong,R,VAN,27,0,0,0,0
33,8475744,Evgeny Kuznetsov,C,,32,0,0,0,0
33,8481019,David Gustafsson,C,WPG,24,0,0,0,0
33,8475906,John Klingberg,D,,32,0,0,0,0
33,8479348,Kale Clague,D,BUF,26,0,0,0,0
33,8476952,Dominic Toninato,C,WPG,30,0,0,0,0
33,8473473,Milan Lucic,L,,36,0,0,0,0
33,8474037,James van Riemsdyk,L,,35,0,0,0,0
33,8474602,Justin Schultz,D,,34,0,0,0,0
33,8482222,Alexander Barabanov,L,,30,0,0,0,0
33,8479372,Josh Mahura,D,SEA,26,0,0,0,0
33,8479982,Conor Timmins,D,TOR,26,0,0,0,0
33,8474031,Kevin Shattenkirk,D,,35,0,0,0,0
33,8480008,Adam Ruzicka,C,,25,0,0,0,0
33,8481059,Scott Perunovich,D,STL,26,0,0,0,0
33,8480884,Calen Addison,D,,24,0,0,0,0
33,8476994,Vinnie Hinostroza,C,NSH,30,0,0,0,0
33,8478452,Caleb Jones,D,LAK,27,0,0,0,0
33,8480157,Calle Rosen,D,COL,30,0,0,0,0
33,8481609,Vladislav Kolyachonok,D,UTA,23,0,0,0,0
33,8479415,Michael McLeod,C,,26,0,0,0,0
33,8476919,Chris Tierney,C,,30,0,0,0,0
33,8479639,Dylan Coghlan,D,WPG,26,0,0,0,0
33,8478146,Matthew Highmore,C,OTT,28,0,0,0,0
33,8478970,Jalen Chatfield,D,CAR,28,0,0,0,0
33,8480205,Emil Bemstrom,C,PIT,25,0,0,0,0
33,8474884,Mike Hoffman,C,,35,0,0,0,0
33,8471274,Alex Goligoski,D,,39,0,0,0,0
33,8478104,Sammy Blais,L,,28,0,0,0,0
33,8474870,Tyler Johnson,C,,34,0,0,0,0
33,8476913,Devin Shore,C,MIN,30,0,0,0,0
33,8481598,Philip Broberg,D,EDM,23,0,0,0,0
33,8480058,Pierre-Olivier Joseph,D,STL,25,0,0,0,0
33,8480891,Michael Kesselring,D,UTA,24,0,0,0,0
33,8477979,Nicolas Aube-Kubel,R,BUF,28,0,0,0,0
33,8476871,Tanner Pearson,L,,32,0,0,0,0
33,8476393,Nick Cousins,C,,31,0,0,0,0
33,8479977,Kailer Yamamoto,R,,26,0,0,0,0
33,8479543,Michael Pezzetta,L,MTL,26,0,0,0,0
33,8477018,Ben Hutton,D,VGK,31,0,0,0,0
33,8480762,Eric Robinson,L,CAR,29,0,0,0,0
33,8474034,Pat Maroon,L,CHI,36,0,0,0,0
33,8481058,Jesse Ylönen,R,,25,0,0,0,0
33,8475179,Dmitry Kulikov,D,FLA,34,0,0,0,0
33,8481527,Kaedan Korczak,D,VGK,23,0,0,0,0
33,8473449,Kyle Okposo,R,,36,0,0,0,0
33,8482192,Isaak Phillips,D,CHI,23,0,0,0,0
33,8480727,Zach Whitecloud,D,VGK,28,0,0,0,0
33,8479346,Dillon Dube,C,,26,0,0,0,0
33,8480821,Filip Zadina,R,,25,0,0,0,0
33,8480001,Urho Vaakanainen,D,ANA,25,0,0,0,0
33,8470966,Mark Giordano,D,,41,0,0,0,0
33,8480853,Liam Foudy,C,,24,0,0,0,0
33,8475225,Craig Smith,C,CHI,35,0,0,0,0
33,8479972,Mason Shaw,C,WPG,26,0,0,0,0
33,8478451,Ethan Bear,D,WSH,27,0,0,0,0
33,8474040,Sam Gagner,C,,35,0,0,0,0
33,8480196,Jacob Bryson,D,BUF,27,0,0,0,0
33,8479984,Cal Foote,D,,26,0,0,0,0
33,8480011,Klim Kostin,C,SJS,25,0,0,0,0
33,8482176,Wyatt Kaiser,D,CHI,22,0,0,0,0
33,8476988,Matt Benning,D,SJS,30,0,0,0,0
33,8479370,Tyson Jost,C,CAR,26,0,0,0,0
33,8477464,Nic Petan,C,,29,0,0,0,0
33,8477380,Jonny Brodzinski,C,NYR,31,0,0,0,0
33,8480070,Ian Mitchell,D,BOS,25,0,0,0,0
33,8479315,Joey Anderson,R,CHI,26,0,0,0,0
33,8478099,Kevin Labanc,R,,29,0,0,0,0
33,8476874,Olli Maatta,D,DET,30,0,0,0,0
33,8475208,Brian Dumoulin,D,ANA,33,0,0,0,0
33,8478430,Oliver Kylington,D,,27,0,0,0,0
33,8479536,Axel Jonsson-Fjallby,L,WPG,26,0,0,0,0
33,8479671,Mathieu Olivier,R,CBJ,27,0,0,0,0
33,8471709,Marc-Edouard Vlasic,D,SJS,37,0,0,0,0
33,8479328,Julien Gauthier,R,NYI,27,0,0,0,0
33,8478421,A.J. Greer,L,FLA,28,0,0,0,0
33,8477573,Nathan Walker,L,STL,30,0,0,0,0
33,8481537,Nikita Okhotiuk,D,CGY,24,0,0,0,0
33,8474166,Alec Martinez,D,CHI,37,0,0,0,0
33,8470610,Zach Parise,L,,40,0,0,0,0
33,8477478,William Carrier,L,CAR,30,0,0,0,0
33,8479344,Jesse Puljujarvi,R,PIT,26,0,0,0,0
33,8480887,Jordan Harris,D,MTL,24,0,0,0,0
33,8478502,Dennis Gilbert,D,BUF,28,0,0,0,0
33,8482730,Brandt Clarke,D,LAK,21,0,0,0,0
33,8480355,Mark Kastelic,C,BOS,25,0,0,0,0
33,8475750,Jon Merrill,D,MIN,32,0,0,0,0
33,8475164,Jakob Silfverberg,R,,34,0,0,0,0
33,8477944,Jakub Vrana,L,,28,0,0,0,0
33,8479439,Jacob MacDonald,D,COL,31,0,0,0,0
33,8474568,Luke Schenn,D,NSH,35,0,0,0,0
33,8478454,Noah Juulsen,D,VAN,27,0,0,0,0
33,8475752,Tyler Pitlick,C,,33,0,0,0,0
33,8482148,Hendrix Lapierre,C,WSH,22,0,0,0,0
33,8481167,Brayden Pachal,D,CGY,25,0,0,0,0
33,8478043,Sam Lafferty,C,BUF,29,0,0,0,0
33,8479321,Lucas Johansen,D,,27,0,0,0,0
33,8471699,Andrew Cogliano,C,,37,0,0,0,0
33,8481521,Ronnie Attard,D,PHI,25,0,0,0,0
33,8481161,Jake Christiansen,D,CBJ,25,0,0,0,0
33,8479458,Nikita Zaitsev,D,,33,0,0,0,0
33,8479619,Michael Carcone,L,UTA,28,0,0,0,0
33,8479026,Philippe Myers,D,TOR,27,0,0,0,0
33,8477330,Dominik Kubalik,L,,29,0,0,0,0
33,8481617,Vasily Podkolzin,R,VAN,23,0,0,0,0
33,8481701,Santeri Hatakka,D,NJD,23,0,0,0,0
33,8479514,Rem Pitlick,C,,27,0,0,0,0
33,8477446,Michael McCarron,R,NSH,29,0,0,0,0
33,8470604,Jeff Carter,C,,39,0,0,0,0
33,8482241,Radim Zohorna,L,,28,0,0,0,0
33,8480289,Morgan Barron,C,WPG,26,0,0,0,0
33,8479379,Givani Smith,R,SJS,26,0,0,0,0
33,8480216,Jacob Peterson,C,,25,0,0,0,0
33,8477851,Jordan Oesterle,D,BOS,32,0,0,0,0
33,8484258,Sam Malinski,D,COL,26,0,0,0,0
33,8478904,Steven Lorentz,C,,28,0,0,0,0
33,8482095,Tyler Kleven,D,OTT,22,0,0,0,0
33,8480848,Ty Dellandrea,C,SJS,24,0,0,0,0
33,8476884,Derrick Pouliot,D,,30,0,0,0,0
33,8479336,Carl Grundstrom,R,SJS,27,0,0,0,0
33,8482964,Arber Xhekaj,D,MTL,23,0,0,0,0
33,8471686,Marc Staal,D,,37,0,0,0,0
33,8477887,Patrick Brown,C,BOS,32,0,0,0,0
33,8478495,Denis Gurianov,R,,27,0,0,0,0
33,8473504,Cal Clutterbuck,R,,37,0,0,0,0
33,8481550,Adam Beckman,L,NJD,23,0,0,0,0
33,8480845,Rasmus Kupari,C,WPG,24,0,0,0,0
33,8474009,Nick Bonino,C,,36,0,0,0,0
33,8478585,Derek Ryan,C,EDM,38,0,0,0,0
33,8477962,Brendan Lemieux,L,CAR,28,0,0,0,0
33,8482861,Vincent Iorio,D,WSH,22,0,0,0,0
33,8479378,Logan Stanley,D,WPG,26,0,0,0,0
33,8473446,Erik Johnson,D,PHI,36,0,0,0,0
33,8481743,Marc Del Gaizo,D,NSH,25,0,0,0,0
33,8477384,Josh Brown,D,EDM,30,0,0,0,0
33,8482165,Yan Kuznetsov,D,CGY,22,0,0,0,0
33,8478424,Jansen Harkins,C,ANA,27,0,0,0,0
33,8482144,Jack Thompson,D,SJS,22,0,0,0,0
33,8478512,Austin Czarnik,C,,32,0,0,0,0
33,8477527,Ross Johnston,L,ANA,30,0,0,0,0
33,8479383,Boris Katchouk,L,,26,0,0,0,0
33,8482094,Daemon Hunt,D,MIN,22,0,0,0,0
33,8481719,Maxwell Crozier,D,TBL,24,0,0,0,0
33,8480192,Johnathan Kovacevic,D,NJD,27,0,0,0,0
33,8479376,Victor Mete,D,,26,0,0,0,0
33,8482511,Mason Lohrei,D,BOS,23,0,0,0,0
33,8475825,Jani Hakanpää,D,,32,0,0,0,0
33,8478021,William Lagesson,D,DET,28,0,0,0,0
33,8475795,Dylan McIlrath,D,WSH,32,0,0,0,0
33,8477846,Ryan Carpenter,C,,33,0,0,0,0
33,8481056,Spencer Stastney,D,NSH,24,0,0,0,0
33,8481564,Ryan Johnson,D,BUF,23,0,0,0,0
33,8478017,Mark Friedman,D,VAN,29,0,0,0,0
33,8479320,Max Lajoie,D,SEA,27,0,0,0,0
33,8480075,Cameron Crotty,D,MIN,25,0,0,0,0
33,8484287,Cole McWard,D,VAN,23,0,0,0,0
33,8484254,Akito Hirose,D,VAN,25,0,0,0,0
33,8483407,Brandon Scanlin,D,NYR,25,0,0,0,0
33,8480274,Philip Kemp,D,EDM,25,0,0,0,0
33,8479522,Hardy Haman Aktell,D,WSH,26,0,0,0,0
33,8480007,Jonas Rondbjerg,R,VGK,25,0,0,0,0
33,8477454,Adam Erne,L,,29,0,0,0,0
33,8481679,Maxence Guenette,D,OTT,23,0,0,0,0
33,8480441,Trey Fix-Wolansky,R,CBJ,25,0,0,0,0
33,8483546,Marshall Rifai,D,TOR,26,0,0,0,0
33,8480084,Nick DeSimone,D,NJD,30,0,0,0,0
33,8481030,Jack St. Ivany,D,PIT,25,0,0,0,0
33,8481592,Jakob Pelletier,L,CGY,23,0,0,0,0
33,8478011,Louie Belpedio,D,PHI,28,0,0,0,0
33,8477930,Pierre-Edouard Bellemare,L,,39,0,0,0,0
33,8484321,Nikolas Matinpalo,D,OTT,26,0,0,0,0
33,8482067,Connor Mackey,D,NYR,28,0,0,0,0
33,8481806,Louis Crevier,D,CHI,23,0,0,0,0
33,8484326,Patrik Koch,D,UTA,28,0,0,0,0
33,8477971,Andreas Englund,D,LAK,28,0,0,0,0
33,8481751,Lukas Rousek,R,BUF,25,0,0,0,0
33,8481006,Tyler Tucker,D,STL,24,0,0,0,0
33,8476867,Brendan Gaunce,C,MIN,30,0,0,0,0
33,8479520,Brandon Duhaime,R,WSH,27,0,0,0,0
33,8477073,Kurtis MacDermid,L,NJD,30,0,0,0,0
33,8480874,Adam Ginning,D,PHI,24,0,0,0,0
33,8477473,Justin Bailey,R,SJS,29,0,0,0,0
33,8479066,Ryan Lomberg,L,CGY,30,0,0,0,0
33,8477070,Liam O'Brien,C,UTA,30,0,0,0,0
33,8474618,Marco Scandella,D,,34,0,0,0,0
33,8475797,Jarred Tinordi,D,,32,0,0,0,0
33,8481441,Joe Snively,C,DET,28,0,0,0,0
33,8477244,Chad Ruhwedel,D,NYR,34,0,0,0,0
33,8479772,Zack MacEwen,R,OTT,28,0,0,0,0
33,8481147,Reese Johnson,C,MIN,26,0,0,0,0
33,8481043,Cole Koepke,L,BOS,26,0,0,0,0
33,8483619,Filip Roos,D,OTT,25,0,0,0,0
33,8481541,Samuel Bolduc,D,NYI,24,0,0,0,0
33,8477810,Joel Hanley,D,CGY,33,0,0,0,0
33,8476907,Mackenzie MacEachern,L,,30,0,0,0,0
33,8482652,Walker Duehr,R,CGY,27,0,0,0,0
33,8477126,Jayson Megna,C,,34,0,0,0,0
33,8483398,Declan Carlile,D,TBL,31,0,0,0,0
33,8482929,Emil Lilleberg,D,TBL,23,0,0,0,0
33,8480880,Jakub Lauko,C,MIN,24,0,0,0,0
33,8480245,Olle Lycksell,R,PHI,25,0,0,0,0
33,8480252,Cole Guttman,C,CHI,25,0,0,0,0
33,8477467,Gustav Olofsson,D,SEA,30,0,0,0,0
33,8479968,Vinni Lettieri,C,BOS,29,0,0,0,0
33,8478400,Colin White,C,,27,0,0,0,0
33,8475755,Alexander Petrovic,D,DAL,32,0,0,0,0
33,8481812,Nikolai Knyzhov,D,,27,0,0,0,0
33,8481593,Jayden Struble,D,MTL,23,0,0,0,0
33,8481532,Alex Turcotte,C,LAK,23,0,0,0,0
33,8482126,Emil Andrae,D,PHI,31,0,0,0,0
33,8479944,Zach Aston-Reese,C,VGK,30,0,0,0,0
33,8471817,Ryan Reaves,R,TOR,37,0,0,0,0
33,8481206,John Ludvig,D,PIT,24,0,0,0,0
33,8481599,Victor Soderstrom,D,UTA,23,0,0,0,0
33,8480292,Carson Meyer,R,ANA,27,0,0,0,0
33,8482496,Nils Aman,C,VAN,24,0,0,0,0
33,8479718,Alex Barré-Boulet,C,MTL,27,0,0,0,0
33,8479994,Jaret Anderson-Dolan,C,WPG,25,0,0,0,0
33,8480184,Gustav Lindstrom,D,,26,0,0,0,0
33,8480890,Jan Jenik,R,OTT,24,0,0,0,0
33,8478067,Oskar Lindblom,L,,28,0,0,0,0
33,8476934,Brock McGinn,L,ANA,30,0,0,0,0
33,8479985,Cale Fleury,D,SEA,26,0,0,0,0
33,8484304,Uvis Balinskis,D,FLA,28,0,0,0,0
33,8479981,Jonah Gadjovich,L,FLA,26,0,0,0,0
33,8481716,Dmitri Voronkov,L,CBJ,24,0,0,0,0
33,8474709,Matt Martin,L,,35,0,0,0,0
33,8482634,Alex Steeves,C,TOR,25,0,0,0,0
33,8480823,Alexander Alexeyev,D,WSH,25,0,0,0,0
33,8477541,Dakota Mermis,D,TOR,30,0,0,0,0
33,8483491,Ivan Miroshnichenko,L,WSH,20,0,0,0,0
33,8478477,Mitchell Stephens,C,SEA,27,0,0,0,0
33,8481543,Nikita Alexandrov,C,STL,24,0,0,0,0
33,8479423,Alex Nylander,L,,26,0,0,0,0
33,8482451,Mikael Pyyhtia,L,CBJ,23,0,0,0,0
33,8478831,Kevin Stenlund,C,UTA,28,0,0,0,0
33,8480306,Grant Hutton,D,NYI,29,0,0,0,0
33,8478028,Fredrik Olofsson,L,,28,0,0,0,0
33,8477462,Robert Hagg,D,VGK,29,0,0,0,0
33,8477320,Anton Blidh,L,NYR,29,0,0,0,0
33,8482157,Will Cuylle,L,NYR,22,0,0,0,0
33,8482737,Zack Bolduc,C,STL,21,0,0,0,0
33,8481239,Samuel Fagemo,L,,24,0,0,0,0
33,8481600,Tobias Bjornfot,D,FLA,23,0,0,0,0
33,8478409,Anthony Richard,C,PHI,28,0,0,0,0
33,8474145,Robert Bortuzzo,D,,35,0,0,0,0
33,8475958,Michael Sgarbossa,C,WSH,32,0,0,0,0
33,8479986,Kole Lind,R,DAL,26,0,0,0,0
33,8479249,Andrew Poturalski,C,SJS,30,0,0,0,0
33,8479362,Riley Tufte,L,BOS,26,0,0,0,0
33,8479991,Jake Leschyshyn,C,NYR,25,0,0,0,0
33,8479587,Rhett Gardner,C,PHI,28,0,0,0,0
33,8482744,James Malatesta,L,CBJ,21,0,0,0,0
33,8478854,Ryan Shea,D,PIT,27,0,0,0,0
33,8481591,Sam Poulin,R,,23,0,0,0,0
33,8483512,Matt Savoie,C,EDM,20,0,0,0,0
33,8482102,Vasily Ponomarev,C,PIT,22,0,0,0,0
33,8482162,Roby Jarventie,L,EDM,22,0,0,0,0
33,8481016,Ruslan Iskhakov,C,,24,0,0,0,0
33,8482172,Landon Slaggert,L,CHI,22,0,0,0,0
33,8482747,Brennan Othmann,L,NYR,21,0,0,0,0
33,8480031,Maxime Comtois,L,,25,0,0,0,0
33,8480226,Marián Studenic,R,,26,0,0,0,0
33,8478408,Travis Dermott,D,,28,0,0,0,0
33,8481518,Nolan Foote,L,NJD,24,0,0,0,0
33,8479419,Brett Murray,L,BUF,26,0,0,0,0
33,8482088,Justin Sourdif,R,FLA,22,0,0,0,0
33,8482201,Gage Goncalves,C,TBL,23,0,0,0,0
33,8481578,Graeme Clarke,R,MIN,23,0,0,0,0
33,8482177,Marat Khusnutdinov,C,MIN,22,0,0,0,0
33,8481754,Nikita Nesterenko,C,ANA,23,0,0,0,0
33,8483531,Brian Halonen,L,NJD,25,0,0,0,0
33,8483920,Pierrick Dube,R,WSH,23,0,0,0,0
33,8480851,Akil Thomas,C,LAK,24,0,0,0,0
33,8475235,Nicolas Deslauriers,L,PHI,33,0,0,0,0
33,8482476,Emil Heineman,L,MTL,23,0,0,0,0
33,8477149,Scott Sabourin,R,SJS,32,0,0,0,0
33,8483549,Lucas Condotta,L,MTL,27,0,0,0,0
33,8482765,Isak Rosen,R,BUF,21,0,0,0,0
33,8481237,Kyle MacLean,C,NYI,25,0,0,0,0
33,8481024,Linus Karlsson,C,VAN,25,0,0,0,0
33,8481690,Tyler Angle,C,,24,0,0,0,0
33,8483570,Ben Meyers,C,SEA,26,0,0,0,0
33,8481655,Cole Schwindt,R,CGY,23,0,0,0,0
33,8481462,Mason Morelli,L,VGK,28,0,0,0,0
33,8483401,Marc Johnstone,R,PIT,28,0,0,0,0
33,8478956,Samuel Laberge,L,NJD,27,0,0,0,0
33,8479533,Joona Koppanen,L,,26,0,0,0,0
33,8482197,Adam Raska,R,MIN,23,0,0,0,0
33,8482250,Callahan Burke,C,VGK,27,0,0,0,0
33,8482784,Zach Dean,C,STL,21,0,0,0,0
33,8484255,Jason Polin,R,COL,25,0,0,0,0
33,8481077,John Leonard,L,,26,0,0,0,0
33,8481534,Raphael Lavoie,C,EDM,24,0,0,0,0
33,8483609,Adam Klapka,R,CGY,24,0,0,0,0
33,8482751,Ryan Winterton,C,SEA,21,0,0,0,0
33,8480267,Sammy Walker,C,MIN,25,0,0,0,0
33,8475766,Austin Watson,L,,32,0,0,0,0
33,8482460,Matt Rempe,C,NYR,22,0,0,0,0
33,8481065,Angus Crookshank,L,OTT,25,0,0,0,0
33,8481070,Hugh McGing,L,,26,0,0,0,0
33,8476323,Max McCormick,L,SEA,32,0,0,0,0
33,8483395,Arshdeep Bains,L,VAN,23,0,0,0,0
33,8484259,Ondrej Pavel,C,COL,31,0,0,0,0
33,8483432,Luca Del Bel Belluz,C,CBJ,31,0,0,0,0
33,8483045,Cameron Butler,R,CBJ,31,0,0,0,0
33,8482061,Brandon Biro,L,SEA,26,0,0,0,0
33,8477401,John Hayden,C,SEA,29,0,0,0,0
33,8475278,Byron Froese,C,,33,0,0,0,0
33,8478446,Glenn Gawdin,C,LAK,27,0,0,0,0
33,8477993,Justin Kirkland,C,CGY,28,0,0,0,0
33,8482147,Jean-Luc Foudy,C,COL,22,0,0,0,0
33,8480032,Shane Bowers,C,NJD,25,0,0,0,0
33,8479330,Brandon Gignac,C,MTL,27,0,0,0,0
33,8480776,Sheldon Rempal,R,,29,0,0,0,0
33,8475413,Justin Dowling,C,NJD,34,0,0,0,0
33,8481726,Adam Edstrom,C,NYR,24,0,0,0,0
33,8480844,Grigori Denisenko,L,VGK,24,0,0,0,0
33,8478147,Bokondji Imama,L,PIT,28,0,0,0,0
33,8478881,Brett Seney,L,CHI,28,0,0,0,0
33,8483630,Pavol Regenda,L,ANA,25,0,0,0,0
33,8480836,Jonathan Gruden,C,,24,0,0,0,0
33,8484314,Jiri Smejkal,L,,28,0,0,0,0
33,8475780,Chris Wagner,R,COL,33,0,0,0,0
33,8479546,Oskar Steen,C,,26,0,0,0,0
33,8483597,Milos Kelemen,L,UTA,25,0,0,0,0
33,8481789,Tye Kartye,L,SEA,23,0,0,0,0
33,8484325,Waltteri Merela,C,TBL,26,0,0,0,0
33,8479421,Jacob Moverare,D,LAK,26,0,0,0,0
33,8481585,Egor Afanasyev,L,SJS,23,0,0,0,0
33,8479547,Matthew Phillips,R,,26,0,0,0,0
33,8479367,William Lockwood,R,FLA,26,0,0,0,0
33,8476915,Jujhar Khaira,L,,30,0,0,0,0
33,8481422,Jacob Lucchini,C,NSH,29,0,0,0,0
33,8480468,James Hamblin,L,EDM,25,0,0,0,0
33,8478051,Max Willman,C,NJD,29,0,0,0,0
33,8481556,John Beecher,C,BOS,23,0,0,0,0
33,8478078,Rourke Chartier,C,,28,0,0,0,0
34,8478402,Connor McDavid,C,EDM,27,82,55,97,152
34,8476453,Nikita Kucherov,R,TBL,31,82,47,96,143
34,8477492,Nathan MacKinnon,C,COL,29,82,56,73,129
34,8479318,Auston Matthews,C,TOR,27,82,60,53,113
34,8477404,Jake Guentzel,C,TBL,30,82,47,60,107
34,8481559,Jack Hughes,C,NJD,23,82,41,66,107
34,8477939,William Nylander,R,TOR,28,82,42,62,104
34,8477493,Aleksander Barkov,C,FLA,29,82,30,74,104
34,8476468,J.T. Miller,C,VAN,31,82,41,62,103
34,8479314,Matthew Tkachuk,L,FLA,27,82,35,68,103
34,8477956,David Pastrnak,R,BOS,28,82,45,57,102
34,8478864,Kirill Kaprizov,L,MIN,27,82,44,58,102
34,8477946,Dylan Larkin,C,DET,28,82,52,49,101
34,8477934,Leon Draisaitl,C,EDM,29,82,30,71,101
34,8478420,Mikko Rantanen,R,COL,28,82,37,62,99
34,8480002,Nico Hischier,C,NJD,25,82,36,62,98
34,8480800,Quinn Hughes,D,VAN,25,82,12,86,98
34,8478550,Artemi Panarin,L,NYR,33,82,35,62,97
34,8474564,Steven Stamkos,C,NSH,34,82,48,47,95
34,8480801,Brady Tkachuk,L,OTT,25,82,42,53,95
34,8481557,Matt Boldy,L,MIN,23,82,46,48,94
34,8482116,Tim Stützle,C,OTT,22,82,32,62,94
34,8480830,Andrei Svechnikov,R,CAR,24,82,45,48,93
34,8477942,Kevin Fiala,L,LAK,28,82,32,61,93
34,8479323,Adam Fox,D,NYR,26,82,21,72,93
34,8476887,Filip Forsberg,L,NSH,30,82,50,42,92
34,8478398,Kyle Connor,L,WPG,28,82,37,55,92
34,8480012,Elias Pettersson,C,VAN,26,82,34,58,92
34,8478403,Jack Eichel,C,VGK,28,82,47,44,91
34,8479343,Clayton Keller,R,UTA,26,82,42,49,91
34,8471675,Sidney Crosby,C,PIT,37,82,33,58,91
34,8475692,Mats Zuccarello,R,MIN,37,82,23,68,91
34,8480027,Jason Robertson,L,DAL,25,82,32,58,90
34,8475166,John Tavares,C,TOR,34,82,34,54,88
34,8477933,Sam Reinhart,C,FLA,29,82,47,40,87
34,8475184,Chris Kreider,L,NYR,33,82,40,47,87
34,8475172,Nazem Kadri,C,CGY,34,82,29,58,87
34,8477402,Pavel Buchnevich,L,STL,29,82,40,46,86
34,8477447,Shea Theodore,D,VGK,29,82,11,74,85
34,8476459,Mika Zibanejad,C,NYR,31,82,33,51,84
34,8478445,Mathew Barzal,C,NYI,27,82,28,56,84
34,8478460,Zach Werenski,D,CBJ,27,82,16,68,84
34,8471214,Alex Ovechkin,L,WSH,39,82,44,39,83
34,8478414,Timo Meier,R,NJD,28,82,39,44,83
34,8480036,Miro Heiskanen,D,DAL,25,82,16,67,83
34,8475754,Brock Nelson,C,NYI,33,82,45,37,82
34,8478444,Brock Boeser,R,VAN,27,82,41,41,82
34,8479385,Jordan Kyrou,C,STL,26,82,33,49,82
34,8480069,Cale Makar,D,COL,26,82,24,58,82
34,8476346,Johnny Gaudreau,L,CBJ,31,82,18,64,82
34,8479420,Tage Thompson,C,BUF,27,82,46,33,79
34,8477960,Adrian Kempe,R,LAK,28,82,32,47,79
34,8479337,Alex DeBrincat,R,DET,27,82,26,53,79
34,8478010,Brayden Point,C,TBL,28,82,42,36,78
34,8477949,Alex Tuch,R,BUF,28,82,34,44,78
34,8479407,Jesper Bratt,L,NJD,26,82,25,53,78
34,8477955,Jared McCann,L,SEA,28,82,32,45,77
34,8480023,Robert Thomas,C,STL,25,82,22,54,76
34,8478493,Joel Eriksson Ek,C,MIN,27,82,39,36,75
34,8478439,Travis Konecny,R,PHI,27,82,35,40,75
34,8478873,Troy Terry,R,ANA,27,82,30,45,75
34,8476389,Vincent Trocheck,C,NYR,31,82,21,54,75
34,8475913,Mark Stone,R,VGK,32,82,31,43,74
34,8474600,Roman Josi,D,NSH,34,82,18,56,74
34,8477501,Valeri Nichushkin,R,COL,29,82,40,33,73
34,8475810,Bryan Rust,R,PIT,32,82,32,41,73
34,8471685,Anze Kopitar,C,LAK,37,82,29,44,73
34,8477951,Nick Schmaltz,C,UTA,28,82,23,50,73
34,8476454,Ryan Nugent-Hopkins,C,EDM,31,82,19,54,73
34,8475798,Mikael Granlund,C,SJS,32,82,16,57,73
34,8473419,Brad Marchand,L,BOS,36,82,27,45,72
34,8476448,William Karlsson,C,VGK,31,82,36,35,71
34,8480839,Rasmus Dahlin,D,BUF,24,82,27,44,71
34,8479339,Patrik Laine,L,CBJ,26,82,37,33,70
34,8476432,Boone Jenner,C,CBJ,31,82,36,34,70
34,8478449,Roope Hintz,C,DAL,28,82,34,36,70
34,8471215,Evgeni Malkin,C,PIT,38,82,27,43,70
34,8473994,Jamie Benn,L,DAL,35,82,22,48,70
34,8480865,Noah Dobson,D,NYI,24,82,16,54,70
34,8478427,Sebastian Aho,C,CAR,27,82,29,40,69
34,8476539,Jonathan Marchessault,R,NSH,34,82,37,31,68
34,8477409,Carter Verhaeghe,C,FLA,29,82,33,35,68
34,8476460,Mark Scheifele,C,WPG,31,82,30,38,68
34,8475158,Ryan O'Reilly,C,NSH,33,82,27,41,68
34,8475168,Matt Duchene,C,DAL,33,82,27,40,67
34,8475745,Charlie Coyle,C,BOS,32,82,27,40,67
34,8475794,Tyler Seguin,C,DAL,32,82,26,41,67
34,8474141,Patrick Kane,R,DET,36,82,24,43,67
34,8476881,Tomas Hertl,C,VGK,31,82,21,46,67
34,8479425,Filip Hronek,D,VAN,27,82,17,50,67
34,8478396,Noah Hanifin,D,VGK,27,82,14,53,67
34,8477416,Oliver Bjorkstrand,R,SEA,29,82,29,37,66
34,8473512,Claude Giroux,R,OTT,36,82,21,45,66
34,8481523,Kirby Dach,C,MTL,23,82,18,48,66
34,8476456,Jonathan Huberdeau,C,CGY,31,82,12,53,65
34,8475765,Vladimir Tarasenko,R,DET,33,82,32,32,64
34,8482109,Alexis Lafrenière,L,NYR,23,82,29,35,64
34,8481533,Trevor Zegras,C,ANA,23,82,19,45,64
34,8477451,Ryan Hartman,R,MIN,30,82,25,38,63
34,8481068,Yegor Sharangovich,C,CGY,26,82,35,27,62
34,8480797,Joel Farabee,L,PHI,24,82,31,31,62
34,8482078,Lucas Raymond,L,DET,22,82,29,33,62
34,8477497,Sean Monahan,C,CBJ,30,82,25,37,62
34,8478042,Viktor Arvidsson,R,EDM,31,82,25,37,62
34,8482093,Seth Jarvis,C,CAR,22,82,22,40,62
34,8477504,Josh Morrissey,D,WPG,29,82,12,50,62
34,8476399,Blake Coleman,C,CGY,33,82,32,29,61
34,8475786,Zach Hyman,L,EDM,32,82,28,33,61
34,8479345,Jakob Chychrun,D,WSH,26,82,19,42,61
34,8479999,Casey Mittelstadt,C,COL,26,82,17,44,61
34,8482684,Luke Hughes,D,NJD,21,82,11,50,61
34,8476880,Tom Wilson,R,WSH,30,82,30,30,60
34,8471698,T.J. Oshie,R,WSH,38,82,27,33,60
34,8480208,Drake Batherson,R,OTT,26,82,26,34,60
34,8476853,Morgan Rielly,D,TOR,30,82,8,52,60
34,8478474,Lawson Crouse,L,UTA,27,82,35,24,59
34,8478498,Jake DeBrusk,L,VAN,28,82,27,32,59
34,8477940,Nikolaj Ehlers,L,WPG,28,82,22,37,59
34,8474679,Gustav Nyquist,C,NSH,35,82,14,45,59
34,8477932,Aaron Ekblad,D,FLA,28,82,14,45,59
34,8475167,Victor Hedman,D,TBL,34,82,9,50,59
34,8478047,Michael Bunting,L,PIT,29,82,23,35,58
34,8476479,Phillip Danault,C,LAK,31,82,22,36,58
34,8473986,Alex Killorn,L,ANA,35,82,21,37,58
34,8478440,Dylan Strome,C,WSH,27,82,19,39,58
34,8477935,Sam Bennett,C,FLA,28,82,30,27,57
34,8478856,Conor Garland,R,VAN,28,82,26,31,57
34,8482745,Mason McTavish,C,ANA,21,82,26,31,57
34,8480039,Martin Necas,C,CAR,25,82,25,32,57
34,8475170,Brayden Schenn,C,STL,33,82,24,33,57
34,8478975,Mason Marchment,L,DAL,29,82,24,33,57
34,8475791,Taylor Hall,L,CHI,33,82,23,34,57
34,8479675,Trevor Moore,L,LAK,29,82,33,23,56
34,8481540,Cole Caufield,R,MTL,23,82,25,31,56
34,8479542,Brandon Hagel,L,TBL,26,82,23,33,56
34,8478469,Thomas Chabot,D,OTT,27,82,16,40,56
34,8477346,MacKenzie Weegar,D,CGY,30,82,14,42,56
34,8482110,Dawson Mercer,C,NJD,23,82,29,26,55
34,8475191,Reilly Smith,R,NYR,33,82,29,26,55
34,8480798,Philipp Kurashev,C,CHI,25,82,25,30,55
34,8482149,Cole Perfetti,C,WPG,22,82,25,30,55
34,8479400,Pierre-Luc Dubois,L,WSH,26,82,19,36,55
34,8482097,Jack Quinn,R,BUF,23,82,17,38,55
34,8477479,Tyler Bertuzzi,L,CHI,29,82,27,27,54
34,8477500,Bo Horvat,C,NYI,29,82,22,32,54
34,8474102,David Perron,L,OTT,36,82,21,33,54
34,8474578,Erik Karlsson,D,PIT,34,82,15,39,54
34,8476792,Torey Krug,D,STL,33,82,15,39,54
34,8476329,Travis Boyd,C,MIN,31,82,12,42,54
34,8481711,Matias Maccelli,L,UTA,24,82,10,44,54
34,8476875,Mike Matheson,D,MTL,30,82,5,49,54
34,8482740,Wyatt Johnston,C,DAL,21,82,31,22,53
34,8474149,Evgenii Dadonov,R,DAL,35,82,27,26,53
34,8476483,Rickard Rakell,R,PIT,31,82,26,27,53
34,8474150,Mikael Backlund,C,CGY,35,82,24,29,53
34,8475726,Tyler Toffoli,C,SJS,32,82,22,31,53
34,8480018,Nick Suzuki,C,MTL,25,82,19,34,53
34,8477494,Jonathan Drouin,L,COL,29,82,15,38,53
34,8480028,Morgan Frost,C,PHI,25,82,12,41,53
34,8483808,Andrei Kuzmenko,L,CGY,28,82,26,26,52
34,8477496,Elias Lindholm,C,BOS,30,82,23,29,52
34,8478519,Anthony Cirelli,C,TBL,27,82,23,29,52
34,8481596,Shane Pinto,C,OTT,24,82,21,31,52
34,8477986,Brandon Montour,D,SEA,30,82,20,32,52
34,8477021,Alex Kerfoot,C,UTA,30,82,18,34,52
34,8474590,John Carlson,D,WSH,34,82,10,42,52
34,8474565,Alex Pietrangelo,D,VGK,34,82,6,46,52
34,8475784,Jeff Skinner,C,EDM,32,82,29,22,51
34,8480014,Gabriel Vilardi,C,WPG,25,82,28,23,51
34,8482665,Matty Beniers,C,SEA,22,82,25,26,51
34,8478462,Nicolas Roy,C,VGK,27,82,25,26,51
34,8478401,Pavel Zacha,C,BOS,27,82,21,30,51
34,8479410,Mikhail Sergachev,D,UTA,26,82,12,39,51
34,8475768,Jaden Schwartz,C,SEA,32,82,28,22,50
34,8482475,Yegor Chinakhov,R,CBJ,23,82,28,22,50
34,8475314,Anders Lee,L,NYI,34,82,23,27,50
34,8475760,Nick Bjugstad,C,UTA,32,82,21,29,50
34,8478407,Vince Dunn,D,SEA,28,82,14,36,50
34,8476869,Brady Skjei,D,NSH,30,82,13,37,50
34,8470613,Brent Burns,D,CAR,39,82,8,42,50
34,8482699,Dylan Guenther,R,UTA,21,82,26,23,49
34,8480185,Eetu Luostarinen,C,FLA,26,82,24,25,49
34,8475793,Ryan Johansen,C,PHI,32,82,20,29,49
34,8475149,Marcus Johansson,L,MIN,34,82,20,29,49
34,8474586,Jordan Eberle,R,SEA,34,82,14,35,49
34,8480803,Evan Bouchard,D,EDM,25,82,13,36,49
34,8477476,Artturi Lehkonen,L,COL,29,82,24,24,48
34,8480015,Owen Tippett,R,PHI,25,82,21,27,48
34,8476906,Shayne Gostisbehere,D,CAR,31,82,18,30,48
34,8481542,Moritz Seider,D,DET,23,82,8,40,48
34,8481560,Arthur Kaliyev,R,LAK,23,82,20,27,47
34,8478542,Evan Rodrigues,C,FLA,31,82,19,28,47
34,8481546,Cam York,D,PHI,23,82,10,37,47
34,8475151,Kyle Palmieri,C,NYI,33,82,31,15,46
34,8477407,Anthony Duclair,L,NYI,29,82,23,23,46
34,8478472,Mathieu Joseph,R,STL,27,82,17,29,46
34,8476905,Chandler Stephenson,C,SEA,30,82,16,30,46
34,8474563,Drew Doughty,D,LAK,35,82,13,33,46
34,8482105,Jake Sanderson,D,OTT,22,82,13,33,46
34,8480434,Sean Durzi,D,UTA,26,82,9,37,46
34,8478038,Devon Toews,D,COL,30,82,8,38,46
34,8482159,Tyson Foerster,R,PHI,22,82,26,19,45
34,8477964,Ivan Barbashev,C,VGK,29,82,21,24,45
34,8480220,Noah Cates,L,PHI,25,82,21,24,45
34,8475287,Erik Haula,L,NJD,33,82,20,25,45
34,8477503,Max Domi,C,TOR,29,82,17,28,45
34,8475722,Jason Zucker,L,BUF,32,82,16,29,45
34,8478115,Pierre Engvall,L,NYI,28,82,15,30,45
34,8477948,Travis Sanheim,D,PHI,28,82,11,34,45
34,8478438,Tommy Novak,C,NSH,27,82,10,35,45
34,8477495,Seth Jones,D,CHI,30,82,10,35,45
34,8482671,Owen Power,D,BUF,22,82,6,39,45
34,8481618,Alex Newhook,C,MTL,23,82,25,19,44
34,8482113,Anton Lundell,C,FLA,23,82,22,22,44
34,8481528,Dylan Cozens,C,BUF,23,82,21,23,44
34,8476872,Scott Laughton,C,PHI,30,82,21,23,44
34,8476392,Adam Lowry,C,WPG,31,82,19,25,44
34,8478233,Andrew Mangiapane,L,WSH,28,82,18,26,44
34,8475714,Calle Jarnkrok,C,TOR,33,82,18,26,44
34,8480078,Filip Chytil,C,NYR,25,82,17,27,44
34,8476882,Teuvo Teravainen,L,CHI,30,82,14,30,44
34,8475218,Mattias Ekholm,D,EDM,34,82,13,31,44
34,8482660,Kent Johnson,C,CBJ,22,82,12,32,44
34,8478397,Rasmus Andersson,D,CGY,28,82,9,35,44
34,8482667,William Eklund,L,SJS,22,82,22,21,43
34,8480849,Barrett Hayton,C,UTA,24,82,21,22,43
34,8475764,Cam Fowler,D,ANA,33,82,6,37,43
34,8480064,Josh Norris,C,OTT,25,82,22,20,42
34,8476462,Dougie Hamilton,D,NJD,31,82,20,22,42
34,8478046,Danton Heinen,L,VAN,29,82,20,22,42
34,8475169,Evander Kane,L,EDM,33,82,18,24,42
34,8479525,Ross Colton,C,COL,28,82,16,26,42
34,8480817,K'Andre Miller,D,NYR,24,82,14,28,42
34,8476925,Colton Sissons,C,NSH,31,82,14,28,42
34,8481581,Thomas Harley,D,DAL,23,82,13,29,42
34,8478891,Mason Appleton,C,WPG,28,82,12,30,42
34,8478055,Gustav Forsling,D,FLA,28,82,10,32,42
34,8480813,Joe Veleno,C,DET,24,82,24,17,41
34,8478366,Frank Vatrano,R,ANA,30,82,23,18,41
34,8482092,Ridly Greig,C,OTT,22,82,23,18,41
34,8473422,Nick Foligno,L,CHI,37,82,20,21,41
34,8480802,Ryan McLeod,C,BUF,25,82,19,22,41
34,8477426,Nicholas Paul,L,TBL,29,82,15,26,41
34,8476958,Jaccob Slavin,D,CAR,30,82,7,34,41
34,8479325,Charlie McAvoy,D,BOS,27,82,6,35,41
34,8475799,Nino Niederreiter,R,WPG,32,82,24,16,40
34,8480835,Jack Drury,C,CAR,24,82,22,18,40
34,8481535,Nils Hoglander,L,VAN,24,82,22,18,40
34,8482705,Cole Sillinger,C,CBJ,21,82,21,19,40
34,8479996,Cody Glass,C,NSH,25,82,17,23,40
34,8482146,Luke Evangelista,R,NSH,22,82,16,24,40
34,8480068,Ryan Poehling,C,PHI,25,82,15,25,40
34,8480789,Oliver Wahlstrom,R,NYI,24,82,14,26,40
34,8476278,Colin Blackwell,C,DAL,31,82,14,26,40
34,8476826,Yanni Gourde,C,SEA,33,82,13,27,40
34,8477498,Darnell Nurse,D,EDM,29,82,12,28,40
34,8477444,Andre Burakovsky,L,SEA,29,82,10,30,40
34,8476923,Damon Severson,D,CBJ,30,82,6,34,40
34,8474641,Adam Henrique,C,EDM,34,82,20,19,39
34,8481624,Ilya Mikheyev,R,CHI,30,82,18,21,39
34,8477456,J.T. Compher,L,DET,29,82,17,22,39
34,8476292,Ondrej Palat,L,NJD,33,82,16,23,39
34,8480459,Pius Suter,C,VAN,28,82,14,25,39
34,8478458,Jack Roslovic,C,CAR,27,82,12,27,39
34,8477429,Andrew Copp,C,DET,30,82,9,30,39
34,8482089,Jake Neighbours,L,STL,22,82,24,14,38
34,8479987,Morgan Geekie,C,BOS,26,82,21,17,38
34,8478020,Michael Amadio,C,OTT,28,82,21,17,38
34,8480188,Fabian Zetterlund,L,SJS,25,82,18,20,38
34,8479365,Trent Frederic,C,BOS,26,82,18,20,38
34,8480829,Jesperi Kotkaniemi,C,CAR,24,82,17,21,38
34,8481186,Logan O'Connor,R,COL,28,82,15,23,38
34,8483515,Juraj Slafkovsky,L,MTL,20,82,13,25,38
34,8482055,Drew O'Connor,L,PIT,26,82,26,11,37
34,8481554,Kaapo Kakko,R,NYR,23,82,19,18,37
34,8477953,Kasperi Kapanen,R,STL,28,82,16,21,37
34,8473533,Jordan Staal,C,CAR,36,82,15,22,37
34,8479316,Luke Kunin,C,SJS,27,82,15,22,37
34,8476458,Ryan Strome,C,ANA,31,82,11,26,37
34,8476331,Dylan DeMelo,D,WPG,31,82,11,26,37
34,8481013,Jonatan Berggren,R,DET,24,82,9,28,37
34,8482124,Quinton Byfield,R,LAK,22,82,5,32,37
34,8475753,Justin Faulk,D,STL,32,82,5,32,37
34,8477511,Anthony Mantha,R,CGY,30,82,19,17,36
34,8479941,Justin Danforth,R,CBJ,31,82,19,17,36
34,8484166,Adam Fantilli,C,CBJ,20,82,16,20,36
34,8476921,Jordan Martinook,L,CAR,32,82,15,21,36
34,8484144,Connor Bedard,C,CHI,19,82,12,24,36
34,8476422,Mike Reilly,D,NYI,31,82,11,25,36
34,8476931,Jake McCabe,D,TOR,31,82,9,27,36
34,8476979,Erik Gustafsson,D,DET,32,82,8,28,36
34,8475171,Oliver Ekman-Larsson,D,TOR,33,82,8,28,36
34,8477220,Nate Schmidt,D,FLA,33,82,6,30,36
34,8477969,Marcus Pettersson,D,PIT,28,82,3,33,36
34,8480893,Kirill Marchenko,R,CBJ,24,82,22,13,35
34,8481604,Pavel Dorofeyev,L,VGK,24,82,20,15,35
34,8476981,Josh Anderson,R,MTL,30,82,19,16,35
34,8477947,Sonny Milano,L,WSH,28,82,17,18,35
34,8480748,Kiefer Sherwood,L,VAN,29,82,14,21,35
34,8476885,Jacob Trouba,D,NYR,30,82,13,22,35
34,8473563,Nicklas Backstrom,C,WSH,37,82,12,23,35
34,8477919,Frederick Gaudreau,C,MIN,31,82,12,23,35
34,8480144,David Kampf,C,TOR,29,82,12,23,35
34,8480336,Sean Walker,D,CAR,30,82,11,24,35
34,8480145,Neal Pionk,D,WPG,29,82,9,26,35
34,8482125,Alexander Holtz,R,VGK,22,82,18,16,34
34,8479351,Sam Steel,C,DAL,26,82,17,17,34
34,8476873,Mark Jankowski,C,NSH,30,82,16,18,34
34,8481656,Aliaksei Protas,C,WSH,23,82,15,19,34
34,8476960,Andreas Athanasiou,C,CHI,30,82,15,19,34
34,8480113,Alex Iafallo,L,WPG,31,82,15,19,34
34,8479992,Michael Rasmussen,C,DET,25,82,15,19,34
34,8479293,Brandon Tanev,L,SEA,33,82,14,20,34
34,8477987,Ryan Donato,C,CHI,28,82,13,21,34
34,8479390,Taylor Raddysh,R,WSH,26,82,13,21,34
34,8476480,Vladislav Namestnikov,C,WPG,32,82,12,22,34
34,8475193,Tomas Tatar,L,NJD,34,82,12,22,34
34,8476461,Sean Couturier,C,PHI,32,82,9,25,34
34,8480871,Adam Boqvist,D,FLA,24,82,6,28,34
34,8474715,Cam Atkinson,R,TBL,35,82,20,13,33
34,8481481,Blake Lizotte,C,PIT,27,82,17,16,33
34,8480806,Isac Lundestrom,C,ANA,25,82,16,17,33
34,8478413,Jordan Greenway,L,BUF,27,82,13,20,33
34,8478508,Yakov Trenin,C,MIN,27,82,12,21,33
34,8478109,Victor Olofsson,L,VGK,29,82,11,22,33
34,8476854,Hampus Lindholm,D,BOS,30,82,6,27,33
34,8474716,Jared Spurgeon,D,MIN,35,82,6,27,33
34,8480873,Rasmus Sandin,D,WSH,24,82,4,29,33
34,8477506,Ryan Pulock,D,NYI,30,82,3,30,33
34,8478057,Dakota Joshua,C,VAN,28,82,16,16,32
34,8476469,Joel Armia,R,MTL,31,82,16,16,32
34,8480009,Eeli Tolvanen,R,SEA,25,82,16,16,32
34,8479353,Brett Howden,C,VGK,26,82,16,16,32
34,8476419,Jean-Gabriel Pageau,C,NYI,32,82,14,18,32
34,8475763,Kevin Hayes,R,PIT,32,82,13,19,32
34,8477488,Brett Pesce,D,NJD,30,82,11,21,32
34,8471724,Kris Letang,D,PIT,37,82,5,27,32
34,8474151,Ryan McDonagh,D,TBL,35,82,4,28,32
34,8474053,Logan Couture,C,SJS,35,82,15,16,31
34,8479393,Noah Gregor,C,OTT,26,82,15,16,31
34,8479368,Max Jones,L,BOS,26,82,14,17,31
34,8482111,Justin Barron,D,MTL,23,82,13,18,31
34,8477989,Christian Dvorak,C,MTL,28,82,11,20,31
34,8478133,Jake Evans,C,MTL,28,82,8,23,31
34,8473507,Jeff Petry,D,DET,37,82,6,25,31
34,8483495,Simon Nemec,D,NJD,20,82,6,25,31
34,8482720,Matthew Knies,L,TOR,22,82,18,12,30
34,8474189,Lars Eller,C,PIT,35,82,14,16,30
34,8477998,Warren Foegele,L,LAK,28,82,12,18,30
34,8475200,Dmitry Orlov,D,CAR,33,82,7,23,30
34,8481014,Alexander Romanov,D,NYI,24,82,4,26,30
34,8480281,Alexey Toropchenko,R,STL,25,82,18,11,29
34,8477952,Robby Fabbri,C,ANA,28,82,17,12,29
34,8476918,Jimmy Vesey,L,NYR,31,82,15,14,29
34,8477450,Jason Dickinson,C,CHI,29,82,13,16,29
34,8482803,Olen Zellweger,D,ANA,21,82,10,19,29
34,8477406,Mattias Janmark,C,EDM,32,82,9,20,29
34,8480043,Timothy Liljegren,D,TOR,25,82,6,23,29
34,8476463,Jonas Brodin,D,MIN,31,82,6,23,29
34,8476892,Colton Parayko,D,STL,31,82,5,24,29
34,8479371,Dante Fabbro,D,NSH,26,82,1,28,29
34,8483431,Logan Cooley,C,UTA,20,82,18,10,28
34,8482259,Bobby McMann,C,TOR,28,82,17,11,28
34,8480003,Jesper Boqvist,C,FLA,26,82,14,14,28
34,8484203,Bradly Nadeau,L,CAR,19,82,12,16,28
34,8475231,Casey Cizikas,C,NYI,33,82,12,16,28
34,8482133,Thomas Bordeleau,C,SJS,22,82,12,16,28
34,8480995,Pontus Holmberg,R,TOR,25,82,11,17,28
34,8478911,Matt Roy,D,WSH,29,82,11,17,28
34,8476438,Brandon Saad,L,STL,32,82,10,18,28
34,8479591,Michael Eyssimont,C,TBL,28,82,9,19,28
34,8482122,Brock Faber,D,MIN,22,82,8,20,28
34,8480073,Erik Brannstrom,D,COL,25,82,7,21,28
34,8482074,Connor Zary,C,CGY,23,82,7,21,28
34,8482142,Jamie Drysdale,D,PHI,22,82,6,22,28
34,8476525,Colin Miller,D,WPG,32,82,5,23,28
34,8482655,J.J. Moser,D,TBL,24,82,5,23,28
34,8475233,David Savard,D,MTL,34,82,3,25,28
34,8479976,Juuso Valimaki,D,UTA,26,82,1,27,28
34,8478500,Ivan Provorov,D,CBJ,27,82,1,27,28
34,8481093,Rafael Harvey-Pinard,L,MTL,25,82,16,11,27
34,8484153,Leo Carlsson,C,ANA,20,82,13,14,27
34,8470621,Corey Perry,R,EDM,39,82,13,14,27
34,8481032,Paul Cotter,C,NJD,25,82,11,16,27
34,8476897,Oskar Sundqvist,C,STL,30,82,9,18,27
34,8477508,Curtis Lazar,C,NJD,29,82,7,20,27
34,8476902,Esa Lindell,D,DAL,30,82,4,23,27
34,8475188,Brayden McNabb,D,VGK,33,82,3,24,27
34,8482077,Dylan Holloway,L,EDM,23,82,19,7,26
34,8482079,Marco Rossi,C,MIN,23,82,15,11,26
34,8476474,Stefan Noesen,R,NJD,31,82,12,14,26
34,8482117,Lukas Reichel,L,CHI,22,82,11,15,26
34,8477903,Garnet Hathaway,R,PHI,33,82,11,15,26
34,8476927,Teddy Blueger,C,VAN,30,82,10,16,26
34,8475220,Marcus Foligno,L,MIN,33,82,10,16,26
34,8482175,JJ Peterka,R,BUF,22,82,9,17,26
34,8477392,Hudson Fasching,R,NYI,29,82,8,18,26
34,8477507,Nikita Zadorov,D,BOS,29,82,5,21,26
34,8475324,Nick Jensen,D,OTT,34,82,5,21,26
34,8482245,Artem Zub,D,OTT,29,82,4,22,26
34,8480246,Nick Perbix,D,TBL,26,82,3,23,26
34,8481704,Juuso Parssinen,C,NSH,23,82,16,9,25
34,8480855,Jack McBain,C,UTA,24,82,12,13,25
34,8475848,Brendan Gallagher,R,MTL,32,82,10,15,25
34,8482624,Daniil Miromanov,D,CGY,27,82,9,16,25
34,8480074,Alexandre Texier,C,STL,25,82,8,17,25
34,8480980,Connor Dewar,C,TOR,25,82,8,17,25
34,8475842,Sam Carrick,C,NYR,32,82,8,17,25
34,8481553,Bobby Brink,R,PHI,23,82,8,17,25
34,8476457,Adam Larsson,D,SEA,32,82,7,18,25
34,8475855,Jesper Fast,R,CAR,33,82,11,13,24
34,8477425,Miles Wood,L,COL,29,82,10,14,24
34,8482166,Shakir Mukhamadullin,D,SJS,22,82,8,16,24
34,8483482,Tristan Luneau,D,ANA,20,82,8,16,24
34,8474574,Tyler Myers,D,VAN,34,82,6,18,24
34,8482809,Jackson Blake,R,CAR,21,82,6,18,24
34,8480878,Nils Lundkvist,D,DAL,24,82,5,19,24
34,8476312,Josh Manson,D,COL,33,82,5,19,24
34,8481178,Egor Zamula,D,PHI,24,82,4,20,24
34,8480049,Dylan Samberg,D,WPG,25,82,3,21,24
34,8480035,Henri Jokiharju,D,BUF,25,82,2,22,24
34,8477845,Trevor van Riemsdyk,D,WSH,33,82,1,23,24
34,8476374,Sean Kuraly,C,CBJ,31,82,15,8,23
34,8483457,Lane Hutson,D,MTL,20,82,11,12,23
34,8476878,Zemgus Girgensons,L,TBL,30,82,11,12,23
34,8475343,Nic Dowd,C,WSH,34,82,10,13,23
34,8481606,Jordan Spence,D,LAK,23,82,9,14,23
34,8478569,Noel Acciari,C,PIT,33,82,9,14,23
34,8482062,Cole Smith,L,NSH,29,82,6,17,23
34,8483471,Brad Lambert,C,WPG,31,82,6,17,23
34,8475181,Nick Leddy,D,STL,33,82,5,18,23
34,8478507,John Marino,D,UTA,27,82,4,19,23
34,8476879,Cody Ceci,D,EDM,31,82,4,19,23
34,8480807,Mattias Samuelsson,D,BUF,24,82,4,19,23
34,8483490,Pavel Mintyukov,D,ANA,21,82,3,20,23
34,8478443,Brandon Carlo,D,BOS,28,82,2,21,23
34,8478211,Dryden Hunt,L,CGY,29,82,13,9,22
34,8481601,Simon Holmstrom,R,NYI,23,82,11,11,22
34,8481580,Connor McMichael,C,WSH,23,82,11,11,22
34,8479983,Mario Ferraro,D,SJS,26,82,7,15,22
34,8480025,MacKenzie Entwistle,R,FLA,25,82,5,17,22
34,8476917,Adam Pelech,D,NYI,30,82,3,19,22
34,8475455,Brenden Dillon,D,NJD,34,82,0,22,22
34,8479414,Nathan Bastian,R,NJD,27,82,14,7,21
34,8477353,Tyler Motte,C,DET,29,82,12,9,21
34,8482659,Josh Doan,R,UTA,22,82,12,9,21
34,8481582,Nicholas Robertson,L,TOR,23,82,9,12,21
34,8479291,Kevin Rooney,C,CGY,31,82,7,14,21
34,8478468,Jeremy Lauzon,D,NSH,27,82,7,14,21
34,8475279,Ben Chiarot,D,DET,33,82,5,16,21
34,8476467,Jamie Oleksiak,D,SEA,32,82,5,16,21
34,8478432,Christian Fischer,R,DET,27,82,5,16,21
34,8478178,Darren Raddysh,D,TBL,28,82,4,17,21
34,8479369,Andrew Peeke,D,BOS,26,82,3,18,21
34,8482073,Braden Schneider,D,NYR,23,82,3,18,21
34,8482702,Logan Stankoven,C,DAL,21,82,11,9,20
34,8482679,Matt Coronato,R,CGY,22,82,10,10,20
34,8482666,Scott Morrow,D,CAR,22,82,9,11,20
34,8483763,Maksymilian Szuber,D,UTA,22,82,6,14,20
34,8481522,Peyton Krebs,C,BUF,23,82,6,14,20
34,8482470,Ilya Solovyov,D,CGY,24,82,6,14,20
34,8474567,Zach Bogosian,D,MIN,34,82,5,15,20
34,8480796,Martin Fehervary,D,WSH,25,82,4,16,20
34,8474673,TJ Brodie,D,CHI,34,82,4,16,20
34,8478416,Erik Cernak,D,TBL,27,82,4,16,20
34,8476891,Matt Grzelcyk,D,PIT,30,82,3,17,20
34,8483565,Nick Blankenburg,D,NSH,26,82,3,17,20
34,8480879,Jacob Bernard-Docker,D,OTT,24,82,3,17,20
34,8478851,Alexandre Carrier,D,NSH,28,82,2,18,20
34,8479359,Beck Malenstyn,L,BUF,26,82,10,9,19
34,8483524,Shane Wright,C,SEA,20,82,9,10,19
34,8482762,Simon Edvinsson,D,DET,21,82,8,11,19
34,8478463,Anthony Beauvillier,L,PIT,27,82,7,12,19
34,8477931,Tomas Nosek,L,FLA,32,82,7,12,19
34,8483499,Liam Ohgren,L,MIN,20,82,7,12,19
34,8484149,Gavin Brindley,C,CBJ,20,82,6,13,19
34,8482101,Danil Gushchin,L,SJS,22,82,6,13,19
34,8479398,Samuel Girard,D,COL,26,82,5,14,19
34,8477839,Conor Sheary,L,TBL,32,82,5,14,19
34,8481708,Zac Jones,D,NYR,24,82,3,16,19
34,8478840,Will Borgen,D,SEA,28,82,3,16,19
34,8478136,Jake Middleton,D,MIN,28,82,2,17,19
34,8480950,Ilya Lyubushkin,D,DAL,30,82,2,17,19
34,8477365,Connor Clifton,D,BUF,29,82,2,17,19
34,8479324,Ryan Lindgren,D,NYR,26,82,1,18,19
34,8476624,Barclay Goodrow,C,SJS,31,82,7,11,18
34,8482733,Logan Mailloux,D,MTL,31,82,6,12,18
34,8481122,Simon Benoit,D,TOR,26,82,5,13,18
34,8478450,Parker Wotherspoon,D,BOS,27,82,5,13,18
34,8481567,Henry Thrun,D,SJS,23,82,3,15,18
34,8478882,Vladislav Gavrikov,D,LAK,29,82,2,16,18
34,8479661,Tanner Jeannot,L,LAK,27,82,2,16,18
34,8480172,Jan Rutta,D,SJS,34,82,2,16,18
34,8479402,Jake Bean,D,CGY,26,82,2,16,18
34,8477034,Jaycob Megna,D,FLA,32,82,2,16,18
34,8480222,Sebastian Aho,D,PIT,28,82,1,17,18
34,8478399,Jonas Siegenthaler,D,NJD,27,82,1,17,18
34,8480448,Parker Kelly,L,COL,25,82,9,8,17
34,8476889,Radek Faksa,C,STL,30,82,7,10,17
34,8481699,Aku Raty,R,UTA,23,82,7,10,17
34,8482807,Ethan Del Mastro,D,CHI,21,82,6,11,17
34,8478859,Niko Mikkola,D,FLA,28,82,6,11,17
34,8481028,Martin Pospisil,C,CGY,25,82,6,11,17
34,8474090,Brendan Smith,D,DAL,35,82,5,12,17
34,8477015,Connor Brown,R,EDM,30,82,5,12,17
34,8479998,Mikey Anderson,D,LAK,25,82,5,12,17
34,8477369,Carson Soucy,D,VAN,30,82,5,12,17
34,8482516,Matthew Kessel,D,STL,24,82,5,12,17
34,8470600,Ryan Suter,D,STL,39,82,3,14,17
34,8476442,Matt Nieto,L,PIT,32,82,11,5,16
34,8479576,Vincent Desharnais,D,VAN,28,82,7,9,16
34,8477499,Rasmus Ristolainen,D,PHI,30,82,6,10,16
34,8478013,Jake Walman,D,SJS,28,82,6,10,16
34,8483493,Frank Nazar,C,CHI,20,82,6,10,16
34,8483468,Jiri Kulich,C,BUF,20,82,5,11,16
34,8477435,Ryan Graves,D,PIT,29,82,4,12,16
34,8475462,Radko Gudas,D,ANA,34,82,1,15,16
34,8476429,Scott Mayfield,D,NYI,32,82,1,15,16
34,8482155,Alex Laferriere,R,LAK,23,82,10,5,15
34,8477505,Alexander Wennberg,C,SJS,30,82,10,5,15
34,8481477,Nico Sturm,C,SJS,29,82,9,6,15
34,8482153,Brendan Brisson,C,VGK,23,82,9,6,15
34,8483012,Logan Morrison,C,SEA,22,82,9,6,15
34,8482141,Lukas Cormier,D,VGK,22,82,8,7,15
34,8473453,Trevor Lewis,C,LAK,37,82,7,8,15
34,8481517,Brett Leason,R,ANA,25,82,7,8,15
34,8478434,Keegan Kolesar,R,VGK,27,82,6,9,15
34,8481641,Joel Kiviranta,L,COL,28,82,6,9,15
34,8482087,Kaiden Guhle,D,MTL,22,82,5,10,15
34,8481524,Bowen Byram,D,BUF,23,82,5,10,15
34,8479442,Troy Stecher,D,EDM,30,82,5,10,15
34,8483445,Cutter Gauthier,L,ANA,20,82,5,10,15
34,8483460,David Jiricek,D,CBJ,21,82,3,12,15
34,8479980,Nicolas Hague,D,VGK,26,82,1,14,15
34,8476822,Luke Glendening,C,TBL,35,82,11,3,14
34,8476967,Brett Kulak,D,EDM,30,82,4,10,14
34,8475177,Calvin de Haan,D,COL,33,82,4,10,14
34,8482859,Zack Ostapchuk,C,OTT,21,82,2,12,14
34,8475690,Chris Tanev,D,TOR,35,82,1,13,14
34,8474013,Ian Cole,D,UTA,35,82,1,13,14
34,8484145,Zach Benson,L,BUF,19,82,7,6,13
34,8480021,Jack Studnicka,C,LAK,25,82,7,6,13
34,8482145,Mavrik Bourque,C,DAL,22,82,7,6,13
34,8479638,Justin Brazeau,R,BOS,26,82,7,6,13
34,8482749,Joshua Roy,R,MTL,21,82,6,7,13
34,8483505,Matthew Poitras,C,BOS,20,82,5,8,13
34,8480990,Declan Chisholm,D,MIN,24,82,5,8,13
34,8477335,Kyle Burroughs,D,LAK,29,82,5,8,13
34,8480834,Ty Emberson,D,SJS,24,82,2,11,13
34,8478874,Adam Gaudette,C,OTT,28,82,2,11,13
34,8480870,Bo Groulx,C,NYR,24,82,5,7,12
34,8481568,Alex Vlasic,D,CHI,23,82,3,9,12
34,8483489,Fraser Minten,C,TOR,31,82,3,9,12
34,8482713,Mackie Samoskevich,R,FLA,22,82,3,9,12
34,8471677,Jack Johnson,D,CBJ,37,82,2,10,12
34,8476372,Nick Seeler,D,PHI,31,82,1,11,12
34,8475762,Derek Forbort,D,VAN,32,82,1,11,12
34,8476473,Connor Murphy,D,CHI,31,82,1,11,12
34,8482118,Sam Colangelo,R,ANA,23,82,5,6,11
34,8482858,Ryker Evans,D,SEA,23,82,4,7,11
34,8483567,Georgii Merkulov,C,BOS,24,82,4,7,11
34,8480860,Kevin Bahl,D,CGY,24,82,1,10,11
34,8475718,Justin Holl,D,DET,32,82,0,11,11
34,8483397,Marc McLaughlin,C,BOS,25,82,7,3,10
34,8476858,Phillip Di Giuseppe,L,VAN,31,82,4,6,10
34,8477938,Haydn Fleury,D,WPG,28,82,3,7,10
34,8484911,Collin Graf,R,SJS,22,82,3,7,10
34,8476441,Joel Edmundson,D,LAK,31,82,2,8,10
34,8481605,Jackson LaCombe,D,ANA,23,82,2,7,9
34,8474612,Travis Hamonic,D,OTT,34,82,1,8,9
34,8483466,Kevin Korchinski,D,CHI,20,82,0,9,9
34,8482070,Mitchell Chaffee,R,TBL,26,82,5,2,7
34,8474062,Riley Nash,C,NYR,35,82,4,3,7
34,8482712,Oskar Olausson,R,COL,22,82,3,4,7
34,8482787,Nikita Chibrikov,R,WPG,31,82,1,6,7
34,8475790,Erik Gudbranson,D,CBJ,32,82,0,7,7
34,8470794,Joe Pavelski,C,,40,0,0,0,0
34,8481703,Valtteri Puustinen,R,PIT,25,0,0,0,0
34,8477950,Tony DeAngelo,D,,29,0,0,0,0
34,8481577,Philip Tomasino,C,NSH,23,0,0,0,0
34,8475197,Tyson Barrie,D,,33,0,0,0,0
34,8471218,Blake Wheeler,R,,38,0,0,0,0
34,8474157,Max Pacioretty,L,,36,0,0,0,0
34,8478466,Daniel Sprong,R,VAN,27,0,0,0,0
34,8475744,Evgeny Kuznetsov,C,,32,0,0,0,0
34,8481019,David Gustafsson,C,WPG,24,0,0,0,0
34,8475906,John Klingberg,D,,32,0,0,0,0
34,8479348,Kale Clague,D,BUF,26,0,0,0,0
34,8476952,Dominic Toninato,C,WPG,30,0,0,0,0
34,8473473,Milan Lucic,L,,36,0,0,0,0
34,8474037,James van Riemsdyk,L,,35,0,0,0,0
34,8474602,Justin Schultz,D,,34,0,0,0,0
34,8482222,Alexander Barabanov,L,,30,0,0,0,0
34,8479372,Josh Mahura,D,SEA,26,0,0,0,0
34,8479982,Conor Timmins,D,TOR,26,0,0,0,0
34,8474031,Kevin Shattenkirk,D,,35,0,0,0,0
34,8480008,Adam Ruzicka,C,,25,0,0,0,0
34,8481059,Scott Perunovich,D,STL,26,0,0,0,0
34,8480884,Calen Addison,D,,24,0,0,0,0
34,8476994,Vinnie Hinostroza,C,NSH,30,0,0,0,0
34,8478452,Caleb Jones,D,LAK,27,0,0,0,0
34,8480157,Calle Rosen,D,COL,30,0,0,0,0
34,8481609,Vladislav Kolyachonok,D,UTA,23,0,0,0,0
34,8479415,Michael McLeod,C,,26,0,0,0,0
34,8476919,Chris Tierney,C,,30,0,0,0,0
34,8479639,Dylan Coghlan,D,WPG,26,0,0,0,0
34,8478146,Matthew Highmore,C,OTT,28,0,0,0,0
34,8478970,Jalen Chatfield,D,CAR,28,0,0,0,0
34,8480205,Emil Bemstrom,C,PIT,25,0,0,0,0
34,8474884,Mike Hoffman,C,,35,0,0,0,0
34,8471274,Alex Goligoski,D,,39,0,0,0,0
34,8478104,Sammy Blais,L,,28,0,0,0,0
34,8474870,Tyler Johnson,C,,34,0,0,0,0
34,8476913,Devin Shore,C,MIN,30,0,0,0,0
34,8481598,Philip Broberg,D,EDM,23,0,0,0,0
34,8480058,Pierre-Olivier Joseph,D,STL,25,0,0,0,0
34,8480891,Michael Kesselring,D,UTA,24,0,0,0,0
34,8477979,Nicolas Aube-Kubel,R,BUF,28,0,0,0,0
34,8476871,Tanner Pearson,L,,32,0,0,0,0
34,8476393,Nick Cousins,C,,31,0,0,0,0
34,8479977,Kailer Yamamoto,R,,26,0,0,0,0
34,8479543,Michael Pezzetta,L,MTL,26,0,0,0,0
34,8477018,Ben Hutton,D,VGK,31,0,0,0,0
34,8480762,Eric Robinson,L,CAR,29,0,0,0,0
34,8474034,Pat Maroon,L,CHI,36,0,0,0,0
34,8481058,Jesse Ylönen,R,,25,0,0,0,0
34,8475179,Dmitry Kulikov,D,FLA,34,0,0,0,0
34,8481527,Kaedan Korczak,D,VGK,23,0,0,0,0
34,8473449,Kyle Okposo,R,,36,0,0,0,0
34,8482192,Isaak Phillips,D,CHI,23,0,0,0,0
34,8480727,Zach Whitecloud,D,VGK,28,0,0,0,0
34,8479346,Dillon Dube,C,,26,0,0,0,0
34,8480821,Filip Zadina,R,,25,0,0,0,0
34,8480001,Urho Vaakanainen,D,ANA,25,0,0,0,0
34,8470966,Mark Giordano,D,,41,0,0,0,0
34,8480853,Liam Foudy,C,,24,0,0,0,0
34,8475225,Craig Smith,C,CHI,35,0,0,0,0
34,8479972,Mason Shaw,C,WPG,26,0,0,0,0
34,8478451,Ethan Bear,D,WSH,27,0,0,0,0
34,8474040,Sam Gagner,C,,35,0,0,0,0
34,8480196,Jacob Bryson,D,BUF,27,0,0,0,0
34,8479984,Cal Foote,D,,26,0,0,0,0
34,8480011,Klim Kostin,C,SJS,25,0,0,0,0
34,8482176,Wyatt Kaiser,D,CHI,22,0,0,0,0
34,8476988,Matt Benning,D,SJS,30,0,0,0,0
34,8479370,Tyson Jost,C,CAR,26,0,0,0,0
34,8477464,Nic Petan,C,,29,0,0,0,0
34,8477380,Jonny Brodzinski,C,NYR,31,0,0,0,0
34,8480070,Ian Mitchell,D,BOS,25,0,0,0,0
34,8479315,Joey Anderson,R,CHI,26,0,0,0,0
34,8478099,Kevin Labanc,R,,29,0,0,0,0
34,8476874,Olli Maatta,D,DET,30,0,0,0,0
34,8475208,Brian Dumoulin,D,ANA,33,0,0,0,0
34,8478430,Oliver Kylington,D,,27,0,0,0,0
34,8479536,Axel Jonsson-Fjallby,L,WPG,26,0,0,0,0
34,8479671,Mathieu Olivier,R,CBJ,27,0,0,0,0
34,8471709,Marc-Edouard Vlasic,D,SJS,37,0,0,0,0
34,8479328,Julien Gauthier,R,NYI,27,0,0,0,0
34,8478421,A.J. Greer,L,FLA,28,0,0,0,0
34,8477573,Nathan Walker,L,STL,30,0,0,0,0
34,8481537,Nikita Okhotiuk,D,CGY,24,0,0,0,0
34,8474166,Alec Martinez,D,CHI,37,0,0,0,0
34,8470610,Zach Parise,L,,40,0,0,0,0
34,8477478,William Carrier,L,CAR,30,0,0,0,0
34,8479344,Jesse Puljujarvi,R,PIT,26,0,0,0,0
34,8480887,Jordan Harris,D,MTL,24,0,0,0,0
34,8478502,Dennis Gilbert,D,BUF,28,0,0,0,0
34,8482730,Brandt Clarke,D,LAK,21,0,0,0,0
34,8480355,Mark Kastelic,C,BOS,25,0,0,0,0
34,8475750,Jon Merrill,D,MIN,32,0,0,0,0
34,8475164,Jakob Silfverberg,R,,34,0,0,0,0
34,8477944,Jakub Vrana,L,,28,0,0,0,0
34,8479439,Jacob MacDonald,D,COL,31,0,0,0,0
34,8474568,Luke Schenn,D,NSH,35,0,0,0,0
34,8478454,Noah Juulsen,D,VAN,27,0,0,0,0
34,8475752,Tyler Pitlick,C,,33,0,0,0,0
34,8482148,Hendrix Lapierre,C,WSH,22,0,0,0,0
34,8481167,Brayden Pachal,D,CGY,25,0,0,0,0
34,8478043,Sam Lafferty,C,BUF,29,0,0,0,0
34,8479321,Lucas Johansen,D,,27,0,0,0,0
34,8471699,Andrew Cogliano,C,,37,0,0,0,0
34,8481521,Ronnie Attard,D,PHI,25,0,0,0,0
34,8481161,Jake Christiansen,D,CBJ,25,0,0,0,0
34,8479458,Nikita Zaitsev,D,,33,0,0,0,0
34,8479619,Michael Carcone,L,UTA,28,0,0,0,0
34,8479026,Philippe Myers,D,TOR,27,0,0,0,0
34,8477330,Dominik Kubalik,L,,29,0,0,0,0
34,8481617,Vasily Podkolzin,R,VAN,23,0,0,0,0
34,8481701,Santeri Hatakka,D,NJD,23,0,0,0,0
34,8479514,Rem Pitlick,C,,27,0,0,0,0
34,8477446,Michael McCarron,R,NSH,29,0,0,0,0
34,8470604,Jeff Carter,C,,39,0,0,0,0
34,8482241,Radim Zohorna,L,,28,0,0,0,0
34,8480289,Morgan Barron,C,WPG,26,0,0,0,0
34,8479379,Givani Smith,R,SJS,26,0,0,0,0
34,8480216,Jacob Peterson,C,,25,0,0,0,0
34,8477851,Jordan Oesterle,D,BOS,32,0,0,0,0
34,8484258,Sam Malinski,D,COL,26,0,0,0,0
34,8478904,Steven Lorentz,C,,28,0,0,0,0
34,8482095,Tyler Kleven,D,OTT,22,0,0,0,0
34,8480848,Ty Dellandrea,C,SJS,24,0,0,0,0
34,8476884,Derrick Pouliot,D,,30,0,0,0,0
34,8479336,Carl Grundstrom,R,SJS,27,0,0,0,0
34,8482964,Arber Xhekaj,D,MTL,23,0,0,0,0
34,8471686,Marc Staal,D,,37,0,0,0,0
34,8477887,Patrick Brown,C,BOS,32,0,0,0,0
34,8478495,Denis Gurianov,R,,27,0,0,0,0
34,8473504,Cal Clutterbuck,R,,37,0,0,0,0
34,8481550,Adam Beckman,L,NJD,23,0,0,0,0
34,8480845,Rasmus Kupari,C,WPG,24,0,0,0,0
34,8474009,Nick Bonino,C,,36,0,0,0,0
34,8478585,Derek Ryan,C,EDM,38,0,0,0,0
34,8477962,Brendan Lemieux,L,CAR,28,0,0,0,0
34,8482861,Vincent Iorio,D,WSH,22,0,0,0,0
34,8479378,Logan Stanley,D,WPG,26,0,0,0,0
34,8473446,Erik Johnson,D,PHI,36,0,0,0,0
34,8481743,Marc Del Gaizo,D,NSH,25,0,0,0,0
34,8477384,Josh Brown,D,EDM,30,0,0,0,0
34,8482165,Yan Kuznetsov,D,CGY,22,0,0,0,0
34,8478424,Jansen Harkins,C,ANA,27,0,0,0,0
34,8482144,Jack Thompson,D,SJS,22,0,0,0,0
34,8478512,Austin Czarnik,C,,32,0,0,0,0
34,8477527,Ross Johnston,L,ANA,30,0,0,0,0
34,8479383,Boris Katchouk,L,,26,0,0,0,0
34,8482094,Daemon Hunt,D,MIN,22,0,0,0,0
34,8481719,Maxwell Crozier,D,TBL,24,0,0,0,0
34,8480192,Johnathan Kovacevic,D,NJD,27,0,0,0,0
34,8479376,Victor Mete,D,,26,0,0,0,0
34,8482511,Mason Lohrei,D,BOS,23,0,0,0,0
34,8475825,Jani Hakanpää,D,,32,0,0,0,0
34,8478021,William Lagesson,D,DET,28,0,0,0,0
34,8475795,Dylan McIlrath,D,WSH,32,0,0,0,0
34,8477846,Ryan Carpenter,C,,33,0,0,0,0
34,8481056,Spencer Stastney,D,NSH,24,0,0,0,0
34,8481564,Ryan Johnson,D,BUF,23,0,0,0,0
34,8478017,Mark Friedman,D,VAN,29,0,0,0,0
34,8479320,Max Lajoie,D,SEA,27,0,0,0,0
34,8480075,Cameron Crotty,D,MIN,25,0,0,0,0
34,8484287,Cole McWard,D,VAN,23,0,0,0,0
34,8484254,Akito Hirose,D,VAN,25,0,0,0,0
34,8483407,Brandon Scanlin,D,NYR,25,0,0,0,0
34,8480274,Philip Kemp,D,EDM,25,0,0,0,0
34,8479522,Hardy Haman Aktell,D,WSH,26,0,0,0,0
34,8480007,Jonas Rondbjerg,R,VGK,25,0,0,0,0
34,8477454,Adam Erne,L,,29,0,0,0,0
34,8481679,Maxence Guenette,D,OTT,23,0,0,0,0
34,8480441,Trey Fix-Wolansky,R,CBJ,25,0,0,0,0
34,8483546,Marshall Rifai,D,TOR,26,0,0,0,0
34,8480084,Nick DeSimone,D,NJD,30,0,0,0,0
34,8481030,Jack St. Ivany,D,PIT,25,0,0,0,0
34,8481592,Jakob Pelletier,L,CGY,23,0,0,0,0
34,8478011,Louie Belpedio,D,PHI,28,0,0,0,0
34,8477930,Pierre-Edouard Bellemare,L,,39,0,0,0,0
34,8484321,Nikolas Matinpalo,D,OTT,26,0,0,0,0
34,8482067,Connor Mackey,D,NYR,28,0,0,0,0
34,8481806,Louis Crevier,D,CHI,23,0,0,0,0
34,8484326,Patrik Koch,D,UTA,28,0,0,0,0
34,8477971,Andreas Englund,D,LAK,28,0,0,0,0
34,8481751,Lukas Rousek,R,BUF,25,0,0,0,0
34,8481006,Tyler Tucker,D,STL,24,0,0,0,0
34,8476867,Brendan Gaunce,C,MIN,30,0,0,0,0
34,8479520,Brandon Duhaime,R,WSH,27,0,0,0,0
34,8477073,Kurtis MacDermid,L,NJD,30,0,0,0,0
34,8480874,Adam Ginning,D,PHI,24,0,0,0,0
34,8477473,Justin Bailey,R,SJS,29,0,0,0,0
34,8479066,Ryan Lomberg,L,CGY,30,0,0,0,0
34,8477070,Liam O'Brien,C,UTA,30,0,0,0,0
34,8474618,Marco Scandella,D,,34,0,0,0,0
34,8475797,Jarred Tinordi,D,,32,0,0,0,0
34,8481441,Joe Snively,C,DET,28,0,0,0,0
34,8477244,Chad Ruhwedel,D,NYR,34,0,0,0,0
34,8479772,Zack MacEwen,R,OTT,28,0,0,0,0
34,8481147,Reese Johnson,C,MIN,26,0,0,0,0
34,8481043,Cole Koepke,L,BOS,26,0,0,0,0
34,8483619,Filip Roos,D,OTT,25,0,0,0,0
34,8481541,Samuel Bolduc,D,NYI,24,0,0,0,0
34,8477810,Joel Hanley,D,CGY,33,0,0,0,0
34,8476907,Mackenzie MacEachern,L,,30,0,0,0,0
34,8482652,Walker Duehr,R,CGY,27,0,0,0,0
34,8477126,Jayson Megna,C,,34,0,0,0,0
34,8483398,Declan Carlile,D,TBL,31,0,0,0,0
34,8482929,Emil Lilleberg,D,TBL,23,0,0,0,0
34,8480880,Jakub Lauko,C,MIN,24,0,0,0,0
34,8480245,Olle Lycksell,R,PHI,25,0,0,0,0
34,8480252,Cole Guttman,C,CHI,25,0,0,0,0
34,8477467,Gustav Olofsson,D,SEA,30,0,0,0,0
34,8479968,Vinni Lettieri,C,BOS,29,0,0,0,0
34,8478400,Colin White,C,,27,0,0,0,0
34,8475755,Alexander Petrovic,D,DAL,32,0,0,0,0
34,8481812,Nikolai Knyzhov,D,,27,0,0,0,0
34,8481593,Jayden Struble,D,MTL,23,0,0,0,0
34,8481532,Alex Turcotte,C,LAK,23,0,0,0,0
34,8482126,Emil Andrae,D,PHI,31,0,0,0,0
34,8479944,Zach Aston-Reese,C,VGK,30,0,0,0,0
34,8471817,Ryan Reaves,R,TOR,37,0,0,0,0
34,8481206,John Ludvig,D,PIT,24,0,0,0,0
34,8481599,Victor Soderstrom,D,UTA,23,0,0,0,0
34,8480292,Carson Meyer,R,ANA,27,0,0,0,0
34,8482496,Nils Aman,C,VAN,24,0,0,0,0
34,8479718,Alex Barré-Boulet,C,MTL,27,0,0,0,0
34,8479994,Jaret Anderson-Dolan,C,WPG,25,0,0,0,0
34,8480184,Gustav Lindstrom,D,,26,0,0,0,0
34,8480890,Jan Jenik,R,OTT,24,0,0,0,0
34,8478067,Oskar Lindblom,L,,28,0,0,0,0
34,8476934,Brock McGinn,L,ANA,30,0,0,0,0
34,8479985,Cale Fleury,D,SEA,26,0,0,0,0
34,8484304,Uvis Balinskis,D,FLA,28,0,0,0,0
34,8479981,Jonah Gadjovich,L,FLA,26,0,0,0,0
34,8481716,Dmitri Voronkov,L,CBJ,24,0,0,0,0
34,8474709,Matt Martin,L,,35,0,0,0,0
34,8482634,Alex Steeves,C,TOR,25,0,0,0,0
34,8480823,Alexander Alexeyev,D,WSH,25,0,0,0,0
34,8477541,Dakota Mermis,D,TOR,30,0,0,0,0
34,8483491,Ivan Miroshnichenko,L,WSH,20,0,0,0,0
34,8478477,Mitchell Stephens,C,SEA,27,0,0,0,0
34,8481543,Nikita Alexandrov,C,STL,24,0,0,0,0
34,8479423,Alex Nylander,L,,26,0,0,0,0
34,8482451,Mikael Pyyhtia,L,CBJ,23,0,0,0,0
34,8478831,Kevin Stenlund,C,UTA,28,0,0,0,0
34,8480306,Grant Hutton,D,NYI,29,0,0,0,0
34,8478028,Fredrik Olofsson,L,,28,0,0,0,0
34,8477462,Robert Hagg,D,VGK,29,0,0,0,0
34,8477320,Anton Blidh,L,NYR,29,0,0,0,0
34,8482157,Will Cuylle,L,NYR,22,0,0,0,0
34,8482737,Zack Bolduc,C,STL,21,0,0,0,0
34,8481239,Samuel Fagemo,L,,24,0,0,0,0
34,8481600,Tobias Bjornfot,D,FLA,23,0,0,0,0
34,8478409,Anthony Richard,C,PHI,28,0,0,0,0
34,8474145,Robert Bortuzzo,D,,35,0,0,0,0
34,8475958,Michael Sgarbossa,C,WSH,32,0,0,0,0
34,8479986,Kole Lind,R,DAL,26,0,0,0,0
34,8479249,Andrew Poturalski,C,SJS,30,0,0,0,0
34,8479362,Riley Tufte,L,BOS,26,0,0,0,0
34,8479991,Jake Leschyshyn,C,NYR,25,0,0,0,0
34,8479587,Rhett Gardner,C,PHI,28,0,0,0,0
34,8482744,James Malatesta,L,CBJ,21,0,0,0,0
34,8478854,Ryan Shea,D,PIT,27,0,0,0,0
34,8481591,Sam Poulin,R,,23,0,0,0,0
34,8483512,Matt Savoie,C,EDM,20,0,0,0,0
34,8482102,Vasily Ponomarev,C,PIT,22,0,0,0,0
34,8482162,Roby Jarventie,L,EDM,22,0,0,0,0
34,8481016,Ruslan Iskhakov,C,,24,0,0,0,0
34,8482172,Landon Slaggert,L,CHI,22,0,0,0,0
34,8482747,Brennan Othmann,L,NYR,21,0,0,0,0
34,8480031,Maxime Comtois,L,,25,0,0,0,0
34,8480226,Marián Studenic,R,,26,0,0,0,0
34,8478408,Travis Dermott,D,,28,0,0,0,0
34,8481518,Nolan Foote,L,NJD,24,0,0,0,0
34,8479419,Brett Murray,L,BUF,26,0,0,0,0
34,8482088,Justin Sourdif,R,FLA,22,0,0,0,0
34,8482201,Gage Goncalves,C,TBL,23,0,0,0,0
34,8481578,Graeme Clarke,R,MIN,23,0,0,0,0
34,8482177,Marat Khusnutdinov,C,MIN,22,0,0,0,0
34,8481754,Nikita Nesterenko,C,ANA,23,0,0,0,0
34,8483531,Brian Halonen,L,NJD,25,0,0,0,0
34,8483920,Pierrick Dube,R,WSH,23,0,0,0,0
34,8480851,Akil Thomas,C,LAK,24,0,0,0,0
34,8475235,Nicolas Deslauriers,L,PHI,33,0,0,0,0
34,8482476,Emil Heineman,L,MTL,23,0,0,0,0
34,8477149,Scott Sabourin,R,SJS,32,0,0,0,0
34,8483549,Lucas Condotta,L,MTL,27,0,0,0,0
34,8482765,Isak Rosen,R,BUF,21,0,0,0,0
34,8481237,Kyle MacLean,C,NYI,25,0,0,0,0
34,8481024,Linus Karlsson,C,VAN,25,0,0,0,0
34,8481690,Tyler Angle,C,,24,0,0,0,0
34,8483570,Ben Meyers,C,SEA,26,0,0,0,0
34,8481655,Cole Schwindt,R,CGY,23,0,0,0,0
34,8481462,Mason Morelli,L,VGK,28,0,0,0,0
34,8483401,Marc Johnstone,R,PIT,28,0,0,0,0
34,8478956,Samuel Laberge,L,NJD,27,0,0,0,0
34,8479533,Joona Koppanen,L,,26,0,0,0,0
34,8482197,Adam Raska,R,MIN,23,0,0,0,0
34,8482250,Callahan Burke,C,VGK,27,0,0,0,0
34,8482784,Zach Dean,C,STL,21,0,0,0,0
34,8484255,Jason Polin,R,COL,25,0,0,0,0
34,8481077,John Leonard,L,,26,0,0,0,0
34,8481534,Raphael Lavoie,C,EDM,24,0,0,0,0
34,8483609,Adam Klapka,R,CGY,24,0,0,0,0
34,8482751,Ryan Winterton,C,SEA,21,0,0,0,0
34,8480267,Sammy Walker,C,MIN,25,0,0,0,0
34,8475766,Austin Watson,L,,32,0,0,0,0
34,8482460,Matt Rempe,C,NYR,22,0,0,0,0
34,8481065,Angus Crookshank,L,OTT,25,0,0,0,0
34,8481070,Hugh McGing,L,,26,0,0,0,0
34,8476323,Max McCormick,L,SEA,32,0,0,0,0
34,8483395,Arshdeep Bains,L,VAN,23,0,0,0,0
34,8484259,Ondrej Pavel,C,COL,31,0,0,0,0
34,8483432,Luca Del Bel Belluz,C,CBJ,31,0,0,0,0
34,8483045,Cameron Butler,R,CBJ,31,0,0,0,0
34,8482061,Brandon Biro,L,SEA,26,0,0,0,0
34,8477401,John Hayden,C,SEA,29,0,0,0,0
34,8475278,Byron Froese,C,,33,0,0,0,0
34,8478446,Glenn Gawdin,C,LAK,27,0,0,0,0
34,8477993,Justin Kirkland,C,CGY,28,0,0,0,0
34,8482147,Jean-Luc Foudy,C,COL,22,0,0,0,0
34,8480032,Shane Bowers,C,NJD,25,0,0,0,0
34,8479330,Brandon Gignac,C,MTL,27,0,0,0,0
34,8480776,Sheldon Rempal,R,,29,0,0,0,0
34,8475413,Justin Dowling,C,NJD,34,0,0,0,0
34,8481726,Adam Edstrom,C,NYR,24,0,0,0,0
34,8480844,Grigori Denisenko,L,VGK,24,0,0,0,0
34,8478147,Bokondji Imama,L,PIT,28,0,0,0,0
34,8478881,Brett Seney,L,CHI,28,0,0,0,0
34,8483630,Pavol Regenda,L,ANA,25,0,0,0,0
34,8480836,Jonathan Gruden,C,,24,0,0,0,0
34,8484314,Jiri Smejkal,L,,28,0,0,0,0
34,8475780,Chris Wagner,R,COL,33,0,0,0,0
34,8479546,Oskar Steen,C,,26,0,0,0,0
34,8483597,Milos Kelemen,L,UTA,25,0,0,0,0
34,8481789,Tye Kartye,L,SEA,23,0,0,0,0
34,8484325,Waltteri Merela,C,TBL,26,0,0,0,0
34,8479421,Jacob Moverare,D,LAK,26,0,0,0,0
34,8481585,Egor Afanasyev,L,SJS,23,0,0,0,0
34,8479547,Matthew Phillips,R,,26,0,0,0,0
34,8479367,William Lockwood,R,FLA,26,0,0,0,0
34,8476915,Jujhar Khaira,L,,30,0,0,0,0
34,8481422,Jacob Lucchini,C,NSH,29,0,0,0,0
34,8480468,James Hamblin,L,EDM,25,0,0,0,0
34,8478051,Max Willman,C,NJD,29,0,0,0,0
34,8481556,John Beecher,C,BOS,23,0,0,0,0
34,8478078,Rourke Chartier,C,,28,0,0,0,0
35,8481559,Jack Hughes,C,NJD,23,82,61,73,134
35,8476453,Nikita Kucherov,R,TBL,31,82,35,98,133
35,8478402,Connor McDavid,C,EDM,27,82,47,85,132
35,8477492,Nathan MacKinnon,C,COL,29,82,53,73,126
35,8479318,Auston Matthews,C,TOR,27,82,64,48,112
35,8478550,Artemi Panarin,L,NYR,33,82,34,77,111
35,8480023,Robert Thomas,C,STL,25,82,29,80,109
35,8476887,Filip Forsberg,L,NSH,30,82,41,66,107
35,8477939,William Nylander,R,TOR,28,82,52,53,105
35,8477934,Leon Draisaitl,C,EDM,29,82,42,63,105
35,8477404,Jake Guentzel,C,TBL,30,82,52,52,104
35,8479314,Matthew Tkachuk,L,FLA,27,82,35,69,104
35,8478445,Mathew Barzal,C,NYI,27,82,32,72,104
35,8480800,Quinn Hughes,D,VAN,25,82,20,84,104
35,8478864,Kirill Kaprizov,L,MIN,27,82,55,46,101
35,8477493,Aleksander Barkov,C,FLA,29,82,25,76,101
35,8475913,Mark Stone,R,VGK,32,82,34,66,100
35,8478403,Jack Eichel,C,VGK,28,82,45,54,99
35,8477956,David Pastrnak,R,BOS,28,82,39,60,99
35,8478010,Brayden Point,C,TBL,28,82,54,43,97
35,8480027,Jason Robertson,L,DAL,25,82,36,61,97
35,8476389,Vincent Trocheck,C,NYR,31,82,35,62,97
35,8478420,Mikko Rantanen,R,COL,28,82,40,56,96
35,8474600,Roman Josi,D,NSH,34,82,19,75,94
35,8479343,Clayton Keller,R,UTA,26,82,49,44,93
35,8480069,Cale Makar,D,COL,26,82,27,66,93
35,8475167,Victor Hedman,D,TBL,34,82,22,70,92
35,8477946,Dylan Larkin,C,DET,28,82,46,45,91
35,8477951,Nick Schmaltz,C,UTA,28,82,34,57,91
35,8482116,Tim Stützle,C,OTT,22,82,31,60,91
35,8479385,Jordan Kyrou,C,STL,26,82,34,56,90
35,8474564,Steven Stamkos,C,NSH,34,82,44,45,89
35,8476346,Johnny Gaudreau,L,CBJ,31,82,30,57,87
35,8477501,Valeri Nichushkin,R,COL,29,82,49,37,86
35,8476460,Mark Scheifele,C,WPG,31,82,31,55,86
35,8476459,Mika Zibanejad,C,NYR,31,82,28,58,86
35,8477933,Sam Reinhart,C,FLA,29,82,54,31,85
35,8480801,Brady Tkachuk,L,OTT,25,82,46,39,85
35,8481557,Matt Boldy,L,MIN,23,82,39,45,84
35,8480002,Nico Hischier,C,NJD,25,82,27,57,84
35,8477496,Elias Lindholm,C,BOS,30,82,36,47,83
35,8478427,Sebastian Aho,C,CAR,27,82,35,48,83
35,8474590,John Carlson,D,WSH,34,82,18,65,83
35,8475172,Nazem Kadri,C,CGY,34,82,20,62,82
35,8478440,Dylan Strome,C,WSH,27,82,37,44,81
35,8476881,Tomas Hertl,C,VGK,31,82,30,51,81
35,8473512,Claude Giroux,R,OTT,36,82,30,51,81
35,8477942,Kevin Fiala,L,LAK,28,82,26,55,81
35,8477409,Carter Verhaeghe,C,FLA,29,82,39,41,80
35,8477402,Pavel Buchnevich,L,STL,29,82,36,44,80
35,8477940,Nikolaj Ehlers,L,WPG,28,82,35,45,80
35,8477504,Josh Morrissey,D,WPG,29,82,10,70,80
35,8476853,Morgan Rielly,D,TOR,30,82,8,72,80
35,8479420,Tage Thompson,C,BUF,27,82,40,39,79
35,8478439,Travis Konecny,R,PHI,27,82,35,44,79
35,8474141,Patrick Kane,R,DET,36,82,23,56,79
35,8478444,Brock Boeser,R,VAN,27,82,33,45,78
35,8476468,J.T. Miller,C,VAN,31,82,27,51,78
35,8480012,Elias Pettersson,C,VAN,26,82,26,51,77
35,8479407,Jesper Bratt,L,NJD,26,82,25,52,77
35,8477949,Alex Tuch,R,BUF,28,82,24,53,77
35,8475753,Justin Faulk,D,STL,32,82,24,53,77
35,8471675,Sidney Crosby,C,PIT,37,82,30,46,76
35,8471685,Anze Kopitar,C,LAK,37,82,22,54,76
35,8480014,Gabriel Vilardi,C,WPG,25,82,45,30,75
35,8478449,Roope Hintz,C,DAL,28,82,41,34,75
35,8478398,Kyle Connor,L,WPG,28,82,35,40,75
35,8479323,Adam Fox,D,NYR,26,82,11,64,75
35,8480830,Andrei Svechnikov,R,CAR,24,82,38,36,74
35,8471214,Alex Ovechkin,L,WSH,39,82,35,39,74
35,8471215,Evgeni Malkin,C,PIT,38,82,32,42,74
35,8475810,Bryan Rust,R,PIT,32,82,31,43,74
35,8479675,Trevor Moore,L,LAK,29,82,30,44,74
35,8475784,Jeff Skinner,C,EDM,32,82,26,47,73
35,8478042,Viktor Arvidsson,R,EDM,31,82,25,48,73
35,8476454,Ryan Nugent-Hopkins,C,EDM,31,82,21,52,73
35,8480036,Miro Heiskanen,D,DAL,25,82,16,57,73
35,8481540,Cole Caufield,R,MTL,23,82,36,36,72
35,8478873,Troy Terry,R,ANA,27,82,22,50,72
35,8475692,Mats Zuccarello,R,MIN,37,82,19,53,72
35,8477500,Bo Horvat,C,NYI,29,82,31,40,71
35,8473419,Brad Marchand,L,BOS,36,82,23,48,71
35,8476456,Jonathan Huberdeau,C,CGY,31,82,17,54,71
35,8475184,Chris Kreider,L,NYR,33,82,45,25,70
35,8482109,Alexis Lafrenière,L,NYR,23,82,37,33,70
35,8482665,Matty Beniers,C,SEA,22,82,32,38,70
35,8480039,Martin Necas,C,CAR,25,82,34,35,69
35,8475170,Brayden Schenn,C,STL,33,82,32,37,69
35,8480208,Drake Batherson,R,OTT,26,82,29,40,69
35,8479337,Alex DeBrincat,R,DET,27,82,28,41,69
35,8475168,Matt Duchene,C,DAL,33,82,24,45,69
35,8475166,John Tavares,C,TOR,34,82,22,47,69
35,8480865,Noah Dobson,D,NYI,24,82,11,58,69
35,8475786,Zach Hyman,L,EDM,32,82,40,28,68
35,8475726,Tyler Toffoli,C,SJS,32,82,36,32,68
35,8476539,Jonathan Marchessault,R,NSH,34,82,34,34,68
35,8480839,Rasmus Dahlin,D,BUF,24,82,19,49,68
35,8477447,Shea Theodore,D,VGK,29,82,16,52,68
35,8478975,Mason Marchment,L,DAL,29,82,30,37,67
35,8481523,Kirby Dach,C,MTL,23,82,15,52,67
35,8479542,Brandon Hagel,L,TBL,26,82,29,37,66
35,8476432,Boone Jenner,C,CBJ,31,82,45,20,65
35,8479325,Charlie McAvoy,D,BOS,27,82,19,46,65
35,8474578,Erik Karlsson,D,PIT,34,82,17,48,65
35,8478038,Devon Toews,D,COL,30,82,16,49,65
35,8476483,Rickard Rakell,R,PIT,31,82,34,30,64
35,8482093,Seth Jarvis,C,CAR,22,82,31,33,64
35,8478493,Joel Eriksson Ek,C,MIN,27,82,25,39,64
35,8474679,Gustav Nyquist,C,NSH,35,82,25,39,64
35,8476438,Brandon Saad,L,STL,32,82,39,24,63
35,8482740,Wyatt Johnston,C,DAL,21,82,36,27,63
35,8476448,William Karlsson,C,VGK,31,82,30,33,63
35,8482097,Jack Quinn,R,BUF,23,82,27,36,63
35,8480797,Joel Farabee,L,PHI,24,82,24,39,63
35,8480803,Evan Bouchard,D,EDM,25,82,16,47,63
35,8478414,Timo Meier,R,NJD,28,82,30,32,62
35,8479400,Pierre-Luc Dubois,L,WSH,26,82,29,33,62
35,8477497,Sean Monahan,C,CBJ,30,82,27,35,62
35,8477935,Sam Bennett,C,FLA,28,82,26,36,62
35,8477494,Jonathan Drouin,L,COL,29,82,16,46,62
35,8478460,Zach Werenski,D,CBJ,27,82,15,47,62
35,8480015,Owen Tippett,R,PHI,25,82,35,26,61
35,8478401,Pavel Zacha,C,BOS,27,82,26,35,61
35,8473994,Jamie Benn,L,DAL,35,82,21,40,61
35,8482684,Luke Hughes,D,NJD,21,82,15,46,61
35,8477960,Adrian Kempe,R,LAK,28,82,32,28,60
35,8475793,Ryan Johansen,C,PHI,32,82,24,36,60
35,8477476,Artturi Lehkonen,L,COL,29,82,24,36,60
35,8477503,Max Domi,C,TOR,29,82,14,46,60
35,8479425,Filip Hronek,D,VAN,27,82,11,49,60
35,8478397,Rasmus Andersson,D,CGY,28,82,8,52,60
35,8473986,Alex Killorn,L,ANA,35,82,26,33,59
35,8474586,Jordan Eberle,R,SEA,34,82,26,33,59
35,8481533,Trevor Zegras,C,ANA,23,82,22,37,59
35,8479999,Casey Mittelstadt,C,COL,26,82,22,37,59
35,8478047,Michael Bunting,L,PIT,29,82,22,37,59
35,8476792,Torey Krug,D,STL,33,82,20,39,59
35,8476399,Blake Coleman,C,CGY,33,82,30,28,58
35,8481068,Yegor Sharangovich,C,CGY,26,82,26,32,58
35,8482745,Mason McTavish,C,ANA,21,82,30,27,57
35,8476392,Adam Lowry,C,WPG,31,82,23,34,57
35,8476875,Mike Matheson,D,MTL,30,82,15,42,57
35,8475151,Kyle Palmieri,C,NYI,33,82,28,28,56
35,8474641,Adam Henrique,C,EDM,34,82,27,29,56
35,8482078,Lucas Raymond,L,DET,22,82,23,33,56
35,8476479,Phillip Danault,C,LAK,31,82,23,33,56
35,8477416,Oliver Bjorkstrand,R,SEA,29,82,22,34,56
35,8475794,Tyler Seguin,C,DAL,32,82,21,35,56
35,8480028,Morgan Frost,C,PHI,25,82,21,35,56
35,8475798,Mikael Granlund,C,SJS,32,82,16,40,56
35,8480018,Nick Suzuki,C,MTL,25,82,14,42,56
35,8476880,Tom Wilson,R,WSH,30,82,30,25,55
35,8478856,Conor Garland,R,VAN,28,82,24,31,55
35,8482124,Quinton Byfield,R,LAK,22,82,20,35,55
35,8476905,Chandler Stephenson,C,SEA,30,82,18,37,55
35,8475799,Nino Niederreiter,R,WPG,32,82,32,22,54
35,8475158,Ryan O'Reilly,C,NSH,33,82,21,33,54
35,8476462,Dougie Hamilton,D,NJD,31,82,19,35,54
35,8477948,Travis Sanheim,D,PHI,28,82,18,36,54
35,8474565,Alex Pietrangelo,D,VGK,34,82,16,38,54
35,8477947,Sonny Milano,L,WSH,28,82,15,39,54
35,8475191,Reilly Smith,R,NYR,33,82,22,31,53
35,8480078,Filip Chytil,C,NYR,25,82,22,31,53
35,8482113,Anton Lundell,C,FLA,23,82,20,33,53
35,8482667,William Eklund,L,SJS,22,82,16,37,53
35,8476923,Damon Severson,D,CBJ,30,82,12,41,53
35,8475169,Evander Kane,L,EDM,33,82,29,23,52
35,8479987,Morgan Geekie,C,BOS,26,82,21,31,52
35,8482117,Lukas Reichel,L,CHI,22,82,20,32,52
35,8476882,Teuvo Teravainen,L,CHI,30,82,18,34,52
35,8477964,Ivan Barbashev,C,VGK,29,82,16,36,52
35,8477495,Seth Jones,D,CHI,30,82,12,40,52
35,8479410,Mikhail Sergachev,D,UTA,26,82,11,41,52
35,8475287,Erik Haula,L,NJD,33,82,24,27,51
35,8474150,Mikael Backlund,C,CGY,35,82,22,29,51
35,8477955,Jared McCann,L,SEA,28,82,21,30,51
35,8476872,Scott Laughton,C,PHI,30,82,19,32,51
35,8478469,Thomas Chabot,D,OTT,27,82,11,40,51
35,8483515,Juraj Slafkovsky,L,MTL,20,82,27,23,50
35,8482475,Yegor Chinakhov,R,CBJ,23,82,21,29,50
35,8478407,Vince Dunn,D,SEA,28,82,9,41,50
35,8478055,Gustav Forsling,D,FLA,28,82,9,41,50
35,8476869,Brady Skjei,D,NSH,30,82,8,42,50
35,8477456,J.T. Compher,L,DET,29,82,27,22,49
35,8478366,Frank Vatrano,R,ANA,30,82,21,28,49
35,8471724,Kris Letang,D,PIT,37,82,14,35,49
35,8476906,Shayne Gostisbehere,D,CAR,31,82,10,39,49
35,8476958,Jaccob Slavin,D,CAR,30,82,10,39,49
35,8482110,Dawson Mercer,C,NJD,23,82,25,23,48
35,8480188,Fabian Zetterlund,L,SJS,25,82,25,23,48
35,8483808,Andrei Kuzmenko,L,CGY,28,82,24,24,48
35,8478519,Anthony Cirelli,C,TBL,27,82,21,27,48
35,8475791,Taylor Hall,L,CHI,33,82,19,29,48
35,8481186,Logan O'Connor,R,COL,28,82,19,29,48
35,8477021,Alex Kerfoot,C,UTA,30,82,17,31,48
35,8478438,Tommy Novak,C,NSH,27,82,16,32,48
35,8477346,MacKenzie Weegar,D,CGY,30,82,15,33,48
35,8477986,Brandon Montour,D,SEA,30,82,14,34,48
35,8482660,Kent Johnson,C,CBJ,22,82,14,34,48
35,8477479,Tyler Bertuzzi,L,CHI,29,82,23,24,47
35,8481560,Arthur Kaliyev,R,LAK,23,82,21,26,47
35,8481528,Dylan Cozens,C,BUF,23,82,19,28,47
35,8474102,David Perron,L,OTT,36,82,18,29,47
35,8476461,Sean Couturier,C,PHI,32,82,17,30,47
35,8476458,Ryan Strome,C,ANA,31,82,16,31,47
35,8476292,Ondrej Palat,L,NJD,33,82,14,33,47
35,8478462,Nicolas Roy,C,VGK,27,82,13,34,47
35,8477498,Darnell Nurse,D,EDM,29,82,11,36,47
35,8478396,Noah Hanifin,D,VGK,27,82,10,37,47
35,8481711,Matias Maccelli,L,UTA,24,82,10,37,47
35,8477426,Nicholas Paul,L,TBL,29,82,24,22,46
35,8480185,Eetu Luostarinen,C,FLA,26,82,18,28,46
35,8478458,Jack Roslovic,C,CAR,27,82,15,31,46
35,8477932,Aaron Ekblad,D,FLA,28,82,7,39,46
35,8475754,Brock Nelson,C,NYI,33,82,21,24,45
35,8480798,Philipp Kurashev,C,CHI,25,82,21,24,45
35,8478474,Lawson Crouse,L,UTA,27,82,18,27,45
35,8477444,Andre Burakovsky,L,SEA,29,82,17,28,45
35,8477953,Kasperi Kapanen,R,STL,28,82,14,31,45
35,8478233,Andrew Mangiapane,L,WSH,28,82,23,21,44
35,8479525,Ross Colton,C,COL,28,82,23,21,44
35,8482175,JJ Peterka,R,BUF,22,82,23,21,44
35,8479339,Patrik Laine,L,CBJ,26,82,22,22,44
35,8475745,Charlie Coyle,C,BOS,32,82,19,25,44
35,8480064,Josh Norris,C,OTT,25,82,19,25,44
35,8471698,T.J. Oshie,R,WSH,38,82,17,27,44
35,8475218,Mattias Ekholm,D,EDM,34,82,15,29,44
35,8480434,Sean Durzi,D,UTA,26,82,5,39,44
35,8478498,Jake DeBrusk,L,VAN,28,82,25,18,43
35,8477511,Anthony Mantha,R,CGY,30,82,22,21,43
35,8477407,Anthony Duclair,L,NYI,29,82,20,23,43
35,8481618,Alex Newhook,C,MTL,23,82,19,24,43
35,8478109,Victor Olofsson,L,VGK,29,82,19,24,43
35,8481553,Bobby Brink,R,PHI,23,82,19,24,43
35,8481596,Shane Pinto,C,OTT,24,82,17,26,43
35,8482705,Cole Sillinger,C,CBJ,21,82,17,26,43
35,8482105,Jake Sanderson,D,OTT,22,82,15,28,43
35,8482149,Cole Perfetti,C,WPG,22,82,20,22,42
35,8477952,Robby Fabbri,C,ANA,28,82,20,22,42
35,8474149,Evgenii Dadonov,R,DAL,35,82,17,25,42
35,8475765,Vladimir Tarasenko,R,DET,33,82,14,28,42
35,8477429,Andrew Copp,C,DET,30,82,13,29,42
35,8479345,Jakob Chychrun,D,WSH,26,82,12,30,42
35,8482699,Dylan Guenther,R,UTA,21,82,22,19,41
35,8476925,Colton Sissons,C,NSH,31,82,21,20,41
35,8475760,Nick Bjugstad,C,UTA,32,82,18,23,41
35,8478472,Mathieu Joseph,R,STL,27,82,18,23,41
35,8475763,Kevin Hayes,R,PIT,32,82,17,24,41
35,8480871,Adam Boqvist,D,FLA,24,82,14,27,41
35,8473563,Nicklas Backstrom,C,WSH,37,82,11,30,41
35,8481581,Thomas Harley,D,DAL,23,82,10,31,41
35,8480893,Kirill Marchenko,R,CBJ,24,82,21,19,40
35,8478046,Danton Heinen,L,VAN,29,82,19,21,40
35,8478891,Mason Appleton,C,WPG,28,82,18,22,40
35,8480849,Barrett Hayton,C,UTA,24,82,17,23,40
35,8481546,Cam York,D,PHI,23,82,10,30,40
35,8480817,K'Andre Miller,D,NYR,24,82,10,30,40
35,8475764,Cam Fowler,D,ANA,33,82,1,39,40
35,8481554,Kaapo Kakko,R,NYR,23,82,26,13,39
35,8480009,Eeli Tolvanen,R,SEA,25,82,22,17,39
35,8479992,Michael Rasmussen,C,DET,25,82,20,19,39
35,8477998,Warren Foegele,L,LAK,28,82,20,19,39
35,8475314,Anders Lee,L,NYI,34,82,18,21,39
35,8475722,Jason Zucker,L,BUF,32,82,17,22,39
35,8477451,Ryan Hartman,R,MIN,30,82,15,24,39
35,8482159,Tyson Foerster,R,PHI,22,82,15,24,39
35,8476897,Oskar Sundqvist,C,STL,30,82,14,25,39
35,8480802,Ryan McLeod,C,BUF,25,82,13,26,39
35,8480145,Neal Pionk,D,WPG,29,82,9,30,39
35,8482125,Alexander Holtz,R,VGK,22,82,21,17,38
35,8480855,Jack McBain,C,UTA,24,82,19,19,38
35,8478542,Evan Rodrigues,C,FLA,31,82,17,21,38
35,8478115,Pierre Engvall,L,NYI,28,82,16,22,38
35,8482146,Luke Evangelista,R,NSH,22,82,15,23,38
35,8476927,Teddy Blueger,C,VAN,30,82,13,25,38
35,8480336,Sean Walker,D,CAR,30,82,12,26,38
35,8481606,Jordan Spence,D,LAK,23,82,10,28,38
35,8477969,Marcus Pettersson,D,PIT,28,82,5,33,38
35,8480873,Rasmus Sandin,D,WSH,24,82,3,35,38
35,8475714,Calle Jarnkrok,C,TOR,33,82,22,15,37
35,8476469,Joel Armia,R,MTL,31,82,20,17,37
35,8482720,Matthew Knies,L,TOR,22,82,19,18,37
35,8480835,Jack Drury,C,CAR,24,82,18,19,37
35,8478413,Jordan Greenway,L,BUF,27,82,17,20,37
35,8476918,Jimmy Vesey,L,NYR,31,82,15,22,37
35,8478020,Michael Amadio,C,OTT,28,82,14,23,37
35,8473533,Jordan Staal,C,CAR,36,82,14,23,37
35,8480068,Ryan Poehling,C,PHI,25,82,12,25,37
35,8482142,Jamie Drysdale,D,PHI,22,82,8,29,37
35,8481542,Moritz Seider,D,DET,23,82,5,32,37
35,8478507,John Marino,D,UTA,27,82,5,32,37
35,8476981,Josh Anderson,R,MTL,30,82,19,17,36
35,8480220,Noah Cates,L,PHI,25,82,13,23,36
35,8476826,Yanni Gourde,C,SEA,33,82,13,23,36
35,8474053,Logan Couture,C,SJS,35,82,13,23,36
35,8474189,Lars Eller,C,PIT,35,82,13,23,36
35,8476474,Stefan Noesen,R,NJD,31,82,13,23,36
35,8479976,Juuso Valimaki,D,UTA,26,82,10,26,36
35,8481656,Aliaksei Protas,C,WSH,23,82,9,27,36
35,8479390,Taylor Raddysh,R,WSH,26,82,21,14,35
35,8480829,Jesperi Kotkaniemi,C,CAR,24,82,17,18,35
35,8482089,Jake Neighbours,L,STL,22,82,16,19,35
35,8477987,Ryan Donato,C,CHI,28,82,15,20,35
35,8476921,Jordan Martinook,L,CAR,32,82,13,22,35
35,8470613,Brent Burns,D,CAR,39,82,12,23,35
35,8481013,Jonatan Berggren,R,DET,24,82,8,27,35
35,8474151,Ryan McDonagh,D,TBL,35,82,1,34,35
35,8479353,Brett Howden,C,VGK,26,82,18,16,34
35,8475768,Jaden Schwartz,C,SEA,32,82,15,19,34
35,8480748,Kiefer Sherwood,L,VAN,29,82,15,19,34
35,8474563,Drew Doughty,D,LAK,35,82,10,24,34
35,8482122,Brock Faber,D,MIN,22,82,9,25,34
35,8478133,Jake Evans,C,MTL,28,82,8,26,34
35,8475200,Dmitry Orlov,D,CAR,33,82,5,29,34
35,8476892,Colton Parayko,D,STL,31,82,2,32,34
35,8479398,Samuel Girard,D,COL,26,82,2,32,34
35,8481582,Nicholas Robertson,L,TOR,23,82,22,11,33
35,8484144,Connor Bedard,C,CHI,19,82,20,13,33
35,8476873,Mark Jankowski,C,NSH,30,82,20,13,33
35,8478057,Dakota Joshua,C,VAN,28,82,19,14,33
35,8480459,Pius Suter,C,VAN,28,82,17,16,33
35,8481624,Ilya Mikheyev,R,CHI,30,82,16,17,33
35,8482055,Drew O'Connor,L,PIT,26,82,16,17,33
35,8482079,Marco Rossi,C,MIN,23,82,16,17,33
35,8484166,Adam Fantilli,C,CBJ,20,82,14,19,33
35,8480789,Oliver Wahlstrom,R,NYI,24,82,13,20,33
35,8479941,Justin Danforth,R,CBJ,31,82,13,20,33
35,8476480,Vladislav Namestnikov,C,WPG,32,82,12,21,33
35,8476854,Hampus Lindholm,D,BOS,30,82,11,22,33
35,8476419,Jean-Gabriel Pageau,C,NYI,32,82,11,22,33
35,8482671,Owen Power,D,BUF,22,82,9,24,33
35,8476885,Jacob Trouba,D,NYR,30,82,6,27,33
35,8481522,Peyton Krebs,C,BUF,23,82,5,28,33
35,8477488,Brett Pesce,D,NJD,30,82,4,29,33
35,8480813,Joe Veleno,C,DET,24,82,18,14,32
35,8481032,Paul Cotter,C,NJD,25,82,14,18,32
35,8476457,Adam Larsson,D,SEA,32,82,8,24,32
35,8476525,Colin Miller,D,WPG,32,82,7,25,32
35,8476331,Dylan DeMelo,D,WPG,31,82,4,28,32
35,8478500,Ivan Provorov,D,CBJ,27,82,2,30,32
35,8477845,Trevor van Riemsdyk,D,WSH,33,82,2,30,32
35,8480049,Dylan Samberg,D,WPG,25,82,1,31,32
35,8481028,Martin Pospisil,C,CGY,25,82,21,10,31
35,8481580,Connor McMichael,C,WSH,23,82,17,14,31
35,8473422,Nick Foligno,L,CHI,37,82,13,18,31
35,8482111,Justin Barron,D,MTL,23,82,10,21,31
35,8480995,Pontus Holmberg,R,TOR,25,82,10,21,31
35,8478911,Matt Roy,D,WSH,29,82,8,23,31
35,8476467,Jamie Oleksiak,D,SEA,32,82,8,23,31
35,8476979,Erik Gustafsson,D,DET,32,82,4,27,31
35,8478851,Alexandre Carrier,D,NSH,28,82,3,28,31
35,8481535,Nils Hoglander,L,VAN,24,82,16,14,30
35,8481704,Juuso Parssinen,C,NSH,23,82,15,15,30
35,8482624,Daniil Miromanov,D,CGY,27,82,15,15,30
35,8480025,MacKenzie Entwistle,R,FLA,25,82,14,16,30
35,8479351,Sam Steel,C,DAL,26,82,12,18,30
35,8480113,Alex Iafallo,L,WPG,31,82,11,19,30
35,8475231,Casey Cizikas,C,NYI,33,82,11,19,30
35,8481517,Brett Leason,R,ANA,25,82,11,19,30
35,8482133,Thomas Bordeleau,C,SJS,22,82,10,20,30
35,8479365,Trent Frederic,C,BOS,26,82,9,21,30
35,8482092,Ridly Greig,C,OTT,22,82,8,22,30
35,8476917,Adam Pelech,D,NYI,30,82,5,25,30
35,8476329,Travis Boyd,C,MIN,31,82,4,26,30
35,8480172,Jan Rutta,D,SJS,34,82,3,27,30
35,8483431,Logan Cooley,C,UTA,20,82,19,10,29
35,8479368,Max Jones,L,BOS,26,82,15,14,29
35,8479316,Luke Kunin,C,SJS,27,82,14,15,29
35,8476278,Colin Blackwell,C,DAL,31,82,13,16,29
35,8475193,Tomas Tatar,L,NJD,34,82,13,16,29
35,8482141,Lukas Cormier,D,VGK,22,82,13,16,29
35,8475220,Marcus Foligno,L,MIN,33,82,12,17,29
35,8480144,David Kampf,C,TOR,29,82,11,18,29
35,8481481,Blake Lizotte,C,PIT,27,82,11,18,29
35,8475343,Nic Dowd,C,WSH,34,82,10,19,29
35,8480796,Martin Fehervary,D,WSH,25,82,9,20,29
35,8475181,Nick Leddy,D,STL,33,82,6,23,29
35,8483490,Pavel Mintyukov,D,ANA,21,82,6,23,29
35,8478882,Vladislav Gavrikov,D,LAK,29,82,4,25,29
35,8479996,Cody Glass,C,NSH,25,82,16,12,28
35,8477989,Christian Dvorak,C,MTL,28,82,15,13,28
35,8477392,Hudson Fasching,R,NYI,29,82,15,13,28
35,8475149,Marcus Johansson,L,MIN,34,82,14,14,28
35,8481093,Rafael Harvey-Pinard,L,MTL,25,82,14,14,28
35,8484145,Zach Benson,L,BUF,19,82,14,14,28
35,8481604,Pavel Dorofeyev,L,VGK,24,82,13,15,28
35,8482679,Matt Coronato,R,CGY,22,82,13,15,28
35,8474715,Cam Atkinson,R,TBL,35,82,11,17,28
35,8482074,Connor Zary,C,CGY,23,82,9,19,28
35,8483457,Lane Hutson,D,MTL,20,82,9,19,28
35,8483763,Maksymilian Szuber,D,UTA,22,82,8,20,28
35,8478136,Jake Middleton,D,MIN,28,82,7,21,28
35,8483495,Simon Nemec,D,NJD,20,82,6,22,28
35,8482087,Kaiden Guhle,D,MTL,22,82,6,22,28
35,8477919,Frederick Gaudreau,C,MIN,31,82,4,24,28
35,8476312,Josh Manson,D,COL,33,82,4,24,28
35,8477499,Rasmus Ristolainen,D,PHI,30,82,4,24,28
35,8479369,Andrew Peeke,D,BOS,26,82,1,27,28
35,8476374,Sean Kuraly,C,CBJ,31,82,15,12,27
35,8470621,Corey Perry,R,EDM,39,82,12,15,27
35,8477425,Miles Wood,L,COL,29,82,12,15,27
35,8476902,Esa Lindell,D,DAL,30,82,10,17,27
35,8475848,Brendan Gallagher,R,MTL,32,82,10,17,27
35,8477508,Curtis Lazar,C,NJD,29,82,9,18,27
35,8478013,Jake Walman,D,SJS,28,82,9,18,27
35,8482245,Artem Zub,D,OTT,29,82,8,19,27
35,8483445,Cutter Gauthier,L,ANA,20,82,8,19,27
35,8474673,TJ Brodie,D,CHI,34,82,6,21,27
35,8479980,Nicolas Hague,D,VGK,26,82,6,21,27
35,8480246,Nick Perbix,D,TBL,26,82,5,22,27
35,8475233,David Savard,D,MTL,34,82,3,24,27
35,8476960,Andreas Athanasiou,C,CHI,30,82,2,25,27
35,8479371,Dante Fabbro,D,NSH,26,82,2,25,27
35,8480281,Alexey Toropchenko,R,STL,25,82,18,8,26
35,8477015,Connor Brown,R,EDM,30,82,10,16,26
35,8479661,Tanner Jeannot,L,LAK,27,82,9,17,26
35,8474716,Jared Spurgeon,D,MIN,35,82,7,19,26
35,8476463,Jonas Brodin,D,MIN,31,82,6,20,26
35,8476429,Scott Mayfield,D,NYI,32,82,6,20,26
35,8480043,Timothy Liljegren,D,TOR,25,82,4,22,26
35,8476931,Jake McCabe,D,TOR,31,82,3,23,26
35,8481601,Simon Holmstrom,R,NYI,23,82,14,11,25
35,8482062,Cole Smith,L,NSH,29,82,13,12,25
35,8477931,Tomas Nosek,L,FLA,32,82,12,13,25
35,8477406,Mattias Janmark,C,EDM,32,82,9,16,25
35,8474574,Tyler Myers,D,VAN,34,82,8,17,25
35,8478399,Jonas Siegenthaler,D,NJD,27,82,6,19,25
35,8480073,Erik Brannstrom,D,COL,25,82,5,20,25
35,8482702,Logan Stankoven,C,DAL,21,82,5,20,25
35,8483565,Nick Blankenburg,D,NSH,26,82,2,23,25
35,8477365,Connor Clifton,D,BUF,29,82,2,23,25
35,8479393,Noah Gregor,C,OTT,26,82,15,9,24
35,8480806,Isac Lundestrom,C,ANA,25,82,14,10,24
35,8478463,Anthony Beauvillier,L,PIT,27,82,13,11,24
35,8478508,Yakov Trenin,C,MIN,27,82,12,12,24
35,8477507,Nikita Zadorov,D,BOS,29,82,11,13,24
35,8479414,Nathan Bastian,R,NJD,27,82,11,13,24
35,8482659,Josh Doan,R,UTA,22,82,9,15,24
35,8480074,Alexandre Texier,C,STL,25,82,8,16,24
35,8483499,Liam Ohgren,L,MIN,20,82,8,16,24
35,8475690,Chris Tanev,D,TOR,35,82,6,18,24
35,8473507,Jeff Petry,D,DET,37,82,5,19,24
35,8481477,Nico Sturm,C,SJS,29,82,5,19,24
35,8475279,Ben Chiarot,D,DET,33,82,4,20,24
35,8475188,Brayden McNabb,D,VGK,33,82,3,21,24
35,8480035,Henri Jokiharju,D,BUF,25,82,2,22,24
35,8478840,Will Borgen,D,SEA,28,82,2,22,24
35,8480021,Jack Studnicka,C,LAK,25,82,14,9,23
35,8484153,Leo Carlsson,C,ANA,20,82,12,11,23
35,8478432,Christian Fischer,R,DET,27,82,12,11,23
35,8476889,Radek Faksa,C,STL,30,82,11,12,23
35,8478569,Noel Acciari,C,PIT,33,82,8,15,23
35,8480980,Connor Dewar,C,TOR,25,82,7,16,23
35,8480860,Kevin Bahl,D,CGY,24,82,7,16,23
35,8475171,Oliver Ekman-Larsson,D,TOR,33,82,6,17,23
35,8477506,Ryan Pulock,D,NYI,30,82,6,17,23
35,8480878,Nils Lundkvist,D,DAL,24,82,5,18,23
35,8478178,Darren Raddysh,D,TBL,28,82,5,18,23
35,8479402,Jake Bean,D,CGY,26,82,4,19,23
35,8470600,Ryan Suter,D,STL,39,82,3,20,23
35,8477450,Jason Dickinson,C,CHI,29,82,13,9,22
35,8482666,Scott Morrow,D,CAR,22,82,11,11,22
35,8478211,Dryden Hunt,L,CGY,29,82,8,14,22
35,8482712,Oskar Olausson,R,COL,22,82,7,15,22
35,8480003,Jesper Boqvist,C,FLA,26,82,6,16,22
35,8480807,Mattias Samuelsson,D,BUF,24,82,5,17,22
35,8475455,Brenden Dillon,D,NJD,34,82,5,17,22
35,8481178,Egor Zamula,D,PHI,24,82,4,18,22
35,8476879,Cody Ceci,D,EDM,31,82,3,19,22
35,8478416,Erik Cernak,D,TBL,27,82,3,19,22
35,8482077,Dylan Holloway,L,EDM,23,82,13,8,21
35,8477353,Tyler Motte,C,DET,29,82,13,8,21
35,8476624,Barclay Goodrow,C,SJS,31,82,10,11,21
35,8480448,Parker Kelly,L,COL,25,82,9,12,21
35,8476422,Mike Reilly,D,NYI,31,82,6,15,21
35,8478443,Brandon Carlo,D,BOS,28,82,4,17,21
35,8475324,Nick Jensen,D,OTT,34,82,2,19,21
35,8477435,Ryan Graves,D,PIT,29,82,1,20,21
35,8482655,J.J. Moser,D,TBL,24,82,0,21,21
35,8477839,Conor Sheary,L,TBL,32,82,13,7,20
35,8476442,Matt Nieto,L,PIT,32,82,10,10,20
35,8482259,Bobby McMann,C,TOR,28,82,8,12,20
35,8482762,Simon Edvinsson,D,DET,21,82,8,12,20
35,8478434,Keegan Kolesar,R,VGK,27,82,8,12,20
35,8477220,Nate Schmidt,D,FLA,33,82,6,14,20
35,8477903,Garnet Hathaway,R,PHI,33,82,6,14,20
35,8480990,Declan Chisholm,D,MIN,24,82,6,14,20
35,8484203,Bradly Nadeau,L,CAR,19,82,5,15,20
35,8481568,Alex Vlasic,D,CHI,23,82,5,15,20
35,8479293,Brandon Tanev,L,SEA,33,82,15,4,19
35,8483524,Shane Wright,C,SEA,20,82,10,9,19
35,8482166,Shakir Mukhamadullin,D,SJS,22,82,8,11,19
35,8478450,Parker Wotherspoon,D,BOS,27,82,7,12,19
35,8477938,Haydn Fleury,D,WPG,28,82,7,12,19
35,8484911,Collin Graf,R,SJS,22,82,6,13,19
35,8476967,Brett Kulak,D,EDM,30,82,3,16,19
35,8479591,Michael Eyssimont,C,TBL,28,82,10,8,18
35,8477369,Carson Soucy,D,VAN,30,82,10,8,18
35,8473453,Trevor Lewis,C,LAK,37,82,10,8,18
35,8481699,Aku Raty,R,UTA,23,82,8,10,18
35,8482101,Danil Gushchin,L,SJS,22,82,7,11,18
35,8475855,Jesper Fast,R,CAR,33,82,5,13,18
35,8481567,Henry Thrun,D,SJS,23,82,4,14,18
35,8480222,Sebastian Aho,D,PIT,28,82,2,16,18
35,8477505,Alexander Wennberg,C,SJS,30,82,10,7,17
35,8482807,Ethan Del Mastro,D,CHI,21,82,7,10,17
35,8476473,Connor Murphy,D,CHI,31,82,7,10,17
35,8482118,Sam Colangelo,R,ANA,23,82,7,10,17
35,8483567,Georgii Merkulov,C,BOS,24,82,7,10,17
35,8479983,Mario Ferraro,D,SJS,26,82,6,11,17
35,8483505,Matthew Poitras,C,BOS,20,82,6,11,17
35,8478468,Jeremy Lauzon,D,NSH,27,82,5,12,17
35,8474013,Ian Cole,D,UTA,35,82,5,12,17
35,8476441,Joel Edmundson,D,LAK,31,82,5,12,17
35,8481014,Alexander Romanov,D,NYI,24,82,4,13,17
35,8475762,Derek Forbort,D,VAN,32,82,4,13,17
35,8476891,Matt Grzelcyk,D,PIT,30,82,3,14,17
35,8479998,Mikey Anderson,D,LAK,25,82,3,14,17
35,8477335,Kyle Burroughs,D,LAK,29,82,3,14,17
35,8479324,Ryan Lindgren,D,NYR,26,82,1,16,17
35,8479291,Kevin Rooney,C,CGY,31,82,9,7,16
35,8475842,Sam Carrick,C,NYR,32,82,7,9,16
35,8482155,Alex Laferriere,R,LAK,23,82,7,9,16
35,8479359,Beck Malenstyn,L,BUF,26,82,6,10,16
35,8482858,Ryker Evans,D,SEA,23,82,3,13,16
35,8475462,Radko Gudas,D,ANA,34,82,2,14,16
35,8471677,Jack Johnson,D,CBJ,37,82,2,14,16
35,8476372,Nick Seeler,D,PHI,31,82,2,14,16
35,8480879,Jacob Bernard-Docker,D,OTT,24,82,1,15,16
35,8483397,Marc McLaughlin,C,BOS,25,82,10,5,15
35,8483482,Tristan Luneau,D,ANA,20,82,7,8,15
35,8482803,Olen Zellweger,D,ANA,21,82,6,9,15
35,8479638,Justin Brazeau,R,BOS,26,82,6,9,15
35,8482787,Nikita Chibrikov,R,WPG,31,82,6,9,15
35,8482145,Mavrik Bourque,C,DAL,22,82,5,10,15
35,8483471,Brad Lambert,C,WPG,31,82,3,12,15
35,8475177,Calvin de Haan,D,COL,33,82,3,12,15
35,8474090,Brendan Smith,D,DAL,35,82,1,14,15
35,8482153,Brendan Brisson,C,VGK,23,82,6,8,14
35,8483468,Jiri Kulich,C,BUF,20,82,9,4,13
35,8482070,Mitchell Chaffee,R,TBL,26,82,9,4,13
35,8476858,Phillip Di Giuseppe,L,VAN,31,82,8,5,13
35,8481524,Bowen Byram,D,BUF,23,82,4,9,13
35,8480834,Ty Emberson,D,SJS,24,82,4,9,13
35,8481708,Zac Jones,D,NYR,24,82,3,10,13
35,8477034,Jaycob Megna,D,FLA,32,82,3,10,13
35,8478859,Niko Mikkola,D,FLA,28,82,3,10,13
35,8475718,Justin Holl,D,DET,32,82,3,10,13
35,8483460,David Jiricek,D,CBJ,21,82,2,11,13
35,8483466,Kevin Korchinski,D,CHI,20,82,1,12,13
35,8475790,Erik Gudbranson,D,CBJ,32,82,1,12,13
35,8480870,Bo Groulx,C,NYR,24,82,6,6,12
35,8482809,Jackson Blake,R,CAR,21,82,5,7,12
35,8476878,Zemgus Girgensons,L,TBL,30,82,5,7,12
35,8482749,Joshua Roy,R,MTL,21,82,5,7,12
35,8484149,Gavin Brindley,C,CBJ,20,82,4,8,12
35,8481605,Jackson LaCombe,D,ANA,23,82,4,8,12
35,8482073,Braden Schneider,D,NYR,23,82,2,10,12
35,8481122,Simon Benoit,D,TOR,26,82,2,10,12
35,8476822,Luke Glendening,C,TBL,35,82,7,4,11
35,8479442,Troy Stecher,D,EDM,30,82,6,5,11
35,8482713,Mackie Samoskevich,R,FLA,22,82,6,5,11
35,8481641,Joel Kiviranta,L,COL,28,82,5,6,11
35,8482470,Ilya Solovyov,D,CGY,24,82,3,8,11
35,8480950,Ilya Lyubushkin,D,DAL,30,82,3,8,11
35,8474567,Zach Bogosian,D,MIN,34,82,1,10,11
35,8483493,Frank Nazar,C,CHI,20,82,1,10,11
35,8478874,Adam Gaudette,C,OTT,28,82,3,7,10
35,8483012,Logan Morrison,C,SEA,22,82,1,9,10
35,8482859,Zack Ostapchuk,C,OTT,21,82,4,5,9
35,8482733,Logan Mailloux,D,MTL,31,82,3,6,9
35,8479576,Vincent Desharnais,D,VAN,28,82,1,8,9
35,8482516,Matthew Kessel,D,STL,24,82,1,7,8
35,8483489,Fraser Minten,C,TOR,31,82,1,6,7
35,8474612,Travis Hamonic,D,OTT,34,82,1,6,7
35,8474062,Riley Nash,C,NYR,35,82,3,3,6
35,8470794,Joe Pavelski,C,,40,0,0,0,0
35,8481703,Valtteri Puustinen,R,PIT,25,0,0,0,0
35,8477950,Tony DeAngelo,D,,29,0,0,0,0
35,8481577,Philip Tomasino,C,NSH,23,0,0,0,0
35,8475197,Tyson Barrie,D,,33,0,0,0,0
35,8471218,Blake Wheeler,R,,38,0,0,0,0
35,8474157,Max Pacioretty,L,,36,0,0,0,0
35,8478466,Daniel Sprong,R,VAN,27,0,0,0,0
35,8475744,Evgeny Kuznetsov,C,,32,0,0,0,0
35,8481019,David Gustafsson,C,WPG,24,0,0,0,0
35,8475906,John Klingberg,D,,32,0,0,0,0
35,8479348,Kale Clague,D,BUF,26,0,0,0,0
35,8476952,Dominic Toninato,C,WPG,30,0,0,0,0
35,8473473,Milan Lucic,L,,36,0,0,0,0
35,8474037,James van Riemsdyk,L,,35,0,0,0,0
35,8474602,Justin Schultz,D,,34,0,0,0,0
35,8482222,Alexander Barabanov,L,,30,0,0,0,0
35,8479372,Josh Mahura,D,SEA,26,0,0,0,0
35,8479982,Conor Timmins,D,TOR,26,0,0,0,0
35,8474031,Kevin Shattenkirk,D,,35,0,0,0,0
35,8480008,Adam Ruzicka,C,,25,0,0,0,0
35,8481059,Scott Perunovich,D,STL,26,0,0,0,0
35,8480884,Calen Addison,D,,24,0,0,0,0
35,8476994,Vinnie Hinostroza,C,NSH,30,0,0,0,0
35,8478452,Caleb Jones,D,LAK,27,0,0,0,0
35,8480157,Calle Rosen,D,COL,30,0,0,0,0
35,8481609,Vladislav Kolyachonok,D,UTA,23,0,0,0,0
35,8479415,Michael McLeod,C,,26,0,0,0,0
35,8476919,Chris Tierney,C,,30,0,0,0,0
35,8479639,Dylan Coghlan,D,WPG,26,0,0,0,0
35,8478146,Matthew Highmore,C,OTT,28,0,0,0,0
35,8478970,Jalen Chatfield,D,CAR,28,0,0,0,0
35,8480205,Emil Bemstrom,C,PIT,25,0,0,0,0
35,8474884,Mike Hoffman,C,,35,0,0,0,0
35,8471274,Alex Goligoski,D,,39,0,0,0,0
35,8478104,Sammy Blais,L,,28,0,0,0,0
35,8474870,Tyler Johnson,C,,34,0,0,0,0
35,8476913,Devin Shore,C,MIN,30,0,0,0,0
35,8481598,Philip Broberg,D,EDM,23,0,0,0,0
35,8480058,Pierre-Olivier Joseph,D,STL,25,0,0,0,0
35,8480891,Michael Kesselring,D,UTA,24,0,0,0,0
35,8477979,Nicolas Aube-Kubel,R,BUF,28,0,0,0,0
35,8476871,Tanner Pearson,L,,32,0,0,0,0
35,8476393,Nick Cousins,C,,31,0,0,0,0
35,8479977,Kailer Yamamoto,R,,26,0,0,0,0
35,8479543,Michael Pezzetta,L,MTL,26,0,0,0,0
35,8477018,Ben Hutton,D,VGK,31,0,0,0,0
35,8480762,Eric Robinson,L,CAR,29,0,0,0,0
35,8474034,Pat Maroon,L,CHI,36,0,0,0,0
35,8481058,Jesse Ylönen,R,,25,0,0,0,0
35,8475179,Dmitry Kulikov,D,FLA,34,0,0,0,0
35,8481527,Kaedan Korczak,D,VGK,23,0,0,0,0
35,8473449,Kyle Okposo,R,,36,0,0,0,0
35,8482192,Isaak Phillips,D,CHI,23,0,0,0,0
35,8480727,Zach Whitecloud,D,VGK,28,0,0,0,0
35,8479346,Dillon Dube,C,,26,0,0,0,0
35,8480821,Filip Zadina,R,,25,0,0,0,0
35,8480001,Urho Vaakanainen,D,ANA,25,0,0,0,0
35,8470966,Mark Giordano,D,,41,0,0,0,0
35,8480853,Liam Foudy,C,,24,0,0,0,0
35,8475225,Craig Smith,C,CHI,35,0,0,0,0
35,8479972,Mason Shaw,C,WPG,26,0,0,0,0
35,8478451,Ethan Bear,D,WSH,27,0,0,0,0
35,8474040,Sam Gagner,C,,35,0,0,0,0
35,8480196,Jacob Bryson,D,BUF,27,0,0,0,0
35,8479984,Cal Foote,D,,26,0,0,0,0
35,8480011,Klim Kostin,C,SJS,25,0,0,0,0
35,8482176,Wyatt Kaiser,D,CHI,22,0,0,0,0
35,8476988,Matt Benning,D,SJS,30,0,0,0,0
35,8479370,Tyson Jost,C,CAR,26,0,0,0,0
35,8477464,Nic Petan,C,,29,0,0,0,0
35,8477380,Jonny Brodzinski,C,NYR,31,0,0,0,0
35,8480070,Ian Mitchell,D,BOS,25,0,0,0,0
35,8479315,Joey Anderson,R,CHI,26,0,0,0,0
35,8478099,Kevin Labanc,R,,29,0,0,0,0
35,8476874,Olli Maatta,D,DET,30,0,0,0,0
35,8475208,Brian Dumoulin,D,ANA,33,0,0,0,0
35,8478430,Oliver Kylington,D,,27,0,0,0,0
35,8479536,Axel Jonsson-Fjallby,L,WPG,26,0,0,0,0
35,8479671,Mathieu Olivier,R,CBJ,27,0,0,0,0
35,8471709,Marc-Edouard Vlasic,D,SJS,37,0,0,0,0
35,8479328,Julien Gauthier,R,NYI,27,0,0,0,0
35,8478421,A.J. Greer,L,FLA,28,0,0,0,0
35,8477573,Nathan Walker,L,STL,30,0,0,0,0
35,8481537,Nikita Okhotiuk,D,CGY,24,0,0,0,0
35,8474166,Alec Martinez,D,CHI,37,0,0,0,0
35,8470610,Zach Parise,L,,40,0,0,0,0
35,8477478,William Carrier,L,CAR,30,0,0,0,0
35,8479344,Jesse Puljujarvi,R,PIT,26,0,0,0,0
35,8480887,Jordan Harris,D,MTL,24,0,0,0,0
35,8478502,Dennis Gilbert,D,BUF,28,0,0,0,0
35,8482730,Brandt Clarke,D,LAK,21,0,0,0,0
35,8480355,Mark Kastelic,C,BOS,25,0,0,0,0
35,8475750,Jon Merrill,D,MIN,32,0,0,0,0
35,8475164,Jakob Silfverberg,R,,34,0,0,0,0
35,8477944,Jakub Vrana,L,,28,0,0,0,0
35,8479439,Jacob MacDonald,D,COL,31,0,0,0,0
35,8474568,Luke Schenn,D,NSH,35,0,0,0,0
35,8478454,Noah Juulsen,D,VAN,27,0,0,0,0
35,8475752,Tyler Pitlick,C,,33,0,0,0,0
35,8482148,Hendrix Lapierre,C,WSH,22,0,0,0,0
35,8481167,Brayden Pachal,D,CGY,25,0,0,0,0
35,8478043,Sam Lafferty,C,BUF,29,0,0,0,0
35,8479321,Lucas Johansen,D,,27,0,0,0,0
35,8471699,Andrew Cogliano,C,,37,0,0,0,0
35,8481521,Ronnie Attard,D,PHI,25,0,0,0,0
35,8481161,Jake Christiansen,D,CBJ,25,0,0,0,0
35,8479458,Nikita Zaitsev,D,,33,0,0,0,0
35,8479619,Michael Carcone,L,UTA,28,0,0,0,0
35,8479026,Philippe Myers,D,TOR,27,0,0,0,0
35,8477330,Dominik Kubalik,L,,29,0,0,0,0
35,8481617,Vasily Podkolzin,R,VAN,23,0,0,0,0
35,8481701,Santeri Hatakka,D,NJD,23,0,0,0,0
35,8479514,Rem Pitlick,C,,27,0,0,0,0
35,8477446,Michael McCarron,R,NSH,29,0,0,0,0
35,8470604,Jeff Carter,C,,39,0,0,0,0
35,8482241,Radim Zohorna,L,,28,0,0,0,0
35,8480289,Morgan Barron,C,WPG,26,0,0,0,0
35,8479379,Givani Smith,R,SJS,26,0,0,0,0
35,8480216,Jacob Peterson,C,,25,0,0,0,0
35,8477851,Jordan Oesterle,D,BOS,32,0,0,0,0
35,8484258,Sam Malinski,D,COL,26,0,0,0,0
35,8478904,Steven Lorentz,C,,28,0,0,0,0
35,8482095,Tyler Kleven,D,OTT,22,0,0,0,0
35,8480848,Ty Dellandrea,C,SJS,24,0,0,0,0
35,8476884,Derrick Pouliot,D,,30,0,0,0,0
35,8479336,Carl Grundstrom,R,SJS,27,0,0,0,0
35,8482964,Arber Xhekaj,D,MTL,23,0,0,0,0
35,8471686,Marc Staal,D,,37,0,0,0,0
35,8477887,Patrick Brown,C,BOS,32,0,0,0,0
35,8478495,Denis Gurianov,R,,27,0,0,0,0
35,8473504,Cal Clutterbuck,R,,37,0,0,0,0
35,8481550,Adam Beckman,L,NJD,23,0,0,0,0
35,8480845,Rasmus Kupari,C,WPG,24,0,0,0,0
35,8474009,Nick Bonino,C,,36,0,0,0,0
35,8478585,Derek Ryan,C,EDM,38,0,0,0,0
35,8477962,Brendan Lemieux,L,CAR,28,0,0,0,0
35,8482861,Vincent Iorio,D,WSH,22,0,0,0,0
35,8479378,Logan Stanley,D,WPG,26,0,0,0,0
35,8473446,Erik Johnson,D,PHI,36,0,0,0,0
35,8481743,Marc Del Gaizo,D,NSH,25,0,0,0,0
35,8477384,Josh Brown,D,EDM,30,0,0,0,0
35,8482165,Yan Kuznetsov,D,CGY,22,0,0,0,0
35,8478424,Jansen Harkins,C,ANA,27,0,0,0,0
35,8482144,Jack Thompson,D,SJS,22,0,0,0,0
35,8478512,Austin Czarnik,C,,32,0,0,0,0
35,8477527,Ross Johnston,L,ANA,30,0,0,0,0
35,8479383,Boris Katchouk,L,,26,0,0,0,0
35,8482094,Daemon Hunt,D,MIN,22,0,0,0,0
35,8481719,Maxwell Crozier,D,TBL,24,0,0,0,0
35,8480192,Johnathan Kovacevic,D,NJD,27,0,0,0,0
35,8479376,Victor Mete,D,,26,0,0,0,0
35,8482511,Mason Lohrei,D,BOS,23,0,0,0,0
35,8475825,Jani Hakanpää,D,,32,0,0,0,0
35,8478021,William Lagesson,D,DET,28,0,0,0,0
35,8475795,Dylan McIlrath,D,WSH,32,0,0,0,0
35,8477846,Ryan Carpenter,C,,33,0,0,0,0
35,8481056,Spencer Stastney,D,NSH,24,0,0,0,0
35,8481564,Ryan Johnson,D,BUF,23,0,0,0,0
35,8478017,Mark Friedman,D,VAN,29,0,0,0,0
35,8479320,Max Lajoie,D,SEA,27,0,0,0,0
35,8480075,Cameron Crotty,D,MIN,25,0,0,0,0
35,8484287,Cole McWard,D,VAN,23,0,0,0,0
35,8484254,Akito Hirose,D,VAN,25,0,0,0,0
35,8483407,Brandon Scanlin,D,NYR,25,0,0,0,0
35,8480274,Philip Kemp,D,EDM,25,0,0,0,0
35,8479522,Hardy Haman Aktell,D,WSH,26,0,0,0,0
35,8480007,Jonas Rondbjerg,R,VGK,25,0,0,0,0
35,8477454,Adam Erne,L,,29,0,0,0,0
35,8481679,Maxence Guenette,D,OTT,23,0,0,0,0
35,8480441,Trey Fix-Wolansky,R,CBJ,25,0,0,0,0
35,8483546,Marshall Rifai,D,TOR,26,0,0,0,0
35,8480084,Nick DeSimone,D,NJD,30,0,0,0,0
35,8481030,Jack St. Ivany,D,PIT,25,0,0,0,0
35,8481592,Jakob Pelletier,L,CGY,23,0,0,0,0
35,8478011,Louie Belpedio,D,PHI,28,0,0,0,0
35,8477930,Pierre-Edouard Bellemare,L,,39,0,0,0,0
35,8484321,Nikolas Matinpalo,D,OTT,26,0,0,0,0
35,8482067,Connor Mackey,D,NYR,28,0,0,0,0
35,8481806,Louis Crevier,D,CHI,23,0,0,0,0
35,8484326,Patrik Koch,D,UTA,28,0,0,0,0
35,8477971,Andreas Englund,D,LAK,28,0,0,0,0
35,8481751,Lukas Rousek,R,BUF,25,0,0,0,0
35,8481006,Tyler Tucker,D,STL,24,0,0,0,0
35,8476867,Brendan Gaunce,C,MIN,30,0,0,0,0
35,8479520,Brandon Duhaime,R,WSH,27,0,0,0,0
35,8477073,Kurtis MacDermid,L,NJD,30,0,0,0,0
35,8480874,Adam Ginning,D,PHI,24,0,0,0,0
35,8477473,Justin Bailey,R,SJS,29,0,0,0,0
35,8479066,Ryan Lomberg,L,CGY,30,0,0,0,0
35,8477070,Liam O'Brien,C,UTA,30,0,0,0,0
35,8474618,Marco Scandella,D,,34,0,0,0,0
35,8475797,Jarred Tinordi,D,,32,0,0,0,0
35,8481441,Joe Snively,C,DET,28,0,0,0,0
35,8477244,Chad Ruhwedel,D,NYR,34,0,0,0,0
35,8479772,Zack MacEwen,R,OTT,28,0,0,0,0
35,8481147,Reese Johnson,C,MIN,26,0,0,0,0
35,8481043,Cole Koepke,L,BOS,26,0,0,0,0
35,8483619,Filip Roos,D,OTT,25,0,0,0,0
35,8481541,Samuel Bolduc,D,NYI,24,0,0,0,0
35,8477810,Joel Hanley,D,CGY,33,0,0,0,0
35,8476907,Mackenzie MacEachern,L,,30,0,0,0,0
35,8482652,Walker Duehr,R,CGY,27,0,0,0,0
35,8477126,Jayson Megna,C,,34,0,0,0,0
35,8483398,Declan Carlile,D,TBL,31,0,0,0,0
35,8482929,Emil Lilleberg,D,TBL,23,0,0,0,0
35,8480880,Jakub Lauko,C,MIN,24,0,0,0,0
35,8480245,Olle Lycksell,R,PHI,25,0,0,0,0
35,8480252,Cole Guttman,C,CHI,25,0,0,0,0
35,8477467,Gustav Olofsson,D,SEA,30,0,0,0,0
35,8479968,Vinni Lettieri,C,BOS,29,0,0,0,0
35,8478400,Colin White,C,,27,0,0,0,0
35,8475755,Alexander Petrovic,D,DAL,32,0,0,0,0
35,8481812,Nikolai Knyzhov,D,,27,0,0,0,0
35,8481593,Jayden Struble,D,MTL,23,0,0,0,0
35,8481532,Alex Turcotte,C,LAK,23,0,0,0,0
35,8482126,Emil Andrae,D,PHI,31,0,0,0,0
35,8479944,Zach Aston-Reese,C,VGK,30,0,0,0,0
35,8471817,Ryan Reaves,R,TOR,37,0,0,0,0
35,8481206,John Ludvig,D,PIT,24,0,0,0,0
35,8481599,Victor Soderstrom,D,UTA,23,0,0,0,0
35,8480292,Carson Meyer,R,ANA,27,0,0,0,0
35,8482496,Nils Aman,C,VAN,24,0,0,0,0
35,8479718,Alex Barré-Boulet,C,MTL,27,0,0,0,0
35,8479994,Jaret Anderson-Dolan,C,WPG,25,0,0,0,0
35,8480184,Gustav Lindstrom,D,,26,0,0,0,0
35,8480890,Jan Jenik,R,OTT,24,0,0,0,0
35,8478067,Oskar Lindblom,L,,28,0,0,0,0
35,8476934,Brock McGinn,L,ANA,30,0,0,0,0
35,8479985,Cale Fleury,D,SEA,26,0,0,0,0
35,8484304,Uvis Balinskis,D,FLA,28,0,0,0,0
35,8479981,Jonah Gadjovich,L,FLA,26,0,0,0,0
35,8481716,Dmitri Voronkov,L,CBJ,24,0,0,0,0
35,8474709,Matt Martin,L,,35,0,0,0,0
35,8482634,Alex Steeves,C,TOR,25,0,0,0,0
35,8480823,Alexander Alexeyev,D,WSH,25,0,0,0,0
35,8477541,Dakota Mermis,D,TOR,30,0,0,0,0
35,8483491,Ivan Miroshnichenko,L,WSH,20,0,0,0,0
35,8478477,Mitchell Stephens,C,SEA,27,0,0,0,0
35,8481543,Nikita Alexandrov,C,STL,24,0,0,0,0
35,8479423,Alex Nylander,L,,26,0,0,0,0
35,8482451,Mikael Pyyhtia,L,CBJ,23,0,0,0,0
35,8478831,Kevin Stenlund,C,UTA,28,0,0,0,0
35,8480306,Grant Hutton,D,NYI,29,0,0,0,0
35,8478028,Fredrik Olofsson,L,,28,0,0,0,0
35,8477462,Robert Hagg,D,VGK,29,0,0,0,0
35,8477320,Anton Blidh,L,NYR,29,0,0,0,0
35,8482157,Will Cuylle,L,NYR,22,0,0,0,0
35,8482737,Zack Bolduc,C,STL,21,0,0,0,0
35,8481239,Samuel Fagemo,L,,24,0,0,0,0
35,8481600,Tobias Bjornfot,D,FLA,23,0,0,0,0
35,8478409,Anthony Richard,C,PHI,28,0,0,0,0
35,8474145,Robert Bortuzzo,D,,35,0,0,0,0
35,8475958,Michael Sgarbossa,C,WSH,32,0,0,0,0
35,8479986,Kole Lind,R,DAL,26,0,0,0,0
35,8479249,Andrew Poturalski,C,SJS,30,0,0,0,0
35,8479362,Riley Tufte,L,BOS,26,0,0,0,0
35,8479991,Jake Leschyshyn,C,NYR,25,0,0,0,0
35,8479587,Rhett Gardner,C,PHI,28,0,0,0,0
35,8482744,James Malatesta,L,CBJ,21,0,0,0,0
35,8478854,Ryan Shea,D,PIT,27,0,0,0,0
35,8481591,Sam Poulin,R,,23,0,0,0,0
35,8483512,Matt Savoie,C,EDM,20,0,0,0,0
35,8482102,Vasily Ponomarev,C,PIT,22,0,0,0,0
35,8482162,Roby Jarventie,L,EDM,22,0,0,0,0
35,8481016,Ruslan Iskhakov,C,,24,0,0,0,0
35,8482172,Landon Slaggert,L,CHI,22,0,0,0,0
35,8482747,Brennan Othmann,L,NYR,21,0,0,0,0
35,8480031,Maxime Comtois,L,,25,0,0,0,0
35,8480226,Marián Studenic,R,,26,0,0,0,0
35,8478408,Travis Dermott,D,,28,0,0,0,0
35,8481518,Nolan Foote,L,NJD,24,0,0,0,0
35,8479419,Brett Murray,L,BUF,26,0,0,0,0
35,8482088,Justin Sourdif,R,FLA,22,0,0,0,0
35,8482201,Gage Goncalves,C,TBL,23,0,0,0,0
35,8481578,Graeme Clarke,R,MIN,23,0,0,0,0
35,8482177,Marat Khusnutdinov,C,MIN,22,0,0,0,0
35,8481754,Nikita Nesterenko,C,ANA,23,0,0,0,0
35,8483531,Brian Halonen,L,NJD,25,0,0,0,0
35,8483920,Pierrick Dube,R,WSH,23,0,0,0,0
35,8480851,Akil Thomas,C,LAK,24,0,0,0,0
35,8475235,Nicolas Deslauriers,L,PHI,33,0,0,0,0
35,8482476,Emil Heineman,L,MTL,23,0,0,0,0
35,8477149,Scott Sabourin,R,SJS,32,0,0,0,0
35,8483549,Lucas Condotta,L,MTL,27,0,0,0,0
35,8482765,Isak Rosen,R,BUF,21,0,0,0,0
35,8481237,Kyle MacLean,C,NYI,25,0,0,0,0
35,8481024,Linus Karlsson,C,VAN,25,0,0,0,0
35,8481690,Tyler Angle,C,,24,0,0,0,0
35,8483570,Ben Meyers,C,SEA,26,0,0,0,0
35,8481655,Cole Schwindt,R,CGY,23,0,0,0,0
35,8481462,Mason Morelli,L,VGK,28,0,0,0,0
35,8483401,Marc Johnstone,R,PIT,28,0,0,0,0
35,8478956,Samuel Laberge,L,NJD,27,0,0,0,0
35,8479533,Joona Koppanen,L,,26,0,0,0,0
35,8482197,Adam Raska,R,MIN,23,0,0,0,0
35,8482250,Callahan Burke,C,VGK,27,0,0,0,0
35,8482784,Zach Dean,C,STL,21,0,0,0,0
35,8484255,Jason Polin,R,COL,25,0,0,0,0
35,8481077,John Leonard,L,,26,0,0,0,0
35,8481534,Raphael Lavoie,C,EDM,24,0,0,0,0
35,8483609,Adam Klapka,R,CGY,24,0,0,0,0
35,8482751,Ryan Winterton,C,SEA,21,0,0,0,0
35,8480267,Sammy Walker,C,MIN,25,0,0,0,0
35,8475766,Austin Watson,L,,32,0,0,0,0
35,8482460,Matt Rempe,C,NYR,22,0,0,0,0
35,8481065,Angus Crookshank,L,OTT,25,0,0,0,0
35,8481070,Hugh McGing,L,,26,0,0,0,0
35,8476323,Max McCormick,L,SEA,32,0,0,0,0
35,8483395,Arshdeep Bains,L,VAN,23,0,0,0,0
35,8484259,Ondrej Pavel,C,COL,31,0,0,0,0
35,8483432,Luca Del Bel Belluz,C,CBJ,31,0,0,0,0
35,8483045,Cameron Butler,R,CBJ,31,0,0,0,0
35,8482061,Brandon Biro,L,SEA,26,0,0,0,0
35,8477401,John Hayden,C,SEA,29,0,0,0,0
35,8475278,Byron Froese,C,,33,0,0,0,0
35,8478446,Glenn Gawdin,C,LAK,27,0,0,0,0
35,8477993,Justin Kirkland,C,CGY,28,0,0,0,0
35,8482147,Jean-Luc Foudy,C,COL,22,0,0,0,0
35,8480032,Shane Bowers,C,NJD,25,0,0,0,0
35,8479330,Brandon Gignac,C,MTL,27,0,0,0,0
35,8480776,Sheldon Rempal,R,,29,0,0,0,0
35,8475413,Justin Dowling,C,NJD,34,0,0,0,0
35,8481726,Adam Edstrom,C,NYR,24,0,0,0,0
35,8480844,Grigori Denisenko,L,VGK,24,0,0,0,0
35,8478147,Bokondji Imama,L,PIT,28,0,0,0,0
35,8478881,Brett Seney,L,CHI,28,0,0,0,0
35,8483630,Pavol Regenda,L,ANA,25,0,0,0,0
35,8480836,Jonathan Gruden,C,,24,0,0,0,0
35,8484314,Jiri Smejkal,L,,28,0,0,0,0
35,8475780,Chris Wagner,R,COL,33,0,0,0,0
35,8479546,Oskar Steen,C,,26,0,0,0,0
35,8483597,Milos Kelemen,L,UTA,25,0,0,0,0
35,8481789,Tye Kartye,L,SEA,23,0,0,0,0
35,8484325,Waltteri Merela,C,TBL,26,0,0,0,0
35,8479421,Jacob Moverare,D,LAK,26,0,0,0,0
35,8481585,Egor Afanasyev,L,SJS,23,0,0,0,0
35,8479547,Matthew Phillips,R,,26,0,0,0,0
35,8479367,William Lockwood,R,FLA,26,0,0,0,0
35,8476915,Jujhar Khaira,L,,30,0,0,0,0
35,8481422,Jacob Lucchini,C,NSH,29,0,0,0,0
35,8480468,James Hamblin,L,EDM,25,0,0,0,0
35,8478051,Max Willman,C,NJD,29,0,0,0,0
35,8481556,John Beecher,C,BOS,23,0,0,0,0
35,8478078,Rourke Chartier,C,,28,0,0,0,0
36,8478402,Connor McDavid,C,EDM,27,82,49,122,171
36,8477492,Nathan MacKinnon,C,COL,29,82,70,76,146
36,8477956,David Pastrnak,R,BOS,28,82,73,66,139
36,8476453,Nikita Kucherov,R,TBL,31,82,36,89,125
36,8479318,Auston Matthews,C,TOR,27,82,66,56,122
36,8478420,Mikko Rantanen,R,COL,28,82,54,66,120
36,8478864,Kirill Kaprizov,L,MIN,27,82,54,63,117
36,8478550,Artemi Panarin,L,NYR,33,82,27,87,114
36,8480069,Cale Makar,D,COL,26,82,31,78,109
36,8477934,Leon Draisaitl,C,EDM,29,82,49,59,108
36,8477493,Aleksander Barkov,C,FLA,29,82,34,73,107
36,8481559,Jack Hughes,C,NJD,23,82,36,68,104
36,8471675,Sidney Crosby,C,PIT,37,82,35,69,104
36,8477946,Dylan Larkin,C,DET,28,82,52,50,102
36,8478398,Kyle Connor,L,WPG,28,82,50,50,100
36,8474564,Steven Stamkos,C,NSH,34,82,44,56,100
36,8479343,Clayton Keller,R,UTA,26,82,44,55,99
36,8476887,Filip Forsberg,L,NSH,30,82,42,56,98
36,8478439,Travis Konecny,R,PHI,27,82,37,61,98
36,8476468,J.T. Miller,C,VAN,31,82,33,65,98
36,8479323,Adam Fox,D,NYR,26,82,18,80,98
36,8475172,Nazem Kadri,C,CGY,34,82,36,61,97
36,8477939,William Nylander,R,TOR,28,82,38,58,96
36,8477942,Kevin Fiala,L,LAK,28,82,31,65,96
36,8482116,Tim Stützle,C,OTT,22,82,28,68,96
36,8479314,Matthew Tkachuk,L,FLA,27,82,39,56,95
36,8477409,Carter Verhaeghe,C,FLA,29,82,40,54,94
36,8480012,Elias Pettersson,C,VAN,26,82,40,54,94
36,8478427,Sebastian Aho,C,CAR,27,82,38,55,93
36,8480023,Robert Thomas,C,STL,25,82,31,62,93
36,8478403,Jack Eichel,C,VGK,28,82,48,43,91
36,8479385,Jordan Kyrou,C,STL,26,82,31,57,88
36,8473419,Brad Marchand,L,BOS,36,82,30,58,88
36,8480800,Quinn Hughes,D,VAN,25,82,19,69,88
36,8476459,Mika Zibanejad,C,NYR,31,82,30,57,87
36,8476456,Jonathan Huberdeau,C,CGY,31,82,26,61,87
36,8481523,Kirby Dach,C,MTL,23,82,24,63,87
36,8480036,Miro Heiskanen,D,DAL,25,82,10,77,87
36,8481557,Matt Boldy,L,MIN,23,82,35,50,85
36,8478010,Brayden Point,C,TBL,28,82,44,40,84
36,8477501,Valeri Nichushkin,R,COL,29,82,37,47,84
36,8480830,Andrei Svechnikov,R,CAR,24,82,34,50,84
36,8471215,Evgeni Malkin,C,PIT,38,82,31,52,83
36,8480801,Brady Tkachuk,L,OTT,25,82,42,40,82
36,8480002,Nico Hischier,C,NJD,25,82,28,54,82
36,8477949,Alex Tuch,R,BUF,28,82,27,55,82
36,8478407,Vince Dunn,D,SEA,28,82,23,59,82
36,8477402,Pavel Buchnevich,L,STL,29,82,37,43,80
36,8480027,Jason Robertson,L,DAL,25,82,30,50,80
36,8477447,Shea Theodore,D,VGK,29,82,14,66,80
36,8475184,Chris Kreider,L,NYR,33,82,44,35,79
36,8477933,Sam Reinhart,C,FLA,29,82,39,40,79
36,8475166,John Tavares,C,TOR,34,82,36,43,79
36,8476460,Mark Scheifele,C,WPG,31,82,34,45,79
36,8476389,Vincent Trocheck,C,NYR,31,82,34,44,78
36,8480039,Martin Necas,C,CAR,25,82,33,45,78
36,8477504,Josh Morrissey,D,WPG,29,82,12,66,78
36,8478042,Viktor Arvidsson,R,EDM,31,82,33,44,77
36,8476448,William Karlsson,C,VGK,31,82,33,44,77
36,8478445,Mathew Barzal,C,NYI,27,82,19,58,77
36,8475786,Zach Hyman,L,EDM,32,82,47,29,76
36,8477940,Nikolaj Ehlers,L,WPG,28,82,27,49,76
36,8479407,Jesper Bratt,L,NJD,26,82,26,50,76
36,8477951,Nick Schmaltz,C,UTA,28,82,24,52,76
36,8475167,Victor Hedman,D,TBL,34,82,19,57,76
36,8474578,Erik Karlsson,D,PIT,34,82,10,66,76
36,8475913,Mark Stone,R,VGK,32,82,26,49,75
36,8477500,Bo Horvat,C,NYI,29,82,39,35,74
36,8475170,Brayden Schenn,C,STL,33,82,33,41,74
36,8480208,Drake Batherson,R,OTT,26,82,26,48,74
36,8480803,Evan Bouchard,D,EDM,25,82,13,61,74
36,8478444,Brock Boeser,R,VAN,27,82,38,35,73
36,8480018,Nick Suzuki,C,MTL,25,82,33,40,73
36,8479339,Patrik Laine,L,CBJ,26,82,32,41,73
36,8476346,Johnny Gaudreau,L,CBJ,31,82,6,67,73
36,8479675,Trevor Moore,L,LAK,29,82,36,36,72
36,8481540,Cole Caufield,R,MTL,23,82,36,36,72
36,8475692,Mats Zuccarello,R,MIN,37,82,26,46,72
36,8478414,Timo Meier,R,NJD,28,82,32,39,71
36,8473994,Jamie Benn,L,DAL,35,82,32,39,71
36,8474600,Roman Josi,D,NSH,34,82,24,47,71
36,8473512,Claude Giroux,R,OTT,36,82,20,51,71
36,8477476,Artturi Lehkonen,L,COL,29,82,39,31,70
36,8476539,Jonathan Marchessault,R,NSH,34,82,38,32,70
36,8475810,Bryan Rust,R,PIT,32,82,37,33,70
36,8478449,Roope Hintz,C,DAL,28,82,34,36,70
36,8480015,Owen Tippett,R,PHI,25,82,31,39,70
36,8475168,Matt Duchene,C,DAL,33,82,30,40,70
36,8476462,Dougie Hamilton,D,NJD,31,82,21,49,70
36,8479420,Tage Thompson,C,BUF,27,82,33,36,69
36,8475158,Ryan O'Reilly,C,NSH,33,82,29,40,69
36,8482093,Seth Jarvis,C,CAR,22,82,27,42,69
36,8482665,Matty Beniers,C,SEA,22,82,25,44,69
36,8478440,Dylan Strome,C,WSH,27,82,24,45,69
36,8480865,Noah Dobson,D,NYI,24,82,11,58,69
36,8478493,Joel Eriksson Ek,C,MIN,27,82,33,35,68
36,8476881,Tomas Hertl,C,VGK,31,82,25,43,68
36,8471214,Alex Ovechkin,L,WSH,39,82,26,41,67
36,8476454,Ryan Nugent-Hopkins,C,EDM,31,82,24,43,67
36,8478975,Mason Marchment,L,DAL,29,82,24,42,66
36,8477479,Tyler Bertuzzi,L,CHI,29,82,23,43,66
36,8481533,Trevor Zegras,C,ANA,23,82,20,46,66
36,8478460,Zach Werenski,D,CBJ,27,82,15,51,66
36,8477955,Jared McCann,L,SEA,28,82,35,30,65
36,8477404,Jake Guentzel,C,TBL,30,82,31,34,65
36,8471724,Kris Letang,D,PIT,37,82,21,44,65
36,8479999,Casey Mittelstadt,C,COL,26,82,15,50,65
36,8479325,Charlie McAvoy,D,BOS,27,82,10,55,65
36,8481528,Dylan Cozens,C,BUF,23,82,30,34,64
36,8471698,T.J. Oshie,R,WSH,38,82,33,30,63
36,8475765,Vladimir Tarasenko,R,DET,33,82,31,32,63
36,8475754,Brock Nelson,C,NYI,33,82,28,35,63
36,8482078,Lucas Raymond,L,DET,22,82,21,42,63
36,8478038,Devon Toews,D,COL,30,82,13,50,63
36,8474141,Patrick Kane,R,DET,36,82,29,33,62
36,8477496,Elias Lindholm,C,BOS,30,82,26,36,62
36,8475745,Charlie Coyle,C,BOS,32,82,22,40,62
36,8479337,Alex DeBrincat,R,DET,27,82,20,42,62
36,8471685,Anze Kopitar,C,LAK,37,82,15,47,62
36,8476399,Blake Coleman,C,CGY,33,82,34,27,61
36,8476479,Phillip Danault,C,LAK,31,82,21,40,61
36,8474679,Gustav Nyquist,C,NSH,35,82,19,42,61
36,8474590,John Carlson,D,WSH,34,82,9,52,61
36,8477497,Sean Monahan,C,CBJ,30,82,29,31,60
36,8474565,Alex Pietrangelo,D,VGK,34,82,12,48,60
36,8478366,Frank Vatrano,R,ANA,30,82,32,27,59
36,8478401,Pavel Zacha,C,BOS,27,82,28,31,59
36,8475726,Tyler Toffoli,C,SJS,32,82,25,34,59
36,8477960,Adrian Kempe,R,LAK,28,82,23,36,59
36,8480839,Rasmus Dahlin,D,BUF,24,82,21,38,59
36,8478873,Troy Terry,R,ANA,27,82,30,28,58
36,8480028,Morgan Frost,C,PHI,25,82,28,30,58
36,8480014,Gabriel Vilardi,C,WPG,25,82,27,31,58
36,8475784,Jeff Skinner,C,EDM,32,82,24,34,58
36,8478047,Michael Bunting,L,PIT,29,82,23,35,58
36,8476432,Boone Jenner,C,CBJ,31,82,35,22,57
36,8482109,Alexis Lafrenière,L,NYR,23,82,32,25,57
36,8482745,Mason McTavish,C,ANA,21,82,28,29,57
36,8482159,Tyson Foerster,R,PHI,22,82,24,33,57
36,8479542,Brandon Hagel,L,TBL,26,82,23,34,57
36,8475798,Mikael Granlund,C,SJS,32,82,13,44,57
36,8479425,Filip Hronek,D,VAN,27,82,12,45,57
36,8475793,Ryan Johansen,C,PHI,32,82,27,29,56
36,8475191,Reilly Smith,R,NYR,33,82,24,32,56
36,8474102,David Perron,L,OTT,36,82,23,33,56
36,8477964,Ivan Barbashev,C,VGK,29,82,20,36,56
36,8477416,Oliver Bjorkstrand,R,SEA,29,82,19,37,56
36,8478397,Rasmus Andersson,D,CGY,28,82,11,45,56
36,8482097,Jack Quinn,R,BUF,23,82,21,34,55
36,8474586,Jordan Eberle,R,SEA,34,82,19,36,55
36,8475799,Nino Niederreiter,R,WPG,32,82,37,17,54
36,8477456,J.T. Compher,L,DET,29,82,24,30,54
36,8478458,Jack Roslovic,C,CAR,27,82,21,33,54
36,8476853,Morgan Rielly,D,TOR,30,82,11,43,54
36,8479410,Mikhail Sergachev,D,UTA,26,82,10,44,54
36,8476880,Tom Wilson,R,WSH,30,82,31,22,53
36,8482124,Quinton Byfield,R,LAK,22,82,21,32,53
36,8476792,Torey Krug,D,STL,33,82,18,35,53
36,8477346,MacKenzie Weegar,D,CGY,30,82,7,46,53
36,8474641,Adam Henrique,C,EDM,34,82,30,22,52
36,8482740,Wyatt Johnston,C,DAL,21,82,26,26,52
36,8482667,William Eklund,L,SJS,22,82,24,28,52
36,8473986,Alex Killorn,L,ANA,35,82,21,31,52
36,8480829,Jesperi Kotkaniemi,C,CAR,24,82,21,31,52
36,8477494,Jonathan Drouin,L,COL,29,82,18,34,52
36,8476906,Shayne Gostisbehere,D,CAR,31,82,13,39,52
36,8478438,Tommy Novak,C,NSH,27,82,13,39,52
36,8477503,Max Domi,C,TOR,29,82,12,40,52
36,8482175,JJ Peterka,R,BUF,22,82,25,26,51
36,8475169,Evander Kane,L,EDM,33,82,23,28,51
36,8476483,Rickard Rakell,R,PIT,31,82,20,31,51
36,8478519,Anthony Cirelli,C,TBL,27,82,18,33,51
36,8480220,Noah Cates,L,PHI,25,82,18,33,51
36,8480078,Filip Chytil,C,NYR,25,82,17,34,51
36,8482105,Jake Sanderson,D,OTT,22,82,16,35,51
36,8480797,Joel Farabee,L,PHI,24,82,15,36,51
36,8482660,Kent Johnson,C,CBJ,22,82,15,36,51
36,8474716,Jared Spurgeon,D,MIN,35,82,14,37,51
36,8481711,Matias Maccelli,L,UTA,24,82,12,39,51
36,8482684,Luke Hughes,D,NJD,21,82,8,43,51
36,8476875,Mike Matheson,D,MTL,30,82,7,44,51
36,8475791,Taylor Hall,L,CHI,33,82,25,25,50
36,8476905,Chandler Stephenson,C,SEA,30,82,15,35,50
36,8481581,Thomas Harley,D,DAL,23,82,15,35,50
36,8478462,Nicolas Roy,C,VGK,27,82,14,36,50
36,8477932,Aaron Ekblad,D,FLA,28,82,13,37,50
36,8478498,Jake DeBrusk,L,VAN,28,82,28,21,49
36,8475794,Tyler Seguin,C,DAL,32,82,23,26,49
36,8476882,Teuvo Teravainen,L,CHI,30,82,20,29,49
36,8477451,Ryan Hartman,R,MIN,30,82,18,31,49
36,8474150,Mikael Backlund,C,CGY,35,82,16,33,49
36,8475764,Cam Fowler,D,ANA,33,82,7,42,49
36,8482110,Dawson Mercer,C,NJD,23,82,27,21,48
36,8478474,Lawson Crouse,L,UTA,27,82,23,25,48
36,8477986,Brandon Montour,D,SEA,30,82,21,27,48
36,8477407,Anthony Duclair,L,NYI,29,82,19,29,48
36,8478472,Mathieu Joseph,R,STL,27,82,16,32,48
36,8477495,Seth Jones,D,CHI,30,82,9,39,48
36,8479525,Ross Colton,C,COL,28,82,22,25,47
36,8482149,Cole Perfetti,C,WPG,22,82,18,29,47
36,8476872,Scott Laughton,C,PHI,30,82,15,32,47
36,8474563,Drew Doughty,D,LAK,35,82,10,37,47
36,8481546,Cam York,D,PHI,23,82,8,39,47
36,8475763,Kevin Hayes,R,PIT,32,82,24,22,46
36,8477987,Ryan Donato,C,CHI,28,82,24,22,46
36,8479365,Trent Frederic,C,BOS,26,82,23,23,46
36,8477935,Sam Bennett,C,FLA,28,82,21,25,46
36,8482146,Luke Evangelista,R,NSH,22,82,18,28,46
36,8476329,Travis Boyd,C,MIN,31,82,14,32,46
36,8482113,Anton Lundell,C,FLA,23,82,13,33,46
36,8478055,Gustav Forsling,D,FLA,28,82,12,34,46
36,8479345,Jakob Chychrun,D,WSH,26,82,12,34,46
36,8476923,Damon Severson,D,CBJ,30,82,10,36,46
36,8478396,Noah Hanifin,D,VGK,27,82,7,39,46
36,8483808,Andrei Kuzmenko,L,CGY,28,82,26,19,45
36,8482699,Dylan Guenther,R,UTA,21,82,25,20,45
36,8481068,Yegor Sharangovich,C,CGY,26,82,23,22,45
36,8482475,Yegor Chinakhov,R,CBJ,23,82,23,22,45
36,8480185,Eetu Luostarinen,C,FLA,26,82,21,24,45
36,8477998,Warren Foegele,L,LAK,28,82,21,24,45
36,8479400,Pierre-Luc Dubois,L,WSH,26,82,18,27,45
36,8482705,Cole Sillinger,C,CBJ,21,82,17,28,45
36,8477444,Andre Burakovsky,L,SEA,29,82,16,29,45
36,8480068,Ryan Poehling,C,PHI,25,82,24,20,44
36,8478413,Jordan Greenway,L,BUF,27,82,21,23,44
36,8475768,Jaden Schwartz,C,SEA,32,82,11,33,44
36,8476854,Hampus Lindholm,D,BOS,30,82,8,36,44
36,8480009,Eeli Tolvanen,R,SEA,25,82,25,18,43
36,8478233,Andrew Mangiapane,L,WSH,28,82,22,21,43
36,8477953,Kasperi Kapanen,R,STL,28,82,21,22,43
36,8478115,Pierre Engvall,L,NYI,28,82,21,22,43
36,8480188,Fabian Zetterlund,L,SJS,25,82,16,27,43
36,8480798,Philipp Kurashev,C,CHI,25,82,12,31,43
36,8478542,Evan Rodrigues,C,FLA,31,82,24,18,42
36,8479987,Morgan Geekie,C,BOS,26,82,21,21,42
36,8478463,Anthony Beauvillier,L,PIT,27,82,20,22,42
36,8478057,Dakota Joshua,C,VAN,28,82,17,25,42
36,8477952,Robby Fabbri,C,ANA,28,82,14,28,42
36,8483515,Juraj Slafkovsky,L,MTL,20,82,12,30,42
36,8480434,Sean Durzi,D,UTA,26,82,12,30,42
36,8481542,Moritz Seider,D,DET,23,82,6,36,42
36,8478020,Michael Amadio,C,OTT,28,82,21,20,41
36,8474149,Evgenii Dadonov,R,DAL,35,82,15,26,41
36,8477511,Anthony Mantha,R,CGY,30,82,14,27,41
36,8482720,Matthew Knies,L,TOR,22,82,14,27,41
36,8470613,Brent Burns,D,CAR,39,82,12,29,41
36,8478469,Thomas Chabot,D,OTT,27,82,11,30,41
36,8477498,Darnell Nurse,D,EDM,29,82,11,30,41
36,8475753,Justin Faulk,D,STL,32,82,10,31,41
36,8475218,Mattias Ekholm,D,EDM,34,82,10,31,41
36,8480871,Adam Boqvist,D,FLA,24,82,10,31,41
36,8482671,Owen Power,D,BUF,22,82,8,33,41
36,8477426,Nicholas Paul,L,TBL,29,82,22,18,40
36,8481554,Kaapo Kakko,R,NYR,23,82,22,18,40
36,8480064,Josh Norris,C,OTT,25,82,18,22,40
36,8481560,Arthur Kaliyev,R,LAK,23,82,17,23,40
36,8477021,Alex Kerfoot,C,UTA,30,82,16,24,40
36,8484153,Leo Carlsson,C,ANA,20,82,16,24,40
36,8477429,Andrew Copp,C,DET,30,82,13,27,40
36,8480817,K'Andre Miller,D,NYR,24,82,12,28,40
36,8481481,Blake Lizotte,C,PIT,27,82,12,28,40
36,8476958,Jaccob Slavin,D,CAR,30,82,10,30,40
36,8482055,Drew O'Connor,L,PIT,26,82,29,10,39
36,8479941,Justin Danforth,R,CBJ,31,82,23,16,39
36,8481580,Connor McMichael,C,WSH,23,82,21,18,39
36,8481624,Ilya Mikheyev,R,CHI,30,82,19,20,39
36,8476292,Ondrej Palat,L,NJD,33,82,18,21,39
36,8475314,Anders Lee,L,NYI,34,82,18,21,39
36,8484144,Connor Bedard,C,CHI,19,82,18,21,39
36,8475722,Jason Zucker,L,BUF,32,82,17,22,39
36,8478856,Conor Garland,R,VAN,28,82,13,26,39
36,8477948,Travis Sanheim,D,PHI,28,82,9,30,39
36,8476885,Jacob Trouba,D,NYR,30,82,9,30,39
36,8476979,Erik Gustafsson,D,DET,32,82,3,36,39
36,8479369,Andrew Peeke,D,BOS,26,82,1,38,39
36,8481604,Pavel Dorofeyev,L,VGK,24,82,23,15,38
36,8481596,Shane Pinto,C,OTT,24,82,18,20,38
36,8481582,Nicholas Robertson,L,TOR,23,82,18,20,38
36,8475287,Erik Haula,L,NJD,33,82,17,21,38
36,8480835,Jack Drury,C,CAR,24,82,15,23,38
36,8470621,Corey Perry,R,EDM,39,82,15,23,38
36,8478133,Jake Evans,C,MTL,28,82,9,29,38
36,8482122,Brock Faber,D,MIN,22,82,8,30,38
36,8482087,Kaiden Guhle,D,MTL,22,82,5,33,38
36,8477989,Christian Dvorak,C,MTL,28,82,22,15,37
36,8476474,Stefan Noesen,R,NJD,31,82,21,16,37
36,8476826,Yanni Gourde,C,SEA,33,82,17,20,37
36,8482092,Ridly Greig,C,OTT,22,82,15,22,37
36,8481618,Alex Newhook,C,MTL,23,82,10,27,37
36,8480145,Neal Pionk,D,WPG,29,82,10,27,37
36,8475848,Brendan Gallagher,R,MTL,32,82,19,17,36
36,8476461,Sean Couturier,C,PHI,32,82,15,21,36
36,8480459,Pius Suter,C,VAN,28,82,13,23,36
36,8480336,Sean Walker,D,CAR,30,82,10,26,36
36,8476480,Vladislav Namestnikov,C,WPG,32,82,10,26,36
36,8478911,Matt Roy,D,WSH,29,82,8,28,36
36,8476917,Adam Pelech,D,NYI,30,82,8,28,36
36,8481032,Paul Cotter,C,NJD,25,82,24,11,35
36,8478109,Victor Olofsson,L,VGK,29,82,22,13,35
36,8475760,Nick Bjugstad,C,UTA,32,82,21,14,35
36,8479992,Michael Rasmussen,C,DET,25,82,21,14,35
36,8473533,Jordan Staal,C,CAR,36,82,21,14,35
36,8475151,Kyle Palmieri,C,NYI,33,82,18,17,35
36,8473563,Nicklas Backstrom,C,WSH,37,82,17,18,35
36,8477919,Frederick Gaudreau,C,MIN,31,82,15,20,35
36,8475149,Marcus Johansson,L,MIN,34,82,14,21,35
36,8476892,Colton Parayko,D,STL,31,82,13,22,35
36,8482624,Daniil Miromanov,D,CGY,27,82,11,24,35
36,8476891,Matt Grzelcyk,D,PIT,30,82,7,28,35
36,8478851,Alexandre Carrier,D,NSH,28,82,3,32,35
36,8481186,Logan O'Connor,R,COL,28,82,14,20,34
36,8482074,Connor Zary,C,CGY,23,82,11,23,34
36,8476392,Adam Lowry,C,WPG,31,82,10,24,34
36,8481656,Aliaksei Protas,C,WSH,23,82,10,24,34
36,8476869,Brady Skjei,D,NSH,30,82,9,25,34
36,8480073,Erik Brannstrom,D,COL,25,82,6,28,34
36,8473507,Jeff Petry,D,DET,37,82,3,31,34
36,8480893,Kirill Marchenko,R,CBJ,24,82,19,14,33
36,8482125,Alexander Holtz,R,VGK,22,82,18,15,33
36,8476981,Josh Anderson,R,MTL,30,82,17,16,33
36,8482117,Lukas Reichel,L,CHI,22,82,14,19,33
36,8476873,Mark Jankowski,C,NSH,30,82,14,19,33
36,8476925,Colton Sissons,C,NSH,31,82,13,20,33
36,8481553,Bobby Brink,R,PHI,23,82,12,21,33
36,8474053,Logan Couture,C,SJS,35,82,12,21,33
36,8479661,Tanner Jeannot,L,LAK,27,82,12,21,33
36,8475171,Oliver Ekman-Larsson,D,TOR,33,82,12,21,33
36,8480043,Timothy Liljegren,D,TOR,25,82,8,25,33
36,8482655,J.J. Moser,D,TBL,24,82,6,27,33
36,8479390,Taylor Raddysh,R,WSH,26,82,18,14,32
36,8482111,Justin Barron,D,MTL,23,82,17,15,32
36,8476889,Radek Faksa,C,STL,30,82,17,15,32
36,8473422,Nick Foligno,L,CHI,37,82,16,16,32
36,8479996,Cody Glass,C,NSH,25,82,15,17,32
36,8480849,Barrett Hayton,C,UTA,24,82,14,18,32
36,8479351,Sam Steel,C,DAL,26,82,14,18,32
36,8477947,Sonny Milano,L,WSH,28,82,13,19,32
36,8475343,Nic Dowd,C,WSH,34,82,13,19,32
36,8482089,Jake Neighbours,L,STL,22,82,12,20,32
36,8482141,Lukas Cormier,D,VGK,22,82,12,20,32
36,8478046,Danton Heinen,L,VAN,29,82,7,25,32
36,8475690,Chris Tanev,D,TOR,35,82,2,30,32
36,8478136,Jake Middleton,D,MIN,28,82,0,32,32
36,8480995,Pontus Holmberg,R,TOR,25,82,17,14,31
36,8483431,Logan Cooley,C,UTA,20,82,17,14,31
36,8480748,Kiefer Sherwood,L,VAN,29,82,16,15,31
36,8480113,Alex Iafallo,L,WPG,31,82,16,15,31
36,8476438,Brandon Saad,L,STL,32,82,15,16,31
36,8476921,Jordan Martinook,L,CAR,32,82,13,18,31
36,8475193,Tomas Tatar,L,NJD,34,82,13,18,31
36,8476927,Teddy Blueger,C,VAN,30,82,11,20,31
36,8478882,Vladislav Gavrikov,D,LAK,29,82,8,23,31
36,8480873,Rasmus Sandin,D,WSH,24,82,7,24,31
36,8477488,Brett Pesce,D,NJD,30,82,4,27,31
36,8475181,Nick Leddy,D,STL,33,82,4,27,31
36,8481535,Nils Hoglander,L,VAN,24,82,18,12,30
36,8480789,Oliver Wahlstrom,R,NYI,24,82,16,14,30
36,8477499,Rasmus Ristolainen,D,PHI,30,82,14,16,30
36,8476960,Andreas Athanasiou,C,CHI,30,82,14,16,30
36,8478508,Yakov Trenin,C,MIN,27,82,14,16,30
36,8477450,Jason Dickinson,C,CHI,29,82,12,18,30
36,8482666,Scott Morrow,D,CAR,22,82,12,18,30
36,8475714,Calle Jarnkrok,C,TOR,33,82,10,20,30
36,8476419,Jean-Gabriel Pageau,C,NYI,32,82,10,20,30
36,8476463,Jonas Brodin,D,MIN,31,82,3,27,30
36,8475842,Sam Carrick,C,NYR,32,82,16,13,29
36,8476374,Sean Kuraly,C,CBJ,31,82,15,14,29
36,8476458,Ryan Strome,C,ANA,31,82,14,15,29
36,8474189,Lars Eller,C,PIT,35,82,14,15,29
36,8477392,Hudson Fasching,R,NYI,29,82,13,16,29
36,8480003,Jesper Boqvist,C,FLA,26,82,13,16,29
36,8481013,Jonatan Berggren,R,DET,24,82,12,17,29
36,8478432,Christian Fischer,R,DET,27,82,10,19,29
36,8475200,Dmitry Orlov,D,CAR,33,82,8,21,29
36,8482803,Olen Zellweger,D,ANA,21,82,8,21,29
36,8476467,Jamie Oleksiak,D,SEA,32,82,5,24,29
36,8474673,TJ Brodie,D,CHI,34,82,2,27,29
36,8481178,Egor Zamula,D,PHI,24,82,1,28,29
36,8479393,Noah Gregor,C,OTT,26,82,20,8,28
36,8480813,Joe Veleno,C,DET,24,82,15,13,28
36,8481093,Rafael Harvey-Pinard,L,MTL,25,82,15,13,28
36,8478434,Keegan Kolesar,R,VGK,27,82,14,14,28
36,8480144,David Kampf,C,TOR,29,82,12,16,28
36,8476331,Dylan DeMelo,D,WPG,31,82,6,22,28
36,8478840,Will Borgen,D,SEA,28,82,6,22,28
36,8479402,Jake Bean,D,CGY,26,82,6,22,28
36,8479398,Samuel Girard,D,COL,26,82,4,24,28
36,8475790,Erik Gudbranson,D,CBJ,32,82,2,26,28
36,8476878,Zemgus Girgensons,L,TBL,30,82,18,9,27
36,8477425,Miles Wood,L,COL,29,82,15,12,27
36,8481477,Nico Sturm,C,SJS,29,82,15,12,27
36,8478891,Mason Appleton,C,WPG,28,82,14,13,27
36,8481704,Juuso Parssinen,C,NSH,23,82,14,13,27
36,8479353,Brett Howden,C,VGK,26,82,12,15,27
36,8476278,Colin Blackwell,C,DAL,31,82,12,15,27
36,8480855,Jack McBain,C,UTA,24,82,10,17,27
36,8480074,Alexandre Texier,C,STL,25,82,9,18,27
36,8477969,Marcus Pettersson,D,PIT,28,82,7,20,27
36,8476525,Colin Miller,D,WPG,32,82,7,20,27
36,8477507,Nikita Zadorov,D,BOS,29,82,7,20,27
36,8480807,Mattias Samuelsson,D,BUF,24,82,5,22,27
36,8480049,Dylan Samberg,D,WPG,25,82,3,24,27
36,8479293,Brandon Tanev,L,SEA,33,82,18,8,26
36,8482079,Marco Rossi,C,MIN,23,82,17,9,26
36,8478569,Noel Acciari,C,PIT,33,82,15,11,26
36,8475220,Marcus Foligno,L,MIN,33,82,11,15,26
36,8480806,Isac Lundestrom,C,ANA,25,82,9,17,26
36,8477435,Ryan Graves,D,PIT,29,82,7,19,26
36,8481568,Alex Vlasic,D,CHI,23,82,6,20,26
36,8478500,Ivan Provorov,D,CBJ,27,82,5,21,26
36,8475233,David Savard,D,MTL,34,82,5,21,26
36,8474151,Ryan McDonagh,D,TBL,35,82,4,22,26
36,8477506,Ryan Pulock,D,NYI,30,82,4,22,26
36,8476931,Jake McCabe,D,TOR,31,82,3,23,26
36,8475279,Ben Chiarot,D,DET,33,82,2,24,26
36,8479976,Juuso Valimaki,D,UTA,26,82,1,25,26
36,8478013,Jake Walman,D,SJS,28,82,12,13,25
36,8477406,Mattias Janmark,C,EDM,32,82,12,13,25
36,8480448,Parker Kelly,L,COL,25,82,12,13,25
36,8479414,Nathan Bastian,R,NJD,27,82,10,15,25
36,8483524,Shane Wright,C,SEA,20,82,10,15,25
36,8483763,Maksymilian Szuber,D,UTA,22,82,9,16,25
36,8479359,Beck Malenstyn,L,BUF,26,82,9,16,25
36,8480796,Martin Fehervary,D,WSH,25,82,7,18,25
36,8477839,Conor Sheary,L,TBL,32,82,7,18,25
36,8484203,Bradly Nadeau,L,CAR,19,82,6,19,25
36,8476457,Adam Larsson,D,SEA,32,82,4,21,25
36,8480222,Sebastian Aho,D,PIT,28,82,4,21,25
36,8476879,Cody Ceci,D,EDM,31,82,3,22,25
36,8476469,Joel Armia,R,MTL,31,82,15,9,24
36,8481517,Brett Leason,R,ANA,25,82,10,14,24
36,8477015,Connor Brown,R,EDM,30,82,9,15,24
36,8482659,Josh Doan,R,UTA,22,82,9,15,24
36,8478211,Dryden Hunt,L,CGY,29,82,9,15,24
36,8482142,Jamie Drysdale,D,PHI,22,82,8,16,24
36,8475855,Jesper Fast,R,CAR,33,82,8,16,24
36,8476902,Esa Lindell,D,DAL,30,82,5,19,24
36,8475188,Brayden McNabb,D,VGK,33,82,4,20,24
36,8478507,John Marino,D,UTA,27,82,2,22,24
36,8478399,Jonas Siegenthaler,D,NJD,27,82,2,22,24
36,8477505,Alexander Wennberg,C,SJS,30,82,12,11,23
36,8476918,Jimmy Vesey,L,NYR,31,82,11,12,23
36,8482062,Cole Smith,L,NSH,29,82,11,12,23
36,8481708,Zac Jones,D,NYR,24,82,11,12,23
36,8477353,Tyler Motte,C,DET,29,82,10,13,23
36,8476624,Barclay Goodrow,C,SJS,31,82,9,14,23
36,8483012,Logan Morrison,C,SEA,22,82,9,14,23
36,8476897,Oskar Sundqvist,C,STL,30,82,7,16,23
36,8477335,Kyle Burroughs,D,LAK,29,82,7,16,23
36,8475462,Radko Gudas,D,ANA,34,82,6,17,23
36,8483490,Pavel Mintyukov,D,ANA,21,82,5,18,23
36,8482245,Artem Zub,D,OTT,29,82,5,18,23
36,8477845,Trevor van Riemsdyk,D,WSH,33,82,3,20,23
36,8477365,Connor Clifton,D,BUF,29,82,3,20,23
36,8476967,Brett Kulak,D,EDM,30,82,3,20,23
36,8480035,Henri Jokiharju,D,BUF,25,82,1,22,23
36,8484166,Adam Fantilli,C,CBJ,20,82,14,8,22
36,8482702,Logan Stankoven,C,DAL,21,82,14,8,22
36,8473453,Trevor Lewis,C,LAK,37,82,12,10,22
36,8484145,Zach Benson,L,BUF,19,82,10,12,22
36,8483457,Lane Hutson,D,MTL,20,82,10,12,22
36,8480980,Connor Dewar,C,TOR,25,82,10,12,22
36,8482133,Thomas Bordeleau,C,SJS,22,82,9,13,22
36,8482259,Bobby McMann,C,TOR,28,82,9,13,22
36,8482166,Shakir Mukhamadullin,D,SJS,22,82,9,13,22
36,8477369,Carson Soucy,D,VAN,30,82,9,13,22
36,8481606,Jordan Spence,D,LAK,23,82,8,14,22
36,8479980,Nicolas Hague,D,VGK,26,82,5,17,22
36,8481014,Alexander Romanov,D,NYI,24,82,5,17,22
36,8480802,Ryan McLeod,C,BUF,25,82,4,18,22
36,8483495,Simon Nemec,D,NJD,20,82,3,19,22
36,8474574,Tyler Myers,D,VAN,34,82,3,19,22
36,8479998,Mikey Anderson,D,LAK,25,82,2,20,22
36,8482155,Alex Laferriere,R,LAK,23,82,14,7,21
36,8479316,Luke Kunin,C,SJS,27,82,11,10,21
36,8474715,Cam Atkinson,R,TBL,35,82,11,10,21
36,8481601,Simon Holmstrom,R,NYI,23,82,10,11,21
36,8479368,Max Jones,L,BOS,26,82,9,12,21
36,8475231,Casey Cizikas,C,NYI,33,82,8,13,21
36,8484149,Gavin Brindley,C,CBJ,20,82,7,14,21
36,8476312,Josh Manson,D,COL,33,82,6,15,21
36,8479983,Mario Ferraro,D,SJS,26,82,6,15,21
36,8482470,Ilya Solovyov,D,CGY,24,82,6,15,21
36,8480950,Ilya Lyubushkin,D,DAL,30,82,5,16,21
36,8478416,Erik Cernak,D,TBL,27,82,1,20,21
36,8479291,Kevin Rooney,C,CGY,31,82,11,9,20
36,8476858,Phillip Di Giuseppe,L,VAN,31,82,11,9,20
36,8481524,Bowen Byram,D,BUF,23,82,11,9,20
36,8481522,Peyton Krebs,C,BUF,23,82,9,11,20
36,8475324,Nick Jensen,D,OTT,34,82,6,14,20
36,8480878,Nils Lundkvist,D,DAL,24,82,5,15,20
36,8481567,Henry Thrun,D,SJS,23,82,5,15,20
36,8477034,Jaycob Megna,D,FLA,32,82,5,15,20
36,8477220,Nate Schmidt,D,FLA,33,82,3,17,20
36,8477903,Garnet Hathaway,R,PHI,33,82,11,8,19
36,8481028,Martin Pospisil,C,CGY,25,82,10,9,19
36,8480281,Alexey Toropchenko,R,STL,25,82,10,9,19
36,8477931,Tomas Nosek,L,FLA,32,82,10,9,19
36,8480021,Jack Studnicka,C,LAK,25,82,9,10,19
36,8482858,Ryker Evans,D,SEA,23,82,9,10,19
36,8483499,Liam Ohgren,L,MIN,20,82,8,11,19
36,8482713,Mackie Samoskevich,R,FLA,22,82,8,11,19
36,8477508,Curtis Lazar,C,NJD,29,82,7,12,19
36,8480172,Jan Rutta,D,SJS,34,82,5,14,19
36,8480860,Kevin Bahl,D,CGY,24,82,4,15,19
36,8483565,Nick Blankenburg,D,NSH,26,82,3,16,19
36,8479576,Vincent Desharnais,D,VAN,28,82,3,16,19
36,8479591,Michael Eyssimont,C,TBL,28,82,10,8,18
36,8481122,Simon Benoit,D,TOR,26,82,6,12,18
36,8479442,Troy Stecher,D,EDM,30,82,4,14,18
36,8479371,Dante Fabbro,D,NSH,26,82,3,15,18
36,8482516,Matthew Kessel,D,STL,24,82,3,15,18
36,8482679,Matt Coronato,R,CGY,22,82,11,6,17
36,8480025,MacKenzie Entwistle,R,FLA,25,82,8,9,17
36,8482077,Dylan Holloway,L,EDM,23,82,8,9,17
36,8483482,Tristan Luneau,D,ANA,20,82,7,10,17
36,8482809,Jackson Blake,R,CAR,21,82,7,10,17
36,8478443,Brandon Carlo,D,BOS,28,82,5,12,17
36,8475455,Brenden Dillon,D,NJD,34,82,4,13,17
36,8482807,Ethan Del Mastro,D,CHI,21,82,4,13,17
36,8482749,Joshua Roy,R,MTL,21,82,4,13,17
36,8477938,Haydn Fleury,D,WPG,28,82,3,14,17
36,8474013,Ian Cole,D,UTA,35,82,3,14,17
36,8480834,Ty Emberson,D,SJS,24,82,3,14,17
36,8482073,Braden Schneider,D,NYR,23,82,0,17,17
36,8481699,Aku Raty,R,UTA,23,82,8,8,16
36,8479638,Justin Brazeau,R,BOS,26,82,8,8,16
36,8476422,Mike Reilly,D,NYI,31,82,6,10,16
36,8480990,Declan Chisholm,D,MIN,24,82,4,12,16
36,8478468,Jeremy Lauzon,D,NSH,27,82,4,12,16
36,8481605,Jackson LaCombe,D,ANA,23,82,2,14,16
36,8478859,Niko Mikkola,D,FLA,28,82,0,16,16
36,8481641,Joel Kiviranta,L,COL,28,82,6,9,15
36,8482153,Brendan Brisson,C,VGK,23,82,4,11,15
36,8482733,Logan Mailloux,D,MTL,31,82,4,11,15
36,8470600,Ryan Suter,D,STL,39,82,2,13,15
36,8478450,Parker Wotherspoon,D,BOS,27,82,2,13,15
36,8476372,Nick Seeler,D,PHI,31,82,2,13,15
36,8475718,Justin Holl,D,DET,32,82,2,13,15
36,8476429,Scott Mayfield,D,NYI,32,82,1,14,15
36,8480879,Jacob Bernard-Docker,D,OTT,24,82,1,14,15
36,8483397,Marc McLaughlin,C,BOS,25,82,10,4,14
36,8480246,Nick Perbix,D,TBL,26,82,7,7,14
36,8484911,Collin Graf,R,SJS,22,82,6,8,14
36,8476442,Matt Nieto,L,PIT,32,82,5,9,14
36,8483460,David Jiricek,D,CBJ,21,82,5,9,14
36,8483493,Frank Nazar,C,CHI,20,82,4,10,14
36,8483445,Cutter Gauthier,L,ANA,20,82,3,11,14
36,8476441,Joel Edmundson,D,LAK,31,82,3,11,14
36,8479324,Ryan Lindgren,D,NYR,26,82,3,11,14
36,8482101,Danil Gushchin,L,SJS,22,82,3,10,13
36,8483505,Matthew Poitras,C,BOS,20,82,2,11,13
36,8474612,Travis Hamonic,D,OTT,34,82,2,11,13
36,8482762,Simon Edvinsson,D,DET,21,82,7,5,12
36,8480870,Bo Groulx,C,NYR,24,82,6,6,12
36,8482145,Mavrik Bourque,C,DAL,22,82,5,7,12
36,8482712,Oskar Olausson,R,COL,22,82,4,8,12
36,8475762,Derek Forbort,D,VAN,32,82,3,9,12
36,8474090,Brendan Smith,D,DAL,35,82,2,10,12
36,8482118,Sam Colangelo,R,ANA,23,82,5,6,11
36,8471677,Jack Johnson,D,CBJ,37,82,3,8,11
36,8478874,Adam Gaudette,C,OTT,28,82,3,8,11
36,8476473,Connor Murphy,D,CHI,31,82,2,9,11
36,8483471,Brad Lambert,C,WPG,31,82,2,9,11
36,8475177,Calvin de Haan,D,COL,33,82,2,9,11
36,8474567,Zach Bogosian,D,MIN,34,82,2,9,11
36,8483466,Kevin Korchinski,D,CHI,20,82,3,7,10
36,8482859,Zack Ostapchuk,C,OTT,21,82,2,8,10
36,8478178,Darren Raddysh,D,TBL,28,82,1,9,10
36,8483468,Jiri Kulich,C,BUF,20,82,4,5,9
36,8483489,Fraser Minten,C,TOR,31,82,2,7,9
36,8476822,Luke Glendening,C,TBL,35,82,5,3,8
36,8482070,Mitchell Chaffee,R,TBL,26,82,2,6,8
36,8482787,Nikita Chibrikov,R,WPG,31,82,5,2,7
36,8474062,Riley Nash,C,NYR,35,82,3,4,7
36,8483567,Georgii Merkulov,C,BOS,24,82,3,3,6
36,8470794,Joe Pavelski,C,,40,0,0,0,0
36,8481703,Valtteri Puustinen,R,PIT,25,0,0,0,0
36,8477950,Tony DeAngelo,D,,29,0,0,0,0
36,8481577,Philip Tomasino,C,NSH,23,0,0,0,0
36,8475197,Tyson Barrie,D,,33,0,0,0,0
36,8471218,Blake Wheeler,R,,38,0,0,0,0
36,8474157,Max Pacioretty,L,,36,0,0,0,0
36,8478466,Daniel Sprong,R,VAN,27,0,0,0,0
36,8475744,Evgeny Kuznetsov,C,,32,0,0,0,0
36,8481019,David Gustafsson,C,WPG,24,0,0,0,0
36,8475906,John Klingberg,D,,32,0,0,0,0
36,8479348,Kale Clague,D,BUF,26,0,0,0,0
36,8476952,Dominic Toninato,C,WPG,30,0,0,0,0
36,8473473,Milan Lucic,L,,36,0,0,0,0
36,8474037,James van Riemsdyk,L,,35,0,0,0,0
36,8474602,Justin Schultz,D,,34,0,0,0,0
36,8482222,Alexander Barabanov,L,,30,0,0,0,0
36,8479372,Josh Mahura,D,SEA,26,0,0,0,0
36,8479982,Conor Timmins,D,TOR,26,0,0,0,0
36,8474031,Kevin Shattenkirk,D,,35,0,0,0,0
36,8480008,Adam Ruzicka,C,,25,0,0,0,0
36,8481059,Scott Perunovich,D,STL,26,0,0,0,0
36,8480884,Calen Addison,D,,24,0,0,0,0
36,8476994,Vinnie Hinostroza,C,NSH,30,0,0,0,0
36,8478452,Caleb Jones,D,LAK,27,0,0,0,0
36,8480157,Calle Rosen,D,COL,30,0,0,0,0
36,8481609,Vladislav Kolyachonok,D,UTA,23,0,0,0,0
36,8479415,Michael McLeod,C,,26,0,0,0,0
36,8476919,Chris Tierney,C,,30,0,0,0,0
36,8479639,Dylan Coghlan,D,WPG,26,0,0,0,0
36,8478146,Matthew Highmore,C,OTT,28,0,0,0,0
36,8478970,Jalen Chatfield,D,CAR,28,0,0,0,0
36,8480205,Emil Bemstrom,C,PIT,25,0,0,0,0
36,8474884,Mike Hoffman,C,,35,0,0,0,0
36,8471274,Alex Goligoski,D,,39,0,0,0,0
36,8478104,Sammy Blais,L,,28,0,0,0,0
36,8474870,Tyler Johnson,C,,34,0,0,0,0
36,8476913,Devin Shore,C,MIN,30,0,0,0,0
36,8481598,Philip Broberg,D,EDM,23,0,0,0,0
36,8480058,Pierre-Olivier Joseph,D,STL,25,0,0,0,0
36,8480891,Michael Kesselring,D,UTA,24,0,0,0,0
36,8477979,Nicolas Aube-Kubel,R,BUF,28,0,0,0,0
36,8476871,Tanner Pearson,L,,32,0,0,0,0
36,8476393,Nick Cousins,C,,31,0,0,0,0
36,8479977,Kailer Yamamoto,R,,26,0,0,0,0
36,8479543,Michael Pezzetta,L,MTL,26,0,0,0,0
36,8477018,Ben Hutton,D,VGK,31,0,0,0,0
36,8480762,Eric Robinson,L,CAR,29,0,0,0,0
36,8474034,Pat Maroon,L,CHI,36,0,0,0,0
36,8481058,Jesse Ylönen,R,,25,0,0,0,0
36,8475179,Dmitry Kulikov,D,FLA,34,0,0,0,0
36,8481527,Kaedan Korczak,D,VGK,23,0,0,0,0
36,8473449,Kyle Okposo,R,,36,0,0,0,0
36,8482192,Isaak Phillips,D,CHI,23,0,0,0,0
36,8480727,Zach Whitecloud,D,VGK,28,0,0,0,0
36,8479346,Dillon Dube,C,,26,0,0,0,0
36,8480821,Filip Zadina,R,,25,0,0,0,0
36,8480001,Urho Vaakanainen,D,ANA,25,0,0,0,0
36,8470966,Mark Giordano,D,,41,0,0,0,0
36,8480853,Liam Foudy,C,,24,0,0,0,0
36,8475225,Craig Smith,C,CHI,35,0,0,0,0
36,8479972,Mason Shaw,C,WPG,26,0,0,0,0
36,8478451,Ethan Bear,D,WSH,27,0,0,0,0
36,8474040,Sam Gagner,C,,35,0,0,0,0
36,8480196,Jacob Bryson,D,BUF,27,0,0,0,0
36,8479984,Cal Foote,D,,26,0,0,0,0
36,8480011,Klim Kostin,C,SJS,25,0,0,0,0
36,8482176,Wyatt Kaiser,D,CHI,22,0,0,0,0
36,8476988,Matt Benning,D,SJS,30,0,0,0,0
36,8479370,Tyson Jost,C,CAR,26,0,0,0,0
36,8477464,Nic Petan,C,,29,0,0,0,0
36,8477380,Jonny Brodzinski,C,NYR,31,0,0,0,0
36,8480070,Ian Mitchell,D,BOS,25,0,0,0,0
36,8479315,Joey Anderson,R,CHI,26,0,0,0,0
36,8478099,Kevin Labanc,R,,29,0,0,0,0
36,8476874,Olli Maatta,D,DET,30,0,0,0,0
36,8475208,Brian Dumoulin,D,ANA,33,0,0,0,0
36,8478430,Oliver Kylington,D,,27,0,0,0,0
36,8479536,Axel Jonsson-Fjallby,L,WPG,26,0,0,0,0
36,8479671,Mathieu Olivier,R,CBJ,27,0,0,0,0
36,8471709,Marc-Edouard Vlasic,D,SJS,37,0,0,0,0
36,8479328,Julien Gauthier,R,NYI,27,0,0,0,0
36,8478421,A.J. Greer,L,FLA,28,0,0,0,0
36,8477573,Nathan Walker,L,STL,30,0,0,0,0
36,8481537,Nikita Okhotiuk,D,CGY,24,0,0,0,0
36,8474166,Alec Martinez,D,CHI,37,0,0,0,0
36,8470610,Zach Parise,L,,40,0,0,0,0
36,8477478,William Carrier,L,CAR,30,0,0,0,0
36,8479344,Jesse Puljujarvi,R,PIT,26,0,0,0,0
36,8480887,Jordan Harris,D,MTL,24,0,0,0,0
36,8478502,Dennis Gilbert,D,BUF,28,0,0,0,0
36,8482730,Brandt Clarke,D,LAK,21,0,0,0,0
36,8480355,Mark Kastelic,C,BOS,25,0,0,0,0
36,8475750,Jon Merrill,D,MIN,32,0,0,0,0
36,8475164,Jakob Silfverberg,R,,34,0,0,0,0
36,8477944,Jakub Vrana,L,,28,0,0,0,0
36,8479439,Jacob MacDonald,D,COL,31,0,0,0,0
36,8474568,Luke Schenn,D,NSH,35,0,0,0,0
36,8478454,Noah Juulsen,D,VAN,27,0,0,0,0
36,8475752,Tyler Pitlick,C,,33,0,0,0,0
36,8482148,Hendrix Lapierre,C,WSH,22,0,0,0,0
36,8481167,Brayden Pachal,D,CGY,25,0,0,0,0
36,8478043,Sam Lafferty,C,BUF,29,0,0,0,0
36,8479321,Lucas Johansen,D,,27,0,0,0,0
36,8471699,Andrew Cogliano,C,,37,0,0,0,0
36,8481521,Ronnie Attard,D,PHI,25,0,0,0,0
36,8481161,Jake Christiansen,D,CBJ,25,0,0,0,0
36,8479458,Nikita Zaitsev,D,,33,0,0,0,0
36,8479619,Michael Carcone,L,UTA,28,0,0,0,0
36,8479026,Philippe Myers,D,TOR,27,0,0,0,0
36,8477330,Dominik Kubalik,L,,29,0,0,0,0
36,8481617,Vasily Podkolzin,R,VAN,23,0,0,0,0
36,8481701,Santeri Hatakka,D,NJD,23,0,0,0,0
36,8479514,Rem Pitlick,C,,27,0,0,0,0
36,8477446,Michael McCarron,R,NSH,29,0,0,0,0
36,8470604,Jeff Carter,C,,39,0,0,0,0
36,8482241,Radim Zohorna,L,,28,0,0,0,0
36,8480289,Morgan Barron,C,WPG,26,0,0,0,0
36,8479379,Givani Smith,R,SJS,26,0,0,0,0
36,8480216,Jacob Peterson,C,,25,0,0,0,0
36,8477851,Jordan Oesterle,D,BOS,32,0,0,0,0
36,8484258,Sam Malinski,D,COL,26,0,0,0,0
36,8478904,Steven Lorentz,C,,28,0,0,0,0
36,8482095,Tyler Kleven,D,OTT,22,0,0,0,0
36,8480848,Ty Dellandrea,C,SJS,24,0,0,0,0
36,8476884,Derrick Pouliot,D,,30,0,0,0,0
36,8479336,Carl Grundstrom,R,SJS,27,0,0,0,0
36,8482964,Arber Xhekaj,D,MTL,23,0,0,0,0
36,8471686,Marc Staal,D,,37,0,0,0,0
36,8477887,Patrick Brown,C,BOS,32,0,0,0,0
36,8478495,Denis Gurianov,R,,27,0,0,0,0
36,8473504,Cal Clutterbuck,R,,37,0,0,0,0
36,8481550,Adam Beckman,L,NJD,23,0,0,0,0
36,8480845,Rasmus Kupari,C,WPG,24,0,0,0,0
36,8474009,Nick Bonino,C,,36,0,0,0,0
36,8478585,Derek Ryan,C,EDM,38,0,0,0,0
36,8477962,Brendan Lemieux,L,CAR,28,0,0,0,0
36,8482861,Vincent Iorio,D,WSH,22,0,0,0,0
36,8479378,Logan Stanley,D,WPG,26,0,0,0,0
36,8473446,Erik Johnson,D,PHI,36,0,0,0,0
36,8481743,Marc Del Gaizo,D,NSH,25,0,0,0,0
36,8477384,Josh Brown,D,EDM,30,0,0,0,0
36,8482165,Yan Kuznetsov,D,CGY,22,0,0,0,0
36,8478424,Jansen Harkins,C,ANA,27,0,0,0,0
36,8482144,Jack Thompson,D,SJS,22,0,0,0,0
36,8478512,Austin Czarnik,C,,32,0,0,0,0
36,8477527,Ross Johnston,L,ANA,30,0,0,0,0
36,8479383,Boris Katchouk,L,,26,0,0,0,0
36,8482094,Daemon Hunt,D,MIN,22,0,0,0,0
36,8481719,Maxwell Crozier,D,TBL,24,0,0,0,0
36,8480192,Johnathan Kovacevic,D,NJD,27,0,0,0,0
36,8479376,Victor Mete,D,,26,0,0,0,0
36,8482511,Mason Lohrei,D,BOS,23,0,0,0,0
36,8475825,Jani Hakanpää,D,,32,0,0,0,0
36,8478021,William Lagesson,D,DET,28,0,0,0,0
36,8475795,Dylan McIlrath,D,WSH,32,0,0,0,0
36,8477846,Ryan Carpenter,C,,33,0,0,0,0
36,8481056,Spencer Stastney,D,NSH,24,0,0,0,0
36,8481564,Ryan Johnson,D,BUF,23,0,0,0,0
36,8478017,Mark Friedman,D,VAN,29,0,0,0,0
36,8479320,Max Lajoie,D,SEA,27,0,0,0,0
36,8480075,Cameron Crotty,D,MIN,25,0,0,0,0
36,8484287,Cole McWard,D,VAN,23,0,0,0,0
36,8484254,Akito Hirose,D,VAN,25,0,0,0,0
36,8483407,Brandon Scanlin,D,NYR,25,0,0,0,0
36,8480274,Philip Kemp,D,EDM,25,0,0,0,0
36,8479522,Hardy Haman Aktell,D,WSH,26,0,0,0,0
36,8480007,Jonas Rondbjerg,R,VGK,25,0,0,0,0
36,8477454,Adam Erne,L,,29,0,0,0,0
36,8481679,Maxence Guenette,D,OTT,23,0,0,0,0
36,8480441,Trey Fix-Wolansky,R,CBJ,25,0,0,0,0
36,8483546,Marshall Rifai,D,TOR,26,0,0,0,0
36,8480084,Nick DeSimone,D,NJD,30,0,0,0,0
36,8481030,Jack St. Ivany,D,PIT,25,0,0,0,0
36,8481592,Jakob Pelletier,L,CGY,23,0,0,0,0
36,8478011,Louie Belpedio,D,PHI,28,0,0,0,0
36,8477930,Pierre-Edouard Bellemare,L,,39,0,0,0,0
36,8484321,Nikolas Matinpalo,D,OTT,26,0,0,0,0
36,8482067,Connor Mackey,D,NYR,28,0,0,0,0
36,8481806,Louis Crevier,D,CHI,23,0,0,0,0
36,8484326,Patrik Koch,D,UTA,28,0,0,0,0
36,8477971,Andreas Englund,D,LAK,28,0,0,0,0
36,8481751,Lukas Rousek,R,BUF,25,0,0,0,0
36,8481006,Tyler Tucker,D,STL,24,0,0,0,0
36,8476867,Brendan Gaunce,C,MIN,30,0,0,0,0
36,8479520,Brandon Duhaime,R,WSH,27,0,0,0,0
36,8477073,Kurtis MacDermid,L,NJD,30,0,0,0,0
36,8480874,Adam Ginning,D,PHI,24,0,0,0,0
36,8477473,Justin Bailey,R,SJS,29,0,0,0,0
36,8479066,Ryan Lomberg,L,CGY,30,0,0,0,0
36,8477070,Liam O'Brien,C,UTA,30,0,0,0,0
36,8474618,Marco Scandella,D,,34,0,0,0,0
36,8475797,Jarred Tinordi,D,,32,0,0,0,0
36,8481441,Joe Snively,C,DET,28,0,0,0,0
36,8477244,Chad Ruhwedel,D,NYR,34,0,0,0,0
36,8479772,Zack MacEwen,R,OTT,28,0,0,0,0
36,8481147,Reese Johnson,C,MIN,26,0,0,0,0
36,8481043,Cole Koepke,L,BOS,26,0,0,0,0
36,8483619,Filip Roos,D,OTT,25,0,0,0,0
36,8481541,Samuel Bolduc,D,NYI,24,0,0,0,0
36,8477810,Joel Hanley,D,CGY,33,0,0,0,0
36,8476907,Mackenzie MacEachern,L,,30,0,0,0,0
36,8482652,Walker Duehr,R,CGY,27,0,0,0,0
36,8477126,Jayson Megna,C,,34,0,0,0,0
36,8483398,Declan Carlile,D,TBL,31,0,0,0,0
36,8482929,Emil Lilleberg,D,TBL,23,0,0,0,0
36,8480880,Jakub Lauko,C,MIN,24,0,0,0,0
36,8480245,Olle Lycksell,R,PHI,25,0,0,0,0
36,8480252,Cole Guttman,C,CHI,25,0,0,0,0
36,8477467,Gustav Olofsson,D,SEA,30,0,0,0,0
36,8479968,Vinni Lettieri,C,BOS,29,0,0,0,0
36,8478400,Colin White,C,,27,0,0,0,0
36,8475755,Alexander Petrovic,D,DAL,32,0,0,0,0
36,8481812,Nikolai Knyzhov,D,,27,0,0,0,0
36,8481593,Jayden Struble,D,MTL,23,0,0,0,0
36,8481532,Alex Turcotte,C,LAK,23,0,0,0,0
36,8482126,Emil Andrae,D,PHI,31,0,0,0,0
36,8479944,Zach Aston-Reese,C,VGK,30,0,0,0,0
36,8471817,Ryan Reaves,R,TOR,37,0,0,0,0
36,8481206,John Ludvig,D,PIT,24,0,0,0,0
36,8481599,Victor Soderstrom,D,UTA,23,0,0,0,0
36,8480292,Carson Meyer,R,ANA,27,0,0,0,0
36,8482496,Nils Aman,C,VAN,24,0,0,0,0
36,8479718,Alex Barré-Boulet,C,MTL,27,0,0,0,0
36,8479994,Jaret Anderson-Dolan,C,WPG,25,0,0,0,0
36,8480184,Gustav Lindstrom,D,,26,0,0,0,0
36,8480890,Jan Jenik,R,OTT,24,0,0,0,0
36,8478067,Oskar Lindblom,L,,28,0,0,0,0
36,8476934,Brock McGinn,L,ANA,30,0,0,0,0
36,8479985,Cale Fleury,D,SEA,26,0,0,0,0
36,8484304,Uvis Balinskis,D,FLA,28,0,0,0,0
36,8479981,Jonah Gadjovich,L,FLA,26,0,0,0,0
36,8481716,Dmitri Voronkov,L,CBJ,24,0,0,0,0
36,8474709,Matt Martin,L,,35,0,0,0,0
36,8482634,Alex Steeves,C,TOR,25,0,0,0,0
36,8480823,Alexander Alexeyev,D,WSH,25,0,0,0,0
36,8477541,Dakota Mermis,D,TOR,30,0,0,0,0
36,8483491,Ivan Miroshnichenko,L,WSH,20,0,0,0,0
36,8478477,Mitchell Stephens,C,SEA,27,0,0,0,0
36,8481543,Nikita Alexandrov,C,STL,24,0,0,0,0
36,8479423,Alex Nylander,L,,26,0,0,0,0
36,8482451,Mikael Pyyhtia,L,CBJ,23,0,0,0,0
36,8478831,Kevin Stenlund,C,UTA,28,0,0,0,0
36,8480306,Grant Hutton,D,NYI,29,0,0,0,0
36,8478028,Fredrik Olofsson,L,,28,0,0,0,0
36,8477462,Robert Hagg,D,VGK,29,0,0,0,0
36,8477320,Anton Blidh,L,NYR,29,0,0,0,0
36,8482157,Will Cuylle,L,NYR,22,0,0,0,0
36,8482737,Zack Bolduc,C,STL,21,0,0,0,0
36,8481239,Samuel Fagemo,L,,24,0,0,0,0
36,8481600,Tobias Bjornfot,D,FLA,23,0,0,0,0
36,8478409,Anthony Richard,C,PHI,28,0,0,0,0
36,8474145,Robert Bortuzzo,D,,35,0,0,0,0
36,8475958,Michael Sgarbossa,C,WSH,32,0,0,0,0
36,8479986,Kole Lind,R,DAL,26,0,0,0,0
36,8479249,Andrew Poturalski,C,SJS,30,0,0,0,0
36,8479362,Riley Tufte,L,BOS,26,0,0,0,0
36,8479991,Jake Leschyshyn,C,NYR,25,0,0,0,0
36,8479587,Rhett Gardner,C,PHI,28,0,0,0,0
36,8482744,James Malatesta,L,CBJ,21,0,0,0,0
36,8478854,Ryan Shea,D,PIT,27,0,0,0,0
36,8481591,Sam Poulin,R,,23,0,0,0,0
36,8483512,Matt Savoie,C,EDM,20,0,0,0,0
36,8482102,Vasily Ponomarev,C,PIT,22,0,0,0,0
36,8482162,Roby Jarventie,L,EDM,22,0,0,0,0
36,8481016,Ruslan Iskhakov,C,,24,0,0,0,0
36,8482172,Landon Slaggert,L,CHI,22,0,0,0,0
36,8482747,Brennan Othmann,L,NYR,21,0,0,0,0
36,8480031,Maxime Comtois,L,,25,0,0,0,0
36,8480226,Marián Studenic,R,,26,0,0,0,0
36,8478408,Travis Dermott,D,,28,0,0,0,0
36,8481518,Nolan Foote,L,NJD,24,0,0,0,0
36,8479419,Brett Murray,L,BUF,26,0,0,0,0
36,8482088,Justin Sourdif,R,FLA,22,0,0,0,0
36,8482201,Gage Goncalves,C,TBL,23,0,0,0,0
36,8481578,Graeme Clarke,R,MIN,23,0,0,0,0
36,8482177,Marat Khusnutdinov,C,MIN,22,0,0,0,0
36,8481754,Nikita Nesterenko,C,ANA,23,0,0,0,0
36,8483531,Brian Halonen,L,NJD,25,0,0,0,0
36,8483920,Pierrick Dube,R,WSH,23,0,0,0,0
36,8480851,Akil Thomas,C,LAK,24,0,0,0,0
36,8475235,Nicolas Deslauriers,L,PHI,33,0,0,0,0
36,8482476,Emil Heineman,L,MTL,23,0,0,0,0
36,8477149,Scott Sabourin,R,SJS,32,0,0,0,0
36,8483549,Lucas Condotta,L,MTL,27,0,0,0,0
36,8482765,Isak Rosen,R,BUF,21,0,0,0,0
36,8481237,Kyle MacLean,C,NYI,25,0,0,0,0
36,8481024,Linus Karlsson,C,VAN,25,0,0,0,0
36,8481690,Tyler Angle,C,,24,0,0,0,0
36,8483570,Ben Meyers,C,SEA,26,0,0,0,0
36,8481655,Cole Schwindt,R,CGY,23,0,0,0,0
36,8481462,Mason Morelli,L,VGK,28,0,0,0,0
36,8483401,Marc Johnstone,R,PIT,28,0,0,0,0
36,8478956,Samuel Laberge,L,NJD,27,0,0,0,0
36,8479533,Joona Koppanen,L,,26,0,0,0,0
36,8482197,Adam Raska,R,MIN,23,0,0,0,0
36,8482250,Callahan Burke,C,VGK,27,0,0,0,0
36,8482784,Zach Dean,C,STL,21,0,0,0,0
36,8484255,Jason Polin,R,COL,25,0,0,0,0
36,8481077,John Leonard,L,,26,0,0,0,0
36,8481534,Raphael Lavoie,C,EDM,24,0,0,0,0
36,8483609,Adam Klapka,R,CGY,24,0,0,0,0
36,8482751,Ryan Winterton,C,SEA,21,0,0,0,0
36,8480267,Sammy Walker,C,MIN,25,0,0,0,0
36,8475766,Austin Watson,L,,32,0,0,0,0
36,8482460,Matt Rempe,C,NYR,22,0,0,0,0
36,8481065,Angus Crookshank,L,OTT,25,0,0,0,0
36,8481070,Hugh McGing,L,,26,0,0,0,0
36,8476323,Max McCormick,L,SEA,32,0,0,0,0
36,8483395,Arshdeep Bains,L,VAN,23,0,0,0,0
36,8484259,Ondrej Pavel,C,COL,31,0,0,0,0
36,8483432,Luca Del Bel Belluz,C,CBJ,31,0,0,0,0
36,8483045,Cameron Butler,R,CBJ,31,0,0,0,0
36,8482061,Brandon Biro,L,SEA,26,0,0,0,0
36,8477401,John Hayden,C,SEA,29,0,0,0,0
36,8475278,Byron Froese,C,,33,0,0,0,0
36,8478446,Glenn Gawdin,C,LAK,27,0,0,0,0
36,8477993,Justin Kirkland,C,CGY,28,0,0,0,0
36,8482147,Jean-Luc Foudy,C,COL,22,0,0,0,0
36,8480032,Shane Bowers,C,NJD,25,0,0,0,0
36,8479330,Brandon Gignac,C,MTL,27,0,0,0,0
36,8480776,Sheldon Rempal,R,,29,0,0,0,0
36,8475413,Justin Dowling,C,NJD,34,0,0,0,0
36,8481726,Adam Edstrom,C,NYR,24,0,0,0,0
36,8480844,Grigori Denisenko,L,VGK,24,0,0,0,0
36,8478147,Bokondji Imama,L,PIT,28,0,0,0,0
36,8478881,Brett Seney,L,CHI,28,0,0,0,0
36,8483630,Pavol Regenda,L,ANA,25,0,0,0,0
36,8480836,Jonathan Gruden,C,,24,0,0,0,0
36,8484314,Jiri Smejkal,L,,28,0,0,0,0
36,8475780,Chris Wagner,R,COL,33,0,0,0,0
36,8479546,Oskar Steen,C,,26,0,0,0,0
36,8483597,Milos Kelemen,L,UTA,25,0,0,0,0
36,8481789,Tye Kartye,L,SEA,23,0,0,0,0
36,8484325,Waltteri Merela,C,TBL,26,0,0,0,0
36,8479421,Jacob Moverare,D,LAK,26,0,0,0,0
36,8481585,Egor Afanasyev,L,SJS,23,0,0,0,0
36,8479547,Matthew Phillips,R,,26,0,0,0,0
36,8479367,William Lockwood,R,FLA,26,0,0,0,0
36,8476915,Jujhar Khaira,L,,30,0,0,0,0
36,8481422,Jacob Lucchini,C,NSH,29,0,0,0,0
36,8480468,James Hamblin,L,EDM,25,0,0,0,0
36,8478051,Max Willman,C,NJD,29,0,0,0,0
36,8481556,John Beecher,C,BOS,23,0,0,0,0
36,8478078,Rourke Chartier,C,,28,0,0,0,0
37,8477956,David Pastrnak,R,BOS,28,82,72,70,142
37,8478402,Connor McDavid,C,EDM,27,82,37,101,138
37,8476453,Nikita Kucherov,R,TBL,31,82,49,87,136
37,8477934,Leon Draisaitl,C,EDM,29,82,47,78,125
37,8477492,Nathan MacKinnon,C,COL,29,82,49,74,123
37,8479314,Matthew Tkachuk,L,FLA,27,82,39,82,121
37,8477493,Aleksander Barkov,C,FLA,29,82,35,84,119
37,8478864,Kirill Kaprizov,L,MIN,27,82,54,61,115
37,8471675,Sidney Crosby,C,PIT,37,82,48,60,108
37,8477946,Dylan Larkin,C,DET,28,82,43,64,107
37,8478550,Artemi Panarin,L,NYR,33,82,34,73,107
37,8479318,Auston Matthews,C,TOR,27,82,47,56,103
37,8475166,John Tavares,C,TOR,34,82,50,51,101
37,8478420,Mikko Rantanen,R,COL,28,82,46,55,101
37,8479407,Jesper Bratt,L,NJD,26,82,46,55,101
37,8474564,Steven Stamkos,C,NSH,34,82,36,65,101
37,8480023,Robert Thomas,C,STL,25,82,30,70,100
37,8476468,J.T. Miller,C,VAN,31,82,45,54,99
37,8477939,William Nylander,R,TOR,28,82,40,59,99
37,8480012,Elias Pettersson,C,VAN,26,82,39,59,98
37,8475913,Mark Stone,R,VGK,32,82,39,57,96
37,8476459,Mika Zibanejad,C,NYR,31,82,29,67,96
37,8478439,Travis Konecny,R,PHI,27,82,37,57,94
37,8482116,Tim Stützle,C,OTT,22,82,35,59,94
37,8478445,Mathew Barzal,C,NYI,27,82,24,70,94
37,8481557,Matt Boldy,L,MIN,23,82,32,61,93
37,8477933,Sam Reinhart,C,FLA,29,82,54,38,92
37,8477409,Carter Verhaeghe,C,FLA,29,82,51,40,91
37,8474600,Roman Josi,D,NSH,34,82,22,66,88
37,8479420,Tage Thompson,C,BUF,27,82,48,39,87
37,8480801,Brady Tkachuk,L,OTT,25,82,43,44,87
37,8476887,Filip Forsberg,L,NSH,30,82,41,46,87
37,8481559,Jack Hughes,C,NJD,23,82,35,52,87
37,8478398,Kyle Connor,L,WPG,28,82,48,38,86
37,8480027,Jason Robertson,L,DAL,25,82,35,50,85
37,8477942,Kevin Fiala,L,LAK,28,82,29,56,85
37,8478427,Sebastian Aho,C,CAR,27,82,38,45,83
37,8480069,Cale Makar,D,COL,26,82,23,60,83
37,8476346,Johnny Gaudreau,L,CBJ,31,82,18,65,83
37,8478047,Michael Bunting,L,PIT,29,82,26,56,82
37,8480800,Quinn Hughes,D,VAN,25,82,8,74,82
37,8478010,Brayden Point,C,TBL,28,82,40,41,81
37,8476454,Ryan Nugent-Hopkins,C,EDM,31,82,28,53,81
37,8481523,Kirby Dach,C,MTL,23,82,17,64,81
37,8477501,Valeri Nichushkin,R,COL,29,82,48,32,80
37,8480865,Noah Dobson,D,NYI,24,82,22,57,79
37,8478449,Roope Hintz,C,DAL,28,82,32,46,78
37,8480839,Rasmus Dahlin,D,BUF,24,82,12,66,78
37,8476460,Mark Scheifele,C,WPG,31,82,34,43,77
37,8477404,Jake Guentzel,C,TBL,30,82,30,47,77
37,8480830,Andrei Svechnikov,R,CAR,24,82,27,50,77
37,8477940,Nikolaj Ehlers,L,WPG,28,82,26,51,77
37,8474141,Patrick Kane,R,DET,36,82,36,39,75
37,8478460,Zach Werenski,D,CBJ,27,82,16,59,75
37,8473419,Brad Marchand,L,BOS,36,82,30,44,74
37,8482078,Lucas Raymond,L,DET,22,82,30,44,74
37,8479385,Jordan Kyrou,C,STL,26,82,30,43,73
37,8475810,Bryan Rust,R,PIT,32,82,40,32,72
37,8480208,Drake Batherson,R,OTT,26,82,32,40,72
37,8482093,Seth Jarvis,C,CAR,22,82,30,42,72
37,8478444,Brock Boeser,R,VAN,27,82,27,45,72
37,8476448,William Karlsson,C,VGK,31,82,24,48,72
37,8479323,Adam Fox,D,NYR,26,82,14,58,72
37,8475184,Chris Kreider,L,NYR,33,82,49,22,71
37,8477960,Adrian Kempe,R,LAK,28,82,35,36,71
37,8478042,Viktor Arvidsson,R,EDM,31,82,34,37,71
37,8477496,Elias Lindholm,C,BOS,30,82,28,43,71
37,8482113,Anton Lundell,C,FLA,23,82,22,49,71
37,8474578,Erik Karlsson,D,PIT,34,82,18,53,71
37,8477402,Pavel Buchnevich,L,STL,29,82,30,40,70
37,8475172,Nazem Kadri,C,CGY,34,82,27,43,70
37,8477504,Josh Morrissey,D,WPG,29,82,19,51,70
37,8480036,Miro Heiskanen,D,DAL,25,82,12,58,70
37,8471214,Alex Ovechkin,L,WSH,39,82,39,30,69
37,8477500,Bo Horvat,C,NYI,29,82,33,36,69
37,8478403,Jack Eichel,C,VGK,28,82,32,37,69
37,8476462,Dougie Hamilton,D,NJD,31,82,25,44,69
37,8476853,Morgan Rielly,D,TOR,30,82,11,58,69
37,8476483,Rickard Rakell,R,PIT,31,82,25,43,68
37,8475167,Victor Hedman,D,TBL,34,82,17,51,68
37,8475692,Mats Zuccarello,R,MIN,37,82,14,54,68
37,8478856,Conor Garland,R,VAN,28,82,33,34,67
37,8476389,Vincent Trocheck,C,NYR,31,82,26,41,67
37,8476881,Tomas Hertl,C,VGK,31,82,25,42,67
37,8480018,Nick Suzuki,C,MTL,25,82,27,39,66
37,8480002,Nico Hischier,C,NJD,25,82,23,43,66
37,8476875,Mike Matheson,D,MTL,30,82,11,55,66
37,8480014,Gabriel Vilardi,C,WPG,25,82,37,28,65
37,8475745,Charlie Coyle,C,BOS,32,82,28,37,65
37,8471215,Evgeni Malkin,C,PIT,38,82,27,38,65
37,8471685,Anze Kopitar,C,LAK,37,82,27,38,65
37,8478440,Dylan Strome,C,WSH,27,82,24,41,65
37,8481596,Shane Pinto,C,OTT,24,82,22,43,65
37,8479542,Brandon Hagel,L,TBL,26,82,34,30,64
37,8474586,Jordan Eberle,R,SEA,34,82,33,31,64
37,8479343,Clayton Keller,R,UTA,26,82,26,38,64
37,8477951,Nick Schmaltz,C,UTA,28,82,26,38,64
37,8479337,Alex DeBrincat,R,DET,27,82,26,38,64
37,8481711,Matias Maccelli,L,UTA,24,82,22,42,64
37,8476479,Phillip Danault,C,LAK,31,82,21,43,64
37,8476432,Boone Jenner,C,CBJ,31,82,43,20,63
37,8475726,Tyler Toffoli,C,SJS,32,82,37,26,63
37,8478414,Timo Meier,R,NJD,28,82,31,32,63
37,8475754,Brock Nelson,C,NYI,33,82,31,32,63
37,8474679,Gustav Nyquist,C,NSH,35,82,18,45,63
37,8479325,Charlie McAvoy,D,BOS,27,82,12,51,63
37,8478873,Troy Terry,R,ANA,27,82,23,39,62
37,8478498,Jake DeBrusk,L,VAN,28,82,19,43,62
37,8477986,Brandon Montour,D,SEA,30,82,19,43,62
37,8477494,Jonathan Drouin,L,COL,29,82,13,49,62
37,8481540,Cole Caufield,R,MTL,23,82,34,27,61
37,8479339,Patrik Laine,L,CBJ,26,82,26,35,61
37,8480015,Owen Tippett,R,PHI,25,82,26,35,61
37,8477503,Max Domi,C,TOR,29,82,12,49,61
37,8481068,Yegor Sharangovich,C,CGY,26,82,31,29,60
37,8482097,Jack Quinn,R,BUF,23,82,30,30,60
37,8481533,Trevor Zegras,C,ANA,23,82,28,32,60
37,8475158,Ryan O'Reilly,C,NSH,33,82,27,33,60
37,8475168,Matt Duchene,C,DAL,33,82,26,34,60
37,8474102,David Perron,L,OTT,36,82,26,34,60
37,8477407,Anthony Duclair,L,NYI,29,82,23,37,60
37,8479675,Trevor Moore,L,LAK,29,82,22,38,60
37,8474150,Mikael Backlund,C,CGY,35,82,19,41,60
37,8477447,Shea Theodore,D,VGK,29,82,13,47,60
37,8474565,Alex Pietrangelo,D,VGK,34,82,12,48,60
37,8476456,Jonathan Huberdeau,C,CGY,31,82,11,49,60
37,8477949,Alex Tuch,R,BUF,28,82,13,46,59
37,8478975,Mason Marchment,L,DAL,29,82,31,27,58
37,8478458,Jack Roslovic,C,CAR,27,82,16,42,58
37,8477953,Kasperi Kapanen,R,STL,28,82,15,43,58
37,8477498,Darnell Nurse,D,EDM,29,82,15,43,58
37,8476539,Jonathan Marchessault,R,NSH,34,82,32,25,57
37,8475170,Brayden Schenn,C,STL,33,82,27,30,57
37,8480039,Martin Necas,C,CAR,25,82,24,33,57
37,8478401,Pavel Zacha,C,BOS,27,82,22,35,57
37,8474590,John Carlson,D,WSH,34,82,19,38,57
37,8477497,Sean Monahan,C,CBJ,30,82,17,40,57
37,8475784,Jeff Skinner,C,EDM,32,82,16,41,57
37,8477346,MacKenzie Weegar,D,CGY,30,82,15,42,57
37,8478397,Rasmus Andersson,D,CGY,28,82,14,43,57
37,8475786,Zach Hyman,L,EDM,32,82,25,31,56
37,8478519,Anthony Cirelli,C,TBL,27,82,24,32,56
37,8482159,Tyson Foerster,R,PHI,22,82,23,33,56
37,8478055,Gustav Forsling,D,FLA,28,82,13,43,56
37,8475794,Tyler Seguin,C,DAL,32,82,33,22,55
37,8475191,Reilly Smith,R,NYR,33,82,24,31,55
37,8473512,Claude Giroux,R,OTT,36,82,16,39,55
37,8478493,Joel Eriksson Ek,C,MIN,27,82,22,32,54
37,8473986,Alex Killorn,L,ANA,35,82,20,34,54
37,8482684,Luke Hughes,D,NJD,21,82,14,40,54
37,8475798,Mikael Granlund,C,SJS,32,82,12,42,54
37,8476399,Blake Coleman,C,CGY,33,82,27,26,53
37,8482665,Matty Beniers,C,SEA,22,82,22,31,53
37,8478407,Vince Dunn,D,SEA,28,82,15,38,53
37,8477955,Jared McCann,L,SEA,28,82,22,30,52
37,8482146,Luke Evangelista,R,NSH,22,82,22,30,52
37,8482149,Cole Perfetti,C,WPG,22,82,18,34,52
37,8475314,Anders Lee,L,NYI,34,82,29,22,51
37,8477935,Sam Bennett,C,FLA,28,82,28,23,51
37,8478396,Noah Hanifin,D,VGK,27,82,15,36,51
37,8473994,Jamie Benn,L,DAL,35,82,13,38,51
37,8475169,Evander Kane,L,EDM,33,82,29,21,50
37,8482124,Quinton Byfield,R,LAK,22,82,24,26,50
37,8478366,Frank Vatrano,R,ANA,30,82,22,28,50
37,8476882,Teuvo Teravainen,L,CHI,30,82,21,29,50
37,8477021,Alex Kerfoot,C,UTA,30,82,20,30,50
37,8477416,Oliver Bjorkstrand,R,SEA,29,82,18,32,50
37,8477932,Aaron Ekblad,D,FLA,28,82,17,33,50
37,8480078,Filip Chytil,C,NYR,25,82,13,37,50
37,8474563,Drew Doughty,D,LAK,35,82,10,40,50
37,8476854,Hampus Lindholm,D,BOS,30,82,10,40,50
37,8478469,Thomas Chabot,D,OTT,27,82,8,42,50
37,8482109,Alexis Lafrenière,L,NYR,23,82,27,22,49
37,8479996,Cody Glass,C,NSH,25,82,24,25,49
37,8478462,Nicolas Roy,C,VGK,27,82,22,27,49
37,8478438,Tommy Novak,C,NSH,27,82,18,31,49
37,8476458,Ryan Strome,C,ANA,31,82,13,36,49
37,8480434,Sean Durzi,D,UTA,26,82,12,37,49
37,8482055,Drew O'Connor,L,PIT,26,82,24,24,48
37,8475151,Kyle Palmieri,C,NYI,33,82,23,25,48
37,8480829,Jesperi Kotkaniemi,C,CAR,24,82,21,27,48
37,8480009,Eeli Tolvanen,R,SEA,25,82,21,27,48
37,8481528,Dylan Cozens,C,BUF,23,82,19,29,48
37,8480803,Evan Bouchard,D,EDM,25,82,8,40,48
37,8479425,Filip Hronek,D,VAN,27,82,8,40,48
37,8476923,Damon Severson,D,CBJ,30,82,6,42,48
37,8478046,Danton Heinen,L,VAN,29,82,28,19,47
37,8481618,Alex Newhook,C,MTL,23,82,26,21,47
37,8483808,Andrei Kuzmenko,L,CGY,28,82,23,24,47
37,8482740,Wyatt Johnston,C,DAL,21,82,22,25,47
37,8477479,Tyler Bertuzzi,L,CHI,29,82,18,29,47
37,8475722,Jason Zucker,L,BUF,32,82,18,29,47
37,8480798,Philipp Kurashev,C,CHI,25,82,13,34,47
37,8476905,Chandler Stephenson,C,SEA,30,82,11,36,47
37,8476869,Brady Skjei,D,NSH,30,82,11,36,47
37,8477476,Artturi Lehkonen,L,COL,29,82,25,21,46
37,8480064,Josh Norris,C,OTT,25,82,23,23,46
37,8477426,Nicholas Paul,L,TBL,29,82,22,24,46
37,8478474,Lawson Crouse,L,UTA,27,82,21,25,46
37,8482667,William Eklund,L,SJS,22,82,20,26,46
37,8475765,Vladimir Tarasenko,R,DET,33,82,19,27,46
37,8475753,Justin Faulk,D,STL,32,82,18,28,46
37,8475149,Marcus Johansson,L,MIN,34,82,18,28,46
37,8483515,Juraj Slafkovsky,L,MTL,20,82,17,29,46
37,8476329,Travis Boyd,C,MIN,31,82,15,31,46
37,8482745,Mason McTavish,C,ANA,21,82,14,32,46
37,8476792,Torey Krug,D,STL,33,82,9,37,46
37,8471724,Kris Letang,D,PIT,37,82,7,39,46
37,8480893,Kirill Marchenko,R,CBJ,24,82,34,11,45
37,8474641,Adam Henrique,C,EDM,34,82,24,21,45
37,8480797,Joel Farabee,L,PHI,24,82,23,22,45
37,8482475,Yegor Chinakhov,R,CBJ,23,82,23,22,45
37,8480113,Alex Iafallo,L,WPG,31,82,23,22,45
37,8478542,Evan Rodrigues,C,FLA,31,82,17,28,45
37,8478038,Devon Toews,D,COL,30,82,11,34,45
37,8477444,Andre Burakovsky,L,SEA,29,82,23,21,44
37,8480028,Morgan Frost,C,PHI,25,82,19,25,44
37,8477998,Warren Foegele,L,LAK,28,82,19,25,44
37,8479400,Pierre-Luc Dubois,L,WSH,26,82,16,28,44
37,8475714,Calle Jarnkrok,C,TOR,33,82,14,30,44
37,8479999,Casey Mittelstadt,C,COL,26,82,11,33,44
37,8477495,Seth Jones,D,CHI,30,82,11,33,44
37,8479987,Morgan Geekie,C,BOS,26,82,11,33,44
37,8482720,Matthew Knies,L,TOR,22,82,24,19,43
37,8480188,Fabian Zetterlund,L,SJS,25,82,18,25,43
37,8476925,Colton Sissons,C,NSH,31,82,17,26,43
37,8477456,J.T. Compher,L,DET,29,82,16,27,43
37,8481606,Jordan Spence,D,LAK,23,82,13,30,43
37,8475793,Ryan Johansen,C,PHI,32,82,9,34,43
37,8482110,Dawson Mercer,C,NJD,23,82,22,20,42
37,8478115,Pierre Engvall,L,NYI,28,82,21,21,42
37,8477451,Ryan Hartman,R,MIN,30,82,19,23,42
37,8478463,Anthony Beauvillier,L,PIT,27,82,19,23,42
37,8476960,Andreas Athanasiou,C,CHI,30,82,19,23,42
37,8476419,Jean-Gabriel Pageau,C,NYI,32,82,19,23,42
37,8475763,Kevin Hayes,R,PIT,32,82,17,25,42
37,8477964,Ivan Barbashev,C,VGK,29,82,16,26,42
37,8480185,Eetu Luostarinen,C,FLA,26,82,16,26,42
37,8477952,Robby Fabbri,C,ANA,28,82,15,27,42
37,8476927,Teddy Blueger,C,VAN,30,82,13,29,42
37,8482660,Kent Johnson,C,CBJ,22,82,12,30,42
37,8476292,Ondrej Palat,L,NJD,33,82,10,32,42
37,8481604,Pavel Dorofeyev,L,VGK,24,82,21,20,41
37,8476880,Tom Wilson,R,WSH,30,82,18,23,41
37,8478057,Dakota Joshua,C,VAN,28,82,14,27,41
37,8476474,Stefan Noesen,R,NJD,31,82,14,27,41
37,8480145,Neal Pionk,D,WPG,29,82,10,31,41
37,8482671,Owen Power,D,BUF,22,82,9,32,41
37,8477969,Marcus Pettersson,D,PIT,28,82,7,34,41
37,8481542,Moritz Seider,D,DET,23,82,4,37,41
37,8479410,Mikhail Sergachev,D,UTA,26,82,3,38,41
37,8484144,Connor Bedard,C,CHI,19,82,22,18,40
37,8481554,Kaapo Kakko,R,NYR,23,82,21,19,40
37,8481535,Nils Hoglander,L,VAN,24,82,21,19,40
37,8475791,Taylor Hall,L,CHI,33,82,20,20,40
37,8481560,Arthur Kaliyev,R,LAK,23,82,18,22,40
37,8471698,T.J. Oshie,R,WSH,38,82,17,23,40
37,8476392,Adam Lowry,C,WPG,31,82,14,26,40
37,8474716,Jared Spurgeon,D,MIN,35,82,12,28,40
37,8476917,Adam Pelech,D,NYI,30,82,7,33,40
37,8478233,Andrew Mangiapane,L,WSH,28,82,22,17,39
37,8479525,Ross Colton,C,COL,28,82,21,18,39
37,8478109,Victor Olofsson,L,VGK,29,82,19,20,39
37,8475287,Erik Haula,L,NJD,33,82,18,21,39
37,8474053,Logan Couture,C,SJS,35,82,18,21,39
37,8477839,Conor Sheary,L,TBL,32,82,16,23,39
37,8477987,Ryan Donato,C,CHI,28,82,15,24,39
37,8477511,Anthony Mantha,R,CGY,30,82,14,25,39
37,8476826,Yanni Gourde,C,SEA,33,82,13,26,39
37,8479345,Jakob Chychrun,D,WSH,26,82,12,27,39
37,8480817,K'Andre Miller,D,NYR,24,82,10,29,39
37,8475848,Brendan Gallagher,R,MTL,32,82,22,16,38
37,8475799,Nino Niederreiter,R,WPG,32,82,17,21,38
37,8476906,Shayne Gostisbehere,D,CAR,31,82,13,25,38
37,8473422,Nick Foligno,L,CHI,37,82,13,25,38
37,8482133,Thomas Bordeleau,C,SJS,22,82,12,26,38
37,8470613,Brent Burns,D,CAR,39,82,6,32,38
37,8483431,Logan Cooley,C,UTA,20,82,24,13,37
37,8475760,Nick Bjugstad,C,UTA,32,82,20,17,37
37,8480849,Barrett Hayton,C,UTA,24,82,14,23,37
37,8477947,Sonny Milano,L,WSH,28,82,11,26,37
37,8476463,Jonas Brodin,D,MIN,31,82,9,28,37
37,8476438,Brandon Saad,L,STL,32,82,22,14,36
37,8479365,Trent Frederic,C,BOS,26,82,20,16,36
37,8481582,Nicholas Robertson,L,TOR,23,82,20,16,36
37,8480835,Jack Drury,C,CAR,24,82,18,18,36
37,8475768,Jaden Schwartz,C,SEA,32,82,16,20,36
37,8481186,Logan O'Connor,R,COL,28,82,15,21,36
37,8476461,Sean Couturier,C,PHI,32,82,14,22,36
37,8476958,Jaccob Slavin,D,CAR,30,82,6,30,36
37,8478413,Jordan Greenway,L,BUF,27,82,18,17,35
37,8476921,Jordan Martinook,L,CAR,32,82,18,17,35
37,8479992,Michael Rasmussen,C,DET,25,82,14,21,35
37,8478133,Jake Evans,C,MTL,28,82,11,24,35
37,8475171,Oliver Ekman-Larsson,D,TOR,33,82,8,27,35
37,8482105,Jake Sanderson,D,OTT,22,82,7,28,35
37,8476892,Colton Parayko,D,STL,31,82,7,28,35
37,8480068,Ryan Poehling,C,PHI,25,82,21,13,34
37,8481704,Juuso Parssinen,C,NSH,23,82,21,13,34
37,8482089,Jake Neighbours,L,STL,22,82,19,15,34
37,8481624,Ilya Mikheyev,R,CHI,30,82,17,17,34
37,8474189,Lars Eller,C,PIT,35,82,16,18,34
37,8476885,Jacob Trouba,D,NYR,30,82,14,20,34
37,8479591,Michael Eyssimont,C,TBL,28,82,14,20,34
37,8481656,Aliaksei Protas,C,WSH,23,82,12,22,34
37,8475200,Dmitry Orlov,D,CAR,33,82,10,24,34
37,8481581,Thomas Harley,D,DAL,23,82,9,25,34
37,8473563,Nicklas Backstrom,C,WSH,37,82,9,25,34
37,8477435,Ryan Graves,D,PIT,29,82,6,28,34
37,8481546,Cam York,D,PHI,23,82,5,29,34
37,8479998,Mikey Anderson,D,LAK,25,82,5,29,34
37,8478851,Alexandre Carrier,D,NSH,28,82,3,31,34
37,8478020,Michael Amadio,C,OTT,28,82,24,9,33
37,8480220,Noah Cates,L,PHI,25,82,15,18,33
37,8479661,Tanner Jeannot,L,LAK,27,82,13,20,33
37,8477429,Andrew Copp,C,DET,30,82,12,21,33
37,8478891,Mason Appleton,C,WPG,28,82,8,25,33
37,8480878,Nils Lundkvist,D,DAL,24,82,7,26,33
37,8480873,Rasmus Sandin,D,WSH,24,82,4,29,33
37,8482699,Dylan Guenther,R,UTA,21,82,19,13,32
37,8476278,Colin Blackwell,C,DAL,31,82,17,15,32
37,8479393,Noah Gregor,C,OTT,26,82,16,16,32
37,8479941,Justin Danforth,R,CBJ,31,82,15,17,32
37,8482117,Lukas Reichel,L,CHI,22,82,11,21,32
37,8480043,Timothy Liljegren,D,TOR,25,82,7,25,32
37,8476979,Erik Gustafsson,D,DET,32,82,5,27,32
37,8476422,Mike Reilly,D,NYI,31,82,5,27,32
37,8477506,Ryan Pulock,D,NYI,30,82,4,28,32
37,8482125,Alexander Holtz,R,VGK,22,82,16,15,31
37,8474715,Cam Atkinson,R,TBL,35,82,16,15,31
37,8480748,Kiefer Sherwood,L,VAN,29,82,15,16,31
37,8478569,Noel Acciari,C,PIT,33,82,14,17,31
37,8480802,Ryan McLeod,C,BUF,25,82,14,17,31
37,8476480,Vladislav Namestnikov,C,WPG,32,82,12,19,31
37,8474149,Evgenii Dadonov,R,DAL,35,82,8,23,31
37,8477989,Christian Dvorak,C,MTL,28,82,8,23,31
37,8478500,Ivan Provorov,D,CBJ,27,82,6,25,31
37,8477220,Nate Schmidt,D,FLA,33,82,6,25,31
37,8479976,Juuso Valimaki,D,UTA,26,82,3,28,31
37,8484166,Adam Fantilli,C,CBJ,20,82,20,10,30
37,8479390,Taylor Raddysh,R,WSH,26,82,17,13,30
37,8481093,Rafael Harvey-Pinard,L,MTL,25,82,15,15,30
37,8475220,Marcus Foligno,L,MIN,33,82,14,16,30
37,8482175,JJ Peterka,R,BUF,22,82,13,17,30
37,8475218,Mattias Ekholm,D,EDM,34,82,13,17,30
37,8480789,Oliver Wahlstrom,R,NYI,24,82,11,19,30
37,8476374,Sean Kuraly,C,CBJ,31,82,9,21,30
37,8477507,Nikita Zadorov,D,BOS,29,82,8,22,30
37,8475181,Nick Leddy,D,STL,33,82,6,24,30
37,8482079,Marco Rossi,C,MIN,23,82,18,11,29
37,8484153,Leo Carlsson,C,ANA,20,82,17,12,29
37,8478472,Mathieu Joseph,R,STL,27,82,14,15,29
37,8475855,Jesper Fast,R,CAR,33,82,12,17,29
37,8475193,Tomas Tatar,L,NJD,34,82,11,18,29
37,8480336,Sean Walker,D,CAR,30,82,10,19,29
37,8476878,Zemgus Girgensons,L,TBL,30,82,10,19,29
37,8476872,Scott Laughton,C,PHI,30,82,9,20,29
37,8480871,Adam Boqvist,D,FLA,24,82,9,20,29
37,8474151,Ryan McDonagh,D,TBL,35,82,8,21,29
37,8475764,Cam Fowler,D,ANA,33,82,6,23,29
37,8470600,Ryan Suter,D,STL,39,82,6,23,29
37,8482655,J.J. Moser,D,TBL,24,82,4,25,29
37,8478882,Vladislav Gavrikov,D,LAK,29,82,4,25,29
37,8478507,John Marino,D,UTA,27,82,3,26,29
37,8476981,Josh Anderson,R,MTL,30,82,19,9,28
37,8479353,Brett Howden,C,VGK,26,82,13,15,28
37,8476873,Mark Jankowski,C,NSH,30,82,11,17,28
37,8483482,Tristan Luneau,D,ANA,20,82,7,21,28
37,8477034,Jaycob Megna,D,FLA,32,82,6,22,28
37,8478443,Brandon Carlo,D,BOS,28,82,5,23,28
37,8476967,Brett Kulak,D,EDM,30,82,3,25,28
37,8476312,Josh Manson,D,COL,33,82,2,26,28
37,8480813,Joe Veleno,C,DET,24,82,15,12,27
37,8482092,Ridly Greig,C,OTT,22,82,14,13,27
37,8477931,Tomas Nosek,L,FLA,32,82,10,17,27
37,8479414,Nathan Bastian,R,NJD,27,82,9,18,27
37,8484203,Bradly Nadeau,L,CAR,19,82,8,19,27
37,8482245,Artem Zub,D,OTT,29,82,5,22,27
37,8476457,Adam Larsson,D,SEA,32,82,4,23,27
37,8479293,Brandon Tanev,L,SEA,33,82,17,9,26
37,8477406,Mattias Janmark,C,EDM,32,82,14,12,26
37,8476469,Joel Armia,R,MTL,31,82,13,13,26
37,8477369,Carson Soucy,D,VAN,30,82,12,14,26
37,8481553,Bobby Brink,R,PHI,23,82,11,15,26
37,8483445,Cutter Gauthier,L,ANA,20,82,11,15,26
37,8477948,Travis Sanheim,D,PHI,28,82,10,16,26
37,8477919,Frederick Gaudreau,C,MIN,31,82,10,16,26
37,8482111,Justin Barron,D,MTL,23,82,10,16,26
37,8480222,Sebastian Aho,D,PIT,28,82,8,18,26
37,8482142,Jamie Drysdale,D,PHI,22,82,7,19,26
37,8478136,Jake Middleton,D,MIN,28,82,4,22,26
37,8482077,Dylan Holloway,L,EDM,23,82,18,7,25
37,8480281,Alexey Toropchenko,R,STL,25,82,17,8,25
37,8482155,Alex Laferriere,R,LAK,23,82,16,9,25
37,8481601,Simon Holmstrom,R,NYI,23,82,16,9,25
37,8481517,Brett Leason,R,ANA,25,82,14,11,25
37,8482062,Cole Smith,L,NSH,29,82,13,12,25
37,8482705,Cole Sillinger,C,CBJ,21,82,12,13,25
37,8480806,Isac Lundestrom,C,ANA,25,82,11,14,25
37,8479351,Sam Steel,C,DAL,26,82,8,17,25
37,8480855,Jack McBain,C,UTA,24,82,6,19,25
37,8482733,Logan Mailloux,D,MTL,31,82,5,20,25
37,8481014,Alexander Romanov,D,NYI,24,82,4,21,25
37,8479983,Mario Ferraro,D,SJS,26,82,2,23,25
37,8476429,Scott Mayfield,D,NYI,32,82,2,23,25
37,8480246,Nick Perbix,D,TBL,26,82,1,24,25
37,8470621,Corey Perry,R,EDM,39,82,14,10,24
37,8480980,Connor Dewar,C,TOR,25,82,10,14,24
37,8477903,Garnet Hathaway,R,PHI,33,82,9,15,24
37,8484145,Zach Benson,L,BUF,19,82,8,16,24
37,8483505,Matthew Poitras,C,BOS,20,82,8,16,24
37,8475343,Nic Dowd,C,WSH,34,82,7,17,24
37,8473507,Jeff Petry,D,DET,37,82,6,18,24
37,8479402,Jake Bean,D,CGY,26,82,5,19,24
37,8475188,Brayden McNabb,D,VGK,33,82,4,20,24
37,8477845,Trevor van Riemsdyk,D,WSH,33,82,3,21,24
37,8480459,Pius Suter,C,VAN,28,82,14,9,23
37,8482259,Bobby McMann,C,TOR,28,82,12,11,23
37,8473533,Jordan Staal,C,CAR,36,82,11,12,23
37,8476889,Radek Faksa,C,STL,30,82,10,13,23
37,8476918,Jimmy Vesey,L,NYR,31,82,10,13,23
37,8475231,Casey Cizikas,C,NYI,33,82,10,13,23
37,8481524,Bowen Byram,D,BUF,23,82,10,13,23
37,8482679,Matt Coronato,R,CGY,22,82,10,13,23
37,8482122,Brock Faber,D,MIN,22,82,6,17,23
37,8476467,Jamie Oleksiak,D,SEA,32,82,6,17,23
37,8476897,Oskar Sundqvist,C,STL,30,82,6,17,23
37,8480073,Erik Brannstrom,D,COL,25,82,5,18,23
37,8475690,Chris Tanev,D,TOR,35,82,4,19,23
37,8482087,Kaiden Guhle,D,MTL,22,82,2,21,23
37,8481580,Connor McMichael,C,WSH,23,82,13,9,22
37,8478211,Dryden Hunt,L,CGY,29,82,12,10,22
37,8473453,Trevor Lewis,C,LAK,37,82,11,11,22
37,8479638,Justin Brazeau,R,BOS,26,82,10,12,22
37,8482074,Connor Zary,C,CGY,23,82,9,13,22
37,8477015,Connor Brown,R,EDM,30,82,9,13,22
37,8479980,Nicolas Hague,D,VGK,26,82,7,15,22
37,8479369,Andrew Peeke,D,BOS,26,82,3,19,22
37,8480049,Dylan Samberg,D,WPG,25,82,3,19,22
37,8475279,Ben Chiarot,D,DET,33,82,3,19,22
37,8476902,Esa Lindell,D,DAL,30,82,3,19,22
37,8476331,Dylan DeMelo,D,WPG,31,82,2,20,22
37,8476879,Cody Ceci,D,EDM,31,82,1,21,22
37,8478416,Erik Cernak,D,TBL,27,82,1,21,22
37,8477392,Hudson Fasching,R,NYI,29,82,11,10,21
37,8482803,Olen Zellweger,D,ANA,21,82,10,11,21
37,8480144,David Kampf,C,TOR,29,82,10,11,21
37,8482624,Daniil Miromanov,D,CGY,27,82,7,14,21
37,8480021,Jack Studnicka,C,LAK,25,82,7,14,21
37,8478911,Matt Roy,D,WSH,29,82,5,16,21
37,8482073,Braden Schneider,D,NYR,23,82,5,16,21
37,8476891,Matt Grzelcyk,D,PIT,30,82,4,17,21
37,8479371,Dante Fabbro,D,NSH,26,82,4,17,21
37,8478840,Will Borgen,D,SEA,28,82,2,19,21
37,8479398,Samuel Girard,D,COL,26,82,2,19,21
37,8475790,Erik Gudbranson,D,CBJ,32,82,2,19,21
37,8478434,Keegan Kolesar,R,VGK,27,82,13,7,20
37,8480448,Parker Kelly,L,COL,25,82,11,9,20
37,8480995,Pontus Holmberg,R,TOR,25,82,9,11,20
37,8478013,Jake Walman,D,SJS,28,82,9,11,20
37,8481032,Paul Cotter,C,NJD,25,82,8,12,20
37,8481013,Jonatan Berggren,R,DET,24,82,8,12,20
37,8483397,Marc McLaughlin,C,BOS,25,82,8,12,20
37,8482666,Scott Morrow,D,CAR,22,82,7,13,20
37,8476624,Barclay Goodrow,C,SJS,31,82,7,13,20
37,8478399,Jonas Siegenthaler,D,NJD,27,82,6,14,20
37,8478859,Niko Mikkola,D,FLA,28,82,4,16,20
37,8474673,TJ Brodie,D,CHI,34,82,2,18,20
37,8483457,Lane Hutson,D,MTL,20,82,2,18,20
37,8474574,Tyler Myers,D,VAN,34,82,2,18,20
37,8481178,Egor Zamula,D,PHI,24,82,1,19,20
37,8478432,Christian Fischer,R,DET,27,82,12,7,19
37,8481477,Nico Sturm,C,SJS,29,82,11,8,19
37,8483493,Frank Nazar,C,CHI,20,82,10,9,19
37,8482762,Simon Edvinsson,D,DET,21,82,10,9,19
37,8481522,Peyton Krebs,C,BUF,23,82,9,10,19
37,8477450,Jason Dickinson,C,CHI,29,82,8,11,19
37,8482807,Ethan Del Mastro,D,CHI,21,82,8,11,19
37,8474567,Zach Bogosian,D,MIN,34,82,8,11,19
37,8481481,Blake Lizotte,C,PIT,27,82,7,12,19
37,8477505,Alexander Wennberg,C,SJS,30,82,7,12,19
37,8477425,Miles Wood,L,COL,29,82,6,13,19
37,8480003,Jesper Boqvist,C,FLA,26,82,5,14,19
37,8476525,Colin Miller,D,WPG,32,82,4,15,19
37,8483565,Nick Blankenburg,D,NSH,26,82,3,16,19
37,8480172,Jan Rutta,D,SJS,34,82,2,17,19
37,8475324,Nick Jensen,D,OTT,34,82,1,18,19
37,8478178,Darren Raddysh,D,TBL,28,82,1,18,19
37,8479316,Luke Kunin,C,SJS,27,82,12,6,18
37,8479368,Max Jones,L,BOS,26,82,10,8,18
37,8475842,Sam Carrick,C,NYR,32,82,9,9,18
37,8482470,Ilya Solovyov,D,CGY,24,82,7,11,18
37,8475233,David Savard,D,MTL,34,82,6,12,18
37,8478450,Parker Wotherspoon,D,BOS,27,82,6,12,18
37,8483490,Pavel Mintyukov,D,ANA,21,82,5,13,18
37,8479324,Ryan Lindgren,D,NYR,26,82,4,14,18
37,8477488,Brett Pesce,D,NJD,30,82,3,15,18
37,8475718,Justin Holl,D,DET,32,82,3,15,18
37,8476858,Phillip Di Giuseppe,L,VAN,31,82,10,7,17
37,8481028,Martin Pospisil,C,CGY,25,82,9,8,17
37,8482166,Shakir Mukhamadullin,D,SJS,22,82,8,9,17
37,8484149,Gavin Brindley,C,CBJ,20,82,8,9,17
37,8476442,Matt Nieto,L,PIT,32,82,8,9,17
37,8480074,Alexandre Texier,C,STL,25,82,6,11,17
37,8477365,Connor Clifton,D,BUF,29,82,5,12,17
37,8476473,Connor Murphy,D,CHI,31,82,5,12,17
37,8476931,Jake McCabe,D,TOR,31,82,3,14,17
37,8481568,Alex Vlasic,D,CHI,23,82,2,15,17
37,8480035,Henri Jokiharju,D,BUF,25,82,1,16,17
37,8483763,Maksymilian Szuber,D,UTA,22,82,9,7,16
37,8483468,Jiri Kulich,C,BUF,20,82,8,8,16
37,8483499,Liam Ohgren,L,MIN,20,82,7,9,16
37,8478508,Yakov Trenin,C,MIN,27,82,6,10,16
37,8480796,Martin Fehervary,D,WSH,25,82,5,11,16
37,8477508,Curtis Lazar,C,NJD,29,82,5,11,16
37,8477499,Rasmus Ristolainen,D,PHI,30,82,3,13,16
37,8481122,Simon Benoit,D,TOR,26,82,3,13,16
37,8480990,Declan Chisholm,D,MIN,24,82,3,13,16
37,8478468,Jeremy Lauzon,D,NSH,27,82,3,13,16
37,8475455,Brenden Dillon,D,NJD,34,82,1,15,16
37,8481641,Joel Kiviranta,L,COL,28,82,8,7,15
37,8482702,Logan Stankoven,C,DAL,21,82,7,8,15
37,8479359,Beck Malenstyn,L,BUF,26,82,6,9,15
37,8482809,Jackson Blake,R,CAR,21,82,6,9,15
37,8482101,Danil Gushchin,L,SJS,22,82,6,9,15
37,8482145,Mavrik Bourque,C,DAL,22,82,6,9,15
37,8482070,Mitchell Chaffee,R,TBL,26,82,5,10,15
37,8480025,MacKenzie Entwistle,R,FLA,25,82,4,11,15
37,8482712,Oskar Olausson,R,COL,22,82,4,11,15
37,8475462,Radko Gudas,D,ANA,34,82,3,12,15
37,8477938,Haydn Fleury,D,WPG,28,82,3,12,15
37,8480950,Ilya Lyubushkin,D,DAL,30,82,2,13,15
37,8475177,Calvin de Haan,D,COL,33,82,2,13,15
37,8481567,Henry Thrun,D,SJS,23,82,1,14,15
37,8484911,Collin Graf,R,SJS,22,82,1,14,15
37,8476441,Joel Edmundson,D,LAK,31,82,1,14,15
37,8483524,Shane Wright,C,SEA,20,82,8,6,14
37,8482141,Lukas Cormier,D,VGK,22,82,6,8,14
37,8479291,Kevin Rooney,C,CGY,31,82,6,8,14
37,8481708,Zac Jones,D,NYR,24,82,5,9,14
37,8483495,Simon Nemec,D,NJD,20,82,5,9,14
37,8477353,Tyler Motte,C,DET,29,82,4,10,14
37,8482858,Ryker Evans,D,SEA,23,82,3,11,14
37,8474013,Ian Cole,D,UTA,35,82,3,11,14
37,8483012,Logan Morrison,C,SEA,22,82,1,13,14
37,8474612,Travis Hamonic,D,OTT,34,82,1,13,14
37,8475762,Derek Forbort,D,VAN,32,82,1,13,14
37,8476822,Luke Glendening,C,TBL,35,82,10,3,13
37,8481605,Jackson LaCombe,D,ANA,23,82,6,7,13
37,8483567,Georgii Merkulov,C,BOS,24,82,5,8,13
37,8477335,Kyle Burroughs,D,LAK,29,82,4,9,13
37,8479576,Vincent Desharnais,D,VAN,28,82,4,9,13
37,8478874,Adam Gaudette,C,OTT,28,82,4,9,13
37,8482118,Sam Colangelo,R,ANA,23,82,3,10,13
37,8480807,Mattias Samuelsson,D,BUF,24,82,1,12,13
37,8480879,Jacob Bernard-Docker,D,OTT,24,82,1,12,13
37,8482749,Joshua Roy,R,MTL,21,82,4,8,12
37,8480834,Ty Emberson,D,SJS,24,82,3,9,12
37,8482153,Brendan Brisson,C,VGK,23,82,2,10,12
37,8483460,David Jiricek,D,CBJ,21,82,2,10,12
37,8481699,Aku Raty,R,UTA,23,82,7,4,11
37,8482713,Mackie Samoskevich,R,FLA,22,82,2,9,11
37,8482659,Josh Doan,R,UTA,22,82,5,5,10
37,8480870,Bo Groulx,C,NYR,24,82,5,5,10
37,8480860,Kevin Bahl,D,CGY,24,82,2,8,10
37,8471677,Jack Johnson,D,CBJ,37,82,1,9,10
37,8474062,Riley Nash,C,NYR,35,82,1,9,10
37,8479442,Troy Stecher,D,EDM,30,82,0,10,10
37,8483489,Fraser Minten,C,TOR,31,82,5,4,9
37,8476372,Nick Seeler,D,PHI,31,82,2,7,9
37,8474090,Brendan Smith,D,DAL,35,82,1,8,9
37,8482516,Matthew Kessel,D,STL,24,82,0,9,9
37,8483466,Kevin Korchinski,D,CHI,20,82,0,9,9
37,8482859,Zack Ostapchuk,C,OTT,21,82,5,3,8
37,8483471,Brad Lambert,C,WPG,31,82,2,6,8
37,8482787,Nikita Chibrikov,R,WPG,31,82,1,7,8
37,8470794,Joe Pavelski,C,,40,0,0,0,0
37,8481703,Valtteri Puustinen,R,PIT,25,0,0,0,0
37,8477950,Tony DeAngelo,D,,29,0,0,0,0
37,8481577,Philip Tomasino,C,NSH,23,0,0,0,0
37,8475197,Tyson Barrie,D,,33,0,0,0,0
37,8471218,Blake Wheeler,R,,38,0,0,0,0
37,8474157,Max Pacioretty,L,,36,0,0,0,0
37,8478466,Daniel Sprong,R,VAN,27,0,0,0,0
37,8475744,Evgeny Kuznetsov,C,,32,0,0,0,0
37,8481019,David Gustafsson,C,WPG,24,0,0,0,0
37,8475906,John Klingberg,D,,32,0,0,0,0
37,8479348,Kale Clague,D,BUF,26,0,0,0,0
37,8476952,Dominic Toninato,C,WPG,30,0,0,0,0
37,8473473,Milan Lucic,L,,36,0,0,0,0
37,8474037,James van Riemsdyk,L,,35,0,0,0,0
37,8474602,Justin Schultz,D,,34,0,0,0,0
37,8482222,Alexander Barabanov,L,,30,0,0,0,0
37,8479372,Josh Mahura,D,SEA,26,0,0,0,0
37,8479982,Conor Timmins,D,TOR,26,0,0,0,0
37,8474031,Kevin Shattenkirk,D,,35,0,0,0,0
37,8480008,Adam Ruzicka,C,,25,0,0,0,0
37,8481059,Scott Perunovich,D,STL,26,0,0,0,0
37,8480884,Calen Addison,D,,24,0,0,0,0
37,8476994,Vinnie Hinostroza,C,NSH,30,0,0,0,0
37,8478452,Caleb Jones,D,LAK,27,0,0,0,0
37,8480157,Calle Rosen,D,COL,30,0,0,0,0
37,8481609,Vladislav Kolyachonok,D,UTA,23,0,0,0,0
37,8479415,Michael McLeod,C,,26,0,0,0,0
37,8476919,Chris Tierney,C,,30,0,0,0,0
37,8479639,Dylan Coghlan,D,WPG,26,0,0,0,0
37,8478146,Matthew Highmore,C,OTT,28,0,0,0,0
37,8478970,Jalen Chatfield,D,CAR,28,0,0,0,0
37,8480205,Emil Bemstrom,C,PIT,25,0,0,0,0
37,8474884,Mike Hoffman,C,,35,0,0,0,0
37,8471274,Alex Goligoski,D,,39,0,0,0,0
37,8478104,Sammy Blais,L,,28,0,0,0,0
37,8474870,Tyler Johnson,C,,34,0,0,0,0
37,8476913,Devin Shore,C,MIN,30,0,0,0,0
37,8481598,Philip Broberg,D,EDM,23,0,0,0,0
37,8480058,Pierre-Olivier Joseph,D,STL,25,0,0,0,0
37,8480891,Michael Kesselring,D,UTA,24,0,0,0,0
37,8477979,Nicolas Aube-Kubel,R,BUF,28,0,0,0,0
37,8476871,Tanner Pearson,L,,32,0,0,0,0
37,8476393,Nick Cousins,C,,31,0,0,0,0
37,8479977,Kailer Yamamoto,R,,26,0,0,0,0
37,8479543,Michael Pezzetta,L,MTL,26,0,0,0,0
37,8477018,Ben Hutton,D,VGK,31,0,0,0,0
37,8480762,Eric Robinson,L,CAR,29,0,0,0,0
37,8474034,Pat Maroon,L,CHI,36,0,0,0,0
37,8481058,Jesse Ylönen,R,,25,0,0,0,0
37,8475179,Dmitry Kulikov,D,FLA,34,0,0,0,0
37,8481527,Kaedan Korczak,D,VGK,23,0,0,0,0
37,8473449,Kyle Okposo,R,,36,0,0,0,0
37,8482192,Isaak Phillips,D,CHI,23,0,0,0,0
37,8480727,Zach Whitecloud,D,VGK,28,0,0,0,0
37,8479346,Dillon Dube,C,,26,0,0,0,0
37,8480821,Filip Zadina,R,,25,0,0,0,0
37,8480001,Urho Vaakanainen,D,ANA,25,0,0,0,0
37,8470966,Mark Giordano,D,,41,0,0,0,0
37,8480853,Liam Foudy,C,,24,0,0,0,0
37,8475225,Craig Smith,C,CHI,35,0,0,0,0
37,8479972,Mason Shaw,C,WPG,26,0,0,0,0
37,8478451,Ethan Bear,D,WSH,27,0,0,0,0
37,8474040,Sam Gagner,C,,35,0,0,0,0
37,8480196,Jacob Bryson,D,BUF,27,0,0,0,0
37,8479984,Cal Foote,D,,26,0,0,0,0
37,8480011,Klim Kostin,C,SJS,25,0,0,0,0
37,8482176,Wyatt Kaiser,D,CHI,22,0,0,0,0
37,8476988,Matt Benning,D,SJS,30,0,0,0,0
37,8479370,Tyson Jost,C,CAR,26,0,0,0,0
37,8477464,Nic Petan,C,,29,0,0,0,0
37,8477380,Jonny Brodzinski,C,NYR,31,0,0,0,0
37,8480070,Ian Mitchell,D,BOS,25,0,0,0,0
37,8479315,Joey Anderson,R,CHI,26,0,0,0,0
37,8478099,Kevin Labanc,R,,29,0,0,0,0
37,8476874,Olli Maatta,D,DET,30,0,0,0,0
37,8475208,Brian Dumoulin,D,ANA,33,0,0,0,0
37,8478430,Oliver Kylington,D,,27,0,0,0,0
37,8479536,Axel Jonsson-Fjallby,L,WPG,26,0,0,0,0
37,8479671,Mathieu Olivier,R,CBJ,27,0,0,0,0
37,8471709,Marc-Edouard Vlasic,D,SJS,37,0,0,0,0
37,8479328,Julien Gauthier,R,NYI,27,0,0,0,0
37,8478421,A.J. Greer,L,FLA,28,0,0,0,0
37,8477573,Nathan Walker,L,STL,30,0,0,0,0
37,8481537,Nikita Okhotiuk,D,CGY,24,0,0,0,0
37,8474166,Alec Martinez,D,CHI,37,0,0,0,0
37,8470610,Zach Parise,L,,40,0,0,0,0
37,8477478,William Carrier,L,CAR,30,0,0,0,0
37,8479344,Jesse Puljujarvi,R,PIT,26,0,0,0,0
37,8480887,Jordan Harris,D,MTL,24,0,0,0,0
37,8478502,Dennis Gilbert,D,BUF,28,0,0,0,0
37,8482730,Brandt Clarke,D,LAK,21,0,0,0,0
37,8480355,Mark Kastelic,C,BOS,25,0,0,0,0
37,8475750,Jon Merrill,D,MIN,32,0,0,0,0
37,8475164,Jakob Silfverberg,R,,34,0,0,0,0
37,8477944,Jakub Vrana,L,,28,0,0,0,0
37,8479439,Jacob MacDonald,D,COL,31,0,0,0,0
37,8474568,Luke Schenn,D,NSH,35,0,0,0,0
37,8478454,Noah Juulsen,D,VAN,27,0,0,0,0
37,8475752,Tyler Pitlick,C,,33,0,0,0,0
37,8482148,Hendrix Lapierre,C,WSH,22,0,0,0,0
37,8481167,Brayden Pachal,D,CGY,25,0,0,0,0
37,8478043,Sam Lafferty,C,BUF,29,0,0,0,0
37,8479321,Lucas Johansen,D,,27,0,0,0,0
37,8471699,Andrew Cogliano,C,,37,0,0,0,0
37,8481521,Ronnie Attard,D,PHI,25,0,0,0,0
37,8481161,Jake Christiansen,D,CBJ,25,0,0,0,0
37,8479458,Nikita Zaitsev,D,,33,0,0,0,0
37,8479619,Michael Carcone,L,UTA,28,0,0,0,0
37,8479026,Philippe Myers,D,TOR,27,0,0,0,0
37,8477330,Dominik Kubalik,L,,29,0,0,0,0
37,8481617,Vasily Podkolzin,R,VAN,23,0,0,0,0
37,8481701,Santeri Hatakka,D,NJD,23,0,0,0,0
37,8479514,Rem Pitlick,C,,27,0,0,0,0
37,8477446,Michael McCarron,R,NSH,29,0,0,0,0
37,8470604,Jeff Carter,C,,39,0,0,0,0
37,8482241,Radim Zohorna,L,,28,0,0,0,0
37,8480289,Morgan Barron,C,WPG,26,0,0,0,0
37,8479379,Givani Smith,R,SJS,26,0,0,0,0
37,8480216,Jacob Peterson,C,,25,0,0,0,0
37,8477851,Jordan Oesterle,D,BOS,32,0,0,0,0
37,8484258,Sam Malinski,D,COL,26,0,0,0,0
37,8478904,Steven Lorentz,C,,28,0,0,0,0
37,8482095,Tyler Kleven,D,OTT,22,0,0,0,0
37,8480848,Ty Dellandrea,C,SJS,24,0,0,0,0
37,8476884,Derrick Pouliot,D,,30,0,0,0,0
37,8479336,Carl Grundstrom,R,SJS,27,0,0,0,0
37,8482964,Arber Xhekaj,D,MTL,23,0,0,0,0
37,8471686,Marc Staal,D,,37,0,0,0,0
37,8477887,Patrick Brown,C,BOS,32,0,0,0,0
37,8478495,Denis Gurianov,R,,27,0,0,0,0
37,8473504,Cal Clutterbuck,R,,37,0,0,0,0
37,8481550,Adam Beckman,L,NJD,23,0,0,0,0
37,8480845,Rasmus Kupari,C,WPG,24,0,0,0,0
37,8474009,Nick Bonino,C,,36,0,0,0,0
37,8478585,Derek Ryan,C,EDM,38,0,0,0,0
37,8477962,Brendan Lemieux,L,CAR,28,0,0,0,0
37,8482861,Vincent Iorio,D,WSH,22,0,0,0,0
37,8479378,Logan Stanley,D,WPG,26,0,0,0,0
37,8473446,Erik Johnson,D,PHI,36,0,0,0,0
37,8481743,Marc Del Gaizo,D,NSH,25,0,0,0,0
37,8477384,Josh Brown,D,EDM,30,0,0,0,0
37,8482165,Yan Kuznetsov,D,CGY,22,0,0,0,0
37,8478424,Jansen Harkins,C,ANA,27,0,0,0,0
37,8482144,Jack Thompson,D,SJS,22,0,0,0,0
37,8478512,Austin Czarnik,C,,32,0,0,0,0
37,8477527,Ross Johnston,L,ANA,30,0,0,0,0
37,8479383,Boris Katchouk,L,,26,0,0,0,0
37,8482094,Daemon Hunt,D,MIN,22,0,0,0,0
37,8481719,Maxwell Crozier,D,TBL,24,0,0,0,0
37,8480192,Johnathan Kovacevic,D,NJD,27,0,0,0,0
37,8479376,Victor Mete,D,,26,0,0,0,0
37,8482511,Mason Lohrei,D,BOS,23,0,0,0,0
37,8475825,Jani Hakanpää,D,,32,0,0,0,0
37,8478021,William Lagesson,D,DET,28,0,0,0,0
37,8475795,Dylan McIlrath,D,WSH,32,0,0,0,0
37,8477846,Ryan Carpenter,C,,33,0,0,0,0
37,8481056,Spencer Stastney,D,NSH,24,0,0,0,0
37,8481564,Ryan Johnson,D,BUF,23,0,0,0,0
37,8478017,Mark Friedman,D,VAN,29,0,0,0,0
37,8479320,Max Lajoie,D,SEA,27,0,0,0,0
37,8480075,Cameron Crotty,D,MIN,25,0,0,0,0
37,8484287,Cole McWard,D,VAN,23,0,0,0,0
37,8484254,Akito Hirose,D,VAN,25,0,0,0,0
37,8483407,Brandon Scanlin,D,NYR,25,0,0,0,0
37,8480274,Philip Kemp,D,EDM,25,0,0,0,0
37,8479522,Hardy Haman Aktell,D,WSH,26,0,0,0,0
37,8480007,Jonas Rondbjerg,R,VGK,25,0,0,0,0
37,8477454,Adam Erne,L,,29,0,0,0,0
37,8481679,Maxence Guenette,D,OTT,23,0,0,0,0
37,8480441,Trey Fix-Wolansky,R,CBJ,25,0,0,0,0
37,8483546,Marshall Rifai,D,TOR,26,0,0,0,0
37,8480084,Nick DeSimone,D,NJD,30,0,0,0,0
37,8481030,Jack St. Ivany,D,PIT,25,0,0,0,0
37,8481592,Jakob Pelletier,L,CGY,23,0,0,0,0
37,8478011,Louie Belpedio,D,PHI,28,0,0,0,0
37,8477930,Pierre-Edouard Bellemare,L,,39,0,0,0,0
37,8484321,Nikolas Matinpalo,D,OTT,26,0,0,0,0
37,8482067,Connor Mackey,D,NYR,28,0,0,0,0
37,8481806,Louis Crevier,D,CHI,23,0,0,0,0
37,8484326,Patrik Koch,D,UTA,28,0,0,0,0
37,8477971,Andreas Englund,D,LAK,28,0,0,0,0
37,8481751,Lukas Rousek,R,BUF,25,0,0,0,0
37,8481006,Tyler Tucker,D,STL,24,0,0,0,0
37,8476867,Brendan Gaunce,C,MIN,30,0,0,0,0
37,8479520,Brandon Duhaime,R,WSH,27,0,0,0,0
37,8477073,Kurtis MacDermid,L,NJD,30,0,0,0,0
37,8480874,Adam Ginning,D,PHI,24,0,0,0,0
37,8477473,Justin Bailey,R,SJS,29,0,0,0,0
37,8479066,Ryan Lomberg,L,CGY,30,0,0,0,0
37,8477070,Liam O'Brien,C,UTA,30,0,0,0,0
37,8474618,Marco Scandella,D,,34,0,0,0,0
37,8475797,Jarred Tinordi,D,,32,0,0,0,0
37,8481441,Joe Snively,C,DET,28,0,0,0,0
37,8477244,Chad Ruhwedel,D,NYR,34,0,0,0,0
37,8479772,Zack MacEwen,R,OTT,28,0,0,0,0
37,8481147,Reese Johnson,C,MIN,26,0,0,0,0
37,8481043,Cole Koepke,L,BOS,26,0,0,0,0
37,8483619,Filip Roos,D,OTT,25,0,0,0,0
37,8481541,Samuel Bolduc,D,NYI,24,0,0,0,0
37,8477810,Joel Hanley,D,CGY,33,0,0,0,0
37,8476907,Mackenzie MacEachern,L,,30,0,0,0,0
37,8482652,Walker Duehr,R,CGY,27,0,0,0,0
37,8477126,Jayson Megna,C,,34,0,0,0,0
37,8483398,Declan Carlile,D,TBL,31,0,0,0,0
37,8482929,Emil Lilleberg,D,TBL,23,0,0,0,0
37,8480880,Jakub Lauko,C,MIN,24,0,0,0,0
37,8480245,Olle Lycksell,R,PHI,25,0,0,0,0
37,8480252,Cole Guttman,C,CHI,25,0,0,0,0
37,8477467,Gustav Olofsson,D,SEA,30,0,0,0,0
37,8479968,Vinni Lettieri,C,BOS,29,0,0,0,0
37,8478400,Colin White,C,,27,0,0,0,0
37,8475755,Alexander Petrovic,D,DAL,32,0,0,0,0
37,8481812,Nikolai Knyzhov,D,,27,0,0,0,0
37,8481593,Jayden Struble,D,MTL,23,0,0,0,0
37,8481532,Alex Turcotte,C,LAK,23,0,0,0,0
37,8482126,Emil Andrae,D,PHI,31,0,0,0,0
37,8479944,Zach Aston-Reese,C,VGK,30,0,0,0,0
37,8471817,Ryan Reaves,R,TOR,37,0,0,0,0
37,8481206,John Ludvig,D,PIT,24,0,0,0,0
37,8481599,Victor Soderstrom,D,UTA,23,0,0,0,0
37,8480292,Carson Meyer,R,ANA,27,0,0,0,0
37,8482496,Nils Aman,C,VAN,24,0,0,0,0
37,8479718,Alex Barré-Boulet,C,MTL,27,0,0,0,0
37,8479994,Jaret Anderson-Dolan,C,WPG,25,0,0,0,0
37,8480184,Gustav Lindstrom,D,,26,0,0,0,0
37,8480890,Jan Jenik,R,OTT,24,0,0,0,0
37,8478067,Oskar Lindblom,L,,28,0,0,0,0
37,8476934,Brock McGinn,L,ANA,30,0,0,0,0
37,8479985,Cale Fleury,D,SEA,26,0,0,0,0
37,8484304,Uvis Balinskis,D,FLA,28,0,0,0,0
37,8479981,Jonah Gadjovich,L,FLA,26,0,0,0,0
37,8481716,Dmitri Voronkov,L,CBJ,24,0,0,0,0
37,8474709,Matt Martin,L,,35,0,0,0,0
37,8482634,Alex Steeves,C,TOR,25,0,0,0,0
37,8480823,Alexander Alexeyev,D,WSH,25,0,0,0,0
37,8477541,Dakota Mermis,D,TOR,30,0,0,0,0
37,8483491,Ivan Miroshnichenko,L,WSH,20,0,0,0,0
37,8478477,Mitchell Stephens,C,SEA,27,0,0,0,0
37,8481543,Nikita Alexandrov,C,STL,24,0,0,0,0
37,8479423,Alex Nylander,L,,26,0,0,0,0
37,8482451,Mikael Pyyhtia,L,CBJ,23,0,0,0,0
37,8478831,Kevin Stenlund,C,UTA,28,0,0,0,0
37,8480306,Grant Hutton,D,NYI,29,0,0,0,0
37,8478028,Fredrik Olofsson,L,,28,0,0,0,0
37,8477462,Robert Hagg,D,VGK,29,0,0,0,0
37,8477320,Anton Blidh,L,NYR,29,0,0,0,0
37,8482157,Will Cuylle,L,NYR,22,0,0,0,0
37,8482737,Zack Bolduc,C,STL,21,0,0,0,0
37,8481239,Samuel Fagemo,L,,24,0,0,0,0
37,8481600,Tobias Bjornfot,D,FLA,23,0,0,0,0
37,8478409,Anthony Richard,C,PHI,28,0,0,0,0
37,8474145,Robert Bortuzzo,D,,35,0,0,0,0
37,8475958,Michael Sgarbossa,C,WSH,32,0,0,0,0
37,8479986,Kole Lind,R,DAL,26,0,0,0,0
37,8479249,Andrew Poturalski,C,SJS,30,0,0,0,0
37,8479362,Riley Tufte,L,BOS,26,0,0,0,0
37,8479991,Jake Leschyshyn,C,NYR,25,0,0,0,0
37,8479587,Rhett Gardner,C,PHI,28,0,0,0,0
37,8482744,James Malatesta,L,CBJ,21,0,0,0,0
37,8478854,Ryan Shea,D,PIT,27,0,0,0,0
37,8481591,Sam Poulin,R,,23,0,0,0,0
37,8483512,Matt Savoie,C,EDM,20,0,0,0,0
37,8482102,Vasily Ponomarev,C,PIT,22,0,0,0,0
37,8482162,Roby Jarventie,L,EDM,22,0,0,0,0
37,8481016,Ruslan Iskhakov,C,,24,0,0,0,0
37,8482172,Landon Slaggert,L,CHI,22,0,0,0,0
37,8482747,Brennan Othmann,L,NYR,21,0,0,0,0
37,8480031,Maxime Comtois,L,,25,0,0,0,0
37,8480226,Marián Studenic,R,,26,0,0,0,0
37,8478408,Travis Dermott,D,,28,0,0,0,0
37,8481518,Nolan Foote,L,NJD,24,0,0,0,0
37,8479419,Brett Murray,L,BUF,26,0,0,0,0
37,8482088,Justin Sourdif,R,FLA,22,0,0,0,0
37,8482201,Gage Goncalves,C,TBL,23,0,0,0,0
37,8481578,Graeme Clarke,R,MIN,23,0,0,0,0
37,8482177,Marat Khusnutdinov,C,MIN,22,0,0,0,0
37,8481754,Nikita Nesterenko,C,ANA,23,0,0,0,0
37,8483531,Brian Halonen,L,NJD,25,0,0,0,0
37,8483920,Pierrick Dube,R,WSH,23,0,0,0,0
37,8480851,Akil Thomas,C,LAK,24,0,0,0,0
37,8475235,Nicolas Deslauriers,L,PHI,33,0,0,0,0
37,8482476,Emil Heineman,L,MTL,23,0,0,0,0
37,8477149,Scott Sabourin,R,SJS,32,0,0,0,0
37,8483549,Lucas Condotta,L,MTL,27,0,0,0,0
37,8482765,Isak Rosen,R,BUF,21,0,0,0,0
37,8481237,Kyle MacLean,C,NYI,25,0,0,0,0
37,8481024,Linus Karlsson,C,VAN,25,0,0,0,0
37,8481690,Tyler Angle,C,,24,0,0,0,0
37,8483570,Ben Meyers,C,SEA,26,0,0,0,0
37,8481655,Cole Schwindt,R,CGY,23,0,0,0,0
37,8481462,Mason Morelli,L,VGK,28,0,0,0,0
37,8483401,Marc Johnstone,R,PIT,28,0,0,0,0
37,8478956,Samuel Laberge,L,NJD,27,0,0,0,0
37,8479533,Joona Koppanen,L,,26,0,0,0,0
37,8482197,Adam Raska,R,MIN,23,0,0,0,0
37,8482250,Callahan Burke,C,VGK,27,0,0,0,0
37,8482784,Zach Dean,C,STL,21,0,0,0,0
37,8484255,Jason Polin,R,COL,25,0,0,0,0
37,8481077,John Leonard,L,,26,0,0,0,0
37,8481534,Raphael Lavoie,C,EDM,24,0,0,0,0
37,8483609,Adam Klapka,R,CGY,24,0,0,0,0
37,8482751,Ryan Winterton,C,SEA,21,0,0,0,0
37,8480267,Sammy Walker,C,MIN,25,0,0,0,0
37,8475766,Austin Watson,L,,32,0,0,0,0
37,8482460,Matt Rempe,C,NYR,22,0,0,0,0
37,8481065,Angus Crookshank,L,OTT,25,0,0,0,0
37,8481070,Hugh McGing,L,,26,0,0,0,0
37,8476323,Max McCormick,L,SEA,32,0,0,0,0
37,8483395,Arshdeep Bains,L,VAN,23,0,0,0,0
37,8484259,Ondrej Pavel,C,COL,31,0,0,0,0
37,8483432,Luca Del Bel Belluz,C,CBJ,31,0,0,0,0
37,8483045,Cameron Butler,R,CBJ,31,0,0,0,0
37,8482061,Brandon Biro,L,SEA,26,0,0,0,0
37,8477401,John Hayden,C,SEA,29,0,0,0,0
37,8475278,Byron Froese,C,,33,0,0,0,0
37,8478446,Glenn Gawdin,C,LAK,27,0,0,0,0
37,8477993,Justin Kirkland,C,CGY,28,0,0,0,0
37,8482147,Jean-Luc Foudy,C,COL,22,0,0,0,0
37,8480032,Shane Bowers,C,NJD,25,0,0,0,0
37,8479330,Brandon Gignac,C,MTL,27,0,0,0,0
37,8480776,Sheldon Rempal,R,,29,0,0,0,0
37,8475413,Justin Dowling,C,NJD,34,0,0,0,0
37,8481726,Adam Edstrom,C,NYR,24,0,0,0,0
37,8480844,Grigori Denisenko,L,VGK,24,0,0,0,0
37,8478147,Bokondji Imama,L,PIT,28,0,0,0,0
37,8478881,Brett Seney,L,CHI,28,0,0,0,0
37,8483630,Pavol Regenda,L,ANA,25,0,0,0,0
37,8480836,Jonathan Gruden,C,,24,0,0,0,0
37,8484314,Jiri Smejkal,L,,28,0,0,0,0
37,8475780,Chris Wagner,R,COL,33,0,0,0,0
37,8479546,Oskar Steen,C,,26,0,0,0,0
37,8483597,Milos Kelemen,L,UTA,25,0,0,0,0
37,8481789,Tye Kartye,L,SEA,23,0,0,0,0
37,8484325,Waltteri Merela,C,TBL,26,0,0,0,0
37,8479421,Jacob Moverare,D,LAK,26,0,0,0,0
37,8481585,Egor Afanasyev,L,SJS,23,0,0,0,0
37,8479547,Matthew Phillips,R,,26,0,0,0,0
37,8479367,William Lockwood,R,FLA,26,0,0,0,0
37,8476915,Jujhar Khaira,L,,30,0,0,0,0
37,8481422,Jacob Lucchini,C,NSH,29,0,0,0,0
37,8480468,James Hamblin,L,EDM,25,0,0,0,0
37,8478051,Max Willman,C,NJD,29,0,0,0,0
37,8481556,John Beecher,C,BOS,23,0,0,0,0
37,8478078,Rourke Chartier,C,,28,0,0,0,0
38,8477492,Nathan MacKinnon,C,COL,29,82,70,94,164
38,8478402,Connor McDavid,C,EDM,27,82,37,93,130
38,8476453,Nikita Kucherov,R,TBL,31,82,37,88,125
38,8479318,Auston Matthews,C,TOR,27,82,72,48,120
38,8471675,Sidney Crosby,C,PIT,37,82,55,64,119
38,8477956,David Pastrnak,R,BOS,28,82,62,56,118
38,8477934,Leon Draisaitl,C,EDM,29,82,47,70,117
38,8480027,Jason Robertson,L,DAL,25,82,44,68,112
38,8478864,Kirill Kaprizov,L,MIN,27,82,47,62,109
38,8479314,Matthew Tkachuk,L,FLA,27,82,33,74,107
38,8477939,William Nylander,R,TOR,28,82,42,63,105
38,8477946,Dylan Larkin,C,DET,28,82,46,57,103
38,8481559,Jack Hughes,C,NJD,23,82,46,57,103
38,8478398,Kyle Connor,L,WPG,28,82,46,56,102
38,8478427,Sebastian Aho,C,CAR,27,82,40,62,102
38,8478550,Artemi Panarin,L,NYR,33,82,33,67,100
38,8480069,Cale Makar,D,COL,26,82,21,79,100
38,8480800,Quinn Hughes,D,VAN,25,82,16,79,95
38,8482116,Tim Stützle,C,OTT,22,82,32,62,94
38,8476887,Filip Forsberg,L,NSH,30,82,40,53,93
38,8478420,Mikko Rantanen,R,COL,28,82,36,57,93
38,8480012,Elias Pettersson,C,VAN,26,82,32,61,93
38,8476468,J.T. Miller,C,VAN,31,82,36,56,92
38,8476456,Jonathan Huberdeau,C,CGY,31,82,18,74,92
38,8480002,Nico Hischier,C,NJD,25,82,31,60,91
38,8482665,Matty Beniers,C,SEA,22,82,28,61,89
38,8477409,Carter Verhaeghe,C,FLA,29,82,47,41,88
38,8478403,Jack Eichel,C,VGK,28,82,46,42,88
38,8477404,Jake Guentzel,C,TBL,30,82,42,46,88
38,8478445,Mathew Barzal,C,NYI,27,82,27,61,88
38,8474564,Steven Stamkos,C,NSH,34,82,41,46,87
38,8477493,Aleksander Barkov,C,FLA,29,82,26,60,86
38,8473512,Claude Giroux,R,OTT,36,82,25,61,86
38,8477942,Kevin Fiala,L,LAK,28,82,32,52,84
38,8479343,Clayton Keller,R,UTA,26,82,32,52,84
38,8471214,Alex Ovechkin,L,WSH,39,82,39,44,83
38,8476460,Mark Scheifele,C,WPG,31,82,35,48,83
38,8479323,Adam Fox,D,NYR,26,82,24,59,83
38,8471215,Evgeni Malkin,C,PIT,38,82,22,61,83
38,8475913,Mark Stone,R,VGK,32,82,20,63,83
38,8479420,Tage Thompson,C,BUF,27,82,37,45,82
38,8475172,Nazem Kadri,C,CGY,34,82,28,54,82
38,8478449,Roope Hintz,C,DAL,28,82,45,36,81
38,8481557,Matt Boldy,L,MIN,23,82,44,36,80
38,8477955,Jared McCann,L,SEA,28,82,35,45,80
38,8482078,Lucas Raymond,L,DET,22,82,29,51,80
38,8475692,Mats Zuccarello,R,MIN,37,82,11,69,80
38,8477949,Alex Tuch,R,BUF,28,82,27,52,79
38,8477501,Valeri Nichushkin,R,COL,29,82,43,35,78
38,8476459,Mika Zibanejad,C,NYR,31,82,28,50,78
38,8474600,Roman Josi,D,NSH,34,82,20,58,78
38,8474590,John Carlson,D,WSH,34,82,13,65,78
38,8478414,Timo Meier,R,NJD,28,82,39,38,77
38,8478010,Brayden Point,C,TBL,28,82,36,41,77
38,8479385,Jordan Kyrou,C,STL,26,82,32,45,77
38,8479407,Jesper Bratt,L,NJD,26,82,31,46,77
38,8475810,Bryan Rust,R,PIT,32,82,34,42,76
38,8473419,Brad Marchand,L,BOS,36,82,30,46,76
38,8480839,Rasmus Dahlin,D,BUF,24,82,18,58,76
38,8480801,Brady Tkachuk,L,OTT,25,82,39,36,75
38,8477935,Sam Bennett,C,FLA,28,82,38,37,75
38,8475166,John Tavares,C,TOR,34,82,34,41,75
38,8477940,Nikolaj Ehlers,L,WPG,28,82,28,47,75
38,8474679,Gustav Nyquist,C,NSH,35,82,22,53,75
38,8478444,Brock Boeser,R,VAN,27,82,38,36,74
38,8478439,Travis Konecny,R,PHI,27,82,32,42,74
38,8478975,Mason Marchment,L,DAL,29,82,25,49,74
38,8480023,Robert Thomas,C,STL,25,82,23,51,74
38,8481523,Kirby Dach,C,MTL,23,82,14,60,74
38,8480830,Andrei Svechnikov,R,CAR,24,82,34,39,73
38,8479542,Brandon Hagel,L,TBL,26,82,34,39,73
38,8474141,Patrick Kane,R,DET,36,82,29,44,73
38,8477402,Pavel Buchnevich,L,STL,29,82,29,44,73
38,8475167,Victor Hedman,D,TBL,34,82,12,60,72
38,8477500,Bo Horvat,C,NYI,29,82,30,41,71
38,8475168,Matt Duchene,C,DAL,33,82,28,43,71
38,8475784,Jeff Skinner,C,EDM,32,82,28,43,71
38,8476346,Johnny Gaudreau,L,CBJ,31,82,17,54,71
38,8477504,Josh Morrissey,D,WPG,29,82,16,55,71
38,8479675,Trevor Moore,L,LAK,29,82,32,38,70
38,8477933,Sam Reinhart,C,FLA,29,82,28,42,70
38,8476454,Ryan Nugent-Hopkins,C,EDM,31,82,20,50,70
38,8478047,Michael Bunting,L,PIT,29,82,32,37,69
38,8480208,Drake Batherson,R,OTT,26,82,27,42,69
38,8479400,Pierre-Luc Dubois,L,WSH,26,82,27,42,69
38,8477496,Elias Lindholm,C,BOS,30,82,19,50,69
38,8476539,Jonathan Marchessault,R,NSH,34,82,29,39,68
38,8480036,Miro Heiskanen,D,DAL,25,82,21,47,68
38,8476462,Dougie Hamilton,D,NJD,31,82,21,47,68
38,8476853,Morgan Rielly,D,TOR,30,82,9,59,68
38,8482093,Seth Jarvis,C,CAR,22,82,32,35,67
38,8475726,Tyler Toffoli,C,SJS,32,82,30,37,67
38,8477951,Nick Schmaltz,C,UTA,28,82,27,40,67
38,8478873,Troy Terry,R,ANA,27,82,27,40,67
38,8482097,Jack Quinn,R,BUF,23,82,24,43,67
38,8476389,Vincent Trocheck,C,NYR,31,82,20,47,67
38,8476881,Tomas Hertl,C,VGK,31,82,32,34,66
38,8473994,Jamie Benn,L,DAL,35,82,22,44,66
38,8477960,Adrian Kempe,R,LAK,28,82,27,38,65
38,8479337,Alex DeBrincat,R,DET,27,82,26,39,65
38,8475169,Evander Kane,L,EDM,33,82,36,28,64
38,8478498,Jake DeBrusk,L,VAN,28,82,34,30,64
38,8478493,Joel Eriksson Ek,C,MIN,27,82,32,32,64
38,8481711,Matias Maccelli,L,UTA,24,82,19,45,64
38,8475794,Tyler Seguin,C,DAL,32,82,34,29,63
38,8475754,Brock Nelson,C,NYI,33,82,30,33,63
38,8475158,Ryan O'Reilly,C,NSH,33,82,27,36,63
38,8476826,Yanni Gourde,C,SEA,33,82,22,41,63
38,8482684,Luke Hughes,D,NJD,21,82,14,49,63
38,8478460,Zach Werenski,D,CBJ,27,82,13,50,63
38,8476483,Rickard Rakell,R,PIT,31,82,36,26,62
38,8475786,Zach Hyman,L,EDM,32,82,34,28,62
38,8481540,Cole Caufield,R,MTL,23,82,33,29,62
38,8474102,David Perron,L,OTT,36,82,31,31,62
38,8481528,Dylan Cozens,C,BUF,23,82,26,36,62
38,8475765,Vladimir Tarasenko,R,DET,33,82,26,36,62
38,8478042,Viktor Arvidsson,R,EDM,31,82,29,32,61
38,8478440,Dylan Strome,C,WSH,27,82,27,34,61
38,8479339,Patrik Laine,L,CBJ,26,82,27,34,61
38,8480039,Martin Necas,C,CAR,25,82,26,35,61
38,8482149,Cole Perfetti,C,WPG,22,82,24,37,61
38,8479425,Filip Hronek,D,VAN,27,82,13,48,61
38,8476432,Boone Jenner,C,CBJ,31,82,34,26,60
38,8478542,Evan Rodrigues,C,FLA,31,82,31,29,60
38,8478401,Pavel Zacha,C,BOS,27,82,25,35,60
38,8480015,Owen Tippett,R,PHI,25,82,24,36,60
38,8478397,Rasmus Andersson,D,CGY,28,82,16,44,60
38,8471698,T.J. Oshie,R,WSH,38,82,33,26,59
38,8475170,Brayden Schenn,C,STL,33,82,27,32,59
38,8476882,Teuvo Teravainen,L,CHI,30,82,26,33,59
38,8477494,Jonathan Drouin,L,COL,29,82,23,36,59
38,8477451,Ryan Hartman,R,MIN,30,82,22,37,59
38,8477447,Shea Theodore,D,VGK,29,82,16,43,59
38,8474578,Erik Karlsson,D,PIT,34,82,11,48,59
38,8479325,Charlie McAvoy,D,BOS,27,82,7,52,59
38,8480797,Joel Farabee,L,PHI,24,82,23,35,58
38,8482671,Owen Power,D,BUF,22,82,14,44,58
38,8475184,Chris Kreider,L,NYR,33,82,32,25,57
38,8476448,William Karlsson,C,VGK,31,82,25,32,57
38,8476399,Blake Coleman,C,CGY,33,82,28,28,56
38,8477476,Artturi Lehkonen,L,COL,29,82,24,32,56
38,8480018,Nick Suzuki,C,MTL,25,82,21,35,56
38,8471685,Anze Kopitar,C,LAK,37,82,20,36,56
38,8475798,Mikael Granlund,C,SJS,32,82,15,41,56
38,8471724,Kris Letang,D,PIT,37,82,9,47,56
38,8478396,Noah Hanifin,D,VGK,27,82,7,49,56
38,8478474,Lawson Crouse,L,UTA,27,82,27,28,55
38,8482740,Wyatt Johnston,C,DAL,21,82,24,31,55
38,8477986,Brandon Montour,D,SEA,30,82,20,35,55
38,8476872,Scott Laughton,C,PHI,30,82,20,35,55
38,8482124,Quinton Byfield,R,LAK,22,82,19,36,55
38,8477456,J.T. Compher,L,DET,29,82,18,37,55
38,8482113,Anton Lundell,C,FLA,23,82,30,24,54
38,8481068,Yegor Sharangovich,C,CGY,26,82,29,25,54
38,8482175,JJ Peterka,R,BUF,22,82,26,28,54
38,8476292,Ondrej Palat,L,NJD,33,82,20,34,54
38,8480803,Evan Bouchard,D,EDM,25,82,14,40,54
38,8482109,Alexis Lafrenière,L,NYR,23,82,22,31,53
38,8481533,Trevor Zegras,C,ANA,23,82,20,33,53
38,8475791,Taylor Hall,L,CHI,33,82,20,33,53
38,8478438,Tommy Novak,C,NSH,27,82,19,34,53
38,8478055,Gustav Forsling,D,FLA,28,82,11,42,53
38,8476792,Torey Krug,D,STL,33,82,11,42,53
38,8482159,Tyson Foerster,R,PHI,22,82,30,22,52
38,8477479,Tyler Bertuzzi,L,CHI,29,82,26,26,52
38,8473986,Alex Killorn,L,ANA,35,82,25,27,52
38,8480078,Filip Chytil,C,NYR,25,82,23,29,52
38,8476875,Mike Matheson,D,MTL,30,82,13,39,52
38,8478469,Thomas Chabot,D,OTT,27,82,13,39,52
38,8479345,Jakob Chychrun,D,WSH,26,82,12,40,52
38,8480014,Gabriel Vilardi,C,WPG,25,82,30,21,51
38,8475151,Kyle Palmieri,C,NYI,33,82,29,22,51
38,8478366,Frank Vatrano,R,ANA,30,82,24,27,51
38,8475722,Jason Zucker,L,BUF,32,82,22,29,51
38,8478519,Anthony Cirelli,C,TBL,27,82,21,30,51
38,8477416,Oliver Bjorkstrand,R,SEA,29,82,20,31,51
38,8478856,Conor Garland,R,VAN,28,82,18,33,51
38,8477964,Ivan Barbashev,C,VGK,29,82,18,33,51
38,8478407,Vince Dunn,D,SEA,28,82,5,46,51
38,8474586,Jordan Eberle,R,SEA,34,82,26,24,50
38,8482699,Dylan Guenther,R,UTA,21,82,23,27,50
38,8479987,Morgan Geekie,C,BOS,26,82,22,28,50
38,8476880,Tom Wilson,R,WSH,30,82,22,28,50
38,8480798,Philipp Kurashev,C,CHI,25,82,15,35,50
38,8476438,Brandon Saad,L,STL,32,82,32,17,49
38,8474641,Adam Henrique,C,EDM,34,82,20,29,49
38,8477346,MacKenzie Weegar,D,CGY,30,82,13,36,49
38,8479410,Mikhail Sergachev,D,UTA,26,82,13,36,49
38,8480865,Noah Dobson,D,NYI,24,82,7,42,49
38,8480064,Josh Norris,C,OTT,25,82,25,23,48
38,8474150,Mikael Backlund,C,CGY,35,82,23,25,48
38,8477021,Alex Kerfoot,C,UTA,30,82,19,29,48
38,8481596,Shane Pinto,C,OTT,24,82,17,31,48
38,8476905,Chandler Stephenson,C,SEA,30,82,13,35,48
38,8476461,Sean Couturier,C,PHI,32,82,13,35,48
38,8478038,Devon Toews,D,COL,30,82,10,38,48
38,8477426,Nicholas Paul,L,TBL,29,82,24,23,47
38,8480028,Morgan Frost,C,PHI,25,82,19,28,47
38,8475287,Erik Haula,L,NJD,33,82,19,28,47
38,8477429,Andrew Copp,C,DET,30,82,19,28,47
38,8477932,Aaron Ekblad,D,FLA,28,82,9,38,47
38,8474563,Drew Doughty,D,LAK,35,82,7,40,47
38,8475768,Jaden Schwartz,C,SEA,32,82,23,23,46
38,8476458,Ryan Strome,C,ANA,31,82,21,25,46
38,8480009,Eeli Tolvanen,R,SEA,25,82,21,25,46
38,8478458,Jack Roslovic,C,CAR,27,82,18,28,46
38,8476479,Phillip Danault,C,LAK,31,82,16,30,46
38,8470613,Brent Burns,D,CAR,39,82,14,32,46
38,8476854,Hampus Lindholm,D,BOS,30,82,7,39,46
38,8481581,Thomas Harley,D,DAL,23,82,4,42,46
38,8482745,Mason McTavish,C,ANA,21,82,24,21,45
38,8475191,Reilly Smith,R,NYR,33,82,21,24,45
38,8478462,Nicolas Roy,C,VGK,27,82,16,29,45
38,8479999,Casey Mittelstadt,C,COL,26,82,10,35,45
38,8477503,Max Domi,C,TOR,29,82,9,36,45
38,8481542,Moritz Seider,D,DET,23,82,9,36,45
38,8475799,Nino Niederreiter,R,WPG,32,82,31,13,44
38,8481704,Juuso Parssinen,C,NSH,23,82,25,19,44
38,8480188,Fabian Zetterlund,L,SJS,25,82,22,22,44
38,8475745,Charlie Coyle,C,BOS,32,82,20,24,44
38,8478413,Jordan Greenway,L,BUF,27,82,19,25,44
38,8477497,Sean Monahan,C,CBJ,30,82,18,26,44
38,8481656,Aliaksei Protas,C,WSH,23,82,16,28,44
38,8478891,Mason Appleton,C,WPG,28,82,16,28,44
38,8477495,Seth Jones,D,CHI,30,82,14,30,44
38,8476958,Jaccob Slavin,D,CAR,30,82,6,38,44
38,8480893,Kirill Marchenko,R,CBJ,24,82,27,16,43
38,8480849,Barrett Hayton,C,UTA,24,82,24,19,43
38,8479365,Trent Frederic,C,BOS,26,82,22,21,43
38,8479941,Justin Danforth,R,CBJ,31,82,21,22,43
38,8477407,Anthony Duclair,L,NYI,29,82,20,23,43
38,8482475,Yegor Chinakhov,R,CBJ,23,82,19,24,43
38,8482092,Ridly Greig,C,OTT,22,82,19,24,43
38,8478233,Andrew Mangiapane,L,WSH,28,82,18,25,43
38,8474189,Lars Eller,C,PIT,35,82,17,26,43
38,8474053,Logan Couture,C,SJS,35,82,15,28,43
38,8481624,Ilya Mikheyev,R,CHI,30,82,15,28,43
38,8480871,Adam Boqvist,D,FLA,24,82,12,31,43
38,8474565,Alex Pietrangelo,D,VGK,34,82,8,35,43
38,8482055,Drew O'Connor,L,PIT,26,82,20,22,42
38,8478057,Dakota Joshua,C,VAN,28,82,19,23,42
38,8481535,Nils Hoglander,L,VAN,24,82,19,23,42
38,8477444,Andre Burakovsky,L,SEA,29,82,18,24,42
38,8476419,Jean-Gabriel Pageau,C,NYI,32,82,18,24,42
38,8483515,Juraj Slafkovsky,L,MTL,20,82,17,25,42
38,8479992,Michael Rasmussen,C,DET,25,82,17,25,42
38,8480220,Noah Cates,L,PHI,25,82,17,25,42
38,8476923,Damon Severson,D,CBJ,30,82,8,34,42
38,8479525,Ross Colton,C,COL,28,82,28,13,41
38,8478046,Danton Heinen,L,VAN,29,82,20,21,41
38,8477998,Warren Foegele,L,LAK,28,82,18,23,41
38,8474149,Evgenii Dadonov,R,DAL,35,82,17,24,41
38,8482667,William Eklund,L,SJS,22,82,14,27,41
38,8476869,Brady Skjei,D,NSH,30,82,13,28,41
38,8476463,Jonas Brodin,D,MIN,31,82,10,31,41
38,8475714,Calle Jarnkrok,C,TOR,33,82,18,22,40
38,8473563,Nicklas Backstrom,C,WSH,37,82,17,23,40
38,8480829,Jesperi Kotkaniemi,C,CAR,24,82,14,26,40
38,8474716,Jared Spurgeon,D,MIN,35,82,11,29,40
38,8475753,Justin Faulk,D,STL,32,82,10,30,40
38,8480434,Sean Durzi,D,UTA,26,82,9,31,40
38,8475764,Cam Fowler,D,ANA,33,82,3,37,40
38,8483808,Andrei Kuzmenko,L,CGY,28,82,25,14,39
38,8482110,Dawson Mercer,C,NJD,23,82,20,19,39
38,8484144,Connor Bedard,C,CHI,19,82,20,19,39
38,8475760,Nick Bjugstad,C,UTA,32,82,19,20,39
38,8481553,Bobby Brink,R,PHI,23,82,18,21,39
38,8475314,Anders Lee,L,NYI,34,82,17,22,39
38,8482117,Lukas Reichel,L,CHI,22,82,15,24,39
38,8476960,Andreas Athanasiou,C,CHI,30,82,14,25,39
38,8477987,Ryan Donato,C,CHI,28,82,14,25,39
38,8478472,Mathieu Joseph,R,STL,27,82,12,27,39
38,8477969,Marcus Pettersson,D,PIT,28,82,7,32,39
38,8475324,Nick Jensen,D,OTT,34,82,3,36,39
38,8482125,Alexander Holtz,R,VGK,22,82,25,13,38
38,8481604,Pavel Dorofeyev,L,VGK,24,82,24,14,38
38,8478109,Victor Olofsson,L,VGK,29,82,19,19,38
38,8475763,Kevin Hayes,R,PIT,32,82,17,21,38
38,8477511,Anthony Mantha,R,CGY,30,82,16,22,38
38,8478133,Jake Evans,C,MTL,28,82,16,22,38
38,8482660,Kent Johnson,C,CBJ,22,82,14,24,38
38,8478911,Matt Roy,D,WSH,29,82,12,26,38
38,8479976,Juuso Valimaki,D,UTA,26,82,9,29,38
38,8476474,Stefan Noesen,R,NJD,31,82,20,17,37
38,8482079,Marco Rossi,C,MIN,23,82,19,18,37
38,8481522,Peyton Krebs,C,BUF,23,82,18,19,37
38,8482146,Luke Evangelista,R,NSH,22,82,17,20,37
38,8475848,Brendan Gallagher,R,MTL,32,82,17,20,37
38,8476921,Jordan Martinook,L,CAR,32,82,16,21,37
38,8477953,Kasperi Kapanen,R,STL,28,82,15,22,37
38,8476925,Colton Sissons,C,NSH,31,82,15,22,37
38,8481013,Jonatan Berggren,R,DET,24,82,12,25,37
38,8476329,Travis Boyd,C,MIN,31,82,11,26,37
38,8482105,Jake Sanderson,D,OTT,22,82,9,28,37
38,8477498,Darnell Nurse,D,EDM,29,82,6,31,37
38,8477952,Robby Fabbri,C,ANA,28,82,20,16,36
38,8480459,Pius Suter,C,VAN,28,82,19,17,36
38,8477839,Conor Sheary,L,TBL,32,82,18,18,36
38,8479393,Noah Gregor,C,OTT,26,82,18,18,36
38,8481618,Alex Newhook,C,MTL,23,82,15,21,36
38,8478115,Pierre Engvall,L,NYI,28,82,15,21,36
38,8482133,Thomas Bordeleau,C,SJS,22,82,15,21,36
38,8473422,Nick Foligno,L,CHI,37,82,14,22,36
38,8475218,Mattias Ekholm,D,EDM,34,82,11,25,36
38,8480817,K'Andre Miller,D,NYR,24,82,8,28,36
38,8476979,Erik Gustafsson,D,DET,32,82,6,30,36
38,8480873,Rasmus Sandin,D,WSH,24,82,4,32,36
38,8480145,Neal Pionk,D,WPG,29,82,3,33,36
38,8475149,Marcus Johansson,L,MIN,34,82,17,18,35
38,8482720,Matthew Knies,L,TOR,22,82,15,20,35
38,8481546,Cam York,D,PHI,23,82,13,22,35
38,8480802,Ryan McLeod,C,BUF,25,82,13,22,35
38,8481186,Logan O'Connor,R,COL,28,82,10,25,35
38,8476885,Jacob Trouba,D,NYR,30,82,9,26,35
38,8476906,Shayne Gostisbehere,D,CAR,31,82,8,27,35
38,8477488,Brett Pesce,D,NJD,30,82,6,29,35
38,8479398,Samuel Girard,D,COL,26,82,4,31,35
38,8477450,Jason Dickinson,C,CHI,29,82,18,16,34
38,8478463,Anthony Beauvillier,L,PIT,27,82,17,17,34
38,8481582,Nicholas Robertson,L,TOR,23,82,17,17,34
38,8476981,Josh Anderson,R,MTL,30,82,16,18,34
38,8474715,Cam Atkinson,R,TBL,35,82,14,20,34
38,8477947,Sonny Milano,L,WSH,28,82,13,21,34
38,8480185,Eetu Luostarinen,C,FLA,26,82,11,23,34
38,8479996,Cody Glass,C,NSH,25,82,10,24,34
38,8477948,Travis Sanheim,D,PHI,28,82,4,30,34
38,8480049,Dylan Samberg,D,WPG,25,82,2,32,34
38,8480068,Ryan Poehling,C,PHI,25,82,15,18,33
38,8480748,Kiefer Sherwood,L,VAN,29,82,13,20,33
38,8481606,Jordan Spence,D,LAK,23,82,9,24,33
38,8479980,Nicolas Hague,D,VGK,26,82,9,24,33
38,8480003,Jesper Boqvist,C,FLA,26,82,9,24,33
38,8477425,Miles Wood,L,COL,29,82,20,12,32
38,8481580,Connor McMichael,C,WSH,23,82,16,16,32
38,8479390,Taylor Raddysh,R,WSH,26,82,15,17,32
38,8475855,Jesper Fast,R,CAR,33,82,10,22,32
38,8480336,Sean Walker,D,CAR,30,82,8,24,32
38,8474673,TJ Brodie,D,CHI,34,82,6,26,32
38,8480813,Joe Veleno,C,DET,24,82,17,14,31
38,8480806,Isac Lundestrom,C,ANA,25,82,17,14,31
38,8475231,Casey Cizikas,C,NYI,33,82,15,16,31
38,8470621,Corey Perry,R,EDM,39,82,14,17,31
38,8476480,Vladislav Namestnikov,C,WPG,32,82,11,20,31
38,8479353,Brett Howden,C,VGK,26,82,11,20,31
38,8482166,Shakir Mukhamadullin,D,SJS,22,82,10,21,31
38,8482655,J.J. Moser,D,TBL,24,82,6,25,31
38,8474574,Tyler Myers,D,VAN,34,82,4,27,31
38,8480043,Timothy Liljegren,D,TOR,25,82,3,28,31
38,8481554,Kaapo Kakko,R,NYR,23,82,17,13,30
38,8476469,Joel Armia,R,MTL,31,82,16,14,30
38,8480113,Alex Iafallo,L,WPG,31,82,13,17,30
38,8476392,Adam Lowry,C,WPG,31,82,12,18,30
38,8482705,Cole Sillinger,C,CBJ,21,82,12,18,30
38,8480980,Connor Dewar,C,TOR,25,82,12,18,30
38,8476897,Oskar Sundqvist,C,STL,30,82,12,18,30
38,8477353,Tyler Motte,C,DET,29,82,12,18,30
38,8480789,Oliver Wahlstrom,R,NYI,24,82,11,19,30
38,8476422,Mike Reilly,D,NYI,31,82,10,20,30
38,8478399,Jonas Siegenthaler,D,NJD,27,82,5,25,30
38,8477506,Ryan Pulock,D,NYI,30,82,3,27,30
38,8475233,David Savard,D,MTL,34,82,1,29,30
38,8479293,Brandon Tanev,L,SEA,33,82,19,10,29
38,8478020,Michael Amadio,C,OTT,28,82,15,14,29
38,8480835,Jack Drury,C,CAR,24,82,14,15,29
38,8475793,Ryan Johansen,C,PHI,32,82,13,16,29
38,8476278,Colin Blackwell,C,DAL,31,82,13,16,29
38,8477919,Frederick Gaudreau,C,MIN,31,82,13,16,29
38,8475200,Dmitry Orlov,D,CAR,33,82,10,19,29
38,8482858,Ryker Evans,D,SEA,23,82,9,20,29
38,8476892,Colton Parayko,D,STL,31,82,6,23,29
38,8479324,Ryan Lindgren,D,NYR,26,82,4,25,29
38,8478211,Dryden Hunt,L,CGY,29,82,15,13,28
38,8481560,Arthur Kaliyev,R,LAK,23,82,13,15,28
38,8476374,Sean Kuraly,C,CBJ,31,82,13,15,28
38,8481481,Blake Lizotte,C,PIT,27,82,10,18,28
38,8480796,Martin Fehervary,D,WSH,25,82,10,18,28
38,8478569,Noel Acciari,C,PIT,33,82,8,20,28
38,8475343,Nic Dowd,C,WSH,34,82,8,20,28
38,8476927,Teddy Blueger,C,VAN,30,82,4,24,28
38,8475462,Radko Gudas,D,ANA,34,82,3,25,28
38,8474151,Ryan McDonagh,D,TBL,35,82,2,26,28
38,8480281,Alexey Toropchenko,R,STL,25,82,18,9,27
38,8481517,Brett Leason,R,ANA,25,82,14,13,27
38,8475220,Marcus Foligno,L,MIN,33,82,12,15,27
38,8484145,Zach Benson,L,BUF,19,82,11,16,27
38,8483763,Maksymilian Szuber,D,UTA,22,82,9,18,27
38,8480144,David Kampf,C,TOR,29,82,5,22,27
38,8476902,Esa Lindell,D,DAL,30,82,4,23,27
38,8477365,Connor Clifton,D,BUF,29,82,4,23,27
38,8482245,Artem Zub,D,OTT,29,82,3,24,27
38,8482122,Brock Faber,D,MIN,22,82,2,25,27
38,8473533,Jordan Staal,C,CAR,36,82,17,9,26
38,8475193,Tomas Tatar,L,NJD,34,82,16,10,26
38,8482155,Alex Laferriere,R,LAK,23,82,15,11,26
38,8483431,Logan Cooley,C,UTA,20,82,13,13,26
38,8479661,Tanner Jeannot,L,LAK,27,82,12,14,26
38,8477903,Garnet Hathaway,R,PHI,33,82,12,14,26
38,8477989,Christian Dvorak,C,MTL,28,82,11,15,26
38,8482074,Connor Zary,C,CGY,23,82,11,15,26
38,8477508,Curtis Lazar,C,NJD,29,82,9,17,26
38,8478851,Alexandre Carrier,D,NSH,28,82,8,18,26
38,8476889,Radek Faksa,C,STL,30,82,8,18,26
38,8481014,Alexander Romanov,D,NYI,24,82,7,19,26
38,8475171,Oliver Ekman-Larsson,D,TOR,33,82,6,20,26
38,8480222,Sebastian Aho,D,PIT,28,82,5,21,26
38,8476467,Jamie Oleksiak,D,SEA,32,82,5,21,26
38,8482101,Danil Gushchin,L,SJS,22,82,5,21,26
38,8479998,Mikey Anderson,D,LAK,25,82,3,23,26
38,8482073,Braden Schneider,D,NYR,23,82,3,23,26
38,8476967,Brett Kulak,D,EDM,30,82,2,24,26
38,8475690,Chris Tanev,D,TOR,35,82,1,25,26
38,8478500,Ivan Provorov,D,CBJ,27,82,0,26,26
38,8479402,Jake Bean,D,CGY,26,82,0,26,26
38,8479591,Michael Eyssimont,C,TBL,28,82,13,12,25
38,8484166,Adam Fantilli,C,CBJ,20,82,13,12,25
38,8484153,Leo Carlsson,C,ANA,20,82,11,14,25
38,8477392,Hudson Fasching,R,NYI,29,82,11,14,25
38,8476873,Mark Jankowski,C,NSH,30,82,10,15,25
38,8476457,Adam Larsson,D,SEA,32,82,10,15,25
38,8480855,Jack McBain,C,UTA,24,82,10,15,25
38,8481032,Paul Cotter,C,NJD,25,82,10,15,25
38,8477507,Nikita Zadorov,D,BOS,29,82,8,17,25
38,8476312,Josh Manson,D,COL,33,82,8,17,25
38,8480990,Declan Chisholm,D,MIN,24,82,6,19,25
38,8477435,Ryan Graves,D,PIT,29,82,5,20,25
38,8479371,Dante Fabbro,D,NSH,26,82,3,22,25
38,8478507,John Marino,D,UTA,27,82,2,23,25
38,8478840,Will Borgen,D,SEA,28,82,2,23,25
38,8482077,Dylan Holloway,L,EDM,23,82,20,4,24
38,8480995,Pontus Holmberg,R,TOR,25,82,15,9,24
38,8478508,Yakov Trenin,C,MIN,27,82,15,9,24
38,8481641,Joel Kiviranta,L,COL,28,82,15,9,24
38,8481601,Simon Holmstrom,R,NYI,23,82,14,10,24
38,8479638,Justin Brazeau,R,BOS,26,82,14,10,24
38,8482111,Justin Barron,D,MTL,23,82,10,14,24
38,8481477,Nico Sturm,C,SJS,29,82,10,14,24
38,8479368,Max Jones,L,BOS,26,82,10,14,24
38,8483499,Liam Ohgren,L,MIN,20,82,10,14,24
38,8482702,Logan Stankoven,C,DAL,21,82,10,14,24
38,8476917,Adam Pelech,D,NYI,30,82,9,15,24
38,8483457,Lane Hutson,D,MTL,20,82,9,15,24
38,8482624,Daniil Miromanov,D,CGY,27,82,8,16,24
38,8480073,Erik Brannstrom,D,COL,25,82,4,20,24
38,8480172,Jan Rutta,D,SJS,34,82,4,20,24
38,8482142,Jamie Drysdale,D,PHI,22,82,3,21,24
38,8475790,Erik Gudbranson,D,CBJ,32,82,3,21,24
38,8480878,Nils Lundkvist,D,DAL,24,82,1,23,24
38,8481093,Rafael Harvey-Pinard,L,MTL,25,82,12,11,23
38,8479359,Beck Malenstyn,L,BUF,26,82,12,11,23
38,8476878,Zemgus Girgensons,L,TBL,30,82,10,13,23
38,8481708,Zac Jones,D,NYR,24,82,9,14,23
38,8477220,Nate Schmidt,D,FLA,33,82,8,15,23
38,8478882,Vladislav Gavrikov,D,LAK,29,82,6,17,23
38,8474090,Brendan Smith,D,DAL,35,82,6,17,23
38,8478443,Brandon Carlo,D,BOS,28,82,5,18,23
38,8484203,Bradly Nadeau,L,CAR,19,82,4,19,23
38,8476931,Jake McCabe,D,TOR,31,82,4,19,23
38,8481178,Egor Zamula,D,PHI,24,82,3,20,23
38,8480035,Henri Jokiharju,D,BUF,25,82,2,21,23
38,8476918,Jimmy Vesey,L,NYR,31,82,15,7,22
38,8480074,Alexandre Texier,C,STL,25,82,11,11,22
38,8482062,Cole Smith,L,NSH,29,82,7,15,22
38,8482807,Ethan Del Mastro,D,CHI,21,82,6,16,22
38,8483565,Nick Blankenburg,D,NSH,26,82,5,17,22
38,8479983,Mario Ferraro,D,SJS,26,82,4,18,22
38,8476891,Matt Grzelcyk,D,PIT,30,82,4,18,22
38,8476429,Scott Mayfield,D,NYI,32,82,3,19,22
38,8476331,Dylan DeMelo,D,WPG,31,82,2,20,22
38,8479414,Nathan Bastian,R,NJD,27,82,9,12,21
38,8478432,Christian Fischer,R,DET,27,82,9,12,21
38,8477015,Connor Brown,R,EDM,30,82,7,14,21
38,8480448,Parker Kelly,L,COL,25,82,7,14,21
38,8481567,Henry Thrun,D,SJS,23,82,7,14,21
38,8483482,Tristan Luneau,D,ANA,20,82,4,17,21
38,8475181,Nick Leddy,D,STL,33,82,2,19,21
38,8483495,Simon Nemec,D,NJD,20,82,2,19,21
38,8478136,Jake Middleton,D,MIN,28,82,1,20,21
38,8483490,Pavel Mintyukov,D,ANA,21,82,1,20,21
38,8482749,Joshua Roy,R,MTL,21,82,10,10,20
38,8473507,Jeff Petry,D,DET,37,82,9,11,20
38,8475842,Sam Carrick,C,NYR,32,82,9,11,20
38,8480025,MacKenzie Entwistle,R,FLA,25,82,8,12,20
38,8483524,Shane Wright,C,SEA,20,82,8,12,20
38,8477034,Jaycob Megna,D,FLA,32,82,6,14,20
38,8477845,Trevor van Riemsdyk,D,WSH,33,82,5,15,20
38,8474013,Ian Cole,D,UTA,35,82,3,17,20
38,8476879,Cody Ceci,D,EDM,31,82,1,19,20
38,8482089,Jake Neighbours,L,STL,22,82,14,5,19
38,8479316,Luke Kunin,C,SJS,27,82,13,6,19
38,8473453,Trevor Lewis,C,LAK,37,82,11,8,19
38,8478013,Jake Walman,D,SJS,28,82,9,10,19
38,8480807,Mattias Samuelsson,D,BUF,24,82,7,12,19
38,8480860,Kevin Bahl,D,CGY,24,82,6,13,19
38,8482803,Olen Zellweger,D,ANA,21,82,4,15,19
38,8475279,Ben Chiarot,D,DET,33,82,3,16,19
38,8480879,Jacob Bernard-Docker,D,OTT,24,82,1,18,19
38,8481524,Bowen Byram,D,BUF,23,82,10,8,18
38,8481028,Martin Pospisil,C,CGY,25,82,10,8,18
38,8482787,Nikita Chibrikov,R,WPG,31,82,9,9,18
38,8482809,Jackson Blake,R,CAR,21,82,8,10,18
38,8483445,Cutter Gauthier,L,ANA,20,82,5,13,18
38,8475718,Justin Holl,D,DET,32,82,5,13,18
38,8479576,Vincent Desharnais,D,VAN,28,82,5,13,18
38,8475455,Brenden Dillon,D,NJD,34,82,2,16,18
38,8482259,Bobby McMann,C,TOR,28,82,9,8,17
38,8477369,Carson Soucy,D,VAN,30,82,8,9,17
38,8482679,Matt Coronato,R,CGY,22,82,8,9,17
38,8481699,Aku Raty,R,UTA,23,82,7,10,17
38,8482762,Simon Edvinsson,D,DET,21,82,6,11,17
38,8480246,Nick Perbix,D,TBL,26,82,2,15,17
38,8475177,Calvin de Haan,D,COL,33,82,2,15,17
38,8481568,Alex Vlasic,D,CHI,23,82,1,16,17
38,8480021,Jack Studnicka,C,LAK,25,82,12,4,16
38,8483397,Marc McLaughlin,C,BOS,25,82,10,6,16
38,8476442,Matt Nieto,L,PIT,32,82,10,6,16
38,8481122,Simon Benoit,D,TOR,26,82,6,10,16
38,8482712,Oskar Olausson,R,COL,22,82,6,10,16
38,8475188,Brayden McNabb,D,VGK,33,82,4,12,16
38,8483493,Frank Nazar,C,CHI,20,82,4,12,16
38,8478450,Parker Wotherspoon,D,BOS,27,82,4,12,16
38,8484911,Collin Graf,R,SJS,22,82,4,12,16
38,8479369,Andrew Peeke,D,BOS,26,82,3,13,16
38,8476372,Nick Seeler,D,PHI,31,82,2,14,16
38,8479291,Kevin Rooney,C,CGY,31,82,8,7,15
38,8484149,Gavin Brindley,C,CBJ,20,82,7,8,15
38,8479351,Sam Steel,C,DAL,26,82,5,10,15
38,8482141,Lukas Cormier,D,VGK,22,82,5,10,15
38,8483505,Matthew Poitras,C,BOS,20,82,4,11,15
38,8478434,Keegan Kolesar,R,VGK,27,82,4,11,15
38,8478859,Niko Mikkola,D,FLA,28,82,4,11,15
38,8483468,Jiri Kulich,C,BUF,20,82,3,12,15
38,8470600,Ryan Suter,D,STL,39,82,2,13,15
38,8482070,Mitchell Chaffee,R,TBL,26,82,12,2,14
38,8476822,Luke Glendening,C,TBL,35,82,9,5,14
38,8477505,Alexander Wennberg,C,SJS,30,82,8,6,14
38,8479442,Troy Stecher,D,EDM,30,82,7,7,14
38,8483460,David Jiricek,D,CBJ,21,82,6,8,14
38,8477931,Tomas Nosek,L,FLA,32,82,5,9,14
38,8476624,Barclay Goodrow,C,SJS,31,82,5,9,14
38,8482659,Josh Doan,R,UTA,22,82,5,9,14
38,8476473,Connor Murphy,D,CHI,31,82,4,10,14
38,8483012,Logan Morrison,C,SEA,22,82,4,10,14
38,8481605,Jackson LaCombe,D,ANA,23,82,4,10,14
38,8482713,Mackie Samoskevich,R,FLA,22,82,4,10,14
38,8474567,Zach Bogosian,D,MIN,34,82,2,12,14
38,8478178,Darren Raddysh,D,TBL,28,82,0,14,14
38,8477406,Mattias Janmark,C,EDM,32,82,6,7,13
38,8476858,Phillip Di Giuseppe,L,VAN,31,82,6,7,13
38,8482145,Mavrik Bourque,C,DAL,22,82,6,7,13
38,8483567,Georgii Merkulov,C,BOS,24,82,6,7,13
38,8482666,Scott Morrow,D,CAR,22,82,5,8,13
38,8477335,Kyle Burroughs,D,LAK,29,82,4,9,13
38,8478416,Erik Cernak,D,TBL,27,82,3,10,13
38,8476525,Colin Miller,D,WPG,32,82,2,11,13
38,8482087,Kaiden Guhle,D,MTL,22,82,1,12,13
38,8482859,Zack Ostapchuk,C,OTT,21,82,5,7,12
38,8482118,Sam Colangelo,R,ANA,23,82,2,9,11
38,8478874,Adam Gaudette,C,OTT,28,82,5,5,10
38,8482733,Logan Mailloux,D,MTL,31,82,4,6,10
38,8480870,Bo Groulx,C,NYR,24,82,4,6,10
38,8483466,Kevin Korchinski,D,CHI,20,82,3,7,10
38,8477499,Rasmus Ristolainen,D,PHI,30,82,2,8,10
38,8477938,Haydn Fleury,D,WPG,28,82,2,8,10
38,8478468,Jeremy Lauzon,D,NSH,27,82,1,9,10
38,8480834,Ty Emberson,D,SJS,24,82,1,9,10
38,8483489,Fraser Minten,C,TOR,31,82,5,4,9
38,8476441,Joel Edmundson,D,LAK,31,82,2,7,9
38,8474612,Travis Hamonic,D,OTT,34,82,2,7,9
38,8482516,Matthew Kessel,D,STL,24,82,2,7,9
38,8471677,Jack Johnson,D,CBJ,37,82,1,8,9
38,8480950,Ilya Lyubushkin,D,DAL,30,82,3,5,8
38,8482470,Ilya Solovyov,D,CGY,24,82,2,6,8
38,8482153,Brendan Brisson,C,VGK,23,82,1,7,8
38,8483471,Brad Lambert,C,WPG,31,82,1,7,8
38,8474062,Riley Nash,C,NYR,35,82,3,3,6
38,8475762,Derek Forbort,D,VAN,32,82,0,6,6
38,8470794,Joe Pavelski,C,,40,0,0,0,0
38,8481703,Valtteri Puustinen,R,PIT,25,0,0,0,0
38,8477950,Tony DeAngelo,D,,29,0,0,0,0
38,8481577,Philip Tomasino,C,NSH,23,0,0,0,0
38,8475197,Tyson Barrie,D,,33,0,0,0,0
38,8471218,Blake Wheeler,R,,38,0,0,0,0
38,8474157,Max Pacioretty,L,,36,0,0,0,0
38,8478466,Daniel Sprong,R,VAN,27,0,0,0,0
38,8475744,Evgeny Kuznetsov,C,,32,0,0,0,0
38,8481019,David Gustafsson,C,WPG,24,0,0,0,0
38,8475906,John Klingberg,D,,32,0,0,0,0
38,8479348,Kale Clague,D,BUF,26,0,0,0,0
38,8476952,Dominic Toninato,C,WPG,30,0,0,0,0
38,8473473,Milan Lucic,L,,36,0,0,0,0
38,8474037,James van Riemsdyk,L,,35,0,0,0,0
38,8474602,Justin Schultz,D,,34,0,0,0,0
38,8482222,Alexander Barabanov,L,,30,0,0,0,0
38,8479372,Josh Mahura,D,SEA,26,0,0,0,0
38,8479982,Conor Timmins,D,TOR,26,0,0,0,0
38,8474031,Kevin Shattenkirk,D,,35,0,0,0,0
38,8480008,Adam Ruzicka,C,,25,0,0,0,0
38,8481059,Scott Perunovich,D,STL,26,0,0,0,0
38,8480884,Calen Addison,D,,24,0,0,0,0
38,8476994,Vinnie Hinostroza,C,NSH,30,0,0,0,0
38,8478452,Caleb Jones,D,LAK,27,0,0,0,0
38,8480157,Calle Rosen,D,COL,30,0,0,0,0
38,8481609,Vladislav Kolyachonok,D,UTA,23,0,0,0,0
38,8479415,Michael McLeod,C,,26,0,0,0,0
38,8476919,Chris Tierney,C,,30,0,0,0,0
38,8479639,Dylan Coghlan,D,WPG,26,0,0,0,0
38,8478146,Matthew Highmore,C,OTT,28,0,0,0,0
38,8478970,Jalen Chatfield,D,CAR,28,0,0,0,0
38,8480205,Emil Bemstrom,C,PIT,25,0,0,0,0
38,8474884,Mike Hoffman,C,,35,0,0,0,0
38,8471274,Alex Goligoski,D,,39,0,0,0,0
38,8478104,Sammy Blais,L,,28,0,0,0,0
38,8474870,Tyler Johnson,C,,34,0,0,0,0
38,8476913,Devin Shore,C,MIN,30,0,0,0,0
38,8481598,Philip Broberg,D,EDM,23,0,0,0,0
38,8480058,Pierre-Olivier Joseph,D,STL,25,0,0,0,0
38,8480891,Michael Kesselring,D,UTA,24,0,0,0,0
38,8477979,Nicolas Aube-Kubel,R,BUF,28,0,0,0,0
38,8476871,Tanner Pearson,L,,32,0,0,0,0
38,8476393,Nick Cousins,C,,31,0,0,0,0
38,8479977,Kailer Yamamoto,R,,26,0,0,0,0
38,8479543,Michael Pezzetta,L,MTL,26,0,0,0,0
38,8477018,Ben Hutton,D,VGK,31,0,0,0,0
38,8480762,Eric Robinson,L,CAR,29,0,0,0,0
38,8474034,Pat Maroon,L,CHI,36,0,0,0,0
38,8481058,Jesse Ylönen,R,,25,0,0,0,0
38,8475179,Dmitry Kulikov,D,FLA,34,0,0,0,0
38,8481527,Kaedan Korczak,D,VGK,23,0,0,0,0
38,8473449,Kyle Okposo,R,,36,0,0,0,0
38,8482192,Isaak Phillips,D,CHI,23,0,0,0,0
38,8480727,Zach Whitecloud,D,VGK,28,0,0,0,0
38,8479346,Dillon Dube,C,,26,0,0,0,0
38,8480821,Filip Zadina,R,,25,0,0,0,0
38,8480001,Urho Vaakanainen,D,ANA,25,0,0,0,0
38,8470966,Mark Giordano,D,,41,0,0,0,0
38,8480853,Liam Foudy,C,,24,0,0,0,0
38,8475225,Craig Smith,C,CHI,35,0,0,0,0
38,8479972,Mason Shaw,C,WPG,26,0,0,0,0
38,8478451,Ethan Bear,D,WSH,27,0,0,0,0
38,8474040,Sam Gagner,C,,35,0,0,0,0
38,8480196,Jacob Bryson,D,BUF,27,0,0,0,0
38,8479984,Cal Foote,D,,26,0,0,0,0
38,8480011,Klim Kostin,C,SJS,25,0,0,0,0
38,8482176,Wyatt Kaiser,D,CHI,22,0,0,0,0
38,8476988,Matt Benning,D,SJS,30,0,0,0,0
38,8479370,Tyson Jost,C,CAR,26,0,0,0,0
38,8477464,Nic Petan,C,,29,0,0,0,0
38,8477380,Jonny Brodzinski,C,NYR,31,0,0,0,0
38,8480070,Ian Mitchell,D,BOS,25,0,0,0,0
38,8479315,Joey Anderson,R,CHI,26,0,0,0,0
38,8478099,Kevin Labanc,R,,29,0,0,0,0
38,8476874,Olli Maatta,D,DET,30,0,0,0,0
38,8475208,Brian Dumoulin,D,ANA,33,0,0,0,0
38,8478430,Oliver Kylington,D,,27,0,0,0,0
38,8479536,Axel Jonsson-Fjallby,L,WPG,26,0,0,0,0
38,8479671,Mathieu Olivier,R,CBJ,27,0,0,0,0
38,8471709,Marc-Edouard Vlasic,D,SJS,37,0,0,0,0
38,8479328,Julien Gauthier,R,NYI,27,0,0,0,0
38,8478421,A.J. Greer,L,FLA,28,0,0,0,0
38,8477573,Nathan Walker,L,STL,30,0,0,0,0
38,8481537,Nikita Okhotiuk,D,CGY,24,0,0,0,0
38,8474166,Alec Martinez,D,CHI,37,0,0,0,0
38,8470610,Zach Parise,L,,40,0,0,0,0
38,8477478,William Carrier,L,CAR,30,0,0,0,0
38,8479344,Jesse Puljujarvi,R,PIT,26,0,0,0,0
38,8480887,Jordan Harris,D,MTL,24,0,0,0,0
38,8478502,Dennis Gilbert,D,BUF,28,0,0,0,0
38,8482730,Brandt Clarke,D,LAK,21,0,0,0,0
38,8480355,Mark Kastelic,C,BOS,25,0,0,0,0
38,8475750,Jon Merrill,D,MIN,32,0,0,0,0
38,8475164,Jakob Silfverberg,R,,34,0,0,0,0
38,8477944,Jakub Vrana,L,,28,0,0,0,0
38,8479439,Jacob MacDonald,D,COL,31,0,0,0,0
38,8474568,Luke Schenn,D,NSH,35,0,0,0,0
38,8478454,Noah Juulsen,D,VAN,27,0,0,0,0
38,8475752,Tyler Pitlick,C,,33,0,0,0,0
38,8482148,Hendrix Lapierre,C,WSH,22,0,0,0,0
38,8481167,Brayden Pachal,D,CGY,25,0,0,0,0
38,8478043,Sam Lafferty,C,BUF,29,0,0,0,0
38,8479321,Lucas Johansen,D,,27,0,0,0,0
38,8471699,Andrew Cogliano,C,,37,0,0,0,0
38,8481521,Ronnie Attard,D,PHI,25,0,0,0,0
38,8481161,Jake Christiansen,D,CBJ,25,0,0,0,0
38,8479458,Nikita Zaitsev,D,,33,0,0,0,0
38,8479619,Michael Carcone,L,UTA,28,0,0,0,0
38,8479026,Philippe Myers,D,TOR,27,0,0,0,0
38,8477330,Dominik Kubalik,L,,29,0,0,0,0
38,8481617,Vasily Podkolzin,R,VAN,23,0,0,0,0
38,8481701,Santeri Hatakka,D,NJD,23,0,0,0,0
38,8479514,Rem Pitlick,C,,27,0,0,0,0
38,8477446,Michael McCarron,R,NSH,29,0,0,0,0
38,8470604,Jeff Carter,C,,39,0,0,0,0
38,8482241,Radim Zohorna,L,,28,0,0,0,0
38,8480289,Morgan Barron,C,WPG,26,0,0,0,0
38,8479379,Givani Smith,R,SJS,26,0,0,0,0
38,8480216,Jacob Peterson,C,,25,0,0,0,0
38,8477851,Jordan Oesterle,D,BOS,32,0,0,0,0
38,8484258,Sam Malinski,D,COL,26,0,0,0,0
38,8478904,Steven Lorentz,C,,28,0,0,0,0
38,8482095,Tyler Kleven,D,OTT,22,0,0,0,0
38,8480848,Ty Dellandrea,C,SJS,24,0,0,0,0
38,8476884,Derrick Pouliot,D,,30,0,0,0,0
38,8479336,Carl Grundstrom,R,SJS,27,0,0,0,0
38,8482964,Arber Xhekaj,D,MTL,23,0,0,0,0
38,8471686,Marc Staal,D,,37,0,0,0,0
38,8477887,Patrick Brown,C,BOS,32,0,0,0,0
38,8478495,Denis Gurianov,R,,27,0,0,0,0
38,8473504,Cal Clutterbuck,R,,37,0,0,0,0
38,8481550,Adam Beckman,L,NJD,23,0,0,0,0
38,8480845,Rasmus Kupari,C,WPG,24,0,0,0,0
38,8474009,Nick Bonino,C,,36,0,0,0,0
38,8478585,Derek Ryan,C,EDM,38,0,0,0,0
38,8477962,Brendan Lemieux,L,CAR,28,0,0,0,0
38,8482861,Vincent Iorio,D,WSH,22,0,0,0,0
38,8479378,Logan Stanley,D,WPG,26,0,0,0,0
38,8473446,Erik Johnson,D,PHI,36,0,0,0,0
38,8481743,Marc Del Gaizo,D,NSH,25,0,0,0,0
38,8477384,Josh Brown,D,EDM,30,0,0,0,0
38,8482165,Yan Kuznetsov,D,CGY,22,0,0,0,0
38,8478424,Jansen Harkins,C,ANA,27,0,0,0,0
38,8482144,Jack Thompson,D,SJS,22,0,0,0,0
38,8478512,Austin Czarnik,C,,32,0,0,0,0
38,8477527,Ross Johnston,L,ANA,30,0,0,0,0
38,8479383,Boris Katchouk,L,,26,0,0,0,0
38,8482094,Daemon Hunt,D,MIN,22,0,0,0,0
38,8481719,Maxwell Crozier,D,TBL,24,0,0,0,0
38,8480192,Johnathan Kovacevic,D,NJD,27,0,0,0,0
38,8479376,Victor Mete,D,,26,0,0,0,0
38,8482511,Mason Lohrei,D,BOS,23,0,0,0,0
38,8475825,Jani Hakanpää,D,,32,0,0,0,0
38,8478021,William Lagesson,D,DET,28,0,0,0,0
38,8475795,Dylan McIlrath,D,WSH,32,0,0,0,0
38,8477846,Ryan Carpenter,C,,33,0,0,0,0
38,8481056,Spencer Stastney,D,NSH,24,0,0,0,0
38,8481564,Ryan Johnson,D,BUF,23,0,0,0,0
38,8478017,Mark Friedman,D,VAN,29,0,0,0,0
38,8479320,Max Lajoie,D,SEA,27,0,0,0,0
38,8480075,Cameron Crotty,D,MIN,25,0,0,0,0
38,8484287,Cole McWard,D,VAN,23,0,0,0,0
38,8484254,Akito Hirose,D,VAN,25,0,0,0,0
38,8483407,Brandon Scanlin,D,NYR,25,0,0,0,0
38,8480274,Philip Kemp,D,EDM,25,0,0,0,0
38,8479522,Hardy Haman Aktell,D,WSH,26,0,0,0,0
38,8480007,Jonas Rondbjerg,R,VGK,25,0,0,0,0
38,8477454,Adam Erne,L,,29,0,0,0,0
38,8481679,Maxence Guenette,D,OTT,23,0,0,0,0
38,8480441,Trey Fix-Wolansky,R,CBJ,25,0,0,0,0
38,8483546,Marshall Rifai,D,TOR,26,0,0,0,0
38,8480084,Nick DeSimone,D,NJD,30,0,0,0,0
38,8481030,Jack St. Ivany,D,PIT,25,0,0,0,0
38,8481592,Jakob Pelletier,L,CGY,23,0,0,0,0
38,8478011,Louie Belpedio,D,PHI,28,0,0,0,0
38,8477930,Pierre-Edouard Bellemare,L,,39,0,0,0,0
38,8484321,Nikolas Matinpalo,D,OTT,26,0,0,0,0
38,8482067,Connor Mackey,D,NYR,28,0,0,0,0
38,8481806,Louis Crevier,D,CHI,23,0,0,0,0
38,8484326,Patrik Koch,D,UTA,28,0,0,0,0
38,8477971,Andreas Englund,D,LAK,28,0,0,0,0
38,8481751,Lukas Rousek,R,BUF,25,0,0,0,0
38,8481006,Tyler Tucker,D,STL,24,0,0,0,0
38,8476867,Brendan Gaunce,C,MIN,30,0,0,0,0
38,8479520,Brandon Duhaime,R,WSH,27,0,0,0,0
38,8477073,Kurtis MacDermid,L,NJD,30,0,0,0,0
38,8480874,Adam Ginning,D,PHI,24,0,0,0,0
38,8477473,Justin Bailey,R,SJS,29,0,0,0,0
38,8479066,Ryan Lomberg,L,CGY,30,0,0,0,0
38,8477070,Liam O'Brien,C,UTA,30,0,0,0,0
38,8474618,Marco Scandella,D,,34,0,0,0,0
38,8475797,Jarred Tinordi,D,,32,0,0,0,0
38,8481441,Joe Snively,C,DET,28,0,0,0,0
38,8477244,Chad Ruhwedel,D,NYR,34,0,0,0,0
38,8479772,Zack MacEwen,R,OTT,28,0,0,0,0
38,8481147,Reese Johnson,C,MIN,26,0,0,0,0
38,8481043,Cole Koepke,L,BOS,26,0,0,0,0
38,8483619,Filip Roos,D,OTT,25,0,0,0,0
38,8481541,Samuel Bolduc,D,NYI,24,0,0,0,0
38,8477810,Joel Hanley,D,CGY,33,0,0,0,0
38,8476907,Mackenzie MacEachern,L,,30,0,0,0,0
38,8482652,Walker Duehr,R,CGY,27,0,0,0,0
38,8477126,Jayson Megna,C,,34,0,0,0,0
38,8483398,Declan Carlile,D,TBL,31,0,0,0,0
38,8482929,Emil Lilleberg,D,TBL,23,0,0,0,0
38,8480880,Jakub Lauko,C,MIN,24,0,0,0,0
38,8480245,Olle Lycksell,R,PHI,25,0,0,0,0
38,8480252,Cole Guttman,C,CHI,25,0,0,0,0
38,8477467,Gustav Olofsson,D,SEA,30,0,0,0,0
38,8479968,Vinni Lettieri,C,BOS,29,0,0,0,0
38,8478400,Colin White,C,,27,0,0,0,0
38,8475755,Alexander Petrovic,D,DAL,32,0,0,0,0
38,8481812,Nikolai Knyzhov,D,,27,0,0,0,0
38,8481593,Jayden Struble,D,MTL,23,0,0,0,0
38,8481532,Alex Turcotte,C,LAK,23,0,0,0,0
38,8482126,Emil Andrae,D,PHI,31,0,0,0,0
38,8479944,Zach Aston-Reese,C,VGK,30,0,0,0,0
38,8471817,Ryan Reaves,R,TOR,37,0,0,0,0
38,8481206,John Ludvig,D,PIT,24,0,0,0,0
38,8481599,Victor Soderstrom,D,UTA,23,0,0,0,0
38,8480292,Carson Meyer,R,ANA,27,0,0,0,0
38,8482496,Nils Aman,C,VAN,24,0,0,0,0
38,8479718,Alex Barré-Boulet,C,MTL,27,0,0,0,0
38,8479994,Jaret Anderson-Dolan,C,WPG,25,0,0,0,0
38,8480184,Gustav Lindstrom,D,,26,0,0,0,0
38,8480890,Jan Jenik,R,OTT,24,0,0,0,0
38,8478067,Oskar Lindblom,L,,28,0,0,0,0
38,8476934,Brock McGinn,L,ANA,30,0,0,0,0
38,8479985,Cale Fleury,D,SEA,26,0,0,0,0
38,8484304,Uvis Balinskis,D,FLA,28,0,0,0,0
38,8479981,Jonah Gadjovich,L,FLA,26,0,0,0,0
38,8481716,Dmitri Voronkov,L,CBJ,24,0,0,0,0
38,8474709,Matt Martin,L,,35,0,0,0,0
38,8482634,Alex Steeves,C,TOR,25,0,0,0,0
38,8480823,Alexander Alexeyev,D,WSH,25,0,0,0,0
38,8477541,Dakota Mermis,D,TOR,30,0,0,0,0
38,8483491,Ivan Miroshnichenko,L,WSH,20,0,0,0,0
38,8478477,Mitchell Stephens,C,SEA,27,0,0,0,0
38,8481543,Nikita Alexandrov,C,STL,24,0,0,0,0
38,8479423,Alex Nylander,L,,26,0,0,0,0
38,8482451,Mikael Pyyhtia,L,CBJ,23,0,0,0,0
38,8478831,Kevin Stenlund,C,UTA,28,0,0,0,0
38,8480306,Grant Hutton,D,NYI,29,0,0,0,0
38,8478028,Fredrik Olofsson,L,,28,0,0,0,0
38,8477462,Robert Hagg,D,VGK,29,0,0,0,0
38,8477320,Anton Blidh,L,NYR,29,0,0,0,0
38,8482157,Will Cuylle,L,NYR,22,0,0,0,0
38,8482737,Zack Bolduc,C,STL,21,0,0,0,0
38,8481239,Samuel Fagemo,L,,24,0,0,0,0
38,8481600,Tobias Bjornfot,D,FLA,23,0,0,0,0
38,8478409,Anthony Richard,C,PHI,28,0,0,0,0
38,8474145,Robert Bortuzzo,D,,35,0,0,0,0
38,8475958,Michael Sgarbossa,C,WSH,32,0,0,0,0
38,8479986,Kole Lind,R,DAL,26,0,0,0,0
38,8479249,Andrew Poturalski,C,SJS,30,0,0,0,0
38,8479362,Riley Tufte,L,BOS,26,0,0,0,0
38,8479991,Jake Leschyshyn,C,NYR,25,0,0,0,0
38,8479587,Rhett Gardner,C,PHI,28,0,0,0,0
38,8482744,James Malatesta,L,CBJ,21,0,0,0,0
38,8478854,Ryan Shea,D,PIT,27,0,0,0,0
38,8481591,Sam Poulin,R,,23,0,0,0,0
38,8483512,Matt Savoie,C,EDM,20,0,0,0,0
38,8482102,Vasily Ponomarev,C,PIT,22,0,0,0,0
38,8482162,Roby Jarventie,L,EDM,22,0,0,0,0
38,8481016,Ruslan Iskhakov,C,,24,0,0,0,0
38,8482172,Landon Slaggert,L,CHI,22,0,0,0,0
38,8482747,Brennan Othmann,L,NYR,21,0,0,0,0
38,8480031,Maxime Comtois,L,,25,0,0,0,0
38,8480226,Marián Studenic,R,,26,0,0,0,0
38,8478408,Travis Dermott,D,,28,0,0,0,0
38,8481518,Nolan Foote,L,NJD,24,0,0,0,0
38,8479419,Brett Murray,L,BUF,26,0,0,0,0
38,8482088,Justin Sourdif,R,FLA,22,0,0,0,0
38,8482201,Gage Goncalves,C,TBL,23,0,0,0,0
38,8481578,Graeme Clarke,R,MIN,23,0,0,0,0
38,8482177,Marat Khusnutdinov,C,MIN,22,0,0,0,0
38,8481754,Nikita Nesterenko,C,ANA,23,0,0,0,0
38,8483531,Brian Halonen,L,NJD,25,0,0,0,0
38,8483920,Pierrick Dube,R,WSH,23,0,0,0,0
38,8480851,Akil Thomas,C,LAK,24,0,0,0,0
38,8475235,Nicolas Deslauriers,L,PHI,33,0,0,0,0
38,8482476,Emil Heineman,L,MTL,23,0,0,0,0
38,8477149,Scott Sabourin,R,SJS,32,0,0,0,0
38,8483549,Lucas Condotta,L,MTL,27,0,0,0,0
38,8482765,Isak Rosen,R,BUF,21,0,0,0,0
38,8481237,Kyle MacLean,C,NYI,25,0,0,0,0
38,8481024,Linus Karlsson,C,VAN,25,0,0,0,0
38,8481690,Tyler Angle,C,,24,0,0,0,0
38,8483570,Ben Meyers,C,SEA,26,0,0,0,0
38,8481655,Cole Schwindt,R,CGY,23,0,0,0,0
38,8481462,Mason Morelli,L,VGK,28,0,0,0,0
38,8483401,Marc Johnstone,R,PIT,28,0,0,0,0
38,8478956,Samuel Laberge,L,NJD,27,0,0,0,0
38,8479533,Joona Koppanen,L,,26,0,0,0,0
38,8482197,Adam Raska,R,MIN,23,0,0,0,0
38,8482250,Callahan Burke,C,VGK,27,0,0,0,0
38,8482784,Zach Dean,C,STL,21,0,0,0,0
38,8484255,Jason Polin,R,COL,25,0,0,0,0
38,8481077,John Leonard,L,,26,0,0,0,0
38,8481534,Raphael Lavoie,C,EDM,24,0,0,0,0
38,8483609,Adam Klapka,R,CGY,24,0,0,0,0
38,8482751,Ryan Winterton,C,SEA,21,0,0,0,0
38,8480267,Sammy Walker,C,MIN,25,0,0,0,0
38,8475766,Austin Watson,L,,32,0,0,0,0
38,8482460,Matt Rempe,C,NYR,22,0,0,0,0
38,8481065,Angus Crookshank,L,OTT,25,0,0,0,0
38,8481070,Hugh McGing,L,,26,0,0,0,0
38,8476323,Max McCormick,L,SEA,32,0,0,0,0
38,8483395,Arshdeep Bains,L,VAN,23,0,0,0,0
38,8484259,Ondrej Pavel,C,COL,31,0,0,0,0
38,8483432,Luca Del Bel Belluz,C,CBJ,31,0,0,0,0
38,8483045,Cameron Butler,R,CBJ,31,0,0,0,0
38,8482061,Brandon Biro,L,SEA,26,0,0,0,0
38,8477401,John Hayden,C,SEA,29,0,0,0,0
38,8475278,Byron Froese,C,,33,0,0,0,0
38,8478446,Glenn Gawdin,C,LAK,27,0,0,0,0
38,8477993,Justin Kirkland,C,CGY,28,0,0,0,0
38,8482147,Jean-Luc Foudy,C,COL,22,0,0,0,0
38,8480032,Shane Bowers,C,NJD,25,0,0,0,0
38,8479330,Brandon Gignac,C,MTL,27,0,0,0,0
38,8480776,Sheldon Rempal,R,,29,0,0,0,0
38,8475413,Justin Dowling,C,NJD,34,0,0,0,0
38,8481726,Adam Edstrom,C,NYR,24,0,0,0,0
38,8480844,Grigori Denisenko,L,VGK,24,0,0,0,0
38,8478147,Bokondji Imama,L,PIT,28,0,0,0,0
38,8478881,Brett Seney,L,CHI,28,0,0,0,0
38,8483630,Pavol Regenda,L,ANA,25,0,0,0,0
38,8480836,Jonathan Gruden,C,,24,0,0,0,0
38,8484314,Jiri Smejkal,L,,28,0,0,0,0
38,8475780,Chris Wagner,R,COL,33,0,0,0,0
38,8479546,Oskar Steen,C,,26,0,0,0,0
38,8483597,Milos Kelemen,L,UTA,25,0,0,0,0
38,8481789,Tye Kartye,L,SEA,23,0,0,0,0
38,8484325,Waltteri Merela,C,TBL,26,0,0,0,0
38,8479421,Jacob Moverare,D,LAK,26,0,0,0,0
38,8481585,Egor Afanasyev,L,SJS,23,0,0,0,0
38,8479547,Matthew Phillips,R,,26,0,0,0,0
38,8479367,William Lockwood,R,FLA,26,0,0,0,0
38,8476915,Jujhar Khaira,L,,30,0,0,0,0
38,8481422,Jacob Lucchini,C,NSH,29,0,0,0,0
38,8480468,James Hamblin,L,EDM,25,0,0,0,0
38,8478051,Max Willman,C,NJD,29,0,0,0,0
38,8481556,John Beecher,C,BOS,23,0,0,0,0
38,8478078,Rourke Chartier,C,,28,0,0,0,0
39,8477956,David Pastrnak,R,BOS,28,82,63,79,142
39,8476453,Nikita Kucherov,R,TBL,31,82,50,89,139
39,8478402,Connor McDavid,C,EDM,27,82,35,97,132
39,8481559,Jack Hughes,C,NJD,23,82,45,77,122
39,8478550,Artemi Panarin,L,NYR,33,82,44,74,118
39,8477939,William Nylander,R,TOR,28,82,44,72,116
39,8479318,Auston Matthews,C,TOR,27,82,63,49,112
39,8478864,Kirill Kaprizov,L,MIN,27,82,50,60,110
39,8480069,Cale Makar,D,COL,26,82,23,87,110
39,8471675,Sidney Crosby,C,PIT,37,82,46,63,109
39,8480027,Jason Robertson,L,DAL,25,82,37,72,109
39,8477492,Nathan MacKinnon,C,COL,29,82,45,62,107
39,8479314,Matthew Tkachuk,L,FLA,27,82,31,74,105
39,8476468,J.T. Miller,C,VAN,31,82,42,62,104
39,8480002,Nico Hischier,C,NJD,25,82,39,65,104
39,8477493,Aleksander Barkov,C,FLA,29,82,31,71,102
39,8480800,Quinn Hughes,D,VAN,25,82,10,91,101
39,8477404,Jake Guentzel,C,TBL,30,82,43,56,99
39,8479407,Jesper Bratt,L,NJD,26,82,36,62,98
39,8474600,Roman Josi,D,NSH,34,82,24,73,97
39,8480801,Brady Tkachuk,L,OTT,25,82,51,45,96
39,8481557,Matt Boldy,L,MIN,23,82,45,51,96
39,8478427,Sebastian Aho,C,CAR,27,82,42,54,96
39,8474564,Steven Stamkos,C,NSH,34,82,39,57,96
39,8476887,Filip Forsberg,L,NSH,30,82,38,57,95
39,8478420,Mikko Rantanen,R,COL,28,82,39,55,94
39,8476459,Mika Zibanejad,C,NYR,31,82,32,62,94
39,8478445,Mathew Barzal,C,NYI,27,82,22,72,94
39,8477933,Sam Reinhart,C,FLA,29,82,44,49,93
39,8480023,Robert Thomas,C,STL,25,82,19,74,93
39,8477934,Leon Draisaitl,C,EDM,29,82,37,55,92
39,8478010,Brayden Point,C,TBL,28,82,41,49,90
39,8480012,Elias Pettersson,C,VAN,26,82,32,58,90
39,8478403,Jack Eichel,C,VGK,28,82,45,44,89
39,8478449,Roope Hintz,C,DAL,28,82,42,46,88
39,8474141,Patrick Kane,R,DET,36,82,42,46,88
39,8477940,Nikolaj Ehlers,L,WPG,28,82,37,50,87
39,8475913,Mark Stone,R,VGK,32,82,32,55,87
39,8473419,Brad Marchand,L,BOS,36,82,23,64,87
39,8475692,Mats Zuccarello,R,MIN,37,82,20,67,87
39,8480830,Andrei Svechnikov,R,CAR,24,82,33,53,86
39,8480208,Drake Batherson,R,OTT,26,82,31,54,85
39,8471685,Anze Kopitar,C,LAK,37,82,28,57,85
39,8476539,Jonathan Marchessault,R,NSH,34,82,48,36,84
39,8479420,Tage Thompson,C,BUF,27,82,43,41,84
39,8471214,Alex Ovechkin,L,WSH,39,82,39,45,84
39,8479542,Brandon Hagel,L,TBL,26,82,37,46,83
39,8477946,Dylan Larkin,C,DET,28,82,34,49,83
39,8476454,Ryan Nugent-Hopkins,C,EDM,31,82,22,61,83
39,8476853,Morgan Rielly,D,TOR,30,82,20,63,83
39,8482116,Tim Stützle,C,OTT,22,82,32,50,82
39,8477409,Carter Verhaeghe,C,FLA,29,82,42,39,81
39,8479343,Clayton Keller,R,UTA,26,82,42,39,81
39,8471215,Evgeni Malkin,C,PIT,38,82,26,55,81
39,8477951,Nick Schmaltz,C,UTA,28,82,34,46,80
39,8481523,Kirby Dach,C,MTL,23,82,13,67,80
39,8475172,Nazem Kadri,C,CGY,34,82,31,48,79
39,8478042,Viktor Arvidsson,R,EDM,31,82,27,51,78
39,8477447,Shea Theodore,D,VGK,29,82,20,58,78
39,8475184,Chris Kreider,L,NYR,33,82,48,29,77
39,8479323,Adam Fox,D,NYR,26,82,20,57,77
39,8478460,Zach Werenski,D,CBJ,27,82,14,63,77
39,8477501,Valeri Nichushkin,R,COL,29,82,37,39,76
39,8476460,Mark Scheifele,C,WPG,31,82,31,45,76
39,8478975,Mason Marchment,L,DAL,29,82,31,45,76
39,8478398,Kyle Connor,L,WPG,28,82,30,46,76
39,8480039,Martin Necas,C,CAR,25,82,28,48,76
39,8478873,Troy Terry,R,ANA,27,82,26,50,76
39,8477942,Kevin Fiala,L,LAK,28,82,29,46,75
39,8476346,Johnny Gaudreau,L,CBJ,31,82,20,55,75
39,8475166,John Tavares,C,TOR,34,82,35,39,74
39,8478401,Pavel Zacha,C,BOS,27,82,28,46,74
39,8480839,Rasmus Dahlin,D,BUF,24,82,22,52,74
39,8475810,Bryan Rust,R,PIT,32,82,40,33,73
39,8480036,Miro Heiskanen,D,DAL,25,82,16,57,73
39,8478414,Timo Meier,R,NJD,28,82,35,37,72
39,8480018,Nick Suzuki,C,MTL,25,82,31,41,72
39,8482097,Jack Quinn,R,BUF,23,82,34,37,71
39,8477402,Pavel Buchnevich,L,STL,29,82,32,39,71
39,8475168,Matt Duchene,C,DAL,33,82,29,42,71
39,8473994,Jamie Benn,L,DAL,35,82,26,45,71
39,8480803,Evan Bouchard,D,EDM,25,82,14,57,71
39,8479325,Charlie McAvoy,D,BOS,27,82,13,58,71
39,8477955,Jared McCann,L,SEA,28,82,41,29,70
39,8475786,Zach Hyman,L,EDM,32,82,39,31,70
39,8479675,Trevor Moore,L,LAK,29,82,33,37,70
39,8477949,Alex Tuch,R,BUF,28,82,26,44,70
39,8479385,Jordan Kyrou,C,STL,26,82,25,45,70
39,8475158,Ryan O'Reilly,C,NSH,33,82,22,48,70
39,8479339,Patrik Laine,L,CBJ,26,82,36,33,69
39,8478444,Brock Boeser,R,VAN,27,82,32,37,69
39,8477504,Josh Morrissey,D,WPG,29,82,18,51,69
39,8475726,Tyler Toffoli,C,SJS,32,82,37,31,68
39,8478856,Conor Garland,R,VAN,28,82,22,46,68
39,8476905,Chandler Stephenson,C,SEA,30,82,21,47,68
39,8478396,Noah Hanifin,D,VGK,27,82,14,54,68
39,8478440,Dylan Strome,C,WSH,27,82,28,39,67
39,8477496,Elias Lindholm,C,BOS,30,82,25,42,67
39,8475765,Vladimir Tarasenko,R,DET,33,82,25,42,67
39,8478047,Michael Bunting,L,PIT,29,82,20,47,67
39,8478366,Frank Vatrano,R,ANA,30,82,38,28,66
39,8476479,Phillip Danault,C,LAK,31,82,22,44,66
39,8475167,Victor Hedman,D,TBL,34,82,9,57,66
39,8477935,Sam Bennett,C,FLA,28,82,31,34,65
39,8481533,Trevor Zegras,C,ANA,23,82,31,34,65
39,8478493,Joel Eriksson Ek,C,MIN,27,82,30,35,65
39,8473512,Claude Giroux,R,OTT,36,82,24,41,65
39,8476462,Dougie Hamilton,D,NJD,31,82,24,41,65
39,8476456,Jonathan Huberdeau,C,CGY,31,82,12,53,65
39,8475784,Jeff Skinner,C,EDM,32,82,28,36,64
39,8481540,Cole Caufield,R,MTL,23,82,26,38,64
39,8477416,Oliver Bjorkstrand,R,SEA,29,82,19,45,64
39,8474565,Alex Pietrangelo,D,VGK,34,82,14,50,64
39,8475754,Brock Nelson,C,NYI,33,82,29,34,63
39,8474586,Jordan Eberle,R,SEA,34,82,29,34,63
39,8482078,Lucas Raymond,L,DET,22,82,27,36,63
39,8476389,Vincent Trocheck,C,NYR,31,82,26,37,63
39,8477451,Ryan Hartman,R,MIN,30,82,22,41,63
39,8477444,Andre Burakovsky,L,SEA,29,82,21,42,63
39,8478439,Travis Konecny,R,PHI,27,82,25,37,62
39,8482110,Dawson Mercer,C,NJD,23,82,24,38,62
39,8477964,Ivan Barbashev,C,VGK,29,82,25,36,61
39,8474578,Erik Karlsson,D,PIT,34,82,12,49,61
39,8478498,Jake DeBrusk,L,VAN,28,82,36,24,60
39,8475170,Brayden Schenn,C,STL,33,82,32,28,60
39,8480014,Gabriel Vilardi,C,WPG,25,82,30,30,60
39,8482109,Alexis Lafrenière,L,NYR,23,82,27,33,60
39,8477497,Sean Monahan,C,CBJ,30,82,20,40,60
39,8476483,Rickard Rakell,R,PIT,31,82,29,30,59
39,8481528,Dylan Cozens,C,BUF,23,82,26,33,59
39,8476448,William Karlsson,C,VGK,31,82,24,35,59
39,8477494,Jonathan Drouin,L,COL,29,82,23,36,59
39,8477503,Max Domi,C,TOR,29,82,18,41,59
39,8481711,Matias Maccelli,L,UTA,24,82,17,42,59
39,8475798,Mikael Granlund,C,SJS,32,82,12,47,59
39,8474102,David Perron,L,OTT,36,82,22,36,58
39,8475753,Justin Faulk,D,STL,32,82,17,41,58
39,8474590,John Carlson,D,WSH,34,82,6,52,58
39,8474641,Adam Henrique,C,EDM,34,82,35,22,57
39,8483808,Andrei Kuzmenko,L,CGY,28,82,31,26,57
39,8476880,Tom Wilson,R,WSH,30,82,26,31,57
39,8475287,Erik Haula,L,NJD,33,82,23,34,57
39,8477495,Seth Jones,D,CHI,30,82,20,37,57
39,8475763,Kevin Hayes,R,PIT,32,82,19,38,57
39,8478458,Jack Roslovic,C,CAR,27,82,18,39,57
39,8478397,Rasmus Andersson,D,CGY,28,82,14,43,57
39,8474563,Drew Doughty,D,LAK,35,82,13,44,57
39,8477500,Bo Horvat,C,NYI,29,82,36,20,56
39,8481068,Yegor Sharangovich,C,CGY,26,82,34,22,56
39,8478046,Danton Heinen,L,VAN,29,82,31,25,56
39,8478438,Tommy Novak,C,NSH,27,82,27,29,56
39,8482665,Matty Beniers,C,SEA,22,82,26,30,56
39,8482093,Seth Jarvis,C,CAR,22,82,26,30,56
39,8482124,Quinton Byfield,R,LAK,22,82,23,33,56
39,8476875,Mike Matheson,D,MTL,30,82,15,41,56
39,8475714,Calle Jarnkrok,C,TOR,33,82,31,24,55
39,8476432,Boone Jenner,C,CBJ,31,82,27,28,55
39,8477476,Artturi Lehkonen,L,COL,29,82,26,29,55
39,8475794,Tyler Seguin,C,DAL,32,82,24,31,55
39,8480078,Filip Chytil,C,NYR,25,82,24,31,55
39,8479337,Alex DeBrincat,R,DET,27,82,23,32,55
39,8477346,MacKenzie Weegar,D,CGY,30,82,15,40,55
39,8480865,Noah Dobson,D,NYI,24,82,12,43,55
39,8482740,Wyatt Johnston,C,DAL,21,82,31,23,54
39,8478519,Anthony Cirelli,C,TBL,27,82,23,31,54
39,8480113,Alex Iafallo,L,WPG,31,82,21,33,54
39,8477479,Tyler Bertuzzi,L,CHI,29,82,18,36,54
39,8471698,T.J. Oshie,R,WSH,38,82,27,26,53
39,8480064,Josh Norris,C,OTT,25,82,25,28,53
39,8482149,Cole Perfetti,C,WPG,22,82,23,30,53
39,8477998,Warren Foegele,L,LAK,28,82,23,30,53
39,8477021,Alex Kerfoot,C,UTA,30,82,19,34,53
39,8477407,Anthony Duclair,L,NYI,29,82,18,35,53
39,8473986,Alex Killorn,L,ANA,35,82,25,27,52
39,8481618,Alex Newhook,C,MTL,23,82,24,28,52
39,8476392,Adam Lowry,C,WPG,31,82,21,31,52
39,8475191,Reilly Smith,R,NYR,33,82,20,32,52
39,8479425,Filip Hronek,D,VAN,27,82,15,37,52
39,8471724,Kris Letang,D,PIT,37,82,14,38,52
39,8478407,Vince Dunn,D,SEA,28,82,14,38,52
39,8478055,Gustav Forsling,D,FLA,28,82,10,42,52
39,8482475,Yegor Chinakhov,R,CBJ,23,82,26,25,51
39,8479999,Casey Mittelstadt,C,COL,26,82,18,33,51
39,8476329,Travis Boyd,C,MIN,31,82,17,34,51
39,8479351,Sam Steel,C,DAL,26,82,13,38,51
39,8474679,Gustav Nyquist,C,NSH,35,82,23,27,50
39,8481596,Shane Pinto,C,OTT,24,82,22,28,50
39,8476882,Teuvo Teravainen,L,CHI,30,82,18,32,50
39,8477986,Brandon Montour,D,SEA,30,82,14,36,50
39,8476869,Brady Skjei,D,NSH,30,82,13,37,50
39,8482684,Luke Hughes,D,NJD,21,82,9,41,50
39,8475169,Evander Kane,L,EDM,33,82,29,20,49
39,8479365,Trent Frederic,C,BOS,26,82,23,26,49
39,8482745,Mason McTavish,C,ANA,21,82,21,28,49
39,8477511,Anthony Mantha,R,CGY,30,82,20,29,49
39,8476792,Torey Krug,D,STL,33,82,19,30,49
39,8480028,Morgan Frost,C,PHI,25,82,19,30,49
39,8480798,Philipp Kurashev,C,CHI,25,82,16,33,49
39,8479987,Morgan Geekie,C,BOS,26,82,23,25,48
39,8481580,Connor McMichael,C,WSH,23,82,21,27,48
39,8477960,Adrian Kempe,R,LAK,28,82,20,28,48
39,8478038,Devon Toews,D,COL,30,82,9,39,48
39,8476906,Shayne Gostisbehere,D,CAR,31,82,9,39,48
39,8479525,Ross Colton,C,COL,28,82,24,23,47
39,8480009,Eeli Tolvanen,R,SEA,25,82,22,25,47
39,8475745,Charlie Coyle,C,BOS,32,82,17,30,47
39,8476925,Colton Sissons,C,NSH,31,82,17,30,47
39,8482092,Ridly Greig,C,OTT,22,82,15,32,47
39,8482105,Jake Sanderson,D,OTT,22,82,10,37,47
39,8481604,Pavel Dorofeyev,L,VGK,24,82,27,19,46
39,8478891,Mason Appleton,C,WPG,28,82,21,25,46
39,8476399,Blake Coleman,C,CGY,33,82,19,27,46
39,8482113,Anton Lundell,C,FLA,23,82,18,28,46
39,8480829,Jesperi Kotkaniemi,C,CAR,24,82,18,28,46
39,8476881,Tomas Hertl,C,VGK,31,82,16,30,46
39,8479400,Pierre-Luc Dubois,L,WSH,26,82,23,22,45
39,8474150,Mikael Backlund,C,CGY,35,82,17,28,45
39,8478469,Thomas Chabot,D,OTT,27,82,9,36,45
39,8476458,Ryan Strome,C,ANA,31,82,6,39,45
39,8476923,Damon Severson,D,CBJ,30,82,6,39,45
39,8482055,Drew O'Connor,L,PIT,26,82,23,21,44
39,8481704,Juuso Parssinen,C,NSH,23,82,22,22,44
39,8484144,Connor Bedard,C,CHI,19,82,22,22,44
39,8481013,Jonatan Berggren,R,DET,24,82,22,22,44
39,8482720,Matthew Knies,L,TOR,22,82,21,23,44
39,8475791,Taylor Hall,L,CHI,33,82,19,25,44
39,8482159,Tyson Foerster,R,PHI,22,82,19,25,44
39,8480748,Kiefer Sherwood,L,VAN,29,82,19,25,44
39,8478462,Nicolas Roy,C,VGK,27,82,18,26,44
39,8480220,Noah Cates,L,PHI,25,82,18,26,44
39,8477426,Nicholas Paul,L,TBL,29,82,27,16,43
39,8473533,Jordan Staal,C,CAR,36,82,22,21,43
39,8480459,Pius Suter,C,VAN,28,82,18,25,43
39,8478474,Lawson Crouse,L,UTA,27,82,17,26,43
39,8482117,Lukas Reichel,L,CHI,22,82,16,27,43
39,8481581,Thomas Harley,D,DAL,23,82,14,29,43
39,8478233,Andrew Mangiapane,L,WSH,28,82,14,29,43
39,8478109,Victor Olofsson,L,VGK,29,82,26,16,42
39,8473422,Nick Foligno,L,CHI,37,82,23,19,42
39,8482705,Cole Sillinger,C,CBJ,21,82,22,20,42
39,8477987,Ryan Donato,C,CHI,28,82,20,22,42
39,8476474,Stefan Noesen,R,NJD,31,82,19,23,42
39,8479992,Michael Rasmussen,C,DET,25,82,18,24,42
39,8479996,Cody Glass,C,NSH,25,82,16,26,42
39,8478542,Evan Rodrigues,C,FLA,31,82,12,30,42
39,8474149,Evgenii Dadonov,R,DAL,35,82,12,30,42
39,8482660,Kent Johnson,C,CBJ,22,82,11,31,42
39,8483515,Juraj Slafkovsky,L,MTL,20,82,22,19,41
39,8481656,Aliaksei Protas,C,WSH,23,82,15,26,41
39,8482699,Dylan Guenther,R,UTA,21,82,21,19,40
39,8479390,Taylor Raddysh,R,WSH,26,82,19,21,40
39,8476419,Jean-Gabriel Pageau,C,NYI,32,82,16,24,40
39,8476461,Sean Couturier,C,PHI,32,82,14,26,40
39,8478911,Matt Roy,D,WSH,29,82,13,27,40
39,8478472,Mathieu Joseph,R,STL,27,82,10,30,40
39,8482671,Owen Power,D,BUF,22,82,9,31,40
39,8479410,Mikhail Sergachev,D,UTA,26,82,6,34,40
39,8480873,Rasmus Sandin,D,WSH,24,82,4,36,40
39,8482089,Jake Neighbours,L,STL,22,82,23,16,39
39,8476438,Brandon Saad,L,STL,32,82,21,18,39
39,8480015,Owen Tippett,R,PHI,25,82,20,19,39
39,8480068,Ryan Poehling,C,PHI,25,82,18,21,39
39,8477952,Robby Fabbri,C,ANA,28,82,17,22,39
39,8480817,K'Andre Miller,D,NYR,24,82,10,29,39
39,8477932,Aaron Ekblad,D,FLA,28,82,8,31,39
39,8476902,Esa Lindell,D,DAL,30,82,8,31,39
39,8476981,Josh Anderson,R,MTL,30,82,22,16,38
39,8475151,Kyle Palmieri,C,NYI,33,82,21,17,38
39,8480188,Fabian Zetterlund,L,SJS,25,82,17,21,38
39,8480813,Joe Veleno,C,DET,24,82,16,22,38
39,8476885,Jacob Trouba,D,NYR,30,82,15,23,38
39,8481582,Nicholas Robertson,L,TOR,23,82,15,23,38
39,8477456,J.T. Compher,L,DET,29,82,13,25,38
39,8480802,Ryan McLeod,C,BUF,25,82,12,26,38
39,8476958,Jaccob Slavin,D,CAR,30,82,7,31,38
39,8479393,Noah Gregor,C,OTT,26,82,18,19,37
39,8481481,Blake Lizotte,C,PIT,27,82,18,19,37
39,8478463,Anthony Beauvillier,L,PIT,27,82,16,21,37
39,8480797,Joel Farabee,L,PHI,24,82,15,22,37
39,8477948,Travis Sanheim,D,PHI,28,82,14,23,37
39,8473563,Nicklas Backstrom,C,WSH,37,82,12,25,37
39,8470613,Brent Burns,D,CAR,39,82,10,27,37
39,8475200,Dmitry Orlov,D,CAR,33,82,9,28,37
39,8476854,Hampus Lindholm,D,BOS,30,82,8,29,37
39,8477506,Ryan Pulock,D,NYI,30,82,3,34,37
39,8475314,Anders Lee,L,NYI,34,82,22,14,36
39,8475343,Nic Dowd,C,WSH,34,82,16,20,36
39,8476960,Andreas Athanasiou,C,CHI,30,82,14,22,36
39,8475220,Marcus Foligno,L,MIN,33,82,14,22,36
39,8477429,Andrew Copp,C,DET,30,82,11,25,36
39,8475764,Cam Fowler,D,ANA,33,82,7,29,36
39,8479976,Juuso Valimaki,D,UTA,26,82,6,30,36
39,8482655,J.J. Moser,D,TBL,24,82,6,30,36
39,8480043,Timothy Liljegren,D,TOR,25,82,5,31,36
39,8481186,Logan O'Connor,R,COL,28,82,19,16,35
39,8478115,Pierre Engvall,L,NYI,28,82,17,18,35
39,8475793,Ryan Johansen,C,PHI,32,82,16,19,35
39,8480849,Barrett Hayton,C,UTA,24,82,15,20,35
39,8477450,Jason Dickinson,C,CHI,29,82,14,21,35
39,8474716,Jared Spurgeon,D,MIN,35,82,13,22,35
39,8476921,Jordan Martinook,L,CAR,32,82,13,22,35
39,8475722,Jason Zucker,L,BUF,32,82,12,23,35
39,8477839,Conor Sheary,L,TBL,32,82,12,23,35
39,8480871,Adam Boqvist,D,FLA,24,82,11,24,35
39,8476931,Jake McCabe,D,TOR,31,82,9,26,35
39,8481542,Moritz Seider,D,DET,23,82,3,32,35
39,8482175,JJ Peterka,R,BUF,22,82,21,13,34
39,8479293,Brandon Tanev,L,SEA,33,82,21,13,34
39,8475848,Brendan Gallagher,R,MTL,32,82,20,14,34
39,8480835,Jack Drury,C,CAR,24,82,20,14,34
39,8478057,Dakota Joshua,C,VAN,28,82,16,18,34
39,8475760,Nick Bjugstad,C,UTA,32,82,16,18,34
39,8482146,Luke Evangelista,R,NSH,22,82,15,19,34
39,8479353,Brett Howden,C,VGK,26,82,12,22,34
39,8476826,Yanni Gourde,C,SEA,33,82,11,23,34
39,8474189,Lars Eller,C,PIT,35,82,10,24,34
39,8481606,Jordan Spence,D,LAK,23,82,8,26,34
39,8473507,Jeff Petry,D,DET,37,82,5,29,34
39,8481178,Egor Zamula,D,PHI,24,82,4,30,34
39,8483431,Logan Cooley,C,UTA,20,82,23,10,33
39,8474053,Logan Couture,C,SJS,35,82,18,15,33
39,8481560,Arthur Kaliyev,R,LAK,23,82,18,15,33
39,8479941,Justin Danforth,R,CBJ,31,82,14,19,33
39,8476918,Jimmy Vesey,L,NYR,31,82,14,19,33
39,8481554,Kaapo Kakko,R,NYR,23,82,13,20,33
39,8476927,Teddy Blueger,C,VAN,30,82,12,21,33
39,8476292,Ondrej Palat,L,NJD,33,82,11,22,33
39,8475855,Jesper Fast,R,CAR,33,82,10,23,33
39,8480789,Oliver Wahlstrom,R,NYI,24,82,9,24,33
39,8481517,Brett Leason,R,ANA,25,82,9,24,33
39,8478882,Vladislav Gavrikov,D,LAK,29,82,9,24,33
39,8480434,Sean Durzi,D,UTA,26,82,7,26,33
39,8477969,Marcus Pettersson,D,PIT,28,82,7,26,33
39,8475171,Oliver Ekman-Larsson,D,TOR,33,82,7,26,33
39,8480145,Neal Pionk,D,WPG,29,82,5,28,33
39,8474151,Ryan McDonagh,D,TBL,35,82,3,30,33
39,8484145,Zach Benson,L,BUF,19,82,20,12,32
39,8477507,Nikita Zadorov,D,BOS,29,82,16,16,32
39,8476872,Scott Laughton,C,PHI,30,82,14,18,32
39,8477919,Frederick Gaudreau,C,MIN,31,82,13,19,32
39,8480336,Sean Walker,D,CAR,30,82,11,21,32
39,8482166,Shakir Mukhamadullin,D,SJS,22,82,11,21,32
39,8478413,Jordan Greenway,L,BUF,27,82,9,23,32
39,8475218,Mattias Ekholm,D,EDM,34,82,9,23,32
39,8481546,Cam York,D,PHI,23,82,7,25,32
39,8474574,Tyler Myers,D,VAN,34,82,7,25,32
39,8476917,Adam Pelech,D,NYI,30,82,5,27,32
39,8478851,Alexandre Carrier,D,NSH,28,82,3,29,32
39,8481553,Bobby Brink,R,PHI,23,82,16,15,31
39,8480855,Jack McBain,C,UTA,24,82,16,15,31
39,8475193,Tomas Tatar,L,NJD,34,82,15,16,31
39,8475231,Casey Cizikas,C,NYI,33,82,14,17,31
39,8482133,Thomas Bordeleau,C,SJS,22,82,11,20,31
39,8479591,Michael Eyssimont,C,TBL,28,82,11,20,31
39,8477989,Christian Dvorak,C,MTL,28,82,8,23,31
39,8480049,Dylan Samberg,D,WPG,25,82,4,27,31
39,8476892,Colton Parayko,D,STL,31,82,3,28,31
39,8480035,Henri Jokiharju,D,BUF,25,82,2,29,31
39,8480893,Kirill Marchenko,R,CBJ,24,82,20,10,30
39,8475799,Nino Niederreiter,R,WPG,32,82,16,14,30
39,8470621,Corey Perry,R,EDM,39,82,16,14,30
39,8475149,Marcus Johansson,L,MIN,34,82,13,17,30
39,8480074,Alexandre Texier,C,STL,25,82,13,17,30
39,8481624,Ilya Mikheyev,R,CHI,30,82,12,18,30
39,8476873,Mark Jankowski,C,NSH,30,82,12,18,30
39,8477947,Sonny Milano,L,WSH,28,82,11,19,30
39,8484153,Leo Carlsson,C,ANA,20,82,11,19,30
39,8484203,Bradly Nadeau,L,CAR,19,82,11,19,30
39,8482111,Justin Barron,D,MTL,23,82,10,20,30
39,8482666,Scott Morrow,D,CAR,22,82,9,21,30
39,8476312,Josh Manson,D,COL,33,82,7,23,30
39,8477498,Darnell Nurse,D,EDM,29,82,6,24,30
39,8476979,Erik Gustafsson,D,DET,32,82,6,24,30
39,8482245,Artem Zub,D,OTT,29,82,2,28,30
39,8480185,Eetu Luostarinen,C,FLA,26,82,15,14,29
39,8475768,Jaden Schwartz,C,SEA,32,82,14,15,29
39,8482125,Alexander Holtz,R,VGK,22,82,13,16,29
39,8476480,Vladislav Namestnikov,C,WPG,32,82,12,17,29
39,8482667,William Eklund,L,SJS,22,82,9,20,29
39,8478133,Jake Evans,C,MTL,28,82,7,22,29
39,8478136,Jake Middleton,D,MIN,28,82,6,23,29
39,8478500,Ivan Provorov,D,CBJ,27,82,4,25,29
39,8477425,Miles Wood,L,COL,29,82,17,11,28
39,8481093,Rafael Harvey-Pinard,L,MTL,25,82,17,11,28
39,8474715,Cam Atkinson,R,TBL,35,82,14,14,28
39,8481601,Simon Holmstrom,R,NYI,23,82,14,14,28
39,8477392,Hudson Fasching,R,NYI,29,82,13,15,28
39,8479345,Jakob Chychrun,D,WSH,26,82,12,16,28
39,8477015,Connor Brown,R,EDM,30,82,12,16,28
39,8476422,Mike Reilly,D,NYI,31,82,8,20,28
39,8479998,Mikey Anderson,D,LAK,25,82,4,24,28
39,8477220,Nate Schmidt,D,FLA,33,82,4,24,28
39,8476331,Dylan DeMelo,D,WPG,31,82,3,25,28
39,8478508,Yakov Trenin,C,MIN,27,82,15,12,27
39,8482062,Cole Smith,L,NSH,29,82,15,12,27
39,8475842,Sam Carrick,C,NYR,32,82,14,13,27
39,8477369,Carson Soucy,D,VAN,30,82,10,17,27
39,8476442,Matt Nieto,L,PIT,32,82,10,17,27
39,8477931,Tomas Nosek,L,FLA,32,82,10,17,27
39,8476463,Jonas Brodin,D,MIN,31,82,4,23,27
39,8481535,Nils Hoglander,L,VAN,24,82,16,10,26
39,8479414,Nathan Bastian,R,NJD,27,82,15,11,26
39,8481032,Paul Cotter,C,NJD,25,82,13,13,26
39,8479368,Max Jones,L,BOS,26,82,13,13,26
39,8480995,Pontus Holmberg,R,TOR,25,82,12,14,26
39,8476889,Radek Faksa,C,STL,30,82,11,15,26
39,8482807,Ethan Del Mastro,D,CHI,21,82,10,16,26
39,8480806,Isac Lundestrom,C,ANA,25,82,9,17,26
39,8476897,Oskar Sundqvist,C,STL,30,82,9,17,26
39,8475324,Nick Jensen,D,OTT,34,82,7,19,26
39,8478443,Brandon Carlo,D,BOS,28,82,7,19,26
39,8479398,Samuel Girard,D,COL,26,82,5,21,26
39,8480878,Nils Lundkvist,D,DAL,24,82,5,21,26
39,8480796,Martin Fehervary,D,WSH,25,82,4,22,26
39,8476457,Adam Larsson,D,SEA,32,82,2,24,26
39,8478507,John Marino,D,UTA,27,82,2,24,26
39,8476469,Joel Armia,R,MTL,31,82,17,8,25
39,8476878,Zemgus Girgensons,L,TBL,30,82,16,9,25
39,8473453,Trevor Lewis,C,LAK,37,82,15,10,25
39,8480003,Jesper Boqvist,C,FLA,26,82,14,11,25
39,8478020,Michael Amadio,C,OTT,28,82,13,12,25
39,8484166,Adam Fantilli,C,CBJ,20,82,13,12,25
39,8477953,Kasperi Kapanen,R,STL,28,82,12,13,25
39,8482074,Connor Zary,C,CGY,23,82,12,13,25
39,8481477,Nico Sturm,C,SJS,29,82,11,14,25
39,8479359,Beck Malenstyn,L,BUF,26,82,10,15,25
39,8480448,Parker Kelly,L,COL,25,82,10,15,25
39,8479316,Luke Kunin,C,SJS,27,82,9,16,25
39,8482259,Bobby McMann,C,TOR,28,82,9,16,25
39,8477435,Ryan Graves,D,PIT,29,82,5,20,25
39,8479369,Andrew Peeke,D,BOS,26,82,3,22,25
39,8481708,Zac Jones,D,NYR,24,82,2,23,25
39,8479371,Dante Fabbro,D,NSH,26,82,1,24,25
39,8477505,Alexander Wennberg,C,SJS,30,82,12,12,24
39,8482624,Daniil Miromanov,D,CGY,27,82,10,14,24
39,8479983,Mario Ferraro,D,SJS,26,82,8,16,24
39,8483482,Tristan Luneau,D,ANA,20,82,8,16,24
39,8482079,Marco Rossi,C,MIN,23,82,7,17,24
39,8479661,Tanner Jeannot,L,LAK,27,82,7,17,24
39,8483505,Matthew Poitras,C,BOS,20,82,7,17,24
39,8479324,Ryan Lindgren,D,NYR,26,82,6,18,24
39,8478450,Parker Wotherspoon,D,BOS,27,82,6,18,24
39,8482073,Braden Schneider,D,NYR,23,82,4,20,24
39,8479402,Jake Bean,D,CGY,26,82,2,22,24
39,8478416,Erik Cernak,D,TBL,27,82,2,22,24
39,8476374,Sean Kuraly,C,CBJ,31,82,16,7,23
39,8476891,Matt Grzelcyk,D,PIT,30,82,10,13,23
39,8477938,Haydn Fleury,D,WPG,28,82,9,14,23
39,8477406,Mattias Janmark,C,EDM,32,82,7,16,23
39,8477353,Tyler Motte,C,DET,29,82,6,17,23
39,8480144,David Kampf,C,TOR,29,82,5,18,23
39,8482087,Kaiden Guhle,D,MTL,22,82,3,20,23
39,8475462,Radko Gudas,D,ANA,34,82,2,21,23
39,8477845,Trevor van Riemsdyk,D,WSH,33,82,1,22,23
39,8478569,Noel Acciari,C,PIT,33,82,13,9,22
39,8480980,Connor Dewar,C,TOR,25,82,12,10,22
39,8482122,Brock Faber,D,MIN,22,82,4,18,22
39,8480950,Ilya Lyubushkin,D,DAL,30,82,4,18,22
39,8475188,Brayden McNabb,D,VGK,33,82,3,19,22
39,8475233,David Savard,D,MTL,34,82,1,21,22
39,8478432,Christian Fischer,R,DET,27,82,9,12,21
39,8478434,Keegan Kolesar,R,VGK,27,82,9,12,21
39,8478013,Jake Walman,D,SJS,28,82,8,13,21
39,8483524,Shane Wright,C,SEA,20,82,7,14,21
39,8483567,Georgii Merkulov,C,BOS,24,82,7,14,21
39,8482858,Ryker Evans,D,SEA,23,82,6,15,21
39,8478468,Jeremy Lauzon,D,NSH,27,82,6,15,21
39,8483493,Frank Nazar,C,CHI,20,82,5,16,21
39,8483468,Jiri Kulich,C,BUF,20,82,5,16,21
39,8477488,Brett Pesce,D,NJD,30,82,4,17,21
39,8477365,Connor Clifton,D,BUF,29,82,4,17,21
39,8483457,Lane Hutson,D,MTL,20,82,3,18,21
39,8482142,Jamie Drysdale,D,PHI,22,82,3,18,21
39,8476429,Scott Mayfield,D,NYI,32,82,3,18,21
39,8474673,TJ Brodie,D,CHI,34,82,2,19,21
39,8478399,Jonas Siegenthaler,D,NJD,27,82,2,19,21
39,8478840,Will Borgen,D,SEA,28,82,2,19,21
39,8480807,Mattias Samuelsson,D,BUF,24,82,2,19,21
39,8480222,Sebastian Aho,D,PIT,28,82,0,21,21
39,8482077,Dylan Holloway,L,EDM,23,82,11,9,20
39,8480021,Jack Studnicka,C,LAK,25,82,10,10,20
39,8477508,Curtis Lazar,C,NJD,29,82,8,12,20
39,8475279,Ben Chiarot,D,DET,33,82,5,15,20
39,8481522,Peyton Krebs,C,BUF,23,82,4,16,20
39,8479980,Nicolas Hague,D,VGK,26,82,3,17,20
39,8476879,Cody Ceci,D,EDM,31,82,1,19,20
39,8481568,Alex Vlasic,D,CHI,23,82,1,19,20
39,8483499,Liam Ohgren,L,MIN,20,82,12,7,19
39,8482749,Joshua Roy,R,MTL,21,82,12,7,19
39,8482155,Alex Laferriere,R,LAK,23,82,11,8,19
39,8482809,Jackson Blake,R,CAR,21,82,9,10,19
39,8476467,Jamie Oleksiak,D,SEA,32,82,6,13,19
39,8475181,Nick Leddy,D,STL,33,82,5,14,19
39,8481014,Alexander Romanov,D,NYI,24,82,4,15,19
39,8475790,Erik Gudbranson,D,CBJ,32,82,4,15,19
39,8480246,Nick Perbix,D,TBL,26,82,3,16,19
39,8483397,Marc McLaughlin,C,BOS,25,82,13,5,18
39,8480281,Alexey Toropchenko,R,STL,25,82,11,7,18
39,8482145,Mavrik Bourque,C,DAL,22,82,10,8,18
39,8483445,Cutter Gauthier,L,ANA,20,82,8,10,18
39,8483763,Maksymilian Szuber,D,UTA,22,82,7,11,18
39,8482470,Ilya Solovyov,D,CGY,24,82,7,11,18
39,8483495,Simon Nemec,D,NJD,20,82,6,12,18
39,8476822,Luke Glendening,C,TBL,35,82,6,12,18
39,8476624,Barclay Goodrow,C,SJS,31,82,6,12,18
39,8483565,Nick Blankenburg,D,NSH,26,82,5,13,18
39,8476441,Joel Edmundson,D,LAK,31,82,4,14,18
39,8475718,Justin Holl,D,DET,32,82,2,16,18
39,8482702,Logan Stankoven,C,DAL,21,82,12,5,17
39,8476858,Phillip Di Giuseppe,L,VAN,31,82,10,7,17
39,8482679,Matt Coronato,R,CGY,22,82,7,10,17
39,8482141,Lukas Cormier,D,VGK,22,82,6,11,17
39,8481699,Aku Raty,R,UTA,23,82,4,13,17
39,8480879,Jacob Bernard-Docker,D,OTT,24,82,3,14,17
39,8477499,Rasmus Ristolainen,D,PHI,30,82,2,15,17
39,8479291,Kevin Rooney,C,CGY,31,82,11,5,16
39,8476278,Colin Blackwell,C,DAL,31,82,9,7,16
39,8482762,Simon Edvinsson,D,DET,21,82,9,7,16
39,8481641,Joel Kiviranta,L,COL,28,82,8,8,16
39,8478211,Dryden Hunt,L,CGY,29,82,7,9,16
39,8483490,Pavel Mintyukov,D,ANA,21,82,6,10,16
39,8481028,Martin Pospisil,C,CGY,25,82,5,11,16
39,8478178,Darren Raddysh,D,TBL,28,82,5,11,16
39,8483012,Logan Morrison,C,SEA,22,82,4,12,16
39,8476525,Colin Miller,D,WPG,32,82,4,12,16
39,8482733,Logan Mailloux,D,MTL,31,82,4,12,16
39,8480990,Declan Chisholm,D,MIN,24,82,3,13,16
39,8480172,Jan Rutta,D,SJS,34,82,3,13,16
39,8481567,Henry Thrun,D,SJS,23,82,3,13,16
39,8483460,David Jiricek,D,CBJ,21,82,2,14,16
39,8481605,Jackson LaCombe,D,ANA,23,82,2,14,16
39,8480860,Kevin Bahl,D,CGY,24,82,0,16,16
39,8480025,MacKenzie Entwistle,R,FLA,25,82,8,7,15
39,8482803,Olen Zellweger,D,ANA,21,82,7,8,15
39,8480073,Erik Brannstrom,D,COL,25,82,5,10,15
39,8478874,Adam Gaudette,C,OTT,28,82,4,11,15
39,8476967,Brett Kulak,D,EDM,30,82,3,12,15
39,8479638,Justin Brazeau,R,BOS,26,82,8,6,14
39,8482859,Zack Ostapchuk,C,OTT,21,82,6,8,14
39,8482118,Sam Colangelo,R,ANA,23,82,5,9,14
39,8471677,Jack Johnson,D,CBJ,37,82,5,9,14
39,8470600,Ryan Suter,D,STL,39,82,4,10,14
39,8477335,Kyle Burroughs,D,LAK,29,82,3,11,14
39,8484911,Collin Graf,R,SJS,22,82,8,5,13
39,8477903,Garnet Hathaway,R,PHI,33,82,5,8,13
39,8483489,Fraser Minten,C,TOR,31,82,3,10,13
39,8474013,Ian Cole,D,UTA,35,82,2,11,13
39,8475455,Brenden Dillon,D,NJD,34,82,2,11,13
39,8483466,Kevin Korchinski,D,CHI,20,82,2,11,13
39,8477034,Jaycob Megna,D,FLA,32,82,6,6,12
39,8482516,Matthew Kessel,D,STL,24,82,4,8,12
39,8484149,Gavin Brindley,C,CBJ,20,82,3,9,12
39,8481122,Simon Benoit,D,TOR,26,82,2,10,12
39,8475690,Chris Tanev,D,TOR,35,82,1,11,12
39,8478859,Niko Mikkola,D,FLA,28,82,1,11,12
39,8481524,Bowen Byram,D,BUF,23,82,5,6,11
39,8480870,Bo Groulx,C,NYR,24,82,3,8,11
39,8474612,Travis Hamonic,D,OTT,34,82,1,10,11
39,8475762,Derek Forbort,D,VAN,32,82,0,11,11
39,8482713,Mackie Samoskevich,R,FLA,22,82,5,5,10
39,8482659,Josh Doan,R,UTA,22,82,4,6,10
39,8482153,Brendan Brisson,C,VGK,23,82,3,7,10
39,8482101,Danil Gushchin,L,SJS,22,82,3,6,9
39,8476473,Connor Murphy,D,CHI,31,82,3,6,9
39,8482787,Nikita Chibrikov,R,WPG,31,82,2,7,9
39,8479442,Troy Stecher,D,EDM,30,82,1,8,9
39,8480834,Ty Emberson,D,SJS,24,82,1,8,9
39,8483471,Brad Lambert,C,WPG,31,82,4,4,8
39,8475177,Calvin de Haan,D,COL,33,82,2,6,8
39,8474567,Zach Bogosian,D,MIN,34,82,2,6,8
39,8482070,Mitchell Chaffee,R,TBL,26,82,6,1,7
39,8474090,Brendan Smith,D,DAL,35,82,2,5,7
39,8476372,Nick Seeler,D,PHI,31,82,2,5,7
39,8482712,Oskar Olausson,R,COL,22,82,1,6,7
39,8474062,Riley Nash,C,NYR,35,82,1,5,6
39,8479576,Vincent Desharnais,D,VAN,28,82,0,5,5
39,8470794,Joe Pavelski,C,,40,0,0,0,0
39,8481703,Valtteri Puustinen,R,PIT,25,0,0,0,0
39,8477950,Tony DeAngelo,D,,29,0,0,0,0
39,8481577,Philip Tomasino,C,NSH,23,0,0,0,0
39,8475197,Tyson Barrie,D,,33,0,0,0,0
39,8471218,Blake Wheeler,R,,38,0,0,0,0
39,8474157,Max Pacioretty,L,,36,0,0,0,0
39,8478466,Daniel Sprong,R,VAN,27,0,0,0,0
39,8475744,Evgeny Kuznetsov,C,,32,0,0,0,0
39,8481019,David Gustafsson,C,WPG,24,0,0,0,0
39,8475906,John Klingberg,D,,32,0,0,0,0
39,8479348,Kale Clague,D,BUF,26,0,0,0,0
39,8476952,Dominic Toninato,C,WPG,30,0,0,0,0
39,8473473,Milan Lucic,L,,36,0,0,0,0
39,8474037,James van Riemsdyk,L,,35,0,0,0,0
39,8474602,Justin Schultz,D,,34,0,0,0,0
39,8482222,Alexander Barabanov,L,,30,0,0,0,0
39,8479372,Josh Mahura,D,SEA,26,0,0,0,0
39,8479982,Conor Timmins,D,TOR,26,0,0,0,0
39,8474031,Kevin Shattenkirk,D,,35,0,0,0,0
39,8480008,Adam Ruzicka,C,,25,0,0,0,0
39,8481059,Scott Perunovich,D,STL,26,0,0,0,0
39,8480884,Calen Addison,D,,24,0,0,0,0
39,8476994,Vinnie Hinostroza,C,NSH,30,0,0,0,0
39,8478452,Caleb Jones,D,LAK,27,0,0,0,0
39,8480157,Calle Rosen,D,COL,30,0,0,0,0
39,8481609,Vladislav Kolyachonok,D,UTA,23,0,0,0,0
39,8479415,Michael McLeod,C,,26,0,0,0,0
39,8476919,Chris Tierney,C,,30,0,0,0,0
39,8479639,Dylan Coghlan,D,WPG,26,0,0,0,0
39,8478146,Matthew Highmore,C,OTT,28,0,0,0,0
39,8478970,Jalen Chatfield,D,CAR,28,0,0,0,0
39,8480205,Emil Bemstrom,C,PIT,25,0,0,0,0
39,8474884,Mike Hoffman,C,,35,0,0,0,0
39,8471274,Alex Goligoski,D,,39,0,0,0,0
39,8478104,Sammy Blais,L,,28,0,0,0,0
39,8474870,Tyler Johnson,C,,34,0,0,0,0
39,8476913,Devin Shore,C,MIN,30,0,0,0,0
39,8481598,Philip Broberg,D,EDM,23,0,0,0,0
39,8480058,Pierre-Olivier Joseph,D,STL,25,0,0,0,0
39,8480891,Michael Kesselring,D,UTA,24,0,0,0,0
39,8477979,Nicolas Aube-Kubel,R,BUF,28,0,0,0,0
39,8476871,Tanner Pearson,L,,32,0,0,0,0
39,8476393,Nick Cousins,C,,31,0,0,0,0
39,8479977,Kailer Yamamoto,R,,26,0,0,0,0
39,8479543,Michael Pezzetta,L,MTL,26,0,0,0,0
39,8477018,Ben Hutton,D,VGK,31,0,0,0,0
39,8480762,Eric Robinson,L,CAR,29,0,0,0,0
39,8474034,Pat Maroon,L,CHI,36,0,0,0,0
39,8481058,Jesse Ylönen,R,,25,0,0,0,0
39,8475179,Dmitry Kulikov,D,FLA,34,0,0,0,0
39,8481527,Kaedan Korczak,D,VGK,23,0,0,0,0
39,8473449,Kyle Okposo,R,,36,0,0,0,0
39,8482192,Isaak Phillips,D,CHI,23,0,0,0,0
39,8480727,Zach Whitecloud,D,VGK,28,0,0,0,0
39,8479346,Dillon Dube,C,,26,0,0,0,0
39,8480821,Filip Zadina,R,,25,0,0,0,0
39,8480001,Urho Vaakanainen,D,ANA,25,0,0,0,0
39,8470966,Mark Giordano,D,,41,0,0,0,0
39,8480853,Liam Foudy,C,,24,0,0,0,0
39,8475225,Craig Smith,C,CHI,35,0,0,0,0
39,8479972,Mason Shaw,C,WPG,26,0,0,0,0
39,8478451,Ethan Bear,D,WSH,27,0,0,0,0
39,8474040,Sam Gagner,C,,35,0,0,0,0
39,8480196,Jacob Bryson,D,BUF,27,0,0,0,0
39,8479984,Cal Foote,D,,26,0,0,0,0
39,8480011,Klim Kostin,C,SJS,25,0,0,0,0
39,8482176,Wyatt Kaiser,D,CHI,22,0,0,0,0
39,8476988,Matt Benning,D,SJS,30,0,0,0,0
39,8479370,Tyson Jost,C,CAR,26,0,0,0,0
39,8477464,Nic Petan,C,,29,0,0,0,0
39,8477380,Jonny Brodzinski,C,NYR,31,0,0,0,0
39,8480070,Ian Mitchell,D,BOS,25,0,0,0,0
39,8479315,Joey Anderson,R,CHI,26,0,0,0,0
39,8478099,Kevin Labanc,R,,29,0,0,0,0
39,8476874,Olli Maatta,D,DET,30,0,0,0,0
39,8475208,Brian Dumoulin,D,ANA,33,0,0,0,0
39,8478430,Oliver Kylington,D,,27,0,0,0,0
39,8479536,Axel Jonsson-Fjallby,L,WPG,26,0,0,0,0
39,8479671,Mathieu Olivier,R,CBJ,27,0,0,0,0
39,8471709,Marc-Edouard Vlasic,D,SJS,37,0,0,0,0
39,8479328,Julien Gauthier,R,NYI,27,0,0,0,0
39,8478421,A.J. Greer,L,FLA,28,0,0,0,0
39,8477573,Nathan Walker,L,STL,30,0,0,0,0
39,8481537,Nikita Okhotiuk,D,CGY,24,0,0,0,0
39,8474166,Alec Martinez,D,CHI,37,0,0,0,0
39,8470610,Zach Parise,L,,40,0,0,0,0
39,8477478,William Carrier,L,CAR,30,0,0,0,0
39,8479344,Jesse Puljujarvi,R,PIT,26,0,0,0,0
39,8480887,Jordan Harris,D,MTL,24,0,0,0,0
39,8478502,Dennis Gilbert,D,BUF,28,0,0,0,0
39,8482730,Brandt Clarke,D,LAK,21,0,0,0,0
39,8480355,Mark Kastelic,C,BOS,25,0,0,0,0
39,8475750,Jon Merrill,D,MIN,32,0,0,0,0
39,8475164,Jakob Silfverberg,R,,34,0,0,0,0
39,8477944,Jakub Vrana,L,,28,0,0,0,0
39,8479439,Jacob MacDonald,D,COL,31,0,0,0,0
39,8474568,Luke Schenn,D,NSH,35,0,0,0,0
39,8478454,Noah Juulsen,D,VAN,27,0,0,0,0
39,8475752,Tyler Pitlick,C,,33,0,0,0,0
39,8482148,Hendrix Lapierre,C,WSH,22,0,0,0,0
39,8481167,Brayden Pachal,D,CGY,25,0,0,0,0
39,8478043,Sam Lafferty,C,BUF,29,0,0,0,0
39,8479321,Lucas Johansen,D,,27,0,0,0,0
39,8471699,Andrew Cogliano,C,,37,0,0,0,0
39,8481521,Ronnie Attard,D,PHI,25,0,0,0,0
39,8481161,Jake Christiansen,D,CBJ,25,0,0,0,0
39,8479458,Nikita Zaitsev,D,,33,0,0,0,0
39,8479619,Michael Carcone,L,UTA,28,0,0,0,0
39,8479026,Philippe Myers,D,TOR,27,0,0,0,0
39,8477330,Dominik Kubalik,L,,29,0,0,0,0
39,8481617,Vasily Podkolzin,R,VAN,23,0,0,0,0
39,8481701,Santeri Hatakka,D,NJD,23,0,0,0,0
39,8479514,Rem Pitlick,C,,27,0,0,0,0
39,8477446,Michael McCarron,R,NSH,29,0,0,0,0
39,8470604,Jeff Carter,C,,39,0,0,0,0
39,8482241,Radim Zohorna,L,,28,0,0,0,0
39,8480289,Morgan Barron,C,WPG,26,0,0,0,0
39,8479379,Givani Smith,R,SJS,26,0,0,0,0
39,8480216,Jacob Peterson,C,,25,0,0,0,0
39,8477851,Jordan Oesterle,D,BOS,32,0,0,0,0
39,8484258,Sam Malinski,D,COL,26,0,0,0,0
39,8478904,Steven Lorentz,C,,28,0,0,0,0
39,8482095,Tyler Kleven,D,OTT,22,0,0,0,0
39,8480848,Ty Dellandrea,C,SJS,24,0,0,0,0
39,8476884,Derrick Pouliot,D,,30,0,0,0,0
39,8479336,Carl Grundstrom,R,SJS,27,0,0,0,0
39,8482964,Arber Xhekaj,D,MTL,23,0,0,0,0
39,8471686,Marc Staal,D,,37,0,0,0,0
39,8477887,Patrick Brown,C,BOS,32,0,0,0,0
39,8478495,Denis Gurianov,R,,27,0,0,0,0
39,8473504,Cal Clutterbuck,R,,37,0,0,0,0
39,8481550,Adam Beckman,L,NJD,23,0,0,0,0
39,8480845,Rasmus Kupari,C,WPG,24,0,0,0,0
39,8474009,Nick Bonino,C,,36,0,0,0,0
39,8478585,Derek Ryan,C,EDM,38,0,0,0,0
39,8477962,Brendan Lemieux,L,CAR,28,0,0,0,0
39,8482861,Vincent Iorio,D,WSH,22,0,0,0,0
39,8479378,Logan Stanley,D,WPG,26,0,0,0,0
39,8473446,Erik Johnson,D,PHI,36,0,0,0,0
39,8481743,Marc Del Gaizo,D,NSH,25,0,0,0,0
39,8477384,Josh Brown,D,EDM,30,0,0,0,0
39,8482165,Yan Kuznetsov,D,CGY,22,0,0,0,0
39,8478424,Jansen Harkins,C,ANA,27,0,0,0,0
39,8482144,Jack Thompson,D,SJS,22,0,0,0,0
39,8478512,Austin Czarnik,C,,32,0,0,0,0
39,8477527,Ross Johnston,L,ANA,30,0,0,0,0
39,8479383,Boris Katchouk,L,,26,0,0,0,0
39,8482094,Daemon Hunt,D,MIN,22,0,0,0,0
39,8481719,Maxwell Crozier,D,TBL,24,0,0,0,0
39,8480192,Johnathan Kovacevic,D,NJD,27,0,0,0,0
39,8479376,Victor Mete,D,,26,0,0,0,0
39,8482511,Mason Lohrei,D,BOS,23,0,0,0,0
39,8475825,Jani Hakanpää,D,,32,0,0,0,0
39,8478021,William Lagesson,D,DET,28,0,0,0,0
39,8475795,Dylan McIlrath,D,WSH,32,0,0,0,0
39,8477846,Ryan Carpenter,C,,33,0,0,0,0
39,8481056,Spencer Stastney,D,NSH,24,0,0,0,0
39,8481564,Ryan Johnson,D,BUF,23,0,0,0,0
39,8478017,Mark Friedman,D,VAN,29,0,0,0,0
39,8479320,Max Lajoie,D,SEA,27,0,0,0,0
39,8480075,Cameron Crotty,D,MIN,25,0,0,0,0
39,8484287,Cole McWard,D,VAN,23,0,0,0,0
39,8484254,Akito Hirose,D,VAN,25,0,0,0,0
39,8483407,Brandon Scanlin,D,NYR,25,0,0,0,0
39,8480274,Philip Kemp,D,EDM,25,0,0,0,0
39,8479522,Hardy Haman Aktell,D,WSH,26,0,0,0,0
39,8480007,Jonas Rondbjerg,R,VGK,25,0,0,0,0
39,8477454,Adam Erne,L,,29,0,0,0,0
39,8481679,Maxence Guenette,D,OTT,23,0,0,0,0
39,8480441,Trey Fix-Wolansky,R,CBJ,25,0,0,0,0
39,8483546,Marshall Rifai,D,TOR,26,0,0,0,0
39,8480084,Nick DeSimone,D,NJD,30,0,0,0,0
39,8481030,Jack St. Ivany,D,PIT,25,0,0,0,0
39,8481592,Jakob Pelletier,L,CGY,23,0,0,0,0
39,8478011,Louie Belpedio,D,PHI,28,0,0,0,0
39,8477930,Pierre-Edouard Bellemare,L,,39,0,0,0,0
39,8484321,Nikolas Matinpalo,D,OTT,26,0,0,0,0
39,8482067,Connor Mackey,D,NYR,28,0,0,0,0
39,8481806,Louis Crevier,D,CHI,23,0,0,0,0
39,8484326,Patrik Koch,D,UTA,28,0,0,0,0
39,8477971,Andreas Englund,D,LAK,28,0,0,0,0
39,8481751,Lukas Rousek,R,BUF,25,0,0,0,0
39,8481006,Tyler Tucker,D,STL,24,0,0,0,0
39,8476867,Brendan Gaunce,C,MIN,30,0,0,0,0
39,8479520,Brandon Duhaime,R,WSH,27,0,0,0,0
39,8477073,Kurtis MacDermid,L,NJD,30,0,0,0,0
39,8480874,Adam Ginning,D,PHI,24,0,0,0,0
39,8477473,Justin Bailey,R,SJS,29,0,0,0,0
39,8479066,Ryan Lomberg,L,CGY,30,0,0,0,0
39,8477070,Liam O'Brien,C,UTA,30,0,0,0,0
39,8474618,Marco Scandella,D,,34,0,0,0,0
39,8475797,Jarred Tinordi,D,,32,0,0,0,0
39,8481441,Joe Snively,C,DET,28,0,0,0,0
39,8477244,Chad Ruhwedel,D,NYR,34,0,0,0,0
39,8479772,Zack MacEwen,R,OTT,28,0,0,0,0
39,8481147,Reese Johnson,C,MIN,26,0,0,0,0
39,8481043,Cole Koepke,L,BOS,26,0,0,0,0
39,8483619,Filip Roos,D,OTT,25,0,0,0,0
39,8481541,Samuel Bolduc,D,NYI,24,0,0,0,0
39,8477810,Joel Hanley,D,CGY,33,0,0,0,0
39,8476907,Mackenzie MacEachern,L,,30,0,0,0,0
39,8482652,Walker Duehr,R,CGY,27,0,0,0,0
39,8477126,Jayson Megna,C,,34,0,0,0,0
39,8483398,Declan Carlile,D,TBL,31,0,0,0,0
39,8482929,Emil Lilleberg,D,TBL,23,0,0,0,0
39,8480880,Jakub Lauko,C,MIN,24,0,0,0,0
39,8480245,Olle Lycksell,R,PHI,25,0,0,0,0
39,8480252,Cole Guttman,C,CHI,25,0,0,0,0
39,8477467,Gustav Olofsson,D,SEA,30,0,0,0,0
39,8479968,Vinni Lettieri,C,BOS,29,0,0,0,0
39,8478400,Colin White,C,,27,0,0,0,0
39,8475755,Alexander Petrovic,D,DAL,32,0,0,0,0
39,8481812,Nikolai Knyzhov,D,,27,0,0,0,0
39,8481593,Jayden Struble,D,MTL,23,0,0,0,0
39,8481532,Alex Turcotte,C,LAK,23,0,0,0,0
39,8482126,Emil Andrae,D,PHI,31,0,0,0,0
39,8479944,Zach Aston-Reese,C,VGK,30,0,0,0,0
39,8471817,Ryan Reaves,R,TOR,37,0,0,0,0
39,8481206,John Ludvig,D,PIT,24,0,0,0,0
39,8481599,Victor Soderstrom,D,UTA,23,0,0,0,0
39,8480292,Carson Meyer,R,ANA,27,0,0,0,0
39,8482496,Nils Aman,C,VAN,24,0,0,0,0
39,8479718,Alex Barré-Boulet,C,MTL,27,0,0,0,0
39,8479994,Jaret Anderson-Dolan,C,WPG,25,0,0,0,0
39,8480184,Gustav Lindstrom,D,,26,0,0,0,0
39,8480890,Jan Jenik,R,OTT,24,0,0,0,0
39,8478067,Oskar Lindblom,L,,28,0,0,0,0
39,8476934,Brock McGinn,L,ANA,30,0,0,0,0
39,8479985,Cale Fleury,D,SEA,26,0,0,0,0
39,8484304,Uvis Balinskis,D,FLA,28,0,0,0,0
39,8479981,Jonah Gadjovich,L,FLA,26,0,0,0,0
39,8481716,Dmitri Voronkov,L,CBJ,24,0,0,0,0
39,8474709,Matt Martin,L,,35,0,0,0,0
39,8482634,Alex Steeves,C,TOR,25,0,0,0,0
39,8480823,Alexander Alexeyev,D,WSH,25,0,0,0,0
39,8477541,Dakota Mermis,D,TOR,30,0,0,0,0
39,8483491,Ivan Miroshnichenko,L,WSH,20,0,0,0,0
39,8478477,Mitchell Stephens,C,SEA,27,0,0,0,0
39,8481543,Nikita Alexandrov,C,STL,24,0,0,0,0
39,8479423,Alex Nylander,L,,26,0,0,0,0
39,8482451,Mikael Pyyhtia,L,CBJ,23,0,0,0,0
39,8478831,Kevin Stenlund,C,UTA,28,0,0,0,0
39,8480306,Grant Hutton,D,NYI,29,0,0,0,0
39,8478028,Fredrik Olofsson,L,,28,0,0,0,0
39,8477462,Robert Hagg,D,VGK,29,0,0,0,0
39,8477320,Anton Blidh,L,NYR,29,0,0,0,0
39,8482157,Will Cuylle,L,NYR,22,0,0,0,0
39,8482737,Zack Bolduc,C,STL,21,0,0,0,0
39,8481239,Samuel Fagemo,L,,24,0,0,0,0
39,8481600,Tobias Bjornfot,D,FLA,23,0,0,0,0
39,8478409,Anthony Richard,C,PHI,28,0,0,0,0
39,8474145,Robert Bortuzzo,D,,35,0,0,0,0
39,8475958,Michael Sgarbossa,C,WSH,32,0,0,0,0
39,8479986,Kole Lind,R,DAL,26,0,0,0,0
39,8479249,Andrew Poturalski,C,SJS,30,0,0,0,0
39,8479362,Riley Tufte,L,BOS,26,0,0,0,0
39,8479991,Jake Leschyshyn,C,NYR,25,0,0,0,0
39,8479587,Rhett Gardner,C,PHI,28,0,0,0,0
39,8482744,James Malatesta,L,CBJ,21,0,0,0,0
39,8478854,Ryan Shea,D,PIT,27,0,0,0,0
39,8481591,Sam Poulin,R,,23,0,0,0,0
39,8483512,Matt Savoie,C,EDM,20,0,0,0,0
39,8482102,Vasily Ponomarev,C,PIT,22,0,0,0,0
39,8482162,Roby Jarventie,L,EDM,22,0,0,0,0
39,8481016,Ruslan Iskhakov,C,,24,0,0,0,0
39,8482172,Landon Slaggert,L,CHI,22,0,0,0,0
39,8482747,Brennan Othmann,L,NYR,21,0,0,0,0
39,8480031,Maxime Comtois,L,,25,0,0,0,0
39,8480226,Marián Studenic,R,,26,0,0,0,0
39,8478408,Travis Dermott,D,,28,0,0,0,0
39,8481518,Nolan Foote,L,NJD,24,0,0,0,0
39,8479419,Brett Murray,L,BUF,26,0,0,0,0
39,8482088,Justin Sourdif,R,FLA,22,0,0,0,0
39,8482201,Gage Goncalves,C,TBL,23,0,0,0,0
39,8481578,Graeme Clarke,R,MIN,23,0,0,0,0
39,8482177,Marat Khusnutdinov,C,MIN,22,0,0,0,0
39,8481754,Nikita Nesterenko,C,ANA,23,0,0,0,0
39,8483531,Brian Halonen,L,NJD,25,0,0,0,0
39,8483920,Pierrick Dube,R,WSH,23,0,0,0,0
39,8480851,Akil Thomas,C,LAK,24,0,0,0,0
39,8475235,Nicolas Deslauriers,L,PHI,33,0,0,0,0
39,8482476,Emil Heineman,L,MTL,23,0,0,0,0
39,8477149,Scott Sabourin,R,SJS,32,0,0,0,0
39,8483549,Lucas Condotta,L,MTL,27,0,0,0,0
39,8482765,Isak Rosen,R,BUF,21,0,0,0,0
39,8481237,Kyle MacLean,C,NYI,25,0,0,0,0
39,8481024,Linus Karlsson,C,VAN,25,0,0,0,0
39,8481690,Tyler Angle,C,,24,0,0,0,0
39,8483570,Ben Meyers,C,SEA,26,0,0,0,0
39,8481655,Cole Schwindt,R,CGY,23,0,0,0,0
39,8481462,Mason Morelli,L,VGK,28,0,0,0,0
39,8483401,Marc Johnstone,R,PIT,28,0,0,0,0
39,8478956,Samuel Laberge,L,NJD,27,0,0,0,0
39,8479533,Joona Koppanen,L,,26,0,0,0,0
39,8482197,Adam Raska,R,MIN,23,0,0,0,0
39,8482250,Callahan Burke,C,VGK,27,0,0,0,0
39,8482784,Zach Dean,C,STL,21,0,0,0,0
39,8484255,Jason Polin,R,COL,25,0,0,0,0
39,8481077,John Leonard,L,,26,0,0,0,0
39,8481534,Raphael Lavoie,C,EDM,24,0,0,0,0
39,8483609,Adam Klapka,R,CGY,24,0,0,0,0
39,8482751,Ryan Winterton,C,SEA,21,0,0,0,0
39,8480267,Sammy Walker,C,MIN,25,0,0,0,0
39,8475766,Austin Watson,L,,32,0,0,0,0
39,8482460,Matt Rempe,C,NYR,22,0,0,0,0
39,8481065,Angus Crookshank,L,OTT,25,0,0,0,0
39,8481070,Hugh McGing,L,,26,0,0,0,0
39,8476323,Max McCormick,L,SEA,32,0,0,0,0
39,8483395,Arshdeep Bains,L,VAN,23,0,0,0,0
39,8484259,Ondrej Pavel,C,COL,31,0,0,0,0
39,8483432,Luca Del Bel Belluz,C,CBJ,31,0,0,0,0
39,8483045,Cameron Butler,R,CBJ,31,0,0,0,0
39,8482061,Brandon Biro,L,SEA,26,0,0,0,0
39,8477401,John Hayden,C,SEA,29,0,0,0,0
39,8475278,Byron Froese,C,,33,0,0,0,0
39,8478446,Glenn Gawdin,C,LAK,27,0,0,0,0
39,8477993,Justin Kirkland,C,CGY,28,0,0,0,0
39,8482147,Jean-Luc Foudy,C,COL,22,0,0,0,0
39,8480032,Shane Bowers,C,NJD,25,0,0,0,0
39,8479330,Brandon Gignac,C,MTL,27,0,0,0,0
39,8480776,Sheldon Rempal,R,,29,0,0,0,0
39,8475413,Justin Dowling,C,NJD,34,0,0,0,0
39,8481726,Adam Edstrom,C,NYR,24,0,0,0,0
39,8480844,Grigori Denisenko,L,VGK,24,0,0,0,0
39,8478147,Bokondji Imama,L,PIT,28,0,0,0,0
39,8478881,Brett Seney,L,CHI,28,0,0,0,0
39,8483630,Pavol Regenda,L,ANA,25,0,0,0,0
39,8480836,Jonathan Gruden,C,,24,0,0,0,0
39,8484314,Jiri Smejkal,L,,28,0,0,0,0
39,8475780,Chris Wagner,R,COL,33,0,0,0,0
39,8479546,Oskar Steen,C,,26,0,0,0,0
39,8483597,Milos Kelemen,L,UTA,25,0,0,0,0
39,8481789,Tye Kartye,L,SEA,23,0,0,0,0
39,8484325,Waltteri Merela,C,TBL,26,0,0,0,0
39,8479421,Jacob Moverare,D,LAK,26,0,0,0,0
39,8481585,Egor Afanasyev,L,SJS,23,0,0,0,0
39,8479547,Matthew Phillips,R,,26,0,0,0,0
39,8479367,William Lockwood,R,FLA,26,0,0,0,0
39,8476915,Jujhar Khaira,L,,30,0,0,0,0
39,8481422,Jacob Lucchini,C,NSH,29,0,0,0,0
39,8480468,James Hamblin,L,EDM,25,0,0,0,0
39,8478051,Max Willman,C,NJD,29,0,0,0,0
39,8481556,John Beecher,C,BOS,23,0,0,0,0
39,8478078,Rourke Chartier,C,,28,0,0,0,0
40,8478402,Connor McDavid,C,EDM,27,82,50,101,151
40,8477492,Nathan MacKinnon,C,COL,29,82,60,89,149
40,8477956,David Pastrnak,R,BOS,28,82,62,74,136
40,8477934,Leon Draisaitl,C,EDM,29,82,52,84,136
40,8476453,Nikita Kucherov,R,TBL,31,82,44,88,132
40,8478864,Kirill Kaprizov,L,MIN,27,82,50,71,121
40,8476468,J.T. Miller,C,VAN,31,82,27,81,108
40,8479318,Auston Matthews,C,TOR,27,82,53,51,104
40,8478398,Kyle Connor,L,WPG,28,82,49,55,104
40,8480027,Jason Robertson,L,DAL,25,82,46,57,103
40,8478420,Mikko Rantanen,R,COL,28,82,38,64,102
40,8477493,Aleksander Barkov,C,FLA,29,82,34,68,102
40,8481559,Jack Hughes,C,NJD,23,82,34,67,101
40,8477939,William Nylander,R,TOR,28,82,42,55,97
40,8471675,Sidney Crosby,C,PIT,37,82,37,60,97
40,8478550,Artemi Panarin,L,NYR,33,82,26,71,97
40,8479314,Matthew Tkachuk,L,FLA,27,82,43,53,96
40,8477501,Valeri Nichushkin,R,COL,29,82,41,54,95
40,8480012,Elias Pettersson,C,VAN,26,82,34,61,95
40,8479323,Adam Fox,D,NYR,26,82,18,77,95
40,8477942,Kevin Fiala,L,LAK,28,82,36,58,94
40,8480036,Miro Heiskanen,D,DAL,25,82,22,72,94
40,8480002,Nico Hischier,C,NJD,25,82,42,51,93
40,8477933,Sam Reinhart,C,FLA,29,82,46,46,92
40,8478445,Mathew Barzal,C,NYI,27,82,21,69,90
40,8476389,Vincent Trocheck,C,NYR,31,82,31,58,89
40,8480801,Brady Tkachuk,L,OTT,25,82,29,60,89
40,8480023,Robert Thomas,C,STL,25,82,29,59,88
40,8474600,Roman Josi,D,NSH,34,82,25,62,87
40,8480830,Andrei Svechnikov,R,CAR,24,82,36,50,86
40,8481557,Matt Boldy,L,MIN,23,82,29,57,86
40,8476887,Filip Forsberg,L,NSH,30,82,41,44,85
40,8480800,Quinn Hughes,D,VAN,25,82,10,75,85
40,8477940,Nikolaj Ehlers,L,WPG,28,82,40,44,84
40,8478427,Sebastian Aho,C,CAR,27,82,36,48,84
40,8479407,Jesper Bratt,L,NJD,26,82,26,58,84
40,8482093,Seth Jarvis,C,CAR,22,82,37,45,82
40,8476460,Mark Scheifele,C,WPG,31,82,28,54,82
40,8477504,Josh Morrissey,D,WPG,29,82,21,61,82
40,8475184,Chris Kreider,L,NYR,33,82,54,27,81
40,8477500,Bo Horvat,C,NYI,29,82,41,40,81
40,8478449,Roope Hintz,C,DAL,28,82,37,44,81
40,8475913,Mark Stone,R,VGK,32,82,28,53,81
40,8478414,Timo Meier,R,NJD,28,82,42,38,80
40,8474564,Steven Stamkos,C,NSH,34,82,35,45,80
40,8478439,Travis Konecny,R,PHI,27,82,35,45,80
40,8479420,Tage Thompson,C,BUF,27,82,42,36,78
40,8477946,Dylan Larkin,C,DET,28,82,39,39,78
40,8477404,Jake Guentzel,C,TBL,30,82,39,38,77
40,8478440,Dylan Strome,C,WSH,27,82,29,48,77
40,8471215,Evgeni Malkin,C,PIT,38,82,24,53,77
40,8476853,Morgan Rielly,D,TOR,30,82,10,67,77
40,8478444,Brock Boeser,R,VAN,27,82,34,42,76
40,8480039,Martin Necas,C,CAR,25,82,32,44,76
40,8475166,John Tavares,C,TOR,34,82,30,46,76
40,8475765,Vladimir Tarasenko,R,DET,33,82,28,48,76
40,8475172,Nazem Kadri,C,CGY,34,82,30,45,75
40,8479325,Charlie McAvoy,D,BOS,27,82,23,52,75
40,8475784,Jeff Skinner,C,EDM,32,82,35,39,74
40,8477416,Oliver Bjorkstrand,R,SEA,29,82,32,42,74
40,8479343,Clayton Keller,R,UTA,26,82,30,44,74
40,8473512,Claude Giroux,R,OTT,36,82,28,46,74
40,8476459,Mika Zibanejad,C,NYR,31,82,22,52,74
40,8482116,Tim Stützle,C,OTT,22,82,32,41,73
40,8481528,Dylan Cozens,C,BUF,23,82,28,45,73
40,8478403,Jack Eichel,C,VGK,28,82,26,47,73
40,8474586,Jordan Eberle,R,SEA,34,82,25,48,73
40,8480208,Drake Batherson,R,OTT,26,82,22,51,73
40,8475692,Mats Zuccarello,R,MIN,37,82,20,53,73
40,8480069,Cale Makar,D,COL,26,82,16,57,73
40,8479385,Jordan Kyrou,C,STL,26,82,38,34,72
40,8479337,Alex DeBrincat,R,DET,27,82,38,34,72
40,8477496,Elias Lindholm,C,BOS,30,82,21,51,72
40,8481523,Kirby Dach,C,MTL,23,82,16,56,72
40,8477409,Carter Verhaeghe,C,FLA,29,82,36,35,71
40,8475810,Bryan Rust,R,PIT,32,82,34,37,71
40,8478975,Mason Marchment,L,DAL,29,82,33,38,71
40,8482665,Matty Beniers,C,SEA,22,82,31,40,71
40,8473419,Brad Marchand,L,BOS,36,82,27,44,71
40,8476454,Ryan Nugent-Hopkins,C,EDM,31,82,24,47,71
40,8476456,Jonathan Huberdeau,C,CGY,31,82,18,53,71
40,8480839,Rasmus Dahlin,D,BUF,24,82,17,54,71
40,8478498,Jake DeBrusk,L,VAN,28,82,44,26,70
40,8477955,Jared McCann,L,SEA,28,82,38,32,70
40,8471214,Alex Ovechkin,L,WSH,39,82,34,36,70
40,8476539,Jonathan Marchessault,R,NSH,34,82,33,37,70
40,8482078,Lucas Raymond,L,DET,22,82,32,38,70
40,8480803,Evan Bouchard,D,EDM,25,82,10,60,70
40,8475786,Zach Hyman,L,EDM,32,82,43,26,69
40,8477949,Alex Tuch,R,BUF,28,82,25,43,68
40,8475745,Charlie Coyle,C,BOS,32,82,24,44,68
40,8479339,Patrik Laine,L,CBJ,26,82,38,29,67
40,8474141,Patrick Kane,R,DET,36,82,29,38,67
40,8477402,Pavel Buchnevich,L,STL,29,82,23,44,67
40,8482740,Wyatt Johnston,C,DAL,21,82,33,32,65
40,8478047,Michael Bunting,L,PIT,29,82,27,38,65
40,8475754,Brock Nelson,C,NYI,33,82,26,39,65
40,8474150,Mikael Backlund,C,CGY,35,82,25,40,65
40,8478493,Joel Eriksson Ek,C,MIN,27,82,23,42,65
40,8478458,Jack Roslovic,C,CAR,27,82,19,46,65
40,8474578,Erik Karlsson,D,PIT,34,82,16,49,65
40,8475726,Tyler Toffoli,C,SJS,32,82,32,32,64
40,8482109,Alexis Lafrenière,L,NYR,23,82,31,33,64
40,8473994,Jamie Benn,L,DAL,35,82,26,38,64
40,8478010,Brayden Point,C,TBL,28,82,23,41,64
40,8475168,Matt Duchene,C,DAL,33,82,21,43,64
40,8477960,Adrian Kempe,R,LAK,28,82,21,43,64
40,8478460,Zach Werenski,D,CBJ,27,82,16,48,64
40,8477407,Anthony Duclair,L,NYI,29,82,32,31,63
40,8478397,Rasmus Andersson,D,CGY,28,82,10,53,63
40,8475794,Tyler Seguin,C,DAL,32,82,37,25,62
40,8478401,Pavel Zacha,C,BOS,27,82,28,34,62
40,8476927,Teddy Blueger,C,VAN,30,82,23,39,62
40,8476905,Chandler Stephenson,C,SEA,30,82,20,42,62
40,8478407,Vince Dunn,D,SEA,28,82,20,42,62
40,8480018,Nick Suzuki,C,MTL,25,82,19,43,62
40,8479425,Filip Hronek,D,VAN,27,82,15,47,62
40,8474679,Gustav Nyquist,C,NSH,35,82,14,48,62
40,8477951,Nick Schmaltz,C,UTA,28,82,19,42,61
40,8478438,Tommy Novak,C,NSH,27,82,18,43,61
40,8475158,Ryan O'Reilly,C,NSH,33,82,30,30,60
40,8478233,Andrew Mangiapane,L,WSH,28,82,22,38,60
40,8476346,Johnny Gaudreau,L,CBJ,31,82,18,42,60
40,8481711,Matias Maccelli,L,UTA,24,82,11,49,60
40,8480015,Owen Tippett,R,PHI,25,82,34,25,59
40,8480014,Gabriel Vilardi,C,WPG,25,82,31,28,59
40,8482097,Jack Quinn,R,BUF,23,82,24,35,59
40,8478873,Troy Terry,R,ANA,27,82,18,41,59
40,8476875,Mike Matheson,D,MTL,30,82,13,46,59
40,8478366,Frank Vatrano,R,ANA,30,82,36,22,58
40,8477935,Sam Bennett,C,FLA,28,82,28,30,58
40,8481540,Cole Caufield,R,MTL,23,82,26,32,58
40,8481596,Shane Pinto,C,OTT,24,82,26,32,58
40,8480865,Noah Dobson,D,NYI,24,82,15,43,58
40,8477346,MacKenzie Weegar,D,CGY,30,82,11,47,58
40,8476462,Dougie Hamilton,D,NJD,31,82,10,48,58
40,8477451,Ryan Hartman,R,MIN,30,82,27,30,57
40,8478042,Viktor Arvidsson,R,EDM,31,82,21,36,57
40,8477021,Alex Kerfoot,C,UTA,30,82,17,40,57
40,8478474,Lawson Crouse,L,UTA,27,82,35,21,56
40,8474641,Adam Henrique,C,EDM,34,82,25,31,56
40,8475167,Victor Hedman,D,TBL,34,82,11,45,56
40,8477447,Shea Theodore,D,VGK,29,82,6,50,56
40,8474102,David Perron,L,OTT,36,82,26,29,55
40,8476419,Jean-Gabriel Pageau,C,NYI,32,82,21,34,55
40,8477444,Andre Burakovsky,L,SEA,29,82,18,37,55
40,8479999,Casey Mittelstadt,C,COL,26,82,15,40,55
40,8476958,Jaccob Slavin,D,CAR,30,82,15,40,55
40,8479675,Trevor Moore,L,LAK,29,82,28,26,54
40,8475151,Kyle Palmieri,C,NYI,33,82,25,29,54
40,8478462,Nicolas Roy,C,VGK,27,82,23,31,54
40,8475287,Erik Haula,L,NJD,33,82,15,39,54
40,8481068,Yegor Sharangovich,C,CGY,26,82,32,21,53
40,8482699,Dylan Guenther,R,UTA,21,82,32,21,53
40,8483808,Andrei Kuzmenko,L,CGY,28,82,30,23,53
40,8476881,Tomas Hertl,C,VGK,31,82,24,29,53
40,8480078,Filip Chytil,C,NYR,25,82,23,30,53
40,8480849,Barrett Hayton,C,UTA,24,82,23,30,53
40,8477494,Jonathan Drouin,L,COL,29,82,15,38,53
40,8478055,Gustav Forsling,D,FLA,28,82,12,41,53
40,8478469,Thomas Chabot,D,OTT,27,82,12,41,53
40,8476432,Boone Jenner,C,CBJ,31,82,28,24,52
40,8476479,Phillip Danault,C,LAK,31,82,27,25,52
40,8479542,Brandon Hagel,L,TBL,26,82,20,32,52
40,8480798,Philipp Kurashev,C,CHI,25,82,20,32,52
40,8477986,Brandon Montour,D,SEA,30,82,18,34,52
40,8477456,J.T. Compher,L,DET,29,82,18,34,52
40,8475799,Nino Niederreiter,R,WPG,32,82,28,23,51
40,8480797,Joel Farabee,L,PHI,24,82,27,24,51
40,8475791,Taylor Hall,L,CHI,33,82,21,30,51
40,8473986,Alex Killorn,L,ANA,35,82,20,31,51
40,8474590,John Carlson,D,WSH,34,82,13,38,51
40,8478038,Devon Toews,D,COL,30,82,10,41,51
40,8474716,Jared Spurgeon,D,MIN,35,82,8,43,51
40,8480028,Morgan Frost,C,PHI,25,82,19,31,50
40,8482684,Luke Hughes,D,NJD,21,82,16,34,50
40,8477948,Travis Sanheim,D,PHI,28,82,13,37,50
40,8476461,Sean Couturier,C,PHI,32,82,11,39,50
40,8477476,Artturi Lehkonen,L,COL,29,82,29,20,49
40,8478046,Danton Heinen,L,VAN,29,82,25,24,49
40,8475793,Ryan Johansen,C,PHI,32,82,24,25,49
40,8477497,Sean Monahan,C,CBJ,30,82,23,26,49
40,8482149,Cole Perfetti,C,WPG,22,82,14,35,49
40,8471724,Kris Letang,D,PIT,37,82,12,37,49
40,8479410,Mikhail Sergachev,D,UTA,26,82,12,37,49
40,8475760,Nick Bjugstad,C,UTA,32,82,27,21,48
40,8475170,Brayden Schenn,C,STL,33,82,21,27,48
40,8478856,Conor Garland,R,VAN,28,82,19,29,48
40,8474149,Evgenii Dadonov,R,DAL,35,82,19,29,48
40,8475722,Jason Zucker,L,BUF,32,82,15,33,48
40,8471685,Anze Kopitar,C,LAK,37,82,13,35,48
40,8476826,Yanni Gourde,C,SEA,33,82,13,35,48
40,8475798,Mikael Granlund,C,SJS,32,82,8,40,48
40,8480064,Josh Norris,C,OTT,25,82,29,18,47
40,8477426,Nicholas Paul,L,TBL,29,82,26,21,47
40,8476483,Rickard Rakell,R,PIT,31,82,23,24,47
40,8476448,William Karlsson,C,VGK,31,82,22,25,47
40,8475191,Reilly Smith,R,NYR,33,82,22,25,47
40,8475763,Kevin Hayes,R,PIT,32,82,21,26,47
40,8477998,Warren Foegele,L,LAK,28,82,21,26,47
40,8479400,Pierre-Luc Dubois,L,WSH,26,82,21,26,47
40,8482159,Tyson Foerster,R,PHI,22,82,21,26,47
40,8482124,Quinton Byfield,R,LAK,22,82,19,28,47
40,8481656,Aliaksei Protas,C,WSH,23,82,16,31,47
40,8475753,Justin Faulk,D,STL,32,82,15,32,47
40,8477503,Max Domi,C,TOR,29,82,11,36,47
40,8481542,Moritz Seider,D,DET,23,82,8,39,47
40,8475169,Evander Kane,L,EDM,33,82,25,21,46
40,8482175,JJ Peterka,R,BUF,22,82,25,21,46
40,8482475,Yegor Chinakhov,R,CBJ,23,82,21,25,46
40,8479987,Morgan Geekie,C,BOS,26,82,20,26,46
40,8478542,Evan Rodrigues,C,FLA,31,82,19,27,46
40,8482113,Anton Lundell,C,FLA,23,82,17,29,46
40,8477964,Ivan Barbashev,C,VGK,29,82,14,32,46
40,8480188,Fabian Zetterlund,L,SJS,25,82,23,22,45
40,8479365,Trent Frederic,C,BOS,26,82,22,23,45
40,8482110,Dawson Mercer,C,NJD,23,82,21,24,45
40,8477953,Kasperi Kapanen,R,STL,28,82,18,27,45
40,8479345,Jakob Chychrun,D,WSH,26,82,11,34,45
40,8477932,Aaron Ekblad,D,FLA,28,82,9,36,45
40,8480434,Sean Durzi,D,UTA,26,82,9,36,45
40,8476979,Erik Gustafsson,D,DET,32,82,7,38,45
40,8476399,Blake Coleman,C,CGY,33,82,29,15,44
40,8478057,Dakota Joshua,C,VAN,28,82,23,21,44
40,8481535,Nils Hoglander,L,VAN,24,82,25,18,43
40,8482745,Mason McTavish,C,ANA,21,82,20,23,43
40,8477479,Tyler Bertuzzi,L,CHI,29,82,18,25,43
40,8480748,Kiefer Sherwood,L,VAN,29,82,18,25,43
40,8475149,Marcus Johansson,L,MIN,34,82,18,25,43
40,8482092,Ridly Greig,C,OTT,22,82,17,26,43
40,8476882,Teuvo Teravainen,L,CHI,30,82,15,28,43
40,8473563,Nicklas Backstrom,C,WSH,37,82,13,30,43
40,8475848,Brendan Gallagher,R,MTL,32,82,23,19,42
40,8476392,Adam Lowry,C,WPG,31,82,22,20,42
40,8470621,Corey Perry,R,EDM,39,82,18,24,42
40,8481032,Paul Cotter,C,NJD,25,82,18,24,42
40,8483515,Juraj Slafkovsky,L,MTL,20,82,13,29,42
40,8478396,Noah Hanifin,D,VGK,27,82,12,30,42
40,8476906,Shayne Gostisbehere,D,CAR,31,82,12,30,42
40,8480459,Pius Suter,C,VAN,28,82,12,30,42
40,8479992,Michael Rasmussen,C,DET,25,82,12,30,42
40,8482117,Lukas Reichel,L,CHI,22,82,10,32,42
40,8480145,Neal Pionk,D,WPG,29,82,9,33,42
40,8480336,Sean Walker,D,CAR,30,82,9,33,42
40,8474563,Drew Doughty,D,LAK,35,82,8,34,42
40,8476792,Torey Krug,D,STL,33,82,8,34,42
40,8480878,Nils Lundkvist,D,DAL,24,82,6,36,42
40,8479525,Ross Colton,C,COL,28,82,23,18,41
40,8481554,Kaapo Kakko,R,NYR,23,82,21,20,41
40,8481582,Nicholas Robertson,L,TOR,23,82,20,21,41
40,8476480,Vladislav Namestnikov,C,WPG,32,82,19,22,41
40,8480113,Alex Iafallo,L,WPG,31,82,14,27,41
40,8480829,Jesperi Kotkaniemi,C,CAR,24,82,13,28,41
40,8476854,Hampus Lindholm,D,BOS,30,82,3,38,41
40,8475714,Calle Jarnkrok,C,TOR,33,82,24,16,40
40,8476981,Josh Anderson,R,MTL,30,82,23,17,40
40,8471698,T.J. Oshie,R,WSH,38,82,22,18,40
40,8476474,Stefan Noesen,R,NJD,31,82,21,19,40
40,8476925,Colton Sissons,C,NSH,31,82,20,20,40
40,8481533,Trevor Zegras,C,ANA,23,82,18,22,40
40,8482667,William Eklund,L,SJS,22,82,18,22,40
40,8478115,Pierre Engvall,L,NYI,28,82,17,23,40
40,8478519,Anthony Cirelli,C,TBL,27,82,16,24,40
40,8481618,Alex Newhook,C,MTL,23,82,15,25,40
40,8478472,Mathieu Joseph,R,STL,27,82,15,25,40
40,8477429,Andrew Copp,C,DET,30,82,15,25,40
40,8480871,Adam Boqvist,D,FLA,24,82,15,25,40
40,8476458,Ryan Strome,C,ANA,31,82,11,29,40
40,8475764,Cam Fowler,D,ANA,33,82,8,32,40
40,8480817,K'Andre Miller,D,NYR,24,82,5,35,40
40,8482079,Marco Rossi,C,MIN,23,82,25,14,39
40,8480802,Ryan McLeod,C,BUF,25,82,17,22,39
40,8475314,Anders Lee,L,NYI,34,82,17,22,39
40,8473533,Jordan Staal,C,CAR,36,82,16,23,39
40,8477511,Anthony Mantha,R,CGY,30,82,15,24,39
40,8476885,Jacob Trouba,D,NYR,30,82,9,30,39
40,8476869,Brady Skjei,D,NSH,30,82,3,36,39
40,8481560,Arthur Kaliyev,R,LAK,23,82,21,17,38
40,8474189,Lars Eller,C,PIT,35,82,19,19,38
40,8476469,Joel Armia,R,MTL,31,82,19,19,38
40,8476329,Travis Boyd,C,MIN,31,82,17,21,38
40,8480185,Eetu Luostarinen,C,FLA,26,82,17,21,38
40,8478463,Anthony Beauvillier,L,PIT,27,82,14,24,38
40,8477495,Seth Jones,D,CHI,30,82,13,25,38
40,8482671,Owen Power,D,BUF,22,82,9,29,38
40,8481581,Thomas Harley,D,DAL,23,82,5,33,38
40,8480873,Rasmus Sandin,D,WSH,24,82,4,34,38
40,8482089,Jake Neighbours,L,STL,22,82,20,17,37
40,8484144,Connor Bedard,C,CHI,19,82,16,21,37
40,8482705,Cole Sillinger,C,CBJ,21,82,14,23,37
40,8476438,Brandon Saad,L,STL,32,82,14,23,37
40,8470613,Brent Burns,D,CAR,39,82,12,25,37
40,8477947,Sonny Milano,L,WSH,28,82,11,26,37
40,8473422,Nick Foligno,L,CHI,37,82,21,15,36
40,8481704,Juuso Parssinen,C,NSH,23,82,20,16,36
40,8480835,Jack Drury,C,CAR,24,82,19,17,36
40,8483431,Logan Cooley,C,UTA,20,82,18,18,36
40,8475193,Tomas Tatar,L,NJD,34,82,16,20,36
40,8481624,Ilya Mikheyev,R,CHI,30,82,16,20,36
40,8478891,Mason Appleton,C,WPG,28,82,13,23,36
40,8475220,Marcus Foligno,L,MIN,33,82,12,24,36
40,8482720,Matthew Knies,L,TOR,22,82,11,25,36
40,8481546,Cam York,D,PHI,23,82,7,29,36
40,8479976,Juuso Valimaki,D,UTA,26,82,6,30,36
40,8482125,Alexander Holtz,R,VGK,22,82,18,17,35
40,8477987,Ryan Donato,C,CHI,28,82,16,19,35
40,8483457,Lane Hutson,D,MTL,20,82,16,19,35
40,8477450,Jason Dickinson,C,CHI,29,82,12,23,35
40,8476960,Andreas Athanasiou,C,CHI,30,82,11,24,35
40,8478508,Yakov Trenin,C,MIN,27,82,25,9,34
40,8477952,Robby Fabbri,C,ANA,28,82,21,13,34
40,8480813,Joe Veleno,C,DET,24,82,15,19,34
40,8475218,Mattias Ekholm,D,EDM,34,82,11,23,34
40,8481604,Pavel Dorofeyev,L,VGK,24,82,20,13,33
40,8476880,Tom Wilson,R,WSH,30,82,19,14,33
40,8480893,Kirill Marchenko,R,CBJ,24,82,19,14,33
40,8480009,Eeli Tolvanen,R,SEA,25,82,18,15,33
40,8481186,Logan O'Connor,R,COL,28,82,15,18,33
40,8476873,Mark Jankowski,C,NSH,30,82,15,18,33
40,8477903,Garnet Hathaway,R,PHI,33,82,15,18,33
40,8476872,Scott Laughton,C,PHI,30,82,14,19,33
40,8475768,Jaden Schwartz,C,SEA,32,82,14,19,33
40,8476292,Ondrej Palat,L,NJD,33,82,13,20,33
40,8476897,Oskar Sundqvist,C,STL,30,82,13,20,33
40,8477989,Christian Dvorak,C,MTL,28,82,11,22,33
40,8478133,Jake Evans,C,MTL,28,82,11,22,33
40,8480806,Isac Lundestrom,C,ANA,25,82,8,25,33
40,8475171,Oliver Ekman-Larsson,D,TOR,33,82,6,27,33
40,8476892,Colton Parayko,D,STL,31,82,4,29,33
40,8476331,Dylan DeMelo,D,WPG,31,82,4,29,33
40,8476463,Jonas Brodin,D,MIN,31,82,3,30,33
40,8479414,Nathan Bastian,R,NJD,27,82,23,9,32
40,8482055,Drew O'Connor,L,PIT,26,82,18,14,32
40,8478109,Victor Olofsson,L,VGK,29,82,18,14,32
40,8479293,Brandon Tanev,L,SEA,33,82,15,17,32
40,8478413,Jordan Greenway,L,BUF,27,82,15,17,32
40,8478882,Vladislav Gavrikov,D,LAK,29,82,10,22,32
40,8477220,Nate Schmidt,D,FLA,33,82,9,23,32
40,8476467,Jamie Oleksiak,D,SEA,32,82,9,23,32
40,8477506,Ryan Pulock,D,NYI,30,82,4,28,32
40,8480068,Ryan Poehling,C,PHI,25,82,18,13,31
40,8482146,Luke Evangelista,R,NSH,22,82,18,13,31
40,8482259,Bobby McMann,C,TOR,28,82,18,13,31
40,8484166,Adam Fantilli,C,CBJ,20,82,15,16,31
40,8479996,Cody Glass,C,NSH,25,82,12,19,31
40,8482702,Logan Stankoven,C,DAL,21,82,12,19,31
40,8480074,Alexandre Texier,C,STL,25,82,10,21,31
40,8475200,Dmitry Orlov,D,CAR,33,82,9,22,31
40,8480220,Noah Cates,L,PHI,25,82,6,25,31
40,8475181,Nick Leddy,D,STL,33,82,6,25,31
40,8480807,Mattias Samuelsson,D,BUF,24,82,4,27,31
40,8482660,Kent Johnson,C,CBJ,22,82,3,28,31
40,8476902,Esa Lindell,D,DAL,30,82,2,29,31
40,8482077,Dylan Holloway,L,EDM,23,82,20,10,30
40,8475231,Casey Cizikas,C,NYI,33,82,16,14,30
40,8479368,Max Jones,L,BOS,26,82,16,14,30
40,8484145,Zach Benson,L,BUF,19,82,15,15,30
40,8479316,Luke Kunin,C,SJS,27,82,15,15,30
40,8481477,Nico Sturm,C,SJS,29,82,13,17,30
40,8477839,Conor Sheary,L,TBL,32,82,12,18,30
40,8481553,Bobby Brink,R,PHI,23,82,9,21,30
40,8483763,Maksymilian Szuber,D,UTA,22,82,9,21,30
40,8483505,Matthew Poitras,C,BOS,20,82,8,22,30
40,8481093,Rafael Harvey-Pinard,L,MTL,25,82,19,10,29
40,8476918,Jimmy Vesey,L,NYR,31,82,16,13,29
40,8484203,Bradly Nadeau,L,CAR,19,82,14,15,29
40,8475855,Jesper Fast,R,CAR,33,82,11,18,29
40,8476278,Colin Blackwell,C,DAL,31,82,10,19,29
40,8478911,Matt Roy,D,WSH,29,82,8,21,29
40,8481606,Jordan Spence,D,LAK,23,82,8,21,29
40,8474565,Alex Pietrangelo,D,VGK,34,82,6,23,29
40,8477435,Ryan Graves,D,PIT,29,82,5,24,29
40,8482142,Jamie Drysdale,D,PHI,22,82,5,24,29
40,8482105,Jake Sanderson,D,OTT,22,82,4,25,29
40,8480043,Timothy Liljegren,D,TOR,25,82,4,25,29
40,8477969,Marcus Pettersson,D,PIT,28,82,4,25,29
40,8478859,Niko Mikkola,D,FLA,28,82,4,25,29
40,8479941,Justin Danforth,R,CBJ,31,82,12,16,28
40,8479351,Sam Steel,C,DAL,26,82,11,17,28
40,8475343,Nic Dowd,C,WSH,34,82,10,18,28
40,8480003,Jesper Boqvist,C,FLA,26,82,10,18,28
40,8482666,Scott Morrow,D,CAR,22,82,9,19,28
40,8479591,Michael Eyssimont,C,TBL,28,82,8,20,28
40,8479369,Andrew Peeke,D,BOS,26,82,8,20,28
40,8475690,Chris Tanev,D,TOR,35,82,4,24,28
40,8478840,Will Borgen,D,SEA,28,82,3,25,28
40,8478507,John Marino,D,UTA,27,82,2,26,28
40,8480049,Dylan Samberg,D,WPG,25,82,0,28,28
40,8474053,Logan Couture,C,SJS,35,82,18,9,27
40,8474715,Cam Atkinson,R,TBL,35,82,16,11,27
40,8481522,Peyton Krebs,C,BUF,23,82,11,16,27
40,8476921,Jordan Martinook,L,CAR,32,82,10,17,27
40,8482624,Daniil Miromanov,D,CGY,27,82,7,20,27
40,8475455,Brenden Dillon,D,NJD,34,82,7,20,27
40,8482655,J.J. Moser,D,TBL,24,82,4,23,27
40,8476917,Adam Pelech,D,NYI,30,82,3,24,27
40,8475718,Justin Holl,D,DET,32,82,3,24,27
40,8481580,Connor McMichael,C,WSH,23,82,19,7,26
40,8479393,Noah Gregor,C,OTT,26,82,18,8,26
40,8478020,Michael Amadio,C,OTT,28,82,11,15,26
40,8476923,Damon Severson,D,CBJ,30,82,5,21,26
40,8477488,Brett Pesce,D,NJD,30,82,4,22,26
40,8481178,Egor Zamula,D,PHI,24,82,3,23,26
40,8478399,Jonas Siegenthaler,D,NJD,27,82,3,23,26
40,8482111,Justin Barron,D,MTL,23,82,15,10,25
40,8476889,Radek Faksa,C,STL,30,82,12,13,25
40,8478432,Christian Fischer,R,DET,27,82,12,13,25
40,8480281,Alexey Toropchenko,R,STL,25,82,12,13,25
40,8480144,David Kampf,C,TOR,29,82,11,14,25
40,8480789,Oliver Wahlstrom,R,NYI,24,82,10,15,25
40,8484153,Leo Carlsson,C,ANA,20,82,10,15,25
40,8480073,Erik Brannstrom,D,COL,25,82,10,15,25
40,8481481,Blake Lizotte,C,PIT,27,82,9,16,25
40,8477498,Darnell Nurse,D,EDM,29,82,8,17,25
40,8477015,Connor Brown,R,EDM,30,82,8,17,25
40,8482809,Jackson Blake,R,CAR,21,82,8,17,25
40,8473507,Jeff Petry,D,DET,37,82,6,19,25
40,8478851,Alexandre Carrier,D,NSH,28,82,6,19,25
40,8474090,Brendan Smith,D,DAL,35,82,4,21,25
40,8474673,TJ Brodie,D,CHI,34,82,3,22,25
40,8475279,Ben Chiarot,D,DET,33,82,3,22,25
40,8479998,Mikey Anderson,D,LAK,25,82,2,23,25
40,8481605,Jackson LaCombe,D,ANA,23,82,1,24,25
40,8476967,Brett Kulak,D,EDM,30,82,1,24,25
40,8475842,Sam Carrick,C,NYR,32,82,12,12,24
40,8482074,Connor Zary,C,CGY,23,82,12,12,24
40,8479291,Kevin Rooney,C,CGY,31,82,11,13,24
40,8481601,Simon Holmstrom,R,NYI,23,82,9,15,24
40,8477507,Nikita Zadorov,D,BOS,29,82,8,16,24
40,8477919,Frederick Gaudreau,C,MIN,31,82,8,16,24
40,8481567,Henry Thrun,D,SJS,23,82,8,16,24
40,8476312,Josh Manson,D,COL,33,82,6,18,24
40,8480035,Henri Jokiharju,D,BUF,25,82,5,19,24
40,8478500,Ivan Provorov,D,CBJ,27,82,4,20,24
40,8477425,Miles Wood,L,COL,29,82,15,8,23
40,8477353,Tyler Motte,C,DET,29,82,12,11,23
40,8480855,Jack McBain,C,UTA,24,82,9,14,23
40,8478569,Noel Acciari,C,PIT,33,82,9,14,23
40,8481524,Bowen Byram,D,BUF,23,82,9,14,23
40,8479371,Dante Fabbro,D,NSH,26,82,6,17,23
40,8479402,Jake Bean,D,CGY,26,82,6,17,23
40,8482122,Brock Faber,D,MIN,22,82,4,19,23
40,8476891,Matt Grzelcyk,D,PIT,30,82,3,20,23
40,8476525,Colin Miller,D,WPG,32,82,3,20,23
40,8478468,Jeremy Lauzon,D,NSH,27,82,2,21,23
40,8476879,Cody Ceci,D,EDM,31,82,1,22,23
40,8477845,Trevor van Riemsdyk,D,WSH,33,82,0,23,23
40,8482807,Ethan Del Mastro,D,CHI,21,82,9,13,22
40,8478211,Dryden Hunt,L,CGY,29,82,9,13,22
40,8478178,Darren Raddysh,D,TBL,28,82,8,14,22
40,8474574,Tyler Myers,D,VAN,34,82,5,17,22
40,8478013,Jake Walman,D,SJS,28,82,5,17,22
40,8477365,Connor Clifton,D,BUF,29,82,5,17,22
40,8481028,Martin Pospisil,C,CGY,25,82,5,17,22
40,8482245,Artem Zub,D,OTT,29,82,4,18,22
40,8480172,Jan Rutta,D,SJS,34,82,4,18,22
40,8479390,Taylor Raddysh,R,WSH,26,82,12,9,21
40,8482659,Josh Doan,R,UTA,22,82,12,9,21
40,8479661,Tanner Jeannot,L,LAK,27,82,10,11,21
40,8476374,Sean Kuraly,C,CBJ,31,82,10,11,21
40,8480448,Parker Kelly,L,COL,25,82,9,12,21
40,8482679,Matt Coronato,R,CGY,22,82,9,12,21
40,8479359,Beck Malenstyn,L,BUF,26,82,8,13,21
40,8481641,Joel Kiviranta,L,COL,28,82,8,13,21
40,8477392,Hudson Fasching,R,NYI,29,82,7,14,21
40,8480246,Nick Perbix,D,TBL,26,82,7,14,21
40,8481013,Jonatan Berggren,R,DET,24,82,6,15,21
40,8480950,Ilya Lyubushkin,D,DAL,30,82,6,15,21
40,8480860,Kevin Bahl,D,CGY,24,82,5,16,21
40,8476931,Jake McCabe,D,TOR,31,82,4,17,21
40,8477499,Rasmus Ristolainen,D,PHI,30,82,4,17,21
40,8476429,Scott Mayfield,D,NYI,32,82,3,18,21
40,8478450,Parker Wotherspoon,D,BOS,27,82,2,19,21
40,8476858,Phillip Di Giuseppe,L,VAN,31,82,12,8,20
40,8481517,Brett Leason,R,ANA,25,82,11,9,20
40,8482062,Cole Smith,L,NSH,29,82,11,9,20
40,8477369,Carson Soucy,D,VAN,30,82,9,11,20
40,8482141,Lukas Cormier,D,VGK,22,82,9,11,20
40,8476442,Matt Nieto,L,PIT,32,82,8,12,20
40,8480995,Pontus Holmberg,R,TOR,25,82,8,12,20
40,8477406,Mattias Janmark,C,EDM,32,82,8,12,20
40,8482101,Danil Gushchin,L,SJS,22,82,7,13,20
40,8479353,Brett Howden,C,VGK,26,82,6,14,20
40,8478136,Jake Middleton,D,MIN,28,82,5,15,20
40,8481568,Alex Vlasic,D,CHI,23,82,3,17,20
40,8483397,Marc McLaughlin,C,BOS,25,82,12,7,19
40,8480025,MacKenzie Entwistle,R,FLA,25,82,10,9,19
40,8483493,Frank Nazar,C,CHI,20,82,9,10,19
40,8477931,Tomas Nosek,L,FLA,32,82,7,12,19
40,8480990,Declan Chisholm,D,MIN,24,82,7,12,19
40,8479983,Mario Ferraro,D,SJS,26,82,6,13,19
40,8481699,Aku Raty,R,UTA,23,82,6,13,19
40,8476422,Mike Reilly,D,NYI,31,82,5,14,19
40,8480796,Martin Fehervary,D,WSH,25,82,2,17,19
40,8482166,Shakir Mukhamadullin,D,SJS,22,82,8,10,18
40,8481122,Simon Benoit,D,TOR,26,82,8,10,18
40,8482133,Thomas Bordeleau,C,SJS,22,82,5,13,18
40,8476457,Adam Larsson,D,SEA,32,82,5,13,18
40,8482153,Brendan Brisson,C,VGK,23,82,5,13,18
40,8478443,Brandon Carlo,D,BOS,28,82,3,15,18
40,8481708,Zac Jones,D,NYR,24,82,3,15,18
40,8483495,Simon Nemec,D,NJD,20,82,3,15,18
40,8484149,Gavin Brindley,C,CBJ,20,82,3,15,18
40,8474151,Ryan McDonagh,D,TBL,35,82,1,17,18
40,8475233,David Savard,D,MTL,34,82,1,17,18
40,8480021,Jack Studnicka,C,LAK,25,82,10,7,17
40,8479638,Justin Brazeau,R,BOS,26,82,10,7,17
40,8481014,Alexander Romanov,D,NYI,24,82,6,11,17
40,8483565,Nick Blankenburg,D,NSH,26,82,6,11,17
40,8484911,Collin Graf,R,SJS,22,82,6,11,17
40,8482470,Ilya Solovyov,D,CGY,24,82,5,12,17
40,8474013,Ian Cole,D,UTA,35,82,5,12,17
40,8482073,Braden Schneider,D,NYR,23,82,4,13,17
40,8482733,Logan Mailloux,D,MTL,31,82,4,13,17
40,8475188,Brayden McNabb,D,VGK,33,82,3,14,17
40,8480222,Sebastian Aho,D,PIT,28,82,3,14,17
40,8476624,Barclay Goodrow,C,SJS,31,82,3,14,17
40,8479398,Samuel Girard,D,COL,26,82,2,15,17
40,8478416,Erik Cernak,D,TBL,27,82,2,15,17
40,8477335,Kyle Burroughs,D,LAK,29,82,2,15,17
40,8480834,Ty Emberson,D,SJS,24,82,1,16,17
40,8475324,Nick Jensen,D,OTT,34,82,0,17,17
40,8479576,Vincent Desharnais,D,VAN,28,82,0,17,17
40,8482859,Zack Ostapchuk,C,OTT,21,82,7,9,16
40,8482762,Simon Edvinsson,D,DET,21,82,6,10,16
40,8479980,Nicolas Hague,D,VGK,26,82,5,11,16
40,8477034,Jaycob Megna,D,FLA,32,82,1,15,16
40,8476878,Zemgus Girgensons,L,TBL,30,82,8,7,15
40,8477508,Curtis Lazar,C,NJD,29,82,8,7,15
40,8473453,Trevor Lewis,C,LAK,37,82,7,8,15
40,8477938,Haydn Fleury,D,WPG,28,82,7,8,15
40,8478434,Keegan Kolesar,R,VGK,27,82,7,8,15
40,8480870,Bo Groulx,C,NYR,24,82,6,9,15
40,8483567,Georgii Merkulov,C,BOS,24,82,3,12,15
40,8482803,Olen Zellweger,D,ANA,21,82,3,12,15
40,8483490,Pavel Mintyukov,D,ANA,21,82,2,13,15
40,8470600,Ryan Suter,D,STL,39,82,2,13,15
40,8483466,Kevin Korchinski,D,CHI,20,82,2,13,15
40,8482155,Alex Laferriere,R,LAK,23,82,10,4,14
40,8480980,Connor Dewar,C,TOR,25,82,7,7,14
40,8479442,Troy Stecher,D,EDM,30,82,7,7,14
40,8482145,Mavrik Bourque,C,DAL,22,82,5,9,14
40,8482858,Ryker Evans,D,SEA,23,82,4,10,14
40,8475177,Calvin de Haan,D,COL,33,82,4,10,14
40,8483499,Liam Ohgren,L,MIN,20,82,3,11,14
40,8476372,Nick Seeler,D,PHI,31,82,3,11,14
40,8482087,Kaiden Guhle,D,MTL,22,82,1,13,14
40,8478874,Adam Gaudette,C,OTT,28,82,1,13,14
40,8476441,Joel Edmundson,D,LAK,31,82,0,14,14
40,8482749,Joshua Roy,R,MTL,21,82,7,6,13
40,8482712,Oskar Olausson,R,COL,22,82,7,6,13
40,8483482,Tristan Luneau,D,ANA,20,82,6,7,13
40,8482516,Matthew Kessel,D,STL,24,82,5,8,13
40,8477505,Alexander Wennberg,C,SJS,30,82,3,10,13
40,8475462,Radko Gudas,D,ANA,34,82,2,11,13
40,8480879,Jacob Bernard-Docker,D,OTT,24,82,2,11,13
40,8482118,Sam Colangelo,R,ANA,23,82,4,8,12
40,8476473,Connor Murphy,D,CHI,31,82,3,9,12
40,8483460,David Jiricek,D,CBJ,21,82,1,11,12
40,8482070,Mitchell Chaffee,R,TBL,26,82,5,6,11
40,8483468,Jiri Kulich,C,BUF,20,82,4,7,11
40,8475762,Derek Forbort,D,VAN,32,82,4,7,11
40,8474567,Zach Bogosian,D,MIN,34,82,3,8,11
40,8479324,Ryan Lindgren,D,NYR,26,82,2,9,11
40,8475790,Erik Gudbranson,D,CBJ,32,82,2,9,11
40,8483524,Shane Wright,C,SEA,20,82,7,3,10
40,8483445,Cutter Gauthier,L,ANA,20,82,4,6,10
40,8476822,Luke Glendening,C,TBL,35,82,7,2,9
40,8483471,Brad Lambert,C,WPG,31,82,6,3,9
40,8482787,Nikita Chibrikov,R,WPG,31,82,5,4,9
40,8474612,Travis Hamonic,D,OTT,34,82,2,5,7
40,8471677,Jack Johnson,D,CBJ,37,82,0,7,7
40,8483489,Fraser Minten,C,TOR,31,82,3,3,6
40,8482713,Mackie Samoskevich,R,FLA,22,82,1,5,6
40,8474062,Riley Nash,C,NYR,35,82,2,2,4
40,8483012,Logan Morrison,C,SEA,22,82,1,3,4
40,8470794,Joe Pavelski,C,,40,0,0,0,0
40,8481703,Valtteri Puustinen,R,PIT,25,0,0,0,0
40,8477950,Tony DeAngelo,D,,29,0,0,0,0
40,8481577,Philip Tomasino,C,NSH,23,0,0,0,0
40,8475197,Tyson Barrie,D,,33,0,0,0,0
40,8471218,Blake Wheeler,R,,38,0,0,0,0
40,8474157,Max Pacioretty,L,,36,0,0,0,0
40,8478466,Daniel Sprong,R,VAN,27,0,0,0,0
40,8475744,Evgeny Kuznetsov,C,,32,0,0,0,0
40,8481019,David Gustafsson,C,WPG,24,0,0,0,0
40,8475906,John Klingberg,D,,32,0,0,0,0
40,8479348,Kale Clague,D,BUF,26,0,0,0,0
40,8476952,Dominic Toninato,C,WPG,30,0,0,0,0
40,8473473,Milan Lucic,L,,36,0,0,0,0
40,8474037,James van Riemsdyk,L,,35,0,0,0,0
40,8474602,Justin Schultz,D,,34,0,0,0,0
40,8482222,Alexander Barabanov,L,,30,0,0,0,0
40,8479372,Josh Mahura,D,SEA,26,0,0,0,0
40,8479982,Conor Timmins,D,TOR,26,0,0,0,0
40,8474031,Kevin Shattenkirk,D,,35,0,0,0,0
40,8480008,Adam Ruzicka,C,,25,0,0,0,0
40,8481059,Scott Perunovich,D,STL,26,0,0,0,0
40,8480884,Calen Addison,D,,24,0,0,0,0
40,8476994,Vinnie Hinostroza,C,NSH,30,0,0,0,0
40,8478452,Caleb Jones,D,LAK,27,0,0,0,0
40,8480157,Calle Rosen,D,COL,30,0,0,0,0
40,8481609,Vladislav Kolyachonok,D,UTA,23,0,0,0,0
40,8479415,Michael McLeod,C,,26,0,0,0,0
40,8476919,Chris Tierney,C,,30,0,0,0,0
40,8479639,Dylan Coghlan,D,WPG,26,0,0,0,0
40,8478146,Matthew Highmore,C,OTT,28,0,0,0,0
40,8478970,Jalen Chatfield,D,CAR,28,0,0,0,0
40,8480205,Emil Bemstrom,C,PIT,25,0,0,0,0
40,8474884,Mike Hoffman,C,,35,0,0,0,0
40,8471274,Alex Goligoski,D,,39,0,0,0,0
40,8478104,Sammy Blais,L,,28,0,0,0,0
40,8474870,Tyler Johnson,C,,34,0,0,0,0
40,8476913,Devin Shore,C,MIN,30,0,0,0,0
40,8481598,Philip Broberg,D,EDM,23,0,0,0,0
40,8480058,Pierre-Olivier Joseph,D,STL,25,0,0,0,0
40,8480891,Michael Kesselring,D,UTA,24,0,0,0,0
40,8477979,Nicolas Aube-Kubel,R,BUF,28,0,0,0,0
40,8476871,Tanner Pearson,L,,32,0,0,0,0
40,8476393,Nick Cousins,C,,31,0,0,0,0
40,8479977,Kailer Yamamoto,R,,26,0,0,0,0
40,8479543,Michael Pezzetta,L,MTL,26,0,0,0,0
40,8477018,Ben Hutton,D,VGK,31,0,0,0,0
40,8480762,Eric Robinson,L,CAR,29,0,0,0,0
40,8474034,Pat Maroon,L,CHI,36,0,0,0,0
40,8481058,Jesse Ylönen,R,,25,0,0,0,0
40,8475179,Dmitry Kulikov,D,FLA,34,0,0,0,0
40,8481527,Kaedan Korczak,D,VGK,23,0,0,0,0
40,8473449,Kyle Okposo,R,,36,0,0,0,0
40,8482192,Isaak Phillips,D,CHI,23,0,0,0,0
40,8480727,Zach Whitecloud,D,VGK,28,0,0,0,0
40,8479346,Dillon Dube,C,,26,0,0,0,0
40,8480821,Filip Zadina,R,,25,0,0,0,0
40,8480001,Urho Vaakanainen,D,ANA,25,0,0,0,0
40,8470966,Mark Giordano,D,,41,0,0,0,0
40,8480853,Liam Foudy,C,,24,0,0,0,0
40,8475225,Craig Smith,C,CHI,35,0,0,0,0
40,8479972,Mason Shaw,C,WPG,26,0,0,0,0
40,8478451,Ethan Bear,D,WSH,27,0,0,0,0
40,8474040,Sam Gagner,C,,35,0,0,0,0
40,8480196,Jacob Bryson,D,BUF,27,0,0,0,0
40,8479984,Cal Foote,D,,26,0,0,0,0
40,8480011,Klim Kostin,C,SJS,25,0,0,0,0
40,8482176,Wyatt Kaiser,D,CHI,22,0,0,0,0
40,8476988,Matt Benning,D,SJS,30,0,0,0,0
40,8479370,Tyson Jost,C,CAR,26,0,0,0,0
40,8477464,Nic Petan,C,,29,0,0,0,0
40,8477380,Jonny Brodzinski,C,NYR,31,0,0,0,0
40,8480070,Ian Mitchell,D,BOS,25,0,0,0,0
40,8479315,Joey Anderson,R,CHI,26,0,0,0,0
40,8478099,Kevin Labanc,R,,29,0,0,0,0
40,8476874,Olli Maatta,D,DET,30,0,0,0,0
40,8475208,Brian Dumoulin,D,ANA,33,0,0,0,0
40,8478430,Oliver Kylington,D,,27,0,0,0,0
40,8479536,Axel Jonsson-Fjallby,L,WPG,26,0,0,0,0
40,8479671,Mathieu Olivier,R,CBJ,27,0,0,0,0
40,8471709,Marc-Edouard Vlasic,D,SJS,37,0,0,0,0
40,8479328,Julien Gauthier,R,NYI,27,0,0,0,0
40,8478421,A.J. Greer,L,FLA,28,0,0,0,0
40,8477573,Nathan Walker,L,STL,30,0,0,0,0
40,8481537,Nikita Okhotiuk,D,CGY,24,0,0,0,0
40,8474166,Alec Martinez,D,CHI,37,0,0,0,0
40,8470610,Zach Parise,L,,40,0,0,0,0
40,8477478,William Carrier,L,CAR,30,0,0,0,0
40,8479344,Jesse Puljujarvi,R,PIT,26,0,0,0,0
40,8480887,Jordan Harris,D,MTL,24,0,0,0,0
40,8478502,Dennis Gilbert,D,BUF,28,0,0,0,0
40,8482730,Brandt Clarke,D,LAK,21,0,0,0,0
40,8480355,Mark Kastelic,C,BOS,25,0,0,0,0
40,8475750,Jon Merrill,D,MIN,32,0,0,0,0
40,8475164,Jakob Silfverberg,R,,34,0,0,0,0
40,8477944,Jakub Vrana,L,,28,0,0,0,0
40,8479439,Jacob MacDonald,D,COL,31,0,0,0,0
40,8474568,Luke Schenn,D,NSH,35,0,0,0,0
40,8478454,Noah Juulsen,D,VAN,27,0,0,0,0
40,8475752,Tyler Pitlick,C,,33,0,0,0,0
40,8482148,Hendrix Lapierre,C,WSH,22,0,0,0,0
40,8481167,Brayden Pachal,D,CGY,25,0,0,0,0
40,8478043,Sam Lafferty,C,BUF,29,0,0,0,0
40,8479321,Lucas Johansen,D,,27,0,0,0,0
40,8471699,Andrew Cogliano,C,,37,0,0,0,0
40,8481521,Ronnie Attard,D,PHI,25,0,0,0,0
40,8481161,Jake Christiansen,D,CBJ,25,0,0,0,0
40,8479458,Nikita Zaitsev,D,,33,0,0,0,0
40,8479619,Michael Carcone,L,UTA,28,0,0,0,0
40,8479026,Philippe Myers,D,TOR,27,0,0,0,0
40,8477330,Dominik Kubalik,L,,29,0,0,0,0
40,8481617,Vasily Podkolzin,R,VAN,23,0,0,0,0
40,8481701,Santeri Hatakka,D,NJD,23,0,0,0,0
40,8479514,Rem Pitlick,C,,27,0,0,0,0
40,8477446,Michael McCarron,R,NSH,29,0,0,0,0
40,8470604,Jeff Carter,C,,39,0,0,0,0
40,8482241,Radim Zohorna,L,,28,0,0,0,0
40,8480289,Morgan Barron,C,WPG,26,0,0,0,0
40,8479379,Givani Smith,R,SJS,26,0,0,0,0
40,8480216,Jacob Peterson,C,,25,0,0,0,0
40,8477851,Jordan Oesterle,D,BOS,32,0,0,0,0
40,8484258,Sam Malinski,D,COL,26,0,0,0,0
40,8478904,Steven Lorentz,C,,28,0,0,0,0
40,8482095,Tyler Kleven,D,OTT,22,0,0,0,0
40,8480848,Ty Dellandrea,C,SJS,24,0,0,0,0
40,8476884,Derrick Pouliot,D,,30,0,0,0,0
40,8479336,Carl Grundstrom,R,SJS,27,0,0,0,0
40,8482964,Arber Xhekaj,D,MTL,23,0,0,0,0
40,8471686,Marc Staal,D,,37,0,0,0,0
40,8477887,Patrick Brown,C,BOS,32,0,0,0,0
40,8478495,Denis Gurianov,R,,27,0,0,0,0
40,8473504,Cal Clutterbuck,R,,37,0,0,0,0
40,8481550,Adam Beckman,L,NJD,23,0,0,0,0
40,8480845,Rasmus Kupari,C,WPG,24,0,0,0,0
40,8474009,Nick Bonino,C,,36,0,0,0,0
40,8478585,Derek Ryan,C,EDM,38,0,0,0,0
40,8477962,Brendan Lemieux,L,CAR,28,0,0,0,0
40,8482861,Vincent Iorio,D,WSH,22,0,0,0,0
40,8479378,Logan Stanley,D,WPG,26,0,0,0,0
40,8473446,Erik Johnson,D,PHI,36,0,0,0,0
40,8481743,Marc Del Gaizo,D,NSH,25,0,0,0,0
40,8477384,Josh Brown,D,EDM,30,0,0,0,0
40,8482165,Yan Kuznetsov,D,CGY,22,0,0,0,0
40,8478424,Jansen Harkins,C,ANA,27,0,0,0,0
40,8482144,Jack Thompson,D,SJS,22,0,0,0,0
40,8478512,Austin Czarnik,C,,32,0,0,0,0
40,8477527,Ross Johnston,L,ANA,30,0,0,0,0
40,8479383,Boris Katchouk,L,,26,0,0,0,0
40,8482094,Daemon Hunt,D,MIN,22,0,0,0,0
40,8481719,Maxwell Crozier,D,TBL,24,0,0,0,0
40,8480192,Johnathan Kovacevic,D,NJD,27,0,0,0,0
40,8479376,Victor Mete,D,,26,0,0,0,0
40,8482511,Mason Lohrei,D,BOS,23,0,0,0,0
40,8475825,Jani Hakanpää,D,,32,0,0,0,0
40,8478021,William Lagesson,D,DET,28,0,0,0,0
40,8475795,Dylan McIlrath,D,WSH,32,0,0,0,0
40,8477846,Ryan Carpenter,C,,33,0,0,0,0
40,8481056,Spencer Stastney,D,NSH,24,0,0,0,0
40,8481564,Ryan Johnson,D,BUF,23,0,0,0,0
40,8478017,Mark Friedman,D,VAN,29,0,0,0,0
40,8479320,Max Lajoie,D,SEA,27,0,0,0,0
40,8480075,Cameron Crotty,D,MIN,25,0,0,0,0
40,8484287,Cole McWard,D,VAN,23,0,0,0,0
40,8484254,Akito Hirose,D,VAN,25,0,0,0,0
40,8483407,Brandon Scanlin,D,NYR,25,0,0,0,0
40,8480274,Philip Kemp,D,EDM,25,0,0,0,0
40,8479522,Hardy Haman Aktell,D,WSH,26,0,0,0,0
40,8480007,Jonas Rondbjerg,R,VGK,25,0,0,0,0
40,8477454,Adam Erne,L,,29,0,0,0,0
40,8481679,Maxence Guenette,D,OTT,23,0,0,0,0
40,8480441,Trey Fix-Wolansky,R,CBJ,25,0,0,0,0
40,8483546,Marshall Rifai,D,TOR,26,0,0,0,0
40,8480084,Nick DeSimone,D,NJD,30,0,0,0,0
40,8481030,Jack St. Ivany,D,PIT,25,0,0,0,0
40,8481592,Jakob Pelletier,L,CGY,23,0,0,0,0
40,8478011,Louie Belpedio,D,PHI,28,0,0,0,0
40,8477930,Pierre-Edouard Bellemare,L,,39,0,0,0,0
40,8484321,Nikolas Matinpalo,D,OTT,26,0,0,0,0
40,8482067,Connor Mackey,D,NYR,28,0,0,0,0
40,8481806,Louis Crevier,D,CHI,23,0,0,0,0
40,8484326,Patrik Koch,D,UTA,28,0,0,0,0
40,8477971,Andreas Englund,D,LAK,28,0,0,0,0
40,8481751,Lukas Rousek,R,BUF,25,0,0,0,0
40,8481006,Tyler Tucker,D,STL,24,0,0,0,0
40,8476867,Brendan Gaunce,C,MIN,30,0,0,0,0
40,8479520,Brandon Duhaime,R,WSH,27,0,0,0,0
40,8477073,Kurtis MacDermid,L,NJD,30,0,0,0,0
40,8480874,Adam Ginning,D,PHI,24,0,0,0,0
40,8477473,Justin Bailey,R,SJS,29,0,0,0,0
40,8479066,Ryan Lomberg,L,CGY,30,0,0,0,0
40,8477070,Liam O'Brien,C,UTA,30,0,0,0,0
40,8474618,Marco Scandella,D,,34,0,0,0,0
40,8475797,Jarred Tinordi,D,,32,0,0,0,0
40,8481441,Joe Snively,C,DET,28,0,0,0,0
40,8477244,Chad Ruhwedel,D,NYR,34,0,0,0,0
40,8479772,Zack MacEwen,R,OTT,28,0,0,0,0
40,8481147,Reese Johnson,C,MIN,26,0,0,0,0
40,8481043,Cole Koepke,L,BOS,26,0,0,0,0
40,8483619,Filip Roos,D,OTT,25,0,0,0,0
40,8481541,Samuel Bolduc,D,NYI,24,0,0,0,0
40,8477810,Joel Hanley,D,CGY,33,0,0,0,0
40,8476907,Mackenzie MacEachern,L,,30,0,0,0,0
40,8482652,Walker Duehr,R,CGY,27,0,0,0,0
40,8477126,Jayson Megna,C,,34,0,0,0,0
40,8483398,Declan Carlile,D,TBL,31,0,0,0,0
40,8482929,Emil Lilleberg,D,TBL,23,0,0,0,0
40,8480880,Jakub Lauko,C,MIN,24,0,0,0,0
40,8480245,Olle Lycksell,R,PHI,25,0,0,0,0
40,8480252,Cole Guttman,C,CHI,25,0,0,0,0
40,8477467,Gustav Olofsson,D,SEA,30,0,0,0,0
40,8479968,Vinni Lettieri,C,BOS,29,0,0,0,0
40,8478400,Colin White,C,,27,0,0,0,0
40,8475755,Alexander Petrovic,D,DAL,32,0,0,0,0
40,8481812,Nikolai Knyzhov,D,,27,0,0,0,0
40,8481593,Jayden Struble,D,MTL,23,0,0,0,0
40,8481532,Alex Turcotte,C,LAK,23,0,0,0,0
40,8482126,Emil Andrae,D,PHI,31,0,0,0,0
40,8479944,Zach Aston-Reese,C,VGK,30,0,0,0,0
40,8471817,Ryan Reaves,R,TOR,37,0,0,0,0
40,8481206,John Ludvig,D,PIT,24,0,0,0,0
40,8481599,Victor Soderstrom,D,UTA,23,0,0,0,0
40,8480292,Carson Meyer,R,ANA,27,0,0,0,0
40,8482496,Nils Aman,C,VAN,24,0,0,0,0
40,8479718,Alex Barré-Boulet,C,MTL,27,0,0,0,0
40,8479994,Jaret Anderson-Dolan,C,WPG,25,0,0,0,0
40,8480184,Gustav Lindstrom,D,,26,0,0,0,0
40,8480890,Jan Jenik,R,OTT,24,0,0,0,0
40,8478067,Oskar Lindblom,L,,28,0,0,0,0
40,8476934,Brock McGinn,L,ANA,30,0,0,0,0
40,8479985,Cale Fleury,D,SEA,26,0,0,0,0
40,8484304,Uvis Balinskis,D,FLA,28,0,0,0,0
40,8479981,Jonah Gadjovich,L,FLA,26,0,0,0,0
40,8481716,Dmitri Voronkov,L,CBJ,24,0,0,0,0
40,8474709,Matt Martin,L,,35,0,0,0,0
40,8482634,Alex Steeves,C,TOR,25,0,0,0,0
40,8480823,Alexander Alexeyev,D,WSH,25,0,0,0,0
40,8477541,Dakota Mermis,D,TOR,30,0,0,0,0
40,8483491,Ivan Miroshnichenko,L,WSH,20,0,0,0,0
40,8478477,Mitchell Stephens,C,SEA,27,0,0,0,0
40,8481543,Nikita Alexandrov,C,STL,24,0,0,0,0
40,8479423,Alex Nylander,L,,26,0,0,0,0
40,8482451,Mikael Pyyhtia,L,CBJ,23,0,0,0,0
40,8478831,Kevin Stenlund,C,UTA,28,0,0,0,0
40,8480306,Grant Hutton,D,NYI,29,0,0,0,0
40,8478028,Fredrik Olofsson,L,,28,0,0,0,0
40,8477462,Robert Hagg,D,VGK,29,0,0,0,0
40,8477320,Anton Blidh,L,NYR,29,0,0,0,0
40,8482157,Will Cuylle,L,NYR,22,0,0,0,0
40,8482737,Zack Bolduc,C,STL,21,0,0,0,0
40,8481239,Samuel Fagemo,L,,24,0,0,0,0
40,8481600,Tobias Bjornfot,D,FLA,23,0,0,0,0
40,8478409,Anthony Richard,C,PHI,28,0,0,0,0
40,8474145,Robert Bortuzzo,D,,35,0,0,0,0
40,8475958,Michael Sgarbossa,C,WSH,32,0,0,0,0
40,8479986,Kole Lind,R,DAL,26,0,0,0,0
40,8479249,Andrew Poturalski,C,SJS,30,0,0,0,0
40,8479362,Riley Tufte,L,BOS,26,0,0,0,0
40,8479991,Jake Leschyshyn,C,NYR,25,0,0,0,0
40,8479587,Rhett Gardner,C,PHI,28,0,0,0,0
40,8482744,James Malatesta,L,CBJ,21,0,0,0,0
40,8478854,Ryan Shea,D,PIT,27,0,0,0,0
40,8481591,Sam Poulin,R,,23,0,0,0,0
40,8483512,Matt Savoie,C,EDM,20,0,0,0,0
40,8482102,Vasily Ponomarev,C,PIT,22,0,0,0,0
40,8482162,Roby Jarventie,L,EDM,22,0,0,0,0
40,8481016,Ruslan Iskhakov,C,,24,0,0,0,0
40,8482172,Landon Slaggert,L,CHI,22,0,0,0,0
40,8482747,Brennan Othmann,L,NYR,21,0,0,0,0
40,8480031,Maxime Comtois,L,,25,0,0,0,0
40,8480226,Marián Studenic,R,,26,0,0,0,0
40,8478408,Travis Dermott,D,,28,0,0,0,0
40,8481518,Nolan Foote,L,NJD,24,0,0,0,0
40,8479419,Brett Murray,L,BUF,26,0,0,0,0
40,8482088,Justin Sourdif,R,FLA,22,0,0,0,0
40,8482201,Gage Goncalves,C,TBL,23,0,0,0,0
40,8481578,Graeme Clarke,R,MIN,23,0,0,0,0
40,8482177,Marat Khusnutdinov,C,MIN,22,0,0,0,0
40,8481754,Nikita Nesterenko,C,ANA,23,0,0,0,0
40,8483531,Brian Halonen,L,NJD,25,0,0,0,0
40,8483920,Pierrick Dube,R,WSH,23,0,0,0,0
40,8480851,Akil Thomas,C,LAK,24,0,0,0,0
40,8475235,Nicolas Deslauriers,L,PHI,33,0,0,0,0
40,8482476,Emil Heineman,L,MTL,23,0,0,0,0
40,8477149,Scott Sabourin,R,SJS,32,0,0,0,0
40,8483549,Lucas Condotta,L,MTL,27,0,0,0,0
40,8482765,Isak Rosen,R,BUF,21,0,0,0,0
40,8481237,Kyle MacLean,C,NYI,25,0,0,0,0
40,8481024,Linus Karlsson,C,VAN,25,0,0,0,0
40,8481690,Tyler Angle,C,,24,0,0,0,0
40,8483570,Ben Meyers,C,SEA,26,0,0,0,0
40,8481655,Cole Schwindt,R,CGY,23,0,0,0,0
40,8481462,Mason Morelli,L,VGK,28,0,0,0,0
40,8483401,Marc Johnstone,R,PIT,28,0,0,0,0
40,8478956,Samuel Laberge,L,NJD,27,0,0,0,0
40,8479533,Joona Koppanen,L,,26,0,0,0,0
40,8482197,Adam Raska,R,MIN,23,0,0,0,0
40,8482250,Callahan Burke,C,VGK,27,0,0,0,0
40,8482784,Zach Dean,C,STL,21,0,0,0,0
40,8484255,Jason Polin,R,COL,25,0,0,0,0
40,8481077,John Leonard,L,,26,0,0,0,0
40,8481534,Raphael Lavoie,C,EDM,24,0,0,0,0
40,8483609,Adam Klapka,R,CGY,24,0,0,0,0
40,8482751,Ryan Winterton,C,SEA,21,0,0,0,0
40,8480267,Sammy Walker,C,MIN,25,0,0,0,0
40,8475766,Austin Watson,L,,32,0,0,0,0
40,8482460,Matt Rempe,C,NYR,22,0,0,0,0
40,8481065,Angus Crookshank,L,OTT,25,0,0,0,0
40,8481070,Hugh McGing,L,,26,0,0,0,0
40,8476323,Max McCormick,L,SEA,32,0,0,0,0
40,8483395,Arshdeep Bains,L,VAN,23,0,0,0,0
40,8484259,Ondrej Pavel,C,COL,31,0,0,0,0
40,8483432,Luca Del Bel Belluz,C,CBJ,31,0,0,0,0
40,8483045,Cameron Butler,R,CBJ,31,0,0,0,0
40,8482061,Brandon Biro,L,SEA,26,0,0,0,0
40,8477401,John Hayden,C,SEA,29,0,0,0,0
40,8475278,Byron Froese,C,,33,0,0,0,0
40,8478446,Glenn Gawdin,C,LAK,27,0,0,0,0
40,8477993,Justin Kirkland,C,CGY,28,0,0,0,0
40,8482147,Jean-Luc Foudy,C,COL,22,0,0,0,0
40,8480032,Shane Bowers,C,NJD,25,0,0,0,0
40,8479330,Brandon Gignac,C,MTL,27,0,0,0,0
40,8480776,Sheldon Rempal,R,,29,0,0,0,0
40,8475413,Justin Dowling,C,NJD,34,0,0,0,0
40,8481726,Adam Edstrom,C,NYR,24,0,0,0,0
40,8480844,Grigori Denisenko,L,VGK,24,0,0,0,0
40,8478147,Bokondji Imama,L,PIT,28,0,0,0,0
40,8478881,Brett Seney,L,CHI,28,0,0,0,0
40,8483630,Pavol Regenda,L,ANA,25,0,0,0,0
40,8480836,Jonathan Gruden,C,,24,0,0,0,0
40,8484314,Jiri Smejkal,L,,28,0,0,0,0
40,8475780,Chris Wagner,R,COL,33,0,0,0,0
40,8479546,Oskar Steen,C,,26,0,0,0,0
40,8483597,Milos Kelemen,L,UTA,25,0,0,0,0
40,8481789,Tye Kartye,L,SEA,23,0,0,0,0
40,8484325,Waltteri Merela,C,TBL,26,0,0,0,0
40,8479421,Jacob Moverare,D,LAK,26,0,0,0,0
40,8481585,Egor Afanasyev,L,SJS,23,0,0,0,0
40,8479547,Matthew Phillips,R,,26,0,0,0,0
40,8479367,William Lockwood,R,FLA,26,0,0,0,0
40,8476915,Jujhar Khaira,L,,30,0,0,0,0
40,8481422,Jacob Lucchini,C,NSH,29,0,0,0,0
40,8480468,James Hamblin,L,EDM,25,0,0,0,0
40,8478051,Max Willman,C,NJD,29,0,0,0,0
40,8481556,John Beecher,C,BOS,23,0,0,0,0
40,8478078,Rourke Chartier,C,,28,0,0,0,0
41,8477492,Nathan MacKinnon,C,COL,29,82,53,78,131
41,8476453,Nikita Kucherov,R,TBL,31,82,44,86,130
41,8481559,Jack Hughes,C,NJD,23,82,46,76,122
41,8478864,Kirill Kaprizov,L,MIN,27,82,55,65,120
41,8478402,Connor McDavid,C,EDM,27,82,38,78,116
41,8478550,Artemi Panarin,L,NYR,33,82,36,79,115
41,8479318,Auston Matthews,C,TOR,27,82,58,54,112
41,8482116,Tim Stützle,C,OTT,22,82,38,71,109
41,8480023,Robert Thomas,C,STL,25,82,32,77,109
41,8477956,David Pastrnak,R,BOS,28,82,47,58,105
41,8478420,Mikko Rantanen,R,COL,28,82,47,57,104
41,8480012,Elias Pettersson,C,VAN,26,82,41,63,104
41,8479314,Matthew Tkachuk,L,FLA,27,82,33,71,104
41,8477939,William Nylander,R,TOR,28,82,42,61,103
41,8477946,Dylan Larkin,C,DET,28,82,52,48,100
41,8477934,Leon Draisaitl,C,EDM,29,82,37,61,98
41,8475692,Mats Zuccarello,R,MIN,37,82,32,64,96
41,8477501,Valeri Nichushkin,R,COL,29,82,54,41,95
41,8477409,Carter Verhaeghe,C,FLA,29,82,47,46,93
41,8481557,Matt Boldy,L,MIN,23,82,36,57,93
41,8476468,J.T. Miller,C,VAN,31,82,34,59,93
41,8478427,Sebastian Aho,C,CAR,27,82,40,51,91
41,8476887,Filip Forsberg,L,NSH,30,82,43,47,90
41,8478449,Roope Hintz,C,DAL,28,82,43,47,90
41,8478439,Travis Konecny,R,PHI,27,82,37,53,90
41,8480036,Miro Heiskanen,D,DAL,25,82,16,73,89
41,8477404,Jake Guentzel,C,TBL,30,82,42,46,88
41,8480801,Brady Tkachuk,L,OTT,25,82,41,47,88
41,8480027,Jason Robertson,L,DAL,25,82,30,58,88
41,8471675,Sidney Crosby,C,PIT,37,82,29,59,88
41,8480069,Cale Makar,D,COL,26,82,22,66,88
41,8477949,Alex Tuch,R,BUF,28,82,29,58,87
41,8477493,Aleksander Barkov,C,FLA,29,82,30,56,86
41,8478398,Kyle Connor,L,WPG,28,82,34,51,85
41,8480002,Nico Hischier,C,NJD,25,82,29,55,84
41,8482093,Seth Jarvis,C,CAR,22,82,39,44,83
41,8471215,Evgeni Malkin,C,PIT,38,82,29,54,83
41,8477951,Nick Schmaltz,C,UTA,28,82,36,46,82
41,8478403,Jack Eichel,C,VGK,28,82,45,36,81
41,8474564,Steven Stamkos,C,NSH,34,82,34,47,81
41,8482078,Lucas Raymond,L,DET,22,82,28,53,81
41,8479323,Adam Fox,D,NYR,26,82,20,61,81
41,8474600,Roman Josi,D,NSH,34,82,18,63,81
41,8476389,Vincent Trocheck,C,NYR,31,82,34,46,80
41,8476459,Mika Zibanejad,C,NYR,31,82,27,52,79
41,8476853,Morgan Rielly,D,TOR,30,82,10,69,79
41,8479343,Clayton Keller,R,UTA,26,82,42,36,78
41,8479385,Jordan Kyrou,C,STL,26,82,39,39,78
41,8479420,Tage Thompson,C,BUF,27,82,36,42,78
41,8478445,Mathew Barzal,C,NYI,27,82,14,64,78
41,8476346,Johnny Gaudreau,L,CBJ,31,82,23,54,77
41,8475913,Mark Stone,R,VGK,32,82,20,57,77
41,8475754,Brock Nelson,C,NYI,33,82,40,35,75
41,8475166,John Tavares,C,TOR,34,82,37,38,75
41,8478042,Viktor Arvidsson,R,EDM,31,82,32,43,75
41,8479407,Jesper Bratt,L,NJD,26,82,25,50,75
41,8477500,Bo Horvat,C,NYI,29,82,41,33,74
41,8476539,Jonathan Marchessault,R,NSH,34,82,32,42,74
41,8473419,Brad Marchand,L,BOS,36,82,31,43,74
41,8477940,Nikolaj Ehlers,L,WPG,28,82,29,45,74
41,8480800,Quinn Hughes,D,VAN,25,82,11,63,74
41,8477933,Sam Reinhart,C,FLA,29,82,35,38,73
41,8477476,Artturi Lehkonen,L,COL,29,82,32,41,73
41,8475170,Brayden Schenn,C,STL,33,82,29,44,73
41,8475798,Mikael Granlund,C,SJS,32,82,17,56,73
41,8481540,Cole Caufield,R,MTL,23,82,39,33,72
41,8478493,Joel Eriksson Ek,C,MIN,27,82,31,41,72
41,8478010,Brayden Point,C,TBL,28,82,31,41,72
41,8475184,Chris Kreider,L,NYR,33,82,46,25,71
41,8478444,Brock Boeser,R,VAN,27,82,34,37,71
41,8477955,Jared McCann,L,SEA,28,82,32,39,71
41,8476460,Mark Scheifele,C,WPG,31,82,29,42,71
41,8477402,Pavel Buchnevich,L,STL,29,82,28,43,71
41,8476454,Ryan Nugent-Hopkins,C,EDM,31,82,18,53,71
41,8477504,Josh Morrissey,D,WPG,29,82,15,56,71
41,8481542,Moritz Seider,D,DET,23,82,10,61,71
41,8477960,Adrian Kempe,R,LAK,28,82,37,33,70
41,8471214,Alex Ovechkin,L,WSH,39,82,36,34,70
41,8473512,Claude Giroux,R,OTT,36,82,20,50,70
41,8478460,Zach Werenski,D,CBJ,27,82,19,51,70
41,8481528,Dylan Cozens,C,BUF,23,82,28,41,69
41,8477942,Kevin Fiala,L,LAK,28,82,18,51,69
41,8475151,Kyle Palmieri,C,NYI,33,82,37,31,68
41,8479337,Alex DeBrincat,R,DET,27,82,30,38,68
41,8480830,Andrei Svechnikov,R,CAR,24,82,25,43,68
41,8481533,Trevor Zegras,C,ANA,23,82,22,45,67
41,8476905,Chandler Stephenson,C,SEA,30,82,21,46,67
41,8477451,Ryan Hartman,R,MIN,30,82,20,47,67
41,8474578,Erik Karlsson,D,PIT,34,82,14,53,67
41,8478038,Devon Toews,D,COL,30,82,13,54,67
41,8471685,Anze Kopitar,C,LAK,37,82,25,40,65
41,8477986,Brandon Montour,D,SEA,30,82,18,47,65
41,8480015,Owen Tippett,R,PHI,25,82,32,32,64
41,8475810,Bryan Rust,R,PIT,32,82,30,34,64
41,8475784,Jeff Skinner,C,EDM,32,82,27,37,64
41,8476448,William Karlsson,C,VGK,31,82,27,37,64
41,8478873,Troy Terry,R,ANA,27,82,26,38,64
41,8480208,Drake Batherson,R,OTT,26,82,17,47,64
41,8480865,Noah Dobson,D,NYI,24,82,12,52,64
41,8477407,Anthony Duclair,L,NYI,29,82,30,33,63
41,8482745,Mason McTavish,C,ANA,21,82,28,35,63
41,8476483,Rickard Rakell,R,PIT,31,82,27,36,63
41,8478396,Noah Hanifin,D,VGK,27,82,13,50,63
41,8481523,Kirby Dach,C,MTL,23,82,9,54,63
41,8478414,Timo Meier,R,NJD,28,82,33,29,62
41,8475167,Victor Hedman,D,TBL,34,82,14,48,62
41,8476869,Brady Skjei,D,NSH,30,82,14,48,62
41,8479325,Charlie McAvoy,D,BOS,27,82,7,55,62
41,8475794,Tyler Seguin,C,DAL,32,82,32,29,61
41,8479675,Trevor Moore,L,LAK,29,82,31,30,61
41,8474102,David Perron,L,OTT,36,82,24,37,61
41,8480039,Martin Necas,C,CAR,25,82,21,40,61
41,8480018,Nick Suzuki,C,MTL,25,82,20,41,61
41,8480839,Rasmus Dahlin,D,BUF,24,82,15,46,61
41,8477021,Alex Kerfoot,C,UTA,30,82,14,47,61
41,8477935,Sam Bennett,C,FLA,28,82,27,33,60
41,8478469,Thomas Chabot,D,OTT,27,82,21,39,60
41,8474679,Gustav Nyquist,C,NSH,35,82,20,40,60
41,8481711,Matias Maccelli,L,UTA,24,82,20,40,60
41,8475753,Justin Faulk,D,STL,32,82,20,40,60
41,8475172,Nazem Kadri,C,CGY,34,82,19,41,60
41,8478401,Pavel Zacha,C,BOS,27,82,16,44,60
41,8481068,Yegor Sharangovich,C,CGY,26,82,32,27,59
41,8480014,Gabriel Vilardi,C,WPG,25,82,30,29,59
41,8482097,Jack Quinn,R,BUF,23,82,30,29,59
41,8479542,Brandon Hagel,L,TBL,26,82,25,34,59
41,8476872,Scott Laughton,C,PHI,30,82,25,34,59
41,8480078,Filip Chytil,C,NYR,25,82,23,36,59
41,8478458,Jack Roslovic,C,CAR,27,82,19,40,59
41,8474590,John Carlson,D,WSH,34,82,16,43,59
41,8479339,Patrik Laine,L,CBJ,26,82,32,26,58
41,8475786,Zach Hyman,L,EDM,32,82,28,30,58
41,8475765,Vladimir Tarasenko,R,DET,33,82,21,37,58
41,8476462,Dougie Hamilton,D,NJD,31,82,18,40,58
41,8474565,Alex Pietrangelo,D,VGK,34,82,14,44,58
41,8476958,Jaccob Slavin,D,CAR,30,82,11,47,58
41,8477496,Elias Lindholm,C,BOS,30,82,31,26,57
41,8480009,Eeli Tolvanen,R,SEA,25,82,31,26,57
41,8478366,Frank Vatrano,R,ANA,30,82,29,28,57
41,8475168,Matt Duchene,C,DAL,33,82,23,34,57
41,8475791,Taylor Hall,L,CHI,33,82,22,35,57
41,8482667,William Eklund,L,SJS,22,82,21,36,57
41,8474141,Patrick Kane,R,DET,36,82,18,39,57
41,8482124,Quinton Byfield,R,LAK,22,82,18,39,57
41,8480803,Evan Bouchard,D,EDM,25,82,11,46,57
41,8475768,Jaden Schwartz,C,SEA,32,82,26,30,56
41,8480797,Joel Farabee,L,PHI,24,82,25,31,56
41,8475149,Marcus Johansson,L,MIN,34,82,23,33,56
41,8475726,Tyler Toffoli,C,SJS,32,82,22,34,56
41,8477494,Jonathan Drouin,L,COL,29,82,18,38,56
41,8480028,Morgan Frost,C,PHI,25,82,18,38,56
41,8477346,MacKenzie Weegar,D,CGY,30,82,16,40,56
41,8482684,Luke Hughes,D,NJD,21,82,10,46,56
41,8477479,Tyler Bertuzzi,L,CHI,29,82,28,27,55
41,8482110,Dawson Mercer,C,NJD,23,82,27,28,55
41,8478047,Michael Bunting,L,PIT,29,82,24,31,55
41,8473994,Jamie Benn,L,DAL,35,82,24,31,55
41,8476826,Yanni Gourde,C,SEA,33,82,21,34,55
41,8474150,Mikael Backlund,C,CGY,35,82,19,36,55
41,8476881,Tomas Hertl,C,VGK,31,82,21,33,54
41,8476479,Phillip Danault,C,LAK,31,82,18,36,54
41,8483808,Andrei Kuzmenko,L,CGY,28,82,25,28,53
41,8477456,J.T. Compher,L,DET,29,82,25,28,53
41,8481596,Shane Pinto,C,OTT,24,82,22,31,53
41,8479400,Pierre-Luc Dubois,L,WSH,26,82,16,37,53
41,8477932,Aaron Ekblad,D,FLA,28,82,15,38,53
41,8479345,Jakob Chychrun,D,WSH,26,82,13,40,53
41,8482740,Wyatt Johnston,C,DAL,21,82,23,29,52
41,8475158,Ryan O'Reilly,C,NSH,33,82,22,30,52
41,8473986,Alex Killorn,L,ANA,35,82,22,30,52
41,8474053,Logan Couture,C,SJS,35,82,22,30,52
41,8478542,Evan Rodrigues,C,FLA,31,82,20,32,52
41,8478440,Dylan Strome,C,WSH,27,82,19,33,52
41,8480185,Eetu Luostarinen,C,FLA,26,82,15,37,52
41,8477495,Seth Jones,D,CHI,30,82,15,37,52
41,8476854,Hampus Lindholm,D,BOS,30,82,8,44,52
41,8482665,Matty Beniers,C,SEA,22,82,22,29,51
41,8475745,Charlie Coyle,C,BOS,32,82,18,33,51
41,8477447,Shea Theodore,D,VGK,29,82,9,42,51
41,8478407,Vince Dunn,D,SEA,28,82,7,44,51
41,8479992,Michael Rasmussen,C,DET,25,82,26,24,50
41,8474586,Jordan Eberle,R,SEA,34,82,24,26,50
41,8482475,Yegor Chinakhov,R,CBJ,23,82,19,31,50
41,8475191,Reilly Smith,R,NYR,33,82,18,32,50
41,8478438,Tommy Novak,C,NSH,27,82,17,33,50
41,8476882,Teuvo Teravainen,L,CHI,30,82,14,36,50
41,8480434,Sean Durzi,D,UTA,26,82,10,40,50
41,8481581,Thomas Harley,D,DAL,23,82,8,42,50
41,8476399,Blake Coleman,C,CGY,33,82,24,25,49
41,8479999,Casey Mittelstadt,C,COL,26,82,23,26,49
41,8480849,Barrett Hayton,C,UTA,24,82,22,27,49
41,8481618,Alex Newhook,C,MTL,23,82,22,27,49
41,8478413,Jordan Greenway,L,BUF,27,82,21,28,49
41,8477429,Andrew Copp,C,DET,30,82,20,29,49
41,8477964,Ivan Barbashev,C,VGK,29,82,19,30,49
41,8477503,Max Domi,C,TOR,29,82,16,33,49
41,8476792,Torey Krug,D,STL,33,82,15,34,49
41,8480817,K'Andre Miller,D,NYR,24,82,11,38,49
41,8478498,Jake DeBrusk,L,VAN,28,82,29,19,48
41,8482159,Tyson Foerster,R,PHI,22,82,26,22,48
41,8477998,Warren Foegele,L,LAK,28,82,25,23,48
41,8475763,Kevin Hayes,R,PIT,32,82,22,26,48
41,8477444,Andre Burakovsky,L,SEA,29,82,20,28,48
41,8478397,Rasmus Andersson,D,CGY,28,82,10,38,48
41,8480145,Neal Pionk,D,WPG,29,82,10,38,48
41,8479410,Mikhail Sergachev,D,UTA,26,82,9,39,48
41,8476875,Mike Matheson,D,MTL,30,82,8,40,48
41,8475799,Nino Niederreiter,R,WPG,32,82,30,17,47
41,8477497,Sean Monahan,C,CBJ,30,82,24,23,47
41,8482720,Matthew Knies,L,TOR,22,82,20,27,47
41,8478519,Anthony Cirelli,C,TBL,27,82,18,29,47
41,8474563,Drew Doughty,D,LAK,35,82,10,37,47
41,8475169,Evander Kane,L,EDM,33,82,29,17,46
41,8476419,Jean-Gabriel Pageau,C,NYI,32,82,20,26,46
41,8479525,Ross Colton,C,COL,28,82,19,27,46
41,8471724,Kris Letang,D,PIT,37,82,14,32,46
41,8475200,Dmitry Orlov,D,CAR,33,82,14,32,46
41,8480829,Jesperi Kotkaniemi,C,CAR,24,82,19,26,45
41,8478975,Mason Marchment,L,DAL,29,82,18,27,45
41,8479987,Morgan Geekie,C,BOS,26,82,18,27,45
41,8475287,Erik Haula,L,NJD,33,82,16,29,45
41,8476906,Shayne Gostisbehere,D,CAR,31,82,16,29,45
41,8482660,Kent Johnson,C,CBJ,22,82,14,31,45
41,8475181,Nick Leddy,D,STL,33,82,6,39,45
41,8478474,Lawson Crouse,L,UTA,27,82,24,20,44
41,8482109,Alexis Lafrenière,L,NYR,23,82,23,21,44
41,8476438,Brandon Saad,L,STL,32,82,19,25,44
41,8480188,Fabian Zetterlund,L,SJS,25,82,17,27,44
41,8476392,Adam Lowry,C,WPG,31,82,17,27,44
41,8482113,Anton Lundell,C,FLA,23,82,16,28,44
41,8476456,Jonathan Huberdeau,C,CGY,31,82,9,35,44
41,8481546,Cam York,D,PHI,23,82,7,37,44
41,8474716,Jared Spurgeon,D,MIN,35,82,5,39,44
41,8482079,Marco Rossi,C,MIN,23,82,28,15,43
41,8482705,Cole Sillinger,C,CBJ,21,82,21,22,43
41,8480113,Alex Iafallo,L,WPG,31,82,20,23,43
41,8478046,Danton Heinen,L,VAN,29,82,15,28,43
41,8476292,Ondrej Palat,L,NJD,33,82,14,29,43
41,8476432,Boone Jenner,C,CBJ,31,82,21,21,42
41,8474149,Evgenii Dadonov,R,DAL,35,82,21,21,42
41,8482117,Lukas Reichel,L,CHI,22,82,18,24,42
41,8476880,Tom Wilson,R,WSH,30,82,18,24,42
41,8478856,Conor Garland,R,VAN,28,82,17,25,42
41,8476921,Jordan Martinook,L,CAR,32,82,17,25,42
41,8476960,Andreas Athanasiou,C,CHI,30,82,16,26,42
41,8476885,Jacob Trouba,D,NYR,30,82,15,27,42
41,8478055,Gustav Forsling,D,FLA,28,82,13,29,42
41,8480798,Philipp Kurashev,C,CHI,25,82,13,29,42
41,8482133,Thomas Bordeleau,C,SJS,22,82,10,32,42
41,8476923,Damon Severson,D,CBJ,30,82,7,35,42
41,8477948,Travis Sanheim,D,PHI,28,82,6,36,42
41,8477947,Sonny Milano,L,WSH,28,82,25,16,41
41,8470621,Corey Perry,R,EDM,39,82,22,19,41
41,8484144,Connor Bedard,C,CHI,19,82,22,19,41
41,8474641,Adam Henrique,C,EDM,34,82,21,20,41
41,8480459,Pius Suter,C,VAN,28,82,21,20,41
41,8478462,Nicolas Roy,C,VGK,27,82,17,24,41
41,8475793,Ryan Johansen,C,PHI,32,82,16,25,41
41,8482105,Jake Sanderson,D,OTT,22,82,14,27,41
41,8476461,Sean Couturier,C,PHI,32,82,13,28,41
41,8481656,Aliaksei Protas,C,WSH,23,82,12,29,41
41,8480043,Timothy Liljegren,D,TOR,25,82,4,37,41
41,8479365,Trent Frederic,C,BOS,26,82,21,19,40
41,8482146,Luke Evangelista,R,NSH,22,82,19,21,40
41,8482092,Ridly Greig,C,OTT,22,82,18,22,40
41,8479996,Cody Glass,C,NSH,25,82,18,22,40
41,8478020,Michael Amadio,C,OTT,28,82,18,22,40
41,8482699,Dylan Guenther,R,UTA,21,82,17,23,40
41,8476480,Vladislav Namestnikov,C,WPG,32,82,15,25,40
41,8471698,T.J. Oshie,R,WSH,38,82,14,26,40
41,8476463,Jonas Brodin,D,MIN,31,82,8,32,40
41,8479425,Filip Hronek,D,VAN,27,82,6,34,40
41,8481560,Arthur Kaliyev,R,LAK,23,82,20,19,39
41,8477511,Anthony Mantha,R,CGY,30,82,18,21,39
41,8475343,Nic Dowd,C,WSH,34,82,18,21,39
41,8477416,Oliver Bjorkstrand,R,SEA,29,82,15,24,39
41,8482671,Owen Power,D,BUF,22,82,5,34,39
41,8480049,Dylan Samberg,D,WPG,25,82,5,34,39
41,8475193,Tomas Tatar,L,NJD,34,82,22,16,38
41,8482175,JJ Peterka,R,BUF,22,82,19,19,38
41,8475722,Jason Zucker,L,BUF,32,82,18,20,38
41,8477952,Robby Fabbri,C,ANA,28,82,17,21,38
41,8476329,Travis Boyd,C,MIN,31,82,16,22,38
41,8480835,Jack Drury,C,CAR,24,82,15,23,38
41,8475220,Marcus Foligno,L,MIN,33,82,15,23,38
41,8480220,Noah Cates,L,PHI,25,82,15,23,38
41,8480893,Kirill Marchenko,R,CBJ,24,82,23,14,37
41,8476278,Colin Blackwell,C,DAL,31,82,22,15,37
41,8481604,Pavel Dorofeyev,L,VGK,24,82,21,16,37
41,8480802,Ryan McLeod,C,BUF,25,82,20,17,37
41,8475314,Anders Lee,L,NYI,34,82,17,20,37
41,8474189,Lars Eller,C,PIT,35,82,14,23,37
41,8482073,Braden Schneider,D,NYR,23,82,9,28,37
41,8480073,Erik Brannstrom,D,COL,25,82,8,29,37
41,8477426,Nicholas Paul,L,TBL,29,82,20,16,36
41,8478057,Dakota Joshua,C,VAN,28,82,20,16,36
41,8478109,Victor Olofsson,L,VGK,29,82,20,16,36
41,8478233,Andrew Mangiapane,L,WSH,28,82,18,18,36
41,8478115,Pierre Engvall,L,NYI,28,82,17,19,36
41,8475714,Calle Jarnkrok,C,TOR,33,82,15,21,36
41,8476927,Teddy Blueger,C,VAN,30,82,11,25,36
41,8480855,Jack McBain,C,UTA,24,82,11,25,36
41,8470613,Brent Burns,D,CAR,39,82,10,26,36
41,8481186,Logan O'Connor,R,COL,28,82,9,27,36
41,8477498,Darnell Nurse,D,EDM,29,82,8,28,36
41,8481704,Juuso Parssinen,C,NSH,23,82,20,15,35
41,8480003,Jesper Boqvist,C,FLA,26,82,19,16,35
41,8476458,Ryan Strome,C,ANA,31,82,8,27,35
41,8482122,Brock Faber,D,MIN,22,82,7,28,35
41,8476892,Colton Parayko,D,STL,31,82,6,29,35
41,8476979,Erik Gustafsson,D,DET,32,82,3,32,35
41,8481554,Kaapo Kakko,R,NYR,23,82,17,17,34
41,8482089,Jake Neighbours,L,STL,22,82,17,17,34
41,8473533,Jordan Staal,C,CAR,36,82,16,18,34
41,8481582,Nicholas Robertson,L,TOR,23,82,15,19,34
41,8481624,Ilya Mikheyev,R,CHI,30,82,15,19,34
41,8482149,Cole Perfetti,C,WPG,22,82,13,21,34
41,8479661,Tanner Jeannot,L,LAK,27,82,13,21,34
41,8473563,Nicklas Backstrom,C,WSH,37,82,8,26,34
41,8481178,Egor Zamula,D,PHI,24,82,3,31,34
41,8480813,Joe Veleno,C,DET,24,82,17,16,33
41,8480068,Ryan Poehling,C,PHI,25,82,16,17,33
41,8480748,Kiefer Sherwood,L,VAN,29,82,14,19,33
41,8475218,Mattias Ekholm,D,EDM,34,82,11,22,33
41,8478472,Mathieu Joseph,R,STL,27,82,9,24,33
41,8480871,Adam Boqvist,D,FLA,24,82,8,25,33
41,8477499,Rasmus Ristolainen,D,PHI,30,82,8,25,33
41,8480878,Nils Lundkvist,D,DAL,24,82,7,26,33
41,8479398,Samuel Girard,D,COL,26,82,2,31,33
41,8476981,Josh Anderson,R,MTL,30,82,21,11,32
41,8475760,Nick Bjugstad,C,UTA,32,82,18,14,32
41,8481093,Rafael Harvey-Pinard,L,MTL,25,82,18,14,32
41,8476918,Jimmy Vesey,L,NYR,31,82,15,17,32
41,8482142,Jamie Drysdale,D,PHI,22,82,9,23,32
41,8480873,Rasmus Sandin,D,WSH,24,82,7,25,32
41,8481606,Jordan Spence,D,LAK,23,82,6,26,32
41,8478500,Ivan Provorov,D,CBJ,27,82,5,27,32
41,8475764,Cam Fowler,D,ANA,33,82,4,28,32
41,8476902,Esa Lindell,D,DAL,30,82,4,28,32
41,8478507,John Marino,D,UTA,27,82,4,28,32
41,8478508,Yakov Trenin,C,MIN,27,82,19,12,31
41,8481477,Nico Sturm,C,SJS,29,82,18,13,31
41,8476474,Stefan Noesen,R,NJD,31,82,15,16,31
41,8477987,Ryan Donato,C,CHI,28,82,11,20,31
41,8475855,Jesper Fast,R,CAR,33,82,10,21,31
41,8482111,Justin Barron,D,MTL,23,82,8,23,31
41,8477435,Ryan Graves,D,PIT,29,82,7,24,31
41,8477969,Marcus Pettersson,D,PIT,28,82,5,26,31
41,8481601,Simon Holmstrom,R,NYI,23,82,15,15,30
41,8479316,Luke Kunin,C,SJS,27,82,14,16,30
41,8479351,Sam Steel,C,DAL,26,82,13,17,30
41,8478891,Mason Appleton,C,WPG,28,82,12,18,30
41,8481553,Bobby Brink,R,PHI,23,82,12,18,30
41,8479353,Brett Howden,C,VGK,26,82,12,18,30
41,8483457,Lane Hutson,D,MTL,20,82,9,21,30
41,8475171,Oliver Ekman-Larsson,D,TOR,33,82,9,21,30
41,8478136,Jake Middleton,D,MIN,28,82,8,22,30
41,8478882,Vladislav Gavrikov,D,LAK,29,82,7,23,30
41,8474151,Ryan McDonagh,D,TBL,35,82,3,27,30
41,8476442,Matt Nieto,L,PIT,32,82,21,8,29
41,8482259,Bobby McMann,C,TOR,28,82,17,12,29
41,8479368,Max Jones,L,BOS,26,82,17,12,29
41,8482055,Drew O'Connor,L,PIT,26,82,16,13,29
41,8477425,Miles Wood,L,COL,29,82,16,13,29
41,8482125,Alexander Holtz,R,VGK,22,82,15,14,29
41,8479390,Taylor Raddysh,R,WSH,26,82,15,14,29
41,8476897,Oskar Sundqvist,C,STL,30,82,14,15,29
41,8482141,Lukas Cormier,D,VGK,22,82,14,15,29
41,8480064,Josh Norris,C,OTT,25,82,13,16,29
41,8477919,Frederick Gaudreau,C,MIN,31,82,12,17,29
41,8478463,Anthony Beauvillier,L,PIT,27,82,10,19,29
41,8482655,J.J. Moser,D,TBL,24,82,2,27,29
41,8480806,Isac Lundestrom,C,ANA,25,82,14,14,28
41,8474715,Cam Atkinson,R,TBL,35,82,14,14,28
41,8475231,Casey Cizikas,C,NYI,33,82,13,15,28
41,8481535,Nils Hoglander,L,VAN,24,82,12,16,28
41,8481032,Paul Cotter,C,NJD,25,82,12,16,28
41,8480074,Alexandre Texier,C,STL,25,82,11,17,28
41,8484203,Bradly Nadeau,L,CAR,19,82,11,17,28
41,8480789,Oliver Wahlstrom,R,NYI,24,82,11,17,28
41,8477392,Hudson Fasching,R,NYI,29,82,9,19,28
41,8481522,Peyton Krebs,C,BUF,23,82,8,20,28
41,8480796,Martin Fehervary,D,WSH,25,82,8,20,28
41,8476891,Matt Grzelcyk,D,PIT,30,82,7,21,28
41,8479976,Juuso Valimaki,D,UTA,26,82,5,23,28
41,8480222,Sebastian Aho,D,PIT,28,82,5,23,28
41,8480246,Nick Perbix,D,TBL,26,82,4,24,28
41,8477506,Ryan Pulock,D,NYI,30,82,3,25,28
41,8478432,Christian Fischer,R,DET,27,82,13,14,27
41,8478434,Keegan Kolesar,R,VGK,27,82,13,14,27
41,8477953,Kasperi Kapanen,R,STL,28,82,12,15,27
41,8475848,Brendan Gallagher,R,MTL,32,82,12,15,27
41,8479293,Brandon Tanev,L,SEA,33,82,12,15,27
41,8477989,Christian Dvorak,C,MTL,28,82,11,16,27
41,8473422,Nick Foligno,L,CHI,37,82,10,17,27
41,8479941,Justin Danforth,R,CBJ,31,82,10,17,27
41,8479591,Michael Eyssimont,C,TBL,28,82,8,19,27
41,8482624,Daniil Miromanov,D,CGY,27,82,8,19,27
41,8476457,Adam Larsson,D,SEA,32,82,8,19,27
41,8477488,Brett Pesce,D,NJD,30,82,7,20,27
41,8482807,Ethan Del Mastro,D,CHI,21,82,6,21,27
41,8482245,Artem Zub,D,OTT,29,82,5,22,27
41,8473507,Jeff Petry,D,DET,37,82,3,24,27
41,8479998,Mikey Anderson,D,LAK,25,82,3,24,27
41,8479402,Jake Bean,D,CGY,26,82,3,24,27
41,8476931,Jake McCabe,D,TOR,31,82,3,24,27
41,8481014,Alexander Romanov,D,NYI,24,82,3,24,27
41,8478851,Alexandre Carrier,D,NSH,28,82,1,26,27
41,8481580,Connor McMichael,C,WSH,23,82,18,8,26
41,8484153,Leo Carlsson,C,ANA,20,82,11,15,26
41,8483565,Nick Blankenburg,D,NSH,26,82,11,15,26
41,8484166,Adam Fantilli,C,CBJ,20,82,9,17,26
41,8477220,Nate Schmidt,D,FLA,33,82,7,19,26
41,8477507,Nikita Zadorov,D,BOS,29,82,7,19,26
41,8482087,Kaiden Guhle,D,MTL,22,82,6,20,26
41,8476917,Adam Pelech,D,NYI,30,82,4,22,26
41,8474574,Tyler Myers,D,VAN,34,82,3,23,26
41,8475188,Brayden McNabb,D,VGK,33,82,1,25,26
41,8475842,Sam Carrick,C,NYR,32,82,16,9,25
41,8476469,Joel Armia,R,MTL,31,82,12,13,25
41,8480281,Alexey Toropchenko,R,STL,25,82,12,13,25
41,8478569,Noel Acciari,C,PIT,33,82,11,14,25
41,8477839,Conor Sheary,L,TBL,32,82,9,16,25
41,8477406,Mattias Janmark,C,EDM,32,82,8,17,25
41,8476873,Mark Jankowski,C,NSH,30,82,7,18,25
41,8484149,Gavin Brindley,C,CBJ,20,82,7,18,25
41,8476331,Dylan DeMelo,D,WPG,31,82,4,21,25
41,8477903,Garnet Hathaway,R,PHI,33,82,13,11,24
41,8481013,Jonatan Berggren,R,DET,24,82,13,11,24
41,8483482,Tristan Luneau,D,ANA,20,82,11,13,24
41,8482809,Jackson Blake,R,CAR,21,82,10,14,24
41,8479359,Beck Malenstyn,L,BUF,26,82,10,14,24
41,8483515,Juraj Slafkovsky,L,MTL,20,82,9,15,24
41,8479983,Mario Ferraro,D,SJS,26,82,9,15,24
41,8480990,Declan Chisholm,D,MIN,24,82,7,17,24
41,8482762,Simon Edvinsson,D,DET,21,82,7,17,24
41,8478133,Jake Evans,C,MTL,28,82,6,18,24
41,8480336,Sean Walker,D,CAR,30,82,4,20,24
41,8476429,Scott Mayfield,D,NYI,32,82,3,21,24
41,8474673,TJ Brodie,D,CHI,34,82,1,23,24
41,8483431,Logan Cooley,C,UTA,20,82,13,10,23
41,8478211,Dryden Hunt,L,CGY,29,82,13,10,23
41,8481517,Brett Leason,R,ANA,25,82,12,11,23
41,8477015,Connor Brown,R,EDM,30,82,8,15,23
41,8476374,Sean Kuraly,C,CBJ,31,82,8,15,23
41,8477369,Carson Soucy,D,VAN,30,82,8,15,23
41,8482166,Shakir Mukhamadullin,D,SJS,22,82,8,15,23
41,8476624,Barclay Goodrow,C,SJS,31,82,8,15,23
41,8481028,Martin Pospisil,C,CGY,25,82,7,16,23
41,8479371,Dante Fabbro,D,NSH,26,82,5,18,23
41,8481122,Simon Benoit,D,TOR,26,82,5,18,23
41,8478840,Will Borgen,D,SEA,28,82,4,19,23
41,8478399,Jonas Siegenthaler,D,NJD,27,82,4,19,23
41,8479369,Andrew Peeke,D,BOS,26,82,3,20,23
41,8480035,Henri Jokiharju,D,BUF,25,82,3,20,23
41,8479393,Noah Gregor,C,OTT,26,82,14,8,22
41,8476878,Zemgus Girgensons,L,TBL,30,82,14,8,22
41,8479414,Nathan Bastian,R,NJD,27,82,12,10,22
41,8476889,Radek Faksa,C,STL,30,82,12,10,22
41,8481481,Blake Lizotte,C,PIT,27,82,12,10,22
41,8480448,Parker Kelly,L,COL,25,82,11,11,22
41,8478450,Parker Wotherspoon,D,BOS,27,82,11,11,22
41,8477931,Tomas Nosek,L,FLA,32,82,11,11,22
41,8477450,Jason Dickinson,C,CHI,29,82,10,12,22
41,8482666,Scott Morrow,D,CAR,22,82,10,12,22
41,8478911,Matt Roy,D,WSH,29,82,8,14,22
41,8476925,Colton Sissons,C,NSH,31,82,7,15,22
41,8479980,Nicolas Hague,D,VGK,26,82,7,15,22
41,8480860,Kevin Bahl,D,CGY,24,82,2,20,22
41,8480144,David Kampf,C,TOR,29,82,9,12,21
41,8481524,Bowen Byram,D,BUF,23,82,9,12,21
41,8477353,Tyler Motte,C,DET,29,82,8,13,21
41,8478859,Niko Mikkola,D,FLA,28,82,3,18,21
41,8475462,Radko Gudas,D,ANA,34,82,3,18,21
41,8482074,Connor Zary,C,CGY,23,82,9,11,20
41,8480995,Pontus Holmberg,R,TOR,25,82,9,11,20
41,8482702,Logan Stankoven,C,DAL,21,82,6,14,20
41,8475233,David Savard,D,MTL,34,82,6,14,20
41,8482712,Oskar Olausson,R,COL,22,82,6,14,20
41,8475762,Derek Forbort,D,VAN,32,82,6,14,20
41,8480025,MacKenzie Entwistle,R,FLA,25,82,5,15,20
41,8483445,Cutter Gauthier,L,ANA,20,82,5,15,20
41,8475790,Erik Gudbranson,D,CBJ,32,82,3,17,20
41,8473453,Trevor Lewis,C,LAK,37,82,13,6,19
41,8477505,Alexander Wennberg,C,SJS,30,82,9,10,19
41,8484911,Collin Graf,R,SJS,22,82,8,11,19
41,8476467,Jamie Oleksiak,D,SEA,32,82,7,12,19
41,8480980,Connor Dewar,C,TOR,25,82,7,12,19
41,8476525,Colin Miller,D,WPG,32,82,6,13,19
41,8482470,Ilya Solovyov,D,CGY,24,82,6,13,19
41,8483468,Jiri Kulich,C,BUF,20,82,6,13,19
41,8476422,Mike Reilly,D,NYI,31,82,4,15,19
41,8479442,Troy Stecher,D,EDM,30,82,4,15,19
41,8478443,Brandon Carlo,D,BOS,28,82,2,17,19
41,8482077,Dylan Holloway,L,EDM,23,82,13,5,18
41,8480879,Jacob Bernard-Docker,D,OTT,24,82,7,11,18
41,8483012,Logan Morrison,C,SEA,22,82,4,14,18
41,8480807,Mattias Samuelsson,D,BUF,24,82,3,15,18
41,8475690,Chris Tanev,D,TOR,35,82,3,15,18
41,8480950,Ilya Lyubushkin,D,DAL,30,82,3,15,18
41,8483495,Simon Nemec,D,NJD,20,82,3,15,18
41,8475718,Justin Holl,D,DET,32,82,2,16,18
41,8477845,Trevor van Riemsdyk,D,WSH,33,82,1,17,18
41,8482062,Cole Smith,L,NSH,29,82,12,5,17
41,8482145,Mavrik Bourque,C,DAL,22,82,10,7,17
41,8483524,Shane Wright,C,SEA,20,82,10,7,17
41,8484145,Zach Benson,L,BUF,19,82,8,9,17
41,8482733,Logan Mailloux,D,MTL,31,82,8,9,17
41,8477508,Curtis Lazar,C,NJD,29,82,8,9,17
41,8483505,Matthew Poitras,C,BOS,20,82,7,10,17
41,8482155,Alex Laferriere,R,LAK,23,82,6,11,17
41,8476441,Joel Edmundson,D,LAK,31,82,6,11,17
41,8482153,Brendan Brisson,C,VGK,23,82,5,12,17
41,8483460,David Jiricek,D,CBJ,21,82,5,12,17
41,8475279,Ben Chiarot,D,DET,33,82,4,13,17
41,8476879,Cody Ceci,D,EDM,31,82,4,13,17
41,8481708,Zac Jones,D,NYR,24,82,4,13,17
41,8482858,Ryker Evans,D,SEA,23,82,3,14,17
41,8476967,Brett Kulak,D,EDM,30,82,2,15,17
41,8476858,Phillip Di Giuseppe,L,VAN,31,82,12,4,16
41,8482749,Joshua Roy,R,MTL,21,82,12,4,16
41,8479291,Kevin Rooney,C,CGY,31,82,8,8,16
41,8480021,Jack Studnicka,C,LAK,25,82,8,8,16
41,8480870,Bo Groulx,C,NYR,24,82,8,8,16
41,8483499,Liam Ohgren,L,MIN,20,82,6,10,16
41,8482118,Sam Colangelo,R,ANA,23,82,6,10,16
41,8481567,Henry Thrun,D,SJS,23,82,3,13,16
41,8480172,Jan Rutta,D,SJS,34,82,2,14,16
41,8483490,Pavel Mintyukov,D,ANA,21,82,2,14,16
41,8477365,Connor Clifton,D,BUF,29,82,1,15,16
41,8483397,Marc McLaughlin,C,BOS,25,82,9,6,15
41,8474013,Ian Cole,D,UTA,35,82,5,10,15
41,8477938,Haydn Fleury,D,WPG,28,82,4,11,15
41,8475177,Calvin de Haan,D,COL,33,82,4,11,15
41,8478468,Jeremy Lauzon,D,NSH,27,82,3,12,15
41,8480834,Ty Emberson,D,SJS,24,82,2,13,15
41,8479324,Ryan Lindgren,D,NYR,26,82,2,13,15
41,8478178,Darren Raddysh,D,TBL,28,82,1,14,15
41,8478416,Erik Cernak,D,TBL,27,82,1,14,15
41,8474612,Travis Hamonic,D,OTT,34,82,1,14,15
41,8478013,Jake Walman,D,SJS,28,82,11,3,14
41,8482679,Matt Coronato,R,CGY,22,82,9,5,14
41,8483763,Maksymilian Szuber,D,UTA,22,82,8,6,14
41,8483493,Frank Nazar,C,CHI,20,82,6,8,14
41,8482787,Nikita Chibrikov,R,WPG,31,82,4,10,14
41,8476312,Josh Manson,D,COL,33,82,3,11,14
41,8470600,Ryan Suter,D,STL,39,82,2,12,14
41,8476822,Luke Glendening,C,TBL,35,82,9,4,13
41,8479638,Justin Brazeau,R,BOS,26,82,8,5,13
41,8482803,Olen Zellweger,D,ANA,21,82,0,13,13
41,8482859,Zack Ostapchuk,C,OTT,21,82,7,5,12
41,8476372,Nick Seeler,D,PHI,31,82,4,8,12
41,8482516,Matthew Kessel,D,STL,24,82,3,9,12
41,8482713,Mackie Samoskevich,R,FLA,22,82,3,9,12
41,8478874,Adam Gaudette,C,OTT,28,82,2,10,12
41,8483471,Brad Lambert,C,WPG,31,82,5,6,11
41,8482101,Danil Gushchin,L,SJS,22,82,4,7,11
41,8482659,Josh Doan,R,UTA,22,82,3,8,11
41,8481568,Alex Vlasic,D,CHI,23,82,2,9,11
41,8475455,Brenden Dillon,D,NJD,34,82,1,10,11
41,8482070,Mitchell Chaffee,R,TBL,26,82,7,3,10
41,8477335,Kyle Burroughs,D,LAK,29,82,5,5,10
41,8481641,Joel Kiviranta,L,COL,28,82,4,6,10
41,8481699,Aku Raty,R,UTA,23,82,3,7,10
41,8474090,Brendan Smith,D,DAL,35,82,2,8,10
41,8481605,Jackson LaCombe,D,ANA,23,82,1,9,10
41,8483567,Georgii Merkulov,C,BOS,24,82,5,4,9
41,8479576,Vincent Desharnais,D,VAN,28,82,1,8,9
41,8474567,Zach Bogosian,D,MIN,34,82,1,8,9
41,8475324,Nick Jensen,D,OTT,34,82,0,9,9
41,8477034,Jaycob Megna,D,FLA,32,82,4,4,8
41,8471677,Jack Johnson,D,CBJ,37,82,2,6,8
41,8476473,Connor Murphy,D,CHI,31,82,0,8,8
41,8483489,Fraser Minten,C,TOR,31,82,3,4,7
41,8474062,Riley Nash,C,NYR,35,82,0,6,6
41,8483466,Kevin Korchinski,D,CHI,20,82,2,3,5
41,8470794,Joe Pavelski,C,,40,0,0,0,0
41,8481703,Valtteri Puustinen,R,PIT,25,0,0,0,0
41,8477950,Tony DeAngelo,D,,29,0,0,0,0
41,8481577,Philip Tomasino,C,NSH,23,0,0,0,0
41,8475197,Tyson Barrie,D,,33,0,0,0,0
41,8471218,Blake Wheeler,R,,38,0,0,0,0
41,8474157,Max Pacioretty,L,,36,0,0,0,0
41,8478466,Daniel Sprong,R,VAN,27,0,0,0,0
41,8475744,Evgeny Kuznetsov,C,,32,0,0,0,0
41,8481019,David Gustafsson,C,WPG,24,0,0,0,0
41,8475906,John Klingberg,D,,32,0,0,0,0
41,8479348,Kale Clague,D,BUF,26,0,0,0,0
41,8476952,Dominic Toninato,C,WPG,30,0,0,0,0
41,8473473,Milan Lucic,L,,36,0,0,0,0
41,8474037,James van Riemsdyk,L,,35,0,0,0,0
41,8474602,Justin Schultz,D,,34,0,0,0,0
41,8482222,Alexander Barabanov,L,,30,0,0,0,0
41,8479372,Josh Mahura,D,SEA,26,0,0,0,0
41,8479982,Conor Timmins,D,TOR,26,0,0,0,0
41,8474031,Kevin Shattenkirk,D,,35,0,0,0,0
41,8480008,Adam Ruzicka,C,,25,0,0,0,0
41,8481059,Scott Perunovich,D,STL,26,0,0,0,0
41,8480884,Calen Addison,D,,24,0,0,0,0
41,8476994,Vinnie Hinostroza,C,NSH,30,0,0,0,0
41,8478452,Caleb Jones,D,LAK,27,0,0,0,0
41,8480157,Calle Rosen,D,COL,30,0,0,0,0
41,8481609,Vladislav Kolyachonok,D,UTA,23,0,0,0,0
41,8479415,Michael McLeod,C,,26,0,0,0,0
41,8476919,Chris Tierney,C,,30,0,0,0,0
41,8479639,Dylan Coghlan,D,WPG,26,0,0,0,0
41,8478146,Matthew Highmore,C,OTT,28,0,0,0,0
41,8478970,Jalen Chatfield,D,CAR,28,0,0,0,0
41,8480205,Emil Bemstrom,C,PIT,25,0,0,0,0
41,8474884,Mike Hoffman,C,,35,0,0,0,0
41,8471274,Alex Goligoski,D,,39,0,0,0,0
41,8478104,Sammy Blais,L,,28,0,0,0,0
41,8474870,Tyler Johnson,C,,34,0,0,0,0
41,8476913,Devin Shore,C,MIN,30,0,0,0,0
41,8481598,Philip Broberg,D,EDM,23,0,0,0,0
41,8480058,Pierre-Olivier Joseph,D,STL,25,0,0,0,0
41,8480891,Michael Kesselring,D,UTA,24,0,0,0,0
41,8477979,Nicolas Aube-Kubel,R,BUF,28,0,0,0,0
41,8476871,Tanner Pearson,L,,32,0,0,0,0
41,8476393,Nick Cousins,C,,31,0,0,0,0
41,8479977,Kailer Yamamoto,R,,26,0,0,0,0
41,8479543,Michael Pezzetta,L,MTL,26,0,0,0,0
41,8477018,Ben Hutton,D,VGK,31,0,0,0,0
41,8480762,Eric Robinson,L,CAR,29,0,0,0,0
41,8474034,Pat Maroon,L,CHI,36,0,0,0,0
41,8481058,Jesse Ylönen,R,,25,0,0,0,0
41,8475179,Dmitry Kulikov,D,FLA,34,0,0,0,0
41,8481527,Kaedan Korczak,D,VGK,23,0,0,0,0
41,8473449,Kyle Okposo,R,,36,0,0,0,0
41,8482192,Isaak Phillips,D,CHI,23,0,0,0,0
41,8480727,Zach Whitecloud,D,VGK,28,0,0,0,0
41,8479346,Dillon Dube,C,,26,0,0,0,0
41,8480821,Filip Zadina,R,,25,0,0,0,0
41,8480001,Urho Vaakanainen,D,ANA,25,0,0,0,0
41,8470966,Mark Giordano,D,,41,0,0,0,0
41,8480853,Liam Foudy,C,,24,0,0,0,0
41,8475225,Craig Smith,C,CHI,35,0,0,0,0
41,8479972,Mason Shaw,C,WPG,26,0,0,0,0
41,8478451,Ethan Bear,D,WSH,27,0,0,0,0
41,8474040,Sam Gagner,C,,35,0,0,0,0
41,8480196,Jacob Bryson,D,BUF,27,0,0,0,0
41,8479984,Cal Foote,D,,26,0,0,0,0
41,8480011,Klim Kostin,C,SJS,25,0,0,0,0
41,8482176,Wyatt Kaiser,D,CHI,22,0,0,0,0
41,8476988,Matt Benning,D,SJS,30,0,0,0,0
41,8479370,Tyson Jost,C,CAR,26,0,0,0,0
41,8477464,Nic Petan,C,,29,0,0,0,0
41,8477380,Jonny Brodzinski,C,NYR,31,0,0,0,0
41,8480070,Ian Mitchell,D,BOS,25,0,0,0,0
41,8479315,Joey Anderson,R,CHI,26,0,0,0,0
41,8478099,Kevin Labanc,R,,29,0,0,0,0
41,8476874,Olli Maatta,D,DET,30,0,0,0,0
41,8475208,Brian Dumoulin,D,ANA,33,0,0,0,0
41,8478430,Oliver Kylington,D,,27,0,0,0,0
41,8479536,Axel Jonsson-Fjallby,L,WPG,26,0,0,0,0
41,8479671,Mathieu Olivier,R,CBJ,27,0,0,0,0
41,8471709,Marc-Edouard Vlasic,D,SJS,37,0,0,0,0
41,8479328,Julien Gauthier,R,NYI,27,0,0,0,0
41,8478421,A.J. Greer,L,FLA,28,0,0,0,0
41,8477573,Nathan Walker,L,STL,30,0,0,0,0
41,8481537,Nikita Okhotiuk,D,CGY,24,0,0,0,0
41,8474166,Alec Martinez,D,CHI,37,0,0,0,0
41,8470610,Zach Parise,L,,40,0,0,0,0
41,8477478,William Carrier,L,CAR,30,0,0,0,0
41,8479344,Jesse Puljujarvi,R,PIT,26,0,0,0,0
41,8480887,Jordan Harris,D,MTL,24,0,0,0,0
41,8478502,Dennis Gilbert,D,BUF,28,0,0,0,0
41,8482730,Brandt Clarke,D,LAK,21,0,0,0,0
41,8480355,Mark Kastelic,C,BOS,25,0,0,0,0
41,8475750,Jon Merrill,D,MIN,32,0,0,0,0
41,8475164,Jakob Silfverberg,R,,34,0,0,0,0
41,8477944,Jakub Vrana,L,,28,0,0,0,0
41,8479439,Jacob MacDonald,D,COL,31,0,0,0,0
41,8474568,Luke Schenn,D,NSH,35,0,0,0,0
41,8478454,Noah Juulsen,D,VAN,27,0,0,0,0
41,8475752,Tyler Pitlick,C,,33,0,0,0,0
41,8482148,Hendrix Lapierre,C,WSH,22,0,0,0,0
41,8481167,Brayden Pachal,D,CGY,25,0,0,0,0
41,8478043,Sam Lafferty,C,BUF,29,0,0,0,0
41,8479321,Lucas Johansen,D,,27,0,0,0,0
41,8471699,Andrew Cogliano,C,,37,0,0,0,0
41,8481521,Ronnie Attard,D,PHI,25,0,0,0,0
41,8481161,Jake Christiansen,D,CBJ,25,0,0,0,0
41,8479458,Nikita Zaitsev,D,,33,0,0,0,0
41,8479619,Michael Carcone,L,UTA,28,0,0,0,0
41,8479026,Philippe Myers,D,TOR,27,0,0,0,0
41,8477330,Dominik Kubalik,L,,29,0,0,0,0
41,8481617,Vasily Podkolzin,R,VAN,23,0,0,0,0
41,8481701,Santeri Hatakka,D,NJD,23,0,0,0,0
41,8479514,Rem Pitlick,C,,27,0,0,0,0
41,8477446,Michael McCarron,R,NSH,29,0,0,0,0
41,8470604,Jeff Carter,C,,39,0,0,0,0
41,8482241,Radim Zohorna,L,,28,0,0,0,0
41,8480289,Morgan Barron,C,WPG,26,0,0,0,0
41,8479379,Givani Smith,R,SJS,26,0,0,0,0
41,8480216,Jacob Peterson,C,,25,0,0,0,0
41,8477851,Jordan Oesterle,D,BOS,32,0,0,0,0
41,8484258,Sam Malinski,D,COL,26,0,0,0,0
41,8478904,Steven Lorentz,C,,28,0,0,0,0
41,8482095,Tyler Kleven,D,OTT,22,0,0,0,0
41,8480848,Ty Dellandrea,C,SJS,24,0,0,0,0
41,8476884,Derrick Pouliot,D,,30,0,0,0,0
41,8479336,Carl Grundstrom,R,SJS,27,0,0,0,0
41,8482964,Arber Xhekaj,D,MTL,23,0,0,0,0
41,8471686,Marc Staal,D,,37,0,0,0,0
41,8477887,Patrick Brown,C,BOS,32,0,0,0,0
41,8478495,Denis Gurianov,R,,27,0,0,0,0
41,8473504,Cal Clutterbuck,R,,37,0,0,0,0
41,8481550,Adam Beckman,L,NJD,23,0,0,0,0
41,8480845,Rasmus Kupari,C,WPG,24,0,0,0,0
41,8474009,Nick Bonino,C,,36,0,0,0,0
41,8478585,Derek Ryan,C,EDM,38,0,0,0,0
41,8477962,Brendan Lemieux,L,CAR,28,0,0,0,0
41,8482861,Vincent Iorio,D,WSH,22,0,0,0,0
41,8479378,Logan Stanley,D,WPG,26,0,0,0,0
41,8473446,Erik Johnson,D,PHI,36,0,0,0,0
41,8481743,Marc Del Gaizo,D,NSH,25,0,0,0,0
41,8477384,Josh Brown,D,EDM,30,0,0,0,0
41,8482165,Yan Kuznetsov,D,CGY,22,0,0,0,0
41,8478424,Jansen Harkins,C,ANA,27,0,0,0,0
41,8482144,Jack Thompson,D,SJS,22,0,0,0,0
41,8478512,Austin Czarnik,C,,32,0,0,0,0
41,8477527,Ross Johnston,L,ANA,30,0,0,0,0
41,8479383,Boris Katchouk,L,,26,0,0,0,0
41,8482094,Daemon Hunt,D,MIN,22,0,0,0,0
41,8481719,Maxwell Crozier,D,TBL,24,0,0,0,0
41,8480192,Johnathan Kovacevic,D,NJD,27,0,0,0,0
41,8479376,Victor Mete,D,,26,0,0,0,0
41,8482511,Mason Lohrei,D,BOS,23,0,0,0,0
41,8475825,Jani Hakanpää,D,,32,0,0,0,0
41,8478021,William Lagesson,D,DET,28,0,0,0,0
41,8475795,Dylan McIlrath,D,WSH,32,0,0,0,0
41,8477846,Ryan Carpenter,C,,33,0,0,0,0
41,8481056,Spencer Stastney,D,NSH,24,0,0,0,0
41,8481564,Ryan Johnson,D,BUF,23,0,0,0,0
41,8478017,Mark Friedman,D,VAN,29,0,0,0,0
41,8479320,Max Lajoie,D,SEA,27,0,0,0,0
41,8480075,Cameron Crotty,D,MIN,25,0,0,0,0
41,8484287,Cole McWard,D,VAN,23,0,0,0,0
41,8484254,Akito Hirose,D,VAN,25,0,0,0,0
41,8483407,Brandon Scanlin,D,NYR,25,0,0,0,0
41,8480274,Philip Kemp,D,EDM,25,0,0,0,0
41,8479522,Hardy Haman Aktell,D,WSH,26,0,0,0,0
41,8480007,Jonas Rondbjerg,R,VGK,25,0,0,0,0
41,8477454,Adam Erne,L,,29,0,0,0,0
41,8481679,Maxence Guenette,D,OTT,23,0,0,0,0
41,8480441,Trey Fix-Wolansky,R,CBJ,25,0,0,0,0
41,8483546,Marshall Rifai,D,TOR,26,0,0,0,0
41,8480084,Nick DeSimone,D,NJD,30,0,0,0,0
41,8481030,Jack St. Ivany,D,PIT,25,0,0,0,0
41,8481592,Jakob Pelletier,L,CGY,23,0,0,0,0
41,8478011,Louie Belpedio,D,PHI,28,0,0,0,0
41,8477930,Pierre-Edouard Bellemare,L,,39,0,0,0,0
41,8484321,Nikolas Matinpalo,D,OTT,26,0,0,0,0
41,8482067,Connor Mackey,D,NYR,28,0,0,0,0
41,8481806,Louis Crevier,D,CHI,23,0,0,0,0
41,8484326,Patrik Koch,D,UTA,28,0,0,0,0
41,8477971,Andreas Englund,D,LAK,28,0,0,0,0
41,8481751,Lukas Rousek,R,BUF,25,0,0,0,0
41,8481006,Tyler Tucker,D,STL,24,0,0,0,0
41,8476867,Brendan Gaunce,C,MIN,30,0,0,0,0
41,8479520,Brandon Duhaime,R,WSH,27,0,0,0,0
41,8477073,Kurtis MacDermid,L,NJD,30,0,0,0,0
41,8480874,Adam Ginning,D,PHI,24,0,0,0,0
41,8477473,Justin Bailey,R,SJS,29,0,0,0,0
41,8479066,Ryan Lomberg,L,CGY,30,0,0,0,0
41,8477070,Liam O'Brien,C,UTA,30,0,0,0,0
41,8474618,Marco Scandella,D,,34,0,0,0,0
41,8475797,Jarred Tinordi,D,,32,0,0,0,0
41,8481441,Joe Snively,C,DET,28,0,0,0,0
41,8477244,Chad Ruhwedel,D,NYR,34,0,0,0,0
41,8479772,Zack MacEwen,R,OTT,28,0,0,0,0
41,8481147,Reese Johnson,C,MIN,26,0,0,0,0
41,8481043,Cole Koepke,L,BOS,26,0,0,0,0
41,8483619,Filip Roos,D,OTT,25,0,0,0,0
41,8481541,Samuel Bolduc,D,NYI,24,0,0,0,0
41,8477810,Joel Hanley,D,CGY,33,0,0,0,0
41,8476907,Mackenzie MacEachern,L,,30,0,0,0,0
41,8482652,Walker Duehr,R,CGY,27,0,0,0,0
41,8477126,Jayson Megna,C,,34,0,0,0,0
41,8483398,Declan Carlile,D,TBL,31,0,0,0,0
41,8482929,Emil Lilleberg,D,TBL,23,0,0,0,0
41,8480880,Jakub Lauko,C,MIN,24,0,0,0,0
41,8480245,Olle Lycksell,R,PHI,25,0,0,0,0
41,8480252,Cole Guttman,C,CHI,25,0,0,0,0
41,8477467,Gustav Olofsson,D,SEA,30,0,0,0,0
41,8479968,Vinni Lettieri,C,BOS,29,0,0,0,0
41,8478400,Colin White,C,,27,0,0,0,0
41,8475755,Alexander Petrovic,D,DAL,32,0,0,0,0
41,8481812,Nikolai Knyzhov,D,,27,0,0,0,0
41,8481593,Jayden Struble,D,MTL,23,0,0,0,0
41,8481532,Alex Turcotte,C,LAK,23,0,0,0,0
41,8482126,Emil Andrae,D,PHI,31,0,0,0,0
41,8479944,Zach Aston-Reese,C,VGK,30,0,0,0,0
41,8471817,Ryan Reaves,R,TOR,37,0,0,0,0
41,8481206,John Ludvig,D,PIT,24,0,0,0,0
41,8481599,Victor Soderstrom,D,UTA,23,0,0,0,0
41,8480292,Carson Meyer,R,ANA,27,0,0,0,0
41,8482496,Nils Aman,C,VAN,24,0,0,0,0
41,8479718,Alex Barré-Boulet,C,MTL,27,0,0,0,0
41,8479994,Jaret Anderson-Dolan,C,WPG,25,0,0,0,0
41,8480184,Gustav Lindstrom,D,,26,0,0,0,0
41,8480890,Jan Jenik,R,OTT,24,0,0,0,0
41,8478067,Oskar Lindblom,L,,28,0,0,0,0
41,8476934,Brock McGinn,L,ANA,30,0,0,0,0
41,8479985,Cale Fleury,D,SEA,26,0,0,0,0
41,8484304,Uvis Balinskis,D,FLA,28,0,0,0,0
41,8479981,Jonah Gadjovich,L,FLA,26,0,0,0,0
41,8481716,Dmitri Voronkov,L,CBJ,24,0,0,0,0
41,8474709,Matt Martin,L,,35,0,0,0,0
41,8482634,Alex Steeves,C,TOR,25,0,0,0,0
41,8480823,Alexander Alexeyev,D,WSH,25,0,0,0,0
41,8477541,Dakota Mermis,D,TOR,30,0,0,0,0
41,8483491,Ivan Miroshnichenko,L,WSH,20,0,0,0,0
41,8478477,Mitchell Stephens,C,SEA,27,0,0,0,0
41,8481543,Nikita Alexandrov,C,STL,24,0,0,0,0
41,8479423,Alex Nylander,L,,26,0,0,0,0
41,8482451,Mikael Pyyhtia,L,CBJ,23,0,0,0,0
41,8478831,Kevin Stenlund,C,UTA,28,0,0,0,0
41,8480306,Grant Hutton,D,NYI,29,0,0,0,0
41,8478028,Fredrik Olofsson,L,,28,0,0,0,0
41,8477462,Robert Hagg,D,VGK,29,0,0,0,0
41,8477320,Anton Blidh,L,NYR,29,0,0,0,0
41,8482157,Will Cuylle,L,NYR,22,0,0,0,0
41,8482737,Zack Bolduc,C,STL,21,0,0,0,0
41,8481239,Samuel Fagemo,L,,24,0,0,0,0
41,8481600,Tobias Bjornfot,D,FLA,23,0,0,0,0
41,8478409,Anthony Richard,C,PHI,28,0,0,0,0
41,8474145,Robert Bortuzzo,D,,35,0,0,0,0
41,8475958,Michael Sgarbossa,C,WSH,32,0,0,0,0
41,8479986,Kole Lind,R,DAL,26,0,0,0,0
41,8479249,Andrew Poturalski,C,SJS,30,0,0,0,0
41,8479362,Riley Tufte,L,BOS,26,0,0,0,0
41,8479991,Jake Leschyshyn,C,NYR,25,0,0,0,0
41,8479587,Rhett Gardner,C,PHI,28,0,0,0,0
41,8482744,James Malatesta,L,CBJ,21,0,0,0,0
41,8478854,Ryan Shea,D,PIT,27,0,0,0,0
41,8481591,Sam Poulin,R,,23,0,0,0,0
41,8483512,Matt Savoie,C,EDM,20,0,0,0,0
41,8482102,Vasily Ponomarev,C,PIT,22,0,0,0,0
41,8482162,Roby Jarventie,L,EDM,22,0,0,0,0
41,8481016,Ruslan Iskhakov,C,,24,0,0,0,0
41,8482172,Landon Slaggert,L,CHI,22,0,0,0,0
41,8482747,Brennan Othmann,L,NYR,21,0,0,0,0
41,8480031,Maxime Comtois,L,,25,0,0,0,0
41,8480226,Marián Studenic,R,,26,0,0,0,0
41,8478408,Travis Dermott,D,,28,0,0,0,0
41,8481518,Nolan Foote,L,NJD,24,0,0,0,0
41,8479419,Brett Murray,L,BUF,26,0,0,0,0
41,8482088,Justin Sourdif,R,FLA,22,0,0,0,0
41,8482201,Gage Goncalves,C,TBL,23,0,0,0,0
41,8481578,Graeme Clarke,R,MIN,23,0,0,0,0
41,8482177,Marat Khusnutdinov,C,MIN,22,0,0,0,0
41,8481754,Nikita Nesterenko,C,ANA,23,0,0,0,0
41,8483531,Brian Halonen,L,NJD,25,0,0,0,0
41,8483920,Pierrick Dube,R,WSH,23,0,0,0,0
41,8480851,Akil Thomas,C,LAK,24,0,0,0,0
41,8475235,Nicolas Deslauriers,L,PHI,33,0,0,0,0
41,8482476,Emil Heineman,L,MTL,23,0,0,0,0
41,8477149,Scott Sabourin,R,SJS,32,0,0,0,0
41,8483549,Lucas Condotta,L,MTL,27,0,0,0,0
41,8482765,Isak Rosen,R,BUF,21,0,0,0,0
41,8481237,Kyle MacLean,C,NYI,25,0,0,0,0
41,8481024,Linus Karlsson,C,VAN,25,0,0,0,0
41,8481690,Tyler Angle,C,,24,0,0,0,0
41,8483570,Ben Meyers,C,SEA,26,0,0,0,0
41,8481655,Cole Schwindt,R,CGY,23,0,0,0,0
41,8481462,Mason Morelli,L,VGK,28,0,0,0,0
41,8483401,Marc Johnstone,R,PIT,28,0,0,0,0
41,8478956,Samuel Laberge,L,NJD,27,0,0,0,0
41,8479533,Joona Koppanen,L,,26,0,0,0,0
41,8482197,Adam Raska,R,MIN,23,0,0,0,0
41,8482250,Callahan Burke,C,VGK,27,0,0,0,0
41,8482784,Zach Dean,C,STL,21,0,0,0,0
41,8484255,Jason Polin,R,COL,25,0,0,0,0
41,8481077,John Leonard,L,,26,0,0,0,0
41,8481534,Raphael Lavoie,C,EDM,24,0,0,0,0
41,8483609,Adam Klapka,R,CGY,24,0,0,0,0
41,8482751,Ryan Winterton,C,SEA,21,0,0,0,0
41,8480267,Sammy Walker,C,MIN,25,0,0,0,0
41,8475766,Austin Watson,L,,32,0,0,0,0
41,8482460,Matt Rempe,C,NYR,22,0,0,0,0
41,8481065,Angus Crookshank,L,OTT,25,0,0,0,0
41,8481070,Hugh McGing,L,,26,0,0,0,0
41,8476323,Max McCormick,L,SEA,32,0,0,0,0
41,8483395,Arshdeep Bains,L,VAN,23,0,0,0,0
41,8484259,Ondrej Pavel,C,COL,31,0,0,0,0
41,8483432,Luca Del Bel Belluz,C,CBJ,31,0,0,0,0
41,8483045,Cameron Butler,R,CBJ,31,0,0,0,0
41,8482061,Brandon Biro,L,SEA,26,0,0,0,0
41,8477401,John Hayden,C,SEA,29,0,0,0,0
41,8475278,Byron Froese,C,,33,0,0,0,0
41,8478446,Glenn Gawdin,C,LAK,27,0,0,0,0
41,8477993,Justin Kirkland,C,CGY,28,0,0,0,0
41,8482147,Jean-Luc Foudy,C,COL,22,0,0,0,0
41,8480032,Shane Bowers,C,NJD,25,0,0,0,0
41,8479330,Brandon Gignac,C,MTL,27,0,0,0,0
41,8480776,Sheldon Rempal,R,,29,0,0,0,0
41,8475413,Justin Dowling,C,NJD,34,0,0,0,0
41,8481726,Adam Edstrom,C,NYR,24,0,0,0,0
41,8480844,Grigori Denisenko,L,VGK,24,0,0,0,0
41,8478147,Bokondji Imama,L,PIT,28,0,0,0,0
41,8478881,Brett Seney,L,CHI,28,0,0,0,0
41,8483630,Pavol Regenda,L,ANA,25,0,0,0,0
41,8480836,Jonathan Gruden,C,,24,0,0,0,0
41,8484314,Jiri Smejkal,L,,28,0,0,0,0
41,8475780,Chris Wagner,R,COL,33,0,0,0,0
41,8479546,Oskar Steen,C,,26,0,0,0,0
41,8483597,Milos Kelemen,L,UTA,25,0,0,0,0
41,8481789,Tye Kartye,L,SEA,23,0,0,0,0
41,8484325,Waltteri Merela,C,TBL,26,0,0,0,0
41,8479421,Jacob Moverare,D,LAK,26,0,0,0,0
41,8481585,Egor Afanasyev,L,SJS,23,0,0,0,0
41,8479547,Matthew Phillips,R,,26,0,0,0,0
41,8479367,William Lockwood,R,FLA,26,0,0,0,0
41,8476915,Jujhar Khaira,L,,30,0,0,0,0
41,8481422,Jacob Lucchini,C,NSH,29,0,0,0,0
41,8480468,James Hamblin,L,EDM,25,0,0,0,0
41,8478051,Max Willman,C,NJD,29,0,0,0,0
41,8481556,John Beecher,C,BOS,23,0,0,0,0
41,8478078,Rourke Chartier,C,,28,0,0,0,0
42,8479318,Auston Matthews,C,TOR,27,82,71,68,139
42,8476453,Nikita Kucherov,R,TBL,31,82,46,93,139
42,8476468,J.T. Miller,C,VAN,31,82,47,82,129
42,8478402,Connor McDavid,C,EDM,27,82,38,82,120
42,8479314,Matthew Tkachuk,L,FLA,27,82,37,77,114
42,8481559,Jack Hughes,C,NJD,23,82,45,66,111
42,8477939,William Nylander,R,TOR,28,82,57,52,109
42,8476887,Filip Forsberg,L,NSH,30,82,55,53,108
42,8482116,Tim Stützle,C,OTT,22,82,39,69,108
42,8478864,Kirill Kaprizov,L,MIN,27,82,45,62,107
42,8477934,Leon Draisaitl,C,EDM,29,82,40,66,106
42,8480801,Brady Tkachuk,L,OTT,25,82,54,51,105
42,8478420,Mikko Rantanen,R,COL,28,82,41,64,105
42,8479343,Clayton Keller,R,UTA,26,82,48,56,104
42,8479323,Adam Fox,D,NYR,26,82,13,91,104
42,8479407,Jesper Bratt,L,NJD,26,82,48,55,103
42,8477942,Kevin Fiala,L,LAK,28,82,39,64,103
42,8480012,Elias Pettersson,C,VAN,26,82,38,65,103
42,8477956,David Pastrnak,R,BOS,28,82,45,56,101
42,8474564,Steven Stamkos,C,NSH,34,82,41,60,101
42,8481557,Matt Boldy,L,MIN,23,82,40,61,101
42,8475172,Nazem Kadri,C,CGY,34,82,32,69,101
42,8480027,Jason Robertson,L,DAL,25,82,38,62,100
42,8477492,Nathan MacKinnon,C,COL,29,82,29,70,99
42,8477960,Adrian Kempe,R,LAK,28,82,42,56,98
42,8477404,Jake Guentzel,C,TBL,30,82,36,62,98
42,8471675,Sidney Crosby,C,PIT,37,82,45,50,95
42,8477933,Sam Reinhart,C,FLA,29,82,55,38,93
42,8475913,Mark Stone,R,VGK,32,82,33,59,92
42,8480069,Cale Makar,D,COL,26,82,28,64,92
42,8476454,Ryan Nugent-Hopkins,C,EDM,31,82,29,62,91
42,8476346,Johnny Gaudreau,L,CBJ,31,82,22,69,91
42,8477493,Aleksander Barkov,C,FLA,29,82,30,60,90
42,8471214,Alex Ovechkin,L,WSH,39,82,35,53,88
42,8478403,Jack Eichel,C,VGK,28,82,39,48,87
42,8477949,Alex Tuch,R,BUF,28,82,31,56,87
42,8478550,Artemi Panarin,L,NYR,33,82,27,60,87
42,8477501,Valeri Nichushkin,R,COL,29,82,44,41,85
42,8475168,Matt Duchene,C,DAL,33,82,34,51,85
42,8475167,Victor Hedman,D,TBL,34,82,20,65,85
42,8480800,Quinn Hughes,D,VAN,25,82,10,75,85
42,8480023,Robert Thomas,C,STL,25,82,19,65,84
42,8477402,Pavel Buchnevich,L,STL,29,82,35,48,83
42,8480830,Andrei Svechnikov,R,CAR,24,82,31,52,83
42,8479385,Jordan Kyrou,C,STL,26,82,42,40,82
42,8475184,Chris Kreider,L,NYR,33,82,42,40,82
42,8476459,Mika Zibanejad,C,NYR,31,82,35,47,82
42,8474600,Roman Josi,D,NSH,34,82,19,63,82
42,8476456,Jonathan Huberdeau,C,CGY,31,82,18,64,82
42,8482093,Seth Jarvis,C,CAR,22,82,39,41,80
42,8476881,Tomas Hertl,C,VGK,31,82,38,42,80
42,8476389,Vincent Trocheck,C,NYR,31,82,36,44,80
42,8477951,Nick Schmaltz,C,UTA,28,82,29,50,79
42,8478439,Travis Konecny,R,PHI,27,82,28,51,79
42,8480839,Rasmus Dahlin,D,BUF,24,82,26,53,79
42,8475692,Mats Zuccarello,R,MIN,37,82,23,56,79
42,8478427,Sebastian Aho,C,CAR,27,82,29,49,78
42,8477496,Elias Lindholm,C,BOS,30,82,27,51,78
42,8477946,Dylan Larkin,C,DET,28,82,32,45,77
42,8471215,Evgeni Malkin,C,PIT,38,82,28,49,77
42,8477955,Jared McCann,L,SEA,28,82,38,38,76
42,8478398,Kyle Connor,L,WPG,28,82,36,40,76
42,8479337,Alex DeBrincat,R,DET,27,82,34,42,76
42,8476460,Mark Scheifele,C,WPG,31,82,31,45,76
42,8477409,Carter Verhaeghe,C,FLA,29,82,30,46,76
42,8480208,Drake Batherson,R,OTT,26,82,30,46,76
42,8477504,Josh Morrissey,D,WPG,29,82,13,63,76
42,8478445,Mathew Barzal,C,NYI,27,82,24,51,75
42,8478010,Brayden Point,C,TBL,28,82,40,34,74
42,8478414,Timo Meier,R,NJD,28,82,33,41,74
42,8478407,Vince Dunn,D,SEA,28,82,17,57,74
42,8478460,Zach Werenski,D,CBJ,27,82,16,58,74
42,8480803,Evan Bouchard,D,EDM,25,82,14,60,74
42,8480014,Gabriel Vilardi,C,WPG,25,82,44,29,73
42,8474141,Patrick Kane,R,DET,36,82,25,48,73
42,8477447,Shea Theodore,D,VGK,29,82,17,56,73
42,8478474,Lawson Crouse,L,UTA,27,82,40,32,72
42,8481068,Yegor Sharangovich,C,CGY,26,82,39,33,72
42,8482097,Jack Quinn,R,BUF,23,82,28,44,72
42,8478975,Mason Marchment,L,DAL,29,82,25,47,72
42,8478440,Dylan Strome,C,WSH,27,82,24,48,72
42,8481540,Cole Caufield,R,MTL,23,82,33,38,71
42,8475166,John Tavares,C,TOR,34,82,29,42,71
42,8482665,Matty Beniers,C,SEA,22,82,27,44,71
42,8478873,Troy Terry,R,ANA,27,82,23,48,71
42,8480036,Miro Heiskanen,D,DAL,25,82,21,50,71
42,8474102,David Perron,L,OTT,36,82,29,41,70
42,8480002,Nico Hischier,C,NJD,25,82,21,49,70
42,8473512,Claude Giroux,R,OTT,36,82,19,51,70
42,8476539,Jonathan Marchessault,R,NSH,34,82,42,27,69
42,8479420,Tage Thompson,C,BUF,27,82,35,34,69
42,8482124,Quinton Byfield,R,LAK,22,82,24,45,69
42,8476869,Brady Skjei,D,NSH,30,82,15,54,69
42,8479339,Patrik Laine,L,CBJ,26,82,38,30,68
42,8481528,Dylan Cozens,C,BUF,23,82,31,37,68
42,8480018,Nick Suzuki,C,MTL,25,82,22,46,68
42,8478444,Brock Boeser,R,VAN,27,82,27,40,67
42,8471685,Anze Kopitar,C,LAK,37,82,25,42,67
42,8475158,Ryan O'Reilly,C,NSH,33,82,27,39,66
42,8480039,Martin Necas,C,CAR,25,82,31,34,65
42,8479542,Brandon Hagel,L,TBL,26,82,29,36,65
42,8475754,Brock Nelson,C,NYI,33,82,24,41,65
42,8474578,Erik Karlsson,D,PIT,34,82,19,46,65
42,8476853,Morgan Rielly,D,TOR,30,82,13,52,65
42,8477940,Nikolaj Ehlers,L,WPG,28,82,23,41,64
42,8476462,Dougie Hamilton,D,NJD,31,82,23,41,64
42,8473994,Jamie Benn,L,DAL,35,82,22,42,64
42,8478438,Tommy Novak,C,NSH,27,82,15,49,64
42,8478366,Frank Vatrano,R,ANA,30,82,35,28,63
42,8475810,Bryan Rust,R,PIT,32,82,33,30,63
42,8476448,William Karlsson,C,VGK,31,82,25,38,63
42,8475794,Tyler Seguin,C,DAL,32,82,27,35,62
42,8480015,Owen Tippett,R,PHI,25,82,25,37,62
42,8476479,Phillip Danault,C,LAK,31,82,24,38,62
42,8481596,Shane Pinto,C,OTT,24,82,24,38,62
42,8478519,Anthony Cirelli,C,TBL,27,82,24,38,62
42,8475745,Charlie Coyle,C,BOS,32,82,23,39,62
42,8476882,Teuvo Teravainen,L,CHI,30,82,20,42,62
42,8480817,K'Andre Miller,D,NYR,24,82,19,43,62
42,8481523,Kirby Dach,C,MTL,23,82,10,52,62
42,8478493,Joel Eriksson Ek,C,MIN,27,82,28,33,61
42,8480865,Noah Dobson,D,NYI,24,82,13,48,61
42,8480797,Joel Farabee,L,PHI,24,82,28,32,60
42,8477503,Max Domi,C,TOR,29,82,20,40,60
42,8475786,Zach Hyman,L,EDM,32,82,31,28,59
42,8478449,Roope Hintz,C,DAL,28,82,30,29,59
42,8479999,Casey Mittelstadt,C,COL,26,82,25,34,59
42,8475784,Jeff Skinner,C,EDM,32,82,24,35,59
42,8474150,Mikael Backlund,C,CGY,35,82,24,35,59
42,8483808,Andrei Kuzmenko,L,CGY,28,82,24,35,59
42,8482113,Anton Lundell,C,FLA,23,82,23,36,59
42,8473419,Brad Marchand,L,BOS,36,82,22,37,59
42,8480078,Filip Chytil,C,NYR,25,82,17,42,59
42,8474565,Alex Pietrangelo,D,VGK,34,82,14,45,59
42,8474679,Gustav Nyquist,C,NSH,35,82,13,46,59
42,8478498,Jake DeBrusk,L,VAN,28,82,31,27,58
42,8478042,Viktor Arvidsson,R,EDM,31,82,30,28,58
42,8478401,Pavel Zacha,C,BOS,27,82,27,31,58
42,8480798,Philipp Kurashev,C,CHI,25,82,21,37,58
42,8476875,Mike Matheson,D,MTL,30,82,15,43,58
42,8479675,Trevor Moore,L,LAK,29,82,27,30,57
42,8477500,Bo Horvat,C,NYI,29,82,24,33,57
42,8475170,Brayden Schenn,C,STL,33,82,23,34,57
42,8475798,Mikael Granlund,C,SJS,32,82,16,41,57
42,8480434,Sean Durzi,D,UTA,26,82,13,44,57
42,8470613,Brent Burns,D,CAR,39,82,9,48,57
42,8482149,Cole Perfetti,C,WPG,22,82,27,29,56
42,8482078,Lucas Raymond,L,DET,22,82,26,30,56
42,8481533,Trevor Zegras,C,ANA,23,82,24,32,56
42,8480028,Morgan Frost,C,PHI,25,82,22,34,56
42,8482146,Luke Evangelista,R,NSH,22,82,29,26,55
42,8476399,Blake Coleman,C,CGY,33,82,27,28,55
42,8477416,Oliver Bjorkstrand,R,SEA,29,82,22,33,55
42,8478047,Michael Bunting,L,PIT,29,82,20,35,55
42,8481711,Matias Maccelli,L,UTA,24,82,16,39,55
42,8479400,Pierre-Luc Dubois,L,WSH,26,82,15,40,55
42,8478469,Thomas Chabot,D,OTT,27,82,12,43,55
42,8479325,Charlie McAvoy,D,BOS,27,82,11,44,55
42,8477456,J.T. Compher,L,DET,29,82,24,30,54
42,8478856,Conor Garland,R,VAN,28,82,24,30,54
42,8478542,Evan Rodrigues,C,FLA,31,82,21,33,54
42,8477444,Andre Burakovsky,L,SEA,29,82,19,35,54
42,8477932,Aaron Ekblad,D,FLA,28,82,18,36,54
42,8477986,Brandon Montour,D,SEA,30,82,17,37,54
42,8474586,Jordan Eberle,R,SEA,34,82,15,39,54
42,8477495,Seth Jones,D,CHI,30,82,13,41,54
42,8479425,Filip Hronek,D,VAN,27,82,10,44,54
42,8477479,Tyler Bertuzzi,L,CHI,29,82,31,22,53
42,8475768,Jaden Schwartz,C,SEA,32,82,29,24,53
42,8475191,Reilly Smith,R,NYR,33,82,27,26,53
42,8475726,Tyler Toffoli,C,SJS,32,82,26,27,53
42,8477451,Ryan Hartman,R,MIN,30,82,25,28,53
42,8477935,Sam Bennett,C,FLA,28,82,23,30,53
42,8475765,Vladimir Tarasenko,R,DET,33,82,23,30,53
42,8477964,Ivan Barbashev,C,VGK,29,82,22,31,53
42,8476905,Chandler Stephenson,C,SEA,30,82,20,33,53
42,8482699,Dylan Guenther,R,UTA,21,82,20,33,53
42,8482684,Luke Hughes,D,NJD,21,82,15,38,53
42,8475722,Jason Zucker,L,BUF,32,82,28,24,52
42,8475799,Nino Niederreiter,R,WPG,32,82,26,26,52
42,8476432,Boone Jenner,C,CBJ,31,82,26,26,52
42,8475760,Nick Bjugstad,C,UTA,32,82,24,28,52
42,8476461,Sean Couturier,C,PHI,32,82,17,35,52
42,8478396,Noah Hanifin,D,VGK,27,82,14,38,52
42,8478038,Devon Toews,D,COL,30,82,13,39,52
42,8474563,Drew Doughty,D,LAK,35,82,13,39,52
42,8477998,Warren Foegele,L,LAK,28,82,26,25,51
42,8475169,Evander Kane,L,EDM,33,82,26,25,51
42,8478046,Danton Heinen,L,VAN,29,82,23,28,51
42,8480009,Eeli Tolvanen,R,SEA,25,82,21,30,51
42,8482110,Dawson Mercer,C,NJD,23,82,20,31,51
42,8478462,Nicolas Roy,C,VGK,27,82,20,31,51
42,8482745,Mason McTavish,C,ANA,21,82,17,34,51
42,8482475,Yegor Chinakhov,R,CBJ,23,82,16,35,51
42,8478397,Rasmus Andersson,D,CGY,28,82,12,39,51
42,8476792,Torey Krug,D,STL,33,82,8,43,51
42,8480188,Fabian Zetterlund,L,SJS,25,82,23,27,50
42,8473986,Alex Killorn,L,ANA,35,82,21,29,50
42,8479992,Michael Rasmussen,C,DET,25,82,21,29,50
42,8484144,Connor Bedard,C,CHI,19,82,17,33,50
42,8478055,Gustav Forsling,D,FLA,28,82,12,38,50
42,8482671,Owen Power,D,BUF,22,82,12,38,50
42,8476906,Shayne Gostisbehere,D,CAR,31,82,11,39,50
42,8482740,Wyatt Johnston,C,DAL,21,82,24,25,49
42,8480064,Josh Norris,C,OTT,25,82,24,25,49
42,8477497,Sean Monahan,C,CBJ,30,82,18,31,49
42,8477494,Jonathan Drouin,L,COL,29,82,12,37,49
42,8476458,Ryan Strome,C,ANA,31,82,12,37,49
42,8477346,MacKenzie Weegar,D,CGY,30,82,9,40,49
42,8476483,Rickard Rakell,R,PIT,31,82,26,22,48
42,8477511,Anthony Mantha,R,CGY,30,82,24,24,48
42,8482092,Ridly Greig,C,OTT,22,82,21,27,48
42,8475764,Cam Fowler,D,ANA,33,82,3,45,48
42,8482109,Alexis Lafrenière,L,NYR,23,82,29,18,47
42,8475714,Calle Jarnkrok,C,TOR,33,82,24,23,47
42,8482159,Tyson Foerster,R,PHI,22,82,21,26,47
42,8480849,Barrett Hayton,C,UTA,24,82,20,27,47
42,8480220,Noah Cates,L,PHI,25,82,19,28,47
42,8476826,Yanni Gourde,C,SEA,33,82,14,33,47
42,8475149,Marcus Johansson,L,MIN,34,82,13,34,47
42,8475287,Erik Haula,L,NJD,33,82,13,34,47
42,8476927,Teddy Blueger,C,VAN,30,82,13,34,47
42,8479410,Mikhail Sergachev,D,UTA,26,82,11,36,47
42,8477407,Anthony Duclair,L,NYI,29,82,24,22,46
42,8477476,Artturi Lehkonen,L,COL,29,82,22,24,46
42,8476880,Tom Wilson,R,WSH,30,82,21,25,46
42,8477429,Andrew Copp,C,DET,30,82,17,29,46
42,8478057,Dakota Joshua,C,VAN,28,82,21,24,45
42,8482667,William Eklund,L,SJS,22,82,20,25,45
42,8481604,Pavel Dorofeyev,L,VGK,24,82,20,25,45
42,8478233,Andrew Mangiapane,L,WSH,28,82,18,27,45
42,8480185,Eetu Luostarinen,C,FLA,26,82,17,28,45
42,8478133,Jake Evans,C,MTL,28,82,16,29,45
42,8477498,Darnell Nurse,D,EDM,29,82,14,31,45
42,8478413,Jordan Greenway,L,BUF,27,82,13,32,45
42,8471724,Kris Letang,D,PIT,37,82,12,33,45
42,8477948,Travis Sanheim,D,PHI,28,82,10,35,45
42,8476931,Jake McCabe,D,TOR,31,82,4,41,45
42,8474641,Adam Henrique,C,EDM,34,82,20,24,44
42,8481560,Arthur Kaliyev,R,LAK,23,82,16,28,44
42,8481581,Thomas Harley,D,DAL,23,82,15,29,44
42,8483515,Juraj Slafkovsky,L,MTL,20,82,15,29,44
42,8482175,JJ Peterka,R,BUF,22,82,14,30,44
42,8476480,Vladislav Namestnikov,C,WPG,32,82,13,31,44
42,8471698,T.J. Oshie,R,WSH,38,82,25,18,43
42,8475793,Ryan Johansen,C,PHI,32,82,24,19,43
42,8479525,Ross Colton,C,COL,28,82,23,20,43
42,8480829,Jesperi Kotkaniemi,C,CAR,24,82,23,20,43
42,8474053,Logan Couture,C,SJS,35,82,21,22,43
42,8481656,Aliaksei Protas,C,WSH,23,82,13,30,43
42,8474590,John Carlson,D,WSH,34,82,12,31,43
42,8476923,Damon Severson,D,CBJ,30,82,7,36,43
42,8480068,Ryan Poehling,C,PHI,25,82,21,21,42
42,8482055,Drew O'Connor,L,PIT,26,82,19,23,42
42,8477021,Alex Kerfoot,C,UTA,30,82,12,30,42
42,8480145,Neal Pionk,D,WPG,29,82,10,32,42
42,8481542,Moritz Seider,D,DET,23,82,6,36,42
42,8476918,Jimmy Vesey,L,NYR,31,82,25,16,41
42,8478463,Anthony Beauvillier,L,PIT,27,82,23,18,41
42,8477953,Kasperi Kapanen,R,STL,28,82,17,24,41
42,8478472,Mathieu Joseph,R,STL,27,82,16,25,41
42,8482660,Kent Johnson,C,CBJ,22,82,15,26,41
42,8475218,Mattias Ekholm,D,EDM,34,82,13,28,41
42,8478458,Jack Roslovic,C,CAR,27,82,10,31,41
42,8473422,Nick Foligno,L,CHI,37,82,25,15,40
42,8480459,Pius Suter,C,VAN,28,82,24,16,40
42,8475151,Kyle Palmieri,C,NYI,33,82,22,18,40
42,8482720,Matthew Knies,L,TOR,22,82,12,28,40
42,8475200,Dmitry Orlov,D,CAR,33,82,12,28,40
42,8475753,Justin Faulk,D,STL,32,82,11,29,40
42,8475314,Anders Lee,L,NYI,34,82,22,17,39
42,8480113,Alex Iafallo,L,WPG,31,82,18,21,39
42,8478891,Mason Appleton,C,WPG,28,82,18,21,39
42,8475791,Taylor Hall,L,CHI,33,82,16,23,39
42,8476392,Adam Lowry,C,WPG,31,82,14,25,39
42,8479351,Sam Steel,C,DAL,26,82,14,25,39
42,8481546,Cam York,D,PHI,23,82,13,26,39
42,8479353,Brett Howden,C,VGK,26,82,13,26,39
42,8477507,Nikita Zadorov,D,BOS,29,82,10,29,39
42,8476958,Jaccob Slavin,D,CAR,30,82,5,34,39
42,8481618,Alex Newhook,C,MTL,23,82,21,17,38
42,8476925,Colton Sissons,C,NSH,31,82,18,20,38
42,8481013,Jonatan Berggren,R,DET,24,82,15,23,38
42,8476872,Scott Laughton,C,PHI,30,82,13,25,38
42,8482122,Brock Faber,D,MIN,22,82,13,25,38
42,8476885,Jacob Trouba,D,NYR,30,82,10,28,38
42,8475763,Kevin Hayes,R,PIT,32,82,18,19,37
42,8480802,Ryan McLeod,C,BUF,25,82,17,20,37
42,8473563,Nicklas Backstrom,C,WSH,37,82,17,20,37
42,8479345,Jakob Chychrun,D,WSH,26,82,14,23,37
42,8475848,Brendan Gallagher,R,MTL,32,82,13,24,37
42,8477947,Sonny Milano,L,WSH,28,82,11,26,37
42,8477919,Frederick Gaudreau,C,MIN,31,82,6,31,37
42,8481582,Nicholas Robertson,L,TOR,23,82,17,19,36
42,8479591,Michael Eyssimont,C,TBL,28,82,15,21,36
42,8477450,Jason Dickinson,C,CHI,29,82,14,22,36
42,8474716,Jared Spurgeon,D,MIN,35,82,10,26,36
42,8482105,Jake Sanderson,D,OTT,22,82,10,26,36
42,8476292,Ondrej Palat,L,NJD,33,82,8,28,36
42,8481606,Jordan Spence,D,LAK,23,82,8,28,36
42,8475462,Radko Gudas,D,ANA,34,82,6,30,36
42,8482089,Jake Neighbours,L,STL,22,82,23,12,35
42,8476469,Joel Armia,R,MTL,31,82,22,13,35
42,8474189,Lars Eller,C,PIT,35,82,17,18,35
42,8477426,Nicholas Paul,L,TBL,29,82,16,19,35
42,8476889,Radek Faksa,C,STL,30,82,16,19,35
42,8476329,Travis Boyd,C,MIN,31,82,15,20,35
42,8480336,Sean Walker,D,CAR,30,82,13,22,35
42,8476419,Jean-Gabriel Pageau,C,NYI,32,82,10,25,35
42,8476892,Colton Parayko,D,STL,31,82,4,31,35
42,8480893,Kirill Marchenko,R,CBJ,24,82,23,11,34
42,8476981,Josh Anderson,R,MTL,30,82,18,16,34
42,8480835,Jack Drury,C,CAR,24,82,17,17,34
42,8478020,Michael Amadio,C,OTT,28,82,16,18,34
42,8475193,Tomas Tatar,L,NJD,34,82,16,18,34
42,8481624,Ilya Mikheyev,R,CHI,30,82,15,19,34
42,8477839,Conor Sheary,L,TBL,32,82,15,19,34
42,8474149,Evgenii Dadonov,R,DAL,35,82,13,21,34
42,8481186,Logan O'Connor,R,COL,28,82,12,22,34
42,8476854,Hampus Lindholm,D,BOS,30,82,6,28,34
42,8474574,Tyler Myers,D,VAN,34,82,6,28,34
42,8479976,Juuso Valimaki,D,UTA,26,82,5,29,34
42,8475181,Nick Leddy,D,STL,33,82,3,31,34
42,8477952,Robby Fabbri,C,ANA,28,82,19,14,33
42,8479941,Justin Danforth,R,CBJ,31,82,19,14,33
42,8479293,Brandon Tanev,L,SEA,33,82,17,16,33
42,8475343,Nic Dowd,C,WSH,34,82,16,17,33
42,8478115,Pierre Engvall,L,NYI,28,82,12,21,33
42,8482133,Thomas Bordeleau,C,SJS,22,82,7,26,33
42,8478882,Vladislav Gavrikov,D,LAK,29,82,7,26,33
42,8482245,Artem Zub,D,OTT,29,82,6,27,33
42,8476917,Adam Pelech,D,NYI,30,82,6,27,33
42,8483431,Logan Cooley,C,UTA,20,82,22,10,32
42,8481554,Kaapo Kakko,R,NYR,23,82,19,13,32
42,8477987,Ryan Donato,C,CHI,28,82,17,15,32
42,8476278,Colin Blackwell,C,DAL,31,82,14,18,32
42,8476474,Stefan Noesen,R,NJD,31,82,14,18,32
42,8476897,Oskar Sundqvist,C,STL,30,82,12,20,32
42,8482624,Daniil Miromanov,D,CGY,27,82,12,20,32
42,8479661,Tanner Jeannot,L,LAK,27,82,11,21,32
42,8481553,Bobby Brink,R,PHI,23,82,11,21,32
42,8477369,Carson Soucy,D,VAN,30,82,10,22,32
42,8476979,Erik Gustafsson,D,DET,32,82,9,23,32
42,8478569,Noel Acciari,C,PIT,33,82,9,23,32
42,8477488,Brett Pesce,D,NJD,30,82,8,24,32
42,8480281,Alexey Toropchenko,R,STL,25,82,22,9,31
42,8481535,Nils Hoglander,L,VAN,24,82,18,13,31
42,8481580,Connor McMichael,C,WSH,23,82,17,14,31
42,8479365,Trent Frederic,C,BOS,26,82,16,15,31
42,8482062,Cole Smith,L,NSH,29,82,16,15,31
42,8470621,Corey Perry,R,EDM,39,82,14,17,31
42,8479998,Mikey Anderson,D,LAK,25,82,8,23,31
42,8480873,Rasmus Sandin,D,WSH,24,82,7,24,31
42,8478507,John Marino,D,UTA,27,82,5,26,31
42,8473507,Jeff Petry,D,DET,37,82,5,26,31
42,8478851,Alexandre Carrier,D,NSH,28,82,2,29,31
42,8482079,Marco Rossi,C,MIN,23,82,18,12,30
42,8481704,Juuso Parssinen,C,NSH,23,82,16,14,30
42,8476438,Brandon Saad,L,STL,32,82,14,16,30
42,8484166,Adam Fantilli,C,CBJ,20,82,14,16,30
42,8482702,Logan Stankoven,C,DAL,21,82,12,18,30
42,8482705,Cole Sillinger,C,CBJ,21,82,11,19,30
42,8480855,Jack McBain,C,UTA,24,82,9,21,30
42,8475171,Oliver Ekman-Larsson,D,TOR,33,82,8,22,30
42,8476873,Mark Jankowski,C,NSH,30,82,8,22,30
42,8480043,Timothy Liljegren,D,TOR,25,82,4,26,30
42,8479371,Dante Fabbro,D,NSH,26,82,3,27,30
42,8478508,Yakov Trenin,C,MIN,27,82,19,10,29
42,8481032,Paul Cotter,C,NJD,25,82,14,15,29
42,8478013,Jake Walman,D,SJS,28,82,13,16,29
42,8480813,Joe Veleno,C,DET,24,82,12,17,29
42,8479987,Morgan Geekie,C,BOS,26,82,10,19,29
42,8475220,Marcus Foligno,L,MIN,33,82,10,19,29
42,8480748,Kiefer Sherwood,L,VAN,29,82,9,20,29
42,8479402,Jake Bean,D,CGY,26,82,7,22,29
42,8479996,Cody Glass,C,NSH,25,82,16,12,28
42,8482111,Justin Barron,D,MTL,23,82,13,15,28
42,8476960,Andreas Athanasiou,C,CHI,30,82,9,19,28
42,8481522,Peyton Krebs,C,BUF,23,82,9,19,28
42,8476902,Esa Lindell,D,DAL,30,82,5,23,28
42,8476879,Cody Ceci,D,EDM,31,82,4,24,28
42,8473533,Jordan Staal,C,CAR,36,82,17,10,27
42,8480789,Oliver Wahlstrom,R,NYI,24,82,15,12,27
42,8474715,Cam Atkinson,R,TBL,35,82,13,14,27
42,8476878,Zemgus Girgensons,L,TBL,30,82,13,14,27
42,8480074,Alexandre Texier,C,STL,25,82,12,15,27
42,8482141,Lukas Cormier,D,VGK,22,82,11,16,27
42,8482117,Lukas Reichel,L,CHI,22,82,9,18,27
42,8477989,Christian Dvorak,C,MTL,28,82,9,18,27
42,8480246,Nick Perbix,D,TBL,26,82,8,19,27
42,8481178,Egor Zamula,D,PHI,24,82,5,22,27
42,8483565,Nick Blankenburg,D,NSH,26,82,4,23,27
42,8476331,Dylan DeMelo,D,WPG,31,82,0,27,27
42,8476921,Jordan Martinook,L,CAR,32,82,13,13,26
42,8479390,Taylor Raddysh,R,WSH,26,82,13,13,26
42,8479359,Beck Malenstyn,L,BUF,26,82,13,13,26
42,8478434,Keegan Kolesar,R,VGK,27,82,10,16,26
42,8476457,Adam Larsson,D,SEA,32,82,9,17,26
42,8482655,J.J. Moser,D,TBL,24,82,7,19,26
42,8477931,Tomas Nosek,L,FLA,32,82,7,19,26
42,8480871,Adam Boqvist,D,FLA,24,82,6,20,26
42,8480144,David Kampf,C,TOR,29,82,5,21,26
42,8477845,Trevor van Riemsdyk,D,WSH,33,82,5,21,26
42,8476312,Josh Manson,D,COL,33,82,5,21,26
42,8475324,Nick Jensen,D,OTT,34,82,4,22,26
42,8476525,Colin Miller,D,WPG,32,82,3,23,26
42,8478840,Will Borgen,D,SEA,28,82,2,24,26
42,8477505,Alexander Wennberg,C,SJS,30,82,14,11,25
42,8478432,Christian Fischer,R,DET,27,82,11,14,25
42,8480025,MacKenzie Entwistle,R,FLA,25,82,11,14,25
42,8477353,Tyler Motte,C,DET,29,82,10,15,25
42,8477508,Curtis Lazar,C,NJD,29,82,10,15,25
42,8477903,Garnet Hathaway,R,PHI,33,82,9,16,25
42,8483468,Jiri Kulich,C,BUF,20,82,7,18,25
42,8476422,Mike Reilly,D,NYI,31,82,7,18,25
42,8478911,Matt Roy,D,WSH,29,82,6,19,25
42,8479983,Mario Ferraro,D,SJS,26,82,3,22,25
42,8474673,TJ Brodie,D,CHI,34,82,3,22,25
42,8480995,Pontus Holmberg,R,TOR,25,82,16,8,24
42,8477392,Hudson Fasching,R,NYI,29,82,14,10,24
42,8478109,Victor Olofsson,L,VGK,29,82,13,11,24
42,8475842,Sam Carrick,C,NYR,32,82,12,12,24
42,8481517,Brett Leason,R,ANA,25,82,12,12,24
42,8480003,Jesper Boqvist,C,FLA,26,82,11,13,24
42,8477406,Mattias Janmark,C,EDM,32,82,11,13,24
42,8476442,Matt Nieto,L,PIT,32,82,8,16,24
42,8482807,Ethan Del Mastro,D,CHI,21,82,8,16,24
42,8484153,Leo Carlsson,C,ANA,20,82,8,16,24
42,8479316,Luke Kunin,C,SJS,27,82,7,17,24
42,8477015,Connor Brown,R,EDM,30,82,6,18,24
42,8477365,Connor Clifton,D,BUF,29,82,6,18,24
42,8481014,Alexander Romanov,D,NYI,24,82,5,19,24
42,8478468,Jeremy Lauzon,D,NSH,27,82,4,20,24
42,8480049,Dylan Samberg,D,WPG,25,82,2,22,24
42,8480807,Mattias Samuelsson,D,BUF,24,82,2,22,24
42,8481028,Martin Pospisil,C,CGY,25,82,14,9,23
42,8483445,Cutter Gauthier,L,ANA,20,82,11,12,23
42,8482155,Alex Laferriere,R,LAK,23,82,11,12,23
42,8480980,Connor Dewar,C,TOR,25,82,10,13,23
42,8482077,Dylan Holloway,L,EDM,23,82,10,13,23
42,8481093,Rafael Harvey-Pinard,L,MTL,25,82,9,14,23
42,8481601,Simon Holmstrom,R,NYI,23,82,9,14,23
42,8482125,Alexander Holtz,R,VGK,22,82,9,14,23
42,8481641,Joel Kiviranta,L,COL,28,82,9,14,23
42,8483482,Tristan Luneau,D,ANA,20,82,8,15,23
42,8480073,Erik Brannstrom,D,COL,25,82,5,18,23
42,8475790,Erik Gudbranson,D,CBJ,32,82,5,18,23
42,8477969,Marcus Pettersson,D,PIT,28,82,4,19,23
42,8479324,Ryan Lindgren,D,NYR,26,82,4,19,23
42,8476463,Jonas Brodin,D,MIN,31,82,2,21,23
42,8482073,Braden Schneider,D,NYR,23,82,0,23,23
42,8481699,Aku Raty,R,UTA,23,82,13,9,22
42,8479393,Noah Gregor,C,OTT,26,82,11,11,22
42,8480448,Parker Kelly,L,COL,25,82,11,11,22
42,8482074,Connor Zary,C,CGY,23,82,11,11,22
42,8482470,Ilya Solovyov,D,CGY,24,82,10,12,22
42,8483524,Shane Wright,C,SEA,20,82,10,12,22
42,8480806,Isac Lundestrom,C,ANA,25,82,9,13,22
42,8484145,Zach Benson,L,BUF,19,82,8,14,22
42,8477506,Ryan Pulock,D,NYI,30,82,6,16,22
42,8475279,Ben Chiarot,D,DET,33,82,5,17,22
42,8483763,Maksymilian Szuber,D,UTA,22,82,5,17,22
42,8475188,Brayden McNabb,D,VGK,33,82,4,18,22
42,8482087,Kaiden Guhle,D,MTL,22,82,3,19,22
42,8480860,Kevin Bahl,D,CGY,24,82,3,19,22
42,8478859,Niko Mikkola,D,FLA,28,82,3,19,22
42,8478399,Jonas Siegenthaler,D,NJD,27,82,2,20,22
42,8478500,Ivan Provorov,D,CBJ,27,82,1,21,22
42,8480021,Jack Studnicka,C,LAK,25,82,12,9,21
42,8476624,Barclay Goodrow,C,SJS,31,82,11,10,21
42,8482803,Olen Zellweger,D,ANA,21,82,11,10,21
42,8479414,Nathan Bastian,R,NJD,27,82,10,11,21
42,8483495,Simon Nemec,D,NJD,20,82,10,11,21
42,8482733,Logan Mailloux,D,MTL,31,82,10,11,21
42,8477335,Kyle Burroughs,D,LAK,29,82,8,13,21
42,8483493,Frank Nazar,C,CHI,20,82,7,14,21
42,8480990,Declan Chisholm,D,MIN,24,82,6,15,21
42,8476467,Jamie Oleksiak,D,SEA,32,82,6,15,21
42,8480796,Martin Fehervary,D,WSH,25,82,5,16,21
42,8481481,Blake Lizotte,C,PIT,27,82,5,16,21
42,8482666,Scott Morrow,D,CAR,22,82,5,16,21
42,8479398,Samuel Girard,D,COL,26,82,2,19,21
42,8481477,Nico Sturm,C,SJS,29,82,15,5,20
42,8477425,Miles Wood,L,COL,29,82,10,10,20
42,8478211,Dryden Hunt,L,CGY,29,82,10,10,20
42,8484149,Gavin Brindley,C,CBJ,20,82,8,12,20
42,8475762,Derek Forbort,D,VAN,32,82,8,12,20
42,8479980,Nicolas Hague,D,VGK,26,82,6,14,20
42,8477220,Nate Schmidt,D,FLA,33,82,4,16,20
42,8480878,Nils Lundkvist,D,DAL,24,82,3,17,20
42,8475455,Brenden Dillon,D,NJD,34,82,2,18,20
42,8481568,Alex Vlasic,D,CHI,23,82,1,19,20
42,8482762,Simon Edvinsson,D,DET,21,82,10,9,19
42,8483505,Matthew Poitras,C,BOS,20,82,10,9,19
42,8482259,Bobby McMann,C,TOR,28,82,9,10,19
42,8476374,Sean Kuraly,C,CBJ,31,82,9,10,19
42,8484203,Bradly Nadeau,L,CAR,19,82,8,11,19
42,8475231,Casey Cizikas,C,NYI,33,82,7,12,19
42,8483490,Pavel Mintyukov,D,ANA,21,82,7,12,19
42,8482679,Matt Coronato,R,CGY,22,82,7,12,19
42,8482858,Ryker Evans,D,SEA,23,82,6,13,19
42,8475177,Calvin de Haan,D,COL,33,82,6,13,19
42,8476891,Matt Grzelcyk,D,PIT,30,82,0,19,19
42,8479368,Max Jones,L,BOS,26,82,8,10,18
42,8482153,Brendan Brisson,C,VGK,23,82,7,11,18
42,8477499,Rasmus Ristolainen,D,PHI,30,82,5,13,18
42,8478443,Brandon Carlo,D,BOS,28,82,5,13,18
42,8480222,Sebastian Aho,D,PIT,28,82,4,14,18
42,8480035,Henri Jokiharju,D,BUF,25,82,4,14,18
42,8478136,Jake Middleton,D,MIN,28,82,3,15,18
42,8479291,Kevin Rooney,C,CGY,31,82,7,10,17
42,8482145,Mavrik Bourque,C,DAL,22,82,5,12,17
42,8481708,Zac Jones,D,NYR,24,82,5,12,17
42,8478450,Parker Wotherspoon,D,BOS,27,82,3,14,17
42,8475233,David Savard,D,MTL,34,82,3,14,17
42,8480172,Jan Rutta,D,SJS,34,82,3,14,17
42,8474151,Ryan McDonagh,D,TBL,35,82,1,16,17
42,8474013,Ian Cole,D,UTA,35,82,1,16,17
42,8475690,Chris Tanev,D,TOR,35,82,0,17,17
42,8482749,Joshua Roy,R,MTL,21,82,9,7,16
42,8482118,Sam Colangelo,R,ANA,23,82,9,7,16
42,8477938,Haydn Fleury,D,WPG,28,82,7,9,16
42,8481524,Bowen Byram,D,BUF,23,82,6,10,16
42,8483471,Brad Lambert,C,WPG,31,82,6,10,16
42,8477034,Jaycob Megna,D,FLA,32,82,6,10,16
42,8483499,Liam Ohgren,L,MIN,20,82,5,11,16
42,8482101,Danil Gushchin,L,SJS,22,82,5,11,16
42,8482712,Oskar Olausson,R,COL,22,82,4,12,16
42,8474567,Zach Bogosian,D,MIN,34,82,4,12,16
42,8470600,Ryan Suter,D,STL,39,82,3,13,16
42,8477435,Ryan Graves,D,PIT,29,82,2,14,16
42,8481567,Henry Thrun,D,SJS,23,82,2,14,16
42,8478416,Erik Cernak,D,TBL,27,82,0,16,16
42,8476858,Phillip Di Giuseppe,L,VAN,31,82,11,4,15
42,8483397,Marc McLaughlin,C,BOS,25,82,11,4,15
42,8482659,Josh Doan,R,UTA,22,82,8,7,15
42,8482787,Nikita Chibrikov,R,WPG,31,82,6,9,15
42,8482166,Shakir Mukhamadullin,D,SJS,22,82,4,11,15
42,8483466,Kevin Korchinski,D,CHI,20,82,4,11,15
42,8482142,Jamie Drysdale,D,PHI,22,82,2,13,15
42,8478178,Darren Raddysh,D,TBL,28,82,2,13,15
42,8476372,Nick Seeler,D,PHI,31,82,2,13,15
42,8481122,Simon Benoit,D,TOR,26,82,1,14,15
42,8476441,Joel Edmundson,D,LAK,31,82,1,14,15
42,8480870,Bo Groulx,C,NYR,24,82,9,5,14
42,8479638,Justin Brazeau,R,BOS,26,82,9,5,14
42,8475855,Jesper Fast,R,CAR,33,82,6,8,14
42,8476967,Brett Kulak,D,EDM,30,82,4,10,14
42,8476473,Connor Murphy,D,CHI,31,82,4,10,14
42,8482516,Matthew Kessel,D,STL,24,82,3,11,14
42,8479369,Andrew Peeke,D,BOS,26,82,0,14,14
42,8473453,Trevor Lewis,C,LAK,37,82,5,8,13
42,8482809,Jackson Blake,R,CAR,21,82,4,9,13
42,8476429,Scott Mayfield,D,NYI,32,82,4,9,13
42,8480879,Jacob Bernard-Docker,D,OTT,24,82,4,9,13
42,8481605,Jackson LaCombe,D,ANA,23,82,4,9,13
42,8483457,Lane Hutson,D,MTL,20,82,3,10,13
42,8471677,Jack Johnson,D,CBJ,37,82,3,10,13
42,8480950,Ilya Lyubushkin,D,DAL,30,82,2,11,13
42,8476822,Luke Glendening,C,TBL,35,82,8,4,12
42,8484911,Collin Graf,R,SJS,22,82,1,11,12
42,8475718,Justin Holl,D,DET,32,82,1,11,12
42,8478874,Adam Gaudette,C,OTT,28,82,1,11,12
42,8482713,Mackie Samoskevich,R,FLA,22,82,5,6,11
42,8483012,Logan Morrison,C,SEA,22,82,4,7,11
42,8482070,Mitchell Chaffee,R,TBL,26,82,5,5,10
42,8483460,David Jiricek,D,CBJ,21,82,4,6,10
42,8482859,Zack Ostapchuk,C,OTT,21,82,4,6,10
42,8479442,Troy Stecher,D,EDM,30,82,3,7,10
42,8483567,Georgii Merkulov,C,BOS,24,82,3,7,10
42,8479576,Vincent Desharnais,D,VAN,28,82,0,10,10
42,8483489,Fraser Minten,C,TOR,31,82,4,5,9
42,8480834,Ty Emberson,D,SJS,24,82,3,6,9
42,8474090,Brendan Smith,D,DAL,35,82,2,7,9
42,8474612,Travis Hamonic,D,OTT,34,82,0,6,6
42,8474062,Riley Nash,C,NYR,35,82,1,4,5
42,8470794,Joe Pavelski,C,,40,0,0,0,0
42,8481703,Valtteri Puustinen,R,PIT,25,0,0,0,0
42,8477950,Tony DeAngelo,D,,29,0,0,0,0
42,8481577,Philip Tomasino,C,NSH,23,0,0,0,0
42,8475197,Tyson Barrie,D,,33,0,0,0,0
42,8471218,Blake Wheeler,R,,38,0,0,0,0
42,8474157,Max Pacioretty,L,,36,0,0,0,0
42,8478466,Daniel Sprong,R,VAN,27,0,0,0,0
42,8475744,Evgeny Kuznetsov,C,,32,0,0,0,0
42,8481019,David Gustafsson,C,WPG,24,0,0,0,0
42,8475906,John Klingberg,D,,32,0,0,0,0
42,8479348,Kale Clague,D,BUF,26,0,0,0,0
42,8476952,Dominic Toninato,C,WPG,30,0,0,0,0
42,8473473,Milan Lucic,L,,36,0,0,0,0
42,8474037,James van Riemsdyk,L,,35,0,0,0,0
42,8474602,Justin Schultz,D,,34,0,0,0,0
42,8482222,Alexander Barabanov,L,,30,0,0,0,0
42,8479372,Josh Mahura,D,SEA,26,0,0,0,0
42,8479982,Conor Timmins,D,TOR,26,0,0,0,0
42,8474031,Kevin Shattenkirk,D,,35,0,0,0,0
42,8480008,Adam Ruzicka,C,,25,0,0,0,0
42,8481059,Scott Perunovich,D,STL,26,0,0,0,0
42,8480884,Calen Addison,D,,24,0,0,0,0
42,8476994,Vinnie Hinostroza,C,NSH,30,0,0,0,0
42,8478452,Caleb Jones,D,LAK,27,0,0,0,0
42,8480157,Calle Rosen,D,COL,30,0,0,0,0
42,8481609,Vladislav Kolyachonok,D,UTA,23,0,0,0,0
42,8479415,Michael McLeod,C,,26,0,0,0,0
42,8476919,Chris Tierney,C,,30,0,0,0,0
42,8479639,Dylan Coghlan,D,WPG,26,0,0,0,0
42,8478146,Matthew Highmore,C,OTT,28,0,0,0,0
42,8478970,Jalen Chatfield,D,CAR,28,0,0,0,0
42,8480205,Emil Bemstrom,C,PIT,25,0,0,0,0
42,8474884,Mike Hoffman,C,,35,0,0,0,0
42,8471274,Alex Goligoski,D,,39,0,0,0,0
42,8478104,Sammy Blais,L,,28,0,0,0,0
42,8474870,Tyler Johnson,C,,34,0,0,0,0
42,8476913,Devin Shore,C,MIN,30,0,0,0,0
42,8481598,Philip Broberg,D,EDM,23,0,0,0,0
42,8480058,Pierre-Olivier Joseph,D,STL,25,0,0,0,0
42,8480891,Michael Kesselring,D,UTA,24,0,0,0,0
42,8477979,Nicolas Aube-Kubel,R,BUF,28,0,0,0,0
42,8476871,Tanner Pearson,L,,32,0,0,0,0
42,8476393,Nick Cousins,C,,31,0,0,0,0
42,8479977,Kailer Yamamoto,R,,26,0,0,0,0
42,8479543,Michael Pezzetta,L,MTL,26,0,0,0,0
42,8477018,Ben Hutton,D,VGK,31,0,0,0,0
42,8480762,Eric Robinson,L,CAR,29,0,0,0,0
42,8474034,Pat Maroon,L,CHI,36,0,0,0,0
42,8481058,Jesse Ylönen,R,,25,0,0,0,0
42,8475179,Dmitry Kulikov,D,FLA,34,0,0,0,0
42,8481527,Kaedan Korczak,D,VGK,23,0,0,0,0
42,8473449,Kyle Okposo,R,,36,0,0,0,0
42,8482192,Isaak Phillips,D,CHI,23,0,0,0,0
42,8480727,Zach Whitecloud,D,VGK,28,0,0,0,0
42,8479346,Dillon Dube,C,,26,0,0,0,0
42,8480821,Filip Zadina,R,,25,0,0,0,0
42,8480001,Urho Vaakanainen,D,ANA,25,0,0,0,0
42,8470966,Mark Giordano,D,,41,0,0,0,0
42,8480853,Liam Foudy,C,,24,0,0,0,0
42,8475225,Craig Smith,C,CHI,35,0,0,0,0
42,8479972,Mason Shaw,C,WPG,26,0,0,0,0
42,8478451,Ethan Bear,D,WSH,27,0,0,0,0
42,8474040,Sam Gagner,C,,35,0,0,0,0
42,8480196,Jacob Bryson,D,BUF,27,0,0,0,0
42,8479984,Cal Foote,D,,26,0,0,0,0
42,8480011,Klim Kostin,C,SJS,25,0,0,0,0
42,8482176,Wyatt Kaiser,D,CHI,22,0,0,0,0
42,8476988,Matt Benning,D,SJS,30,0,0,0,0
42,8479370,Tyson Jost,C,CAR,26,0,0,0,0
42,8477464,Nic Petan,C,,29,0,0,0,0
42,8477380,Jonny Brodzinski,C,NYR,31,0,0,0,0
42,8480070,Ian Mitchell,D,BOS,25,0,0,0,0
42,8479315,Joey Anderson,R,CHI,26,0,0,0,0
42,8478099,Kevin Labanc,R,,29,0,0,0,0
42,8476874,Olli Maatta,D,DET,30,0,0,0,0
42,8475208,Brian Dumoulin,D,ANA,33,0,0,0,0
42,8478430,Oliver Kylington,D,,27,0,0,0,0
42,8479536,Axel Jonsson-Fjallby,L,WPG,26,0,0,0,0
42,8479671,Mathieu Olivier,R,CBJ,27,0,0,0,0
42,8471709,Marc-Edouard Vlasic,D,SJS,37,0,0,0,0
42,8479328,Julien Gauthier,R,NYI,27,0,0,0,0
42,8478421,A.J. Greer,L,FLA,28,0,0,0,0
42,8477573,Nathan Walker,L,STL,30,0,0,0,0
42,8481537,Nikita Okhotiuk,D,CGY,24,0,0,0,0
42,8474166,Alec Martinez,D,CHI,37,0,0,0,0
42,8470610,Zach Parise,L,,40,0,0,0,0
42,8477478,William Carrier,L,CAR,30,0,0,0,0
42,8479344,Jesse Puljujarvi,R,PIT,26,0,0,0,0
42,8480887,Jordan Harris,D,MTL,24,0,0,0,0
42,8478502,Dennis Gilbert,D,BUF,28,0,0,0,0
42,8482730,Brandt Clarke,D,LAK,21,0,0,0,0
42,8480355,Mark Kastelic,C,BOS,25,0,0,0,0
42,8475750,Jon Merrill,D,MIN,32,0,0,0,0
42,8475164,Jakob Silfverberg,R,,34,0,0,0,0
42,8477944,Jakub Vrana,L,,28,0,0,0,0
42,8479439,Jacob MacDonald,D,COL,31,0,0,0,0
42,8474568,Luke Schenn,D,NSH,35,0,0,0,0
42,8478454,Noah Juulsen,D,VAN,27,0,0,0,0
42,8475752,Tyler Pitlick,C,,33,0,0,0,0
42,8482148,Hendrix Lapierre,C,WSH,22,0,0,0,0
42,8481167,Brayden Pachal,D,CGY,25,0,0,0,0
42,8478043,Sam Lafferty,C,BUF,29,0,0,0,0
42,8479321,Lucas Johansen,D,,27,0,0,0,0
42,8471699,Andrew Cogliano,C,,37,0,0,0,0
42,8481521,Ronnie Attard,D,PHI,25,0,0,0,0
42,8481161,Jake Christiansen,D,CBJ,25,0,0,0,0
42,8479458,Nikita Zaitsev,D,,33,0,0,0,0
42,8479619,Michael Carcone,L,UTA,28,0,0,0,0
42,8479026,Philippe Myers,D,TOR,27,0,0,0,0
42,8477330,Dominik Kubalik,L,,29,0,0,0,0
42,8481617,Vasily Podkolzin,R,VAN,23,0,0,0,0
42,8481701,Santeri Hatakka,D,NJD,23,0,0,0,0
42,8479514,Rem Pitlick,C,,27,0,0,0,0
42,8477446,Michael McCarron,R,NSH,29,0,0,0,0
42,8470604,Jeff Carter,C,,39,0,0,0,0
42,8482241,Radim Zohorna,L,,28,0,0,0,0
42,8480289,Morgan Barron,C,WPG,26,0,0,0,0
42,8479379,Givani Smith,R,SJS,26,0,0,0,0
42,8480216,Jacob Peterson,C,,25,0,0,0,0
42,8477851,Jordan Oesterle,D,BOS,32,0,0,0,0
42,8484258,Sam Malinski,D,COL,26,0,0,0,0
42,8478904,Steven Lorentz,C,,28,0,0,0,0
42,8482095,Tyler Kleven,D,OTT,22,0,0,0,0
42,8480848,Ty Dellandrea,C,SJS,24,0,0,0,0
42,8476884,Derrick Pouliot,D,,30,0,0,0,0
42,8479336,Carl Grundstrom,R,SJS,27,0,0,0,0
42,8482964,Arber Xhekaj,D,MTL,23,0,0,0,0
42,8471686,Marc Staal,D,,37,0,0,0,0
42,8477887,Patrick Brown,C,BOS,32,0,0,0,0
42,8478495,Denis Gurianov,R,,27,0,0,0,0
42,8473504,Cal Clutterbuck,R,,37,0,0,0,0
42,8481550,Adam Beckman,L,NJD,23,0,0,0,0
42,8480845,Rasmus Kupari,C,WPG,24,0,0,0,0
42,8474009,Nick Bonino,C,,36,0,0,0,0
42,8478585,Derek Ryan,C,EDM,38,0,0,0,0
42,8477962,Brendan Lemieux,L,CAR,28,0,0,0,0
42,8482861,Vincent Iorio,D,WSH,22,0,0,0,0
42,8479378,Logan Stanley,D,WPG,26,0,0,0,0
42,8473446,Erik Johnson,D,PHI,36,0,0,0,0
42,8481743,Marc Del Gaizo,D,NSH,25,0,0,0,0
42,8477384,Josh Brown,D,EDM,30,0,0,0,0
42,8482165,Yan Kuznetsov,D,CGY,22,0,0,0,0
42,8478424,Jansen Harkins,C,ANA,27,0,0,0,0
42,8482144,Jack Thompson,D,SJS,22,0,0,0,0
42,8478512,Austin Czarnik,C,,32,0,0,0,0
42,8477527,Ross Johnston,L,ANA,30,0,0,0,0
42,8479383,Boris Katchouk,L,,26,0,0,0,0
42,8482094,Daemon Hunt,D,MIN,22,0,0,0,0
42,8481719,Maxwell Crozier,D,TBL,24,0,0,0,0
42,8480192,Johnathan Kovacevic,D,NJD,27,0,0,0,0
42,8479376,Victor Mete,D,,26,0,0,0,0
42,8482511,Mason Lohrei,D,BOS,23,0,0,0,0
42,8475825,Jani Hakanpää,D,,32,0,0,0,0
42,8478021,William Lagesson,D,DET,28,0,0,0,0
42,8475795,Dylan McIlrath,D,WSH,32,0,0,0,0
42,8477846,Ryan Carpenter,C,,33,0,0,0,0
42,8481056,Spencer Stastney,D,NSH,24,0,0,0,0
42,8481564,Ryan Johnson,D,BUF,23,0,0,0,0
42,8478017,Mark Friedman,D,VAN,29,0,0,0,0
42,8479320,Max Lajoie,D,SEA,27,0,0,0,0
42,8480075,Cameron Crotty,D,MIN,25,0,0,0,0
42,8484287,Cole McWard,D,VAN,23,0,0,0,0
42,8484254,Akito Hirose,D,VAN,25,0,0,0,0
42,8483407,Brandon Scanlin,D,NYR,25,0,0,0,0
42,8480274,Philip Kemp,D,EDM,25,0,0,0,0
42,8479522,Hardy Haman Aktell,D,WSH,26,0,0,0,0
42,8480007,Jonas Rondbjerg,R,VGK,25,0,0,0,0
42,8477454,Adam Erne,L,,29,0,0,0,0
42,8481679,Maxence Guenette,D,OTT,23,0,0,0,0
42,8480441,Trey Fix-Wolansky,R,CBJ,25,0,0,0,0
42,8483546,Marshall Rifai,D,TOR,26,0,0,0,0
42,8480084,Nick DeSimone,D,NJD,30,0,0,0,0
42,8481030,Jack St. Ivany,D,PIT,25,0,0,0,0
42,8481592,Jakob Pelletier,L,CGY,23,0,0,0,0
42,8478011,Louie Belpedio,D,PHI,28,0,0,0,0
42,8477930,Pierre-Edouard Bellemare,L,,39,0,0,0,0
42,8484321,Nikolas Matinpalo,D,OTT,26,0,0,0,0
42,8482067,Connor Mackey,D,NYR,28,0,0,0,0
42,8481806,Louis Crevier,D,CHI,23,0,0,0,0
42,8484326,Patrik Koch,D,UTA,28,0,0,0,0
42,8477971,Andreas Englund,D,LAK,28,0,0,0,0
42,8481751,Lukas Rousek,R,BUF,25,0,0,0,0
42,8481006,Tyler Tucker,D,STL,24,0,0,0,0
42,8476867,Brendan Gaunce,C,MIN,30,0,0,0,0
42,8479520,Brandon Duhaime,R,WSH,27,0,0,0,0
42,8477073,Kurtis MacDermid,L,NJD,30,0,0,0,0
42,8480874,Adam Ginning,D,PHI,24,0,0,0,0
42,8477473,Justin Bailey,R,SJS,29,0,0,0,0
42,8479066,Ryan Lomberg,L,CGY,30,0,0,0,0
42,8477070,Liam O'Brien,C,UTA,30,0,0,0,0
42,8474618,Marco Scandella,D,,34,0,0,0,0
42,8475797,Jarred Tinordi,D,,32,0,0,0,0
42,8481441,Joe Snively,C,DET,28,0,0,0,0
42,8477244,Chad Ruhwedel,D,NYR,34,0,0,0,0
42,8479772,Zack MacEwen,R,OTT,28,0,0,0,0
42,8481147,Reese Johnson,C,MIN,26,0,0,0,0
42,8481043,Cole Koepke,L,BOS,26,0,0,0,0
42,8483619,Filip Roos,D,OTT,25,0,0,0,0
42,8481541,Samuel Bolduc,D,NYI,24,0,0,0,0
42,8477810,Joel Hanley,D,CGY,33,0,0,0,0
42,8476907,Mackenzie MacEachern,L,,30,0,0,0,0
42,8482652,Walker Duehr,R,CGY,27,0,0,0,0
42,8477126,Jayson Megna,C,,34,0,0,0,0
42,8483398,Declan Carlile,D,TBL,31,0,0,0,0
42,8482929,Emil Lilleberg,D,TBL,23,0,0,0,0
42,8480880,Jakub Lauko,C,MIN,24,0,0,0,0
42,8480245,Olle Lycksell,R,PHI,25,0,0,0,0
42,8480252,Cole Guttman,C,CHI,25,0,0,0,0
42,8477467,Gustav Olofsson,D,SEA,30,0,0,0,0
42,8479968,Vinni Lettieri,C,BOS,29,0,0,0,0
42,8478400,Colin White,C,,27,0,0,0,0
42,8475755,Alexander Petrovic,D,DAL,32,0,0,0,0
42,8481812,Nikolai Knyzhov,D,,27,0,0,0,0
42,8481593,Jayden Struble,D,MTL,23,0,0,0,0
42,8481532,Alex Turcotte,C,LAK,23,0,0,0,0
42,8482126,Emil Andrae,D,PHI,31,0,0,0,0
42,8479944,Zach Aston-Reese,C,VGK,30,0,0,0,0
42,8471817,Ryan Reaves,R,TOR,37,0,0,0,0
42,8481206,John Ludvig,D,PIT,24,0,0,0,0
42,8481599,Victor Soderstrom,D,UTA,23,0,0,0,0
42,8480292,Carson Meyer,R,ANA,27,0,0,0,0
42,8482496,Nils Aman,C,VAN,24,0,0,0,0
42,8479718,Alex Barré-Boulet,C,MTL,27,0,0,0,0
42,8479994,Jaret Anderson-Dolan,C,WPG,25,0,0,0,0
42,8480184,Gustav Lindstrom,D,,26,0,0,0,0
42,8480890,Jan Jenik,R,OTT,24,0,0,0,0
42,8478067,Oskar Lindblom,L,,28,0,0,0,0
42,8476934,Brock McGinn,L,ANA,30,0,0,0,0
42,8479985,Cale Fleury,D,SEA,26,0,0,0,0
42,8484304,Uvis Balinskis,D,FLA,28,0,0,0,0
42,8479981,Jonah Gadjovich,L,FLA,26,0,0,0,0
42,8481716,Dmitri Voronkov,L,CBJ,24,0,0,0,0
42,8474709,Matt Martin,L,,35,0,0,0,0
42,8482634,Alex Steeves,C,TOR,25,0,0,0,0
42,8480823,Alexander Alexeyev,D,WSH,25,0,0,0,0
42,8477541,Dakota Mermis,D,TOR,30,0,0,0,0
42,8483491,Ivan Miroshnichenko,L,WSH,20,0,0,0,0
42,8478477,Mitchell Stephens,C,SEA,27,0,0,0,0
42,8481543,Nikita Alexandrov,C,STL,24,0,0,0,0
42,8479423,Alex Nylander,L,,26,0,0,0,0
42,8482451,Mikael Pyyhtia,L,CBJ,23,0,0,0,0
42,8478831,Kevin Stenlund,C,UTA,28,0,0,0,0
42,8480306,Grant Hutton,D,NYI,29,0,0,0,0
42,8478028,Fredrik Olofsson,L,,28,0,0,0,0
42,8477462,Robert Hagg,D,VGK,29,0,0,0,0
42,8477320,Anton Blidh,L,NYR,29,0,0,0,0
42,8482157,Will Cuylle,L,NYR,22,0,0,0,0
42,8482737,Zack Bolduc,C,STL,21,0,0,0,0
42,8481239,Samuel Fagemo,L,,24,0,0,0,0
42,8481600,Tobias Bjornfot,D,FLA,23,0,0,0,0
42,8478409,Anthony Richard,C,PHI,28,0,0,0,0
42,8474145,Robert Bortuzzo,D,,35,0,0,0,0
42,8475958,Michael Sgarbossa,C,WSH,32,0,0,0,0
42,8479986,Kole Lind,R,DAL,26,0,0,0,0
42,8479249,Andrew Poturalski,C,SJS,30,0,0,0,0
42,8479362,Riley Tufte,L,BOS,26,0,0,0,0
42,8479991,Jake Leschyshyn,C,NYR,25,0,0,0,0
42,8479587,Rhett Gardner,C,PHI,28,0,0,0,0
42,8482744,James Malatesta,L,CBJ,21,0,0,0,0
42,8478854,Ryan Shea,D,PIT,27,0,0,0,0
42,8481591,Sam Poulin,R,,23,0,0,0,0
42,8483512,Matt Savoie,C,EDM,20,0,0,0,0
42,8482102,Vasily Ponomarev,C,PIT,22,0,0,0,0
42,8482162,Roby Jarventie,L,EDM,22,0,0,0,0
42,8481016,Ruslan Iskhakov,C,,24,0,0,0,0
42,8482172,Landon Slaggert,L,CHI,22,0,0,0,0
42,8482747,Brennan Othmann,L,NYR,21,0,0,0,0
42,8480031,Maxime Comtois,L,,25,0,0,0,0
42,8480226,Marián Studenic,R,,26,0,0,0,0
42,8478408,Travis Dermott,D,,28,0,0,0,0
42,8481518,Nolan Foote,L,NJD,24,0,0,0,0
42,8479419,Brett Murray,L,BUF,26,0,0,0,0
42,8482088,Justin Sourdif,R,FLA,22,0,0,0,0
42,8482201,Gage Goncalves,C,TBL,23,0,0,0,0
42,8481578,Graeme Clarke,R,MIN,23,0,0,0,0
42,8482177,Marat Khusnutdinov,C,MIN,22,0,0,0,0
42,8481754,Nikita Nesterenko,C,ANA,23,0,0,0,0
42,8483531,Brian Halonen,L,NJD,25,0,0,0,0
42,8483920,Pierrick Dube,R,WSH,23,0,0,0,0
42,8480851,Akil Thomas,C,LAK,24,0,0,0,0
42,8475235,Nicolas Deslauriers,L,PHI,33,0,0,0,0
42,8482476,Emil Heineman,L,MTL,23,0,0,0,0
42,8477149,Scott Sabourin,R,SJS,32,0,0,0,0
42,8483549,Lucas Condotta,L,MTL,27,0,0,0,0
42,8482765,Isak Rosen,R,BUF,21,0,0,0,0
42,8481237,Kyle MacLean,C,NYI,25,0,0,0,0
42,8481024,Linus Karlsson,C,VAN,25,0,0,0,0
42,8481690,Tyler Angle,C,,24,0,0,0,0
42,8483570,Ben Meyers,C,SEA,26,0,0,0,0
42,8481655,Cole Schwindt,R,CGY,23,0,0,0,0
42,8481462,Mason Morelli,L,VGK,28,0,0,0,0
42,8483401,Marc Johnstone,R,PIT,28,0,0,0,0
42,8478956,Samuel Laberge,L,NJD,27,0,0,0,0
42,8479533,Joona Koppanen,L,,26,0,0,0,0
42,8482197,Adam Raska,R,MIN,23,0,0,0,0
42,8482250,Callahan Burke,C,VGK,27,0,0,0,0
42,8482784,Zach Dean,C,STL,21,0,0,0,0
42,8484255,Jason Polin,R,COL,25,0,0,0,0
42,8481077,John Leonard,L,,26,0,0,0,0
42,8481534,Raphael Lavoie,C,EDM,24,0,0,0,0
42,8483609,Adam Klapka,R,CGY,24,0,0,0,0
42,8482751,Ryan Winterton,C,SEA,21,0,0,0,0
42,8480267,Sammy Walker,C,MIN,25,0,0,0,0
42,8475766,Austin Watson,L,,32,0,0,0,0
42,8482460,Matt Rempe,C,NYR,22,0,0,0,0
42,8481065,Angus Crookshank,L,OTT,25,0,0,0,0
42,8481070,Hugh McGing,L,,26,0,0,0,0
42,8476323,Max McCormick,L,SEA,32,0,0,0,0
42,8483395,Arshdeep Bains,L,VAN,23,0,0,0,0
42,8484259,Ondrej Pavel,C,COL,31,0,0,0,0
42,8483432,Luca Del Bel Belluz,C,CBJ,31,0,0,0,0
42,8483045,Cameron Butler,R,CBJ,31,0,0,0,0
42,8482061,Brandon Biro,L,SEA,26,0,0,0,0
42,8477401,John Hayden,C,SEA,29,0,0,0,0
42,8475278,Byron Froese,C,,33,0,0,0,0
42,8478446,Glenn Gawdin,C,LAK,27,0,0,0,0
42,8477993,Justin Kirkland,C,CGY,28,0,0,0,0
42,8482147,Jean-Luc Foudy,C,COL,22,0,0,0,0
42,8480032,Shane Bowers,C,NJD,25,0,0,0,0
42,8479330,Brandon Gignac,C,MTL,27,0,0,0,0
42,8480776,Sheldon Rempal,R,,29,0,0,0,0
42,8475413,Justin Dowling,C,NJD,34,0,0,0,0
42,8481726,Adam Edstrom,C,NYR,24,0,0,0,0
42,8480844,Grigori Denisenko,L,VGK,24,0,0,0,0
42,8478147,Bokondji Imama,L,PIT,28,0,0,0,0
42,8478881,Brett Seney,L,CHI,28,0,0,0,0
42,8483630,Pavol Regenda,L,ANA,25,0,0,0,0
42,8480836,Jonathan Gruden,C,,24,0,0,0,0
42,8484314,Jiri Smejkal,L,,28,0,0,0,0
42,8475780,Chris Wagner,R,COL,33,0,0,0,0
42,8479546,Oskar Steen,C,,26,0,0,0,0
42,8483597,Milos Kelemen,L,UTA,25,0,0,0,0
42,8481789,Tye Kartye,L,SEA,23,0,0,0,0
42,8484325,Waltteri Merela,C,TBL,26,0,0,0,0
42,8479421,Jacob Moverare,D,LAK,26,0,0,0,0
42,8481585,Egor Afanasyev,L,SJS,23,0,0,0,0
42,8479547,Matthew Phillips,R,,26,0,0,0,0
42,8479367,William Lockwood,R,FLA,26,0,0,0,0
42,8476915,Jujhar Khaira,L,,30,0,0,0,0
42,8481422,Jacob Lucchini,C,NSH,29,0,0,0,0
42,8480468,James Hamblin,L,EDM,25,0,0,0,0
42,8478051,Max Willman,C,NJD,29,0,0,0,0
42,8481556,John Beecher,C,BOS,23,0,0,0,0
42,8478078,Rourke Chartier,C,,28,0,0,0,0
43,8477492,Nathan MacKinnon,C,COL,29,82,57,90,147
43,8479318,Auston Matthews,C,TOR,27,82,74,66,140
43,8476453,Nikita Kucherov,R,TBL,31,82,37,93,130
43,8477956,David Pastrnak,R,BOS,28,82,57,72,129
43,8478402,Connor McDavid,C,EDM,27,82,47,80,127
43,8478864,Kirill Kaprizov,L,MIN,27,82,48,64,112
43,8477934,Leon Draisaitl,C,EDM,29,82,36,73,109
43,8481559,Jack Hughes,C,NJD,23,82,38,66,104
43,8479314,Matthew Tkachuk,L,FLA,27,82,37,64,101
43,8480800,Quinn Hughes,D,VAN,25,82,19,82,101
43,8477939,William Nylander,R,TOR,28,82,49,51,100
43,8477946,Dylan Larkin,C,DET,28,82,48,52,100
43,8480830,Andrei Svechnikov,R,CAR,24,82,46,53,99
43,8473419,Brad Marchand,L,BOS,36,82,41,55,96
43,8480023,Robert Thomas,C,STL,25,82,34,62,96
43,8478445,Mathew Barzal,C,NYI,27,82,31,65,96
43,8475913,Mark Stone,R,VGK,32,82,35,60,95
43,8480069,Cale Makar,D,COL,26,82,29,66,95
43,8478420,Mikko Rantanen,R,COL,28,82,46,47,93
43,8476468,J.T. Miller,C,VAN,31,82,36,57,93
43,8471675,Sidney Crosby,C,PIT,37,82,36,57,93
43,8480027,Jason Robertson,L,DAL,25,82,38,54,92
43,8478550,Artemi Panarin,L,NYR,33,82,22,69,91
43,8479420,Tage Thompson,C,BUF,27,82,47,43,90
43,8479343,Clayton Keller,R,UTA,26,82,42,48,90
43,8477942,Kevin Fiala,L,LAK,28,82,30,60,90
43,8479337,Alex DeBrincat,R,DET,27,82,36,53,89
43,8476460,Mark Scheifele,C,WPG,31,82,35,54,89
43,8479407,Jesper Bratt,L,NJD,26,82,32,57,89
43,8477493,Aleksander Barkov,C,FLA,29,82,22,66,88
43,8477501,Valeri Nichushkin,R,COL,29,82,46,41,87
43,8475166,John Tavares,C,TOR,34,82,38,48,86
43,8476887,Filip Forsberg,L,NSH,30,82,37,49,86
43,8478427,Sebastian Aho,C,CAR,27,82,44,41,85
43,8478403,Jack Eichel,C,VGK,28,82,38,47,85
43,8475184,Chris Kreider,L,NYR,33,82,58,26,84
43,8480012,Elias Pettersson,C,VAN,26,82,28,56,84
43,8477949,Alex Tuch,R,BUF,28,82,28,56,84
43,8475172,Nazem Kadri,C,CGY,34,82,23,61,84
43,8478398,Kyle Connor,L,WPG,28,82,45,37,82
43,8478440,Dylan Strome,C,WSH,27,82,28,54,82
43,8482116,Tim Stützle,C,OTT,22,82,26,55,81
43,8481523,Kirby Dach,C,MTL,23,82,15,66,81
43,8476881,Tomas Hertl,C,VGK,31,82,38,42,80
43,8481540,Cole Caufield,R,MTL,23,82,38,42,80
43,8477404,Jake Guentzel,C,TBL,30,82,37,43,80
43,8479675,Trevor Moore,L,LAK,29,82,36,44,80
43,8477496,Elias Lindholm,C,BOS,30,82,35,45,80
43,8477409,Carter Verhaeghe,C,FLA,29,82,35,45,80
43,8478042,Viktor Arvidsson,R,EDM,31,82,30,50,80
43,8478010,Brayden Point,C,TBL,28,82,40,39,79
43,8478439,Travis Konecny,R,PHI,27,82,31,48,79
43,8478873,Troy Terry,R,ANA,27,82,25,54,79
43,8480002,Nico Hischier,C,NJD,25,82,31,47,78
43,8476456,Jonathan Huberdeau,C,CGY,31,82,23,55,78
43,8481557,Matt Boldy,L,MIN,23,82,37,40,77
43,8476539,Jonathan Marchessault,R,NSH,34,82,34,43,77
43,8474564,Steven Stamkos,C,NSH,34,82,27,50,77
43,8479385,Jordan Kyrou,C,STL,26,82,27,50,77
43,8474600,Roman Josi,D,NSH,34,82,22,55,77
43,8478449,Roope Hintz,C,DAL,28,82,42,34,76
43,8480803,Evan Bouchard,D,EDM,25,82,16,60,76
43,8480801,Brady Tkachuk,L,OTT,25,82,34,41,75
43,8479542,Brandon Hagel,L,TBL,26,82,33,42,75
43,8474578,Erik Karlsson,D,PIT,34,82,19,56,75
43,8480839,Rasmus Dahlin,D,BUF,24,82,15,60,75
43,8476853,Morgan Rielly,D,TOR,30,82,13,62,75
43,8477933,Sam Reinhart,C,FLA,29,82,43,31,74
43,8476459,Mika Zibanejad,C,NYR,31,82,40,34,74
43,8480018,Nick Suzuki,C,MTL,25,82,26,48,74
43,8471685,Anze Kopitar,C,LAK,37,82,23,51,74
43,8477447,Shea Theodore,D,VGK,29,82,16,58,74
43,8480208,Drake Batherson,R,OTT,26,82,38,35,73
43,8476454,Ryan Nugent-Hopkins,C,EDM,31,82,21,52,73
43,8475692,Mats Zuccarello,R,MIN,37,82,20,53,73
43,8478407,Vince Dunn,D,SEA,28,82,18,55,73
43,8480036,Miro Heiskanen,D,DAL,25,82,16,57,73
43,8479325,Charlie McAvoy,D,BOS,27,82,13,60,73
43,8476462,Dougie Hamilton,D,NJD,31,82,27,45,72
43,8479323,Adam Fox,D,NYR,26,82,9,63,72
43,8477960,Adrian Kempe,R,LAK,28,82,34,37,71
43,8476483,Rickard Rakell,R,PIT,31,82,34,37,71
43,8477940,Nikolaj Ehlers,L,WPG,28,82,31,40,71
43,8482078,Lucas Raymond,L,DET,22,82,27,44,71
43,8473512,Claude Giroux,R,OTT,36,82,22,49,71
43,8474590,John Carlson,D,WSH,34,82,14,57,71
43,8477504,Josh Morrissey,D,WPG,29,82,11,60,71
43,8475726,Tyler Toffoli,C,SJS,32,82,35,35,70
43,8475754,Brock Nelson,C,NYI,33,82,28,42,70
43,8476875,Mike Matheson,D,MTL,30,82,15,55,70
43,8475765,Vladimir Tarasenko,R,DET,33,82,30,39,69
43,8475810,Bryan Rust,R,PIT,32,82,28,41,69
43,8471214,Alex Ovechkin,L,WSH,39,82,35,33,68
43,8481528,Dylan Cozens,C,BUF,23,82,33,35,68
43,8478414,Timo Meier,R,NJD,28,82,32,36,68
43,8480188,Fabian Zetterlund,L,SJS,25,82,29,39,68
43,8471215,Evgeni Malkin,C,PIT,38,82,27,41,68
43,8477951,Nick Schmaltz,C,UTA,28,82,20,48,68
43,8478444,Brock Boeser,R,VAN,27,82,32,35,67
43,8473994,Jamie Benn,L,DAL,35,82,32,35,67
43,8476389,Vincent Trocheck,C,NYR,31,82,27,40,67
43,8477500,Bo Horvat,C,NYI,29,82,35,31,66
43,8475158,Ryan O'Reilly,C,NSH,33,82,30,36,66
43,8480015,Owen Tippett,R,PHI,25,82,28,38,66
43,8482097,Jack Quinn,R,BUF,23,82,18,48,66
43,8479339,Patrik Laine,L,CBJ,26,82,34,31,65
43,8475786,Zach Hyman,L,EDM,32,82,32,33,65
43,8475168,Matt Duchene,C,DAL,33,82,25,40,65
43,8476448,William Karlsson,C,VGK,31,82,25,40,65
43,8478493,Joel Eriksson Ek,C,MIN,27,82,24,41,65
43,8480039,Martin Necas,C,CAR,25,82,21,44,65
43,8471698,T.J. Oshie,R,WSH,38,82,30,34,64
43,8474141,Patrick Kane,R,DET,36,82,26,38,64
43,8476346,Johnny Gaudreau,L,CBJ,31,82,13,51,64
43,8480865,Noah Dobson,D,NYI,24,82,14,49,63
43,8477964,Ivan Barbashev,C,VGK,29,82,28,34,62
43,8477497,Sean Monahan,C,CBJ,30,82,22,40,62
43,8477476,Artturi Lehkonen,L,COL,29,82,25,36,61
43,8478462,Nicolas Roy,C,VGK,27,82,23,38,61
43,8479365,Trent Frederic,C,BOS,26,82,19,42,61
43,8477402,Pavel Buchnevich,L,STL,29,82,24,36,60
43,8475798,Mikael Granlund,C,SJS,32,82,17,43,60
43,8477935,Sam Bennett,C,FLA,28,82,28,31,59
43,8482110,Dawson Mercer,C,NJD,23,82,26,33,59
43,8482665,Matty Beniers,C,SEA,22,82,24,35,59
43,8474641,Adam Henrique,C,EDM,34,82,23,36,59
43,8478460,Zach Werenski,D,CBJ,27,82,16,43,59
43,8481711,Matias Maccelli,L,UTA,24,82,16,43,59
43,8478469,Thomas Chabot,D,OTT,27,82,11,48,59
43,8477955,Jared McCann,L,SEA,28,82,33,25,58
43,8481596,Shane Pinto,C,OTT,24,82,23,35,58
43,8478397,Rasmus Andersson,D,CGY,28,82,13,45,58
43,8479410,Mikhail Sergachev,D,UTA,26,82,13,45,58
43,8475794,Tyler Seguin,C,DAL,32,82,26,31,57
43,8478856,Conor Garland,R,VAN,28,82,24,33,57
43,8478975,Mason Marchment,L,DAL,29,82,22,35,57
43,8481533,Trevor Zegras,C,ANA,23,82,22,35,57
43,8477986,Brandon Montour,D,SEA,30,82,20,37,57
43,8474586,Jordan Eberle,R,SEA,34,82,19,38,57
43,8477429,Andrew Copp,C,DET,30,82,19,38,57
43,8476906,Shayne Gostisbehere,D,CAR,31,82,14,43,57
43,8480064,Josh Norris,C,OTT,25,82,30,26,56
43,8475799,Nino Niederreiter,R,WPG,32,82,29,27,56
43,8482475,Yegor Chinakhov,R,CBJ,23,82,25,31,56
43,8475745,Charlie Coyle,C,BOS,32,82,24,32,56
43,8479400,Pierre-Luc Dubois,L,WSH,26,82,22,34,56
43,8474679,Gustav Nyquist,C,NSH,35,82,20,36,56
43,8478401,Pavel Zacha,C,BOS,27,82,20,36,56
43,8476792,Torey Krug,D,STL,33,82,15,41,56
43,8475167,Victor Hedman,D,TBL,34,82,11,45,56
43,8475784,Jeff Skinner,C,EDM,32,82,33,22,55
43,8477407,Anthony Duclair,L,NYI,29,82,31,24,55
43,8478498,Jake DeBrusk,L,VAN,28,82,26,29,55
43,8482159,Tyson Foerster,R,PHI,22,82,25,30,55
43,8477456,J.T. Compher,L,DET,29,82,24,31,55
43,8482740,Wyatt Johnston,C,DAL,21,82,22,33,55
43,8475714,Calle Jarnkrok,C,TOR,33,82,22,33,55
43,8478047,Michael Bunting,L,PIT,29,82,20,35,55
43,8480113,Alex Iafallo,L,WPG,31,82,17,38,55
43,8478396,Noah Hanifin,D,VGK,27,82,15,40,55
43,8477494,Jonathan Drouin,L,COL,29,82,15,40,55
43,8482149,Cole Perfetti,C,WPG,22,82,14,41,55
43,8476869,Brady Skjei,D,NSH,30,82,12,43,55
43,8478474,Lawson Crouse,L,UTA,27,82,29,25,54
43,8474150,Mikael Backlund,C,CGY,35,82,27,27,54
43,8482699,Dylan Guenther,R,UTA,21,82,25,29,54
43,8476432,Boone Jenner,C,CBJ,31,82,25,29,54
43,8476905,Chandler Stephenson,C,SEA,30,82,15,39,54
43,8481068,Yegor Sharangovich,C,CGY,26,82,31,22,53
43,8482175,JJ Peterka,R,BUF,22,82,30,23,53
43,8477416,Oliver Bjorkstrand,R,SEA,29,82,26,27,53
43,8474102,David Perron,L,OTT,36,82,16,37,53
43,8478366,Frank Vatrano,R,ANA,30,82,29,23,52
43,8482113,Anton Lundell,C,FLA,23,82,24,28,52
43,8476399,Blake Coleman,C,CGY,33,82,22,30,52
43,8477479,Tyler Bertuzzi,L,CHI,29,82,21,31,52
43,8476479,Phillip Danault,C,LAK,31,82,20,32,52
43,8476826,Yanni Gourde,C,SEA,33,82,19,33,52
43,8474563,Drew Doughty,D,LAK,35,82,14,38,52
43,8478458,Jack Roslovic,C,CAR,27,82,12,40,52
43,8479425,Filip Hronek,D,VAN,27,82,11,41,52
43,8482684,Luke Hughes,D,NJD,21,82,9,43,52
43,8473986,Alex Killorn,L,ANA,35,82,27,24,51
43,8475170,Brayden Schenn,C,STL,33,82,23,28,51
43,8480797,Joel Farabee,L,PHI,24,82,19,32,51
43,8476458,Ryan Strome,C,ANA,31,82,11,40,51
43,8481560,Arthur Kaliyev,R,LAK,23,82,25,25,50
43,8478438,Tommy Novak,C,NSH,27,82,20,30,50
43,8478519,Anthony Cirelli,C,TBL,27,82,19,31,50
43,8477503,Max Domi,C,TOR,29,82,17,33,50
43,8474565,Alex Pietrangelo,D,VGK,34,82,10,40,50
43,8475151,Kyle Palmieri,C,NYI,33,82,33,16,49
43,8483808,Andrei Kuzmenko,L,CGY,28,82,26,23,49
43,8480078,Filip Chytil,C,NYR,25,82,20,29,49
43,8482745,Mason McTavish,C,ANA,21,82,17,32,49
43,8479345,Jakob Chychrun,D,WSH,26,82,16,33,49
43,8479999,Casey Mittelstadt,C,COL,26,82,13,36,49
43,8477346,MacKenzie Weegar,D,CGY,30,82,11,38,49
43,8479996,Cody Glass,C,NSH,25,82,25,23,48
43,8475768,Jaden Schwartz,C,SEA,32,82,21,27,48
43,8479987,Morgan Geekie,C,BOS,26,82,18,30,48
43,8478233,Andrew Mangiapane,L,WSH,28,82,17,31,48
43,8482720,Matthew Knies,L,TOR,22,82,15,33,48
43,8476872,Scott Laughton,C,PHI,30,82,19,28,47
43,8475763,Kevin Hayes,R,PIT,32,82,19,28,47
43,8474053,Logan Couture,C,SJS,35,82,17,30,47
43,8475793,Ryan Johansen,C,PHI,32,82,15,32,47
43,8482105,Jake Sanderson,D,OTT,22,82,14,33,47
43,8482109,Alexis Lafrenière,L,NYR,23,82,26,20,46
43,8475760,Nick Bjugstad,C,UTA,32,82,21,25,46
43,8482705,Cole Sillinger,C,CBJ,21,82,20,26,46
43,8482093,Seth Jarvis,C,CAR,22,82,17,29,46
43,8477495,Seth Jones,D,CHI,30,82,15,31,46
43,8475218,Mattias Ekholm,D,EDM,34,82,14,32,46
43,8477948,Travis Sanheim,D,PHI,28,82,12,34,46
43,8477932,Aaron Ekblad,D,FLA,28,82,10,36,46
43,8471724,Kris Letang,D,PIT,37,82,9,37,46
43,8481542,Moritz Seider,D,DET,23,82,4,42,46
43,8480434,Sean Durzi,D,UTA,26,82,18,27,45
43,8478542,Evan Rodrigues,C,FLA,31,82,17,28,45
43,8480145,Neal Pionk,D,WPG,29,82,15,30,45
43,8477021,Alex Kerfoot,C,UTA,30,82,13,32,45
43,8477998,Warren Foegele,L,LAK,28,82,12,33,45
43,8477498,Darnell Nurse,D,EDM,29,82,8,37,45
43,8480220,Noah Cates,L,PHI,25,82,21,23,44
43,8477511,Anthony Mantha,R,CGY,30,82,20,24,44
43,8482667,William Eklund,L,SJS,22,82,18,26,44
43,8475722,Jason Zucker,L,BUF,32,82,17,27,44
43,8476419,Jean-Gabriel Pageau,C,NYI,32,82,13,31,44
43,8478038,Devon Toews,D,COL,30,82,10,34,44
43,8480798,Philipp Kurashev,C,CHI,25,82,9,35,44
43,8478055,Gustav Forsling,D,FLA,28,82,7,37,44
43,8475753,Justin Faulk,D,STL,32,82,6,38,44
43,8475169,Evander Kane,L,EDM,33,82,25,18,43
43,8478891,Mason Appleton,C,WPG,28,82,24,19,43
43,8482146,Luke Evangelista,R,NSH,22,82,18,25,43
43,8477444,Andre Burakovsky,L,SEA,29,82,18,25,43
43,8481618,Alex Newhook,C,MTL,23,82,16,27,43
43,8481581,Thomas Harley,D,DAL,23,82,12,31,43
43,8480014,Gabriel Vilardi,C,WPG,25,82,23,19,42
43,8479293,Brandon Tanev,L,SEA,33,82,22,20,42
43,8480028,Morgan Frost,C,PHI,25,82,21,21,42
43,8478046,Danton Heinen,L,VAN,29,82,20,22,42
43,8480849,Barrett Hayton,C,UTA,24,82,20,22,42
43,8483515,Juraj Slafkovsky,L,MTL,20,82,18,24,42
43,8482660,Kent Johnson,C,CBJ,22,82,14,28,42
43,8476923,Damon Severson,D,CBJ,30,82,13,29,42
43,8476854,Hampus Lindholm,D,BOS,30,82,8,34,42
43,8482089,Jake Neighbours,L,STL,22,82,30,11,41
43,8482079,Marco Rossi,C,MIN,23,82,24,17,41
43,8478109,Victor Olofsson,L,VGK,29,82,21,20,41
43,8478413,Jordan Greenway,L,BUF,27,82,19,22,41
43,8475149,Marcus Johansson,L,MIN,34,82,18,23,41
43,8476882,Teuvo Teravainen,L,CHI,30,82,14,27,41
43,8470613,Brent Burns,D,CAR,39,82,11,30,41
43,8475287,Erik Haula,L,NJD,33,82,11,30,41
43,8482124,Quinton Byfield,R,LAK,22,82,8,33,41
43,8477969,Marcus Pettersson,D,PIT,28,82,8,33,41
43,8474149,Evgenii Dadonov,R,DAL,35,82,17,23,40
43,8479992,Michael Rasmussen,C,DET,25,82,16,24,40
43,8476885,Jacob Trouba,D,NYR,30,82,6,34,40
43,8481604,Pavel Dorofeyev,L,VGK,24,82,21,18,39
43,8480459,Pius Suter,C,VAN,28,82,21,18,39
43,8482092,Ridly Greig,C,OTT,22,82,20,19,39
43,8474189,Lars Eller,C,PIT,35,82,19,20,39
43,8482117,Lukas Reichel,L,CHI,22,82,18,21,39
43,8477425,Miles Wood,L,COL,29,82,18,21,39
43,8476292,Ondrej Palat,L,NJD,33,82,14,25,39
43,8478472,Mathieu Joseph,R,STL,27,82,12,27,39
43,8476958,Jaccob Slavin,D,CAR,30,82,10,29,39
43,8475171,Oliver Ekman-Larsson,D,TOR,33,82,9,30,39
43,8475764,Cam Fowler,D,ANA,33,82,6,33,39
43,8480817,K'Andre Miller,D,NYR,24,82,5,34,39
43,8480185,Eetu Luostarinen,C,FLA,26,82,20,18,38
43,8477987,Ryan Donato,C,CHI,28,82,20,18,38
43,8475314,Anders Lee,L,NYI,34,82,18,20,38
43,8476474,Stefan Noesen,R,NJD,31,82,17,21,38
43,8476461,Sean Couturier,C,PHI,32,82,16,22,38
43,8481032,Paul Cotter,C,NJD,25,82,13,25,38
43,8473563,Nicklas Backstrom,C,WSH,37,82,11,27,38
43,8479398,Samuel Girard,D,COL,26,82,3,35,38
43,8480893,Kirill Marchenko,R,CBJ,24,82,24,13,37
43,8482055,Drew O'Connor,L,PIT,26,82,17,20,37
43,8481656,Aliaksei Protas,C,WSH,23,82,13,24,37
43,8475191,Reilly Smith,R,NYR,33,82,12,25,37
43,8482111,Justin Barron,D,MTL,23,82,12,25,37
43,8481546,Cam York,D,PHI,23,82,8,29,37
43,8476902,Esa Lindell,D,DAL,30,82,8,29,37
43,8479976,Juuso Valimaki,D,UTA,26,82,3,34,37
43,8477952,Robby Fabbri,C,ANA,28,82,22,14,36
43,8476880,Tom Wilson,R,WSH,30,82,16,20,36
43,8477451,Ryan Hartman,R,MIN,30,82,15,21,36
43,8480009,Eeli Tolvanen,R,SEA,25,82,14,22,36
43,8483431,Logan Cooley,C,UTA,20,82,14,22,36
43,8478057,Dakota Joshua,C,VAN,28,82,13,23,36
43,8474716,Jared Spurgeon,D,MIN,35,82,10,26,36
43,8480871,Adam Boqvist,D,FLA,24,82,8,28,36
43,8479402,Jake Bean,D,CGY,26,82,2,34,36
43,8479525,Ross Colton,C,COL,28,82,20,15,35
43,8479661,Tanner Jeannot,L,LAK,27,82,17,18,35
43,8476925,Colton Sissons,C,NSH,31,82,15,20,35
43,8476480,Vladislav Namestnikov,C,WPG,32,82,11,24,35
43,8478507,John Marino,D,UTA,27,82,3,32,35
43,8473422,Nick Foligno,L,CHI,37,82,17,17,34
43,8481553,Bobby Brink,R,PHI,23,82,13,21,34
43,8478911,Matt Roy,D,WSH,29,82,12,22,34
43,8481624,Ilya Mikheyev,R,CHI,30,82,11,23,34
43,8478115,Pierre Engvall,L,NYI,28,82,11,23,34
43,8476897,Oskar Sundqvist,C,STL,30,82,11,23,34
43,8476960,Andreas Athanasiou,C,CHI,30,82,9,25,34
43,8481580,Connor McMichael,C,WSH,23,82,23,10,33
43,8476438,Brandon Saad,L,STL,32,82,22,11,33
43,8480835,Jack Drury,C,CAR,24,82,19,14,33
43,8475791,Taylor Hall,L,CHI,33,82,17,16,33
43,8481582,Nicholas Robertson,L,TOR,23,82,17,16,33
43,8481554,Kaapo Kakko,R,NYR,23,82,17,16,33
43,8476873,Mark Jankowski,C,NSH,30,82,16,17,33
43,8480802,Ryan McLeod,C,BUF,25,82,14,19,33
43,8482087,Kaiden Guhle,D,MTL,22,82,7,26,33
43,8477220,Nate Schmidt,D,FLA,33,82,7,26,33
43,8477506,Ryan Pulock,D,NYI,30,82,2,31,33
43,8479941,Justin Danforth,R,CBJ,31,82,20,12,32
43,8481535,Nils Hoglander,L,VAN,24,82,19,13,32
43,8477426,Nicholas Paul,L,TBL,29,82,16,16,32
43,8476927,Teddy Blueger,C,VAN,30,82,14,18,32
43,8481013,Jonatan Berggren,R,DET,24,82,14,18,32
43,8484144,Connor Bedard,C,CHI,19,82,12,20,32
43,8477488,Brett Pesce,D,NJD,30,82,8,24,32
43,8476979,Erik Gustafsson,D,DET,32,82,7,25,32
43,8476463,Jonas Brodin,D,MIN,31,82,7,25,32
43,8477435,Ryan Graves,D,PIT,29,82,7,25,32
43,8474673,TJ Brodie,D,CHI,34,82,6,26,32
43,8476981,Josh Anderson,R,MTL,30,82,20,11,31
43,8478020,Michael Amadio,C,OTT,28,82,20,11,31
43,8470621,Corey Perry,R,EDM,39,82,15,16,31
43,8480829,Jesperi Kotkaniemi,C,CAR,24,82,11,20,31
43,8477839,Conor Sheary,L,TBL,32,82,11,20,31
43,8481704,Juuso Parssinen,C,NSH,23,82,11,20,31
43,8475200,Dmitry Orlov,D,CAR,33,82,10,21,31
43,8475855,Jesper Fast,R,CAR,33,82,10,21,31
43,8481606,Jordan Spence,D,LAK,23,82,7,24,31
43,8482671,Owen Power,D,BUF,22,82,6,25,31
43,8476329,Travis Boyd,C,MIN,31,82,6,25,31
43,8475181,Nick Leddy,D,STL,33,82,6,25,31
43,8476931,Jake McCabe,D,TOR,31,82,4,27,31
43,8482245,Artem Zub,D,OTT,29,82,4,27,31
43,8478399,Jonas Siegenthaler,D,NJD,27,82,4,27,31
43,8480813,Joe Veleno,C,DET,24,82,14,16,30
43,8473533,Jordan Staal,C,CAR,36,82,14,16,30
43,8477947,Sonny Milano,L,WSH,28,82,12,18,30
43,8476858,Phillip Di Giuseppe,L,VAN,31,82,12,18,30
43,8480336,Sean Walker,D,CAR,30,82,11,19,30
43,8482074,Connor Zary,C,CGY,23,82,10,20,30
43,8479983,Mario Ferraro,D,SJS,26,82,7,23,30
43,8478500,Ivan Provorov,D,CBJ,27,82,0,30,30
43,8476469,Joel Armia,R,MTL,31,82,18,11,29
43,8480806,Isac Lundestrom,C,ANA,25,82,15,14,29
43,8480068,Ryan Poehling,C,PHI,25,82,14,15,29
43,8477450,Jason Dickinson,C,CHI,29,82,14,15,29
43,8484166,Adam Fantilli,C,CBJ,20,82,14,15,29
43,8480789,Oliver Wahlstrom,R,NYI,24,82,13,16,29
43,8484203,Bradly Nadeau,L,CAR,19,82,13,16,29
43,8481517,Brett Leason,R,ANA,25,82,11,18,29
43,8476374,Sean Kuraly,C,CBJ,31,82,9,20,29
43,8478508,Yakov Trenin,C,MIN,27,82,13,15,28
43,8478463,Anthony Beauvillier,L,PIT,27,82,11,17,28
43,8479353,Brett Howden,C,VGK,26,82,11,17,28
43,8475231,Casey Cizikas,C,NYI,33,82,11,17,28
43,8480873,Rasmus Sandin,D,WSH,24,82,8,20,28
43,8479351,Sam Steel,C,DAL,26,82,6,22,28
43,8480074,Alexandre Texier,C,STL,25,82,6,22,28
43,8473507,Jeff Petry,D,DET,37,82,5,23,28
43,8478443,Brandon Carlo,D,BOS,28,82,5,23,28
43,8475324,Nick Jensen,D,OTT,34,82,3,25,28
43,8480281,Alexey Toropchenko,R,STL,25,82,15,12,27
43,8480748,Kiefer Sherwood,L,VAN,29,82,14,13,27
43,8479390,Taylor Raddysh,R,WSH,26,82,14,13,27
43,8480855,Jack McBain,C,UTA,24,82,13,14,27
43,8482133,Thomas Bordeleau,C,SJS,22,82,12,15,27
43,8482062,Cole Smith,L,NSH,29,82,12,15,27
43,8478432,Christian Fischer,R,DET,27,82,12,15,27
43,8477953,Kasperi Kapanen,R,STL,28,82,10,17,27
43,8477353,Tyler Motte,C,DET,29,82,10,17,27
43,8480144,David Kampf,C,TOR,29,82,8,19,27
43,8483445,Cutter Gauthier,L,ANA,20,82,8,19,27
43,8482122,Brock Faber,D,MIN,22,82,5,22,27
43,8475233,David Savard,D,MTL,34,82,5,22,27
43,8470600,Ryan Suter,D,STL,39,82,5,22,27
43,8478851,Alexandre Carrier,D,NSH,28,82,4,23,27
43,8474151,Ryan McDonagh,D,TBL,35,82,4,23,27
43,8480035,Henri Jokiharju,D,BUF,25,82,3,24,27
43,8482142,Jamie Drysdale,D,PHI,22,82,3,24,27
43,8480003,Jesper Boqvist,C,FLA,26,82,14,12,26
43,8481186,Logan O'Connor,R,COL,28,82,13,13,26
43,8477508,Curtis Lazar,C,NJD,29,82,13,13,26
43,8476392,Adam Lowry,C,WPG,31,82,11,15,26
43,8476624,Barclay Goodrow,C,SJS,31,82,11,15,26
43,8477507,Nikita Zadorov,D,BOS,29,82,10,16,26
43,8477499,Rasmus Ristolainen,D,PHI,30,82,8,18,26
43,8476467,Jamie Oleksiak,D,SEA,32,82,7,19,26
43,8481477,Nico Sturm,C,SJS,29,82,7,19,26
43,8479371,Dante Fabbro,D,NSH,26,82,4,22,26
43,8480049,Dylan Samberg,D,WPG,25,82,2,24,26
43,8481178,Egor Zamula,D,PHI,24,82,1,25,26
43,8475193,Tomas Tatar,L,NJD,34,82,16,9,25
43,8481524,Bowen Byram,D,BUF,23,82,14,11,25
43,8476921,Jordan Martinook,L,CAR,32,82,13,12,25
43,8477392,Hudson Fasching,R,NYI,29,82,13,12,25
43,8479316,Luke Kunin,C,SJS,27,82,13,12,25
43,8479368,Max Jones,L,BOS,26,82,11,14,25
43,8477919,Frederick Gaudreau,C,MIN,31,82,10,15,25
43,8484153,Leo Carlsson,C,ANA,20,82,10,15,25
43,8478178,Darren Raddysh,D,TBL,28,82,10,15,25
43,8476312,Josh Manson,D,COL,33,82,5,20,25
43,8482073,Braden Schneider,D,NYR,23,82,5,20,25
43,8480043,Timothy Liljegren,D,TOR,25,82,4,21,25
43,8478882,Vladislav Gavrikov,D,LAK,29,82,3,22,25
43,8476879,Cody Ceci,D,EDM,31,82,2,23,25
43,8478840,Will Borgen,D,SEA,28,82,1,24,25
43,8475848,Brendan Gallagher,R,MTL,32,82,16,8,24
43,8479591,Michael Eyssimont,C,TBL,28,82,12,12,24
43,8477931,Tomas Nosek,L,FLA,32,82,12,12,24
43,8484145,Zach Benson,L,BUF,19,82,12,12,24
43,8480995,Pontus Holmberg,R,TOR,25,82,10,14,24
43,8480448,Parker Kelly,L,COL,25,82,10,14,24
43,8483482,Tristan Luneau,D,ANA,20,82,9,15,24
43,8484149,Gavin Brindley,C,CBJ,20,82,5,19,24
43,8479980,Nicolas Hague,D,VGK,26,82,5,19,24
43,8482655,J.J. Moser,D,TBL,24,82,4,20,24
43,8481014,Alexander Romanov,D,NYI,24,82,4,20,24
43,8478133,Jake Evans,C,MTL,28,82,2,22,24
43,8480796,Martin Fehervary,D,WSH,25,82,1,23,24
43,8474715,Cam Atkinson,R,TBL,35,82,15,8,23
43,8473453,Trevor Lewis,C,LAK,37,82,14,9,23
43,8477015,Connor Brown,R,EDM,30,82,12,11,23
43,8477989,Christian Dvorak,C,MTL,28,82,11,12,23
43,8482125,Alexander Holtz,R,VGK,22,82,10,13,23
43,8484911,Collin Graf,R,SJS,22,82,10,13,23
43,8478434,Keegan Kolesar,R,VGK,27,82,9,14,23
43,8481481,Blake Lizotte,C,PIT,27,82,8,15,23
43,8480980,Connor Dewar,C,TOR,25,82,7,16,23
43,8476892,Colton Parayko,D,STL,31,82,6,17,23
43,8476422,Mike Reilly,D,NYI,31,82,5,18,23
43,8479324,Ryan Lindgren,D,NYR,26,82,5,18,23
43,8475279,Ben Chiarot,D,DET,33,82,4,19,23
43,8475462,Radko Gudas,D,ANA,34,82,3,20,23
43,8478569,Noel Acciari,C,PIT,33,82,15,7,22
43,8481028,Martin Pospisil,C,CGY,25,82,13,9,22
43,8479414,Nathan Bastian,R,NJD,27,82,13,9,22
43,8482259,Bobby McMann,C,TOR,28,82,13,9,22
43,8483763,Maksymilian Szuber,D,UTA,22,82,10,12,22
43,8477369,Carson Soucy,D,VAN,30,82,9,13,22
43,8482702,Logan Stankoven,C,DAL,21,82,9,13,22
43,8476473,Connor Murphy,D,CHI,31,82,7,15,22
43,8477365,Connor Clifton,D,BUF,29,82,6,16,22
43,8483490,Pavel Mintyukov,D,ANA,21,82,6,16,22
43,8482807,Ethan Del Mastro,D,CHI,21,82,5,17,22
43,8475690,Chris Tanev,D,TOR,35,82,5,17,22
43,8475790,Erik Gudbranson,D,CBJ,32,82,4,18,22
43,8482803,Olen Zellweger,D,ANA,21,82,4,18,22
43,8480878,Nils Lundkvist,D,DAL,24,82,4,18,22
43,8476457,Adam Larsson,D,SEA,32,82,3,19,22
43,8479369,Andrew Peeke,D,BOS,26,82,3,19,22
43,8476917,Adam Pelech,D,NYI,30,82,1,21,22
43,8482679,Matt Coronato,R,CGY,22,82,13,8,21
43,8476278,Colin Blackwell,C,DAL,31,82,12,9,21
43,8483457,Lane Hutson,D,MTL,20,82,12,9,21
43,8481093,Rafael Harvey-Pinard,L,MTL,25,82,11,10,21
43,8483524,Shane Wright,C,SEA,20,82,11,10,21
43,8478211,Dryden Hunt,L,CGY,29,82,9,12,21
43,8481522,Peyton Krebs,C,BUF,23,82,7,14,21
43,8482470,Ilya Solovyov,D,CGY,24,82,6,15,21
43,8479998,Mikey Anderson,D,LAK,25,82,4,17,21
43,8477845,Trevor van Riemsdyk,D,WSH,33,82,3,18,21
43,8475188,Brayden McNabb,D,VGK,33,82,2,19,21
43,8476878,Zemgus Girgensons,L,TBL,30,82,11,9,20
43,8475343,Nic Dowd,C,WSH,34,82,10,10,20
43,8479393,Noah Gregor,C,OTT,26,82,9,11,20
43,8476918,Jimmy Vesey,L,NYR,31,82,8,12,20
43,8478136,Jake Middleton,D,MIN,28,82,7,13,20
43,8474574,Tyler Myers,D,VAN,34,82,6,14,20
43,8479359,Beck Malenstyn,L,BUF,26,82,6,14,20
43,8482155,Alex Laferriere,R,LAK,23,82,16,3,19
43,8477406,Mattias Janmark,C,EDM,32,82,10,9,19
43,8482712,Oskar Olausson,R,COL,22,82,8,11,19
43,8476525,Colin Miller,D,WPG,32,82,6,13,19
43,8476442,Matt Nieto,L,PIT,32,82,6,13,19
43,8476429,Scott Mayfield,D,NYI,32,82,6,13,19
43,8478416,Erik Cernak,D,TBL,27,82,4,15,19
43,8476331,Dylan DeMelo,D,WPG,31,82,3,16,19
43,8480860,Kevin Bahl,D,CGY,24,82,3,16,19
43,8480246,Nick Perbix,D,TBL,26,82,2,17,19
43,8483565,Nick Blankenburg,D,NSH,26,82,2,17,19
43,8480073,Erik Brannstrom,D,COL,25,82,2,17,19
43,8476891,Matt Grzelcyk,D,PIT,30,82,2,17,19
43,8482077,Dylan Holloway,L,EDM,23,82,12,6,18
43,8482624,Daniil Miromanov,D,CGY,27,82,10,8,18
43,8477505,Alexander Wennberg,C,SJS,30,82,9,9,18
43,8476889,Radek Faksa,C,STL,30,82,6,12,18
43,8475220,Marcus Foligno,L,MIN,33,82,6,12,18
43,8482858,Ryker Evans,D,SEA,23,82,5,13,18
43,8481708,Zac Jones,D,NYR,24,82,5,13,18
43,8480879,Jacob Bernard-Docker,D,OTT,24,82,2,16,18
43,8480807,Mattias Samuelsson,D,BUF,24,82,1,17,18
43,8478874,Adam Gaudette,C,OTT,28,82,1,17,18
43,8478468,Jeremy Lauzon,D,NSH,27,82,6,11,17
43,8482762,Simon Edvinsson,D,DET,21,82,5,12,17
43,8480222,Sebastian Aho,D,PIT,28,82,5,12,17
43,8481601,Simon Holmstrom,R,NYI,23,82,4,13,17
43,8483505,Matthew Poitras,C,BOS,20,82,12,4,16
43,8482666,Scott Morrow,D,CAR,22,82,8,8,16
43,8483499,Liam Ohgren,L,MIN,20,82,7,9,16
43,8476967,Brett Kulak,D,EDM,30,82,6,10,16
43,8476372,Nick Seeler,D,PHI,31,82,4,12,16
43,8474090,Brendan Smith,D,DAL,35,82,4,12,16
43,8478859,Niko Mikkola,D,FLA,28,82,3,13,16
43,8483495,Simon Nemec,D,NJD,20,82,3,13,16
43,8481699,Aku Raty,R,UTA,23,82,10,5,15
43,8482749,Joshua Roy,R,MTL,21,82,7,8,15
43,8478013,Jake Walman,D,SJS,28,82,6,9,15
43,8475842,Sam Carrick,C,NYR,32,82,6,9,15
43,8482141,Lukas Cormier,D,VGK,22,82,5,10,15
43,8482118,Sam Colangelo,R,ANA,23,82,5,10,15
43,8475177,Calvin de Haan,D,COL,33,82,3,12,15
43,8482101,Danil Gushchin,L,SJS,22,82,3,12,15
43,8479442,Troy Stecher,D,EDM,30,82,3,12,15
43,8480834,Ty Emberson,D,SJS,24,82,3,12,15
43,8483468,Jiri Kulich,C,BUF,20,82,2,13,15
43,8483460,David Jiricek,D,CBJ,21,82,2,13,15
43,8483397,Marc McLaughlin,C,BOS,25,82,8,6,14
43,8482733,Logan Mailloux,D,MTL,31,82,6,8,14
43,8480025,MacKenzie Entwistle,R,FLA,25,82,5,9,14
43,8480172,Jan Rutta,D,SJS,34,82,4,10,14
43,8482166,Shakir Mukhamadullin,D,SJS,22,82,4,10,14
43,8471677,Jack Johnson,D,CBJ,37,82,4,10,14
43,8483567,Georgii Merkulov,C,BOS,24,82,4,10,14
43,8482809,Jackson Blake,R,CAR,21,82,3,11,14
43,8480950,Ilya Lyubushkin,D,DAL,30,82,3,11,14
43,8477335,Kyle Burroughs,D,LAK,29,82,2,12,14
43,8480990,Declan Chisholm,D,MIN,24,82,2,12,14
43,8475455,Brenden Dillon,D,NJD,34,82,2,12,14
43,8482659,Josh Doan,R,UTA,22,82,8,5,13
43,8483493,Frank Nazar,C,CHI,20,82,7,6,13
43,8477903,Garnet Hathaway,R,PHI,33,82,6,7,13
43,8480021,Jack Studnicka,C,LAK,25,82,6,7,13
43,8482145,Mavrik Bourque,C,DAL,22,82,3,10,13
43,8474013,Ian Cole,D,UTA,35,82,3,10,13
43,8481605,Jackson LaCombe,D,ANA,23,82,3,10,13
43,8474612,Travis Hamonic,D,OTT,34,82,3,10,13
43,8481641,Joel Kiviranta,L,COL,28,82,2,11,13
43,8481568,Alex Vlasic,D,CHI,23,82,2,11,13
43,8482153,Brendan Brisson,C,VGK,23,82,2,11,13
43,8481122,Simon Benoit,D,TOR,26,82,0,13,13
43,8479291,Kevin Rooney,C,CGY,31,82,8,4,12
43,8476441,Joel Edmundson,D,LAK,31,82,5,7,12
43,8478450,Parker Wotherspoon,D,BOS,27,82,4,8,12
43,8482859,Zack Ostapchuk,C,OTT,21,82,4,8,12
43,8481567,Henry Thrun,D,SJS,23,82,3,9,12
43,8482713,Mackie Samoskevich,R,FLA,22,82,2,10,12
43,8483471,Brad Lambert,C,WPG,31,82,1,11,12
43,8482787,Nikita Chibrikov,R,WPG,31,82,8,3,11
43,8483466,Kevin Korchinski,D,CHI,20,82,6,5,11
43,8477938,Haydn Fleury,D,WPG,28,82,4,7,11
43,8479638,Justin Brazeau,R,BOS,26,82,6,4,10
43,8482070,Mitchell Chaffee,R,TBL,26,82,8,1,9
43,8483489,Fraser Minten,C,TOR,31,82,4,5,9
43,8477034,Jaycob Megna,D,FLA,32,82,3,6,9
43,8474567,Zach Bogosian,D,MIN,34,82,3,6,9
43,8475718,Justin Holl,D,DET,32,82,3,6,9
43,8479576,Vincent Desharnais,D,VAN,28,82,3,6,9
43,8483012,Logan Morrison,C,SEA,22,82,2,7,9
43,8482516,Matthew Kessel,D,STL,24,82,4,4,8
43,8480870,Bo Groulx,C,NYR,24,82,2,6,8
43,8474062,Riley Nash,C,NYR,35,82,3,4,7
43,8475762,Derek Forbort,D,VAN,32,82,1,6,7
43,8476822,Luke Glendening,C,TBL,35,82,1,4,5
43,8470794,Joe Pavelski,C,,40,0,0,0,0
43,8481703,Valtteri Puustinen,R,PIT,25,0,0,0,0
43,8477950,Tony DeAngelo,D,,29,0,0,0,0
43,8481577,Philip Tomasino,C,NSH,23,0,0,0,0
43,8475197,Tyson Barrie,D,,33,0,0,0,0
43,8471218,Blake Wheeler,R,,38,0,0,0,0
43,8474157,Max Pacioretty,L,,36,0,0,0,0
43,8478466,Daniel Sprong,R,VAN,27,0,0,0,0
43,8475744,Evgeny Kuznetsov,C,,32,0,0,0,0
43,8481019,David Gustafsson,C,WPG,24,0,0,0,0
43,8475906,John Klingberg,D,,32,0,0,0,0
43,8479348,Kale Clague,D,BUF,26,0,0,0,0
43,8476952,Dominic Toninato,C,WPG,30,0,0,0,0
43,8473473,Milan Lucic,L,,36,0,0,0,0
43,8474037,James van Riemsdyk,L,,35,0,0,0,0
43,8474602,Justin Schultz,D,,34,0,0,0,0
43,8482222,Alexander Barabanov,L,,30,0,0,0,0
43,8479372,Josh Mahura,D,SEA,26,0,0,0,0
43,8479982,Conor Timmins,D,TOR,26,0,0,0,0
43,8474031,Kevin Shattenkirk,D,,35,0,0,0,0
43,8480008,Adam Ruzicka,C,,25,0,0,0,0
43,8481059,Scott Perunovich,D,STL,26,0,0,0,0
43,8480884,Calen Addison,D,,24,0,0,0,0
43,8476994,Vinnie Hinostroza,C,NSH,30,0,0,0,0
43,8478452,Caleb Jones,D,LAK,27,0,0,0,0
43,8480157,Calle Rosen,D,COL,30,0,0,0,0
43,8481609,Vladislav Kolyachonok,D,UTA,23,0,0,0,0
43,8479415,Michael McLeod,C,,26,0,0,0,0
43,8476919,Chris Tierney,C,,30,0,0,0,0
43,8479639,Dylan Coghlan,D,WPG,26,0,0,0,0
43,8478146,Matthew Highmore,C,OTT,28,0,0,0,0
43,8478970,Jalen Chatfield,D,CAR,28,0,0,0,0
43,8480205,Emil Bemstrom,C,PIT,25,0,0,0,0
43,8474884,Mike Hoffman,C,,35,0,0,0,0
43,8471274,Alex Goligoski,D,,39,0,0,0,0
43,8478104,Sammy Blais,L,,28,0,0,0,0
43,8474870,Tyler Johnson,C,,34,0,0,0,0
43,8476913,Devin Shore,C,MIN,30,0,0,0,0
43,8481598,Philip Broberg,D,EDM,23,0,0,0,0
43,8480058,Pierre-Olivier Joseph,D,STL,25,0,0,0,0
43,8480891,Michael Kesselring,D,UTA,24,0,0,0,0
43,8477979,Nicolas Aube-Kubel,R,BUF,28,0,0,0,0
43,8476871,Tanner Pearson,L,,32,0,0,0,0
43,8476393,Nick Cousins,C,,31,0,0,0,0
43,8479977,Kailer Yamamoto,R,,26,0,0,0,0
43,8479543,Michael Pezzetta,L,MTL,26,0,0,0,0
43,8477018,Ben Hutton,D,VGK,31,0,0,0,0
43,8480762,Eric Robinson,L,CAR,29,0,0,0,0
43,8474034,Pat Maroon,L,CHI,36,0,0,0,0
43,8481058,Jesse Ylönen,R,,25,0,0,0,0
43,8475179,Dmitry Kulikov,D,FLA,34,0,0,0,0
43,8481527,Kaedan Korczak,D,VGK,23,0,0,0,0
43,8473449,Kyle Okposo,R,,36,0,0,0,0
43,8482192,Isaak Phillips,D,CHI,23,0,0,0,0
43,8480727,Zach Whitecloud,D,VGK,28,0,0,0,0
43,8479346,Dillon Dube,C,,26,0,0,0,0
43,8480821,Filip Zadina,R,,25,0,0,0,0
43,8480001,Urho Vaakanainen,D,ANA,25,0,0,0,0
43,8470966,Mark Giordano,D,,41,0,0,0,0
43,8480853,Liam Foudy,C,,24,0,0,0,0
43,8475225,Craig Smith,C,CHI,35,0,0,0,0
43,8479972,Mason Shaw,C,WPG,26,0,0,0,0
43,8478451,Ethan Bear,D,WSH,27,0,0,0,0
43,8474040,Sam Gagner,C,,35,0,0,0,0
43,8480196,Jacob Bryson,D,BUF,27,0,0,0,0
43,8479984,Cal Foote,D,,26,0,0,0,0
43,8480011,Klim Kostin,C,SJS,25,0,0,0,0
43,8482176,Wyatt Kaiser,D,CHI,22,0,0,0,0
43,8476988,Matt Benning,D,SJS,30,0,0,0,0
43,8479370,Tyson Jost,C,CAR,26,0,0,0,0
43,8477464,Nic Petan,C,,29,0,0,0,0
43,8477380,Jonny Brodzinski,C,NYR,31,0,0,0,0
43,8480070,Ian Mitchell,D,BOS,25,0,0,0,0
43,8479315,Joey Anderson,R,CHI,26,0,0,0,0
43,8478099,Kevin Labanc,R,,29,0,0,0,0
43,8476874,Olli Maatta,D,DET,30,0,0,0,0
43,8475208,Brian Dumoulin,D,ANA,33,0,0,0,0
43,8478430,Oliver Kylington,D,,27,0,0,0,0
43,8479536,Axel Jonsson-Fjallby,L,WPG,26,0,0,0,0
43,8479671,Mathieu Olivier,R,CBJ,27,0,0,0,0
43,8471709,Marc-Edouard Vlasic,D,SJS,37,0,0,0,0
43,8479328,Julien Gauthier,R,NYI,27,0,0,0,0
43,8478421,A.J. Greer,L,FLA,28,0,0,0,0
43,8477573,Nathan Walker,L,STL,30,0,0,0,0
43,8481537,Nikita Okhotiuk,D,CGY,24,0,0,0,0
43,8474166,Alec Martinez,D,CHI,37,0,0,0,0
43,8470610,Zach Parise,L,,40,0,0,0,0
43,8477478,William Carrier,L,CAR,30,0,0,0,0
43,8479344,Jesse Puljujarvi,R,PIT,26,0,0,0,0
43,8480887,Jordan Harris,D,MTL,24,0,0,0,0
43,8478502,Dennis Gilbert,D,BUF,28,0,0,0,0
43,8482730,Brandt Clarke,D,LAK,21,0,0,0,0
43,8480355,Mark Kastelic,C,BOS,25,0,0,0,0
43,8475750,Jon Merrill,D,MIN,32,0,0,0,0
43,8475164,Jakob Silfverberg,R,,34,0,0,0,0
43,8477944,Jakub Vrana,L,,28,0,0,0,0
43,8479439,Jacob MacDonald,D,COL,31,0,0,0,0
43,8474568,Luke Schenn,D,NSH,35,0,0,0,0
43,8478454,Noah Juulsen,D,VAN,27,0,0,0,0
43,8475752,Tyler Pitlick,C,,33,0,0,0,0
43,8482148,Hendrix Lapierre,C,WSH,22,0,0,0,0
43,8481167,Brayden Pachal,D,CGY,25,0,0,0,0
43,8478043,Sam Lafferty,C,BUF,29,0,0,0,0
43,8479321,Lucas Johansen,D,,27,0,0,0,0
43,8471699,Andrew Cogliano,C,,37,0,0,0,0
43,8481521,Ronnie Attard,D,PHI,25,0,0,0,0
43,8481161,Jake Christiansen,D,CBJ,25,0,0,0,0
43,8479458,Nikita Zaitsev,D,,33,0,0,0,0
43,8479619,Michael Carcone,L,UTA,28,0,0,0,0
43,8479026,Philippe Myers,D,TOR,27,0,0,0,0
43,8477330,Dominik Kubalik,L,,29,0,0,0,0
43,8481617,Vasily Podkolzin,R,VAN,23,0,0,0,0
43,8481701,Santeri Hatakka,D,NJD,23,0,0,0,0
43,8479514,Rem Pitlick,C,,27,0,0,0,0
43,8477446,Michael McCarron,R,NSH,29,0,0,0,0
43,8470604,Jeff Carter,C,,39,0,0,0,0
43,8482241,Radim Zohorna,L,,28,0,0,0,0
43,8480289,Morgan Barron,C,WPG,26,0,0,0,0
43,8479379,Givani Smith,R,SJS,26,0,0,0,0
43,8480216,Jacob Peterson,C,,25,0,0,0,0
43,8477851,Jordan Oesterle,D,BOS,32,0,0,0,0
43,8484258,Sam Malinski,D,COL,26,0,0,0,0
43,8478904,Steven Lorentz,C,,28,0,0,0,0
43,8482095,Tyler Kleven,D,OTT,22,0,0,0,0
43,8480848,Ty Dellandrea,C,SJS,24,0,0,0,0
43,8476884,Derrick Pouliot,D,,30,0,0,0,0
43,8479336,Carl Grundstrom,R,SJS,27,0,0,0,0
43,8482964,Arber Xhekaj,D,MTL,23,0,0,0,0
43,8471686,Marc Staal,D,,37,0,0,0,0
43,8477887,Patrick Brown,C,BOS,32,0,0,0,0
43,8478495,Denis Gurianov,R,,27,0,0,0,0
43,8473504,Cal Clutterbuck,R,,37,0,0,0,0
43,8481550,Adam Beckman,L,NJD,23,0,0,0,0
43,8480845,Rasmus Kupari,C,WPG,24,0,0,0,0
43,8474009,Nick Bonino,C,,36,0,0,0,0
43,8478585,Derek Ryan,C,EDM,38,0,0,0,0
43,8477962,Brendan Lemieux,L,CAR,28,0,0,0,0
43,8482861,Vincent Iorio,D,WSH,22,0,0,0,0
43,8479378,Logan Stanley,D,WPG,26,0,0,0,0
43,8473446,Erik Johnson,D,PHI,36,0,0,0,0
43,8481743,Marc Del Gaizo,D,NSH,25,0,0,0,0
43,8477384,Josh Brown,D,EDM,30,0,0,0,0
43,8482165,Yan Kuznetsov,D,CGY,22,0,0,0,0
43,8478424,Jansen Harkins,C,ANA,27,0,0,0,0
43,8482144,Jack Thompson,D,SJS,22,0,0,0,0
43,8478512,Austin Czarnik,C,,32,0,0,0,0
43,8477527,Ross Johnston,L,ANA,30,0,0,0,0
43,8479383,Boris Katchouk,L,,26,0,0,0,0
43,8482094,Daemon Hunt,D,MIN,22,0,0,0,0
43,8481719,Maxwell Crozier,D,TBL,24,0,0,0,0
43,8480192,Johnathan Kovacevic,D,NJD,27,0,0,0,0
43,8479376,Victor Mete,D,,26,0,0,0,0
43,8482511,Mason Lohrei,D,BOS,23,0,0,0,0
43,8475825,Jani Hakanpää,D,,32,0,0,0,0
43,8478021,William Lagesson,D,DET,28,0,0,0,0
43,8475795,Dylan McIlrath,D,WSH,32,0,0,0,0
43,8477846,Ryan Carpenter,C,,33,0,0,0,0
43,8481056,Spencer Stastney,D,NSH,24,0,0,0,0
43,8481564,Ryan Johnson,D,BUF,23,0,0,0,0
43,8478017,Mark Friedman,D,VAN,29,0,0,0,0
43,8479320,Max Lajoie,D,SEA,27,0,0,0,0
43,8480075,Cameron Crotty,D,MIN,25,0,0,0,0
43,8484287,Cole McWard,D,VAN,23,0,0,0,0
43,8484254,Akito Hirose,D,VAN,25,0,0,0,0
43,8483407,Brandon Scanlin,D,NYR,25,0,0,0,0
43,8480274,Philip Kemp,D,EDM,25,0,0,0,0
43,8479522,Hardy Haman Aktell,D,WSH,26,0,0,0,0
43,8480007,Jonas Rondbjerg,R,VGK,25,0,0,0,0
43,8477454,Adam Erne,L,,29,0,0,0,0
43,8481679,Maxence Guenette,D,OTT,23,0,0,0,0
43,8480441,Trey Fix-Wolansky,R,CBJ,25,0,0,0,0
43,8483546,Marshall Rifai,D,TOR,26,0,0,0,0
43,8480084,Nick DeSimone,D,NJD,30,0,0,0,0
43,8481030,Jack St. Ivany,D,PIT,25,0,0,0,0
43,8481592,Jakob Pelletier,L,CGY,23,0,0,0,0
43,8478011,Louie Belpedio,D,PHI,28,0,0,0,0
43,8477930,Pierre-Edouard Bellemare,L,,39,0,0,0,0
43,8484321,Nikolas Matinpalo,D,OTT,26,0,0,0,0
43,8482067,Connor Mackey,D,NYR,28,0,0,0,0
43,8481806,Louis Crevier,D,CHI,23,0,0,0,0
43,8484326,Patrik Koch,D,UTA,28,0,0,0,0
43,8477971,Andreas Englund,D,LAK,28,0,0,0,0
43,8481751,Lukas Rousek,R,BUF,25,0,0,0,0
43,8481006,Tyler Tucker,D,STL,24,0,0,0,0
43,8476867,Brendan Gaunce,C,MIN,30,0,0,0,0
43,8479520,Brandon Duhaime,R,WSH,27,0,0,0,0
43,8477073,Kurtis MacDermid,L,NJD,30,0,0,0,0
43,8480874,Adam Ginning,D,PHI,24,0,0,0,0
43,8477473,Justin Bailey,R,SJS,29,0,0,0,0
43,8479066,Ryan Lomberg,L,CGY,30,0,0,0,0
43,8477070,Liam O'Brien,C,UTA,30,0,0,0,0
43,8474618,Marco Scandella,D,,34,0,0,0,0
43,8475797,Jarred Tinordi,D,,32,0,0,0,0
43,8481441,Joe Snively,C,DET,28,0,0,0,0
43,8477244,Chad Ruhwedel,D,NYR,34,0,0,0,0
43,8479772,Zack MacEwen,R,OTT,28,0,0,0,0
43,8481147,Reese Johnson,C,MIN,26,0,0,0,0
43,8481043,Cole Koepke,L,BOS,26,0,0,0,0
43,8483619,Filip Roos,D,OTT,25,0,0,0,0
43,8481541,Samuel Bolduc,D,NYI,24,0,0,0,0
43,8477810,Joel Hanley,D,CGY,33,0,0,0,0
43,8476907,Mackenzie MacEachern,L,,30,0,0,0,0
43,8482652,Walker Duehr,R,CGY,27,0,0,0,0
43,8477126,Jayson Megna,C,,34,0,0,0,0
43,8483398,Declan Carlile,D,TBL,31,0,0,0,0
43,8482929,Emil Lilleberg,D,TBL,23,0,0,0,0
43,8480880,Jakub Lauko,C,MIN,24,0,0,0,0
43,8480245,Olle Lycksell,R,PHI,25,0,0,0,0
43,8480252,Cole Guttman,C,CHI,25,0,0,0,0
43,8477467,Gustav Olofsson,D,SEA,30,0,0,0,0
43,8479968,Vinni Lettieri,C,BOS,29,0,0,0,0
43,8478400,Colin White,C,,27,0,0,0,0
43,8475755,Alexander Petrovic,D,DAL,32,0,0,0,0
43,8481812,Nikolai Knyzhov,D,,27,0,0,0,0
43,8481593,Jayden Struble,D,MTL,23,0,0,0,0
43,8481532,Alex Turcotte,C,LAK,23,0,0,0,0
43,8482126,Emil Andrae,D,PHI,31,0,0,0,0
43,8479944,Zach Aston-Reese,C,VGK,30,0,0,0,0
43,8471817,Ryan Reaves,R,TOR,37,0,0,0,0
43,8481206,John Ludvig,D,PIT,24,0,0,0,0
43,8481599,Victor Soderstrom,D,UTA,23,0,0,0,0
43,8480292,Carson Meyer,R,ANA,27,0,0,0,0
43,8482496,Nils Aman,C,VAN,24,0,0,0,0
43,8479718,Alex Barré-Boulet,C,MTL,27,0,0,0,0
43,8479994,Jaret Anderson-Dolan,C,WPG,25,0,0,0,0
43,8480184,Gustav Lindstrom,D,,26,0,0,0,0
43,8480890,Jan Jenik,R,OTT,24,0,0,0,0
43,8478067,Oskar Lindblom,L,,28,0,0,0,0
43,8476934,Brock McGinn,L,ANA,30,0,0,0,0
43,8479985,Cale Fleury,D,SEA,26,0,0,0,0
43,8484304,Uvis Balinskis,D,FLA,28,0,0,0,0
43,8479981,Jonah Gadjovich,L,FLA,26,0,0,0,0
43,8481716,Dmitri Voronkov,L,CBJ,24,0,0,0,0
43,8474709,Matt Martin,L,,35,0,0,0,0
43,8482634,Alex Steeves,C,TOR,25,0,0,0,0
43,8480823,Alexander Alexeyev,D,WSH,25,0,0,0,0
43,8477541,Dakota Mermis,D,TOR,30,0,0,0,0
43,8483491,Ivan Miroshnichenko,L,WSH,20,0,0,0,0
43,8478477,Mitchell Stephens,C,SEA,27,0,0,0,0
43,8481543,Nikita Alexandrov,C,STL,24,0,0,0,0
43,8479423,Alex Nylander,L,,26,0,0,0,0
43,8482451,Mikael Pyyhtia,L,CBJ,23,0,0,0,0
43,8478831,Kevin Stenlund,C,UTA,28,0,0,0,0
43,8480306,Grant Hutton,D,NYI,29,0,0,0,0
43,8478028,Fredrik Olofsson,L,,28,0,0,0,0
43,8477462,Robert Hagg,D,VGK,29,0,0,0,0
43,8477320,Anton Blidh,L,NYR,29,0,0,0,0
43,8482157,Will Cuylle,L,NYR,22,0,0,0,0
43,8482737,Zack Bolduc,C,STL,21,0,0,0,0
43,8481239,Samuel Fagemo,L,,24,0,0,0,0
43,8481600,Tobias Bjornfot,D,FLA,23,0,0,0,0
43,8478409,Anthony Richard,C,PHI,28,0,0,0,0
43,8474145,Robert Bortuzzo,D,,35,0,0,0,0
43,8475958,Michael Sgarbossa,C,WSH,32,0,0,0,0
43,8479986,Kole Lind,R,DAL,26,0,0,0,0
43,8479249,Andrew Poturalski,C,SJS,30,0,0,0,0
43,8479362,Riley Tufte,L,BOS,26,0,0,0,0
43,8479991,Jake Leschyshyn,C,NYR,25,0,0,0,0
43,8479587,Rhett Gardner,C,PHI,28,0,0,0,0
43,8482744,James Malatesta,L,CBJ,21,0,0,0,0
43,8478854,Ryan Shea,D,PIT,27,0,0,0,0
43,8481591,Sam Poulin,R,,23,0,0,0,0
43,8483512,Matt Savoie,C,EDM,20,0,0,0,0
43,8482102,Vasily Ponomarev,C,PIT,22,0,0,0,0
43,8482162,Roby Jarventie,L,EDM,22,0,0,0,0
43,8481016,Ruslan Iskhakov,C,,24,0,0,0,0
43,8482172,Landon Slaggert,L,CHI,22,0,0,0,0
43,8482747,Brennan Othmann,L,NYR,21,0,0,0,0
43,8480031,Maxime Comtois,L,,25,0,0,0,0
43,8480226,Marián Studenic,R,,26,0,0,0,0
43,8478408,Travis Dermott,D,,28,0,0,0,0
43,8481518,Nolan Foote,L,NJD,24,0,0,0,0
43,8479419,Brett Murray,L,BUF,26,0,0,0,0
43,8482088,Justin Sourdif,R,FLA,22,0,0,0,0
43,8482201,Gage Goncalves,C,TBL,23,0,0,0,0
43,8481578,Graeme Clarke,R,MIN,23,0,0,0,0
43,8482177,Marat Khusnutdinov,C,MIN,22,0,0,0,0
43,8481754,Nikita Nesterenko,C,ANA,23,0,0,0,0
43,8483531,Brian Halonen,L,NJD,25,0,0,0,0
43,8483920,Pierrick Dube,R,WSH,23,0,0,0,0
43,8480851,Akil Thomas,C,LAK,24,0,0,0,0
43,8475235,Nicolas Deslauriers,L,PHI,33,0,0,0,0
43,8482476,Emil Heineman,L,MTL,23,0,0,0,0
43,8477149,Scott Sabourin,R,SJS,32,0,0,0,0
43,8483549,Lucas Condotta,L,MTL,27,0,0,0,0
43,8482765,Isak Rosen,R,BUF,21,0,0,0,0
43,8481237,Kyle MacLean,C,NYI,25,0,0,0,0
43,8481024,Linus Karlsson,C,VAN,25,0,0,0,0
43,8481690,Tyler Angle,C,,24,0,0,0,0
43,8483570,Ben Meyers,C,SEA,26,0,0,0,0
43,8481655,Cole Schwindt,R,CGY,23,0,0,0,0
43,8481462,Mason Morelli,L,VGK,28,0,0,0,0
43,8483401,Marc Johnstone,R,PIT,28,0,0,0,0
43,8478956,Samuel Laberge,L,NJD,27,0,0,0,0
43,8479533,Joona Koppanen,L,,26,0,0,0,0
43,8482197,Adam Raska,R,MIN,23,0,0,0,0
43,8482250,Callahan Burke,C,VGK,27,0,0,0,0
43,8482784,Zach Dean,C,STL,21,0,0,0,0
43,8484255,Jason Polin,R,COL,25,0,0,0,0
43,8481077,John Leonard,L,,26,0,0,0,0
43,8481534,Raphael Lavoie,C,EDM,24,0,0,0,0
43,8483609,Adam Klapka,R,CGY,24,0,0,0,0
43,8482751,Ryan Winterton,C,SEA,21,0,0,0,0
43,8480267,Sammy Walker,C,MIN,25,0,0,0,0
43,8475766,Austin Watson,L,,32,0,0,0,0
43,8482460,Matt Rempe,C,NYR,22,0,0,0,0
43,8481065,Angus Crookshank,L,OTT,25,0,0,0,0
43,8481070,Hugh McGing,L,,26,0,0,0,0
43,8476323,Max McCormick,L,SEA,32,0,0,0,0
43,8483395,Arshdeep Bains,L,VAN,23,0,0,0,0
43,8484259,Ondrej Pavel,C,COL,31,0,0,0,0
43,8483432,Luca Del Bel Belluz,C,CBJ,31,0,0,0,0
43,8483045,Cameron Butler,R,CBJ,31,0,0,0,0
43,8482061,Brandon Biro,L,SEA,26,0,0,0,0
43,8477401,John Hayden,C,SEA,29,0,0,0,0
43,8475278,Byron Froese,C,,33,0,0,0,0
43,8478446,Glenn Gawdin,C,LAK,27,0,0,0,0
43,8477993,Justin Kirkland,C,CGY,28,0,0,0,0
43,8482147,Jean-Luc Foudy,C,COL,22,0,0,0,0
43,8480032,Shane Bowers,C,NJD,25,0,0,0,0
43,8479330,Brandon Gignac,C,MTL,27,0,0,0,0
43,8480776,Sheldon Rempal,R,,29,0,0,0,0
43,8475413,Justin Dowling,C,NJD,34,0,0,0,0
43,8481726,Adam Edstrom,C,NYR,24,0,0,0,0
43,8480844,Grigori Denisenko,L,VGK,24,0,0,0,0
43,8478147,Bokondji Imama,L,PIT,28,0,0,0,0
43,8478881,Brett Seney,L,CHI,28,0,0,0,0
43,8483630,Pavol Regenda,L,ANA,25,0,0,0,0
43,8480836,Jonathan Gruden,C,,24,0,0,0,0
43,8484314,Jiri Smejkal,L,,28,0,0,0,0
43,8475780,Chris Wagner,R,COL,33,0,0,0,0
43,8479546,Oskar Steen,C,,26,0,0,0,0
43,8483597,Milos Kelemen,L,UTA,25,0,0,0,0
43,8481789,Tye Kartye,L,SEA,23,0,0,0,0
43,8484325,Waltteri Merela,C,TBL,26,0,0,0,0
43,8479421,Jacob Moverare,D,LAK,26,0,0,0,0
43,8481585,Egor Afanasyev,L,SJS,23,0,0,0,0
43,8479547,Matthew Phillips,R,,26,0,0,0,0
43,8479367,William Lockwood,R,FLA,26,0,0,0,0
43,8476915,Jujhar Khaira,L,,30,0,0,0,0
43,8481422,Jacob Lucchini,C,NSH,29,0,0,0,0
43,8480468,James Hamblin,L,EDM,25,0,0,0,0
43,8478051,Max Willman,C,NJD,29,0,0,0,0
43,8481556,John Beecher,C,BOS,23,0,0,0,0
43,8478078,Rourke Chartier,C,,28,0,0,0,0
44,8478402,Connor McDavid,C,EDM,27,82,42,103,145
44,8478864,Kirill Kaprizov,L,MIN,27,82,58,71,129
44,8479318,Auston Matthews,C,TOR,27,82,56,72,128
44,8477492,Nathan MacKinnon,C,COL,29,82,57,70,127
44,8476453,Nikita Kucherov,R,TBL,31,82,47,80,127
44,8477956,David Pastrnak,R,BOS,28,82,56,69,125
44,8479314,Matthew Tkachuk,L,FLA,27,82,45,75,120
44,8481559,Jack Hughes,C,NJD,23,82,48,69,117
44,8477934,Leon Draisaitl,C,EDM,29,82,48,68,116
44,8476468,J.T. Miller,C,VAN,31,82,43,70,113
44,8477939,William Nylander,R,TOR,28,82,59,51,110
44,8478550,Artemi Panarin,L,NYR,33,82,40,70,110
44,8477933,Sam Reinhart,C,FLA,29,82,44,64,108
44,8471675,Sidney Crosby,C,PIT,37,82,43,63,106
44,8476887,Filip Forsberg,L,NSH,30,82,50,53,103
44,8478420,Mikko Rantanen,R,COL,28,82,40,63,103
44,8480801,Brady Tkachuk,L,OTT,25,82,51,50,101
44,8477493,Aleksander Barkov,C,FLA,29,82,30,71,101
44,8479323,Adam Fox,D,NYR,26,82,18,83,101
44,8480800,Quinn Hughes,D,VAN,25,82,16,82,98
44,8478403,Jack Eichel,C,VGK,28,82,37,60,97
44,8478427,Sebastian Aho,C,CAR,27,82,43,52,95
44,8480012,Elias Pettersson,C,VAN,26,82,37,57,94
44,8478010,Brayden Point,C,TBL,28,82,52,41,93
44,8480002,Nico Hischier,C,NJD,25,82,27,66,93
44,8480069,Cale Makar,D,COL,26,82,28,64,92
44,8477942,Kevin Fiala,L,LAK,28,82,37,52,89
44,8476881,Tomas Hertl,C,VGK,31,82,35,53,88
44,8477402,Pavel Buchnevich,L,STL,29,82,41,46,87
44,8478047,Michael Bunting,L,PIT,29,82,32,55,87
44,8478449,Roope Hintz,C,DAL,28,82,42,44,86
44,8478398,Kyle Connor,L,WPG,28,82,39,47,86
44,8480027,Jason Robertson,L,DAL,25,82,34,52,86
44,8475172,Nazem Kadri,C,CGY,34,82,29,57,86
44,8471214,Alex Ovechkin,L,WSH,39,82,46,39,85
44,8475166,John Tavares,C,TOR,34,82,35,50,85
44,8476459,Mika Zibanejad,C,NYR,31,82,35,50,85
44,8476539,Jonathan Marchessault,R,NSH,34,82,43,41,84
44,8481557,Matt Boldy,L,MIN,23,82,32,51,83
44,8480865,Noah Dobson,D,NYI,24,82,16,67,83
44,8476346,Johnny Gaudreau,L,CBJ,31,82,21,61,82
44,8476456,Jonathan Huberdeau,C,CGY,31,82,15,67,82
44,8476460,Mark Scheifele,C,WPG,31,82,33,48,81
44,8482116,Tim Stützle,C,OTT,22,82,24,57,81
44,8482093,Seth Jarvis,C,CAR,22,82,32,48,80
44,8477404,Jake Guentzel,C,TBL,30,82,31,49,80
44,8476462,Dougie Hamilton,D,NJD,31,82,31,49,80
44,8479407,Jesper Bratt,L,NJD,26,82,25,55,80
44,8477503,Max Domi,C,TOR,29,82,25,55,80
44,8474590,John Carlson,D,WSH,34,82,20,60,80
44,8474600,Roman Josi,D,NSH,34,82,18,62,80
44,8478439,Travis Konecny,R,PHI,27,82,32,47,79
44,8476454,Ryan Nugent-Hopkins,C,EDM,31,82,14,65,79
44,8478873,Troy Terry,R,ANA,27,82,35,43,78
44,8471215,Evgeni Malkin,C,PIT,38,82,33,45,78
44,8475810,Bryan Rust,R,PIT,32,82,32,46,78
44,8479385,Jordan Kyrou,C,STL,26,82,30,48,78
44,8481523,Kirby Dach,C,MTL,23,82,15,63,78
44,8475184,Chris Kreider,L,NYR,33,82,43,34,77
44,8477409,Carter Verhaeghe,C,FLA,29,82,38,39,77
44,8478445,Mathew Barzal,C,NYI,27,82,18,59,77
44,8479675,Trevor Moore,L,LAK,29,82,31,45,76
44,8475913,Mark Stone,R,VGK,32,82,29,46,75
44,8480036,Miro Heiskanen,D,DAL,25,82,17,58,75
44,8475754,Brock Nelson,C,NYI,33,82,40,34,74
44,8475786,Zach Hyman,L,EDM,32,82,40,34,74
44,8477501,Valeri Nichushkin,R,COL,29,82,39,35,74
44,8478042,Viktor Arvidsson,R,EDM,31,82,30,44,74
44,8475158,Ryan O'Reilly,C,NSH,33,82,30,44,74
44,8479343,Clayton Keller,R,UTA,26,82,27,47,74
44,8474564,Steven Stamkos,C,NSH,34,82,23,51,74
44,8476389,Vincent Trocheck,C,NYR,31,82,20,54,74
44,8477951,Nick Schmaltz,C,UTA,28,82,25,48,73
44,8477496,Elias Lindholm,C,BOS,30,82,22,51,73
44,8477946,Dylan Larkin,C,DET,28,82,36,36,72
44,8479420,Tage Thompson,C,BUF,27,82,36,36,72
44,8480830,Andrei Svechnikov,R,CAR,24,82,29,43,72
44,8475692,Mats Zuccarello,R,MIN,37,82,17,55,72
44,8480023,Robert Thomas,C,STL,25,82,19,52,71
44,8478407,Vince Dunn,D,SEA,28,82,14,57,71
44,8477504,Josh Morrissey,D,WPG,29,82,13,58,71
44,8478414,Timo Meier,R,NJD,28,82,40,30,70
44,8479542,Brandon Hagel,L,TBL,26,82,31,39,70
44,8475168,Matt Duchene,C,DAL,33,82,30,40,70
44,8473512,Claude Giroux,R,OTT,36,82,24,46,70
44,8480803,Evan Bouchard,D,EDM,25,82,19,51,70
44,8480208,Drake Batherson,R,OTT,26,82,27,42,69
44,8477949,Alex Tuch,R,BUF,28,82,23,46,69
44,8476853,Morgan Rielly,D,TOR,30,82,13,56,69
44,8477497,Sean Monahan,C,CBJ,30,82,26,42,68
44,8477447,Shea Theodore,D,VGK,29,82,17,51,68
44,8476432,Boone Jenner,C,CBJ,31,82,40,27,67
44,8481540,Cole Caufield,R,MTL,23,82,35,32,67
44,8481528,Dylan Cozens,C,BUF,23,82,26,41,67
44,8476906,Shayne Gostisbehere,D,CAR,31,82,12,55,67
44,8477500,Bo Horvat,C,NYI,29,82,35,31,66
44,8475784,Jeff Skinner,C,EDM,32,82,28,38,66
44,8473419,Brad Marchand,L,BOS,36,82,20,46,66
44,8478440,Dylan Strome,C,WSH,27,82,15,51,66
44,8478444,Brock Boeser,R,VAN,27,82,35,30,65
44,8477940,Nikolaj Ehlers,L,WPG,28,82,26,39,65
44,8482159,Tyson Foerster,R,PHI,22,82,36,28,64
44,8478493,Joel Eriksson Ek,C,MIN,27,82,35,29,64
44,8482665,Matty Beniers,C,SEA,22,82,27,37,64
44,8478460,Zach Werenski,D,CBJ,27,82,16,48,64
44,8482699,Dylan Guenther,R,UTA,21,82,32,31,63
44,8482109,Alexis Lafrenière,L,NYR,23,82,26,37,63
44,8481533,Trevor Zegras,C,ANA,23,82,24,39,63
44,8480018,Nick Suzuki,C,MTL,25,82,20,43,63
44,8476448,William Karlsson,C,VGK,31,82,35,27,62
44,8475745,Charlie Coyle,C,BOS,32,82,31,31,62
44,8478975,Mason Marchment,L,DAL,29,82,25,37,62
44,8478469,Thomas Chabot,D,OTT,27,82,19,43,62
44,8474563,Drew Doughty,D,LAK,35,82,15,47,62
44,8480188,Fabian Zetterlund,L,SJS,25,82,27,34,61
44,8476882,Teuvo Teravainen,L,CHI,30,82,26,35,61
44,8477407,Anthony Duclair,L,NYI,29,82,24,37,61
44,8480839,Rasmus Dahlin,D,BUF,24,82,20,41,61
44,8471685,Anze Kopitar,C,LAK,37,82,20,41,61
44,8479425,Filip Hronek,D,VAN,27,82,12,49,61
44,8479325,Charlie McAvoy,D,BOS,27,82,10,51,61
44,8477479,Tyler Bertuzzi,L,CHI,29,82,31,29,60
44,8478519,Anthony Cirelli,C,TBL,27,82,24,36,60
44,8475798,Mikael Granlund,C,SJS,32,82,17,43,60
44,8478396,Noah Hanifin,D,VGK,27,82,14,46,60
44,8480829,Jesperi Kotkaniemi,C,CAR,24,82,31,28,59
44,8476483,Rickard Rakell,R,PIT,31,82,29,30,59
44,8482113,Anton Lundell,C,FLA,23,82,26,33,59
44,8478438,Tommy Novak,C,NSH,27,82,20,39,59
44,8480078,Filip Chytil,C,NYR,25,82,20,39,59
44,8478397,Rasmus Andersson,D,CGY,28,82,14,45,59
44,8477511,Anthony Mantha,R,CGY,30,82,30,28,58
44,8477935,Sam Bennett,C,FLA,28,82,27,31,58
44,8480797,Joel Farabee,L,PHI,24,82,26,32,58
44,8480015,Owen Tippett,R,PHI,25,82,24,34,58
44,8474565,Alex Pietrangelo,D,VGK,34,82,11,47,58
44,8475169,Evander Kane,L,EDM,33,82,31,26,57
44,8482092,Ridly Greig,C,OTT,22,82,24,33,57
44,8482097,Jack Quinn,R,BUF,23,82,23,34,57
44,8478401,Pavel Zacha,C,BOS,27,82,22,35,57
44,8478542,Evan Rodrigues,C,FLA,31,82,21,36,57
44,8474141,Patrick Kane,R,DET,36,82,15,42,57
44,8475794,Tyler Seguin,C,DAL,32,82,28,28,56
44,8476479,Phillip Danault,C,LAK,31,82,28,28,56
44,8482745,Mason McTavish,C,ANA,21,82,27,29,56
44,8475170,Brayden Schenn,C,STL,33,82,22,34,56
44,8477451,Ryan Hartman,R,MIN,30,82,19,37,56
44,8478474,Lawson Crouse,L,UTA,27,82,36,19,55
44,8480064,Josh Norris,C,OTT,25,82,26,29,55
44,8477960,Adrian Kempe,R,LAK,28,82,20,35,55
44,8474102,David Perron,L,OTT,36,82,18,37,55
44,8477932,Aaron Ekblad,D,FLA,28,82,17,38,55
44,8474679,Gustav Nyquist,C,NSH,35,82,14,41,55
44,8477495,Seth Jones,D,CHI,30,82,12,43,55
44,8475167,Victor Hedman,D,TBL,34,82,9,46,55
44,8476880,Tom Wilson,R,WSH,30,82,26,28,54
44,8479339,Patrik Laine,L,CBJ,26,82,25,29,54
44,8481068,Yegor Sharangovich,C,CGY,26,82,24,30,54
44,8478458,Jack Roslovic,C,CAR,27,82,17,37,54
44,8477416,Oliver Bjorkstrand,R,SEA,29,82,16,38,54
44,8474578,Erik Karlsson,D,PIT,34,82,11,43,54
44,8477346,MacKenzie Weegar,D,CGY,30,82,20,33,53
44,8476872,Scott Laughton,C,PHI,30,82,19,34,53
44,8481711,Matias Maccelli,L,UTA,24,82,17,36,53
44,8473994,Jamie Benn,L,DAL,35,82,16,37,53
44,8480014,Gabriel Vilardi,C,WPG,25,82,31,21,52
44,8479337,Alex DeBrincat,R,DET,27,82,29,23,52
44,8480039,Martin Necas,C,CAR,25,82,27,25,52
44,8475191,Reilly Smith,R,NYR,33,82,26,26,52
44,8476905,Chandler Stephenson,C,SEA,30,82,22,30,52
44,8475151,Kyle Palmieri,C,NYI,33,82,22,30,52
44,8475287,Erik Haula,L,NJD,33,82,19,33,52
44,8478856,Conor Garland,R,VAN,28,82,18,34,52
44,8479345,Jakob Chychrun,D,WSH,26,82,16,36,52
44,8480434,Sean Durzi,D,UTA,26,82,10,42,52
44,8473986,Alex Killorn,L,ANA,35,82,25,26,51
44,8477444,Andre Burakovsky,L,SEA,29,82,22,29,51
44,8475765,Vladimir Tarasenko,R,DET,33,82,21,30,51
44,8479400,Pierre-Luc Dubois,L,WSH,26,82,16,35,51
44,8480028,Morgan Frost,C,PHI,25,82,16,35,51
44,8482684,Luke Hughes,D,NJD,21,82,12,39,51
44,8470613,Brent Burns,D,CAR,39,82,12,39,51
44,8476854,Hampus Lindholm,D,BOS,30,82,7,44,51
44,8482078,Lucas Raymond,L,DET,22,82,21,29,50
44,8477998,Warren Foegele,L,LAK,28,82,21,29,50
44,8480849,Barrett Hayton,C,UTA,24,82,21,29,50
44,8482105,Jake Sanderson,D,OTT,22,82,17,33,50
44,8481581,Thomas Harley,D,DAL,23,82,12,38,50
44,8481596,Shane Pinto,C,OTT,24,82,19,30,49
44,8475726,Tyler Toffoli,C,SJS,32,82,17,32,49
44,8479410,Mikhail Sergachev,D,UTA,26,82,8,41,49
44,8475764,Cam Fowler,D,ANA,33,82,6,43,49
44,8475314,Anders Lee,L,NYI,34,82,27,21,48
44,8482667,William Eklund,L,SJS,22,82,26,22,48
44,8477964,Ivan Barbashev,C,VGK,29,82,22,26,48
44,8475793,Ryan Johansen,C,PHI,32,82,20,28,48
44,8474150,Mikael Backlund,C,CGY,35,82,16,32,48
44,8475753,Justin Faulk,D,STL,32,82,15,33,48
44,8477494,Jonathan Drouin,L,COL,29,82,9,39,48
44,8474641,Adam Henrique,C,EDM,34,82,24,23,47
44,8477021,Alex Kerfoot,C,UTA,30,82,18,29,47
44,8475791,Taylor Hall,L,CHI,33,82,17,30,47
44,8478462,Nicolas Roy,C,VGK,27,82,15,32,47
44,8476419,Jean-Gabriel Pageau,C,NYI,32,82,15,32,47
44,8481542,Moritz Seider,D,DET,23,82,9,38,47
44,8480043,Timothy Liljegren,D,TOR,25,82,3,44,47
44,8480113,Alex Iafallo,L,WPG,31,82,29,17,46
44,8478233,Andrew Mangiapane,L,WSH,28,82,19,27,46
44,8482124,Quinton Byfield,R,LAK,22,82,14,32,46
44,8481546,Cam York,D,PHI,23,82,12,34,46
44,8476792,Torey Krug,D,STL,33,82,11,35,46
44,8476958,Jaccob Slavin,D,CAR,30,82,7,39,46
44,8479525,Ross Colton,C,COL,28,82,27,18,45
44,8478498,Jake DeBrusk,L,VAN,28,82,26,19,45
44,8480459,Pius Suter,C,VAN,28,82,25,20,45
44,8482175,JJ Peterka,R,BUF,22,82,24,21,45
44,8474586,Jordan Eberle,R,SEA,34,82,22,23,45
44,8475722,Jason Zucker,L,BUF,32,82,21,24,45
44,8480009,Eeli Tolvanen,R,SEA,25,82,19,26,45
44,8476927,Teddy Blueger,C,VAN,30,82,17,28,45
44,8481656,Aliaksei Protas,C,WSH,23,82,15,30,45
44,8480798,Philipp Kurashev,C,CHI,25,82,13,32,45
44,8480835,Jack Drury,C,CAR,24,82,21,23,44
44,8477955,Jared McCann,L,SEA,28,82,20,24,44
44,8471724,Kris Letang,D,PIT,37,82,16,28,44
44,8477948,Travis Sanheim,D,PHI,28,82,15,29,44
44,8480817,K'Andre Miller,D,NYR,24,82,14,30,44
44,8478038,Devon Toews,D,COL,30,82,9,35,44
44,8482740,Wyatt Johnston,C,DAL,21,82,23,20,43
44,8482055,Drew O'Connor,L,PIT,26,82,23,20,43
44,8477456,J.T. Compher,L,DET,29,82,20,23,43
44,8474053,Logan Couture,C,SJS,35,82,19,24,43
44,8476921,Jordan Martinook,L,CAR,32,82,19,24,43
44,8478057,Dakota Joshua,C,VAN,28,82,12,31,43
44,8482660,Kent Johnson,C,CBJ,22,82,9,34,43
44,8476826,Yanni Gourde,C,SEA,33,82,20,22,42
44,8482146,Luke Evangelista,R,NSH,22,82,18,24,42
44,8471698,T.J. Oshie,R,WSH,38,82,16,26,42
44,8482110,Dawson Mercer,C,NJD,23,82,25,16,41
44,8483808,Andrei Kuzmenko,L,CGY,28,82,25,16,41
44,8476438,Brandon Saad,L,STL,32,82,21,20,41
44,8478366,Frank Vatrano,R,ANA,30,82,20,21,41
44,8479987,Morgan Geekie,C,BOS,26,82,20,21,41
44,8476461,Sean Couturier,C,PHI,32,82,16,25,41
44,8477986,Brandon Montour,D,SEA,30,82,13,28,41
44,8477429,Andrew Copp,C,DET,30,82,12,29,41
44,8480185,Eetu Luostarinen,C,FLA,26,82,12,29,41
44,8476875,Mike Matheson,D,MTL,30,82,8,33,41
44,8481604,Pavel Dorofeyev,L,VGK,24,82,22,18,40
44,8482720,Matthew Knies,L,TOR,22,82,19,21,40
44,8476474,Stefan Noesen,R,NJD,31,82,19,21,40
44,8475799,Nino Niederreiter,R,WPG,32,82,18,22,40
44,8474149,Evgenii Dadonov,R,DAL,35,82,15,25,40
44,8480144,David Kampf,C,TOR,29,82,15,25,40
44,8481618,Alex Newhook,C,MTL,23,82,13,27,40
44,8479999,Casey Mittelstadt,C,COL,26,82,12,28,40
44,8478055,Gustav Forsling,D,FLA,28,82,9,31,40
44,8476329,Travis Boyd,C,MIN,31,82,7,33,40
44,8480873,Rasmus Sandin,D,WSH,24,82,7,33,40
44,8476917,Adam Pelech,D,NYI,30,82,4,36,40
44,8480893,Kirill Marchenko,R,CBJ,24,82,27,12,39
44,8482079,Marco Rossi,C,MIN,23,82,21,18,39
44,8481535,Nils Hoglander,L,VAN,24,82,20,19,39
44,8477476,Artturi Lehkonen,L,COL,29,82,19,20,39
44,8476392,Adam Lowry,C,WPG,31,82,19,20,39
44,8477953,Kasperi Kapanen,R,STL,28,82,18,21,39
44,8480220,Noah Cates,L,PHI,25,82,17,22,39
44,8478463,Anthony Beauvillier,L,PIT,27,82,17,22,39
44,8480855,Jack McBain,C,UTA,24,82,16,23,39
44,8476885,Jacob Trouba,D,NYR,30,82,12,27,39
44,8479351,Sam Steel,C,DAL,26,82,12,27,39
44,8480871,Adam Boqvist,D,FLA,24,82,11,28,39
44,8479992,Michael Rasmussen,C,DET,25,82,21,17,38
44,8476981,Josh Anderson,R,MTL,30,82,18,20,38
44,8477952,Robby Fabbri,C,ANA,28,82,16,22,38
44,8475193,Tomas Tatar,L,NJD,34,82,14,24,38
44,8476458,Ryan Strome,C,ANA,31,82,13,25,38
44,8478472,Mathieu Joseph,R,STL,27,82,13,25,38
44,8476960,Andreas Athanasiou,C,CHI,30,82,13,25,38
44,8476902,Esa Lindell,D,DAL,30,82,5,33,38
44,8482671,Owen Power,D,BUF,22,82,5,33,38
44,8479365,Trent Frederic,C,BOS,26,82,21,16,37
44,8484144,Connor Bedard,C,CHI,19,82,20,17,37
44,8475760,Nick Bjugstad,C,UTA,32,82,19,18,37
44,8477426,Nicholas Paul,L,TBL,29,82,18,19,37
44,8474715,Cam Atkinson,R,TBL,35,82,14,23,37
44,8477989,Christian Dvorak,C,MTL,28,82,14,23,37
44,8476869,Brady Skjei,D,NSH,30,82,11,26,37
44,8483515,Juraj Slafkovsky,L,MTL,20,82,19,17,36
44,8481582,Nicholas Robertson,L,TOR,23,82,19,17,36
44,8482705,Cole Sillinger,C,CBJ,21,82,17,19,36
44,8477839,Conor Sheary,L,TBL,32,82,17,19,36
44,8481477,Nico Sturm,C,SJS,29,82,17,19,36
44,8475714,Calle Jarnkrok,C,TOR,33,82,14,22,36
44,8473422,Nick Foligno,L,CHI,37,82,14,22,36
44,8477919,Frederick Gaudreau,C,MIN,31,82,14,22,36
44,8475218,Mattias Ekholm,D,EDM,34,82,12,24,36
44,8477498,Darnell Nurse,D,EDM,29,82,11,25,36
44,8475763,Kevin Hayes,R,PIT,32,82,10,26,36
44,8474716,Jared Spurgeon,D,MIN,35,82,9,27,36
44,8475171,Oliver Ekman-Larsson,D,TOR,33,82,7,29,36
44,8476399,Blake Coleman,C,CGY,33,82,16,19,35
44,8478133,Jake Evans,C,MTL,28,82,16,19,35
44,8475149,Marcus Johansson,L,MIN,34,82,15,20,35
44,8473563,Nicklas Backstrom,C,WSH,37,82,15,20,35
44,8478891,Mason Appleton,C,WPG,28,82,13,22,35
44,8474189,Lars Eller,C,PIT,35,82,13,22,35
44,8476480,Vladislav Namestnikov,C,WPG,32,82,13,22,35
44,8480748,Kiefer Sherwood,L,VAN,29,82,11,24,35
44,8479976,Juuso Valimaki,D,UTA,26,82,9,26,35
44,8481560,Arthur Kaliyev,R,LAK,23,82,16,18,34
44,8481624,Ilya Mikheyev,R,CHI,30,82,16,18,34
44,8477450,Jason Dickinson,C,CHI,29,82,14,20,34
44,8482062,Cole Smith,L,NSH,29,82,13,21,34
44,8477987,Ryan Donato,C,CHI,28,82,12,22,34
44,8480068,Ryan Poehling,C,PHI,25,82,11,23,34
44,8482149,Cole Perfetti,C,WPG,22,82,10,24,34
44,8482133,Thomas Bordeleau,C,SJS,22,82,10,24,34
44,8476923,Damon Severson,D,CBJ,30,82,5,29,34
44,8478507,John Marino,D,UTA,27,82,5,29,34
44,8477220,Nate Schmidt,D,FLA,33,82,5,29,34
44,8478046,Danton Heinen,L,VAN,29,82,17,16,33
44,8481704,Juuso Parssinen,C,NSH,23,82,16,17,33
44,8480003,Jesper Boqvist,C,FLA,26,82,16,17,33
44,8478413,Jordan Greenway,L,BUF,27,82,15,18,33
44,8481606,Jordan Spence,D,LAK,23,82,12,21,33
44,8478911,Matt Roy,D,WSH,29,82,11,22,33
44,8480336,Sean Walker,D,CAR,30,82,8,25,33
44,8479996,Cody Glass,C,NSH,25,82,20,12,32
44,8479293,Brandon Tanev,L,SEA,33,82,18,14,32
44,8478115,Pierre Engvall,L,NYI,28,82,17,15,32
44,8479941,Justin Danforth,R,CBJ,31,82,17,15,32
44,8477425,Miles Wood,L,COL,29,82,16,16,32
44,8480813,Joe Veleno,C,DET,24,82,13,19,32
44,8475220,Marcus Foligno,L,MIN,33,82,13,19,32
44,8480074,Alexandre Texier,C,STL,25,82,12,20,32
44,8477969,Marcus Pettersson,D,PIT,28,82,7,25,32
44,8479983,Mario Ferraro,D,SJS,26,82,7,25,32
44,8476892,Colton Parayko,D,STL,31,82,7,25,32
44,8476292,Ondrej Palat,L,NJD,33,82,6,26,32
44,8476979,Erik Gustafsson,D,DET,32,82,5,27,32
44,8482141,Lukas Cormier,D,VGK,22,82,18,13,31
44,8482089,Jake Neighbours,L,STL,22,82,17,14,31
44,8475768,Jaden Schwartz,C,SEA,32,82,15,16,31
44,8477508,Curtis Lazar,C,NJD,29,82,15,16,31
44,8479661,Tanner Jeannot,L,LAK,27,82,14,17,31
44,8480789,Oliver Wahlstrom,R,NYI,24,82,14,17,31
44,8481553,Bobby Brink,R,PHI,23,82,12,19,31
44,8480980,Connor Dewar,C,TOR,25,82,12,19,31
44,8478569,Noel Acciari,C,PIT,33,82,11,20,31
44,8482475,Yegor Chinakhov,R,CBJ,23,82,10,21,31
44,8480878,Nils Lundkvist,D,DAL,24,82,10,21,31
44,8477507,Nikita Zadorov,D,BOS,29,82,9,22,31
44,8482655,J.J. Moser,D,TBL,24,82,7,24,31
44,8479402,Jake Bean,D,CGY,26,82,2,29,31
44,8478508,Yakov Trenin,C,MIN,27,82,18,12,30
44,8476918,Jimmy Vesey,L,NYR,31,82,17,13,30
44,8479591,Michael Eyssimont,C,TBL,28,82,15,15,30
44,8480802,Ryan McLeod,C,BUF,25,82,13,17,30
44,8479353,Brett Howden,C,VGK,26,82,11,19,30
44,8482111,Justin Barron,D,MTL,23,82,9,21,30
44,8475200,Dmitry Orlov,D,CAR,33,82,6,24,30
44,8479998,Mikey Anderson,D,LAK,25,82,5,25,30
44,8480145,Neal Pionk,D,WPG,29,82,2,28,30
44,8476429,Scott Mayfield,D,NYI,32,82,1,29,30
44,8479390,Taylor Raddysh,R,WSH,26,82,18,11,29
44,8481554,Kaapo Kakko,R,NYR,23,82,16,13,29
44,8479393,Noah Gregor,C,OTT,26,82,15,14,29
44,8482624,Daniil Miromanov,D,CGY,27,82,14,15,29
44,8477506,Ryan Pulock,D,NYI,30,82,13,16,29
44,8473533,Jordan Staal,C,CAR,36,82,12,17,29
44,8483431,Logan Cooley,C,UTA,20,82,11,18,29
44,8476422,Mike Reilly,D,NYI,31,82,11,18,29
44,8483763,Maksymilian Szuber,D,UTA,22,82,10,19,29
44,8476457,Adam Larsson,D,SEA,32,82,6,23,29
44,8478416,Erik Cernak,D,TBL,27,82,6,23,29
44,8478500,Ivan Provorov,D,CBJ,27,82,4,25,29
44,8479324,Ryan Lindgren,D,NYR,26,82,2,27,29
44,8478020,Michael Amadio,C,OTT,28,82,17,11,28
44,8479316,Luke Kunin,C,SJS,27,82,17,11,28
44,8479368,Max Jones,L,BOS,26,82,15,13,28
44,8475848,Brendan Gallagher,R,MTL,32,82,15,13,28
44,8478109,Victor Olofsson,L,VGK,29,82,12,16,28
44,8482166,Shakir Mukhamadullin,D,SJS,22,82,11,17,28
44,8476925,Colton Sissons,C,NSH,31,82,8,20,28
44,8477015,Connor Brown,R,EDM,30,82,8,20,28
44,8480807,Mattias Samuelsson,D,BUF,24,82,7,21,28
44,8477488,Brett Pesce,D,NJD,30,82,5,23,28
44,8477845,Trevor van Riemsdyk,D,WSH,33,82,5,23,28
44,8476331,Dylan DeMelo,D,WPG,31,82,4,24,28
44,8474151,Ryan McDonagh,D,TBL,35,82,3,25,28
44,8481517,Brett Leason,R,ANA,25,82,17,10,27
44,8476278,Colin Blackwell,C,DAL,31,82,13,14,27
44,8475343,Nic Dowd,C,WSH,34,82,13,14,27
44,8481481,Blake Lizotte,C,PIT,27,82,10,17,27
44,8478013,Jake Walman,D,SJS,28,82,10,17,27
44,8481186,Logan O'Connor,R,COL,28,82,9,18,27
44,8475855,Jesper Fast,R,CAR,33,82,8,19,27
44,8476467,Jamie Oleksiak,D,SEA,32,82,8,19,27
44,8478840,Will Borgen,D,SEA,28,82,6,21,27
44,8476891,Matt Grzelcyk,D,PIT,30,82,4,23,27
44,8480049,Dylan Samberg,D,WPG,25,82,3,24,27
44,8480246,Nick Perbix,D,TBL,26,82,2,25,27
44,8476873,Mark Jankowski,C,NSH,30,82,16,10,26
44,8477947,Sonny Milano,L,WSH,28,82,14,12,26
44,8481580,Connor McMichael,C,WSH,23,82,13,13,26
44,8476469,Joel Armia,R,MTL,31,82,12,14,26
44,8476374,Sean Kuraly,C,CBJ,31,82,11,15,26
44,8480796,Martin Fehervary,D,WSH,25,82,10,16,26
44,8480995,Pontus Holmberg,R,TOR,25,82,9,17,26
44,8478211,Dryden Hunt,L,CGY,29,82,9,17,26
44,8477505,Alexander Wennberg,C,SJS,30,82,8,18,26
44,8475462,Radko Gudas,D,ANA,34,82,4,22,26
44,8475690,Chris Tanev,D,TOR,35,82,2,24,26
44,8480281,Alexey Toropchenko,R,STL,25,82,18,7,25
44,8484145,Zach Benson,L,BUF,19,82,17,8,25
44,8476897,Oskar Sundqvist,C,STL,30,82,13,12,25
44,8482125,Alexander Holtz,R,VGK,22,82,12,13,25
44,8476442,Matt Nieto,L,PIT,32,82,12,13,25
44,8482733,Logan Mailloux,D,MTL,31,82,12,13,25
44,8482122,Brock Faber,D,MIN,22,82,11,14,25
44,8476889,Radek Faksa,C,STL,30,82,8,17,25
44,8476463,Jonas Brodin,D,MIN,31,82,6,19,25
44,8479398,Samuel Girard,D,COL,26,82,5,20,25
44,8480073,Erik Brannstrom,D,COL,25,82,5,20,25
44,8478882,Vladislav Gavrikov,D,LAK,29,82,3,22,25
44,8477365,Connor Clifton,D,BUF,29,82,3,22,25
44,8474574,Tyler Myers,D,VAN,34,82,3,22,25
44,8478851,Alexandre Carrier,D,NSH,28,82,2,23,25
44,8480035,Henri Jokiharju,D,BUF,25,82,1,24,25
44,8482245,Artem Zub,D,OTT,29,82,0,25,25
44,8484153,Leo Carlsson,C,ANA,20,82,9,15,24
44,8475324,Nick Jensen,D,OTT,34,82,7,17,24
44,8478178,Darren Raddysh,D,TBL,28,82,7,17,24
44,8476312,Josh Manson,D,COL,33,82,7,17,24
44,8482142,Jamie Drysdale,D,PHI,22,82,6,18,24
44,8482087,Kaiden Guhle,D,MTL,22,82,5,19,24
44,8479371,Dante Fabbro,D,NSH,26,82,5,19,24
44,8473507,Jeff Petry,D,DET,37,82,4,20,24
44,8476624,Barclay Goodrow,C,SJS,31,82,3,21,24
44,8481178,Egor Zamula,D,PHI,24,82,2,22,24
44,8484203,Bradly Nadeau,L,CAR,19,82,13,10,23
44,8476858,Phillip Di Giuseppe,L,VAN,31,82,12,11,23
44,8470621,Corey Perry,R,EDM,39,82,11,12,23
44,8477931,Tomas Nosek,L,FLA,32,82,11,12,23
44,8476878,Zemgus Girgensons,L,TBL,30,82,10,13,23
44,8482803,Olen Zellweger,D,ANA,21,82,9,14,23
44,8480448,Parker Kelly,L,COL,25,82,8,15,23
44,8477435,Ryan Graves,D,PIT,29,82,6,17,23
44,8480806,Isac Lundestrom,C,ANA,25,82,6,17,23
44,8475181,Nick Leddy,D,STL,33,82,3,20,23
44,8480860,Kevin Bahl,D,CGY,24,82,3,20,23
44,8480950,Ilya Lyubushkin,D,DAL,30,82,3,20,23
44,8475718,Justin Holl,D,DET,32,82,3,20,23
44,8475188,Brayden McNabb,D,VGK,33,82,2,21,23
44,8482117,Lukas Reichel,L,CHI,22,82,11,11,22
44,8484166,Adam Fantilli,C,CBJ,20,82,10,12,22
44,8477369,Carson Soucy,D,VAN,30,82,9,13,22
44,8482666,Scott Morrow,D,CAR,22,82,9,13,22
44,8475231,Casey Cizikas,C,NYI,33,82,8,14,22
44,8484911,Collin Graf,R,SJS,22,82,8,14,22
44,8482807,Ethan Del Mastro,D,CHI,21,82,8,14,22
44,8481522,Peyton Krebs,C,BUF,23,82,6,16,22
44,8482073,Braden Schneider,D,NYR,23,82,5,17,22
44,8474612,Travis Hamonic,D,OTT,34,82,4,18,22
44,8476931,Jake McCabe,D,TOR,31,82,3,19,22
44,8481032,Paul Cotter,C,NJD,25,82,12,9,21
44,8481093,Rafael Harvey-Pinard,L,MTL,25,82,11,10,21
44,8482077,Dylan Holloway,L,EDM,23,82,11,10,21
44,8477353,Tyler Motte,C,DET,29,82,10,11,21
44,8477903,Garnet Hathaway,R,PHI,33,82,10,11,21
44,8479359,Beck Malenstyn,L,BUF,26,82,9,12,21
44,8483457,Lane Hutson,D,MTL,20,82,7,14,21
44,8483524,Shane Wright,C,SEA,20,82,5,16,21
44,8478136,Jake Middleton,D,MIN,28,82,5,16,21
44,8483495,Simon Nemec,D,NJD,20,82,5,16,21
44,8483482,Tristan Luneau,D,ANA,20,82,4,17,21
44,8482858,Ryker Evans,D,SEA,23,82,4,17,21
44,8477499,Rasmus Ristolainen,D,PHI,30,82,3,18,21
44,8483490,Pavel Mintyukov,D,ANA,21,82,3,18,21
44,8479369,Andrew Peeke,D,BOS,26,82,3,18,21
44,8480222,Sebastian Aho,D,PIT,28,82,3,18,21
44,8475455,Brenden Dillon,D,NJD,34,82,3,18,21
44,8481028,Martin Pospisil,C,CGY,25,82,13,7,20
44,8482259,Bobby McMann,C,TOR,28,82,13,7,20
44,8483505,Matthew Poitras,C,BOS,20,82,12,8,20
44,8477392,Hudson Fasching,R,NYI,29,82,10,10,20
44,8477938,Haydn Fleury,D,WPG,28,82,8,12,20
44,8483445,Cutter Gauthier,L,ANA,20,82,5,15,20
44,8479980,Nicolas Hague,D,VGK,26,82,4,16,20
44,8477335,Kyle Burroughs,D,LAK,29,82,4,16,20
44,8481708,Zac Jones,D,NYR,24,82,3,17,20
44,8478468,Jeremy Lauzon,D,NSH,27,82,3,17,20
44,8480990,Declan Chisholm,D,MIN,24,82,3,17,20
44,8483493,Frank Nazar,C,CHI,20,82,3,17,20
44,8478399,Jonas Siegenthaler,D,NJD,27,82,2,18,20
44,8480879,Jacob Bernard-Docker,D,OTT,24,82,2,18,20
44,8482679,Matt Coronato,R,CGY,22,82,11,8,19
44,8475842,Sam Carrick,C,NYR,32,82,11,8,19
44,8481601,Simon Holmstrom,R,NYI,23,82,10,9,19
44,8482702,Logan Stankoven,C,DAL,21,82,9,10,19
44,8482762,Simon Edvinsson,D,DET,21,82,9,10,19
44,8478450,Parker Wotherspoon,D,BOS,27,82,9,10,19
44,8477406,Mattias Janmark,C,EDM,32,82,7,12,19
44,8475790,Erik Gudbranson,D,CBJ,32,82,5,14,19
44,8479414,Nathan Bastian,R,NJD,27,82,12,6,18
44,8480025,MacKenzie Entwistle,R,FLA,25,82,10,8,18
44,8478434,Keegan Kolesar,R,VGK,27,82,9,9,18
44,8475177,Calvin de Haan,D,COL,33,82,9,9,18
44,8481013,Jonatan Berggren,R,DET,24,82,8,10,18
44,8483489,Fraser Minten,C,TOR,31,82,8,10,18
44,8481641,Joel Kiviranta,L,COL,28,82,7,11,18
44,8482153,Brendan Brisson,C,VGK,23,82,7,11,18
44,8478859,Niko Mikkola,D,FLA,28,82,4,14,18
44,8474673,TJ Brodie,D,CHI,34,82,3,15,18
44,8470600,Ryan Suter,D,STL,39,82,3,15,18
44,8476372,Nick Seeler,D,PHI,31,82,3,15,18
44,8476967,Brett Kulak,D,EDM,30,82,2,16,18
44,8482809,Jackson Blake,R,CAR,21,82,9,8,17
44,8480021,Jack Studnicka,C,LAK,25,82,9,8,17
44,8478432,Christian Fischer,R,DET,27,82,8,9,17
44,8476879,Cody Ceci,D,EDM,31,82,6,11,17
44,8483468,Jiri Kulich,C,BUF,20,82,6,11,17
44,8474013,Ian Cole,D,UTA,35,82,3,14,17
44,8477034,Jaycob Megna,D,FLA,32,82,3,14,17
44,8475233,David Savard,D,MTL,34,82,2,15,17
44,8475279,Ben Chiarot,D,DET,33,82,2,15,17
44,8482155,Alex Laferriere,R,LAK,23,82,14,2,16
44,8482074,Connor Zary,C,CGY,23,82,12,4,16
44,8473453,Trevor Lewis,C,LAK,37,82,10,6,16
44,8481524,Bowen Byram,D,BUF,23,82,9,7,16
44,8482470,Ilya Solovyov,D,CGY,24,82,5,11,16
44,8481699,Aku Raty,R,UTA,23,82,5,11,16
44,8483499,Liam Ohgren,L,MIN,20,82,4,12,16
44,8480172,Jan Rutta,D,SJS,34,82,4,12,16
44,8476525,Colin Miller,D,WPG,32,82,3,13,16
44,8483471,Brad Lambert,C,WPG,31,82,0,16,16
44,8482659,Josh Doan,R,UTA,22,82,8,7,15
44,8479638,Justin Brazeau,R,BOS,26,82,6,9,15
44,8483460,David Jiricek,D,CBJ,21,82,4,11,15
44,8482516,Matthew Kessel,D,STL,24,82,4,11,15
44,8482713,Mackie Samoskevich,R,FLA,22,82,8,6,14
44,8482712,Oskar Olausson,R,COL,22,82,6,8,14
44,8484149,Gavin Brindley,C,CBJ,20,82,5,9,14
44,8481605,Jackson LaCombe,D,ANA,23,82,3,11,14
44,8481568,Alex Vlasic,D,CHI,23,82,3,11,14
44,8481014,Alexander Romanov,D,NYI,24,82,0,14,14
44,8483567,Georgii Merkulov,C,BOS,24,82,6,7,13
44,8483012,Logan Morrison,C,SEA,22,82,5,8,13
44,8482101,Danil Gushchin,L,SJS,22,82,4,9,13
44,8483565,Nick Blankenburg,D,NSH,26,82,3,10,13
44,8475762,Derek Forbort,D,VAN,32,82,3,10,13
44,8471677,Jack Johnson,D,CBJ,37,82,1,12,13
44,8476441,Joel Edmundson,D,LAK,31,82,1,12,13
44,8483397,Marc McLaughlin,C,BOS,25,82,8,4,12
44,8482145,Mavrik Bourque,C,DAL,22,82,6,6,12
44,8482859,Zack Ostapchuk,C,OTT,21,82,4,8,12
44,8478443,Brandon Carlo,D,BOS,28,82,2,10,12
44,8482118,Sam Colangelo,R,ANA,23,82,2,10,12
44,8476822,Luke Glendening,C,TBL,35,82,5,6,11
44,8481567,Henry Thrun,D,SJS,23,82,3,8,11
44,8474567,Zach Bogosian,D,MIN,34,82,3,8,11
44,8479442,Troy Stecher,D,EDM,30,82,5,5,10
44,8482070,Mitchell Chaffee,R,TBL,26,82,5,5,10
44,8474090,Brendan Smith,D,DAL,35,82,3,7,10
44,8479576,Vincent Desharnais,D,VAN,28,82,3,7,10
44,8483466,Kevin Korchinski,D,CHI,20,82,1,9,10
44,8476473,Connor Murphy,D,CHI,31,82,4,5,9
44,8482749,Joshua Roy,R,MTL,21,82,4,5,9
44,8478874,Adam Gaudette,C,OTT,28,82,0,9,9
44,8479291,Kevin Rooney,C,CGY,31,82,2,6,8
44,8481122,Simon Benoit,D,TOR,26,82,1,7,8
44,8480870,Bo Groulx,C,NYR,24,82,4,2,6
44,8474062,Riley Nash,C,NYR,35,82,2,4,6
44,8480834,Ty Emberson,D,SJS,24,82,1,5,6
44,8482787,Nikita Chibrikov,R,WPG,31,82,0,6,6
44,8470794,Joe Pavelski,C,,40,0,0,0,0
44,8481703,Valtteri Puustinen,R,PIT,25,0,0,0,0
44,8477950,Tony DeAngelo,D,,29,0,0,0,0
44,8481577,Philip Tomasino,C,NSH,23,0,0,0,0
44,8475197,Tyson Barrie,D,,33,0,0,0,0
44,8471218,Blake Wheeler,R,,38,0,0,0,0
44,8474157,Max Pacioretty,L,,36,0,0,0,0
44,8478466,Daniel Sprong,R,VAN,27,0,0,0,0
44,8475744,Evgeny Kuznetsov,C,,32,0,0,0,0
44,8481019,David Gustafsson,C,WPG,24,0,0,0,0
44,8475906,John Klingberg,D,,32,0,0,0,0
44,8479348,Kale Clague,D,BUF,26,0,0,0,0
44,8476952,Dominic Toninato,C,WPG,30,0,0,0,0
44,8473473,Milan Lucic,L,,36,0,0,0,0
44,8474037,James van Riemsdyk,L,,35,0,0,0,0
44,8474602,Justin Schultz,D,,34,0,0,0,0
44,8482222,Alexander Barabanov,L,,30,0,0,0,0
44,8479372,Josh Mahura,D,SEA,26,0,0,0,0
44,8479982,Conor Timmins,D,TOR,26,0,0,0,0
44,8474031,Kevin Shattenkirk,D,,35,0,0,0,0
44,8480008,Adam Ruzicka,C,,25,0,0,0,0
44,8481059,Scott Perunovich,D,STL,26,0,0,0,0
44,8480884,Calen Addison,D,,24,0,0,0,0
44,8476994,Vinnie Hinostroza,C,NSH,30,0,0,0,0
44,8478452,Caleb Jones,D,LAK,27,0,0,0,0
44,8480157,Calle Rosen,D,COL,30,0,0,0,0
44,8481609,Vladislav Kolyachonok,D,UTA,23,0,0,0,0
44,8479415,Michael McLeod,C,,26,0,0,0,0
44,8476919,Chris Tierney,C,,30,0,0,0,0
44,8479639,Dylan Coghlan,D,WPG,26,0,0,0,0
44,8478146,Matthew Highmore,C,OTT,28,0,0,0,0
44,8478970,Jalen Chatfield,D,CAR,28,0,0,0,0
44,8480205,Emil Bemstrom,C,PIT,25,0,0,0,0
44,8474884,Mike Hoffman,C,,35,0,0,0,0
44,8471274,Alex Goligoski,D,,39,0,0,0,0
44,8478104,Sammy Blais,L,,28,0,0,0,0
44,8474870,Tyler Johnson,C,,34,0,0,0,0
44,8476913,Devin Shore,C,MIN,30,0,0,0,0
44,8481598,Philip Broberg,D,EDM,23,0,0,0,0
44,8480058,Pierre-Olivier Joseph,D,STL,25,0,0,0,0
44,8480891,Michael Kesselring,D,UTA,24,0,0,0,0
44,8477979,Nicolas Aube-Kubel,R,BUF,28,0,0,0,0
44,8476871,Tanner Pearson,L,,32,0,0,0,0
44,8476393,Nick Cousins,C,,31,0,0,0,0
44,8479977,Kailer Yamamoto,R,,26,0,0,0,0
44,8479543,Michael Pezzetta,L,MTL,26,0,0,0,0
44,8477018,Ben Hutton,D,VGK,31,0,0,0,0
44,8480762,Eric Robinson,L,CAR,29,0,0,0,0
44,8474034,Pat Maroon,L,CHI,36,0,0,0,0
44,8481058,Jesse Ylönen,R,,25,0,0,0,0
44,8475179,Dmitry Kulikov,D,FLA,34,0,0,0,0
44,8481527,Kaedan Korczak,D,VGK,23,0,0,0,0
44,8473449,Kyle Okposo,R,,36,0,0,0,0
44,8482192,Isaak Phillips,D,CHI,23,0,0,0,0
44,8480727,Zach Whitecloud,D,VGK,28,0,0,0,0
44,8479346,Dillon Dube,C,,26,0,0,0,0
44,8480821,Filip Zadina,R,,25,0,0,0,0
44,8480001,Urho Vaakanainen,D,ANA,25,0,0,0,0
44,8470966,Mark Giordano,D,,41,0,0,0,0
44,8480853,Liam Foudy,C,,24,0,0,0,0
44,8475225,Craig Smith,C,CHI,35,0,0,0,0
44,8479972,Mason Shaw,C,WPG,26,0,0,0,0
44,8478451,Ethan Bear,D,WSH,27,0,0,0,0
44,8474040,Sam Gagner,C,,35,0,0,0,0
44,8480196,Jacob Bryson,D,BUF,27,0,0,0,0
44,8479984,Cal Foote,D,,26,0,0,0,0
44,8480011,Klim Kostin,C,SJS,25,0,0,0,0
44,8482176,Wyatt Kaiser,D,CHI,22,0,0,0,0
44,8476988,Matt Benning,D,SJS,30,0,0,0,0
44,8479370,Tyson Jost,C,CAR,26,0,0,0,0
44,8477464,Nic Petan,C,,29,0,0,0,0
44,8477380,Jonny Brodzinski,C,NYR,31,0,0,0,0
44,8480070,Ian Mitchell,D,BOS,25,0,0,0,0
44,8479315,Joey Anderson,R,CHI,26,0,0,0,0
44,8478099,Kevin Labanc,R,,29,0,0,0,0
44,8476874,Olli Maatta,D,DET,30,0,0,0,0
44,8475208,Brian Dumoulin,D,ANA,33,0,0,0,0
44,8478430,Oliver Kylington,D,,27,0,0,0,0
44,8479536,Axel Jonsson-Fjallby,L,WPG,26,0,0,0,0
44,8479671,Mathieu Olivier,R,CBJ,27,0,0,0,0
44,8471709,Marc-Edouard Vlasic,D,SJS,37,0,0,0,0
44,8479328,Julien Gauthier,R,NYI,27,0,0,0,0
44,8478421,A.J. Greer,L,FLA,28,0,0,0,0
44,8477573,Nathan Walker,L,STL,30,0,0,0,0
44,8481537,Nikita Okhotiuk,D,CGY,24,0,0,0,0
44,8474166,Alec Martinez,D,CHI,37,0,0,0,0
44,8470610,Zach Parise,L,,40,0,0,0,0
44,8477478,William Carrier,L,CAR,30,0,0,0,0
44,8479344,Jesse Puljujarvi,R,PIT,26,0,0,0,0
44,8480887,Jordan Harris,D,MTL,24,0,0,0,0
44,8478502,Dennis Gilbert,D,BUF,28,0,0,0,0
44,8482730,Brandt Clarke,D,LAK,21,0,0,0,0
44,8480355,Mark Kastelic,C,BOS,25,0,0,0,0
44,8475750,Jon Merrill,D,MIN,32,0,0,0,0
44,8475164,Jakob Silfverberg,R,,34,0,0,0,0
44,8477944,Jakub Vrana,L,,28,0,0,0,0
44,8479439,Jacob MacDonald,D,COL,31,0,0,0,0
44,8474568,Luke Schenn,D,NSH,35,0,0,0,0
44,8478454,Noah Juulsen,D,VAN,27,0,0,0,0
44,8475752,Tyler Pitlick,C,,33,0,0,0,0
44,8482148,Hendrix Lapierre,C,WSH,22,0,0,0,0
44,8481167,Brayden Pachal,D,CGY,25,0,0,0,0
44,8478043,Sam Lafferty,C,BUF,29,0,0,0,0
44,8479321,Lucas Johansen,D,,27,0,0,0,0
44,8471699,Andrew Cogliano,C,,37,0,0,0,0
44,8481521,Ronnie Attard,D,PHI,25,0,0,0,0
44,8481161,Jake Christiansen,D,CBJ,25,0,0,0,0
44,8479458,Nikita Zaitsev,D,,33,0,0,0,0
44,8479619,Michael Carcone,L,UTA,28,0,0,0,0
44,8479026,Philippe Myers,D,TOR,27,0,0,0,0
44,8477330,Dominik Kubalik,L,,29,0,0,0,0
44,8481617,Vasily Podkolzin,R,VAN,23,0,0,0,0
44,8481701,Santeri Hatakka,D,NJD,23,0,0,0,0
44,8479514,Rem Pitlick,C,,27,0,0,0,0
44,8477446,Michael McCarron,R,NSH,29,0,0,0,0
44,8470604,Jeff Carter,C,,39,0,0,0,0
44,8482241,Radim Zohorna,L,,28,0,0,0,0
44,8480289,Morgan Barron,C,WPG,26,0,0,0,0
44,8479379,Givani Smith,R,SJS,26,0,0,0,0
44,8480216,Jacob Peterson,C,,25,0,0,0,0
44,8477851,Jordan Oesterle,D,BOS,32,0,0,0,0
44,8484258,Sam Malinski,D,COL,26,0,0,0,0
44,8478904,Steven Lorentz,C,,28,0,0,0,0
44,8482095,Tyler Kleven,D,OTT,22,0,0,0,0
44,8480848,Ty Dellandrea,C,SJS,24,0,0,0,0
44,8476884,Derrick Pouliot,D,,30,0,0,0,0
44,8479336,Carl Grundstrom,R,SJS,27,0,0,0,0
44,8482964,Arber Xhekaj,D,MTL,23,0,0,0,0
44,8471686,Marc Staal,D,,37,0,0,0,0
44,8477887,Patrick Brown,C,BOS,32,0,0,0,0
44,8478495,Denis Gurianov,R,,27,0,0,0,0
44,8473504,Cal Clutterbuck,R,,37,0,0,0,0
44,8481550,Adam Beckman,L,NJD,23,0,0,0,0
44,8480845,Rasmus Kupari,C,WPG,24,0,0,0,0
44,8474009,Nick Bonino,C,,36,0,0,0,0
44,8478585,Derek Ryan,C,EDM,38,0,0,0,0
44,8477962,Brendan Lemieux,L,CAR,28,0,0,0,0
44,8482861,Vincent Iorio,D,WSH,22,0,0,0,0
44,8479378,Logan Stanley,D,WPG,26,0,0,0,0
44,8473446,Erik Johnson,D,PHI,36,0,0,0,0
44,8481743,Marc Del Gaizo,D,NSH,25,0,0,0,0
44,8477384,Josh Brown,D,EDM,30,0,0,0,0
44,8482165,Yan Kuznetsov,D,CGY,22,0,0,0,0
44,8478424,Jansen Harkins,C,ANA,27,0,0,0,0
44,8482144,Jack Thompson,D,SJS,22,0,0,0,0
44,8478512,Austin Czarnik,C,,32,0,0,0,0
44,8477527,Ross Johnston,L,ANA,30,0,0,0,0
44,8479383,Boris Katchouk,L,,26,0,0,0,0
44,8482094,Daemon Hunt,D,MIN,22,0,0,0,0
44,8481719,Maxwell Crozier,D,TBL,24,0,0,0,0
44,8480192,Johnathan Kovacevic,D,NJD,27,0,0,0,0
44,8479376,Victor Mete,D,,26,0,0,0,0
44,8482511,Mason Lohrei,D,BOS,23,0,0,0,0
44,8475825,Jani Hakanpää,D,,32,0,0,0,0
44,8478021,William Lagesson,D,DET,28,0,0,0,0
44,8475795,Dylan McIlrath,D,WSH,32,0,0,0,0
44,8477846,Ryan Carpenter,C,,33,0,0,0,0
44,8481056,Spencer Stastney,D,NSH,24,0,0,0,0
44,8481564,Ryan Johnson,D,BUF,23,0,0,0,0
44,8478017,Mark Friedman,D,VAN,29,0,0,0,0
44,8479320,Max Lajoie,D,SEA,27,0,0,0,0
44,8480075,Cameron Crotty,D,MIN,25,0,0,0,0
44,8484287,Cole McWard,D,VAN,23,0,0,0,0
44,8484254,Akito Hirose,D,VAN,25,0,0,0,0
44,8483407,Brandon Scanlin,D,NYR,25,0,0,0,0
44,8480274,Philip Kemp,D,EDM,25,0,0,0,0
44,8479522,Hardy Haman Aktell,D,WSH,26,0,0,0,0
44,8480007,Jonas Rondbjerg,R,VGK,25,0,0,0,0
44,8477454,Adam Erne,L,,29,0,0,0,0
44,8481679,Maxence Guenette,D,OTT,23,0,0,0,0
44,8480441,Trey Fix-Wolansky,R,CBJ,25,0,0,0,0
44,8483546,Marshall Rifai,D,TOR,26,0,0,0,0
44,8480084,Nick DeSimone,D,NJD,30,0,0,0,0
44,8481030,Jack St. Ivany,D,PIT,25,0,0,0,0
44,8481592,Jakob Pelletier,L,CGY,23,0,0,0,0
44,8478011,Louie Belpedio,D,PHI,28,0,0,0,0
44,8477930,Pierre-Edouard Bellemare,L,,39,0,0,0,0
44,8484321,Nikolas Matinpalo,D,OTT,26,0,0,0,0
44,8482067,Connor Mackey,D,NYR,28,0,0,0,0
44,8481806,Louis Crevier,D,CHI,23,0,0,0,0
44,8484326,Patrik Koch,D,UTA,28,0,0,0,0
44,8477971,Andreas Englund,D,LAK,28,0,0,0,0
44,8481751,Lukas Rousek,R,BUF,25,0,0,0,0
44,8481006,Tyler Tucker,D,STL,24,0,0,0,0
44,8476867,Brendan Gaunce,C,MIN,30,0,0,0,0
44,8479520,Brandon Duhaime,R,WSH,27,0,0,0,0
44,8477073,Kurtis MacDermid,L,NJD,30,0,0,0,0
44,8480874,Adam Ginning,D,PHI,24,0,0,0,0
44,8477473,Justin Bailey,R,SJS,29,0,0,0,0
44,8479066,Ryan Lomberg,L,CGY,30,0,0,0,0
44,8477070,Liam O'Brien,C,UTA,30,0,0,0,0
44,8474618,Marco Scandella,D,,34,0,0,0,0
44,8475797,Jarred Tinordi,D,,32,0,0,0,0
44,8481441,Joe Snively,C,DET,28,0,0,0,0
44,8477244,Chad Ruhwedel,D,NYR,34,0,0,0,0
44,8479772,Zack MacEwen,R,OTT,28,0,0,0,0
44,8481147,Reese Johnson,C,MIN,26,0,0,0,0
44,8481043,Cole Koepke,L,BOS,26,0,0,0,0
44,8483619,Filip Roos,D,OTT,25,0,0,0,0
44,8481541,Samuel Bolduc,D,NYI,24,0,0,0,0
44,8477810,Joel Hanley,D,CGY,33,0,0,0,0
44,8476907,Mackenzie MacEachern,L,,30,0,0,0,0
44,8482652,Walker Duehr,R,CGY,27,0,0,0,0
44,8477126,Jayson Megna,C,,34,0,0,0,0
44,8483398,Declan Carlile,D,TBL,31,0,0,0,0
44,8482929,Emil Lilleberg,D,TBL,23,0,0,0,0
44,8480880,Jakub Lauko,C,MIN,24,0,0,0,0
44,8480245,Olle Lycksell,R,PHI,25,0,0,0,0
44,8480252,Cole Guttman,C,CHI,25,0,0,0,0
44,8477467,Gustav Olofsson,D,SEA,30,0,0,0,0
44,8479968,Vinni Lettieri,C,BOS,29,0,0,0,0
44,8478400,Colin White,C,,27,0,0,0,0
44,8475755,Alexander Petrovic,D,DAL,32,0,0,0,0
44,8481812,Nikolai Knyzhov,D,,27,0,0,0,0
44,8481593,Jayden Struble,D,MTL,23,0,0,0,0
44,8481532,Alex Turcotte,C,LAK,23,0,0,0,0
44,8482126,Emil Andrae,D,PHI,31,0,0,0,0
44,8479944,Zach Aston-Reese,C,VGK,30,0,0,0,0
44,8471817,Ryan Reaves,R,TOR,37,0,0,0,0
44,8481206,John Ludvig,D,PIT,24,0,0,0,0
44,8481599,Victor Soderstrom,D,UTA,23,0,0,0,0
44,8480292,Carson Meyer,R,ANA,27,0,0,0,0
44,8482496,Nils Aman,C,VAN,24,0,0,0,0
44,8479718,Alex Barré-Boulet,C,MTL,27,0,0,0,0
44,8479994,Jaret Anderson-Dolan,C,WPG,25,0,0,0,0
44,8480184,Gustav Lindstrom,D,,26,0,0,0,0
44,8480890,Jan Jenik,R,OTT,24,0,0,0,0
44,8478067,Oskar Lindblom,L,,28,0,0,0,0
44,8476934,Brock McGinn,L,ANA,30,0,0,0,0
44,8479985,Cale Fleury,D,SEA,26,0,0,0,0
44,8484304,Uvis Balinskis,D,FLA,28,0,0,0,0
44,8479981,Jonah Gadjovich,L,FLA,26,0,0,0,0
44,8481716,Dmitri Voronkov,L,CBJ,24,0,0,0,0
44,8474709,Matt Martin,L,,35,0,0,0,0
44,8482634,Alex Steeves,C,TOR,25,0,0,0,0
44,8480823,Alexander Alexeyev,D,WSH,25,0,0,0,0
44,8477541,Dakota Mermis,D,TOR,30,0,0,0,0
44,8483491,Ivan Miroshnichenko,L,WSH,20,0,0,0,0
44,8478477,Mitchell Stephens,C,SEA,27,0,0,0,0
44,8481543,Nikita Alexandrov,C,STL,24,0,0,0,0
44,8479423,Alex Nylander,L,,26,0,0,0,0
44,8482451,Mikael Pyyhtia,L,CBJ,23,0,0,0,0
44,8478831,Kevin Stenlund,C,UTA,28,0,0,0,0
44,8480306,Grant Hutton,D,NYI,29,0,0,0,0
44,8478028,Fredrik Olofsson,L,,28,0,0,0,0
44,8477462,Robert Hagg,D,VGK,29,0,0,0,0
44,8477320,Anton Blidh,L,NYR,29,0,0,0,0
44,8482157,Will Cuylle,L,NYR,22,0,0,0,0
44,8482737,Zack Bolduc,C,STL,21,0,0,0,0
44,8481239,Samuel Fagemo,L,,24,0,0,0,0
44,8481600,Tobias Bjornfot,D,FLA,23,0,0,0,0
44,8478409,Anthony Richard,C,PHI,28,0,0,0,0
44,8474145,Robert Bortuzzo,D,,35,0,0,0,0
44,8475958,Michael Sgarbossa,C,WSH,32,0,0,0,0
44,8479986,Kole Lind,R,DAL,26,0,0,0,0
44,8479249,Andrew Poturalski,C,SJS,30,0,0,0,0
44,8479362,Riley Tufte,L,BOS,26,0,0,0,0
44,8479991,Jake Leschyshyn,C,NYR,25,0,0,0,0
44,8479587,Rhett Gardner,C,PHI,28,0,0,0,0
44,8482744,James Malatesta,L,CBJ,21,0,0,0,0
44,8478854,Ryan Shea,D,PIT,27,0,0,0,0
44,8481591,Sam Poulin,R,,23,0,0,0,0
44,8483512,Matt Savoie,C,EDM,20,0,0,0,0
44,8482102,Vasily Ponomarev,C,PIT,22,0,0,0,0
44,8482162,Roby Jarventie,L,EDM,22,0,0,0,0
44,8481016,Ruslan Iskhakov,C,,24,0,0,0,0
44,8482172,Landon Slaggert,L,CHI,22,0,0,0,0
44,8482747,Brennan Othmann,L,NYR,21,0,0,0,0
44,8480031,Maxime Comtois,L,,25,0,0,0,0
44,8480226,Marián Studenic,R,,26,0,0,0,0
44,8478408,Travis Dermott,D,,28,0,0,0,0
44,8481518,Nolan Foote,L,NJD,24,0,0,0,0
44,8479419,Brett Murray,L,BUF,26,0,0,0,0
44,8482088,Justin Sourdif,R,FLA,22,0,0,0,0
44,8482201,Gage Goncalves,C,TBL,23,0,0,0,0
44,8481578,Graeme Clarke,R,MIN,23,0,0,0,0
44,8482177,Marat Khusnutdinov,C,MIN,22,0,0,0,0
44,8481754,Nikita Nesterenko,C,ANA,23,0,0,0,0
44,8483531,Brian Halonen,L,NJD,25,0,0,0,0
44,8483920,Pierrick Dube,R,WSH,23,0,0,0,0
44,8480851,Akil Thomas,C,LAK,24,0,0,0,0
44,8475235,Nicolas Deslauriers,L,PHI,33,0,0,0,0
44,8482476,Emil Heineman,L,MTL,23,0,0,0,0
44,8477149,Scott Sabourin,R,SJS,32,0,0,0,0
44,8483549,Lucas Condotta,L,MTL,27,0,0,0,0
44,8482765,Isak Rosen,R,BUF,21,0,0,0,0
44,8481237,Kyle MacLean,C,NYI,25,0,0,0,0
44,8481024,Linus Karlsson,C,VAN,25,0,0,0,0
44,8481690,Tyler Angle,C,,24,0,0,0,0
44,8483570,Ben Meyers,C,SEA,26,0,0,0,0
44,8481655,Cole Schwindt,R,CGY,23,0,0,0,0
44,8481462,Mason Morelli,L,VGK,28,0,0,0,0
44,8483401,Marc Johnstone,R,PIT,28,0,0,0,0
44,8478956,Samuel Laberge,L,NJD,27,0,0,0,0
44,8479533,Joona Koppanen,L,,26,0,0,0,0
44,8482197,Adam Raska,R,MIN,23,0,0,0,0
44,8482250,Callahan Burke,C,VGK,27,0,0,0,0
44,8482784,Zach Dean,C,STL,21,0,0,0,0
44,8484255,Jason Polin,R,COL,25,0,0,0,0
44,8481077,John Leonard,L,,26,0,0,0,0
44,8481534,Raphael Lavoie,C,EDM,24,0,0,0,0
44,8483609,Adam Klapka,R,CGY,24,0,0,0,0
44,8482751,Ryan Winterton,C,SEA,21,0,0,0,0
44,8480267,Sammy Walker,C,MIN,25,0,0,0,0
44,8475766,Austin Watson,L,,32,0,0,0,0
44,8482460,Matt Rempe,C,NYR,22,0,0,0,0
44,8481065,Angus Crookshank,L,OTT,25,0,0,0,0
44,8481070,Hugh McGing,L,,26,0,0,0,0
44,8476323,Max McCormick,L,SEA,32,0,0,0,0
44,8483395,Arshdeep Bains,L,VAN,23,0,0,0,0
44,8484259,Ondrej Pavel,C,COL,31,0,0,0,0
44,8483432,Luca Del Bel Belluz,C,CBJ,31,0,0,0,0
44,8483045,Cameron Butler,R,CBJ,31,0,0,0,0
44,8482061,Brandon Biro,L,SEA,26,0,0,0,0
44,8477401,John Hayden,C,SEA,29,0,0,0,0
44,8475278,Byron Froese,C,,33,0,0,0,0
44,8478446,Glenn Gawdin,C,LAK,27,0,0,0,0
44,8477993,Justin Kirkland,C,CGY,28,0,0,0,0
44,8482147,Jean-Luc Foudy,C,COL,22,0,0,0,0
44,8480032,Shane Bowers,C,NJD,25,0,0,0,0
44,8479330,Brandon Gignac,C,MTL,27,0,0,0,0
44,8480776,Sheldon Rempal,R,,29,0,0,0,0
44,8475413,Justin Dowling,C,NJD,34,0,0,0,0
44,8481726,Adam Edstrom,C,NYR,24,0,0,0,0
44,8480844,Grigori Denisenko,L,VGK,24,0,0,0,0
44,8478147,Bokondji Imama,L,PIT,28,0,0,0,0
44,8478881,Brett Seney,L,CHI,28,0,0,0,0
44,8483630,Pavol Regenda,L,ANA,25,0,0,0,0
44,8480836,Jonathan Gruden,C,,24,0,0,0,0
44,8484314,Jiri Smejkal,L,,28,0,0,0,0
44,8475780,Chris Wagner,R,COL,33,0,0,0,0
44,8479546,Oskar Steen,C,,26,0,0,0,0
44,8483597,Milos Kelemen,L,UTA,25,0,0,0,0
44,8481789,Tye Kartye,L,SEA,23,0,0,0,0
44,8484325,Waltteri Merela,C,TBL,26,0,0,0,0
44,8479421,Jacob Moverare,D,LAK,26,0,0,0,0
44,8481585,Egor Afanasyev,L,SJS,23,0,0,0,0
44,8479547,Matthew Phillips,R,,26,0,0,0,0
44,8479367,William Lockwood,R,FLA,26,0,0,0,0
44,8476915,Jujhar Khaira,L,,30,0,0,0,0
44,8481422,Jacob Lucchini,C,NSH,29,0,0,0,0
44,8480468,James Hamblin,L,EDM,25,0,0,0,0
44,8478051,Max Willman,C,NJD,29,0,0,0,0
44,8481556,John Beecher,C,BOS,23,0,0,0,0
44,8478078,Rourke Chartier,C,,28,0,0,0,0
45,8478402,Connor McDavid,C,EDM,27,82,47,117,164
45,8481559,Jack Hughes,C,NJD,23,82,63,86,149
45,8476453,Nikita Kucherov,R,TBL,31,82,41,88,129
45,8479314,Matthew Tkachuk,L,FLA,27,82,43,84,127
45,8476887,Filip Forsberg,L,NSH,30,82,57,68,125
45,8479318,Auston Matthews,C,TOR,27,82,59,61,120
45,8477956,David Pastrnak,R,BOS,28,82,55,63,118
45,8478427,Sebastian Aho,C,CAR,27,82,48,67,115
45,8471675,Sidney Crosby,C,PIT,37,82,47,64,111
45,8476468,J.T. Miller,C,VAN,31,82,35,74,109
45,8477492,Nathan MacKinnon,C,COL,29,82,29,80,109
45,8477939,William Nylander,R,TOR,28,82,47,58,105
45,8479407,Jesper Bratt,L,NJD,26,82,35,68,103
45,8478420,Mikko Rantanen,R,COL,28,82,38,62,100
45,8480027,Jason Robertson,L,DAL,25,82,33,67,100
45,8477934,Leon Draisaitl,C,EDM,29,82,43,55,98
45,8480023,Robert Thomas,C,STL,25,82,29,67,96
45,8474600,Roman Josi,D,NSH,34,82,22,73,95
45,8478550,Artemi Panarin,L,NYR,33,82,39,55,94
45,8478864,Kirill Kaprizov,L,MIN,27,82,45,48,93
45,8471215,Evgeni Malkin,C,PIT,38,82,27,66,93
45,8478449,Roope Hintz,C,DAL,28,82,43,48,91
45,8477404,Jake Guentzel,C,TBL,30,82,37,54,91
45,8480830,Andrei Svechnikov,R,CAR,24,82,33,58,91
45,8476459,Mika Zibanejad,C,NYR,31,82,34,56,90
45,8475166,John Tavares,C,TOR,34,82,26,64,90
45,8474564,Steven Stamkos,C,NSH,34,82,26,64,90
45,8480800,Quinn Hughes,D,VAN,25,82,17,72,89
45,8479343,Clayton Keller,R,UTA,26,82,36,52,88
45,8481523,Kirby Dach,C,MTL,23,82,19,69,88
45,8480801,Brady Tkachuk,L,OTT,25,82,38,49,87
45,8477942,Kevin Fiala,L,LAK,28,82,32,55,87
45,8478010,Brayden Point,C,TBL,28,82,44,42,86
45,8478445,Mathew Barzal,C,NYI,27,82,27,59,86
45,8475172,Nazem Kadri,C,CGY,34,82,25,61,86
45,8479420,Tage Thompson,C,BUF,27,82,44,41,85
45,8478403,Jack Eichel,C,VGK,28,82,39,46,85
45,8478401,Pavel Zacha,C,BOS,27,82,38,47,85
45,8479385,Jordan Kyrou,C,STL,26,82,37,48,85
45,8477402,Pavel Buchnevich,L,STL,29,82,31,54,85
45,8476346,Johnny Gaudreau,L,CBJ,31,82,24,61,85
45,8480012,Elias Pettersson,C,VAN,26,82,34,50,84
45,8478398,Kyle Connor,L,WPG,28,82,45,38,83
45,8477501,Valeri Nichushkin,R,COL,29,82,43,40,83
45,8478414,Timo Meier,R,NJD,28,82,46,36,82
45,8475786,Zach Hyman,L,EDM,32,82,40,42,82
45,8478873,Troy Terry,R,ANA,27,82,32,50,82
45,8477955,Jared McCann,L,SEA,28,82,43,38,81
45,8476389,Vincent Trocheck,C,NYR,31,82,32,49,81
45,8478439,Travis Konecny,R,PHI,27,82,26,54,80
45,8479323,Adam Fox,D,NYR,26,82,16,64,80
45,8477500,Bo Horvat,C,NYI,29,82,45,34,79
45,8477933,Sam Reinhart,C,FLA,29,82,44,35,79
45,8480018,Nick Suzuki,C,MTL,25,82,32,47,79
45,8476460,Mark Scheifele,C,WPG,31,82,28,51,79
45,8480069,Cale Makar,D,COL,26,82,24,55,79
45,8477493,Aleksander Barkov,C,FLA,29,82,21,58,79
45,8478047,Michael Bunting,L,PIT,29,82,35,43,78
45,8475692,Mats Zuccarello,R,MIN,37,82,19,59,78
45,8476462,Dougie Hamilton,D,NJD,31,82,18,60,78
45,8477409,Carter Verhaeghe,C,FLA,29,82,41,36,77
45,8475184,Chris Kreider,L,NYR,33,82,48,28,76
45,8476539,Jonathan Marchessault,R,NSH,34,82,36,40,76
45,8482116,Tim Stützle,C,OTT,22,82,28,48,76
45,8475810,Bryan Rust,R,PIT,32,82,36,39,75
45,8471214,Alex Ovechkin,L,WSH,39,82,32,43,75
45,8475158,Ryan O'Reilly,C,NSH,33,82,31,44,75
45,8474141,Patrick Kane,R,DET,36,82,27,48,75
45,8477946,Dylan Larkin,C,DET,28,82,39,35,74
45,8473994,Jamie Benn,L,DAL,35,82,31,43,74
45,8480208,Drake Batherson,R,OTT,26,82,30,43,73
45,8477960,Adrian Kempe,R,LAK,28,82,30,42,72
45,8475168,Matt Duchene,C,DAL,33,82,28,44,72
45,8473419,Brad Marchand,L,BOS,36,82,27,45,72
45,8480002,Nico Hischier,C,NJD,25,82,20,52,72
45,8474679,Gustav Nyquist,C,NSH,35,82,20,52,72
45,8480036,Miro Heiskanen,D,DAL,25,82,19,53,72
45,8477504,Josh Morrissey,D,WPG,29,82,14,58,72
45,8476454,Ryan Nugent-Hopkins,C,EDM,31,82,13,59,72
45,8471724,Kris Letang,D,PIT,37,82,10,62,72
45,8477951,Nick Schmaltz,C,UTA,28,82,29,42,71
45,8482078,Lucas Raymond,L,DET,22,82,26,45,71
45,8479325,Charlie McAvoy,D,BOS,27,82,21,50,71
45,8473512,Claude Giroux,R,OTT,36,82,25,45,70
45,8477496,Elias Lindholm,C,BOS,30,82,27,42,69
45,8478438,Tommy Novak,C,NSH,27,82,26,42,68
45,8479542,Brandon Hagel,L,TBL,26,82,28,39,67
45,8475913,Mark Stone,R,VGK,32,82,26,41,67
45,8481557,Matt Boldy,L,MIN,23,82,24,43,67
45,8475765,Vladimir Tarasenko,R,DET,33,82,24,43,67
45,8475170,Brayden Schenn,C,STL,33,82,23,44,67
45,8476905,Chandler Stephenson,C,SEA,30,82,18,49,67
45,8480803,Evan Bouchard,D,EDM,25,82,13,54,67
45,8473986,Alex Killorn,L,ANA,35,82,25,41,66
45,8478498,Jake DeBrusk,L,VAN,28,82,37,28,65
45,8480014,Gabriel Vilardi,C,WPG,25,82,30,35,65
45,8476881,Tomas Hertl,C,VGK,31,82,29,36,65
45,8482093,Seth Jarvis,C,CAR,22,82,29,36,65
45,8477416,Oliver Bjorkstrand,R,SEA,29,82,26,39,65
45,8480039,Martin Necas,C,CAR,25,82,24,41,65
45,8482745,Mason McTavish,C,ANA,21,82,31,33,64
45,8476479,Phillip Danault,C,LAK,31,82,30,34,64
45,8481711,Matias Maccelli,L,UTA,24,82,21,43,64
45,8475798,Mikael Granlund,C,SJS,32,82,18,46,64
45,8474590,John Carlson,D,WSH,34,82,15,49,64
45,8482665,Matty Beniers,C,SEA,22,82,24,39,63
45,8481528,Dylan Cozens,C,BUF,23,82,20,43,63
45,8476399,Blake Coleman,C,CGY,33,82,30,32,62
45,8478493,Joel Eriksson Ek,C,MIN,27,82,27,35,62
45,8479337,Alex DeBrincat,R,DET,27,82,27,35,62
45,8476448,William Karlsson,C,VGK,31,82,22,40,62
45,8477503,Max Domi,C,TOR,29,82,21,41,62
45,8477949,Alex Tuch,R,BUF,28,82,21,41,62
45,8476853,Morgan Rielly,D,TOR,30,82,12,50,62
45,8475167,Victor Hedman,D,TBL,34,82,12,50,62
45,8478038,Devon Toews,D,COL,30,82,10,52,62
45,8481540,Cole Caufield,R,MTL,23,82,33,28,61
45,8478440,Dylan Strome,C,WSH,27,82,27,34,61
45,8479675,Trevor Moore,L,LAK,29,82,26,35,61
45,8474578,Erik Karlsson,D,PIT,34,82,19,42,61
45,8476456,Jonathan Huberdeau,C,CGY,31,82,14,47,61
45,8476875,Mike Matheson,D,MTL,30,82,13,48,61
45,8476432,Boone Jenner,C,CBJ,31,82,35,25,60
45,8478042,Viktor Arvidsson,R,EDM,31,82,30,30,60
45,8475784,Jeff Skinner,C,EDM,32,82,30,30,60
45,8478444,Brock Boeser,R,VAN,27,82,28,32,60
45,8481533,Trevor Zegras,C,ANA,23,82,25,35,60
45,8477940,Nikolaj Ehlers,L,WPG,28,82,23,37,60
45,8477986,Brandon Montour,D,SEA,30,82,23,37,60
45,8477932,Aaron Ekblad,D,FLA,28,82,21,38,59
45,8477494,Jonathan Drouin,L,COL,29,82,20,39,59
45,8478460,Zach Werenski,D,CBJ,27,82,18,41,59
45,8478407,Vince Dunn,D,SEA,28,82,12,47,59
45,8476483,Rickard Rakell,R,PIT,31,82,36,22,58
45,8479999,Casey Mittelstadt,C,COL,26,82,24,34,58
45,8479410,Mikhail Sergachev,D,UTA,26,82,7,51,58
45,8477935,Sam Bennett,C,FLA,28,82,28,29,57
45,8480849,Barrett Hayton,C,UTA,24,82,28,29,57
45,8479339,Patrik Laine,L,CBJ,26,82,27,30,57
45,8480028,Morgan Frost,C,PHI,25,82,19,38,57
45,8482124,Quinton Byfield,R,LAK,22,82,17,40,57
45,8475726,Tyler Toffoli,C,SJS,32,82,31,25,56
45,8482740,Wyatt Johnston,C,DAL,21,82,30,26,56
45,8475754,Brock Nelson,C,NYI,33,82,29,27,56
45,8478366,Frank Vatrano,R,ANA,30,82,28,28,56
45,8477498,Darnell Nurse,D,EDM,29,82,19,37,56
45,8471685,Anze Kopitar,C,LAK,37,82,16,40,56
45,8480839,Rasmus Dahlin,D,BUF,24,82,9,47,56
45,8477451,Ryan Hartman,R,MIN,30,82,26,29,55
45,8474641,Adam Henrique,C,EDM,34,82,25,30,55
45,8478519,Anthony Cirelli,C,TBL,27,82,21,34,55
45,8478975,Mason Marchment,L,DAL,29,82,15,40,55
45,8482175,JJ Peterka,R,BUF,22,82,31,23,54
45,8481068,Yegor Sharangovich,C,CGY,26,82,23,31,54
45,8477407,Anthony Duclair,L,NYI,29,82,18,36,54
45,8478458,Jack Roslovic,C,CAR,27,82,18,36,54
45,8475169,Evander Kane,L,EDM,33,82,32,21,53
45,8482109,Alexis Lafrenière,L,NYR,23,82,27,26,53
45,8483808,Andrei Kuzmenko,L,CGY,28,82,27,26,53
45,8480829,Jesperi Kotkaniemi,C,CAR,24,82,24,29,53
45,8481596,Shane Pinto,C,OTT,24,82,21,32,53
45,8477479,Tyler Bertuzzi,L,CHI,29,82,20,33,53
45,8480078,Filip Chytil,C,NYR,25,82,17,36,53
45,8481581,Thomas Harley,D,DAL,23,82,15,38,53
45,8475753,Justin Faulk,D,STL,32,82,13,40,53
45,8479400,Pierre-Luc Dubois,L,WSH,26,82,27,25,52
45,8482097,Jack Quinn,R,BUF,23,82,25,27,52
45,8477495,Seth Jones,D,CHI,30,82,13,39,52
45,8482660,Kent Johnson,C,CBJ,22,82,13,39,52
45,8482671,Owen Power,D,BUF,22,82,12,40,52
45,8478055,Gustav Forsling,D,FLA,28,82,8,44,52
45,8480798,Philipp Kurashev,C,CHI,25,82,27,24,51
45,8478057,Dakota Joshua,C,VAN,28,82,27,24,51
45,8482146,Luke Evangelista,R,NSH,22,82,24,27,51
45,8477497,Sean Monahan,C,CBJ,30,82,23,28,51
45,8477444,Andre Burakovsky,L,SEA,29,82,20,31,51
45,8474565,Alex Pietrangelo,D,VGK,34,82,11,40,51
45,8477476,Artturi Lehkonen,L,COL,29,82,25,25,50
45,8482159,Tyson Foerster,R,PHI,22,82,20,30,50
45,8480797,Joel Farabee,L,PHI,24,82,19,31,50
45,8476882,Teuvo Teravainen,L,CHI,30,82,17,33,50
45,8475791,Taylor Hall,L,CHI,33,82,16,34,50
45,8479425,Filip Hronek,D,VAN,27,82,5,45,50
45,8476438,Brandon Saad,L,STL,32,82,29,20,49
45,8477429,Andrew Copp,C,DET,30,82,25,24,49
45,8477426,Nicholas Paul,L,TBL,29,82,25,24,49
45,8480009,Eeli Tolvanen,R,SEA,25,82,22,27,49
45,8482149,Cole Perfetti,C,WPG,22,82,21,28,49
45,8473563,Nicklas Backstrom,C,WSH,37,82,18,31,49
45,8474563,Drew Doughty,D,LAK,35,82,16,33,49
45,8476906,Shayne Gostisbehere,D,CAR,31,82,12,37,49
45,8481546,Cam York,D,PHI,23,82,11,38,49
45,8477447,Shea Theodore,D,VGK,29,82,9,40,49
45,8481542,Moritz Seider,D,DET,23,82,2,47,49
45,8476880,Tom Wilson,R,WSH,30,82,27,21,48
45,8475794,Tyler Seguin,C,DAL,32,82,25,23,48
45,8476461,Sean Couturier,C,PHI,32,82,24,24,48
45,8480015,Owen Tippett,R,PHI,25,82,23,25,48
45,8475193,Tomas Tatar,L,NJD,34,82,23,25,48
45,8478046,Danton Heinen,L,VAN,29,82,23,25,48
45,8481624,Ilya Mikheyev,R,CHI,30,82,22,26,48
45,8474102,David Perron,L,OTT,36,82,20,28,48
45,8480865,Noah Dobson,D,NYI,24,82,11,37,48
45,8478463,Anthony Beauvillier,L,PIT,27,82,24,23,47
45,8480802,Ryan McLeod,C,BUF,25,82,24,23,47
45,8478109,Victor Olofsson,L,VGK,29,82,21,26,47
45,8475714,Calle Jarnkrok,C,TOR,33,82,19,28,47
45,8480188,Fabian Zetterlund,L,SJS,25,82,17,30,47
45,8475218,Mattias Ekholm,D,EDM,34,82,14,33,47
45,8476869,Brady Skjei,D,NSH,30,82,10,37,47
45,8478474,Lawson Crouse,L,UTA,27,82,27,19,46
45,8475768,Jaden Schwartz,C,SEA,32,82,21,25,46
45,8482475,Yegor Chinakhov,R,CBJ,23,82,21,25,46
45,8474586,Jordan Eberle,R,SEA,34,82,16,30,46
45,8478469,Thomas Chabot,D,OTT,27,82,12,34,46
45,8482684,Luke Hughes,D,NJD,21,82,9,37,46
45,8480043,Timothy Liljegren,D,TOR,25,82,4,42,46
45,8479525,Ross Colton,C,COL,28,82,25,20,45
45,8477021,Alex Kerfoot,C,UTA,30,82,17,28,45
45,8476458,Ryan Strome,C,ANA,31,82,13,32,45
45,8475764,Cam Fowler,D,ANA,33,82,4,41,45
45,8477998,Warren Foegele,L,LAK,28,82,23,21,44
45,8475793,Ryan Johansen,C,PHI,32,82,21,23,44
45,8477456,J.T. Compher,L,DET,29,82,21,23,44
45,8480064,Josh Norris,C,OTT,25,82,19,25,44
45,8482110,Dawson Mercer,C,NJD,23,82,19,25,44
45,8479987,Morgan Geekie,C,BOS,26,82,19,25,44
45,8473422,Nick Foligno,L,CHI,37,82,19,25,44
45,8478462,Nicolas Roy,C,VGK,27,82,18,26,44
45,8476292,Ondrej Palat,L,NJD,33,82,16,28,44
45,8475191,Reilly Smith,R,NYR,33,82,14,30,44
45,8480434,Sean Durzi,D,UTA,26,82,8,36,44
45,8478856,Conor Garland,R,VAN,28,82,23,20,43
45,8483515,Juraj Slafkovsky,L,MTL,20,82,21,22,43
45,8480459,Pius Suter,C,VAN,28,82,20,23,43
45,8475848,Brendan Gallagher,R,MTL,32,82,20,23,43
45,8474149,Evgenii Dadonov,R,DAL,35,82,18,25,43
45,8480748,Kiefer Sherwood,L,VAN,29,82,16,27,43
45,8475745,Charlie Coyle,C,BOS,32,82,15,28,43
45,8478397,Rasmus Andersson,D,CGY,28,82,11,32,43
45,8477346,MacKenzie Weegar,D,CGY,30,82,11,32,43
45,8476923,Damon Severson,D,CBJ,30,82,11,32,43
45,8481535,Nils Hoglander,L,VAN,24,82,20,22,42
45,8482113,Anton Lundell,C,FLA,23,82,18,24,42
45,8480855,Jack McBain,C,UTA,24,82,18,24,42
45,8475287,Erik Haula,L,NJD,33,82,17,25,42
45,8478542,Evan Rodrigues,C,FLA,31,82,16,26,42
45,8480220,Noah Cates,L,PHI,25,82,14,28,42
45,8476826,Yanni Gourde,C,SEA,33,82,13,29,42
45,8481560,Arthur Kaliyev,R,LAK,23,82,13,29,42
45,8476885,Jacob Trouba,D,NYR,30,82,9,33,42
45,8478500,Ivan Provorov,D,CBJ,27,82,5,37,42
45,8479996,Cody Glass,C,NSH,25,82,26,15,41
45,8470621,Corey Perry,R,EDM,39,82,22,19,41
45,8481618,Alex Newhook,C,MTL,23,82,17,24,41
45,8482667,William Eklund,L,SJS,22,82,14,27,41
45,8477839,Conor Sheary,L,TBL,32,82,14,27,41
45,8476792,Torey Krug,D,STL,33,82,13,28,41
45,8479345,Jakob Chychrun,D,WSH,26,82,12,29,41
45,8478133,Jake Evans,C,MTL,28,82,12,29,41
45,8478396,Noah Hanifin,D,VGK,27,82,9,32,41
45,8475799,Nino Niederreiter,R,WPG,32,82,20,20,40
45,8475151,Kyle Palmieri,C,NYI,33,82,18,22,40
45,8475763,Kevin Hayes,R,PIT,32,82,17,23,40
45,8477919,Frederick Gaudreau,C,MIN,31,82,15,25,40
45,8479992,Michael Rasmussen,C,DET,25,82,14,26,40
45,8476457,Adam Larsson,D,SEA,32,82,11,29,40
45,8470613,Brent Burns,D,CAR,39,82,9,31,40
45,8478413,Jordan Greenway,L,BUF,27,82,7,33,40
45,8482705,Cole Sillinger,C,CBJ,21,82,22,17,39
45,8475314,Anders Lee,L,NYI,34,82,20,19,39
45,8482699,Dylan Guenther,R,UTA,21,82,18,21,39
45,8477953,Kasperi Kapanen,R,STL,28,82,17,22,39
45,8477948,Travis Sanheim,D,PHI,28,82,9,30,39
45,8481580,Connor McMichael,C,WSH,23,82,22,16,38
45,8482720,Matthew Knies,L,TOR,22,82,21,17,38
45,8471698,T.J. Oshie,R,WSH,38,82,19,19,38
45,8480995,Pontus Holmberg,R,TOR,25,82,19,19,38
45,8476958,Jaccob Slavin,D,CAR,30,82,6,32,38
45,8480893,Kirill Marchenko,R,CBJ,24,82,22,15,37
45,8481582,Nicholas Robertson,L,TOR,23,82,21,16,37
45,8480068,Ryan Poehling,C,PHI,25,82,20,17,37
45,8477987,Ryan Donato,C,CHI,28,82,19,18,37
45,8474150,Mikael Backlund,C,CGY,35,82,17,20,37
45,8475855,Jesper Fast,R,CAR,33,82,17,20,37
45,8482125,Alexander Holtz,R,VGK,22,82,17,20,37
45,8481013,Jonatan Berggren,R,DET,24,82,15,22,37
45,8478472,Mathieu Joseph,R,STL,27,82,11,26,37
45,8480817,K'Andre Miller,D,NYR,24,82,10,27,37
45,8475171,Oliver Ekman-Larsson,D,TOR,33,82,5,32,37
45,8476917,Adam Pelech,D,NYI,30,82,4,33,37
45,8476981,Josh Anderson,R,MTL,30,82,21,15,36
45,8476480,Vladislav Namestnikov,C,WPG,32,82,19,17,36
45,8477952,Robby Fabbri,C,ANA,28,82,18,18,36
45,8480113,Alex Iafallo,L,WPG,31,82,17,19,36
45,8482092,Ridly Greig,C,OTT,22,82,15,21,36
45,8475149,Marcus Johansson,L,MIN,34,82,15,21,36
45,8479941,Justin Danforth,R,CBJ,31,82,12,24,36
45,8476979,Erik Gustafsson,D,DET,32,82,11,25,36
45,8475722,Jason Zucker,L,BUF,32,82,21,14,35
45,8476872,Scott Laughton,C,PHI,30,82,17,18,35
45,8477964,Ivan Barbashev,C,VGK,29,82,17,18,35
45,8478233,Andrew Mangiapane,L,WSH,28,82,17,18,35
45,8481553,Bobby Brink,R,PHI,23,82,13,22,35
45,8476463,Jonas Brodin,D,MIN,31,82,7,28,35
45,8477845,Trevor van Riemsdyk,D,WSH,33,82,5,30,35
45,8475760,Nick Bjugstad,C,UTA,32,82,20,14,34
45,8482624,Daniil Miromanov,D,CGY,27,82,18,16,34
45,8476921,Jordan Martinook,L,CAR,32,82,16,18,34
45,8478891,Mason Appleton,C,WPG,28,82,16,18,34
45,8474053,Logan Couture,C,SJS,35,82,15,19,34
45,8479353,Brett Howden,C,VGK,26,82,15,19,34
45,8476873,Mark Jankowski,C,NSH,30,82,14,20,34
45,8480835,Jack Drury,C,CAR,24,82,11,23,34
45,8477015,Connor Brown,R,EDM,30,82,10,24,34
45,8477425,Miles Wood,L,COL,29,82,9,25,34
45,8476931,Jake McCabe,D,TOR,31,82,7,27,34
45,8477969,Marcus Pettersson,D,PIT,28,82,5,29,34
45,8476854,Hampus Lindholm,D,BOS,30,82,4,30,34
45,8479414,Nathan Bastian,R,NJD,27,82,20,13,33
45,8481704,Juuso Parssinen,C,NSH,23,82,19,14,33
45,8481604,Pavel Dorofeyev,L,VGK,24,82,17,16,33
45,8482089,Jake Neighbours,L,STL,22,82,17,16,33
45,8481032,Paul Cotter,C,NJD,25,82,17,16,33
45,8475220,Marcus Foligno,L,MIN,33,82,14,19,33
45,8479365,Trent Frederic,C,BOS,26,82,13,20,33
45,8475200,Dmitry Orlov,D,CAR,33,82,12,21,33
45,8476278,Colin Blackwell,C,DAL,31,82,12,21,33
45,8476419,Jean-Gabriel Pageau,C,NYI,32,82,10,23,33
45,8476329,Travis Boyd,C,MIN,31,82,8,25,33
45,8484144,Connor Bedard,C,CHI,19,82,18,14,32
45,8476474,Stefan Noesen,R,NJD,31,82,17,15,32
45,8478508,Yakov Trenin,C,MIN,27,82,17,15,32
45,8473533,Jordan Staal,C,CAR,36,82,15,17,32
45,8477511,Anthony Mantha,R,CGY,30,82,14,18,32
45,8476927,Teddy Blueger,C,VAN,30,82,13,19,32
45,8480871,Adam Boqvist,D,FLA,24,82,12,20,32
45,8474716,Jared Spurgeon,D,MIN,35,82,12,20,32
45,8478569,Noel Acciari,C,PIT,33,82,10,22,32
45,8476422,Mike Reilly,D,NYI,31,82,10,22,32
45,8482105,Jake Sanderson,D,OTT,22,82,9,23,32
45,8476392,Adam Lowry,C,WPG,31,82,9,23,32
45,8476925,Colton Sissons,C,NSH,31,82,8,24,32
45,8482117,Lukas Reichel,L,CHI,22,82,8,24,32
45,8479402,Jake Bean,D,CGY,26,82,1,31,32
45,8482055,Drew O'Connor,L,PIT,26,82,14,17,31
45,8484145,Zach Benson,L,BUF,19,82,12,19,31
45,8480003,Jesper Boqvist,C,FLA,26,82,11,20,31
45,8477947,Sonny Milano,L,WSH,28,82,11,20,31
45,8482142,Jamie Drysdale,D,PHI,22,82,10,21,31
45,8481522,Peyton Krebs,C,BUF,23,82,10,21,31
45,8479976,Juuso Valimaki,D,UTA,26,82,8,23,31
45,8480336,Sean Walker,D,CAR,30,82,8,23,31
45,8479980,Nicolas Hague,D,VGK,26,82,7,24,31
45,8474151,Ryan McDonagh,D,TBL,35,82,5,26,31
45,8477488,Brett Pesce,D,NJD,30,82,4,27,31
45,8478851,Alexandre Carrier,D,NSH,28,82,4,27,31
45,8478432,Christian Fischer,R,DET,27,82,16,14,30
45,8483431,Logan Cooley,C,UTA,20,82,15,15,30
45,8476469,Joel Armia,R,MTL,31,82,15,15,30
45,8479368,Max Jones,L,BOS,26,82,13,17,30
45,8482133,Thomas Bordeleau,C,SJS,22,82,11,19,30
45,8482111,Justin Barron,D,MTL,23,82,11,19,30
45,8476467,Jamie Oleksiak,D,SEA,32,82,10,20,30
45,8476960,Andreas Athanasiou,C,CHI,30,82,9,21,30
45,8477450,Jason Dickinson,C,CHI,29,82,9,21,30
45,8480185,Eetu Luostarinen,C,FLA,26,82,8,22,30
45,8476892,Colton Parayko,D,STL,31,82,5,25,30
45,8474574,Tyler Myers,D,VAN,34,82,5,25,30
45,8482245,Artem Zub,D,OTT,29,82,4,26,30
45,8482259,Bobby McMann,C,TOR,28,82,17,12,29
45,8478434,Keegan Kolesar,R,VGK,27,82,12,17,29
45,8483457,Lane Hutson,D,MTL,20,82,10,19,29
45,8479661,Tanner Jeannot,L,LAK,27,82,9,20,29
45,8479351,Sam Steel,C,DAL,26,82,8,21,29
45,8481606,Jordan Spence,D,LAK,23,82,8,21,29
45,8480074,Alexandre Texier,C,STL,25,82,8,21,29
45,8477435,Ryan Graves,D,PIT,29,82,5,24,29
45,8477365,Connor Clifton,D,BUF,29,82,4,25,29
45,8480049,Dylan Samberg,D,WPG,25,82,2,27,29
45,8477392,Hudson Fasching,R,NYI,29,82,16,12,28
45,8482702,Logan Stankoven,C,DAL,21,82,16,12,28
45,8482079,Marco Rossi,C,MIN,23,82,15,13,28
45,8481481,Blake Lizotte,C,PIT,27,82,15,13,28
45,8484166,Adam Fantilli,C,CBJ,20,82,14,14,28
45,8479398,Samuel Girard,D,COL,26,82,12,16,28
45,8477989,Christian Dvorak,C,MTL,28,82,8,20,28
45,8478507,John Marino,D,UTA,27,82,6,22,28
45,8478911,Matt Roy,D,WSH,29,82,6,22,28
45,8481708,Zac Jones,D,NYR,24,82,5,23,28
45,8480873,Rasmus Sandin,D,WSH,24,82,2,26,28
45,8474715,Cam Atkinson,R,TBL,35,82,16,11,27
45,8479293,Brandon Tanev,L,SEA,33,82,13,14,27
45,8481093,Rafael Harvey-Pinard,L,MTL,25,82,13,14,27
45,8475343,Nic Dowd,C,WSH,34,82,12,15,27
45,8481186,Logan O'Connor,R,COL,28,82,12,15,27
45,8476374,Sean Kuraly,C,CBJ,31,82,12,15,27
45,8480448,Parker Kelly,L,COL,25,82,11,16,27
45,8476312,Josh Manson,D,COL,33,82,10,17,27
45,8477499,Rasmus Ristolainen,D,PHI,30,82,7,20,27
45,8482655,J.J. Moser,D,TBL,24,82,3,24,27
45,8475324,Nick Jensen,D,OTT,34,82,1,26,27
45,8480281,Alexey Toropchenko,R,STL,25,82,17,9,26
45,8476918,Jimmy Vesey,L,NYR,31,82,15,11,26
45,8474189,Lars Eller,C,PIT,35,82,14,12,26
45,8478020,Michael Amadio,C,OTT,28,82,14,12,26
45,8481554,Kaapo Kakko,R,NYR,23,82,13,13,26
45,8479591,Michael Eyssimont,C,TBL,28,82,12,14,26
45,8476858,Phillip Di Giuseppe,L,VAN,31,82,12,14,26
45,8479390,Taylor Raddysh,R,WSH,26,82,11,15,26
45,8480144,David Kampf,C,TOR,29,82,10,16,26
45,8478115,Pierre Engvall,L,NYI,28,82,8,18,26
45,8480246,Nick Perbix,D,TBL,26,82,6,20,26
45,8478840,Will Borgen,D,SEA,28,82,3,23,26
45,8476879,Cody Ceci,D,EDM,31,82,2,24,26
45,8483524,Shane Wright,C,SEA,20,82,11,14,25
45,8481028,Martin Pospisil,C,CGY,25,82,11,14,25
45,8482666,Scott Morrow,D,CAR,22,82,9,16,25
45,8481656,Aliaksei Protas,C,WSH,23,82,8,17,25
45,8481568,Alex Vlasic,D,CHI,23,82,7,18,25
45,8482122,Brock Faber,D,MIN,22,82,6,19,25
45,8480145,Neal Pionk,D,WPG,29,82,5,20,25
45,8475690,Chris Tanev,D,TOR,35,82,5,20,25
45,8477369,Carson Soucy,D,VAN,30,82,4,21,25
45,8477034,Jaycob Megna,D,FLA,32,82,4,21,25
45,8478013,Jake Walman,D,SJS,28,82,14,10,24
45,8484153,Leo Carlsson,C,ANA,20,82,10,14,24
45,8483468,Jiri Kulich,C,BUF,20,82,10,14,24
45,8478178,Darren Raddysh,D,TBL,28,82,9,15,24
45,8484203,Bradly Nadeau,L,CAR,19,82,9,15,24
45,8482659,Josh Doan,R,UTA,22,82,9,15,24
45,8477335,Kyle Burroughs,D,LAK,29,82,6,18,24
45,8474673,TJ Brodie,D,CHI,34,82,5,19,24
45,8479371,Dante Fabbro,D,NSH,26,82,4,20,24
45,8480222,Sebastian Aho,D,PIT,28,82,4,20,24
45,8475462,Radko Gudas,D,ANA,34,82,3,21,24
45,8478399,Jonas Siegenthaler,D,NJD,27,82,2,22,24
45,8476331,Dylan DeMelo,D,WPG,31,82,1,23,24
45,8476897,Oskar Sundqvist,C,STL,30,82,13,10,23
45,8483493,Frank Nazar,C,CHI,20,82,10,13,23
45,8477931,Tomas Nosek,L,FLA,32,82,9,14,23
45,8483565,Nick Blankenburg,D,NSH,26,82,8,15,23
45,8476902,Esa Lindell,D,DAL,30,82,6,17,23
45,8482141,Lukas Cormier,D,VGK,22,82,6,17,23
45,8481014,Alexander Romanov,D,NYI,24,82,5,18,23
45,8473507,Jeff Petry,D,DET,37,82,4,19,23
45,8475188,Brayden McNabb,D,VGK,33,82,4,19,23
45,8476891,Matt Grzelcyk,D,PIT,30,82,3,20,23
45,8482087,Kaiden Guhle,D,MTL,22,82,2,21,23
45,8478136,Jake Middleton,D,MIN,28,82,2,21,23
45,8475790,Erik Gudbranson,D,CBJ,32,82,1,22,23
45,8476878,Zemgus Girgensons,L,TBL,30,82,11,11,22
45,8481601,Simon Holmstrom,R,NYI,23,82,10,12,22
45,8482809,Jackson Blake,R,CAR,21,82,8,14,22
45,8482062,Cole Smith,L,NSH,29,82,7,15,22
45,8480878,Nils Lundkvist,D,DAL,24,82,4,18,22
45,8483490,Pavel Mintyukov,D,ANA,21,82,4,18,22
45,8475279,Ben Chiarot,D,DET,33,82,4,18,22
45,8480035,Henri Jokiharju,D,BUF,25,82,3,19,22
45,8479369,Andrew Peeke,D,BOS,26,82,2,20,22
45,8482155,Alex Laferriere,R,LAK,23,82,14,7,21
45,8482074,Connor Zary,C,CGY,23,82,14,7,21
45,8477508,Curtis Lazar,C,NJD,29,82,9,12,21
45,8480789,Oliver Wahlstrom,R,NYI,24,82,8,13,21
45,8477406,Mattias Janmark,C,EDM,32,82,8,13,21
45,8482807,Ethan Del Mastro,D,CHI,21,82,7,14,21
45,8474013,Ian Cole,D,UTA,35,82,4,17,21
45,8477506,Ryan Pulock,D,NYI,30,82,3,18,21
45,8482166,Shakir Mukhamadullin,D,SJS,22,82,3,18,21
45,8480796,Martin Fehervary,D,WSH,25,82,3,18,21
45,8475181,Nick Leddy,D,STL,33,82,3,18,21
45,8480172,Jan Rutta,D,SJS,34,82,2,19,21
45,8481524,Bowen Byram,D,BUF,23,82,15,5,20
45,8479316,Luke Kunin,C,SJS,27,82,10,10,20
45,8477353,Tyler Motte,C,DET,29,82,10,10,20
45,8483763,Maksymilian Szuber,D,UTA,22,82,9,11,20
45,8476442,Matt Nieto,L,PIT,32,82,9,11,20
45,8475842,Sam Carrick,C,NYR,32,82,8,12,20
45,8480025,MacKenzie Entwistle,R,FLA,25,82,8,12,20
45,8481567,Henry Thrun,D,SJS,23,82,6,14,20
45,8480813,Joe Veleno,C,DET,24,82,5,15,20
45,8479998,Mikey Anderson,D,LAK,25,82,5,15,20
45,8478859,Niko Mikkola,D,FLA,28,82,2,18,20
45,8481477,Nico Sturm,C,SJS,29,82,15,4,19
45,8482679,Matt Coronato,R,CGY,22,82,12,7,19
45,8482762,Simon Edvinsson,D,DET,21,82,10,9,19
45,8473453,Trevor Lewis,C,LAK,37,82,8,11,19
45,8483397,Marc McLaughlin,C,BOS,25,82,7,12,19
45,8477220,Nate Schmidt,D,FLA,33,82,6,13,19
45,8478211,Dryden Hunt,L,CGY,29,82,6,13,19
45,8479324,Ryan Lindgren,D,NYR,26,82,4,15,19
45,8475233,David Savard,D,MTL,34,82,3,16,19
45,8476525,Colin Miller,D,WPG,32,82,3,16,19
45,8481178,Egor Zamula,D,PHI,24,82,2,17,19
45,8478450,Parker Wotherspoon,D,BOS,27,82,9,9,18
45,8480870,Bo Groulx,C,NYR,24,82,9,9,18
45,8482733,Logan Mailloux,D,MTL,31,82,8,10,18
45,8476889,Radek Faksa,C,STL,30,82,8,10,18
45,8480980,Connor Dewar,C,TOR,25,82,7,11,18
45,8476624,Barclay Goodrow,C,SJS,31,82,7,11,18
45,8477505,Alexander Wennberg,C,SJS,30,82,6,12,18
45,8479638,Justin Brazeau,R,BOS,26,82,6,12,18
45,8483012,Logan Morrison,C,SEA,22,82,5,13,18
45,8479983,Mario Ferraro,D,SJS,26,82,4,14,18
45,8482073,Braden Schneider,D,NYR,23,82,4,14,18
45,8470600,Ryan Suter,D,STL,39,82,4,14,18
45,8478416,Erik Cernak,D,TBL,27,82,3,15,18
45,8480807,Mattias Samuelsson,D,BUF,24,82,2,16,18
45,8477903,Garnet Hathaway,R,PHI,33,82,12,5,17
45,8482713,Mackie Samoskevich,R,FLA,22,82,9,8,17
45,8482516,Matthew Kessel,D,STL,24,82,7,10,17
45,8477507,Nikita Zadorov,D,BOS,29,82,6,11,17
45,8481122,Simon Benoit,D,TOR,26,82,6,11,17
45,8478882,Vladislav Gavrikov,D,LAK,29,82,5,12,17
45,8478468,Jeremy Lauzon,D,NSH,27,82,5,12,17
45,8478443,Brandon Carlo,D,BOS,28,82,5,12,17
45,8482803,Olen Zellweger,D,ANA,21,82,4,13,17
45,8475231,Casey Cizikas,C,NYI,33,82,4,13,17
45,8476429,Scott Mayfield,D,NYI,32,82,3,14,17
45,8483495,Simon Nemec,D,NJD,20,82,3,14,17
45,8476967,Brett Kulak,D,EDM,30,82,3,14,17
45,8480806,Isac Lundestrom,C,ANA,25,82,8,8,16
45,8480073,Erik Brannstrom,D,COL,25,82,6,10,16
45,8482145,Mavrik Bourque,C,DAL,22,82,6,10,16
45,8483499,Liam Ohgren,L,MIN,20,82,5,11,16
45,8481699,Aku Raty,R,UTA,23,82,4,12,16
45,8479393,Noah Gregor,C,OTT,26,82,9,6,15
45,8482749,Joshua Roy,R,MTL,21,82,5,10,15
45,8479442,Troy Stecher,D,EDM,30,82,4,11,15
45,8480021,Jack Studnicka,C,LAK,25,82,2,13,15
45,8482858,Ryker Evans,D,SEA,23,82,8,6,14
45,8482118,Sam Colangelo,R,ANA,23,82,8,6,14
45,8482153,Brendan Brisson,C,VGK,23,82,6,8,14
45,8484149,Gavin Brindley,C,CBJ,20,82,6,8,14
45,8476822,Luke Glendening,C,TBL,35,82,6,8,14
45,8483445,Cutter Gauthier,L,ANA,20,82,5,9,14
45,8480990,Declan Chisholm,D,MIN,24,82,5,9,14
45,8480860,Kevin Bahl,D,CGY,24,82,4,10,14
45,8482712,Oskar Olausson,R,COL,22,82,4,10,14
45,8474567,Zach Bogosian,D,MIN,34,82,4,10,14
45,8482470,Ilya Solovyov,D,CGY,24,82,2,12,14
45,8483460,David Jiricek,D,CBJ,21,82,2,12,14
45,8482077,Dylan Holloway,L,EDM,23,82,10,3,13
45,8481517,Brett Leason,R,ANA,25,82,6,7,13
45,8483482,Tristan Luneau,D,ANA,20,82,6,7,13
45,8475762,Derek Forbort,D,VAN,32,82,4,9,13
45,8480879,Jacob Bernard-Docker,D,OTT,24,82,2,11,13
45,8483567,Georgii Merkulov,C,BOS,24,82,2,11,13
45,8475455,Brenden Dillon,D,NJD,34,82,1,12,13
45,8479359,Beck Malenstyn,L,BUF,26,82,5,7,12
45,8481605,Jackson LaCombe,D,ANA,23,82,5,7,12
45,8483466,Kevin Korchinski,D,CHI,20,82,3,9,12
45,8475718,Justin Holl,D,DET,32,82,2,10,12
45,8475177,Calvin de Haan,D,COL,33,82,2,10,12
45,8474090,Brendan Smith,D,DAL,35,82,2,10,12
45,8474612,Travis Hamonic,D,OTT,34,82,5,6,11
45,8482859,Zack Ostapchuk,C,OTT,21,82,5,6,11
45,8480950,Ilya Lyubushkin,D,DAL,30,82,3,8,11
45,8476372,Nick Seeler,D,PHI,31,82,2,9,11
45,8482070,Mitchell Chaffee,R,TBL,26,82,6,4,10
45,8482787,Nikita Chibrikov,R,WPG,31,82,5,5,10
45,8477938,Haydn Fleury,D,WPG,28,82,4,6,10
45,8483489,Fraser Minten,C,TOR,31,82,4,6,10
45,8482101,Danil Gushchin,L,SJS,22,82,4,6,10
45,8483505,Matthew Poitras,C,BOS,20,82,3,7,10
45,8471677,Jack Johnson,D,CBJ,37,82,3,7,10
45,8481641,Joel Kiviranta,L,COL,28,82,4,5,9
45,8479291,Kevin Rooney,C,CGY,31,82,4,5,9
45,8479576,Vincent Desharnais,D,VAN,28,82,3,6,9
45,8476441,Joel Edmundson,D,LAK,31,82,1,8,9
45,8483471,Brad Lambert,C,WPG,31,82,3,5,8
45,8484911,Collin Graf,R,SJS,22,82,2,6,8
45,8480834,Ty Emberson,D,SJS,24,82,2,6,8
45,8478874,Adam Gaudette,C,OTT,28,82,3,4,7
45,8476473,Connor Murphy,D,CHI,31,82,1,4,5
45,8474062,Riley Nash,C,NYR,35,82,1,4,5
45,8470794,Joe Pavelski,C,,40,0,0,0,0
45,8481703,Valtteri Puustinen,R,PIT,25,0,0,0,0
45,8477950,Tony DeAngelo,D,,29,0,0,0,0
45,8481577,Philip Tomasino,C,NSH,23,0,0,0,0
45,8475197,Tyson Barrie,D,,33,0,0,0,0
45,8471218,Blake Wheeler,R,,38,0,0,0,0
45,8474157,Max Pacioretty,L,,36,0,0,0,0
45,8478466,Daniel Sprong,R,VAN,27,0,0,0,0
45,8475744,Evgeny Kuznetsov,C,,32,0,0,0,0
45,8481019,David Gustafsson,C,WPG,24,0,0,0,0
45,8475906,John Klingberg,D,,32,0,0,0,0
45,8479348,Kale Clague,D,BUF,26,0,0,0,0
45,8476952,Dominic Toninato,C,WPG,30,0,0,0,0
45,8473473,Milan Lucic,L,,36,0,0,0,0
45,8474037,James van Riemsdyk,L,,35,0,0,0,0
45,8474602,Justin Schultz,D,,34,0,0,0,0
45,8482222,Alexander Barabanov,L,,30,0,0,0,0
45,8479372,Josh Mahura,D,SEA,26,0,0,0,0
45,8479982,Conor Timmins,D,TOR,26,0,0,0,0
45,8474031,Kevin Shattenkirk,D,,35,0,0,0,0
45,8480008,Adam Ruzicka,C,,25,0,0,0,0
45,8481059,Scott Perunovich,D,STL,26,0,0,0,0
45,8480884,Calen Addison,D,,24,0,0,0,0
45,8476994,Vinnie Hinostroza,C,NSH,30,0,0,0,0
45,8478452,Caleb Jones,D,LAK,27,0,0,0,0
45,8480157,Calle Rosen,D,COL,30,0,0,0,0
45,8481609,Vladislav Kolyachonok,D,UTA,23,0,0,0,0
45,8479415,Michael McLeod,C,,26,0,0,0,0
45,8476919,Chris Tierney,C,,30,0,0,0,0
45,8479639,Dylan Coghlan,D,WPG,26,0,0,0,0
45,8478146,Matthew Highmore,C,OTT,28,0,0,0,0
45,8478970,Jalen Chatfield,D,CAR,28,0,0,0,0
45,8480205,Emil Bemstrom,C,PIT,25,0,0,0,0
45,8474884,Mike Hoffman,C,,35,0,0,0,0
45,8471274,Alex Goligoski,D,,39,0,0,0,0
45,8478104,Sammy Blais,L,,28,0,0,0,0
45,8474870,Tyler Johnson,C,,34,0,0,0,0
45,8476913,Devin Shore,C,MIN,30,0,0,0,0
45,8481598,Philip Broberg,D,EDM,23,0,0,0,0
45,8480058,Pierre-Olivier Joseph,D,STL,25,0,0,0,0
45,8480891,Michael Kesselring,D,UTA,24,0,0,0,0
45,8477979,Nicolas Aube-Kubel,R,BUF,28,0,0,0,0
45,8476871,Tanner Pearson,L,,32,0,0,0,0
45,8476393,Nick Cousins,C,,31,0,0,0,0
45,8479977,Kailer Yamamoto,R,,26,0,0,0,0
45,8479543,Michael Pezzetta,L,MTL,26,0,0,0,0
45,8477018,Ben Hutton,D,VGK,31,0,0,0,0
45,8480762,Eric Robinson,L,CAR,29,0,0,0,0
45,8474034,Pat Maroon,L,CHI,36,0,0,0,0
45,8481058,Jesse Ylönen,R,,25,0,0,0,0
45,8475179,Dmitry Kulikov,D,FLA,34,0,0,0,0
45,8481527,Kaedan Korczak,D,VGK,23,0,0,0,0
45,8473449,Kyle Okposo,R,,36,0,0,0,0
45,8482192,Isaak Phillips,D,CHI,23,0,0,0,0
45,8480727,Zach Whitecloud,D,VGK,28,0,0,0,0
45,8479346,Dillon Dube,C,,26,0,0,0,0
45,8480821,Filip Zadina,R,,25,0,0,0,0
45,8480001,Urho Vaakanainen,D,ANA,25,0,0,0,0
45,8470966,Mark Giordano,D,,41,0,0,0,0
45,8480853,Liam Foudy,C,,24,0,0,0,0
45,8475225,Craig Smith,C,CHI,35,0,0,0,0
45,8479972,Mason Shaw,C,WPG,26,0,0,0,0
45,8478451,Ethan Bear,D,WSH,27,0,0,0,0
45,8474040,Sam Gagner,C,,35,0,0,0,0
45,8480196,Jacob Bryson,D,BUF,27,0,0,0,0
45,8479984,Cal Foote,D,,26,0,0,0,0
45,8480011,Klim Kostin,C,SJS,25,0,0,0,0
45,8482176,Wyatt Kaiser,D,CHI,22,0,0,0,0
45,8476988,Matt Benning,D,SJS,30,0,0,0,0
45,8479370,Tyson Jost,C,CAR,26,0,0,0,0
45,8477464,Nic Petan,C,,29,0,0,0,0
45,8477380,Jonny Brodzinski,C,NYR,31,0,0,0,0
45,8480070,Ian Mitchell,D,BOS,25,0,0,0,0
45,8479315,Joey Anderson,R,CHI,26,0,0,0,0
45,8478099,Kevin Labanc,R,,29,0,0,0,0
45,8476874,Olli Maatta,D,DET,30,0,0,0,0
45,8475208,Brian Dumoulin,D,ANA,33,0,0,0,0
45,8478430,Oliver Kylington,D,,27,0,0,0,0
45,8479536,Axel Jonsson-Fjallby,L,WPG,26,0,0,0,0
45,8479671,Mathieu Olivier,R,CBJ,27,0,0,0,0
45,8471709,Marc-Edouard Vlasic,D,SJS,37,0,0,0,0
45,8479328,Julien Gauthier,R,NYI,27,0,0,0,0
45,8478421,A.J. Greer,L,FLA,28,0,0,0,0
45,8477573,Nathan Walker,L,STL,30,0,0,0,0
45,8481537,Nikita Okhotiuk,D,CGY,24,0,0,0,0
45,8474166,Alec Martinez,D,CHI,37,0,0,0,0
45,8470610,Zach Parise,L,,40,0,0,0,0
45,8477478,William Carrier,L,CAR,30,0,0,0,0
45,8479344,Jesse Puljujarvi,R,PIT,26,0,0,0,0
45,8480887,Jordan Harris,D,MTL,24,0,0,0,0
45,8478502,Dennis Gilbert,D,BUF,28,0,0,0,0
45,8482730,Brandt Clarke,D,LAK,21,0,0,0,0
45,8480355,Mark Kastelic,C,BOS,25,0,0,0,0
45,8475750,Jon Merrill,D,MIN,32,0,0,0,0
45,8475164,Jakob Silfverberg,R,,34,0,0,0,0
45,8477944,Jakub Vrana,L,,28,0,0,0,0
45,8479439,Jacob MacDonald,D,COL,31,0,0,0,0
45,8474568,Luke Schenn,D,NSH,35,0,0,0,0
45,8478454,Noah Juulsen,D,VAN,27,0,0,0,0
45,8475752,Tyler Pitlick,C,,33,0,0,0,0
45,8482148,Hendrix Lapierre,C,WSH,22,0,0,0,0
45,8481167,Brayden Pachal,D,CGY,25,0,0,0,0
45,8478043,Sam Lafferty,C,BUF,29,0,0,0,0
45,8479321,Lucas Johansen,D,,27,0,0,0,0
45,8471699,Andrew Cogliano,C,,37,0,0,0,0
45,8481521,Ronnie Attard,D,PHI,25,0,0,0,0
45,8481161,Jake Christiansen,D,CBJ,25,0,0,0,0
45,8479458,Nikita Zaitsev,D,,33,0,0,0,0
45,8479619,Michael Carcone,L,UTA,28,0,0,0,0
45,8479026,Philippe Myers,D,TOR,27,0,0,0,0
45,8477330,Dominik Kubalik,L,,29,0,0,0,0
45,8481617,Vasily Podkolzin,R,VAN,23,0,0,0,0
45,8481701,Santeri Hatakka,D,NJD,23,0,0,0,0
45,8479514,Rem Pitlick,C,,27,0,0,0,0
45,8477446,Michael McCarron,R,NSH,29,0,0,0,0
45,8470604,Jeff Carter,C,,39,0,0,0,0
45,8482241,Radim Zohorna,L,,28,0,0,0,0
45,8480289,Morgan Barron,C,WPG,26,0,0,0,0
45,8479379,Givani Smith,R,SJS,26,0,0,0,0
45,8480216,Jacob Peterson,C,,25,0,0,0,0
45,8477851,Jordan Oesterle,D,BOS,32,0,0,0,0
45,8484258,Sam Malinski,D,COL,26,0,0,0,0
45,8478904,Steven Lorentz,C,,28,0,0,0,0
45,8482095,Tyler Kleven,D,OTT,22,0,0,0,0
45,8480848,Ty Dellandrea,C,SJS,24,0,0,0,0
45,8476884,Derrick Pouliot,D,,30,0,0,0,0
45,8479336,Carl Grundstrom,R,SJS,27,0,0,0,0
45,8482964,Arber Xhekaj,D,MTL,23,0,0,0,0
45,8471686,Marc Staal,D,,37,0,0,0,0
45,8477887,Patrick Brown,C,BOS,32,0,0,0,0
45,8478495,Denis Gurianov,R,,27,0,0,0,0
45,8473504,Cal Clutterbuck,R,,37,0,0,0,0
45,8481550,Adam Beckman,L,NJD,23,0,0,0,0
45,8480845,Rasmus Kupari,C,WPG,24,0,0,0,0
45,8474009,Nick Bonino,C,,36,0,0,0,0
45,8478585,Derek Ryan,C,EDM,38,0,0,0,0
45,8477962,Brendan Lemieux,L,CAR,28,0,0,0,0
45,8482861,Vincent Iorio,D,WSH,22,0,0,0,0
45,8479378,Logan Stanley,D,WPG,26,0,0,0,0
45,8473446,Erik Johnson,D,PHI,36,0,0,0,0
45,8481743,Marc Del Gaizo,D,NSH,25,0,0,0,0
45,8477384,Josh Brown,D,EDM,30,0,0,0,0
45,8482165,Yan Kuznetsov,D,CGY,22,0,0,0,0
45,8478424,Jansen Harkins,C,ANA,27,0,0,0,0
45,8482144,Jack Thompson,D,SJS,22,0,0,0,0
45,8478512,Austin Czarnik,C,,32,0,0,0,0
45,8477527,Ross Johnston,L,ANA,30,0,0,0,0
45,8479383,Boris Katchouk,L,,26,0,0,0,0
45,8482094,Daemon Hunt,D,MIN,22,0,0,0,0
45,8481719,Maxwell Crozier,D,TBL,24,0,0,0,0
45,8480192,Johnathan Kovacevic,D,NJD,27,0,0,0,0
45,8479376,Victor Mete,D,,26,0,0,0,0
45,8482511,Mason Lohrei,D,BOS,23,0,0,0,0
45,8475825,Jani Hakanpää,D,,32,0,0,0,0
45,8478021,William Lagesson,D,DET,28,0,0,0,0
45,8475795,Dylan McIlrath,D,WSH,32,0,0,0,0
45,8477846,Ryan Carpenter,C,,33,0,0,0,0
45,8481056,Spencer Stastney,D,NSH,24,0,0,0,0
45,8481564,Ryan Johnson,D,BUF,23,0,0,0,0
45,8478017,Mark Friedman,D,VAN,29,0,0,0,0
45,8479320,Max Lajoie,D,SEA,27,0,0,0,0
45,8480075,Cameron Crotty,D,MIN,25,0,0,0,0
45,8484287,Cole McWard,D,VAN,23,0,0,0,0
45,8484254,Akito Hirose,D,VAN,25,0,0,0,0
45,8483407,Brandon Scanlin,D,NYR,25,0,0,0,0
45,8480274,Philip Kemp,D,EDM,25,0,0,0,0
45,8479522,Hardy Haman Aktell,D,WSH,26,0,0,0,0
45,8480007,Jonas Rondbjerg,R,VGK,25,0,0,0,0
45,8477454,Adam Erne,L,,29,0,0,0,0
45,8481679,Maxence Guenette,D,OTT,23,0,0,0,0
45,8480441,Trey Fix-Wolansky,R,CBJ,25,0,0,0,0
45,8483546,Marshall Rifai,D,TOR,26,0,0,0,0
45,8480084,Nick DeSimone,D,NJD,30,0,0,0,0
45,8481030,Jack St. Ivany,D,PIT,25,0,0,0,0
45,8481592,Jakob Pelletier,L,CGY,23,0,0,0,0
45,8478011,Louie Belpedio,D,PHI,28,0,0,0,0
45,8477930,Pierre-Edouard Bellemare,L,,39,0,0,0,0
45,8484321,Nikolas Matinpalo,D,OTT,26,0,0,0,0
45,8482067,Connor Mackey,D,NYR,28,0,0,0,0
45,8481806,Louis Crevier,D,CHI,23,0,0,0,0
45,8484326,Patrik Koch,D,UTA,28,0,0,0,0
45,8477971,Andreas Englund,D,LAK,28,0,0,0,0
45,8481751,Lukas Rousek,R,BUF,25,0,0,0,0
45,8481006,Tyler Tucker,D,STL,24,0,0,0,0
45,8476867,Brendan Gaunce,C,MIN,30,0,0,0,0
45,8479520,Brandon Duhaime,R,WSH,27,0,0,0,0
45,8477073,Kurtis MacDermid,L,NJD,30,0,0,0,0
45,8480874,Adam Ginning,D,PHI,24,0,0,0,0
45,8477473,Justin Bailey,R,SJS,29,0,0,0,0
45,8479066,Ryan Lomberg,L,CGY,30,0,0,0,0
45,8477070,Liam O'Brien,C,UTA,30,0,0,0,0
45,8474618,Marco Scandella,D,,34,0,0,0,0
45,8475797,Jarred Tinordi,D,,32,0,0,0,0
45,8481441,Joe Snively,C,DET,28,0,0,0,0
45,8477244,Chad Ruhwedel,D,NYR,34,0,0,0,0
45,8479772,Zack MacEwen,R,OTT,28,0,0,0,0
45,8481147,Reese Johnson,C,MIN,26,0,0,0,0
45,8481043,Cole Koepke,L,BOS,26,0,0,0,0
45,8483619,Filip Roos,D,OTT,25,0,0,0,0
45,8481541,Samuel Bolduc,D,NYI,24,0,0,0,0
45,8477810,Joel Hanley,D,CGY,33,0,0,0,0
45,8476907,Mackenzie MacEachern,L,,30,0,0,0,0
45,8482652,Walker Duehr,R,CGY,27,0,0,0,0
45,8477126,Jayson Megna,C,,34,0,0,0,0
45,8483398,Declan Carlile,D,TBL,31,0,0,0,0
45,8482929,Emil Lilleberg,D,TBL,23,0,0,0,0
45,8480880,Jakub Lauko,C,MIN,24,0,0,0,0
45,8480245,Olle Lycksell,R,PHI,25,0,0,0,0
45,8480252,Cole Guttman,C,CHI,25,0,0,0,0
45,8477467,Gustav Olofsson,D,SEA,30,0,0,0,0
45,8479968,Vinni Lettieri,C,BOS,29,0,0,0,0
45,8478400,Colin White,C,,27,0,0,0,0
45,8475755,Alexander Petrovic,D,DAL,32,0,0,0,0
45,8481812,Nikolai Knyzhov,D,,27,0,0,0,0
45,8481593,Jayden Struble,D,MTL,23,0,0,0,0
45,8481532,Alex Turcotte,C,LAK,23,0,0,0,0
45,8482126,Emil Andrae,D,PHI,31,0,0,0,0
45,8479944,Zach Aston-Reese,C,VGK,30,0,0,0,0
45,8471817,Ryan Reaves,R,TOR,37,0,0,0,0
45,8481206,John Ludvig,D,PIT,24,0,0,0,0
45,8481599,Victor Soderstrom,D,UTA,23,0,0,0,0
45,8480292,Carson Meyer,R,ANA,27,0,0,0,0
45,8482496,Nils Aman,C,VAN,24,0,0,0,0
45,8479718,Alex Barré-Boulet,C,MTL,27,0,0,0,0
45,8479994,Jaret Anderson-Dolan,C,WPG,25,0,0,0,0
45,8480184,Gustav Lindstrom,D,,26,0,0,0,0
45,8480890,Jan Jenik,R,OTT,24,0,0,0,0
45,8478067,Oskar Lindblom,L,,28,0,0,0,0
45,8476934,Brock McGinn,L,ANA,30,0,0,0,0
45,8479985,Cale Fleury,D,SEA,26,0,0,0,0
45,8484304,Uvis Balinskis,D,FLA,28,0,0,0,0
45,8479981,Jonah Gadjovich,L,FLA,26,0,0,0,0
45,8481716,Dmitri Voronkov,L,CBJ,24,0,0,0,0
45,8474709,Matt Martin,L,,35,0,0,0,0
45,8482634,Alex Steeves,C,TOR,25,0,0,0,0
45,8480823,Alexander Alexeyev,D,WSH,25,0,0,0,0
45,8477541,Dakota Mermis,D,TOR,30,0,0,0,0
45,8483491,Ivan Miroshnichenko,L,WSH,20,0,0,0,0
45,8478477,Mitchell Stephens,C,SEA,27,0,0,0,0
45,8481543,Nikita Alexandrov,C,STL,24,0,0,0,0
45,8479423,Alex Nylander,L,,26,0,0,0,0
45,8482451,Mikael Pyyhtia,L,CBJ,23,0,0,0,0
45,8478831,Kevin Stenlund,C,UTA,28,0,0,0,0
45,8480306,Grant Hutton,D,NYI,29,0,0,0,0
45,8478028,Fredrik Olofsson,L,,28,0,0,0,0
45,8477462,Robert Hagg,D,VGK,29,0,0,0,0
45,8477320,Anton Blidh,L,NYR,29,0,0,0,0
45,8482157,Will Cuylle,L,NYR,22,0,0,0,0
45,8482737,Zack Bolduc,C,STL,21,0,0,0,0
45,8481239,Samuel Fagemo,L,,24,0,0,0,0
45,8481600,Tobias Bjornfot,D,FLA,23,0,0,0,0
45,8478409,Anthony Richard,C,PHI,28,0,0,0,0
45,8474145,Robert Bortuzzo,D,,35,0,0,0,0
45,8475958,Michael Sgarbossa,C,WSH,32,0,0,0,0
45,8479986,Kole Lind,R,DAL,26,0,0,0,0
45,8479249,Andrew Poturalski,C,SJS,30,0,0,0,0
45,8479362,Riley Tufte,L,BOS,26,0,0,0,0
45,8479991,Jake Leschyshyn,C,NYR,25,0,0,0,0
45,8479587,Rhett Gardner,C,PHI,28,0,0,0,0
45,8482744,James Malatesta,L,CBJ,21,0,0,0,0
45,8478854,Ryan Shea,D,PIT,27,0,0,0,0
45,8481591,Sam Poulin,R,,23,0,0,0,0
45,8483512,Matt Savoie,C,EDM,20,0,0,0,0
45,8482102,Vasily Ponomarev,C,PIT,22,0,0,0,0
45,8482162,Roby Jarventie,L,EDM,22,0,0,0,0
45,8481016,Ruslan Iskhakov,C,,24,0,0,0,0
45,8482172,Landon Slaggert,L,CHI,22,0,0,0,0
45,8482747,Brennan Othmann,L,NYR,21,0,0,0,0
45,8480031,Maxime Comtois,L,,25,0,0,0,0
45,8480226,Marián Studenic,R,,26,0,0,0,0
45,8478408,Travis Dermott,D,,28,0,0,0,0
45,8481518,Nolan Foote,L,NJD,24,0,0,0,0
45,8479419,Brett Murray,L,BUF,26,0,0,0,0
45,8482088,Justin Sourdif,R,FLA,22,0,0,0,0
45,8482201,Gage Goncalves,C,TBL,23,0,0,0,0
45,8481578,Graeme Clarke,R,MIN,23,0,0,0,0
45,8482177,Marat Khusnutdinov,C,MIN,22,0,0,0,0
45,8481754,Nikita Nesterenko,C,ANA,23,0,0,0,0
45,8483531,Brian Halonen,L,NJD,25,0,0,0,0
45,8483920,Pierrick Dube,R,WSH,23,0,0,0,0
45,8480851,Akil Thomas,C,LAK,24,0,0,0,0
45,8475235,Nicolas Deslauriers,L,PHI,33,0,0,0,0
45,8482476,Emil Heineman,L,MTL,23,0,0,0,0
45,8477149,Scott Sabourin,R,SJS,32,0,0,0,0
45,8483549,Lucas Condotta,L,MTL,27,0,0,0,0
45,8482765,Isak Rosen,R,BUF,21,0,0,0,0
45,8481237,Kyle MacLean,C,NYI,25,0,0,0,0
45,8481024,Linus Karlsson,C,VAN,25,0,0,0,0
45,8481690,Tyler Angle,C,,24,0,0,0,0
45,8483570,Ben Meyers,C,SEA,26,0,0,0,0
45,8481655,Cole Schwindt,R,CGY,23,0,0,0,0
45,8481462,Mason Morelli,L,VGK,28,0,0,0,0
45,8483401,Marc Johnstone,R,PIT,28,0,0,0,0
45,8478956,Samuel Laberge,L,NJD,27,0,0,0,0
45,8479533,Joona Koppanen,L,,26,0,0,0,0
45,8482197,Adam Raska,R,MIN,23,0,0,0,0
45,8482250,Callahan Burke,C,VGK,27,0,0,0,0
45,8482784,Zach Dean,C,STL,21,0,0,0,0
45,8484255,Jason Polin,R,COL,25,0,0,0,0
45,8481077,John Leonard,L,,26,0,0,0,0
45,8481534,Raphael Lavoie,C,EDM,24,0,0,0,0
45,8483609,Adam Klapka,R,CGY,24,0,0,0,0
45,8482751,Ryan Winterton,C,SEA,21,0,0,0,0
45,8480267,Sammy Walker,C,MIN,25,0,0,0,0
45,8475766,Austin Watson,L,,32,0,0,0,0
45,8482460,Matt Rempe,C,NYR,22,0,0,0,0
45,8481065,Angus Crookshank,L,OTT,25,0,0,0,0
45,8481070,Hugh McGing,L,,26,0,0,0,0
45,8476323,Max McCormick,L,SEA,32,0,0,0,0
45,8483395,Arshdeep Bains,L,VAN,23,0,0,0,0
45,8484259,Ondrej Pavel,C,COL,31,0,0,0,0
45,8483432,Luca Del Bel Belluz,C,CBJ,31,0,0,0,0
45,8483045,Cameron Butler,R,CBJ,31,0,0,0,0
45,8482061,Brandon Biro,L,SEA,26,0,0,0,0
45,8477401,John Hayden,C,SEA,29,0,0,0,0
45,8475278,Byron Froese,C,,33,0,0,0,0
45,8478446,Glenn Gawdin,C,LAK,27,0,0,0,0
45,8477993,Justin Kirkland,C,CGY,28,0,0,0,0
45,8482147,Jean-Luc Foudy,C,COL,22,0,0,0,0
45,8480032,Shane Bowers,C,NJD,25,0,0,0,0
45,8479330,Brandon Gignac,C,MTL,27,0,0,0,0
45,8480776,Sheldon Rempal,R,,29,0,0,0,0
45,8475413,Justin Dowling,C,NJD,34,0,0,0,0
45,8481726,Adam Edstrom,C,NYR,24,0,0,0,0
45,8480844,Grigori Denisenko,L,VGK,24,0,0,0,0
45,8478147,Bokondji Imama,L,PIT,28,0,0,0,0
45,8478881,Brett Seney,L,CHI,28,0,0,0,0
45,8483630,Pavol Regenda,L,ANA,25,0,0,0,0
45,8480836,Jonathan Gruden,C,,24,0,0,0,0
45,8484314,Jiri Smejkal,L,,28,0,0,0,0
45,8475780,Chris Wagner,R,COL,33,0,0,0,0
45,8479546,Oskar Steen,C,,26,0,0,0,0
45,8483597,Milos Kelemen,L,UTA,25,0,0,0,0
45,8481789,Tye Kartye,L,SEA,23,0,0,0,0
45,8484325,Waltteri Merela,C,TBL,26,0,0,0,0
45,8479421,Jacob Moverare,D,LAK,26,0,0,0,0
45,8481585,Egor Afanasyev,L,SJS,23,0,0,0,0
45,8479547,Matthew Phillips,R,,26,0,0,0,0
45,8479367,William Lockwood,R,FLA,26,0,0,0,0
45,8476915,Jujhar Khaira,L,,30,0,0,0,0
45,8481422,Jacob Lucchini,C,NSH,29,0,0,0,0
45,8480468,James Hamblin,L,EDM,25,0,0,0,0
45,8478051,Max Willman,C,NJD,29,0,0,0,0
45,8481556,John Beecher,C,BOS,23,0,0,0,0
45,8478078,Rourke Chartier,C,,28,0,0,0,0
46,8478402,Connor McDavid,C,EDM,27,82,40,116,156
46,8477934,Leon Draisaitl,C,EDM,29,82,60,81,141
46,8476453,Nikita Kucherov,R,TBL,31,82,37,90,127
46,8481559,Jack Hughes,C,NJD,23,82,47,68,115
46,8480027,Jason Robertson,L,DAL,25,82,46,69,115
46,8477493,Aleksander Barkov,C,FLA,29,82,37,78,115
46,8477492,Nathan MacKinnon,C,COL,29,82,47,67,114
46,8479318,Auston Matthews,C,TOR,27,82,61,50,111
46,8478550,Artemi Panarin,L,NYR,33,82,41,70,111
46,8478420,Mikko Rantanen,R,COL,28,82,44,61,105
46,8477956,David Pastrnak,R,BOS,28,82,56,48,104
46,8477946,Dylan Larkin,C,DET,28,82,46,56,102
46,8477939,William Nylander,R,TOR,28,82,44,57,101
46,8478403,Jack Eichel,C,VGK,28,82,43,58,101
46,8476887,Filip Forsberg,L,NSH,30,82,52,48,100
46,8478864,Kirill Kaprizov,L,MIN,27,82,45,54,99
46,8480023,Robert Thomas,C,STL,25,82,33,66,99
46,8479314,Matthew Tkachuk,L,FLA,27,82,28,71,99
46,8471675,Sidney Crosby,C,PIT,37,82,36,60,96
46,8476539,Jonathan Marchessault,R,NSH,34,82,51,44,95
46,8476468,J.T. Miller,C,VAN,31,82,35,59,94
46,8480800,Quinn Hughes,D,VAN,25,82,16,78,94
46,8480069,Cale Makar,D,COL,26,82,31,62,93
46,8477409,Carter Verhaeghe,C,FLA,29,82,51,41,92
46,8478427,Sebastian Aho,C,CAR,27,82,50,41,91
46,8478042,Viktor Arvidsson,R,EDM,31,82,44,46,90
46,8477933,Sam Reinhart,C,FLA,29,82,41,49,90
46,8471214,Alex Ovechkin,L,WSH,39,82,50,39,89
46,8477404,Jake Guentzel,C,TBL,30,82,44,45,89
46,8479420,Tage Thompson,C,BUF,27,82,42,47,89
46,8479385,Jordan Kyrou,C,STL,26,82,36,53,89
46,8475913,Mark Stone,R,VGK,32,82,31,58,89
46,8479407,Jesper Bratt,L,NJD,26,82,30,58,88
46,8476454,Ryan Nugent-Hopkins,C,EDM,31,82,24,63,87
46,8477942,Kevin Fiala,L,LAK,28,82,32,54,86
46,8474600,Roman Josi,D,NSH,34,82,20,66,86
46,8476460,Mark Scheifele,C,WPG,31,82,36,49,85
46,8480002,Nico Hischier,C,NJD,25,82,30,55,85
46,8478010,Brayden Point,C,TBL,28,82,40,43,83
46,8476459,Mika Zibanejad,C,NYR,31,82,35,48,83
46,8482116,Tim Stützle,C,OTT,22,82,30,53,83
46,8479337,Alex DeBrincat,R,DET,27,82,38,43,81
46,8478439,Travis Konecny,R,PHI,27,82,29,52,81
46,8477501,Valeri Nichushkin,R,COL,29,82,35,45,80
46,8481523,Kirby Dach,C,MTL,23,82,17,63,80
46,8480012,Elias Pettersson,C,VAN,26,82,33,46,79
46,8478414,Timo Meier,R,NJD,28,82,30,49,79
46,8476346,Johnny Gaudreau,L,CBJ,31,82,14,65,79
46,8475167,Victor Hedman,D,TBL,34,82,14,64,78
46,8478440,Dylan Strome,C,WSH,27,82,29,48,77
46,8474578,Erik Karlsson,D,PIT,34,82,17,60,77
46,8478444,Brock Boeser,R,VAN,27,82,33,43,76
46,8474564,Steven Stamkos,C,NSH,34,82,27,49,76
46,8480801,Brady Tkachuk,L,OTT,25,82,39,36,75
46,8478873,Troy Terry,R,ANA,27,82,30,45,75
46,8477951,Nick Schmaltz,C,UTA,28,82,28,47,75
46,8480839,Rasmus Dahlin,D,BUF,24,82,19,56,75
46,8480803,Evan Bouchard,D,EDM,25,82,16,59,75
46,8475184,Chris Kreider,L,NYR,33,82,43,31,74
46,8478493,Joel Eriksson Ek,C,MIN,27,82,35,39,74
46,8479542,Brandon Hagel,L,TBL,26,82,34,40,74
46,8475166,John Tavares,C,TOR,34,82,32,42,74
46,8481557,Matt Boldy,L,MIN,23,82,31,43,74
46,8478449,Roope Hintz,C,DAL,28,82,31,42,73
46,8475172,Nazem Kadri,C,CGY,34,82,29,44,73
46,8482665,Matty Beniers,C,SEA,22,82,28,45,73
46,8474141,Patrick Kane,R,DET,36,82,27,46,73
46,8478445,Mathew Barzal,C,NYI,27,82,21,52,73
46,8482093,Seth Jarvis,C,CAR,22,82,38,34,72
46,8475810,Bryan Rust,R,PIT,32,82,35,37,72
46,8482097,Jack Quinn,R,BUF,23,82,32,40,72
46,8477940,Nikolaj Ehlers,L,WPG,28,82,27,45,72
46,8476456,Jonathan Huberdeau,C,CGY,31,82,18,54,72
46,8478398,Kyle Connor,L,WPG,28,82,39,32,71
46,8475786,Zach Hyman,L,EDM,32,82,35,36,71
46,8480039,Martin Necas,C,CAR,25,82,28,43,71
46,8477949,Alex Tuch,R,BUF,28,82,22,49,71
46,8476389,Vincent Trocheck,C,NYR,31,82,17,54,71
46,8475692,Mats Zuccarello,R,MIN,37,82,12,58,70
46,8477447,Shea Theodore,D,VGK,29,82,12,58,70
46,8476853,Morgan Rielly,D,TOR,30,82,10,60,70
46,8479343,Clayton Keller,R,UTA,26,82,32,37,69
46,8474679,Gustav Nyquist,C,NSH,35,82,17,52,69
46,8476448,William Karlsson,C,VGK,31,82,35,33,68
46,8480830,Andrei Svechnikov,R,CAR,24,82,29,39,68
46,8471215,Evgeni Malkin,C,PIT,38,82,28,40,68
46,8478407,Vince Dunn,D,SEA,28,82,18,50,68
46,8480865,Noah Dobson,D,NYI,24,82,15,53,68
46,8475784,Jeff Skinner,C,EDM,32,82,32,35,67
46,8477500,Bo Horvat,C,NYI,29,82,29,38,67
46,8482149,Cole Perfetti,C,WPG,22,82,28,39,67
46,8480036,Miro Heiskanen,D,DAL,25,82,12,55,67
46,8475798,Mikael Granlund,C,SJS,32,82,20,46,66
46,8475168,Matt Duchene,C,DAL,33,82,27,38,65
46,8479325,Charlie McAvoy,D,BOS,27,82,16,49,65
46,8475169,Evander Kane,L,EDM,33,82,32,32,64
46,8482124,Quinton Byfield,R,LAK,22,82,23,41,64
46,8481528,Dylan Cozens,C,BUF,23,82,22,42,64
46,8477504,Josh Morrissey,D,WPG,29,82,10,54,64
46,8476905,Chandler Stephenson,C,SEA,30,82,23,40,63
46,8477932,Aaron Ekblad,D,FLA,28,82,20,43,63
46,8477955,Jared McCann,L,SEA,28,82,36,26,62
46,8474586,Jordan Eberle,R,SEA,34,82,27,35,62
46,8480208,Drake Batherson,R,OTT,26,82,23,39,62
46,8479323,Adam Fox,D,NYR,26,82,11,51,62
46,8476432,Boone Jenner,C,CBJ,31,82,33,28,61
46,8477416,Oliver Bjorkstrand,R,SEA,29,82,28,33,61
46,8477476,Artturi Lehkonen,L,COL,29,82,28,33,61
46,8477402,Pavel Buchnevich,L,STL,29,82,25,36,61
46,8476881,Tomas Hertl,C,VGK,31,82,24,37,61
46,8478401,Pavel Zacha,C,BOS,27,82,23,38,61
46,8474590,John Carlson,D,WSH,34,82,16,45,61
46,8477503,Max Domi,C,TOR,29,82,14,47,61
46,8478396,Noah Hanifin,D,VGK,27,82,12,49,61
46,8475754,Brock Nelson,C,NYI,33,82,30,30,60
46,8475726,Tyler Toffoli,C,SJS,32,82,28,32,60
46,8480188,Fabian Zetterlund,L,SJS,25,82,28,32,60
46,8483808,Andrei Kuzmenko,L,CGY,28,82,24,36,60
46,8478469,Thomas Chabot,D,OTT,27,82,16,44,60
46,8479999,Casey Mittelstadt,C,COL,26,82,15,45,60
46,8478460,Zach Werenski,D,CBJ,27,82,14,46,60
46,8481533,Trevor Zegras,C,ANA,23,82,24,35,59
46,8480018,Nick Suzuki,C,MTL,25,82,18,41,59
46,8478975,Mason Marchment,L,DAL,29,82,18,41,59
46,8480014,Gabriel Vilardi,C,WPG,25,82,36,22,58
46,8481540,Cole Caufield,R,MTL,23,82,33,25,58
46,8478498,Jake DeBrusk,L,VAN,28,82,25,33,58
46,8477497,Sean Monahan,C,CBJ,30,82,24,34,58
46,8480797,Joel Farabee,L,PHI,24,82,22,36,58
46,8474150,Mikael Backlund,C,CGY,35,82,20,38,58
46,8475765,Vladimir Tarasenko,R,DET,33,82,19,39,58
46,8471685,Anze Kopitar,C,LAK,37,82,19,39,58
46,8476875,Mike Matheson,D,MTL,30,82,12,46,58
46,8482110,Dawson Mercer,C,NJD,23,82,32,25,57
46,8477479,Tyler Bertuzzi,L,CHI,29,82,30,27,57
46,8482745,Mason McTavish,C,ANA,21,82,29,28,57
46,8475170,Brayden Schenn,C,STL,33,82,28,29,57
46,8475158,Ryan O'Reilly,C,NSH,33,82,23,34,57
46,8477496,Elias Lindholm,C,BOS,30,82,21,36,57
46,8479400,Pierre-Luc Dubois,L,WSH,26,82,20,37,57
46,8478542,Evan Rodrigues,C,FLA,31,82,20,37,57
46,8479345,Jakob Chychrun,D,WSH,26,82,20,37,57
46,8470613,Brent Burns,D,CAR,39,82,7,50,57
46,8479425,Filip Hronek,D,VAN,27,82,6,51,57
46,8476483,Rickard Rakell,R,PIT,31,82,28,28,56
46,8473994,Jamie Benn,L,DAL,35,82,23,33,56
46,8477964,Ivan Barbashev,C,VGK,29,82,23,33,56
46,8474641,Adam Henrique,C,EDM,34,82,22,34,56
46,8473419,Brad Marchand,L,BOS,36,82,21,35,56
46,8478438,Tommy Novak,C,NSH,27,82,15,41,56
46,8480015,Owen Tippett,R,PHI,25,82,29,26,55
46,8479675,Trevor Moore,L,LAK,29,82,26,29,55
46,8482078,Lucas Raymond,L,DET,22,82,22,33,55
46,8477021,Alex Kerfoot,C,UTA,30,82,18,37,55
46,8477960,Adrian Kempe,R,LAK,28,82,22,32,54
46,8473512,Claude Giroux,R,OTT,36,82,19,35,54
46,8481542,Moritz Seider,D,DET,23,82,8,46,54
46,8479339,Patrik Laine,L,CBJ,26,82,30,23,53
46,8478366,Frank Vatrano,R,ANA,30,82,30,23,53
46,8482159,Tyson Foerster,R,PHI,22,82,28,25,53
46,8475191,Reilly Smith,R,NYR,33,82,25,28,53
46,8481068,Yegor Sharangovich,C,CGY,26,82,23,30,53
46,8482113,Anton Lundell,C,FLA,23,82,22,31,53
46,8478397,Rasmus Andersson,D,CGY,28,82,14,39,53
46,8477346,MacKenzie Weegar,D,CGY,30,82,13,40,53
46,8478047,Michael Bunting,L,PIT,29,82,23,29,52
46,8476882,Teuvo Teravainen,L,CHI,30,82,23,29,52
46,8482109,Alexis Lafrenière,L,NYR,23,82,22,30,52
46,8476292,Ondrej Palat,L,NJD,33,82,17,35,52
46,8478856,Conor Garland,R,VAN,28,82,17,35,52
46,8478038,Devon Toews,D,COL,30,82,15,37,52
46,8477495,Seth Jones,D,CHI,30,82,9,43,52
46,8478472,Mathieu Joseph,R,STL,27,82,20,31,51
46,8480798,Philipp Kurashev,C,CHI,25,82,15,36,51
46,8471698,T.J. Oshie,R,WSH,38,82,31,19,50
46,8475793,Ryan Johansen,C,PHI,32,82,25,25,50
46,8479365,Trent Frederic,C,BOS,26,82,24,26,50
46,8480068,Ryan Poehling,C,PHI,25,82,21,29,50
46,8475794,Tyler Seguin,C,DAL,32,82,20,30,50
46,8482699,Dylan Guenther,R,UTA,21,82,20,30,50
46,8480185,Eetu Luostarinen,C,FLA,26,82,20,30,50
46,8477494,Jonathan Drouin,L,COL,29,82,18,32,50
46,8482175,JJ Peterka,R,BUF,22,82,21,28,49
46,8476880,Tom Wilson,R,WSH,30,82,20,29,49
46,8475218,Mattias Ekholm,D,EDM,34,82,15,34,49
46,8476399,Blake Coleman,C,CGY,33,82,25,23,48
46,8482667,William Eklund,L,SJS,22,82,20,28,48
46,8484144,Connor Bedard,C,CHI,19,82,20,28,48
46,8475763,Kevin Hayes,R,PIT,32,82,17,31,48
46,8480078,Filip Chytil,C,NYR,25,82,13,35,48
46,8476869,Brady Skjei,D,NSH,30,82,9,39,48
46,8476872,Scott Laughton,C,PHI,30,82,27,20,47
46,8477407,Anthony Duclair,L,NYI,29,82,24,23,47
46,8476458,Ryan Strome,C,ANA,31,82,21,26,47
46,8477998,Warren Foegele,L,LAK,28,82,18,29,47
46,8475745,Charlie Coyle,C,BOS,32,82,16,31,47
46,8481618,Alex Newhook,C,MTL,23,82,25,21,46
46,8480064,Josh Norris,C,OTT,25,82,24,22,46
46,8481582,Nicholas Robertson,L,TOR,23,82,23,23,46
46,8476438,Brandon Saad,L,STL,32,82,19,27,46
46,8474102,David Perron,L,OTT,36,82,17,29,46
46,8480817,K'Andre Miller,D,NYR,24,82,16,30,46
46,8476906,Shayne Gostisbehere,D,CAR,31,82,13,33,46
46,8475764,Cam Fowler,D,ANA,33,82,3,43,46
46,8473422,Nick Foligno,L,CHI,37,82,22,23,45
46,8481535,Nils Hoglander,L,VAN,24,82,22,23,45
46,8477456,J.T. Compher,L,DET,29,82,18,27,45
46,8473986,Alex Killorn,L,ANA,35,82,16,29,45
46,8480009,Eeli Tolvanen,R,SEA,25,82,16,29,45
46,8478462,Nicolas Roy,C,VGK,27,82,15,30,45
46,8474565,Alex Pietrangelo,D,VGK,34,82,11,34,45
46,8471724,Kris Letang,D,PIT,37,82,6,39,45
46,8483515,Juraj Slafkovsky,L,MTL,20,82,24,20,44
46,8474149,Evgenii Dadonov,R,DAL,35,82,22,22,44
46,8476792,Torey Krug,D,STL,33,82,9,35,44
46,8480113,Alex Iafallo,L,WPG,31,82,22,21,43
46,8475714,Calle Jarnkrok,C,TOR,33,82,21,22,43
46,8476479,Phillip Danault,C,LAK,31,82,20,23,43
46,8480829,Jesperi Kotkaniemi,C,CAR,24,82,19,24,43
46,8477947,Sonny Milano,L,WSH,28,82,19,24,43
46,8478458,Jack Roslovic,C,CAR,27,82,18,25,43
46,8477426,Nicholas Paul,L,TBL,29,82,16,27,43
46,8478891,Mason Appleton,C,WPG,28,82,14,29,43
46,8478911,Matt Roy,D,WSH,29,82,10,33,43
46,8476462,Dougie Hamilton,D,NJD,31,82,8,35,43
46,8475151,Kyle Palmieri,C,NYI,33,82,27,15,42
46,8477952,Robby Fabbri,C,ANA,28,82,23,19,42
46,8476461,Sean Couturier,C,PHI,32,82,17,25,42
46,8482720,Matthew Knies,L,TOR,22,82,14,28,42
46,8476419,Jean-Gabriel Pageau,C,NYI,32,82,13,29,42
46,8476329,Travis Boyd,C,MIN,31,82,13,29,42
46,8481581,Thomas Harley,D,DAL,23,82,12,30,42
46,8480434,Sean Durzi,D,UTA,26,82,10,32,42
46,8479410,Mikhail Sergachev,D,UTA,26,82,8,34,42
46,8478046,Danton Heinen,L,VAN,29,82,25,16,41
46,8477935,Sam Bennett,C,FLA,28,82,23,18,41
46,8479525,Ross Colton,C,COL,28,82,21,20,41
46,8479987,Morgan Geekie,C,BOS,26,82,21,20,41
46,8477498,Darnell Nurse,D,EDM,29,82,18,23,41
46,8477511,Anthony Mantha,R,CGY,30,82,18,23,41
46,8475314,Anders Lee,L,NYI,34,82,17,24,41
46,8479992,Michael Rasmussen,C,DET,25,82,16,25,41
46,8478115,Pierre Engvall,L,NYI,28,82,16,25,41
46,8478233,Andrew Mangiapane,L,WSH,28,82,15,26,41
46,8476826,Yanni Gourde,C,SEA,33,82,14,27,41
46,8475753,Justin Faulk,D,STL,32,82,12,29,41
46,8481546,Cam York,D,PHI,23,82,11,30,41
46,8482055,Drew O'Connor,L,PIT,26,82,21,19,40
46,8477987,Ryan Donato,C,CHI,28,82,18,22,40
46,8475760,Nick Bjugstad,C,UTA,32,82,18,22,40
46,8475722,Jason Zucker,L,BUF,32,82,17,23,40
46,8475149,Marcus Johansson,L,MIN,34,82,16,24,40
46,8474189,Lars Eller,C,PIT,35,82,16,24,40
46,8482660,Kent Johnson,C,CBJ,22,82,14,26,40
46,8480028,Morgan Frost,C,PHI,25,82,13,27,40
46,8476885,Jacob Trouba,D,NYR,30,82,12,28,40
46,8474716,Jared Spurgeon,D,MIN,35,82,11,29,40
46,8477969,Marcus Pettersson,D,PIT,28,82,6,34,40
46,8476958,Jaccob Slavin,D,CAR,30,82,0,40,40
46,8475848,Brendan Gallagher,R,MTL,32,82,21,18,39
46,8479996,Cody Glass,C,NSH,25,82,20,19,39
46,8481554,Kaapo Kakko,R,NYR,23,82,20,19,39
46,8478519,Anthony Cirelli,C,TBL,27,82,17,22,39
46,8481624,Ilya Mikheyev,R,CHI,30,82,17,22,39
46,8477451,Ryan Hartman,R,MIN,30,82,16,23,39
46,8477986,Brandon Montour,D,SEA,30,82,11,28,39
46,8477444,Andre Burakovsky,L,SEA,29,82,11,28,39
46,8480871,Adam Boqvist,D,FLA,24,82,7,32,39
46,8478055,Gustav Forsling,D,FLA,28,82,5,34,39
46,8480873,Rasmus Sandin,D,WSH,24,82,3,36,39
46,8482475,Yegor Chinakhov,R,CBJ,23,82,25,13,38
46,8482740,Wyatt Johnston,C,DAL,21,82,19,19,38
46,8475791,Taylor Hall,L,CHI,33,82,17,21,38
46,8476927,Teddy Blueger,C,VAN,30,82,17,21,38
46,8477989,Christian Dvorak,C,MTL,28,82,16,22,38
46,8482684,Luke Hughes,D,NJD,21,82,15,23,38
46,8477953,Kasperi Kapanen,R,STL,28,82,14,24,38
46,8474053,Logan Couture,C,SJS,35,82,13,25,38
46,8477948,Travis Sanheim,D,PHI,28,82,11,27,38
46,8475200,Dmitry Orlov,D,CAR,33,82,11,27,38
46,8482111,Justin Barron,D,MTL,23,82,8,30,38
46,8478474,Lawson Crouse,L,UTA,27,82,21,16,37
46,8481604,Pavel Dorofeyev,L,VGK,24,82,21,16,37
46,8477429,Andrew Copp,C,DET,30,82,13,24,37
46,8473563,Nicklas Backstrom,C,WSH,37,82,12,25,37
46,8476925,Colton Sissons,C,NSH,31,82,12,25,37
46,8478133,Jake Evans,C,MTL,28,82,11,26,37
46,8480893,Kirill Marchenko,R,CBJ,24,82,26,10,36
46,8478463,Anthony Beauvillier,L,PIT,27,82,17,19,36
46,8475768,Jaden Schwartz,C,SEA,32,82,17,19,36
46,8482092,Ridly Greig,C,OTT,22,82,15,21,36
46,8480806,Isac Lundestrom,C,ANA,25,82,14,22,36
46,8476960,Andreas Athanasiou,C,CHI,30,82,13,23,36
46,8480043,Timothy Liljegren,D,TOR,25,82,7,29,36
46,8481013,Jonatan Berggren,R,DET,24,82,16,19,35
46,8481186,Logan O'Connor,R,COL,28,82,14,21,35
46,8479591,Michael Eyssimont,C,TBL,28,82,14,21,35
46,8475220,Marcus Foligno,L,MIN,33,82,13,22,35
46,8482105,Jake Sanderson,D,OTT,22,82,11,24,35
46,8482671,Owen Power,D,BUF,22,82,8,27,35
46,8482142,Jamie Drysdale,D,PHI,22,82,8,27,35
46,8481606,Jordan Spence,D,LAK,23,82,7,28,35
46,8476474,Stefan Noesen,R,NJD,31,82,22,12,34
46,8475799,Nino Niederreiter,R,WPG,32,82,19,15,34
46,8476469,Joel Armia,R,MTL,31,82,19,15,34
46,8480813,Joe Veleno,C,DET,24,82,19,15,34
46,8480748,Kiefer Sherwood,L,VAN,29,82,18,16,34
46,8482062,Cole Smith,L,NSH,29,82,18,16,34
46,8478413,Jordan Greenway,L,BUF,27,82,15,19,34
46,8481596,Shane Pinto,C,OTT,24,82,14,20,34
46,8481704,Juuso Parssinen,C,NSH,23,82,14,20,34
46,8481711,Matias Maccelli,L,UTA,24,82,13,21,34
46,8470621,Corey Perry,R,EDM,39,82,13,21,34
46,8473533,Jordan Staal,C,CAR,36,82,11,23,34
46,8480220,Noah Cates,L,PHI,25,82,6,28,34
46,8476854,Hampus Lindholm,D,BOS,30,82,4,30,34
46,8482146,Luke Evangelista,R,NSH,22,82,23,10,33
46,8480835,Jack Drury,C,CAR,24,82,22,11,33
46,8482089,Jake Neighbours,L,STL,22,82,20,13,33
46,8478057,Dakota Joshua,C,VAN,28,82,19,14,33
46,8477425,Miles Wood,L,COL,29,82,18,15,33
46,8481560,Arthur Kaliyev,R,LAK,23,82,16,17,33
46,8481553,Bobby Brink,R,PHI,23,82,13,20,33
46,8479351,Sam Steel,C,DAL,26,82,13,20,33
46,8482624,Daniil Miromanov,D,CGY,27,82,12,21,33
46,8480145,Neal Pionk,D,WPG,29,82,8,25,33
46,8476892,Colton Parayko,D,STL,31,82,6,27,33
46,8482125,Alexander Holtz,R,VGK,22,82,20,12,32
46,8482074,Connor Zary,C,CGY,23,82,15,17,32
46,8476889,Radek Faksa,C,STL,30,82,11,21,32
46,8477450,Jason Dickinson,C,CHI,29,82,9,23,32
46,8476979,Erik Gustafsson,D,DET,32,82,4,28,32
46,8477015,Connor Brown,R,EDM,30,82,14,17,31
46,8476897,Oskar Sundqvist,C,STL,30,82,13,18,31
46,8476921,Jordan Martinook,L,CAR,32,82,12,19,31
46,8480878,Nils Lundkvist,D,DAL,24,82,11,20,31
46,8475287,Erik Haula,L,NJD,33,82,9,22,31
46,8478507,John Marino,D,UTA,27,82,7,24,31
46,8482655,J.J. Moser,D,TBL,24,82,3,28,31
46,8476879,Cody Ceci,D,EDM,31,82,2,29,31
46,8474673,TJ Brodie,D,CHI,34,82,2,29,31
46,8479393,Noah Gregor,C,OTT,26,82,20,10,30
46,8476278,Colin Blackwell,C,DAL,31,82,19,11,30
46,8478508,Yakov Trenin,C,MIN,27,82,19,11,30
46,8476981,Josh Anderson,R,MTL,30,82,18,12,30
46,8482079,Marco Rossi,C,MIN,23,82,17,13,30
46,8476374,Sean Kuraly,C,CBJ,31,82,15,15,30
46,8478109,Victor Olofsson,L,VGK,29,82,14,16,30
46,8481601,Simon Holmstrom,R,NYI,23,82,14,16,30
46,8476918,Jimmy Vesey,L,NYR,31,82,13,17,30
46,8480849,Barrett Hayton,C,UTA,24,82,12,18,30
46,8475193,Tomas Tatar,L,NJD,34,82,10,20,30
46,8475855,Jesper Fast,R,CAR,33,82,10,20,30
46,8476392,Adam Lowry,C,WPG,31,82,8,22,30
46,8477488,Brett Pesce,D,NJD,30,82,8,22,30
46,8475171,Oliver Ekman-Larsson,D,TOR,33,82,7,23,30
46,8480336,Sean Walker,D,CAR,30,82,7,23,30
46,8475181,Nick Leddy,D,STL,33,82,7,23,30
46,8476442,Matt Nieto,L,PIT,32,82,15,14,29
46,8480802,Ryan McLeod,C,BUF,25,82,13,16,29
46,8479390,Taylor Raddysh,R,WSH,26,82,13,16,29
46,8482133,Thomas Bordeleau,C,SJS,22,82,12,17,29
46,8478020,Michael Amadio,C,OTT,28,82,12,17,29
46,8480807,Mattias Samuelsson,D,BUF,24,82,10,19,29
46,8476457,Adam Larsson,D,SEA,32,82,8,21,29
46,8474151,Ryan McDonagh,D,TBL,35,82,8,21,29
46,8477508,Curtis Lazar,C,NJD,29,82,7,22,29
46,8474563,Drew Doughty,D,LAK,35,82,6,23,29
46,8476923,Damon Severson,D,CBJ,30,82,5,24,29
46,8475188,Brayden McNabb,D,VGK,33,82,4,25,29
46,8476931,Jake McCabe,D,TOR,31,82,3,26,29
46,8474715,Cam Atkinson,R,TBL,35,82,16,12,28
46,8480448,Parker Kelly,L,COL,25,82,15,13,28
46,8479414,Nathan Bastian,R,NJD,27,82,14,14,28
46,8484145,Zach Benson,L,BUF,19,82,13,15,28
46,8479293,Brandon Tanev,L,SEA,33,82,13,15,28
46,8480074,Alexandre Texier,C,STL,25,82,11,17,28
46,8482117,Lukas Reichel,L,CHI,22,82,10,18,28
46,8476917,Adam Pelech,D,NYI,30,82,6,22,28
46,8478500,Ivan Provorov,D,CBJ,27,82,5,23,28
46,8479369,Andrew Peeke,D,BOS,26,82,4,24,28
46,8475233,David Savard,D,MTL,34,82,2,26,28
46,8482077,Dylan Holloway,L,EDM,23,82,20,7,27
46,8478569,Noel Acciari,C,PIT,33,82,16,11,27
46,8477931,Tomas Nosek,L,FLA,32,82,13,14,27
46,8482705,Cole Sillinger,C,CBJ,21,82,12,15,27
46,8480144,David Kampf,C,TOR,29,82,12,15,27
46,8481580,Connor McMichael,C,WSH,23,82,11,16,27
46,8480789,Oliver Wahlstrom,R,NYI,24,82,11,16,27
46,8477903,Garnet Hathaway,R,PHI,33,82,11,16,27
46,8481093,Rafael Harvey-Pinard,L,MTL,25,82,10,17,27
46,8477499,Rasmus Ristolainen,D,PHI,30,82,8,19,27
46,8473507,Jeff Petry,D,DET,37,82,8,19,27
46,8477220,Nate Schmidt,D,FLA,33,82,6,21,27
46,8484203,Bradly Nadeau,L,CAR,19,82,5,22,27
46,8482166,Shakir Mukhamadullin,D,SJS,22,82,5,22,27
46,8479998,Mikey Anderson,D,LAK,25,82,5,22,27
46,8483482,Tristan Luneau,D,ANA,20,82,3,24,27
46,8478840,Will Borgen,D,SEA,28,82,1,26,27
46,8479316,Luke Kunin,C,SJS,27,82,12,14,26
46,8480459,Pius Suter,C,VAN,28,82,11,15,26
46,8473453,Trevor Lewis,C,LAK,37,82,11,15,26
46,8475231,Casey Cizikas,C,NYI,33,82,11,15,26
46,8479353,Brett Howden,C,VGK,26,82,10,16,26
46,8481522,Peyton Krebs,C,BUF,23,82,10,16,26
46,8484166,Adam Fantilli,C,CBJ,20,82,9,17,26
46,8475343,Nic Dowd,C,WSH,34,82,9,17,26
46,8476480,Vladislav Namestnikov,C,WPG,32,82,8,18,26
46,8481481,Blake Lizotte,C,PIT,27,82,8,18,26
46,8476463,Jonas Brodin,D,MIN,31,82,6,20,26
46,8477506,Ryan Pulock,D,NYI,30,82,6,20,26
46,8481656,Aliaksei Protas,C,WSH,23,82,5,21,26
46,8480222,Sebastian Aho,D,PIT,28,82,4,22,26
46,8477505,Alexander Wennberg,C,SJS,30,82,16,9,25
46,8480980,Connor Dewar,C,TOR,25,82,13,12,25
46,8476624,Barclay Goodrow,C,SJS,31,82,11,14,25
46,8478434,Keegan Kolesar,R,VGK,27,82,9,16,25
46,8474574,Tyler Myers,D,VAN,34,82,6,19,25
46,8481014,Alexander Romanov,D,NYI,24,82,6,19,25
46,8480860,Kevin Bahl,D,CGY,24,82,4,21,25
46,8476902,Esa Lindell,D,DAL,30,82,2,23,25
46,8480281,Alexey Toropchenko,R,STL,25,82,17,7,24
46,8482259,Bobby McMann,C,TOR,28,82,13,11,24
46,8479661,Tanner Jeannot,L,LAK,27,82,12,12,24
46,8480021,Jack Studnicka,C,LAK,25,82,10,14,24
46,8479368,Max Jones,L,BOS,26,82,9,15,24
46,8481477,Nico Sturm,C,SJS,29,82,9,15,24
46,8483499,Liam Ohgren,L,MIN,20,82,8,16,24
46,8482749,Joshua Roy,R,MTL,21,82,8,16,24
46,8478211,Dryden Hunt,L,CGY,29,82,6,18,24
46,8480073,Erik Brannstrom,D,COL,25,82,6,18,24
46,8479402,Jake Bean,D,CGY,26,82,4,20,24
46,8476525,Colin Miller,D,WPG,32,82,3,21,24
46,8478882,Vladislav Gavrikov,D,LAK,29,82,3,21,24
46,8479941,Justin Danforth,R,CBJ,31,82,11,12,23
46,8480003,Jesper Boqvist,C,FLA,26,82,11,12,23
46,8477392,Hudson Fasching,R,NYI,29,82,11,12,23
46,8484153,Leo Carlsson,C,ANA,20,82,11,12,23
46,8478432,Christian Fischer,R,DET,27,82,10,13,23
46,8476873,Mark Jankowski,C,NSH,30,82,9,14,23
46,8483457,Lane Hutson,D,MTL,20,82,9,14,23
46,8483524,Shane Wright,C,SEA,20,82,9,14,23
46,8477839,Conor Sheary,L,TBL,32,82,8,15,23
46,8482762,Simon Edvinsson,D,DET,21,82,8,15,23
46,8479442,Troy Stecher,D,EDM,30,82,6,17,23
46,8480246,Nick Perbix,D,TBL,26,82,5,18,23
46,8482122,Brock Faber,D,MIN,22,82,2,21,23
46,8476331,Dylan DeMelo,D,WPG,31,82,2,21,23
46,8481178,Egor Zamula,D,PHI,24,82,2,21,23
46,8482245,Artem Zub,D,OTT,29,82,1,22,23
46,8477919,Frederick Gaudreau,C,MIN,31,82,13,9,22
46,8476858,Phillip Di Giuseppe,L,VAN,31,82,11,11,22
46,8477507,Nikita Zadorov,D,BOS,29,82,8,14,22
46,8484149,Gavin Brindley,C,CBJ,20,82,8,14,22
46,8483445,Cutter Gauthier,L,ANA,20,82,7,15,22
46,8476891,Matt Grzelcyk,D,PIT,30,82,4,18,22
46,8478859,Niko Mikkola,D,FLA,28,82,4,18,22
46,8482087,Kaiden Guhle,D,MTL,22,82,3,19,22
46,8480035,Henri Jokiharju,D,BUF,25,82,2,20,22
46,8482141,Lukas Cormier,D,VGK,22,82,12,9,21
46,8481032,Paul Cotter,C,NJD,25,82,11,10,21
46,8478013,Jake Walman,D,SJS,28,82,7,14,21
46,8482807,Ethan Del Mastro,D,CHI,21,82,6,15,21
46,8481517,Brett Leason,R,ANA,25,82,6,15,21
46,8479976,Juuso Valimaki,D,UTA,26,82,5,16,21
46,8481567,Henry Thrun,D,SJS,23,82,5,16,21
46,8478468,Jeremy Lauzon,D,NSH,27,82,4,17,21
46,8476967,Brett Kulak,D,EDM,30,82,4,17,21
46,8476429,Scott Mayfield,D,NYI,32,82,3,18,21
46,8483468,Jiri Kulich,C,BUF,20,82,8,12,20
46,8477353,Tyler Motte,C,DET,29,82,8,12,20
46,8481524,Bowen Byram,D,BUF,23,82,7,13,20
46,8474013,Ian Cole,D,UTA,35,82,6,14,20
46,8481708,Zac Jones,D,NYR,24,82,5,15,20
46,8483490,Pavel Mintyukov,D,ANA,21,82,4,16,20
46,8482712,Oskar Olausson,R,COL,22,82,4,16,20
46,8477435,Ryan Graves,D,PIT,29,82,3,17,20
46,8479371,Dante Fabbro,D,NSH,26,82,3,17,20
46,8483493,Frank Nazar,C,CHI,20,82,12,7,19
46,8480995,Pontus Holmberg,R,TOR,25,82,11,8,19
46,8482713,Mackie Samoskevich,R,FLA,22,82,9,10,19
46,8476441,Joel Edmundson,D,LAK,31,82,8,11,19
46,8477369,Carson Soucy,D,VAN,30,82,7,12,19
46,8475279,Ben Chiarot,D,DET,33,82,7,12,19
46,8479980,Nicolas Hague,D,VGK,26,82,6,13,19
46,8475324,Nick Jensen,D,OTT,34,82,6,13,19
46,8482666,Scott Morrow,D,CAR,22,82,6,13,19
46,8482118,Sam Colangelo,R,ANA,23,82,6,13,19
46,8481605,Jackson LaCombe,D,ANA,23,82,6,13,19
46,8476422,Mike Reilly,D,NYI,31,82,5,14,19
46,8482809,Jackson Blake,R,CAR,21,82,5,14,19
46,8476312,Josh Manson,D,COL,33,82,4,15,19
46,8481568,Alex Vlasic,D,CHI,23,82,4,15,19
46,8478136,Jake Middleton,D,MIN,28,82,3,16,19
46,8480834,Ty Emberson,D,SJS,24,82,3,16,19
46,8478851,Alexandre Carrier,D,NSH,28,82,2,17,19
46,8481028,Martin Pospisil,C,CGY,25,82,10,8,18
46,8482803,Olen Zellweger,D,ANA,21,82,9,9,18
46,8482470,Ilya Solovyov,D,CGY,24,82,8,10,18
46,8477406,Mattias Janmark,C,EDM,32,82,7,11,18
46,8483565,Nick Blankenburg,D,NSH,26,82,3,15,18
46,8480049,Dylan Samberg,D,WPG,25,82,1,17,18
46,8478399,Jonas Siegenthaler,D,NJD,27,82,1,17,18
46,8475455,Brenden Dillon,D,NJD,34,82,1,17,18
46,8476372,Nick Seeler,D,PHI,31,82,1,17,18
46,8479398,Samuel Girard,D,COL,26,82,0,18,18
46,8480855,Jack McBain,C,UTA,24,82,13,4,17
46,8476878,Zemgus Girgensons,L,TBL,30,82,10,7,17
46,8482145,Mavrik Bourque,C,DAL,22,82,9,8,17
46,8479291,Kevin Rooney,C,CGY,31,82,7,10,17
46,8477335,Kyle Burroughs,D,LAK,29,82,6,11,17
46,8479983,Mario Ferraro,D,SJS,26,82,6,11,17
46,8483763,Maksymilian Szuber,D,UTA,22,82,5,12,17
46,8477034,Jaycob Megna,D,FLA,32,82,4,13,17
46,8475462,Radko Gudas,D,ANA,34,82,4,13,17
46,8478443,Brandon Carlo,D,BOS,28,82,3,14,17
46,8471677,Jack Johnson,D,CBJ,37,82,3,14,17
46,8475790,Erik Gudbranson,D,CBJ,32,82,2,15,17
46,8482155,Alex Laferriere,R,LAK,23,82,9,7,16
46,8482733,Logan Mailloux,D,MTL,31,82,5,11,16
46,8477938,Haydn Fleury,D,WPG,28,82,5,11,16
46,8483471,Brad Lambert,C,WPG,31,82,5,11,16
46,8483431,Logan Cooley,C,UTA,20,82,4,12,16
46,8478178,Darren Raddysh,D,TBL,28,82,4,12,16
46,8478416,Erik Cernak,D,TBL,27,82,4,12,16
46,8482073,Braden Schneider,D,NYR,23,82,3,13,16
46,8475718,Justin Holl,D,DET,32,82,3,13,16
46,8480879,Jacob Bernard-Docker,D,OTT,24,82,2,14,16
46,8483397,Marc McLaughlin,C,BOS,25,82,10,5,15
46,8479359,Beck Malenstyn,L,BUF,26,82,9,6,15
46,8475842,Sam Carrick,C,NYR,32,82,7,8,15
46,8481641,Joel Kiviranta,L,COL,28,82,7,8,15
46,8482101,Danil Gushchin,L,SJS,22,82,6,9,15
46,8476467,Jamie Oleksiak,D,SEA,32,82,5,10,15
46,8479324,Ryan Lindgren,D,NYR,26,82,4,11,15
46,8480990,Declan Chisholm,D,MIN,24,82,4,11,15
46,8477845,Trevor van Riemsdyk,D,WSH,33,82,2,13,15
46,8477365,Connor Clifton,D,BUF,29,82,2,13,15
46,8478450,Parker Wotherspoon,D,BOS,27,82,2,13,15
46,8470600,Ryan Suter,D,STL,39,82,1,14,15
46,8475690,Chris Tanev,D,TOR,35,82,0,15,15
46,8482679,Matt Coronato,R,CGY,22,82,8,6,14
46,8476822,Luke Glendening,C,TBL,35,82,8,6,14
46,8480796,Martin Fehervary,D,WSH,25,82,6,8,14
46,8483495,Simon Nemec,D,NJD,20,82,5,9,14
46,8483460,David Jiricek,D,CBJ,21,82,5,9,14
46,8475762,Derek Forbort,D,VAN,32,82,3,11,14
46,8480950,Ilya Lyubushkin,D,DAL,30,82,3,11,14
46,8478874,Adam Gaudette,C,OTT,28,82,1,13,14
46,8483505,Matthew Poitras,C,BOS,20,82,7,6,13
46,8482659,Josh Doan,R,UTA,22,82,6,7,13
46,8483012,Logan Morrison,C,SEA,22,82,6,7,13
46,8482702,Logan Stankoven,C,DAL,21,82,5,8,13
46,8482858,Ryker Evans,D,SEA,23,82,4,9,13
46,8482153,Brendan Brisson,C,VGK,23,82,4,9,13
46,8482787,Nikita Chibrikov,R,WPG,31,82,4,9,13
46,8483489,Fraser Minten,C,TOR,31,82,4,9,13
46,8476473,Connor Murphy,D,CHI,31,82,2,11,13
46,8480172,Jan Rutta,D,SJS,34,82,1,12,13
46,8474090,Brendan Smith,D,DAL,35,82,1,12,13
46,8481122,Simon Benoit,D,TOR,26,82,4,8,12
46,8484911,Collin Graf,R,SJS,22,82,2,10,12
46,8480025,MacKenzie Entwistle,R,FLA,25,82,9,2,11
46,8481699,Aku Raty,R,UTA,23,82,6,5,11
46,8482070,Mitchell Chaffee,R,TBL,26,82,4,7,11
46,8479576,Vincent Desharnais,D,VAN,28,82,4,7,11
46,8483466,Kevin Korchinski,D,CHI,20,82,2,9,11
46,8475177,Calvin de Haan,D,COL,33,82,2,9,11
46,8483567,Georgii Merkulov,C,BOS,24,82,3,7,10
46,8480870,Bo Groulx,C,NYR,24,82,5,4,9
46,8474612,Travis Hamonic,D,OTT,34,82,2,7,9
46,8482516,Matthew Kessel,D,STL,24,82,3,5,8
46,8482859,Zack Ostapchuk,C,OTT,21,82,1,7,8
46,8479638,Justin Brazeau,R,BOS,26,82,4,3,7
46,8474567,Zach Bogosian,D,MIN,34,82,0,7,7
46,8474062,Riley Nash,C,NYR,35,82,0,6,6
46,8470794,Joe Pavelski,C,,40,0,0,0,0
46,8481703,Valtteri Puustinen,R,PIT,25,0,0,0,0
46,8477950,Tony DeAngelo,D,,29,0,0,0,0
46,8481577,Philip Tomasino,C,NSH,23,0,0,0,0
46,8475197,Tyson Barrie,D,,33,0,0,0,0
46,8471218,Blake Wheeler,R,,38,0,0,0,0
46,8474157,Max Pacioretty,L,,36,0,0,0,0
46,8478466,Daniel Sprong,R,VAN,27,0,0,0,0
46,8475744,Evgeny Kuznetsov,C,,32,0,0,0,0
46,8481019,David Gustafsson,C,WPG,24,0,0,0,0
46,8475906,John Klingberg,D,,32,0,0,0,0
46,8479348,Kale Clague,D,BUF,26,0,0,0,0
46,8476952,Dominic Toninato,C,WPG,30,0,0,0,0
46,8473473,Milan Lucic,L,,36,0,0,0,0
46,8474037,James van Riemsdyk,L,,35,0,0,0,0
46,8474602,Justin Schultz,D,,34,0,0,0,0
46,8482222,Alexander Barabanov,L,,30,0,0,0,0
46,8479372,Josh Mahura,D,SEA,26,0,0,0,0
46,8479982,Conor Timmins,D,TOR,26,0,0,0,0
46,8474031,Kevin Shattenkirk,D,,35,0,0,0,0
46,8480008,Adam Ruzicka,C,,25,0,0,0,0
46,8481059,Scott Perunovich,D,STL,26,0,0,0,0
46,8480884,Calen Addison,D,,24,0,0,0,0
46,8476994,Vinnie Hinostroza,C,NSH,30,0,0,0,0
46,8478452,Caleb Jones,D,LAK,27,0,0,0,0
46,8480157,Calle Rosen,D,COL,30,0,0,0,0
46,8481609,Vladislav Kolyachonok,D,UTA,23,0,0,0,0
46,8479415,Michael McLeod,C,,26,0,0,0,0
46,8476919,Chris Tierney,C,,30,0,0,0,0
46,8479639,Dylan Coghlan,D,WPG,26,0,0,0,0
46,8478146,Matthew Highmore,C,OTT,28,0,0,0,0
46,8478970,Jalen Chatfield,D,CAR,28,0,0,0,0
46,8480205,Emil Bemstrom,C,PIT,25,0,0,0,0
46,8474884,Mike Hoffman,C,,35,0,0,0,0
46,8471274,Alex Goligoski,D,,39,0,0,0,0
46,8478104,Sammy Blais,L,,28,0,0,0,0
46,8474870,Tyler Johnson,C,,34,0,0,0,0
46,8476913,Devin Shore,C,MIN,30,0,0,0,0
46,8481598,Philip Broberg,D,EDM,23,0,0,0,0
46,8480058,Pierre-Olivier Joseph,D,STL,25,0,0,0,0
46,8480891,Michael Kesselring,D,UTA,24,0,0,0,0
46,8477979,Nicolas Aube-Kubel,R,BUF,28,0,0,0,0
46,8476871,Tanner Pearson,L,,32,0,0,0,0
46,8476393,Nick Cousins,C,,31,0,0,0,0
46,8479977,Kailer Yamamoto,R,,26,0,0,0,0
46,8479543,Michael Pezzetta,L,MTL,26,0,0,0,0
46,8477018,Ben Hutton,D,VGK,31,0,0,0,0
46,8480762,Eric Robinson,L,CAR,29,0,0,0,0
46,8474034,Pat Maroon,L,CHI,36,0,0,0,0
46,8481058,Jesse Ylönen,R,,25,0,0,0,0
46,8475179,Dmitry Kulikov,D,FLA,34,0,0,0,0
46,8481527,Kaedan Korczak,D,VGK,23,0,0,0,0
46,8473449,Kyle Okposo,R,,36,0,0,0,0
46,8482192,Isaak Phillips,D,CHI,23,0,0,0,0
46,8480727,Zach Whitecloud,D,VGK,28,0,0,0,0
46,8479346,Dillon Dube,C,,26,0,0,0,0
46,8480821,Filip Zadina,R,,25,0,0,0,0
46,8480001,Urho Vaakanainen,D,ANA,25,0,0,0,0
46,8470966,Mark Giordano,D,,41,0,0,0,0
46,8480853,Liam Foudy,C,,24,0,0,0,0
46,8475225,Craig Smith,C,CHI,35,0,0,0,0
46,8479972,Mason Shaw,C,WPG,26,0,0,0,0
46,8478451,Ethan Bear,D,WSH,27,0,0,0,0
46,8474040,Sam Gagner,C,,35,0,0,0,0
46,8480196,Jacob Bryson,D,BUF,27,0,0,0,0
46,8479984,Cal Foote,D,,26,0,0,0,0
46,8480011,Klim Kostin,C,SJS,25,0,0,0,0
46,8482176,Wyatt Kaiser,D,CHI,22,0,0,0,0
46,8476988,Matt Benning,D,SJS,30,0,0,0,0
46,8479370,Tyson Jost,C,CAR,26,0,0,0,0
46,8477464,Nic Petan,C,,29,0,0,0,0
46,8477380,Jonny Brodzinski,C,NYR,31,0,0,0,0
46,8480070,Ian Mitchell,D,BOS,25,0,0,0,0
46,8479315,Joey Anderson,R,CHI,26,0,0,0,0
46,8478099,Kevin Labanc,R,,29,0,0,0,0
46,8476874,Olli Maatta,D,DET,30,0,0,0,0
46,8475208,Brian Dumoulin,D,ANA,33,0,0,0,0
46,8478430,Oliver Kylington,D,,27,0,0,0,0
46,8479536,Axel Jonsson-Fjallby,L,WPG,26,0,0,0,0
46,8479671,Mathieu Olivier,R,CBJ,27,0,0,0,0
46,8471709,Marc-Edouard Vlasic,D,SJS,37,0,0,0,0
46,8479328,Julien Gauthier,R,NYI,27,0,0,0,0
46,8478421,A.J. Greer,L,FLA,28,0,0,0,0
46,8477573,Nathan Walker,L,STL,30,0,0,0,0
46,8481537,Nikita Okhotiuk,D,CGY,24,0,0,0,0
46,8474166,Alec Martinez,D,CHI,37,0,0,0,0
46,8470610,Zach Parise,L,,40,0,0,0,0
46,8477478,William Carrier,L,CAR,30,0,0,0,0
46,8479344,Jesse Puljujarvi,R,PIT,26,0,0,0,0
46,8480887,Jordan Harris,D,MTL,24,0,0,0,0
46,8478502,Dennis Gilbert,D,BUF,28,0,0,0,0
46,8482730,Brandt Clarke,D,LAK,21,0,0,0,0
46,8480355,Mark Kastelic,C,BOS,25,0,0,0,0
46,8475750,Jon Merrill,D,MIN,32,0,0,0,0
46,8475164,Jakob Silfverberg,R,,34,0,0,0,0
46,8477944,Jakub Vrana,L,,28,0,0,0,0
46,8479439,Jacob MacDonald,D,COL,31,0,0,0,0
46,8474568,Luke Schenn,D,NSH,35,0,0,0,0
46,8478454,Noah Juulsen,D,VAN,27,0,0,0,0
46,8475752,Tyler Pitlick,C,,33,0,0,0,0
46,8482148,Hendrix Lapierre,C,WSH,22,0,0,0,0
46,8481167,Brayden Pachal,D,CGY,25,0,0,0,0
46,8478043,Sam Lafferty,C,BUF,29,0,0,0,0
46,8479321,Lucas Johansen,D,,27,0,0,0,0
46,8471699,Andrew Cogliano,C,,37,0,0,0,0
46,8481521,Ronnie Attard,D,PHI,25,0,0,0,0
46,8481161,Jake Christiansen,D,CBJ,25,0,0,0,0
46,8479458,Nikita Zaitsev,D,,33,0,0,0,0
46,8479619,Michael Carcone,L,UTA,28,0,0,0,0
46,8479026,Philippe Myers,D,TOR,27,0,0,0,0
46,8477330,Dominik Kubalik,L,,29,0,0,0,0
46,8481617,Vasily Podkolzin,R,VAN,23,0,0,0,0
46,8481701,Santeri Hatakka,D,NJD,23,0,0,0,0
46,8479514,Rem Pitlick,C,,27,0,0,0,0
46,8477446,Michael McCarron,R,NSH,29,0,0,0,0
46,8470604,Jeff Carter,C,,39,0,0,0,0
46,8482241,Radim Zohorna,L,,28,0,0,0,0
46,8480289,Morgan Barron,C,WPG,26,0,0,0,0
46,8479379,Givani Smith,R,SJS,26,0,0,0,0
46,8480216,Jacob Peterson,C,,25,0,0,0,0
46,8477851,Jordan Oesterle,D,BOS,32,0,0,0,0
46,8484258,Sam Malinski,D,COL,26,0,0,0,0
46,8478904,Steven Lorentz,C,,28,0,0,0,0
46,8482095,Tyler Kleven,D,OTT,22,0,0,0,0
46,8480848,Ty Dellandrea,C,SJS,24,0,0,0,0
46,8476884,Derrick Pouliot,D,,30,0,0,0,0
46,8479336,Carl Grundstrom,R,SJS,27,0,0,0,0
46,8482964,Arber Xhekaj,D,MTL,23,0,0,0,0
46,8471686,Marc Staal,D,,37,0,0,0,0
46,8477887,Patrick Brown,C,BOS,32,0,0,0,0
46,8478495,Denis Gurianov,R,,27,0,0,0,0
46,8473504,Cal Clutterbuck,R,,37,0,0,0,0
46,8481550,Adam Beckman,L,NJD,23,0,0,0,0
46,8480845,Rasmus Kupari,C,WPG,24,0,0,0,0
46,8474009,Nick Bonino,C,,36,0,0,0,0
46,8478585,Derek Ryan,C,EDM,38,0,0,0,0
46,8477962,Brendan Lemieux,L,CAR,28,0,0,0,0
46,8482861,Vincent Iorio,D,WSH,22,0,0,0,0
46,8479378,Logan Stanley,D,WPG,26,0,0,0,0
46,8473446,Erik Johnson,D,PHI,36,0,0,0,0
46,8481743,Marc Del Gaizo,D,NSH,25,0,0,0,0
46,8477384,Josh Brown,D,EDM,30,0,0,0,0
46,8482165,Yan Kuznetsov,D,CGY,22,0,0,0,0
46,8478424,Jansen Harkins,C,ANA,27,0,0,0,0
46,8482144,Jack Thompson,D,SJS,22,0,0,0,0
46,8478512,Austin Czarnik,C,,32,0,0,0,0
46,8477527,Ross Johnston,L,ANA,30,0,0,0,0
46,8479383,Boris Katchouk,L,,26,0,0,0,0
46,8482094,Daemon Hunt,D,MIN,22,0,0,0,0
46,8481719,Maxwell Crozier,D,TBL,24,0,0,0,0
46,8480192,Johnathan Kovacevic,D,NJD,27,0,0,0,0
46,8479376,Victor Mete,D,,26,0,0,0,0
46,8482511,Mason Lohrei,D,BOS,23,0,0,0,0
46,8475825,Jani Hakanpää,D,,32,0,0,0,0
46,8478021,William Lagesson,D,DET,28,0,0,0,0
46,8475795,Dylan McIlrath,D,WSH,32,0,0,0,0
46,8477846,Ryan Carpenter,C,,33,0,0,0,0
46,8481056,Spencer Stastney,D,NSH,24,0,0,0,0
46,8481564,Ryan Johnson,D,BUF,23,0,0,0,0
46,8478017,Mark Friedman,D,VAN,29,0,0,0,0
46,8479320,Max Lajoie,D,SEA,27,0,0,0,0
46,8480075,Cameron Crotty,D,MIN,25,0,0,0,0
46,8484287,Cole McWard,D,VAN,23,0,0,0,0
46,8484254,Akito Hirose,D,VAN,25,0,0,0,0
46,8483407,Brandon Scanlin,D,NYR,25,0,0,0,0
46,8480274,Philip Kemp,D,EDM,25,0,0,0,0
46,8479522,Hardy Haman Aktell,D,WSH,26,0,0,0,0
46,8480007,Jonas Rondbjerg,R,VGK,25,0,0,0,0
46,8477454,Adam Erne,L,,29,0,0,0,0
46,8481679,Maxence Guenette,D,OTT,23,0,0,0,0
46,8480441,Trey Fix-Wolansky,R,CBJ,25,0,0,0,0
46,8483546,Marshall Rifai,D,TOR,26,0,0,0,0
46,8480084,Nick DeSimone,D,NJD,30,0,0,0,0
46,8481030,Jack St. Ivany,D,PIT,25,0,0,0,0
46,8481592,Jakob Pelletier,L,CGY,23,0,0,0,0
46,8478011,Louie Belpedio,D,PHI,28,0,0,0,0
46,8477930,Pierre-Edouard Bellemare,L,,39,0,0,0,0
46,8484321,Nikolas Matinpalo,D,OTT,26,0,0,0,0
46,8482067,Connor Mackey,D,NYR,28,0,0,0,0
46,8481806,Louis Crevier,D,CHI,23,0,0,0,0
46,8484326,Patrik Koch,D,UTA,28,0,0,0,0
46,8477971,Andreas Englund,D,LAK,28,0,0,0,0
46,8481751,Lukas Rousek,R,BUF,25,0,0,0,0
46,8481006,Tyler Tucker,D,STL,24,0,0,0,0
46,8476867,Brendan Gaunce,C,MIN,30,0,0,0,0
46,8479520,Brandon Duhaime,R,WSH,27,0,0,0,0
46,8477073,Kurtis MacDermid,L,NJD,30,0,0,0,0
46,8480874,Adam Ginning,D,PHI,24,0,0,0,0
46,8477473,Justin Bailey,R,SJS,29,0,0,0,0
46,8479066,Ryan Lomberg,L,CGY,30,0,0,0,0
46,8477070,Liam O'Brien,C,UTA,30,0,0,0,0
46,8474618,Marco Scandella,D,,34,0,0,0,0
46,8475797,Jarred Tinordi,D,,32,0,0,0,0
46,8481441,Joe Snively,C,DET,28,0,0,0,0
46,8477244,Chad Ruhwedel,D,NYR,34,0,0,0,0
46,8479772,Zack MacEwen,R,OTT,28,0,0,0,0
46,8481147,Reese Johnson,C,MIN,26,0,0,0,0
46,8481043,Cole Koepke,L,BOS,26,0,0,0,0
46,8483619,Filip Roos,D,OTT,25,0,0,0,0
46,8481541,Samuel Bolduc,D,NYI,24,0,0,0,0
46,8477810,Joel Hanley,D,CGY,33,0,0,0,0
46,8476907,Mackenzie MacEachern,L,,30,0,0,0,0
46,8482652,Walker Duehr,R,CGY,27,0,0,0,0
46,8477126,Jayson Megna,C,,34,0,0,0,0
46,8483398,Declan Carlile,D,TBL,31,0,0,0,0
46,8482929,Emil Lilleberg,D,TBL,23,0,0,0,0
46,8480880,Jakub Lauko,C,MIN,24,0,0,0,0
46,8480245,Olle Lycksell,R,PHI,25,0,0,0,0
46,8480252,Cole Guttman,C,CHI,25,0,0,0,0
46,8477467,Gustav Olofsson,D,SEA,30,0,0,0,0
46,8479968,Vinni Lettieri,C,BOS,29,0,0,0,0
46,8478400,Colin White,C,,27,0,0,0,0
46,8475755,Alexander Petrovic,D,DAL,32,0,0,0,0
46,8481812,Nikolai Knyzhov,D,,27,0,0,0,0
46,8481593,Jayden Struble,D,MTL,23,0,0,0,0
46,8481532,Alex Turcotte,C,LAK,23,0,0,0,0
46,8482126,Emil Andrae,D,PHI,31,0,0,0,0
46,8479944,Zach Aston-Reese,C,VGK,30,0,0,0,0
46,8471817,Ryan Reaves,R,TOR,37,0,0,0,0
46,8481206,John Ludvig,D,PIT,24,0,0,0,0
46,8481599,Victor Soderstrom,D,UTA,23,0,0,0,0
46,8480292,Carson Meyer,R,ANA,27,0,0,0,0
46,8482496,Nils Aman,C,VAN,24,0,0,0,0
46,8479718,Alex Barré-Boulet,C,MTL,27,0,0,0,0
46,8479994,Jaret Anderson-Dolan,C,WPG,25,0,0,0,0
46,8480184,Gustav Lindstrom,D,,26,0,0,0,0
46,8480890,Jan Jenik,R,OTT,24,0,0,0,0
46,8478067,Oskar Lindblom,L,,28,0,0,0,0
46,8476934,Brock McGinn,L,ANA,30,0,0,0,0
46,8479985,Cale Fleury,D,SEA,26,0,0,0,0
46,8484304,Uvis Balinskis,D,FLA,28,0,0,0,0
46,8479981,Jonah Gadjovich,L,FLA,26,0,0,0,0
46,8481716,Dmitri Voronkov,L,CBJ,24,0,0,0,0
46,8474709,Matt Martin,L,,35,0,0,0,0
46,8482634,Alex Steeves,C,TOR,25,0,0,0,0
46,8480823,Alexander Alexeyev,D,WSH,25,0,0,0,0
46,8477541,Dakota Mermis,D,TOR,30,0,0,0,0
46,8483491,Ivan Miroshnichenko,L,WSH,20,0,0,0,0
46,8478477,Mitchell Stephens,C,SEA,27,0,0,0,0
46,8481543,Nikita Alexandrov,C,STL,24,0,0,0,0
46,8479423,Alex Nylander,L,,26,0,0,0,0
46,8482451,Mikael Pyyhtia,L,CBJ,23,0,0,0,0
46,8478831,Kevin Stenlund,C,UTA,28,0,0,0,0
46,8480306,Grant Hutton,D,NYI,29,0,0,0,0
46,8478028,Fredrik Olofsson,L,,28,0,0,0,0
46,8477462,Robert Hagg,D,VGK,29,0,0,0,0
46,8477320,Anton Blidh,L,NYR,29,0,0,0,0
46,8482157,Will Cuylle,L,NYR,22,0,0,0,0
46,8482737,Zack Bolduc,C,STL,21,0,0,0,0
46,8481239,Samuel Fagemo,L,,24,0,0,0,0
46,8481600,Tobias Bjornfot,D,FLA,23,0,0,0,0
46,8478409,Anthony Richard,C,PHI,28,0,0,0,0
46,8474145,Robert Bortuzzo,D,,35,0,0,0,0
46,8475958,Michael Sgarbossa,C,WSH,32,0,0,0,0
46,8479986,Kole Lind,R,DAL,26,0,0,0,0
46,8479249,Andrew Poturalski,C,SJS,30,0,0,0,0
46,8479362,Riley Tufte,L,BOS,26,0,0,0,0
46,8479991,Jake Leschyshyn,C,NYR,25,0,0,0,0
46,8479587,Rhett Gardner,C,PHI,28,0,0,0,0
46,8482744,James Malatesta,L,CBJ,21,0,0,0,0
46,8478854,Ryan Shea,D,PIT,27,0,0,0,0
46,8481591,Sam Poulin,R,,23,0,0,0,0
46,8483512,Matt Savoie,C,EDM,20,0,0,0,0
46,8482102,Vasily Ponomarev,C,PIT,22,0,0,0,0
46,8482162,Roby Jarventie,L,EDM,22,0,0,0,0
46,8481016,Ruslan Iskhakov,C,,24,0,0,0,0
46,8482172,Landon Slaggert,L,CHI,22,0,0,0,0
46,8482747,Brennan Othmann,L,NYR,21,0,0,0,0
46,8480031,Maxime Comtois,L,,25,0,0,0,0
46,8480226,Marián Studenic,R,,26,0,0,0,0
46,8478408,Travis Dermott,D,,28,0,0,0,0
46,8481518,Nolan Foote,L,NJD,24,0,0,0,0
46,8479419,Brett Murray,L,BUF,26,0,0,0,0
46,8482088,Justin Sourdif,R,FLA,22,0,0,0,0
46,8482201,Gage Goncalves,C,TBL,23,0,0,0,0
46,8481578,Graeme Clarke,R,MIN,23,0,0,0,0
46,8482177,Marat Khusnutdinov,C,MIN,22,0,0,0,0
46,8481754,Nikita Nesterenko,C,ANA,23,0,0,0,0
46,8483531,Brian Halonen,L,NJD,25,0,0,0,0
46,8483920,Pierrick Dube,R,WSH,23,0,0,0,0
46,8480851,Akil Thomas,C,LAK,24,0,0,0,0
46,8475235,Nicolas Deslauriers,L,PHI,33,0,0,0,0
46,8482476,Emil Heineman,L,MTL,23,0,0,0,0
46,8477149,Scott Sabourin,R,SJS,32,0,0,0,0
46,8483549,Lucas Condotta,L,MTL,27,0,0,0,0
46,8482765,Isak Rosen,R,BUF,21,0,0,0,0
46,8481237,Kyle MacLean,C,NYI,25,0,0,0,0
46,8481024,Linus Karlsson,C,VAN,25,0,0,0,0
46,8481690,Tyler Angle,C,,24,0,0,0,0
46,8483570,Ben Meyers,C,SEA,26,0,0,0,0
46,8481655,Cole Schwindt,R,CGY,23,0,0,0,0
46,8481462,Mason Morelli,L,VGK,28,0,0,0,0
46,8483401,Marc Johnstone,R,PIT,28,0,0,0,0
46,8478956,Samuel Laberge,L,NJD,27,0,0,0,0
46,8479533,Joona Koppanen,L,,26,0,0,0,0
46,8482197,Adam Raska,R,MIN,23,0,0,0,0
46,8482250,Callahan Burke,C,VGK,27,0,0,0,0
46,8482784,Zach Dean,C,STL,21,0,0,0,0
46,8484255,Jason Polin,R,COL,25,0,0,0,0
46,8481077,John Leonard,L,,26,0,0,0,0
46,8481534,Raphael Lavoie,C,EDM,24,0,0,0,0
46,8483609,Adam Klapka,R,CGY,24,0,0,0,0
46,8482751,Ryan Winterton,C,SEA,21,0,0,0,0
46,8480267,Sammy Walker,C,MIN,25,0,0,0,0
46,8475766,Austin Watson,L,,32,0,0,0,0
46,8482460,Matt Rempe,C,NYR,22,0,0,0,0
46,8481065,Angus Crookshank,L,OTT,25,0,0,0,0
46,8481070,Hugh McGing,L,,26,0,0,0,0
46,8476323,Max McCormick,L,SEA,32,0,0,0,0
46,8483395,Arshdeep Bains,L,VAN,23,0,0,0,0
46,8484259,Ondrej Pavel,C,COL,31,0,0,0,0
46,8483432,Luca Del Bel Belluz,C,CBJ,31,0,0,0,0
46,8483045,Cameron Butler,R,CBJ,31,0,0,0,0
46,8482061,Brandon Biro,L,SEA,26,0,0,0,0
46,8477401,John Hayden,C,SEA,29,0,0,0,0
46,8475278,Byron Froese,C,,33,0,0,0,0
46,8478446,Glenn Gawdin,C,LAK,27,0,0,0,0
46,8477993,Justin Kirkland,C,CGY,28,0,0,0,0
46,8482147,Jean-Luc Foudy,C,COL,22,0,0,0,0
46,8480032,Shane Bowers,C,NJD,25,0,0,0,0
46,8479330,Brandon Gignac,C,MTL,27,0,0,0,0
46,8480776,Sheldon Rempal,R,,29,0,0,0,0
46,8475413,Justin Dowling,C,NJD,34,0,0,0,0
46,8481726,Adam Edstrom,C,NYR,24,0,0,0,0
46,8480844,Grigori Denisenko,L,VGK,24,0,0,0,0
46,8478147,Bokondji Imama,L,PIT,28,0,0,0,0
46,8478881,Brett Seney,L,CHI,28,0,0,0,0
46,8483630,Pavol Regenda,L,ANA,25,0,0,0,0
46,8480836,Jonathan Gruden,C,,24,0,0,0,0
46,8484314,Jiri Smejkal,L,,28,0,0,0,0
46,8475780,Chris Wagner,R,COL,33,0,0,0,0
46,8479546,Oskar Steen,C,,26,0,0,0,0
46,8483597,Milos Kelemen,L,UTA,25,0,0,0,0
46,8481789,Tye Kartye,L,SEA,23,0,0,0,0
46,8484325,Waltteri Merela,C,TBL,26,0,0,0,0
46,8479421,Jacob Moverare,D,LAK,26,0,0,0,0
46,8481585,Egor Afanasyev,L,SJS,23,0,0,0,0
46,8479547,Matthew Phillips,R,,26,0,0,0,0
46,8479367,William Lockwood,R,FLA,26,0,0,0,0
46,8476915,Jujhar Khaira,L,,30,0,0,0,0
46,8481422,Jacob Lucchini,C,NSH,29,0,0,0,0
46,8480468,James Hamblin,L,EDM,25,0,0,0,0
46,8478051,Max Willman,C,NJD,29,0,0,0,0
46,8481556,John Beecher,C,BOS,23,0,0,0,0
46,8478078,Rourke Chartier,C,,28,0,0,0,0
47,8477492,Nathan MacKinnon,C,COL,29,82,61,95,156
47,8476453,Nikita Kucherov,R,TBL,31,82,50,102,152
47,8478402,Connor McDavid,C,EDM,27,82,46,101,147
47,8479318,Auston Matthews,C,TOR,27,82,57,67,124
47,8481559,Jack Hughes,C,NJD,23,82,52,66,118
47,8479314,Matthew Tkachuk,L,FLA,27,82,38,77,115
47,8478550,Artemi Panarin,L,NYR,33,82,36,79,115
47,8477956,David Pastrnak,R,BOS,28,82,52,61,113
47,8477933,Sam Reinhart,C,FLA,29,82,51,56,107
47,8480012,Elias Pettersson,C,VAN,26,82,44,63,107
47,8478420,Mikko Rantanen,R,COL,28,82,47,58,105
47,8476468,J.T. Miller,C,VAN,31,82,40,65,105
47,8477946,Dylan Larkin,C,DET,28,82,47,56,103
47,8480800,Quinn Hughes,D,VAN,25,82,16,87,103
47,8480801,Brady Tkachuk,L,OTT,25,82,46,55,101
47,8477942,Kevin Fiala,L,LAK,28,82,46,54,100
47,8477404,Jake Guentzel,C,TBL,30,82,41,59,100
47,8476346,Johnny Gaudreau,L,CBJ,31,82,25,75,100
47,8477939,William Nylander,R,TOR,28,82,38,60,98
47,8480069,Cale Makar,D,COL,26,82,26,72,98
47,8477934,Leon Draisaitl,C,EDM,29,82,41,56,97
47,8478010,Brayden Point,C,TBL,28,82,50,46,96
47,8478439,Travis Konecny,R,PHI,27,82,35,61,96
47,8479420,Tage Thompson,C,BUF,27,82,56,38,94
47,8478427,Sebastian Aho,C,CAR,27,82,39,55,94
47,8474564,Steven Stamkos,C,NSH,34,82,40,53,93
47,8475172,Nazem Kadri,C,CGY,34,82,33,60,93
47,8476887,Filip Forsberg,L,NSH,30,82,44,48,92
47,8478864,Kirill Kaprizov,L,MIN,27,82,41,51,92
47,8480027,Jason Robertson,L,DAL,25,82,31,61,92
47,8471675,Sidney Crosby,C,PIT,37,82,43,48,91
47,8477409,Carter Verhaeghe,C,FLA,29,82,37,54,91
47,8475913,Mark Stone,R,VGK,32,82,29,62,91
47,8477493,Aleksander Barkov,C,FLA,29,82,36,54,90
47,8480023,Robert Thomas,C,STL,25,82,24,66,90
47,8476460,Mark Scheifele,C,WPG,31,82,40,49,89
47,8479385,Jordan Kyrou,C,STL,26,82,33,56,89
47,8475166,John Tavares,C,TOR,34,82,29,59,88
47,8479323,Adam Fox,D,NYR,26,82,19,66,85
47,8479343,Clayton Keller,R,UTA,26,82,33,51,84
47,8478445,Mathew Barzal,C,NYI,27,82,16,68,84
47,8480002,Nico Hischier,C,NJD,25,82,42,41,83
47,8478449,Roope Hintz,C,DAL,28,82,37,46,83
47,8477940,Nikolaj Ehlers,L,WPG,28,82,37,44,81
47,8481523,Kirby Dach,C,MTL,23,82,20,61,81
47,8475167,Victor Hedman,D,TBL,34,82,20,60,80
47,8480830,Andrei Svechnikov,R,CAR,24,82,32,47,79
47,8477501,Valeri Nichushkin,R,COL,29,82,34,44,78
47,8480018,Nick Suzuki,C,MTL,25,82,34,44,78
47,8479337,Alex DeBrincat,R,DET,27,82,33,45,78
47,8482116,Tim Stützle,C,OTT,22,82,28,50,78
47,8475692,Mats Zuccarello,R,MIN,37,82,24,54,78
47,8476459,Mika Zibanejad,C,NYR,31,82,23,55,78
47,8480039,Martin Necas,C,CAR,25,82,32,45,77
47,8476389,Vincent Trocheck,C,NYR,31,82,27,50,77
47,8477949,Alex Tuch,R,BUF,28,82,17,60,77
47,8478398,Kyle Connor,L,WPG,28,82,30,46,76
47,8474600,Roman Josi,D,NSH,34,82,14,62,76
47,8478414,Timo Meier,R,NJD,28,82,38,37,75
47,8476881,Tomas Hertl,C,VGK,31,82,35,40,75
47,8479407,Jesper Bratt,L,NJD,26,82,26,49,75
47,8476454,Ryan Nugent-Hopkins,C,EDM,31,82,20,54,74
47,8480036,Miro Heiskanen,D,DAL,25,82,16,58,74
47,8474141,Patrick Kane,R,DET,36,82,26,47,73
47,8475798,Mikael Granlund,C,SJS,32,82,19,54,73
47,8481068,Yegor Sharangovich,C,CGY,26,82,40,31,71
47,8475786,Zach Hyman,L,EDM,32,82,39,32,71
47,8482078,Lucas Raymond,L,DET,22,82,28,43,71
47,8476456,Jonathan Huberdeau,C,CGY,31,82,16,55,71
47,8473419,Brad Marchand,L,BOS,36,82,30,40,70
47,8479542,Brandon Hagel,L,TBL,26,82,37,32,69
47,8478403,Jack Eichel,C,VGK,28,82,35,34,69
47,8482093,Seth Jarvis,C,CAR,22,82,33,36,69
47,8480803,Evan Bouchard,D,EDM,25,82,16,53,69
47,8475184,Chris Kreider,L,NYR,33,82,42,26,68
47,8471685,Anze Kopitar,C,LAK,37,82,29,39,68
47,8476882,Teuvo Teravainen,L,CHI,30,82,29,39,68
47,8475810,Bryan Rust,R,PIT,32,82,28,40,68
47,8475168,Matt Duchene,C,DAL,33,82,23,45,68
47,8477935,Sam Bennett,C,FLA,28,82,34,33,67
47,8471215,Evgeni Malkin,C,PIT,38,82,33,34,67
47,8476448,William Karlsson,C,VGK,31,82,32,35,67
47,8473512,Claude Giroux,R,OTT,36,82,25,42,67
47,8480839,Rasmus Dahlin,D,BUF,24,82,20,47,67
47,8478397,Rasmus Andersson,D,CGY,28,82,8,59,67
47,8481557,Matt Boldy,L,MIN,23,82,32,34,66
47,8478444,Brock Boeser,R,VAN,27,82,28,38,66
47,8475765,Vladimir Tarasenko,R,DET,33,82,26,40,66
47,8478042,Viktor Arvidsson,R,EDM,31,82,25,41,66
47,8474586,Jordan Eberle,R,SEA,34,82,22,44,66
47,8475754,Brock Nelson,C,NYI,33,82,22,44,66
47,8476462,Dougie Hamilton,D,NJD,31,82,20,46,66
47,8477447,Shea Theodore,D,VGK,29,82,7,59,66
47,8480188,Fabian Zetterlund,L,SJS,25,82,24,41,65
47,8479339,Patrik Laine,L,CBJ,26,82,29,35,64
47,8477951,Nick Schmaltz,C,UTA,28,82,20,44,64
47,8476792,Torey Krug,D,STL,33,82,18,46,64
47,8478460,Zach Werenski,D,CBJ,27,82,16,48,64
47,8475158,Ryan O'Reilly,C,NSH,33,82,27,36,63
47,8478407,Vince Dunn,D,SEA,28,82,18,45,63
47,8477503,Max Domi,C,TOR,29,82,17,46,63
47,8476875,Mike Matheson,D,MTL,30,82,10,53,63
47,8474679,Gustav Nyquist,C,NSH,35,82,27,35,62
47,8474150,Mikael Backlund,C,CGY,35,82,25,37,62
47,8482097,Jack Quinn,R,BUF,23,82,24,38,62
47,8478047,Michael Bunting,L,PIT,29,82,22,40,62
47,8481711,Matias Maccelli,L,UTA,24,82,21,41,62
47,8476905,Chandler Stephenson,C,SEA,30,82,20,42,62
47,8473994,Jamie Benn,L,DAL,35,82,19,43,62
47,8474578,Erik Karlsson,D,PIT,34,82,11,51,62
47,8475726,Tyler Toffoli,C,SJS,32,82,29,32,61
47,8477497,Sean Monahan,C,CBJ,30,82,25,36,61
47,8482667,William Eklund,L,SJS,22,82,25,36,61
47,8477407,Anthony Duclair,L,NYI,29,82,25,36,61
47,8482665,Matty Beniers,C,SEA,22,82,20,41,61
47,8477500,Bo Horvat,C,NYI,29,82,33,27,60
47,8475784,Jeff Skinner,C,EDM,32,82,31,29,60
47,8478975,Mason Marchment,L,DAL,29,82,24,36,60
47,8481542,Moritz Seider,D,DET,23,82,11,49,60
47,8480865,Noah Dobson,D,NYI,24,82,10,50,60
47,8475794,Tyler Seguin,C,DAL,32,82,38,21,59
47,8475170,Brayden Schenn,C,STL,33,82,24,35,59
47,8477960,Adrian Kempe,R,LAK,28,82,24,35,59
47,8481540,Cole Caufield,R,MTL,23,82,23,36,59
47,8479325,Charlie McAvoy,D,BOS,27,82,17,42,59
47,8479999,Casey Mittelstadt,C,COL,26,82,25,33,58
47,8477402,Pavel Buchnevich,L,STL,29,82,24,34,58
47,8477504,Josh Morrissey,D,WPG,29,82,14,44,58
47,8477986,Brandon Montour,D,SEA,30,82,12,46,58
47,8476853,Morgan Rielly,D,TOR,30,82,10,48,58
47,8477955,Jared McCann,L,SEA,28,82,37,20,57
47,8482109,Alexis Lafrenière,L,NYR,23,82,34,23,57
47,8476539,Jonathan Marchessault,R,NSH,34,82,30,27,57
47,8475169,Evander Kane,L,EDM,33,82,30,27,57
47,8479675,Trevor Moore,L,LAK,29,82,29,28,57
47,8478493,Joel Eriksson Ek,C,MIN,27,82,26,31,57
47,8478401,Pavel Zacha,C,BOS,27,82,24,33,57
47,8478873,Troy Terry,R,ANA,27,82,21,36,57
47,8477429,Andrew Copp,C,DET,30,82,21,36,57
47,8474565,Alex Pietrangelo,D,VGK,34,82,16,41,57
47,8480028,Morgan Frost,C,PHI,25,82,14,43,57
47,8482113,Anton Lundell,C,FLA,23,82,33,23,56
47,8476826,Yanni Gourde,C,SEA,33,82,21,35,56
47,8478856,Conor Garland,R,VAN,28,82,19,37,56
47,8480829,Jesperi Kotkaniemi,C,CAR,24,82,18,38,56
47,8478438,Tommy Novak,C,NSH,27,82,14,42,56
47,8477494,Jonathan Drouin,L,COL,29,82,16,39,55
47,8474563,Drew Doughty,D,LAK,35,82,13,42,55
47,8478396,Noah Hanifin,D,VGK,27,82,8,47,55
47,8475764,Cam Fowler,D,ANA,33,82,8,47,55
47,8477495,Seth Jones,D,CHI,30,82,15,39,54
47,8478038,Devon Toews,D,COL,30,82,12,42,54
47,8480015,Owen Tippett,R,PHI,25,82,29,24,53
47,8473986,Alex Killorn,L,ANA,35,82,28,25,53
47,8476419,Jean-Gabriel Pageau,C,NYI,32,82,26,27,53
47,8477476,Artturi Lehkonen,L,COL,29,82,25,28,53
47,8482684,Luke Hughes,D,NJD,21,82,10,43,53
47,8476399,Blake Coleman,C,CGY,33,82,27,25,52
47,8474641,Adam Henrique,C,EDM,34,82,25,27,52
47,8478462,Nicolas Roy,C,VGK,27,82,25,27,52
47,8480064,Josh Norris,C,OTT,25,82,24,28,52
47,8474102,David Perron,L,OTT,36,82,24,28,52
47,8477416,Oliver Bjorkstrand,R,SEA,29,82,20,32,52
47,8480797,Joel Farabee,L,PHI,24,82,18,34,52
47,8470613,Brent Burns,D,CAR,39,82,18,34,52
47,8476461,Sean Couturier,C,PHI,32,82,17,35,52
47,8471724,Kris Letang,D,PIT,37,82,12,40,52
47,8477932,Aaron Ekblad,D,FLA,28,82,10,42,52
47,8481581,Thomas Harley,D,DAL,23,82,10,42,52
47,8482124,Quinton Byfield,R,LAK,22,82,20,31,51
47,8477479,Tyler Bertuzzi,L,CHI,29,82,20,31,51
47,8481533,Trevor Zegras,C,ANA,23,82,19,32,51
47,8477496,Elias Lindholm,C,BOS,30,82,19,32,51
47,8479425,Filip Hronek,D,VAN,27,82,11,40,51
47,8476880,Tom Wilson,R,WSH,30,82,29,21,50
47,8476483,Rickard Rakell,R,PIT,31,82,23,27,50
47,8478519,Anthony Cirelli,C,TBL,27,82,23,27,50
47,8482159,Tyson Foerster,R,PHI,22,82,22,28,50
47,8482092,Ridly Greig,C,OTT,22,82,22,28,50
47,8471698,T.J. Oshie,R,WSH,38,82,21,29,50
47,8478469,Thomas Chabot,D,OTT,27,82,20,30,50
47,8479992,Michael Rasmussen,C,DET,25,82,18,32,50
47,8482740,Wyatt Johnston,C,DAL,21,82,25,24,49
47,8482475,Yegor Chinakhov,R,CBJ,23,82,22,27,49
47,8482705,Cole Sillinger,C,CBJ,21,82,22,27,49
47,8479400,Pierre-Luc Dubois,L,WSH,26,82,19,30,49
47,8480208,Drake Batherson,R,OTT,26,82,18,31,49
47,8476869,Brady Skjei,D,NSH,30,82,13,36,49
47,8475745,Charlie Coyle,C,BOS,32,82,11,38,49
47,8478055,Gustav Forsling,D,FLA,28,82,9,40,49
47,8476906,Shayne Gostisbehere,D,CAR,31,82,7,42,49
47,8471214,Alex Ovechkin,L,WSH,39,82,31,17,48
47,8475793,Ryan Johansen,C,PHI,32,82,28,20,48
47,8483808,Andrei Kuzmenko,L,CGY,28,82,24,24,48
47,8477456,J.T. Compher,L,DET,29,82,20,28,48
47,8475763,Kevin Hayes,R,PIT,32,82,19,29,48
47,8481528,Dylan Cozens,C,BUF,23,82,17,31,48
47,8480014,Gabriel Vilardi,C,WPG,25,82,24,23,47
47,8475722,Jason Zucker,L,BUF,32,82,23,24,47
47,8479987,Morgan Geekie,C,BOS,26,82,22,25,47
47,8479345,Jakob Chychrun,D,WSH,26,82,16,31,47
47,8481596,Shane Pinto,C,OTT,24,82,14,33,47
47,8479996,Cody Glass,C,NSH,25,82,12,35,47
47,8478366,Frank Vatrano,R,ANA,30,82,23,23,46
47,8478440,Dylan Strome,C,WSH,27,82,16,30,46
47,8477451,Ryan Hartman,R,MIN,30,82,14,32,46
47,8479410,Mikhail Sergachev,D,UTA,26,82,9,37,46
47,8477948,Travis Sanheim,D,PHI,28,82,9,37,46
47,8475768,Jaden Schwartz,C,SEA,32,82,25,20,45
47,8484144,Connor Bedard,C,CHI,19,82,23,22,45
47,8480078,Filip Chytil,C,NYR,25,82,21,24,45
47,8475191,Reilly Smith,R,NYR,33,82,20,25,45
47,8480220,Noah Cates,L,PHI,25,82,19,26,45
47,8475791,Taylor Hall,L,CHI,33,82,16,29,45
47,8476927,Teddy Blueger,C,VAN,30,82,16,29,45
47,8474590,John Carlson,D,WSH,34,82,12,33,45
47,8480009,Eeli Tolvanen,R,SEA,25,82,26,18,44
47,8483515,Juraj Slafkovsky,L,MTL,20,82,26,18,44
47,8480459,Pius Suter,C,VAN,28,82,21,23,44
47,8478115,Pierre Engvall,L,NYI,28,82,20,24,44
47,8478020,Michael Amadio,C,OTT,28,82,18,26,44
47,8477964,Ivan Barbashev,C,VGK,29,82,17,27,44
47,8474149,Evgenii Dadonov,R,DAL,35,82,17,27,44
47,8477444,Andre Burakovsky,L,SEA,29,82,15,29,44
47,8475287,Erik Haula,L,NJD,33,82,14,30,44
47,8476292,Ondrej Palat,L,NJD,33,82,12,32,44
47,8476479,Phillip Danault,C,LAK,31,82,10,34,44
47,8477952,Robby Fabbri,C,ANA,28,82,22,21,43
47,8482079,Marco Rossi,C,MIN,23,82,22,21,43
47,8475151,Kyle Palmieri,C,NYI,33,82,21,22,43
47,8478498,Jake DeBrusk,L,VAN,28,82,19,24,43
47,8482149,Cole Perfetti,C,WPG,22,82,18,25,43
47,8481553,Bobby Brink,R,PHI,23,82,17,26,43
47,8480871,Adam Boqvist,D,FLA,24,82,15,28,43
47,8478458,Jack Roslovic,C,CAR,27,82,10,33,43
47,8476958,Jaccob Slavin,D,CAR,30,82,9,34,43
47,8476854,Hampus Lindholm,D,BOS,30,82,9,34,43
47,8476432,Boone Jenner,C,CBJ,31,82,30,12,42
47,8482175,JJ Peterka,R,BUF,22,82,26,16,42
47,8475314,Anders Lee,L,NYI,34,82,25,17,42
47,8475799,Nino Niederreiter,R,WPG,32,82,23,19,42
47,8482745,Mason McTavish,C,ANA,21,82,22,20,42
47,8481582,Nicholas Robertson,L,TOR,23,82,20,22,42
47,8480798,Philipp Kurashev,C,CHI,25,82,13,29,42
47,8475218,Mattias Ekholm,D,EDM,34,82,9,33,42
47,8480893,Kirill Marchenko,R,CBJ,24,82,25,16,41
47,8479365,Trent Frederic,C,BOS,26,82,21,20,41
47,8478046,Danton Heinen,L,VAN,29,82,21,20,41
47,8478542,Evan Rodrigues,C,FLA,31,82,17,24,41
47,8478233,Andrew Mangiapane,L,WSH,28,82,17,24,41
47,8482133,Thomas Bordeleau,C,SJS,22,82,16,25,41
47,8477953,Kasperi Kapanen,R,STL,28,82,15,26,41
47,8474053,Logan Couture,C,SJS,35,82,15,26,41
47,8477947,Sonny Milano,L,WSH,28,82,13,28,41
47,8480434,Sean Durzi,D,UTA,26,82,11,30,41
47,8482089,Jake Neighbours,L,STL,22,82,27,13,40
47,8479525,Ross Colton,C,COL,28,82,23,17,40
47,8477426,Nicholas Paul,L,TBL,29,82,20,20,40
47,8477021,Alex Kerfoot,C,UTA,30,82,18,22,40
47,8477998,Warren Foegele,L,LAK,28,82,17,23,40
47,8477346,MacKenzie Weegar,D,CGY,30,82,11,29,40
47,8476438,Brandon Saad,L,STL,32,82,24,15,39
47,8482699,Dylan Guenther,R,UTA,21,82,20,19,39
47,8481624,Ilya Mikheyev,R,CHI,30,82,18,21,39
47,8480185,Eetu Luostarinen,C,FLA,26,82,17,22,39
47,8473422,Nick Foligno,L,CHI,37,82,17,22,39
47,8481013,Jonatan Berggren,R,DET,24,82,17,22,39
47,8475171,Oliver Ekman-Larsson,D,TOR,33,82,12,27,39
47,8475753,Justin Faulk,D,STL,32,82,11,28,39
47,8481535,Nils Hoglander,L,VAN,24,82,24,14,38
47,8482055,Drew O'Connor,L,PIT,26,82,19,19,38
47,8480113,Alex Iafallo,L,WPG,31,82,18,20,38
47,8482720,Matthew Knies,L,TOR,22,82,18,20,38
47,8482146,Luke Evangelista,R,NSH,22,82,18,20,38
47,8480835,Jack Drury,C,CAR,24,82,12,26,38
47,8477506,Ryan Pulock,D,NYI,30,82,4,34,38
47,8482259,Bobby McMann,C,TOR,28,82,25,12,37
47,8476921,Jordan Martinook,L,CAR,32,82,20,17,37
47,8480068,Ryan Poehling,C,PHI,25,82,17,20,37
47,8476392,Adam Lowry,C,WPG,31,82,15,22,37
47,8474189,Lars Eller,C,PIT,35,82,13,24,37
47,8482105,Jake Sanderson,D,OTT,22,82,8,29,37
47,8476458,Ryan Strome,C,ANA,31,82,7,30,37
47,8480073,Erik Brannstrom,D,COL,25,82,5,32,37
47,8477903,Garnet Hathaway,R,PHI,33,82,19,17,36
47,8482660,Kent Johnson,C,CBJ,22,82,15,21,36
47,8473533,Jordan Staal,C,CAR,36,82,14,22,36
47,8476312,Josh Manson,D,COL,33,82,14,22,36
47,8480336,Sean Walker,D,CAR,30,82,12,24,36
47,8478413,Jordan Greenway,L,BUF,27,82,10,26,36
47,8480043,Timothy Liljegren,D,TOR,25,82,6,30,36
47,8480817,K'Andre Miller,D,NYR,24,82,5,31,36
47,8478474,Lawson Crouse,L,UTA,27,82,18,17,35
47,8476474,Stefan Noesen,R,NJD,31,82,18,17,35
47,8481604,Pavel Dorofeyev,L,VGK,24,82,16,19,35
47,8477498,Darnell Nurse,D,EDM,29,82,14,21,35
47,8481186,Logan O'Connor,R,COL,28,82,14,21,35
47,8476480,Vladislav Namestnikov,C,WPG,32,82,14,21,35
47,8478472,Mathieu Joseph,R,STL,27,82,9,26,35
47,8475149,Marcus Johansson,L,MIN,34,82,8,27,35
47,8478882,Vladislav Gavrikov,D,LAK,29,82,8,27,35
47,8479398,Samuel Girard,D,COL,26,82,5,30,35
47,8478013,Jake Walman,D,SJS,28,82,19,15,34
47,8480849,Barrett Hayton,C,UTA,24,82,18,16,34
47,8482110,Dawson Mercer,C,NJD,23,82,17,17,34
47,8475714,Calle Jarnkrok,C,TOR,33,82,16,18,34
47,8473563,Nicklas Backstrom,C,WSH,37,82,16,18,34
47,8476278,Colin Blackwell,C,DAL,31,82,16,18,34
47,8479351,Sam Steel,C,DAL,26,82,15,19,34
47,8476960,Andreas Athanasiou,C,CHI,30,82,13,21,34
47,8480003,Jesper Boqvist,C,FLA,26,82,13,21,34
47,8476329,Travis Boyd,C,MIN,31,82,11,23,34
47,8476902,Esa Lindell,D,DAL,30,82,9,25,34
47,8476923,Damon Severson,D,CBJ,30,82,6,28,34
47,8475790,Erik Gudbranson,D,CBJ,32,82,3,31,34
47,8479293,Brandon Tanev,L,SEA,33,82,16,17,33
47,8481560,Arthur Kaliyev,R,LAK,23,82,15,18,33
47,8478463,Anthony Beauvillier,L,PIT,27,82,12,21,33
47,8478891,Mason Appleton,C,WPG,28,82,11,22,33
47,8477987,Ryan Donato,C,CHI,28,82,11,22,33
47,8479661,Tanner Jeannot,L,LAK,27,82,11,22,33
47,8478500,Ivan Provorov,D,CBJ,27,82,5,28,33
47,8478109,Victor Olofsson,L,VGK,29,82,22,10,32
47,8478057,Dakota Joshua,C,VAN,28,82,20,12,32
47,8479368,Max Jones,L,BOS,26,82,19,13,32
47,8479941,Justin Danforth,R,CBJ,31,82,19,13,32
47,8481618,Alex Newhook,C,MTL,23,82,15,17,32
47,8480074,Alexandre Texier,C,STL,25,82,15,17,32
47,8470621,Corey Perry,R,EDM,39,82,14,18,32
47,8476873,Mark Jankowski,C,NSH,30,82,14,18,32
47,8480802,Ryan McLeod,C,BUF,25,82,13,19,32
47,8475193,Tomas Tatar,L,NJD,34,82,9,23,32
47,8482655,J.J. Moser,D,TBL,24,82,4,28,32
47,8477425,Miles Wood,L,COL,29,82,20,11,31
47,8483431,Logan Cooley,C,UTA,20,82,18,13,31
47,8476981,Josh Anderson,R,MTL,30,82,16,15,31
47,8481580,Connor McMichael,C,WSH,23,82,15,16,31
47,8476897,Oskar Sundqvist,C,STL,30,82,14,17,31
47,8481517,Brett Leason,R,ANA,25,82,14,17,31
47,8482125,Alexander Holtz,R,VGK,22,82,12,19,31
47,8477353,Tyler Motte,C,DET,29,82,11,20,31
47,8482142,Jamie Drysdale,D,PHI,22,82,10,21,31
47,8476463,Jonas Brodin,D,MIN,31,82,9,22,31
47,8476872,Scott Laughton,C,PHI,30,82,7,24,31
47,8479402,Jake Bean,D,CGY,26,82,6,25,31
47,8476892,Colton Parayko,D,STL,31,82,3,28,31
47,8481704,Juuso Parssinen,C,NSH,23,82,15,15,30
47,8477015,Connor Brown,R,EDM,30,82,15,15,30
47,8482624,Daniil Miromanov,D,CGY,27,82,14,16,30
47,8480748,Kiefer Sherwood,L,VAN,29,82,12,18,30
47,8476467,Jamie Oleksiak,D,SEA,32,82,9,21,30
47,8483457,Lane Hutson,D,MTL,20,82,7,23,30
47,8476917,Adam Pelech,D,NYI,30,82,5,25,30
47,8480049,Dylan Samberg,D,WPG,25,82,5,25,30
47,8482671,Owen Power,D,BUF,22,82,4,26,30
47,8480035,Henri Jokiharju,D,BUF,25,82,4,26,30
47,8481568,Alex Vlasic,D,CHI,23,82,4,26,30
47,8476918,Jimmy Vesey,L,NYR,31,82,19,10,29
47,8476469,Joel Armia,R,MTL,31,82,12,17,29
47,8482166,Shakir Mukhamadullin,D,SJS,22,82,10,19,29
47,8481546,Cam York,D,PHI,23,82,7,22,29
47,8476885,Jacob Trouba,D,NYR,30,82,7,22,29
47,8479371,Dante Fabbro,D,NSH,26,82,7,22,29
47,8481606,Jordan Spence,D,LAK,23,82,5,24,29
47,8476457,Adam Larsson,D,SEA,32,82,5,24,29
47,8475188,Brayden McNabb,D,VGK,33,82,5,24,29
47,8481708,Zac Jones,D,NYR,24,82,5,24,29
47,8480807,Mattias Samuelsson,D,BUF,24,82,4,25,29
47,8475231,Casey Cizikas,C,NYI,33,82,16,12,28
47,8479591,Michael Eyssimont,C,TBL,28,82,15,13,28
47,8481032,Paul Cotter,C,NJD,25,82,15,13,28
47,8481522,Peyton Krebs,C,BUF,23,82,13,15,28
47,8482679,Matt Coronato,R,CGY,22,82,12,16,28
47,8477919,Frederick Gaudreau,C,MIN,31,82,11,17,28
47,8477508,Curtis Lazar,C,NJD,29,82,10,18,28
47,8479980,Nicolas Hague,D,VGK,26,82,7,21,28
47,8478911,Matt Roy,D,WSH,29,82,6,22,28
47,8481656,Aliaksei Protas,C,WSH,23,82,4,24,28
47,8475324,Nick Jensen,D,OTT,34,82,4,24,28
47,8474151,Ryan McDonagh,D,TBL,35,82,2,26,28
47,8479393,Noah Gregor,C,OTT,26,82,17,10,27
47,8480995,Pontus Holmberg,R,TOR,25,82,16,11,27
47,8480855,Jack McBain,C,UTA,24,82,15,12,27
47,8476878,Zemgus Girgensons,L,TBL,30,82,15,12,27
47,8477989,Christian Dvorak,C,MTL,28,82,12,15,27
47,8482074,Connor Zary,C,CGY,23,82,12,15,27
47,8478508,Yakov Trenin,C,MIN,27,82,12,15,27
47,8481477,Nico Sturm,C,SJS,29,82,11,16,27
47,8480806,Isac Lundestrom,C,ANA,25,82,9,18,27
47,8484166,Adam Fantilli,C,CBJ,20,82,9,18,27
47,8477450,Jason Dickinson,C,CHI,29,82,8,19,27
47,8474715,Cam Atkinson,R,TBL,35,82,8,19,27
47,8481028,Martin Pospisil,C,CGY,25,82,8,19,27
47,8477499,Rasmus Ristolainen,D,PHI,30,82,7,20,27
47,8480246,Nick Perbix,D,TBL,26,82,7,20,27
47,8476979,Erik Gustafsson,D,DET,32,82,6,21,27
47,8480145,Neal Pionk,D,WPG,29,82,4,23,27
47,8478569,Noel Acciari,C,PIT,33,82,14,12,26
47,8477511,Anthony Mantha,R,CGY,30,82,13,13,26
47,8484153,Leo Carlsson,C,ANA,20,82,13,13,26
47,8484203,Bradly Nadeau,L,CAR,19,82,12,14,26
47,8478432,Christian Fischer,R,DET,27,82,12,14,26
47,8479353,Brett Howden,C,VGK,26,82,10,16,26
47,8480980,Connor Dewar,C,TOR,25,82,10,16,26
47,8481567,Henry Thrun,D,SJS,23,82,10,16,26
47,8477969,Marcus Pettersson,D,PIT,28,82,9,17,26
47,8482141,Lukas Cormier,D,VGK,22,82,9,17,26
47,8475455,Brenden Dillon,D,NJD,34,82,7,19,26
47,8475200,Dmitry Orlov,D,CAR,33,82,6,20,26
47,8476925,Colton Sissons,C,NSH,31,82,6,20,26
47,8473507,Jeff Petry,D,DET,37,82,6,20,26
47,8476879,Cody Ceci,D,EDM,31,82,5,21,26
47,8482245,Artem Zub,D,OTT,29,82,5,21,26
47,8478416,Erik Cernak,D,TBL,27,82,5,21,26
47,8480860,Kevin Bahl,D,CGY,24,82,2,24,26
47,8478178,Darren Raddysh,D,TBL,28,82,2,24,26
47,8481093,Rafael Harvey-Pinard,L,MTL,25,82,15,10,25
47,8477931,Tomas Nosek,L,FLA,32,82,12,13,25
47,8479390,Taylor Raddysh,R,WSH,26,82,11,14,25
47,8481699,Aku Raty,R,UTA,23,82,11,14,25
47,8481481,Blake Lizotte,C,PIT,27,82,10,15,25
47,8481554,Kaapo Kakko,R,NYR,23,82,8,17,25
47,8478133,Jake Evans,C,MTL,28,82,8,17,25
47,8475233,David Savard,D,MTL,34,82,6,19,25
47,8479983,Mario Ferraro,D,SJS,26,82,5,20,25
47,8474574,Tyler Myers,D,VAN,34,82,4,21,25
47,8476525,Colin Miller,D,WPG,32,82,4,21,25
47,8476931,Jake McCabe,D,TOR,31,82,3,22,25
47,8477365,Connor Clifton,D,BUF,29,82,3,22,25
47,8476331,Dylan DeMelo,D,WPG,31,82,1,24,25
47,8484145,Zach Benson,L,BUF,19,82,18,6,24
47,8482117,Lukas Reichel,L,CHI,22,82,16,8,24
47,8475855,Jesper Fast,R,CAR,33,82,14,10,24
47,8478434,Keegan Kolesar,R,VGK,27,82,12,12,24
47,8482666,Scott Morrow,D,CAR,22,82,11,13,24
47,8475842,Sam Carrick,C,NYR,32,82,11,13,24
47,8476889,Radek Faksa,C,STL,30,82,10,14,24
47,8480144,David Kampf,C,TOR,29,82,10,14,24
47,8475848,Brendan Gallagher,R,MTL,32,82,9,15,24
47,8477839,Conor Sheary,L,TBL,32,82,7,17,24
47,8480878,Nils Lundkvist,D,DAL,24,82,4,20,24
47,8478507,John Marino,D,UTA,27,82,4,20,24
47,8479369,Andrew Peeke,D,BOS,26,82,2,22,24
47,8475760,Nick Bjugstad,C,UTA,32,82,12,11,23
47,8476374,Sean Kuraly,C,CBJ,31,82,12,11,23
47,8479414,Nathan Bastian,R,NJD,27,82,10,13,23
47,8482702,Logan Stankoven,C,DAL,21,82,10,13,23
47,8483468,Jiri Kulich,C,BUF,20,82,7,16,23
47,8476422,Mike Reilly,D,NYI,31,82,7,16,23
47,8482809,Jackson Blake,R,CAR,21,82,7,16,23
47,8482122,Brock Faber,D,MIN,22,82,6,17,23
47,8479976,Juuso Valimaki,D,UTA,26,82,4,19,23
47,8477507,Nikita Zadorov,D,BOS,29,82,2,21,23
47,8480172,Jan Rutta,D,SJS,34,82,2,21,23
47,8480789,Oliver Wahlstrom,R,NYI,24,82,11,11,22
47,8482111,Justin Barron,D,MTL,23,82,10,12,22
47,8475343,Nic Dowd,C,WSH,34,82,10,12,22
47,8483565,Nick Blankenburg,D,NSH,26,82,8,14,22
47,8474716,Jared Spurgeon,D,MIN,35,82,7,15,22
47,8483763,Maksymilian Szuber,D,UTA,22,82,7,15,22
47,8479359,Beck Malenstyn,L,BUF,26,82,7,15,22
47,8475181,Nick Leddy,D,STL,33,82,5,17,22
47,8478840,Will Borgen,D,SEA,28,82,4,18,22
47,8480873,Rasmus Sandin,D,WSH,24,82,0,22,22
47,8482062,Cole Smith,L,NSH,29,82,10,11,21
47,8479316,Luke Kunin,C,SJS,27,82,10,11,21
47,8478211,Dryden Hunt,L,CGY,29,82,8,13,21
47,8476891,Matt Grzelcyk,D,PIT,30,82,5,16,21
47,8477488,Brett Pesce,D,NJD,30,82,4,17,21
47,8483482,Tristan Luneau,D,ANA,20,82,4,17,21
47,8482087,Kaiden Guhle,D,MTL,22,82,3,18,21
47,8478443,Brandon Carlo,D,BOS,28,82,1,20,21
47,8482155,Alex Laferriere,R,LAK,23,82,15,5,20
47,8475220,Marcus Foligno,L,MIN,33,82,10,10,20
47,8482762,Simon Edvinsson,D,DET,21,82,8,12,20
47,8473453,Trevor Lewis,C,LAK,37,82,7,13,20
47,8475462,Radko Gudas,D,ANA,34,82,7,13,20
47,8483490,Pavel Mintyukov,D,ANA,21,82,6,14,20
47,8481178,Egor Zamula,D,PHI,24,82,5,15,20
47,8478399,Jonas Siegenthaler,D,NJD,27,82,4,16,20
47,8483495,Simon Nemec,D,NJD,20,82,4,16,20
47,8470600,Ryan Suter,D,STL,39,82,3,17,20
47,8474673,TJ Brodie,D,CHI,34,82,2,18,20
47,8480222,Sebastian Aho,D,PIT,28,82,2,18,20
47,8474013,Ian Cole,D,UTA,35,82,2,18,20
47,8475690,Chris Tanev,D,TOR,35,82,2,18,20
47,8477505,Alexander Wennberg,C,SJS,30,82,13,6,19
47,8480870,Bo Groulx,C,NYR,24,82,13,6,19
47,8482077,Dylan Holloway,L,EDM,23,82,10,9,19
47,8483524,Shane Wright,C,SEA,20,82,9,10,19
47,8482807,Ethan Del Mastro,D,CHI,21,82,9,10,19
47,8482733,Logan Mailloux,D,MTL,31,82,9,10,19
47,8480813,Joe Veleno,C,DET,24,82,8,11,19
47,8483499,Liam Ohgren,L,MIN,20,82,7,12,19
47,8475279,Ben Chiarot,D,DET,33,82,6,13,19
47,8482101,Danil Gushchin,L,SJS,22,82,6,13,19
47,8474090,Brendan Smith,D,DAL,35,82,5,14,19
47,8479324,Ryan Lindgren,D,NYR,26,82,4,15,19
47,8479998,Mikey Anderson,D,LAK,25,82,2,17,19
47,8476967,Brett Kulak,D,EDM,30,82,2,17,19
47,8482073,Braden Schneider,D,NYR,23,82,0,19,19
47,8480025,MacKenzie Entwistle,R,FLA,25,82,8,10,18
47,8476624,Barclay Goodrow,C,SJS,31,82,7,11,18
47,8478468,Jeremy Lauzon,D,NSH,27,82,5,13,18
47,8475177,Calvin de Haan,D,COL,33,82,4,14,18
47,8477845,Trevor van Riemsdyk,D,WSH,33,82,3,15,18
47,8478859,Niko Mikkola,D,FLA,28,82,2,16,18
47,8480796,Martin Fehervary,D,WSH,25,82,2,16,18
47,8481601,Simon Holmstrom,R,NYI,23,82,7,10,17
47,8480021,Jack Studnicka,C,LAK,25,82,7,10,17
47,8477938,Haydn Fleury,D,WPG,28,82,5,12,17
47,8476429,Scott Mayfield,D,NYI,32,82,4,13,17
47,8479442,Troy Stecher,D,EDM,30,82,3,14,17
47,8477220,Nate Schmidt,D,FLA,33,82,2,15,17
47,8483397,Marc McLaughlin,C,BOS,25,82,11,5,16
47,8476858,Phillip Di Giuseppe,L,VAN,31,82,6,10,16
47,8477369,Carson Soucy,D,VAN,30,82,6,10,16
47,8480990,Declan Chisholm,D,MIN,24,82,6,10,16
47,8475762,Derek Forbort,D,VAN,32,82,6,10,16
47,8480448,Parker Kelly,L,COL,25,82,4,12,16
47,8481605,Jackson LaCombe,D,ANA,23,82,3,13,16
47,8477406,Mattias Janmark,C,EDM,32,82,3,13,16
47,8484149,Gavin Brindley,C,CBJ,20,82,2,14,16
47,8482749,Joshua Roy,R,MTL,21,82,10,5,15
47,8479291,Kevin Rooney,C,CGY,31,82,10,5,15
47,8477392,Hudson Fasching,R,NYI,29,82,9,6,15
47,8483567,Georgii Merkulov,C,BOS,24,82,8,7,15
47,8482145,Mavrik Bourque,C,DAL,22,82,7,8,15
47,8483493,Frank Nazar,C,CHI,20,82,6,9,15
47,8480950,Ilya Lyubushkin,D,DAL,30,82,4,11,15
47,8483445,Cutter Gauthier,L,ANA,20,82,3,12,15
47,8478136,Jake Middleton,D,MIN,28,82,2,13,15
47,8474612,Travis Hamonic,D,OTT,34,82,2,13,15
47,8482070,Mitchell Chaffee,R,TBL,26,82,6,8,14
47,8476442,Matt Nieto,L,PIT,32,82,5,9,14
47,8482118,Sam Colangelo,R,ANA,23,82,5,9,14
47,8481524,Bowen Byram,D,BUF,23,82,3,11,14
47,8477435,Ryan Graves,D,PIT,29,82,3,11,14
47,8480834,Ty Emberson,D,SJS,24,82,2,12,14
47,8478851,Alexandre Carrier,D,NSH,28,82,1,13,14
47,8475718,Justin Holl,D,DET,32,82,1,13,14
47,8480281,Alexey Toropchenko,R,STL,25,82,8,5,13
47,8476822,Luke Glendening,C,TBL,35,82,7,6,13
47,8484911,Collin Graf,R,SJS,22,82,5,8,13
47,8482787,Nikita Chibrikov,R,WPG,31,82,4,9,13
47,8477335,Kyle Burroughs,D,LAK,29,82,3,10,13
47,8483505,Matthew Poitras,C,BOS,20,82,3,10,13
47,8476473,Connor Murphy,D,CHI,31,82,3,10,13
47,8478450,Parker Wotherspoon,D,BOS,27,82,2,11,13
47,8478874,Adam Gaudette,C,OTT,28,82,0,13,13
47,8482659,Josh Doan,R,UTA,22,82,7,5,12
47,8483489,Fraser Minten,C,TOR,31,82,5,7,12
47,8482858,Ryker Evans,D,SEA,23,82,4,8,12
47,8481014,Alexander Romanov,D,NYI,24,82,3,9,12
47,8483460,David Jiricek,D,CBJ,21,82,3,9,12
47,8474567,Zach Bogosian,D,MIN,34,82,1,11,12
47,8481641,Joel Kiviranta,L,COL,28,82,8,3,11
47,8482712,Oskar Olausson,R,COL,22,82,5,6,11
47,8482153,Brendan Brisson,C,VGK,23,82,5,6,11
47,8481122,Simon Benoit,D,TOR,26,82,5,6,11
47,8482803,Olen Zellweger,D,ANA,21,82,4,7,11
47,8480879,Jacob Bernard-Docker,D,OTT,24,82,3,8,11
47,8476441,Joel Edmundson,D,LAK,31,82,2,9,11
47,8476372,Nick Seeler,D,PHI,31,82,2,9,11
47,8471677,Jack Johnson,D,CBJ,37,82,2,9,11
47,8483471,Brad Lambert,C,WPG,31,82,2,9,11
47,8479638,Justin Brazeau,R,BOS,26,82,6,4,10
47,8482516,Matthew Kessel,D,STL,24,82,4,6,10
47,8482713,Mackie Samoskevich,R,FLA,22,82,1,9,10
47,8482470,Ilya Solovyov,D,CGY,24,82,5,4,9
47,8483012,Logan Morrison,C,SEA,22,82,3,6,9
47,8479576,Vincent Desharnais,D,VAN,28,82,1,8,9
47,8477034,Jaycob Megna,D,FLA,32,82,1,7,8
47,8483466,Kevin Korchinski,D,CHI,20,82,1,7,8
47,8482859,Zack Ostapchuk,C,OTT,21,82,2,4,6
47,8474062,Riley Nash,C,NYR,35,82,2,2,4
47,8470794,Joe Pavelski,C,,40,0,0,0,0
47,8481703,Valtteri Puustinen,R,PIT,25,0,0,0,0
47,8477950,Tony DeAngelo,D,,29,0,0,0,0
47,8481577,Philip Tomasino,C,NSH,23,0,0,0,0
47,8475197,Tyson Barrie,D,,33,0,0,0,0
47,8471218,Blake Wheeler,R,,38,0,0,0,0
47,8474157,Max Pacioretty,L,,36,0,0,0,0
47,8478466,Daniel Sprong,R,VAN,27,0,0,0,0
47,8475744,Evgeny Kuznetsov,C,,32,0,0,0,0
47,8481019,David Gustafsson,C,WPG,24,0,0,0,0
47,8475906,John Klingberg,D,,32,0,0,0,0
47,8479348,Kale Clague,D,BUF,26,0,0,0,0
47,8476952,Dominic Toninato,C,WPG,30,0,0,0,0
47,8473473,Milan Lucic,L,,36,0,0,0,0
47,8474037,James van Riemsdyk,L,,35,0,0,0,0
47,8474602,Justin Schultz,D,,34,0,0,0,0
47,8482222,Alexander Barabanov,L,,30,0,0,0,0
47,8479372,Josh Mahura,D,SEA,26,0,0,0,0
47,8479982,Conor Timmins,D,TOR,26,0,0,0,0
47,8474031,Kevin Shattenkirk,D,,35,0,0,0,0
47,8480008,Adam Ruzicka,C,,25,0,0,0,0
47,8481059,Scott Perunovich,D,STL,26,0,0,0,0
47,8480884,Calen Addison,D,,24,0,0,0,0
47,8476994,Vinnie Hinostroza,C,NSH,30,0,0,0,0
47,8478452,Caleb Jones,D,LAK,27,0,0,0,0
47,8480157,Calle Rosen,D,COL,30,0,0,0,0
47,8481609,Vladislav Kolyachonok,D,UTA,23,0,0,0,0
47,8479415,Michael McLeod,C,,26,0,0,0,0
47,8476919,Chris Tierney,C,,30,0,0,0,0
47,8479639,Dylan Coghlan,D,WPG,26,0,0,0,0
47,8478146,Matthew Highmore,C,OTT,28,0,0,0,0
47,8478970,Jalen Chatfield,D,CAR,28,0,0,0,0
47,8480205,Emil Bemstrom,C,PIT,25,0,0,0,0
47,8474884,Mike Hoffman,C,,35,0,0,0,0
47,8471274,Alex Goligoski,D,,39,0,0,0,0
47,8478104,Sammy Blais,L,,28,0,0,0,0
47,8474870,Tyler Johnson,C,,34,0,0,0,0
47,8476913,Devin Shore,C,MIN,30,0,0,0,0
47,8481598,Philip Broberg,D,EDM,23,0,0,0,0
47,8480058,Pierre-Olivier Joseph,D,STL,25,0,0,0,0
47,8480891,Michael Kesselring,D,UTA,24,0,0,0,0
47,8477979,Nicolas Aube-Kubel,R,BUF,28,0,0,0,0
47,8476871,Tanner Pearson,L,,32,0,0,0,0
47,8476393,Nick Cousins,C,,31,0,0,0,0
47,8479977,Kailer Yamamoto,R,,26,0,0,0,0
47,8479543,Michael Pezzetta,L,MTL,26,0,0,0,0
47,8477018,Ben Hutton,D,VGK,31,0,0,0,0
47,8480762,Eric Robinson,L,CAR,29,0,0,0,0
47,8474034,Pat Maroon,L,CHI,36,0,0,0,0
47,8481058,Jesse Ylönen,R,,25,0,0,0,0
47,8475179,Dmitry Kulikov,D,FLA,34,0,0,0,0
47,8481527,Kaedan Korczak,D,VGK,23,0,0,0,0
47,8473449,Kyle Okposo,R,,36,0,0,0,0
47,8482192,Isaak Phillips,D,CHI,23,0,0,0,0
47,8480727,Zach Whitecloud,D,VGK,28,0,0,0,0
47,8479346,Dillon Dube,C,,26,0,0,0,0
47,8480821,Filip Zadina,R,,25,0,0,0,0
47,8480001,Urho Vaakanainen,D,ANA,25,0,0,0,0
47,8470966,Mark Giordano,D,,41,0,0,0,0
47,8480853,Liam Foudy,C,,24,0,0,0,0
47,8475225,Craig Smith,C,CHI,35,0,0,0,0
47,8479972,Mason Shaw,C,WPG,26,0,0,0,0
47,8478451,Ethan Bear,D,WSH,27,0,0,0,0
47,8474040,Sam Gagner,C,,35,0,0,0,0
47,8480196,Jacob Bryson,D,BUF,27,0,0,0,0
47,8479984,Cal Foote,D,,26,0,0,0,0
47,8480011,Klim Kostin,C,SJS,25,0,0,0,0
47,8482176,Wyatt Kaiser,D,CHI,22,0,0,0,0
47,8476988,Matt Benning,D,SJS,30,0,0,0,0
47,8479370,Tyson Jost,C,CAR,26,0,0,0,0
47,8477464,Nic Petan,C,,29,0,0,0,0
47,8477380,Jonny Brodzinski,C,NYR,31,0,0,0,0
47,8480070,Ian Mitchell,D,BOS,25,0,0,0,0
47,8479315,Joey Anderson,R,CHI,26,0,0,0,0
47,8478099,Kevin Labanc,R,,29,0,0,0,0
47,8476874,Olli Maatta,D,DET,30,0,0,0,0
47,8475208,Brian Dumoulin,D,ANA,33,0,0,0,0
47,8478430,Oliver Kylington,D,,27,0,0,0,0
47,8479536,Axel Jonsson-Fjallby,L,WPG,26,0,0,0,0
47,8479671,Mathieu Olivier,R,CBJ,27,0,0,0,0
47,8471709,Marc-Edouard Vlasic,D,SJS,37,0,0,0,0
47,8479328,Julien Gauthier,R,NYI,27,0,0,0,0
47,8478421,A.J. Greer,L,FLA,28,0,0,0,0
47,8477573,Nathan Walker,L,STL,30,0,0,0,0
47,8481537,Nikita Okhotiuk,D,CGY,24,0,0,0,0
47,8474166,Alec Martinez,D,CHI,37,0,0,0,0
47,8470610,Zach Parise,L,,40,0,0,0,0
47,8477478,William Carrier,L,CAR,30,0,0,0,0
47,8479344,Jesse Puljujarvi,R,PIT,26,0,0,0,0
47,8480887,Jordan Harris,D,MTL,24,0,0,0,0
47,8478502,Dennis Gilbert,D,BUF,28,0,0,0,0
47,8482730,Brandt Clarke,D,LAK,21,0,0,0,0
47,8480355,Mark Kastelic,C,BOS,25,0,0,0,0
47,8475750,Jon Merrill,D,MIN,32,0,0,0,0
47,8475164,Jakob Silfverberg,R,,34,0,0,0,0
47,8477944,Jakub Vrana,L,,28,0,0,0,0
47,8479439,Jacob MacDonald,D,COL,31,0,0,0,0
47,8474568,Luke Schenn,D,NSH,35,0,0,0,0
47,8478454,Noah Juulsen,D,VAN,27,0,0,0,0
47,8475752,Tyler Pitlick,C,,33,0,0,0,0
47,8482148,Hendrix Lapierre,C,WSH,22,0,0,0,0
47,8481167,Brayden Pachal,D,CGY,25,0,0,0,0
47,8478043,Sam Lafferty,C,BUF,29,0,0,0,0
47,8479321,Lucas Johansen,D,,27,0,0,0,0
47,8471699,Andrew Cogliano,C,,37,0,0,0,0
47,8481521,Ronnie Attard,D,PHI,25,0,0,0,0
47,8481161,Jake Christiansen,D,CBJ,25,0,0,0,0
47,8479458,Nikita Zaitsev,D,,33,0,0,0,0
47,8479619,Michael Carcone,L,UTA,28,0,0,0,0
47,8479026,Philippe Myers,D,TOR,27,0,0,0,0
47,8477330,Dominik Kubalik,L,,29,0,0,0,0
47,8481617,Vasily Podkolzin,R,VAN,23,0,0,0,0
47,8481701,Santeri Hatakka,D,NJD,23,0,0,0,0
47,8479514,Rem Pitlick,C,,27,0,0,0,0
47,8477446,Michael McCarron,R,NSH,29,0,0,0,0
47,8470604,Jeff Carter,C,,39,0,0,0,0
47,8482241,Radim Zohorna,L,,28,0,0,0,0
47,8480289,Morgan Barron,C,WPG,26,0,0,0,0
47,8479379,Givani Smith,R,SJS,26,0,0,0,0
47,8480216,Jacob Peterson,C,,25,0,0,0,0
47,8477851,Jordan Oesterle,D,BOS,32,0,0,0,0
47,8484258,Sam Malinski,D,COL,26,0,0,0,0
47,8478904,Steven Lorentz,C,,28,0,0,0,0
47,8482095,Tyler Kleven,D,OTT,22,0,0,0,0
47,8480848,Ty Dellandrea,C,SJS,24,0,0,0,0
47,8476884,Derrick Pouliot,D,,30,0,0,0,0
47,8479336,Carl Grundstrom,R,SJS,27,0,0,0,0
47,8482964,Arber Xhekaj,D,MTL,23,0,0,0,0
47,8471686,Marc Staal,D,,37,0,0,0,0
47,8477887,Patrick Brown,C,BOS,32,0,0,0,0
47,8478495,Denis Gurianov,R,,27,0,0,0,0
47,8473504,Cal Clutterbuck,R,,37,0,0,0,0
47,8481550,Adam Beckman,L,NJD,23,0,0,0,0
47,8480845,Rasmus Kupari,C,WPG,24,0,0,0,0
47,8474009,Nick Bonino,C,,36,0,0,0,0
47,8478585,Derek Ryan,C,EDM,38,0,0,0,0
47,8477962,Brendan Lemieux,L,CAR,28,0,0,0,0
47,8482861,Vincent Iorio,D,WSH,22,0,0,0,0
47,8479378,Logan Stanley,D,WPG,26,0,0,0,0
47,8473446,Erik Johnson,D,PHI,36,0,0,0,0
47,8481743,Marc Del Gaizo,D,NSH,25,0,0,0,0
47,8477384,Josh Brown,D,EDM,30,0,0,0,0
47,8482165,Yan Kuznetsov,D,CGY,22,0,0,0,0
47,8478424,Jansen Harkins,C,ANA,27,0,0,0,0
47,8482144,Jack Thompson,D,SJS,22,0,0,0,0
47,8478512,Austin Czarnik,C,,32,0,0,0,0
47,8477527,Ross Johnston,L,ANA,30,0,0,0,0
47,8479383,Boris Katchouk,L,,26,0,0,0,0
47,8482094,Daemon Hunt,D,MIN,22,0,0,0,0
47,8481719,Maxwell Crozier,D,TBL,24,0,0,0,0
47,8480192,Johnathan Kovacevic,D,NJD,27,0,0,0,0
47,8479376,Victor Mete,D,,26,0,0,0,0
47,8482511,Mason Lohrei,D,BOS,23,0,0,0,0
47,8475825,Jani Hakanpää,D,,32,0,0,0,0
47,8478021,William Lagesson,D,DET,28,0,0,0,0
47,8475795,Dylan McIlrath,D,WSH,32,0,0,0,0
47,8477846,Ryan Carpenter,C,,33,0,0,0,0
47,8481056,Spencer Stastney,D,NSH,24,0,0,0,0
47,8481564,Ryan Johnson,D,BUF,23,0,0,0,0
47,8478017,Mark Friedman,D,VAN,29,0,0,0,0
47,8479320,Max Lajoie,D,SEA,27,0,0,0,0
47,8480075,Cameron Crotty,D,MIN,25,0,0,0,0
47,8484287,Cole McWard,D,VAN,23,0,0,0,0
47,8484254,Akito Hirose,D,VAN,25,0,0,0,0
47,8483407,Brandon Scanlin,D,NYR,25,0,0,0,0
47,8480274,Philip Kemp,D,EDM,25,0,0,0,0
47,8479522,Hardy Haman Aktell,D,WSH,26,0,0,0,0
47,8480007,Jonas Rondbjerg,R,VGK,25,0,0,0,0
47,8477454,Adam Erne,L,,29,0,0,0,0
47,8481679,Maxence Guenette,D,OTT,23,0,0,0,0
47,8480441,Trey Fix-Wolansky,R,CBJ,25,0,0,0,0
47,8483546,Marshall Rifai,D,TOR,26,0,0,0,0
47,8480084,Nick DeSimone,D,NJD,30,0,0,0,0
47,8481030,Jack St. Ivany,D,PIT,25,0,0,0,0
47,8481592,Jakob Pelletier,L,CGY,23,0,0,0,0
47,8478011,Louie Belpedio,D,PHI,28,0,0,0,0
47,8477930,Pierre-Edouard Bellemare,L,,39,0,0,0,0
47,8484321,Nikolas Matinpalo,D,OTT,26,0,0,0,0
47,8482067,Connor Mackey,D,NYR,28,0,0,0,0
47,8481806,Louis Crevier,D,CHI,23,0,0,0,0
47,8484326,Patrik Koch,D,UTA,28,0,0,0,0
47,8477971,Andreas Englund,D,LAK,28,0,0,0,0
47,8481751,Lukas Rousek,R,BUF,25,0,0,0,0
47,8481006,Tyler Tucker,D,STL,24,0,0,0,0
47,8476867,Brendan Gaunce,C,MIN,30,0,0,0,0
47,8479520,Brandon Duhaime,R,WSH,27,0,0,0,0
47,8477073,Kurtis MacDermid,L,NJD,30,0,0,0,0
47,8480874,Adam Ginning,D,PHI,24,0,0,0,0
47,8477473,Justin Bailey,R,SJS,29,0,0,0,0
47,8479066,Ryan Lomberg,L,CGY,30,0,0,0,0
47,8477070,Liam O'Brien,C,UTA,30,0,0,0,0
47,8474618,Marco Scandella,D,,34,0,0,0,0
47,8475797,Jarred Tinordi,D,,32,0,0,0,0
47,8481441,Joe Snively,C,DET,28,0,0,0,0
47,8477244,Chad Ruhwedel,D,NYR,34,0,0,0,0
47,8479772,Zack MacEwen,R,OTT,28,0,0,0,0
47,8481147,Reese Johnson,C,MIN,26,0,0,0,0
47,8481043,Cole Koepke,L,BOS,26,0,0,0,0
47,8483619,Filip Roos,D,OTT,25,0,0,0,0
47,8481541,Samuel Bolduc,D,NYI,24,0,0,0,0
47,8477810,Joel Hanley,D,CGY,33,0,0,0,0
47,8476907,Mackenzie MacEachern,L,,30,0,0,0,0
47,8482652,Walker Duehr,R,CGY,27,0,0,0,0
47,8477126,Jayson Megna,C,,34,0,0,0,0
47,8483398,Declan Carlile,D,TBL,31,0,0,0,0
47,8482929,Emil Lilleberg,D,TBL,23,0,0,0,0
47,8480880,Jakub Lauko,C,MIN,24,0,0,0,0
47,8480245,Olle Lycksell,R,PHI,25,0,0,0,0
47,8480252,Cole Guttman,C,CHI,25,0,0,0,0
47,8477467,Gustav Olofsson,D,SEA,30,0,0,0,0
47,8479968,Vinni Lettieri,C,BOS,29,0,0,0,0
47,8478400,Colin White,C,,27,0,0,0,0
47,8475755,Alexander Petrovic,D,DAL,32,0,0,0,0
47,8481812,Nikolai Knyzhov,D,,27,0,0,0,0
47,8481593,Jayden Struble,D,MTL,23,0,0,0,0
47,8481532,Alex Turcotte,C,LAK,23,0,0,0,0
47,8482126,Emil Andrae,D,PHI,31,0,0,0,0
47,8479944,Zach Aston-Reese,C,VGK,30,0,0,0,0
47,8471817,Ryan Reaves,R,TOR,37,0,0,0,0
47,8481206,John Ludvig,D,PIT,24,0,0,0,0
47,8481599,Victor Soderstrom,D,UTA,23,0,0,0,0
47,8480292,Carson Meyer,R,ANA,27,0,0,0,0
47,8482496,Nils Aman,C,VAN,24,0,0,0,0
47,8479718,Alex Barré-Boulet,C,MTL,27,0,0,0,0
47,8479994,Jaret Anderson-Dolan,C,WPG,25,0,0,0,0
47,8480184,Gustav Lindstrom,D,,26,0,0,0,0
47,8480890,Jan Jenik,R,OTT,24,0,0,0,0
47,8478067,Oskar Lindblom,L,,28,0,0,0,0
47,8476934,Brock McGinn,L,ANA,30,0,0,0,0
47,8479985,Cale Fleury,D,SEA,26,0,0,0,0
47,8484304,Uvis Balinskis,D,FLA,28,0,0,0,0
47,8479981,Jonah Gadjovich,L,FLA,26,0,0,0,0
47,8481716,Dmitri Voronkov,L,CBJ,24,0,0,0,0
47,8474709,Matt Martin,L,,35,0,0,0,0
47,8482634,Alex Steeves,C,TOR,25,0,0,0,0
47,8480823,Alexander Alexeyev,D,WSH,25,0,0,0,0
47,8477541,Dakota Mermis,D,TOR,30,0,0,0,0
47,8483491,Ivan Miroshnichenko,L,WSH,20,0,0,0,0
47,8478477,Mitchell Stephens,C,SEA,27,0,0,0,0
47,8481543,Nikita Alexandrov,C,STL,24,0,0,0,0
47,8479423,Alex Nylander,L,,26,0,0,0,0
47,8482451,Mikael Pyyhtia,L,CBJ,23,0,0,0,0
47,8478831,Kevin Stenlund,C,UTA,28,0,0,0,0
47,8480306,Grant Hutton,D,NYI,29,0,0,0,0
47,8478028,Fredrik Olofsson,L,,28,0,0,0,0
47,8477462,Robert Hagg,D,VGK,29,0,0,0,0
47,8477320,Anton Blidh,L,NYR,29,0,0,0,0
47,8482157,Will Cuylle,L,NYR,22,0,0,0,0
47,8482737,Zack Bolduc,C,STL,21,0,0,0,0
47,8481239,Samuel Fagemo,L,,24,0,0,0,0
47,8481600,Tobias Bjornfot,D,FLA,23,0,0,0,0
47,8478409,Anthony Richard,C,PHI,28,0,0,0,0
47,8474145,Robert Bortuzzo,D,,35,0,0,0,0
47,8475958,Michael Sgarbossa,C,WSH,32,0,0,0,0
47,8479986,Kole Lind,R,DAL,26,0,0,0,0
47,8479249,Andrew Poturalski,C,SJS,30,0,0,0,0
47,8479362,Riley Tufte,L,BOS,26,0,0,0,0
47,8479991,Jake Leschyshyn,C,NYR,25,0,0,0,0
47,8479587,Rhett Gardner,C,PHI,28,0,0,0,0
47,8482744,James Malatesta,L,CBJ,21,0,0,0,0
47,8478854,Ryan Shea,D,PIT,27,0,0,0,0
47,8481591,Sam Poulin,R,,23,0,0,0,0
47,8483512,Matt Savoie,C,EDM,20,0,0,0,0
47,8482102,Vasily Ponomarev,C,PIT,22,0,0,0,0
47,8482162,Roby Jarventie,L,EDM,22,0,0,0,0
47,8481016,Ruslan Iskhakov,C,,24,0,0,0,0
47,8482172,Landon Slaggert,L,CHI,22,0,0,0,0
47,8482747,Brennan Othmann,L,NYR,21,0,0,0,0
47,8480031,Maxime Comtois,L,,25,0,0,0,0
47,8480226,Marián Studenic,R,,26,0,0,0,0
47,8478408,Travis Dermott,D,,28,0,0,0,0
47,8481518,Nolan Foote,L,NJD,24,0,0,0,0
47,8479419,Brett Murray,L,BUF,26,0,0,0,0
47,8482088,Justin Sourdif,R,FLA,22,0,0,0,0
47,8482201,Gage Goncalves,C,TBL,23,0,0,0,0
47,8481578,Graeme Clarke,R,MIN,23,0,0,0,0
47,8482177,Marat Khusnutdinov,C,MIN,22,0,0,0,0
47,8481754,Nikita Nesterenko,C,ANA,23,0,0,0,0
47,8483531,Brian Halonen,L,NJD,25,0,0,0,0
47,8483920,Pierrick Dube,R,WSH,23,0,0,0,0
47,8480851,Akil Thomas,C,LAK,24,0,0,0,0
47,8475235,Nicolas Deslauriers,L,PHI,33,0,0,0,0
47,8482476,Emil Heineman,L,MTL,23,0,0,0,0
47,8477149,Scott Sabourin,R,SJS,32,0,0,0,0
47,8483549,Lucas Condotta,L,MTL,27,0,0,0,0
47,8482765,Isak Rosen,R,BUF,21,0,0,0,0
47,8481237,Kyle MacLean,C,NYI,25,0,0,0,0
47,8481024,Linus Karlsson,C,VAN,25,0,0,0,0
47,8481690,Tyler Angle,C,,24,0,0,0,0
47,8483570,Ben Meyers,C,SEA,26,0,0,0,0
47,8481655,Cole Schwindt,R,CGY,23,0,0,0,0
47,8481462,Mason Morelli,L,VGK,28,0,0,0,0
47,8483401,Marc Johnstone,R,PIT,28,0,0,0,0
47,8478956,Samuel Laberge,L,NJD,27,0,0,0,0
47,8479533,Joona Koppanen,L,,26,0,0,0,0
47,8482197,Adam Raska,R,MIN,23,0,0,0,0
47,8482250,Callahan Burke,C,VGK,27,0,0,0,0
47,8482784,Zach Dean,C,STL,21,0,0,0,0
47,8484255,Jason Polin,R,COL,25,0,0,0,0
47,8481077,John Leonard,L,,26,0,0,0,0
47,8481534,Raphael Lavoie,C,EDM,24,0,0,0,0
47,8483609,Adam Klapka,R,CGY,24,0,0,0,0
47,8482751,Ryan Winterton,C,SEA,21,0,0,0,0
47,8480267,Sammy Walker,C,MIN,25,0,0,0,0
47,8475766,Austin Watson,L,,32,0,0,0,0
47,8482460,Matt Rempe,C,NYR,22,0,0,0,0
47,8481065,Angus Crookshank,L,OTT,25,0,0,0,0
47,8481070,Hugh McGing,L,,26,0,0,0,0
47,8476323,Max McCormick,L,SEA,32,0,0,0,0
47,8483395,Arshdeep Bains,L,VAN,23,0,0,0,0
47,8484259,Ondrej Pavel,C,COL,31,0,0,0,0
47,8483432,Luca Del Bel Belluz,C,CBJ,31,0,0,0,0
47,8483045,Cameron Butler,R,CBJ,31,0,0,0,0
47,8482061,Brandon Biro,L,SEA,26,0,0,0,0
47,8477401,John Hayden,C,SEA,29,0,0,0,0
47,8475278,Byron Froese,C,,33,0,0,0,0
47,8478446,Glenn Gawdin,C,LAK,27,0,0,0,0
47,8477993,Justin Kirkland,C,CGY,28,0,0,0,0
47,8482147,Jean-Luc Foudy,C,COL,22,0,0,0,0
47,8480032,Shane Bowers,C,NJD,25,0,0,0,0
47,8479330,Brandon Gignac,C,MTL,27,0,0,0,0
47,8480776,Sheldon Rempal,R,,29,0,0,0,0
47,8475413,Justin Dowling,C,NJD,34,0,0,0,0
47,8481726,Adam Edstrom,C,NYR,24,0,0,0,0
47,8480844,Grigori Denisenko,L,VGK,24,0,0,0,0
47,8478147,Bokondji Imama,L,PIT,28,0,0,0,0
47,8478881,Brett Seney,L,CHI,28,0,0,0,0
47,8483630,Pavol Regenda,L,ANA,25,0,0,0,0
47,8480836,Jonathan Gruden,C,,24,0,0,0,0
47,8484314,Jiri Smejkal,L,,28,0,0,0,0
47,8475780,Chris Wagner,R,COL,33,0,0,0,0
47,8479546,Oskar Steen,C,,26,0,0,0,0
47,8483597,Milos Kelemen,L,UTA,25,0,0,0,0
47,8481789,Tye Kartye,L,SEA,23,0,0,0,0
47,8484325,Waltteri Merela,C,TBL,26,0,0,0,0
47,8479421,Jacob Moverare,D,LAK,26,0,0,0,0
47,8481585,Egor Afanasyev,L,SJS,23,0,0,0,0
47,8479547,Matthew Phillips,R,,26,0,0,0,0
47,8479367,William Lockwood,R,FLA,26,0,0,0,0
47,8476915,Jujhar Khaira,L,,30,0,0,0,0
47,8481422,Jacob Lucchini,C,NSH,29,0,0,0,0
47,8480468,James Hamblin,L,EDM,25,0,0,0,0
47,8478051,Max Willman,C,NJD,29,0,0,0,0
47,8481556,John Beecher,C,BOS,23,0,0,0,0
47,8478078,Rourke Chartier,C,,28,0,0,0,0
48,8478402,Connor McDavid,C,EDM,27,82,52,100,152
48,8477956,David Pastrnak,R,BOS,28,82,54,85,139
48,8476453,Nikita Kucherov,R,TBL,31,82,40,95,135
48,8477492,Nathan MacKinnon,C,COL,29,82,52,82,134
48,8479318,Auston Matthews,C,TOR,27,82,53,74,127
48,8481559,Jack Hughes,C,NJD,23,82,50,74,124
48,8477493,Aleksander Barkov,C,FLA,29,82,28,94,122
48,8478864,Kirill Kaprizov,L,MIN,27,82,61,55,116
48,8476468,J.T. Miller,C,VAN,31,82,41,74,115
48,8480069,Cale Makar,D,COL,26,82,26,85,111
48,8480012,Elias Pettersson,C,VAN,26,82,43,65,108
48,8479314,Matthew Tkachuk,L,FLA,27,82,33,75,108
48,8479407,Jesper Bratt,L,NJD,26,82,48,56,104
48,8480002,Nico Hischier,C,NJD,25,82,35,69,104
48,8480027,Jason Robertson,L,DAL,25,82,45,58,103
48,8480800,Quinn Hughes,D,VAN,25,82,19,84,103
48,8481557,Matt Boldy,L,MIN,23,82,41,61,102
48,8477939,William Nylander,R,TOR,28,82,38,62,100
48,8474564,Steven Stamkos,C,NSH,34,82,41,55,96
48,8477501,Valeri Nichushkin,R,COL,29,82,41,55,96
48,8477933,Sam Reinhart,C,FLA,29,82,49,45,94
48,8479343,Clayton Keller,R,UTA,26,82,35,58,93
48,8477934,Leon Draisaitl,C,EDM,29,82,30,63,93
48,8471214,Alex Ovechkin,L,WSH,39,82,42,49,91
48,8476887,Filip Forsberg,L,NSH,30,82,39,52,91
48,8478420,Mikko Rantanen,R,COL,28,82,38,53,91
48,8471675,Sidney Crosby,C,PIT,37,82,34,54,88
48,8478550,Artemi Panarin,L,NYR,33,82,32,56,88
48,8477946,Dylan Larkin,C,DET,28,82,42,45,87
48,8481523,Kirby Dach,C,MTL,23,82,16,70,86
48,8479420,Tage Thompson,C,BUF,27,82,41,44,85
48,8478427,Sebastian Aho,C,CAR,27,82,35,50,85
48,8477942,Kevin Fiala,L,LAK,28,82,30,55,85
48,8475172,Nazem Kadri,C,CGY,34,82,29,56,85
48,8477409,Carter Verhaeghe,C,FLA,29,82,36,48,84
48,8475166,John Tavares,C,TOR,34,82,35,49,84
48,8475913,Mark Stone,R,VGK,32,82,34,50,84
48,8471215,Evgeni Malkin,C,PIT,38,82,31,53,84
48,8474590,John Carlson,D,WSH,34,82,18,66,84
48,8479385,Jordan Kyrou,C,STL,26,82,41,41,82
48,8476460,Mark Scheifele,C,WPG,31,82,30,52,82
48,8480023,Robert Thomas,C,STL,25,82,23,59,82
48,8476456,Jonathan Huberdeau,C,CGY,31,82,20,62,82
48,8474600,Roman Josi,D,NSH,34,82,19,63,82
48,8478414,Timo Meier,R,NJD,28,82,33,48,81
48,8478403,Jack Eichel,C,VGK,28,82,37,43,80
48,8480830,Andrei Svechnikov,R,CAR,24,82,31,49,80
48,8477949,Alex Tuch,R,BUF,28,82,29,51,80
48,8475810,Bryan Rust,R,PIT,32,82,38,41,79
48,8477404,Jake Guentzel,C,TBL,30,82,30,49,79
48,8476454,Ryan Nugent-Hopkins,C,EDM,31,82,22,56,78
48,8477951,Nick Schmaltz,C,UTA,28,82,31,46,77
48,8482116,Tim Stützle,C,OTT,22,82,25,52,77
48,8480865,Noah Dobson,D,NYI,24,82,14,63,77
48,8476346,Johnny Gaudreau,L,CBJ,31,82,15,61,76
48,8480036,Miro Heiskanen,D,DAL,25,82,10,66,76
48,8476539,Jonathan Marchessault,R,NSH,34,82,47,28,75
48,8479337,Alex DeBrincat,R,DET,27,82,32,43,75
48,8478010,Brayden Point,C,TBL,28,82,40,34,74
48,8475786,Zach Hyman,L,EDM,32,82,34,40,74
48,8476389,Vincent Trocheck,C,NYR,31,82,33,41,74
48,8473512,Claude Giroux,R,OTT,36,82,29,45,74
48,8478445,Mathew Barzal,C,NYI,27,82,18,56,74
48,8478398,Kyle Connor,L,WPG,28,82,35,38,73
48,8474141,Patrick Kane,R,DET,36,82,24,49,73
48,8471685,Anze Kopitar,C,LAK,37,82,24,49,73
48,8476399,Blake Coleman,C,CGY,33,82,38,32,70
48,8479542,Brandon Hagel,L,TBL,26,82,32,38,70
48,8475794,Tyler Seguin,C,DAL,32,82,30,40,70
48,8477496,Elias Lindholm,C,BOS,30,82,29,41,70
48,8480208,Drake Batherson,R,OTT,26,82,28,42,70
48,8478444,Brock Boeser,R,VAN,27,82,26,44,70
48,8476881,Tomas Hertl,C,VGK,31,82,32,37,69
48,8480018,Nick Suzuki,C,MTL,25,82,31,38,69
48,8475692,Mats Zuccarello,R,MIN,37,82,20,49,69
48,8477416,Oliver Bjorkstrand,R,SEA,29,82,19,50,69
48,8479323,Adam Fox,D,NYR,26,82,16,53,69
48,8480014,Gabriel Vilardi,C,WPG,25,82,34,34,68
48,8482078,Lucas Raymond,L,DET,22,82,26,42,68
48,8476462,Dougie Hamilton,D,NJD,31,82,21,47,68
48,8474578,Erik Karlsson,D,PIT,34,82,15,53,68
48,8475167,Victor Hedman,D,TBL,34,82,14,54,68
48,8481540,Cole Caufield,R,MTL,23,82,29,38,67
48,8475168,Matt Duchene,C,DAL,33,82,27,40,67
48,8478873,Troy Terry,R,ANA,27,82,27,40,67
48,8476459,Mika Zibanejad,C,NYR,31,82,23,44,67
48,8478439,Travis Konecny,R,PHI,27,82,27,39,66
48,8480801,Brady Tkachuk,L,OTT,25,82,31,34,65
48,8477940,Nikolaj Ehlers,L,WPG,28,82,31,34,65
48,8473419,Brad Marchand,L,BOS,36,82,23,42,65
48,8481711,Matias Maccelli,L,UTA,24,82,22,43,65
48,8477447,Shea Theodore,D,VGK,29,82,17,48,65
48,8476853,Morgan Rielly,D,TOR,30,82,13,52,65
48,8482665,Matty Beniers,C,SEA,22,82,27,37,64
48,8480839,Rasmus Dahlin,D,BUF,24,82,14,50,64
48,8475184,Chris Kreider,L,NYR,33,82,36,27,63
48,8478449,Roope Hintz,C,DAL,28,82,33,30,63
48,8475745,Charlie Coyle,C,BOS,32,82,26,37,63
48,8474150,Mikael Backlund,C,CGY,35,82,25,38,63
48,8477402,Pavel Buchnevich,L,STL,29,82,23,40,63
48,8477503,Max Domi,C,TOR,29,82,16,47,63
48,8477932,Aaron Ekblad,D,FLA,28,82,12,51,63
48,8477504,Josh Morrissey,D,WPG,29,82,10,53,63
48,8478438,Tommy Novak,C,NSH,27,82,22,40,62
48,8475726,Tyler Toffoli,C,SJS,32,82,36,25,61
48,8482093,Seth Jarvis,C,CAR,22,82,31,30,61
48,8477479,Tyler Bertuzzi,L,CHI,29,82,28,33,61
48,8482745,Mason McTavish,C,ANA,21,82,28,33,61
48,8478493,Joel Eriksson Ek,C,MIN,27,82,27,34,61
48,8478401,Pavel Zacha,C,BOS,27,82,23,38,61
48,8478397,Rasmus Andersson,D,CGY,28,82,14,47,61
48,8478460,Zach Werenski,D,CBJ,27,82,13,48,61
48,8476483,Rickard Rakell,R,PIT,31,82,26,34,60
48,8478440,Dylan Strome,C,WSH,27,82,24,36,60
48,8480803,Evan Bouchard,D,EDM,25,82,15,45,60
48,8473986,Alex Killorn,L,ANA,35,82,28,31,59
48,8473994,Jamie Benn,L,DAL,35,82,24,35,59
48,8474102,David Perron,L,OTT,36,82,24,35,59
48,8481533,Trevor Zegras,C,ANA,23,82,21,38,59
48,8482110,Dawson Mercer,C,NJD,23,82,21,38,59
48,8479410,Mikhail Sergachev,D,UTA,26,82,9,50,59
48,8481528,Dylan Cozens,C,BUF,23,82,26,32,58
48,8478047,Michael Bunting,L,PIT,29,82,24,34,58
48,8474565,Alex Pietrangelo,D,VGK,34,82,13,45,58
48,8478396,Noah Hanifin,D,VGK,27,82,13,45,58
48,8478975,Mason Marchment,L,DAL,29,82,24,33,57
48,8479400,Pierre-Luc Dubois,L,WSH,26,82,22,35,57
48,8477494,Jonathan Drouin,L,COL,29,82,18,38,56
48,8477346,MacKenzie Weegar,D,CGY,30,82,15,41,56
48,8478407,Vince Dunn,D,SEA,28,82,12,44,56
48,8477935,Sam Bennett,C,FLA,28,82,36,19,55
48,8482113,Anton Lundell,C,FLA,23,82,34,21,55
48,8482740,Wyatt Johnston,C,DAL,21,82,32,23,55
48,8477497,Sean Monahan,C,CBJ,30,82,20,35,55
48,8482149,Cole Perfetti,C,WPG,22,82,20,35,55
48,8482667,William Eklund,L,SJS,22,82,19,36,55
48,8481596,Shane Pinto,C,OTT,24,82,16,39,55
48,8476875,Mike Matheson,D,MTL,30,82,10,45,55
48,8478038,Devon Toews,D,COL,30,82,9,46,55
48,8478519,Anthony Cirelli,C,TBL,27,82,27,27,54
48,8480064,Josh Norris,C,OTT,25,82,25,29,54
48,8477456,J.T. Compher,L,DET,29,82,20,34,54
48,8475763,Kevin Hayes,R,PIT,32,82,18,36,54
48,8477986,Brandon Montour,D,SEA,30,82,15,39,54
48,8475798,Mikael Granlund,C,SJS,32,82,14,40,54
48,8476432,Boone Jenner,C,CBJ,31,82,33,20,53
48,8475158,Ryan O'Reilly,C,NSH,33,82,27,26,53
48,8478046,Danton Heinen,L,VAN,29,82,25,28,53
48,8475170,Brayden Schenn,C,STL,33,82,24,29,53
48,8479675,Trevor Moore,L,LAK,29,82,23,30,53
48,8475191,Reilly Smith,R,NYR,33,82,20,33,53
48,8479999,Casey Mittelstadt,C,COL,26,82,18,35,53
48,8482124,Quinton Byfield,R,LAK,22,82,18,35,53
48,8475765,Vladimir Tarasenko,R,DET,33,82,17,36,53
48,8478055,Gustav Forsling,D,FLA,28,82,12,41,53
48,8476880,Tom Wilson,R,WSH,30,82,26,26,52
48,8474586,Jordan Eberle,R,SEA,34,82,18,34,52
48,8482097,Jack Quinn,R,BUF,23,82,18,34,52
48,8475791,Taylor Hall,L,CHI,33,82,18,34,52
48,8477476,Artturi Lehkonen,L,COL,29,82,29,22,51
48,8477444,Andre Burakovsky,L,SEA,29,82,29,22,51
48,8478498,Jake DeBrusk,L,VAN,28,82,29,22,51
48,8477500,Bo Horvat,C,NYI,29,82,25,26,51
48,8477960,Adrian Kempe,R,LAK,28,82,24,27,51
48,8483808,Andrei Kuzmenko,L,CGY,28,82,23,28,51
48,8476882,Teuvo Teravainen,L,CHI,30,82,22,29,51
48,8482660,Kent Johnson,C,CBJ,22,82,21,30,51
48,8480188,Fabian Zetterlund,L,SJS,25,82,20,31,51
48,8480039,Martin Necas,C,CAR,25,82,19,32,51
48,8477495,Seth Jones,D,CHI,30,82,17,34,51
48,8481068,Yegor Sharangovich,C,CGY,26,82,26,24,50
48,8475754,Brock Nelson,C,NYI,33,82,24,26,50
48,8477955,Jared McCann,L,SEA,28,82,24,26,50
48,8481535,Nils Hoglander,L,VAN,24,82,22,28,50
48,8476905,Chandler Stephenson,C,SEA,30,82,12,38,50
48,8474679,Gustav Nyquist,C,NSH,35,82,10,40,50
48,8476906,Shayne Gostisbehere,D,CAR,31,82,10,40,50
48,8481542,Moritz Seider,D,DET,23,82,6,44,50
48,8482109,Alexis Lafrenière,L,NYR,23,82,21,28,49
48,8480028,Morgan Frost,C,PHI,25,82,19,30,49
48,8477451,Ryan Hartman,R,MIN,30,82,19,30,49
48,8476792,Torey Krug,D,STL,33,82,11,38,49
48,8479345,Jakob Chychrun,D,WSH,26,82,11,38,49
48,8479325,Charlie McAvoy,D,BOS,27,82,9,40,49
48,8478469,Thomas Chabot,D,OTT,27,82,9,40,49
48,8475169,Evander Kane,L,EDM,33,82,24,24,48
48,8475784,Jeff Skinner,C,EDM,32,82,22,26,48
48,8475768,Jaden Schwartz,C,SEA,32,82,22,26,48
48,8478042,Viktor Arvidsson,R,EDM,31,82,21,27,48
48,8480797,Joel Farabee,L,PHI,24,82,20,28,48
48,8480078,Filip Chytil,C,NYR,25,82,15,33,48
48,8480871,Adam Boqvist,D,FLA,24,82,14,34,48
48,8475314,Anders Lee,L,NYI,34,82,30,17,47
48,8480009,Eeli Tolvanen,R,SEA,25,82,28,19,47
48,8481618,Alex Newhook,C,MTL,23,82,27,20,47
48,8477511,Anthony Mantha,R,CGY,30,82,25,22,47
48,8475151,Kyle Palmieri,C,NYI,33,82,22,25,47
48,8476448,William Karlsson,C,VGK,31,82,21,26,47
48,8478462,Nicolas Roy,C,VGK,27,82,20,27,47
48,8477964,Ivan Barbashev,C,VGK,29,82,20,27,47
48,8479987,Morgan Geekie,C,BOS,26,82,17,30,47
48,8481581,Thomas Harley,D,DAL,23,82,12,35,47
48,8476869,Brady Skjei,D,NSH,30,82,10,37,47
48,8482159,Tyson Foerster,R,PHI,22,82,19,27,46
48,8476458,Ryan Strome,C,ANA,31,82,19,27,46
48,8478458,Jack Roslovic,C,CAR,27,82,18,28,46
48,8478856,Conor Garland,R,VAN,28,82,17,29,46
48,8481582,Nicholas Robertson,L,TOR,23,82,21,24,45
48,8476479,Phillip Danault,C,LAK,31,82,20,25,45
48,8479339,Patrik Laine,L,CBJ,26,82,19,26,45
48,8484144,Connor Bedard,C,CHI,19,82,19,26,45
48,8477953,Kasperi Kapanen,R,STL,28,82,19,26,45
48,8480798,Philipp Kurashev,C,CHI,25,82,13,32,45
48,8480145,Neal Pionk,D,WPG,29,82,8,37,45
48,8471698,T.J. Oshie,R,WSH,38,82,27,17,44
48,8480849,Barrett Hayton,C,UTA,24,82,26,18,44
48,8478366,Frank Vatrano,R,ANA,30,82,24,20,44
48,8475287,Erik Haula,L,NJD,33,82,20,24,44
48,8476826,Yanni Gourde,C,SEA,33,82,17,27,44
48,8482684,Luke Hughes,D,NJD,21,82,8,36,44
48,8475764,Cam Fowler,D,ANA,33,82,3,41,44
48,8479525,Ross Colton,C,COL,28,82,28,15,43
48,8475760,Nick Bjugstad,C,UTA,32,82,26,17,43
48,8482055,Drew O'Connor,L,PIT,26,82,25,18,43
48,8480748,Kiefer Sherwood,L,VAN,29,82,20,23,43
48,8474641,Adam Henrique,C,EDM,34,82,19,24,43
48,8478115,Pierre Engvall,L,NYI,28,82,19,24,43
48,8479591,Michael Eyssimont,C,TBL,28,82,18,25,43
48,8482720,Matthew Knies,L,TOR,22,82,14,29,43
48,8475149,Marcus Johansson,L,MIN,34,82,14,29,43
48,8479425,Filip Hronek,D,VAN,27,82,12,31,43
48,8474053,Logan Couture,C,SJS,35,82,12,31,43
48,8471724,Kris Letang,D,PIT,37,82,11,32,43
48,8480113,Alex Iafallo,L,WPG,31,82,23,19,42
48,8477429,Andrew Copp,C,DET,30,82,20,22,42
48,8476474,Stefan Noesen,R,NJD,31,82,17,25,42
48,8476292,Ondrej Palat,L,NJD,33,82,15,27,42
48,8475753,Justin Faulk,D,STL,32,82,15,27,42
48,8482671,Owen Power,D,BUF,22,82,11,31,42
48,8470613,Brent Burns,D,CAR,39,82,9,33,42
48,8476329,Travis Boyd,C,MIN,31,82,7,35,42
48,8474563,Drew Doughty,D,LAK,35,82,6,36,42
48,8480015,Owen Tippett,R,PHI,25,82,20,21,41
48,8477021,Alex Kerfoot,C,UTA,30,82,19,22,41
48,8483515,Juraj Slafkovsky,L,MTL,20,82,18,23,41
48,8482092,Ridly Greig,C,OTT,22,82,16,25,41
48,8477948,Travis Sanheim,D,PHI,28,82,13,28,41
48,8474149,Evgenii Dadonov,R,DAL,35,82,13,28,41
48,8480817,K'Andre Miller,D,NYR,24,82,12,29,41
48,8482089,Jake Neighbours,L,STL,22,82,23,17,40
48,8477407,Anthony Duclair,L,NYI,29,82,21,19,40
48,8475722,Jason Zucker,L,BUF,32,82,15,25,40
48,8478413,Jordan Greenway,L,BUF,27,82,13,27,40
48,8480336,Sean Walker,D,CAR,30,82,12,28,40
48,8476923,Damon Severson,D,CBJ,30,82,11,29,40
48,8479365,Trent Frederic,C,BOS,26,82,27,12,39
48,8476438,Brandon Saad,L,STL,32,82,22,17,39
48,8482699,Dylan Guenther,R,UTA,21,82,20,19,39
48,8478542,Evan Rodrigues,C,FLA,31,82,15,24,39
48,8482175,JJ Peterka,R,BUF,22,82,13,26,39
48,8481656,Aliaksei Protas,C,WSH,23,82,10,29,39
48,8479976,Juuso Valimaki,D,UTA,26,82,5,34,39
48,8475181,Nick Leddy,D,STL,33,82,2,37,39
48,8479992,Michael Rasmussen,C,DET,25,82,20,18,38
48,8481580,Connor McMichael,C,WSH,23,82,20,18,38
48,8480220,Noah Cates,L,PHI,25,82,19,19,38
48,8477998,Warren Foegele,L,LAK,28,82,17,21,38
48,8481186,Logan O'Connor,R,COL,28,82,17,21,38
48,8478474,Lawson Crouse,L,UTA,27,82,16,22,38
48,8477426,Nicholas Paul,L,TBL,29,82,15,23,38
48,8478233,Andrew Mangiapane,L,WSH,28,82,13,25,38
48,8481546,Cam York,D,PHI,23,82,13,25,38
48,8474716,Jared Spurgeon,D,MIN,35,82,11,27,38
48,8475799,Nino Niederreiter,R,WPG,32,82,22,15,37
48,8482259,Bobby McMann,C,TOR,28,82,22,15,37
48,8475714,Calle Jarnkrok,C,TOR,33,82,22,15,37
48,8476278,Colin Blackwell,C,DAL,31,82,19,18,37
48,8477947,Sonny Milano,L,WSH,28,82,17,20,37
48,8480802,Ryan McLeod,C,BUF,25,82,16,21,37
48,8476480,Vladislav Namestnikov,C,WPG,32,82,14,23,37
48,8478109,Victor Olofsson,L,VGK,29,82,14,23,37
48,8473422,Nick Foligno,L,CHI,37,82,13,24,37
48,8478472,Mathieu Joseph,R,STL,27,82,13,24,37
48,8482146,Luke Evangelista,R,NSH,22,82,12,25,37
48,8475218,Mattias Ekholm,D,EDM,34,82,11,26,37
48,8477220,Nate Schmidt,D,FLA,33,82,7,30,37
48,8482475,Yegor Chinakhov,R,CBJ,23,82,19,17,36
48,8484166,Adam Fantilli,C,CBJ,20,82,16,20,36
48,8476897,Oskar Sundqvist,C,STL,30,82,15,21,36
48,8476927,Teddy Blueger,C,VAN,30,82,14,22,36
48,8477987,Ryan Donato,C,CHI,28,82,13,23,36
48,8476872,Scott Laughton,C,PHI,30,82,12,24,36
48,8479402,Jake Bean,D,CGY,26,82,8,28,36
48,8478911,Matt Roy,D,WSH,29,82,8,28,36
48,8476958,Jaccob Slavin,D,CAR,30,82,7,29,36
48,8476979,Erik Gustafsson,D,DET,32,82,6,30,36
48,8477952,Robby Fabbri,C,ANA,28,82,17,18,35
48,8481624,Ilya Mikheyev,R,CHI,30,82,17,18,35
48,8480185,Eetu Luostarinen,C,FLA,26,82,13,22,35
48,8476392,Adam Lowry,C,WPG,31,82,13,22,35
48,8480434,Sean Durzi,D,UTA,26,82,11,24,35
48,8477989,Christian Dvorak,C,MTL,28,82,11,24,35
48,8480144,David Kampf,C,TOR,29,82,10,25,35
48,8477507,Nikita Zadorov,D,BOS,29,82,10,25,35
48,8477506,Ryan Pulock,D,NYI,30,82,9,26,35
48,8477498,Darnell Nurse,D,EDM,29,82,8,27,35
48,8478020,Michael Amadio,C,OTT,28,82,23,11,34
48,8477450,Jason Dickinson,C,CHI,29,82,20,14,34
48,8482079,Marco Rossi,C,MIN,23,82,19,15,34
48,8475793,Ryan Johansen,C,PHI,32,82,18,16,34
48,8480835,Jack Drury,C,CAR,24,82,18,16,34
48,8475343,Nic Dowd,C,WSH,34,82,15,19,34
48,8476960,Andreas Athanasiou,C,CHI,30,82,13,21,34
48,8477488,Brett Pesce,D,NJD,30,82,10,24,34
48,8475171,Oliver Ekman-Larsson,D,TOR,33,82,9,25,34
48,8474151,Ryan McDonagh,D,TBL,35,82,7,27,34
48,8473533,Jordan Staal,C,CAR,36,82,20,13,33
48,8480893,Kirill Marchenko,R,CBJ,24,82,18,15,33
48,8480995,Pontus Holmberg,R,TOR,25,82,18,15,33
48,8482705,Cole Sillinger,C,CBJ,21,82,17,16,33
48,8473563,Nicklas Backstrom,C,WSH,37,82,17,16,33
48,8481517,Brett Leason,R,ANA,25,82,17,16,33
48,8479414,Nathan Bastian,R,NJD,27,82,17,16,33
48,8481604,Pavel Dorofeyev,L,VGK,24,82,16,17,33
48,8470621,Corey Perry,R,EDM,39,82,16,17,33
48,8478891,Mason Appleton,C,WPG,28,82,14,19,33
48,8480459,Pius Suter,C,VAN,28,82,12,21,33
48,8476463,Jonas Brodin,D,MIN,31,82,7,26,33
48,8482655,J.J. Moser,D,TBL,24,82,5,28,33
48,8478500,Ivan Provorov,D,CBJ,27,82,4,29,33
48,8476878,Zemgus Girgensons,L,TBL,30,82,20,12,32
48,8478463,Anthony Beauvillier,L,PIT,27,82,13,19,32
48,8476854,Hampus Lindholm,D,BOS,30,82,7,25,32
48,8482133,Thomas Bordeleau,C,SJS,22,82,6,26,32
48,8481560,Arthur Kaliyev,R,LAK,23,82,19,12,31
48,8482166,Shakir Mukhamadullin,D,SJS,22,82,15,16,31
48,8481522,Peyton Krebs,C,BUF,23,82,13,18,31
48,8479293,Brandon Tanev,L,SEA,33,82,12,19,31
48,8478133,Jake Evans,C,MTL,28,82,10,21,31
48,8476457,Adam Larsson,D,SEA,32,82,8,23,31
48,8480829,Jesperi Kotkaniemi,C,CAR,24,82,7,24,31
48,8475279,Ben Chiarot,D,DET,33,82,7,24,31
48,8477969,Marcus Pettersson,D,PIT,28,82,5,26,31
48,8480068,Ryan Poehling,C,PHI,25,82,14,16,30
48,8476925,Colton Sissons,C,NSH,31,82,14,16,30
48,8476374,Sean Kuraly,C,CBJ,31,82,9,21,30
48,8475220,Marcus Foligno,L,MIN,33,82,9,21,30
48,8476917,Adam Pelech,D,NYI,30,82,8,22,30
48,8482105,Jake Sanderson,D,OTT,22,82,7,23,30
48,8475690,Chris Tanev,D,TOR,35,82,4,26,30
48,8476331,Dylan DeMelo,D,WPG,31,82,3,27,30
48,8478508,Yakov Trenin,C,MIN,27,82,19,10,29
48,8479368,Max Jones,L,BOS,26,82,15,14,29
48,8475848,Brendan Gallagher,R,MTL,32,82,15,14,29
48,8482624,Daniil Miromanov,D,CGY,27,82,14,15,29
48,8479353,Brett Howden,C,VGK,26,82,14,15,29
48,8481013,Jonatan Berggren,R,DET,24,82,13,16,29
48,8476921,Jordan Martinook,L,CAR,32,82,13,16,29
48,8482125,Alexander Holtz,R,VGK,22,82,13,16,29
48,8484145,Zach Benson,L,BUF,19,82,13,16,29
48,8482117,Lukas Reichel,L,CHI,22,82,13,16,29
48,8483457,Lane Hutson,D,MTL,20,82,12,17,29
48,8475200,Dmitry Orlov,D,CAR,33,82,11,18,29
48,8482111,Justin Barron,D,MTL,23,82,11,18,29
48,8478057,Dakota Joshua,C,VAN,28,82,10,19,29
48,8475324,Nick Jensen,D,OTT,34,82,6,23,29
48,8480873,Rasmus Sandin,D,WSH,24,82,6,23,29
48,8480049,Dylan Samberg,D,WPG,25,82,1,28,29
48,8481477,Nico Sturm,C,SJS,29,82,18,10,28
48,8479661,Tanner Jeannot,L,LAK,27,82,15,13,28
48,8478434,Keegan Kolesar,R,VGK,27,82,13,15,28
48,8476419,Jean-Gabriel Pageau,C,NYI,32,82,7,21,28
48,8480855,Jack McBain,C,UTA,24,82,6,22,28
48,8480043,Timothy Liljegren,D,TOR,25,82,4,24,28
48,8477425,Miles Wood,L,COL,29,82,19,8,27
48,8479941,Justin Danforth,R,CBJ,31,82,16,11,27
48,8474189,Lars Eller,C,PIT,35,82,15,12,27
48,8483524,Shane Wright,C,SEA,20,82,14,13,27
48,8480813,Joe Veleno,C,DET,24,82,14,13,27
48,8475193,Tomas Tatar,L,NJD,34,82,13,14,27
48,8476469,Joel Armia,R,MTL,31,82,13,14,27
48,8476442,Matt Nieto,L,PIT,32,82,13,14,27
48,8479996,Cody Glass,C,NSH,25,82,12,15,27
48,8475855,Jesper Fast,R,CAR,33,82,10,17,27
48,8478450,Parker Wotherspoon,D,BOS,27,82,8,19,27
48,8474574,Tyler Myers,D,VAN,34,82,6,21,27
48,8482087,Kaiden Guhle,D,MTL,22,82,5,22,27
48,8479398,Samuel Girard,D,COL,26,82,3,24,27
48,8477903,Garnet Hathaway,R,PHI,33,82,14,12,26
48,8483431,Logan Cooley,C,UTA,20,82,12,14,26
48,8477392,Hudson Fasching,R,NYI,29,82,12,14,26
48,8474715,Cam Atkinson,R,TBL,35,82,11,15,26
48,8481606,Jordan Spence,D,LAK,23,82,7,19,26
48,8480073,Erik Brannstrom,D,COL,25,82,5,21,26
48,8480878,Nils Lundkvist,D,DAL,24,82,4,22,26
48,8478399,Jonas Siegenthaler,D,NJD,27,82,4,22,26
48,8474673,TJ Brodie,D,CHI,34,82,3,23,26
48,8481178,Egor Zamula,D,PHI,24,82,1,25,26
48,8476873,Mark Jankowski,C,NSH,30,82,13,12,25
48,8482733,Logan Mailloux,D,MTL,31,82,13,12,25
48,8480025,MacKenzie Entwistle,R,FLA,25,82,13,12,25
48,8480003,Jesper Boqvist,C,FLA,26,82,12,13,25
48,8477015,Connor Brown,R,EDM,30,82,12,13,25
48,8481028,Martin Pospisil,C,CGY,25,82,12,13,25
48,8480789,Oliver Wahlstrom,R,NYI,24,82,10,15,25
48,8477406,Mattias Janmark,C,EDM,32,82,9,16,25
48,8480074,Alexandre Texier,C,STL,25,82,8,17,25
48,8479390,Taylor Raddysh,R,WSH,26,82,8,17,25
48,8476885,Jacob Trouba,D,NYR,30,82,7,18,25
48,8476891,Matt Grzelcyk,D,PIT,30,82,5,20,25
48,8483495,Simon Nemec,D,NJD,20,82,5,20,25
48,8482142,Jamie Drysdale,D,PHI,22,82,4,21,25
48,8475188,Brayden McNabb,D,VGK,33,82,3,22,25
48,8475233,David Savard,D,MTL,34,82,3,22,25
48,8482122,Brock Faber,D,MIN,22,82,3,22,25
48,8478840,Will Borgen,D,SEA,28,82,3,22,25
48,8478507,John Marino,D,UTA,27,82,2,23,25
48,8481554,Kaapo Kakko,R,NYR,23,82,15,9,24
48,8475231,Casey Cizikas,C,NYI,33,82,13,11,24
48,8481093,Rafael Harvey-Pinard,L,MTL,25,82,13,11,24
48,8481553,Bobby Brink,R,PHI,23,82,11,13,24
48,8482807,Ethan Del Mastro,D,CHI,21,82,11,13,24
48,8483468,Jiri Kulich,C,BUF,20,82,10,14,24
48,8477938,Haydn Fleury,D,WPG,28,82,10,14,24
48,8479359,Beck Malenstyn,L,BUF,26,82,9,15,24
48,8479351,Sam Steel,C,DAL,26,82,8,16,24
48,8479393,Noah Gregor,C,OTT,26,82,8,16,24
48,8484153,Leo Carlsson,C,ANA,20,82,8,16,24
48,8476902,Esa Lindell,D,DAL,30,82,4,20,24
48,8478882,Vladislav Gavrikov,D,LAK,29,82,3,21,24
48,8476879,Cody Ceci,D,EDM,31,82,3,21,24
48,8475842,Sam Carrick,C,NYR,32,82,12,11,23
48,8478013,Jake Walman,D,SJS,28,82,10,13,23
48,8476461,Sean Couturier,C,PHI,32,82,8,15,23
48,8482702,Logan Stankoven,C,DAL,21,82,8,15,23
48,8482245,Artem Zub,D,OTT,29,82,7,16,23
48,8476312,Josh Manson,D,COL,33,82,6,17,23
48,8482141,Lukas Cormier,D,VGK,22,82,6,17,23
48,8481708,Zac Jones,D,NYR,24,82,5,18,23
48,8475462,Radko Gudas,D,ANA,34,82,2,21,23
48,8481032,Paul Cotter,C,NJD,25,82,16,6,22
48,8481601,Simon Holmstrom,R,NYI,23,82,13,9,22
48,8477919,Frederick Gaudreau,C,MIN,31,82,11,11,22
48,8479316,Luke Kunin,C,SJS,27,82,10,12,22
48,8484149,Gavin Brindley,C,CBJ,20,82,9,13,22
48,8483490,Pavel Mintyukov,D,ANA,21,82,6,16,22
48,8482073,Braden Schneider,D,NYR,23,82,5,17,22
48,8482803,Olen Zellweger,D,ANA,21,82,5,17,22
48,8476372,Nick Seeler,D,PHI,31,82,5,17,22
48,8480281,Alexey Toropchenko,R,STL,25,82,14,7,21
48,8476981,Josh Anderson,R,MTL,30,82,11,10,21
48,8482155,Alex Laferriere,R,LAK,23,82,10,11,21
48,8480806,Isac Lundestrom,C,ANA,25,82,9,12,21
48,8481704,Juuso Parssinen,C,NSH,23,82,6,15,21
48,8476889,Radek Faksa,C,STL,30,82,6,15,21
48,8480222,Sebastian Aho,D,PIT,28,82,6,15,21
48,8480246,Nick Perbix,D,TBL,26,82,5,16,21
48,8476931,Jake McCabe,D,TOR,31,82,5,16,21
48,8478443,Brandon Carlo,D,BOS,28,82,5,16,21
48,8476892,Colton Parayko,D,STL,31,82,4,17,21
48,8476467,Jamie Oleksiak,D,SEA,32,82,4,17,21
48,8480860,Kevin Bahl,D,CGY,24,82,4,17,21
48,8478136,Jake Middleton,D,MIN,28,82,4,17,21
48,8479369,Andrew Peeke,D,BOS,26,82,3,18,21
48,8474090,Brendan Smith,D,DAL,35,82,3,18,21
48,8473507,Jeff Petry,D,DET,37,82,2,19,21
48,8478851,Alexandre Carrier,D,NSH,28,82,2,19,21
48,8473453,Trevor Lewis,C,LAK,37,82,15,5,20
48,8481524,Bowen Byram,D,BUF,23,82,12,8,20
48,8478432,Christian Fischer,R,DET,27,82,10,10,20
48,8477839,Conor Sheary,L,TBL,32,82,8,12,20
48,8477499,Rasmus Ristolainen,D,PHI,30,82,6,14,20
48,8480448,Parker Kelly,L,COL,25,82,6,14,20
48,8478859,Niko Mikkola,D,FLA,28,82,4,16,20
48,8479980,Nicolas Hague,D,VGK,26,82,3,17,20
48,8480796,Martin Fehervary,D,WSH,25,82,2,18,20
48,8475455,Brenden Dillon,D,NJD,34,82,1,19,20
48,8482077,Dylan Holloway,L,EDM,23,82,11,8,19
48,8476918,Jimmy Vesey,L,NYR,31,82,9,10,19
48,8483012,Logan Morrison,C,SEA,22,82,9,10,19
48,8477931,Tomas Nosek,L,FLA,32,82,8,11,19
48,8482749,Joshua Roy,R,MTL,21,82,6,13,19
48,8482145,Mavrik Bourque,C,DAL,22,82,6,13,19
48,8478178,Darren Raddysh,D,TBL,28,82,4,15,19
48,8470600,Ryan Suter,D,STL,39,82,4,15,19
48,8481568,Alex Vlasic,D,CHI,23,82,3,16,19
48,8476525,Colin Miller,D,WPG,32,82,3,16,19
48,8479998,Mikey Anderson,D,LAK,25,82,3,16,19
48,8480035,Henri Jokiharju,D,BUF,25,82,2,17,19
48,8480950,Ilya Lyubushkin,D,DAL,30,82,2,17,19
48,8475790,Erik Gudbranson,D,CBJ,32,82,1,18,19
48,8479371,Dante Fabbro,D,NSH,26,82,0,19,19
48,8483763,Maksymilian Szuber,D,UTA,22,82,11,7,18
48,8477508,Curtis Lazar,C,NJD,29,82,10,8,18
48,8482659,Josh Doan,R,UTA,22,82,8,10,18
48,8477353,Tyler Motte,C,DET,29,82,7,11,18
48,8481481,Blake Lizotte,C,PIT,27,82,7,11,18
48,8483565,Nick Blankenburg,D,NSH,26,82,6,12,18
48,8480990,Declan Chisholm,D,MIN,24,82,6,12,18
48,8475177,Calvin de Haan,D,COL,33,82,5,13,18
48,8482679,Matt Coronato,R,CGY,22,82,4,14,18
48,8481014,Alexander Romanov,D,NYI,24,82,4,14,18
48,8482470,Ilya Solovyov,D,CGY,24,82,4,14,18
48,8478569,Noel Acciari,C,PIT,33,82,9,8,17
48,8480021,Jack Studnicka,C,LAK,25,82,8,9,17
48,8482062,Cole Smith,L,NSH,29,82,7,10,17
48,8483482,Tristan Luneau,D,ANA,20,82,7,10,17
48,8482762,Simon Edvinsson,D,DET,21,82,7,10,17
48,8476858,Phillip Di Giuseppe,L,VAN,31,82,7,10,17
48,8477369,Carson Soucy,D,VAN,30,82,7,10,17
48,8482074,Connor Zary,C,CGY,23,82,5,12,17
48,8477435,Ryan Graves,D,PIT,29,82,5,12,17
48,8483460,David Jiricek,D,CBJ,21,82,5,12,17
48,8478468,Jeremy Lauzon,D,NSH,27,82,4,13,17
48,8481567,Henry Thrun,D,SJS,23,82,2,15,17
48,8484203,Bradly Nadeau,L,CAR,19,82,10,6,16
48,8483489,Fraser Minten,C,TOR,31,82,9,7,16
48,8477505,Alexander Wennberg,C,SJS,30,82,7,9,16
48,8483499,Liam Ohgren,L,MIN,20,82,7,9,16
48,8479576,Vincent Desharnais,D,VAN,28,82,6,10,16
48,8480980,Connor Dewar,C,TOR,25,82,5,11,16
48,8482666,Scott Morrow,D,CAR,22,82,5,11,16
48,8479291,Kevin Rooney,C,CGY,31,82,5,11,16
48,8477845,Trevor van Riemsdyk,D,WSH,33,82,4,12,16
48,8474567,Zach Bogosian,D,MIN,34,82,3,13,16
48,8477365,Connor Clifton,D,BUF,29,82,2,14,16
48,8478416,Erik Cernak,D,TBL,27,82,0,16,16
48,8476429,Scott Mayfield,D,NYI,32,82,0,16,16
48,8482809,Jackson Blake,R,CAR,21,82,7,8,15
48,8482101,Danil Gushchin,L,SJS,22,82,7,8,15
48,8480172,Jan Rutta,D,SJS,34,82,5,10,15
48,8474013,Ian Cole,D,UTA,35,82,4,11,15
48,8483505,Matthew Poitras,C,BOS,20,82,4,11,15
48,8476422,Mike Reilly,D,NYI,31,82,3,12,15
48,8476624,Barclay Goodrow,C,SJS,31,82,3,12,15
48,8482118,Sam Colangelo,R,ANA,23,82,3,12,15
48,8476473,Connor Murphy,D,CHI,31,82,3,12,15
48,8476441,Joel Edmundson,D,LAK,31,82,3,12,15
48,8479983,Mario Ferraro,D,SJS,26,82,2,13,15
48,8482859,Zack Ostapchuk,C,OTT,21,82,8,6,14
48,8478211,Dryden Hunt,L,CGY,29,82,7,7,14
48,8479638,Justin Brazeau,R,BOS,26,82,7,7,14
48,8484911,Collin Graf,R,SJS,22,82,6,8,14
48,8482712,Oskar Olausson,R,COL,22,82,6,8,14
48,8483445,Cutter Gauthier,L,ANA,20,82,5,9,14
48,8482858,Ryker Evans,D,SEA,23,82,5,9,14
48,8482153,Brendan Brisson,C,VGK,23,82,5,9,14
48,8477335,Kyle Burroughs,D,LAK,29,82,4,10,14
48,8480879,Jacob Bernard-Docker,D,OTT,24,82,4,10,14
48,8474612,Travis Hamonic,D,OTT,34,82,3,11,14
48,8483397,Marc McLaughlin,C,BOS,25,82,6,7,13
48,8482713,Mackie Samoskevich,R,FLA,22,82,5,8,13
48,8480807,Mattias Samuelsson,D,BUF,24,82,3,10,13
48,8482516,Matthew Kessel,D,STL,24,82,3,10,13
48,8482070,Mitchell Chaffee,R,TBL,26,82,8,4,12
48,8481641,Joel Kiviranta,L,COL,28,82,5,7,12
48,8477034,Jaycob Megna,D,FLA,32,82,3,9,12
48,8482787,Nikita Chibrikov,R,WPG,31,82,5,6,11
48,8479442,Troy Stecher,D,EDM,30,82,4,7,11
48,8481122,Simon Benoit,D,TOR,26,82,3,8,11
48,8481699,Aku Raty,R,UTA,23,82,2,9,11
48,8483493,Frank Nazar,C,CHI,20,82,2,9,11
48,8475718,Justin Holl,D,DET,32,82,2,9,11
48,8475762,Derek Forbort,D,VAN,32,82,1,10,11
48,8480870,Bo Groulx,C,NYR,24,82,6,4,10
48,8476822,Luke Glendening,C,TBL,35,82,5,5,10
48,8483471,Brad Lambert,C,WPG,31,82,5,5,10
48,8481605,Jackson LaCombe,D,ANA,23,82,4,6,10
48,8476967,Brett Kulak,D,EDM,30,82,1,9,10
48,8480834,Ty Emberson,D,SJS,24,82,1,8,9
48,8471677,Jack Johnson,D,CBJ,37,82,3,5,8
48,8483466,Kevin Korchinski,D,CHI,20,82,2,6,8
48,8478874,Adam Gaudette,C,OTT,28,82,0,8,8
48,8483567,Georgii Merkulov,C,BOS,24,82,3,4,7
48,8479324,Ryan Lindgren,D,NYR,26,82,1,6,7
48,8474062,Riley Nash,C,NYR,35,82,2,2,4
48,8470794,Joe Pavelski,C,,40,0,0,0,0
48,8481703,Valtteri Puustinen,R,PIT,25,0,0,0,0
48,8477950,Tony DeAngelo,D,,29,0,0,0,0
48,8481577,Philip Tomasino,C,NSH,23,0,0,0,0
48,8475197,Tyson Barrie,D,,33,0,0,0,0
48,8471218,Blake Wheeler,R,,38,0,0,0,0
48,8474157,Max Pacioretty,L,,36,0,0,0,0
48,8478466,Daniel Sprong,R,VAN,27,0,0,0,0
48,8475744,Evgeny Kuznetsov,C,,32,0,0,0,0
48,8481019,David Gustafsson,C,WPG,24,0,0,0,0
48,8475906,John Klingberg,D,,32,0,0,0,0
48,8479348,Kale Clague,D,BUF,26,0,0,0,0
48,8476952,Dominic Toninato,C,WPG,30,0,0,0,0
48,8473473,Milan Lucic,L,,36,0,0,0,0
48,8474037,James van Riemsdyk,L,,35,0,0,0,0
48,8474602,Justin Schultz,D,,34,0,0,0,0
48,8482222,Alexander Barabanov,L,,30,0,0,0,0
48,8479372,Josh Mahura,D,SEA,26,0,0,0,0
48,8479982,Conor Timmins,D,TOR,26,0,0,0,0
48,8474031,Kevin Shattenkirk,D,,35,0,0,0,0
48,8480008,Adam Ruzicka,C,,25,0,0,0,0
48,8481059,Scott Perunovich,D,STL,26,0,0,0,0
48,8480884,Calen Addison,D,,24,0,0,0,0
48,8476994,Vinnie Hinostroza,C,NSH,30,0,0,0,0
48,8478452,Caleb Jones,D,LAK,27,0,0,0,0
48,8480157,Calle Rosen,D,COL,30,0,0,0,0
48,8481609,Vladislav Kolyachonok,D,UTA,23,0,0,0,0
48,8479415,Michael McLeod,C,,26,0,0,0,0
48,8476919,Chris Tierney,C,,30,0,0,0,0
48,8479639,Dylan Coghlan,D,WPG,26,0,0,0,0
48,8478146,Matthew Highmore,C,OTT,28,0,0,0,0
48,8478970,Jalen Chatfield,D,CAR,28,0,0,0,0
48,8480205,Emil Bemstrom,C,PIT,25,0,0,0,0
48,8474884,Mike Hoffman,C,,35,0,0,0,0
48,8471274,Alex Goligoski,D,,39,0,0,0,0
48,8478104,Sammy Blais,L,,28,0,0,0,0
48,8474870,Tyler Johnson,C,,34,0,0,0,0
48,8476913,Devin Shore,C,MIN,30,0,0,0,0
48,8481598,Philip Broberg,D,EDM,23,0,0,0,0
48,8480058,Pierre-Olivier Joseph,D,STL,25,0,0,0,0
48,8480891,Michael Kesselring,D,UTA,24,0,0,0,0
48,8477979,Nicolas Aube-Kubel,R,BUF,28,0,0,0,0
48,8476871,Tanner Pearson,L,,32,0,0,0,0
48,8476393,Nick Cousins,C,,31,0,0,0,0
48,8479977,Kailer Yamamoto,R,,26,0,0,0,0
48,8479543,Michael Pezzetta,L,MTL,26,0,0,0,0
48,8477018,Ben Hutton,D,VGK,31,0,0,0,0
48,8480762,Eric Robinson,L,CAR,29,0,0,0,0
48,8474034,Pat Maroon,L,CHI,36,0,0,0,0
48,8481058,Jesse Ylönen,R,,25,0,0,0,0
48,8475179,Dmitry Kulikov,D,FLA,34,0,0,0,0
48,8481527,Kaedan Korczak,D,VGK,23,0,0,0,0
48,8473449,Kyle Okposo,R,,36,0,0,0,0
48,8482192,Isaak Phillips,D,CHI,23,0,0,0,0
48,8480727,Zach Whitecloud,D,VGK,28,0,0,0,0
48,8479346,Dillon Dube,C,,26,0,0,0,0
48,8480821,Filip Zadina,R,,25,0,0,0,0
48,8480001,Urho Vaakanainen,D,ANA,25,0,0,0,0
48,8470966,Mark Giordano,D,,41,0,0,0,0
48,8480853,Liam Foudy,C,,24,0,0,0,0
48,8475225,Craig Smith,C,CHI,35,0,0,0,0
48,8479972,Mason Shaw,C,WPG,26,0,0,0,0
48,8478451,Ethan Bear,D,WSH,27,0,0,0,0
48,8474040,Sam Gagner,C,,35,0,0,0,0
48,8480196,Jacob Bryson,D,BUF,27,0,0,0,0
48,8479984,Cal Foote,D,,26,0,0,0,0
48,8480011,Klim Kostin,C,SJS,25,0,0,0,0
48,8482176,Wyatt Kaiser,D,CHI,22,0,0,0,0
48,8476988,Matt Benning,D,SJS,30,0,0,0,0
48,8479370,Tyson Jost,C,CAR,26,0,0,0,0
48,8477464,Nic Petan,C,,29,0,0,0,0
48,8477380,Jonny Brodzinski,C,NYR,31,0,0,0,0
48,8480070,Ian Mitchell,D,BOS,25,0,0,0,0
48,8479315,Joey Anderson,R,CHI,26,0,0,0,0
48,8478099,Kevin Labanc,R,,29,0,0,0,0
48,8476874,Olli Maatta,D,DET,30,0,0,0,0
48,8475208,Brian Dumoulin,D,ANA,33,0,0,0,0
48,8478430,Oliver Kylington,D,,27,0,0,0,0
48,8479536,Axel Jonsson-Fjallby,L,WPG,26,0,0,0,0
48,8479671,Mathieu Olivier,R,CBJ,27,0,0,0,0
48,8471709,Marc-Edouard Vlasic,D,SJS,37,0,0,0,0
48,8479328,Julien Gauthier,R,NYI,27,0,0,0,0
48,8478421,A.J. Greer,L,FLA,28,0,0,0,0
48,8477573,Nathan Walker,L,STL,30,0,0,0,0
48,8481537,Nikita Okhotiuk,D,CGY,24,0,0,0,0
48,8474166,Alec Martinez,D,CHI,37,0,0,0,0
48,8470610,Zach Parise,L,,40,0,0,0,0
48,8477478,William Carrier,L,CAR,30,0,0,0,0
48,8479344,Jesse Puljujarvi,R,PIT,26,0,0,0,0
48,8480887,Jordan Harris,D,MTL,24,0,0,0,0
48,8478502,Dennis Gilbert,D,BUF,28,0,0,0,0
48,8482730,Brandt Clarke,D,LAK,21,0,0,0,0
48,8480355,Mark Kastelic,C,BOS,25,0,0,0,0
48,8475750,Jon Merrill,D,MIN,32,0,0,0,0
48,8475164,Jakob Silfverberg,R,,34,0,0,0,0
48,8477944,Jakub Vrana,L,,28,0,0,0,0
48,8479439,Jacob MacDonald,D,COL,31,0,0,0,0
48,8474568,Luke Schenn,D,NSH,35,0,0,0,0
48,8478454,Noah Juulsen,D,VAN,27,0,0,0,0
48,8475752,Tyler Pitlick,C,,33,0,0,0,0
48,8482148,Hendrix Lapierre,C,WSH,22,0,0,0,0
48,8481167,Brayden Pachal,D,CGY,25,0,0,0,0
48,8478043,Sam Lafferty,C,BUF,29,0,0,0,0
48,8479321,Lucas Johansen,D,,27,0,0,0,0
48,8471699,Andrew Cogliano,C,,37,0,0,0,0
48,8481521,Ronnie Attard,D,PHI,25,0,0,0,0
48,8481161,Jake Christiansen,D,CBJ,25,0,0,0,0
48,8479458,Nikita Zaitsev,D,,33,0,0,0,0
48,8479619,Michael Carcone,L,UTA,28,0,0,0,0
48,8479026,Philippe Myers,D,TOR,27,0,0,0,0
48,8477330,Dominik Kubalik,L,,29,0,0,0,0
48,8481617,Vasily Podkolzin,R,VAN,23,0,0,0,0
48,8481701,Santeri Hatakka,D,NJD,23,0,0,0,0
48,8479514,Rem Pitlick,C,,27,0,0,0,0
48,8477446,Michael McCarron,R,NSH,29,0,0,0,0
48,8470604,Jeff Carter,C,,39,0,0,0,0
48,8482241,Radim Zohorna,L,,28,0,0,0,0
48,8480289,Morgan Barron,C,WPG,26,0,0,0,0
48,8479379,Givani Smith,R,SJS,26,0,0,0,0
48,8480216,Jacob Peterson,C,,25,0,0,0,0
48,8477851,Jordan Oesterle,D,BOS,32,0,0,0,0
48,8484258,Sam Malinski,D,COL,26,0,0,0,0
48,8478904,Steven Lorentz,C,,28,0,0,0,0
48,8482095,Tyler Kleven,D,OTT,22,0,0,0,0
48,8480848,Ty Dellandrea,C,SJS,24,0,0,0,0
48,8476884,Derrick Pouliot,D,,30,0,0,0,0
48,8479336,Carl Grundstrom,R,SJS,27,0,0,0,0
48,8482964,Arber Xhekaj,D,MTL,23,0,0,0,0
48,8471686,Marc Staal,D,,37,0,0,0,0
48,8477887,Patrick Brown,C,BOS,32,0,0,0,0
48,8478495,Denis Gurianov,R,,27,0,0,0,0
48,8473504,Cal Clutterbuck,R,,37,0,0,0,0
48,8481550,Adam Beckman,L,NJD,23,0,0,0,0
48,8480845,Rasmus Kupari,C,WPG,24,0,0,0,0
48,8474009,Nick Bonino,C,,36,0,0,0,0
48,8478585,Derek Ryan,C,EDM,38,0,0,0,0
48,8477962,Brendan Lemieux,L,CAR,28,0,0,0,0
48,8482861,Vincent Iorio,D,WSH,22,0,0,0,0
48,8479378,Logan Stanley,D,WPG,26,0,0,0,0
48,8473446,Erik Johnson,D,PHI,36,0,0,0,0
48,8481743,Marc Del Gaizo,D,NSH,25,0,0,0,0
48,8477384,Josh Brown,D,EDM,30,0,0,0,0
48,8482165,Yan Kuznetsov,D,CGY,22,0,0,0,0
48,8478424,Jansen Harkins,C,ANA,27,0,0,0,0
48,8482144,Jack Thompson,D,SJS,22,0,0,0,0
48,8478512,Austin Czarnik,C,,32,0,0,0,0
48,8477527,Ross Johnston,L,ANA,30,0,0,0,0
48,8479383,Boris Katchouk,L,,26,0,0,0,0
48,8482094,Daemon Hunt,D,MIN,22,0,0,0,0
48,8481719,Maxwell Crozier,D,TBL,24,0,0,0,0
48,8480192,Johnathan Kovacevic,D,NJD,27,0,0,0,0
48,8479376,Victor Mete,D,,26,0,0,0,0
48,8482511,Mason Lohrei,D,BOS,23,0,0,0,0
48,8475825,Jani Hakanpää,D,,32,0,0,0,0
48,8478021,William Lagesson,D,DET,28,0,0,0,0
48,8475795,Dylan McIlrath,D,WSH,32,0,0,0,0
48,8477846,Ryan Carpenter,C,,33,0,0,0,0
48,8481056,Spencer Stastney,D,NSH,24,0,0,0,0
48,8481564,Ryan Johnson,D,BUF,23,0,0,0,0
48,8478017,Mark Friedman,D,VAN,29,0,0,0,0
48,8479320,Max Lajoie,D,SEA,27,0,0,0,0
48,8480075,Cameron Crotty,D,MIN,25,0,0,0,0
48,8484287,Cole McWard,D,VAN,23,0,0,0,0
48,8484254,Akito Hirose,D,VAN,25,0,0,0,0
48,8483407,Brandon Scanlin,D,NYR,25,0,0,0,0
48,8480274,Philip Kemp,D,EDM,25,0,0,0,0
48,8479522,Hardy Haman Aktell,D,WSH,26,0,0,0,0
48,8480007,Jonas Rondbjerg,R,VGK,25,0,0,0,0
48,8477454,Adam Erne,L,,29,0,0,0,0
48,8481679,Maxence Guenette,D,OTT,23,0,0,0,0
48,8480441,Trey Fix-Wolansky,R,CBJ,25,0,0,0,0
48,8483546,Marshall Rifai,D,TOR,26,0,0,0,0
48,8480084,Nick DeSimone,D,NJD,30,0,0,0,0
48,8481030,Jack St. Ivany,D,PIT,25,0,0,0,0
48,8481592,Jakob Pelletier,L,CGY,23,0,0,0,0
48,8478011,Louie Belpedio,D,PHI,28,0,0,0,0
48,8477930,Pierre-Edouard Bellemare,L,,39,0,0,0,0
48,8484321,Nikolas Matinpalo,D,OTT,26,0,0,0,0
48,8482067,Connor Mackey,D,NYR,28,0,0,0,0
48,8481806,Louis Crevier,D,CHI,23,0,0,0,0
48,8484326,Patrik Koch,D,UTA,28,0,0,0,0
48,8477971,Andreas Englund,D,LAK,28,0,0,0,0
48,8481751,Lukas Rousek,R,BUF,25,0,0,0,0
48,8481006,Tyler Tucker,D,STL,24,0,0,0,0
48,8476867,Brendan Gaunce,C,MIN,30,0,0,0,0
48,8479520,Brandon Duhaime,R,WSH,27,0,0,0,0
48,8477073,Kurtis MacDermid,L,NJD,30,0,0,0,0
48,8480874,Adam Ginning,D,PHI,24,0,0,0,0
48,8477473,Justin Bailey,R,SJS,29,0,0,0,0
48,8479066,Ryan Lomberg,L,CGY,30,0,0,0,0
48,8477070,Liam O'Brien,C,UTA,30,0,0,0,0
48,8474618,Marco Scandella,D,,34,0,0,0,0
48,8475797,Jarred Tinordi,D,,32,0,0,0,0
48,8481441,Joe Snively,C,DET,28,0,0,0,0
48,8477244,Chad Ruhwedel,D,NYR,34,0,0,0,0
48,8479772,Zack MacEwen,R,OTT,28,0,0,0,0
48,8481147,Reese Johnson,C,MIN,26,0,0,0,0
48,8481043,Cole Koepke,L,BOS,26,0,0,0,0
48,8483619,Filip Roos,D,OTT,25,0,0,0,0
48,8481541,Samuel Bolduc,D,NYI,24,0,0,0,0
48,8477810,Joel Hanley,D,CGY,33,0,0,0,0
48,8476907,Mackenzie MacEachern,L,,30,0,0,0,0
48,8482652,Walker Duehr,R,CGY,27,0,0,0,0
48,8477126,Jayson Megna,C,,34,0,0,0,0
48,8483398,Declan Carlile,D,TBL,31,0,0,0,0
48,8482929,Emil Lilleberg,D,TBL,23,0,0,0,0
48,8480880,Jakub Lauko,C,MIN,24,0,0,0,0
48,8480245,Olle Lycksell,R,PHI,25,0,0,0,0
48,8480252,Cole Guttman,C,CHI,25,0,0,0,0
48,8477467,Gustav Olofsson,D,SEA,30,0,0,0,0
48,8479968,Vinni Lettieri,C,BOS,29,0,0,0,0
48,8478400,Colin White,C,,27,0,0,0,0
48,8475755,Alexander Petrovic,D,DAL,32,0,0,0,0
48,8481812,Nikolai Knyzhov,D,,27,0,0,0,0
48,8481593,Jayden Struble,D,MTL,23,0,0,0,0
48,8481532,Alex Turcotte,C,LAK,23,0,0,0,0
48,8482126,Emil Andrae,D,PHI,31,0,0,0,0
48,8479944,Zach Aston-Reese,C,VGK,30,0,0,0,0
48,8471817,Ryan Reaves,R,TOR,37,0,0,0,0
48,8481206,John Ludvig,D,PIT,24,0,0,0,0
48,8481599,Victor Soderstrom,D,UTA,23,0,0,0,0
48,8480292,Carson Meyer,R,ANA,27,0,0,0,0
48,8482496,Nils Aman,C,VAN,24,0,0,0,0
48,8479718,Alex Barré-Boulet,C,MTL,27,0,0,0,0
48,8479994,Jaret Anderson-Dolan,C,WPG,25,0,0,0,0
48,8480184,Gustav Lindstrom,D,,26,0,0,0,0
48,8480890,Jan Jenik,R,OTT,24,0,0,0,0
48,8478067,Oskar Lindblom,L,,28,0,0,0,0
48,8476934,Brock McGinn,L,ANA,30,0,0,0,0
48,8479985,Cale Fleury,D,SEA,26,0,0,0,0
48,8484304,Uvis Balinskis,D,FLA,28,0,0,0,0
48,8479981,Jonah Gadjovich,L,FLA,26,0,0,0,0
48,8481716,Dmitri Voronkov,L,CBJ,24,0,0,0,0
48,8474709,Matt Martin,L,,35,0,0,0,0
48,8482634,Alex Steeves,C,TOR,25,0,0,0,0
48,8480823,Alexander Alexeyev,D,WSH,25,0,0,0,0
48,8477541,Dakota Mermis,D,TOR,30,0,0,0,0
48,8483491,Ivan Miroshnichenko,L,WSH,20,0,0,0,0
48,8478477,Mitchell Stephens,C,SEA,27,0,0,0,0
48,8481543,Nikita Alexandrov,C,STL,24,0,0,0,0
48,8479423,Alex Nylander,L,,26,0,0,0,0
48,8482451,Mikael Pyyhtia,L,CBJ,23,0,0,0,0
48,8478831,Kevin Stenlund,C,UTA,28,0,0,0,0
48,8480306,Grant Hutton,D,NYI,29,0,0,0,0
48,8478028,Fredrik Olofsson,L,,28,0,0,0,0
48,8477462,Robert Hagg,D,VGK,29,0,0,0,0
48,8477320,Anton Blidh,L,NYR,29,0,0,0,0
48,8482157,Will Cuylle,L,NYR,22,0,0,0,0
48,8482737,Zack Bolduc,C,STL,21,0,0,0,0
48,8481239,Samuel Fagemo,L,,24,0,0,0,0
48,8481600,Tobias Bjornfot,D,FLA,23,0,0,0,0
48,8478409,Anthony Richard,C,PHI,28,0,0,0,0
48,8474145,Robert Bortuzzo,D,,35,0,0,0,0
48,8475958,Michael Sgarbossa,C,WSH,32,0,0,0,0
48,8479986,Kole Lind,R,DAL,26,0,0,0,0
48,8479249,Andrew Poturalski,C,SJS,30,0,0,0,0
48,8479362,Riley Tufte,L,BOS,26,0,0,0,0
48,8479991,Jake Leschyshyn,C,NYR,25,0,0,0,0
48,8479587,Rhett Gardner,C,PHI,28,0,0,0,0
48,8482744,James Malatesta,L,CBJ,21,0,0,0,0
48,8478854,Ryan Shea,D,PIT,27,0,0,0,0
48,8481591,Sam Poulin,R,,23,0,0,0,0
48,8483512,Matt Savoie,C,EDM,20,0,0,0,0
48,8482102,Vasily Ponomarev,C,PIT,22,0,0,0,0
48,8482162,Roby Jarventie,L,EDM,22,0,0,0,0
48,8481016,Ruslan Iskhakov,C,,24,0,0,0,0
48,8482172,Landon Slaggert,L,CHI,22,0,0,0,0
48,8482747,Brennan Othmann,L,NYR,21,0,0,0,0
48,8480031,Maxime Comtois,L,,25,0,0,0,0
48,8480226,Marián Studenic,R,,26,0,0,0,0
48,8478408,Travis Dermott,D,,28,0,0,0,0
48,8481518,Nolan Foote,L,NJD,24,0,0,0,0
48,8479419,Brett Murray,L,BUF,26,0,0,0,0
48,8482088,Justin Sourdif,R,FLA,22,0,0,0,0
48,8482201,Gage Goncalves,C,TBL,23,0,0,0,0
48,8481578,Graeme Clarke,R,MIN,23,0,0,0,0
48,8482177,Marat Khusnutdinov,C,MIN,22,0,0,0,0
48,8481754,Nikita Nesterenko,C,ANA,23,0,0,0,0
48,8483531,Brian Halonen,L,NJD,25,0,0,0,0
48,8483920,Pierrick Dube,R,WSH,23,0,0,0,0
48,8480851,Akil Thomas,C,LAK,24,0,0,0,0
48,8475235,Nicolas Deslauriers,L,PHI,33,0,0,0,0
48,8482476,Emil Heineman,L,MTL,23,0,0,0,0
48,8477149,Scott Sabourin,R,SJS,32,0,0,0,0
48,8483549,Lucas Condotta,L,MTL,27,0,0,0,0
48,8482765,Isak Rosen,R,BUF,21,0,0,0,0
48,8481237,Kyle MacLean,C,NYI,25,0,0,0,0
48,8481024,Linus Karlsson,C,VAN,25,0,0,0,0
48,8481690,Tyler Angle,C,,24,0,0,0,0
48,8483570,Ben Meyers,C,SEA,26,0,0,0,0
48,8481655,Cole Schwindt,R,CGY,23,0,0,0,0
48,8481462,Mason Morelli,L,VGK,28,0,0,0,0
48,8483401,Marc Johnstone,R,PIT,28,0,0,0,0
48,8478956,Samuel Laberge,L,NJD,27,0,0,0,0
48,8479533,Joona Koppanen,L,,26,0,0,0,0
48,8482197,Adam Raska,R,MIN,23,0,0,0,0
48,8482250,Callahan Burke,C,VGK,27,0,0,0,0
48,8482784,Zach Dean,C,STL,21,0,0,0,0
48,8484255,Jason Polin,R,COL,25,0,0,0,0
48,8481077,John Leonard,L,,26,0,0,0,0
48,8481534,Raphael Lavoie,C,EDM,24,0,0,0,0
48,8483609,Adam Klapka,R,CGY,24,0,0,0,0
48,8482751,Ryan Winterton,C,SEA,21,0,0,0,0
48,8480267,Sammy Walker,C,MIN,25,0,0,0,0
48,8475766,Austin Watson,L,,32,0,0,0,0
48,8482460,Matt Rempe,C,NYR,22,0,0,0,0
48,8481065,Angus Crookshank,L,OTT,25,0,0,0,0
48,8481070,Hugh McGing,L,,26,0,0,0,0
48,8476323,Max McCormick,L,SEA,32,0,0,0,0
48,8483395,Arshdeep Bains,L,VAN,23,0,0,0,0
48,8484259,Ondrej Pavel,C,COL,31,0,0,0,0
48,8483432,Luca Del Bel Belluz,C,CBJ,31,0,0,0,0
48,8483045,Cameron Butler,R,CBJ,31,0,0,0,0
48,8482061,Brandon Biro,L,SEA,26,0,0,0,0
48,8477401,John Hayden,C,SEA,29,0,0,0,0
48,8475278,Byron Froese,C,,33,0,0,0,0
48,8478446,Glenn Gawdin,C,LAK,27,0,0,0,0
48,8477993,Justin Kirkland,C,CGY,28,0,0,0,0
48,8482147,Jean-Luc Foudy,C,COL,22,0,0,0,0
48,8480032,Shane Bowers,C,NJD,25,0,0,0,0
48,8479330,Brandon Gignac,C,MTL,27,0,0,0,0
48,8480776,Sheldon Rempal,R,,29,0,0,0,0
48,8475413,Justin Dowling,C,NJD,34,0,0,0,0
48,8481726,Adam Edstrom,C,NYR,24,0,0,0,0
48,8480844,Grigori Denisenko,L,VGK,24,0,0,0,0
48,8478147,Bokondji Imama,L,PIT,28,0,0,0,0
48,8478881,Brett Seney,L,CHI,28,0,0,0,0
48,8483630,Pavol Regenda,L,ANA,25,0,0,0,0
48,8480836,Jonathan Gruden,C,,24,0,0,0,0
48,8484314,Jiri Smejkal,L,,28,0,0,0,0
48,8475780,Chris Wagner,R,COL,33,0,0,0,0
48,8479546,Oskar Steen,C,,26,0,0,0,0
48,8483597,Milos Kelemen,L,UTA,25,0,0,0,0
48,8481789,Tye Kartye,L,SEA,23,0,0,0,0
48,8484325,Waltteri Merela,C,TBL,26,0,0,0,0
48,8479421,Jacob Moverare,D,LAK,26,0,0,0,0
48,8481585,Egor Afanasyev,L,SJS,23,0,0,0,0
48,8479547,Matthew Phillips,R,,26,0,0,0,0
48,8479367,William Lockwood,R,FLA,26,0,0,0,0
48,8476915,Jujhar Khaira,L,,30,0,0,0,0
48,8481422,Jacob Lucchini,C,NSH,29,0,0,0,0
48,8480468,James Hamblin,L,EDM,25,0,0,0,0
48,8478051,Max Willman,C,NJD,29,0,0,0,0
48,8481556,John Beecher,C,BOS,23,0,0,0,0
48,8478078,Rourke Chartier,C,,28,0,0,0,0
49,8476453,Nikita Kucherov,R,TBL,31,82,47,99,146
49,8478402,Connor McDavid,C,EDM,27,82,46,93,139
49,8477492,Nathan MacKinnon,C,COL,29,82,53,74,127
49,8479318,Auston Matthews,C,TOR,27,82,68,52,120
49,8477956,David Pastrnak,R,BOS,28,82,54,63,117
49,8478398,Kyle Connor,L,WPG,28,82,51,63,114
49,8478864,Kirill Kaprizov,L,MIN,27,82,56,52,108
49,8480027,Jason Robertson,L,DAL,25,82,39,69,108
49,8477939,William Nylander,R,TOR,28,82,40,66,106
49,8476468,J.T. Miller,C,VAN,31,82,37,67,104
49,8481559,Jack Hughes,C,NJD,23,82,46,57,103
49,8476887,Filip Forsberg,L,NSH,30,82,44,57,101
49,8480069,Cale Makar,D,COL,26,82,29,68,97
49,8480012,Elias Pettersson,C,VAN,26,82,48,48,96
49,8481557,Matt Boldy,L,MIN,23,82,30,65,95
49,8478010,Brayden Point,C,TBL,28,82,44,49,93
49,8477404,Jake Guentzel,C,TBL,30,82,35,58,93
49,8477504,Josh Morrissey,D,WPG,29,82,24,69,93
49,8479385,Jordan Kyrou,C,STL,26,82,43,49,92
49,8478420,Mikko Rantanen,R,COL,28,82,33,59,92
49,8477501,Valeri Nichushkin,R,COL,29,82,45,46,91
49,8478427,Sebastian Aho,C,CAR,27,82,37,54,91
49,8479314,Matthew Tkachuk,L,FLA,27,82,32,59,91
49,8478550,Artemi Panarin,L,NYR,33,82,29,62,91
49,8475166,John Tavares,C,TOR,34,82,37,53,90
49,8480800,Quinn Hughes,D,VAN,25,82,14,75,89
49,8480801,Brady Tkachuk,L,OTT,25,82,39,49,88
49,8480830,Andrei Svechnikov,R,CAR,24,82,36,52,88
49,8477940,Nikolaj Ehlers,L,WPG,28,82,36,51,87
49,8478439,Travis Konecny,R,PHI,27,82,40,45,85
49,8473512,Claude Giroux,R,OTT,36,82,36,49,85
49,8478449,Roope Hintz,C,DAL,28,82,41,43,84
49,8478445,Mathew Barzal,C,NYI,27,82,20,64,84
49,8479420,Tage Thompson,C,BUF,27,82,40,43,83
49,8474564,Steven Stamkos,C,NSH,34,82,38,45,83
49,8477946,Dylan Larkin,C,DET,28,82,34,49,83
49,8477409,Carter Verhaeghe,C,FLA,29,82,32,51,83
49,8477934,Leon Draisaitl,C,EDM,29,82,31,52,83
49,8475692,Mats Zuccarello,R,MIN,37,82,20,63,83
49,8480865,Noah Dobson,D,NYI,24,82,18,65,83
49,8476346,Johnny Gaudreau,L,CBJ,31,82,21,61,82
49,8479323,Adam Fox,D,NYR,26,82,17,65,82
49,8482116,Tim Stützle,C,OTT,22,82,34,46,80
49,8475754,Brock Nelson,C,NYI,33,82,38,41,79
49,8477493,Aleksander Barkov,C,FLA,29,82,30,49,79
49,8475913,Mark Stone,R,VGK,32,82,27,52,79
49,8478444,Brock Boeser,R,VAN,27,82,30,48,78
49,8478975,Mason Marchment,L,DAL,29,82,27,51,78
49,8480002,Nico Hischier,C,NJD,25,82,26,52,78
49,8475172,Nazem Kadri,C,CGY,34,82,30,47,77
49,8479407,Jesper Bratt,L,NJD,26,82,29,48,77
49,8476462,Dougie Hamilton,D,NJD,31,82,24,53,77
49,8477942,Kevin Fiala,L,LAK,28,82,23,54,77
49,8475765,Vladimir Tarasenko,R,DET,33,82,35,41,76
49,8471215,Evgeni Malkin,C,PIT,38,82,28,48,76
49,8475810,Bryan Rust,R,PIT,32,82,40,35,75
49,8482097,Jack Quinn,R,BUF,23,82,27,48,75
49,8477402,Pavel Buchnevich,L,STL,29,82,26,49,75
49,8476459,Mika Zibanejad,C,NYR,31,82,23,52,75
49,8480036,Miro Heiskanen,D,DAL,25,82,14,61,75
49,8477960,Adrian Kempe,R,LAK,28,82,42,32,74
49,8477933,Sam Reinhart,C,FLA,29,82,36,38,74
49,8475184,Chris Kreider,L,NYR,33,82,45,28,73
49,8471675,Sidney Crosby,C,PIT,37,82,38,35,73
49,8477500,Bo Horvat,C,NYI,29,82,33,40,73
49,8482093,Seth Jarvis,C,CAR,22,82,30,43,73
49,8480039,Martin Necas,C,CAR,25,82,30,43,73
49,8474141,Patrick Kane,R,DET,36,82,25,48,73
49,8478460,Zach Werenski,D,CBJ,27,82,23,50,73
49,8473994,Jamie Benn,L,DAL,35,82,23,50,73
49,8476454,Ryan Nugent-Hopkins,C,EDM,31,82,17,56,73
49,8476460,Mark Scheifele,C,WPG,31,82,31,41,72
49,8476389,Vincent Trocheck,C,NYR,31,82,27,45,72
49,8478042,Viktor Arvidsson,R,EDM,31,82,27,45,72
49,8477949,Alex Tuch,R,BUF,28,82,21,51,72
49,8476853,Morgan Rielly,D,TOR,30,82,4,68,72
49,8476539,Jonathan Marchessault,R,NSH,34,82,35,36,71
49,8476881,Tomas Hertl,C,VGK,31,82,35,36,71
49,8476448,William Karlsson,C,VGK,31,82,29,42,71
49,8473419,Brad Marchand,L,BOS,36,82,25,46,71
49,8476456,Jonathan Huberdeau,C,CGY,31,82,22,49,71
49,8480839,Rasmus Dahlin,D,BUF,24,82,17,54,71
49,8480018,Nick Suzuki,C,MTL,25,82,30,39,69
49,8480208,Drake Batherson,R,OTT,26,82,28,41,69
49,8477951,Nick Schmaltz,C,UTA,28,82,22,47,69
49,8478403,Jack Eichel,C,VGK,28,82,30,38,68
49,8479343,Clayton Keller,R,UTA,26,82,27,41,68
49,8475168,Matt Duchene,C,DAL,33,82,27,41,68
49,8480023,Robert Thomas,C,STL,25,82,17,51,68
49,8471214,Alex Ovechkin,L,WSH,39,82,31,36,67
49,8476432,Boone Jenner,C,CBJ,31,82,31,36,67
49,8482740,Wyatt Johnston,C,DAL,21,82,36,30,66
49,8475784,Jeff Skinner,C,EDM,32,82,33,33,66
49,8478440,Dylan Strome,C,WSH,27,82,26,40,66
49,8479337,Alex DeBrincat,R,DET,27,82,25,41,66
49,8478873,Troy Terry,R,ANA,27,82,22,44,66
49,8474590,John Carlson,D,WSH,34,82,16,50,66
49,8474578,Erik Karlsson,D,PIT,34,82,12,54,66
49,8477451,Ryan Hartman,R,MIN,30,82,24,41,65
49,8474600,Roman Josi,D,NSH,34,82,20,45,65
49,8478414,Timo Meier,R,NJD,28,82,37,27,64
49,8478498,Jake DeBrusk,L,VAN,28,82,33,31,64
49,8481528,Dylan Cozens,C,BUF,23,82,27,37,64
49,8476882,Teuvo Teravainen,L,CHI,30,82,24,40,64
49,8479339,Patrik Laine,L,CBJ,26,82,23,41,64
49,8477496,Elias Lindholm,C,BOS,30,82,21,43,64
49,8471685,Anze Kopitar,C,LAK,37,82,20,43,63
49,8481523,Kirby Dach,C,MTL,23,82,12,51,63
49,8475167,Victor Hedman,D,TBL,34,82,8,55,63
49,8481711,Matias Maccelli,L,UTA,24,82,19,43,62
49,8474679,Gustav Nyquist,C,NSH,35,82,22,39,61
49,8480014,Gabriel Vilardi,C,WPG,25,82,37,23,60
49,8475794,Tyler Seguin,C,DAL,32,82,31,29,60
49,8481533,Trevor Zegras,C,ANA,23,82,28,32,60
49,8480015,Owen Tippett,R,PHI,25,82,26,34,60
49,8478493,Joel Eriksson Ek,C,MIN,27,82,23,37,60
49,8478047,Michael Bunting,L,PIT,29,82,21,39,60
49,8476906,Shayne Gostisbehere,D,CAR,31,82,15,45,60
49,8477447,Shea Theodore,D,VGK,29,82,9,51,60
49,8477407,Anthony Duclair,L,NYI,29,82,30,29,59
49,8481596,Shane Pinto,C,OTT,24,82,21,38,59
49,8471724,Kris Letang,D,PIT,37,82,18,40,58
49,8475170,Brayden Schenn,C,STL,33,82,34,23,57
49,8478366,Frank Vatrano,R,ANA,30,82,31,26,57
49,8482078,Lucas Raymond,L,DET,22,82,29,28,57
49,8475786,Zach Hyman,L,EDM,32,82,26,31,57
49,8479542,Brandon Hagel,L,TBL,26,82,26,31,57
49,8479410,Mikhail Sergachev,D,UTA,26,82,7,50,57
49,8481540,Cole Caufield,R,MTL,23,82,31,25,56
49,8477955,Jared McCann,L,SEA,28,82,30,26,56
49,8477476,Artturi Lehkonen,L,COL,29,82,27,29,56
49,8481068,Yegor Sharangovich,C,CGY,26,82,26,30,56
49,8482124,Quinton Byfield,R,LAK,22,82,21,35,56
49,8480802,Ryan McLeod,C,BUF,25,82,24,31,55
49,8478038,Devon Toews,D,COL,30,82,14,41,55
49,8478438,Tommy Novak,C,NSH,27,82,12,43,55
49,8480797,Joel Farabee,L,PHI,24,82,29,25,54
49,8476483,Rickard Rakell,R,PIT,31,82,28,26,54
49,8482109,Alexis Lafrenière,L,NYR,23,82,27,27,54
49,8482745,Mason McTavish,C,ANA,21,82,25,29,54
49,8478401,Pavel Zacha,C,BOS,27,82,24,30,54
49,8482720,Matthew Knies,L,TOR,22,82,22,32,54
49,8482113,Anton Lundell,C,FLA,23,82,21,33,54
49,8475798,Mikael Granlund,C,SJS,32,82,17,37,54
49,8480798,Philipp Kurashev,C,CHI,25,82,15,39,54
49,8480434,Sean Durzi,D,UTA,26,82,15,39,54
49,8477932,Aaron Ekblad,D,FLA,28,82,13,41,54
49,8480803,Evan Bouchard,D,EDM,25,82,11,43,54
49,8480064,Josh Norris,C,OTT,25,82,31,22,53
49,8476399,Blake Coleman,C,CGY,33,82,27,26,53
49,8477935,Sam Bennett,C,FLA,28,82,27,26,53
49,8475151,Kyle Palmieri,C,NYI,33,82,24,29,53
49,8474102,David Perron,L,OTT,36,82,23,30,53
49,8470613,Brent Burns,D,CAR,39,82,17,36,53
49,8478407,Vince Dunn,D,SEA,28,82,10,43,53
49,8478856,Conor Garland,R,VAN,28,82,21,31,52
49,8477964,Ivan Barbashev,C,VGK,29,82,19,33,52
49,8477503,Max Domi,C,TOR,29,82,15,37,52
49,8476875,Mike Matheson,D,MTL,30,82,14,38,52
49,8474565,Alex Pietrangelo,D,VGK,34,82,13,39,52
49,8476869,Brady Skjei,D,NSH,30,82,11,41,52
49,8478396,Noah Hanifin,D,VGK,27,82,10,42,52
49,8479325,Charlie McAvoy,D,BOS,27,82,10,42,52
49,8477479,Tyler Bertuzzi,L,CHI,29,82,21,30,51
49,8477416,Oliver Bjorkstrand,R,SEA,29,82,16,35,51
49,8481542,Moritz Seider,D,DET,23,82,13,38,51
49,8478519,Anthony Cirelli,C,TBL,27,82,26,24,50
49,8475169,Evander Kane,L,EDM,33,82,25,25,50
49,8482665,Matty Beniers,C,SEA,22,82,24,26,50
49,8484144,Connor Bedard,C,CHI,19,82,23,27,50
49,8474641,Adam Henrique,C,EDM,34,82,21,29,50
49,8478469,Thomas Chabot,D,OTT,27,82,15,35,50
49,8480078,Filip Chytil,C,NYR,25,82,15,35,50
49,8476480,Vladislav Namestnikov,C,WPG,32,82,14,36,50
49,8479425,Filip Hronek,D,VAN,27,82,7,43,50
49,8478046,Danton Heinen,L,VAN,29,82,27,22,49
49,8477511,Anthony Mantha,R,CGY,30,82,25,24,49
49,8475158,Ryan O'Reilly,C,NSH,33,82,23,26,49
49,8473986,Alex Killorn,L,ANA,35,82,22,27,49
49,8478462,Nicolas Roy,C,VGK,27,82,21,28,49
49,8474150,Mikael Backlund,C,CGY,35,82,20,29,49
49,8477497,Sean Monahan,C,CBJ,30,82,18,31,49
49,8480188,Fabian Zetterlund,L,SJS,25,82,18,31,49
49,8480028,Morgan Frost,C,PHI,25,82,18,31,49
49,8477494,Jonathan Drouin,L,COL,29,82,16,33,49
49,8476872,Scott Laughton,C,PHI,30,82,16,33,49
49,8478055,Gustav Forsling,D,FLA,28,82,12,37,49
49,8476905,Chandler Stephenson,C,SEA,30,82,11,38,49
49,8482699,Dylan Guenther,R,UTA,21,82,28,20,48
49,8479675,Trevor Moore,L,LAK,29,82,25,23,48
49,8479992,Michael Rasmussen,C,DET,25,82,24,24,48
49,8474586,Jordan Eberle,R,SEA,34,82,23,25,48
49,8481618,Alex Newhook,C,MTL,23,82,20,28,48
49,8482159,Tyson Foerster,R,PHI,22,82,18,30,48
49,8475745,Charlie Coyle,C,BOS,32,82,17,31,48
49,8475200,Dmitry Orlov,D,CAR,33,82,13,35,48
49,8480009,Eeli Tolvanen,R,SEA,25,82,27,20,47
49,8477426,Nicholas Paul,L,TBL,29,82,25,22,47
49,8479525,Ross Colton,C,COL,28,82,24,23,47
49,8475726,Tyler Toffoli,C,SJS,32,82,23,24,47
49,8482667,William Eklund,L,SJS,22,82,19,28,47
49,8477986,Brandon Montour,D,SEA,30,82,19,28,47
49,8476880,Tom Wilson,R,WSH,30,82,18,29,47
49,8480893,Kirill Marchenko,R,CBJ,24,82,27,19,46
49,8482175,JJ Peterka,R,BUF,22,82,24,22,46
49,8482110,Dawson Mercer,C,NJD,23,82,20,26,46
49,8482475,Yegor Chinakhov,R,CBJ,23,82,20,26,46
49,8476826,Yanni Gourde,C,SEA,33,82,18,28,46
49,8475763,Kevin Hayes,R,PIT,32,82,17,29,46
49,8482671,Owen Power,D,BUF,22,82,14,32,46
49,8474563,Drew Doughty,D,LAK,35,82,13,33,46
49,8473422,Nick Foligno,L,CHI,37,82,23,22,45
49,8476479,Phillip Danault,C,LAK,31,82,20,25,45
49,8475287,Erik Haula,L,NJD,33,82,20,25,45
49,8481546,Cam York,D,PHI,23,82,16,29,45
49,8474715,Cam Atkinson,R,TBL,35,82,14,31,45
49,8479345,Jakob Chychrun,D,WSH,26,82,13,32,45
49,8479999,Casey Mittelstadt,C,COL,26,82,12,33,45
49,8481606,Jordan Spence,D,LAK,23,82,8,37,45
49,8482105,Jake Sanderson,D,OTT,22,82,7,38,45
49,8476925,Colton Sissons,C,NSH,31,82,22,22,44
49,8477998,Warren Foegele,L,LAK,28,82,17,27,44
49,8475791,Taylor Hall,L,CHI,33,82,16,28,44
49,8478397,Rasmus Andersson,D,CGY,28,82,13,31,44
49,8476419,Jean-Gabriel Pageau,C,NYI,32,82,13,31,44
49,8478458,Jack Roslovic,C,CAR,27,82,12,32,44
49,8482684,Luke Hughes,D,NJD,21,82,11,33,44
49,8480336,Sean Walker,D,CAR,30,82,11,33,44
49,8477495,Seth Jones,D,CHI,30,82,9,35,44
49,8481560,Arthur Kaliyev,R,LAK,23,82,21,22,43
49,8482660,Kent Johnson,C,CBJ,22,82,19,24,43
49,8475149,Marcus Johansson,L,MIN,34,82,14,29,43
49,8476792,Torey Krug,D,STL,33,82,10,33,43
49,8477948,Travis Sanheim,D,PHI,28,82,8,35,43
49,8471698,T.J. Oshie,R,WSH,38,82,21,21,42
49,8482117,Lukas Reichel,L,CHI,22,82,20,22,42
49,8475793,Ryan Johansen,C,PHI,32,82,18,24,42
49,8475191,Reilly Smith,R,NYR,33,82,17,25,42
49,8482705,Cole Sillinger,C,CBJ,21,82,17,25,42
49,8476461,Sean Couturier,C,PHI,32,82,17,25,42
49,8477021,Alex Kerfoot,C,UTA,30,82,13,29,42
49,8475764,Cam Fowler,D,ANA,33,82,7,35,42
49,8480873,Rasmus Sandin,D,WSH,24,82,6,36,42
49,8475314,Anders Lee,L,NYI,34,82,28,13,41
49,8483808,Andrei Kuzmenko,L,CGY,28,82,19,22,41
49,8478891,Mason Appleton,C,WPG,28,82,19,22,41
49,8477444,Andre Burakovsky,L,SEA,29,82,18,23,41
49,8480748,Kiefer Sherwood,L,VAN,29,82,17,24,41
49,8482055,Drew O'Connor,L,PIT,26,82,15,26,41
49,8477456,J.T. Compher,L,DET,29,82,14,27,41
49,8481581,Thomas Harley,D,DAL,23,82,12,29,41
49,8478133,Jake Evans,C,MTL,28,82,11,30,41
49,8477346,MacKenzie Weegar,D,CGY,30,82,9,32,41
49,8478542,Evan Rodrigues,C,FLA,31,82,20,20,40
49,8480459,Pius Suter,C,VAN,28,82,20,20,40
49,8477947,Sonny Milano,L,WSH,28,82,16,24,40
49,8477952,Robby Fabbri,C,ANA,28,82,15,25,40
49,8475343,Nic Dowd,C,WSH,34,82,15,25,40
49,8480871,Adam Boqvist,D,FLA,24,82,14,26,40
49,8480113,Alex Iafallo,L,WPG,31,82,12,28,40
49,8475799,Nino Niederreiter,R,WPG,32,82,23,16,39
49,8478474,Lawson Crouse,L,UTA,27,82,22,17,39
49,8480185,Eetu Luostarinen,C,FLA,26,82,21,18,39
49,8480829,Jesperi Kotkaniemi,C,CAR,24,82,21,18,39
49,8481481,Blake Lizotte,C,PIT,27,82,19,20,39
49,8474053,Logan Couture,C,SJS,35,82,18,21,39
49,8478233,Andrew Mangiapane,L,WSH,28,82,15,24,39
49,8477498,Darnell Nurse,D,EDM,29,82,11,28,39
49,8479976,Juuso Valimaki,D,UTA,26,82,7,32,39
49,8477969,Marcus Pettersson,D,PIT,28,82,3,36,39
49,8478109,Victor Olofsson,L,VGK,29,82,20,18,38
49,8477987,Ryan Donato,C,CHI,28,82,17,21,38
49,8475768,Jaden Schwartz,C,SEA,32,82,16,22,38
49,8478413,Jordan Greenway,L,BUF,27,82,16,22,38
49,8477953,Kasperi Kapanen,R,STL,28,82,14,24,38
49,8474716,Jared Spurgeon,D,MIN,35,82,13,25,38
49,8479400,Pierre-Luc Dubois,L,WSH,26,82,11,27,38
49,8474151,Ryan McDonagh,D,TBL,35,82,11,27,38
49,8481624,Ilya Mikheyev,R,CHI,30,82,9,29,38
49,8481580,Connor McMichael,C,WSH,23,82,20,17,37
49,8481601,Simon Holmstrom,R,NYI,23,82,19,18,37
49,8475722,Jason Zucker,L,BUF,32,82,17,20,37
49,8478115,Pierre Engvall,L,NYI,28,82,16,21,37
49,8476392,Adam Lowry,C,WPG,31,82,16,21,37
49,8477989,Christian Dvorak,C,MTL,28,82,16,21,37
49,8476463,Jonas Brodin,D,MIN,31,82,14,23,37
49,8476923,Damon Severson,D,CBJ,30,82,10,27,37
49,8476927,Teddy Blueger,C,VAN,30,82,8,29,37
49,8479987,Morgan Geekie,C,BOS,26,82,22,14,36
49,8476278,Colin Blackwell,C,DAL,31,82,20,16,36
49,8470621,Corey Perry,R,EDM,39,82,20,16,36
49,8475714,Calle Jarnkrok,C,TOR,33,82,17,19,36
49,8475848,Brendan Gallagher,R,MTL,32,82,17,19,36
49,8479365,Trent Frederic,C,BOS,26,82,16,20,36
49,8476438,Brandon Saad,L,STL,32,82,16,20,36
49,8474189,Lars Eller,C,PIT,35,82,16,20,36
49,8481656,Aliaksei Protas,C,WSH,23,82,15,21,36
49,8482146,Luke Evangelista,R,NSH,22,82,14,22,36
49,8478463,Anthony Beauvillier,L,PIT,27,82,14,22,36
49,8481013,Jonatan Berggren,R,DET,24,82,12,24,36
49,8477506,Ryan Pulock,D,NYI,30,82,7,29,36
49,8475753,Justin Faulk,D,STL,32,82,6,30,36
49,8483431,Logan Cooley,C,UTA,20,82,25,10,35
49,8481553,Bobby Brink,R,PHI,23,82,16,19,35
49,8479941,Justin Danforth,R,CBJ,31,82,15,20,35
49,8478057,Dakota Joshua,C,VAN,28,82,14,21,35
49,8475220,Marcus Foligno,L,MIN,33,82,11,24,35
49,8476958,Jaccob Slavin,D,CAR,30,82,6,29,35
49,8481582,Nicholas Robertson,L,TOR,23,82,20,14,34
49,8475760,Nick Bjugstad,C,UTA,32,82,18,16,34
49,8473563,Nicklas Backstrom,C,WSH,37,82,17,17,34
49,8477429,Andrew Copp,C,DET,30,82,16,18,34
49,8483457,Lane Hutson,D,MTL,20,82,16,18,34
49,8479390,Taylor Raddysh,R,WSH,26,82,15,19,34
49,8479371,Dante Fabbro,D,NSH,26,82,7,27,34
49,8476917,Adam Pelech,D,NYI,30,82,3,31,34
49,8479398,Samuel Girard,D,COL,26,82,3,31,34
49,8478508,Yakov Trenin,C,MIN,27,82,22,11,33
49,8482092,Ridly Greig,C,OTT,22,82,19,14,33
49,8484145,Zach Benson,L,BUF,19,82,16,17,33
49,8478472,Mathieu Joseph,R,STL,27,82,15,18,33
49,8480835,Jack Drury,C,CAR,24,82,15,18,33
49,8476960,Andreas Athanasiou,C,CHI,30,82,14,19,33
49,8480074,Alexandre Texier,C,STL,25,82,14,19,33
49,8476292,Ondrej Palat,L,NJD,33,82,13,20,33
49,8482149,Cole Perfetti,C,WPG,22,82,11,22,33
49,8480995,Pontus Holmberg,R,TOR,25,82,11,22,33
49,8476931,Jake McCabe,D,TOR,31,82,4,29,33
49,8479316,Luke Kunin,C,SJS,27,82,21,11,32
49,8481554,Kaapo Kakko,R,NYR,23,82,19,13,32
49,8481704,Juuso Parssinen,C,NSH,23,82,18,14,32
49,8473533,Jordan Staal,C,CAR,36,82,15,17,32
49,8474149,Evgenii Dadonov,R,DAL,35,82,14,18,32
49,8478434,Keegan Kolesar,R,VGK,27,82,13,19,32
49,8479996,Cody Glass,C,NSH,25,82,13,19,32
49,8476885,Jacob Trouba,D,NYR,30,82,11,21,32
49,8482122,Brock Faber,D,MIN,22,82,10,22,32
49,8479393,Noah Gregor,C,OTT,26,82,10,22,32
49,8476329,Travis Boyd,C,MIN,31,82,6,26,32
49,8478500,Ivan Provorov,D,CBJ,27,82,4,28,32
49,8476854,Hampus Lindholm,D,BOS,30,82,4,28,32
49,8480043,Timothy Liljegren,D,TOR,25,82,3,29,32
49,8483505,Matthew Poitras,C,BOS,20,82,16,15,31
49,8479293,Brandon Tanev,L,SEA,33,82,15,16,31
49,8475193,Tomas Tatar,L,NJD,34,82,14,17,31
49,8475855,Jesper Fast,R,CAR,33,82,14,17,31
49,8481186,Logan O'Connor,R,COL,28,82,13,18,31
49,8481093,Rafael Harvey-Pinard,L,MTL,25,82,13,18,31
49,8475231,Casey Cizikas,C,NYI,33,82,12,19,31
49,8480220,Noah Cates,L,PHI,25,82,11,20,31
49,8476474,Stefan Noesen,R,NJD,31,82,6,25,31
49,8481178,Egor Zamula,D,PHI,24,82,6,25,31
49,8482089,Jake Neighbours,L,STL,22,82,20,10,30
49,8476981,Josh Anderson,R,MTL,30,82,19,11,30
49,8477919,Frederick Gaudreau,C,MIN,31,82,17,13,30
49,8476858,Phillip Di Giuseppe,L,VAN,31,82,16,14,30
49,8480855,Jack McBain,C,UTA,24,82,12,18,30
49,8480003,Jesper Boqvist,C,FLA,26,82,10,20,30
49,8475218,Mattias Ekholm,D,EDM,34,82,9,21,30
49,8480817,K'Andre Miller,D,NYR,24,82,6,24,30
49,8476892,Colton Parayko,D,STL,31,82,6,24,30
49,8474574,Tyler Myers,D,VAN,34,82,5,25,30
49,8480145,Neal Pionk,D,WPG,29,82,4,26,30
49,8477220,Nate Schmidt,D,FLA,33,82,4,26,30
49,8481535,Nils Hoglander,L,VAN,24,82,19,10,29
49,8477425,Miles Wood,L,COL,29,82,18,11,29
49,8476442,Matt Nieto,L,PIT,32,82,17,12,29
49,8477450,Jason Dickinson,C,CHI,29,82,15,14,29
49,8482079,Marco Rossi,C,MIN,23,82,15,14,29
49,8480789,Oliver Wahlstrom,R,NYI,24,82,14,15,29
49,8481604,Pavel Dorofeyev,L,VGK,24,82,13,16,29
49,8484166,Adam Fantilli,C,CBJ,20,82,12,17,29
49,8478432,Christian Fischer,R,DET,27,82,12,17,29
49,8483515,Juraj Slafkovsky,L,MTL,20,82,10,19,29
49,8476312,Josh Manson,D,COL,33,82,6,23,29
49,8476891,Matt Grzelcyk,D,PIT,30,82,5,24,29
49,8480222,Sebastian Aho,D,PIT,28,82,5,24,29
49,8476331,Dylan DeMelo,D,WPG,31,82,4,25,29
49,8476918,Jimmy Vesey,L,NYR,31,82,16,12,28
49,8480849,Barrett Hayton,C,UTA,24,82,15,13,28
49,8479359,Beck Malenstyn,L,BUF,26,82,15,13,28
49,8482125,Alexander Holtz,R,VGK,22,82,14,14,28
49,8480144,David Kampf,C,TOR,29,82,13,15,28
49,8482133,Thomas Bordeleau,C,SJS,22,82,12,16,28
49,8482111,Justin Barron,D,MTL,23,82,9,19,28
49,8478020,Michael Amadio,C,OTT,28,82,7,21,28
49,8478851,Alexandre Carrier,D,NSH,28,82,5,23,28
49,8482245,Artem Zub,D,OTT,29,82,4,24,28
49,8476525,Colin Miller,D,WPG,32,82,4,24,28
49,8476458,Ryan Strome,C,ANA,31,82,3,25,28
49,8479353,Brett Howden,C,VGK,26,82,15,12,27
49,8477392,Hudson Fasching,R,NYI,29,82,14,13,27
49,8482809,Jackson Blake,R,CAR,21,82,12,15,27
49,8479661,Tanner Jeannot,L,LAK,27,82,11,16,27
49,8476624,Barclay Goodrow,C,SJS,31,82,8,19,27
49,8476979,Erik Gustafsson,D,DET,32,82,6,21,27
49,8482142,Jamie Drysdale,D,PHI,22,82,6,21,27
49,8478507,John Marino,D,UTA,27,82,4,23,27
49,8478859,Niko Mikkola,D,FLA,28,82,4,23,27
49,8476902,Esa Lindell,D,DAL,30,82,3,24,27
49,8480035,Henri Jokiharju,D,BUF,25,82,3,24,27
49,8476921,Jordan Martinook,L,CAR,32,82,13,13,26
49,8479351,Sam Steel,C,DAL,26,82,13,13,26
49,8479414,Nathan Bastian,R,NJD,27,82,11,15,26
49,8478013,Jake Walman,D,SJS,28,82,11,15,26
49,8482166,Shakir Mukhamadullin,D,SJS,22,82,9,17,26
49,8476897,Oskar Sundqvist,C,STL,30,82,7,19,26
49,8481477,Nico Sturm,C,SJS,29,82,7,19,26
49,8482087,Kaiden Guhle,D,MTL,22,82,5,21,26
49,8482655,J.J. Moser,D,TBL,24,82,4,22,26
49,8475324,Nick Jensen,D,OTT,34,82,4,22,26
49,8478840,Will Borgen,D,SEA,28,82,0,26,26
49,8482074,Connor Zary,C,CGY,23,82,13,12,25
49,8479591,Michael Eyssimont,C,TBL,28,82,12,13,25
49,8479368,Max Jones,L,BOS,26,82,11,14,25
49,8481028,Martin Pospisil,C,CGY,25,82,11,14,25
49,8484153,Leo Carlsson,C,ANA,20,82,10,15,25
49,8480806,Isac Lundestrom,C,ANA,25,82,10,15,25
49,8478911,Matt Roy,D,WSH,29,82,8,17,25
49,8475171,Oliver Ekman-Larsson,D,TOR,33,82,7,18,25
49,8475279,Ben Chiarot,D,DET,33,82,7,18,25
49,8477488,Brett Pesce,D,NJD,30,82,5,20,25
49,8477365,Connor Clifton,D,BUF,29,82,5,20,25
49,8477508,Curtis Lazar,C,NJD,29,82,11,13,24
49,8477903,Garnet Hathaway,R,PHI,33,82,8,16,24
49,8481522,Peyton Krebs,C,BUF,23,82,7,17,24
49,8483495,Simon Nemec,D,NJD,20,82,7,17,24
49,8482803,Olen Zellweger,D,ANA,21,82,6,18,24
49,8482624,Daniil Miromanov,D,CGY,27,82,4,20,24
49,8480073,Erik Brannstrom,D,COL,25,82,4,20,24
49,8479369,Andrew Peeke,D,BOS,26,82,4,20,24
49,8476967,Brett Kulak,D,EDM,30,82,4,20,24
49,8475233,David Savard,D,MTL,34,82,2,22,24
49,8482259,Bobby McMann,C,TOR,28,82,17,6,23
49,8476374,Sean Kuraly,C,CBJ,31,82,15,8,23
49,8477406,Mattias Janmark,C,EDM,32,82,12,11,23
49,8480813,Joe Veleno,C,DET,24,82,10,13,23
49,8480980,Connor Dewar,C,TOR,25,82,9,14,23
49,8477353,Tyler Motte,C,DET,29,82,8,15,23
49,8477839,Conor Sheary,L,TBL,32,82,7,16,23
49,8477435,Ryan Graves,D,PIT,29,82,7,16,23
49,8473507,Jeff Petry,D,DET,37,82,5,18,23
49,8478882,Vladislav Gavrikov,D,LAK,29,82,4,19,23
49,8478443,Brandon Carlo,D,BOS,28,82,3,20,23
49,8480049,Dylan Samberg,D,WPG,25,82,2,21,23
49,8480068,Ryan Poehling,C,PHI,25,82,10,12,22
49,8478569,Noel Acciari,C,PIT,33,82,9,13,22
49,8482666,Scott Morrow,D,CAR,22,82,9,13,22
49,8482733,Logan Mailloux,D,MTL,31,82,7,15,22
49,8481568,Alex Vlasic,D,CHI,23,82,6,16,22
49,8470600,Ryan Suter,D,STL,39,82,3,19,22
49,8480172,Jan Rutta,D,SJS,34,82,3,19,22
49,8475690,Chris Tanev,D,TOR,35,82,2,20,22
49,8480878,Nils Lundkvist,D,DAL,24,82,2,20,22
49,8476879,Cody Ceci,D,EDM,31,82,2,20,22
49,8476878,Zemgus Girgensons,L,TBL,30,82,14,7,21
49,8481641,Joel Kiviranta,L,COL,28,82,10,11,21
49,8476457,Adam Larsson,D,SEA,32,82,9,12,21
49,8476889,Radek Faksa,C,STL,30,82,8,13,21
49,8482470,Ilya Solovyov,D,CGY,24,82,8,13,21
49,8477507,Nikita Zadorov,D,BOS,29,82,7,14,21
49,8480448,Parker Kelly,L,COL,25,82,6,15,21
49,8478136,Jake Middleton,D,MIN,28,82,5,16,21
49,8479402,Jake Bean,D,CGY,26,82,2,19,21
49,8481014,Alexander Romanov,D,NYI,24,82,2,19,21
49,8476429,Scott Mayfield,D,NYI,32,82,2,19,21
49,8478399,Jonas Siegenthaler,D,NJD,27,82,1,20,21
49,8478416,Erik Cernak,D,TBL,27,82,1,20,21
49,8480281,Alexey Toropchenko,R,STL,25,82,10,10,20
49,8482702,Logan Stankoven,C,DAL,21,82,9,11,20
49,8482679,Matt Coronato,R,CGY,22,82,8,12,20
49,8477015,Connor Brown,R,EDM,30,82,7,13,20
49,8477931,Tomas Nosek,L,FLA,32,82,7,13,20
49,8482145,Mavrik Bourque,C,DAL,22,82,7,13,20
49,8480796,Martin Fehervary,D,WSH,25,82,6,14,20
49,8484203,Bradly Nadeau,L,CAR,19,82,5,15,20
49,8483468,Jiri Kulich,C,BUF,20,82,4,16,20
49,8483490,Pavel Mintyukov,D,ANA,21,82,4,16,20
49,8482073,Braden Schneider,D,NYR,23,82,4,16,20
49,8476422,Mike Reilly,D,NYI,31,82,4,16,20
49,8481708,Zac Jones,D,NYR,24,82,3,17,20
49,8479980,Nicolas Hague,D,VGK,26,82,3,17,20
49,8475790,Erik Gudbranson,D,CBJ,32,82,3,17,20
49,8476467,Jamie Oleksiak,D,SEA,32,82,2,18,20
49,8476469,Joel Armia,R,MTL,31,82,9,10,19
49,8480246,Nick Perbix,D,TBL,26,82,9,10,19
49,8482062,Cole Smith,L,NSH,29,82,8,11,19
49,8482712,Oskar Olausson,R,COL,22,82,8,11,19
49,8482141,Lukas Cormier,D,VGK,22,82,7,12,19
49,8482807,Ethan Del Mastro,D,CHI,21,82,6,13,19
49,8480860,Kevin Bahl,D,CGY,24,82,5,14,19
49,8479983,Mario Ferraro,D,SJS,26,82,5,14,19
49,8474673,TJ Brodie,D,CHI,34,82,1,18,19
49,8482155,Alex Laferriere,R,LAK,23,82,12,6,18
49,8483493,Frank Nazar,C,CHI,20,82,9,9,18
49,8483499,Liam Ohgren,L,MIN,20,82,8,10,18
49,8481517,Brett Leason,R,ANA,25,82,7,11,18
49,8473453,Trevor Lewis,C,LAK,37,82,7,11,18
49,8482762,Simon Edvinsson,D,DET,21,82,7,11,18
49,8482858,Ryker Evans,D,SEA,23,82,6,12,18
49,8481567,Henry Thrun,D,SJS,23,82,3,15,18
49,8481699,Aku Raty,R,UTA,23,82,9,8,17
49,8477369,Carson Soucy,D,VAN,30,82,6,11,17
49,8478211,Dryden Hunt,L,CGY,29,82,6,11,17
49,8475188,Brayden McNabb,D,VGK,33,82,5,12,17
49,8483763,Maksymilian Szuber,D,UTA,22,82,4,13,17
49,8480950,Ilya Lyubushkin,D,DAL,30,82,3,14,17
49,8483565,Nick Blankenburg,D,NSH,26,82,3,14,17
49,8476473,Connor Murphy,D,CHI,31,82,3,14,17
49,8476372,Nick Seeler,D,PHI,31,82,2,15,17
49,8478178,Darren Raddysh,D,TBL,28,82,1,16,17
49,8477034,Jaycob Megna,D,FLA,32,82,1,16,17
49,8475842,Sam Carrick,C,NYR,32,82,10,6,16
49,8481524,Bowen Byram,D,BUF,23,82,9,7,16
49,8483445,Cutter Gauthier,L,ANA,20,82,9,7,16
49,8482101,Danil Gushchin,L,SJS,22,82,7,9,16
49,8483012,Logan Morrison,C,SEA,22,82,6,10,16
49,8474013,Ian Cole,D,UTA,35,82,5,11,16
49,8475181,Nick Leddy,D,STL,33,82,3,13,16
49,8477845,Trevor van Riemsdyk,D,WSH,33,82,3,13,16
49,8479998,Mikey Anderson,D,LAK,25,82,1,15,16
49,8482077,Dylan Holloway,L,EDM,23,82,12,3,15
49,8481032,Paul Cotter,C,NJD,25,82,8,7,15
49,8483489,Fraser Minten,C,TOR,31,82,8,7,15
49,8476873,Mark Jankowski,C,NSH,30,82,6,9,15
49,8483482,Tristan Luneau,D,ANA,20,82,6,9,15
49,8482153,Brendan Brisson,C,VGK,23,82,6,9,15
49,8478468,Jeremy Lauzon,D,NSH,27,82,5,10,15
49,8477505,Alexander Wennberg,C,SJS,30,82,5,10,15
49,8480807,Mattias Samuelsson,D,BUF,24,82,3,12,15
49,8477938,Haydn Fleury,D,WPG,28,82,2,13,15
49,8480879,Jacob Bernard-Docker,D,OTT,24,82,2,13,15
49,8475762,Derek Forbort,D,VAN,32,82,2,13,15
49,8479638,Justin Brazeau,R,BOS,26,82,8,6,14
49,8480021,Jack Studnicka,C,LAK,25,82,7,7,14
49,8482659,Josh Doan,R,UTA,22,82,4,10,14
49,8480990,Declan Chisholm,D,MIN,24,82,4,10,14
49,8476441,Joel Edmundson,D,LAK,31,82,4,10,14
49,8475462,Radko Gudas,D,ANA,34,82,2,12,14
49,8475455,Brenden Dillon,D,NJD,34,82,2,12,14
49,8477335,Kyle Burroughs,D,LAK,29,82,2,12,14
49,8477499,Rasmus Ristolainen,D,PHI,30,82,0,14,14
49,8479576,Vincent Desharnais,D,VAN,28,82,0,14,14
49,8484149,Gavin Brindley,C,CBJ,20,82,8,5,13
49,8482749,Joshua Roy,R,MTL,21,82,6,7,13
49,8481122,Simon Benoit,D,TOR,26,82,5,8,13
49,8480834,Ty Emberson,D,SJS,24,82,4,9,13
49,8474090,Brendan Smith,D,DAL,35,82,3,10,13
49,8483460,David Jiricek,D,CBJ,21,82,3,10,13
49,8479324,Ryan Lindgren,D,NYR,26,82,2,11,13
49,8475718,Justin Holl,D,DET,32,82,1,12,13
49,8484911,Collin Graf,R,SJS,22,82,4,8,12
49,8481605,Jackson LaCombe,D,ANA,23,82,4,8,12
49,8482859,Zack Ostapchuk,C,OTT,21,82,3,9,12
49,8471677,Jack Johnson,D,CBJ,37,82,1,11,12
49,8483471,Brad Lambert,C,WPG,31,82,7,4,11
49,8482787,Nikita Chibrikov,R,WPG,31,82,5,6,11
49,8478874,Adam Gaudette,C,OTT,28,82,4,7,11
49,8480870,Bo Groulx,C,NYR,24,82,3,8,11
49,8482070,Mitchell Chaffee,R,TBL,26,82,7,3,10
49,8480025,MacKenzie Entwistle,R,FLA,25,82,6,4,10
49,8483524,Shane Wright,C,SEA,20,82,5,5,10
49,8482713,Mackie Samoskevich,R,FLA,22,82,5,5,10
49,8482118,Sam Colangelo,R,ANA,23,82,4,6,10
49,8474567,Zach Bogosian,D,MIN,34,82,3,7,10
49,8479442,Troy Stecher,D,EDM,30,82,3,7,10
49,8476822,Luke Glendening,C,TBL,35,82,7,2,9
49,8475177,Calvin de Haan,D,COL,33,82,2,7,9
49,8474612,Travis Hamonic,D,OTT,34,82,0,9,9
49,8479291,Kevin Rooney,C,CGY,31,82,4,4,8
49,8483466,Kevin Korchinski,D,CHI,20,82,3,5,8
49,8483567,Georgii Merkulov,C,BOS,24,82,3,5,8
49,8478450,Parker Wotherspoon,D,BOS,27,82,0,8,8
49,8483397,Marc McLaughlin,C,BOS,25,82,4,3,7
49,8482516,Matthew Kessel,D,STL,24,82,1,6,7
49,8474062,Riley Nash,C,NYR,35,82,0,6,6
49,8470794,Joe Pavelski,C,,40,0,0,0,0
49,8481703,Valtteri Puustinen,R,PIT,25,0,0,0,0
49,8477950,Tony DeAngelo,D,,29,0,0,0,0
49,8481577,Philip Tomasino,C,NSH,23,0,0,0,0
49,8475197,Tyson Barrie,D,,33,0,0,0,0
49,8471218,Blake Wheeler,R,,38,0,0,0,0
49,8474157,Max Pacioretty,L,,36,0,0,0,0
49,8478466,Daniel Sprong,R,VAN,27,0,0,0,0
49,8475744,Evgeny Kuznetsov,C,,32,0,0,0,0
49,8481019,David Gustafsson,C,WPG,24,0,0,0,0
49,8475906,John Klingberg,D,,32,0,0,0,0
49,8479348,Kale Clague,D,BUF,26,0,0,0,0
49,8476952,Dominic Toninato,C,WPG,30,0,0,0,0
49,8473473,Milan Lucic,L,,36,0,0,0,0
49,8474037,James van Riemsdyk,L,,35,0,0,0,0
49,8474602,Justin Schultz,D,,34,0,0,0,0
49,8482222,Alexander Barabanov,L,,30,0,0,0,0
49,8479372,Josh Mahura,D,SEA,26,0,0,0,0
49,8479982,Conor Timmins,D,TOR,26,0,0,0,0
49,8474031,Kevin Shattenkirk,D,,35,0,0,0,0
49,8480008,Adam Ruzicka,C,,25,0,0,0,0
49,8481059,Scott Perunovich,D,STL,26,0,0,0,0
49,8480884,Calen Addison,D,,24,0,0,0,0
49,8476994,Vinnie Hinostroza,C,NSH,30,0,0,0,0
49,8478452,Caleb Jones,D,LAK,27,0,0,0,0
49,8480157,Calle Rosen,D,COL,30,0,0,0,0
49,8481609,Vladislav Kolyachonok,D,UTA,23,0,0,0,0
49,8479415,Michael McLeod,C,,26,0,0,0,0
49,8476919,Chris Tierney,C,,30,0,0,0,0
49,8479639,Dylan Coghlan,D,WPG,26,0,0,0,0
49,8478146,Matthew Highmore,C,OTT,28,0,0,0,0
49,8478970,Jalen Chatfield,D,CAR,28,0,0,0,0
49,8480205,Emil Bemstrom,C,PIT,25,0,0,0,0
49,8474884,Mike Hoffman,C,,35,0,0,0,0
49,8471274,Alex Goligoski,D,,39,0,0,0,0
49,8478104,Sammy Blais,L,,28,0,0,0,0
49,8474870,Tyler Johnson,C,,34,0,0,0,0
49,8476913,Devin Shore,C,MIN,30,0,0,0,0
49,8481598,Philip Broberg,D,EDM,23,0,0,0,0
49,8480058,Pierre-Olivier Joseph,D,STL,25,0,0,0,0
49,8480891,Michael Kesselring,D,UTA,24,0,0,0,0
49,8477979,Nicolas Aube-Kubel,R,BUF,28,0,0,0,0
49,8476871,Tanner Pearson,L,,32,0,0,0,0
49,8476393,Nick Cousins,C,,31,0,0,0,0
49,8479977,Kailer Yamamoto,R,,26,0,0,0,0
49,8479543,Michael Pezzetta,L,MTL,26,0,0,0,0
49,8477018,Ben Hutton,D,VGK,31,0,0,0,0
49,8480762,Eric Robinson,L,CAR,29,0,0,0,0
49,8474034,Pat Maroon,L,CHI,36,0,0,0,0
49,8481058,Jesse Ylönen,R,,25,0,0,0,0
49,8475179,Dmitry Kulikov,D,FLA,34,0,0,0,0
49,8481527,Kaedan Korczak,D,VGK,23,0,0,0,0
49,8473449,Kyle Okposo,R,,36,0,0,0,0
49,8482192,Isaak Phillips,D,CHI,23,0,0,0,0
49,8480727,Zach Whitecloud,D,VGK,28,0,0,0,0
49,8479346,Dillon Dube,C,,26,0,0,0,0
49,8480821,Filip Zadina,R,,25,0,0,0,0
49,8480001,Urho Vaakanainen,D,ANA,25,0,0,0,0
49,8470966,Mark Giordano,D,,41,0,0,0,0
49,8480853,Liam Foudy,C,,24,0,0,0,0
49,8475225,Craig Smith,C,CHI,35,0,0,0,0
49,8479972,Mason Shaw,C,WPG,26,0,0,0,0
49,8478451,Ethan Bear,D,WSH,27,0,0,0,0
49,8474040,Sam Gagner,C,,35,0,0,0,0
49,8480196,Jacob Bryson,D,BUF,27,0,0,0,0
49,8479984,Cal Foote,D,,26,0,0,0,0
49,8480011,Klim Kostin,C,SJS,25,0,0,0,0
49,8482176,Wyatt Kaiser,D,CHI,22,0,0,0,0
49,8476988,Matt Benning,D,SJS,30,0,0,0,0
49,8479370,Tyson Jost,C,CAR,26,0,0,0,0
49,8477464,Nic Petan,C,,29,0,0,0,0
49,8477380,Jonny Brodzinski,C,NYR,31,0,0,0,0
49,8480070,Ian Mitchell,D,BOS,25,0,0,0,0
49,8479315,Joey Anderson,R,CHI,26,0,0,0,0
49,8478099,Kevin Labanc,R,,29,0,0,0,0
49,8476874,Olli Maatta,D,DET,30,0,0,0,0
49,8475208,Brian Dumoulin,D,ANA,33,0,0,0,0
49,8478430,Oliver Kylington,D,,27,0,0,0,0
49,8479536,Axel Jonsson-Fjallby,L,WPG,26,0,0,0,0
49,8479671,Mathieu Olivier,R,CBJ,27,0,0,0,0
49,8471709,Marc-Edouard Vlasic,D,SJS,37,0,0,0,0
49,8479328,Julien Gauthier,R,NYI,27,0,0,0,0
49,8478421,A.J. Greer,L,FLA,28,0,0,0,0
49,8477573,Nathan Walker,L,STL,30,0,0,0,0
49,8481537,Nikita Okhotiuk,D,CGY,24,0,0,0,0
49,8474166,Alec Martinez,D,CHI,37,0,0,0,0
49,8470610,Zach Parise,L,,40,0,0,0,0
49,8477478,William Carrier,L,CAR,30,0,0,0,0
49,8479344,Jesse Puljujarvi,R,PIT,26,0,0,0,0
49,8480887,Jordan Harris,D,MTL,24,0,0,0,0
49,8478502,Dennis Gilbert,D,BUF,28,0,0,0,0
49,8482730,Brandt Clarke,D,LAK,21,0,0,0,0
49,8480355,Mark Kastelic,C,BOS,25,0,0,0,0
49,8475750,Jon Merrill,D,MIN,32,0,0,0,0
49,8475164,Jakob Silfverberg,R,,34,0,0,0,0
49,8477944,Jakub Vrana,L,,28,0,0,0,0
49,8479439,Jacob MacDonald,D,COL,31,0,0,0,0
49,8474568,Luke Schenn,D,NSH,35,0,0,0,0
49,8478454,Noah Juulsen,D,VAN,27,0,0,0,0
49,8475752,Tyler Pitlick,C,,33,0,0,0,0
49,8482148,Hendrix Lapierre,C,WSH,22,0,0,0,0
49,8481167,Brayden Pachal,D,CGY,25,0,0,0,0
49,8478043,Sam Lafferty,C,BUF,29,0,0,0,0
49,8479321,Lucas Johansen,D,,27,0,0,0,0
49,8471699,Andrew Cogliano,C,,37,0,0,0,0
49,8481521,Ronnie Attard,D,PHI,25,0,0,0,0
49,8481161,Jake Christiansen,D,CBJ,25,0,0,0,0
49,8479458,Nikita Zaitsev,D,,33,0,0,0,0
49,8479619,Michael Carcone,L,UTA,28,0,0,0,0
49,8479026,Philippe Myers,D,TOR,27,0,0,0,0
49,8477330,Dominik Kubalik,L,,29,0,0,0,0
49,8481617,Vasily Podkolzin,R,VAN,23,0,0,0,0
49,8481701,Santeri Hatakka,D,NJD,23,0,0,0,0
49,8479514,Rem Pitlick,C,,27,0,0,0,0
49,8477446,Michael McCarron,R,NSH,29,0,0,0,0
49,8470604,Jeff Carter,C,,39,0,0,0,0
49,8482241,Radim Zohorna,L,,28,0,0,0,0
49,8480289,Morgan Barron,C,WPG,26,0,0,0,0
49,8479379,Givani Smith,R,SJS,26,0,0,0,0
49,8480216,Jacob Peterson,C,,25,0,0,0,0
49,8477851,Jordan Oesterle,D,BOS,32,0,0,0,0
49,8484258,Sam Malinski,D,COL,26,0,0,0,0
49,8478904,Steven Lorentz,C,,28,0,0,0,0
49,8482095,Tyler Kleven,D,OTT,22,0,0,0,0
49,8480848,Ty Dellandrea,C,SJS,24,0,0,0,0
49,8476884,Derrick Pouliot,D,,30,0,0,0,0
49,8479336,Carl Grundstrom,R,SJS,27,0,0,0,0
49,8482964,Arber Xhekaj,D,MTL,23,0,0,0,0
49,8471686,Marc Staal,D,,37,0,0,0,0
49,8477887,Patrick Brown,C,BOS,32,0,0,0,0
49,8478495,Denis Gurianov,R,,27,0,0,0,0
49,8473504,Cal Clutterbuck,R,,37,0,0,0,0
49,8481550,Adam Beckman,L,NJD,23,0,0,0,0
49,8480845,Rasmus Kupari,C,WPG,24,0,0,0,0
49,8474009,Nick Bonino,C,,36,0,0,0,0
49,8478585,Derek Ryan,C,EDM,38,0,0,0,0
49,8477962,Brendan Lemieux,L,CAR,28,0,0,0,0
49,8482861,Vincent Iorio,D,WSH,22,0,0,0,0
49,8479378,Logan Stanley,D,WPG,26,0,0,0,0
49,8473446,Erik Johnson,D,PHI,36,0,0,0,0
49,8481743,Marc Del Gaizo,D,NSH,25,0,0,0,0
49,8477384,Josh Brown,D,EDM,30,0,0,0,0
49,8482165,Yan Kuznetsov,D,CGY,22,0,0,0,0
49,8478424,Jansen Harkins,C,ANA,27,0,0,0,0
49,8482144,Jack Thompson,D,SJS,22,0,0,0,0
49,8478512,Austin Czarnik,C,,32,0,0,0,0
49,8477527,Ross Johnston,L,ANA,30,0,0,0,0
49,8479383,Boris Katchouk,L,,26,0,0,0,0
49,8482094,Daemon Hunt,D,MIN,22,0,0,0,0
49,8481719,Maxwell Crozier,D,TBL,24,0,0,0,0
49,8480192,Johnathan Kovacevic,D,NJD,27,0,0,0,0
49,8479376,Victor Mete,D,,26,0,0,0,0
49,8482511,Mason Lohrei,D,BOS,23,0,0,0,0
49,8475825,Jani Hakanpää,D,,32,0,0,0,0
49,8478021,William Lagesson,D,DET,28,0,0,0,0
49,8475795,Dylan McIlrath,D,WSH,32,0,0,0,0
49,8477846,Ryan Carpenter,C,,33,0,0,0,0
49,8481056,Spencer Stastney,D,NSH,24,0,0,0,0
49,8481564,Ryan Johnson,D,BUF,23,0,0,0,0
49,8478017,Mark Friedman,D,VAN,29,0,0,0,0
49,8479320,Max Lajoie,D,SEA,27,0,0,0,0
49,8480075,Cameron Crotty,D,MIN,25,0,0,0,0
49,8484287,Cole McWard,D,VAN,23,0,0,0,0
49,8484254,Akito Hirose,D,VAN,25,0,0,0,0
49,8483407,Brandon Scanlin,D,NYR,25,0,0,0,0
49,8480274,Philip Kemp,D,EDM,25,0,0,0,0
49,8479522,Hardy Haman Aktell,D,WSH,26,0,0,0,0
49,8480007,Jonas Rondbjerg,R,VGK,25,0,0,0,0
49,8477454,Adam Erne,L,,29,0,0,0,0
49,8481679,Maxence Guenette,D,OTT,23,0,0,0,0
49,8480441,Trey Fix-Wolansky,R,CBJ,25,0,0,0,0
49,8483546,Marshall Rifai,D,TOR,26,0,0,0,0
49,8480084,Nick DeSimone,D,NJD,30,0,0,0,0
49,8481030,Jack St. Ivany,D,PIT,25,0,0,0,0
49,8481592,Jakob Pelletier,L,CGY,23,0,0,0,0
49,8478011,Louie Belpedio,D,PHI,28,0,0,0,0
49,8477930,Pierre-Edouard Bellemare,L,,39,0,0,0,0
49,8484321,Nikolas Matinpalo,D,OTT,26,0,0,0,0
49,8482067,Connor Mackey,D,NYR,28,0,0,0,0
49,8481806,Louis Crevier,D,CHI,23,0,0,0,0
49,8484326,Patrik Koch,D,UTA,28,0,0,0,0
49,8477971,Andreas Englund,D,LAK,28,0,0,0,0
49,8481751,Lukas Rousek,R,BUF,25,0,0,0,0
49,8481006,Tyler Tucker,D,STL,24,0,0,0,0
49,8476867,Brendan Gaunce,C,MIN,30,0,0,0,0
49,8479520,Brandon Duhaime,R,WSH,27,0,0,0,0
49,8477073,Kurtis MacDermid,L,NJD,30,0,0,0,0
49,8480874,Adam Ginning,D,PHI,24,0,0,0,0
49,8477473,Justin Bailey,R,SJS,29,0,0,0,0
49,8479066,Ryan Lomberg,L,CGY,30,0,0,0,0
49,8477070,Liam O'Brien,C,UTA,30,0,0,0,0
49,8474618,Marco Scandella,D,,34,0,0,0,0
49,8475797,Jarred Tinordi,D,,32,0,0,0,0
49,8481441,Joe Snively,C,DET,28,0,0,0,0
49,8477244,Chad Ruhwedel,D,NYR,34,0,0,0,0
49,8479772,Zack MacEwen,R,OTT,28,0,0,0,0
49,8481147,Reese Johnson,C,MIN,26,0,0,0,0
49,8481043,Cole Koepke,L,BOS,26,0,0,0,0
49,8483619,Filip Roos,D,OTT,25,0,0,0,0
49,8481541,Samuel Bolduc,D,NYI,24,0,0,0,0
49,8477810,Joel Hanley,D,CGY,33,0,0,0,0
49,8476907,Mackenzie MacEachern,L,,30,0,0,0,0
49,8482652,Walker Duehr,R,CGY,27,0,0,0,0
49,8477126,Jayson Megna,C,,34,0,0,0,0
49,8483398,Declan Carlile,D,TBL,31,0,0,0,0
49,8482929,Emil Lilleberg,D,TBL,23,0,0,0,0
49,8480880,Jakub Lauko,C,MIN,24,0,0,0,0
49,8480245,Olle Lycksell,R,PHI,25,0,0,0,0
49,8480252,Cole Guttman,C,CHI,25,0,0,0,0
49,8477467,Gustav Olofsson,D,SEA,30,0,0,0,0
49,8479968,Vinni Lettieri,C,BOS,29,0,0,0,0
49,8478400,Colin White,C,,27,0,0,0,0
49,8475755,Alexander Petrovic,D,DAL,32,0,0,0,0
49,8481812,Nikolai Knyzhov,D,,27,0,0,0,0
49,8481593,Jayden Struble,D,MTL,23,0,0,0,0
49,8481532,Alex Turcotte,C,LAK,23,0,0,0,0
49,8482126,Emil Andrae,D,PHI,31,0,0,0,0
49,8479944,Zach Aston-Reese,C,VGK,30,0,0,0,0
49,8471817,Ryan Reaves,R,TOR,37,0,0,0,0
49,8481206,John Ludvig,D,PIT,24,0,0,0,0
49,8481599,Victor Soderstrom,D,UTA,23,0,0,0,0
49,8480292,Carson Meyer,R,ANA,27,0,0,0,0
49,8482496,Nils Aman,C,VAN,24,0,0,0,0
49,8479718,Alex Barré-Boulet,C,MTL,27,0,0,0,0
49,8479994,Jaret Anderson-Dolan,C,WPG,25,0,0,0,0
49,8480184,Gustav Lindstrom,D,,26,0,0,0,0
49,8480890,Jan Jenik,R,OTT,24,0,0,0,0
49,8478067,Oskar Lindblom,L,,28,0,0,0,0
49,8476934,Brock McGinn,L,ANA,30,0,0,0,0
49,8479985,Cale Fleury,D,SEA,26,0,0,0,0
49,8484304,Uvis Balinskis,D,FLA,28,0,0,0,0
49,8479981,Jonah Gadjovich,L,FLA,26,0,0,0,0
49,8481716,Dmitri Voronkov,L,CBJ,24,0,0,0,0
49,8474709,Matt Martin,L,,35,0,0,0,0
49,8482634,Alex Steeves,C,TOR,25,0,0,0,0
49,8480823,Alexander Alexeyev,D,WSH,25,0,0,0,0
49,8477541,Dakota Mermis,D,TOR,30,0,0,0,0
49,8483491,Ivan Miroshnichenko,L,WSH,20,0,0,0,0
49,8478477,Mitchell Stephens,C,SEA,27,0,0,0,0
49,8481543,Nikita Alexandrov,C,STL,24,0,0,0,0
49,8479423,Alex Nylander,L,,26,0,0,0,0
49,8482451,Mikael Pyyhtia,L,CBJ,23,0,0,0,0
49,8478831,Kevin Stenlund,C,UTA,28,0,0,0,0
49,8480306,Grant Hutton,D,NYI,29,0,0,0,0
49,8478028,Fredrik Olofsson,L,,28,0,0,0,0
49,8477462,Robert Hagg,D,VGK,29,0,0,0,0
49,8477320,Anton Blidh,L,NYR,29,0,0,0,0
49,8482157,Will Cuylle,L,NYR,22,0,0,0,0
49,8482737,Zack Bolduc,C,STL,21,0,0,0,0
49,8481239,Samuel Fagemo,L,,24,0,0,0,0
49,8481600,Tobias Bjornfot,D,FLA,23,0,0,0,0
49,8478409,Anthony Richard,C,PHI,28,0,0,0,0
49,8474145,Robert Bortuzzo,D,,35,0,0,0,0
49,8475958,Michael Sgarbossa,C,WSH,32,0,0,0,0
49,8479986,Kole Lind,R,DAL,26,0,0,0,0
49,8479249,Andrew Poturalski,C,SJS,30,0,0,0,0
49,8479362,Riley Tufte,L,BOS,26,0,0,0,0
49,8479991,Jake Leschyshyn,C,NYR,25,0,0,0,0
49,8479587,Rhett Gardner,C,PHI,28,0,0,0,0
49,8482744,James Malatesta,L,CBJ,21,0,0,0,0
49,8478854,Ryan Shea,D,PIT,27,0,0,0,0
49,8481591,Sam Poulin,R,,23,0,0,0,0
49,8483512,Matt Savoie,C,EDM,20,0,0,0,0
49,8482102,Vasily Ponomarev,C,PIT,22,0,0,0,0
49,8482162,Roby Jarventie,L,EDM,22,0,0,0,0
49,8481016,Ruslan Iskhakov,C,,24,0,0,0,0
49,8482172,Landon Slaggert,L,CHI,22,0,0,0,0
49,8482747,Brennan Othmann,L,NYR,21,0,0,0,0
49,8480031,Maxime Comtois,L,,25,0,0,0,0
49,8480226,Marián Studenic,R,,26,0,0,0,0
49,8478408,Travis Dermott,D,,28,0,0,0,0
49,8481518,Nolan Foote,L,NJD,24,0,0,0,0
49,8479419,Brett Murray,L,BUF,26,0,0,0,0
49,8482088,Justin Sourdif,R,FLA,22,0,0,0,0
49,8482201,Gage Goncalves,C,TBL,23,0,0,0,0
49,8481578,Graeme Clarke,R,MIN,23,0,0,0,0
49,8482177,Marat Khusnutdinov,C,MIN,22,0,0,0,0
49,8481754,Nikita Nesterenko,C,ANA,23,0,0,0,0
49,8483531,Brian Halonen,L,NJD,25,0,0,0,0
49,8483920,Pierrick Dube,R,WSH,23,0,0,0,0
49,8480851,Akil Thomas,C,LAK,24,0,0,0,0
49,8475235,Nicolas Deslauriers,L,PHI,33,0,0,0,0
49,8482476,Emil Heineman,L,MTL,23,0,0,0,0
49,8477149,Scott Sabourin,R,SJS,32,0,0,0,0
49,8483549,Lucas Condotta,L,MTL,27,0,0,0,0
49,8482765,Isak Rosen,R,BUF,21,0,0,0,0
49,8481237,Kyle MacLean,C,NYI,25,0,0,0,0
49,8481024,Linus Karlsson,C,VAN,25,0,0,0,0
49,8481690,Tyler Angle,C,,24,0,0,0,0
49,8483570,Ben Meyers,C,SEA,26,0,0,0,0
49,8481655,Cole Schwindt,R,CGY,23,0,0,0,0
49,8481462,Mason Morelli,L,VGK,28,0,0,0,0
49,8483401,Marc Johnstone,R,PIT,28,0,0,0,0
49,8478956,Samuel Laberge,L,NJD,27,0,0,0,0
49,8479533,Joona Koppanen,L,,26,0,0,0,0
49,8482197,Adam Raska,R,MIN,23,0,0,0,0
49,8482250,Callahan Burke,C,VGK,27,0,0,0,0
49,8482784,Zach Dean,C,STL,21,0,0,0,0
49,8484255,Jason Polin,R,COL,25,0,0,0,0
49,8481077,John Leonard,L,,26,0,0,0,0
49,8481534,Raphael Lavoie,C,EDM,24,0,0,0,0
49,8483609,Adam Klapka,R,CGY,24,0,0,0,0
49,8482751,Ryan Winterton,C,SEA,21,0,0,0,0
49,8480267,Sammy Walker,C,MIN,25,0,0,0,0
49,8475766,Austin Watson,L,,32,0,0,0,0
49,8482460,Matt Rempe,C,NYR,22,0,0,0,0
49,8481065,Angus Crookshank,L,OTT,25,0,0,0,0
49,8481070,Hugh McGing,L,,26,0,0,0,0
49,8476323,Max McCormick,L,SEA,32,0,0,0,0
49,8483395,Arshdeep Bains,L,VAN,23,0,0,0,0
49,8484259,Ondrej Pavel,C,COL,31,0,0,0,0
49,8483432,Luca Del Bel Belluz,C,CBJ,31,0,0,0,0
49,8483045,Cameron Butler,R,CBJ,31,0,0,0,0
49,8482061,Brandon Biro,L,SEA,26,0,0,0,0
49,8477401,John Hayden,C,SEA,29,0,0,0,0
49,8475278,Byron Froese,C,,33,0,0,0,0
49,8478446,Glenn Gawdin,C,LAK,27,0,0,0,0
49,8477993,Justin Kirkland,C,CGY,28,0,0,0,0
49,8482147,Jean-Luc Foudy,C,COL,22,0,0,0,0
49,8480032,Shane Bowers,C,NJD,25,0,0,0,0
49,8479330,Brandon Gignac,C,MTL,27,0,0,0,0
49,8480776,Sheldon Rempal,R,,29,0,0,0,0
49,8475413,Justin Dowling,C,NJD,34,0,0,0,0
49,8481726,Adam Edstrom,C,NYR,24,0,0,0,0
49,8480844,Grigori Denisenko,L,VGK,24,0,0,0,0
49,8478147,Bokondji Imama,L,PIT,28,0,0,0,0
49,8478881,Brett Seney,L,CHI,28,0,0,0,0
49,8483630,Pavol Regenda,L,ANA,25,0,0,0,0
49,8480836,Jonathan Gruden,C,,24,0,0,0,0
49,8484314,Jiri Smejkal,L,,28,0,0,0,0
49,8475780,Chris Wagner,R,COL,33,0,0,0,0
49,8479546,Oskar Steen,C,,26,0,0,0,0
49,8483597,Milos Kelemen,L,UTA,25,0,0,0,0
49,8481789,Tye Kartye,L,SEA,23,0,0,0,0
49,8484325,Waltteri Merela,C,TBL,26,0,0,0,0
49,8479421,Jacob Moverare,D,LAK,26,0,0,0,0
49,8481585,Egor Afanasyev,L,SJS,23,0,0,0,0
49,8479547,Matthew Phillips,R,,26,0,0,0,0
49,8479367,William Lockwood,R,FLA,26,0,0,0,0
49,8476915,Jujhar Khaira,L,,30,0,0,0,0
49,8481422,Jacob Lucchini,C,NSH,29,0,0,0,0
49,8480468,James Hamblin,L,EDM,25,0,0,0,0
49,8478051,Max Willman,C,NJD,29,0,0,0,0
49,8481556,John Beecher,C,BOS,23,0,0,0,0
49,8478078,Rourke Chartier,C,,28,0,0,0,0
50,8477492,Nathan MacKinnon,C,COL,29,82,50,92,142
50,8476453,Nikita Kucherov,R,TBL,31,82,46,95,141
50,8478402,Connor McDavid,C,EDM,27,82,45,93,138
50,8481559,Jack Hughes,C,NJD,23,82,53,78,131
50,8478420,Mikko Rantanen,R,COL,28,82,55,68,123
50,8477956,David Pastrnak,R,BOS,28,82,62,56,118
50,8479318,Auston Matthews,C,TOR,27,82,74,43,117
50,8478864,Kirill Kaprizov,L,MIN,27,82,44,64,108
50,8477934,Leon Draisaitl,C,EDM,29,82,38,67,105
50,8479314,Matthew Tkachuk,L,FLA,27,82,37,66,103
50,8482116,Tim Stützle,C,OTT,22,82,37,66,103
50,8480069,Cale Makar,D,COL,26,82,32,71,103
50,8477933,Sam Reinhart,C,FLA,29,82,51,51,102
50,8476468,J.T. Miller,C,VAN,31,82,32,70,102
50,8477946,Dylan Larkin,C,DET,28,82,42,59,101
50,8478550,Artemi Panarin,L,NYR,33,82,36,64,100
50,8480012,Elias Pettersson,C,VAN,26,82,33,66,99
50,8479407,Jesper Bratt,L,NJD,26,82,33,63,96
50,8478010,Brayden Point,C,TBL,28,82,46,49,95
50,8478427,Sebastian Aho,C,CAR,27,82,42,53,95
50,8477493,Aleksander Barkov,C,FLA,29,82,39,56,95
50,8477939,William Nylander,R,TOR,28,82,36,59,95
50,8480023,Robert Thomas,C,STL,25,82,30,64,94
50,8478445,Mathew Barzal,C,NYI,27,82,18,76,94
50,8480801,Brady Tkachuk,L,OTT,25,82,48,43,91
50,8478440,Dylan Strome,C,WSH,27,82,34,57,91
50,8479385,Jordan Kyrou,C,STL,26,82,32,58,90
50,8479343,Clayton Keller,R,UTA,26,82,36,52,88
50,8480027,Jason Robertson,L,DAL,25,82,33,55,88
50,8474600,Roman Josi,D,NSH,34,82,17,69,86
50,8477402,Pavel Buchnevich,L,STL,29,82,34,51,85
50,8479323,Adam Fox,D,NYR,26,82,23,62,85
50,8477951,Nick Schmaltz,C,UTA,28,82,39,45,84
50,8478403,Jack Eichel,C,VGK,28,82,38,45,83
50,8475798,Mikael Granlund,C,SJS,32,82,18,65,83
50,8475692,Mats Zuccarello,R,MIN,37,82,15,68,83
50,8480830,Andrei Svechnikov,R,CAR,24,82,33,48,81
50,8479337,Alex DeBrincat,R,DET,27,82,32,49,81
50,8478439,Travis Konecny,R,PHI,27,82,31,50,81
50,8471675,Sidney Crosby,C,PIT,37,82,31,50,81
50,8477447,Shea Theodore,D,VGK,29,82,19,62,81
50,8480800,Quinn Hughes,D,VAN,25,82,7,74,81
50,8478444,Brock Boeser,R,VAN,27,82,40,40,80
50,8480002,Nico Hischier,C,NJD,25,82,36,44,80
50,8477942,Kevin Fiala,L,LAK,28,82,34,46,80
50,8479542,Brandon Hagel,L,TBL,26,82,35,44,79
50,8477404,Jake Guentzel,C,TBL,30,82,31,48,79
50,8471215,Evgeni Malkin,C,PIT,38,82,30,49,79
50,8475172,Nazem Kadri,C,CGY,34,82,28,51,79
50,8480208,Drake Batherson,R,OTT,26,82,23,56,79
50,8476456,Jonathan Huberdeau,C,CGY,31,82,16,63,79
50,8477940,Nikolaj Ehlers,L,WPG,28,82,39,39,78
50,8480839,Rasmus Dahlin,D,BUF,24,82,20,58,78
50,8474590,John Carlson,D,WSH,34,82,18,60,78
50,8475784,Jeff Skinner,C,EDM,32,82,40,37,77
50,8473419,Brad Marchand,L,BOS,36,82,33,44,77
50,8477960,Adrian Kempe,R,LAK,28,82,32,44,76
50,8481557,Matt Boldy,L,MIN,23,82,29,47,76
50,8480018,Nick Suzuki,C,MTL,25,82,26,50,76
50,8477496,Elias Lindholm,C,BOS,30,82,24,52,76
50,8477500,Bo Horvat,C,NYI,29,82,45,30,75
50,8479420,Tage Thompson,C,BUF,27,82,37,38,75
50,8475786,Zach Hyman,L,EDM,32,82,33,42,75
50,8475765,Vladimir Tarasenko,R,DET,33,82,29,46,75
50,8480036,Miro Heiskanen,D,DAL,25,82,11,64,75
50,8475184,Chris Kreider,L,NYR,33,82,45,29,74
50,8476887,Filip Forsberg,L,NSH,30,82,41,33,74
50,8478398,Kyle Connor,L,WPG,28,82,39,35,74
50,8475810,Bryan Rust,R,PIT,32,82,38,36,74
50,8477409,Carter Verhaeghe,C,FLA,29,82,35,39,74
50,8471214,Alex Ovechkin,L,WSH,39,82,35,39,74
50,8476448,William Karlsson,C,VGK,31,82,29,45,74
50,8477497,Sean Monahan,C,CBJ,30,82,27,47,74
50,8476459,Mika Zibanejad,C,NYR,31,82,20,54,74
50,8481523,Kirby Dach,C,MTL,23,82,18,56,74
50,8477504,Josh Morrissey,D,WPG,29,82,15,59,74
50,8476346,Johnny Gaudreau,L,CBJ,31,82,15,59,74
50,8477501,Valeri Nichushkin,R,COL,29,82,37,36,73
50,8475913,Mark Stone,R,VGK,32,82,21,52,73
50,8477949,Alex Tuch,R,BUF,28,82,20,53,73
50,8476389,Vincent Trocheck,C,NYR,31,82,29,43,72
50,8478449,Roope Hintz,C,DAL,28,82,28,44,72
50,8480865,Noah Dobson,D,NYI,24,82,15,57,72
50,8475168,Matt Duchene,C,DAL,33,82,38,33,71
50,8477476,Artturi Lehkonen,L,COL,29,82,33,38,71
50,8474141,Patrick Kane,R,DET,36,82,32,39,71
50,8478401,Pavel Zacha,C,BOS,27,82,22,48,70
50,8478460,Zach Werenski,D,CBJ,27,82,18,52,70
50,8478414,Timo Meier,R,NJD,28,82,30,39,69
50,8473512,Claude Giroux,R,OTT,36,82,23,46,69
50,8476454,Ryan Nugent-Hopkins,C,EDM,31,82,13,56,69
50,8482078,Lucas Raymond,L,DET,22,82,27,41,68
50,8478397,Rasmus Andersson,D,CGY,28,82,12,56,68
50,8482149,Cole Perfetti,C,WPG,22,82,23,44,67
50,8475167,Victor Hedman,D,TBL,34,82,15,52,67
50,8477955,Jared McCann,L,SEA,28,82,36,30,66
50,8474578,Erik Karlsson,D,PIT,34,82,19,46,65
50,8479325,Charlie McAvoy,D,BOS,27,82,15,50,65
50,8480014,Gabriel Vilardi,C,WPG,25,82,42,22,64
50,8476881,Tomas Hertl,C,VGK,31,82,34,30,64
50,8473994,Jamie Benn,L,DAL,35,82,29,35,64
50,8475745,Charlie Coyle,C,BOS,32,82,23,41,64
50,8478975,Mason Marchment,L,DAL,29,82,21,43,64
50,8476905,Chandler Stephenson,C,SEA,30,82,20,44,64
50,8479999,Casey Mittelstadt,C,COL,26,82,17,47,64
50,8477451,Ryan Hartman,R,MIN,30,82,33,30,63
50,8478493,Joel Eriksson Ek,C,MIN,27,82,33,30,63
50,8482665,Matty Beniers,C,SEA,22,82,29,34,63
50,8471685,Anze Kopitar,C,LAK,37,82,21,42,63
50,8475754,Brock Nelson,C,NYI,33,82,30,32,62
50,8477416,Oliver Bjorkstrand,R,SEA,29,82,28,34,62
50,8482097,Jack Quinn,R,BUF,23,82,27,35,62
50,8475166,John Tavares,C,TOR,34,82,24,38,62
50,8480078,Filip Chytil,C,NYR,25,82,19,43,62
50,8482093,Seth Jarvis,C,CAR,22,82,34,27,61
50,8476460,Mark Scheifele,C,WPG,31,82,27,34,61
50,8475726,Tyler Toffoli,C,SJS,32,82,26,35,61
50,8474564,Steven Stamkos,C,NSH,34,82,25,36,61
50,8476462,Dougie Hamilton,D,NJD,31,82,21,40,61
50,8478038,Devon Toews,D,COL,30,82,12,49,61
50,8476539,Jonathan Marchessault,R,NSH,34,82,32,28,60
50,8475170,Brayden Schenn,C,STL,33,82,32,28,60
50,8477935,Sam Bennett,C,FLA,28,82,30,30,60
50,8481533,Trevor Zegras,C,ANA,23,82,26,34,60
50,8482113,Anton Lundell,C,FLA,23,82,25,35,60
50,8477407,Anthony Duclair,L,NYI,29,82,25,34,59
50,8478047,Michael Bunting,L,PIT,29,82,21,38,59
50,8477964,Ivan Barbashev,C,VGK,29,82,16,43,59
50,8481540,Cole Caufield,R,MTL,23,82,30,27,57
50,8476432,Boone Jenner,C,CBJ,31,82,29,28,57
50,8478873,Troy Terry,R,ANA,27,82,25,32,57
50,8481528,Dylan Cozens,C,BUF,23,82,24,33,57
50,8477429,Andrew Copp,C,DET,30,82,23,34,57
50,8478042,Viktor Arvidsson,R,EDM,31,82,21,36,57
50,8474565,Alex Pietrangelo,D,VGK,34,82,13,44,57
50,8481068,Yegor Sharangovich,C,CGY,26,82,33,23,56
50,8479339,Patrik Laine,L,CBJ,26,82,25,31,56
50,8474053,Logan Couture,C,SJS,35,82,25,31,56
50,8478519,Anthony Cirelli,C,TBL,27,82,23,33,56
50,8481596,Shane Pinto,C,OTT,24,82,22,34,56
50,8477503,Max Domi,C,TOR,29,82,11,45,56
50,8480803,Evan Bouchard,D,EDM,25,82,10,46,56
50,8478498,Jake DeBrusk,L,VAN,28,82,35,20,55
50,8480015,Owen Tippett,R,PHI,25,82,28,27,55
50,8476483,Rickard Rakell,R,PIT,31,82,28,27,55
50,8483808,Andrei Kuzmenko,L,CGY,28,82,26,29,55
50,8480039,Martin Necas,C,CAR,25,82,25,30,55
50,8473986,Alex Killorn,L,ANA,35,82,24,31,55
50,8475793,Ryan Johansen,C,PHI,32,82,22,33,55
50,8478856,Conor Garland,R,VAN,28,82,20,35,55
50,8476826,Yanni Gourde,C,SEA,33,82,20,35,55
50,8476853,Morgan Rielly,D,TOR,30,82,14,41,55
50,8471724,Kris Letang,D,PIT,37,82,11,44,55
50,8475768,Jaden Schwartz,C,SEA,32,82,21,33,54
50,8474586,Jordan Eberle,R,SEA,34,82,20,34,54
50,8478233,Andrew Mangiapane,L,WSH,28,82,20,33,53
50,8477494,Jonathan Drouin,L,COL,29,82,18,35,53
50,8476906,Shayne Gostisbehere,D,CAR,31,82,12,41,53
50,8479410,Mikhail Sergachev,D,UTA,26,82,8,45,53
50,8482159,Tyson Foerster,R,PHI,22,82,30,22,52
50,8476880,Tom Wilson,R,WSH,30,82,29,23,52
50,8475158,Ryan O'Reilly,C,NSH,33,82,27,25,52
50,8475287,Erik Haula,L,NJD,33,82,23,29,52
50,8474679,Gustav Nyquist,C,NSH,35,82,22,30,52
50,8478366,Frank Vatrano,R,ANA,30,82,22,30,52
50,8476872,Scott Laughton,C,PHI,30,82,18,34,52
50,8479400,Pierre-Luc Dubois,L,WSH,26,82,18,34,52
50,8480188,Fabian Zetterlund,L,SJS,25,82,17,35,52
50,8479345,Jakob Chychrun,D,WSH,26,82,15,37,52
50,8482699,Dylan Guenther,R,UTA,21,82,30,21,51
50,8474641,Adam Henrique,C,EDM,34,82,29,22,51
50,8478474,Lawson Crouse,L,UTA,27,82,25,26,51
50,8476474,Stefan Noesen,R,NJD,31,82,21,30,51
50,8477021,Alex Kerfoot,C,UTA,30,82,18,33,51
50,8479525,Ross Colton,C,COL,28,82,26,24,50
50,8481560,Arthur Kaliyev,R,LAK,23,82,25,25,50
50,8475714,Calle Jarnkrok,C,TOR,33,82,23,27,50
50,8478115,Pierre Engvall,L,NYI,28,82,21,29,50
50,8482109,Alexis Lafrenière,L,NYR,23,82,19,31,50
50,8482667,William Eklund,L,SJS,22,82,19,31,50
50,8480220,Noah Cates,L,PHI,25,82,18,32,50
50,8476458,Ryan Strome,C,ANA,31,82,14,36,50
50,8481711,Matias Maccelli,L,UTA,24,82,11,39,50
50,8477986,Brandon Montour,D,SEA,30,82,11,39,50
50,8481618,Alex Newhook,C,MTL,23,82,23,26,49
50,8479675,Trevor Moore,L,LAK,29,82,22,27,49
50,8476927,Teddy Blueger,C,VAN,30,82,21,28,49
50,8474102,David Perron,L,OTT,36,82,15,34,49
50,8470613,Brent Burns,D,CAR,39,82,14,35,49
50,8476875,Mike Matheson,D,MTL,30,82,12,37,49
50,8477948,Travis Sanheim,D,PHI,28,82,12,37,49
50,8482684,Luke Hughes,D,NJD,21,82,9,40,49
50,8475169,Evander Kane,L,EDM,33,82,33,15,48
50,8477479,Tyler Bertuzzi,L,CHI,29,82,24,24,48
50,8474149,Evgenii Dadonov,R,DAL,35,82,24,24,48
50,8475760,Nick Bjugstad,C,UTA,32,82,23,25,48
50,8480797,Joel Farabee,L,PHI,24,82,18,30,48
50,8480009,Eeli Tolvanen,R,SEA,25,82,16,32,48
50,8477495,Seth Jones,D,CHI,30,82,14,34,48
50,8478055,Gustav Forsling,D,FLA,28,82,10,38,48
50,8476958,Jaccob Slavin,D,CAR,30,82,10,38,48
50,8478407,Vince Dunn,D,SEA,28,82,7,41,48
50,8479591,Michael Eyssimont,C,TBL,28,82,23,24,47
50,8479365,Trent Frederic,C,BOS,26,82,22,25,47
50,8476461,Sean Couturier,C,PHI,32,82,16,31,47
50,8477444,Andre Burakovsky,L,SEA,29,82,16,31,47
50,8476854,Hampus Lindholm,D,BOS,30,82,11,36,47
50,8476399,Blake Coleman,C,CGY,33,82,30,16,46
50,8480849,Barrett Hayton,C,UTA,24,82,25,21,46
50,8471698,T.J. Oshie,R,WSH,38,82,22,24,46
50,8477947,Sonny Milano,L,WSH,28,82,22,24,46
50,8477998,Warren Foegele,L,LAK,28,82,21,25,46
50,8477932,Aaron Ekblad,D,FLA,28,82,13,33,46
50,8480028,Morgan Frost,C,PHI,25,82,13,33,46
50,8477346,MacKenzie Weegar,D,CGY,30,82,11,35,46
50,8474716,Jared Spurgeon,D,MIN,35,82,11,35,46
50,8481581,Thomas Harley,D,DAL,23,82,10,36,46
50,8481542,Moritz Seider,D,DET,23,82,8,38,46
50,8474563,Drew Doughty,D,LAK,35,82,8,38,46
50,8482740,Wyatt Johnston,C,DAL,21,82,24,21,45
50,8475799,Nino Niederreiter,R,WPG,32,82,24,21,45
50,8481013,Jonatan Berggren,R,DET,24,82,24,21,45
50,8479992,Michael Rasmussen,C,DET,25,82,20,25,45
50,8479987,Morgan Geekie,C,BOS,26,82,20,25,45
50,8475191,Reilly Smith,R,NYR,33,82,19,26,45
50,8475218,Mattias Ekholm,D,EDM,34,82,17,28,45
50,8478438,Tommy Novak,C,NSH,27,82,15,30,45
50,8478469,Thomas Chabot,D,OTT,27,82,15,30,45
50,8477426,Nicholas Paul,L,TBL,29,82,15,30,45
50,8479425,Filip Hronek,D,VAN,27,82,9,36,45
50,8480893,Kirill Marchenko,R,CBJ,24,82,26,18,44
50,8482745,Mason McTavish,C,ANA,21,82,24,20,44
50,8474715,Cam Atkinson,R,TBL,35,82,20,24,44
50,8475343,Nic Dowd,C,WSH,34,82,18,26,44
50,8479293,Brandon Tanev,L,SEA,33,82,18,26,44
50,8476329,Travis Boyd,C,MIN,31,82,13,31,44
50,8478891,Mason Appleton,C,WPG,28,82,12,32,44
50,8476869,Brady Skjei,D,NSH,30,82,11,33,44
50,8476792,Torey Krug,D,STL,33,82,9,35,44
50,8475764,Cam Fowler,D,ANA,33,82,4,40,44
50,8475151,Kyle Palmieri,C,NYI,33,82,28,15,43
50,8480064,Josh Norris,C,OTT,25,82,23,20,43
50,8478472,Mathieu Joseph,R,STL,27,82,21,22,43
50,8481535,Nils Hoglander,L,VAN,24,82,20,23,43
50,8475791,Taylor Hall,L,CHI,33,82,16,27,43
50,8475753,Justin Faulk,D,STL,32,82,12,31,43
50,8476438,Brandon Saad,L,STL,32,82,24,18,42
50,8480798,Philipp Kurashev,C,CHI,25,82,18,24,42
50,8478046,Danton Heinen,L,VAN,29,82,18,24,42
50,8476479,Phillip Danault,C,LAK,31,82,12,30,42
50,8482079,Marco Rossi,C,MIN,23,82,23,18,41
50,8482124,Quinton Byfield,R,LAK,22,82,20,21,41
50,8482720,Matthew Knies,L,TOR,22,82,16,25,41
50,8478413,Jordan Greenway,L,BUF,27,82,15,26,41
50,8474150,Mikael Backlund,C,CGY,35,82,14,27,41
50,8477456,J.T. Compher,L,DET,29,82,14,27,41
50,8476480,Vladislav Namestnikov,C,WPG,32,82,12,29,41
50,8482671,Owen Power,D,BUF,22,82,10,31,41
50,8476892,Colton Parayko,D,STL,31,82,5,36,41
50,8475794,Tyler Seguin,C,DAL,32,82,23,17,40
50,8481554,Kaapo Kakko,R,NYR,23,82,19,21,40
50,8481580,Connor McMichael,C,WSH,23,82,18,22,40
50,8476374,Sean Kuraly,C,CBJ,31,82,16,24,40
50,8479398,Samuel Girard,D,COL,26,82,9,31,40
50,8478458,Jack Roslovic,C,CAR,27,82,8,32,40
50,8476979,Erik Gustafsson,D,DET,32,82,4,36,40
50,8476981,Josh Anderson,R,MTL,30,82,23,16,39
50,8477839,Conor Sheary,L,TBL,32,82,16,23,39
50,8482705,Cole Sillinger,C,CBJ,21,82,15,24,39
50,8482105,Jake Sanderson,D,OTT,22,82,13,26,39
50,8478396,Noah Hanifin,D,VGK,27,82,11,28,39
50,8479976,Juuso Valimaki,D,UTA,26,82,9,30,39
50,8480434,Sean Durzi,D,UTA,26,82,6,33,39
50,8474151,Ryan McDonagh,D,TBL,35,82,5,34,39
50,8482089,Jake Neighbours,L,STL,22,82,24,14,38
50,8481186,Logan O'Connor,R,COL,28,82,18,20,38
50,8477987,Ryan Donato,C,CHI,28,82,17,21,38
50,8482146,Luke Evangelista,R,NSH,22,82,16,22,38
50,8480185,Eetu Luostarinen,C,FLA,26,82,15,23,38
50,8478463,Anthony Beauvillier,L,PIT,27,82,15,23,38
50,8478013,Jake Walman,D,SJS,28,82,15,23,38
50,8481656,Aliaksei Protas,C,WSH,23,82,13,25,38
50,8480855,Jack McBain,C,UTA,24,82,11,27,38
50,8473563,Nicklas Backstrom,C,WSH,37,82,10,28,38
50,8480871,Adam Boqvist,D,FLA,24,82,9,29,38
50,8481546,Cam York,D,PHI,23,82,8,30,38
50,8482175,JJ Peterka,R,BUF,22,82,20,17,37
50,8482110,Dawson Mercer,C,NJD,23,82,20,17,37
50,8477511,Anthony Mantha,R,CGY,30,82,17,20,37
50,8482055,Drew O'Connor,L,PIT,26,82,17,20,37
50,8476882,Teuvo Teravainen,L,CHI,30,82,16,21,37
50,8475763,Kevin Hayes,R,PIT,32,82,16,21,37
50,8477953,Kasperi Kapanen,R,STL,28,82,14,23,37
50,8477989,Christian Dvorak,C,MTL,28,82,13,24,37
50,8479661,Tanner Jeannot,L,LAK,27,82,13,24,37
50,8477498,Darnell Nurse,D,EDM,29,82,12,25,37
50,8478542,Evan Rodrigues,C,FLA,31,82,8,29,37
50,8476923,Damon Severson,D,CBJ,30,82,8,29,37
50,8478507,John Marino,D,UTA,27,82,4,33,37
50,8481604,Pavel Dorofeyev,L,VGK,24,82,23,13,36
50,8482092,Ridly Greig,C,OTT,22,82,17,19,36
50,8483515,Juraj Slafkovsky,L,MTL,20,82,15,21,36
50,8475220,Marcus Foligno,L,MIN,33,82,14,22,36
50,8480003,Jesper Boqvist,C,FLA,26,82,12,24,36
50,8475171,Oliver Ekman-Larsson,D,TOR,33,82,7,29,36
50,8482655,J.J. Moser,D,TBL,24,82,4,32,36
50,8478057,Dakota Joshua,C,VAN,28,82,20,15,35
50,8478109,Victor Olofsson,L,VGK,29,82,18,17,35
50,8478462,Nicolas Roy,C,VGK,27,82,17,18,35
50,8475855,Jesper Fast,R,CAR,33,82,15,20,35
50,8473533,Jordan Staal,C,CAR,36,82,13,22,35
50,8475722,Jason Zucker,L,BUF,32,82,18,16,34
50,8479414,Nathan Bastian,R,NJD,27,82,16,18,34
50,8476897,Oskar Sundqvist,C,STL,30,82,14,20,34
50,8476419,Jean-Gabriel Pageau,C,NYI,32,82,11,23,34
50,8476392,Adam Lowry,C,WPG,31,82,8,26,34
50,8478500,Ivan Provorov,D,CBJ,27,82,7,27,34
50,8477488,Brett Pesce,D,NJD,30,82,6,28,34
50,8480145,Neal Pionk,D,WPG,29,82,5,29,34
50,8477969,Marcus Pettersson,D,PIT,28,82,4,30,34
50,8470621,Corey Perry,R,EDM,39,82,20,13,33
50,8483431,Logan Cooley,C,UTA,20,82,20,13,33
50,8480829,Jesperi Kotkaniemi,C,CAR,24,82,17,16,33
50,8480835,Jack Drury,C,CAR,24,82,14,19,33
50,8482133,Thomas Bordeleau,C,SJS,22,82,14,19,33
50,8480748,Kiefer Sherwood,L,VAN,29,82,13,20,33
50,8476292,Ondrej Palat,L,NJD,33,82,12,21,33
50,8481624,Ilya Mikheyev,R,CHI,30,82,11,22,33
50,8476873,Mark Jankowski,C,NSH,30,82,11,22,33
50,8473507,Jeff Petry,D,DET,37,82,5,28,33
50,8477952,Robby Fabbri,C,ANA,28,82,20,12,32
50,8484144,Connor Bedard,C,CHI,19,82,18,14,32
50,8477425,Miles Wood,L,COL,29,82,18,14,32
50,8482475,Yegor Chinakhov,R,CBJ,23,82,15,17,32
50,8474189,Lars Eller,C,PIT,35,82,14,18,32
50,8482125,Alexander Holtz,R,VGK,22,82,14,18,32
50,8476925,Colton Sissons,C,NSH,31,82,13,19,32
50,8480802,Ryan McLeod,C,BUF,25,82,12,20,32
50,8481517,Brett Leason,R,ANA,25,82,12,20,32
50,8476921,Jordan Martinook,L,CAR,32,82,9,23,32
50,8480817,K'Andre Miller,D,NYR,24,82,5,27,32
50,8479996,Cody Glass,C,NSH,25,82,14,17,31
50,8480448,Parker Kelly,L,COL,25,82,14,17,31
50,8480068,Ryan Poehling,C,PHI,25,82,13,18,31
50,8476889,Radek Faksa,C,STL,30,82,11,20,31
50,8477919,Frederick Gaudreau,C,MIN,31,82,9,22,31
50,8477506,Ryan Pulock,D,NYI,30,82,5,26,31
50,8480873,Rasmus Sandin,D,WSH,24,82,3,28,31
50,8479941,Justin Danforth,R,CBJ,31,82,21,9,30
50,8480113,Alex Iafallo,L,WPG,31,82,20,10,30
50,8479353,Brett Howden,C,VGK,26,82,15,15,30
50,8481582,Nicholas Robertson,L,TOR,23,82,14,16,30
50,8480144,David Kampf,C,TOR,29,82,14,16,30
50,8479390,Taylor Raddysh,R,WSH,26,82,12,18,30
50,8476960,Andreas Athanasiou,C,CHI,30,82,12,18,30
50,8476931,Jake McCabe,D,TOR,31,82,3,27,30
50,8478840,Will Borgen,D,SEA,28,82,2,28,30
50,8475848,Brendan Gallagher,R,MTL,32,82,15,14,29
50,8482660,Kent Johnson,C,CBJ,22,82,12,17,29
50,8478911,Matt Roy,D,WSH,29,82,12,17,29
50,8475193,Tomas Tatar,L,NJD,34,82,10,19,29
50,8479983,Mario Ferraro,D,SJS,26,82,10,19,29
50,8474574,Tyler Myers,D,VAN,34,82,7,22,29
50,8482624,Daniil Miromanov,D,CGY,27,82,7,22,29
50,8481606,Jordan Spence,D,LAK,23,82,6,23,29
50,8480073,Erik Brannstrom,D,COL,25,82,5,24,29
50,8476917,Adam Pelech,D,NYI,30,82,2,27,29
50,8480043,Timothy Liljegren,D,TOR,25,82,1,28,29
50,8479393,Noah Gregor,C,OTT,26,82,17,11,28
50,8477903,Garnet Hathaway,R,PHI,33,82,17,11,28
50,8480789,Oliver Wahlstrom,R,NYI,24,82,14,14,28
50,8482062,Cole Smith,L,NSH,29,82,14,14,28
50,8477406,Mattias Janmark,C,EDM,32,82,12,16,28
50,8482117,Lukas Reichel,L,CHI,22,82,11,17,28
50,8478133,Jake Evans,C,MTL,28,82,9,19,28
50,8482101,Danil Gushchin,L,SJS,22,82,8,20,28
50,8476463,Jonas Brodin,D,MIN,31,82,6,22,28
50,8479351,Sam Steel,C,DAL,26,82,6,22,28
50,8482142,Jamie Drysdale,D,PHI,22,82,5,23,28
50,8477220,Nate Schmidt,D,FLA,33,82,4,24,28
50,8475188,Brayden McNabb,D,VGK,33,82,4,24,28
50,8481178,Egor Zamula,D,PHI,24,82,3,25,28
50,8478851,Alexandre Carrier,D,NSH,28,82,3,25,28
50,8482155,Alex Laferriere,R,LAK,23,82,17,10,27
50,8475314,Anders Lee,L,NYI,34,82,16,11,27
50,8481601,Simon Holmstrom,R,NYI,23,82,14,13,27
50,8477369,Carson Soucy,D,VAN,30,82,13,14,27
50,8476885,Jacob Trouba,D,NYR,30,82,12,15,27
50,8476918,Jimmy Vesey,L,NYR,31,82,11,16,27
50,8481522,Peyton Krebs,C,BUF,23,82,10,17,27
50,8480813,Joe Veleno,C,DET,24,82,10,17,27
50,8478416,Erik Cernak,D,TBL,27,82,9,18,27
50,8479368,Max Jones,L,BOS,26,82,7,20,27
50,8483763,Maksymilian Szuber,D,UTA,22,82,7,20,27
50,8476331,Dylan DeMelo,D,WPG,31,82,6,21,27
50,8475279,Ben Chiarot,D,DET,33,82,3,24,27
50,8476469,Joel Armia,R,MTL,31,82,14,12,26
50,8481032,Paul Cotter,C,NJD,25,82,14,12,26
50,8481477,Nico Sturm,C,SJS,29,82,12,14,26
50,8475149,Marcus Johansson,L,MIN,34,82,11,15,26
50,8480995,Pontus Holmberg,R,TOR,25,82,11,15,26
50,8477353,Tyler Motte,C,DET,29,82,11,15,26
50,8480074,Alexandre Texier,C,STL,25,82,10,16,26
50,8478020,Michael Amadio,C,OTT,28,82,10,16,26
50,8480336,Sean Walker,D,CAR,30,82,9,17,26
50,8483457,Lane Hutson,D,MTL,20,82,9,17,26
50,8482666,Scott Morrow,D,CAR,22,82,9,17,26
50,8482679,Matt Coronato,R,CGY,22,82,9,17,26
50,8482073,Braden Schneider,D,NYR,23,82,7,19,26
50,8478882,Vladislav Gavrikov,D,LAK,29,82,6,20,26
50,8476525,Colin Miller,D,WPG,32,82,4,22,26
50,8475455,Brenden Dillon,D,NJD,34,82,3,23,26
50,8482245,Artem Zub,D,OTT,29,82,2,24,26
50,8475181,Nick Leddy,D,STL,33,82,2,24,26
50,8480281,Alexey Toropchenko,R,STL,25,82,16,9,25
50,8478211,Dryden Hunt,L,CGY,29,82,13,12,25
50,8478432,Christian Fischer,R,DET,27,82,12,13,25
50,8481028,Martin Pospisil,C,CGY,25,82,11,14,25
50,8477015,Connor Brown,R,EDM,30,82,9,16,25
50,8480459,Pius Suter,C,VAN,28,82,8,17,25
50,8482166,Shakir Mukhamadullin,D,SJS,22,82,8,17,25
50,8476467,Jamie Oleksiak,D,SEA,32,82,8,17,25
50,8479369,Andrew Peeke,D,BOS,26,82,7,18,25
50,8476312,Josh Manson,D,COL,33,82,6,19,25
50,8482111,Justin Barron,D,MTL,23,82,6,19,25
50,8476891,Matt Grzelcyk,D,PIT,30,82,5,20,25
50,8476902,Esa Lindell,D,DAL,30,82,5,20,25
50,8482087,Kaiden Guhle,D,MTL,22,82,4,21,25
50,8475324,Nick Jensen,D,OTT,34,82,4,21,25
50,8476878,Zemgus Girgensons,L,TBL,30,82,13,11,24
50,8478569,Noel Acciari,C,PIT,33,82,12,12,24
50,8479316,Luke Kunin,C,SJS,27,82,11,13,24
50,8473422,Nick Foligno,L,CHI,37,82,9,15,24
50,8477845,Trevor van Riemsdyk,D,WSH,33,82,6,18,24
50,8477938,Haydn Fleury,D,WPG,28,82,6,18,24
50,8476429,Scott Mayfield,D,NYI,32,82,5,19,24
50,8483490,Pavel Mintyukov,D,ANA,21,82,4,20,24
50,8480035,Henri Jokiharju,D,BUF,25,82,2,22,24
50,8475790,Erik Gudbranson,D,CBJ,32,82,2,22,24
50,8481553,Bobby Brink,R,PHI,23,82,14,9,23
50,8481093,Rafael Harvey-Pinard,L,MTL,25,82,11,12,23
50,8475231,Casey Cizikas,C,NYI,33,82,10,13,23
50,8477392,Hudson Fasching,R,NYI,29,82,10,13,23
50,8482809,Jackson Blake,R,CAR,21,82,9,14,23
50,8477507,Nikita Zadorov,D,BOS,29,82,9,14,23
50,8484203,Bradly Nadeau,L,CAR,19,82,9,14,23
50,8478434,Keegan Kolesar,R,VGK,27,82,8,15,23
50,8480878,Nils Lundkvist,D,DAL,24,82,8,15,23
50,8474673,TJ Brodie,D,CHI,34,82,3,20,23
50,8481481,Blake Lizotte,C,PIT,27,82,13,9,22
50,8484166,Adam Fantilli,C,CBJ,20,82,13,9,22
50,8482762,Simon Edvinsson,D,DET,21,82,13,9,22
50,8479359,Beck Malenstyn,L,BUF,26,82,12,10,22
50,8482074,Connor Zary,C,CGY,23,82,11,11,22
50,8481567,Henry Thrun,D,SJS,23,82,11,11,22
50,8477450,Jason Dickinson,C,CHI,29,82,10,12,22
50,8473453,Trevor Lewis,C,LAK,37,82,10,12,22
50,8482858,Ryker Evans,D,SEA,23,82,10,12,22
50,8482659,Josh Doan,R,UTA,22,82,9,13,22
50,8476442,Matt Nieto,L,PIT,32,82,8,14,22
50,8482122,Brock Faber,D,MIN,22,82,7,15,22
50,8484911,Collin Graf,R,SJS,22,82,7,15,22
50,8481708,Zac Jones,D,NYR,24,82,6,16,22
50,8480807,Mattias Samuelsson,D,BUF,24,82,4,18,22
50,8475200,Dmitry Orlov,D,CAR,33,82,3,19,22
50,8478399,Jonas Siegenthaler,D,NJD,27,82,3,19,22
50,8475233,David Savard,D,MTL,34,82,2,20,22
50,8483524,Shane Wright,C,SEA,20,82,12,9,21
50,8482259,Bobby McMann,C,TOR,28,82,10,11,21
50,8480980,Connor Dewar,C,TOR,25,82,10,11,21
50,8482702,Logan Stankoven,C,DAL,21,82,9,12,21
50,8481704,Juuso Parssinen,C,NSH,23,82,7,14,21
50,8477435,Ryan Graves,D,PIT,29,82,6,15,21
50,8478443,Brandon Carlo,D,BOS,28,82,6,15,21
50,8477365,Connor Clifton,D,BUF,29,82,5,16,21
50,8476879,Cody Ceci,D,EDM,31,82,3,18,21
50,8483565,Nick Blankenburg,D,NSH,26,82,3,18,21
50,8482145,Mavrik Bourque,C,DAL,22,82,11,9,20
50,8482077,Dylan Holloway,L,EDM,23,82,11,9,20
50,8476858,Phillip Di Giuseppe,L,VAN,31,82,10,10,20
50,8479291,Kevin Rooney,C,CGY,31,82,10,10,20
50,8480806,Isac Lundestrom,C,ANA,25,82,9,11,20
50,8476422,Mike Reilly,D,NYI,31,82,6,14,20
50,8477508,Curtis Lazar,C,NJD,29,82,5,15,20
50,8480049,Dylan Samberg,D,WPG,25,82,5,15,20
50,8480796,Martin Fehervary,D,WSH,25,82,4,16,20
50,8478859,Niko Mikkola,D,FLA,28,82,2,18,20
50,8479980,Nicolas Hague,D,VGK,26,82,1,19,20
50,8475842,Sam Carrick,C,NYR,32,82,12,7,19
50,8478508,Yakov Trenin,C,MIN,27,82,10,9,19
50,8481641,Joel Kiviranta,L,COL,28,82,10,9,19
50,8483482,Tristan Luneau,D,ANA,20,82,7,12,19
50,8480025,MacKenzie Entwistle,R,FLA,25,82,7,12,19
50,8477499,Rasmus Ristolainen,D,PHI,30,82,6,13,19
50,8479324,Ryan Lindgren,D,NYR,26,82,5,14,19
50,8483445,Cutter Gauthier,L,ANA,20,82,4,15,19
50,8481014,Alexander Romanov,D,NYI,24,82,2,17,19
50,8480860,Kevin Bahl,D,CGY,24,82,2,17,19
50,8476822,Luke Glendening,C,TBL,35,82,12,6,18
50,8476624,Barclay Goodrow,C,SJS,31,82,10,8,18
50,8482141,Lukas Cormier,D,VGK,22,82,9,9,18
50,8482733,Logan Mailloux,D,MTL,31,82,7,11,18
50,8483495,Simon Nemec,D,NJD,20,82,6,12,18
50,8483499,Liam Ohgren,L,MIN,20,82,6,12,18
50,8476457,Adam Larsson,D,SEA,32,82,5,13,18
50,8474090,Brendan Smith,D,DAL,35,82,5,13,18
50,8481568,Alex Vlasic,D,CHI,23,82,3,15,18
50,8475690,Chris Tanev,D,TOR,35,82,3,15,18
50,8479402,Jake Bean,D,CGY,26,82,3,15,18
50,8478468,Jeremy Lauzon,D,NSH,27,82,3,15,18
50,8483397,Marc McLaughlin,C,BOS,25,82,10,7,17
50,8476278,Colin Blackwell,C,DAL,31,82,7,10,17
50,8478178,Darren Raddysh,D,TBL,28,82,7,10,17
50,8475462,Radko Gudas,D,ANA,34,82,5,12,17
50,8480834,Ty Emberson,D,SJS,24,82,5,12,17
50,8484153,Leo Carlsson,C,ANA,20,82,4,13,17
50,8480246,Nick Perbix,D,TBL,26,82,3,14,17
50,8475718,Justin Holl,D,DET,32,82,1,16,17
50,8480870,Bo Groulx,C,NYR,24,82,11,5,16
50,8481524,Bowen Byram,D,BUF,23,82,8,8,16
50,8484145,Zach Benson,L,BUF,19,82,7,9,16
50,8481605,Jackson LaCombe,D,ANA,23,82,7,9,16
50,8474013,Ian Cole,D,UTA,35,82,6,10,16
50,8484149,Gavin Brindley,C,CBJ,20,82,6,10,16
50,8482712,Oskar Olausson,R,COL,22,82,5,11,16
50,8480879,Jacob Bernard-Docker,D,OTT,24,82,5,11,16
50,8482803,Olen Zellweger,D,ANA,21,82,4,12,16
50,8470600,Ryan Suter,D,STL,39,82,2,14,16
50,8479638,Justin Brazeau,R,BOS,26,82,8,7,15
50,8477931,Tomas Nosek,L,FLA,32,82,7,8,15
50,8475762,Derek Forbort,D,VAN,32,82,5,10,15
50,8478136,Jake Middleton,D,MIN,28,82,3,12,15
50,8482807,Ethan Del Mastro,D,CHI,21,82,3,12,15
50,8476473,Connor Murphy,D,CHI,31,82,3,12,15
50,8477034,Jaycob Megna,D,FLA,32,82,3,12,15
50,8480172,Jan Rutta,D,SJS,34,82,2,13,15
50,8478450,Parker Wotherspoon,D,BOS,27,82,1,14,15
50,8479371,Dante Fabbro,D,NSH,26,82,0,15,15
50,8480021,Jack Studnicka,C,LAK,25,82,5,9,14
50,8474567,Zach Bogosian,D,MIN,34,82,5,9,14
50,8483493,Frank Nazar,C,CHI,20,82,4,10,14
50,8481122,Simon Benoit,D,TOR,26,82,4,10,14
50,8483505,Matthew Poitras,C,BOS,20,82,3,11,14
50,8480222,Sebastian Aho,D,PIT,28,82,2,12,14
50,8479998,Mikey Anderson,D,LAK,25,82,2,12,14
50,8475177,Calvin de Haan,D,COL,33,82,2,12,14
50,8477505,Alexander Wennberg,C,SJS,30,82,8,5,13
50,8483567,Georgii Merkulov,C,BOS,24,82,7,6,13
50,8481699,Aku Raty,R,UTA,23,82,5,8,13
50,8482859,Zack Ostapchuk,C,OTT,21,82,5,8,13
50,8479576,Vincent Desharnais,D,VAN,28,82,4,9,13
50,8482153,Brendan Brisson,C,VGK,23,82,8,4,12
50,8482713,Mackie Samoskevich,R,FLA,22,82,7,5,12
50,8483468,Jiri Kulich,C,BUF,20,82,5,7,12
50,8482749,Joshua Roy,R,MTL,21,82,3,9,12
50,8483471,Brad Lambert,C,WPG,31,82,3,9,12
50,8480950,Ilya Lyubushkin,D,DAL,30,82,2,10,12
50,8476967,Brett Kulak,D,EDM,30,82,1,11,12
50,8479442,Troy Stecher,D,EDM,30,82,1,11,12
50,8476372,Nick Seeler,D,PHI,31,82,3,8,11
50,8476441,Joel Edmundson,D,LAK,31,82,3,8,11
50,8480990,Declan Chisholm,D,MIN,24,82,1,10,11
50,8477335,Kyle Burroughs,D,LAK,29,82,1,10,11
50,8483012,Logan Morrison,C,SEA,22,82,7,3,10
50,8483460,David Jiricek,D,CBJ,21,82,3,7,10
50,8482787,Nikita Chibrikov,R,WPG,31,82,3,7,10
50,8482470,Ilya Solovyov,D,CGY,24,82,1,9,10
50,8474612,Travis Hamonic,D,OTT,34,82,1,9,10
50,8483489,Fraser Minten,C,TOR,31,82,2,7,9
50,8483466,Kevin Korchinski,D,CHI,20,82,2,7,9
50,8474062,Riley Nash,C,NYR,35,82,2,7,9
50,8478874,Adam Gaudette,C,OTT,28,82,1,8,9
50,8482516,Matthew Kessel,D,STL,24,82,0,9,9
50,8482118,Sam Colangelo,R,ANA,23,82,4,4,8
50,8482070,Mitchell Chaffee,R,TBL,26,82,3,3,6
50,8471677,Jack Johnson,D,CBJ,37,82,3,2,5
50,8470794,Joe Pavelski,C,,40,0,0,0,0
50,8481703,Valtteri Puustinen,R,PIT,25,0,0,0,0
50,8477950,Tony DeAngelo,D,,29,0,0,0,0
50,8481577,Philip Tomasino,C,NSH,23,0,0,0,0
50,8475197,Tyson Barrie,D,,33,0,0,0,0
50,8471218,Blake Wheeler,R,,38,0,0,0,0
50,8474157,Max Pacioretty,L,,36,0,0,0,0
50,8478466,Daniel Sprong,R,VAN,27,0,0,0,0
50,8475744,Evgeny Kuznetsov,C,,32,0,0,0,0
50,8481019,David Gustafsson,C,WPG,24,0,0,0,0
50,8475906,John Klingberg,D,,32,0,0,0,0
50,8479348,Kale Clague,D,BUF,26,0,0,0,0
50,8476952,Dominic Toninato,C,WPG,30,0,0,0,0
50,8473473,Milan Lucic,L,,36,0,0,0,0
50,8474037,James van Riemsdyk,L,,35,0,0,0,0
50,8474602,Justin Schultz,D,,34,0,0,0,0
50,8482222,Alexander Barabanov,L,,30,0,0,0,0
50,8479372,Josh Mahura,D,SEA,26,0,0,0,0
50,8479982,Conor Timmins,D,TOR,26,0,0,0,0
50,8474031,Kevin Shattenkirk,D,,35,0,0,0,0
50,8480008,Adam Ruzicka,C,,25,0,0,0,0
50,8481059,Scott Perunovich,D,STL,26,0,0,0,0
50,8480884,Calen Addison,D,,24,0,0,0,0
50,8476994,Vinnie Hinostroza,C,NSH,30,0,0,0,0
50,8478452,Caleb Jones,D,LAK,27,0,0,0,0
50,8480157,Calle Rosen,D,COL,30,0,0,0,0
50,8481609,Vladislav Kolyachonok,D,UTA,23,0,0,0,0
50,8479415,Michael McLeod,C,,26,0,0,0,0
50,8476919,Chris Tierney,C,,30,0,0,0,0
50,8479639,Dylan Coghlan,D,WPG,26,0,0,0,0
50,8478146,Matthew Highmore,C,OTT,28,0,0,0,0
50,8478970,Jalen Chatfield,D,CAR,28,0,0,0,0
50,8480205,Emil Bemstrom,C,PIT,25,0,0,0,0
50,8474884,Mike Hoffman,C,,35,0,0,0,0
50,8471274,Alex Goligoski,D,,39,0,0,0,0
50,8478104,Sammy Blais,L,,28,0,0,0,0
50,8474870,Tyler Johnson,C,,34,0,0,0,0
50,8476913,Devin Shore,C,MIN,30,0,0,0,0
50,8481598,Philip Broberg,D,EDM,23,0,0,0,0
50,8480058,Pierre-Olivier Joseph,D,STL,25,0,0,0,0
50,8480891,Michael Kesselring,D,UTA,24,0,0,0,0
50,8477979,Nicolas Aube-Kubel,R,BUF,28,0,0,0,0
50,8476871,Tanner Pearson,L,,32,0,0,0,0
50,8476393,Nick Cousins,C,,31,0,0,0,0
50,8479977,Kailer Yamamoto,R,,26,0,0,0,0
50,8479543,Michael Pezzetta,L,MTL,26,0,0,0,0
50,8477018,Ben Hutton,D,VGK,31,0,0,0,0
50,8480762,Eric Robinson,L,CAR,29,0,0,0,0
50,8474034,Pat Maroon,L,CHI,36,0,0,0,0
50,8481058,Jesse Ylönen,R,,25,0,0,0,0
50,8475179,Dmitry Kulikov,D,FLA,34,0,0,0,0
50,8481527,Kaedan Korczak,D,VGK,23,0,0,0,0
50,8473449,Kyle Okposo,R,,36,0,0,0,0
50,8482192,Isaak Phillips,D,CHI,23,0,0,0,0
50,8480727,Zach Whitecloud,D,VGK,28,0,0,0,0
50,8479346,Dillon Dube,C,,26,0,0,0,0
50,8480821,Filip Zadina,R,,25,0,0,0,0
50,8480001,Urho Vaakanainen,D,ANA,25,0,0,0,0
50,8470966,Mark Giordano,D,,41,0,0,0,0
50,8480853,Liam Foudy,C,,24,0,0,0,0
50,8475225,Craig Smith,C,CHI,35,0,0,0,0
50,8479972,Mason Shaw,C,WPG,26,0,0,0,0
50,8478451,Ethan Bear,D,WSH,27,0,0,0,0
50,8474040,Sam Gagner,C,,35,0,0,0,0
50,8480196,Jacob Bryson,D,BUF,27,0,0,0,0
50,8479984,Cal Foote,D,,26,0,0,0,0
50,8480011,Klim Kostin,C,SJS,25,0,0,0,0
50,8482176,Wyatt Kaiser,D,CHI,22,0,0,0,0
50,8476988,Matt Benning,D,SJS,30,0,0,0,0
50,8479370,Tyson Jost,C,CAR,26,0,0,0,0
50,8477464,Nic Petan,C,,29,0,0,0,0
50,8477380,Jonny Brodzinski,C,NYR,31,0,0,0,0
50,8480070,Ian Mitchell,D,BOS,25,0,0,0,0
50,8479315,Joey Anderson,R,CHI,26,0,0,0,0
50,8478099,Kevin Labanc,R,,29,0,0,0,0
50,8476874,Olli Maatta,D,DET,30,0,0,0,0
50,8475208,Brian Dumoulin,D,ANA,33,0,0,0,0
50,8478430,Oliver Kylington,D,,27,0,0,0,0
50,8479536,Axel Jonsson-Fjallby,L,WPG,26,0,0,0,0
50,8479671,Mathieu Olivier,R,CBJ,27,0,0,0,0
50,8471709,Marc-Edouard Vlasic,D,SJS,37,0,0,0,0
50,8479328,Julien Gauthier,R,NYI,27,0,0,0,0
50,8478421,A.J. Greer,L,FLA,28,0,0,0,0
50,8477573,Nathan Walker,L,STL,30,0,0,0,0
50,8481537,Nikita Okhotiuk,D,CGY,24,0,0,0,0
50,8474166,Alec Martinez,D,CHI,37,0,0,0,0
50,8470610,Zach Parise,L,,40,0,0,0,0
50,8477478,William Carrier,L,CAR,30,0,0,0,0
50,8479344,Jesse Puljujarvi,R,PIT,26,0,0,0,0
50,8480887,Jordan Harris,D,MTL,24,0,0,0,0
50,8478502,Dennis Gilbert,D,BUF,28,0,0,0,0
50,8482730,Brandt Clarke,D,LAK,21,0,0,0,0
50,8480355,Mark Kastelic,C,BOS,25,0,0,0,0
50,8475750,Jon Merrill,D,MIN,32,0,0,0,0
50,8475164,Jakob Silfverberg,R,,34,0,0,0,0
50,8477944,Jakub Vrana,L,,28,0,0,0,0
50,8479439,Jacob MacDonald,D,COL,31,0,0,0,0
50,8474568,Luke Schenn,D,NSH,35,0,0,0,0
50,8478454,Noah Juulsen,D,VAN,27,0,0,0,0
50,8475752,Tyler Pitlick,C,,33,0,0,0,0
50,8482148,Hendrix Lapierre,C,WSH,22,0,0,0,0
50,8481167,Brayden Pachal,D,CGY,25,0,0,0,0
50,8478043,Sam Lafferty,C,BUF,29,0,0,0,0
50,8479321,Lucas Johansen,D,,27,0,0,0,0
50,8471699,Andrew Cogliano,C,,37,0,0,0,0
50,8481521,Ronnie Attard,D,PHI,25,0,0,0,0
50,8481161,Jake Christiansen,D,CBJ,25,0,0,0,0
50,8479458,Nikita Zaitsev,D,,33,0,0,0,0
50,8479619,Michael Carcone,L,UTA,28,0,0,0,0
50,8479026,Philippe Myers,D,TOR,27,0,0,0,0
50,8477330,Dominik Kubalik,L,,29,0,0,0,0
50,8481617,Vasily Podkolzin,R,VAN,23,0,0,0,0
50,8481701,Santeri Hatakka,D,NJD,23,0,0,0,0
50,8479514,Rem Pitlick,C,,27,0,0,0,0
50,8477446,Michael McCarron,R,NSH,29,0,0,0,0
50,8470604,Jeff Carter,C,,39,0,0,0,0
50,8482241,Radim Zohorna,L,,28,0,0,0,0
50,8480289,Morgan Barron,C,WPG,26,0,0,0,0
50,8479379,Givani Smith,R,SJS,26,0,0,0,0
50,8480216,Jacob Peterson,C,,25,0,0,0,0
50,8477851,Jordan Oesterle,D,BOS,32,0,0,0,0
50,8484258,Sam Malinski,D,COL,26,0,0,0,0
50,8478904,Steven Lorentz,C,,28,0,0,0,0
50,8482095,Tyler Kleven,D,OTT,22,0,0,0,0
50,8480848,Ty Dellandrea,C,SJS,24,0,0,0,0
50,8476884,Derrick Pouliot,D,,30,0,0,0,0
50,8479336,Carl Grundstrom,R,SJS,27,0,0,0,0
50,8482964,Arber Xhekaj,D,MTL,23,0,0,0,0
50,8471686,Marc Staal,D,,37,0,0,0,0
50,8477887,Patrick Brown,C,BOS,32,0,0,0,0
50,8478495,Denis Gurianov,R,,27,0,0,0,0
50,8473504,Cal Clutterbuck,R,,37,0,0,0,0
50,8481550,Adam Beckman,L,NJD,23,0,0,0,0
50,8480845,Rasmus Kupari,C,WPG,24,0,0,0,0
50,8474009,Nick Bonino,C,,36,0,0,0,0
50,8478585,Derek Ryan,C,EDM,38,0,0,0,0
50,8477962,Brendan Lemieux,L,CAR,28,0,0,0,0
50,8482861,Vincent Iorio,D,WSH,22,0,0,0,0
50,8479378,Logan Stanley,D,WPG,26,0,0,0,0
50,8473446,Erik Johnson,D,PHI,36,0,0,0,0
50,8481743,Marc Del Gaizo,D,NSH,25,0,0,0,0
50,8477384,Josh Brown,D,EDM,30,0,0,0,0
50,8482165,Yan Kuznetsov,D,CGY,22,0,0,0,0
50,8478424,Jansen Harkins,C,ANA,27,0,0,0,0
50,8482144,Jack Thompson,D,SJS,22,0,0,0,0
50,8478512,Austin Czarnik,C,,32,0,0,0,0
50,8477527,Ross Johnston,L,ANA,30,0,0,0,0
50,8479383,Boris Katchouk,L,,26,0,0,0,0
50,8482094,Daemon Hunt,D,MIN,22,0,0,0,0
50,8481719,Maxwell Crozier,D,TBL,24,0,0,0,0
50,8480192,Johnathan Kovacevic,D,NJD,27,0,0,0,0
50,8479376,Victor Mete,D,,26,0,0,0,0
50,8482511,Mason Lohrei,D,BOS,23,0,0,0,0
50,8475825,Jani Hakanpää,D,,32,0,0,0,0
50,8478021,William Lagesson,D,DET,28,0,0,0,0
50,8475795,Dylan McIlrath,D,WSH,32,0,0,0,0
50,8477846,Ryan Carpenter,C,,33,0,0,0,0
50,8481056,Spencer Stastney,D,NSH,24,0,0,0,0
50,8481564,Ryan Johnson,D,BUF,23,0,0,0,0
50,8478017,Mark Friedman,D,VAN,29,0,0,0,0
50,8479320,Max Lajoie,D,SEA,27,0,0,0,0
50,8480075,Cameron Crotty,D,MIN,25,0,0,0,0
50,8484287,Cole McWard,D,VAN,23,0,0,0,0
50,8484254,Akito Hirose,D,VAN,25,0,0,0,0
50,8483407,Brandon Scanlin,D,NYR,25,0,0,0,0
50,8480274,Philip Kemp,D,EDM,25,0,0,0,0
50,8479522,Hardy Haman Aktell,D,WSH,26,0,0,0,0
50,8480007,Jonas Rondbjerg,R,VGK,25,0,0,0,0
50,8477454,Adam Erne,L,,29,0,0,0,0
50,8481679,Maxence Guenette,D,OTT,23,0,0,0,0
50,8480441,Trey Fix-Wolansky,R,CBJ,25,0,0,0,0
50,8483546,Marshall Rifai,D,TOR,26,0,0,0,0
50,8480084,Nick DeSimone,D,NJD,30,0,0,0,0
50,8481030,Jack St. Ivany,D,PIT,25,0,0,0,0
50,8481592,Jakob Pelletier,L,CGY,23,0,0,0,0
50,8478011,Louie Belpedio,D,PHI,28,0,0,0,0
50,8477930,Pierre-Edouard Bellemare,L,,39,0,0,0,0
50,8484321,Nikolas Matinpalo,D,OTT,26,0,0,0,0
50,8482067,Connor Mackey,D,NYR,28,0,0,0,0
50,8481806,Louis Crevier,D,CHI,23,0,0,0,0
50,8484326,Patrik Koch,D,UTA,28,0,0,0,0
50,8477971,Andreas Englund,D,LAK,28,0,0,0,0
50,8481751,Lukas Rousek,R,BUF,25,0,0,0,0
50,8481006,Tyler Tucker,D,STL,24,0,0,0,0
50,8476867,Brendan Gaunce,C,MIN,30,0,0,0,0
50,8479520,Brandon Duhaime,R,WSH,27,0,0,0,0
50,8477073,Kurtis MacDermid,L,NJD,30,0,0,0,0
50,8480874,Adam Ginning,D,PHI,24,0,0,0,0
50,8477473,Justin Bailey,R,SJS,29,0,0,0,0
50,8479066,Ryan Lomberg,L,CGY,30,0,0,0,0
50,8477070,Liam O'Brien,C,UTA,30,0,0,0,0
50,8474618,Marco Scandella,D,,34,0,0,0,0
50,8475797,Jarred Tinordi,D,,32,0,0,0,0
50,8481441,Joe Snively,C,DET,28,0,0,0,0
50,8477244,Chad Ruhwedel,D,NYR,34,0,0,0,0
50,8479772,Zack MacEwen,R,OTT,28,0,0,0,0
50,8481147,Reese Johnson,C,MIN,26,0,0,0,0
50,8481043,Cole Koepke,L,BOS,26,0,0,0,0
50,8483619,Filip Roos,D,OTT,25,0,0,0,0
50,8481541,Samuel Bolduc,D,NYI,24,0,0,0,0
50,8477810,Joel Hanley,D,CGY,33,0,0,0,0
50,8476907,Mackenzie MacEachern,L,,30,0,0,0,0
50,8482652,Walker Duehr,R,CGY,27,0,0,0,0
50,8477126,Jayson Megna,C,,34,0,0,0,0
50,8483398,Declan Carlile,D,TBL,31,0,0,0,0
50,8482929,Emil Lilleberg,D,TBL,23,0,0,0,0
50,8480880,Jakub Lauko,C,MIN,24,0,0,0,0
50,8480245,Olle Lycksell,R,PHI,25,0,0,0,0
50,8480252,Cole Guttman,C,CHI,25,0,0,0,0
50,8477467,Gustav Olofsson,D,SEA,30,0,0,0,0
50,8479968,Vinni Lettieri,C,BOS,29,0,0,0,0
50,8478400,Colin White,C,,27,0,0,0,0
50,8475755,Alexander Petrovic,D,DAL,32,0,0,0,0
50,8481812,Nikolai Knyzhov,D,,27,0,0,0,0
50,8481593,Jayden Struble,D,MTL,23,0,0,0,0
50,8481532,Alex Turcotte,C,LAK,23,0,0,0,0
50,8482126,Emil Andrae,D,PHI,31,0,0,0,0
50,8479944,Zach Aston-Reese,C,VGK,30,0,0,0,0
50,8471817,Ryan Reaves,R,TOR,37,0,0,0,0
50,8481206,John Ludvig,D,PIT,24,0,0,0,0
50,8481599,Victor Soderstrom,D,UTA,23,0,0,0,0
50,8480292,Carson Meyer,R,ANA,27,0,0,0,0
50,8482496,Nils Aman,C,VAN,24,0,0,0,0
50,8479718,Alex Barré-Boulet,C,MTL,27,0,0,0,0
50,8479994,Jaret Anderson-Dolan,C,WPG,25,0,0,0,0
50,8480184,Gustav Lindstrom,D,,26,0,0,0,0
50,8480890,Jan Jenik,R,OTT,24,0,0,0,0
50,8478067,Oskar Lindblom,L,,28,0,0,0,0
50,8476934,Brock McGinn,L,ANA,30,0,0,0,0
50,8479985,Cale Fleury,D,SEA,26,0,0,0,0
50,8484304,Uvis Balinskis,D,FLA,28,0,0,0,0
50,8479981,Jonah Gadjovich,L,FLA,26,0,0,0,0
50,8481716,Dmitri Voronkov,L,CBJ,24,0,0,0,0
50,8474709,Matt Martin,L,,35,0,0,0,0
50,8482634,Alex Steeves,C,TOR,25,0,0,0,0
50,8480823,Alexander Alexeyev,D,WSH,25,0,0,0,0
50,8477541,Dakota Mermis,D,TOR,30,0,0,0,0
50,8483491,Ivan Miroshnichenko,L,WSH,20,0,0,0,0
50,8478477,Mitchell Stephens,C,SEA,27,0,0,0,0
50,8481543,Nikita Alexandrov,C,STL,24,0,0,0,0
50,8479423,Alex Nylander,L,,26,0,0,0,0
50,8482451,Mikael Pyyhtia,L,CBJ,23,0,0,0,0
50,8478831,Kevin Stenlund,C,UTA,28,0,0,0,0
50,8480306,Grant Hutton,D,NYI,29,0,0,0,0
50,8478028,Fredrik Olofsson,L,,28,0,0,0,0
50,8477462,Robert Hagg,D,VGK,29,0,0,0,0
50,8477320,Anton Blidh,L,NYR,29,0,0,0,0
50,8482157,Will Cuylle,L,NYR,22,0,0,0,0
50,8482737,Zack Bolduc,C,STL,21,0,0,0,0
50,8481239,Samuel Fagemo,L,,24,0,0,0,0
50,8481600,Tobias Bjornfot,D,FLA,23,0,0,0,0
50,8478409,Anthony Richard,C,PHI,28,0,0,0,0
50,8474145,Robert Bortuzzo,D,,35,0,0,0,0
50,8475958,Michael Sgarbossa,C,WSH,32,0,0,0,0
50,8479986,Kole Lind,R,DAL,26,0,0,0,0
50,8479249,Andrew Poturalski,C,SJS,30,0,0,0,0
50,8479362,Riley Tufte,L,BOS,26,0,0,0,0
50,8479991,Jake Leschyshyn,C,NYR,25,0,0,0,0
50,8479587,Rhett Gardner,C,PHI,28,0,0,0,0
50,8482744,James Malatesta,L,CBJ,21,0,0,0,0
50,8478854,Ryan Shea,D,PIT,27,0,0,0,0
50,8481591,Sam Poulin,R,,23,0,0,0,0
50,8483512,Matt Savoie,C,EDM,20,0,0,0,0
50,8482102,Vasily Ponomarev,C,PIT,22,0,0,0,0
50,8482162,Roby Jarventie,L,EDM,22,0,0,0,0
50,8481016,Ruslan Iskhakov,C,,24,0,0,0,0
50,8482172,Landon Slaggert,L,CHI,22,0,0,0,0
50,8482747,Brennan Othmann,L,NYR,21,0,0,0,0
50,8480031,Maxime Comtois,L,,25,0,0,0,0
50,8480226,Marián Studenic,R,,26,0,0,0,0
50,8478408,Travis Dermott,D,,28,0,0,0,0
50,8481518,Nolan Foote,L,NJD,24,0,0,0,0
50,8479419,Brett Murray,L,BUF,26,0,0,0,0
50,8482088,Justin Sourdif,R,FLA,22,0,0,0,0
50,8482201,Gage Goncalves,C,TBL,23,0,0,0,0
50,8481578,Graeme Clarke,R,MIN,23,0,0,0,0
50,8482177,Marat Khusnutdinov,C,MIN,22,0,0,0,0
50,8481754,Nikita Nesterenko,C,ANA,23,0,0,0,0
50,8483531,Brian Halonen,L,NJD,25,0,0,0,0
50,8483920,Pierrick Dube,R,WSH,23,0,0,0,0
50,8480851,Akil Thomas,C,LAK,24,0,0,0,0
50,8475235,Nicolas Deslauriers,L,PHI,33,0,0,0,0
50,8482476,Emil Heineman,L,MTL,23,0,0,0,0
50,8477149,Scott Sabourin,R,SJS,32,0,0,0,0
50,8483549,Lucas Condotta,L,MTL,27,0,0,0,0
50,8482765,Isak Rosen,R,BUF,21,0,0,0,0
50,8481237,Kyle MacLean,C,NYI,25,0,0,0,0
50,8481024,Linus Karlsson,C,VAN,25,0,0,0,0
50,8481690,Tyler Angle,C,,24,0,0,0,0
50,8483570,Ben Meyers,C,SEA,26,0,0,0,0
50,8481655,Cole Schwindt,R,CGY,23,0,0,0,0
50,8481462,Mason Morelli,L,VGK,28,0,0,0,0
50,8483401,Marc Johnstone,R,PIT,28,0,0,0,0
50,8478956,Samuel Laberge,L,NJD,27,0,0,0,0
50,8479533,Joona Koppanen,L,,26,0,0,0,0
50,8482197,Adam Raska,R,MIN,23,0,0,0,0
50,8482250,Callahan Burke,C,VGK,27,0,0,0,0
50,8482784,Zach Dean,C,STL,21,0,0,0,0
50,8484255,Jason Polin,R,COL,25,0,0,0,0
50,8481077,John Leonard,L,,26,0,0,0,0
50,8481534,Raphael Lavoie,C,EDM,24,0,0,0,0
50,8483609,Adam Klapka,R,CGY,24,0,0,0,0
50,8482751,Ryan Winterton,C,SEA,21,0,0,0,0
50,8480267,Sammy Walker,C,MIN,25,0,0,0,0
50,8475766,Austin Watson,L,,32,0,0,0,0
50,8482460,Matt Rempe,C,NYR,22,0,0,0,0
50,8481065,Angus Crookshank,L,OTT,25,0,0,0,0
50,8481070,Hugh McGing,L,,26,0,0,0,0
50,8476323,Max McCormick,L,SEA,32,0,0,0,0
50,8483395,Arshdeep Bains,L,VAN,23,0,0,0,0
50,8484259,Ondrej Pavel,C,COL,31,0,0,0,0
50,8483432,Luca Del Bel Belluz,C,CBJ,31,0,0,0,0
50,8483045,Cameron Butler,R,CBJ,31,0,0,0,0
50,8482061,Brandon Biro,L,SEA,26,0,0,0,0
50,8477401,John Hayden,C,SEA,29,0,0,0,0
50,8475278,Byron Froese,C,,33,0,0,0,0
50,8478446,Glenn Gawdin,C,LAK,27,0,0,0,0
50,8477993,Justin Kirkland,C,CGY,28,0,0,0,0
50,8482147,Jean-Luc Foudy,C,COL,22,0,0,0,0
50,8480032,Shane Bowers,C,NJD,25,0,0,0,0
50,8479330,Brandon Gignac,C,MTL,27,0,0,0,0
50,8480776,Sheldon Rempal,R,,29,0,0,0,0
50,8475413,Justin Dowling,C,NJD,34,0,0,0,0
50,8481726,Adam Edstrom,C,NYR,24,0,0,0,0
50,8480844,Grigori Denisenko,L,VGK,24,0,0,0,0
50,8478147,Bokondji Imama,L,PIT,28,0,0,0,0
50,8478881,Brett Seney,L,CHI,28,0,0,0,0
50,8483630,Pavol Regenda,L,ANA,25,0,0,0,0
50,8480836,Jonathan Gruden,C,,24,0,0,0,0
50,8484314,Jiri Smejkal,L,,28,0,0,0,0
50,8475780,Chris Wagner,R,COL,33,0,0,0,0
50,8479546,Oskar Steen,C,,26,0,0,0,0
50,8483597,Milos Kelemen,L,UTA,25,0,0,0,0
50,8481789,Tye Kartye,L,SEA,23,0,0,0,0
50,8484325,Waltteri Merela,C,TBL,26,0,0,0,0
50,8479421,Jacob Moverare,D,LAK,26,0,0,0,0
50,8481585,Egor Afanasyev,L,SJS,23,0,0,0,0
50,8479547,Matthew Phillips,R,,26,0,0,0,0
50,8479367,William Lockwood,R,FLA,26,0,0,0,0
50,8476915,Jujhar Khaira,L,,30,0,0,0,0
50,8481422,Jacob Lucchini,C,NSH,29,0,0,0,0
50,8480468,James Hamblin,L,EDM,25,0,0,0,0
50,8478051,Max Willman,C,NJD,29,0,0,0,0
50,8481556,John Beecher,C,BOS,23,0,0,0,0
50,8478078,Rourke Chartier,C,,28,0,0,0,0
51,8476453,Nikita Kucherov,R,TBL,31,82,46,102,148
51,8479318,Auston Matthews,C,TOR,27,82,73,65,138
51,8477492,Nathan MacKinnon,C,COL,29,82,46,89,135
51,8478402,Connor McDavid,C,EDM,27,82,45,80,125
51,8476459,Mika Zibanejad,C,NYR,31,82,46,69,115
51,8476887,Filip Forsberg,L,NSH,30,82,52,60,112
51,8478550,Artemi Panarin,L,NYR,33,82,35,77,112
51,8477939,William Nylander,R,TOR,28,82,43,68,111
51,8477956,David Pastrnak,R,BOS,28,82,54,56,110
51,8479314,Matthew Tkachuk,L,FLA,27,82,39,71,110
51,8481559,Jack Hughes,C,NJD,23,82,43,66,109
51,8477404,Jake Guentzel,C,TBL,30,82,45,62,107
51,8478420,Mikko Rantanen,R,COL,28,82,51,54,105
51,8478010,Brayden Point,C,TBL,28,82,49,50,99
51,8479323,Adam Fox,D,NYR,26,82,15,84,99
51,8480208,Drake Batherson,R,OTT,26,82,36,62,98
51,8477934,Leon Draisaitl,C,EDM,29,82,36,61,97
51,8480800,Quinn Hughes,D,VAN,25,82,18,79,97
51,8480801,Brady Tkachuk,L,OTT,25,82,48,48,96
51,8482116,Tim Stützle,C,OTT,22,82,27,69,96
51,8478398,Kyle Connor,L,WPG,28,82,46,49,95
51,8478403,Jack Eichel,C,VGK,28,82,38,56,94
51,8471675,Sidney Crosby,C,PIT,37,82,33,61,94
51,8480012,Elias Pettersson,C,VAN,26,82,32,61,93
51,8478444,Brock Boeser,R,VAN,27,82,45,46,91
51,8476389,Vincent Trocheck,C,NYR,31,82,40,51,91
51,8477942,Kevin Fiala,L,LAK,28,82,36,55,91
51,8480027,Jason Robertson,L,DAL,25,82,25,66,91
51,8480002,Nico Hischier,C,NJD,25,82,36,54,90
51,8477493,Aleksander Barkov,C,FLA,29,82,25,65,90
51,8475172,Nazem Kadri,C,CGY,34,82,43,45,88
51,8478864,Kirill Kaprizov,L,MIN,27,82,39,49,88
51,8480830,Andrei Svechnikov,R,CAR,24,82,33,54,87
51,8479343,Clayton Keller,R,UTA,26,82,43,43,86
51,8479407,Jesper Bratt,L,NJD,26,82,24,62,86
51,8481557,Matt Boldy,L,MIN,23,82,36,49,85
51,8476468,J.T. Miller,C,VAN,31,82,31,54,85
51,8482078,Lucas Raymond,L,DET,22,82,44,40,84
51,8477500,Bo Horvat,C,NYI,29,82,40,44,84
51,8480069,Cale Makar,D,COL,26,82,25,58,83
51,8480803,Evan Bouchard,D,EDM,25,82,17,66,83
51,8479420,Tage Thompson,C,BUF,27,82,48,34,82
51,8478414,Timo Meier,R,NJD,28,82,39,42,81
51,8476454,Ryan Nugent-Hopkins,C,EDM,31,82,28,53,81
51,8474600,Roman Josi,D,NSH,34,82,24,57,81
51,8474578,Erik Karlsson,D,PIT,34,82,22,59,81
51,8480023,Robert Thomas,C,STL,25,82,17,64,81
51,8476460,Mark Scheifele,C,WPG,31,82,29,51,80
51,8475786,Zach Hyman,L,EDM,32,82,41,38,79
51,8476346,Johnny Gaudreau,L,CBJ,31,82,22,57,79
51,8481523,Kirby Dach,C,MTL,23,82,11,68,79
51,8474564,Steven Stamkos,C,NSH,34,82,39,39,78
51,8477946,Dylan Larkin,C,DET,28,82,36,42,78
51,8476853,Morgan Rielly,D,TOR,30,82,14,64,78
51,8475166,John Tavares,C,TOR,34,82,29,48,77
51,8475692,Mats Zuccarello,R,MIN,37,82,17,59,76
51,8478445,Mathew Barzal,C,NYI,27,82,16,60,76
51,8475167,Victor Hedman,D,TBL,34,82,14,62,76
51,8478439,Travis Konecny,R,PHI,27,82,33,42,75
51,8478427,Sebastian Aho,C,CAR,27,82,30,45,75
51,8473419,Brad Marchand,L,BOS,36,82,27,48,75
51,8471215,Evgeni Malkin,C,PIT,38,82,22,53,75
51,8475913,Mark Stone,R,VGK,32,82,20,55,75
51,8477501,Valeri Nichushkin,R,COL,29,82,38,36,74
51,8479337,Alex DeBrincat,R,DET,27,82,35,38,73
51,8477960,Adrian Kempe,R,LAK,28,82,30,43,73
51,8480865,Noah Dobson,D,NYI,24,82,15,58,73
51,8476881,Tomas Hertl,C,VGK,31,82,38,34,72
51,8471214,Alex Ovechkin,L,WSH,39,82,36,36,72
51,8479385,Jordan Kyrou,C,STL,26,82,34,38,72
51,8478047,Michael Bunting,L,PIT,29,82,32,40,72
51,8474586,Jordan Eberle,R,SEA,34,82,26,46,72
51,8478401,Pavel Zacha,C,BOS,27,82,24,48,72
51,8478438,Tommy Novak,C,NSH,27,82,23,49,72
51,8471724,Kris Letang,D,PIT,37,82,18,53,71
51,8477933,Sam Reinhart,C,FLA,29,82,37,33,70
51,8479339,Patrik Laine,L,CBJ,26,82,36,34,70
51,8482093,Seth Jarvis,C,CAR,22,82,35,35,70
51,8477409,Carter Verhaeghe,C,FLA,29,82,33,37,70
51,8477951,Nick Schmaltz,C,UTA,28,82,23,47,70
51,8475184,Chris Kreider,L,NYR,33,82,35,34,69
51,8477476,Artturi Lehkonen,L,COL,29,82,27,42,69
51,8475168,Matt Duchene,C,DAL,33,82,25,44,69
51,8475798,Mikael Granlund,C,SJS,32,82,21,48,69
51,8477940,Nikolaj Ehlers,L,WPG,28,82,21,48,69
51,8473512,Claude Giroux,R,OTT,36,82,18,51,69
51,8480036,Miro Heiskanen,D,DAL,25,82,13,56,69
51,8473986,Alex Killorn,L,ANA,35,82,30,38,68
51,8480188,Fabian Zetterlund,L,SJS,25,82,28,40,68
51,8477402,Pavel Buchnevich,L,STL,29,82,27,41,68
51,8480839,Rasmus Dahlin,D,BUF,24,82,18,50,68
51,8478449,Roope Hintz,C,DAL,28,82,39,28,67
51,8478493,Joel Eriksson Ek,C,MIN,27,82,31,36,67
51,8475810,Bryan Rust,R,PIT,32,82,35,31,66
51,8476448,William Karlsson,C,VGK,31,82,30,36,66
51,8479675,Trevor Moore,L,LAK,29,82,29,37,66
51,8482665,Matty Beniers,C,SEA,22,82,28,38,66
51,8476462,Dougie Hamilton,D,NJD,31,82,25,40,65
51,8474102,David Perron,L,OTT,36,82,24,41,65
51,8480018,Nick Suzuki,C,MTL,25,82,22,43,65
51,8478460,Zach Werenski,D,CBJ,27,82,15,50,65
51,8475794,Tyler Seguin,C,DAL,32,82,30,34,64
51,8473994,Jamie Benn,L,DAL,35,82,28,36,64
51,8471685,Anze Kopitar,C,LAK,37,82,22,42,64
51,8475158,Ryan O'Reilly,C,NSH,33,82,22,42,64
51,8477503,Max Domi,C,TOR,29,82,21,43,64
51,8477949,Alex Tuch,R,BUF,28,82,20,44,64
51,8475287,Erik Haula,L,NJD,33,82,19,45,64
51,8475726,Tyler Toffoli,C,SJS,32,82,36,27,63
51,8481540,Cole Caufield,R,MTL,23,82,33,30,63
51,8475745,Charlie Coyle,C,BOS,32,82,22,41,63
51,8477447,Shea Theodore,D,VGK,29,82,10,53,63
51,8477496,Elias Lindholm,C,BOS,30,82,28,34,62
51,8478873,Troy Terry,R,ANA,27,82,22,40,62
51,8477955,Jared McCann,L,SEA,28,82,32,29,61
51,8480015,Owen Tippett,R,PHI,25,82,32,29,61
51,8476882,Teuvo Teravainen,L,CHI,30,82,24,37,61
51,8476456,Jonathan Huberdeau,C,CGY,31,82,10,51,61
51,8476399,Blake Coleman,C,CGY,33,82,26,34,60
51,8475754,Brock Nelson,C,NYI,33,82,25,35,60
51,8478856,Conor Garland,R,VAN,28,82,25,35,60
51,8479542,Brandon Hagel,L,TBL,26,82,23,37,60
51,8480798,Philipp Kurashev,C,CHI,25,82,19,41,60
51,8477504,Josh Morrissey,D,WPG,29,82,12,48,60
51,8478407,Vince Dunn,D,SEA,28,82,12,48,60
51,8474641,Adam Henrique,C,EDM,34,82,38,21,59
51,8481596,Shane Pinto,C,OTT,24,82,23,36,59
51,8479400,Pierre-Luc Dubois,L,WSH,26,82,23,36,59
51,8482109,Alexis Lafrenière,L,NYR,23,82,22,37,59
51,8478462,Nicolas Roy,C,VGK,27,82,21,38,59
51,8478440,Dylan Strome,C,WSH,27,82,20,39,59
51,8477416,Oliver Bjorkstrand,R,SEA,29,82,18,41,59
51,8474590,John Carlson,D,WSH,34,82,16,43,59
51,8482740,Wyatt Johnston,C,DAL,21,82,33,25,58
51,8480064,Josh Norris,C,OTT,25,82,33,25,58
51,8478042,Viktor Arvidsson,R,EDM,31,82,17,41,58
51,8481528,Dylan Cozens,C,BUF,23,82,31,26,57
51,8477407,Anthony Duclair,L,NYI,29,82,30,27,57
51,8480220,Noah Cates,L,PHI,25,82,24,33,57
51,8475169,Evander Kane,L,EDM,33,82,24,33,57
51,8477456,J.T. Compher,L,DET,29,82,21,36,57
51,8480434,Sean Durzi,D,UTA,26,82,18,39,57
51,8480014,Gabriel Vilardi,C,WPG,25,82,29,27,56
51,8480039,Martin Necas,C,CAR,25,82,23,33,56
51,8478975,Mason Marchment,L,DAL,29,82,22,34,56
51,8478396,Noah Hanifin,D,VGK,27,82,17,39,56
51,8477948,Travis Sanheim,D,PHI,28,82,14,42,56
51,8476539,Jonathan Marchessault,R,NSH,34,82,33,22,55
51,8476483,Rickard Rakell,R,PIT,31,82,29,26,55
51,8482159,Tyson Foerster,R,PHI,22,82,29,26,55
51,8475799,Nino Niederreiter,R,WPG,32,82,28,27,55
51,8482124,Quinton Byfield,R,LAK,22,82,26,29,55
51,8482745,Mason McTavish,C,ANA,21,82,21,34,55
51,8480028,Morgan Frost,C,PHI,25,82,20,35,55
51,8477497,Sean Monahan,C,CBJ,30,82,19,36,55
51,8481546,Cam York,D,PHI,23,82,18,37,55
51,8474565,Alex Pietrangelo,D,VGK,34,82,14,41,55
51,8475784,Jeff Skinner,C,EDM,32,82,28,26,54
51,8476432,Boone Jenner,C,CBJ,31,82,27,27,54
51,8481533,Trevor Zegras,C,ANA,23,82,25,29,54
51,8478366,Frank Vatrano,R,ANA,30,82,23,31,54
51,8478474,Lawson Crouse,L,UTA,27,82,23,31,54
51,8481554,Kaapo Kakko,R,NYR,23,82,21,33,54
51,8482110,Dawson Mercer,C,NJD,23,82,21,33,54
51,8476905,Chandler Stephenson,C,SEA,30,82,20,34,54
51,8479999,Casey Mittelstadt,C,COL,26,82,18,36,54
51,8476479,Phillip Danault,C,LAK,31,82,14,40,54
51,8477935,Sam Bennett,C,FLA,28,82,25,28,53
51,8481535,Nils Hoglander,L,VAN,24,82,24,29,53
51,8478519,Anthony Cirelli,C,TBL,27,82,21,32,53
51,8479410,Mikhail Sergachev,D,UTA,26,82,14,39,53
51,8477451,Ryan Hartman,R,MIN,30,82,26,26,52
51,8477426,Nicholas Paul,L,TBL,29,82,24,28,52
51,8478046,Danton Heinen,L,VAN,29,82,23,29,52
51,8475791,Taylor Hall,L,CHI,33,82,22,30,52
51,8482667,William Eklund,L,SJS,22,82,18,34,52
51,8475170,Brayden Schenn,C,STL,33,82,16,36,52
51,8478038,Devon Toews,D,COL,30,82,10,42,52
51,8477932,Aaron Ekblad,D,FLA,28,82,10,42,52
51,8474679,Gustav Nyquist,C,NSH,35,82,8,44,52
51,8475768,Jaden Schwartz,C,SEA,32,82,29,22,51
51,8474141,Patrick Kane,R,DET,36,82,20,31,51
51,8478498,Jake DeBrusk,L,VAN,28,82,27,23,50
51,8483808,Andrei Kuzmenko,L,CGY,28,82,27,23,50
51,8482097,Jack Quinn,R,BUF,23,82,23,27,50
51,8477511,Anthony Mantha,R,CGY,30,82,20,30,50
51,8478458,Jack Roslovic,C,CAR,27,82,16,34,50
51,8476419,Jean-Gabriel Pageau,C,NYI,32,82,15,35,50
51,8479325,Charlie McAvoy,D,BOS,27,82,13,37,50
51,8470613,Brent Burns,D,CAR,39,82,11,39,50
51,8478397,Rasmus Andersson,D,CGY,28,82,9,41,50
51,8476869,Brady Skjei,D,NSH,30,82,9,41,50
51,8474150,Mikael Backlund,C,CGY,35,82,23,26,49
51,8476461,Sean Couturier,C,PHI,32,82,19,30,49
51,8477498,Darnell Nurse,D,EDM,29,82,17,32,49
51,8479425,Filip Hronek,D,VAN,27,82,11,38,49
51,8482055,Drew O'Connor,L,PIT,26,82,33,15,48
51,8476438,Brandon Saad,L,STL,32,82,26,22,48
51,8481068,Yegor Sharangovich,C,CGY,26,82,25,23,48
51,8476918,Jimmy Vesey,L,NYR,31,82,25,23,48
51,8482699,Dylan Guenther,R,UTA,21,82,23,25,48
51,8482720,Matthew Knies,L,TOR,22,82,23,25,48
51,8477987,Ryan Donato,C,CHI,28,82,22,26,48
51,8476792,Torey Krug,D,STL,33,82,13,35,48
51,8479345,Jakob Chychrun,D,WSH,26,82,12,36,48
51,8477494,Jonathan Drouin,L,COL,29,82,11,37,48
51,8475191,Reilly Smith,R,NYR,33,82,24,23,47
51,8480829,Jesperi Kotkaniemi,C,CAR,24,82,23,24,47
51,8482113,Anton Lundell,C,FLA,23,82,19,28,47
51,8478891,Mason Appleton,C,WPG,28,82,16,31,47
51,8482660,Kent Johnson,C,CBJ,22,82,14,33,47
51,8475793,Ryan Johansen,C,PHI,32,82,13,34,47
51,8476875,Mike Matheson,D,MTL,30,82,13,34,47
51,8482684,Luke Hughes,D,NJD,21,82,13,34,47
51,8480145,Neal Pionk,D,WPG,29,82,7,40,47
51,8480185,Eetu Luostarinen,C,FLA,26,82,21,25,46
51,8478463,Anthony Beauvillier,L,PIT,27,82,20,26,46
51,8484144,Connor Bedard,C,CHI,19,82,20,26,46
51,8481582,Nicholas Robertson,L,TOR,23,82,20,26,46
51,8480797,Joel Farabee,L,PHI,24,82,19,27,46
51,8477444,Andre Burakovsky,L,SEA,29,82,19,27,46
51,8475765,Vladimir Tarasenko,R,DET,33,82,13,33,46
51,8477986,Brandon Montour,D,SEA,30,82,13,33,46
51,8477346,MacKenzie Weegar,D,CGY,30,82,10,36,46
51,8479996,Cody Glass,C,NSH,25,82,26,19,45
51,8476392,Adam Lowry,C,WPG,31,82,22,23,45
51,8475314,Anders Lee,L,NYI,34,82,22,23,45
51,8482092,Ridly Greig,C,OTT,22,82,19,26,45
51,8473422,Nick Foligno,L,CHI,37,82,18,27,45
51,8477495,Seth Jones,D,CHI,30,82,11,34,45
51,8475171,Oliver Ekman-Larsson,D,TOR,33,82,9,36,45
51,8480078,Filip Chytil,C,NYR,25,82,19,25,44
51,8477021,Alex Kerfoot,C,UTA,30,82,19,25,44
51,8476458,Ryan Strome,C,ANA,31,82,15,29,44
51,8475714,Calle Jarnkrok,C,TOR,33,82,14,30,44
51,8481711,Matias Maccelli,L,UTA,24,82,13,31,44
51,8475764,Cam Fowler,D,ANA,33,82,3,41,44
51,8478542,Evan Rodrigues,C,FLA,31,82,21,22,43
51,8477952,Robby Fabbri,C,ANA,28,82,20,23,43
51,8477998,Warren Foegele,L,LAK,28,82,19,24,43
51,8476329,Travis Boyd,C,MIN,31,82,10,33,43
51,8475763,Kevin Hayes,R,PIT,32,82,8,35,43
51,8477989,Christian Dvorak,C,MTL,28,82,8,35,43
51,8471698,T.J. Oshie,R,WSH,38,82,23,19,42
51,8475753,Justin Faulk,D,STL,32,82,18,24,42
51,8476826,Yanni Gourde,C,SEA,33,82,17,25,42
51,8483431,Logan Cooley,C,UTA,20,82,17,25,42
51,8476873,Mark Jankowski,C,NSH,30,82,17,25,42
51,8479351,Sam Steel,C,DAL,26,82,14,28,42
51,8475149,Marcus Johansson,L,MIN,34,82,13,29,42
51,8482475,Yegor Chinakhov,R,CBJ,23,82,21,20,41
51,8479525,Ross Colton,C,COL,28,82,18,23,41
51,8475722,Jason Zucker,L,BUF,32,82,16,25,41
51,8476906,Shayne Gostisbehere,D,CAR,31,82,14,27,41
51,8478233,Andrew Mangiapane,L,WSH,28,82,10,31,41
51,8481542,Moritz Seider,D,DET,23,82,5,36,41
51,8476880,Tom Wilson,R,WSH,30,82,24,16,40
51,8474053,Logan Couture,C,SJS,35,82,17,23,40
51,8476854,Hampus Lindholm,D,BOS,30,82,17,23,40
51,8477964,Ivan Barbashev,C,VGK,29,82,15,25,40
51,8482146,Luke Evangelista,R,NSH,22,82,14,26,40
51,8476872,Scott Laughton,C,PHI,30,82,12,28,40
51,8477429,Andrew Copp,C,DET,30,82,9,31,40
51,8476923,Damon Severson,D,CBJ,30,82,9,31,40
51,8478469,Thomas Chabot,D,OTT,27,82,8,32,40
51,8478057,Dakota Joshua,C,VAN,28,82,24,15,39
51,8480009,Eeli Tolvanen,R,SEA,25,82,21,18,39
51,8479353,Brett Howden,C,VGK,26,82,17,22,39
51,8482117,Lukas Reichel,L,CHI,22,82,17,22,39
51,8482175,JJ Peterka,R,BUF,22,82,15,24,39
51,8474189,Lars Eller,C,PIT,35,82,15,24,39
51,8473563,Nicklas Backstrom,C,WSH,37,82,14,25,39
51,8476960,Andreas Athanasiou,C,CHI,30,82,13,26,39
51,8477479,Tyler Bertuzzi,L,CHI,29,82,12,27,39
51,8480817,K'Andre Miller,D,NYR,24,82,12,27,39
51,8478055,Gustav Forsling,D,FLA,28,82,9,30,39
51,8476902,Esa Lindell,D,DAL,30,82,8,31,39
51,8476958,Jaccob Slavin,D,CAR,30,82,7,32,39
51,8476981,Josh Anderson,R,MTL,30,82,25,13,38
51,8481604,Pavel Dorofeyev,L,VGK,24,82,22,16,38
51,8475760,Nick Bjugstad,C,UTA,32,82,19,19,38
51,8481624,Ilya Mikheyev,R,CHI,30,82,18,20,38
51,8478115,Pierre Engvall,L,NYI,28,82,15,23,38
51,8478472,Mathieu Joseph,R,STL,27,82,14,24,38
51,8476292,Ondrej Palat,L,NJD,33,82,12,26,38
51,8477435,Ryan Graves,D,PIT,29,82,7,31,38
51,8481477,Nico Sturm,C,SJS,29,82,20,17,37
51,8480113,Alex Iafallo,L,WPG,31,82,18,19,37
51,8482705,Cole Sillinger,C,CBJ,21,82,16,21,37
51,8481704,Juuso Parssinen,C,NSH,23,82,16,21,37
51,8479365,Trent Frederic,C,BOS,26,82,15,22,37
51,8476921,Jordan Martinook,L,CAR,32,82,14,23,37
51,8480802,Ryan McLeod,C,BUF,25,82,13,24,37
51,8474716,Jared Spurgeon,D,MIN,35,82,11,26,37
51,8476931,Jake McCabe,D,TOR,31,82,8,29,37
51,8482671,Owen Power,D,BUF,22,82,7,30,37
51,8478840,Will Borgen,D,SEA,28,82,2,35,37
51,8480459,Pius Suter,C,VAN,28,82,19,17,36
51,8480003,Jesper Boqvist,C,FLA,26,82,18,18,36
51,8475848,Brendan Gallagher,R,MTL,32,82,18,18,36
51,8480849,Barrett Hayton,C,UTA,24,82,17,19,36
51,8481186,Logan O'Connor,R,COL,28,82,16,20,36
51,8479987,Morgan Geekie,C,BOS,26,82,13,23,36
51,8483515,Juraj Slafkovsky,L,MTL,20,82,13,23,36
51,8479398,Samuel Girard,D,COL,26,82,9,27,36
51,8476927,Teddy Blueger,C,VAN,30,82,8,28,36
51,8482133,Thomas Bordeleau,C,SJS,22,82,8,28,36
51,8482105,Jake Sanderson,D,OTT,22,82,7,29,36
51,8474563,Drew Doughty,D,LAK,35,82,5,31,36
51,8474574,Tyler Myers,D,VAN,34,82,2,34,36
51,8479293,Brandon Tanev,L,SEA,33,82,19,16,35
51,8481618,Alex Newhook,C,MTL,23,82,18,17,35
51,8479941,Justin Danforth,R,CBJ,31,82,18,17,35
51,8475151,Kyle Palmieri,C,NYI,33,82,15,20,35
51,8474149,Evgenii Dadonov,R,DAL,35,82,14,21,35
51,8477508,Curtis Lazar,C,NJD,29,82,14,21,35
51,8478911,Matt Roy,D,WSH,29,82,11,24,35
51,8482111,Justin Barron,D,MTL,23,82,10,25,35
51,8481581,Thomas Harley,D,DAL,23,82,9,26,35
51,8478020,Michael Amadio,C,OTT,28,82,18,16,34
51,8479390,Taylor Raddysh,R,WSH,26,82,17,17,34
51,8481553,Bobby Brink,R,PHI,23,82,16,18,34
51,8480144,David Kampf,C,TOR,29,82,13,21,34
51,8475855,Jesper Fast,R,CAR,33,82,12,22,34
51,8477969,Marcus Pettersson,D,PIT,28,82,10,24,34
51,8476885,Jacob Trouba,D,NYR,30,82,9,25,34
51,8480893,Kirill Marchenko,R,CBJ,24,82,25,8,33
51,8477947,Sonny Milano,L,WSH,28,82,17,16,33
51,8481013,Jonatan Berggren,R,DET,24,82,17,16,33
51,8481580,Connor McMichael,C,WSH,23,82,17,16,33
51,8476925,Colton Sissons,C,NSH,31,82,15,18,33
51,8480068,Ryan Poehling,C,PHI,25,82,15,18,33
51,8476474,Stefan Noesen,R,NJD,31,82,14,19,33
51,8476480,Vladislav Namestnikov,C,WPG,32,82,14,19,33
51,8481481,Blake Lizotte,C,PIT,27,82,11,22,33
51,8475218,Mattias Ekholm,D,EDM,34,82,8,25,33
51,8476917,Adam Pelech,D,NYI,30,82,8,25,33
51,8474151,Ryan McDonagh,D,TBL,35,82,5,28,33
51,8482655,J.J. Moser,D,TBL,24,82,3,30,33
51,8482089,Jake Neighbours,L,STL,22,82,17,15,32
51,8477450,Jason Dickinson,C,CHI,29,82,17,15,32
51,8480806,Isac Lundestrom,C,ANA,25,82,15,17,32
51,8480995,Pontus Holmberg,R,TOR,25,82,14,18,32
51,8475343,Nic Dowd,C,WSH,34,82,12,20,32
51,8479992,Michael Rasmussen,C,DET,25,82,11,21,32
51,8480336,Sean Walker,D,CAR,30,82,11,21,32
51,8476892,Colton Parayko,D,STL,31,82,6,26,32
51,8476979,Erik Gustafsson,D,DET,32,82,6,26,32
51,8478507,John Marino,D,UTA,27,82,4,28,32
51,8482125,Alexander Holtz,R,VGK,22,82,16,15,31
51,8476469,Joel Armia,R,MTL,31,82,16,15,31
51,8474715,Cam Atkinson,R,TBL,35,82,15,16,31
51,8478109,Victor Olofsson,L,VGK,29,82,15,16,31
51,8480980,Connor Dewar,C,TOR,25,82,13,18,31
51,8484153,Leo Carlsson,C,ANA,20,82,13,18,31
51,8478133,Jake Evans,C,MTL,28,82,12,19,31
51,8470621,Corey Perry,R,EDM,39,82,11,20,31
51,8477507,Nikita Zadorov,D,BOS,29,82,10,21,31
51,8476374,Sean Kuraly,C,CBJ,31,82,9,22,31
51,8480043,Timothy Liljegren,D,TOR,25,82,6,25,31
51,8478500,Ivan Provorov,D,CBJ,27,82,5,26,31
51,8475324,Nick Jensen,D,OTT,34,82,5,26,31
51,8474673,TJ Brodie,D,CHI,34,82,3,28,31
51,8480807,Mattias Samuelsson,D,BUF,24,82,0,31,31
51,8479414,Nathan Bastian,R,NJD,27,82,14,16,30
51,8476897,Oskar Sundqvist,C,STL,30,82,13,17,30
51,8480748,Kiefer Sherwood,L,VAN,29,82,13,17,30
51,8477488,Brett Pesce,D,NJD,30,82,10,20,30
51,8483468,Jiri Kulich,C,BUF,20,82,9,21,30
51,8475200,Dmitry Orlov,D,CAR,33,82,8,22,30
51,8477506,Ryan Pulock,D,NYI,30,82,6,24,30
51,8476331,Dylan DeMelo,D,WPG,31,82,1,29,30
51,8481032,Paul Cotter,C,NJD,25,82,18,11,29
51,8479393,Noah Gregor,C,OTT,26,82,16,13,29
51,8479316,Luke Kunin,C,SJS,27,82,16,13,29
51,8479591,Michael Eyssimont,C,TBL,28,82,15,14,29
51,8482149,Cole Perfetti,C,WPG,22,82,13,16,29
51,8480813,Joe Veleno,C,DET,24,82,13,16,29
51,8479368,Max Jones,L,BOS,26,82,12,17,29
51,8477839,Conor Sheary,L,TBL,32,82,11,18,29
51,8483505,Matthew Poitras,C,BOS,20,82,10,19,29
51,8480871,Adam Boqvist,D,FLA,24,82,9,20,29
51,8480222,Sebastian Aho,D,PIT,28,82,5,24,29
51,8473507,Jeff Petry,D,DET,37,82,3,26,29
51,8481560,Arthur Kaliyev,R,LAK,23,82,13,15,28
51,8475193,Tomas Tatar,L,NJD,34,82,13,15,28
51,8478508,Yakov Trenin,C,MIN,27,82,13,15,28
51,8477903,Garnet Hathaway,R,PHI,33,82,12,16,28
51,8475220,Marcus Foligno,L,MIN,33,82,9,19,28
51,8482803,Olen Zellweger,D,ANA,21,82,9,19,28
51,8481708,Zac Jones,D,NYR,24,82,8,20,28
51,8481656,Aliaksei Protas,C,WSH,23,82,6,22,28
51,8480878,Nils Lundkvist,D,DAL,24,82,6,22,28
51,8480073,Erik Brannstrom,D,COL,25,82,4,24,28
51,8479983,Mario Ferraro,D,SJS,26,82,3,25,28
51,8478882,Vladislav Gavrikov,D,LAK,29,82,3,25,28
51,8481093,Rafael Harvey-Pinard,L,MTL,25,82,17,10,27
51,8480789,Oliver Wahlstrom,R,NYI,24,82,14,13,27
51,8483457,Lane Hutson,D,MTL,20,82,14,13,27
51,8484166,Adam Fantilli,C,CBJ,20,82,14,13,27
51,8482079,Marco Rossi,C,MIN,23,82,12,15,27
51,8482807,Ethan Del Mastro,D,CHI,21,82,12,15,27
51,8480855,Jack McBain,C,UTA,24,82,11,16,27
51,8481522,Peyton Krebs,C,BUF,23,82,9,18,27
51,8481606,Jordan Spence,D,LAK,23,82,7,20,27
51,8479976,Juuso Valimaki,D,UTA,26,82,3,24,27
51,8478136,Jake Middleton,D,MIN,28,82,8,18,26
51,8477406,Mattias Janmark,C,EDM,32,82,7,19,26
51,8480873,Rasmus Sandin,D,WSH,24,82,5,21,26
51,8476463,Jonas Brodin,D,MIN,31,82,5,21,26
51,8481568,Alex Vlasic,D,CHI,23,82,4,22,26
51,8481517,Brett Leason,R,ANA,25,82,14,11,25
51,8481601,Simon Holmstrom,R,NYI,23,82,13,12,25
51,8476878,Zemgus Girgensons,L,TBL,30,82,13,12,25
51,8478569,Noel Acciari,C,PIT,33,82,12,13,25
51,8482259,Bobby McMann,C,TOR,28,82,12,13,25
51,8484203,Bradly Nadeau,L,CAR,19,82,11,14,25
51,8482101,Danil Gushchin,L,SJS,22,82,9,16,25
51,8476422,Mike Reilly,D,NYI,31,82,7,18,25
51,8476891,Matt Grzelcyk,D,PIT,30,82,5,20,25
51,8477425,Miles Wood,L,COL,29,82,16,8,24
51,8477919,Frederick Gaudreau,C,MIN,31,82,14,10,24
51,8477953,Kasperi Kapanen,R,STL,28,82,13,11,24
51,8482062,Cole Smith,L,NSH,29,82,10,14,24
51,8477015,Connor Brown,R,EDM,30,82,10,14,24
51,8482762,Simon Edvinsson,D,DET,21,82,10,14,24
51,8473533,Jordan Staal,C,CAR,36,82,9,15,24
51,8482166,Shakir Mukhamadullin,D,SJS,22,82,7,17,24
51,8483763,Maksymilian Szuber,D,UTA,22,82,6,18,24
51,8482142,Jamie Drysdale,D,PHI,22,82,5,19,24
51,8482122,Brock Faber,D,MIN,22,82,3,21,24
51,8477845,Trevor van Riemsdyk,D,WSH,33,82,1,23,24
51,8484145,Zach Benson,L,BUF,19,82,13,10,23
51,8478413,Jordan Greenway,L,BUF,27,82,11,12,23
51,8480835,Jack Drury,C,CAR,24,82,9,14,23
51,8476889,Radek Faksa,C,STL,30,82,9,14,23
51,8482624,Daniil Miromanov,D,CGY,27,82,8,15,23
51,8475462,Radko Gudas,D,ANA,34,82,6,17,23
51,8481567,Henry Thrun,D,SJS,23,82,5,18,23
51,8480246,Nick Perbix,D,TBL,26,82,4,19,23
51,8478851,Alexandre Carrier,D,NSH,28,82,3,20,23
51,8478416,Erik Cernak,D,TBL,27,82,3,20,23
51,8480035,Henri Jokiharju,D,BUF,25,82,3,20,23
51,8478443,Brandon Carlo,D,BOS,28,82,3,20,23
51,8477499,Rasmus Ristolainen,D,PHI,30,82,3,20,23
51,8480172,Jan Rutta,D,SJS,34,82,3,20,23
51,8477335,Kyle Burroughs,D,LAK,29,82,3,20,23
51,8477220,Nate Schmidt,D,FLA,33,82,2,21,23
51,8475233,David Savard,D,MTL,34,82,2,21,23
51,8480950,Ilya Lyubushkin,D,DAL,30,82,2,21,23
51,8476442,Matt Nieto,L,PIT,32,82,13,9,22
51,8480281,Alexey Toropchenko,R,STL,25,82,12,10,22
51,8476278,Colin Blackwell,C,DAL,31,82,10,12,22
51,8480074,Alexandre Texier,C,STL,25,82,9,13,22
51,8482666,Scott Morrow,D,CAR,22,82,9,13,22
51,8479980,Nicolas Hague,D,VGK,26,82,5,17,22
51,8478468,Jeremy Lauzon,D,NSH,27,82,5,17,22
51,8482245,Artem Zub,D,OTT,29,82,4,18,22
51,8478178,Darren Raddysh,D,TBL,28,82,4,18,22
51,8480796,Martin Fehervary,D,WSH,25,82,2,20,22
51,8475690,Chris Tanev,D,TOR,35,82,2,20,22
51,8477392,Hudson Fasching,R,NYI,29,82,14,7,21
51,8482858,Ryker Evans,D,SEA,23,82,8,13,21
51,8477369,Carson Soucy,D,VAN,30,82,5,16,21
51,8476457,Adam Larsson,D,SEA,32,82,4,17,21
51,8479371,Dante Fabbro,D,NSH,26,82,3,18,21
51,8476967,Brett Kulak,D,EDM,30,82,2,19,21
51,8483490,Pavel Mintyukov,D,ANA,21,82,1,20,21
51,8476312,Josh Manson,D,COL,33,82,12,8,20
51,8483495,Simon Nemec,D,NJD,20,82,11,9,20
51,8483493,Frank Nazar,C,CHI,20,82,8,12,20
51,8482073,Braden Schneider,D,NYR,23,82,7,13,20
51,8476467,Jamie Oleksiak,D,SEA,32,82,7,13,20
51,8483445,Cutter Gauthier,L,ANA,20,82,6,14,20
51,8482141,Lukas Cormier,D,VGK,22,82,6,14,20
51,8474090,Brendan Smith,D,DAL,35,82,6,14,20
51,8475188,Brayden McNabb,D,VGK,33,82,5,15,20
51,8476525,Colin Miller,D,WPG,32,82,5,15,20
51,8482470,Ilya Solovyov,D,CGY,24,82,5,15,20
51,8479402,Jake Bean,D,CGY,26,82,4,16,20
51,8475279,Ben Chiarot,D,DET,33,82,3,17,20
51,8479369,Andrew Peeke,D,BOS,26,82,3,17,20
51,8479324,Ryan Lindgren,D,NYR,26,82,3,17,20
51,8481178,Egor Zamula,D,PHI,24,82,2,18,20
51,8475790,Erik Gudbranson,D,CBJ,32,82,1,19,20
51,8475231,Casey Cizikas,C,NYI,33,82,13,6,19
51,8478434,Keegan Kolesar,R,VGK,27,82,10,9,19
51,8476473,Connor Murphy,D,CHI,31,82,8,11,19
51,8482749,Joshua Roy,R,MTL,21,82,8,11,19
51,8479998,Mikey Anderson,D,LAK,25,82,6,13,19
51,8478013,Jake Walman,D,SJS,28,82,4,15,19
51,8480860,Kevin Bahl,D,CGY,24,82,4,15,19
51,8478399,Jonas Siegenthaler,D,NJD,27,82,3,16,19
51,8481014,Alexander Romanov,D,NYI,24,82,3,16,19
51,8480049,Dylan Samberg,D,WPG,25,82,1,18,19
51,8476858,Phillip Di Giuseppe,L,VAN,31,82,11,7,18
51,8482074,Connor Zary,C,CGY,23,82,10,8,18
51,8473453,Trevor Lewis,C,LAK,37,82,10,8,18
51,8482702,Logan Stankoven,C,DAL,21,82,10,8,18
51,8481524,Bowen Byram,D,BUF,23,82,10,8,18
51,8480021,Jack Studnicka,C,LAK,25,82,9,9,18
51,8477505,Alexander Wennberg,C,SJS,30,82,9,9,18
51,8478432,Christian Fischer,R,DET,27,82,7,11,18
51,8474013,Ian Cole,D,UTA,35,82,7,11,18
51,8483524,Shane Wright,C,SEA,20,82,5,13,18
51,8480834,Ty Emberson,D,SJS,24,82,5,13,18
51,8475181,Nick Leddy,D,STL,33,82,4,14,18
51,8483482,Tristan Luneau,D,ANA,20,82,4,14,18
51,8482087,Kaiden Guhle,D,MTL,22,82,3,15,18
51,8475455,Brenden Dillon,D,NJD,34,82,0,18,18
51,8482155,Alex Laferriere,R,LAK,23,82,13,4,17
51,8481028,Martin Pospisil,C,CGY,25,82,9,8,17
51,8475842,Sam Carrick,C,NYR,32,82,8,9,17
51,8483489,Fraser Minten,C,TOR,31,82,8,9,17
51,8480448,Parker Kelly,L,COL,25,82,7,10,17
51,8480870,Bo Groulx,C,NYR,24,82,7,10,17
51,8480990,Declan Chisholm,D,MIN,24,82,7,10,17
51,8482712,Oskar Olausson,R,COL,22,82,5,12,17
51,8471677,Jack Johnson,D,CBJ,37,82,4,13,17
51,8475762,Derek Forbort,D,VAN,32,82,3,14,17
51,8470600,Ryan Suter,D,STL,39,82,1,16,17
51,8482859,Zack Ostapchuk,C,OTT,21,82,11,5,16
51,8482809,Jackson Blake,R,CAR,21,82,10,6,16
51,8482077,Dylan Holloway,L,EDM,23,82,10,6,16
51,8476624,Barclay Goodrow,C,SJS,31,82,7,9,16
51,8483012,Logan Morrison,C,SEA,22,82,7,9,16
51,8484149,Gavin Brindley,C,CBJ,20,82,5,11,16
51,8476372,Nick Seeler,D,PHI,31,82,4,12,16
51,8474612,Travis Hamonic,D,OTT,34,82,4,12,16
51,8478859,Niko Mikkola,D,FLA,28,82,1,15,16
51,8477353,Tyler Motte,C,DET,29,82,8,7,15
51,8479638,Justin Brazeau,R,BOS,26,82,6,9,15
51,8477365,Connor Clifton,D,BUF,29,82,4,11,15
51,8483471,Brad Lambert,C,WPG,31,82,4,11,15
51,8483466,Kevin Korchinski,D,CHI,20,82,3,12,15
51,8482733,Logan Mailloux,D,MTL,31,82,2,13,15
51,8477931,Tomas Nosek,L,FLA,32,82,2,13,15
51,8476879,Cody Ceci,D,EDM,31,82,1,14,15
51,8476429,Scott Mayfield,D,NYI,32,82,0,15,15
51,8480025,MacKenzie Entwistle,R,FLA,25,82,7,7,14
51,8482679,Matt Coronato,R,CGY,22,82,6,8,14
51,8478211,Dryden Hunt,L,CGY,29,82,6,8,14
51,8479291,Kevin Rooney,C,CGY,31,82,6,8,14
51,8479661,Tanner Jeannot,L,LAK,27,82,4,10,14
51,8477034,Jaycob Megna,D,FLA,32,82,3,11,14
51,8477938,Haydn Fleury,D,WPG,28,82,7,6,13
51,8481641,Joel Kiviranta,L,COL,28,82,6,7,13
51,8481699,Aku Raty,R,UTA,23,82,5,8,13
51,8482659,Josh Doan,R,UTA,22,82,4,9,13
51,8478450,Parker Wotherspoon,D,BOS,27,82,4,9,13
51,8479576,Vincent Desharnais,D,VAN,28,82,2,11,13
51,8476822,Luke Glendening,C,TBL,35,82,10,2,12
51,8483397,Marc McLaughlin,C,BOS,25,82,9,3,12
51,8482070,Mitchell Chaffee,R,TBL,26,82,8,4,12
51,8482145,Mavrik Bourque,C,DAL,22,82,5,7,12
51,8483499,Liam Ohgren,L,MIN,20,82,4,8,12
51,8481605,Jackson LaCombe,D,ANA,23,82,2,10,12
51,8483565,Nick Blankenburg,D,NSH,26,82,1,11,12
51,8479359,Beck Malenstyn,L,BUF,26,82,7,4,11
51,8474062,Riley Nash,C,NYR,35,82,6,5,11
51,8484911,Collin Graf,R,SJS,22,82,5,6,11
51,8483567,Georgii Merkulov,C,BOS,24,82,5,6,11
51,8482787,Nikita Chibrikov,R,WPG,31,82,5,6,11
51,8474567,Zach Bogosian,D,MIN,34,82,3,8,11
51,8481122,Simon Benoit,D,TOR,26,82,3,8,11
51,8480879,Jacob Bernard-Docker,D,OTT,24,82,2,9,11
51,8475177,Calvin de Haan,D,COL,33,82,2,9,11
51,8478874,Adam Gaudette,C,OTT,28,82,1,10,11
51,8482713,Mackie Samoskevich,R,FLA,22,82,7,3,10
51,8482153,Brendan Brisson,C,VGK,23,82,2,8,10
51,8475718,Justin Holl,D,DET,32,82,1,9,10
51,8476441,Joel Edmundson,D,LAK,31,82,1,8,9
51,8483460,David Jiricek,D,CBJ,21,82,2,6,8
51,8482516,Matthew Kessel,D,STL,24,82,1,7,8
51,8479442,Troy Stecher,D,EDM,30,82,1,6,7
51,8482118,Sam Colangelo,R,ANA,23,82,1,6,7
51,8470794,Joe Pavelski,C,,40,0,0,0,0
51,8481703,Valtteri Puustinen,R,PIT,25,0,0,0,0
51,8477950,Tony DeAngelo,D,,29,0,0,0,0
51,8481577,Philip Tomasino,C,NSH,23,0,0,0,0
51,8475197,Tyson Barrie,D,,33,0,0,0,0
51,8471218,Blake Wheeler,R,,38,0,0,0,0
51,8474157,Max Pacioretty,L,,36,0,0,0,0
51,8478466,Daniel Sprong,R,VAN,27,0,0,0,0
51,8475744,Evgeny Kuznetsov,C,,32,0,0,0,0
51,8481019,David Gustafsson,C,WPG,24,0,0,0,0
51,8475906,John Klingberg,D,,32,0,0,0,0
51,8479348,Kale Clague,D,BUF,26,0,0,0,0
51,8476952,Dominic Toninato,C,WPG,30,0,0,0,0
51,8473473,Milan Lucic,L,,36,0,0,0,0
51,8474037,James van Riemsdyk,L,,35,0,0,0,0
51,8474602,Justin Schultz,D,,34,0,0,0,0
51,8482222,Alexander Barabanov,L,,30,0,0,0,0
51,8479372,Josh Mahura,D,SEA,26,0,0,0,0
51,8479982,Conor Timmins,D,TOR,26,0,0,0,0
51,8474031,Kevin Shattenkirk,D,,35,0,0,0,0
51,8480008,Adam Ruzicka,C,,25,0,0,0,0
51,8481059,Scott Perunovich,D,STL,26,0,0,0,0
51,8480884,Calen Addison,D,,24,0,0,0,0
51,8476994,Vinnie Hinostroza,C,NSH,30,0,0,0,0
51,8478452,Caleb Jones,D,LAK,27,0,0,0,0
51,8480157,Calle Rosen,D,COL,30,0,0,0,0
51,8481609,Vladislav Kolyachonok,D,UTA,23,0,0,0,0
51,8479415,Michael McLeod,C,,26,0,0,0,0
51,8476919,Chris Tierney,C,,30,0,0,0,0
51,8479639,Dylan Coghlan,D,WPG,26,0,0,0,0
51,8478146,Matthew Highmore,C,OTT,28,0,0,0,0
51,8478970,Jalen Chatfield,D,CAR,28,0,0,0,0
51,8480205,Emil Bemstrom,C,PIT,25,0,0,0,0
51,8474884,Mike Hoffman,C,,35,0,0,0,0
51,8471274,Alex Goligoski,D,,39,0,0,0,0
51,8478104,Sammy Blais,L,,28,0,0,0,0
51,8474870,Tyler Johnson,C,,34,0,0,0,0
51,8476913,Devin Shore,C,MIN,30,0,0,0,0
51,8481598,Philip Broberg,D,EDM,23,0,0,0,0
51,8480058,Pierre-Olivier Joseph,D,STL,25,0,0,0,0
51,8480891,Michael Kesselring,D,UTA,24,0,0,0,0
51,8477979,Nicolas Aube-Kubel,R,BUF,28,0,0,0,0
51,8476871,Tanner Pearson,L,,32,0,0,0,0
51,8476393,Nick Cousins,C,,31,0,0,0,0
51,8479977,Kailer Yamamoto,R,,26,0,0,0,0
51,8479543,Michael Pezzetta,L,MTL,26,0,0,0,0
51,8477018,Ben Hutton,D,VGK,31,0,0,0,0
51,8480762,Eric Robinson,L,CAR,29,0,0,0,0
51,8474034,Pat Maroon,L,CHI,36,0,0,0,0
51,8481058,Jesse Ylönen,R,,25,0,0,0,0
51,8475179,Dmitry Kulikov,D,FLA,34,0,0,0,0
51,8481527,Kaedan Korczak,D,VGK,23,0,0,0,0
51,8473449,Kyle Okposo,R,,36,0,0,0,0
51,8482192,Isaak Phillips,D,CHI,23,0,0,0,0
51,8480727,Zach Whitecloud,D,VGK,28,0,0,0,0
51,8479346,Dillon Dube,C,,26,0,0,0,0
51,8480821,Filip Zadina,R,,25,0,0,0,0
51,8480001,Urho Vaakanainen,D,ANA,25,0,0,0,0
51,8470966,Mark Giordano,D,,41,0,0,0,0
51,8480853,Liam Foudy,C,,24,0,0,0,0
51,8475225,Craig Smith,C,CHI,35,0,0,0,0
51,8479972,Mason Shaw,C,WPG,26,0,0,0,0
51,8478451,Ethan Bear,D,WSH,27,0,0,0,0
51,8474040,Sam Gagner,C,,35,0,0,0,0
51,8480196,Jacob Bryson,D,BUF,27,0,0,0,0
51,8479984,Cal Foote,D,,26,0,0,0,0
51,8480011,Klim Kostin,C,SJS,25,0,0,0,0
51,8482176,Wyatt Kaiser,D,CHI,22,0,0,0,0
51,8476988,Matt Benning,D,SJS,30,0,0,0,0
51,8479370,Tyson Jost,C,CAR,26,0,0,0,0
51,8477464,Nic Petan,C,,29,0,0,0,0
51,8477380,Jonny Brodzinski,C,NYR,31,0,0,0,0
51,8480070,Ian Mitchell,D,BOS,25,0,0,0,0
51,8479315,Joey Anderson,R,CHI,26,0,0,0,0
51,8478099,Kevin Labanc,R,,29,0,0,0,0
51,8476874,Olli Maatta,D,DET,30,0,0,0,0
51,8475208,Brian Dumoulin,D,ANA,33,0,0,0,0
51,8478430,Oliver Kylington,D,,27,0,0,0,0
51,8479536,Axel Jonsson-Fjallby,L,WPG,26,0,0,0,0
51,8479671,Mathieu Olivier,R,CBJ,27,0,0,0,0
51,8471709,Marc-Edouard Vlasic,D,SJS,37,0,0,0,0
51,8479328,Julien Gauthier,R,NYI,27,0,0,0,0
51,8478421,A.J. Greer,L,FLA,28,0,0,0,0
51,8477573,Nathan Walker,L,STL,30,0,0,0,0
51,8481537,Nikita Okhotiuk,D,CGY,24,0,0,0,0
51,8474166,Alec Martinez,D,CHI,37,0,0,0,0
51,8470610,Zach Parise,L,,40,0,0,0,0
51,8477478,William Carrier,L,CAR,30,0,0,0,0
51,8479344,Jesse Puljujarvi,R,PIT,26,0,0,0,0
51,8480887,Jordan Harris,D,MTL,24,0,0,0,0
51,8478502,Dennis Gilbert,D,BUF,28,0,0,0,0
51,8482730,Brandt Clarke,D,LAK,21,0,0,0,0
51,8480355,Mark Kastelic,C,BOS,25,0,0,0,0
51,8475750,Jon Merrill,D,MIN,32,0,0,0,0
51,8475164,Jakob Silfverberg,R,,34,0,0,0,0
51,8477944,Jakub Vrana,L,,28,0,0,0,0
51,8479439,Jacob MacDonald,D,COL,31,0,0,0,0
51,8474568,Luke Schenn,D,NSH,35,0,0,0,0
51,8478454,Noah Juulsen,D,VAN,27,0,0,0,0
51,8475752,Tyler Pitlick,C,,33,0,0,0,0
51,8482148,Hendrix Lapierre,C,WSH,22,0,0,0,0
51,8481167,Brayden Pachal,D,CGY,25,0,0,0,0
51,8478043,Sam Lafferty,C,BUF,29,0,0,0,0
51,8479321,Lucas Johansen,D,,27,0,0,0,0
51,8471699,Andrew Cogliano,C,,37,0,0,0,0
51,8481521,Ronnie Attard,D,PHI,25,0,0,0,0
51,8481161,Jake Christiansen,D,CBJ,25,0,0,0,0
51,8479458,Nikita Zaitsev,D,,33,0,0,0,0
51,8479619,Michael Carcone,L,UTA,28,0,0,0,0
51,8479026,Philippe Myers,D,TOR,27,0,0,0,0
51,8477330,Dominik Kubalik,L,,29,0,0,0,0
51,8481617,Vasily Podkolzin,R,VAN,23,0,0,0,0
51,8481701,Santeri Hatakka,D,NJD,23,0,0,0,0
51,8479514,Rem Pitlick,C,,27,0,0,0,0
51,8477446,Michael McCarron,R,NSH,29,0,0,0,0
51,8470604,Jeff Carter,C,,39,0,0,0,0
51,8482241,Radim Zohorna,L,,28,0,0,0,0
51,8480289,Morgan Barron,C,WPG,26,0,0,0,0
51,8479379,Givani Smith,R,SJS,26,0,0,0,0
51,8480216,Jacob Peterson,C,,25,0,0,0,0
51,8477851,Jordan Oesterle,D,BOS,32,0,0,0,0
51,8484258,Sam Malinski,D,COL,26,0,0,0,0
51,8478904,Steven Lorentz,C,,28,0,0,0,0
51,8482095,Tyler Kleven,D,OTT,22,0,0,0,0
51,8480848,Ty Dellandrea,C,SJS,24,0,0,0,0
51,8476884,Derrick Pouliot,D,,30,0,0,0,0
51,8479336,Carl Grundstrom,R,SJS,27,0,0,0,0
51,8482964,Arber Xhekaj,D,MTL,23,0,0,0,0
51,8471686,Marc Staal,D,,37,0,0,0,0
51,8477887,Patrick Brown,C,BOS,32,0,0,0,0
51,8478495,Denis Gurianov,R,,27,0,0,0,0
51,8473504,Cal Clutterbuck,R,,37,0,0,0,0
51,8481550,Adam Beckman,L,NJD,23,0,0,0,0
51,8480845,Rasmus Kupari,C,WPG,24,0,0,0,0
51,8474009,Nick Bonino,C,,36,0,0,0,0
51,8478585,Derek Ryan,C,EDM,38,0,0,0,0
51,8477962,Brendan Lemieux,L,CAR,28,0,0,0,0
51,8482861,Vincent Iorio,D,WSH,22,0,0,0,0
51,8479378,Logan Stanley,D,WPG,26,0,0,0,0
51,8473446,Erik Johnson,D,PHI,36,0,0,0,0
51,8481743,Marc Del Gaizo,D,NSH,25,0,0,0,0
51,8477384,Josh Brown,D,EDM,30,0,0,0,0
51,8482165,Yan Kuznetsov,D,CGY,22,0,0,0,0
51,8478424,Jansen Harkins,C,ANA,27,0,0,0,0
51,8482144,Jack Thompson,D,SJS,22,0,0,0,0
51,8478512,Austin Czarnik,C,,32,0,0,0,0
51,8477527,Ross Johnston,L,ANA,30,0,0,0,0
51,8479383,Boris Katchouk,L,,26,0,0,0,0
51,8482094,Daemon Hunt,D,MIN,22,0,0,0,0
51,8481719,Maxwell Crozier,D,TBL,24,0,0,0,0
51,8480192,Johnathan Kovacevic,D,NJD,27,0,0,0,0
51,8479376,Victor Mete,D,,26,0,0,0,0
51,8482511,Mason Lohrei,D,BOS,23,0,0,0,0
51,8475825,Jani Hakanpää,D,,32,0,0,0,0
51,8478021,William Lagesson,D,DET,28,0,0,0,0
51,8475795,Dylan McIlrath,D,WSH,32,0,0,0,0
51,8477846,Ryan Carpenter,C,,33,0,0,0,0
51,8481056,Spencer Stastney,D,NSH,24,0,0,0,0
51,8481564,Ryan Johnson,D,BUF,23,0,0,0,0
51,8478017,Mark Friedman,D,VAN,29,0,0,0,0
51,8479320,Max Lajoie,D,SEA,27,0,0,0,0
51,8480075,Cameron Crotty,D,MIN,25,0,0,0,0
51,8484287,Cole McWard,D,VAN,23,0,0,0,0
51,8484254,Akito Hirose,D,VAN,25,0,0,0,0
51,8483407,Brandon Scanlin,D,NYR,25,0,0,0,0
51,8480274,Philip Kemp,D,EDM,25,0,0,0,0
51,8479522,Hardy Haman Aktell,D,WSH,26,0,0,0,0
51,8480007,Jonas Rondbjerg,R,VGK,25,0,0,0,0
51,8477454,Adam Erne,L,,29,0,0,0,0
51,8481679,Maxence Guenette,D,OTT,23,0,0,0,0
51,8480441,Trey Fix-Wolansky,R,CBJ,25,0,0,0,0
51,8483546,Marshall Rifai,D,TOR,26,0,0,0,0
51,8480084,Nick DeSimone,D,NJD,30,0,0,0,0
51,8481030,Jack St. Ivany,D,PIT,25,0,0,0,0
51,8481592,Jakob Pelletier,L,CGY,23,0,0,0,0
51,8478011,Louie Belpedio,D,PHI,28,0,0,0,0
51,8477930,Pierre-Edouard Bellemare,L,,39,0,0,0,0
51,8484321,Nikolas Matinpalo,D,OTT,26,0,0,0,0
51,8482067,Connor Mackey,D,NYR,28,0,0,0,0
51,8481806,Louis Crevier,D,CHI,23,0,0,0,0
51,8484326,Patrik Koch,D,UTA,28,0,0,0,0
51,8477971,Andreas Englund,D,LAK,28,0,0,0,0
51,8481751,Lukas Rousek,R,BUF,25,0,0,0,0
51,8481006,Tyler Tucker,D,STL,24,0,0,0,0
51,8476867,Brendan Gaunce,C,MIN,30,0,0,0,0
51,8479520,Brandon Duhaime,R,WSH,27,0,0,0,0
51,8477073,Kurtis MacDermid,L,NJD,30,0,0,0,0
51,8480874,Adam Ginning,D,PHI,24,0,0,0,0
51,8477473,Justin Bailey,R,SJS,29,0,0,0,0
51,8479066,Ryan Lomberg,L,CGY,30,0,0,0,0
51,8477070,Liam O'Brien,C,UTA,30,0,0,0,0
51,8474618,Marco Scandella,D,,34,0,0,0,0
51,8475797,Jarred Tinordi,D,,32,0,0,0,0
51,8481441,Joe Snively,C,DET,28,0,0,0,0
51,8477244,Chad Ruhwedel,D,NYR,34,0,0,0,0
51,8479772,Zack MacEwen,R,OTT,28,0,0,0,0
51,8481147,Reese Johnson,C,MIN,26,0,0,0,0
51,8481043,Cole Koepke,L,BOS,26,0,0,0,0
51,8483619,Filip Roos,D,OTT,25,0,0,0,0
51,8481541,Samuel Bolduc,D,NYI,24,0,0,0,0
51,8477810,Joel Hanley,D,CGY,33,0,0,0,0
51,8476907,Mackenzie MacEachern,L,,30,0,0,0,0
51,8482652,Walker Duehr,R,CGY,27,0,0,0,0
51,8477126,Jayson Megna,C,,34,0,0,0,0
51,8483398,Declan Carlile,D,TBL,31,0,0,0,0
51,8482929,Emil Lilleberg,D,TBL,23,0,0,0,0
51,8480880,Jakub Lauko,C,MIN,24,0,0,0,0
51,8480245,Olle Lycksell,R,PHI,25,0,0,0,0
51,8480252,Cole Guttman,C,CHI,25,0,0,0,0
51,8477467,Gustav Olofsson,D,SEA,30,0,0,0,0
51,8479968,Vinni Lettieri,C,BOS,29,0,0,0,0
51,8478400,Colin White,C,,27,0,0,0,0
51,8475755,Alexander Petrovic,D,DAL,32,0,0,0,0
51,8481812,Nikolai Knyzhov,D,,27,0,0,0,0
51,8481593,Jayden Struble,D,MTL,23,0,0,0,0
51,8481532,Alex Turcotte,C,LAK,23,0,0,0,0
51,8482126,Emil Andrae,D,PHI,31,0,0,0,0
51,8479944,Zach Aston-Reese,C,VGK,30,0,0,0,0
51,8471817,Ryan Reaves,R,TOR,37,0,0,0,0
51,8481206,John Ludvig,D,PIT,24,0,0,0,0
51,8481599,Victor Soderstrom,D,UTA,23,0,0,0,0
51,8480292,Carson Meyer,R,ANA,27,0,0,0,0
51,8482496,Nils Aman,C,VAN,24,0,0,0,0
51,8479718,Alex Barré-Boulet,C,MTL,27,0,0,0,0
51,8479994,Jaret Anderson-Dolan,C,WPG,25,0,0,0,0
51,8480184,Gustav Lindstrom,D,,26,0,0,0,0
51,8480890,Jan Jenik,R,OTT,24,0,0,0,0
51,8478067,Oskar Lindblom,L,,28,0,0,0,0
51,8476934,Brock McGinn,L,ANA,30,0,0,0,0
51,8479985,Cale Fleury,D,SEA,26,0,0,0,0
51,8484304,Uvis Balinskis,D,FLA,28,0,0,0,0
51,8479981,Jonah Gadjovich,L,FLA,26,0,0,0,0
51,8481716,Dmitri Voronkov,L,CBJ,24,0,0,0,0
51,8474709,Matt Martin,L,,35,0,0,0,0
51,8482634,Alex Steeves,C,TOR,25,0,0,0,0
51,8480823,Alexander Alexeyev,D,WSH,25,0,0,0,0
51,8477541,Dakota Mermis,D,TOR,30,0,0,0,0
51,8483491,Ivan Miroshnichenko,L,WSH,20,0,0,0,0
51,8478477,Mitchell Stephens,C,SEA,27,0,0,0,0
51,8481543,Nikita Alexandrov,C,STL,24,0,0,0,0
51,8479423,Alex Nylander,L,,26,0,0,0,0
51,8482451,Mikael Pyyhtia,L,CBJ,23,0,0,0,0
51,8478831,Kevin Stenlund,C,UTA,28,0,0,0,0
51,8480306,Grant Hutton,D,NYI,29,0,0,0,0
51,8478028,Fredrik Olofsson,L,,28,0,0,0,0
51,8477462,Robert Hagg,D,VGK,29,0,0,0,0
51,8477320,Anton Blidh,L,NYR,29,0,0,0,0
51,8482157,Will Cuylle,L,NYR,22,0,0,0,0
51,8482737,Zack Bolduc,C,STL,21,0,0,0,0
51,8481239,Samuel Fagemo,L,,24,0,0,0,0
51,8481600,Tobias Bjornfot,D,FLA,23,0,0,0,0
51,8478409,Anthony Richard,C,PHI,28,0,0,0,0
51,8474145,Robert Bortuzzo,D,,35,0,0,0,0
51,8475958,Michael Sgarbossa,C,WSH,32,0,0,0,0
51,8479986,Kole Lind,R,DAL,26,0,0,0,0
51,8479249,Andrew Poturalski,C,SJS,30,0,0,0,0
51,8479362,Riley Tufte,L,BOS,26,0,0,0,0
51,8479991,Jake Leschyshyn,C,NYR,25,0,0,0,0
51,8479587,Rhett Gardner,C,PHI,28,0,0,0,0
51,8482744,James Malatesta,L,CBJ,21,0,0,0,0
51,8478854,Ryan Shea,D,PIT,27,0,0,0,0
51,8481591,Sam Poulin,R,,23,0,0,0,0
51,8483512,Matt Savoie,C,EDM,20,0,0,0,0
51,8482102,Vasily Ponomarev,C,PIT,22,0,0,0,0
51,8482162,Roby Jarventie,L,EDM,22,0,0,0,0
51,8481016,Ruslan Iskhakov,C,,24,0,0,0,0
51,8482172,Landon Slaggert,L,CHI,22,0,0,0,0
51,8482747,Brennan Othmann,L,NYR,21,0,0,0,0
51,8480031,Maxime Comtois,L,,25,0,0,0,0
51,8480226,Marián Studenic,R,,26,0,0,0,0
51,8478408,Travis Dermott,D,,28,0,0,0,0
51,8481518,Nolan Foote,L,NJD,24,0,0,0,0
51,8479419,Brett Murray,L,BUF,26,0,0,0,0
51,8482088,Justin Sourdif,R,FLA,22,0,0,0,0
51,8482201,Gage Goncalves,C,TBL,23,0,0,0,0
51,8481578,Graeme Clarke,R,MIN,23,0,0,0,0
51,8482177,Marat Khusnutdinov,C,MIN,22,0,0,0,0
51,8481754,Nikita Nesterenko,C,ANA,23,0,0,0,0
51,8483531,Brian Halonen,L,NJD,25,0,0,0,0
51,8483920,Pierrick Dube,R,WSH,23,0,0,0,0
51,8480851,Akil Thomas,C,LAK,24,0,0,0,0
51,8475235,Nicolas Deslauriers,L,PHI,33,0,0,0,0
51,8482476,Emil Heineman,L,MTL,23,0,0,0,0
51,8477149,Scott Sabourin,R,SJS,32,0,0,0,0
51,8483549,Lucas Condotta,L,MTL,27,0,0,0,0
51,8482765,Isak Rosen,R,BUF,21,0,0,0,0
51,8481237,Kyle MacLean,C,NYI,25,0,0,0,0
51,8481024,Linus Karlsson,C,VAN,25,0,0,0,0
51,8481690,Tyler Angle,C,,24,0,0,0,0
51,8483570,Ben Meyers,C,SEA,26,0,0,0,0
51,8481655,Cole Schwindt,R,CGY,23,0,0,0,0
51,8481462,Mason Morelli,L,VGK,28,0,0,0,0
51,8483401,Marc Johnstone,R,PIT,28,0,0,0,0
51,8478956,Samuel Laberge,L,NJD,27,0,0,0,0
51,8479533,Joona Koppanen,L,,26,0,0,0,0
51,8482197,Adam Raska,R,MIN,23,0,0,0,0
51,8482250,Callahan Burke,C,VGK,27,0,0,0,0
51,8482784,Zach Dean,C,STL,21,0,0,0,0
51,8484255,Jason Polin,R,COL,25,0,0,0,0
51,8481077,John Leonard,L,,26,0,0,0,0
51,8481534,Raphael Lavoie,C,EDM,24,0,0,0,0
51,8483609,Adam Klapka,R,CGY,24,0,0,0,0
51,8482751,Ryan Winterton,C,SEA,21,0,0,0,0
51,8480267,Sammy Walker,C,MIN,25,0,0,0,0
51,8475766,Austin Watson,L,,32,0,0,0,0
51,8482460,Matt Rempe,C,NYR,22,0,0,0,0
51,8481065,Angus Crookshank,L,OTT,25,0,0,0,0
51,8481070,Hugh McGing,L,,26,0,0,0,0
51,8476323,Max McCormick,L,SEA,32,0,0,0,0
51,8483395,Arshdeep Bains,L,VAN,23,0,0,0,0
51,8484259,Ondrej Pavel,C,COL,31,0,0,0,0
51,8483432,Luca Del Bel Belluz,C,CBJ,31,0,0,0,0
51,8483045,Cameron Butler,R,CBJ,31,0,0,0,0
51,8482061,Brandon Biro,L,SEA,26,0,0,0,0
51,8477401,John Hayden,C,SEA,29,0,0,0,0
51,8475278,Byron Froese,C,,33,0,0,0,0
51,8478446,Glenn Gawdin,C,LAK,27,0,0,0,0
51,8477993,Justin Kirkland,C,CGY,28,0,0,0,0
51,8482147,Jean-Luc Foudy,C,COL,22,0,0,0,0
51,8480032,Shane Bowers,C,NJD,25,0,0,0,0
51,8479330,Brandon Gignac,C,MTL,27,0,0,0,0
51,8480776,Sheldon Rempal,R,,29,0,0,0,0
51,8475413,Justin Dowling,C,NJD,34,0,0,0,0
51,8481726,Adam Edstrom,C,NYR,24,0,0,0,0
51,8480844,Grigori Denisenko,L,VGK,24,0,0,0,0
51,8478147,Bokondji Imama,L,PIT,28,0,0,0,0
51,8478881,Brett Seney,L,CHI,28,0,0,0,0
51,8483630,Pavol Regenda,L,ANA,25,0,0,0,0
51,8480836,Jonathan Gruden,C,,24,0,0,0,0
51,8484314,Jiri Smejkal,L,,28,0,0,0,0
51,8475780,Chris Wagner,R,COL,33,0,0,0,0
51,8479546,Oskar Steen,C,,26,0,0,0,0
51,8483597,Milos Kelemen,L,UTA,25,0,0,0,0
51,8481789,Tye Kartye,L,SEA,23,0,0,0,0
51,8484325,Waltteri Merela,C,TBL,26,0,0,0,0
51,8479421,Jacob Moverare,D,LAK,26,0,0,0,0
51,8481585,Egor Afanasyev,L,SJS,23,0,0,0,0
51,8479547,Matthew Phillips,R,,26,0,0,0,0
51,8479367,William Lockwood,R,FLA,26,0,0,0,0
51,8476915,Jujhar Khaira,L,,30,0,0,0,0
51,8481422,Jacob Lucchini,C,NSH,29,0,0,0,0
51,8480468,James Hamblin,L,EDM,25,0,0,0,0
51,8478051,Max Willman,C,NJD,29,0,0,0,0
51,8481556,John Beecher,C,BOS,23,0,0,0,0
51,8478078,Rourke Chartier,C,,28,0,0,0,0
52,8478402,Connor McDavid,C,EDM,27,82,48,93,141
52,8477492,Nathan MacKinnon,C,COL,29,82,50,89,139
52,8479318,Auston Matthews,C,TOR,27,82,68,68,136
52,8477934,Leon Draisaitl,C,EDM,29,82,45,79,124
52,8476453,Nikita Kucherov,R,TBL,31,82,36,85,121
52,8477939,William Nylander,R,TOR,28,82,47,72,119
52,8471675,Sidney Crosby,C,PIT,37,82,53,62,115
52,8477956,David Pastrnak,R,BOS,28,82,53,60,113
52,8479314,Matthew Tkachuk,L,FLA,27,82,39,73,112
52,8477409,Carter Verhaeghe,C,FLA,29,82,49,62,111
52,8481559,Jack Hughes,C,NJD,23,82,39,72,111
52,8478864,Kirill Kaprizov,L,MIN,27,82,48,61,109
52,8478550,Artemi Panarin,L,NYR,33,82,30,75,105
52,8477493,Aleksander Barkov,C,FLA,29,82,30,75,105
52,8480002,Nico Hischier,C,NJD,25,82,38,65,103
52,8478420,Mikko Rantanen,R,COL,28,82,48,54,102
52,8478398,Kyle Connor,L,WPG,28,82,41,58,99
52,8480865,Noah Dobson,D,NYI,24,82,23,75,98
52,8478414,Timo Meier,R,NJD,28,82,48,48,96
52,8482116,Tim Stützle,C,OTT,22,82,40,56,96
52,8475166,John Tavares,C,TOR,34,82,42,52,94
52,8478445,Mathew Barzal,C,NYI,27,82,29,65,94
52,8474564,Steven Stamkos,C,NSH,34,82,38,55,93
52,8480023,Robert Thomas,C,STL,25,82,37,56,93
52,8477933,Sam Reinhart,C,FLA,29,82,42,50,92
52,8475172,Nazem Kadri,C,CGY,34,82,46,45,91
52,8477946,Dylan Larkin,C,DET,28,82,37,54,91
52,8480027,Jason Robertson,L,DAL,25,82,27,64,91
52,8478427,Sebastian Aho,C,CAR,27,82,37,53,90
52,8481557,Matt Boldy,L,MIN,23,82,33,56,89
52,8480012,Elias Pettersson,C,VAN,26,82,35,53,88
52,8476389,Vincent Trocheck,C,NYR,31,82,41,46,87
52,8476468,J.T. Miller,C,VAN,31,82,32,55,87
52,8478010,Brayden Point,C,TBL,28,82,47,39,86
52,8478449,Roope Hintz,C,DAL,28,82,43,43,86
52,8477949,Alex Tuch,R,BUF,28,82,26,60,86
52,8480800,Quinn Hughes,D,VAN,25,82,14,72,86
52,8478439,Travis Konecny,R,PHI,27,82,33,52,85
52,8476346,Johnny Gaudreau,L,CBJ,31,82,23,62,85
52,8480069,Cale Makar,D,COL,26,82,23,60,83
52,8476887,Filip Forsberg,L,NSH,30,82,44,38,82
52,8481523,Kirby Dach,C,MTL,23,82,21,61,82
52,8474600,Roman Josi,D,NSH,34,82,17,65,82
52,8480036,Miro Heiskanen,D,DAL,25,82,17,65,82
52,8476853,Morgan Rielly,D,TOR,30,82,15,67,82
52,8473994,Jamie Benn,L,DAL,35,82,38,43,81
52,8479407,Jesper Bratt,L,NJD,26,82,30,50,80
52,8480208,Drake Batherson,R,OTT,26,82,28,52,80
52,8477404,Jake Guentzel,C,TBL,30,82,38,41,79
52,8475168,Matt Duchene,C,DAL,33,82,25,54,79
52,8477504,Josh Morrissey,D,WPG,29,82,19,60,79
52,8478403,Jack Eichel,C,VGK,28,82,31,47,78
52,8480830,Andrei Svechnikov,R,CAR,24,82,27,51,78
52,8477935,Sam Bennett,C,FLA,28,82,40,37,77
52,8479343,Clayton Keller,R,UTA,26,82,34,43,77
52,8477942,Kevin Fiala,L,LAK,28,82,32,45,77
52,8475167,Victor Hedman,D,TBL,34,82,11,66,77
52,8477501,Valeri Nichushkin,R,COL,29,82,36,40,76
52,8475913,Mark Stone,R,VGK,32,82,37,38,75
52,8480801,Brady Tkachuk,L,OTT,25,82,35,40,75
52,8471215,Evgeni Malkin,C,PIT,38,82,29,46,75
52,8476454,Ryan Nugent-Hopkins,C,EDM,31,82,25,50,75
52,8478047,Michael Bunting,L,PIT,29,82,23,52,75
52,8475692,Mats Zuccarello,R,MIN,37,82,17,58,75
52,8482093,Seth Jarvis,C,CAR,22,82,33,41,74
52,8477447,Shea Theodore,D,VGK,29,82,13,61,74
52,8478042,Viktor Arvidsson,R,EDM,31,82,32,41,73
52,8477940,Nikolaj Ehlers,L,WPG,28,82,30,43,73
52,8477476,Artturi Lehkonen,L,COL,29,82,46,26,72
52,8478493,Joel Eriksson Ek,C,MIN,27,82,31,41,72
52,8479542,Brandon Hagel,L,TBL,26,82,31,41,72
52,8477951,Nick Schmaltz,C,UTA,28,82,28,44,72
52,8473512,Claude Giroux,R,OTT,36,82,21,51,72
52,8479420,Tage Thompson,C,BUF,27,82,32,39,71
52,8477402,Pavel Buchnevich,L,STL,29,82,31,40,71
52,8479323,Adam Fox,D,NYR,26,82,14,57,71
52,8478444,Brock Boeser,R,VAN,27,82,42,28,70
52,8475754,Brock Nelson,C,NYI,33,82,35,35,70
52,8476448,William Karlsson,C,VGK,31,82,30,40,70
52,8479337,Alex DeBrincat,R,DET,27,82,34,35,69
52,8476881,Tomas Hertl,C,VGK,31,82,28,41,69
52,8479385,Jordan Kyrou,C,STL,26,82,24,45,69
52,8475765,Vladimir Tarasenko,R,DET,33,82,21,48,69
52,8479675,Trevor Moore,L,LAK,29,82,34,34,68
52,8474150,Mikael Backlund,C,CGY,35,82,27,41,68
52,8480018,Nick Suzuki,C,MTL,25,82,26,42,68
52,8476460,Mark Scheifele,C,WPG,31,82,22,46,68
52,8478460,Zach Werenski,D,CBJ,27,82,12,56,68
52,8480803,Evan Bouchard,D,EDM,25,82,10,58,68
52,8482740,Wyatt Johnston,C,DAL,21,82,36,31,67
52,8476459,Mika Zibanejad,C,NYR,31,82,29,38,67
52,8475170,Brayden Schenn,C,STL,33,82,26,41,67
52,8474141,Patrick Kane,R,DET,36,82,26,41,67
52,8474578,Erik Karlsson,D,PIT,34,82,16,51,67
52,8476875,Mike Matheson,D,MTL,30,82,16,51,67
52,8475798,Mikael Granlund,C,SJS,32,82,17,49,66
52,8476456,Jonathan Huberdeau,C,CGY,31,82,13,53,66
52,8476483,Rickard Rakell,R,PIT,31,82,34,31,65
52,8476419,Jean-Gabriel Pageau,C,NYI,32,82,25,40,65
52,8478440,Dylan Strome,C,WSH,27,82,18,47,65
52,8478407,Vince Dunn,D,SEA,28,82,17,48,65
52,8476462,Dougie Hamilton,D,NJD,31,82,16,49,65
52,8475786,Zach Hyman,L,EDM,32,82,33,31,64
52,8476479,Phillip Danault,C,LAK,31,82,30,34,64
52,8479400,Pierre-Luc Dubois,L,WSH,26,82,29,35,64
52,8480039,Martin Necas,C,CAR,25,82,26,38,64
52,8471685,Anze Kopitar,C,LAK,37,82,24,40,64
52,8476905,Chandler Stephenson,C,SEA,30,82,18,46,64
52,8480839,Rasmus Dahlin,D,BUF,24,82,17,47,64
52,8481528,Dylan Cozens,C,BUF,23,82,32,31,63
52,8478975,Mason Marchment,L,DAL,29,82,19,44,63
52,8477503,Max Domi,C,TOR,29,82,18,45,63
52,8482745,Mason McTavish,C,ANA,21,82,30,32,62
52,8481533,Trevor Zegras,C,ANA,23,82,24,38,62
52,8477955,Jared McCann,L,SEA,28,82,34,27,61
52,8476399,Blake Coleman,C,CGY,33,82,33,28,61
52,8471214,Alex Ovechkin,L,WSH,39,82,31,30,61
52,8482078,Lucas Raymond,L,DET,22,82,30,31,61
52,8476906,Shayne Gostisbehere,D,CAR,31,82,10,51,61
52,8476539,Jonathan Marchessault,R,NSH,34,82,42,18,60
52,8478498,Jake DeBrusk,L,VAN,28,82,34,26,60
52,8481596,Shane Pinto,C,OTT,24,82,23,37,60
52,8475726,Tyler Toffoli,C,SJS,32,82,34,25,59
52,8478873,Troy Terry,R,ANA,27,82,33,26,59
52,8475184,Chris Kreider,L,NYR,33,82,32,27,59
52,8482665,Matty Beniers,C,SEA,22,82,23,36,59
52,8478401,Pavel Zacha,C,BOS,27,82,20,39,59
52,8477479,Tyler Bertuzzi,L,CHI,29,82,19,40,59
52,8476432,Boone Jenner,C,CBJ,31,82,35,23,58
52,8477407,Anthony Duclair,L,NYI,29,82,32,26,58
52,8477494,Jonathan Drouin,L,COL,29,82,24,34,58
52,8477416,Oliver Bjorkstrand,R,SEA,29,82,23,35,58
52,8477497,Sean Monahan,C,CBJ,30,82,22,36,58
52,8474679,Gustav Nyquist,C,NSH,35,82,18,40,58
52,8471724,Kris Letang,D,PIT,37,82,16,42,58
52,8478396,Noah Hanifin,D,VGK,27,82,13,45,58
52,8479410,Mikhail Sergachev,D,UTA,26,82,7,51,58
52,8477500,Bo Horvat,C,NYI,29,82,34,23,57
52,8473419,Brad Marchand,L,BOS,36,82,23,34,57
52,8475784,Jeff Skinner,C,EDM,32,82,23,34,57
52,8477960,Adrian Kempe,R,LAK,28,82,17,40,57
52,8477021,Alex Kerfoot,C,UTA,30,82,17,40,57
52,8480064,Josh Norris,C,OTT,25,82,28,28,56
52,8478462,Nicolas Roy,C,VGK,27,82,25,31,56
52,8477932,Aaron Ekblad,D,FLA,28,82,21,35,56
52,8482667,William Eklund,L,SJS,22,82,18,38,56
52,8479325,Charlie McAvoy,D,BOS,27,82,10,46,56
52,8475768,Jaden Schwartz,C,SEA,32,82,34,21,55
52,8475169,Evander Kane,L,EDM,33,82,32,23,55
52,8480188,Fabian Zetterlund,L,SJS,25,82,22,33,55
52,8473986,Alex Killorn,L,ANA,35,82,20,35,55
52,8475745,Charlie Coyle,C,BOS,32,82,20,35,55
52,8481540,Cole Caufield,R,MTL,23,82,27,27,54
52,8479339,Patrik Laine,L,CBJ,26,82,25,29,54
52,8474586,Jordan Eberle,R,SEA,34,82,21,33,54
52,8475158,Ryan O'Reilly,C,NSH,33,82,21,33,54
52,8478458,Jack Roslovic,C,CAR,27,82,16,38,54
52,8482124,Quinton Byfield,R,LAK,22,82,15,39,54
52,8481581,Thomas Harley,D,DAL,23,82,14,40,54
52,8480434,Sean Durzi,D,UTA,26,82,12,42,54
52,8478038,Devon Toews,D,COL,30,82,10,44,54
52,8477495,Seth Jones,D,CHI,30,82,6,48,54
52,8474641,Adam Henrique,C,EDM,34,82,36,17,53
52,8480798,Philipp Kurashev,C,CHI,25,82,20,33,53
52,8474565,Alex Pietrangelo,D,VGK,34,82,8,45,53
52,8482159,Tyson Foerster,R,PHI,22,82,26,26,52
52,8482475,Yegor Chinakhov,R,CBJ,23,82,25,27,52
52,8480849,Barrett Hayton,C,UTA,24,82,22,30,52
52,8477496,Elias Lindholm,C,BOS,30,82,21,31,52
52,8475753,Justin Faulk,D,STL,32,82,16,36,52
52,8474590,John Carlson,D,WSH,34,82,9,43,52
52,8478366,Frank Vatrano,R,ANA,30,82,20,31,51
52,8477964,Ivan Barbashev,C,VGK,29,82,20,31,51
52,8477429,Andrew Copp,C,DET,30,82,19,32,51
52,8474563,Drew Doughty,D,LAK,35,82,8,43,51
52,8476880,Tom Wilson,R,WSH,30,82,28,22,50
52,8475794,Tyler Seguin,C,DAL,32,82,26,24,50
52,8475722,Jason Zucker,L,BUF,32,82,23,27,50
52,8475287,Erik Haula,L,NJD,33,82,18,32,50
52,8476458,Ryan Strome,C,ANA,31,82,15,35,50
52,8478397,Rasmus Andersson,D,CGY,28,82,9,41,50
52,8480014,Gabriel Vilardi,C,WPG,25,82,36,13,49
52,8475314,Anders Lee,L,NYI,34,82,28,21,49
52,8475810,Bryan Rust,R,PIT,32,82,24,25,49
52,8475151,Kyle Palmieri,C,NYI,33,82,23,26,49
52,8480797,Joel Farabee,L,PHI,24,82,21,28,49
52,8481711,Matias Maccelli,L,UTA,24,82,18,31,49
52,8478469,Thomas Chabot,D,OTT,27,82,12,37,49
52,8471698,T.J. Oshie,R,WSH,38,82,24,24,48
52,8482113,Anton Lundell,C,FLA,23,82,22,26,48
52,8481560,Arthur Kaliyev,R,LAK,23,82,22,26,48
52,8478519,Anthony Cirelli,C,TBL,27,82,20,28,48
52,8481542,Moritz Seider,D,DET,23,82,6,42,48
52,8482149,Cole Perfetti,C,WPG,22,82,23,24,47
52,8475218,Mattias Ekholm,D,EDM,34,82,12,35,47
52,8480871,Adam Boqvist,D,FLA,24,82,12,35,47
52,8477998,Warren Foegele,L,LAK,28,82,24,22,46
52,8481618,Alex Newhook,C,MTL,23,82,22,24,46
52,8482109,Alexis Lafrenière,L,NYR,23,82,20,26,46
52,8477456,J.T. Compher,L,DET,29,82,19,27,46
52,8470613,Brent Burns,D,CAR,39,82,14,32,46
52,8477986,Brandon Montour,D,SEA,30,82,13,33,46
52,8479425,Filip Hronek,D,VAN,27,82,11,35,46
52,8479999,Casey Mittelstadt,C,COL,26,82,7,39,46
52,8480145,Neal Pionk,D,WPG,29,82,7,39,46
52,8474102,David Perron,L,OTT,36,82,21,24,45
52,8481068,Yegor Sharangovich,C,CGY,26,82,20,25,45
52,8476882,Teuvo Teravainen,L,CHI,30,82,19,26,45
52,8478233,Andrew Mangiapane,L,WSH,28,82,19,26,45
52,8482092,Ridly Greig,C,OTT,22,82,17,28,45
52,8478115,Pierre Engvall,L,NYI,28,82,14,31,45
52,8477498,Darnell Nurse,D,EDM,29,82,9,36,45
52,8476469,Joel Armia,R,MTL,31,82,30,14,44
52,8476438,Brandon Saad,L,STL,32,82,23,21,44
52,8478891,Mason Appleton,C,WPG,28,82,21,23,44
52,8482705,Cole Sillinger,C,CBJ,21,82,20,24,44
52,8480802,Ryan McLeod,C,BUF,25,82,19,25,44
52,8477451,Ryan Hartman,R,MIN,30,82,18,26,44
52,8478055,Gustav Forsling,D,FLA,28,82,11,33,44
52,8482105,Jake Sanderson,D,OTT,22,82,11,33,44
52,8477346,MacKenzie Weegar,D,CGY,30,82,10,34,44
52,8480015,Owen Tippett,R,PHI,25,82,24,19,43
52,8475793,Ryan Johansen,C,PHI,32,82,16,27,43
52,8478463,Anthony Beauvillier,L,PIT,27,82,15,28,43
52,8479987,Morgan Geekie,C,BOS,26,82,13,30,43
52,8482720,Matthew Knies,L,TOR,22,82,12,31,43
52,8476923,Damon Severson,D,CBJ,30,82,10,33,43
52,8475191,Reilly Smith,R,NYR,33,82,21,21,42
52,8482110,Dawson Mercer,C,NJD,23,82,20,22,42
52,8480028,Morgan Frost,C,PHI,25,82,17,25,42
52,8479293,Brandon Tanev,L,SEA,33,82,17,25,42
52,8474149,Evgenii Dadonov,R,DAL,35,82,17,25,42
52,8477511,Anthony Mantha,R,CGY,30,82,16,26,42
52,8476885,Jacob Trouba,D,NYR,30,82,14,28,42
52,8477426,Nicholas Paul,L,TBL,29,82,26,15,41
52,8478474,Lawson Crouse,L,UTA,27,82,25,16,41
52,8478856,Conor Garland,R,VAN,28,82,19,22,41
52,8480459,Pius Suter,C,VAN,28,82,19,22,41
52,8478438,Tommy Novak,C,NSH,27,82,18,23,41
52,8481481,Blake Lizotte,C,PIT,27,82,18,23,41
52,8478109,Victor Olofsson,L,VGK,29,82,17,24,41
52,8478046,Danton Heinen,L,VAN,29,82,15,26,41
52,8482097,Jack Quinn,R,BUF,23,82,15,26,41
52,8476826,Yanni Gourde,C,SEA,33,82,15,26,41
52,8476292,Ondrej Palat,L,NJD,33,82,12,29,41
52,8480220,Noah Cates,L,PHI,25,82,11,30,41
52,8476872,Scott Laughton,C,PHI,30,82,11,30,41
52,8482684,Luke Hughes,D,NJD,21,82,10,31,41
52,8478542,Evan Rodrigues,C,FLA,31,82,18,22,40
52,8479365,Trent Frederic,C,BOS,26,82,18,22,40
52,8480078,Filip Chytil,C,NYR,25,82,15,25,40
52,8476792,Torey Krug,D,STL,33,82,13,27,40
52,8477444,Andre Burakovsky,L,SEA,29,82,12,28,40
52,8475799,Nino Niederreiter,R,WPG,32,82,23,16,39
52,8482175,JJ Peterka,R,BUF,22,82,21,18,39
52,8479525,Ross Colton,C,COL,28,82,18,21,39
52,8478057,Dakota Joshua,C,VAN,28,82,18,21,39
52,8475791,Taylor Hall,L,CHI,33,82,17,22,39
52,8479996,Cody Glass,C,NSH,25,82,17,22,39
52,8476897,Oskar Sundqvist,C,STL,30,82,14,25,39
52,8481186,Logan O'Connor,R,COL,28,82,12,27,39
52,8476329,Travis Boyd,C,MIN,31,82,10,29,39
52,8477948,Travis Sanheim,D,PHI,28,82,7,32,39
52,8475760,Nick Bjugstad,C,UTA,32,82,29,9,38
52,8482079,Marco Rossi,C,MIN,23,82,25,13,38
52,8473533,Jordan Staal,C,CAR,36,82,24,14,38
52,8480068,Ryan Poehling,C,PHI,25,82,21,17,38
52,8480113,Alex Iafallo,L,WPG,31,82,19,19,38
52,8473563,Nicklas Backstrom,C,WSH,37,82,12,26,38
52,8476392,Adam Lowry,C,WPG,31,82,11,27,38
52,8476461,Sean Couturier,C,PHI,32,82,10,28,38
52,8476902,Esa Lindell,D,DAL,30,82,9,29,38
52,8476854,Hampus Lindholm,D,BOS,30,82,7,31,38
52,8476958,Jaccob Slavin,D,CAR,30,82,5,33,38
52,8476869,Brady Skjei,D,NSH,30,82,4,34,38
52,8476979,Erik Gustafsson,D,DET,32,82,3,35,38
52,8481582,Nicholas Robertson,L,TOR,23,82,20,17,37
52,8477450,Jason Dickinson,C,CHI,29,82,20,17,37
52,8478508,Yakov Trenin,C,MIN,27,82,20,17,37
52,8477987,Ryan Donato,C,CHI,28,82,19,18,37
52,8477952,Robby Fabbri,C,ANA,28,82,19,18,37
52,8482089,Jake Neighbours,L,STL,22,82,19,18,37
52,8479345,Jakob Chychrun,D,WSH,26,82,16,21,37
52,8478472,Mathieu Joseph,R,STL,27,82,13,24,37
52,8478882,Vladislav Gavrikov,D,LAK,29,82,11,26,37
52,8482671,Owen Power,D,BUF,22,82,10,27,37
52,8481606,Jordan Spence,D,LAK,23,82,8,29,37
52,8480829,Jesperi Kotkaniemi,C,CAR,24,82,21,15,36
52,8476474,Stefan Noesen,R,NJD,31,82,15,21,36
52,8484144,Connor Bedard,C,CHI,19,82,13,23,36
52,8480748,Kiefer Sherwood,L,VAN,29,82,12,24,36
52,8477435,Ryan Graves,D,PIT,29,82,5,31,36
52,8478500,Ivan Provorov,D,CBJ,27,82,5,31,36
52,8478507,John Marino,D,UTA,27,82,4,32,36
52,8479976,Juuso Valimaki,D,UTA,26,82,4,32,36
52,8481624,Ilya Mikheyev,R,CHI,30,82,22,13,35
52,8480185,Eetu Luostarinen,C,FLA,26,82,17,18,35
52,8474189,Lars Eller,C,PIT,35,82,17,18,35
52,8484153,Leo Carlsson,C,ANA,20,82,16,19,35
52,8482699,Dylan Guenther,R,UTA,21,82,14,21,35
52,8480009,Eeli Tolvanen,R,SEA,25,82,14,21,35
52,8476480,Vladislav Namestnikov,C,WPG,32,82,11,24,35
52,8482660,Kent Johnson,C,CBJ,22,82,9,26,35
52,8480817,K'Andre Miller,D,NYR,24,82,6,29,35
52,8477506,Ryan Pulock,D,NYI,30,82,5,30,35
52,8480281,Alexey Toropchenko,R,STL,25,82,20,14,34
52,8480813,Joe Veleno,C,DET,24,82,15,19,34
52,8474053,Logan Couture,C,SJS,35,82,14,20,34
52,8483808,Andrei Kuzmenko,L,CGY,28,82,13,21,34
52,8475714,Calle Jarnkrok,C,TOR,33,82,12,22,34
52,8482133,Thomas Bordeleau,C,SJS,22,82,11,23,34
52,8477953,Kasperi Kapanen,R,STL,28,82,11,23,34
52,8478911,Matt Roy,D,WSH,29,82,10,24,34
52,8476917,Adam Pelech,D,NYI,30,82,4,30,34
52,8475848,Brendan Gallagher,R,MTL,32,82,21,12,33
52,8473422,Nick Foligno,L,CHI,37,82,18,15,33
52,8483431,Logan Cooley,C,UTA,20,82,17,16,33
52,8479390,Taylor Raddysh,R,WSH,26,82,17,16,33
52,8482624,Daniil Miromanov,D,CGY,27,82,10,23,33
52,8480878,Nils Lundkvist,D,DAL,24,82,8,25,33
52,8480043,Timothy Liljegren,D,TOR,25,82,5,28,33
52,8480873,Rasmus Sandin,D,WSH,24,82,1,32,33
52,8482055,Drew O'Connor,L,PIT,26,82,20,12,32
52,8480893,Kirill Marchenko,R,CBJ,24,82,20,12,32
52,8481580,Connor McMichael,C,WSH,23,82,18,14,32
52,8479393,Noah Gregor,C,OTT,26,82,18,14,32
52,8474715,Cam Atkinson,R,TBL,35,82,16,16,32
52,8477425,Miles Wood,L,COL,29,82,16,16,32
52,8475149,Marcus Johansson,L,MIN,34,82,15,17,32
52,8477989,Christian Dvorak,C,MTL,28,82,12,20,32
52,8475220,Marcus Foligno,L,MIN,33,82,12,20,32
52,8477015,Connor Brown,R,EDM,30,82,12,20,32
52,8481522,Peyton Krebs,C,BUF,23,82,9,23,32
52,8475181,Nick Leddy,D,STL,33,82,7,25,32
52,8483457,Lane Hutson,D,MTL,20,82,6,26,32
52,8475690,Chris Tanev,D,TOR,35,82,2,30,32
52,8481554,Kaapo Kakko,R,NYR,23,82,16,15,31
52,8475763,Kevin Hayes,R,PIT,32,82,15,16,31
52,8482117,Lukas Reichel,L,CHI,22,82,15,16,31
52,8476960,Andreas Athanasiou,C,CHI,30,82,14,17,31
52,8476873,Mark Jankowski,C,NSH,30,82,12,19,31
52,8483515,Juraj Slafkovsky,L,MTL,20,82,11,20,31
52,8481546,Cam York,D,PHI,23,82,10,21,31
52,8481656,Aliaksei Protas,C,WSH,23,82,10,21,31
52,8474716,Jared Spurgeon,D,MIN,35,82,9,22,31
52,8475171,Oliver Ekman-Larsson,D,TOR,33,82,8,23,31
52,8482122,Brock Faber,D,MIN,22,82,7,24,31
52,8476312,Josh Manson,D,COL,33,82,7,24,31
52,8477969,Marcus Pettersson,D,PIT,28,82,4,27,31
52,8476278,Colin Blackwell,C,DAL,31,82,20,10,30
52,8481604,Pavel Dorofeyev,L,VGK,24,82,18,12,30
52,8484166,Adam Fantilli,C,CBJ,20,82,18,12,30
52,8476918,Jimmy Vesey,L,NYR,31,82,17,13,30
52,8476921,Jordan Martinook,L,CAR,32,82,17,13,30
52,8479414,Nathan Bastian,R,NJD,27,82,16,14,30
52,8480855,Jack McBain,C,UTA,24,82,16,14,30
52,8478413,Jordan Greenway,L,BUF,27,82,16,14,30
52,8482146,Luke Evangelista,R,NSH,22,82,15,15,30
52,8475193,Tomas Tatar,L,NJD,34,82,15,15,30
52,8481013,Jonatan Berggren,R,DET,24,82,14,16,30
52,8478020,Michael Amadio,C,OTT,28,82,13,17,30
52,8477947,Sonny Milano,L,WSH,28,82,10,20,30
52,8478178,Darren Raddysh,D,TBL,28,82,8,22,30
52,8475764,Cam Fowler,D,ANA,33,82,5,25,30
52,8476879,Cody Ceci,D,EDM,31,82,5,25,30
52,8482655,J.J. Moser,D,TBL,24,82,3,27,30
52,8478416,Erik Cernak,D,TBL,27,82,3,27,30
52,8479591,Michael Eyssimont,C,TBL,28,82,11,18,29
52,8483763,Maksymilian Szuber,D,UTA,22,82,10,19,29
52,8475200,Dmitry Orlov,D,CAR,33,82,8,21,29
52,8480789,Oliver Wahlstrom,R,NYI,24,82,8,21,29
52,8477499,Rasmus Ristolainen,D,PHI,30,82,8,21,29
52,8482087,Kaiden Guhle,D,MTL,22,82,8,21,29
52,8476422,Mike Reilly,D,NYI,31,82,7,22,29
52,8479941,Justin Danforth,R,CBJ,31,82,17,11,28
52,8475231,Casey Cizikas,C,NYI,33,82,17,11,28
52,8480835,Jack Drury,C,CAR,24,82,14,14,28
52,8481517,Brett Leason,R,ANA,25,82,11,17,28
52,8479353,Brett Howden,C,VGK,26,82,10,18,28
52,8483565,Nick Blankenburg,D,NSH,26,82,7,21,28
52,8476925,Colton Sissons,C,NSH,31,82,6,22,28
52,8474151,Ryan McDonagh,D,TBL,35,82,6,22,28
52,8480336,Sean Walker,D,CAR,30,82,6,22,28
52,8475324,Nick Jensen,D,OTT,34,82,6,22,28
52,8482245,Artem Zub,D,OTT,29,82,5,23,28
52,8476931,Jake McCabe,D,TOR,31,82,2,26,28
52,8476429,Scott Mayfield,D,NYI,32,82,2,26,28
52,8482702,Logan Stankoven,C,DAL,21,82,17,10,27
52,8477507,Nikita Zadorov,D,BOS,29,82,11,16,27
52,8482762,Simon Edvinsson,D,DET,21,82,11,16,27
52,8480003,Jesper Boqvist,C,FLA,26,82,10,17,27
52,8480074,Alexandre Texier,C,STL,25,82,10,17,27
52,8482111,Justin Barron,D,MTL,23,82,9,18,27
52,8478851,Alexandre Carrier,D,NSH,28,82,8,19,27
52,8480246,Nick Perbix,D,TBL,26,82,6,21,27
52,8479983,Mario Ferraro,D,SJS,26,82,5,22,27
52,8475233,David Savard,D,MTL,34,82,5,22,27
52,8476892,Colton Parayko,D,STL,31,82,3,24,27
52,8482259,Bobby McMann,C,TOR,28,82,17,9,26
52,8477919,Frederick Gaudreau,C,MIN,31,82,11,15,26
52,8480806,Isac Lundestrom,C,ANA,25,82,10,16,26
52,8479351,Sam Steel,C,DAL,26,82,7,19,26
52,8482803,Olen Zellweger,D,ANA,21,82,6,20,26
52,8479998,Mikey Anderson,D,LAK,25,82,5,21,26
52,8474673,TJ Brodie,D,CHI,34,82,4,22,26
52,8476331,Dylan DeMelo,D,WPG,31,82,4,22,26
52,8480073,Erik Brannstrom,D,COL,25,82,4,22,26
52,8481014,Alexander Romanov,D,NYI,24,82,3,23,26
52,8481535,Nils Hoglander,L,VAN,24,82,16,9,25
52,8479992,Michael Rasmussen,C,DET,25,82,16,9,25
52,8482166,Shakir Mukhamadullin,D,SJS,22,82,12,13,25
52,8479661,Tanner Jeannot,L,LAK,27,82,12,13,25
52,8477392,Hudson Fasching,R,NYI,29,82,11,14,25
52,8477353,Tyler Motte,C,DET,29,82,10,15,25
52,8478133,Jake Evans,C,MTL,28,82,9,16,25
52,8476889,Radek Faksa,C,STL,30,82,8,17,25
52,8476624,Barclay Goodrow,C,SJS,31,82,7,18,25
52,8482807,Ethan Del Mastro,D,CHI,21,82,6,19,25
52,8475188,Brayden McNabb,D,VGK,33,82,6,19,25
52,8475455,Brenden Dillon,D,NJD,34,82,6,19,25
52,8476525,Colin Miller,D,WPG,32,82,5,20,25
52,8479371,Dante Fabbro,D,NSH,26,82,2,23,25
52,8482073,Braden Schneider,D,NYR,23,82,2,23,25
52,8482125,Alexander Holtz,R,VGK,22,82,18,6,24
52,8481704,Juuso Parssinen,C,NSH,23,82,16,8,24
52,8484145,Zach Benson,L,BUF,19,82,12,12,24
52,8482141,Lukas Cormier,D,VGK,22,82,12,12,24
52,8478432,Christian Fischer,R,DET,27,82,12,12,24
52,8478434,Keegan Kolesar,R,VGK,27,82,11,13,24
52,8478013,Jake Walman,D,SJS,28,82,11,13,24
52,8470621,Corey Perry,R,EDM,39,82,9,15,24
52,8476927,Teddy Blueger,C,VAN,30,82,7,17,24
52,8477839,Conor Sheary,L,TBL,32,82,7,17,24
52,8473507,Jeff Petry,D,DET,37,82,6,18,24
52,8477406,Mattias Janmark,C,EDM,32,82,6,18,24
52,8480834,Ty Emberson,D,SJS,24,82,5,19,24
52,8479359,Beck Malenstyn,L,BUF,26,82,5,19,24
52,8476463,Jonas Brodin,D,MIN,31,82,4,20,24
52,8477220,Nate Schmidt,D,FLA,33,82,3,21,24
52,8481178,Egor Zamula,D,PHI,24,82,2,22,24
52,8478399,Jonas Siegenthaler,D,NJD,27,82,1,23,24
52,8480144,David Kampf,C,TOR,29,82,13,10,23
52,8480995,Pontus Holmberg,R,TOR,25,82,12,11,23
52,8481553,Bobby Brink,R,PHI,23,82,11,12,23
52,8475855,Jesper Fast,R,CAR,33,82,11,12,23
52,8481032,Paul Cotter,C,NJD,25,82,11,12,23
52,8478211,Dryden Hunt,L,CGY,29,82,11,12,23
52,8480980,Connor Dewar,C,TOR,25,82,9,14,23
52,8475343,Nic Dowd,C,WSH,34,82,8,15,23
52,8484203,Bradly Nadeau,L,CAR,19,82,8,15,23
52,8474574,Tyler Myers,D,VAN,34,82,5,18,23
52,8480807,Mattias Samuelsson,D,BUF,24,82,5,18,23
52,8476891,Matt Grzelcyk,D,PIT,30,82,4,19,23
52,8478840,Will Borgen,D,SEA,28,82,2,21,23
52,8476878,Zemgus Girgensons,L,TBL,30,82,15,7,22
52,8481028,Martin Pospisil,C,CGY,25,82,11,11,22
52,8483524,Shane Wright,C,SEA,20,82,10,12,22
52,8483482,Tristan Luneau,D,ANA,20,82,8,14,22
52,8482142,Jamie Drysdale,D,PHI,22,82,6,16,22
52,8481093,Rafael Harvey-Pinard,L,MTL,25,82,5,17,22
52,8477938,Haydn Fleury,D,WPG,28,82,5,17,22
52,8478468,Jeremy Lauzon,D,NSH,27,82,4,18,22
52,8479402,Jake Bean,D,CGY,26,82,4,18,22
52,8475762,Derek Forbort,D,VAN,32,82,0,22,22
52,8473453,Trevor Lewis,C,LAK,37,82,13,8,21
52,8477903,Garnet Hathaway,R,PHI,33,82,12,9,21
52,8481601,Simon Holmstrom,R,NYI,23,82,12,9,21
52,8480448,Parker Kelly,L,COL,25,82,10,11,21
52,8482659,Josh Doan,R,UTA,22,82,9,12,21
52,8476467,Jamie Oleksiak,D,SEA,32,82,8,13,21
52,8477488,Brett Pesce,D,NJD,30,82,5,16,21
52,8481568,Alex Vlasic,D,CHI,23,82,4,17,21
52,8479980,Nicolas Hague,D,VGK,26,82,4,17,21
52,8480860,Kevin Bahl,D,CGY,24,82,4,17,21
52,8478136,Jake Middleton,D,MIN,28,82,3,18,21
52,8475462,Radko Gudas,D,ANA,34,82,3,18,21
52,8477365,Connor Clifton,D,BUF,29,82,2,19,21
52,8475718,Justin Holl,D,DET,32,82,1,20,21
52,8476981,Josh Anderson,R,MTL,30,82,15,5,20
52,8482666,Scott Morrow,D,CAR,22,82,7,13,20
52,8481524,Bowen Byram,D,BUF,23,82,7,13,20
52,8476457,Adam Larsson,D,SEA,32,82,4,16,20
52,8479324,Ryan Lindgren,D,NYR,26,82,2,18,20
52,8474090,Brendan Smith,D,DAL,35,82,1,19,20
52,8475790,Erik Gudbranson,D,CBJ,32,82,1,19,20
52,8479316,Luke Kunin,C,SJS,27,82,12,7,19
52,8482062,Cole Smith,L,NSH,29,82,11,8,19
52,8479368,Max Jones,L,BOS,26,82,10,9,19
52,8482733,Logan Mailloux,D,MTL,31,82,8,11,19
52,8476442,Matt Nieto,L,PIT,32,82,7,12,19
52,8481708,Zac Jones,D,NYR,24,82,6,13,19
52,8477369,Carson Soucy,D,VAN,30,82,5,14,19
52,8477845,Trevor van Riemsdyk,D,WSH,33,82,4,15,19
52,8479398,Samuel Girard,D,COL,26,82,3,16,19
52,8480990,Declan Chisholm,D,MIN,24,82,3,16,19
52,8480035,Henri Jokiharju,D,BUF,25,82,2,17,19
52,8480796,Martin Fehervary,D,WSH,25,82,2,17,19
52,8480950,Ilya Lyubushkin,D,DAL,30,82,1,18,19
52,8482074,Connor Zary,C,CGY,23,82,9,9,18
52,8483012,Logan Morrison,C,SEA,22,82,9,9,18
52,8476822,Luke Glendening,C,TBL,35,82,9,9,18
52,8480025,MacKenzie Entwistle,R,FLA,25,82,8,10,18
52,8476374,Sean Kuraly,C,CBJ,31,82,7,11,18
52,8480021,Jack Studnicka,C,LAK,25,82,6,12,18
52,8476967,Brett Kulak,D,EDM,30,82,5,13,18
52,8482118,Sam Colangelo,R,ANA,23,82,5,13,18
52,8480222,Sebastian Aho,D,PIT,28,82,2,16,18
52,8482077,Dylan Holloway,L,EDM,23,82,14,3,17
52,8482155,Alex Laferriere,R,LAK,23,82,11,6,17
52,8477505,Alexander Wennberg,C,SJS,30,82,10,7,17
52,8482749,Joshua Roy,R,MTL,21,82,9,8,17
52,8481477,Nico Sturm,C,SJS,29,82,8,9,17
52,8478569,Noel Acciari,C,PIT,33,82,8,9,17
52,8483445,Cutter Gauthier,L,ANA,20,82,7,10,17
52,8474013,Ian Cole,D,UTA,35,82,5,12,17
52,8475177,Calvin de Haan,D,COL,33,82,4,13,17
52,8480172,Jan Rutta,D,SJS,34,82,2,15,17
52,8482470,Ilya Solovyov,D,CGY,24,82,9,7,16
52,8483505,Matthew Poitras,C,BOS,20,82,7,9,16
52,8483471,Brad Lambert,C,WPG,31,82,7,9,16
52,8479291,Kevin Rooney,C,CGY,31,82,5,11,16
52,8477335,Kyle Burroughs,D,LAK,29,82,3,13,16
52,8475279,Ben Chiarot,D,DET,33,82,3,13,16
52,8478443,Brandon Carlo,D,BOS,28,82,2,14,16
52,8483468,Jiri Kulich,C,BUF,20,82,7,8,15
52,8475842,Sam Carrick,C,NYR,32,82,7,8,15
52,8483499,Liam Ohgren,L,MIN,20,82,7,8,15
52,8476858,Phillip Di Giuseppe,L,VAN,31,82,6,9,15
52,8477931,Tomas Nosek,L,FLA,32,82,5,10,15
52,8483495,Simon Nemec,D,NJD,20,82,4,11,15
52,8470600,Ryan Suter,D,STL,39,82,4,11,15
52,8478859,Niko Mikkola,D,FLA,28,82,4,11,15
52,8481605,Jackson LaCombe,D,ANA,23,82,3,12,15
52,8481122,Simon Benoit,D,TOR,26,82,3,12,15
52,8479442,Troy Stecher,D,EDM,30,82,3,12,15
52,8480049,Dylan Samberg,D,WPG,25,82,0,15,15
52,8479638,Justin Brazeau,R,BOS,26,82,9,5,14
52,8482679,Matt Coronato,R,CGY,22,82,8,6,14
52,8482145,Mavrik Bourque,C,DAL,22,82,7,7,14
52,8482101,Danil Gushchin,L,SJS,22,82,6,8,14
52,8482516,Matthew Kessel,D,STL,24,82,5,9,14
52,8478874,Adam Gaudette,C,OTT,28,82,4,10,14
52,8476473,Connor Murphy,D,CHI,31,82,3,11,14
52,8483490,Pavel Mintyukov,D,ANA,21,82,1,13,14
52,8479369,Andrew Peeke,D,BOS,26,82,1,13,14
52,8480879,Jacob Bernard-Docker,D,OTT,24,82,1,13,14
52,8482713,Mackie Samoskevich,R,FLA,22,82,4,9,13
52,8478450,Parker Wotherspoon,D,BOS,27,82,3,10,13
52,8474567,Zach Bogosian,D,MIN,34,82,3,10,13
52,8482809,Jackson Blake,R,CAR,21,82,2,11,13
52,8483397,Marc McLaughlin,C,BOS,25,82,8,4,12
52,8477508,Curtis Lazar,C,NJD,29,82,6,6,12
52,8483493,Frank Nazar,C,CHI,20,82,6,6,12
52,8481567,Henry Thrun,D,SJS,23,82,5,7,12
52,8484149,Gavin Brindley,C,CBJ,20,82,5,7,12
52,8471677,Jack Johnson,D,CBJ,37,82,4,8,12
52,8481699,Aku Raty,R,UTA,23,82,4,8,12
52,8476441,Joel Edmundson,D,LAK,31,82,3,9,12
52,8476372,Nick Seeler,D,PHI,31,82,2,10,12
52,8483466,Kevin Korchinski,D,CHI,20,82,1,11,12
52,8482858,Ryker Evans,D,SEA,23,82,5,6,11
52,8481641,Joel Kiviranta,L,COL,28,82,5,6,11
52,8477034,Jaycob Megna,D,FLA,32,82,4,7,11
52,8484911,Collin Graf,R,SJS,22,82,2,9,11
52,8482153,Brendan Brisson,C,VGK,23,82,2,8,10
52,8482070,Mitchell Chaffee,R,TBL,26,82,4,5,9
52,8479576,Vincent Desharnais,D,VAN,28,82,1,8,9
52,8480870,Bo Groulx,C,NYR,24,82,5,3,8
52,8482859,Zack Ostapchuk,C,OTT,21,82,4,4,8
52,8482712,Oskar Olausson,R,COL,22,82,3,5,8
52,8483460,David Jiricek,D,CBJ,21,82,3,5,8
52,8474612,Travis Hamonic,D,OTT,34,82,1,7,8
52,8483489,Fraser Minten,C,TOR,31,82,2,5,7
52,8483567,Georgii Merkulov,C,BOS,24,82,3,3,6
52,8474062,Riley Nash,C,NYR,35,82,2,4,6
52,8482787,Nikita Chibrikov,R,WPG,31,82,1,5,6
52,8470794,Joe Pavelski,C,,40,0,0,0,0
52,8481703,Valtteri Puustinen,R,PIT,25,0,0,0,0
52,8477950,Tony DeAngelo,D,,29,0,0,0,0
52,8481577,Philip Tomasino,C,NSH,23,0,0,0,0
52,8475197,Tyson Barrie,D,,33,0,0,0,0
52,8471218,Blake Wheeler,R,,38,0,0,0,0
52,8474157,Max Pacioretty,L,,36,0,0,0,0
52,8478466,Daniel Sprong,R,VAN,27,0,0,0,0
52,8475744,Evgeny Kuznetsov,C,,32,0,0,0,0
52,8481019,David Gustafsson,C,WPG,24,0,0,0,0
52,8475906,John Klingberg,D,,32,0,0,0,0
52,8479348,Kale Clague,D,BUF,26,0,0,0,0
52,8476952,Dominic Toninato,C,WPG,30,0,0,0,0
52,8473473,Milan Lucic,L,,36,0,0,0,0
52,8474037,James van Riemsdyk,L,,35,0,0,0,0
52,8474602,Justin Schultz,D,,34,0,0,0,0
52,8482222,Alexander Barabanov,L,,30,0,0,0,0
52,8479372,Josh Mahura,D,SEA,26,0,0,0,0
52,8479982,Conor Timmins,D,TOR,26,0,0,0,0
52,8474031,Kevin Shattenkirk,D,,35,0,0,0,0
52,8480008,Adam Ruzicka,C,,25,0,0,0,0
52,8481059,Scott Perunovich,D,STL,26,0,0,0,0
52,8480884,Calen Addison,D,,24,0,0,0,0
52,8476994,Vinnie Hinostroza,C,NSH,30,0,0,0,0
52,8478452,Caleb Jones,D,LAK,27,0,0,0,0
52,8480157,Calle Rosen,D,COL,30,0,0,0,0
52,8481609,Vladislav Kolyachonok,D,UTA,23,0,0,0,0
52,8479415,Michael McLeod,C,,26,0,0,0,0
52,8476919,Chris Tierney,C,,30,0,0,0,0
52,8479639,Dylan Coghlan,D,WPG,26,0,0,0,0
52,8478146,Matthew Highmore,C,OTT,28,0,0,0,0
52,8478970,Jalen Chatfield,D,CAR,28,0,0,0,0
52,8480205,Emil Bemstrom,C,PIT,25,0,0,0,0
52,8474884,Mike Hoffman,C,,35,0,0,0,0
52,8471274,Alex Goligoski,D,,39,0,0,0,0
52,8478104,Sammy Blais,L,,28,0,0,0,0
52,8474870,Tyler Johnson,C,,34,0,0,0,0
52,8476913,Devin Shore,C,MIN,30,0,0,0,0
52,8481598,Philip Broberg,D,EDM,23,0,0,0,0
52,8480058,Pierre-Olivier Joseph,D,STL,25,0,0,0,0
52,8480891,Michael Kesselring,D,UTA,24,0,0,0,0
52,8477979,Nicolas Aube-Kubel,R,BUF,28,0,0,0,0
52,8476871,Tanner Pearson,L,,32,0,0,0,0
52,8476393,Nick Cousins,C,,31,0,0,0,0
52,8479977,Kailer Yamamoto,R,,26,0,0,0,0
52,8479543,Michael Pezzetta,L,MTL,26,0,0,0,0
52,8477018,Ben Hutton,D,VGK,31,0,0,0,0
52,8480762,Eric Robinson,L,CAR,29,0,0,0,0
52,8474034,Pat Maroon,L,CHI,36,0,0,0,0
52,8481058,Jesse Ylönen,R,,25,0,0,0,0
52,8475179,Dmitry Kulikov,D,FLA,34,0,0,0,0
52,8481527,Kaedan Korczak,D,VGK,23,0,0,0,0
52,8473449,Kyle Okposo,R,,36,0,0,0,0
52,8482192,Isaak Phillips,D,CHI,23,0,0,0,0
52,8480727,Zach Whitecloud,D,VGK,28,0,0,0,0
52,8479346,Dillon Dube,C,,26,0,0,0,0
52,8480821,Filip Zadina,R,,25,0,0,0,0
52,8480001,Urho Vaakanainen,D,ANA,25,0,0,0,0
52,8470966,Mark Giordano,D,,41,0,0,0,0
52,8480853,Liam Foudy,C,,24,0,0,0,0
52,8475225,Craig Smith,C,CHI,35,0,0,0,0
52,8479972,Mason Shaw,C,WPG,26,0,0,0,0
52,8478451,Ethan Bear,D,WSH,27,0,0,0,0
52,8474040,Sam Gagner,C,,35,0,0,0,0
52,8480196,Jacob Bryson,D,BUF,27,0,0,0,0
52,8479984,Cal Foote,D,,26,0,0,0,0
52,8480011,Klim Kostin,C,SJS,25,0,0,0,0
52,8482176,Wyatt Kaiser,D,CHI,22,0,0,0,0
52,8476988,Matt Benning,D,SJS,30,0,0,0,0
52,8479370,Tyson Jost,C,CAR,26,0,0,0,0
52,8477464,Nic Petan,C,,29,0,0,0,0
52,8477380,Jonny Brodzinski,C,NYR,31,0,0,0,0
52,8480070,Ian Mitchell,D,BOS,25,0,0,0,0
52,8479315,Joey Anderson,R,CHI,26,0,0,0,0
52,8478099,Kevin Labanc,R,,29,0,0,0,0
52,8476874,Olli Maatta,D,DET,30,0,0,0,0
52,8475208,Brian Dumoulin,D,ANA,33,0,0,0,0
52,8478430,Oliver Kylington,D,,27,0,0,0,0
52,8479536,Axel Jonsson-Fjallby,L,WPG,26,0,0,0,0
52,8479671,Mathieu Olivier,R,CBJ,27,0,0,0,0
52,8471709,Marc-Edouard Vlasic,D,SJS,37,0,0,0,0
52,8479328,Julien Gauthier,R,NYI,27,0,0,0,0
52,8478421,A.J. Greer,L,FLA,28,0,0,0,0
52,8477573,Nathan Walker,L,STL,30,0,0,0,0
52,8481537,Nikita Okhotiuk,D,CGY,24,0,0,0,0
52,8474166,Alec Martinez,D,CHI,37,0,0,0,0
52,8470610,Zach Parise,L,,40,0,0,0,0
52,8477478,William Carrier,L,CAR,30,0,0,0,0
52,8479344,Jesse Puljujarvi,R,PIT,26,0,0,0,0
52,8480887,Jordan Harris,D,MTL,24,0,0,0,0
52,8478502,Dennis Gilbert,D,BUF,28,0,0,0,0
52,8482730,Brandt Clarke,D,LAK,21,0,0,0,0
52,8480355,Mark Kastelic,C,BOS,25,0,0,0,0
52,8475750,Jon Merrill,D,MIN,32,0,0,0,0
52,8475164,Jakob Silfverberg,R,,34,0,0,0,0
52,8477944,Jakub Vrana,L,,28,0,0,0,0
52,8479439,Jacob MacDonald,D,COL,31,0,0,0,0
52,8474568,Luke Schenn,D,NSH,35,0,0,0,0
52,8478454,Noah Juulsen,D,VAN,27,0,0,0,0
52,8475752,Tyler Pitlick,C,,33,0,0,0,0
52,8482148,Hendrix Lapierre,C,WSH,22,0,0,0,0
52,8481167,Brayden Pachal,D,CGY,25,0,0,0,0
52,8478043,Sam Lafferty,C,BUF,29,0,0,0,0
52,8479321,Lucas Johansen,D,,27,0,0,0,0
52,8471699,Andrew Cogliano,C,,37,0,0,0,0
52,8481521,Ronnie Attard,D,PHI,25,0,0,0,0
52,8481161,Jake Christiansen,D,CBJ,25,0,0,0,0
52,8479458,Nikita Zaitsev,D,,33,0,0,0,0
52,8479619,Michael Carcone,L,UTA,28,0,0,0,0
52,8479026,Philippe Myers,D,TOR,27,0,0,0,0
52,8477330,Dominik Kubalik,L,,29,0,0,0,0
52,8481617,Vasily Podkolzin,R,VAN,23,0,0,0,0
52,8481701,Santeri Hatakka,D,NJD,23,0,0,0,0
52,8479514,Rem Pitlick,C,,27,0,0,0,0
52,8477446,Michael McCarron,R,NSH,29,0,0,0,0
52,8470604,Jeff Carter,C,,39,0,0,0,0
52,8482241,Radim Zohorna,L,,28,0,0,0,0
52,8480289,Morgan Barron,C,WPG,26,0,0,0,0
52,8479379,Givani Smith,R,SJS,26,0,0,0,0
52,8480216,Jacob Peterson,C,,25,0,0,0,0
52,8477851,Jordan Oesterle,D,BOS,32,0,0,0,0
52,8484258,Sam Malinski,D,COL,26,0,0,0,0
52,8478904,Steven Lorentz,C,,28,0,0,0,0
52,8482095,Tyler Kleven,D,OTT,22,0,0,0,0
52,8480848,Ty Dellandrea,C,SJS,24,0,0,0,0
52,8476884,Derrick Pouliot,D,,30,0,0,0,0
52,8479336,Carl Grundstrom,R,SJS,27,0,0,0,0
52,8482964,Arber Xhekaj,D,MTL,23,0,0,0,0
52,8471686,Marc Staal,D,,37,0,0,0,0
52,8477887,Patrick Brown,C,BOS,32,0,0,0,0
52,8478495,Denis Gurianov,R,,27,0,0,0,0
52,8473504,Cal Clutterbuck,R,,37,0,0,0,0
52,8481550,Adam Beckman,L,NJD,23,0,0,0,0
52,8480845,Rasmus Kupari,C,WPG,24,0,0,0,0
52,8474009,Nick Bonino,C,,36,0,0,0,0
52,8478585,Derek Ryan,C,EDM,38,0,0,0,0
52,8477962,Brendan Lemieux,L,CAR,28,0,0,0,0
52,8482861,Vincent Iorio,D,WSH,22,0,0,0,0
52,8479378,Logan Stanley,D,WPG,26,0,0,0,0
52,8473446,Erik Johnson,D,PHI,36,0,0,0,0
52,8481743,Marc Del Gaizo,D,NSH,25,0,0,0,0
52,8477384,Josh Brown,D,EDM,30,0,0,0,0
52,8482165,Yan Kuznetsov,D,CGY,22,0,0,0,0
52,8478424,Jansen Harkins,C,ANA,27,0,0,0,0
52,8482144,Jack Thompson,D,SJS,22,0,0,0,0
52,8478512,Austin Czarnik,C,,32,0,0,0,0
52,8477527,Ross Johnston,L,ANA,30,0,0,0,0
52,8479383,Boris Katchouk,L,,26,0,0,0,0
52,8482094,Daemon Hunt,D,MIN,22,0,0,0,0
52,8481719,Maxwell Crozier,D,TBL,24,0,0,0,0
52,8480192,Johnathan Kovacevic,D,NJD,27,0,0,0,0
52,8479376,Victor Mete,D,,26,0,0,0,0
52,8482511,Mason Lohrei,D,BOS,23,0,0,0,0
52,8475825,Jani Hakanpää,D,,32,0,0,0,0
52,8478021,William Lagesson,D,DET,28,0,0,0,0
52,8475795,Dylan McIlrath,D,WSH,32,0,0,0,0
52,8477846,Ryan Carpenter,C,,33,0,0,0,0
52,8481056,Spencer Stastney,D,NSH,24,0,0,0,0
52,8481564,Ryan Johnson,D,BUF,23,0,0,0,0
52,8478017,Mark Friedman,D,VAN,29,0,0,0,0
52,8479320,Max Lajoie,D,SEA,27,0,0,0,0
52,8480075,Cameron Crotty,D,MIN,25,0,0,0,0
52,8484287,Cole McWard,D,VAN,23,0,0,0,0
52,8484254,Akito Hirose,D,VAN,25,0,0,0,0
52,8483407,Brandon Scanlin,D,NYR,25,0,0,0,0
52,8480274,Philip Kemp,D,EDM,25,0,0,0,0
52,8479522,Hardy Haman Aktell,D,WSH,26,0,0,0,0
52,8480007,Jonas Rondbjerg,R,VGK,25,0,0,0,0
52,8477454,Adam Erne,L,,29,0,0,0,0
52,8481679,Maxence Guenette,D,OTT,23,0,0,0,0
52,8480441,Trey Fix-Wolansky,R,CBJ,25,0,0,0,0
52,8483546,Marshall Rifai,D,TOR,26,0,0,0,0
52,8480084,Nick DeSimone,D,NJD,30,0,0,0,0
52,8481030,Jack St. Ivany,D,PIT,25,0,0,0,0
52,8481592,Jakob Pelletier,L,CGY,23,0,0,0,0
52,8478011,Louie Belpedio,D,PHI,28,0,0,0,0
52,8477930,Pierre-Edouard Bellemare,L,,39,0,0,0,0
52,8484321,Nikolas Matinpalo,D,OTT,26,0,0,0,0
52,8482067,Connor Mackey,D,NYR,28,0,0,0,0
52,8481806,Louis Crevier,D,CHI,23,0,0,0,0
52,8484326,Patrik Koch,D,UTA,28,0,0,0,0
52,8477971,Andreas Englund,D,LAK,28,0,0,0,0
52,8481751,Lukas Rousek,R,BUF,25,0,0,0,0
52,8481006,Tyler Tucker,D,STL,24,0,0,0,0
52,8476867,Brendan Gaunce,C,MIN,30,0,0,0,0
52,8479520,Brandon Duhaime,R,WSH,27,0,0,0,0
52,8477073,Kurtis MacDermid,L,NJD,30,0,0,0,0
52,8480874,Adam Ginning,D,PHI,24,0,0,0,0
52,8477473,Justin Bailey,R,SJS,29,0,0,0,0
52,8479066,Ryan Lomberg,L,CGY,30,0,0,0,0
52,8477070,Liam O'Brien,C,UTA,30,0,0,0,0
52,8474618,Marco Scandella,D,,34,0,0,0,0
52,8475797,Jarred Tinordi,D,,32,0,0,0,0
52,8481441,Joe Snively,C,DET,28,0,0,0,0
52,8477244,Chad Ruhwedel,D,NYR,34,0,0,0,0
52,8479772,Zack MacEwen,R,OTT,28,0,0,0,0
52,8481147,Reese Johnson,C,MIN,26,0,0,0,0
52,8481043,Cole Koepke,L,BOS,26,0,0,0,0
52,8483619,Filip Roos,D,OTT,25,0,0,0,0
52,8481541,Samuel Bolduc,D,NYI,24,0,0,0,0
52,8477810,Joel Hanley,D,CGY,33,0,0,0,0
52,8476907,Mackenzie MacEachern,L,,30,0,0,0,0
52,8482652,Walker Duehr,R,CGY,27,0,0,0,0
52,8477126,Jayson Megna,C,,34,0,0,0,0
52,8483398,Declan Carlile,D,TBL,31,0,0,0,0
52,8482929,Emil Lilleberg,D,TBL,23,0,0,0,0
52,8480880,Jakub Lauko,C,MIN,24,0,0,0,0
52,8480245,Olle Lycksell,R,PHI,25,0,0,0,0
52,8480252,Cole Guttman,C,CHI,25,0,0,0,0
52,8477467,Gustav Olofsson,D,SEA,30,0,0,0,0
52,8479968,Vinni Lettieri,C,BOS,29,0,0,0,0
52,8478400,Colin White,C,,27,0,0,0,0
52,8475755,Alexander Petrovic,D,DAL,32,0,0,0,0
52,8481812,Nikolai Knyzhov,D,,27,0,0,0,0
52,8481593,Jayden Struble,D,MTL,23,0,0,0,0
52,8481532,Alex Turcotte,C,LAK,23,0,0,0,0
52,8482126,Emil Andrae,D,PHI,31,0,0,0,0
52,8479944,Zach Aston-Reese,C,VGK,30,0,0,0,0
52,8471817,Ryan Reaves,R,TOR,37,0,0,0,0
52,8481206,John Ludvig,D,PIT,24,0,0,0,0
52,8481599,Victor Soderstrom,D,UTA,23,0,0,0,0
52,8480292,Carson Meyer,R,ANA,27,0,0,0,0
52,8482496,Nils Aman,C,VAN,24,0,0,0,0
52,8479718,Alex Barré-Boulet,C,MTL,27,0,0,0,0
52,8479994,Jaret Anderson-Dolan,C,WPG,25,0,0,0,0
52,8480184,Gustav Lindstrom,D,,26,0,0,0,0
52,8480890,Jan Jenik,R,OTT,24,0,0,0,0
52,8478067,Oskar Lindblom,L,,28,0,0,0,0
52,8476934,Brock McGinn,L,ANA,30,0,0,0,0
52,8479985,Cale Fleury,D,SEA,26,0,0,0,0
52,8484304,Uvis Balinskis,D,FLA,28,0,0,0,0
52,8479981,Jonah Gadjovich,L,FLA,26,0,0,0,0
52,8481716,Dmitri Voronkov,L,CBJ,24,0,0,0,0
52,8474709,Matt Martin,L,,35,0,0,0,0
52,8482634,Alex Steeves,C,TOR,25,0,0,0,0
52,8480823,Alexander Alexeyev,D,WSH,25,0,0,0,0
52,8477541,Dakota Mermis,D,TOR,30,0,0,0,0
52,8483491,Ivan Miroshnichenko,L,WSH,20,0,0,0,0
52,8478477,Mitchell Stephens,C,SEA,27,0,0,0,0
52,8481543,Nikita Alexandrov,C,STL,24,0,0,0,0
52,8479423,Alex Nylander,L,,26,0,0,0,0
52,8482451,Mikael Pyyhtia,L,CBJ,23,0,0,0,0
52,8478831,Kevin Stenlund,C,UTA,28,0,0,0,0
52,8480306,Grant Hutton,D,NYI,29,0,0,0,0
52,8478028,Fredrik Olofsson,L,,28,0,0,0,0
52,8477462,Robert Hagg,D,VGK,29,0,0,0,0
52,8477320,Anton Blidh,L,NYR,29,0,0,0,0
52,8482157,Will Cuylle,L,NYR,22,0,0,0,0
52,8482737,Zack Bolduc,C,STL,21,0,0,0,0
52,8481239,Samuel Fagemo,L,,24,0,0,0,0
52,8481600,Tobias Bjornfot,D,FLA,23,0,0,0,0
52,8478409,Anthony Richard,C,PHI,28,0,0,0,0
52,8474145,Robert Bortuzzo,D,,35,0,0,0,0
52,8475958,Michael Sgarbossa,C,WSH,32,0,0,0,0
52,8479986,Kole Lind,R,DAL,26,0,0,0,0
52,8479249,Andrew Poturalski,C,SJS,30,0,0,0,0
52,8479362,Riley Tufte,L,BOS,26,0,0,0,0
52,8479991,Jake Leschyshyn,C,NYR,25,0,0,0,0
52,8479587,Rhett Gardner,C,PHI,28,0,0,0,0
52,8482744,James Malatesta,L,CBJ,21,0,0,0,0
52,8478854,Ryan Shea,D,PIT,27,0,0,0,0
52,8481591,Sam Poulin,R,,23,0,0,0,0
52,8483512,Matt Savoie,C,EDM,20,0,0,0,0
52,8482102,Vasily Ponomarev,C,PIT,22,0,0,0,0
52,8482162,Roby Jarventie,L,EDM,22,0,0,0,0
52,8481016,Ruslan Iskhakov,C,,24,0,0,0,0
52,8482172,Landon Slaggert,L,CHI,22,0,0,0,0
52,8482747,Brennan Othmann,L,NYR,21,0,0,0,0
52,8480031,Maxime Comtois,L,,25,0,0,0,0
52,8480226,Marián Studenic,R,,26,0,0,0,0
52,8478408,Travis Dermott,D,,28,0,0,0,0
52,8481518,Nolan Foote,L,NJD,24,0,0,0,0
52,8479419,Brett Murray,L,BUF,26,0,0,0,0
52,8482088,Justin Sourdif,R,FLA,22,0,0,0,0
52,8482201,Gage Goncalves,C,TBL,23,0,0,0,0
52,8481578,Graeme Clarke,R,MIN,23,0,0,0,0
52,8482177,Marat Khusnutdinov,C,MIN,22,0,0,0,0
52,8481754,Nikita Nesterenko,C,ANA,23,0,0,0,0
52,8483531,Brian Halonen,L,NJD,25,0,0,0,0
52,8483920,Pierrick Dube,R,WSH,23,0,0,0,0
52,8480851,Akil Thomas,C,LAK,24,0,0,0,0
52,8475235,Nicolas Deslauriers,L,PHI,33,0,0,0,0
52,8482476,Emil Heineman,L,MTL,23,0,0,0,0
52,8477149,Scott Sabourin,R,SJS,32,0,0,0,0
52,8483549,Lucas Condotta,L,MTL,27,0,0,0,0
52,8482765,Isak Rosen,R,BUF,21,0,0,0,0
52,8481237,Kyle MacLean,C,NYI,25,0,0,0,0
52,8481024,Linus Karlsson,C,VAN,25,0,0,0,0
52,8481690,Tyler Angle,C,,24,0,0,0,0
52,8483570,Ben Meyers,C,SEA,26,0,0,0,0
52,8481655,Cole Schwindt,R,CGY,23,0,0,0,0
52,8481462,Mason Morelli,L,VGK,28,0,0,0,0
52,8483401,Marc Johnstone,R,PIT,28,0,0,0,0
52,8478956,Samuel Laberge,L,NJD,27,0,0,0,0
52,8479533,Joona Koppanen,L,,26,0,0,0,0
52,8482197,Adam Raska,R,MIN,23,0,0,0,0
52,8482250,Callahan Burke,C,VGK,27,0,0,0,0
52,8482784,Zach Dean,C,STL,21,0,0,0,0
52,8484255,Jason Polin,R,COL,25,0,0,0,0
52,8481077,John Leonard,L,,26,0,0,0,0
52,8481534,Raphael Lavoie,C,EDM,24,0,0,0,0
52,8483609,Adam Klapka,R,CGY,24,0,0,0,0
52,8482751,Ryan Winterton,C,SEA,21,0,0,0,0
52,8480267,Sammy Walker,C,MIN,25,0,0,0,0
52,8475766,Austin Watson,L,,32,0,0,0,0
52,8482460,Matt Rempe,C,NYR,22,0,0,0,0
52,8481065,Angus Crookshank,L,OTT,25,0,0,0,0
52,8481070,Hugh McGing,L,,26,0,0,0,0
52,8476323,Max McCormick,L,SEA,32,0,0,0,0
52,8483395,Arshdeep Bains,L,VAN,23,0,0,0,0
52,8484259,Ondrej Pavel,C,COL,31,0,0,0,0
52,8483432,Luca Del Bel Belluz,C,CBJ,31,0,0,0,0
52,8483045,Cameron Butler,R,CBJ,31,0,0,0,0
52,8482061,Brandon Biro,L,SEA,26,0,0,0,0
52,8477401,John Hayden,C,SEA,29,0,0,0,0
52,8475278,Byron Froese,C,,33,0,0,0,0
52,8478446,Glenn Gawdin,C,LAK,27,0,0,0,0
52,8477993,Justin Kirkland,C,CGY,28,0,0,0,0
52,8482147,Jean-Luc Foudy,C,COL,22,0,0,0,0
52,8480032,Shane Bowers,C,NJD,25,0,0,0,0
52,8479330,Brandon Gignac,C,MTL,27,0,0,0,0
52,8480776,Sheldon Rempal,R,,29,0,0,0,0
52,8475413,Justin Dowling,C,NJD,34,0,0,0,0
52,8481726,Adam Edstrom,C,NYR,24,0,0,0,0
52,8480844,Grigori Denisenko,L,VGK,24,0,0,0,0
52,8478147,Bokondji Imama,L,PIT,28,0,0,0,0
52,8478881,Brett Seney,L,CHI,28,0,0,0,0
52,8483630,Pavol Regenda,L,ANA,25,0,0,0,0
52,8480836,Jonathan Gruden,C,,24,0,0,0,0
52,8484314,Jiri Smejkal,L,,28,0,0,0,0
52,8475780,Chris Wagner,R,COL,33,0,0,0,0
52,8479546,Oskar Steen,C,,26,0,0,0,0
52,8483597,Milos Kelemen,L,UTA,25,0,0,0,0
52,8481789,Tye Kartye,L,SEA,23,0,0,0,0
52,8484325,Waltteri Merela,C,TBL,26,0,0,0,0
52,8479421,Jacob Moverare,D,LAK,26,0,0,0,0
52,8481585,Egor Afanasyev,L,SJS,23,0,0,0,0
52,8479547,Matthew Phillips,R,,26,0,0,0,0
52,8479367,William Lockwood,R,FLA,26,0,0,0,0
52,8476915,Jujhar Khaira,L,,30,0,0,0,0
52,8481422,Jacob Lucchini,C,NSH,29,0,0,0,0
52,8480468,James Hamblin,L,EDM,25,0,0,0,0
52,8478051,Max Willman,C,NJD,29,0,0,0,0
52,8481556,John Beecher,C,BOS,23,0,0,0,0
52,8478078,Rourke Chartier,C,,28,0,0,0,0
53,8476453,Nikita Kucherov,R,TBL,31,82,39,94,133
53,8477956,David Pastrnak,R,BOS,28,82,49,82,131
53,8477492,Nathan MacKinnon,C,COL,29,82,56,73,129
53,8478550,Artemi Panarin,L,NYR,33,82,42,82,124
53,8478402,Connor McDavid,C,EDM,27,82,35,86,121
53,8479318,Auston Matthews,C,TOR,27,82,59,56,115
53,8479314,Matthew Tkachuk,L,FLA,27,82,38,77,115
53,8474564,Steven Stamkos,C,NSH,34,82,48,63,111
53,8480069,Cale Makar,D,COL,26,82,26,84,110
53,8478403,Jack Eichel,C,VGK,28,82,35,74,109
53,8481559,Jack Hughes,C,NJD,23,82,35,70,105
53,8477946,Dylan Larkin,C,DET,28,82,50,52,102
53,8471675,Sidney Crosby,C,PIT,37,82,48,54,102
53,8478420,Mikko Rantanen,R,COL,28,82,49,51,100
53,8480012,Elias Pettersson,C,VAN,26,82,43,57,100
53,8477404,Jake Guentzel,C,TBL,30,82,43,56,99
53,8477933,Sam Reinhart,C,FLA,29,82,50,48,98
53,8479325,Charlie McAvoy,D,BOS,27,82,18,80,98
53,8478864,Kirill Kaprizov,L,MIN,27,82,49,47,96
53,8477939,William Nylander,R,TOR,28,82,43,53,96
53,8477942,Kevin Fiala,L,LAK,28,82,35,61,96
53,8480027,Jason Robertson,L,DAL,25,82,34,59,93
53,8478445,Mathew Barzal,C,NYI,27,82,24,69,93
53,8476887,Filip Forsberg,L,NSH,30,82,43,49,92
53,8477934,Leon Draisaitl,C,EDM,29,82,37,55,92
53,8480002,Nico Hischier,C,NJD,25,82,40,51,91
53,8480830,Andrei Svechnikov,R,CAR,24,82,36,54,90
53,8482116,Tim Stützle,C,OTT,22,82,34,54,88
53,8475184,Chris Kreider,L,NYR,33,82,44,43,87
53,8476468,J.T. Miller,C,VAN,31,82,27,60,87
53,8474600,Roman Josi,D,NSH,34,82,17,70,87
53,8476389,Vincent Trocheck,C,NYR,31,82,41,45,86
53,8480036,Miro Heiskanen,D,DAL,25,82,28,57,85
53,8473419,Brad Marchand,L,BOS,36,82,38,46,84
53,8478010,Brayden Point,C,TBL,28,82,40,42,82
53,8475172,Nazem Kadri,C,CGY,34,82,33,49,82
53,8477951,Nick Schmaltz,C,UTA,28,82,30,52,82
53,8475913,Mark Stone,R,VGK,32,82,25,56,81
53,8480800,Quinn Hughes,D,VAN,25,82,13,68,81
53,8479407,Jesper Bratt,L,NJD,26,82,20,60,80
53,8480865,Noah Dobson,D,NYI,24,82,19,61,80
53,8480801,Brady Tkachuk,L,OTT,25,82,39,40,79
53,8478398,Kyle Connor,L,WPG,28,82,37,42,79
53,8479385,Jordan Kyrou,C,STL,26,82,23,56,79
53,8476456,Jonathan Huberdeau,C,CGY,31,82,20,59,79
53,8475810,Bryan Rust,R,PIT,32,82,38,40,78
53,8476459,Mika Zibanejad,C,NYR,31,82,30,48,78
53,8476454,Ryan Nugent-Hopkins,C,EDM,31,82,28,50,78
53,8477493,Aleksander Barkov,C,FLA,29,82,18,60,78
53,8474590,John Carlson,D,WSH,34,82,17,61,78
53,8475754,Brock Nelson,C,NYI,33,82,41,36,77
53,8477409,Carter Verhaeghe,C,FLA,29,82,39,38,77
53,8479343,Clayton Keller,R,UTA,26,82,36,41,77
53,8477494,Jonathan Drouin,L,COL,29,82,24,53,77
53,8479420,Tage Thompson,C,BUF,27,82,39,37,76
53,8476882,Teuvo Teravainen,L,CHI,30,82,29,47,76
53,8477500,Bo Horvat,C,NYI,29,82,33,42,75
53,8477501,Valeri Nichushkin,R,COL,29,82,28,47,75
53,8480023,Robert Thomas,C,STL,25,82,22,53,75
53,8476346,Johnny Gaudreau,L,CBJ,31,82,20,55,75
53,8477960,Adrian Kempe,R,LAK,28,82,43,31,74
53,8475726,Tyler Toffoli,C,SJS,32,82,34,40,74
53,8478047,Michael Bunting,L,PIT,29,82,30,44,74
53,8478873,Troy Terry,R,ANA,27,82,25,49,74
53,8480803,Evan Bouchard,D,EDM,25,82,21,53,74
53,8473512,Claude Giroux,R,OTT,36,82,26,47,73
53,8478439,Travis Konecny,R,PHI,27,82,25,48,73
53,8479323,Adam Fox,D,NYR,26,82,17,56,73
53,8475166,John Tavares,C,TOR,34,82,34,38,72
53,8479339,Patrik Laine,L,CBJ,26,82,32,40,72
53,8482093,Seth Jarvis,C,CAR,22,82,29,43,72
53,8482097,Jack Quinn,R,BUF,23,82,28,44,72
53,8475168,Matt Duchene,C,DAL,33,82,22,50,72
53,8474141,Patrick Kane,R,DET,36,82,20,52,72
53,8475158,Ryan O'Reilly,C,NSH,33,82,31,40,71
53,8477949,Alex Tuch,R,BUF,28,82,22,49,71
53,8471685,Anze Kopitar,C,LAK,37,82,16,55,71
53,8473994,Jamie Benn,L,DAL,35,82,34,36,70
53,8478449,Roope Hintz,C,DAL,28,82,28,42,70
53,8476432,Boone Jenner,C,CBJ,31,82,42,27,69
53,8476539,Jonathan Marchessault,R,NSH,34,82,38,31,69
53,8479542,Brandon Hagel,L,TBL,26,82,32,37,69
53,8479987,Morgan Geekie,C,BOS,26,82,21,48,69
53,8477447,Shea Theodore,D,VGK,29,82,20,49,69
53,8475170,Brayden Schenn,C,STL,33,82,39,29,68
53,8477935,Sam Bennett,C,FLA,28,82,33,35,68
53,8477402,Pavel Buchnevich,L,STL,29,82,28,40,68
53,8478440,Dylan Strome,C,WSH,27,82,27,41,68
53,8478460,Zach Werenski,D,CBJ,27,82,18,50,68
53,8477504,Josh Morrissey,D,WPG,29,82,13,55,68
53,8476853,Morgan Rielly,D,TOR,30,82,9,59,68
53,8478414,Timo Meier,R,NJD,28,82,36,31,67
53,8478444,Brock Boeser,R,VAN,27,82,31,36,67
53,8478427,Sebastian Aho,C,CAR,27,82,30,37,67
53,8482078,Lucas Raymond,L,DET,22,82,26,41,67
53,8476448,William Karlsson,C,VGK,31,82,29,37,66
53,8480797,Joel Farabee,L,PHI,24,82,23,43,66
53,8475786,Zach Hyman,L,EDM,32,82,34,31,65
53,8476905,Chandler Stephenson,C,SEA,30,82,23,42,65
53,8476881,Tomas Hertl,C,VGK,31,82,29,35,64
53,8481557,Matt Boldy,L,MIN,23,82,25,39,64
53,8475765,Vladimir Tarasenko,R,DET,33,82,21,43,64
53,8474578,Erik Karlsson,D,PIT,34,82,18,46,64
53,8475753,Justin Faulk,D,STL,32,82,15,49,64
53,8480839,Rasmus Dahlin,D,BUF,24,82,13,51,64
53,8479337,Alex DeBrincat,R,DET,27,82,27,36,63
53,8477497,Sean Monahan,C,CBJ,30,82,24,39,63
53,8479999,Casey Mittelstadt,C,COL,26,82,23,40,63
53,8474679,Gustav Nyquist,C,NSH,35,82,16,47,63
53,8482745,Mason McTavish,C,ANA,21,82,31,31,62
53,8481528,Dylan Cozens,C,BUF,23,82,27,35,62
53,8471214,Alex Ovechkin,L,WSH,39,82,26,36,62
53,8478042,Viktor Arvidsson,R,EDM,31,82,19,43,62
53,8476438,Brandon Saad,L,STL,32,82,34,27,61
53,8481068,Yegor Sharangovich,C,CGY,26,82,29,32,61
53,8480208,Drake Batherson,R,OTT,26,82,25,36,61
53,8477496,Elias Lindholm,C,BOS,30,82,24,37,61
53,8481523,Kirby Dach,C,MTL,23,82,6,55,61
53,8471215,Evgeni Malkin,C,PIT,38,82,25,35,60
53,8476880,Tom Wilson,R,WSH,30,82,25,35,60
53,8474563,Drew Doughty,D,LAK,35,82,13,47,60
53,8478498,Jake DeBrusk,L,VAN,28,82,33,26,59
53,8483808,Andrei Kuzmenko,L,CGY,28,82,29,30,59
53,8478519,Anthony Cirelli,C,TBL,27,82,27,32,59
53,8479400,Pierre-Luc Dubois,L,WSH,26,82,26,33,59
53,8478462,Nicolas Roy,C,VGK,27,82,26,33,59
53,8476479,Phillip Danault,C,LAK,31,82,20,39,59
53,8477503,Max Domi,C,TOR,29,82,19,40,59
53,8476906,Shayne Gostisbehere,D,CAR,31,82,16,43,59
53,8477955,Jared McCann,L,SEA,28,82,27,31,58
53,8478401,Pavel Zacha,C,BOS,27,82,25,33,58
53,8476460,Mark Scheifele,C,WPG,31,82,23,35,58
53,8478975,Mason Marchment,L,DAL,29,82,18,40,58
53,8477407,Anthony Duclair,L,NYI,29,82,30,27,57
53,8478493,Joel Eriksson Ek,C,MIN,27,82,26,31,57
53,8479675,Trevor Moore,L,LAK,29,82,23,34,57
53,8482665,Matty Beniers,C,SEA,22,82,20,37,57
53,8478469,Thomas Chabot,D,OTT,27,82,19,38,57
53,8478396,Noah Hanifin,D,VGK,27,82,16,41,57
53,8476792,Torey Krug,D,STL,33,82,14,43,57
53,8478407,Vince Dunn,D,SEA,28,82,12,45,57
53,8481542,Moritz Seider,D,DET,23,82,11,46,57
53,8479525,Ross Colton,C,COL,28,82,29,27,56
53,8482124,Quinton Byfield,R,LAK,22,82,25,31,56
53,8480015,Owen Tippett,R,PHI,25,82,24,32,56
53,8476872,Scott Laughton,C,PHI,30,82,22,34,56
53,8482740,Wyatt Johnston,C,DAL,21,82,33,22,55
53,8474586,Jordan Eberle,R,SEA,34,82,25,30,55
53,8482159,Tyson Foerster,R,PHI,22,82,24,31,55
53,8478856,Conor Garland,R,VAN,28,82,21,34,55
53,8475692,Mats Zuccarello,R,MIN,37,82,14,41,55
53,8477456,J.T. Compher,L,DET,29,82,28,26,54
53,8475794,Tyler Seguin,C,DAL,32,82,26,28,54
53,8473986,Alex Killorn,L,ANA,35,82,24,30,54
53,8480078,Filip Chytil,C,NYR,25,82,16,38,54
53,8475798,Mikael Granlund,C,SJS,32,82,9,45,54
53,8477476,Artturi Lehkonen,L,COL,29,82,24,29,53
53,8477479,Tyler Bertuzzi,L,CHI,29,82,22,31,53
53,8474641,Adam Henrique,C,EDM,34,82,20,33,53
53,8479425,Filip Hronek,D,VAN,27,82,14,39,53
53,8475167,Victor Hedman,D,TBL,34,82,12,41,53
53,8477495,Seth Jones,D,CHI,30,82,12,41,53
53,8474565,Alex Pietrangelo,D,VGK,34,82,11,42,53
53,8471724,Kris Letang,D,PIT,37,82,9,44,53
53,8481540,Cole Caufield,R,MTL,23,82,35,17,52
53,8480064,Josh Norris,C,OTT,25,82,34,18,52
53,8480039,Martin Necas,C,CAR,25,82,24,28,52
53,8482110,Dawson Mercer,C,NJD,23,82,23,29,52
53,8477416,Oliver Bjorkstrand,R,SEA,29,82,22,30,52
53,8477964,Ivan Barbashev,C,VGK,29,82,21,31,52
53,8480018,Nick Suzuki,C,MTL,25,82,20,32,52
53,8481618,Alex Newhook,C,MTL,23,82,20,32,52
53,8480188,Fabian Zetterlund,L,SJS,25,82,19,33,52
53,8477986,Brandon Montour,D,SEA,30,82,15,37,52
53,8478438,Tommy Novak,C,NSH,27,82,13,39,52
53,8482684,Luke Hughes,D,NJD,21,82,12,40,52
53,8477998,Warren Foegele,L,LAK,28,82,24,27,51
53,8476483,Rickard Rakell,R,PIT,31,82,22,29,51
53,8481186,Logan O'Connor,R,COL,28,82,21,30,51
53,8480798,Philipp Kurashev,C,CHI,25,82,20,31,51
53,8482113,Anton Lundell,C,FLA,23,82,18,33,51
53,8476462,Dougie Hamilton,D,NJD,31,82,14,37,51
53,8478397,Rasmus Andersson,D,CGY,28,82,8,43,51
53,8475784,Jeff Skinner,C,EDM,32,82,28,22,50
53,8482175,JJ Peterka,R,BUF,22,82,26,24,50
53,8481533,Trevor Zegras,C,ANA,23,82,25,25,50
53,8481596,Shane Pinto,C,OTT,24,82,25,25,50
53,8482699,Dylan Guenther,R,UTA,21,82,25,25,50
53,8477511,Anthony Mantha,R,CGY,30,82,24,26,50
53,8475768,Jaden Schwartz,C,SEA,32,82,23,27,50
53,8475791,Taylor Hall,L,CHI,33,82,18,32,50
53,8471698,T.J. Oshie,R,WSH,38,82,25,24,49
53,8476399,Blake Coleman,C,CGY,33,82,24,25,49
53,8477021,Alex Kerfoot,C,UTA,30,82,19,30,49
53,8474102,David Perron,L,OTT,36,82,19,30,49
53,8477451,Ryan Hartman,R,MIN,30,82,17,32,49
53,8477444,Andre Burakovsky,L,SEA,29,82,17,32,49
53,8474149,Evgenii Dadonov,R,DAL,35,82,12,37,49
53,8480014,Gabriel Vilardi,C,WPG,25,82,28,20,48
53,8478474,Lawson Crouse,L,UTA,27,82,24,24,48
53,8475191,Reilly Smith,R,NYR,33,82,23,25,48
53,8482109,Alexis Lafrenière,L,NYR,23,82,22,26,48
53,8480185,Eetu Luostarinen,C,FLA,26,82,18,30,48
53,8475763,Kevin Hayes,R,PIT,32,82,18,30,48
53,8474150,Mikael Backlund,C,CGY,35,82,17,31,48
53,8475169,Evander Kane,L,EDM,33,82,17,31,48
53,8478458,Jack Roslovic,C,CAR,27,82,16,32,48
53,8480817,K'Andre Miller,D,NYR,24,82,11,37,48
53,8476826,Yanni Gourde,C,SEA,33,82,19,28,47
53,8479345,Jakob Chychrun,D,WSH,26,82,16,31,47
53,8482092,Ridly Greig,C,OTT,22,82,15,32,47
53,8477932,Aaron Ekblad,D,FLA,28,82,14,33,47
53,8476458,Ryan Strome,C,ANA,31,82,13,34,47
53,8482671,Owen Power,D,BUF,22,82,10,37,47
53,8475287,Erik Haula,L,NJD,33,82,24,22,46
53,8475151,Kyle Palmieri,C,NYI,33,82,23,23,46
53,8475799,Nino Niederreiter,R,WPG,32,82,23,23,46
53,8482705,Cole Sillinger,C,CBJ,21,82,16,30,46
53,8479365,Trent Frederic,C,BOS,26,82,29,16,45
53,8476923,Damon Severson,D,CBJ,30,82,13,32,45
53,8478055,Gustav Forsling,D,FLA,28,82,12,33,45
53,8478038,Devon Toews,D,COL,30,82,9,36,45
53,8481624,Ilya Mikheyev,R,CHI,30,82,21,23,44
53,8479390,Taylor Raddysh,R,WSH,26,82,18,26,44
53,8473533,Jordan Staal,C,CAR,36,82,17,27,44
53,8478115,Pierre Engvall,L,NYI,28,82,15,29,44
53,8476875,Mike Matheson,D,MTL,30,82,10,34,44
53,8476958,Jaccob Slavin,D,CAR,30,82,10,34,44
53,8480829,Jesperi Kotkaniemi,C,CAR,24,82,24,19,43
53,8478366,Frank Vatrano,R,ANA,30,82,21,22,43
53,8480220,Noah Cates,L,PHI,25,82,17,26,43
53,8478542,Evan Rodrigues,C,FLA,31,82,17,26,43
53,8477940,Nikolaj Ehlers,L,WPG,28,82,15,28,43
53,8482667,William Eklund,L,SJS,22,82,14,29,43
53,8477346,MacKenzie Weegar,D,CGY,30,82,11,32,43
53,8480434,Sean Durzi,D,UTA,26,82,10,33,43
53,8480459,Pius Suter,C,VAN,28,82,22,20,42
53,8482475,Yegor Chinakhov,R,CBJ,23,82,20,22,42
53,8480802,Ryan McLeod,C,BUF,25,82,17,25,42
53,8476461,Sean Couturier,C,PHI,32,82,16,26,42
53,8475171,Oliver Ekman-Larsson,D,TOR,33,82,13,29,42
53,8482105,Jake Sanderson,D,OTT,22,82,9,33,42
53,8477426,Nicholas Paul,L,TBL,29,82,23,18,41
53,8480893,Kirill Marchenko,R,CBJ,24,82,22,19,41
53,8481580,Connor McMichael,C,WSH,23,82,21,20,41
53,8480009,Eeli Tolvanen,R,SEA,25,82,19,22,41
53,8477952,Robby Fabbri,C,ANA,28,82,18,23,41
53,8480849,Barrett Hayton,C,UTA,24,82,17,24,41
53,8476921,Jordan Martinook,L,CAR,32,82,17,24,41
53,8474053,Logan Couture,C,SJS,35,82,16,25,41
53,8480145,Neal Pionk,D,WPG,29,82,12,29,41
53,8478233,Andrew Mangiapane,L,WSH,28,82,12,29,41
53,8481581,Thomas Harley,D,DAL,23,82,11,30,41
53,8476854,Hampus Lindholm,D,BOS,30,82,7,34,41
53,8479410,Mikhail Sergachev,D,UTA,26,82,5,36,41
53,8475193,Tomas Tatar,L,NJD,34,82,16,24,40
53,8476419,Jean-Gabriel Pageau,C,NYI,32,82,14,26,40
53,8477948,Travis Sanheim,D,PHI,28,82,12,28,40
53,8476292,Ondrej Palat,L,NJD,33,82,9,31,40
53,8475314,Anders Lee,L,NYI,34,82,25,14,39
53,8477987,Ryan Donato,C,CHI,28,82,18,21,39
53,8477450,Jason Dickinson,C,CHI,29,82,17,22,39
53,8473422,Nick Foligno,L,CHI,37,82,16,23,39
53,8479992,Michael Rasmussen,C,DET,25,82,16,23,39
53,8481553,Bobby Brink,R,PHI,23,82,16,23,39
53,8475745,Charlie Coyle,C,BOS,32,82,15,24,39
53,8481560,Arthur Kaliyev,R,LAK,23,82,15,24,39
53,8480871,Adam Boqvist,D,FLA,24,82,13,26,39
53,8476329,Travis Boyd,C,MIN,31,82,9,30,39
53,8482055,Drew O'Connor,L,PIT,26,82,20,18,38
53,8476897,Oskar Sundqvist,C,STL,30,82,16,22,38
53,8476873,Mark Jankowski,C,NSH,30,82,16,22,38
53,8477429,Andrew Copp,C,DET,30,82,14,24,38
53,8477507,Nikita Zadorov,D,BOS,29,82,12,26,38
53,8470613,Brent Burns,D,CAR,39,82,7,31,38
53,8476892,Colton Parayko,D,STL,31,82,7,31,38
53,8478500,Ivan Provorov,D,CBJ,27,82,3,35,38
53,8478507,John Marino,D,UTA,27,82,3,35,38
53,8475760,Nick Bjugstad,C,UTA,32,82,19,18,37
53,8475793,Ryan Johansen,C,PHI,32,82,18,19,37
53,8484144,Connor Bedard,C,CHI,19,82,18,19,37
53,8475149,Marcus Johansson,L,MIN,34,82,17,20,37
53,8481554,Kaapo Kakko,R,NYR,23,82,17,20,37
53,8476960,Andreas Athanasiou,C,CHI,30,82,15,22,37
53,8478472,Mathieu Joseph,R,STL,27,82,14,23,37
53,8481711,Matias Maccelli,L,UTA,24,82,13,24,37
53,8479996,Cody Glass,C,NSH,25,82,12,25,37
53,8475218,Mattias Ekholm,D,EDM,34,82,11,26,37
53,8482660,Kent Johnson,C,CBJ,22,82,11,26,37
53,8476917,Adam Pelech,D,NYI,30,82,5,32,37
53,8482125,Alexander Holtz,R,VGK,22,82,20,16,36
53,8476392,Adam Lowry,C,WPG,31,82,18,18,36
53,8482089,Jake Neighbours,L,STL,22,82,18,18,36
53,8482149,Cole Perfetti,C,WPG,22,82,15,21,36
53,8481656,Aliaksei Protas,C,WSH,23,82,14,22,36
53,8480028,Morgan Frost,C,PHI,25,82,13,23,36
53,8483515,Juraj Slafkovsky,L,MTL,20,82,13,23,36
53,8476885,Jacob Trouba,D,NYR,30,82,12,24,36
53,8476869,Brady Skjei,D,NSH,30,82,11,25,36
53,8478882,Vladislav Gavrikov,D,LAK,29,82,7,29,36
53,8479398,Samuel Girard,D,COL,26,82,3,33,36
53,8475722,Jason Zucker,L,BUF,32,82,22,13,35
53,8480068,Ryan Poehling,C,PHI,25,82,17,18,35
53,8480813,Joe Veleno,C,DET,24,82,15,20,35
53,8475714,Calle Jarnkrok,C,TOR,33,82,15,20,35
53,8480878,Nils Lundkvist,D,DAL,24,82,14,21,35
53,8478057,Dakota Joshua,C,VAN,28,82,13,22,35
53,8478046,Danton Heinen,L,VAN,29,82,12,23,35
53,8476927,Teddy Blueger,C,VAN,30,82,12,23,35
53,8475764,Cam Fowler,D,ANA,33,82,3,32,35
53,8477969,Marcus Pettersson,D,PIT,28,82,2,33,35
53,8481604,Pavel Dorofeyev,L,VGK,24,82,22,12,34
53,8483431,Logan Cooley,C,UTA,20,82,20,14,34
53,8478463,Anthony Beauvillier,L,PIT,27,82,18,16,34
53,8470621,Corey Perry,R,EDM,39,82,16,18,34
53,8479293,Brandon Tanev,L,SEA,33,82,13,21,34
53,8477989,Christian Dvorak,C,MTL,28,82,10,24,34
53,8474715,Cam Atkinson,R,TBL,35,82,18,15,33
53,8479353,Brett Howden,C,VGK,26,82,16,17,33
53,8477498,Darnell Nurse,D,EDM,29,82,14,19,33
53,8478891,Mason Appleton,C,WPG,28,82,14,19,33
53,8477931,Tomas Nosek,L,FLA,32,82,13,20,33
53,8476474,Stefan Noesen,R,NJD,31,82,12,21,33
53,8482807,Ethan Del Mastro,D,CHI,21,82,11,22,33
53,8476467,Jamie Oleksiak,D,SEA,32,82,11,22,33
53,8476925,Colton Sissons,C,NSH,31,82,10,23,33
53,8478413,Jordan Greenway,L,BUF,27,82,9,24,33
53,8477488,Brett Pesce,D,NJD,30,82,9,24,33
53,8474189,Lars Eller,C,PIT,35,82,7,26,33
53,8474574,Tyler Myers,D,VAN,34,82,7,26,33
53,8476979,Erik Gustafsson,D,DET,32,82,5,28,33
53,8475188,Brayden McNabb,D,VGK,33,82,4,29,33
53,8479414,Nathan Bastian,R,NJD,27,82,21,11,32
53,8478109,Victor Olofsson,L,VGK,29,82,15,17,32
53,8475343,Nic Dowd,C,WSH,34,82,15,17,32
53,8482062,Cole Smith,L,NSH,29,82,15,17,32
53,8480835,Jack Drury,C,CAR,24,82,14,18,32
53,8477953,Kasperi Kapanen,R,STL,28,82,11,21,32
53,8477947,Sonny Milano,L,WSH,28,82,10,22,32
53,8481606,Jordan Spence,D,LAK,23,82,5,27,32
53,8476457,Adam Larsson,D,SEA,32,82,5,27,32
53,8480043,Timothy Liljegren,D,TOR,25,82,3,29,32
53,8475848,Brendan Gallagher,R,MTL,32,82,20,11,31
53,8479941,Justin Danforth,R,CBJ,31,82,17,14,31
53,8479359,Beck Malenstyn,L,BUF,26,82,16,15,31
53,8481032,Paul Cotter,C,NJD,25,82,15,16,31
53,8484203,Bradly Nadeau,L,CAR,19,82,11,20,31
53,8474716,Jared Spurgeon,D,MIN,35,82,8,23,31
53,8483445,Cutter Gauthier,L,ANA,20,82,8,23,31
53,8479976,Juuso Valimaki,D,UTA,26,82,5,26,31
53,8482146,Luke Evangelista,R,NSH,22,82,18,12,30
53,8482720,Matthew Knies,L,TOR,22,82,16,14,30
53,8482079,Marco Rossi,C,MIN,23,82,15,15,30
53,8477425,Miles Wood,L,COL,29,82,15,15,30
53,8480113,Alex Iafallo,L,WPG,31,82,14,16,30
53,8482117,Lukas Reichel,L,CHI,22,82,13,17,30
53,8478434,Keegan Kolesar,R,VGK,27,82,12,18,30
53,8481013,Jonatan Berggren,R,DET,24,82,10,20,30
53,8482111,Justin Barron,D,MTL,23,82,10,20,30
53,8481546,Cam York,D,PHI,23,82,9,21,30
53,8475200,Dmitry Orlov,D,CAR,33,82,8,22,30
53,8473563,Nicklas Backstrom,C,WSH,37,82,7,23,30
53,8480873,Rasmus Sandin,D,WSH,24,82,6,24,30
53,8482655,J.J. Moser,D,TBL,24,82,4,26,30
53,8480748,Kiefer Sherwood,L,VAN,29,82,17,12,29
53,8476480,Vladislav Namestnikov,C,WPG,32,82,16,13,29
53,8481481,Blake Lizotte,C,PIT,27,82,15,14,29
53,8481535,Nils Hoglander,L,VAN,24,82,15,14,29
53,8482624,Daniil Miromanov,D,CGY,27,82,12,17,29
53,8482074,Connor Zary,C,CGY,23,82,10,19,29
53,8482166,Shakir Mukhamadullin,D,SJS,22,82,9,20,29
53,8478911,Matt Roy,D,WSH,29,82,8,21,29
53,8481708,Zac Jones,D,NYR,24,82,5,24,29
53,8482245,Artem Zub,D,OTT,29,82,1,28,29
53,8479402,Jake Bean,D,CGY,26,82,1,28,29
53,8480281,Alexey Toropchenko,R,STL,25,82,19,9,28
53,8477919,Frederick Gaudreau,C,MIN,31,82,17,11,28
53,8478013,Jake Walman,D,SJS,28,82,17,11,28
53,8476374,Sean Kuraly,C,CBJ,31,82,9,19,28
53,8482733,Logan Mailloux,D,MTL,31,82,6,22,28
53,8481568,Alex Vlasic,D,CHI,23,82,5,23,28
53,8476331,Dylan DeMelo,D,WPG,31,82,4,24,28
53,8476525,Colin Miller,D,WPG,32,82,4,24,28
53,8480049,Dylan Samberg,D,WPG,25,82,3,25,28
53,8477903,Garnet Hathaway,R,PHI,33,82,17,10,27
53,8479316,Luke Kunin,C,SJS,27,82,17,10,27
53,8481582,Nicholas Robertson,L,TOR,23,82,16,11,27
53,8480789,Oliver Wahlstrom,R,NYI,24,82,14,13,27
53,8484145,Zach Benson,L,BUF,19,82,14,13,27
53,8476981,Josh Anderson,R,MTL,30,82,13,14,27
53,8479591,Michael Eyssimont,C,TBL,28,82,12,15,27
53,8476858,Phillip Di Giuseppe,L,VAN,31,82,12,15,27
53,8479980,Nicolas Hague,D,VGK,26,82,11,16,27
53,8481477,Nico Sturm,C,SJS,29,82,10,17,27
53,8479351,Sam Steel,C,DAL,26,82,9,18,27
53,8479442,Troy Stecher,D,EDM,30,82,9,18,27
53,8476902,Esa Lindell,D,DAL,30,82,7,20,27
53,8476312,Josh Manson,D,COL,33,82,6,21,27
53,8476931,Jake McCabe,D,TOR,31,82,4,23,27
53,8475181,Nick Leddy,D,STL,33,82,2,25,27
53,8474151,Ryan McDonagh,D,TBL,35,82,1,26,27
53,8475462,Radko Gudas,D,ANA,34,82,1,26,27
53,8481028,Martin Pospisil,C,CGY,25,82,17,9,26
53,8479661,Tanner Jeannot,L,LAK,27,82,16,10,26
53,8480806,Isac Lundestrom,C,ANA,25,82,14,12,26
53,8480003,Jesper Boqvist,C,FLA,26,82,9,17,26
53,8480144,David Kampf,C,TOR,29,82,9,17,26
53,8479368,Max Jones,L,BOS,26,82,9,17,26
53,8482803,Olen Zellweger,D,ANA,21,82,7,19,26
53,8474673,TJ Brodie,D,CHI,34,82,6,20,26
53,8477365,Connor Clifton,D,BUF,29,82,6,20,26
53,8476422,Mike Reilly,D,NYI,31,82,4,22,26
53,8481093,Rafael Harvey-Pinard,L,MTL,25,82,13,12,25
53,8482809,Jackson Blake,R,CAR,21,82,12,13,25
53,8476878,Zemgus Girgensons,L,TBL,30,82,11,14,25
53,8484153,Leo Carlsson,C,ANA,20,82,10,15,25
53,8478851,Alexandre Carrier,D,NSH,28,82,8,17,25
53,8484911,Collin Graf,R,SJS,22,82,8,17,25
53,8479983,Mario Ferraro,D,SJS,26,82,7,18,25
53,8478133,Jake Evans,C,MTL,28,82,7,18,25
53,8480796,Martin Fehervary,D,WSH,25,82,5,20,25
53,8482073,Braden Schneider,D,NYR,23,82,4,21,25
53,8484166,Adam Fantilli,C,CBJ,20,82,13,11,24
53,8478020,Michael Amadio,C,OTT,28,82,13,11,24
53,8480995,Pontus Holmberg,R,TOR,25,82,12,12,24
53,8482141,Lukas Cormier,D,VGK,22,82,10,14,24
53,8481524,Bowen Byram,D,BUF,23,82,10,14,24
53,8480074,Alexandre Texier,C,STL,25,82,8,16,24
53,8476463,Jonas Brodin,D,MIN,31,82,8,16,24
53,8482666,Scott Morrow,D,CAR,22,82,8,16,24
53,8480980,Connor Dewar,C,TOR,25,82,6,18,24
53,8480035,Henri Jokiharju,D,BUF,25,82,6,18,24
53,8476429,Scott Mayfield,D,NYI,32,82,3,21,24
53,8478840,Will Borgen,D,SEA,28,82,3,21,24
53,8480246,Nick Perbix,D,TBL,26,82,2,22,24
53,8483457,Lane Hutson,D,MTL,20,82,10,13,23
53,8480336,Sean Walker,D,CAR,30,82,8,15,23
53,8477034,Jaycob Megna,D,FLA,32,82,6,17,23
53,8482122,Brock Faber,D,MIN,22,82,3,20,23
53,8481567,Henry Thrun,D,SJS,23,82,2,21,23
53,8483524,Shane Wright,C,SEA,20,82,14,8,22
53,8476278,Colin Blackwell,C,DAL,31,82,12,10,22
53,8481704,Juuso Parssinen,C,NSH,23,82,12,10,22
53,8475842,Sam Carrick,C,NYR,32,82,11,11,22
53,8482077,Dylan Holloway,L,EDM,23,82,10,12,22
53,8480855,Jack McBain,C,UTA,24,82,9,13,22
53,8476889,Radek Faksa,C,STL,30,82,9,13,22
53,8481522,Peyton Krebs,C,BUF,23,82,7,15,22
53,8477435,Ryan Graves,D,PIT,29,82,4,18,22
53,8479324,Ryan Lindgren,D,NYR,26,82,4,18,22
53,8477506,Ryan Pulock,D,NYI,30,82,2,20,22
53,8481014,Alexander Romanov,D,NYI,24,82,2,20,22
53,8480025,MacKenzie Entwistle,R,FLA,25,82,12,9,21
53,8482702,Logan Stankoven,C,DAL,21,82,11,10,21
53,8477406,Mattias Janmark,C,EDM,32,82,11,10,21
53,8476469,Joel Armia,R,MTL,31,82,10,11,21
53,8478211,Dryden Hunt,L,CGY,29,82,9,12,21
53,8477353,Tyler Motte,C,DET,29,82,8,13,21
53,8482659,Josh Doan,R,UTA,22,82,8,13,21
53,8477392,Hudson Fasching,R,NYI,29,82,7,14,21
53,8481122,Simon Benoit,D,TOR,26,82,7,14,21
53,8475279,Ben Chiarot,D,DET,33,82,5,16,21
53,8483565,Nick Blankenburg,D,NSH,26,82,3,18,21
53,8478859,Niko Mikkola,D,FLA,28,82,3,18,21
53,8476879,Cody Ceci,D,EDM,31,82,2,19,21
53,8475762,Derek Forbort,D,VAN,32,82,2,19,21
53,8482762,Simon Edvinsson,D,DET,21,82,12,8,20
53,8481641,Joel Kiviranta,L,COL,28,82,9,11,20
53,8482142,Jamie Drysdale,D,PHI,22,82,5,15,20
53,8477369,Carson Soucy,D,VAN,30,82,4,16,20
53,8474090,Brendan Smith,D,DAL,35,82,3,17,20
53,8473507,Jeff Petry,D,DET,37,82,1,19,20
53,8475718,Justin Holl,D,DET,32,82,1,19,20
53,8482679,Matt Coronato,R,CGY,22,82,11,8,19
53,8482101,Danil Gushchin,L,SJS,22,82,11,8,19
53,8480021,Jack Studnicka,C,LAK,25,82,10,9,19
53,8477015,Connor Brown,R,EDM,30,82,9,10,19
53,8479291,Kevin Rooney,C,CGY,31,82,9,10,19
53,8481517,Brett Leason,R,ANA,25,82,8,11,19
53,8477839,Conor Sheary,L,TBL,32,82,8,11,19
53,8477220,Nate Schmidt,D,FLA,33,82,8,11,19
53,8476442,Matt Nieto,L,PIT,32,82,8,11,19
53,8482133,Thomas Bordeleau,C,SJS,22,82,7,12,19
53,8479393,Noah Gregor,C,OTT,26,82,7,12,19
53,8476624,Barclay Goodrow,C,SJS,31,82,7,12,19
53,8480834,Ty Emberson,D,SJS,24,82,6,13,19
53,8483505,Matthew Poitras,C,BOS,20,82,6,13,19
53,8482858,Ryker Evans,D,SEA,23,82,6,13,19
53,8475690,Chris Tanev,D,TOR,35,82,5,14,19
53,8480073,Erik Brannstrom,D,COL,25,82,5,14,19
53,8476891,Matt Grzelcyk,D,PIT,30,82,5,14,19
53,8479998,Mikey Anderson,D,LAK,25,82,4,15,19
53,8479371,Dante Fabbro,D,NSH,26,82,4,15,19
53,8478136,Jake Middleton,D,MIN,28,82,4,15,19
53,8474013,Ian Cole,D,UTA,35,82,3,16,19
53,8470600,Ryan Suter,D,STL,39,82,2,17,19
53,8478432,Christian Fischer,R,DET,27,82,12,6,18
53,8483493,Frank Nazar,C,CHI,20,82,7,11,18
53,8482087,Kaiden Guhle,D,MTL,22,82,6,12,18
53,8475855,Jesper Fast,R,CAR,33,82,6,12,18
53,8483468,Jiri Kulich,C,BUF,20,82,4,14,18
53,8481178,Egor Zamula,D,PHI,24,82,3,15,18
53,8476967,Brett Kulak,D,EDM,30,82,3,15,18
53,8478399,Jonas Siegenthaler,D,NJD,27,82,2,16,18
53,8480222,Sebastian Aho,D,PIT,28,82,2,16,18
53,8476441,Joel Edmundson,D,LAK,31,82,2,16,18
53,8477335,Kyle Burroughs,D,LAK,29,82,1,17,18
53,8475231,Casey Cizikas,C,NYI,33,82,12,5,17
53,8483397,Marc McLaughlin,C,BOS,25,82,11,6,17
53,8480448,Parker Kelly,L,COL,25,82,9,8,17
53,8478569,Noel Acciari,C,PIT,33,82,9,8,17
53,8477508,Curtis Lazar,C,NJD,29,82,9,8,17
53,8482259,Bobby McMann,C,TOR,28,82,8,9,17
53,8478508,Yakov Trenin,C,MIN,27,82,7,10,17
53,8484149,Gavin Brindley,C,CBJ,20,82,5,12,17
53,8483482,Tristan Luneau,D,ANA,20,82,4,13,17
53,8479369,Andrew Peeke,D,BOS,26,82,4,13,17
53,8481605,Jackson LaCombe,D,ANA,23,82,3,14,17
53,8483466,Kevin Korchinski,D,CHI,20,82,3,14,17
53,8480172,Jan Rutta,D,SJS,34,82,2,15,17
53,8475324,Nick Jensen,D,OTT,34,82,0,17,17
53,8480860,Kevin Bahl,D,CGY,24,82,0,17,17
53,8473453,Trevor Lewis,C,LAK,37,82,11,5,16
53,8476918,Jimmy Vesey,L,NYR,31,82,7,9,16
53,8481699,Aku Raty,R,UTA,23,82,7,9,16
53,8471677,Jack Johnson,D,CBJ,37,82,6,10,16
53,8483012,Logan Morrison,C,SEA,22,82,4,12,16
53,8478443,Brandon Carlo,D,BOS,28,82,4,12,16
53,8483495,Simon Nemec,D,NJD,20,82,4,12,16
53,8475233,David Savard,D,MTL,34,82,3,13,16
53,8477505,Alexander Wennberg,C,SJS,30,82,8,7,15
53,8482749,Joshua Roy,R,MTL,21,82,8,7,15
53,8475220,Marcus Foligno,L,MIN,33,82,7,8,15
53,8482118,Sam Colangelo,R,ANA,23,82,7,8,15
53,8482153,Brendan Brisson,C,VGK,23,82,5,10,15
53,8482859,Zack Ostapchuk,C,OTT,21,82,4,11,15
53,8482712,Oskar Olausson,R,COL,22,82,4,11,15
53,8477845,Trevor van Riemsdyk,D,WSH,33,82,3,12,15
53,8480807,Mattias Samuelsson,D,BUF,24,82,2,13,15
53,8477499,Rasmus Ristolainen,D,PHI,30,82,1,14,15
53,8480870,Bo Groulx,C,NYR,24,82,7,7,14
53,8483499,Liam Ohgren,L,MIN,20,82,5,9,14
53,8477938,Haydn Fleury,D,WPG,28,82,4,10,14
53,8478468,Jeremy Lauzon,D,NSH,27,82,4,10,14
53,8476473,Connor Murphy,D,CHI,31,82,2,12,14
53,8478416,Erik Cernak,D,TBL,27,82,1,13,14
53,8481601,Simon Holmstrom,R,NYI,23,82,8,5,13
53,8483567,Georgii Merkulov,C,BOS,24,82,7,6,13
53,8482145,Mavrik Bourque,C,DAL,22,82,5,8,13
53,8483490,Pavel Mintyukov,D,ANA,21,82,5,8,13
53,8482470,Ilya Solovyov,D,CGY,24,82,4,9,13
53,8480879,Jacob Bernard-Docker,D,OTT,24,82,4,9,13
53,8475790,Erik Gudbranson,D,CBJ,32,82,1,12,13
53,8480950,Ilya Lyubushkin,D,DAL,30,82,1,12,13
53,8482070,Mitchell Chaffee,R,TBL,26,82,7,5,12
53,8479638,Justin Brazeau,R,BOS,26,82,6,6,12
53,8474062,Riley Nash,C,NYR,35,82,6,6,12
53,8476822,Luke Glendening,C,TBL,35,82,5,7,12
53,8483763,Maksymilian Szuber,D,UTA,22,82,3,9,12
53,8478450,Parker Wotherspoon,D,BOS,27,82,3,9,12
53,8480990,Declan Chisholm,D,MIN,24,82,2,10,12
53,8482713,Mackie Samoskevich,R,FLA,22,82,2,10,12
53,8474567,Zach Bogosian,D,MIN,34,82,2,10,12
53,8476372,Nick Seeler,D,PHI,31,82,2,10,12
53,8474612,Travis Hamonic,D,OTT,34,82,0,12,12
53,8475177,Calvin de Haan,D,COL,33,82,2,9,11
53,8482155,Alex Laferriere,R,LAK,23,82,9,1,10
53,8478178,Darren Raddysh,D,TBL,28,82,2,8,10
53,8483460,David Jiricek,D,CBJ,21,82,2,8,10
53,8475455,Brenden Dillon,D,NJD,34,82,3,6,9
53,8478874,Adam Gaudette,C,OTT,28,82,3,6,9
53,8482787,Nikita Chibrikov,R,WPG,31,82,2,7,9
53,8483489,Fraser Minten,C,TOR,31,82,3,5,8
53,8483471,Brad Lambert,C,WPG,31,82,3,4,7
53,8482516,Matthew Kessel,D,STL,24,82,3,4,7
53,8479576,Vincent Desharnais,D,VAN,28,82,1,6,7
53,8470794,Joe Pavelski,C,,40,0,0,0,0
53,8481703,Valtteri Puustinen,R,PIT,25,0,0,0,0
53,8477950,Tony DeAngelo,D,,29,0,0,0,0
53,8481577,Philip Tomasino,C,NSH,23,0,0,0,0
53,8475197,Tyson Barrie,D,,33,0,0,0,0
53,8471218,Blake Wheeler,R,,38,0,0,0,0
53,8474157,Max Pacioretty,L,,36,0,0,0,0
53,8478466,Daniel Sprong,R,VAN,27,0,0,0,0
53,8475744,Evgeny Kuznetsov,C,,32,0,0,0,0
53,8481019,David Gustafsson,C,WPG,24,0,0,0,0
53,8475906,John Klingberg,D,,32,0,0,0,0
53,8479348,Kale Clague,D,BUF,26,0,0,0,0
53,8476952,Dominic Toninato,C,WPG,30,0,0,0,0
53,8473473,Milan Lucic,L,,36,0,0,0,0
53,8474037,James van Riemsdyk,L,,35,0,0,0,0
53,8474602,Justin Schultz,D,,34,0,0,0,0
53,8482222,Alexander Barabanov,L,,30,0,0,0,0
53,8479372,Josh Mahura,D,SEA,26,0,0,0,0
53,8479982,Conor Timmins,D,TOR,26,0,0,0,0
53,8474031,Kevin Shattenkirk,D,,35,0,0,0,0
53,8480008,Adam Ruzicka,C,,25,0,0,0,0
53,8481059,Scott Perunovich,D,STL,26,0,0,0,0
53,8480884,Calen Addison,D,,24,0,0,0,0
53,8476994,Vinnie Hinostroza,C,NSH,30,0,0,0,0
53,8478452,Caleb Jones,D,LAK,27,0,0,0,0
53,8480157,Calle Rosen,D,COL,30,0,0,0,0
53,8481609,Vladislav Kolyachonok,D,UTA,23,0,0,0,0
53,8479415,Michael McLeod,C,,26,0,0,0,0
53,8476919,Chris Tierney,C,,30,0,0,0,0
53,8479639,Dylan Coghlan,D,WPG,26,0,0,0,0
53,8478146,Matthew Highmore,C,OTT,28,0,0,0,0
53,8478970,Jalen Chatfield,D,CAR,28,0,0,0,0
53,8480205,Emil Bemstrom,C,PIT,25,0,0,0,0
53,8474884,Mike Hoffman,C,,35,0,0,0,0
53,8471274,Alex Goligoski,D,,39,0,0,0,0
53,8478104,Sammy Blais,L,,28,0,0,0,0
53,8474870,Tyler Johnson,C,,34,0,0,0,0
53,8476913,Devin Shore,C,MIN,30,0,0,0,0
53,8481598,Philip Broberg,D,EDM,23,0,0,0,0
53,8480058,Pierre-Olivier Joseph,D,STL,25,0,0,0,0
53,8480891,Michael Kesselring,D,UTA,24,0,0,0,0
53,8477979,Nicolas Aube-Kubel,R,BUF,28,0,0,0,0
53,8476871,Tanner Pearson,L,,32,0,0,0,0
53,8476393,Nick Cousins,C,,31,0,0,0,0
53,8479977,Kailer Yamamoto,R,,26,0,0,0,0
53,8479543,Michael Pezzetta,L,MTL,26,0,0,0,0
53,8477018,Ben Hutton,D,VGK,31,0,0,0,0
53,8480762,Eric Robinson,L,CAR,29,0,0,0,0
53,8474034,Pat Maroon,L,CHI,36,0,0,0,0
53,8481058,Jesse Ylönen,R,,25,0,0,0,0
53,8475179,Dmitry Kulikov,D,FLA,34,0,0,0,0
53,8481527,Kaedan Korczak,D,VGK,23,0,0,0,0
53,8473449,Kyle Okposo,R,,36,0,0,0,0
53,8482192,Isaak Phillips,D,CHI,23,0,0,0,0
53,8480727,Zach Whitecloud,D,VGK,28,0,0,0,0
53,8479346,Dillon Dube,C,,26,0,0,0,0
53,8480821,Filip Zadina,R,,25,0,0,0,0
53,8480001,Urho Vaakanainen,D,ANA,25,0,0,0,0
53,8470966,Mark Giordano,D,,41,0,0,0,0
53,8480853,Liam Foudy,C,,24,0,0,0,0
53,8475225,Craig Smith,C,CHI,35,0,0,0,0
53,8479972,Mason Shaw,C,WPG,26,0,0,0,0
53,8478451,Ethan Bear,D,WSH,27,0,0,0,0
53,8474040,Sam Gagner,C,,35,0,0,0,0
53,8480196,Jacob Bryson,D,BUF,27,0,0,0,0
53,8479984,Cal Foote,D,,26,0,0,0,0
53,8480011,Klim Kostin,C,SJS,25,0,0,0,0
53,8482176,Wyatt Kaiser,D,CHI,22,0,0,0,0
53,8476988,Matt Benning,D,SJS,30,0,0,0,0
53,8479370,Tyson Jost,C,CAR,26,0,0,0,0
53,8477464,Nic Petan,C,,29,0,0,0,0
53,8477380,Jonny Brodzinski,C,NYR,31,0,0,0,0
53,8480070,Ian Mitchell,D,BOS,25,0,0,0,0
53,8479315,Joey Anderson,R,CHI,26,0,0,0,0
53,8478099,Kevin Labanc,R,,29,0,0,0,0
53,8476874,Olli Maatta,D,DET,30,0,0,0,0
53,8475208,Brian Dumoulin,D,ANA,33,0,0,0,0
53,8478430,Oliver Kylington,D,,27,0,0,0,0
53,8479536,Axel Jonsson-Fjallby,L,WPG,26,0,0,0,0
53,8479671,Mathieu Olivier,R,CBJ,27,0,0,0,0
53,8471709,Marc-Edouard Vlasic,D,SJS,37,0,0,0,0
53,8479328,Julien Gauthier,R,NYI,27,0,0,0,0
53,8478421,A.J. Greer,L,FLA,28,0,0,0,0
53,8477573,Nathan Walker,L,STL,30,0,0,0,0
53,8481537,Nikita Okhotiuk,D,CGY,24,0,0,0,0
53,8474166,Alec Martinez,D,CHI,37,0,0,0,0
53,8470610,Zach Parise,L,,40,0,0,0,0
53,8477478,William Carrier,L,CAR,30,0,0,0,0
53,8479344,Jesse Puljujarvi,R,PIT,26,0,0,0,0
53,8480887,Jordan Harris,D,MTL,24,0,0,0,0
53,8478502,Dennis Gilbert,D,BUF,28,0,0,0,0
53,8482730,Brandt Clarke,D,LAK,21,0,0,0,0
53,8480355,Mark Kastelic,C,BOS,25,0,0,0,0
53,8475750,Jon Merrill,D,MIN,32,0,0,0,0
53,8475164,Jakob Silfverberg,R,,34,0,0,0,0
53,8477944,Jakub Vrana,L,,28,0,0,0,0
53,8479439,Jacob MacDonald,D,COL,31,0,0,0,0
53,8474568,Luke Schenn,D,NSH,35,0,0,0,0
53,8478454,Noah Juulsen,D,VAN,27,0,0,0,0
53,8475752,Tyler Pitlick,C,,33,0,0,0,0
53,8482148,Hendrix Lapierre,C,WSH,22,0,0,0,0
53,8481167,Brayden Pachal,D,CGY,25,0,0,0,0
53,8478043,Sam Lafferty,C,BUF,29,0,0,0,0
53,8479321,Lucas Johansen,D,,27,0,0,0,0
53,8471699,Andrew Cogliano,C,,37,0,0,0,0
53,8481521,Ronnie Attard,D,PHI,25,0,0,0,0
53,8481161,Jake Christiansen,D,CBJ,25,0,0,0,0
53,8479458,Nikita Zaitsev,D,,33,0,0,0,0
53,8479619,Michael Carcone,L,UTA,28,0,0,0,0
53,8479026,Philippe Myers,D,TOR,27,0,0,0,0
53,8477330,Dominik Kubalik,L,,29,0,0,0,0
53,8481617,Vasily Podkolzin,R,VAN,23,0,0,0,0
53,8481701,Santeri Hatakka,D,NJD,23,0,0,0,0
53,8479514,Rem Pitlick,C,,27,0,0,0,0
53,8477446,Michael McCarron,R,NSH,29,0,0,0,0
53,8470604,Jeff Carter,C,,39,0,0,0,0
53,8482241,Radim Zohorna,L,,28,0,0,0,0
53,8480289,Morgan Barron,C,WPG,26,0,0,0,0
53,8479379,Givani Smith,R,SJS,26,0,0,0,0
53,8480216,Jacob Peterson,C,,25,0,0,0,0
53,8477851,Jordan Oesterle,D,BOS,32,0,0,0,0
53,8484258,Sam Malinski,D,COL,26,0,0,0,0
53,8478904,Steven Lorentz,C,,28,0,0,0,0
53,8482095,Tyler Kleven,D,OTT,22,0,0,0,0
53,8480848,Ty Dellandrea,C,SJS,24,0,0,0,0
53,8476884,Derrick Pouliot,D,,30,0,0,0,0
53,8479336,Carl Grundstrom,R,SJS,27,0,0,0,0
53,8482964,Arber Xhekaj,D,MTL,23,0,0,0,0
53,8471686,Marc Staal,D,,37,0,0,0,0
53,8477887,Patrick Brown,C,BOS,32,0,0,0,0
53,8478495,Denis Gurianov,R,,27,0,0,0,0
53,8473504,Cal Clutterbuck,R,,37,0,0,0,0
53,8481550,Adam Beckman,L,NJD,23,0,0,0,0
53,8480845,Rasmus Kupari,C,WPG,24,0,0,0,0
53,8474009,Nick Bonino,C,,36,0,0,0,0
53,8478585,Derek Ryan,C,EDM,38,0,0,0,0
53,8477962,Brendan Lemieux,L,CAR,28,0,0,0,0
53,8482861,Vincent Iorio,D,WSH,22,0,0,0,0
53,8479378,Logan Stanley,D,WPG,26,0,0,0,0
53,8473446,Erik Johnson,D,PHI,36,0,0,0,0
53,8481743,Marc Del Gaizo,D,NSH,25,0,0,0,0
53,8477384,Josh Brown,D,EDM,30,0,0,0,0
53,8482165,Yan Kuznetsov,D,CGY,22,0,0,0,0
53,8478424,Jansen Harkins,C,ANA,27,0,0,0,0
53,8482144,Jack Thompson,D,SJS,22,0,0,0,0
53,8478512,Austin Czarnik,C,,32,0,0,0,0
53,8477527,Ross Johnston,L,ANA,30,0,0,0,0
53,8479383,Boris Katchouk,L,,26,0,0,0,0
53,8482094,Daemon Hunt,D,MIN,22,0,0,0,0
53,8481719,Maxwell Crozier,D,TBL,24,0,0,0,0
53,8480192,Johnathan Kovacevic,D,NJD,27,0,0,0,0
53,8479376,Victor Mete,D,,26,0,0,0,0
53,8482511,Mason Lohrei,D,BOS,23,0,0,0,0
53,8475825,Jani Hakanpää,D,,32,0,0,0,0
53,8478021,William Lagesson,D,DET,28,0,0,0,0
53,8475795,Dylan McIlrath,D,WSH,32,0,0,0,0
53,8477846,Ryan Carpenter,C,,33,0,0,0,0
53,8481056,Spencer Stastney,D,NSH,24,0,0,0,0
53,8481564,Ryan Johnson,D,BUF,23,0,0,0,0
53,8478017,Mark Friedman,D,VAN,29,0,0,0,0
53,8479320,Max Lajoie,D,SEA,27,0,0,0,0
53,8480075,Cameron Crotty,D,MIN,25,0,0,0,0
53,8484287,Cole McWard,D,VAN,23,0,0,0,0
53,8484254,Akito Hirose,D,VAN,25,0,0,0,0
53,8483407,Brandon Scanlin,D,NYR,25,0,0,0,0
53,8480274,Philip Kemp,D,EDM,25,0,0,0,0
53,8479522,Hardy Haman Aktell,D,WSH,26,0,0,0,0
53,8480007,Jonas Rondbjerg,R,VGK,25,0,0,0,0
53,8477454,Adam Erne,L,,29,0,0,0,0
53,8481679,Maxence Guenette,D,OTT,23,0,0,0,0
53,8480441,Trey Fix-Wolansky,R,CBJ,25,0,0,0,0
53,8483546,Marshall Rifai,D,TOR,26,0,0,0,0
53,8480084,Nick DeSimone,D,NJD,30,0,0,0,0
53,8481030,Jack St. Ivany,D,PIT,25,0,0,0,0
53,8481592,Jakob Pelletier,L,CGY,23,0,0,0,0
53,8478011,Louie Belpedio,D,PHI,28,0,0,0,0
53,8477930,Pierre-Edouard Bellemare,L,,39,0,0,0,0
53,8484321,Nikolas Matinpalo,D,OTT,26,0,0,0,0
53,8482067,Connor Mackey,D,NYR,28,0,0,0,0
53,8481806,Louis Crevier,D,CHI,23,0,0,0,0
53,8484326,Patrik Koch,D,UTA,28,0,0,0,0
53,8477971,Andreas Englund,D,LAK,28,0,0,0,0
53,8481751,Lukas Rousek,R,BUF,25,0,0,0,0
53,8481006,Tyler Tucker,D,STL,24,0,0,0,0
53,8476867,Brendan Gaunce,C,MIN,30,0,0,0,0
53,8479520,Brandon Duhaime,R,WSH,27,0,0,0,0
53,8477073,Kurtis MacDermid,L,NJD,30,0,0,0,0
53,8480874,Adam Ginning,D,PHI,24,0,0,0,0
53,8477473,Justin Bailey,R,SJS,29,0,0,0,0
53,8479066,Ryan Lomberg,L,CGY,30,0,0,0,0
53,8477070,Liam O'Brien,C,UTA,30,0,0,0,0
53,8474618,Marco Scandella,D,,34,0,0,0,0
53,8475797,Jarred Tinordi,D,,32,0,0,0,0
53,8481441,Joe Snively,C,DET,28,0,0,0,0
53,8477244,Chad Ruhwedel,D,NYR,34,0,0,0,0
53,8479772,Zack MacEwen,R,OTT,28,0,0,0,0
53,8481147,Reese Johnson,C,MIN,26,0,0,0,0
53,8481043,Cole Koepke,L,BOS,26,0,0,0,0
53,8483619,Filip Roos,D,OTT,25,0,0,0,0
53,8481541,Samuel Bolduc,D,NYI,24,0,0,0,0
53,8477810,Joel Hanley,D,CGY,33,0,0,0,0
53,8476907,Mackenzie MacEachern,L,,30,0,0,0,0
53,8482652,Walker Duehr,R,CGY,27,0,0,0,0
53,8477126,Jayson Megna,C,,34,0,0,0,0
53,8483398,Declan Carlile,D,TBL,31,0,0,0,0
53,8482929,Emil Lilleberg,D,TBL,23,0,0,0,0
53,8480880,Jakub Lauko,C,MIN,24,0,0,0,0
53,8480245,Olle Lycksell,R,PHI,25,0,0,0,0
53,8480252,Cole Guttman,C,CHI,25,0,0,0,0
53,8477467,Gustav Olofsson,D,SEA,30,0,0,0,0
53,8479968,Vinni Lettieri,C,BOS,29,0,0,0,0
53,8478400,Colin White,C,,27,0,0,0,0
53,8475755,Alexander Petrovic,D,DAL,32,0,0,0,0
53,8481812,Nikolai Knyzhov,D,,27,0,0,0,0
53,8481593,Jayden Struble,D,MTL,23,0,0,0,0
53,8481532,Alex Turcotte,C,LAK,23,0,0,0,0
53,8482126,Emil Andrae,D,PHI,31,0,0,0,0
53,8479944,Zach Aston-Reese,C,VGK,30,0,0,0,0
53,8471817,Ryan Reaves,R,TOR,37,0,0,0,0
53,8481206,John Ludvig,D,PIT,24,0,0,0,0
53,8481599,Victor Soderstrom,D,UTA,23,0,0,0,0
53,8480292,Carson Meyer,R,ANA,27,0,0,0,0
53,8482496,Nils Aman,C,VAN,24,0,0,0,0
53,8479718,Alex Barré-Boulet,C,MTL,27,0,0,0,0
53,8479994,Jaret Anderson-Dolan,C,WPG,25,0,0,0,0
53,8480184,Gustav Lindstrom,D,,26,0,0,0,0
53,8480890,Jan Jenik,R,OTT,24,0,0,0,0
53,8478067,Oskar Lindblom,L,,28,0,0,0,0
53,8476934,Brock McGinn,L,ANA,30,0,0,0,0
53,8479985,Cale Fleury,D,SEA,26,0,0,0,0
53,8484304,Uvis Balinskis,D,FLA,28,0,0,0,0
53,8479981,Jonah Gadjovich,L,FLA,26,0,0,0,0
53,8481716,Dmitri Voronkov,L,CBJ,24,0,0,0,0
53,8474709,Matt Martin,L,,35,0,0,0,0
53,8482634,Alex Steeves,C,TOR,25,0,0,0,0
53,8480823,Alexander Alexeyev,D,WSH,25,0,0,0,0
53,8477541,Dakota Mermis,D,TOR,30,0,0,0,0
53,8483491,Ivan Miroshnichenko,L,WSH,20,0,0,0,0
53,8478477,Mitchell Stephens,C,SEA,27,0,0,0,0
53,8481543,Nikita Alexandrov,C,STL,24,0,0,0,0
53,8479423,Alex Nylander,L,,26,0,0,0,0
53,8482451,Mikael Pyyhtia,L,CBJ,23,0,0,0,0
53,8478831,Kevin Stenlund,C,UTA,28,0,0,0,0
53,8480306,Grant Hutton,D,NYI,29,0,0,0,0
53,8478028,Fredrik Olofsson,L,,28,0,0,0,0
53,8477462,Robert Hagg,D,VGK,29,0,0,0,0
53,8477320,Anton Blidh,L,NYR,29,0,0,0,0
53,8482157,Will Cuylle,L,NYR,22,0,0,0,0
53,8482737,Zack Bolduc,C,STL,21,0,0,0,0
53,8481239,Samuel Fagemo,L,,24,0,0,0,0
53,8481600,Tobias Bjornfot,D,FLA,23,0,0,0,0
53,8478409,Anthony Richard,C,PHI,28,0,0,0,0
53,8474145,Robert Bortuzzo,D,,35,0,0,0,0
53,8475958,Michael Sgarbossa,C,WSH,32,0,0,0,0
53,8479986,Kole Lind,R,DAL,26,0,0,0,0
53,8479249,Andrew Poturalski,C,SJS,30,0,0,0,0
53,8479362,Riley Tufte,L,BOS,26,0,0,0,0
53,8479991,Jake Leschyshyn,C,NYR,25,0,0,0,0
53,8479587,Rhett Gardner,C,PHI,28,0,0,0,0
53,8482744,James Malatesta,L,CBJ,21,0,0,0,0
53,8478854,Ryan Shea,D,PIT,27,0,0,0,0
53,8481591,Sam Poulin,R,,23,0,0,0,0
53,8483512,Matt Savoie,C,EDM,20,0,0,0,0
53,8482102,Vasily Ponomarev,C,PIT,22,0,0,0,0
53,8482162,Roby Jarventie,L,EDM,22,0,0,0,0
53,8481016,Ruslan Iskhakov,C,,24,0,0,0,0
53,8482172,Landon Slaggert,L,CHI,22,0,0,0,0
53,8482747,Brennan Othmann,L,NYR,21,0,0,0,0
53,8480031,Maxime Comtois,L,,25,0,0,0,0
53,8480226,Marián Studenic,R,,26,0,0,0,0
53,8478408,Travis Dermott,D,,28,0,0,0,0
53,8481518,Nolan Foote,L,NJD,24,0,0,0,0
53,8479419,Brett Murray,L,BUF,26,0,0,0,0
53,8482088,Justin Sourdif,R,FLA,22,0,0,0,0
53,8482201,Gage Goncalves,C,TBL,23,0,0,0,0
53,8481578,Graeme Clarke,R,MIN,23,0,0,0,0
53,8482177,Marat Khusnutdinov,C,MIN,22,0,0,0,0
53,8481754,Nikita Nesterenko,C,ANA,23,0,0,0,0
53,8483531,Brian Halonen,L,NJD,25,0,0,0,0
53,8483920,Pierrick Dube,R,WSH,23,0,0,0,0
53,8480851,Akil Thomas,C,LAK,24,0,0,0,0
53,8475235,Nicolas Deslauriers,L,PHI,33,0,0,0,0
53,8482476,Emil Heineman,L,MTL,23,0,0,0,0
53,8477149,Scott Sabourin,R,SJS,32,0,0,0,0
53,8483549,Lucas Condotta,L,MTL,27,0,0,0,0
53,8482765,Isak Rosen,R,BUF,21,0,0,0,0
53,8481237,Kyle MacLean,C,NYI,25,0,0,0,0
53,8481024,Linus Karlsson,C,VAN,25,0,0,0,0
53,8481690,Tyler Angle,C,,24,0,0,0,0
53,8483570,Ben Meyers,C,SEA,26,0,0,0,0
53,8481655,Cole Schwindt,R,CGY,23,0,0,0,0
53,8481462,Mason Morelli,L,VGK,28,0,0,0,0
53,8483401,Marc Johnstone,R,PIT,28,0,0,0,0
53,8478956,Samuel Laberge,L,NJD,27,0,0,0,0
53,8479533,Joona Koppanen,L,,26,0,0,0,0
53,8482197,Adam Raska,R,MIN,23,0,0,0,0
53,8482250,Callahan Burke,C,VGK,27,0,0,0,0
53,8482784,Zach Dean,C,STL,21,0,0,0,0
53,8484255,Jason Polin,R,COL,25,0,0,0,0
53,8481077,John Leonard,L,,26,0,0,0,0
53,8481534,Raphael Lavoie,C,EDM,24,0,0,0,0
53,8483609,Adam Klapka,R,CGY,24,0,0,0,0
53,8482751,Ryan Winterton,C,SEA,21,0,0,0,0
53,8480267,Sammy Walker,C,MIN,25,0,0,0,0
53,8475766,Austin Watson,L,,32,0,0,0,0
53,8482460,Matt Rempe,C,NYR,22,0,0,0,0
53,8481065,Angus Crookshank,L,OTT,25,0,0,0,0
53,8481070,Hugh McGing,L,,26,0,0,0,0
53,8476323,Max McCormick,L,SEA,32,0,0,0,0
53,8483395,Arshdeep Bains,L,VAN,23,0,0,0,0
53,8484259,Ondrej Pavel,C,COL,31,0,0,0,0
53,8483432,Luca Del Bel Belluz,C,CBJ,31,0,0,0,0
53,8483045,Cameron Butler,R,CBJ,31,0,0,0,0
53,8482061,Brandon Biro,L,SEA,26,0,0,0,0
53,8477401,John Hayden,C,SEA,29,0,0,0,0
53,8475278,Byron Froese,C,,33,0,0,0,0
53,8478446,Glenn Gawdin,C,LAK,27,0,0,0,0
53,8477993,Justin Kirkland,C,CGY,28,0,0,0,0
53,8482147,Jean-Luc Foudy,C,COL,22,0,0,0,0
53,8480032,Shane Bowers,C,NJD,25,0,0,0,0
53,8479330,Brandon Gignac,C,MTL,27,0,0,0,0
53,8480776,Sheldon Rempal,R,,29,0,0,0,0
53,8475413,Justin Dowling,C,NJD,34,0,0,0,0
53,8481726,Adam Edstrom,C,NYR,24,0,0,0,0
53,8480844,Grigori Denisenko,L,VGK,24,0,0,0,0
53,8478147,Bokondji Imama,L,PIT,28,0,0,0,0
53,8478881,Brett Seney,L,CHI,28,0,0,0,0
53,8483630,Pavol Regenda,L,ANA,25,0,0,0,0
53,8480836,Jonathan Gruden,C,,24,0,0,0,0
53,8484314,Jiri Smejkal,L,,28,0,0,0,0
53,8475780,Chris Wagner,R,COL,33,0,0,0,0
53,8479546,Oskar Steen,C,,26,0,0,0,0
53,8483597,Milos Kelemen,L,UTA,25,0,0,0,0
53,8481789,Tye Kartye,L,SEA,23,0,0,0,0
53,8484325,Waltteri Merela,C,TBL,26,0,0,0,0
53,8479421,Jacob Moverare,D,LAK,26,0,0,0,0
53,8481585,Egor Afanasyev,L,SJS,23,0,0,0,0
53,8479547,Matthew Phillips,R,,26,0,0,0,0
53,8479367,William Lockwood,R,FLA,26,0,0,0,0
53,8476915,Jujhar Khaira,L,,30,0,0,0,0
53,8481422,Jacob Lucchini,C,NSH,29,0,0,0,0
53,8480468,James Hamblin,L,EDM,25,0,0,0,0
53,8478051,Max Willman,C,NJD,29,0,0,0,0
53,8481556,John Beecher,C,BOS,23,0,0,0,0
53,8478078,Rourke Chartier,C,,28,0,0,0,0
54,8477492,Nathan MacKinnon,C,COL,29,82,53,98,151
54,8478402,Connor McDavid,C,EDM,27,82,52,93,145
54,8478550,Artemi Panarin,L,NYR,33,82,50,79,129
54,8479318,Auston Matthews,C,TOR,27,82,73,55,128
54,8477956,David Pastrnak,R,BOS,28,82,57,69,126
54,8476453,Nikita Kucherov,R,TBL,31,82,34,89,123
54,8478864,Kirill Kaprizov,L,MIN,27,82,59,63,122
54,8477939,William Nylander,R,TOR,28,82,44,71,115
54,8481559,Jack Hughes,C,NJD,23,82,41,70,111
54,8479314,Matthew Tkachuk,L,FLA,27,82,45,65,110
54,8471675,Sidney Crosby,C,PIT,37,82,36,69,105
54,8480023,Robert Thomas,C,STL,25,82,33,72,105
54,8478010,Brayden Point,C,TBL,28,82,53,51,104
54,8477493,Aleksander Barkov,C,FLA,29,82,31,73,104
54,8477934,Leon Draisaitl,C,EDM,29,82,34,69,103
54,8481523,Kirby Dach,C,MTL,23,82,23,79,102
54,8474564,Steven Stamkos,C,NSH,34,82,45,55,100
54,8478420,Mikko Rantanen,R,COL,28,82,36,62,98
54,8482116,Tim Stützle,C,OTT,22,82,32,66,98
54,8480027,Jason Robertson,L,DAL,25,82,34,60,94
54,8479407,Jesper Bratt,L,NJD,26,82,32,62,94
54,8476887,Filip Forsberg,L,NSH,30,82,42,50,92
54,8478403,Jack Eichel,C,VGK,28,82,38,54,92
54,8477942,Kevin Fiala,L,LAK,28,82,31,61,92
54,8478427,Sebastian Aho,C,CAR,27,82,27,64,91
54,8479323,Adam Fox,D,NYR,26,82,26,65,91
54,8480069,Cale Makar,D,COL,26,82,23,68,91
54,8477946,Dylan Larkin,C,DET,28,82,36,54,90
54,8477409,Carter Verhaeghe,C,FLA,29,82,43,45,88
54,8474600,Roman Josi,D,NSH,34,82,18,70,88
54,8477404,Jake Guentzel,C,TBL,30,82,35,52,87
54,8480801,Brady Tkachuk,L,OTT,25,82,38,47,85
54,8479343,Clayton Keller,R,UTA,26,82,38,47,85
54,8476468,J.T. Miller,C,VAN,31,82,35,50,85
54,8479337,Alex DeBrincat,R,DET,27,82,33,52,85
54,8478439,Travis Konecny,R,PHI,27,82,34,49,83
54,8481557,Matt Boldy,L,MIN,23,82,34,49,83
54,8480018,Nick Suzuki,C,MTL,25,82,25,58,83
54,8478398,Kyle Connor,L,WPG,28,82,44,38,82
54,8480002,Nico Hischier,C,NJD,25,82,31,51,82
54,8480012,Elias Pettersson,C,VAN,26,82,25,57,82
54,8475166,John Tavares,C,TOR,34,82,40,41,81
54,8477402,Pavel Buchnevich,L,STL,29,82,36,45,81
54,8476454,Ryan Nugent-Hopkins,C,EDM,31,82,21,59,80
54,8476460,Mark Scheifele,C,WPG,31,82,27,52,79
54,8476853,Morgan Rielly,D,TOR,30,82,14,65,79
54,8480800,Quinn Hughes,D,VAN,25,82,9,70,79
54,8476539,Jonathan Marchessault,R,NSH,34,82,42,36,78
54,8480830,Andrei Svechnikov,R,CAR,24,82,32,46,78
54,8476346,Johnny Gaudreau,L,CBJ,31,82,21,57,78
54,8479542,Brandon Hagel,L,TBL,26,82,39,37,76
54,8477933,Sam Reinhart,C,FLA,29,82,38,38,76
54,8475168,Matt Duchene,C,DAL,33,82,24,52,76
54,8475692,Mats Zuccarello,R,MIN,37,82,19,57,76
54,8475172,Nazem Kadri,C,CGY,34,82,29,46,75
54,8478873,Troy Terry,R,ANA,27,82,26,49,75
54,8478445,Mathew Barzal,C,NYI,27,82,16,59,75
54,8475786,Zach Hyman,L,EDM,32,82,45,29,74
54,8473512,Claude Giroux,R,OTT,36,82,30,44,74
54,8480865,Noah Dobson,D,NYI,24,82,18,56,74
54,8477501,Valeri Nichushkin,R,COL,29,82,49,24,73
54,8477476,Artturi Lehkonen,L,COL,29,82,36,37,73
54,8475810,Bryan Rust,R,PIT,32,82,34,39,73
54,8477986,Brandon Montour,D,SEA,30,82,28,45,73
54,8475158,Ryan O'Reilly,C,NSH,33,82,27,46,73
54,8476459,Mika Zibanejad,C,NYR,31,82,23,50,73
54,8482745,Mason McTavish,C,ANA,21,82,33,39,72
54,8479385,Jordan Kyrou,C,STL,26,82,30,42,72
54,8477951,Nick Schmaltz,C,UTA,28,82,27,45,72
54,8476456,Jonathan Huberdeau,C,CGY,31,82,13,59,72
54,8476881,Tomas Hertl,C,VGK,31,82,30,41,71
54,8479675,Trevor Moore,L,LAK,29,82,30,41,71
54,8471215,Evgeni Malkin,C,PIT,38,82,28,43,71
54,8479999,Casey Mittelstadt,C,COL,26,82,24,47,71
54,8477940,Nikolaj Ehlers,L,WPG,28,82,31,39,70
54,8477496,Elias Lindholm,C,BOS,30,82,29,41,70
54,8476462,Dougie Hamilton,D,NJD,31,82,24,46,70
54,8478460,Zach Werenski,D,CBJ,27,82,15,55,70
54,8480803,Evan Bouchard,D,EDM,25,82,13,57,70
54,8476432,Boone Jenner,C,CBJ,31,82,40,29,69
54,8481540,Cole Caufield,R,MTL,23,82,35,34,69
54,8476389,Vincent Trocheck,C,NYR,31,82,30,39,69
54,8480039,Martin Necas,C,CAR,25,82,28,41,69
54,8475745,Charlie Coyle,C,BOS,32,82,26,42,68
54,8473419,Brad Marchand,L,BOS,36,82,25,43,68
54,8474141,Patrick Kane,R,DET,36,82,25,43,68
54,8480839,Rasmus Dahlin,D,BUF,24,82,19,49,68
54,8475167,Victor Hedman,D,TBL,34,82,13,55,68
54,8478449,Roope Hintz,C,DAL,28,82,36,31,67
54,8482093,Seth Jarvis,C,CAR,22,82,28,39,67
54,8477960,Adrian Kempe,R,LAK,28,82,23,44,67
54,8471685,Anze Kopitar,C,LAK,37,82,21,46,67
54,8478440,Dylan Strome,C,WSH,27,82,20,47,67
54,8477504,Josh Morrissey,D,WPG,29,82,14,53,67
54,8477500,Bo Horvat,C,NYI,29,82,38,28,66
54,8478414,Timo Meier,R,NJD,28,82,28,38,66
54,8478047,Michael Bunting,L,PIT,29,82,27,39,66
54,8473994,Jamie Benn,L,DAL,35,82,25,41,66
54,8475913,Mark Stone,R,VGK,32,82,22,44,66
54,8476875,Mike Matheson,D,MTL,30,82,22,44,66
54,8481542,Moritz Seider,D,DET,23,82,20,46,66
54,8480208,Drake Batherson,R,OTT,26,82,31,34,65
54,8471214,Alex Ovechkin,L,WSH,39,82,28,37,65
54,8479420,Tage Thompson,C,BUF,27,82,38,26,64
54,8478493,Joel Eriksson Ek,C,MIN,27,82,30,34,64
54,8478366,Frank Vatrano,R,ANA,30,82,33,30,63
54,8483808,Andrei Kuzmenko,L,CGY,28,82,28,35,63
54,8475754,Brock Nelson,C,NYI,33,82,23,40,63
54,8482665,Matty Beniers,C,SEA,22,82,23,40,63
54,8478401,Pavel Zacha,C,BOS,27,82,27,35,62
54,8476905,Chandler Stephenson,C,SEA,30,82,18,44,62
54,8478397,Rasmus Andersson,D,CGY,28,82,13,49,62
54,8477949,Alex Tuch,R,BUF,28,82,25,36,61
54,8478042,Viktor Arvidsson,R,EDM,31,82,28,32,60
54,8474679,Gustav Nyquist,C,NSH,35,82,27,33,60
54,8478438,Tommy Novak,C,NSH,27,82,21,39,60
54,8474590,John Carlson,D,WSH,34,82,16,44,60
54,8480036,Miro Heiskanen,D,DAL,25,82,15,45,60
54,8475784,Jeff Skinner,C,EDM,32,82,28,31,59
54,8482667,William Eklund,L,SJS,22,82,25,34,59
54,8475170,Brayden Schenn,C,STL,33,82,23,36,59
54,8474102,David Perron,L,OTT,36,82,23,36,59
54,8475798,Mikael Granlund,C,SJS,32,82,16,43,59
54,8475184,Chris Kreider,L,NYR,33,82,40,18,58
54,8481068,Yegor Sharangovich,C,CGY,26,82,32,26,58
54,8475726,Tyler Toffoli,C,SJS,32,82,27,31,58
54,8475765,Vladimir Tarasenko,R,DET,33,82,24,34,58
54,8477494,Jonathan Drouin,L,COL,29,82,20,38,58
54,8476880,Tom Wilson,R,WSH,30,82,27,30,57
54,8477456,J.T. Compher,L,DET,29,82,26,31,57
54,8478444,Brock Boeser,R,VAN,27,82,24,33,57
54,8482078,Lucas Raymond,L,DET,22,82,24,33,57
54,8477955,Jared McCann,L,SEA,28,82,24,33,57
54,8476448,William Karlsson,C,VGK,31,82,22,35,57
54,8475191,Reilly Smith,R,NYR,33,82,21,36,57
54,8480078,Filip Chytil,C,NYR,25,82,18,39,57
54,8477935,Sam Bennett,C,FLA,28,82,30,26,56
54,8477416,Oliver Bjorkstrand,R,SEA,29,82,23,33,56
54,8477497,Sean Monahan,C,CBJ,30,82,22,34,56
54,8478856,Conor Garland,R,VAN,28,82,19,37,56
54,8477503,Max Domi,C,TOR,29,82,16,40,56
54,8477932,Aaron Ekblad,D,FLA,28,82,16,40,56
54,8482684,Luke Hughes,D,NJD,21,82,15,41,56
54,8479410,Mikhail Sergachev,D,UTA,26,82,14,42,56
54,8479425,Filip Hronek,D,VAN,27,82,13,43,56
54,8476483,Rickard Rakell,R,PIT,31,82,29,26,55
54,8475151,Kyle Palmieri,C,NYI,33,82,29,26,55
54,8482740,Wyatt Johnston,C,DAL,21,82,28,27,55
54,8480028,Morgan Frost,C,PHI,25,82,18,37,55
54,8481711,Matias Maccelli,L,UTA,24,82,15,40,55
54,8476906,Shayne Gostisbehere,D,CAR,31,82,14,41,55
54,8478407,Vince Dunn,D,SEA,28,82,10,45,55
54,8474578,Erik Karlsson,D,PIT,34,82,9,46,55
54,8480798,Philipp Kurashev,C,CHI,25,82,19,35,54
54,8478038,Devon Toews,D,COL,30,82,17,37,54
54,8477346,MacKenzie Weegar,D,CGY,30,82,17,37,54
54,8480015,Owen Tippett,R,PHI,25,82,28,25,53
54,8482109,Alexis Lafrenière,L,NYR,23,82,27,26,53
54,8482159,Tyson Foerster,R,PHI,22,82,25,28,53
54,8481528,Dylan Cozens,C,BUF,23,82,20,33,53
54,8478975,Mason Marchment,L,DAL,29,82,19,34,53
54,8481533,Trevor Zegras,C,ANA,23,82,19,34,53
54,8480188,Fabian Zetterlund,L,SJS,25,82,16,37,53
54,8476399,Blake Coleman,C,CGY,33,82,35,17,52
54,8477964,Ivan Barbashev,C,VGK,29,82,26,26,52
54,8476885,Jacob Trouba,D,NYR,30,82,18,34,52
54,8477021,Alex Kerfoot,C,UTA,30,82,15,37,52
54,8479325,Charlie McAvoy,D,BOS,27,82,13,39,52
54,8471724,Kris Letang,D,PIT,37,82,9,43,52
54,8477407,Anthony Duclair,L,NYI,29,82,29,22,51
54,8479987,Morgan Geekie,C,BOS,26,82,23,28,51
54,8481596,Shane Pinto,C,OTT,24,82,23,28,51
54,8477987,Ryan Donato,C,CHI,28,82,23,28,51
54,8475794,Tyler Seguin,C,DAL,32,82,21,30,51
54,8482097,Jack Quinn,R,BUF,23,82,20,31,51
54,8470613,Brent Burns,D,CAR,39,82,14,37,51
54,8480434,Sean Durzi,D,UTA,26,82,11,40,51
54,8477447,Shea Theodore,D,VGK,29,82,8,43,51
54,8471698,T.J. Oshie,R,WSH,38,82,27,23,50
54,8478519,Anthony Cirelli,C,TBL,27,82,18,32,50
54,8475287,Erik Haula,L,NJD,33,82,16,34,50
54,8474563,Drew Doughty,D,LAK,35,82,14,36,50
54,8478396,Noah Hanifin,D,VGK,27,82,13,37,50
54,8475314,Anders Lee,L,NYI,34,82,33,16,49
54,8479525,Ross Colton,C,COL,28,82,21,28,49
54,8477479,Tyler Bertuzzi,L,CHI,29,82,21,28,49
54,8478463,Anthony Beauvillier,L,PIT,27,82,26,22,48
54,8474053,Logan Couture,C,SJS,35,82,22,26,48
54,8479400,Pierre-Luc Dubois,L,WSH,26,82,21,27,48
54,8480829,Jesperi Kotkaniemi,C,CAR,24,82,21,27,48
54,8482124,Quinton Byfield,R,LAK,22,82,20,28,48
54,8478469,Thomas Chabot,D,OTT,27,82,12,36,48
54,8476958,Jaccob Slavin,D,CAR,30,82,8,40,48
54,8475169,Evander Kane,L,EDM,33,82,24,23,47
54,8482149,Cole Perfetti,C,WPG,22,82,23,24,47
54,8473986,Alex Killorn,L,ANA,35,82,22,25,47
54,8480009,Eeli Tolvanen,R,SEA,25,82,21,26,47
54,8482720,Matthew Knies,L,TOR,22,82,18,29,47
54,8478542,Evan Rodrigues,C,FLA,31,82,17,30,47
54,8477919,Frederick Gaudreau,C,MIN,31,82,15,32,47
54,8476882,Teuvo Teravainen,L,CHI,30,82,14,33,47
54,8475753,Justin Faulk,D,STL,32,82,13,34,47
54,8477495,Seth Jones,D,CHI,30,82,9,38,47
54,8482699,Dylan Guenther,R,UTA,21,82,26,20,46
54,8482110,Dawson Mercer,C,NJD,23,82,24,22,46
54,8477451,Ryan Hartman,R,MIN,30,82,23,23,46
54,8473422,Nick Foligno,L,CHI,37,82,23,23,46
54,8474641,Adam Henrique,C,EDM,34,82,19,27,46
54,8474150,Mikael Backlund,C,CGY,35,82,15,31,46
54,8477429,Andrew Copp,C,DET,30,82,14,32,46
54,8476461,Sean Couturier,C,PHI,32,82,13,33,46
54,8478472,Mathieu Joseph,R,STL,27,82,13,33,46
54,8480064,Josh Norris,C,OTT,25,82,26,19,45
54,8482113,Anton Lundell,C,FLA,23,82,22,23,45
54,8478233,Andrew Mangiapane,L,WSH,28,82,21,24,45
54,8481554,Kaapo Kakko,R,NYR,23,82,21,24,45
54,8478458,Jack Roslovic,C,CAR,27,82,19,26,45
54,8476792,Torey Krug,D,STL,33,82,18,27,45
54,8476872,Scott Laughton,C,PHI,30,82,17,28,45
54,8479365,Trent Frederic,C,BOS,26,82,10,35,45
54,8476892,Colton Parayko,D,STL,31,82,8,37,45
54,8478498,Jake DeBrusk,L,VAN,28,82,27,17,44
54,8481618,Alex Newhook,C,MTL,23,82,25,19,44
54,8480014,Gabriel Vilardi,C,WPG,25,82,24,20,44
54,8476474,Stefan Noesen,R,NJD,31,82,22,22,44
54,8476438,Brandon Saad,L,STL,32,82,21,23,44
54,8479992,Michael Rasmussen,C,DET,25,82,20,24,44
54,8474586,Jordan Eberle,R,SEA,34,82,19,25,44
54,8477998,Warren Foegele,L,LAK,28,82,18,26,44
54,8476854,Hampus Lindholm,D,BOS,30,82,12,32,44
54,8478474,Lawson Crouse,L,UTA,27,82,23,20,43
54,8475793,Ryan Johansen,C,PHI,32,82,23,20,43
54,8477426,Nicholas Paul,L,TBL,29,82,21,22,43
54,8476826,Yanni Gourde,C,SEA,33,82,19,24,43
54,8477953,Kasperi Kapanen,R,STL,28,82,19,24,43
54,8479339,Patrik Laine,L,CBJ,26,82,17,26,43
54,8478462,Nicolas Roy,C,VGK,27,82,15,28,43
54,8476278,Colin Blackwell,C,DAL,31,82,14,29,43
54,8476869,Brady Skjei,D,NSH,30,82,13,30,43
54,8479345,Jakob Chychrun,D,WSH,26,82,12,31,43
54,8481581,Thomas Harley,D,DAL,23,82,7,36,43
54,8476979,Erik Gustafsson,D,DET,32,82,7,36,43
54,8478055,Gustav Forsling,D,FLA,28,82,5,38,43
54,8477511,Anthony Mantha,R,CGY,30,82,26,16,42
54,8482079,Marco Rossi,C,MIN,23,82,19,23,42
54,8482117,Lukas Reichel,L,CHI,22,82,15,27,42
54,8480817,K'Andre Miller,D,NYR,24,82,12,30,42
54,8474565,Alex Pietrangelo,D,VGK,34,82,11,31,42
54,8482671,Owen Power,D,BUF,22,82,8,34,42
54,8478020,Michael Amadio,C,OTT,28,82,23,18,41
54,8478891,Mason Appleton,C,WPG,28,82,21,20,41
54,8475799,Nino Niederreiter,R,WPG,32,82,19,22,41
54,8475714,Calle Jarnkrok,C,TOR,33,82,17,24,41
54,8477948,Travis Sanheim,D,PHI,28,82,12,29,41
54,8482105,Jake Sanderson,D,OTT,22,82,11,30,41
54,8480873,Rasmus Sandin,D,WSH,24,82,5,36,41
54,8480043,Timothy Liljegren,D,TOR,25,82,2,39,41
54,8482175,JJ Peterka,R,BUF,22,82,23,17,40
54,8478115,Pierre Engvall,L,NYI,28,82,18,22,40
54,8478046,Danton Heinen,L,VAN,29,82,17,23,40
54,8475768,Jaden Schwartz,C,SEA,32,82,16,24,40
54,8482146,Luke Evangelista,R,NSH,22,82,16,24,40
54,8475218,Mattias Ekholm,D,EDM,34,82,14,26,40
54,8478133,Jake Evans,C,MTL,28,82,13,27,40
54,8476329,Travis Boyd,C,MIN,31,82,11,29,40
54,8481546,Cam York,D,PHI,23,82,7,33,40
54,8475760,Nick Bjugstad,C,UTA,32,82,21,18,39
54,8481560,Arthur Kaliyev,R,LAK,23,82,20,19,39
54,8484144,Connor Bedard,C,CHI,19,82,19,20,39
54,8480068,Ryan Poehling,C,PHI,25,82,19,20,39
54,8482705,Cole Sillinger,C,CBJ,21,82,13,26,39
54,8476419,Jean-Gabriel Pageau,C,NYI,32,82,11,28,39
54,8481093,Rafael Harvey-Pinard,L,MTL,25,82,23,15,38
54,8481604,Pavel Dorofeyev,L,VGK,24,82,21,17,38
54,8479353,Brett Howden,C,VGK,26,82,19,19,38
54,8477952,Robby Fabbri,C,ANA,28,82,18,20,38
54,8474149,Evgenii Dadonov,R,DAL,35,82,17,21,38
54,8479996,Cody Glass,C,NSH,25,82,17,21,38
54,8476292,Ondrej Palat,L,NJD,33,82,15,23,38
54,8475848,Brendan Gallagher,R,MTL,32,82,21,16,37
54,8473533,Jordan Staal,C,CAR,36,82,19,18,37
54,8475220,Marcus Foligno,L,MIN,33,82,19,18,37
54,8479390,Taylor Raddysh,R,WSH,26,82,18,19,37
54,8475763,Kevin Hayes,R,PIT,32,82,16,21,37
54,8480797,Joel Farabee,L,PHI,24,82,15,22,37
54,8480835,Jack Drury,C,CAR,24,82,15,22,37
54,8476458,Ryan Strome,C,ANA,31,82,14,23,37
54,8475722,Jason Zucker,L,BUF,32,82,13,24,37
54,8476925,Colton Sissons,C,NSH,31,82,13,24,37
54,8481186,Logan O'Connor,R,COL,28,82,12,25,37
54,8477488,Brett Pesce,D,NJD,30,82,8,29,37
54,8474716,Jared Spurgeon,D,MIN,35,82,8,29,37
54,8482125,Alexander Holtz,R,VGK,22,82,22,14,36
54,8482055,Drew O'Connor,L,PIT,26,82,21,15,36
54,8480185,Eetu Luostarinen,C,FLA,26,82,11,25,36
54,8476624,Barclay Goodrow,C,SJS,31,82,11,25,36
54,8482087,Kaiden Guhle,D,MTL,22,82,7,29,36
54,8478057,Dakota Joshua,C,VAN,28,82,22,13,35
54,8482089,Jake Neighbours,L,STL,22,82,21,14,35
54,8476981,Josh Anderson,R,MTL,30,82,21,14,35
54,8476921,Jordan Martinook,L,CAR,32,82,19,16,35
54,8477947,Sonny Milano,L,WSH,28,82,16,19,35
54,8481656,Aliaksei Protas,C,WSH,23,82,15,20,35
54,8476889,Radek Faksa,C,STL,30,82,14,21,35
54,8480802,Ryan McLeod,C,BUF,25,82,13,22,35
54,8477498,Darnell Nurse,D,EDM,29,82,5,30,35
54,8480789,Oliver Wahlstrom,R,NYI,24,82,15,19,34
54,8479591,Michael Eyssimont,C,TBL,28,82,14,20,34
54,8480448,Parker Kelly,L,COL,25,82,14,20,34
54,8475791,Taylor Hall,L,CHI,33,82,13,21,34
54,8480893,Kirill Marchenko,R,CBJ,24,82,23,10,33
54,8480849,Barrett Hayton,C,UTA,24,82,18,15,33
54,8481535,Nils Hoglander,L,VAN,24,82,18,15,33
54,8476469,Joel Armia,R,MTL,31,82,18,15,33
54,8480459,Pius Suter,C,VAN,28,82,16,17,33
54,8475343,Nic Dowd,C,WSH,34,82,16,17,33
54,8478013,Jake Walman,D,SJS,28,82,14,19,33
54,8482133,Thomas Bordeleau,C,SJS,22,82,14,19,33
54,8476479,Phillip Danault,C,LAK,31,82,12,21,33
54,8481580,Connor McMichael,C,WSH,23,82,12,21,33
54,8484203,Bradly Nadeau,L,CAR,19,82,11,22,33
54,8477989,Christian Dvorak,C,MTL,28,82,8,25,33
54,8482092,Ridly Greig,C,OTT,22,82,7,26,33
54,8475764,Cam Fowler,D,ANA,33,82,7,26,33
54,8481178,Egor Zamula,D,PHI,24,82,4,29,33
54,8480003,Jesper Boqvist,C,FLA,26,82,19,13,32
54,8480220,Noah Cates,L,PHI,25,82,15,17,32
54,8476960,Andreas Athanasiou,C,CHI,30,82,15,17,32
54,8483515,Juraj Slafkovsky,L,MTL,20,82,15,17,32
54,8478413,Jordan Greenway,L,BUF,27,82,15,17,32
54,8482660,Kent Johnson,C,CBJ,22,82,11,21,32
54,8476392,Adam Lowry,C,WPG,31,82,11,21,32
54,8476927,Teddy Blueger,C,VAN,30,82,10,22,32
54,8482111,Justin Barron,D,MTL,23,82,10,22,32
54,8482122,Brock Faber,D,MIN,22,82,9,23,32
54,8477969,Marcus Pettersson,D,PIT,28,82,8,24,32
54,8476457,Adam Larsson,D,SEA,32,82,7,25,32
54,8480871,Adam Boqvist,D,FLA,24,82,6,26,32
54,8482655,J.J. Moser,D,TBL,24,82,6,26,32
54,8476463,Jonas Brodin,D,MIN,31,82,4,28,32
54,8477506,Ryan Pulock,D,NYI,30,82,3,29,32
54,8481032,Paul Cotter,C,NJD,25,82,18,13,31
54,8478109,Victor Olofsson,L,VGK,29,82,16,15,31
54,8481013,Jonatan Berggren,R,DET,24,82,16,15,31
54,8480748,Kiefer Sherwood,L,VAN,29,82,14,17,31
54,8479351,Sam Steel,C,DAL,26,82,14,17,31
54,8476923,Damon Severson,D,CBJ,30,82,13,18,31
54,8480813,Joe Veleno,C,DET,24,82,12,19,31
54,8475200,Dmitry Orlov,D,CAR,33,82,12,19,31
54,8475149,Marcus Johansson,L,MIN,34,82,11,20,31
54,8476480,Vladislav Namestnikov,C,WPG,32,82,9,22,31
54,8481704,Juuso Parssinen,C,NSH,23,82,8,23,31
54,8482142,Jamie Drysdale,D,PHI,22,82,7,24,31
54,8477220,Nate Schmidt,D,FLA,33,82,4,27,31
54,8478569,Noel Acciari,C,PIT,33,82,20,10,30
54,8481624,Ilya Mikheyev,R,CHI,30,82,16,14,30
54,8476918,Jimmy Vesey,L,NYR,31,82,15,15,30
54,8477444,Andre Burakovsky,L,SEA,29,82,14,16,30
54,8475193,Tomas Tatar,L,NJD,34,82,13,17,30
54,8480074,Alexandre Texier,C,STL,25,82,11,19,30
54,8470621,Corey Perry,R,EDM,39,82,10,20,30
54,8480113,Alex Iafallo,L,WPG,31,82,10,20,30
54,8478432,Christian Fischer,R,DET,27,82,9,21,30
54,8479398,Samuel Girard,D,COL,26,82,3,27,30
54,8479402,Jake Bean,D,CGY,26,82,3,27,30
54,8476931,Jake McCabe,D,TOR,31,82,2,28,30
54,8479941,Justin Danforth,R,CBJ,31,82,13,16,29
54,8480855,Jack McBain,C,UTA,24,82,11,18,29
54,8482624,Daniil Miromanov,D,CGY,27,82,9,20,29
54,8480336,Sean Walker,D,CAR,30,82,9,20,29
54,8481582,Nicholas Robertson,L,TOR,23,82,15,13,28
54,8483431,Logan Cooley,C,UTA,20,82,13,15,28
54,8481481,Blake Lizotte,C,PIT,27,82,12,16,28
54,8479661,Tanner Jeannot,L,LAK,27,82,12,16,28
54,8476897,Oskar Sundqvist,C,STL,30,82,10,18,28
54,8477015,Connor Brown,R,EDM,30,82,10,18,28
54,8477839,Conor Sheary,L,TBL,32,82,10,18,28
54,8473563,Nicklas Backstrom,C,WSH,37,82,7,21,28
54,8477507,Nikita Zadorov,D,BOS,29,82,6,22,28
54,8474673,TJ Brodie,D,CHI,34,82,5,23,28
54,8474151,Ryan McDonagh,D,TBL,35,82,4,24,28
54,8481014,Alexander Romanov,D,NYI,24,82,4,24,28
54,8475188,Brayden McNabb,D,VGK,33,82,3,25,28
54,8474715,Cam Atkinson,R,TBL,35,82,14,13,27
54,8480878,Nils Lundkvist,D,DAL,24,82,11,16,27
54,8479393,Noah Gregor,C,OTT,26,82,11,16,27
54,8476467,Jamie Oleksiak,D,SEA,32,82,10,17,27
54,8479976,Juuso Valimaki,D,UTA,26,82,6,21,27
54,8477365,Connor Clifton,D,BUF,29,82,6,21,27
54,8478399,Jonas Siegenthaler,D,NJD,27,82,6,21,27
54,8482166,Shakir Mukhamadullin,D,SJS,22,82,5,22,27
54,8483457,Lane Hutson,D,MTL,20,82,5,22,27
54,8480145,Neal Pionk,D,WPG,29,82,4,23,27
54,8477931,Tomas Nosek,L,FLA,32,82,13,13,26
54,8482762,Simon Edvinsson,D,DET,21,82,12,14,26
54,8482074,Connor Zary,C,CGY,23,82,11,15,26
54,8478911,Matt Roy,D,WSH,29,82,8,18,26
54,8481708,Zac Jones,D,NYR,24,82,6,20,26
54,8473507,Jeff Petry,D,DET,37,82,5,21,26
54,8474574,Tyler Myers,D,VAN,34,82,4,22,26
54,8478178,Darren Raddysh,D,TBL,28,82,4,22,26
54,8482245,Artem Zub,D,OTT,29,82,3,23,26
54,8482073,Braden Schneider,D,NYR,23,82,3,23,26
54,8476891,Matt Grzelcyk,D,PIT,30,82,2,24,26
54,8482475,Yegor Chinakhov,R,CBJ,23,82,19,6,25
54,8473453,Trevor Lewis,C,LAK,37,82,14,11,25
54,8479293,Brandon Tanev,L,SEA,33,82,13,12,25
54,8481477,Nico Sturm,C,SJS,29,82,13,12,25
54,8481553,Bobby Brink,R,PHI,23,82,10,15,25
54,8482141,Lukas Cormier,D,VGK,22,82,10,15,25
54,8476902,Esa Lindell,D,DAL,30,82,9,16,25
54,8480144,David Kampf,C,TOR,29,82,7,18,25
54,8479983,Mario Ferraro,D,SJS,26,82,7,18,25
54,8482101,Danil Gushchin,L,SJS,22,82,7,18,25
54,8477508,Curtis Lazar,C,NJD,29,82,7,18,25
54,8481606,Jordan Spence,D,LAK,23,82,6,19,25
54,8476873,Mark Jankowski,C,NSH,30,82,5,20,25
54,8479324,Ryan Lindgren,D,NYR,26,82,2,23,25
54,8470600,Ryan Suter,D,STL,39,82,2,23,25
54,8476878,Zemgus Girgensons,L,TBL,30,82,16,8,24
54,8482666,Scott Morrow,D,CAR,22,82,9,15,24
54,8476331,Dylan DeMelo,D,WPG,31,82,1,23,24
54,8480281,Alexey Toropchenko,R,STL,25,82,16,7,23
54,8477425,Miles Wood,L,COL,29,82,13,10,23
54,8480806,Isac Lundestrom,C,ANA,25,82,11,12,23
54,8481601,Simon Holmstrom,R,NYI,23,82,10,13,23
54,8477450,Jason Dickinson,C,CHI,29,82,9,14,23
54,8479414,Nathan Bastian,R,NJD,27,82,9,14,23
54,8481567,Henry Thrun,D,SJS,23,82,9,14,23
54,8476374,Sean Kuraly,C,CBJ,31,82,8,15,23
54,8479998,Mikey Anderson,D,LAK,25,82,6,17,23
54,8481568,Alex Vlasic,D,CHI,23,82,4,19,23
54,8483490,Pavel Mintyukov,D,ANA,21,82,4,19,23
54,8476879,Cody Ceci,D,EDM,31,82,3,20,23
54,8476917,Adam Pelech,D,NYI,30,82,0,23,23
54,8479316,Luke Kunin,C,SJS,27,82,12,10,22
54,8475171,Oliver Ekman-Larsson,D,TOR,33,82,7,15,22
54,8478851,Alexandre Carrier,D,NSH,28,82,7,15,22
54,8480980,Connor Dewar,C,TOR,25,82,7,15,22
54,8475279,Ben Chiarot,D,DET,33,82,6,16,22
54,8480073,Erik Brannstrom,D,COL,25,82,6,16,22
54,8474189,Lars Eller,C,PIT,35,82,5,17,22
54,8479980,Nicolas Hague,D,VGK,26,82,5,17,22
54,8479369,Andrew Peeke,D,BOS,26,82,5,17,22
54,8475455,Brenden Dillon,D,NJD,34,82,5,17,22
54,8480246,Nick Perbix,D,TBL,26,82,3,19,22
54,8475690,Chris Tanev,D,TOR,35,82,3,19,22
54,8475324,Nick Jensen,D,OTT,34,82,3,19,22
54,8476429,Scott Mayfield,D,NYI,32,82,2,20,22
54,8478507,John Marino,D,UTA,27,82,1,21,22
54,8475181,Nick Leddy,D,STL,33,82,1,21,22
54,8477406,Mattias Janmark,C,EDM,32,82,16,5,21
54,8483524,Shane Wright,C,SEA,20,82,12,9,21
54,8478434,Keegan Kolesar,R,VGK,27,82,11,10,21
54,8482259,Bobby McMann,C,TOR,28,82,11,10,21
54,8481028,Martin Pospisil,C,CGY,25,82,10,11,21
54,8479359,Beck Malenstyn,L,BUF,26,82,9,12,21
54,8482702,Logan Stankoven,C,DAL,21,82,9,12,21
54,8484153,Leo Carlsson,C,ANA,20,82,8,13,21
54,8475855,Jesper Fast,R,CAR,33,82,8,13,21
54,8474567,Zach Bogosian,D,MIN,34,82,8,13,21
54,8476312,Josh Manson,D,COL,33,82,7,14,21
54,8481522,Peyton Krebs,C,BUF,23,82,5,16,21
54,8477435,Ryan Graves,D,PIT,29,82,2,19,21
54,8482803,Olen Zellweger,D,ANA,21,82,1,20,21
54,8479371,Dante Fabbro,D,NSH,26,82,1,20,21
54,8480860,Kevin Bahl,D,CGY,24,82,1,20,21
54,8483505,Matthew Poitras,C,BOS,20,82,13,7,20
54,8478508,Yakov Trenin,C,MIN,27,82,12,8,20
54,8481517,Brett Leason,R,ANA,25,82,11,9,20
54,8482807,Ethan Del Mastro,D,CHI,21,82,10,10,20
54,8475842,Sam Carrick,C,NYR,32,82,8,12,20
54,8480796,Martin Fehervary,D,WSH,25,82,5,15,20
54,8480879,Jacob Bernard-Docker,D,OTT,24,82,5,15,20
54,8482733,Logan Mailloux,D,MTL,31,82,4,16,20
54,8476525,Colin Miller,D,WPG,32,82,4,16,20
54,8475462,Radko Gudas,D,ANA,34,82,4,16,20
54,8478840,Will Borgen,D,SEA,28,82,4,16,20
54,8480049,Dylan Samberg,D,WPG,25,82,3,17,20
54,8478500,Ivan Provorov,D,CBJ,27,82,2,18,20
54,8479368,Max Jones,L,BOS,26,82,11,8,19
54,8482809,Jackson Blake,R,CAR,21,82,11,8,19
54,8476442,Matt Nieto,L,PIT,32,82,11,8,19
54,8482062,Cole Smith,L,NSH,29,82,10,9,19
54,8484911,Collin Graf,R,SJS,22,82,9,10,19
54,8479291,Kevin Rooney,C,CGY,31,82,9,10,19
54,8476822,Luke Glendening,C,TBL,35,82,9,10,19
54,8484145,Zach Benson,L,BUF,19,82,6,13,19
54,8477353,Tyler Motte,C,DET,29,82,6,13,19
54,8480172,Jan Rutta,D,SJS,34,82,2,17,19
54,8480990,Declan Chisholm,D,MIN,24,82,1,18,19
54,8476858,Phillip Di Giuseppe,L,VAN,31,82,12,6,18
54,8478211,Dryden Hunt,L,CGY,29,82,11,7,18
54,8477392,Hudson Fasching,R,NYI,29,82,11,7,18
54,8484166,Adam Fantilli,C,CBJ,20,82,8,10,18
54,8480021,Jack Studnicka,C,LAK,25,82,7,11,18
54,8484149,Gavin Brindley,C,CBJ,20,82,7,11,18
54,8482659,Josh Doan,R,UTA,22,82,6,12,18
54,8483565,Nick Blankenburg,D,NSH,26,82,5,13,18
54,8477369,Carson Soucy,D,VAN,30,82,4,14,18
54,8478882,Vladislav Gavrikov,D,LAK,29,82,3,15,18
54,8475177,Calvin de Haan,D,COL,33,82,3,15,18
54,8480995,Pontus Holmberg,R,TOR,25,82,10,7,17
54,8482749,Joshua Roy,R,MTL,21,82,6,11,17
54,8478859,Niko Mikkola,D,FLA,28,82,4,13,17
54,8478416,Erik Cernak,D,TBL,27,82,3,14,17
54,8482155,Alex Laferriere,R,LAK,23,82,10,6,16
54,8483468,Jiri Kulich,C,BUF,20,82,9,7,16
54,8483482,Tristan Luneau,D,ANA,20,82,8,8,16
54,8482516,Matthew Kessel,D,STL,24,82,7,9,16
54,8474090,Brendan Smith,D,DAL,35,82,6,10,16
54,8477938,Haydn Fleury,D,WPG,28,82,6,10,16
54,8483763,Maksymilian Szuber,D,UTA,22,82,6,10,16
54,8483489,Fraser Minten,C,TOR,31,82,6,10,16
54,8474612,Travis Hamonic,D,OTT,34,82,5,11,16
54,8476441,Joel Edmundson,D,LAK,31,82,4,12,16
54,8477499,Rasmus Ristolainen,D,PHI,30,82,4,12,16
54,8483460,David Jiricek,D,CBJ,21,82,3,13,16
54,8477505,Alexander Wennberg,C,SJS,30,82,9,6,15
54,8475231,Casey Cizikas,C,NYI,33,82,8,7,15
54,8481524,Bowen Byram,D,BUF,23,82,5,10,15
54,8483493,Frank Nazar,C,CHI,20,82,5,10,15
54,8480834,Ty Emberson,D,SJS,24,82,4,11,15
54,8478136,Jake Middleton,D,MIN,28,82,4,11,15
54,8483499,Liam Ohgren,L,MIN,20,82,4,11,15
54,8480025,MacKenzie Entwistle,R,FLA,25,82,3,12,15
54,8475718,Justin Holl,D,DET,32,82,3,12,15
54,8480950,Ilya Lyubushkin,D,DAL,30,82,3,12,15
54,8480035,Henri Jokiharju,D,BUF,25,82,2,13,15
54,8476422,Mike Reilly,D,NYI,31,82,1,14,15
54,8475790,Erik Gudbranson,D,CBJ,32,82,1,14,15
54,8483397,Marc McLaughlin,C,BOS,25,82,8,6,14
54,8482077,Dylan Holloway,L,EDM,23,82,7,7,14
54,8482679,Matt Coronato,R,CGY,22,82,5,9,14
54,8474013,Ian Cole,D,UTA,35,82,5,9,14
54,8478450,Parker Wotherspoon,D,BOS,27,82,4,10,14
54,8480222,Sebastian Aho,D,PIT,28,82,2,12,14
54,8478443,Brandon Carlo,D,BOS,28,82,1,13,14
54,8477845,Trevor van Riemsdyk,D,WSH,33,82,1,13,14
54,8475233,David Savard,D,MTL,34,82,0,14,14
54,8479442,Troy Stecher,D,EDM,30,82,6,7,13
54,8477903,Garnet Hathaway,R,PHI,33,82,5,8,13
54,8480870,Bo Groulx,C,NYR,24,82,5,8,13
54,8483445,Cutter Gauthier,L,ANA,20,82,4,9,13
54,8477034,Jaycob Megna,D,FLA,32,82,4,9,13
54,8481641,Joel Kiviranta,L,COL,28,82,4,9,13
54,8482145,Mavrik Bourque,C,DAL,22,82,4,9,13
54,8475762,Derek Forbort,D,VAN,32,82,3,10,13
54,8482858,Ryker Evans,D,SEA,23,82,3,10,13
54,8483567,Georgii Merkulov,C,BOS,24,82,3,10,13
54,8476967,Brett Kulak,D,EDM,30,82,2,11,13
54,8481699,Aku Raty,R,UTA,23,82,2,11,13
54,8481605,Jackson LaCombe,D,ANA,23,82,1,12,13
54,8476473,Connor Murphy,D,CHI,31,82,6,6,12
54,8482787,Nikita Chibrikov,R,WPG,31,82,5,7,12
54,8483012,Logan Morrison,C,SEA,22,82,4,8,12
54,8482070,Mitchell Chaffee,R,TBL,26,82,4,8,12
54,8483471,Brad Lambert,C,WPG,31,82,4,8,12
54,8482470,Ilya Solovyov,D,CGY,24,82,3,9,12
54,8478874,Adam Gaudette,C,OTT,28,82,2,10,12
54,8482712,Oskar Olausson,R,COL,22,82,5,6,11
54,8483495,Simon Nemec,D,NJD,20,82,4,7,11
54,8482713,Mackie Samoskevich,R,FLA,22,82,4,7,11
54,8483466,Kevin Korchinski,D,CHI,20,82,2,9,11
54,8479576,Vincent Desharnais,D,VAN,28,82,2,9,11
54,8471677,Jack Johnson,D,CBJ,37,82,0,11,11
54,8482118,Sam Colangelo,R,ANA,23,82,4,6,10
54,8479638,Justin Brazeau,R,BOS,26,82,3,7,10
54,8480807,Mattias Samuelsson,D,BUF,24,82,2,8,10
54,8476372,Nick Seeler,D,PHI,31,82,0,10,10
54,8478468,Jeremy Lauzon,D,NSH,27,82,2,7,9
54,8481122,Simon Benoit,D,TOR,26,82,3,5,8
54,8477335,Kyle Burroughs,D,LAK,29,82,3,5,8
54,8482859,Zack Ostapchuk,C,OTT,21,82,2,6,8
54,8482153,Brendan Brisson,C,VGK,23,82,0,7,7
54,8474062,Riley Nash,C,NYR,35,82,0,3,3
54,8470794,Joe Pavelski,C,,40,0,0,0,0
54,8481703,Valtteri Puustinen,R,PIT,25,0,0,0,0
54,8477950,Tony DeAngelo,D,,29,0,0,0,0
54,8481577,Philip Tomasino,C,NSH,23,0,0,0,0
54,8475197,Tyson Barrie,D,,33,0,0,0,0
54,8471218,Blake Wheeler,R,,38,0,0,0,0
54,8474157,Max Pacioretty,L,,36,0,0,0,0
54,8478466,Daniel Sprong,R,VAN,27,0,0,0,0
54,8475744,Evgeny Kuznetsov,C,,32,0,0,0,0
54,8481019,David Gustafsson,C,WPG,24,0,0,0,0
54,8475906,John Klingberg,D,,32,0,0,0,0
54,8479348,Kale Clague,D,BUF,26,0,0,0,0
54,8476952,Dominic Toninato,C,WPG,30,0,0,0,0
54,8473473,Milan Lucic,L,,36,0,0,0,0
54,8474037,James van Riemsdyk,L,,35,0,0,0,0
54,8474602,Justin Schultz,D,,34,0,0,0,0
54,8482222,Alexander Barabanov,L,,30,0,0,0,0
54,8479372,Josh Mahura,D,SEA,26,0,0,0,0
54,8479982,Conor Timmins,D,TOR,26,0,0,0,0
54,8474031,Kevin Shattenkirk,D,,35,0,0,0,0
54,8480008,Adam Ruzicka,C,,25,0,0,0,0
54,8481059,Scott Perunovich,D,STL,26,0,0,0,0
54,8480884,Calen Addison,D,,24,0,0,0,0
54,8476994,Vinnie Hinostroza,C,NSH,30,0,0,0,0
54,8478452,Caleb Jones,D,LAK,27,0,0,0,0
54,8480157,Calle Rosen,D,COL,30,0,0,0,0
54,8481609,Vladislav Kolyachonok,D,UTA,23,0,0,0,0
54,8479415,Michael McLeod,C,,26,0,0,0,0
54,8476919,Chris Tierney,C,,30,0,0,0,0
54,8479639,Dylan Coghlan,D,WPG,26,0,0,0,0
54,8478146,Matthew Highmore,C,OTT,28,0,0,0,0
54,8478970,Jalen Chatfield,D,CAR,28,0,0,0,0
54,8480205,Emil Bemstrom,C,PIT,25,0,0,0,0
54,8474884,Mike Hoffman,C,,35,0,0,0,0
54,8471274,Alex Goligoski,D,,39,0,0,0,0
54,8478104,Sammy Blais,L,,28,0,0,0,0
54,8474870,Tyler Johnson,C,,34,0,0,0,0
54,8476913,Devin Shore,C,MIN,30,0,0,0,0
54,8481598,Philip Broberg,D,EDM,23,0,0,0,0
54,8480058,Pierre-Olivier Joseph,D,STL,25,0,0,0,0
54,8480891,Michael Kesselring,D,UTA,24,0,0,0,0
54,8477979,Nicolas Aube-Kubel,R,BUF,28,0,0,0,0
54,8476871,Tanner Pearson,L,,32,0,0,0,0
54,8476393,Nick Cousins,C,,31,0,0,0,0
54,8479977,Kailer Yamamoto,R,,26,0,0,0,0
54,8479543,Michael Pezzetta,L,MTL,26,0,0,0,0
54,8477018,Ben Hutton,D,VGK,31,0,0,0,0
54,8480762,Eric Robinson,L,CAR,29,0,0,0,0
54,8474034,Pat Maroon,L,CHI,36,0,0,0,0
54,8481058,Jesse Ylönen,R,,25,0,0,0,0
54,8475179,Dmitry Kulikov,D,FLA,34,0,0,0,0
54,8481527,Kaedan Korczak,D,VGK,23,0,0,0,0
54,8473449,Kyle Okposo,R,,36,0,0,0,0
54,8482192,Isaak Phillips,D,CHI,23,0,0,0,0
54,8480727,Zach Whitecloud,D,VGK,28,0,0,0,0
54,8479346,Dillon Dube,C,,26,0,0,0,0
54,8480821,Filip Zadina,R,,25,0,0,0,0
54,8480001,Urho Vaakanainen,D,ANA,25,0,0,0,0
54,8470966,Mark Giordano,D,,41,0,0,0,0
54,8480853,Liam Foudy,C,,24,0,0,0,0
54,8475225,Craig Smith,C,CHI,35,0,0,0,0
54,8479972,Mason Shaw,C,WPG,26,0,0,0,0
54,8478451,Ethan Bear,D,WSH,27,0,0,0,0
54,8474040,Sam Gagner,C,,35,0,0,0,0
54,8480196,Jacob Bryson,D,BUF,27,0,0,0,0
54,8479984,Cal Foote,D,,26,0,0,0,0
54,8480011,Klim Kostin,C,SJS,25,0,0,0,0
54,8482176,Wyatt Kaiser,D,CHI,22,0,0,0,0
54,8476988,Matt Benning,D,SJS,30,0,0,0,0
54,8479370,Tyson Jost,C,CAR,26,0,0,0,0
54,8477464,Nic Petan,C,,29,0,0,0,0
54,8477380,Jonny Brodzinski,C,NYR,31,0,0,0,0
54,8480070,Ian Mitchell,D,BOS,25,0,0,0,0
54,8479315,Joey Anderson,R,CHI,26,0,0,0,0
54,8478099,Kevin Labanc,R,,29,0,0,0,0
54,8476874,Olli Maatta,D,DET,30,0,0,0,0
54,8475208,Brian Dumoulin,D,ANA,33,0,0,0,0
54,8478430,Oliver Kylington,D,,27,0,0,0,0
54,8479536,Axel Jonsson-Fjallby,L,WPG,26,0,0,0,0
54,8479671,Mathieu Olivier,R,CBJ,27,0,0,0,0
54,8471709,Marc-Edouard Vlasic,D,SJS,37,0,0,0,0
54,8479328,Julien Gauthier,R,NYI,27,0,0,0,0
54,8478421,A.J. Greer,L,FLA,28,0,0,0,0
54,8477573,Nathan Walker,L,STL,30,0,0,0,0
54,8481537,Nikita Okhotiuk,D,CGY,24,0,0,0,0
54,8474166,Alec Martinez,D,CHI,37,0,0,0,0
54,8470610,Zach Parise,L,,40,0,0,0,0
54,8477478,William Carrier,L,CAR,30,0,0,0,0
54,8479344,Jesse Puljujarvi,R,PIT,26,0,0,0,0
54,8480887,Jordan Harris,D,MTL,24,0,0,0,0
54,8478502,Dennis Gilbert,D,BUF,28,0,0,0,0
54,8482730,Brandt Clarke,D,LAK,21,0,0,0,0
54,8480355,Mark Kastelic,C,BOS,25,0,0,0,0
54,8475750,Jon Merrill,D,MIN,32,0,0,0,0
54,8475164,Jakob Silfverberg,R,,34,0,0,0,0
54,8477944,Jakub Vrana,L,,28,0,0,0,0
54,8479439,Jacob MacDonald,D,COL,31,0,0,0,0
54,8474568,Luke Schenn,D,NSH,35,0,0,0,0
54,8478454,Noah Juulsen,D,VAN,27,0,0,0,0
54,8475752,Tyler Pitlick,C,,33,0,0,0,0
54,8482148,Hendrix Lapierre,C,WSH,22,0,0,0,0
54,8481167,Brayden Pachal,D,CGY,25,0,0,0,0
54,8478043,Sam Lafferty,C,BUF,29,0,0,0,0
54,8479321,Lucas Johansen,D,,27,0,0,0,0
54,8471699,Andrew Cogliano,C,,37,0,0,0,0
54,8481521,Ronnie Attard,D,PHI,25,0,0,0,0
54,8481161,Jake Christiansen,D,CBJ,25,0,0,0,0
54,8479458,Nikita Zaitsev,D,,33,0,0,0,0
54,8479619,Michael Carcone,L,UTA,28,0,0,0,0
54,8479026,Philippe Myers,D,TOR,27,0,0,0,0
54,8477330,Dominik Kubalik,L,,29,0,0,0,0
54,8481617,Vasily Podkolzin,R,VAN,23,0,0,0,0
54,8481701,Santeri Hatakka,D,NJD,23,0,0,0,0
54,8479514,Rem Pitlick,C,,27,0,0,0,0
54,8477446,Michael McCarron,R,NSH,29,0,0,0,0
54,8470604,Jeff Carter,C,,39,0,0,0,0
54,8482241,Radim Zohorna,L,,28,0,0,0,0
54,8480289,Morgan Barron,C,WPG,26,0,0,0,0
54,8479379,Givani Smith,R,SJS,26,0,0,0,0
54,8480216,Jacob Peterson,C,,25,0,0,0,0
54,8477851,Jordan Oesterle,D,BOS,32,0,0,0,0
54,8484258,Sam Malinski,D,COL,26,0,0,0,0
54,8478904,Steven Lorentz,C,,28,0,0,0,0
54,8482095,Tyler Kleven,D,OTT,22,0,0,0,0
54,8480848,Ty Dellandrea,C,SJS,24,0,0,0,0
54,8476884,Derrick Pouliot,D,,30,0,0,0,0
54,8479336,Carl Grundstrom,R,SJS,27,0,0,0,0
54,8482964,Arber Xhekaj,D,MTL,23,0,0,0,0
54,8471686,Marc Staal,D,,37,0,0,0,0
54,8477887,Patrick Brown,C,BOS,32,0,0,0,0
54,8478495,Denis Gurianov,R,,27,0,0,0,0
54,8473504,Cal Clutterbuck,R,,37,0,0,0,0
54,8481550,Adam Beckman,L,NJD,23,0,0,0,0
54,8480845,Rasmus Kupari,C,WPG,24,0,0,0,0
54,8474009,Nick Bonino,C,,36,0,0,0,0
54,8478585,Derek Ryan,C,EDM,38,0,0,0,0
54,8477962,Brendan Lemieux,L,CAR,28,0,0,0,0
54,8482861,Vincent Iorio,D,WSH,22,0,0,0,0
54,8479378,Logan Stanley,D,WPG,26,0,0,0,0
54,8473446,Erik Johnson,D,PHI,36,0,0,0,0
54,8481743,Marc Del Gaizo,D,NSH,25,0,0,0,0
54,8477384,Josh Brown,D,EDM,30,0,0,0,0
54,8482165,Yan Kuznetsov,D,CGY,22,0,0,0,0
54,8478424,Jansen Harkins,C,ANA,27,0,0,0,0
54,8482144,Jack Thompson,D,SJS,22,0,0,0,0
54,8478512,Austin Czarnik,C,,32,0,0,0,0
54,8477527,Ross Johnston,L,ANA,30,0,0,0,0
54,8479383,Boris Katchouk,L,,26,0,0,0,0
54,8482094,Daemon Hunt,D,MIN,22,0,0,0,0
54,8481719,Maxwell Crozier,D,TBL,24,0,0,0,0
54,8480192,Johnathan Kovacevic,D,NJD,27,0,0,0,0
54,8479376,Victor Mete,D,,26,0,0,0,0
54,8482511,Mason Lohrei,D,BOS,23,0,0,0,0
54,8475825,Jani Hakanpää,D,,32,0,0,0,0
54,8478021,William Lagesson,D,DET,28,0,0,0,0
54,8475795,Dylan McIlrath,D,WSH,32,0,0,0,0
54,8477846,Ryan Carpenter,C,,33,0,0,0,0
54,8481056,Spencer Stastney,D,NSH,24,0,0,0,0
54,8481564,Ryan Johnson,D,BUF,23,0,0,0,0
54,8478017,Mark Friedman,D,VAN,29,0,0,0,0
54,8479320,Max Lajoie,D,SEA,27,0,0,0,0
54,8480075,Cameron Crotty,D,MIN,25,0,0,0,0
54,8484287,Cole McWard,D,VAN,23,0,0,0,0
54,8484254,Akito Hirose,D,VAN,25,0,0,0,0
54,8483407,Brandon Scanlin,D,NYR,25,0,0,0,0
54,8480274,Philip Kemp,D,EDM,25,0,0,0,0
54,8479522,Hardy Haman Aktell,D,WSH,26,0,0,0,0
54,8480007,Jonas Rondbjerg,R,VGK,25,0,0,0,0
54,8477454,Adam Erne,L,,29,0,0,0,0
54,8481679,Maxence Guenette,D,OTT,23,0,0,0,0
54,8480441,Trey Fix-Wolansky,R,CBJ,25,0,0,0,0
54,8483546,Marshall Rifai,D,TOR,26,0,0,0,0
54,8480084,Nick DeSimone,D,NJD,30,0,0,0,0
54,8481030,Jack St. Ivany,D,PIT,25,0,0,0,0
54,8481592,Jakob Pelletier,L,CGY,23,0,0,0,0
54,8478011,Louie Belpedio,D,PHI,28,0,0,0,0
54,8477930,Pierre-Edouard Bellemare,L,,39,0,0,0,0
54,8484321,Nikolas Matinpalo,D,OTT,26,0,0,0,0
54,8482067,Connor Mackey,D,NYR,28,0,0,0,0
54,8481806,Louis Crevier,D,CHI,23,0,0,0,0
54,8484326,Patrik Koch,D,UTA,28,0,0,0,0
54,8477971,Andreas Englund,D,LAK,28,0,0,0,0
54,8481751,Lukas Rousek,R,BUF,25,0,0,0,0
54,8481006,Tyler Tucker,D,STL,24,0,0,0,0
54,8476867,Brendan Gaunce,C,MIN,30,0,0,0,0
54,8479520,Brandon Duhaime,R,WSH,27,0,0,0,0
54,8477073,Kurtis MacDermid,L,NJD,30,0,0,0,0
54,8480874,Adam Ginning,D,PHI,24,0,0,0,0
54,8477473,Justin Bailey,R,SJS,29,0,0,0,0
54,8479066,Ryan Lomberg,L,CGY,30,0,0,0,0
54,8477070,Liam O'Brien,C,UTA,30,0,0,0,0
54,8474618,Marco Scandella,D,,34,0,0,0,0
54,8475797,Jarred Tinordi,D,,32,0,0,0,0
54,8481441,Joe Snively,C,DET,28,0,0,0,0
54,8477244,Chad Ruhwedel,D,NYR,34,0,0,0,0
54,8479772,Zack MacEwen,R,OTT,28,0,0,0,0
54,8481147,Reese Johnson,C,MIN,26,0,0,0,0
54,8481043,Cole Koepke,L,BOS,26,0,0,0,0
54,8483619,Filip Roos,D,OTT,25,0,0,0,0
54,8481541,Samuel Bolduc,D,NYI,24,0,0,0,0
54,8477810,Joel Hanley,D,CGY,33,0,0,0,0
54,8476907,Mackenzie MacEachern,L,,30,0,0,0,0
54,8482652,Walker Duehr,R,CGY,27,0,0,0,0
54,8477126,Jayson Megna,C,,34,0,0,0,0
54,8483398,Declan Carlile,D,TBL,31,0,0,0,0
54,8482929,Emil Lilleberg,D,TBL,23,0,0,0,0
54,8480880,Jakub Lauko,C,MIN,24,0,0,0,0
54,8480245,Olle Lycksell,R,PHI,25,0,0,0,0
54,8480252,Cole Guttman,C,CHI,25,0,0,0,0
54,8477467,Gustav Olofsson,D,SEA,30,0,0,0,0
54,8479968,Vinni Lettieri,C,BOS,29,0,0,0,0
54,8478400,Colin White,C,,27,0,0,0,0
54,8475755,Alexander Petrovic,D,DAL,32,0,0,0,0
54,8481812,Nikolai Knyzhov,D,,27,0,0,0,0
54,8481593,Jayden Struble,D,MTL,23,0,0,0,0
54,8481532,Alex Turcotte,C,LAK,23,0,0,0,0
54,8482126,Emil Andrae,D,PHI,31,0,0,0,0
54,8479944,Zach Aston-Reese,C,VGK,30,0,0,0,0
54,8471817,Ryan Reaves,R,TOR,37,0,0,0,0
54,8481206,John Ludvig,D,PIT,24,0,0,0,0
54,8481599,Victor Soderstrom,D,UTA,23,0,0,0,0
54,8480292,Carson Meyer,R,ANA,27,0,0,0,0
54,8482496,Nils Aman,C,VAN,24,0,0,0,0
54,8479718,Alex Barré-Boulet,C,MTL,27,0,0,0,0
54,8479994,Jaret Anderson-Dolan,C,WPG,25,0,0,0,0
54,8480184,Gustav Lindstrom,D,,26,0,0,0,0
54,8480890,Jan Jenik,R,OTT,24,0,0,0,0
54,8478067,Oskar Lindblom,L,,28,0,0,0,0
54,8476934,Brock McGinn,L,ANA,30,0,0,0,0
54,8479985,Cale Fleury,D,SEA,26,0,0,0,0
54,8484304,Uvis Balinskis,D,FLA,28,0,0,0,0
54,8479981,Jonah Gadjovich,L,FLA,26,0,0,0,0
54,8481716,Dmitri Voronkov,L,CBJ,24,0,0,0,0
54,8474709,Matt Martin,L,,35,0,0,0,0
54,8482634,Alex Steeves,C,TOR,25,0,0,0,0
54,8480823,Alexander Alexeyev,D,WSH,25,0,0,0,0
54,8477541,Dakota Mermis,D,TOR,30,0,0,0,0
54,8483491,Ivan Miroshnichenko,L,WSH,20,0,0,0,0
54,8478477,Mitchell Stephens,C,SEA,27,0,0,0,0
54,8481543,Nikita Alexandrov,C,STL,24,0,0,0,0
54,8479423,Alex Nylander,L,,26,0,0,0,0
54,8482451,Mikael Pyyhtia,L,CBJ,23,0,0,0,0
54,8478831,Kevin Stenlund,C,UTA,28,0,0,0,0
54,8480306,Grant Hutton,D,NYI,29,0,0,0,0
54,8478028,Fredrik Olofsson,L,,28,0,0,0,0
54,8477462,Robert Hagg,D,VGK,29,0,0,0,0
54,8477320,Anton Blidh,L,NYR,29,0,0,0,0
54,8482157,Will Cuylle,L,NYR,22,0,0,0,0
54,8482737,Zack Bolduc,C,STL,21,0,0,0,0
54,8481239,Samuel Fagemo,L,,24,0,0,0,0
54,8481600,Tobias Bjornfot,D,FLA,23,0,0,0,0
54,8478409,Anthony Richard,C,PHI,28,0,0,0,0
54,8474145,Robert Bortuzzo,D,,35,0,0,0,0
54,8475958,Michael Sgarbossa,C,WSH,32,0,0,0,0
54,8479986,Kole Lind,R,DAL,26,0,0,0,0
54,8479249,Andrew Poturalski,C,SJS,30,0,0,0,0
54,8479362,Riley Tufte,L,BOS,26,0,0,0,0
54,8479991,Jake Leschyshyn,C,NYR,25,0,0,0,0
54,8479587,Rhett Gardner,C,PHI,28,0,0,0,0
54,8482744,James Malatesta,L,CBJ,21,0,0,0,0
54,8478854,Ryan Shea,D,PIT,27,0,0,0,0
54,8481591,Sam Poulin,R,,23,0,0,0,0
54,8483512,Matt Savoie,C,EDM,20,0,0,0,0
54,8482102,Vasily Ponomarev,C,PIT,22,0,0,0,0
54,8482162,Roby Jarventie,L,EDM,22,0,0,0,0
54,8481016,Ruslan Iskhakov,C,,24,0,0,0,0
54,8482172,Landon Slaggert,L,CHI,22,0,0,0,0
54,8482747,Brennan Othmann,L,NYR,21,0,0,0,0
54,8480031,Maxime Comtois,L,,25,0,0,0,0
54,8480226,Marián Studenic,R,,26,0,0,0,0
54,8478408,Travis Dermott,D,,28,0,0,0,0
54,8481518,Nolan Foote,L,NJD,24,0,0,0,0
54,8479419,Brett Murray,L,BUF,26,0,0,0,0
54,8482088,Justin Sourdif,R,FLA,22,0,0,0,0
54,8482201,Gage Goncalves,C,TBL,23,0,0,0,0
54,8481578,Graeme Clarke,R,MIN,23,0,0,0,0
54,8482177,Marat Khusnutdinov,C,MIN,22,0,0,0,0
54,8481754,Nikita Nesterenko,C,ANA,23,0,0,0,0
54,8483531,Brian Halonen,L,NJD,25,0,0,0,0
54,8483920,Pierrick Dube,R,WSH,23,0,0,0,0
54,8480851,Akil Thomas,C,LAK,24,0,0,0,0
54,8475235,Nicolas Deslauriers,L,PHI,33,0,0,0,0
54,8482476,Emil Heineman,L,MTL,23,0,0,0,0
54,8477149,Scott Sabourin,R,SJS,32,0,0,0,0
54,8483549,Lucas Condotta,L,MTL,27,0,0,0,0
54,8482765,Isak Rosen,R,BUF,21,0,0,0,0
54,8481237,Kyle MacLean,C,NYI,25,0,0,0,0
54,8481024,Linus Karlsson,C,VAN,25,0,0,0,0
54,8481690,Tyler Angle,C,,24,0,0,0,0
54,8483570,Ben Meyers,C,SEA,26,0,0,0,0
54,8481655,Cole Schwindt,R,CGY,23,0,0,0,0
54,8481462,Mason Morelli,L,VGK,28,0,0,0,0
54,8483401,Marc Johnstone,R,PIT,28,0,0,0,0
54,8478956,Samuel Laberge,L,NJD,27,0,0,0,0
54,8479533,Joona Koppanen,L,,26,0,0,0,0
54,8482197,Adam Raska,R,MIN,23,0,0,0,0
54,8482250,Callahan Burke,C,VGK,27,0,0,0,0
54,8482784,Zach Dean,C,STL,21,0,0,0,0
54,8484255,Jason Polin,R,COL,25,0,0,0,0
54,8481077,John Leonard,L,,26,0,0,0,0
54,8481534,Raphael Lavoie,C,EDM,24,0,0,0,0
54,8483609,Adam Klapka,R,CGY,24,0,0,0,0
54,8482751,Ryan Winterton,C,SEA,21,0,0,0,0
54,8480267,Sammy Walker,C,MIN,25,0,0,0,0
54,8475766,Austin Watson,L,,32,0,0,0,0
54,8482460,Matt Rempe,C,NYR,22,0,0,0,0
54,8481065,Angus Crookshank,L,OTT,25,0,0,0,0
54,8481070,Hugh McGing,L,,26,0,0,0,0
54,8476323,Max McCormick,L,SEA,32,0,0,0,0
54,8483395,Arshdeep Bains,L,VAN,23,0,0,0,0
54,8484259,Ondrej Pavel,C,COL,31,0,0,0,0
54,8483432,Luca Del Bel Belluz,C,CBJ,31,0,0,0,0
54,8483045,Cameron Butler,R,CBJ,31,0,0,0,0
54,8482061,Brandon Biro,L,SEA,26,0,0,0,0
54,8477401,John Hayden,C,SEA,29,0,0,0,0
54,8475278,Byron Froese,C,,33,0,0,0,0
54,8478446,Glenn Gawdin,C,LAK,27,0,0,0,0
54,8477993,Justin Kirkland,C,CGY,28,0,0,0,0
54,8482147,Jean-Luc Foudy,C,COL,22,0,0,0,0
54,8480032,Shane Bowers,C,NJD,25,0,0,0,0
54,8479330,Brandon Gignac,C,MTL,27,0,0,0,0
54,8480776,Sheldon Rempal,R,,29,0,0,0,0
54,8475413,Justin Dowling,C,NJD,34,0,0,0,0
54,8481726,Adam Edstrom,C,NYR,24,0,0,0,0
54,8480844,Grigori Denisenko,L,VGK,24,0,0,0,0
54,8478147,Bokondji Imama,L,PIT,28,0,0,0,0
54,8478881,Brett Seney,L,CHI,28,0,0,0,0
54,8483630,Pavol Regenda,L,ANA,25,0,0,0,0
54,8480836,Jonathan Gruden,C,,24,0,0,0,0
54,8484314,Jiri Smejkal,L,,28,0,0,0,0
54,8475780,Chris Wagner,R,COL,33,0,0,0,0
54,8479546,Oskar Steen,C,,26,0,0,0,0
54,8483597,Milos Kelemen,L,UTA,25,0,0,0,0
54,8481789,Tye Kartye,L,SEA,23,0,0,0,0
54,8484325,Waltteri Merela,C,TBL,26,0,0,0,0
54,8479421,Jacob Moverare,D,LAK,26,0,0,0,0
54,8481585,Egor Afanasyev,L,SJS,23,0,0,0,0
54,8479547,Matthew Phillips,R,,26,0,0,0,0
54,8479367,William Lockwood,R,FLA,26,0,0,0,0
54,8476915,Jujhar Khaira,L,,30,0,0,0,0
54,8481422,Jacob Lucchini,C,NSH,29,0,0,0,0
54,8480468,James Hamblin,L,EDM,25,0,0,0,0
54,8478051,Max Willman,C,NJD,29,0,0,0,0
54,8481556,John Beecher,C,BOS,23,0,0,0,0
54,8478078,Rourke Chartier,C,,28,0,0,0,0
55,8478402,Connor McDavid,C,EDM,27,82,56,98,154
55,8476453,Nikita Kucherov,R,TBL,31,82,40,87,127
55,8479318,Auston Matthews,C,TOR,27,82,55,64,119
55,8477939,William Nylander,R,TOR,28,82,54,65,119
55,8477934,Leon Draisaitl,C,EDM,29,82,45,74,119
55,8477492,Nathan MacKinnon,C,COL,29,82,49,69,118
55,8476468,J.T. Miller,C,VAN,31,82,39,68,107
55,8478420,Mikko Rantanen,R,COL,28,82,48,58,106
55,8480801,Brady Tkachuk,L,OTT,25,82,48,58,106
55,8477402,Pavel Buchnevich,L,STL,29,82,42,63,105
55,8479314,Matthew Tkachuk,L,FLA,27,82,36,69,105
55,8481559,Jack Hughes,C,NJD,23,82,51,52,103
55,8480027,Jason Robertson,L,DAL,25,82,37,66,103
55,8477956,David Pastrnak,R,BOS,28,82,50,52,102
55,8477493,Aleksander Barkov,C,FLA,29,82,31,70,101
55,8471675,Sidney Crosby,C,PIT,37,82,35,65,100
55,8476887,Filip Forsberg,L,NSH,30,82,51,48,99
55,8480012,Elias Pettersson,C,VAN,26,82,35,60,95
55,8480023,Robert Thomas,C,STL,25,82,31,64,95
55,8478550,Artemi Panarin,L,NYR,33,82,37,57,94
55,8475166,John Tavares,C,TOR,34,82,40,53,93
55,8480830,Andrei Svechnikov,R,CAR,24,82,39,54,93
55,8482116,Tim Stützle,C,OTT,22,82,34,58,92
55,8479343,Clayton Keller,R,UTA,26,82,43,48,91
55,8479385,Jordan Kyrou,C,STL,26,82,43,48,91
55,8479407,Jesper Bratt,L,NJD,26,82,32,57,89
55,8481557,Matt Boldy,L,MIN,23,82,36,52,88
55,8476389,Vincent Trocheck,C,NYR,31,82,35,53,88
55,8480069,Cale Makar,D,COL,26,82,30,58,88
55,8477933,Sam Reinhart,C,FLA,29,82,45,42,87
55,8477404,Jake Guentzel,C,TBL,30,82,43,44,87
55,8480208,Drake Batherson,R,OTT,26,82,37,50,87
55,8479323,Adam Fox,D,NYR,26,82,16,71,87
55,8480002,Nico Hischier,C,NJD,25,82,21,65,86
55,8476454,Ryan Nugent-Hopkins,C,EDM,31,82,21,65,86
55,8476459,Mika Zibanejad,C,NYR,31,82,29,56,85
55,8478398,Kyle Connor,L,WPG,28,82,36,48,84
55,8475158,Ryan O'Reilly,C,NSH,33,82,36,47,83
55,8477951,Nick Schmaltz,C,UTA,28,82,29,54,83
55,8478449,Roope Hintz,C,DAL,28,82,28,53,81
55,8478440,Dylan Strome,C,WSH,27,82,25,56,81
55,8475786,Zach Hyman,L,EDM,32,82,36,44,80
55,8473419,Brad Marchand,L,BOS,36,82,33,47,80
55,8475172,Nazem Kadri,C,CGY,34,82,28,52,80
55,8478445,Mathew Barzal,C,NYI,27,82,19,61,80
55,8476853,Morgan Rielly,D,TOR,30,82,13,67,80
55,8477960,Adrian Kempe,R,LAK,28,82,37,42,79
55,8476456,Jonathan Huberdeau,C,CGY,31,82,14,65,79
55,8478403,Jack Eichel,C,VGK,28,82,41,37,78
55,8476460,Mark Scheifele,C,WPG,31,82,30,48,78
55,8480839,Rasmus Dahlin,D,BUF,24,82,21,57,78
55,8474600,Roman Josi,D,NSH,34,82,19,59,78
55,8477409,Carter Verhaeghe,C,FLA,29,82,35,42,77
55,8474564,Steven Stamkos,C,NSH,34,82,32,45,77
55,8476462,Dougie Hamilton,D,NJD,31,82,20,57,77
55,8478427,Sebastian Aho,C,CAR,27,82,36,40,76
55,8478414,Timo Meier,R,NJD,28,82,31,44,75
55,8474578,Erik Karlsson,D,PIT,34,82,9,66,75
55,8478444,Brock Boeser,R,VAN,27,82,36,38,74
55,8478042,Viktor Arvidsson,R,EDM,31,82,35,39,74
55,8481533,Trevor Zegras,C,ANA,23,82,25,49,74
55,8478010,Brayden Point,C,TBL,28,82,40,33,73
55,8478873,Troy Terry,R,ANA,27,82,28,45,73
55,8479337,Alex DeBrincat,R,DET,27,82,24,49,73
55,8473512,Claude Giroux,R,OTT,36,82,19,54,73
55,8474590,John Carlson,D,WSH,34,82,18,55,73
55,8475798,Mikael Granlund,C,SJS,32,82,16,57,73
55,8480865,Noah Dobson,D,NYI,24,82,9,64,73
55,8471214,Alex Ovechkin,L,WSH,39,82,42,30,72
55,8471215,Evgeni Malkin,C,PIT,38,82,29,43,72
55,8477942,Kevin Fiala,L,LAK,28,82,25,47,72
55,8480800,Quinn Hughes,D,VAN,25,82,12,60,72
55,8475184,Chris Kreider,L,NYR,33,82,44,27,71
55,8476539,Jonathan Marchessault,R,NSH,34,82,35,36,71
55,8478864,Kirill Kaprizov,L,MIN,27,82,34,37,71
55,8477946,Dylan Larkin,C,DET,28,82,31,40,71
55,8480036,Miro Heiskanen,D,DAL,25,82,13,58,71
55,8481523,Kirby Dach,C,MTL,23,82,10,61,71
55,8480015,Owen Tippett,R,PHI,25,82,35,35,70
55,8475168,Matt Duchene,C,DAL,33,82,27,43,70
55,8475913,Mark Stone,R,VGK,32,82,21,49,70
55,8480803,Evan Bouchard,D,EDM,25,82,17,53,70
55,8475692,Mats Zuccarello,R,MIN,37,82,16,54,70
55,8474679,Gustav Nyquist,C,NSH,35,82,12,58,70
55,8476483,Rickard Rakell,R,PIT,31,82,32,37,69
55,8477504,Josh Morrissey,D,WPG,29,82,15,54,69
55,8475754,Brock Nelson,C,NYI,33,82,34,34,68
55,8482109,Alexis Lafrenière,L,NYR,23,82,30,38,68
55,8480018,Nick Suzuki,C,MTL,25,82,28,40,68
55,8478439,Travis Konecny,R,PHI,27,82,25,43,68
55,8477447,Shea Theodore,D,VGK,29,82,14,54,68
55,8477940,Nikolaj Ehlers,L,WPG,28,82,33,34,67
55,8475169,Evander Kane,L,EDM,33,82,32,34,66
55,8475726,Tyler Toffoli,C,SJS,32,82,31,35,66
55,8476448,William Karlsson,C,VGK,31,82,26,40,66
55,8477494,Jonathan Drouin,L,COL,29,82,19,47,66
55,8476346,Johnny Gaudreau,L,CBJ,31,82,17,49,66
55,8477932,Aaron Ekblad,D,FLA,28,82,17,49,66
55,8477955,Jared McCann,L,SEA,28,82,27,38,65
55,8474150,Mikael Backlund,C,CGY,35,82,27,38,65
55,8479420,Tage Thompson,C,BUF,27,82,30,34,64
55,8475784,Jeff Skinner,C,EDM,32,82,28,36,64
55,8476881,Tomas Hertl,C,VGK,31,82,25,39,64
55,8477949,Alex Tuch,R,BUF,28,82,18,46,64
55,8479345,Jakob Chychrun,D,WSH,26,82,13,51,64
55,8477500,Bo Horvat,C,NYI,29,82,29,34,63
55,8479400,Pierre-Luc Dubois,L,WSH,26,82,29,34,63
55,8475794,Tyler Seguin,C,DAL,32,82,26,37,63
55,8475167,Victor Hedman,D,TBL,34,82,11,52,63
55,8477935,Sam Bennett,C,FLA,28,82,33,29,62
55,8482097,Jack Quinn,R,BUF,23,82,26,36,62
55,8480064,Josh Norris,C,OTT,25,82,39,22,61
55,8483808,Andrei Kuzmenko,L,CGY,28,82,32,29,61
55,8478401,Pavel Zacha,C,BOS,27,82,27,34,61
55,8479675,Trevor Moore,L,LAK,29,82,26,35,61
55,8473994,Jamie Benn,L,DAL,35,82,23,38,61
55,8482740,Wyatt Johnston,C,DAL,21,82,39,21,60
55,8476792,Torey Krug,D,STL,33,82,17,43,60
55,8478407,Vince Dunn,D,SEA,28,82,12,48,60
55,8477346,MacKenzie Weegar,D,CGY,30,82,11,49,60
55,8482078,Lucas Raymond,L,DET,22,82,29,30,59
55,8478047,Michael Bunting,L,PIT,29,82,25,34,59
55,8474141,Patrick Kane,R,DET,36,82,24,35,59
55,8477496,Elias Lindholm,C,BOS,30,82,19,40,59
55,8475810,Bryan Rust,R,PIT,32,82,30,28,58
55,8482175,JJ Peterka,R,BUF,22,82,27,31,58
55,8479542,Brandon Hagel,L,TBL,26,82,21,37,58
55,8481528,Dylan Cozens,C,BUF,23,82,20,38,58
55,8475151,Kyle Palmieri,C,NYI,33,82,34,23,57
55,8478498,Jake DeBrusk,L,VAN,28,82,32,25,57
55,8477501,Valeri Nichushkin,R,COL,29,82,31,26,57
55,8482113,Anton Lundell,C,FLA,23,82,28,29,57
55,8478438,Tommy Novak,C,NSH,27,82,23,34,57
55,8477497,Sean Monahan,C,CBJ,30,82,23,34,57
55,8476882,Teuvo Teravainen,L,CHI,30,82,22,35,57
55,8481540,Cole Caufield,R,MTL,23,82,20,37,57
55,8481711,Matias Maccelli,L,UTA,24,82,18,39,57
55,8477021,Alex Kerfoot,C,UTA,30,82,17,40,57
55,8482110,Dawson Mercer,C,NJD,23,82,32,24,56
55,8477479,Tyler Bertuzzi,L,CHI,29,82,28,28,56
55,8480849,Barrett Hayton,C,UTA,24,82,24,32,56
55,8480188,Fabian Zetterlund,L,SJS,25,82,22,34,56
55,8478856,Conor Garland,R,VAN,28,82,21,35,56
55,8479999,Casey Mittelstadt,C,COL,26,82,18,38,56
55,8480871,Adam Boqvist,D,FLA,24,82,18,38,56
55,8476906,Shayne Gostisbehere,D,CAR,31,82,15,41,56
55,8478493,Joel Eriksson Ek,C,MIN,27,82,29,26,55
55,8482159,Tyson Foerster,R,PHI,22,82,27,28,55
55,8482093,Seth Jarvis,C,CAR,22,82,23,32,55
55,8477476,Artturi Lehkonen,L,COL,29,82,22,33,55
55,8482665,Matty Beniers,C,SEA,22,82,22,33,55
55,8479987,Morgan Geekie,C,BOS,26,82,22,33,55
55,8477986,Brandon Montour,D,SEA,30,82,20,35,55
55,8478460,Zach Werenski,D,CBJ,27,82,11,43,54
55,8476329,Travis Boyd,C,MIN,31,82,11,43,54
55,8478396,Noah Hanifin,D,VGK,27,82,10,44,54
55,8480014,Gabriel Vilardi,C,WPG,25,82,30,23,53
55,8475170,Brayden Schenn,C,STL,33,82,22,31,53
55,8474641,Adam Henrique,C,EDM,34,82,22,31,53
55,8477416,Oliver Bjorkstrand,R,SEA,29,82,20,33,53
55,8476826,Yanni Gourde,C,SEA,33,82,18,35,53
55,8481546,Cam York,D,PHI,23,82,18,35,53
55,8478472,Mathieu Joseph,R,STL,27,82,14,39,53
55,8479339,Patrik Laine,L,CBJ,26,82,27,25,52
55,8476432,Boone Jenner,C,CBJ,31,82,20,32,52
55,8478038,Devon Toews,D,COL,30,82,9,43,52
55,8476875,Mike Matheson,D,MTL,30,82,6,46,52
55,8475763,Kevin Hayes,R,PIT,32,82,26,25,51
55,8478975,Mason Marchment,L,DAL,29,82,23,28,51
55,8480028,Morgan Frost,C,PHI,25,82,21,30,51
55,8478458,Jack Roslovic,C,CAR,27,82,19,32,51
55,8474149,Evgenii Dadonov,R,DAL,35,82,18,33,51
55,8480039,Martin Necas,C,CAR,25,82,16,35,51
55,8474102,David Perron,L,OTT,36,82,16,35,51
55,8481596,Shane Pinto,C,OTT,24,82,15,36,51
55,8475191,Reilly Smith,R,NYR,33,82,14,37,51
55,8471724,Kris Letang,D,PIT,37,82,9,42,51
55,8482684,Luke Hughes,D,NJD,21,82,8,43,51
55,8480797,Joel Farabee,L,PHI,24,82,28,22,50
55,8477407,Anthony Duclair,L,NYI,29,82,26,24,50
55,8478542,Evan Rodrigues,C,FLA,31,82,24,26,50
55,8482745,Mason McTavish,C,ANA,21,82,22,28,50
55,8480835,Jack Drury,C,CAR,24,82,21,29,50
55,8480220,Noah Cates,L,PHI,25,82,16,34,50
55,8477503,Max Domi,C,TOR,29,82,15,35,50
55,8474563,Drew Doughty,D,LAK,35,82,15,35,50
55,8480078,Filip Chytil,C,NYR,25,82,14,36,50
55,8477495,Seth Jones,D,CHI,30,82,13,37,50
55,8478055,Gustav Forsling,D,FLA,28,82,13,37,50
55,8481068,Yegor Sharangovich,C,CGY,26,82,31,18,49
55,8474586,Jordan Eberle,R,SEA,34,82,23,26,49
55,8484144,Connor Bedard,C,CHI,19,82,18,31,49
55,8478469,Thomas Chabot,D,OTT,27,82,17,32,49
55,8482089,Jake Neighbours,L,STL,22,82,28,20,48
55,8475745,Charlie Coyle,C,BOS,32,82,21,27,48
55,8471685,Anze Kopitar,C,LAK,37,82,10,38,48
55,8479325,Charlie McAvoy,D,BOS,27,82,8,40,48
55,8476438,Brandon Saad,L,STL,32,82,25,22,47
55,8475714,Calle Jarnkrok,C,TOR,33,82,21,26,47
55,8477511,Anthony Mantha,R,CGY,30,82,19,28,47
55,8478233,Andrew Mangiapane,L,WSH,28,82,18,29,47
55,8478519,Anthony Cirelli,C,TBL,27,82,16,31,47
55,8476885,Jacob Trouba,D,NYR,30,82,14,33,47
55,8475218,Mattias Ekholm,D,EDM,34,82,14,33,47
55,8477498,Darnell Nurse,D,EDM,29,82,10,37,47
55,8475722,Jason Zucker,L,BUF,32,82,23,23,46
55,8475768,Jaden Schwartz,C,SEA,32,82,20,26,46
55,8480798,Philipp Kurashev,C,CHI,25,82,19,27,46
55,8482475,Yegor Chinakhov,R,CBJ,23,82,18,28,46
55,8476872,Scott Laughton,C,PHI,30,82,14,32,46
55,8476479,Phillip Danault,C,LAK,31,82,12,34,46
55,8476869,Brady Skjei,D,NSH,30,82,7,39,46
55,8476981,Josh Anderson,R,MTL,30,82,28,17,45
55,8481656,Aliaksei Protas,C,WSH,23,82,17,28,45
55,8475287,Erik Haula,L,NJD,33,82,13,32,45
55,8470613,Brent Burns,D,CAR,39,82,12,33,45
55,8480434,Sean Durzi,D,UTA,26,82,12,33,45
55,8478397,Rasmus Andersson,D,CGY,28,82,9,36,45
55,8476399,Blake Coleman,C,CGY,33,82,27,17,44
55,8478474,Lawson Crouse,L,UTA,27,82,23,21,44
55,8475765,Vladimir Tarasenko,R,DET,33,82,19,25,44
55,8482105,Jake Sanderson,D,OTT,22,82,17,27,44
55,8473563,Nicklas Backstrom,C,WSH,37,82,14,30,44
55,8475314,Anders Lee,L,NYI,34,82,26,17,43
55,8479390,Taylor Raddysh,R,WSH,26,82,21,22,43
55,8480829,Jesperi Kotkaniemi,C,CAR,24,82,20,23,43
55,8477451,Ryan Hartman,R,MIN,30,82,20,23,43
55,8471698,T.J. Oshie,R,WSH,38,82,18,25,43
55,8475793,Ryan Johansen,C,PHI,32,82,18,25,43
55,8473986,Alex Killorn,L,ANA,35,82,16,27,43
55,8481624,Ilya Mikheyev,R,CHI,30,82,16,27,43
55,8480113,Alex Iafallo,L,WPG,31,82,15,28,43
55,8476905,Chandler Stephenson,C,SEA,30,82,14,29,43
55,8476958,Jaccob Slavin,D,CAR,30,82,11,32,43
55,8475753,Justin Faulk,D,STL,32,82,11,32,43
55,8481581,Thomas Harley,D,DAL,23,82,11,32,43
55,8479425,Filip Hronek,D,VAN,27,82,7,36,43
55,8478366,Frank Vatrano,R,ANA,30,82,32,10,42
55,8481560,Arthur Kaliyev,R,LAK,23,82,24,18,42
55,8474053,Logan Couture,C,SJS,35,82,23,19,42
55,8481580,Connor McMichael,C,WSH,23,82,23,19,42
55,8478413,Jordan Greenway,L,BUF,27,82,22,20,42
55,8482146,Luke Evangelista,R,NSH,22,82,19,23,42
55,8477444,Andre Burakovsky,L,SEA,29,82,14,28,42
55,8476292,Ondrej Palat,L,NJD,33,82,9,33,42
55,8479410,Mikhail Sergachev,D,UTA,26,82,6,36,42
55,8482074,Connor Zary,C,CGY,23,82,23,18,41
55,8477998,Warren Foegele,L,LAK,28,82,21,20,41
55,8476392,Adam Lowry,C,WPG,31,82,17,24,41
55,8476979,Erik Gustafsson,D,DET,32,82,6,35,41
55,8475799,Nino Niederreiter,R,WPG,32,82,26,14,40
55,8477426,Nicholas Paul,L,TBL,29,82,25,15,40
55,8481618,Alex Newhook,C,MTL,23,82,20,20,40
55,8477953,Kasperi Kapanen,R,STL,28,82,19,21,40
55,8478046,Danton Heinen,L,VAN,29,82,18,22,40
55,8482124,Quinton Byfield,R,LAK,22,82,17,23,40
55,8480185,Eetu Luostarinen,C,FLA,26,82,15,25,40
55,8474565,Alex Pietrangelo,D,VGK,34,82,14,26,40
55,8482149,Cole Perfetti,C,WPG,22,82,13,27,40
55,8479525,Ross Colton,C,COL,28,82,24,15,39
55,8483515,Juraj Slafkovsky,L,MTL,20,82,20,19,39
55,8479996,Cody Glass,C,NSH,25,82,19,20,39
55,8473533,Jordan Staal,C,CAR,36,82,17,22,39
55,8478109,Victor Olofsson,L,VGK,29,82,17,22,39
55,8482699,Dylan Guenther,R,UTA,21,82,16,23,39
55,8476461,Sean Couturier,C,PHI,32,82,16,23,39
55,8481582,Nicholas Robertson,L,TOR,23,82,16,23,39
55,8482667,William Eklund,L,SJS,22,82,14,25,39
55,8476892,Colton Parayko,D,STL,31,82,3,36,39
55,8482055,Drew O'Connor,L,PIT,26,82,22,16,38
55,8476927,Teddy Blueger,C,VAN,30,82,15,23,38
55,8478462,Nicolas Roy,C,VGK,27,82,14,24,38
55,8475764,Cam Fowler,D,ANA,33,82,5,33,38
55,8476880,Tom Wilson,R,WSH,30,82,22,15,37
55,8481535,Nils Hoglander,L,VAN,24,82,19,18,37
55,8475760,Nick Bjugstad,C,UTA,32,82,18,19,37
55,8478115,Pierre Engvall,L,NYI,28,82,17,20,37
55,8480459,Pius Suter,C,VAN,28,82,16,21,37
55,8480068,Ryan Poehling,C,PHI,25,82,15,22,37
55,8480145,Neal Pionk,D,WPG,29,82,9,28,37
55,8475171,Oliver Ekman-Larsson,D,TOR,33,82,7,30,37
55,8482142,Jamie Drysdale,D,PHI,22,82,6,31,37
55,8481554,Kaapo Kakko,R,NYR,23,82,21,15,36
55,8481604,Pavel Dorofeyev,L,VGK,24,82,21,15,36
55,8479365,Trent Frederic,C,BOS,26,82,18,18,36
55,8481477,Nico Sturm,C,SJS,29,82,18,18,36
55,8477964,Ivan Barbashev,C,VGK,29,82,13,23,36
55,8478911,Matt Roy,D,WSH,29,82,12,24,36
55,8482245,Artem Zub,D,OTT,29,82,11,25,36
55,8482079,Marco Rossi,C,MIN,23,82,23,12,35
55,8482259,Bobby McMann,C,TOR,28,82,23,12,35
55,8475791,Taylor Hall,L,CHI,33,82,20,15,35
55,8478508,Yakov Trenin,C,MIN,27,82,17,18,35
55,8482117,Lukas Reichel,L,CHI,22,82,16,19,35
55,8475149,Marcus Johansson,L,MIN,34,82,11,24,35
55,8480873,Rasmus Sandin,D,WSH,24,82,4,31,35
55,8482655,J.J. Moser,D,TBL,24,82,4,31,35
55,8482720,Matthew Knies,L,TOR,22,82,19,15,34
55,8477947,Sonny Milano,L,WSH,28,82,16,18,34
55,8478057,Dakota Joshua,C,VAN,28,82,15,19,34
55,8480995,Pontus Holmberg,R,TOR,25,82,15,19,34
55,8476960,Andreas Athanasiou,C,CHI,30,82,14,20,34
55,8476897,Oskar Sundqvist,C,STL,30,82,11,23,34
55,8482671,Owen Power,D,BUF,22,82,10,24,34
55,8478891,Mason Appleton,C,WPG,28,82,8,26,34
55,8475200,Dmitry Orlov,D,CAR,33,82,8,26,34
55,8478500,Ivan Provorov,D,CBJ,27,82,7,27,34
55,8477969,Marcus Pettersson,D,PIT,28,82,6,28,34
55,8476931,Jake McCabe,D,TOR,31,82,6,28,34
55,8480748,Kiefer Sherwood,L,VAN,29,82,21,12,33
55,8479591,Michael Eyssimont,C,TBL,28,82,17,16,33
55,8475848,Brendan Gallagher,R,MTL,32,82,16,17,33
55,8476480,Vladislav Namestnikov,C,WPG,32,82,14,19,33
55,8476419,Jean-Gabriel Pageau,C,NYI,32,82,11,22,33
55,8477456,J.T. Compher,L,DET,29,82,10,23,33
55,8476312,Josh Manson,D,COL,33,82,10,23,33
55,8480817,K'Andre Miller,D,NYR,24,82,7,26,33
55,8477948,Travis Sanheim,D,PHI,28,82,6,27,33
55,8481568,Alex Vlasic,D,CHI,23,82,5,28,33
55,8481542,Moritz Seider,D,DET,23,82,4,29,33
55,8478463,Anthony Beauvillier,L,PIT,27,82,17,15,32
55,8477989,Christian Dvorak,C,MTL,28,82,17,15,32
55,8482092,Ridly Greig,C,OTT,22,82,15,17,32
55,8477450,Jason Dickinson,C,CHI,29,82,15,17,32
55,8473422,Nick Foligno,L,CHI,37,82,14,18,32
55,8476925,Colton Sissons,C,NSH,31,82,14,18,32
55,8476921,Jordan Martinook,L,CAR,32,82,13,19,32
55,8475343,Nic Dowd,C,WSH,34,82,13,19,32
55,8476873,Mark Jankowski,C,NSH,30,82,13,19,32
55,8480980,Connor Dewar,C,TOR,25,82,11,21,32
55,8477488,Brett Pesce,D,NJD,30,82,4,28,32
55,8476463,Jonas Brodin,D,MIN,31,82,2,30,32
55,8470621,Corey Perry,R,EDM,39,82,21,10,31
55,8481013,Jonatan Berggren,R,DET,24,82,16,15,31
55,8482705,Cole Sillinger,C,CBJ,21,82,15,16,31
55,8480789,Oliver Wahlstrom,R,NYI,24,82,11,20,31
55,8480074,Alexandre Texier,C,STL,25,82,11,20,31
55,8476923,Damon Severson,D,CBJ,30,82,9,22,31
55,8476458,Ryan Strome,C,ANA,31,82,8,23,31
55,8479398,Samuel Girard,D,COL,26,82,7,24,31
55,8480073,Erik Brannstrom,D,COL,25,82,6,25,31
55,8478851,Alexandre Carrier,D,NSH,28,82,5,26,31
55,8481178,Egor Zamula,D,PHI,24,82,4,27,31
55,8483431,Logan Cooley,C,UTA,20,82,18,12,30
55,8480893,Kirill Marchenko,R,CBJ,24,82,17,13,30
55,8477429,Andrew Copp,C,DET,30,82,15,15,30
55,8477952,Robby Fabbri,C,ANA,28,82,15,15,30
55,8482133,Thomas Bordeleau,C,SJS,22,82,14,16,30
55,8477406,Mattias Janmark,C,EDM,32,82,14,16,30
55,8480009,Eeli Tolvanen,R,SEA,25,82,12,18,30
55,8479351,Sam Steel,C,DAL,26,82,11,19,30
55,8481481,Blake Lizotte,C,PIT,27,82,11,19,30
55,8479976,Juuso Valimaki,D,UTA,26,82,8,22,30
55,8482087,Kaiden Guhle,D,MTL,22,82,5,25,30
55,8481093,Rafael Harvey-Pinard,L,MTL,25,82,18,11,29
55,8474189,Lars Eller,C,PIT,35,82,16,13,29
55,8479992,Michael Rasmussen,C,DET,25,82,14,15,29
55,8481186,Logan O'Connor,R,COL,28,82,14,15,29
55,8474715,Cam Atkinson,R,TBL,35,82,14,15,29
55,8484203,Bradly Nadeau,L,CAR,19,82,12,17,29
55,8482111,Justin Barron,D,MTL,23,82,12,17,29
55,8480855,Jack McBain,C,UTA,24,82,12,17,29
55,8477392,Hudson Fasching,R,NYI,29,82,11,18,29
55,8482660,Kent Johnson,C,CBJ,22,82,10,19,29
55,8480144,David Kampf,C,TOR,29,82,10,19,29
55,8474013,Ian Cole,D,UTA,35,82,7,22,29
55,8476917,Adam Pelech,D,NYI,30,82,5,24,29
55,8474151,Ryan McDonagh,D,TBL,35,82,3,26,29
55,8476474,Stefan Noesen,R,NJD,31,82,19,9,28
55,8479293,Brandon Tanev,L,SEA,33,82,16,12,28
55,8482125,Alexander Holtz,R,VGK,22,82,13,15,28
55,8478013,Jake Walman,D,SJS,28,82,11,17,28
55,8480336,Sean Walker,D,CAR,30,82,11,17,28
55,8476854,Hampus Lindholm,D,BOS,30,82,9,19,28
55,8476624,Barclay Goodrow,C,SJS,31,82,9,19,28
55,8482807,Ethan Del Mastro,D,CHI,21,82,9,19,28
55,8476467,Jamie Oleksiak,D,SEA,32,82,6,22,28
55,8480049,Dylan Samberg,D,WPG,25,82,6,22,28
55,8476331,Dylan DeMelo,D,WPG,31,82,3,25,28
55,8478020,Michael Amadio,C,OTT,28,82,18,9,27
55,8480281,Alexey Toropchenko,R,STL,25,82,18,9,27
55,8481032,Paul Cotter,C,NJD,25,82,17,10,27
55,8475855,Jesper Fast,R,CAR,33,82,14,13,27
55,8480448,Parker Kelly,L,COL,25,82,13,14,27
55,8477919,Frederick Gaudreau,C,MIN,31,82,10,17,27
55,8479368,Max Jones,L,BOS,26,82,10,17,27
55,8480043,Timothy Liljegren,D,TOR,25,82,6,21,27
55,8477506,Ryan Pulock,D,NYI,30,82,6,21,27
55,8479371,Dante Fabbro,D,NSH,26,82,6,21,27
55,8476422,Mike Reilly,D,NYI,31,82,5,22,27
55,8479402,Jake Bean,D,CGY,26,82,2,25,27
55,8470600,Ryan Suter,D,STL,39,82,2,25,27
55,8482077,Dylan Holloway,L,EDM,23,82,20,6,26
55,8476918,Jimmy Vesey,L,NYR,31,82,13,13,26
55,8477987,Ryan Donato,C,CHI,28,82,12,14,26
55,8478211,Dryden Hunt,L,CGY,29,82,12,14,26
55,8476889,Radek Faksa,C,STL,30,82,10,16,26
55,8477938,Haydn Fleury,D,WPG,28,82,9,17,26
55,8478569,Noel Acciari,C,PIT,33,82,8,18,26
55,8477015,Connor Brown,R,EDM,30,82,8,18,26
55,8476902,Esa Lindell,D,DAL,30,82,6,20,26
55,8480878,Nils Lundkvist,D,DAL,24,82,5,21,26
55,8477365,Connor Clifton,D,BUF,29,82,3,23,26
55,8475462,Radko Gudas,D,ANA,34,82,3,23,26
55,8476278,Colin Blackwell,C,DAL,31,82,17,8,25
55,8479316,Luke Kunin,C,SJS,27,82,13,12,25
55,8481708,Zac Jones,D,NYR,24,82,11,14,25
55,8484153,Leo Carlsson,C,ANA,20,82,11,14,25
55,8475220,Marcus Foligno,L,MIN,33,82,10,15,25
55,8482624,Daniil Miromanov,D,CGY,27,82,10,15,25
55,8476442,Matt Nieto,L,PIT,32,82,10,15,25
55,8478133,Jake Evans,C,MTL,28,82,9,16,25
55,8480802,Ryan McLeod,C,BUF,25,82,8,17,25
55,8480246,Nick Perbix,D,TBL,26,82,8,17,25
55,8478468,Jeremy Lauzon,D,NSH,27,82,6,19,25
55,8482122,Brock Faber,D,MIN,22,82,5,20,25
55,8480222,Sebastian Aho,D,PIT,28,82,5,20,25
55,8476525,Colin Miller,D,WPG,32,82,4,21,25
55,8480796,Martin Fehervary,D,WSH,25,82,2,23,25
55,8476879,Cody Ceci,D,EDM,31,82,1,24,25
55,8478507,John Marino,D,UTA,27,82,0,25,25
55,8483505,Matthew Poitras,C,BOS,20,82,13,11,24
55,8476469,Joel Armia,R,MTL,31,82,12,12,24
55,8475193,Tomas Tatar,L,NJD,34,82,12,12,24
55,8479353,Brett Howden,C,VGK,26,82,11,13,24
55,8480870,Bo Groulx,C,NYR,24,82,11,13,24
55,8477931,Tomas Nosek,L,FLA,32,82,9,15,24
55,8482141,Lukas Cormier,D,VGK,22,82,9,15,24
55,8480003,Jesper Boqvist,C,FLA,26,82,8,16,24
55,8477220,Nate Schmidt,D,FLA,33,82,8,16,24
55,8481522,Peyton Krebs,C,BUF,23,82,8,16,24
55,8481553,Bobby Brink,R,PHI,23,82,7,17,24
55,8475324,Nick Jensen,D,OTT,34,82,6,18,24
55,8477369,Carson Soucy,D,VAN,30,82,5,19,24
55,8477845,Trevor van Riemsdyk,D,WSH,33,82,3,21,24
55,8480035,Henri Jokiharju,D,BUF,25,82,2,22,24
55,8474673,TJ Brodie,D,CHI,34,82,0,24,24
55,8483524,Shane Wright,C,SEA,20,82,13,10,23
55,8477903,Garnet Hathaway,R,PHI,33,82,11,12,23
55,8483482,Tristan Luneau,D,ANA,20,82,10,13,23
55,8474716,Jared Spurgeon,D,MIN,35,82,7,16,23
55,8482073,Braden Schneider,D,NYR,23,82,5,18,23
55,8481567,Henry Thrun,D,SJS,23,82,5,18,23
55,8478136,Jake Middleton,D,MIN,28,82,5,18,23
55,8478416,Erik Cernak,D,TBL,27,82,3,20,23
55,8474574,Tyler Myers,D,VAN,34,82,2,21,23
55,8477425,Miles Wood,L,COL,29,82,11,11,22
55,8484145,Zach Benson,L,BUF,19,82,11,11,22
55,8477353,Tyler Motte,C,DET,29,82,10,12,22
55,8483763,Maksymilian Szuber,D,UTA,22,82,10,12,22
55,8483457,Lane Hutson,D,MTL,20,82,7,15,22
55,8477435,Ryan Graves,D,PIT,29,82,7,15,22
55,8475690,Chris Tanev,D,TOR,35,82,4,18,22
55,8480950,Ilya Lyubushkin,D,DAL,30,82,4,18,22
55,8473507,Jeff Petry,D,DET,37,82,3,19,22
55,8476967,Brett Kulak,D,EDM,30,82,0,22,22
55,8479414,Nathan Bastian,R,NJD,27,82,16,5,21
55,8479941,Justin Danforth,R,CBJ,31,82,13,8,21
55,8478432,Christian Fischer,R,DET,27,82,11,10,21
55,8476374,Sean Kuraly,C,CBJ,31,82,10,11,21
55,8483565,Nick Blankenburg,D,NSH,26,82,7,14,21
55,8477507,Nikita Zadorov,D,BOS,29,82,5,16,21
55,8479324,Ryan Lindgren,D,NYR,26,82,4,17,21
55,8481606,Jordan Spence,D,LAK,23,82,3,18,21
55,8475181,Nick Leddy,D,STL,33,82,2,19,21
55,8481601,Simon Holmstrom,R,NYI,23,82,14,6,20
55,8476878,Zemgus Girgensons,L,TBL,30,82,13,7,20
55,8484166,Adam Fantilli,C,CBJ,20,82,12,8,20
55,8479661,Tanner Jeannot,L,LAK,27,82,10,10,20
55,8481704,Juuso Parssinen,C,NSH,23,82,8,12,20
55,8476858,Phillip Di Giuseppe,L,VAN,31,82,8,12,20
55,8480025,MacKenzie Entwistle,R,FLA,25,82,7,13,20
55,8479393,Noah Gregor,C,OTT,26,82,6,14,20
55,8479980,Nicolas Hague,D,VGK,26,82,6,14,20
55,8478399,Jonas Siegenthaler,D,NJD,27,82,5,15,20
55,8482803,Olen Zellweger,D,ANA,21,82,5,15,20
55,8478840,Will Borgen,D,SEA,28,82,5,15,20
55,8475233,David Savard,D,MTL,34,82,5,15,20
55,8481014,Alexander Romanov,D,NYI,24,82,4,16,20
55,8480860,Kevin Bahl,D,CGY,24,82,4,16,20
55,8482809,Jackson Blake,R,CAR,21,82,3,17,20
55,8482702,Logan Stankoven,C,DAL,21,82,12,7,19
55,8480813,Joe Veleno,C,DET,24,82,10,9,19
55,8482062,Cole Smith,L,NSH,29,82,8,11,19
55,8478434,Keegan Kolesar,R,VGK,27,82,7,12,19
55,8483499,Liam Ohgren,L,MIN,20,82,6,13,19
55,8480807,Mattias Samuelsson,D,BUF,24,82,5,14,19
55,8482666,Scott Morrow,D,CAR,22,82,4,15,19
55,8475188,Brayden McNabb,D,VGK,33,82,3,16,19
55,8479998,Mikey Anderson,D,LAK,25,82,2,17,19
55,8476822,Luke Glendening,C,TBL,35,82,11,7,18
55,8477839,Conor Sheary,L,TBL,32,82,9,9,18
55,8475231,Casey Cizikas,C,NYI,33,82,9,9,18
55,8479638,Justin Brazeau,R,BOS,26,82,8,10,18
55,8482712,Oskar Olausson,R,COL,22,82,5,13,18
55,8479983,Mario Ferraro,D,SJS,26,82,4,14,18
55,8475279,Ben Chiarot,D,DET,33,82,4,14,18
55,8476429,Scott Mayfield,D,NYI,32,82,4,14,18
55,8482516,Matthew Kessel,D,STL,24,82,4,14,18
55,8475790,Erik Gudbranson,D,CBJ,32,82,3,15,18
55,8483490,Pavel Mintyukov,D,ANA,21,82,2,16,18
55,8477034,Jaycob Megna,D,FLA,32,82,2,16,18
55,8477335,Kyle Burroughs,D,LAK,29,82,2,16,18
55,8483468,Jiri Kulich,C,BUF,20,82,10,7,17
55,8477508,Curtis Lazar,C,NJD,29,82,9,8,17
55,8475842,Sam Carrick,C,NYR,32,82,8,9,17
55,8483493,Frank Nazar,C,CHI,20,82,8,9,17
55,8480990,Declan Chisholm,D,MIN,24,82,7,10,17
55,8482166,Shakir Mukhamadullin,D,SJS,22,82,6,11,17
55,8475177,Calvin de Haan,D,COL,33,82,5,12,17
55,8478178,Darren Raddysh,D,TBL,28,82,4,13,17
55,8481641,Joel Kiviranta,L,COL,28,82,4,13,17
55,8482470,Ilya Solovyov,D,CGY,24,82,4,13,17
55,8476372,Nick Seeler,D,PHI,31,82,4,13,17
55,8480172,Jan Rutta,D,SJS,34,82,3,14,17
55,8483495,Simon Nemec,D,NJD,20,82,3,14,17
55,8474090,Brendan Smith,D,DAL,35,82,1,16,17
55,8480834,Ty Emberson,D,SJS,24,82,0,17,17
55,8480021,Jack Studnicka,C,LAK,25,82,12,4,16
55,8473453,Trevor Lewis,C,LAK,37,82,9,7,16
55,8480806,Isac Lundestrom,C,ANA,25,82,8,8,16
55,8477505,Alexander Wennberg,C,SJS,30,82,7,9,16
55,8481524,Bowen Byram,D,BUF,23,82,6,10,16
55,8481028,Martin Pospisil,C,CGY,25,82,5,11,16
55,8484911,Collin Graf,R,SJS,22,82,5,11,16
55,8484149,Gavin Brindley,C,CBJ,20,82,5,11,16
55,8482858,Ryker Evans,D,SEA,23,82,3,13,16
55,8483466,Kevin Korchinski,D,CHI,20,82,2,14,16
55,8478859,Niko Mikkola,D,FLA,28,82,1,15,16
55,8483012,Logan Morrison,C,SEA,22,82,11,4,15
55,8482762,Simon Edvinsson,D,DET,21,82,8,7,15
55,8483445,Cutter Gauthier,L,ANA,20,82,5,10,15
55,8476891,Matt Grzelcyk,D,PIT,30,82,4,11,15
55,8476457,Adam Larsson,D,SEA,32,82,3,12,15
55,8475718,Justin Holl,D,DET,32,82,2,13,15
55,8483460,David Jiricek,D,CBJ,21,82,7,7,14
55,8482659,Josh Doan,R,UTA,22,82,6,8,14
55,8479576,Vincent Desharnais,D,VAN,28,82,4,10,14
55,8475455,Brenden Dillon,D,NJD,34,82,3,11,14
55,8475762,Derek Forbort,D,VAN,32,82,3,11,14
55,8481122,Simon Benoit,D,TOR,26,82,2,12,14
55,8476473,Connor Murphy,D,CHI,31,82,0,14,14
55,8482155,Alex Laferriere,R,LAK,23,82,9,4,13
55,8479359,Beck Malenstyn,L,BUF,26,82,8,5,13
55,8481517,Brett Leason,R,ANA,25,82,8,5,13
55,8479291,Kevin Rooney,C,CGY,31,82,6,7,13
55,8482749,Joshua Roy,R,MTL,21,82,6,7,13
55,8481699,Aku Raty,R,UTA,23,82,6,7,13
55,8477499,Rasmus Ristolainen,D,PHI,30,82,5,8,13
55,8482679,Matt Coronato,R,CGY,22,82,5,8,13
55,8471677,Jack Johnson,D,CBJ,37,82,5,8,13
55,8482859,Zack Ostapchuk,C,OTT,21,82,4,9,13
55,8478443,Brandon Carlo,D,BOS,28,82,3,10,13
55,8483567,Georgii Merkulov,C,BOS,24,82,2,11,13
55,8479369,Andrew Peeke,D,BOS,26,82,1,12,13
55,8474612,Travis Hamonic,D,OTT,34,82,1,12,13
55,8482713,Mackie Samoskevich,R,FLA,22,82,4,8,12
55,8479442,Troy Stecher,D,EDM,30,82,3,9,12
55,8481605,Jackson LaCombe,D,ANA,23,82,3,9,12
55,8482787,Nikita Chibrikov,R,WPG,31,82,3,9,12
55,8480879,Jacob Bernard-Docker,D,OTT,24,82,2,10,12
55,8478882,Vladislav Gavrikov,D,LAK,29,82,0,12,12
55,8482101,Danil Gushchin,L,SJS,22,82,7,4,11
55,8483471,Brad Lambert,C,WPG,31,82,4,7,11
55,8478450,Parker Wotherspoon,D,BOS,27,82,3,8,11
55,8482733,Logan Mailloux,D,MTL,31,82,2,9,11
55,8478874,Adam Gaudette,C,OTT,28,82,1,10,11
55,8482118,Sam Colangelo,R,ANA,23,82,1,10,11
55,8482145,Mavrik Bourque,C,DAL,22,82,5,5,10
55,8482153,Brendan Brisson,C,VGK,23,82,5,4,9
55,8483489,Fraser Minten,C,TOR,31,82,2,7,9
55,8482070,Mitchell Chaffee,R,TBL,26,82,7,1,8
55,8476441,Joel Edmundson,D,LAK,31,82,0,8,8
55,8474567,Zach Bogosian,D,MIN,34,82,2,5,7
55,8483397,Marc McLaughlin,C,BOS,25,82,1,6,7
55,8474062,Riley Nash,C,NYR,35,82,2,2,4
55,8470794,Joe Pavelski,C,,40,0,0,0,0
55,8481703,Valtteri Puustinen,R,PIT,25,0,0,0,0
55,8477950,Tony DeAngelo,D,,29,0,0,0,0
55,8481577,Philip Tomasino,C,NSH,23,0,0,0,0
55,8475197,Tyson Barrie,D,,33,0,0,0,0
55,8471218,Blake Wheeler,R,,38,0,0,0,0
55,8474157,Max Pacioretty,L,,36,0,0,0,0
55,8478466,Daniel Sprong,R,VAN,27,0,0,0,0
55,8475744,Evgeny Kuznetsov,C,,32,0,0,0,0
55,8481019,David Gustafsson,C,WPG,24,0,0,0,0
55,8475906,John Klingberg,D,,32,0,0,0,0
55,8479348,Kale Clague,D,BUF,26,0,0,0,0
55,8476952,Dominic Toninato,C,WPG,30,0,0,0,0
55,8473473,Milan Lucic,L,,36,0,0,0,0
55,8474037,James van Riemsdyk,L,,35,0,0,0,0
55,8474602,Justin Schultz,D,,34,0,0,0,0
55,8482222,Alexander Barabanov,L,,30,0,0,0,0
55,8479372,Josh Mahura,D,SEA,26,0,0,0,0
55,8479982,Conor Timmins,D,TOR,26,0,0,0,0
55,8474031,Kevin Shattenkirk,D,,35,0,0,0,0
55,8480008,Adam Ruzicka,C,,25,0,0,0,0
55,8481059,Scott Perunovich,D,STL,26,0,0,0,0
55,8480884,Calen Addison,D,,24,0,0,0,0
55,8476994,Vinnie Hinostroza,C,NSH,30,0,0,0,0
55,8478452,Caleb Jones,D,LAK,27,0,0,0,0
55,8480157,Calle Rosen,D,COL,30,0,0,0,0
55,8481609,Vladislav Kolyachonok,D,UTA,23,0,0,0,0
55,8479415,Michael McLeod,C,,26,0,0,0,0
55,8476919,Chris Tierney,C,,30,0,0,0,0
55,8479639,Dylan Coghlan,D,WPG,26,0,0,0,0
55,8478146,Matthew Highmore,C,OTT,28,0,0,0,0
55,8478970,Jalen Chatfield,D,CAR,28,0,0,0,0
55,8480205,Emil Bemstrom,C,PIT,25,0,0,0,0
55,8474884,Mike Hoffman,C,,35,0,0,0,0
55,8471274,Alex Goligoski,D,,39,0,0,0,0
55,8478104,Sammy Blais,L,,28,0,0,0,0
55,8474870,Tyler Johnson,C,,34,0,0,0,0
55,8476913,Devin Shore,C,MIN,30,0,0,0,0
55,8481598,Philip Broberg,D,EDM,23,0,0,0,0
55,8480058,Pierre-Olivier Joseph,D,STL,25,0,0,0,0
55,8480891,Michael Kesselring,D,UTA,24,0,0,0,0
55,8477979,Nicolas Aube-Kubel,R,BUF,28,0,0,0,0
55,8476871,Tanner Pearson,L,,32,0,0,0,0
55,8476393,Nick Cousins,C,,31,0,0,0,0
55,8479977,Kailer Yamamoto,R,,26,0,0,0,0
55,8479543,Michael Pezzetta,L,MTL,26,0,0,0,0
55,8477018,Ben Hutton,D,VGK,31,0,0,0,0
55,8480762,Eric Robinson,L,CAR,29,0,0,0,0
55,8474034,Pat Maroon,L,CHI,36,0,0,0,0
55,8481058,Jesse Ylönen,R,,25,0,0,0,0
55,8475179,Dmitry Kulikov,D,FLA,34,0,0,0,0
55,8481527,Kaedan Korczak,D,VGK,23,0,0,0,0
55,8473449,Kyle Okposo,R,,36,0,0,0,0
55,8482192,Isaak Phillips,D,CHI,23,0,0,0,0
55,8480727,Zach Whitecloud,D,VGK,28,0,0,0,0
55,8479346,Dillon Dube,C,,26,0,0,0,0
55,8480821,Filip Zadina,R,,25,0,0,0,0
55,8480001,Urho Vaakanainen,D,ANA,25,0,0,0,0
55,8470966,Mark Giordano,D,,41,0,0,0,0
55,8480853,Liam Foudy,C,,24,0,0,0,0
55,8475225,Craig Smith,C,CHI,35,0,0,0,0
55,8479972,Mason Shaw,C,WPG,26,0,0,0,0
55,8478451,Ethan Bear,D,WSH,27,0,0,0,0
55,8474040,Sam Gagner,C,,35,0,0,0,0
55,8480196,Jacob Bryson,D,BUF,27,0,0,0,0
55,8479984,Cal Foote,D,,26,0,0,0,0
55,8480011,Klim Kostin,C,SJS,25,0,0,0,0
55,8482176,Wyatt Kaiser,D,CHI,22,0,0,0,0
55,8476988,Matt Benning,D,SJS,30,0,0,0,0
55,8479370,Tyson Jost,C,CAR,26,0,0,0,0
55,8477464,Nic Petan,C,,29,0,0,0,0
55,8477380,Jonny Brodzinski,C,NYR,31,0,0,0,0
55,8480070,Ian Mitchell,D,BOS,25,0,0,0,0
55,8479315,Joey Anderson,R,CHI,26,0,0,0,0
55,8478099,Kevin Labanc,R,,29,0,0,0,0
55,8476874,Olli Maatta,D,DET,30,0,0,0,0
55,8475208,Brian Dumoulin,D,ANA,33,0,0,0,0
55,8478430,Oliver Kylington,D,,27,0,0,0,0
55,8479536,Axel Jonsson-Fjallby,L,WPG,26,0,0,0,0
55,8479671,Mathieu Olivier,R,CBJ,27,0,0,0,0
55,8471709,Marc-Edouard Vlasic,D,SJS,37,0,0,0,0
55,8479328,Julien Gauthier,R,NYI,27,0,0,0,0
55,8478421,A.J. Greer,L,FLA,28,0,0,0,0
55,8477573,Nathan Walker,L,STL,30,0,0,0,0
55,8481537,Nikita Okhotiuk,D,CGY,24,0,0,0,0
55,8474166,Alec Martinez,D,CHI,37,0,0,0,0
55,8470610,Zach Parise,L,,40,0,0,0,0
55,8477478,William Carrier,L,CAR,30,0,0,0,0
55,8479344,Jesse Puljujarvi,R,PIT,26,0,0,0,0
55,8480887,Jordan Harris,D,MTL,24,0,0,0,0
55,8478502,Dennis Gilbert,D,BUF,28,0,0,0,0
55,8482730,Brandt Clarke,D,LAK,21,0,0,0,0
55,8480355,Mark Kastelic,C,BOS,25,0,0,0,0
55,8475750,Jon Merrill,D,MIN,32,0,0,0,0
55,8475164,Jakob Silfverberg,R,,34,0,0,0,0
55,8477944,Jakub Vrana,L,,28,0,0,0,0
55,8479439,Jacob MacDonald,D,COL,31,0,0,0,0
55,8474568,Luke Schenn,D,NSH,35,0,0,0,0
55,8478454,Noah Juulsen,D,VAN,27,0,0,0,0
55,8475752,Tyler Pitlick,C,,33,0,0,0,0
55,8482148,Hendrix Lapierre,C,WSH,22,0,0,0,0
55,8481167,Brayden Pachal,D,CGY,25,0,0,0,0
55,8478043,Sam Lafferty,C,BUF,29,0,0,0,0
55,8479321,Lucas Johansen,D,,27,0,0,0,0
55,8471699,Andrew Cogliano,C,,37,0,0,0,0
55,8481521,Ronnie Attard,D,PHI,25,0,0,0,0
55,8481161,Jake Christiansen,D,CBJ,25,0,0,0,0
55,8479458,Nikita Zaitsev,D,,33,0,0,0,0
55,8479619,Michael Carcone,L,UTA,28,0,0,0,0
55,8479026,Philippe Myers,D,TOR,27,0,0,0,0
55,8477330,Dominik Kubalik,L,,29,0,0,0,0
55,8481617,Vasily Podkolzin,R,VAN,23,0,0,0,0
55,8481701,Santeri Hatakka,D,NJD,23,0,0,0,0
55,8479514,Rem Pitlick,C,,27,0,0,0,0
55,8477446,Michael McCarron,R,NSH,29,0,0,0,0
55,8470604,Jeff Carter,C,,39,0,0,0,0
55,8482241,Radim Zohorna,L,,28,0,0,0,0
55,8480289,Morgan Barron,C,WPG,26,0,0,0,0
55,8479379,Givani Smith,R,SJS,26,0,0,0,0
55,8480216,Jacob Peterson,C,,25,0,0,0,0
55,8477851,Jordan Oesterle,D,BOS,32,0,0,0,0
55,8484258,Sam Malinski,D,COL,26,0,0,0,0
55,8478904,Steven Lorentz,C,,28,0,0,0,0
55,8482095,Tyler Kleven,D,OTT,22,0,0,0,0
55,8480848,Ty Dellandrea,C,SJS,24,0,0,0,0
55,8476884,Derrick Pouliot,D,,30,0,0,0,0
55,8479336,Carl Grundstrom,R,SJS,27,0,0,0,0
55,8482964,Arber Xhekaj,D,MTL,23,0,0,0,0
55,8471686,Marc Staal,D,,37,0,0,0,0
55,8477887,Patrick Brown,C,BOS,32,0,0,0,0
55,8478495,Denis Gurianov,R,,27,0,0,0,0
55,8473504,Cal Clutterbuck,R,,37,0,0,0,0
55,8481550,Adam Beckman,L,NJD,23,0,0,0,0
55,8480845,Rasmus Kupari,C,WPG,24,0,0,0,0
55,8474009,Nick Bonino,C,,36,0,0,0,0
55,8478585,Derek Ryan,C,EDM,38,0,0,0,0
55,8477962,Brendan Lemieux,L,CAR,28,0,0,0,0
55,8482861,Vincent Iorio,D,WSH,22,0,0,0,0
55,8479378,Logan Stanley,D,WPG,26,0,0,0,0
55,8473446,Erik Johnson,D,PHI,36,0,0,0,0
55,8481743,Marc Del Gaizo,D,NSH,25,0,0,0,0
55,8477384,Josh Brown,D,EDM,30,0,0,0,0
55,8482165,Yan Kuznetsov,D,CGY,22,0,0,0,0
55,8478424,Jansen Harkins,C,ANA,27,0,0,0,0
55,8482144,Jack Thompson,D,SJS,22,0,0,0,0
55,8478512,Austin Czarnik,C,,32,0,0,0,0
55,8477527,Ross Johnston,L,ANA,30,0,0,0,0
55,8479383,Boris Katchouk,L,,26,0,0,0,0
55,8482094,Daemon Hunt,D,MIN,22,0,0,0,0
55,8481719,Maxwell Crozier,D,TBL,24,0,0,0,0
55,8480192,Johnathan Kovacevic,D,NJD,27,0,0,0,0
55,8479376,Victor Mete,D,,26,0,0,0,0
55,8482511,Mason Lohrei,D,BOS,23,0,0,0,0
55,8475825,Jani Hakanpää,D,,32,0,0,0,0
55,8478021,William Lagesson,D,DET,28,0,0,0,0
55,8475795,Dylan McIlrath,D,WSH,32,0,0,0,0
55,8477846,Ryan Carpenter,C,,33,0,0,0,0
55,8481056,Spencer Stastney,D,NSH,24,0,0,0,0
55,8481564,Ryan Johnson,D,BUF,23,0,0,0,0
55,8478017,Mark Friedman,D,VAN,29,0,0,0,0
55,8479320,Max Lajoie,D,SEA,27,0,0,0,0
55,8480075,Cameron Crotty,D,MIN,25,0,0,0,0
55,8484287,Cole McWard,D,VAN,23,0,0,0,0
55,8484254,Akito Hirose,D,VAN,25,0,0,0,0
55,8483407,Brandon Scanlin,D,NYR,25,0,0,0,0
55,8480274,Philip Kemp,D,EDM,25,0,0,0,0
55,8479522,Hardy Haman Aktell,D,WSH,26,0,0,0,0
55,8480007,Jonas Rondbjerg,R,VGK,25,0,0,0,0
55,8477454,Adam Erne,L,,29,0,0,0,0
55,8481679,Maxence Guenette,D,OTT,23,0,0,0,0
55,8480441,Trey Fix-Wolansky,R,CBJ,25,0,0,0,0
55,8483546,Marshall Rifai,D,TOR,26,0,0,0,0
55,8480084,Nick DeSimone,D,NJD,30,0,0,0,0
55,8481030,Jack St. Ivany,D,PIT,25,0,0,0,0
55,8481592,Jakob Pelletier,L,CGY,23,0,0,0,0
55,8478011,Louie Belpedio,D,PHI,28,0,0,0,0
55,8477930,Pierre-Edouard Bellemare,L,,39,0,0,0,0
55,8484321,Nikolas Matinpalo,D,OTT,26,0,0,0,0
55,8482067,Connor Mackey,D,NYR,28,0,0,0,0
55,8481806,Louis Crevier,D,CHI,23,0,0,0,0
55,8484326,Patrik Koch,D,UTA,28,0,0,0,0
55,8477971,Andreas Englund,D,LAK,28,0,0,0,0
55,8481751,Lukas Rousek,R,BUF,25,0,0,0,0
55,8481006,Tyler Tucker,D,STL,24,0,0,0,0
55,8476867,Brendan Gaunce,C,MIN,30,0,0,0,0
55,8479520,Brandon Duhaime,R,WSH,27,0,0,0,0
55,8477073,Kurtis MacDermid,L,NJD,30,0,0,0,0
55,8480874,Adam Ginning,D,PHI,24,0,0,0,0
55,8477473,Justin Bailey,R,SJS,29,0,0,0,0
55,8479066,Ryan Lomberg,L,CGY,30,0,0,0,0
55,8477070,Liam O'Brien,C,UTA,30,0,0,0,0
55,8474618,Marco Scandella,D,,34,0,0,0,0
55,8475797,Jarred Tinordi,D,,32,0,0,0,0
55,8481441,Joe Snively,C,DET,28,0,0,0,0
55,8477244,Chad Ruhwedel,D,NYR,34,0,0,0,0
55,8479772,Zack MacEwen,R,OTT,28,0,0,0,0
55,8481147,Reese Johnson,C,MIN,26,0,0,0,0
55,8481043,Cole Koepke,L,BOS,26,0,0,0,0
55,8483619,Filip Roos,D,OTT,25,0,0,0,0
55,8481541,Samuel Bolduc,D,NYI,24,0,0,0,0
55,8477810,Joel Hanley,D,CGY,33,0,0,0,0
55,8476907,Mackenzie MacEachern,L,,30,0,0,0,0
55,8482652,Walker Duehr,R,CGY,27,0,0,0,0
55,8477126,Jayson Megna,C,,34,0,0,0,0
55,8483398,Declan Carlile,D,TBL,31,0,0,0,0
55,8482929,Emil Lilleberg,D,TBL,23,0,0,0,0
55,8480880,Jakub Lauko,C,MIN,24,0,0,0,0
55,8480245,Olle Lycksell,R,PHI,25,0,0,0,0
55,8480252,Cole Guttman,C,CHI,25,0,0,0,0
55,8477467,Gustav Olofsson,D,SEA,30,0,0,0,0
55,8479968,Vinni Lettieri,C,BOS,29,0,0,0,0
55,8478400,Colin White,C,,27,0,0,0,0
55,8475755,Alexander Petrovic,D,DAL,32,0,0,0,0
55,8481812,Nikolai Knyzhov,D,,27,0,0,0,0
55,8481593,Jayden Struble,D,MTL,23,0,0,0,0
55,8481532,Alex Turcotte,C,LAK,23,0,0,0,0
55,8482126,Emil Andrae,D,PHI,31,0,0,0,0
55,8479944,Zach Aston-Reese,C,VGK,30,0,0,0,0
55,8471817,Ryan Reaves,R,TOR,37,0,0,0,0
55,8481206,John Ludvig,D,PIT,24,0,0,0,0
55,8481599,Victor Soderstrom,D,UTA,23,0,0,0,0
55,8480292,Carson Meyer,R,ANA,27,0,0,0,0
55,8482496,Nils Aman,C,VAN,24,0,0,0,0
55,8479718,Alex Barré-Boulet,C,MTL,27,0,0,0,0
55,8479994,Jaret Anderson-Dolan,C,WPG,25,0,0,0,0
55,8480184,Gustav Lindstrom,D,,26,0,0,0,0
55,8480890,Jan Jenik,R,OTT,24,0,0,0,0
55,8478067,Oskar Lindblom,L,,28,0,0,0,0
55,8476934,Brock McGinn,L,ANA,30,0,0,0,0
55,8479985,Cale Fleury,D,SEA,26,0,0,0,0
55,8484304,Uvis Balinskis,D,FLA,28,0,0,0,0
55,8479981,Jonah Gadjovich,L,FLA,26,0,0,0,0
55,8481716,Dmitri Voronkov,L,CBJ,24,0,0,0,0
55,8474709,Matt Martin,L,,35,0,0,0,0
55,8482634,Alex Steeves,C,TOR,25,0,0,0,0
55,8480823,Alexander Alexeyev,D,WSH,25,0,0,0,0
55,8477541,Dakota Mermis,D,TOR,30,0,0,0,0
55,8483491,Ivan Miroshnichenko,L,WSH,20,0,0,0,0
55,8478477,Mitchell Stephens,C,SEA,27,0,0,0,0
55,8481543,Nikita Alexandrov,C,STL,24,0,0,0,0
55,8479423,Alex Nylander,L,,26,0,0,0,0
55,8482451,Mikael Pyyhtia,L,CBJ,23,0,0,0,0
55,8478831,Kevin Stenlund,C,UTA,28,0,0,0,0
55,8480306,Grant Hutton,D,NYI,29,0,0,0,0
55,8478028,Fredrik Olofsson,L,,28,0,0,0,0
55,8477462,Robert Hagg,D,VGK,29,0,0,0,0
55,8477320,Anton Blidh,L,NYR,29,0,0,0,0
55,8482157,Will Cuylle,L,NYR,22,0,0,0,0
55,8482737,Zack Bolduc,C,STL,21,0,0,0,0
55,8481239,Samuel Fagemo,L,,24,0,0,0,0
55,8481600,Tobias Bjornfot,D,FLA,23,0,0,0,0
55,8478409,Anthony Richard,C,PHI,28,0,0,0,0
55,8474145,Robert Bortuzzo,D,,35,0,0,0,0
55,8475958,Michael Sgarbossa,C,WSH,32,0,0,0,0
55,8479986,Kole Lind,R,DAL,26,0,0,0,0
55,8479249,Andrew Poturalski,C,SJS,30,0,0,0,0
55,8479362,Riley Tufte,L,BOS,26,0,0,0,0
55,8479991,Jake Leschyshyn,C,NYR,25,0,0,0,0
55,8479587,Rhett Gardner,C,PHI,28,0,0,0,0
55,8482744,James Malatesta,L,CBJ,21,0,0,0,0
55,8478854,Ryan Shea,D,PIT,27,0,0,0,0
55,8481591,Sam Poulin,R,,23,0,0,0,0
55,8483512,Matt Savoie,C,EDM,20,0,0,0,0
55,8482102,Vasily Ponomarev,C,PIT,22,0,0,0,0
55,8482162,Roby Jarventie,L,EDM,22,0,0,0,0
55,8481016,Ruslan Iskhakov,C,,24,0,0,0,0
55,8482172,Landon Slaggert,L,CHI,22,0,0,0,0
55,8482747,Brennan Othmann,L,NYR,21,0,0,0,0
55,8480031,Maxime Comtois,L,,25,0,0,0,0
55,8480226,Marián Studenic,R,,26,0,0,0,0
55,8478408,Travis Dermott,D,,28,0,0,0,0
55,8481518,Nolan Foote,L,NJD,24,0,0,0,0
55,8479419,Brett Murray,L,BUF,26,0,0,0,0
55,8482088,Justin Sourdif,R,FLA,22,0,0,0,0
55,8482201,Gage Goncalves,C,TBL,23,0,0,0,0
55,8481578,Graeme Clarke,R,MIN,23,0,0,0,0
55,8482177,Marat Khusnutdinov,C,MIN,22,0,0,0,0
55,8481754,Nikita Nesterenko,C,ANA,23,0,0,0,0
55,8483531,Brian Halonen,L,NJD,25,0,0,0,0
55,8483920,Pierrick Dube,R,WSH,23,0,0,0,0
55,8480851,Akil Thomas,C,LAK,24,0,0,0,0
55,8475235,Nicolas Deslauriers,L,PHI,33,0,0,0,0
55,8482476,Emil Heineman,L,MTL,23,0,0,0,0
55,8477149,Scott Sabourin,R,SJS,32,0,0,0,0
55,8483549,Lucas Condotta,L,MTL,27,0,0,0,0
55,8482765,Isak Rosen,R,BUF,21,0,0,0,0
55,8481237,Kyle MacLean,C,NYI,25,0,0,0,0
55,8481024,Linus Karlsson,C,VAN,25,0,0,0,0
55,8481690,Tyler Angle,C,,24,0,0,0,0
55,8483570,Ben Meyers,C,SEA,26,0,0,0,0
55,8481655,Cole Schwindt,R,CGY,23,0,0,0,0
55,8481462,Mason Morelli,L,VGK,28,0,0,0,0
55,8483401,Marc Johnstone,R,PIT,28,0,0,0,0
55,8478956,Samuel Laberge,L,NJD,27,0,0,0,0
55,8479533,Joona Koppanen,L,,26,0,0,0,0
55,8482197,Adam Raska,R,MIN,23,0,0,0,0
55,8482250,Callahan Burke,C,VGK,27,0,0,0,0
55,8482784,Zach Dean,C,STL,21,0,0,0,0
55,8484255,Jason Polin,R,COL,25,0,0,0,0
55,8481077,John Leonard,L,,26,0,0,0,0
55,8481534,Raphael Lavoie,C,EDM,24,0,0,0,0
55,8483609,Adam Klapka,R,CGY,24,0,0,0,0
55,8482751,Ryan Winterton,C,SEA,21,0,0,0,0
55,8480267,Sammy Walker,C,MIN,25,0,0,0,0
55,8475766,Austin Watson,L,,32,0,0,0,0
55,8482460,Matt Rempe,C,NYR,22,0,0,0,0
55,8481065,Angus Crookshank,L,OTT,25,0,0,0,0
55,8481070,Hugh McGing,L,,26,0,0,0,0
55,8476323,Max McCormick,L,SEA,32,0,0,0,0
55,8483395,Arshdeep Bains,L,VAN,23,0,0,0,0
55,8484259,Ondrej Pavel,C,COL,31,0,0,0,0
55,8483432,Luca Del Bel Belluz,C,CBJ,31,0,0,0,0
55,8483045,Cameron Butler,R,CBJ,31,0,0,0,0
55,8482061,Brandon Biro,L,SEA,26,0,0,0,0
55,8477401,John Hayden,C,SEA,29,0,0,0,0
55,8475278,Byron Froese,C,,33,0,0,0,0
55,8478446,Glenn Gawdin,C,LAK,27,0,0,0,0
55,8477993,Justin Kirkland,C,CGY,28,0,0,0,0
55,8482147,Jean-Luc Foudy,C,COL,22,0,0,0,0
55,8480032,Shane Bowers,C,NJD,25,0,0,0,0
55,8479330,Brandon Gignac,C,MTL,27,0,0,0,0
55,8480776,Sheldon Rempal,R,,29,0,0,0,0
55,8475413,Justin Dowling,C,NJD,34,0,0,0,0
55,8481726,Adam Edstrom,C,NYR,24,0,0,0,0
55,8480844,Grigori Denisenko,L,VGK,24,0,0,0,0
55,8478147,Bokondji Imama,L,PIT,28,0,0,0,0
55,8478881,Brett Seney,L,CHI,28,0,0,0,0
55,8483630,Pavol Regenda,L,ANA,25,0,0,0,0
55,8480836,Jonathan Gruden,C,,24,0,0,0,0
55,8484314,Jiri Smejkal,L,,28,0,0,0,0
55,8475780,Chris Wagner,R,COL,33,0,0,0,0
55,8479546,Oskar Steen,C,,26,0,0,0,0
55,8483597,Milos Kelemen,L,UTA,25,0,0,0,0
55,8481789,Tye Kartye,L,SEA,23,0,0,0,0
55,8484325,Waltteri Merela,C,TBL,26,0,0,0,0
55,8479421,Jacob Moverare,D,LAK,26,0,0,0,0
55,8481585,Egor Afanasyev,L,SJS,23,0,0,0,0
55,8479547,Matthew Phillips,R,,26,0,0,0,0
55,8479367,William Lockwood,R,FLA,26,0,0,0,0
55,8476915,Jujhar Khaira,L,,30,0,0,0,0
55,8481422,Jacob Lucchini,C,NSH,29,0,0,0,0
55,8480468,James Hamblin,L,EDM,25,0,0,0,0
55,8478051,Max Willman,C,NJD,29,0,0,0,0
55,8481556,John Beecher,C,BOS,23,0,0,0,0
55,8478078,Rourke Chartier,C,,28,0,0,0,0
56,8479318,Auston Matthews,C,TOR,27,82,70,64,134
56,8478402,Connor McDavid,C,EDM,27,82,40,93,133
56,8476453,Nikita Kucherov,R,TBL,31,82,35,93,128
56,8477492,Nathan MacKinnon,C,COL,29,82,53,73,126
56,8481559,Jack Hughes,C,NJD,23,82,42,79,121
56,8479314,Matthew Tkachuk,L,FLA,27,82,33,88,121
56,8477956,David Pastrnak,R,BOS,28,82,53,66,119
56,8477939,William Nylander,R,TOR,28,82,53,64,117
56,8480012,Elias Pettersson,C,VAN,26,82,41,72,113
56,8477934,Leon Draisaitl,C,EDM,29,82,40,68,108
56,8478550,Artemi Panarin,L,NYR,33,82,32,75,107
56,8478420,Mikko Rantanen,R,COL,28,82,46,56,102
56,8477942,Kevin Fiala,L,LAK,28,82,37,65,102
56,8480023,Robert Thomas,C,STL,25,82,19,83,102
56,8477933,Sam Reinhart,C,FLA,29,82,45,56,101
56,8482116,Tim Stützle,C,OTT,22,82,37,63,100
56,8477493,Aleksander Barkov,C,FLA,29,82,31,69,100
56,8477404,Jake Guentzel,C,TBL,30,82,47,51,98
56,8478398,Kyle Connor,L,WPG,28,82,41,57,98
56,8471675,Sidney Crosby,C,PIT,37,82,43,52,95
56,8476887,Filip Forsberg,L,NSH,30,82,39,56,95
56,8476468,J.T. Miller,C,VAN,31,82,43,51,94
56,8475172,Nazem Kadri,C,CGY,34,82,35,59,94
56,8474600,Roman Josi,D,NSH,34,82,25,69,94
56,8474564,Steven Stamkos,C,NSH,34,82,42,51,93
56,8480069,Cale Makar,D,COL,26,82,26,67,93
56,8480800,Quinn Hughes,D,VAN,25,82,13,80,93
56,8479420,Tage Thompson,C,BUF,27,82,43,46,89
56,8479542,Brandon Hagel,L,TBL,26,82,35,54,89
56,8480027,Jason Robertson,L,DAL,25,82,28,60,88
56,8477409,Carter Verhaeghe,C,FLA,29,82,50,37,87
56,8478403,Jack Eichel,C,VGK,28,82,39,48,87
56,8477946,Dylan Larkin,C,DET,28,82,40,46,86
56,8478010,Brayden Point,C,TBL,28,82,38,48,86
56,8479407,Jesper Bratt,L,NJD,26,82,35,51,86
56,8476456,Jonathan Huberdeau,C,CGY,31,82,22,64,86
56,8475167,Victor Hedman,D,TBL,34,82,21,65,86
56,8471215,Evgeni Malkin,C,PIT,38,82,34,51,85
56,8480002,Nico Hischier,C,NJD,25,82,31,53,84
56,8476460,Mark Scheifele,C,WPG,31,82,28,56,84
56,8476346,Johnny Gaudreau,L,CBJ,31,82,16,68,84
56,8480801,Brady Tkachuk,L,OTT,25,82,35,48,83
56,8477496,Elias Lindholm,C,BOS,30,82,26,56,82
56,8478427,Sebastian Aho,C,CAR,27,82,29,52,81
56,8478519,Anthony Cirelli,C,TBL,27,82,37,42,79
56,8478445,Mathew Barzal,C,NYI,27,82,17,62,79
56,8471214,Alex Ovechkin,L,WSH,39,82,45,33,78
56,8480208,Drake Batherson,R,OTT,26,82,30,48,78
56,8481557,Matt Boldy,L,MIN,23,82,40,37,77
56,8478864,Kirill Kaprizov,L,MIN,27,82,37,40,77
56,8475166,John Tavares,C,TOR,34,82,34,43,77
56,8473512,Claude Giroux,R,OTT,36,82,23,53,76
56,8476448,William Karlsson,C,VGK,31,82,31,44,75
56,8475913,Mark Stone,R,VGK,32,82,24,51,75
56,8475754,Brock Nelson,C,NYI,33,82,45,29,74
56,8478449,Roope Hintz,C,DAL,28,82,34,40,74
56,8483808,Andrei Kuzmenko,L,CGY,28,82,34,39,73
56,8476881,Tomas Hertl,C,VGK,31,82,32,41,73
56,8471685,Anze Kopitar,C,LAK,37,82,26,47,73
56,8478440,Dylan Strome,C,WSH,27,82,20,53,73
56,8480839,Rasmus Dahlin,D,BUF,24,82,17,56,73
56,8477501,Valeri Nichushkin,R,COL,29,82,44,28,72
56,8473419,Brad Marchand,L,BOS,36,82,27,45,72
56,8479323,Adam Fox,D,NYR,26,82,13,59,72
56,8477949,Alex Tuch,R,BUF,28,82,30,41,71
56,8477402,Pavel Buchnevich,L,STL,29,82,24,47,71
56,8478444,Brock Boeser,R,VAN,27,82,33,37,70
56,8481533,Trevor Zegras,C,ANA,23,82,32,38,70
56,8475794,Tyler Seguin,C,DAL,32,82,31,39,70
56,8477960,Adrian Kempe,R,LAK,28,82,28,42,70
56,8476459,Mika Zibanejad,C,NYR,31,82,27,43,70
56,8475810,Bryan Rust,R,PIT,32,82,37,32,69
56,8480036,Miro Heiskanen,D,DAL,25,82,21,48,69
56,8474679,Gustav Nyquist,C,NSH,35,82,19,50,69
56,8476875,Mike Matheson,D,MTL,30,82,14,55,69
56,8478873,Troy Terry,R,ANA,27,82,33,35,68
56,8476539,Jonathan Marchessault,R,NSH,34,82,31,37,68
56,8479343,Clayton Keller,R,UTA,26,82,30,38,68
56,8475786,Zach Hyman,L,EDM,32,82,37,30,67
56,8477497,Sean Monahan,C,CBJ,30,82,30,37,67
56,8478493,Joel Eriksson Ek,C,MIN,27,82,29,38,67
56,8475158,Ryan O'Reilly,C,NSH,33,82,25,42,67
56,8482113,Anton Lundell,C,FLA,23,82,25,42,67
56,8477447,Shea Theodore,D,VGK,29,82,12,55,67
56,8478439,Travis Konecny,R,PHI,27,82,35,31,66
56,8475784,Jeff Skinner,C,EDM,32,82,35,31,66
56,8480830,Andrei Svechnikov,R,CAR,24,82,32,34,66
56,8479675,Trevor Moore,L,LAK,29,82,30,36,66
56,8477940,Nikolaj Ehlers,L,WPG,28,82,28,38,66
56,8480797,Joel Farabee,L,PHI,24,82,28,38,66
56,8475765,Vladimir Tarasenko,R,DET,33,82,23,43,66
56,8476454,Ryan Nugent-Hopkins,C,EDM,31,82,15,51,66
56,8477504,Josh Morrissey,D,WPG,29,82,14,52,66
56,8481523,Kirby Dach,C,MTL,23,82,12,54,66
56,8476389,Vincent Trocheck,C,NYR,31,82,25,40,65
56,8482078,Lucas Raymond,L,DET,22,82,23,42,65
56,8480865,Noah Dobson,D,NYI,24,82,16,49,65
56,8479337,Alex DeBrincat,R,DET,27,82,37,27,64
56,8474141,Patrick Kane,R,DET,36,82,25,39,64
56,8480188,Fabian Zetterlund,L,SJS,25,82,24,40,64
56,8476462,Dougie Hamilton,D,NJD,31,82,19,45,64
56,8473994,Jamie Benn,L,DAL,35,82,17,47,64
56,8474565,Alex Pietrangelo,D,VGK,34,82,16,48,64
56,8477346,MacKenzie Weegar,D,CGY,30,82,14,50,64
56,8476853,Morgan Rielly,D,TOR,30,82,9,55,64
56,8482159,Tyson Foerster,R,PHI,22,82,36,27,63
56,8482097,Jack Quinn,R,BUF,23,82,25,38,63
56,8481528,Dylan Cozens,C,BUF,23,82,23,40,63
56,8474578,Erik Karlsson,D,PIT,34,82,19,44,63
56,8479999,Casey Mittelstadt,C,COL,26,82,18,45,63
56,8475726,Tyler Toffoli,C,SJS,32,82,34,28,62
56,8477951,Nick Schmaltz,C,UTA,28,82,32,30,62
56,8478414,Timo Meier,R,NJD,28,82,32,30,62
56,8477479,Tyler Bertuzzi,L,CHI,29,82,22,40,62
56,8479345,Jakob Chychrun,D,WSH,26,82,18,44,62
56,8474590,John Carlson,D,WSH,34,82,13,49,62
56,8480014,Gabriel Vilardi,C,WPG,25,82,36,25,61
56,8482110,Dawson Mercer,C,NJD,23,82,28,33,61
56,8478042,Viktor Arvidsson,R,EDM,31,82,26,35,61
56,8480018,Nick Suzuki,C,MTL,25,82,26,35,61
56,8475168,Matt Duchene,C,DAL,33,82,20,41,61
56,8478407,Vince Dunn,D,SEA,28,82,15,46,61
56,8474102,David Perron,L,OTT,36,82,22,38,60
56,8477964,Ivan Barbashev,C,VGK,29,82,21,39,60
56,8476399,Blake Coleman,C,CGY,33,82,33,26,59
56,8478498,Jake DeBrusk,L,VAN,28,82,30,29,59
56,8480015,Owen Tippett,R,PHI,25,82,29,30,59
56,8479385,Jordan Kyrou,C,STL,26,82,27,32,59
56,8477500,Bo Horvat,C,NYI,29,82,27,32,59
56,8475692,Mats Zuccarello,R,MIN,37,82,18,41,59
56,8482667,William Eklund,L,SJS,22,82,16,43,59
56,8473986,Alex Killorn,L,ANA,35,82,29,29,58
56,8482093,Seth Jarvis,C,CAR,22,82,26,32,58
56,8477955,Jared McCann,L,SEA,28,82,25,33,58
56,8476880,Tom Wilson,R,WSH,30,82,25,33,58
56,8479400,Pierre-Luc Dubois,L,WSH,26,82,20,38,58
56,8477407,Anthony Duclair,L,NYI,29,82,20,38,58
56,8478396,Noah Hanifin,D,VGK,27,82,15,43,58
56,8478460,Zach Werenski,D,CBJ,27,82,14,44,58
56,8479425,Filip Hronek,D,VAN,27,82,14,44,58
56,8480803,Evan Bouchard,D,EDM,25,82,13,45,58
56,8475184,Chris Kreider,L,NYR,33,82,35,22,57
56,8477416,Oliver Bjorkstrand,R,SEA,29,82,33,24,57
56,8477935,Sam Bennett,C,FLA,28,82,32,25,57
56,8477426,Nicholas Paul,L,TBL,29,82,25,32,57
56,8476479,Phillip Danault,C,LAK,31,82,23,34,57
56,8475753,Justin Faulk,D,STL,32,82,16,41,57
56,8474563,Drew Doughty,D,LAK,35,82,14,43,57
56,8481540,Cole Caufield,R,MTL,23,82,27,29,56
56,8481618,Alex Newhook,C,MTL,23,82,27,29,56
56,8474586,Jordan Eberle,R,SEA,34,82,26,30,56
56,8475714,Calle Jarnkrok,C,TOR,33,82,25,31,56
56,8477476,Artturi Lehkonen,L,COL,29,82,24,32,56
56,8478047,Michael Bunting,L,PIT,29,82,22,34,56
56,8477932,Aaron Ekblad,D,FLA,28,82,13,43,56
56,8481068,Yegor Sharangovich,C,CGY,26,82,27,28,55
56,8476432,Boone Jenner,C,CBJ,31,82,33,21,54
56,8479339,Patrik Laine,L,CBJ,26,82,29,25,54
56,8475191,Reilly Smith,R,NYR,33,82,28,26,54
56,8478472,Mathieu Joseph,R,STL,27,82,20,34,54
56,8482124,Quinton Byfield,R,LAK,22,82,20,34,54
56,8482684,Luke Hughes,D,NJD,21,82,17,37,54
56,8474150,Mikael Backlund,C,CGY,35,82,16,38,54
56,8477494,Jonathan Drouin,L,COL,29,82,13,41,54
56,8476869,Brady Skjei,D,NSH,30,82,11,43,54
56,8479410,Mikhail Sergachev,D,UTA,26,82,11,43,54
56,8481560,Arthur Kaliyev,R,LAK,23,82,29,24,53
56,8475745,Charlie Coyle,C,BOS,32,82,24,29,53
56,8480039,Martin Necas,C,CAR,25,82,17,36,53
56,8482109,Alexis Lafrenière,L,NYR,23,82,29,23,52
56,8475169,Evander Kane,L,EDM,33,82,29,23,52
56,8481596,Shane Pinto,C,OTT,24,82,26,26,52
56,8478975,Mason Marchment,L,DAL,29,82,25,27,52
56,8475768,Jaden Schwartz,C,SEA,32,82,22,30,52
56,8478462,Nicolas Roy,C,VGK,27,82,22,30,52
56,8477986,Brandon Montour,D,SEA,30,82,18,34,52
56,8482745,Mason McTavish,C,ANA,21,82,23,28,51
56,8476905,Chandler Stephenson,C,SEA,30,82,14,37,51
56,8477503,Max Domi,C,TOR,29,82,13,38,51
56,8475170,Brayden Schenn,C,STL,33,82,24,26,50
56,8476474,Stefan Noesen,R,NJD,31,82,23,27,50
56,8471698,T.J. Oshie,R,WSH,38,82,19,31,50
56,8476958,Jaccob Slavin,D,CAR,30,82,14,36,50
56,8479325,Charlie McAvoy,D,BOS,27,82,10,40,50
56,8471724,Kris Letang,D,PIT,37,82,9,41,50
56,8475799,Nino Niederreiter,R,WPG,32,82,27,22,49
56,8477444,Andre Burakovsky,L,SEA,29,82,19,30,49
56,8475287,Erik Haula,L,NJD,33,82,18,31,49
56,8476458,Ryan Strome,C,ANA,31,82,14,35,49
56,8478397,Rasmus Andersson,D,CGY,28,82,9,40,49
56,8478020,Michael Amadio,C,OTT,28,82,26,22,48
56,8476483,Rickard Rakell,R,PIT,31,82,24,24,48
56,8473422,Nick Foligno,L,CHI,37,82,23,25,48
56,8477456,J.T. Compher,L,DET,29,82,22,26,48
56,8477998,Warren Foegele,L,LAK,28,82,20,28,48
56,8480185,Eetu Luostarinen,C,FLA,26,82,20,28,48
56,8478438,Tommy Novak,C,NSH,27,82,19,29,48
56,8482671,Owen Power,D,BUF,22,82,16,32,48
56,8478401,Pavel Zacha,C,BOS,27,82,15,33,48
56,8478469,Thomas Chabot,D,OTT,27,82,10,38,48
56,8482699,Dylan Guenther,R,UTA,21,82,24,23,47
56,8480064,Josh Norris,C,OTT,25,82,23,24,47
56,8481711,Matias Maccelli,L,UTA,24,82,18,29,47
56,8477451,Ryan Hartman,R,MIN,30,82,16,31,47
56,8478458,Jack Roslovic,C,CAR,27,82,13,34,47
56,8478055,Gustav Forsling,D,FLA,28,82,10,37,47
56,8475798,Mikael Granlund,C,SJS,32,82,9,38,47
56,8476438,Brandon Saad,L,STL,32,82,26,20,46
56,8478366,Frank Vatrano,R,ANA,30,82,24,22,46
56,8482740,Wyatt Johnston,C,DAL,21,82,22,24,46
56,8482660,Kent Johnson,C,CBJ,22,82,19,27,46
56,8476906,Shayne Gostisbehere,D,CAR,31,82,17,29,46
56,8480028,Morgan Frost,C,PHI,25,82,16,30,46
56,8478542,Evan Rodrigues,C,FLA,31,82,16,30,46
56,8482475,Yegor Chinakhov,R,CBJ,23,82,16,30,46
56,8476872,Scott Laughton,C,PHI,30,82,16,30,46
56,8476792,Torey Krug,D,STL,33,82,15,31,46
56,8470613,Brent Burns,D,CAR,39,82,7,39,46
56,8478474,Lawson Crouse,L,UTA,27,82,24,21,45
56,8475218,Mattias Ekholm,D,EDM,34,82,14,31,45
56,8481581,Thomas Harley,D,DAL,23,82,14,31,45
56,8477511,Anthony Mantha,R,CGY,30,82,22,22,44
56,8478856,Conor Garland,R,VAN,28,82,20,24,44
56,8478891,Mason Appleton,C,WPG,28,82,19,25,44
56,8480009,Eeli Tolvanen,R,SEA,25,82,19,25,44
56,8477021,Alex Kerfoot,C,UTA,30,82,10,34,44
56,8479365,Trent Frederic,C,BOS,26,82,23,20,43
56,8479992,Michael Rasmussen,C,DET,25,82,20,23,43
56,8482175,JJ Peterka,R,BUF,22,82,19,24,43
56,8482146,Luke Evangelista,R,NSH,22,82,18,25,43
56,8482665,Matty Beniers,C,SEA,22,82,17,26,43
56,8474053,Logan Couture,C,SJS,35,82,17,26,43
56,8478038,Devon Toews,D,COL,30,82,9,34,43
56,8480849,Barrett Hayton,C,UTA,24,82,20,22,42
56,8478413,Jordan Greenway,L,BUF,27,82,18,24,42
56,8477429,Andrew Copp,C,DET,30,82,16,26,42
56,8473563,Nicklas Backstrom,C,WSH,37,82,15,27,42
56,8475200,Dmitry Orlov,D,CAR,33,82,14,28,42
56,8477948,Travis Sanheim,D,PHI,28,82,10,32,42
56,8476463,Jonas Brodin,D,MIN,31,82,6,36,42
56,8474715,Cam Atkinson,R,TBL,35,82,20,21,41
56,8478046,Danton Heinen,L,VAN,29,82,18,23,41
56,8476826,Yanni Gourde,C,SEA,33,82,17,24,41
56,8482720,Matthew Knies,L,TOR,22,82,15,26,41
56,8480873,Rasmus Sandin,D,WSH,24,82,5,36,41
56,8481542,Moritz Seider,D,DET,23,82,4,37,41
56,8477947,Sonny Milano,L,WSH,28,82,19,21,40
56,8480078,Filip Chytil,C,NYR,25,82,18,22,40
56,8484144,Connor Bedard,C,CHI,19,82,18,22,40
56,8479987,Morgan Geekie,C,BOS,26,82,16,24,40
56,8476292,Ondrej Palat,L,NJD,33,82,15,25,40
56,8474149,Evgenii Dadonov,R,DAL,35,82,14,26,40
56,8476885,Jacob Trouba,D,NYR,30,82,9,31,40
56,8476892,Colton Parayko,D,STL,31,82,8,32,40
56,8475764,Cam Fowler,D,ANA,33,82,4,36,40
56,8480893,Kirill Marchenko,R,CBJ,24,82,22,17,39
56,8481535,Nils Hoglander,L,VAN,24,82,21,18,39
56,8481477,Nico Sturm,C,SJS,29,82,21,18,39
56,8476882,Teuvo Teravainen,L,CHI,30,82,18,21,39
56,8474641,Adam Henrique,C,EDM,34,82,18,21,39
56,8478057,Dakota Joshua,C,VAN,28,82,18,21,39
56,8478233,Andrew Mangiapane,L,WSH,28,82,15,24,39
56,8477953,Kasperi Kapanen,R,STL,28,82,15,24,39
56,8480748,Kiefer Sherwood,L,VAN,29,82,15,24,39
56,8482149,Cole Perfetti,C,WPG,22,82,14,25,39
56,8475763,Kevin Hayes,R,PIT,32,82,11,28,39
56,8482105,Jake Sanderson,D,OTT,22,82,10,29,39
56,8476854,Hampus Lindholm,D,BOS,30,82,10,29,39
56,8481606,Jordan Spence,D,LAK,23,82,9,30,39
56,8481546,Cam York,D,PHI,23,82,7,32,39
56,8482089,Jake Neighbours,L,STL,22,82,27,11,38
56,8481580,Connor McMichael,C,WSH,23,82,22,16,38
56,8481604,Pavel Dorofeyev,L,VGK,24,82,19,19,38
56,8482092,Ridly Greig,C,OTT,22,82,17,21,38
56,8477952,Robby Fabbri,C,ANA,28,82,17,21,38
56,8476927,Teddy Blueger,C,VAN,30,82,14,24,38
56,8475722,Jason Zucker,L,BUF,32,82,13,25,38
56,8481186,Logan O'Connor,R,COL,28,82,21,16,37
56,8479996,Cody Glass,C,NSH,25,82,19,18,37
56,8482705,Cole Sillinger,C,CBJ,21,82,18,19,37
56,8482117,Lukas Reichel,L,CHI,22,82,16,21,37
56,8476480,Vladislav Namestnikov,C,WPG,32,82,15,22,37
56,8477989,Christian Dvorak,C,MTL,28,82,13,24,37
56,8481582,Nicholas Robertson,L,TOR,23,82,11,26,37
56,8475314,Anders Lee,L,NYI,34,82,21,15,36
56,8482055,Drew O'Connor,L,PIT,26,82,19,17,36
56,8481554,Kaapo Kakko,R,NYR,23,82,19,17,36
56,8479591,Michael Eyssimont,C,TBL,28,82,18,18,36
56,8475848,Brendan Gallagher,R,MTL,32,82,18,18,36
56,8476897,Oskar Sundqvist,C,STL,30,82,15,21,36
56,8480220,Noah Cates,L,PHI,25,82,14,22,36
56,8475793,Ryan Johansen,C,PHI,32,82,13,23,36
56,8476329,Travis Boyd,C,MIN,31,82,12,24,36
56,8476419,Jean-Gabriel Pageau,C,NYI,32,82,11,25,36
56,8480049,Dylan Samberg,D,WPG,25,82,4,32,36
56,8480113,Alex Iafallo,L,WPG,31,82,16,19,35
56,8474189,Lars Eller,C,PIT,35,82,16,19,35
56,8478463,Anthony Beauvillier,L,PIT,27,82,13,22,35
56,8481656,Aliaksei Protas,C,WSH,23,82,12,23,35
56,8482624,Daniil Miromanov,D,CGY,27,82,11,24,35
56,8480878,Nils Lundkvist,D,DAL,24,82,10,25,35
56,8477498,Darnell Nurse,D,EDM,29,82,9,26,35
56,8477495,Seth Jones,D,CHI,30,82,6,29,35
56,8480817,K'Andre Miller,D,NYR,24,82,4,31,35
56,8480789,Oliver Wahlstrom,R,NYI,24,82,21,13,34
56,8482125,Alexander Holtz,R,VGK,22,82,18,16,34
56,8484166,Adam Fantilli,C,CBJ,20,82,17,17,34
56,8475760,Nick Bjugstad,C,UTA,32,82,15,19,34
56,8480459,Pius Suter,C,VAN,28,82,15,19,34
56,8480336,Sean Walker,D,CAR,30,82,13,21,34
56,8481553,Bobby Brink,R,PHI,23,82,13,21,34
56,8478434,Keegan Kolesar,R,VGK,27,82,13,21,34
56,8482122,Brock Faber,D,MIN,22,82,10,24,34
56,8480145,Neal Pionk,D,WPG,29,82,5,29,34
56,8482142,Jamie Drysdale,D,PHI,22,82,3,31,34
56,8480835,Jack Drury,C,CAR,24,82,16,17,33
56,8480829,Jesperi Kotkaniemi,C,CAR,24,82,15,18,33
56,8479293,Brandon Tanev,L,SEA,33,82,13,20,33
56,8480003,Jesper Boqvist,C,FLA,26,82,13,20,33
56,8475791,Taylor Hall,L,CHI,33,82,12,21,33
56,8476461,Sean Couturier,C,PHI,32,82,11,22,33
56,8480434,Sean Durzi,D,UTA,26,82,9,24,33
56,8478882,Vladislav Gavrikov,D,LAK,29,82,4,29,33
56,8476981,Josh Anderson,R,MTL,30,82,26,6,32
56,8475193,Tomas Tatar,L,NJD,34,82,21,11,32
56,8478109,Victor Olofsson,L,VGK,29,82,19,13,32
56,8475151,Kyle Palmieri,C,NYI,33,82,17,15,32
56,8479351,Sam Steel,C,DAL,26,82,17,15,32
56,8475855,Jesper Fast,R,CAR,33,82,17,15,32
56,8477987,Ryan Donato,C,CHI,28,82,16,16,32
56,8480995,Pontus Holmberg,R,TOR,25,82,14,18,32
56,8483515,Juraj Slafkovsky,L,MTL,20,82,13,19,32
56,8479941,Justin Danforth,R,CBJ,31,82,13,19,32
56,8476925,Colton Sissons,C,NSH,31,82,12,20,32
56,8480806,Isac Lundestrom,C,ANA,25,82,11,21,32
56,8480798,Philipp Kurashev,C,CHI,25,82,10,22,32
56,8480043,Timothy Liljegren,D,TOR,25,82,8,24,32
56,8480246,Nick Perbix,D,TBL,26,82,7,25,32
56,8476979,Erik Gustafsson,D,DET,32,82,5,27,32
56,8476873,Mark Jankowski,C,NSH,30,82,14,17,31
56,8476960,Andreas Athanasiou,C,CHI,30,82,11,20,31
56,8483457,Lane Hutson,D,MTL,20,82,11,20,31
56,8480871,Adam Boqvist,D,FLA,24,82,10,21,31
56,8480074,Alexandre Texier,C,STL,25,82,10,21,31
56,8480813,Joe Veleno,C,DET,24,82,10,21,31
56,8477220,Nate Schmidt,D,FLA,33,82,7,24,31
56,8479998,Mikey Anderson,D,LAK,25,82,6,25,31
56,8475171,Oliver Ekman-Larsson,D,TOR,33,82,5,26,31
56,8479976,Juuso Valimaki,D,UTA,26,82,2,29,31
56,8479390,Taylor Raddysh,R,WSH,26,82,20,10,30
56,8479353,Brett Howden,C,VGK,26,82,18,12,30
56,8479525,Ross Colton,C,COL,28,82,17,13,30
56,8480068,Ryan Poehling,C,PHI,25,82,15,15,30
56,8477839,Conor Sheary,L,TBL,32,82,11,19,30
56,8482133,Thomas Bordeleau,C,SJS,22,82,10,20,30
56,8484153,Leo Carlsson,C,ANA,20,82,10,20,30
56,8476923,Damon Severson,D,CBJ,30,82,9,21,30
56,8477506,Ryan Pulock,D,NYI,30,82,7,23,30
56,8479324,Ryan Lindgren,D,NYR,26,82,6,24,30
56,8479980,Nicolas Hague,D,VGK,26,82,4,26,30
56,8482259,Bobby McMann,C,TOR,28,82,20,9,29
56,8478508,Yakov Trenin,C,MIN,27,82,16,13,29
56,8481093,Rafael Harvey-Pinard,L,MTL,25,82,16,13,29
56,8479393,Noah Gregor,C,OTT,26,82,16,13,29
56,8476918,Jimmy Vesey,L,NYR,31,82,15,14,29
56,8482062,Cole Smith,L,NSH,29,82,14,15,29
56,8481028,Martin Pospisil,C,CGY,25,82,12,17,29
56,8482733,Logan Mailloux,D,MTL,31,82,12,17,29
56,8475220,Marcus Foligno,L,MIN,33,82,11,18,29
56,8475149,Marcus Johansson,L,MIN,34,82,8,21,29
56,8483482,Tristan Luneau,D,ANA,20,82,8,21,29
56,8476917,Adam Pelech,D,NYI,30,82,7,22,29
56,8475279,Ben Chiarot,D,DET,33,82,7,22,29
56,8474574,Tyler Myers,D,VAN,34,82,6,23,29
56,8476902,Esa Lindell,D,DAL,30,82,5,24,29
56,8478133,Jake Evans,C,MTL,28,82,5,24,29
56,8479398,Samuel Girard,D,COL,26,82,4,25,29
56,8478507,John Marino,D,UTA,27,82,3,26,29
56,8482077,Dylan Holloway,L,EDM,23,82,20,8,28
56,8481624,Ilya Mikheyev,R,CHI,30,82,16,12,28
56,8477931,Tomas Nosek,L,FLA,32,82,15,13,28
56,8477508,Curtis Lazar,C,NJD,29,82,14,14,28
56,8479359,Beck Malenstyn,L,BUF,26,82,12,16,28
56,8473533,Jordan Staal,C,CAR,36,82,11,17,28
56,8478013,Jake Walman,D,SJS,28,82,10,18,28
56,8478416,Erik Cernak,D,TBL,27,82,7,21,28
56,8479983,Mario Ferraro,D,SJS,26,82,7,21,28
56,8483445,Cutter Gauthier,L,ANA,20,82,7,21,28
56,8478911,Matt Roy,D,WSH,29,82,6,22,28
56,8478136,Jake Middleton,D,MIN,28,82,6,22,28
56,8481014,Alexander Romanov,D,NYI,24,82,5,23,28
56,8475462,Radko Gudas,D,ANA,34,82,4,24,28
56,8478399,Jonas Siegenthaler,D,NJD,27,82,4,24,28
56,8477499,Rasmus Ristolainen,D,PHI,30,82,4,24,28
56,8473507,Jeff Petry,D,DET,37,82,2,26,28
56,8479661,Tanner Jeannot,L,LAK,27,82,16,11,27
56,8484145,Zach Benson,L,BUF,19,82,14,13,27
56,8481704,Juuso Parssinen,C,NSH,23,82,13,14,27
56,8478115,Pierre Engvall,L,NYI,28,82,12,15,27
56,8480980,Connor Dewar,C,TOR,25,82,12,15,27
56,8476525,Colin Miller,D,WPG,32,82,6,21,27
56,8476312,Josh Manson,D,COL,33,82,5,22,27
56,8477435,Ryan Graves,D,PIT,29,82,5,22,27
56,8477969,Marcus Pettersson,D,PIT,28,82,4,23,27
56,8483495,Simon Nemec,D,NJD,20,82,4,23,27
56,8476331,Dylan DeMelo,D,WPG,31,82,3,24,27
56,8481178,Egor Zamula,D,PHI,24,82,2,25,27
56,8478500,Ivan Provorov,D,CBJ,27,82,1,26,27
56,8482111,Justin Barron,D,MTL,23,82,12,14,26
56,8476889,Radek Faksa,C,STL,30,82,12,14,26
56,8476374,Sean Kuraly,C,CBJ,31,82,10,16,26
56,8481013,Jonatan Berggren,R,DET,24,82,9,17,26
56,8483490,Pavel Mintyukov,D,ANA,21,82,7,19,26
56,8476457,Adam Larsson,D,SEA,32,82,5,21,26
56,8482655,J.J. Moser,D,TBL,24,82,2,24,26
56,8478851,Alexandre Carrier,D,NSH,28,82,2,24,26
56,8480860,Kevin Bahl,D,CGY,24,82,1,25,26
56,8482074,Connor Zary,C,CGY,23,82,12,13,25
56,8481481,Blake Lizotte,C,PIT,27,82,12,13,25
56,8475842,Sam Carrick,C,NYR,32,82,12,13,25
56,8482807,Ethan Del Mastro,D,CHI,21,82,10,15,25
56,8476469,Joel Armia,R,MTL,31,82,10,15,25
56,8476878,Zemgus Girgensons,L,TBL,30,82,10,15,25
56,8470621,Corey Perry,R,EDM,39,82,9,16,25
56,8480802,Ryan McLeod,C,BUF,25,82,9,16,25
56,8482141,Lukas Cormier,D,VGK,22,82,8,17,25
56,8478859,Niko Mikkola,D,FLA,28,82,8,17,25
56,8475188,Brayden McNabb,D,VGK,33,82,6,19,25
56,8479402,Jake Bean,D,CGY,26,82,4,21,25
56,8476429,Scott Mayfield,D,NYI,32,82,4,21,25
56,8475790,Erik Gudbranson,D,CBJ,32,82,4,21,25
56,8480073,Erik Brannstrom,D,COL,25,82,1,24,25
56,8474673,TJ Brodie,D,CHI,34,82,0,25,25
56,8482702,Logan Stankoven,C,DAL,21,82,16,8,24
56,8476392,Adam Lowry,C,WPG,31,82,12,12,24
56,8476278,Colin Blackwell,C,DAL,31,82,10,14,24
56,8478468,Jeremy Lauzon,D,NSH,27,82,10,14,24
56,8481567,Henry Thrun,D,SJS,23,82,8,16,24
56,8477425,Miles Wood,L,COL,29,82,6,18,24
56,8478178,Darren Raddysh,D,TBL,28,82,5,19,24
56,8476467,Jamie Oleksiak,D,SEA,32,82,4,20,24
56,8475455,Brenden Dillon,D,NJD,34,82,4,20,24
56,8481568,Alex Vlasic,D,CHI,23,82,3,21,24
56,8477369,Carson Soucy,D,VAN,30,82,3,21,24
56,8475324,Nick Jensen,D,OTT,34,82,1,23,24
56,8478211,Dryden Hunt,L,CGY,29,82,9,14,23
56,8475343,Nic Dowd,C,WSH,34,82,8,15,23
56,8477392,Hudson Fasching,R,NYI,29,82,8,15,23
56,8482166,Shakir Mukhamadullin,D,SJS,22,82,8,15,23
56,8474716,Jared Spurgeon,D,MIN,35,82,7,16,23
56,8479369,Andrew Peeke,D,BOS,26,82,4,19,23
56,8482245,Artem Zub,D,OTT,29,82,3,20,23
56,8477488,Brett Pesce,D,NJD,30,82,1,22,23
56,8475181,Nick Leddy,D,STL,33,82,0,23,23
56,8482679,Matt Coronato,R,CGY,22,82,13,9,22
56,8481517,Brett Leason,R,ANA,25,82,10,12,22
56,8477919,Frederick Gaudreau,C,MIN,31,82,9,13,22
56,8479316,Luke Kunin,C,SJS,27,82,9,13,22
56,8476442,Matt Nieto,L,PIT,32,82,9,13,22
56,8480855,Jack McBain,C,UTA,24,82,8,14,22
56,8482145,Mavrik Bourque,C,DAL,22,82,8,14,22
56,8477365,Connor Clifton,D,BUF,29,82,5,17,22
56,8478840,Will Borgen,D,SEA,28,82,5,17,22
56,8482858,Ryker Evans,D,SEA,23,82,5,17,22
56,8479414,Nathan Bastian,R,NJD,27,82,13,8,21
56,8477450,Jason Dickinson,C,CHI,29,82,10,11,21
56,8479368,Max Jones,L,BOS,26,82,10,11,21
56,8481524,Bowen Byram,D,BUF,23,82,10,11,21
56,8482713,Mackie Samoskevich,R,FLA,22,82,10,11,21
56,8478432,Christian Fischer,R,DET,27,82,9,12,21
56,8481601,Simon Holmstrom,R,NYI,23,82,9,12,21
56,8483468,Jiri Kulich,C,BUF,20,82,9,12,21
56,8476422,Mike Reilly,D,NYI,31,82,5,16,21
56,8481522,Peyton Krebs,C,BUF,23,82,5,16,21
56,8479371,Dante Fabbro,D,NSH,26,82,4,17,21
56,8475690,Chris Tanev,D,TOR,35,82,3,18,21
56,8482803,Olen Zellweger,D,ANA,21,82,2,19,21
56,8480281,Alexey Toropchenko,R,STL,25,82,15,5,20
56,8484911,Collin Graf,R,SJS,22,82,11,9,20
56,8484203,Bradly Nadeau,L,CAR,19,82,10,10,20
56,8480144,David Kampf,C,TOR,29,82,8,12,20
56,8477507,Nikita Zadorov,D,BOS,29,82,8,12,20
56,8482470,Ilya Solovyov,D,CGY,24,82,8,12,20
56,8483763,Maksymilian Szuber,D,UTA,22,82,7,13,20
56,8474013,Ian Cole,D,UTA,35,82,6,14,20
56,8484149,Gavin Brindley,C,CBJ,20,82,6,14,20
56,8477015,Connor Brown,R,EDM,30,82,5,15,20
56,8478443,Brandon Carlo,D,BOS,28,82,4,16,20
56,8474151,Ryan McDonagh,D,TBL,35,82,3,17,20
56,8482087,Kaiden Guhle,D,MTL,22,82,2,18,20
56,8480807,Mattias Samuelsson,D,BUF,24,82,2,18,20
56,8480172,Jan Rutta,D,SJS,34,82,2,18,20
56,8483431,Logan Cooley,C,UTA,20,82,12,7,19
56,8481032,Paul Cotter,C,NJD,25,82,9,10,19
56,8483524,Shane Wright,C,SEA,20,82,9,10,19
56,8476624,Barclay Goodrow,C,SJS,31,82,8,11,19
56,8478569,Noel Acciari,C,PIT,33,82,8,11,19
56,8482101,Danil Gushchin,L,SJS,22,82,8,11,19
56,8480025,MacKenzie Entwistle,R,FLA,25,82,6,13,19
56,8475231,Casey Cizikas,C,NYI,33,82,6,13,19
56,8480879,Jacob Bernard-Docker,D,OTT,24,82,6,13,19
56,8477406,Mattias Janmark,C,EDM,32,82,5,14,19
56,8477938,Haydn Fleury,D,WPG,28,82,4,15,19
56,8476931,Jake McCabe,D,TOR,31,82,3,16,19
56,8476879,Cody Ceci,D,EDM,31,82,3,16,19
56,8480035,Henri Jokiharju,D,BUF,25,82,3,16,19
56,8476967,Brett Kulak,D,EDM,30,82,3,16,19
56,8478874,Adam Gaudette,C,OTT,28,82,3,16,19
56,8477505,Alexander Wennberg,C,SJS,30,82,11,7,18
56,8477353,Tyler Motte,C,DET,29,82,10,8,18
56,8476921,Jordan Martinook,L,CAR,32,82,9,9,18
56,8483505,Matthew Poitras,C,BOS,20,82,9,9,18
56,8483565,Nick Blankenburg,D,NSH,26,82,6,12,18
56,8470600,Ryan Suter,D,STL,39,82,4,14,18
56,8475762,Derek Forbort,D,VAN,32,82,4,14,18
56,8480222,Sebastian Aho,D,PIT,28,82,2,16,18
56,8477845,Trevor van Riemsdyk,D,WSH,33,82,2,16,18
56,8476891,Matt Grzelcyk,D,PIT,30,82,2,16,18
56,8483397,Marc McLaughlin,C,BOS,25,82,11,6,17
56,8479291,Kevin Rooney,C,CGY,31,82,9,8,17
56,8482118,Sam Colangelo,R,ANA,23,82,9,8,17
56,8482712,Oskar Olausson,R,COL,22,82,8,9,17
56,8480796,Martin Fehervary,D,WSH,25,82,5,12,17
56,8474567,Zach Bogosian,D,MIN,34,82,5,12,17
56,8477335,Kyle Burroughs,D,LAK,29,82,4,13,17
56,8481605,Jackson LaCombe,D,ANA,23,82,3,14,17
56,8475233,David Savard,D,MTL,34,82,1,16,17
56,8482079,Marco Rossi,C,MIN,23,82,11,5,16
56,8482155,Alex Laferriere,R,LAK,23,82,11,5,16
56,8480448,Parker Kelly,L,COL,25,82,9,7,16
56,8479638,Justin Brazeau,R,BOS,26,82,9,7,16
56,8481641,Joel Kiviranta,L,COL,28,82,8,8,16
56,8482516,Matthew Kessel,D,STL,24,82,7,9,16
56,8480950,Ilya Lyubushkin,D,DAL,30,82,5,11,16
56,8481708,Zac Jones,D,NYR,24,82,3,13,16
56,8480834,Ty Emberson,D,SJS,24,82,3,13,16
56,8477903,Garnet Hathaway,R,PHI,33,82,8,7,15
56,8483471,Brad Lambert,C,WPG,31,82,8,7,15
56,8480021,Jack Studnicka,C,LAK,25,82,5,10,15
56,8483567,Georgii Merkulov,C,BOS,24,82,4,11,15
56,8477034,Jaycob Megna,D,FLA,32,82,3,12,15
56,8482809,Jackson Blake,R,CAR,21,82,9,5,14
56,8479576,Vincent Desharnais,D,VAN,28,82,6,8,14
56,8481699,Aku Raty,R,UTA,23,82,5,9,14
56,8482762,Simon Edvinsson,D,DET,21,82,2,12,14
56,8482073,Braden Schneider,D,NYR,23,82,1,13,14
56,8478450,Parker Wotherspoon,D,BOS,27,82,1,13,14
56,8482659,Josh Doan,R,UTA,22,82,7,6,13
56,8480870,Bo Groulx,C,NYR,24,82,6,7,13
56,8473453,Trevor Lewis,C,LAK,37,82,6,7,13
56,8483012,Logan Morrison,C,SEA,22,82,5,8,13
56,8482749,Joshua Roy,R,MTL,21,82,5,8,13
56,8482787,Nikita Chibrikov,R,WPG,31,82,5,8,13
56,8476372,Nick Seeler,D,PHI,31,82,3,10,13
56,8475718,Justin Holl,D,DET,32,82,1,12,13
56,8476822,Luke Glendening,C,TBL,35,82,6,6,12
56,8476473,Connor Murphy,D,CHI,31,82,5,7,12
56,8482666,Scott Morrow,D,CAR,22,82,3,9,12
56,8474090,Brendan Smith,D,DAL,35,82,3,9,12
56,8483466,Kevin Korchinski,D,CHI,20,82,2,10,12
56,8471677,Jack Johnson,D,CBJ,37,82,2,10,12
56,8479442,Troy Stecher,D,EDM,30,82,2,10,12
56,8476858,Phillip Di Giuseppe,L,VAN,31,82,5,6,11
56,8482153,Brendan Brisson,C,VGK,23,82,4,7,11
56,8483460,David Jiricek,D,CBJ,21,82,3,8,11
56,8475177,Calvin de Haan,D,COL,33,82,2,9,11
56,8481122,Simon Benoit,D,TOR,26,82,2,9,11
56,8476441,Joel Edmundson,D,LAK,31,82,2,9,11
56,8483499,Liam Ohgren,L,MIN,20,82,6,4,10
56,8483493,Frank Nazar,C,CHI,20,82,4,6,10
56,8474612,Travis Hamonic,D,OTT,34,82,2,8,10
56,8483489,Fraser Minten,C,TOR,31,82,4,5,9
56,8480990,Declan Chisholm,D,MIN,24,82,1,7,8
56,8482859,Zack Ostapchuk,C,OTT,21,82,1,7,8
56,8482070,Mitchell Chaffee,R,TBL,26,82,5,0,5
56,8474062,Riley Nash,C,NYR,35,82,1,4,5
56,8470794,Joe Pavelski,C,,40,0,0,0,0
56,8481703,Valtteri Puustinen,R,PIT,25,0,0,0,0
56,8477950,Tony DeAngelo,D,,29,0,0,0,0
56,8481577,Philip Tomasino,C,NSH,23,0,0,0,0
56,8475197,Tyson Barrie,D,,33,0,0,0,0
56,8471218,Blake Wheeler,R,,38,0,0,0,0
56,8474157,Max Pacioretty,L,,36,0,0,0,0
56,8478466,Daniel Sprong,R,VAN,27,0,0,0,0
56,8475744,Evgeny Kuznetsov,C,,32,0,0,0,0
56,8481019,David Gustafsson,C,WPG,24,0,0,0,0
56,8475906,John Klingberg,D,,32,0,0,0,0
56,8479348,Kale Clague,D,BUF,26,0,0,0,0
56,8476952,Dominic Toninato,C,WPG,30,0,0,0,0
56,8473473,Milan Lucic,L,,36,0,0,0,0
56,8474037,James van Riemsdyk,L,,35,0,0,0,0
56,8474602,Justin Schultz,D,,34,0,0,0,0
56,8482222,Alexander Barabanov,L,,30,0,0,0,0
56,8479372,Josh Mahura,D,SEA,26,0,0,0,0
56,8479982,Conor Timmins,D,TOR,26,0,0,0,0
56,8474031,Kevin Shattenkirk,D,,35,0,0,0,0
56,8480008,Adam Ruzicka,C,,25,0,0,0,0
56,8481059,Scott Perunovich,D,STL,26,0,0,0,0
56,8480884,Calen Addison,D,,24,0,0,0,0
56,8476994,Vinnie Hinostroza,C,NSH,30,0,0,0,0
56,8478452,Caleb Jones,D,LAK,27,0,0,0,0
56,8480157,Calle Rosen,D,COL,30,0,0,0,0
56,8481609,Vladislav Kolyachonok,D,UTA,23,0,0,0,0
56,8479415,Michael McLeod,C,,26,0,0,0,0
56,8476919,Chris Tierney,C,,30,0,0,0,0
56,8479639,Dylan Coghlan,D,WPG,26,0,0,0,0
56,8478146,Matthew Highmore,C,OTT,28,0,0,0,0
56,8478970,Jalen Chatfield,D,CAR,28,0,0,0,0
56,8480205,Emil Bemstrom,C,PIT,25,0,0,0,0
56,8474884,Mike Hoffman,C,,35,0,0,0,0
56,8471274,Alex Goligoski,D,,39,0,0,0,0
56,8478104,Sammy Blais,L,,28,0,0,0,0
56,8474870,Tyler Johnson,C,,34,0,0,0,0
56,8476913,Devin Shore,C,MIN,30,0,0,0,0
56,8481598,Philip Broberg,D,EDM,23,0,0,0,0
56,8480058,Pierre-Olivier Joseph,D,STL,25,0,0,0,0
56,8480891,Michael Kesselring,D,UTA,24,0,0,0,0
56,8477979,Nicolas Aube-Kubel,R,BUF,28,0,0,0,0
56,8476871,Tanner Pearson,L,,32,0,0,0,0
56,8476393,Nick Cousins,C,,31,0,0,0,0
56,8479977,Kailer Yamamoto,R,,26,0,0,0,0
56,8479543,Michael Pezzetta,L,MTL,26,0,0,0,0
56,8477018,Ben Hutton,D,VGK,31,0,0,0,0
56,8480762,Eric Robinson,L,CAR,29,0,0,0,0
56,8474034,Pat Maroon,L,CHI,36,0,0,0,0
56,8481058,Jesse Ylönen,R,,25,0,0,0,0
56,8475179,Dmitry Kulikov,D,FLA,34,0,0,0,0
56,8481527,Kaedan Korczak,D,VGK,23,0,0,0,0
56,8473449,Kyle Okposo,R,,36,0,0,0,0
56,8482192,Isaak Phillips,D,CHI,23,0,0,0,0
56,8480727,Zach Whitecloud,D,VGK,28,0,0,0,0
56,8479346,Dillon Dube,C,,26,0,0,0,0
56,8480821,Filip Zadina,R,,25,0,0,0,0
56,8480001,Urho Vaakanainen,D,ANA,25,0,0,0,0
56,8470966,Mark Giordano,D,,41,0,0,0,0
56,8480853,Liam Foudy,C,,24,0,0,0,0
56,8475225,Craig Smith,C,CHI,35,0,0,0,0
56,8479972,Mason Shaw,C,WPG,26,0,0,0,0
56,8478451,Ethan Bear,D,WSH,27,0,0,0,0
56,8474040,Sam Gagner,C,,35,0,0,0,0
56,8480196,Jacob Bryson,D,BUF,27,0,0,0,0
56,8479984,Cal Foote,D,,26,0,0,0,0
56,8480011,Klim Kostin,C,SJS,25,0,0,0,0
56,8482176,Wyatt Kaiser,D,CHI,22,0,0,0,0
56,8476988,Matt Benning,D,SJS,30,0,0,0,0
56,8479370,Tyson Jost,C,CAR,26,0,0,0,0
56,8477464,Nic Petan,C,,29,0,0,0,0
56,8477380,Jonny Brodzinski,C,NYR,31,0,0,0,0
56,8480070,Ian Mitchell,D,BOS,25,0,0,0,0
56,8479315,Joey Anderson,R,CHI,26,0,0,0,0
56,8478099,Kevin Labanc,R,,29,0,0,0,0
56,8476874,Olli Maatta,D,DET,30,0,0,0,0
56,8475208,Brian Dumoulin,D,ANA,33,0,0,0,0
56,8478430,Oliver Kylington,D,,27,0,0,0,0
56,8479536,Axel Jonsson-Fjallby,L,WPG,26,0,0,0,0
56,8479671,Mathieu Olivier,R,CBJ,27,0,0,0,0
56,8471709,Marc-Edouard Vlasic,D,SJS,37,0,0,0,0
56,8479328,Julien Gauthier,R,NYI,27,0,0,0,0
56,8478421,A.J. Greer,L,FLA,28,0,0,0,0
56,8477573,Nathan Walker,L,STL,30,0,0,0,0
56,8481537,Nikita Okhotiuk,D,CGY,24,0,0,0,0
56,8474166,Alec Martinez,D,CHI,37,0,0,0,0
56,8470610,Zach Parise,L,,40,0,0,0,0
56,8477478,William Carrier,L,CAR,30,0,0,0,0
56,8479344,Jesse Puljujarvi,R,PIT,26,0,0,0,0
56,8480887,Jordan Harris,D,MTL,24,0,0,0,0
56,8478502,Dennis Gilbert,D,BUF,28,0,0,0,0
56,8482730,Brandt Clarke,D,LAK,21,0,0,0,0
56,8480355,Mark Kastelic,C,BOS,25,0,0,0,0
56,8475750,Jon Merrill,D,MIN,32,0,0,0,0
56,8475164,Jakob Silfverberg,R,,34,0,0,0,0
56,8477944,Jakub Vrana,L,,28,0,0,0,0
56,8479439,Jacob MacDonald,D,COL,31,0,0,0,0
56,8474568,Luke Schenn,D,NSH,35,0,0,0,0
56,8478454,Noah Juulsen,D,VAN,27,0,0,0,0
56,8475752,Tyler Pitlick,C,,33,0,0,0,0
56,8482148,Hendrix Lapierre,C,WSH,22,0,0,0,0
56,8481167,Brayden Pachal,D,CGY,25,0,0,0,0
56,8478043,Sam Lafferty,C,BUF,29,0,0,0,0
56,8479321,Lucas Johansen,D,,27,0,0,0,0
56,8471699,Andrew Cogliano,C,,37,0,0,0,0
56,8481521,Ronnie Attard,D,PHI,25,0,0,0,0
56,8481161,Jake Christiansen,D,CBJ,25,0,0,0,0
56,8479458,Nikita Zaitsev,D,,33,0,0,0,0
56,8479619,Michael Carcone,L,UTA,28,0,0,0,0
56,8479026,Philippe Myers,D,TOR,27,0,0,0,0
56,8477330,Dominik Kubalik,L,,29,0,0,0,0
56,8481617,Vasily Podkolzin,R,VAN,23,0,0,0,0
56,8481701,Santeri Hatakka,D,NJD,23,0,0,0,0
56,8479514,Rem Pitlick,C,,27,0,0,0,0
56,8477446,Michael McCarron,R,NSH,29,0,0,0,0
56,8470604,Jeff Carter,C,,39,0,0,0,0
56,8482241,Radim Zohorna,L,,28,0,0,0,0
56,8480289,Morgan Barron,C,WPG,26,0,0,0,0
56,8479379,Givani Smith,R,SJS,26,0,0,0,0
56,8480216,Jacob Peterson,C,,25,0,0,0,0
56,8477851,Jordan Oesterle,D,BOS,32,0,0,0,0
56,8484258,Sam Malinski,D,COL,26,0,0,0,0
56,8478904,Steven Lorentz,C,,28,0,0,0,0
56,8482095,Tyler Kleven,D,OTT,22,0,0,0,0
56,8480848,Ty Dellandrea,C,SJS,24,0,0,0,0
56,8476884,Derrick Pouliot,D,,30,0,0,0,0
56,8479336,Carl Grundstrom,R,SJS,27,0,0,0,0
56,8482964,Arber Xhekaj,D,MTL,23,0,0,0,0
56,8471686,Marc Staal,D,,37,0,0,0,0
56,8477887,Patrick Brown,C,BOS,32,0,0,0,0
56,8478495,Denis Gurianov,R,,27,0,0,0,0
56,8473504,Cal Clutterbuck,R,,37,0,0,0,0
56,8481550,Adam Beckman,L,NJD,23,0,0,0,0
56,8480845,Rasmus Kupari,C,WPG,24,0,0,0,0
56,8474009,Nick Bonino,C,,36,0,0,0,0
56,8478585,Derek Ryan,C,EDM,38,0,0,0,0
56,8477962,Brendan Lemieux,L,CAR,28,0,0,0,0
56,8482861,Vincent Iorio,D,WSH,22,0,0,0,0
56,8479378,Logan Stanley,D,WPG,26,0,0,0,0
56,8473446,Erik Johnson,D,PHI,36,0,0,0,0
56,8481743,Marc Del Gaizo,D,NSH,25,0,0,0,0
56,8477384,Josh Brown,D,EDM,30,0,0,0,0
56,8482165,Yan Kuznetsov,D,CGY,22,0,0,0,0
56,8478424,Jansen Harkins,C,ANA,27,0,0,0,0
56,8482144,Jack Thompson,D,SJS,22,0,0,0,0
56,8478512,Austin Czarnik,C,,32,0,0,0,0
56,8477527,Ross Johnston,L,ANA,30,0,0,0,0
56,8479383,Boris Katchouk,L,,26,0,0,0,0
56,8482094,Daemon Hunt,D,MIN,22,0,0,0,0
56,8481719,Maxwell Crozier,D,TBL,24,0,0,0,0
56,8480192,Johnathan Kovacevic,D,NJD,27,0,0,0,0
56,8479376,Victor Mete,D,,26,0,0,0,0
56,8482511,Mason Lohrei,D,BOS,23,0,0,0,0
56,8475825,Jani Hakanpää,D,,32,0,0,0,0
56,8478021,William Lagesson,D,DET,28,0,0,0,0
56,8475795,Dylan McIlrath,D,WSH,32,0,0,0,0
56,8477846,Ryan Carpenter,C,,33,0,0,0,0
56,8481056,Spencer Stastney,D,NSH,24,0,0,0,0
56,8481564,Ryan Johnson,D,BUF,23,0,0,0,0
56,8478017,Mark Friedman,D,VAN,29,0,0,0,0
56,8479320,Max Lajoie,D,SEA,27,0,0,0,0
56,8480075,Cameron Crotty,D,MIN,25,0,0,0,0
56,8484287,Cole McWard,D,VAN,23,0,0,0,0
56,8484254,Akito Hirose,D,VAN,25,0,0,0,0
56,8483407,Brandon Scanlin,D,NYR,25,0,0,0,0
56,8480274,Philip Kemp,D,EDM,25,0,0,0,0
56,8479522,Hardy Haman Aktell,D,WSH,26,0,0,0,0
56,8480007,Jonas Rondbjerg,R,VGK,25,0,0,0,0
56,8477454,Adam Erne,L,,29,0,0,0,0
56,8481679,Maxence Guenette,D,OTT,23,0,0,0,0
56,8480441,Trey Fix-Wolansky,R,CBJ,25,0,0,0,0
56,8483546,Marshall Rifai,D,TOR,26,0,0,0,0
56,8480084,Nick DeSimone,D,NJD,30,0,0,0,0
56,8481030,Jack St. Ivany,D,PIT,25,0,0,0,0
56,8481592,Jakob Pelletier,L,CGY,23,0,0,0,0
56,8478011,Louie Belpedio,D,PHI,28,0,0,0,0
56,8477930,Pierre-Edouard Bellemare,L,,39,0,0,0,0
56,8484321,Nikolas Matinpalo,D,OTT,26,0,0,0,0
56,8482067,Connor Mackey,D,NYR,28,0,0,0,0
56,8481806,Louis Crevier,D,CHI,23,0,0,0,0
56,8484326,Patrik Koch,D,UTA,28,0,0,0,0
56,8477971,Andreas Englund,D,LAK,28,0,0,0,0
56,8481751,Lukas Rousek,R,BUF,25,0,0,0,0
56,8481006,Tyler Tucker,D,STL,24,0,0,0,0
56,8476867,Brendan Gaunce,C,MIN,30,0,0,0,0
56,8479520,Brandon Duhaime,R,WSH,27,0,0,0,0
56,8477073,Kurtis MacDermid,L,NJD,30,0,0,0,0
56,8480874,Adam Ginning,D,PHI,24,0,0,0,0
56,8477473,Justin Bailey,R,SJS,29,0,0,0,0
56,8479066,Ryan Lomberg,L,CGY,30,0,0,0,0
56,8477070,Liam O'Brien,C,UTA,30,0,0,0,0
56,8474618,Marco Scandella,D,,34,0,0,0,0
56,8475797,Jarred Tinordi,D,,32,0,0,0,0
56,8481441,Joe Snively,C,DET,28,0,0,0,0
56,8477244,Chad Ruhwedel,D,NYR,34,0,0,0,0
56,8479772,Zack MacEwen,R,OTT,28,0,0,0,0
56,8481147,Reese Johnson,C,MIN,26,0,0,0,0
56,8481043,Cole Koepke,L,BOS,26,0,0,0,0
56,8483619,Filip Roos,D,OTT,25,0,0,0,0
56,8481541,Samuel Bolduc,D,NYI,24,0,0,0,0
56,8477810,Joel Hanley,D,CGY,33,0,0,0,0
56,8476907,Mackenzie MacEachern,L,,30,0,0,0,0
56,8482652,Walker Duehr,R,CGY,27,0,0,0,0
56,8477126,Jayson Megna,C,,34,0,0,0,0
56,8483398,Declan Carlile,D,TBL,31,0,0,0,0
56,8482929,Emil Lilleberg,D,TBL,23,0,0,0,0
56,8480880,Jakub Lauko,C,MIN,24,0,0,0,0
56,8480245,Olle Lycksell,R,PHI,25,0,0,0,0
56,8480252,Cole Guttman,C,CHI,25,0,0,0,0
56,8477467,Gustav Olofsson,D,SEA,30,0,0,0,0
56,8479968,Vinni Lettieri,C,BOS,29,0,0,0,0
56,8478400,Colin White,C,,27,0,0,0,0
56,8475755,Alexander Petrovic,D,DAL,32,0,0,0,0
56,8481812,Nikolai Knyzhov,D,,27,0,0,0,0
56,8481593,Jayden Struble,D,MTL,23,0,0,0,0
56,8481532,Alex Turcotte,C,LAK,23,0,0,0,0
56,8482126,Emil Andrae,D,PHI,31,0,0,0,0
56,8479944,Zach Aston-Reese,C,VGK,30,0,0,0,0
56,8471817,Ryan Reaves,R,TOR,37,0,0,0,0
56,8481206,John Ludvig,D,PIT,24,0,0,0,0
56,8481599,Victor Soderstrom,D,UTA,23,0,0,0,0
56,8480292,Carson Meyer,R,ANA,27,0,0,0,0
56,8482496,Nils Aman,C,VAN,24,0,0,0,0
56,8479718,Alex Barré-Boulet,C,MTL,27,0,0,0,0
56,8479994,Jaret Anderson-Dolan,C,WPG,25,0,0,0,0
56,8480184,Gustav Lindstrom,D,,26,0,0,0,0
56,8480890,Jan Jenik,R,OTT,24,0,0,0,0
56,8478067,Oskar Lindblom,L,,28,0,0,0,0
56,8476934,Brock McGinn,L,ANA,30,0,0,0,0
56,8479985,Cale Fleury,D,SEA,26,0,0,0,0
56,8484304,Uvis Balinskis,D,FLA,28,0,0,0,0
56,8479981,Jonah Gadjovich,L,FLA,26,0,0,0,0
56,8481716,Dmitri Voronkov,L,CBJ,24,0,0,0,0
56,8474709,Matt Martin,L,,35,0,0,0,0
56,8482634,Alex Steeves,C,TOR,25,0,0,0,0
56,8480823,Alexander Alexeyev,D,WSH,25,0,0,0,0
56,8477541,Dakota Mermis,D,TOR,30,0,0,0,0
56,8483491,Ivan Miroshnichenko,L,WSH,20,0,0,0,0
56,8478477,Mitchell Stephens,C,SEA,27,0,0,0,0
56,8481543,Nikita Alexandrov,C,STL,24,0,0,0,0
56,8479423,Alex Nylander,L,,26,0,0,0,0
56,8482451,Mikael Pyyhtia,L,CBJ,23,0,0,0,0
56,8478831,Kevin Stenlund,C,UTA,28,0,0,0,0
56,8480306,Grant Hutton,D,NYI,29,0,0,0,0
56,8478028,Fredrik Olofsson,L,,28,0,0,0,0
56,8477462,Robert Hagg,D,VGK,29,0,0,0,0
56,8477320,Anton Blidh,L,NYR,29,0,0,0,0
56,8482157,Will Cuylle,L,NYR,22,0,0,0,0
56,8482737,Zack Bolduc,C,STL,21,0,0,0,0
56,8481239,Samuel Fagemo,L,,24,0,0,0,0
56,8481600,Tobias Bjornfot,D,FLA,23,0,0,0,0
56,8478409,Anthony Richard,C,PHI,28,0,0,0,0
56,8474145,Robert Bortuzzo,D,,35,0,0,0,0
56,8475958,Michael Sgarbossa,C,WSH,32,0,0,0,0
56,8479986,Kole Lind,R,DAL,26,0,0,0,0
56,8479249,Andrew Poturalski,C,SJS,30,0,0,0,0
56,8479362,Riley Tufte,L,BOS,26,0,0,0,0
56,8479991,Jake Leschyshyn,C,NYR,25,0,0,0,0
56,8479587,Rhett Gardner,C,PHI,28,0,0,0,0
56,8482744,James Malatesta,L,CBJ,21,0,0,0,0
56,8478854,Ryan Shea,D,PIT,27,0,0,0,0
56,8481591,Sam Poulin,R,,23,0,0,0,0
56,8483512,Matt Savoie,C,EDM,20,0,0,0,0
56,8482102,Vasily Ponomarev,C,PIT,22,0,0,0,0
56,8482162,Roby Jarventie,L,EDM,22,0,0,0,0
56,8481016,Ruslan Iskhakov,C,,24,0,0,0,0
56,8482172,Landon Slaggert,L,CHI,22,0,0,0,0
56,8482747,Brennan Othmann,L,NYR,21,0,0,0,0
56,8480031,Maxime Comtois,L,,25,0,0,0,0
56,8480226,Marián Studenic,R,,26,0,0,0,0
56,8478408,Travis Dermott,D,,28,0,0,0,0
56,8481518,Nolan Foote,L,NJD,24,0,0,0,0
56,8479419,Brett Murray,L,BUF,26,0,0,0,0
56,8482088,Justin Sourdif,R,FLA,22,0,0,0,0
56,8482201,Gage Goncalves,C,TBL,23,0,0,0,0
56,8481578,Graeme Clarke,R,MIN,23,0,0,0,0
56,8482177,Marat Khusnutdinov,C,MIN,22,0,0,0,0
56,8481754,Nikita Nesterenko,C,ANA,23,0,0,0,0
56,8483531,Brian Halonen,L,NJD,25,0,0,0,0
56,8483920,Pierrick Dube,R,WSH,23,0,0,0,0
56,8480851,Akil Thomas,C,LAK,24,0,0,0,0
56,8475235,Nicolas Deslauriers,L,PHI,33,0,0,0,0
56,8482476,Emil Heineman,L,MTL,23,0,0,0,0
56,8477149,Scott Sabourin,R,SJS,32,0,0,0,0
56,8483549,Lucas Condotta,L,MTL,27,0,0,0,0
56,8482765,Isak Rosen,R,BUF,21,0,0,0,0
56,8481237,Kyle MacLean,C,NYI,25,0,0,0,0
56,8481024,Linus Karlsson,C,VAN,25,0,0,0,0
56,8481690,Tyler Angle,C,,24,0,0,0,0
56,8483570,Ben Meyers,C,SEA,26,0,0,0,0
56,8481655,Cole Schwindt,R,CGY,23,0,0,0,0
56,8481462,Mason Morelli,L,VGK,28,0,0,0,0
56,8483401,Marc Johnstone,R,PIT,28,0,0,0,0
56,8478956,Samuel Laberge,L,NJD,27,0,0,0,0
56,8479533,Joona Koppanen,L,,26,0,0,0,0
56,8482197,Adam Raska,R,MIN,23,0,0,0,0
56,8482250,Callahan Burke,C,VGK,27,0,0,0,0
56,8482784,Zach Dean,C,STL,21,0,0,0,0
56,8484255,Jason Polin,R,COL,25,0,0,0,0
56,8481077,John Leonard,L,,26,0,0,0,0
56,8481534,Raphael Lavoie,C,EDM,24,0,0,0,0
56,8483609,Adam Klapka,R,CGY,24,0,0,0,0
56,8482751,Ryan Winterton,C,SEA,21,0,0,0,0
56,8480267,Sammy Walker,C,MIN,25,0,0,0,0
56,8475766,Austin Watson,L,,32,0,0,0,0
56,8482460,Matt Rempe,C,NYR,22,0,0,0,0
56,8481065,Angus Crookshank,L,OTT,25,0,0,0,0
56,8481070,Hugh McGing,L,,26,0,0,0,0
56,8476323,Max McCormick,L,SEA,32,0,0,0,0
56,8483395,Arshdeep Bains,L,VAN,23,0,0,0,0
56,8484259,Ondrej Pavel,C,COL,31,0,0,0,0
56,8483432,Luca Del Bel Belluz,C,CBJ,31,0,0,0,0
56,8483045,Cameron Butler,R,CBJ,31,0,0,0,0
56,8482061,Brandon Biro,L,SEA,26,0,0,0,0
56,8477401,John Hayden,C,SEA,29,0,0,0,0
56,8475278,Byron Froese,C,,33,0,0,0,0
56,8478446,Glenn Gawdin,C,LAK,27,0,0,0,0
56,8477993,Justin Kirkland,C,CGY,28,0,0,0,0
56,8482147,Jean-Luc Foudy,C,COL,22,0,0,0,0
56,8480032,Shane Bowers,C,NJD,25,0,0,0,0
56,8479330,Brandon Gignac,C,MTL,27,0,0,0,0
56,8480776,Sheldon Rempal,R,,29,0,0,0,0
56,8475413,Justin Dowling,C,NJD,34,0,0,0,0
56,8481726,Adam Edstrom,C,NYR,24,0,0,0,0
56,8480844,Grigori Denisenko,L,VGK,24,0,0,0,0
56,8478147,Bokondji Imama,L,PIT,28,0,0,0,0
56,8478881,Brett Seney,L,CHI,28,0,0,0,0
56,8483630,Pavol Regenda,L,ANA,25,0,0,0,0
56,8480836,Jonathan Gruden,C,,24,0,0,0,0
56,8484314,Jiri Smejkal,L,,28,0,0,0,0
56,8475780,Chris Wagner,R,COL,33,0,0,0,0
56,8479546,Oskar Steen,C,,26,0,0,0,0
56,8483597,Milos Kelemen,L,UTA,25,0,0,0,0
56,8481789,Tye Kartye,L,SEA,23,0,0,0,0
56,8484325,Waltteri Merela,C,TBL,26,0,0,0,0
56,8479421,Jacob Moverare,D,LAK,26,0,0,0,0
56,8481585,Egor Afanasyev,L,SJS,23,0,0,0,0
56,8479547,Matthew Phillips,R,,26,0,0,0,0
56,8479367,William Lockwood,R,FLA,26,0,0,0,0
56,8476915,Jujhar Khaira,L,,30,0,0,0,0
56,8481422,Jacob Lucchini,C,NSH,29,0,0,0,0
56,8480468,James Hamblin,L,EDM,25,0,0,0,0
56,8478051,Max Willman,C,NJD,29,0,0,0,0
56,8481556,John Beecher,C,BOS,23,0,0,0,0
56,8478078,Rourke Chartier,C,,28,0,0,0,0
57,8478402,Connor McDavid,C,EDM,27,82,34,113,147
57,8477492,Nathan MacKinnon,C,COL,29,82,53,85,138
57,8476453,Nikita Kucherov,R,TBL,31,82,37,82,119
57,8478550,Artemi Panarin,L,NYR,33,82,35,80,115
57,8476468,J.T. Miller,C,VAN,31,82,40,73,113
57,8477934,Leon Draisaitl,C,EDM,29,82,35,77,112
57,8479314,Matthew Tkachuk,L,FLA,27,82,29,80,109
57,8479318,Auston Matthews,C,TOR,27,82,60,48,108
57,8474600,Roman Josi,D,NSH,34,82,19,87,106
57,8477493,Aleksander Barkov,C,FLA,29,82,39,65,104
57,8481559,Jack Hughes,C,NJD,23,82,35,69,104
57,8478398,Kyle Connor,L,WPG,28,82,50,52,102
57,8477956,David Pastrnak,R,BOS,28,82,39,62,101
57,8478445,Mathew Barzal,C,NYI,27,82,34,67,101
57,8478010,Brayden Point,C,TBL,28,82,63,36,99
57,8480027,Jason Robertson,L,DAL,25,82,32,66,98
57,8480012,Elias Pettersson,C,VAN,26,82,34,63,97
57,8480800,Quinn Hughes,D,VAN,25,82,15,82,97
57,8480069,Cale Makar,D,COL,26,82,29,67,96
57,8478864,Kirill Kaprizov,L,MIN,27,82,48,47,95
57,8478420,Mikko Rantanen,R,COL,28,82,43,52,95
57,8480002,Nico Hischier,C,NJD,25,82,38,57,95
57,8477939,William Nylander,R,TOR,28,82,36,59,95
57,8477933,Sam Reinhart,C,FLA,29,82,47,47,94
57,8478427,Sebastian Aho,C,CAR,27,82,36,58,94
57,8476454,Ryan Nugent-Hopkins,C,EDM,31,82,35,59,94
57,8480023,Robert Thomas,C,STL,25,82,29,64,93
57,8479385,Jordan Kyrou,C,STL,26,82,49,42,91
57,8474564,Steven Stamkos,C,NSH,34,82,38,53,91
57,8478414,Timo Meier,R,NJD,28,82,36,55,91
57,8471675,Sidney Crosby,C,PIT,37,82,33,57,90
57,8475754,Brock Nelson,C,NYI,33,82,48,41,89
57,8477501,Valeri Nichushkin,R,COL,29,82,47,42,89
57,8482116,Tim Stützle,C,OTT,22,82,40,49,89
57,8479343,Clayton Keller,R,UTA,26,82,35,54,89
57,8476887,Filip Forsberg,L,NSH,30,82,44,43,87
57,8480801,Brady Tkachuk,L,OTT,25,82,35,51,86
57,8478403,Jack Eichel,C,VGK,28,82,37,47,84
57,8475913,Mark Stone,R,VGK,32,82,26,58,84
57,8476389,Vincent Trocheck,C,NYR,31,82,29,54,83
57,8476539,Jonathan Marchessault,R,NSH,34,82,38,44,82
57,8476456,Jonathan Huberdeau,C,CGY,31,82,24,58,82
57,8475167,Victor Hedman,D,TBL,34,82,17,65,82
57,8477402,Pavel Buchnevich,L,STL,29,82,35,46,81
57,8475172,Nazem Kadri,C,CGY,34,82,32,49,81
57,8480039,Martin Necas,C,CAR,25,82,35,45,80
57,8478047,Michael Bunting,L,PIT,29,82,30,50,80
57,8477942,Kevin Fiala,L,LAK,28,82,29,51,80
57,8479407,Jesper Bratt,L,NJD,26,82,26,54,80
57,8477946,Dylan Larkin,C,DET,28,82,40,39,79
57,8478449,Roope Hintz,C,DAL,28,82,36,42,78
57,8479337,Alex DeBrincat,R,DET,27,82,33,45,78
57,8482078,Lucas Raymond,L,DET,22,82,28,50,78
57,8479323,Adam Fox,D,NYR,26,82,22,56,78
57,8478444,Brock Boeser,R,VAN,27,82,40,37,77
57,8481068,Yegor Sharangovich,C,CGY,26,82,39,38,77
57,8475784,Jeff Skinner,C,EDM,32,82,35,42,77
57,8475166,John Tavares,C,TOR,34,82,25,52,77
57,8473512,Claude Giroux,R,OTT,36,82,24,53,77
57,8477447,Shea Theodore,D,VGK,29,82,22,54,76
57,8477409,Carter Verhaeghe,C,FLA,29,82,35,40,75
57,8476448,William Karlsson,C,VGK,31,82,33,42,75
57,8481557,Matt Boldy,L,MIN,23,82,25,50,75
57,8479999,Casey Mittelstadt,C,COL,26,82,25,50,75
57,8480865,Noah Dobson,D,NYI,24,82,18,57,75
57,8479420,Tage Thompson,C,BUF,27,82,45,29,74
57,8475810,Bryan Rust,R,PIT,32,82,42,32,74
57,8480803,Evan Bouchard,D,EDM,25,82,15,59,74
57,8477416,Oliver Bjorkstrand,R,SEA,29,82,27,46,73
57,8479339,Patrik Laine,L,CBJ,26,82,36,36,72
57,8480830,Andrei Svechnikov,R,CAR,24,82,30,42,72
57,8480014,Gabriel Vilardi,C,WPG,25,82,40,31,71
57,8482093,Seth Jarvis,C,CAR,22,82,34,37,71
57,8471685,Anze Kopitar,C,LAK,37,82,27,44,71
57,8471215,Evgeni Malkin,C,PIT,38,82,26,45,71
57,8477504,Josh Morrissey,D,WPG,29,82,18,53,71
57,8482665,Matty Beniers,C,SEA,22,82,30,40,70
57,8476460,Mark Scheifele,C,WPG,31,82,28,42,70
57,8480018,Nick Suzuki,C,MTL,25,82,28,42,70
57,8476459,Mika Zibanejad,C,NYR,31,82,24,46,70
57,8480839,Rasmus Dahlin,D,BUF,24,82,23,47,70
57,8476346,Johnny Gaudreau,L,CBJ,31,82,14,56,70
57,8474578,Erik Karlsson,D,PIT,34,82,12,58,70
57,8481523,Kirby Dach,C,MTL,23,82,11,59,70
57,8475726,Tyler Toffoli,C,SJS,32,82,42,27,69
57,8475169,Evander Kane,L,EDM,33,82,41,27,68
57,8474102,David Perron,L,OTT,36,82,28,40,68
57,8475151,Kyle Palmieri,C,NYI,33,82,34,33,67
57,8477496,Elias Lindholm,C,BOS,30,82,29,38,67
57,8474141,Patrick Kane,R,DET,36,82,26,41,67
57,8477986,Brandon Montour,D,SEA,30,82,22,45,67
57,8480036,Miro Heiskanen,D,DAL,25,82,12,55,67
57,8477935,Sam Bennett,C,FLA,28,82,31,35,66
57,8473994,Jamie Benn,L,DAL,35,82,28,38,66
57,8476432,Boone Jenner,C,CBJ,31,82,28,38,66
57,8479542,Brandon Hagel,L,TBL,26,82,27,39,66
57,8474590,John Carlson,D,WSH,34,82,9,57,66
57,8477404,Jake Guentzel,C,TBL,30,82,29,36,65
57,8477500,Bo Horvat,C,NYI,29,82,37,27,64
57,8475170,Brayden Schenn,C,STL,33,82,30,34,64
57,8475158,Ryan O'Reilly,C,NSH,33,82,28,36,64
57,8475168,Matt Duchene,C,DAL,33,82,28,36,64
57,8471214,Alex Ovechkin,L,WSH,39,82,38,25,63
57,8478042,Viktor Arvidsson,R,EDM,31,82,30,33,63
57,8477476,Artturi Lehkonen,L,COL,29,82,26,37,63
57,8477949,Alex Tuch,R,BUF,28,82,25,38,63
57,8478856,Conor Garland,R,VAN,28,82,25,38,63
57,8478440,Dylan Strome,C,WSH,27,82,23,40,63
57,8476462,Dougie Hamilton,D,NJD,31,82,22,41,63
57,8477494,Jonathan Drouin,L,COL,29,82,20,43,63
57,8476399,Blake Coleman,C,CGY,33,82,38,24,62
57,8477951,Nick Schmaltz,C,UTA,28,82,30,32,62
57,8477960,Adrian Kempe,R,LAK,28,82,26,36,62
57,8477940,Nikolaj Ehlers,L,WPG,28,82,28,33,61
57,8476881,Tomas Hertl,C,VGK,31,82,26,35,61
57,8478438,Tommy Novak,C,NSH,27,82,24,37,61
57,8478038,Devon Toews,D,COL,30,82,19,42,61
57,8482124,Quinton Byfield,R,LAK,22,82,14,47,61
57,8476483,Rickard Rakell,R,PIT,31,82,32,28,60
57,8478474,Lawson Crouse,L,UTA,27,82,28,32,60
57,8477497,Sean Monahan,C,CBJ,30,82,27,33,60
57,8476479,Phillip Danault,C,LAK,31,82,21,39,60
57,8478460,Zach Werenski,D,CBJ,27,82,14,46,60
57,8478975,Mason Marchment,L,DAL,29,82,28,31,59
57,8478439,Travis Konecny,R,PHI,27,82,27,32,59
57,8476458,Ryan Strome,C,ANA,31,82,23,36,59
57,8470613,Brent Burns,D,CAR,39,82,10,49,59
57,8475184,Chris Kreider,L,NYR,33,82,38,20,58
57,8477955,Jared McCann,L,SEA,28,82,35,23,58
57,8481540,Cole Caufield,R,MTL,23,82,35,23,58
57,8482110,Dawson Mercer,C,NJD,23,82,29,29,58
57,8482097,Jack Quinn,R,BUF,23,82,24,34,58
57,8481528,Dylan Cozens,C,BUF,23,82,23,35,58
57,8482699,Dylan Guenther,R,UTA,21,82,21,37,58
57,8478462,Nicolas Roy,C,VGK,27,82,20,38,58
57,8482684,Luke Hughes,D,NJD,21,82,12,46,58
57,8475794,Tyler Seguin,C,DAL,32,82,29,28,57
57,8477479,Tyler Bertuzzi,L,CHI,29,82,25,32,57
57,8481533,Trevor Zegras,C,ANA,23,82,21,36,57
57,8476875,Mike Matheson,D,MTL,30,82,18,39,57
57,8482149,Cole Perfetti,C,WPG,22,82,15,42,57
57,8475798,Mikael Granlund,C,SJS,32,82,13,44,57
57,8479410,Mikhail Sergachev,D,UTA,26,82,12,45,57
57,8475692,Mats Zuccarello,R,MIN,37,82,11,46,57
57,8475786,Zach Hyman,L,EDM,32,82,33,23,56
57,8473419,Brad Marchand,L,BOS,36,82,27,29,56
57,8477964,Ivan Barbashev,C,VGK,29,82,22,34,56
57,8480208,Drake Batherson,R,OTT,26,82,21,35,56
57,8477451,Ryan Hartman,R,MIN,30,82,19,37,56
57,8471724,Kris Letang,D,PIT,37,82,17,39,56
57,8476853,Morgan Rielly,D,TOR,30,82,11,45,56
57,8477407,Anthony Duclair,L,NYI,29,82,26,29,55
57,8478873,Troy Terry,R,ANA,27,82,18,37,55
57,8477346,MacKenzie Weegar,D,CGY,30,82,17,38,55
57,8478407,Vince Dunn,D,SEA,28,82,14,41,55
57,8477511,Anthony Mantha,R,CGY,30,82,24,30,54
57,8477456,J.T. Compher,L,DET,29,82,23,31,54
57,8478233,Andrew Mangiapane,L,WSH,28,82,22,32,54
57,8474150,Mikael Backlund,C,CGY,35,82,20,34,54
57,8479325,Charlie McAvoy,D,BOS,27,82,10,44,54
57,8478366,Frank Vatrano,R,ANA,30,82,33,20,53
57,8478498,Jake DeBrusk,L,VAN,28,82,31,22,53
57,8478401,Pavel Zacha,C,BOS,27,82,21,32,53
57,8474565,Alex Pietrangelo,D,VGK,34,82,17,36,53
57,8482720,Matthew Knies,L,TOR,22,82,16,37,53
57,8478469,Thomas Chabot,D,OTT,27,82,13,40,53
57,8479675,Trevor Moore,L,LAK,29,82,27,25,52
57,8478493,Joel Eriksson Ek,C,MIN,27,82,22,30,52
57,8475745,Charlie Coyle,C,BOS,32,82,18,34,52
57,8482175,JJ Peterka,R,BUF,22,82,18,34,52
57,8477426,Nicholas Paul,L,TBL,29,82,30,21,51
57,8482745,Mason McTavish,C,ANA,21,82,29,22,51
57,8474641,Adam Henrique,C,EDM,34,82,28,23,51
57,8476880,Tom Wilson,R,WSH,30,82,27,24,51
57,8474679,Gustav Nyquist,C,NSH,35,82,21,30,51
57,8477444,Andre Burakovsky,L,SEA,29,82,18,33,51
57,8475765,Vladimir Tarasenko,R,DET,33,82,14,37,51
57,8479400,Pierre-Luc Dubois,L,WSH,26,82,20,30,50
57,8475768,Jaden Schwartz,C,SEA,32,82,20,30,50
57,8478458,Jack Roslovic,C,CAR,27,82,18,32,50
57,8481581,Thomas Harley,D,DAL,23,82,18,32,50
57,8480798,Philipp Kurashev,C,CHI,25,82,17,33,50
57,8477495,Seth Jones,D,CHI,30,82,13,37,50
57,8480188,Fabian Zetterlund,L,SJS,25,82,22,27,49
57,8475149,Marcus Johansson,L,MIN,34,82,21,28,49
57,8478519,Anthony Cirelli,C,TBL,27,82,17,32,49
57,8476882,Teuvo Teravainen,L,CHI,30,82,17,32,49
57,8475763,Kevin Hayes,R,PIT,32,82,17,32,49
57,8478055,Gustav Forsling,D,FLA,28,82,15,34,49
57,8480871,Adam Boqvist,D,FLA,24,82,15,34,49
57,8478542,Evan Rodrigues,C,FLA,31,82,14,35,49
57,8476906,Shayne Gostisbehere,D,CAR,31,82,13,36,49
57,8476792,Torey Krug,D,STL,33,82,12,37,49
57,8482109,Alexis Lafrenière,L,NYR,23,82,25,23,48
57,8480028,Morgan Frost,C,PHI,25,82,20,28,48
57,8474586,Jordan Eberle,R,SEA,34,82,17,31,48
57,8478397,Rasmus Andersson,D,CGY,28,82,12,36,48
57,8478396,Noah Hanifin,D,VGK,27,82,10,38,48
57,8476923,Damon Severson,D,CBJ,30,82,8,40,48
57,8480015,Owen Tippett,R,PHI,25,82,29,18,47
57,8480064,Josh Norris,C,OTT,25,82,26,21,47
57,8482113,Anton Lundell,C,FLA,23,82,21,26,47
57,8480797,Joel Farabee,L,PHI,24,82,18,29,47
57,8477021,Alex Kerfoot,C,UTA,30,82,15,32,47
57,8478891,Mason Appleton,C,WPG,28,82,13,34,47
57,8479987,Morgan Geekie,C,BOS,26,82,23,23,46
57,8480849,Barrett Hayton,C,UTA,24,82,19,27,46
57,8473986,Alex Killorn,L,ANA,35,82,18,28,46
57,8481186,Logan O'Connor,R,COL,28,82,17,29,46
57,8475191,Reilly Smith,R,NYR,33,82,16,30,46
57,8480078,Filip Chytil,C,NYR,25,82,14,32,46
57,8474563,Drew Doughty,D,LAK,35,82,11,35,46
57,8477969,Marcus Pettersson,D,PIT,28,82,8,38,46
57,8471698,T.J. Oshie,R,WSH,38,82,25,20,45
57,8475799,Nino Niederreiter,R,WPG,32,82,24,21,45
57,8482092,Ridly Greig,C,OTT,22,82,22,23,45
57,8481596,Shane Pinto,C,OTT,24,82,20,25,45
57,8482740,Wyatt Johnston,C,DAL,21,82,18,27,45
57,8482660,Kent Johnson,C,CBJ,22,82,15,30,45
57,8482089,Jake Neighbours,L,STL,22,82,27,17,44
57,8480113,Alex Iafallo,L,WPG,31,82,21,23,44
57,8481604,Pavel Dorofeyev,L,VGK,24,82,20,24,44
57,8482705,Cole Sillinger,C,CBJ,21,82,19,25,44
57,8482159,Tyson Foerster,R,PHI,22,82,17,27,44
57,8476826,Yanni Gourde,C,SEA,33,82,16,28,44
57,8478472,Mathieu Joseph,R,STL,27,82,15,29,44
57,8474053,Logan Couture,C,SJS,35,82,15,29,44
57,8482667,William Eklund,L,SJS,22,82,14,30,44
57,8476461,Sean Couturier,C,PHI,32,82,14,30,44
57,8480434,Sean Durzi,D,UTA,26,82,12,32,44
57,8475218,Mattias Ekholm,D,EDM,34,82,11,33,44
57,8476927,Teddy Blueger,C,VAN,30,82,11,33,44
57,8475753,Justin Faulk,D,STL,32,82,4,40,44
57,8481535,Nils Hoglander,L,VAN,24,82,28,15,43
57,8480829,Jesperi Kotkaniemi,C,CAR,24,82,22,21,43
57,8482475,Yegor Chinakhov,R,CBJ,23,82,20,23,43
57,8476872,Scott Laughton,C,PHI,30,82,19,24,43
57,8477952,Robby Fabbri,C,ANA,28,82,19,24,43
57,8478463,Anthony Beauvillier,L,PIT,27,82,15,28,43
57,8481624,Ilya Mikheyev,R,CHI,30,82,15,28,43
57,8477503,Max Domi,C,TOR,29,82,12,31,43
57,8477932,Aaron Ekblad,D,FLA,28,82,11,32,43
57,8473563,Nicklas Backstrom,C,WSH,37,82,9,34,43
57,8481542,Moritz Seider,D,DET,23,82,9,34,43
57,8481656,Aliaksei Protas,C,WSH,23,82,9,34,43
57,8480009,Eeli Tolvanen,R,SEA,25,82,26,16,42
57,8482055,Drew O'Connor,L,PIT,26,82,25,17,42
57,8476438,Brandon Saad,L,STL,32,82,23,19,42
57,8476474,Stefan Noesen,R,NJD,31,82,21,21,42
57,8477947,Sonny Milano,L,WSH,28,82,17,25,42
57,8479345,Jakob Chychrun,D,WSH,26,82,15,27,42
57,8478413,Jordan Greenway,L,BUF,27,82,12,30,42
57,8480145,Neal Pionk,D,WPG,29,82,8,34,42
57,8476869,Brady Skjei,D,NSH,30,82,5,37,42
57,8476958,Jaccob Slavin,D,CAR,30,82,5,37,42
57,8483808,Andrei Kuzmenko,L,CGY,28,82,22,19,41
57,8475793,Ryan Johansen,C,PHI,32,82,21,20,41
57,8481618,Alex Newhook,C,MTL,23,82,18,23,41
57,8484144,Connor Bedard,C,CHI,19,82,18,23,41
57,8479525,Ross Colton,C,COL,28,82,18,23,41
57,8476925,Colton Sissons,C,NSH,31,82,17,24,41
57,8476419,Jean-Gabriel Pageau,C,NYI,32,82,15,26,41
57,8479941,Justin Danforth,R,CBJ,31,82,23,17,40
57,8475714,Calle Jarnkrok,C,TOR,33,82,21,19,40
57,8480003,Jesper Boqvist,C,FLA,26,82,21,19,40
57,8482146,Luke Evangelista,R,NSH,22,82,20,20,40
57,8475314,Anders Lee,L,NYI,34,82,17,23,40
57,8478115,Pierre Engvall,L,NYI,28,82,16,24,40
57,8475287,Erik Haula,L,NJD,33,82,14,26,40
57,8476329,Travis Boyd,C,MIN,31,82,11,29,40
57,8474189,Lars Eller,C,PIT,35,82,19,20,39
57,8480802,Ryan McLeod,C,BUF,25,82,17,22,39
57,8476905,Chandler Stephenson,C,SEA,30,82,15,24,39
57,8477429,Andrew Copp,C,DET,30,82,15,24,39
57,8481013,Jonatan Berggren,R,DET,24,82,11,28,39
57,8474716,Jared Spurgeon,D,MIN,35,82,10,29,39
57,8476979,Erik Gustafsson,D,DET,32,82,5,34,39
57,8479425,Filip Hronek,D,VAN,27,82,4,35,39
57,8481582,Nicholas Robertson,L,TOR,23,82,26,12,38
57,8480893,Kirill Marchenko,R,CBJ,24,82,22,16,38
57,8481553,Bobby Brink,R,PHI,23,82,17,21,38
57,8477919,Frederick Gaudreau,C,MIN,31,82,17,21,38
57,8480748,Kiefer Sherwood,L,VAN,29,82,16,22,38
57,8479996,Cody Glass,C,NSH,25,82,16,22,38
57,8481560,Arthur Kaliyev,R,LAK,23,82,15,23,38
57,8480835,Jack Drury,C,CAR,24,82,15,23,38
57,8481546,Cam York,D,PHI,23,82,14,24,38
57,8481711,Matias Maccelli,L,UTA,24,82,13,25,38
57,8476392,Adam Lowry,C,WPG,31,82,12,26,38
57,8480220,Noah Cates,L,PHI,25,82,11,27,38
57,8476292,Ondrej Palat,L,NJD,33,82,9,29,38
57,8479992,Michael Rasmussen,C,DET,25,82,21,16,37
57,8475760,Nick Bjugstad,C,UTA,32,82,19,18,37
57,8479293,Brandon Tanev,L,SEA,33,82,16,21,37
57,8478046,Danton Heinen,L,VAN,29,82,12,25,37
57,8470621,Corey Perry,R,EDM,39,82,26,10,36
57,8481032,Paul Cotter,C,NJD,25,82,22,14,36
57,8479365,Trent Frederic,C,BOS,26,82,20,16,36
57,8475722,Jason Zucker,L,BUF,32,82,19,17,36
57,8480185,Eetu Luostarinen,C,FLA,26,82,14,22,36
57,8475791,Taylor Hall,L,CHI,33,82,11,25,36
57,8476854,Hampus Lindholm,D,BOS,30,82,9,27,36
57,8477498,Darnell Nurse,D,EDM,29,82,9,27,36
57,8480073,Erik Brannstrom,D,COL,25,82,7,29,36
57,8478057,Dakota Joshua,C,VAN,28,82,18,17,35
57,8476981,Josh Anderson,R,MTL,30,82,18,17,35
57,8478569,Noel Acciari,C,PIT,33,82,17,18,35
57,8477488,Brett Pesce,D,NJD,30,82,12,23,35
57,8480336,Sean Walker,D,CAR,30,82,11,24,35
57,8480873,Rasmus Sandin,D,WSH,24,82,3,32,35
57,8479591,Michael Eyssimont,C,TBL,28,82,22,12,34
57,8483515,Juraj Slafkovsky,L,MTL,20,82,17,17,34
57,8473422,Nick Foligno,L,CHI,37,82,16,18,34
57,8480995,Pontus Holmberg,R,TOR,25,82,15,19,34
57,8475848,Brendan Gallagher,R,MTL,32,82,13,21,34
57,8484153,Leo Carlsson,C,ANA,20,82,10,24,34
57,8479398,Samuel Girard,D,COL,26,82,5,29,34
57,8480459,Pius Suter,C,VAN,28,82,18,15,33
57,8474149,Evgenii Dadonov,R,DAL,35,82,14,19,33
57,8482133,Thomas Bordeleau,C,SJS,22,82,12,21,33
57,8480817,K'Andre Miller,D,NYR,24,82,11,22,33
57,8482624,Daniil Miromanov,D,CGY,27,82,10,23,33
57,8476374,Sean Kuraly,C,CBJ,31,82,10,23,33
57,8477220,Nate Schmidt,D,FLA,33,82,8,25,33
57,8476902,Esa Lindell,D,DAL,30,82,5,28,33
57,8476331,Dylan DeMelo,D,WPG,31,82,4,29,33
57,8476892,Colton Parayko,D,STL,31,82,3,30,33
57,8481554,Kaapo Kakko,R,NYR,23,82,21,11,32
57,8481580,Connor McMichael,C,WSH,23,82,19,13,32
57,8476918,Jimmy Vesey,L,NYR,31,82,19,13,32
57,8482125,Alexander Holtz,R,VGK,22,82,17,15,32
57,8479351,Sam Steel,C,DAL,26,82,16,16,32
57,8484203,Bradly Nadeau,L,CAR,19,82,15,17,32
57,8476873,Mark Jankowski,C,NSH,30,82,14,18,32
57,8478133,Jake Evans,C,MTL,28,82,12,20,32
57,8479316,Luke Kunin,C,SJS,27,82,10,22,32
57,8481522,Peyton Krebs,C,BUF,23,82,10,22,32
57,8476885,Jacob Trouba,D,NYR,30,82,9,23,32
57,8482671,Owen Power,D,BUF,22,82,6,26,32
57,8474151,Ryan McDonagh,D,TBL,35,82,3,29,32
57,8482142,Jamie Drysdale,D,PHI,22,82,1,31,32
57,8477425,Miles Wood,L,COL,29,82,21,10,31
57,8476960,Andreas Athanasiou,C,CHI,30,82,16,15,31
57,8479353,Brett Howden,C,VGK,26,82,16,15,31
57,8482079,Marco Rossi,C,MIN,23,82,16,15,31
57,8482803,Olen Zellweger,D,ANA,21,82,12,19,31
57,8475200,Dmitry Orlov,D,CAR,33,82,9,22,31
57,8482809,Jackson Blake,R,CAR,21,82,8,23,31
57,8477435,Ryan Graves,D,PIT,29,82,3,28,31
57,8478020,Michael Amadio,C,OTT,28,82,18,12,30
57,8474715,Cam Atkinson,R,TBL,35,82,17,13,30
57,8477987,Ryan Donato,C,CHI,28,82,14,16,30
57,8479393,Noah Gregor,C,OTT,26,82,14,16,30
57,8484145,Zach Benson,L,BUF,19,82,14,16,30
57,8479390,Taylor Raddysh,R,WSH,26,82,12,18,30
57,8480789,Oliver Wahlstrom,R,NYI,24,82,11,19,30
57,8476878,Zemgus Girgensons,L,TBL,30,82,10,20,30
57,8480878,Nils Lundkvist,D,DAL,24,82,7,23,30
57,8476897,Oskar Sundqvist,C,STL,30,82,5,25,30
57,8477948,Travis Sanheim,D,PHI,28,82,4,26,30
57,8481477,Nico Sturm,C,SJS,29,82,14,15,29
57,8477353,Tyler Motte,C,DET,29,82,13,16,29
57,8476480,Vladislav Namestnikov,C,WPG,32,82,12,17,29
57,8478434,Keegan Kolesar,R,VGK,27,82,10,19,29
57,8477839,Conor Sheary,L,TBL,32,82,9,20,29
57,8476457,Adam Larsson,D,SEA,32,82,8,21,29
57,8478507,John Marino,D,UTA,27,82,6,23,29
57,8478500,Ivan Provorov,D,CBJ,27,82,6,23,29
57,8475764,Cam Fowler,D,ANA,33,82,5,24,29
57,8476312,Josh Manson,D,COL,33,82,5,24,29
57,8479402,Jake Bean,D,CGY,26,82,2,27,29
57,8481014,Alexander Romanov,D,NYI,24,82,0,29,29
57,8482117,Lukas Reichel,L,CHI,22,82,16,12,28
57,8473533,Jordan Staal,C,CAR,36,82,14,14,28
57,8483431,Logan Cooley,C,UTA,20,82,14,14,28
57,8476469,Joel Armia,R,MTL,31,82,13,15,28
57,8476442,Matt Nieto,L,PIT,32,82,12,16,28
57,8477953,Kasperi Kapanen,R,STL,28,82,11,17,28
57,8477989,Christian Dvorak,C,MTL,28,82,11,17,28
57,8481517,Brett Leason,R,ANA,25,82,10,18,28
57,8481606,Jordan Spence,D,LAK,23,82,5,23,28
57,8475462,Radko Gudas,D,ANA,34,82,5,23,28
57,8476931,Jake McCabe,D,TOR,31,82,4,24,28
57,8479371,Dante Fabbro,D,NSH,26,82,1,27,28
57,8481093,Rafael Harvey-Pinard,L,MTL,25,82,17,10,27
57,8482077,Dylan Holloway,L,EDM,23,82,17,10,27
57,8478508,Yakov Trenin,C,MIN,27,82,15,12,27
57,8484166,Adam Fantilli,C,CBJ,20,82,13,14,27
57,8478109,Victor Olofsson,L,VGK,29,82,13,14,27
57,8475220,Marcus Foligno,L,MIN,33,82,13,14,27
57,8481481,Blake Lizotte,C,PIT,27,82,11,16,27
57,8475343,Nic Dowd,C,WSH,34,82,11,16,27
57,8476278,Colin Blackwell,C,DAL,31,82,10,17,27
57,8479414,Nathan Bastian,R,NJD,27,82,10,17,27
57,8477369,Carson Soucy,D,VAN,30,82,9,18,27
57,8479976,Juuso Valimaki,D,UTA,26,82,8,19,27
57,8477506,Ryan Pulock,D,NYI,30,82,5,22,27
57,8476917,Adam Pelech,D,NYI,30,82,5,22,27
57,8476463,Jonas Brodin,D,MIN,31,82,3,24,27
57,8476879,Cody Ceci,D,EDM,31,82,2,25,27
57,8475690,Chris Tanev,D,TOR,35,82,0,27,27
57,8477998,Warren Foegele,L,LAK,28,82,17,9,26
57,8482155,Alex Laferriere,R,LAK,23,82,15,11,26
57,8475193,Tomas Tatar,L,NJD,34,82,14,12,26
57,8481704,Juuso Parssinen,C,NSH,23,82,13,13,26
57,8477392,Hudson Fasching,R,NYI,29,82,12,14,26
57,8482074,Connor Zary,C,CGY,23,82,11,15,26
57,8482122,Brock Faber,D,MIN,22,82,8,18,26
57,8476467,Jamie Oleksiak,D,SEA,32,82,8,18,26
57,8475231,Casey Cizikas,C,NYI,33,82,8,18,26
57,8476921,Jordan Martinook,L,CAR,32,82,8,18,26
57,8482105,Jake Sanderson,D,OTT,22,82,7,19,26
57,8476429,Scott Mayfield,D,NYI,32,82,5,21,26
57,8474574,Tyler Myers,D,VAN,34,82,4,22,26
57,8480246,Nick Perbix,D,TBL,26,82,3,23,26
57,8475455,Brenden Dillon,D,NJD,34,82,3,23,26
57,8475855,Jesper Fast,R,CAR,33,82,14,11,25
57,8480813,Joe Veleno,C,DET,24,82,14,11,25
57,8482101,Danil Gushchin,L,SJS,22,82,14,11,25
57,8480074,Alexandre Texier,C,STL,25,82,11,14,25
57,8482062,Cole Smith,L,NSH,29,82,10,15,25
57,8480021,Jack Studnicka,C,LAK,25,82,9,16,25
57,8478911,Matt Roy,D,WSH,29,82,8,17,25
57,8478399,Jonas Siegenthaler,D,NJD,27,82,7,18,25
57,8475181,Nick Leddy,D,STL,33,82,5,20,25
57,8481568,Alex Vlasic,D,CHI,23,82,4,21,25
57,8475324,Nick Jensen,D,OTT,34,82,3,22,25
57,8480049,Dylan Samberg,D,WPG,25,82,1,24,25
57,8478416,Erik Cernak,D,TBL,27,82,1,24,25
57,8482245,Artem Zub,D,OTT,29,82,0,25,25
57,8479661,Tanner Jeannot,L,LAK,27,82,12,12,24
57,8480806,Isac Lundestrom,C,ANA,25,82,11,13,24
57,8480068,Ryan Poehling,C,PHI,25,82,9,15,24
57,8477507,Nikita Zadorov,D,BOS,29,82,9,15,24
57,8478136,Jake Middleton,D,MIN,28,82,8,16,24
57,8477406,Mattias Janmark,C,EDM,32,82,8,16,24
57,8479980,Nicolas Hague,D,VGK,26,82,6,18,24
57,8474673,TJ Brodie,D,CHI,34,82,4,20,24
57,8480222,Sebastian Aho,D,PIT,28,82,4,20,24
57,8479368,Max Jones,L,BOS,26,82,14,9,23
57,8480144,David Kampf,C,TOR,29,82,11,12,23
57,8482166,Shakir Mukhamadullin,D,SJS,22,82,10,13,23
57,8481028,Martin Pospisil,C,CGY,25,82,8,15,23
57,8474013,Ian Cole,D,UTA,35,82,8,15,23
57,8480448,Parker Kelly,L,COL,25,82,8,15,23
57,8478882,Vladislav Gavrikov,D,LAK,29,82,6,17,23
57,8483445,Cutter Gauthier,L,ANA,20,82,6,17,23
57,8479442,Troy Stecher,D,EDM,30,82,6,17,23
57,8479983,Mario Ferraro,D,SJS,26,82,5,18,23
57,8478178,Darren Raddysh,D,TBL,28,82,5,18,23
57,8476422,Mike Reilly,D,NYI,31,82,4,19,23
57,8480025,MacKenzie Entwistle,R,FLA,25,82,4,19,23
57,8480043,Timothy Liljegren,D,TOR,25,82,3,20,23
57,8479998,Mikey Anderson,D,LAK,25,82,3,20,23
57,8477505,Alexander Wennberg,C,SJS,30,82,10,12,22
57,8483457,Lane Hutson,D,MTL,20,82,9,13,22
57,8483495,Simon Nemec,D,NJD,20,82,7,15,22
57,8475171,Oliver Ekman-Larsson,D,TOR,33,82,6,16,22
57,8475279,Ben Chiarot,D,DET,33,82,6,16,22
57,8473507,Jeff Petry,D,DET,37,82,4,18,22
57,8483763,Maksymilian Szuber,D,UTA,22,82,4,18,22
57,8482655,J.J. Moser,D,TBL,24,82,0,22,22
57,8476858,Phillip Di Giuseppe,L,VAN,31,82,13,8,21
57,8480281,Alexey Toropchenko,R,STL,25,82,12,9,21
57,8477450,Jason Dickinson,C,CHI,29,82,11,10,21
57,8481641,Joel Kiviranta,L,COL,28,82,8,13,21
57,8476525,Colin Miller,D,WPG,32,82,6,15,21
57,8480855,Jack McBain,C,UTA,24,82,6,15,21
57,8480796,Martin Fehervary,D,WSH,25,82,6,15,21
57,8477015,Connor Brown,R,EDM,30,82,5,16,21
57,8477845,Trevor van Riemsdyk,D,WSH,33,82,5,16,21
57,8482470,Ilya Solovyov,D,CGY,24,82,4,17,21
57,8476891,Matt Grzelcyk,D,PIT,30,82,2,19,21
57,8483490,Pavel Mintyukov,D,ANA,21,82,1,20,21
57,8478468,Jeremy Lauzon,D,NSH,27,82,10,10,20
57,8478211,Dryden Hunt,L,CGY,29,82,10,10,20
57,8482702,Logan Stankoven,C,DAL,21,82,8,12,20
57,8483482,Tristan Luneau,D,ANA,20,82,7,13,20
57,8482762,Simon Edvinsson,D,DET,21,82,7,13,20
57,8481178,Egor Zamula,D,PHI,24,82,5,15,20
57,8483505,Matthew Poitras,C,BOS,20,82,5,15,20
57,8481605,Jackson LaCombe,D,ANA,23,82,5,15,20
57,8480834,Ty Emberson,D,SJS,24,82,4,16,20
57,8475233,David Savard,D,MTL,34,82,3,17,20
57,8483012,Logan Morrison,C,SEA,22,82,3,17,20
57,8475188,Brayden McNabb,D,VGK,33,82,2,18,20
57,8482259,Bobby McMann,C,TOR,28,82,12,7,19
57,8477508,Curtis Lazar,C,NJD,29,82,9,10,19
57,8478432,Christian Fischer,R,DET,27,82,8,11,19
57,8473453,Trevor Lewis,C,LAK,37,82,8,11,19
57,8484911,Collin Graf,R,SJS,22,82,7,12,19
57,8479359,Beck Malenstyn,L,BUF,26,82,6,13,19
57,8482858,Ryker Evans,D,SEA,23,82,5,14,19
57,8482141,Lukas Cormier,D,VGK,22,82,4,15,19
57,8481567,Henry Thrun,D,SJS,23,82,4,15,19
57,8478851,Alexandre Carrier,D,NSH,28,82,3,16,19
57,8478859,Niko Mikkola,D,FLA,28,82,3,16,19
57,8479369,Andrew Peeke,D,BOS,26,82,2,17,19
57,8475718,Justin Holl,D,DET,32,82,2,17,19
57,8477365,Connor Clifton,D,BUF,29,82,1,18,19
57,8478840,Will Borgen,D,SEA,28,82,1,18,19
57,8482712,Oskar Olausson,R,COL,22,82,9,9,18
57,8482659,Josh Doan,R,UTA,22,82,9,9,18
57,8476889,Radek Faksa,C,STL,30,82,6,12,18
57,8478013,Jake Walman,D,SJS,28,82,5,13,18
57,8483524,Shane Wright,C,SEA,20,82,5,13,18
57,8481708,Zac Jones,D,NYR,24,82,5,13,18
57,8477499,Rasmus Ristolainen,D,PHI,30,82,4,14,18
57,8475790,Erik Gudbranson,D,CBJ,32,82,4,14,18
57,8475762,Derek Forbort,D,VAN,32,82,4,14,18
57,8479324,Ryan Lindgren,D,NYR,26,82,3,15,18
57,8474612,Travis Hamonic,D,OTT,34,82,3,15,18
57,8480807,Mattias Samuelsson,D,BUF,24,82,1,17,18
57,8476967,Brett Kulak,D,EDM,30,82,1,17,18
57,8477931,Tomas Nosek,L,FLA,32,82,8,9,17
57,8481524,Bowen Byram,D,BUF,23,82,7,10,17
57,8483468,Jiri Kulich,C,BUF,20,82,5,12,17
57,8483493,Frank Nazar,C,CHI,20,82,5,12,17
57,8477938,Haydn Fleury,D,WPG,28,82,4,13,17
57,8478450,Parker Wotherspoon,D,BOS,27,82,4,13,17
57,8480950,Ilya Lyubushkin,D,DAL,30,82,3,14,17
57,8479576,Vincent Desharnais,D,VAN,28,82,3,14,17
57,8476624,Barclay Goodrow,C,SJS,31,82,2,15,17
57,8482073,Braden Schneider,D,NYR,23,82,2,15,17
57,8482807,Ethan Del Mastro,D,CHI,21,82,7,9,16
57,8481601,Simon Holmstrom,R,NYI,23,82,7,9,16
57,8477903,Garnet Hathaway,R,PHI,33,82,6,10,16
57,8482111,Justin Barron,D,MTL,23,82,4,12,16
57,8482666,Scott Morrow,D,CAR,22,82,4,12,16
57,8475177,Calvin de Haan,D,COL,33,82,3,13,16
57,8480860,Kevin Bahl,D,CGY,24,82,2,14,16
57,8480879,Jacob Bernard-Docker,D,OTT,24,82,0,16,16
57,8483397,Marc McLaughlin,C,BOS,25,82,9,6,15
57,8482153,Brendan Brisson,C,VGK,23,82,7,8,15
57,8480980,Connor Dewar,C,TOR,25,82,6,9,15
57,8482733,Logan Mailloux,D,MTL,31,82,5,10,15
57,8478874,Adam Gaudette,C,OTT,28,82,4,11,15
57,8483499,Liam Ohgren,L,MIN,20,82,4,11,15
57,8482749,Joshua Roy,R,MTL,21,82,3,12,15
57,8476372,Nick Seeler,D,PHI,31,82,3,12,15
57,8483460,David Jiricek,D,CBJ,21,82,3,12,15
57,8481699,Aku Raty,R,UTA,23,82,10,4,14
57,8475842,Sam Carrick,C,NYR,32,82,8,6,14
57,8482679,Matt Coronato,R,CGY,22,82,4,10,14
57,8479291,Kevin Rooney,C,CGY,31,82,4,10,14
57,8482787,Nikita Chibrikov,R,WPG,31,82,4,10,14
57,8483565,Nick Blankenburg,D,NSH,26,82,1,13,14
57,8470600,Ryan Suter,D,STL,39,82,1,13,14
57,8476441,Joel Edmundson,D,LAK,31,82,1,13,14
57,8480990,Declan Chisholm,D,MIN,24,82,7,6,13
57,8482516,Matthew Kessel,D,STL,24,82,4,9,13
57,8477034,Jaycob Megna,D,FLA,32,82,4,9,13
57,8484149,Gavin Brindley,C,CBJ,20,82,3,10,13
57,8481122,Simon Benoit,D,TOR,26,82,3,10,13
57,8483466,Kevin Korchinski,D,CHI,20,82,2,11,13
57,8471677,Jack Johnson,D,CBJ,37,82,2,11,13
57,8480035,Henri Jokiharju,D,BUF,25,82,1,12,13
57,8482145,Mavrik Bourque,C,DAL,22,82,3,9,12
57,8477335,Kyle Burroughs,D,LAK,29,82,3,9,12
57,8478443,Brandon Carlo,D,BOS,28,82,2,10,12
57,8482859,Zack Ostapchuk,C,OTT,21,82,2,10,12
57,8480870,Bo Groulx,C,NYR,24,82,5,6,11
57,8474567,Zach Bogosian,D,MIN,34,82,3,8,11
57,8482087,Kaiden Guhle,D,MTL,22,82,2,9,11
57,8479638,Justin Brazeau,R,BOS,26,82,2,9,11
57,8480172,Jan Rutta,D,SJS,34,82,3,7,10
57,8482713,Mackie Samoskevich,R,FLA,22,82,2,8,10
57,8474062,Riley Nash,C,NYR,35,82,2,8,10
57,8476473,Connor Murphy,D,CHI,31,82,3,5,8
57,8482070,Mitchell Chaffee,R,TBL,26,82,3,5,8
57,8483567,Georgii Merkulov,C,BOS,24,82,1,7,8
57,8476822,Luke Glendening,C,TBL,35,82,4,3,7
57,8483471,Brad Lambert,C,WPG,31,82,3,4,7
57,8474090,Brendan Smith,D,DAL,35,82,2,4,6
57,8482118,Sam Colangelo,R,ANA,23,82,1,4,5
57,8483489,Fraser Minten,C,TOR,31,82,1,4,5
57,8470794,Joe Pavelski,C,,40,0,0,0,0
57,8481703,Valtteri Puustinen,R,PIT,25,0,0,0,0
57,8477950,Tony DeAngelo,D,,29,0,0,0,0
57,8481577,Philip Tomasino,C,NSH,23,0,0,0,0
57,8475197,Tyson Barrie,D,,33,0,0,0,0
57,8471218,Blake Wheeler,R,,38,0,0,0,0
57,8474157,Max Pacioretty,L,,36,0,0,0,0
57,8478466,Daniel Sprong,R,VAN,27,0,0,0,0
57,8475744,Evgeny Kuznetsov,C,,32,0,0,0,0
57,8481019,David Gustafsson,C,WPG,24,0,0,0,0
57,8475906,John Klingberg,D,,32,0,0,0,0
57,8479348,Kale Clague,D,BUF,26,0,0,0,0
57,8476952,Dominic Toninato,C,WPG,30,0,0,0,0
57,8473473,Milan Lucic,L,,36,0,0,0,0
57,8474037,James van Riemsdyk,L,,35,0,0,0,0
57,8474602,Justin Schultz,D,,34,0,0,0,0
57,8482222,Alexander Barabanov,L,,30,0,0,0,0
57,8479372,Josh Mahura,D,SEA,26,0,0,0,0
57,8479982,Conor Timmins,D,TOR,26,0,0,0,0
57,8474031,Kevin Shattenkirk,D,,35,0,0,0,0
57,8480008,Adam Ruzicka,C,,25,0,0,0,0
57,8481059,Scott Perunovich,D,STL,26,0,0,0,0
57,8480884,Calen Addison,D,,24,0,0,0,0
57,8476994,Vinnie Hinostroza,C,NSH,30,0,0,0,0
57,8478452,Caleb Jones,D,LAK,27,0,0,0,0
57,8480157,Calle Rosen,D,COL,30,0,0,0,0
57,8481609,Vladislav Kolyachonok,D,UTA,23,0,0,0,0
57,8479415,Michael McLeod,C,,26,0,0,0,0
57,8476919,Chris Tierney,C,,30,0,0,0,0
57,8479639,Dylan Coghlan,D,WPG,26,0,0,0,0
57,8478146,Matthew Highmore,C,OTT,28,0,0,0,0
57,8478970,Jalen Chatfield,D,CAR,28,0,0,0,0
57,8480205,Emil Bemstrom,C,PIT,25,0,0,0,0
57,8474884,Mike Hoffman,C,,35,0,0,0,0
57,8471274,Alex Goligoski,D,,39,0,0,0,0
57,8478104,Sammy Blais,L,,28,0,0,0,0
57,8474870,Tyler Johnson,C,,34,0,0,0,0
57,8476913,Devin Shore,C,MIN,30,0,0,0,0
57,8481598,Philip Broberg,D,EDM,23,0,0,0,0
57,8480058,Pierre-Olivier Joseph,D,STL,25,0,0,0,0
57,8480891,Michael Kesselring,D,UTA,24,0,0,0,0
57,8477979,Nicolas Aube-Kubel,R,BUF,28,0,0,0,0
57,8476871,Tanner Pearson,L,,32,0,0,0,0
57,8476393,Nick Cousins,C,,31,0,0,0,0
57,8479977,Kailer Yamamoto,R,,26,0,0,0,0
57,8479543,Michael Pezzetta,L,MTL,26,0,0,0,0
57,8477018,Ben Hutton,D,VGK,31,0,0,0,0
57,8480762,Eric Robinson,L,CAR,29,0,0,0,0
57,8474034,Pat Maroon,L,CHI,36,0,0,0,0
57,8481058,Jesse Ylönen,R,,25,0,0,0,0
57,8475179,Dmitry Kulikov,D,FLA,34,0,0,0,0
57,8481527,Kaedan Korczak,D,VGK,23,0,0,0,0
57,8473449,Kyle Okposo,R,,36,0,0,0,0
57,8482192,Isaak Phillips,D,CHI,23,0,0,0,0
57,8480727,Zach Whitecloud,D,VGK,28,0,0,0,0
57,8479346,Dillon Dube,C,,26,0,0,0,0
57,8480821,Filip Zadina,R,,25,0,0,0,0
57,8480001,Urho Vaakanainen,D,ANA,25,0,0,0,0
57,8470966,Mark Giordano,D,,41,0,0,0,0
57,8480853,Liam Foudy,C,,24,0,0,0,0
57,8475225,Craig Smith,C,CHI,35,0,0,0,0
57,8479972,Mason Shaw,C,WPG,26,0,0,0,0
57,8478451,Ethan Bear,D,WSH,27,0,0,0,0
57,8474040,Sam Gagner,C,,35,0,0,0,0
57,8480196,Jacob Bryson,D,BUF,27,0,0,0,0
57,8479984,Cal Foote,D,,26,0,0,0,0
57,8480011,Klim Kostin,C,SJS,25,0,0,0,0
57,8482176,Wyatt Kaiser,D,CHI,22,0,0,0,0
57,8476988,Matt Benning,D,SJS,30,0,0,0,0
57,8479370,Tyson Jost,C,CAR,26,0,0,0,0
57,8477464,Nic Petan,C,,29,0,0,0,0
57,8477380,Jonny Brodzinski,C,NYR,31,0,0,0,0
57,8480070,Ian Mitchell,D,BOS,25,0,0,0,0
57,8479315,Joey Anderson,R,CHI,26,0,0,0,0
57,8478099,Kevin Labanc,R,,29,0,0,0,0
57,8476874,Olli Maatta,D,DET,30,0,0,0,0
57,8475208,Brian Dumoulin,D,ANA,33,0,0,0,0
57,8478430,Oliver Kylington,D,,27,0,0,0,0
57,8479536,Axel Jonsson-Fjallby,L,WPG,26,0,0,0,0
57,8479671,Mathieu Olivier,R,CBJ,27,0,0,0,0
57,8471709,Marc-Edouard Vlasic,D,SJS,37,0,0,0,0
57,8479328,Julien Gauthier,R,NYI,27,0,0,0,0
57,8478421,A.J. Greer,L,FLA,28,0,0,0,0
57,8477573,Nathan Walker,L,STL,30,0,0,0,0
57,8481537,Nikita Okhotiuk,D,CGY,24,0,0,0,0
57,8474166,Alec Martinez,D,CHI,37,0,0,0,0
57,8470610,Zach Parise,L,,40,0,0,0,0
57,8477478,William Carrier,L,CAR,30,0,0,0,0
57,8479344,Jesse Puljujarvi,R,PIT,26,0,0,0,0
57,8480887,Jordan Harris,D,MTL,24,0,0,0,0
57,8478502,Dennis Gilbert,D,BUF,28,0,0,0,0
57,8482730,Brandt Clarke,D,LAK,21,0,0,0,0
57,8480355,Mark Kastelic,C,BOS,25,0,0,0,0
57,8475750,Jon Merrill,D,MIN,32,0,0,0,0
57,8475164,Jakob Silfverberg,R,,34,0,0,0,0
57,8477944,Jakub Vrana,L,,28,0,0,0,0
57,8479439,Jacob MacDonald,D,COL,31,0,0,0,0
57,8474568,Luke Schenn,D,NSH,35,0,0,0,0
57,8478454,Noah Juulsen,D,VAN,27,0,0,0,0
57,8475752,Tyler Pitlick,C,,33,0,0,0,0
57,8482148,Hendrix Lapierre,C,WSH,22,0,0,0,0
57,8481167,Brayden Pachal,D,CGY,25,0,0,0,0
57,8478043,Sam Lafferty,C,BUF,29,0,0,0,0
57,8479321,Lucas Johansen,D,,27,0,0,0,0
57,8471699,Andrew Cogliano,C,,37,0,0,0,0
57,8481521,Ronnie Attard,D,PHI,25,0,0,0,0
57,8481161,Jake Christiansen,D,CBJ,25,0,0,0,0
57,8479458,Nikita Zaitsev,D,,33,0,0,0,0
57,8479619,Michael Carcone,L,UTA,28,0,0,0,0
57,8479026,Philippe Myers,D,TOR,27,0,0,0,0
57,8477330,Dominik Kubalik,L,,29,0,0,0,0
57,8481617,Vasily Podkolzin,R,VAN,23,0,0,0,0
57,8481701,Santeri Hatakka,D,NJD,23,0,0,0,0
57,8479514,Rem Pitlick,C,,27,0,0,0,0
57,8477446,Michael McCarron,R,NSH,29,0,0,0,0
57,8470604,Jeff Carter,C,,39,0,0,0,0
57,8482241,Radim Zohorna,L,,28,0,0,0,0
57,8480289,Morgan Barron,C,WPG,26,0,0,0,0
57,8479379,Givani Smith,R,SJS,26,0,0,0,0
57,8480216,Jacob Peterson,C,,25,0,0,0,0
57,8477851,Jordan Oesterle,D,BOS,32,0,0,0,0
57,8484258,Sam Malinski,D,COL,26,0,0,0,0
57,8478904,Steven Lorentz,C,,28,0,0,0,0
57,8482095,Tyler Kleven,D,OTT,22,0,0,0,0
57,8480848,Ty Dellandrea,C,SJS,24,0,0,0,0
57,8476884,Derrick Pouliot,D,,30,0,0,0,0
57,8479336,Carl Grundstrom,R,SJS,27,0,0,0,0
57,8482964,Arber Xhekaj,D,MTL,23,0,0,0,0
57,8471686,Marc Staal,D,,37,0,0,0,0
57,8477887,Patrick Brown,C,BOS,32,0,0,0,0
57,8478495,Denis Gurianov,R,,27,0,0,0,0
57,8473504,Cal Clutterbuck,R,,37,0,0,0,0
57,8481550,Adam Beckman,L,NJD,23,0,0,0,0
57,8480845,Rasmus Kupari,C,WPG,24,0,0,0,0
57,8474009,Nick Bonino,C,,36,0,0,0,0
57,8478585,Derek Ryan,C,EDM,38,0,0,0,0
57,8477962,Brendan Lemieux,L,CAR,28,0,0,0,0
57,8482861,Vincent Iorio,D,WSH,22,0,0,0,0
57,8479378,Logan Stanley,D,WPG,26,0,0,0,0
57,8473446,Erik Johnson,D,PHI,36,0,0,0,0
57,8481743,Marc Del Gaizo,D,NSH,25,0,0,0,0
57,8477384,Josh Brown,D,EDM,30,0,0,0,0
57,8482165,Yan Kuznetsov,D,CGY,22,0,0,0,0
57,8478424,Jansen Harkins,C,ANA,27,0,0,0,0
57,8482144,Jack Thompson,D,SJS,22,0,0,0,0
57,8478512,Austin Czarnik,C,,32,0,0,0,0
57,8477527,Ross Johnston,L,ANA,30,0,0,0,0
57,8479383,Boris Katchouk,L,,26,0,0,0,0
57,8482094,Daemon Hunt,D,MIN,22,0,0,0,0
57,8481719,Maxwell Crozier,D,TBL,24,0,0,0,0
57,8480192,Johnathan Kovacevic,D,NJD,27,0,0,0,0
57,8479376,Victor Mete,D,,26,0,0,0,0
57,8482511,Mason Lohrei,D,BOS,23,0,0,0,0
57,8475825,Jani Hakanpää,D,,32,0,0,0,0
57,8478021,William Lagesson,D,DET,28,0,0,0,0
57,8475795,Dylan McIlrath,D,WSH,32,0,0,0,0
57,8477846,Ryan Carpenter,C,,33,0,0,0,0
57,8481056,Spencer Stastney,D,NSH,24,0,0,0,0
57,8481564,Ryan Johnson,D,BUF,23,0,0,0,0
57,8478017,Mark Friedman,D,VAN,29,0,0,0,0
57,8479320,Max Lajoie,D,SEA,27,0,0,0,0
57,8480075,Cameron Crotty,D,MIN,25,0,0,0,0
57,8484287,Cole McWard,D,VAN,23,0,0,0,0
57,8484254,Akito Hirose,D,VAN,25,0,0,0,0
57,8483407,Brandon Scanlin,D,NYR,25,0,0,0,0
57,8480274,Philip Kemp,D,EDM,25,0,0,0,0
57,8479522,Hardy Haman Aktell,D,WSH,26,0,0,0,0
57,8480007,Jonas Rondbjerg,R,VGK,25,0,0,0,0
57,8477454,Adam Erne,L,,29,0,0,0,0
57,8481679,Maxence Guenette,D,OTT,23,0,0,0,0
57,8480441,Trey Fix-Wolansky,R,CBJ,25,0,0,0,0
57,8483546,Marshall Rifai,D,TOR,26,0,0,0,0
57,8480084,Nick DeSimone,D,NJD,30,0,0,0,0
57,8481030,Jack St. Ivany,D,PIT,25,0,0,0,0
57,8481592,Jakob Pelletier,L,CGY,23,0,0,0,0
57,8478011,Louie Belpedio,D,PHI,28,0,0,0,0
57,8477930,Pierre-Edouard Bellemare,L,,39,0,0,0,0
57,8484321,Nikolas Matinpalo,D,OTT,26,0,0,0,0
57,8482067,Connor Mackey,D,NYR,28,0,0,0,0
57,8481806,Louis Crevier,D,CHI,23,0,0,0,0
57,8484326,Patrik Koch,D,UTA,28,0,0,0,0
57,8477971,Andreas Englund,D,LAK,28,0,0,0,0
57,8481751,Lukas Rousek,R,BUF,25,0,0,0,0
57,8481006,Tyler Tucker,D,STL,24,0,0,0,0
57,8476867,Brendan Gaunce,C,MIN,30,0,0,0,0
57,8479520,Brandon Duhaime,R,WSH,27,0,0,0,0
57,8477073,Kurtis MacDermid,L,NJD,30,0,0,0,0
57,8480874,Adam Ginning,D,PHI,24,0,0,0,0
57,8477473,Justin Bailey,R,SJS,29,0,0,0,0
57,8479066,Ryan Lomberg,L,CGY,30,0,0,0,0
57,8477070,Liam O'Brien,C,UTA,30,0,0,0,0
57,8474618,Marco Scandella,D,,34,0,0,0,0
57,8475797,Jarred Tinordi,D,,32,0,0,0,0
57,8481441,Joe Snively,C,DET,28,0,0,0,0
57,8477244,Chad Ruhwedel,D,NYR,34,0,0,0,0
57,8479772,Zack MacEwen,R,OTT,28,0,0,0,0
57,8481147,Reese Johnson,C,MIN,26,0,0,0,0
57,8481043,Cole Koepke,L,BOS,26,0,0,0,0
57,8483619,Filip Roos,D,OTT,25,0,0,0,0
57,8481541,Samuel Bolduc,D,NYI,24,0,0,0,0
57,8477810,Joel Hanley,D,CGY,33,0,0,0,0
57,8476907,Mackenzie MacEachern,L,,30,0,0,0,0
57,8482652,Walker Duehr,R,CGY,27,0,0,0,0
57,8477126,Jayson Megna,C,,34,0,0,0,0
57,8483398,Declan Carlile,D,TBL,31,0,0,0,0
57,8482929,Emil Lilleberg,D,TBL,23,0,0,0,0
57,8480880,Jakub Lauko,C,MIN,24,0,0,0,0
57,8480245,Olle Lycksell,R,PHI,25,0,0,0,0
57,8480252,Cole Guttman,C,CHI,25,0,0,0,0
57,8477467,Gustav Olofsson,D,SEA,30,0,0,0,0
57,8479968,Vinni Lettieri,C,BOS,29,0,0,0,0
57,8478400,Colin White,C,,27,0,0,0,0
57,8475755,Alexander Petrovic,D,DAL,32,0,0,0,0
57,8481812,Nikolai Knyzhov,D,,27,0,0,0,0
57,8481593,Jayden Struble,D,MTL,23,0,0,0,0
57,8481532,Alex Turcotte,C,LAK,23,0,0,0,0
57,8482126,Emil Andrae,D,PHI,31,0,0,0,0
57,8479944,Zach Aston-Reese,C,VGK,30,0,0,0,0
57,8471817,Ryan Reaves,R,TOR,37,0,0,0,0
57,8481206,John Ludvig,D,PIT,24,0,0,0,0
57,8481599,Victor Soderstrom,D,UTA,23,0,0,0,0
57,8480292,Carson Meyer,R,ANA,27,0,0,0,0
57,8482496,Nils Aman,C,VAN,24,0,0,0,0
57,8479718,Alex Barré-Boulet,C,MTL,27,0,0,0,0
57,8479994,Jaret Anderson-Dolan,C,WPG,25,0,0,0,0
57,8480184,Gustav Lindstrom,D,,26,0,0,0,0
57,8480890,Jan Jenik,R,OTT,24,0,0,0,0
57,8478067,Oskar Lindblom,L,,28,0,0,0,0
57,8476934,Brock McGinn,L,ANA,30,0,0,0,0
57,8479985,Cale Fleury,D,SEA,26,0,0,0,0
57,8484304,Uvis Balinskis,D,FLA,28,0,0,0,0
57,8479981,Jonah Gadjovich,L,FLA,26,0,0,0,0
57,8481716,Dmitri Voronkov,L,CBJ,24,0,0,0,0
57,8474709,Matt Martin,L,,35,0,0,0,0
57,8482634,Alex Steeves,C,TOR,25,0,0,0,0
57,8480823,Alexander Alexeyev,D,WSH,25,0,0,0,0
57,8477541,Dakota Mermis,D,TOR,30,0,0,0,0
57,8483491,Ivan Miroshnichenko,L,WSH,20,0,0,0,0
57,8478477,Mitchell Stephens,C,SEA,27,0,0,0,0
57,8481543,Nikita Alexandrov,C,STL,24,0,0,0,0
57,8479423,Alex Nylander,L,,26,0,0,0,0
57,8482451,Mikael Pyyhtia,L,CBJ,23,0,0,0,0
57,8478831,Kevin Stenlund,C,UTA,28,0,0,0,0
57,8480306,Grant Hutton,D,NYI,29,0,0,0,0
57,8478028,Fredrik Olofsson,L,,28,0,0,0,0
57,8477462,Robert Hagg,D,VGK,29,0,0,0,0
57,8477320,Anton Blidh,L,NYR,29,0,0,0,0
57,8482157,Will Cuylle,L,NYR,22,0,0,0,0
57,8482737,Zack Bolduc,C,STL,21,0,0,0,0
57,8481239,Samuel Fagemo,L,,24,0,0,0,0
57,8481600,Tobias Bjornfot,D,FLA,23,0,0,0,0
57,8478409,Anthony Richard,C,PHI,28,0,0,0,0
57,8474145,Robert Bortuzzo,D,,35,0,0,0,0
57,8475958,Michael Sgarbossa,C,WSH,32,0,0,0,0
57,8479986,Kole Lind,R,DAL,26,0,0,0,0
57,8479249,Andrew Poturalski,C,SJS,30,0,0,0,0
57,8479362,Riley Tufte,L,BOS,26,0,0,0,0
57,8479991,Jake Leschyshyn,C,NYR,25,0,0,0,0
57,8479587,Rhett Gardner,C,PHI,28,0,0,0,0
57,8482744,James Malatesta,L,CBJ,21,0,0,0,0
57,8478854,Ryan Shea,D,PIT,27,0,0,0,0
57,8481591,Sam Poulin,R,,23,0,0,0,0
57,8483512,Matt Savoie,C,EDM,20,0,0,0,0
57,8482102,Vasily Ponomarev,C,PIT,22,0,0,0,0
57,8482162,Roby Jarventie,L,EDM,22,0,0,0,0
57,8481016,Ruslan Iskhakov,C,,24,0,0,0,0
57,8482172,Landon Slaggert,L,CHI,22,0,0,0,0
57,8482747,Brennan Othmann,L,NYR,21,0,0,0,0
57,8480031,Maxime Comtois,L,,25,0,0,0,0
57,8480226,Marián Studenic,R,,26,0,0,0,0
57,8478408,Travis Dermott,D,,28,0,0,0,0
57,8481518,Nolan Foote,L,NJD,24,0,0,0,0
57,8479419,Brett Murray,L,BUF,26,0,0,0,0
57,8482088,Justin Sourdif,R,FLA,22,0,0,0,0
57,8482201,Gage Goncalves,C,TBL,23,0,0,0,0
57,8481578,Graeme Clarke,R,MIN,23,0,0,0,0
57,8482177,Marat Khusnutdinov,C,MIN,22,0,0,0,0
57,8481754,Nikita Nesterenko,C,ANA,23,0,0,0,0
57,8483531,Brian Halonen,L,NJD,25,0,0,0,0
57,8483920,Pierrick Dube,R,WSH,23,0,0,0,0
57,8480851,Akil Thomas,C,LAK,24,0,0,0,0
57,8475235,Nicolas Deslauriers,L,PHI,33,0,0,0,0
57,8482476,Emil Heineman,L,MTL,23,0,0,0,0
57,8477149,Scott Sabourin,R,SJS,32,0,0,0,0
57,8483549,Lucas Condotta,L,MTL,27,0,0,0,0
57,8482765,Isak Rosen,R,BUF,21,0,0,0,0
57,8481237,Kyle MacLean,C,NYI,25,0,0,0,0
57,8481024,Linus Karlsson,C,VAN,25,0,0,0,0
57,8481690,Tyler Angle,C,,24,0,0,0,0
57,8483570,Ben Meyers,C,SEA,26,0,0,0,0
57,8481655,Cole Schwindt,R,CGY,23,0,0,0,0
57,8481462,Mason Morelli,L,VGK,28,0,0,0,0
57,8483401,Marc Johnstone,R,PIT,28,0,0,0,0
57,8478956,Samuel Laberge,L,NJD,27,0,0,0,0
57,8479533,Joona Koppanen,L,,26,0,0,0,0
57,8482197,Adam Raska,R,MIN,23,0,0,0,0
57,8482250,Callahan Burke,C,VGK,27,0,0,0,0
57,8482784,Zach Dean,C,STL,21,0,0,0,0
57,8484255,Jason Polin,R,COL,25,0,0,0,0
57,8481077,John Leonard,L,,26,0,0,0,0
57,8481534,Raphael Lavoie,C,EDM,24,0,0,0,0
57,8483609,Adam Klapka,R,CGY,24,0,0,0,0
57,8482751,Ryan Winterton,C,SEA,21,0,0,0,0
57,8480267,Sammy Walker,C,MIN,25,0,0,0,0
57,8475766,Austin Watson,L,,32,0,0,0,0
57,8482460,Matt Rempe,C,NYR,22,0,0,0,0
57,8481065,Angus Crookshank,L,OTT,25,0,0,0,0
57,8481070,Hugh McGing,L,,26,0,0,0,0
57,8476323,Max McCormick,L,SEA,32,0,0,0,0
57,8483395,Arshdeep Bains,L,VAN,23,0,0,0,0
57,8484259,Ondrej Pavel,C,COL,31,0,0,0,0
57,8483432,Luca Del Bel Belluz,C,CBJ,31,0,0,0,0
57,8483045,Cameron Butler,R,CBJ,31,0,0,0,0
57,8482061,Brandon Biro,L,SEA,26,0,0,0,0
57,8477401,John Hayden,C,SEA,29,0,0,0,0
57,8475278,Byron Froese,C,,33,0,0,0,0
57,8478446,Glenn Gawdin,C,LAK,27,0,0,0,0
57,8477993,Justin Kirkland,C,CGY,28,0,0,0,0
57,8482147,Jean-Luc Foudy,C,COL,22,0,0,0,0
57,8480032,Shane Bowers,C,NJD,25,0,0,0,0
57,8479330,Brandon Gignac,C,MTL,27,0,0,0,0
57,8480776,Sheldon Rempal,R,,29,0,0,0,0
57,8475413,Justin Dowling,C,NJD,34,0,0,0,0
57,8481726,Adam Edstrom,C,NYR,24,0,0,0,0
57,8480844,Grigori Denisenko,L,VGK,24,0,0,0,0
57,8478147,Bokondji Imama,L,PIT,28,0,0,0,0
57,8478881,Brett Seney,L,CHI,28,0,0,0,0
57,8483630,Pavol Regenda,L,ANA,25,0,0,0,0
57,8480836,Jonathan Gruden,C,,24,0,0,0,0
57,8484314,Jiri Smejkal,L,,28,0,0,0,0
57,8475780,Chris Wagner,R,COL,33,0,0,0,0
57,8479546,Oskar Steen,C,,26,0,0,0,0
57,8483597,Milos Kelemen,L,UTA,25,0,0,0,0
57,8481789,Tye Kartye,L,SEA,23,0,0,0,0
57,8484325,Waltteri Merela,C,TBL,26,0,0,0,0
57,8479421,Jacob Moverare,D,LAK,26,0,0,0,0
57,8481585,Egor Afanasyev,L,SJS,23,0,0,0,0
57,8479547,Matthew Phillips,R,,26,0,0,0,0
57,8479367,William Lockwood,R,FLA,26,0,0,0,0
57,8476915,Jujhar Khaira,L,,30,0,0,0,0
57,8481422,Jacob Lucchini,C,NSH,29,0,0,0,0
57,8480468,James Hamblin,L,EDM,25,0,0,0,0
57,8478051,Max Willman,C,NJD,29,0,0,0,0
57,8481556,John Beecher,C,BOS,23,0,0,0,0
57,8478078,Rourke Chartier,C,,28,0,0,0,0
58,8476453,Nikita Kucherov,R,TBL,31,82,41,98,139
58,8477492,Nathan MacKinnon,C,COL,29,82,45,93,138
58,8478402,Connor McDavid,C,EDM,27,82,42,90,132
58,8479318,Auston Matthews,C,TOR,27,82,67,62,129
58,8478420,Mikko Rantanen,R,COL,28,82,49,70,119
58,8481559,Jack Hughes,C,NJD,23,82,52,64,116
58,8477934,Leon Draisaitl,C,EDM,29,82,42,73,115
58,8477939,William Nylander,R,TOR,28,82,49,65,114
58,8474564,Steven Stamkos,C,NSH,34,82,39,71,110
58,8478550,Artemi Panarin,L,NYR,33,82,27,81,108
58,8478864,Kirill Kaprizov,L,MIN,27,82,53,54,107
58,8477501,Valeri Nichushkin,R,COL,29,82,49,55,104
58,8479314,Matthew Tkachuk,L,FLA,27,82,30,74,104
58,8480012,Elias Pettersson,C,VAN,26,82,37,65,102
58,8480069,Cale Makar,D,COL,26,82,22,79,101
58,8478449,Roope Hintz,C,DAL,28,82,51,49,100
58,8477956,David Pastrnak,R,BOS,28,82,48,52,100
58,8476468,J.T. Miller,C,VAN,31,82,40,60,100
58,8480027,Jason Robertson,L,DAL,25,82,40,60,100
58,8482116,Tim Stützle,C,OTT,22,82,33,65,98
58,8476887,Filip Forsberg,L,NSH,30,82,43,54,97
58,8475913,Mark Stone,R,VGK,32,82,39,58,97
58,8478427,Sebastian Aho,C,CAR,27,82,38,59,97
58,8478445,Mathew Barzal,C,NYI,27,82,32,65,97
58,8480800,Quinn Hughes,D,VAN,25,82,10,86,96
58,8477942,Kevin Fiala,L,LAK,28,82,34,61,95
58,8475172,Nazem Kadri,C,CGY,34,82,36,57,93
58,8479407,Jesper Bratt,L,NJD,26,82,31,62,93
58,8477493,Aleksander Barkov,C,FLA,29,82,31,61,92
58,8477933,Sam Reinhart,C,FLA,29,82,44,47,91
58,8474600,Roman Josi,D,NSH,34,82,19,72,91
58,8478873,Troy Terry,R,ANA,27,82,25,64,89
58,8477946,Dylan Larkin,C,DET,28,82,35,51,86
58,8480002,Nico Hischier,C,NJD,25,82,34,52,86
58,8471675,Sidney Crosby,C,PIT,37,82,41,42,83
58,8479343,Clayton Keller,R,UTA,26,82,35,48,83
58,8480839,Rasmus Dahlin,D,BUF,24,82,22,61,83
58,8476389,Vincent Trocheck,C,NYR,31,82,28,54,82
58,8476853,Morgan Rielly,D,TOR,30,82,15,67,82
58,8478398,Kyle Connor,L,WPG,28,82,42,39,81
58,8476881,Tomas Hertl,C,VGK,31,82,41,40,81
58,8477504,Josh Morrissey,D,WPG,29,82,15,65,80
58,8480036,Miro Heiskanen,D,DAL,25,82,14,66,80
58,8478444,Brock Boeser,R,VAN,27,82,44,35,79
58,8480801,Brady Tkachuk,L,OTT,25,82,36,43,79
58,8477949,Alex Tuch,R,BUF,28,82,25,54,79
58,8479323,Adam Fox,D,NYR,26,82,16,63,79
58,8476539,Jonathan Marchessault,R,NSH,34,82,38,40,78
58,8476460,Mark Scheifele,C,WPG,31,82,31,47,78
58,8477951,Nick Schmaltz,C,UTA,28,82,28,50,78
58,8480803,Evan Bouchard,D,EDM,25,82,21,56,77
58,8478010,Brayden Point,C,TBL,28,82,38,38,76
58,8479675,Trevor Moore,L,LAK,29,82,37,39,76
58,8475692,Mats Zuccarello,R,MIN,37,82,22,54,76
58,8475167,Victor Hedman,D,TBL,34,82,13,62,75
58,8475166,John Tavares,C,TOR,34,82,33,41,74
58,8474679,Gustav Nyquist,C,NSH,35,82,25,49,74
58,8479420,Tage Thompson,C,BUF,27,82,45,28,73
58,8474141,Patrick Kane,R,DET,36,82,38,35,73
58,8477476,Artturi Lehkonen,L,COL,29,82,37,36,73
58,8475754,Brock Nelson,C,NYI,33,82,36,37,73
58,8482093,Seth Jarvis,C,CAR,22,82,35,38,73
58,8475810,Bryan Rust,R,PIT,32,82,33,40,73
58,8478439,Travis Konecny,R,PHI,27,82,30,43,73
58,8482665,Matty Beniers,C,SEA,22,82,29,44,73
58,8476454,Ryan Nugent-Hopkins,C,EDM,31,82,23,50,73
58,8478403,Jack Eichel,C,VGK,28,82,37,35,72
58,8479337,Alex DeBrincat,R,DET,27,82,35,37,72
58,8475158,Ryan O'Reilly,C,NSH,33,82,35,37,72
58,8479542,Brandon Hagel,L,TBL,26,82,34,38,72
58,8477940,Nikolaj Ehlers,L,WPG,28,82,24,48,72
58,8474590,John Carlson,D,WSH,34,82,18,54,72
58,8481523,Kirby Dach,C,MTL,23,82,13,59,72
58,8478414,Timo Meier,R,NJD,28,82,41,30,71
58,8477404,Jake Guentzel,C,TBL,30,82,29,42,71
58,8477960,Adrian Kempe,R,LAK,28,82,29,42,71
58,8481557,Matt Boldy,L,MIN,23,82,28,43,71
58,8475168,Matt Duchene,C,DAL,33,82,26,45,71
58,8474578,Erik Karlsson,D,PIT,34,82,18,53,71
58,8473419,Brad Marchand,L,BOS,36,82,31,39,70
58,8477496,Elias Lindholm,C,BOS,30,82,26,44,70
58,8477409,Carter Verhaeghe,C,FLA,29,82,36,33,69
58,8475786,Zach Hyman,L,EDM,32,82,34,35,69
58,8477402,Pavel Buchnevich,L,STL,29,82,35,33,68
58,8471685,Anze Kopitar,C,LAK,37,82,27,41,68
58,8477955,Jared McCann,L,SEA,28,82,35,32,67
58,8478042,Viktor Arvidsson,R,EDM,31,82,26,41,67
58,8477447,Shea Theodore,D,VGK,29,82,14,53,67
58,8481540,Cole Caufield,R,MTL,23,82,31,35,66
58,8476459,Mika Zibanejad,C,NYR,31,82,24,42,66
58,8476462,Dougie Hamilton,D,NJD,31,82,19,47,66
58,8482078,Lucas Raymond,L,DET,22,82,30,35,65
58,8475794,Tyler Seguin,C,DAL,32,82,26,39,65
58,8479999,Casey Mittelstadt,C,COL,26,82,21,44,65
58,8482097,Jack Quinn,R,BUF,23,82,19,46,65
58,8474565,Alex Pietrangelo,D,VGK,34,82,12,53,65
58,8479385,Jordan Kyrou,C,STL,26,82,26,38,64
58,8480018,Nick Suzuki,C,MTL,25,82,23,41,64
58,8480023,Robert Thomas,C,STL,25,82,22,42,64
58,8476869,Brady Skjei,D,NSH,30,82,18,46,64
58,8474586,Jordan Eberle,R,SEA,34,82,28,35,63
58,8478975,Mason Marchment,L,DAL,29,82,21,42,63
58,8480830,Andrei Svechnikov,R,CAR,24,82,20,43,63
58,8478038,Devon Toews,D,COL,30,82,12,51,63
58,8475765,Vladimir Tarasenko,R,DET,33,82,25,37,62
58,8473994,Jamie Benn,L,DAL,35,82,23,39,62
58,8481528,Dylan Cozens,C,BUF,23,82,19,43,62
58,8470613,Brent Burns,D,CAR,39,82,16,46,62
58,8478407,Vince Dunn,D,SEA,28,82,8,54,62
58,8475184,Chris Kreider,L,NYR,33,82,37,24,61
58,8475726,Tyler Toffoli,C,SJS,32,82,36,25,61
58,8471214,Alex Ovechkin,L,WSH,39,82,34,27,61
58,8477935,Sam Bennett,C,FLA,28,82,25,36,61
58,8478438,Tommy Novak,C,NSH,27,82,17,44,61
58,8482684,Luke Hughes,D,NJD,21,82,11,50,61
58,8481533,Trevor Zegras,C,ANA,23,82,30,30,60
58,8473512,Claude Giroux,R,OTT,36,82,20,40,60
58,8471215,Evgeni Malkin,C,PIT,38,82,20,40,60
58,8476346,Johnny Gaudreau,L,CBJ,31,82,17,43,60
58,8476875,Mike Matheson,D,MTL,30,82,16,44,60
58,8475151,Kyle Palmieri,C,NYI,33,82,33,26,59
58,8474102,David Perron,L,OTT,36,82,25,34,59
58,8478440,Dylan Strome,C,WSH,27,82,23,36,59
58,8482124,Quinton Byfield,R,LAK,22,82,28,30,58
58,8475745,Charlie Coyle,C,BOS,32,82,22,36,58
58,8475798,Mikael Granlund,C,SJS,32,82,14,44,58
58,8476456,Jonathan Huberdeau,C,CGY,31,82,12,46,58
58,8480009,Eeli Tolvanen,R,SEA,25,82,26,31,57
58,8477500,Bo Horvat,C,NYI,29,82,23,34,57
58,8480208,Drake Batherson,R,OTT,26,82,23,34,57
58,8478493,Joel Eriksson Ek,C,MIN,27,82,21,36,57
58,8480078,Filip Chytil,C,NYR,25,82,21,36,57
58,8475170,Brayden Schenn,C,STL,33,82,20,37,57
58,8479400,Pierre-Luc Dubois,L,WSH,26,82,20,37,57
58,8477429,Andrew Copp,C,DET,30,82,12,45,57
58,8480039,Martin Necas,C,CAR,25,82,23,33,56
58,8477494,Jonathan Drouin,L,COL,29,82,20,36,56
58,8477416,Oliver Bjorkstrand,R,SEA,29,82,27,28,55
58,8476399,Blake Coleman,C,CGY,33,82,25,30,55
58,8483808,Andrei Kuzmenko,L,CGY,28,82,25,30,55
58,8474150,Mikael Backlund,C,CGY,35,82,24,31,55
58,8476448,William Karlsson,C,VGK,31,82,19,36,55
58,8478462,Nicolas Roy,C,VGK,27,82,18,37,55
58,8482745,Mason McTavish,C,ANA,21,82,18,37,55
58,8477503,Max Domi,C,TOR,29,82,17,38,55
58,8478469,Thomas Chabot,D,OTT,27,82,16,39,55
58,8478366,Frank Vatrano,R,ANA,30,82,32,22,54
58,8477407,Anthony Duclair,L,NYI,29,82,27,27,54
58,8476882,Teuvo Teravainen,L,CHI,30,82,18,36,54
58,8480064,Josh Norris,C,OTT,25,82,32,21,53
58,8477511,Anthony Mantha,R,CGY,30,82,27,26,53
58,8475784,Jeff Skinner,C,EDM,32,82,25,28,53
58,8475722,Jason Zucker,L,BUF,32,82,25,28,53
58,8480865,Noah Dobson,D,NYI,24,82,8,45,53
58,8478856,Conor Garland,R,VAN,28,82,23,29,52
58,8482667,William Eklund,L,SJS,22,82,19,33,52
58,8471724,Kris Letang,D,PIT,37,82,10,42,52
58,8482159,Tyson Foerster,R,PHI,22,82,28,23,51
58,8477451,Ryan Hartman,R,MIN,30,82,26,25,51
58,8482113,Anton Lundell,C,FLA,23,82,25,26,51
58,8478047,Michael Bunting,L,PIT,29,82,24,27,51
58,8478401,Pavel Zacha,C,BOS,27,82,23,28,51
58,8476461,Sean Couturier,C,PHI,32,82,19,32,51
58,8480028,Morgan Frost,C,PHI,25,82,18,33,51
58,8479339,Patrik Laine,L,CBJ,26,82,17,34,51
58,8477444,Andre Burakovsky,L,SEA,29,82,15,36,51
58,8477346,MacKenzie Weegar,D,CGY,30,82,11,40,51
58,8479325,Charlie McAvoy,D,BOS,27,82,11,40,51
58,8480014,Gabriel Vilardi,C,WPG,25,82,33,17,50
58,8475169,Evander Kane,L,EDM,33,82,26,24,50
58,8473986,Alex Killorn,L,ANA,35,82,24,26,50
58,8477456,J.T. Compher,L,DET,29,82,23,27,50
58,8482055,Drew O'Connor,L,PIT,26,82,21,29,50
58,8476905,Chandler Stephenson,C,SEA,30,82,19,31,50
58,8476826,Yanni Gourde,C,SEA,33,82,14,36,50
58,8476927,Teddy Blueger,C,VAN,30,82,12,38,50
58,8476906,Shayne Gostisbehere,D,CAR,31,82,10,40,50
58,8478498,Jake DeBrusk,L,VAN,28,82,29,20,49
58,8475314,Anders Lee,L,NYI,34,82,28,21,49
58,8475287,Erik Haula,L,NJD,33,82,22,27,49
58,8471698,T.J. Oshie,R,WSH,38,82,21,28,49
58,8481711,Matias Maccelli,L,UTA,24,82,20,29,49
58,8476792,Torey Krug,D,STL,33,82,16,33,49
58,8475791,Taylor Hall,L,CHI,33,82,16,33,49
58,8477932,Aaron Ekblad,D,FLA,28,82,15,34,49
58,8478460,Zach Werenski,D,CBJ,27,82,11,38,49
58,8479410,Mikhail Sergachev,D,UTA,26,82,10,39,49
58,8477426,Nicholas Paul,L,TBL,29,82,30,18,48
58,8476483,Rickard Rakell,R,PIT,31,82,20,28,48
58,8478458,Jack Roslovic,C,CAR,27,82,18,30,48
58,8474563,Drew Doughty,D,LAK,35,82,13,35,48
58,8475768,Jaden Schwartz,C,SEA,32,82,23,24,47
58,8480015,Owen Tippett,R,PHI,25,82,22,25,47
58,8481618,Alex Newhook,C,MTL,23,82,21,26,47
58,8477479,Tyler Bertuzzi,L,CHI,29,82,20,27,47
58,8477497,Sean Monahan,C,CBJ,30,82,18,29,47
58,8474053,Logan Couture,C,SJS,35,82,16,31,47
58,8476458,Ryan Strome,C,ANA,31,82,13,34,47
58,8476329,Travis Boyd,C,MIN,31,82,10,37,47
58,8476958,Jaccob Slavin,D,CAR,30,82,5,42,47
58,8482699,Dylan Guenther,R,UTA,21,82,26,20,46
58,8479525,Ross Colton,C,COL,28,82,25,21,46
58,8482109,Alexis Lafrenière,L,NYR,23,82,24,22,46
58,8482720,Matthew Knies,L,TOR,22,82,19,27,46
58,8480797,Joel Farabee,L,PHI,24,82,15,31,46
58,8482671,Owen Power,D,BUF,22,82,15,31,46
58,8478397,Rasmus Andersson,D,CGY,28,82,11,35,46
58,8478396,Noah Hanifin,D,VGK,27,82,9,37,46
58,8479425,Filip Hronek,D,VAN,27,82,7,39,46
58,8476438,Brandon Saad,L,STL,32,82,25,20,45
58,8478057,Dakota Joshua,C,VAN,28,82,25,20,45
58,8476432,Boone Jenner,C,CBJ,31,82,24,21,45
58,8482110,Dawson Mercer,C,NJD,23,82,22,23,45
58,8480113,Alex Iafallo,L,WPG,31,82,21,24,45
58,8481596,Shane Pinto,C,OTT,24,82,19,26,45
58,8478109,Victor Olofsson,L,VGK,29,82,17,28,45
58,8482705,Cole Sillinger,C,CBJ,21,82,16,29,45
58,8475753,Justin Faulk,D,STL,32,82,10,35,45
58,8478020,Michael Amadio,C,OTT,28,82,22,22,44
58,8480068,Ryan Poehling,C,PHI,25,82,20,24,44
58,8480829,Jesperi Kotkaniemi,C,CAR,24,82,17,27,44
58,8478046,Danton Heinen,L,VAN,29,82,17,27,44
58,8473563,Nicklas Backstrom,C,WSH,37,82,13,31,44
58,8476979,Erik Gustafsson,D,DET,32,82,9,35,44
58,8477506,Ryan Pulock,D,NYI,30,82,8,36,44
58,8473533,Jordan Staal,C,CAR,36,82,22,21,43
58,8476880,Tom Wilson,R,WSH,30,82,20,23,43
58,8477986,Brandon Montour,D,SEA,30,82,19,24,43
58,8483515,Juraj Slafkovsky,L,MTL,20,82,16,27,43
58,8478891,Mason Appleton,C,WPG,28,82,13,30,43
58,8479345,Jakob Chychrun,D,WSH,26,82,13,30,43
58,8478542,Evan Rodrigues,C,FLA,31,82,12,31,43
58,8477021,Alex Kerfoot,C,UTA,30,82,12,31,43
58,8481068,Yegor Sharangovich,C,CGY,26,82,20,22,42
58,8477964,Ivan Barbashev,C,VGK,29,82,19,23,42
58,8480798,Philipp Kurashev,C,CHI,25,82,18,24,42
58,8480188,Fabian Zetterlund,L,SJS,25,82,16,26,42
58,8476474,Stefan Noesen,R,NJD,31,82,16,26,42
58,8480220,Noah Cates,L,PHI,25,82,15,27,42
58,8476872,Scott Laughton,C,PHI,30,82,12,30,42
58,8478413,Jordan Greenway,L,BUF,27,82,11,31,42
58,8475171,Oliver Ekman-Larsson,D,TOR,33,82,10,32,42
58,8474715,Cam Atkinson,R,TBL,35,82,26,15,41
58,8484144,Connor Bedard,C,CHI,19,82,22,19,41
58,8479390,Taylor Raddysh,R,WSH,26,82,20,21,41
58,8476921,Jordan Martinook,L,CAR,32,82,20,21,41
58,8482105,Jake Sanderson,D,OTT,22,82,15,26,41
58,8480185,Eetu Luostarinen,C,FLA,26,82,14,27,41
58,8476479,Phillip Danault,C,LAK,31,82,13,28,41
58,8478055,Gustav Forsling,D,FLA,28,82,12,29,41
58,8478472,Mathieu Joseph,R,STL,27,82,9,32,41
58,8479393,Noah Gregor,C,OTT,26,82,23,17,40
58,8475793,Ryan Johansen,C,PHI,32,82,21,19,40
58,8480871,Adam Boqvist,D,FLA,24,82,19,21,40
58,8475799,Nino Niederreiter,R,WPG,32,82,19,21,40
58,8477987,Ryan Donato,C,CHI,28,82,18,22,40
58,8476292,Ondrej Palat,L,NJD,33,82,16,24,40
58,8474149,Evgenii Dadonov,R,DAL,35,82,16,24,40
58,8482175,JJ Peterka,R,BUF,22,82,15,25,40
58,8477948,Travis Sanheim,D,PHI,28,82,9,31,40
58,8479398,Samuel Girard,D,COL,26,82,7,33,40
58,8478115,Pierre Engvall,L,NYI,28,82,20,19,39
58,8481535,Nils Hoglander,L,VAN,24,82,19,20,39
58,8481560,Arthur Kaliyev,R,LAK,23,82,18,21,39
58,8479293,Brandon Tanev,L,SEA,33,82,16,23,39
58,8481581,Thomas Harley,D,DAL,23,82,12,27,39
58,8480434,Sean Durzi,D,UTA,26,82,11,28,39
58,8474151,Ryan McDonagh,D,TBL,35,82,6,33,39
58,8481186,Logan O'Connor,R,COL,28,82,20,18,38
58,8477989,Christian Dvorak,C,MTL,28,82,18,20,38
58,8482146,Luke Evangelista,R,NSH,22,82,17,21,38
58,8473422,Nick Foligno,L,CHI,37,82,16,22,38
58,8476885,Jacob Trouba,D,NYR,30,82,11,27,38
58,8482149,Cole Perfetti,C,WPG,22,82,10,28,38
58,8474641,Adam Henrique,C,EDM,34,82,21,16,37
58,8481704,Juuso Parssinen,C,NSH,23,82,18,19,37
58,8478474,Lawson Crouse,L,UTA,27,82,17,20,37
58,8477495,Seth Jones,D,CHI,30,82,14,23,37
58,8474716,Jared Spurgeon,D,MIN,35,82,12,25,37
58,8480144,David Kampf,C,TOR,29,82,12,25,37
58,8480145,Neal Pionk,D,WPG,29,82,11,26,37
58,8476923,Damon Severson,D,CBJ,30,82,9,28,37
58,8481542,Moritz Seider,D,DET,23,82,5,32,37
58,8481546,Cam York,D,PHI,23,82,5,32,37
58,8480873,Rasmus Sandin,D,WSH,24,82,4,33,37
58,8480893,Kirill Marchenko,R,CBJ,24,82,25,11,36
58,8481582,Nicholas Robertson,L,TOR,23,82,21,15,36
58,8478519,Anthony Cirelli,C,TBL,27,82,17,19,36
58,8475191,Reilly Smith,R,NYR,33,82,17,19,36
58,8481624,Ilya Mikheyev,R,CHI,30,82,16,20,36
58,8476925,Colton Sissons,C,NSH,31,82,15,21,36
58,8482117,Lukas Reichel,L,CHI,22,82,15,21,36
58,8478911,Matt Roy,D,WSH,29,82,13,23,36
58,8480806,Isac Lundestrom,C,ANA,25,82,12,24,36
58,8475218,Mattias Ekholm,D,EDM,34,82,8,28,36
58,8476854,Hampus Lindholm,D,BOS,30,82,5,31,36
58,8475764,Cam Fowler,D,ANA,33,82,5,31,36
58,8482740,Wyatt Johnston,C,DAL,21,82,22,13,35
58,8470621,Corey Perry,R,EDM,39,82,22,13,35
58,8478463,Anthony Beauvillier,L,PIT,27,82,20,15,35
58,8479996,Cody Glass,C,NSH,25,82,18,17,35
58,8481553,Bobby Brink,R,PHI,23,82,17,18,35
58,8477947,Sonny Milano,L,WSH,28,82,16,19,35
58,8477425,Miles Wood,L,COL,29,82,16,19,35
58,8475149,Marcus Johansson,L,MIN,34,82,15,20,35
58,8475763,Kevin Hayes,R,PIT,32,82,15,20,35
58,8482660,Kent Johnson,C,CBJ,22,82,13,22,35
58,8480802,Ryan McLeod,C,BUF,25,82,13,22,35
58,8476480,Vladislav Namestnikov,C,WPG,32,82,13,22,35
58,8480073,Erik Brannstrom,D,COL,25,82,7,28,35
58,8476981,Josh Anderson,R,MTL,30,82,19,15,34
58,8479661,Tanner Jeannot,L,LAK,27,82,19,15,34
58,8476918,Jimmy Vesey,L,NYR,31,82,18,16,34
58,8477952,Robby Fabbri,C,ANA,28,82,17,17,34
58,8479365,Trent Frederic,C,BOS,26,82,16,18,34
58,8478233,Andrew Mangiapane,L,WSH,28,82,12,22,34
58,8478882,Vladislav Gavrikov,D,LAK,29,82,9,25,34
58,8473507,Jeff Petry,D,DET,37,82,9,25,34
58,8479371,Dante Fabbro,D,NSH,26,82,4,30,34
58,8476897,Oskar Sundqvist,C,STL,30,82,19,14,33
58,8480849,Barrett Hayton,C,UTA,24,82,18,15,33
58,8479941,Justin Danforth,R,CBJ,31,82,17,16,33
58,8479987,Morgan Geekie,C,BOS,26,82,16,17,33
58,8476873,Mark Jankowski,C,NSH,30,82,16,17,33
58,8482079,Marco Rossi,C,MIN,23,82,16,17,33
58,8478569,Noel Acciari,C,PIT,33,82,15,18,33
58,8482475,Yegor Chinakhov,R,CBJ,23,82,12,21,33
58,8475760,Nick Bjugstad,C,UTA,32,82,11,22,33
58,8480817,K'Andre Miller,D,NYR,24,82,11,22,33
58,8475200,Dmitry Orlov,D,CAR,33,82,10,23,33
58,8481606,Jordan Spence,D,LAK,23,82,5,28,33
58,8481014,Alexander Romanov,D,NYI,24,82,4,29,33
58,8481580,Connor McMichael,C,WSH,23,82,19,13,32
58,8474189,Lars Eller,C,PIT,35,82,16,16,32
58,8480459,Pius Suter,C,VAN,28,82,13,19,32
58,8477919,Frederick Gaudreau,C,MIN,31,82,12,20,32
58,8480835,Jack Drury,C,CAR,24,82,12,20,32
58,8475343,Nic Dowd,C,WSH,34,82,12,20,32
58,8482666,Scott Morrow,D,CAR,22,82,11,21,32
58,8483565,Nick Blankenburg,D,NSH,26,82,9,23,32
58,8476467,Jamie Oleksiak,D,SEA,32,82,8,24,32
58,8483457,Lane Hutson,D,MTL,20,82,6,26,32
58,8476419,Jean-Gabriel Pageau,C,NYI,32,82,4,28,32
58,8482125,Alexander Holtz,R,VGK,22,82,17,14,31
58,8479992,Michael Rasmussen,C,DET,25,82,14,17,31
58,8475714,Calle Jarnkrok,C,TOR,33,82,13,18,31
58,8481032,Paul Cotter,C,NJD,25,82,13,18,31
58,8479591,Michael Eyssimont,C,TBL,28,82,13,18,31
58,8481656,Aliaksei Protas,C,WSH,23,82,12,19,31
58,8482133,Thomas Bordeleau,C,SJS,22,82,11,20,31
58,8482624,Daniil Miromanov,D,CGY,27,82,11,20,31
58,8476960,Andreas Athanasiou,C,CHI,30,82,11,20,31
58,8475220,Marcus Foligno,L,MIN,33,82,10,21,31
58,8477969,Marcus Pettersson,D,PIT,28,82,6,25,31
58,8480813,Joe Veleno,C,DET,24,82,6,25,31
58,8484153,Leo Carlsson,C,ANA,20,82,18,12,30
58,8481604,Pavel Dorofeyev,L,VGK,24,82,16,14,30
58,8484203,Bradly Nadeau,L,CAR,19,82,16,14,30
58,8480855,Jack McBain,C,UTA,24,82,16,14,30
58,8476392,Adam Lowry,C,WPG,31,82,13,17,30
58,8481522,Peyton Krebs,C,BUF,23,82,13,17,30
58,8483431,Logan Cooley,C,UTA,20,82,12,18,30
58,8482807,Ethan Del Mastro,D,CHI,21,82,10,20,30
58,8477498,Darnell Nurse,D,EDM,29,82,9,21,30
58,8483490,Pavel Mintyukov,D,ANA,21,82,7,23,30
58,8482245,Artem Zub,D,OTT,29,82,5,25,30
58,8479998,Mikey Anderson,D,LAK,25,82,3,27,30
58,8477392,Hudson Fasching,R,NYI,29,82,14,15,29
58,8481013,Jonatan Berggren,R,DET,24,82,12,17,29
58,8475193,Tomas Tatar,L,NJD,34,82,9,20,29
58,8476422,Mike Reilly,D,NYI,31,82,8,21,29
58,8476917,Adam Pelech,D,NYI,30,82,7,22,29
58,8480336,Sean Walker,D,CAR,30,82,6,23,29
58,8476902,Esa Lindell,D,DAL,30,82,5,24,29
58,8480878,Nils Lundkvist,D,DAL,24,82,4,25,29
58,8476892,Colton Parayko,D,STL,31,82,2,27,29
58,8481028,Martin Pospisil,C,CGY,25,82,16,12,28
58,8479359,Beck Malenstyn,L,BUF,26,82,16,12,28
58,8475231,Casey Cizikas,C,NYI,33,82,13,15,28
58,8478211,Dryden Hunt,L,CGY,29,82,13,15,28
58,8480748,Kiefer Sherwood,L,VAN,29,82,12,16,28
58,8478434,Keegan Kolesar,R,VGK,27,82,12,16,28
58,8481481,Blake Lizotte,C,PIT,27,82,12,16,28
58,8477998,Warren Foegele,L,LAK,28,82,9,19,28
58,8475279,Ben Chiarot,D,DET,33,82,8,20,28
58,8482122,Brock Faber,D,MIN,22,82,7,21,28
58,8476879,Cody Ceci,D,EDM,31,82,6,22,28
58,8477435,Ryan Graves,D,PIT,29,82,5,23,28
58,8480246,Nick Perbix,D,TBL,26,82,5,23,28
58,8475848,Brendan Gallagher,R,MTL,32,82,15,12,27
58,8475855,Jesper Fast,R,CAR,33,82,14,13,27
58,8477903,Garnet Hathaway,R,PHI,33,82,13,14,27
58,8482092,Ridly Greig,C,OTT,22,82,12,15,27
58,8480074,Alexandre Texier,C,STL,25,82,11,16,27
58,8482142,Jamie Drysdale,D,PHI,22,82,8,19,27
58,8479976,Juuso Valimaki,D,UTA,26,82,5,22,27
58,8475690,Chris Tanev,D,TOR,35,82,5,22,27
58,8481178,Egor Zamula,D,PHI,24,82,4,23,27
58,8476463,Jonas Brodin,D,MIN,31,82,3,24,27
58,8482655,J.J. Moser,D,TBL,24,82,3,24,27
58,8474673,TJ Brodie,D,CHI,34,82,2,25,27
58,8477845,Trevor van Riemsdyk,D,WSH,33,82,2,25,27
58,8478508,Yakov Trenin,C,MIN,27,82,12,14,26
58,8479353,Brett Howden,C,VGK,26,82,11,15,26
58,8482809,Jackson Blake,R,CAR,21,82,11,15,26
58,8476278,Colin Blackwell,C,DAL,31,82,11,15,26
58,8478432,Christian Fischer,R,DET,27,82,11,15,26
58,8482141,Lukas Cormier,D,VGK,22,82,9,17,26
58,8478013,Jake Walman,D,SJS,28,82,9,17,26
58,8483468,Jiri Kulich,C,BUF,20,82,9,17,26
58,8477369,Carson Soucy,D,VAN,30,82,7,19,26
58,8478507,John Marino,D,UTA,27,82,6,20,26
58,8481605,Jackson LaCombe,D,ANA,23,82,6,20,26
58,8480860,Kevin Bahl,D,CGY,24,82,6,20,26
58,8480043,Timothy Liljegren,D,TOR,25,82,2,24,26
58,8479369,Andrew Peeke,D,BOS,26,82,2,24,26
58,8479368,Max Jones,L,BOS,26,82,17,8,25
58,8477450,Jason Dickinson,C,CHI,29,82,14,11,25
58,8482062,Cole Smith,L,NSH,29,82,10,15,25
58,8473453,Trevor Lewis,C,LAK,37,82,9,16,25
58,8482803,Olen Zellweger,D,ANA,21,82,7,18,25
58,8476525,Colin Miller,D,WPG,32,82,7,18,25
58,8480222,Sebastian Aho,D,PIT,28,82,5,20,25
58,8478851,Alexandre Carrier,D,NSH,28,82,4,21,25
58,8479402,Jake Bean,D,CGY,26,82,3,22,25
58,8480035,Henri Jokiharju,D,BUF,25,82,3,22,25
58,8481554,Kaapo Kakko,R,NYR,23,82,14,10,24
58,8484166,Adam Fantilli,C,CBJ,20,82,14,10,24
58,8482155,Alex Laferriere,R,LAK,23,82,12,12,24
58,8478133,Jake Evans,C,MTL,28,82,10,14,24
58,8480448,Parker Kelly,L,COL,25,82,9,15,24
58,8479351,Sam Steel,C,DAL,26,82,8,16,24
58,8474574,Tyler Myers,D,VAN,34,82,8,16,24
58,8483482,Tristan Luneau,D,ANA,20,82,8,16,24
58,8480003,Jesper Boqvist,C,FLA,26,82,7,17,24
58,8480796,Martin Fehervary,D,WSH,25,82,7,17,24
58,8476374,Sean Kuraly,C,CBJ,31,82,13,10,23
58,8476889,Radek Faksa,C,STL,30,82,13,10,23
58,8480789,Oliver Wahlstrom,R,NYI,24,82,12,11,23
58,8482166,Shakir Mukhamadullin,D,SJS,22,82,11,12,23
58,8477953,Kasperi Kapanen,R,STL,28,82,10,13,23
58,8482074,Connor Zary,C,CGY,23,82,10,13,23
58,8477015,Connor Brown,R,EDM,30,82,7,16,23
58,8481601,Simon Holmstrom,R,NYI,23,82,7,16,23
58,8483445,Cutter Gauthier,L,ANA,20,82,6,17,23
58,8482073,Braden Schneider,D,NYR,23,82,6,17,23
58,8478840,Will Borgen,D,SEA,28,82,5,18,23
58,8476931,Jake McCabe,D,TOR,31,82,4,19,23
58,8475233,David Savard,D,MTL,34,82,4,19,23
58,8477488,Brett Pesce,D,NJD,30,82,3,20,23
58,8475462,Radko Gudas,D,ANA,34,82,3,20,23
58,8477353,Tyler Motte,C,DET,29,82,12,10,22
58,8481517,Brett Leason,R,ANA,25,82,12,10,22
58,8476624,Barclay Goodrow,C,SJS,31,82,8,14,22
58,8483763,Maksymilian Szuber,D,UTA,22,82,6,16,22
58,8478416,Erik Cernak,D,TBL,27,82,5,17,22
58,8478178,Darren Raddysh,D,TBL,28,82,4,18,22
58,8478500,Ivan Provorov,D,CBJ,27,82,3,19,22
58,8479324,Ryan Lindgren,D,NYR,26,82,3,19,22
58,8476967,Brett Kulak,D,EDM,30,82,2,20,22
58,8480281,Alexey Toropchenko,R,STL,25,82,14,7,21
58,8476469,Joel Armia,R,MTL,31,82,13,8,21
58,8482089,Jake Neighbours,L,STL,22,82,11,10,21
58,8481093,Rafael Harvey-Pinard,L,MTL,25,82,10,11,21
58,8477839,Conor Sheary,L,TBL,32,82,9,12,21
58,8482259,Bobby McMann,C,TOR,28,82,8,13,21
58,8483495,Simon Nemec,D,NJD,20,82,7,14,21
58,8483460,David Jiricek,D,CBJ,21,82,7,14,21
58,8479980,Nicolas Hague,D,VGK,26,82,6,15,21
58,8480980,Connor Dewar,C,TOR,25,82,6,15,21
58,8480807,Mattias Samuelsson,D,BUF,24,82,5,16,21
58,8475790,Erik Gudbranson,D,CBJ,32,82,4,17,21
58,8475762,Derek Forbort,D,VAN,32,82,3,18,21
58,8470600,Ryan Suter,D,STL,39,82,3,18,21
58,8476457,Adam Larsson,D,SEA,32,82,2,19,21
58,8484145,Zach Benson,L,BUF,19,82,12,8,20
58,8477508,Curtis Lazar,C,NJD,29,82,10,10,20
58,8482712,Oskar Olausson,R,COL,22,82,9,11,20
58,8482749,Joshua Roy,R,MTL,21,82,9,11,20
58,8482702,Logan Stankoven,C,DAL,21,82,7,13,20
58,8482111,Justin Barron,D,MTL,23,82,6,14,20
58,8482858,Ryker Evans,D,SEA,23,82,5,15,20
58,8478399,Jonas Siegenthaler,D,NJD,27,82,4,16,20
58,8475177,Calvin de Haan,D,COL,33,82,4,16,20
58,8475455,Brenden Dillon,D,NJD,34,82,3,17,20
58,8476372,Nick Seeler,D,PHI,31,82,2,18,20
58,8475188,Brayden McNabb,D,VGK,33,82,1,19,20
58,8477365,Connor Clifton,D,BUF,29,82,0,20,20
58,8482077,Dylan Holloway,L,EDM,23,82,10,9,19
58,8483524,Shane Wright,C,SEA,20,82,10,9,19
58,8476312,Josh Manson,D,COL,33,82,7,12,19
58,8481708,Zac Jones,D,NYR,24,82,6,13,19
58,8477499,Rasmus Ristolainen,D,PHI,30,82,6,13,19
58,8484911,Collin Graf,R,SJS,22,82,5,14,19
58,8477507,Nikita Zadorov,D,BOS,29,82,4,15,19
58,8480834,Ty Emberson,D,SJS,24,82,4,15,19
58,8482087,Kaiden Guhle,D,MTL,22,82,3,16,19
58,8476441,Joel Edmundson,D,LAK,31,82,2,17,19
58,8480172,Jan Rutta,D,SJS,34,82,2,17,19
58,8475181,Nick Leddy,D,STL,33,82,1,18,19
58,8476891,Matt Grzelcyk,D,PIT,30,82,1,18,19
58,8482659,Josh Doan,R,UTA,22,82,10,8,18
58,8480995,Pontus Holmberg,R,TOR,25,82,8,10,18
58,8481477,Nico Sturm,C,SJS,29,82,8,10,18
58,8479414,Nathan Bastian,R,NJD,27,82,8,10,18
58,8480021,Jack Studnicka,C,LAK,25,82,8,10,18
58,8477931,Tomas Nosek,L,FLA,32,82,8,10,18
58,8481567,Henry Thrun,D,SJS,23,82,6,12,18
58,8477220,Nate Schmidt,D,FLA,33,82,5,13,18
58,8478136,Jake Middleton,D,MIN,28,82,5,13,18
58,8476331,Dylan DeMelo,D,WPG,31,82,3,15,18
58,8480049,Dylan Samberg,D,WPG,25,82,2,16,18
58,8475718,Justin Holl,D,DET,32,82,2,16,18
58,8474612,Travis Hamonic,D,OTT,34,82,2,16,18
58,8478443,Brandon Carlo,D,BOS,28,82,2,16,18
58,8479638,Justin Brazeau,R,BOS,26,82,9,8,17
58,8482118,Sam Colangelo,R,ANA,23,82,9,8,17
58,8476442,Matt Nieto,L,PIT,32,82,6,11,17
58,8480025,MacKenzie Entwistle,R,FLA,25,82,6,11,17
58,8482733,Logan Mailloux,D,MTL,31,82,6,11,17
58,8474090,Brendan Smith,D,DAL,35,82,6,11,17
58,8480950,Ilya Lyubushkin,D,DAL,30,82,5,12,17
58,8480990,Declan Chisholm,D,MIN,24,82,5,12,17
58,8482470,Ilya Solovyov,D,CGY,24,82,4,13,17
58,8484149,Gavin Brindley,C,CBJ,20,82,4,13,17
58,8476429,Scott Mayfield,D,NYI,32,82,3,14,17
58,8475324,Nick Jensen,D,OTT,34,82,3,14,17
58,8479983,Mario Ferraro,D,SJS,26,82,3,14,17
58,8479316,Luke Kunin,C,SJS,27,82,11,5,16
58,8481524,Bowen Byram,D,BUF,23,82,10,6,16
58,8482101,Danil Gushchin,L,SJS,22,82,7,9,16
58,8481641,Joel Kiviranta,L,COL,28,82,7,9,16
58,8479576,Vincent Desharnais,D,VAN,28,82,5,11,16
58,8480870,Bo Groulx,C,NYR,24,82,11,4,15
58,8475842,Sam Carrick,C,NYR,32,82,10,5,15
58,8476878,Zemgus Girgensons,L,TBL,30,82,7,8,15
58,8477406,Mattias Janmark,C,EDM,32,82,7,8,15
58,8481699,Aku Raty,R,UTA,23,82,6,9,15
58,8483493,Frank Nazar,C,CHI,20,82,4,11,15
58,8482516,Matthew Kessel,D,STL,24,82,4,11,15
58,8482679,Matt Coronato,R,CGY,22,82,6,8,14
58,8481568,Alex Vlasic,D,CHI,23,82,4,10,14
58,8478450,Parker Wotherspoon,D,BOS,27,82,4,10,14
58,8477034,Jaycob Megna,D,FLA,32,82,2,12,14
58,8480879,Jacob Bernard-Docker,D,OTT,24,82,0,14,14
58,8483499,Liam Ohgren,L,MIN,20,82,8,5,13
58,8476822,Luke Glendening,C,TBL,35,82,6,7,13
58,8482762,Simon Edvinsson,D,DET,21,82,3,10,13
58,8481122,Simon Benoit,D,TOR,26,82,0,13,13
58,8482145,Mavrik Bourque,C,DAL,22,82,6,6,12
58,8479291,Kevin Rooney,C,CGY,31,82,4,8,12
58,8477505,Alexander Wennberg,C,SJS,30,82,3,9,12
58,8483505,Matthew Poitras,C,BOS,20,82,3,9,12
58,8482787,Nikita Chibrikov,R,WPG,31,82,5,6,11
58,8483012,Logan Morrison,C,SEA,22,82,4,7,11
58,8474013,Ian Cole,D,UTA,35,82,3,8,11
58,8483397,Marc McLaughlin,C,BOS,25,82,3,8,11
58,8471677,Jack Johnson,D,CBJ,37,82,3,8,11
58,8476473,Connor Murphy,D,CHI,31,82,3,8,11
58,8483471,Brad Lambert,C,WPG,31,82,3,8,11
58,8478859,Niko Mikkola,D,FLA,28,82,2,9,11
58,8477938,Haydn Fleury,D,WPG,28,82,2,9,11
58,8477335,Kyle Burroughs,D,LAK,29,82,1,10,11
58,8479442,Troy Stecher,D,EDM,30,82,3,7,10
58,8476858,Phillip Di Giuseppe,L,VAN,31,82,3,7,10
58,8482859,Zack Ostapchuk,C,OTT,21,82,3,7,10
58,8483489,Fraser Minten,C,TOR,31,82,3,7,10
58,8478468,Jeremy Lauzon,D,NSH,27,82,2,8,10
58,8483466,Kevin Korchinski,D,CHI,20,82,2,8,10
58,8482713,Mackie Samoskevich,R,FLA,22,82,0,10,10
58,8474567,Zach Bogosian,D,MIN,34,82,2,7,9
58,8482153,Brendan Brisson,C,VGK,23,82,1,8,9
58,8478874,Adam Gaudette,C,OTT,28,82,1,8,9
58,8483567,Georgii Merkulov,C,BOS,24,82,1,8,9
58,8482070,Mitchell Chaffee,R,TBL,26,82,4,4,8
58,8474062,Riley Nash,C,NYR,35,82,1,3,4
58,8470794,Joe Pavelski,C,,40,0,0,0,0
58,8481703,Valtteri Puustinen,R,PIT,25,0,0,0,0
58,8477950,Tony DeAngelo,D,,29,0,0,0,0
58,8481577,Philip Tomasino,C,NSH,23,0,0,0,0
58,8475197,Tyson Barrie,D,,33,0,0,0,0
58,8471218,Blake Wheeler,R,,38,0,0,0,0
58,8474157,Max Pacioretty,L,,36,0,0,0,0
58,8478466,Daniel Sprong,R,VAN,27,0,0,0,0
58,8475744,Evgeny Kuznetsov,C,,32,0,0,0,0
58,8481019,David Gustafsson,C,WPG,24,0,0,0,0
58,8475906,John Klingberg,D,,32,0,0,0,0
58,8479348,Kale Clague,D,BUF,26,0,0,0,0
58,8476952,Dominic Toninato,C,WPG,30,0,0,0,0
58,8473473,Milan Lucic,L,,36,0,0,0,0
58,8474037,James van Riemsdyk,L,,35,0,0,0,0
58,8474602,Justin Schultz,D,,34,0,0,0,0
58,8482222,Alexander Barabanov,L,,30,0,0,0,0
58,8479372,Josh Mahura,D,SEA,26,0,0,0,0
58,8479982,Conor Timmins,D,TOR,26,0,0,0,0
58,8474031,Kevin Shattenkirk,D,,35,0,0,0,0
58,8480008,Adam Ruzicka,C,,25,0,0,0,0
58,8481059,Scott Perunovich,D,STL,26,0,0,0,0
58,8480884,Calen Addison,D,,24,0,0,0,0
58,8476994,Vinnie Hinostroza,C,NSH,30,0,0,0,0
58,8478452,Caleb Jones,D,LAK,27,0,0,0,0
58,8480157,Calle Rosen,D,COL,30,0,0,0,0
58,8481609,Vladislav Kolyachonok,D,UTA,23,0,0,0,0
58,8479415,Michael McLeod,C,,26,0,0,0,0
58,8476919,Chris Tierney,C,,30,0,0,0,0
58,8479639,Dylan Coghlan,D,WPG,26,0,0,0,0
58,8478146,Matthew Highmore,C,OTT,28,0,0,0,0
58,8478970,Jalen Chatfield,D,CAR,28,0,0,0,0
58,8480205,Emil Bemstrom,C,PIT,25,0,0,0,0
58,8474884,Mike Hoffman,C,,35,0,0,0,0
58,8471274,Alex Goligoski,D,,39,0,0,0,0
58,8478104,Sammy Blais,L,,28,0,0,0,0
58,8474870,Tyler Johnson,C,,34,0,0,0,0
58,8476913,Devin Shore,C,MIN,30,0,0,0,0
58,8481598,Philip Broberg,D,EDM,23,0,0,0,0
58,8480058,Pierre-Olivier Joseph,D,STL,25,0,0,0,0
58,8480891,Michael Kesselring,D,UTA,24,0,0,0,0
58,8477979,Nicolas Aube-Kubel,R,BUF,28,0,0,0,0
58,8476871,Tanner Pearson,L,,32,0,0,0,0
58,8476393,Nick Cousins,C,,31,0,0,0,0
58,8479977,Kailer Yamamoto,R,,26,0,0,0,0
58,8479543,Michael Pezzetta,L,MTL,26,0,0,0,0
58,8477018,Ben Hutton,D,VGK,31,0,0,0,0
58,8480762,Eric Robinson,L,CAR,29,0,0,0,0
58,8474034,Pat Maroon,L,CHI,36,0,0,0,0
58,8481058,Jesse Ylönen,R,,25,0,0,0,0
58,8475179,Dmitry Kulikov,D,FLA,34,0,0,0,0
58,8481527,Kaedan Korczak,D,VGK,23,0,0,0,0
58,8473449,Kyle Okposo,R,,36,0,0,0,0
58,8482192,Isaak Phillips,D,CHI,23,0,0,0,0
58,8480727,Zach Whitecloud,D,VGK,28,0,0,0,0
58,8479346,Dillon Dube,C,,26,0,0,0,0
58,8480821,Filip Zadina,R,,25,0,0,0,0
58,8480001,Urho Vaakanainen,D,ANA,25,0,0,0,0
58,8470966,Mark Giordano,D,,41,0,0,0,0
58,8480853,Liam Foudy,C,,24,0,0,0,0
58,8475225,Craig Smith,C,CHI,35,0,0,0,0
58,8479972,Mason Shaw,C,WPG,26,0,0,0,0
58,8478451,Ethan Bear,D,WSH,27,0,0,0,0
58,8474040,Sam Gagner,C,,35,0,0,0,0
58,8480196,Jacob Bryson,D,BUF,27,0,0,0,0
58,8479984,Cal Foote,D,,26,0,0,0,0
58,8480011,Klim Kostin,C,SJS,25,0,0,0,0
58,8482176,Wyatt Kaiser,D,CHI,22,0,0,0,0
58,8476988,Matt Benning,D,SJS,30,0,0,0,0
58,8479370,Tyson Jost,C,CAR,26,0,0,0,0
58,8477464,Nic Petan,C,,29,0,0,0,0
58,8477380,Jonny Brodzinski,C,NYR,31,0,0,0,0
58,8480070,Ian Mitchell,D,BOS,25,0,0,0,0
58,8479315,Joey Anderson,R,CHI,26,0,0,0,0
58,8478099,Kevin Labanc,R,,29,0,0,0,0
58,8476874,Olli Maatta,D,DET,30,0,0,0,0
58,8475208,Brian Dumoulin,D,ANA,33,0,0,0,0
58,8478430,Oliver Kylington,D,,27,0,0,0,0
58,8479536,Axel Jonsson-Fjallby,L,WPG,26,0,0,0,0
58,8479671,Mathieu Olivier,R,CBJ,27,0,0,0,0
58,8471709,Marc-Edouard Vlasic,D,SJS,37,0,0,0,0
58,8479328,Julien Gauthier,R,NYI,27,0,0,0,0
58,8478421,A.J. Greer,L,FLA,28,0,0,0,0
58,8477573,Nathan Walker,L,STL,30,0,0,0,0
58,8481537,Nikita Okhotiuk,D,CGY,24,0,0,0,0
58,8474166,Alec Martinez,D,CHI,37,0,0,0,0
58,8470610,Zach Parise,L,,40,0,0,0,0
58,8477478,William Carrier,L,CAR,30,0,0,0,0
58,8479344,Jesse Puljujarvi,R,PIT,26,0,0,0,0
58,8480887,Jordan Harris,D,MTL,24,0,0,0,0
58,8478502,Dennis Gilbert,D,BUF,28,0,0,0,0
58,8482730,Brandt Clarke,D,LAK,21,0,0,0,0
58,8480355,Mark Kastelic,C,BOS,25,0,0,0,0
58,8475750,Jon Merrill,D,MIN,32,0,0,0,0
58,8475164,Jakob Silfverberg,R,,34,0,0,0,0
58,8477944,Jakub Vrana,L,,28,0,0,0,0
58,8479439,Jacob MacDonald,D,COL,31,0,0,0,0
58,8474568,Luke Schenn,D,NSH,35,0,0,0,0
58,8478454,Noah Juulsen,D,VAN,27,0,0,0,0
58,8475752,Tyler Pitlick,C,,33,0,0,0,0
58,8482148,Hendrix Lapierre,C,WSH,22,0,0,0,0
58,8481167,Brayden Pachal,D,CGY,25,0,0,0,0
58,8478043,Sam Lafferty,C,BUF,29,0,0,0,0
58,8479321,Lucas Johansen,D,,27,0,0,0,0
58,8471699,Andrew Cogliano,C,,37,0,0,0,0
58,8481521,Ronnie Attard,D,PHI,25,0,0,0,0
58,8481161,Jake Christiansen,D,CBJ,25,0,0,0,0
58,8479458,Nikita Zaitsev,D,,33,0,0,0,0
58,8479619,Michael Carcone,L,UTA,28,0,0,0,0
58,8479026,Philippe Myers,D,TOR,27,0,0,0,0
58,8477330,Dominik Kubalik,L,,29,0,0,0,0
58,8481617,Vasily Podkolzin,R,VAN,23,0,0,0,0
58,8481701,Santeri Hatakka,D,NJD,23,0,0,0,0
58,8479514,Rem Pitlick,C,,27,0,0,0,0
58,8477446,Michael McCarron,R,NSH,29,0,0,0,0
58,8470604,Jeff Carter,C,,39,0,0,0,0
58,8482241,Radim Zohorna,L,,28,0,0,0,0
58,8480289,Morgan Barron,C,WPG,26,0,0,0,0
58,8479379,Givani Smith,R,SJS,26,0,0,0,0
58,8480216,Jacob Peterson,C,,25,0,0,0,0
58,8477851,Jordan Oesterle,D,BOS,32,0,0,0,0
58,8484258,Sam Malinski,D,COL,26,0,0,0,0
58,8478904,Steven Lorentz,C,,28,0,0,0,0
58,8482095,Tyler Kleven,D,OTT,22,0,0,0,0
58,8480848,Ty Dellandrea,C,SJS,24,0,0,0,0
58,8476884,Derrick Pouliot,D,,30,0,0,0,0
58,8479336,Carl Grundstrom,R,SJS,27,0,0,0,0
58,8482964,Arber Xhekaj,D,MTL,23,0,0,0,0
58,8471686,Marc Staal,D,,37,0,0,0,0
58,8477887,Patrick Brown,C,BOS,32,0,0,0,0
58,8478495,Denis Gurianov,R,,27,0,0,0,0
58,8473504,Cal Clutterbuck,R,,37,0,0,0,0
58,8481550,Adam Beckman,L,NJD,23,0,0,0,0
58,8480845,Rasmus Kupari,C,WPG,24,0,0,0,0
58,8474009,Nick Bonino,C,,36,0,0,0,0
58,8478585,Derek Ryan,C,EDM,38,0,0,0,0
58,8477962,Brendan Lemieux,L,CAR,28,0,0,0,0
58,8482861,Vincent Iorio,D,WSH,22,0,0,0,0
58,8479378,Logan Stanley,D,WPG,26,0,0,0,0
58,8473446,Erik Johnson,D,PHI,36,0,0,0,0
58,8481743,Marc Del Gaizo,D,NSH,25,0,0,0,0
58,8477384,Josh Brown,D,EDM,30,0,0,0,0
58,8482165,Yan Kuznetsov,D,CGY,22,0,0,0,0
58,8478424,Jansen Harkins,C,ANA,27,0,0,0,0
58,8482144,Jack Thompson,D,SJS,22,0,0,0,0
58,8478512,Austin Czarnik,C,,32,0,0,0,0
58,8477527,Ross Johnston,L,ANA,30,0,0,0,0
58,8479383,Boris Katchouk,L,,26,0,0,0,0
58,8482094,Daemon Hunt,D,MIN,22,0,0,0,0
58,8481719,Maxwell Crozier,D,TBL,24,0,0,0,0
58,8480192,Johnathan Kovacevic,D,NJD,27,0,0,0,0
58,8479376,Victor Mete,D,,26,0,0,0,0
58,8482511,Mason Lohrei,D,BOS,23,0,0,0,0
58,8475825,Jani Hakanpää,D,,32,0,0,0,0
58,8478021,William Lagesson,D,DET,28,0,0,0,0
58,8475795,Dylan McIlrath,D,WSH,32,0,0,0,0
58,8477846,Ryan Carpenter,C,,33,0,0,0,0
58,8481056,Spencer Stastney,D,NSH,24,0,0,0,0
58,8481564,Ryan Johnson,D,BUF,23,0,0,0,0
58,8478017,Mark Friedman,D,VAN,29,0,0,0,0
58,8479320,Max Lajoie,D,SEA,27,0,0,0,0
58,8480075,Cameron Crotty,D,MIN,25,0,0,0,0
58,8484287,Cole McWard,D,VAN,23,0,0,0,0
58,8484254,Akito Hirose,D,VAN,25,0,0,0,0
58,8483407,Brandon Scanlin,D,NYR,25,0,0,0,0
58,8480274,Philip Kemp,D,EDM,25,0,0,0,0
58,8479522,Hardy Haman Aktell,D,WSH,26,0,0,0,0
58,8480007,Jonas Rondbjerg,R,VGK,25,0,0,0,0
58,8477454,Adam Erne,L,,29,0,0,0,0
58,8481679,Maxence Guenette,D,OTT,23,0,0,0,0
58,8480441,Trey Fix-Wolansky,R,CBJ,25,0,0,0,0
58,8483546,Marshall Rifai,D,TOR,26,0,0,0,0
58,8480084,Nick DeSimone,D,NJD,30,0,0,0,0
58,8481030,Jack St. Ivany,D,PIT,25,0,0,0,0
58,8481592,Jakob Pelletier,L,CGY,23,0,0,0,0
58,8478011,Louie Belpedio,D,PHI,28,0,0,0,0
58,8477930,Pierre-Edouard Bellemare,L,,39,0,0,0,0
58,8484321,Nikolas Matinpalo,D,OTT,26,0,0,0,0
58,8482067,Connor Mackey,D,NYR,28,0,0,0,0
58,8481806,Louis Crevier,D,CHI,23,0,0,0,0
58,8484326,Patrik Koch,D,UTA,28,0,0,0,0
58,8477971,Andreas Englund,D,LAK,28,0,0,0,0
58,8481751,Lukas Rousek,R,BUF,25,0,0,0,0
58,8481006,Tyler Tucker,D,STL,24,0,0,0,0
58,8476867,Brendan Gaunce,C,MIN,30,0,0,0,0
58,8479520,Brandon Duhaime,R,WSH,27,0,0,0,0
58,8477073,Kurtis MacDermid,L,NJD,30,0,0,0,0
58,8480874,Adam Ginning,D,PHI,24,0,0,0,0
58,8477473,Justin Bailey,R,SJS,29,0,0,0,0
58,8479066,Ryan Lomberg,L,CGY,30,0,0,0,0
58,8477070,Liam O'Brien,C,UTA,30,0,0,0,0
58,8474618,Marco Scandella,D,,34,0,0,0,0
58,8475797,Jarred Tinordi,D,,32,0,0,0,0
58,8481441,Joe Snively,C,DET,28,0,0,0,0
58,8477244,Chad Ruhwedel,D,NYR,34,0,0,0,0
58,8479772,Zack MacEwen,R,OTT,28,0,0,0,0
58,8481147,Reese Johnson,C,MIN,26,0,0,0,0
58,8481043,Cole Koepke,L,BOS,26,0,0,0,0
58,8483619,Filip Roos,D,OTT,25,0,0,0,0
58,8481541,Samuel Bolduc,D,NYI,24,0,0,0,0
58,8477810,Joel Hanley,D,CGY,33,0,0,0,0
58,8476907,Mackenzie MacEachern,L,,30,0,0,0,0
58,8482652,Walker Duehr,R,CGY,27,0,0,0,0
58,8477126,Jayson Megna,C,,34,0,0,0,0
58,8483398,Declan Carlile,D,TBL,31,0,0,0,0
58,8482929,Emil Lilleberg,D,TBL,23,0,0,0,0
58,8480880,Jakub Lauko,C,MIN,24,0,0,0,0
58,8480245,Olle Lycksell,R,PHI,25,0,0,0,0
58,8480252,Cole Guttman,C,CHI,25,0,0,0,0
58,8477467,Gustav Olofsson,D,SEA,30,0,0,0,0
58,8479968,Vinni Lettieri,C,BOS,29,0,0,0,0
58,8478400,Colin White,C,,27,0,0,0,0
58,8475755,Alexander Petrovic,D,DAL,32,0,0,0,0
58,8481812,Nikolai Knyzhov,D,,27,0,0,0,0
58,8481593,Jayden Struble,D,MTL,23,0,0,0,0
58,8481532,Alex Turcotte,C,LAK,23,0,0,0,0
58,8482126,Emil Andrae,D,PHI,31,0,0,0,0
58,8479944,Zach Aston-Reese,C,VGK,30,0,0,0,0
58,8471817,Ryan Reaves,R,TOR,37,0,0,0,0
58,8481206,John Ludvig,D,PIT,24,0,0,0,0
58,8481599,Victor Soderstrom,D,UTA,23,0,0,0,0
58,8480292,Carson Meyer,R,ANA,27,0,0,0,0
58,8482496,Nils Aman,C,VAN,24,0,0,0,0
58,8479718,Alex Barré-Boulet,C,MTL,27,0,0,0,0
58,8479994,Jaret Anderson-Dolan,C,WPG,25,0,0,0,0
58,8480184,Gustav Lindstrom,D,,26,0,0,0,0
58,8480890,Jan Jenik,R,OTT,24,0,0,0,0
58,8478067,Oskar Lindblom,L,,28,0,0,0,0
58,8476934,Brock McGinn,L,ANA,30,0,0,0,0
58,8479985,Cale Fleury,D,SEA,26,0,0,0,0
58,8484304,Uvis Balinskis,D,FLA,28,0,0,0,0
58,8479981,Jonah Gadjovich,L,FLA,26,0,0,0,0
58,8481716,Dmitri Voronkov,L,CBJ,24,0,0,0,0
58,8474709,Matt Martin,L,,35,0,0,0,0
58,8482634,Alex Steeves,C,TOR,25,0,0,0,0
58,8480823,Alexander Alexeyev,D,WSH,25,0,0,0,0
58,8477541,Dakota Mermis,D,TOR,30,0,0,0,0
58,8483491,Ivan Miroshnichenko,L,WSH,20,0,0,0,0
58,8478477,Mitchell Stephens,C,SEA,27,0,0,0,0
58,8481543,Nikita Alexandrov,C,STL,24,0,0,0,0
58,8479423,Alex Nylander,L,,26,0,0,0,0
58,8482451,Mikael Pyyhtia,L,CBJ,23,0,0,0,0
58,8478831,Kevin Stenlund,C,UTA,28,0,0,0,0
58,8480306,Grant Hutton,D,NYI,29,0,0,0,0
58,8478028,Fredrik Olofsson,L,,28,0,0,0,0
58,8477462,Robert Hagg,D,VGK,29,0,0,0,0
58,8477320,Anton Blidh,L,NYR,29,0,0,0,0
58,8482157,Will Cuylle,L,NYR,22,0,0,0,0
58,8482737,Zack Bolduc,C,STL,21,0,0,0,0
58,8481239,Samuel Fagemo,L,,24,0,0,0,0
58,8481600,Tobias Bjornfot,D,FLA,23,0,0,0,0
58,8478409,Anthony Richard,C,PHI,28,0,0,0,0
58,8474145,Robert Bortuzzo,D,,35,0,0,0,0
58,8475958,Michael Sgarbossa,C,WSH,32,0,0,0,0
58,8479986,Kole Lind,R,DAL,26,0,0,0,0
58,8479249,Andrew Poturalski,C,SJS,30,0,0,0,0
58,8479362,Riley Tufte,L,BOS,26,0,0,0,0
58,8479991,Jake Leschyshyn,C,NYR,25,0,0,0,0
58,8479587,Rhett Gardner,C,PHI,28,0,0,0,0
58,8482744,James Malatesta,L,CBJ,21,0,0,0,0
58,8478854,Ryan Shea,D,PIT,27,0,0,0,0
58,8481591,Sam Poulin,R,,23,0,0,0,0
58,8483512,Matt Savoie,C,EDM,20,0,0,0,0
58,8482102,Vasily Ponomarev,C,PIT,22,0,0,0,0
58,8482162,Roby Jarventie,L,EDM,22,0,0,0,0
58,8481016,Ruslan Iskhakov,C,,24,0,0,0,0
58,8482172,Landon Slaggert,L,CHI,22,0,0,0,0
58,8482747,Brennan Othmann,L,NYR,21,0,0,0,0
58,8480031,Maxime Comtois,L,,25,0,0,0,0
58,8480226,Marián Studenic,R,,26,0,0,0,0
58,8478408,Travis Dermott,D,,28,0,0,0,0
58,8481518,Nolan Foote,L,NJD,24,0,0,0,0
58,8479419,Brett Murray,L,BUF,26,0,0,0,0
58,8482088,Justin Sourdif,R,FLA,22,0,0,0,0
58,8482201,Gage Goncalves,C,TBL,23,0,0,0,0
58,8481578,Graeme Clarke,R,MIN,23,0,0,0,0
58,8482177,Marat Khusnutdinov,C,MIN,22,0,0,0,0
58,8481754,Nikita Nesterenko,C,ANA,23,0,0,0,0
58,8483531,Brian Halonen,L,NJD,25,0,0,0,0
58,8483920,Pierrick Dube,R,WSH,23,0,0,0,0
58,8480851,Akil Thomas,C,LAK,24,0,0,0,0
58,8475235,Nicolas Deslauriers,L,PHI,33,0,0,0,0
58,8482476,Emil Heineman,L,MTL,23,0,0,0,0
58,8477149,Scott Sabourin,R,SJS,32,0,0,0,0
58,8483549,Lucas Condotta,L,MTL,27,0,0,0,0
58,8482765,Isak Rosen,R,BUF,21,0,0,0,0
58,8481237,Kyle MacLean,C,NYI,25,0,0,0,0
58,8481024,Linus Karlsson,C,VAN,25,0,0,0,0
58,8481690,Tyler Angle,C,,24,0,0,0,0
58,8483570,Ben Meyers,C,SEA,26,0,0,0,0
58,8481655,Cole Schwindt,R,CGY,23,0,0,0,0
58,8481462,Mason Morelli,L,VGK,28,0,0,0,0
58,8483401,Marc Johnstone,R,PIT,28,0,0,0,0
58,8478956,Samuel Laberge,L,NJD,27,0,0,0,0
58,8479533,Joona Koppanen,L,,26,0,0,0,0
58,8482197,Adam Raska,R,MIN,23,0,0,0,0
58,8482250,Callahan Burke,C,VGK,27,0,0,0,0
58,8482784,Zach Dean,C,STL,21,0,0,0,0
58,8484255,Jason Polin,R,COL,25,0,0,0,0
58,8481077,John Leonard,L,,26,0,0,0,0
58,8481534,Raphael Lavoie,C,EDM,24,0,0,0,0
58,8483609,Adam Klapka,R,CGY,24,0,0,0,0
58,8482751,Ryan Winterton,C,SEA,21,0,0,0,0
58,8480267,Sammy Walker,C,MIN,25,0,0,0,0
58,8475766,Austin Watson,L,,32,0,0,0,0
58,8482460,Matt Rempe,C,NYR,22,0,0,0,0
58,8481065,Angus Crookshank,L,OTT,25,0,0,0,0
58,8481070,Hugh McGing,L,,26,0,0,0,0
58,8476323,Max McCormick,L,SEA,32,0,0,0,0
58,8483395,Arshdeep Bains,L,VAN,23,0,0,0,0
58,8484259,Ondrej Pavel,C,COL,31,0,0,0,0
58,8483432,Luca Del Bel Belluz,C,CBJ,31,0,0,0,0
58,8483045,Cameron Butler,R,CBJ,31,0,0,0,0
58,8482061,Brandon Biro,L,SEA,26,0,0,0,0
58,8477401,John Hayden,C,SEA,29,0,0,0,0
58,8475278,Byron Froese,C,,33,0,0,0,0
58,8478446,Glenn Gawdin,C,LAK,27,0,0,0,0
58,8477993,Justin Kirkland,C,CGY,28,0,0,0,0
58,8482147,Jean-Luc Foudy,C,COL,22,0,0,0,0
58,8480032,Shane Bowers,C,NJD,25,0,0,0,0
58,8479330,Brandon Gignac,C,MTL,27,0,0,0,0
58,8480776,Sheldon Rempal,R,,29,0,0,0,0
58,8475413,Justin Dowling,C,NJD,34,0,0,0,0
58,8481726,Adam Edstrom,C,NYR,24,0,0,0,0
58,8480844,Grigori Denisenko,L,VGK,24,0,0,0,0
58,8478147,Bokondji Imama,L,PIT,28,0,0,0,0
58,8478881,Brett Seney,L,CHI,28,0,0,0,0
58,8483630,Pavol Regenda,L,ANA,25,0,0,0,0
58,8480836,Jonathan Gruden,C,,24,0,0,0,0
58,8484314,Jiri Smejkal,L,,28,0,0,0,0
58,8475780,Chris Wagner,R,COL,33,0,0,0,0
58,8479546,Oskar Steen,C,,26,0,0,0,0
58,8483597,Milos Kelemen,L,UTA,25,0,0,0,0
58,8481789,Tye Kartye,L,SEA,23,0,0,0,0
58,8484325,Waltteri Merela,C,TBL,26,0,0,0,0
58,8479421,Jacob Moverare,D,LAK,26,0,0,0,0
58,8481585,Egor Afanasyev,L,SJS,23,0,0,0,0
58,8479547,Matthew Phillips,R,,26,0,0,0,0
58,8479367,William Lockwood,R,FLA,26,0,0,0,0
58,8476915,Jujhar Khaira,L,,30,0,0,0,0
58,8481422,Jacob Lucchini,C,NSH,29,0,0,0,0
58,8480468,James Hamblin,L,EDM,25,0,0,0,0
58,8478051,Max Willman,C,NJD,29,0,0,0,0
58,8481556,John Beecher,C,BOS,23,0,0,0,0
58,8478078,Rourke Chartier,C,,28,0,0,0,0
59,8478402,Connor McDavid,C,EDM,27,82,40,102,142
59,8480027,Jason Robertson,L,DAL,25,82,50,72,122
59,8477956,David Pastrnak,R,BOS,28,82,59,59,118
59,8476453,Nikita Kucherov,R,TBL,31,82,23,95,118
59,8477934,Leon Draisaitl,C,EDM,29,82,46,66,112
59,8477492,Nathan MacKinnon,C,COL,29,82,42,67,109
59,8479318,Auston Matthews,C,TOR,27,82,66,41,107
59,8476468,J.T. Miller,C,VAN,31,82,35,68,103
59,8480830,Andrei Svechnikov,R,CAR,24,82,36,66,102
59,8480800,Quinn Hughes,D,VAN,25,82,10,92,102
59,8479314,Matthew Tkachuk,L,FLA,27,82,33,67,100
59,8477939,William Nylander,R,TOR,28,82,39,59,98
59,8480023,Robert Thomas,C,STL,25,82,31,67,98
59,8474564,Steven Stamkos,C,NSH,34,82,46,51,97
59,8480801,Brady Tkachuk,L,OTT,25,82,42,54,96
59,8478864,Kirill Kaprizov,L,MIN,27,82,48,47,95
59,8471675,Sidney Crosby,C,PIT,37,82,38,57,95
59,8479407,Jesper Bratt,L,NJD,26,82,37,58,95
59,8477933,Sam Reinhart,C,FLA,29,82,42,52,94
59,8481523,Kirby Dach,C,MTL,23,82,22,72,94
59,8480012,Elias Pettersson,C,VAN,26,82,38,55,93
59,8477404,Jake Guentzel,C,TBL,30,82,47,44,91
59,8481559,Jack Hughes,C,NJD,23,82,31,60,91
59,8480036,Miro Heiskanen,D,DAL,25,82,17,74,91
59,8476460,Mark Scheifele,C,WPG,31,82,31,59,90
59,8477501,Valeri Nichushkin,R,COL,29,82,49,40,89
59,8478420,Mikko Rantanen,R,COL,28,82,38,51,89
59,8477940,Nikolaj Ehlers,L,WPG,28,82,32,57,89
59,8474600,Roman Josi,D,NSH,34,82,30,59,89
59,8475810,Bryan Rust,R,PIT,32,82,41,47,88
59,8477942,Kevin Fiala,L,LAK,28,82,29,59,88
59,8476887,Filip Forsberg,L,NSH,30,82,37,49,86
59,8480002,Nico Hischier,C,NJD,25,82,37,49,86
59,8475172,Nazem Kadri,C,CGY,34,82,30,56,86
59,8475166,John Tavares,C,TOR,34,82,35,49,84
59,8477493,Aleksander Barkov,C,FLA,29,82,27,57,84
59,8478550,Artemi Panarin,L,NYR,33,82,26,58,84
59,8478010,Brayden Point,C,TBL,28,82,39,44,83
59,8479385,Jordan Kyrou,C,STL,26,82,39,44,83
59,8478427,Sebastian Aho,C,CAR,27,82,35,48,83
59,8482116,Tim Stützle,C,OTT,22,82,25,57,82
59,8480069,Cale Makar,D,COL,26,82,21,61,82
59,8478398,Kyle Connor,L,WPG,28,82,39,42,81
59,8475913,Mark Stone,R,VGK,32,82,24,57,81
59,8471214,Alex Ovechkin,L,WSH,39,82,46,34,80
59,8479343,Clayton Keller,R,UTA,26,82,41,39,80
59,8478439,Travis Konecny,R,PHI,27,82,33,47,80
59,8476459,Mika Zibanejad,C,NYR,31,82,30,49,79
59,8476456,Jonathan Huberdeau,C,CGY,31,82,23,56,79
59,8479323,Adam Fox,D,NYR,26,82,19,59,78
59,8481557,Matt Boldy,L,MIN,23,82,26,51,77
59,8476539,Jonathan Marchessault,R,NSH,34,82,35,41,76
59,8476389,Vincent Trocheck,C,NYR,31,82,27,48,75
59,8477496,Elias Lindholm,C,BOS,30,82,23,52,75
59,8476346,Johnny Gaudreau,L,CBJ,31,82,22,53,75
59,8475184,Chris Kreider,L,NYR,33,82,37,37,74
59,8478403,Jack Eichel,C,VGK,28,82,34,40,74
59,8478445,Mathew Barzal,C,NYI,27,82,16,58,74
59,8477447,Shea Theodore,D,VGK,29,82,15,59,74
59,8477402,Pavel Buchnevich,L,STL,29,82,28,45,73
59,8475798,Mikael Granlund,C,SJS,32,82,17,56,73
59,8479339,Patrik Laine,L,CBJ,26,82,36,36,72
59,8479675,Trevor Moore,L,LAK,29,82,29,43,72
59,8481533,Trevor Zegras,C,ANA,23,82,29,43,72
59,8476454,Ryan Nugent-Hopkins,C,EDM,31,82,20,51,71
59,8475692,Mats Zuccarello,R,MIN,37,82,19,51,70
59,8478498,Jake DeBrusk,L,VAN,28,82,34,35,69
59,8479542,Brandon Hagel,L,TBL,26,82,32,37,69
59,8478440,Dylan Strome,C,WSH,27,82,21,48,69
59,8478414,Timo Meier,R,NJD,28,82,37,31,68
59,8478444,Brock Boeser,R,VAN,27,82,33,35,68
59,8479337,Alex DeBrincat,R,DET,27,82,33,35,68
59,8477935,Sam Bennett,C,FLA,28,82,32,36,68
59,8477960,Adrian Kempe,R,LAK,28,82,27,41,68
59,8474150,Mikael Backlund,C,CGY,35,82,24,44,68
59,8476905,Chandler Stephenson,C,SEA,30,82,15,53,68
59,8475168,Matt Duchene,C,DAL,33,82,32,35,67
59,8476881,Tomas Hertl,C,VGK,31,82,31,36,67
59,8481528,Dylan Cozens,C,BUF,23,82,27,40,67
59,8478042,Viktor Arvidsson,R,EDM,31,82,26,41,67
59,8476462,Dougie Hamilton,D,NJD,31,82,13,54,67
59,8477346,MacKenzie Weegar,D,CGY,30,82,13,54,67
59,8481068,Yegor Sharangovich,C,CGY,26,82,32,34,66
59,8477946,Dylan Larkin,C,DET,28,82,31,35,66
59,8478493,Joel Eriksson Ek,C,MIN,27,82,31,35,66
59,8473419,Brad Marchand,L,BOS,36,82,23,43,66
59,8471215,Evgeni Malkin,C,PIT,38,82,21,45,66
59,8477955,Jared McCann,L,SEA,28,82,33,32,65
59,8475786,Zach Hyman,L,EDM,32,82,31,34,65
59,8474141,Patrick Kane,R,DET,36,82,25,40,65
59,8478449,Roope Hintz,C,DAL,28,82,24,41,65
59,8479345,Jakob Chychrun,D,WSH,26,82,20,45,65
59,8476853,Morgan Rielly,D,TOR,30,82,15,50,65
59,8474590,John Carlson,D,WSH,34,82,13,52,65
59,8482078,Lucas Raymond,L,DET,22,82,20,44,64
59,8474578,Erik Karlsson,D,PIT,34,82,14,50,64
59,8471724,Kris Letang,D,PIT,37,82,14,50,64
59,8479420,Tage Thompson,C,BUF,27,82,38,25,63
59,8477409,Carter Verhaeghe,C,FLA,29,82,30,33,63
59,8477476,Artturi Lehkonen,L,COL,29,82,27,36,63
59,8478460,Zach Werenski,D,CBJ,27,82,12,51,63
59,8476399,Blake Coleman,C,CGY,33,82,37,25,62
59,8482740,Wyatt Johnston,C,DAL,21,82,33,29,62
59,8478975,Mason Marchment,L,DAL,29,82,21,41,62
59,8480208,Drake Batherson,R,OTT,26,82,18,44,62
59,8477503,Max Domi,C,TOR,29,82,18,44,62
59,8474679,Gustav Nyquist,C,NSH,35,82,17,45,62
59,8475167,Victor Hedman,D,TBL,34,82,16,46,62
59,8478407,Vince Dunn,D,SEA,28,82,8,54,62
59,8475794,Tyler Seguin,C,DAL,32,82,29,32,61
59,8476483,Rickard Rakell,R,PIT,31,82,28,33,61
59,8477949,Alex Tuch,R,BUF,28,82,23,38,61
59,8482093,Seth Jarvis,C,CAR,22,82,21,40,61
59,8482665,Matty Beniers,C,SEA,22,82,21,40,61
59,8476792,Torey Krug,D,STL,33,82,9,52,61
59,8477497,Sean Monahan,C,CBJ,30,82,21,39,60
59,8478856,Conor Garland,R,VAN,28,82,33,26,59
59,8478873,Troy Terry,R,ANA,27,82,31,28,59
59,8475726,Tyler Toffoli,C,SJS,32,82,27,32,59
59,8482124,Quinton Byfield,R,LAK,22,82,24,35,59
59,8475784,Jeff Skinner,C,EDM,32,82,24,35,59
59,8480797,Joel Farabee,L,PHI,24,82,23,36,59
59,8478462,Nicolas Roy,C,VGK,27,82,21,38,59
59,8480039,Martin Necas,C,CAR,25,82,16,43,59
59,8477504,Josh Morrissey,D,WPG,29,82,11,48,59
59,8475754,Brock Nelson,C,NYI,33,82,33,25,58
59,8476448,William Karlsson,C,VGK,31,82,31,27,58
59,8473986,Alex Killorn,L,ANA,35,82,23,35,58
59,8478401,Pavel Zacha,C,BOS,27,82,20,38,58
59,8477951,Nick Schmaltz,C,UTA,28,82,15,43,58
59,8475169,Evander Kane,L,EDM,33,82,32,25,57
59,8476432,Boone Jenner,C,CBJ,31,82,31,26,57
59,8471685,Anze Kopitar,C,LAK,37,82,26,31,57
59,8475765,Vladimir Tarasenko,R,DET,33,82,24,33,57
59,8480018,Nick Suzuki,C,MTL,25,82,20,37,57
59,8478047,Michael Bunting,L,PIT,29,82,20,37,57
59,8480078,Filip Chytil,C,NYR,25,82,17,40,57
59,8482159,Tyson Foerster,R,PHI,22,82,30,26,56
59,8481540,Cole Caufield,R,MTL,23,82,24,32,56
59,8478519,Anthony Cirelli,C,TBL,27,82,24,32,56
59,8475158,Ryan O'Reilly,C,NSH,33,82,22,34,56
59,8477986,Brandon Montour,D,SEA,30,82,21,35,56
59,8479425,Filip Hronek,D,VAN,27,82,20,36,56
59,8475191,Reilly Smith,R,NYR,33,82,26,29,55
59,8475170,Brayden Schenn,C,STL,33,82,20,35,55
59,8482109,Alexis Lafrenière,L,NYR,23,82,28,26,54
59,8477416,Oliver Bjorkstrand,R,SEA,29,82,27,27,54
59,8475763,Kevin Hayes,R,PIT,32,82,25,29,54
59,8473994,Jamie Benn,L,DAL,35,82,24,30,54
59,8481618,Alex Newhook,C,MTL,23,82,23,31,54
59,8479365,Trent Frederic,C,BOS,26,82,23,31,54
59,8476906,Shayne Gostisbehere,D,CAR,31,82,20,34,54
59,8477998,Warren Foegele,L,LAK,28,82,20,34,54
59,8480803,Evan Bouchard,D,EDM,25,82,12,42,54
59,8478463,Anthony Beauvillier,L,PIT,27,82,30,23,53
59,8480014,Gabriel Vilardi,C,WPG,25,82,27,26,53
59,8480459,Pius Suter,C,VAN,28,82,24,29,53
59,8482113,Anton Lundell,C,FLA,23,82,20,33,53
59,8477444,Andre Burakovsky,L,SEA,29,82,24,28,52
59,8474563,Drew Doughty,D,LAK,35,82,18,34,52
59,8477495,Seth Jones,D,CHI,30,82,18,34,52
59,8474586,Jordan Eberle,R,SEA,34,82,17,35,52
59,8475745,Charlie Coyle,C,BOS,32,82,17,35,52
59,8474565,Alex Pietrangelo,D,VGK,34,82,16,36,52
59,8475151,Kyle Palmieri,C,NYI,33,82,25,26,51
59,8482699,Dylan Guenther,R,UTA,21,82,19,32,51
59,8477964,Ivan Barbashev,C,VGK,29,82,17,34,51
59,8473512,Claude Giroux,R,OTT,36,82,15,36,51
59,8478038,Devon Toews,D,COL,30,82,9,42,51
59,8479400,Pierre-Luc Dubois,L,WSH,26,82,28,22,50
59,8482110,Dawson Mercer,C,NJD,23,82,26,24,50
59,8484144,Connor Bedard,C,CHI,19,82,21,29,50
59,8474641,Adam Henrique,C,EDM,34,82,21,29,50
59,8470613,Brent Burns,D,CAR,39,82,15,35,50
59,8479410,Mikhail Sergachev,D,UTA,26,82,9,41,50
59,8476880,Tom Wilson,R,WSH,30,82,31,18,49
59,8480865,Noah Dobson,D,NYI,24,82,11,38,49
59,8476854,Hampus Lindholm,D,BOS,30,82,8,41,49
59,8478472,Mathieu Joseph,R,STL,27,82,22,26,48
59,8476872,Scott Laughton,C,PHI,30,82,21,27,48
59,8477479,Tyler Bertuzzi,L,CHI,29,82,20,28,48
59,8476292,Ondrej Palat,L,NJD,33,82,20,28,48
59,8475722,Jason Zucker,L,BUF,32,82,19,29,48
59,8479999,Casey Mittelstadt,C,COL,26,82,18,30,48
59,8478397,Rasmus Andersson,D,CGY,28,82,18,30,48
59,8483808,Andrei Kuzmenko,L,CGY,28,82,17,31,48
59,8476927,Teddy Blueger,C,VAN,30,82,16,32,48
59,8476875,Mike Matheson,D,MTL,30,82,12,36,48
59,8479325,Charlie McAvoy,D,BOS,27,82,9,39,48
59,8480043,Timothy Liljegren,D,TOR,25,82,2,46,48
59,8480015,Owen Tippett,R,PHI,25,82,24,23,47
59,8478474,Lawson Crouse,L,UTA,27,82,24,23,47
59,8481711,Matias Maccelli,L,UTA,24,82,18,29,47
59,8478438,Tommy Novak,C,NSH,27,82,13,34,47
59,8480028,Morgan Frost,C,PHI,25,82,13,34,47
59,8478055,Gustav Forsling,D,FLA,28,82,12,35,47
59,8480434,Sean Durzi,D,UTA,26,82,12,35,47
59,8480893,Kirill Marchenko,R,CBJ,24,82,29,17,46
59,8477407,Anthony Duclair,L,NYI,29,82,20,26,46
59,8476461,Sean Couturier,C,PHI,32,82,20,26,46
59,8476882,Teuvo Teravainen,L,CHI,30,82,16,30,46
59,8482667,William Eklund,L,SJS,22,82,16,30,46
59,8481560,Arthur Kaliyev,R,LAK,23,82,15,31,46
59,8482684,Luke Hughes,D,NJD,21,82,14,32,46
59,8480839,Rasmus Dahlin,D,BUF,24,82,12,34,46
59,8480064,Josh Norris,C,OTT,25,82,28,17,45
59,8477426,Nicholas Paul,L,TBL,29,82,24,21,45
59,8481582,Nicholas Robertson,L,TOR,23,82,19,26,45
59,8477511,Anthony Mantha,R,CGY,30,82,18,27,45
59,8481596,Shane Pinto,C,OTT,24,82,18,27,45
59,8480068,Ryan Poehling,C,PHI,25,82,18,27,45
59,8482745,Mason McTavish,C,ANA,21,82,16,29,45
59,8475791,Taylor Hall,L,CHI,33,82,16,29,45
59,8480798,Philipp Kurashev,C,CHI,25,82,16,29,45
59,8478542,Evan Rodrigues,C,FLA,31,82,15,30,45
59,8474149,Evgenii Dadonov,R,DAL,35,82,15,30,45
59,8478469,Thomas Chabot,D,OTT,27,82,12,33,45
59,8478366,Frank Vatrano,R,ANA,30,82,25,19,44
59,8471698,T.J. Oshie,R,WSH,38,82,21,23,44
59,8476479,Phillip Danault,C,LAK,31,82,21,23,44
59,8478396,Noah Hanifin,D,VGK,27,82,18,26,44
59,8475793,Ryan Johansen,C,PHI,32,82,15,29,44
59,8477494,Jonathan Drouin,L,COL,29,82,12,32,44
59,8475287,Erik Haula,L,NJD,33,82,18,25,43
59,8477932,Aaron Ekblad,D,FLA,28,82,16,27,43
59,8482055,Drew O'Connor,L,PIT,26,82,27,15,42
59,8480220,Noah Cates,L,PHI,25,82,24,18,42
59,8482097,Jack Quinn,R,BUF,23,82,19,23,42
59,8481704,Juuso Parssinen,C,NSH,23,82,19,23,42
59,8474053,Logan Couture,C,SJS,35,82,18,24,42
59,8478046,Danton Heinen,L,VAN,29,82,18,24,42
59,8482705,Cole Sillinger,C,CBJ,21,82,17,25,42
59,8481581,Thomas Harley,D,DAL,23,82,14,28,42
59,8478458,Jack Roslovic,C,CAR,27,82,13,29,42
59,8482671,Owen Power,D,BUF,22,82,12,30,42
59,8475753,Justin Faulk,D,STL,32,82,12,30,42
59,8473563,Nicklas Backstrom,C,WSH,37,82,11,31,42
59,8482089,Jake Neighbours,L,STL,22,82,27,14,41
59,8475149,Marcus Johansson,L,MIN,34,82,19,22,41
59,8476392,Adam Lowry,C,WPG,31,82,18,23,41
59,8480835,Jack Drury,C,CAR,24,82,17,24,41
59,8476826,Yanni Gourde,C,SEA,33,82,16,25,41
59,8481656,Aliaksei Protas,C,WSH,23,82,16,25,41
59,8478891,Mason Appleton,C,WPG,28,82,14,27,41
59,8479293,Brandon Tanev,L,SEA,33,82,26,14,40
59,8475314,Anders Lee,L,NYI,34,82,22,18,40
59,8476469,Joel Armia,R,MTL,31,82,22,18,40
59,8477987,Ryan Donato,C,CHI,28,82,20,20,40
59,8479525,Ross Colton,C,COL,28,82,18,22,40
59,8479996,Cody Glass,C,NSH,25,82,17,23,40
59,8477500,Bo Horvat,C,NYI,29,82,16,24,40
59,8478233,Andrew Mangiapane,L,WSH,28,82,15,25,40
59,8480185,Eetu Luostarinen,C,FLA,26,82,14,26,40
59,8474102,David Perron,L,OTT,36,82,11,29,40
59,8481546,Cam York,D,PHI,23,82,7,33,40
59,8475799,Nino Niederreiter,R,WPG,32,82,27,12,39
59,8482475,Yegor Chinakhov,R,CBJ,23,82,19,20,39
59,8475768,Jaden Schwartz,C,SEA,32,82,18,21,39
59,8477952,Robby Fabbri,C,ANA,28,82,17,22,39
59,8477498,Darnell Nurse,D,EDM,29,82,13,26,39
59,8480074,Alexandre Texier,C,STL,25,82,13,26,39
59,8481542,Moritz Seider,D,DET,23,82,3,36,39
59,8475760,Nick Bjugstad,C,UTA,32,82,25,13,38
59,8479987,Morgan Geekie,C,BOS,26,82,18,20,38
59,8476885,Jacob Trouba,D,NYR,30,82,16,22,38
59,8475218,Mattias Ekholm,D,EDM,34,82,16,22,38
59,8476480,Vladislav Namestnikov,C,WPG,32,82,12,26,38
59,8480009,Eeli Tolvanen,R,SEA,25,82,19,18,37
59,8480829,Jesperi Kotkaniemi,C,CAR,24,82,16,21,37
59,8477451,Ryan Hartman,R,MIN,30,82,13,24,37
59,8477947,Sonny Milano,L,WSH,28,82,11,26,37
59,8482111,Justin Barron,D,MTL,23,82,10,27,37
59,8478109,Victor Olofsson,L,VGK,29,82,20,16,36
59,8475848,Brendan Gallagher,R,MTL,32,82,20,16,36
59,8475714,Calle Jarnkrok,C,TOR,33,82,16,20,36
59,8477021,Alex Kerfoot,C,UTA,30,82,13,23,36
59,8476869,Brady Skjei,D,NSH,30,82,12,24,36
59,8482720,Matthew Knies,L,TOR,22,82,12,24,36
59,8476458,Ryan Strome,C,ANA,31,82,9,27,36
59,8480802,Ryan McLeod,C,BUF,25,82,9,27,36
59,8482660,Kent Johnson,C,CBJ,22,82,8,28,36
59,8477456,J.T. Compher,L,DET,29,82,21,14,35
59,8476438,Brandon Saad,L,STL,32,82,20,15,35
59,8481032,Paul Cotter,C,NJD,25,82,19,16,35
59,8481186,Logan O'Connor,R,COL,28,82,17,18,35
59,8481624,Ilya Mikheyev,R,CHI,30,82,15,20,35
59,8476329,Travis Boyd,C,MIN,31,82,14,21,35
59,8478115,Pierre Engvall,L,NYI,28,82,13,22,35
59,8476902,Esa Lindell,D,DAL,30,82,8,27,35
59,8477450,Jason Dickinson,C,CHI,29,82,18,16,34
59,8477953,Kasperi Kapanen,R,STL,28,82,18,16,34
59,8483431,Logan Cooley,C,UTA,20,82,16,18,34
59,8479992,Michael Rasmussen,C,DET,25,82,14,20,34
59,8482149,Cole Perfetti,C,WPG,22,82,12,22,34
59,8480188,Fabian Zetterlund,L,SJS,25,82,10,24,34
59,8480878,Nils Lundkvist,D,DAL,24,82,8,26,34
59,8476923,Damon Severson,D,CBJ,30,82,7,27,34
59,8480817,K'Andre Miller,D,NYR,24,82,6,28,34
59,8479390,Taylor Raddysh,R,WSH,26,82,17,16,33
59,8474715,Cam Atkinson,R,TBL,35,82,13,20,33
59,8479402,Jake Bean,D,CGY,26,82,8,25,33
59,8477948,Travis Sanheim,D,PHI,28,82,7,26,33
59,8475193,Tomas Tatar,L,NJD,34,82,7,26,33
59,8478840,Will Borgen,D,SEA,28,82,4,29,33
59,8476981,Josh Anderson,R,MTL,30,82,19,13,32
59,8476918,Jimmy Vesey,L,NYR,31,82,19,13,32
59,8473533,Jordan Staal,C,CAR,36,82,17,15,32
59,8482117,Lukas Reichel,L,CHI,22,82,15,17,32
59,8484166,Adam Fantilli,C,CBJ,20,82,15,17,32
59,8480113,Alex Iafallo,L,WPG,31,82,14,18,32
59,8482175,JJ Peterka,R,BUF,22,82,14,18,32
59,8480003,Jesper Boqvist,C,FLA,26,82,14,18,32
59,8477429,Andrew Copp,C,DET,30,82,13,19,32
59,8476925,Colton Sissons,C,NSH,31,82,13,19,32
59,8481013,Jonatan Berggren,R,DET,24,82,13,19,32
59,8476958,Jaccob Slavin,D,CAR,30,82,10,22,32
59,8476312,Josh Manson,D,COL,33,82,9,23,32
59,8482655,J.J. Moser,D,TBL,24,82,7,25,32
59,8480145,Neal Pionk,D,WPG,29,82,4,28,32
59,8475764,Cam Fowler,D,ANA,33,82,3,29,32
59,8473507,Jeff Petry,D,DET,37,82,3,29,32
59,8476921,Jordan Martinook,L,CAR,32,82,18,13,31
59,8481477,Nico Sturm,C,SJS,29,82,18,13,31
59,8475855,Jesper Fast,R,CAR,33,82,15,16,31
59,8482092,Ridly Greig,C,OTT,22,82,14,17,31
59,8482702,Logan Stankoven,C,DAL,21,82,14,17,31
59,8477989,Christian Dvorak,C,MTL,28,82,13,18,31
59,8481580,Connor McMichael,C,WSH,23,82,13,18,31
59,8476419,Jean-Gabriel Pageau,C,NYI,32,82,11,20,31
59,8476960,Andreas Athanasiou,C,CHI,30,82,11,20,31
59,8482166,Shakir Mukhamadullin,D,SJS,22,82,11,20,31
59,8475343,Nic Dowd,C,WSH,34,82,10,21,31
59,8480796,Martin Fehervary,D,WSH,25,82,9,22,31
59,8481522,Peyton Krebs,C,BUF,23,82,8,23,31
59,8477488,Brett Pesce,D,NJD,30,82,8,23,31
59,8479976,Juuso Valimaki,D,UTA,26,82,3,28,31
59,8480873,Rasmus Sandin,D,WSH,24,82,2,29,31
59,8483515,Juraj Slafkovsky,L,MTL,20,82,17,13,30
59,8470621,Corey Perry,R,EDM,39,82,17,13,30
59,8476474,Stefan Noesen,R,NJD,31,82,16,14,30
59,8477425,Miles Wood,L,COL,29,82,14,16,30
59,8478057,Dakota Joshua,C,VAN,28,82,13,17,30
59,8479353,Brett Howden,C,VGK,26,82,13,17,30
59,8477507,Nikita Zadorov,D,BOS,29,82,10,20,30
59,8480336,Sean Walker,D,CAR,30,82,9,21,30
59,8477969,Marcus Pettersson,D,PIT,28,82,7,23,30
59,8474716,Jared Spurgeon,D,MIN,35,82,6,24,30
59,8474151,Ryan McDonagh,D,TBL,35,82,5,25,30
59,8474673,TJ Brodie,D,CHI,34,82,4,26,30
59,8480281,Alexey Toropchenko,R,STL,25,82,19,10,29
59,8482146,Luke Evangelista,R,NSH,22,82,18,11,29
59,8480849,Barrett Hayton,C,UTA,24,82,16,13,29
59,8479368,Max Jones,L,BOS,26,82,16,13,29
59,8482105,Jake Sanderson,D,OTT,22,82,14,15,29
59,8481093,Rafael Harvey-Pinard,L,MTL,25,82,14,15,29
59,8484145,Zach Benson,L,BUF,19,82,14,15,29
59,8474189,Lars Eller,C,PIT,35,82,12,17,29
59,8480748,Kiefer Sherwood,L,VAN,29,82,11,18,29
59,8480806,Isac Lundestrom,C,ANA,25,82,10,19,29
59,8478413,Jordan Greenway,L,BUF,27,82,8,21,29
59,8476931,Jake McCabe,D,TOR,31,82,7,22,29
59,8480871,Adam Boqvist,D,FLA,24,82,6,23,29
59,8475462,Radko Gudas,D,ANA,34,82,5,24,29
59,8482079,Marco Rossi,C,MIN,23,82,17,11,28
59,8476873,Mark Jankowski,C,NSH,30,82,12,16,28
59,8483493,Frank Nazar,C,CHI,20,82,12,16,28
59,8482679,Matt Coronato,R,CGY,22,82,12,16,28
59,8481481,Blake Lizotte,C,PIT,27,82,11,17,28
59,8478882,Vladislav Gavrikov,D,LAK,29,82,7,21,28
59,8476892,Colton Parayko,D,STL,31,82,7,21,28
59,8477499,Rasmus Ristolainen,D,PHI,30,82,5,23,28
59,8481606,Jordan Spence,D,LAK,23,82,4,24,28
59,8477435,Ryan Graves,D,PIT,29,82,3,25,28
59,8475181,Nick Leddy,D,STL,33,82,1,27,28
59,8481535,Nils Hoglander,L,VAN,24,82,14,13,27
59,8479661,Tanner Jeannot,L,LAK,27,82,13,14,27
59,8480025,MacKenzie Entwistle,R,FLA,25,82,12,15,27
59,8482624,Daniil Miromanov,D,CGY,27,82,11,16,27
59,8477919,Frederick Gaudreau,C,MIN,31,82,10,17,27
59,8473422,Nick Foligno,L,CHI,37,82,8,19,27
59,8478013,Jake Walman,D,SJS,28,82,8,19,27
59,8483457,Lane Hutson,D,MTL,20,82,7,20,27
59,8476979,Erik Gustafsson,D,DET,32,82,4,23,27
59,8481568,Alex Vlasic,D,CHI,23,82,4,23,27
59,8478851,Alexandre Carrier,D,NSH,28,82,3,24,27
59,8475188,Brayden McNabb,D,VGK,33,82,3,24,27
59,8470600,Ryan Suter,D,STL,39,82,2,25,27
59,8478500,Ivan Provorov,D,CBJ,27,82,1,26,27
59,8477903,Garnet Hathaway,R,PHI,33,82,15,11,26
59,8476278,Colin Blackwell,C,DAL,31,82,15,11,26
59,8482133,Thomas Bordeleau,C,SJS,22,82,14,12,26
59,8480995,Pontus Holmberg,R,TOR,25,82,14,12,26
59,8478569,Noel Acciari,C,PIT,33,82,13,13,26
59,8482074,Connor Zary,C,CGY,23,82,13,13,26
59,8479316,Luke Kunin,C,SJS,27,82,13,13,26
59,8479591,Michael Eyssimont,C,TBL,28,82,11,15,26
59,8484153,Leo Carlsson,C,ANA,20,82,11,15,26
59,8481553,Bobby Brink,R,PHI,23,82,10,16,26
59,8484203,Bradly Nadeau,L,CAR,19,82,7,19,26
59,8482245,Artem Zub,D,OTT,29,82,7,19,26
59,8482122,Brock Faber,D,MIN,22,82,7,19,26
59,8478911,Matt Roy,D,WSH,29,82,6,20,26
59,8483565,Nick Blankenburg,D,NSH,26,82,5,21,26
59,8476891,Matt Grzelcyk,D,PIT,30,82,2,24,26
59,8478443,Brandon Carlo,D,BOS,28,82,2,24,26
59,8479941,Justin Danforth,R,CBJ,31,82,15,10,25
59,8475220,Marcus Foligno,L,MIN,33,82,13,12,25
59,8480813,Joe Veleno,C,DET,24,82,12,13,25
59,8482062,Cole Smith,L,NSH,29,82,12,13,25
59,8480021,Jack Studnicka,C,LAK,25,82,12,13,25
59,8479393,Noah Gregor,C,OTT,26,82,11,14,25
59,8481604,Pavel Dorofeyev,L,VGK,24,82,11,14,25
59,8480144,David Kampf,C,TOR,29,82,10,15,25
59,8476374,Sean Kuraly,C,CBJ,31,82,10,15,25
59,8477015,Connor Brown,R,EDM,30,82,10,15,25
59,8479351,Sam Steel,C,DAL,26,82,8,17,25
59,8479998,Mikey Anderson,D,LAK,25,82,5,20,25
59,8478133,Jake Evans,C,MTL,28,82,5,20,25
59,8475171,Oliver Ekman-Larsson,D,TOR,33,82,4,21,25
59,8477839,Conor Sheary,L,TBL,32,82,10,14,24
59,8475200,Dmitry Orlov,D,CAR,33,82,9,15,24
59,8476624,Barclay Goodrow,C,SJS,31,82,9,15,24
59,8477353,Tyler Motte,C,DET,29,82,8,16,24
59,8477369,Carson Soucy,D,VAN,30,82,5,19,24
59,8480073,Erik Brannstrom,D,COL,25,82,4,20,24
59,8476967,Brett Kulak,D,EDM,30,82,3,21,24
59,8475790,Erik Gudbranson,D,CBJ,32,82,3,21,24
59,8479359,Beck Malenstyn,L,BUF,26,82,14,9,23
59,8478432,Christian Fischer,R,DET,27,82,13,10,23
59,8476878,Zemgus Girgensons,L,TBL,30,82,13,10,23
59,8476889,Radek Faksa,C,STL,30,82,10,13,23
59,8481601,Simon Holmstrom,R,NYI,23,82,10,13,23
59,8477508,Curtis Lazar,C,NJD,29,82,10,13,23
59,8482809,Jackson Blake,R,CAR,21,82,7,16,23
59,8482087,Kaiden Guhle,D,MTL,22,82,7,16,23
59,8475279,Ben Chiarot,D,DET,33,82,6,17,23
59,8480860,Kevin Bahl,D,CGY,24,82,5,18,23
59,8480222,Sebastian Aho,D,PIT,28,82,4,19,23
59,8479324,Ryan Lindgren,D,NYR,26,82,4,19,23
59,8479371,Dante Fabbro,D,NSH,26,82,2,21,23
59,8477845,Trevor van Riemsdyk,D,WSH,33,82,2,21,23
59,8478399,Jonas Siegenthaler,D,NJD,27,82,2,21,23
59,8473453,Trevor Lewis,C,LAK,37,82,11,11,22
59,8479414,Nathan Bastian,R,NJD,27,82,10,12,22
59,8480855,Jack McBain,C,UTA,24,82,9,13,22
59,8483445,Cutter Gauthier,L,ANA,20,82,9,13,22
59,8477406,Mattias Janmark,C,EDM,32,82,9,13,22
59,8484911,Collin Graf,R,SJS,22,82,8,14,22
59,8483505,Matthew Poitras,C,BOS,20,82,8,14,22
59,8482713,Mackie Samoskevich,R,FLA,22,82,8,14,22
59,8483524,Shane Wright,C,SEA,20,82,7,15,22
59,8476917,Adam Pelech,D,NYI,30,82,5,17,22
59,8478507,John Marino,D,UTA,27,82,5,17,22
59,8476463,Jonas Brodin,D,MIN,31,82,3,19,22
59,8479980,Nicolas Hague,D,VGK,26,82,2,20,22
59,8481028,Martin Pospisil,C,CGY,25,82,10,11,21
59,8478508,Yakov Trenin,C,MIN,27,82,10,11,21
59,8476897,Oskar Sundqvist,C,STL,30,82,9,12,21
59,8482141,Lukas Cormier,D,VGK,22,82,9,12,21
59,8480789,Oliver Wahlstrom,R,NYI,24,82,9,12,21
59,8478211,Dryden Hunt,L,CGY,29,82,8,13,21
59,8482803,Olen Zellweger,D,ANA,21,82,8,13,21
59,8475231,Casey Cizikas,C,NYI,33,82,7,14,21
59,8482125,Alexander Holtz,R,VGK,22,82,6,15,21
59,8477365,Connor Clifton,D,BUF,29,82,5,16,21
59,8477220,Nate Schmidt,D,FLA,33,82,5,16,21
59,8476331,Dylan DeMelo,D,WPG,31,82,5,16,21
59,8478859,Niko Mikkola,D,FLA,28,82,4,17,21
59,8482142,Jamie Drysdale,D,PHI,22,82,3,18,21
59,8474013,Ian Cole,D,UTA,35,82,3,18,21
59,8482077,Dylan Holloway,L,EDM,23,82,14,6,20
59,8482153,Brendan Brisson,C,VGK,23,82,13,7,20
59,8483397,Marc McLaughlin,C,BOS,25,82,12,8,20
59,8477392,Hudson Fasching,R,NYI,29,82,11,9,20
59,8481517,Brett Leason,R,ANA,25,82,10,10,20
59,8481554,Kaapo Kakko,R,NYR,23,82,8,12,20
59,8480980,Connor Dewar,C,TOR,25,82,8,12,20
59,8476525,Colin Miller,D,WPG,32,82,5,15,20
59,8480834,Ty Emberson,D,SJS,24,82,5,15,20
59,8476422,Mike Reilly,D,NYI,31,82,3,17,20
59,8479398,Samuel Girard,D,COL,26,82,2,18,20
59,8474574,Tyler Myers,D,VAN,34,82,2,18,20
59,8478136,Jake Middleton,D,MIN,28,82,1,19,20
59,8480049,Dylan Samberg,D,WPG,25,82,1,19,20
59,8480035,Henri Jokiharju,D,BUF,25,82,0,20,20
59,8478020,Michael Amadio,C,OTT,28,82,11,8,19
59,8482259,Bobby McMann,C,TOR,28,82,11,8,19
59,8475842,Sam Carrick,C,NYR,32,82,11,8,19
59,8477931,Tomas Nosek,L,FLA,32,82,8,11,19
59,8482762,Simon Edvinsson,D,DET,21,82,8,11,19
59,8483490,Pavel Mintyukov,D,ANA,21,82,6,13,19
59,8479983,Mario Ferraro,D,SJS,26,82,5,14,19
59,8480950,Ilya Lyubushkin,D,DAL,30,82,3,16,19
59,8481178,Egor Zamula,D,PHI,24,82,2,17,19
59,8480990,Declan Chisholm,D,MIN,24,82,2,17,19
59,8483468,Jiri Kulich,C,BUF,20,82,7,11,18
59,8481524,Bowen Byram,D,BUF,23,82,7,11,18
59,8481708,Zac Jones,D,NYR,24,82,6,12,18
59,8482733,Logan Mailloux,D,MTL,31,82,5,13,18
59,8475233,David Savard,D,MTL,34,82,4,14,18
59,8481122,Simon Benoit,D,TOR,26,82,4,14,18
59,8479442,Troy Stecher,D,EDM,30,82,3,15,18
59,8480246,Nick Perbix,D,TBL,26,82,0,18,18
59,8479638,Justin Brazeau,R,BOS,26,82,9,8,17
59,8482807,Ethan Del Mastro,D,CHI,21,82,8,9,17
59,8482858,Ryker Evans,D,SEA,23,82,7,10,17
59,8480448,Parker Kelly,L,COL,25,82,6,11,17
59,8479291,Kevin Rooney,C,CGY,31,82,6,11,17
59,8478434,Keegan Kolesar,R,VGK,27,82,5,12,17
59,8483763,Maksymilian Szuber,D,UTA,22,82,5,12,17
59,8480172,Jan Rutta,D,SJS,34,82,5,12,17
59,8476879,Cody Ceci,D,EDM,31,82,3,14,17
59,8478416,Erik Cernak,D,TBL,27,82,3,14,17
59,8479369,Andrew Peeke,D,BOS,26,82,2,15,17
59,8476858,Phillip Di Giuseppe,L,VAN,31,82,14,2,16
59,8482659,Josh Doan,R,UTA,22,82,7,9,16
59,8476442,Matt Nieto,L,PIT,32,82,7,9,16
59,8484149,Gavin Brindley,C,CBJ,20,82,7,9,16
59,8483012,Logan Morrison,C,SEA,22,82,7,9,16
59,8477506,Ryan Pulock,D,NYI,30,82,6,10,16
59,8476467,Jamie Oleksiak,D,SEA,32,82,5,11,16
59,8475177,Calvin de Haan,D,COL,33,82,5,11,16
59,8477938,Haydn Fleury,D,WPG,28,82,5,11,16
59,8483466,Kevin Korchinski,D,CHI,20,82,5,11,16
59,8476441,Joel Edmundson,D,LAK,31,82,4,12,16
59,8475690,Chris Tanev,D,TOR,35,82,3,13,16
59,8476372,Nick Seeler,D,PHI,31,82,3,13,16
59,8480879,Jacob Bernard-Docker,D,OTT,24,82,3,13,16
59,8482749,Joshua Roy,R,MTL,21,82,5,10,15
59,8482145,Mavrik Bourque,C,DAL,22,82,5,10,15
59,8482470,Ilya Solovyov,D,CGY,24,82,4,11,15
59,8482073,Braden Schneider,D,NYR,23,82,3,12,15
59,8474090,Brendan Smith,D,DAL,35,82,3,12,15
59,8479576,Vincent Desharnais,D,VAN,28,82,2,13,15
59,8476457,Adam Larsson,D,SEA,32,82,0,15,15
59,8483471,Brad Lambert,C,WPG,31,82,10,4,14
59,8481641,Joel Kiviranta,L,COL,28,82,9,5,14
59,8474612,Travis Hamonic,D,OTT,34,82,5,9,14
59,8478178,Darren Raddysh,D,TBL,28,82,3,11,14
59,8483495,Simon Nemec,D,NJD,20,82,3,11,14
59,8477034,Jaycob Megna,D,FLA,32,82,5,8,13
59,8483499,Liam Ohgren,L,MIN,20,82,5,8,13
59,8474567,Zach Bogosian,D,MIN,34,82,5,8,13
59,8482155,Alex Laferriere,R,LAK,23,82,4,9,13
59,8476429,Scott Mayfield,D,NYI,32,82,3,10,13
59,8481699,Aku Raty,R,UTA,23,82,3,10,13
59,8475455,Brenden Dillon,D,NJD,34,82,2,11,13
59,8481014,Alexander Romanov,D,NYI,24,82,1,12,13
59,8480870,Bo Groulx,C,NYR,24,82,6,6,12
59,8477505,Alexander Wennberg,C,SJS,30,82,6,6,12
59,8482666,Scott Morrow,D,CAR,22,82,5,7,12
59,8482101,Danil Gushchin,L,SJS,22,82,5,7,12
59,8481605,Jackson LaCombe,D,ANA,23,82,3,9,12
59,8475718,Justin Holl,D,DET,32,82,3,9,12
59,8483460,David Jiricek,D,CBJ,21,82,2,10,12
59,8480807,Mattias Samuelsson,D,BUF,24,82,2,10,12
59,8475762,Derek Forbort,D,VAN,32,82,2,10,12
59,8471677,Jack Johnson,D,CBJ,37,82,2,10,12
59,8476473,Connor Murphy,D,CHI,31,82,2,10,12
59,8478468,Jeremy Lauzon,D,NSH,27,82,2,10,12
59,8481567,Henry Thrun,D,SJS,23,82,1,11,12
59,8483567,Georgii Merkulov,C,BOS,24,82,7,4,11
59,8483482,Tristan Luneau,D,ANA,20,82,2,9,11
59,8482516,Matthew Kessel,D,STL,24,82,1,10,11
59,8477335,Kyle Burroughs,D,LAK,29,82,1,10,11
59,8482859,Zack Ostapchuk,C,OTT,21,82,5,5,10
59,8475324,Nick Jensen,D,OTT,34,82,3,7,10
59,8478874,Adam Gaudette,C,OTT,28,82,1,9,10
59,8482070,Mitchell Chaffee,R,TBL,26,82,7,2,9
59,8476822,Luke Glendening,C,TBL,35,82,4,5,9
59,8478450,Parker Wotherspoon,D,BOS,27,82,2,7,9
59,8483489,Fraser Minten,C,TOR,31,82,4,4,8
59,8482712,Oskar Olausson,R,COL,22,82,2,6,8
59,8482787,Nikita Chibrikov,R,WPG,31,82,1,7,8
59,8482118,Sam Colangelo,R,ANA,23,82,2,4,6
59,8474062,Riley Nash,C,NYR,35,82,1,4,5
59,8470794,Joe Pavelski,C,,40,0,0,0,0
59,8481703,Valtteri Puustinen,R,PIT,25,0,0,0,0
59,8477950,Tony DeAngelo,D,,29,0,0,0,0
59,8481577,Philip Tomasino,C,NSH,23,0,0,0,0
59,8475197,Tyson Barrie,D,,33,0,0,0,0
59,8471218,Blake Wheeler,R,,38,0,0,0,0
59,8474157,Max Pacioretty,L,,36,0,0,0,0
59,8478466,Daniel Sprong,R,VAN,27,0,0,0,0
59,8475744,Evgeny Kuznetsov,C,,32,0,0,0,0
59,8481019,David Gustafsson,C,WPG,24,0,0,0,0
59,8475906,John Klingberg,D,,32,0,0,0,0
59,8479348,Kale Clague,D,BUF,26,0,0,0,0
59,8476952,Dominic Toninato,C,WPG,30,0,0,0,0
59,8473473,Milan Lucic,L,,36,0,0,0,0
59,8474037,James van Riemsdyk,L,,35,0,0,0,0
59,8474602,Justin Schultz,D,,34,0,0,0,0
59,8482222,Alexander Barabanov,L,,30,0,0,0,0
59,8479372,Josh Mahura,D,SEA,26,0,0,0,0
59,8479982,Conor Timmins,D,TOR,26,0,0,0,0
59,8474031,Kevin Shattenkirk,D,,35,0,0,0,0
59,8480008,Adam Ruzicka,C,,25,0,0,0,0
59,8481059,Scott Perunovich,D,STL,26,0,0,0,0
59,8480884,Calen Addison,D,,24,0,0,0,0
59,8476994,Vinnie Hinostroza,C,NSH,30,0,0,0,0
59,8478452,Caleb Jones,D,LAK,27,0,0,0,0
59,8480157,Calle Rosen,D,COL,30,0,0,0,0
59,8481609,Vladislav Kolyachonok,D,UTA,23,0,0,0,0
59,8479415,Michael McLeod,C,,26,0,0,0,0
59,8476919,Chris Tierney,C,,30,0,0,0,0
59,8479639,Dylan Coghlan,D,WPG,26,0,0,0,0
59,8478146,Matthew Highmore,C,OTT,28,0,0,0,0
59,8478970,Jalen Chatfield,D,CAR,28,0,0,0,0
59,8480205,Emil Bemstrom,C,PIT,25,0,0,0,0
59,8474884,Mike Hoffman,C,,35,0,0,0,0
59,8471274,Alex Goligoski,D,,39,0,0,0,0
59,8478104,Sammy Blais,L,,28,0,0,0,0
59,8474870,Tyler Johnson,C,,34,0,0,0,0
59,8476913,Devin Shore,C,MIN,30,0,0,0,0
59,8481598,Philip Broberg,D,EDM,23,0,0,0,0
59,8480058,Pierre-Olivier Joseph,D,STL,25,0,0,0,0
59,8480891,Michael Kesselring,D,UTA,24,0,0,0,0
59,8477979,Nicolas Aube-Kubel,R,BUF,28,0,0,0,0
59,8476871,Tanner Pearson,L,,32,0,0,0,0
59,8476393,Nick Cousins,C,,31,0,0,0,0
59,8479977,Kailer Yamamoto,R,,26,0,0,0,0
59,8479543,Michael Pezzetta,L,MTL,26,0,0,0,0
59,8477018,Ben Hutton,D,VGK,31,0,0,0,0
59,8480762,Eric Robinson,L,CAR,29,0,0,0,0
59,8474034,Pat Maroon,L,CHI,36,0,0,0,0
59,8481058,Jesse Ylönen,R,,25,0,0,0,0
59,8475179,Dmitry Kulikov,D,FLA,34,0,0,0,0
59,8481527,Kaedan Korczak,D,VGK,23,0,0,0,0
59,8473449,Kyle Okposo,R,,36,0,0,0,0
59,8482192,Isaak Phillips,D,CHI,23,0,0,0,0
59,8480727,Zach Whitecloud,D,VGK,28,0,0,0,0
59,8479346,Dillon Dube,C,,26,0,0,0,0
59,8480821,Filip Zadina,R,,25,0,0,0,0
59,8480001,Urho Vaakanainen,D,ANA,25,0,0,0,0
59,8470966,Mark Giordano,D,,41,0,0,0,0
59,8480853,Liam Foudy,C,,24,0,0,0,0
59,8475225,Craig Smith,C,CHI,35,0,0,0,0
59,8479972,Mason Shaw,C,WPG,26,0,0,0,0
59,8478451,Ethan Bear,D,WSH,27,0,0,0,0
59,8474040,Sam Gagner,C,,35,0,0,0,0
59,8480196,Jacob Bryson,D,BUF,27,0,0,0,0
59,8479984,Cal Foote,D,,26,0,0,0,0
59,8480011,Klim Kostin,C,SJS,25,0,0,0,0
59,8482176,Wyatt Kaiser,D,CHI,22,0,0,0,0
59,8476988,Matt Benning,D,SJS,30,0,0,0,0
59,8479370,Tyson Jost,C,CAR,26,0,0,0,0
59,8477464,Nic Petan,C,,29,0,0,0,0
59,8477380,Jonny Brodzinski,C,NYR,31,0,0,0,0
59,8480070,Ian Mitchell,D,BOS,25,0,0,0,0
59,8479315,Joey Anderson,R,CHI,26,0,0,0,0
59,8478099,Kevin Labanc,R,,29,0,0,0,0
59,8476874,Olli Maatta,D,DET,30,0,0,0,0
59,8475208,Brian Dumoulin,D,ANA,33,0,0,0,0
59,8478430,Oliver Kylington,D,,27,0,0,0,0
59,8479536,Axel Jonsson-Fjallby,L,WPG,26,0,0,0,0
59,8479671,Mathieu Olivier,R,CBJ,27,0,0,0,0
59,8471709,Marc-Edouard Vlasic,D,SJS,37,0,0,0,0
59,8479328,Julien Gauthier,R,NYI,27,0,0,0,0
59,8478421,A.J. Greer,L,FLA,28,0,0,0,0
59,8477573,Nathan Walker,L,STL,30,0,0,0,0
59,8481537,Nikita Okhotiuk,D,CGY,24,0,0,0,0
59,8474166,Alec Martinez,D,CHI,37,0,0,0,0
59,8470610,Zach Parise,L,,40,0,0,0,0
59,8477478,William Carrier,L,CAR,30,0,0,0,0
59,8479344,Jesse Puljujarvi,R,PIT,26,0,0,0,0
59,8480887,Jordan Harris,D,MTL,24,0,0,0,0
59,8478502,Dennis Gilbert,D,BUF,28,0,0,0,0
59,8482730,Brandt Clarke,D,LAK,21,0,0,0,0
59,8480355,Mark Kastelic,C,BOS,25,0,0,0,0
59,8475750,Jon Merrill,D,MIN,32,0,0,0,0
59,8475164,Jakob Silfverberg,R,,34,0,0,0,0
59,8477944,Jakub Vrana,L,,28,0,0,0,0
59,8479439,Jacob MacDonald,D,COL,31,0,0,0,0
59,8474568,Luke Schenn,D,NSH,35,0,0,0,0
59,8478454,Noah Juulsen,D,VAN,27,0,0,0,0
59,8475752,Tyler Pitlick,C,,33,0,0,0,0
59,8482148,Hendrix Lapierre,C,WSH,22,0,0,0,0
59,8481167,Brayden Pachal,D,CGY,25,0,0,0,0
59,8478043,Sam Lafferty,C,BUF,29,0,0,0,0
59,8479321,Lucas Johansen,D,,27,0,0,0,0
59,8471699,Andrew Cogliano,C,,37,0,0,0,0
59,8481521,Ronnie Attard,D,PHI,25,0,0,0,0
59,8481161,Jake Christiansen,D,CBJ,25,0,0,0,0
59,8479458,Nikita Zaitsev,D,,33,0,0,0,0
59,8479619,Michael Carcone,L,UTA,28,0,0,0,0
59,8479026,Philippe Myers,D,TOR,27,0,0,0,0
59,8477330,Dominik Kubalik,L,,29,0,0,0,0
59,8481617,Vasily Podkolzin,R,VAN,23,0,0,0,0
59,8481701,Santeri Hatakka,D,NJD,23,0,0,0,0
59,8479514,Rem Pitlick,C,,27,0,0,0,0
59,8477446,Michael McCarron,R,NSH,29,0,0,0,0
59,8470604,Jeff Carter,C,,39,0,0,0,0
59,8482241,Radim Zohorna,L,,28,0,0,0,0
59,8480289,Morgan Barron,C,WPG,26,0,0,0,0
59,8479379,Givani Smith,R,SJS,26,0,0,0,0
59,8480216,Jacob Peterson,C,,25,0,0,0,0
59,8477851,Jordan Oesterle,D,BOS,32,0,0,0,0
59,8484258,Sam Malinski,D,COL,26,0,0,0,0
59,8478904,Steven Lorentz,C,,28,0,0,0,0
59,8482095,Tyler Kleven,D,OTT,22,0,0,0,0
59,8480848,Ty Dellandrea,C,SJS,24,0,0,0,0
59,8476884,Derrick Pouliot,D,,30,0,0,0,0
59,8479336,Carl Grundstrom,R,SJS,27,0,0,0,0
59,8482964,Arber Xhekaj,D,MTL,23,0,0,0,0
59,8471686,Marc Staal,D,,37,0,0,0,0
59,8477887,Patrick Brown,C,BOS,32,0,0,0,0
59,8478495,Denis Gurianov,R,,27,0,0,0,0
59,8473504,Cal Clutterbuck,R,,37,0,0,0,0
59,8481550,Adam Beckman,L,NJD,23,0,0,0,0
59,8480845,Rasmus Kupari,C,WPG,24,0,0,0,0
59,8474009,Nick Bonino,C,,36,0,0,0,0
59,8478585,Derek Ryan,C,EDM,38,0,0,0,0
59,8477962,Brendan Lemieux,L,CAR,28,0,0,0,0
59,8482861,Vincent Iorio,D,WSH,22,0,0,0,0
59,8479378,Logan Stanley,D,WPG,26,0,0,0,0
59,8473446,Erik Johnson,D,PHI,36,0,0,0,0
59,8481743,Marc Del Gaizo,D,NSH,25,0,0,0,0
59,8477384,Josh Brown,D,EDM,30,0,0,0,0
59,8482165,Yan Kuznetsov,D,CGY,22,0,0,0,0
59,8478424,Jansen Harkins,C,ANA,27,0,0,0,0
59,8482144,Jack Thompson,D,SJS,22,0,0,0,0
59,8478512,Austin Czarnik,C,,32,0,0,0,0
59,8477527,Ross Johnston,L,ANA,30,0,0,0,0
59,8479383,Boris Katchouk,L,,26,0,0,0,0
59,8482094,Daemon Hunt,D,MIN,22,0,0,0,0
59,8481719,Maxwell Crozier,D,TBL,24,0,0,0,0
59,8480192,Johnathan Kovacevic,D,NJD,27,0,0,0,0
59,8479376,Victor Mete,D,,26,0,0,0,0
59,8482511,Mason Lohrei,D,BOS,23,0,0,0,0
59,8475825,Jani Hakanpää,D,,32,0,0,0,0
59,8478021,William Lagesson,D,DET,28,0,0,0,0
59,8475795,Dylan McIlrath,D,WSH,32,0,0,0,0
59,8477846,Ryan Carpenter,C,,33,0,0,0,0
59,8481056,Spencer Stastney,D,NSH,24,0,0,0,0
59,8481564,Ryan Johnson,D,BUF,23,0,0,0,0
59,8478017,Mark Friedman,D,VAN,29,0,0,0,0
59,8479320,Max Lajoie,D,SEA,27,0,0,0,0
59,8480075,Cameron Crotty,D,MIN,25,0,0,0,0
59,8484287,Cole McWard,D,VAN,23,0,0,0,0
59,8484254,Akito Hirose,D,VAN,25,0,0,0,0
59,8483407,Brandon Scanlin,D,NYR,25,0,0,0,0
59,8480274,Philip Kemp,D,EDM,25,0,0,0,0
59,8479522,Hardy Haman Aktell,D,WSH,26,0,0,0,0
59,8480007,Jonas Rondbjerg,R,VGK,25,0,0,0,0
59,8477454,Adam Erne,L,,29,0,0,0,0
59,8481679,Maxence Guenette,D,OTT,23,0,0,0,0
59,8480441,Trey Fix-Wolansky,R,CBJ,25,0,0,0,0
59,8483546,Marshall Rifai,D,TOR,26,0,0,0,0
59,8480084,Nick DeSimone,D,NJD,30,0,0,0,0
59,8481030,Jack St. Ivany,D,PIT,25,0,0,0,0
59,8481592,Jakob Pelletier,L,CGY,23,0,0,0,0
59,8478011,Louie Belpedio,D,PHI,28,0,0,0,0
59,8477930,Pierre-Edouard Bellemare,L,,39,0,0,0,0
59,8484321,Nikolas Matinpalo,D,OTT,26,0,0,0,0
59,8482067,Connor Mackey,D,NYR,28,0,0,0,0
59,8481806,Louis Crevier,D,CHI,23,0,0,0,0
59,8484326,Patrik Koch,D,UTA,28,0,0,0,0
59,8477971,Andreas Englund,D,LAK,28,0,0,0,0
59,8481751,Lukas Rousek,R,BUF,25,0,0,0,0
59,8481006,Tyler Tucker,D,STL,24,0,0,0,0
59,8476867,Brendan Gaunce,C,MIN,30,0,0,0,0
59,8479520,Brandon Duhaime,R,WSH,27,0,0,0,0
59,8477073,Kurtis MacDermid,L,NJD,30,0,0,0,0
59,8480874,Adam Ginning,D,PHI,24,0,0,0,0
59,8477473,Justin Bailey,R,SJS,29,0,0,0,0
59,8479066,Ryan Lomberg,L,CGY,30,0,0,0,0
59,8477070,Liam O'Brien,C,UTA,30,0,0,0,0
59,8474618,Marco Scandella,D,,34,0,0,0,0
59,8475797,Jarred Tinordi,D,,32,0,0,0,0
59,8481441,Joe Snively,C,DET,28,0,0,0,0
59,8477244,Chad Ruhwedel,D,NYR,34,0,0,0,0
59,8479772,Zack MacEwen,R,OTT,28,0,0,0,0
59,8481147,Reese Johnson,C,MIN,26,0,0,0,0
59,8481043,Cole Koepke,L,BOS,26,0,0,0,0
59,8483619,Filip Roos,D,OTT,25,0,0,0,0
59,8481541,Samuel Bolduc,D,NYI,24,0,0,0,0
59,8477810,Joel Hanley,D,CGY,33,0,0,0,0
59,8476907,Mackenzie MacEachern,L,,30,0,0,0,0
59,8482652,Walker Duehr,R,CGY,27,0,0,0,0
59,8477126,Jayson Megna,C,,34,0,0,0,0
59,8483398,Declan Carlile,D,TBL,31,0,0,0,0
59,8482929,Emil Lilleberg,D,TBL,23,0,0,0,0
59,8480880,Jakub Lauko,C,MIN,24,0,0,0,0
59,8480245,Olle Lycksell,R,PHI,25,0,0,0,0
59,8480252,Cole Guttman,C,CHI,25,0,0,0,0
59,8477467,Gustav Olofsson,D,SEA,30,0,0,0,0
59,8479968,Vinni Lettieri,C,BOS,29,0,0,0,0
59,8478400,Colin White,C,,27,0,0,0,0
59,8475755,Alexander Petrovic,D,DAL,32,0,0,0,0
59,8481812,Nikolai Knyzhov,D,,27,0,0,0,0
59,8481593,Jayden Struble,D,MTL,23,0,0,0,0
59,8481532,Alex Turcotte,C,LAK,23,0,0,0,0
59,8482126,Emil Andrae,D,PHI,31,0,0,0,0
59,8479944,Zach Aston-Reese,C,VGK,30,0,0,0,0
59,8471817,Ryan Reaves,R,TOR,37,0,0,0,0
59,8481206,John Ludvig,D,PIT,24,0,0,0,0
59,8481599,Victor Soderstrom,D,UTA,23,0,0,0,0
59,8480292,Carson Meyer,R,ANA,27,0,0,0,0
59,8482496,Nils Aman,C,VAN,24,0,0,0,0
59,8479718,Alex Barré-Boulet,C,MTL,27,0,0,0,0
59,8479994,Jaret Anderson-Dolan,C,WPG,25,0,0,0,0
59,8480184,Gustav Lindstrom,D,,26,0,0,0,0
59,8480890,Jan Jenik,R,OTT,24,0,0,0,0
59,8478067,Oskar Lindblom,L,,28,0,0,0,0
59,8476934,Brock McGinn,L,ANA,30,0,0,0,0
59,8479985,Cale Fleury,D,SEA,26,0,0,0,0
59,8484304,Uvis Balinskis,D,FLA,28,0,0,0,0
59,8479981,Jonah Gadjovich,L,FLA,26,0,0,0,0
59,8481716,Dmitri Voronkov,L,CBJ,24,0,0,0,0
59,8474709,Matt Martin,L,,35,0,0,0,0
59,8482634,Alex Steeves,C,TOR,25,0,0,0,0
59,8480823,Alexander Alexeyev,D,WSH,25,0,0,0,0
59,8477541,Dakota Mermis,D,TOR,30,0,0,0,0
59,8483491,Ivan Miroshnichenko,L,WSH,20,0,0,0,0
59,8478477,Mitchell Stephens,C,SEA,27,0,0,0,0
59,8481543,Nikita Alexandrov,C,STL,24,0,0,0,0
59,8479423,Alex Nylander,L,,26,0,0,0,0
59,8482451,Mikael Pyyhtia,L,CBJ,23,0,0,0,0
59,8478831,Kevin Stenlund,C,UTA,28,0,0,0,0
59,8480306,Grant Hutton,D,NYI,29,0,0,0,0
59,8478028,Fredrik Olofsson,L,,28,0,0,0,0
59,8477462,Robert Hagg,D,VGK,29,0,0,0,0
59,8477320,Anton Blidh,L,NYR,29,0,0,0,0
59,8482157,Will Cuylle,L,NYR,22,0,0,0,0
59,8482737,Zack Bolduc,C,STL,21,0,0,0,0
59,8481239,Samuel Fagemo,L,,24,0,0,0,0
59,8481600,Tobias Bjornfot,D,FLA,23,0,0,0,0
59,8478409,Anthony Richard,C,PHI,28,0,0,0,0
59,8474145,Robert Bortuzzo,D,,35,0,0,0,0
59,8475958,Michael Sgarbossa,C,WSH,32,0,0,0,0
59,8479986,Kole Lind,R,DAL,26,0,0,0,0
59,8479249,Andrew Poturalski,C,SJS,30,0,0,0,0
59,8479362,Riley Tufte,L,BOS,26,0,0,0,0
59,8479991,Jake Leschyshyn,C,NYR,25,0,0,0,0
59,8479587,Rhett Gardner,C,PHI,28,0,0,0,0
59,8482744,James Malatesta,L,CBJ,21,0,0,0,0
59,8478854,Ryan Shea,D,PIT,27,0,0,0,0
59,8481591,Sam Poulin,R,,23,0,0,0,0
59,8483512,Matt Savoie,C,EDM,20,0,0,0,0
59,8482102,Vasily Ponomarev,C,PIT,22,0,0,0,0
59,8482162,Roby Jarventie,L,EDM,22,0,0,0,0
59,8481016,Ruslan Iskhakov,C,,24,0,0,0,0
59,8482172,Landon Slaggert,L,CHI,22,0,0,0,0
59,8482747,Brennan Othmann,L,NYR,21,0,0,0,0
59,8480031,Maxime Comtois,L,,25,0,0,0,0
59,8480226,Marián Studenic,R,,26,0,0,0,0
59,8478408,Travis Dermott,D,,28,0,0,0,0
59,8481518,Nolan Foote,L,NJD,24,0,0,0,0
59,8479419,Brett Murray,L,BUF,26,0,0,0,0
59,8482088,Justin Sourdif,R,FLA,22,0,0,0,0
59,8482201,Gage Goncalves,C,TBL,23,0,0,0,0
59,8481578,Graeme Clarke,R,MIN,23,0,0,0,0
59,8482177,Marat Khusnutdinov,C,MIN,22,0,0,0,0
59,8481754,Nikita Nesterenko,C,ANA,23,0,0,0,0
59,8483531,Brian Halonen,L,NJD,25,0,0,0,0
59,8483920,Pierrick Dube,R,WSH,23,0,0,0,0
59,8480851,Akil Thomas,C,LAK,24,0,0,0,0
59,8475235,Nicolas Deslauriers,L,PHI,33,0,0,0,0
59,8482476,Emil Heineman,L,MTL,23,0,0,0,0
59,8477149,Scott Sabourin,R,SJS,32,0,0,0,0
59,8483549,Lucas Condotta,L,MTL,27,0,0,0,0
59,8482765,Isak Rosen,R,BUF,21,0,0,0,0
59,8481237,Kyle MacLean,C,NYI,25,0,0,0,0
59,8481024,Linus Karlsson,C,VAN,25,0,0,0,0
59,8481690,Tyler Angle,C,,24,0,0,0,0
59,8483570,Ben Meyers,C,SEA,26,0,0,0,0
59,8481655,Cole Schwindt,R,CGY,23,0,0,0,0
59,8481462,Mason Morelli,L,VGK,28,0,0,0,0
59,8483401,Marc Johnstone,R,PIT,28,0,0,0,0
59,8478956,Samuel Laberge,L,NJD,27,0,0,0,0
59,8479533,Joona Koppanen,L,,26,0,0,0,0
59,8482197,Adam Raska,R,MIN,23,0,0,0,0
59,8482250,Callahan Burke,C,VGK,27,0,0,0,0
59,8482784,Zach Dean,C,STL,21,0,0,0,0
59,8484255,Jason Polin,R,COL,25,0,0,0,0
59,8481077,John Leonard,L,,26,0,0,0,0
59,8481534,Raphael Lavoie,C,EDM,24,0,0,0,0
59,8483609,Adam Klapka,R,CGY,24,0,0,0,0
59,8482751,Ryan Winterton,C,SEA,21,0,0,0,0
59,8480267,Sammy Walker,C,MIN,25,0,0,0,0
59,8475766,Austin Watson,L,,32,0,0,0,0
59,8482460,Matt Rempe,C,NYR,22,0,0,0,0
59,8481065,Angus Crookshank,L,OTT,25,0,0,0,0
59,8481070,Hugh McGing,L,,26,0,0,0,0
59,8476323,Max McCormick,L,SEA,32,0,0,0,0
59,8483395,Arshdeep Bains,L,VAN,23,0,0,0,0
59,8484259,Ondrej Pavel,C,COL,31,0,0,0,0
59,8483432,Luca Del Bel Belluz,C,CBJ,31,0,0,0,0
59,8483045,Cameron Butler,R,CBJ,31,0,0,0,0
59,8482061,Brandon Biro,L,SEA,26,0,0,0,0
59,8477401,John Hayden,C,SEA,29,0,0,0,0
59,8475278,Byron Froese,C,,33,0,0,0,0
59,8478446,Glenn Gawdin,C,LAK,27,0,0,0,0
59,8477993,Justin Kirkland,C,CGY,28,0,0,0,0
59,8482147,Jean-Luc Foudy,C,COL,22,0,0,0,0
59,8480032,Shane Bowers,C,NJD,25,0,0,0,0
59,8479330,Brandon Gignac,C,MTL,27,0,0,0,0
59,8480776,Sheldon Rempal,R,,29,0,0,0,0
59,8475413,Justin Dowling,C,NJD,34,0,0,0,0
59,8481726,Adam Edstrom,C,NYR,24,0,0,0,0
59,8480844,Grigori Denisenko,L,VGK,24,0,0,0,0
59,8478147,Bokondji Imama,L,PIT,28,0,0,0,0
59,8478881,Brett Seney,L,CHI,28,0,0,0,0
59,8483630,Pavol Regenda,L,ANA,25,0,0,0,0
59,8480836,Jonathan Gruden,C,,24,0,0,0,0
59,8484314,Jiri Smejkal,L,,28,0,0,0,0
59,8475780,Chris Wagner,R,COL,33,0,0,0,0
59,8479546,Oskar Steen,C,,26,0,0,0,0
59,8483597,Milos Kelemen,L,UTA,25,0,0,0,0
59,8481789,Tye Kartye,L,SEA,23,0,0,0,0
59,8484325,Waltteri Merela,C,TBL,26,0,0,0,0
59,8479421,Jacob Moverare,D,LAK,26,0,0,0,0
59,8481585,Egor Afanasyev,L,SJS,23,0,0,0,0
59,8479547,Matthew Phillips,R,,26,0,0,0,0
59,8479367,William Lockwood,R,FLA,26,0,0,0,0
59,8476915,Jujhar Khaira,L,,30,0,0,0,0
59,8481422,Jacob Lucchini,C,NSH,29,0,0,0,0
59,8480468,James Hamblin,L,EDM,25,0,0,0,0
59,8478051,Max Willman,C,NJD,29,0,0,0,0
59,8481556,John Beecher,C,BOS,23,0,0,0,0
59,8478078,Rourke Chartier,C,,28,0,0,0,0
60,8477939,William Nylander,R,TOR,28,82,57,78,135
60,8478402,Connor McDavid,C,EDM,27,82,47,86,133
60,8481559,Jack Hughes,C,NJD,23,82,52,80,132
60,8479318,Auston Matthews,C,TOR,27,82,63,62,125
60,8476453,Nikita Kucherov,R,TBL,31,82,42,78,120
60,8477492,Nathan MacKinnon,C,COL,29,82,41,75,116
60,8478864,Kirill Kaprizov,L,MIN,27,82,51,63,114
60,8478420,Mikko Rantanen,R,COL,28,82,49,62,111
60,8476468,J.T. Miller,C,VAN,31,82,48,61,109
60,8480027,Jason Robertson,L,DAL,25,82,44,63,107
60,8477956,David Pastrnak,R,BOS,28,82,49,55,104
60,8478550,Artemi Panarin,L,NYR,33,82,35,69,104
60,8477934,Leon Draisaitl,C,EDM,29,82,35,67,102
60,8480801,Brady Tkachuk,L,OTT,25,82,47,54,101
60,8477942,Kevin Fiala,L,LAK,28,82,35,66,101
60,8480012,Elias Pettersson,C,VAN,26,82,30,71,101
60,8478449,Roope Hintz,C,DAL,28,82,50,49,99
60,8477402,Pavel Buchnevich,L,STL,29,82,38,60,98
60,8479343,Clayton Keller,R,UTA,26,82,42,55,97
60,8478403,Jack Eichel,C,VGK,28,82,42,55,97
60,8480069,Cale Makar,D,COL,26,82,28,69,97
60,8481557,Matt Boldy,L,MIN,23,82,37,59,96
60,8479420,Tage Thompson,C,BUF,27,82,47,48,95
60,8474564,Steven Stamkos,C,NSH,34,82,46,48,94
60,8479314,Matthew Tkachuk,L,FLA,27,82,37,57,94
60,8477501,Valeri Nichushkin,R,COL,29,82,39,53,92
60,8475166,John Tavares,C,TOR,34,82,35,57,92
60,8476454,Ryan Nugent-Hopkins,C,EDM,31,82,31,59,90
60,8474600,Roman Josi,D,NSH,34,82,20,70,90
60,8480800,Quinn Hughes,D,VAN,25,82,13,77,90
60,8477493,Aleksander Barkov,C,FLA,29,82,32,57,89
60,8482116,Tim Stützle,C,OTT,22,82,29,59,88
60,8478010,Brayden Point,C,TBL,28,82,44,43,87
60,8479407,Jesper Bratt,L,NJD,26,82,26,61,87
60,8478445,Mathew Barzal,C,NYI,27,82,25,62,87
60,8480023,Robert Thomas,C,STL,25,82,24,63,87
60,8471675,Sidney Crosby,C,PIT,37,82,38,47,85
60,8479385,Jordan Kyrou,C,STL,26,82,34,51,85
60,8475158,Ryan O'Reilly,C,NSH,33,82,34,51,85
60,8476887,Filip Forsberg,L,NSH,30,82,29,56,85
60,8475168,Matt Duchene,C,DAL,33,82,31,52,83
60,8478444,Brock Boeser,R,VAN,27,82,46,36,82
60,8478439,Travis Konecny,R,PHI,27,82,36,46,82
60,8480830,Andrei Svechnikov,R,CAR,24,82,35,47,82
60,8480036,Miro Heiskanen,D,DAL,25,82,14,68,82
60,8477960,Adrian Kempe,R,LAK,28,82,39,42,81
60,8477955,Jared McCann,L,SEA,28,82,37,44,81
60,8475172,Nazem Kadri,C,CGY,34,82,28,53,81
60,8475913,Mark Stone,R,VGK,32,82,27,54,81
60,8478398,Kyle Connor,L,WPG,28,82,38,42,80
60,8477946,Dylan Larkin,C,DET,28,82,30,50,80
60,8477949,Alex Tuch,R,BUF,28,82,24,56,80
60,8480002,Nico Hischier,C,NJD,25,82,37,42,79
60,8477404,Jake Guentzel,C,TBL,30,82,31,47,78
60,8476456,Jonathan Huberdeau,C,CGY,31,82,20,58,78
60,8478407,Vince Dunn,D,SEA,28,82,16,62,78
60,8471215,Evgeni Malkin,C,PIT,38,82,27,49,76
60,8479542,Brandon Hagel,L,TBL,26,82,33,42,75
60,8478427,Sebastian Aho,C,CAR,27,82,30,44,74
60,8477504,Josh Morrissey,D,WPG,29,82,19,55,74
60,8477933,Sam Reinhart,C,FLA,29,82,30,43,73
60,8476389,Vincent Trocheck,C,NYR,31,82,29,44,73
60,8471214,Alex Ovechkin,L,WSH,39,82,42,30,72
60,8477409,Carter Verhaeghe,C,FLA,29,82,36,36,72
60,8476539,Jonathan Marchessault,R,NSH,34,82,35,37,72
60,8475754,Brock Nelson,C,NYI,33,82,34,38,72
60,8475810,Bryan Rust,R,PIT,32,82,31,41,72
60,8482078,Lucas Raymond,L,DET,22,82,31,41,72
60,8473512,Claude Giroux,R,OTT,36,82,31,41,72
60,8480208,Drake Batherson,R,OTT,26,82,26,46,72
60,8478414,Timo Meier,R,NJD,28,82,40,31,71
60,8475768,Jaden Schwartz,C,SEA,32,82,29,42,71
60,8473419,Brad Marchand,L,BOS,36,82,22,49,71
60,8476346,Johnny Gaudreau,L,CBJ,31,82,19,52,71
60,8480803,Evan Bouchard,D,EDM,25,82,16,55,71
60,8477447,Shea Theodore,D,VGK,29,82,10,61,71
60,8477940,Nikolaj Ehlers,L,WPG,28,82,29,41,70
60,8474141,Patrick Kane,R,DET,36,82,29,41,70
60,8479675,Trevor Moore,L,LAK,29,82,28,42,70
60,8476462,Dougie Hamilton,D,NJD,31,82,27,43,70
60,8482740,Wyatt Johnston,C,DAL,21,82,27,43,70
60,8481528,Dylan Cozens,C,BUF,23,82,25,45,70
60,8475167,Victor Hedman,D,TBL,34,82,16,54,70
60,8475692,Mats Zuccarello,R,MIN,37,82,12,58,70
60,8481523,Kirby Dach,C,MTL,23,82,15,54,69
60,8477496,Elias Lindholm,C,BOS,30,82,40,28,68
60,8477500,Bo Horvat,C,NYI,29,82,32,36,68
60,8477494,Jonathan Drouin,L,COL,29,82,19,49,68
60,8480839,Rasmus Dahlin,D,BUF,24,82,15,53,68
60,8475184,Chris Kreider,L,NYR,33,82,35,32,67
60,8478493,Joel Eriksson Ek,C,MIN,27,82,33,34,67
60,8475170,Brayden Schenn,C,STL,33,82,33,34,67
60,8476905,Chandler Stephenson,C,SEA,30,82,28,39,67
60,8481068,Yegor Sharangovich,C,CGY,26,82,28,39,67
60,8479337,Alex DeBrincat,R,DET,27,82,24,43,67
60,8474679,Gustav Nyquist,C,NSH,35,82,18,49,67
60,8480865,Noah Dobson,D,NYI,24,82,16,51,67
60,8479323,Adam Fox,D,NYR,26,82,7,60,67
60,8481711,Matias Maccelli,L,UTA,24,82,21,45,66
60,8475798,Mikael Granlund,C,SJS,32,82,19,47,66
60,8482665,Matty Beniers,C,SEA,22,82,19,47,66
60,8480797,Joel Farabee,L,PHI,24,82,28,37,65
60,8478042,Viktor Arvidsson,R,EDM,31,82,25,40,65
60,8478440,Dylan Strome,C,WSH,27,82,21,44,65
60,8474590,John Carlson,D,WSH,34,82,13,52,65
60,8475799,Nino Niederreiter,R,WPG,32,82,37,27,64
60,8475726,Tyler Toffoli,C,SJS,32,82,32,32,64
60,8477444,Andre Burakovsky,L,SEA,29,82,21,43,64
60,8482093,Seth Jarvis,C,CAR,22,82,29,34,63
60,8480018,Nick Suzuki,C,MTL,25,82,18,45,63
60,8481581,Thomas Harley,D,DAL,23,82,15,48,63
60,8477416,Oliver Bjorkstrand,R,SEA,29,82,28,34,62
60,8476448,William Karlsson,C,VGK,31,82,24,38,62
60,8478401,Pavel Zacha,C,BOS,27,82,22,40,62
60,8474102,David Perron,L,OTT,36,82,24,37,61
60,8477476,Artturi Lehkonen,L,COL,29,82,29,31,60
60,8477407,Anthony Duclair,L,NYI,29,82,24,36,60
60,8476460,Mark Scheifele,C,WPG,31,82,23,37,60
60,8476459,Mika Zibanejad,C,NYR,31,82,22,38,60
60,8478397,Rasmus Andersson,D,CGY,28,82,12,48,60
60,8482110,Dawson Mercer,C,NJD,23,82,27,32,59
60,8478047,Michael Bunting,L,PIT,29,82,24,35,59
60,8474565,Alex Pietrangelo,D,VGK,34,82,18,41,59
60,8474578,Erik Karlsson,D,PIT,34,82,7,52,59
60,8476399,Blake Coleman,C,CGY,33,82,38,20,58
60,8477511,Anthony Mantha,R,CGY,30,82,33,25,58
60,8475714,Calle Jarnkrok,C,TOR,33,82,29,29,58
60,8478856,Conor Garland,R,VAN,28,82,25,33,58
60,8478975,Mason Marchment,L,DAL,29,82,23,35,58
60,8477951,Nick Schmaltz,C,UTA,28,82,23,35,58
60,8480028,Morgan Frost,C,PHI,25,82,21,37,58
60,8476853,Morgan Rielly,D,TOR,30,82,9,49,58
60,8480039,Martin Necas,C,CAR,25,82,32,25,57
60,8471685,Anze Kopitar,C,LAK,37,82,22,35,57
60,8477497,Sean Monahan,C,CBJ,30,82,20,37,57
60,8475794,Tyler Seguin,C,DAL,32,82,27,29,56
60,8478438,Tommy Novak,C,NSH,27,82,26,30,56
60,8481533,Trevor Zegras,C,ANA,23,82,22,34,56
60,8475784,Jeff Skinner,C,EDM,32,82,22,34,56
60,8476826,Yanni Gourde,C,SEA,33,82,22,34,56
60,8478498,Jake DeBrusk,L,VAN,28,82,21,35,56
60,8473994,Jamie Benn,L,DAL,35,82,21,35,56
60,8477503,Max Domi,C,TOR,29,82,17,39,56
60,8479999,Casey Mittelstadt,C,COL,26,82,14,42,56
60,8475786,Zach Hyman,L,EDM,32,82,31,24,55
60,8474586,Jordan Eberle,R,SEA,34,82,29,26,55
60,8480015,Owen Tippett,R,PHI,25,82,27,28,55
60,8482124,Quinton Byfield,R,LAK,22,82,23,32,55
60,8478469,Thomas Chabot,D,OTT,27,82,15,40,55
60,8482097,Jack Quinn,R,BUF,23,82,25,29,54
60,8477998,Warren Foegele,L,LAK,28,82,22,32,54
60,8479345,Jakob Chychrun,D,WSH,26,82,19,35,54
60,8478038,Devon Toews,D,COL,30,82,11,43,54
60,8479425,Filip Hronek,D,VAN,27,82,7,47,54
60,8476483,Rickard Rakell,R,PIT,31,82,31,22,53
60,8476881,Tomas Hertl,C,VGK,31,82,24,29,53
60,8479365,Trent Frederic,C,BOS,26,82,21,32,53
60,8482113,Anton Lundell,C,FLA,23,82,21,32,53
60,8478046,Danton Heinen,L,VAN,29,82,21,32,53
60,8478873,Troy Terry,R,ANA,27,82,20,33,53
60,8478366,Frank Vatrano,R,ANA,30,82,32,20,52
60,8479339,Patrik Laine,L,CBJ,26,82,24,28,52
60,8480064,Josh Norris,C,OTT,25,82,24,28,52
60,8479400,Pierre-Luc Dubois,L,WSH,26,82,21,31,52
60,8480802,Ryan McLeod,C,BUF,25,82,16,36,52
60,8474053,Logan Couture,C,SJS,35,82,14,38,52
60,8471724,Kris Letang,D,PIT,37,82,12,40,52
60,8479325,Charlie McAvoy,D,BOS,27,82,8,44,52
60,8475169,Evander Kane,L,EDM,33,82,25,26,51
60,8478233,Andrew Mangiapane,L,WSH,28,82,23,28,51
60,8477935,Sam Bennett,C,FLA,28,82,22,29,51
60,8475793,Ryan Johansen,C,PHI,32,82,21,30,51
60,8478458,Jack Roslovic,C,CAR,27,82,21,30,51
60,8480078,Filip Chytil,C,NYR,25,82,20,31,51
60,8481596,Shane Pinto,C,OTT,24,82,20,31,51
60,8470613,Brent Burns,D,CAR,39,82,17,34,51
60,8477346,MacKenzie Weegar,D,CGY,30,82,9,42,51
60,8474150,Mikael Backlund,C,CGY,35,82,19,31,50
60,8477021,Alex Kerfoot,C,UTA,30,82,14,36,50
60,8476292,Ondrej Palat,L,NJD,33,82,12,38,50
60,8474563,Drew Doughty,D,LAK,35,82,8,42,50
60,8482684,Luke Hughes,D,NJD,21,82,8,42,50
60,8471698,T.J. Oshie,R,WSH,38,82,29,20,49
60,8474641,Adam Henrique,C,EDM,34,82,24,25,49
60,8477451,Ryan Hartman,R,MIN,30,82,24,25,49
60,8481540,Cole Caufield,R,MTL,23,82,22,27,49
60,8480188,Fabian Zetterlund,L,SJS,25,82,20,29,49
60,8482149,Cole Perfetti,C,WPG,22,82,19,30,49
60,8476882,Teuvo Teravainen,L,CHI,30,82,17,32,49
60,8478891,Mason Appleton,C,WPG,28,82,17,32,49
60,8482475,Yegor Chinakhov,R,CBJ,23,82,15,34,49
60,8478460,Zach Werenski,D,CBJ,27,82,9,40,49
60,8475722,Jason Zucker,L,BUF,32,82,30,18,48
60,8481624,Ilya Mikheyev,R,CHI,30,82,23,25,48
60,8475191,Reilly Smith,R,NYR,33,82,22,26,48
60,8482109,Alexis Lafrenière,L,NYR,23,82,22,26,48
60,8479987,Morgan Geekie,C,BOS,26,82,17,31,48
60,8476461,Sean Couturier,C,PHI,32,82,16,32,48
60,8476869,Brady Skjei,D,NSH,30,82,10,38,48
60,8478055,Gustav Forsling,D,FLA,28,82,9,39,48
60,8476880,Tom Wilson,R,WSH,30,82,27,20,47
60,8480014,Gabriel Vilardi,C,WPG,25,82,25,22,47
60,8480829,Jesperi Kotkaniemi,C,CAR,24,82,19,28,47
60,8476875,Mike Matheson,D,MTL,30,82,11,36,47
60,8479525,Ross Colton,C,COL,28,82,26,20,46
60,8477426,Nicholas Paul,L,TBL,29,82,23,23,46
60,8482745,Mason McTavish,C,ANA,21,82,22,24,46
60,8475765,Vladimir Tarasenko,R,DET,33,82,20,26,46
60,8475763,Kevin Hayes,R,PIT,32,82,16,30,46
60,8478472,Mathieu Joseph,R,STL,27,82,13,33,46
60,8476906,Shayne Gostisbehere,D,CAR,31,82,12,34,46
60,8476458,Ryan Strome,C,ANA,31,82,12,34,46
60,8479410,Mikhail Sergachev,D,UTA,26,82,11,35,46
60,8482175,JJ Peterka,R,BUF,22,82,26,19,45
60,8483808,Andrei Kuzmenko,L,CGY,28,82,25,20,45
60,8480798,Philipp Kurashev,C,CHI,25,82,21,24,45
60,8482092,Ridly Greig,C,OTT,22,82,20,25,45
60,8476792,Torey Krug,D,STL,33,82,15,30,45
60,8477456,J.T. Compher,L,DET,29,82,15,30,45
60,8475218,Mattias Ekholm,D,EDM,34,82,14,31,45
60,8482671,Owen Power,D,BUF,22,82,11,34,45
60,8478396,Noah Hanifin,D,VGK,27,82,9,36,45
60,8475314,Anders Lee,L,NYI,34,82,27,17,44
60,8476432,Boone Jenner,C,CBJ,31,82,26,18,44
60,8482159,Tyson Foerster,R,PHI,22,82,23,21,44
60,8480009,Eeli Tolvanen,R,SEA,25,82,23,21,44
60,8478542,Evan Rodrigues,C,FLA,31,82,19,25,44
60,8474149,Evgenii Dadonov,R,DAL,35,82,19,25,44
60,8484144,Connor Bedard,C,CHI,19,82,18,26,44
60,8480220,Noah Cates,L,PHI,25,82,16,28,44
60,8477987,Ryan Donato,C,CHI,28,82,16,28,44
60,8478463,Anthony Beauvillier,L,PIT,27,82,21,22,43
60,8477964,Ivan Barbashev,C,VGK,29,82,19,24,43
60,8476872,Scott Laughton,C,PHI,30,82,19,24,43
60,8480849,Barrett Hayton,C,UTA,24,82,19,24,43
60,8481553,Bobby Brink,R,PHI,23,82,19,24,43
60,8476479,Phillip Danault,C,LAK,31,82,17,26,43
60,8476885,Jacob Trouba,D,NYR,30,82,15,28,43
60,8477986,Brandon Montour,D,SEA,30,82,12,31,43
60,8475753,Justin Faulk,D,STL,32,82,7,36,43
60,8479992,Michael Rasmussen,C,DET,25,82,22,20,42
60,8475151,Kyle Palmieri,C,NYI,33,82,21,21,42
60,8480835,Jack Drury,C,CAR,24,82,20,22,42
60,8478519,Anthony Cirelli,C,TBL,27,82,18,24,42
60,8477479,Tyler Bertuzzi,L,CHI,29,82,18,24,42
60,8475764,Cam Fowler,D,ANA,33,82,9,33,42
60,8480434,Sean Durzi,D,UTA,26,82,8,34,42
60,8480893,Kirill Marchenko,R,CBJ,24,82,25,16,41
60,8481186,Logan O'Connor,R,COL,28,82,23,18,41
60,8480185,Eetu Luostarinen,C,FLA,26,82,22,19,41
60,8475760,Nick Bjugstad,C,UTA,32,82,20,21,41
60,8477429,Andrew Copp,C,DET,30,82,18,23,41
60,8475855,Jesper Fast,R,CAR,33,82,15,26,41
60,8482133,Thomas Bordeleau,C,SJS,22,82,15,26,41
60,8476474,Stefan Noesen,R,NJD,31,82,13,28,41
60,8483431,Logan Cooley,C,UTA,20,82,25,15,40
60,8481535,Nils Hoglander,L,VAN,24,82,24,16,40
60,8483515,Juraj Slafkovsky,L,MTL,20,82,23,17,40
60,8478474,Lawson Crouse,L,UTA,27,82,21,19,40
60,8473986,Alex Killorn,L,ANA,35,82,17,23,40
60,8477989,Christian Dvorak,C,MTL,28,82,17,23,40
60,8481704,Juuso Parssinen,C,NSH,23,82,14,26,40
60,8476921,Jordan Martinook,L,CAR,32,82,13,27,40
60,8480336,Sean Walker,D,CAR,30,82,13,27,40
60,8473563,Nicklas Backstrom,C,WSH,37,82,10,30,40
60,8477932,Aaron Ekblad,D,FLA,28,82,9,31,40
60,8477495,Seth Jones,D,CHI,30,82,8,32,40
60,8481542,Moritz Seider,D,DET,23,82,6,34,40
60,8481656,Aliaksei Protas,C,WSH,23,82,18,21,39
60,8482117,Lukas Reichel,L,CHI,22,82,17,22,39
60,8482705,Cole Sillinger,C,CBJ,21,82,16,23,39
60,8482105,Jake Sanderson,D,OTT,22,82,16,23,39
60,8475745,Charlie Coyle,C,BOS,32,82,15,24,39
60,8475791,Taylor Hall,L,CHI,33,82,15,24,39
60,8474716,Jared Spurgeon,D,MIN,35,82,14,25,39
60,8480871,Adam Boqvist,D,FLA,24,82,11,28,39
60,8476854,Hampus Lindholm,D,BOS,30,82,7,32,39
60,8476979,Erik Gustafsson,D,DET,32,82,6,33,39
60,8481032,Paul Cotter,C,NJD,25,82,23,15,38
60,8476960,Andreas Athanasiou,C,CHI,30,82,21,17,38
60,8478020,Michael Amadio,C,OTT,28,82,20,18,38
60,8470621,Corey Perry,R,EDM,39,82,18,20,38
60,8479591,Michael Eyssimont,C,TBL,28,82,18,20,38
60,8478057,Dakota Joshua,C,VAN,28,82,17,21,38
60,8481618,Alex Newhook,C,MTL,23,82,13,25,38
60,8480873,Rasmus Sandin,D,WSH,24,82,6,32,38
60,8477425,Miles Wood,L,COL,29,82,20,17,37
60,8482146,Luke Evangelista,R,NSH,22,82,17,20,37
60,8481582,Nicholas Robertson,L,TOR,23,82,15,22,37
60,8477953,Kasperi Kapanen,R,STL,28,82,14,23,37
60,8477947,Sonny Milano,L,WSH,28,82,13,24,37
60,8481546,Cam York,D,PHI,23,82,12,25,37
60,8477948,Travis Sanheim,D,PHI,28,82,8,29,37
60,8482089,Jake Neighbours,L,STL,22,82,19,17,36
60,8476469,Joel Armia,R,MTL,31,82,19,17,36
60,8479368,Max Jones,L,BOS,26,82,17,19,36
60,8477952,Robby Fabbri,C,ANA,28,82,16,20,36
60,8475848,Brendan Gallagher,R,MTL,32,82,15,21,36
60,8476419,Jean-Gabriel Pageau,C,NYI,32,82,14,22,36
60,8473422,Nick Foligno,L,CHI,37,82,14,22,36
60,8476278,Colin Blackwell,C,DAL,31,82,14,22,36
60,8476329,Travis Boyd,C,MIN,31,82,11,25,36
60,8476958,Jaccob Slavin,D,CAR,30,82,6,30,36
60,8476457,Adam Larsson,D,SEA,32,82,6,30,36
60,8480748,Kiefer Sherwood,L,VAN,29,82,18,17,35
60,8481554,Kaapo Kakko,R,NYR,23,82,17,18,35
60,8482699,Dylan Guenther,R,UTA,21,82,14,21,35
60,8475287,Erik Haula,L,NJD,33,82,13,22,35
60,8480068,Ryan Poehling,C,PHI,25,82,12,23,35
60,8476480,Vladislav Namestnikov,C,WPG,32,82,12,23,35
60,8476467,Jamie Oleksiak,D,SEA,32,82,12,23,35
60,8478851,Alexandre Carrier,D,NSH,28,82,10,25,35
60,8478840,Will Borgen,D,SEA,28,82,5,30,35
60,8477488,Brett Pesce,D,NJD,30,82,5,30,35
60,8478507,John Marino,D,UTA,27,82,4,31,35
60,8476438,Brandon Saad,L,STL,32,82,22,12,34
60,8481560,Arthur Kaliyev,R,LAK,23,82,19,15,34
60,8478462,Nicolas Roy,C,VGK,27,82,15,19,34
60,8475220,Marcus Foligno,L,MIN,33,82,14,20,34
60,8476925,Colton Sissons,C,NSH,31,82,13,21,34
60,8479390,Taylor Raddysh,R,WSH,26,82,11,23,34
60,8476927,Teddy Blueger,C,VAN,30,82,10,24,34
60,8481013,Jonatan Berggren,R,DET,24,82,9,25,34
60,8480145,Neal Pionk,D,WPG,29,82,6,28,34
60,8479353,Brett Howden,C,VGK,26,82,20,13,33
60,8474715,Cam Atkinson,R,TBL,35,82,19,14,33
60,8478508,Yakov Trenin,C,MIN,27,82,18,15,33
60,8477450,Jason Dickinson,C,CHI,29,82,17,16,33
60,8479293,Brandon Tanev,L,SEA,33,82,14,19,33
60,8475193,Tomas Tatar,L,NJD,34,82,13,20,33
60,8481606,Jordan Spence,D,LAK,23,82,10,23,33
60,8482660,Kent Johnson,C,CBJ,22,82,8,25,33
60,8476923,Damon Severson,D,CBJ,30,82,8,25,33
60,8474151,Ryan McDonagh,D,TBL,35,82,5,28,33
60,8476873,Mark Jankowski,C,NSH,30,82,14,18,32
60,8482720,Matthew Knies,L,TOR,22,82,10,22,32
60,8477498,Darnell Nurse,D,EDM,29,82,9,23,32
60,8476892,Colton Parayko,D,STL,31,82,3,29,32
60,8480113,Alex Iafallo,L,WPG,31,82,16,15,31
60,8479316,Luke Kunin,C,SJS,27,82,15,16,31
60,8481580,Connor McMichael,C,WSH,23,82,14,17,31
60,8476897,Oskar Sundqvist,C,STL,30,82,14,17,31
60,8480459,Pius Suter,C,VAN,28,82,13,18,31
60,8473533,Jordan Staal,C,CAR,36,82,11,20,31
60,8478133,Jake Evans,C,MTL,28,82,11,20,31
60,8477406,Mattias Janmark,C,EDM,32,82,11,20,31
60,8476902,Esa Lindell,D,DAL,30,82,8,23,31
60,8477220,Nate Schmidt,D,FLA,33,82,7,24,31
60,8482655,J.J. Moser,D,TBL,24,82,4,27,31
60,8480049,Dylan Samberg,D,WPG,25,82,3,28,31
60,8480074,Alexandre Texier,C,STL,25,82,12,18,30
60,8480789,Oliver Wahlstrom,R,NYI,24,82,12,18,30
60,8481481,Blake Lizotte,C,PIT,27,82,11,19,30
60,8475279,Ben Chiarot,D,DET,33,82,9,21,30
60,8478434,Keegan Kolesar,R,VGK,27,82,9,21,30
60,8480817,K'Andre Miller,D,NYR,24,82,8,22,30
60,8479983,Mario Ferraro,D,SJS,26,82,8,22,30
60,8476917,Adam Pelech,D,NYI,30,82,7,23,30
60,8475233,David Savard,D,MTL,34,82,3,27,30
60,8481604,Pavel Dorofeyev,L,VGK,24,82,18,11,29
60,8484153,Leo Carlsson,C,ANA,20,82,16,13,29
60,8479941,Justin Danforth,R,CBJ,31,82,16,13,29
60,8480813,Joe Veleno,C,DET,24,82,16,13,29
60,8474189,Lars Eller,C,PIT,35,82,15,14,29
60,8484166,Adam Fantilli,C,CBJ,20,82,12,17,29
60,8482667,William Eklund,L,SJS,22,82,11,18,29
60,8475149,Marcus Johansson,L,MIN,34,82,10,19,29
60,8477507,Nikita Zadorov,D,BOS,29,82,8,21,29
60,8480806,Isac Lundestrom,C,ANA,25,82,7,22,29
60,8475200,Dmitry Orlov,D,CAR,33,82,6,23,29
60,8480043,Timothy Liljegren,D,TOR,25,82,5,24,29
60,8477969,Marcus Pettersson,D,PIT,28,82,4,25,29
60,8480860,Kevin Bahl,D,CGY,24,82,4,25,29
60,8480073,Erik Brannstrom,D,COL,25,82,3,26,29
60,8478109,Victor Olofsson,L,VGK,29,82,18,10,28
60,8482155,Alex Laferriere,R,LAK,23,82,17,11,28
60,8478413,Jordan Greenway,L,BUF,27,82,14,14,28
60,8480855,Jack McBain,C,UTA,24,82,14,14,28
60,8482259,Bobby McMann,C,TOR,28,82,13,15,28
60,8477919,Frederick Gaudreau,C,MIN,31,82,12,16,28
60,8478115,Pierre Engvall,L,NYI,28,82,11,17,28
60,8475181,Nick Leddy,D,STL,33,82,6,22,28
60,8482125,Alexander Holtz,R,VGK,22,82,17,10,27
60,8481517,Brett Leason,R,ANA,25,82,14,13,27
60,8479996,Cody Glass,C,NSH,25,82,13,14,27
60,8479414,Nathan Bastian,R,NJD,27,82,13,14,27
60,8483524,Shane Wright,C,SEA,20,82,13,14,27
60,8482079,Marco Rossi,C,MIN,23,82,12,15,27
60,8479351,Sam Steel,C,DAL,26,82,11,16,27
60,8482807,Ethan Del Mastro,D,CHI,21,82,9,18,27
60,8480878,Nils Lundkvist,D,DAL,24,82,7,20,27
60,8478911,Matt Roy,D,WSH,29,82,6,21,27
60,8477435,Ryan Graves,D,PIT,29,82,5,22,27
60,8481178,Egor Zamula,D,PHI,24,82,1,26,27
60,8478013,Jake Walman,D,SJS,28,82,11,15,26
60,8481601,Simon Holmstrom,R,NYI,23,82,10,16,26
60,8475171,Oliver Ekman-Larsson,D,TOR,33,82,9,17,26
60,8475231,Casey Cizikas,C,NYI,33,82,8,18,26
60,8477508,Curtis Lazar,C,NJD,29,82,7,19,26
60,8476463,Jonas Brodin,D,MIN,31,82,7,19,26
60,8482803,Olen Zellweger,D,ANA,21,82,7,19,26
60,8479359,Beck Malenstyn,L,BUF,26,82,5,21,26
60,8475790,Erik Gudbranson,D,CBJ,32,82,4,22,26
60,8476931,Jake McCabe,D,TOR,31,82,3,23,26
60,8482245,Artem Zub,D,OTT,29,82,3,23,26
60,8479324,Ryan Lindgren,D,NYR,26,82,3,23,26
60,8478882,Vladislav Gavrikov,D,LAK,29,82,2,24,26
60,8482055,Drew O'Connor,L,PIT,26,82,16,9,25
60,8480980,Connor Dewar,C,TOR,25,82,16,9,25
60,8477903,Garnet Hathaway,R,PHI,33,82,15,10,25
60,8480144,David Kampf,C,TOR,29,82,13,12,25
60,8476918,Jimmy Vesey,L,NYR,31,82,11,14,25
60,8482624,Daniil Miromanov,D,CGY,27,82,11,14,25
60,8476392,Adam Lowry,C,WPG,31,82,9,16,25
60,8478432,Christian Fischer,R,DET,27,82,9,16,25
60,8481567,Henry Thrun,D,SJS,23,82,8,17,25
60,8477365,Connor Clifton,D,BUF,29,82,6,19,25
60,8481522,Peyton Krebs,C,BUF,23,82,5,20,25
60,8476879,Cody Ceci,D,EDM,31,82,5,20,25
60,8479976,Juuso Valimaki,D,UTA,26,82,4,21,25
60,8480246,Nick Perbix,D,TBL,26,82,3,22,25
60,8475455,Brenden Dillon,D,NJD,34,82,3,22,25
60,8481568,Alex Vlasic,D,CHI,23,82,2,23,25
60,8475842,Sam Carrick,C,NYR,32,82,15,9,24
60,8481477,Nico Sturm,C,SJS,29,82,14,10,24
60,8481093,Rafael Harvey-Pinard,L,MTL,25,82,13,11,24
60,8476374,Sean Kuraly,C,CBJ,31,82,11,13,24
60,8482111,Justin Barron,D,MTL,23,82,9,15,24
60,8482702,Logan Stankoven,C,DAL,21,82,9,15,24
60,8483445,Cutter Gauthier,L,ANA,20,82,8,16,24
60,8474574,Tyler Myers,D,VAN,34,82,8,16,24
60,8477506,Ryan Pulock,D,NYI,30,82,6,18,24
60,8482087,Kaiden Guhle,D,MTL,22,82,5,19,24
60,8478500,Ivan Provorov,D,CBJ,27,82,4,20,24
60,8475690,Chris Tanev,D,TOR,35,82,4,20,24
60,8479398,Samuel Girard,D,COL,26,82,3,21,24
60,8479402,Jake Bean,D,CGY,26,82,2,22,24
60,8476981,Josh Anderson,R,MTL,30,82,17,6,23
60,8484145,Zach Benson,L,BUF,19,82,11,12,23
60,8479393,Noah Gregor,C,OTT,26,82,11,12,23
60,8483457,Lane Hutson,D,MTL,20,82,10,13,23
60,8482062,Cole Smith,L,NSH,29,82,9,14,23
60,8482122,Brock Faber,D,MIN,22,82,8,15,23
60,8483012,Logan Morrison,C,SEA,22,82,8,15,23
60,8483495,Simon Nemec,D,NJD,20,82,7,16,23
60,8478399,Jonas Siegenthaler,D,NJD,27,82,6,17,23
60,8478416,Erik Cernak,D,TBL,27,82,6,17,23
60,8483499,Liam Ohgren,L,MIN,20,82,5,18,23
60,8476312,Josh Manson,D,COL,33,82,4,19,23
60,8479998,Mikey Anderson,D,LAK,25,82,3,20,23
60,8482077,Dylan Holloway,L,EDM,23,82,15,7,22
60,8483763,Maksymilian Szuber,D,UTA,22,82,12,10,22
60,8476889,Radek Faksa,C,STL,30,82,9,13,22
60,8475343,Nic Dowd,C,WSH,34,82,7,15,22
60,8483565,Nick Blankenburg,D,NSH,26,82,5,17,22
60,8477839,Conor Sheary,L,TBL,32,82,5,17,22
60,8482073,Braden Schneider,D,NYR,23,82,4,18,22
60,8475188,Brayden McNabb,D,VGK,33,82,3,19,22
60,8480035,Henri Jokiharju,D,BUF,25,82,3,19,22
60,8481028,Martin Pospisil,C,CGY,25,82,13,8,21
60,8480448,Parker Kelly,L,COL,25,82,10,11,21
60,8478569,Noel Acciari,C,PIT,33,82,9,12,21
60,8476422,Mike Reilly,D,NYI,31,82,9,12,21
60,8480995,Pontus Holmberg,R,TOR,25,82,8,13,21
60,8470600,Ryan Suter,D,STL,39,82,6,15,21
60,8482141,Lukas Cormier,D,VGK,22,82,6,15,21
60,8478136,Jake Middleton,D,MIN,28,82,3,18,21
60,8481524,Bowen Byram,D,BUF,23,82,15,5,20
60,8482074,Connor Zary,C,CGY,23,82,10,10,20
60,8480003,Jesper Boqvist,C,FLA,26,82,8,12,20
60,8477392,Hudson Fasching,R,NYI,29,82,8,12,20
60,8479291,Kevin Rooney,C,CGY,31,82,7,13,20
60,8479980,Nicolas Hague,D,VGK,26,82,5,15,20
60,8477938,Haydn Fleury,D,WPG,28,82,5,15,20
60,8480222,Sebastian Aho,D,PIT,28,82,4,16,20
60,8475462,Radko Gudas,D,ANA,34,82,3,17,20
60,8477499,Rasmus Ristolainen,D,PHI,30,82,3,17,20
60,8483468,Jiri Kulich,C,BUF,20,82,2,18,20
60,8477845,Trevor van Riemsdyk,D,WSH,33,82,0,20,20
60,8479661,Tanner Jeannot,L,LAK,27,82,11,8,19
60,8482762,Simon Edvinsson,D,DET,21,82,11,8,19
60,8477353,Tyler Motte,C,DET,29,82,9,10,19
60,8477505,Alexander Wennberg,C,SJS,30,82,9,10,19
60,8476878,Zemgus Girgensons,L,TBL,30,82,8,11,19
60,8479369,Andrew Peeke,D,BOS,26,82,7,12,19
60,8477931,Tomas Nosek,L,FLA,32,82,6,13,19
60,8478178,Darren Raddysh,D,TBL,28,82,4,15,19
60,8481014,Alexander Romanov,D,NYI,24,82,3,16,19
60,8474673,TJ Brodie,D,CHI,34,82,2,17,19
60,8474013,Ian Cole,D,UTA,35,82,2,17,19
60,8476331,Dylan DeMelo,D,WPG,31,82,1,18,19
60,8482142,Jamie Drysdale,D,PHI,22,82,1,18,19
60,8475324,Nick Jensen,D,OTT,34,82,1,18,19
60,8476442,Matt Nieto,L,PIT,32,82,10,8,18
60,8476624,Barclay Goodrow,C,SJS,31,82,8,10,18
60,8482166,Shakir Mukhamadullin,D,SJS,22,82,5,13,18
60,8477369,Carson Soucy,D,VAN,30,82,5,13,18
60,8476967,Brett Kulak,D,EDM,30,82,5,13,18
60,8482809,Jackson Blake,R,CAR,21,82,4,14,18
60,8478450,Parker Wotherspoon,D,BOS,27,82,4,14,18
60,8480281,Alexey Toropchenko,R,STL,25,82,12,5,17
60,8482153,Brendan Brisson,C,VGK,23,82,9,8,17
60,8482787,Nikita Chibrikov,R,WPG,31,82,9,8,17
60,8482858,Ryker Evans,D,SEA,23,82,8,9,17
60,8482749,Joshua Roy,R,MTL,21,82,8,9,17
60,8480021,Jack Studnicka,C,LAK,25,82,7,10,17
60,8480834,Ty Emberson,D,SJS,24,82,6,11,17
60,8482666,Scott Morrow,D,CAR,22,82,6,11,17
60,8473507,Jeff Petry,D,DET,37,82,4,13,17
60,8481708,Zac Jones,D,NYR,24,82,2,15,17
60,8479442,Troy Stecher,D,EDM,30,82,2,15,17
60,8484149,Gavin Brindley,C,CBJ,20,82,8,8,16
60,8478859,Niko Mikkola,D,FLA,28,82,6,10,16
60,8478443,Brandon Carlo,D,BOS,28,82,5,11,16
60,8479576,Vincent Desharnais,D,VAN,28,82,5,11,16
60,8483471,Brad Lambert,C,WPG,31,82,5,11,16
60,8479371,Dante Fabbro,D,NSH,26,82,3,13,16
60,8476441,Joel Edmundson,D,LAK,31,82,3,13,16
60,8480807,Mattias Samuelsson,D,BUF,24,82,3,13,16
60,8480879,Jacob Bernard-Docker,D,OTT,24,82,1,15,16
60,8476822,Luke Glendening,C,TBL,35,82,9,6,15
60,8482101,Danil Gushchin,L,SJS,22,82,8,7,15
60,8477015,Connor Brown,R,EDM,30,82,7,8,15
60,8482712,Oskar Olausson,R,COL,22,82,7,8,15
60,8483493,Frank Nazar,C,CHI,20,82,6,9,15
60,8482679,Matt Coronato,R,CGY,22,82,6,9,15
60,8478211,Dryden Hunt,L,CGY,29,82,6,9,15
60,8482733,Logan Mailloux,D,MTL,31,82,6,9,15
60,8476858,Phillip Di Giuseppe,L,VAN,31,82,6,9,15
60,8474090,Brendan Smith,D,DAL,35,82,4,11,15
60,8480950,Ilya Lyubushkin,D,DAL,30,82,3,12,15
60,8480172,Jan Rutta,D,SJS,34,82,1,14,15
60,8478874,Adam Gaudette,C,OTT,28,82,1,14,15
60,8476372,Nick Seeler,D,PHI,31,82,0,15,15
60,8480870,Bo Groulx,C,NYR,24,82,8,6,14
60,8473453,Trevor Lewis,C,LAK,37,82,7,7,14
60,8483397,Marc McLaughlin,C,BOS,25,82,7,7,14
60,8483505,Matthew Poitras,C,BOS,20,82,6,8,14
60,8482713,Mackie Samoskevich,R,FLA,22,82,5,9,14
60,8480990,Declan Chisholm,D,MIN,24,82,5,9,14
60,8482470,Ilya Solovyov,D,CGY,24,82,5,9,14
60,8476891,Matt Grzelcyk,D,PIT,30,82,2,12,14
60,8478468,Jeremy Lauzon,D,NSH,27,82,2,12,14
60,8477335,Kyle Burroughs,D,LAK,29,82,2,12,14
60,8476429,Scott Mayfield,D,NYI,32,82,0,14,14
60,8480025,MacKenzie Entwistle,R,FLA,25,82,6,7,13
60,8484203,Bradly Nadeau,L,CAR,19,82,5,8,13
60,8482145,Mavrik Bourque,C,DAL,22,82,4,9,13
60,8480796,Martin Fehervary,D,WSH,25,82,3,10,13
60,8474567,Zach Bogosian,D,MIN,34,82,3,10,13
60,8482118,Sam Colangelo,R,ANA,23,82,3,10,13
60,8476525,Colin Miller,D,WPG,32,82,1,12,13
60,8483490,Pavel Mintyukov,D,ANA,21,82,1,12,13
60,8484911,Collin Graf,R,SJS,22,82,6,6,12
60,8482516,Matthew Kessel,D,STL,24,82,6,6,12
60,8475718,Justin Holl,D,DET,32,82,4,8,12
60,8483466,Kevin Korchinski,D,CHI,20,82,3,9,12
60,8483567,Georgii Merkulov,C,BOS,24,82,2,10,12
60,8479638,Justin Brazeau,R,BOS,26,82,5,6,11
60,8477034,Jaycob Megna,D,FLA,32,82,4,7,11
60,8475762,Derek Forbort,D,VAN,32,82,3,8,11
60,8482859,Zack Ostapchuk,C,OTT,21,82,3,8,11
60,8481605,Jackson LaCombe,D,ANA,23,82,2,9,11
60,8476473,Connor Murphy,D,CHI,31,82,2,9,11
60,8471677,Jack Johnson,D,CBJ,37,82,4,6,10
60,8481122,Simon Benoit,D,TOR,26,82,2,8,10
60,8475177,Calvin de Haan,D,COL,33,82,2,8,10
60,8474612,Travis Hamonic,D,OTT,34,82,2,8,10
60,8482659,Josh Doan,R,UTA,22,82,4,5,9
60,8483460,David Jiricek,D,CBJ,21,82,4,5,9
60,8481699,Aku Raty,R,UTA,23,82,2,6,8
60,8482070,Mitchell Chaffee,R,TBL,26,82,3,4,7
60,8483482,Tristan Luneau,D,ANA,20,82,1,6,7
60,8481641,Joel Kiviranta,L,COL,28,82,4,2,6
60,8474062,Riley Nash,C,NYR,35,82,4,2,6
60,8483489,Fraser Minten,C,TOR,31,82,0,5,5
60,8470794,Joe Pavelski,C,,40,0,0,0,0
60,8481703,Valtteri Puustinen,R,PIT,25,0,0,0,0
60,8477950,Tony DeAngelo,D,,29,0,0,0,0
60,8481577,Philip Tomasino,C,NSH,23,0,0,0,0
60,8475197,Tyson Barrie,D,,33,0,0,0,0
60,8471218,Blake Wheeler,R,,38,0,0,0,0
60,8474157,Max Pacioretty,L,,36,0,0,0,0
60,8478466,Daniel Sprong,R,VAN,27,0,0,0,0
60,8475744,Evgeny Kuznetsov,C,,32,0,0,0,0
60,8481019,David Gustafsson,C,WPG,24,0,0,0,0
60,8475906,John Klingberg,D,,32,0,0,0,0
60,8479348,Kale Clague,D,BUF,26,0,0,0,0
60,8476952,Dominic Toninato,C,WPG,30,0,0,0,0
60,8473473,Milan Lucic,L,,36,0,0,0,0
60,8474037,James van Riemsdyk,L,,35,0,0,0,0
60,8474602,Justin Schultz,D,,34,0,0,0,0
60,8482222,Alexander Barabanov,L,,30,0,0,0,0
60,8479372,Josh Mahura,D,SEA,26,0,0,0,0
60,8479982,Conor Timmins,D,TOR,26,0,0,0,0
60,8474031,Kevin Shattenkirk,D,,35,0,0,0,0
60,8480008,Adam Ruzicka,C,,25,0,0,0,0
60,8481059,Scott Perunovich,D,STL,26,0,0,0,0
60,8480884,Calen Addison,D,,24,0,0,0,0
60,8476994,Vinnie Hinostroza,C,NSH,30,0,0,0,0
60,8478452,Caleb Jones,D,LAK,27,0,0,0,0
60,8480157,Calle Rosen,D,COL,30,0,0,0,0
60,8481609,Vladislav Kolyachonok,D,UTA,23,0,0,0,0
60,8479415,Michael McLeod,C,,26,0,0,0,0
60,8476919,Chris Tierney,C,,30,0,0,0,0
60,8479639,Dylan Coghlan,D,WPG,26,0,0,0,0
60,8478146,Matthew Highmore,C,OTT,28,0,0,0,0
60,8478970,Jalen Chatfield,D,CAR,28,0,0,0,0
60,8480205,Emil Bemstrom,C,PIT,25,0,0,0,0
60,8474884,Mike Hoffman,C,,35,0,0,0,0
60,8471274,Alex Goligoski,D,,39,0,0,0,0
60,8478104,Sammy Blais,L,,28,0,0,0,0
60,8474870,Tyler Johnson,C,,34,0,0,0,0
60,8476913,Devin Shore,C,MIN,30,0,0,0,0
60,8481598,Philip Broberg,D,EDM,23,0,0,0,0
60,8480058,Pierre-Olivier Joseph,D,STL,25,0,0,0,0
60,8480891,Michael Kesselring,D,UTA,24,0,0,0,0
60,8477979,Nicolas Aube-Kubel,R,BUF,28,0,0,0,0
60,8476871,Tanner Pearson,L,,32,0,0,0,0
60,8476393,Nick Cousins,C,,31,0,0,0,0
60,8479977,Kailer Yamamoto,R,,26,0,0,0,0
60,8479543,Michael Pezzetta,L,MTL,26,0,0,0,0
60,8477018,Ben Hutton,D,VGK,31,0,0,0,0
60,8480762,Eric Robinson,L,CAR,29,0,0,0,0
60,8474034,Pat Maroon,L,CHI,36,0,0,0,0
60,8481058,Jesse Ylönen,R,,25,0,0,0,0
60,8475179,Dmitry Kulikov,D,FLA,34,0,0,0,0
60,8481527,Kaedan Korczak,D,VGK,23,0,0,0,0
60,8473449,Kyle Okposo,R,,36,0,0,0,0
60,8482192,Isaak Phillips,D,CHI,23,0,0,0,0
60,8480727,Zach Whitecloud,D,VGK,28,0,0,0,0
60,8479346,Dillon Dube,C,,26,0,0,0,0
60,8480821,Filip Zadina,R,,25,0,0,0,0
60,8480001,Urho Vaakanainen,D,ANA,25,0,0,0,0
60,8470966,Mark Giordano,D,,41,0,0,0,0
60,8480853,Liam Foudy,C,,24,0,0,0,0
60,8475225,Craig Smith,C,CHI,35,0,0,0,0
60,8479972,Mason Shaw,C,WPG,26,0,0,0,0
60,8478451,Ethan Bear,D,WSH,27,0,0,0,0
60,8474040,Sam Gagner,C,,35,0,0,0,0
60,8480196,Jacob Bryson,D,BUF,27,0,0,0,0
60,8479984,Cal Foote,D,,26,0,0,0,0
60,8480011,Klim Kostin,C,SJS,25,0,0,0,0
60,8482176,Wyatt Kaiser,D,CHI,22,0,0,0,0
60,8476988,Matt Benning,D,SJS,30,0,0,0,0
60,8479370,Tyson Jost,C,CAR,26,0,0,0,0
60,8477464,Nic Petan,C,,29,0,0,0,0
60,8477380,Jonny Brodzinski,C,NYR,31,0,0,0,0
60,8480070,Ian Mitchell,D,BOS,25,0,0,0,0
60,8479315,Joey Anderson,R,CHI,26,0,0,0,0
60,8478099,Kevin Labanc,R,,29,0,0,0,0
60,8476874,Olli Maatta,D,DET,30,0,0,0,0
60,8475208,Brian Dumoulin,D,ANA,33,0,0,0,0
60,8478430,Oliver Kylington,D,,27,0,0,0,0
60,8479536,Axel Jonsson-Fjallby,L,WPG,26,0,0,0,0
60,8479671,Mathieu Olivier,R,CBJ,27,0,0,0,0
60,8471709,Marc-Edouard Vlasic,D,SJS,37,0,0,0,0
60,8479328,Julien Gauthier,R,NYI,27,0,0,0,0
60,8478421,A.J. Greer,L,FLA,28,0,0,0,0
60,8477573,Nathan Walker,L,STL,30,0,0,0,0
60,8481537,Nikita Okhotiuk,D,CGY,24,0,0,0,0
60,8474166,Alec Martinez,D,CHI,37,0,0,0,0
60,8470610,Zach Parise,L,,40,0,0,0,0
60,8477478,William Carrier,L,CAR,30,0,0,0,0
60,8479344,Jesse Puljujarvi,R,PIT,26,0,0,0,0
60,8480887,Jordan Harris,D,MTL,24,0,0,0,0
60,8478502,Dennis Gilbert,D,BUF,28,0,0,0,0
60,8482730,Brandt Clarke,D,LAK,21,0,0,0,0
60,8480355,Mark Kastelic,C,BOS,25,0,0,0,0
60,8475750,Jon Merrill,D,MIN,32,0,0,0,0
60,8475164,Jakob Silfverberg,R,,34,0,0,0,0
60,8477944,Jakub Vrana,L,,28,0,0,0,0
60,8479439,Jacob MacDonald,D,COL,31,0,0,0,0
60,8474568,Luke Schenn,D,NSH,35,0,0,0,0
60,8478454,Noah Juulsen,D,VAN,27,0,0,0,0
60,8475752,Tyler Pitlick,C,,33,0,0,0,0
60,8482148,Hendrix Lapierre,C,WSH,22,0,0,0,0
60,8481167,Brayden Pachal,D,CGY,25,0,0,0,0
60,8478043,Sam Lafferty,C,BUF,29,0,0,0,0
60,8479321,Lucas Johansen,D,,27,0,0,0,0
60,8471699,Andrew Cogliano,C,,37,0,0,0,0
60,8481521,Ronnie Attard,D,PHI,25,0,0,0,0
60,8481161,Jake Christiansen,D,CBJ,25,0,0,0,0
60,8479458,Nikita Zaitsev,D,,33,0,0,0,0
60,8479619,Michael Carcone,L,UTA,28,0,0,0,0
60,8479026,Philippe Myers,D,TOR,27,0,0,0,0
60,8477330,Dominik Kubalik,L,,29,0,0,0,0
60,8481617,Vasily Podkolzin,R,VAN,23,0,0,0,0
60,8481701,Santeri Hatakka,D,NJD,23,0,0,0,0
60,8479514,Rem Pitlick,C,,27,0,0,0,0
60,8477446,Michael McCarron,R,NSH,29,0,0,0,0
60,8470604,Jeff Carter,C,,39,0,0,0,0
60,8482241,Radim Zohorna,L,,28,0,0,0,0
60,8480289,Morgan Barron,C,WPG,26,0,0,0,0
60,8479379,Givani Smith,R,SJS,26,0,0,0,0
60,8480216,Jacob Peterson,C,,25,0,0,0,0
60,8477851,Jordan Oesterle,D,BOS,32,0,0,0,0
60,8484258,Sam Malinski,D,COL,26,0,0,0,0
60,8478904,Steven Lorentz,C,,28,0,0,0,0
60,8482095,Tyler Kleven,D,OTT,22,0,0,0,0
60,8480848,Ty Dellandrea,C,SJS,24,0,0,0,0
60,8476884,Derrick Pouliot,D,,30,0,0,0,0
60,8479336,Carl Grundstrom,R,SJS,27,0,0,0,0
60,8482964,Arber Xhekaj,D,MTL,23,0,0,0,0
60,8471686,Marc Staal,D,,37,0,0,0,0
60,8477887,Patrick Brown,C,BOS,32,0,0,0,0
60,8478495,Denis Gurianov,R,,27,0,0,0,0
60,8473504,Cal Clutterbuck,R,,37,0,0,0,0
60,8481550,Adam Beckman,L,NJD,23,0,0,0,0
60,8480845,Rasmus Kupari,C,WPG,24,0,0,0,0
60,8474009,Nick Bonino,C,,36,0,0,0,0
60,8478585,Derek Ryan,C,EDM,38,0,0,0,0
60,8477962,Brendan Lemieux,L,CAR,28,0,0,0,0
60,8482861,Vincent Iorio,D,WSH,22,0,0,0,0
60,8479378,Logan Stanley,D,WPG,26,0,0,0,0
60,8473446,Erik Johnson,D,PHI,36,0,0,0,0
60,8481743,Marc Del Gaizo,D,NSH,25,0,0,0,0
60,8477384,Josh Brown,D,EDM,30,0,0,0,0
60,8482165,Yan Kuznetsov,D,CGY,22,0,0,0,0
60,8478424,Jansen Harkins,C,ANA,27,0,0,0,0
60,8482144,Jack Thompson,D,SJS,22,0,0,0,0
60,8478512,Austin Czarnik,C,,32,0,0,0,0
60,8477527,Ross Johnston,L,ANA,30,0,0,0,0
60,8479383,Boris Katchouk,L,,26,0,0,0,0
60,8482094,Daemon Hunt,D,MIN,22,0,0,0,0
60,8481719,Maxwell Crozier,D,TBL,24,0,0,0,0
60,8480192,Johnathan Kovacevic,D,NJD,27,0,0,0,0
60,8479376,Victor Mete,D,,26,0,0,0,0
60,8482511,Mason Lohrei,D,BOS,23,0,0,0,0
60,8475825,Jani Hakanpää,D,,32,0,0,0,0
60,8478021,William Lagesson,D,DET,28,0,0,0,0
60,8475795,Dylan McIlrath,D,WSH,32,0,0,0,0
60,8477846,Ryan Carpenter,C,,33,0,0,0,0
60,8481056,Spencer Stastney,D,NSH,24,0,0,0,0
60,8481564,Ryan Johnson,D,BUF,23,0,0,0,0
60,8478017,Mark Friedman,D,VAN,29,0,0,0,0
60,8479320,Max Lajoie,D,SEA,27,0,0,0,0
60,8480075,Cameron Crotty,D,MIN,25,0,0,0,0
60,8484287,Cole McWard,D,VAN,23,0,0,0,0
60,8484254,Akito Hirose,D,VAN,25,0,0,0,0
60,8483407,Brandon Scanlin,D,NYR,25,0,0,0,0
60,8480274,Philip Kemp,D,EDM,25,0,0,0,0
60,8479522,Hardy Haman Aktell,D,WSH,26,0,0,0,0
60,8480007,Jonas Rondbjerg,R,VGK,25,0,0,0,0
60,8477454,Adam Erne,L,,29,0,0,0,0
60,8481679,Maxence Guenette,D,OTT,23,0,0,0,0
60,8480441,Trey Fix-Wolansky,R,CBJ,25,0,0,0,0
60,8483546,Marshall Rifai,D,TOR,26,0,0,0,0
60,8480084,Nick DeSimone,D,NJD,30,0,0,0,0
60,8481030,Jack St. Ivany,D,PIT,25,0,0,0,0
60,8481592,Jakob Pelletier,L,CGY,23,0,0,0,0
60,8478011,Louie Belpedio,D,PHI,28,0,0,0,0
60,8477930,Pierre-Edouard Bellemare,L,,39,0,0,0,0
60,8484321,Nikolas Matinpalo,D,OTT,26,0,0,0,0
60,8482067,Connor Mackey,D,NYR,28,0,0,0,0
60,8481806,Louis Crevier,D,CHI,23,0,0,0,0
60,8484326,Patrik Koch,D,UTA,28,0,0,0,0
60,8477971,Andreas Englund,D,LAK,28,0,0,0,0
60,8481751,Lukas Rousek,R,BUF,25,0,0,0,0
60,8481006,Tyler Tucker,D,STL,24,0,0,0,0
60,8476867,Brendan Gaunce,C,MIN,30,0,0,0,0
60,8479520,Brandon Duhaime,R,WSH,27,0,0,0,0
60,8477073,Kurtis MacDermid,L,NJD,30,0,0,0,0
60,8480874,Adam Ginning,D,PHI,24,0,0,0,0
60,8477473,Justin Bailey,R,SJS,29,0,0,0,0
60,8479066,Ryan Lomberg,L,CGY,30,0,0,0,0
60,8477070,Liam O'Brien,C,UTA,30,0,0,0,0
60,8474618,Marco Scandella,D,,34,0,0,0,0
60,8475797,Jarred Tinordi,D,,32,0,0,0,0
60,8481441,Joe Snively,C,DET,28,0,0,0,0
60,8477244,Chad Ruhwedel,D,NYR,34,0,0,0,0
60,8479772,Zack MacEwen,R,OTT,28,0,0,0,0
60,8481147,Reese Johnson,C,MIN,26,0,0,0,0
60,8481043,Cole Koepke,L,BOS,26,0,0,0,0
60,8483619,Filip Roos,D,OTT,25,0,0,0,0
60,8481541,Samuel Bolduc,D,NYI,24,0,0,0,0
60,8477810,Joel Hanley,D,CGY,33,0,0,0,0
60,8476907,Mackenzie MacEachern,L,,30,0,0,0,0
60,8482652,Walker Duehr,R,CGY,27,0,0,0,0
60,8477126,Jayson Megna,C,,34,0,0,0,0
60,8483398,Declan Carlile,D,TBL,31,0,0,0,0
60,8482929,Emil Lilleberg,D,TBL,23,0,0,0,0
60,8480880,Jakub Lauko,C,MIN,24,0,0,0,0
60,8480245,Olle Lycksell,R,PHI,25,0,0,0,0
60,8480252,Cole Guttman,C,CHI,25,0,0,0,0
60,8477467,Gustav Olofsson,D,SEA,30,0,0,0,0
60,8479968,Vinni Lettieri,C,BOS,29,0,0,0,0
60,8478400,Colin White,C,,27,0,0,0,0
60,8475755,Alexander Petrovic,D,DAL,32,0,0,0,0
60,8481812,Nikolai Knyzhov,D,,27,0,0,0,0
60,8481593,Jayden Struble,D,MTL,23,0,0,0,0
60,8481532,Alex Turcotte,C,LAK,23,0,0,0,0
60,8482126,Emil Andrae,D,PHI,31,0,0,0,0
60,8479944,Zach Aston-Reese,C,VGK,30,0,0,0,0
60,8471817,Ryan Reaves,R,TOR,37,0,0,0,0
60,8481206,John Ludvig,D,PIT,24,0,0,0,0
60,8481599,Victor Soderstrom,D,UTA,23,0,0,0,0
60,8480292,Carson Meyer,R,ANA,27,0,0,0,0
60,8482496,Nils Aman,C,VAN,24,0,0,0,0
60,8479718,Alex Barré-Boulet,C,MTL,27,0,0,0,0
60,8479994,Jaret Anderson-Dolan,C,WPG,25,0,0,0,0
60,8480184,Gustav Lindstrom,D,,26,0,0,0,0
60,8480890,Jan Jenik,R,OTT,24,0,0,0,0
60,8478067,Oskar Lindblom,L,,28,0,0,0,0
60,8476934,Brock McGinn,L,ANA,30,0,0,0,0
60,8479985,Cale Fleury,D,SEA,26,0,0,0,0
60,8484304,Uvis Balinskis,D,FLA,28,0,0,0,0
60,8479981,Jonah Gadjovich,L,FLA,26,0,0,0,0
60,8481716,Dmitri Voronkov,L,CBJ,24,0,0,0,0
60,8474709,Matt Martin,L,,35,0,0,0,0
60,8482634,Alex Steeves,C,TOR,25,0,0,0,0
60,8480823,Alexander Alexeyev,D,WSH,25,0,0,0,0
60,8477541,Dakota Mermis,D,TOR,30,0,0,0,0
60,8483491,Ivan Miroshnichenko,L,WSH,20,0,0,0,0
60,8478477,Mitchell Stephens,C,SEA,27,0,0,0,0
60,8481543,Nikita Alexandrov,C,STL,24,0,0,0,0
60,8479423,Alex Nylander,L,,26,0,0,0,0
60,8482451,Mikael Pyyhtia,L,CBJ,23,0,0,0,0
60,8478831,Kevin Stenlund,C,UTA,28,0,0,0,0
60,8480306,Grant Hutton,D,NYI,29,0,0,0,0
60,8478028,Fredrik Olofsson,L,,28,0,0,0,0
60,8477462,Robert Hagg,D,VGK,29,0,0,0,0
60,8477320,Anton Blidh,L,NYR,29,0,0,0,0
60,8482157,Will Cuylle,L,NYR,22,0,0,0,0
60,8482737,Zack Bolduc,C,STL,21,0,0,0,0
60,8481239,Samuel Fagemo,L,,24,0,0,0,0
60,8481600,Tobias Bjornfot,D,FLA,23,0,0,0,0
60,8478409,Anthony Richard,C,PHI,28,0,0,0,0
60,8474145,Robert Bortuzzo,D,,35,0,0,0,0
60,8475958,Michael Sgarbossa,C,WSH,32,0,0,0,0
60,8479986,Kole Lind,R,DAL,26,0,0,0,0
60,8479249,Andrew Poturalski,C,SJS,30,0,0,0,0
60,8479362,Riley Tufte,L,BOS,26,0,0,0,0
60,8479991,Jake Leschyshyn,C,NYR,25,0,0,0,0
60,8479587,Rhett Gardner,C,PHI,28,0,0,0,0
60,8482744,James Malatesta,L,CBJ,21,0,0,0,0
60,8478854,Ryan Shea,D,PIT,27,0,0,0,0
60,8481591,Sam Poulin,R,,23,0,0,0,0
60,8483512,Matt Savoie,C,EDM,20,0,0,0,0
60,8482102,Vasily Ponomarev,C,PIT,22,0,0,0,0
60,8482162,Roby Jarventie,L,EDM,22,0,0,0,0
60,8481016,Ruslan Iskhakov,C,,24,0,0,0,0
60,8482172,Landon Slaggert,L,CHI,22,0,0,0,0
60,8482747,Brennan Othmann,L,NYR,21,0,0,0,0
60,8480031,Maxime Comtois,L,,25,0,0,0,0
60,8480226,Marián Studenic,R,,26,0,0,0,0
60,8478408,Travis Dermott,D,,28,0,0,0,0
60,8481518,Nolan Foote,L,NJD,24,0,0,0,0
60,8479419,Brett Murray,L,BUF,26,0,0,0,0
60,8482088,Justin Sourdif,R,FLA,22,0,0,0,0
60,8482201,Gage Goncalves,C,TBL,23,0,0,0,0
60,8481578,Graeme Clarke,R,MIN,23,0,0,0,0
60,8482177,Marat Khusnutdinov,C,MIN,22,0,0,0,0
60,8481754,Nikita Nesterenko,C,ANA,23,0,0,0,0
60,8483531,Brian Halonen,L,NJD,25,0,0,0,0
60,8483920,Pierrick Dube,R,WSH,23,0,0,0,0
60,8480851,Akil Thomas,C,LAK,24,0,0,0,0
60,8475235,Nicolas Deslauriers,L,PHI,33,0,0,0,0
60,8482476,Emil Heineman,L,MTL,23,0,0,0,0
60,8477149,Scott Sabourin,R,SJS,32,0,0,0,0
60,8483549,Lucas Condotta,L,MTL,27,0,0,0,0
60,8482765,Isak Rosen,R,BUF,21,0,0,0,0
60,8481237,Kyle MacLean,C,NYI,25,0,0,0,0
60,8481024,Linus Karlsson,C,VAN,25,0,0,0,0
60,8481690,Tyler Angle,C,,24,0,0,0,0
60,8483570,Ben Meyers,C,SEA,26,0,0,0,0
60,8481655,Cole Schwindt,R,CGY,23,0,0,0,0
60,8481462,Mason Morelli,L,VGK,28,0,0,0,0
60,8483401,Marc Johnstone,R,PIT,28,0,0,0,0
60,8478956,Samuel Laberge,L,NJD,27,0,0,0,0
60,8479533,Joona Koppanen,L,,26,0,0,0,0
60,8482197,Adam Raska,R,MIN,23,0,0,0,0
60,8482250,Callahan Burke,C,VGK,27,0,0,0,0
60,8482784,Zach Dean,C,STL,21,0,0,0,0
60,8484255,Jason Polin,R,COL,25,0,0,0,0
60,8481077,John Leonard,L,,26,0,0,0,0
60,8481534,Raphael Lavoie,C,EDM,24,0,0,0,0
60,8483609,Adam Klapka,R,CGY,24,0,0,0,0
60,8482751,Ryan Winterton,C,SEA,21,0,0,0,0
60,8480267,Sammy Walker,C,MIN,25,0,0,0,0
60,8475766,Austin Watson,L,,32,0,0,0,0
60,8482460,Matt Rempe,C,NYR,22,0,0,0,0
60,8481065,Angus Crookshank,L,OTT,25,0,0,0,0
60,8481070,Hugh McGing,L,,26,0,0,0,0
60,8476323,Max McCormick,L,SEA,32,0,0,0,0
60,8483395,Arshdeep Bains,L,VAN,23,0,0,0,0
60,8484259,Ondrej Pavel,C,COL,31,0,0,0,0
60,8483432,Luca Del Bel Belluz,C,CBJ,31,0,0,0,0
60,8483045,Cameron Butler,R,CBJ,31,0,0,0,0
60,8482061,Brandon Biro,L,SEA,26,0,0,0,0
60,8477401,John Hayden,C,SEA,29,0,0,0,0
60,8475278,Byron Froese,C,,33,0,0,0,0
60,8478446,Glenn Gawdin,C,LAK,27,0,0,0,0
60,8477993,Justin Kirkland,C,CGY,28,0,0,0,0
60,8482147,Jean-Luc Foudy,C,COL,22,0,0,0,0
60,8480032,Shane Bowers,C,NJD,25,0,0,0,0
60,8479330,Brandon Gignac,C,MTL,27,0,0,0,0
60,8480776,Sheldon Rempal,R,,29,0,0,0,0
60,8475413,Justin Dowling,C,NJD,34,0,0,0,0
60,8481726,Adam Edstrom,C,NYR,24,0,0,0,0
60,8480844,Grigori Denisenko,L,VGK,24,0,0,0,0
60,8478147,Bokondji Imama,L,PIT,28,0,0,0,0
60,8478881,Brett Seney,L,CHI,28,0,0,0,0
60,8483630,Pavol Regenda,L,ANA,25,0,0,0,0
60,8480836,Jonathan Gruden,C,,24,0,0,0,0
60,8484314,Jiri Smejkal,L,,28,0,0,0,0
60,8475780,Chris Wagner,R,COL,33,0,0,0,0
60,8479546,Oskar Steen,C,,26,0,0,0,0
60,8483597,Milos Kelemen,L,UTA,25,0,0,0,0
60,8481789,Tye Kartye,L,SEA,23,0,0,0,0
60,8484325,Waltteri Merela,C,TBL,26,0,0,0,0
60,8479421,Jacob Moverare,D,LAK,26,0,0,0,0
60,8481585,Egor Afanasyev,L,SJS,23,0,0,0,0
60,8479547,Matthew Phillips,R,,26,0,0,0,0
60,8479367,William Lockwood,R,FLA,26,0,0,0,0
60,8476915,Jujhar Khaira,L,,30,0,0,0,0
60,8481422,Jacob Lucchini,C,NSH,29,0,0,0,0
60,8480468,James Hamblin,L,EDM,25,0,0,0,0
60,8478051,Max Willman,C,NJD,29,0,0,0,0
60,8481556,John Beecher,C,BOS,23,0,0,0,0
60,8478078,Rourke Chartier,C,,28,0,0,0,0
61,8478402,Connor McDavid,C,EDM,27,82,48,94,142
61,8477492,Nathan MacKinnon,C,COL,29,82,47,93,140
61,8476453,Nikita Kucherov,R,TBL,31,82,48,85,133
61,8477934,Leon Draisaitl,C,EDM,29,82,50,78,128
61,8479318,Auston Matthews,C,TOR,27,82,52,59,111
61,8478864,Kirill Kaprizov,L,MIN,27,82,48,63,111
61,8476887,Filip Forsberg,L,NSH,30,82,55,55,110
61,8481559,Jack Hughes,C,NJD,23,82,38,69,107
61,8482116,Tim Stützle,C,OTT,22,82,32,75,107
61,8474564,Steven Stamkos,C,NSH,34,82,39,65,104
61,8477493,Aleksander Barkov,C,FLA,29,82,33,71,104
61,8477946,Dylan Larkin,C,DET,28,82,42,60,102
61,8476468,J.T. Miller,C,VAN,31,82,34,67,101
61,8479314,Matthew Tkachuk,L,FLA,27,82,28,72,100
61,8480069,Cale Makar,D,COL,26,82,22,77,99
61,8477939,William Nylander,R,TOR,28,82,45,53,98
61,8477933,Sam Reinhart,C,FLA,29,82,52,44,96
61,8478550,Artemi Panarin,L,NYR,33,82,29,67,96
61,8479343,Clayton Keller,R,UTA,26,82,44,51,95
61,8475786,Zach Hyman,L,EDM,32,82,49,45,94
61,8476459,Mika Zibanejad,C,NYR,31,82,34,60,94
61,8480027,Jason Robertson,L,DAL,25,82,34,59,93
61,8471675,Sidney Crosby,C,PIT,37,82,30,63,93
61,8477956,David Pastrnak,R,BOS,28,82,46,46,92
61,8477960,Adrian Kempe,R,LAK,28,82,38,54,92
61,8478445,Mathew Barzal,C,NYI,27,82,28,64,92
61,8478420,Mikko Rantanen,R,COL,28,82,37,53,90
61,8475172,Nazem Kadri,C,CGY,34,82,36,54,90
61,8477942,Kevin Fiala,L,LAK,28,82,31,59,90
61,8478398,Kyle Connor,L,WPG,28,82,48,41,89
61,8475810,Bryan Rust,R,PIT,32,82,51,36,87
61,8476346,Johnny Gaudreau,L,CBJ,31,82,23,64,87
61,8476460,Mark Scheifele,C,WPG,31,82,27,59,86
61,8475913,Mark Stone,R,VGK,32,82,30,55,85
61,8476389,Vincent Trocheck,C,NYR,31,82,27,58,85
61,8476454,Ryan Nugent-Hopkins,C,EDM,31,82,23,62,85
61,8480002,Nico Hischier,C,NJD,25,82,29,55,84
61,8481557,Matt Boldy,L,MIN,23,82,40,43,83
61,8477504,Josh Morrissey,D,WPG,29,82,21,62,83
61,8476853,Morgan Rielly,D,TOR,30,82,12,71,83
61,8471214,Alex Ovechkin,L,WSH,39,82,34,48,82
61,8477951,Nick Schmaltz,C,UTA,28,82,30,52,82
61,8480036,Miro Heiskanen,D,DAL,25,82,24,58,82
61,8480801,Brady Tkachuk,L,OTT,25,82,40,41,81
61,8477940,Nikolaj Ehlers,L,WPG,28,82,31,50,81
61,8478427,Sebastian Aho,C,CAR,27,82,36,44,80
61,8473994,Jamie Benn,L,DAL,35,82,34,46,80
61,8471215,Evgeni Malkin,C,PIT,38,82,29,51,80
61,8480800,Quinn Hughes,D,VAN,25,82,14,66,80
61,8474600,Roman Josi,D,NSH,34,82,13,67,80
61,8477501,Valeri Nichushkin,R,COL,29,82,45,34,79
61,8477409,Carter Verhaeghe,C,FLA,29,82,45,34,79
61,8477404,Jake Guentzel,C,TBL,30,82,37,42,79
61,8478010,Brayden Point,C,TBL,28,82,34,45,79
61,8477447,Shea Theodore,D,VGK,29,82,20,59,79
61,8475784,Jeff Skinner,C,EDM,32,82,39,39,78
61,8480012,Elias Pettersson,C,VAN,26,82,33,45,78
61,8473512,Claude Giroux,R,OTT,36,82,25,51,76
61,8481523,Kirby Dach,C,MTL,23,82,17,59,76
61,8477949,Alex Tuch,R,BUF,28,82,32,42,74
61,8475166,John Tavares,C,TOR,34,82,31,43,74
61,8480830,Andrei Svechnikov,R,CAR,24,82,26,48,74
61,8478873,Troy Terry,R,ANA,27,82,25,49,74
61,8473419,Brad Marchand,L,BOS,36,82,23,51,74
61,8479420,Tage Thompson,C,BUF,27,82,38,35,73
61,8479542,Brandon Hagel,L,TBL,26,82,29,44,73
61,8475765,Vladimir Tarasenko,R,DET,33,82,29,44,73
61,8480023,Robert Thomas,C,STL,25,82,23,50,73
61,8477500,Bo Horvat,C,NYI,29,82,35,37,72
61,8478439,Travis Konecny,R,PHI,27,82,28,44,72
61,8477503,Max Domi,C,TOR,29,82,26,46,72
61,8477416,Oliver Bjorkstrand,R,SEA,29,82,24,48,72
61,8482097,Jack Quinn,R,BUF,23,82,32,39,71
61,8480018,Nick Suzuki,C,MTL,25,82,26,45,71
61,8475168,Matt Duchene,C,DAL,33,82,25,46,71
61,8476539,Jonathan Marchessault,R,NSH,34,82,39,31,70
61,8479323,Adam Fox,D,NYR,26,82,14,56,70
61,8475169,Evander Kane,L,EDM,33,82,32,37,69
61,8480208,Drake Batherson,R,OTT,26,82,31,38,69
61,8471685,Anze Kopitar,C,LAK,37,82,26,43,69
61,8480865,Noah Dobson,D,NYI,24,82,15,53,68
61,8476399,Blake Coleman,C,CGY,33,82,42,25,67
61,8480015,Owen Tippett,R,PHI,25,82,37,30,67
61,8478403,Jack Eichel,C,VGK,28,82,36,31,67
61,8482093,Seth Jarvis,C,CAR,22,82,31,36,67
61,8477496,Elias Lindholm,C,BOS,30,82,27,40,67
61,8478493,Joel Eriksson Ek,C,MIN,27,82,26,41,67
61,8475158,Ryan O'Reilly,C,NSH,33,82,33,33,66
61,8478498,Jake DeBrusk,L,VAN,28,82,32,34,66
61,8477955,Jared McCann,L,SEA,28,82,31,35,66
61,8482665,Matty Beniers,C,SEA,22,82,23,43,66
61,8478407,Vince Dunn,D,SEA,28,82,21,45,66
61,8475692,Mats Zuccarello,R,MIN,37,82,20,46,66
61,8474578,Erik Karlsson,D,PIT,34,82,17,49,66
61,8475184,Chris Kreider,L,NYR,33,82,38,27,65
61,8479675,Trevor Moore,L,LAK,29,82,32,33,65
61,8479337,Alex DeBrincat,R,DET,27,82,28,37,65
61,8476905,Chandler Stephenson,C,SEA,30,82,27,38,65
61,8477402,Pavel Buchnevich,L,STL,29,82,25,40,65
61,8478460,Zach Werenski,D,CBJ,27,82,20,45,65
61,8471698,T.J. Oshie,R,WSH,38,82,34,30,64
61,8479339,Patrik Laine,L,CBJ,26,82,33,31,64
61,8478047,Michael Bunting,L,PIT,29,82,30,34,64
61,8479385,Jordan Kyrou,C,STL,26,82,26,38,64
61,8476881,Tomas Hertl,C,VGK,31,82,24,40,64
61,8479400,Pierre-Luc Dubois,L,WSH,26,82,20,44,64
61,8474563,Drew Doughty,D,LAK,35,82,18,46,64
61,8475167,Victor Hedman,D,TBL,34,82,16,48,64
61,8475754,Brock Nelson,C,NYI,33,82,36,27,63
61,8479407,Jesper Bratt,L,NJD,26,82,28,35,63
61,8474586,Jordan Eberle,R,SEA,34,82,26,37,63
61,8474141,Patrick Kane,R,DET,36,82,24,39,63
61,8475798,Mikael Granlund,C,SJS,32,82,12,51,63
61,8480839,Rasmus Dahlin,D,BUF,24,82,11,52,63
61,8481533,Trevor Zegras,C,ANA,23,82,25,37,62
61,8476882,Teuvo Teravainen,L,CHI,30,82,25,37,62
61,8478438,Tommy Novak,C,NSH,27,82,22,40,62
61,8478440,Dylan Strome,C,WSH,27,82,20,42,62
61,8476456,Jonathan Huberdeau,C,CGY,31,82,11,51,62
61,8481540,Cole Caufield,R,MTL,23,82,39,22,61
61,8482078,Lucas Raymond,L,DET,22,82,28,33,61
61,8480039,Martin Necas,C,CAR,25,82,24,37,61
61,8478975,Mason Marchment,L,DAL,29,82,23,38,61
61,8481528,Dylan Cozens,C,BUF,23,82,22,39,61
61,8477346,MacKenzie Weegar,D,CGY,30,82,17,44,61
61,8479410,Mikhail Sergachev,D,UTA,26,82,10,51,61
61,8478042,Viktor Arvidsson,R,EDM,31,82,30,30,60
61,8471724,Kris Letang,D,PIT,37,82,17,43,60
61,8475218,Mattias Ekholm,D,EDM,34,82,16,44,60
61,8474590,John Carlson,D,WSH,34,82,8,52,60
61,8476432,Boone Jenner,C,CBJ,31,82,35,24,59
61,8480014,Gabriel Vilardi,C,WPG,25,82,30,29,59
61,8478542,Evan Rodrigues,C,FLA,31,82,26,33,59
61,8477497,Sean Monahan,C,CBJ,30,82,21,38,59
61,8474679,Gustav Nyquist,C,NSH,35,82,19,40,59
61,8482684,Luke Hughes,D,NJD,21,82,12,47,59
61,8475170,Brayden Schenn,C,STL,33,82,28,30,58
61,8476483,Rickard Rakell,R,PIT,31,82,27,31,58
61,8475768,Jaden Schwartz,C,SEA,32,82,24,34,58
61,8482745,Mason McTavish,C,ANA,21,82,24,34,58
61,8481711,Matias Maccelli,L,UTA,24,82,17,41,58
61,8479345,Jakob Chychrun,D,WSH,26,82,13,45,58
61,8480803,Evan Bouchard,D,EDM,25,82,7,51,58
61,8482110,Dawson Mercer,C,NJD,23,82,25,32,57
61,8482124,Quinton Byfield,R,LAK,22,82,22,35,57
61,8477935,Sam Bennett,C,FLA,28,82,21,36,57
61,8478055,Gustav Forsling,D,FLA,28,82,16,41,57
61,8478414,Timo Meier,R,NJD,28,82,34,22,56
61,8473986,Alex Killorn,L,ANA,35,82,25,31,56
61,8478458,Jack Roslovic,C,CAR,27,82,23,33,56
61,8477444,Andre Burakovsky,L,SEA,29,82,19,37,56
61,8477986,Brandon Montour,D,SEA,30,82,16,40,56
61,8481542,Moritz Seider,D,DET,23,82,11,45,56
61,8478366,Frank Vatrano,R,ANA,30,82,34,21,55
61,8483808,Andrei Kuzmenko,L,CGY,28,82,29,26,55
61,8482740,Wyatt Johnston,C,DAL,21,82,28,27,55
61,8478449,Roope Hintz,C,DAL,28,82,26,29,55
61,8475745,Charlie Coyle,C,BOS,32,82,22,33,55
61,8478469,Thomas Chabot,D,OTT,27,82,14,41,55
61,8479325,Charlie McAvoy,D,BOS,27,82,14,41,55
61,8480188,Fabian Zetterlund,L,SJS,25,82,14,41,55
61,8478397,Rasmus Andersson,D,CGY,28,82,8,46,54
61,8475794,Tyler Seguin,C,DAL,32,82,27,26,53
61,8474102,David Perron,L,OTT,36,82,22,31,53
61,8481581,Thomas Harley,D,DAL,23,82,12,41,53
61,8476875,Mike Matheson,D,MTL,30,82,9,44,53
61,8478444,Brock Boeser,R,VAN,27,82,27,25,52
61,8475791,Taylor Hall,L,CHI,33,82,22,30,52
61,8478856,Conor Garland,R,VAN,28,82,20,32,52
61,8479999,Casey Mittelstadt,C,COL,26,82,19,33,52
61,8481618,Alex Newhook,C,MTL,23,82,19,33,52
61,8477948,Travis Sanheim,D,PHI,28,82,13,39,52
61,8476906,Shayne Gostisbehere,D,CAR,31,82,5,47,52
61,8476448,William Karlsson,C,VGK,31,82,24,27,51
61,8477456,J.T. Compher,L,DET,29,82,20,31,51
61,8477479,Tyler Bertuzzi,L,CHI,29,82,20,31,51
61,8478401,Pavel Zacha,C,BOS,27,82,19,32,51
61,8480185,Eetu Luostarinen,C,FLA,26,82,17,34,51
61,8473422,Nick Foligno,L,CHI,37,82,17,34,51
61,8480797,Joel Farabee,L,PHI,24,82,16,35,51
61,8474150,Mikael Backlund,C,CGY,35,82,16,35,51
61,8478038,Devon Toews,D,COL,30,82,14,37,51
61,8480434,Sean Durzi,D,UTA,26,82,7,44,51
61,8475722,Jason Zucker,L,BUF,32,82,23,27,50
61,8482146,Luke Evangelista,R,NSH,22,82,23,27,50
61,8482660,Kent Johnson,C,CBJ,22,82,22,28,50
61,8482149,Cole Perfetti,C,WPG,22,82,21,29,50
61,8482175,JJ Peterka,R,BUF,22,82,17,33,50
61,8478396,Noah Hanifin,D,VGK,27,82,14,36,50
61,8479425,Filip Hronek,D,VAN,27,82,11,39,50
61,8474565,Alex Pietrangelo,D,VGK,34,82,10,40,50
61,8476869,Brady Skjei,D,NSH,30,82,9,41,50
61,8482671,Owen Power,D,BUF,22,82,9,41,50
61,8478233,Andrew Mangiapane,L,WSH,28,82,24,25,49
61,8477407,Anthony Duclair,L,NYI,29,82,22,27,49
61,8480028,Morgan Frost,C,PHI,25,82,22,27,49
61,8475191,Reilly Smith,R,NYR,33,82,20,29,49
61,8483515,Juraj Slafkovsky,L,MTL,20,82,18,31,49
61,8482105,Jake Sanderson,D,OTT,22,82,17,32,49
61,8476462,Dougie Hamilton,D,NJD,31,82,15,34,49
61,8477495,Seth Jones,D,CHI,30,82,8,41,49
61,8478882,Vladislav Gavrikov,D,LAK,29,82,8,41,49
61,8481068,Yegor Sharangovich,C,CGY,26,82,23,25,48
61,8477964,Ivan Barbashev,C,VGK,29,82,23,25,48
61,8474053,Logan Couture,C,SJS,35,82,20,28,48
61,8477021,Alex Kerfoot,C,UTA,30,82,13,35,48
61,8476826,Yanni Gourde,C,SEA,33,82,10,38,48
61,8478474,Lawson Crouse,L,UTA,27,82,30,17,47
61,8478115,Pierre Engvall,L,NYI,28,82,23,24,47
61,8476474,Stefan Noesen,R,NJD,31,82,22,25,47
61,8476479,Phillip Danault,C,LAK,31,82,14,33,47
61,8474641,Adam Henrique,C,EDM,34,82,24,22,46
61,8482667,William Eklund,L,SJS,22,82,20,26,46
61,8480798,Philipp Kurashev,C,CHI,25,82,19,27,46
61,8478462,Nicolas Roy,C,VGK,27,82,15,31,46
61,8480078,Filip Chytil,C,NYR,25,82,14,32,46
61,8476458,Ryan Strome,C,ANA,31,82,12,34,46
61,8482109,Alexis Lafrenière,L,NYR,23,82,28,17,45
61,8482699,Dylan Guenther,R,UTA,21,82,24,21,45
61,8481596,Shane Pinto,C,OTT,24,82,21,24,45
61,8482475,Yegor Chinakhov,R,CBJ,23,82,21,24,45
61,8476292,Ondrej Palat,L,NJD,33,82,17,28,45
61,8476923,Damon Severson,D,CBJ,30,82,13,32,45
61,8470613,Brent Burns,D,CAR,39,82,11,34,45
61,8476958,Jaccob Slavin,D,CAR,30,82,8,37,45
61,8481560,Arthur Kaliyev,R,LAK,23,82,27,17,44
61,8480829,Jesperi Kotkaniemi,C,CAR,24,82,25,19,44
61,8482159,Tyson Foerster,R,PHI,22,82,25,19,44
61,8484144,Connor Bedard,C,CHI,19,82,19,25,44
61,8482705,Cole Sillinger,C,CBJ,21,82,19,25,44
61,8482113,Anton Lundell,C,FLA,23,82,17,27,44
61,8477494,Jonathan Drouin,L,COL,29,82,16,28,44
61,8476872,Scott Laughton,C,PHI,30,82,15,29,44
61,8476960,Andreas Athanasiou,C,CHI,30,82,14,30,44
61,8475726,Tyler Toffoli,C,SJS,32,82,22,21,43
61,8480849,Barrett Hayton,C,UTA,24,82,21,22,43
61,8475848,Brendan Gallagher,R,MTL,32,82,21,22,43
61,8479987,Morgan Geekie,C,BOS,26,82,19,24,43
61,8478519,Anthony Cirelli,C,TBL,27,82,13,30,43
61,8477511,Anthony Mantha,R,CGY,30,82,19,23,42
61,8473563,Nicklas Backstrom,C,WSH,37,82,18,24,42
61,8476925,Colton Sissons,C,NSH,31,82,15,27,42
61,8477426,Nicholas Paul,L,TBL,29,82,23,18,41
61,8480009,Eeli Tolvanen,R,SEA,25,82,21,20,41
61,8479365,Trent Frederic,C,BOS,26,82,19,22,41
61,8481624,Ilya Mikheyev,R,CHI,30,82,16,25,41
61,8480835,Jack Drury,C,CAR,24,82,16,25,41
61,8480113,Alex Iafallo,L,WPG,31,82,13,28,41
61,8476854,Hampus Lindholm,D,BOS,30,82,6,35,41
61,8475799,Nino Niederreiter,R,WPG,32,82,20,20,40
61,8480064,Josh Norris,C,OTT,25,82,19,21,40
61,8474189,Lars Eller,C,PIT,35,82,18,22,40
61,8476921,Jordan Martinook,L,CAR,32,82,17,23,40
61,8478472,Mathieu Joseph,R,STL,27,82,14,26,40
61,8479992,Michael Rasmussen,C,DET,25,82,14,26,40
61,8476329,Travis Boyd,C,MIN,31,82,12,28,40
61,8476892,Colton Parayko,D,STL,31,82,10,30,40
61,8482259,Bobby McMann,C,TOR,28,82,25,14,39
61,8477952,Robby Fabbri,C,ANA,28,82,19,20,39
61,8475151,Kyle Palmieri,C,NYI,33,82,17,22,39
61,8481704,Juuso Parssinen,C,NSH,23,82,17,22,39
61,8480802,Ryan McLeod,C,BUF,25,82,16,23,39
61,8477451,Ryan Hartman,R,MIN,30,82,14,25,39
61,8480871,Adam Boqvist,D,FLA,24,82,9,30,39
61,8475764,Cam Fowler,D,ANA,33,82,6,33,39
61,8477476,Artturi Lehkonen,L,COL,29,82,22,16,38
61,8475760,Nick Bjugstad,C,UTA,32,82,20,18,38
61,8480459,Pius Suter,C,VAN,28,82,19,19,38
61,8481580,Connor McMichael,C,WSH,23,82,18,20,38
61,8475793,Ryan Johansen,C,PHI,32,82,16,22,38
61,8481582,Nicholas Robertson,L,TOR,23,82,16,22,38
61,8477406,Mattias Janmark,C,EDM,32,82,15,23,38
61,8478020,Michael Amadio,C,OTT,28,82,14,24,38
61,8475287,Erik Haula,L,NJD,33,82,14,24,38
61,8481481,Blake Lizotte,C,PIT,27,82,14,24,38
61,8477998,Warren Foegele,L,LAK,28,82,13,25,38
61,8478133,Jake Evans,C,MTL,28,82,13,25,38
61,8475763,Kevin Hayes,R,PIT,32,82,12,26,38
61,8475753,Justin Faulk,D,STL,32,82,10,28,38
61,8477498,Darnell Nurse,D,EDM,29,82,9,29,38
61,8480817,K'Andre Miller,D,NYR,24,82,7,31,38
61,8476438,Brandon Saad,L,STL,32,82,19,18,37
61,8478891,Mason Appleton,C,WPG,28,82,14,23,37
61,8476480,Vladislav Namestnikov,C,WPG,32,82,13,24,37
61,8482133,Thomas Bordeleau,C,SJS,22,82,12,25,37
61,8477932,Aaron Ekblad,D,FLA,28,82,12,25,37
61,8478413,Jordan Greenway,L,BUF,27,82,12,25,37
61,8477969,Marcus Pettersson,D,PIT,28,82,7,30,37
61,8480893,Kirill Marchenko,R,CBJ,24,82,25,11,36
61,8475314,Anders Lee,L,NYI,34,82,22,14,36
61,8482055,Drew O'Connor,L,PIT,26,82,20,16,36
61,8470621,Corey Perry,R,EDM,39,82,19,17,36
61,8476880,Tom Wilson,R,WSH,30,82,18,18,36
61,8477429,Andrew Copp,C,DET,30,82,17,19,36
61,8474149,Evgenii Dadonov,R,DAL,35,82,15,21,36
61,8476419,Jean-Gabriel Pageau,C,NYI,32,82,15,21,36
61,8480003,Jesper Boqvist,C,FLA,26,82,15,21,36
61,8480748,Kiefer Sherwood,L,VAN,29,82,14,22,36
61,8479996,Cody Glass,C,NSH,25,82,14,22,36
61,8476927,Teddy Blueger,C,VAN,30,82,13,23,36
61,8477450,Jason Dickinson,C,CHI,29,82,13,23,36
61,8475200,Dmitry Orlov,D,CAR,33,82,11,25,36
61,8480043,Timothy Liljegren,D,TOR,25,82,6,30,36
61,8478500,Ivan Provorov,D,CBJ,27,82,3,33,36
61,8482720,Matthew Knies,L,TOR,22,82,19,16,35
61,8476469,Joel Armia,R,MTL,31,82,18,17,35
61,8478569,Noel Acciari,C,PIT,33,82,18,17,35
61,8476873,Mark Jankowski,C,NSH,30,82,17,18,35
61,8475714,Calle Jarnkrok,C,TOR,33,82,15,20,35
61,8478463,Anthony Beauvillier,L,PIT,27,82,15,20,35
61,8474716,Jared Spurgeon,D,MIN,35,82,13,22,35
61,8477989,Christian Dvorak,C,MTL,28,82,12,23,35
61,8477953,Kasperi Kapanen,R,STL,28,82,12,23,35
61,8484153,Leo Carlsson,C,ANA,20,82,11,24,35
61,8476885,Jacob Trouba,D,NYR,30,82,5,30,35
61,8479398,Samuel Girard,D,COL,26,82,5,30,35
61,8476918,Jimmy Vesey,L,NYR,31,82,21,13,34
61,8482089,Jake Neighbours,L,STL,22,82,19,15,34
61,8476461,Sean Couturier,C,PHI,32,82,18,16,34
61,8481656,Aliaksei Protas,C,WSH,23,82,15,19,34
61,8478057,Dakota Joshua,C,VAN,28,82,15,19,34
61,8478046,Danton Heinen,L,VAN,29,82,14,20,34
61,8479941,Justin Danforth,R,CBJ,31,82,12,22,34
61,8476792,Torey Krug,D,STL,33,82,10,24,34
61,8476374,Sean Kuraly,C,CBJ,31,82,10,24,34
61,8481546,Cam York,D,PHI,23,82,9,25,34
61,8480855,Jack McBain,C,UTA,24,82,5,29,34
61,8482655,J.J. Moser,D,TBL,24,82,2,32,34
61,8476917,Adam Pelech,D,NYI,30,82,1,33,34
61,8480806,Isac Lundestrom,C,ANA,25,82,18,15,33
61,8479351,Sam Steel,C,DAL,26,82,17,16,33
61,8483431,Logan Cooley,C,UTA,20,82,16,17,33
61,8477947,Sonny Milano,L,WSH,28,82,14,19,33
61,8475193,Tomas Tatar,L,NJD,34,82,13,20,33
61,8477839,Conor Sheary,L,TBL,32,82,11,22,33
61,8481606,Jordan Spence,D,LAK,23,82,6,27,33
61,8482074,Connor Zary,C,CGY,23,82,22,10,32
61,8477987,Ryan Donato,C,CHI,28,82,17,15,32
61,8479591,Michael Eyssimont,C,TBL,28,82,16,16,32
61,8481535,Nils Hoglander,L,VAN,24,82,15,17,32
61,8481186,Logan O'Connor,R,COL,28,82,14,18,32
61,8480068,Ryan Poehling,C,PHI,25,82,14,18,32
61,8481604,Pavel Dorofeyev,L,VGK,24,82,14,18,32
61,8480789,Oliver Wahlstrom,R,NYI,24,82,12,20,32
61,8482624,Daniil Miromanov,D,CGY,27,82,11,21,32
61,8476278,Colin Blackwell,C,DAL,31,82,10,22,32
61,8480336,Sean Walker,D,CAR,30,82,9,23,32
61,8475171,Oliver Ekman-Larsson,D,TOR,33,82,4,28,32
61,8481093,Rafael Harvey-Pinard,L,MTL,25,82,19,12,31
61,8479661,Tanner Jeannot,L,LAK,27,82,18,13,31
61,8479353,Brett Howden,C,VGK,26,82,17,14,31
61,8482117,Lukas Reichel,L,CHI,22,82,16,15,31
61,8478109,Victor Olofsson,L,VGK,29,82,16,15,31
61,8478911,Matt Roy,D,WSH,29,82,7,24,31
61,8475181,Nick Leddy,D,STL,33,82,3,28,31
61,8479525,Ross Colton,C,COL,28,82,17,13,30
61,8475343,Nic Dowd,C,WSH,34,82,12,18,30
61,8476392,Adam Lowry,C,WPG,31,82,11,19,30
61,8481013,Jonatan Berggren,R,DET,24,82,10,20,30
61,8480145,Neal Pionk,D,WPG,29,82,9,21,30
61,8480796,Martin Fehervary,D,WSH,25,82,8,22,30
61,8478507,John Marino,D,UTA,27,82,5,25,30
61,8482142,Jamie Drysdale,D,PHI,22,82,4,26,30
61,8481032,Paul Cotter,C,NJD,25,82,18,11,29
61,8476981,Josh Anderson,R,MTL,30,82,18,11,29
61,8479293,Brandon Tanev,L,SEA,33,82,16,13,29
61,8481477,Nico Sturm,C,SJS,29,82,13,16,29
61,8477506,Ryan Pulock,D,NYI,30,82,11,18,29
61,8476312,Josh Manson,D,COL,33,82,11,18,29
61,8477507,Nikita Zadorov,D,BOS,29,82,10,19,29
61,8483457,Lane Hutson,D,MTL,20,82,8,21,29
61,8480873,Rasmus Sandin,D,WSH,24,82,3,26,29
61,8479980,Nicolas Hague,D,VGK,26,82,3,26,29
61,8481554,Kaapo Kakko,R,NYR,23,82,22,6,28
61,8479393,Noah Gregor,C,OTT,26,82,16,12,28
61,8480220,Noah Cates,L,PHI,25,82,8,20,28
61,8477220,Nate Schmidt,D,FLA,33,82,8,20,28
61,8478851,Alexandre Carrier,D,NSH,28,82,6,22,28
61,8478859,Niko Mikkola,D,FLA,28,82,6,22,28
61,8481014,Alexander Romanov,D,NYI,24,82,4,24,28
61,8473507,Jeff Petry,D,DET,37,82,4,24,28
61,8481517,Brett Leason,R,ANA,25,82,19,8,27
61,8473533,Jordan Staal,C,CAR,36,82,16,11,27
61,8477931,Tomas Nosek,L,FLA,32,82,11,16,27
61,8479414,Nathan Bastian,R,NJD,27,82,10,17,27
61,8481553,Bobby Brink,R,PHI,23,82,8,19,27
61,8476457,Adam Larsson,D,SEA,32,82,8,19,27
61,8480878,Nils Lundkvist,D,DAL,24,82,8,19,27
61,8482858,Ryker Evans,D,SEA,23,82,6,21,27
61,8479983,Mario Ferraro,D,SJS,26,82,5,22,27
61,8477435,Ryan Graves,D,PIT,29,82,5,22,27
61,8481708,Zac Jones,D,NYR,24,82,4,23,27
61,8479390,Taylor Raddysh,R,WSH,26,82,15,11,26
61,8482079,Marco Rossi,C,MIN,23,82,15,11,26
61,8474715,Cam Atkinson,R,TBL,35,82,14,12,26
61,8482125,Alexander Holtz,R,VGK,22,82,14,12,26
61,8475855,Jesper Fast,R,CAR,33,82,13,13,26
61,8482092,Ridly Greig,C,OTT,22,82,10,16,26
61,8478013,Jake Walman,D,SJS,28,82,9,17,26
61,8478178,Darren Raddysh,D,TBL,28,82,8,18,26
61,8476467,Jamie Oleksiak,D,SEA,32,82,7,19,26
61,8475231,Casey Cizikas,C,NYI,33,82,7,19,26
61,8476422,Mike Reilly,D,NYI,31,82,7,19,26
61,8475790,Erik Gudbranson,D,CBJ,32,82,3,23,26
61,8479316,Luke Kunin,C,SJS,27,82,18,7,25
61,8476889,Radek Faksa,C,STL,30,82,12,13,25
61,8477425,Miles Wood,L,COL,29,82,11,14,25
61,8480980,Connor Dewar,C,TOR,25,82,9,16,25
61,8482141,Lukas Cormier,D,VGK,22,82,7,18,25
61,8476902,Esa Lindell,D,DAL,30,82,6,19,25
61,8481568,Alex Vlasic,D,CHI,23,82,5,20,25
61,8478136,Jake Middleton,D,MIN,28,82,5,20,25
61,8480246,Nick Perbix,D,TBL,26,82,3,22,25
61,8480035,Henri Jokiharju,D,BUF,25,82,3,22,25
61,8476891,Matt Grzelcyk,D,PIT,30,82,3,22,25
61,8481178,Egor Zamula,D,PHI,24,82,2,23,25
61,8479371,Dante Fabbro,D,NSH,26,82,2,23,25
61,8480813,Joe Veleno,C,DET,24,82,14,10,24
61,8477353,Tyler Motte,C,DET,29,82,13,11,24
61,8477015,Connor Brown,R,EDM,30,82,12,12,24
61,8484166,Adam Fantilli,C,CBJ,20,82,10,14,24
61,8473453,Trevor Lewis,C,LAK,37,82,10,14,24
61,8482077,Dylan Holloway,L,EDM,23,82,9,15,24
61,8482762,Simon Edvinsson,D,DET,21,82,7,17,24
61,8480073,Erik Brannstrom,D,COL,25,82,5,19,24
61,8476463,Jonas Brodin,D,MIN,31,82,4,20,24
61,8482073,Braden Schneider,D,NYR,23,82,4,20,24
61,8482245,Artem Zub,D,OTT,29,82,3,21,24
61,8479998,Mikey Anderson,D,LAK,25,82,3,21,24
61,8480172,Jan Rutta,D,SJS,34,82,1,23,24
61,8480860,Kevin Bahl,D,CGY,24,82,0,24,24
61,8476624,Barclay Goodrow,C,SJS,31,82,17,6,23
61,8482807,Ethan Del Mastro,D,CHI,21,82,15,8,23
61,8478508,Yakov Trenin,C,MIN,27,82,14,9,23
61,8475220,Marcus Foligno,L,MIN,33,82,12,11,23
61,8475149,Marcus Johansson,L,MIN,34,82,12,11,23
61,8484145,Zach Benson,L,BUF,19,82,11,12,23
61,8481028,Martin Pospisil,C,CGY,25,82,11,12,23
61,8480144,David Kampf,C,TOR,29,82,10,13,23
61,8481522,Peyton Krebs,C,BUF,23,82,10,13,23
61,8483468,Jiri Kulich,C,BUF,20,82,10,13,23
61,8480074,Alexandre Texier,C,STL,25,82,9,14,23
61,8477903,Garnet Hathaway,R,PHI,33,82,9,14,23
61,8476897,Oskar Sundqvist,C,STL,30,82,7,16,23
61,8475188,Brayden McNabb,D,VGK,33,82,4,19,23
61,8476525,Colin Miller,D,WPG,32,82,4,19,23
61,8476879,Cody Ceci,D,EDM,31,82,2,21,23
61,8474673,TJ Brodie,D,CHI,34,82,2,21,23
61,8479976,Juuso Valimaki,D,UTA,26,82,1,22,23
61,8483397,Marc McLaughlin,C,BOS,25,82,13,9,22
61,8479368,Max Jones,L,BOS,26,82,11,11,22
61,8482062,Cole Smith,L,NSH,29,82,9,13,22
61,8482111,Justin Barron,D,MTL,23,82,8,14,22
61,8482666,Scott Morrow,D,CAR,22,82,6,16,22
61,8484149,Gavin Brindley,C,CBJ,20,82,6,16,22
61,8474574,Tyler Myers,D,VAN,34,82,4,18,22
61,8476979,Erik Gustafsson,D,DET,32,82,3,19,22
61,8475233,David Savard,D,MTL,34,82,3,19,22
61,8483763,Maksymilian Szuber,D,UTA,22,82,13,8,21
61,8480281,Alexey Toropchenko,R,STL,25,82,12,9,21
61,8484203,Bradly Nadeau,L,CAR,19,82,11,10,21
61,8482155,Alex Laferriere,R,LAK,23,82,10,11,21
61,8480448,Parker Kelly,L,COL,25,82,9,12,21
61,8477508,Curtis Lazar,C,NJD,29,82,8,13,21
61,8478432,Christian Fischer,R,DET,27,82,8,13,21
61,8483012,Logan Morrison,C,SEA,22,82,8,13,21
61,8480025,MacKenzie Entwistle,R,FLA,25,82,8,13,21
61,8477365,Connor Clifton,D,BUF,29,82,4,17,21
61,8479402,Jake Bean,D,CGY,26,82,3,18,21
61,8478416,Erik Cernak,D,TBL,27,82,3,18,21
61,8477488,Brett Pesce,D,NJD,30,82,2,19,21
61,8483495,Simon Nemec,D,NJD,20,82,2,19,21
61,8481699,Aku Raty,R,UTA,23,82,9,11,20
61,8477499,Rasmus Ristolainen,D,PHI,30,82,7,13,20
61,8482702,Logan Stankoven,C,DAL,21,82,6,14,20
61,8477392,Hudson Fasching,R,NYI,29,82,6,14,20
61,8482166,Shakir Mukhamadullin,D,SJS,22,82,6,14,20
61,8477845,Trevor van Riemsdyk,D,WSH,33,82,5,15,20
61,8483505,Matthew Poitras,C,BOS,20,82,5,15,20
61,8480049,Dylan Samberg,D,WPG,25,82,4,16,20
61,8476331,Dylan DeMelo,D,WPG,31,82,4,16,20
61,8478840,Will Borgen,D,SEA,28,82,3,17,20
61,8483490,Pavel Mintyukov,D,ANA,21,82,3,17,20
61,8482087,Kaiden Guhle,D,MTL,22,82,2,18,20
61,8478434,Keegan Kolesar,R,VGK,27,82,8,11,19
61,8481641,Joel Kiviranta,L,COL,28,82,8,11,19
61,8480995,Pontus Holmberg,R,TOR,25,82,6,13,19
61,8474151,Ryan McDonagh,D,TBL,35,82,4,15,19
61,8475455,Brenden Dillon,D,NJD,34,82,4,15,19
61,8483565,Nick Blankenburg,D,NSH,26,82,4,15,19
61,8482803,Olen Zellweger,D,ANA,21,82,3,16,19
61,8480807,Mattias Samuelsson,D,BUF,24,82,3,16,19
61,8481601,Simon Holmstrom,R,NYI,23,82,10,8,18
61,8479359,Beck Malenstyn,L,BUF,26,82,10,8,18
61,8476858,Phillip Di Giuseppe,L,VAN,31,82,10,8,18
61,8481567,Henry Thrun,D,SJS,23,82,7,11,18
61,8482470,Ilya Solovyov,D,CGY,24,82,5,13,18
61,8480021,Jack Studnicka,C,LAK,25,82,4,14,18
61,8480879,Jacob Bernard-Docker,D,OTT,24,82,4,14,18
61,8482809,Jackson Blake,R,CAR,21,82,3,15,18
61,8475177,Calvin de Haan,D,COL,33,82,3,15,18
61,8482122,Brock Faber,D,MIN,22,82,2,16,18
61,8482659,Josh Doan,R,UTA,22,82,11,6,17
61,8475842,Sam Carrick,C,NYR,32,82,10,7,17
61,8479369,Andrew Peeke,D,BOS,26,82,5,12,17
61,8476442,Matt Nieto,L,PIT,32,82,5,12,17
61,8482145,Mavrik Bourque,C,DAL,22,82,5,12,17
61,8483445,Cutter Gauthier,L,ANA,20,82,3,14,17
61,8481524,Bowen Byram,D,BUF,23,82,10,6,16
61,8477505,Alexander Wennberg,C,SJS,30,82,9,7,16
61,8477919,Frederick Gaudreau,C,MIN,31,82,8,8,16
61,8476822,Luke Glendening,C,TBL,35,82,7,9,16
61,8480950,Ilya Lyubushkin,D,DAL,30,82,5,11,16
61,8478468,Jeremy Lauzon,D,NSH,27,82,5,11,16
61,8482118,Sam Colangelo,R,ANA,23,82,5,11,16
61,8483482,Tristan Luneau,D,ANA,20,82,5,11,16
61,8476967,Brett Kulak,D,EDM,30,82,4,12,16
61,8482733,Logan Mailloux,D,MTL,31,82,4,12,16
61,8475279,Ben Chiarot,D,DET,33,82,3,13,16
61,8479324,Ryan Lindgren,D,NYR,26,82,3,13,16
61,8475718,Justin Holl,D,DET,32,82,1,15,16
61,8480222,Sebastian Aho,D,PIT,28,82,0,16,16
61,8476878,Zemgus Girgensons,L,TBL,30,82,11,4,15
61,8478211,Dryden Hunt,L,CGY,29,82,9,6,15
61,8477335,Kyle Burroughs,D,LAK,29,82,5,10,15
61,8478450,Parker Wotherspoon,D,BOS,27,82,3,12,15
61,8480990,Declan Chisholm,D,MIN,24,82,3,12,15
61,8476931,Jake McCabe,D,TOR,31,82,2,13,15
61,8475462,Radko Gudas,D,ANA,34,82,2,13,15
61,8477034,Jaycob Megna,D,FLA,32,82,2,13,15
61,8481605,Jackson LaCombe,D,ANA,23,82,2,13,15
61,8475324,Nick Jensen,D,OTT,34,82,1,14,15
61,8479291,Kevin Rooney,C,CGY,31,82,7,7,14
61,8474062,Riley Nash,C,NYR,35,82,6,8,14
61,8479638,Justin Brazeau,R,BOS,26,82,5,9,14
61,8480834,Ty Emberson,D,SJS,24,82,4,10,14
61,8482679,Matt Coronato,R,CGY,22,82,4,10,14
61,8484911,Collin Graf,R,SJS,22,82,4,10,14
61,8474567,Zach Bogosian,D,MIN,34,82,2,12,14
61,8478443,Brandon Carlo,D,BOS,28,82,1,13,14
61,8476429,Scott Mayfield,D,NYI,32,82,1,13,14
61,8475690,Chris Tanev,D,TOR,35,82,0,14,14
61,8483493,Frank Nazar,C,CHI,20,82,9,4,13
61,8483471,Brad Lambert,C,WPG,31,82,6,7,13
61,8482713,Mackie Samoskevich,R,FLA,22,82,6,7,13
61,8477938,Haydn Fleury,D,WPG,28,82,4,9,13
61,8478874,Adam Gaudette,C,OTT,28,82,3,10,13
61,8474612,Travis Hamonic,D,OTT,34,82,2,11,13
61,8482101,Danil Gushchin,L,SJS,22,82,7,5,12
61,8482859,Zack Ostapchuk,C,OTT,21,82,6,6,12
61,8476473,Connor Murphy,D,CHI,31,82,6,6,12
61,8474090,Brendan Smith,D,DAL,35,82,4,8,12
61,8482516,Matthew Kessel,D,STL,24,82,4,8,12
61,8477369,Carson Soucy,D,VAN,30,82,3,9,12
61,8478399,Jonas Siegenthaler,D,NJD,27,82,2,10,12
61,8483499,Liam Ohgren,L,MIN,20,82,2,10,12
61,8470600,Ryan Suter,D,STL,39,82,1,11,12
61,8482787,Nikita Chibrikov,R,WPG,31,82,0,12,12
61,8480870,Bo Groulx,C,NYR,24,82,5,6,11
61,8474013,Ian Cole,D,UTA,35,82,4,7,11
61,8482153,Brendan Brisson,C,VGK,23,82,4,7,11
61,8482712,Oskar Olausson,R,COL,22,82,3,8,11
61,8475762,Derek Forbort,D,VAN,32,82,1,10,11
61,8483460,David Jiricek,D,CBJ,21,82,1,10,11
61,8483524,Shane Wright,C,SEA,20,82,8,2,10
61,8483567,Georgii Merkulov,C,BOS,24,82,4,6,10
61,8471677,Jack Johnson,D,CBJ,37,82,3,7,10
61,8481122,Simon Benoit,D,TOR,26,82,3,7,10
61,8483489,Fraser Minten,C,TOR,31,82,4,4,8
61,8482749,Joshua Roy,R,MTL,21,82,3,5,8
61,8476372,Nick Seeler,D,PHI,31,82,1,7,8
61,8479576,Vincent Desharnais,D,VAN,28,82,0,8,8
61,8479442,Troy Stecher,D,EDM,30,82,3,4,7
61,8482070,Mitchell Chaffee,R,TBL,26,82,3,4,7
61,8483466,Kevin Korchinski,D,CHI,20,82,1,6,7
61,8476441,Joel Edmundson,D,LAK,31,82,2,3,5
61,8470794,Joe Pavelski,C,,40,0,0,0,0
61,8481703,Valtteri Puustinen,R,PIT,25,0,0,0,0
61,8477950,Tony DeAngelo,D,,29,0,0,0,0
61,8481577,Philip Tomasino,C,NSH,23,0,0,0,0
61,8475197,Tyson Barrie,D,,33,0,0,0,0
61,8471218,Blake Wheeler,R,,38,0,0,0,0
61,8474157,Max Pacioretty,L,,36,0,0,0,0
61,8478466,Daniel Sprong,R,VAN,27,0,0,0,0
61,8475744,Evgeny Kuznetsov,C,,32,0,0,0,0
61,8481019,David Gustafsson,C,WPG,24,0,0,0,0
61,8475906,John Klingberg,D,,32,0,0,0,0
61,8479348,Kale Clague,D,BUF,26,0,0,0,0
61,8476952,Dominic Toninato,C,WPG,30,0,0,0,0
61,8473473,Milan Lucic,L,,36,0,0,0,0
61,8474037,James van Riemsdyk,L,,35,0,0,0,0
61,8474602,Justin Schultz,D,,34,0,0,0,0
61,8482222,Alexander Barabanov,L,,30,0,0,0,0
61,8479372,Josh Mahura,D,SEA,26,0,0,0,0
61,8479982,Conor Timmins,D,TOR,26,0,0,0,0
61,8474031,Kevin Shattenkirk,D,,35,0,0,0,0
61,8480008,Adam Ruzicka,C,,25,0,0,0,0
61,8481059,Scott Perunovich,D,STL,26,0,0,0,0
61,8480884,Calen Addison,D,,24,0,0,0,0
61,8476994,Vinnie Hinostroza,C,NSH,30,0,0,0,0
61,8478452,Caleb Jones,D,LAK,27,0,0,0,0
61,8480157,Calle Rosen,D,COL,30,0,0,0,0
61,8481609,Vladislav Kolyachonok,D,UTA,23,0,0,0,0
61,8479415,Michael McLeod,C,,26,0,0,0,0
61,8476919,Chris Tierney,C,,30,0,0,0,0
61,8479639,Dylan Coghlan,D,WPG,26,0,0,0,0
61,8478146,Matthew Highmore,C,OTT,28,0,0,0,0
61,8478970,Jalen Chatfield,D,CAR,28,0,0,0,0
61,8480205,Emil Bemstrom,C,PIT,25,0,0,0,0
61,8474884,Mike Hoffman,C,,35,0,0,0,0
61,8471274,Alex Goligoski,D,,39,0,0,0,0
61,8478104,Sammy Blais,L,,28,0,0,0,0
61,8474870,Tyler Johnson,C,,34,0,0,0,0
61,8476913,Devin Shore,C,MIN,30,0,0,0,0
61,8481598,Philip Broberg,D,EDM,23,0,0,0,0
61,8480058,Pierre-Olivier Joseph,D,STL,25,0,0,0,0
61,8480891,Michael Kesselring,D,UTA,24,0,0,0,0
61,8477979,Nicolas Aube-Kubel,R,BUF,28,0,0,0,0
61,8476871,Tanner Pearson,L,,32,0,0,0,0
61,8476393,Nick Cousins,C,,31,0,0,0,0
61,8479977,Kailer Yamamoto,R,,26,0,0,0,0
61,8479543,Michael Pezzetta,L,MTL,26,0,0,0,0
61,8477018,Ben Hutton,D,VGK,31,0,0,0,0
61,8480762,Eric Robinson,L,CAR,29,0,0,0,0
61,8474034,Pat Maroon,L,CHI,36,0,0,0,0
61,8481058,Jesse Ylönen,R,,25,0,0,0,0
61,8475179,Dmitry Kulikov,D,FLA,34,0,0,0,0
61,8481527,Kaedan Korczak,D,VGK,23,0,0,0,0
61,8473449,Kyle Okposo,R,,36,0,0,0,0
61,8482192,Isaak Phillips,D,CHI,23,0,0,0,0
61,8480727,Zach Whitecloud,D,VGK,28,0,0,0,0
61,8479346,Dillon Dube,C,,26,0,0,0,0
61,8480821,Filip Zadina,R,,25,0,0,0,0
61,8480001,Urho Vaakanainen,D,ANA,25,0,0,0,0
61,8470966,Mark Giordano,D,,41,0,0,0,0
61,8480853,Liam Foudy,C,,24,0,0,0,0
61,8475225,Craig Smith,C,CHI,35,0,0,0,0
61,8479972,Mason Shaw,C,WPG,26,0,0,0,0
61,8478451,Ethan Bear,D,WSH,27,0,0,0,0
61,8474040,Sam Gagner,C,,35,0,0,0,0
61,8480196,Jacob Bryson,D,BUF,27,0,0,0,0
61,8479984,Cal Foote,D,,26,0,0,0,0
61,8480011,Klim Kostin,C,SJS,25,0,0,0,0
61,8482176,Wyatt Kaiser,D,CHI,22,0,0,0,0
61,8476988,Matt Benning,D,SJS,30,0,0,0,0
61,8479370,Tyson Jost,C,CAR,26,0,0,0,0
61,8477464,Nic Petan,C,,29,0,0,0,0
61,8477380,Jonny Brodzinski,C,NYR,31,0,0,0,0
61,8480070,Ian Mitchell,D,BOS,25,0,0,0,0
61,8479315,Joey Anderson,R,CHI,26,0,0,0,0
61,8478099,Kevin Labanc,R,,29,0,0,0,0
61,8476874,Olli Maatta,D,DET,30,0,0,0,0
61,8475208,Brian Dumoulin,D,ANA,33,0,0,0,0
61,8478430,Oliver Kylington,D,,27,0,0,0,0
61,8479536,Axel Jonsson-Fjallby,L,WPG,26,0,0,0,0
61,8479671,Mathieu Olivier,R,CBJ,27,0,0,0,0
61,8471709,Marc-Edouard Vlasic,D,SJS,37,0,0,0,0
61,8479328,Julien Gauthier,R,NYI,27,0,0,0,0
61,8478421,A.J. Greer,L,FLA,28,0,0,0,0
61,8477573,Nathan Walker,L,STL,30,0,0,0,0
61,8481537,Nikita Okhotiuk,D,CGY,24,0,0,0,0
61,8474166,Alec Martinez,D,CHI,37,0,0,0,0
61,8470610,Zach Parise,L,,40,0,0,0,0
61,8477478,William Carrier,L,CAR,30,0,0,0,0
61,8479344,Jesse Puljujarvi,R,PIT,26,0,0,0,0
61,8480887,Jordan Harris,D,MTL,24,0,0,0,0
61,8478502,Dennis Gilbert,D,BUF,28,0,0,0,0
61,8482730,Brandt Clarke,D,LAK,21,0,0,0,0
61,8480355,Mark Kastelic,C,BOS,25,0,0,0,0
61,8475750,Jon Merrill,D,MIN,32,0,0,0,0
61,8475164,Jakob Silfverberg,R,,34,0,0,0,0
61,8477944,Jakub Vrana,L,,28,0,0,0,0
61,8479439,Jacob MacDonald,D,COL,31,0,0,0,0
61,8474568,Luke Schenn,D,NSH,35,0,0,0,0
61,8478454,Noah Juulsen,D,VAN,27,0,0,0,0
61,8475752,Tyler Pitlick,C,,33,0,0,0,0
61,8482148,Hendrix Lapierre,C,WSH,22,0,0,0,0
61,8481167,Brayden Pachal,D,CGY,25,0,0,0,0
61,8478043,Sam Lafferty,C,BUF,29,0,0,0,0
61,8479321,Lucas Johansen,D,,27,0,0,0,0
61,8471699,Andrew Cogliano,C,,37,0,0,0,0
61,8481521,Ronnie Attard,D,PHI,25,0,0,0,0
61,8481161,Jake Christiansen,D,CBJ,25,0,0,0,0
61,8479458,Nikita Zaitsev,D,,33,0,0,0,0
61,8479619,Michael Carcone,L,UTA,28,0,0,0,0
61,8479026,Philippe Myers,D,TOR,27,0,0,0,0
61,8477330,Dominik Kubalik,L,,29,0,0,0,0
61,8481617,Vasily Podkolzin,R,VAN,23,0,0,0,0
61,8481701,Santeri Hatakka,D,NJD,23,0,0,0,0
61,8479514,Rem Pitlick,C,,27,0,0,0,0
61,8477446,Michael McCarron,R,NSH,29,0,0,0,0
61,8470604,Jeff Carter,C,,39,0,0,0,0
61,8482241,Radim Zohorna,L,,28,0,0,0,0
61,8480289,Morgan Barron,C,WPG,26,0,0,0,0
61,8479379,Givani Smith,R,SJS,26,0,0,0,0
61,8480216,Jacob Peterson,C,,25,0,0,0,0
61,8477851,Jordan Oesterle,D,BOS,32,0,0,0,0
61,8484258,Sam Malinski,D,COL,26,0,0,0,0
61,8478904,Steven Lorentz,C,,28,0,0,0,0
61,8482095,Tyler Kleven,D,OTT,22,0,0,0,0
61,8480848,Ty Dellandrea,C,SJS,24,0,0,0,0
61,8476884,Derrick Pouliot,D,,30,0,0,0,0
61,8479336,Carl Grundstrom,R,SJS,27,0,0,0,0
61,8482964,Arber Xhekaj,D,MTL,23,0,0,0,0
61,8471686,Marc Staal,D,,37,0,0,0,0
61,8477887,Patrick Brown,C,BOS,32,0,0,0,0
61,8478495,Denis Gurianov,R,,27,0,0,0,0
61,8473504,Cal Clutterbuck,R,,37,0,0,0,0
61,8481550,Adam Beckman,L,NJD,23,0,0,0,0
61,8480845,Rasmus Kupari,C,WPG,24,0,0,0,0
61,8474009,Nick Bonino,C,,36,0,0,0,0
61,8478585,Derek Ryan,C,EDM,38,0,0,0,0
61,8477962,Brendan Lemieux,L,CAR,28,0,0,0,0
61,8482861,Vincent Iorio,D,WSH,22,0,0,0,0
61,8479378,Logan Stanley,D,WPG,26,0,0,0,0
61,8473446,Erik Johnson,D,PHI,36,0,0,0,0
61,8481743,Marc Del Gaizo,D,NSH,25,0,0,0,0
61,8477384,Josh Brown,D,EDM,30,0,0,0,0
61,8482165,Yan Kuznetsov,D,CGY,22,0,0,0,0
61,8478424,Jansen Harkins,C,ANA,27,0,0,0,0
61,8482144,Jack Thompson,D,SJS,22,0,0,0,0
61,8478512,Austin Czarnik,C,,32,0,0,0,0
61,8477527,Ross Johnston,L,ANA,30,0,0,0,0
61,8479383,Boris Katchouk,L,,26,0,0,0,0
61,8482094,Daemon Hunt,D,MIN,22,0,0,0,0
61,8481719,Maxwell Crozier,D,TBL,24,0,0,0,0
61,8480192,Johnathan Kovacevic,D,NJD,27,0,0,0,0
61,8479376,Victor Mete,D,,26,0,0,0,0
61,8482511,Mason Lohrei,D,BOS,23,0,0,0,0
61,8475825,Jani Hakanpää,D,,32,0,0,0,0
61,8478021,William Lagesson,D,DET,28,0,0,0,0
61,8475795,Dylan McIlrath,D,WSH,32,0,0,0,0
61,8477846,Ryan Carpenter,C,,33,0,0,0,0
61,8481056,Spencer Stastney,D,NSH,24,0,0,0,0
61,8481564,Ryan Johnson,D,BUF,23,0,0,0,0
61,8478017,Mark Friedman,D,VAN,29,0,0,0,0
61,8479320,Max Lajoie,D,SEA,27,0,0,0,0
61,8480075,Cameron Crotty,D,MIN,25,0,0,0,0
61,8484287,Cole McWard,D,VAN,23,0,0,0,0
61,8484254,Akito Hirose,D,VAN,25,0,0,0,0
61,8483407,Brandon Scanlin,D,NYR,25,0,0,0,0
61,8480274,Philip Kemp,D,EDM,25,0,0,0,0
61,8479522,Hardy Haman Aktell,D,WSH,26,0,0,0,0
61,8480007,Jonas Rondbjerg,R,VGK,25,0,0,0,0
61,8477454,Adam Erne,L,,29,0,0,0,0
61,8481679,Maxence Guenette,D,OTT,23,0,0,0,0
61,8480441,Trey Fix-Wolansky,R,CBJ,25,0,0,0,0
61,8483546,Marshall Rifai,D,TOR,26,0,0,0,0
61,8480084,Nick DeSimone,D,NJD,30,0,0,0,0
61,8481030,Jack St. Ivany,D,PIT,25,0,0,0,0
61,8481592,Jakob Pelletier,L,CGY,23,0,0,0,0
61,8478011,Louie Belpedio,D,PHI,28,0,0,0,0
61,8477930,Pierre-Edouard Bellemare,L,,39,0,0,0,0
61,8484321,Nikolas Matinpalo,D,OTT,26,0,0,0,0
61,8482067,Connor Mackey,D,NYR,28,0,0,0,0
61,8481806,Louis Crevier,D,CHI,23,0,0,0,0
61,8484326,Patrik Koch,D,UTA,28,0,0,0,0
61,8477971,Andreas Englund,D,LAK,28,0,0,0,0
61,8481751,Lukas Rousek,R,BUF,25,0,0,0,0
61,8481006,Tyler Tucker,D,STL,24,0,0,0,0
61,8476867,Brendan Gaunce,C,MIN,30,0,0,0,0
61,8479520,Brandon Duhaime,R,WSH,27,0,0,0,0
61,8477073,Kurtis MacDermid,L,NJD,30,0,0,0,0
61,8480874,Adam Ginning,D,PHI,24,0,0,0,0
61,8477473,Justin Bailey,R,SJS,29,0,0,0,0
61,8479066,Ryan Lomberg,L,CGY,30,0,0,0,0
61,8477070,Liam O'Brien,C,UTA,30,0,0,0,0
61,8474618,Marco Scandella,D,,34,0,0,0,0
61,8475797,Jarred Tinordi,D,,32,0,0,0,0
61,8481441,Joe Snively,C,DET,28,0,0,0,0
61,8477244,Chad Ruhwedel,D,NYR,34,0,0,0,0
61,8479772,Zack MacEwen,R,OTT,28,0,0,0,0
61,8481147,Reese Johnson,C,MIN,26,0,0,0,0
61,8481043,Cole Koepke,L,BOS,26,0,0,0,0
61,8483619,Filip Roos,D,OTT,25,0,0,0,0
61,8481541,Samuel Bolduc,D,NYI,24,0,0,0,0
61,8477810,Joel Hanley,D,CGY,33,0,0,0,0
61,8476907,Mackenzie MacEachern,L,,30,0,0,0,0
61,8482652,Walker Duehr,R,CGY,27,0,0,0,0
61,8477126,Jayson Megna,C,,34,0,0,0,0
61,8483398,Declan Carlile,D,TBL,31,0,0,0,0
61,8482929,Emil Lilleberg,D,TBL,23,0,0,0,0
61,8480880,Jakub Lauko,C,MIN,24,0,0,0,0
61,8480245,Olle Lycksell,R,PHI,25,0,0,0,0
61,8480252,Cole Guttman,C,CHI,25,0,0,0,0
61,8477467,Gustav Olofsson,D,SEA,30,0,0,0,0
61,8479968,Vinni Lettieri,C,BOS,29,0,0,0,0
61,8478400,Colin White,C,,27,0,0,0,0
61,8475755,Alexander Petrovic,D,DAL,32,0,0,0,0
61,8481812,Nikolai Knyzhov,D,,27,0,0,0,0
61,8481593,Jayden Struble,D,MTL,23,0,0,0,0
61,8481532,Alex Turcotte,C,LAK,23,0,0,0,0
61,8482126,Emil Andrae,D,PHI,31,0,0,0,0
61,8479944,Zach Aston-Reese,C,VGK,30,0,0,0,0
61,8471817,Ryan Reaves,R,TOR,37,0,0,0,0
61,8481206,John Ludvig,D,PIT,24,0,0,0,0
61,8481599,Victor Soderstrom,D,UTA,23,0,0,0,0
61,8480292,Carson Meyer,R,ANA,27,0,0,0,0
61,8482496,Nils Aman,C,VAN,24,0,0,0,0
61,8479718,Alex Barré-Boulet,C,MTL,27,0,0,0,0
61,8479994,Jaret Anderson-Dolan,C,WPG,25,0,0,0,0
61,8480184,Gustav Lindstrom,D,,26,0,0,0,0
61,8480890,Jan Jenik,R,OTT,24,0,0,0,0
61,8478067,Oskar Lindblom,L,,28,0,0,0,0
61,8476934,Brock McGinn,L,ANA,30,0,0,0,0
61,8479985,Cale Fleury,D,SEA,26,0,0,0,0
61,8484304,Uvis Balinskis,D,FLA,28,0,0,0,0
61,8479981,Jonah Gadjovich,L,FLA,26,0,0,0,0
61,8481716,Dmitri Voronkov,L,CBJ,24,0,0,0,0
61,8474709,Matt Martin,L,,35,0,0,0,0
61,8482634,Alex Steeves,C,TOR,25,0,0,0,0
61,8480823,Alexander Alexeyev,D,WSH,25,0,0,0,0
61,8477541,Dakota Mermis,D,TOR,30,0,0,0,0
61,8483491,Ivan Miroshnichenko,L,WSH,20,0,0,0,0
61,8478477,Mitchell Stephens,C,SEA,27,0,0,0,0
61,8481543,Nikita Alexandrov,C,STL,24,0,0,0,0
61,8479423,Alex Nylander,L,,26,0,0,0,0
61,8482451,Mikael Pyyhtia,L,CBJ,23,0,0,0,0
61,8478831,Kevin Stenlund,C,UTA,28,0,0,0,0
61,8480306,Grant Hutton,D,NYI,29,0,0,0,0
61,8478028,Fredrik Olofsson,L,,28,0,0,0,0
61,8477462,Robert Hagg,D,VGK,29,0,0,0,0
61,8477320,Anton Blidh,L,NYR,29,0,0,0,0
61,8482157,Will Cuylle,L,NYR,22,0,0,0,0
61,8482737,Zack Bolduc,C,STL,21,0,0,0,0
61,8481239,Samuel Fagemo,L,,24,0,0,0,0
61,8481600,Tobias Bjornfot,D,FLA,23,0,0,0,0
61,8478409,Anthony Richard,C,PHI,28,0,0,0,0
61,8474145,Robert Bortuzzo,D,,35,0,0,0,0
61,8475958,Michael Sgarbossa,C,WSH,32,0,0,0,0
61,8479986,Kole Lind,R,DAL,26,0,0,0,0
61,8479249,Andrew Poturalski,C,SJS,30,0,0,0,0
61,8479362,Riley Tufte,L,BOS,26,0,0,0,0
61,8479991,Jake Leschyshyn,C,NYR,25,0,0,0,0
61,8479587,Rhett Gardner,C,PHI,28,0,0,0,0
61,8482744,James Malatesta,L,CBJ,21,0,0,0,0
61,8478854,Ryan Shea,D,PIT,27,0,0,0,0
61,8481591,Sam Poulin,R,,23,0,0,0,0
61,8483512,Matt Savoie,C,EDM,20,0,0,0,0
61,8482102,Vasily Ponomarev,C,PIT,22,0,0,0,0
61,8482162,Roby Jarventie,L,EDM,22,0,0,0,0
61,8481016,Ruslan Iskhakov,C,,24,0,0,0,0
61,8482172,Landon Slaggert,L,CHI,22,0,0,0,0
61,8482747,Brennan Othmann,L,NYR,21,0,0,0,0
61,8480031,Maxime Comtois,L,,25,0,0,0,0
61,8480226,Marián Studenic,R,,26,0,0,0,0
61,8478408,Travis Dermott,D,,28,0,0,0,0
61,8481518,Nolan Foote,L,NJD,24,0,0,0,0
61,8479419,Brett Murray,L,BUF,26,0,0,0,0
61,8482088,Justin Sourdif,R,FLA,22,0,0,0,0
61,8482201,Gage Goncalves,C,TBL,23,0,0,0,0
61,8481578,Graeme Clarke,R,MIN,23,0,0,0,0
61,8482177,Marat Khusnutdinov,C,MIN,22,0,0,0,0
61,8481754,Nikita Nesterenko,C,ANA,23,0,0,0,0
61,8483531,Brian Halonen,L,NJD,25,0,0,0,0
61,8483920,Pierrick Dube,R,WSH,23,0,0,0,0
61,8480851,Akil Thomas,C,LAK,24,0,0,0,0
61,8475235,Nicolas Deslauriers,L,PHI,33,0,0,0,0
61,8482476,Emil Heineman,L,MTL,23,0,0,0,0
61,8477149,Scott Sabourin,R,SJS,32,0,0,0,0
61,8483549,Lucas Condotta,L,MTL,27,0,0,0,0
61,8482765,Isak Rosen,R,BUF,21,0,0,0,0
61,8481237,Kyle MacLean,C,NYI,25,0,0,0,0
61,8481024,Linus Karlsson,C,VAN,25,0,0,0,0
61,8481690,Tyler Angle,C,,24,0,0,0,0
61,8483570,Ben Meyers,C,SEA,26,0,0,0,0
61,8481655,Cole Schwindt,R,CGY,23,0,0,0,0
61,8481462,Mason Morelli,L,VGK,28,0,0,0,0
61,8483401,Marc Johnstone,R,PIT,28,0,0,0,0
61,8478956,Samuel Laberge,L,NJD,27,0,0,0,0
61,8479533,Joona Koppanen,L,,26,0,0,0,0
61,8482197,Adam Raska,R,MIN,23,0,0,0,0
61,8482250,Callahan Burke,C,VGK,27,0,0,0,0
61,8482784,Zach Dean,C,STL,21,0,0,0,0
61,8484255,Jason Polin,R,COL,25,0,0,0,0
61,8481077,John Leonard,L,,26,0,0,0,0
61,8481534,Raphael Lavoie,C,EDM,24,0,0,0,0
61,8483609,Adam Klapka,R,CGY,24,0,0,0,0
61,8482751,Ryan Winterton,C,SEA,21,0,0,0,0
61,8480267,Sammy Walker,C,MIN,25,0,0,0,0
61,8475766,Austin Watson,L,,32,0,0,0,0
61,8482460,Matt Rempe,C,NYR,22,0,0,0,0
61,8481065,Angus Crookshank,L,OTT,25,0,0,0,0
61,8481070,Hugh McGing,L,,26,0,0,0,0
61,8476323,Max McCormick,L,SEA,32,0,0,0,0
61,8483395,Arshdeep Bains,L,VAN,23,0,0,0,0
61,8484259,Ondrej Pavel,C,COL,31,0,0,0,0
61,8483432,Luca Del Bel Belluz,C,CBJ,31,0,0,0,0
61,8483045,Cameron Butler,R,CBJ,31,0,0,0,0
61,8482061,Brandon Biro,L,SEA,26,0,0,0,0
61,8477401,John Hayden,C,SEA,29,0,0,0,0
61,8475278,Byron Froese,C,,33,0,0,0,0
61,8478446,Glenn Gawdin,C,LAK,27,0,0,0,0
61,8477993,Justin Kirkland,C,CGY,28,0,0,0,0
61,8482147,Jean-Luc Foudy,C,COL,22,0,0,0,0
61,8480032,Shane Bowers,C,NJD,25,0,0,0,0
61,8479330,Brandon Gignac,C,MTL,27,0,0,0,0
61,8480776,Sheldon Rempal,R,,29,0,0,0,0
61,8475413,Justin Dowling,C,NJD,34,0,0,0,0
61,8481726,Adam Edstrom,C,NYR,24,0,0,0,0
61,8480844,Grigori Denisenko,L,VGK,24,0,0,0,0
61,8478147,Bokondji Imama,L,PIT,28,0,0,0,0
61,8478881,Brett Seney,L,CHI,28,0,0,0,0
61,8483630,Pavol Regenda,L,ANA,25,0,0,0,0
61,8480836,Jonathan Gruden,C,,24,0,0,0,0
61,8484314,Jiri Smejkal,L,,28,0,0,0,0
61,8475780,Chris Wagner,R,COL,33,0,0,0,0
61,8479546,Oskar Steen,C,,26,0,0,0,0
61,8483597,Milos Kelemen,L,UTA,25,0,0,0,0
61,8481789,Tye Kartye,L,SEA,23,0,0,0,0
61,8484325,Waltteri Merela,C,TBL,26,0,0,0,0
61,8479421,Jacob Moverare,D,LAK,26,0,0,0,0
61,8481585,Egor Afanasyev,L,SJS,23,0,0,0,0
61,8479547,Matthew Phillips,R,,26,0,0,0,0
61,8479367,William Lockwood,R,FLA,26,0,0,0,0
61,8476915,Jujhar Khaira,L,,30,0,0,0,0
61,8481422,Jacob Lucchini,C,NSH,29,0,0,0,0
61,8480468,James Hamblin,L,EDM,25,0,0,0,0
61,8478051,Max Willman,C,NJD,29,0,0,0,0
61,8481556,John Beecher,C,BOS,23,0,0,0,0
61,8478078,Rourke Chartier,C,,28,0,0,0,0
62,8478402,Connor McDavid,C,EDM,27,82,54,99,153
62,8481559,Jack Hughes,C,NJD,23,82,53,92,145
62,8477939,William Nylander,R,TOR,28,82,64,66,130
62,8477492,Nathan MacKinnon,C,COL,29,82,52,71,123
62,8476453,Nikita Kucherov,R,TBL,31,82,31,92,123
62,8479318,Auston Matthews,C,TOR,27,82,57,65,122
62,8478420,Mikko Rantanen,R,COL,28,82,55,67,122
62,8478864,Kirill Kaprizov,L,MIN,27,82,57,58,115
62,8479314,Matthew Tkachuk,L,FLA,27,82,30,83,113
62,8478550,Artemi Panarin,L,NYR,33,82,27,83,110
62,8477493,Aleksander Barkov,C,FLA,29,82,37,71,108
62,8481557,Matt Boldy,L,MIN,23,82,51,55,106
62,8477934,Leon Draisaitl,C,EDM,29,82,40,66,106
62,8477956,David Pastrnak,R,BOS,28,82,47,57,104
62,8478403,Jack Eichel,C,VGK,28,82,51,52,103
62,8471675,Sidney Crosby,C,PIT,37,82,44,59,103
62,8476468,J.T. Miller,C,VAN,31,82,41,61,102
62,8480069,Cale Makar,D,COL,26,82,25,76,101
62,8475172,Nazem Kadri,C,CGY,34,82,40,59,99
62,8480012,Elias Pettersson,C,VAN,26,82,32,67,99
62,8476887,Filip Forsberg,L,NSH,30,82,44,54,98
62,8479323,Adam Fox,D,NYR,26,82,25,71,96
62,8480027,Jason Robertson,L,DAL,25,82,36,59,95
62,8476459,Mika Zibanejad,C,NYR,31,82,41,53,94
62,8475913,Mark Stone,R,VGK,32,82,30,62,92
62,8480036,Miro Heiskanen,D,DAL,25,82,19,73,92
62,8477404,Jake Guentzel,C,TBL,30,82,46,45,91
62,8480023,Robert Thomas,C,STL,25,82,27,64,91
62,8477409,Carter Verhaeghe,C,FLA,29,82,41,47,88
62,8478427,Sebastian Aho,C,CAR,27,82,37,51,88
62,8474564,Steven Stamkos,C,NSH,34,82,34,53,87
62,8477946,Dylan Larkin,C,DET,28,82,47,39,86
62,8477942,Kevin Fiala,L,LAK,28,82,30,56,86
62,8479407,Jesper Bratt,L,NJD,26,82,22,63,85
62,8471214,Alex Ovechkin,L,WSH,39,82,45,39,84
62,8478449,Roope Hintz,C,DAL,28,82,41,43,84
62,8474600,Roman Josi,D,NSH,34,82,22,62,84
62,8474578,Erik Karlsson,D,PIT,34,82,22,62,84
62,8476389,Vincent Trocheck,C,NYR,31,82,36,47,83
62,8480002,Nico Hischier,C,NJD,25,82,31,52,83
62,8471685,Anze Kopitar,C,LAK,37,82,24,58,82
62,8477933,Sam Reinhart,C,FLA,29,82,46,35,81
62,8480830,Andrei Svechnikov,R,CAR,24,82,35,46,81
62,8476460,Mark Scheifele,C,WPG,31,82,29,52,81
62,8476456,Jonathan Huberdeau,C,CGY,31,82,23,58,81
62,8475692,Mats Zuccarello,R,MIN,37,82,17,64,81
62,8482116,Tim Stützle,C,OTT,22,82,22,58,80
62,8476539,Jonathan Marchessault,R,NSH,34,82,51,28,79
62,8477501,Valeri Nichushkin,R,COL,29,82,38,41,79
62,8480801,Brady Tkachuk,L,OTT,25,82,37,42,79
62,8482078,Lucas Raymond,L,DET,22,82,32,47,79
62,8477949,Alex Tuch,R,BUF,28,82,25,54,79
62,8476853,Morgan Rielly,D,TOR,30,82,13,66,79
62,8475166,John Tavares,C,TOR,34,82,39,39,78
62,8480208,Drake Batherson,R,OTT,26,82,34,44,78
62,8477402,Pavel Buchnevich,L,STL,29,82,34,44,78
62,8480800,Quinn Hughes,D,VAN,25,82,12,66,78
62,8482093,Seth Jarvis,C,CAR,22,82,40,36,76
62,8478445,Mathew Barzal,C,NYI,27,82,28,47,75
62,8478439,Travis Konecny,R,PHI,27,82,28,47,75
62,8474565,Alex Pietrangelo,D,VGK,34,82,17,58,75
62,8478010,Brayden Point,C,TBL,28,82,43,30,73
62,8478444,Brock Boeser,R,VAN,27,82,35,38,73
62,8477960,Adrian Kempe,R,LAK,28,82,32,41,73
62,8477951,Nick Schmaltz,C,UTA,28,82,30,43,73
62,8475168,Matt Duchene,C,DAL,33,82,27,46,73
62,8476346,Johnny Gaudreau,L,CBJ,31,82,16,57,73
62,8479343,Clayton Keller,R,UTA,26,82,35,37,72
62,8473994,Jamie Benn,L,DAL,35,82,27,45,72
62,8475184,Chris Kreider,L,NYR,33,82,42,29,71
62,8477503,Max Domi,C,TOR,29,82,28,43,71
62,8474141,Patrick Kane,R,DET,36,82,23,48,71
62,8475167,Victor Hedman,D,TBL,34,82,19,52,71
62,8478398,Kyle Connor,L,WPG,28,82,33,37,70
62,8476881,Tomas Hertl,C,VGK,31,82,28,42,70
62,8480039,Martin Necas,C,CAR,25,82,28,42,70
62,8478440,Dylan Strome,C,WSH,27,82,24,46,70
62,8482665,Matty Beniers,C,SEA,22,82,25,44,69
62,8479385,Jordan Kyrou,C,STL,26,82,31,37,68
62,8475726,Tyler Toffoli,C,SJS,32,82,31,37,68
62,8481528,Dylan Cozens,C,BUF,23,82,27,41,68
62,8478873,Troy Terry,R,ANA,27,82,26,42,68
62,8479542,Brandon Hagel,L,TBL,26,82,26,42,68
62,8478042,Viktor Arvidsson,R,EDM,31,82,26,42,68
62,8473512,Claude Giroux,R,OTT,36,82,22,46,68
62,8480839,Rasmus Dahlin,D,BUF,24,82,18,50,68
62,8481523,Kirby Dach,C,MTL,23,82,15,53,68
62,8475786,Zach Hyman,L,EDM,32,82,37,30,67
62,8478414,Timo Meier,R,NJD,28,82,36,31,67
62,8479337,Alex DeBrincat,R,DET,27,82,28,39,67
62,8476454,Ryan Nugent-Hopkins,C,EDM,31,82,27,40,67
62,8478493,Joel Eriksson Ek,C,MIN,27,82,27,40,67
62,8476448,William Karlsson,C,VGK,31,82,26,41,67
62,8476462,Dougie Hamilton,D,NJD,31,82,23,44,67
62,8478038,Devon Toews,D,COL,30,82,16,51,67
62,8477416,Oliver Bjorkstrand,R,SEA,29,82,29,37,66
62,8477964,Ivan Barbashev,C,VGK,29,82,27,39,66
62,8480078,Filip Chytil,C,NYR,25,82,22,44,66
62,8480015,Owen Tippett,R,PHI,25,82,37,28,65
62,8475158,Ryan O'Reilly,C,NSH,33,82,26,39,65
62,8477447,Shea Theodore,D,VGK,29,82,13,52,65
62,8480014,Gabriel Vilardi,C,WPG,25,82,45,19,64
62,8476399,Blake Coleman,C,CGY,33,82,38,26,64
62,8479420,Tage Thompson,C,BUF,27,82,27,37,64
62,8482097,Jack Quinn,R,BUF,23,82,25,39,64
62,8475191,Reilly Smith,R,NYR,33,82,24,40,64
62,8475798,Mikael Granlund,C,SJS,32,82,20,44,64
62,8474679,Gustav Nyquist,C,NSH,35,82,19,45,64
62,8478407,Vince Dunn,D,SEA,28,82,13,51,64
62,8473419,Brad Marchand,L,BOS,36,82,23,40,63
62,8478891,Mason Appleton,C,WPG,28,82,22,41,63
62,8480865,Noah Dobson,D,NYI,24,82,9,54,63
62,8479675,Trevor Moore,L,LAK,29,82,29,33,62
62,8482110,Dawson Mercer,C,NJD,23,82,29,33,62
62,8478519,Anthony Cirelli,C,TBL,27,82,29,33,62
62,8471215,Evgeni Malkin,C,PIT,38,82,24,38,62
62,8475784,Jeff Skinner,C,EDM,32,82,18,44,62
62,8475765,Vladimir Tarasenko,R,DET,33,82,17,45,62
62,8474590,John Carlson,D,WSH,34,82,9,53,62
62,8477504,Josh Morrissey,D,WPG,29,82,8,54,62
62,8481540,Cole Caufield,R,MTL,23,82,25,35,60
62,8477496,Elias Lindholm,C,BOS,30,82,23,37,60
62,8482667,William Eklund,L,SJS,22,82,22,38,60
62,8479345,Jakob Chychrun,D,WSH,26,82,21,39,60
62,8478047,Michael Bunting,L,PIT,29,82,18,42,60
62,8476906,Shayne Gostisbehere,D,CAR,31,82,12,48,60
62,8480145,Neal Pionk,D,WPG,29,82,12,48,60
62,8477955,Jared McCann,L,SEA,28,82,33,26,59
62,8482159,Tyson Foerster,R,PHI,22,82,32,27,59
62,8478401,Pavel Zacha,C,BOS,27,82,29,30,59
62,8481533,Trevor Zegras,C,ANA,23,82,17,42,59
62,8470613,Brent Burns,D,CAR,39,82,10,49,59
62,8475754,Brock Nelson,C,NYI,33,82,24,34,58
62,8477940,Nikolaj Ehlers,L,WPG,28,82,21,37,58
62,8482720,Matthew Knies,L,TOR,22,82,15,43,58
62,8478460,Zach Werenski,D,CBJ,27,82,10,48,58
62,8475169,Evander Kane,L,EDM,33,82,32,25,57
62,8475810,Bryan Rust,R,PIT,32,82,28,29,57
62,8478542,Evan Rodrigues,C,FLA,31,82,23,34,57
62,8473986,Alex Killorn,L,ANA,35,82,20,37,57
62,8478856,Conor Garland,R,VAN,28,82,19,38,57
62,8474150,Mikael Backlund,C,CGY,35,82,16,41,57
62,8480803,Evan Bouchard,D,EDM,25,82,6,51,57
62,8482109,Alexis Lafrenière,L,NYR,23,82,32,24,56
62,8474641,Adam Henrique,C,EDM,34,82,26,30,56
62,8478975,Mason Marchment,L,DAL,29,82,25,31,56
62,8477451,Ryan Hartman,R,MIN,30,82,24,32,56
62,8480434,Sean Durzi,D,UTA,26,82,11,45,56
62,8478498,Jake DeBrusk,L,VAN,28,82,31,24,55
62,8476432,Boone Jenner,C,CBJ,31,82,38,16,54
62,8477935,Sam Bennett,C,FLA,28,82,28,26,54
62,8478462,Nicolas Roy,C,VGK,27,82,19,35,54
62,8476461,Sean Couturier,C,PHI,32,82,19,35,54
62,8478469,Thomas Chabot,D,OTT,27,82,15,39,54
62,8476869,Brady Skjei,D,NSH,30,82,15,39,54
62,8475764,Cam Fowler,D,ANA,33,82,5,49,54
62,8477476,Artturi Lehkonen,L,COL,29,82,31,22,53
62,8475794,Tyler Seguin,C,DAL,32,82,22,31,53
62,8476882,Teuvo Teravainen,L,CHI,30,82,20,33,53
62,8475170,Brayden Schenn,C,STL,33,82,20,33,53
62,8480028,Morgan Frost,C,PHI,25,82,19,34,53
62,8477986,Brandon Montour,D,SEA,30,82,13,40,53
62,8479410,Mikhail Sergachev,D,UTA,26,82,8,45,53
62,8479339,Patrik Laine,L,CBJ,26,82,23,29,52
62,8474586,Jordan Eberle,R,SEA,34,82,23,29,52
62,8481581,Thomas Harley,D,DAL,23,82,17,35,52
62,8477495,Seth Jones,D,CHI,30,82,9,43,52
62,8476479,Phillip Danault,C,LAK,31,82,26,25,51
62,8476826,Yanni Gourde,C,SEA,33,82,16,35,51
62,8477494,Jonathan Drouin,L,COL,29,82,15,36,51
62,8476905,Chandler Stephenson,C,SEA,30,82,13,38,51
62,8478396,Noah Hanifin,D,VGK,27,82,11,40,51
62,8471724,Kris Letang,D,PIT,37,82,7,44,51
62,8475151,Kyle Palmieri,C,NYI,33,82,32,18,50
62,8482699,Dylan Guenther,R,UTA,21,82,24,26,50
62,8481068,Yegor Sharangovich,C,CGY,26,82,23,27,50
62,8482745,Mason McTavish,C,ANA,21,82,21,29,50
62,8479999,Casey Mittelstadt,C,COL,26,82,17,33,50
62,8476875,Mike Matheson,D,MTL,30,82,16,34,50
62,8481711,Matias Maccelli,L,UTA,24,82,14,36,50
62,8482149,Cole Perfetti,C,WPG,22,82,13,37,50
62,8479425,Filip Hronek,D,VAN,27,82,13,37,50
62,8476872,Scott Laughton,C,PHI,30,82,11,39,50
62,8475171,Oliver Ekman-Larsson,D,TOR,33,82,11,39,50
62,8477346,MacKenzie Weegar,D,CGY,30,82,10,40,50
62,8476392,Adam Lowry,C,WPG,31,82,31,18,49
62,8480064,Josh Norris,C,OTT,25,82,30,19,49
62,8481582,Nicholas Robertson,L,TOR,23,82,30,19,49
62,8475287,Erik Haula,L,NJD,33,82,24,25,49
62,8473533,Jordan Staal,C,CAR,36,82,23,26,49
62,8481596,Shane Pinto,C,OTT,24,82,21,28,49
62,8478438,Tommy Novak,C,NSH,27,82,20,29,49
62,8480797,Joel Farabee,L,PHI,24,82,18,31,49
62,8480018,Nick Suzuki,C,MTL,25,82,17,32,49
62,8480798,Philipp Kurashev,C,CHI,25,82,17,32,49
62,8478233,Andrew Mangiapane,L,WSH,28,82,16,33,49
62,8477429,Andrew Copp,C,DET,30,82,14,35,49
62,8482684,Luke Hughes,D,NJD,21,82,10,39,49
62,8481542,Moritz Seider,D,DET,23,82,7,42,49
62,8477511,Anthony Mantha,R,CGY,30,82,26,22,48
62,8483808,Andrei Kuzmenko,L,CGY,28,82,24,24,48
62,8477998,Warren Foegele,L,LAK,28,82,22,26,48
62,8480188,Fabian Zetterlund,L,SJS,25,82,20,28,48
62,8477498,Darnell Nurse,D,EDM,29,82,16,32,48
62,8478055,Gustav Forsling,D,FLA,28,82,10,38,48
62,8479325,Charlie McAvoy,D,BOS,27,82,8,40,48
62,8482740,Wyatt Johnston,C,DAL,21,82,28,19,47
62,8482259,Bobby McMann,C,TOR,28,82,25,22,47
62,8477497,Sean Monahan,C,CBJ,30,82,22,25,47
62,8480220,Noah Cates,L,PHI,25,82,17,30,47
62,8474053,Logan Couture,C,SJS,35,82,16,31,47
62,8476979,Erik Gustafsson,D,DET,32,82,13,34,47
62,8482124,Quinton Byfield,R,LAK,22,82,16,30,46
62,8478458,Jack Roslovic,C,CAR,27,82,12,34,46
62,8475218,Mattias Ekholm,D,EDM,34,82,11,35,46
62,8478397,Rasmus Andersson,D,CGY,28,82,8,38,46
62,8476483,Rickard Rakell,R,PIT,31,82,24,21,45
62,8475768,Jaden Schwartz,C,SEA,32,82,24,21,45
62,8480113,Alex Iafallo,L,WPG,31,82,22,23,45
62,8482660,Kent Johnson,C,CBJ,22,82,19,26,45
62,8477932,Aaron Ekblad,D,FLA,28,82,19,26,45
62,8481618,Alex Newhook,C,MTL,23,82,14,31,45
62,8476958,Jaccob Slavin,D,CAR,30,82,8,37,45
62,8478474,Lawson Crouse,L,UTA,27,82,26,18,44
62,8478366,Frank Vatrano,R,ANA,30,82,24,20,44
62,8474149,Evgenii Dadonov,R,DAL,35,82,18,26,44
62,8480849,Barrett Hayton,C,UTA,24,82,17,27,44
62,8480817,K'Andre Miller,D,NYR,24,82,11,33,44
62,8481546,Cam York,D,PHI,23,82,6,38,44
62,8477500,Bo Horvat,C,NYI,29,82,25,18,43
62,8475799,Nino Niederreiter,R,WPG,32,82,23,20,43
62,8473422,Nick Foligno,L,CHI,37,82,21,22,43
62,8478472,Mathieu Joseph,R,STL,27,82,20,23,43
62,8477406,Mattias Janmark,C,EDM,32,82,19,24,43
62,8482133,Thomas Bordeleau,C,SJS,22,82,16,27,43
62,8476927,Teddy Blueger,C,VAN,30,82,12,31,43
62,8481604,Pavel Dorofeyev,L,VGK,24,82,23,19,42
62,8483515,Juraj Slafkovsky,L,MTL,20,82,20,22,42
62,8479400,Pierre-Luc Dubois,L,WSH,26,82,18,24,42
62,8477426,Nicholas Paul,L,TBL,29,82,17,25,42
62,8475791,Taylor Hall,L,CHI,33,82,15,27,42
62,8482113,Anton Lundell,C,FLA,23,82,15,27,42
62,8476921,Jordan Martinook,L,CAR,32,82,15,27,42
62,8477948,Travis Sanheim,D,PHI,28,82,12,30,42
62,8480336,Sean Walker,D,CAR,30,82,12,30,42
62,8475753,Justin Faulk,D,STL,32,82,11,31,42
62,8481704,Juuso Parssinen,C,NSH,23,82,24,17,41
62,8481535,Nils Hoglander,L,VAN,24,82,24,17,41
62,8482055,Drew O'Connor,L,PIT,26,82,21,20,41
62,8477021,Alex Kerfoot,C,UTA,30,82,18,23,41
62,8475745,Charlie Coyle,C,BOS,32,82,15,26,41
62,8475200,Dmitry Orlov,D,CAR,33,82,10,31,41
62,8474716,Jared Spurgeon,D,MIN,35,82,9,32,41
62,8474563,Drew Doughty,D,LAK,35,82,8,33,41
62,8482111,Justin Barron,D,MTL,23,82,21,19,40
62,8477987,Ryan Donato,C,CHI,28,82,19,21,40
62,8479525,Ross Colton,C,COL,28,82,14,26,40
62,8477488,Brett Pesce,D,NJD,30,82,12,28,40
62,8471698,T.J. Oshie,R,WSH,38,82,20,19,39
62,8474102,David Perron,L,OTT,36,82,18,21,39
62,8476458,Ryan Strome,C,ANA,31,82,16,23,39
62,8482105,Jake Sanderson,D,OTT,22,82,14,25,39
62,8479351,Sam Steel,C,DAL,26,82,13,26,39
62,8476292,Ondrej Palat,L,NJD,33,82,11,28,39
62,8476792,Torey Krug,D,STL,33,82,10,29,39
62,8481656,Aliaksei Protas,C,WSH,23,82,9,30,39
62,8479398,Samuel Girard,D,COL,26,82,8,31,39
62,8475722,Jason Zucker,L,BUF,32,82,21,17,38
62,8475763,Kevin Hayes,R,PIT,32,82,18,20,38
62,8476438,Brandon Saad,L,STL,32,82,18,20,38
62,8475793,Ryan Johansen,C,PHI,32,82,16,22,38
62,8477947,Sonny Milano,L,WSH,28,82,15,23,38
62,8475714,Calle Jarnkrok,C,TOR,33,82,14,24,38
62,8479987,Morgan Geekie,C,BOS,26,82,9,29,38
62,8480043,Timothy Liljegren,D,TOR,25,82,7,31,38
62,8480802,Ryan McLeod,C,BUF,25,82,21,16,37
62,8482079,Marco Rossi,C,MIN,23,82,18,19,37
62,8481560,Arthur Kaliyev,R,LAK,23,82,17,20,37
62,8476480,Vladislav Namestnikov,C,WPG,32,82,17,20,37
62,8480068,Ryan Poehling,C,PHI,25,82,16,21,37
62,8477444,Andre Burakovsky,L,SEA,29,82,15,22,37
62,8476960,Andreas Athanasiou,C,CHI,30,82,14,23,37
62,8474189,Lars Eller,C,PIT,35,82,14,23,37
62,8480813,Joe Veleno,C,DET,24,82,13,24,37
62,8475855,Jesper Fast,R,CAR,33,82,12,25,37
62,8477839,Conor Sheary,L,TBL,32,82,11,26,37
62,8482671,Owen Power,D,BUF,22,82,10,27,37
62,8484144,Connor Bedard,C,CHI,19,82,8,29,37
62,8475149,Marcus Johansson,L,MIN,34,82,8,29,37
62,8478507,John Marino,D,UTA,27,82,7,30,37
62,8482089,Jake Neighbours,L,STL,22,82,25,11,36
62,8480806,Isac Lundestrom,C,ANA,25,82,22,14,36
62,8481580,Connor McMichael,C,WSH,23,82,21,15,36
62,8479365,Trent Frederic,C,BOS,26,82,20,16,36
62,8477952,Robby Fabbri,C,ANA,28,82,20,16,36
62,8479293,Brandon Tanev,L,SEA,33,82,20,16,36
62,8478911,Matt Roy,D,WSH,29,82,19,17,36
62,8480009,Eeli Tolvanen,R,SEA,25,82,17,19,36
62,8480855,Jack McBain,C,UTA,24,82,17,19,36
62,8479661,Tanner Jeannot,L,LAK,27,82,16,20,36
62,8478109,Victor Olofsson,L,VGK,29,82,15,21,36
62,8476897,Oskar Sundqvist,C,STL,30,82,11,25,36
62,8478133,Jake Evans,C,MTL,28,82,10,26,36
62,8476854,Hampus Lindholm,D,BOS,30,82,9,27,36
62,8480873,Rasmus Sandin,D,WSH,24,82,7,29,36
62,8477969,Marcus Pettersson,D,PIT,28,82,4,32,36
62,8482175,JJ Peterka,R,BUF,22,82,21,14,35
62,8481477,Nico Sturm,C,SJS,29,82,20,15,35
62,8478020,Michael Amadio,C,OTT,28,82,19,16,35
62,8481554,Kaapo Kakko,R,NYR,23,82,19,16,35
62,8480835,Jack Drury,C,CAR,24,82,17,18,35
62,8470621,Corey Perry,R,EDM,39,82,17,18,35
62,8476880,Tom Wilson,R,WSH,30,82,17,18,35
62,8478115,Pierre Engvall,L,NYI,28,82,16,19,35
62,8475760,Nick Bjugstad,C,UTA,32,82,15,20,35
62,8477953,Kasperi Kapanen,R,STL,28,82,15,20,35
62,8480893,Kirill Marchenko,R,CBJ,24,82,14,21,35
62,8478413,Jordan Greenway,L,BUF,27,82,12,23,35
62,8476873,Mark Jankowski,C,NSH,30,82,12,23,35
62,8479992,Michael Rasmussen,C,DET,25,82,11,24,35
62,8481606,Jordan Spence,D,LAK,23,82,9,26,35
62,8475181,Nick Leddy,D,STL,33,82,6,29,35
62,8476931,Jake McCabe,D,TOR,31,82,5,30,35
62,8478851,Alexandre Carrier,D,NSH,28,82,3,32,35
62,8482125,Alexander Holtz,R,VGK,22,82,22,12,34
62,8481013,Jonatan Berggren,R,DET,24,82,19,15,34
62,8478057,Dakota Joshua,C,VAN,28,82,18,16,34
62,8479316,Luke Kunin,C,SJS,27,82,18,16,34
62,8480829,Jesperi Kotkaniemi,C,CAR,24,82,15,19,34
62,8477015,Connor Brown,R,EDM,30,82,14,20,34
62,8480789,Oliver Wahlstrom,R,NYI,24,82,13,21,34
62,8477425,Miles Wood,L,COL,29,82,13,21,34
62,8480748,Kiefer Sherwood,L,VAN,29,82,12,22,34
62,8478463,Anthony Beauvillier,L,PIT,27,82,11,23,34
62,8476885,Jacob Trouba,D,NYR,30,82,9,25,34
62,8477435,Ryan Graves,D,PIT,29,82,8,26,34
62,8478500,Ivan Provorov,D,CBJ,27,82,4,30,34
62,8476891,Matt Grzelcyk,D,PIT,30,82,4,30,34
62,8476981,Josh Anderson,R,MTL,30,82,20,13,33
62,8482475,Yegor Chinakhov,R,CBJ,23,82,16,17,33
62,8475848,Brendan Gallagher,R,MTL,32,82,13,20,33
62,8484153,Leo Carlsson,C,ANA,20,82,13,20,33
62,8473563,Nicklas Backstrom,C,WSH,37,82,11,22,33
62,8477989,Christian Dvorak,C,MTL,28,82,11,22,33
62,8476467,Jamie Oleksiak,D,SEA,32,82,11,22,33
62,8480871,Adam Boqvist,D,FLA,24,82,9,24,33
62,8478882,Vladislav Gavrikov,D,LAK,29,82,5,28,33
62,8476624,Barclay Goodrow,C,SJS,31,82,17,15,32
62,8483431,Logan Cooley,C,UTA,20,82,16,16,32
62,8476469,Joel Armia,R,MTL,31,82,15,17,32
62,8477456,J.T. Compher,L,DET,29,82,12,20,32
62,8482146,Luke Evangelista,R,NSH,22,82,12,20,32
62,8476474,Stefan Noesen,R,NJD,31,82,12,20,32
62,8476925,Colton Sissons,C,NSH,31,82,12,20,32
62,8482122,Brock Faber,D,MIN,22,82,7,25,32
62,8480144,David Kampf,C,TOR,29,82,6,26,32
62,8473507,Jeff Petry,D,DET,37,82,4,28,32
62,8478508,Yakov Trenin,C,MIN,27,82,19,12,31
62,8482117,Lukas Reichel,L,CHI,22,82,18,13,31
62,8482705,Cole Sillinger,C,CBJ,21,82,16,15,31
62,8480459,Pius Suter,C,VAN,28,82,16,15,31
62,8475314,Anders Lee,L,NYI,34,82,16,15,31
62,8481553,Bobby Brink,R,PHI,23,82,16,15,31
62,8480995,Pontus Holmberg,R,TOR,25,82,13,18,31
62,8477450,Jason Dickinson,C,CHI,29,82,12,19,31
62,8475193,Tomas Tatar,L,NJD,34,82,12,19,31
62,8475220,Marcus Foligno,L,MIN,33,82,12,19,31
62,8477919,Frederick Gaudreau,C,MIN,31,82,12,19,31
62,8476329,Travis Boyd,C,MIN,31,82,8,23,31
62,8476463,Jonas Brodin,D,MIN,31,82,7,24,31
62,8476923,Damon Severson,D,CBJ,30,82,5,26,31
62,8481624,Ilya Mikheyev,R,CHI,30,82,19,11,30
62,8478569,Noel Acciari,C,PIT,33,82,19,11,30
62,8477479,Tyler Bertuzzi,L,CHI,29,82,13,17,30
62,8477407,Anthony Duclair,L,NYI,29,82,13,17,30
62,8480185,Eetu Luostarinen,C,FLA,26,82,11,19,30
62,8479591,Michael Eyssimont,C,TBL,28,82,10,20,30
62,8480878,Nils Lundkvist,D,DAL,24,82,6,24,30
62,8476902,Esa Lindell,D,DAL,30,82,4,26,30
62,8474715,Cam Atkinson,R,TBL,35,82,16,13,29
62,8481186,Logan O'Connor,R,COL,28,82,15,14,29
62,8476917,Adam Pelech,D,NYI,30,82,5,24,29
62,8481178,Egor Zamula,D,PHI,24,82,5,24,29
62,8478136,Jake Middleton,D,MIN,28,82,4,25,29
62,8482074,Connor Zary,C,CGY,23,82,17,11,28
62,8479390,Taylor Raddysh,R,WSH,26,82,16,12,28
62,8479393,Noah Gregor,C,OTT,26,82,15,13,28
62,8483457,Lane Hutson,D,MTL,20,82,13,15,28
62,8479996,Cody Glass,C,NSH,25,82,10,18,28
62,8476419,Jean-Gabriel Pageau,C,NYI,32,82,8,20,28
62,8481517,Brett Leason,R,ANA,25,82,8,20,28
62,8478013,Jake Walman,D,SJS,28,82,8,20,28
62,8478840,Will Borgen,D,SEA,28,82,6,22,28
62,8480074,Alexandre Texier,C,STL,25,82,5,23,28
62,8481601,Simon Holmstrom,R,NYI,23,82,18,9,27
62,8476442,Matt Nieto,L,PIT,32,82,15,12,27
62,8475842,Sam Carrick,C,NYR,32,82,13,14,27
62,8480003,Jesper Boqvist,C,FLA,26,82,10,17,27
62,8476441,Joel Edmundson,D,LAK,31,82,6,21,27
62,8481568,Alex Vlasic,D,CHI,23,82,5,22,27
62,8482142,Jamie Drysdale,D,PHI,22,82,4,23,27
62,8475455,Brenden Dillon,D,NJD,34,82,4,23,27
62,8475690,Chris Tanev,D,TOR,35,82,2,25,27
62,8479353,Brett Howden,C,VGK,26,82,13,13,26
62,8478046,Danton Heinen,L,VAN,29,82,12,14,26
62,8480980,Connor Dewar,C,TOR,25,82,12,14,26
62,8476918,Jimmy Vesey,L,NYR,31,82,11,15,26
62,8479941,Justin Danforth,R,CBJ,31,82,11,15,26
62,8475343,Nic Dowd,C,WSH,34,82,10,16,26
62,8482141,Lukas Cormier,D,VGK,22,82,8,18,26
62,8482166,Shakir Mukhamadullin,D,SJS,22,82,8,18,26
62,8480049,Dylan Samberg,D,WPG,25,82,4,22,26
62,8480073,Erik Brannstrom,D,COL,25,82,2,24,26
62,8481032,Paul Cotter,C,NJD,25,82,15,10,25
62,8477903,Garnet Hathaway,R,PHI,33,82,12,13,25
62,8479368,Max Jones,L,BOS,26,82,12,13,25
62,8484166,Adam Fantilli,C,CBJ,20,82,11,14,25
62,8481524,Bowen Byram,D,BUF,23,82,11,14,25
62,8479291,Kevin Rooney,C,CGY,31,82,8,17,25
62,8474574,Tyler Myers,D,VAN,34,82,6,19,25
62,8483490,Pavel Mintyukov,D,ANA,21,82,6,19,25
62,8478416,Erik Cernak,D,TBL,27,82,4,21,25
62,8483565,Nick Blankenburg,D,NSH,26,82,2,23,25
62,8484203,Bradly Nadeau,L,CAR,19,82,12,12,24
62,8483499,Liam Ohgren,L,MIN,20,82,10,14,24
62,8476374,Sean Kuraly,C,CBJ,31,82,9,15,24
62,8477499,Rasmus Ristolainen,D,PHI,30,82,9,15,24
62,8484911,Collin Graf,R,SJS,22,82,9,15,24
62,8481522,Peyton Krebs,C,BUF,23,82,7,17,24
62,8476312,Josh Manson,D,COL,33,82,6,18,24
62,8476879,Cody Ceci,D,EDM,31,82,6,18,24
62,8482733,Logan Mailloux,D,MTL,31,82,6,18,24
62,8480222,Sebastian Aho,D,PIT,28,82,6,18,24
62,8481093,Rafael Harvey-Pinard,L,MTL,25,82,12,11,23
62,8480281,Alexey Toropchenko,R,STL,25,82,12,11,23
62,8476457,Adam Larsson,D,SEA,32,82,8,15,23
62,8482807,Ethan Del Mastro,D,CHI,21,82,8,15,23
62,8476892,Colton Parayko,D,STL,31,82,6,17,23
62,8479983,Mario Ferraro,D,SJS,26,82,5,18,23
62,8482245,Artem Zub,D,OTT,29,82,5,18,23
62,8480807,Mattias Samuelsson,D,BUF,24,82,5,18,23
62,8479998,Mikey Anderson,D,LAK,25,82,4,19,23
62,8479980,Nicolas Hague,D,VGK,26,82,3,20,23
62,8479324,Ryan Lindgren,D,NYR,26,82,3,20,23
62,8476422,Mike Reilly,D,NYI,31,82,2,21,23
62,8477845,Trevor van Riemsdyk,D,WSH,33,82,1,22,23
62,8476331,Dylan DeMelo,D,WPG,31,82,1,22,23
62,8481481,Blake Lizotte,C,PIT,27,82,12,10,22
62,8476278,Colin Blackwell,C,DAL,31,82,10,12,22
62,8482092,Ridly Greig,C,OTT,22,82,10,12,22
62,8482666,Scott Morrow,D,CAR,22,82,7,15,22
62,8482624,Daniil Miromanov,D,CGY,27,82,6,16,22
62,8475188,Brayden McNabb,D,VGK,33,82,5,17,22
62,8477220,Nate Schmidt,D,FLA,33,82,4,18,22
62,8478859,Niko Mikkola,D,FLA,28,82,4,18,22
62,8475231,Casey Cizikas,C,NYI,33,82,4,18,22
62,8482087,Kaiden Guhle,D,MTL,22,82,4,18,22
62,8477938,Haydn Fleury,D,WPG,28,82,4,18,22
62,8479369,Andrew Peeke,D,BOS,26,82,3,19,22
62,8478178,Darren Raddysh,D,TBL,28,82,2,20,22
62,8480035,Henri Jokiharju,D,BUF,25,82,2,20,22
62,8482073,Braden Schneider,D,NYR,23,82,2,20,22
62,8475324,Nick Jensen,D,OTT,34,82,1,21,22
62,8478434,Keegan Kolesar,R,VGK,27,82,11,10,21
62,8480021,Jack Studnicka,C,LAK,25,82,11,10,21
62,8483524,Shane Wright,C,SEA,20,82,11,10,21
62,8476889,Radek Faksa,C,STL,30,82,10,11,21
62,8477508,Curtis Lazar,C,NJD,29,82,10,11,21
62,8482470,Ilya Solovyov,D,CGY,24,82,8,13,21
62,8483495,Simon Nemec,D,NJD,20,82,7,14,21
62,8478211,Dryden Hunt,L,CGY,29,82,7,14,21
62,8477369,Carson Soucy,D,VAN,30,82,7,14,21
62,8482101,Danil Gushchin,L,SJS,22,82,5,16,21
62,8474567,Zach Bogosian,D,MIN,34,82,4,17,21
62,8480246,Nick Perbix,D,TBL,26,82,3,18,21
62,8470600,Ryan Suter,D,STL,39,82,3,18,21
62,8479371,Dante Fabbro,D,NSH,26,82,2,19,21
62,8479414,Nathan Bastian,R,NJD,27,82,14,6,20
62,8473453,Trevor Lewis,C,LAK,37,82,14,6,20
62,8476858,Phillip Di Giuseppe,L,VAN,31,82,7,13,20
62,8478399,Jonas Siegenthaler,D,NJD,27,82,1,19,20
62,8477353,Tyler Motte,C,DET,29,82,10,9,19
62,8482762,Simon Edvinsson,D,DET,21,82,10,9,19
62,8479359,Beck Malenstyn,L,BUF,26,82,10,9,19
62,8482679,Matt Coronato,R,CGY,22,82,10,9,19
62,8477931,Tomas Nosek,L,FLA,32,82,9,10,19
62,8484145,Zach Benson,L,BUF,19,82,9,10,19
62,8482070,Mitchell Chaffee,R,TBL,26,82,9,10,19
62,8482655,J.J. Moser,D,TBL,24,82,6,13,19
62,8481699,Aku Raty,R,UTA,23,82,6,13,19
62,8477507,Nikita Zadorov,D,BOS,29,82,4,15,19
62,8475279,Ben Chiarot,D,DET,33,82,4,15,19
62,8477365,Connor Clifton,D,BUF,29,82,3,16,19
62,8476967,Brett Kulak,D,EDM,30,82,3,16,19
62,8479402,Jake Bean,D,CGY,26,82,2,17,19
62,8474151,Ryan McDonagh,D,TBL,35,82,2,17,19
62,8480796,Martin Fehervary,D,WSH,25,82,1,18,19
62,8482077,Dylan Holloway,L,EDM,23,82,11,7,18
62,8476822,Luke Glendening,C,TBL,35,82,10,8,18
62,8476878,Zemgus Girgensons,L,TBL,30,82,9,9,18
62,8480025,MacKenzie Entwistle,R,FLA,25,82,7,11,18
62,8483505,Matthew Poitras,C,BOS,20,82,7,11,18
62,8477506,Ryan Pulock,D,NYI,30,82,3,15,18
62,8480172,Jan Rutta,D,SJS,34,82,3,15,18
62,8476525,Colin Miller,D,WPG,32,82,2,16,18
62,8481567,Henry Thrun,D,SJS,23,82,2,16,18
62,8477505,Alexander Wennberg,C,SJS,30,82,9,8,17
62,8482118,Sam Colangelo,R,ANA,23,82,8,9,17
62,8481028,Martin Pospisil,C,CGY,25,82,7,10,17
62,8483445,Cutter Gauthier,L,ANA,20,82,7,10,17
62,8483482,Tristan Luneau,D,ANA,20,82,7,10,17
62,8482803,Olen Zellweger,D,ANA,21,82,6,11,17
62,8482153,Brendan Brisson,C,VGK,23,82,6,11,17
62,8481708,Zac Jones,D,NYR,24,82,5,12,17
62,8482809,Jackson Blake,R,CAR,21,82,5,12,17
62,8480834,Ty Emberson,D,SJS,24,82,4,13,17
62,8474673,TJ Brodie,D,CHI,34,82,2,15,17
62,8479976,Juuso Valimaki,D,UTA,26,82,2,15,17
62,8478432,Christian Fischer,R,DET,27,82,10,6,16
62,8481641,Joel Kiviranta,L,COL,28,82,10,6,16
62,8482062,Cole Smith,L,NSH,29,82,7,9,16
62,8482659,Josh Doan,R,UTA,22,82,7,9,16
62,8480990,Declan Chisholm,D,MIN,24,82,6,10,16
62,8482702,Logan Stankoven,C,DAL,21,82,5,11,16
62,8478443,Brandon Carlo,D,BOS,28,82,4,12,16
62,8475233,David Savard,D,MTL,34,82,1,15,16
62,8482155,Alex Laferriere,R,LAK,23,82,12,3,15
62,8483493,Frank Nazar,C,CHI,20,82,8,7,15
62,8483471,Brad Lambert,C,WPG,31,82,6,9,15
62,8481122,Simon Benoit,D,TOR,26,82,6,9,15
62,8479442,Troy Stecher,D,EDM,30,82,5,10,15
62,8483012,Logan Morrison,C,SEA,22,82,4,11,15
62,8476473,Connor Murphy,D,CHI,31,82,3,12,15
62,8475762,Derek Forbort,D,VAN,32,82,2,13,15
62,8480879,Jacob Bernard-Docker,D,OTT,24,82,1,14,15
62,8482145,Mavrik Bourque,C,DAL,22,82,7,7,14
62,8477034,Jaycob Megna,D,FLA,32,82,5,9,14
62,8483460,David Jiricek,D,CBJ,21,82,5,9,14
62,8480950,Ilya Lyubushkin,D,DAL,30,82,3,11,14
62,8475790,Erik Gudbranson,D,CBJ,32,82,2,12,14
62,8483468,Jiri Kulich,C,BUF,20,82,2,12,14
62,8482749,Joshua Roy,R,MTL,21,82,6,7,13
62,8483763,Maksymilian Szuber,D,UTA,22,82,5,8,13
62,8480448,Parker Kelly,L,COL,25,82,5,8,13
62,8474612,Travis Hamonic,D,OTT,34,82,3,10,13
62,8483489,Fraser Minten,C,TOR,31,82,3,10,13
62,8481014,Alexander Romanov,D,NYI,24,82,2,11,13
62,8482859,Zack Ostapchuk,C,OTT,21,82,2,11,13
62,8475462,Radko Gudas,D,ANA,34,82,1,12,13
62,8478874,Adam Gaudette,C,OTT,28,82,1,12,13
62,8482858,Ryker Evans,D,SEA,23,82,6,6,12
62,8480870,Bo Groulx,C,NYR,24,82,6,6,12
62,8471677,Jack Johnson,D,CBJ,37,82,4,8,12
62,8478468,Jeremy Lauzon,D,NSH,27,82,2,10,12
62,8482712,Oskar Olausson,R,COL,22,82,8,3,11
62,8482713,Mackie Samoskevich,R,FLA,22,82,6,5,11
62,8482516,Matthew Kessel,D,STL,24,82,5,6,11
62,8476372,Nick Seeler,D,PHI,31,82,3,8,11
62,8477335,Kyle Burroughs,D,LAK,29,82,0,11,11
62,8483397,Marc McLaughlin,C,BOS,25,82,9,1,10
62,8483466,Kevin Korchinski,D,CHI,20,82,6,4,10
62,8474090,Brendan Smith,D,DAL,35,82,4,6,10
62,8477392,Hudson Fasching,R,NYI,29,82,3,7,10
62,8475718,Justin Holl,D,DET,32,82,3,7,10
62,8476429,Scott Mayfield,D,NYI,32,82,3,7,10
62,8475177,Calvin de Haan,D,COL,33,82,2,8,10
62,8474013,Ian Cole,D,UTA,35,82,2,8,10
62,8480860,Kevin Bahl,D,CGY,24,82,1,9,10
62,8478450,Parker Wotherspoon,D,BOS,27,82,1,9,10
62,8483567,Georgii Merkulov,C,BOS,24,82,7,2,9
62,8479638,Justin Brazeau,R,BOS,26,82,4,5,9
62,8481605,Jackson LaCombe,D,ANA,23,82,3,6,9
62,8482787,Nikita Chibrikov,R,WPG,31,82,2,7,9
62,8474062,Riley Nash,C,NYR,35,82,2,6,8
62,8479576,Vincent Desharnais,D,VAN,28,82,0,8,8
62,8484149,Gavin Brindley,C,CBJ,20,82,5,2,7
62,8470794,Joe Pavelski,C,,40,0,0,0,0
62,8481703,Valtteri Puustinen,R,PIT,25,0,0,0,0
62,8477950,Tony DeAngelo,D,,29,0,0,0,0
62,8481577,Philip Tomasino,C,NSH,23,0,0,0,0
62,8475197,Tyson Barrie,D,,33,0,0,0,0
62,8471218,Blake Wheeler,R,,38,0,0,0,0
62,8474157,Max Pacioretty,L,,36,0,0,0,0
62,8478466,Daniel Sprong,R,VAN,27,0,0,0,0
62,8475744,Evgeny Kuznetsov,C,,32,0,0,0,0
62,8481019,David Gustafsson,C,WPG,24,0,0,0,0
62,8475906,John Klingberg,D,,32,0,0,0,0
62,8479348,Kale Clague,D,BUF,26,0,0,0,0
62,8476952,Dominic Toninato,C,WPG,30,0,0,0,0
62,8473473,Milan Lucic,L,,36,0,0,0,0
62,8474037,James van Riemsdyk,L,,35,0,0,0,0
62,8474602,Justin Schultz,D,,34,0,0,0,0
62,8482222,Alexander Barabanov,L,,30,0,0,0,0
62,8479372,Josh Mahura,D,SEA,26,0,0,0,0
62,8479982,Conor Timmins,D,TOR,26,0,0,0,0
62,8474031,Kevin Shattenkirk,D,,35,0,0,0,0
62,8480008,Adam Ruzicka,C,,25,0,0,0,0
62,8481059,Scott Perunovich,D,STL,26,0,0,0,0
62,8480884,Calen Addison,D,,24,0,0,0,0
62,8476994,Vinnie Hinostroza,C,NSH,30,0,0,0,0
62,8478452,Caleb Jones,D,LAK,27,0,0,0,0
62,8480157,Calle Rosen,D,COL,30,0,0,0,0
62,8481609,Vladislav Kolyachonok,D,UTA,23,0,0,0,0
62,8479415,Michael McLeod,C,,26,0,0,0,0
62,8476919,Chris Tierney,C,,30,0,0,0,0
62,8479639,Dylan Coghlan,D,WPG,26,0,0,0,0
62,8478146,Matthew Highmore,C,OTT,28,0,0,0,0
62,8478970,Jalen Chatfield,D,CAR,28,0,0,0,0
62,8480205,Emil Bemstrom,C,PIT,25,0,0,0,0
62,8474884,Mike Hoffman,C,,35,0,0,0,0
62,8471274,Alex Goligoski,D,,39,0,0,0,0
62,8478104,Sammy Blais,L,,28,0,0,0,0
62,8474870,Tyler Johnson,C,,34,0,0,0,0
62,8476913,Devin Shore,C,MIN,30,0,0,0,0
62,8481598,Philip Broberg,D,EDM,23,0,0,0,0
62,8480058,Pierre-Olivier Joseph,D,STL,25,0,0,0,0
62,8480891,Michael Kesselring,D,UTA,24,0,0,0,0
62,8477979,Nicolas Aube-Kubel,R,BUF,28,0,0,0,0
62,8476871,Tanner Pearson,L,,32,0,0,0,0
62,8476393,Nick Cousins,C,,31,0,0,0,0
62,8479977,Kailer Yamamoto,R,,26,0,0,0,0
62,8479543,Michael Pezzetta,L,MTL,26,0,0,0,0
62,8477018,Ben Hutton,D,VGK,31,0,0,0,0
62,8480762,Eric Robinson,L,CAR,29,0,0,0,0
62,8474034,Pat Maroon,L,CHI,36,0,0,0,0
62,8481058,Jesse Ylönen,R,,25,0,0,0,0
62,8475179,Dmitry Kulikov,D,FLA,34,0,0,0,0
62,8481527,Kaedan Korczak,D,VGK,23,0,0,0,0
62,8473449,Kyle Okposo,R,,36,0,0,0,0
62,8482192,Isaak Phillips,D,CHI,23,0,0,0,0
62,8480727,Zach Whitecloud,D,VGK,28,0,0,0,0
62,8479346,Dillon Dube,C,,26,0,0,0,0
62,8480821,Filip Zadina,R,,25,0,0,0,0
62,8480001,Urho Vaakanainen,D,ANA,25,0,0,0,0
62,8470966,Mark Giordano,D,,41,0,0,0,0
62,8480853,Liam Foudy,C,,24,0,0,0,0
62,8475225,Craig Smith,C,CHI,35,0,0,0,0
62,8479972,Mason Shaw,C,WPG,26,0,0,0,0
62,8478451,Ethan Bear,D,WSH,27,0,0,0,0
62,8474040,Sam Gagner,C,,35,0,0,0,0
62,8480196,Jacob Bryson,D,BUF,27,0,0,0,0
62,8479984,Cal Foote,D,,26,0,0,0,0
62,8480011,Klim Kostin,C,SJS,25,0,0,0,0
62,8482176,Wyatt Kaiser,D,CHI,22,0,0,0,0
62,8476988,Matt Benning,D,SJS,30,0,0,0,0
62,8479370,Tyson Jost,C,CAR,26,0,0,0,0
62,8477464,Nic Petan,C,,29,0,0,0,0
62,8477380,Jonny Brodzinski,C,NYR,31,0,0,0,0
62,8480070,Ian Mitchell,D,BOS,25,0,0,0,0
62,8479315,Joey Anderson,R,CHI,26,0,0,0,0
62,8478099,Kevin Labanc,R,,29,0,0,0,0
62,8476874,Olli Maatta,D,DET,30,0,0,0,0
62,8475208,Brian Dumoulin,D,ANA,33,0,0,0,0
62,8478430,Oliver Kylington,D,,27,0,0,0,0
62,8479536,Axel Jonsson-Fjallby,L,WPG,26,0,0,0,0
62,8479671,Mathieu Olivier,R,CBJ,27,0,0,0,0
62,8471709,Marc-Edouard Vlasic,D,SJS,37,0,0,0,0
62,8479328,Julien Gauthier,R,NYI,27,0,0,0,0
62,8478421,A.J. Greer,L,FLA,28,0,0,0,0
62,8477573,Nathan Walker,L,STL,30,0,0,0,0
62,8481537,Nikita Okhotiuk,D,CGY,24,0,0,0,0
62,8474166,Alec Martinez,D,CHI,37,0,0,0,0
62,8470610,Zach Parise,L,,40,0,0,0,0
62,8477478,William Carrier,L,CAR,30,0,0,0,0
62,8479344,Jesse Puljujarvi,R,PIT,26,0,0,0,0
62,8480887,Jordan Harris,D,MTL,24,0,0,0,0
62,8478502,Dennis Gilbert,D,BUF,28,0,0,0,0
62,8482730,Brandt Clarke,D,LAK,21,0,0,0,0
62,8480355,Mark Kastelic,C,BOS,25,0,0,0,0
62,8475750,Jon Merrill,D,MIN,32,0,0,0,0
62,8475164,Jakob Silfverberg,R,,34,0,0,0,0
62,8477944,Jakub Vrana,L,,28,0,0,0,0
62,8479439,Jacob MacDonald,D,COL,31,0,0,0,0
62,8474568,Luke Schenn,D,NSH,35,0,0,0,0
62,8478454,Noah Juulsen,D,VAN,27,0,0,0,0
62,8475752,Tyler Pitlick,C,,33,0,0,0,0
62,8482148,Hendrix Lapierre,C,WSH,22,0,0,0,0
62,8481167,Brayden Pachal,D,CGY,25,0,0,0,0
62,8478043,Sam Lafferty,C,BUF,29,0,0,0,0
62,8479321,Lucas Johansen,D,,27,0,0,0,0
62,8471699,Andrew Cogliano,C,,37,0,0,0,0
62,8481521,Ronnie Attard,D,PHI,25,0,0,0,0
62,8481161,Jake Christiansen,D,CBJ,25,0,0,0,0
62,8479458,Nikita Zaitsev,D,,33,0,0,0,0
62,8479619,Michael Carcone,L,UTA,28,0,0,0,0
62,8479026,Philippe Myers,D,TOR,27,0,0,0,0
62,8477330,Dominik Kubalik,L,,29,0,0,0,0
62,8481617,Vasily Podkolzin,R,VAN,23,0,0,0,0
62,8481701,Santeri Hatakka,D,NJD,23,0,0,0,0
62,8479514,Rem Pitlick,C,,27,0,0,0,0
62,8477446,Michael McCarron,R,NSH,29,0,0,0,0
62,8470604,Jeff Carter,C,,39,0,0,0,0
62,8482241,Radim Zohorna,L,,28,0,0,0,0
62,8480289,Morgan Barron,C,WPG,26,0,0,0,0
62,8479379,Givani Smith,R,SJS,26,0,0,0,0
62,8480216,Jacob Peterson,C,,25,0,0,0,0
62,8477851,Jordan Oesterle,D,BOS,32,0,0,0,0
62,8484258,Sam Malinski,D,COL,26,0,0,0,0
62,8478904,Steven Lorentz,C,,28,0,0,0,0
62,8482095,Tyler Kleven,D,OTT,22,0,0,0,0
62,8480848,Ty Dellandrea,C,SJS,24,0,0,0,0
62,8476884,Derrick Pouliot,D,,30,0,0,0,0
62,8479336,Carl Grundstrom,R,SJS,27,0,0,0,0
62,8482964,Arber Xhekaj,D,MTL,23,0,0,0,0
62,8471686,Marc Staal,D,,37,0,0,0,0
62,8477887,Patrick Brown,C,BOS,32,0,0,0,0
62,8478495,Denis Gurianov,R,,27,0,0,0,0
62,8473504,Cal Clutterbuck,R,,37,0,0,0,0
62,8481550,Adam Beckman,L,NJD,23,0,0,0,0
62,8480845,Rasmus Kupari,C,WPG,24,0,0,0,0
62,8474009,Nick Bonino,C,,36,0,0,0,0
62,8478585,Derek Ryan,C,EDM,38,0,0,0,0
62,8477962,Brendan Lemieux,L,CAR,28,0,0,0,0
62,8482861,Vincent Iorio,D,WSH,22,0,0,0,0
62,8479378,Logan Stanley,D,WPG,26,0,0,0,0
62,8473446,Erik Johnson,D,PHI,36,0,0,0,0
62,8481743,Marc Del Gaizo,D,NSH,25,0,0,0,0
62,8477384,Josh Brown,D,EDM,30,0,0,0,0
62,8482165,Yan Kuznetsov,D,CGY,22,0,0,0,0
62,8478424,Jansen Harkins,C,ANA,27,0,0,0,0
62,8482144,Jack Thompson,D,SJS,22,0,0,0,0
62,8478512,Austin Czarnik,C,,32,0,0,0,0
62,8477527,Ross Johnston,L,ANA,30,0,0,0,0
62,8479383,Boris Katchouk,L,,26,0,0,0,0
62,8482094,Daemon Hunt,D,MIN,22,0,0,0,0
62,8481719,Maxwell Crozier,D,TBL,24,0,0,0,0
62,8480192,Johnathan Kovacevic,D,NJD,27,0,0,0,0
62,8479376,Victor Mete,D,,26,0,0,0,0
62,8482511,Mason Lohrei,D,BOS,23,0,0,0,0
62,8475825,Jani Hakanpää,D,,32,0,0,0,0
62,8478021,William Lagesson,D,DET,28,0,0,0,0
62,8475795,Dylan McIlrath,D,WSH,32,0,0,0,0
62,8477846,Ryan Carpenter,C,,33,0,0,0,0
62,8481056,Spencer Stastney,D,NSH,24,0,0,0,0
62,8481564,Ryan Johnson,D,BUF,23,0,0,0,0
62,8478017,Mark Friedman,D,VAN,29,0,0,0,0
62,8479320,Max Lajoie,D,SEA,27,0,0,0,0
62,8480075,Cameron Crotty,D,MIN,25,0,0,0,0
62,8484287,Cole McWard,D,VAN,23,0,0,0,0
62,8484254,Akito Hirose,D,VAN,25,0,0,0,0
62,8483407,Brandon Scanlin,D,NYR,25,0,0,0,0
62,8480274,Philip Kemp,D,EDM,25,0,0,0,0
62,8479522,Hardy Haman Aktell,D,WSH,26,0,0,0,0
62,8480007,Jonas Rondbjerg,R,VGK,25,0,0,0,0
62,8477454,Adam Erne,L,,29,0,0,0,0
62,8481679,Maxence Guenette,D,OTT,23,0,0,0,0
62,8480441,Trey Fix-Wolansky,R,CBJ,25,0,0,0,0
62,8483546,Marshall Rifai,D,TOR,26,0,0,0,0
62,8480084,Nick DeSimone,D,NJD,30,0,0,0,0
62,8481030,Jack St. Ivany,D,PIT,25,0,0,0,0
62,8481592,Jakob Pelletier,L,CGY,23,0,0,0,0
62,8478011,Louie Belpedio,D,PHI,28,0,0,0,0
62,8477930,Pierre-Edouard Bellemare,L,,39,0,0,0,0
62,8484321,Nikolas Matinpalo,D,OTT,26,0,0,0,0
62,8482067,Connor Mackey,D,NYR,28,0,0,0,0
62,8481806,Louis Crevier,D,CHI,23,0,0,0,0
62,8484326,Patrik Koch,D,UTA,28,0,0,0,0
62,8477971,Andreas Englund,D,LAK,28,0,0,0,0
62,8481751,Lukas Rousek,R,BUF,25,0,0,0,0
62,8481006,Tyler Tucker,D,STL,24,0,0,0,0
62,8476867,Brendan Gaunce,C,MIN,30,0,0,0,0
62,8479520,Brandon Duhaime,R,WSH,27,0,0,0,0
62,8477073,Kurtis MacDermid,L,NJD,30,0,0,0,0
62,8480874,Adam Ginning,D,PHI,24,0,0,0,0
62,8477473,Justin Bailey,R,SJS,29,0,0,0,0
62,8479066,Ryan Lomberg,L,CGY,30,0,0,0,0
62,8477070,Liam O'Brien,C,UTA,30,0,0,0,0
62,8474618,Marco Scandella,D,,34,0,0,0,0
62,8475797,Jarred Tinordi,D,,32,0,0,0,0
62,8481441,Joe Snively,C,DET,28,0,0,0,0
62,8477244,Chad Ruhwedel,D,NYR,34,0,0,0,0
62,8479772,Zack MacEwen,R,OTT,28,0,0,0,0
62,8481147,Reese Johnson,C,MIN,26,0,0,0,0
62,8481043,Cole Koepke,L,BOS,26,0,0,0,0
62,8483619,Filip Roos,D,OTT,25,0,0,0,0
62,8481541,Samuel Bolduc,D,NYI,24,0,0,0,0
62,8477810,Joel Hanley,D,CGY,33,0,0,0,0
62,8476907,Mackenzie MacEachern,L,,30,0,0,0,0
62,8482652,Walker Duehr,R,CGY,27,0,0,0,0
62,8477126,Jayson Megna,C,,34,0,0,0,0
62,8483398,Declan Carlile,D,TBL,31,0,0,0,0
62,8482929,Emil Lilleberg,D,TBL,23,0,0,0,0
62,8480880,Jakub Lauko,C,MIN,24,0,0,0,0
62,8480245,Olle Lycksell,R,PHI,25,0,0,0,0
62,8480252,Cole Guttman,C,CHI,25,0,0,0,0
62,8477467,Gustav Olofsson,D,SEA,30,0,0,0,0
62,8479968,Vinni Lettieri,C,BOS,29,0,0,0,0
62,8478400,Colin White,C,,27,0,0,0,0
62,8475755,Alexander Petrovic,D,DAL,32,0,0,0,0
62,8481812,Nikolai Knyzhov,D,,27,0,0,0,0
62,8481593,Jayden Struble,D,MTL,23,0,0,0,0
62,8481532,Alex Turcotte,C,LAK,23,0,0,0,0
62,8482126,Emil Andrae,D,PHI,31,0,0,0,0
62,8479944,Zach Aston-Reese,C,VGK,30,0,0,0,0
62,8471817,Ryan Reaves,R,TOR,37,0,0,0,0
62,8481206,John Ludvig,D,PIT,24,0,0,0,0
62,8481599,Victor Soderstrom,D,UTA,23,0,0,0,0
62,8480292,Carson Meyer,R,ANA,27,0,0,0,0
62,8482496,Nils Aman,C,VAN,24,0,0,0,0
62,8479718,Alex Barré-Boulet,C,MTL,27,0,0,0,0
62,8479994,Jaret Anderson-Dolan,C,WPG,25,0,0,0,0
62,8480184,Gustav Lindstrom,D,,26,0,0,0,0
62,8480890,Jan Jenik,R,OTT,24,0,0,0,0
62,8478067,Oskar Lindblom,L,,28,0,0,0,0
62,8476934,Brock McGinn,L,ANA,30,0,0,0,0
62,8479985,Cale Fleury,D,SEA,26,0,0,0,0
62,8484304,Uvis Balinskis,D,FLA,28,0,0,0,0
62,8479981,Jonah Gadjovich,L,FLA,26,0,0,0,0
62,8481716,Dmitri Voronkov,L,CBJ,24,0,0,0,0
62,8474709,Matt Martin,L,,35,0,0,0,0
62,8482634,Alex Steeves,C,TOR,25,0,0,0,0
62,8480823,Alexander Alexeyev,D,WSH,25,0,0,0,0
62,8477541,Dakota Mermis,D,TOR,30,0,0,0,0
62,8483491,Ivan Miroshnichenko,L,WSH,20,0,0,0,0
62,8478477,Mitchell Stephens,C,SEA,27,0,0,0,0
62,8481543,Nikita Alexandrov,C,STL,24,0,0,0,0
62,8479423,Alex Nylander,L,,26,0,0,0,0
62,8482451,Mikael Pyyhtia,L,CBJ,23,0,0,0,0
62,8478831,Kevin Stenlund,C,UTA,28,0,0,0,0
62,8480306,Grant Hutton,D,NYI,29,0,0,0,0
62,8478028,Fredrik Olofsson,L,,28,0,0,0,0
62,8477462,Robert Hagg,D,VGK,29,0,0,0,0
62,8477320,Anton Blidh,L,NYR,29,0,0,0,0
62,8482157,Will Cuylle,L,NYR,22,0,0,0,0
62,8482737,Zack Bolduc,C,STL,21,0,0,0,0
62,8481239,Samuel Fagemo,L,,24,0,0,0,0
62,8481600,Tobias Bjornfot,D,FLA,23,0,0,0,0
62,8478409,Anthony Richard,C,PHI,28,0,0,0,0
62,8474145,Robert Bortuzzo,D,,35,0,0,0,0
62,8475958,Michael Sgarbossa,C,WSH,32,0,0,0,0
62,8479986,Kole Lind,R,DAL,26,0,0,0,0
62,8479249,Andrew Poturalski,C,SJS,30,0,0,0,0
62,8479362,Riley Tufte,L,BOS,26,0,0,0,0
62,8479991,Jake Leschyshyn,C,NYR,25,0,0,0,0
62,8479587,Rhett Gardner,C,PHI,28,0,0,0,0
62,8482744,James Malatesta,L,CBJ,21,0,0,0,0
62,8478854,Ryan Shea,D,PIT,27,0,0,0,0
62,8481591,Sam Poulin,R,,23,0,0,0,0
62,8483512,Matt Savoie,C,EDM,20,0,0,0,0
62,8482102,Vasily Ponomarev,C,PIT,22,0,0,0,0
62,8482162,Roby Jarventie,L,EDM,22,0,0,0,0
62,8481016,Ruslan Iskhakov,C,,24,0,0,0,0
62,8482172,Landon Slaggert,L,CHI,22,0,0,0,0
62,8482747,Brennan Othmann,L,NYR,21,0,0,0,0
62,8480031,Maxime Comtois,L,,25,0,0,0,0
62,8480226,Marián Studenic,R,,26,0,0,0,0
62,8478408,Travis Dermott,D,,28,0,0,0,0
62,8481518,Nolan Foote,L,NJD,24,0,0,0,0
62,8479419,Brett Murray,L,BUF,26,0,0,0,0
62,8482088,Justin Sourdif,R,FLA,22,0,0,0,0
62,8482201,Gage Goncalves,C,TBL,23,0,0,0,0
62,8481578,Graeme Clarke,R,MIN,23,0,0,0,0
62,8482177,Marat Khusnutdinov,C,MIN,22,0,0,0,0
62,8481754,Nikita Nesterenko,C,ANA,23,0,0,0,0
62,8483531,Brian Halonen,L,NJD,25,0,0,0,0
62,8483920,Pierrick Dube,R,WSH,23,0,0,0,0
62,8480851,Akil Thomas,C,LAK,24,0,0,0,0
62,8475235,Nicolas Deslauriers,L,PHI,33,0,0,0,0
62,8482476,Emil Heineman,L,MTL,23,0,0,0,0
62,8477149,Scott Sabourin,R,SJS,32,0,0,0,0
62,8483549,Lucas Condotta,L,MTL,27,0,0,0,0
62,8482765,Isak Rosen,R,BUF,21,0,0,0,0
62,8481237,Kyle MacLean,C,NYI,25,0,0,0,0
62,8481024,Linus Karlsson,C,VAN,25,0,0,0,0
62,8481690,Tyler Angle,C,,24,0,0,0,0
62,8483570,Ben Meyers,C,SEA,26,0,0,0,0
62,8481655,Cole Schwindt,R,CGY,23,0,0,0,0
62,8481462,Mason Morelli,L,VGK,28,0,0,0,0
62,8483401,Marc Johnstone,R,PIT,28,0,0,0,0
62,8478956,Samuel Laberge,L,NJD,27,0,0,0,0
62,8479533,Joona Koppanen,L,,26,0,0,0,0
62,8482197,Adam Raska,R,MIN,23,0,0,0,0
62,8482250,Callahan Burke,C,VGK,27,0,0,0,0
62,8482784,Zach Dean,C,STL,21,0,0,0,0
62,8484255,Jason Polin,R,COL,25,0,0,0,0
62,8481077,John Leonard,L,,26,0,0,0,0
62,8481534,Raphael Lavoie,C,EDM,24,0,0,0,0
62,8483609,Adam Klapka,R,CGY,24,0,0,0,0
62,8482751,Ryan Winterton,C,SEA,21,0,0,0,0
62,8480267,Sammy Walker,C,MIN,25,0,0,0,0
62,8475766,Austin Watson,L,,32,0,0,0,0
62,8482460,Matt Rempe,C,NYR,22,0,0,0,0
62,8481065,Angus Crookshank,L,OTT,25,0,0,0,0
62,8481070,Hugh McGing,L,,26,0,0,0,0
62,8476323,Max McCormick,L,SEA,32,0,0,0,0
62,8483395,Arshdeep Bains,L,VAN,23,0,0,0,0
62,8484259,Ondrej Pavel,C,COL,31,0,0,0,0
62,8483432,Luca Del Bel Belluz,C,CBJ,31,0,0,0,0
62,8483045,Cameron Butler,R,CBJ,31,0,0,0,0
62,8482061,Brandon Biro,L,SEA,26,0,0,0,0
62,8477401,John Hayden,C,SEA,29,0,0,0,0
62,8475278,Byron Froese,C,,33,0,0,0,0
62,8478446,Glenn Gawdin,C,LAK,27,0,0,0,0
62,8477993,Justin Kirkland,C,CGY,28,0,0,0,0
62,8482147,Jean-Luc Foudy,C,COL,22,0,0,0,0
62,8480032,Shane Bowers,C,NJD,25,0,0,0,0
62,8479330,Brandon Gignac,C,MTL,27,0,0,0,0
62,8480776,Sheldon Rempal,R,,29,0,0,0,0
62,8475413,Justin Dowling,C,NJD,34,0,0,0,0
62,8481726,Adam Edstrom,C,NYR,24,0,0,0,0
62,8480844,Grigori Denisenko,L,VGK,24,0,0,0,0
62,8478147,Bokondji Imama,L,PIT,28,0,0,0,0
62,8478881,Brett Seney,L,CHI,28,0,0,0,0
62,8483630,Pavol Regenda,L,ANA,25,0,0,0,0
62,8480836,Jonathan Gruden,C,,24,0,0,0,0
62,8484314,Jiri Smejkal,L,,28,0,0,0,0
62,8475780,Chris Wagner,R,COL,33,0,0,0,0
62,8479546,Oskar Steen,C,,26,0,0,0,0
62,8483597,Milos Kelemen,L,UTA,25,0,0,0,0
62,8481789,Tye Kartye,L,SEA,23,0,0,0,0
62,8484325,Waltteri Merela,C,TBL,26,0,0,0,0
62,8479421,Jacob Moverare,D,LAK,26,0,0,0,0
62,8481585,Egor Afanasyev,L,SJS,23,0,0,0,0
62,8479547,Matthew Phillips,R,,26,0,0,0,0
62,8479367,William Lockwood,R,FLA,26,0,0,0,0
62,8476915,Jujhar Khaira,L,,30,0,0,0,0
62,8481422,Jacob Lucchini,C,NSH,29,0,0,0,0
62,8480468,James Hamblin,L,EDM,25,0,0,0,0
62,8478051,Max Willman,C,NJD,29,0,0,0,0
62,8481556,John Beecher,C,BOS,23,0,0,0,0
62,8478078,Rourke Chartier,C,,28,0,0,0,0
63,8477492,Nathan MacKinnon,C,COL,29,82,61,92,153
63,8477934,Leon Draisaitl,C,EDM,29,82,57,77,134
63,8476453,Nikita Kucherov,R,TBL,31,82,36,95,131
63,8478402,Connor McDavid,C,EDM,27,82,31,95,126
63,8479318,Auston Matthews,C,TOR,27,82,67,51,118
63,8478550,Artemi Panarin,L,NYR,33,82,43,71,114
63,8478864,Kirill Kaprizov,L,MIN,27,82,49,59,108
63,8480027,Jason Robertson,L,DAL,25,82,38,69,107
63,8476887,Filip Forsberg,L,NSH,30,82,46,60,106
63,8471675,Sidney Crosby,C,PIT,37,82,38,68,106
63,8476468,J.T. Miller,C,VAN,31,82,34,70,104
63,8479314,Matthew Tkachuk,L,FLA,27,82,29,75,104
63,8478010,Brayden Point,C,TBL,28,82,47,56,103
63,8477956,David Pastrnak,R,BOS,28,82,42,61,103
63,8477939,William Nylander,R,TOR,28,82,41,60,101
63,8480800,Quinn Hughes,D,VAN,25,82,9,92,101
63,8477493,Aleksander Barkov,C,FLA,29,82,31,69,100
63,8477501,Valeri Nichushkin,R,COL,29,82,47,52,99
63,8481557,Matt Boldy,L,MIN,23,82,42,56,98
63,8482116,Tim Stützle,C,OTT,22,82,29,69,98
63,8480801,Brady Tkachuk,L,OTT,25,82,36,60,96
63,8477933,Sam Reinhart,C,FLA,29,82,52,43,95
63,8481559,Jack Hughes,C,NJD,23,82,40,54,94
63,8477946,Dylan Larkin,C,DET,28,82,39,55,94
63,8478427,Sebastian Aho,C,CAR,27,82,36,58,94
63,8477404,Jake Guentzel,C,TBL,30,82,34,59,93
63,8474564,Steven Stamkos,C,NSH,34,82,43,49,92
63,8474141,Patrick Kane,R,DET,36,82,32,60,92
63,8478420,Mikko Rantanen,R,COL,28,82,42,48,90
63,8480002,Nico Hischier,C,NJD,25,82,34,55,89
63,8478042,Viktor Arvidsson,R,EDM,31,82,38,50,88
63,8471215,Evgeni Malkin,C,PIT,38,82,34,54,88
63,8477940,Nikolaj Ehlers,L,WPG,28,82,35,51,86
63,8479323,Adam Fox,D,NYR,26,82,21,65,86
63,8478445,Mathew Barzal,C,NYI,27,82,21,65,86
63,8482078,Lucas Raymond,L,DET,22,82,39,46,85
63,8476459,Mika Zibanejad,C,NYR,31,82,30,55,85
63,8479407,Jesper Bratt,L,NJD,26,82,30,55,85
63,8475913,Mark Stone,R,VGK,32,82,29,56,85
63,8480839,Rasmus Dahlin,D,BUF,24,82,21,63,84
63,8476389,Vincent Trocheck,C,NYR,31,82,39,44,83
63,8475166,John Tavares,C,TOR,34,82,36,47,83
63,8474600,Roman Josi,D,NSH,34,82,25,58,83
63,8475172,Nazem Kadri,C,CGY,34,82,35,47,82
63,8478439,Travis Konecny,R,PHI,27,82,33,48,81
63,8479337,Alex DeBrincat,R,DET,27,82,30,51,81
63,8475184,Chris Kreider,L,NYR,33,82,48,32,80
63,8479385,Jordan Kyrou,C,STL,26,82,31,48,79
63,8480012,Elias Pettersson,C,VAN,26,82,29,50,79
63,8476346,Johnny Gaudreau,L,CBJ,31,82,21,58,79
63,8481523,Kirby Dach,C,MTL,23,82,17,62,79
63,8479343,Clayton Keller,R,UTA,26,82,43,35,78
63,8477409,Carter Verhaeghe,C,FLA,29,82,33,45,78
63,8475167,Victor Hedman,D,TBL,34,82,17,61,78
63,8480036,Miro Heiskanen,D,DAL,25,82,15,63,78
63,8478414,Timo Meier,R,NJD,28,82,36,41,77
63,8480865,Noah Dobson,D,NYI,24,82,12,65,77
63,8478398,Kyle Connor,L,WPG,28,82,40,36,76
63,8478449,Roope Hintz,C,DAL,28,82,35,41,76
63,8478047,Michael Bunting,L,PIT,29,82,33,43,76
63,8477955,Jared McCann,L,SEA,28,82,33,43,76
63,8477949,Alex Tuch,R,BUF,28,82,27,49,76
63,8478873,Troy Terry,R,ANA,27,82,26,49,75
63,8476853,Morgan Rielly,D,TOR,30,82,10,65,75
63,8475692,Mats Zuccarello,R,MIN,37,82,18,56,74
63,8475786,Zach Hyman,L,EDM,32,82,38,35,73
63,8479420,Tage Thompson,C,BUF,27,82,36,36,72
63,8478493,Joel Eriksson Ek,C,MIN,27,82,31,41,72
63,8478440,Dylan Strome,C,WSH,27,82,27,45,72
63,8477447,Shea Theodore,D,VGK,29,82,16,56,72
63,8477504,Josh Morrissey,D,WPG,29,82,15,57,72
63,8471214,Alex Ovechkin,L,WSH,39,82,39,32,71
63,8478444,Brock Boeser,R,VAN,27,82,34,37,71
63,8473994,Jamie Benn,L,DAL,35,82,27,44,71
63,8480803,Evan Bouchard,D,EDM,25,82,17,54,71
63,8480069,Cale Makar,D,COL,26,82,15,56,71
63,8475794,Tyler Seguin,C,DAL,32,82,43,27,70
63,8477960,Adrian Kempe,R,LAK,28,82,36,34,70
63,8477500,Bo Horvat,C,NYI,29,82,35,35,70
63,8475784,Jeff Skinner,C,EDM,32,82,31,39,70
63,8477942,Kevin Fiala,L,LAK,28,82,29,41,70
63,8480830,Andrei Svechnikov,R,CAR,24,82,27,43,70
63,8480023,Robert Thomas,C,STL,25,82,19,51,70
63,8479410,Mikhail Sergachev,D,UTA,26,82,7,63,70
63,8473419,Brad Marchand,L,BOS,36,82,30,39,69
63,8479542,Brandon Hagel,L,TBL,26,82,33,35,68
63,8477951,Nick Schmaltz,C,UTA,28,82,29,39,68
63,8476454,Ryan Nugent-Hopkins,C,EDM,31,82,23,45,68
63,8478407,Vince Dunn,D,SEA,28,82,19,49,68
63,8481596,Shane Pinto,C,OTT,24,82,17,51,68
63,8480208,Drake Batherson,R,OTT,26,82,35,32,67
63,8481533,Trevor Zegras,C,ANA,23,82,27,40,67
63,8475754,Brock Nelson,C,NYI,33,82,36,30,66
63,8478403,Jack Eichel,C,VGK,28,82,33,33,66
63,8474590,John Carlson,D,WSH,34,82,16,50,66
63,8482159,Tyson Foerster,R,PHI,22,82,37,28,65
63,8476539,Jonathan Marchessault,R,NSH,34,82,36,29,65
63,8475810,Bryan Rust,R,PIT,32,82,34,31,65
63,8479339,Patrik Laine,L,CBJ,26,82,28,37,65
63,8482093,Seth Jarvis,C,CAR,22,82,27,38,65
63,8473512,Claude Giroux,R,OTT,36,82,27,38,65
63,8482665,Matty Beniers,C,SEA,22,82,24,41,65
63,8476456,Jonathan Huberdeau,C,CGY,31,82,12,53,65
63,8481068,Yegor Sharangovich,C,CGY,26,82,36,28,64
63,8477476,Artturi Lehkonen,L,COL,29,82,27,37,64
63,8482097,Jack Quinn,R,BUF,23,82,26,38,64
63,8471685,Anze Kopitar,C,LAK,37,82,24,40,64
63,8475168,Matt Duchene,C,DAL,33,82,24,40,64
63,8477496,Elias Lindholm,C,BOS,30,82,30,33,63
63,8483808,Andrei Kuzmenko,L,CGY,28,82,29,34,63
63,8480018,Nick Suzuki,C,MTL,25,82,27,36,63
63,8476881,Tomas Hertl,C,VGK,31,82,25,38,63
63,8476882,Teuvo Teravainen,L,CHI,30,82,23,40,63
63,8478038,Devon Toews,D,COL,30,82,17,46,63
63,8477402,Pavel Buchnevich,L,STL,29,82,32,30,62
63,8477416,Oliver Bjorkstrand,R,SEA,29,82,29,33,62
63,8478856,Conor Garland,R,VAN,28,82,26,36,62
63,8480014,Gabriel Vilardi,C,WPG,25,82,34,27,61
63,8477935,Sam Bennett,C,FLA,28,82,27,34,61
63,8475745,Charlie Coyle,C,BOS,32,82,24,37,61
63,8475798,Mikael Granlund,C,SJS,32,82,16,45,61
63,8474578,Erik Karlsson,D,PIT,34,82,13,48,61
63,8482740,Wyatt Johnston,C,DAL,21,82,30,30,60
63,8476460,Mark Scheifele,C,WPG,31,82,28,32,60
63,8474641,Adam Henrique,C,EDM,34,82,25,35,60
63,8479675,Trevor Moore,L,LAK,29,82,24,36,60
63,8475158,Ryan O'Reilly,C,NSH,33,82,21,38,59
63,8474586,Jordan Eberle,R,SEA,34,82,21,38,59
63,8476905,Chandler Stephenson,C,SEA,30,82,20,39,59
63,8481711,Matias Maccelli,L,UTA,24,82,18,41,59
63,8479325,Charlie McAvoy,D,BOS,27,82,16,43,59
63,8478460,Zach Werenski,D,CBJ,27,82,14,45,59
63,8478397,Rasmus Andersson,D,CGY,28,82,10,49,59
63,8475170,Brayden Schenn,C,STL,33,82,29,29,58
63,8480188,Fabian Zetterlund,L,SJS,25,82,21,37,58
63,8474679,Gustav Nyquist,C,NSH,35,82,17,41,58
63,8477503,Max Domi,C,TOR,29,82,10,48,58
63,8476875,Mike Matheson,D,MTL,30,82,8,50,58
63,8477451,Ryan Hartman,R,MIN,30,82,29,28,57
63,8481528,Dylan Cozens,C,BUF,23,82,23,34,57
63,8479400,Pierre-Luc Dubois,L,WSH,26,82,21,36,57
63,8477964,Ivan Barbashev,C,VGK,29,82,19,38,57
63,8478975,Mason Marchment,L,DAL,29,82,26,30,56
63,8475191,Reilly Smith,R,NYR,33,82,22,34,56
63,8477494,Jonathan Drouin,L,COL,29,82,22,34,56
63,8477497,Sean Monahan,C,CBJ,30,82,20,36,56
63,8478396,Noah Hanifin,D,VGK,27,82,13,43,56
63,8481540,Cole Caufield,R,MTL,23,82,33,22,55
63,8482109,Alexis Lafrenière,L,NYR,23,82,30,25,55
63,8480064,Josh Norris,C,OTT,25,82,29,26,55
63,8476880,Tom Wilson,R,WSH,30,82,25,30,55
63,8474150,Mikael Backlund,C,CGY,35,82,21,34,55
63,8479345,Jakob Chychrun,D,WSH,26,82,17,38,55
63,8482113,Anton Lundell,C,FLA,23,82,27,27,54
63,8478462,Nicolas Roy,C,VGK,27,82,24,30,54
63,8475765,Vladimir Tarasenko,R,DET,33,82,23,31,54
63,8480797,Joel Farabee,L,PHI,24,82,23,31,54
63,8477932,Aaron Ekblad,D,FLA,28,82,17,37,54
63,8478472,Mathieu Joseph,R,STL,27,82,15,39,54
63,8482684,Luke Hughes,D,NJD,21,82,11,43,54
63,8476432,Boone Jenner,C,CBJ,31,82,35,18,53
63,8482699,Dylan Guenther,R,UTA,21,82,26,27,53
63,8480015,Owen Tippett,R,PHI,25,82,25,28,53
63,8476399,Blake Coleman,C,CGY,33,82,25,28,53
63,8482671,Owen Power,D,BUF,22,82,23,30,53
63,8476479,Phillip Danault,C,LAK,31,82,19,34,53
63,8478438,Tommy Novak,C,NSH,27,82,14,39,53
63,8478498,Jake DeBrusk,L,VAN,28,82,31,21,52
63,8475722,Jason Zucker,L,BUF,32,82,31,21,52
63,8482055,Drew O'Connor,L,PIT,26,82,28,24,52
63,8471698,T.J. Oshie,R,WSH,38,82,28,24,52
63,8478542,Evan Rodrigues,C,FLA,31,82,25,27,52
63,8482175,JJ Peterka,R,BUF,22,82,23,29,52
63,8477456,J.T. Compher,L,DET,29,82,23,29,52
63,8482745,Mason McTavish,C,ANA,21,82,21,31,52
63,8475791,Taylor Hall,L,CHI,33,82,21,31,52
63,8476792,Torey Krug,D,STL,33,82,14,38,52
63,8471724,Kris Letang,D,PIT,37,82,9,43,52
63,8480459,Pius Suter,C,VAN,28,82,22,29,51
63,8480039,Martin Necas,C,CAR,25,82,21,30,51
63,8480798,Philipp Kurashev,C,CHI,25,82,21,30,51
63,8480829,Jesperi Kotkaniemi,C,CAR,24,82,21,30,51
63,8479999,Casey Mittelstadt,C,COL,26,82,19,32,51
63,8473563,Nicklas Backstrom,C,WSH,37,82,19,32,51
63,8476458,Ryan Strome,C,ANA,31,82,18,33,51
63,8476292,Ondrej Palat,L,NJD,33,82,17,34,51
63,8480145,Neal Pionk,D,WPG,29,82,13,38,51
63,8470613,Brent Burns,D,CAR,39,82,13,38,51
63,8478020,Michael Amadio,C,OTT,28,82,28,22,50
63,8475151,Kyle Palmieri,C,NYI,33,82,23,27,50
63,8477407,Anthony Duclair,L,NYI,29,82,23,27,50
63,8480113,Alex Iafallo,L,WPG,31,82,22,28,50
63,8476461,Sean Couturier,C,PHI,32,82,20,30,50
63,8476906,Shayne Gostisbehere,D,CAR,31,82,18,32,50
63,8473986,Alex Killorn,L,ANA,35,82,18,32,50
63,8474565,Alex Pietrangelo,D,VGK,34,82,6,44,50
63,8475169,Evander Kane,L,EDM,33,82,24,25,49
63,8478401,Pavel Zacha,C,BOS,27,82,21,28,49
63,8478233,Andrew Mangiapane,L,WSH,28,82,21,28,49
63,8478046,Danton Heinen,L,VAN,29,82,20,29,49
63,8474102,David Perron,L,OTT,36,82,18,31,49
63,8482149,Cole Perfetti,C,WPG,22,82,16,33,49
63,8480078,Filip Chytil,C,NYR,25,82,15,34,49
63,8477948,Travis Sanheim,D,PHI,28,82,12,37,49
63,8478463,Anthony Beauvillier,L,PIT,27,82,26,22,48
63,8482110,Dawson Mercer,C,NJD,23,82,22,26,48
63,8478519,Anthony Cirelli,C,TBL,27,82,19,29,48
63,8476448,William Karlsson,C,VGK,31,82,18,30,48
63,8478055,Gustav Forsling,D,FLA,28,82,17,31,48
63,8479425,Filip Hronek,D,VAN,27,82,10,38,48
63,8475726,Tyler Toffoli,C,SJS,32,82,24,23,47
63,8481535,Nils Hoglander,L,VAN,24,82,24,23,47
63,8473422,Nick Foligno,L,CHI,37,82,19,28,47
63,8475287,Erik Haula,L,NJD,33,82,18,28,46
63,8481581,Thomas Harley,D,DAL,23,82,10,36,46
63,8482092,Ridly Greig,C,OTT,22,82,27,18,45
63,8478366,Frank Vatrano,R,ANA,30,82,26,19,45
63,8477998,Warren Foegele,L,LAK,28,82,25,20,45
63,8475793,Ryan Johansen,C,PHI,32,82,20,25,45
63,8480009,Eeli Tolvanen,R,SEA,25,82,19,26,45
63,8481624,Ilya Mikheyev,R,CHI,30,82,19,26,45
63,8477511,Anthony Mantha,R,CGY,30,82,17,28,45
63,8476480,Vladislav Namestnikov,C,WPG,32,82,15,30,45
63,8477986,Brandon Montour,D,SEA,30,82,14,31,45
63,8474563,Drew Doughty,D,LAK,35,82,12,33,45
63,8477498,Darnell Nurse,D,EDM,29,82,11,34,45
63,8477021,Alex Kerfoot,C,UTA,30,82,11,34,45
63,8476483,Rickard Rakell,R,PIT,31,82,23,21,44
63,8482124,Quinton Byfield,R,LAK,22,82,17,27,44
63,8478458,Jack Roslovic,C,CAR,27,82,16,28,44
63,8479525,Ross Colton,C,COL,28,82,16,28,44
63,8484144,Connor Bedard,C,CHI,19,82,16,28,44
63,8475768,Jaden Schwartz,C,SEA,32,82,14,30,44
63,8482660,Kent Johnson,C,CBJ,22,82,12,32,44
63,8476329,Travis Boyd,C,MIN,31,82,12,32,44
63,8480434,Sean Durzi,D,UTA,26,82,9,35,44
63,8481542,Moritz Seider,D,DET,23,82,3,41,44
63,8478474,Lawson Crouse,L,UTA,27,82,23,20,43
63,8477479,Tyler Bertuzzi,L,CHI,29,82,21,22,43
63,8476927,Teddy Blueger,C,VAN,30,82,16,27,43
63,8480028,Morgan Frost,C,PHI,25,82,14,29,43
63,8474053,Logan Couture,C,SJS,35,82,14,29,43
63,8476869,Brady Skjei,D,NSH,30,82,11,32,43
63,8478469,Thomas Chabot,D,OTT,27,82,9,34,43
63,8478109,Victor Olofsson,L,VGK,29,82,28,14,42
63,8479390,Taylor Raddysh,R,WSH,26,82,23,19,42
63,8482667,William Eklund,L,SJS,22,82,20,22,42
63,8480220,Noah Cates,L,PHI,25,82,20,22,42
63,8476438,Brandon Saad,L,STL,32,82,19,23,42
63,8477429,Andrew Copp,C,DET,30,82,18,24,42
63,8481618,Alex Newhook,C,MTL,23,82,17,25,42
63,8481604,Pavel Dorofeyev,L,VGK,24,82,17,25,42
63,8479987,Morgan Geekie,C,BOS,26,82,16,26,42
63,8477495,Seth Jones,D,CHI,30,82,12,30,42
63,8476923,Damon Severson,D,CBJ,30,82,8,34,42
63,8475764,Cam Fowler,D,ANA,33,82,7,35,42
63,8477952,Robby Fabbri,C,ANA,28,82,21,20,41
63,8480068,Ryan Poehling,C,PHI,25,82,17,24,41
63,8479365,Trent Frederic,C,BOS,26,82,17,24,41
63,8481013,Jonatan Berggren,R,DET,24,82,17,24,41
63,8476826,Yanni Gourde,C,SEA,33,82,16,25,41
63,8476462,Dougie Hamilton,D,NJD,31,82,12,29,41
63,8480817,K'Andre Miller,D,NYR,24,82,10,31,41
63,8482655,J.J. Moser,D,TBL,24,82,6,35,41
63,8478057,Dakota Joshua,C,VAN,28,82,18,22,40
63,8482146,Luke Evangelista,R,NSH,22,82,18,22,40
63,8476419,Jean-Gabriel Pageau,C,NYI,32,82,15,25,40
63,8478115,Pierre Engvall,L,NYI,28,82,14,26,40
63,8475763,Kevin Hayes,R,PIT,32,82,13,27,40
63,8477947,Sonny Milano,L,WSH,28,82,13,27,40
63,8481546,Cam York,D,PHI,23,82,11,29,40
63,8475753,Justin Faulk,D,STL,32,82,8,32,40
63,8476958,Jaccob Slavin,D,CAR,30,82,5,35,40
63,8483515,Juraj Slafkovsky,L,MTL,20,82,18,21,39
63,8481554,Kaapo Kakko,R,NYR,23,82,18,21,39
63,8482475,Yegor Chinakhov,R,CBJ,23,82,18,21,39
63,8477987,Ryan Donato,C,CHI,28,82,17,22,39
63,8474189,Lars Eller,C,PIT,35,82,12,27,39
63,8476872,Scott Laughton,C,PHI,30,82,11,28,39
63,8482122,Brock Faber,D,MIN,22,82,9,30,39
63,8476921,Jordan Martinook,L,CAR,32,82,22,16,38
63,8476925,Colton Sissons,C,NSH,31,82,15,23,38
63,8477989,Christian Dvorak,C,MTL,28,82,10,28,38
63,8479398,Samuel Girard,D,COL,26,82,7,31,38
63,8475760,Nick Bjugstad,C,UTA,32,82,28,9,37
63,8475848,Brendan Gallagher,R,MTL,32,82,20,17,37
63,8475314,Anders Lee,L,NYI,34,82,20,17,37
63,8482720,Matthew Knies,L,TOR,22,82,19,18,37
63,8477426,Nicholas Paul,L,TBL,29,82,19,18,37
63,8475714,Calle Jarnkrok,C,TOR,33,82,17,20,37
63,8470621,Corey Perry,R,EDM,39,82,17,20,37
63,8474149,Evgenii Dadonov,R,DAL,35,82,14,23,37
63,8477444,Andre Burakovsky,L,SEA,29,82,11,26,37
63,8475855,Jesper Fast,R,CAR,33,82,11,26,37
63,8477953,Kasperi Kapanen,R,STL,28,82,10,27,37
63,8480185,Eetu Luostarinen,C,FLA,26,82,10,27,37
63,8476457,Adam Larsson,D,SEA,32,82,9,28,37
63,8474715,Cam Atkinson,R,TBL,35,82,23,13,36
63,8476392,Adam Lowry,C,WPG,31,82,18,18,36
63,8480789,Oliver Wahlstrom,R,NYI,24,82,18,18,36
63,8480980,Connor Dewar,C,TOR,25,82,17,19,36
63,8480802,Ryan McLeod,C,BUF,25,82,14,22,36
63,8478891,Mason Appleton,C,WPG,28,82,10,26,36
63,8477450,Jason Dickinson,C,CHI,29,82,10,26,36
63,8474716,Jared Spurgeon,D,MIN,35,82,7,29,36
63,8476931,Jake McCabe,D,TOR,31,82,6,30,36
63,8480873,Rasmus Sandin,D,WSH,24,82,3,33,36
63,8480849,Barrett Hayton,C,UTA,24,82,16,19,35
63,8476873,Mark Jankowski,C,NSH,30,82,13,22,35
63,8476885,Jacob Trouba,D,NYR,30,82,11,24,35
63,8481553,Bobby Brink,R,PHI,23,82,10,25,35
63,8477969,Marcus Pettersson,D,PIT,28,82,9,26,35
63,8474151,Ryan McDonagh,D,TBL,35,82,9,26,35
63,8482105,Jake Sanderson,D,OTT,22,82,7,28,35
63,8476854,Hampus Lindholm,D,BOS,30,82,6,29,35
63,8476981,Josh Anderson,R,MTL,30,82,19,15,34
63,8481560,Arthur Kaliyev,R,LAK,23,82,18,16,34
63,8476374,Sean Kuraly,C,CBJ,31,82,18,16,34
63,8476278,Colin Blackwell,C,DAL,31,82,18,16,34
63,8479353,Brett Howden,C,VGK,26,82,17,17,34
63,8477839,Conor Sheary,L,TBL,32,82,16,18,34
63,8476918,Jimmy Vesey,L,NYR,31,82,15,19,34
63,8481656,Aliaksei Protas,C,WSH,23,82,10,24,34
63,8475218,Mattias Ekholm,D,EDM,34,82,9,25,34
63,8476917,Adam Pelech,D,NYI,30,82,9,25,34
63,8477346,MacKenzie Weegar,D,CGY,30,82,7,27,34
63,8480281,Alexey Toropchenko,R,STL,25,82,27,6,33
63,8480893,Kirill Marchenko,R,CBJ,24,82,17,16,33
63,8481580,Connor McMichael,C,WSH,23,82,16,17,33
63,8482705,Cole Sillinger,C,CBJ,21,82,16,17,33
63,8479351,Sam Steel,C,DAL,26,82,15,18,33
63,8476960,Andreas Athanasiou,C,CHI,30,82,14,19,33
63,8480003,Jesper Boqvist,C,FLA,26,82,14,19,33
63,8476979,Erik Gustafsson,D,DET,32,82,6,27,33
63,8478500,Ivan Provorov,D,CBJ,27,82,6,27,33
63,8481582,Nicholas Robertson,L,TOR,23,82,16,16,32
63,8482079,Marco Rossi,C,MIN,23,82,15,17,32
63,8480835,Jack Drury,C,CAR,24,82,15,17,32
63,8481186,Logan O'Connor,R,COL,28,82,14,18,32
63,8479992,Michael Rasmussen,C,DET,25,82,12,20,32
63,8480871,Adam Boqvist,D,FLA,24,82,9,23,32
63,8482133,Thomas Bordeleau,C,SJS,22,82,6,26,32
63,8477488,Brett Pesce,D,NJD,30,82,5,27,32
63,8474673,TJ Brodie,D,CHI,34,82,5,27,32
63,8473507,Jeff Petry,D,DET,37,82,3,29,32
63,8480043,Timothy Liljegren,D,TOR,25,82,1,31,32
63,8482117,Lukas Reichel,L,CHI,22,82,19,12,31
63,8475799,Nino Niederreiter,R,WPG,32,82,17,14,31
63,8477919,Frederick Gaudreau,C,MIN,31,82,14,17,31
63,8482166,Shakir Mukhamadullin,D,SJS,22,82,13,18,31
63,8477369,Carson Soucy,D,VAN,30,82,8,23,31
63,8476463,Jonas Brodin,D,MIN,31,82,7,24,31
63,8475324,Nick Jensen,D,OTT,34,82,5,26,31
63,8481606,Jordan Spence,D,LAK,23,82,4,27,31
63,8479402,Jake Bean,D,CGY,26,82,4,27,31
63,8482089,Jake Neighbours,L,STL,22,82,20,10,30
63,8479293,Brandon Tanev,L,SEA,33,82,17,13,30
63,8479996,Cody Glass,C,NSH,25,82,15,15,30
63,8480855,Jack McBain,C,UTA,24,82,14,16,30
63,8476469,Joel Armia,R,MTL,31,82,14,16,30
63,8473533,Jordan Staal,C,CAR,36,82,12,18,30
63,8475343,Nic Dowd,C,WSH,34,82,12,18,30
63,8481517,Brett Leason,R,ANA,25,82,10,20,30
63,8476897,Oskar Sundqvist,C,STL,30,82,9,21,30
63,8481522,Peyton Krebs,C,BUF,23,82,9,21,30
63,8477220,Nate Schmidt,D,FLA,33,82,6,24,30
63,8476879,Cody Ceci,D,EDM,31,82,3,27,30
63,8478882,Vladislav Gavrikov,D,LAK,29,82,2,28,30
63,8481032,Paul Cotter,C,NJD,25,82,17,12,29
63,8478508,Yakov Trenin,C,MIN,27,82,14,15,29
63,8484145,Zach Benson,L,BUF,19,82,14,15,29
63,8478211,Dryden Hunt,L,CGY,29,82,12,17,29
63,8479591,Michael Eyssimont,C,TBL,28,82,11,18,29
63,8482111,Justin Barron,D,MTL,23,82,10,19,29
63,8475149,Marcus Johansson,L,MIN,34,82,10,19,29
63,8478911,Matt Roy,D,WSH,29,82,9,20,29
63,8478413,Jordan Greenway,L,BUF,27,82,9,20,29
63,8482142,Jamie Drysdale,D,PHI,22,82,9,20,29
63,8482624,Daniil Miromanov,D,CGY,27,82,9,20,29
63,8478507,John Marino,D,UTA,27,82,5,24,29
63,8478840,Will Borgen,D,SEA,28,82,5,24,29
63,8482125,Alexander Holtz,R,VGK,22,82,19,9,28
63,8480813,Joe Veleno,C,DET,24,82,13,15,28
63,8480144,David Kampf,C,TOR,29,82,11,17,28
63,8480995,Pontus Holmberg,R,TOR,25,82,11,17,28
63,8477015,Connor Brown,R,EDM,30,82,9,19,28
63,8476624,Barclay Goodrow,C,SJS,31,82,8,20,28
63,8480878,Nils Lundkvist,D,DAL,24,82,7,21,28
63,8480336,Sean Walker,D,CAR,30,82,6,22,28
63,8479976,Juuso Valimaki,D,UTA,26,82,6,22,28
63,8476902,Esa Lindell,D,DAL,30,82,2,26,28
63,8479316,Luke Kunin,C,SJS,27,82,17,10,27
63,8481093,Rafael Harvey-Pinard,L,MTL,25,82,17,10,27
63,8481704,Juuso Parssinen,C,NSH,23,82,14,13,27
63,8477425,Miles Wood,L,COL,29,82,13,14,27
63,8480748,Kiefer Sherwood,L,VAN,29,82,13,14,27
63,8475193,Tomas Tatar,L,NJD,34,82,12,15,27
63,8475220,Marcus Foligno,L,MIN,33,82,11,16,27
63,8480448,Parker Kelly,L,COL,25,82,11,16,27
63,8484203,Bradly Nadeau,L,CAR,19,82,10,17,27
63,8482141,Lukas Cormier,D,VGK,22,82,8,19,27
63,8477931,Tomas Nosek,L,FLA,32,82,8,19,27
63,8480073,Erik Brannstrom,D,COL,25,82,7,20,27
63,8477435,Ryan Graves,D,PIT,29,82,6,21,27
63,8477506,Ryan Pulock,D,NYI,30,82,4,23,27
63,8477845,Trevor van Riemsdyk,D,WSH,33,82,3,24,27
63,8479661,Tanner Jeannot,L,LAK,27,82,13,13,26
63,8481481,Blake Lizotte,C,PIT,27,82,11,15,26
63,8475171,Oliver Ekman-Larsson,D,TOR,33,82,9,17,26
63,8479442,Troy Stecher,D,EDM,30,82,8,18,26
63,8475690,Chris Tanev,D,TOR,35,82,7,19,26
63,8481708,Zac Jones,D,NYR,24,82,7,19,26
63,8481568,Alex Vlasic,D,CHI,23,82,4,22,26
63,8480807,Mattias Samuelsson,D,BUF,24,82,2,24,26
63,8479998,Mikey Anderson,D,LAK,25,82,1,25,26
63,8476474,Stefan Noesen,R,NJD,31,82,15,10,25
63,8478569,Noel Acciari,C,PIT,33,82,13,12,25
63,8481028,Martin Pospisil,C,CGY,25,82,13,12,25
63,8482259,Bobby McMann,C,TOR,28,82,12,13,25
63,8479941,Justin Danforth,R,CBJ,31,82,12,13,25
63,8477507,Nikita Zadorov,D,BOS,29,82,12,13,25
63,8478434,Keegan Kolesar,R,VGK,27,82,10,15,25
63,8482807,Ethan Del Mastro,D,CHI,21,82,9,16,25
63,8482733,Logan Mailloux,D,MTL,31,82,8,17,25
63,8483763,Maksymilian Szuber,D,UTA,22,82,8,17,25
63,8475200,Dmitry Orlov,D,CAR,33,82,6,19,25
63,8476312,Josh Manson,D,COL,33,82,6,19,25
63,8478859,Niko Mikkola,D,FLA,28,82,4,21,25
63,8475455,Brenden Dillon,D,NJD,34,82,1,24,25
63,8475233,David Savard,D,MTL,34,82,1,24,25
63,8479393,Noah Gregor,C,OTT,26,82,18,6,24
63,8484166,Adam Fantilli,C,CBJ,20,82,15,9,24
63,8477392,Hudson Fasching,R,NYI,29,82,14,10,24
63,8478133,Jake Evans,C,MTL,28,82,9,15,24
63,8480806,Isac Lundestrom,C,ANA,25,82,8,16,24
63,8476442,Matt Nieto,L,PIT,32,82,8,16,24
63,8476372,Nick Seeler,D,PHI,31,82,5,19,24
63,8482087,Kaiden Guhle,D,MTL,22,82,3,21,24
63,8476889,Radek Faksa,C,STL,30,82,17,6,23
63,8479414,Nathan Bastian,R,NJD,27,82,16,7,23
63,8482077,Dylan Holloway,L,EDM,23,82,15,8,23
63,8482101,Danil Gushchin,L,SJS,22,82,12,11,23
63,8475842,Sam Carrick,C,NYR,32,82,8,15,23
63,8484153,Leo Carlsson,C,ANA,20,82,7,16,23
63,8480074,Alexandre Texier,C,STL,25,82,7,16,23
63,8476467,Jamie Oleksiak,D,SEA,32,82,5,18,23
63,8478178,Darren Raddysh,D,TBL,28,82,5,18,23
63,8478399,Jonas Siegenthaler,D,NJD,27,82,5,18,23
63,8481014,Alexander Romanov,D,NYI,24,82,5,18,23
63,8476331,Dylan DeMelo,D,WPG,31,82,4,19,23
63,8482073,Braden Schneider,D,NYR,23,82,4,19,23
63,8476967,Brett Kulak,D,EDM,30,82,3,20,23
63,8476878,Zemgus Girgensons,L,TBL,30,82,16,6,22
63,8477406,Mattias Janmark,C,EDM,32,82,8,14,22
63,8478851,Alexandre Carrier,D,NSH,28,82,5,17,22
63,8475181,Nick Leddy,D,STL,33,82,3,19,22
63,8479371,Dante Fabbro,D,NSH,26,82,3,19,22
63,8480172,Jan Rutta,D,SJS,34,82,3,19,22
63,8481601,Simon Holmstrom,R,NYI,23,82,13,8,21
63,8482666,Scott Morrow,D,CAR,22,82,13,8,21
63,8482062,Cole Smith,L,NSH,29,82,9,12,21
63,8478013,Jake Walman,D,SJS,28,82,8,13,21
63,8482803,Olen Zellweger,D,ANA,21,82,8,13,21
63,8482809,Jackson Blake,R,CAR,21,82,8,13,21
63,8476422,Mike Reilly,D,NYI,31,82,6,15,21
63,8479980,Nicolas Hague,D,VGK,26,82,5,16,21
63,8482702,Logan Stankoven,C,DAL,21,82,5,16,21
63,8478443,Brandon Carlo,D,BOS,28,82,5,16,21
63,8476891,Matt Grzelcyk,D,PIT,30,82,2,19,21
63,8478136,Jake Middleton,D,MIN,28,82,2,19,21
63,8480035,Henri Jokiharju,D,BUF,25,82,1,20,21
63,8477903,Garnet Hathaway,R,PHI,33,82,7,13,20
63,8480796,Martin Fehervary,D,WSH,25,82,5,15,20
63,8483445,Cutter Gauthier,L,ANA,20,82,5,15,20
63,8481178,Egor Zamula,D,PHI,24,82,4,16,20
63,8475279,Ben Chiarot,D,DET,33,82,4,16,20
63,8476525,Colin Miller,D,WPG,32,82,4,16,20
63,8480222,Sebastian Aho,D,PIT,28,82,3,17,20
63,8481477,Nico Sturm,C,SJS,29,82,9,10,19
63,8473453,Trevor Lewis,C,LAK,37,82,9,10,19
63,8482470,Ilya Solovyov,D,CGY,24,82,8,11,19
63,8482155,Alex Laferriere,R,LAK,23,82,8,11,19
63,8483471,Brad Lambert,C,WPG,31,82,8,11,19
63,8477508,Curtis Lazar,C,NJD,29,82,7,12,19
63,8482712,Oskar Olausson,R,COL,22,82,7,12,19
63,8477499,Rasmus Ristolainen,D,PHI,30,82,4,15,19
63,8479983,Mario Ferraro,D,SJS,26,82,4,15,19
63,8479369,Andrew Peeke,D,BOS,26,82,4,15,19
63,8477365,Connor Clifton,D,BUF,29,82,4,15,19
63,8474013,Ian Cole,D,UTA,35,82,4,15,19
63,8479576,Vincent Desharnais,D,VAN,28,82,4,15,19
63,8482245,Artem Zub,D,OTT,29,82,3,16,19
63,8483495,Simon Nemec,D,NJD,20,82,3,16,19
63,8470600,Ryan Suter,D,STL,39,82,1,18,19
63,8479324,Ryan Lindgren,D,NYR,26,82,0,19,19
63,8478432,Christian Fischer,R,DET,27,82,9,9,18
63,8483431,Logan Cooley,C,UTA,20,82,8,10,18
63,8477505,Alexander Wennberg,C,SJS,30,82,8,10,18
63,8482659,Josh Doan,R,UTA,22,82,8,10,18
63,8482074,Connor Zary,C,CGY,23,82,7,11,18
63,8475231,Casey Cizikas,C,NYI,33,82,7,11,18
63,8477353,Tyler Motte,C,DET,29,82,7,11,18
63,8481567,Henry Thrun,D,SJS,23,82,7,11,18
63,8476892,Colton Parayko,D,STL,31,82,6,12,18
63,8479359,Beck Malenstyn,L,BUF,26,82,6,12,18
63,8483505,Matthew Poitras,C,BOS,20,82,6,12,18
63,8479368,Max Jones,L,BOS,26,82,5,13,18
63,8474090,Brendan Smith,D,DAL,35,82,5,13,18
63,8480834,Ty Emberson,D,SJS,24,82,4,14,18
63,8483468,Jiri Kulich,C,BUF,20,82,4,14,18
63,8475462,Radko Gudas,D,ANA,34,82,4,14,18
63,8482787,Nikita Chibrikov,R,WPG,31,82,4,14,18
63,8476429,Scott Mayfield,D,NYI,32,82,3,15,18
63,8474612,Travis Hamonic,D,OTT,34,82,2,16,18
63,8480021,Jack Studnicka,C,LAK,25,82,11,6,17
63,8481524,Bowen Byram,D,BUF,23,82,9,8,17
63,8482679,Matt Coronato,R,CGY,22,82,7,10,17
63,8482858,Ryker Evans,D,SEA,23,82,7,10,17
63,8478874,Adam Gaudette,C,OTT,28,82,6,11,17
63,8483457,Lane Hutson,D,MTL,20,82,5,12,17
63,8475790,Erik Gudbranson,D,CBJ,32,82,5,12,17
63,8483460,David Jiricek,D,CBJ,21,82,4,13,17
63,8482516,Matthew Kessel,D,STL,24,82,3,14,17
63,8475718,Justin Holl,D,DET,32,82,3,14,17
63,8480860,Kevin Bahl,D,CGY,24,82,3,14,17
63,8478450,Parker Wotherspoon,D,BOS,27,82,3,14,17
63,8480950,Ilya Lyubushkin,D,DAL,30,82,2,15,17
63,8471677,Jack Johnson,D,CBJ,37,82,2,15,17
63,8476441,Joel Edmundson,D,LAK,31,82,1,16,17
63,8482762,Simon Edvinsson,D,DET,21,82,7,9,16
63,8480870,Bo Groulx,C,NYR,24,82,6,10,16
63,8478468,Jeremy Lauzon,D,NSH,27,82,4,12,16
63,8483565,Nick Blankenburg,D,NSH,26,82,3,13,16
63,8483499,Liam Ohgren,L,MIN,20,82,3,13,16
63,8474574,Tyler Myers,D,VAN,34,82,2,14,16
63,8478416,Erik Cernak,D,TBL,27,82,2,14,16
63,8480879,Jacob Bernard-Docker,D,OTT,24,82,2,14,16
63,8480049,Dylan Samberg,D,WPG,25,82,1,15,16
63,8482070,Mitchell Chaffee,R,TBL,26,82,7,8,15
63,8480025,MacKenzie Entwistle,R,FLA,25,82,7,8,15
63,8474567,Zach Bogosian,D,MIN,34,82,5,10,15
63,8482153,Brendan Brisson,C,VGK,23,82,5,10,15
63,8475188,Brayden McNabb,D,VGK,33,82,4,11,15
63,8480246,Nick Perbix,D,TBL,26,82,4,11,15
63,8475177,Calvin de Haan,D,COL,33,82,2,13,15
63,8484149,Gavin Brindley,C,CBJ,20,82,2,13,15
63,8483524,Shane Wright,C,SEA,20,82,10,4,14
63,8476858,Phillip Di Giuseppe,L,VAN,31,82,10,4,14
63,8483493,Frank Nazar,C,CHI,20,82,8,6,14
63,8479291,Kevin Rooney,C,CGY,31,82,7,7,14
63,8476473,Connor Murphy,D,CHI,31,82,6,8,14
63,8482713,Mackie Samoskevich,R,FLA,22,82,5,9,14
63,8475762,Derek Forbort,D,VAN,32,82,4,10,14
63,8483490,Pavel Mintyukov,D,ANA,21,82,3,11,14
63,8482145,Mavrik Bourque,C,DAL,22,82,7,6,13
63,8483482,Tristan Luneau,D,ANA,20,82,6,7,13
63,8483397,Marc McLaughlin,C,BOS,25,82,6,7,13
63,8482118,Sam Colangelo,R,ANA,23,82,5,8,13
63,8483012,Logan Morrison,C,SEA,22,82,5,8,13
63,8481605,Jackson LaCombe,D,ANA,23,82,4,9,13
63,8476822,Luke Glendening,C,TBL,35,82,8,4,12
63,8481641,Joel Kiviranta,L,COL,28,82,6,6,12
63,8482749,Joshua Roy,R,MTL,21,82,6,6,12
63,8484911,Collin Graf,R,SJS,22,82,5,7,12
63,8481122,Simon Benoit,D,TOR,26,82,5,7,12
63,8480990,Declan Chisholm,D,MIN,24,82,4,8,12
63,8483489,Fraser Minten,C,TOR,31,82,1,11,12
63,8479638,Justin Brazeau,R,BOS,26,82,6,5,11
63,8482859,Zack Ostapchuk,C,OTT,21,82,4,6,10
63,8477034,Jaycob Megna,D,FLA,32,82,2,7,9
63,8474062,Riley Nash,C,NYR,35,82,2,7,9
63,8477335,Kyle Burroughs,D,LAK,29,82,2,6,8
63,8483466,Kevin Korchinski,D,CHI,20,82,0,8,8
63,8477938,Haydn Fleury,D,WPG,28,82,3,4,7
63,8483567,Georgii Merkulov,C,BOS,24,82,2,5,7
63,8481699,Aku Raty,R,UTA,23,82,0,5,5
63,8470794,Joe Pavelski,C,,40,0,0,0,0
63,8481703,Valtteri Puustinen,R,PIT,25,0,0,0,0
63,8477950,Tony DeAngelo,D,,29,0,0,0,0
63,8481577,Philip Tomasino,C,NSH,23,0,0,0,0
63,8475197,Tyson Barrie,D,,33,0,0,0,0
63,8471218,Blake Wheeler,R,,38,0,0,0,0
63,8474157,Max Pacioretty,L,,36,0,0,0,0
63,8478466,Daniel Sprong,R,VAN,27,0,0,0,0
63,8475744,Evgeny Kuznetsov,C,,32,0,0,0,0
63,8481019,David Gustafsson,C,WPG,24,0,0,0,0
63,8475906,John Klingberg,D,,32,0,0,0,0
63,8479348,Kale Clague,D,BUF,26,0,0,0,0
63,8476952,Dominic Toninato,C,WPG,30,0,0,0,0
63,8473473,Milan Lucic,L,,36,0,0,0,0
63,8474037,James van Riemsdyk,L,,35,0,0,0,0
63,8474602,Justin Schultz,D,,34,0,0,0,0
63,8482222,Alexander Barabanov,L,,30,0,0,0,0
63,8479372,Josh Mahura,D,SEA,26,0,0,0,0
63,8479982,Conor Timmins,D,TOR,26,0,0,0,0
63,8474031,Kevin Shattenkirk,D,,35,0,0,0,0
63,8480008,Adam Ruzicka,C,,25,0,0,0,0
63,8481059,Scott Perunovich,D,STL,26,0,0,0,0
63,8480884,Calen Addison,D,,24,0,0,0,0
63,8476994,Vinnie Hinostroza,C,NSH,30,0,0,0,0
63,8478452,Caleb Jones,D,LAK,27,0,0,0,0
63,8480157,Calle Rosen,D,COL,30,0,0,0,0
63,8481609,Vladislav Kolyachonok,D,UTA,23,0,0,0,0
63,8479415,Michael McLeod,C,,26,0,0,0,0
63,8476919,Chris Tierney,C,,30,0,0,0,0
63,8479639,Dylan Coghlan,D,WPG,26,0,0,0,0
63,8478146,Matthew Highmore,C,OTT,28,0,0,0,0
63,8478970,Jalen Chatfield,D,CAR,28,0,0,0,0
63,8480205,Emil Bemstrom,C,PIT,25,0,0,0,0
63,8474884,Mike Hoffman,C,,35,0,0,0,0
63,8471274,Alex Goligoski,D,,39,0,0,0,0
63,8478104,Sammy Blais,L,,28,0,0,0,0
63,8474870,Tyler Johnson,C,,34,0,0,0,0
63,8476913,Devin Shore,C,MIN,30,0,0,0,0
63,8481598,Philip Broberg,D,EDM,23,0,0,0,0
63,8480058,Pierre-Olivier Joseph,D,STL,25,0,0,0,0
63,8480891,Michael Kesselring,D,UTA,24,0,0,0,0
63,8477979,Nicolas Aube-Kubel,R,BUF,28,0,0,0,0
63,8476871,Tanner Pearson,L,,32,0,0,0,0
63,8476393,Nick Cousins,C,,31,0,0,0,0
63,8479977,Kailer Yamamoto,R,,26,0,0,0,0
63,8479543,Michael Pezzetta,L,MTL,26,0,0,0,0
63,8477018,Ben Hutton,D,VGK,31,0,0,0,0
63,8480762,Eric Robinson,L,CAR,29,0,0,0,0
63,8474034,Pat Maroon,L,CHI,36,0,0,0,0
63,8481058,Jesse Ylönen,R,,25,0,0,0,0
63,8475179,Dmitry Kulikov,D,FLA,34,0,0,0,0
63,8481527,Kaedan Korczak,D,VGK,23,0,0,0,0
63,8473449,Kyle Okposo,R,,36,0,0,0,0
63,8482192,Isaak Phillips,D,CHI,23,0,0,0,0
63,8480727,Zach Whitecloud,D,VGK,28,0,0,0,0
63,8479346,Dillon Dube,C,,26,0,0,0,0
63,8480821,Filip Zadina,R,,25,0,0,0,0
63,8480001,Urho Vaakanainen,D,ANA,25,0,0,0,0
63,8470966,Mark Giordano,D,,41,0,0,0,0
63,8480853,Liam Foudy,C,,24,0,0,0,0
63,8475225,Craig Smith,C,CHI,35,0,0,0,0
63,8479972,Mason Shaw,C,WPG,26,0,0,0,0
63,8478451,Ethan Bear,D,WSH,27,0,0,0,0
63,8474040,Sam Gagner,C,,35,0,0,0,0
63,8480196,Jacob Bryson,D,BUF,27,0,0,0,0
63,8479984,Cal Foote,D,,26,0,0,0,0
63,8480011,Klim Kostin,C,SJS,25,0,0,0,0
63,8482176,Wyatt Kaiser,D,CHI,22,0,0,0,0
63,8476988,Matt Benning,D,SJS,30,0,0,0,0
63,8479370,Tyson Jost,C,CAR,26,0,0,0,0
63,8477464,Nic Petan,C,,29,0,0,0,0
63,8477380,Jonny Brodzinski,C,NYR,31,0,0,0,0
63,8480070,Ian Mitchell,D,BOS,25,0,0,0,0
63,8479315,Joey Anderson,R,CHI,26,0,0,0,0
63,8478099,Kevin Labanc,R,,29,0,0,0,0
63,8476874,Olli Maatta,D,DET,30,0,0,0,0
63,8475208,Brian Dumoulin,D,ANA,33,0,0,0,0
63,8478430,Oliver Kylington,D,,27,0,0,0,0
63,8479536,Axel Jonsson-Fjallby,L,WPG,26,0,0,0,0
63,8479671,Mathieu Olivier,R,CBJ,27,0,0,0,0
63,8471709,Marc-Edouard Vlasic,D,SJS,37,0,0,0,0
63,8479328,Julien Gauthier,R,NYI,27,0,0,0,0
63,8478421,A.J. Greer,L,FLA,28,0,0,0,0
63,8477573,Nathan Walker,L,STL,30,0,0,0,0
63,8481537,Nikita Okhotiuk,D,CGY,24,0,0,0,0
63,8474166,Alec Martinez,D,CHI,37,0,0,0,0
63,8470610,Zach Parise,L,,40,0,0,0,0
63,8477478,William Carrier,L,CAR,30,0,0,0,0
63,8479344,Jesse Puljujarvi,R,PIT,26,0,0,0,0
63,8480887,Jordan Harris,D,MTL,24,0,0,0,0
63,8478502,Dennis Gilbert,D,BUF,28,0,0,0,0
63,8482730,Brandt Clarke,D,LAK,21,0,0,0,0
63,8480355,Mark Kastelic,C,BOS,25,0,0,0,0
63,8475750,Jon Merrill,D,MIN,32,0,0,0,0
63,8475164,Jakob Silfverberg,R,,34,0,0,0,0
63,8477944,Jakub Vrana,L,,28,0,0,0,0
63,8479439,Jacob MacDonald,D,COL,31,0,0,0,0
63,8474568,Luke Schenn,D,NSH,35,0,0,0,0
63,8478454,Noah Juulsen,D,VAN,27,0,0,0,0
63,8475752,Tyler Pitlick,C,,33,0,0,0,0
63,8482148,Hendrix Lapierre,C,WSH,22,0,0,0,0
63,8481167,Brayden Pachal,D,CGY,25,0,0,0,0
63,8478043,Sam Lafferty,C,BUF,29,0,0,0,0
63,8479321,Lucas Johansen,D,,27,0,0,0,0
63,8471699,Andrew Cogliano,C,,37,0,0,0,0
63,8481521,Ronnie Attard,D,PHI,25,0,0,0,0
63,8481161,Jake Christiansen,D,CBJ,25,0,0,0,0
63,8479458,Nikita Zaitsev,D,,33,0,0,0,0
63,8479619,Michael Carcone,L,UTA,28,0,0,0,0
63,8479026,Philippe Myers,D,TOR,27,0,0,0,0
63,8477330,Dominik Kubalik,L,,29,0,0,0,0
63,8481617,Vasily Podkolzin,R,VAN,23,0,0,0,0
63,8481701,Santeri Hatakka,D,NJD,23,0,0,0,0
63,8479514,Rem Pitlick,C,,27,0,0,0,0
63,8477446,Michael McCarron,R,NSH,29,0,0,0,0
63,8470604,Jeff Carter,C,,39,0,0,0,0
63,8482241,Radim Zohorna,L,,28,0,0,0,0
63,8480289,Morgan Barron,C,WPG,26,0,0,0,0
63,8479379,Givani Smith,R,SJS,26,0,0,0,0
63,8480216,Jacob Peterson,C,,25,0,0,0,0
63,8477851,Jordan Oesterle,D,BOS,32,0,0,0,0
63,8484258,Sam Malinski,D,COL,26,0,0,0,0
63,8478904,Steven Lorentz,C,,28,0,0,0,0
63,8482095,Tyler Kleven,D,OTT,22,0,0,0,0
63,8480848,Ty Dellandrea,C,SJS,24,0,0,0,0
63,8476884,Derrick Pouliot,D,,30,0,0,0,0
63,8479336,Carl Grundstrom,R,SJS,27,0,0,0,0
63,8482964,Arber Xhekaj,D,MTL,23,0,0,0,0
63,8471686,Marc Staal,D,,37,0,0,0,0
63,8477887,Patrick Brown,C,BOS,32,0,0,0,0
63,8478495,Denis Gurianov,R,,27,0,0,0,0
63,8473504,Cal Clutterbuck,R,,37,0,0,0,0
63,8481550,Adam Beckman,L,NJD,23,0,0,0,0
63,8480845,Rasmus Kupari,C,WPG,24,0,0,0,0
63,8474009,Nick Bonino,C,,36,0,0,0,0
63,8478585,Derek Ryan,C,EDM,38,0,0,0,0
63,8477962,Brendan Lemieux,L,CAR,28,0,0,0,0
63,8482861,Vincent Iorio,D,WSH,22,0,0,0,0
63,8479378,Logan Stanley,D,WPG,26,0,0,0,0
63,8473446,Erik Johnson,D,PHI,36,0,0,0,0
63,8481743,Marc Del Gaizo,D,NSH,25,0,0,0,0
63,8477384,Josh Brown,D,EDM,30,0,0,0,0
63,8482165,Yan Kuznetsov,D,CGY,22,0,0,0,0
63,8478424,Jansen Harkins,C,ANA,27,0,0,0,0
63,8482144,Jack Thompson,D,SJS,22,0,0,0,0
63,8478512,Austin Czarnik,C,,32,0,0,0,0
63,8477527,Ross Johnston,L,ANA,30,0,0,0,0
63,8479383,Boris Katchouk,L,,26,0,0,0,0
63,8482094,Daemon Hunt,D,MIN,22,0,0,0,0
63,8481719,Maxwell Crozier,D,TBL,24,0,0,0,0
63,8480192,Johnathan Kovacevic,D,NJD,27,0,0,0,0
63,8479376,Victor Mete,D,,26,0,0,0,0
63,8482511,Mason Lohrei,D,BOS,23,0,0,0,0
63,8475825,Jani Hakanpää,D,,32,0,0,0,0
63,8478021,William Lagesson,D,DET,28,0,0,0,0
63,8475795,Dylan McIlrath,D,WSH,32,0,0,0,0
63,8477846,Ryan Carpenter,C,,33,0,0,0,0
63,8481056,Spencer Stastney,D,NSH,24,0,0,0,0
63,8481564,Ryan Johnson,D,BUF,23,0,0,0,0
63,8478017,Mark Friedman,D,VAN,29,0,0,0,0
63,8479320,Max Lajoie,D,SEA,27,0,0,0,0
63,8480075,Cameron Crotty,D,MIN,25,0,0,0,0
63,8484287,Cole McWard,D,VAN,23,0,0,0,0
63,8484254,Akito Hirose,D,VAN,25,0,0,0,0
63,8483407,Brandon Scanlin,D,NYR,25,0,0,0,0
63,8480274,Philip Kemp,D,EDM,25,0,0,0,0
63,8479522,Hardy Haman Aktell,D,WSH,26,0,0,0,0
63,8480007,Jonas Rondbjerg,R,VGK,25,0,0,0,0
63,8477454,Adam Erne,L,,29,0,0,0,0
63,8481679,Maxence Guenette,D,OTT,23,0,0,0,0
63,8480441,Trey Fix-Wolansky,R,CBJ,25,0,0,0,0
63,8483546,Marshall Rifai,D,TOR,26,0,0,0,0
63,8480084,Nick DeSimone,D,NJD,30,0,0,0,0
63,8481030,Jack St. Ivany,D,PIT,25,0,0,0,0
63,8481592,Jakob Pelletier,L,CGY,23,0,0,0,0
63,8478011,Louie Belpedio,D,PHI,28,0,0,0,0
63,8477930,Pierre-Edouard Bellemare,L,,39,0,0,0,0
63,8484321,Nikolas Matinpalo,D,OTT,26,0,0,0,0
63,8482067,Connor Mackey,D,NYR,28,0,0,0,0
63,8481806,Louis Crevier,D,CHI,23,0,0,0,0
63,8484326,Patrik Koch,D,UTA,28,0,0,0,0
63,8477971,Andreas Englund,D,LAK,28,0,0,0,0
63,8481751,Lukas Rousek,R,BUF,25,0,0,0,0
63,8481006,Tyler Tucker,D,STL,24,0,0,0,0
63,8476867,Brendan Gaunce,C,MIN,30,0,0,0,0
63,8479520,Brandon Duhaime,R,WSH,27,0,0,0,0
63,8477073,Kurtis MacDermid,L,NJD,30,0,0,0,0
63,8480874,Adam Ginning,D,PHI,24,0,0,0,0
63,8477473,Justin Bailey,R,SJS,29,0,0,0,0
63,8479066,Ryan Lomberg,L,CGY,30,0,0,0,0
63,8477070,Liam O'Brien,C,UTA,30,0,0,0,0
63,8474618,Marco Scandella,D,,34,0,0,0,0
63,8475797,Jarred Tinordi,D,,32,0,0,0,0
63,8481441,Joe Snively,C,DET,28,0,0,0,0
63,8477244,Chad Ruhwedel,D,NYR,34,0,0,0,0
63,8479772,Zack MacEwen,R,OTT,28,0,0,0,0
63,8481147,Reese Johnson,C,MIN,26,0,0,0,0
63,8481043,Cole Koepke,L,BOS,26,0,0,0,0
63,8483619,Filip Roos,D,OTT,25,0,0,0,0
63,8481541,Samuel Bolduc,D,NYI,24,0,0,0,0
63,8477810,Joel Hanley,D,CGY,33,0,0,0,0
63,8476907,Mackenzie MacEachern,L,,30,0,0,0,0
63,8482652,Walker Duehr,R,CGY,27,0,0,0,0
63,8477126,Jayson Megna,C,,34,0,0,0,0
63,8483398,Declan Carlile,D,TBL,31,0,0,0,0
63,8482929,Emil Lilleberg,D,TBL,23,0,0,0,0
63,8480880,Jakub Lauko,C,MIN,24,0,0,0,0
63,8480245,Olle Lycksell,R,PHI,25,0,0,0,0
63,8480252,Cole Guttman,C,CHI,25,0,0,0,0
63,8477467,Gustav Olofsson,D,SEA,30,0,0,0,0
63,8479968,Vinni Lettieri,C,BOS,29,0,0,0,0
63,8478400,Colin White,C,,27,0,0,0,0
63,8475755,Alexander Petrovic,D,DAL,32,0,0,0,0
63,8481812,Nikolai Knyzhov,D,,27,0,0,0,0
63,8481593,Jayden Struble,D,MTL,23,0,0,0,0
63,8481532,Alex Turcotte,C,LAK,23,0,0,0,0
63,8482126,Emil Andrae,D,PHI,31,0,0,0,0
63,8479944,Zach Aston-Reese,C,VGK,30,0,0,0,0
63,8471817,Ryan Reaves,R,TOR,37,0,0,0,0
63,8481206,John Ludvig,D,PIT,24,0,0,0,0
63,8481599,Victor Soderstrom,D,UTA,23,0,0,0,0
63,8480292,Carson Meyer,R,ANA,27,0,0,0,0
63,8482496,Nils Aman,C,VAN,24,0,0,0,0
63,8479718,Alex Barré-Boulet,C,MTL,27,0,0,0,0
63,8479994,Jaret Anderson-Dolan,C,WPG,25,0,0,0,0
63,8480184,Gustav Lindstrom,D,,26,0,0,0,0
63,8480890,Jan Jenik,R,OTT,24,0,0,0,0
63,8478067,Oskar Lindblom,L,,28,0,0,0,0
63,8476934,Brock McGinn,L,ANA,30,0,0,0,0
63,8479985,Cale Fleury,D,SEA,26,0,0,0,0
63,8484304,Uvis Balinskis,D,FLA,28,0,0,0,0
63,8479981,Jonah Gadjovich,L,FLA,26,0,0,0,0
63,8481716,Dmitri Voronkov,L,CBJ,24,0,0,0,0
63,8474709,Matt Martin,L,,35,0,0,0,0
63,8482634,Alex Steeves,C,TOR,25,0,0,0,0
63,8480823,Alexander Alexeyev,D,WSH,25,0,0,0,0
63,8477541,Dakota Mermis,D,TOR,30,0,0,0,0
63,8483491,Ivan Miroshnichenko,L,WSH,20,0,0,0,0
63,8478477,Mitchell Stephens,C,SEA,27,0,0,0,0
63,8481543,Nikita Alexandrov,C,STL,24,0,0,0,0
63,8479423,Alex Nylander,L,,26,0,0,0,0
63,8482451,Mikael Pyyhtia,L,CBJ,23,0,0,0,0
63,8478831,Kevin Stenlund,C,UTA,28,0,0,0,0
63,8480306,Grant Hutton,D,NYI,29,0,0,0,0
63,8478028,Fredrik Olofsson,L,,28,0,0,0,0
63,8477462,Robert Hagg,D,VGK,29,0,0,0,0
63,8477320,Anton Blidh,L,NYR,29,0,0,0,0
63,8482157,Will Cuylle,L,NYR,22,0,0,0,0
63,8482737,Zack Bolduc,C,STL,21,0,0,0,0
63,8481239,Samuel Fagemo,L,,24,0,0,0,0
63,8481600,Tobias Bjornfot,D,FLA,23,0,0,0,0
63,8478409,Anthony Richard,C,PHI,28,0,0,0,0
63,8474145,Robert Bortuzzo,D,,35,0,0,0,0
63,8475958,Michael Sgarbossa,C,WSH,32,0,0,0,0
63,8479986,Kole Lind,R,DAL,26,0,0,0,0
63,8479249,Andrew Poturalski,C,SJS,30,0,0,0,0
63,8479362,Riley Tufte,L,BOS,26,0,0,0,0
63,8479991,Jake Leschyshyn,C,NYR,25,0,0,0,0
63,8479587,Rhett Gardner,C,PHI,28,0,0,0,0
63,8482744,James Malatesta,L,CBJ,21,0,0,0,0
63,8478854,Ryan Shea,D,PIT,27,0,0,0,0
63,8481591,Sam Poulin,R,,23,0,0,0,0
63,8483512,Matt Savoie,C,EDM,20,0,0,0,0
63,8482102,Vasily Ponomarev,C,PIT,22,0,0,0,0
63,8482162,Roby Jarventie,L,EDM,22,0,0,0,0
63,8481016,Ruslan Iskhakov,C,,24,0,0,0,0
63,8482172,Landon Slaggert,L,CHI,22,0,0,0,0
63,8482747,Brennan Othmann,L,NYR,21,0,0,0,0
63,8480031,Maxime Comtois,L,,25,0,0,0,0
63,8480226,Marián Studenic,R,,26,0,0,0,0
63,8478408,Travis Dermott,D,,28,0,0,0,0
63,8481518,Nolan Foote,L,NJD,24,0,0,0,0
63,8479419,Brett Murray,L,BUF,26,0,0,0,0
63,8482088,Justin Sourdif,R,FLA,22,0,0,0,0
63,8482201,Gage Goncalves,C,TBL,23,0,0,0,0
63,8481578,Graeme Clarke,R,MIN,23,0,0,0,0
63,8482177,Marat Khusnutdinov,C,MIN,22,0,0,0,0
63,8481754,Nikita Nesterenko,C,ANA,23,0,0,0,0
63,8483531,Brian Halonen,L,NJD,25,0,0,0,0
63,8483920,Pierrick Dube,R,WSH,23,0,0,0,0
63,8480851,Akil Thomas,C,LAK,24,0,0,0,0
63,8475235,Nicolas Deslauriers,L,PHI,33,0,0,0,0
63,8482476,Emil Heineman,L,MTL,23,0,0,0,0
63,8477149,Scott Sabourin,R,SJS,32,0,0,0,0
63,8483549,Lucas Condotta,L,MTL,27,0,0,0,0
63,8482765,Isak Rosen,R,BUF,21,0,0,0,0
63,8481237,Kyle MacLean,C,NYI,25,0,0,0,0
63,8481024,Linus Karlsson,C,VAN,25,0,0,0,0
63,8481690,Tyler Angle,C,,24,0,0,0,0
63,8483570,Ben Meyers,C,SEA,26,0,0,0,0
63,8481655,Cole Schwindt,R,CGY,23,0,0,0,0
63,8481462,Mason Morelli,L,VGK,28,0,0,0,0
63,8483401,Marc Johnstone,R,PIT,28,0,0,0,0
63,8478956,Samuel Laberge,L,NJD,27,0,0,0,0
63,8479533,Joona Koppanen,L,,26,0,0,0,0
63,8482197,Adam Raska,R,MIN,23,0,0,0,0
63,8482250,Callahan Burke,C,VGK,27,0,0,0,0
63,8482784,Zach Dean,C,STL,21,0,0,0,0
63,8484255,Jason Polin,R,COL,25,0,0,0,0
63,8481077,John Leonard,L,,26,0,0,0,0
63,8481534,Raphael Lavoie,C,EDM,24,0,0,0,0
63,8483609,Adam Klapka,R,CGY,24,0,0,0,0
63,8482751,Ryan Winterton,C,SEA,21,0,0,0,0
63,8480267,Sammy Walker,C,MIN,25,0,0,0,0
63,8475766,Austin Watson,L,,32,0,0,0,0
63,8482460,Matt Rempe,C,NYR,22,0,0,0,0
63,8481065,Angus Crookshank,L,OTT,25,0,0,0,0
63,8481070,Hugh McGing,L,,26,0,0,0,0
63,8476323,Max McCormick,L,SEA,32,0,0,0,0
63,8483395,Arshdeep Bains,L,VAN,23,0,0,0,0
63,8484259,Ondrej Pavel,C,COL,31,0,0,0,0
63,8483432,Luca Del Bel Belluz,C,CBJ,31,0,0,0,0
63,8483045,Cameron Butler,R,CBJ,31,0,0,0,0
63,8482061,Brandon Biro,L,SEA,26,0,0,0,0
63,8477401,John Hayden,C,SEA,29,0,0,0,0
63,8475278,Byron Froese,C,,33,0,0,0,0
63,8478446,Glenn Gawdin,C,LAK,27,0,0,0,0
63,8477993,Justin Kirkland,C,CGY,28,0,0,0,0
63,8482147,Jean-Luc Foudy,C,COL,22,0,0,0,0
63,8480032,Shane Bowers,C,NJD,25,0,0,0,0
63,8479330,Brandon Gignac,C,MTL,27,0,0,0,0
63,8480776,Sheldon Rempal,R,,29,0,0,0,0
63,8475413,Justin Dowling,C,NJD,34,0,0,0,0
63,8481726,Adam Edstrom,C,NYR,24,0,0,0,0
63,8480844,Grigori Denisenko,L,VGK,24,0,0,0,0
63,8478147,Bokondji Imama,L,PIT,28,0,0,0,0
63,8478881,Brett Seney,L,CHI,28,0,0,0,0
63,8483630,Pavol Regenda,L,ANA,25,0,0,0,0
63,8480836,Jonathan Gruden,C,,24,0,0,0,0
63,8484314,Jiri Smejkal,L,,28,0,0,0,0
63,8475780,Chris Wagner,R,COL,33,0,0,0,0
63,8479546,Oskar Steen,C,,26,0,0,0,0
63,8483597,Milos Kelemen,L,UTA,25,0,0,0,0
63,8481789,Tye Kartye,L,SEA,23,0,0,0,0
63,8484325,Waltteri Merela,C,TBL,26,0,0,0,0
63,8479421,Jacob Moverare,D,LAK,26,0,0,0,0
63,8481585,Egor Afanasyev,L,SJS,23,0,0,0,0
63,8479547,Matthew Phillips,R,,26,0,0,0,0
63,8479367,William Lockwood,R,FLA,26,0,0,0,0
63,8476915,Jujhar Khaira,L,,30,0,0,0,0
63,8481422,Jacob Lucchini,C,NSH,29,0,0,0,0
63,8480468,James Hamblin,L,EDM,25,0,0,0,0
63,8478051,Max Willman,C,NJD,29,0,0,0,0
63,8481556,John Beecher,C,BOS,23,0,0,0,0
63,8478078,Rourke Chartier,C,,28,0,0,0,0
64,8476453,Nikita Kucherov,R,TBL,31,82,41,95,136
64,8478402,Connor McDavid,C,EDM,27,82,37,95,132
64,8479318,Auston Matthews,C,TOR,27,82,63,58,121
64,8477934,Leon Draisaitl,C,EDM,29,82,43,75,118
64,8478550,Artemi Panarin,L,NYR,33,82,37,81,118
64,8479314,Matthew Tkachuk,L,FLA,27,82,43,73,116
64,8480027,Jason Robertson,L,DAL,25,82,39,77,116
64,8477492,Nathan MacKinnon,C,COL,29,82,45,69,114
64,8477939,William Nylander,R,TOR,28,82,45,67,112
64,8480069,Cale Makar,D,COL,26,82,30,82,112
64,8482116,Tim Stützle,C,OTT,22,82,46,63,109
64,8476468,J.T. Miller,C,VAN,31,82,46,62,108
64,8476887,Filip Forsberg,L,NSH,30,82,50,55,105
64,8477956,David Pastrnak,R,BOS,28,82,48,57,105
64,8477404,Jake Guentzel,C,TBL,30,82,49,54,103
64,8478420,Mikko Rantanen,R,COL,28,82,40,61,101
64,8478445,Mathew Barzal,C,NYI,27,82,27,74,101
64,8477493,Aleksander Barkov,C,FLA,29,82,36,60,96
64,8478427,Sebastian Aho,C,CAR,27,82,47,47,94
64,8478864,Kirill Kaprizov,L,MIN,27,82,42,50,92
64,8477409,Carter Verhaeghe,C,FLA,29,82,42,50,92
64,8477942,Kevin Fiala,L,LAK,28,82,32,60,92
64,8481559,Jack Hughes,C,NJD,23,82,38,53,91
64,8480012,Elias Pettersson,C,VAN,26,82,35,56,91
64,8474600,Roman Josi,D,NSH,34,82,25,66,91
64,8478403,Jack Eichel,C,VGK,28,82,41,49,90
64,8474564,Steven Stamkos,C,NSH,34,82,39,51,90
64,8476459,Mika Zibanejad,C,NYR,31,82,37,53,90
64,8471675,Sidney Crosby,C,PIT,37,82,36,53,89
64,8480023,Robert Thomas,C,STL,25,82,27,61,88
64,8480208,Drake Batherson,R,OTT,26,82,34,53,87
64,8479542,Brandon Hagel,L,TBL,26,82,36,50,86
64,8477960,Adrian Kempe,R,LAK,28,82,35,50,85
64,8476454,Ryan Nugent-Hopkins,C,EDM,31,82,31,54,85
64,8480801,Brady Tkachuk,L,OTT,25,82,30,55,85
64,8477951,Nick Schmaltz,C,UTA,28,82,28,57,85
64,8477949,Alex Tuch,R,BUF,28,82,26,58,84
64,8477940,Nikolaj Ehlers,L,WPG,28,82,32,51,83
64,8479407,Jesper Bratt,L,NJD,26,82,24,59,83
64,8478398,Kyle Connor,L,WPG,28,82,37,45,82
64,8477933,Sam Reinhart,C,FLA,29,82,41,39,80
64,8479385,Jordan Kyrou,C,STL,26,82,36,44,80
64,8478439,Travis Konecny,R,PHI,27,82,31,49,80
64,8480830,Andrei Svechnikov,R,CAR,24,82,31,49,80
64,8480839,Rasmus Dahlin,D,BUF,24,82,22,58,80
64,8478449,Roope Hintz,C,DAL,28,82,37,42,79
64,8478010,Brayden Point,C,TBL,28,82,34,45,79
64,8476875,Mike Matheson,D,MTL,30,82,17,62,79
64,8480800,Quinn Hughes,D,VAN,25,82,11,68,79
64,8481540,Cole Caufield,R,MTL,23,82,39,39,78
64,8481523,Kirby Dach,C,MTL,23,82,18,60,78
64,8479323,Adam Fox,D,NYR,26,82,16,62,78
64,8473419,Brad Marchand,L,BOS,36,82,35,42,77
64,8473512,Claude Giroux,R,OTT,36,82,30,47,77
64,8475167,Victor Hedman,D,TBL,34,82,19,58,77
64,8471215,Evgeni Malkin,C,PIT,38,82,30,46,76
64,8474141,Patrick Kane,R,DET,36,82,27,49,76
64,8475784,Jeff Skinner,C,EDM,32,82,25,51,76
64,8475810,Bryan Rust,R,PIT,32,82,32,43,75
64,8481528,Dylan Cozens,C,BUF,23,82,32,43,75
64,8478407,Vince Dunn,D,SEA,28,82,16,59,75
64,8475166,John Tavares,C,TOR,34,82,38,36,74
64,8477500,Bo Horvat,C,NYI,29,82,36,38,74
64,8481557,Matt Boldy,L,MIN,23,82,32,42,74
64,8476389,Vincent Trocheck,C,NYR,31,82,30,44,74
64,8475692,Mats Zuccarello,R,MIN,37,82,17,57,74
64,8477504,Josh Morrissey,D,WPG,29,82,11,63,74
64,8479343,Clayton Keller,R,UTA,26,82,34,39,73
64,8474578,Erik Karlsson,D,PIT,34,82,15,58,73
64,8479675,Trevor Moore,L,LAK,29,82,39,33,72
64,8482093,Seth Jarvis,C,CAR,22,82,38,34,72
64,8478042,Viktor Arvidsson,R,EDM,31,82,30,42,72
64,8478460,Zach Werenski,D,CBJ,27,82,18,54,72
64,8479420,Tage Thompson,C,BUF,27,82,39,32,71
64,8476539,Jonathan Marchessault,R,NSH,34,82,34,37,71
64,8480015,Owen Tippett,R,PHI,25,82,31,40,71
64,8477501,Valeri Nichushkin,R,COL,29,82,30,41,71
64,8475794,Tyler Seguin,C,DAL,32,82,24,47,71
64,8480002,Nico Hischier,C,NJD,25,82,21,50,71
64,8476881,Tomas Hertl,C,VGK,31,82,33,37,70
64,8477946,Dylan Larkin,C,DET,28,82,31,39,70
64,8477955,Jared McCann,L,SEA,28,82,30,39,69
64,8481533,Trevor Zegras,C,ANA,23,82,29,40,69
64,8478498,Jake DeBrusk,L,VAN,28,82,26,43,69
64,8477496,Elias Lindholm,C,BOS,30,82,20,48,68
64,8480865,Noah Dobson,D,NYI,24,82,9,59,68
64,8475191,Reilly Smith,R,NYR,33,82,29,38,67
64,8475913,Mark Stone,R,VGK,32,82,25,42,67
64,8476460,Mark Scheifele,C,WPG,31,82,24,43,67
64,8475168,Matt Duchene,C,DAL,33,82,23,44,67
64,8480036,Miro Heiskanen,D,DAL,25,82,19,48,67
64,8474590,John Carlson,D,WSH,34,82,18,49,67
64,8480018,Nick Suzuki,C,MTL,25,82,28,38,66
64,8475172,Nazem Kadri,C,CGY,34,82,24,42,66
64,8474586,Jordan Eberle,R,SEA,34,82,23,43,66
64,8471685,Anze Kopitar,C,LAK,37,82,16,50,66
64,8475786,Zach Hyman,L,EDM,32,82,36,29,65
64,8479337,Alex DeBrincat,R,DET,27,82,27,38,65
64,8477456,J.T. Compher,L,DET,29,82,27,38,65
64,8475768,Jaden Schwartz,C,SEA,32,82,27,38,65
64,8475158,Ryan O'Reilly,C,NSH,33,82,23,42,65
64,8480039,Martin Necas,C,CAR,25,82,23,42,65
64,8478873,Troy Terry,R,ANA,27,82,20,45,65
64,8476853,Morgan Rielly,D,TOR,30,82,13,52,65
64,8474563,Drew Doughty,D,LAK,35,82,13,52,65
64,8475754,Brock Nelson,C,NYI,33,82,33,31,64
64,8482078,Lucas Raymond,L,DET,22,82,27,37,64
64,8482665,Matty Beniers,C,SEA,22,82,26,38,64
64,8477402,Pavel Buchnevich,L,STL,29,82,26,38,64
64,8479999,Casey Mittelstadt,C,COL,26,82,26,38,64
64,8476432,Boone Jenner,C,CBJ,31,82,38,25,63
64,8477494,Jonathan Drouin,L,COL,29,82,22,41,63
64,8477447,Shea Theodore,D,VGK,29,82,11,52,63
64,8476479,Phillip Danault,C,LAK,31,82,22,40,62
64,8478438,Tommy Novak,C,NSH,27,82,21,41,62
64,8471214,Alex Ovechkin,L,WSH,39,82,34,26,60
64,8475169,Evander Kane,L,EDM,33,82,28,32,60
64,8476448,William Karlsson,C,VGK,31,82,26,34,60
64,8476905,Chandler Stephenson,C,SEA,30,82,24,36,60
64,8475765,Vladimir Tarasenko,R,DET,33,82,24,36,60
64,8478458,Jack Roslovic,C,CAR,27,82,22,38,60
64,8480803,Evan Bouchard,D,EDM,25,82,13,47,60
64,8477497,Sean Monahan,C,CBJ,30,82,19,40,59
64,8478038,Devon Toews,D,COL,30,82,14,45,59
64,8482740,Wyatt Johnston,C,DAL,21,82,34,24,58
64,8478493,Joel Eriksson Ek,C,MIN,27,82,31,27,58
64,8475184,Chris Kreider,L,NYR,33,82,27,31,58
64,8478444,Brock Boeser,R,VAN,27,82,27,31,58
64,8476483,Rickard Rakell,R,PIT,31,82,24,34,58
64,8478440,Dylan Strome,C,WSH,27,82,23,35,58
64,8474679,Gustav Nyquist,C,NSH,35,82,16,42,58
64,8482671,Owen Power,D,BUF,22,82,11,47,58
64,8477503,Max Domi,C,TOR,29,82,10,48,58
64,8478975,Mason Marchment,L,DAL,29,82,24,33,57
64,8480797,Joel Farabee,L,PHI,24,82,24,33,57
64,8473994,Jamie Benn,L,DAL,35,82,23,34,57
64,8482175,JJ Peterka,R,BUF,22,82,23,34,57
64,8477935,Sam Bennett,C,FLA,28,82,32,24,56
64,8482159,Tyson Foerster,R,PHI,22,82,29,27,56
64,8475745,Charlie Coyle,C,BOS,32,82,29,27,56
64,8478414,Timo Meier,R,NJD,28,82,26,30,56
64,8478233,Andrew Mangiapane,L,WSH,28,82,24,32,56
64,8481068,Yegor Sharangovich,C,CGY,26,82,22,34,56
64,8478856,Conor Garland,R,VAN,28,82,22,34,56
64,8477407,Anthony Duclair,L,NYI,29,82,22,34,56
64,8476882,Teuvo Teravainen,L,CHI,30,82,20,36,56
64,8476906,Shayne Gostisbehere,D,CAR,31,82,15,41,56
64,8479425,Filip Hronek,D,VAN,27,82,14,42,56
64,8482146,Luke Evangelista,R,NSH,22,82,24,31,55
64,8477964,Ivan Barbashev,C,VGK,29,82,22,33,55
64,8482699,Dylan Guenther,R,UTA,21,82,22,33,55
64,8473986,Alex Killorn,L,ANA,35,82,22,33,55
64,8482113,Anton Lundell,C,FLA,23,82,18,37,55
64,8476346,Johnny Gaudreau,L,CBJ,31,82,10,45,55
64,8478366,Frank Vatrano,R,ANA,30,82,29,25,54
64,8482109,Alexis Lafrenière,L,NYR,23,82,28,26,54
64,8480009,Eeli Tolvanen,R,SEA,25,82,22,32,54
64,8476792,Torey Krug,D,STL,33,82,19,35,54
64,8476458,Ryan Strome,C,ANA,31,82,16,38,54
64,8479325,Charlie McAvoy,D,BOS,27,82,7,47,54
64,8479410,Mikhail Sergachev,D,UTA,26,82,6,48,54
64,8477426,Nicholas Paul,L,TBL,29,82,30,23,53
64,8482097,Jack Quinn,R,BUF,23,82,28,25,53
64,8477476,Artturi Lehkonen,L,COL,29,82,25,28,53
64,8478519,Anthony Cirelli,C,TBL,27,82,24,29,53
64,8478047,Michael Bunting,L,PIT,29,82,22,31,53
64,8471698,T.J. Oshie,R,WSH,38,82,21,32,53
64,8478396,Noah Hanifin,D,VGK,27,82,12,41,53
64,8479339,Patrik Laine,L,CBJ,26,82,26,26,52
64,8482149,Cole Perfetti,C,WPG,22,82,24,28,52
64,8474150,Mikael Backlund,C,CGY,35,82,15,37,52
64,8474565,Alex Pietrangelo,D,VGK,34,82,12,40,52
64,8470613,Brent Burns,D,CAR,39,82,9,43,52
64,8478401,Pavel Zacha,C,BOS,27,82,22,29,51
64,8481596,Shane Pinto,C,OTT,24,82,21,30,51
64,8475726,Tyler Toffoli,C,SJS,32,82,21,30,51
64,8476419,Jean-Gabriel Pageau,C,NYI,32,82,19,32,51
64,8477346,MacKenzie Weegar,D,CGY,30,82,13,38,51
64,8475753,Justin Faulk,D,STL,32,82,11,40,51
64,8475764,Cam Fowler,D,ANA,33,82,9,42,51
64,8480014,Gabriel Vilardi,C,WPG,25,82,31,19,50
64,8475170,Brayden Schenn,C,STL,33,82,19,31,50
64,8482124,Quinton Byfield,R,LAK,22,82,18,32,50
64,8481711,Matias Maccelli,L,UTA,24,82,17,33,50
64,8471724,Kris Letang,D,PIT,37,82,16,34,50
64,8476462,Dougie Hamilton,D,NJD,31,82,14,36,50
64,8476456,Jonathan Huberdeau,C,CGY,31,82,10,40,50
64,8476399,Blake Coleman,C,CGY,33,82,36,13,49
64,8478115,Pierre Engvall,L,NYI,28,82,26,23,49
64,8480829,Jesperi Kotkaniemi,C,CAR,24,82,20,29,49
64,8477932,Aaron Ekblad,D,FLA,28,82,14,35,49
64,8476958,Jaccob Slavin,D,CAR,30,82,11,38,49
64,8475314,Anders Lee,L,NYI,34,82,28,20,48
64,8474641,Adam Henrique,C,EDM,34,82,24,24,48
64,8477416,Oliver Bjorkstrand,R,SEA,29,82,23,25,48
64,8475287,Erik Haula,L,NJD,33,82,20,28,48
64,8477511,Anthony Mantha,R,CGY,30,82,18,30,48
64,8476880,Tom Wilson,R,WSH,30,82,29,18,47
64,8482089,Jake Neighbours,L,STL,22,82,26,21,47
64,8479525,Ross Colton,C,COL,28,82,24,23,47
64,8477498,Darnell Nurse,D,EDM,29,82,23,24,47
64,8477479,Tyler Bertuzzi,L,CHI,29,82,18,29,47
64,8479345,Jakob Chychrun,D,WSH,26,82,6,41,47
64,8480064,Josh Norris,C,OTT,25,82,25,21,46
64,8482720,Matthew Knies,L,TOR,22,82,23,23,46
64,8479400,Pierre-Luc Dubois,L,WSH,26,82,22,24,46
64,8476925,Colton Sissons,C,NSH,31,82,21,25,46
64,8477451,Ryan Hartman,R,MIN,30,82,19,27,46
64,8480078,Filip Chytil,C,NYR,25,82,19,27,46
64,8481606,Jordan Spence,D,LAK,23,82,15,31,46
64,8475798,Mikael Granlund,C,SJS,32,82,14,32,46
64,8476826,Yanni Gourde,C,SEA,33,82,13,33,46
64,8476854,Hampus Lindholm,D,BOS,30,82,10,36,46
64,8478469,Thomas Chabot,D,OTT,27,82,9,37,46
64,8477948,Travis Sanheim,D,PHI,28,82,6,40,46
64,8482745,Mason McTavish,C,ANA,21,82,23,22,45
64,8476480,Vladislav Namestnikov,C,WPG,32,82,21,24,45
64,8480849,Barrett Hayton,C,UTA,24,82,21,24,45
64,8480188,Fabian Zetterlund,L,SJS,25,82,20,25,45
64,8477998,Warren Foegele,L,LAK,28,82,17,28,45
64,8476392,Adam Lowry,C,WPG,31,82,16,29,45
64,8477969,Marcus Pettersson,D,PIT,28,82,7,38,45
64,8476872,Scott Laughton,C,PHI,30,82,22,22,44
64,8477425,Miles Wood,L,COL,29,82,22,22,44
64,8473533,Jordan Staal,C,CAR,36,82,21,23,44
64,8478542,Evan Rodrigues,C,FLA,31,82,17,27,44
64,8480434,Sean Durzi,D,UTA,26,82,12,32,44
64,8475218,Mattias Ekholm,D,EDM,34,82,12,32,44
64,8481542,Moritz Seider,D,DET,23,82,8,36,44
64,8478474,Lawson Crouse,L,UTA,27,82,21,22,43
64,8480113,Alex Iafallo,L,WPG,31,82,19,24,43
64,8478057,Dakota Joshua,C,VAN,28,82,19,24,43
64,8480220,Noah Cates,L,PHI,25,82,18,25,43
64,8476292,Ondrej Palat,L,NJD,33,82,17,26,43
64,8476461,Sean Couturier,C,PHI,32,82,16,27,43
64,8475793,Ryan Johansen,C,PHI,32,82,15,28,43
64,8477021,Alex Kerfoot,C,UTA,30,82,14,29,43
64,8478055,Gustav Forsling,D,FLA,28,82,9,34,43
64,8474151,Ryan McDonagh,D,TBL,35,82,7,36,43
64,8477952,Robby Fabbri,C,ANA,28,82,26,16,42
64,8484144,Connor Bedard,C,CHI,19,82,21,21,42
64,8473422,Nick Foligno,L,CHI,37,82,18,24,42
64,8483808,Andrei Kuzmenko,L,CGY,28,82,17,25,42
64,8480802,Ryan McLeod,C,BUF,25,82,14,28,42
64,8477495,Seth Jones,D,CHI,30,82,12,30,42
64,8479987,Morgan Geekie,C,BOS,26,82,11,31,42
64,8477986,Brandon Montour,D,SEA,30,82,9,33,42
64,8480893,Kirill Marchenko,R,CBJ,24,82,26,15,41
64,8474102,David Perron,L,OTT,36,82,21,20,41
64,8481560,Arthur Kaliyev,R,LAK,23,82,19,22,41
64,8475151,Kyle Palmieri,C,NYI,33,82,17,24,41
64,8480835,Jack Drury,C,CAR,24,82,16,25,41
64,8478046,Danton Heinen,L,VAN,29,82,14,27,41
64,8473563,Nicklas Backstrom,C,WSH,37,82,13,28,41
64,8481581,Thomas Harley,D,DAL,23,82,12,29,41
64,8475791,Taylor Hall,L,CHI,33,82,11,30,41
64,8480043,Timothy Liljegren,D,TOR,25,82,6,35,41
64,8475171,Oliver Ekman-Larsson,D,TOR,33,82,4,37,41
64,8475760,Nick Bjugstad,C,UTA,32,82,26,14,40
64,8475722,Jason Zucker,L,BUF,32,82,20,20,40
64,8481618,Alex Newhook,C,MTL,23,82,18,22,40
64,8479365,Trent Frederic,C,BOS,26,82,18,22,40
64,8478462,Nicolas Roy,C,VGK,27,82,17,23,40
64,8477987,Ryan Donato,C,CHI,28,82,15,25,40
64,8478397,Rasmus Andersson,D,CGY,28,82,10,30,40
64,8476438,Brandon Saad,L,STL,32,82,27,12,39
64,8480459,Pius Suter,C,VAN,28,82,22,17,39
64,8474715,Cam Atkinson,R,TBL,35,82,19,20,39
64,8475714,Calle Jarnkrok,C,TOR,33,82,18,21,39
64,8478911,Matt Roy,D,WSH,29,82,13,26,39
64,8480145,Neal Pionk,D,WPG,29,82,10,29,39
64,8476923,Damon Severson,D,CBJ,30,82,8,31,39
64,8479398,Samuel Girard,D,COL,26,82,4,35,39
64,8481704,Juuso Parssinen,C,NSH,23,82,25,13,38
64,8475763,Kevin Hayes,R,PIT,32,82,17,21,38
64,8480074,Alexandre Texier,C,STL,25,82,16,22,38
64,8484145,Zach Benson,L,BUF,19,82,15,23,38
64,8475343,Nic Dowd,C,WSH,34,82,13,25,38
64,8476979,Erik Gustafsson,D,DET,32,82,6,32,38
64,8478463,Anthony Beauvillier,L,PIT,27,82,19,18,37
64,8481604,Pavel Dorofeyev,L,VGK,24,82,19,18,37
64,8475799,Nino Niederreiter,R,WPG,32,82,18,19,37
64,8483515,Juraj Slafkovsky,L,MTL,20,82,15,22,37
64,8481522,Peyton Krebs,C,BUF,23,82,15,22,37
64,8477429,Andrew Copp,C,DET,30,82,14,23,37
64,8474149,Evgenii Dadonov,R,DAL,35,82,14,23,37
64,8477953,Kasperi Kapanen,R,STL,28,82,13,24,37
64,8482475,Yegor Chinakhov,R,CBJ,23,82,11,26,37
64,8476869,Brady Skjei,D,NSH,30,82,9,28,37
64,8482684,Luke Hughes,D,NJD,21,82,6,31,37
64,8477392,Hudson Fasching,R,NYI,29,82,20,16,36
64,8478020,Michael Amadio,C,OTT,28,82,19,17,36
64,8482055,Drew O'Connor,L,PIT,26,82,18,18,36
64,8479293,Brandon Tanev,L,SEA,33,82,18,18,36
64,8477444,Andre Burakovsky,L,SEA,29,82,15,21,36
64,8474053,Logan Couture,C,SJS,35,82,14,22,36
64,8476921,Jordan Martinook,L,CAR,32,82,13,23,36
64,8470621,Corey Perry,R,EDM,39,82,12,24,36
64,8476927,Teddy Blueger,C,VAN,30,82,11,25,36
64,8480871,Adam Boqvist,D,FLA,24,82,11,25,36
64,8475149,Marcus Johansson,L,MIN,34,82,10,26,36
64,8481554,Kaapo Kakko,R,NYR,23,82,22,13,35
64,8481535,Nils Hoglander,L,VAN,24,82,18,17,35
64,8476873,Mark Jankowski,C,NSH,30,82,16,19,35
64,8478472,Mathieu Joseph,R,STL,27,82,14,21,35
64,8482092,Ridly Greig,C,OTT,22,82,12,23,35
64,8482660,Kent Johnson,C,CBJ,22,82,10,25,35
64,8476457,Adam Larsson,D,SEA,32,82,6,29,35
64,8480873,Rasmus Sandin,D,WSH,24,82,3,32,35
64,8476474,Stefan Noesen,R,NJD,31,82,19,15,34
64,8477450,Jason Dickinson,C,CHI,29,82,18,16,34
64,8481580,Connor McMichael,C,WSH,23,82,18,16,34
64,8477947,Sonny Milano,L,WSH,28,82,16,18,34
64,8481186,Logan O'Connor,R,COL,28,82,15,19,34
64,8480798,Philipp Kurashev,C,CHI,25,82,14,20,34
64,8482667,William Eklund,L,SJS,22,82,14,20,34
64,8480748,Kiefer Sherwood,L,VAN,29,82,14,20,34
64,8476960,Andreas Athanasiou,C,CHI,30,82,13,21,34
64,8480185,Eetu Luostarinen,C,FLA,26,82,12,22,34
64,8484153,Leo Carlsson,C,ANA,20,82,11,23,34
64,8477506,Ryan Pulock,D,NYI,30,82,8,26,34
64,8479976,Juuso Valimaki,D,UTA,26,82,6,28,34
64,8476917,Adam Pelech,D,NYI,30,82,5,29,34
64,8476892,Colton Parayko,D,STL,31,82,5,29,34
64,8476981,Josh Anderson,R,MTL,30,82,24,9,33
64,8482079,Marco Rossi,C,MIN,23,82,23,10,33
64,8482110,Dawson Mercer,C,NJD,23,82,20,13,33
64,8479368,Max Jones,L,BOS,26,82,18,15,33
64,8474189,Lars Eller,C,PIT,35,82,16,17,33
64,8479591,Michael Eyssimont,C,TBL,28,82,16,17,33
64,8478413,Jordan Greenway,L,BUF,27,82,16,17,33
64,8477903,Garnet Hathaway,R,PHI,33,82,16,17,33
64,8480980,Connor Dewar,C,TOR,25,82,13,20,33
64,8481601,Simon Holmstrom,R,NYI,23,82,13,20,33
64,8476329,Travis Boyd,C,MIN,31,82,10,23,33
64,8481032,Paul Cotter,C,NJD,25,82,18,14,32
64,8479353,Brett Howden,C,VGK,26,82,15,17,32
64,8475193,Tomas Tatar,L,NJD,34,82,15,17,32
64,8480336,Sean Walker,D,CAR,30,82,9,23,32
64,8476885,Jacob Trouba,D,NYR,30,82,8,24,32
64,8475200,Dmitry Orlov,D,CAR,33,82,7,25,32
64,8481178,Egor Zamula,D,PHI,24,82,6,26,32
64,8482655,J.J. Moser,D,TBL,24,82,5,27,32
64,8480049,Dylan Samberg,D,WPG,25,82,4,28,32
64,8483565,Nick Blankenburg,D,NSH,26,82,3,29,32
64,8476278,Colin Blackwell,C,DAL,31,82,22,9,31
64,8479941,Justin Danforth,R,CBJ,31,82,18,13,31
64,8477989,Christian Dvorak,C,MTL,28,82,15,16,31
64,8480789,Oliver Wahlstrom,R,NYI,24,82,15,16,31
64,8481013,Jonatan Berggren,R,DET,24,82,14,17,31
64,8478434,Keegan Kolesar,R,VGK,27,82,14,17,31
64,8481553,Bobby Brink,R,PHI,23,82,11,20,31
64,8481624,Ilya Mikheyev,R,CHI,30,82,10,21,31
64,8479351,Sam Steel,C,DAL,26,82,9,22,31
64,8475855,Jesper Fast,R,CAR,33,82,8,23,31
64,8476463,Jonas Brodin,D,MIN,31,82,5,26,31
64,8481582,Nicholas Robertson,L,TOR,23,82,18,12,30
64,8480068,Ryan Poehling,C,PHI,25,82,17,13,30
64,8476918,Jimmy Vesey,L,NYR,31,82,17,13,30
64,8482117,Lukas Reichel,L,CHI,22,82,17,13,30
64,8476469,Joel Armia,R,MTL,31,82,15,15,30
64,8483431,Logan Cooley,C,UTA,20,82,13,17,30
64,8481546,Cam York,D,PHI,23,82,11,19,30
64,8480995,Pontus Holmberg,R,TOR,25,82,10,20,30
64,8480003,Jesper Boqvist,C,FLA,26,82,9,21,30
64,8478500,Ivan Provorov,D,CBJ,27,82,6,24,30
64,8479371,Dante Fabbro,D,NSH,26,82,2,28,30
64,8482624,Daniil Miromanov,D,CGY,27,82,15,14,29
64,8477839,Conor Sheary,L,TBL,32,82,14,15,29
64,8479393,Noah Gregor,C,OTT,26,82,14,15,29
64,8479414,Nathan Bastian,R,NJD,27,82,14,15,29
64,8482705,Cole Sillinger,C,CBJ,21,82,12,17,29
64,8480144,David Kampf,C,TOR,29,82,12,17,29
64,8481656,Aliaksei Protas,C,WSH,23,82,9,20,29
64,8482105,Jake Sanderson,D,OTT,22,82,8,21,29
64,8482133,Thomas Bordeleau,C,SJS,22,82,8,21,29
64,8478851,Alexandre Carrier,D,NSH,28,82,4,25,29
64,8478178,Darren Raddysh,D,TBL,28,82,2,27,29
64,8482073,Braden Schneider,D,NYR,23,82,2,27,29
64,8479390,Taylor Raddysh,R,WSH,26,82,19,9,28
64,8481093,Rafael Harvey-Pinard,L,MTL,25,82,16,12,28
64,8482062,Cole Smith,L,NSH,29,82,13,15,28
64,8478891,Mason Appleton,C,WPG,28,82,11,17,28
64,8478882,Vladislav Gavrikov,D,LAK,29,82,11,17,28
64,8477353,Tyler Motte,C,DET,29,82,11,17,28
64,8482803,Olen Zellweger,D,ANA,21,82,9,19,28
64,8476902,Esa Lindell,D,DAL,30,82,7,21,28
64,8481014,Alexander Romanov,D,NYI,24,82,2,26,28
64,8480813,Joe Veleno,C,DET,24,82,17,10,27
64,8482155,Alex Laferriere,R,LAK,23,82,16,11,27
64,8475220,Marcus Foligno,L,MIN,33,82,13,14,27
64,8476312,Josh Manson,D,COL,33,82,13,14,27
64,8475231,Casey Cizikas,C,NYI,33,82,13,14,27
64,8476897,Oskar Sundqvist,C,STL,30,82,12,15,27
64,8480448,Parker Kelly,L,COL,25,82,12,15,27
64,8477508,Curtis Lazar,C,NJD,29,82,10,17,27
64,8482807,Ethan Del Mastro,D,CHI,21,82,9,18,27
64,8477220,Nate Schmidt,D,FLA,33,82,8,19,27
64,8478133,Jake Evans,C,MTL,28,82,7,20,27
64,8476331,Dylan DeMelo,D,WPG,31,82,6,21,27
64,8475324,Nick Jensen,D,OTT,34,82,4,23,27
64,8480817,K'Andre Miller,D,NYR,24,82,3,24,27
64,8477406,Mattias Janmark,C,EDM,32,82,15,11,26
64,8479992,Michael Rasmussen,C,DET,25,82,12,14,26
64,8479661,Tanner Jeannot,L,LAK,27,82,12,14,26
64,8484149,Gavin Brindley,C,CBJ,20,82,12,14,26
64,8481517,Brett Leason,R,ANA,25,82,11,15,26
64,8482111,Justin Barron,D,MTL,23,82,10,16,26
64,8481567,Henry Thrun,D,SJS,23,82,9,17,26
64,8477015,Connor Brown,R,EDM,30,82,8,18,26
64,8480855,Jack McBain,C,UTA,24,82,7,19,26
64,8475690,Chris Tanev,D,TOR,35,82,7,19,26
64,8482142,Jamie Drysdale,D,PHI,22,82,5,21,26
64,8475181,Nick Leddy,D,STL,33,82,5,21,26
64,8478416,Erik Cernak,D,TBL,27,82,3,23,26
64,8475848,Brendan Gallagher,R,MTL,32,82,16,9,25
64,8476467,Jamie Oleksiak,D,SEA,32,82,14,11,25
64,8479359,Beck Malenstyn,L,BUF,26,82,14,11,25
64,8477931,Tomas Nosek,L,FLA,32,82,9,16,25
64,8476878,Zemgus Girgensons,L,TBL,30,82,9,16,25
64,8477369,Carson Soucy,D,VAN,30,82,7,18,25
64,8479402,Jake Bean,D,CGY,26,82,7,18,25
64,8480246,Nick Perbix,D,TBL,26,82,6,19,25
64,8477365,Connor Clifton,D,BUF,29,82,4,21,25
64,8476931,Jake McCabe,D,TOR,31,82,1,24,25
64,8478432,Christian Fischer,R,DET,27,82,11,13,24
64,8481481,Blake Lizotte,C,PIT,27,82,10,14,24
64,8477919,Frederick Gaudreau,C,MIN,31,82,7,17,24
64,8480807,Mattias Samuelsson,D,BUF,24,82,6,18,24
64,8482245,Artem Zub,D,OTT,29,82,5,19,24
64,8476525,Colin Miller,D,WPG,32,82,4,20,24
64,8480878,Nils Lundkvist,D,DAL,24,82,3,21,24
64,8480834,Ty Emberson,D,SJS,24,82,3,21,24
64,8478109,Victor Olofsson,L,VGK,29,82,13,10,23
64,8475842,Sam Carrick,C,NYR,32,82,12,11,23
64,8480281,Alexey Toropchenko,R,STL,25,82,10,13,23
64,8478569,Noel Acciari,C,PIT,33,82,10,13,23
64,8483763,Maksymilian Szuber,D,UTA,22,82,9,14,23
64,8474716,Jared Spurgeon,D,MIN,35,82,8,15,23
64,8481028,Martin Pospisil,C,CGY,25,82,8,15,23
64,8483505,Matthew Poitras,C,BOS,20,82,8,15,23
64,8482153,Brendan Brisson,C,VGK,23,82,5,18,23
64,8477488,Brett Pesce,D,NJD,30,82,4,19,23
64,8482122,Brock Faber,D,MIN,22,82,3,20,23
64,8482259,Bobby McMann,C,TOR,28,82,14,8,22
64,8482679,Matt Coronato,R,CGY,22,82,11,11,22
64,8476822,Luke Glendening,C,TBL,35,82,9,13,22
64,8476889,Radek Faksa,C,STL,30,82,7,15,22
64,8480028,Morgan Frost,C,PHI,25,82,6,16,22
64,8474574,Tyler Myers,D,VAN,34,82,6,16,22
64,8483457,Lane Hutson,D,MTL,20,82,4,18,22
64,8475188,Brayden McNabb,D,VGK,33,82,3,19,22
64,8476442,Matt Nieto,L,PIT,32,82,14,7,21
64,8478013,Jake Walman,D,SJS,28,82,11,10,21
64,8484203,Bradly Nadeau,L,CAR,19,82,8,13,21
64,8483524,Shane Wright,C,SEA,20,82,8,13,21
64,8483466,Kevin Korchinski,D,CHI,20,82,6,15,21
64,8478507,John Marino,D,UTA,27,82,4,17,21
64,8481708,Zac Jones,D,NYR,24,82,3,18,21
64,8476891,Matt Grzelcyk,D,PIT,30,82,2,19,21
64,8474673,TJ Brodie,D,CHI,34,82,1,20,21
64,8475233,David Savard,D,MTL,34,82,1,20,21
64,8480035,Henri Jokiharju,D,BUF,25,82,1,20,21
64,8476374,Sean Kuraly,C,CBJ,31,82,11,9,20
64,8480806,Isac Lundestrom,C,ANA,25,82,9,11,20
64,8483012,Logan Morrison,C,SEA,22,82,9,11,20
64,8484166,Adam Fantilli,C,CBJ,20,82,7,13,20
64,8483445,Cutter Gauthier,L,ANA,20,82,7,13,20
64,8479983,Mario Ferraro,D,SJS,26,82,7,13,20
64,8477507,Nikita Zadorov,D,BOS,29,82,5,15,20
64,8475455,Brenden Dillon,D,NJD,34,82,5,15,20
64,8482087,Kaiden Guhle,D,MTL,22,82,5,15,20
64,8482858,Ryker Evans,D,SEA,23,82,5,15,20
64,8475462,Radko Gudas,D,ANA,34,82,4,16,20
64,8475718,Justin Holl,D,DET,32,82,2,18,20
64,8476429,Scott Mayfield,D,NYI,32,82,1,19,20
64,8473507,Jeff Petry,D,DET,37,82,0,20,20
64,8476879,Cody Ceci,D,EDM,31,82,0,20,20
64,8473453,Trevor Lewis,C,LAK,37,82,12,7,19
64,8479996,Cody Glass,C,NSH,25,82,11,8,19
64,8478508,Yakov Trenin,C,MIN,27,82,10,9,19
64,8481477,Nico Sturm,C,SJS,29,82,10,9,19
64,8478136,Jake Middleton,D,MIN,28,82,9,10,19
64,8480021,Jack Studnicka,C,LAK,25,82,9,10,19
64,8482101,Danil Gushchin,L,SJS,22,82,8,11,19
64,8482666,Scott Morrow,D,CAR,22,82,8,11,19
64,8476858,Phillip Di Giuseppe,L,VAN,31,82,8,11,19
64,8476624,Barclay Goodrow,C,SJS,31,82,6,13,19
64,8480073,Erik Brannstrom,D,COL,25,82,4,15,19
64,8482749,Joshua Roy,R,MTL,21,82,4,15,19
64,8477938,Haydn Fleury,D,WPG,28,82,4,15,19
64,8478840,Will Borgen,D,SEA,28,82,3,16,19
64,8481568,Alex Vlasic,D,CHI,23,82,3,16,19
64,8479369,Andrew Peeke,D,BOS,26,82,3,16,19
64,8478399,Jonas Siegenthaler,D,NJD,27,82,2,17,19
64,8476967,Brett Kulak,D,EDM,30,82,2,17,19
64,8482141,Lukas Cormier,D,VGK,22,82,8,10,18
64,8476422,Mike Reilly,D,NYI,31,82,6,12,18
64,8477435,Ryan Graves,D,PIT,29,82,3,15,18
64,8479998,Mikey Anderson,D,LAK,25,82,3,15,18
64,8478859,Niko Mikkola,D,FLA,28,82,2,16,18
64,8479980,Nicolas Hague,D,VGK,26,82,2,16,18
64,8480879,Jacob Bernard-Docker,D,OTT,24,82,2,16,18
64,8482077,Dylan Holloway,L,EDM,23,82,10,7,17
64,8482659,Josh Doan,R,UTA,22,82,10,7,17
64,8479316,Luke Kunin,C,SJS,27,82,8,9,17
64,8482166,Shakir Mukhamadullin,D,SJS,22,82,7,10,17
64,8482702,Logan Stankoven,C,DAL,21,82,7,10,17
64,8482074,Connor Zary,C,CGY,23,82,6,11,17
64,8482733,Logan Mailloux,D,MTL,31,82,4,13,17
64,8475279,Ben Chiarot,D,DET,33,82,4,13,17
64,8483499,Liam Ohgren,L,MIN,20,82,4,13,17
64,8482145,Mavrik Bourque,C,DAL,22,82,4,13,17
64,8481122,Simon Benoit,D,TOR,26,82,4,13,17
64,8483490,Pavel Mintyukov,D,ANA,21,82,3,14,17
64,8482125,Alexander Holtz,R,VGK,22,82,9,7,16
64,8478211,Dryden Hunt,L,CGY,29,82,8,8,16
64,8479291,Kevin Rooney,C,CGY,31,82,6,10,16
64,8475790,Erik Gudbranson,D,CBJ,32,82,5,11,16
64,8482516,Matthew Kessel,D,STL,24,82,4,12,16
64,8477034,Jaycob Megna,D,FLA,32,82,4,12,16
64,8477335,Kyle Burroughs,D,LAK,29,82,4,12,16
64,8479324,Ryan Lindgren,D,NYR,26,82,1,15,16
64,8482809,Jackson Blake,R,CAR,21,82,9,6,15
64,8478450,Parker Wotherspoon,D,BOS,27,82,6,9,15
64,8480025,MacKenzie Entwistle,R,FLA,25,82,6,9,15
64,8483397,Marc McLaughlin,C,BOS,25,82,6,9,15
64,8478443,Brandon Carlo,D,BOS,28,82,5,10,15
64,8479576,Vincent Desharnais,D,VAN,28,82,5,10,15
64,8480172,Jan Rutta,D,SJS,34,82,3,12,15
64,8480222,Sebastian Aho,D,PIT,28,82,3,12,15
64,8483482,Tristan Luneau,D,ANA,20,82,3,12,15
64,8476372,Nick Seeler,D,PHI,31,82,2,13,15
64,8478468,Jeremy Lauzon,D,NSH,27,82,2,13,15
64,8481524,Bowen Byram,D,BUF,23,82,1,14,15
64,8483471,Brad Lambert,C,WPG,31,82,6,8,14
64,8480950,Ilya Lyubushkin,D,DAL,30,82,6,8,14
64,8482859,Zack Ostapchuk,C,OTT,21,82,5,9,14
64,8480860,Kevin Bahl,D,CGY,24,82,3,11,14
64,8477845,Trevor van Riemsdyk,D,WSH,33,82,2,12,14
64,8483495,Simon Nemec,D,NJD,20,82,2,12,14
64,8471677,Jack Johnson,D,CBJ,37,82,2,12,14
64,8476441,Joel Edmundson,D,LAK,31,82,2,12,14
64,8480796,Martin Fehervary,D,WSH,25,82,1,13,14
64,8470600,Ryan Suter,D,STL,39,82,1,13,14
64,8477505,Alexander Wennberg,C,SJS,30,82,10,3,13
64,8482470,Ilya Solovyov,D,CGY,24,82,8,5,13
64,8482070,Mitchell Chaffee,R,TBL,26,82,8,5,13
64,8483493,Frank Nazar,C,CHI,20,82,7,6,13
64,8480870,Bo Groulx,C,NYR,24,82,6,7,13
64,8482118,Sam Colangelo,R,ANA,23,82,5,8,13
64,8475762,Derek Forbort,D,VAN,32,82,4,9,13
64,8477499,Rasmus Ristolainen,D,PHI,30,82,3,10,13
64,8481605,Jackson LaCombe,D,ANA,23,82,1,12,13
64,8474612,Travis Hamonic,D,OTT,34,82,0,13,13
64,8481641,Joel Kiviranta,L,COL,28,82,7,5,12
64,8484911,Collin Graf,R,SJS,22,82,5,7,12
64,8479638,Justin Brazeau,R,BOS,26,82,5,7,12
64,8474090,Brendan Smith,D,DAL,35,82,4,8,12
64,8483468,Jiri Kulich,C,BUF,20,82,3,9,12
64,8480990,Declan Chisholm,D,MIN,24,82,3,9,12
64,8482712,Oskar Olausson,R,COL,22,82,5,6,11
64,8474013,Ian Cole,D,UTA,35,82,5,6,11
64,8482762,Simon Edvinsson,D,DET,21,82,4,7,11
64,8482787,Nikita Chibrikov,R,WPG,31,82,3,8,11
64,8476473,Connor Murphy,D,CHI,31,82,2,9,11
64,8479442,Troy Stecher,D,EDM,30,82,5,5,10
64,8478874,Adam Gaudette,C,OTT,28,82,3,7,10
64,8482713,Mackie Samoskevich,R,FLA,22,82,1,9,10
64,8475177,Calvin de Haan,D,COL,33,82,4,5,9
64,8474567,Zach Bogosian,D,MIN,34,82,1,8,9
64,8483489,Fraser Minten,C,TOR,31,82,4,4,8
64,8483460,David Jiricek,D,CBJ,21,82,2,6,8
64,8474062,Riley Nash,C,NYR,35,82,2,6,8
64,8481699,Aku Raty,R,UTA,23,82,2,5,7
64,8483567,Georgii Merkulov,C,BOS,24,82,1,3,4
64,8470794,Joe Pavelski,C,,40,0,0,0,0
64,8481703,Valtteri Puustinen,R,PIT,25,0,0,0,0
64,8477950,Tony DeAngelo,D,,29,0,0,0,0
64,8481577,Philip Tomasino,C,NSH,23,0,0,0,0
64,8475197,Tyson Barrie,D,,33,0,0,0,0
64,8471218,Blake Wheeler,R,,38,0,0,0,0
64,8474157,Max Pacioretty,L,,36,0,0,0,0
64,8478466,Daniel Sprong,R,VAN,27,0,0,0,0
64,8475744,Evgeny Kuznetsov,C,,32,0,0,0,0
64,8481019,David Gustafsson,C,WPG,24,0,0,0,0
64,8475906,John Klingberg,D,,32,0,0,0,0
64,8479348,Kale Clague,D,BUF,26,0,0,0,0
64,8476952,Dominic Toninato,C,WPG,30,0,0,0,0
64,8473473,Milan Lucic,L,,36,0,0,0,0
64,8474037,James van Riemsdyk,L,,35,0,0,0,0
64,8474602,Justin Schultz,D,,34,0,0,0,0
64,8482222,Alexander Barabanov,L,,30,0,0,0,0
64,8479372,Josh Mahura,D,SEA,26,0,0,0,0
64,8479982,Conor Timmins,D,TOR,26,0,0,0,0
64,8474031,Kevin Shattenkirk,D,,35,0,0,0,0
64,8480008,Adam Ruzicka,C,,25,0,0,0,0
64,8481059,Scott Perunovich,D,STL,26,0,0,0,0
64,8480884,Calen Addison,D,,24,0,0,0,0
64,8476994,Vinnie Hinostroza,C,NSH,30,0,0,0,0
64,8478452,Caleb Jones,D,LAK,27,0,0,0,0
64,8480157,Calle Rosen,D,COL,30,0,0,0,0
64,8481609,Vladislav Kolyachonok,D,UTA,23,0,0,0,0
64,8479415,Michael McLeod,C,,26,0,0,0,0
64,8476919,Chris Tierney,C,,30,0,0,0,0
64,8479639,Dylan Coghlan,D,WPG,26,0,0,0,0
64,8478146,Matthew Highmore,C,OTT,28,0,0,0,0
64,8478970,Jalen Chatfield,D,CAR,28,0,0,0,0
64,8480205,Emil Bemstrom,C,PIT,25,0,0,0,0
64,8474884,Mike Hoffman,C,,35,0,0,0,0
64,8471274,Alex Goligoski,D,,39,0,0,0,0
64,8478104,Sammy Blais,L,,28,0,0,0,0
64,8474870,Tyler Johnson,C,,34,0,0,0,0
64,8476913,Devin Shore,C,MIN,30,0,0,0,0
64,8481598,Philip Broberg,D,EDM,23,0,0,0,0
64,8480058,Pierre-Olivier Joseph,D,STL,25,0,0,0,0
64,8480891,Michael Kesselring,D,UTA,24,0,0,0,0
64,8477979,Nicolas Aube-Kubel,R,BUF,28,0,0,0,0
64,8476871,Tanner Pearson,L,,32,0,0,0,0
64,8476393,Nick Cousins,C,,31,0,0,0,0
64,8479977,Kailer Yamamoto,R,,26,0,0,0,0
64,8479543,Michael Pezzetta,L,MTL,26,0,0,0,0
64,8477018,Ben Hutton,D,VGK,31,0,0,0,0
64,8480762,Eric Robinson,L,CAR,29,0,0,0,0
64,8474034,Pat Maroon,L,CHI,36,0,0,0,0
64,8481058,Jesse Ylönen,R,,25,0,0,0,0
64,8475179,Dmitry Kulikov,D,FLA,34,0,0,0,0
64,8481527,Kaedan Korczak,D,VGK,23,0,0,0,0
64,8473449,Kyle Okposo,R,,36,0,0,0,0
64,8482192,Isaak Phillips,D,CHI,23,0,0,0,0
64,8480727,Zach Whitecloud,D,VGK,28,0,0,0,0
64,8479346,Dillon Dube,C,,26,0,0,0,0
64,8480821,Filip Zadina,R,,25,0,0,0,0
64,8480001,Urho Vaakanainen,D,ANA,25,0,0,0,0
64,8470966,Mark Giordano,D,,41,0,0,0,0
64,8480853,Liam Foudy,C,,24,0,0,0,0
64,8475225,Craig Smith,C,CHI,35,0,0,0,0
64,8479972,Mason Shaw,C,WPG,26,0,0,0,0
64,8478451,Ethan Bear,D,WSH,27,0,0,0,0
64,8474040,Sam Gagner,C,,35,0,0,0,0
64,8480196,Jacob Bryson,D,BUF,27,0,0,0,0
64,8479984,Cal Foote,D,,26,0,0,0,0
64,8480011,Klim Kostin,C,SJS,25,0,0,0,0
64,8482176,Wyatt Kaiser,D,CHI,22,0,0,0,0
64,8476988,Matt Benning,D,SJS,30,0,0,0,0
64,8479370,Tyson Jost,C,CAR,26,0,0,0,0
64,8477464,Nic Petan,C,,29,0,0,0,0
64,8477380,Jonny Brodzinski,C,NYR,31,0,0,0,0
64,8480070,Ian Mitchell,D,BOS,25,0,0,0,0
64,8479315,Joey Anderson,R,CHI,26,0,0,0,0
64,8478099,Kevin Labanc,R,,29,0,0,0,0
64,8476874,Olli Maatta,D,DET,30,0,0,0,0
64,8475208,Brian Dumoulin,D,ANA,33,0,0,0,0
64,8478430,Oliver Kylington,D,,27,0,0,0,0
64,8479536,Axel Jonsson-Fjallby,L,WPG,26,0,0,0,0
64,8479671,Mathieu Olivier,R,CBJ,27,0,0,0,0
64,8471709,Marc-Edouard Vlasic,D,SJS,37,0,0,0,0
64,8479328,Julien Gauthier,R,NYI,27,0,0,0,0
64,8478421,A.J. Greer,L,FLA,28,0,0,0,0
64,8477573,Nathan Walker,L,STL,30,0,0,0,0
64,8481537,Nikita Okhotiuk,D,CGY,24,0,0,0,0
64,8474166,Alec Martinez,D,CHI,37,0,0,0,0
64,8470610,Zach Parise,L,,40,0,0,0,0
64,8477478,William Carrier,L,CAR,30,0,0,0,0
64,8479344,Jesse Puljujarvi,R,PIT,26,0,0,0,0
64,8480887,Jordan Harris,D,MTL,24,0,0,0,0
64,8478502,Dennis Gilbert,D,BUF,28,0,0,0,0
64,8482730,Brandt Clarke,D,LAK,21,0,0,0,0
64,8480355,Mark Kastelic,C,BOS,25,0,0,0,0
64,8475750,Jon Merrill,D,MIN,32,0,0,0,0
64,8475164,Jakob Silfverberg,R,,34,0,0,0,0
64,8477944,Jakub Vrana,L,,28,0,0,0,0
64,8479439,Jacob MacDonald,D,COL,31,0,0,0,0
64,8474568,Luke Schenn,D,NSH,35,0,0,0,0
64,8478454,Noah Juulsen,D,VAN,27,0,0,0,0
64,8475752,Tyler Pitlick,C,,33,0,0,0,0
64,8482148,Hendrix Lapierre,C,WSH,22,0,0,0,0
64,8481167,Brayden Pachal,D,CGY,25,0,0,0,0
64,8478043,Sam Lafferty,C,BUF,29,0,0,0,0
64,8479321,Lucas Johansen,D,,27,0,0,0,0
64,8471699,Andrew Cogliano,C,,37,0,0,0,0
64,8481521,Ronnie Attard,D,PHI,25,0,0,0,0
64,8481161,Jake Christiansen,D,CBJ,25,0,0,0,0
64,8479458,Nikita Zaitsev,D,,33,0,0,0,0
64,8479619,Michael Carcone,L,UTA,28,0,0,0,0
64,8479026,Philippe Myers,D,TOR,27,0,0,0,0
64,8477330,Dominik Kubalik,L,,29,0,0,0,0
64,8481617,Vasily Podkolzin,R,VAN,23,0,0,0,0
64,8481701,Santeri Hatakka,D,NJD,23,0,0,0,0
64,8479514,Rem Pitlick,C,,27,0,0,0,0
64,8477446,Michael McCarron,R,NSH,29,0,0,0,0
64,8470604,Jeff Carter,C,,39,0,0,0,0
64,8482241,Radim Zohorna,L,,28,0,0,0,0
64,8480289,Morgan Barron,C,WPG,26,0,0,0,0
64,8479379,Givani Smith,R,SJS,26,0,0,0,0
64,8480216,Jacob Peterson,C,,25,0,0,0,0
64,8477851,Jordan Oesterle,D,BOS,32,0,0,0,0
64,8484258,Sam Malinski,D,COL,26,0,0,0,0
64,8478904,Steven Lorentz,C,,28,0,0,0,0
64,8482095,Tyler Kleven,D,OTT,22,0,0,0,0
64,8480848,Ty Dellandrea,C,SJS,24,0,0,0,0
64,8476884,Derrick Pouliot,D,,30,0,0,0,0
64,8479336,Carl Grundstrom,R,SJS,27,0,0,0,0
64,8482964,Arber Xhekaj,D,MTL,23,0,0,0,0
64,8471686,Marc Staal,D,,37,0,0,0,0
64,8477887,Patrick Brown,C,BOS,32,0,0,0,0
64,8478495,Denis Gurianov,R,,27,0,0,0,0
64,8473504,Cal Clutterbuck,R,,37,0,0,0,0
64,8481550,Adam Beckman,L,NJD,23,0,0,0,0
64,8480845,Rasmus Kupari,C,WPG,24,0,0,0,0
64,8474009,Nick Bonino,C,,36,0,0,0,0
64,8478585,Derek Ryan,C,EDM,38,0,0,0,0
64,8477962,Brendan Lemieux,L,CAR,28,0,0,0,0
64,8482861,Vincent Iorio,D,WSH,22,0,0,0,0
64,8479378,Logan Stanley,D,WPG,26,0,0,0,0
64,8473446,Erik Johnson,D,PHI,36,0,0,0,0
64,8481743,Marc Del Gaizo,D,NSH,25,0,0,0,0
64,8477384,Josh Brown,D,EDM,30,0,0,0,0
64,8482165,Yan Kuznetsov,D,CGY,22,0,0,0,0
64,8478424,Jansen Harkins,C,ANA,27,0,0,0,0
64,8482144,Jack Thompson,D,SJS,22,0,0,0,0
64,8478512,Austin Czarnik,C,,32,0,0,0,0
64,8477527,Ross Johnston,L,ANA,30,0,0,0,0
64,8479383,Boris Katchouk,L,,26,0,0,0,0
64,8482094,Daemon Hunt,D,MIN,22,0,0,0,0
64,8481719,Maxwell Crozier,D,TBL,24,0,0,0,0
64,8480192,Johnathan Kovacevic,D,NJD,27,0,0,0,0
64,8479376,Victor Mete,D,,26,0,0,0,0
64,8482511,Mason Lohrei,D,BOS,23,0,0,0,0
64,8475825,Jani Hakanpää,D,,32,0,0,0,0
64,8478021,William Lagesson,D,DET,28,0,0,0,0
64,8475795,Dylan McIlrath,D,WSH,32,0,0,0,0
64,8477846,Ryan Carpenter,C,,33,0,0,0,0
64,8481056,Spencer Stastney,D,NSH,24,0,0,0,0
64,8481564,Ryan Johnson,D,BUF,23,0,0,0,0
64,8478017,Mark Friedman,D,VAN,29,0,0,0,0
64,8479320,Max Lajoie,D,SEA,27,0,0,0,0
64,8480075,Cameron Crotty,D,MIN,25,0,0,0,0
64,8484287,Cole McWard,D,VAN,23,0,0,0,0
64,8484254,Akito Hirose,D,VAN,25,0,0,0,0
64,8483407,Brandon Scanlin,D,NYR,25,0,0,0,0
64,8480274,Philip Kemp,D,EDM,25,0,0,0,0
64,8479522,Hardy Haman Aktell,D,WSH,26,0,0,0,0
64,8480007,Jonas Rondbjerg,R,VGK,25,0,0,0,0
64,8477454,Adam Erne,L,,29,0,0,0,0
64,8481679,Maxence Guenette,D,OTT,23,0,0,0,0
64,8480441,Trey Fix-Wolansky,R,CBJ,25,0,0,0,0
64,8483546,Marshall Rifai,D,TOR,26,0,0,0,0
64,8480084,Nick DeSimone,D,NJD,30,0,0,0,0
64,8481030,Jack St. Ivany,D,PIT,25,0,0,0,0
64,8481592,Jakob Pelletier,L,CGY,23,0,0,0,0
64,8478011,Louie Belpedio,D,PHI,28,0,0,0,0
64,8477930,Pierre-Edouard Bellemare,L,,39,0,0,0,0
64,8484321,Nikolas Matinpalo,D,OTT,26,0,0,0,0
64,8482067,Connor Mackey,D,NYR,28,0,0,0,0
64,8481806,Louis Crevier,D,CHI,23,0,0,0,0
64,8484326,Patrik Koch,D,UTA,28,0,0,0,0
64,8477971,Andreas Englund,D,LAK,28,0,0,0,0
64,8481751,Lukas Rousek,R,BUF,25,0,0,0,0
64,8481006,Tyler Tucker,D,STL,24,0,0,0,0
64,8476867,Brendan Gaunce,C,MIN,30,0,0,0,0
64,8479520,Brandon Duhaime,R,WSH,27,0,0,0,0
64,8477073,Kurtis MacDermid,L,NJD,30,0,0,0,0
64,8480874,Adam Ginning,D,PHI,24,0,0,0,0
64,8477473,Justin Bailey,R,SJS,29,0,0,0,0
64,8479066,Ryan Lomberg,L,CGY,30,0,0,0,0
64,8477070,Liam O'Brien,C,UTA,30,0,0,0,0
64,8474618,Marco Scandella,D,,34,0,0,0,0
64,8475797,Jarred Tinordi,D,,32,0,0,0,0
64,8481441,Joe Snively,C,DET,28,0,0,0,0
64,8477244,Chad Ruhwedel,D,NYR,34,0,0,0,0
64,8479772,Zack MacEwen,R,OTT,28,0,0,0,0
64,8481147,Reese Johnson,C,MIN,26,0,0,0,0
64,8481043,Cole Koepke,L,BOS,26,0,0,0,0
64,8483619,Filip Roos,D,OTT,25,0,0,0,0
64,8481541,Samuel Bolduc,D,NYI,24,0,0,0,0
64,8477810,Joel Hanley,D,CGY,33,0,0,0,0
64,8476907,Mackenzie MacEachern,L,,30,0,0,0,0
64,8482652,Walker Duehr,R,CGY,27,0,0,0,0
64,8477126,Jayson Megna,C,,34,0,0,0,0
64,8483398,Declan Carlile,D,TBL,31,0,0,0,0
64,8482929,Emil Lilleberg,D,TBL,23,0,0,0,0
64,8480880,Jakub Lauko,C,MIN,24,0,0,0,0
64,8480245,Olle Lycksell,R,PHI,25,0,0,0,0
64,8480252,Cole Guttman,C,CHI,25,0,0,0,0
64,8477467,Gustav Olofsson,D,SEA,30,0,0,0,0
64,8479968,Vinni Lettieri,C,BOS,29,0,0,0,0
64,8478400,Colin White,C,,27,0,0,0,0
64,8475755,Alexander Petrovic,D,DAL,32,0,0,0,0
64,8481812,Nikolai Knyzhov,D,,27,0,0,0,0
64,8481593,Jayden Struble,D,MTL,23,0,0,0,0
64,8481532,Alex Turcotte,C,LAK,23,0,0,0,0
64,8482126,Emil Andrae,D,PHI,31,0,0,0,0
64,8479944,Zach Aston-Reese,C,VGK,30,0,0,0,0
64,8471817,Ryan Reaves,R,TOR,37,0,0,0,0
64,8481206,John Ludvig,D,PIT,24,0,0,0,0
64,8481599,Victor Soderstrom,D,UTA,23,0,0,0,0
64,8480292,Carson Meyer,R,ANA,27,0,0,0,0
64,8482496,Nils Aman,C,VAN,24,0,0,0,0
64,8479718,Alex Barré-Boulet,C,MTL,27,0,0,0,0
64,8479994,Jaret Anderson-Dolan,C,WPG,25,0,0,0,0
64,8480184,Gustav Lindstrom,D,,26,0,0,0,0
64,8480890,Jan Jenik,R,OTT,24,0,0,0,0
64,8478067,Oskar Lindblom,L,,28,0,0,0,0
64,8476934,Brock McGinn,L,ANA,30,0,0,0,0
64,8479985,Cale Fleury,D,SEA,26,0,0,0,0
64,8484304,Uvis Balinskis,D,FLA,28,0,0,0,0
64,8479981,Jonah Gadjovich,L,FLA,26,0,0,0,0
64,8481716,Dmitri Voronkov,L,CBJ,24,0,0,0,0
64,8474709,Matt Martin,L,,35,0,0,0,0
64,8482634,Alex Steeves,C,TOR,25,0,0,0,0
64,8480823,Alexander Alexeyev,D,WSH,25,0,0,0,0
64,8477541,Dakota Mermis,D,TOR,30,0,0,0,0
64,8483491,Ivan Miroshnichenko,L,WSH,20,0,0,0,0
64,8478477,Mitchell Stephens,C,SEA,27,0,0,0,0
64,8481543,Nikita Alexandrov,C,STL,24,0,0,0,0
64,8479423,Alex Nylander,L,,26,0,0,0,0
64,8482451,Mikael Pyyhtia,L,CBJ,23,0,0,0,0
64,8478831,Kevin Stenlund,C,UTA,28,0,0,0,0
64,8480306,Grant Hutton,D,NYI,29,0,0,0,0
64,8478028,Fredrik Olofsson,L,,28,0,0,0,0
64,8477462,Robert Hagg,D,VGK,29,0,0,0,0
64,8477320,Anton Blidh,L,NYR,29,0,0,0,0
64,8482157,Will Cuylle,L,NYR,22,0,0,0,0
64,8482737,Zack Bolduc,C,STL,21,0,0,0,0
64,8481239,Samuel Fagemo,L,,24,0,0,0,0
64,8481600,Tobias Bjornfot,D,FLA,23,0,0,0,0
64,8478409,Anthony Richard,C,PHI,28,0,0,0,0
64,8474145,Robert Bortuzzo,D,,35,0,0,0,0
64,8475958,Michael Sgarbossa,C,WSH,32,0,0,0,0
64,8479986,Kole Lind,R,DAL,26,0,0,0,0
64,8479249,Andrew Poturalski,C,SJS,30,0,0,0,0
64,8479362,Riley Tufte,L,BOS,26,0,0,0,0
64,8479991,Jake Leschyshyn,C,NYR,25,0,0,0,0
64,8479587,Rhett Gardner,C,PHI,28,0,0,0,0
64,8482744,James Malatesta,L,CBJ,21,0,0,0,0
64,8478854,Ryan Shea,D,PIT,27,0,0,0,0
64,8481591,Sam Poulin,R,,23,0,0,0,0
64,8483512,Matt Savoie,C,EDM,20,0,0,0,0
64,8482102,Vasily Ponomarev,C,PIT,22,0,0,0,0
64,8482162,Roby Jarventie,L,EDM,22,0,0,0,0
64,8481016,Ruslan Iskhakov,C,,24,0,0,0,0
64,8482172,Landon Slaggert,L,CHI,22,0,0,0,0
64,8482747,Brennan Othmann,L,NYR,21,0,0,0,0
64,8480031,Maxime Comtois,L,,25,0,0,0,0
64,8480226,Marián Studenic,R,,26,0,0,0,0
64,8478408,Travis Dermott,D,,28,0,0,0,0
64,8481518,Nolan Foote,L,NJD,24,0,0,0,0
64,8479419,Brett Murray,L,BUF,26,0,0,0,0
64,8482088,Justin Sourdif,R,FLA,22,0,0,0,0
64,8482201,Gage Goncalves,C,TBL,23,0,0,0,0
64,8481578,Graeme Clarke,R,MIN,23,0,0,0,0
64,8482177,Marat Khusnutdinov,C,MIN,22,0,0,0,0
64,8481754,Nikita Nesterenko,C,ANA,23,0,0,0,0
64,8483531,Brian Halonen,L,NJD,25,0,0,0,0
64,8483920,Pierrick Dube,R,WSH,23,0,0,0,0
64,8480851,Akil Thomas,C,LAK,24,0,0,0,0
64,8475235,Nicolas Deslauriers,L,PHI,33,0,0,0,0
64,8482476,Emil Heineman,L,MTL,23,0,0,0,0
64,8477149,Scott Sabourin,R,SJS,32,0,0,0,0
64,8483549,Lucas Condotta,L,MTL,27,0,0,0,0
64,8482765,Isak Rosen,R,BUF,21,0,0,0,0
64,8481237,Kyle MacLean,C,NYI,25,0,0,0,0
64,8481024,Linus Karlsson,C,VAN,25,0,0,0,0
64,8481690,Tyler Angle,C,,24,0,0,0,0
64,8483570,Ben Meyers,C,SEA,26,0,0,0,0
64,8481655,Cole Schwindt,R,CGY,23,0,0,0,0
64,8481462,Mason Morelli,L,VGK,28,0,0,0,0
64,8483401,Marc Johnstone,R,PIT,28,0,0,0,0
64,8478956,Samuel Laberge,L,NJD,27,0,0,0,0
64,8479533,Joona Koppanen,L,,26,0,0,0,0
64,8482197,Adam Raska,R,MIN,23,0,0,0,0
64,8482250,Callahan Burke,C,VGK,27,0,0,0,0
64,8482784,Zach Dean,C,STL,21,0,0,0,0
64,8484255,Jason Polin,R,COL,25,0,0,0,0
64,8481077,John Leonard,L,,26,0,0,0,0
64,8481534,Raphael Lavoie,C,EDM,24,0,0,0,0
64,8483609,Adam Klapka,R,CGY,24,0,0,0,0
64,8482751,Ryan Winterton,C,SEA,21,0,0,0,0
64,8480267,Sammy Walker,C,MIN,25,0,0,0,0
64,8475766,Austin Watson,L,,32,0,0,0,0
64,8482460,Matt Rempe,C,NYR,22,0,0,0,0
64,8481065,Angus Crookshank,L,OTT,25,0,0,0,0
64,8481070,Hugh McGing,L,,26,0,0,0,0
64,8476323,Max McCormick,L,SEA,32,0,0,0,0
64,8483395,Arshdeep Bains,L,VAN,23,0,0,0,0
64,8484259,Ondrej Pavel,C,COL,31,0,0,0,0
64,8483432,Luca Del Bel Belluz,C,CBJ,31,0,0,0,0
64,8483045,Cameron Butler,R,CBJ,31,0,0,0,0
64,8482061,Brandon Biro,L,SEA,26,0,0,0,0
64,8477401,John Hayden,C,SEA,29,0,0,0,0
64,8475278,Byron Froese,C,,33,0,0,0,0
64,8478446,Glenn Gawdin,C,LAK,27,0,0,0,0
64,8477993,Justin Kirkland,C,CGY,28,0,0,0,0
64,8482147,Jean-Luc Foudy,C,COL,22,0,0,0,0
64,8480032,Shane Bowers,C,NJD,25,0,0,0,0
64,8479330,Brandon Gignac,C,MTL,27,0,0,0,0
64,8480776,Sheldon Rempal,R,,29,0,0,0,0
64,8475413,Justin Dowling,C,NJD,34,0,0,0,0
64,8481726,Adam Edstrom,C,NYR,24,0,0,0,0
64,8480844,Grigori Denisenko,L,VGK,24,0,0,0,0
64,8478147,Bokondji Imama,L,PIT,28,0,0,0,0
64,8478881,Brett Seney,L,CHI,28,0,0,0,0
64,8483630,Pavol Regenda,L,ANA,25,0,0,0,0
64,8480836,Jonathan Gruden,C,,24,0,0,0,0
64,8484314,Jiri Smejkal,L,,28,0,0,0,0
64,8475780,Chris Wagner,R,COL,33,0,0,0,0
64,8479546,Oskar Steen,C,,26,0,0,0,0
64,8483597,Milos Kelemen,L,UTA,25,0,0,0,0
64,8481789,Tye Kartye,L,SEA,23,0,0,0,0
64,8484325,Waltteri Merela,C,TBL,26,0,0,0,0
64,8479421,Jacob Moverare,D,LAK,26,0,0,0,0
64,8481585,Egor Afanasyev,L,SJS,23,0,0,0,0
64,8479547,Matthew Phillips,R,,26,0,0,0,0
64,8479367,William Lockwood,R,FLA,26,0,0,0,0
64,8476915,Jujhar Khaira,L,,30,0,0,0,0
64,8481422,Jacob Lucchini,C,NSH,29,0,0,0,0
64,8480468,James Hamblin,L,EDM,25,0,0,0,0
64,8478051,Max Willman,C,NJD,29,0,0,0,0
64,8481556,John Beecher,C,BOS,23,0,0,0,0
64,8478078,Rourke Chartier,C,,28,0,0,0,0
65,8478402,Connor McDavid,C,EDM,27,82,42,96,138
65,8479318,Auston Matthews,C,TOR,27,82,69,63,132
65,8476453,Nikita Kucherov,R,TBL,31,82,45,80,125
65,8477934,Leon Draisaitl,C,EDM,29,82,41,84,125
65,8477492,Nathan MacKinnon,C,COL,29,82,45,77,122
65,8477939,William Nylander,R,TOR,28,82,45,75,120
65,8478420,Mikko Rantanen,R,COL,28,82,60,57,117
65,8478010,Brayden Point,C,TBL,28,82,54,63,117
65,8479314,Matthew Tkachuk,L,FLA,27,82,51,66,117
65,8477956,David Pastrnak,R,BOS,28,82,55,61,116
65,8477404,Jake Guentzel,C,TBL,30,82,48,61,109
65,8477493,Aleksander Barkov,C,FLA,29,82,32,77,109
65,8477942,Kevin Fiala,L,LAK,28,82,42,66,108
65,8480012,Elias Pettersson,C,VAN,26,82,42,63,105
65,8471675,Sidney Crosby,C,PIT,37,82,45,59,104
65,8480801,Brady Tkachuk,L,OTT,25,82,44,60,104
65,8478550,Artemi Panarin,L,NYR,33,82,28,76,104
65,8478864,Kirill Kaprizov,L,MIN,27,82,46,56,102
65,8481557,Matt Boldy,L,MIN,23,82,45,56,101
65,8476887,Filip Forsberg,L,NSH,30,82,56,44,100
65,8480027,Jason Robertson,L,DAL,25,82,39,61,100
65,8481559,Jack Hughes,C,NJD,23,82,32,68,100
65,8476389,Vincent Trocheck,C,NYR,31,82,44,54,98
65,8478427,Sebastian Aho,C,CAR,27,82,41,56,97
65,8480800,Quinn Hughes,D,VAN,25,82,18,78,96
65,8482116,Tim Stützle,C,OTT,22,82,36,59,95
65,8480069,Cale Makar,D,COL,26,82,22,73,95
65,8478398,Kyle Connor,L,WPG,28,82,49,44,93
65,8479407,Jesper Bratt,L,NJD,26,82,37,53,90
65,8474600,Roman Josi,D,NSH,34,82,23,65,88
65,8476468,J.T. Miller,C,VAN,31,82,22,66,88
65,8478460,Zach Werenski,D,CBJ,27,82,14,74,88
65,8480002,Nico Hischier,C,NJD,25,82,33,54,87
65,8475172,Nazem Kadri,C,CGY,34,82,35,51,86
65,8477409,Carter Verhaeghe,C,FLA,29,82,42,43,85
65,8477940,Nikolaj Ehlers,L,WPG,28,82,27,58,85
65,8474564,Steven Stamkos,C,NSH,34,82,33,51,84
65,8475692,Mats Zuccarello,R,MIN,37,82,22,62,84
65,8478445,Mathew Barzal,C,NYI,27,82,21,63,84
65,8479323,Adam Fox,D,NYR,26,82,16,68,84
65,8480036,Miro Heiskanen,D,DAL,25,82,13,71,84
65,8479542,Brandon Hagel,L,TBL,26,82,41,42,83
65,8478449,Roope Hintz,C,DAL,28,82,38,44,82
65,8477946,Dylan Larkin,C,DET,28,82,45,36,81
65,8477933,Sam Reinhart,C,FLA,29,82,40,41,81
65,8480023,Robert Thomas,C,STL,25,82,23,58,81
65,8479337,Alex DeBrincat,R,DET,27,82,40,40,80
65,8479343,Clayton Keller,R,UTA,26,82,39,41,80
65,8478403,Jack Eichel,C,VGK,28,82,32,48,80
65,8476456,Jonathan Huberdeau,C,CGY,31,82,19,61,80
65,8475786,Zach Hyman,L,EDM,32,82,43,36,79
65,8480018,Nick Suzuki,C,MTL,25,82,39,40,79
65,8477960,Adrian Kempe,R,LAK,28,82,32,47,79
65,8480839,Rasmus Dahlin,D,BUF,24,82,24,55,79
65,8476460,Mark Scheifele,C,WPG,31,82,29,49,78
65,8477447,Shea Theodore,D,VGK,29,82,18,60,78
65,8480830,Andrei Svechnikov,R,CAR,24,82,41,36,77
65,8477501,Valeri Nichushkin,R,COL,29,82,41,36,77
65,8481540,Cole Caufield,R,MTL,23,82,33,44,77
65,8482078,Lucas Raymond,L,DET,22,82,26,50,76
65,8481523,Kirby Dach,C,MTL,23,82,18,58,76
65,8471214,Alex Ovechkin,L,WSH,39,82,40,35,75
65,8475913,Mark Stone,R,VGK,32,82,32,43,75
65,8471215,Evgeni Malkin,C,PIT,38,82,30,45,75
65,8475168,Matt Duchene,C,DAL,33,82,29,46,75
65,8478493,Joel Eriksson Ek,C,MIN,27,82,28,47,75
65,8477951,Nick Schmaltz,C,UTA,28,82,17,58,75
65,8475754,Brock Nelson,C,NYI,33,82,35,39,74
65,8478440,Dylan Strome,C,WSH,27,82,32,42,74
65,8474141,Patrick Kane,R,DET,36,82,26,48,74
65,8479420,Tage Thompson,C,BUF,27,82,38,35,73
65,8479385,Jordan Kyrou,C,STL,26,82,33,40,73
65,8480208,Drake Batherson,R,OTT,26,82,25,48,73
65,8475167,Victor Hedman,D,TBL,34,82,16,57,73
65,8475166,John Tavares,C,TOR,34,82,37,35,72
65,8478444,Brock Boeser,R,VAN,27,82,36,36,72
65,8476346,Johnny Gaudreau,L,CBJ,31,82,18,54,72
65,8474578,Erik Karlsson,D,PIT,34,82,17,55,72
65,8476905,Chandler Stephenson,C,SEA,30,82,16,56,72
65,8478439,Travis Konecny,R,PHI,27,82,25,46,71
65,8478397,Rasmus Andersson,D,CGY,28,82,14,57,71
65,8476399,Blake Coleman,C,CGY,33,82,38,32,70
65,8482093,Seth Jarvis,C,CAR,22,82,34,36,70
65,8471685,Anze Kopitar,C,LAK,37,82,25,45,70
65,8473512,Claude Giroux,R,OTT,36,82,24,46,70
65,8477504,Josh Morrissey,D,WPG,29,82,16,54,70
65,8480434,Sean Durzi,D,UTA,26,82,16,54,70
65,8480865,Noah Dobson,D,NYI,24,82,15,55,70
65,8479675,Trevor Moore,L,LAK,29,82,37,32,69
65,8477500,Bo Horvat,C,NYI,29,82,34,35,69
65,8478873,Troy Terry,R,ANA,27,82,33,36,69
65,8477402,Pavel Buchnevich,L,STL,29,82,26,43,69
65,8476448,William Karlsson,C,VGK,31,82,32,36,68
65,8476454,Ryan Nugent-Hopkins,C,EDM,31,82,27,41,68
65,8476459,Mika Zibanejad,C,NYR,31,82,25,43,68
65,8473419,Brad Marchand,L,BOS,36,82,24,43,67
65,8477496,Elias Lindholm,C,BOS,30,82,23,44,67
65,8476881,Tomas Hertl,C,VGK,31,82,22,45,67
65,8481533,Trevor Zegras,C,ANA,23,82,21,46,67
65,8476853,Morgan Rielly,D,TOR,30,82,8,59,67
65,8475169,Evander Kane,L,EDM,33,82,38,28,66
65,8473994,Jamie Benn,L,DAL,35,82,22,44,66
65,8477949,Alex Tuch,R,BUF,28,82,18,48,66
65,8475158,Ryan O'Reilly,C,NSH,33,82,18,48,66
65,8476432,Boone Jenner,C,CBJ,31,82,39,26,65
65,8475810,Bryan Rust,R,PIT,32,82,29,36,65
65,8482097,Jack Quinn,R,BUF,23,82,27,38,65
65,8478498,Jake DeBrusk,L,VAN,28,82,28,36,64
65,8476882,Teuvo Teravainen,L,CHI,30,82,28,36,64
65,8477416,Oliver Bjorkstrand,R,SEA,29,82,26,38,64
65,8482149,Cole Perfetti,C,WPG,22,82,25,39,64
65,8477503,Max Domi,C,TOR,29,82,19,45,64
65,8474590,John Carlson,D,WSH,34,82,14,50,64
65,8477955,Jared McCann,L,SEA,28,82,31,31,62
65,8477476,Artturi Lehkonen,L,COL,29,82,31,31,62
65,8475765,Vladimir Tarasenko,R,DET,33,82,21,41,62
65,8481068,Yegor Sharangovich,C,CGY,26,82,32,29,61
65,8478042,Viktor Arvidsson,R,EDM,31,82,26,35,61
65,8477456,J.T. Compher,L,DET,29,82,20,41,61
65,8480803,Evan Bouchard,D,EDM,25,82,18,43,61
65,8479325,Charlie McAvoy,D,BOS,27,82,13,48,61
65,8478396,Noah Hanifin,D,VGK,27,82,12,49,61
65,8478414,Timo Meier,R,NJD,28,82,27,33,60
65,8478366,Frank Vatrano,R,ANA,30,82,35,24,59
65,8482665,Matty Beniers,C,SEA,22,82,19,40,59
65,8477494,Jonathan Drouin,L,COL,29,82,15,44,59
65,8477935,Sam Bennett,C,FLA,28,82,29,29,58
65,8477511,Anthony Mantha,R,CGY,30,82,27,31,58
65,8477998,Warren Foegele,L,LAK,28,82,25,33,58
65,8477407,Anthony Duclair,L,NYI,29,82,23,35,58
65,8476875,Mike Matheson,D,MTL,30,82,15,43,58
65,8480039,Martin Necas,C,CAR,25,82,15,43,58
65,8482109,Alexis Lafrenière,L,NYR,23,82,34,23,57
65,8479400,Pierre-Luc Dubois,L,WSH,26,82,28,29,57
65,8479339,Patrik Laine,L,CBJ,26,82,26,31,57
65,8477479,Tyler Bertuzzi,L,CHI,29,82,25,32,57
65,8475170,Brayden Schenn,C,STL,33,82,24,33,57
65,8477444,Andre Burakovsky,L,SEA,29,82,19,38,57
65,8478438,Tommy Novak,C,NSH,27,82,17,40,57
65,8477932,Aaron Ekblad,D,FLA,28,82,17,40,57
65,8475794,Tyler Seguin,C,DAL,32,82,27,29,56
65,8482740,Wyatt Johnston,C,DAL,21,82,27,29,56
65,8475726,Tyler Toffoli,C,SJS,32,82,26,30,56
65,8480078,Filip Chytil,C,NYR,25,82,24,32,56
65,8475287,Erik Haula,L,NJD,33,82,23,33,56
65,8479345,Jakob Chychrun,D,WSH,26,82,21,35,56
65,8474563,Drew Doughty,D,LAK,35,82,14,42,56
65,8475151,Kyle Palmieri,C,NYI,33,82,29,26,55
65,8478856,Conor Garland,R,VAN,28,82,25,30,55
65,8478401,Pavel Zacha,C,BOS,27,82,21,34,55
65,8480797,Joel Farabee,L,PHI,24,82,20,35,55
65,8482745,Mason McTavish,C,ANA,21,82,20,35,55
65,8477497,Sean Monahan,C,CBJ,30,82,19,36,55
65,8476480,Vladislav Namestnikov,C,WPG,32,82,19,36,55
65,8475798,Mikael Granlund,C,SJS,32,82,18,37,55
65,8475314,Anders Lee,L,NYI,34,82,30,24,54
65,8476826,Yanni Gourde,C,SEA,33,82,24,30,54
65,8477964,Ivan Barbashev,C,VGK,29,82,22,32,54
65,8481528,Dylan Cozens,C,BUF,23,82,21,33,54
65,8478047,Michael Bunting,L,PIT,29,82,18,36,54
65,8474565,Alex Pietrangelo,D,VGK,34,82,13,41,54
65,8479410,Mikhail Sergachev,D,UTA,26,82,3,51,54
65,8481618,Alex Newhook,C,MTL,23,82,25,28,53
65,8478462,Nicolas Roy,C,VGK,27,82,24,29,53
65,8476539,Jonathan Marchessault,R,NSH,34,82,20,33,53
65,8480015,Owen Tippett,R,PHI,25,82,20,33,53
65,8479999,Casey Mittelstadt,C,COL,26,82,18,35,53
65,8477986,Brandon Montour,D,SEA,30,82,16,37,53
65,8475184,Chris Kreider,L,NYR,33,82,30,22,52
65,8475791,Taylor Hall,L,CHI,33,82,21,31,52
65,8476462,Dougie Hamilton,D,NJD,31,82,20,32,52
65,8483808,Andrei Kuzmenko,L,CGY,28,82,20,32,52
65,8480028,Morgan Frost,C,PHI,25,82,18,34,52
65,8482684,Luke Hughes,D,NJD,21,82,14,38,52
65,8476906,Shayne Gostisbehere,D,CAR,31,82,8,44,52
65,8480014,Gabriel Vilardi,C,WPG,25,82,30,21,51
65,8474150,Mikael Backlund,C,CGY,35,82,23,28,51
65,8476880,Tom Wilson,R,WSH,30,82,23,28,51
65,8478519,Anthony Cirelli,C,TBL,27,82,20,31,51
65,8477451,Ryan Hartman,R,MIN,30,82,20,31,51
65,8474679,Gustav Nyquist,C,NSH,35,82,18,33,51
65,8475760,Nick Bjugstad,C,UTA,32,82,23,27,50
65,8482113,Anton Lundell,C,FLA,23,82,21,29,50
65,8478407,Vince Dunn,D,SEA,28,82,14,36,50
65,8478469,Thomas Chabot,D,OTT,27,82,13,37,50
65,8477346,MacKenzie Weegar,D,CGY,30,82,12,38,50
65,8481596,Shane Pinto,C,OTT,24,82,27,22,49
65,8480849,Barrett Hayton,C,UTA,24,82,26,23,49
65,8478474,Lawson Crouse,L,UTA,27,82,25,24,49
65,8475191,Reilly Smith,R,NYR,33,82,23,26,49
65,8475768,Jaden Schwartz,C,SEA,32,82,21,28,49
65,8481711,Matias Maccelli,L,UTA,24,82,11,38,49
65,8471724,Kris Letang,D,PIT,37,82,9,40,49
65,8480064,Josh Norris,C,OTT,25,82,31,17,48
65,8482110,Dawson Mercer,C,NJD,23,82,26,22,48
65,8481560,Arthur Kaliyev,R,LAK,23,82,24,24,48
65,8476483,Rickard Rakell,R,PIT,31,82,23,25,48
65,8477495,Seth Jones,D,CHI,30,82,16,32,48
65,8479425,Filip Hronek,D,VAN,27,82,10,38,48
65,8470613,Brent Burns,D,CAR,39,82,10,38,48
65,8479525,Ross Colton,C,COL,28,82,23,24,47
65,8482705,Cole Sillinger,C,CBJ,21,82,23,24,47
65,8479591,Michael Eyssimont,C,TBL,28,82,22,25,47
65,8477426,Nicholas Paul,L,TBL,29,82,19,28,47
65,8476461,Sean Couturier,C,PHI,32,82,19,28,47
65,8474102,David Perron,L,OTT,36,82,19,28,47
65,8475753,Justin Faulk,D,STL,32,82,13,34,47
65,8476479,Phillip Danault,C,LAK,31,82,11,36,47
65,8482699,Dylan Guenther,R,UTA,21,82,24,22,46
65,8482475,Yegor Chinakhov,R,CBJ,23,82,22,24,46
65,8478975,Mason Marchment,L,DAL,29,82,19,27,46
65,8480185,Eetu Luostarinen,C,FLA,26,82,17,29,46
65,8475745,Charlie Coyle,C,BOS,32,82,16,30,46
65,8482720,Matthew Knies,L,TOR,22,82,16,30,46
65,8482055,Drew O'Connor,L,PIT,26,82,29,16,45
65,8482175,JJ Peterka,R,BUF,22,82,24,21,45
65,8474586,Jordan Eberle,R,SEA,34,82,20,25,45
65,8482124,Quinton Byfield,R,LAK,22,82,15,30,45
65,8477429,Andrew Copp,C,DET,30,82,15,30,45
65,8480893,Kirill Marchenko,R,CBJ,24,82,29,15,44
65,8480113,Alex Iafallo,L,WPG,31,82,25,19,44
65,8475714,Calle Jarnkrok,C,TOR,33,82,22,22,44
65,8476438,Brandon Saad,L,STL,32,82,20,24,44
65,8480009,Eeli Tolvanen,R,SEA,25,82,19,25,44
65,8478115,Pierre Engvall,L,NYI,28,82,18,26,44
65,8474641,Adam Henrique,C,EDM,34,82,16,28,44
65,8481581,Thomas Harley,D,DAL,23,82,13,31,44
65,8475784,Jeff Skinner,C,EDM,32,82,20,23,43
65,8475722,Jason Zucker,L,BUF,32,82,16,27,43
65,8476927,Teddy Blueger,C,VAN,30,82,14,29,43
65,8476869,Brady Skjei,D,NSH,30,82,8,35,43
65,8476958,Jaccob Slavin,D,CAR,30,82,5,38,43
65,8474149,Evgenii Dadonov,R,DAL,35,82,25,17,42
65,8480835,Jack Drury,C,CAR,24,82,23,19,42
65,8476329,Travis Boyd,C,MIN,31,82,19,23,42
65,8477021,Alex Kerfoot,C,UTA,30,82,17,25,42
65,8476458,Ryan Strome,C,ANA,31,82,16,26,42
65,8476872,Scott Laughton,C,PHI,30,82,16,26,42
65,8476792,Torey Krug,D,STL,33,82,15,27,42
65,8480188,Fabian Zetterlund,L,SJS,25,82,13,29,42
65,8482089,Jake Neighbours,L,STL,22,82,24,17,41
65,8482159,Tyson Foerster,R,PHI,22,82,22,19,41
65,8480459,Pius Suter,C,VAN,28,82,22,19,41
65,8475799,Nino Niederreiter,R,WPG,32,82,21,20,41
65,8476392,Adam Lowry,C,WPG,31,82,19,22,41
65,8482667,William Eklund,L,SJS,22,82,13,28,41
65,8474715,Cam Atkinson,R,TBL,35,82,21,19,40
65,8480220,Noah Cates,L,PHI,25,82,20,20,40
65,8475848,Brendan Gallagher,R,MTL,32,82,20,20,40
65,8478233,Andrew Mangiapane,L,WSH,28,82,18,22,40
65,8481604,Pavel Dorofeyev,L,VGK,24,82,18,22,40
65,8475793,Ryan Johansen,C,PHI,32,82,15,25,40
65,8473986,Alex Killorn,L,ANA,35,82,13,27,40
65,8478542,Evan Rodrigues,C,FLA,31,82,9,31,40
65,8478055,Gustav Forsling,D,FLA,28,82,9,31,40
65,8481656,Aliaksei Protas,C,WSH,23,82,9,31,40
65,8478109,Victor Olofsson,L,VGK,29,82,22,17,39
65,8482660,Kent Johnson,C,CBJ,22,82,13,26,39
65,8474716,Jared Spurgeon,D,MIN,35,82,13,26,39
65,8482671,Owen Power,D,BUF,22,82,10,29,39
65,8480246,Nick Perbix,D,TBL,26,82,3,36,39
65,8479293,Brandon Tanev,L,SEA,33,82,25,13,38
65,8478057,Dakota Joshua,C,VAN,28,82,20,18,38
65,8477987,Ryan Donato,C,CHI,28,82,16,22,38
65,8479365,Trent Frederic,C,BOS,26,82,15,23,38
65,8477947,Sonny Milano,L,WSH,28,82,15,23,38
65,8474053,Logan Couture,C,SJS,35,82,13,25,38
65,8471698,T.J. Oshie,R,WSH,38,82,21,16,37
65,8477450,Jason Dickinson,C,CHI,29,82,18,19,37
65,8481186,Logan O'Connor,R,COL,28,82,15,22,37
65,8481624,Ilya Mikheyev,R,CHI,30,82,15,22,37
65,8479992,Michael Rasmussen,C,DET,25,82,15,22,37
65,8476292,Ondrej Palat,L,NJD,33,82,10,27,37
65,8478046,Danton Heinen,L,VAN,29,82,10,27,37
65,8476917,Adam Pelech,D,NYI,30,82,5,32,37
65,8475764,Cam Fowler,D,ANA,33,82,2,35,37
65,8475763,Kevin Hayes,R,PIT,32,82,17,19,36
65,8479987,Morgan Geekie,C,BOS,26,82,14,22,36
65,8475343,Nic Dowd,C,WSH,34,82,14,22,36
65,8476419,Jean-Gabriel Pageau,C,NYI,32,82,11,25,36
65,8482655,J.J. Moser,D,TBL,24,82,8,28,36
65,8482105,Jake Sanderson,D,OTT,22,82,8,28,36
65,8476979,Erik Gustafsson,D,DET,32,82,6,30,36
65,8478500,Ivan Provorov,D,CBJ,27,82,5,31,36
65,8477952,Robby Fabbri,C,ANA,28,82,19,16,35
65,8480003,Jesper Boqvist,C,FLA,26,82,19,16,35
65,8476921,Jordan Martinook,L,CAR,32,82,18,17,35
65,8478413,Jordan Greenway,L,BUF,27,82,18,17,35
65,8479393,Noah Gregor,C,OTT,26,82,18,17,35
65,8482146,Luke Evangelista,R,NSH,22,82,17,18,35
65,8476442,Matt Nieto,L,PIT,32,82,16,19,35
65,8475193,Tomas Tatar,L,NJD,34,82,14,21,35
65,8481546,Cam York,D,PHI,23,82,13,22,35
65,8480798,Philipp Kurashev,C,CHI,25,82,12,23,35
65,8482142,Jamie Drysdale,D,PHI,22,82,10,25,35
65,8476312,Josh Manson,D,COL,33,82,9,26,35
65,8477948,Travis Sanheim,D,PHI,28,82,7,28,35
65,8475218,Mattias Ekholm,D,EDM,34,82,7,28,35
65,8481542,Moritz Seider,D,DET,23,82,6,29,35
65,8477498,Darnell Nurse,D,EDM,29,82,3,32,35
65,8479661,Tanner Jeannot,L,LAK,27,82,20,14,34
65,8479316,Luke Kunin,C,SJS,27,82,19,15,34
65,8483515,Juraj Slafkovsky,L,MTL,20,82,16,18,34
65,8477989,Christian Dvorak,C,MTL,28,82,15,19,34
65,8476897,Oskar Sundqvist,C,STL,30,82,15,19,34
65,8480789,Oliver Wahlstrom,R,NYI,24,82,12,22,34
65,8476885,Jacob Trouba,D,NYR,30,82,11,23,34
65,8480336,Sean Walker,D,CAR,30,82,10,24,34
65,8482624,Daniil Miromanov,D,CGY,27,82,10,24,34
65,8473422,Nick Foligno,L,CHI,37,82,9,25,34
65,8478472,Mathieu Joseph,R,STL,27,82,9,25,34
65,8479402,Jake Bean,D,CGY,26,82,9,25,34
65,8478038,Devon Toews,D,COL,30,82,5,29,34
65,8477969,Marcus Pettersson,D,PIT,28,82,2,32,34
65,8481093,Rafael Harvey-Pinard,L,MTL,25,82,21,12,33
65,8481554,Kaapo Kakko,R,NYR,23,82,18,15,33
65,8475855,Jesper Fast,R,CAR,33,82,17,16,33
65,8476374,Sean Kuraly,C,CBJ,31,82,16,17,33
65,8481032,Paul Cotter,C,NJD,25,82,15,18,33
65,8479996,Cody Glass,C,NSH,25,82,15,18,33
65,8478891,Mason Appleton,C,WPG,28,82,14,19,33
65,8480817,K'Andre Miller,D,NYR,24,82,5,28,33
65,8480145,Neal Pionk,D,WPG,29,82,4,29,33
65,8480829,Jesperi Kotkaniemi,C,CAR,24,82,17,15,32
65,8481535,Nils Hoglander,L,VAN,24,82,17,15,32
65,8484144,Connor Bedard,C,CHI,19,82,15,17,32
65,8479390,Taylor Raddysh,R,WSH,26,82,15,17,32
65,8478508,Yakov Trenin,C,MIN,27,82,15,17,32
65,8480871,Adam Boqvist,D,FLA,24,82,10,22,32
65,8475200,Dmitry Orlov,D,CAR,33,82,4,28,32
65,8478882,Vladislav Gavrikov,D,LAK,29,82,3,29,32
65,8475149,Marcus Johansson,L,MIN,34,82,16,15,31
65,8482092,Ridly Greig,C,OTT,22,82,16,15,31
65,8479353,Brett Howden,C,VGK,26,82,14,17,31
65,8478463,Anthony Beauvillier,L,PIT,27,82,12,19,31
65,8481522,Peyton Krebs,C,BUF,23,82,11,20,31
65,8481580,Connor McMichael,C,WSH,23,82,10,21,31
65,8477839,Conor Sheary,L,TBL,32,82,10,21,31
65,8479351,Sam Steel,C,DAL,26,82,9,22,31
65,8476467,Jamie Oleksiak,D,SEA,32,82,8,23,31
65,8476463,Jonas Brodin,D,MIN,31,82,6,25,31
65,8477220,Nate Schmidt,D,FLA,33,82,6,25,31
65,8482133,Thomas Bordeleau,C,SJS,22,82,5,26,31
65,8482087,Kaiden Guhle,D,MTL,22,82,5,26,31
65,8474673,TJ Brodie,D,CHI,34,82,4,27,31
65,8476923,Damon Severson,D,CBJ,30,82,2,29,31
65,8481704,Juuso Parssinen,C,NSH,23,82,22,8,30
65,8478569,Noel Acciari,C,PIT,33,82,16,14,30
65,8480748,Kiefer Sherwood,L,VAN,29,82,14,16,30
65,8482079,Marco Rossi,C,MIN,23,82,13,17,30
65,8477015,Connor Brown,R,EDM,30,82,12,18,30
65,8474189,Lars Eller,C,PIT,35,82,11,19,30
65,8481481,Blake Lizotte,C,PIT,27,82,11,19,30
65,8481582,Nicholas Robertson,L,TOR,23,82,10,20,30
65,8476854,Hampus Lindholm,D,BOS,30,82,8,22,30
65,8476960,Andreas Athanasiou,C,CHI,30,82,7,23,30
65,8482122,Brock Faber,D,MIN,22,82,6,24,30
65,8479980,Nicolas Hague,D,VGK,26,82,6,24,30
65,8480043,Timothy Liljegren,D,TOR,25,82,5,25,30
65,8478020,Michael Amadio,C,OTT,28,82,17,12,29
65,8477392,Hudson Fasching,R,NYI,29,82,15,14,29
65,8476918,Jimmy Vesey,L,NYR,31,82,15,14,29
65,8479941,Justin Danforth,R,CBJ,31,82,14,15,29
65,8473533,Jordan Staal,C,CAR,36,82,13,16,29
65,8480068,Ryan Poehling,C,PHI,25,82,13,16,29
65,8480980,Connor Dewar,C,TOR,25,82,12,17,29
65,8477919,Frederick Gaudreau,C,MIN,31,82,11,18,29
65,8476925,Colton Sissons,C,NSH,31,82,10,19,29
65,8477425,Miles Wood,L,COL,29,82,7,22,29
65,8478507,John Marino,D,UTA,27,82,7,22,29
65,8478911,Matt Roy,D,WSH,29,82,6,23,29
65,8478458,Jack Roslovic,C,CAR,27,82,5,24,29
65,8477506,Ryan Pulock,D,NYI,30,82,4,25,29
65,8482245,Artem Zub,D,OTT,29,82,1,28,29
65,8480281,Alexey Toropchenko,R,STL,25,82,17,11,28
65,8480855,Jack McBain,C,UTA,24,82,15,13,28
65,8482077,Dylan Holloway,L,EDM,23,82,15,13,28
65,8482259,Bobby McMann,C,TOR,28,82,13,15,28
65,8484145,Zach Benson,L,BUF,19,82,12,16,28
65,8484149,Gavin Brindley,C,CBJ,20,82,10,18,28
65,8477488,Brett Pesce,D,NJD,30,82,8,20,28
65,8473563,Nicklas Backstrom,C,WSH,37,82,5,23,28
65,8481014,Alexander Romanov,D,NYI,24,82,4,24,28
65,8479398,Samuel Girard,D,COL,26,82,3,25,28
65,8476331,Dylan DeMelo,D,WPG,31,82,2,26,28
65,8476474,Stefan Noesen,R,NJD,31,82,16,11,27
65,8476278,Colin Blackwell,C,DAL,31,82,16,11,27
65,8482062,Cole Smith,L,NSH,29,82,14,13,27
65,8477931,Tomas Nosek,L,FLA,32,82,11,16,27
65,8476873,Mark Jankowski,C,NSH,30,82,10,17,27
65,8475171,Oliver Ekman-Larsson,D,TOR,33,82,9,18,27
65,8477508,Curtis Lazar,C,NJD,29,82,9,18,27
65,8479976,Juuso Valimaki,D,UTA,26,82,8,19,27
65,8482111,Justin Barron,D,MTL,23,82,8,19,27
65,8479324,Ryan Lindgren,D,NYR,26,82,8,19,27
65,8478851,Alexandre Carrier,D,NSH,28,82,6,21,27
65,8476891,Matt Grzelcyk,D,PIT,30,82,5,22,27
65,8477435,Ryan Graves,D,PIT,29,82,5,22,27
65,8482073,Braden Schneider,D,NYR,23,82,4,23,27
65,8481601,Simon Holmstrom,R,NYI,23,82,14,12,26
65,8480802,Ryan McLeod,C,BUF,25,82,13,13,26
65,8470621,Corey Perry,R,EDM,39,82,13,13,26
65,8484203,Bradly Nadeau,L,CAR,19,82,13,13,26
65,8479368,Max Jones,L,BOS,26,82,11,15,26
65,8482166,Shakir Mukhamadullin,D,SJS,22,82,11,15,26
65,8478211,Dryden Hunt,L,CGY,29,82,9,17,26
65,8481567,Henry Thrun,D,SJS,23,82,8,18,26
65,8474574,Tyler Myers,D,VAN,34,82,7,19,26
65,8476902,Esa Lindell,D,DAL,30,82,4,22,26
65,8475181,Nick Leddy,D,STL,33,82,4,22,26
65,8475188,Brayden McNabb,D,VGK,33,82,4,22,26
65,8479983,Mario Ferraro,D,SJS,26,82,4,22,26
65,8474151,Ryan McDonagh,D,TBL,35,82,2,24,26
65,8483397,Marc McLaughlin,C,BOS,25,82,15,10,25
65,8481477,Nico Sturm,C,SJS,29,82,14,11,25
65,8482125,Alexander Holtz,R,VGK,22,82,14,11,25
65,8476878,Zemgus Girgensons,L,TBL,30,82,13,12,25
65,8476469,Joel Armia,R,MTL,31,82,11,14,25
65,8476981,Josh Anderson,R,MTL,30,82,9,16,25
65,8478133,Jake Evans,C,MTL,28,82,6,19,25
65,8481708,Zac Jones,D,NYR,24,82,5,20,25
65,8475279,Ben Chiarot,D,DET,33,82,3,22,25
65,8476892,Colton Parayko,D,STL,31,82,1,24,25
65,8476931,Jake McCabe,D,TOR,31,82,1,24,25
65,8480995,Pontus Holmberg,R,TOR,25,82,15,9,24
65,8481013,Jonatan Berggren,R,DET,24,82,13,11,24
65,8480813,Joe Veleno,C,DET,24,82,13,11,24
65,8475842,Sam Carrick,C,NYR,32,82,12,12,24
65,8484153,Leo Carlsson,C,ANA,20,82,11,13,24
65,8475220,Marcus Foligno,L,MIN,33,82,9,15,24
65,8480878,Nils Lundkvist,D,DAL,24,82,9,15,24
65,8482702,Logan Stankoven,C,DAL,21,82,9,15,24
65,8476422,Mike Reilly,D,NYI,31,82,6,18,24
65,8477507,Nikita Zadorov,D,BOS,29,82,5,19,24
65,8475455,Brenden Dillon,D,NJD,34,82,5,19,24
65,8480073,Erik Brannstrom,D,COL,25,82,5,19,24
65,8483490,Pavel Mintyukov,D,ANA,21,82,5,19,24
65,8480873,Rasmus Sandin,D,WSH,24,82,3,21,24
65,8483431,Logan Cooley,C,UTA,20,82,12,11,23
65,8483505,Matthew Poitras,C,BOS,20,82,12,11,23
65,8482074,Connor Zary,C,CGY,23,82,12,11,23
65,8476624,Barclay Goodrow,C,SJS,31,82,11,12,23
65,8484166,Adam Fantilli,C,CBJ,20,82,10,13,23
65,8483445,Cutter Gauthier,L,ANA,20,82,10,13,23
65,8482117,Lukas Reichel,L,CHI,22,82,9,14,23
65,8480448,Parker Kelly,L,COL,25,82,8,15,23
65,8481606,Jordan Spence,D,LAK,23,82,6,17,23
65,8477953,Kasperi Kapanen,R,STL,28,82,6,17,23
65,8475690,Chris Tanev,D,TOR,35,82,6,17,23
65,8473507,Jeff Petry,D,DET,37,82,4,19,23
65,8480222,Sebastian Aho,D,PIT,28,82,3,20,23
65,8478416,Erik Cernak,D,TBL,27,82,2,21,23
65,8478840,Will Borgen,D,SEA,28,82,1,22,23
65,8476525,Colin Miller,D,WPG,32,82,0,23,23
65,8477353,Tyler Motte,C,DET,29,82,10,12,22
65,8482803,Olen Zellweger,D,ANA,21,82,8,14,22
65,8478432,Christian Fischer,R,DET,27,82,8,14,22
65,8477406,Mattias Janmark,C,EDM,32,82,7,15,22
65,8483499,Liam Ohgren,L,MIN,20,82,6,16,22
65,8483524,Shane Wright,C,SEA,20,82,14,7,21
65,8481553,Bobby Brink,R,PHI,23,82,12,9,21
65,8481028,Martin Pospisil,C,CGY,25,82,11,10,21
65,8476889,Radek Faksa,C,STL,30,82,11,10,21
65,8481641,Joel Kiviranta,L,COL,28,82,11,10,21
65,8480074,Alexandre Texier,C,STL,25,82,8,13,21
65,8475790,Erik Gudbranson,D,CBJ,32,82,5,16,21
65,8480172,Jan Rutta,D,SJS,34,82,4,17,21
65,8483457,Lane Hutson,D,MTL,20,82,3,18,21
65,8479369,Andrew Peeke,D,BOS,26,82,2,19,21
65,8480879,Jacob Bernard-Docker,D,OTT,24,82,2,19,21
65,8477505,Alexander Wennberg,C,SJS,30,82,11,9,20
65,8477903,Garnet Hathaway,R,PHI,33,82,9,11,20
65,8480144,David Kampf,C,TOR,29,82,9,11,20
65,8482666,Scott Morrow,D,CAR,22,82,8,12,20
65,8482733,Logan Mailloux,D,MTL,31,82,7,13,20
65,8482762,Simon Edvinsson,D,DET,21,82,7,13,20
65,8478013,Jake Walman,D,SJS,28,82,6,14,20
65,8480796,Martin Fehervary,D,WSH,25,82,6,14,20
65,8479359,Beck Malenstyn,L,BUF,26,82,5,15,20
65,8481568,Alex Vlasic,D,CHI,23,82,3,17,20
65,8476967,Brett Kulak,D,EDM,30,82,2,18,20
65,8471677,Jack Johnson,D,CBJ,37,82,2,18,20
65,8478399,Jonas Siegenthaler,D,NJD,27,82,1,19,20
65,8475231,Casey Cizikas,C,NYI,33,82,11,8,19
65,8482659,Josh Doan,R,UTA,22,82,10,9,19
65,8482101,Danil Gushchin,L,SJS,22,82,9,10,19
65,8477938,Haydn Fleury,D,WPG,28,82,9,10,19
65,8482807,Ethan Del Mastro,D,CHI,21,82,8,11,19
65,8483495,Simon Nemec,D,NJD,20,82,8,11,19
65,8479371,Dante Fabbro,D,NSH,26,82,7,12,19
65,8483489,Fraser Minten,C,TOR,31,82,7,12,19
65,8481699,Aku Raty,R,UTA,23,82,7,12,19
65,8482145,Mavrik Bourque,C,DAL,22,82,6,13,19
65,8483565,Nick Blankenburg,D,NSH,26,82,5,14,19
65,8480990,Declan Chisholm,D,MIN,24,82,5,14,19
65,8477335,Kyle Burroughs,D,LAK,29,82,4,15,19
65,8483482,Tristan Luneau,D,ANA,20,82,4,15,19
65,8483763,Maksymilian Szuber,D,UTA,22,82,11,7,18
65,8482155,Alex Laferriere,R,LAK,23,82,10,8,18
65,8479414,Nathan Bastian,R,NJD,27,82,9,9,18
65,8473453,Trevor Lewis,C,LAK,37,82,7,11,18
65,8482858,Ryker Evans,D,SEA,23,82,6,12,18
65,8480806,Isac Lundestrom,C,ANA,25,82,5,13,18
65,8483468,Jiri Kulich,C,BUF,20,82,5,13,18
65,8478443,Brandon Carlo,D,BOS,28,82,4,14,18
65,8482470,Ilya Solovyov,D,CGY,24,82,4,14,18
65,8478468,Jeremy Lauzon,D,NSH,27,82,3,15,18
65,8480807,Mattias Samuelsson,D,BUF,24,82,2,16,18
65,8475233,David Savard,D,MTL,34,82,2,16,18
65,8480035,Henri Jokiharju,D,BUF,25,82,2,16,18
65,8478859,Niko Mikkola,D,FLA,28,82,2,16,18
65,8476441,Joel Edmundson,D,LAK,31,82,2,16,18
65,8483567,Georgii Merkulov,C,BOS,24,82,7,10,17
65,8478178,Darren Raddysh,D,TBL,28,82,5,12,17
65,8482749,Joshua Roy,R,MTL,21,82,5,12,17
65,8482809,Jackson Blake,R,CAR,21,82,5,12,17
65,8481524,Bowen Byram,D,BUF,23,82,5,12,17
65,8478136,Jake Middleton,D,MIN,28,82,2,15,17
65,8481178,Egor Zamula,D,PHI,24,82,1,16,17
65,8475324,Nick Jensen,D,OTT,34,82,1,16,17
65,8478434,Keegan Kolesar,R,VGK,27,82,9,7,16
65,8482141,Lukas Cormier,D,VGK,22,82,6,10,16
65,8477499,Rasmus Ristolainen,D,PHI,30,82,6,10,16
65,8484911,Collin Graf,R,SJS,22,82,6,10,16
65,8470600,Ryan Suter,D,STL,39,82,4,12,16
65,8481122,Simon Benoit,D,TOR,26,82,3,13,16
65,8477034,Jaycob Megna,D,FLA,32,82,3,13,16
65,8480860,Kevin Bahl,D,CGY,24,82,3,13,16
65,8479998,Mikey Anderson,D,LAK,25,82,2,14,16
65,8477365,Connor Clifton,D,BUF,29,82,1,15,16
65,8476879,Cody Ceci,D,EDM,31,82,1,15,16
65,8480021,Jack Studnicka,C,LAK,25,82,8,7,15
65,8483493,Frank Nazar,C,CHI,20,82,8,7,15
65,8478450,Parker Wotherspoon,D,BOS,27,82,6,9,15
65,8481517,Brett Leason,R,ANA,25,82,4,11,15
65,8476457,Adam Larsson,D,SEA,32,82,2,13,15
65,8477845,Trevor van Riemsdyk,D,WSH,33,82,1,14,15
65,8479291,Kevin Rooney,C,CGY,31,82,7,7,14
65,8482118,Sam Colangelo,R,ANA,23,82,5,9,14
65,8475177,Calvin de Haan,D,COL,33,82,5,9,14
65,8482070,Mitchell Chaffee,R,TBL,26,82,4,10,14
65,8479442,Troy Stecher,D,EDM,30,82,4,10,14
65,8477369,Carson Soucy,D,VAN,30,82,3,11,14
65,8483466,Kevin Korchinski,D,CHI,20,82,3,11,14
65,8480025,MacKenzie Entwistle,R,FLA,25,82,3,11,14
65,8483460,David Jiricek,D,CBJ,21,82,3,11,14
65,8480950,Ilya Lyubushkin,D,DAL,30,82,2,12,14
65,8480049,Dylan Samberg,D,WPG,25,82,1,13,14
65,8474612,Travis Hamonic,D,OTT,34,82,0,14,14
65,8479638,Justin Brazeau,R,BOS,26,82,5,8,13
65,8475462,Radko Gudas,D,ANA,34,82,2,11,13
65,8479576,Vincent Desharnais,D,VAN,28,82,1,12,13
65,8474567,Zach Bogosian,D,MIN,34,82,1,12,13
65,8483012,Logan Morrison,C,SEA,22,82,8,4,12
65,8482787,Nikita Chibrikov,R,WPG,31,82,7,5,12
65,8482713,Mackie Samoskevich,R,FLA,22,82,6,6,12
65,8475718,Justin Holl,D,DET,32,82,5,7,12
65,8475762,Derek Forbort,D,VAN,32,82,5,7,12
65,8483471,Brad Lambert,C,WPG,31,82,4,8,12
65,8480870,Bo Groulx,C,NYR,24,82,4,8,12
65,8476429,Scott Mayfield,D,NYI,32,82,3,9,12
65,8482712,Oskar Olausson,R,COL,22,82,3,9,12
65,8476473,Connor Murphy,D,CHI,31,82,3,9,12
65,8474013,Ian Cole,D,UTA,35,82,2,10,12
65,8480834,Ty Emberson,D,SJS,24,82,5,6,11
65,8482859,Zack Ostapchuk,C,OTT,21,82,4,7,11
65,8481605,Jackson LaCombe,D,ANA,23,82,4,7,11
65,8482516,Matthew Kessel,D,STL,24,82,1,10,11
65,8476372,Nick Seeler,D,PHI,31,82,1,10,11
65,8482153,Brendan Brisson,C,VGK,23,82,4,6,10
65,8474090,Brendan Smith,D,DAL,35,82,1,9,10
65,8476858,Phillip Di Giuseppe,L,VAN,31,82,7,2,9
65,8476822,Luke Glendening,C,TBL,35,82,6,3,9
65,8478874,Adam Gaudette,C,OTT,28,82,1,8,9
65,8482679,Matt Coronato,R,CGY,22,82,2,6,8
65,8474062,Riley Nash,C,NYR,35,82,0,7,7
65,8470794,Joe Pavelski,C,,40,0,0,0,0
65,8481703,Valtteri Puustinen,R,PIT,25,0,0,0,0
65,8477950,Tony DeAngelo,D,,29,0,0,0,0
65,8481577,Philip Tomasino,C,NSH,23,0,0,0,0
65,8475197,Tyson Barrie,D,,33,0,0,0,0
65,8471218,Blake Wheeler,R,,38,0,0,0,0
65,8474157,Max Pacioretty,L,,36,0,0,0,0
65,8478466,Daniel Sprong,R,VAN,27,0,0,0,0
65,8475744,Evgeny Kuznetsov,C,,32,0,0,0,0
65,8481019,David Gustafsson,C,WPG,24,0,0,0,0
65,8475906,John Klingberg,D,,32,0,0,0,0
65,8479348,Kale Clague,D,BUF,26,0,0,0,0
65,8476952,Dominic Toninato,C,WPG,30,0,0,0,0
65,8473473,Milan Lucic,L,,36,0,0,0,0
65,8474037,James van Riemsdyk,L,,35,0,0,0,0
65,8474602,Justin Schultz,D,,34,0,0,0,0
65,8482222,Alexander Barabanov,L,,30,0,0,0,0
65,8479372,Josh Mahura,D,SEA,26,0,0,0,0
65,8479982,Conor Timmins,D,TOR,26,0,0,0,0
65,8474031,Kevin Shattenkirk,D,,35,0,0,0,0
65,8480008,Adam Ruzicka,C,,25,0,0,0,0
65,8481059,Scott Perunovich,D,STL,26,0,0,0,0
65,8480884,Calen Addison,D,,24,0,0,0,0
65,8476994,Vinnie Hinostroza,C,NSH,30,0,0,0,0
65,8478452,Caleb Jones,D,LAK,27,0,0,0,0
65,8480157,Calle Rosen,D,COL,30,0,0,0,0
65,8481609,Vladislav Kolyachonok,D,UTA,23,0,0,0,0
65,8479415,Michael McLeod,C,,26,0,0,0,0
65,8476919,Chris Tierney,C,,30,0,0,0,0
65,8479639,Dylan Coghlan,D,WPG,26,0,0,0,0
65,8478146,Matthew Highmore,C,OTT,28,0,0,0,0
65,8478970,Jalen Chatfield,D,CAR,28,0,0,0,0
65,8480205,Emil Bemstrom,C,PIT,25,0,0,0,0
65,8474884,Mike Hoffman,C,,35,0,0,0,0
65,8471274,Alex Goligoski,D,,39,0,0,0,0
65,8478104,Sammy Blais,L,,28,0,0,0,0
65,8474870,Tyler Johnson,C,,34,0,0,0,0
65,8476913,Devin Shore,C,MIN,30,0,0,0,0
65,8481598,Philip Broberg,D,EDM,23,0,0,0,0
65,8480058,Pierre-Olivier Joseph,D,STL,25,0,0,0,0
65,8480891,Michael Kesselring,D,UTA,24,0,0,0,0
65,8477979,Nicolas Aube-Kubel,R,BUF,28,0,0,0,0
65,8476871,Tanner Pearson,L,,32,0,0,0,0
65,8476393,Nick Cousins,C,,31,0,0,0,0
65,8479977,Kailer Yamamoto,R,,26,0,0,0,0
65,8479543,Michael Pezzetta,L,MTL,26,0,0,0,0
65,8477018,Ben Hutton,D,VGK,31,0,0,0,0
65,8480762,Eric Robinson,L,CAR,29,0,0,0,0
65,8474034,Pat Maroon,L,CHI,36,0,0,0,0
65,8481058,Jesse Ylönen,R,,25,0,0,0,0
65,8475179,Dmitry Kulikov,D,FLA,34,0,0,0,0
65,8481527,Kaedan Korczak,D,VGK,23,0,0,0,0
65,8473449,Kyle Okposo,R,,36,0,0,0,0
65,8482192,Isaak Phillips,D,CHI,23,0,0,0,0
65,8480727,Zach Whitecloud,D,VGK,28,0,0,0,0
65,8479346,Dillon Dube,C,,26,0,0,0,0
65,8480821,Filip Zadina,R,,25,0,0,0,0
65,8480001,Urho Vaakanainen,D,ANA,25,0,0,0,0
65,8470966,Mark Giordano,D,,41,0,0,0,0
65,8480853,Liam Foudy,C,,24,0,0,0,0
65,8475225,Craig Smith,C,CHI,35,0,0,0,0
65,8479972,Mason Shaw,C,WPG,26,0,0,0,0
65,8478451,Ethan Bear,D,WSH,27,0,0,0,0
65,8474040,Sam Gagner,C,,35,0,0,0,0
65,8480196,Jacob Bryson,D,BUF,27,0,0,0,0
65,8479984,Cal Foote,D,,26,0,0,0,0
65,8480011,Klim Kostin,C,SJS,25,0,0,0,0
65,8482176,Wyatt Kaiser,D,CHI,22,0,0,0,0
65,8476988,Matt Benning,D,SJS,30,0,0,0,0
65,8479370,Tyson Jost,C,CAR,26,0,0,0,0
65,8477464,Nic Petan,C,,29,0,0,0,0
65,8477380,Jonny Brodzinski,C,NYR,31,0,0,0,0
65,8480070,Ian Mitchell,D,BOS,25,0,0,0,0
65,8479315,Joey Anderson,R,CHI,26,0,0,0,0
65,8478099,Kevin Labanc,R,,29,0,0,0,0
65,8476874,Olli Maatta,D,DET,30,0,0,0,0
65,8475208,Brian Dumoulin,D,ANA,33,0,0,0,0
65,8478430,Oliver Kylington,D,,27,0,0,0,0
65,8479536,Axel Jonsson-Fjallby,L,WPG,26,0,0,0,0
65,8479671,Mathieu Olivier,R,CBJ,27,0,0,0,0
65,8471709,Marc-Edouard Vlasic,D,SJS,37,0,0,0,0
65,8479328,Julien Gauthier,R,NYI,27,0,0,0,0
65,8478421,A.J. Greer,L,FLA,28,0,0,0,0
65,8477573,Nathan Walker,L,STL,30,0,0,0,0
65,8481537,Nikita Okhotiuk,D,CGY,24,0,0,0,0
65,8474166,Alec Martinez,D,CHI,37,0,0,0,0
65,8470610,Zach Parise,L,,40,0,0,0,0
65,8477478,William Carrier,L,CAR,30,0,0,0,0
65,8479344,Jesse Puljujarvi,R,PIT,26,0,0,0,0
65,8480887,Jordan Harris,D,MTL,24,0,0,0,0
65,8478502,Dennis Gilbert,D,BUF,28,0,0,0,0
65,8482730,Brandt Clarke,D,LAK,21,0,0,0,0
65,8480355,Mark Kastelic,C,BOS,25,0,0,0,0
65,8475750,Jon Merrill,D,MIN,32,0,0,0,0
65,8475164,Jakob Silfverberg,R,,34,0,0,0,0
65,8477944,Jakub Vrana,L,,28,0,0,0,0
65,8479439,Jacob MacDonald,D,COL,31,0,0,0,0
65,8474568,Luke Schenn,D,NSH,35,0,0,0,0
65,8478454,Noah Juulsen,D,VAN,27,0,0,0,0
65,8475752,Tyler Pitlick,C,,33,0,0,0,0
65,8482148,Hendrix Lapierre,C,WSH,22,0,0,0,0
65,8481167,Brayden Pachal,D,CGY,25,0,0,0,0
65,8478043,Sam Lafferty,C,BUF,29,0,0,0,0
65,8479321,Lucas Johansen,D,,27,0,0,0,0
65,8471699,Andrew Cogliano,C,,37,0,0,0,0
65,8481521,Ronnie Attard,D,PHI,25,0,0,0,0
65,8481161,Jake Christiansen,D,CBJ,25,0,0,0,0
65,8479458,Nikita Zaitsev,D,,33,0,0,0,0
65,8479619,Michael Carcone,L,UTA,28,0,0,0,0
65,8479026,Philippe Myers,D,TOR,27,0,0,0,0
65,8477330,Dominik Kubalik,L,,29,0,0,0,0
65,8481617,Vasily Podkolzin,R,VAN,23,0,0,0,0
65,8481701,Santeri Hatakka,D,NJD,23,0,0,0,0
65,8479514,Rem Pitlick,C,,27,0,0,0,0
65,8477446,Michael McCarron,R,NSH,29,0,0,0,0
65,8470604,Jeff Carter,C,,39,0,0,0,0
65,8482241,Radim Zohorna,L,,28,0,0,0,0
65,8480289,Morgan Barron,C,WPG,26,0,0,0,0
65,8479379,Givani Smith,R,SJS,26,0,0,0,0
65,8480216,Jacob Peterson,C,,25,0,0,0,0
65,8477851,Jordan Oesterle,D,BOS,32,0,0,0,0
65,8484258,Sam Malinski,D,COL,26,0,0,0,0
65,8478904,Steven Lorentz,C,,28,0,0,0,0
65,8482095,Tyler Kleven,D,OTT,22,0,0,0,0
65,8480848,Ty Dellandrea,C,SJS,24,0,0,0,0
65,8476884,Derrick Pouliot,D,,30,0,0,0,0
65,8479336,Carl Grundstrom,R,SJS,27,0,0,0,0
65,8482964,Arber Xhekaj,D,MTL,23,0,0,0,0
65,8471686,Marc Staal,D,,37,0,0,0,0
65,8477887,Patrick Brown,C,BOS,32,0,0,0,0
65,8478495,Denis Gurianov,R,,27,0,0,0,0
65,8473504,Cal Clutterbuck,R,,37,0,0,0,0
65,8481550,Adam Beckman,L,NJD,23,0,0,0,0
65,8480845,Rasmus Kupari,C,WPG,24,0,0,0,0
65,8474009,Nick Bonino,C,,36,0,0,0,0
65,8478585,Derek Ryan,C,EDM,38,0,0,0,0
65,8477962,Brendan Lemieux,L,CAR,28,0,0,0,0
65,8482861,Vincent Iorio,D,WSH,22,0,0,0,0
65,8479378,Logan Stanley,D,WPG,26,0,0,0,0
65,8473446,Erik Johnson,D,PHI,36,0,0,0,0
65,8481743,Marc Del Gaizo,D,NSH,25,0,0,0,0
65,8477384,Josh Brown,D,EDM,30,0,0,0,0
65,8482165,Yan Kuznetsov,D,CGY,22,0,0,0,0
65,8478424,Jansen Harkins,C,ANA,27,0,0,0,0
65,8482144,Jack Thompson,D,SJS,22,0,0,0,0
65,8478512,Austin Czarnik,C,,32,0,0,0,0
65,8477527,Ross Johnston,L,ANA,30,0,0,0,0
65,8479383,Boris Katchouk,L,,26,0,0,0,0
65,8482094,Daemon Hunt,D,MIN,22,0,0,0,0
65,8481719,Maxwell Crozier,D,TBL,24,0,0,0,0
65,8480192,Johnathan Kovacevic,D,NJD,27,0,0,0,0
65,8479376,Victor Mete,D,,26,0,0,0,0
65,8482511,Mason Lohrei,D,BOS,23,0,0,0,0
65,8475825,Jani Hakanpää,D,,32,0,0,0,0
65,8478021,William Lagesson,D,DET,28,0,0,0,0
65,8475795,Dylan McIlrath,D,WSH,32,0,0,0,0
65,8477846,Ryan Carpenter,C,,33,0,0,0,0
65,8481056,Spencer Stastney,D,NSH,24,0,0,0,0
65,8481564,Ryan Johnson,D,BUF,23,0,0,0,0
65,8478017,Mark Friedman,D,VAN,29,0,0,0,0
65,8479320,Max Lajoie,D,SEA,27,0,0,0,0
65,8480075,Cameron Crotty,D,MIN,25,0,0,0,0
65,8484287,Cole McWard,D,VAN,23,0,0,0,0
65,8484254,Akito Hirose,D,VAN,25,0,0,0,0
65,8483407,Brandon Scanlin,D,NYR,25,0,0,0,0
65,8480274,Philip Kemp,D,EDM,25,0,0,0,0
65,8479522,Hardy Haman Aktell,D,WSH,26,0,0,0,0
65,8480007,Jonas Rondbjerg,R,VGK,25,0,0,0,0
65,8477454,Adam Erne,L,,29,0,0,0,0
65,8481679,Maxence Guenette,D,OTT,23,0,0,0,0
65,8480441,Trey Fix-Wolansky,R,CBJ,25,0,0,0,0
65,8483546,Marshall Rifai,D,TOR,26,0,0,0,0
65,8480084,Nick DeSimone,D,NJD,30,0,0,0,0
65,8481030,Jack St. Ivany,D,PIT,25,0,0,0,0
65,8481592,Jakob Pelletier,L,CGY,23,0,0,0,0
65,8478011,Louie Belpedio,D,PHI,28,0,0,0,0
65,8477930,Pierre-Edouard Bellemare,L,,39,0,0,0,0
65,8484321,Nikolas Matinpalo,D,OTT,26,0,0,0,0
65,8482067,Connor Mackey,D,NYR,28,0,0,0,0
65,8481806,Louis Crevier,D,CHI,23,0,0,0,0
65,8484326,Patrik Koch,D,UTA,28,0,0,0,0
65,8477971,Andreas Englund,D,LAK,28,0,0,0,0
65,8481751,Lukas Rousek,R,BUF,25,0,0,0,0
65,8481006,Tyler Tucker,D,STL,24,0,0,0,0
65,8476867,Brendan Gaunce,C,MIN,30,0,0,0,0
65,8479520,Brandon Duhaime,R,WSH,27,0,0,0,0
65,8477073,Kurtis MacDermid,L,NJD,30,0,0,0,0
65,8480874,Adam Ginning,D,PHI,24,0,0,0,0
65,8477473,Justin Bailey,R,SJS,29,0,0,0,0
65,8479066,Ryan Lomberg,L,CGY,30,0,0,0,0
65,8477070,Liam O'Brien,C,UTA,30,0,0,0,0
65,8474618,Marco Scandella,D,,34,0,0,0,0
65,8475797,Jarred Tinordi,D,,32,0,0,0,0
65,8481441,Joe Snively,C,DET,28,0,0,0,0
65,8477244,Chad Ruhwedel,D,NYR,34,0,0,0,0
65,8479772,Zack MacEwen,R,OTT,28,0,0,0,0
65,8481147,Reese Johnson,C,MIN,26,0,0,0,0
65,8481043,Cole Koepke,L,BOS,26,0,0,0,0
65,8483619,Filip Roos,D,OTT,25,0,0,0,0
65,8481541,Samuel Bolduc,D,NYI,24,0,0,0,0
65,8477810,Joel Hanley,D,CGY,33,0,0,0,0
65,8476907,Mackenzie MacEachern,L,,30,0,0,0,0
65,8482652,Walker Duehr,R,CGY,27,0,0,0,0
65,8477126,Jayson Megna,C,,34,0,0,0,0
65,8483398,Declan Carlile,D,TBL,31,0,0,0,0
65,8482929,Emil Lilleberg,D,TBL,23,0,0,0,0
65,8480880,Jakub Lauko,C,MIN,24,0,0,0,0
65,8480245,Olle Lycksell,R,PHI,25,0,0,0,0
65,8480252,Cole Guttman,C,CHI,25,0,0,0,0
65,8477467,Gustav Olofsson,D,SEA,30,0,0,0,0
65,8479968,Vinni Lettieri,C,BOS,29,0,0,0,0
65,8478400,Colin White,C,,27,0,0,0,0
65,8475755,Alexander Petrovic,D,DAL,32,0,0,0,0
65,8481812,Nikolai Knyzhov,D,,27,0,0,0,0
65,8481593,Jayden Struble,D,MTL,23,0,0,0,0
65,8481532,Alex Turcotte,C,LAK,23,0,0,0,0
65,8482126,Emil Andrae,D,PHI,31,0,0,0,0
65,8479944,Zach Aston-Reese,C,VGK,30,0,0,0,0
65,8471817,Ryan Reaves,R,TOR,37,0,0,0,0
65,8481206,John Ludvig,D,PIT,24,0,0,0,0
65,8481599,Victor Soderstrom,D,UTA,23,0,0,0,0
65,8480292,Carson Meyer,R,ANA,27,0,0,0,0
65,8482496,Nils Aman,C,VAN,24,0,0,0,0
65,8479718,Alex Barré-Boulet,C,MTL,27,0,0,0,0
65,8479994,Jaret Anderson-Dolan,C,WPG,25,0,0,0,0
65,8480184,Gustav Lindstrom,D,,26,0,0,0,0
65,8480890,Jan Jenik,R,OTT,24,0,0,0,0
65,8478067,Oskar Lindblom,L,,28,0,0,0,0
65,8476934,Brock McGinn,L,ANA,30,0,0,0,0
65,8479985,Cale Fleury,D,SEA,26,0,0,0,0
65,8484304,Uvis Balinskis,D,FLA,28,0,0,0,0
65,8479981,Jonah Gadjovich,L,FLA,26,0,0,0,0
65,8481716,Dmitri Voronkov,L,CBJ,24,0,0,0,0
65,8474709,Matt Martin,L,,35,0,0,0,0
65,8482634,Alex Steeves,C,TOR,25,0,0,0,0
65,8480823,Alexander Alexeyev,D,WSH,25,0,0,0,0
65,8477541,Dakota Mermis,D,TOR,30,0,0,0,0
65,8483491,Ivan Miroshnichenko,L,WSH,20,0,0,0,0
65,8478477,Mitchell Stephens,C,SEA,27,0,0,0,0
65,8481543,Nikita Alexandrov,C,STL,24,0,0,0,0
65,8479423,Alex Nylander,L,,26,0,0,0,0
65,8482451,Mikael Pyyhtia,L,CBJ,23,0,0,0,0
65,8478831,Kevin Stenlund,C,UTA,28,0,0,0,0
65,8480306,Grant Hutton,D,NYI,29,0,0,0,0
65,8478028,Fredrik Olofsson,L,,28,0,0,0,0
65,8477462,Robert Hagg,D,VGK,29,0,0,0,0
65,8477320,Anton Blidh,L,NYR,29,0,0,0,0
65,8482157,Will Cuylle,L,NYR,22,0,0,0,0
65,8482737,Zack Bolduc,C,STL,21,0,0,0,0
65,8481239,Samuel Fagemo,L,,24,0,0,0,0
65,8481600,Tobias Bjornfot,D,FLA,23,0,0,0,0
65,8478409,Anthony Richard,C,PHI,28,0,0,0,0
65,8474145,Robert Bortuzzo,D,,35,0,0,0,0
65,8475958,Michael Sgarbossa,C,WSH,32,0,0,0,0
65,8479986,Kole Lind,R,DAL,26,0,0,0,0
65,8479249,Andrew Poturalski,C,SJS,30,0,0,0,0
65,8479362,Riley Tufte,L,BOS,26,0,0,0,0
65,8479991,Jake Leschyshyn,C,NYR,25,0,0,0,0
65,8479587,Rhett Gardner,C,PHI,28,0,0,0,0
65,8482744,James Malatesta,L,CBJ,21,0,0,0,0
65,8478854,Ryan Shea,D,PIT,27,0,0,0,0
65,8481591,Sam Poulin,R,,23,0,0,0,0
65,8483512,Matt Savoie,C,EDM,20,0,0,0,0
65,8482102,Vasily Ponomarev,C,PIT,22,0,0,0,0
65,8482162,Roby Jarventie,L,EDM,22,0,0,0,0
65,8481016,Ruslan Iskhakov,C,,24,0,0,0,0
65,8482172,Landon Slaggert,L,CHI,22,0,0,0,0
65,8482747,Brennan Othmann,L,NYR,21,0,0,0,0
65,8480031,Maxime Comtois,L,,25,0,0,0,0
65,8480226,Marián Studenic,R,,26,0,0,0,0
65,8478408,Travis Dermott,D,,28,0,0,0,0
65,8481518,Nolan Foote,L,NJD,24,0,0,0,0
65,8479419,Brett Murray,L,BUF,26,0,0,0,0
65,8482088,Justin Sourdif,R,FLA,22,0,0,0,0
65,8482201,Gage Goncalves,C,TBL,23,0,0,0,0
65,8481578,Graeme Clarke,R,MIN,23,0,0,0,0
65,8482177,Marat Khusnutdinov,C,MIN,22,0,0,0,0
65,8481754,Nikita Nesterenko,C,ANA,23,0,0,0,0
65,8483531,Brian Halonen,L,NJD,25,0,0,0,0
65,8483920,Pierrick Dube,R,WSH,23,0,0,0,0
65,8480851,Akil Thomas,C,LAK,24,0,0,0,0
65,8475235,Nicolas Deslauriers,L,PHI,33,0,0,0,0
65,8482476,Emil Heineman,L,MTL,23,0,0,0,0
65,8477149,Scott Sabourin,R,SJS,32,0,0,0,0
65,8483549,Lucas Condotta,L,MTL,27,0,0,0,0
65,8482765,Isak Rosen,R,BUF,21,0,0,0,0
65,8481237,Kyle MacLean,C,NYI,25,0,0,0,0
65,8481024,Linus Karlsson,C,VAN,25,0,0,0,0
65,8481690,Tyler Angle,C,,24,0,0,0,0
65,8483570,Ben Meyers,C,SEA,26,0,0,0,0
65,8481655,Cole Schwindt,R,CGY,23,0,0,0,0
65,8481462,Mason Morelli,L,VGK,28,0,0,0,0
65,8483401,Marc Johnstone,R,PIT,28,0,0,0,0
65,8478956,Samuel Laberge,L,NJD,27,0,0,0,0
65,8479533,Joona Koppanen,L,,26,0,0,0,0
65,8482197,Adam Raska,R,MIN,23,0,0,0,0
65,8482250,Callahan Burke,C,VGK,27,0,0,0,0
65,8482784,Zach Dean,C,STL,21,0,0,0,0
65,8484255,Jason Polin,R,COL,25,0,0,0,0
65,8481077,John Leonard,L,,26,0,0,0,0
65,8481534,Raphael Lavoie,C,EDM,24,0,0,0,0
65,8483609,Adam Klapka,R,CGY,24,0,0,0,0
65,8482751,Ryan Winterton,C,SEA,21,0,0,0,0
65,8480267,Sammy Walker,C,MIN,25,0,0,0,0
65,8475766,Austin Watson,L,,32,0,0,0,0
65,8482460,Matt Rempe,C,NYR,22,0,0,0,0
65,8481065,Angus Crookshank,L,OTT,25,0,0,0,0
65,8481070,Hugh McGing,L,,26,0,0,0,0
65,8476323,Max McCormick,L,SEA,32,0,0,0,0
65,8483395,Arshdeep Bains,L,VAN,23,0,0,0,0
65,8484259,Ondrej Pavel,C,COL,31,0,0,0,0
65,8483432,Luca Del Bel Belluz,C,CBJ,31,0,0,0,0
65,8483045,Cameron Butler,R,CBJ,31,0,0,0,0
65,8482061,Brandon Biro,L,SEA,26,0,0,0,0
65,8477401,John Hayden,C,SEA,29,0,0,0,0
65,8475278,Byron Froese,C,,33,0,0,0,0
65,8478446,Glenn Gawdin,C,LAK,27,0,0,0,0
65,8477993,Justin Kirkland,C,CGY,28,0,0,0,0
65,8482147,Jean-Luc Foudy,C,COL,22,0,0,0,0
65,8480032,Shane Bowers,C,NJD,25,0,0,0,0
65,8479330,Brandon Gignac,C,MTL,27,0,0,0,0
65,8480776,Sheldon Rempal,R,,29,0,0,0,0
65,8475413,Justin Dowling,C,NJD,34,0,0,0,0
65,8481726,Adam Edstrom,C,NYR,24,0,0,0,0
65,8480844,Grigori Denisenko,L,VGK,24,0,0,0,0
65,8478147,Bokondji Imama,L,PIT,28,0,0,0,0
65,8478881,Brett Seney,L,CHI,28,0,0,0,0
65,8483630,Pavol Regenda,L,ANA,25,0,0,0,0
65,8480836,Jonathan Gruden,C,,24,0,0,0,0
65,8484314,Jiri Smejkal,L,,28,0,0,0,0
65,8475780,Chris Wagner,R,COL,33,0,0,0,0
65,8479546,Oskar Steen,C,,26,0,0,0,0
65,8483597,Milos Kelemen,L,UTA,25,0,0,0,0
65,8481789,Tye Kartye,L,SEA,23,0,0,0,0
65,8484325,Waltteri Merela,C,TBL,26,0,0,0,0
65,8479421,Jacob Moverare,D,LAK,26,0,0,0,0
65,8481585,Egor Afanasyev,L,SJS,23,0,0,0,0
65,8479547,Matthew Phillips,R,,26,0,0,0,0
65,8479367,William Lockwood,R,FLA,26,0,0,0,0
65,8476915,Jujhar Khaira,L,,30,0,0,0,0
65,8481422,Jacob Lucchini,C,NSH,29,0,0,0,0
65,8480468,James Hamblin,L,EDM,25,0,0,0,0
65,8478051,Max Willman,C,NJD,29,0,0,0,0
65,8481556,John Beecher,C,BOS,23,0,0,0,0
65,8478078,Rourke Chartier,C,,28,0,0,0,0
66,8478402,Connor McDavid,C,EDM,27,82,44,103,147
66,8477492,Nathan MacKinnon,C,COL,29,82,57,80,137
66,8476453,Nikita Kucherov,R,TBL,31,82,47,86,133
66,8481559,Jack Hughes,C,NJD,23,82,42,80,122
66,8478420,Mikko Rantanen,R,COL,28,82,49,63,112
66,8478864,Kirill Kaprizov,L,MIN,27,82,46,62,108
66,8478550,Artemi Panarin,L,NYR,33,82,32,76,108
66,8480002,Nico Hischier,C,NJD,25,82,39,68,107
66,8476887,Filip Forsberg,L,NSH,30,82,48,58,106
66,8477934,Leon Draisaitl,C,EDM,29,82,43,62,105
66,8479318,Auston Matthews,C,TOR,27,82,55,49,104
66,8471675,Sidney Crosby,C,PIT,37,82,42,62,104
66,8476468,J.T. Miller,C,VAN,31,82,38,66,104
66,8477942,Kevin Fiala,L,LAK,28,82,37,67,104
66,8478398,Kyle Connor,L,WPG,28,82,48,55,103
66,8477939,William Nylander,R,TOR,28,82,36,66,102
66,8477956,David Pastrnak,R,BOS,28,82,49,52,101
66,8480801,Brady Tkachuk,L,OTT,25,82,49,50,99
66,8480012,Elias Pettersson,C,VAN,26,82,41,57,98
66,8476456,Jonathan Huberdeau,C,CGY,31,82,20,76,96
66,8477933,Sam Reinhart,C,FLA,29,82,46,49,95
66,8479314,Matthew Tkachuk,L,FLA,27,82,33,62,95
66,8477493,Aleksander Barkov,C,FLA,29,82,27,68,95
66,8482116,Tim Stützle,C,OTT,22,82,39,55,94
66,8478439,Travis Konecny,R,PHI,27,82,35,58,93
66,8480027,Jason Robertson,L,DAL,25,82,30,63,93
66,8478445,Mathew Barzal,C,NYI,27,82,22,71,93
66,8480023,Robert Thomas,C,STL,25,82,21,72,93
66,8481557,Matt Boldy,L,MIN,23,82,37,55,92
66,8479407,Jesper Bratt,L,NJD,26,82,27,63,90
66,8480069,Cale Makar,D,COL,26,82,27,62,89
66,8477404,Jake Guentzel,C,TBL,30,82,39,49,88
66,8471214,Alex Ovechkin,L,WSH,39,82,36,52,88
66,8477940,Nikolaj Ehlers,L,WPG,28,82,35,53,88
66,8474564,Steven Stamkos,C,NSH,34,82,39,48,87
66,8478010,Brayden Point,C,TBL,28,82,40,46,86
66,8481523,Kirby Dach,C,MTL,23,82,18,68,86
66,8477960,Adrian Kempe,R,LAK,28,82,40,45,85
66,8479420,Tage Thompson,C,BUF,27,82,40,42,82
66,8473512,Claude Giroux,R,OTT,36,82,29,52,81
66,8476454,Ryan Nugent-Hopkins,C,EDM,31,82,27,54,81
66,8480830,Andrei Svechnikov,R,CAR,24,82,36,44,80
66,8477949,Alex Tuch,R,BUF,28,82,35,45,80
66,8476881,Tomas Hertl,C,VGK,31,82,32,48,80
66,8481533,Trevor Zegras,C,ANA,23,82,30,50,80
66,8478427,Sebastian Aho,C,CAR,27,82,42,37,79
66,8477946,Dylan Larkin,C,DET,28,82,32,47,79
66,8477402,Pavel Buchnevich,L,STL,29,82,29,50,79
66,8478440,Dylan Strome,C,WSH,27,82,26,53,79
66,8474600,Roman Josi,D,NSH,34,82,24,55,79
66,8478414,Timo Meier,R,NJD,28,82,41,37,78
66,8479343,Clayton Keller,R,UTA,26,82,37,41,78
66,8475913,Mark Stone,R,VGK,32,82,33,45,78
66,8476459,Mika Zibanejad,C,NYR,31,82,30,48,78
66,8476346,Johnny Gaudreau,L,CBJ,31,82,23,55,78
66,8475692,Mats Zuccarello,R,MIN,37,82,17,61,78
66,8480800,Quinn Hughes,D,VAN,25,82,8,70,78
66,8478493,Joel Eriksson Ek,C,MIN,27,82,45,32,77
66,8477955,Jared McCann,L,SEA,28,82,39,38,77
66,8479339,Patrik Laine,L,CBJ,26,82,37,40,77
66,8473994,Jamie Benn,L,DAL,35,82,34,43,77
66,8478444,Brock Boeser,R,VAN,27,82,41,35,76
66,8478403,Jack Eichel,C,VGK,28,82,29,47,76
66,8475158,Ryan O'Reilly,C,NSH,33,82,33,42,75
66,8476462,Dougie Hamilton,D,NJD,31,82,22,53,75
66,8479323,Adam Fox,D,NYR,26,82,15,60,75
66,8482093,Seth Jarvis,C,CAR,22,82,39,35,74
66,8477409,Carter Verhaeghe,C,FLA,29,82,38,36,74
66,8475786,Zach Hyman,L,EDM,32,82,36,38,74
66,8476389,Vincent Trocheck,C,NYR,31,82,35,39,74
66,8477504,Josh Morrissey,D,WPG,29,82,15,59,74
66,8476853,Morgan Rielly,D,TOR,30,82,12,62,74
66,8480036,Miro Heiskanen,D,DAL,25,82,11,63,74
66,8480839,Rasmus Dahlin,D,BUF,24,82,19,54,73
66,8478401,Pavel Zacha,C,BOS,27,82,36,36,72
66,8479385,Jordan Kyrou,C,STL,26,82,34,38,72
66,8474141,Patrick Kane,R,DET,36,82,29,43,72
66,8475754,Brock Nelson,C,NYI,33,82,32,39,71
66,8473986,Alex Killorn,L,ANA,35,82,32,39,71
66,8471215,Evgeni Malkin,C,PIT,38,82,26,45,71
66,8475184,Chris Kreider,L,NYR,33,82,39,31,70
66,8475810,Bryan Rust,R,PIT,32,82,34,36,70
66,8478449,Roope Hintz,C,DAL,28,82,33,37,70
66,8475765,Vladimir Tarasenko,R,DET,33,82,27,43,70
66,8474679,Gustav Nyquist,C,NSH,35,82,23,47,70
66,8475172,Nazem Kadri,C,CGY,34,82,21,49,70
66,8476539,Jonathan Marchessault,R,NSH,34,82,35,34,69
66,8478460,Zach Werenski,D,CBJ,27,82,12,57,69
66,8475166,John Tavares,C,TOR,34,82,39,29,68
66,8477501,Valeri Nichushkin,R,COL,29,82,34,34,68
66,8473419,Brad Marchand,L,BOS,36,82,26,42,68
66,8480865,Noah Dobson,D,NYI,24,82,13,55,68
66,8478519,Anthony Cirelli,C,TBL,27,82,31,36,67
66,8477496,Elias Lindholm,C,BOS,30,82,22,45,67
66,8474578,Erik Karlsson,D,PIT,34,82,11,56,67
66,8479337,Alex DeBrincat,R,DET,27,82,33,33,66
66,8476448,William Karlsson,C,VGK,31,82,30,36,66
66,8475784,Jeff Skinner,C,EDM,32,82,34,31,65
66,8478047,Michael Bunting,L,PIT,29,82,27,38,65
66,8475168,Matt Duchene,C,DAL,33,82,24,41,65
66,8475794,Tyler Seguin,C,DAL,32,82,24,41,65
66,8471685,Anze Kopitar,C,LAK,37,82,20,45,65
66,8476432,Boone Jenner,C,CBJ,31,82,36,28,64
66,8477951,Nick Schmaltz,C,UTA,28,82,29,35,64
66,8475167,Victor Hedman,D,TBL,34,82,15,49,64
66,8474586,Jordan Eberle,R,SEA,34,82,31,32,63
66,8476479,Phillip Danault,C,LAK,31,82,28,35,63
66,8481528,Dylan Cozens,C,BUF,23,82,22,41,63
66,8480208,Drake Batherson,R,OTT,26,82,20,43,63
66,8479400,Pierre-Luc Dubois,L,WSH,26,82,20,43,63
66,8480803,Evan Bouchard,D,EDM,25,82,12,51,63
66,8477935,Sam Bennett,C,FLA,28,82,33,29,62
66,8474102,David Perron,L,OTT,36,82,26,36,62
66,8477494,Jonathan Drouin,L,COL,29,82,22,40,62
66,8482740,Wyatt Johnston,C,DAL,21,82,31,30,61
66,8477476,Artturi Lehkonen,L,COL,29,82,28,33,61
66,8479542,Brandon Hagel,L,TBL,26,82,27,34,61
66,8482078,Lucas Raymond,L,DET,22,82,27,34,61
66,8482097,Jack Quinn,R,BUF,23,82,21,40,61
66,8482110,Dawson Mercer,C,NJD,23,82,30,30,60
66,8478975,Mason Marchment,L,DAL,29,82,30,30,60
66,8477500,Bo Horvat,C,NYI,29,82,29,31,60
66,8478366,Frank Vatrano,R,ANA,30,82,28,32,60
66,8482665,Matty Beniers,C,SEA,22,82,28,32,60
66,8477986,Brandon Montour,D,SEA,30,82,28,32,60
66,8478042,Viktor Arvidsson,R,EDM,31,82,17,43,60
66,8470613,Brent Burns,D,CAR,39,82,9,51,60
66,8482055,Drew O'Connor,L,PIT,26,82,35,24,59
66,8480015,Owen Tippett,R,PHI,25,82,28,31,59
66,8476483,Rickard Rakell,R,PIT,31,82,27,32,59
66,8476460,Mark Scheifele,C,WPG,31,82,26,33,59
66,8480018,Nick Suzuki,C,MTL,25,82,18,41,59
66,8476905,Chandler Stephenson,C,SEA,30,82,15,44,59
66,8476875,Mike Matheson,D,MTL,30,82,11,48,59
66,8477451,Ryan Hartman,R,MIN,30,82,21,37,58
66,8474150,Mikael Backlund,C,CGY,35,82,17,41,58
66,8479999,Casey Mittelstadt,C,COL,26,82,15,43,58
66,8475798,Mikael Granlund,C,SJS,32,82,13,45,58
66,8471724,Kris Letang,D,PIT,37,82,11,47,58
66,8478038,Devon Toews,D,COL,30,82,10,48,58
66,8481542,Moritz Seider,D,DET,23,82,6,52,58
66,8480014,Gabriel Vilardi,C,WPG,25,82,34,23,57
66,8478856,Conor Garland,R,VAN,28,82,28,29,57
66,8476880,Tom Wilson,R,WSH,30,82,26,31,57
66,8480028,Morgan Frost,C,PHI,25,82,18,39,57
66,8474563,Drew Doughty,D,LAK,35,82,14,43,57
66,8475169,Evander Kane,L,EDM,33,82,32,24,56
66,8478873,Troy Terry,R,ANA,27,82,28,28,56
66,8475191,Reilly Smith,R,NYR,33,82,25,31,56
66,8479675,Trevor Moore,L,LAK,29,82,23,33,56
66,8482745,Mason McTavish,C,ANA,21,82,23,33,56
66,8481618,Alex Newhook,C,MTL,23,82,17,39,56
66,8479410,Mikhail Sergachev,D,UTA,26,82,10,46,56
66,8478474,Lawson Crouse,L,UTA,27,82,27,28,55
66,8475745,Charlie Coyle,C,BOS,32,82,17,38,55
66,8478407,Vince Dunn,D,SEA,28,82,11,44,55
66,8483808,Andrei Kuzmenko,L,CGY,28,82,25,29,54
66,8478542,Evan Rodrigues,C,FLA,31,82,24,30,54
66,8477456,J.T. Compher,L,DET,29,82,20,34,54
66,8480078,Filip Chytil,C,NYR,25,82,19,35,54
66,8480039,Martin Necas,C,CAR,25,82,16,38,54
66,8481068,Yegor Sharangovich,C,CGY,26,82,26,27,53
66,8482699,Dylan Guenther,R,UTA,21,82,26,27,53
66,8478233,Andrew Mangiapane,L,WSH,28,82,22,31,53
66,8481596,Shane Pinto,C,OTT,24,82,20,33,53
66,8478438,Tommy Novak,C,NSH,27,82,13,40,53
66,8482159,Tyson Foerster,R,PHI,22,82,27,25,52
66,8475791,Taylor Hall,L,CHI,33,82,20,32,52
66,8475753,Justin Faulk,D,STL,32,82,15,37,52
66,8475763,Kevin Hayes,R,PIT,32,82,15,37,52
66,8474590,John Carlson,D,WSH,34,82,14,38,52
66,8477503,Max Domi,C,TOR,29,82,13,39,52
66,8477447,Shea Theodore,D,VGK,29,82,9,43,52
66,8475151,Kyle Palmieri,C,NYI,33,82,25,26,51
66,8480849,Barrett Hayton,C,UTA,24,82,24,27,51
66,8477416,Oliver Bjorkstrand,R,SEA,29,82,20,31,51
66,8482671,Owen Power,D,BUF,22,82,16,35,51
66,8478469,Thomas Chabot,D,OTT,27,82,12,39,51
66,8479325,Charlie McAvoy,D,BOS,27,82,11,40,51
66,8476438,Brandon Saad,L,STL,32,82,33,17,50
66,8482149,Cole Perfetti,C,WPG,22,82,23,27,50
66,8478498,Jake DeBrusk,L,VAN,28,82,18,32,50
66,8481656,Aliaksei Protas,C,WSH,23,82,17,33,50
66,8481711,Matias Maccelli,L,UTA,24,82,12,38,50
66,8477407,Anthony Duclair,L,NYI,29,82,23,26,49
66,8482705,Cole Sillinger,C,CBJ,21,82,20,29,49
66,8476882,Teuvo Teravainen,L,CHI,30,82,17,32,49
66,8477497,Sean Monahan,C,CBJ,30,82,17,32,49
66,8477346,MacKenzie Weegar,D,CGY,30,82,17,32,49
66,8478055,Gustav Forsling,D,FLA,28,82,13,36,49
66,8478397,Rasmus Andersson,D,CGY,28,82,10,39,49
66,8481560,Arthur Kaliyev,R,LAK,23,82,22,26,48
66,8482124,Quinton Byfield,R,LAK,22,82,22,26,48
66,8478115,Pierre Engvall,L,NYI,28,82,22,26,48
66,8478458,Jack Roslovic,C,CAR,27,82,16,32,48
66,8477498,Darnell Nurse,D,EDM,29,82,12,36,48
66,8480434,Sean Durzi,D,UTA,26,82,11,37,48
66,8478396,Noah Hanifin,D,VGK,27,82,10,38,48
66,8474565,Alex Pietrangelo,D,VGK,34,82,10,38,48
66,8477932,Aaron Ekblad,D,FLA,28,82,9,39,48
66,8479425,Filip Hronek,D,VAN,27,82,9,39,48
66,8477511,Anthony Mantha,R,CGY,30,82,28,19,47
66,8475722,Jason Zucker,L,BUF,32,82,19,28,47
66,8474641,Adam Henrique,C,EDM,34,82,18,29,47
66,8480798,Philipp Kurashev,C,CHI,25,82,13,34,47
66,8480336,Sean Walker,D,CAR,30,82,10,37,47
66,8477426,Nicholas Paul,L,TBL,29,82,30,16,46
66,8476399,Blake Coleman,C,CGY,33,82,23,23,46
66,8476792,Torey Krug,D,STL,33,82,13,33,46
66,8474716,Jared Spurgeon,D,MIN,35,82,8,38,46
66,8476979,Erik Gustafsson,D,DET,32,82,5,41,46
66,8479525,Ross Colton,C,COL,28,82,28,17,45
66,8475170,Brayden Schenn,C,STL,33,82,22,23,45
66,8477479,Tyler Bertuzzi,L,CHI,29,82,21,24,45
66,8477953,Kasperi Kapanen,R,STL,28,82,21,24,45
66,8475760,Nick Bjugstad,C,UTA,32,82,20,25,45
66,8482117,Lukas Reichel,L,CHI,22,82,18,27,45
66,8476329,Travis Boyd,C,MIN,31,82,13,32,45
66,8477506,Ryan Pulock,D,NYI,30,82,10,35,45
66,8482109,Alexis Lafrenière,L,NYR,23,82,26,18,44
66,8480459,Pius Suter,C,VAN,28,82,23,21,44
66,8475768,Jaden Schwartz,C,SEA,32,82,16,28,44
66,8482684,Luke Hughes,D,NJD,21,82,9,35,44
66,8480188,Fabian Zetterlund,L,SJS,25,82,24,19,43
66,8475726,Tyler Toffoli,C,SJS,32,82,23,20,43
66,8480797,Joel Farabee,L,PHI,24,82,23,20,43
66,8478020,Michael Amadio,C,OTT,28,82,23,20,43
66,8476925,Colton Sissons,C,NSH,31,82,22,21,43
66,8482113,Anton Lundell,C,FLA,23,82,17,26,43
66,8482667,William Eklund,L,SJS,22,82,16,27,43
66,8473533,Jordan Staal,C,CAR,36,82,16,27,43
66,8477495,Seth Jones,D,CHI,30,82,13,30,43
66,8479345,Jakob Chychrun,D,WSH,26,82,12,31,43
66,8478891,Mason Appleton,C,WPG,28,82,11,32,43
66,8476923,Damon Severson,D,CBJ,30,82,8,35,43
66,8477948,Travis Sanheim,D,PHI,28,82,7,36,43
66,8475764,Cam Fowler,D,ANA,33,82,2,41,43
66,8477429,Andrew Copp,C,DET,30,82,21,21,42
66,8471698,T.J. Oshie,R,WSH,38,82,20,22,42
66,8479390,Taylor Raddysh,R,WSH,26,82,19,23,42
66,8476872,Scott Laughton,C,PHI,30,82,17,25,42
66,8478057,Dakota Joshua,C,VAN,28,82,15,27,42
66,8477021,Alex Kerfoot,C,UTA,30,82,12,30,42
66,8477969,Marcus Pettersson,D,PIT,28,82,10,32,42
66,8481535,Nils Hoglander,L,VAN,24,82,25,16,41
66,8481540,Cole Caufield,R,MTL,23,82,20,21,41
66,8474149,Evgenii Dadonov,R,DAL,35,82,19,22,41
66,8480064,Josh Norris,C,OTT,25,82,18,23,41
66,8477964,Ivan Barbashev,C,VGK,29,82,15,26,41
66,8475218,Mattias Ekholm,D,EDM,34,82,12,29,41
66,8479976,Juuso Valimaki,D,UTA,26,82,5,36,41
66,8482079,Marco Rossi,C,MIN,23,82,26,14,40
66,8477952,Robby Fabbri,C,ANA,28,82,25,15,40
66,8475714,Calle Jarnkrok,C,TOR,33,82,22,18,40
66,8484144,Connor Bedard,C,CHI,19,82,22,18,40
66,8478046,Danton Heinen,L,VAN,29,82,19,21,40
66,8480185,Eetu Luostarinen,C,FLA,26,82,17,23,40
66,8479365,Trent Frederic,C,BOS,26,82,15,25,40
66,8476461,Sean Couturier,C,PHI,32,82,14,26,40
66,8480220,Noah Cates,L,PHI,25,82,14,26,40
66,8480871,Adam Boqvist,D,FLA,24,82,13,27,40
66,8482122,Brock Faber,D,MIN,22,82,10,30,40
66,8476458,Ryan Strome,C,ANA,31,82,9,31,40
66,8480043,Timothy Liljegren,D,TOR,25,82,5,35,40
66,8475314,Anders Lee,L,NYI,34,82,20,19,39
66,8476292,Ondrej Palat,L,NJD,33,82,19,20,39
66,8475793,Ryan Johansen,C,PHI,32,82,18,21,39
66,8478462,Nicolas Roy,C,VGK,27,82,16,23,39
66,8475799,Nino Niederreiter,R,WPG,32,82,15,24,39
66,8477998,Warren Foegele,L,LAK,28,82,14,25,39
66,8474189,Lars Eller,C,PIT,35,82,14,25,39
66,8481581,Thomas Harley,D,DAL,23,82,9,30,39
66,8480145,Neal Pionk,D,WPG,29,82,6,33,39
66,8482175,JJ Peterka,R,BUF,22,82,22,16,38
66,8481624,Ilya Mikheyev,R,CHI,30,82,17,21,38
66,8476873,Mark Jankowski,C,NSH,30,82,15,23,38
66,8479996,Cody Glass,C,NSH,25,82,11,27,38
66,8478413,Jordan Greenway,L,BUF,27,82,9,29,38
66,8478911,Matt Roy,D,WSH,29,82,9,29,38
66,8476885,Jacob Trouba,D,NYR,30,82,6,32,38
66,8479941,Justin Danforth,R,CBJ,31,82,23,14,37
66,8478463,Anthony Beauvillier,L,PIT,27,82,18,19,37
66,8474053,Logan Couture,C,SJS,35,82,16,21,37
66,8479987,Morgan Geekie,C,BOS,26,82,16,21,37
66,8475287,Erik Haula,L,NJD,33,82,15,22,37
66,8476826,Yanni Gourde,C,SEA,33,82,9,28,37
66,8476392,Adam Lowry,C,WPG,31,82,9,28,37
66,8476869,Brady Skjei,D,NSH,30,82,7,30,37
66,8473422,Nick Foligno,L,CHI,37,82,16,20,36
66,8477987,Ryan Donato,C,CHI,28,82,14,22,36
66,8480009,Eeli Tolvanen,R,SEA,25,82,13,23,36
66,8475193,Tomas Tatar,L,NJD,34,82,13,23,36
66,8481013,Jonatan Berggren,R,DET,24,82,13,23,36
66,8481546,Cam York,D,PHI,23,82,9,27,36
66,8476902,Esa Lindell,D,DAL,30,82,6,30,36
66,8476958,Jaccob Slavin,D,CAR,30,82,5,31,36
66,8476854,Hampus Lindholm,D,BOS,30,82,5,31,36
66,8476374,Sean Kuraly,C,CBJ,31,82,17,18,35
66,8482125,Alexander Holtz,R,VGK,22,82,14,21,35
66,8477919,Frederick Gaudreau,C,MIN,31,82,13,22,35
66,8482720,Matthew Knies,L,TOR,22,82,12,23,35
66,8482105,Jake Sanderson,D,OTT,22,82,11,24,35
66,8475149,Marcus Johansson,L,MIN,34,82,11,24,35
66,8476927,Teddy Blueger,C,VAN,30,82,10,25,35
66,8482660,Kent Johnson,C,CBJ,22,82,10,25,35
66,8476419,Jean-Gabriel Pageau,C,NYI,32,82,9,26,35
66,8474715,Cam Atkinson,R,TBL,35,82,18,16,34
66,8481601,Simon Holmstrom,R,NYI,23,82,18,16,34
66,8478569,Noel Acciari,C,PIT,33,82,16,18,34
66,8480068,Ryan Poehling,C,PHI,25,82,16,18,34
66,8480113,Alex Iafallo,L,WPG,31,82,12,22,34
66,8477989,Christian Dvorak,C,MTL,28,82,11,23,34
66,8476422,Mike Reilly,D,NYI,31,82,11,23,34
66,8476921,Jordan Martinook,L,CAR,32,82,10,24,34
66,8480873,Rasmus Sandin,D,WSH,24,82,9,25,34
66,8481604,Pavel Dorofeyev,L,VGK,24,82,25,8,33
66,8476981,Josh Anderson,R,MTL,30,82,25,8,33
66,8483515,Juraj Slafkovsky,L,MTL,20,82,22,11,33
66,8482475,Yegor Chinakhov,R,CBJ,23,82,17,16,33
66,8480893,Kirill Marchenko,R,CBJ,24,82,17,16,33
66,8473563,Nicklas Backstrom,C,WSH,37,82,17,16,33
66,8482092,Ridly Greig,C,OTT,22,82,16,17,33
66,8475855,Jesper Fast,R,CAR,33,82,13,20,33
66,8484153,Leo Carlsson,C,ANA,20,82,13,20,33
66,8477444,Andre Burakovsky,L,SEA,29,82,10,23,33
66,8476960,Andreas Athanasiou,C,CHI,30,82,8,25,33
66,8473507,Jeff Petry,D,DET,37,82,7,26,33
66,8482245,Artem Zub,D,OTT,29,82,5,28,33
66,8475343,Nic Dowd,C,WSH,34,82,22,10,32
66,8481554,Kaapo Kakko,R,NYR,23,82,21,11,32
66,8478109,Victor Olofsson,L,VGK,29,82,17,15,32
66,8480829,Jesperi Kotkaniemi,C,CAR,24,82,17,15,32
66,8481580,Connor McMichael,C,WSH,23,82,16,16,32
66,8482089,Jake Neighbours,L,STL,22,82,14,18,32
66,8476278,Colin Blackwell,C,DAL,31,82,14,18,32
66,8477947,Sonny Milano,L,WSH,28,82,13,19,32
66,8481186,Logan O'Connor,R,COL,28,82,9,23,32
66,8476906,Shayne Gostisbehere,D,CAR,31,82,8,24,32
66,8476917,Adam Pelech,D,NYI,30,82,7,25,32
66,8475220,Marcus Foligno,L,MIN,33,82,7,25,32
66,8481606,Jordan Spence,D,LAK,23,82,6,26,32
66,8474151,Ryan McDonagh,D,TBL,35,82,2,30,32
66,8480835,Jack Drury,C,CAR,24,82,14,17,31
66,8480806,Isac Lundestrom,C,ANA,25,82,14,17,31
66,8482146,Luke Evangelista,R,NSH,22,82,12,19,31
66,8478472,Mathieu Joseph,R,STL,27,82,10,21,31
66,8475462,Radko Gudas,D,ANA,34,82,2,29,31
66,8479368,Max Jones,L,BOS,26,82,19,11,30
66,8481582,Nicholas Robertson,L,TOR,23,82,18,12,30
66,8482259,Bobby McMann,C,TOR,28,82,18,12,30
66,8476469,Joel Armia,R,MTL,31,82,15,15,30
66,8479992,Michael Rasmussen,C,DET,25,82,14,16,30
66,8476480,Vladislav Namestnikov,C,WPG,32,82,13,17,30
66,8477450,Jason Dickinson,C,CHI,29,82,13,17,30
66,8480802,Ryan McLeod,C,BUF,25,82,13,17,30
66,8470621,Corey Perry,R,EDM,39,82,11,19,30
66,8480878,Nils Lundkvist,D,DAL,24,82,11,19,30
66,8479351,Sam Steel,C,DAL,26,82,10,20,30
66,8481704,Juuso Parssinen,C,NSH,23,82,10,20,30
66,8479402,Jake Bean,D,CGY,26,82,6,24,30
66,8479983,Mario Ferraro,D,SJS,26,82,6,24,30
66,8481178,Egor Zamula,D,PHI,24,82,3,27,30
66,8478508,Yakov Trenin,C,MIN,27,82,23,6,29
66,8482062,Cole Smith,L,NSH,29,82,15,14,29
66,8476474,Stefan Noesen,R,NJD,31,82,14,15,29
66,8480748,Kiefer Sherwood,L,VAN,29,82,13,16,29
66,8476918,Jimmy Vesey,L,NYR,31,82,13,16,29
66,8484203,Bradly Nadeau,L,CAR,19,82,13,16,29
66,8480817,K'Andre Miller,D,NYR,24,82,5,24,29
66,8479359,Beck Malenstyn,L,BUF,26,82,19,9,28
66,8480789,Oliver Wahlstrom,R,NYI,24,82,16,12,28
66,8476889,Radek Faksa,C,STL,30,82,14,14,28
66,8478434,Keegan Kolesar,R,VGK,27,82,13,15,28
66,8479291,Kevin Rooney,C,CGY,31,82,12,16,28
66,8479661,Tanner Jeannot,L,LAK,27,82,11,17,28
66,8482074,Connor Zary,C,CGY,23,82,11,17,28
66,8477508,Curtis Lazar,C,NJD,29,82,10,18,28
66,8480035,Henri Jokiharju,D,BUF,25,82,6,22,28
66,8478178,Darren Raddysh,D,TBL,28,82,5,23,28
66,8482073,Braden Schneider,D,NYR,23,82,4,24,28
66,8475790,Erik Gudbranson,D,CBJ,32,82,4,24,28
66,8476463,Jonas Brodin,D,MIN,31,82,3,25,28
66,8475690,Chris Tanev,D,TOR,35,82,3,25,28
66,8480281,Alexey Toropchenko,R,STL,25,82,17,10,27
66,8483763,Maksymilian Szuber,D,UTA,22,82,15,12,27
66,8475231,Casey Cizikas,C,NYI,33,82,14,13,27
66,8484166,Adam Fantilli,C,CBJ,20,82,13,14,27
66,8479293,Brandon Tanev,L,SEA,33,82,12,15,27
66,8476624,Barclay Goodrow,C,SJS,31,82,12,15,27
66,8482133,Thomas Bordeleau,C,SJS,22,82,11,16,27
66,8477839,Conor Sheary,L,TBL,32,82,9,18,27
66,8482655,J.J. Moser,D,TBL,24,82,6,21,27
66,8475200,Dmitry Orlov,D,CAR,33,82,6,21,27
66,8480073,Erik Brannstrom,D,COL,25,82,6,21,27
66,8476525,Colin Miller,D,WPG,32,82,5,22,27
66,8478500,Ivan Provorov,D,CBJ,27,82,4,23,27
66,8479414,Nathan Bastian,R,NJD,27,82,15,11,26
66,8476897,Oskar Sundqvist,C,STL,30,82,12,14,26
66,8477353,Tyler Motte,C,DET,29,82,12,14,26
66,8479591,Michael Eyssimont,C,TBL,28,82,11,15,26
66,8478133,Jake Evans,C,MTL,28,82,11,15,26
66,8480995,Pontus Holmberg,R,TOR,25,82,11,15,26
66,8477406,Mattias Janmark,C,EDM,32,82,11,15,26
66,8481553,Bobby Brink,R,PHI,23,82,10,16,26
66,8476312,Josh Manson,D,COL,33,82,9,17,26
66,8477425,Miles Wood,L,COL,29,82,9,17,26
66,8475181,Nick Leddy,D,STL,33,82,4,22,26
66,8476457,Adam Larsson,D,SEA,32,82,4,22,26
66,8478507,John Marino,D,UTA,27,82,3,23,26
66,8482077,Dylan Holloway,L,EDM,23,82,16,9,25
66,8475848,Brendan Gallagher,R,MTL,32,82,14,11,25
66,8481032,Paul Cotter,C,NJD,25,82,13,12,25
66,8483457,Lane Hutson,D,MTL,20,82,11,14,25
66,8477507,Nikita Zadorov,D,BOS,29,82,10,15,25
66,8480144,David Kampf,C,TOR,29,82,10,15,25
66,8477015,Connor Brown,R,EDM,30,82,9,16,25
66,8480003,Jesper Boqvist,C,FLA,26,82,8,17,25
66,8483482,Tristan Luneau,D,ANA,20,82,8,17,25
66,8475279,Ben Chiarot,D,DET,33,82,7,18,25
66,8480222,Sebastian Aho,D,PIT,28,82,7,18,25
66,8481522,Peyton Krebs,C,BUF,23,82,6,19,25
66,8477220,Nate Schmidt,D,FLA,33,82,5,20,25
66,8482087,Kaiden Guhle,D,MTL,22,82,5,20,25
66,8476892,Colton Parayko,D,STL,31,82,5,20,25
66,8478136,Jake Middleton,D,MIN,28,82,5,20,25
66,8479398,Samuel Girard,D,COL,26,82,4,21,25
66,8478851,Alexandre Carrier,D,NSH,28,82,3,22,25
66,8481028,Martin Pospisil,C,CGY,25,82,16,8,24
66,8477903,Garnet Hathaway,R,PHI,33,82,14,10,24
66,8482702,Logan Stankoven,C,DAL,21,82,13,11,24
66,8483431,Logan Cooley,C,UTA,20,82,13,11,24
66,8480855,Jack McBain,C,UTA,24,82,10,14,24
66,8480980,Connor Dewar,C,TOR,25,82,9,15,24
66,8476467,Jamie Oleksiak,D,SEA,32,82,7,17,24
66,8476891,Matt Grzelcyk,D,PIT,30,82,5,19,24
66,8481568,Alex Vlasic,D,CHI,23,82,4,20,24
66,8470600,Ryan Suter,D,STL,39,82,3,21,24
66,8481517,Brett Leason,R,ANA,25,82,12,11,23
66,8482141,Lukas Cormier,D,VGK,22,82,11,12,23
66,8481481,Blake Lizotte,C,PIT,27,82,10,13,23
66,8479393,Noah Gregor,C,OTT,26,82,9,14,23
66,8478882,Vladislav Gavrikov,D,LAK,29,82,9,14,23
66,8479353,Brett Howden,C,VGK,26,82,9,14,23
66,8484145,Zach Benson,L,BUF,19,82,9,14,23
66,8476331,Dylan DeMelo,D,WPG,31,82,6,17,23
66,8474574,Tyler Myers,D,VAN,34,82,6,17,23
66,8484149,Gavin Brindley,C,CBJ,20,82,5,18,23
66,8477488,Brett Pesce,D,NJD,30,82,5,18,23
66,8475171,Oliver Ekman-Larsson,D,TOR,33,82,5,18,23
66,8482142,Jamie Drysdale,D,PHI,22,82,4,19,23
66,8477365,Connor Clifton,D,BUF,29,82,2,21,23
66,8483505,Matthew Poitras,C,BOS,20,82,11,11,22
66,8478013,Jake Walman,D,SJS,28,82,10,12,22
66,8480025,MacKenzie Entwistle,R,FLA,25,82,10,12,22
66,8476442,Matt Nieto,L,PIT,32,82,9,13,22
66,8482624,Daniil Miromanov,D,CGY,27,82,8,14,22
66,8478211,Dryden Hunt,L,CGY,29,82,8,14,22
66,8473453,Trevor Lewis,C,LAK,37,82,7,15,22
66,8475324,Nick Jensen,D,OTT,34,82,5,17,22
66,8476879,Cody Ceci,D,EDM,31,82,5,17,22
66,8475455,Brenden Dillon,D,NJD,34,82,4,18,22
66,8479371,Dante Fabbro,D,NSH,26,82,4,18,22
66,8474013,Ian Cole,D,UTA,35,82,4,18,22
66,8476931,Jake McCabe,D,TOR,31,82,3,19,22
66,8476967,Brett Kulak,D,EDM,30,82,2,20,22
66,8475188,Brayden McNabb,D,VGK,33,82,1,21,22
66,8477392,Hudson Fasching,R,NYI,29,82,10,11,21
66,8480813,Joe Veleno,C,DET,24,82,9,12,21
66,8483499,Liam Ohgren,L,MIN,20,82,9,12,21
66,8483445,Cutter Gauthier,L,ANA,20,82,7,14,21
66,8482858,Ryker Evans,D,SEA,23,82,7,14,21
66,8481567,Henry Thrun,D,SJS,23,82,6,15,21
66,8477435,Ryan Graves,D,PIT,29,82,5,16,21
66,8479324,Ryan Lindgren,D,NYR,26,82,3,18,21
66,8478416,Erik Cernak,D,TBL,27,82,3,18,21
66,8480834,Ty Emberson,D,SJS,24,82,2,19,21
66,8483490,Pavel Mintyukov,D,ANA,21,82,1,20,21
66,8482807,Ethan Del Mastro,D,CHI,21,82,10,10,20
66,8480074,Alexandre Texier,C,STL,25,82,7,13,20
66,8477931,Tomas Nosek,L,FLA,32,82,6,14,20
66,8482153,Brendan Brisson,C,VGK,23,82,6,14,20
66,8478468,Jeremy Lauzon,D,NSH,27,82,4,16,20
66,8481014,Alexander Romanov,D,NYI,24,82,3,17,20
66,8475718,Justin Holl,D,DET,32,82,3,17,20
66,8476429,Scott Mayfield,D,NYI,32,82,2,18,20
66,8482155,Alex Laferriere,R,LAK,23,82,12,7,19
66,8478432,Christian Fischer,R,DET,27,82,9,10,19
66,8480021,Jack Studnicka,C,LAK,25,82,9,10,19
66,8477938,Haydn Fleury,D,WPG,28,82,8,11,19
66,8479316,Luke Kunin,C,SJS,27,82,5,14,19
66,8480796,Martin Fehervary,D,WSH,25,82,4,15,19
66,8478859,Niko Mikkola,D,FLA,28,82,4,15,19
66,8479369,Andrew Peeke,D,BOS,26,82,3,16,19
66,8482809,Jackson Blake,R,CAR,21,82,3,16,19
66,8480860,Kevin Bahl,D,CGY,24,82,3,16,19
66,8479998,Mikey Anderson,D,LAK,25,82,3,16,19
66,8478443,Brandon Carlo,D,BOS,28,82,1,18,19
66,8481093,Rafael Harvey-Pinard,L,MTL,25,82,10,8,18
66,8483397,Marc McLaughlin,C,BOS,25,82,9,9,18
66,8475842,Sam Carrick,C,NYR,32,82,9,9,18
66,8482679,Matt Coronato,R,CGY,22,82,9,9,18
66,8476878,Zemgus Girgensons,L,TBL,30,82,8,10,18
66,8481699,Aku Raty,R,UTA,23,82,8,10,18
66,8483495,Simon Nemec,D,NJD,20,82,7,11,18
66,8475233,David Savard,D,MTL,34,82,7,11,18
66,8482111,Justin Barron,D,MTL,23,82,6,12,18
66,8477499,Rasmus Ristolainen,D,PHI,30,82,5,13,18
66,8478399,Jonas Siegenthaler,D,NJD,27,82,3,15,18
66,8478840,Will Borgen,D,SEA,28,82,2,16,18
66,8480246,Nick Perbix,D,TBL,26,82,1,17,18
66,8482666,Scott Morrow,D,CAR,22,82,12,5,17
66,8482762,Simon Edvinsson,D,DET,21,82,12,5,17
66,8482659,Josh Doan,R,UTA,22,82,10,7,17
66,8481477,Nico Sturm,C,SJS,29,82,8,9,17
66,8482101,Danil Gushchin,L,SJS,22,82,8,9,17
66,8481524,Bowen Byram,D,BUF,23,82,7,10,17
66,8482166,Shakir Mukhamadullin,D,SJS,22,82,4,13,17
66,8482733,Logan Mailloux,D,MTL,31,82,4,13,17
66,8482803,Olen Zellweger,D,ANA,21,82,2,15,17
66,8477845,Trevor van Riemsdyk,D,WSH,33,82,0,17,17
66,8483524,Shane Wright,C,SEA,20,82,10,6,16
66,8477505,Alexander Wennberg,C,SJS,30,82,9,7,16
66,8483468,Jiri Kulich,C,BUF,20,82,6,10,16
66,8477034,Jaycob Megna,D,FLA,32,82,4,12,16
66,8477369,Carson Soucy,D,VAN,30,82,4,12,16
66,8480879,Jacob Bernard-Docker,D,OTT,24,82,3,13,16
66,8480807,Mattias Samuelsson,D,BUF,24,82,3,13,16
66,8482470,Ilya Solovyov,D,CGY,24,82,7,8,15
66,8476858,Phillip Di Giuseppe,L,VAN,31,82,7,8,15
66,8479442,Troy Stecher,D,EDM,30,82,6,9,15
66,8480049,Dylan Samberg,D,WPG,25,82,4,11,15
66,8479980,Nicolas Hague,D,VGK,26,82,3,12,15
66,8480990,Declan Chisholm,D,MIN,24,82,3,12,15
66,8475762,Derek Forbort,D,VAN,32,82,3,12,15
66,8479638,Justin Brazeau,R,BOS,26,82,6,8,14
66,8483565,Nick Blankenburg,D,NSH,26,82,5,9,14
66,8478450,Parker Wotherspoon,D,BOS,27,82,4,10,14
66,8481122,Simon Benoit,D,TOR,26,82,3,11,14
66,8481708,Zac Jones,D,NYR,24,82,2,12,14
66,8483460,David Jiricek,D,CBJ,21,82,2,12,14
66,8474673,TJ Brodie,D,CHI,34,82,1,13,14
66,8476441,Joel Edmundson,D,LAK,31,82,0,14,14
66,8476822,Luke Glendening,C,TBL,35,82,7,6,13
66,8482145,Mavrik Bourque,C,DAL,22,82,6,7,13
66,8482787,Nikita Chibrikov,R,WPG,31,82,6,7,13
66,8477335,Kyle Burroughs,D,LAK,29,82,5,8,13
66,8471677,Jack Johnson,D,CBJ,37,82,3,10,13
66,8481605,Jackson LaCombe,D,ANA,23,82,3,10,13
66,8480172,Jan Rutta,D,SJS,34,82,2,11,13
66,8480950,Ilya Lyubushkin,D,DAL,30,82,2,11,13
66,8475177,Calvin de Haan,D,COL,33,82,1,12,13
66,8478874,Adam Gaudette,C,OTT,28,82,1,12,13
66,8480448,Parker Kelly,L,COL,25,82,6,6,12
66,8482118,Sam Colangelo,R,ANA,23,82,5,7,12
66,8484911,Collin Graf,R,SJS,22,82,3,9,12
66,8482516,Matthew Kessel,D,STL,24,82,2,10,12
66,8483471,Brad Lambert,C,WPG,31,82,7,4,11
66,8482713,Mackie Samoskevich,R,FLA,22,82,6,5,11
66,8483489,Fraser Minten,C,TOR,31,82,5,6,11
66,8482070,Mitchell Chaffee,R,TBL,26,82,4,7,11
66,8483466,Kevin Korchinski,D,CHI,20,82,4,7,11
66,8483567,Georgii Merkulov,C,BOS,24,82,3,8,11
66,8479576,Vincent Desharnais,D,VAN,28,82,1,10,11
66,8483012,Logan Morrison,C,SEA,22,82,6,4,10
66,8474567,Zach Bogosian,D,MIN,34,82,3,7,10
66,8483493,Frank Nazar,C,CHI,20,82,2,8,10
66,8474090,Brendan Smith,D,DAL,35,82,1,9,10
66,8482712,Oskar Olausson,R,COL,22,82,3,6,9
66,8474612,Travis Hamonic,D,OTT,34,82,1,8,9
66,8481641,Joel Kiviranta,L,COL,28,82,4,4,8
66,8482749,Joshua Roy,R,MTL,21,82,4,4,8
66,8476372,Nick Seeler,D,PHI,31,82,1,7,8
66,8480870,Bo Groulx,C,NYR,24,82,4,3,7
66,8476473,Connor Murphy,D,CHI,31,82,1,6,7
66,8482859,Zack Ostapchuk,C,OTT,21,82,2,4,6
66,8474062,Riley Nash,C,NYR,35,82,0,5,5
66,8470794,Joe Pavelski,C,,40,0,0,0,0
66,8481703,Valtteri Puustinen,R,PIT,25,0,0,0,0
66,8477950,Tony DeAngelo,D,,29,0,0,0,0
66,8481577,Philip Tomasino,C,NSH,23,0,0,0,0
66,8475197,Tyson Barrie,D,,33,0,0,0,0
66,8471218,Blake Wheeler,R,,38,0,0,0,0
66,8474157,Max Pacioretty,L,,36,0,0,0,0
66,8478466,Daniel Sprong,R,VAN,27,0,0,0,0
66,8475744,Evgeny Kuznetsov,C,,32,0,0,0,0
66,8481019,David Gustafsson,C,WPG,24,0,0,0,0
66,8475906,John Klingberg,D,,32,0,0,0,0
66,8479348,Kale Clague,D,BUF,26,0,0,0,0
66,8476952,Dominic Toninato,C,WPG,30,0,0,0,0
66,8473473,Milan Lucic,L,,36,0,0,0,0
66,8474037,James van Riemsdyk,L,,35,0,0,0,0
66,8474602,Justin Schultz,D,,34,0,0,0,0
66,8482222,Alexander Barabanov,L,,30,0,0,0,0
66,8479372,Josh Mahura,D,SEA,26,0,0,0,0
66,8479982,Conor Timmins,D,TOR,26,0,0,0,0
66,8474031,Kevin Shattenkirk,D,,35,0,0,0,0
66,8480008,Adam Ruzicka,C,,25,0,0,0,0
66,8481059,Scott Perunovich,D,STL,26,0,0,0,0
66,8480884,Calen Addison,D,,24,0,0,0,0
66,8476994,Vinnie Hinostroza,C,NSH,30,0,0,0,0
66,8478452,Caleb Jones,D,LAK,27,0,0,0,0
66,8480157,Calle Rosen,D,COL,30,0,0,0,0
66,8481609,Vladislav Kolyachonok,D,UTA,23,0,0,0,0
66,8479415,Michael McLeod,C,,26,0,0,0,0
66,8476919,Chris Tierney,C,,30,0,0,0,0
66,8479639,Dylan Coghlan,D,WPG,26,0,0,0,0
66,8478146,Matthew Highmore,C,OTT,28,0,0,0,0
66,8478970,Jalen Chatfield,D,CAR,28,0,0,0,0
66,8480205,Emil Bemstrom,C,PIT,25,0,0,0,0
66,8474884,Mike Hoffman,C,,35,0,0,0,0
66,8471274,Alex Goligoski,D,,39,0,0,0,0
66,8478104,Sammy Blais,L,,28,0,0,0,0
66,8474870,Tyler Johnson,C,,34,0,0,0,0
66,8476913,Devin Shore,C,MIN,30,0,0,0,0
66,8481598,Philip Broberg,D,EDM,23,0,0,0,0
66,8480058,Pierre-Olivier Joseph,D,STL,25,0,0,0,0
66,8480891,Michael Kesselring,D,UTA,24,0,0,0,0
66,8477979,Nicolas Aube-Kubel,R,BUF,28,0,0,0,0
66,8476871,Tanner Pearson,L,,32,0,0,0,0
66,8476393,Nick Cousins,C,,31,0,0,0,0
66,8479977,Kailer Yamamoto,R,,26,0,0,0,0
66,8479543,Michael Pezzetta,L,MTL,26,0,0,0,0
66,8477018,Ben Hutton,D,VGK,31,0,0,0,0
66,8480762,Eric Robinson,L,CAR,29,0,0,0,0
66,8474034,Pat Maroon,L,CHI,36,0,0,0,0
66,8481058,Jesse Ylönen,R,,25,0,0,0,0
66,8475179,Dmitry Kulikov,D,FLA,34,0,0,0,0
66,8481527,Kaedan Korczak,D,VGK,23,0,0,0,0
66,8473449,Kyle Okposo,R,,36,0,0,0,0
66,8482192,Isaak Phillips,D,CHI,23,0,0,0,0
66,8480727,Zach Whitecloud,D,VGK,28,0,0,0,0
66,8479346,Dillon Dube,C,,26,0,0,0,0
66,8480821,Filip Zadina,R,,25,0,0,0,0
66,8480001,Urho Vaakanainen,D,ANA,25,0,0,0,0
66,8470966,Mark Giordano,D,,41,0,0,0,0
66,8480853,Liam Foudy,C,,24,0,0,0,0
66,8475225,Craig Smith,C,CHI,35,0,0,0,0
66,8479972,Mason Shaw,C,WPG,26,0,0,0,0
66,8478451,Ethan Bear,D,WSH,27,0,0,0,0
66,8474040,Sam Gagner,C,,35,0,0,0,0
66,8480196,Jacob Bryson,D,BUF,27,0,0,0,0
66,8479984,Cal Foote,D,,26,0,0,0,0
66,8480011,Klim Kostin,C,SJS,25,0,0,0,0
66,8482176,Wyatt Kaiser,D,CHI,22,0,0,0,0
66,8476988,Matt Benning,D,SJS,30,0,0,0,0
66,8479370,Tyson Jost,C,CAR,26,0,0,0,0
66,8477464,Nic Petan,C,,29,0,0,0,0
66,8477380,Jonny Brodzinski,C,NYR,31,0,0,0,0
66,8480070,Ian Mitchell,D,BOS,25,0,0,0,0
66,8479315,Joey Anderson,R,CHI,26,0,0,0,0
66,8478099,Kevin Labanc,R,,29,0,0,0,0
66,8476874,Olli Maatta,D,DET,30,0,0,0,0
66,8475208,Brian Dumoulin,D,ANA,33,0,0,0,0
66,8478430,Oliver Kylington,D,,27,0,0,0,0
66,8479536,Axel Jonsson-Fjallby,L,WPG,26,0,0,0,0
66,8479671,Mathieu Olivier,R,CBJ,27,0,0,0,0
66,8471709,Marc-Edouard Vlasic,D,SJS,37,0,0,0,0
66,8479328,Julien Gauthier,R,NYI,27,0,0,0,0
66,8478421,A.J. Greer,L,FLA,28,0,0,0,0
66,8477573,Nathan Walker,L,STL,30,0,0,0,0
66,8481537,Nikita Okhotiuk,D,CGY,24,0,0,0,0
66,8474166,Alec Martinez,D,CHI,37,0,0,0,0
66,8470610,Zach Parise,L,,40,0,0,0,0
66,8477478,William Carrier,L,CAR,30,0,0,0,0
66,8479344,Jesse Puljujarvi,R,PIT,26,0,0,0,0
66,8480887,Jordan Harris,D,MTL,24,0,0,0,0
66,8478502,Dennis Gilbert,D,BUF,28,0,0,0,0
66,8482730,Brandt Clarke,D,LAK,21,0,0,0,0
66,8480355,Mark Kastelic,C,BOS,25,0,0,0,0
66,8475750,Jon Merrill,D,MIN,32,0,0,0,0
66,8475164,Jakob Silfverberg,R,,34,0,0,0,0
66,8477944,Jakub Vrana,L,,28,0,0,0,0
66,8479439,Jacob MacDonald,D,COL,31,0,0,0,0
66,8474568,Luke Schenn,D,NSH,35,0,0,0,0
66,8478454,Noah Juulsen,D,VAN,27,0,0,0,0
66,8475752,Tyler Pitlick,C,,33,0,0,0,0
66,8482148,Hendrix Lapierre,C,WSH,22,0,0,0,0
66,8481167,Brayden Pachal,D,CGY,25,0,0,0,0
66,8478043,Sam Lafferty,C,BUF,29,0,0,0,0
66,8479321,Lucas Johansen,D,,27,0,0,0,0
66,8471699,Andrew Cogliano,C,,37,0,0,0,0
66,8481521,Ronnie Attard,D,PHI,25,0,0,0,0
66,8481161,Jake Christiansen,D,CBJ,25,0,0,0,0
66,8479458,Nikita Zaitsev,D,,33,0,0,0,0
66,8479619,Michael Carcone,L,UTA,28,0,0,0,0
66,8479026,Philippe Myers,D,TOR,27,0,0,0,0
66,8477330,Dominik Kubalik,L,,29,0,0,0,0
66,8481617,Vasily Podkolzin,R,VAN,23,0,0,0,0
66,8481701,Santeri Hatakka,D,NJD,23,0,0,0,0
66,8479514,Rem Pitlick,C,,27,0,0,0,0
66,8477446,Michael McCarron,R,NSH,29,0,0,0,0
66,8470604,Jeff Carter,C,,39,0,0,0,0
66,8482241,Radim Zohorna,L,,28,0,0,0,0
66,8480289,Morgan Barron,C,WPG,26,0,0,0,0
66,8479379,Givani Smith,R,SJS,26,0,0,0,0
66,8480216,Jacob Peterson,C,,25,0,0,0,0
66,8477851,Jordan Oesterle,D,BOS,32,0,0,0,0
66,8484258,Sam Malinski,D,COL,26,0,0,0,0
66,8478904,Steven Lorentz,C,,28,0,0,0,0
66,8482095,Tyler Kleven,D,OTT,22,0,0,0,0
66,8480848,Ty Dellandrea,C,SJS,24,0,0,0,0
66,8476884,Derrick Pouliot,D,,30,0,0,0,0
66,8479336,Carl Grundstrom,R,SJS,27,0,0,0,0
66,8482964,Arber Xhekaj,D,MTL,23,0,0,0,0
66,8471686,Marc Staal,D,,37,0,0,0,0
66,8477887,Patrick Brown,C,BOS,32,0,0,0,0
66,8478495,Denis Gurianov,R,,27,0,0,0,0
66,8473504,Cal Clutterbuck,R,,37,0,0,0,0
66,8481550,Adam Beckman,L,NJD,23,0,0,0,0
66,8480845,Rasmus Kupari,C,WPG,24,0,0,0,0
66,8474009,Nick Bonino,C,,36,0,0,0,0
66,8478585,Derek Ryan,C,EDM,38,0,0,0,0
66,8477962,Brendan Lemieux,L,CAR,28,0,0,0,0
66,8482861,Vincent Iorio,D,WSH,22,0,0,0,0
66,8479378,Logan Stanley,D,WPG,26,0,0,0,0
66,8473446,Erik Johnson,D,PHI,36,0,0,0,0
66,8481743,Marc Del Gaizo,D,NSH,25,0,0,0,0
66,8477384,Josh Brown,D,EDM,30,0,0,0,0
66,8482165,Yan Kuznetsov,D,CGY,22,0,0,0,0
66,8478424,Jansen Harkins,C,ANA,27,0,0,0,0
66,8482144,Jack Thompson,D,SJS,22,0,0,0,0
66,8478512,Austin Czarnik,C,,32,0,0,0,0
66,8477527,Ross Johnston,L,ANA,30,0,0,0,0
66,8479383,Boris Katchouk,L,,26,0,0,0,0
66,8482094,Daemon Hunt,D,MIN,22,0,0,0,0
66,8481719,Maxwell Crozier,D,TBL,24,0,0,0,0
66,8480192,Johnathan Kovacevic,D,NJD,27,0,0,0,0
66,8479376,Victor Mete,D,,26,0,0,0,0
66,8482511,Mason Lohrei,D,BOS,23,0,0,0,0
66,8475825,Jani Hakanpää,D,,32,0,0,0,0
66,8478021,William Lagesson,D,DET,28,0,0,0,0
66,8475795,Dylan McIlrath,D,WSH,32,0,0,0,0
66,8477846,Ryan Carpenter,C,,33,0,0,0,0
66,8481056,Spencer Stastney,D,NSH,24,0,0,0,0
66,8481564,Ryan Johnson,D,BUF,23,0,0,0,0
66,8478017,Mark Friedman,D,VAN,29,0,0,0,0
66,8479320,Max Lajoie,D,SEA,27,0,0,0,0
66,8480075,Cameron Crotty,D,MIN,25,0,0,0,0
66,8484287,Cole McWard,D,VAN,23,0,0,0,0
66,8484254,Akito Hirose,D,VAN,25,0,0,0,0
66,8483407,Brandon Scanlin,D,NYR,25,0,0,0,0
66,8480274,Philip Kemp,D,EDM,25,0,0,0,0
66,8479522,Hardy Haman Aktell,D,WSH,26,0,0,0,0
66,8480007,Jonas Rondbjerg,R,VGK,25,0,0,0,0
66,8477454,Adam Erne,L,,29,0,0,0,0
66,8481679,Maxence Guenette,D,OTT,23,0,0,0,0
66,8480441,Trey Fix-Wolansky,R,CBJ,25,0,0,0,0
66,8483546,Marshall Rifai,D,TOR,26,0,0,0,0
66,8480084,Nick DeSimone,D,NJD,30,0,0,0,0
66,8481030,Jack St. Ivany,D,PIT,25,0,0,0,0
66,8481592,Jakob Pelletier,L,CGY,23,0,0,0,0
66,8478011,Louie Belpedio,D,PHI,28,0,0,0,0
66,8477930,Pierre-Edouard Bellemare,L,,39,0,0,0,0
66,8484321,Nikolas Matinpalo,D,OTT,26,0,0,0,0
66,8482067,Connor Mackey,D,NYR,28,0,0,0,0
66,8481806,Louis Crevier,D,CHI,23,0,0,0,0
66,8484326,Patrik Koch,D,UTA,28,0,0,0,0
66,8477971,Andreas Englund,D,LAK,28,0,0,0,0
66,8481751,Lukas Rousek,R,BUF,25,0,0,0,0
66,8481006,Tyler Tucker,D,STL,24,0,0,0,0
66,8476867,Brendan Gaunce,C,MIN,30,0,0,0,0
66,8479520,Brandon Duhaime,R,WSH,27,0,0,0,0
66,8477073,Kurtis MacDermid,L,NJD,30,0,0,0,0
66,8480874,Adam Ginning,D,PHI,24,0,0,0,0
66,8477473,Justin Bailey,R,SJS,29,0,0,0,0
66,8479066,Ryan Lomberg,L,CGY,30,0,0,0,0
66,8477070,Liam O'Brien,C,UTA,30,0,0,0,0
66,8474618,Marco Scandella,D,,34,0,0,0,0
66,8475797,Jarred Tinordi,D,,32,0,0,0,0
66,8481441,Joe Snively,C,DET,28,0,0,0,0
66,8477244,Chad Ruhwedel,D,NYR,34,0,0,0,0
66,8479772,Zack MacEwen,R,OTT,28,0,0,0,0
66,8481147,Reese Johnson,C,MIN,26,0,0,0,0
66,8481043,Cole Koepke,L,BOS,26,0,0,0,0
66,8483619,Filip Roos,D,OTT,25,0,0,0,0
66,8481541,Samuel Bolduc,D,NYI,24,0,0,0,0
66,8477810,Joel Hanley,D,CGY,33,0,0,0,0
66,8476907,Mackenzie MacEachern,L,,30,0,0,0,0
66,8482652,Walker Duehr,R,CGY,27,0,0,0,0
66,8477126,Jayson Megna,C,,34,0,0,0,0
66,8483398,Declan Carlile,D,TBL,31,0,0,0,0
66,8482929,Emil Lilleberg,D,TBL,23,0,0,0,0
66,8480880,Jakub Lauko,C,MIN,24,0,0,0,0
66,8480245,Olle Lycksell,R,PHI,25,0,0,0,0
66,8480252,Cole Guttman,C,CHI,25,0,0,0,0
66,8477467,Gustav Olofsson,D,SEA,30,0,0,0,0
66,8479968,Vinni Lettieri,C,BOS,29,0,0,0,0
66,8478400,Colin White,C,,27,0,0,0,0
66,8475755,Alexander Petrovic,D,DAL,32,0,0,0,0
66,8481812,Nikolai Knyzhov,D,,27,0,0,0,0
66,8481593,Jayden Struble,D,MTL,23,0,0,0,0
66,8481532,Alex Turcotte,C,LAK,23,0,0,0,0
66,8482126,Emil Andrae,D,PHI,31,0,0,0,0
66,8479944,Zach Aston-Reese,C,VGK,30,0,0,0,0
66,8471817,Ryan Reaves,R,TOR,37,0,0,0,0
66,8481206,John Ludvig,D,PIT,24,0,0,0,0
66,8481599,Victor Soderstrom,D,UTA,23,0,0,0,0
66,8480292,Carson Meyer,R,ANA,27,0,0,0,0
66,8482496,Nils Aman,C,VAN,24,0,0,0,0
66,8479718,Alex Barré-Boulet,C,MTL,27,0,0,0,0
66,8479994,Jaret Anderson-Dolan,C,WPG,25,0,0,0,0
66,8480184,Gustav Lindstrom,D,,26,0,0,0,0
66,8480890,Jan Jenik,R,OTT,24,0,0,0,0
66,8478067,Oskar Lindblom,L,,28,0,0,0,0
66,8476934,Brock McGinn,L,ANA,30,0,0,0,0
66,8479985,Cale Fleury,D,SEA,26,0,0,0,0
66,8484304,Uvis Balinskis,D,FLA,28,0,0,0,0
66,8479981,Jonah Gadjovich,L,FLA,26,0,0,0,0
66,8481716,Dmitri Voronkov,L,CBJ,24,0,0,0,0
66,8474709,Matt Martin,L,,35,0,0,0,0
66,8482634,Alex Steeves,C,TOR,25,0,0,0,0
66,8480823,Alexander Alexeyev,D,WSH,25,0,0,0,0
66,8477541,Dakota Mermis,D,TOR,30,0,0,0,0
66,8483491,Ivan Miroshnichenko,L,WSH,20,0,0,0,0
66,8478477,Mitchell Stephens,C,SEA,27,0,0,0,0
66,8481543,Nikita Alexandrov,C,STL,24,0,0,0,0
66,8479423,Alex Nylander,L,,26,0,0,0,0
66,8482451,Mikael Pyyhtia,L,CBJ,23,0,0,0,0
66,8478831,Kevin Stenlund,C,UTA,28,0,0,0,0
66,8480306,Grant Hutton,D,NYI,29,0,0,0,0
66,8478028,Fredrik Olofsson,L,,28,0,0,0,0
66,8477462,Robert Hagg,D,VGK,29,0,0,0,0
66,8477320,Anton Blidh,L,NYR,29,0,0,0,0
66,8482157,Will Cuylle,L,NYR,22,0,0,0,0
66,8482737,Zack Bolduc,C,STL,21,0,0,0,0
66,8481239,Samuel Fagemo,L,,24,0,0,0,0
66,8481600,Tobias Bjornfot,D,FLA,23,0,0,0,0
66,8478409,Anthony Richard,C,PHI,28,0,0,0,0
66,8474145,Robert Bortuzzo,D,,35,0,0,0,0
66,8475958,Michael Sgarbossa,C,WSH,32,0,0,0,0
66,8479986,Kole Lind,R,DAL,26,0,0,0,0
66,8479249,Andrew Poturalski,C,SJS,30,0,0,0,0
66,8479362,Riley Tufte,L,BOS,26,0,0,0,0
66,8479991,Jake Leschyshyn,C,NYR,25,0,0,0,0
66,8479587,Rhett Gardner,C,PHI,28,0,0,0,0
66,8482744,James Malatesta,L,CBJ,21,0,0,0,0
66,8478854,Ryan Shea,D,PIT,27,0,0,0,0
66,8481591,Sam Poulin,R,,23,0,0,0,0
66,8483512,Matt Savoie,C,EDM,20,0,0,0,0
66,8482102,Vasily Ponomarev,C,PIT,22,0,0,0,0
66,8482162,Roby Jarventie,L,EDM,22,0,0,0,0
66,8481016,Ruslan Iskhakov,C,,24,0,0,0,0
66,8482172,Landon Slaggert,L,CHI,22,0,0,0,0
66,8482747,Brennan Othmann,L,NYR,21,0,0,0,0
66,8480031,Maxime Comtois,L,,25,0,0,0,0
66,8480226,Marián Studenic,R,,26,0,0,0,0
66,8478408,Travis Dermott,D,,28,0,0,0,0
66,8481518,Nolan Foote,L,NJD,24,0,0,0,0
66,8479419,Brett Murray,L,BUF,26,0,0,0,0
66,8482088,Justin Sourdif,R,FLA,22,0,0,0,0
66,8482201,Gage Goncalves,C,TBL,23,0,0,0,0
66,8481578,Graeme Clarke,R,MIN,23,0,0,0,0
66,8482177,Marat Khusnutdinov,C,MIN,22,0,0,0,0
66,8481754,Nikita Nesterenko,C,ANA,23,0,0,0,0
66,8483531,Brian Halonen,L,NJD,25,0,0,0,0
66,8483920,Pierrick Dube,R,WSH,23,0,0,0,0
66,8480851,Akil Thomas,C,LAK,24,0,0,0,0
66,8475235,Nicolas Deslauriers,L,PHI,33,0,0,0,0
66,8482476,Emil Heineman,L,MTL,23,0,0,0,0
66,8477149,Scott Sabourin,R,SJS,32,0,0,0,0
66,8483549,Lucas Condotta,L,MTL,27,0,0,0,0
66,8482765,Isak Rosen,R,BUF,21,0,0,0,0
66,8481237,Kyle MacLean,C,NYI,25,0,0,0,0
66,8481024,Linus Karlsson,C,VAN,25,0,0,0,0
66,8481690,Tyler Angle,C,,24,0,0,0,0
66,8483570,Ben Meyers,C,SEA,26,0,0,0,0
66,8481655,Cole Schwindt,R,CGY,23,0,0,0,0
66,8481462,Mason Morelli,L,VGK,28,0,0,0,0
66,8483401,Marc Johnstone,R,PIT,28,0,0,0,0
66,8478956,Samuel Laberge,L,NJD,27,0,0,0,0
66,8479533,Joona Koppanen,L,,26,0,0,0,0
66,8482197,Adam Raska,R,MIN,23,0,0,0,0
66,8482250,Callahan Burke,C,VGK,27,0,0,0,0
66,8482784,Zach Dean,C,STL,21,0,0,0,0
66,8484255,Jason Polin,R,COL,25,0,0,0,0
66,8481077,John Leonard,L,,26,0,0,0,0
66,8481534,Raphael Lavoie,C,EDM,24,0,0,0,0
66,8483609,Adam Klapka,R,CGY,24,0,0,0,0
66,8482751,Ryan Winterton,C,SEA,21,0,0,0,0
66,8480267,Sammy Walker,C,MIN,25,0,0,0,0
66,8475766,Austin Watson,L,,32,0,0,0,0
66,8482460,Matt Rempe,C,NYR,22,0,0,0,0
66,8481065,Angus Crookshank,L,OTT,25,0,0,0,0
66,8481070,Hugh McGing,L,,26,0,0,0,0
66,8476323,Max McCormick,L,SEA,32,0,0,0,0
66,8483395,Arshdeep Bains,L,VAN,23,0,0,0,0
66,8484259,Ondrej Pavel,C,COL,31,0,0,0,0
66,8483432,Luca Del Bel Belluz,C,CBJ,31,0,0,0,0
66,8483045,Cameron Butler,R,CBJ,31,0,0,0,0
66,8482061,Brandon Biro,L,SEA,26,0,0,0,0
66,8477401,John Hayden,C,SEA,29,0,0,0,0
66,8475278,Byron Froese,C,,33,0,0,0,0
66,8478446,Glenn Gawdin,C,LAK,27,0,0,0,0
66,8477993,Justin Kirkland,C,CGY,28,0,0,0,0
66,8482147,Jean-Luc Foudy,C,COL,22,0,0,0,0
66,8480032,Shane Bowers,C,NJD,25,0,0,0,0
66,8479330,Brandon Gignac,C,MTL,27,0,0,0,0
66,8480776,Sheldon Rempal,R,,29,0,0,0,0
66,8475413,Justin Dowling,C,NJD,34,0,0,0,0
66,8481726,Adam Edstrom,C,NYR,24,0,0,0,0
66,8480844,Grigori Denisenko,L,VGK,24,0,0,0,0
66,8478147,Bokondji Imama,L,PIT,28,0,0,0,0
66,8478881,Brett Seney,L,CHI,28,0,0,0,0
66,8483630,Pavol Regenda,L,ANA,25,0,0,0,0
66,8480836,Jonathan Gruden,C,,24,0,0,0,0
66,8484314,Jiri Smejkal,L,,28,0,0,0,0
66,8475780,Chris Wagner,R,COL,33,0,0,0,0
66,8479546,Oskar Steen,C,,26,0,0,0,0
66,8483597,Milos Kelemen,L,UTA,25,0,0,0,0
66,8481789,Tye Kartye,L,SEA,23,0,0,0,0
66,8484325,Waltteri Merela,C,TBL,26,0,0,0,0
66,8479421,Jacob Moverare,D,LAK,26,0,0,0,0
66,8481585,Egor Afanasyev,L,SJS,23,0,0,0,0
66,8479547,Matthew Phillips,R,,26,0,0,0,0
66,8479367,William Lockwood,R,FLA,26,0,0,0,0
66,8476915,Jujhar Khaira,L,,30,0,0,0,0
66,8481422,Jacob Lucchini,C,NSH,29,0,0,0,0
66,8480468,James Hamblin,L,EDM,25,0,0,0,0
66,8478051,Max Willman,C,NJD,29,0,0,0,0
66,8481556,John Beecher,C,BOS,23,0,0,0,0
66,8478078,Rourke Chartier,C,,28,0,0,0,0
67,8477492,Nathan MacKinnon,C,COL,29,82,49,100,149
67,8478402,Connor McDavid,C,EDM,27,82,35,104,139
67,8476453,Nikita Kucherov,R,TBL,31,82,36,97,133
67,8479314,Matthew Tkachuk,L,FLA,27,82,50,80,130
67,8481559,Jack Hughes,C,NJD,23,82,47,79,126
67,8479318,Auston Matthews,C,TOR,27,82,69,48,117
67,8477493,Aleksander Barkov,C,FLA,29,82,36,78,114
67,8478420,Mikko Rantanen,R,COL,28,82,48,63,111
67,8477956,David Pastrnak,R,BOS,28,82,54,54,108
67,8474600,Roman Josi,D,NSH,34,82,26,77,103
67,8474564,Steven Stamkos,C,NSH,34,82,36,66,102
67,8480069,Cale Makar,D,COL,26,82,30,72,102
67,8478864,Kirill Kaprizov,L,MIN,27,82,46,55,101
67,8477939,William Nylander,R,TOR,28,82,43,58,101
67,8480023,Robert Thomas,C,STL,25,82,33,68,101
67,8477933,Sam Reinhart,C,FLA,29,82,43,57,100
67,8471675,Sidney Crosby,C,PIT,37,82,47,52,99
67,8480800,Quinn Hughes,D,VAN,25,82,14,85,99
67,8476468,J.T. Miller,C,VAN,31,82,34,61,95
67,8477942,Kevin Fiala,L,LAK,28,82,32,63,95
67,8480002,Nico Hischier,C,NJD,25,82,30,65,95
67,8477934,Leon Draisaitl,C,EDM,29,82,36,58,94
67,8479407,Jesper Bratt,L,NJD,26,82,35,59,94
67,8476346,Johnny Gaudreau,L,CBJ,31,82,27,67,94
67,8477404,Jake Guentzel,C,TBL,30,82,40,53,93
67,8476887,Filip Forsberg,L,NSH,30,82,35,57,92
67,8479323,Adam Fox,D,NYR,26,82,18,74,92
67,8480027,Jason Robertson,L,DAL,25,82,40,50,90
67,8480012,Elias Pettersson,C,VAN,26,82,36,54,90
67,8475913,Mark Stone,R,VGK,32,82,34,55,89
67,8473419,Brad Marchand,L,BOS,36,82,33,56,89
67,8478445,Mathew Barzal,C,NYI,27,82,23,66,89
67,8477946,Dylan Larkin,C,DET,28,82,43,45,88
67,8478403,Jack Eichel,C,VGK,28,82,42,45,87
67,8475784,Jeff Skinner,C,EDM,32,82,37,50,87
67,8478550,Artemi Panarin,L,NYR,33,82,30,57,87
67,8471685,Anze Kopitar,C,LAK,37,82,25,61,86
67,8475172,Nazem Kadri,C,CGY,34,82,34,51,85
67,8478010,Brayden Point,C,TBL,28,82,45,39,84
67,8479420,Tage Thompson,C,BUF,27,82,43,41,84
67,8481557,Matt Boldy,L,MIN,23,82,38,45,83
67,8478414,Timo Meier,R,NJD,28,82,37,46,83
67,8482116,Tim Stützle,C,OTT,22,82,22,61,83
67,8477402,Pavel Buchnevich,L,STL,29,82,33,48,81
67,8477951,Nick Schmaltz,C,UTA,28,82,31,50,81
67,8475166,John Tavares,C,TOR,34,82,26,55,81
67,8477409,Carter Verhaeghe,C,FLA,29,82,42,38,80
67,8478493,Joel Eriksson Ek,C,MIN,27,82,43,36,79
67,8478444,Brock Boeser,R,VAN,27,82,38,41,79
67,8479337,Alex DeBrincat,R,DET,27,82,37,42,79
67,8477960,Adrian Kempe,R,LAK,28,82,36,43,79
67,8473512,Claude Giroux,R,OTT,36,82,30,49,79
67,8475726,Tyler Toffoli,C,SJS,32,82,47,31,78
67,8477476,Artturi Lehkonen,L,COL,29,82,43,35,78
67,8480801,Brady Tkachuk,L,OTT,25,82,37,41,78
67,8479385,Jordan Kyrou,C,STL,26,82,33,45,78
67,8477501,Valeri Nichushkin,R,COL,29,82,29,49,78
67,8480018,Nick Suzuki,C,MTL,25,82,26,52,78
67,8475692,Mats Zuccarello,R,MIN,37,82,18,60,78
67,8476539,Jonathan Marchessault,R,NSH,34,82,46,31,77
67,8479542,Brandon Hagel,L,TBL,26,82,28,48,76
67,8476462,Dougie Hamilton,D,NJD,31,82,25,51,76
67,8476389,Vincent Trocheck,C,NYR,31,82,27,48,75
67,8481540,Cole Caufield,R,MTL,23,82,42,32,74
67,8480015,Owen Tippett,R,PHI,25,82,34,40,74
67,8480839,Rasmus Dahlin,D,BUF,24,82,23,51,74
67,8476853,Morgan Rielly,D,TOR,30,82,13,61,74
67,8478440,Dylan Strome,C,WSH,27,82,29,44,73
67,8476456,Jonathan Huberdeau,C,CGY,31,82,14,59,73
67,8479343,Clayton Keller,R,UTA,26,82,39,33,72
67,8477955,Jared McCann,L,SEA,28,82,39,33,72
67,8475810,Bryan Rust,R,PIT,32,82,36,36,72
67,8478439,Travis Konecny,R,PHI,27,82,29,43,72
67,8474141,Patrick Kane,R,DET,36,82,27,45,72
67,8480036,Miro Heiskanen,D,DAL,25,82,13,59,72
67,8476399,Blake Coleman,C,CGY,33,82,36,35,71
67,8471215,Evgeni Malkin,C,PIT,38,82,29,42,71
67,8475184,Chris Kreider,L,NYR,33,82,40,30,70
67,8477496,Elias Lindholm,C,BOS,30,82,29,41,70
67,8480014,Gabriel Vilardi,C,WPG,25,82,40,29,69
67,8478856,Conor Garland,R,VAN,28,82,32,37,69
67,8476882,Teuvo Teravainen,L,CHI,30,82,28,41,69
67,8478449,Roope Hintz,C,DAL,28,82,31,37,68
67,8471214,Alex Ovechkin,L,WSH,39,82,30,38,68
67,8476881,Tomas Hertl,C,VGK,31,82,25,43,68
67,8482078,Lucas Raymond,L,DET,22,82,24,44,68
67,8474679,Gustav Nyquist,C,NSH,35,82,17,51,68
67,8482740,Wyatt Johnston,C,DAL,21,82,35,32,67
67,8478873,Troy Terry,R,ANA,27,82,29,38,67
67,8480208,Drake Batherson,R,OTT,26,82,28,39,67
67,8476454,Ryan Nugent-Hopkins,C,EDM,31,82,18,49,67
67,8475798,Mikael Granlund,C,SJS,32,82,15,52,67
67,8478407,Vince Dunn,D,SEA,28,82,14,53,67
67,8476875,Mike Matheson,D,MTL,30,82,13,54,67
67,8475170,Brayden Schenn,C,STL,33,82,30,36,66
67,8480830,Andrei Svechnikov,R,CAR,24,82,28,38,66
67,8478427,Sebastian Aho,C,CAR,27,82,28,38,66
67,8475167,Victor Hedman,D,TBL,34,82,19,47,66
67,8481523,Kirby Dach,C,MTL,23,82,14,52,66
67,8477447,Shea Theodore,D,VGK,29,82,13,53,66
67,8475754,Brock Nelson,C,NYI,33,82,33,32,65
67,8478498,Jake DeBrusk,L,VAN,28,82,26,39,65
67,8477949,Alex Tuch,R,BUF,28,82,24,41,65
67,8476460,Mark Scheifele,C,WPG,31,82,21,44,65
67,8475745,Charlie Coyle,C,BOS,32,82,32,32,64
67,8475168,Matt Duchene,C,DAL,33,82,25,39,64
67,8476905,Chandler Stephenson,C,SEA,30,82,12,52,64
67,8475794,Tyler Seguin,C,DAL,32,82,25,38,63
67,8476479,Phillip Danault,C,LAK,31,82,22,41,63
67,8481711,Matias Maccelli,L,UTA,24,82,21,42,63
67,8474578,Erik Karlsson,D,PIT,34,82,18,45,63
67,8477504,Josh Morrissey,D,WPG,29,82,12,51,63
67,8475786,Zach Hyman,L,EDM,32,82,35,27,62
67,8478055,Gustav Forsling,D,FLA,28,82,21,41,62
67,8478460,Zach Werenski,D,CBJ,27,82,19,43,62
67,8478398,Kyle Connor,L,WPG,28,82,31,30,61
67,8479339,Patrik Laine,L,CBJ,26,82,28,33,61
67,8480220,Noah Cates,L,PHI,25,82,27,34,61
67,8477416,Oliver Bjorkstrand,R,SEA,29,82,25,36,61
67,8476459,Mika Zibanejad,C,NYR,31,82,24,37,61
67,8478047,Michael Bunting,L,PIT,29,82,23,38,61
67,8479345,Jakob Chychrun,D,WSH,26,82,18,43,61
67,8473986,Alex Killorn,L,ANA,35,82,26,34,60
67,8478401,Pavel Zacha,C,BOS,27,82,23,37,60
67,8477986,Brandon Montour,D,SEA,30,82,19,41,60
67,8477503,Max Domi,C,TOR,29,82,16,44,60
67,8480865,Noah Dobson,D,NYI,24,82,12,48,60
67,8483808,Andrei Kuzmenko,L,CGY,28,82,33,26,59
67,8476483,Rickard Rakell,R,PIT,31,82,30,29,59
67,8482093,Seth Jarvis,C,CAR,22,82,27,32,59
67,8482665,Matty Beniers,C,SEA,22,82,27,32,59
67,8482124,Quinton Byfield,R,LAK,22,82,25,34,59
67,8481528,Dylan Cozens,C,BUF,23,82,21,38,59
67,8480078,Filip Chytil,C,NYR,25,82,18,41,59
67,8478469,Thomas Chabot,D,OTT,27,82,17,42,59
67,8478474,Lawson Crouse,L,UTA,27,82,29,29,58
67,8477479,Tyler Bertuzzi,L,CHI,29,82,28,30,58
67,8477500,Bo Horvat,C,NYI,29,82,27,31,58
67,8475791,Taylor Hall,L,CHI,33,82,25,33,58
67,8476448,William Karlsson,C,VGK,31,82,23,35,58
67,8478542,Evan Rodrigues,C,FLA,31,82,21,37,58
67,8475765,Vladimir Tarasenko,R,DET,33,82,20,38,58
67,8479400,Pierre-Luc Dubois,L,WSH,26,82,19,39,58
67,8476432,Boone Jenner,C,CBJ,31,82,40,17,57
67,8478366,Frank Vatrano,R,ANA,30,82,30,27,57
67,8474102,David Perron,L,OTT,36,82,29,28,57
67,8478975,Mason Marchment,L,DAL,29,82,21,36,57
67,8476872,Scott Laughton,C,PHI,30,82,20,37,57
67,8477932,Aaron Ekblad,D,FLA,28,82,17,40,57
67,8481542,Moritz Seider,D,DET,23,82,10,47,57
67,8474563,Drew Doughty,D,LAK,35,82,8,49,57
67,8480064,Josh Norris,C,OTT,25,82,31,25,56
67,8481533,Trevor Zegras,C,ANA,23,82,26,30,56
67,8479425,Filip Hronek,D,VAN,27,82,9,47,56
67,8478519,Anthony Cirelli,C,TBL,27,82,26,29,55
67,8477451,Ryan Hartman,R,MIN,30,82,22,33,55
67,8480797,Joel Farabee,L,PHI,24,82,22,33,55
67,8473994,Jamie Benn,L,DAL,35,82,20,35,55
67,8479410,Mikhail Sergachev,D,UTA,26,82,14,41,55
67,8482684,Luke Hughes,D,NJD,21,82,11,44,55
67,8477495,Seth Jones,D,CHI,30,82,10,45,55
67,8481068,Yegor Sharangovich,C,CGY,26,82,26,28,54
67,8480028,Morgan Frost,C,PHI,25,82,14,40,54
67,8475753,Justin Faulk,D,STL,32,82,14,40,54
67,8480803,Evan Bouchard,D,EDM,25,82,7,47,54
67,8477964,Ivan Barbashev,C,VGK,29,82,24,29,53
67,8474586,Jordan Eberle,R,SEA,34,82,21,32,53
67,8474150,Mikael Backlund,C,CGY,35,82,21,32,53
67,8482667,William Eklund,L,SJS,22,82,21,32,53
67,8482097,Jack Quinn,R,BUF,23,82,17,36,53
67,8478397,Rasmus Andersson,D,CGY,28,82,14,39,53
67,8471724,Kris Letang,D,PIT,37,82,13,40,53
67,8475158,Ryan O'Reilly,C,NSH,33,82,27,25,52
67,8477444,Andre Burakovsky,L,SEA,29,82,26,26,52
67,8478042,Viktor Arvidsson,R,EDM,31,82,25,27,52
67,8477940,Nikolaj Ehlers,L,WPG,28,82,21,31,52
67,8477021,Alex Kerfoot,C,UTA,30,82,18,34,52
67,8477346,MacKenzie Weegar,D,CGY,30,82,10,42,52
67,8475768,Jaden Schwartz,C,SEA,32,82,22,29,51
67,8475191,Reilly Smith,R,NYR,33,82,21,30,51
67,8481596,Shane Pinto,C,OTT,24,82,21,30,51
67,8477935,Sam Bennett,C,FLA,28,82,20,31,51
67,8480188,Fabian Zetterlund,L,SJS,25,82,20,31,51
67,8477456,J.T. Compher,L,DET,29,82,19,32,51
67,8479987,Morgan Geekie,C,BOS,26,82,19,32,51
67,8479999,Casey Mittelstadt,C,COL,26,82,15,36,51
67,8474641,Adam Henrique,C,EDM,34,82,32,18,50
67,8482109,Alexis Lafrenière,L,NYR,23,82,22,28,50
67,8475149,Marcus Johansson,L,MIN,34,82,17,33,50
67,8482149,Cole Perfetti,C,WPG,22,82,16,34,50
67,8478396,Noah Hanifin,D,VGK,27,82,11,39,50
67,8476792,Torey Krug,D,STL,33,82,11,39,50
67,8476906,Shayne Gostisbehere,D,CAR,31,82,8,42,50
67,8479992,Michael Rasmussen,C,DET,25,82,24,25,49
67,8480039,Martin Necas,C,CAR,25,82,21,28,49
67,8476958,Jaccob Slavin,D,CAR,30,82,14,35,49
67,8475799,Nino Niederreiter,R,WPG,32,82,27,21,48
67,8475287,Erik Haula,L,NJD,33,82,27,21,48
67,8480849,Barrett Hayton,C,UTA,24,82,24,24,48
67,8479325,Charlie McAvoy,D,BOS,27,82,11,37,48
67,8470613,Brent Burns,D,CAR,39,82,9,39,48
67,8477407,Anthony Duclair,L,NYI,29,82,24,23,47
67,8482055,Drew O'Connor,L,PIT,26,82,22,25,47
67,8482110,Dawson Mercer,C,NJD,23,82,19,28,47
67,8482113,Anton Lundell,C,FLA,23,82,18,29,47
67,8480829,Jesperi Kotkaniemi,C,CAR,24,82,15,32,47
67,8480434,Sean Durzi,D,UTA,26,82,7,40,47
67,8479675,Trevor Moore,L,LAK,29,82,23,23,46
67,8480798,Philipp Kurashev,C,CHI,25,82,19,27,46
67,8482745,Mason McTavish,C,ANA,21,82,17,29,46
67,8478438,Tommy Novak,C,NSH,27,82,16,30,46
67,8478038,Devon Toews,D,COL,30,82,14,32,46
67,8474716,Jared Spurgeon,D,MIN,35,82,12,34,46
67,8474565,Alex Pietrangelo,D,VGK,34,82,11,35,46
67,8477948,Travis Sanheim,D,PHI,28,82,10,36,46
67,8476923,Damon Severson,D,CBJ,30,82,6,40,46
67,8481560,Arthur Kaliyev,R,LAK,23,82,30,15,45
67,8478233,Andrew Mangiapane,L,WSH,28,82,27,18,45
67,8482159,Tyson Foerster,R,PHI,22,82,27,18,45
67,8479996,Cody Glass,C,NSH,25,82,23,22,45
67,8475714,Calle Jarnkrok,C,TOR,33,82,21,24,45
67,8477998,Warren Foegele,L,LAK,28,82,21,24,45
67,8482671,Owen Power,D,BUF,22,82,13,32,45
67,8471698,T.J. Oshie,R,WSH,38,82,28,16,44
67,8475151,Kyle Palmieri,C,NYI,33,82,23,21,44
67,8475169,Evander Kane,L,EDM,33,82,21,23,44
67,8482699,Dylan Guenther,R,UTA,21,82,14,30,44
67,8475218,Mattias Ekholm,D,EDM,34,82,12,32,44
67,8480871,Adam Boqvist,D,FLA,24,82,9,35,44
67,8477494,Jonathan Drouin,L,COL,29,82,8,36,44
67,8482175,JJ Peterka,R,BUF,22,82,25,18,43
67,8476438,Brandon Saad,L,STL,32,82,22,21,43
67,8480185,Eetu Luostarinen,C,FLA,26,82,21,22,43
67,8473422,Nick Foligno,L,CHI,37,82,21,22,43
67,8476458,Ryan Strome,C,ANA,31,82,19,24,43
67,8478472,Mathieu Joseph,R,STL,27,82,16,27,43
67,8476292,Ondrej Palat,L,NJD,33,82,14,29,43
67,8481581,Thomas Harley,D,DAL,23,82,14,29,43
67,8476869,Brady Skjei,D,NSH,30,82,11,32,43
67,8475171,Oliver Ekman-Larsson,D,TOR,33,82,11,32,43
67,8474590,John Carlson,D,WSH,34,82,9,34,43
67,8475722,Jason Zucker,L,BUF,32,82,24,18,42
67,8482089,Jake Neighbours,L,STL,22,82,24,18,42
67,8479525,Ross Colton,C,COL,28,82,19,23,42
67,8480459,Pius Suter,C,VAN,28,82,15,27,42
67,8476826,Yanni Gourde,C,SEA,33,82,15,27,42
67,8475848,Brendan Gallagher,R,MTL,32,82,24,17,41
67,8476880,Tom Wilson,R,WSH,30,82,17,24,41
67,8478462,Nicolas Roy,C,VGK,27,82,16,25,41
67,8481618,Alex Newhook,C,MTL,23,82,15,26,41
67,8481656,Aliaksei Protas,C,WSH,23,82,15,26,41
67,8482079,Marco Rossi,C,MIN,23,82,22,18,40
67,8478057,Dakota Joshua,C,VAN,28,82,21,19,40
67,8483431,Logan Cooley,C,UTA,20,82,20,20,40
67,8476927,Teddy Blueger,C,VAN,30,82,19,21,40
67,8476921,Jordan Martinook,L,CAR,32,82,18,22,40
67,8481013,Jonatan Berggren,R,DET,24,82,17,23,40
67,8476419,Jean-Gabriel Pageau,C,NYI,32,82,14,26,40
67,8478911,Matt Roy,D,WSH,29,82,13,27,40
67,8474053,Logan Couture,C,SJS,35,82,12,28,40
67,8477497,Sean Monahan,C,CBJ,30,82,11,29,40
67,8475314,Anders Lee,L,NYI,34,82,23,16,39
67,8477511,Anthony Mantha,R,CGY,30,82,18,21,39
67,8481535,Nils Hoglander,L,VAN,24,82,17,22,39
67,8476960,Andreas Athanasiou,C,CHI,30,82,17,22,39
67,8482146,Luke Evangelista,R,NSH,22,82,16,23,39
67,8475763,Kevin Hayes,R,PIT,32,82,15,24,39
67,8477987,Ryan Donato,C,CHI,28,82,15,24,39
67,8479353,Brett Howden,C,VGK,26,82,14,25,39
67,8483515,Juraj Slafkovsky,L,MTL,20,82,11,28,39
67,8480009,Eeli Tolvanen,R,SEA,25,82,22,16,38
67,8474189,Lars Eller,C,PIT,35,82,21,17,38
67,8480893,Kirill Marchenko,R,CBJ,24,82,20,18,38
67,8481032,Paul Cotter,C,NJD,25,82,20,18,38
67,8481553,Bobby Brink,R,PHI,23,82,17,21,38
67,8480813,Joe Veleno,C,DET,24,82,17,21,38
67,8478046,Danton Heinen,L,VAN,29,82,16,22,38
67,8476329,Travis Boyd,C,MIN,31,82,14,24,38
67,8477947,Sonny Milano,L,WSH,28,82,13,25,38
67,8482105,Jake Sanderson,D,OTT,22,82,9,29,38
67,8475760,Nick Bjugstad,C,UTA,32,82,25,12,37
67,8481624,Ilya Mikheyev,R,CHI,30,82,18,19,37
67,8480802,Ryan McLeod,C,BUF,25,82,18,19,37
67,8477953,Kasperi Kapanen,R,STL,28,82,15,22,37
67,8478413,Jordan Greenway,L,BUF,27,82,15,22,37
67,8475220,Marcus Foligno,L,MIN,33,82,15,22,37
67,8480144,David Kampf,C,TOR,29,82,15,22,37
67,8477989,Christian Dvorak,C,MTL,28,82,14,23,37
67,8479976,Juuso Valimaki,D,UTA,26,82,4,33,37
67,8481554,Kaapo Kakko,R,NYR,23,82,21,15,36
67,8473533,Jordan Staal,C,CAR,36,82,20,16,36
67,8480748,Kiefer Sherwood,L,VAN,29,82,19,17,36
67,8482475,Yegor Chinakhov,R,CBJ,23,82,18,18,36
67,8479390,Taylor Raddysh,R,WSH,26,82,16,20,36
67,8477919,Frederick Gaudreau,C,MIN,31,82,11,25,36
67,8475193,Tomas Tatar,L,NJD,34,82,15,20,35
67,8482125,Alexander Holtz,R,VGK,22,82,15,20,35
67,8479293,Brandon Tanev,L,SEA,33,82,15,20,35
67,8477498,Darnell Nurse,D,EDM,29,82,14,21,35
67,8474149,Evgenii Dadonov,R,DAL,35,82,14,21,35
67,8476392,Adam Lowry,C,WPG,31,82,14,21,35
67,8475793,Ryan Johansen,C,PHI,32,82,12,23,35
67,8482092,Ridly Greig,C,OTT,22,82,12,23,35
67,8482624,Daniil Miromanov,D,CGY,27,82,12,23,35
67,8473563,Nicklas Backstrom,C,WSH,37,82,11,24,35
67,8476480,Vladislav Namestnikov,C,WPG,32,82,10,25,35
67,8480789,Oliver Wahlstrom,R,NYI,24,82,10,25,35
67,8477429,Andrew Copp,C,DET,30,82,9,26,35
67,8476979,Erik Gustafsson,D,DET,32,82,6,29,35
67,8478882,Vladislav Gavrikov,D,LAK,29,82,6,29,35
67,8476854,Hampus Lindholm,D,BOS,30,82,4,31,35
67,8478109,Victor Olofsson,L,VGK,29,82,20,14,34
67,8479941,Justin Danforth,R,CBJ,31,82,19,15,34
67,8477426,Nicholas Paul,L,TBL,29,82,17,17,34
67,8474715,Cam Atkinson,R,TBL,35,82,17,17,34
67,8470621,Corey Perry,R,EDM,39,82,16,18,34
67,8478463,Anthony Beauvillier,L,PIT,27,82,8,26,34
67,8481546,Cam York,D,PHI,23,82,7,27,34
67,8475764,Cam Fowler,D,ANA,33,82,4,30,34
67,8477969,Marcus Pettersson,D,PIT,28,82,4,30,34
67,8482245,Artem Zub,D,OTT,29,82,4,30,34
67,8481604,Pavel Dorofeyev,L,VGK,24,82,18,15,33
67,8478020,Michael Amadio,C,OTT,28,82,16,17,33
67,8479365,Trent Frederic,C,BOS,26,82,15,18,33
67,8477952,Robby Fabbri,C,ANA,28,82,14,19,33
67,8484144,Connor Bedard,C,CHI,19,82,14,19,33
67,8476897,Oskar Sundqvist,C,STL,30,82,12,21,33
67,8482660,Kent Johnson,C,CBJ,22,82,10,23,33
67,8481522,Peyton Krebs,C,BUF,23,82,8,25,33
67,8478432,Christian Fischer,R,DET,27,82,8,25,33
67,8481606,Jordan Spence,D,LAK,23,82,7,26,33
67,8481093,Rafael Harvey-Pinard,L,MTL,25,82,20,12,32
67,8476474,Stefan Noesen,R,NJD,31,82,13,19,32
67,8478115,Pierre Engvall,L,NYI,28,82,11,21,32
67,8475343,Nic Dowd,C,WSH,34,82,10,22,32
67,8481481,Blake Lizotte,C,PIT,27,82,6,26,32
67,8478507,John Marino,D,UTA,27,82,4,28,32
67,8482062,Cole Smith,L,NSH,29,82,15,16,31
67,8480448,Parker Kelly,L,COL,25,82,15,16,31
67,8477450,Jason Dickinson,C,CHI,29,82,13,18,31
67,8482705,Cole Sillinger,C,CBJ,21,82,11,20,31
67,8482122,Brock Faber,D,MIN,22,82,5,26,31
67,8479398,Samuel Girard,D,COL,26,82,4,27,31
67,8480873,Rasmus Sandin,D,WSH,24,82,3,28,31
67,8481704,Juuso Parssinen,C,NSH,23,82,17,13,30
67,8476981,Josh Anderson,R,MTL,30,82,16,14,30
67,8481580,Connor McMichael,C,WSH,23,82,16,14,30
67,8480835,Jack Drury,C,CAR,24,82,15,15,30
67,8481517,Brett Leason,R,ANA,25,82,13,17,30
67,8477507,Nikita Zadorov,D,BOS,29,82,12,18,30
67,8478458,Jack Roslovic,C,CAR,27,82,9,21,30
67,8482133,Thomas Bordeleau,C,SJS,22,82,9,21,30
67,8482655,J.J. Moser,D,TBL,24,82,6,24,30
67,8482087,Kaiden Guhle,D,MTL,22,82,6,24,30
67,8475233,David Savard,D,MTL,34,82,6,24,30
67,8476457,Adam Larsson,D,SEA,32,82,5,25,30
67,8481601,Simon Holmstrom,R,NYI,23,82,17,12,29
67,8484166,Adam Fantilli,C,CBJ,20,82,17,12,29
67,8478434,Keegan Kolesar,R,VGK,27,82,13,16,29
67,8476278,Colin Blackwell,C,DAL,31,82,11,18,29
67,8477931,Tomas Nosek,L,FLA,32,82,11,18,29
67,8480145,Neal Pionk,D,WPG,29,82,9,20,29
67,8478133,Jake Evans,C,MTL,28,82,9,20,29
67,8477369,Carson Soucy,D,VAN,30,82,9,20,29
67,8481568,Alex Vlasic,D,CHI,23,82,7,22,29
67,8482807,Ethan Del Mastro,D,CHI,21,82,7,22,29
67,8477365,Connor Clifton,D,BUF,29,82,5,24,29
67,8480246,Nick Perbix,D,TBL,26,82,5,24,29
67,8475181,Nick Leddy,D,STL,33,82,3,26,29
67,8476891,Matt Grzelcyk,D,PIT,30,82,3,26,29
67,8474673,TJ Brodie,D,CHI,34,82,2,27,29
67,8480281,Alexey Toropchenko,R,STL,25,82,19,9,28
67,8475231,Casey Cizikas,C,NYI,33,82,11,17,28
67,8477353,Tyler Motte,C,DET,29,82,11,17,28
67,8482074,Connor Zary,C,CGY,23,82,10,18,28
67,8480068,Ryan Poehling,C,PHI,25,82,9,19,28
67,8477488,Brett Pesce,D,NJD,30,82,8,20,28
67,8479369,Andrew Peeke,D,BOS,26,82,4,24,28
67,8476902,Esa Lindell,D,DAL,30,82,3,25,28
67,8480035,Henri Jokiharju,D,BUF,25,82,3,25,28
67,8479316,Luke Kunin,C,SJS,27,82,17,10,27
67,8476918,Jimmy Vesey,L,NYR,31,82,16,11,27
67,8478891,Mason Appleton,C,WPG,28,82,14,13,27
67,8479591,Michael Eyssimont,C,TBL,28,82,14,13,27
67,8476925,Colton Sissons,C,NSH,31,82,13,14,27
67,8482702,Logan Stankoven,C,DAL,21,82,11,16,27
67,8484203,Bradly Nadeau,L,CAR,19,82,9,18,27
67,8476461,Sean Couturier,C,PHI,32,82,8,19,27
67,8476624,Barclay Goodrow,C,SJS,31,82,8,19,27
67,8480995,Pontus Holmberg,R,TOR,25,82,8,19,27
67,8482142,Jamie Drysdale,D,PHI,22,82,8,19,27
67,8480817,K'Andre Miller,D,NYR,24,82,6,21,27
67,8475324,Nick Jensen,D,OTT,34,82,6,21,27
67,8476931,Jake McCabe,D,TOR,31,82,4,23,27
67,8481582,Nicholas Robertson,L,TOR,23,82,16,10,26
67,8478569,Noel Acciari,C,PIT,33,82,14,12,26
67,8480980,Connor Dewar,C,TOR,25,82,14,12,26
67,8476442,Matt Nieto,L,PIT,32,82,14,12,26
67,8480113,Alex Iafallo,L,WPG,31,82,11,15,26
67,8479368,Max Jones,L,BOS,26,82,10,16,26
67,8476312,Josh Manson,D,COL,33,82,9,17,26
67,8480878,Nils Lundkvist,D,DAL,24,82,7,19,26
67,8477435,Ryan Graves,D,PIT,29,82,5,21,26
67,8480222,Sebastian Aho,D,PIT,28,82,3,23,26
67,8474151,Ryan McDonagh,D,TBL,35,82,2,24,26
67,8479393,Noah Gregor,C,OTT,26,82,19,6,25
67,8477903,Garnet Hathaway,R,PHI,33,82,17,8,25
67,8476858,Phillip Di Giuseppe,L,VAN,31,82,16,9,25
67,8482117,Lukas Reichel,L,CHI,22,82,15,10,25
67,8480003,Jesper Boqvist,C,FLA,26,82,13,12,25
67,8476889,Radek Faksa,C,STL,30,82,12,13,25
67,8477425,Miles Wood,L,COL,29,82,12,13,25
67,8482111,Justin Barron,D,MTL,23,82,8,17,25
67,8480336,Sean Walker,D,CAR,30,82,7,18,25
67,8477506,Ryan Pulock,D,NYI,30,82,7,18,25
67,8476917,Adam Pelech,D,NYI,30,82,6,19,25
67,8478443,Brandon Carlo,D,BOS,28,82,4,21,25
67,8478500,Ivan Provorov,D,CBJ,27,82,3,22,25
67,8480049,Dylan Samberg,D,WPG,25,82,3,22,25
67,8476892,Colton Parayko,D,STL,31,82,2,23,25
67,8480807,Mattias Samuelsson,D,BUF,24,82,2,23,25
67,8480021,Jack Studnicka,C,LAK,25,82,14,10,24
67,8478508,Yakov Trenin,C,MIN,27,82,13,11,24
67,8481477,Nico Sturm,C,SJS,29,82,13,11,24
67,8476469,Joel Armia,R,MTL,31,82,10,14,24
67,8477839,Conor Sheary,L,TBL,32,82,10,14,24
67,8483457,Lane Hutson,D,MTL,20,82,10,14,24
67,8482720,Matthew Knies,L,TOR,22,82,8,16,24
67,8479402,Jake Bean,D,CGY,26,82,7,17,24
67,8479983,Mario Ferraro,D,SJS,26,82,4,20,24
67,8481178,Egor Zamula,D,PHI,24,82,4,20,24
67,8474013,Ian Cole,D,UTA,35,82,4,20,24
67,8483490,Pavel Mintyukov,D,ANA,21,82,3,21,24
67,8480043,Timothy Liljegren,D,TOR,25,82,2,22,24
67,8476463,Jonas Brodin,D,MIN,31,82,2,22,24
67,8481186,Logan O'Connor,R,COL,28,82,11,12,23
67,8482762,Simon Edvinsson,D,DET,21,82,11,12,23
67,8477392,Hudson Fasching,R,NYI,29,82,10,13,23
67,8480074,Alexandre Texier,C,STL,25,82,10,13,23
67,8483482,Tristan Luneau,D,ANA,20,82,7,16,23
67,8481708,Zac Jones,D,NYR,24,82,7,16,23
67,8483505,Matthew Poitras,C,BOS,20,82,6,17,23
67,8479980,Nicolas Hague,D,VGK,26,82,6,17,23
67,8479351,Sam Steel,C,DAL,26,82,5,18,23
67,8475188,Brayden McNabb,D,VGK,33,82,4,19,23
67,8482073,Braden Schneider,D,NYR,23,82,3,20,23
67,8478416,Erik Cernak,D,TBL,27,82,3,20,23
67,8477220,Nate Schmidt,D,FLA,33,82,2,21,23
67,8477845,Trevor van Riemsdyk,D,WSH,33,82,2,21,23
67,8483565,Nick Blankenburg,D,NSH,26,82,2,21,23
67,8480855,Jack McBain,C,UTA,24,82,11,11,22
67,8482858,Ryker Evans,D,SEA,23,82,9,13,22
67,8476885,Jacob Trouba,D,NYR,30,82,8,14,22
67,8476878,Zemgus Girgensons,L,TBL,30,82,8,14,22
67,8477015,Connor Brown,R,EDM,30,82,7,15,22
67,8475279,Ben Chiarot,D,DET,33,82,5,17,22
67,8473507,Jeff Petry,D,DET,37,82,3,19,22
67,8483445,Cutter Gauthier,L,ANA,20,82,3,19,22
67,8478468,Jeremy Lauzon,D,NSH,27,82,3,19,22
67,8478859,Niko Mikkola,D,FLA,28,82,3,19,22
67,8478840,Will Borgen,D,SEA,28,82,3,19,22
67,8474574,Tyler Myers,D,VAN,34,82,1,21,22
67,8482259,Bobby McMann,C,TOR,28,82,13,8,21
67,8476873,Mark Jankowski,C,NSH,30,82,11,10,21
67,8475855,Jesper Fast,R,CAR,33,82,11,10,21
67,8484145,Zach Benson,L,BUF,19,82,10,11,21
67,8482666,Scott Morrow,D,CAR,22,82,10,11,21
67,8473453,Trevor Lewis,C,LAK,37,82,9,12,21
67,8480806,Isac Lundestrom,C,ANA,25,82,8,13,21
67,8478211,Dryden Hunt,L,CGY,29,82,8,13,21
67,8475200,Dmitry Orlov,D,CAR,33,82,7,14,21
67,8477499,Rasmus Ristolainen,D,PHI,30,82,7,14,21
67,8480950,Ilya Lyubushkin,D,DAL,30,82,7,14,21
67,8478178,Darren Raddysh,D,TBL,28,82,6,15,21
67,8477406,Mattias Janmark,C,EDM,32,82,6,15,21
67,8478013,Jake Walman,D,SJS,28,82,5,16,21
67,8479371,Dante Fabbro,D,NSH,26,82,5,16,21
67,8475177,Calvin de Haan,D,COL,33,82,5,16,21
67,8476879,Cody Ceci,D,EDM,31,82,4,17,21
67,8479998,Mikey Anderson,D,LAK,25,82,3,18,21
67,8476467,Jamie Oleksiak,D,SEA,32,82,2,19,21
67,8478399,Jonas Siegenthaler,D,NJD,27,82,1,20,21
67,8479661,Tanner Jeannot,L,LAK,27,82,11,9,20
67,8482077,Dylan Holloway,L,EDM,23,82,11,9,20
67,8479291,Kevin Rooney,C,CGY,31,82,10,10,20
67,8471677,Jack Johnson,D,CBJ,37,82,7,13,20
67,8484153,Leo Carlsson,C,ANA,20,82,6,14,20
67,8480073,Erik Brannstrom,D,COL,25,82,6,14,20
67,8475762,Derek Forbort,D,VAN,32,82,6,14,20
67,8476422,Mike Reilly,D,NYI,31,82,4,16,20
67,8478851,Alexandre Carrier,D,NSH,28,82,3,17,20
67,8476525,Colin Miller,D,WPG,32,82,2,18,20
67,8479414,Nathan Bastian,R,NJD,27,82,10,9,19
67,8477508,Curtis Lazar,C,NJD,29,82,8,11,19
67,8482145,Mavrik Bourque,C,DAL,22,82,8,11,19
67,8483567,Georgii Merkulov,C,BOS,24,82,7,12,19
67,8475455,Brenden Dillon,D,NJD,34,82,5,14,19
67,8482470,Ilya Solovyov,D,CGY,24,82,5,14,19
67,8476374,Sean Kuraly,C,CBJ,31,82,4,15,19
67,8478450,Parker Wotherspoon,D,BOS,27,82,3,16,19
67,8475462,Radko Gudas,D,ANA,34,82,0,19,19
67,8481028,Martin Pospisil,C,CGY,25,82,10,8,18
67,8482733,Logan Mailloux,D,MTL,31,82,9,9,18
67,8480025,MacKenzie Entwistle,R,FLA,25,82,7,11,18
67,8474612,Travis Hamonic,D,OTT,34,82,6,12,18
67,8470600,Ryan Suter,D,STL,39,82,4,14,18
67,8476441,Joel Edmundson,D,LAK,31,82,4,14,18
67,8474567,Zach Bogosian,D,MIN,34,82,4,14,18
67,8483397,Marc McLaughlin,C,BOS,25,82,9,8,17
67,8477505,Alexander Wennberg,C,SJS,30,82,9,8,17
67,8484149,Gavin Brindley,C,CBJ,20,82,8,9,17
67,8482712,Oskar Olausson,R,COL,22,82,7,10,17
67,8481699,Aku Raty,R,UTA,23,82,5,12,17
67,8483493,Frank Nazar,C,CHI,20,82,5,12,17
67,8482809,Jackson Blake,R,CAR,21,82,4,13,17
67,8480860,Kevin Bahl,D,CGY,24,82,4,13,17
67,8480172,Jan Rutta,D,SJS,34,82,4,13,17
67,8474090,Brendan Smith,D,DAL,35,82,4,13,17
67,8475790,Erik Gudbranson,D,CBJ,32,82,2,15,17
67,8475690,Chris Tanev,D,TOR,35,82,2,15,17
67,8476967,Brett Kulak,D,EDM,30,82,1,16,17
67,8476429,Scott Mayfield,D,NYI,32,82,0,17,17
67,8483499,Liam Ohgren,L,MIN,20,82,6,10,16
67,8482713,Mackie Samoskevich,R,FLA,22,82,6,10,16
67,8483489,Fraser Minten,C,TOR,31,82,5,11,16
67,8478136,Jake Middleton,D,MIN,28,82,4,12,16
67,8481567,Henry Thrun,D,SJS,23,82,3,13,16
67,8476331,Dylan DeMelo,D,WPG,31,82,1,15,16
67,8484911,Collin Graf,R,SJS,22,82,7,8,15
67,8482659,Josh Doan,R,UTA,22,82,6,9,15
67,8483763,Maksymilian Szuber,D,UTA,22,82,5,10,15
67,8480834,Ty Emberson,D,SJS,24,82,5,10,15
67,8480796,Martin Fehervary,D,WSH,25,82,5,10,15
67,8483495,Simon Nemec,D,NJD,20,82,5,10,15
67,8482101,Danil Gushchin,L,SJS,22,82,5,10,15
67,8482141,Lukas Cormier,D,VGK,22,82,4,11,15
67,8483012,Logan Morrison,C,SEA,22,82,4,11,15
67,8482166,Shakir Mukhamadullin,D,SJS,22,82,3,12,15
67,8482155,Alex Laferriere,R,LAK,23,82,12,2,14
67,8482749,Joshua Roy,R,MTL,21,82,8,6,14
67,8475718,Justin Holl,D,DET,32,82,6,8,14
67,8479442,Troy Stecher,D,EDM,30,82,5,9,14
67,8480870,Bo Groulx,C,NYR,24,82,5,9,14
67,8479324,Ryan Lindgren,D,NYR,26,82,4,10,14
67,8479359,Beck Malenstyn,L,BUF,26,82,3,11,14
67,8480990,Declan Chisholm,D,MIN,24,82,3,11,14
67,8480879,Jacob Bernard-Docker,D,OTT,24,82,2,12,14
67,8479576,Vincent Desharnais,D,VAN,28,82,1,13,14
67,8476822,Luke Glendening,C,TBL,35,82,12,1,13
67,8483524,Shane Wright,C,SEA,20,82,7,6,13
67,8482516,Matthew Kessel,D,STL,24,82,6,7,13
67,8481524,Bowen Byram,D,BUF,23,82,5,8,13
67,8482679,Matt Coronato,R,CGY,22,82,2,11,13
67,8477335,Kyle Burroughs,D,LAK,29,82,2,11,13
67,8481014,Alexander Romanov,D,NYI,24,82,1,12,13
67,8483460,David Jiricek,D,CBJ,21,82,0,13,13
67,8475842,Sam Carrick,C,NYR,32,82,7,5,12
67,8482070,Mitchell Chaffee,R,TBL,26,82,6,6,12
67,8482803,Olen Zellweger,D,ANA,21,82,5,7,12
67,8482118,Sam Colangelo,R,ANA,23,82,5,7,12
67,8483471,Brad Lambert,C,WPG,31,82,5,7,12
67,8476473,Connor Murphy,D,CHI,31,82,2,10,12
67,8483466,Kevin Korchinski,D,CHI,20,82,1,11,12
67,8483468,Jiri Kulich,C,BUF,20,82,7,4,11
67,8482859,Zack Ostapchuk,C,OTT,21,82,3,8,11
67,8481122,Simon Benoit,D,TOR,26,82,2,9,11
67,8481605,Jackson LaCombe,D,ANA,23,82,2,9,11
67,8479638,Justin Brazeau,R,BOS,26,82,5,5,10
67,8476372,Nick Seeler,D,PHI,31,82,1,9,10
67,8481641,Joel Kiviranta,L,COL,28,82,6,3,9
67,8482153,Brendan Brisson,C,VGK,23,82,3,6,9
67,8477938,Haydn Fleury,D,WPG,28,82,1,7,8
67,8478874,Adam Gaudette,C,OTT,28,82,0,8,8
67,8477034,Jaycob Megna,D,FLA,32,82,1,6,7
67,8482787,Nikita Chibrikov,R,WPG,31,82,3,3,6
67,8474062,Riley Nash,C,NYR,35,82,0,3,3
67,8470794,Joe Pavelski,C,,40,0,0,0,0
67,8481703,Valtteri Puustinen,R,PIT,25,0,0,0,0
67,8477950,Tony DeAngelo,D,,29,0,0,0,0
67,8481577,Philip Tomasino,C,NSH,23,0,0,0,0
67,8475197,Tyson Barrie,D,,33,0,0,0,0
67,8471218,Blake Wheeler,R,,38,0,0,0,0
67,8474157,Max Pacioretty,L,,36,0,0,0,0
67,8478466,Daniel Sprong,R,VAN,27,0,0,0,0
67,8475744,Evgeny Kuznetsov,C,,32,0,0,0,0
67,8481019,David Gustafsson,C,WPG,24,0,0,0,0
67,8475906,John Klingberg,D,,32,0,0,0,0
67,8479348,Kale Clague,D,BUF,26,0,0,0,0
67,8476952,Dominic Toninato,C,WPG,30,0,0,0,0
67,8473473,Milan Lucic,L,,36,0,0,0,0
67,8474037,James van Riemsdyk,L,,35,0,0,0,0
67,8474602,Justin Schultz,D,,34,0,0,0,0
67,8482222,Alexander Barabanov,L,,30,0,0,0,0
67,8479372,Josh Mahura,D,SEA,26,0,0,0,0
67,8479982,Conor Timmins,D,TOR,26,0,0,0,0
67,8474031,Kevin Shattenkirk,D,,35,0,0,0,0
67,8480008,Adam Ruzicka,C,,25,0,0,0,0
67,8481059,Scott Perunovich,D,STL,26,0,0,0,0
67,8480884,Calen Addison,D,,24,0,0,0,0
67,8476994,Vinnie Hinostroza,C,NSH,30,0,0,0,0
67,8478452,Caleb Jones,D,LAK,27,0,0,0,0
67,8480157,Calle Rosen,D,COL,30,0,0,0,0
67,8481609,Vladislav Kolyachonok,D,UTA,23,0,0,0,0
67,8479415,Michael McLeod,C,,26,0,0,0,0
67,8476919,Chris Tierney,C,,30,0,0,0,0
67,8479639,Dylan Coghlan,D,WPG,26,0,0,0,0
67,8478146,Matthew Highmore,C,OTT,28,0,0,0,0
67,8478970,Jalen Chatfield,D,CAR,28,0,0,0,0
67,8480205,Emil Bemstrom,C,PIT,25,0,0,0,0
67,8474884,Mike Hoffman,C,,35,0,0,0,0
67,8471274,Alex Goligoski,D,,39,0,0,0,0
67,8478104,Sammy Blais,L,,28,0,0,0,0
67,8474870,Tyler Johnson,C,,34,0,0,0,0
67,8476913,Devin Shore,C,MIN,30,0,0,0,0
67,8481598,Philip Broberg,D,EDM,23,0,0,0,0
67,8480058,Pierre-Olivier Joseph,D,STL,25,0,0,0,0
67,8480891,Michael Kesselring,D,UTA,24,0,0,0,0
67,8477979,Nicolas Aube-Kubel,R,BUF,28,0,0,0,0
67,8476871,Tanner Pearson,L,,32,0,0,0,0
67,8476393,Nick Cousins,C,,31,0,0,0,0
67,8479977,Kailer Yamamoto,R,,26,0,0,0,0
67,8479543,Michael Pezzetta,L,MTL,26,0,0,0,0
67,8477018,Ben Hutton,D,VGK,31,0,0,0,0
67,8480762,Eric Robinson,L,CAR,29,0,0,0,0
67,8474034,Pat Maroon,L,CHI,36,0,0,0,0
67,8481058,Jesse Ylönen,R,,25,0,0,0,0
67,8475179,Dmitry Kulikov,D,FLA,34,0,0,0,0
67,8481527,Kaedan Korczak,D,VGK,23,0,0,0,0
67,8473449,Kyle Okposo,R,,36,0,0,0,0
67,8482192,Isaak Phillips,D,CHI,23,0,0,0,0
67,8480727,Zach Whitecloud,D,VGK,28,0,0,0,0
67,8479346,Dillon Dube,C,,26,0,0,0,0
67,8480821,Filip Zadina,R,,25,0,0,0,0
67,8480001,Urho Vaakanainen,D,ANA,25,0,0,0,0
67,8470966,Mark Giordano,D,,41,0,0,0,0
67,8480853,Liam Foudy,C,,24,0,0,0,0
67,8475225,Craig Smith,C,CHI,35,0,0,0,0
67,8479972,Mason Shaw,C,WPG,26,0,0,0,0
67,8478451,Ethan Bear,D,WSH,27,0,0,0,0
67,8474040,Sam Gagner,C,,35,0,0,0,0
67,8480196,Jacob Bryson,D,BUF,27,0,0,0,0
67,8479984,Cal Foote,D,,26,0,0,0,0
67,8480011,Klim Kostin,C,SJS,25,0,0,0,0
67,8482176,Wyatt Kaiser,D,CHI,22,0,0,0,0
67,8476988,Matt Benning,D,SJS,30,0,0,0,0
67,8479370,Tyson Jost,C,CAR,26,0,0,0,0
67,8477464,Nic Petan,C,,29,0,0,0,0
67,8477380,Jonny Brodzinski,C,NYR,31,0,0,0,0
67,8480070,Ian Mitchell,D,BOS,25,0,0,0,0
67,8479315,Joey Anderson,R,CHI,26,0,0,0,0
67,8478099,Kevin Labanc,R,,29,0,0,0,0
67,8476874,Olli Maatta,D,DET,30,0,0,0,0
67,8475208,Brian Dumoulin,D,ANA,33,0,0,0,0
67,8478430,Oliver Kylington,D,,27,0,0,0,0
67,8479536,Axel Jonsson-Fjallby,L,WPG,26,0,0,0,0
67,8479671,Mathieu Olivier,R,CBJ,27,0,0,0,0
67,8471709,Marc-Edouard Vlasic,D,SJS,37,0,0,0,0
67,8479328,Julien Gauthier,R,NYI,27,0,0,0,0
67,8478421,A.J. Greer,L,FLA,28,0,0,0,0
67,8477573,Nathan Walker,L,STL,30,0,0,0,0
67,8481537,Nikita Okhotiuk,D,CGY,24,0,0,0,0
67,8474166,Alec Martinez,D,CHI,37,0,0,0,0
67,8470610,Zach Parise,L,,40,0,0,0,0
67,8477478,William Carrier,L,CAR,30,0,0,0,0
67,8479344,Jesse Puljujarvi,R,PIT,26,0,0,0,0
67,8480887,Jordan Harris,D,MTL,24,0,0,0,0
67,8478502,Dennis Gilbert,D,BUF,28,0,0,0,0
67,8482730,Brandt Clarke,D,LAK,21,0,0,0,0
67,8480355,Mark Kastelic,C,BOS,25,0,0,0,0
67,8475750,Jon Merrill,D,MIN,32,0,0,0,0
67,8475164,Jakob Silfverberg,R,,34,0,0,0,0
67,8477944,Jakub Vrana,L,,28,0,0,0,0
67,8479439,Jacob MacDonald,D,COL,31,0,0,0,0
67,8474568,Luke Schenn,D,NSH,35,0,0,0,0
67,8478454,Noah Juulsen,D,VAN,27,0,0,0,0
67,8475752,Tyler Pitlick,C,,33,0,0,0,0
67,8482148,Hendrix Lapierre,C,WSH,22,0,0,0,0
67,8481167,Brayden Pachal,D,CGY,25,0,0,0,0
67,8478043,Sam Lafferty,C,BUF,29,0,0,0,0
67,8479321,Lucas Johansen,D,,27,0,0,0,0
67,8471699,Andrew Cogliano,C,,37,0,0,0,0
67,8481521,Ronnie Attard,D,PHI,25,0,0,0,0
67,8481161,Jake Christiansen,D,CBJ,25,0,0,0,0
67,8479458,Nikita Zaitsev,D,,33,0,0,0,0
67,8479619,Michael Carcone,L,UTA,28,0,0,0,0
67,8479026,Philippe Myers,D,TOR,27,0,0,0,0
67,8477330,Dominik Kubalik,L,,29,0,0,0,0
67,8481617,Vasily Podkolzin,R,VAN,23,0,0,0,0
67,8481701,Santeri Hatakka,D,NJD,23,0,0,0,0
67,8479514,Rem Pitlick,C,,27,0,0,0,0
67,8477446,Michael McCarron,R,NSH,29,0,0,0,0
67,8470604,Jeff Carter,C,,39,0,0,0,0
67,8482241,Radim Zohorna,L,,28,0,0,0,0
67,8480289,Morgan Barron,C,WPG,26,0,0,0,0
67,8479379,Givani Smith,R,SJS,26,0,0,0,0
67,8480216,Jacob Peterson,C,,25,0,0,0,0
67,8477851,Jordan Oesterle,D,BOS,32,0,0,0,0
67,8484258,Sam Malinski,D,COL,26,0,0,0,0
67,8478904,Steven Lorentz,C,,28,0,0,0,0
67,8482095,Tyler Kleven,D,OTT,22,0,0,0,0
67,8480848,Ty Dellandrea,C,SJS,24,0,0,0,0
67,8476884,Derrick Pouliot,D,,30,0,0,0,0
67,8479336,Carl Grundstrom,R,SJS,27,0,0,0,0
67,8482964,Arber Xhekaj,D,MTL,23,0,0,0,0
67,8471686,Marc Staal,D,,37,0,0,0,0
67,8477887,Patrick Brown,C,BOS,32,0,0,0,0
67,8478495,Denis Gurianov,R,,27,0,0,0,0
67,8473504,Cal Clutterbuck,R,,37,0,0,0,0
67,8481550,Adam Beckman,L,NJD,23,0,0,0,0
67,8480845,Rasmus Kupari,C,WPG,24,0,0,0,0
67,8474009,Nick Bonino,C,,36,0,0,0,0
67,8478585,Derek Ryan,C,EDM,38,0,0,0,0
67,8477962,Brendan Lemieux,L,CAR,28,0,0,0,0
67,8482861,Vincent Iorio,D,WSH,22,0,0,0,0
67,8479378,Logan Stanley,D,WPG,26,0,0,0,0
67,8473446,Erik Johnson,D,PHI,36,0,0,0,0
67,8481743,Marc Del Gaizo,D,NSH,25,0,0,0,0
67,8477384,Josh Brown,D,EDM,30,0,0,0,0
67,8482165,Yan Kuznetsov,D,CGY,22,0,0,0,0
67,8478424,Jansen Harkins,C,ANA,27,0,0,0,0
67,8482144,Jack Thompson,D,SJS,22,0,0,0,0
67,8478512,Austin Czarnik,C,,32,0,0,0,0
67,8477527,Ross Johnston,L,ANA,30,0,0,0,0
67,8479383,Boris Katchouk,L,,26,0,0,0,0
67,8482094,Daemon Hunt,D,MIN,22,0,0,0,0
67,8481719,Maxwell Crozier,D,TBL,24,0,0,0,0
67,8480192,Johnathan Kovacevic,D,NJD,27,0,0,0,0
67,8479376,Victor Mete,D,,26,0,0,0,0
67,8482511,Mason Lohrei,D,BOS,23,0,0,0,0
67,8475825,Jani Hakanpää,D,,32,0,0,0,0
67,8478021,William Lagesson,D,DET,28,0,0,0,0
67,8475795,Dylan McIlrath,D,WSH,32,0,0,0,0
67,8477846,Ryan Carpenter,C,,33,0,0,0,0
67,8481056,Spencer Stastney,D,NSH,24,0,0,0,0
67,8481564,Ryan Johnson,D,BUF,23,0,0,0,0
67,8478017,Mark Friedman,D,VAN,29,0,0,0,0
67,8479320,Max Lajoie,D,SEA,27,0,0,0,0
67,8480075,Cameron Crotty,D,MIN,25,0,0,0,0
67,8484287,Cole McWard,D,VAN,23,0,0,0,0
67,8484254,Akito Hirose,D,VAN,25,0,0,0,0
67,8483407,Brandon Scanlin,D,NYR,25,0,0,0,0
67,8480274,Philip Kemp,D,EDM,25,0,0,0,0
67,8479522,Hardy Haman Aktell,D,WSH,26,0,0,0,0
67,8480007,Jonas Rondbjerg,R,VGK,25,0,0,0,0
67,8477454,Adam Erne,L,,29,0,0,0,0
67,8481679,Maxence Guenette,D,OTT,23,0,0,0,0
67,8480441,Trey Fix-Wolansky,R,CBJ,25,0,0,0,0
67,8483546,Marshall Rifai,D,TOR,26,0,0,0,0
67,8480084,Nick DeSimone,D,NJD,30,0,0,0,0
67,8481030,Jack St. Ivany,D,PIT,25,0,0,0,0
67,8481592,Jakob Pelletier,L,CGY,23,0,0,0,0
67,8478011,Louie Belpedio,D,PHI,28,0,0,0,0
67,8477930,Pierre-Edouard Bellemare,L,,39,0,0,0,0
67,8484321,Nikolas Matinpalo,D,OTT,26,0,0,0,0
67,8482067,Connor Mackey,D,NYR,28,0,0,0,0
67,8481806,Louis Crevier,D,CHI,23,0,0,0,0
67,8484326,Patrik Koch,D,UTA,28,0,0,0,0
67,8477971,Andreas Englund,D,LAK,28,0,0,0,0
67,8481751,Lukas Rousek,R,BUF,25,0,0,0,0
67,8481006,Tyler Tucker,D,STL,24,0,0,0,0
67,8476867,Brendan Gaunce,C,MIN,30,0,0,0,0
67,8479520,Brandon Duhaime,R,WSH,27,0,0,0,0
67,8477073,Kurtis MacDermid,L,NJD,30,0,0,0,0
67,8480874,Adam Ginning,D,PHI,24,0,0,0,0
67,8477473,Justin Bailey,R,SJS,29,0,0,0,0
67,8479066,Ryan Lomberg,L,CGY,30,0,0,0,0
67,8477070,Liam O'Brien,C,UTA,30,0,0,0,0
67,8474618,Marco Scandella,D,,34,0,0,0,0
67,8475797,Jarred Tinordi,D,,32,0,0,0,0
67,8481441,Joe Snively,C,DET,28,0,0,0,0
67,8477244,Chad Ruhwedel,D,NYR,34,0,0,0,0
67,8479772,Zack MacEwen,R,OTT,28,0,0,0,0
67,8481147,Reese Johnson,C,MIN,26,0,0,0,0
67,8481043,Cole Koepke,L,BOS,26,0,0,0,0
67,8483619,Filip Roos,D,OTT,25,0,0,0,0
67,8481541,Samuel Bolduc,D,NYI,24,0,0,0,0
67,8477810,Joel Hanley,D,CGY,33,0,0,0,0
67,8476907,Mackenzie MacEachern,L,,30,0,0,0,0
67,8482652,Walker Duehr,R,CGY,27,0,0,0,0
67,8477126,Jayson Megna,C,,34,0,0,0,0
67,8483398,Declan Carlile,D,TBL,31,0,0,0,0
67,8482929,Emil Lilleberg,D,TBL,23,0,0,0,0
67,8480880,Jakub Lauko,C,MIN,24,0,0,0,0
67,8480245,Olle Lycksell,R,PHI,25,0,0,0,0
67,8480252,Cole Guttman,C,CHI,25,0,0,0,0
67,8477467,Gustav Olofsson,D,SEA,30,0,0,0,0
67,8479968,Vinni Lettieri,C,BOS,29,0,0,0,0
67,8478400,Colin White,C,,27,0,0,0,0
67,8475755,Alexander Petrovic,D,DAL,32,0,0,0,0
67,8481812,Nikolai Knyzhov,D,,27,0,0,0,0
67,8481593,Jayden Struble,D,MTL,23,0,0,0,0
67,8481532,Alex Turcotte,C,LAK,23,0,0,0,0
67,8482126,Emil Andrae,D,PHI,31,0,0,0,0
67,8479944,Zach Aston-Reese,C,VGK,30,0,0,0,0
67,8471817,Ryan Reaves,R,TOR,37,0,0,0,0
67,8481206,John Ludvig,D,PIT,24,0,0,0,0
67,8481599,Victor Soderstrom,D,UTA,23,0,0,0,0
67,8480292,Carson Meyer,R,ANA,27,0,0,0,0
67,8482496,Nils Aman,C,VAN,24,0,0,0,0
67,8479718,Alex Barré-Boulet,C,MTL,27,0,0,0,0
67,8479994,Jaret Anderson-Dolan,C,WPG,25,0,0,0,0
67,8480184,Gustav Lindstrom,D,,26,0,0,0,0
67,8480890,Jan Jenik,R,OTT,24,0,0,0,0
67,8478067,Oskar Lindblom,L,,28,0,0,0,0
67,8476934,Brock McGinn,L,ANA,30,0,0,0,0
67,8479985,Cale Fleury,D,SEA,26,0,0,0,0
67,8484304,Uvis Balinskis,D,FLA,28,0,0,0,0
67,8479981,Jonah Gadjovich,L,FLA,26,0,0,0,0
67,8481716,Dmitri Voronkov,L,CBJ,24,0,0,0,0
67,8474709,Matt Martin,L,,35,0,0,0,0
67,8482634,Alex Steeves,C,TOR,25,0,0,0,0
67,8480823,Alexander Alexeyev,D,WSH,25,0,0,0,0
67,8477541,Dakota Mermis,D,TOR,30,0,0,0,0
67,8483491,Ivan Miroshnichenko,L,WSH,20,0,0,0,0
67,8478477,Mitchell Stephens,C,SEA,27,0,0,0,0
67,8481543,Nikita Alexandrov,C,STL,24,0,0,0,0
67,8479423,Alex Nylander,L,,26,0,0,0,0
67,8482451,Mikael Pyyhtia,L,CBJ,23,0,0,0,0
67,8478831,Kevin Stenlund,C,UTA,28,0,0,0,0
67,8480306,Grant Hutton,D,NYI,29,0,0,0,0
67,8478028,Fredrik Olofsson,L,,28,0,0,0,0
67,8477462,Robert Hagg,D,VGK,29,0,0,0,0
67,8477320,Anton Blidh,L,NYR,29,0,0,0,0
67,8482157,Will Cuylle,L,NYR,22,0,0,0,0
67,8482737,Zack Bolduc,C,STL,21,0,0,0,0
67,8481239,Samuel Fagemo,L,,24,0,0,0,0
67,8481600,Tobias Bjornfot,D,FLA,23,0,0,0,0
67,8478409,Anthony Richard,C,PHI,28,0,0,0,0
67,8474145,Robert Bortuzzo,D,,35,0,0,0,0
67,8475958,Michael Sgarbossa,C,WSH,32,0,0,0,0
67,8479986,Kole Lind,R,DAL,26,0,0,0,0
67,8479249,Andrew Poturalski,C,SJS,30,0,0,0,0
67,8479362,Riley Tufte,L,BOS,26,0,0,0,0
67,8479991,Jake Leschyshyn,C,NYR,25,0,0,0,0
67,8479587,Rhett Gardner,C,PHI,28,0,0,0,0
67,8482744,James Malatesta,L,CBJ,21,0,0,0,0
67,8478854,Ryan Shea,D,PIT,27,0,0,0,0
67,8481591,Sam Poulin,R,,23,0,0,0,0
67,8483512,Matt Savoie,C,EDM,20,0,0,0,0
67,8482102,Vasily Ponomarev,C,PIT,22,0,0,0,0
67,8482162,Roby Jarventie,L,EDM,22,0,0,0,0
67,8481016,Ruslan Iskhakov,C,,24,0,0,0,0
67,8482172,Landon Slaggert,L,CHI,22,0,0,0,0
67,8482747,Brennan Othmann,L,NYR,21,0,0,0,0
67,8480031,Maxime Comtois,L,,25,0,0,0,0
67,8480226,Marián Studenic,R,,26,0,0,0,0
67,8478408,Travis Dermott,D,,28,0,0,0,0
67,8481518,Nolan Foote,L,NJD,24,0,0,0,0
67,8479419,Brett Murray,L,BUF,26,0,0,0,0
67,8482088,Justin Sourdif,R,FLA,22,0,0,0,0
67,8482201,Gage Goncalves,C,TBL,23,0,0,0,0
67,8481578,Graeme Clarke,R,MIN,23,0,0,0,0
67,8482177,Marat Khusnutdinov,C,MIN,22,0,0,0,0
67,8481754,Nikita Nesterenko,C,ANA,23,0,0,0,0
67,8483531,Brian Halonen,L,NJD,25,0,0,0,0
67,8483920,Pierrick Dube,R,WSH,23,0,0,0,0
67,8480851,Akil Thomas,C,LAK,24,0,0,0,0
67,8475235,Nicolas Deslauriers,L,PHI,33,0,0,0,0
67,8482476,Emil Heineman,L,MTL,23,0,0,0,0
67,8477149,Scott Sabourin,R,SJS,32,0,0,0,0
67,8483549,Lucas Condotta,L,MTL,27,0,0,0,0
67,8482765,Isak Rosen,R,BUF,21,0,0,0,0
67,8481237,Kyle MacLean,C,NYI,25,0,0,0,0
67,8481024,Linus Karlsson,C,VAN,25,0,0,0,0
67,8481690,Tyler Angle,C,,24,0,0,0,0
67,8483570,Ben Meyers,C,SEA,26,0,0,0,0
67,8481655,Cole Schwindt,R,CGY,23,0,0,0,0
67,8481462,Mason Morelli,L,VGK,28,0,0,0,0
67,8483401,Marc Johnstone,R,PIT,28,0,0,0,0
67,8478956,Samuel Laberge,L,NJD,27,0,0,0,0
67,8479533,Joona Koppanen,L,,26,0,0,0,0
67,8482197,Adam Raska,R,MIN,23,0,0,0,0
67,8482250,Callahan Burke,C,VGK,27,0,0,0,0
67,8482784,Zach Dean,C,STL,21,0,0,0,0
67,8484255,Jason Polin,R,COL,25,0,0,0,0
67,8481077,John Leonard,L,,26,0,0,0,0
67,8481534,Raphael Lavoie,C,EDM,24,0,0,0,0
67,8483609,Adam Klapka,R,CGY,24,0,0,0,0
67,8482751,Ryan Winterton,C,SEA,21,0,0,0,0
67,8480267,Sammy Walker,C,MIN,25,0,0,0,0
67,8475766,Austin Watson,L,,32,0,0,0,0
67,8482460,Matt Rempe,C,NYR,22,0,0,0,0
67,8481065,Angus Crookshank,L,OTT,25,0,0,0,0
67,8481070,Hugh McGing,L,,26,0,0,0,0
67,8476323,Max McCormick,L,SEA,32,0,0,0,0
67,8483395,Arshdeep Bains,L,VAN,23,0,0,0,0
67,8484259,Ondrej Pavel,C,COL,31,0,0,0,0
67,8483432,Luca Del Bel Belluz,C,CBJ,31,0,0,0,0
67,8483045,Cameron Butler,R,CBJ,31,0,0,0,0
67,8482061,Brandon Biro,L,SEA,26,0,0,0,0
67,8477401,John Hayden,C,SEA,29,0,0,0,0
67,8475278,Byron Froese,C,,33,0,0,0,0
67,8478446,Glenn Gawdin,C,LAK,27,0,0,0,0
67,8477993,Justin Kirkland,C,CGY,28,0,0,0,0
67,8482147,Jean-Luc Foudy,C,COL,22,0,0,0,0
67,8480032,Shane Bowers,C,NJD,25,0,0,0,0
67,8479330,Brandon Gignac,C,MTL,27,0,0,0,0
67,8480776,Sheldon Rempal,R,,29,0,0,0,0
67,8475413,Justin Dowling,C,NJD,34,0,0,0,0
67,8481726,Adam Edstrom,C,NYR,24,0,0,0,0
67,8480844,Grigori Denisenko,L,VGK,24,0,0,0,0
67,8478147,Bokondji Imama,L,PIT,28,0,0,0,0
67,8478881,Brett Seney,L,CHI,28,0,0,0,0
67,8483630,Pavol Regenda,L,ANA,25,0,0,0,0
67,8480836,Jonathan Gruden,C,,24,0,0,0,0
67,8484314,Jiri Smejkal,L,,28,0,0,0,0
67,8475780,Chris Wagner,R,COL,33,0,0,0,0
67,8479546,Oskar Steen,C,,26,0,0,0,0
67,8483597,Milos Kelemen,L,UTA,25,0,0,0,0
67,8481789,Tye Kartye,L,SEA,23,0,0,0,0
67,8484325,Waltteri Merela,C,TBL,26,0,0,0,0
67,8479421,Jacob Moverare,D,LAK,26,0,0,0,0
67,8481585,Egor Afanasyev,L,SJS,23,0,0,0,0
67,8479547,Matthew Phillips,R,,26,0,0,0,0
67,8479367,William Lockwood,R,FLA,26,0,0,0,0
67,8476915,Jujhar Khaira,L,,30,0,0,0,0
67,8481422,Jacob Lucchini,C,NSH,29,0,0,0,0
67,8480468,James Hamblin,L,EDM,25,0,0,0,0
67,8478051,Max Willman,C,NJD,29,0,0,0,0
67,8481556,John Beecher,C,BOS,23,0,0,0,0
67,8478078,Rourke Chartier,C,,28,0,0,0,0
68,8478402,Connor McDavid,C,EDM,27,82,39,117,156
68,8477492,Nathan MacKinnon,C,COL,29,82,46,89,135
68,8477934,Leon Draisaitl,C,EDM,29,82,44,87,131
68,8477956,David Pastrnak,R,BOS,28,82,55,63,118
68,8476453,Nikita Kucherov,R,TBL,31,82,34,84,118
68,8480800,Quinn Hughes,D,VAN,25,82,16,100,116
68,8480027,Jason Robertson,L,DAL,25,82,44,71,115
68,8478550,Artemi Panarin,L,NYR,33,82,46,63,109
68,8476468,J.T. Miller,C,VAN,31,82,35,74,109
68,8477939,William Nylander,R,TOR,28,82,52,54,106
68,8481559,Jack Hughes,C,NJD,23,82,42,63,105
68,8479318,Auston Matthews,C,TOR,27,82,54,49,103
68,8477946,Dylan Larkin,C,DET,28,82,53,48,101
68,8478864,Kirill Kaprizov,L,MIN,27,82,49,51,100
68,8471675,Sidney Crosby,C,PIT,37,82,44,56,100
68,8471214,Alex Ovechkin,L,WSH,39,82,43,54,97
68,8480069,Cale Makar,D,COL,26,82,29,68,97
68,8482116,Tim Stützle,C,OTT,22,82,26,70,96
68,8480801,Brady Tkachuk,L,OTT,25,82,39,56,95
68,8480012,Elias Pettersson,C,VAN,26,82,36,59,95
68,8479385,Jordan Kyrou,C,STL,26,82,34,61,95
68,8475172,Nazem Kadri,C,CGY,34,82,33,62,95
68,8477493,Aleksander Barkov,C,FLA,29,82,30,65,95
68,8476887,Filip Forsberg,L,NSH,30,82,47,45,92
68,8478403,Jack Eichel,C,VGK,28,82,43,49,92
68,8480023,Robert Thomas,C,STL,25,82,25,67,92
68,8477404,Jake Guentzel,C,TBL,30,82,45,46,91
68,8478445,Mathew Barzal,C,NYI,27,82,24,67,91
68,8478420,Mikko Rantanen,R,COL,28,82,37,53,90
68,8477933,Sam Reinhart,C,FLA,29,82,49,40,89
68,8477409,Carter Verhaeghe,C,FLA,29,82,41,48,89
68,8474141,Patrick Kane,R,DET,36,82,35,54,89
68,8479314,Matthew Tkachuk,L,FLA,27,82,26,63,89
68,8474600,Roman Josi,D,NSH,34,82,19,69,88
68,8479407,Jesper Bratt,L,NJD,26,82,29,58,87
68,8478427,Sebastian Aho,C,CAR,27,82,36,50,86
68,8481523,Kirby Dach,C,MTL,23,82,17,69,86
68,8478439,Travis Konecny,R,PHI,27,82,35,50,85
68,8477402,Pavel Buchnevich,L,STL,29,82,31,54,85
68,8474564,Steven Stamkos,C,NSH,34,82,34,50,84
68,8477942,Kevin Fiala,L,LAK,28,82,38,45,83
68,8478440,Dylan Strome,C,WSH,27,82,31,52,83
68,8476346,Johnny Gaudreau,L,CBJ,31,82,17,66,83
68,8478398,Kyle Connor,L,WPG,28,82,44,38,82
68,8480036,Miro Heiskanen,D,DAL,25,82,13,68,81
68,8481557,Matt Boldy,L,MIN,23,82,40,40,80
68,8477496,Elias Lindholm,C,BOS,30,82,32,48,80
68,8478873,Troy Terry,R,ANA,27,82,32,48,80
68,8471685,Anze Kopitar,C,LAK,37,82,26,54,80
68,8475913,Mark Stone,R,VGK,32,82,22,57,79
68,8475810,Bryan Rust,R,PIT,32,82,42,36,78
68,8479343,Clayton Keller,R,UTA,26,82,33,45,78
68,8476454,Ryan Nugent-Hopkins,C,EDM,31,82,29,48,77
68,8476459,Mika Zibanejad,C,NYR,31,82,24,53,77
68,8477504,Josh Morrissey,D,WPG,29,82,18,59,77
68,8479323,Adam Fox,D,NYR,26,82,17,60,77
68,8480208,Drake Batherson,R,OTT,26,82,39,37,76
68,8475786,Zach Hyman,L,EDM,32,82,37,39,76
68,8478449,Roope Hintz,C,DAL,28,82,40,35,75
68,8478444,Brock Boeser,R,VAN,27,82,35,40,75
68,8482093,Seth Jarvis,C,CAR,22,82,32,43,75
68,8474578,Erik Karlsson,D,PIT,34,82,16,59,75
68,8475184,Chris Kreider,L,NYR,33,82,46,28,74
68,8477501,Valeri Nichushkin,R,COL,29,82,30,44,74
68,8477951,Nick Schmaltz,C,UTA,28,82,29,45,74
68,8475166,John Tavares,C,TOR,34,82,29,45,74
68,8478401,Pavel Zacha,C,BOS,27,82,32,40,72
68,8478042,Viktor Arvidsson,R,EDM,31,82,32,40,72
68,8476460,Mark Scheifele,C,WPG,31,82,31,41,72
68,8476389,Vincent Trocheck,C,NYR,31,82,30,42,72
68,8478010,Brayden Point,C,TBL,28,82,31,40,71
68,8471215,Evgeni Malkin,C,PIT,38,82,27,44,71
68,8480002,Nico Hischier,C,NJD,25,82,25,46,71
68,8480830,Andrei Svechnikov,R,CAR,24,82,24,47,71
68,8479325,Charlie McAvoy,D,BOS,27,82,17,54,71
68,8480015,Owen Tippett,R,PHI,25,82,35,35,70
68,8476456,Jonathan Huberdeau,C,CGY,31,82,18,52,70
68,8477955,Jared McCann,L,SEA,28,82,35,34,69
68,8475754,Brock Nelson,C,NYI,33,82,38,30,68
68,8477500,Bo Horvat,C,NYI,29,82,37,31,68
68,8480018,Nick Suzuki,C,MTL,25,82,28,40,68
68,8475692,Mats Zuccarello,R,MIN,37,82,23,45,68
68,8479420,Tage Thompson,C,BUF,27,82,36,31,67
68,8475168,Matt Duchene,C,DAL,33,82,27,40,67
68,8477949,Alex Tuch,R,BUF,28,82,22,45,67
68,8476853,Morgan Rielly,D,TOR,30,82,12,55,67
68,8478366,Frank Vatrano,R,ANA,30,82,38,28,66
68,8475784,Jeff Skinner,C,EDM,32,82,35,31,66
68,8477960,Adrian Kempe,R,LAK,28,82,33,33,66
68,8481068,Yegor Sharangovich,C,CGY,26,82,31,35,66
68,8480803,Evan Bouchard,D,EDM,25,82,14,52,66
68,8479400,Pierre-Luc Dubois,L,WSH,26,82,33,32,65
68,8479339,Patrik Laine,L,CBJ,26,82,28,37,65
68,8478460,Zach Werenski,D,CBJ,27,82,19,46,65
68,8480839,Rasmus Dahlin,D,BUF,24,82,12,53,65
68,8474102,David Perron,L,OTT,36,82,31,33,64
68,8476881,Tomas Hertl,C,VGK,31,82,30,34,64
68,8480028,Morgan Frost,C,PHI,25,82,27,37,64
68,8482097,Jack Quinn,R,BUF,23,82,27,37,64
68,8476448,William Karlsson,C,VGK,31,82,25,39,64
68,8478498,Jake DeBrusk,L,VAN,28,82,36,27,63
68,8480797,Joel Farabee,L,PHI,24,82,28,35,63
68,8481711,Matias Maccelli,L,UTA,24,82,22,41,63
68,8483808,Andrei Kuzmenko,L,CGY,28,82,29,33,62
68,8479337,Alex DeBrincat,R,DET,27,82,28,34,62
68,8475726,Tyler Toffoli,C,SJS,32,82,28,34,62
68,8475765,Vladimir Tarasenko,R,DET,33,82,22,40,62
68,8477497,Sean Monahan,C,CBJ,30,82,17,45,62
68,8476539,Jonathan Marchessault,R,NSH,34,82,31,30,61
68,8474150,Mikael Backlund,C,CGY,35,82,30,31,61
68,8482745,Mason McTavish,C,ANA,21,82,30,31,61
68,8478396,Noah Hanifin,D,VGK,27,82,18,43,61
68,8471724,Kris Letang,D,PIT,37,82,14,47,61
68,8480865,Noah Dobson,D,NYI,24,82,13,48,61
68,8478493,Joel Eriksson Ek,C,MIN,27,82,33,27,60
68,8476462,Dougie Hamilton,D,NJD,31,82,16,44,60
68,8475167,Victor Hedman,D,TBL,34,82,12,48,60
68,8481540,Cole Caufield,R,MTL,23,82,36,23,59
68,8480829,Jesperi Kotkaniemi,C,CAR,24,82,31,28,59
68,8476483,Rickard Rakell,R,PIT,31,82,28,31,59
68,8475169,Evander Kane,L,EDM,33,82,27,32,59
68,8475798,Mikael Granlund,C,SJS,32,82,19,40,59
68,8482684,Luke Hughes,D,NJD,21,82,13,46,59
68,8480434,Sean Durzi,D,UTA,26,82,13,46,59
68,8477447,Shea Theodore,D,VGK,29,82,12,47,59
68,8476399,Blake Coleman,C,CGY,33,82,30,28,58
68,8482175,JJ Peterka,R,BUF,22,82,28,30,58
68,8475794,Tyler Seguin,C,DAL,32,82,27,31,58
68,8475158,Ryan O'Reilly,C,NSH,33,82,22,36,58
68,8473512,Claude Giroux,R,OTT,36,82,19,39,58
68,8476905,Chandler Stephenson,C,SEA,30,82,15,43,58
68,8476869,Brady Skjei,D,NSH,30,82,15,43,58
68,8476438,Brandon Saad,L,STL,32,82,40,17,57
68,8481596,Shane Pinto,C,OTT,24,82,24,33,57
68,8473419,Brad Marchand,L,BOS,36,82,23,34,57
68,8473986,Alex Killorn,L,ANA,35,82,22,35,57
68,8478414,Timo Meier,R,NJD,28,82,21,36,57
68,8477940,Nikolaj Ehlers,L,WPG,28,82,21,36,57
68,8477986,Brandon Montour,D,SEA,30,82,14,43,57
68,8474565,Alex Pietrangelo,D,VGK,34,82,10,47,57
68,8482078,Lucas Raymond,L,DET,22,82,23,33,56
68,8475191,Reilly Smith,R,NYR,33,82,23,33,56
68,8477407,Anthony Duclair,L,NYI,29,82,18,38,56
68,8476875,Mike Matheson,D,MTL,30,82,12,44,56
68,8476432,Boone Jenner,C,CBJ,31,82,36,19,55
68,8478438,Tommy Novak,C,NSH,27,82,26,29,55
68,8479525,Ross Colton,C,COL,28,82,25,30,55
68,8473994,Jamie Benn,L,DAL,35,82,24,31,55
68,8479542,Brandon Hagel,L,TBL,26,82,23,32,55
68,8478856,Conor Garland,R,VAN,28,82,21,34,55
68,8477456,J.T. Compher,L,DET,29,82,21,34,55
68,8477953,Kasperi Kapanen,R,STL,28,82,19,36,55
68,8478047,Michael Bunting,L,PIT,29,82,15,40,55
68,8482110,Dawson Mercer,C,NJD,23,82,31,23,54
68,8477476,Artturi Lehkonen,L,COL,29,82,29,25,54
68,8476880,Tom Wilson,R,WSH,30,82,28,26,54
68,8475793,Ryan Johansen,C,PHI,32,82,26,28,54
68,8482740,Wyatt Johnston,C,DAL,21,82,23,31,54
68,8477935,Sam Bennett,C,FLA,28,82,26,27,53
68,8480078,Filip Chytil,C,NYR,25,82,20,33,53
68,8478397,Rasmus Andersson,D,CGY,28,82,15,38,53
68,8474590,John Carlson,D,WSH,34,82,9,44,53
68,8482159,Tyson Foerster,R,PHI,22,82,24,28,52
68,8478474,Lawson Crouse,L,UTA,27,82,23,29,52
68,8479675,Trevor Moore,L,LAK,29,82,23,29,52
68,8478233,Andrew Mangiapane,L,WSH,28,82,16,36,52
68,8481533,Trevor Zegras,C,ANA,23,82,13,39,52
68,8478469,Thomas Chabot,D,OTT,27,82,12,40,52
68,8471698,T.J. Oshie,R,WSH,38,82,29,22,51
68,8474641,Adam Henrique,C,EDM,34,82,20,31,51
68,8478055,Gustav Forsling,D,FLA,28,82,11,40,51
68,8481542,Moritz Seider,D,DET,23,82,11,40,51
68,8481528,Dylan Cozens,C,BUF,23,82,24,26,50
68,8476479,Phillip Danault,C,LAK,31,82,21,29,50
68,8475745,Charlie Coyle,C,BOS,32,82,18,32,50
68,8470613,Brent Burns,D,CAR,39,82,15,35,50
68,8482124,Quinton Byfield,R,LAK,22,82,14,36,50
68,8480188,Fabian Zetterlund,L,SJS,25,82,14,36,50
68,8478458,Jack Roslovic,C,CAR,27,82,12,38,50
68,8478046,Danton Heinen,L,VAN,29,82,28,21,49
68,8475760,Nick Bjugstad,C,UTA,32,82,26,23,49
68,8482055,Drew O'Connor,L,PIT,26,82,24,25,49
68,8480064,Josh Norris,C,OTT,25,82,22,27,49
68,8480798,Philipp Kurashev,C,CHI,25,82,18,31,49
68,8476461,Sean Couturier,C,PHI,32,82,17,32,49
68,8475791,Taylor Hall,L,CHI,33,82,14,35,49
68,8475753,Justin Faulk,D,STL,32,82,14,35,49
68,8480220,Noah Cates,L,PHI,25,82,13,36,49
68,8477495,Seth Jones,D,CHI,30,82,13,36,49
68,8476906,Shayne Gostisbehere,D,CAR,31,82,11,38,49
68,8477503,Max Domi,C,TOR,29,82,9,40,49
68,8479425,Filip Hronek,D,VAN,27,82,8,41,49
68,8480893,Kirill Marchenko,R,CBJ,24,82,32,16,48
68,8478519,Anthony Cirelli,C,TBL,27,82,25,23,48
68,8475799,Nino Niederreiter,R,WPG,32,82,25,23,48
68,8477952,Robby Fabbri,C,ANA,28,82,24,24,48
68,8475287,Erik Haula,L,NJD,33,82,23,25,48
68,8480459,Pius Suter,C,VAN,28,82,23,25,48
68,8482149,Cole Perfetti,C,WPG,22,82,22,26,48
68,8474053,Logan Couture,C,SJS,35,82,22,26,48
68,8476882,Teuvo Teravainen,L,CHI,30,82,19,29,48
68,8479999,Casey Mittelstadt,C,COL,26,82,19,29,48
68,8477451,Ryan Hartman,R,MIN,30,82,16,32,48
68,8474679,Gustav Nyquist,C,NSH,35,82,14,34,48
68,8476872,Scott Laughton,C,PHI,30,82,13,35,48
68,8474563,Drew Doughty,D,LAK,35,82,9,39,48
68,8482109,Alexis Lafrenière,L,NYR,23,82,25,22,47
68,8477964,Ivan Barbashev,C,VGK,29,82,21,26,47
68,8482665,Matty Beniers,C,SEA,22,82,19,28,47
68,8475722,Jason Zucker,L,BUF,32,82,19,28,47
68,8476458,Ryan Strome,C,ANA,31,82,14,33,47
68,8479345,Jakob Chychrun,D,WSH,26,82,13,34,47
68,8477494,Jonathan Drouin,L,COL,29,82,12,35,47
68,8481656,Aliaksei Protas,C,WSH,23,82,11,36,47
68,8477987,Ryan Donato,C,CHI,28,82,23,23,46
68,8482720,Matthew Knies,L,TOR,22,82,22,24,46
68,8480039,Martin Necas,C,CAR,25,82,19,27,46
68,8477416,Oliver Bjorkstrand,R,SEA,29,82,18,28,46
68,8484144,Connor Bedard,C,CHI,19,82,17,29,46
68,8476292,Ondrej Palat,L,NJD,33,82,15,31,46
68,8476792,Torey Krug,D,STL,33,82,12,34,46
68,8478975,Mason Marchment,L,DAL,29,82,18,27,45
68,8473563,Nicklas Backstrom,C,WSH,37,82,18,27,45
68,8481618,Alex Newhook,C,MTL,23,82,17,28,45
68,8478542,Evan Rodrigues,C,FLA,31,82,14,31,45
68,8477021,Alex Kerfoot,C,UTA,30,82,14,31,45
68,8477346,MacKenzie Weegar,D,CGY,30,82,11,34,45
68,8477948,Travis Sanheim,D,PHI,28,82,10,35,45
68,8479410,Mikhail Sergachev,D,UTA,26,82,8,37,45
68,8475764,Cam Fowler,D,ANA,33,82,3,42,45
68,8480068,Ryan Poehling,C,PHI,25,82,28,16,44
68,8478057,Dakota Joshua,C,VAN,28,82,21,23,44
68,8474149,Evgenii Dadonov,R,DAL,35,82,19,25,44
68,8475714,Calle Jarnkrok,C,TOR,33,82,22,21,43
68,8482475,Yegor Chinakhov,R,CBJ,23,82,21,22,43
68,8480835,Jack Drury,C,CAR,24,82,21,22,43
68,8476826,Yanni Gourde,C,SEA,33,82,20,23,43
68,8478472,Mathieu Joseph,R,STL,27,82,15,28,43
68,8478407,Vince Dunn,D,SEA,28,82,14,29,43
68,8480817,K'Andre Miller,D,NYR,24,82,11,32,43
68,8478038,Devon Toews,D,COL,30,82,9,34,43
68,8475171,Oliver Ekman-Larsson,D,TOR,33,82,8,35,43
68,8474586,Jordan Eberle,R,SEA,34,82,22,20,42
68,8480014,Gabriel Vilardi,C,WPG,25,82,20,22,42
68,8475151,Kyle Palmieri,C,NYI,33,82,19,23,42
68,8477498,Darnell Nurse,D,EDM,29,82,19,23,42
68,8475170,Brayden Schenn,C,STL,33,82,18,24,42
68,8473533,Jordan Staal,C,CAR,36,82,18,24,42
68,8478891,Mason Appleton,C,WPG,28,82,15,27,42
68,8477444,Andre Burakovsky,L,SEA,29,82,12,30,42
68,8482125,Alexander Holtz,R,VGK,22,82,21,20,41
68,8481604,Pavel Dorofeyev,L,VGK,24,82,21,20,41
68,8477511,Anthony Mantha,R,CGY,30,82,15,26,41
68,8475200,Dmitry Orlov,D,CAR,33,82,15,26,41
68,8477429,Andrew Copp,C,DET,30,82,14,27,41
68,8475218,Mattias Ekholm,D,EDM,34,82,13,28,41
68,8474716,Jared Spurgeon,D,MIN,35,82,12,29,41
68,8476892,Colton Parayko,D,STL,31,82,10,31,41
68,8476923,Damon Severson,D,CBJ,30,82,6,35,41
68,8475768,Jaden Schwartz,C,SEA,32,82,19,21,40
68,8482699,Dylan Guenther,R,UTA,21,82,18,22,40
68,8477426,Nicholas Paul,L,TBL,29,82,15,25,40
68,8479365,Trent Frederic,C,BOS,26,82,15,25,40
68,8475763,Kevin Hayes,R,PIT,32,82,13,27,40
68,8476927,Teddy Blueger,C,VAN,30,82,12,28,40
68,8481546,Cam York,D,PHI,23,82,5,35,40
68,8478507,John Marino,D,UTA,27,82,4,36,40
68,8482113,Anton Lundell,C,FLA,23,82,24,15,39
68,8476889,Radek Faksa,C,STL,30,82,21,18,39
68,8481032,Paul Cotter,C,NJD,25,82,20,19,39
68,8482117,Lukas Reichel,L,CHI,22,82,18,21,39
68,8480855,Jack McBain,C,UTA,24,82,18,21,39
68,8482146,Luke Evangelista,R,NSH,22,82,15,24,39
68,8473422,Nick Foligno,L,CHI,37,82,13,26,39
68,8482105,Jake Sanderson,D,OTT,22,82,13,26,39
68,8482660,Kent Johnson,C,CBJ,22,82,12,27,39
68,8476480,Vladislav Namestnikov,C,WPG,32,82,11,28,39
68,8477932,Aaron Ekblad,D,FLA,28,82,9,30,39
68,8480145,Neal Pionk,D,WPG,29,82,8,31,39
68,8483515,Juraj Slafkovsky,L,MTL,20,82,17,21,38
68,8481535,Nils Hoglander,L,VAN,24,82,15,23,38
68,8482111,Justin Barron,D,MTL,23,82,13,25,38
68,8479987,Morgan Geekie,C,BOS,26,82,12,26,38
68,8476885,Jacob Trouba,D,NYR,30,82,9,29,38
68,8481581,Thomas Harley,D,DAL,23,82,8,30,38
68,8475314,Anders Lee,L,NYI,34,82,21,16,37
68,8477479,Tyler Bertuzzi,L,CHI,29,82,20,17,37
68,8480849,Barrett Hayton,C,UTA,24,82,16,21,37
68,8481186,Logan O'Connor,R,COL,28,82,16,21,37
68,8476463,Jonas Brodin,D,MIN,31,82,9,28,37
68,8480878,Nils Lundkvist,D,DAL,24,82,8,29,37
68,8480873,Rasmus Sandin,D,WSH,24,82,6,31,37
68,8478500,Ivan Provorov,D,CBJ,27,82,5,32,37
68,8476854,Hampus Lindholm,D,BOS,30,82,3,34,37
68,8476960,Andreas Athanasiou,C,CHI,30,82,19,17,36
68,8481624,Ilya Mikheyev,R,CHI,30,82,18,18,36
68,8481582,Nicholas Robertson,L,TOR,23,82,17,19,36
68,8482705,Cole Sillinger,C,CBJ,21,82,16,20,36
68,8484145,Zach Benson,L,BUF,19,82,16,20,36
68,8479353,Brett Howden,C,VGK,26,82,15,21,36
68,8481560,Arthur Kaliyev,R,LAK,23,82,12,24,36
68,8476419,Jean-Gabriel Pageau,C,NYI,32,82,12,24,36
68,8480185,Eetu Luostarinen,C,FLA,26,82,11,25,36
68,8478911,Matt Roy,D,WSH,29,82,11,25,36
68,8476329,Travis Boyd,C,MIN,31,82,11,25,36
68,8482142,Jamie Drysdale,D,PHI,22,82,6,30,36
68,8476474,Stefan Noesen,R,NJD,31,82,19,16,35
68,8479591,Michael Eyssimont,C,TBL,28,82,18,17,35
68,8476921,Jordan Martinook,L,CAR,32,82,16,19,35
68,8478115,Pierre Engvall,L,NYI,28,82,13,22,35
68,8477998,Warren Foegele,L,LAK,28,82,11,24,35
68,8482245,Artem Zub,D,OTT,29,82,8,27,35
68,8481606,Jordan Spence,D,LAK,23,82,8,27,35
68,8483431,Logan Cooley,C,UTA,20,82,18,16,34
68,8478462,Nicolas Roy,C,VGK,27,82,15,19,34
68,8481013,Jonatan Berggren,R,DET,24,82,15,19,34
68,8482087,Kaiden Guhle,D,MTL,22,82,4,30,34
68,8480748,Kiefer Sherwood,L,VAN,29,82,19,14,33
68,8480009,Eeli Tolvanen,R,SEA,25,82,16,17,33
68,8476392,Adam Lowry,C,WPG,31,82,16,17,33
68,8474189,Lars Eller,C,PIT,35,82,15,18,33
68,8482092,Ridly Greig,C,OTT,22,82,13,20,33
68,8475149,Marcus Johansson,L,MIN,34,82,12,21,33
68,8475193,Tomas Tatar,L,NJD,34,82,11,22,33
68,8476374,Sean Kuraly,C,CBJ,31,82,11,22,33
68,8480871,Adam Boqvist,D,FLA,24,82,10,23,33
68,8477947,Sonny Milano,L,WSH,28,82,9,24,33
68,8480043,Timothy Liljegren,D,TOR,25,82,5,28,33
68,8481178,Egor Zamula,D,PHI,24,82,3,30,33
68,8481580,Connor McMichael,C,WSH,23,82,23,9,32
68,8479390,Taylor Raddysh,R,WSH,26,82,16,16,32
68,8479992,Michael Rasmussen,C,DET,25,82,12,20,32
68,8480074,Alexandre Texier,C,STL,25,82,12,20,32
68,8474574,Tyler Myers,D,VAN,34,82,7,25,32
68,8482671,Owen Power,D,BUF,22,82,5,27,32
68,8477488,Brett Pesce,D,NJD,30,82,4,28,32
68,8477989,Christian Dvorak,C,MTL,28,82,15,16,31
68,8479941,Justin Danforth,R,CBJ,31,82,15,16,31
68,8481481,Blake Lizotte,C,PIT,27,82,10,21,31
68,8476917,Adam Pelech,D,NYI,30,82,10,21,31
68,8481553,Bobby Brink,R,PHI,23,82,9,22,31
68,8481708,Zac Jones,D,NYR,24,82,6,25,31
68,8476979,Erik Gustafsson,D,DET,32,82,3,28,31
68,8476469,Joel Armia,R,MTL,31,82,20,10,30
68,8482259,Bobby McMann,C,TOR,28,82,18,12,30
68,8480813,Joe Veleno,C,DET,24,82,17,13,30
68,8474715,Cam Atkinson,R,TBL,35,82,17,13,30
68,8481704,Juuso Parssinen,C,NSH,23,82,16,14,30
68,8477015,Connor Brown,R,EDM,30,82,16,14,30
68,8478109,Victor Olofsson,L,VGK,29,82,15,15,30
68,8484166,Adam Fantilli,C,CBJ,20,82,14,16,30
68,8480113,Alex Iafallo,L,WPG,31,82,14,16,30
68,8476897,Oskar Sundqvist,C,STL,30,82,9,21,30
68,8477435,Ryan Graves,D,PIT,29,82,7,23,30
68,8479398,Samuel Girard,D,COL,26,82,5,25,30
68,8475181,Nick Leddy,D,STL,33,82,4,26,30
68,8479402,Jake Bean,D,CGY,26,82,2,28,30
68,8479996,Cody Glass,C,NSH,25,82,15,14,29
68,8478432,Christian Fischer,R,DET,27,82,14,15,29
68,8476981,Josh Anderson,R,MTL,30,82,14,15,29
68,8475855,Jesper Fast,R,CAR,33,82,14,15,29
68,8483457,Lane Hutson,D,MTL,20,82,13,16,29
68,8478463,Anthony Beauvillier,L,PIT,27,82,12,17,29
68,8482666,Scott Morrow,D,CAR,22,82,12,17,29
68,8482667,William Eklund,L,SJS,22,82,11,18,29
68,8484153,Leo Carlsson,C,ANA,20,82,10,19,29
68,8482624,Daniil Miromanov,D,CGY,27,82,8,21,29
68,8476525,Colin Miller,D,WPG,32,82,5,24,29
68,8477845,Trevor van Riemsdyk,D,WSH,33,82,4,25,29
68,8476467,Jamie Oleksiak,D,SEA,32,82,3,26,29
68,8478882,Vladislav Gavrikov,D,LAK,29,82,2,27,29
68,8476624,Barclay Goodrow,C,SJS,31,82,12,16,28
68,8477499,Rasmus Ristolainen,D,PHI,30,82,12,16,28
68,8483763,Maksymilian Szuber,D,UTA,22,82,12,16,28
68,8481522,Peyton Krebs,C,BUF,23,82,11,17,28
68,8480003,Jesper Boqvist,C,FLA,26,82,11,17,28
68,8476958,Jaccob Slavin,D,CAR,30,82,2,26,28
68,8479661,Tanner Jeannot,L,LAK,27,82,16,11,27
68,8482074,Connor Zary,C,CGY,23,82,12,15,27
68,8479351,Sam Steel,C,DAL,26,82,11,16,27
68,8475842,Sam Carrick,C,NYR,32,82,11,16,27
68,8475220,Marcus Foligno,L,MIN,33,82,10,17,27
68,8481699,Aku Raty,R,UTA,23,82,8,19,27
68,8482166,Shakir Mukhamadullin,D,SJS,22,82,8,19,27
68,8482803,Olen Zellweger,D,ANA,21,82,7,20,27
68,8478133,Jake Evans,C,MTL,28,82,6,21,27
68,8476331,Dylan DeMelo,D,WPG,31,82,6,21,27
68,8483565,Nick Blankenburg,D,NSH,26,82,5,22,27
68,8478136,Jake Middleton,D,MIN,28,82,5,22,27
68,8477220,Nate Schmidt,D,FLA,33,82,4,23,27
68,8481014,Alexander Romanov,D,NYI,24,82,3,24,27
68,8480035,Henri Jokiharju,D,BUF,25,82,2,25,27
68,8479293,Brandon Tanev,L,SEA,33,82,18,8,26
68,8479393,Noah Gregor,C,OTT,26,82,15,11,26
68,8479368,Max Jones,L,BOS,26,82,13,13,26
68,8478508,Yakov Trenin,C,MIN,27,82,13,13,26
68,8477839,Conor Sheary,L,TBL,32,82,10,16,26
68,8477507,Nikita Zadorov,D,BOS,29,82,9,17,26
68,8476925,Colton Sissons,C,NSH,31,82,9,17,26
68,8480073,Erik Brannstrom,D,COL,25,82,9,17,26
68,8480336,Sean Walker,D,CAR,30,82,8,18,26
68,8476422,Mike Reilly,D,NYI,31,82,8,18,26
68,8476967,Brett Kulak,D,EDM,30,82,6,20,26
68,8482655,J.J. Moser,D,TBL,24,82,5,21,26
68,8474151,Ryan McDonagh,D,TBL,35,82,5,21,26
68,8477969,Marcus Pettersson,D,PIT,28,82,3,23,26
68,8480049,Dylan Samberg,D,WPG,25,82,2,24,26
68,8482089,Jake Neighbours,L,STL,22,82,17,8,25
68,8478211,Dryden Hunt,L,CGY,29,82,15,10,25
68,8481601,Simon Holmstrom,R,NYI,23,82,14,11,25
68,8477392,Hudson Fasching,R,NYI,29,82,14,11,25
68,8477508,Curtis Lazar,C,NJD,29,82,14,11,25
68,8475231,Casey Cizikas,C,NYI,33,82,13,12,25
68,8482079,Marco Rossi,C,MIN,23,82,12,13,25
68,8478413,Jordan Greenway,L,BUF,27,82,12,13,25
68,8481554,Kaapo Kakko,R,NYR,23,82,9,16,25
68,8475848,Brendan Gallagher,R,MTL,32,82,7,18,25
68,8477919,Frederick Gaudreau,C,MIN,31,82,7,18,25
68,8475233,David Savard,D,MTL,34,82,5,20,25
68,8475188,Brayden McNabb,D,VGK,33,82,4,21,25
68,8476879,Cody Ceci,D,EDM,31,82,2,23,25
68,8476918,Jimmy Vesey,L,NYR,31,82,14,10,24
68,8477425,Miles Wood,L,COL,29,82,13,11,24
68,8481477,Nico Sturm,C,SJS,29,82,13,11,24
68,8480448,Parker Kelly,L,COL,25,82,12,12,24
68,8478569,Noel Acciari,C,PIT,33,82,12,12,24
68,8478020,Michael Amadio,C,OTT,28,82,11,13,24
68,8475343,Nic Dowd,C,WSH,34,82,11,13,24
68,8482141,Lukas Cormier,D,VGK,22,82,11,13,24
68,8477903,Garnet Hathaway,R,PHI,33,82,10,14,24
68,8477406,Mattias Janmark,C,EDM,32,82,10,14,24
68,8477931,Tomas Nosek,L,FLA,32,82,9,15,24
68,8480246,Nick Perbix,D,TBL,26,82,7,17,24
68,8476891,Matt Grzelcyk,D,PIT,30,82,7,17,24
68,8482809,Jackson Blake,R,CAR,21,82,5,19,24
68,8479324,Ryan Lindgren,D,NYR,26,82,2,22,24
68,8481568,Alex Vlasic,D,CHI,23,82,1,23,24
68,8479316,Luke Kunin,C,SJS,27,82,14,9,23
68,8483445,Cutter Gauthier,L,ANA,20,82,13,10,23
68,8477353,Tyler Motte,C,DET,29,82,12,11,23
68,8480802,Ryan McLeod,C,BUF,25,82,11,12,23
68,8482702,Logan Stankoven,C,DAL,21,82,8,15,23
68,8480806,Isac Lundestrom,C,ANA,25,82,8,15,23
68,8479976,Juuso Valimaki,D,UTA,26,82,7,16,23
68,8480995,Pontus Holmberg,R,TOR,25,82,7,16,23
68,8478840,Will Borgen,D,SEA,28,82,5,18,23
68,8481028,Martin Pospisil,C,CGY,25,82,5,18,23
68,8476372,Nick Seeler,D,PHI,31,82,5,18,23
68,8482122,Brock Faber,D,MIN,22,82,4,19,23
68,8476902,Esa Lindell,D,DAL,30,82,3,20,23
68,8481605,Jackson LaCombe,D,ANA,23,82,3,20,23
68,8479371,Dante Fabbro,D,NSH,26,82,1,22,23
68,8476278,Colin Blackwell,C,DAL,31,82,13,9,22
68,8477450,Jason Dickinson,C,CHI,29,82,12,10,22
68,8480021,Jack Studnicka,C,LAK,25,82,8,14,22
68,8478468,Jeremy Lauzon,D,NSH,27,82,8,14,22
68,8476873,Mark Jankowski,C,NSH,30,82,8,14,22
68,8476931,Jake McCabe,D,TOR,31,82,5,17,22
68,8479980,Nicolas Hague,D,VGK,26,82,4,18,22
68,8474673,TJ Brodie,D,CHI,34,82,1,21,22
68,8481093,Rafael Harvey-Pinard,L,MTL,25,82,14,7,21
68,8476312,Josh Manson,D,COL,33,82,11,10,21
68,8480025,MacKenzie Entwistle,R,FLA,25,82,10,11,21
68,8479359,Beck Malenstyn,L,BUF,26,82,8,13,21
68,8480789,Oliver Wahlstrom,R,NYI,24,82,6,15,21
68,8477506,Ryan Pulock,D,NYI,30,82,1,20,21
68,8482062,Cole Smith,L,NSH,29,82,12,8,20
68,8478434,Keegan Kolesar,R,VGK,27,82,9,11,20
68,8481517,Brett Leason,R,ANA,25,82,6,14,20
68,8482153,Brendan Brisson,C,VGK,23,82,6,14,20
68,8479983,Mario Ferraro,D,SJS,26,82,5,15,20
68,8470621,Corey Perry,R,EDM,39,82,4,16,20
68,8480860,Kevin Bahl,D,CGY,24,82,3,17,20
68,8482133,Thomas Bordeleau,C,SJS,22,82,7,12,19
68,8475177,Calvin de Haan,D,COL,33,82,6,13,19
68,8484203,Bradly Nadeau,L,CAR,19,82,5,14,19
68,8482762,Simon Edvinsson,D,DET,21,82,4,15,19
68,8478851,Alexandre Carrier,D,NSH,28,82,4,15,19
68,8478399,Jonas Siegenthaler,D,NJD,27,82,3,16,19
68,8475462,Radko Gudas,D,ANA,34,82,3,16,19
68,8475279,Ben Chiarot,D,DET,33,82,2,17,19
68,8473507,Jeff Petry,D,DET,37,82,2,17,19
68,8482077,Dylan Holloway,L,EDM,23,82,13,5,18
68,8482155,Alex Laferriere,R,LAK,23,82,13,5,18
68,8480870,Bo Groulx,C,NYR,24,82,10,8,18
68,8483490,Pavel Mintyukov,D,ANA,21,82,9,9,18
68,8482712,Oskar Olausson,R,COL,22,82,8,10,18
68,8476442,Matt Nieto,L,PIT,32,82,6,12,18
68,8483482,Tristan Luneau,D,ANA,20,82,6,12,18
68,8476457,Adam Larsson,D,SEA,32,82,4,14,18
68,8479369,Andrew Peeke,D,BOS,26,82,4,14,18
68,8480807,Mattias Samuelsson,D,BUF,24,82,4,14,18
68,8475790,Erik Gudbranson,D,CBJ,32,82,4,14,18
68,8483499,Liam Ohgren,L,MIN,20,82,4,14,18
68,8476473,Connor Murphy,D,CHI,31,82,3,15,18
68,8482807,Ethan Del Mastro,D,CHI,21,82,2,16,18
68,8475324,Nick Jensen,D,OTT,34,82,2,16,18
68,8482073,Braden Schneider,D,NYR,23,82,2,16,18
68,8480172,Jan Rutta,D,SJS,34,82,1,17,18
68,8482118,Sam Colangelo,R,ANA,23,82,1,17,18
68,8476878,Zemgus Girgensons,L,TBL,30,82,10,7,17
68,8473453,Trevor Lewis,C,LAK,37,82,10,7,17
68,8483397,Marc McLaughlin,C,BOS,25,82,10,7,17
68,8476858,Phillip Di Giuseppe,L,VAN,31,82,9,8,17
68,8482858,Ryker Evans,D,SEA,23,82,7,10,17
68,8470600,Ryan Suter,D,STL,39,82,7,10,17
68,8481524,Bowen Byram,D,BUF,23,82,7,10,17
68,8483495,Simon Nemec,D,NJD,20,82,6,11,17
68,8478450,Parker Wotherspoon,D,BOS,27,82,5,12,17
68,8482101,Danil Gushchin,L,SJS,22,82,5,12,17
68,8480222,Sebastian Aho,D,PIT,28,82,3,14,17
68,8475762,Derek Forbort,D,VAN,32,82,3,14,17
68,8476429,Scott Mayfield,D,NYI,32,82,2,15,17
68,8480281,Alexey Toropchenko,R,STL,25,82,12,4,16
68,8478013,Jake Walman,D,SJS,28,82,10,6,16
68,8482659,Josh Doan,R,UTA,22,82,8,8,16
68,8482679,Matt Coronato,R,CGY,22,82,8,8,16
68,8483524,Shane Wright,C,SEA,20,82,7,9,16
68,8483468,Jiri Kulich,C,BUF,20,82,6,10,16
68,8475455,Brenden Dillon,D,NJD,34,82,5,11,16
68,8477505,Alexander Wennberg,C,SJS,30,82,5,11,16
68,8482516,Matthew Kessel,D,STL,24,82,4,12,16
68,8481122,Simon Benoit,D,TOR,26,82,4,12,16
68,8482733,Logan Mailloux,D,MTL,31,82,3,13,16
68,8480796,Martin Fehervary,D,WSH,25,82,3,13,16
68,8480879,Jacob Bernard-Docker,D,OTT,24,82,3,13,16
68,8481567,Henry Thrun,D,SJS,23,82,2,14,16
68,8474567,Zach Bogosian,D,MIN,34,82,1,15,16
68,8475690,Chris Tanev,D,TOR,35,82,1,15,16
68,8479291,Kevin Rooney,C,CGY,31,82,8,7,15
68,8483505,Matthew Poitras,C,BOS,20,82,6,9,15
68,8481641,Joel Kiviranta,L,COL,28,82,6,9,15
68,8480144,David Kampf,C,TOR,29,82,5,10,15
68,8482470,Ilya Solovyov,D,CGY,24,82,5,10,15
68,8482859,Zack Ostapchuk,C,OTT,21,82,5,10,15
68,8475718,Justin Holl,D,DET,32,82,4,11,15
68,8477938,Haydn Fleury,D,WPG,28,82,4,11,15
68,8477365,Connor Clifton,D,BUF,29,82,3,12,15
68,8478178,Darren Raddysh,D,TBL,28,82,3,12,15
68,8480990,Declan Chisholm,D,MIN,24,82,3,12,15
68,8477034,Jaycob Megna,D,FLA,32,82,3,12,15
68,8484149,Gavin Brindley,C,CBJ,20,82,2,13,15
68,8484911,Collin Graf,R,SJS,22,82,10,4,14
68,8482145,Mavrik Bourque,C,DAL,22,82,7,7,14
68,8477369,Carson Soucy,D,VAN,30,82,6,8,14
68,8480980,Connor Dewar,C,TOR,25,82,4,10,14
68,8478443,Brandon Carlo,D,BOS,28,82,4,10,14
68,8479442,Troy Stecher,D,EDM,30,82,4,10,14
68,8478859,Niko Mikkola,D,FLA,28,82,3,11,14
68,8483460,David Jiricek,D,CBJ,21,82,3,11,14
68,8479998,Mikey Anderson,D,LAK,25,82,2,12,14
68,8483493,Frank Nazar,C,CHI,20,82,8,5,13
68,8479414,Nathan Bastian,R,NJD,27,82,4,9,13
68,8479576,Vincent Desharnais,D,VAN,28,82,4,9,13
68,8483012,Logan Morrison,C,SEA,22,82,3,10,13
68,8478416,Erik Cernak,D,TBL,27,82,1,12,13
68,8480834,Ty Emberson,D,SJS,24,82,1,12,13
68,8474612,Travis Hamonic,D,OTT,34,82,2,10,12
68,8482713,Mackie Samoskevich,R,FLA,22,82,6,5,11
68,8476822,Luke Glendening,C,TBL,35,82,6,5,11
68,8482787,Nikita Chibrikov,R,WPG,31,82,6,5,11
68,8483567,Georgii Merkulov,C,BOS,24,82,4,7,11
68,8483489,Fraser Minten,C,TOR,31,82,4,7,11
68,8483466,Kevin Korchinski,D,CHI,20,82,4,7,11
68,8482749,Joshua Roy,R,MTL,21,82,3,8,11
68,8474013,Ian Cole,D,UTA,35,82,2,9,11
68,8476441,Joel Edmundson,D,LAK,31,82,2,9,11
68,8474090,Brendan Smith,D,DAL,35,82,2,9,11
68,8483471,Brad Lambert,C,WPG,31,82,2,9,11
68,8479638,Justin Brazeau,R,BOS,26,82,7,3,10
68,8480950,Ilya Lyubushkin,D,DAL,30,82,3,6,9
68,8477335,Kyle Burroughs,D,LAK,29,82,3,6,9
68,8482070,Mitchell Chaffee,R,TBL,26,82,3,5,8
68,8478874,Adam Gaudette,C,OTT,28,82,0,7,7
68,8471677,Jack Johnson,D,CBJ,37,82,2,4,6
68,8474062,Riley Nash,C,NYR,35,82,1,5,6
68,8470794,Joe Pavelski,C,,40,0,0,0,0
68,8481703,Valtteri Puustinen,R,PIT,25,0,0,0,0
68,8477950,Tony DeAngelo,D,,29,0,0,0,0
68,8481577,Philip Tomasino,C,NSH,23,0,0,0,0
68,8475197,Tyson Barrie,D,,33,0,0,0,0
68,8471218,Blake Wheeler,R,,38,0,0,0,0
68,8474157,Max Pacioretty,L,,36,0,0,0,0
68,8478466,Daniel Sprong,R,VAN,27,0,0,0,0
68,8475744,Evgeny Kuznetsov,C,,32,0,0,0,0
68,8481019,David Gustafsson,C,WPG,24,0,0,0,0
68,8475906,John Klingberg,D,,32,0,0,0,0
68,8479348,Kale Clague,D,BUF,26,0,0,0,0
68,8476952,Dominic Toninato,C,WPG,30,0,0,0,0
68,8473473,Milan Lucic,L,,36,0,0,0,0
68,8474037,James van Riemsdyk,L,,35,0,0,0,0
68,8474602,Justin Schultz,D,,34,0,0,0,0
68,8482222,Alexander Barabanov,L,,30,0,0,0,0
68,8479372,Josh Mahura,D,SEA,26,0,0,0,0
68,8479982,Conor Timmins,D,TOR,26,0,0,0,0
68,8474031,Kevin Shattenkirk,D,,35,0,0,0,0
68,8480008,Adam Ruzicka,C,,25,0,0,0,0
68,8481059,Scott Perunovich,D,STL,26,0,0,0,0
68,8480884,Calen Addison,D,,24,0,0,0,0
68,8476994,Vinnie Hinostroza,C,NSH,30,0,0,0,0
68,8478452,Caleb Jones,D,LAK,27,0,0,0,0
68,8480157,Calle Rosen,D,COL,30,0,0,0,0
68,8481609,Vladislav Kolyachonok,D,UTA,23,0,0,0,0
68,8479415,Michael McLeod,C,,26,0,0,0,0
68,8476919,Chris Tierney,C,,30,0,0,0,0
68,8479639,Dylan Coghlan,D,WPG,26,0,0,0,0
68,8478146,Matthew Highmore,C,OTT,28,0,0,0,0
68,8478970,Jalen Chatfield,D,CAR,28,0,0,0,0
68,8480205,Emil Bemstrom,C,PIT,25,0,0,0,0
68,8474884,Mike Hoffman,C,,35,0,0,0,0
68,8471274,Alex Goligoski,D,,39,0,0,0,0
68,8478104,Sammy Blais,L,,28,0,0,0,0
68,8474870,Tyler Johnson,C,,34,0,0,0,0
68,8476913,Devin Shore,C,MIN,30,0,0,0,0
68,8481598,Philip Broberg,D,EDM,23,0,0,0,0
68,8480058,Pierre-Olivier Joseph,D,STL,25,0,0,0,0
68,8480891,Michael Kesselring,D,UTA,24,0,0,0,0
68,8477979,Nicolas Aube-Kubel,R,BUF,28,0,0,0,0
68,8476871,Tanner Pearson,L,,32,0,0,0,0
68,8476393,Nick Cousins,C,,31,0,0,0,0
68,8479977,Kailer Yamamoto,R,,26,0,0,0,0
68,8479543,Michael Pezzetta,L,MTL,26,0,0,0,0
68,8477018,Ben Hutton,D,VGK,31,0,0,0,0
68,8480762,Eric Robinson,L,CAR,29,0,0,0,0
68,8474034,Pat Maroon,L,CHI,36,0,0,0,0
68,8481058,Jesse Ylönen,R,,25,0,0,0,0
68,8475179,Dmitry Kulikov,D,FLA,34,0,0,0,0
68,8481527,Kaedan Korczak,D,VGK,23,0,0,0,0
68,8473449,Kyle Okposo,R,,36,0,0,0,0
68,8482192,Isaak Phillips,D,CHI,23,0,0,0,0
68,8480727,Zach Whitecloud,D,VGK,28,0,0,0,0
68,8479346,Dillon Dube,C,,26,0,0,0,0
68,8480821,Filip Zadina,R,,25,0,0,0,0
68,8480001,Urho Vaakanainen,D,ANA,25,0,0,0,0
68,8470966,Mark Giordano,D,,41,0,0,0,0
68,8480853,Liam Foudy,C,,24,0,0,0,0
68,8475225,Craig Smith,C,CHI,35,0,0,0,0
68,8479972,Mason Shaw,C,WPG,26,0,0,0,0
68,8478451,Ethan Bear,D,WSH,27,0,0,0,0
68,8474040,Sam Gagner,C,,35,0,0,0,0
68,8480196,Jacob Bryson,D,BUF,27,0,0,0,0
68,8479984,Cal Foote,D,,26,0,0,0,0
68,8480011,Klim Kostin,C,SJS,25,0,0,0,0
68,8482176,Wyatt Kaiser,D,CHI,22,0,0,0,0
68,8476988,Matt Benning,D,SJS,30,0,0,0,0
68,8479370,Tyson Jost,C,CAR,26,0,0,0,0
68,8477464,Nic Petan,C,,29,0,0,0,0
68,8477380,Jonny Brodzinski,C,NYR,31,0,0,0,0
68,8480070,Ian Mitchell,D,BOS,25,0,0,0,0
68,8479315,Joey Anderson,R,CHI,26,0,0,0,0
68,8478099,Kevin Labanc,R,,29,0,0,0,0
68,8476874,Olli Maatta,D,DET,30,0,0,0,0
68,8475208,Brian Dumoulin,D,ANA,33,0,0,0,0
68,8478430,Oliver Kylington,D,,27,0,0,0,0
68,8479536,Axel Jonsson-Fjallby,L,WPG,26,0,0,0,0
68,8479671,Mathieu Olivier,R,CBJ,27,0,0,0,0
68,8471709,Marc-Edouard Vlasic,D,SJS,37,0,0,0,0
68,8479328,Julien Gauthier,R,NYI,27,0,0,0,0
68,8478421,A.J. Greer,L,FLA,28,0,0,0,0
68,8477573,Nathan Walker,L,STL,30,0,0,0,0
68,8481537,Nikita Okhotiuk,D,CGY,24,0,0,0,0
68,8474166,Alec Martinez,D,CHI,37,0,0,0,0
68,8470610,Zach Parise,L,,40,0,0,0,0
68,8477478,William Carrier,L,CAR,30,0,0,0,0
68,8479344,Jesse Puljujarvi,R,PIT,26,0,0,0,0
68,8480887,Jordan Harris,D,MTL,24,0,0,0,0
68,8478502,Dennis Gilbert,D,BUF,28,0,0,0,0
68,8482730,Brandt Clarke,D,LAK,21,0,0,0,0
68,8480355,Mark Kastelic,C,BOS,25,0,0,0,0
68,8475750,Jon Merrill,D,MIN,32,0,0,0,0
68,8475164,Jakob Silfverberg,R,,34,0,0,0,0
68,8477944,Jakub Vrana,L,,28,0,0,0,0
68,8479439,Jacob MacDonald,D,COL,31,0,0,0,0
68,8474568,Luke Schenn,D,NSH,35,0,0,0,0
68,8478454,Noah Juulsen,D,VAN,27,0,0,0,0
68,8475752,Tyler Pitlick,C,,33,0,0,0,0
68,8482148,Hendrix Lapierre,C,WSH,22,0,0,0,0
68,8481167,Brayden Pachal,D,CGY,25,0,0,0,0
68,8478043,Sam Lafferty,C,BUF,29,0,0,0,0
68,8479321,Lucas Johansen,D,,27,0,0,0,0
68,8471699,Andrew Cogliano,C,,37,0,0,0,0
68,8481521,Ronnie Attard,D,PHI,25,0,0,0,0
68,8481161,Jake Christiansen,D,CBJ,25,0,0,0,0
68,8479458,Nikita Zaitsev,D,,33,0,0,0,0
68,8479619,Michael Carcone,L,UTA,28,0,0,0,0
68,8479026,Philippe Myers,D,TOR,27,0,0,0,0
68,8477330,Dominik Kubalik,L,,29,0,0,0,0
68,8481617,Vasily Podkolzin,R,VAN,23,0,0,0,0
68,8481701,Santeri Hatakka,D,NJD,23,0,0,0,0
68,8479514,Rem Pitlick,C,,27,0,0,0,0
68,8477446,Michael McCarron,R,NSH,29,0,0,0,0
68,8470604,Jeff Carter,C,,39,0,0,0,0
68,8482241,Radim Zohorna,L,,28,0,0,0,0
68,8480289,Morgan Barron,C,WPG,26,0,0,0,0
68,8479379,Givani Smith,R,SJS,26,0,0,0,0
68,8480216,Jacob Peterson,C,,25,0,0,0,0
68,8477851,Jordan Oesterle,D,BOS,32,0,0,0,0
68,8484258,Sam Malinski,D,COL,26,0,0,0,0
68,8478904,Steven Lorentz,C,,28,0,0,0,0
68,8482095,Tyler Kleven,D,OTT,22,0,0,0,0
68,8480848,Ty Dellandrea,C,SJS,24,0,0,0,0
68,8476884,Derrick Pouliot,D,,30,0,0,0,0
68,8479336,Carl Grundstrom,R,SJS,27,0,0,0,0
68,8482964,Arber Xhekaj,D,MTL,23,0,0,0,0
68,8471686,Marc Staal,D,,37,0,0,0,0
68,8477887,Patrick Brown,C,BOS,32,0,0,0,0
68,8478495,Denis Gurianov,R,,27,0,0,0,0
68,8473504,Cal Clutterbuck,R,,37,0,0,0,0
68,8481550,Adam Beckman,L,NJD,23,0,0,0,0
68,8480845,Rasmus Kupari,C,WPG,24,0,0,0,0
68,8474009,Nick Bonino,C,,36,0,0,0,0
68,8478585,Derek Ryan,C,EDM,38,0,0,0,0
68,8477962,Brendan Lemieux,L,CAR,28,0,0,0,0
68,8482861,Vincent Iorio,D,WSH,22,0,0,0,0
68,8479378,Logan Stanley,D,WPG,26,0,0,0,0
68,8473446,Erik Johnson,D,PHI,36,0,0,0,0
68,8481743,Marc Del Gaizo,D,NSH,25,0,0,0,0
68,8477384,Josh Brown,D,EDM,30,0,0,0,0
68,8482165,Yan Kuznetsov,D,CGY,22,0,0,0,0
68,8478424,Jansen Harkins,C,ANA,27,0,0,0,0
68,8482144,Jack Thompson,D,SJS,22,0,0,0,0
68,8478512,Austin Czarnik,C,,32,0,0,0,0
68,8477527,Ross Johnston,L,ANA,30,0,0,0,0
68,8479383,Boris Katchouk,L,,26,0,0,0,0
68,8482094,Daemon Hunt,D,MIN,22,0,0,0,0
68,8481719,Maxwell Crozier,D,TBL,24,0,0,0,0
68,8480192,Johnathan Kovacevic,D,NJD,27,0,0,0,0
68,8479376,Victor Mete,D,,26,0,0,0,0
68,8482511,Mason Lohrei,D,BOS,23,0,0,0,0
68,8475825,Jani Hakanpää,D,,32,0,0,0,0
68,8478021,William Lagesson,D,DET,28,0,0,0,0
68,8475795,Dylan McIlrath,D,WSH,32,0,0,0,0
68,8477846,Ryan Carpenter,C,,33,0,0,0,0
68,8481056,Spencer Stastney,D,NSH,24,0,0,0,0
68,8481564,Ryan Johnson,D,BUF,23,0,0,0,0
68,8478017,Mark Friedman,D,VAN,29,0,0,0,0
68,8479320,Max Lajoie,D,SEA,27,0,0,0,0
68,8480075,Cameron Crotty,D,MIN,25,0,0,0,0
68,8484287,Cole McWard,D,VAN,23,0,0,0,0
68,8484254,Akito Hirose,D,VAN,25,0,0,0,0
68,8483407,Brandon Scanlin,D,NYR,25,0,0,0,0
68,8480274,Philip Kemp,D,EDM,25,0,0,0,0
68,8479522,Hardy Haman Aktell,D,WSH,26,0,0,0,0
68,8480007,Jonas Rondbjerg,R,VGK,25,0,0,0,0
68,8477454,Adam Erne,L,,29,0,0,0,0
68,8481679,Maxence Guenette,D,OTT,23,0,0,0,0
68,8480441,Trey Fix-Wolansky,R,CBJ,25,0,0,0,0
68,8483546,Marshall Rifai,D,TOR,26,0,0,0,0
68,8480084,Nick DeSimone,D,NJD,30,0,0,0,0
68,8481030,Jack St. Ivany,D,PIT,25,0,0,0,0
68,8481592,Jakob Pelletier,L,CGY,23,0,0,0,0
68,8478011,Louie Belpedio,D,PHI,28,0,0,0,0
68,8477930,Pierre-Edouard Bellemare,L,,39,0,0,0,0
68,8484321,Nikolas Matinpalo,D,OTT,26,0,0,0,0
68,8482067,Connor Mackey,D,NYR,28,0,0,0,0
68,8481806,Louis Crevier,D,CHI,23,0,0,0,0
68,8484326,Patrik Koch,D,UTA,28,0,0,0,0
68,8477971,Andreas Englund,D,LAK,28,0,0,0,0
68,8481751,Lukas Rousek,R,BUF,25,0,0,0,0
68,8481006,Tyler Tucker,D,STL,24,0,0,0,0
68,8476867,Brendan Gaunce,C,MIN,30,0,0,0,0
68,8479520,Brandon Duhaime,R,WSH,27,0,0,0,0
68,8477073,Kurtis MacDermid,L,NJD,30,0,0,0,0
68,8480874,Adam Ginning,D,PHI,24,0,0,0,0
68,8477473,Justin Bailey,R,SJS,29,0,0,0,0
68,8479066,Ryan Lomberg,L,CGY,30,0,0,0,0
68,8477070,Liam O'Brien,C,UTA,30,0,0,0,0
68,8474618,Marco Scandella,D,,34,0,0,0,0
68,8475797,Jarred Tinordi,D,,32,0,0,0,0
68,8481441,Joe Snively,C,DET,28,0,0,0,0
68,8477244,Chad Ruhwedel,D,NYR,34,0,0,0,0
68,8479772,Zack MacEwen,R,OTT,28,0,0,0,0
68,8481147,Reese Johnson,C,MIN,26,0,0,0,0
68,8481043,Cole Koepke,L,BOS,26,0,0,0,0
68,8483619,Filip Roos,D,OTT,25,0,0,0,0
68,8481541,Samuel Bolduc,D,NYI,24,0,0,0,0
68,8477810,Joel Hanley,D,CGY,33,0,0,0,0
68,8476907,Mackenzie MacEachern,L,,30,0,0,0,0
68,8482652,Walker Duehr,R,CGY,27,0,0,0,0
68,8477126,Jayson Megna,C,,34,0,0,0,0
68,8483398,Declan Carlile,D,TBL,31,0,0,0,0
68,8482929,Emil Lilleberg,D,TBL,23,0,0,0,0
68,8480880,Jakub Lauko,C,MIN,24,0,0,0,0
68,8480245,Olle Lycksell,R,PHI,25,0,0,0,0
68,8480252,Cole Guttman,C,CHI,25,0,0,0,0
68,8477467,Gustav Olofsson,D,SEA,30,0,0,0,0
68,8479968,Vinni Lettieri,C,BOS,29,0,0,0,0
68,8478400,Colin White,C,,27,0,0,0,0
68,8475755,Alexander Petrovic,D,DAL,32,0,0,0,0
68,8481812,Nikolai Knyzhov,D,,27,0,0,0,0
68,8481593,Jayden Struble,D,MTL,23,0,0,0,0
68,8481532,Alex Turcotte,C,LAK,23,0,0,0,0
68,8482126,Emil Andrae,D,PHI,31,0,0,0,0
68,8479944,Zach Aston-Reese,C,VGK,30,0,0,0,0
68,8471817,Ryan Reaves,R,TOR,37,0,0,0,0
68,8481206,John Ludvig,D,PIT,24,0,0,0,0
68,8481599,Victor Soderstrom,D,UTA,23,0,0,0,0
68,8480292,Carson Meyer,R,ANA,27,0,0,0,0
68,8482496,Nils Aman,C,VAN,24,0,0,0,0
68,8479718,Alex Barré-Boulet,C,MTL,27,0,0,0,0
68,8479994,Jaret Anderson-Dolan,C,WPG,25,0,0,0,0
68,8480184,Gustav Lindstrom,D,,26,0,0,0,0
68,8480890,Jan Jenik,R,OTT,24,0,0,0,0
68,8478067,Oskar Lindblom,L,,28,0,0,0,0
68,8476934,Brock McGinn,L,ANA,30,0,0,0,0
68,8479985,Cale Fleury,D,SEA,26,0,0,0,0
68,8484304,Uvis Balinskis,D,FLA,28,0,0,0,0
68,8479981,Jonah Gadjovich,L,FLA,26,0,0,0,0
68,8481716,Dmitri Voronkov,L,CBJ,24,0,0,0,0
68,8474709,Matt Martin,L,,35,0,0,0,0
68,8482634,Alex Steeves,C,TOR,25,0,0,0,0
68,8480823,Alexander Alexeyev,D,WSH,25,0,0,0,0
68,8477541,Dakota Mermis,D,TOR,30,0,0,0,0
68,8483491,Ivan Miroshnichenko,L,WSH,20,0,0,0,0
68,8478477,Mitchell Stephens,C,SEA,27,0,0,0,0
68,8481543,Nikita Alexandrov,C,STL,24,0,0,0,0
68,8479423,Alex Nylander,L,,26,0,0,0,0
68,8482451,Mikael Pyyhtia,L,CBJ,23,0,0,0,0
68,8478831,Kevin Stenlund,C,UTA,28,0,0,0,0
68,8480306,Grant Hutton,D,NYI,29,0,0,0,0
68,8478028,Fredrik Olofsson,L,,28,0,0,0,0
68,8477462,Robert Hagg,D,VGK,29,0,0,0,0
68,8477320,Anton Blidh,L,NYR,29,0,0,0,0
68,8482157,Will Cuylle,L,NYR,22,0,0,0,0
68,8482737,Zack Bolduc,C,STL,21,0,0,0,0
68,8481239,Samuel Fagemo,L,,24,0,0,0,0
68,8481600,Tobias Bjornfot,D,FLA,23,0,0,0,0
68,8478409,Anthony Richard,C,PHI,28,0,0,0,0
68,8474145,Robert Bortuzzo,D,,35,0,0,0,0
68,8475958,Michael Sgarbossa,C,WSH,32,0,0,0,0
68,8479986,Kole Lind,R,DAL,26,0,0,0,0
68,8479249,Andrew Poturalski,C,SJS,30,0,0,0,0
68,8479362,Riley Tufte,L,BOS,26,0,0,0,0
68,8479991,Jake Leschyshyn,C,NYR,25,0,0,0,0
68,8479587,Rhett Gardner,C,PHI,28,0,0,0,0
68,8482744,James Malatesta,L,CBJ,21,0,0,0,0
68,8478854,Ryan Shea,D,PIT,27,0,0,0,0
68,8481591,Sam Poulin,R,,23,0,0,0,0
68,8483512,Matt Savoie,C,EDM,20,0,0,0,0
68,8482102,Vasily Ponomarev,C,PIT,22,0,0,0,0
68,8482162,Roby Jarventie,L,EDM,22,0,0,0,0
68,8481016,Ruslan Iskhakov,C,,24,0,0,0,0
68,8482172,Landon Slaggert,L,CHI,22,0,0,0,0
68,8482747,Brennan Othmann,L,NYR,21,0,0,0,0
68,8480031,Maxime Comtois,L,,25,0,0,0,0
68,8480226,Marián Studenic,R,,26,0,0,0,0
68,8478408,Travis Dermott,D,,28,0,0,0,0
68,8481518,Nolan Foote,L,NJD,24,0,0,0,0
68,8479419,Brett Murray,L,BUF,26,0,0,0,0
68,8482088,Justin Sourdif,R,FLA,22,0,0,0,0
68,8482201,Gage Goncalves,C,TBL,23,0,0,0,0
68,8481578,Graeme Clarke,R,MIN,23,0,0,0,0
68,8482177,Marat Khusnutdinov,C,MIN,22,0,0,0,0
68,8481754,Nikita Nesterenko,C,ANA,23,0,0,0,0
68,8483531,Brian Halonen,L,NJD,25,0,0,0,0
68,8483920,Pierrick Dube,R,WSH,23,0,0,0,0
68,8480851,Akil Thomas,C,LAK,24,0,0,0,0
68,8475235,Nicolas Deslauriers,L,PHI,33,0,0,0,0
68,8482476,Emil Heineman,L,MTL,23,0,0,0,0
68,8477149,Scott Sabourin,R,SJS,32,0,0,0,0
68,8483549,Lucas Condotta,L,MTL,27,0,0,0,0
68,8482765,Isak Rosen,R,BUF,21,0,0,0,0
68,8481237,Kyle MacLean,C,NYI,25,0,0,0,0
68,8481024,Linus Karlsson,C,VAN,25,0,0,0,0
68,8481690,Tyler Angle,C,,24,0,0,0,0
68,8483570,Ben Meyers,C,SEA,26,0,0,0,0
68,8481655,Cole Schwindt,R,CGY,23,0,0,0,0
68,8481462,Mason Morelli,L,VGK,28,0,0,0,0
68,8483401,Marc Johnstone,R,PIT,28,0,0,0,0
68,8478956,Samuel Laberge,L,NJD,27,0,0,0,0
68,8479533,Joona Koppanen,L,,26,0,0,0,0
68,8482197,Adam Raska,R,MIN,23,0,0,0,0
68,8482250,Callahan Burke,C,VGK,27,0,0,0,0
68,8482784,Zach Dean,C,STL,21,0,0,0,0
68,8484255,Jason Polin,R,COL,25,0,0,0,0
68,8481077,John Leonard,L,,26,0,0,0,0
68,8481534,Raphael Lavoie,C,EDM,24,0,0,0,0
68,8483609,Adam Klapka,R,CGY,24,0,0,0,0
68,8482751,Ryan Winterton,C,SEA,21,0,0,0,0
68,8480267,Sammy Walker,C,MIN,25,0,0,0,0
68,8475766,Austin Watson,L,,32,0,0,0,0
68,8482460,Matt Rempe,C,NYR,22,0,0,0,0
68,8481065,Angus Crookshank,L,OTT,25,0,0,0,0
68,8481070,Hugh McGing,L,,26,0,0,0,0
68,8476323,Max McCormick,L,SEA,32,0,0,0,0
68,8483395,Arshdeep Bains,L,VAN,23,0,0,0,0
68,8484259,Ondrej Pavel,C,COL,31,0,0,0,0
68,8483432,Luca Del Bel Belluz,C,CBJ,31,0,0,0,0
68,8483045,Cameron Butler,R,CBJ,31,0,0,0,0
68,8482061,Brandon Biro,L,SEA,26,0,0,0,0
68,8477401,John Hayden,C,SEA,29,0,0,0,0
68,8475278,Byron Froese,C,,33,0,0,0,0
68,8478446,Glenn Gawdin,C,LAK,27,0,0,0,0
68,8477993,Justin Kirkland,C,CGY,28,0,0,0,0
68,8482147,Jean-Luc Foudy,C,COL,22,0,0,0,0
68,8480032,Shane Bowers,C,NJD,25,0,0,0,0
68,8479330,Brandon Gignac,C,MTL,27,0,0,0,0
68,8480776,Sheldon Rempal,R,,29,0,0,0,0
68,8475413,Justin Dowling,C,NJD,34,0,0,0,0
68,8481726,Adam Edstrom,C,NYR,24,0,0,0,0
68,8480844,Grigori Denisenko,L,VGK,24,0,0,0,0
68,8478147,Bokondji Imama,L,PIT,28,0,0,0,0
68,8478881,Brett Seney,L,CHI,28,0,0,0,0
68,8483630,Pavol Regenda,L,ANA,25,0,0,0,0
68,8480836,Jonathan Gruden,C,,24,0,0,0,0
68,8484314,Jiri Smejkal,L,,28,0,0,0,0
68,8475780,Chris Wagner,R,COL,33,0,0,0,0
68,8479546,Oskar Steen,C,,26,0,0,0,0
68,8483597,Milos Kelemen,L,UTA,25,0,0,0,0
68,8481789,Tye Kartye,L,SEA,23,0,0,0,0
68,8484325,Waltteri Merela,C,TBL,26,0,0,0,0
68,8479421,Jacob Moverare,D,LAK,26,0,0,0,0
68,8481585,Egor Afanasyev,L,SJS,23,0,0,0,0
68,8479547,Matthew Phillips,R,,26,0,0,0,0
68,8479367,William Lockwood,R,FLA,26,0,0,0,0
68,8476915,Jujhar Khaira,L,,30,0,0,0,0
68,8481422,Jacob Lucchini,C,NSH,29,0,0,0,0
68,8480468,James Hamblin,L,EDM,25,0,0,0,0
68,8478051,Max Willman,C,NJD,29,0,0,0,0
68,8481556,John Beecher,C,BOS,23,0,0,0,0
68,8478078,Rourke Chartier,C,,28,0,0,0,0
69,8479318,Auston Matthews,C,TOR,27,82,78,66,144
69,8477492,Nathan MacKinnon,C,COL,29,82,54,87,141
69,8476453,Nikita Kucherov,R,TBL,31,82,40,99,139
69,8478402,Connor McDavid,C,EDM,27,82,53,72,125
69,8481559,Jack Hughes,C,NJD,23,82,48,71,119
69,8480012,Elias Pettersson,C,VAN,26,82,49,69,118
69,8479314,Matthew Tkachuk,L,FLA,27,82,37,80,117
69,8478550,Artemi Panarin,L,NYR,33,82,42,72,114
69,8476468,J.T. Miller,C,VAN,31,82,37,76,113
69,8477934,Leon Draisaitl,C,EDM,29,82,32,78,110
69,8478420,Mikko Rantanen,R,COL,28,82,41,67,108
69,8481557,Matt Boldy,L,MIN,23,82,44,62,106
69,8477939,William Nylander,R,TOR,28,82,49,54,103
69,8477942,Kevin Fiala,L,LAK,28,82,32,71,103
69,8479420,Tage Thompson,C,BUF,27,82,48,54,102
69,8479343,Clayton Keller,R,UTA,26,82,41,60,101
69,8475913,Mark Stone,R,VGK,32,82,32,69,101
69,8480069,Cale Makar,D,COL,26,82,30,71,101
69,8477493,Aleksander Barkov,C,FLA,29,82,26,75,101
69,8477402,Pavel Buchnevich,L,STL,29,82,44,56,100
69,8475166,John Tavares,C,TOR,34,82,40,60,100
69,8480800,Quinn Hughes,D,VAN,25,82,7,92,99
69,8477956,David Pastrnak,R,BOS,28,82,43,55,98
69,8478864,Kirill Kaprizov,L,MIN,27,82,42,55,97
69,8477951,Nick Schmaltz,C,UTA,28,82,40,57,97
69,8480002,Nico Hischier,C,NJD,25,82,30,67,97
69,8473419,Brad Marchand,L,BOS,36,82,37,58,95
69,8480023,Robert Thomas,C,STL,25,82,26,69,95
69,8478010,Brayden Point,C,TBL,28,82,32,61,93
69,8480027,Jason Robertson,L,DAL,25,82,29,63,92
69,8478445,Mathew Barzal,C,NYI,27,82,27,63,90
69,8475810,Bryan Rust,R,PIT,32,82,41,48,89
69,8474564,Steven Stamkos,C,NSH,34,82,39,50,89
69,8477409,Carter Verhaeghe,C,FLA,29,82,35,54,89
69,8479407,Jesper Bratt,L,NJD,26,82,34,55,89
69,8471675,Sidney Crosby,C,PIT,37,82,41,46,87
69,8475184,Chris Kreider,L,NYR,33,82,49,37,86
69,8477404,Jake Guentzel,C,TBL,30,82,43,43,86
69,8476887,Filip Forsberg,L,NSH,30,82,40,46,86
69,8474600,Roman Josi,D,NSH,34,82,21,65,86
69,8476389,Vincent Trocheck,C,NYR,31,82,40,44,84
69,8477501,Valeri Nichushkin,R,COL,29,82,38,46,84
69,8482116,Tim Stützle,C,OTT,22,82,35,49,84
69,8476853,Morgan Rielly,D,TOR,30,82,16,68,84
69,8477933,Sam Reinhart,C,FLA,29,82,39,44,83
69,8478398,Kyle Connor,L,WPG,28,82,37,46,83
69,8480801,Brady Tkachuk,L,OTT,25,82,31,52,83
69,8478403,Jack Eichel,C,VGK,28,82,40,42,82
69,8480015,Owen Tippett,R,PHI,25,82,39,43,82
69,8471215,Evgeni Malkin,C,PIT,38,82,27,55,82
69,8476459,Mika Zibanejad,C,NYR,31,82,24,58,82
69,8475692,Mats Zuccarello,R,MIN,37,82,24,57,81
69,8476454,Ryan Nugent-Hopkins,C,EDM,31,82,19,62,81
69,8480036,Miro Heiskanen,D,DAL,25,82,8,73,81
69,8477946,Dylan Larkin,C,DET,28,82,39,41,80
69,8480830,Andrei Svechnikov,R,CAR,24,82,30,50,80
69,8480839,Rasmus Dahlin,D,BUF,24,82,22,58,80
69,8477447,Shea Theodore,D,VGK,29,82,16,64,80
69,8476881,Tomas Hertl,C,VGK,31,82,35,44,79
69,8478427,Sebastian Aho,C,CAR,27,82,35,42,77
69,8479385,Jordan Kyrou,C,STL,26,82,32,45,77
69,8478439,Travis Konecny,R,PHI,27,82,30,47,77
69,8477949,Alex Tuch,R,BUF,28,82,28,49,77
69,8479323,Adam Fox,D,NYR,26,82,16,61,77
69,8475168,Matt Duchene,C,DAL,33,82,38,38,76
69,8479542,Brandon Hagel,L,TBL,26,82,35,41,76
69,8482124,Quinton Byfield,R,LAK,22,82,31,45,76
69,8477960,Adrian Kempe,R,LAK,28,82,31,44,75
69,8478460,Zach Werenski,D,CBJ,27,82,17,58,75
69,8478873,Troy Terry,R,ANA,27,82,35,39,74
69,8481523,Kirby Dach,C,MTL,23,82,17,57,74
69,8475786,Zach Hyman,L,EDM,32,82,36,37,73
69,8478449,Roope Hintz,C,DAL,28,82,32,41,73
69,8480018,Nick Suzuki,C,MTL,25,82,23,50,73
69,8478493,Joel Eriksson Ek,C,MIN,27,82,36,36,72
69,8475172,Nazem Kadri,C,CGY,34,82,30,42,72
69,8478396,Noah Hanifin,D,VGK,27,82,21,51,72
69,8476462,Dougie Hamilton,D,NJD,31,82,21,51,72
69,8477476,Artturi Lehkonen,L,COL,29,82,44,27,71
69,8477500,Bo Horvat,C,NYI,29,82,42,29,71
69,8479337,Alex DeBrincat,R,DET,27,82,25,46,71
69,8477955,Jared McCann,L,SEA,28,82,39,31,70
69,8476448,William Karlsson,C,VGK,31,82,32,37,69
69,8476460,Mark Scheifele,C,WPG,31,82,28,41,69
69,8477940,Nikolaj Ehlers,L,WPG,28,82,25,44,69
69,8476346,Johnny Gaudreau,L,CBJ,31,82,13,55,68
69,8476539,Jonathan Marchessault,R,NSH,34,82,35,32,67
69,8475765,Vladimir Tarasenko,R,DET,33,82,31,36,67
69,8481528,Dylan Cozens,C,BUF,23,82,27,40,67
69,8477504,Josh Morrissey,D,WPG,29,82,16,51,67
69,8482684,Luke Hughes,D,NJD,21,82,14,53,67
69,8478042,Viktor Arvidsson,R,EDM,31,82,34,32,66
69,8477416,Oliver Bjorkstrand,R,SEA,29,82,28,38,66
69,8471685,Anze Kopitar,C,LAK,37,82,20,46,66
69,8479325,Charlie McAvoy,D,BOS,27,82,19,47,66
69,8475784,Jeff Skinner,C,EDM,32,82,29,36,65
69,8480039,Martin Necas,C,CAR,25,82,27,38,65
69,8474565,Alex Pietrangelo,D,VGK,34,82,18,47,65
69,8478856,Conor Garland,R,VAN,28,82,29,35,64
69,8474641,Adam Henrique,C,EDM,34,82,28,36,64
69,8481540,Cole Caufield,R,MTL,23,82,26,38,64
69,8478414,Timo Meier,R,NJD,28,82,26,38,64
69,8478047,Michael Bunting,L,PIT,29,82,24,40,64
69,8479339,Patrik Laine,L,CBJ,26,82,28,35,63
69,8474141,Patrick Kane,R,DET,36,82,26,37,63
69,8477497,Sean Monahan,C,CBJ,30,82,26,37,63
69,8473994,Jamie Benn,L,DAL,35,82,26,37,63
69,8478975,Mason Marchment,L,DAL,29,82,26,37,63
69,8475191,Reilly Smith,R,NYR,33,82,27,35,62
69,8471214,Alex Ovechkin,L,WSH,39,82,26,36,62
69,8482078,Lucas Raymond,L,DET,22,82,26,36,62
69,8478407,Vince Dunn,D,SEA,28,82,12,50,62
69,8482093,Seth Jarvis,C,CAR,22,82,35,26,61
69,8477444,Andre Burakovsky,L,SEA,29,82,21,40,61
69,8477496,Elias Lindholm,C,BOS,30,82,16,45,61
69,8475798,Mikael Granlund,C,SJS,32,82,15,46,61
69,8476458,Ryan Strome,C,ANA,31,82,15,46,61
69,8477935,Sam Bennett,C,FLA,28,82,35,25,60
69,8479675,Trevor Moore,L,LAK,29,82,31,29,60
69,8482097,Jack Quinn,R,BUF,23,82,26,34,60
69,8478038,Devon Toews,D,COL,30,82,15,45,60
69,8480803,Evan Bouchard,D,EDM,25,82,8,52,60
69,8481068,Yegor Sharangovich,C,CGY,26,82,33,26,59
69,8476483,Rickard Rakell,R,PIT,31,82,31,28,59
69,8482740,Wyatt Johnston,C,DAL,21,82,31,28,59
69,8474150,Mikael Backlund,C,CGY,35,82,22,37,59
69,8474578,Erik Karlsson,D,PIT,34,82,14,45,59
69,8471698,T.J. Oshie,R,WSH,38,82,24,34,58
69,8481711,Matias Maccelli,L,UTA,24,82,20,38,58
69,8474590,John Carlson,D,WSH,34,82,8,50,58
69,8478366,Frank Vatrano,R,ANA,30,82,37,20,57
69,8478519,Anthony Cirelli,C,TBL,27,82,26,31,57
69,8478462,Nicolas Roy,C,VGK,27,82,23,34,57
69,8475745,Charlie Coyle,C,BOS,32,82,22,35,57
69,8478440,Dylan Strome,C,WSH,27,82,20,37,57
69,8476479,Phillip Danault,C,LAK,31,82,20,37,57
69,8480865,Noah Dobson,D,NYI,24,82,12,45,57
69,8480208,Drake Batherson,R,OTT,26,82,27,29,56
69,8475170,Brayden Schenn,C,STL,33,82,24,32,56
69,8480028,Morgan Frost,C,PHI,25,82,23,33,56
69,8480078,Filip Chytil,C,NYR,25,82,22,34,56
69,8474679,Gustav Nyquist,C,NSH,35,82,20,36,56
69,8475158,Ryan O'Reilly,C,NSH,33,82,17,39,56
69,8476456,Jonathan Huberdeau,C,CGY,31,82,14,42,56
69,8478397,Rasmus Andersson,D,CGY,28,82,11,45,56
69,8479410,Mikhail Sergachev,D,UTA,26,82,11,45,56
69,8478444,Brock Boeser,R,VAN,27,82,31,24,55
69,8481596,Shane Pinto,C,OTT,24,82,26,29,55
69,8479345,Jakob Chychrun,D,WSH,26,82,20,35,55
69,8475167,Victor Hedman,D,TBL,34,82,14,41,55
69,8475754,Brock Nelson,C,NYI,33,82,30,24,54
69,8475169,Evander Kane,L,EDM,33,82,25,29,54
69,8475768,Jaden Schwartz,C,SEA,32,82,25,29,54
69,8477451,Ryan Hartman,R,MIN,30,82,22,32,54
69,8474586,Jordan Eberle,R,SEA,34,82,22,32,54
69,8473986,Alex Killorn,L,ANA,35,82,20,34,54
69,8476792,Torey Krug,D,STL,33,82,17,37,54
69,8476905,Chandler Stephenson,C,SEA,30,82,11,43,54
69,8475753,Justin Faulk,D,STL,32,82,11,43,54
69,8482745,Mason McTavish,C,ANA,21,82,26,27,53
69,8475794,Tyler Seguin,C,DAL,32,82,25,28,53
69,8476432,Boone Jenner,C,CBJ,31,82,22,31,53
69,8477964,Ivan Barbashev,C,VGK,29,82,21,32,53
69,8479992,Michael Rasmussen,C,DET,25,82,18,35,53
69,8477494,Jonathan Drouin,L,COL,29,82,15,38,53
69,8477932,Aaron Ekblad,D,FLA,28,82,13,40,53
69,8479425,Filip Hronek,D,VAN,27,82,11,42,53
69,8474563,Drew Doughty,D,LAK,35,82,9,44,53
69,8475287,Erik Haula,L,NJD,33,82,27,25,52
69,8482110,Dawson Mercer,C,NJD,23,82,26,26,52
69,8474102,David Perron,L,OTT,36,82,24,28,52
69,8477511,Anthony Mantha,R,CGY,30,82,24,28,52
69,8475793,Ryan Johansen,C,PHI,32,82,23,29,52
69,8482109,Alexis Lafrenière,L,NYR,23,82,21,31,52
69,8478458,Jack Roslovic,C,CAR,27,82,16,36,52
69,8473512,Claude Giroux,R,OTT,36,82,13,39,52
69,8476880,Tom Wilson,R,WSH,30,82,27,24,51
69,8477456,J.T. Compher,L,DET,29,82,26,25,51
69,8482665,Matty Beniers,C,SEA,22,82,23,28,51
69,8482113,Anton Lundell,C,FLA,23,82,22,29,51
69,8478401,Pavel Zacha,C,BOS,27,82,18,33,51
69,8471724,Kris Letang,D,PIT,37,82,7,44,51
69,8480014,Gabriel Vilardi,C,WPG,25,82,30,20,50
69,8477998,Warren Foegele,L,LAK,28,82,27,23,50
69,8478542,Evan Rodrigues,C,FLA,31,82,24,26,50
69,8477986,Brandon Montour,D,SEA,30,82,19,31,50
69,8477495,Seth Jones,D,CHI,30,82,19,31,50
69,8480798,Philipp Kurashev,C,CHI,25,82,14,36,50
69,8481560,Arthur Kaliyev,R,LAK,23,82,23,26,49
69,8480797,Joel Farabee,L,PHI,24,82,21,28,49
69,8482720,Matthew Knies,L,TOR,22,82,19,30,49
69,8476906,Shayne Gostisbehere,D,CAR,31,82,12,37,49
69,8476474,Stefan Noesen,R,NJD,31,82,27,21,48
69,8480188,Fabian Zetterlund,L,SJS,25,82,25,23,48
69,8475151,Kyle Palmieri,C,NYI,33,82,25,23,48
69,8478046,Danton Heinen,L,VAN,29,82,23,25,48
69,8479400,Pierre-Luc Dubois,L,WSH,26,82,21,27,48
69,8480220,Noah Cates,L,PHI,25,82,21,27,48
69,8479999,Casey Mittelstadt,C,COL,26,82,19,29,48
69,8477426,Nicholas Paul,L,TBL,29,82,17,31,48
69,8470613,Brent Burns,D,CAR,39,82,16,32,48
69,8480849,Barrett Hayton,C,UTA,24,82,15,33,48
69,8480185,Eetu Luostarinen,C,FLA,26,82,15,33,48
69,8481542,Moritz Seider,D,DET,23,82,8,40,48
69,8482699,Dylan Guenther,R,UTA,21,82,27,20,47
69,8482146,Luke Evangelista,R,NSH,22,82,27,20,47
69,8480009,Eeli Tolvanen,R,SEA,25,82,26,21,47
69,8478474,Lawson Crouse,L,UTA,27,82,23,24,47
69,8478498,Jake DeBrusk,L,VAN,28,82,22,25,47
69,8481604,Pavel Dorofeyev,L,VGK,24,82,22,25,47
69,8475714,Calle Jarnkrok,C,TOR,33,82,19,28,47
69,8475763,Kevin Hayes,R,PIT,32,82,18,29,47
69,8476882,Teuvo Teravainen,L,CHI,30,82,17,30,47
69,8482159,Tyson Foerster,R,PHI,22,82,22,24,46
69,8476438,Brandon Saad,L,STL,32,82,20,26,46
69,8476918,Jimmy Vesey,L,NYR,31,82,20,26,46
69,8480064,Josh Norris,C,OTT,25,82,19,27,46
69,8476869,Brady Skjei,D,NSH,30,82,12,34,46
69,8477503,Max Domi,C,TOR,29,82,7,39,46
69,8483808,Andrei Kuzmenko,L,CGY,28,82,24,21,45
69,8479365,Trent Frederic,C,BOS,26,82,24,21,45
69,8479525,Ross Colton,C,COL,28,82,22,23,45
69,8476292,Ondrej Palat,L,NJD,33,82,18,27,45
69,8481618,Alex Newhook,C,MTL,23,82,17,28,45
69,8475218,Mattias Ekholm,D,EDM,34,82,13,32,45
69,8478469,Thomas Chabot,D,OTT,27,82,11,34,45
69,8480434,Sean Durzi,D,UTA,26,82,10,35,45
69,8478438,Tommy Novak,C,NSH,27,82,10,35,45
69,8480043,Timothy Liljegren,D,TOR,25,82,5,40,45
69,8475760,Nick Bjugstad,C,UTA,32,82,24,20,44
69,8477407,Anthony Duclair,L,NYI,29,82,21,23,44
69,8477953,Kasperi Kapanen,R,STL,28,82,17,27,44
69,8480113,Alex Iafallo,L,WPG,31,82,14,30,44
69,8476875,Mike Matheson,D,MTL,30,82,11,33,44
69,8477948,Travis Sanheim,D,PHI,28,82,10,34,44
69,8477021,Alex Kerfoot,C,UTA,30,82,9,35,44
69,8477346,MacKenzie Weegar,D,CGY,30,82,8,36,44
69,8476399,Blake Coleman,C,CGY,33,82,22,21,43
69,8475791,Taylor Hall,L,CHI,33,82,21,22,43
69,8482667,William Eklund,L,SJS,22,82,21,22,43
69,8475314,Anders Lee,L,NYI,34,82,17,26,43
69,8481554,Kaapo Kakko,R,NYR,23,82,16,27,43
69,8481535,Nils Hoglander,L,VAN,24,82,25,17,42
69,8482125,Alexander Holtz,R,VGK,22,82,22,20,42
69,8476872,Scott Laughton,C,PHI,30,82,18,24,42
69,8473533,Jordan Staal,C,CAR,36,82,17,25,42
69,8481186,Logan O'Connor,R,COL,28,82,17,25,42
69,8481533,Trevor Zegras,C,ANA,23,82,14,28,42
69,8478472,Mathieu Joseph,R,STL,27,82,13,29,42
69,8480817,K'Andre Miller,D,NYR,24,82,12,30,42
69,8476826,Yanni Gourde,C,SEA,33,82,11,31,42
69,8474053,Logan Couture,C,SJS,35,82,10,32,42
69,8477969,Marcus Pettersson,D,PIT,28,82,4,38,42
69,8479996,Cody Glass,C,NSH,25,82,26,15,41
69,8475726,Tyler Toffoli,C,SJS,32,82,20,21,41
69,8476927,Teddy Blueger,C,VAN,30,82,19,22,41
69,8482475,Yegor Chinakhov,R,CBJ,23,82,17,24,41
69,8476885,Jacob Trouba,D,NYR,30,82,13,28,41
69,8481546,Cam York,D,PHI,23,82,9,32,41
69,8476329,Travis Boyd,C,MIN,31,82,9,32,41
69,8478463,Anthony Beauvillier,L,PIT,27,82,20,20,40
69,8478233,Andrew Mangiapane,L,WSH,28,82,19,21,40
69,8473563,Nicklas Backstrom,C,WSH,37,82,19,21,40
69,8476480,Vladislav Namestnikov,C,WPG,32,82,18,22,40
69,8481013,Jonatan Berggren,R,DET,24,82,18,22,40
69,8477952,Robby Fabbri,C,ANA,28,82,17,23,40
69,8482671,Owen Power,D,BUF,22,82,17,23,40
69,8482705,Cole Sillinger,C,CBJ,21,82,15,25,40
69,8477987,Ryan Donato,C,CHI,28,82,11,29,40
69,8474149,Evgenii Dadonov,R,DAL,35,82,20,19,39
69,8478891,Mason Appleton,C,WPG,28,82,18,21,39
69,8475149,Marcus Johansson,L,MIN,34,82,17,22,39
69,8482149,Cole Perfetti,C,WPG,22,82,13,26,39
69,8481553,Bobby Brink,R,PHI,23,82,13,26,39
69,8477479,Tyler Bertuzzi,L,CHI,29,82,11,28,39
69,8482092,Ridly Greig,C,OTT,22,82,22,16,38
69,8482117,Lukas Reichel,L,CHI,22,82,20,18,38
69,8484144,Connor Bedard,C,CHI,19,82,16,22,38
69,8479353,Brett Howden,C,VGK,26,82,16,22,38
69,8480336,Sean Walker,D,CAR,30,82,15,23,38
69,8478413,Jordan Greenway,L,BUF,27,82,15,23,38
69,8482105,Jake Sanderson,D,OTT,22,82,14,24,38
69,8475171,Oliver Ekman-Larsson,D,TOR,33,82,10,28,38
69,8475722,Jason Zucker,L,BUF,32,82,9,29,38
69,8475181,Nick Leddy,D,STL,33,82,6,32,38
69,8480813,Joe Veleno,C,DET,24,82,20,17,37
69,8481582,Nicholas Robertson,L,TOR,23,82,16,21,37
69,8479987,Morgan Geekie,C,BOS,26,82,15,22,37
69,8477989,Christian Dvorak,C,MTL,28,82,15,22,37
69,8475200,Dmitry Orlov,D,CAR,33,82,11,26,37
69,8478055,Gustav Forsling,D,FLA,28,82,10,27,37
69,8476958,Jaccob Slavin,D,CAR,30,82,6,31,37
69,8476854,Hampus Lindholm,D,BOS,30,82,4,33,37
69,8477919,Frederick Gaudreau,C,MIN,31,82,17,19,36
69,8480459,Pius Suter,C,VAN,28,82,16,20,36
69,8475193,Tomas Tatar,L,NJD,34,82,15,21,36
69,8480995,Pontus Holmberg,R,TOR,25,82,14,22,36
69,8477429,Andrew Copp,C,DET,30,82,12,24,36
69,8482660,Kent Johnson,C,CBJ,22,82,11,25,36
69,8482175,JJ Peterka,R,BUF,22,82,20,15,35
69,8482055,Drew O'Connor,L,PIT,26,82,19,16,35
69,8474715,Cam Atkinson,R,TBL,35,82,19,16,35
69,8480802,Ryan McLeod,C,BUF,25,82,13,22,35
69,8481656,Aliaksei Protas,C,WSH,23,82,12,23,35
69,8474716,Jared Spurgeon,D,MIN,35,82,12,23,35
69,8478434,Keegan Kolesar,R,VGK,27,82,11,24,35
69,8475231,Casey Cizikas,C,NYI,33,82,9,26,35
69,8476392,Adam Lowry,C,WPG,31,82,19,15,34
69,8480835,Jack Drury,C,CAR,24,82,15,19,34
69,8479591,Michael Eyssimont,C,TBL,28,82,15,19,34
69,8476925,Colton Sissons,C,NSH,31,82,13,21,34
69,8481581,Thomas Harley,D,DAL,23,82,10,24,34
69,8476931,Jake McCabe,D,TOR,31,82,4,30,34
69,8475764,Cam Fowler,D,ANA,33,82,3,31,34
69,8479398,Samuel Girard,D,COL,26,82,3,31,34
69,8483515,Juraj Slafkovsky,L,MTL,20,82,17,16,33
69,8481704,Juuso Parssinen,C,NSH,23,82,12,21,33
69,8476419,Jean-Gabriel Pageau,C,NYI,32,82,11,22,33
69,8483457,Lane Hutson,D,MTL,20,82,9,24,33
69,8476461,Sean Couturier,C,PHI,32,82,8,25,33
69,8477498,Darnell Nurse,D,EDM,29,82,8,25,33
69,8476923,Damon Severson,D,CBJ,30,82,8,25,33
69,8474673,TJ Brodie,D,CHI,34,82,5,28,33
69,8480873,Rasmus Sandin,D,WSH,24,82,4,29,33
69,8476331,Dylan DeMelo,D,WPG,31,82,3,30,33
69,8479941,Justin Danforth,R,CBJ,31,82,23,9,32
69,8480855,Jack McBain,C,UTA,24,82,16,16,32
69,8478109,Victor Olofsson,L,VGK,29,82,16,16,32
69,8476960,Andreas Athanasiou,C,CHI,30,82,15,17,32
69,8477488,Brett Pesce,D,NJD,30,82,13,19,32
69,8478115,Pierre Engvall,L,NYI,28,82,11,21,32
69,8480145,Neal Pionk,D,WPG,29,82,10,22,32
69,8473507,Jeff Petry,D,DET,37,82,10,22,32
69,8476979,Erik Gustafsson,D,DET,32,82,2,30,32
69,8470621,Corey Perry,R,EDM,39,82,20,11,31
69,8476981,Josh Anderson,R,MTL,30,82,18,13,31
69,8475799,Nino Niederreiter,R,WPG,32,82,17,14,31
69,8477947,Sonny Milano,L,WSH,28,82,17,14,31
69,8480748,Kiefer Sherwood,L,VAN,29,82,15,16,31
69,8480144,David Kampf,C,TOR,29,82,14,17,31
69,8478057,Dakota Joshua,C,VAN,28,82,13,18,31
69,8481624,Ilya Mikheyev,R,CHI,30,82,13,18,31
69,8484145,Zach Benson,L,BUF,19,82,13,18,31
69,8480074,Alexandre Texier,C,STL,25,82,13,18,31
69,8479661,Tanner Jeannot,L,LAK,27,82,13,18,31
69,8474574,Tyler Myers,D,VAN,34,82,9,22,31
69,8477839,Conor Sheary,L,TBL,32,82,17,13,30
69,8476889,Radek Faksa,C,STL,30,82,15,15,30
69,8477392,Hudson Fasching,R,NYI,29,82,15,15,30
69,8479368,Max Jones,L,BOS,26,82,14,16,30
69,8480829,Jesperi Kotkaniemi,C,CAR,24,82,13,17,30
69,8477450,Jason Dickinson,C,CHI,29,82,12,18,30
69,8482111,Justin Barron,D,MTL,23,82,11,19,30
69,8482666,Scott Morrow,D,CAR,22,82,8,22,30
69,8478500,Ivan Provorov,D,CBJ,27,82,6,24,30
69,8482142,Jamie Drysdale,D,PHI,22,82,6,24,30
69,8477507,Nikita Zadorov,D,BOS,29,82,6,24,30
69,8476892,Colton Parayko,D,STL,31,82,5,25,30
69,8481606,Jordan Spence,D,LAK,23,82,5,25,30
69,8482089,Jake Neighbours,L,STL,22,82,19,10,29
69,8479390,Taylor Raddysh,R,WSH,26,82,18,11,29
69,8482259,Bobby McMann,C,TOR,28,82,18,11,29
69,8481032,Paul Cotter,C,NJD,25,82,15,14,29
69,8481477,Nico Sturm,C,SJS,29,82,15,14,29
69,8482702,Logan Stankoven,C,DAL,21,82,13,16,29
69,8474189,Lars Eller,C,PIT,35,82,12,17,29
69,8481580,Connor McMichael,C,WSH,23,82,12,17,29
69,8476873,Mark Jankowski,C,NSH,30,82,11,18,29
69,8479976,Juuso Valimaki,D,UTA,26,82,8,21,29
69,8480222,Sebastian Aho,D,PIT,28,82,7,22,29
69,8474151,Ryan McDonagh,D,TBL,35,82,4,25,29
69,8476917,Adam Pelech,D,NYI,30,82,3,26,29
69,8480068,Ryan Poehling,C,PHI,25,82,16,12,28
69,8480980,Connor Dewar,C,TOR,25,82,14,14,28
69,8479414,Nathan Bastian,R,NJD,27,82,14,14,28
69,8476374,Sean Kuraly,C,CBJ,31,82,11,17,28
69,8477353,Tyler Motte,C,DET,29,82,9,19,28
69,8482133,Thomas Bordeleau,C,SJS,22,82,9,19,28
69,8484203,Bradly Nadeau,L,CAR,19,82,9,19,28
69,8482803,Olen Zellweger,D,ANA,21,82,8,20,28
69,8478882,Vladislav Gavrikov,D,LAK,29,82,7,21,28
69,8476902,Esa Lindell,D,DAL,30,82,7,21,28
69,8479369,Andrew Peeke,D,BOS,26,82,7,21,28
69,8477220,Nate Schmidt,D,FLA,33,82,6,22,28
69,8478911,Matt Roy,D,WSH,29,82,4,24,28
69,8475690,Chris Tanev,D,TOR,35,82,4,24,28
69,8477506,Ryan Pulock,D,NYI,30,82,3,25,28
69,8480893,Kirill Marchenko,R,CBJ,24,82,18,9,27
69,8481481,Blake Lizotte,C,PIT,27,82,18,9,27
69,8477425,Miles Wood,L,COL,29,82,15,12,27
69,8476278,Colin Blackwell,C,DAL,31,82,14,13,27
69,8479393,Noah Gregor,C,OTT,26,82,13,14,27
69,8477903,Garnet Hathaway,R,PHI,33,82,12,15,27
69,8476921,Jordan Martinook,L,CAR,32,82,10,17,27
69,8475343,Nic Dowd,C,WSH,34,82,9,18,27
69,8482809,Jackson Blake,R,CAR,21,82,9,18,27
69,8480871,Adam Boqvist,D,FLA,24,82,7,20,27
69,8479371,Dante Fabbro,D,NSH,26,82,5,22,27
69,8482077,Dylan Holloway,L,EDM,23,82,19,7,26
69,8475848,Brendan Gallagher,R,MTL,32,82,17,9,26
69,8479316,Luke Kunin,C,SJS,27,82,14,12,26
69,8476469,Joel Armia,R,MTL,31,82,13,13,26
69,8482079,Marco Rossi,C,MIN,23,82,12,14,26
69,8473422,Nick Foligno,L,CHI,37,82,11,15,26
69,8478432,Christian Fischer,R,DET,27,82,11,15,26
69,8482166,Shakir Mukhamadullin,D,SJS,22,82,8,18,26
69,8478020,Michael Amadio,C,OTT,28,82,8,18,26
69,8481522,Peyton Krebs,C,BUF,23,82,7,19,26
69,8483490,Pavel Mintyukov,D,ANA,21,82,6,20,26
69,8483495,Simon Nemec,D,NJD,20,82,6,20,26
69,8479980,Nicolas Hague,D,VGK,26,82,5,21,26
69,8479402,Jake Bean,D,CGY,26,82,4,22,26
69,8478507,John Marino,D,UTA,27,82,3,23,26
69,8477435,Ryan Graves,D,PIT,29,82,2,24,26
69,8478508,Yakov Trenin,C,MIN,27,82,17,8,25
69,8483431,Logan Cooley,C,UTA,20,82,14,11,25
69,8476897,Oskar Sundqvist,C,STL,30,82,14,11,25
69,8476312,Josh Manson,D,COL,33,82,9,16,25
69,8478013,Jake Walman,D,SJS,28,82,9,16,25
69,8475855,Jesper Fast,R,CAR,33,82,7,18,25
69,8476422,Mike Reilly,D,NYI,31,82,5,20,25
69,8477499,Rasmus Ristolainen,D,PHI,30,82,4,21,25
69,8480073,Erik Brannstrom,D,COL,25,82,4,21,25
69,8478840,Will Borgen,D,SEA,28,82,4,21,25
69,8484166,Adam Fantilli,C,CBJ,20,82,16,8,24
69,8481028,Martin Pospisil,C,CGY,25,82,14,10,24
69,8475842,Sam Carrick,C,NYR,32,82,13,11,24
69,8476442,Matt Nieto,L,PIT,32,82,12,12,24
69,8478569,Noel Acciari,C,PIT,33,82,11,13,24
69,8478133,Jake Evans,C,MTL,28,82,10,14,24
69,8480806,Isac Lundestrom,C,ANA,25,82,10,14,24
69,8483763,Maksymilian Szuber,D,UTA,22,82,9,15,24
69,8475220,Marcus Foligno,L,MIN,33,82,9,15,24
69,8477369,Carson Soucy,D,VAN,30,82,9,15,24
69,8482141,Lukas Cormier,D,VGK,22,82,8,16,24
69,8482624,Daniil Miromanov,D,CGY,27,82,6,18,24
69,8482655,J.J. Moser,D,TBL,24,82,5,19,24
69,8481014,Alexander Romanov,D,NYI,24,82,4,20,24
69,8479983,Mario Ferraro,D,SJS,26,82,4,20,24
69,8476457,Adam Larsson,D,SEA,32,82,4,20,24
69,8482245,Artem Zub,D,OTT,29,82,3,21,24
69,8481093,Rafael Harvey-Pinard,L,MTL,25,82,13,10,23
69,8477508,Curtis Lazar,C,NJD,29,82,5,18,23
69,8476463,Jonas Brodin,D,MIN,31,82,4,19,23
69,8481708,Zac Jones,D,NYR,24,82,2,21,23
69,8476891,Matt Grzelcyk,D,PIT,30,82,2,21,23
69,8481601,Simon Holmstrom,R,NYI,23,82,12,10,22
69,8482762,Simon Edvinsson,D,DET,21,82,11,11,22
69,8473453,Trevor Lewis,C,LAK,37,82,11,11,22
69,8476624,Barclay Goodrow,C,SJS,31,82,10,12,22
69,8479351,Sam Steel,C,DAL,26,82,9,13,22
69,8482659,Josh Doan,R,UTA,22,82,7,15,22
69,8480878,Nils Lundkvist,D,DAL,24,82,5,17,22
69,8482153,Brendan Brisson,C,VGK,23,82,5,17,22
69,8476879,Cody Ceci,D,EDM,31,82,4,18,22
69,8476429,Scott Mayfield,D,NYI,32,82,4,18,22
69,8481178,Egor Zamula,D,PHI,24,82,2,20,22
69,8479293,Brandon Tanev,L,SEA,33,82,13,8,21
69,8481524,Bowen Byram,D,BUF,23,82,9,12,21
69,8477015,Connor Brown,R,EDM,30,82,7,14,21
69,8481605,Jackson LaCombe,D,ANA,23,82,7,14,21
69,8470600,Ryan Suter,D,STL,39,82,5,16,21
69,8475455,Brenden Dillon,D,NJD,34,82,5,16,21
69,8480796,Martin Fehervary,D,WSH,25,82,5,16,21
69,8477845,Trevor van Riemsdyk,D,WSH,33,82,4,17,21
69,8481568,Alex Vlasic,D,CHI,23,82,4,17,21
69,8478851,Alexandre Carrier,D,NSH,28,82,4,17,21
69,8483499,Liam Ohgren,L,MIN,20,82,4,17,21
69,8475279,Ben Chiarot,D,DET,33,82,3,18,21
69,8482073,Braden Schneider,D,NYR,23,82,3,18,21
69,8482122,Brock Faber,D,MIN,22,82,1,20,21
69,8475324,Nick Jensen,D,OTT,34,82,0,21,21
69,8480003,Jesper Boqvist,C,FLA,26,82,9,11,20
69,8483524,Shane Wright,C,SEA,20,82,9,11,20
69,8481641,Joel Kiviranta,L,COL,28,82,9,11,20
69,8476525,Colin Miller,D,WPG,32,82,8,12,20
69,8482074,Connor Zary,C,CGY,23,82,8,12,20
69,8478211,Dryden Hunt,L,CGY,29,82,7,13,20
69,8476467,Jamie Oleksiak,D,SEA,32,82,5,15,20
69,8476372,Nick Seeler,D,PHI,31,82,5,15,20
69,8482062,Cole Smith,L,NSH,29,82,5,15,20
69,8483482,Tristan Luneau,D,ANA,20,82,5,15,20
69,8480807,Mattias Samuelsson,D,BUF,24,82,4,16,20
69,8478178,Darren Raddysh,D,TBL,28,82,4,16,20
69,8474013,Ian Cole,D,UTA,35,82,3,17,20
69,8480049,Dylan Samberg,D,WPG,25,82,2,18,20
69,8476967,Brett Kulak,D,EDM,30,82,1,19,20
69,8478416,Erik Cernak,D,TBL,27,82,1,19,20
69,8482155,Alex Laferriere,R,LAK,23,82,14,5,19
69,8477931,Tomas Nosek,L,FLA,32,82,11,8,19
69,8483445,Cutter Gauthier,L,ANA,20,82,10,9,19
69,8483397,Marc McLaughlin,C,BOS,25,82,10,9,19
69,8476858,Phillip Di Giuseppe,L,VAN,31,82,9,10,19
69,8479359,Beck Malenstyn,L,BUF,26,82,7,12,19
69,8482470,Ilya Solovyov,D,CGY,24,82,7,12,19
69,8475188,Brayden McNabb,D,VGK,33,82,6,13,19
69,8481517,Brett Leason,R,ANA,25,82,6,13,19
69,8478468,Jeremy Lauzon,D,NSH,27,82,3,16,19
69,8480035,Henri Jokiharju,D,BUF,25,82,2,17,19
69,8478443,Brandon Carlo,D,BOS,28,82,2,17,19
69,8482087,Kaiden Guhle,D,MTL,22,82,0,19,19
69,8478399,Jonas Siegenthaler,D,NJD,27,82,0,19,19
69,8482859,Zack Ostapchuk,C,OTT,21,82,8,10,18
69,8482679,Matt Coronato,R,CGY,22,82,7,11,18
69,8477406,Mattias Janmark,C,EDM,32,82,6,12,18
69,8481567,Henry Thrun,D,SJS,23,82,5,13,18
69,8479324,Ryan Lindgren,D,NYR,26,82,3,15,18
69,8480879,Jacob Bernard-Docker,D,OTT,24,82,3,15,18
69,8479998,Mikey Anderson,D,LAK,25,82,3,15,18
69,8483565,Nick Blankenburg,D,NSH,26,82,2,16,18
69,8478136,Jake Middleton,D,MIN,28,82,2,16,18
69,8484153,Leo Carlsson,C,ANA,20,82,7,10,17
69,8482516,Matthew Kessel,D,STL,24,82,5,12,17
69,8478859,Niko Mikkola,D,FLA,28,82,5,12,17
69,8478874,Adam Gaudette,C,OTT,28,82,5,12,17
69,8475177,Calvin de Haan,D,COL,33,82,4,13,17
69,8475790,Erik Gudbranson,D,CBJ,32,82,4,13,17
69,8483468,Jiri Kulich,C,BUF,20,82,4,13,17
69,8479442,Troy Stecher,D,EDM,30,82,4,13,17
69,8475233,David Savard,D,MTL,34,82,3,14,17
69,8476441,Joel Edmundson,D,LAK,31,82,3,14,17
69,8475462,Radko Gudas,D,ANA,34,82,1,16,17
69,8476878,Zemgus Girgensons,L,TBL,30,82,9,7,16
69,8480281,Alexey Toropchenko,R,STL,25,82,9,7,16
69,8483505,Matthew Poitras,C,BOS,20,82,9,7,16
69,8483489,Fraser Minten,C,TOR,31,82,8,8,16
69,8480021,Jack Studnicka,C,LAK,25,82,7,9,16
69,8484149,Gavin Brindley,C,CBJ,20,82,7,9,16
69,8482713,Mackie Samoskevich,R,FLA,22,82,6,10,16
69,8480448,Parker Kelly,L,COL,25,82,5,11,16
69,8482733,Logan Mailloux,D,MTL,31,82,5,11,16
69,8481122,Simon Benoit,D,TOR,26,82,3,13,16
69,8474567,Zach Bogosian,D,MIN,34,82,3,13,16
69,8480950,Ilya Lyubushkin,D,DAL,30,82,3,13,16
69,8480860,Kevin Bahl,D,CGY,24,82,2,14,16
69,8482145,Mavrik Bourque,C,DAL,22,82,2,14,16
69,8482749,Joshua Roy,R,MTL,21,82,6,9,15
69,8474090,Brendan Smith,D,DAL,35,82,5,10,15
69,8482787,Nikita Chibrikov,R,WPG,31,82,4,11,15
69,8476822,Luke Glendening,C,TBL,35,82,10,4,14
69,8482101,Danil Gushchin,L,SJS,22,82,6,8,14
69,8480172,Jan Rutta,D,SJS,34,82,3,11,14
69,8477335,Kyle Burroughs,D,LAK,29,82,3,11,14
69,8480246,Nick Perbix,D,TBL,26,82,2,12,14
69,8475762,Derek Forbort,D,VAN,32,82,1,13,14
69,8483567,Georgii Merkulov,C,BOS,24,82,9,4,13
69,8480025,MacKenzie Entwistle,R,FLA,25,82,7,6,13
69,8481699,Aku Raty,R,UTA,23,82,6,7,13
69,8480990,Declan Chisholm,D,MIN,24,82,5,8,13
69,8482807,Ethan Del Mastro,D,CHI,21,82,6,6,12
69,8483466,Kevin Korchinski,D,CHI,20,82,5,7,12
69,8482858,Ryker Evans,D,SEA,23,82,4,8,12
69,8484911,Collin Graf,R,SJS,22,82,3,9,12
69,8483460,David Jiricek,D,CBJ,21,82,3,9,12
69,8474062,Riley Nash,C,NYR,35,82,3,9,12
69,8475718,Justin Holl,D,DET,32,82,2,10,12
69,8480834,Ty Emberson,D,SJS,24,82,2,10,12
69,8480870,Bo Groulx,C,NYR,24,82,7,4,11
69,8477938,Haydn Fleury,D,WPG,28,82,5,6,11
69,8479638,Justin Brazeau,R,BOS,26,82,5,6,11
69,8480789,Oliver Wahlstrom,R,NYI,24,82,3,8,11
69,8474612,Travis Hamonic,D,OTT,34,82,3,8,11
69,8477365,Connor Clifton,D,BUF,29,82,2,9,11
69,8479291,Kevin Rooney,C,CGY,31,82,8,2,10
69,8482118,Sam Colangelo,R,ANA,23,82,4,6,10
69,8471677,Jack Johnson,D,CBJ,37,82,3,7,10
69,8483471,Brad Lambert,C,WPG,31,82,2,8,10
69,8483012,Logan Morrison,C,SEA,22,82,1,9,10
69,8477505,Alexander Wennberg,C,SJS,30,82,6,3,9
69,8482070,Mitchell Chaffee,R,TBL,26,82,5,4,9
69,8479576,Vincent Desharnais,D,VAN,28,82,2,7,9
69,8482712,Oskar Olausson,R,COL,22,82,4,4,8
69,8483493,Frank Nazar,C,CHI,20,82,3,5,8
69,8478450,Parker Wotherspoon,D,BOS,27,82,1,7,8
69,8477034,Jaycob Megna,D,FLA,32,82,2,5,7
69,8476473,Connor Murphy,D,CHI,31,82,2,4,6
69,8470794,Joe Pavelski,C,,40,0,0,0,0
69,8481703,Valtteri Puustinen,R,PIT,25,0,0,0,0
69,8477950,Tony DeAngelo,D,,29,0,0,0,0
69,8481577,Philip Tomasino,C,NSH,23,0,0,0,0
69,8475197,Tyson Barrie,D,,33,0,0,0,0
69,8471218,Blake Wheeler,R,,38,0,0,0,0
69,8474157,Max Pacioretty,L,,36,0,0,0,0
69,8478466,Daniel Sprong,R,VAN,27,0,0,0,0
69,8475744,Evgeny Kuznetsov,C,,32,0,0,0,0
69,8481019,David Gustafsson,C,WPG,24,0,0,0,0
69,8475906,John Klingberg,D,,32,0,0,0,0
69,8479348,Kale Clague,D,BUF,26,0,0,0,0
69,8476952,Dominic Toninato,C,WPG,30,0,0,0,0
69,8473473,Milan Lucic,L,,36,0,0,0,0
69,8474037,James van Riemsdyk,L,,35,0,0,0,0
69,8474602,Justin Schultz,D,,34,0,0,0,0
69,8482222,Alexander Barabanov,L,,30,0,0,0,0
69,8479372,Josh Mahura,D,SEA,26,0,0,0,0
69,8479982,Conor Timmins,D,TOR,26,0,0,0,0
69,8474031,Kevin Shattenkirk,D,,35,0,0,0,0
69,8480008,Adam Ruzicka,C,,25,0,0,0,0
69,8481059,Scott Perunovich,D,STL,26,0,0,0,0
69,8480884,Calen Addison,D,,24,0,0,0,0
69,8476994,Vinnie Hinostroza,C,NSH,30,0,0,0,0
69,8478452,Caleb Jones,D,LAK,27,0,0,0,0
69,8480157,Calle Rosen,D,COL,30,0,0,0,0
69,8481609,Vladislav Kolyachonok,D,UTA,23,0,0,0,0
69,8479415,Michael McLeod,C,,26,0,0,0,0
69,8476919,Chris Tierney,C,,30,0,0,0,0
69,8479639,Dylan Coghlan,D,WPG,26,0,0,0,0
69,8478146,Matthew Highmore,C,OTT,28,0,0,0,0
69,8478970,Jalen Chatfield,D,CAR,28,0,0,0,0
69,8480205,Emil Bemstrom,C,PIT,25,0,0,0,0
69,8474884,Mike Hoffman,C,,35,0,0,0,0
69,8471274,Alex Goligoski,D,,39,0,0,0,0
69,8478104,Sammy Blais,L,,28,0,0,0,0
69,8474870,Tyler Johnson,C,,34,0,0,0,0
69,8476913,Devin Shore,C,MIN,30,0,0,0,0
69,8481598,Philip Broberg,D,EDM,23,0,0,0,0
69,8480058,Pierre-Olivier Joseph,D,STL,25,0,0,0,0
69,8480891,Michael Kesselring,D,UTA,24,0,0,0,0
69,8477979,Nicolas Aube-Kubel,R,BUF,28,0,0,0,0
69,8476871,Tanner Pearson,L,,32,0,0,0,0
69,8476393,Nick Cousins,C,,31,0,0,0,0
69,8479977,Kailer Yamamoto,R,,26,0,0,0,0
69,8479543,Michael Pezzetta,L,MTL,26,0,0,0,0
69,8477018,Ben Hutton,D,VGK,31,0,0,0,0
69,8480762,Eric Robinson,L,CAR,29,0,0,0,0
69,8474034,Pat Maroon,L,CHI,36,0,0,0,0
69,8481058,Jesse Ylönen,R,,25,0,0,0,0
69,8475179,Dmitry Kulikov,D,FLA,34,0,0,0,0
69,8481527,Kaedan Korczak,D,VGK,23,0,0,0,0
69,8473449,Kyle Okposo,R,,36,0,0,0,0
69,8482192,Isaak Phillips,D,CHI,23,0,0,0,0
69,8480727,Zach Whitecloud,D,VGK,28,0,0,0,0
69,8479346,Dillon Dube,C,,26,0,0,0,0
69,8480821,Filip Zadina,R,,25,0,0,0,0
69,8480001,Urho Vaakanainen,D,ANA,25,0,0,0,0
69,8470966,Mark Giordano,D,,41,0,0,0,0
69,8480853,Liam Foudy,C,,24,0,0,0,0
69,8475225,Craig Smith,C,CHI,35,0,0,0,0
69,8479972,Mason Shaw,C,WPG,26,0,0,0,0
69,8478451,Ethan Bear,D,WSH,27,0,0,0,0
69,8474040,Sam Gagner,C,,35,0,0,0,0
69,8480196,Jacob Bryson,D,BUF,27,0,0,0,0
69,8479984,Cal Foote,D,,26,0,0,0,0
69,8480011,Klim Kostin,C,SJS,25,0,0,0,0
69,8482176,Wyatt Kaiser,D,CHI,22,0,0,0,0
69,8476988,Matt Benning,D,SJS,30,0,0,0,0
69,8479370,Tyson Jost,C,CAR,26,0,0,0,0
69,8477464,Nic Petan,C,,29,0,0,0,0
69,8477380,Jonny Brodzinski,C,NYR,31,0,0,0,0
69,8480070,Ian Mitchell,D,BOS,25,0,0,0,0
69,8479315,Joey Anderson,R,CHI,26,0,0,0,0
69,8478099,Kevin Labanc,R,,29,0,0,0,0
69,8476874,Olli Maatta,D,DET,30,0,0,0,0
69,8475208,Brian Dumoulin,D,ANA,33,0,0,0,0
69,8478430,Oliver Kylington,D,,27,0,0,0,0
69,8479536,Axel Jonsson-Fjallby,L,WPG,26,0,0,0,0
69,8479671,Mathieu Olivier,R,CBJ,27,0,0,0,0
69,8471709,Marc-Edouard Vlasic,D,SJS,37,0,0,0,0
69,8479328,Julien Gauthier,R,NYI,27,0,0,0,0
69,8478421,A.J. Greer,L,FLA,28,0,0,0,0
69,8477573,Nathan Walker,L,STL,30,0,0,0,0
69,8481537,Nikita Okhotiuk,D,CGY,24,0,0,0,0
69,8474166,Alec Martinez,D,CHI,37,0,0,0,0
69,8470610,Zach Parise,L,,40,0,0,0,0
69,8477478,William Carrier,L,CAR,30,0,0,0,0
69,8479344,Jesse Puljujarvi,R,PIT,26,0,0,0,0
69,8480887,Jordan Harris,D,MTL,24,0,0,0,0
69,8478502,Dennis Gilbert,D,BUF,28,0,0,0,0
69,8482730,Brandt Clarke,D,LAK,21,0,0,0,0
69,8480355,Mark Kastelic,C,BOS,25,0,0,0,0
69,8475750,Jon Merrill,D,MIN,32,0,0,0,0
69,8475164,Jakob Silfverberg,R,,34,0,0,0,0
69,8477944,Jakub Vrana,L,,28,0,0,0,0
69,8479439,Jacob MacDonald,D,COL,31,0,0,0,0
69,8474568,Luke Schenn,D,NSH,35,0,0,0,0
69,8478454,Noah Juulsen,D,VAN,27,0,0,0,0
69,8475752,Tyler Pitlick,C,,33,0,0,0,0
69,8482148,Hendrix Lapierre,C,WSH,22,0,0,0,0
69,8481167,Brayden Pachal,D,CGY,25,0,0,0,0
69,8478043,Sam Lafferty,C,BUF,29,0,0,0,0
69,8479321,Lucas Johansen,D,,27,0,0,0,0
69,8471699,Andrew Cogliano,C,,37,0,0,0,0
69,8481521,Ronnie Attard,D,PHI,25,0,0,0,0
69,8481161,Jake Christiansen,D,CBJ,25,0,0,0,0
69,8479458,Nikita Zaitsev,D,,33,0,0,0,0
69,8479619,Michael Carcone,L,UTA,28,0,0,0,0
69,8479026,Philippe Myers,D,TOR,27,0,0,0,0
69,8477330,Dominik Kubalik,L,,29,0,0,0,0
69,8481617,Vasily Podkolzin,R,VAN,23,0,0,0,0
69,8481701,Santeri Hatakka,D,NJD,23,0,0,0,0
69,8479514,Rem Pitlick,C,,27,0,0,0,0
69,8477446,Michael McCarron,R,NSH,29,0,0,0,0
69,8470604,Jeff Carter,C,,39,0,0,0,0
69,8482241,Radim Zohorna,L,,28,0,0,0,0
69,8480289,Morgan Barron,C,WPG,26,0,0,0,0
69,8479379,Givani Smith,R,SJS,26,0,0,0,0
69,8480216,Jacob Peterson,C,,25,0,0,0,0
69,8477851,Jordan Oesterle,D,BOS,32,0,0,0,0
69,8484258,Sam Malinski,D,COL,26,0,0,0,0
69,8478904,Steven Lorentz,C,,28,0,0,0,0
69,8482095,Tyler Kleven,D,OTT,22,0,0,0,0
69,8480848,Ty Dellandrea,C,SJS,24,0,0,0,0
69,8476884,Derrick Pouliot,D,,30,0,0,0,0
69,8479336,Carl Grundstrom,R,SJS,27,0,0,0,0
69,8482964,Arber Xhekaj,D,MTL,23,0,0,0,0
69,8471686,Marc Staal,D,,37,0,0,0,0
69,8477887,Patrick Brown,C,BOS,32,0,0,0,0
69,8478495,Denis Gurianov,R,,27,0,0,0,0
69,8473504,Cal Clutterbuck,R,,37,0,0,0,0
69,8481550,Adam Beckman,L,NJD,23,0,0,0,0
69,8480845,Rasmus Kupari,C,WPG,24,0,0,0,0
69,8474009,Nick Bonino,C,,36,0,0,0,0
69,8478585,Derek Ryan,C,EDM,38,0,0,0,0
69,8477962,Brendan Lemieux,L,CAR,28,0,0,0,0
69,8482861,Vincent Iorio,D,WSH,22,0,0,0,0
69,8479378,Logan Stanley,D,WPG,26,0,0,0,0
69,8473446,Erik Johnson,D,PHI,36,0,0,0,0
69,8481743,Marc Del Gaizo,D,NSH,25,0,0,0,0
69,8477384,Josh Brown,D,EDM,30,0,0,0,0
69,8482165,Yan Kuznetsov,D,CGY,22,0,0,0,0
69,8478424,Jansen Harkins,C,ANA,27,0,0,0,0
69,8482144,Jack Thompson,D,SJS,22,0,0,0,0
69,8478512,Austin Czarnik,C,,32,0,0,0,0
69,8477527,Ross Johnston,L,ANA,30,0,0,0,0
69,8479383,Boris Katchouk,L,,26,0,0,0,0
69,8482094,Daemon Hunt,D,MIN,22,0,0,0,0
69,8481719,Maxwell Crozier,D,TBL,24,0,0,0,0
69,8480192,Johnathan Kovacevic,D,NJD,27,0,0,0,0
69,8479376,Victor Mete,D,,26,0,0,0,0
69,8482511,Mason Lohrei,D,BOS,23,0,0,0,0
69,8475825,Jani Hakanpää,D,,32,0,0,0,0
69,8478021,William Lagesson,D,DET,28,0,0,0,0
69,8475795,Dylan McIlrath,D,WSH,32,0,0,0,0
69,8477846,Ryan Carpenter,C,,33,0,0,0,0
69,8481056,Spencer Stastney,D,NSH,24,0,0,0,0
69,8481564,Ryan Johnson,D,BUF,23,0,0,0,0
69,8478017,Mark Friedman,D,VAN,29,0,0,0,0
69,8479320,Max Lajoie,D,SEA,27,0,0,0,0
69,8480075,Cameron Crotty,D,MIN,25,0,0,0,0
69,8484287,Cole McWard,D,VAN,23,0,0,0,0
69,8484254,Akito Hirose,D,VAN,25,0,0,0,0
69,8483407,Brandon Scanlin,D,NYR,25,0,0,0,0
69,8480274,Philip Kemp,D,EDM,25,0,0,0,0
69,8479522,Hardy Haman Aktell,D,WSH,26,0,0,0,0
69,8480007,Jonas Rondbjerg,R,VGK,25,0,0,0,0
69,8477454,Adam Erne,L,,29,0,0,0,0
69,8481679,Maxence Guenette,D,OTT,23,0,0,0,0
69,8480441,Trey Fix-Wolansky,R,CBJ,25,0,0,0,0
69,8483546,Marshall Rifai,D,TOR,26,0,0,0,0
69,8480084,Nick DeSimone,D,NJD,30,0,0,0,0
69,8481030,Jack St. Ivany,D,PIT,25,0,0,0,0
69,8481592,Jakob Pelletier,L,CGY,23,0,0,0,0
69,8478011,Louie Belpedio,D,PHI,28,0,0,0,0
69,8477930,Pierre-Edouard Bellemare,L,,39,0,0,0,0
69,8484321,Nikolas Matinpalo,D,OTT,26,0,0,0,0
69,8482067,Connor Mackey,D,NYR,28,0,0,0,0
69,8481806,Louis Crevier,D,CHI,23,0,0,0,0
69,8484326,Patrik Koch,D,UTA,28,0,0,0,0
69,8477971,Andreas Englund,D,LAK,28,0,0,0,0
69,8481751,Lukas Rousek,R,BUF,25,0,0,0,0
69,8481006,Tyler Tucker,D,STL,24,0,0,0,0
69,8476867,Brendan Gaunce,C,MIN,30,0,0,0,0
69,8479520,Brandon Duhaime,R,WSH,27,0,0,0,0
69,8477073,Kurtis MacDermid,L,NJD,30,0,0,0,0
69,8480874,Adam Ginning,D,PHI,24,0,0,0,0
69,8477473,Justin Bailey,R,SJS,29,0,0,0,0
69,8479066,Ryan Lomberg,L,CGY,30,0,0,0,0
69,8477070,Liam O'Brien,C,UTA,30,0,0,0,0
69,8474618,Marco Scandella,D,,34,0,0,0,0
69,8475797,Jarred Tinordi,D,,32,0,0,0,0
69,8481441,Joe Snively,C,DET,28,0,0,0,0
69,8477244,Chad Ruhwedel,D,NYR,34,0,0,0,0
69,8479772,Zack MacEwen,R,OTT,28,0,0,0,0
69,8481147,Reese Johnson,C,MIN,26,0,0,0,0
69,8481043,Cole Koepke,L,BOS,26,0,0,0,0
69,8483619,Filip Roos,D,OTT,25,0,0,0,0
69,8481541,Samuel Bolduc,D,NYI,24,0,0,0,0
69,8477810,Joel Hanley,D,CGY,33,0,0,0,0
69,8476907,Mackenzie MacEachern,L,,30,0,0,0,0
69,8482652,Walker Duehr,R,CGY,27,0,0,0,0
69,8477126,Jayson Megna,C,,34,0,0,0,0
69,8483398,Declan Carlile,D,TBL,31,0,0,0,0
69,8482929,Emil Lilleberg,D,TBL,23,0,0,0,0
69,8480880,Jakub Lauko,C,MIN,24,0,0,0,0
69,8480245,Olle Lycksell,R,PHI,25,0,0,0,0
69,8480252,Cole Guttman,C,CHI,25,0,0,0,0
69,8477467,Gustav Olofsson,D,SEA,30,0,0,0,0
69,8479968,Vinni Lettieri,C,BOS,29,0,0,0,0
69,8478400,Colin White,C,,27,0,0,0,0
69,8475755,Alexander Petrovic,D,DAL,32,0,0,0,0
69,8481812,Nikolai Knyzhov,D,,27,0,0,0,0
69,8481593,Jayden Struble,D,MTL,23,0,0,0,0
69,8481532,Alex Turcotte,C,LAK,23,0,0,0,0
69,8482126,Emil Andrae,D,PHI,31,0,0,0,0
69,8479944,Zach Aston-Reese,C,VGK,30,0,0,0,0
69,8471817,Ryan Reaves,R,TOR,37,0,0,0,0
69,8481206,John Ludvig,D,PIT,24,0,0,0,0
69,8481599,Victor Soderstrom,D,UTA,23,0,0,0,0
69,8480292,Carson Meyer,R,ANA,27,0,0,0,0
69,8482496,Nils Aman,C,VAN,24,0,0,0,0
69,8479718,Alex Barré-Boulet,C,MTL,27,0,0,0,0
69,8479994,Jaret Anderson-Dolan,C,WPG,25,0,0,0,0
69,8480184,Gustav Lindstrom,D,,26,0,0,0,0
69,8480890,Jan Jenik,R,OTT,24,0,0,0,0
69,8478067,Oskar Lindblom,L,,28,0,0,0,0
69,8476934,Brock McGinn,L,ANA,30,0,0,0,0
69,8479985,Cale Fleury,D,SEA,26,0,0,0,0
69,8484304,Uvis Balinskis,D,FLA,28,0,0,0,0
69,8479981,Jonah Gadjovich,L,FLA,26,0,0,0,0
69,8481716,Dmitri Voronkov,L,CBJ,24,0,0,0,0
69,8474709,Matt Martin,L,,35,0,0,0,0
69,8482634,Alex Steeves,C,TOR,25,0,0,0,0
69,8480823,Alexander Alexeyev,D,WSH,25,0,0,0,0
69,8477541,Dakota Mermis,D,TOR,30,0,0,0,0
69,8483491,Ivan Miroshnichenko,L,WSH,20,0,0,0,0
69,8478477,Mitchell Stephens,C,SEA,27,0,0,0,0
69,8481543,Nikita Alexandrov,C,STL,24,0,0,0,0
69,8479423,Alex Nylander,L,,26,0,0,0,0
69,8482451,Mikael Pyyhtia,L,CBJ,23,0,0,0,0
69,8478831,Kevin Stenlund,C,UTA,28,0,0,0,0
69,8480306,Grant Hutton,D,NYI,29,0,0,0,0
69,8478028,Fredrik Olofsson,L,,28,0,0,0,0
69,8477462,Robert Hagg,D,VGK,29,0,0,0,0
69,8477320,Anton Blidh,L,NYR,29,0,0,0,0
69,8482157,Will Cuylle,L,NYR,22,0,0,0,0
69,8482737,Zack Bolduc,C,STL,21,0,0,0,0
69,8481239,Samuel Fagemo,L,,24,0,0,0,0
69,8481600,Tobias Bjornfot,D,FLA,23,0,0,0,0
69,8478409,Anthony Richard,C,PHI,28,0,0,0,0
69,8474145,Robert Bortuzzo,D,,35,0,0,0,0
69,8475958,Michael Sgarbossa,C,WSH,32,0,0,0,0
69,8479986,Kole Lind,R,DAL,26,0,0,0,0
69,8479249,Andrew Poturalski,C,SJS,30,0,0,0,0
69,8479362,Riley Tufte,L,BOS,26,0,0,0,0
69,8479991,Jake Leschyshyn,C,NYR,25,0,0,0,0
69,8479587,Rhett Gardner,C,PHI,28,0,0,0,0
69,8482744,James Malatesta,L,CBJ,21,0,0,0,0
69,8478854,Ryan Shea,D,PIT,27,0,0,0,0
69,8481591,Sam Poulin,R,,23,0,0,0,0
69,8483512,Matt Savoie,C,EDM,20,0,0,0,0
69,8482102,Vasily Ponomarev,C,PIT,22,0,0,0,0
69,8482162,Roby Jarventie,L,EDM,22,0,0,0,0
69,8481016,Ruslan Iskhakov,C,,24,0,0,0,0
69,8482172,Landon Slaggert,L,CHI,22,0,0,0,0
69,8482747,Brennan Othmann,L,NYR,21,0,0,0,0
69,8480031,Maxime Comtois,L,,25,0,0,0,0
69,8480226,Marián Studenic,R,,26,0,0,0,0
69,8478408,Travis Dermott,D,,28,0,0,0,0
69,8481518,Nolan Foote,L,NJD,24,0,0,0,0
69,8479419,Brett Murray,L,BUF,26,0,0,0,0
69,8482088,Justin Sourdif,R,FLA,22,0,0,0,0
69,8482201,Gage Goncalves,C,TBL,23,0,0,0,0
69,8481578,Graeme Clarke,R,MIN,23,0,0,0,0
69,8482177,Marat Khusnutdinov,C,MIN,22,0,0,0,0
69,8481754,Nikita Nesterenko,C,ANA,23,0,0,0,0
69,8483531,Brian Halonen,L,NJD,25,0,0,0,0
69,8483920,Pierrick Dube,R,WSH,23,0,0,0,0
69,8480851,Akil Thomas,C,LAK,24,0,0,0,0
69,8475235,Nicolas Deslauriers,L,PHI,33,0,0,0,0
69,8482476,Emil Heineman,L,MTL,23,0,0,0,0
69,8477149,Scott Sabourin,R,SJS,32,0,0,0,0
69,8483549,Lucas Condotta,L,MTL,27,0,0,0,0
69,8482765,Isak Rosen,R,BUF,21,0,0,0,0
69,8481237,Kyle MacLean,C,NYI,25,0,0,0,0
69,8481024,Linus Karlsson,C,VAN,25,0,0,0,0
69,8481690,Tyler Angle,C,,24,0,0,0,0
69,8483570,Ben Meyers,C,SEA,26,0,0,0,0
69,8481655,Cole Schwindt,R,CGY,23,0,0,0,0
69,8481462,Mason Morelli,L,VGK,28,0,0,0,0
69,8483401,Marc Johnstone,R,PIT,28,0,0,0,0
69,8478956,Samuel Laberge,L,NJD,27,0,0,0,0
69,8479533,Joona Koppanen,L,,26,0,0,0,0
69,8482197,Adam Raska,R,MIN,23,0,0,0,0
69,8482250,Callahan Burke,C,VGK,27,0,0,0,0
69,8482784,Zach Dean,C,STL,21,0,0,0,0
69,8484255,Jason Polin,R,COL,25,0,0,0,0
69,8481077,John Leonard,L,,26,0,0,0,0
69,8481534,Raphael Lavoie,C,EDM,24,0,0,0,0
69,8483609,Adam Klapka,R,CGY,24,0,0,0,0
69,8482751,Ryan Winterton,C,SEA,21,0,0,0,0
69,8480267,Sammy Walker,C,MIN,25,0,0,0,0
69,8475766,Austin Watson,L,,32,0,0,0,0
69,8482460,Matt Rempe,C,NYR,22,0,0,0,0
69,8481065,Angus Crookshank,L,OTT,25,0,0,0,0
69,8481070,Hugh McGing,L,,26,0,0,0,0
69,8476323,Max McCormick,L,SEA,32,0,0,0,0
69,8483395,Arshdeep Bains,L,VAN,23,0,0,0,0
69,8484259,Ondrej Pavel,C,COL,31,0,0,0,0
69,8483432,Luca Del Bel Belluz,C,CBJ,31,0,0,0,0
69,8483045,Cameron Butler,R,CBJ,31,0,0,0,0
69,8482061,Brandon Biro,L,SEA,26,0,0,0,0
69,8477401,John Hayden,C,SEA,29,0,0,0,0
69,8475278,Byron Froese,C,,33,0,0,0,0
69,8478446,Glenn Gawdin,C,LAK,27,0,0,0,0
69,8477993,Justin Kirkland,C,CGY,28,0,0,0,0
69,8482147,Jean-Luc Foudy,C,COL,22,0,0,0,0
69,8480032,Shane Bowers,C,NJD,25,0,0,0,0
69,8479330,Brandon Gignac,C,MTL,27,0,0,0,0
69,8480776,Sheldon Rempal,R,,29,0,0,0,0
69,8475413,Justin Dowling,C,NJD,34,0,0,0,0
69,8481726,Adam Edstrom,C,NYR,24,0,0,0,0
69,8480844,Grigori Denisenko,L,VGK,24,0,0,0,0
69,8478147,Bokondji Imama,L,PIT,28,0,0,0,0
69,8478881,Brett Seney,L,CHI,28,0,0,0,0
69,8483630,Pavol Regenda,L,ANA,25,0,0,0,0
69,8480836,Jonathan Gruden,C,,24,0,0,0,0
69,8484314,Jiri Smejkal,L,,28,0,0,0,0
69,8475780,Chris Wagner,R,COL,33,0,0,0,0
69,8479546,Oskar Steen,C,,26,0,0,0,0
69,8483597,Milos Kelemen,L,UTA,25,0,0,0,0
69,8481789,Tye Kartye,L,SEA,23,0,0,0,0
69,8484325,Waltteri Merela,C,TBL,26,0,0,0,0
69,8479421,Jacob Moverare,D,LAK,26,0,0,0,0
69,8481585,Egor Afanasyev,L,SJS,23,0,0,0,0
69,8479547,Matthew Phillips,R,,26,0,0,0,0
69,8479367,William Lockwood,R,FLA,26,0,0,0,0
69,8476915,Jujhar Khaira,L,,30,0,0,0,0
69,8481422,Jacob Lucchini,C,NSH,29,0,0,0,0
69,8480468,James Hamblin,L,EDM,25,0,0,0,0
69,8478051,Max Willman,C,NJD,29,0,0,0,0
69,8481556,John Beecher,C,BOS,23,0,0,0,0
69,8478078,Rourke Chartier,C,,28,0,0,0,0
70,8476453,Nikita Kucherov,R,TBL,31,82,46,97,143
70,8478402,Connor McDavid,C,EDM,27,82,52,87,139
70,8477956,David Pastrnak,R,BOS,28,82,63,70,133
70,8479318,Auston Matthews,C,TOR,27,82,64,55,119
70,8477942,Kevin Fiala,L,LAK,28,82,39,80,119
70,8476468,J.T. Miller,C,VAN,31,82,34,84,118
70,8479314,Matthew Tkachuk,L,FLA,27,82,46,68,114
70,8478550,Artemi Panarin,L,NYR,33,82,31,79,110
70,8480012,Elias Pettersson,C,VAN,26,82,41,65,106
70,8481559,Jack Hughes,C,NJD,23,82,47,57,104
70,8477939,William Nylander,R,TOR,28,82,51,52,103
70,8477492,Nathan MacKinnon,C,COL,29,82,39,64,103
70,8478864,Kirill Kaprizov,L,MIN,27,82,37,65,102
70,8478420,Mikko Rantanen,R,COL,28,82,34,68,102
70,8478398,Kyle Connor,L,WPG,28,82,45,56,101
70,8477934,Leon Draisaitl,C,EDM,29,82,38,62,100
70,8478493,Joel Eriksson Ek,C,MIN,27,82,48,49,97
70,8477946,Dylan Larkin,C,DET,28,82,44,52,96
70,8476887,Filip Forsberg,L,NSH,30,82,43,52,95
70,8477493,Aleksander Barkov,C,FLA,29,82,15,80,95
70,8480800,Quinn Hughes,D,VAN,25,82,12,83,95
70,8478010,Brayden Point,C,TBL,28,82,43,51,94
70,8480002,Nico Hischier,C,NJD,25,82,31,63,94
70,8481557,Matt Boldy,L,MIN,23,82,37,54,91
70,8476389,Vincent Trocheck,C,NYR,31,82,54,36,90
70,8473512,Claude Giroux,R,OTT,36,82,31,59,90
70,8479407,Jesper Bratt,L,NJD,26,82,27,63,90
70,8476346,Johnny Gaudreau,L,CBJ,31,82,17,73,90
70,8480801,Brady Tkachuk,L,OTT,25,82,42,47,89
70,8478403,Jack Eichel,C,VGK,28,82,38,51,89
70,8480069,Cale Makar,D,COL,26,82,26,59,85
70,8474600,Roman Josi,D,NSH,34,82,21,64,85
70,8479323,Adam Fox,D,NYR,26,82,14,71,85
70,8477409,Carter Verhaeghe,C,FLA,29,82,43,41,84
70,8477404,Jake Guentzel,C,TBL,30,82,36,48,84
70,8475167,Victor Hedman,D,TBL,34,82,24,60,84
70,8480036,Miro Heiskanen,D,DAL,25,82,20,64,84
70,8478445,Mathew Barzal,C,NYI,27,82,18,66,84
70,8479337,Alex DeBrincat,R,DET,27,82,35,48,83
70,8477933,Sam Reinhart,C,FLA,29,82,50,32,82
70,8471214,Alex Ovechkin,L,WSH,39,82,44,38,82
70,8475786,Zach Hyman,L,EDM,32,82,40,42,82
70,8471675,Sidney Crosby,C,PIT,37,82,29,53,82
70,8475913,Mark Stone,R,VGK,32,82,28,53,81
70,8480208,Drake Batherson,R,OTT,26,82,32,48,80
70,8471685,Anze Kopitar,C,LAK,37,82,26,54,80
70,8480023,Robert Thomas,C,STL,25,82,23,57,80
70,8476460,Mark Scheifele,C,WPG,31,82,31,48,79
70,8474564,Steven Stamkos,C,NSH,34,82,35,43,78
70,8475172,Nazem Kadri,C,CGY,34,82,31,47,78
70,8476454,Ryan Nugent-Hopkins,C,EDM,31,82,28,50,78
70,8481523,Kirby Dach,C,MTL,23,82,20,58,78
70,8478427,Sebastian Aho,C,CAR,27,82,33,44,77
70,8477940,Nikolaj Ehlers,L,WPG,28,82,24,53,77
70,8477501,Valeri Nichushkin,R,COL,29,82,48,28,76
70,8482116,Tim Stützle,C,OTT,22,82,22,54,76
70,8475166,John Tavares,C,TOR,34,82,36,39,75
70,8480018,Nick Suzuki,C,MTL,25,82,27,48,75
70,8479542,Brandon Hagel,L,TBL,26,82,35,39,74
70,8480830,Andrei Svechnikov,R,CAR,24,82,33,41,74
70,8475184,Chris Kreider,L,NYR,33,82,45,28,73
70,8480027,Jason Robertson,L,DAL,25,82,35,38,73
70,8476881,Tomas Hertl,C,VGK,31,82,34,39,73
70,8478439,Travis Konecny,R,PHI,27,82,26,47,73
70,8478042,Viktor Arvidsson,R,EDM,31,82,26,47,73
70,8477951,Nick Schmaltz,C,UTA,28,82,24,49,73
70,8473419,Brad Marchand,L,BOS,36,82,36,36,72
70,8475784,Jeff Skinner,C,EDM,32,82,32,40,72
70,8476539,Jonathan Marchessault,R,NSH,34,82,28,44,72
70,8477496,Elias Lindholm,C,BOS,30,82,21,50,71
70,8478460,Zach Werenski,D,CBJ,27,82,18,53,71
70,8476905,Chandler Stephenson,C,SEA,30,82,18,53,71
70,8475810,Bryan Rust,R,PIT,32,82,40,30,70
70,8475158,Ryan O'Reilly,C,NSH,33,82,32,38,70
70,8479343,Clayton Keller,R,UTA,26,82,29,41,70
70,8476459,Mika Zibanejad,C,NYR,31,82,28,41,69
70,8479325,Charlie McAvoy,D,BOS,27,82,20,49,69
70,8476456,Jonathan Huberdeau,C,CGY,31,82,16,53,69
70,8477500,Bo Horvat,C,NYI,29,82,32,36,68
70,8481533,Trevor Zegras,C,ANA,23,82,31,37,68
70,8473994,Jamie Benn,L,DAL,35,82,24,44,68
70,8480865,Noah Dobson,D,NYI,24,82,16,52,68
70,8477447,Shea Theodore,D,VGK,29,82,13,55,68
70,8482078,Lucas Raymond,L,DET,22,82,33,34,67
70,8475692,Mats Zuccarello,R,MIN,37,82,18,49,67
70,8470613,Brent Burns,D,CAR,39,82,15,52,67
70,8474563,Drew Doughty,D,LAK,35,82,13,53,66
70,8477416,Oliver Bjorkstrand,R,SEA,29,82,33,32,65
70,8477407,Anthony Duclair,L,NYI,29,82,28,37,65
70,8480839,Rasmus Dahlin,D,BUF,24,82,19,46,65
70,8474141,Patrick Kane,R,DET,36,82,19,46,65
70,8477504,Josh Morrissey,D,WPG,29,82,14,51,65
70,8477949,Alex Tuch,R,BUF,28,82,18,46,64
70,8474578,Erik Karlsson,D,PIT,34,82,15,49,64
70,8477511,Anthony Mantha,R,CGY,30,82,34,29,63
70,8475754,Brock Nelson,C,NYI,33,82,33,30,63
70,8481528,Dylan Cozens,C,BUF,23,82,31,32,63
70,8479385,Jordan Kyrou,C,STL,26,82,29,34,63
70,8478444,Brock Boeser,R,VAN,27,82,28,35,63
70,8476853,Morgan Rielly,D,TOR,30,82,11,52,63
70,8476432,Boone Jenner,C,CBJ,31,82,35,27,62
70,8476399,Blake Coleman,C,CGY,33,82,35,27,62
70,8478414,Timo Meier,R,NJD,28,82,32,30,62
70,8480039,Martin Necas,C,CAR,25,82,27,35,62
70,8482097,Jack Quinn,R,BUF,23,82,25,37,62
70,8478440,Dylan Strome,C,WSH,27,82,20,42,62
70,8477494,Jonathan Drouin,L,COL,29,82,17,45,62
70,8480803,Evan Bouchard,D,EDM,25,82,10,52,62
70,8478449,Roope Hintz,C,DAL,28,82,30,31,61
70,8475763,Kevin Hayes,R,PIT,32,82,29,32,61
70,8478047,Michael Bunting,L,PIT,29,82,28,33,61
70,8477402,Pavel Buchnevich,L,STL,29,82,26,35,61
70,8478519,Anthony Cirelli,C,TBL,27,82,25,36,61
70,8471215,Evgeni Malkin,C,PIT,38,82,22,39,61
70,8482660,Kent Johnson,C,CBJ,22,82,18,43,61
70,8478873,Troy Terry,R,ANA,27,82,15,46,61
70,8477495,Seth Jones,D,CHI,30,82,14,47,61
70,8474590,John Carlson,D,WSH,34,82,11,50,61
70,8477960,Adrian Kempe,R,LAK,28,82,29,31,60
70,8475726,Tyler Toffoli,C,SJS,32,82,29,31,60
70,8478498,Jake DeBrusk,L,VAN,28,82,27,33,60
70,8480798,Philipp Kurashev,C,CHI,25,82,23,37,60
70,8479425,Filip Hronek,D,VAN,27,82,18,42,60
70,8474150,Mikael Backlund,C,CGY,35,82,15,45,60
70,8477955,Jared McCann,L,SEA,28,82,28,31,59
70,8479420,Tage Thompson,C,BUF,27,82,27,32,59
70,8482093,Seth Jarvis,C,CAR,22,82,25,34,59
70,8471724,Kris Letang,D,PIT,37,82,12,47,59
70,8475765,Vladimir Tarasenko,R,DET,33,82,25,33,58
70,8481068,Yegor Sharangovich,C,CGY,26,82,25,33,58
70,8474102,David Perron,L,OTT,36,82,22,36,58
70,8476448,William Karlsson,C,VGK,31,82,21,37,58
70,8474565,Alex Pietrangelo,D,VGK,34,82,10,48,58
70,8476854,Hampus Lindholm,D,BOS,30,82,9,49,58
70,8480014,Gabriel Vilardi,C,WPG,25,82,33,24,57
70,8482665,Matty Beniers,C,SEA,22,82,21,36,57
70,8482740,Wyatt Johnston,C,DAL,21,82,30,26,56
70,8482159,Tyson Foerster,R,PHI,22,82,29,27,56
70,8477451,Ryan Hartman,R,MIN,30,82,22,34,56
70,8482124,Quinton Byfield,R,LAK,22,82,21,35,56
70,8477935,Sam Bennett,C,FLA,28,82,21,35,56
70,8478396,Noah Hanifin,D,VGK,27,82,16,40,56
70,8478469,Thomas Chabot,D,OTT,27,82,15,41,56
70,8478397,Rasmus Andersson,D,CGY,28,82,13,43,56
70,8476923,Damon Severson,D,CBJ,30,82,6,50,56
70,8479675,Trevor Moore,L,LAK,29,82,30,25,55
70,8479339,Patrik Laine,L,CBJ,26,82,29,26,55
70,8478401,Pavel Zacha,C,BOS,27,82,20,35,55
70,8475168,Matt Duchene,C,DAL,33,82,18,37,55
70,8476792,Torey Krug,D,STL,33,82,17,38,55
70,8476462,Dougie Hamilton,D,NJD,31,82,16,39,55
70,8475798,Mikael Granlund,C,SJS,32,82,14,41,55
70,8475151,Kyle Palmieri,C,NYI,33,82,25,29,54
70,8479400,Pierre-Luc Dubois,L,WSH,26,82,21,33,54
70,8476872,Scott Laughton,C,PHI,30,82,20,34,54
70,8480078,Filip Chytil,C,NYR,25,82,17,37,54
70,8479999,Casey Mittelstadt,C,COL,26,82,15,39,54
70,8480185,Eetu Luostarinen,C,FLA,26,82,24,29,53
70,8480015,Owen Tippett,R,PHI,25,82,23,30,53
70,8475170,Brayden Schenn,C,STL,33,82,20,33,53
70,8476479,Phillip Danault,C,LAK,31,82,19,34,53
70,8474679,Gustav Nyquist,C,NSH,35,82,19,34,53
70,8477503,Max Domi,C,TOR,29,82,16,37,53
70,8480113,Alex Iafallo,L,WPG,31,82,16,37,53
70,8480797,Joel Farabee,L,PHI,24,82,24,28,52
70,8480434,Sean Durzi,D,UTA,26,82,17,35,52
70,8482699,Dylan Guenther,R,UTA,21,82,32,19,51
70,8480064,Josh Norris,C,OTT,25,82,32,19,51
70,8477964,Ivan Barbashev,C,VGK,29,82,27,24,51
70,8483808,Andrei Kuzmenko,L,CGY,28,82,27,24,51
70,8475169,Evander Kane,L,EDM,33,82,23,28,51
70,8479987,Morgan Geekie,C,BOS,26,82,23,28,51
70,8474641,Adam Henrique,C,EDM,34,82,21,30,51
70,8482667,William Eklund,L,SJS,22,82,20,31,51
70,8474586,Jordan Eberle,R,SEA,34,82,19,32,51
70,8475745,Charlie Coyle,C,BOS,32,82,18,33,51
70,8482149,Cole Perfetti,C,WPG,22,82,17,34,51
70,8481711,Matias Maccelli,L,UTA,24,82,15,36,51
70,8477986,Brandon Montour,D,SEA,30,82,15,36,51
70,8478057,Dakota Joshua,C,VAN,28,82,26,24,50
70,8478462,Nicolas Roy,C,VGK,27,82,19,31,50
70,8477932,Aaron Ekblad,D,FLA,28,82,18,32,50
70,8476826,Yanni Gourde,C,SEA,33,82,16,34,50
70,8477346,MacKenzie Weegar,D,CGY,30,82,13,37,50
70,8481542,Moritz Seider,D,DET,23,82,10,40,50
70,8482684,Luke Hughes,D,NJD,21,82,7,43,50
70,8481540,Cole Caufield,R,MTL,23,82,25,24,49
70,8481618,Alex Newhook,C,MTL,23,82,23,26,49
70,8480028,Morgan Frost,C,PHI,25,82,22,27,49
70,8476880,Tom Wilson,R,WSH,30,82,22,27,49
70,8477456,J.T. Compher,L,DET,29,82,20,29,49
70,8482113,Anton Lundell,C,FLA,23,82,20,29,49
70,8476882,Teuvo Teravainen,L,CHI,30,82,17,32,49
70,8473986,Alex Killorn,L,ANA,35,82,16,33,49
70,8482175,JJ Peterka,R,BUF,22,82,28,20,48
70,8481596,Shane Pinto,C,OTT,24,82,15,33,48
70,8478438,Tommy Novak,C,NSH,27,82,15,33,48
70,8478407,Vince Dunn,D,SEA,28,82,13,35,48
70,8478458,Jack Roslovic,C,CAR,27,82,13,35,48
70,8478366,Frank Vatrano,R,ANA,30,82,28,19,47
70,8477476,Artturi Lehkonen,L,COL,29,82,21,26,47
70,8475314,Anders Lee,L,NYI,34,82,30,16,46
70,8479525,Ross Colton,C,COL,28,82,27,19,46
70,8475149,Marcus Johansson,L,MIN,34,82,23,23,46
70,8482092,Ridly Greig,C,OTT,22,82,20,26,46
70,8476483,Rickard Rakell,R,PIT,31,82,18,28,46
70,8480188,Fabian Zetterlund,L,SJS,25,82,18,28,46
70,8475794,Tyler Seguin,C,DAL,32,82,16,30,46
70,8476292,Ondrej Palat,L,NJD,33,82,13,33,46
70,8480145,Neal Pionk,D,WPG,29,82,12,34,46
70,8478038,Devon Toews,D,COL,30,82,10,36,46
70,8478055,Gustav Forsling,D,FLA,28,82,10,36,46
70,8478975,Mason Marchment,L,DAL,29,82,19,26,45
70,8475855,Jesper Fast,R,CAR,33,82,19,26,45
70,8476461,Sean Couturier,C,PHI,32,82,18,27,45
70,8474149,Evgenii Dadonov,R,DAL,35,82,16,29,45
70,8478542,Evan Rodrigues,C,FLA,31,82,14,31,45
70,8479410,Mikhail Sergachev,D,UTA,26,82,11,34,45
70,8475218,Mattias Ekholm,D,EDM,34,82,11,34,45
70,8475799,Nino Niederreiter,R,WPG,32,82,33,11,44
70,8481604,Pavel Dorofeyev,L,VGK,24,82,27,17,44
70,8477479,Tyler Bertuzzi,L,CHI,29,82,19,25,44
70,8480802,Ryan McLeod,C,BUF,25,82,19,25,44
70,8476925,Colton Sissons,C,NSH,31,82,18,26,44
70,8482109,Alexis Lafrenière,L,NYR,23,82,17,27,44
70,8477429,Andrew Copp,C,DET,30,82,16,28,44
70,8476906,Shayne Gostisbehere,D,CAR,31,82,13,31,44
70,8478891,Mason Appleton,C,WPG,28,82,13,31,44
70,8480873,Rasmus Sandin,D,WSH,24,82,9,35,44
70,8471698,T.J. Oshie,R,WSH,38,82,24,19,43
70,8482110,Dawson Mercer,C,NJD,23,82,24,19,43
70,8476981,Josh Anderson,R,MTL,30,82,24,19,43
70,8482745,Mason McTavish,C,ANA,21,82,21,22,43
70,8479365,Trent Frederic,C,BOS,26,82,20,23,43
70,8482475,Yegor Chinakhov,R,CBJ,23,82,20,23,43
70,8475793,Ryan Johansen,C,PHI,32,82,19,24,43
70,8475753,Justin Faulk,D,STL,32,82,12,31,43
70,8479941,Justin Danforth,R,CBJ,31,82,21,21,42
70,8475722,Jason Zucker,L,BUF,32,82,17,25,42
70,8478413,Jordan Greenway,L,BUF,27,82,16,26,42
70,8477497,Sean Monahan,C,CBJ,30,82,15,27,42
70,8479345,Jakob Chychrun,D,WSH,26,82,13,29,42
70,8480871,Adam Boqvist,D,FLA,24,82,8,34,42
70,8478020,Michael Amadio,C,OTT,28,82,24,17,41
70,8482055,Drew O'Connor,L,PIT,26,82,22,19,41
70,8475848,Brendan Gallagher,R,MTL,32,82,22,19,41
70,8477498,Darnell Nurse,D,EDM,29,82,21,20,41
70,8479992,Michael Rasmussen,C,DET,25,82,19,22,41
70,8475791,Taylor Hall,L,CHI,33,82,19,22,41
70,8474716,Jared Spurgeon,D,MIN,35,82,12,29,41
70,8476329,Travis Boyd,C,MIN,31,82,9,32,41
70,8478474,Lawson Crouse,L,UTA,27,82,24,16,40
70,8480009,Eeli Tolvanen,R,SEA,25,82,21,19,40
70,8482146,Luke Evangelista,R,NSH,22,82,19,21,40
70,8476927,Teddy Blueger,C,VAN,30,82,19,21,40
70,8481535,Nils Hoglander,L,VAN,24,82,17,23,40
70,8480748,Kiefer Sherwood,L,VAN,29,82,15,25,40
70,8475714,Calle Jarnkrok,C,TOR,33,82,13,27,40
70,8476480,Vladislav Namestnikov,C,WPG,32,82,13,27,40
70,8475191,Reilly Smith,R,NYR,33,82,12,28,40
70,8477444,Andre Burakovsky,L,SEA,29,82,11,29,40
70,8477948,Travis Sanheim,D,PHI,28,82,10,30,40
70,8482671,Owen Power,D,BUF,22,82,10,30,40
70,8476869,Brady Skjei,D,NSH,30,82,6,34,40
70,8478046,Danton Heinen,L,VAN,29,82,22,17,39
70,8484144,Connor Bedard,C,CHI,19,82,22,17,39
70,8482705,Cole Sillinger,C,CBJ,21,82,20,19,39
70,8477998,Warren Foegele,L,LAK,28,82,19,20,39
70,8474053,Logan Couture,C,SJS,35,82,19,20,39
70,8479996,Cody Glass,C,NSH,25,82,19,20,39
70,8478463,Anthony Beauvillier,L,PIT,27,82,13,26,39
70,8481581,Thomas Harley,D,DAL,23,82,12,27,39
70,8475760,Nick Bjugstad,C,UTA,32,82,20,18,38
70,8478856,Conor Garland,R,VAN,28,82,16,22,38
70,8481013,Jonatan Berggren,R,DET,24,82,16,22,38
70,8477021,Alex Kerfoot,C,UTA,30,82,11,27,38
70,8477426,Nicholas Paul,L,TBL,29,82,21,16,37
70,8482125,Alexander Holtz,R,VGK,22,82,17,20,37
70,8482074,Connor Zary,C,CGY,23,82,17,20,37
70,8476419,Jean-Gabriel Pageau,C,NYI,32,82,15,22,37
70,8473422,Nick Foligno,L,CHI,37,82,15,22,37
70,8478233,Andrew Mangiapane,L,WSH,28,82,14,23,37
70,8482624,Daniil Miromanov,D,CGY,27,82,12,25,37
70,8482105,Jake Sanderson,D,OTT,22,82,11,26,37
70,8476885,Jacob Trouba,D,NYR,30,82,10,27,37
70,8482142,Jamie Drysdale,D,PHI,22,82,9,28,37
70,8476875,Mike Matheson,D,MTL,30,82,8,29,37
70,8481032,Paul Cotter,C,NJD,25,82,20,16,36
70,8481582,Nicholas Robertson,L,TOR,23,82,17,19,36
70,8481580,Connor McMichael,C,WSH,23,82,17,19,36
70,8480459,Pius Suter,C,VAN,28,82,16,20,36
70,8480220,Noah Cates,L,PHI,25,82,15,21,36
70,8476889,Radek Faksa,C,STL,30,82,15,21,36
70,8478115,Pierre Engvall,L,NYI,28,82,9,27,36
70,8479983,Mario Ferraro,D,SJS,26,82,7,29,36
70,8478500,Ivan Provorov,D,CBJ,27,82,4,32,36
70,8484145,Zach Benson,L,BUF,19,82,20,15,35
70,8476374,Sean Kuraly,C,CBJ,31,82,19,16,35
70,8475768,Jaden Schwartz,C,SEA,32,82,18,17,35
70,8480068,Ryan Poehling,C,PHI,25,82,16,19,35
70,8473563,Nicklas Backstrom,C,WSH,37,82,15,20,35
70,8480829,Jesperi Kotkaniemi,C,CAR,24,82,14,21,35
70,8479393,Noah Gregor,C,OTT,26,82,14,21,35
70,8477953,Kasperi Kapanen,R,STL,28,82,13,22,35
70,8475200,Dmitry Orlov,D,CAR,33,82,11,24,35
70,8480817,K'Andre Miller,D,NYR,24,82,10,25,35
70,8476979,Erik Gustafsson,D,DET,32,82,2,33,35
70,8482089,Jake Neighbours,L,STL,22,82,26,8,34
70,8480893,Kirill Marchenko,R,CBJ,24,82,25,9,34
70,8480849,Barrett Hayton,C,UTA,24,82,15,19,34
70,8474715,Cam Atkinson,R,TBL,35,82,15,19,34
70,8481656,Aliaksei Protas,C,WSH,23,82,14,20,34
70,8481028,Martin Pospisil,C,CGY,25,82,13,21,34
70,8481606,Jordan Spence,D,LAK,23,82,10,24,34
70,8476958,Jaccob Slavin,D,CAR,30,82,6,28,34
70,8481546,Cam York,D,PHI,23,82,5,29,34
70,8480043,Timothy Liljegren,D,TOR,25,82,4,30,34
70,8481601,Simon Holmstrom,R,NYI,23,82,19,14,33
70,8476469,Joel Armia,R,MTL,31,82,18,15,33
70,8475220,Marcus Foligno,L,MIN,33,82,14,19,33
70,8483515,Juraj Slafkovsky,L,MTL,20,82,12,21,33
70,8474189,Lars Eller,C,PIT,35,82,12,21,33
70,8476458,Ryan Strome,C,ANA,31,82,10,23,33
70,8478507,John Marino,D,UTA,27,82,5,28,33
70,8481554,Kaapo Kakko,R,NYR,23,82,16,16,32
70,8477987,Ryan Donato,C,CHI,28,82,16,16,32
70,8481560,Arthur Kaliyev,R,LAK,23,82,15,17,32
70,8477947,Sonny Milano,L,WSH,28,82,14,18,32
70,8475287,Erik Haula,L,NJD,33,82,13,19,32
70,8477450,Jason Dickinson,C,CHI,29,82,13,19,32
70,8480980,Connor Dewar,C,TOR,25,82,12,20,32
70,8482720,Matthew Knies,L,TOR,22,82,9,23,32
70,8478911,Matt Roy,D,WSH,29,82,9,23,32
70,8481522,Peyton Krebs,C,BUF,23,82,8,24,32
70,8479351,Sam Steel,C,DAL,26,82,7,25,32
70,8476331,Dylan DeMelo,D,WPG,31,82,5,27,32
70,8481704,Juuso Parssinen,C,NSH,23,82,18,13,31
70,8470621,Corey Perry,R,EDM,39,82,18,13,31
70,8478472,Mathieu Joseph,R,STL,27,82,13,18,31
70,8477015,Connor Brown,R,EDM,30,82,13,18,31
70,8475171,Oliver Ekman-Larsson,D,TOR,33,82,9,22,31
70,8480336,Sean Walker,D,CAR,30,82,7,24,31
70,8479398,Samuel Girard,D,COL,26,82,7,24,31
70,8477488,Brett Pesce,D,NJD,30,82,7,24,31
70,8476931,Jake McCabe,D,TOR,31,82,5,26,31
70,8480835,Jack Drury,C,CAR,24,82,20,10,30
70,8476438,Brandon Saad,L,STL,32,82,17,13,30
70,8481186,Logan O'Connor,R,COL,28,82,17,13,30
70,8479316,Luke Kunin,C,SJS,27,82,17,13,30
70,8473533,Jordan Staal,C,CAR,36,82,16,14,30
70,8476960,Andreas Athanasiou,C,CHI,30,82,16,14,30
70,8479661,Tanner Jeannot,L,LAK,27,82,15,15,30
70,8476474,Stefan Noesen,R,NJD,31,82,14,16,30
70,8476918,Jimmy Vesey,L,NYR,31,82,14,16,30
70,8479414,Nathan Bastian,R,NJD,27,82,14,16,30
70,8481553,Bobby Brink,R,PHI,23,82,13,17,30
70,8475343,Nic Dowd,C,WSH,34,82,12,18,30
70,8481624,Ilya Mikheyev,R,CHI,30,82,11,19,30
70,8478133,Jake Evans,C,MTL,28,82,10,20,30
70,8480144,David Kampf,C,TOR,29,82,9,21,30
70,8480878,Nils Lundkvist,D,DAL,24,82,9,21,30
70,8477435,Ryan Graves,D,PIT,29,82,8,22,30
70,8477989,Christian Dvorak,C,MTL,28,82,7,23,30
70,8477506,Ryan Pulock,D,NYI,30,82,4,26,30
70,8479591,Michael Eyssimont,C,TBL,28,82,13,16,29
70,8482666,Scott Morrow,D,CAR,22,82,13,16,29
70,8479368,Max Jones,L,BOS,26,82,11,18,29
70,8476873,Mark Jankowski,C,NSH,30,82,11,18,29
70,8476624,Barclay Goodrow,C,SJS,31,82,11,18,29
70,8480003,Jesper Boqvist,C,FLA,26,82,11,18,29
70,8484149,Gavin Brindley,C,CBJ,20,82,11,18,29
70,8480813,Joe Veleno,C,DET,24,82,10,19,29
70,8480049,Dylan Samberg,D,WPG,25,82,5,24,29
70,8476879,Cody Ceci,D,EDM,31,82,4,25,29
70,8476891,Matt Grzelcyk,D,PIT,30,82,3,26,29
70,8478508,Yakov Trenin,C,MIN,27,82,16,12,28
70,8481093,Rafael Harvey-Pinard,L,MTL,25,82,15,13,28
70,8476392,Adam Lowry,C,WPG,31,82,13,15,28
70,8483457,Lane Hutson,D,MTL,20,82,11,17,28
70,8477425,Miles Wood,L,COL,29,82,10,18,28
70,8478013,Jake Walman,D,SJS,28,82,10,18,28
70,8476902,Esa Lindell,D,DAL,30,82,9,19,28
70,8477507,Nikita Zadorov,D,BOS,29,82,7,21,28
70,8477220,Nate Schmidt,D,FLA,33,82,7,21,28
70,8481481,Blake Lizotte,C,PIT,27,82,5,23,28
70,8476463,Jonas Brodin,D,MIN,31,82,5,23,28
70,8482087,Kaiden Guhle,D,MTL,22,82,5,23,28
70,8477365,Connor Clifton,D,BUF,29,82,2,26,28
70,8478434,Keegan Kolesar,R,VGK,27,82,14,13,27
70,8482079,Marco Rossi,C,MIN,23,82,14,13,27
70,8473453,Trevor Lewis,C,LAK,37,82,14,13,27
70,8475193,Tomas Tatar,L,NJD,34,82,13,14,27
70,8480074,Alexandre Texier,C,STL,25,82,12,15,27
70,8481477,Nico Sturm,C,SJS,29,82,11,16,27
70,8477353,Tyler Motte,C,DET,29,82,11,16,27
70,8476921,Jordan Martinook,L,CAR,32,82,9,18,27
70,8476457,Adam Larsson,D,SEA,32,82,8,19,27
70,8477969,Marcus Pettersson,D,PIT,28,82,4,23,27
70,8478136,Jake Middleton,D,MIN,28,82,4,23,27
70,8473507,Jeff Petry,D,DET,37,82,1,26,27
70,8474151,Ryan McDonagh,D,TBL,35,82,1,26,27
70,8477903,Garnet Hathaway,R,PHI,33,82,11,15,26
70,8480806,Isac Lundestrom,C,ANA,25,82,11,15,26
70,8482117,Lukas Reichel,L,CHI,22,82,10,16,26
70,8479976,Juuso Valimaki,D,UTA,26,82,7,19,26
70,8480860,Kevin Bahl,D,CGY,24,82,7,19,26
70,8476892,Colton Parayko,D,STL,31,82,5,21,26
70,8479371,Dante Fabbro,D,NSH,26,82,4,22,26
70,8474673,TJ Brodie,D,CHI,34,82,3,23,26
70,8478882,Vladislav Gavrikov,D,LAK,29,82,3,23,26
70,8478851,Alexandre Carrier,D,NSH,28,82,1,25,26
70,8475462,Radko Gudas,D,ANA,34,82,1,25,26
70,8478109,Victor Olofsson,L,VGK,29,82,13,12,25
70,8482166,Shakir Mukhamadullin,D,SJS,22,82,12,13,25
70,8477952,Robby Fabbri,C,ANA,28,82,9,16,25
70,8482133,Thomas Bordeleau,C,SJS,22,82,9,16,25
70,8480246,Nick Perbix,D,TBL,26,82,6,19,25
70,8482122,Brock Faber,D,MIN,22,82,4,21,25
70,8475764,Cam Fowler,D,ANA,33,82,2,23,25
70,8475324,Nick Jensen,D,OTT,34,82,2,23,25
70,8479324,Ryan Lindgren,D,NYR,26,82,2,23,25
70,8478569,Noel Acciari,C,PIT,33,82,15,9,24
70,8480789,Oliver Wahlstrom,R,NYI,24,82,13,11,24
70,8480855,Jack McBain,C,UTA,24,82,12,12,24
70,8480448,Parker Kelly,L,COL,25,82,9,15,24
70,8477919,Frederick Gaudreau,C,MIN,31,82,8,16,24
70,8479980,Nicolas Hague,D,VGK,26,82,8,16,24
70,8478399,Jonas Siegenthaler,D,NJD,27,82,6,18,24
70,8481014,Alexander Romanov,D,NYI,24,82,4,20,24
70,8475181,Nick Leddy,D,STL,33,82,1,23,24
70,8475233,David Savard,D,MTL,34,82,1,23,24
70,8482702,Logan Stankoven,C,DAL,21,82,14,9,23
70,8476278,Colin Blackwell,C,DAL,31,82,14,9,23
70,8480281,Alexey Toropchenko,R,STL,25,82,14,9,23
70,8482062,Cole Smith,L,NSH,29,82,12,11,23
70,8477392,Hudson Fasching,R,NYI,29,82,10,13,23
70,8477369,Carson Soucy,D,VAN,30,82,10,13,23
70,8478211,Dryden Hunt,L,CGY,29,82,10,13,23
70,8476422,Mike Reilly,D,NYI,31,82,9,14,23
70,8476917,Adam Pelech,D,NYI,30,82,6,17,23
70,8479402,Jake Bean,D,CGY,26,82,6,17,23
70,8475690,Chris Tanev,D,TOR,35,82,4,19,23
70,8483490,Pavel Mintyukov,D,ANA,21,82,4,19,23
70,8480035,Henri Jokiharju,D,BUF,25,82,1,22,23
70,8476878,Zemgus Girgensons,L,TBL,30,82,16,6,22
70,8482679,Matt Coronato,R,CGY,22,82,9,13,22
70,8477839,Conor Sheary,L,TBL,32,82,7,15,22
70,8478468,Jeremy Lauzon,D,NSH,27,82,7,15,22
70,8483495,Simon Nemec,D,NJD,20,82,6,16,22
70,8483505,Matthew Poitras,C,BOS,20,82,6,16,22
70,8479353,Brett Howden,C,VGK,26,82,5,17,22
70,8477499,Rasmus Ristolainen,D,PHI,30,82,3,19,22
70,8480073,Erik Brannstrom,D,COL,25,82,3,19,22
70,8481568,Alex Vlasic,D,CHI,23,82,2,20,22
70,8475188,Brayden McNabb,D,VGK,33,82,2,20,22
70,8484153,Leo Carlsson,C,ANA,20,82,13,8,21
70,8478432,Christian Fischer,R,DET,27,82,12,9,21
70,8484166,Adam Fantilli,C,CBJ,20,82,12,9,21
70,8479390,Taylor Raddysh,R,WSH,26,82,11,10,21
70,8482101,Danil Gushchin,L,SJS,22,82,11,10,21
70,8480995,Pontus Holmberg,R,TOR,25,82,9,12,21
70,8482807,Ethan Del Mastro,D,CHI,21,82,9,12,21
70,8479291,Kevin Rooney,C,CGY,31,82,7,14,21
70,8475718,Justin Holl,D,DET,32,82,6,15,21
70,8478443,Brandon Carlo,D,BOS,28,82,4,17,21
70,8475231,Casey Cizikas,C,NYI,33,82,3,18,21
70,8483763,Maksymilian Szuber,D,UTA,22,82,3,18,21
70,8482073,Braden Schneider,D,NYR,23,82,1,20,21
70,8482655,J.J. Moser,D,TBL,24,82,0,21,21
70,8479293,Brandon Tanev,L,SEA,33,82,12,8,20
70,8483431,Logan Cooley,C,UTA,20,82,9,11,20
70,8477406,Mattias Janmark,C,EDM,32,82,8,12,20
70,8477505,Alexander Wennberg,C,SJS,30,82,7,13,20
70,8477508,Curtis Lazar,C,NJD,29,82,6,14,20
70,8482733,Logan Mailloux,D,MTL,31,82,6,14,20
70,8476467,Jamie Oleksiak,D,SEA,32,82,5,15,20
70,8482516,Matthew Kessel,D,STL,24,82,5,15,20
70,8474574,Tyler Myers,D,VAN,34,82,4,16,20
70,8484203,Bradly Nadeau,L,CAR,19,82,3,17,20
70,8475455,Brenden Dillon,D,NJD,34,82,3,17,20
70,8480796,Martin Fehervary,D,WSH,25,82,3,17,20
70,8474013,Ian Cole,D,UTA,35,82,3,17,20
70,8478416,Erik Cernak,D,TBL,27,82,1,19,20
70,8482077,Dylan Holloway,L,EDM,23,82,9,10,19
70,8480990,Declan Chisholm,D,MIN,24,82,9,10,19
70,8480021,Jack Studnicka,C,LAK,25,82,8,11,19
70,8482259,Bobby McMann,C,TOR,28,82,6,13,19
70,8476897,Oskar Sundqvist,C,STL,30,82,5,14,19
70,8477931,Tomas Nosek,L,FLA,32,82,5,14,19
70,8482470,Ilya Solovyov,D,CGY,24,82,5,14,19
70,8480222,Sebastian Aho,D,PIT,28,82,4,15,19
70,8476967,Brett Kulak,D,EDM,30,82,4,15,19
70,8476312,Josh Manson,D,COL,33,82,3,16,19
70,8477845,Trevor van Riemsdyk,D,WSH,33,82,2,17,19
70,8479998,Mikey Anderson,D,LAK,25,82,2,17,19
70,8478178,Darren Raddysh,D,TBL,28,82,1,18,19
70,8483482,Tristan Luneau,D,ANA,20,82,9,9,18
70,8481699,Aku Raty,R,UTA,23,82,9,9,18
70,8476858,Phillip Di Giuseppe,L,VAN,31,82,8,10,18
70,8482111,Justin Barron,D,MTL,23,82,7,11,18
70,8482153,Brendan Brisson,C,VGK,23,82,7,11,18
70,8482659,Josh Doan,R,UTA,22,82,6,12,18
70,8483524,Shane Wright,C,SEA,20,82,6,12,18
70,8478840,Will Borgen,D,SEA,28,82,5,13,18
70,8474567,Zach Bogosian,D,MIN,34,82,5,13,18
70,8474090,Brendan Smith,D,DAL,35,82,5,13,18
70,8477938,Haydn Fleury,D,WPG,28,82,5,13,18
70,8475177,Calvin de Haan,D,COL,33,82,4,14,18
70,8482858,Ryker Evans,D,SEA,23,82,4,14,18
70,8470600,Ryan Suter,D,STL,39,82,3,15,18
70,8483466,Kevin Korchinski,D,CHI,20,82,3,15,18
70,8480950,Ilya Lyubushkin,D,DAL,30,82,2,16,18
70,8477034,Jaycob Megna,D,FLA,32,82,2,16,18
70,8482155,Alex Laferriere,R,LAK,23,82,11,6,17
70,8481524,Bowen Byram,D,BUF,23,82,9,8,17
70,8479359,Beck Malenstyn,L,BUF,26,82,9,8,17
70,8481517,Brett Leason,R,ANA,25,82,9,8,17
70,8483468,Jiri Kulich,C,BUF,20,82,7,10,17
70,8479442,Troy Stecher,D,EDM,30,82,4,13,17
70,8471677,Jack Johnson,D,CBJ,37,82,3,14,17
70,8476429,Scott Mayfield,D,NYI,32,82,2,15,17
70,8481178,Egor Zamula,D,PHI,24,82,2,15,17
70,8482762,Simon Edvinsson,D,DET,21,82,11,5,16
70,8480025,MacKenzie Entwistle,R,FLA,25,82,10,6,16
70,8483012,Logan Morrison,C,SEA,22,82,9,7,16
70,8482713,Mackie Samoskevich,R,FLA,22,82,7,9,16
70,8482749,Joshua Roy,R,MTL,21,82,7,9,16
70,8480879,Jacob Bernard-Docker,D,OTT,24,82,4,12,16
70,8483460,David Jiricek,D,CBJ,21,82,4,12,16
70,8476525,Colin Miller,D,WPG,32,82,3,13,16
70,8481567,Henry Thrun,D,SJS,23,82,3,13,16
70,8479369,Andrew Peeke,D,BOS,26,82,2,14,16
70,8480807,Mattias Samuelsson,D,BUF,24,82,0,16,16
70,8482141,Lukas Cormier,D,VGK,22,82,7,8,15
70,8478859,Niko Mikkola,D,FLA,28,82,6,9,15
70,8480870,Bo Groulx,C,NYR,24,82,6,9,15
70,8479638,Justin Brazeau,R,BOS,26,82,6,9,15
70,8482245,Artem Zub,D,OTT,29,82,5,10,15
70,8483493,Frank Nazar,C,CHI,20,82,5,10,15
70,8475279,Ben Chiarot,D,DET,33,82,3,12,15
70,8476372,Nick Seeler,D,PHI,31,82,3,12,15
70,8476442,Matt Nieto,L,PIT,32,82,8,6,14
70,8482712,Oskar Olausson,R,COL,22,82,8,6,14
70,8481708,Zac Jones,D,NYR,24,82,7,7,14
70,8475790,Erik Gudbranson,D,CBJ,32,82,6,8,14
70,8482145,Mavrik Bourque,C,DAL,22,82,5,9,14
70,8482787,Nikita Chibrikov,R,WPG,31,82,5,9,14
70,8483445,Cutter Gauthier,L,ANA,20,82,4,10,14
70,8482859,Zack Ostapchuk,C,OTT,21,82,4,10,14
70,8476441,Joel Edmundson,D,LAK,31,82,3,11,14
70,8481122,Simon Benoit,D,TOR,26,82,3,11,14
70,8482809,Jackson Blake,R,CAR,21,82,7,6,13
70,8483565,Nick Blankenburg,D,NSH,26,82,4,9,13
70,8484911,Collin Graf,R,SJS,22,82,4,9,13
70,8474612,Travis Hamonic,D,OTT,34,82,4,9,13
70,8480172,Jan Rutta,D,SJS,34,82,0,13,13
70,8483397,Marc McLaughlin,C,BOS,25,82,8,4,12
70,8481605,Jackson LaCombe,D,ANA,23,82,5,7,12
70,8483489,Fraser Minten,C,TOR,31,82,5,7,12
70,8483471,Brad Lambert,C,WPG,31,82,5,7,12
70,8480834,Ty Emberson,D,SJS,24,82,3,9,12
70,8477335,Kyle Burroughs,D,LAK,29,82,2,10,12
70,8475842,Sam Carrick,C,NYR,32,82,8,3,11
70,8482070,Mitchell Chaffee,R,TBL,26,82,6,5,11
70,8481641,Joel Kiviranta,L,COL,28,82,5,6,11
70,8479576,Vincent Desharnais,D,VAN,28,82,5,6,11
70,8482803,Olen Zellweger,D,ANA,21,82,3,8,11
70,8483567,Georgii Merkulov,C,BOS,24,82,2,9,11
70,8483499,Liam Ohgren,L,MIN,20,82,3,7,10
70,8474062,Riley Nash,C,NYR,35,82,3,7,10
70,8482118,Sam Colangelo,R,ANA,23,82,5,4,9
70,8476473,Connor Murphy,D,CHI,31,82,2,7,9
70,8478874,Adam Gaudette,C,OTT,28,82,0,9,9
70,8476822,Luke Glendening,C,TBL,35,82,4,4,8
70,8478450,Parker Wotherspoon,D,BOS,27,82,3,4,7
70,8475762,Derek Forbort,D,VAN,32,82,0,7,7
70,8470794,Joe Pavelski,C,,40,0,0,0,0
70,8481703,Valtteri Puustinen,R,PIT,25,0,0,0,0
70,8477950,Tony DeAngelo,D,,29,0,0,0,0
70,8481577,Philip Tomasino,C,NSH,23,0,0,0,0
70,8475197,Tyson Barrie,D,,33,0,0,0,0
70,8471218,Blake Wheeler,R,,38,0,0,0,0
70,8474157,Max Pacioretty,L,,36,0,0,0,0
70,8478466,Daniel Sprong,R,VAN,27,0,0,0,0
70,8475744,Evgeny Kuznetsov,C,,32,0,0,0,0
70,8481019,David Gustafsson,C,WPG,24,0,0,0,0
70,8475906,John Klingberg,D,,32,0,0,0,0
70,8479348,Kale Clague,D,BUF,26,0,0,0,0
70,8476952,Dominic Toninato,C,WPG,30,0,0,0,0
70,8473473,Milan Lucic,L,,36,0,0,0,0
70,8474037,James van Riemsdyk,L,,35,0,0,0,0
70,8474602,Justin Schultz,D,,34,0,0,0,0
70,8482222,Alexander Barabanov,L,,30,0,0,0,0
70,8479372,Josh Mahura,D,SEA,26,0,0,0,0
70,8479982,Conor Timmins,D,TOR,26,0,0,0,0
70,8474031,Kevin Shattenkirk,D,,35,0,0,0,0
70,8480008,Adam Ruzicka,C,,25,0,0,0,0
70,8481059,Scott Perunovich,D,STL,26,0,0,0,0
70,8480884,Calen Addison,D,,24,0,0,0,0
70,8476994,Vinnie Hinostroza,C,NSH,30,0,0,0,0
70,8478452,Caleb Jones,D,LAK,27,0,0,0,0
70,8480157,Calle Rosen,D,COL,30,0,0,0,0
70,8481609,Vladislav Kolyachonok,D,UTA,23,0,0,0,0
70,8479415,Michael McLeod,C,,26,0,0,0,0
70,8476919,Chris Tierney,C,,30,0,0,0,0
70,8479639,Dylan Coghlan,D,WPG,26,0,0,0,0
70,8478146,Matthew Highmore,C,OTT,28,0,0,0,0
70,8478970,Jalen Chatfield,D,CAR,28,0,0,0,0
70,8480205,Emil Bemstrom,C,PIT,25,0,0,0,0
70,8474884,Mike Hoffman,C,,35,0,0,0,0
70,8471274,Alex Goligoski,D,,39,0,0,0,0
70,8478104,Sammy Blais,L,,28,0,0,0,0
70,8474870,Tyler Johnson,C,,34,0,0,0,0
70,8476913,Devin Shore,C,MIN,30,0,0,0,0
70,8481598,Philip Broberg,D,EDM,23,0,0,0,0
70,8480058,Pierre-Olivier Joseph,D,STL,25,0,0,0,0
70,8480891,Michael Kesselring,D,UTA,24,0,0,0,0
70,8477979,Nicolas Aube-Kubel,R,BUF,28,0,0,0,0
70,8476871,Tanner Pearson,L,,32,0,0,0,0
70,8476393,Nick Cousins,C,,31,0,0,0,0
70,8479977,Kailer Yamamoto,R,,26,0,0,0,0
70,8479543,Michael Pezzetta,L,MTL,26,0,0,0,0
70,8477018,Ben Hutton,D,VGK,31,0,0,0,0
70,8480762,Eric Robinson,L,CAR,29,0,0,0,0
70,8474034,Pat Maroon,L,CHI,36,0,0,0,0
70,8481058,Jesse Ylönen,R,,25,0,0,0,0
70,8475179,Dmitry Kulikov,D,FLA,34,0,0,0,0
70,8481527,Kaedan Korczak,D,VGK,23,0,0,0,0
70,8473449,Kyle Okposo,R,,36,0,0,0,0
70,8482192,Isaak Phillips,D,CHI,23,0,0,0,0
70,8480727,Zach Whitecloud,D,VGK,28,0,0,0,0
70,8479346,Dillon Dube,C,,26,0,0,0,0
70,8480821,Filip Zadina,R,,25,0,0,0,0
70,8480001,Urho Vaakanainen,D,ANA,25,0,0,0,0
70,8470966,Mark Giordano,D,,41,0,0,0,0
70,8480853,Liam Foudy,C,,24,0,0,0,0
70,8475225,Craig Smith,C,CHI,35,0,0,0,0
70,8479972,Mason Shaw,C,WPG,26,0,0,0,0
70,8478451,Ethan Bear,D,WSH,27,0,0,0,0
70,8474040,Sam Gagner,C,,35,0,0,0,0
70,8480196,Jacob Bryson,D,BUF,27,0,0,0,0
70,8479984,Cal Foote,D,,26,0,0,0,0
70,8480011,Klim Kostin,C,SJS,25,0,0,0,0
70,8482176,Wyatt Kaiser,D,CHI,22,0,0,0,0
70,8476988,Matt Benning,D,SJS,30,0,0,0,0
70,8479370,Tyson Jost,C,CAR,26,0,0,0,0
70,8477464,Nic Petan,C,,29,0,0,0,0
70,8477380,Jonny Brodzinski,C,NYR,31,0,0,0,0
70,8480070,Ian Mitchell,D,BOS,25,0,0,0,0
70,8479315,Joey Anderson,R,CHI,26,0,0,0,0
70,8478099,Kevin Labanc,R,,29,0,0,0,0
70,8476874,Olli Maatta,D,DET,30,0,0,0,0
70,8475208,Brian Dumoulin,D,ANA,33,0,0,0,0
70,8478430,Oliver Kylington,D,,27,0,0,0,0
70,8479536,Axel Jonsson-Fjallby,L,WPG,26,0,0,0,0
70,8479671,Mathieu Olivier,R,CBJ,27,0,0,0,0
70,8471709,Marc-Edouard Vlasic,D,SJS,37,0,0,0,0
70,8479328,Julien Gauthier,R,NYI,27,0,0,0,0
70,8478421,A.J. Greer,L,FLA,28,0,0,0,0
70,8477573,Nathan Walker,L,STL,30,0,0,0,0
70,8481537,Nikita Okhotiuk,D,CGY,24,0,0,0,0
70,8474166,Alec Martinez,D,CHI,37,0,0,0,0
70,8470610,Zach Parise,L,,40,0,0,0,0
70,8477478,William Carrier,L,CAR,30,0,0,0,0
70,8479344,Jesse Puljujarvi,R,PIT,26,0,0,0,0
70,8480887,Jordan Harris,D,MTL,24,0,0,0,0
70,8478502,Dennis Gilbert,D,BUF,28,0,0,0,0
70,8482730,Brandt Clarke,D,LAK,21,0,0,0,0
70,8480355,Mark Kastelic,C,BOS,25,0,0,0,0
70,8475750,Jon Merrill,D,MIN,32,0,0,0,0
70,8475164,Jakob Silfverberg,R,,34,0,0,0,0
70,8477944,Jakub Vrana,L,,28,0,0,0,0
70,8479439,Jacob MacDonald,D,COL,31,0,0,0,0
70,8474568,Luke Schenn,D,NSH,35,0,0,0,0
70,8478454,Noah Juulsen,D,VAN,27,0,0,0,0
70,8475752,Tyler Pitlick,C,,33,0,0,0,0
70,8482148,Hendrix Lapierre,C,WSH,22,0,0,0,0
70,8481167,Brayden Pachal,D,CGY,25,0,0,0,0
70,8478043,Sam Lafferty,C,BUF,29,0,0,0,0
70,8479321,Lucas Johansen,D,,27,0,0,0,0
70,8471699,Andrew Cogliano,C,,37,0,0,0,0
70,8481521,Ronnie Attard,D,PHI,25,0,0,0,0
70,8481161,Jake Christiansen,D,CBJ,25,0,0,0,0
70,8479458,Nikita Zaitsev,D,,33,0,0,0,0
70,8479619,Michael Carcone,L,UTA,28,0,0,0,0
70,8479026,Philippe Myers,D,TOR,27,0,0,0,0
70,8477330,Dominik Kubalik,L,,29,0,0,0,0
70,8481617,Vasily Podkolzin,R,VAN,23,0,0,0,0
70,8481701,Santeri Hatakka,D,NJD,23,0,0,0,0
70,8479514,Rem Pitlick,C,,27,0,0,0,0
70,8477446,Michael McCarron,R,NSH,29,0,0,0,0
70,8470604,Jeff Carter,C,,39,0,0,0,0
70,8482241,Radim Zohorna,L,,28,0,0,0,0
70,8480289,Morgan Barron,C,WPG,26,0,0,0,0
70,8479379,Givani Smith,R,SJS,26,0,0,0,0
70,8480216,Jacob Peterson,C,,25,0,0,0,0
70,8477851,Jordan Oesterle,D,BOS,32,0,0,0,0
70,8484258,Sam Malinski,D,COL,26,0,0,0,0
70,8478904,Steven Lorentz,C,,28,0,0,0,0
70,8482095,Tyler Kleven,D,OTT,22,0,0,0,0
70,8480848,Ty Dellandrea,C,SJS,24,0,0,0,0
70,8476884,Derrick Pouliot,D,,30,0,0,0,0
70,8479336,Carl Grundstrom,R,SJS,27,0,0,0,0
70,8482964,Arber Xhekaj,D,MTL,23,0,0,0,0
70,8471686,Marc Staal,D,,37,0,0,0,0
70,8477887,Patrick Brown,C,BOS,32,0,0,0,0
70,8478495,Denis Gurianov,R,,27,0,0,0,0
70,8473504,Cal Clutterbuck,R,,37,0,0,0,0
70,8481550,Adam Beckman,L,NJD,23,0,0,0,0
70,8480845,Rasmus Kupari,C,WPG,24,0,0,0,0
70,8474009,Nick Bonino,C,,36,0,0,0,0
70,8478585,Derek Ryan,C,EDM,38,0,0,0,0
70,8477962,Brendan Lemieux,L,CAR,28,0,0,0,0
70,8482861,Vincent Iorio,D,WSH,22,0,0,0,0
70,8479378,Logan Stanley,D,WPG,26,0,0,0,0
70,8473446,Erik Johnson,D,PHI,36,0,0,0,0
70,8481743,Marc Del Gaizo,D,NSH,25,0,0,0,0
70,8477384,Josh Brown,D,EDM,30,0,0,0,0
70,8482165,Yan Kuznetsov,D,CGY,22,0,0,0,0
70,8478424,Jansen Harkins,C,ANA,27,0,0,0,0
70,8482144,Jack Thompson,D,SJS,22,0,0,0,0
70,8478512,Austin Czarnik,C,,32,0,0,0,0
70,8477527,Ross Johnston,L,ANA,30,0,0,0,0
70,8479383,Boris Katchouk,L,,26,0,0,0,0
70,8482094,Daemon Hunt,D,MIN,22,0,0,0,0
70,8481719,Maxwell Crozier,D,TBL,24,0,0,0,0
70,8480192,Johnathan Kovacevic,D,NJD,27,0,0,0,0
70,8479376,Victor Mete,D,,26,0,0,0,0
70,8482511,Mason Lohrei,D,BOS,23,0,0,0,0
70,8475825,Jani Hakanpää,D,,32,0,0,0,0
70,8478021,William Lagesson,D,DET,28,0,0,0,0
70,8475795,Dylan McIlrath,D,WSH,32,0,0,0,0
70,8477846,Ryan Carpenter,C,,33,0,0,0,0
70,8481056,Spencer Stastney,D,NSH,24,0,0,0,0
70,8481564,Ryan Johnson,D,BUF,23,0,0,0,0
70,8478017,Mark Friedman,D,VAN,29,0,0,0,0
70,8479320,Max Lajoie,D,SEA,27,0,0,0,0
70,8480075,Cameron Crotty,D,MIN,25,0,0,0,0
70,8484287,Cole McWard,D,VAN,23,0,0,0,0
70,8484254,Akito Hirose,D,VAN,25,0,0,0,0
70,8483407,Brandon Scanlin,D,NYR,25,0,0,0,0
70,8480274,Philip Kemp,D,EDM,25,0,0,0,0
70,8479522,Hardy Haman Aktell,D,WSH,26,0,0,0,0
70,8480007,Jonas Rondbjerg,R,VGK,25,0,0,0,0
70,8477454,Adam Erne,L,,29,0,0,0,0
70,8481679,Maxence Guenette,D,OTT,23,0,0,0,0
70,8480441,Trey Fix-Wolansky,R,CBJ,25,0,0,0,0
70,8483546,Marshall Rifai,D,TOR,26,0,0,0,0
70,8480084,Nick DeSimone,D,NJD,30,0,0,0,0
70,8481030,Jack St. Ivany,D,PIT,25,0,0,0,0
70,8481592,Jakob Pelletier,L,CGY,23,0,0,0,0
70,8478011,Louie Belpedio,D,PHI,28,0,0,0,0
70,8477930,Pierre-Edouard Bellemare,L,,39,0,0,0,0
70,8484321,Nikolas Matinpalo,D,OTT,26,0,0,0,0
70,8482067,Connor Mackey,D,NYR,28,0,0,0,0
70,8481806,Louis Crevier,D,CHI,23,0,0,0,0
70,8484326,Patrik Koch,D,UTA,28,0,0,0,0
70,8477971,Andreas Englund,D,LAK,28,0,0,0,0
70,8481751,Lukas Rousek,R,BUF,25,0,0,0,0
70,8481006,Tyler Tucker,D,STL,24,0,0,0,0
70,8476867,Brendan Gaunce,C,MIN,30,0,0,0,0
70,8479520,Brandon Duhaime,R,WSH,27,0,0,0,0
70,8477073,Kurtis MacDermid,L,NJD,30,0,0,0,0
70,8480874,Adam Ginning,D,PHI,24,0,0,0,0
70,8477473,Justin Bailey,R,SJS,29,0,0,0,0
70,8479066,Ryan Lomberg,L,CGY,30,0,0,0,0
70,8477070,Liam O'Brien,C,UTA,30,0,0,0,0
70,8474618,Marco Scandella,D,,34,0,0,0,0
70,8475797,Jarred Tinordi,D,,32,0,0,0,0
70,8481441,Joe Snively,C,DET,28,0,0,0,0
70,8477244,Chad Ruhwedel,D,NYR,34,0,0,0,0
70,8479772,Zack MacEwen,R,OTT,28,0,0,0,0
70,8481147,Reese Johnson,C,MIN,26,0,0,0,0
70,8481043,Cole Koepke,L,BOS,26,0,0,0,0
70,8483619,Filip Roos,D,OTT,25,0,0,0,0
70,8481541,Samuel Bolduc,D,NYI,24,0,0,0,0
70,8477810,Joel Hanley,D,CGY,33,0,0,0,0
70,8476907,Mackenzie MacEachern,L,,30,0,0,0,0
70,8482652,Walker Duehr,R,CGY,27,0,0,0,0
70,8477126,Jayson Megna,C,,34,0,0,0,0
70,8483398,Declan Carlile,D,TBL,31,0,0,0,0
70,8482929,Emil Lilleberg,D,TBL,23,0,0,0,0
70,8480880,Jakub Lauko,C,MIN,24,0,0,0,0
70,8480245,Olle Lycksell,R,PHI,25,0,0,0,0
70,8480252,Cole Guttman,C,CHI,25,0,0,0,0
70,8477467,Gustav Olofsson,D,SEA,30,0,0,0,0
70,8479968,Vinni Lettieri,C,BOS,29,0,0,0,0
70,8478400,Colin White,C,,27,0,0,0,0
70,8475755,Alexander Petrovic,D,DAL,32,0,0,0,0
70,8481812,Nikolai Knyzhov,D,,27,0,0,0,0
70,8481593,Jayden Struble,D,MTL,23,0,0,0,0
70,8481532,Alex Turcotte,C,LAK,23,0,0,0,0
70,8482126,Emil Andrae,D,PHI,31,0,0,0,0
70,8479944,Zach Aston-Reese,C,VGK,30,0,0,0,0
70,8471817,Ryan Reaves,R,TOR,37,0,0,0,0
70,8481206,John Ludvig,D,PIT,24,0,0,0,0
70,8481599,Victor Soderstrom,D,UTA,23,0,0,0,0
70,8480292,Carson Meyer,R,ANA,27,0,0,0,0
70,8482496,Nils Aman,C,VAN,24,0,0,0,0
70,8479718,Alex Barré-Boulet,C,MTL,27,0,0,0,0
70,8479994,Jaret Anderson-Dolan,C,WPG,25,0,0,0,0
70,8480184,Gustav Lindstrom,D,,26,0,0,0,0
70,8480890,Jan Jenik,R,OTT,24,0,0,0,0
70,8478067,Oskar Lindblom,L,,28,0,0,0,0
70,8476934,Brock McGinn,L,ANA,30,0,0,0,0
70,8479985,Cale Fleury,D,SEA,26,0,0,0,0
70,8484304,Uvis Balinskis,D,FLA,28,0,0,0,0
70,8479981,Jonah Gadjovich,L,FLA,26,0,0,0,0
70,8481716,Dmitri Voronkov,L,CBJ,24,0,0,0,0
70,8474709,Matt Martin,L,,35,0,0,0,0
70,8482634,Alex Steeves,C,TOR,25,0,0,0,0
70,8480823,Alexander Alexeyev,D,WSH,25,0,0,0,0
70,8477541,Dakota Mermis,D,TOR,30,0,0,0,0
70,8483491,Ivan Miroshnichenko,L,WSH,20,0,0,0,0
70,8478477,Mitchell Stephens,C,SEA,27,0,0,0,0
70,8481543,Nikita Alexandrov,C,STL,24,0,0,0,0
70,8479423,Alex Nylander,L,,26,0,0,0,0
70,8482451,Mikael Pyyhtia,L,CBJ,23,0,0,0,0
70,8478831,Kevin Stenlund,C,UTA,28,0,0,0,0
70,8480306,Grant Hutton,D,NYI,29,0,0,0,0
70,8478028,Fredrik Olofsson,L,,28,0,0,0,0
70,8477462,Robert Hagg,D,VGK,29,0,0,0,0
70,8477320,Anton Blidh,L,NYR,29,0,0,0,0
70,8482157,Will Cuylle,L,NYR,22,0,0,0,0
70,8482737,Zack Bolduc,C,STL,21,0,0,0,0
70,8481239,Samuel Fagemo,L,,24,0,0,0,0
70,8481600,Tobias Bjornfot,D,FLA,23,0,0,0,0
70,8478409,Anthony Richard,C,PHI,28,0,0,0,0
70,8474145,Robert Bortuzzo,D,,35,0,0,0,0
70,8475958,Michael Sgarbossa,C,WSH,32,0,0,0,0
70,8479986,Kole Lind,R,DAL,26,0,0,0,0
70,8479249,Andrew Poturalski,C,SJS,30,0,0,0,0
70,8479362,Riley Tufte,L,BOS,26,0,0,0,0
70,8479991,Jake Leschyshyn,C,NYR,25,0,0,0,0
70,8479587,Rhett Gardner,C,PHI,28,0,0,0,0
70,8482744,James Malatesta,L,CBJ,21,0,0,0,0
70,8478854,Ryan Shea,D,PIT,27,0,0,0,0
70,8481591,Sam Poulin,R,,23,0,0,0,0
70,8483512,Matt Savoie,C,EDM,20,0,0,0,0
70,8482102,Vasily Ponomarev,C,PIT,22,0,0,0,0
70,8482162,Roby Jarventie,L,EDM,22,0,0,0,0
70,8481016,Ruslan Iskhakov,C,,24,0,0,0,0
70,8482172,Landon Slaggert,L,CHI,22,0,0,0,0
70,8482747,Brennan Othmann,L,NYR,21,0,0,0,0
70,8480031,Maxime Comtois,L,,25,0,0,0,0
70,8480226,Marián Studenic,R,,26,0,0,0,0
70,8478408,Travis Dermott,D,,28,0,0,0,0
70,8481518,Nolan Foote,L,NJD,24,0,0,0,0
70,8479419,Brett Murray,L,BUF,26,0,0,0,0
70,8482088,Justin Sourdif,R,FLA,22,0,0,0,0
70,8482201,Gage Goncalves,C,TBL,23,0,0,0,0
70,8481578,Graeme Clarke,R,MIN,23,0,0,0,0
70,8482177,Marat Khusnutdinov,C,MIN,22,0,0,0,0
70,8481754,Nikita Nesterenko,C,ANA,23,0,0,0,0
70,8483531,Brian Halonen,L,NJD,25,0,0,0,0
70,8483920,Pierrick Dube,R,WSH,23,0,0,0,0
70,8480851,Akil Thomas,C,LAK,24,0,0,0,0
70,8475235,Nicolas Deslauriers,L,PHI,33,0,0,0,0
70,8482476,Emil Heineman,L,MTL,23,0,0,0,0
70,8477149,Scott Sabourin,R,SJS,32,0,0,0,0
70,8483549,Lucas Condotta,L,MTL,27,0,0,0,0
70,8482765,Isak Rosen,R,BUF,21,0,0,0,0
70,8481237,Kyle MacLean,C,NYI,25,0,0,0,0
70,8481024,Linus Karlsson,C,VAN,25,0,0,0,0
70,8481690,Tyler Angle,C,,24,0,0,0,0
70,8483570,Ben Meyers,C,SEA,26,0,0,0,0
70,8481655,Cole Schwindt,R,CGY,23,0,0,0,0
70,8481462,Mason Morelli,L,VGK,28,0,0,0,0
70,8483401,Marc Johnstone,R,PIT,28,0,0,0,0
70,8478956,Samuel Laberge,L,NJD,27,0,0,0,0
70,8479533,Joona Koppanen,L,,26,0,0,0,0
70,8482197,Adam Raska,R,MIN,23,0,0,0,0
70,8482250,Callahan Burke,C,VGK,27,0,0,0,0
70,8482784,Zach Dean,C,STL,21,0,0,0,0
70,8484255,Jason Polin,R,COL,25,0,0,0,0
70,8481077,John Leonard,L,,26,0,0,0,0
70,8481534,Raphael Lavoie,C,EDM,24,0,0,0,0
70,8483609,Adam Klapka,R,CGY,24,0,0,0,0
70,8482751,Ryan Winterton,C,SEA,21,0,0,0,0
70,8480267,Sammy Walker,C,MIN,25,0,0,0,0
70,8475766,Austin Watson,L,,32,0,0,0,0
70,8482460,Matt Rempe,C,NYR,22,0,0,0,0
70,8481065,Angus Crookshank,L,OTT,25,0,0,0,0
70,8481070,Hugh McGing,L,,26,0,0,0,0
70,8476323,Max McCormick,L,SEA,32,0,0,0,0
70,8483395,Arshdeep Bains,L,VAN,23,0,0,0,0
70,8484259,Ondrej Pavel,C,COL,31,0,0,0,0
70,8483432,Luca Del Bel Belluz,C,CBJ,31,0,0,0,0
70,8483045,Cameron Butler,R,CBJ,31,0,0,0,0
70,8482061,Brandon Biro,L,SEA,26,0,0,0,0
70,8477401,John Hayden,C,SEA,29,0,0,0,0
70,8475278,Byron Froese,C,,33,0,0,0,0
70,8478446,Glenn Gawdin,C,LAK,27,0,0,0,0
70,8477993,Justin Kirkland,C,CGY,28,0,0,0,0
70,8482147,Jean-Luc Foudy,C,COL,22,0,0,0,0
70,8480032,Shane Bowers,C,NJD,25,0,0,0,0
70,8479330,Brandon Gignac,C,MTL,27,0,0,0,0
70,8480776,Sheldon Rempal,R,,29,0,0,0,0
70,8475413,Justin Dowling,C,NJD,34,0,0,0,0
70,8481726,Adam Edstrom,C,NYR,24,0,0,0,0
70,8480844,Grigori Denisenko,L,VGK,24,0,0,0,0
70,8478147,Bokondji Imama,L,PIT,28,0,0,0,0
70,8478881,Brett Seney,L,CHI,28,0,0,0,0
70,8483630,Pavol Regenda,L,ANA,25,0,0,0,0
70,8480836,Jonathan Gruden,C,,24,0,0,0,0
70,8484314,Jiri Smejkal,L,,28,0,0,0,0
70,8475780,Chris Wagner,R,COL,33,0,0,0,0
70,8479546,Oskar Steen,C,,26,0,0,0,0
70,8483597,Milos Kelemen,L,UTA,25,0,0,0,0
70,8481789,Tye Kartye,L,SEA,23,0,0,0,0
70,8484325,Waltteri Merela,C,TBL,26,0,0,0,0
70,8479421,Jacob Moverare,D,LAK,26,0,0,0,0
70,8481585,Egor Afanasyev,L,SJS,23,0,0,0,0
70,8479547,Matthew Phillips,R,,26,0,0,0,0
70,8479367,William Lockwood,R,FLA,26,0,0,0,0
70,8476915,Jujhar Khaira,L,,30,0,0,0,0
70,8481422,Jacob Lucchini,C,NSH,29,0,0,0,0
70,8480468,James Hamblin,L,EDM,25,0,0,0,0
70,8478051,Max Willman,C,NJD,29,0,0,0,0
70,8481556,John Beecher,C,BOS,23,0,0,0,0
70,8478078,Rourke Chartier,C,,28,0,0,0,0
71,8476453,Nikita Kucherov,R,TBL,31,82,37,108,145
71,8478402,Connor McDavid,C,EDM,27,82,38,95,133
71,8478864,Kirill Kaprizov,L,MIN,27,82,57,68,125
71,8477939,William Nylander,R,TOR,28,82,56,66,122
71,8479314,Matthew Tkachuk,L,FLA,27,82,31,78,109
71,8478550,Artemi Panarin,L,NYR,33,82,38,69,107
71,8477492,Nathan MacKinnon,C,COL,29,82,38,68,106
71,8478420,Mikko Rantanen,R,COL,28,82,37,68,105
71,8477934,Leon Draisaitl,C,EDM,29,82,49,54,103
71,8479318,Auston Matthews,C,TOR,27,82,51,49,100
71,8477956,David Pastrnak,R,BOS,28,82,50,49,99
71,8480027,Jason Robertson,L,DAL,25,82,35,64,99
71,8477409,Carter Verhaeghe,C,FLA,29,82,48,50,98
71,8477493,Aleksander Barkov,C,FLA,29,82,31,67,98
71,8478445,Mathew Barzal,C,NYI,27,82,20,78,98
71,8478398,Kyle Connor,L,WPG,28,82,54,43,97
71,8471675,Sidney Crosby,C,PIT,37,82,39,57,96
71,8482116,Tim Stützle,C,OTT,22,82,34,62,96
71,8476887,Filip Forsberg,L,NSH,30,82,33,63,96
71,8481559,Jack Hughes,C,NJD,23,82,42,53,95
71,8478403,Jack Eichel,C,VGK,28,82,42,51,93
71,8480012,Elias Pettersson,C,VAN,26,82,34,59,93
71,8477404,Jake Guentzel,C,TBL,30,82,42,47,89
71,8477946,Dylan Larkin,C,DET,28,82,42,46,88
71,8477933,Sam Reinhart,C,FLA,29,82,42,46,88
71,8474564,Steven Stamkos,C,NSH,34,82,35,53,88
71,8480069,Cale Makar,D,COL,26,82,25,63,88
71,8475172,Nazem Kadri,C,CGY,34,82,25,62,87
71,8479343,Clayton Keller,R,UTA,26,82,33,53,86
71,8481557,Matt Boldy,L,MIN,23,82,26,60,86
71,8475158,Ryan O'Reilly,C,NSH,33,82,37,47,84
71,8479407,Jesper Bratt,L,NJD,26,82,29,55,84
71,8480865,Noah Dobson,D,NYI,24,82,19,65,84
71,8478010,Brayden Point,C,TBL,28,82,45,38,83
71,8480801,Brady Tkachuk,L,OTT,25,82,45,38,83
71,8479420,Tage Thompson,C,BUF,27,82,39,44,83
71,8480800,Quinn Hughes,D,VAN,25,82,14,69,83
71,8477951,Nick Schmaltz,C,UTA,28,82,27,55,82
71,8479323,Adam Fox,D,NYR,26,82,23,59,82
71,8478449,Roope Hintz,C,DAL,28,82,43,38,81
71,8477960,Adrian Kempe,R,LAK,28,82,32,49,81
71,8476454,Ryan Nugent-Hopkins,C,EDM,31,82,23,58,81
71,8471215,Evgeni Malkin,C,PIT,38,82,28,52,80
71,8477942,Kevin Fiala,L,LAK,28,82,32,47,79
71,8475166,John Tavares,C,TOR,34,82,29,50,79
71,8480023,Robert Thomas,C,STL,25,82,26,53,79
71,8478427,Sebastian Aho,C,CAR,27,82,29,49,78
71,8477940,Nikolaj Ehlers,L,WPG,28,82,29,49,78
71,8480002,Nico Hischier,C,NJD,25,82,27,51,78
71,8478460,Zach Werenski,D,CBJ,27,82,18,60,78
71,8478493,Joel Eriksson Ek,C,MIN,27,82,41,36,77
71,8476459,Mika Zibanejad,C,NYR,31,82,41,36,77
71,8480830,Andrei Svechnikov,R,CAR,24,82,27,50,77
71,8477402,Pavel Buchnevich,L,STL,29,82,26,51,77
71,8476389,Vincent Trocheck,C,NYR,31,82,23,54,77
71,8474141,Patrick Kane,R,DET,36,82,33,43,76
71,8473512,Claude Giroux,R,OTT,36,82,21,55,76
71,8476539,Jonathan Marchessault,R,NSH,34,82,40,35,75
71,8475786,Zach Hyman,L,EDM,32,82,37,38,75
71,8480208,Drake Batherson,R,OTT,26,82,33,42,75
71,8475913,Mark Stone,R,VGK,32,82,28,47,75
71,8481528,Dylan Cozens,C,BUF,23,82,28,47,75
71,8474600,Roman Josi,D,NSH,34,82,19,56,75
71,8477504,Josh Morrissey,D,WPG,29,82,8,67,75
71,8475754,Brock Nelson,C,NYI,33,82,36,38,74
71,8480015,Owen Tippett,R,PHI,25,82,32,42,74
71,8476346,Johnny Gaudreau,L,CBJ,31,82,16,58,74
71,8481523,Kirby Dach,C,MTL,23,82,16,58,74
71,8478439,Travis Konecny,R,PHI,27,82,37,36,73
71,8477500,Bo Horvat,C,NYI,29,82,36,37,73
71,8476905,Chandler Stephenson,C,SEA,30,82,21,52,73
71,8478440,Dylan Strome,C,WSH,27,82,20,53,73
71,8476468,J.T. Miller,C,VAN,31,82,22,50,72
71,8475168,Matt Duchene,C,DAL,33,82,22,50,72
71,8475184,Chris Kreider,L,NYR,33,82,40,31,71
71,8479339,Patrik Laine,L,CBJ,26,82,39,32,71
71,8482109,Alexis Lafrenière,L,NYR,23,82,28,43,71
71,8474586,Jordan Eberle,R,SEA,34,82,22,49,71
71,8477447,Shea Theodore,D,VGK,29,82,11,60,71
71,8477955,Jared McCann,L,SEA,28,82,42,28,70
71,8478444,Brock Boeser,R,VAN,27,82,34,36,70
71,8473419,Brad Marchand,L,BOS,36,82,26,44,70
71,8479337,Alex DeBrincat,R,DET,27,82,23,47,70
71,8477949,Alex Tuch,R,BUF,28,82,21,49,70
71,8482665,Matty Beniers,C,SEA,22,82,19,51,70
71,8480036,Miro Heiskanen,D,DAL,25,82,11,59,70
71,8475810,Bryan Rust,R,PIT,32,82,29,39,68
71,8482078,Lucas Raymond,L,DET,22,82,29,39,68
71,8480039,Martin Necas,C,CAR,25,82,27,41,68
71,8475692,Mats Zuccarello,R,MIN,37,82,21,47,68
71,8476875,Mike Matheson,D,MTL,30,82,17,51,68
71,8477416,Oliver Bjorkstrand,R,SEA,29,82,34,33,67
71,8478414,Timo Meier,R,NJD,28,82,30,37,67
71,8479385,Jordan Kyrou,C,STL,26,82,32,34,66
71,8476460,Mark Scheifele,C,WPG,31,82,26,40,66
71,8478438,Tommy Novak,C,NSH,27,82,26,39,65
71,8475167,Victor Hedman,D,TBL,34,82,17,48,65
71,8476399,Blake Coleman,C,CGY,33,82,39,25,64
71,8475794,Tyler Seguin,C,DAL,32,82,35,29,64
71,8478366,Frank Vatrano,R,ANA,30,82,33,31,64
71,8478401,Pavel Zacha,C,BOS,27,82,31,33,64
71,8481540,Cole Caufield,R,MTL,23,82,30,34,64
71,8478047,Michael Bunting,L,PIT,29,82,27,37,64
71,8475765,Vladimir Tarasenko,R,DET,33,82,23,41,64
71,8480018,Nick Suzuki,C,MTL,25,82,22,42,64
71,8474590,John Carlson,D,WSH,34,82,15,49,64
71,8480839,Rasmus Dahlin,D,BUF,24,82,13,51,64
71,8477501,Valeri Nichushkin,R,COL,29,82,38,25,63
71,8476432,Boone Jenner,C,CBJ,31,82,35,28,63
71,8471214,Alex Ovechkin,L,WSH,39,82,31,32,63
71,8482745,Mason McTavish,C,ANA,21,82,27,36,63
71,8478407,Vince Dunn,D,SEA,28,82,22,41,63
71,8476881,Tomas Hertl,C,VGK,31,82,30,32,62
71,8482093,Seth Jarvis,C,CAR,22,82,28,34,62
71,8479542,Brandon Hagel,L,TBL,26,82,27,35,62
71,8481533,Trevor Zegras,C,ANA,23,82,26,36,62
71,8473994,Jamie Benn,L,DAL,35,82,26,36,62
71,8478042,Viktor Arvidsson,R,EDM,31,82,25,37,62
71,8478975,Mason Marchment,L,DAL,29,82,24,38,62
71,8482097,Jack Quinn,R,BUF,23,82,28,33,61
71,8474102,David Perron,L,OTT,36,82,22,39,61
71,8480803,Evan Bouchard,D,EDM,25,82,17,44,61
71,8471724,Kris Letang,D,PIT,37,82,10,51,61
71,8477496,Elias Lindholm,C,BOS,30,82,19,41,60
71,8477986,Brandon Montour,D,SEA,30,82,18,42,60
71,8474679,Gustav Nyquist,C,NSH,35,82,15,45,60
71,8475784,Jeff Skinner,C,EDM,32,82,31,28,59
71,8477511,Anthony Mantha,R,CGY,30,82,31,28,59
71,8477479,Tyler Bertuzzi,L,CHI,29,82,29,30,59
71,8477935,Sam Bennett,C,FLA,28,82,21,38,59
71,8482684,Luke Hughes,D,NJD,21,82,20,39,59
71,8479325,Charlie McAvoy,D,BOS,27,82,12,47,59
71,8478856,Conor Garland,R,VAN,28,82,20,38,58
71,8478396,Noah Hanifin,D,VGK,27,82,17,41,58
71,8476458,Ryan Strome,C,ANA,31,82,16,42,58
71,8475726,Tyler Toffoli,C,SJS,32,82,29,28,57
71,8479675,Trevor Moore,L,LAK,29,82,22,35,57
71,8478462,Nicolas Roy,C,VGK,27,82,20,37,57
71,8476958,Jaccob Slavin,D,CAR,30,82,13,44,57
71,8478397,Rasmus Andersson,D,CGY,28,82,11,46,57
71,8478474,Lawson Crouse,L,UTA,27,82,33,23,56
71,8478498,Jake DeBrusk,L,VAN,28,82,28,28,56
71,8480188,Fabian Zetterlund,L,SJS,25,82,25,31,56
71,8479345,Jakob Chychrun,D,WSH,26,82,22,34,56
71,8475287,Erik Haula,L,NJD,33,82,22,34,56
71,8475753,Justin Faulk,D,STL,32,82,16,40,56
71,8478038,Devon Toews,D,COL,30,82,13,43,56
71,8475798,Mikael Granlund,C,SJS,32,82,11,45,56
71,8479410,Mikhail Sergachev,D,UTA,26,82,11,45,56
71,8476456,Jonathan Huberdeau,C,CGY,31,82,8,48,56
71,8475151,Kyle Palmieri,C,NYI,33,82,28,27,55
71,8474150,Mikael Backlund,C,CGY,35,82,27,28,55
71,8481068,Yegor Sharangovich,C,CGY,26,82,23,32,55
71,8477346,MacKenzie Weegar,D,CGY,30,82,13,42,55
71,8480014,Gabriel Vilardi,C,WPG,25,82,33,21,54
71,8482740,Wyatt Johnston,C,DAL,21,82,22,32,54
71,8478873,Troy Terry,R,ANA,27,82,19,35,54
71,8482159,Tyson Foerster,R,PHI,22,82,27,26,53
71,8476448,William Karlsson,C,VGK,31,82,25,28,53
71,8476461,Sean Couturier,C,PHI,32,82,23,30,53
71,8481581,Thomas Harley,D,DAL,23,82,10,43,53
71,8476792,Torey Krug,D,STL,33,82,9,44,53
71,8476853,Morgan Rielly,D,TOR,30,82,7,46,53
71,8471698,T.J. Oshie,R,WSH,38,82,31,21,52
71,8476479,Phillip Danault,C,LAK,31,82,22,30,52
71,8480113,Alex Iafallo,L,WPG,31,82,21,31,52
71,8475745,Charlie Coyle,C,BOS,32,82,21,31,52
71,8474578,Erik Karlsson,D,PIT,34,82,17,35,52
71,8481711,Matias Maccelli,L,UTA,24,82,17,35,52
71,8470613,Brent Burns,D,CAR,39,82,16,36,52
71,8482667,William Eklund,L,SJS,22,82,15,37,52
71,8480797,Joel Farabee,L,PHI,24,82,23,28,51
71,8473986,Alex Killorn,L,ANA,35,82,22,29,51
71,8475768,Jaden Schwartz,C,SEA,32,82,22,29,51
71,8477964,Ivan Barbashev,C,VGK,29,82,19,32,51
71,8477444,Andre Burakovsky,L,SEA,29,82,19,32,51
71,8478469,Thomas Chabot,D,OTT,27,82,16,35,51
71,8477503,Max Domi,C,TOR,29,82,13,38,51
71,8479425,Filip Hronek,D,VAN,27,82,11,40,51
71,8474563,Drew Doughty,D,LAK,35,82,10,41,51
71,8475314,Anders Lee,L,NYI,34,82,32,18,50
71,8476483,Rickard Rakell,R,PIT,31,82,23,27,50
71,8474053,Logan Couture,C,SJS,35,82,20,30,50
71,8477932,Aaron Ekblad,D,FLA,28,82,12,38,50
71,8476826,Yanni Gourde,C,SEA,33,82,12,38,50
71,8481542,Moritz Seider,D,DET,23,82,7,43,50
71,8477456,J.T. Compher,L,DET,29,82,23,26,49
71,8482105,Jake Sanderson,D,OTT,22,82,13,36,49
71,8475218,Mattias Ekholm,D,EDM,34,82,12,37,49
71,8477495,Seth Jones,D,CHI,30,82,11,38,49
71,8483808,Andrei Kuzmenko,L,CGY,28,82,23,25,48
71,8480185,Eetu Luostarinen,C,FLA,26,82,22,26,48
71,8475169,Evander Kane,L,EDM,33,82,22,26,48
71,8475149,Marcus Johansson,L,MIN,34,82,18,30,48
71,8477429,Andrew Copp,C,DET,30,82,18,30,48
71,8477497,Sean Monahan,C,CBJ,30,82,18,30,48
71,8476882,Teuvo Teravainen,L,CHI,30,82,16,32,48
71,8482175,JJ Peterka,R,BUF,22,82,26,21,47
71,8475170,Brayden Schenn,C,STL,33,82,23,24,47
71,8481596,Shane Pinto,C,OTT,24,82,16,31,47
71,8479999,Casey Mittelstadt,C,COL,26,82,11,36,47
71,8474565,Alex Pietrangelo,D,VGK,34,82,7,40,47
71,8478472,Mathieu Joseph,R,STL,27,82,22,24,46
71,8478519,Anthony Cirelli,C,TBL,27,82,17,29,46
71,8478046,Danton Heinen,L,VAN,29,82,15,31,46
71,8477451,Ryan Hartman,R,MIN,30,82,14,32,46
71,8480434,Sean Durzi,D,UTA,26,82,10,36,46
71,8479525,Ross Colton,C,COL,28,82,21,24,45
71,8475793,Ryan Johansen,C,PHI,32,82,21,24,45
71,8482146,Luke Evangelista,R,NSH,22,82,20,25,45
71,8480220,Noah Cates,L,PHI,25,82,16,29,45
71,8475791,Taylor Hall,L,CHI,33,82,15,30,45
71,8477021,Alex Kerfoot,C,UTA,30,82,13,32,45
71,8477506,Ryan Pulock,D,NYI,30,82,4,41,45
71,8476438,Brandon Saad,L,STL,32,82,23,21,44
71,8481618,Alex Newhook,C,MTL,23,82,21,23,44
71,8482092,Ridly Greig,C,OTT,22,82,20,24,44
71,8482110,Dawson Mercer,C,NJD,23,82,20,24,44
71,8477407,Anthony Duclair,L,NYI,29,82,19,25,44
71,8479992,Michael Rasmussen,C,DET,25,82,18,26,44
71,8482720,Matthew Knies,L,TOR,22,82,18,26,44
71,8482624,Daniil Miromanov,D,CGY,27,82,16,28,44
71,8476906,Shayne Gostisbehere,D,CAR,31,82,12,32,44
71,8480871,Adam Boqvist,D,FLA,24,82,11,33,44
71,8477476,Artturi Lehkonen,L,COL,29,82,22,21,43
71,8475714,Calle Jarnkrok,C,TOR,33,82,22,21,43
71,8478542,Evan Rodrigues,C,FLA,31,82,21,22,43
71,8471685,Anze Kopitar,C,LAK,37,82,20,23,43
71,8476329,Travis Boyd,C,MIN,31,82,20,23,43
71,8478463,Anthony Beauvillier,L,PIT,27,82,18,25,43
71,8481554,Kaapo Kakko,R,NYR,23,82,18,25,43
71,8478458,Jack Roslovic,C,CAR,27,82,17,26,43
71,8474149,Evgenii Dadonov,R,DAL,35,82,17,26,43
71,8476462,Dougie Hamilton,D,NJD,31,82,16,27,43
71,8475191,Reilly Smith,R,NYR,33,82,13,30,43
71,8479400,Pierre-Luc Dubois,L,WSH,26,82,12,31,43
71,8482671,Owen Power,D,BUF,22,82,9,34,43
71,8475193,Tomas Tatar,L,NJD,34,82,19,23,42
71,8473422,Nick Foligno,L,CHI,37,82,17,25,42
71,8478233,Andrew Mangiapane,L,WSH,28,82,15,27,42
71,8482124,Quinton Byfield,R,LAK,22,82,14,28,42
71,8480028,Morgan Frost,C,PHI,25,82,10,32,42
71,8479365,Trent Frederic,C,BOS,26,82,21,20,41
71,8481624,Ilya Mikheyev,R,CHI,30,82,21,20,41
71,8477953,Kasperi Kapanen,R,STL,28,82,19,22,41
71,8473533,Jordan Staal,C,CAR,36,82,19,22,41
71,8478413,Jordan Greenway,L,BUF,27,82,16,25,41
71,8476869,Brady Skjei,D,NSH,30,82,11,30,41
71,8478055,Gustav Forsling,D,FLA,28,82,8,33,41
71,8481580,Connor McMichael,C,WSH,23,82,22,18,40
71,8482113,Anton Lundell,C,FLA,23,82,20,20,40
71,8476918,Jimmy Vesey,L,NYR,31,82,19,21,40
71,8480798,Philipp Kurashev,C,CHI,25,82,17,23,40
71,8480849,Barrett Hayton,C,UTA,24,82,17,23,40
71,8482699,Dylan Guenther,R,UTA,21,82,16,24,40
71,8473563,Nicklas Backstrom,C,WSH,37,82,15,25,40
71,8477498,Darnell Nurse,D,EDM,29,82,14,26,40
71,8481546,Cam York,D,PHI,23,82,10,30,40
71,8475760,Nick Bjugstad,C,UTA,32,82,23,16,39
71,8481704,Juuso Parssinen,C,NSH,23,82,20,19,39
71,8476873,Mark Jankowski,C,NSH,30,82,20,19,39
71,8477494,Jonathan Drouin,L,COL,29,82,19,20,39
71,8476292,Ondrej Palat,L,NJD,33,82,17,22,39
71,8479591,Michael Eyssimont,C,TBL,28,82,17,22,39
71,8480817,K'Andre Miller,D,NYR,24,82,12,27,39
71,8474716,Jared Spurgeon,D,MIN,35,82,10,29,39
71,8479941,Justin Danforth,R,CBJ,31,82,22,16,38
71,8478115,Pierre Engvall,L,NYI,28,82,19,19,38
71,8482475,Yegor Chinakhov,R,CBJ,23,82,18,20,38
71,8481582,Nicholas Robertson,L,TOR,23,82,18,20,38
71,8480893,Kirill Marchenko,R,CBJ,24,82,18,20,38
71,8477952,Robby Fabbri,C,ANA,28,82,18,20,38
71,8483515,Juraj Slafkovsky,L,MTL,20,82,17,21,38
71,8480802,Ryan McLeod,C,BUF,25,82,11,27,38
71,8476923,Damon Severson,D,CBJ,30,82,10,28,38
71,8480068,Ryan Poehling,C,PHI,25,82,9,29,38
71,8475764,Cam Fowler,D,ANA,33,82,6,32,38
71,8475722,Jason Zucker,L,BUF,32,82,23,14,37
71,8483431,Logan Cooley,C,UTA,20,82,23,14,37
71,8476880,Tom Wilson,R,WSH,30,82,21,16,37
71,8481604,Pavel Dorofeyev,L,VGK,24,82,19,18,37
71,8475799,Nino Niederreiter,R,WPG,32,82,16,21,37
71,8479390,Taylor Raddysh,R,WSH,26,82,14,23,37
71,8475763,Kevin Hayes,R,PIT,32,82,12,25,37
71,8477220,Nate Schmidt,D,FLA,33,82,8,29,37
71,8482055,Drew O'Connor,L,PIT,26,82,21,15,36
71,8474641,Adam Henrique,C,EDM,34,82,18,18,36
71,8478057,Dakota Joshua,C,VAN,28,82,18,18,36
71,8477426,Nicholas Paul,L,TBL,29,82,18,18,36
71,8481481,Blake Lizotte,C,PIT,27,82,17,19,36
71,8482149,Cole Perfetti,C,WPG,22,82,16,20,36
71,8480829,Jesperi Kotkaniemi,C,CAR,24,82,16,20,36
71,8477931,Tomas Nosek,L,FLA,32,82,15,21,36
71,8480009,Eeli Tolvanen,R,SEA,25,82,14,22,36
71,8476960,Andreas Athanasiou,C,CHI,30,82,14,22,36
71,8473507,Jeff Petry,D,DET,37,82,10,26,36
71,8480145,Neal Pionk,D,WPG,29,82,6,30,36
71,8476902,Esa Lindell,D,DAL,30,82,5,31,36
71,8479398,Samuel Girard,D,COL,26,82,3,33,36
71,8484144,Connor Bedard,C,CHI,19,82,18,17,35
71,8476278,Colin Blackwell,C,DAL,31,82,18,17,35
71,8479293,Brandon Tanev,L,SEA,33,82,18,17,35
71,8480064,Josh Norris,C,OTT,25,82,17,18,35
71,8480835,Jack Drury,C,CAR,24,82,17,18,35
71,8479987,Morgan Geekie,C,BOS,26,82,16,19,35
71,8476419,Jean-Gabriel Pageau,C,NYI,32,82,16,19,35
71,8482705,Cole Sillinger,C,CBJ,21,82,14,21,35
71,8477998,Warren Foegele,L,LAK,28,82,13,22,35
71,8474574,Tyler Myers,D,VAN,34,82,12,23,35
71,8476925,Colton Sissons,C,NSH,31,82,11,24,35
71,8475200,Dmitry Orlov,D,CAR,33,82,7,28,35
71,8477488,Brett Pesce,D,NJD,30,82,7,28,35
71,8474151,Ryan McDonagh,D,TBL,35,82,5,30,35
71,8482089,Jake Neighbours,L,STL,22,82,18,16,34
71,8474715,Cam Atkinson,R,TBL,35,82,17,17,34
71,8481560,Arthur Kaliyev,R,LAK,23,82,17,17,34
71,8482117,Lukas Reichel,L,CHI,22,82,17,17,34
71,8481535,Nils Hoglander,L,VAN,24,82,16,18,34
71,8482133,Thomas Bordeleau,C,SJS,22,82,13,21,34
71,8476854,Hampus Lindholm,D,BOS,30,82,10,24,34
71,8476917,Adam Pelech,D,NYI,30,82,6,28,34
71,8479316,Luke Kunin,C,SJS,27,82,17,16,33
71,8478569,Noel Acciari,C,PIT,33,82,16,17,33
71,8480003,Jesper Boqvist,C,FLA,26,82,15,18,33
71,8478891,Mason Appleton,C,WPG,28,82,14,19,33
71,8480748,Kiefer Sherwood,L,VAN,29,82,13,20,33
71,8481553,Bobby Brink,R,PHI,23,82,12,21,33
71,8477919,Frederick Gaudreau,C,MIN,31,82,12,21,33
71,8483457,Lane Hutson,D,MTL,20,82,10,23,33
71,8478911,Matt Roy,D,WSH,29,82,8,25,33
71,8477947,Sonny Milano,L,WSH,28,82,7,26,33
71,8476979,Erik Gustafsson,D,DET,32,82,6,27,33
71,8476463,Jonas Brodin,D,MIN,31,82,6,27,33
71,8481568,Alex Vlasic,D,CHI,23,82,4,29,33
71,8475848,Brendan Gallagher,R,MTL,32,82,17,15,32
71,8478109,Victor Olofsson,L,VGK,29,82,17,15,32
71,8481186,Logan O'Connor,R,COL,28,82,15,17,32
71,8482079,Marco Rossi,C,MIN,23,82,13,19,32
71,8480078,Filip Chytil,C,NYR,25,82,12,20,32
71,8481656,Aliaksei Protas,C,WSH,23,82,12,20,32
71,8477450,Jason Dickinson,C,CHI,29,82,11,21,32
71,8480336,Sean Walker,D,CAR,30,82,9,23,32
71,8482660,Kent Johnson,C,CBJ,22,82,8,24,32
71,8477508,Curtis Lazar,C,NJD,29,82,8,24,32
71,8480035,Henri Jokiharju,D,BUF,25,82,3,29,32
71,8479353,Brett Howden,C,VGK,26,82,18,13,31
71,8481601,Simon Holmstrom,R,NYI,23,82,16,15,31
71,8481032,Paul Cotter,C,NJD,25,82,15,16,31
71,8480789,Oliver Wahlstrom,R,NYI,24,82,14,17,31
71,8476872,Scott Laughton,C,PHI,30,82,13,18,31
71,8480873,Rasmus Sandin,D,WSH,24,82,7,24,31
71,8476885,Jacob Trouba,D,NYR,30,82,7,24,31
71,8478133,Jake Evans,C,MTL,28,82,7,24,31
71,8478500,Ivan Provorov,D,CBJ,27,82,6,25,31
71,8478508,Yakov Trenin,C,MIN,27,82,17,13,30
71,8483524,Shane Wright,C,SEA,20,82,16,14,30
71,8479996,Cody Glass,C,NSH,25,82,15,15,30
71,8479393,Noah Gregor,C,OTT,26,82,14,16,30
71,8482666,Scott Morrow,D,CAR,22,82,13,17,30
71,8477989,Christian Dvorak,C,MTL,28,82,11,19,30
71,8476467,Jamie Oleksiak,D,SEA,32,82,10,20,30
71,8484166,Adam Fantilli,C,CBJ,20,82,7,23,30
71,8479976,Juuso Valimaki,D,UTA,26,82,3,27,30
71,8477425,Miles Wood,L,COL,29,82,16,13,29
71,8476921,Jordan Martinook,L,CAR,32,82,16,13,29
71,8476981,Josh Anderson,R,MTL,30,82,15,14,29
71,8479661,Tanner Jeannot,L,LAK,27,82,15,14,29
71,8480855,Jack McBain,C,UTA,24,82,15,14,29
71,8478432,Christian Fischer,R,DET,27,82,14,15,29
71,8477406,Mattias Janmark,C,EDM,32,82,14,15,29
71,8484203,Bradly Nadeau,L,CAR,19,82,14,15,29
71,8476927,Teddy Blueger,C,VAN,30,82,13,16,29
71,8477987,Ryan Donato,C,CHI,28,82,12,17,29
71,8477839,Conor Sheary,L,TBL,32,82,12,17,29
71,8483468,Jiri Kulich,C,BUF,20,82,12,17,29
71,8478013,Jake Walman,D,SJS,28,82,11,18,29
71,8477369,Carson Soucy,D,VAN,30,82,10,19,29
71,8476312,Josh Manson,D,COL,33,82,9,20,29
71,8478882,Vladislav Gavrikov,D,LAK,29,82,8,21,29
71,8476892,Colton Parayko,D,STL,31,82,6,23,29
71,8482122,Brock Faber,D,MIN,22,82,6,23,29
71,8476331,Dylan DeMelo,D,WPG,31,82,2,27,29
71,8481178,Egor Zamula,D,PHI,24,82,2,27,29
71,8478020,Michael Amadio,C,OTT,28,82,18,10,28
71,8482125,Alexander Holtz,R,VGK,22,82,15,13,28
71,8480459,Pius Suter,C,VAN,28,82,15,13,28
71,8474189,Lars Eller,C,PIT,35,82,13,15,28
71,8479351,Sam Steel,C,DAL,26,82,13,15,28
71,8480813,Joe Veleno,C,DET,24,82,12,16,28
71,8477353,Tyler Motte,C,DET,29,82,10,18,28
71,8476457,Adam Larsson,D,SEA,32,82,10,18,28
71,8477948,Travis Sanheim,D,PHI,28,82,7,21,28
71,8482655,J.J. Moser,D,TBL,24,82,6,22,28
71,8480073,Erik Brannstrom,D,COL,25,82,4,24,28
71,8480049,Dylan Samberg,D,WPG,25,82,3,25,28
71,8479402,Jake Bean,D,CGY,26,82,3,25,28
71,8481013,Jonatan Berggren,R,DET,24,82,18,9,27
71,8477903,Garnet Hathaway,R,PHI,33,82,15,12,27
71,8475220,Marcus Foligno,L,MIN,33,82,12,15,27
71,8484145,Zach Benson,L,BUF,19,82,11,16,27
71,8475171,Oliver Ekman-Larsson,D,TOR,33,82,6,21,27
71,8480074,Alexandre Texier,C,STL,25,82,6,21,27
71,8475690,Chris Tanev,D,TOR,35,82,4,23,27
71,8478840,Will Borgen,D,SEA,28,82,3,24,27
71,8480043,Timothy Liljegren,D,TOR,25,82,2,25,27
71,8476374,Sean Kuraly,C,CBJ,31,82,14,12,26
71,8484153,Leo Carlsson,C,ANA,20,82,11,15,26
71,8477392,Hudson Fasching,R,NYI,29,82,10,16,26
71,8476897,Oskar Sundqvist,C,STL,30,82,10,16,26
71,8476422,Mike Reilly,D,NYI,31,82,9,17,26
71,8475181,Nick Leddy,D,STL,33,82,7,19,26
71,8475231,Casey Cizikas,C,NYI,33,82,7,19,26
71,8475233,David Savard,D,MTL,34,82,6,20,26
71,8481606,Jordan Spence,D,LAK,23,82,5,21,26
71,8478507,John Marino,D,UTA,27,82,4,22,26
71,8482111,Justin Barron,D,MTL,23,82,17,8,25
71,8482259,Bobby McMann,C,TOR,28,82,15,10,25
71,8476480,Vladislav Namestnikov,C,WPG,32,82,13,12,25
71,8476469,Joel Armia,R,MTL,31,82,13,12,25
71,8479414,Nathan Bastian,R,NJD,27,82,12,13,25
71,8481093,Rafael Harvey-Pinard,L,MTL,25,82,12,13,25
71,8481477,Nico Sturm,C,SJS,29,82,12,13,25
71,8477507,Nikita Zadorov,D,BOS,29,82,11,14,25
71,8475343,Nic Dowd,C,WSH,34,82,10,15,25
71,8480144,David Kampf,C,TOR,29,82,9,16,25
71,8476624,Barclay Goodrow,C,SJS,31,82,9,16,25
71,8482141,Lukas Cormier,D,VGK,22,82,8,17,25
71,8479980,Nicolas Hague,D,VGK,26,82,6,19,25
71,8481567,Henry Thrun,D,SJS,23,82,6,19,25
71,8477969,Marcus Pettersson,D,PIT,28,82,5,20,25
71,8478399,Jonas Siegenthaler,D,NJD,27,82,5,20,25
71,8478416,Erik Cernak,D,TBL,27,82,5,20,25
71,8482142,Jamie Drysdale,D,PHI,22,82,4,21,25
71,8477435,Ryan Graves,D,PIT,29,82,4,21,25
71,8482073,Braden Schneider,D,NYR,23,82,3,22,25
71,8476879,Cody Ceci,D,EDM,31,82,2,23,25
71,8475324,Nick Jensen,D,OTT,34,82,2,23,25
71,8482702,Logan Stankoven,C,DAL,21,82,13,11,24
71,8475842,Sam Carrick,C,NYR,32,82,13,11,24
71,8477015,Connor Brown,R,EDM,30,82,8,16,24
71,8476474,Stefan Noesen,R,NJD,31,82,8,16,24
71,8482166,Shakir Mukhamadullin,D,SJS,22,82,8,16,24
71,8484911,Collin Graf,R,SJS,22,82,7,17,24
71,8482245,Artem Zub,D,OTT,29,82,4,20,24
71,8481522,Peyton Krebs,C,BUF,23,82,11,12,23
71,8483505,Matthew Poitras,C,BOS,20,82,10,13,23
71,8482733,Logan Mailloux,D,MTL,31,82,8,15,23
71,8479324,Ryan Lindgren,D,NYR,26,82,7,16,23
71,8477499,Rasmus Ristolainen,D,PHI,30,82,7,16,23
71,8482470,Ilya Solovyov,D,CGY,24,82,7,16,23
71,8483482,Tristan Luneau,D,ANA,20,82,7,16,23
71,8479368,Max Jones,L,BOS,26,82,6,17,23
71,8480807,Mattias Samuelsson,D,BUF,24,82,5,18,23
71,8477845,Trevor van Riemsdyk,D,WSH,33,82,4,19,23
71,8474673,TJ Brodie,D,CHI,34,82,2,21,23
71,8482074,Connor Zary,C,CGY,23,82,11,11,22
71,8480281,Alexey Toropchenko,R,STL,25,82,11,11,22
71,8480995,Pontus Holmberg,R,TOR,25,82,9,13,22
71,8483565,Nick Blankenburg,D,NSH,26,82,9,13,22
71,8478851,Alexandre Carrier,D,NSH,28,82,7,15,22
71,8483495,Simon Nemec,D,NJD,20,82,7,15,22
71,8479369,Andrew Peeke,D,BOS,26,82,6,16,22
71,8470621,Corey Perry,R,EDM,39,82,10,11,21
71,8482807,Ethan Del Mastro,D,CHI,21,82,9,12,21
71,8476392,Adam Lowry,C,WPG,31,82,8,13,21
71,8478434,Keegan Kolesar,R,VGK,27,82,8,13,21
71,8483012,Logan Morrison,C,SEA,22,82,8,13,21
71,8482087,Kaiden Guhle,D,MTL,22,82,6,15,21
71,8473453,Trevor Lewis,C,LAK,37,82,6,15,21
71,8480806,Isac Lundestrom,C,ANA,25,82,6,15,21
71,8476525,Colin Miller,D,WPG,32,82,6,15,21
71,8480878,Nils Lundkvist,D,DAL,24,82,5,16,21
71,8482062,Cole Smith,L,NSH,29,82,5,16,21
71,8478136,Jake Middleton,D,MIN,28,82,3,18,21
71,8481014,Alexander Romanov,D,NYI,24,82,3,18,21
71,8481708,Zac Jones,D,NYR,24,82,3,18,21
71,8476967,Brett Kulak,D,EDM,30,82,2,19,21
71,8476858,Phillip Di Giuseppe,L,VAN,31,82,13,7,20
71,8481517,Brett Leason,R,ANA,25,82,11,9,20
71,8476889,Radek Faksa,C,STL,30,82,9,11,20
71,8481524,Bowen Byram,D,BUF,23,82,9,11,20
71,8479291,Kevin Rooney,C,CGY,31,82,8,12,20
71,8474090,Brendan Smith,D,DAL,35,82,6,14,20
71,8480860,Kevin Bahl,D,CGY,24,82,3,17,20
71,8475279,Ben Chiarot,D,DET,33,82,3,17,20
71,8475790,Erik Gudbranson,D,CBJ,32,82,3,17,20
71,8475188,Brayden McNabb,D,VGK,33,82,2,18,20
71,8476931,Jake McCabe,D,TOR,31,82,0,20,20
71,8480448,Parker Kelly,L,COL,25,82,8,11,19
71,8482858,Ryker Evans,D,SEA,23,82,6,13,19
71,8480879,Jacob Bernard-Docker,D,OTT,24,82,5,14,19
71,8478859,Niko Mikkola,D,FLA,28,82,5,14,19
71,8482803,Olen Zellweger,D,ANA,21,82,5,14,19
71,8475462,Radko Gudas,D,ANA,34,82,4,15,19
71,8475177,Calvin de Haan,D,COL,33,82,4,15,19
71,8479442,Troy Stecher,D,EDM,30,82,4,15,19
71,8480172,Jan Rutta,D,SJS,34,82,4,15,19
71,8480950,Ilya Lyubushkin,D,DAL,30,82,3,16,19
71,8480990,Declan Chisholm,D,MIN,24,82,1,18,19
71,8482155,Alex Laferriere,R,LAK,23,82,12,6,18
71,8482749,Joshua Roy,R,MTL,21,82,12,6,18
71,8478211,Dryden Hunt,L,CGY,29,82,9,9,18
71,8480980,Connor Dewar,C,TOR,25,82,6,12,18
71,8480796,Martin Fehervary,D,WSH,25,82,6,12,18
71,8483499,Liam Ohgren,L,MIN,20,82,6,12,18
71,8484149,Gavin Brindley,C,CBJ,20,82,4,14,18
71,8479359,Beck Malenstyn,L,BUF,26,82,4,14,18
71,8480834,Ty Emberson,D,SJS,24,82,4,14,18
71,8480246,Nick Perbix,D,TBL,26,82,3,15,18
71,8483490,Pavel Mintyukov,D,ANA,21,82,3,15,18
71,8478443,Brandon Carlo,D,BOS,28,82,2,16,18
71,8478468,Jeremy Lauzon,D,NSH,27,82,1,17,18
71,8480870,Bo Groulx,C,NYR,24,82,11,6,17
71,8477505,Alexander Wennberg,C,SJS,30,82,8,9,17
71,8476878,Zemgus Girgensons,L,TBL,30,82,7,10,17
71,8482101,Danil Gushchin,L,SJS,22,82,7,10,17
71,8482762,Simon Edvinsson,D,DET,21,82,6,11,17
71,8475855,Jesper Fast,R,CAR,33,82,5,12,17
71,8476429,Scott Mayfield,D,NYI,32,82,5,12,17
71,8476442,Matt Nieto,L,PIT,32,82,5,12,17
71,8481699,Aku Raty,R,UTA,23,82,4,13,17
71,8479371,Dante Fabbro,D,NSH,26,82,1,16,17
71,8480025,MacKenzie Entwistle,R,FLA,25,82,9,7,16
71,8482809,Jackson Blake,R,CAR,21,82,9,7,16
71,8481641,Joel Kiviranta,L,COL,28,82,9,7,16
71,8481028,Martin Pospisil,C,CGY,25,82,8,8,16
71,8479983,Mario Ferraro,D,SJS,26,82,5,11,16
71,8478178,Darren Raddysh,D,TBL,28,82,5,11,16
71,8483471,Brad Lambert,C,WPG,31,82,5,11,16
71,8474612,Travis Hamonic,D,OTT,34,82,3,13,16
71,8476372,Nick Seeler,D,PHI,31,82,2,14,16
71,8482077,Dylan Holloway,L,EDM,23,82,8,7,15
71,8482679,Matt Coronato,R,CGY,22,82,6,9,15
71,8483763,Maksymilian Szuber,D,UTA,22,82,6,9,15
71,8483493,Frank Nazar,C,CHI,20,82,5,10,15
71,8481605,Jackson LaCombe,D,ANA,23,82,5,10,15
71,8477938,Haydn Fleury,D,WPG,28,82,4,11,15
71,8482516,Matthew Kessel,D,STL,24,82,3,12,15
71,8474013,Ian Cole,D,UTA,35,82,3,12,15
71,8475762,Derek Forbort,D,VAN,32,82,3,12,15
71,8475718,Justin Holl,D,DET,32,82,0,15,15
71,8482070,Mitchell Chaffee,R,TBL,26,82,7,7,14
71,8477365,Connor Clifton,D,BUF,29,82,5,9,14
71,8479998,Mikey Anderson,D,LAK,25,82,3,11,14
71,8477335,Kyle Burroughs,D,LAK,29,82,3,11,14
71,8476891,Matt Grzelcyk,D,PIT,30,82,0,14,14
71,8483445,Cutter Gauthier,L,ANA,20,82,3,10,13
71,8480222,Sebastian Aho,D,PIT,28,82,2,11,13
71,8477034,Jaycob Megna,D,FLA,32,82,1,12,13
71,8483460,David Jiricek,D,CBJ,21,82,1,12,13
71,8482659,Josh Doan,R,UTA,22,82,8,4,12
71,8482145,Mavrik Bourque,C,DAL,22,82,4,8,12
71,8483466,Kevin Korchinski,D,CHI,20,82,3,9,12
71,8482118,Sam Colangelo,R,ANA,23,82,3,9,12
71,8470600,Ryan Suter,D,STL,39,82,2,10,12
71,8476441,Joel Edmundson,D,LAK,31,82,2,10,12
71,8475455,Brenden Dillon,D,NJD,34,82,0,12,12
71,8482713,Mackie Samoskevich,R,FLA,22,82,4,7,11
71,8482153,Brendan Brisson,C,VGK,23,82,3,8,11
71,8480021,Jack Studnicka,C,LAK,25,82,7,3,10
71,8482712,Oskar Olausson,R,COL,22,82,6,4,10
71,8483489,Fraser Minten,C,TOR,31,82,5,5,10
71,8476822,Luke Glendening,C,TBL,35,82,5,5,10
71,8474567,Zach Bogosian,D,MIN,34,82,3,7,10
71,8478450,Parker Wotherspoon,D,BOS,27,82,1,9,10
71,8482859,Zack Ostapchuk,C,OTT,21,82,6,3,9
71,8476473,Connor Murphy,D,CHI,31,82,1,8,9
71,8478874,Adam Gaudette,C,OTT,28,82,0,9,9
71,8479638,Justin Brazeau,R,BOS,26,82,4,4,8
71,8483397,Marc McLaughlin,C,BOS,25,82,3,5,8
71,8479576,Vincent Desharnais,D,VAN,28,82,3,5,8
71,8471677,Jack Johnson,D,CBJ,37,82,2,6,8
71,8483567,Georgii Merkulov,C,BOS,24,82,2,6,8
71,8482787,Nikita Chibrikov,R,WPG,31,82,2,5,7
71,8481122,Simon Benoit,D,TOR,26,82,1,6,7
71,8474062,Riley Nash,C,NYR,35,82,2,4,6
71,8470794,Joe Pavelski,C,,40,0,0,0,0
71,8481703,Valtteri Puustinen,R,PIT,25,0,0,0,0
71,8477950,Tony DeAngelo,D,,29,0,0,0,0
71,8481577,Philip Tomasino,C,NSH,23,0,0,0,0
71,8475197,Tyson Barrie,D,,33,0,0,0,0
71,8471218,Blake Wheeler,R,,38,0,0,0,0
71,8474157,Max Pacioretty,L,,36,0,0,0,0
71,8478466,Daniel Sprong,R,VAN,27,0,0,0,0
71,8475744,Evgeny Kuznetsov,C,,32,0,0,0,0
71,8481019,David Gustafsson,C,WPG,24,0,0,0,0
71,8475906,John Klingberg,D,,32,0,0,0,0
71,8479348,Kale Clague,D,BUF,26,0,0,0,0
71,8476952,Dominic Toninato,C,WPG,30,0,0,0,0
71,8473473,Milan Lucic,L,,36,0,0,0,0
71,8474037,James van Riemsdyk,L,,35,0,0,0,0
71,8474602,Justin Schultz,D,,34,0,0,0,0
71,8482222,Alexander Barabanov,L,,30,0,0,0,0
71,8479372,Josh Mahura,D,SEA,26,0,0,0,0
71,8479982,Conor Timmins,D,TOR,26,0,0,0,0
71,8474031,Kevin Shattenkirk,D,,35,0,0,0,0
71,8480008,Adam Ruzicka,C,,25,0,0,0,0
71,8481059,Scott Perunovich,D,STL,26,0,0,0,0
71,8480884,Calen Addison,D,,24,0,0,0,0
71,8476994,Vinnie Hinostroza,C,NSH,30,0,0,0,0
71,8478452,Caleb Jones,D,LAK,27,0,0,0,0
71,8480157,Calle Rosen,D,COL,30,0,0,0,0
71,8481609,Vladislav Kolyachonok,D,UTA,23,0,0,0,0
71,8479415,Michael McLeod,C,,26,0,0,0,0
71,8476919,Chris Tierney,C,,30,0,0,0,0
71,8479639,Dylan Coghlan,D,WPG,26,0,0,0,0
71,8478146,Matthew Highmore,C,OTT,28,0,0,0,0
71,8478970,Jalen Chatfield,D,CAR,28,0,0,0,0
71,8480205,Emil Bemstrom,C,PIT,25,0,0,0,0
71,8474884,Mike Hoffman,C,,35,0,0,0,0
71,8471274,Alex Goligoski,D,,39,0,0,0,0
71,8478104,Sammy Blais,L,,28,0,0,0,0
71,8474870,Tyler Johnson,C,,34,0,0,0,0
71,8476913,Devin Shore,C,MIN,30,0,0,0,0
71,8481598,Philip Broberg,D,EDM,23,0,0,0,0
71,8480058,Pierre-Olivier Joseph,D,STL,25,0,0,0,0
71,8480891,Michael Kesselring,D,UTA,24,0,0,0,0
71,8477979,Nicolas Aube-Kubel,R,BUF,28,0,0,0,0
71,8476871,Tanner Pearson,L,,32,0,0,0,0
71,8476393,Nick Cousins,C,,31,0,0,0,0
71,8479977,Kailer Yamamoto,R,,26,0,0,0,0
71,8479543,Michael Pezzetta,L,MTL,26,0,0,0,0
71,8477018,Ben Hutton,D,VGK,31,0,0,0,0
71,8480762,Eric Robinson,L,CAR,29,0,0,0,0
71,8474034,Pat Maroon,L,CHI,36,0,0,0,0
71,8481058,Jesse Ylönen,R,,25,0,0,0,0
71,8475179,Dmitry Kulikov,D,FLA,34,0,0,0,0
71,8481527,Kaedan Korczak,D,VGK,23,0,0,0,0
71,8473449,Kyle Okposo,R,,36,0,0,0,0
71,8482192,Isaak Phillips,D,CHI,23,0,0,0,0
71,8480727,Zach Whitecloud,D,VGK,28,0,0,0,0
71,8479346,Dillon Dube,C,,26,0,0,0,0
71,8480821,Filip Zadina,R,,25,0,0,0,0
71,8480001,Urho Vaakanainen,D,ANA,25,0,0,0,0
71,8470966,Mark Giordano,D,,41,0,0,0,0
71,8480853,Liam Foudy,C,,24,0,0,0,0
71,8475225,Craig Smith,C,CHI,35,0,0,0,0
71,8479972,Mason Shaw,C,WPG,26,0,0,0,0
71,8478451,Ethan Bear,D,WSH,27,0,0,0,0
71,8474040,Sam Gagner,C,,35,0,0,0,0
71,8480196,Jacob Bryson,D,BUF,27,0,0,0,0
71,8479984,Cal Foote,D,,26,0,0,0,0
71,8480011,Klim Kostin,C,SJS,25,0,0,0,0
71,8482176,Wyatt Kaiser,D,CHI,22,0,0,0,0
71,8476988,Matt Benning,D,SJS,30,0,0,0,0
71,8479370,Tyson Jost,C,CAR,26,0,0,0,0
71,8477464,Nic Petan,C,,29,0,0,0,0
71,8477380,Jonny Brodzinski,C,NYR,31,0,0,0,0
71,8480070,Ian Mitchell,D,BOS,25,0,0,0,0
71,8479315,Joey Anderson,R,CHI,26,0,0,0,0
71,8478099,Kevin Labanc,R,,29,0,0,0,0
71,8476874,Olli Maatta,D,DET,30,0,0,0,0
71,8475208,Brian Dumoulin,D,ANA,33,0,0,0,0
71,8478430,Oliver Kylington,D,,27,0,0,0,0
71,8479536,Axel Jonsson-Fjallby,L,WPG,26,0,0,0,0
71,8479671,Mathieu Olivier,R,CBJ,27,0,0,0,0
71,8471709,Marc-Edouard Vlasic,D,SJS,37,0,0,0,0
71,8479328,Julien Gauthier,R,NYI,27,0,0,0,0
71,8478421,A.J. Greer,L,FLA,28,0,0,0,0
71,8477573,Nathan Walker,L,STL,30,0,0,0,0
71,8481537,Nikita Okhotiuk,D,CGY,24,0,0,0,0
71,8474166,Alec Martinez,D,CHI,37,0,0,0,0
71,8470610,Zach Parise,L,,40,0,0,0,0
71,8477478,William Carrier,L,CAR,30,0,0,0,0
71,8479344,Jesse Puljujarvi,R,PIT,26,0,0,0,0
71,8480887,Jordan Harris,D,MTL,24,0,0,0,0
71,8478502,Dennis Gilbert,D,BUF,28,0,0,0,0
71,8482730,Brandt Clarke,D,LAK,21,0,0,0,0
71,8480355,Mark Kastelic,C,BOS,25,0,0,0,0
71,8475750,Jon Merrill,D,MIN,32,0,0,0,0
71,8475164,Jakob Silfverberg,R,,34,0,0,0,0
71,8477944,Jakub Vrana,L,,28,0,0,0,0
71,8479439,Jacob MacDonald,D,COL,31,0,0,0,0
71,8474568,Luke Schenn,D,NSH,35,0,0,0,0
71,8478454,Noah Juulsen,D,VAN,27,0,0,0,0
71,8475752,Tyler Pitlick,C,,33,0,0,0,0
71,8482148,Hendrix Lapierre,C,WSH,22,0,0,0,0
71,8481167,Brayden Pachal,D,CGY,25,0,0,0,0
71,8478043,Sam Lafferty,C,BUF,29,0,0,0,0
71,8479321,Lucas Johansen,D,,27,0,0,0,0
71,8471699,Andrew Cogliano,C,,37,0,0,0,0
71,8481521,Ronnie Attard,D,PHI,25,0,0,0,0
71,8481161,Jake Christiansen,D,CBJ,25,0,0,0,0
71,8479458,Nikita Zaitsev,D,,33,0,0,0,0
71,8479619,Michael Carcone,L,UTA,28,0,0,0,0
71,8479026,Philippe Myers,D,TOR,27,0,0,0,0
71,8477330,Dominik Kubalik,L,,29,0,0,0,0
71,8481617,Vasily Podkolzin,R,VAN,23,0,0,0,0
71,8481701,Santeri Hatakka,D,NJD,23,0,0,0,0
71,8479514,Rem Pitlick,C,,27,0,0,0,0
71,8477446,Michael McCarron,R,NSH,29,0,0,0,0
71,8470604,Jeff Carter,C,,39,0,0,0,0
71,8482241,Radim Zohorna,L,,28,0,0,0,0
71,8480289,Morgan Barron,C,WPG,26,0,0,0,0
71,8479379,Givani Smith,R,SJS,26,0,0,0,0
71,8480216,Jacob Peterson,C,,25,0,0,0,0
71,8477851,Jordan Oesterle,D,BOS,32,0,0,0,0
71,8484258,Sam Malinski,D,COL,26,0,0,0,0
71,8478904,Steven Lorentz,C,,28,0,0,0,0
71,8482095,Tyler Kleven,D,OTT,22,0,0,0,0
71,8480848,Ty Dellandrea,C,SJS,24,0,0,0,0
71,8476884,Derrick Pouliot,D,,30,0,0,0,0
71,8479336,Carl Grundstrom,R,SJS,27,0,0,0,0
71,8482964,Arber Xhekaj,D,MTL,23,0,0,0,0
71,8471686,Marc Staal,D,,37,0,0,0,0
71,8477887,Patrick Brown,C,BOS,32,0,0,0,0
71,8478495,Denis Gurianov,R,,27,0,0,0,0
71,8473504,Cal Clutterbuck,R,,37,0,0,0,0
71,8481550,Adam Beckman,L,NJD,23,0,0,0,0
71,8480845,Rasmus Kupari,C,WPG,24,0,0,0,0
71,8474009,Nick Bonino,C,,36,0,0,0,0
71,8478585,Derek Ryan,C,EDM,38,0,0,0,0
71,8477962,Brendan Lemieux,L,CAR,28,0,0,0,0
71,8482861,Vincent Iorio,D,WSH,22,0,0,0,0
71,8479378,Logan Stanley,D,WPG,26,0,0,0,0
71,8473446,Erik Johnson,D,PHI,36,0,0,0,0
71,8481743,Marc Del Gaizo,D,NSH,25,0,0,0,0
71,8477384,Josh Brown,D,EDM,30,0,0,0,0
71,8482165,Yan Kuznetsov,D,CGY,22,0,0,0,0
71,8478424,Jansen Harkins,C,ANA,27,0,0,0,0
71,8482144,Jack Thompson,D,SJS,22,0,0,0,0
71,8478512,Austin Czarnik,C,,32,0,0,0,0
71,8477527,Ross Johnston,L,ANA,30,0,0,0,0
71,8479383,Boris Katchouk,L,,26,0,0,0,0
71,8482094,Daemon Hunt,D,MIN,22,0,0,0,0
71,8481719,Maxwell Crozier,D,TBL,24,0,0,0,0
71,8480192,Johnathan Kovacevic,D,NJD,27,0,0,0,0
71,8479376,Victor Mete,D,,26,0,0,0,0
71,8482511,Mason Lohrei,D,BOS,23,0,0,0,0
71,8475825,Jani Hakanpää,D,,32,0,0,0,0
71,8478021,William Lagesson,D,DET,28,0,0,0,0
71,8475795,Dylan McIlrath,D,WSH,32,0,0,0,0
71,8477846,Ryan Carpenter,C,,33,0,0,0,0
71,8481056,Spencer Stastney,D,NSH,24,0,0,0,0
71,8481564,Ryan Johnson,D,BUF,23,0,0,0,0
71,8478017,Mark Friedman,D,VAN,29,0,0,0,0
71,8479320,Max Lajoie,D,SEA,27,0,0,0,0
71,8480075,Cameron Crotty,D,MIN,25,0,0,0,0
71,8484287,Cole McWard,D,VAN,23,0,0,0,0
71,8484254,Akito Hirose,D,VAN,25,0,0,0,0
71,8483407,Brandon Scanlin,D,NYR,25,0,0,0,0
71,8480274,Philip Kemp,D,EDM,25,0,0,0,0
71,8479522,Hardy Haman Aktell,D,WSH,26,0,0,0,0
71,8480007,Jonas Rondbjerg,R,VGK,25,0,0,0,0
71,8477454,Adam Erne,L,,29,0,0,0,0
71,8481679,Maxence Guenette,D,OTT,23,0,0,0,0
71,8480441,Trey Fix-Wolansky,R,CBJ,25,0,0,0,0
71,8483546,Marshall Rifai,D,TOR,26,0,0,0,0
71,8480084,Nick DeSimone,D,NJD,30,0,0,0,0
71,8481030,Jack St. Ivany,D,PIT,25,0,0,0,0
71,8481592,Jakob Pelletier,L,CGY,23,0,0,0,0
71,8478011,Louie Belpedio,D,PHI,28,0,0,0,0
71,8477930,Pierre-Edouard Bellemare,L,,39,0,0,0,0
71,8484321,Nikolas Matinpalo,D,OTT,26,0,0,0,0
71,8482067,Connor Mackey,D,NYR,28,0,0,0,0
71,8481806,Louis Crevier,D,CHI,23,0,0,0,0
71,8484326,Patrik Koch,D,UTA,28,0,0,0,0
71,8477971,Andreas Englund,D,LAK,28,0,0,0,0
71,8481751,Lukas Rousek,R,BUF,25,0,0,0,0
71,8481006,Tyler Tucker,D,STL,24,0,0,0,0
71,8476867,Brendan Gaunce,C,MIN,30,0,0,0,0
71,8479520,Brandon Duhaime,R,WSH,27,0,0,0,0
71,8477073,Kurtis MacDermid,L,NJD,30,0,0,0,0
71,8480874,Adam Ginning,D,PHI,24,0,0,0,0
71,8477473,Justin Bailey,R,SJS,29,0,0,0,0
71,8479066,Ryan Lomberg,L,CGY,30,0,0,0,0
71,8477070,Liam O'Brien,C,UTA,30,0,0,0,0
71,8474618,Marco Scandella,D,,34,0,0,0,0
71,8475797,Jarred Tinordi,D,,32,0,0,0,0
71,8481441,Joe Snively,C,DET,28,0,0,0,0
71,8477244,Chad Ruhwedel,D,NYR,34,0,0,0,0
71,8479772,Zack MacEwen,R,OTT,28,0,0,0,0
71,8481147,Reese Johnson,C,MIN,26,0,0,0,0
71,8481043,Cole Koepke,L,BOS,26,0,0,0,0
71,8483619,Filip Roos,D,OTT,25,0,0,0,0
71,8481541,Samuel Bolduc,D,NYI,24,0,0,0,0
71,8477810,Joel Hanley,D,CGY,33,0,0,0,0
71,8476907,Mackenzie MacEachern,L,,30,0,0,0,0
71,8482652,Walker Duehr,R,CGY,27,0,0,0,0
71,8477126,Jayson Megna,C,,34,0,0,0,0
71,8483398,Declan Carlile,D,TBL,31,0,0,0,0
71,8482929,Emil Lilleberg,D,TBL,23,0,0,0,0
71,8480880,Jakub Lauko,C,MIN,24,0,0,0,0
71,8480245,Olle Lycksell,R,PHI,25,0,0,0,0
71,8480252,Cole Guttman,C,CHI,25,0,0,0,0
71,8477467,Gustav Olofsson,D,SEA,30,0,0,0,0
71,8479968,Vinni Lettieri,C,BOS,29,0,0,0,0
71,8478400,Colin White,C,,27,0,0,0,0
71,8475755,Alexander Petrovic,D,DAL,32,0,0,0,0
71,8481812,Nikolai Knyzhov,D,,27,0,0,0,0
71,8481593,Jayden Struble,D,MTL,23,0,0,0,0
71,8481532,Alex Turcotte,C,LAK,23,0,0,0,0
71,8482126,Emil Andrae,D,PHI,31,0,0,0,0
71,8479944,Zach Aston-Reese,C,VGK,30,0,0,0,0
71,8471817,Ryan Reaves,R,TOR,37,0,0,0,0
71,8481206,John Ludvig,D,PIT,24,0,0,0,0
71,8481599,Victor Soderstrom,D,UTA,23,0,0,0,0
71,8480292,Carson Meyer,R,ANA,27,0,0,0,0
71,8482496,Nils Aman,C,VAN,24,0,0,0,0
71,8479718,Alex Barré-Boulet,C,MTL,27,0,0,0,0
71,8479994,Jaret Anderson-Dolan,C,WPG,25,0,0,0,0
71,8480184,Gustav Lindstrom,D,,26,0,0,0,0
71,8480890,Jan Jenik,R,OTT,24,0,0,0,0
71,8478067,Oskar Lindblom,L,,28,0,0,0,0
71,8476934,Brock McGinn,L,ANA,30,0,0,0,0
71,8479985,Cale Fleury,D,SEA,26,0,0,0,0
71,8484304,Uvis Balinskis,D,FLA,28,0,0,0,0
71,8479981,Jonah Gadjovich,L,FLA,26,0,0,0,0
71,8481716,Dmitri Voronkov,L,CBJ,24,0,0,0,0
71,8474709,Matt Martin,L,,35,0,0,0,0
71,8482634,Alex Steeves,C,TOR,25,0,0,0,0
71,8480823,Alexander Alexeyev,D,WSH,25,0,0,0,0
71,8477541,Dakota Mermis,D,TOR,30,0,0,0,0
71,8483491,Ivan Miroshnichenko,L,WSH,20,0,0,0,0
71,8478477,Mitchell Stephens,C,SEA,27,0,0,0,0
71,8481543,Nikita Alexandrov,C,STL,24,0,0,0,0
71,8479423,Alex Nylander,L,,26,0,0,0,0
71,8482451,Mikael Pyyhtia,L,CBJ,23,0,0,0,0
71,8478831,Kevin Stenlund,C,UTA,28,0,0,0,0
71,8480306,Grant Hutton,D,NYI,29,0,0,0,0
71,8478028,Fredrik Olofsson,L,,28,0,0,0,0
71,8477462,Robert Hagg,D,VGK,29,0,0,0,0
71,8477320,Anton Blidh,L,NYR,29,0,0,0,0
71,8482157,Will Cuylle,L,NYR,22,0,0,0,0
71,8482737,Zack Bolduc,C,STL,21,0,0,0,0
71,8481239,Samuel Fagemo,L,,24,0,0,0,0
71,8481600,Tobias Bjornfot,D,FLA,23,0,0,0,0
71,8478409,Anthony Richard,C,PHI,28,0,0,0,0
71,8474145,Robert Bortuzzo,D,,35,0,0,0,0
71,8475958,Michael Sgarbossa,C,WSH,32,0,0,0,0
71,8479986,Kole Lind,R,DAL,26,0,0,0,0
71,8479249,Andrew Poturalski,C,SJS,30,0,0,0,0
71,8479362,Riley Tufte,L,BOS,26,0,0,0,0
71,8479991,Jake Leschyshyn,C,NYR,25,0,0,0,0
71,8479587,Rhett Gardner,C,PHI,28,0,0,0,0
71,8482744,James Malatesta,L,CBJ,21,0,0,0,0
71,8478854,Ryan Shea,D,PIT,27,0,0,0,0
71,8481591,Sam Poulin,R,,23,0,0,0,0
71,8483512,Matt Savoie,C,EDM,20,0,0,0,0
71,8482102,Vasily Ponomarev,C,PIT,22,0,0,0,0
71,8482162,Roby Jarventie,L,EDM,22,0,0,0,0
71,8481016,Ruslan Iskhakov,C,,24,0,0,0,0
71,8482172,Landon Slaggert,L,CHI,22,0,0,0,0
71,8482747,Brennan Othmann,L,NYR,21,0,0,0,0
71,8480031,Maxime Comtois,L,,25,0,0,0,0
71,8480226,Marián Studenic,R,,26,0,0,0,0
71,8478408,Travis Dermott,D,,28,0,0,0,0
71,8481518,Nolan Foote,L,NJD,24,0,0,0,0
71,8479419,Brett Murray,L,BUF,26,0,0,0,0
71,8482088,Justin Sourdif,R,FLA,22,0,0,0,0
71,8482201,Gage Goncalves,C,TBL,23,0,0,0,0
71,8481578,Graeme Clarke,R,MIN,23,0,0,0,0
71,8482177,Marat Khusnutdinov,C,MIN,22,0,0,0,0
71,8481754,Nikita Nesterenko,C,ANA,23,0,0,0,0
71,8483531,Brian Halonen,L,NJD,25,0,0,0,0
71,8483920,Pierrick Dube,R,WSH,23,0,0,0,0
71,8480851,Akil Thomas,C,LAK,24,0,0,0,0
71,8475235,Nicolas Deslauriers,L,PHI,33,0,0,0,0
71,8482476,Emil Heineman,L,MTL,23,0,0,0,0
71,8477149,Scott Sabourin,R,SJS,32,0,0,0,0
71,8483549,Lucas Condotta,L,MTL,27,0,0,0,0
71,8482765,Isak Rosen,R,BUF,21,0,0,0,0
71,8481237,Kyle MacLean,C,NYI,25,0,0,0,0
71,8481024,Linus Karlsson,C,VAN,25,0,0,0,0
71,8481690,Tyler Angle,C,,24,0,0,0,0
71,8483570,Ben Meyers,C,SEA,26,0,0,0,0
71,8481655,Cole Schwindt,R,CGY,23,0,0,0,0
71,8481462,Mason Morelli,L,VGK,28,0,0,0,0
71,8483401,Marc Johnstone,R,PIT,28,0,0,0,0
71,8478956,Samuel Laberge,L,NJD,27,0,0,0,0
71,8479533,Joona Koppanen,L,,26,0,0,0,0
71,8482197,Adam Raska,R,MIN,23,0,0,0,0
71,8482250,Callahan Burke,C,VGK,27,0,0,0,0
71,8482784,Zach Dean,C,STL,21,0,0,0,0
71,8484255,Jason Polin,R,COL,25,0,0,0,0
71,8481077,John Leonard,L,,26,0,0,0,0
71,8481534,Raphael Lavoie,C,EDM,24,0,0,0,0
71,8483609,Adam Klapka,R,CGY,24,0,0,0,0
71,8482751,Ryan Winterton,C,SEA,21,0,0,0,0
71,8480267,Sammy Walker,C,MIN,25,0,0,0,0
71,8475766,Austin Watson,L,,32,0,0,0,0
71,8482460,Matt Rempe,C,NYR,22,0,0,0,0
71,8481065,Angus Crookshank,L,OTT,25,0,0,0,0
71,8481070,Hugh McGing,L,,26,0,0,0,0
71,8476323,Max McCormick,L,SEA,32,0,0,0,0
71,8483395,Arshdeep Bains,L,VAN,23,0,0,0,0
71,8484259,Ondrej Pavel,C,COL,31,0,0,0,0
71,8483432,Luca Del Bel Belluz,C,CBJ,31,0,0,0,0
71,8483045,Cameron Butler,R,CBJ,31,0,0,0,0
71,8482061,Brandon Biro,L,SEA,26,0,0,0,0
71,8477401,John Hayden,C,SEA,29,0,0,0,0
71,8475278,Byron Froese,C,,33,0,0,0,0
71,8478446,Glenn Gawdin,C,LAK,27,0,0,0,0
71,8477993,Justin Kirkland,C,CGY,28,0,0,0,0
71,8482147,Jean-Luc Foudy,C,COL,22,0,0,0,0
71,8480032,Shane Bowers,C,NJD,25,0,0,0,0
71,8479330,Brandon Gignac,C,MTL,27,0,0,0,0
71,8480776,Sheldon Rempal,R,,29,0,0,0,0
71,8475413,Justin Dowling,C,NJD,34,0,0,0,0
71,8481726,Adam Edstrom,C,NYR,24,0,0,0,0
71,8480844,Grigori Denisenko,L,VGK,24,0,0,0,0
71,8478147,Bokondji Imama,L,PIT,28,0,0,0,0
71,8478881,Brett Seney,L,CHI,28,0,0,0,0
71,8483630,Pavol Regenda,L,ANA,25,0,0,0,0
71,8480836,Jonathan Gruden,C,,24,0,0,0,0
71,8484314,Jiri Smejkal,L,,28,0,0,0,0
71,8475780,Chris Wagner,R,COL,33,0,0,0,0
71,8479546,Oskar Steen,C,,26,0,0,0,0
71,8483597,Milos Kelemen,L,UTA,25,0,0,0,0
71,8481789,Tye Kartye,L,SEA,23,0,0,0,0
71,8484325,Waltteri Merela,C,TBL,26,0,0,0,0
71,8479421,Jacob Moverare,D,LAK,26,0,0,0,0
71,8481585,Egor Afanasyev,L,SJS,23,0,0,0,0
71,8479547,Matthew Phillips,R,,26,0,0,0,0
71,8479367,William Lockwood,R,FLA,26,0,0,0,0
71,8476915,Jujhar Khaira,L,,30,0,0,0,0
71,8481422,Jacob Lucchini,C,NSH,29,0,0,0,0
71,8480468,James Hamblin,L,EDM,25,0,0,0,0
71,8478051,Max Willman,C,NJD,29,0,0,0,0
71,8481556,John Beecher,C,BOS,23,0,0,0,0
71,8478078,Rourke Chartier,C,,28,0,0,0,0
72,8478402,Connor McDavid,C,EDM,27,82,52,110,162
72,8476453,Nikita Kucherov,R,TBL,31,82,49,104,153
72,8477492,Nathan MacKinnon,C,COL,29,82,43,84,127
72,8481559,Jack Hughes,C,NJD,23,82,45,77,122
72,8478864,Kirill Kaprizov,L,MIN,27,82,48,72,120
72,8471675,Sidney Crosby,C,PIT,37,82,50,67,117
72,8477956,David Pastrnak,R,BOS,28,82,49,68,117
72,8477939,William Nylander,R,TOR,28,82,41,74,115
72,8477934,Leon Draisaitl,C,EDM,29,82,46,65,111
72,8478449,Roope Hintz,C,DAL,28,82,52,58,110
72,8478420,Mikko Rantanen,R,COL,28,82,52,56,108
72,8479420,Tage Thompson,C,BUF,27,82,53,54,107
72,8479318,Auston Matthews,C,TOR,27,82,62,43,105
72,8478550,Artemi Panarin,L,NYR,33,82,32,73,105
72,8476468,J.T. Miller,C,VAN,31,82,35,67,102
72,8480801,Brady Tkachuk,L,OTT,25,82,52,48,100
72,8480069,Cale Makar,D,COL,26,82,36,63,99
72,8480002,Nico Hischier,C,NJD,25,82,35,62,97
72,8480027,Jason Robertson,L,DAL,25,82,37,58,95
72,8475172,Nazem Kadri,C,CGY,34,82,34,60,94
72,8480012,Elias Pettersson,C,VAN,26,82,38,55,93
72,8477493,Aleksander Barkov,C,FLA,29,82,28,65,93
72,8476887,Filip Forsberg,L,NSH,30,82,45,46,91
72,8476389,Vincent Trocheck,C,NYR,31,82,37,54,91
72,8480036,Miro Heiskanen,D,DAL,25,82,20,71,91
72,8479343,Clayton Keller,R,UTA,26,82,41,49,90
72,8477946,Dylan Larkin,C,DET,28,82,40,49,89
72,8479407,Jesper Bratt,L,NJD,26,82,22,67,89
72,8473419,Brad Marchand,L,BOS,36,82,37,51,88
72,8479314,Matthew Tkachuk,L,FLA,27,82,25,63,88
72,8480023,Robert Thomas,C,STL,25,82,29,58,87
72,8478047,Michael Bunting,L,PIT,29,82,31,55,86
72,8477404,Jake Guentzel,C,TBL,30,82,35,50,85
72,8476346,Johnny Gaudreau,L,CBJ,31,82,20,65,85
72,8478398,Kyle Connor,L,WPG,28,82,42,42,84
72,8480830,Andrei Svechnikov,R,CAR,24,82,31,53,84
72,8474600,Roman Josi,D,NSH,34,82,26,58,84
72,8478445,Mathew Barzal,C,NYI,27,82,24,60,84
72,8481557,Matt Boldy,L,MIN,23,82,31,52,83
72,8475158,Ryan O'Reilly,C,NSH,33,82,31,52,83
72,8478010,Brayden Point,C,TBL,28,82,46,36,82
72,8479385,Jordan Kyrou,C,STL,26,82,36,46,82
72,8476459,Mika Zibanejad,C,NYR,31,82,27,55,82
72,8475692,Mats Zuccarello,R,MIN,37,82,23,59,82
72,8480839,Rasmus Dahlin,D,BUF,24,82,20,62,82
72,8479323,Adam Fox,D,NYR,26,82,19,63,82
72,8475184,Chris Kreider,L,NYR,33,82,45,35,80
72,8477501,Valeri Nichushkin,R,COL,29,82,42,38,80
72,8482116,Tim Stützle,C,OTT,22,82,25,55,80
72,8481523,Kirby Dach,C,MTL,23,82,18,62,80
72,8479337,Alex DeBrincat,R,DET,27,82,39,40,79
72,8471215,Evgeni Malkin,C,PIT,38,82,30,49,79
72,8478439,Travis Konecny,R,PHI,27,82,34,44,78
72,8479542,Brandon Hagel,L,TBL,26,82,25,53,78
72,8477933,Sam Reinhart,C,FLA,29,82,41,36,77
72,8475810,Bryan Rust,R,PIT,32,82,34,43,77
72,8477942,Kevin Fiala,L,LAK,28,82,33,44,77
72,8478414,Timo Meier,R,NJD,28,82,34,42,76
72,8477504,Josh Morrissey,D,WPG,29,82,15,61,76
72,8476539,Jonathan Marchessault,R,NSH,34,82,34,41,75
72,8478403,Jack Eichel,C,VGK,28,82,28,47,75
72,8476853,Morgan Rielly,D,TOR,30,82,12,62,74
72,8475166,John Tavares,C,TOR,34,82,31,42,73
72,8480208,Drake Batherson,R,OTT,26,82,27,46,73
72,8474564,Steven Stamkos,C,NSH,34,82,25,48,73
72,8477940,Nikolaj Ehlers,L,WPG,28,82,25,48,73
72,8475167,Victor Hedman,D,TBL,34,82,19,54,73
72,8477500,Bo Horvat,C,NYI,29,82,33,39,72
72,8477409,Carter Verhaeghe,C,FLA,29,82,31,41,72
72,8475168,Matt Duchene,C,DAL,33,82,29,43,72
72,8477951,Nick Schmaltz,C,UTA,28,82,23,49,72
72,8482097,Jack Quinn,R,BUF,23,82,15,57,72
72,8480865,Noah Dobson,D,NYI,24,82,8,64,72
72,8477960,Adrian Kempe,R,LAK,28,82,35,36,71
72,8478493,Joel Eriksson Ek,C,MIN,27,82,32,39,71
72,8475913,Mark Stone,R,VGK,32,82,29,42,71
72,8482665,Matty Beniers,C,SEA,22,82,32,38,70
72,8481540,Cole Caufield,R,MTL,23,82,42,27,69
72,8475754,Brock Nelson,C,NYI,33,82,34,35,69
72,8476460,Mark Scheifele,C,WPG,31,82,32,37,69
72,8478975,Mason Marchment,L,DAL,29,82,32,37,69
72,8478427,Sebastian Aho,C,CAR,27,82,30,39,69
72,8477402,Pavel Buchnevich,L,STL,29,82,24,45,69
72,8475786,Zach Hyman,L,EDM,32,82,32,36,68
72,8481596,Shane Pinto,C,OTT,24,82,26,42,68
72,8482740,Wyatt Johnston,C,DAL,21,82,35,32,67
72,8478440,Dylan Strome,C,WSH,27,82,24,43,67
72,8476454,Ryan Nugent-Hopkins,C,EDM,31,82,21,46,67
72,8473512,Claude Giroux,R,OTT,36,82,21,46,67
72,8476399,Blake Coleman,C,CGY,33,82,29,37,66
72,8479400,Pierre-Luc Dubois,L,WSH,26,82,29,37,66
72,8480039,Martin Necas,C,CAR,25,82,25,41,66
72,8482110,Dawson Mercer,C,NJD,23,82,37,28,65
72,8471214,Alex Ovechkin,L,WSH,39,82,31,34,65
72,8482078,Lucas Raymond,L,DET,22,82,29,36,65
72,8474141,Patrick Kane,R,DET,36,82,24,41,65
72,8475765,Vladimir Tarasenko,R,DET,33,82,18,47,65
72,8474578,Erik Karlsson,D,PIT,34,82,14,51,65
72,8476483,Rickard Rakell,R,PIT,31,82,30,34,64
72,8477447,Shea Theodore,D,VGK,29,82,10,54,64
72,8481528,Dylan Cozens,C,BUF,23,82,31,32,63
72,8478042,Viktor Arvidsson,R,EDM,31,82,27,36,63
72,8474563,Drew Doughty,D,LAK,35,82,16,47,63
72,8480803,Evan Bouchard,D,EDM,25,82,11,52,63
72,8479425,Filip Hronek,D,VAN,27,82,11,52,63
72,8480800,Quinn Hughes,D,VAN,25,82,9,54,63
72,8475794,Tyler Seguin,C,DAL,32,82,32,30,62
72,8477476,Artturi Lehkonen,L,COL,29,82,28,34,62
72,8477949,Alex Tuch,R,BUF,28,82,21,41,62
72,8474590,John Carlson,D,WSH,34,82,12,50,62
72,8481068,Yegor Sharangovich,C,CGY,26,82,31,30,61
72,8477496,Elias Lindholm,C,BOS,30,82,26,35,61
72,8475784,Jeff Skinner,C,EDM,32,82,26,35,61
72,8475726,Tyler Toffoli,C,SJS,32,82,26,35,61
72,8480018,Nick Suzuki,C,MTL,25,82,23,38,61
72,8482159,Tyson Foerster,R,PHI,22,82,31,29,60
72,8479675,Trevor Moore,L,LAK,29,82,29,31,60
72,8476882,Teuvo Teravainen,L,CHI,30,82,25,35,60
72,8471724,Kris Letang,D,PIT,37,82,17,43,60
72,8478460,Zach Werenski,D,CBJ,27,82,15,45,60
72,8479325,Charlie McAvoy,D,BOS,27,82,15,45,60
72,8476456,Jonathan Huberdeau,C,CGY,31,82,15,45,60
72,8481546,Cam York,D,PHI,23,82,13,47,60
72,8481542,Moritz Seider,D,DET,23,82,11,49,60
72,8481533,Trevor Zegras,C,ANA,23,82,22,37,59
72,8476905,Chandler Stephenson,C,SEA,30,82,16,43,59
72,8478401,Pavel Zacha,C,BOS,27,82,15,44,59
72,8477986,Brandon Montour,D,SEA,30,82,13,46,59
72,8478444,Brock Boeser,R,VAN,27,82,26,32,58
72,8473994,Jamie Benn,L,DAL,35,82,22,36,58
72,8480078,Filip Chytil,C,NYR,25,82,25,32,57
72,8476448,William Karlsson,C,VGK,31,82,18,39,57
72,8476792,Torey Krug,D,STL,33,82,13,44,57
72,8474586,Jordan Eberle,R,SEA,34,82,27,29,56
72,8477497,Sean Monahan,C,CBJ,30,82,24,32,56
72,8478856,Conor Garland,R,VAN,28,82,22,34,56
72,8481711,Matias Maccelli,L,UTA,24,82,19,37,56
72,8478407,Vince Dunn,D,SEA,28,82,9,47,56
72,8471698,T.J. Oshie,R,WSH,38,82,29,26,55
72,8482093,Seth Jarvis,C,CAR,22,82,27,28,55
72,8480015,Owen Tippett,R,PHI,25,82,23,32,55
72,8478115,Pierre Engvall,L,NYI,28,82,23,32,55
72,8480798,Philipp Kurashev,C,CHI,25,82,19,36,55
72,8474150,Mikael Backlund,C,CGY,35,82,18,37,55
72,8478873,Troy Terry,R,ANA,27,82,16,39,55
72,8482113,Anton Lundell,C,FLA,23,82,16,39,55
72,8477346,MacKenzie Weegar,D,CGY,30,82,8,47,55
72,8479365,Trent Frederic,C,BOS,26,82,24,30,54
72,8477407,Anthony Duclair,L,NYI,29,82,23,31,54
72,8478462,Nicolas Roy,C,VGK,27,82,20,34,54
72,8477451,Ryan Hartman,R,MIN,30,82,18,36,54
72,8481581,Thomas Harley,D,DAL,23,82,16,38,54
72,8474149,Evgenii Dadonov,R,DAL,35,82,13,41,54
72,8481604,Pavel Dorofeyev,L,VGK,24,82,36,17,53
72,8479339,Patrik Laine,L,CBJ,26,82,24,29,53
72,8477955,Jared McCann,L,SEA,28,82,23,30,53
72,8475191,Reilly Smith,R,NYR,33,82,21,32,53
72,8477429,Andrew Copp,C,DET,30,82,16,37,53
72,8478458,Jack Roslovic,C,CAR,27,82,16,37,53
72,8476419,Jean-Gabriel Pageau,C,NYI,32,82,16,37,53
72,8482684,Luke Hughes,D,NJD,21,82,14,39,53
72,8475798,Mikael Granlund,C,SJS,32,82,14,39,53
72,8480064,Josh Norris,C,OTT,25,82,30,22,52
72,8482109,Alexis Lafrenière,L,NYR,23,82,26,26,52
72,8479345,Jakob Chychrun,D,WSH,26,82,23,29,52
72,8480028,Morgan Frost,C,PHI,25,82,23,29,52
72,8477456,J.T. Compher,L,DET,29,82,21,31,52
72,8479987,Morgan Geekie,C,BOS,26,82,26,25,51
72,8477935,Sam Bennett,C,FLA,28,82,25,26,51
72,8475151,Kyle Palmieri,C,NYI,33,82,23,28,51
72,8478366,Frank Vatrano,R,ANA,30,82,22,29,51
72,8474641,Adam Henrique,C,EDM,34,82,22,29,51
72,8475768,Jaden Schwartz,C,SEA,32,82,21,30,51
72,8475170,Brayden Schenn,C,STL,33,82,21,30,51
72,8476479,Phillip Danault,C,LAK,31,82,20,31,51
72,8475763,Kevin Hayes,R,PIT,32,82,18,33,51
72,8475287,Erik Haula,L,NJD,33,82,17,34,51
72,8477444,Andre Burakovsky,L,SEA,29,82,16,35,51
72,8482745,Mason McTavish,C,ANA,21,82,28,22,50
72,8484144,Connor Bedard,C,CHI,19,82,25,25,50
72,8474053,Logan Couture,C,SJS,35,82,18,32,50
72,8478396,Noah Hanifin,D,VGK,27,82,15,35,50
72,8476872,Scott Laughton,C,PHI,30,82,15,35,50
72,8478055,Gustav Forsling,D,FLA,28,82,11,39,50
72,8476875,Mike Matheson,D,MTL,30,82,10,40,50
72,8478498,Jake DeBrusk,L,VAN,28,82,27,22,49
72,8475799,Nino Niederreiter,R,WPG,32,82,24,25,49
72,8475745,Charlie Coyle,C,BOS,32,82,20,29,49
72,8482124,Quinton Byfield,R,LAK,22,82,13,36,49
72,8477503,Max Domi,C,TOR,29,82,12,37,49
72,8479410,Mikhail Sergachev,D,UTA,26,82,10,39,49
72,8475314,Anders Lee,L,NYI,34,82,29,19,48
72,8480113,Alex Iafallo,L,WPG,31,82,28,20,48
72,8477511,Anthony Mantha,R,CGY,30,82,24,24,48
72,8482055,Drew O'Connor,L,PIT,26,82,24,24,48
72,8480797,Joel Farabee,L,PHI,24,82,17,31,48
72,8482149,Cole Perfetti,C,WPG,22,82,15,33,48
72,8477495,Seth Jones,D,CHI,30,82,13,35,48
72,8478038,Devon Toews,D,COL,30,82,10,38,48
72,8476869,Brady Skjei,D,NSH,30,82,10,38,48
72,8478233,Andrew Mangiapane,L,WSH,28,82,24,23,47
72,8476432,Boone Jenner,C,CBJ,31,82,23,24,47
72,8479992,Michael Rasmussen,C,DET,25,82,23,24,47
72,8482146,Luke Evangelista,R,NSH,22,82,22,25,47
72,8477416,Oliver Bjorkstrand,R,SEA,29,82,21,26,47
72,8477479,Tyler Bertuzzi,L,CHI,29,82,18,29,47
72,8482667,William Eklund,L,SJS,22,82,17,30,47
72,8476458,Ryan Strome,C,ANA,31,82,16,31,47
72,8482671,Owen Power,D,BUF,22,82,13,34,47
72,8477932,Aaron Ekblad,D,FLA,28,82,11,36,47
72,8477494,Jonathan Drouin,L,COL,29,82,11,36,47
72,8471685,Anze Kopitar,C,LAK,37,82,9,38,47
72,8480014,Gabriel Vilardi,C,WPG,25,82,26,20,46
72,8479525,Ross Colton,C,COL,28,82,22,24,46
72,8478474,Lawson Crouse,L,UTA,27,82,19,27,46
72,8480748,Kiefer Sherwood,L,VAN,29,82,18,28,46
72,8474565,Alex Pietrangelo,D,VGK,34,82,12,34,46
72,8478397,Rasmus Andersson,D,CGY,28,82,11,35,46
72,8478469,Thomas Chabot,D,OTT,27,82,11,35,46
72,8477426,Nicholas Paul,L,TBL,29,82,23,22,45
72,8482720,Matthew Knies,L,TOR,22,82,22,23,45
72,8475722,Jason Zucker,L,BUF,32,82,21,24,45
72,8476826,Yanni Gourde,C,SEA,33,82,20,25,45
72,8476880,Tom Wilson,R,WSH,30,82,20,25,45
72,8473422,Nick Foligno,L,CHI,37,82,18,27,45
72,8476960,Andreas Athanasiou,C,CHI,30,82,18,27,45
72,8475753,Justin Faulk,D,STL,32,82,10,35,45
72,8482175,JJ Peterka,R,BUF,22,82,23,21,44
72,8480849,Barrett Hayton,C,UTA,24,82,22,22,44
72,8481560,Arthur Kaliyev,R,LAK,23,82,22,22,44
72,8477021,Alex Kerfoot,C,UTA,30,82,21,23,44
72,8480829,Jesperi Kotkaniemi,C,CAR,24,82,21,23,44
72,8482705,Cole Sillinger,C,CBJ,21,82,19,25,44
72,8476881,Tomas Hertl,C,VGK,31,82,17,27,44
72,8482092,Ridly Greig,C,OTT,22,82,17,27,44
72,8482475,Yegor Chinakhov,R,CBJ,23,82,16,28,44
72,8474102,David Perron,L,OTT,36,82,13,31,44
72,8476329,Travis Boyd,C,MIN,31,82,12,32,44
72,8476462,Dougie Hamilton,D,NJD,31,82,11,33,44
72,8479999,Casey Mittelstadt,C,COL,26,82,10,34,44
72,8475169,Evander Kane,L,EDM,33,82,23,20,43
72,8480188,Fabian Zetterlund,L,SJS,25,82,20,23,43
72,8477964,Ivan Barbashev,C,VGK,29,82,15,28,43
72,8478438,Tommy Novak,C,NSH,27,82,14,29,43
72,8481618,Alex Newhook,C,MTL,23,82,14,29,43
72,8476906,Shayne Gostisbehere,D,CAR,31,82,11,32,43
72,8481554,Kaapo Kakko,R,NYR,23,82,27,15,42
72,8479996,Cody Glass,C,NSH,25,82,24,18,42
72,8473986,Alex Killorn,L,ANA,35,82,23,19,42
72,8475793,Ryan Johansen,C,PHI,32,82,21,21,42
72,8480893,Kirill Marchenko,R,CBJ,24,82,24,17,41
72,8480813,Joe Veleno,C,DET,24,82,20,21,41
72,8481624,Ilya Mikheyev,R,CHI,30,82,18,23,41
72,8477998,Warren Foegele,L,LAK,28,82,18,23,41
72,8477987,Ryan Donato,C,CHI,28,82,18,23,41
72,8477947,Sonny Milano,L,WSH,28,82,17,24,41
72,8480220,Noah Cates,L,PHI,25,82,16,25,41
72,8478472,Mathieu Joseph,R,STL,27,82,11,30,41
72,8482111,Justin Barron,D,MTL,23,82,11,30,41
72,8478851,Alexandre Carrier,D,NSH,28,82,7,34,41
72,8475760,Nick Bjugstad,C,UTA,32,82,27,13,40
72,8482699,Dylan Guenther,R,UTA,21,82,20,20,40
72,8474715,Cam Atkinson,R,TBL,35,82,20,20,40
72,8483515,Juraj Slafkovsky,L,MTL,20,82,19,21,40
72,8476927,Teddy Blueger,C,VAN,30,82,18,22,40
72,8480185,Eetu Luostarinen,C,FLA,26,82,16,24,40
72,8478519,Anthony Cirelli,C,TBL,27,82,15,25,40
72,8475764,Cam Fowler,D,ANA,33,82,5,35,40
72,8481580,Connor McMichael,C,WSH,23,82,22,17,39
72,8475791,Taylor Hall,L,CHI,33,82,17,22,39
72,8476278,Colin Blackwell,C,DAL,31,82,17,22,39
72,8478133,Jake Evans,C,MTL,28,82,15,24,39
72,8476873,Mark Jankowski,C,NSH,30,82,14,25,39
72,8480802,Ryan McLeod,C,BUF,25,82,14,25,39
72,8474679,Gustav Nyquist,C,NSH,35,82,11,28,39
72,8470613,Brent Burns,D,CAR,39,82,10,29,39
72,8476931,Jake McCabe,D,TOR,31,82,8,31,39
72,8478046,Danton Heinen,L,VAN,29,82,22,16,38
72,8481535,Nils Hoglander,L,VAN,24,82,22,16,38
72,8478463,Anthony Beauvillier,L,PIT,27,82,18,20,38
72,8473533,Jordan Staal,C,CAR,36,82,14,24,38
72,8476392,Adam Lowry,C,WPG,31,82,11,27,38
72,8480009,Eeli Tolvanen,R,SEA,25,82,10,28,38
72,8480817,K'Andre Miller,D,NYR,24,82,5,33,38
72,8478911,Matt Roy,D,WSH,29,82,4,34,38
72,8476438,Brandon Saad,L,STL,32,82,24,13,37
72,8476474,Stefan Noesen,R,NJD,31,82,20,17,37
72,8475218,Mattias Ekholm,D,EDM,34,82,13,24,37
72,8480434,Sean Durzi,D,UTA,26,82,11,26,37
72,8477506,Ryan Pulock,D,NYI,30,82,10,27,37
72,8482142,Jamie Drysdale,D,PHI,22,82,7,30,37
72,8478508,Yakov Trenin,C,MIN,27,82,23,13,36
72,8478057,Dakota Joshua,C,VAN,28,82,19,17,36
72,8478413,Jordan Greenway,L,BUF,27,82,18,18,36
72,8477392,Hudson Fasching,R,NYI,29,82,17,19,36
72,8476461,Sean Couturier,C,PHI,32,82,15,21,36
72,8482660,Kent Johnson,C,CBJ,22,82,15,21,36
72,8478891,Mason Appleton,C,WPG,28,82,12,24,36
72,8476885,Jacob Trouba,D,NYR,30,82,9,27,36
72,8481582,Nicholas Robertson,L,TOR,23,82,17,18,35
72,8476925,Colton Sissons,C,NSH,31,82,16,19,35
72,8477948,Travis Sanheim,D,PHI,28,82,11,24,35
72,8476480,Vladislav Namestnikov,C,WPG,32,82,11,24,35
72,8481656,Aliaksei Protas,C,WSH,23,82,10,25,35
72,8477498,Darnell Nurse,D,EDM,29,82,5,30,35
72,8484166,Adam Fantilli,C,CBJ,20,82,23,11,34
72,8479390,Taylor Raddysh,R,WSH,26,82,18,16,34
72,8480068,Ryan Poehling,C,PHI,25,82,14,20,34
72,8475220,Marcus Foligno,L,MIN,33,82,14,20,34
72,8476897,Oskar Sundqvist,C,STL,30,82,13,21,34
72,8478542,Evan Rodrigues,C,FLA,31,82,11,23,34
72,8479402,Jake Bean,D,CGY,26,82,7,27,34
72,8476918,Jimmy Vesey,L,NYR,31,82,19,14,33
72,8480789,Oliver Wahlstrom,R,NYI,24,82,18,15,33
72,8483431,Logan Cooley,C,UTA,20,82,17,16,33
72,8479359,Beck Malenstyn,L,BUF,26,82,16,17,33
72,8475149,Marcus Johansson,L,MIN,34,82,15,18,33
72,8476292,Ondrej Palat,L,NJD,33,82,15,18,33
72,8479941,Justin Danforth,R,CBJ,31,82,15,18,33
72,8477839,Conor Sheary,L,TBL,32,82,13,20,33
72,8477903,Garnet Hathaway,R,PHI,33,82,13,20,33
72,8475714,Calle Jarnkrok,C,TOR,33,82,12,21,33
72,8482624,Daniil Miromanov,D,CGY,27,82,9,24,33
72,8481186,Logan O'Connor,R,COL,28,82,9,24,33
72,8476958,Jaccob Slavin,D,CAR,30,82,8,25,33
72,8476923,Damon Severson,D,CBJ,30,82,8,25,33
72,8476854,Hampus Lindholm,D,BOS,30,82,6,27,33
72,8480145,Neal Pionk,D,WPG,29,82,5,28,33
72,8479398,Samuel Girard,D,COL,26,82,4,29,33
72,8482089,Jake Neighbours,L,STL,22,82,18,14,32
72,8477425,Miles Wood,L,COL,29,82,14,18,32
72,8475200,Dmitry Orlov,D,CAR,33,82,13,19,32
72,8477919,Frederick Gaudreau,C,MIN,31,82,12,20,32
72,8482105,Jake Sanderson,D,OTT,22,82,11,21,32
72,8473563,Nicklas Backstrom,C,WSH,37,82,10,22,32
72,8476467,Jamie Oleksiak,D,SEA,32,82,7,25,32
72,8478882,Vladislav Gavrikov,D,LAK,29,82,7,25,32
72,8476902,Esa Lindell,D,DAL,30,82,3,29,32
72,8478109,Victor Olofsson,L,VGK,29,82,19,12,31
72,8482117,Lukas Reichel,L,CHI,22,82,15,16,31
72,8482079,Marco Rossi,C,MIN,23,82,15,16,31
72,8475855,Jesper Fast,R,CAR,33,82,14,17,31
72,8480459,Pius Suter,C,VAN,28,82,13,18,31
72,8482062,Cole Smith,L,NSH,29,82,13,18,31
72,8483468,Jiri Kulich,C,BUF,20,82,12,19,31
72,8481477,Nico Sturm,C,SJS,29,82,11,20,31
72,8476422,Mike Reilly,D,NYI,31,82,8,23,31
72,8482655,J.J. Moser,D,TBL,24,82,6,25,31
72,8476917,Adam Pelech,D,NYI,30,82,4,27,31
72,8480878,Nils Lundkvist,D,DAL,24,82,4,27,31
72,8475790,Erik Gudbranson,D,CBJ,32,82,4,27,31
72,8476892,Colton Parayko,D,STL,31,82,3,28,31
72,8479316,Luke Kunin,C,SJS,27,82,16,14,30
72,8481601,Simon Holmstrom,R,NYI,23,82,15,15,30
72,8478020,Michael Amadio,C,OTT,28,82,12,18,30
72,8480980,Connor Dewar,C,TOR,25,82,12,18,30
72,8482133,Thomas Bordeleau,C,SJS,22,82,11,19,30
72,8481013,Jonatan Berggren,R,DET,24,82,11,19,30
72,8474716,Jared Spurgeon,D,MIN,35,82,8,22,30
72,8479976,Juuso Valimaki,D,UTA,26,82,7,23,30
72,8476331,Dylan DeMelo,D,WPG,31,82,7,23,30
72,8476979,Erik Gustafsson,D,DET,32,82,5,25,30
72,8480003,Jesper Boqvist,C,FLA,26,82,18,11,29
72,8481032,Paul Cotter,C,NJD,25,82,16,13,29
72,8483457,Lane Hutson,D,MTL,20,82,9,20,29
72,8479371,Dante Fabbro,D,NSH,26,82,8,21,29
72,8473507,Jeff Petry,D,DET,37,82,6,23,29
72,8477488,Brett Pesce,D,NJD,30,82,6,23,29
72,8481178,Egor Zamula,D,PHI,24,82,6,23,29
72,8482073,Braden Schneider,D,NYR,23,82,6,23,29
72,8478178,Darren Raddysh,D,TBL,28,82,6,23,29
72,8478500,Ivan Provorov,D,CBJ,27,82,4,25,29
72,8480035,Henri Jokiharju,D,BUF,25,82,3,26,29
72,8480995,Pontus Holmberg,R,TOR,25,82,18,10,28
72,8478432,Christian Fischer,R,DET,27,82,17,11,28
72,8483808,Andrei Kuzmenko,L,CGY,28,82,14,14,28
72,8480074,Alexandre Texier,C,STL,25,82,14,14,28
72,8477953,Kasperi Kapanen,R,STL,28,82,13,15,28
72,8477989,Christian Dvorak,C,MTL,28,82,13,15,28
72,8484153,Leo Carlsson,C,ANA,20,82,12,16,28
72,8480021,Jack Studnicka,C,LAK,25,82,12,16,28
72,8481522,Peyton Krebs,C,BUF,23,82,9,19,28
72,8474151,Ryan McDonagh,D,TBL,35,82,8,20,28
72,8477435,Ryan Graves,D,PIT,29,82,6,22,28
72,8480222,Sebastian Aho,D,PIT,28,82,6,22,28
72,8480043,Timothy Liljegren,D,TOR,25,82,5,23,28
72,8482125,Alexander Holtz,R,VGK,22,82,16,11,27
72,8470621,Corey Perry,R,EDM,39,82,14,13,27
72,8480336,Sean Walker,D,CAR,30,82,13,14,27
72,8481704,Juuso Parssinen,C,NSH,23,82,11,16,27
72,8479353,Brett Howden,C,VGK,26,82,11,16,27
72,8475171,Oliver Ekman-Larsson,D,TOR,33,82,7,20,27
72,8481014,Alexander Romanov,D,NYI,24,82,5,22,27
72,8477969,Marcus Pettersson,D,PIT,28,82,3,24,27
72,8478507,John Marino,D,UTA,27,82,2,25,27
72,8480873,Rasmus Sandin,D,WSH,24,82,1,26,27
72,8477952,Robby Fabbri,C,ANA,28,82,15,11,26
72,8479393,Noah Gregor,C,OTT,26,82,15,11,26
72,8476469,Joel Armia,R,MTL,31,82,14,12,26
72,8475848,Brendan Gallagher,R,MTL,32,82,13,13,26
72,8480835,Jack Drury,C,CAR,24,82,12,14,26
72,8484203,Bradly Nadeau,L,CAR,19,82,12,14,26
72,8479368,Max Jones,L,BOS,26,82,12,14,26
72,8478211,Dryden Hunt,L,CGY,29,82,12,14,26
72,8479351,Sam Steel,C,DAL,26,82,11,15,26
72,8480871,Adam Boqvist,D,FLA,24,82,9,17,26
72,8482141,Lukas Cormier,D,VGK,22,82,8,18,26
72,8476921,Jordan Martinook,L,CAR,32,82,7,19,26
72,8476463,Jonas Brodin,D,MIN,31,82,5,21,26
72,8475455,Brenden Dillon,D,NJD,34,82,5,21,26
72,8475181,Nick Leddy,D,STL,33,82,3,23,26
72,8481553,Bobby Brink,R,PHI,23,82,14,11,25
72,8476981,Josh Anderson,R,MTL,30,82,14,11,25
72,8473453,Trevor Lewis,C,LAK,37,82,14,11,25
72,8475193,Tomas Tatar,L,NJD,34,82,12,13,25
72,8479661,Tanner Jeannot,L,LAK,27,82,9,16,25
72,8475343,Nic Dowd,C,WSH,34,82,9,16,25
72,8480144,David Kampf,C,TOR,29,82,9,16,25
72,8477507,Nikita Zadorov,D,BOS,29,82,7,18,25
72,8484149,Gavin Brindley,C,CBJ,20,82,7,18,25
72,8482145,Mavrik Bourque,C,DAL,22,82,7,18,25
72,8474673,TJ Brodie,D,CHI,34,82,6,19,25
72,8481708,Zac Jones,D,NYR,24,82,6,19,25
72,8476429,Scott Mayfield,D,NYI,32,82,6,19,25
72,8474574,Tyler Myers,D,VAN,34,82,5,20,25
72,8480807,Mattias Samuelsson,D,BUF,24,82,5,20,25
72,8477845,Trevor van Riemsdyk,D,WSH,33,82,4,21,25
72,8474189,Lars Eller,C,PIT,35,82,11,13,24
72,8481093,Rafael Harvey-Pinard,L,MTL,25,82,11,13,24
72,8481517,Brett Leason,R,ANA,25,82,11,13,24
72,8477505,Alexander Wennberg,C,SJS,30,82,11,13,24
72,8478569,Noel Acciari,C,PIT,33,82,9,15,24
72,8475231,Casey Cizikas,C,NYI,33,82,8,16,24
72,8481524,Bowen Byram,D,BUF,23,82,8,16,24
72,8476457,Adam Larsson,D,SEA,32,82,7,17,24
72,8482666,Scott Morrow,D,CAR,22,82,6,18,24
72,8482087,Kaiden Guhle,D,MTL,22,82,6,18,24
72,8474090,Brendan Smith,D,DAL,35,82,6,18,24
72,8482122,Brock Faber,D,MIN,22,82,5,19,24
72,8480246,Nick Perbix,D,TBL,26,82,5,19,24
72,8479324,Ryan Lindgren,D,NYR,26,82,3,21,24
72,8481028,Martin Pospisil,C,CGY,25,82,16,7,23
72,8479293,Brandon Tanev,L,SEA,33,82,15,8,23
72,8479414,Nathan Bastian,R,NJD,27,82,15,8,23
72,8480855,Jack McBain,C,UTA,24,82,10,13,23
72,8481481,Blake Lizotte,C,PIT,27,82,9,14,23
72,8477450,Jason Dickinson,C,CHI,29,82,8,15,23
72,8477220,Nate Schmidt,D,FLA,33,82,7,16,23
72,8475324,Nick Jensen,D,OTT,34,82,7,16,23
72,8480806,Isac Lundestrom,C,ANA,25,82,7,16,23
72,8482166,Shakir Mukhamadullin,D,SJS,22,82,5,18,23
72,8476967,Brett Kulak,D,EDM,30,82,1,22,23
72,8475690,Chris Tanev,D,TOR,35,82,0,23,23
72,8481641,Joel Kiviranta,L,COL,28,82,15,7,22
72,8482074,Connor Zary,C,CGY,23,82,14,8,22
72,8479591,Michael Eyssimont,C,TBL,28,82,12,10,22
72,8477931,Tomas Nosek,L,FLA,32,82,12,10,22
72,8484145,Zach Benson,L,BUF,19,82,10,12,22
72,8478434,Keegan Kolesar,R,VGK,27,82,10,12,22
72,8478013,Jake Walman,D,SJS,28,82,7,15,22
72,8483495,Simon Nemec,D,NJD,20,82,7,15,22
72,8480990,Declan Chisholm,D,MIN,24,82,7,15,22
72,8474612,Travis Hamonic,D,OTT,34,82,5,17,22
72,8476312,Josh Manson,D,COL,33,82,4,18,22
72,8475188,Brayden McNabb,D,VGK,33,82,3,19,22
72,8481606,Jordan Spence,D,LAK,23,82,2,20,22
72,8479291,Kevin Rooney,C,CGY,31,82,8,13,21
72,8475279,Ben Chiarot,D,DET,33,82,8,13,21
72,8478840,Will Borgen,D,SEA,28,82,6,15,21
72,8482803,Olen Zellweger,D,ANA,21,82,5,16,21
72,8481568,Alex Vlasic,D,CHI,23,82,3,18,21
72,8479369,Andrew Peeke,D,BOS,26,82,3,18,21
72,8480049,Dylan Samberg,D,WPG,25,82,0,21,21
72,8482077,Dylan Holloway,L,EDM,23,82,14,6,20
72,8483524,Shane Wright,C,SEA,20,82,12,8,20
72,8476374,Sean Kuraly,C,CBJ,31,82,10,10,20
72,8480448,Parker Kelly,L,COL,25,82,10,10,20
72,8480025,MacKenzie Entwistle,R,FLA,25,82,9,11,20
72,8482679,Matt Coronato,R,CGY,22,82,9,11,20
72,8482702,Logan Stankoven,C,DAL,21,82,7,13,20
72,8481699,Aku Raty,R,UTA,23,82,7,13,20
72,8476879,Cody Ceci,D,EDM,31,82,6,14,20
72,8482858,Ryker Evans,D,SEA,23,82,6,14,20
72,8480834,Ty Emberson,D,SJS,24,82,6,14,20
72,8475462,Radko Gudas,D,ANA,34,82,5,15,20
72,8482153,Brendan Brisson,C,VGK,23,82,5,15,20
72,8476525,Colin Miller,D,WPG,32,82,3,17,20
72,8478399,Jonas Siegenthaler,D,NJD,27,82,2,18,20
72,8482259,Bobby McMann,C,TOR,28,82,11,8,19
72,8476878,Zemgus Girgensons,L,TBL,30,82,7,12,19
72,8483493,Frank Nazar,C,CHI,20,82,6,13,19
72,8480172,Jan Rutta,D,SJS,34,82,5,14,19
72,8477034,Jaycob Megna,D,FLA,32,82,5,14,19
72,8476891,Matt Grzelcyk,D,PIT,30,82,3,16,19
72,8480281,Alexey Toropchenko,R,STL,25,82,14,4,18
72,8483505,Matthew Poitras,C,BOS,20,82,8,10,18
72,8482101,Danil Gushchin,L,SJS,22,82,8,10,18
72,8483763,Maksymilian Szuber,D,UTA,22,82,7,11,18
72,8477353,Tyler Motte,C,DET,29,82,6,12,18
72,8482807,Ethan Del Mastro,D,CHI,21,82,6,12,18
72,8483490,Pavel Mintyukov,D,ANA,21,82,3,15,18
72,8479998,Mikey Anderson,D,LAK,25,82,3,15,18
72,8474013,Ian Cole,D,UTA,35,82,1,17,18
72,8475842,Sam Carrick,C,NYR,32,82,11,6,17
72,8476442,Matt Nieto,L,PIT,32,82,10,7,17
72,8477406,Mattias Janmark,C,EDM,32,82,9,8,17
72,8483499,Liam Ohgren,L,MIN,20,82,8,9,17
72,8482762,Simon Edvinsson,D,DET,21,82,8,9,17
72,8477508,Curtis Lazar,C,NJD,29,82,6,11,17
72,8482733,Logan Mailloux,D,MTL,31,82,6,11,17
72,8480796,Martin Fehervary,D,WSH,25,82,6,11,17
72,8482659,Josh Doan,R,UTA,22,82,6,11,17
72,8480860,Kevin Bahl,D,CGY,24,82,4,13,17
72,8470600,Ryan Suter,D,STL,39,82,4,13,17
72,8478416,Erik Cernak,D,TBL,27,82,3,14,17
72,8479980,Nicolas Hague,D,VGK,26,82,2,15,17
72,8478136,Jake Middleton,D,MIN,28,82,1,16,17
72,8483567,Georgii Merkulov,C,BOS,24,82,11,5,16
72,8482470,Ilya Solovyov,D,CGY,24,82,5,11,16
72,8483482,Tristan Luneau,D,ANA,20,82,4,12,16
72,8483565,Nick Blankenburg,D,NSH,26,82,4,12,16
72,8480073,Erik Brannstrom,D,COL,25,82,3,13,16
72,8478443,Brandon Carlo,D,BOS,28,82,3,13,16
72,8476858,Phillip Di Giuseppe,L,VAN,31,82,8,7,15
72,8476889,Radek Faksa,C,STL,30,82,6,9,15
72,8477365,Connor Clifton,D,BUF,29,82,5,10,15
72,8478859,Niko Mikkola,D,FLA,28,82,3,12,15
72,8480950,Ilya Lyubushkin,D,DAL,30,82,2,13,15
72,8476372,Nick Seeler,D,PHI,31,82,2,13,15
72,8475762,Derek Forbort,D,VAN,32,82,2,13,15
72,8475233,David Savard,D,MTL,34,82,1,14,15
72,8477015,Connor Brown,R,EDM,30,82,7,7,14
72,8479638,Justin Brazeau,R,BOS,26,82,6,8,14
72,8482245,Artem Zub,D,OTT,29,82,2,12,14
72,8480879,Jacob Bernard-Docker,D,OTT,24,82,1,13,14
72,8482155,Alex Laferriere,R,LAK,23,82,11,2,13
72,8482118,Sam Colangelo,R,ANA,23,82,7,6,13
72,8484911,Collin Graf,R,SJS,22,82,5,8,13
72,8483445,Cutter Gauthier,L,ANA,20,82,5,8,13
72,8478468,Jeremy Lauzon,D,NSH,27,82,2,11,13
72,8482809,Jackson Blake,R,CAR,21,82,2,11,13
72,8476441,Joel Edmundson,D,LAK,31,82,2,11,13
72,8483460,David Jiricek,D,CBJ,21,82,1,12,13
72,8483397,Marc McLaughlin,C,BOS,25,82,10,2,12
72,8480870,Bo Groulx,C,NYR,24,82,6,6,12
72,8482516,Matthew Kessel,D,STL,24,82,3,9,12
72,8482712,Oskar Olausson,R,COL,22,82,3,9,12
72,8474567,Zach Bogosian,D,MIN,34,82,3,9,12
72,8477369,Carson Soucy,D,VAN,30,82,2,10,12
72,8479442,Troy Stecher,D,EDM,30,82,2,10,12
72,8478874,Adam Gaudette,C,OTT,28,82,0,12,12
72,8481605,Jackson LaCombe,D,ANA,23,82,6,5,11
72,8483012,Logan Morrison,C,SEA,22,82,5,6,11
72,8482713,Mackie Samoskevich,R,FLA,22,82,5,6,11
72,8481567,Henry Thrun,D,SJS,23,82,2,9,11
72,8477499,Rasmus Ristolainen,D,PHI,30,82,2,9,11
72,8475177,Calvin de Haan,D,COL,33,82,2,9,11
72,8475718,Justin Holl,D,DET,32,82,1,10,11
72,8476473,Connor Murphy,D,CHI,31,82,1,10,11
72,8481122,Simon Benoit,D,TOR,26,82,1,10,11
72,8483471,Brad Lambert,C,WPG,31,82,6,4,10
72,8482070,Mitchell Chaffee,R,TBL,26,82,6,4,10
72,8482749,Joshua Roy,R,MTL,21,82,5,5,10
72,8482859,Zack Ostapchuk,C,OTT,21,82,5,5,10
72,8476624,Barclay Goodrow,C,SJS,31,82,4,6,10
72,8477938,Haydn Fleury,D,WPG,28,82,4,6,10
72,8479983,Mario Ferraro,D,SJS,26,82,2,8,10
72,8478450,Parker Wotherspoon,D,BOS,27,82,3,6,9
72,8477335,Kyle Burroughs,D,LAK,29,82,2,7,9
72,8476822,Luke Glendening,C,TBL,35,82,3,5,8
72,8471677,Jack Johnson,D,CBJ,37,82,3,5,8
72,8483489,Fraser Minten,C,TOR,31,82,2,6,8
72,8482787,Nikita Chibrikov,R,WPG,31,82,2,5,7
72,8474062,Riley Nash,C,NYR,35,82,2,5,7
72,8483466,Kevin Korchinski,D,CHI,20,82,1,5,6
72,8479576,Vincent Desharnais,D,VAN,28,82,0,2,2
72,8470794,Joe Pavelski,C,,40,0,0,0,0
72,8481703,Valtteri Puustinen,R,PIT,25,0,0,0,0
72,8477950,Tony DeAngelo,D,,29,0,0,0,0
72,8481577,Philip Tomasino,C,NSH,23,0,0,0,0
72,8475197,Tyson Barrie,D,,33,0,0,0,0
72,8471218,Blake Wheeler,R,,38,0,0,0,0
72,8474157,Max Pacioretty,L,,36,0,0,0,0
72,8478466,Daniel Sprong,R,VAN,27,0,0,0,0
72,8475744,Evgeny Kuznetsov,C,,32,0,0,0,0
72,8481019,David Gustafsson,C,WPG,24,0,0,0,0
72,8475906,John Klingberg,D,,32,0,0,0,0
72,8479348,Kale Clague,D,BUF,26,0,0,0,0
72,8476952,Dominic Toninato,C,WPG,30,0,0,0,0
72,8473473,Milan Lucic,L,,36,0,0,0,0
72,8474037,James van Riemsdyk,L,,35,0,0,0,0
72,8474602,Justin Schultz,D,,34,0,0,0,0
72,8482222,Alexander Barabanov,L,,30,0,0,0,0
72,8479372,Josh Mahura,D,SEA,26,0,0,0,0
72,8479982,Conor Timmins,D,TOR,26,0,0,0,0
72,8474031,Kevin Shattenkirk,D,,35,0,0,0,0
72,8480008,Adam Ruzicka,C,,25,0,0,0,0
72,8481059,Scott Perunovich,D,STL,26,0,0,0,0
72,8480884,Calen Addison,D,,24,0,0,0,0
72,8476994,Vinnie Hinostroza,C,NSH,30,0,0,0,0
72,8478452,Caleb Jones,D,LAK,27,0,0,0,0
72,8480157,Calle Rosen,D,COL,30,0,0,0,0
72,8481609,Vladislav Kolyachonok,D,UTA,23,0,0,0,0
72,8479415,Michael McLeod,C,,26,0,0,0,0
72,8476919,Chris Tierney,C,,30,0,0,0,0
72,8479639,Dylan Coghlan,D,WPG,26,0,0,0,0
72,8478146,Matthew Highmore,C,OTT,28,0,0,0,0
72,8478970,Jalen Chatfield,D,CAR,28,0,0,0,0
72,8480205,Emil Bemstrom,C,PIT,25,0,0,0,0
72,8474884,Mike Hoffman,C,,35,0,0,0,0
72,8471274,Alex Goligoski,D,,39,0,0,0,0
72,8478104,Sammy Blais,L,,28,0,0,0,0
72,8474870,Tyler Johnson,C,,34,0,0,0,0
72,8476913,Devin Shore,C,MIN,30,0,0,0,0
72,8481598,Philip Broberg,D,EDM,23,0,0,0,0
72,8480058,Pierre-Olivier Joseph,D,STL,25,0,0,0,0
72,8480891,Michael Kesselring,D,UTA,24,0,0,0,0
72,8477979,Nicolas Aube-Kubel,R,BUF,28,0,0,0,0
72,8476871,Tanner Pearson,L,,32,0,0,0,0
72,8476393,Nick Cousins,C,,31,0,0,0,0
72,8479977,Kailer Yamamoto,R,,26,0,0,0,0
72,8479543,Michael Pezzetta,L,MTL,26,0,0,0,0
72,8477018,Ben Hutton,D,VGK,31,0,0,0,0
72,8480762,Eric Robinson,L,CAR,29,0,0,0,0
72,8474034,Pat Maroon,L,CHI,36,0,0,0,0
72,8481058,Jesse Ylönen,R,,25,0,0,0,0
72,8475179,Dmitry Kulikov,D,FLA,34,0,0,0,0
72,8481527,Kaedan Korczak,D,VGK,23,0,0,0,0
72,8473449,Kyle Okposo,R,,36,0,0,0,0
72,8482192,Isaak Phillips,D,CHI,23,0,0,0,0
72,8480727,Zach Whitecloud,D,VGK,28,0,0,0,0
72,8479346,Dillon Dube,C,,26,0,0,0,0
72,8480821,Filip Zadina,R,,25,0,0,0,0
72,8480001,Urho Vaakanainen,D,ANA,25,0,0,0,0
72,8470966,Mark Giordano,D,,41,0,0,0,0
72,8480853,Liam Foudy,C,,24,0,0,0,0
72,8475225,Craig Smith,C,CHI,35,0,0,0,0
72,8479972,Mason Shaw,C,WPG,26,0,0,0,0
72,8478451,Ethan Bear,D,WSH,27,0,0,0,0
72,8474040,Sam Gagner,C,,35,0,0,0,0
72,8480196,Jacob Bryson,D,BUF,27,0,0,0,0
72,8479984,Cal Foote,D,,26,0,0,0,0
72,8480011,Klim Kostin,C,SJS,25,0,0,0,0
72,8482176,Wyatt Kaiser,D,CHI,22,0,0,0,0
72,8476988,Matt Benning,D,SJS,30,0,0,0,0
72,8479370,Tyson Jost,C,CAR,26,0,0,0,0
72,8477464,Nic Petan,C,,29,0,0,0,0
72,8477380,Jonny Brodzinski,C,NYR,31,0,0,0,0
72,8480070,Ian Mitchell,D,BOS,25,0,0,0,0
72,8479315,Joey Anderson,R,CHI,26,0,0,0,0
72,8478099,Kevin Labanc,R,,29,0,0,0,0
72,8476874,Olli Maatta,D,DET,30,0,0,0,0
72,8475208,Brian Dumoulin,D,ANA,33,0,0,0,0
72,8478430,Oliver Kylington,D,,27,0,0,0,0
72,8479536,Axel Jonsson-Fjallby,L,WPG,26,0,0,0,0
72,8479671,Mathieu Olivier,R,CBJ,27,0,0,0,0
72,8471709,Marc-Edouard Vlasic,D,SJS,37,0,0,0,0
72,8479328,Julien Gauthier,R,NYI,27,0,0,0,0
72,8478421,A.J. Greer,L,FLA,28,0,0,0,0
72,8477573,Nathan Walker,L,STL,30,0,0,0,0
72,8481537,Nikita Okhotiuk,D,CGY,24,0,0,0,0
72,8474166,Alec Martinez,D,CHI,37,0,0,0,0
72,8470610,Zach Parise,L,,40,0,0,0,0
72,8477478,William Carrier,L,CAR,30,0,0,0,0
72,8479344,Jesse Puljujarvi,R,PIT,26,0,0,0,0
72,8480887,Jordan Harris,D,MTL,24,0,0,0,0
72,8478502,Dennis Gilbert,D,BUF,28,0,0,0,0
72,8482730,Brandt Clarke,D,LAK,21,0,0,0,0
72,8480355,Mark Kastelic,C,BOS,25,0,0,0,0
72,8475750,Jon Merrill,D,MIN,32,0,0,0,0
72,8475164,Jakob Silfverberg,R,,34,0,0,0,0
72,8477944,Jakub Vrana,L,,28,0,0,0,0
72,8479439,Jacob MacDonald,D,COL,31,0,0,0,0
72,8474568,Luke Schenn,D,NSH,35,0,0,0,0
72,8478454,Noah Juulsen,D,VAN,27,0,0,0,0
72,8475752,Tyler Pitlick,C,,33,0,0,0,0
72,8482148,Hendrix Lapierre,C,WSH,22,0,0,0,0
72,8481167,Brayden Pachal,D,CGY,25,0,0,0,0
72,8478043,Sam Lafferty,C,BUF,29,0,0,0,0
72,8479321,Lucas Johansen,D,,27,0,0,0,0
72,8471699,Andrew Cogliano,C,,37,0,0,0,0
72,8481521,Ronnie Attard,D,PHI,25,0,0,0,0
72,8481161,Jake Christiansen,D,CBJ,25,0,0,0,0
72,8479458,Nikita Zaitsev,D,,33,0,0,0,0
72,8479619,Michael Carcone,L,UTA,28,0,0,0,0
72,8479026,Philippe Myers,D,TOR,27,0,0,0,0
72,8477330,Dominik Kubalik,L,,29,0,0,0,0
72,8481617,Vasily Podkolzin,R,VAN,23,0,0,0,0
72,8481701,Santeri Hatakka,D,NJD,23,0,0,0,0
72,8479514,Rem Pitlick,C,,27,0,0,0,0
72,8477446,Michael McCarron,R,NSH,29,0,0,0,0
72,8470604,Jeff Carter,C,,39,0,0,0,0
72,8482241,Radim Zohorna,L,,28,0,0,0,0
72,8480289,Morgan Barron,C,WPG,26,0,0,0,0
72,8479379,Givani Smith,R,SJS,26,0,0,0,0
72,8480216,Jacob Peterson,C,,25,0,0,0,0
72,8477851,Jordan Oesterle,D,BOS,32,0,0,0,0
72,8484258,Sam Malinski,D,COL,26,0,0,0,0
72,8478904,Steven Lorentz,C,,28,0,0,0,0
72,8482095,Tyler Kleven,D,OTT,22,0,0,0,0
72,8480848,Ty Dellandrea,C,SJS,24,0,0,0,0
72,8476884,Derrick Pouliot,D,,30,0,0,0,0
72,8479336,Carl Grundstrom,R,SJS,27,0,0,0,0
72,8482964,Arber Xhekaj,D,MTL,23,0,0,0,0
72,8471686,Marc Staal,D,,37,0,0,0,0
72,8477887,Patrick Brown,C,BOS,32,0,0,0,0
72,8478495,Denis Gurianov,R,,27,0,0,0,0
72,8473504,Cal Clutterbuck,R,,37,0,0,0,0
72,8481550,Adam Beckman,L,NJD,23,0,0,0,0
72,8480845,Rasmus Kupari,C,WPG,24,0,0,0,0
72,8474009,Nick Bonino,C,,36,0,0,0,0
72,8478585,Derek Ryan,C,EDM,38,0,0,0,0
72,8477962,Brendan Lemieux,L,CAR,28,0,0,0,0
72,8482861,Vincent Iorio,D,WSH,22,0,0,0,0
72,8479378,Logan Stanley,D,WPG,26,0,0,0,0
72,8473446,Erik Johnson,D,PHI,36,0,0,0,0
72,8481743,Marc Del Gaizo,D,NSH,25,0,0,0,0
72,8477384,Josh Brown,D,EDM,30,0,0,0,0
72,8482165,Yan Kuznetsov,D,CGY,22,0,0,0,0
72,8478424,Jansen Harkins,C,ANA,27,0,0,0,0
72,8482144,Jack Thompson,D,SJS,22,0,0,0,0
72,8478512,Austin Czarnik,C,,32,0,0,0,0
72,8477527,Ross Johnston,L,ANA,30,0,0,0,0
72,8479383,Boris Katchouk,L,,26,0,0,0,0
72,8482094,Daemon Hunt,D,MIN,22,0,0,0,0
72,8481719,Maxwell Crozier,D,TBL,24,0,0,0,0
72,8480192,Johnathan Kovacevic,D,NJD,27,0,0,0,0
72,8479376,Victor Mete,D,,26,0,0,0,0
72,8482511,Mason Lohrei,D,BOS,23,0,0,0,0
72,8475825,Jani Hakanpää,D,,32,0,0,0,0
72,8478021,William Lagesson,D,DET,28,0,0,0,0
72,8475795,Dylan McIlrath,D,WSH,32,0,0,0,0
72,8477846,Ryan Carpenter,C,,33,0,0,0,0
72,8481056,Spencer Stastney,D,NSH,24,0,0,0,0
72,8481564,Ryan Johnson,D,BUF,23,0,0,0,0
72,8478017,Mark Friedman,D,VAN,29,0,0,0,0
72,8479320,Max Lajoie,D,SEA,27,0,0,0,0
72,8480075,Cameron Crotty,D,MIN,25,0,0,0,0
72,8484287,Cole McWard,D,VAN,23,0,0,0,0
72,8484254,Akito Hirose,D,VAN,25,0,0,0,0
72,8483407,Brandon Scanlin,D,NYR,25,0,0,0,0
72,8480274,Philip Kemp,D,EDM,25,0,0,0,0
72,8479522,Hardy Haman Aktell,D,WSH,26,0,0,0,0
72,8480007,Jonas Rondbjerg,R,VGK,25,0,0,0,0
72,8477454,Adam Erne,L,,29,0,0,0,0
72,8481679,Maxence Guenette,D,OTT,23,0,0,0,0
72,8480441,Trey Fix-Wolansky,R,CBJ,25,0,0,0,0
72,8483546,Marshall Rifai,D,TOR,26,0,0,0,0
72,8480084,Nick DeSimone,D,NJD,30,0,0,0,0
72,8481030,Jack St. Ivany,D,PIT,25,0,0,0,0
72,8481592,Jakob Pelletier,L,CGY,23,0,0,0,0
72,8478011,Louie Belpedio,D,PHI,28,0,0,0,0
72,8477930,Pierre-Edouard Bellemare,L,,39,0,0,0,0
72,8484321,Nikolas Matinpalo,D,OTT,26,0,0,0,0
72,8482067,Connor Mackey,D,NYR,28,0,0,0,0
72,8481806,Louis Crevier,D,CHI,23,0,0,0,0
72,8484326,Patrik Koch,D,UTA,28,0,0,0,0
72,8477971,Andreas Englund,D,LAK,28,0,0,0,0
72,8481751,Lukas Rousek,R,BUF,25,0,0,0,0
72,8481006,Tyler Tucker,D,STL,24,0,0,0,0
72,8476867,Brendan Gaunce,C,MIN,30,0,0,0,0
72,8479520,Brandon Duhaime,R,WSH,27,0,0,0,0
72,8477073,Kurtis MacDermid,L,NJD,30,0,0,0,0
72,8480874,Adam Ginning,D,PHI,24,0,0,0,0
72,8477473,Justin Bailey,R,SJS,29,0,0,0,0
72,8479066,Ryan Lomberg,L,CGY,30,0,0,0,0
72,8477070,Liam O'Brien,C,UTA,30,0,0,0,0
72,8474618,Marco Scandella,D,,34,0,0,0,0
72,8475797,Jarred Tinordi,D,,32,0,0,0,0
72,8481441,Joe Snively,C,DET,28,0,0,0,0
72,8477244,Chad Ruhwedel,D,NYR,34,0,0,0,0
72,8479772,Zack MacEwen,R,OTT,28,0,0,0,0
72,8481147,Reese Johnson,C,MIN,26,0,0,0,0
72,8481043,Cole Koepke,L,BOS,26,0,0,0,0
72,8483619,Filip Roos,D,OTT,25,0,0,0,0
72,8481541,Samuel Bolduc,D,NYI,24,0,0,0,0
72,8477810,Joel Hanley,D,CGY,33,0,0,0,0
72,8476907,Mackenzie MacEachern,L,,30,0,0,0,0
72,8482652,Walker Duehr,R,CGY,27,0,0,0,0
72,8477126,Jayson Megna,C,,34,0,0,0,0
72,8483398,Declan Carlile,D,TBL,31,0,0,0,0
72,8482929,Emil Lilleberg,D,TBL,23,0,0,0,0
72,8480880,Jakub Lauko,C,MIN,24,0,0,0,0
72,8480245,Olle Lycksell,R,PHI,25,0,0,0,0
72,8480252,Cole Guttman,C,CHI,25,0,0,0,0
72,8477467,Gustav Olofsson,D,SEA,30,0,0,0,0
72,8479968,Vinni Lettieri,C,BOS,29,0,0,0,0
72,8478400,Colin White,C,,27,0,0,0,0
72,8475755,Alexander Petrovic,D,DAL,32,0,0,0,0
72,8481812,Nikolai Knyzhov,D,,27,0,0,0,0
72,8481593,Jayden Struble,D,MTL,23,0,0,0,0
72,8481532,Alex Turcotte,C,LAK,23,0,0,0,0
72,8482126,Emil Andrae,D,PHI,31,0,0,0,0
72,8479944,Zach Aston-Reese,C,VGK,30,0,0,0,0
72,8471817,Ryan Reaves,R,TOR,37,0,0,0,0
72,8481206,John Ludvig,D,PIT,24,0,0,0,0
72,8481599,Victor Soderstrom,D,UTA,23,0,0,0,0
72,8480292,Carson Meyer,R,ANA,27,0,0,0,0
72,8482496,Nils Aman,C,VAN,24,0,0,0,0
72,8479718,Alex Barré-Boulet,C,MTL,27,0,0,0,0
72,8479994,Jaret Anderson-Dolan,C,WPG,25,0,0,0,0
72,8480184,Gustav Lindstrom,D,,26,0,0,0,0
72,8480890,Jan Jenik,R,OTT,24,0,0,0,0
72,8478067,Oskar Lindblom,L,,28,0,0,0,0
72,8476934,Brock McGinn,L,ANA,30,0,0,0,0
72,8479985,Cale Fleury,D,SEA,26,0,0,0,0
72,8484304,Uvis Balinskis,D,FLA,28,0,0,0,0
72,8479981,Jonah Gadjovich,L,FLA,26,0,0,0,0
72,8481716,Dmitri Voronkov,L,CBJ,24,0,0,0,0
72,8474709,Matt Martin,L,,35,0,0,0,0
72,8482634,Alex Steeves,C,TOR,25,0,0,0,0
72,8480823,Alexander Alexeyev,D,WSH,25,0,0,0,0
72,8477541,Dakota Mermis,D,TOR,30,0,0,0,0
72,8483491,Ivan Miroshnichenko,L,WSH,20,0,0,0,0
72,8478477,Mitchell Stephens,C,SEA,27,0,0,0,0
72,8481543,Nikita Alexandrov,C,STL,24,0,0,0,0
72,8479423,Alex Nylander,L,,26,0,0,0,0
72,8482451,Mikael Pyyhtia,L,CBJ,23,0,0,0,0
72,8478831,Kevin Stenlund,C,UTA,28,0,0,0,0
72,8480306,Grant Hutton,D,NYI,29,0,0,0,0
72,8478028,Fredrik Olofsson,L,,28,0,0,0,0
72,8477462,Robert Hagg,D,VGK,29,0,0,0,0
72,8477320,Anton Blidh,L,NYR,29,0,0,0,0
72,8482157,Will Cuylle,L,NYR,22,0,0,0,0
72,8482737,Zack Bolduc,C,STL,21,0,0,0,0
72,8481239,Samuel Fagemo,L,,24,0,0,0,0
72,8481600,Tobias Bjornfot,D,FLA,23,0,0,0,0
72,8478409,Anthony Richard,C,PHI,28,0,0,0,0
72,8474145,Robert Bortuzzo,D,,35,0,0,0,0
72,8475958,Michael Sgarbossa,C,WSH,32,0,0,0,0
72,8479986,Kole Lind,R,DAL,26,0,0,0,0
72,8479249,Andrew Poturalski,C,SJS,30,0,0,0,0
72,8479362,Riley Tufte,L,BOS,26,0,0,0,0
72,8479991,Jake Leschyshyn,C,NYR,25,0,0,0,0
72,8479587,Rhett Gardner,C,PHI,28,0,0,0,0
72,8482744,James Malatesta,L,CBJ,21,0,0,0,0
72,8478854,Ryan Shea,D,PIT,27,0,0,0,0
72,8481591,Sam Poulin,R,,23,0,0,0,0
72,8483512,Matt Savoie,C,EDM,20,0,0,0,0
72,8482102,Vasily Ponomarev,C,PIT,22,0,0,0,0
72,8482162,Roby Jarventie,L,EDM,22,0,0,0,0
72,8481016,Ruslan Iskhakov,C,,24,0,0,0,0
72,8482172,Landon Slaggert,L,CHI,22,0,0,0,0
72,8482747,Brennan Othmann,L,NYR,21,0,0,0,0
72,8480031,Maxime Comtois,L,,25,0,0,0,0
72,8480226,Marián Studenic,R,,26,0,0,0,0
72,8478408,Travis Dermott,D,,28,0,0,0,0
72,8481518,Nolan Foote,L,NJD,24,0,0,0,0
72,8479419,Brett Murray,L,BUF,26,0,0,0,0
72,8482088,Justin Sourdif,R,FLA,22,0,0,0,0
72,8482201,Gage Goncalves,C,TBL,23,0,0,0,0
72,8481578,Graeme Clarke,R,MIN,23,0,0,0,0
72,8482177,Marat Khusnutdinov,C,MIN,22,0,0,0,0
72,8481754,Nikita Nesterenko,C,ANA,23,0,0,0,0
72,8483531,Brian Halonen,L,NJD,25,0,0,0,0
72,8483920,Pierrick Dube,R,WSH,23,0,0,0,0
72,8480851,Akil Thomas,C,LAK,24,0,0,0,0
72,8475235,Nicolas Deslauriers,L,PHI,33,0,0,0,0
72,8482476,Emil Heineman,L,MTL,23,0,0,0,0
72,8477149,Scott Sabourin,R,SJS,32,0,0,0,0
72,8483549,Lucas Condotta,L,MTL,27,0,0,0,0
72,8482765,Isak Rosen,R,BUF,21,0,0,0,0
72,8481237,Kyle MacLean,C,NYI,25,0,0,0,0
72,8481024,Linus Karlsson,C,VAN,25,0,0,0,0
72,8481690,Tyler Angle,C,,24,0,0,0,0
72,8483570,Ben Meyers,C,SEA,26,0,0,0,0
72,8481655,Cole Schwindt,R,CGY,23,0,0,0,0
72,8481462,Mason Morelli,L,VGK,28,0,0,0,0
72,8483401,Marc Johnstone,R,PIT,28,0,0,0,0
72,8478956,Samuel Laberge,L,NJD,27,0,0,0,0
72,8479533,Joona Koppanen,L,,26,0,0,0,0
72,8482197,Adam Raska,R,MIN,23,0,0,0,0
72,8482250,Callahan Burke,C,VGK,27,0,0,0,0
72,8482784,Zach Dean,C,STL,21,0,0,0,0
72,8484255,Jason Polin,R,COL,25,0,0,0,0
72,8481077,John Leonard,L,,26,0,0,0,0
72,8481534,Raphael Lavoie,C,EDM,24,0,0,0,0
72,8483609,Adam Klapka,R,CGY,24,0,0,0,0
72,8482751,Ryan Winterton,C,SEA,21,0,0,0,0
72,8480267,Sammy Walker,C,MIN,25,0,0,0,0
72,8475766,Austin Watson,L,,32,0,0,0,0
72,8482460,Matt Rempe,C,NYR,22,0,0,0,0
72,8481065,Angus Crookshank,L,OTT,25,0,0,0,0
72,8481070,Hugh McGing,L,,26,0,0,0,0
72,8476323,Max McCormick,L,SEA,32,0,0,0,0
72,8483395,Arshdeep Bains,L,VAN,23,0,0,0,0
72,8484259,Ondrej Pavel,C,COL,31,0,0,0,0
72,8483432,Luca Del Bel Belluz,C,CBJ,31,0,0,0,0
72,8483045,Cameron Butler,R,CBJ,31,0,0,0,0
72,8482061,Brandon Biro,L,SEA,26,0,0,0,0
72,8477401,John Hayden,C,SEA,29,0,0,0,0
72,8475278,Byron Froese,C,,33,0,0,0,0
72,8478446,Glenn Gawdin,C,LAK,27,0,0,0,0
72,8477993,Justin Kirkland,C,CGY,28,0,0,0,0
72,8482147,Jean-Luc Foudy,C,COL,22,0,0,0,0
72,8480032,Shane Bowers,C,NJD,25,0,0,0,0
72,8479330,Brandon Gignac,C,MTL,27,0,0,0,0
72,8480776,Sheldon Rempal,R,,29,0,0,0,0
72,8475413,Justin Dowling,C,NJD,34,0,0,0,0
72,8481726,Adam Edstrom,C,NYR,24,0,0,0,0
72,8480844,Grigori Denisenko,L,VGK,24,0,0,0,0
72,8478147,Bokondji Imama,L,PIT,28,0,0,0,0
72,8478881,Brett Seney,L,CHI,28,0,0,0,0
72,8483630,Pavol Regenda,L,ANA,25,0,0,0,0
72,8480836,Jonathan Gruden,C,,24,0,0,0,0
72,8484314,Jiri Smejkal,L,,28,0,0,0,0
72,8475780,Chris Wagner,R,COL,33,0,0,0,0
72,8479546,Oskar Steen,C,,26,0,0,0,0
72,8483597,Milos Kelemen,L,UTA,25,0,0,0,0
72,8481789,Tye Kartye,L,SEA,23,0,0,0,0
72,8484325,Waltteri Merela,C,TBL,26,0,0,0,0
72,8479421,Jacob Moverare,D,LAK,26,0,0,0,0
72,8481585,Egor Afanasyev,L,SJS,23,0,0,0,0
72,8479547,Matthew Phillips,R,,26,0,0,0,0
72,8479367,William Lockwood,R,FLA,26,0,0,0,0
72,8476915,Jujhar Khaira,L,,30,0,0,0,0
72,8481422,Jacob Lucchini,C,NSH,29,0,0,0,0
72,8480468,James Hamblin,L,EDM,25,0,0,0,0
72,8478051,Max Willman,C,NJD,29,0,0,0,0
72,8481556,John Beecher,C,BOS,23,0,0,0,0
72,8478078,Rourke Chartier,C,,28,0,0,0,0
73,8478402,Connor McDavid,C,EDM,27,82,49,97,146
73,8477492,Nathan MacKinnon,C,COL,29,82,65,77,142
73,8478864,Kirill Kaprizov,L,MIN,27,82,56,64,120
73,8476453,Nikita Kucherov,R,TBL,31,82,39,80,119
73,8477934,Leon Draisaitl,C,EDM,29,82,35,84,119
73,8477956,David Pastrnak,R,BOS,28,82,57,56,113
73,8481559,Jack Hughes,C,NJD,23,82,43,66,109
73,8480012,Elias Pettersson,C,VAN,26,82,43,66,109
73,8478420,Mikko Rantanen,R,COL,28,82,43,65,108
73,8478445,Mathew Barzal,C,NYI,27,82,31,75,106
73,8478550,Artemi Panarin,L,NYR,33,82,38,67,105
73,8477493,Aleksander Barkov,C,FLA,29,82,29,76,105
73,8479314,Matthew Tkachuk,L,FLA,27,82,28,77,105
73,8477939,William Nylander,R,TOR,28,82,46,56,102
73,8479318,Auston Matthews,C,TOR,27,82,52,49,101
73,8477946,Dylan Larkin,C,DET,28,82,41,60,101
73,8474564,Steven Stamkos,C,NSH,34,82,39,61,100
73,8471675,Sidney Crosby,C,PIT,37,82,50,48,98
73,8480801,Brady Tkachuk,L,OTT,25,82,48,49,97
73,8477404,Jake Guentzel,C,TBL,30,82,41,54,95
73,8476887,Filip Forsberg,L,NSH,30,82,45,49,94
73,8479343,Clayton Keller,R,UTA,26,82,41,53,94
73,8478398,Kyle Connor,L,WPG,28,82,37,56,93
73,8476459,Mika Zibanejad,C,NYR,31,82,31,62,93
73,8477933,Sam Reinhart,C,FLA,29,82,46,46,92
73,8479420,Tage Thompson,C,BUF,27,82,42,49,91
73,8482116,Tim Stützle,C,OTT,22,82,30,61,91
73,8481523,Kirby Dach,C,MTL,23,82,13,78,91
73,8475810,Bryan Rust,R,PIT,32,82,44,45,89
73,8478427,Sebastian Aho,C,CAR,27,82,39,50,89
73,8480069,Cale Makar,D,COL,26,82,16,73,89
73,8479385,Jordan Kyrou,C,STL,26,82,43,45,88
73,8475166,John Tavares,C,TOR,34,82,38,50,88
73,8481557,Matt Boldy,L,MIN,23,82,35,53,88
73,8475692,Mats Zuccarello,R,MIN,37,82,22,66,88
73,8473419,Brad Marchand,L,BOS,36,82,33,52,85
73,8475913,Mark Stone,R,VGK,32,82,25,60,85
73,8476853,Morgan Rielly,D,TOR,30,82,20,65,85
73,8479407,Jesper Bratt,L,NJD,26,82,24,60,84
73,8478403,Jack Eichel,C,VGK,28,82,41,42,83
73,8479323,Adam Fox,D,NYR,26,82,15,68,83
73,8480002,Nico Hischier,C,NJD,25,82,30,52,82
73,8474600,Roman Josi,D,NSH,34,82,28,54,82
73,8476456,Jonathan Huberdeau,C,CGY,31,82,25,57,82
73,8478444,Brock Boeser,R,VAN,27,82,38,43,81
73,8476460,Mark Scheifele,C,WPG,31,82,33,48,81
73,8476468,J.T. Miller,C,VAN,31,82,31,50,81
73,8480027,Jason Robertson,L,DAL,25,82,32,48,80
73,8477409,Carter Verhaeghe,C,FLA,29,82,38,41,79
73,8477951,Nick Schmaltz,C,UTA,28,82,33,46,79
73,8480023,Robert Thomas,C,STL,25,82,32,47,79
73,8480800,Quinn Hughes,D,VAN,25,82,14,65,79
73,8476389,Vincent Trocheck,C,NYR,31,82,39,39,78
73,8477942,Kevin Fiala,L,LAK,28,82,30,48,78
73,8480839,Rasmus Dahlin,D,BUF,24,82,21,57,78
73,8476346,Johnny Gaudreau,L,CBJ,31,82,20,58,78
73,8475786,Zach Hyman,L,EDM,32,82,40,37,77
73,8475168,Matt Duchene,C,DAL,33,82,30,47,77
73,8480036,Miro Heiskanen,D,DAL,25,82,13,64,77
73,8478414,Timo Meier,R,NJD,28,82,39,37,76
73,8478439,Travis Konecny,R,PHI,27,82,35,41,76
73,8480208,Drake Batherson,R,OTT,26,82,30,46,76
73,8471215,Evgeni Malkin,C,PIT,38,82,26,50,76
73,8474141,Patrick Kane,R,DET,36,82,26,50,76
73,8476539,Jonathan Marchessault,R,NSH,34,82,37,38,75
73,8479542,Brandon Hagel,L,TBL,26,82,28,47,75
73,8482665,Matty Beniers,C,SEA,22,82,31,43,74
73,8480018,Nick Suzuki,C,MTL,25,82,25,49,74
73,8482093,Seth Jarvis,C,CAR,22,82,31,42,73
73,8477949,Alex Tuch,R,BUF,28,82,26,47,73
73,8478460,Zach Werenski,D,CBJ,27,82,18,53,71
73,8474578,Erik Karlsson,D,PIT,34,82,10,61,71
73,8478010,Brayden Point,C,TBL,28,82,38,32,70
73,8482078,Lucas Raymond,L,DET,22,82,28,42,70
73,8477940,Nikolaj Ehlers,L,WPG,28,82,23,47,70
73,8478493,Joel Eriksson Ek,C,MIN,27,82,37,32,69
73,8482097,Jack Quinn,R,BUF,23,82,29,40,69
73,8475172,Nazem Kadri,C,CGY,34,82,27,42,69
73,8476454,Ryan Nugent-Hopkins,C,EDM,31,82,16,53,69
73,8480830,Andrei Svechnikov,R,CAR,24,82,29,39,68
73,8473512,Claude Giroux,R,OTT,36,82,24,44,68
73,8477503,Max Domi,C,TOR,29,82,11,57,68
73,8478449,Roope Hintz,C,DAL,28,82,29,38,67
73,8475184,Chris Kreider,L,NYR,33,82,43,23,66
73,8475158,Ryan O'Reilly,C,NSH,33,82,26,40,66
73,8481533,Trevor Zegras,C,ANA,23,82,21,45,66
73,8477504,Josh Morrissey,D,WPG,29,82,14,52,66
73,8481540,Cole Caufield,R,MTL,23,82,37,28,65
73,8477935,Sam Bennett,C,FLA,28,82,35,30,65
73,8481618,Alex Newhook,C,MTL,23,82,31,34,65
73,8477955,Jared McCann,L,SEA,28,82,25,40,65
73,8478038,Devon Toews,D,COL,30,82,11,54,65
73,8477476,Artturi Lehkonen,L,COL,29,82,34,30,64
73,8477960,Adrian Kempe,R,LAK,28,82,32,32,64
73,8479337,Alex DeBrincat,R,DET,27,82,28,36,64
73,8478042,Viktor Arvidsson,R,EDM,31,82,26,38,64
73,8477494,Jonathan Drouin,L,COL,29,82,19,45,64
73,8480014,Gabriel Vilardi,C,WPG,25,82,38,25,63
73,8480064,Josh Norris,C,OTT,25,82,30,33,63
73,8477496,Elias Lindholm,C,BOS,30,82,22,41,63
73,8473994,Jamie Benn,L,DAL,35,82,20,43,63
73,8477416,Oliver Bjorkstrand,R,SEA,29,82,20,43,63
73,8475167,Victor Hedman,D,TBL,34,82,12,51,63
73,8471724,Kris Letang,D,PIT,37,82,10,53,63
73,8480015,Owen Tippett,R,PHI,25,82,28,34,62
73,8476881,Tomas Hertl,C,VGK,31,82,27,35,62
73,8476399,Blake Coleman,C,CGY,33,82,26,36,62
73,8478440,Dylan Strome,C,WSH,27,82,18,44,62
73,8477497,Sean Monahan,C,CBJ,30,82,30,31,61
73,8477501,Valeri Nichushkin,R,COL,29,82,25,36,61
73,8474679,Gustav Nyquist,C,NSH,35,82,21,40,61
73,8478401,Pavel Zacha,C,BOS,27,82,20,41,61
73,8478397,Rasmus Andersson,D,CGY,28,82,20,41,61
73,8478469,Thomas Chabot,D,OTT,27,82,10,51,61
73,8478047,Michael Bunting,L,PIT,29,82,28,32,60
73,8480798,Philipp Kurashev,C,CHI,25,82,28,32,60
73,8475754,Brock Nelson,C,NYI,33,82,25,35,60
73,8482113,Anton Lundell,C,FLA,23,82,23,37,60
73,8474641,Adam Henrique,C,EDM,34,82,23,37,60
73,8479410,Mikhail Sergachev,D,UTA,26,82,9,51,60
73,8475784,Jeff Skinner,C,EDM,32,82,34,25,59
73,8477500,Bo Horvat,C,NYI,29,82,33,26,59
73,8471214,Alex Ovechkin,L,WSH,39,82,30,29,59
73,8482149,Cole Perfetti,C,WPG,22,82,22,37,59
73,8476905,Chandler Stephenson,C,SEA,30,82,18,41,59
73,8475798,Mikael Granlund,C,SJS,32,82,10,49,59
73,8480865,Noah Dobson,D,NYI,24,82,6,53,59
73,8482124,Quinton Byfield,R,LAK,22,82,24,34,58
73,8478438,Tommy Novak,C,NSH,27,82,20,38,58
73,8478407,Vince Dunn,D,SEA,28,82,14,44,58
73,8474150,Mikael Backlund,C,CGY,35,82,27,30,57
73,8477407,Anthony Duclair,L,NYI,29,82,24,33,57
73,8478856,Conor Garland,R,VAN,28,82,22,35,57
73,8479425,Filip Hronek,D,VAN,27,82,18,39,57
73,8479999,Casey Mittelstadt,C,COL,26,82,16,41,57
73,8478366,Frank Vatrano,R,ANA,30,82,36,20,56
73,8476483,Rickard Rakell,R,PIT,31,82,32,24,56
73,8482159,Tyson Foerster,R,PHI,22,82,32,24,56
73,8475169,Evander Kane,L,EDM,33,82,32,24,56
73,8475794,Tyler Seguin,C,DAL,32,82,24,32,56
73,8475745,Charlie Coyle,C,BOS,32,82,23,33,56
73,8481068,Yegor Sharangovich,C,CGY,26,82,28,27,55
73,8477511,Anthony Mantha,R,CGY,30,82,24,31,55
73,8476882,Teuvo Teravainen,L,CHI,30,82,23,32,55
73,8478458,Jack Roslovic,C,CAR,27,82,17,38,55
73,8470613,Brent Burns,D,CAR,39,82,17,38,55
73,8482105,Jake Sanderson,D,OTT,22,82,14,41,55
73,8477479,Tyler Bertuzzi,L,CHI,29,82,26,28,54
73,8477402,Pavel Buchnevich,L,STL,29,82,21,32,53
73,8478873,Troy Terry,R,ANA,27,82,21,32,53
73,8478975,Mason Marchment,L,DAL,29,82,20,33,53
73,8479345,Jakob Chychrun,D,WSH,26,82,17,36,53
73,8482671,Owen Power,D,BUF,22,82,15,38,53
73,8474590,John Carlson,D,WSH,34,82,13,40,53
73,8478396,Noah Hanifin,D,VGK,27,82,11,42,53
73,8474565,Alex Pietrangelo,D,VGK,34,82,10,43,53
73,8480028,Morgan Frost,C,PHI,25,82,22,30,52
73,8474586,Jordan Eberle,R,SEA,34,82,21,31,52
73,8479987,Morgan Geekie,C,BOS,26,82,21,31,52
73,8476462,Dougie Hamilton,D,NJD,31,82,21,31,52
73,8473986,Alex Killorn,L,ANA,35,82,21,31,52
73,8480803,Evan Bouchard,D,EDM,25,82,19,33,52
73,8471685,Anze Kopitar,C,LAK,37,82,11,41,52
73,8479992,Michael Rasmussen,C,DET,25,82,24,27,51
73,8482699,Dylan Guenther,R,UTA,21,82,22,29,51
73,8476906,Shayne Gostisbehere,D,CAR,31,82,13,38,51
73,8479325,Charlie McAvoy,D,BOS,27,82,11,40,51
73,8481542,Moritz Seider,D,DET,23,82,9,42,51
73,8475314,Anders Lee,L,NYI,34,82,29,21,50
73,8476448,William Karlsson,C,VGK,31,82,24,26,50
73,8479339,Patrik Laine,L,CBJ,26,82,24,26,50
73,8479675,Trevor Moore,L,LAK,29,82,23,27,50
73,8475191,Reilly Smith,R,NYR,33,82,21,29,50
73,8477964,Ivan Barbashev,C,VGK,29,82,20,30,50
73,8475765,Vladimir Tarasenko,R,DET,33,82,17,33,50
73,8480039,Martin Necas,C,CAR,25,82,16,34,50
73,8481711,Matias Maccelli,L,UTA,24,82,13,37,50
73,8477447,Shea Theodore,D,VGK,29,82,10,40,50
73,8482740,Wyatt Johnston,C,DAL,21,82,26,23,49
73,8482745,Mason McTavish,C,ANA,21,82,25,24,49
73,8475287,Erik Haula,L,NJD,33,82,20,29,49
73,8475799,Nino Niederreiter,R,WPG,32,82,28,20,48
73,8476432,Boone Jenner,C,CBJ,31,82,23,25,48
73,8475791,Taylor Hall,L,CHI,33,82,22,26,48
73,8477986,Brandon Montour,D,SEA,30,82,18,30,48
73,8480459,Pius Suter,C,VAN,28,82,16,32,48
73,8475151,Kyle Palmieri,C,NYI,33,82,25,22,47
73,8482109,Alexis Lafrenière,L,NYR,23,82,24,23,47
73,8475726,Tyler Toffoli,C,SJS,32,82,23,24,47
73,8481528,Dylan Cozens,C,BUF,23,82,20,27,47
73,8477451,Ryan Hartman,R,MIN,30,82,19,28,47
73,8482660,Kent Johnson,C,CBJ,22,82,19,28,47
73,8477495,Seth Jones,D,CHI,30,82,11,36,47
73,8481560,Arthur Kaliyev,R,LAK,23,82,23,23,46
73,8480185,Eetu Luostarinen,C,FLA,26,82,20,26,46
73,8478462,Nicolas Roy,C,VGK,27,82,19,27,46
73,8477456,J.T. Compher,L,DET,29,82,19,27,46
73,8474053,Logan Couture,C,SJS,35,82,17,29,46
73,8482684,Luke Hughes,D,NJD,21,82,14,32,46
73,8475193,Tomas Tatar,L,NJD,34,82,14,32,46
73,8476960,Andreas Athanasiou,C,CHI,30,82,13,33,46
73,8478498,Jake DeBrusk,L,VAN,28,82,25,20,45
73,8471698,T.J. Oshie,R,WSH,38,82,24,21,45
73,8480893,Kirill Marchenko,R,CBJ,24,82,24,21,45
73,8475218,Mattias Ekholm,D,EDM,34,82,21,24,45
73,8475768,Jaden Schwartz,C,SEA,32,82,19,26,45
73,8480797,Joel Farabee,L,PHI,24,82,18,27,45
73,8477429,Andrew Copp,C,DET,30,82,17,28,45
73,8475170,Brayden Schenn,C,STL,33,82,17,28,45
73,8479996,Cody Glass,C,NSH,25,82,17,28,45
73,8478046,Danton Heinen,L,VAN,29,82,17,28,45
73,8477346,MacKenzie Weegar,D,CGY,30,82,9,36,45
73,8478474,Lawson Crouse,L,UTA,27,82,27,17,44
73,8482175,JJ Peterka,R,BUF,22,82,25,19,44
73,8474102,David Perron,L,OTT,36,82,23,21,44
73,8475760,Nick Bjugstad,C,UTA,32,82,22,22,44
73,8482720,Matthew Knies,L,TOR,22,82,20,24,44
73,8478519,Anthony Cirelli,C,TBL,27,82,19,25,44
73,8480113,Alex Iafallo,L,WPG,31,82,18,26,44
73,8478413,Jordan Greenway,L,BUF,27,82,18,26,44
73,8483808,Andrei Kuzmenko,L,CGY,28,82,18,26,44
73,8482133,Thomas Bordeleau,C,SJS,22,82,17,27,44
73,8480078,Filip Chytil,C,NYR,25,82,14,30,44
73,8476461,Sean Couturier,C,PHI,32,82,14,30,44
73,8476458,Ryan Strome,C,ANA,31,82,10,34,44
73,8476958,Jaccob Slavin,D,CAR,30,82,6,38,44
73,8476875,Mike Matheson,D,MTL,30,82,5,39,44
73,8482110,Dawson Mercer,C,NJD,23,82,24,19,43
73,8484144,Connor Bedard,C,CHI,19,82,23,20,43
73,8476826,Yanni Gourde,C,SEA,33,82,20,23,43
73,8476981,Josh Anderson,R,MTL,30,82,19,24,43
73,8476479,Phillip Danault,C,LAK,31,82,18,25,43
73,8477021,Alex Kerfoot,C,UTA,30,82,14,29,43
73,8474563,Drew Doughty,D,LAK,35,82,12,31,43
73,8476885,Jacob Trouba,D,NYR,30,82,8,35,43
73,8480434,Sean Durzi,D,UTA,26,82,7,36,43
73,8479525,Ross Colton,C,COL,28,82,23,19,42
73,8475793,Ryan Johansen,C,PHI,32,82,19,23,42
73,8475714,Calle Jarnkrok,C,TOR,33,82,18,24,42
73,8477498,Darnell Nurse,D,EDM,29,82,15,27,42
73,8481581,Thomas Harley,D,DAL,23,82,14,28,42
73,8481553,Bobby Brink,R,PHI,23,82,14,28,42
73,8479400,Pierre-Luc Dubois,L,WSH,26,82,15,26,41
73,8475200,Dmitry Orlov,D,CAR,33,82,12,29,41
73,8477932,Aaron Ekblad,D,FLA,28,82,8,33,41
73,8478851,Alexandre Carrier,D,NSH,28,82,8,33,41
73,8478542,Evan Rodrigues,C,FLA,31,82,7,34,41
73,8481535,Nils Hoglander,L,VAN,24,82,23,17,40
73,8478109,Victor Olofsson,L,VGK,29,82,21,19,40
73,8480188,Fabian Zetterlund,L,SJS,25,82,20,20,40
73,8473422,Nick Foligno,L,CHI,37,82,17,23,40
73,8481596,Shane Pinto,C,OTT,24,82,16,24,40
73,8476392,Adam Lowry,C,WPG,31,82,16,24,40
73,8480220,Noah Cates,L,PHI,25,82,14,26,40
73,8477948,Travis Sanheim,D,PHI,28,82,11,29,40
73,8480817,K'Andre Miller,D,NYR,24,82,9,31,40
73,8475764,Cam Fowler,D,ANA,33,82,5,35,40
73,8478911,Matt Roy,D,WSH,29,82,5,35,40
73,8480009,Eeli Tolvanen,R,SEA,25,82,22,17,39
73,8473563,Nicklas Backstrom,C,WSH,37,82,17,22,39
73,8480829,Jesperi Kotkaniemi,C,CAR,24,82,16,23,39
73,8480802,Ryan McLeod,C,BUF,25,82,16,23,39
73,8478891,Mason Appleton,C,WPG,28,82,15,24,39
73,8476480,Vladislav Namestnikov,C,WPG,32,82,15,24,39
73,8476292,Ondrej Palat,L,NJD,33,82,15,24,39
73,8481522,Peyton Krebs,C,BUF,23,82,15,24,39
73,8475171,Oliver Ekman-Larsson,D,TOR,33,82,13,26,39
73,8477444,Andre Burakovsky,L,SEA,29,82,11,28,39
73,8481546,Cam York,D,PHI,23,82,7,32,39
73,8480748,Kiefer Sherwood,L,VAN,29,82,19,19,38
73,8477998,Warren Foegele,L,LAK,28,82,19,19,38
73,8475848,Brendan Gallagher,R,MTL,32,82,18,20,38
73,8481624,Ilya Mikheyev,R,CHI,30,82,16,22,38
73,8480871,Adam Boqvist,D,FLA,24,82,15,23,38
73,8476792,Torey Krug,D,STL,33,82,9,29,38
73,8475753,Justin Faulk,D,STL,32,82,7,31,38
73,8482125,Alexander Holtz,R,VGK,22,82,21,16,37
73,8477952,Robby Fabbri,C,ANA,28,82,21,16,37
73,8482092,Ridly Greig,C,OTT,22,82,20,17,37
73,8478115,Pierre Engvall,L,NYI,28,82,19,18,37
73,8477947,Sonny Milano,L,WSH,28,82,19,18,37
73,8478233,Andrew Mangiapane,L,WSH,28,82,17,20,37
73,8482079,Marco Rossi,C,MIN,23,82,17,20,37
73,8478055,Gustav Forsling,D,FLA,28,82,14,23,37
73,8476329,Travis Boyd,C,MIN,31,82,14,23,37
73,8476925,Colton Sissons,C,NSH,31,82,12,25,37
73,8476869,Brady Skjei,D,NSH,30,82,8,29,37
73,8476854,Hampus Lindholm,D,BOS,30,82,6,31,37
73,8482089,Jake Neighbours,L,STL,22,82,24,12,36
73,8481554,Kaapo Kakko,R,NYR,23,82,21,15,36
73,8476438,Brandon Saad,L,STL,32,82,20,16,36
73,8476474,Stefan Noesen,R,NJD,31,82,20,16,36
73,8481601,Simon Holmstrom,R,NYI,23,82,19,17,36
73,8478463,Anthony Beauvillier,L,PIT,27,82,17,19,36
73,8475722,Jason Zucker,L,BUF,32,82,16,20,36
73,8481704,Juuso Parssinen,C,NSH,23,82,16,20,36
73,8476419,Jean-Gabriel Pageau,C,NYI,32,82,15,21,36
73,8482624,Daniil Miromanov,D,CGY,27,82,10,26,36
73,8481606,Jordan Spence,D,LAK,23,82,9,27,36
73,8479398,Samuel Girard,D,COL,26,82,7,29,36
73,8476331,Dylan DeMelo,D,WPG,31,82,5,31,36
73,8479393,Noah Gregor,C,OTT,26,82,23,12,35
73,8481580,Connor McMichael,C,WSH,23,82,18,17,35
73,8476469,Joel Armia,R,MTL,31,82,18,17,35
73,8480835,Jack Drury,C,CAR,24,82,17,18,35
73,8475149,Marcus Johansson,L,MIN,34,82,14,21,35
73,8480336,Sean Walker,D,CAR,30,82,11,24,35
73,8475763,Kevin Hayes,R,PIT,32,82,10,25,35
73,8476872,Scott Laughton,C,PHI,30,82,9,26,35
73,8477426,Nicholas Paul,L,TBL,29,82,20,14,34
73,8480849,Barrett Hayton,C,UTA,24,82,20,14,34
73,8479293,Brandon Tanev,L,SEA,33,82,20,14,34
73,8479941,Justin Danforth,R,CBJ,31,82,19,15,34
73,8474149,Evgenii Dadonov,R,DAL,35,82,18,16,34
73,8476873,Mark Jankowski,C,NSH,30,82,17,17,34
73,8479353,Brett Howden,C,VGK,26,82,16,18,34
73,8484145,Zach Benson,L,BUF,19,82,16,18,34
73,8476312,Josh Manson,D,COL,33,82,15,19,34
73,8482475,Yegor Chinakhov,R,CBJ,23,82,14,20,34
73,8479365,Trent Frederic,C,BOS,26,82,11,23,34
73,8482667,William Eklund,L,SJS,22,82,11,23,34
73,8478472,Mathieu Joseph,R,STL,27,82,11,23,34
73,8476927,Teddy Blueger,C,VAN,30,82,11,23,34
73,8477499,Rasmus Ristolainen,D,PHI,30,82,11,23,34
73,8477969,Marcus Pettersson,D,PIT,28,82,6,28,34
73,8477425,Miles Wood,L,COL,29,82,14,19,33
73,8481582,Nicholas Robertson,L,TOR,23,82,13,20,33
73,8478057,Dakota Joshua,C,VAN,28,82,12,21,33
73,8477953,Kasperi Kapanen,R,STL,28,82,12,21,33
73,8482074,Connor Zary,C,CGY,23,82,11,22,33
73,8482087,Kaiden Guhle,D,MTL,22,82,8,25,33
73,8480145,Neal Pionk,D,WPG,29,82,6,27,33
73,8473533,Jordan Staal,C,CAR,36,82,19,13,32
73,8476278,Colin Blackwell,C,DAL,31,82,18,14,32
73,8482146,Luke Evangelista,R,NSH,22,82,15,17,32
73,8482111,Justin Barron,D,MTL,23,82,14,18,32
73,8476921,Jordan Martinook,L,CAR,32,82,13,19,32
73,8480873,Rasmus Sandin,D,WSH,24,82,8,24,32
73,8477015,Connor Brown,R,EDM,30,82,7,25,32
73,8475181,Nick Leddy,D,STL,33,82,4,28,32
73,8482055,Drew O'Connor,L,PIT,26,82,18,13,31
73,8478020,Michael Amadio,C,OTT,28,82,16,15,31
73,8474189,Lars Eller,C,PIT,35,82,13,18,31
73,8481656,Aliaksei Protas,C,WSH,23,82,10,21,31
73,8482062,Cole Smith,L,NSH,29,82,10,21,31
73,8476374,Sean Kuraly,C,CBJ,31,82,10,21,31
73,8476902,Esa Lindell,D,DAL,30,82,5,26,31
73,8478507,John Marino,D,UTA,27,82,5,26,31
73,8482245,Artem Zub,D,OTT,29,82,4,27,31
73,8484166,Adam Fantilli,C,CBJ,20,82,15,15,30
73,8480995,Pontus Holmberg,R,TOR,25,82,15,15,30
73,8475220,Marcus Foligno,L,MIN,33,82,14,16,30
73,8482259,Bobby McMann,C,TOR,28,82,14,16,30
73,8478133,Jake Evans,C,MTL,28,82,13,17,30
73,8477987,Ryan Donato,C,CHI,28,82,10,20,30
73,8477839,Conor Sheary,L,TBL,32,82,10,20,30
73,8476467,Jamie Oleksiak,D,SEA,32,82,10,20,30
73,8477488,Brett Pesce,D,NJD,30,82,5,25,30
73,8478882,Vladislav Gavrikov,D,LAK,29,82,4,26,30
73,8481604,Pavel Dorofeyev,L,VGK,24,82,16,13,29
73,8480806,Isac Lundestrom,C,ANA,25,82,15,14,29
73,8482117,Lukas Reichel,L,CHI,22,82,14,15,29
73,8477989,Christian Dvorak,C,MTL,28,82,14,15,29
73,8480144,David Kampf,C,TOR,29,82,13,16,29
73,8479661,Tanner Jeannot,L,LAK,27,82,11,18,29
73,8476923,Damon Severson,D,CBJ,30,82,9,20,29
73,8479983,Mario Ferraro,D,SJS,26,82,9,20,29
73,8482655,J.J. Moser,D,TBL,24,82,8,21,29
73,8476429,Scott Mayfield,D,NYI,32,82,8,21,29
73,8481481,Blake Lizotte,C,PIT,27,82,8,21,29
73,8480043,Timothy Liljegren,D,TOR,25,82,1,28,29
73,8482712,Oskar Olausson,R,COL,22,82,17,11,28
73,8483431,Logan Cooley,C,UTA,20,82,14,14,28
73,8481032,Paul Cotter,C,NJD,25,82,14,14,28
73,8482705,Cole Sillinger,C,CBJ,21,82,12,16,28
73,8483515,Juraj Slafkovsky,L,MTL,20,82,12,16,28
73,8475855,Jesper Fast,R,CAR,33,82,11,17,28
73,8478211,Dryden Hunt,L,CGY,29,82,10,18,28
73,8479359,Beck Malenstyn,L,BUF,26,82,9,19,28
73,8476979,Erik Gustafsson,D,DET,32,82,9,19,28
73,8480878,Nils Lundkvist,D,DAL,24,82,6,22,28
73,8476525,Colin Miller,D,WPG,32,82,6,22,28
73,8475279,Ben Chiarot,D,DET,33,82,5,23,28
73,8478136,Jake Middleton,D,MIN,28,82,3,25,28
73,8479316,Luke Kunin,C,SJS,27,82,15,12,27
73,8479591,Michael Eyssimont,C,TBL,28,82,15,12,27
73,8476880,Tom Wilson,R,WSH,30,82,14,13,27
73,8479390,Taylor Raddysh,R,WSH,26,82,12,15,27
73,8479368,Max Jones,L,BOS,26,82,12,15,27
73,8474715,Cam Atkinson,R,TBL,35,82,11,16,27
73,8473507,Jeff Petry,D,DET,37,82,7,20,27
73,8479371,Dante Fabbro,D,NSH,26,82,5,22,27
73,8474574,Tyler Myers,D,VAN,34,82,5,22,27
73,8480049,Dylan Samberg,D,WPG,25,82,5,22,27
73,8477506,Ryan Pulock,D,NYI,30,82,4,23,27
73,8474151,Ryan McDonagh,D,TBL,35,82,4,23,27
73,8480813,Joe Veleno,C,DET,24,82,13,13,26
73,8481477,Nico Sturm,C,SJS,29,82,13,13,26
73,8481093,Rafael Harvey-Pinard,L,MTL,25,82,13,13,26
73,8481186,Logan O'Connor,R,COL,28,82,11,15,26
73,8480980,Connor Dewar,C,TOR,25,82,11,15,26
73,8480789,Oliver Wahlstrom,R,NYI,24,82,10,16,26
73,8476889,Radek Faksa,C,STL,30,82,10,16,26
73,8476422,Mike Reilly,D,NYI,31,82,9,17,26
73,8477507,Nikita Zadorov,D,BOS,29,82,7,19,26
73,8476917,Adam Pelech,D,NYI,30,82,4,22,26
73,8478500,Ivan Provorov,D,CBJ,27,82,4,22,26
73,8475188,Brayden McNabb,D,VGK,33,82,4,22,26
73,8480860,Kevin Bahl,D,CGY,24,82,4,22,26
73,8475177,Calvin de Haan,D,COL,33,82,4,22,26
73,8482077,Dylan Holloway,L,EDM,23,82,16,9,25
73,8482155,Alex Laferriere,R,LAK,23,82,14,11,25
73,8480448,Parker Kelly,L,COL,25,82,12,13,25
73,8477919,Frederick Gaudreau,C,MIN,31,82,11,14,25
73,8478569,Noel Acciari,C,PIT,33,82,11,14,25
73,8479414,Nathan Bastian,R,NJD,27,82,11,14,25
73,8476442,Matt Nieto,L,PIT,32,82,11,14,25
73,8480855,Jack McBain,C,UTA,24,82,10,15,25
73,8475343,Nic Dowd,C,WSH,34,82,9,16,25
73,8470621,Corey Perry,R,EDM,39,82,8,17,25
73,8480807,Mattias Samuelsson,D,BUF,24,82,8,17,25
73,8476457,Adam Larsson,D,SEA,32,82,7,18,25
73,8477365,Connor Clifton,D,BUF,29,82,7,18,25
73,8475690,Chris Tanev,D,TOR,35,82,5,20,25
73,8479369,Andrew Peeke,D,BOS,26,82,5,20,25
73,8481568,Alex Vlasic,D,CHI,23,82,3,22,25
73,8475324,Nick Jensen,D,OTT,34,82,2,23,25
73,8477903,Garnet Hathaway,R,PHI,33,82,14,10,24
73,8481028,Martin Pospisil,C,CGY,25,82,14,10,24
73,8480068,Ryan Poehling,C,PHI,25,82,12,12,24
73,8477450,Jason Dickinson,C,CHI,29,82,12,12,24
73,8483457,Lane Hutson,D,MTL,20,82,11,13,24
73,8475842,Sam Carrick,C,NYR,32,82,11,13,24
73,8478013,Jake Walman,D,SJS,28,82,8,16,24
73,8482073,Braden Schneider,D,NYR,23,82,6,18,24
73,8480222,Sebastian Aho,D,PIT,28,82,5,19,24
73,8476879,Cody Ceci,D,EDM,31,82,4,20,24
73,8476463,Jonas Brodin,D,MIN,31,82,3,21,24
73,8481178,Egor Zamula,D,PHI,24,82,1,23,24
73,8474673,TJ Brodie,D,CHI,34,82,1,23,24
73,8475462,Radko Gudas,D,ANA,34,82,1,23,24
73,8481013,Jonatan Berggren,R,DET,24,82,11,12,23
73,8482166,Shakir Mukhamadullin,D,SJS,22,82,11,12,23
73,8482858,Ryker Evans,D,SEA,23,82,11,12,23
73,8476918,Jimmy Vesey,L,NYR,31,82,10,13,23
73,8482733,Logan Mailloux,D,MTL,31,82,8,15,23
73,8482122,Brock Faber,D,MIN,22,82,7,16,23
73,8476892,Colton Parayko,D,STL,31,82,6,17,23
73,8483468,Jiri Kulich,C,BUF,20,82,4,19,23
73,8476931,Jake McCabe,D,TOR,31,82,3,20,23
73,8476891,Matt Grzelcyk,D,PIT,30,82,1,22,23
73,8476897,Oskar Sundqvist,C,STL,30,82,11,11,22
73,8482809,Jackson Blake,R,CAR,21,82,10,12,22
73,8483505,Matthew Poitras,C,BOS,20,82,9,13,22
73,8482749,Joshua Roy,R,MTL,21,82,9,13,22
73,8482803,Olen Zellweger,D,ANA,21,82,5,17,22
73,8479402,Jake Bean,D,CGY,26,82,4,18,22
73,8478399,Jonas Siegenthaler,D,NJD,27,82,4,18,22
73,8480035,Henri Jokiharju,D,BUF,25,82,3,19,22
73,8474567,Zach Bogosian,D,MIN,34,82,3,19,22
73,8482142,Jamie Drysdale,D,PHI,22,82,2,20,22
73,8475455,Brenden Dillon,D,NJD,34,82,2,20,22
73,8483565,Nick Blankenburg,D,NSH,26,82,2,20,22
73,8478508,Yakov Trenin,C,MIN,27,82,11,10,21
73,8482145,Mavrik Bourque,C,DAL,22,82,11,10,21
73,8484203,Bradly Nadeau,L,CAR,19,82,10,11,21
73,8483524,Shane Wright,C,SEA,20,82,9,12,21
73,8482101,Danil Gushchin,L,SJS,22,82,8,13,21
73,8477392,Hudson Fasching,R,NYI,29,82,7,14,21
73,8477220,Nate Schmidt,D,FLA,33,82,6,15,21
73,8479291,Kevin Rooney,C,CGY,31,82,6,15,21
73,8478443,Brandon Carlo,D,BOS,28,82,6,15,21
73,8477435,Ryan Graves,D,PIT,29,82,5,16,21
73,8477369,Carson Soucy,D,VAN,30,82,5,16,21
73,8474716,Jared Spurgeon,D,MIN,35,82,3,18,21
73,8481708,Zac Jones,D,NYR,24,82,3,18,21
73,8477845,Trevor van Riemsdyk,D,WSH,33,82,3,18,21
73,8478434,Keegan Kolesar,R,VGK,27,82,2,19,21
73,8479998,Mikey Anderson,D,LAK,25,82,1,20,21
73,8476822,Luke Glendening,C,TBL,35,82,12,8,20
73,8477938,Haydn Fleury,D,WPG,28,82,9,11,20
73,8482141,Lukas Cormier,D,VGK,22,82,7,13,20
73,8484153,Leo Carlsson,C,ANA,20,82,6,14,20
73,8475718,Justin Holl,D,DET,32,82,6,14,20
73,8478416,Erik Cernak,D,TBL,27,82,5,15,20
73,8479980,Nicolas Hague,D,VGK,26,82,4,16,20
73,8480879,Jacob Bernard-Docker,D,OTT,24,82,4,16,20
73,8479324,Ryan Lindgren,D,NYR,26,82,3,17,20
73,8477406,Mattias Janmark,C,EDM,32,82,3,17,20
73,8481014,Alexander Romanov,D,NYI,24,82,1,19,20
73,8478840,Will Borgen,D,SEA,28,82,0,20,20
73,8482702,Logan Stankoven,C,DAL,21,82,11,8,19
73,8483763,Maksymilian Szuber,D,UTA,22,82,9,10,19
73,8473453,Trevor Lewis,C,LAK,37,82,8,11,19
73,8482470,Ilya Solovyov,D,CGY,24,82,7,12,19
73,8480074,Alexandre Texier,C,STL,25,82,5,14,19
73,8476624,Barclay Goodrow,C,SJS,31,82,5,14,19
73,8475790,Erik Gudbranson,D,CBJ,32,82,2,17,19
73,8476967,Brett Kulak,D,EDM,30,82,2,17,19
73,8480003,Jesper Boqvist,C,FLA,26,82,10,8,18
73,8475231,Casey Cizikas,C,NYI,33,82,10,8,18
73,8476878,Zemgus Girgensons,L,TBL,30,82,10,8,18
73,8480281,Alexey Toropchenko,R,STL,25,82,10,8,18
73,8483482,Tristan Luneau,D,ANA,20,82,9,9,18
73,8482659,Josh Doan,R,UTA,22,82,6,12,18
73,8480073,Erik Brannstrom,D,COL,25,82,6,12,18
73,8479351,Sam Steel,C,DAL,26,82,5,13,18
73,8474013,Ian Cole,D,UTA,35,82,4,14,18
73,8479638,Justin Brazeau,R,BOS,26,82,4,14,18
73,8478468,Jeremy Lauzon,D,NSH,27,82,4,14,18
73,8481567,Henry Thrun,D,SJS,23,82,4,14,18
73,8470600,Ryan Suter,D,STL,39,82,3,15,18
73,8480950,Ilya Lyubushkin,D,DAL,30,82,3,15,18
73,8482679,Matt Coronato,R,CGY,22,82,12,5,17
73,8476858,Phillip Di Giuseppe,L,VAN,31,82,12,5,17
73,8477931,Tomas Nosek,L,FLA,32,82,7,10,17
73,8483445,Cutter Gauthier,L,ANA,20,82,7,10,17
73,8477508,Curtis Lazar,C,NJD,29,82,4,13,17
73,8477034,Jaycob Megna,D,FLA,32,82,3,14,17
73,8483499,Liam Ohgren,L,MIN,20,82,10,6,16
73,8482762,Simon Edvinsson,D,DET,21,82,9,7,16
73,8481524,Bowen Byram,D,BUF,23,82,6,10,16
73,8483460,David Jiricek,D,CBJ,21,82,6,10,16
73,8482859,Zack Ostapchuk,C,OTT,21,82,5,11,16
73,8479576,Vincent Desharnais,D,VAN,28,82,5,11,16
73,8478859,Niko Mikkola,D,FLA,28,82,4,12,16
73,8484149,Gavin Brindley,C,CBJ,20,82,3,13,16
73,8475233,David Savard,D,MTL,34,82,2,14,16
73,8481605,Jackson LaCombe,D,ANA,23,82,2,14,16
73,8476473,Connor Murphy,D,CHI,31,82,2,14,16
73,8480025,MacKenzie Entwistle,R,FLA,25,82,8,7,15
73,8483490,Pavel Mintyukov,D,ANA,21,82,8,7,15
73,8483489,Fraser Minten,C,TOR,31,82,8,7,15
73,8483493,Frank Nazar,C,CHI,20,82,7,8,15
73,8477505,Alexander Wennberg,C,SJS,30,82,6,9,15
73,8477353,Tyler Motte,C,DET,29,82,5,10,15
73,8478450,Parker Wotherspoon,D,BOS,27,82,4,11,15
73,8482666,Scott Morrow,D,CAR,22,82,3,12,15
73,8480246,Nick Perbix,D,TBL,26,82,3,12,15
73,8479442,Troy Stecher,D,EDM,30,82,3,12,15
73,8479976,Juuso Valimaki,D,UTA,26,82,1,14,15
73,8483466,Kevin Korchinski,D,CHI,20,82,1,14,15
73,8480021,Jack Studnicka,C,LAK,25,82,7,7,14
73,8480870,Bo Groulx,C,NYR,24,82,7,7,14
73,8480796,Martin Fehervary,D,WSH,25,82,6,8,14
73,8481517,Brett Leason,R,ANA,25,82,5,9,14
73,8482807,Ethan Del Mastro,D,CHI,21,82,4,10,14
73,8482118,Sam Colangelo,R,ANA,23,82,3,11,14
73,8478432,Christian Fischer,R,DET,27,82,2,12,14
73,8476372,Nick Seeler,D,PHI,31,82,2,12,14
73,8474612,Travis Hamonic,D,OTT,34,82,1,13,14
73,8481641,Joel Kiviranta,L,COL,28,82,10,3,13
73,8483012,Logan Morrison,C,SEA,22,82,5,8,13
73,8480990,Declan Chisholm,D,MIN,24,82,3,10,13
73,8480834,Ty Emberson,D,SJS,24,82,3,10,13
73,8483397,Marc McLaughlin,C,BOS,25,82,10,2,12
73,8483567,Georgii Merkulov,C,BOS,24,82,6,6,12
73,8482787,Nikita Chibrikov,R,WPG,31,82,6,6,12
73,8484911,Collin Graf,R,SJS,22,82,5,7,12
73,8483495,Simon Nemec,D,NJD,20,82,4,8,12
73,8482713,Mackie Samoskevich,R,FLA,22,82,3,9,12
73,8477335,Kyle Burroughs,D,LAK,29,82,2,10,12
73,8474090,Brendan Smith,D,DAL,35,82,5,6,11
73,8476441,Joel Edmundson,D,LAK,31,82,4,7,11
73,8483471,Brad Lambert,C,WPG,31,82,3,8,11
73,8478178,Darren Raddysh,D,TBL,28,82,2,9,11
73,8471677,Jack Johnson,D,CBJ,37,82,2,8,10
73,8482070,Mitchell Chaffee,R,TBL,26,82,3,6,9
73,8475762,Derek Forbort,D,VAN,32,82,2,7,9
73,8481122,Simon Benoit,D,TOR,26,82,2,7,9
73,8478874,Adam Gaudette,C,OTT,28,82,0,9,9
73,8482516,Matthew Kessel,D,STL,24,82,0,8,8
73,8482153,Brendan Brisson,C,VGK,23,82,2,5,7
73,8474062,Riley Nash,C,NYR,35,82,1,6,7
73,8480172,Jan Rutta,D,SJS,34,82,3,3,6
73,8481699,Aku Raty,R,UTA,23,82,2,3,5
73,8470794,Joe Pavelski,C,,40,0,0,0,0
73,8481703,Valtteri Puustinen,R,PIT,25,0,0,0,0
73,8477950,Tony DeAngelo,D,,29,0,0,0,0
73,8481577,Philip Tomasino,C,NSH,23,0,0,0,0
73,8475197,Tyson Barrie,D,,33,0,0,0,0
73,8471218,Blake Wheeler,R,,38,0,0,0,0
73,8474157,Max Pacioretty,L,,36,0,0,0,0
73,8478466,Daniel Sprong,R,VAN,27,0,0,0,0
73,8475744,Evgeny Kuznetsov,C,,32,0,0,0,0
73,8481019,David Gustafsson,C,WPG,24,0,0,0,0
73,8475906,John Klingberg,D,,32,0,0,0,0
73,8479348,Kale Clague,D,BUF,26,0,0,0,0
73,8476952,Dominic Toninato,C,WPG,30,0,0,0,0
73,8473473,Milan Lucic,L,,36,0,0,0,0
73,8474037,James van Riemsdyk,L,,35,0,0,0,0
73,8474602,Justin Schultz,D,,34,0,0,0,0
73,8482222,Alexander Barabanov,L,,30,0,0,0,0
73,8479372,Josh Mahura,D,SEA,26,0,0,0,0
73,8479982,Conor Timmins,D,TOR,26,0,0,0,0
73,8474031,Kevin Shattenkirk,D,,35,0,0,0,0
73,8480008,Adam Ruzicka,C,,25,0,0,0,0
73,8481059,Scott Perunovich,D,STL,26,0,0,0,0
73,8480884,Calen Addison,D,,24,0,0,0,0
73,8476994,Vinnie Hinostroza,C,NSH,30,0,0,0,0
73,8478452,Caleb Jones,D,LAK,27,0,0,0,0
73,8480157,Calle Rosen,D,COL,30,0,0,0,0
73,8481609,Vladislav Kolyachonok,D,UTA,23,0,0,0,0
73,8479415,Michael McLeod,C,,26,0,0,0,0
73,8476919,Chris Tierney,C,,30,0,0,0,0
73,8479639,Dylan Coghlan,D,WPG,26,0,0,0,0
73,8478146,Matthew Highmore,C,OTT,28,0,0,0,0
73,8478970,Jalen Chatfield,D,CAR,28,0,0,0,0
73,8480205,Emil Bemstrom,C,PIT,25,0,0,0,0
73,8474884,Mike Hoffman,C,,35,0,0,0,0
73,8471274,Alex Goligoski,D,,39,0,0,0,0
73,8478104,Sammy Blais,L,,28,0,0,0,0
73,8474870,Tyler Johnson,C,,34,0,0,0,0
73,8476913,Devin Shore,C,MIN,30,0,0,0,0
73,8481598,Philip Broberg,D,EDM,23,0,0,0,0
73,8480058,Pierre-Olivier Joseph,D,STL,25,0,0,0,0
73,8480891,Michael Kesselring,D,UTA,24,0,0,0,0
73,8477979,Nicolas Aube-Kubel,R,BUF,28,0,0,0,0
73,8476871,Tanner Pearson,L,,32,0,0,0,0
73,8476393,Nick Cousins,C,,31,0,0,0,0
73,8479977,Kailer Yamamoto,R,,26,0,0,0,0
73,8479543,Michael Pezzetta,L,MTL,26,0,0,0,0
73,8477018,Ben Hutton,D,VGK,31,0,0,0,0
73,8480762,Eric Robinson,L,CAR,29,0,0,0,0
73,8474034,Pat Maroon,L,CHI,36,0,0,0,0
73,8481058,Jesse Ylönen,R,,25,0,0,0,0
73,8475179,Dmitry Kulikov,D,FLA,34,0,0,0,0
73,8481527,Kaedan Korczak,D,VGK,23,0,0,0,0
73,8473449,Kyle Okposo,R,,36,0,0,0,0
73,8482192,Isaak Phillips,D,CHI,23,0,0,0,0
73,8480727,Zach Whitecloud,D,VGK,28,0,0,0,0
73,8479346,Dillon Dube,C,,26,0,0,0,0
73,8480821,Filip Zadina,R,,25,0,0,0,0
73,8480001,Urho Vaakanainen,D,ANA,25,0,0,0,0
73,8470966,Mark Giordano,D,,41,0,0,0,0
73,8480853,Liam Foudy,C,,24,0,0,0,0
73,8475225,Craig Smith,C,CHI,35,0,0,0,0
73,8479972,Mason Shaw,C,WPG,26,0,0,0,0
73,8478451,Ethan Bear,D,WSH,27,0,0,0,0
73,8474040,Sam Gagner,C,,35,0,0,0,0
73,8480196,Jacob Bryson,D,BUF,27,0,0,0,0
73,8479984,Cal Foote,D,,26,0,0,0,0
73,8480011,Klim Kostin,C,SJS,25,0,0,0,0
73,8482176,Wyatt Kaiser,D,CHI,22,0,0,0,0
73,8476988,Matt Benning,D,SJS,30,0,0,0,0
73,8479370,Tyson Jost,C,CAR,26,0,0,0,0
73,8477464,Nic Petan,C,,29,0,0,0,0
73,8477380,Jonny Brodzinski,C,NYR,31,0,0,0,0
73,8480070,Ian Mitchell,D,BOS,25,0,0,0,0
73,8479315,Joey Anderson,R,CHI,26,0,0,0,0
73,8478099,Kevin Labanc,R,,29,0,0,0,0
73,8476874,Olli Maatta,D,DET,30,0,0,0,0
73,8475208,Brian Dumoulin,D,ANA,33,0,0,0,0
73,8478430,Oliver Kylington,D,,27,0,0,0,0
73,8479536,Axel Jonsson-Fjallby,L,WPG,26,0,0,0,0
73,8479671,Mathieu Olivier,R,CBJ,27,0,0,0,0
73,8471709,Marc-Edouard Vlasic,D,SJS,37,0,0,0,0
73,8479328,Julien Gauthier,R,NYI,27,0,0,0,0
73,8478421,A.J. Greer,L,FLA,28,0,0,0,0
73,8477573,Nathan Walker,L,STL,30,0,0,0,0
73,8481537,Nikita Okhotiuk,D,CGY,24,0,0,0,0
73,8474166,Alec Martinez,D,CHI,37,0,0,0,0
73,8470610,Zach Parise,L,,40,0,0,0,0
73,8477478,William Carrier,L,CAR,30,0,0,0,0
73,8479344,Jesse Puljujarvi,R,PIT,26,0,0,0,0
73,8480887,Jordan Harris,D,MTL,24,0,0,0,0
73,8478502,Dennis Gilbert,D,BUF,28,0,0,0,0
73,8482730,Brandt Clarke,D,LAK,21,0,0,0,0
73,8480355,Mark Kastelic,C,BOS,25,0,0,0,0
73,8475750,Jon Merrill,D,MIN,32,0,0,0,0
73,8475164,Jakob Silfverberg,R,,34,0,0,0,0
73,8477944,Jakub Vrana,L,,28,0,0,0,0
73,8479439,Jacob MacDonald,D,COL,31,0,0,0,0
73,8474568,Luke Schenn,D,NSH,35,0,0,0,0
73,8478454,Noah Juulsen,D,VAN,27,0,0,0,0
73,8475752,Tyler Pitlick,C,,33,0,0,0,0
73,8482148,Hendrix Lapierre,C,WSH,22,0,0,0,0
73,8481167,Brayden Pachal,D,CGY,25,0,0,0,0
73,8478043,Sam Lafferty,C,BUF,29,0,0,0,0
73,8479321,Lucas Johansen,D,,27,0,0,0,0
73,8471699,Andrew Cogliano,C,,37,0,0,0,0
73,8481521,Ronnie Attard,D,PHI,25,0,0,0,0
73,8481161,Jake Christiansen,D,CBJ,25,0,0,0,0
73,8479458,Nikita Zaitsev,D,,33,0,0,0,0
73,8479619,Michael Carcone,L,UTA,28,0,0,0,0
73,8479026,Philippe Myers,D,TOR,27,0,0,0,0
73,8477330,Dominik Kubalik,L,,29,0,0,0,0
73,8481617,Vasily Podkolzin,R,VAN,23,0,0,0,0
73,8481701,Santeri Hatakka,D,NJD,23,0,0,0,0
73,8479514,Rem Pitlick,C,,27,0,0,0,0
73,8477446,Michael McCarron,R,NSH,29,0,0,0,0
73,8470604,Jeff Carter,C,,39,0,0,0,0
73,8482241,Radim Zohorna,L,,28,0,0,0,0
73,8480289,Morgan Barron,C,WPG,26,0,0,0,0
73,8479379,Givani Smith,R,SJS,26,0,0,0,0
73,8480216,Jacob Peterson,C,,25,0,0,0,0
73,8477851,Jordan Oesterle,D,BOS,32,0,0,0,0
73,8484258,Sam Malinski,D,COL,26,0,0,0,0
73,8478904,Steven Lorentz,C,,28,0,0,0,0
73,8482095,Tyler Kleven,D,OTT,22,0,0,0,0
73,8480848,Ty Dellandrea,C,SJS,24,0,0,0,0
73,8476884,Derrick Pouliot,D,,30,0,0,0,0
73,8479336,Carl Grundstrom,R,SJS,27,0,0,0,0
73,8482964,Arber Xhekaj,D,MTL,23,0,0,0,0
73,8471686,Marc Staal,D,,37,0,0,0,0
73,8477887,Patrick Brown,C,BOS,32,0,0,0,0
73,8478495,Denis Gurianov,R,,27,0,0,0,0
73,8473504,Cal Clutterbuck,R,,37,0,0,0,0
73,8481550,Adam Beckman,L,NJD,23,0,0,0,0
73,8480845,Rasmus Kupari,C,WPG,24,0,0,0,0
73,8474009,Nick Bonino,C,,36,0,0,0,0
73,8478585,Derek Ryan,C,EDM,38,0,0,0,0
73,8477962,Brendan Lemieux,L,CAR,28,0,0,0,0
73,8482861,Vincent Iorio,D,WSH,22,0,0,0,0
73,8479378,Logan Stanley,D,WPG,26,0,0,0,0
73,8473446,Erik Johnson,D,PHI,36,0,0,0,0
73,8481743,Marc Del Gaizo,D,NSH,25,0,0,0,0
73,8477384,Josh Brown,D,EDM,30,0,0,0,0
73,8482165,Yan Kuznetsov,D,CGY,22,0,0,0,0
73,8478424,Jansen Harkins,C,ANA,27,0,0,0,0
73,8482144,Jack Thompson,D,SJS,22,0,0,0,0
73,8478512,Austin Czarnik,C,,32,0,0,0,0
73,8477527,Ross Johnston,L,ANA,30,0,0,0,0
73,8479383,Boris Katchouk,L,,26,0,0,0,0
73,8482094,Daemon Hunt,D,MIN,22,0,0,0,0
73,8481719,Maxwell Crozier,D,TBL,24,0,0,0,0
73,8480192,Johnathan Kovacevic,D,NJD,27,0,0,0,0
73,8479376,Victor Mete,D,,26,0,0,0,0
73,8482511,Mason Lohrei,D,BOS,23,0,0,0,0
73,8475825,Jani Hakanpää,D,,32,0,0,0,0
73,8478021,William Lagesson,D,DET,28,0,0,0,0
73,8475795,Dylan McIlrath,D,WSH,32,0,0,0,0
73,8477846,Ryan Carpenter,C,,33,0,0,0,0
73,8481056,Spencer Stastney,D,NSH,24,0,0,0,0
73,8481564,Ryan Johnson,D,BUF,23,0,0,0,0
73,8478017,Mark Friedman,D,VAN,29,0,0,0,0
73,8479320,Max Lajoie,D,SEA,27,0,0,0,0
73,8480075,Cameron Crotty,D,MIN,25,0,0,0,0
73,8484287,Cole McWard,D,VAN,23,0,0,0,0
73,8484254,Akito Hirose,D,VAN,25,0,0,0,0
73,8483407,Brandon Scanlin,D,NYR,25,0,0,0,0
73,8480274,Philip Kemp,D,EDM,25,0,0,0,0
73,8479522,Hardy Haman Aktell,D,WSH,26,0,0,0,0
73,8480007,Jonas Rondbjerg,R,VGK,25,0,0,0,0
73,8477454,Adam Erne,L,,29,0,0,0,0
73,8481679,Maxence Guenette,D,OTT,23,0,0,0,0
73,8480441,Trey Fix-Wolansky,R,CBJ,25,0,0,0,0
73,8483546,Marshall Rifai,D,TOR,26,0,0,0,0
73,8480084,Nick DeSimone,D,NJD,30,0,0,0,0
73,8481030,Jack St. Ivany,D,PIT,25,0,0,0,0
73,8481592,Jakob Pelletier,L,CGY,23,0,0,0,0
73,8478011,Louie Belpedio,D,PHI,28,0,0,0,0
73,8477930,Pierre-Edouard Bellemare,L,,39,0,0,0,0
73,8484321,Nikolas Matinpalo,D,OTT,26,0,0,0,0
73,8482067,Connor Mackey,D,NYR,28,0,0,0,0
73,8481806,Louis Crevier,D,CHI,23,0,0,0,0
73,8484326,Patrik Koch,D,UTA,28,0,0,0,0
73,8477971,Andreas Englund,D,LAK,28,0,0,0,0
73,8481751,Lukas Rousek,R,BUF,25,0,0,0,0
73,8481006,Tyler Tucker,D,STL,24,0,0,0,0
73,8476867,Brendan Gaunce,C,MIN,30,0,0,0,0
73,8479520,Brandon Duhaime,R,WSH,27,0,0,0,0
73,8477073,Kurtis MacDermid,L,NJD,30,0,0,0,0
73,8480874,Adam Ginning,D,PHI,24,0,0,0,0
73,8477473,Justin Bailey,R,SJS,29,0,0,0,0
73,8479066,Ryan Lomberg,L,CGY,30,0,0,0,0
73,8477070,Liam O'Brien,C,UTA,30,0,0,0,0
73,8474618,Marco Scandella,D,,34,0,0,0,0
73,8475797,Jarred Tinordi,D,,32,0,0,0,0
73,8481441,Joe Snively,C,DET,28,0,0,0,0
73,8477244,Chad Ruhwedel,D,NYR,34,0,0,0,0
73,8479772,Zack MacEwen,R,OTT,28,0,0,0,0
73,8481147,Reese Johnson,C,MIN,26,0,0,0,0
73,8481043,Cole Koepke,L,BOS,26,0,0,0,0
73,8483619,Filip Roos,D,OTT,25,0,0,0,0
73,8481541,Samuel Bolduc,D,NYI,24,0,0,0,0
73,8477810,Joel Hanley,D,CGY,33,0,0,0,0
73,8476907,Mackenzie MacEachern,L,,30,0,0,0,0
73,8482652,Walker Duehr,R,CGY,27,0,0,0,0
73,8477126,Jayson Megna,C,,34,0,0,0,0
73,8483398,Declan Carlile,D,TBL,31,0,0,0,0
73,8482929,Emil Lilleberg,D,TBL,23,0,0,0,0
73,8480880,Jakub Lauko,C,MIN,24,0,0,0,0
73,8480245,Olle Lycksell,R,PHI,25,0,0,0,0
73,8480252,Cole Guttman,C,CHI,25,0,0,0,0
73,8477467,Gustav Olofsson,D,SEA,30,0,0,0,0
73,8479968,Vinni Lettieri,C,BOS,29,0,0,0,0
73,8478400,Colin White,C,,27,0,0,0,0
73,8475755,Alexander Petrovic,D,DAL,32,0,0,0,0
73,8481812,Nikolai Knyzhov,D,,27,0,0,0,0
73,8481593,Jayden Struble,D,MTL,23,0,0,0,0
73,8481532,Alex Turcotte,C,LAK,23,0,0,0,0
73,8482126,Emil Andrae,D,PHI,31,0,0,0,0
73,8479944,Zach Aston-Reese,C,VGK,30,0,0,0,0
73,8471817,Ryan Reaves,R,TOR,37,0,0,0,0
73,8481206,John Ludvig,D,PIT,24,0,0,0,0
73,8481599,Victor Soderstrom,D,UTA,23,0,0,0,0
73,8480292,Carson Meyer,R,ANA,27,0,0,0,0
73,8482496,Nils Aman,C,VAN,24,0,0,0,0
73,8479718,Alex Barré-Boulet,C,MTL,27,0,0,0,0
73,8479994,Jaret Anderson-Dolan,C,WPG,25,0,0,0,0
73,8480184,Gustav Lindstrom,D,,26,0,0,0,0
73,8480890,Jan Jenik,R,OTT,24,0,0,0,0
73,8478067,Oskar Lindblom,L,,28,0,0,0,0
73,8476934,Brock McGinn,L,ANA,30,0,0,0,0
73,8479985,Cale Fleury,D,SEA,26,0,0,0,0
73,8484304,Uvis Balinskis,D,FLA,28,0,0,0,0
73,8479981,Jonah Gadjovich,L,FLA,26,0,0,0,0
73,8481716,Dmitri Voronkov,L,CBJ,24,0,0,0,0
73,8474709,Matt Martin,L,,35,0,0,0,0
73,8482634,Alex Steeves,C,TOR,25,0,0,0,0
73,8480823,Alexander Alexeyev,D,WSH,25,0,0,0,0
73,8477541,Dakota Mermis,D,TOR,30,0,0,0,0
73,8483491,Ivan Miroshnichenko,L,WSH,20,0,0,0,0
73,8478477,Mitchell Stephens,C,SEA,27,0,0,0,0
73,8481543,Nikita Alexandrov,C,STL,24,0,0,0,0
73,8479423,Alex Nylander,L,,26,0,0,0,0
73,8482451,Mikael Pyyhtia,L,CBJ,23,0,0,0,0
73,8478831,Kevin Stenlund,C,UTA,28,0,0,0,0
73,8480306,Grant Hutton,D,NYI,29,0,0,0,0
73,8478028,Fredrik Olofsson,L,,28,0,0,0,0
73,8477462,Robert Hagg,D,VGK,29,0,0,0,0
73,8477320,Anton Blidh,L,NYR,29,0,0,0,0
73,8482157,Will Cuylle,L,NYR,22,0,0,0,0
73,8482737,Zack Bolduc,C,STL,21,0,0,0,0
73,8481239,Samuel Fagemo,L,,24,0,0,0,0
73,8481600,Tobias Bjornfot,D,FLA,23,0,0,0,0
73,8478409,Anthony Richard,C,PHI,28,0,0,0,0
73,8474145,Robert Bortuzzo,D,,35,0,0,0,0
73,8475958,Michael Sgarbossa,C,WSH,32,0,0,0,0
73,8479986,Kole Lind,R,DAL,26,0,0,0,0
73,8479249,Andrew Poturalski,C,SJS,30,0,0,0,0
73,8479362,Riley Tufte,L,BOS,26,0,0,0,0
73,8479991,Jake Leschyshyn,C,NYR,25,0,0,0,0
73,8479587,Rhett Gardner,C,PHI,28,0,0,0,0
73,8482744,James Malatesta,L,CBJ,21,0,0,0,0
73,8478854,Ryan Shea,D,PIT,27,0,0,0,0
73,8481591,Sam Poulin,R,,23,0,0,0,0
73,8483512,Matt Savoie,C,EDM,20,0,0,0,0
73,8482102,Vasily Ponomarev,C,PIT,22,0,0,0,0
73,8482162,Roby Jarventie,L,EDM,22,0,0,0,0
73,8481016,Ruslan Iskhakov,C,,24,0,0,0,0
73,8482172,Landon Slaggert,L,CHI,22,0,0,0,0
73,8482747,Brennan Othmann,L,NYR,21,0,0,0,0
73,8480031,Maxime Comtois,L,,25,0,0,0,0
73,8480226,Marián Studenic,R,,26,0,0,0,0
73,8478408,Travis Dermott,D,,28,0,0,0,0
73,8481518,Nolan Foote,L,NJD,24,0,0,0,0
73,8479419,Brett Murray,L,BUF,26,0,0,0,0
73,8482088,Justin Sourdif,R,FLA,22,0,0,0,0
73,8482201,Gage Goncalves,C,TBL,23,0,0,0,0
73,8481578,Graeme Clarke,R,MIN,23,0,0,0,0
73,8482177,Marat Khusnutdinov,C,MIN,22,0,0,0,0
73,8481754,Nikita Nesterenko,C,ANA,23,0,0,0,0
73,8483531,Brian Halonen,L,NJD,25,0,0,0,0
73,8483920,Pierrick Dube,R,WSH,23,0,0,0,0
73,8480851,Akil Thomas,C,LAK,24,0,0,0,0
73,8475235,Nicolas Deslauriers,L,PHI,33,0,0,0,0
73,8482476,Emil Heineman,L,MTL,23,0,0,0,0
73,8477149,Scott Sabourin,R,SJS,32,0,0,0,0
73,8483549,Lucas Condotta,L,MTL,27,0,0,0,0
73,8482765,Isak Rosen,R,BUF,21,0,0,0,0
73,8481237,Kyle MacLean,C,NYI,25,0,0,0,0
73,8481024,Linus Karlsson,C,VAN,25,0,0,0,0
73,8481690,Tyler Angle,C,,24,0,0,0,0
73,8483570,Ben Meyers,C,SEA,26,0,0,0,0
73,8481655,Cole Schwindt,R,CGY,23,0,0,0,0
73,8481462,Mason Morelli,L,VGK,28,0,0,0,0
73,8483401,Marc Johnstone,R,PIT,28,0,0,0,0
73,8478956,Samuel Laberge,L,NJD,27,0,0,0,0
73,8479533,Joona Koppanen,L,,26,0,0,0,0
73,8482197,Adam Raska,R,MIN,23,0,0,0,0
73,8482250,Callahan Burke,C,VGK,27,0,0,0,0
73,8482784,Zach Dean,C,STL,21,0,0,0,0
73,8484255,Jason Polin,R,COL,25,0,0,0,0
73,8481077,John Leonard,L,,26,0,0,0,0
73,8481534,Raphael Lavoie,C,EDM,24,0,0,0,0
73,8483609,Adam Klapka,R,CGY,24,0,0,0,0
73,8482751,Ryan Winterton,C,SEA,21,0,0,0,0
73,8480267,Sammy Walker,C,MIN,25,0,0,0,0
73,8475766,Austin Watson,L,,32,0,0,0,0
73,8482460,Matt Rempe,C,NYR,22,0,0,0,0
73,8481065,Angus Crookshank,L,OTT,25,0,0,0,0
73,8481070,Hugh McGing,L,,26,0,0,0,0
73,8476323,Max McCormick,L,SEA,32,0,0,0,0
73,8483395,Arshdeep Bains,L,VAN,23,0,0,0,0
73,8484259,Ondrej Pavel,C,COL,31,0,0,0,0
73,8483432,Luca Del Bel Belluz,C,CBJ,31,0,0,0,0
73,8483045,Cameron Butler,R,CBJ,31,0,0,0,0
73,8482061,Brandon Biro,L,SEA,26,0,0,0,0
73,8477401,John Hayden,C,SEA,29,0,0,0,0
73,8475278,Byron Froese,C,,33,0,0,0,0
73,8478446,Glenn Gawdin,C,LAK,27,0,0,0,0
73,8477993,Justin Kirkland,C,CGY,28,0,0,0,0
73,8482147,Jean-Luc Foudy,C,COL,22,0,0,0,0
73,8480032,Shane Bowers,C,NJD,25,0,0,0,0
73,8479330,Brandon Gignac,C,MTL,27,0,0,0,0
73,8480776,Sheldon Rempal,R,,29,0,0,0,0
73,8475413,Justin Dowling,C,NJD,34,0,0,0,0
73,8481726,Adam Edstrom,C,NYR,24,0,0,0,0
73,8480844,Grigori Denisenko,L,VGK,24,0,0,0,0
73,8478147,Bokondji Imama,L,PIT,28,0,0,0,0
73,8478881,Brett Seney,L,CHI,28,0,0,0,0
73,8483630,Pavol Regenda,L,ANA,25,0,0,0,0
73,8480836,Jonathan Gruden,C,,24,0,0,0,0
73,8484314,Jiri Smejkal,L,,28,0,0,0,0
73,8475780,Chris Wagner,R,COL,33,0,0,0,0
73,8479546,Oskar Steen,C,,26,0,0,0,0
73,8483597,Milos Kelemen,L,UTA,25,0,0,0,0
73,8481789,Tye Kartye,L,SEA,23,0,0,0,0
73,8484325,Waltteri Merela,C,TBL,26,0,0,0,0
73,8479421,Jacob Moverare,D,LAK,26,0,0,0,0
73,8481585,Egor Afanasyev,L,SJS,23,0,0,0,0
73,8479547,Matthew Phillips,R,,26,0,0,0,0
73,8479367,William Lockwood,R,FLA,26,0,0,0,0
73,8476915,Jujhar Khaira,L,,30,0,0,0,0
73,8481422,Jacob Lucchini,C,NSH,29,0,0,0,0
73,8480468,James Hamblin,L,EDM,25,0,0,0,0
73,8478051,Max Willman,C,NJD,29,0,0,0,0
73,8481556,John Beecher,C,BOS,23,0,0,0,0
73,8478078,Rourke Chartier,C,,28,0,0,0,0
74,8479318,Auston Matthews,C,TOR,27,82,90,68,158
74,8476453,Nikita Kucherov,R,TBL,31,82,49,96,145
74,8478402,Connor McDavid,C,EDM,27,82,45,99,144
74,8477492,Nathan MacKinnon,C,COL,29,82,46,91,137
74,8479314,Matthew Tkachuk,L,FLA,27,82,37,91,128
74,8477939,William Nylander,R,TOR,28,82,48,75,123
74,8477956,David Pastrnak,R,BOS,28,82,53,69,122
74,8478864,Kirill Kaprizov,L,MIN,27,82,43,78,121
74,8478420,Mikko Rantanen,R,COL,28,82,48,68,116
74,8477934,Leon Draisaitl,C,EDM,29,82,36,80,116
74,8480027,Jason Robertson,L,DAL,25,82,44,71,115
74,8477493,Aleksander Barkov,C,FLA,29,82,41,73,114
74,8478550,Artemi Panarin,L,NYR,33,82,38,73,111
74,8476468,J.T. Miller,C,VAN,31,82,42,66,108
74,8480012,Elias Pettersson,C,VAN,26,82,34,73,107
74,8477942,Kevin Fiala,L,LAK,28,82,37,69,106
74,8482116,Tim Stützle,C,OTT,22,82,42,63,105
74,8481559,Jack Hughes,C,NJD,23,82,36,66,102
74,8471675,Sidney Crosby,C,PIT,37,82,33,69,102
74,8475172,Nazem Kadri,C,CGY,34,82,44,55,99
74,8476887,Filip Forsberg,L,NSH,30,82,45,51,96
74,8480023,Robert Thomas,C,STL,25,82,28,66,94
74,8478403,Jack Eichel,C,VGK,28,82,41,51,92
74,8477404,Jake Guentzel,C,TBL,30,82,32,60,92
74,8477946,Dylan Larkin,C,DET,28,82,42,49,91
74,8474600,Roman Josi,D,NSH,34,82,17,74,91
74,8478449,Roope Hintz,C,DAL,28,82,34,56,90
74,8478445,Mathew Barzal,C,NYI,27,82,24,66,90
74,8478439,Travis Konecny,R,PHI,27,82,42,47,89
74,8480800,Quinn Hughes,D,VAN,25,82,16,73,89
74,8480069,Cale Makar,D,COL,26,82,22,66,88
74,8478444,Brock Boeser,R,VAN,27,82,45,42,87
74,8474564,Steven Stamkos,C,NSH,34,82,36,51,87
74,8475913,Mark Stone,R,VGK,32,82,32,55,87
74,8480002,Nico Hischier,C,NJD,25,82,36,48,84
74,8481557,Matt Boldy,L,MIN,23,82,33,51,84
74,8478398,Kyle Connor,L,WPG,28,82,39,44,83
74,8480801,Brady Tkachuk,L,OTT,25,82,29,54,83
74,8476346,Johnny Gaudreau,L,CBJ,31,82,18,65,83
74,8476539,Jonathan Marchessault,R,NSH,34,82,38,44,82
74,8480036,Miro Heiskanen,D,DAL,25,82,15,67,82
74,8476460,Mark Scheifele,C,WPG,31,82,33,48,81
74,8476456,Jonathan Huberdeau,C,CGY,31,82,19,62,81
74,8475167,Victor Hedman,D,TBL,34,82,16,64,80
74,8480803,Evan Bouchard,D,EDM,25,82,13,66,79
74,8476459,Mika Zibanejad,C,NYR,31,82,34,44,78
74,8474590,John Carlson,D,WSH,34,82,24,54,78
74,8476853,Morgan Rielly,D,TOR,30,82,12,65,77
74,8478498,Jake DeBrusk,L,VAN,28,82,38,38,76
74,8478010,Brayden Point,C,TBL,28,82,32,44,76
74,8482078,Lucas Raymond,L,DET,22,82,32,44,76
74,8475784,Jeff Skinner,C,EDM,32,82,32,44,76
74,8475166,John Tavares,C,TOR,34,82,29,47,76
74,8478440,Dylan Strome,C,WSH,27,82,28,48,76
74,8475692,Mats Zuccarello,R,MIN,37,82,20,56,76
74,8479542,Brandon Hagel,L,TBL,26,82,34,41,75
74,8479323,Adam Fox,D,NYR,26,82,12,63,75
74,8471215,Evgeni Malkin,C,PIT,38,82,36,38,74
74,8478414,Timo Meier,R,NJD,28,82,35,38,73
74,8479343,Clayton Keller,R,UTA,26,82,27,46,73
74,8478042,Viktor Arvidsson,R,EDM,31,82,35,37,72
74,8476389,Vincent Trocheck,C,NYR,31,82,33,38,71
74,8479385,Jordan Kyrou,C,STL,26,82,28,43,71
74,8477447,Shea Theodore,D,VGK,29,82,10,61,71
74,8477933,Sam Reinhart,C,FLA,29,82,32,38,70
74,8473986,Alex Killorn,L,ANA,35,82,31,39,70
74,8477500,Bo Horvat,C,NYI,29,82,35,34,69
74,8478975,Mason Marchment,L,DAL,29,82,29,40,69
74,8476875,Mike Matheson,D,MTL,30,82,15,54,69
74,8475798,Mikael Granlund,C,SJS,32,82,14,55,69
74,8471214,Alex Ovechkin,L,WSH,39,82,39,29,68
74,8479420,Tage Thompson,C,BUF,27,82,38,30,68
74,8477955,Jared McCann,L,SEA,28,82,34,34,68
74,8477501,Valeri Nichushkin,R,COL,29,82,31,37,68
74,8477940,Nikolaj Ehlers,L,WPG,28,82,29,39,68
74,8478873,Troy Terry,R,ANA,27,82,29,39,68
74,8480208,Drake Batherson,R,OTT,26,82,28,40,68
74,8476454,Ryan Nugent-Hopkins,C,EDM,31,82,28,40,68
74,8473512,Claude Giroux,R,OTT,36,82,18,50,68
74,8479410,Mikhail Sergachev,D,UTA,26,82,17,51,68
74,8478401,Pavel Zacha,C,BOS,27,82,28,39,67
74,8476882,Teuvo Teravainen,L,CHI,30,82,28,39,67
74,8475168,Matt Duchene,C,DAL,33,82,26,41,67
74,8479337,Alex DeBrincat,R,DET,27,82,26,41,67
74,8475786,Zach Hyman,L,EDM,32,82,36,30,66
74,8477960,Adrian Kempe,R,LAK,28,82,27,39,66
74,8478427,Sebastian Aho,C,CAR,27,82,26,40,66
74,8480018,Nick Suzuki,C,MTL,25,82,25,41,66
74,8482665,Matty Beniers,C,SEA,22,82,24,42,66
74,8478047,Michael Bunting,L,PIT,29,82,24,42,66
74,8482684,Luke Hughes,D,NJD,21,82,18,48,66
74,8474578,Erik Karlsson,D,PIT,34,82,17,49,66
74,8475184,Chris Kreider,L,NYR,33,82,39,26,65
74,8481540,Cole Caufield,R,MTL,23,82,37,28,65
74,8481533,Trevor Zegras,C,ANA,23,82,32,33,65
74,8478856,Conor Garland,R,VAN,28,82,32,33,65
74,8475794,Tyler Seguin,C,DAL,32,82,32,33,65
74,8480188,Fabian Zetterlund,L,SJS,25,82,30,35,65
74,8476448,William Karlsson,C,VGK,31,82,29,36,65
74,8477949,Alex Tuch,R,BUF,28,82,24,41,65
74,8479325,Charlie McAvoy,D,BOS,27,82,14,51,65
74,8477402,Pavel Buchnevich,L,STL,29,82,29,35,64
74,8481523,Kirby Dach,C,MTL,23,82,14,50,64
74,8477496,Elias Lindholm,C,BOS,30,82,30,33,63
74,8480830,Andrei Svechnikov,R,CAR,24,82,33,29,62
74,8477409,Carter Verhaeghe,C,FLA,29,82,30,32,62
74,8476432,Boone Jenner,C,CBJ,31,82,28,34,62
74,8473419,Brad Marchand,L,BOS,36,82,27,35,62
74,8477951,Nick Schmaltz,C,UTA,28,82,23,39,62
74,8482667,William Eklund,L,SJS,22,82,20,42,62
74,8479407,Jesper Bratt,L,NJD,26,82,17,45,62
74,8477932,Aaron Ekblad,D,FLA,28,82,17,45,62
74,8474565,Alex Pietrangelo,D,VGK,34,82,15,47,62
74,8475810,Bryan Rust,R,PIT,32,82,29,32,61
74,8473994,Jamie Benn,L,DAL,35,82,26,35,61
74,8482745,Mason McTavish,C,ANA,21,82,26,35,61
74,8477426,Nicholas Paul,L,TBL,29,82,24,37,61
74,8474141,Patrick Kane,R,DET,36,82,19,42,61
74,8476792,Torey Krug,D,STL,33,82,18,43,61
74,8471685,Anze Kopitar,C,LAK,37,82,17,44,61
74,8480865,Noah Dobson,D,NYI,24,82,13,48,61
74,8482159,Tyson Foerster,R,PHI,22,82,29,31,60
74,8477511,Anthony Mantha,R,CGY,30,82,31,28,59
74,8475765,Vladimir Tarasenko,R,DET,33,82,27,32,59
74,8474150,Mikael Backlund,C,CGY,35,82,19,40,59
74,8479675,Trevor Moore,L,LAK,29,82,34,24,58
74,8482093,Seth Jarvis,C,CAR,22,82,24,34,58
74,8475170,Brayden Schenn,C,STL,33,82,23,35,58
74,8481068,Yegor Sharangovich,C,CGY,26,82,30,27,57
74,8475791,Taylor Hall,L,CHI,33,82,25,32,57
74,8477429,Andrew Copp,C,DET,30,82,21,36,57
74,8477494,Jonathan Drouin,L,COL,29,82,20,37,57
74,8471724,Kris Letang,D,PIT,37,82,16,41,57
74,8478397,Rasmus Andersson,D,CGY,28,82,13,44,57
74,8477504,Josh Morrissey,D,WPG,29,82,12,45,57
74,8475754,Brock Nelson,C,NYI,33,82,31,25,56
74,8477935,Sam Bennett,C,FLA,28,82,29,27,56
74,8471698,T.J. Oshie,R,WSH,38,82,29,27,56
74,8474679,Gustav Nyquist,C,NSH,35,82,23,33,56
74,8475726,Tyler Toffoli,C,SJS,32,82,23,33,56
74,8476479,Phillip Danault,C,LAK,31,82,23,33,56
74,8480039,Martin Necas,C,CAR,25,82,20,36,56
74,8477498,Darnell Nurse,D,EDM,29,82,20,36,56
74,8476826,Yanni Gourde,C,SEA,33,82,15,41,56
74,8482110,Dawson Mercer,C,NJD,23,82,31,24,55
74,8477476,Artturi Lehkonen,L,COL,29,82,30,25,55
74,8475151,Kyle Palmieri,C,NYI,33,82,27,28,55
74,8482097,Jack Quinn,R,BUF,23,82,20,35,55
74,8479425,Filip Hronek,D,VAN,27,82,13,42,55
74,8478460,Zach Werenski,D,CBJ,27,82,12,43,55
74,8479339,Patrik Laine,L,CBJ,26,82,33,21,54
74,8482109,Alexis Lafrenière,L,NYR,23,82,25,29,54
74,8476881,Tomas Hertl,C,VGK,31,82,24,30,54
74,8478458,Jack Roslovic,C,CAR,27,82,18,36,54
74,8480078,Filip Chytil,C,NYR,25,82,17,37,54
74,8480797,Joel Farabee,L,PHI,24,82,12,42,54
74,8475169,Evander Kane,L,EDM,33,82,32,21,53
74,8478366,Frank Vatrano,R,ANA,30,82,29,24,53
74,8477964,Ivan Barbashev,C,VGK,29,82,21,32,53
74,8482124,Quinton Byfield,R,LAK,22,82,19,34,53
74,8470613,Brent Burns,D,CAR,39,82,14,39,53
74,8480015,Owen Tippett,R,PHI,25,82,25,27,52
74,8477416,Oliver Bjorkstrand,R,SEA,29,82,19,33,52
74,8477479,Tyler Bertuzzi,L,CHI,29,82,18,34,52
74,8481528,Dylan Cozens,C,BUF,23,82,18,34,52
74,8476419,Jean-Gabriel Pageau,C,NYI,32,82,17,35,52
74,8475218,Mattias Ekholm,D,EDM,34,82,15,37,52
74,8480839,Rasmus Dahlin,D,BUF,24,82,13,39,52
74,8476906,Shayne Gostisbehere,D,CAR,31,82,13,39,52
74,8474563,Drew Doughty,D,LAK,35,82,13,39,52
74,8476462,Dougie Hamilton,D,NJD,31,82,11,41,52
74,8477986,Brandon Montour,D,SEA,30,82,11,41,52
74,8477503,Max Domi,C,TOR,29,82,8,44,52
74,8483808,Andrei Kuzmenko,L,CGY,28,82,28,23,51
74,8480064,Josh Norris,C,OTT,25,82,26,25,51
74,8478542,Evan Rodrigues,C,FLA,31,82,25,26,51
74,8477451,Ryan Hartman,R,MIN,30,82,24,27,51
74,8474586,Jordan Eberle,R,SEA,34,82,23,28,51
74,8474102,David Perron,L,OTT,36,82,23,28,51
74,8483515,Juraj Slafkovsky,L,MTL,20,82,23,28,51
74,8478396,Noah Hanifin,D,VGK,27,82,12,39,51
74,8477497,Sean Monahan,C,CBJ,30,82,24,26,50
74,8475714,Calle Jarnkrok,C,TOR,33,82,23,27,50
74,8475158,Ryan O'Reilly,C,NSH,33,82,22,28,50
74,8479999,Casey Mittelstadt,C,COL,26,82,19,31,50
74,8478055,Gustav Forsling,D,FLA,28,82,16,34,50
74,8477346,MacKenzie Weegar,D,CGY,30,82,11,39,50
74,8475287,Erik Haula,L,NJD,33,82,22,27,49
74,8481560,Arthur Kaliyev,R,LAK,23,82,21,28,49
74,8480798,Philipp Kurashev,C,CHI,25,82,18,31,49
74,8482740,Wyatt Johnston,C,DAL,21,82,26,22,48
74,8476399,Blake Coleman,C,CGY,33,82,24,24,48
74,8484144,Connor Bedard,C,CHI,19,82,24,24,48
74,8477953,Kasperi Kapanen,R,STL,28,82,23,25,48
74,8476329,Travis Boyd,C,MIN,31,82,20,28,48
74,8476872,Scott Laughton,C,PHI,30,82,18,30,48
74,8478438,Tommy Novak,C,NSH,27,82,17,31,48
74,8476905,Chandler Stephenson,C,SEA,30,82,15,33,48
74,8480028,Morgan Frost,C,PHI,25,82,15,33,48
74,8478469,Thomas Chabot,D,OTT,27,82,14,34,48
74,8476461,Sean Couturier,C,PHI,32,82,21,26,47
74,8476483,Rickard Rakell,R,PIT,31,82,20,27,47
74,8481535,Nils Hoglander,L,VAN,24,82,20,27,47
74,8476880,Tom Wilson,R,WSH,30,82,19,28,47
74,8478493,Joel Eriksson Ek,C,MIN,27,82,18,29,47
74,8478407,Vince Dunn,D,SEA,28,82,14,33,47
74,8475745,Charlie Coyle,C,BOS,32,82,14,33,47
74,8482720,Matthew Knies,L,TOR,22,82,14,33,47
74,8481711,Matias Maccelli,L,UTA,24,82,12,35,47
74,8482055,Drew O'Connor,L,PIT,26,82,28,18,46
74,8481582,Nicholas Robertson,L,TOR,23,82,26,20,46
74,8479525,Ross Colton,C,COL,28,82,23,23,46
74,8477998,Warren Foegele,L,LAK,28,82,23,23,46
74,8474149,Evgenii Dadonov,R,DAL,35,82,23,23,46
74,8482175,JJ Peterka,R,BUF,22,82,22,24,46
74,8477987,Ryan Donato,C,CHI,28,82,22,24,46
74,8475760,Nick Bjugstad,C,UTA,32,82,21,25,46
74,8477444,Andre Burakovsky,L,SEA,29,82,17,29,46
74,8476458,Ryan Strome,C,ANA,31,82,13,33,46
74,8476869,Brady Skjei,D,NSH,30,82,9,37,46
74,8482671,Owen Power,D,BUF,22,82,8,38,46
74,8477495,Seth Jones,D,CHI,30,82,6,40,46
74,8480849,Barrett Hayton,C,UTA,24,82,25,20,45
74,8480829,Jesperi Kotkaniemi,C,CAR,24,82,23,22,45
74,8480113,Alex Iafallo,L,WPG,31,82,22,23,45
74,8480459,Pius Suter,C,VAN,28,82,19,26,45
74,8482705,Cole Sillinger,C,CBJ,21,82,19,26,45
74,8475753,Justin Faulk,D,STL,32,82,17,28,45
74,8475191,Reilly Smith,R,NYR,33,82,16,29,45
74,8482089,Jake Neighbours,L,STL,22,82,28,16,44
74,8480014,Gabriel Vilardi,C,WPG,25,82,25,19,44
74,8478519,Anthony Cirelli,C,TBL,27,82,24,20,44
74,8479941,Justin Danforth,R,CBJ,31,82,24,20,44
74,8481604,Pavel Dorofeyev,L,VGK,24,82,24,20,44
74,8475722,Jason Zucker,L,BUF,32,82,21,23,44
74,8475793,Ryan Johansen,C,PHI,32,82,20,24,44
74,8477021,Alex Kerfoot,C,UTA,30,82,17,27,44
74,8481618,Alex Newhook,C,MTL,23,82,16,28,44
74,8482149,Cole Perfetti,C,WPG,22,82,14,30,44
74,8476927,Teddy Blueger,C,VAN,30,82,13,31,44
74,8476958,Jaccob Slavin,D,CAR,30,82,8,36,44
74,8476885,Jacob Trouba,D,NYR,30,82,7,37,44
74,8475763,Kevin Hayes,R,PIT,32,82,20,23,43
74,8476474,Stefan Noesen,R,NJD,31,82,18,25,43
74,8480220,Noah Cates,L,PHI,25,82,16,27,43
74,8480434,Sean Durzi,D,UTA,26,82,15,28,43
74,8479365,Trent Frederic,C,BOS,26,82,19,23,42
74,8473533,Jordan Staal,C,CAR,36,82,19,23,42
74,8482117,Lukas Reichel,L,CHI,22,82,19,23,42
74,8477407,Anthony Duclair,L,NYI,29,82,15,27,42
74,8481546,Cam York,D,PHI,23,82,15,27,42
74,8480185,Eetu Luostarinen,C,FLA,26,82,13,29,42
74,8482146,Luke Evangelista,R,NSH,22,82,25,16,41
74,8478474,Lawson Crouse,L,UTA,27,82,22,19,41
74,8481596,Shane Pinto,C,OTT,24,82,22,19,41
74,8478057,Dakota Joshua,C,VAN,28,82,21,20,41
74,8482113,Anton Lundell,C,FLA,23,82,18,23,41
74,8475799,Nino Niederreiter,R,WPG,32,82,17,24,41
74,8476292,Ondrej Palat,L,NJD,33,82,17,24,41
74,8480817,K'Andre Miller,D,NYR,24,82,10,31,41
74,8478038,Devon Toews,D,COL,30,82,8,33,41
74,8475314,Anders Lee,L,NYI,34,82,23,17,40
74,8475768,Jaden Schwartz,C,SEA,32,82,23,17,40
74,8476981,Josh Anderson,R,MTL,30,82,21,19,40
74,8478462,Nicolas Roy,C,VGK,27,82,19,21,40
74,8473563,Nicklas Backstrom,C,WSH,37,82,18,22,40
74,8479400,Pierre-Luc Dubois,L,WSH,26,82,17,23,40
74,8478233,Andrew Mangiapane,L,WSH,28,82,16,24,40
74,8482475,Yegor Chinakhov,R,CBJ,23,82,16,24,40
74,8478911,Matt Roy,D,WSH,29,82,8,32,40
74,8481032,Paul Cotter,C,NJD,25,82,20,19,39
74,8477456,J.T. Compher,L,DET,29,82,19,20,39
74,8476438,Brandon Saad,L,STL,32,82,19,20,39
74,8477952,Robby Fabbri,C,ANA,28,82,17,22,39
74,8482699,Dylan Guenther,R,UTA,21,82,16,23,39
74,8474641,Adam Henrique,C,EDM,34,82,14,25,39
74,8482133,Thomas Bordeleau,C,SJS,22,82,13,26,39
74,8482105,Jake Sanderson,D,OTT,22,82,11,28,39
74,8481581,Thomas Harley,D,DAL,23,82,11,28,39
74,8479345,Jakob Chychrun,D,WSH,26,82,9,30,39
74,8475764,Cam Fowler,D,ANA,33,82,3,36,39
74,8480009,Eeli Tolvanen,R,SEA,25,82,24,14,38
74,8478463,Anthony Beauvillier,L,PIT,27,82,19,19,38
74,8482111,Justin Barron,D,MTL,23,82,16,22,38
74,8480871,Adam Boqvist,D,FLA,24,82,14,24,38
74,8482122,Brock Faber,D,MIN,22,82,7,31,38
74,8480893,Kirill Marchenko,R,CBJ,24,82,22,15,37
74,8478046,Danton Heinen,L,VAN,29,82,15,22,37
74,8470621,Corey Perry,R,EDM,39,82,15,22,37
74,8479987,Morgan Geekie,C,BOS,26,82,13,24,37
74,8480878,Nils Lundkvist,D,DAL,24,82,11,26,37
74,8481656,Aliaksei Protas,C,WSH,23,82,10,27,37
74,8473507,Jeff Petry,D,DET,37,82,10,27,37
74,8479351,Sam Steel,C,DAL,26,82,9,28,37
74,8481542,Moritz Seider,D,DET,23,82,4,33,37
74,8476918,Jimmy Vesey,L,NYR,31,82,19,17,36
74,8474189,Lars Eller,C,PIT,35,82,18,18,36
74,8476392,Adam Lowry,C,WPG,31,82,14,22,36
74,8480145,Neal Pionk,D,WPG,29,82,9,27,36
74,8476923,Damon Severson,D,CBJ,30,82,4,32,36
74,8480043,Timothy Liljegren,D,TOR,25,82,2,34,36
74,8481580,Connor McMichael,C,WSH,23,82,21,14,35
74,8475220,Marcus Foligno,L,MIN,33,82,16,19,35
74,8482092,Ridly Greig,C,OTT,22,82,15,20,35
74,8475193,Tomas Tatar,L,NJD,34,82,14,21,35
74,8476480,Vladislav Namestnikov,C,WPG,32,82,14,21,35
74,8475149,Marcus Johansson,L,MIN,34,82,13,22,35
74,8479992,Michael Rasmussen,C,DET,25,82,11,24,35
74,8480748,Kiefer Sherwood,L,VAN,29,82,11,24,35
74,8474574,Tyler Myers,D,VAN,34,82,9,26,35
74,8476931,Jake McCabe,D,TOR,31,82,6,29,35
74,8476457,Adam Larsson,D,SEA,32,82,3,32,35
74,8482259,Bobby McMann,C,TOR,28,82,22,12,34
74,8478413,Jordan Greenway,L,BUF,27,82,16,18,34
74,8475848,Brendan Gallagher,R,MTL,32,82,16,18,34
74,8478115,Pierre Engvall,L,NYI,28,82,15,19,34
74,8474053,Logan Couture,C,SJS,35,82,14,20,34
74,8479996,Cody Glass,C,NSH,25,82,13,21,34
74,8473422,Nick Foligno,L,CHI,37,82,12,22,34
74,8477948,Travis Sanheim,D,PHI,28,82,12,22,34
74,8478891,Mason Appleton,C,WPG,28,82,11,23,34
74,8476925,Colton Sissons,C,NSH,31,82,11,23,34
74,8476463,Jonas Brodin,D,MIN,31,82,11,23,34
74,8476854,Hampus Lindholm,D,BOS,30,82,6,28,34
74,8480980,Connor Dewar,C,TOR,25,82,15,18,33
74,8478020,Michael Amadio,C,OTT,28,82,14,19,33
74,8477425,Miles Wood,L,COL,29,82,13,20,33
74,8480336,Sean Walker,D,CAR,30,82,9,24,33
74,8482660,Kent Johnson,C,CBJ,22,82,6,27,33
74,8476979,Erik Gustafsson,D,DET,32,82,4,29,33
74,8476892,Colton Parayko,D,STL,31,82,3,30,33
74,8482125,Alexander Holtz,R,VGK,22,82,19,13,32
74,8479353,Brett Howden,C,VGK,26,82,19,13,32
74,8476278,Colin Blackwell,C,DAL,31,82,16,16,32
74,8482624,Daniil Miromanov,D,CGY,27,82,15,17,32
74,8481704,Juuso Parssinen,C,NSH,23,82,14,18,32
74,8480995,Pontus Holmberg,R,TOR,25,82,14,18,32
74,8480068,Ryan Poehling,C,PHI,25,82,12,20,32
74,8481522,Peyton Krebs,C,BUF,23,82,5,27,32
74,8481606,Jordan Spence,D,LAK,23,82,4,28,32
74,8479293,Brandon Tanev,L,SEA,33,82,17,14,31
74,8476921,Jordan Martinook,L,CAR,32,82,17,14,31
74,8476469,Joel Armia,R,MTL,31,82,15,16,31
74,8477508,Curtis Lazar,C,NJD,29,82,15,16,31
74,8477947,Sonny Milano,L,WSH,28,82,14,17,31
74,8478472,Mathieu Joseph,R,STL,27,82,7,24,31
74,8477969,Marcus Pettersson,D,PIT,28,82,3,28,31
74,8475690,Chris Tanev,D,TOR,35,82,2,29,31
74,8481554,Kaapo Kakko,R,NYR,23,82,18,12,30
74,8476374,Sean Kuraly,C,CBJ,31,82,15,15,30
74,8475171,Oliver Ekman-Larsson,D,TOR,33,82,8,22,30
74,8475188,Brayden McNabb,D,VGK,33,82,7,23,30
74,8478851,Alexandre Carrier,D,NSH,28,82,5,25,30
74,8476525,Colin Miller,D,WPG,32,82,4,26,30
74,8475790,Erik Gudbranson,D,CBJ,32,82,4,26,30
74,8480873,Rasmus Sandin,D,WSH,24,82,0,30,30
74,8476960,Andreas Athanasiou,C,CHI,30,82,13,16,29
74,8480813,Joe Veleno,C,DET,24,82,13,16,29
74,8476873,Mark Jankowski,C,NSH,30,82,12,17,29
74,8478569,Noel Acciari,C,PIT,33,82,12,17,29
74,8474716,Jared Spurgeon,D,MIN,35,82,12,17,29
74,8481186,Logan O'Connor,R,COL,28,82,10,19,29
74,8479591,Michael Eyssimont,C,TBL,28,82,9,20,29
74,8483457,Lane Hutson,D,MTL,20,82,9,20,29
74,8477220,Nate Schmidt,D,FLA,33,82,9,20,29
74,8477488,Brett Pesce,D,NJD,30,82,5,24,29
74,8481178,Egor Zamula,D,PHI,24,82,4,25,29
74,8474673,TJ Brodie,D,CHI,34,82,2,27,29
74,8480281,Alexey Toropchenko,R,STL,25,82,19,9,28
74,8483431,Logan Cooley,C,UTA,20,82,16,12,28
74,8479390,Taylor Raddysh,R,WSH,26,82,14,14,28
74,8481567,Henry Thrun,D,SJS,23,82,14,14,28
74,8477450,Jason Dickinson,C,CHI,29,82,13,15,28
74,8477353,Tyler Motte,C,DET,29,82,13,15,28
74,8475343,Nic Dowd,C,WSH,34,82,12,16,28
74,8482166,Shakir Mukhamadullin,D,SJS,22,82,11,17,28
74,8480789,Oliver Wahlstrom,R,NYI,24,82,10,18,28
74,8476897,Oskar Sundqvist,C,STL,30,82,9,19,28
74,8477406,Mattias Janmark,C,EDM,32,82,9,19,28
74,8479998,Mikey Anderson,D,LAK,25,82,6,22,28
74,8479976,Juuso Valimaki,D,UTA,26,82,5,23,28
74,8476422,Mike Reilly,D,NYI,31,82,3,25,28
74,8480950,Ilya Lyubushkin,D,DAL,30,82,3,25,28
74,8479316,Luke Kunin,C,SJS,27,82,18,9,27
74,8481553,Bobby Brink,R,PHI,23,82,15,12,27
74,8474715,Cam Atkinson,R,TBL,35,82,15,12,27
74,8484145,Zach Benson,L,BUF,19,82,14,13,27
74,8481028,Martin Pospisil,C,CGY,25,82,13,14,27
74,8481624,Ilya Mikheyev,R,CHI,30,82,11,16,27
74,8478013,Jake Walman,D,SJS,28,82,11,16,27
74,8480144,David Kampf,C,TOR,29,82,10,17,27
74,8480835,Jack Drury,C,CAR,24,82,9,18,27
74,8477369,Carson Soucy,D,VAN,30,82,7,20,27
74,8480860,Kevin Bahl,D,CGY,24,82,5,22,27
74,8483490,Pavel Mintyukov,D,ANA,21,82,5,22,27
74,8479402,Jake Bean,D,CGY,26,82,4,23,27
74,8476331,Dylan DeMelo,D,WPG,31,82,2,25,27
74,8477903,Garnet Hathaway,R,PHI,33,82,14,12,26
74,8481013,Jonatan Berggren,R,DET,24,82,13,13,26
74,8480855,Jack McBain,C,UTA,24,82,11,15,26
74,8482702,Logan Stankoven,C,DAL,21,82,10,16,26
74,8481481,Blake Lizotte,C,PIT,27,82,8,18,26
74,8478399,Jonas Siegenthaler,D,NJD,27,82,2,24,26
74,8479393,Noah Gregor,C,OTT,26,82,19,6,25
74,8482079,Marco Rossi,C,MIN,23,82,13,12,25
74,8479661,Tanner Jeannot,L,LAK,27,82,13,12,25
74,8477015,Connor Brown,R,EDM,30,82,10,15,25
74,8480448,Parker Kelly,L,COL,25,82,10,15,25
74,8480802,Ryan McLeod,C,BUF,25,82,9,16,25
74,8475855,Jesper Fast,R,CAR,33,82,9,16,25
74,8478133,Jake Evans,C,MTL,28,82,8,17,25
74,8477989,Christian Dvorak,C,MTL,28,82,8,17,25
74,8483493,Frank Nazar,C,CHI,20,82,8,17,25
74,8482245,Artem Zub,D,OTT,29,82,7,18,25
74,8476624,Barclay Goodrow,C,SJS,31,82,7,18,25
74,8482803,Olen Zellweger,D,ANA,21,82,6,19,25
74,8480074,Alexandre Texier,C,STL,25,82,6,19,25
74,8477435,Ryan Graves,D,PIT,29,82,5,20,25
74,8477499,Rasmus Ristolainen,D,PHI,30,82,3,22,25
74,8478507,John Marino,D,UTA,27,82,3,22,25
74,8482142,Jamie Drysdale,D,PHI,22,82,3,22,25
74,8477931,Tomas Nosek,L,FLA,32,82,9,15,24
74,8480003,Jesper Boqvist,C,FLA,26,82,8,16,24
74,8476902,Esa Lindell,D,DAL,30,82,7,17,24
74,8479398,Samuel Girard,D,COL,26,82,6,18,24
74,8476429,Scott Mayfield,D,NYI,32,82,6,18,24
74,8482655,J.J. Moser,D,TBL,24,82,5,19,24
74,8479324,Ryan Lindgren,D,NYR,26,82,5,19,24
74,8474151,Ryan McDonagh,D,TBL,35,82,4,20,24
74,8478416,Erik Cernak,D,TBL,27,82,4,20,24
74,8476967,Brett Kulak,D,EDM,30,82,4,20,24
74,8474090,Brendan Smith,D,DAL,35,82,4,20,24
74,8480049,Dylan Samberg,D,WPG,25,82,3,21,24
74,8476917,Adam Pelech,D,NYI,30,82,3,21,24
74,8478882,Vladislav Gavrikov,D,LAK,29,82,2,22,24
74,8477506,Ryan Pulock,D,NYI,30,82,1,23,24
74,8475324,Nick Jensen,D,OTT,34,82,1,23,24
74,8480222,Sebastian Aho,D,PIT,28,82,0,24,24
74,8478508,Yakov Trenin,C,MIN,27,82,16,7,23
74,8480806,Isac Lundestrom,C,ANA,25,82,11,12,23
74,8479414,Nathan Bastian,R,NJD,27,82,10,13,23
74,8478432,Christian Fischer,R,DET,27,82,10,13,23
74,8476889,Radek Faksa,C,STL,30,82,8,15,23
74,8480807,Mattias Samuelsson,D,BUF,24,82,7,16,23
74,8476312,Josh Manson,D,COL,33,82,6,17,23
74,8475181,Nick Leddy,D,STL,33,82,5,18,23
74,8482858,Ryker Evans,D,SEA,23,82,5,18,23
74,8470600,Ryan Suter,D,STL,39,82,4,19,23
74,8477392,Hudson Fasching,R,NYI,29,82,13,9,22
74,8480025,MacKenzie Entwistle,R,FLA,25,82,10,12,22
74,8482807,Ethan Del Mastro,D,CHI,21,82,10,12,22
74,8475200,Dmitry Orlov,D,CAR,33,82,9,13,22
74,8481093,Rafael Harvey-Pinard,L,MTL,25,82,9,13,22
74,8482666,Scott Morrow,D,CAR,22,82,9,13,22
74,8482749,Joshua Roy,R,MTL,21,82,8,14,22
74,8483445,Cutter Gauthier,L,ANA,20,82,8,14,22
74,8481517,Brett Leason,R,ANA,25,82,8,14,22
74,8478211,Dryden Hunt,L,CGY,29,82,7,15,22
74,8476879,Cody Ceci,D,EDM,31,82,3,19,22
74,8476372,Nick Seeler,D,PHI,31,82,3,19,22
74,8484166,Adam Fantilli,C,CBJ,20,82,13,8,21
74,8483524,Shane Wright,C,SEA,20,82,13,8,21
74,8481477,Nico Sturm,C,SJS,29,82,12,9,21
74,8482659,Josh Doan,R,UTA,22,82,12,9,21
74,8483505,Matthew Poitras,C,BOS,20,82,11,10,21
74,8473453,Trevor Lewis,C,LAK,37,82,11,10,21
74,8478109,Victor Olofsson,L,VGK,29,82,10,11,21
74,8477839,Conor Sheary,L,TBL,32,82,10,11,21
74,8477919,Frederick Gaudreau,C,MIN,31,82,8,13,21
74,8483565,Nick Blankenburg,D,NSH,26,82,8,13,21
74,8482809,Jackson Blake,R,CAR,21,82,7,14,21
74,8481014,Alexander Romanov,D,NYI,24,82,5,16,21
74,8479980,Nicolas Hague,D,VGK,26,82,4,17,21
74,8480796,Martin Fehervary,D,WSH,25,82,4,17,21
74,8483495,Simon Nemec,D,NJD,20,82,4,17,21
74,8479369,Andrew Peeke,D,BOS,26,82,3,18,21
74,8483482,Tristan Luneau,D,ANA,20,82,3,18,21
74,8475233,David Savard,D,MTL,34,82,3,18,21
74,8478500,Ivan Provorov,D,CBJ,27,82,2,19,21
74,8481601,Simon Holmstrom,R,NYI,23,82,14,6,20
74,8482077,Dylan Holloway,L,EDM,23,82,14,6,20
74,8476858,Phillip Di Giuseppe,L,VAN,31,82,13,7,20
74,8482679,Matt Coronato,R,CGY,22,82,10,10,20
74,8484203,Bradly Nadeau,L,CAR,19,82,8,12,20
74,8482101,Danil Gushchin,L,SJS,22,82,8,12,20
74,8484153,Leo Carlsson,C,ANA,20,82,6,14,20
74,8480246,Nick Perbix,D,TBL,26,82,6,14,20
74,8478136,Jake Middleton,D,MIN,28,82,5,15,20
74,8475279,Ben Chiarot,D,DET,33,82,4,16,20
74,8478840,Will Borgen,D,SEA,28,82,4,16,20
74,8480035,Henri Jokiharju,D,BUF,25,82,3,17,20
74,8475462,Radko Gudas,D,ANA,34,82,0,20,20
74,8481641,Joel Kiviranta,L,COL,28,82,12,7,19
74,8475842,Sam Carrick,C,NYR,32,82,11,8,19
74,8479359,Beck Malenstyn,L,BUF,26,82,10,9,19
74,8482074,Connor Zary,C,CGY,23,82,9,10,19
74,8482062,Cole Smith,L,NSH,29,82,9,10,19
74,8482118,Sam Colangelo,R,ANA,23,82,7,12,19
74,8477507,Nikita Zadorov,D,BOS,29,82,6,13,19
74,8480834,Ty Emberson,D,SJS,24,82,5,14,19
74,8476467,Jamie Oleksiak,D,SEA,32,82,4,15,19
74,8475455,Brenden Dillon,D,NJD,34,82,4,15,19
74,8478859,Niko Mikkola,D,FLA,28,82,4,15,19
74,8482087,Kaiden Guhle,D,MTL,22,82,3,16,19
74,8476878,Zemgus Girgensons,L,TBL,30,82,11,7,18
74,8482155,Alex Laferriere,R,LAK,23,82,9,9,18
74,8475231,Casey Cizikas,C,NYI,33,82,9,9,18
74,8478434,Keegan Kolesar,R,VGK,27,82,8,10,18
74,8477505,Alexander Wennberg,C,SJS,30,82,6,12,18
74,8481708,Zac Jones,D,NYR,24,82,4,14,18
74,8478468,Jeremy Lauzon,D,NSH,27,82,4,14,18
74,8482073,Braden Schneider,D,NYR,23,82,3,15,18
74,8476442,Matt Nieto,L,PIT,32,82,8,9,17
74,8483468,Jiri Kulich,C,BUF,20,82,8,9,17
74,8483499,Liam Ohgren,L,MIN,20,82,8,9,17
74,8484149,Gavin Brindley,C,CBJ,20,82,8,9,17
74,8482712,Oskar Olausson,R,COL,22,82,7,10,17
74,8479291,Kevin Rooney,C,CGY,31,82,7,10,17
74,8479442,Troy Stecher,D,EDM,30,82,7,10,17
74,8477335,Kyle Burroughs,D,LAK,29,82,7,10,17
74,8480073,Erik Brannstrom,D,COL,25,82,6,11,17
74,8483466,Kevin Korchinski,D,CHI,20,82,6,11,17
74,8477938,Haydn Fleury,D,WPG,28,82,5,12,17
74,8482470,Ilya Solovyov,D,CGY,24,82,4,13,17
74,8479371,Dante Fabbro,D,NSH,26,82,1,16,17
74,8480870,Bo Groulx,C,NYR,24,82,10,6,16
74,8484911,Collin Graf,R,SJS,22,82,7,9,16
74,8481524,Bowen Byram,D,BUF,23,82,5,11,16
74,8483471,Brad Lambert,C,WPG,31,82,5,11,16
74,8481699,Aku Raty,R,UTA,23,82,5,11,16
74,8479983,Mario Ferraro,D,SJS,26,82,3,13,16
74,8475762,Derek Forbort,D,VAN,32,82,3,13,16
74,8476891,Matt Grzelcyk,D,PIT,30,82,2,14,16
74,8477845,Trevor van Riemsdyk,D,WSH,33,82,2,14,16
74,8483397,Marc McLaughlin,C,BOS,25,82,8,7,15
74,8479368,Max Jones,L,BOS,26,82,7,8,15
74,8482145,Mavrik Bourque,C,DAL,22,82,7,8,15
74,8483460,David Jiricek,D,CBJ,21,82,6,9,15
74,8480990,Declan Chisholm,D,MIN,24,82,4,11,15
74,8481568,Alex Vlasic,D,CHI,23,82,3,12,15
74,8480879,Jacob Bernard-Docker,D,OTT,24,82,1,14,15
74,8482141,Lukas Cormier,D,VGK,22,82,0,15,15
74,8476822,Luke Glendening,C,TBL,35,82,10,4,14
74,8482713,Mackie Samoskevich,R,FLA,22,82,9,5,14
74,8483012,Logan Morrison,C,SEA,22,82,8,6,14
74,8481122,Simon Benoit,D,TOR,26,82,7,7,14
74,8474567,Zach Bogosian,D,MIN,34,82,3,11,14
74,8476441,Joel Edmundson,D,LAK,31,82,3,11,14
74,8478450,Parker Wotherspoon,D,BOS,27,82,1,13,14
74,8480021,Jack Studnicka,C,LAK,25,82,5,8,13
74,8478443,Brandon Carlo,D,BOS,28,82,3,10,13
74,8475177,Calvin de Haan,D,COL,33,82,2,11,13
74,8477034,Jaycob Megna,D,FLA,32,82,2,11,13
74,8481605,Jackson LaCombe,D,ANA,23,82,2,11,13
74,8478178,Darren Raddysh,D,TBL,28,82,2,11,13
74,8478874,Adam Gaudette,C,OTT,28,82,1,12,13
74,8482762,Simon Edvinsson,D,DET,21,82,7,5,12
74,8483763,Maksymilian Szuber,D,UTA,22,82,4,8,12
74,8474612,Travis Hamonic,D,OTT,34,82,1,11,12
74,8482153,Brendan Brisson,C,VGK,23,82,0,12,12
74,8480172,Jan Rutta,D,SJS,34,82,0,12,12
74,8479638,Justin Brazeau,R,BOS,26,82,4,7,11
74,8477365,Connor Clifton,D,BUF,29,82,3,8,11
74,8482516,Matthew Kessel,D,STL,24,82,3,8,11
74,8482787,Nikita Chibrikov,R,WPG,31,82,7,3,10
74,8482733,Logan Mailloux,D,MTL,31,82,3,7,10
74,8476473,Connor Murphy,D,CHI,31,82,2,8,10
74,8475718,Justin Holl,D,DET,32,82,1,9,10
74,8479576,Vincent Desharnais,D,VAN,28,82,2,7,9
74,8471677,Jack Johnson,D,CBJ,37,82,2,7,9
74,8483489,Fraser Minten,C,TOR,31,82,2,6,8
74,8483567,Georgii Merkulov,C,BOS,24,82,4,3,7
74,8482070,Mitchell Chaffee,R,TBL,26,82,4,3,7
74,8482859,Zack Ostapchuk,C,OTT,21,82,2,5,7
74,8474013,Ian Cole,D,UTA,35,82,0,7,7
74,8474062,Riley Nash,C,NYR,35,82,1,2,3
74,8470794,Joe Pavelski,C,,40,0,0,0,0
74,8481703,Valtteri Puustinen,R,PIT,25,0,0,0,0
74,8477950,Tony DeAngelo,D,,29,0,0,0,0
74,8481577,Philip Tomasino,C,NSH,23,0,0,0,0
74,8475197,Tyson Barrie,D,,33,0,0,0,0
74,8471218,Blake Wheeler,R,,38,0,0,0,0
74,8474157,Max Pacioretty,L,,36,0,0,0,0
74,8478466,Daniel Sprong,R,VAN,27,0,0,0,0
74,8475744,Evgeny Kuznetsov,C,,32,0,0,0,0
74,8481019,David Gustafsson,C,WPG,24,0,0,0,0
74,8475906,John Klingberg,D,,32,0,0,0,0
74,8479348,Kale Clague,D,BUF,26,0,0,0,0
74,8476952,Dominic Toninato,C,WPG,30,0,0,0,0
74,8473473,Milan Lucic,L,,36,0,0,0,0
74,8474037,James van Riemsdyk,L,,35,0,0,0,0
74,8474602,Justin Schultz,D,,34,0,0,0,0
74,8482222,Alexander Barabanov,L,,30,0,0,0,0
74,8479372,Josh Mahura,D,SEA,26,0,0,0,0
74,8479982,Conor Timmins,D,TOR,26,0,0,0,0
74,8474031,Kevin Shattenkirk,D,,35,0,0,0,0
74,8480008,Adam Ruzicka,C,,25,0,0,0,0
74,8481059,Scott Perunovich,D,STL,26,0,0,0,0
74,8480884,Calen Addison,D,,24,0,0,0,0
74,8476994,Vinnie Hinostroza,C,NSH,30,0,0,0,0
74,8478452,Caleb Jones,D,LAK,27,0,0,0,0
74,8480157,Calle Rosen,D,COL,30,0,0,0,0
74,8481609,Vladislav Kolyachonok,D,UTA,23,0,0,0,0
74,8479415,Michael McLeod,C,,26,0,0,0,0
74,8476919,Chris Tierney,C,,30,0,0,0,0
74,8479639,Dylan Coghlan,D,WPG,26,0,0,0,0
74,8478146,Matthew Highmore,C,OTT,28,0,0,0,0
74,8478970,Jalen Chatfield,D,CAR,28,0,0,0,0
74,8480205,Emil Bemstrom,C,PIT,25,0,0,0,0
74,8474884,Mike Hoffman,C,,35,0,0,0,0
74,8471274,Alex Goligoski,D,,39,0,0,0,0
74,8478104,Sammy Blais,L,,28,0,0,0,0
74,8474870,Tyler Johnson,C,,34,0,0,0,0
74,8476913,Devin Shore,C,MIN,30,0,0,0,0
74,8481598,Philip Broberg,D,EDM,23,0,0,0,0
74,8480058,Pierre-Olivier Joseph,D,STL,25,0,0,0,0
74,8480891,Michael Kesselring,D,UTA,24,0,0,0,0
74,8477979,Nicolas Aube-Kubel,R,BUF,28,0,0,0,0
74,8476871,Tanner Pearson,L,,32,0,0,0,0
74,8476393,Nick Cousins,C,,31,0,0,0,0
74,8479977,Kailer Yamamoto,R,,26,0,0,0,0
74,8479543,Michael Pezzetta,L,MTL,26,0,0,0,0
74,8477018,Ben Hutton,D,VGK,31,0,0,0,0
74,8480762,Eric Robinson,L,CAR,29,0,0,0,0
74,8474034,Pat Maroon,L,CHI,36,0,0,0,0
74,8481058,Jesse Ylönen,R,,25,0,0,0,0
74,8475179,Dmitry Kulikov,D,FLA,34,0,0,0,0
74,8481527,Kaedan Korczak,D,VGK,23,0,0,0,0
74,8473449,Kyle Okposo,R,,36,0,0,0,0
74,8482192,Isaak Phillips,D,CHI,23,0,0,0,0
74,8480727,Zach Whitecloud,D,VGK,28,0,0,0,0
74,8479346,Dillon Dube,C,,26,0,0,0,0
74,8480821,Filip Zadina,R,,25,0,0,0,0
74,8480001,Urho Vaakanainen,D,ANA,25,0,0,0,0
74,8470966,Mark Giordano,D,,41,0,0,0,0
74,8480853,Liam Foudy,C,,24,0,0,0,0
74,8475225,Craig Smith,C,CHI,35,0,0,0,0
74,8479972,Mason Shaw,C,WPG,26,0,0,0,0
74,8478451,Ethan Bear,D,WSH,27,0,0,0,0
74,8474040,Sam Gagner,C,,35,0,0,0,0
74,8480196,Jacob Bryson,D,BUF,27,0,0,0,0
74,8479984,Cal Foote,D,,26,0,0,0,0
74,8480011,Klim Kostin,C,SJS,25,0,0,0,0
74,8482176,Wyatt Kaiser,D,CHI,22,0,0,0,0
74,8476988,Matt Benning,D,SJS,30,0,0,0,0
74,8479370,Tyson Jost,C,CAR,26,0,0,0,0
74,8477464,Nic Petan,C,,29,0,0,0,0
74,8477380,Jonny Brodzinski,C,NYR,31,0,0,0,0
74,8480070,Ian Mitchell,D,BOS,25,0,0,0,0
74,8479315,Joey Anderson,R,CHI,26,0,0,0,0
74,8478099,Kevin Labanc,R,,29,0,0,0,0
74,8476874,Olli Maatta,D,DET,30,0,0,0,0
74,8475208,Brian Dumoulin,D,ANA,33,0,0,0,0
74,8478430,Oliver Kylington,D,,27,0,0,0,0
74,8479536,Axel Jonsson-Fjallby,L,WPG,26,0,0,0,0
74,8479671,Mathieu Olivier,R,CBJ,27,0,0,0,0
74,8471709,Marc-Edouard Vlasic,D,SJS,37,0,0,0,0
74,8479328,Julien Gauthier,R,NYI,27,0,0,0,0
74,8478421,A.J. Greer,L,FLA,28,0,0,0,0
74,8477573,Nathan Walker,L,STL,30,0,0,0,0
74,8481537,Nikita Okhotiuk,D,CGY,24,0,0,0,0
74,8474166,Alec Martinez,D,CHI,37,0,0,0,0
74,8470610,Zach Parise,L,,40,0,0,0,0
74,8477478,William Carrier,L,CAR,30,0,0,0,0
74,8479344,Jesse Puljujarvi,R,PIT,26,0,0,0,0
74,8480887,Jordan Harris,D,MTL,24,0,0,0,0
74,8478502,Dennis Gilbert,D,BUF,28,0,0,0,0
74,8482730,Brandt Clarke,D,LAK,21,0,0,0,0
74,8480355,Mark Kastelic,C,BOS,25,0,0,0,0
74,8475750,Jon Merrill,D,MIN,32,0,0,0,0
74,8475164,Jakob Silfverberg,R,,34,0,0,0,0
74,8477944,Jakub Vrana,L,,28,0,0,0,0
74,8479439,Jacob MacDonald,D,COL,31,0,0,0,0
74,8474568,Luke Schenn,D,NSH,35,0,0,0,0
74,8478454,Noah Juulsen,D,VAN,27,0,0,0,0
74,8475752,Tyler Pitlick,C,,33,0,0,0,0
74,8482148,Hendrix Lapierre,C,WSH,22,0,0,0,0
74,8481167,Brayden Pachal,D,CGY,25,0,0,0,0
74,8478043,Sam Lafferty,C,BUF,29,0,0,0,0
74,8479321,Lucas Johansen,D,,27,0,0,0,0
74,8471699,Andrew Cogliano,C,,37,0,0,0,0
74,8481521,Ronnie Attard,D,PHI,25,0,0,0,0
74,8481161,Jake Christiansen,D,CBJ,25,0,0,0,0
74,8479458,Nikita Zaitsev,D,,33,0,0,0,0
74,8479619,Michael Carcone,L,UTA,28,0,0,0,0
74,8479026,Philippe Myers,D,TOR,27,0,0,0,0
74,8477330,Dominik Kubalik,L,,29,0,0,0,0
74,8481617,Vasily Podkolzin,R,VAN,23,0,0,0,0
74,8481701,Santeri Hatakka,D,NJD,23,0,0,0,0
74,8479514,Rem Pitlick,C,,27,0,0,0,0
74,8477446,Michael McCarron,R,NSH,29,0,0,0,0
74,8470604,Jeff Carter,C,,39,0,0,0,0
74,8482241,Radim Zohorna,L,,28,0,0,0,0
74,8480289,Morgan Barron,C,WPG,26,0,0,0,0
74,8479379,Givani Smith,R,SJS,26,0,0,0,0
74,8480216,Jacob Peterson,C,,25,0,0,0,0
74,8477851,Jordan Oesterle,D,BOS,32,0,0,0,0
74,8484258,Sam Malinski,D,COL,26,0,0,0,0
74,8478904,Steven Lorentz,C,,28,0,0,0,0
74,8482095,Tyler Kleven,D,OTT,22,0,0,0,0
74,8480848,Ty Dellandrea,C,SJS,24,0,0,0,0
74,8476884,Derrick Pouliot,D,,30,0,0,0,0
74,8479336,Carl Grundstrom,R,SJS,27,0,0,0,0
74,8482964,Arber Xhekaj,D,MTL,23,0,0,0,0
74,8471686,Marc Staal,D,,37,0,0,0,0
74,8477887,Patrick Brown,C,BOS,32,0,0,0,0
74,8478495,Denis Gurianov,R,,27,0,0,0,0
74,8473504,Cal Clutterbuck,R,,37,0,0,0,0
74,8481550,Adam Beckman,L,NJD,23,0,0,0,0
74,8480845,Rasmus Kupari,C,WPG,24,0,0,0,0
74,8474009,Nick Bonino,C,,36,0,0,0,0
74,8478585,Derek Ryan,C,EDM,38,0,0,0,0
74,8477962,Brendan Lemieux,L,CAR,28,0,0,0,0
74,8482861,Vincent Iorio,D,WSH,22,0,0,0,0
74,8479378,Logan Stanley,D,WPG,26,0,0,0,0
74,8473446,Erik Johnson,D,PHI,36,0,0,0,0
74,8481743,Marc Del Gaizo,D,NSH,25,0,0,0,0
74,8477384,Josh Brown,D,EDM,30,0,0,0,0
74,8482165,Yan Kuznetsov,D,CGY,22,0,0,0,0
74,8478424,Jansen Harkins,C,ANA,27,0,0,0,0
74,8482144,Jack Thompson,D,SJS,22,0,0,0,0
74,8478512,Austin Czarnik,C,,32,0,0,0,0
74,8477527,Ross Johnston,L,ANA,30,0,0,0,0
74,8479383,Boris Katchouk,L,,26,0,0,0,0
74,8482094,Daemon Hunt,D,MIN,22,0,0,0,0
74,8481719,Maxwell Crozier,D,TBL,24,0,0,0,0
74,8480192,Johnathan Kovacevic,D,NJD,27,0,0,0,0
74,8479376,Victor Mete,D,,26,0,0,0,0
74,8482511,Mason Lohrei,D,BOS,23,0,0,0,0
74,8475825,Jani Hakanpää,D,,32,0,0,0,0
74,8478021,William Lagesson,D,DET,28,0,0,0,0
74,8475795,Dylan McIlrath,D,WSH,32,0,0,0,0
74,8477846,Ryan Carpenter,C,,33,0,0,0,0
74,8481056,Spencer Stastney,D,NSH,24,0,0,0,0
74,8481564,Ryan Johnson,D,BUF,23,0,0,0,0
74,8478017,Mark Friedman,D,VAN,29,0,0,0,0
74,8479320,Max Lajoie,D,SEA,27,0,0,0,0
74,8480075,Cameron Crotty,D,MIN,25,0,0,0,0
74,8484287,Cole McWard,D,VAN,23,0,0,0,0
74,8484254,Akito Hirose,D,VAN,25,0,0,0,0
74,8483407,Brandon Scanlin,D,NYR,25,0,0,0,0
74,8480274,Philip Kemp,D,EDM,25,0,0,0,0
74,8479522,Hardy Haman Aktell,D,WSH,26,0,0,0,0
74,8480007,Jonas Rondbjerg,R,VGK,25,0,0,0,0
74,8477454,Adam Erne,L,,29,0,0,0,0
74,8481679,Maxence Guenette,D,OTT,23,0,0,0,0
74,8480441,Trey Fix-Wolansky,R,CBJ,25,0,0,0,0
74,8483546,Marshall Rifai,D,TOR,26,0,0,0,0
74,8480084,Nick DeSimone,D,NJD,30,0,0,0,0
74,8481030,Jack St. Ivany,D,PIT,25,0,0,0,0
74,8481592,Jakob Pelletier,L,CGY,23,0,0,0,0
74,8478011,Louie Belpedio,D,PHI,28,0,0,0,0
74,8477930,Pierre-Edouard Bellemare,L,,39,0,0,0,0
74,8484321,Nikolas Matinpalo,D,OTT,26,0,0,0,0
74,8482067,Connor Mackey,D,NYR,28,0,0,0,0
74,8481806,Louis Crevier,D,CHI,23,0,0,0,0
74,8484326,Patrik Koch,D,UTA,28,0,0,0,0
74,8477971,Andreas Englund,D,LAK,28,0,0,0,0
74,8481751,Lukas Rousek,R,BUF,25,0,0,0,0
74,8481006,Tyler Tucker,D,STL,24,0,0,0,0
74,8476867,Brendan Gaunce,C,MIN,30,0,0,0,0
74,8479520,Brandon Duhaime,R,WSH,27,0,0,0,0
74,8477073,Kurtis MacDermid,L,NJD,30,0,0,0,0
74,8480874,Adam Ginning,D,PHI,24,0,0,0,0
74,8477473,Justin Bailey,R,SJS,29,0,0,0,0
74,8479066,Ryan Lomberg,L,CGY,30,0,0,0,0
74,8477070,Liam O'Brien,C,UTA,30,0,0,0,0
74,8474618,Marco Scandella,D,,34,0,0,0,0
74,8475797,Jarred Tinordi,D,,32,0,0,0,0
74,8481441,Joe Snively,C,DET,28,0,0,0,0
74,8477244,Chad Ruhwedel,D,NYR,34,0,0,0,0
74,8479772,Zack MacEwen,R,OTT,28,0,0,0,0
74,8481147,Reese Johnson,C,MIN,26,0,0,0,0
74,8481043,Cole Koepke,L,BOS,26,0,0,0,0
74,8483619,Filip Roos,D,OTT,25,0,0,0,0
74,8481541,Samuel Bolduc,D,NYI,24,0,0,0,0
74,8477810,Joel Hanley,D,CGY,33,0,0,0,0
74,8476907,Mackenzie MacEachern,L,,30,0,0,0,0
74,8482652,Walker Duehr,R,CGY,27,0,0,0,0
74,8477126,Jayson Megna,C,,34,0,0,0,0
74,8483398,Declan Carlile,D,TBL,31,0,0,0,0
74,8482929,Emil Lilleberg,D,TBL,23,0,0,0,0
74,8480880,Jakub Lauko,C,MIN,24,0,0,0,0
74,8480245,Olle Lycksell,R,PHI,25,0,0,0,0
74,8480252,Cole Guttman,C,CHI,25,0,0,0,0
74,8477467,Gustav Olofsson,D,SEA,30,0,0,0,0
74,8479968,Vinni Lettieri,C,BOS,29,0,0,0,0
74,8478400,Colin White,C,,27,0,0,0,0
74,8475755,Alexander Petrovic,D,DAL,32,0,0,0,0
74,8481812,Nikolai Knyzhov,D,,27,0,0,0,0
74,8481593,Jayden Struble,D,MTL,23,0,0,0,0
74,8481532,Alex Turcotte,C,LAK,23,0,0,0,0
74,8482126,Emil Andrae,D,PHI,31,0,0,0,0
74,8479944,Zach Aston-Reese,C,VGK,30,0,0,0,0
74,8471817,Ryan Reaves,R,TOR,37,0,0,0,0
74,8481206,John Ludvig,D,PIT,24,0,0,0,0
74,8481599,Victor Soderstrom,D,UTA,23,0,0,0,0
74,8480292,Carson Meyer,R,ANA,27,0,0,0,0
74,8482496,Nils Aman,C,VAN,24,0,0,0,0
74,8479718,Alex Barré-Boulet,C,MTL,27,0,0,0,0
74,8479994,Jaret Anderson-Dolan,C,WPG,25,0,0,0,0
74,8480184,Gustav Lindstrom,D,,26,0,0,0,0
74,8480890,Jan Jenik,R,OTT,24,0,0,0,0
74,8478067,Oskar Lindblom,L,,28,0,0,0,0
74,8476934,Brock McGinn,L,ANA,30,0,0,0,0
74,8479985,Cale Fleury,D,SEA,26,0,0,0,0
74,8484304,Uvis Balinskis,D,FLA,28,0,0,0,0
74,8479981,Jonah Gadjovich,L,FLA,26,0,0,0,0
74,8481716,Dmitri Voronkov,L,CBJ,24,0,0,0,0
74,8474709,Matt Martin,L,,35,0,0,0,0
74,8482634,Alex Steeves,C,TOR,25,0,0,0,0
74,8480823,Alexander Alexeyev,D,WSH,25,0,0,0,0
74,8477541,Dakota Mermis,D,TOR,30,0,0,0,0
74,8483491,Ivan Miroshnichenko,L,WSH,20,0,0,0,0
74,8478477,Mitchell Stephens,C,SEA,27,0,0,0,0
74,8481543,Nikita Alexandrov,C,STL,24,0,0,0,0
74,8479423,Alex Nylander,L,,26,0,0,0,0
74,8482451,Mikael Pyyhtia,L,CBJ,23,0,0,0,0
74,8478831,Kevin Stenlund,C,UTA,28,0,0,0,0
74,8480306,Grant Hutton,D,NYI,29,0,0,0,0
74,8478028,Fredrik Olofsson,L,,28,0,0,0,0
74,8477462,Robert Hagg,D,VGK,29,0,0,0,0
74,8477320,Anton Blidh,L,NYR,29,0,0,0,0
74,8482157,Will Cuylle,L,NYR,22,0,0,0,0
74,8482737,Zack Bolduc,C,STL,21,0,0,0,0
74,8481239,Samuel Fagemo,L,,24,0,0,0,0
74,8481600,Tobias Bjornfot,D,FLA,23,0,0,0,0
74,8478409,Anthony Richard,C,PHI,28,0,0,0,0
74,8474145,Robert Bortuzzo,D,,35,0,0,0,0
74,8475958,Michael Sgarbossa,C,WSH,32,0,0,0,0
74,8479986,Kole Lind,R,DAL,26,0,0,0,0
74,8479249,Andrew Poturalski,C,SJS,30,0,0,0,0
74,8479362,Riley Tufte,L,BOS,26,0,0,0,0
74,8479991,Jake Leschyshyn,C,NYR,25,0,0,0,0
74,8479587,Rhett Gardner,C,PHI,28,0,0,0,0
74,8482744,James Malatesta,L,CBJ,21,0,0,0,0
74,8478854,Ryan Shea,D,PIT,27,0,0,0,0
74,8481591,Sam Poulin,R,,23,0,0,0,0
74,8483512,Matt Savoie,C,EDM,20,0,0,0,0
74,8482102,Vasily Ponomarev,C,PIT,22,0,0,0,0
74,8482162,Roby Jarventie,L,EDM,22,0,0,0,0
74,8481016,Ruslan Iskhakov,C,,24,0,0,0,0
74,8482172,Landon Slaggert,L,CHI,22,0,0,0,0
74,8482747,Brennan Othmann,L,NYR,21,0,0,0,0
74,8480031,Maxime Comtois,L,,25,0,0,0,0
74,8480226,Marián Studenic,R,,26,0,0,0,0
74,8478408,Travis Dermott,D,,28,0,0,0,0
74,8481518,Nolan Foote,L,NJD,24,0,0,0,0
74,8479419,Brett Murray,L,BUF,26,0,0,0,0
74,8482088,Justin Sourdif,R,FLA,22,0,0,0,0
74,8482201,Gage Goncalves,C,TBL,23,0,0,0,0
74,8481578,Graeme Clarke,R,MIN,23,0,0,0,0
74,8482177,Marat Khusnutdinov,C,MIN,22,0,0,0,0
74,8481754,Nikita Nesterenko,C,ANA,23,0,0,0,0
74,8483531,Brian Halonen,L,NJD,25,0,0,0,0
74,8483920,Pierrick Dube,R,WSH,23,0,0,0,0
74,8480851,Akil Thomas,C,LAK,24,0,0,0,0
74,8475235,Nicolas Deslauriers,L,PHI,33,0,0,0,0
74,8482476,Emil Heineman,L,MTL,23,0,0,0,0
74,8477149,Scott Sabourin,R,SJS,32,0,0,0,0
74,8483549,Lucas Condotta,L,MTL,27,0,0,0,0
74,8482765,Isak Rosen,R,BUF,21,0,0,0,0
74,8481237,Kyle MacLean,C,NYI,25,0,0,0,0
74,8481024,Linus Karlsson,C,VAN,25,0,0,0,0
74,8481690,Tyler Angle,C,,24,0,0,0,0
74,8483570,Ben Meyers,C,SEA,26,0,0,0,0
74,8481655,Cole Schwindt,R,CGY,23,0,0,0,0
74,8481462,Mason Morelli,L,VGK,28,0,0,0,0
74,8483401,Marc Johnstone,R,PIT,28,0,0,0,0
74,8478956,Samuel Laberge,L,NJD,27,0,0,0,0
74,8479533,Joona Koppanen,L,,26,0,0,0,0
74,8482197,Adam Raska,R,MIN,23,0,0,0,0
74,8482250,Callahan Burke,C,VGK,27,0,0,0,0
74,8482784,Zach Dean,C,STL,21,0,0,0,0
74,8484255,Jason Polin,R,COL,25,0,0,0,0
74,8481077,John Leonard,L,,26,0,0,0,0
74,8481534,Raphael Lavoie,C,EDM,24,0,0,0,0
74,8483609,Adam Klapka,R,CGY,24,0,0,0,0
74,8482751,Ryan Winterton,C,SEA,21,0,0,0,0
74,8480267,Sammy Walker,C,MIN,25,0,0,0,0
74,8475766,Austin Watson,L,,32,0,0,0,0
74,8482460,Matt Rempe,C,NYR,22,0,0,0,0
74,8481065,Angus Crookshank,L,OTT,25,0,0,0,0
74,8481070,Hugh McGing,L,,26,0,0,0,0
74,8476323,Max McCormick,L,SEA,32,0,0,0,0
74,8483395,Arshdeep Bains,L,VAN,23,0,0,0,0
74,8484259,Ondrej Pavel,C,COL,31,0,0,0,0
74,8483432,Luca Del Bel Belluz,C,CBJ,31,0,0,0,0
74,8483045,Cameron Butler,R,CBJ,31,0,0,0,0
74,8482061,Brandon Biro,L,SEA,26,0,0,0,0
74,8477401,John Hayden,C,SEA,29,0,0,0,0
74,8475278,Byron Froese,C,,33,0,0,0,0
74,8478446,Glenn Gawdin,C,LAK,27,0,0,0,0
74,8477993,Justin Kirkland,C,CGY,28,0,0,0,0
74,8482147,Jean-Luc Foudy,C,COL,22,0,0,0,0
74,8480032,Shane Bowers,C,NJD,25,0,0,0,0
74,8479330,Brandon Gignac,C,MTL,27,0,0,0,0
74,8480776,Sheldon Rempal,R,,29,0,0,0,0
74,8475413,Justin Dowling,C,NJD,34,0,0,0,0
74,8481726,Adam Edstrom,C,NYR,24,0,0,0,0
74,8480844,Grigori Denisenko,L,VGK,24,0,0,0,0
74,8478147,Bokondji Imama,L,PIT,28,0,0,0,0
74,8478881,Brett Seney,L,CHI,28,0,0,0,0
74,8483630,Pavol Regenda,L,ANA,25,0,0,0,0
74,8480836,Jonathan Gruden,C,,24,0,0,0,0
74,8484314,Jiri Smejkal,L,,28,0,0,0,0
74,8475780,Chris Wagner,R,COL,33,0,0,0,0
74,8479546,Oskar Steen,C,,26,0,0,0,0
74,8483597,Milos Kelemen,L,UTA,25,0,0,0,0
74,8481789,Tye Kartye,L,SEA,23,0,0,0,0
74,8484325,Waltteri Merela,C,TBL,26,0,0,0,0
74,8479421,Jacob Moverare,D,LAK,26,0,0,0,0
74,8481585,Egor Afanasyev,L,SJS,23,0,0,0,0
74,8479547,Matthew Phillips,R,,26,0,0,0,0
74,8479367,William Lockwood,R,FLA,26,0,0,0,0
74,8476915,Jujhar Khaira,L,,30,0,0,0,0
74,8481422,Jacob Lucchini,C,NSH,29,0,0,0,0
74,8480468,James Hamblin,L,EDM,25,0,0,0,0
74,8478051,Max Willman,C,NJD,29,0,0,0,0
74,8481556,John Beecher,C,BOS,23,0,0,0,0
74,8478078,Rourke Chartier,C,,28,0,0,0,0
75,8477492,Nathan MacKinnon,C,COL,29,82,52,81,133
75,8476453,Nikita Kucherov,R,TBL,31,82,35,94,129
75,8477956,David Pastrnak,R,BOS,28,82,56,69,125
75,8479318,Auston Matthews,C,TOR,27,82,66,58,124
75,8478402,Connor McDavid,C,EDM,27,82,34,87,121
75,8478864,Kirill Kaprizov,L,MIN,27,82,55,63,118
75,8477946,Dylan Larkin,C,DET,28,82,54,58,112
75,8481559,Jack Hughes,C,NJD,23,82,47,65,112
75,8477934,Leon Draisaitl,C,EDM,29,82,41,71,112
75,8478420,Mikko Rantanen,R,COL,28,82,57,54,111
75,8478550,Artemi Panarin,L,NYR,33,82,36,73,109
75,8480069,Cale Makar,D,COL,26,82,28,77,105
75,8471675,Sidney Crosby,C,PIT,37,82,41,63,104
75,8479314,Matthew Tkachuk,L,FLA,27,82,36,68,104
75,8477404,Jake Guentzel,C,TBL,30,82,47,56,103
75,8476887,Filip Forsberg,L,NSH,30,82,43,54,97
75,8480027,Jason Robertson,L,DAL,25,82,38,58,96
75,8475692,Mats Zuccarello,R,MIN,37,82,27,68,95
75,8474564,Steven Stamkos,C,NSH,34,82,43,51,94
75,8476468,J.T. Miller,C,VAN,31,82,37,56,93
75,8475166,John Tavares,C,TOR,34,82,42,50,92
75,8474600,Roman Josi,D,NSH,34,82,24,67,91
75,8477447,Shea Theodore,D,VGK,29,82,20,71,91
75,8477501,Valeri Nichushkin,R,COL,29,82,47,43,90
75,8475913,Mark Stone,R,VGK,32,82,31,59,90
75,8477939,William Nylander,R,TOR,28,82,34,55,89
75,8480023,Robert Thomas,C,STL,25,82,30,59,89
75,8478010,Brayden Point,C,TBL,28,82,43,45,88
75,8478403,Jack Eichel,C,VGK,28,82,39,49,88
75,8477942,Kevin Fiala,L,LAK,28,82,34,54,88
75,8480801,Brady Tkachuk,L,OTT,25,82,42,44,86
75,8478427,Sebastian Aho,C,CAR,27,82,40,46,86
75,8479407,Jesper Bratt,L,NJD,26,82,25,61,86
75,8477933,Sam Reinhart,C,FLA,29,82,39,46,85
75,8478439,Travis Konecny,R,PHI,27,82,33,52,85
75,8477949,Alex Tuch,R,BUF,28,82,26,59,85
75,8478398,Kyle Connor,L,WPG,28,82,42,42,84
75,8474141,Patrick Kane,R,DET,36,82,39,45,84
75,8477402,Pavel Buchnevich,L,STL,29,82,36,48,84
75,8480036,Miro Heiskanen,D,DAL,25,82,18,66,84
75,8479420,Tage Thompson,C,BUF,27,82,50,33,83
75,8479343,Clayton Keller,R,UTA,26,82,31,52,83
75,8475172,Nazem Kadri,C,CGY,34,82,30,53,83
75,8473419,Brad Marchand,L,BOS,36,82,27,56,83
75,8478445,Mathew Barzal,C,NYI,27,82,16,67,83
75,8480800,Quinn Hughes,D,VAN,25,82,10,73,83
75,8482116,Tim Stützle,C,OTT,22,82,37,45,82
75,8477955,Jared McCann,L,SEA,28,82,34,48,82
75,8481557,Matt Boldy,L,MIN,23,82,28,53,81
75,8471724,Kris Letang,D,PIT,37,82,24,56,80
75,8479323,Adam Fox,D,NYR,26,82,22,58,80
75,8477493,Aleksander Barkov,C,FLA,29,82,21,59,80
75,8480012,Elias Pettersson,C,VAN,26,82,36,43,79
75,8477409,Carter Verhaeghe,C,FLA,29,82,36,42,78
75,8477960,Adrian Kempe,R,LAK,28,82,33,45,78
75,8476389,Vincent Trocheck,C,NYR,31,82,23,55,78
75,8480839,Rasmus Dahlin,D,BUF,24,82,19,59,78
75,8481523,Kirby Dach,C,MTL,23,82,18,58,76
75,8476853,Morgan Rielly,D,TOR,30,82,8,68,76
75,8480208,Drake Batherson,R,OTT,26,82,30,45,75
75,8473512,Claude Giroux,R,OTT,36,82,28,47,75
75,8481528,Dylan Cozens,C,BUF,23,82,27,48,75
75,8482097,Jack Quinn,R,BUF,23,82,23,52,75
75,8476539,Jonathan Marchessault,R,NSH,34,82,41,32,73
75,8478493,Joel Eriksson Ek,C,MIN,27,82,30,43,73
75,8478449,Roope Hintz,C,DAL,28,82,31,41,72
75,8471214,Alex Ovechkin,L,WSH,39,82,42,29,71
75,8479385,Jordan Kyrou,C,STL,26,82,34,37,71
75,8474578,Erik Karlsson,D,PIT,34,82,27,44,71
75,8476454,Ryan Nugent-Hopkins,C,EDM,31,82,26,45,71
75,8480803,Evan Bouchard,D,EDM,25,82,23,48,71
75,8474679,Gustav Nyquist,C,NSH,35,82,23,48,71
75,8475167,Victor Hedman,D,TBL,34,82,14,57,71
75,8477935,Sam Bennett,C,FLA,28,82,34,36,70
75,8476459,Mika Zibanejad,C,NYR,31,82,27,43,70
75,8471685,Anze Kopitar,C,LAK,37,82,19,51,70
75,8482665,Matty Beniers,C,SEA,22,82,32,37,69
75,8480830,Andrei Svechnikov,R,CAR,24,82,29,40,69
75,8480002,Nico Hischier,C,NJD,25,82,26,43,69
75,8479337,Alex DeBrincat,R,DET,27,82,27,41,68
75,8475765,Vladimir Tarasenko,R,DET,33,82,27,41,68
75,8480018,Nick Suzuki,C,MTL,25,82,20,48,68
75,8476456,Jonathan Huberdeau,C,CGY,31,82,16,52,68
75,8478397,Rasmus Andersson,D,CGY,28,82,13,54,67
75,8474102,David Perron,L,OTT,36,82,24,42,66
75,8474563,Drew Doughty,D,LAK,35,82,13,53,66
75,8475754,Brock Nelson,C,NYI,33,82,30,35,65
75,8477951,Nick Schmaltz,C,UTA,28,82,26,39,65
75,8476881,Tomas Hertl,C,VGK,31,82,26,39,65
75,8475184,Chris Kreider,L,NYR,33,82,46,18,64
75,8482093,Seth Jarvis,C,CAR,22,82,31,33,64
75,8480188,Fabian Zetterlund,L,SJS,25,82,28,36,64
75,8475168,Matt Duchene,C,DAL,33,82,24,40,64
75,8475798,Mikael Granlund,C,SJS,32,82,20,44,64
75,8474565,Alex Pietrangelo,D,VGK,34,82,15,48,63
75,8476346,Johnny Gaudreau,L,CBJ,31,82,11,52,63
75,8479542,Brandon Hagel,L,TBL,26,82,28,34,62
75,8479339,Patrik Laine,L,CBJ,26,82,26,36,62
75,8478401,Pavel Zacha,C,BOS,27,82,25,37,62
75,8479345,Jakob Chychrun,D,WSH,26,82,22,40,62
75,8481596,Shane Pinto,C,OTT,24,82,21,41,62
75,8477504,Josh Morrissey,D,WPG,29,82,15,47,62
75,8477986,Brandon Montour,D,SEA,30,82,14,48,62
75,8478414,Timo Meier,R,NJD,28,82,34,27,61
75,8480015,Owen Tippett,R,PHI,25,82,32,29,61
75,8480014,Gabriel Vilardi,C,WPG,25,82,30,31,61
75,8477407,Anthony Duclair,L,NYI,29,82,30,31,61
75,8477496,Elias Lindholm,C,BOS,30,82,26,35,61
75,8473994,Jamie Benn,L,DAL,35,82,22,39,61
75,8478469,Thomas Chabot,D,OTT,27,82,16,45,61
75,8476906,Shayne Gostisbehere,D,CAR,31,82,15,46,61
75,8475726,Tyler Toffoli,C,SJS,32,82,34,26,60
75,8475170,Brayden Schenn,C,STL,33,82,33,27,60
75,8475791,Taylor Hall,L,CHI,33,82,32,28,60
75,8479675,Trevor Moore,L,LAK,29,82,31,29,60
75,8476448,William Karlsson,C,VGK,31,82,29,31,60
75,8475810,Bryan Rust,R,PIT,32,82,25,35,60
75,8471215,Evgeni Malkin,C,PIT,38,82,23,37,60
75,8479325,Charlie McAvoy,D,BOS,27,82,12,48,60
75,8477511,Anthony Mantha,R,CGY,30,82,33,26,59
75,8477500,Bo Horvat,C,NYI,29,82,31,28,59
75,8477456,J.T. Compher,L,DET,29,82,28,31,59
75,8475784,Jeff Skinner,C,EDM,32,82,25,34,59
75,8478042,Viktor Arvidsson,R,EDM,31,82,24,35,59
75,8478975,Mason Marchment,L,DAL,29,82,23,36,59
75,8477451,Ryan Hartman,R,MIN,30,82,23,36,59
75,8477494,Jonathan Drouin,L,COL,29,82,13,46,59
75,8475753,Justin Faulk,D,STL,32,82,8,51,59
75,8477476,Artturi Lehkonen,L,COL,29,82,30,28,58
75,8478444,Brock Boeser,R,VAN,27,82,28,30,58
75,8482078,Lucas Raymond,L,DET,22,82,27,31,58
75,8478407,Vince Dunn,D,SEA,28,82,17,41,58
75,8475794,Tyler Seguin,C,DAL,32,82,29,28,57
75,8478856,Conor Garland,R,VAN,28,82,23,34,57
75,8476460,Mark Scheifele,C,WPG,31,82,19,38,57
75,8476882,Teuvo Teravainen,L,CHI,30,82,17,40,57
75,8478047,Michael Bunting,L,PIT,29,82,26,30,56
75,8478519,Anthony Cirelli,C,TBL,27,82,26,30,56
75,8482740,Wyatt Johnston,C,DAL,21,82,24,32,56
75,8477940,Nikolaj Ehlers,L,WPG,28,82,20,36,56
75,8475158,Ryan O'Reilly,C,NSH,33,82,19,37,56
75,8477416,Oliver Bjorkstrand,R,SEA,29,82,17,39,56
75,8476458,Ryan Strome,C,ANA,31,82,15,41,56
75,8480039,Martin Necas,C,CAR,25,82,25,30,55
75,8480865,Noah Dobson,D,NYI,24,82,8,47,55
75,8481542,Moritz Seider,D,DET,23,82,5,50,55
75,8480064,Josh Norris,C,OTT,25,82,33,21,54
75,8476399,Blake Coleman,C,CGY,33,82,32,22,54
75,8475722,Jason Zucker,L,BUF,32,82,29,25,54
75,8475786,Zach Hyman,L,EDM,32,82,27,27,54
75,8478396,Noah Hanifin,D,VGK,27,82,17,37,54
75,8479410,Mikhail Sergachev,D,UTA,26,82,11,43,54
75,8476854,Hampus Lindholm,D,BOS,30,82,8,46,54
75,8481540,Cole Caufield,R,MTL,23,82,32,21,53
75,8481068,Yegor Sharangovich,C,CGY,26,82,24,29,53
75,8478440,Dylan Strome,C,WSH,27,82,20,33,53
75,8481618,Alex Newhook,C,MTL,23,82,20,33,53
75,8475191,Reilly Smith,R,NYR,33,82,19,34,53
75,8479425,Filip Hronek,D,VAN,27,82,11,42,53
75,8477495,Seth Jones,D,CHI,30,82,10,43,53
75,8478873,Troy Terry,R,ANA,27,82,25,27,52
75,8482113,Anton Lundell,C,FLA,23,82,24,28,52
75,8473986,Alex Killorn,L,ANA,35,82,22,30,52
75,8482146,Luke Evangelista,R,NSH,22,82,21,31,52
75,8474586,Jordan Eberle,R,SEA,34,82,19,33,52
75,8476479,Phillip Danault,C,LAK,31,82,16,36,52
75,8480028,Morgan Frost,C,PHI,25,82,15,37,52
75,8476905,Chandler Stephenson,C,SEA,30,82,13,39,52
75,8478498,Jake DeBrusk,L,VAN,28,82,25,26,51
75,8476483,Rickard Rakell,R,PIT,31,82,24,27,51
75,8482110,Dawson Mercer,C,NJD,23,82,23,28,51
75,8477964,Ivan Barbashev,C,VGK,29,82,20,31,51
75,8474053,Logan Couture,C,SJS,35,82,19,32,51
75,8478038,Devon Toews,D,COL,30,82,8,43,51
75,8476432,Boone Jenner,C,CBJ,31,82,34,16,50
75,8475799,Nino Niederreiter,R,WPG,32,82,27,23,50
75,8482159,Tyson Foerster,R,PHI,22,82,24,26,50
75,8482124,Quinton Byfield,R,LAK,22,82,24,26,50
75,8474150,Mikael Backlund,C,CGY,35,82,23,27,50
75,8475745,Charlie Coyle,C,BOS,32,82,22,28,50
75,8479987,Morgan Geekie,C,BOS,26,82,22,28,50
75,8477479,Tyler Bertuzzi,L,CHI,29,82,19,31,50
75,8481711,Matias Maccelli,L,UTA,24,82,13,37,50
75,8476869,Brady Skjei,D,NSH,30,82,10,40,50
75,8482175,JJ Peterka,R,BUF,22,82,33,16,49
75,8475151,Kyle Palmieri,C,NYI,33,82,24,25,49
75,8483808,Andrei Kuzmenko,L,CGY,28,82,24,25,49
75,8480829,Jesperi Kotkaniemi,C,CAR,24,82,22,27,49
75,8482149,Cole Perfetti,C,WPG,22,82,22,27,49
75,8477503,Max Domi,C,TOR,29,82,17,32,49
75,8480078,Filip Chytil,C,NYR,25,82,15,34,49
75,8477346,MacKenzie Weegar,D,CGY,30,82,8,41,49
75,8477426,Nicholas Paul,L,TBL,29,82,24,24,48
75,8478463,Anthony Beauvillier,L,PIT,27,82,20,28,48
75,8479400,Pierre-Luc Dubois,L,WSH,26,82,19,29,48
75,8477932,Aaron Ekblad,D,FLA,28,82,15,33,48
75,8480871,Adam Boqvist,D,FLA,24,82,12,36,48
75,8482089,Jake Neighbours,L,STL,22,82,27,20,47
75,8482109,Alexis Lafrenière,L,NYR,23,82,23,24,47
75,8479999,Casey Mittelstadt,C,COL,26,82,17,30,47
75,8476921,Jordan Martinook,L,CAR,32,82,17,30,47
75,8476960,Andreas Athanasiou,C,CHI,30,82,17,30,47
75,8478460,Zach Werenski,D,CBJ,27,82,14,33,47
75,8476462,Dougie Hamilton,D,NJD,31,82,14,33,47
75,8480434,Sean Durzi,D,UTA,26,82,14,33,47
75,8482660,Kent Johnson,C,CBJ,22,82,11,36,47
75,8482671,Owen Power,D,BUF,22,82,10,37,47
75,8475768,Jaden Schwartz,C,SEA,32,82,23,23,46
75,8475169,Evander Kane,L,EDM,33,82,22,24,46
75,8477497,Sean Monahan,C,CBJ,30,82,21,25,46
75,8482699,Dylan Guenther,R,UTA,21,82,19,27,46
75,8474590,John Carlson,D,WSH,34,82,15,31,46
75,8476792,Torey Krug,D,STL,33,82,6,40,46
75,8480797,Joel Farabee,L,PHI,24,82,21,24,45
75,8475793,Ryan Johansen,C,PHI,32,82,21,24,45
75,8478462,Nicolas Roy,C,VGK,27,82,20,25,45
75,8482105,Jake Sanderson,D,OTT,22,82,10,35,45
75,8474641,Adam Henrique,C,EDM,34,82,24,20,44
75,8484144,Connor Bedard,C,CHI,19,82,22,22,44
75,8479365,Trent Frederic,C,BOS,26,82,22,22,44
75,8478046,Danton Heinen,L,VAN,29,82,21,23,44
75,8480068,Ryan Poehling,C,PHI,25,82,21,23,44
75,8478438,Tommy Novak,C,NSH,27,82,19,25,44
75,8478057,Dakota Joshua,C,VAN,28,82,18,26,44
75,8476880,Tom Wilson,R,WSH,30,82,17,27,44
75,8478472,Mathieu Joseph,R,STL,27,82,13,31,44
75,8478911,Matt Roy,D,WSH,29,82,7,37,44
75,8476875,Mike Matheson,D,MTL,30,82,5,39,44
75,8477998,Warren Foegele,L,LAK,28,82,22,21,43
75,8475848,Brendan Gallagher,R,MTL,32,82,21,22,43
75,8480798,Philipp Kurashev,C,CHI,25,82,17,26,43
75,8476292,Ondrej Palat,L,NJD,33,82,17,26,43
75,8470613,Brent Burns,D,CAR,39,82,13,30,43
75,8480835,Jack Drury,C,CAR,24,82,18,24,42
75,8480802,Ryan McLeod,C,BUF,25,82,18,24,42
75,8477429,Andrew Copp,C,DET,30,82,17,25,42
75,8481481,Blake Lizotte,C,PIT,27,82,15,27,42
75,8476461,Sean Couturier,C,PHI,32,82,14,28,42
75,8476826,Yanni Gourde,C,SEA,33,82,12,30,42
75,8480817,K'Andre Miller,D,NYR,24,82,12,30,42
75,8481546,Cam York,D,PHI,23,82,7,35,42
75,8480220,Noah Cates,L,PHI,25,82,22,19,41
75,8477987,Ryan Donato,C,CHI,28,82,21,20,41
75,8479996,Cody Glass,C,NSH,25,82,19,22,41
75,8482667,William Eklund,L,SJS,22,82,16,25,41
75,8478413,Jordan Greenway,L,BUF,27,82,16,25,41
75,8478458,Jack Roslovic,C,CAR,27,82,14,27,41
75,8478055,Gustav Forsling,D,FLA,28,82,10,31,41
75,8475760,Nick Bjugstad,C,UTA,32,82,23,17,40
75,8480009,Eeli Tolvanen,R,SEA,25,82,23,17,40
75,8480113,Alex Iafallo,L,WPG,31,82,18,22,40
75,8479525,Ross Colton,C,COL,28,82,16,24,40
75,8473563,Nicklas Backstrom,C,WSH,37,82,16,24,40
75,8481533,Trevor Zegras,C,ANA,23,82,15,25,40
75,8475314,Anders Lee,L,NYI,34,82,18,21,39
75,8478542,Evan Rodrigues,C,FLA,31,82,17,22,39
75,8476958,Jaccob Slavin,D,CAR,30,82,9,30,39
75,8477948,Travis Sanheim,D,PHI,28,82,9,30,39
75,8477969,Marcus Pettersson,D,PIT,28,82,7,32,39
75,8481604,Pavel Dorofeyev,L,VGK,24,82,22,16,38
75,8478115,Pierre Engvall,L,NYI,28,82,20,18,38
75,8477444,Andre Burakovsky,L,SEA,29,82,17,21,38
75,8476925,Colton Sissons,C,NSH,31,82,16,22,38
75,8482745,Mason McTavish,C,ANA,21,82,12,26,38
75,8476329,Travis Boyd,C,MIN,31,82,12,26,38
75,8480873,Rasmus Sandin,D,WSH,24,82,7,31,38
75,8476979,Erik Gustafsson,D,DET,32,82,2,36,38
75,8478366,Frank Vatrano,R,ANA,30,82,21,16,37
75,8481580,Connor McMichael,C,WSH,23,82,20,17,37
75,8481560,Arthur Kaliyev,R,LAK,23,82,19,18,37
75,8482720,Matthew Knies,L,TOR,22,82,19,18,37
75,8471698,T.J. Oshie,R,WSH,38,82,17,20,37
75,8483515,Juraj Slafkovsky,L,MTL,20,82,17,20,37
75,8478233,Andrew Mangiapane,L,WSH,28,82,13,24,37
75,8473507,Jeff Petry,D,DET,37,82,7,30,37
75,8476457,Adam Larsson,D,SEA,32,82,7,30,37
75,8476981,Josh Anderson,R,MTL,30,82,18,18,36
75,8477952,Robby Fabbri,C,ANA,28,82,17,19,36
75,8482055,Drew O'Connor,L,PIT,26,82,16,20,36
75,8482475,Yegor Chinakhov,R,CBJ,23,82,15,21,36
75,8478020,Michael Amadio,C,OTT,28,82,14,22,36
75,8477498,Darnell Nurse,D,EDM,29,82,9,27,36
75,8476331,Dylan DeMelo,D,WPG,31,82,7,29,36
75,8476463,Jonas Brodin,D,MIN,31,82,6,30,36
75,8481535,Nils Hoglander,L,VAN,24,82,18,17,35
75,8476392,Adam Lowry,C,WPG,31,82,17,18,35
75,8477021,Alex Kerfoot,C,UTA,30,82,16,19,35
75,8475763,Kevin Hayes,R,PIT,32,82,14,21,35
75,8480185,Eetu Luostarinen,C,FLA,26,82,14,21,35
75,8477953,Kasperi Kapanen,R,STL,28,82,12,23,35
75,8479351,Sam Steel,C,DAL,26,82,11,24,35
75,8476927,Teddy Blueger,C,VAN,30,82,9,26,35
75,8475181,Nick Leddy,D,STL,33,82,7,28,35
75,8480043,Timothy Liljegren,D,TOR,25,82,6,29,35
75,8479976,Juuso Valimaki,D,UTA,26,82,5,30,35
75,8479992,Michael Rasmussen,C,DET,25,82,20,14,34
75,8484145,Zach Benson,L,BUF,19,82,18,16,34
75,8480074,Alexandre Texier,C,STL,25,82,17,17,34
75,8476897,Oskar Sundqvist,C,STL,30,82,14,20,34
75,8480855,Jack McBain,C,UTA,24,82,14,20,34
75,8481477,Nico Sturm,C,SJS,29,82,14,20,34
75,8476480,Vladislav Namestnikov,C,WPG,32,82,10,24,34
75,8481013,Jonatan Berggren,R,DET,24,82,10,24,34
75,8476419,Jean-Gabriel Pageau,C,NYI,32,82,8,26,34
75,8474715,Cam Atkinson,R,TBL,35,82,21,12,33
75,8478508,Yakov Trenin,C,MIN,27,82,19,14,33
75,8482062,Cole Smith,L,NSH,29,82,19,14,33
75,8480849,Barrett Hayton,C,UTA,24,82,17,16,33
75,8478109,Victor Olofsson,L,VGK,29,82,17,16,33
75,8479353,Brett Howden,C,VGK,26,82,14,19,33
75,8481186,Logan O'Connor,R,COL,28,82,14,19,33
75,8477947,Sonny Milano,L,WSH,28,82,11,22,33
75,8476467,Jamie Oleksiak,D,SEA,32,82,10,23,33
75,8476872,Scott Laughton,C,PHI,30,82,8,25,33
75,8480336,Sean Walker,D,CAR,30,82,6,27,33
75,8476892,Colton Parayko,D,STL,31,82,5,28,33
75,8482655,J.J. Moser,D,TBL,24,82,5,28,33
75,8482684,Luke Hughes,D,NJD,21,82,2,31,33
75,8478500,Ivan Provorov,D,CBJ,27,82,2,31,33
75,8480035,Henri Jokiharju,D,BUF,25,82,2,31,33
75,8474149,Evgenii Dadonov,R,DAL,35,82,19,13,32
75,8482125,Alexander Holtz,R,VGK,22,82,16,16,32
75,8474189,Lars Eller,C,PIT,35,82,13,19,32
75,8475287,Erik Haula,L,NJD,33,82,12,20,32
75,8474716,Jared Spurgeon,D,MIN,35,82,11,21,32
75,8475149,Marcus Johansson,L,MIN,34,82,10,22,32
75,8476923,Damon Severson,D,CBJ,30,82,9,23,32
75,8477507,Nikita Zadorov,D,BOS,29,82,9,23,32
75,8474151,Ryan McDonagh,D,TBL,35,82,3,29,32
75,8473422,Nick Foligno,L,CHI,37,82,19,12,31
75,8475714,Calle Jarnkrok,C,TOR,33,82,18,13,31
75,8476438,Brandon Saad,L,STL,32,82,18,13,31
75,8479293,Brandon Tanev,L,SEA,33,82,17,14,31
75,8482705,Cole Sillinger,C,CBJ,21,82,14,17,31
75,8476278,Colin Blackwell,C,DAL,31,82,14,17,31
75,8476474,Stefan Noesen,R,NJD,31,82,13,18,31
75,8477450,Jason Dickinson,C,CHI,29,82,13,18,31
75,8481581,Thomas Harley,D,DAL,23,82,11,20,31
75,8470621,Corey Perry,R,EDM,39,82,11,20,31
75,8480003,Jesper Boqvist,C,FLA,26,82,10,21,31
75,8481553,Bobby Brink,R,PHI,23,82,9,22,31
75,8480878,Nils Lundkvist,D,DAL,24,82,5,26,31
75,8479998,Mikey Anderson,D,LAK,25,82,5,26,31
75,8476931,Jake McCabe,D,TOR,31,82,4,27,31
75,8479398,Samuel Girard,D,COL,26,82,4,27,31
75,8481568,Alex Vlasic,D,CHI,23,82,4,27,31
75,8475764,Cam Fowler,D,ANA,33,82,3,28,31
75,8480459,Pius Suter,C,VAN,28,82,18,12,30
75,8479368,Max Jones,L,BOS,26,82,18,12,30
75,8473533,Jordan Staal,C,CAR,36,82,16,14,30
75,8478474,Lawson Crouse,L,UTA,27,82,16,14,30
75,8482117,Lukas Reichel,L,CHI,22,82,12,18,30
75,8477989,Christian Dvorak,C,MTL,28,82,12,18,30
75,8481522,Peyton Krebs,C,BUF,23,82,11,19,30
75,8480813,Joe Veleno,C,DET,24,82,11,19,30
75,8475200,Dmitry Orlov,D,CAR,33,82,9,21,30
75,8479983,Mario Ferraro,D,SJS,26,82,6,24,30
75,8478840,Will Borgen,D,SEA,28,82,2,28,30
75,8479941,Justin Danforth,R,CBJ,31,82,16,13,29
75,8477931,Tomas Nosek,L,FLA,32,82,16,13,29
75,8480789,Oliver Wahlstrom,R,NYI,24,82,14,15,29
75,8482079,Marco Rossi,C,MIN,23,82,12,17,29
75,8475343,Nic Dowd,C,WSH,34,82,10,19,29
75,8479661,Tanner Jeannot,L,LAK,27,82,10,19,29
75,8481624,Ilya Mikheyev,R,CHI,30,82,8,21,29
75,8477365,Connor Clifton,D,BUF,29,82,4,25,29
75,8481554,Kaapo Kakko,R,NYR,23,82,18,10,28
75,8482092,Ridly Greig,C,OTT,22,82,17,11,28
75,8478891,Mason Appleton,C,WPG,28,82,17,11,28
75,8481093,Rafael Harvey-Pinard,L,MTL,25,82,17,11,28
75,8481582,Nicholas Robertson,L,TOR,23,82,16,12,28
75,8476918,Jimmy Vesey,L,NYR,31,82,16,12,28
75,8480748,Kiefer Sherwood,L,VAN,29,82,14,14,28
75,8475218,Mattias Ekholm,D,EDM,34,82,8,20,28
75,8470600,Ryan Suter,D,STL,39,82,8,20,28
75,8478569,Noel Acciari,C,PIT,33,82,7,21,28
75,8480807,Mattias Samuelsson,D,BUF,24,82,5,23,28
75,8480145,Neal Pionk,D,WPG,29,82,3,25,28
75,8482133,Thomas Bordeleau,C,SJS,22,82,15,12,27
75,8480893,Kirill Marchenko,R,CBJ,24,82,15,12,27
75,8481704,Juuso Parssinen,C,NSH,23,82,13,14,27
75,8477353,Tyler Motte,C,DET,29,82,13,14,27
75,8478013,Jake Walman,D,SJS,28,82,12,15,27
75,8483763,Maksymilian Szuber,D,UTA,22,82,12,15,27
75,8482111,Justin Barron,D,MTL,23,82,10,17,27
75,8481656,Aliaksei Protas,C,WSH,23,82,10,17,27
75,8477369,Carson Soucy,D,VAN,30,82,8,19,27
75,8475855,Jesper Fast,R,CAR,33,82,8,19,27
75,8478507,John Marino,D,UTA,27,82,6,21,27
75,8478136,Jake Middleton,D,MIN,28,82,6,21,27
75,8479591,Michael Eyssimont,C,TBL,28,82,5,22,27
75,8476525,Colin Miller,D,WPG,32,82,4,23,27
75,8477488,Brett Pesce,D,NJD,30,82,4,23,27
75,8474673,TJ Brodie,D,CHI,34,82,4,23,27
75,8477845,Trevor van Riemsdyk,D,WSH,33,82,2,25,27
75,8479390,Taylor Raddysh,R,WSH,26,82,15,11,26
75,8481032,Paul Cotter,C,NJD,25,82,13,13,26
75,8477919,Frederick Gaudreau,C,MIN,31,82,13,13,26
75,8482624,Daniil Miromanov,D,CGY,27,82,11,15,26
75,8476889,Radek Faksa,C,STL,30,82,11,15,26
75,8476374,Sean Kuraly,C,CBJ,31,82,9,17,26
75,8477499,Rasmus Ristolainen,D,PHI,30,82,9,17,26
75,8478443,Brandon Carlo,D,BOS,28,82,5,21,26
75,8475231,Casey Cizikas,C,NYI,33,82,13,12,25
75,8479316,Luke Kunin,C,SJS,27,82,12,13,25
75,8482666,Scott Morrow,D,CAR,22,82,9,16,25
75,8477506,Ryan Pulock,D,NYI,30,82,6,19,25
75,8482809,Jackson Blake,R,CAR,21,82,6,19,25
75,8480073,Erik Brannstrom,D,COL,25,82,6,19,25
75,8476469,Joel Armia,R,MTL,31,82,14,10,24
75,8483471,Brad Lambert,C,WPG,31,82,12,12,24
75,8480025,MacKenzie Entwistle,R,FLA,25,82,11,13,24
75,8476624,Barclay Goodrow,C,SJS,31,82,10,14,24
75,8481606,Jordan Spence,D,LAK,23,82,8,16,24
75,8482074,Connor Zary,C,CGY,23,82,8,16,24
75,8481178,Egor Zamula,D,PHI,24,82,7,17,24
75,8482142,Jamie Drysdale,D,PHI,22,82,6,18,24
75,8482087,Kaiden Guhle,D,MTL,22,82,6,18,24
75,8475171,Oliver Ekman-Larsson,D,TOR,33,82,5,19,24
75,8481567,Henry Thrun,D,SJS,23,82,5,19,24
75,8476917,Adam Pelech,D,NYI,30,82,4,20,24
75,8475324,Nick Jensen,D,OTT,34,82,4,20,24
75,8479371,Dante Fabbro,D,NSH,26,82,3,21,24
75,8483524,Shane Wright,C,SEA,20,82,15,8,23
75,8483431,Logan Cooley,C,UTA,20,82,13,10,23
75,8478432,Christian Fischer,R,DET,27,82,11,12,23
75,8475193,Tomas Tatar,L,NJD,34,82,8,15,23
75,8480980,Connor Dewar,C,TOR,25,82,8,15,23
75,8476429,Scott Mayfield,D,NYI,32,82,7,16,23
75,8478882,Vladislav Gavrikov,D,LAK,29,82,6,17,23
75,8481014,Alexander Romanov,D,NYI,24,82,6,17,23
75,8480246,Nick Perbix,D,TBL,26,82,6,17,23
75,8476312,Josh Manson,D,COL,33,82,5,18,23
75,8481708,Zac Jones,D,NYR,24,82,5,18,23
75,8482245,Artem Zub,D,OTT,29,82,4,19,23
75,8477435,Ryan Graves,D,PIT,29,82,3,20,23
75,8475718,Justin Holl,D,DET,32,82,2,21,23
75,8479402,Jake Bean,D,CGY,26,82,1,22,23
75,8484166,Adam Fantilli,C,CBJ,20,82,15,7,22
75,8476858,Phillip Di Giuseppe,L,VAN,31,82,15,7,22
75,8480281,Alexey Toropchenko,R,STL,25,82,14,8,22
75,8479414,Nathan Bastian,R,NJD,27,82,12,10,22
75,8476878,Zemgus Girgensons,L,TBL,30,82,11,11,22
75,8480995,Pontus Holmberg,R,TOR,25,82,10,12,22
75,8484203,Bradly Nadeau,L,CAR,19,82,10,12,22
75,8482141,Lukas Cormier,D,VGK,22,82,10,12,22
75,8482122,Brock Faber,D,MIN,22,82,9,13,22
75,8478211,Dryden Hunt,L,CGY,29,82,9,13,22
75,8477839,Conor Sheary,L,TBL,32,82,8,14,22
75,8479359,Beck Malenstyn,L,BUF,26,82,8,14,22
75,8478434,Keegan Kolesar,R,VGK,27,82,8,14,22
75,8481524,Bowen Byram,D,BUF,23,82,7,15,22
75,8477220,Nate Schmidt,D,FLA,33,82,6,16,22
75,8482166,Shakir Mukhamadullin,D,SJS,22,82,5,17,22
75,8482073,Braden Schneider,D,NYR,23,82,5,17,22
75,8480144,David Kampf,C,TOR,29,82,4,18,22
75,8475233,David Savard,D,MTL,34,82,2,20,22
75,8481601,Simon Holmstrom,R,NYI,23,82,9,12,21
75,8477903,Garnet Hathaway,R,PHI,33,82,8,13,21
75,8476873,Mark Jankowski,C,NSH,30,82,7,14,21
75,8476422,Mike Reilly,D,NYI,31,82,7,14,21
75,8482807,Ethan Del Mastro,D,CHI,21,82,7,14,21
75,8482101,Danil Gushchin,L,SJS,22,82,7,14,21
75,8474574,Tyler Myers,D,VAN,34,82,5,16,21
75,8478416,Erik Cernak,D,TBL,27,82,5,16,21
75,8477335,Kyle Burroughs,D,LAK,29,82,4,17,21
75,8478851,Alexandre Carrier,D,NSH,28,82,3,18,21
75,8476902,Esa Lindell,D,DAL,30,82,3,18,21
75,8480049,Dylan Samberg,D,WPG,25,82,3,18,21
75,8476879,Cody Ceci,D,EDM,31,82,3,18,21
75,8477425,Miles Wood,L,COL,29,82,15,5,20
75,8482155,Alex Laferriere,R,LAK,23,82,11,9,20
75,8482259,Bobby McMann,C,TOR,28,82,9,11,20
75,8475188,Brayden McNabb,D,VGK,33,82,4,16,20
75,8479324,Ryan Lindgren,D,NYR,26,82,4,16,20
75,8478450,Parker Wotherspoon,D,BOS,27,82,4,16,20
75,8477938,Haydn Fleury,D,WPG,28,82,3,17,20
75,8475690,Chris Tanev,D,TOR,35,82,2,18,20
75,8476442,Matt Nieto,L,PIT,32,82,10,9,19
75,8480806,Isac Lundestrom,C,ANA,25,82,9,10,19
75,8477015,Connor Brown,R,EDM,30,82,8,11,19
75,8484153,Leo Carlsson,C,ANA,20,82,8,11,19
75,8477505,Alexander Wennberg,C,SJS,30,82,7,12,19
75,8482858,Ryker Evans,D,SEA,23,82,6,13,19
75,8479980,Nicolas Hague,D,VGK,26,82,6,13,19
75,8483495,Simon Nemec,D,NJD,20,82,6,13,19
75,8475220,Marcus Foligno,L,MIN,33,82,5,14,19
75,8483565,Nick Blankenburg,D,NSH,26,82,4,15,19
75,8483468,Jiri Kulich,C,BUF,20,82,4,15,19
75,8475762,Derek Forbort,D,VAN,32,82,3,16,19
75,8478178,Darren Raddysh,D,TBL,28,82,3,16,19
75,8475455,Brenden Dillon,D,NJD,34,82,2,17,19
75,8477406,Mattias Janmark,C,EDM,32,82,8,10,18
75,8473453,Trevor Lewis,C,LAK,37,82,8,10,18
75,8482077,Dylan Holloway,L,EDM,23,82,8,10,18
75,8480950,Ilya Lyubushkin,D,DAL,30,82,6,12,18
75,8480222,Sebastian Aho,D,PIT,28,82,6,12,18
75,8478859,Niko Mikkola,D,FLA,28,82,6,12,18
75,8478468,Jeremy Lauzon,D,NSH,27,82,5,13,18
75,8482470,Ilya Solovyov,D,CGY,24,82,5,13,18
75,8474013,Ian Cole,D,UTA,35,82,5,13,18
75,8476885,Jacob Trouba,D,NYR,30,82,4,14,18
75,8483457,Lane Hutson,D,MTL,20,82,4,14,18
75,8480879,Jacob Bernard-Docker,D,OTT,24,82,4,14,18
75,8475177,Calvin de Haan,D,COL,33,82,4,14,18
75,8482803,Olen Zellweger,D,ANA,21,82,7,10,17
75,8478133,Jake Evans,C,MTL,28,82,6,11,17
75,8483466,Kevin Korchinski,D,CHI,20,82,6,11,17
75,8477508,Curtis Lazar,C,NJD,29,82,5,12,17
75,8480448,Parker Kelly,L,COL,25,82,5,12,17
75,8483445,Cutter Gauthier,L,ANA,20,82,4,13,17
75,8483482,Tristan Luneau,D,ANA,20,82,4,13,17
75,8478399,Jonas Siegenthaler,D,NJD,27,82,3,14,17
75,8475279,Ben Chiarot,D,DET,33,82,3,14,17
75,8477034,Jaycob Megna,D,FLA,32,82,2,15,17
75,8484149,Gavin Brindley,C,CBJ,20,82,10,6,16
75,8481641,Joel Kiviranta,L,COL,28,82,9,7,16
75,8479291,Kevin Rooney,C,CGY,31,82,9,7,16
75,8481517,Brett Leason,R,ANA,25,82,8,8,16
75,8482659,Josh Doan,R,UTA,22,82,8,8,16
75,8482712,Oskar Olausson,R,COL,22,82,8,8,16
75,8480021,Jack Studnicka,C,LAK,25,82,8,8,16
75,8482702,Logan Stankoven,C,DAL,21,82,5,11,16
75,8477392,Hudson Fasching,R,NYI,29,82,5,11,16
75,8479393,Noah Gregor,C,OTT,26,82,4,12,16
75,8480834,Ty Emberson,D,SJS,24,82,3,13,16
75,8483397,Marc McLaughlin,C,BOS,25,82,9,6,15
75,8483493,Frank Nazar,C,CHI,20,82,6,9,15
75,8483499,Liam Ohgren,L,MIN,20,82,6,9,15
75,8483490,Pavel Mintyukov,D,ANA,21,82,5,10,15
75,8482762,Simon Edvinsson,D,DET,21,82,4,11,15
75,8476967,Brett Kulak,D,EDM,30,82,2,13,15
75,8480172,Jan Rutta,D,SJS,34,82,2,13,15
75,8482118,Sam Colangelo,R,ANA,23,82,8,6,14
75,8479442,Troy Stecher,D,EDM,30,82,5,9,14
75,8480860,Kevin Bahl,D,CGY,24,82,3,11,14
75,8475462,Radko Gudas,D,ANA,34,82,2,12,14
75,8479369,Andrew Peeke,D,BOS,26,82,1,13,14
75,8482787,Nikita Chibrikov,R,WPG,31,82,8,5,13
75,8476822,Luke Glendening,C,TBL,35,82,7,6,13
75,8482679,Matt Coronato,R,CGY,22,82,6,7,13
75,8479638,Justin Brazeau,R,BOS,26,82,5,8,13
75,8481699,Aku Raty,R,UTA,23,82,3,10,13
75,8471677,Jack Johnson,D,CBJ,37,82,2,11,13
75,8476473,Connor Murphy,D,CHI,31,82,1,12,13
75,8483460,David Jiricek,D,CBJ,21,82,0,13,13
75,8482070,Mitchell Chaffee,R,TBL,26,82,9,3,12
75,8482749,Joshua Roy,R,MTL,21,82,6,6,12
75,8475842,Sam Carrick,C,NYR,32,82,6,6,12
75,8480870,Bo Groulx,C,NYR,24,82,5,7,12
75,8480990,Declan Chisholm,D,MIN,24,82,5,7,12
75,8483012,Logan Morrison,C,SEA,22,82,5,7,12
75,8481028,Martin Pospisil,C,CGY,25,82,4,8,12
75,8481122,Simon Benoit,D,TOR,26,82,3,9,12
75,8482733,Logan Mailloux,D,MTL,31,82,3,9,12
75,8480796,Martin Fehervary,D,WSH,25,82,2,10,12
75,8479576,Vincent Desharnais,D,VAN,28,82,2,10,12
75,8476891,Matt Grzelcyk,D,PIT,30,82,0,12,12
75,8474567,Zach Bogosian,D,MIN,34,82,4,7,11
75,8481605,Jackson LaCombe,D,ANA,23,82,4,7,11
75,8482153,Brendan Brisson,C,VGK,23,82,4,7,11
75,8476372,Nick Seeler,D,PHI,31,82,3,8,11
75,8482859,Zack Ostapchuk,C,OTT,21,82,3,8,11
75,8475790,Erik Gudbranson,D,CBJ,32,82,2,9,11
75,8474090,Brendan Smith,D,DAL,35,82,2,9,11
75,8474062,Riley Nash,C,NYR,35,82,2,9,11
75,8483489,Fraser Minten,C,TOR,31,82,3,7,10
75,8474612,Travis Hamonic,D,OTT,34,82,0,10,10
75,8483505,Matthew Poitras,C,BOS,20,82,5,4,9
75,8482713,Mackie Samoskevich,R,FLA,22,82,4,5,9
75,8484911,Collin Graf,R,SJS,22,82,3,6,9
75,8482145,Mavrik Bourque,C,DAL,22,82,3,6,9
75,8483567,Georgii Merkulov,C,BOS,24,82,2,7,9
75,8476441,Joel Edmundson,D,LAK,31,82,0,8,8
75,8478874,Adam Gaudette,C,OTT,28,82,0,6,6
75,8482516,Matthew Kessel,D,STL,24,82,0,6,6
75,8470794,Joe Pavelski,C,,40,0,0,0,0
75,8481703,Valtteri Puustinen,R,PIT,25,0,0,0,0
75,8477950,Tony DeAngelo,D,,29,0,0,0,0
75,8481577,Philip Tomasino,C,NSH,23,0,0,0,0
75,8475197,Tyson Barrie,D,,33,0,0,0,0
75,8471218,Blake Wheeler,R,,38,0,0,0,0
75,8474157,Max Pacioretty,L,,36,0,0,0,0
75,8478466,Daniel Sprong,R,VAN,27,0,0,0,0
75,8475744,Evgeny Kuznetsov,C,,32,0,0,0,0
75,8481019,David Gustafsson,C,WPG,24,0,0,0,0
75,8475906,John Klingberg,D,,32,0,0,0,0
75,8479348,Kale Clague,D,BUF,26,0,0,0,0
75,8476952,Dominic Toninato,C,WPG,30,0,0,0,0
75,8473473,Milan Lucic,L,,36,0,0,0,0
75,8474037,James van Riemsdyk,L,,35,0,0,0,0
75,8474602,Justin Schultz,D,,34,0,0,0,0
75,8482222,Alexander Barabanov,L,,30,0,0,0,0
75,8479372,Josh Mahura,D,SEA,26,0,0,0,0
75,8479982,Conor Timmins,D,TOR,26,0,0,0,0
75,8474031,Kevin Shattenkirk,D,,35,0,0,0,0
75,8480008,Adam Ruzicka,C,,25,0,0,0,0
75,8481059,Scott Perunovich,D,STL,26,0,0,0,0
75,8480884,Calen Addison,D,,24,0,0,0,0
75,8476994,Vinnie Hinostroza,C,NSH,30,0,0,0,0
75,8478452,Caleb Jones,D,LAK,27,0,0,0,0
75,8480157,Calle Rosen,D,COL,30,0,0,0,0
75,8481609,Vladislav Kolyachonok,D,UTA,23,0,0,0,0
75,8479415,Michael McLeod,C,,26,0,0,0,0
75,8476919,Chris Tierney,C,,30,0,0,0,0
75,8479639,Dylan Coghlan,D,WPG,26,0,0,0,0
75,8478146,Matthew Highmore,C,OTT,28,0,0,0,0
75,8478970,Jalen Chatfield,D,CAR,28,0,0,0,0
75,8480205,Emil Bemstrom,C,PIT,25,0,0,0,0
75,8474884,Mike Hoffman,C,,35,0,0,0,0
75,8471274,Alex Goligoski,D,,39,0,0,0,0
75,8478104,Sammy Blais,L,,28,0,0,0,0
75,8474870,Tyler Johnson,C,,34,0,0,0,0
75,8476913,Devin Shore,C,MIN,30,0,0,0,0
75,8481598,Philip Broberg,D,EDM,23,0,0,0,0
75,8480058,Pierre-Olivier Joseph,D,STL,25,0,0,0,0
75,8480891,Michael Kesselring,D,UTA,24,0,0,0,0
75,8477979,Nicolas Aube-Kubel,R,BUF,28,0,0,0,0
75,8476871,Tanner Pearson,L,,32,0,0,0,0
75,8476393,Nick Cousins,C,,31,0,0,0,0
75,8479977,Kailer Yamamoto,R,,26,0,0,0,0
75,8479543,Michael Pezzetta,L,MTL,26,0,0,0,0
75,8477018,Ben Hutton,D,VGK,31,0,0,0,0
75,8480762,Eric Robinson,L,CAR,29,0,0,0,0
75,8474034,Pat Maroon,L,CHI,36,0,0,0,0
75,8481058,Jesse Ylönen,R,,25,0,0,0,0
75,8475179,Dmitry Kulikov,D,FLA,34,0,0,0,0
75,8481527,Kaedan Korczak,D,VGK,23,0,0,0,0
75,8473449,Kyle Okposo,R,,36,0,0,0,0
75,8482192,Isaak Phillips,D,CHI,23,0,0,0,0
75,8480727,Zach Whitecloud,D,VGK,28,0,0,0,0
75,8479346,Dillon Dube,C,,26,0,0,0,0
75,8480821,Filip Zadina,R,,25,0,0,0,0
75,8480001,Urho Vaakanainen,D,ANA,25,0,0,0,0
75,8470966,Mark Giordano,D,,41,0,0,0,0
75,8480853,Liam Foudy,C,,24,0,0,0,0
75,8475225,Craig Smith,C,CHI,35,0,0,0,0
75,8479972,Mason Shaw,C,WPG,26,0,0,0,0
75,8478451,Ethan Bear,D,WSH,27,0,0,0,0
75,8474040,Sam Gagner,C,,35,0,0,0,0
75,8480196,Jacob Bryson,D,BUF,27,0,0,0,0
75,8479984,Cal Foote,D,,26,0,0,0,0
75,8480011,Klim Kostin,C,SJS,25,0,0,0,0
75,8482176,Wyatt Kaiser,D,CHI,22,0,0,0,0
75,8476988,Matt Benning,D,SJS,30,0,0,0,0
75,8479370,Tyson Jost,C,CAR,26,0,0,0,0
75,8477464,Nic Petan,C,,29,0,0,0,0
75,8477380,Jonny Brodzinski,C,NYR,31,0,0,0,0
75,8480070,Ian Mitchell,D,BOS,25,0,0,0,0
75,8479315,Joey Anderson,R,CHI,26,0,0,0,0
75,8478099,Kevin Labanc,R,,29,0,0,0,0
75,8476874,Olli Maatta,D,DET,30,0,0,0,0
75,8475208,Brian Dumoulin,D,ANA,33,0,0,0,0
75,8478430,Oliver Kylington,D,,27,0,0,0,0
75,8479536,Axel Jonsson-Fjallby,L,WPG,26,0,0,0,0
75,8479671,Mathieu Olivier,R,CBJ,27,0,0,0,0
75,8471709,Marc-Edouard Vlasic,D,SJS,37,0,0,0,0
75,8479328,Julien Gauthier,R,NYI,27,0,0,0,0
75,8478421,A.J. Greer,L,FLA,28,0,0,0,0
75,8477573,Nathan Walker,L,STL,30,0,0,0,0
75,8481537,Nikita Okhotiuk,D,CGY,24,0,0,0,0
75,8474166,Alec Martinez,D,CHI,37,0,0,0,0
75,8470610,Zach Parise,L,,40,0,0,0,0
75,8477478,William Carrier,L,CAR,30,0,0,0,0
75,8479344,Jesse Puljujarvi,R,PIT,26,0,0,0,0
75,8480887,Jordan Harris,D,MTL,24,0,0,0,0
75,8478502,Dennis Gilbert,D,BUF,28,0,0,0,0
75,8482730,Brandt Clarke,D,LAK,21,0,0,0,0
75,8480355,Mark Kastelic,C,BOS,25,0,0,0,0
75,8475750,Jon Merrill,D,MIN,32,0,0,0,0
75,8475164,Jakob Silfverberg,R,,34,0,0,0,0
75,8477944,Jakub Vrana,L,,28,0,0,0,0
75,8479439,Jacob MacDonald,D,COL,31,0,0,0,0
75,8474568,Luke Schenn,D,NSH,35,0,0,0,0
75,8478454,Noah Juulsen,D,VAN,27,0,0,0,0
75,8475752,Tyler Pitlick,C,,33,0,0,0,0
75,8482148,Hendrix Lapierre,C,WSH,22,0,0,0,0
75,8481167,Brayden Pachal,D,CGY,25,0,0,0,0
75,8478043,Sam Lafferty,C,BUF,29,0,0,0,0
75,8479321,Lucas Johansen,D,,27,0,0,0,0
75,8471699,Andrew Cogliano,C,,37,0,0,0,0
75,8481521,Ronnie Attard,D,PHI,25,0,0,0,0
75,8481161,Jake Christiansen,D,CBJ,25,0,0,0,0
75,8479458,Nikita Zaitsev,D,,33,0,0,0,0
75,8479619,Michael Carcone,L,UTA,28,0,0,0,0
75,8479026,Philippe Myers,D,TOR,27,0,0,0,0
75,8477330,Dominik Kubalik,L,,29,0,0,0,0
75,8481617,Vasily Podkolzin,R,VAN,23,0,0,0,0
75,8481701,Santeri Hatakka,D,NJD,23,0,0,0,0
75,8479514,Rem Pitlick,C,,27,0,0,0,0
75,8477446,Michael McCarron,R,NSH,29,0,0,0,0
75,8470604,Jeff Carter,C,,39,0,0,0,0
75,8482241,Radim Zohorna,L,,28,0,0,0,0
75,8480289,Morgan Barron,C,WPG,26,0,0,0,0
75,8479379,Givani Smith,R,SJS,26,0,0,0,0
75,8480216,Jacob Peterson,C,,25,0,0,0,0
75,8477851,Jordan Oesterle,D,BOS,32,0,0,0,0
75,8484258,Sam Malinski,D,COL,26,0,0,0,0
75,8478904,Steven Lorentz,C,,28,0,0,0,0
75,8482095,Tyler Kleven,D,OTT,22,0,0,0,0
75,8480848,Ty Dellandrea,C,SJS,24,0,0,0,0
75,8476884,Derrick Pouliot,D,,30,0,0,0,0
75,8479336,Carl Grundstrom,R,SJS,27,0,0,0,0
75,8482964,Arber Xhekaj,D,MTL,23,0,0,0,0
75,8471686,Marc Staal,D,,37,0,0,0,0
75,8477887,Patrick Brown,C,BOS,32,0,0,0,0
75,8478495,Denis Gurianov,R,,27,0,0,0,0
75,8473504,Cal Clutterbuck,R,,37,0,0,0,0
75,8481550,Adam Beckman,L,NJD,23,0,0,0,0
75,8480845,Rasmus Kupari,C,WPG,24,0,0,0,0
75,8474009,Nick Bonino,C,,36,0,0,0,0
75,8478585,Derek Ryan,C,EDM,38,0,0,0,0
75,8477962,Brendan Lemieux,L,CAR,28,0,0,0,0
75,8482861,Vincent Iorio,D,WSH,22,0,0,0,0
75,8479378,Logan Stanley,D,WPG,26,0,0,0,0
75,8473446,Erik Johnson,D,PHI,36,0,0,0,0
75,8481743,Marc Del Gaizo,D,NSH,25,0,0,0,0
75,8477384,Josh Brown,D,EDM,30,0,0,0,0
75,8482165,Yan Kuznetsov,D,CGY,22,0,0,0,0
75,8478424,Jansen Harkins,C,ANA,27,0,0,0,0
75,8482144,Jack Thompson,D,SJS,22,0,0,0,0
75,8478512,Austin Czarnik,C,,32,0,0,0,0
75,8477527,Ross Johnston,L,ANA,30,0,0,0,0
75,8479383,Boris Katchouk,L,,26,0,0,0,0
75,8482094,Daemon Hunt,D,MIN,22,0,0,0,0
75,8481719,Maxwell Crozier,D,TBL,24,0,0,0,0
75,8480192,Johnathan Kovacevic,D,NJD,27,0,0,0,0
75,8479376,Victor Mete,D,,26,0,0,0,0
75,8482511,Mason Lohrei,D,BOS,23,0,0,0,0
75,8475825,Jani Hakanpää,D,,32,0,0,0,0
75,8478021,William Lagesson,D,DET,28,0,0,0,0
75,8475795,Dylan McIlrath,D,WSH,32,0,0,0,0
75,8477846,Ryan Carpenter,C,,33,0,0,0,0
75,8481056,Spencer Stastney,D,NSH,24,0,0,0,0
75,8481564,Ryan Johnson,D,BUF,23,0,0,0,0
75,8478017,Mark Friedman,D,VAN,29,0,0,0,0
75,8479320,Max Lajoie,D,SEA,27,0,0,0,0
75,8480075,Cameron Crotty,D,MIN,25,0,0,0,0
75,8484287,Cole McWard,D,VAN,23,0,0,0,0
75,8484254,Akito Hirose,D,VAN,25,0,0,0,0
75,8483407,Brandon Scanlin,D,NYR,25,0,0,0,0
75,8480274,Philip Kemp,D,EDM,25,0,0,0,0
75,8479522,Hardy Haman Aktell,D,WSH,26,0,0,0,0
75,8480007,Jonas Rondbjerg,R,VGK,25,0,0,0,0
75,8477454,Adam Erne,L,,29,0,0,0,0
75,8481679,Maxence Guenette,D,OTT,23,0,0,0,0
75,8480441,Trey Fix-Wolansky,R,CBJ,25,0,0,0,0
75,8483546,Marshall Rifai,D,TOR,26,0,0,0,0
75,8480084,Nick DeSimone,D,NJD,30,0,0,0,0
75,8481030,Jack St. Ivany,D,PIT,25,0,0,0,0
75,8481592,Jakob Pelletier,L,CGY,23,0,0,0,0
75,8478011,Louie Belpedio,D,PHI,28,0,0,0,0
75,8477930,Pierre-Edouard Bellemare,L,,39,0,0,0,0
75,8484321,Nikolas Matinpalo,D,OTT,26,0,0,0,0
75,8482067,Connor Mackey,D,NYR,28,0,0,0,0
75,8481806,Louis Crevier,D,CHI,23,0,0,0,0
75,8484326,Patrik Koch,D,UTA,28,0,0,0,0
75,8477971,Andreas Englund,D,LAK,28,0,0,0,0
75,8481751,Lukas Rousek,R,BUF,25,0,0,0,0
75,8481006,Tyler Tucker,D,STL,24,0,0,0,0
75,8476867,Brendan Gaunce,C,MIN,30,0,0,0,0
75,8479520,Brandon Duhaime,R,WSH,27,0,0,0,0
75,8477073,Kurtis MacDermid,L,NJD,30,0,0,0,0
75,8480874,Adam Ginning,D,PHI,24,0,0,0,0
75,8477473,Justin Bailey,R,SJS,29,0,0,0,0
75,8479066,Ryan Lomberg,L,CGY,30,0,0,0,0
75,8477070,Liam O'Brien,C,UTA,30,0,0,0,0
75,8474618,Marco Scandella,D,,34,0,0,0,0
75,8475797,Jarred Tinordi,D,,32,0,0,0,0
75,8481441,Joe Snively,C,DET,28,0,0,0,0
75,8477244,Chad Ruhwedel,D,NYR,34,0,0,0,0
75,8479772,Zack MacEwen,R,OTT,28,0,0,0,0
75,8481147,Reese Johnson,C,MIN,26,0,0,0,0
75,8481043,Cole Koepke,L,BOS,26,0,0,0,0
75,8483619,Filip Roos,D,OTT,25,0,0,0,0
75,8481541,Samuel Bolduc,D,NYI,24,0,0,0,0
75,8477810,Joel Hanley,D,CGY,33,0,0,0,0
75,8476907,Mackenzie MacEachern,L,,30,0,0,0,0
75,8482652,Walker Duehr,R,CGY,27,0,0,0,0
75,8477126,Jayson Megna,C,,34,0,0,0,0
75,8483398,Declan Carlile,D,TBL,31,0,0,0,0
75,8482929,Emil Lilleberg,D,TBL,23,0,0,0,0
75,8480880,Jakub Lauko,C,MIN,24,0,0,0,0
75,8480245,Olle Lycksell,R,PHI,25,0,0,0,0
75,8480252,Cole Guttman,C,CHI,25,0,0,0,0
75,8477467,Gustav Olofsson,D,SEA,30,0,0,0,0
75,8479968,Vinni Lettieri,C,BOS,29,0,0,0,0
75,8478400,Colin White,C,,27,0,0,0,0
75,8475755,Alexander Petrovic,D,DAL,32,0,0,0,0
75,8481812,Nikolai Knyzhov,D,,27,0,0,0,0
75,8481593,Jayden Struble,D,MTL,23,0,0,0,0
75,8481532,Alex Turcotte,C,LAK,23,0,0,0,0
75,8482126,Emil Andrae,D,PHI,31,0,0,0,0
75,8479944,Zach Aston-Reese,C,VGK,30,0,0,0,0
75,8471817,Ryan Reaves,R,TOR,37,0,0,0,0
75,8481206,John Ludvig,D,PIT,24,0,0,0,0
75,8481599,Victor Soderstrom,D,UTA,23,0,0,0,0
75,8480292,Carson Meyer,R,ANA,27,0,0,0,0
75,8482496,Nils Aman,C,VAN,24,0,0,0,0
75,8479718,Alex Barré-Boulet,C,MTL,27,0,0,0,0
75,8479994,Jaret Anderson-Dolan,C,WPG,25,0,0,0,0
75,8480184,Gustav Lindstrom,D,,26,0,0,0,0
75,8480890,Jan Jenik,R,OTT,24,0,0,0,0
75,8478067,Oskar Lindblom,L,,28,0,0,0,0
75,8476934,Brock McGinn,L,ANA,30,0,0,0,0
75,8479985,Cale Fleury,D,SEA,26,0,0,0,0
75,8484304,Uvis Balinskis,D,FLA,28,0,0,0,0
75,8479981,Jonah Gadjovich,L,FLA,26,0,0,0,0
75,8481716,Dmitri Voronkov,L,CBJ,24,0,0,0,0
75,8474709,Matt Martin,L,,35,0,0,0,0
75,8482634,Alex Steeves,C,TOR,25,0,0,0,0
75,8480823,Alexander Alexeyev,D,WSH,25,0,0,0,0
75,8477541,Dakota Mermis,D,TOR,30,0,0,0,0
75,8483491,Ivan Miroshnichenko,L,WSH,20,0,0,0,0
75,8478477,Mitchell Stephens,C,SEA,27,0,0,0,0
75,8481543,Nikita Alexandrov,C,STL,24,0,0,0,0
75,8479423,Alex Nylander,L,,26,0,0,0,0
75,8482451,Mikael Pyyhtia,L,CBJ,23,0,0,0,0
75,8478831,Kevin Stenlund,C,UTA,28,0,0,0,0
75,8480306,Grant Hutton,D,NYI,29,0,0,0,0
75,8478028,Fredrik Olofsson,L,,28,0,0,0,0
75,8477462,Robert Hagg,D,VGK,29,0,0,0,0
75,8477320,Anton Blidh,L,NYR,29,0,0,0,0
75,8482157,Will Cuylle,L,NYR,22,0,0,0,0
75,8482737,Zack Bolduc,C,STL,21,0,0,0,0
75,8481239,Samuel Fagemo,L,,24,0,0,0,0
75,8481600,Tobias Bjornfot,D,FLA,23,0,0,0,0
75,8478409,Anthony Richard,C,PHI,28,0,0,0,0
75,8474145,Robert Bortuzzo,D,,35,0,0,0,0
75,8475958,Michael Sgarbossa,C,WSH,32,0,0,0,0
75,8479986,Kole Lind,R,DAL,26,0,0,0,0
75,8479249,Andrew Poturalski,C,SJS,30,0,0,0,0
75,8479362,Riley Tufte,L,BOS,26,0,0,0,0
75,8479991,Jake Leschyshyn,C,NYR,25,0,0,0,0
75,8479587,Rhett Gardner,C,PHI,28,0,0,0,0
75,8482744,James Malatesta,L,CBJ,21,0,0,0,0
75,8478854,Ryan Shea,D,PIT,27,0,0,0,0
75,8481591,Sam Poulin,R,,23,0,0,0,0
75,8483512,Matt Savoie,C,EDM,20,0,0,0,0
75,8482102,Vasily Ponomarev,C,PIT,22,0,0,0,0
75,8482162,Roby Jarventie,L,EDM,22,0,0,0,0
75,8481016,Ruslan Iskhakov,C,,24,0,0,0,0
75,8482172,Landon Slaggert,L,CHI,22,0,0,0,0
75,8482747,Brennan Othmann,L,NYR,21,0,0,0,0
75,8480031,Maxime Comtois,L,,25,0,0,0,0
75,8480226,Marián Studenic,R,,26,0,0,0,0
75,8478408,Travis Dermott,D,,28,0,0,0,0
75,8481518,Nolan Foote,L,NJD,24,0,0,0,0
75,8479419,Brett Murray,L,BUF,26,0,0,0,0
75,8482088,Justin Sourdif,R,FLA,22,0,0,0,0
75,8482201,Gage Goncalves,C,TBL,23,0,0,0,0
75,8481578,Graeme Clarke,R,MIN,23,0,0,0,0
75,8482177,Marat Khusnutdinov,C,MIN,22,0,0,0,0
75,8481754,Nikita Nesterenko,C,ANA,23,0,0,0,0
75,8483531,Brian Halonen,L,NJD,25,0,0,0,0
75,8483920,Pierrick Dube,R,WSH,23,0,0,0,0
75,8480851,Akil Thomas,C,LAK,24,0,0,0,0
75,8475235,Nicolas Deslauriers,L,PHI,33,0,0,0,0
75,8482476,Emil Heineman,L,MTL,23,0,0,0,0
75,8477149,Scott Sabourin,R,SJS,32,0,0,0,0
75,8483549,Lucas Condotta,L,MTL,27,0,0,0,0
75,8482765,Isak Rosen,R,BUF,21,0,0,0,0
75,8481237,Kyle MacLean,C,NYI,25,0,0,0,0
75,8481024,Linus Karlsson,C,VAN,25,0,0,0,0
75,8481690,Tyler Angle,C,,24,0,0,0,0
75,8483570,Ben Meyers,C,SEA,26,0,0,0,0
75,8481655,Cole Schwindt,R,CGY,23,0,0,0,0
75,8481462,Mason Morelli,L,VGK,28,0,0,0,0
75,8483401,Marc Johnstone,R,PIT,28,0,0,0,0
75,8478956,Samuel Laberge,L,NJD,27,0,0,0,0
75,8479533,Joona Koppanen,L,,26,0,0,0,0
75,8482197,Adam Raska,R,MIN,23,0,0,0,0
75,8482250,Callahan Burke,C,VGK,27,0,0,0,0
75,8482784,Zach Dean,C,STL,21,0,0,0,0
75,8484255,Jason Polin,R,COL,25,0,0,0,0
75,8481077,John Leonard,L,,26,0,0,0,0
75,8481534,Raphael Lavoie,C,EDM,24,0,0,0,0
75,8483609,Adam Klapka,R,CGY,24,0,0,0,0
75,8482751,Ryan Winterton,C,SEA,21,0,0,0,0
75,8480267,Sammy Walker,C,MIN,25,0,0,0,0
75,8475766,Austin Watson,L,,32,0,0,0,0
75,8482460,Matt Rempe,C,NYR,22,0,0,0,0
75,8481065,Angus Crookshank,L,OTT,25,0,0,0,0
75,8481070,Hugh McGing,L,,26,0,0,0,0
75,8476323,Max McCormick,L,SEA,32,0,0,0,0
75,8483395,Arshdeep Bains,L,VAN,23,0,0,0,0
75,8484259,Ondrej Pavel,C,COL,31,0,0,0,0
75,8483432,Luca Del Bel Belluz,C,CBJ,31,0,0,0,0
75,8483045,Cameron Butler,R,CBJ,31,0,0,0,0
75,8482061,Brandon Biro,L,SEA,26,0,0,0,0
75,8477401,John Hayden,C,SEA,29,0,0,0,0
75,8475278,Byron Froese,C,,33,0,0,0,0
75,8478446,Glenn Gawdin,C,LAK,27,0,0,0,0
75,8477993,Justin Kirkland,C,CGY,28,0,0,0,0
75,8482147,Jean-Luc Foudy,C,COL,22,0,0,0,0
75,8480032,Shane Bowers,C,NJD,25,0,0,0,0
75,8479330,Brandon Gignac,C,MTL,27,0,0,0,0
75,8480776,Sheldon Rempal,R,,29,0,0,0,0
75,8475413,Justin Dowling,C,NJD,34,0,0,0,0
75,8481726,Adam Edstrom,C,NYR,24,0,0,0,0
75,8480844,Grigori Denisenko,L,VGK,24,0,0,0,0
75,8478147,Bokondji Imama,L,PIT,28,0,0,0,0
75,8478881,Brett Seney,L,CHI,28,0,0,0,0
75,8483630,Pavol Regenda,L,ANA,25,0,0,0,0
75,8480836,Jonathan Gruden,C,,24,0,0,0,0
75,8484314,Jiri Smejkal,L,,28,0,0,0,0
75,8475780,Chris Wagner,R,COL,33,0,0,0,0
75,8479546,Oskar Steen,C,,26,0,0,0,0
75,8483597,Milos Kelemen,L,UTA,25,0,0,0,0
75,8481789,Tye Kartye,L,SEA,23,0,0,0,0
75,8484325,Waltteri Merela,C,TBL,26,0,0,0,0
75,8479421,Jacob Moverare,D,LAK,26,0,0,0,0
75,8481585,Egor Afanasyev,L,SJS,23,0,0,0,0
75,8479547,Matthew Phillips,R,,26,0,0,0,0
75,8479367,William Lockwood,R,FLA,26,0,0,0,0
75,8476915,Jujhar Khaira,L,,30,0,0,0,0
75,8481422,Jacob Lucchini,C,NSH,29,0,0,0,0
75,8480468,James Hamblin,L,EDM,25,0,0,0,0
75,8478051,Max Willman,C,NJD,29,0,0,0,0
75,8481556,John Beecher,C,BOS,23,0,0,0,0
75,8478078,Rourke Chartier,C,,28,0,0,0,0
76,8478402,Connor McDavid,C,EDM,27,82,41,104,145
76,8476453,Nikita Kucherov,R,TBL,31,82,45,96,141
76,8478550,Artemi Panarin,L,NYR,33,82,38,87,125
76,8477956,David Pastrnak,R,BOS,28,82,58,60,118
76,8479318,Auston Matthews,C,TOR,27,82,53,65,118
76,8477934,Leon Draisaitl,C,EDM,29,82,53,65,118
76,8477492,Nathan MacKinnon,C,COL,29,82,43,72,115
76,8481559,Jack Hughes,C,NJD,23,82,49,64,113
76,8476887,Filip Forsberg,L,NSH,30,82,53,58,111
76,8479314,Matthew Tkachuk,L,FLA,27,82,34,77,111
76,8478864,Kirill Kaprizov,L,MIN,27,82,45,65,110
76,8478420,Mikko Rantanen,R,COL,28,82,45,58,103
76,8477493,Aleksander Barkov,C,FLA,29,82,28,75,103
76,8477939,William Nylander,R,TOR,28,82,48,53,101
76,8476468,J.T. Miller,C,VAN,31,82,30,70,100
76,8476459,Mika Zibanejad,C,NYR,31,82,27,69,96
76,8477404,Jake Guentzel,C,TBL,30,82,43,52,95
76,8481523,Kirby Dach,C,MTL,23,82,15,80,95
76,8477942,Kevin Fiala,L,LAK,28,82,29,64,93
76,8475913,Mark Stone,R,VGK,32,82,27,65,92
76,8480027,Jason Robertson,L,DAL,25,82,38,53,91
76,8480069,Cale Makar,D,COL,26,82,33,58,91
76,8480012,Elias Pettersson,C,VAN,26,82,49,41,90
76,8477933,Sam Reinhart,C,FLA,29,82,42,48,90
76,8471675,Sidney Crosby,C,PIT,37,82,39,51,90
76,8477946,Dylan Larkin,C,DET,28,82,44,45,89
76,8478427,Sebastian Aho,C,CAR,27,82,43,46,89
76,8477402,Pavel Buchnevich,L,STL,29,82,43,45,88
76,8474600,Roman Josi,D,NSH,34,82,27,61,88
76,8480830,Andrei Svechnikov,R,CAR,24,82,32,54,86
76,8475172,Nazem Kadri,C,CGY,34,82,29,57,86
76,8471215,Evgeni Malkin,C,PIT,38,82,32,53,85
76,8478449,Roope Hintz,C,DAL,28,82,38,46,84
76,8480023,Robert Thomas,C,STL,25,82,24,60,84
76,8480800,Quinn Hughes,D,VAN,25,82,13,71,84
76,8478010,Brayden Point,C,TBL,28,82,47,36,83
76,8481557,Matt Boldy,L,MIN,23,82,45,38,83
76,8480036,Miro Heiskanen,D,DAL,25,82,21,62,83
76,8479323,Adam Fox,D,NYR,26,82,16,67,83
76,8474564,Steven Stamkos,C,NSH,34,82,43,39,82
76,8478873,Troy Terry,R,ANA,27,82,34,48,82
76,8477951,Nick Schmaltz,C,UTA,28,82,32,50,82
76,8479385,Jordan Kyrou,C,STL,26,82,35,46,81
76,8480002,Nico Hischier,C,NJD,25,82,35,46,81
76,8479542,Brandon Hagel,L,TBL,26,82,33,47,80
76,8475166,John Tavares,C,TOR,34,82,32,48,80
76,8475692,Mats Zuccarello,R,MIN,37,82,20,60,80
76,8477496,Elias Lindholm,C,BOS,30,82,28,51,79
76,8476456,Jonathan Huberdeau,C,CGY,31,82,21,58,79
76,8479343,Clayton Keller,R,UTA,26,82,36,42,78
76,8476389,Vincent Trocheck,C,NYR,31,82,35,43,78
76,8479407,Jesper Bratt,L,NJD,26,82,25,53,78
76,8478444,Brock Boeser,R,VAN,27,82,33,44,77
76,8482116,Tim Stützle,C,OTT,22,82,29,48,77
76,8476539,Jonathan Marchessault,R,NSH,34,82,38,38,76
76,8478403,Jack Eichel,C,VGK,28,82,34,42,76
76,8480801,Brady Tkachuk,L,OTT,25,82,31,45,76
76,8476875,Mike Matheson,D,MTL,30,82,25,51,76
76,8475810,Bryan Rust,R,PIT,32,82,36,39,75
76,8478440,Dylan Strome,C,WSH,27,82,31,43,74
76,8478439,Travis Konecny,R,PHI,27,82,29,45,74
76,8478401,Pavel Zacha,C,BOS,27,82,26,48,74
76,8478445,Mathew Barzal,C,NYI,27,82,22,52,74
76,8480208,Drake Batherson,R,OTT,26,82,38,35,73
76,8475754,Brock Nelson,C,NYI,33,82,34,39,73
76,8475158,Ryan O'Reilly,C,NSH,33,82,31,42,73
76,8475167,Victor Hedman,D,TBL,34,82,22,51,73
76,8477501,Valeri Nichushkin,R,COL,29,82,33,39,72
76,8473512,Claude Giroux,R,OTT,36,82,20,52,72
76,8478493,Joel Eriksson Ek,C,MIN,27,82,38,33,71
76,8481528,Dylan Cozens,C,BUF,23,82,25,46,71
76,8480839,Rasmus Dahlin,D,BUF,24,82,18,53,71
76,8475786,Zach Hyman,L,EDM,32,82,37,33,70
76,8477949,Alex Tuch,R,BUF,28,82,18,52,70
76,8475184,Chris Kreider,L,NYR,33,82,46,23,69
76,8482078,Lucas Raymond,L,DET,22,82,28,41,69
76,8474141,Patrick Kane,R,DET,36,82,27,42,69
76,8481533,Trevor Zegras,C,ANA,23,82,16,53,69
76,8480015,Owen Tippett,R,PHI,25,82,40,28,68
76,8471685,Anze Kopitar,C,LAK,37,82,27,41,68
76,8478397,Rasmus Andersson,D,CGY,28,82,9,59,68
76,8481540,Cole Caufield,R,MTL,23,82,33,34,67
76,8476346,Johnny Gaudreau,L,CBJ,31,82,18,49,67
76,8477447,Shea Theodore,D,VGK,29,82,16,51,67
76,8480865,Noah Dobson,D,NYI,24,82,13,54,67
76,8476399,Blake Coleman,C,CGY,33,82,36,30,66
76,8473419,Brad Marchand,L,BOS,36,82,31,35,66
76,8476881,Tomas Hertl,C,VGK,31,82,29,37,66
76,8475170,Brayden Schenn,C,STL,33,82,27,39,66
76,8478042,Viktor Arvidsson,R,EDM,31,82,25,41,66
76,8474578,Erik Karlsson,D,PIT,34,82,18,48,66
76,8477409,Carter Verhaeghe,C,FLA,29,82,38,27,65
76,8482665,Matty Beniers,C,SEA,22,82,33,32,65
76,8476448,William Karlsson,C,VGK,31,82,32,33,65
76,8481711,Matias Maccelli,L,UTA,24,82,24,41,65
76,8480078,Filip Chytil,C,NYR,25,82,20,45,65
76,8482097,Jack Quinn,R,BUF,23,82,31,33,64
76,8476462,Dougie Hamilton,D,NJD,31,82,19,45,64
76,8480803,Evan Bouchard,D,EDM,25,82,14,50,64
76,8477503,Max Domi,C,TOR,29,82,19,44,63
76,8476853,Morgan Rielly,D,TOR,30,82,6,57,63
76,8480014,Gabriel Vilardi,C,WPG,25,82,35,27,62
76,8482109,Alexis Lafrenière,L,NYR,23,82,31,31,62
76,8483808,Andrei Kuzmenko,L,CGY,28,82,29,33,62
76,8478047,Michael Bunting,L,PIT,29,82,27,35,62
76,8477451,Ryan Hartman,R,MIN,30,82,24,38,62
76,8479675,Trevor Moore,L,LAK,29,82,23,39,62
76,8474150,Mikael Backlund,C,CGY,35,82,26,35,61
76,8480018,Nick Suzuki,C,MTL,25,82,24,37,61
76,8475168,Matt Duchene,C,DAL,33,82,24,37,61
76,8479337,Alex DeBrincat,R,DET,27,82,23,38,61
76,8477494,Jonathan Drouin,L,COL,29,82,22,39,61
76,8476882,Teuvo Teravainen,L,CHI,30,82,21,40,61
76,8476454,Ryan Nugent-Hopkins,C,EDM,31,82,19,42,61
76,8477500,Bo Horvat,C,NYI,29,82,33,27,60
76,8479400,Pierre-Luc Dubois,L,WSH,26,82,33,27,60
76,8478366,Frank Vatrano,R,ANA,30,82,32,28,60
76,8473986,Alex Killorn,L,ANA,35,82,31,29,60
76,8482113,Anton Lundell,C,FLA,23,82,28,32,60
76,8471214,Alex Ovechkin,L,WSH,39,82,27,33,60
76,8476460,Mark Scheifele,C,WPG,31,82,27,33,60
76,8479339,Patrik Laine,L,CBJ,26,82,24,36,60
76,8475798,Mikael Granlund,C,SJS,32,82,15,45,60
76,8478396,Noah Hanifin,D,VGK,27,82,13,47,60
76,8478460,Zach Werenski,D,CBJ,27,82,12,48,60
76,8481068,Yegor Sharangovich,C,CGY,26,82,33,26,59
76,8476432,Boone Jenner,C,CBJ,31,82,33,26,59
76,8479420,Tage Thompson,C,BUF,27,82,27,32,59
76,8475765,Vladimir Tarasenko,R,DET,33,82,22,37,59
76,8473994,Jamie Benn,L,DAL,35,82,22,37,59
76,8477998,Warren Foegele,L,LAK,28,82,28,30,58
76,8478856,Conor Garland,R,VAN,28,82,20,38,58
76,8474563,Drew Doughty,D,LAK,35,82,16,42,58
76,8477346,MacKenzie Weegar,D,CGY,30,82,12,46,58
76,8481542,Moritz Seider,D,DET,23,82,11,47,58
76,8479325,Charlie McAvoy,D,BOS,27,82,9,49,58
76,8477955,Jared McCann,L,SEA,28,82,33,24,57
76,8477479,Tyler Bertuzzi,L,CHI,29,82,30,27,57
76,8477456,J.T. Compher,L,DET,29,82,24,33,57
76,8478398,Kyle Connor,L,WPG,28,82,23,34,57
76,8477940,Nikolaj Ehlers,L,WPG,28,82,23,34,57
76,8477932,Aaron Ekblad,D,FLA,28,82,16,41,57
76,8477504,Josh Morrissey,D,WPG,29,82,11,46,57
76,8481596,Shane Pinto,C,OTT,24,82,22,34,56
76,8478414,Timo Meier,R,NJD,28,82,20,36,56
76,8475745,Charlie Coyle,C,BOS,32,82,18,38,56
76,8478975,Mason Marchment,L,DAL,29,82,16,40,56
76,8474590,John Carlson,D,WSH,34,82,12,44,56
76,8471724,Kris Letang,D,PIT,37,82,10,46,56
76,8477935,Sam Bennett,C,FLA,28,82,32,23,55
76,8477960,Adrian Kempe,R,LAK,28,82,29,26,55
76,8477511,Anthony Mantha,R,CGY,30,82,25,30,55
76,8475793,Ryan Johansen,C,PHI,32,82,25,30,55
76,8480798,Philipp Kurashev,C,CHI,25,82,22,33,55
76,8478462,Nicolas Roy,C,VGK,27,82,21,34,55
76,8475763,Kevin Hayes,R,PIT,32,82,19,36,55
76,8474565,Alex Pietrangelo,D,VGK,34,82,14,41,55
76,8480434,Sean Durzi,D,UTA,26,82,14,41,55
76,8478519,Anthony Cirelli,C,TBL,27,82,26,28,54
76,8474102,David Perron,L,OTT,36,82,24,30,54
76,8482699,Dylan Guenther,R,UTA,21,82,23,31,54
76,8482720,Matthew Knies,L,TOR,22,82,23,31,54
76,8479365,Trent Frederic,C,BOS,26,82,21,33,54
76,8475151,Kyle Palmieri,C,NYI,33,82,20,34,54
76,8478438,Tommy Novak,C,NSH,27,82,15,39,54
76,8482093,Seth Jarvis,C,CAR,22,82,22,31,53
76,8477964,Ivan Barbashev,C,VGK,29,82,19,34,53
76,8475191,Reilly Smith,R,NYR,33,82,30,22,52
76,8480039,Martin Necas,C,CAR,25,82,23,29,52
76,8476869,Brady Skjei,D,NSH,30,82,15,37,52
76,8476872,Scott Laughton,C,PHI,30,82,15,37,52
76,8475753,Justin Faulk,D,STL,32,82,13,39,52
76,8475794,Tyler Seguin,C,DAL,32,82,25,26,51
76,8478498,Jake DeBrusk,L,VAN,28,82,22,29,51
76,8482149,Cole Perfetti,C,WPG,22,82,21,30,51
76,8482092,Ridly Greig,C,OTT,22,82,21,30,51
76,8477476,Artturi Lehkonen,L,COL,29,82,20,31,51
76,8477444,Andre Burakovsky,L,SEA,29,82,18,33,51
76,8479410,Mikhail Sergachev,D,UTA,26,82,9,42,51
76,8478407,Vince Dunn,D,SEA,28,82,11,39,50
76,8482740,Wyatt Johnston,C,DAL,21,82,29,20,49
76,8476880,Tom Wilson,R,WSH,30,82,23,26,49
76,8477416,Oliver Bjorkstrand,R,SEA,29,82,22,27,49
76,8481618,Alex Newhook,C,MTL,23,82,21,28,49
76,8476292,Ondrej Palat,L,NJD,33,82,18,31,49
76,8477986,Brandon Montour,D,SEA,30,82,16,33,49
76,8478055,Gustav Forsling,D,FLA,28,82,12,37,49
76,8476905,Chandler Stephenson,C,SEA,30,82,10,39,49
76,8482671,Owen Power,D,BUF,22,82,9,40,49
76,8478474,Lawson Crouse,L,UTA,27,82,27,21,48
76,8477429,Andrew Copp,C,DET,30,82,25,23,48
76,8480797,Joel Farabee,L,PHI,24,82,22,26,48
76,8480220,Noah Cates,L,PHI,25,82,22,26,48
76,8480188,Fabian Zetterlund,L,SJS,25,82,21,27,48
76,8482089,Jake Neighbours,L,STL,22,82,21,27,48
76,8474586,Jordan Eberle,R,SEA,34,82,20,28,48
76,8478115,Pierre Engvall,L,NYI,28,82,20,28,48
76,8475760,Nick Bjugstad,C,UTA,32,82,18,30,48
76,8474679,Gustav Nyquist,C,NSH,35,82,15,33,48
76,8476438,Brandon Saad,L,STL,32,82,25,22,47
76,8480849,Barrett Hayton,C,UTA,24,82,22,25,47
76,8479987,Morgan Geekie,C,BOS,26,82,21,26,47
76,8482745,Mason McTavish,C,ANA,21,82,19,28,47
76,8475287,Erik Haula,L,NJD,33,82,18,29,47
76,8476479,Phillip Danault,C,LAK,31,82,14,33,47
76,8482124,Quinton Byfield,R,LAK,22,82,14,33,47
76,8476458,Ryan Strome,C,ANA,31,82,13,34,47
76,8478038,Devon Toews,D,COL,30,82,8,39,47
76,8475799,Nino Niederreiter,R,WPG,32,82,26,20,46
76,8476925,Colton Sissons,C,NSH,31,82,19,27,46
76,8478469,Thomas Chabot,D,OTT,27,82,14,32,46
76,8470613,Brent Burns,D,CAR,39,82,6,40,46
76,8475726,Tyler Toffoli,C,SJS,32,82,24,21,45
76,8478472,Mathieu Joseph,R,STL,27,82,21,24,45
76,8480028,Morgan Frost,C,PHI,25,82,17,28,45
76,8479345,Jakob Chychrun,D,WSH,26,82,14,31,45
76,8479999,Casey Mittelstadt,C,COL,26,82,12,33,45
76,8479425,Filip Hronek,D,VAN,27,82,11,34,45
76,8480459,Pius Suter,C,VAN,28,82,22,22,44
76,8477497,Sean Monahan,C,CBJ,30,82,21,23,44
76,8479992,Michael Rasmussen,C,DET,25,82,20,24,44
76,8475714,Calle Jarnkrok,C,TOR,33,82,20,24,44
76,8475784,Jeff Skinner,C,EDM,32,82,19,25,44
76,8475768,Jaden Schwartz,C,SEA,32,82,19,25,44
76,8475791,Taylor Hall,L,CHI,33,82,17,27,44
76,8477947,Sonny Milano,L,WSH,28,82,17,27,44
76,8482660,Kent Johnson,C,CBJ,22,82,15,29,44
76,8479996,Cody Glass,C,NSH,25,82,15,29,44
76,8480009,Eeli Tolvanen,R,SEA,25,82,15,29,44
76,8480802,Ryan McLeod,C,BUF,25,82,13,31,44
76,8482684,Luke Hughes,D,NJD,21,82,10,34,44
76,8477495,Seth Jones,D,CHI,30,82,9,35,44
76,8474716,Jared Spurgeon,D,MIN,35,82,7,37,44
76,8475722,Jason Zucker,L,BUF,32,82,22,21,43
76,8481560,Arthur Kaliyev,R,LAK,23,82,22,21,43
76,8478542,Evan Rodrigues,C,FLA,31,82,17,26,43
76,8482705,Cole Sillinger,C,CBJ,21,82,14,29,43
76,8476906,Shayne Gostisbehere,D,CAR,31,82,10,33,43
76,8476792,Torey Krug,D,STL,33,82,7,36,43
76,8477426,Nicholas Paul,L,TBL,29,82,21,21,42
76,8476483,Rickard Rakell,R,PIT,31,82,19,23,42
76,8478046,Danton Heinen,L,VAN,29,82,18,24,42
76,8474189,Lars Eller,C,PIT,35,82,18,24,42
76,8477407,Anthony Duclair,L,NYI,29,82,13,29,42
76,8481656,Aliaksei Protas,C,WSH,23,82,12,30,42
76,8476923,Damon Severson,D,CBJ,30,82,10,32,42
76,8480145,Neal Pionk,D,WPG,29,82,8,34,42
76,8474641,Adam Henrique,C,EDM,34,82,22,19,41
76,8475848,Brendan Gallagher,R,MTL,32,82,22,19,41
76,8475200,Dmitry Orlov,D,CAR,33,82,13,28,41
76,8476885,Jacob Trouba,D,NYR,30,82,11,30,41
76,8480873,Rasmus Sandin,D,WSH,24,82,5,36,41
76,8475764,Cam Fowler,D,ANA,33,82,4,37,41
76,8481546,Cam York,D,PHI,23,82,3,38,41
76,8482175,JJ Peterka,R,BUF,22,82,24,16,40
76,8481604,Pavel Dorofeyev,L,VGK,24,82,24,16,40
76,8477952,Robby Fabbri,C,ANA,28,82,23,17,40
76,8482055,Drew O'Connor,L,PIT,26,82,23,17,40
76,8479525,Ross Colton,C,COL,28,82,21,19,40
76,8478233,Andrew Mangiapane,L,WSH,28,82,20,20,40
76,8482110,Dawson Mercer,C,NJD,23,82,18,22,40
76,8480893,Kirill Marchenko,R,CBJ,24,82,27,12,39
76,8474053,Logan Couture,C,SJS,35,82,18,21,39
76,8479316,Luke Kunin,C,SJS,27,82,18,21,39
76,8473422,Nick Foligno,L,CHI,37,82,16,23,39
76,8483515,Juraj Slafkovsky,L,MTL,20,82,15,24,39
76,8482667,William Eklund,L,SJS,22,82,14,25,39
76,8477021,Alex Kerfoot,C,UTA,30,82,12,27,39
76,8482133,Thomas Bordeleau,C,SJS,22,82,11,28,39
76,8479661,Tanner Jeannot,L,LAK,27,82,20,18,38
76,8482475,Yegor Chinakhov,R,CBJ,23,82,19,19,38
76,8482159,Tyson Foerster,R,PHI,22,82,17,21,38
76,8476826,Yanni Gourde,C,SEA,33,82,17,21,38
76,8484144,Connor Bedard,C,CHI,19,82,14,24,38
76,8476854,Hampus Lindholm,D,BOS,30,82,10,28,38
76,8476329,Travis Boyd,C,MIN,31,82,9,29,38
76,8477948,Travis Sanheim,D,PHI,28,82,6,32,38
76,8480064,Josh Norris,C,OTT,25,82,26,11,37
76,8475169,Evander Kane,L,EDM,33,82,22,15,37
76,8476981,Josh Anderson,R,MTL,30,82,22,15,37
76,8481580,Connor McMichael,C,WSH,23,82,20,17,37
76,8478413,Jordan Greenway,L,BUF,27,82,19,18,37
76,8481624,Ilya Mikheyev,R,CHI,30,82,16,21,37
76,8476392,Adam Lowry,C,WPG,31,82,13,24,37
76,8473507,Jeff Petry,D,DET,37,82,7,30,37
76,8475314,Anders Lee,L,NYI,34,82,22,14,36
76,8481535,Nils Hoglander,L,VAN,24,82,18,18,36
76,8482079,Marco Rossi,C,MIN,23,82,16,20,36
76,8480995,Pontus Holmberg,R,TOR,25,82,16,20,36
76,8476461,Sean Couturier,C,PHI,32,82,15,21,36
76,8476419,Jean-Gabriel Pageau,C,NYI,32,82,14,22,36
76,8477450,Jason Dickinson,C,CHI,29,82,14,22,36
76,8473563,Nicklas Backstrom,C,WSH,37,82,13,23,36
76,8476892,Colton Parayko,D,STL,31,82,4,32,36
76,8479390,Taylor Raddysh,R,WSH,26,82,21,14,35
76,8476474,Stefan Noesen,R,NJD,31,82,20,15,35
76,8481582,Nicholas Robertson,L,TOR,23,82,20,15,35
76,8477953,Kasperi Kapanen,R,STL,28,82,16,19,35
76,8477919,Frederick Gaudreau,C,MIN,31,82,15,20,35
76,8480068,Ryan Poehling,C,PHI,25,82,13,22,35
76,8476960,Andreas Athanasiou,C,CHI,30,82,12,23,35
76,8476958,Jaccob Slavin,D,CAR,30,82,8,27,35
76,8478133,Jake Evans,C,MTL,28,82,8,27,35
76,8480817,K'Andre Miller,D,NYR,24,82,5,30,35
76,8476463,Jonas Brodin,D,MIN,31,82,2,33,35
76,8480113,Alex Iafallo,L,WPG,31,82,19,15,34
76,8478211,Dryden Hunt,L,CGY,29,82,14,20,34
76,8478458,Jack Roslovic,C,CAR,27,82,11,23,34
76,8477498,Darnell Nurse,D,EDM,29,82,8,26,34
76,8482142,Jamie Drysdale,D,PHI,22,82,4,30,34
76,8475188,Brayden McNabb,D,VGK,33,82,3,31,34
76,8480829,Jesperi Kotkaniemi,C,CAR,24,82,15,18,33
76,8480185,Eetu Luostarinen,C,FLA,26,82,12,21,33
76,8481704,Juuso Parssinen,C,NSH,23,82,11,22,33
76,8480878,Nils Lundkvist,D,DAL,24,82,10,23,33
76,8477506,Ryan Pulock,D,NYI,30,82,9,24,33
76,8475218,Mattias Ekholm,D,EDM,34,82,7,26,33
76,8476979,Erik Gustafsson,D,DET,32,82,5,28,33
76,8475455,Brenden Dillon,D,NJD,34,82,3,30,33
76,8482125,Alexander Holtz,R,VGK,22,82,18,14,32
76,8480748,Kiefer Sherwood,L,VAN,29,82,15,17,32
76,8478569,Noel Acciari,C,PIT,33,82,13,19,32
76,8475220,Marcus Foligno,L,MIN,33,82,12,20,32
76,8475149,Marcus Johansson,L,MIN,34,82,10,22,32
76,8482146,Luke Evangelista,R,NSH,22,82,9,23,32
76,8482105,Jake Sanderson,D,OTT,22,82,9,23,32
76,8475343,Nic Dowd,C,WSH,34,82,8,24,32
76,8481581,Thomas Harley,D,DAL,23,82,7,25,32
76,8475171,Oliver Ekman-Larsson,D,TOR,33,82,7,25,32
76,8477987,Ryan Donato,C,CHI,28,82,19,12,31
76,8478109,Victor Olofsson,L,VGK,29,82,17,14,31
76,8478463,Anthony Beauvillier,L,PIT,27,82,16,15,31
76,8480074,Alexandre Texier,C,STL,25,82,15,16,31
76,8480835,Jack Drury,C,CAR,24,82,14,17,31
76,8479351,Sam Steel,C,DAL,26,82,14,17,31
76,8474149,Evgenii Dadonov,R,DAL,35,82,7,24,31
76,8477845,Trevor van Riemsdyk,D,WSH,33,82,5,26,31
76,8477435,Ryan Graves,D,PIT,29,82,5,26,31
76,8482655,J.J. Moser,D,TBL,24,82,3,28,31
76,8480855,Jack McBain,C,UTA,24,82,17,13,30
76,8482074,Connor Zary,C,CGY,23,82,16,14,30
76,8478057,Dakota Joshua,C,VAN,28,82,15,15,30
76,8471698,T.J. Oshie,R,WSH,38,82,15,15,30
76,8477353,Tyler Motte,C,DET,29,82,15,15,30
76,8479941,Justin Danforth,R,CBJ,31,82,14,16,30
76,8475855,Jesper Fast,R,CAR,33,82,13,17,30
76,8475193,Tomas Tatar,L,NJD,34,82,12,18,30
76,8482062,Cole Smith,L,NSH,29,82,11,19,30
76,8474673,TJ Brodie,D,CHI,34,82,3,27,30
76,8476469,Joel Armia,R,MTL,31,82,17,12,29
76,8481553,Bobby Brink,R,PHI,23,82,16,13,29
76,8479368,Max Jones,L,BOS,26,82,14,15,29
76,8474715,Cam Atkinson,R,TBL,35,82,13,16,29
76,8482624,Daniil Miromanov,D,CGY,27,82,13,16,29
76,8475231,Casey Cizikas,C,NYI,33,82,13,16,29
76,8477989,Christian Dvorak,C,MTL,28,82,11,18,29
76,8477903,Garnet Hathaway,R,PHI,33,82,11,18,29
76,8476927,Teddy Blueger,C,VAN,30,82,9,20,29
76,8475462,Radko Gudas,D,ANA,34,82,6,23,29
76,8481606,Jordan Spence,D,LAK,23,82,5,24,29
76,8477839,Conor Sheary,L,TBL,32,82,5,24,29
76,8475324,Nick Jensen,D,OTT,34,82,4,25,29
76,8478507,John Marino,D,UTA,27,82,2,27,29
76,8478508,Yakov Trenin,C,MIN,27,82,17,11,28
76,8477425,Miles Wood,L,COL,29,82,17,11,28
76,8477931,Tomas Nosek,L,FLA,32,82,13,15,28
76,8480789,Oliver Wahlstrom,R,NYI,24,82,12,16,28
76,8481517,Brett Leason,R,ANA,25,82,12,16,28
76,8480871,Adam Boqvist,D,FLA,24,82,11,17,28
76,8479353,Brett Howden,C,VGK,26,82,11,17,28
76,8476422,Mike Reilly,D,NYI,31,82,11,17,28
76,8481186,Logan O'Connor,R,COL,28,82,9,19,28
76,8481554,Kaapo Kakko,R,NYR,23,82,9,19,28
76,8479976,Juuso Valimaki,D,UTA,26,82,6,22,28
76,8479324,Ryan Lindgren,D,NYR,26,82,5,23,28
76,8479402,Jake Bean,D,CGY,26,82,2,26,28
76,8484166,Adam Fantilli,C,CBJ,20,82,15,12,27
76,8476918,Jimmy Vesey,L,NYR,31,82,14,13,27
76,8483431,Logan Cooley,C,UTA,20,82,14,13,27
76,8479293,Brandon Tanev,L,SEA,33,82,11,16,27
76,8480806,Isac Lundestrom,C,ANA,25,82,10,17,27
76,8480043,Timothy Liljegren,D,TOR,25,82,8,19,27
76,8476480,Vladislav Namestnikov,C,WPG,32,82,7,20,27
76,8477220,Nate Schmidt,D,FLA,33,82,7,20,27
76,8483490,Pavel Mintyukov,D,ANA,21,82,6,21,27
76,8483457,Lane Hutson,D,MTL,20,82,5,22,27
76,8479998,Mikey Anderson,D,LAK,25,82,4,23,27
76,8478859,Niko Mikkola,D,FLA,28,82,4,23,27
76,8477969,Marcus Pettersson,D,PIT,28,82,3,24,27
76,8482122,Brock Faber,D,MIN,22,82,2,25,27
76,8474574,Tyler Myers,D,VAN,34,82,1,26,27
76,8479591,Michael Eyssimont,C,TBL,28,82,13,13,26
76,8478020,Michael Amadio,C,OTT,28,82,12,14,26
76,8482166,Shakir Mukhamadullin,D,SJS,22,82,10,16,26
76,8473533,Jordan Staal,C,CAR,36,82,9,17,26
76,8482117,Lukas Reichel,L,CHI,22,82,9,17,26
76,8476902,Esa Lindell,D,DAL,30,82,7,19,26
76,8476331,Dylan DeMelo,D,WPG,31,82,5,21,26
76,8478500,Ivan Provorov,D,CBJ,27,82,5,21,26
76,8481014,Alexander Romanov,D,NYI,24,82,5,21,26
76,8470600,Ryan Suter,D,STL,39,82,4,22,26
76,8478851,Alexandre Carrier,D,NSH,28,82,1,25,26
76,8481641,Joel Kiviranta,L,COL,28,82,14,11,25
76,8480980,Connor Dewar,C,TOR,25,82,12,13,25
76,8478434,Keegan Kolesar,R,VGK,27,82,12,13,25
76,8482702,Logan Stankoven,C,DAL,21,82,12,13,25
76,8481028,Martin Pospisil,C,CGY,25,82,12,13,25
76,8482111,Justin Barron,D,MTL,23,82,11,14,25
76,8484153,Leo Carlsson,C,ANA,20,82,10,15,25
76,8476897,Oskar Sundqvist,C,STL,30,82,9,16,25
76,8483482,Tristan Luneau,D,ANA,20,82,9,16,25
76,8480003,Jesper Boqvist,C,FLA,26,82,8,17,25
76,8476873,Mark Jankowski,C,NSH,30,82,8,17,25
76,8478891,Mason Appleton,C,WPG,28,82,7,18,25
76,8480807,Mattias Samuelsson,D,BUF,24,82,6,19,25
76,8482245,Artem Zub,D,OTT,29,82,4,21,25
76,8476457,Adam Larsson,D,SEA,32,82,3,22,25
76,8476921,Jordan Martinook,L,CAR,32,82,15,9,24
76,8481601,Simon Holmstrom,R,NYI,23,82,14,10,24
76,8481013,Jonatan Berggren,R,DET,24,82,13,11,24
76,8481032,Paul Cotter,C,NJD,25,82,13,11,24
76,8484145,Zach Benson,L,BUF,19,82,12,12,24
76,8480813,Joe Veleno,C,DET,24,82,11,13,24
76,8482666,Scott Morrow,D,CAR,22,82,11,13,24
76,8480025,MacKenzie Entwistle,R,FLA,25,82,10,14,24
76,8479983,Mario Ferraro,D,SJS,26,82,9,15,24
76,8476878,Zemgus Girgensons,L,TBL,30,82,9,15,24
76,8482073,Braden Schneider,D,NYR,23,82,9,15,24
76,8482259,Bobby McMann,C,TOR,28,82,9,15,24
76,8477015,Connor Brown,R,EDM,30,82,9,15,24
76,8481477,Nico Sturm,C,SJS,29,82,8,16,24
76,8482762,Simon Edvinsson,D,DET,21,82,8,16,24
76,8480336,Sean Walker,D,CAR,30,82,7,17,24
76,8478911,Matt Roy,D,WSH,29,82,6,18,24
76,8474013,Ian Cole,D,UTA,35,82,5,19,24
76,8478443,Brandon Carlo,D,BOS,28,82,2,22,24
76,8480281,Alexey Toropchenko,R,STL,25,82,17,6,23
76,8482077,Dylan Holloway,L,EDM,23,82,12,11,23
76,8470621,Corey Perry,R,EDM,39,82,11,12,23
76,8479359,Beck Malenstyn,L,BUF,26,82,11,12,23
76,8479414,Nathan Bastian,R,NJD,27,82,10,13,23
76,8479393,Noah Gregor,C,OTT,26,82,10,13,23
76,8481522,Peyton Krebs,C,BUF,23,82,9,14,23
76,8484203,Bradly Nadeau,L,CAR,19,82,9,14,23
76,8476278,Colin Blackwell,C,DAL,31,82,8,15,23
76,8478432,Christian Fischer,R,DET,27,82,7,16,23
76,8478136,Jake Middleton,D,MIN,28,82,6,17,23
76,8481708,Zac Jones,D,NYR,24,82,6,17,23
76,8476879,Cody Ceci,D,EDM,31,82,6,17,23
76,8483505,Matthew Poitras,C,BOS,20,82,6,17,23
76,8474151,Ryan McDonagh,D,TBL,35,82,5,18,23
76,8475279,Ben Chiarot,D,DET,33,82,5,18,23
76,8480860,Kevin Bahl,D,CGY,24,82,5,18,23
76,8475790,Erik Gudbranson,D,CBJ,32,82,5,18,23
76,8483565,Nick Blankenburg,D,NSH,26,82,4,19,23
76,8476931,Jake McCabe,D,TOR,31,82,1,22,23
76,8478416,Erik Cernak,D,TBL,27,82,1,22,23
76,8481093,Rafael Harvey-Pinard,L,MTL,25,82,13,9,22
76,8477406,Mattias Janmark,C,EDM,32,82,10,12,22
76,8477369,Carson Soucy,D,VAN,30,82,9,13,22
76,8484149,Gavin Brindley,C,CBJ,20,82,9,13,22
76,8477499,Rasmus Ristolainen,D,PHI,30,82,7,15,22
76,8479398,Samuel Girard,D,COL,26,82,4,18,22
76,8479980,Nicolas Hague,D,VGK,26,82,3,19,22
76,8482679,Matt Coronato,R,CGY,22,82,12,9,21
76,8482858,Ryker Evans,D,SEA,23,82,10,11,21
76,8473453,Trevor Lewis,C,LAK,37,82,9,12,21
76,8477392,Hudson Fasching,R,NYI,29,82,9,12,21
76,8482470,Ilya Solovyov,D,CGY,24,82,8,13,21
76,8480144,David Kampf,C,TOR,29,82,7,14,21
76,8481567,Henry Thrun,D,SJS,23,82,6,15,21
76,8478399,Jonas Siegenthaler,D,NJD,27,82,6,15,21
76,8481568,Alex Vlasic,D,CHI,23,82,4,17,21
76,8478840,Will Borgen,D,SEA,28,82,4,17,21
76,8478882,Vladislav Gavrikov,D,LAK,29,82,4,17,21
76,8475233,David Savard,D,MTL,34,82,4,17,21
76,8482803,Olen Zellweger,D,ANA,21,82,4,17,21
76,8482087,Kaiden Guhle,D,MTL,22,82,3,18,21
76,8479371,Dante Fabbro,D,NSH,26,82,3,18,21
76,8477488,Brett Pesce,D,NJD,30,82,2,19,21
76,8475181,Nick Leddy,D,STL,33,82,1,20,21
76,8476891,Matt Grzelcyk,D,PIT,30,82,1,20,21
76,8478178,Darren Raddysh,D,TBL,28,82,0,21,21
76,8479638,Justin Brazeau,R,BOS,26,82,11,9,20
76,8478013,Jake Walman,D,SJS,28,82,10,10,20
76,8480448,Parker Kelly,L,COL,25,82,9,11,20
76,8483499,Liam Ohgren,L,MIN,20,82,9,11,20
76,8483763,Maksymilian Szuber,D,UTA,22,82,6,14,20
76,8482153,Brendan Brisson,C,VGK,23,82,6,14,20
76,8476374,Sean Kuraly,C,CBJ,31,82,4,16,20
76,8476429,Scott Mayfield,D,NYI,32,82,3,17,20
76,8475718,Justin Holl,D,DET,32,82,2,18,20
76,8475690,Chris Tanev,D,TOR,35,82,2,18,20
76,8476858,Phillip Di Giuseppe,L,VAN,31,82,12,7,19
76,8476624,Barclay Goodrow,C,SJS,31,82,7,12,19
76,8477508,Curtis Lazar,C,NJD,29,82,7,12,19
76,8479291,Kevin Rooney,C,CGY,31,82,7,12,19
76,8476889,Radek Faksa,C,STL,30,82,6,13,19
76,8483012,Logan Morrison,C,SEA,22,82,6,13,19
76,8483468,Jiri Kulich,C,BUF,20,82,5,14,19
76,8479369,Andrew Peeke,D,BOS,26,82,5,14,19
76,8481178,Egor Zamula,D,PHI,24,82,4,15,19
76,8476312,Josh Manson,D,COL,33,82,4,15,19
76,8481605,Jackson LaCombe,D,ANA,23,82,4,15,19
76,8480073,Erik Brannstrom,D,COL,25,82,3,16,19
76,8481524,Bowen Byram,D,BUF,23,82,10,8,18
76,8482712,Oskar Olausson,R,COL,22,82,9,9,18
76,8475842,Sam Carrick,C,NYR,32,82,9,9,18
76,8481481,Blake Lizotte,C,PIT,27,82,7,11,18
76,8477507,Nikita Zadorov,D,BOS,29,82,6,12,18
76,8476441,Joel Edmundson,D,LAK,31,82,6,12,18
76,8480222,Sebastian Aho,D,PIT,28,82,5,13,18
76,8476467,Jamie Oleksiak,D,SEA,32,82,4,14,18
76,8482141,Lukas Cormier,D,VGK,22,82,9,8,17
76,8476442,Matt Nieto,L,PIT,32,82,9,8,17
76,8482807,Ethan Del Mastro,D,CHI,21,82,7,10,17
76,8482733,Logan Mailloux,D,MTL,31,82,7,10,17
76,8482749,Joshua Roy,R,MTL,21,82,6,11,17
76,8482809,Jackson Blake,R,CAR,21,82,4,13,17
76,8476917,Adam Pelech,D,NYI,30,82,1,16,17
76,8480879,Jacob Bernard-Docker,D,OTT,24,82,1,16,17
76,8476967,Brett Kulak,D,EDM,30,82,1,16,17
76,8482155,Alex Laferriere,R,LAK,23,82,11,5,16
76,8482145,Mavrik Bourque,C,DAL,22,82,8,8,16
76,8483495,Simon Nemec,D,NJD,20,82,6,10,16
76,8476525,Colin Miller,D,WPG,32,82,5,11,16
76,8480246,Nick Perbix,D,TBL,26,82,4,12,16
76,8477365,Connor Clifton,D,BUF,29,82,3,13,16
76,8480172,Jan Rutta,D,SJS,34,82,3,13,16
76,8475762,Derek Forbort,D,VAN,32,82,1,15,16
76,8483524,Shane Wright,C,SEA,20,82,8,7,15
76,8482659,Josh Doan,R,UTA,22,82,8,7,15
76,8479442,Troy Stecher,D,EDM,30,82,8,7,15
76,8483445,Cutter Gauthier,L,ANA,20,82,7,8,15
76,8480870,Bo Groulx,C,NYR,24,82,5,10,15
76,8478468,Jeremy Lauzon,D,NSH,27,82,4,11,15
76,8480796,Martin Fehervary,D,WSH,25,82,4,11,15
76,8480035,Henri Jokiharju,D,BUF,25,82,2,13,15
76,8480021,Jack Studnicka,C,LAK,25,82,8,6,14
76,8477505,Alexander Wennberg,C,SJS,30,82,5,9,14
76,8477335,Kyle Burroughs,D,LAK,29,82,3,11,14
76,8483460,David Jiricek,D,CBJ,21,82,3,11,14
76,8475177,Calvin de Haan,D,COL,33,82,1,13,14
76,8480049,Dylan Samberg,D,WPG,25,82,0,14,14
76,8483397,Marc McLaughlin,C,BOS,25,82,8,5,13
76,8482118,Sam Colangelo,R,ANA,23,82,5,8,13
76,8482787,Nikita Chibrikov,R,WPG,31,82,5,8,13
76,8481122,Simon Benoit,D,TOR,26,82,5,8,13
76,8483471,Brad Lambert,C,WPG,31,82,4,9,13
76,8477938,Haydn Fleury,D,WPG,28,82,4,9,13
76,8481699,Aku Raty,R,UTA,23,82,4,9,13
76,8474090,Brendan Smith,D,DAL,35,82,1,12,13
76,8482516,Matthew Kessel,D,STL,24,82,5,7,12
76,8476473,Connor Murphy,D,CHI,31,82,3,9,12
76,8480950,Ilya Lyubushkin,D,DAL,30,82,2,10,12
76,8480834,Ty Emberson,D,SJS,24,82,2,10,12
76,8477034,Jaycob Megna,D,FLA,32,82,1,11,12
76,8482101,Danil Gushchin,L,SJS,22,82,3,8,11
76,8482859,Zack Ostapchuk,C,OTT,21,82,3,8,11
76,8478450,Parker Wotherspoon,D,BOS,27,82,1,10,11
76,8478874,Adam Gaudette,C,OTT,28,82,1,10,11
76,8476822,Luke Glendening,C,TBL,35,82,5,5,10
76,8484911,Collin Graf,R,SJS,22,82,5,5,10
76,8483567,Georgii Merkulov,C,BOS,24,82,3,7,10
76,8479576,Vincent Desharnais,D,VAN,28,82,2,8,10
76,8482070,Mitchell Chaffee,R,TBL,26,82,6,3,9
76,8483493,Frank Nazar,C,CHI,20,82,3,6,9
76,8482713,Mackie Samoskevich,R,FLA,22,82,2,7,9
76,8476372,Nick Seeler,D,PHI,31,82,1,8,9
76,8474612,Travis Hamonic,D,OTT,34,82,1,8,9
76,8483489,Fraser Minten,C,TOR,31,82,3,5,8
76,8483466,Kevin Korchinski,D,CHI,20,82,2,6,8
76,8474567,Zach Bogosian,D,MIN,34,82,2,6,8
76,8471677,Jack Johnson,D,CBJ,37,82,0,8,8
76,8480990,Declan Chisholm,D,MIN,24,82,3,4,7
76,8474062,Riley Nash,C,NYR,35,82,3,2,5
76,8470794,Joe Pavelski,C,,40,0,0,0,0
76,8481703,Valtteri Puustinen,R,PIT,25,0,0,0,0
76,8477950,Tony DeAngelo,D,,29,0,0,0,0
76,8481577,Philip Tomasino,C,NSH,23,0,0,0,0
76,8475197,Tyson Barrie,D,,33,0,0,0,0
76,8471218,Blake Wheeler,R,,38,0,0,0,0
76,8474157,Max Pacioretty,L,,36,0,0,0,0
76,8478466,Daniel Sprong,R,VAN,27,0,0,0,0
76,8475744,Evgeny Kuznetsov,C,,32,0,0,0,0
76,8481019,David Gustafsson,C,WPG,24,0,0,0,0
76,8475906,John Klingberg,D,,32,0,0,0,0
76,8479348,Kale Clague,D,BUF,26,0,0,0,0
76,8476952,Dominic Toninato,C,WPG,30,0,0,0,0
76,8473473,Milan Lucic,L,,36,0,0,0,0
76,8474037,James van Riemsdyk,L,,35,0,0,0,0
76,8474602,Justin Schultz,D,,34,0,0,0,0
76,8482222,Alexander Barabanov,L,,30,0,0,0,0
76,8479372,Josh Mahura,D,SEA,26,0,0,0,0
76,8479982,Conor Timmins,D,TOR,26,0,0,0,0
76,8474031,Kevin Shattenkirk,D,,35,0,0,0,0
76,8480008,Adam Ruzicka,C,,25,0,0,0,0
76,8481059,Scott Perunovich,D,STL,26,0,0,0,0
76,8480884,Calen Addison,D,,24,0,0,0,0
76,8476994,Vinnie Hinostroza,C,NSH,30,0,0,0,0
76,8478452,Caleb Jones,D,LAK,27,0,0,0,0
76,8480157,Calle Rosen,D,COL,30,0,0,0,0
76,8481609,Vladislav Kolyachonok,D,UTA,23,0,0,0,0
76,8479415,Michael McLeod,C,,26,0,0,0,0
76,8476919,Chris Tierney,C,,30,0,0,0,0
76,8479639,Dylan Coghlan,D,WPG,26,0,0,0,0
76,8478146,Matthew Highmore,C,OTT,28,0,0,0,0
76,8478970,Jalen Chatfield,D,CAR,28,0,0,0,0
76,8480205,Emil Bemstrom,C,PIT,25,0,0,0,0
76,8474884,Mike Hoffman,C,,35,0,0,0,0
76,8471274,Alex Goligoski,D,,39,0,0,0,0
76,8478104,Sammy Blais,L,,28,0,0,0,0
76,8474870,Tyler Johnson,C,,34,0,0,0,0
76,8476913,Devin Shore,C,MIN,30,0,0,0,0
76,8481598,Philip Broberg,D,EDM,23,0,0,0,0
76,8480058,Pierre-Olivier Joseph,D,STL,25,0,0,0,0
76,8480891,Michael Kesselring,D,UTA,24,0,0,0,0
76,8477979,Nicolas Aube-Kubel,R,BUF,28,0,0,0,0
76,8476871,Tanner Pearson,L,,32,0,0,0,0
76,8476393,Nick Cousins,C,,31,0,0,0,0
76,8479977,Kailer Yamamoto,R,,26,0,0,0,0
76,8479543,Michael Pezzetta,L,MTL,26,0,0,0,0
76,8477018,Ben Hutton,D,VGK,31,0,0,0,0
76,8480762,Eric Robinson,L,CAR,29,0,0,0,0
76,8474034,Pat Maroon,L,CHI,36,0,0,0,0
76,8481058,Jesse Ylönen,R,,25,0,0,0,0
76,8475179,Dmitry Kulikov,D,FLA,34,0,0,0,0
76,8481527,Kaedan Korczak,D,VGK,23,0,0,0,0
76,8473449,Kyle Okposo,R,,36,0,0,0,0
76,8482192,Isaak Phillips,D,CHI,23,0,0,0,0
76,8480727,Zach Whitecloud,D,VGK,28,0,0,0,0
76,8479346,Dillon Dube,C,,26,0,0,0,0
76,8480821,Filip Zadina,R,,25,0,0,0,0
76,8480001,Urho Vaakanainen,D,ANA,25,0,0,0,0
76,8470966,Mark Giordano,D,,41,0,0,0,0
76,8480853,Liam Foudy,C,,24,0,0,0,0
76,8475225,Craig Smith,C,CHI,35,0,0,0,0
76,8479972,Mason Shaw,C,WPG,26,0,0,0,0
76,8478451,Ethan Bear,D,WSH,27,0,0,0,0
76,8474040,Sam Gagner,C,,35,0,0,0,0
76,8480196,Jacob Bryson,D,BUF,27,0,0,0,0
76,8479984,Cal Foote,D,,26,0,0,0,0
76,8480011,Klim Kostin,C,SJS,25,0,0,0,0
76,8482176,Wyatt Kaiser,D,CHI,22,0,0,0,0
76,8476988,Matt Benning,D,SJS,30,0,0,0,0
76,8479370,Tyson Jost,C,CAR,26,0,0,0,0
76,8477464,Nic Petan,C,,29,0,0,0,0
76,8477380,Jonny Brodzinski,C,NYR,31,0,0,0,0
76,8480070,Ian Mitchell,D,BOS,25,0,0,0,0
76,8479315,Joey Anderson,R,CHI,26,0,0,0,0
76,8478099,Kevin Labanc,R,,29,0,0,0,0
76,8476874,Olli Maatta,D,DET,30,0,0,0,0
76,8475208,Brian Dumoulin,D,ANA,33,0,0,0,0
76,8478430,Oliver Kylington,D,,27,0,0,0,0
76,8479536,Axel Jonsson-Fjallby,L,WPG,26,0,0,0,0
76,8479671,Mathieu Olivier,R,CBJ,27,0,0,0,0
76,8471709,Marc-Edouard Vlasic,D,SJS,37,0,0,0,0
76,8479328,Julien Gauthier,R,NYI,27,0,0,0,0
76,8478421,A.J. Greer,L,FLA,28,0,0,0,0
76,8477573,Nathan Walker,L,STL,30,0,0,0,0
76,8481537,Nikita Okhotiuk,D,CGY,24,0,0,0,0
76,8474166,Alec Martinez,D,CHI,37,0,0,0,0
76,8470610,Zach Parise,L,,40,0,0,0,0
76,8477478,William Carrier,L,CAR,30,0,0,0,0
76,8479344,Jesse Puljujarvi,R,PIT,26,0,0,0,0
76,8480887,Jordan Harris,D,MTL,24,0,0,0,0
76,8478502,Dennis Gilbert,D,BUF,28,0,0,0,0
76,8482730,Brandt Clarke,D,LAK,21,0,0,0,0
76,8480355,Mark Kastelic,C,BOS,25,0,0,0,0
76,8475750,Jon Merrill,D,MIN,32,0,0,0,0
76,8475164,Jakob Silfverberg,R,,34,0,0,0,0
76,8477944,Jakub Vrana,L,,28,0,0,0,0
76,8479439,Jacob MacDonald,D,COL,31,0,0,0,0
76,8474568,Luke Schenn,D,NSH,35,0,0,0,0
76,8478454,Noah Juulsen,D,VAN,27,0,0,0,0
76,8475752,Tyler Pitlick,C,,33,0,0,0,0
76,8482148,Hendrix Lapierre,C,WSH,22,0,0,0,0
76,8481167,Brayden Pachal,D,CGY,25,0,0,0,0
76,8478043,Sam Lafferty,C,BUF,29,0,0,0,0
76,8479321,Lucas Johansen,D,,27,0,0,0,0
76,8471699,Andrew Cogliano,C,,37,0,0,0,0
76,8481521,Ronnie Attard,D,PHI,25,0,0,0,0
76,8481161,Jake Christiansen,D,CBJ,25,0,0,0,0
76,8479458,Nikita Zaitsev,D,,33,0,0,0,0
76,8479619,Michael Carcone,L,UTA,28,0,0,0,0
76,8479026,Philippe Myers,D,TOR,27,0,0,0,0
76,8477330,Dominik Kubalik,L,,29,0,0,0,0
76,8481617,Vasily Podkolzin,R,VAN,23,0,0,0,0
76,8481701,Santeri Hatakka,D,NJD,23,0,0,0,0
76,8479514,Rem Pitlick,C,,27,0,0,0,0
76,8477446,Michael McCarron,R,NSH,29,0,0,0,0
76,8470604,Jeff Carter,C,,39,0,0,0,0
76,8482241,Radim Zohorna,L,,28,0,0,0,0
76,8480289,Morgan Barron,C,WPG,26,0,0,0,0
76,8479379,Givani Smith,R,SJS,26,0,0,0,0
76,8480216,Jacob Peterson,C,,25,0,0,0,0
76,8477851,Jordan Oesterle,D,BOS,32,0,0,0,0
76,8484258,Sam Malinski,D,COL,26,0,0,0,0
76,8478904,Steven Lorentz,C,,28,0,0,0,0
76,8482095,Tyler Kleven,D,OTT,22,0,0,0,0
76,8480848,Ty Dellandrea,C,SJS,24,0,0,0,0
76,8476884,Derrick Pouliot,D,,30,0,0,0,0
76,8479336,Carl Grundstrom,R,SJS,27,0,0,0,0
76,8482964,Arber Xhekaj,D,MTL,23,0,0,0,0
76,8471686,Marc Staal,D,,37,0,0,0,0
76,8477887,Patrick Brown,C,BOS,32,0,0,0,0
76,8478495,Denis Gurianov,R,,27,0,0,0,0
76,8473504,Cal Clutterbuck,R,,37,0,0,0,0
76,8481550,Adam Beckman,L,NJD,23,0,0,0,0
76,8480845,Rasmus Kupari,C,WPG,24,0,0,0,0
76,8474009,Nick Bonino,C,,36,0,0,0,0
76,8478585,Derek Ryan,C,EDM,38,0,0,0,0
76,8477962,Brendan Lemieux,L,CAR,28,0,0,0,0
76,8482861,Vincent Iorio,D,WSH,22,0,0,0,0
76,8479378,Logan Stanley,D,WPG,26,0,0,0,0
76,8473446,Erik Johnson,D,PHI,36,0,0,0,0
76,8481743,Marc Del Gaizo,D,NSH,25,0,0,0,0
76,8477384,Josh Brown,D,EDM,30,0,0,0,0
76,8482165,Yan Kuznetsov,D,CGY,22,0,0,0,0
76,8478424,Jansen Harkins,C,ANA,27,0,0,0,0
76,8482144,Jack Thompson,D,SJS,22,0,0,0,0
76,8478512,Austin Czarnik,C,,32,0,0,0,0
76,8477527,Ross Johnston,L,ANA,30,0,0,0,0
76,8479383,Boris Katchouk,L,,26,0,0,0,0
76,8482094,Daemon Hunt,D,MIN,22,0,0,0,0
76,8481719,Maxwell Crozier,D,TBL,24,0,0,0,0
76,8480192,Johnathan Kovacevic,D,NJD,27,0,0,0,0
76,8479376,Victor Mete,D,,26,0,0,0,0
76,8482511,Mason Lohrei,D,BOS,23,0,0,0,0
76,8475825,Jani Hakanpää,D,,32,0,0,0,0
76,8478021,William Lagesson,D,DET,28,0,0,0,0
76,8475795,Dylan McIlrath,D,WSH,32,0,0,0,0
76,8477846,Ryan Carpenter,C,,33,0,0,0,0
76,8481056,Spencer Stastney,D,NSH,24,0,0,0,0
76,8481564,Ryan Johnson,D,BUF,23,0,0,0,0
76,8478017,Mark Friedman,D,VAN,29,0,0,0,0
76,8479320,Max Lajoie,D,SEA,27,0,0,0,0
76,8480075,Cameron Crotty,D,MIN,25,0,0,0,0
76,8484287,Cole McWard,D,VAN,23,0,0,0,0
76,8484254,Akito Hirose,D,VAN,25,0,0,0,0
76,8483407,Brandon Scanlin,D,NYR,25,0,0,0,0
76,8480274,Philip Kemp,D,EDM,25,0,0,0,0
76,8479522,Hardy Haman Aktell,D,WSH,26,0,0,0,0
76,8480007,Jonas Rondbjerg,R,VGK,25,0,0,0,0
76,8477454,Adam Erne,L,,29,0,0,0,0
76,8481679,Maxence Guenette,D,OTT,23,0,0,0,0
76,8480441,Trey Fix-Wolansky,R,CBJ,25,0,0,0,0
76,8483546,Marshall Rifai,D,TOR,26,0,0,0,0
76,8480084,Nick DeSimone,D,NJD,30,0,0,0,0
76,8481030,Jack St. Ivany,D,PIT,25,0,0,0,0
76,8481592,Jakob Pelletier,L,CGY,23,0,0,0,0
76,8478011,Louie Belpedio,D,PHI,28,0,0,0,0
76,8477930,Pierre-Edouard Bellemare,L,,39,0,0,0,0
76,8484321,Nikolas Matinpalo,D,OTT,26,0,0,0,0
76,8482067,Connor Mackey,D,NYR,28,0,0,0,0
76,8481806,Louis Crevier,D,CHI,23,0,0,0,0
76,8484326,Patrik Koch,D,UTA,28,0,0,0,0
76,8477971,Andreas Englund,D,LAK,28,0,0,0,0
76,8481751,Lukas Rousek,R,BUF,25,0,0,0,0
76,8481006,Tyler Tucker,D,STL,24,0,0,0,0
76,8476867,Brendan Gaunce,C,MIN,30,0,0,0,0
76,8479520,Brandon Duhaime,R,WSH,27,0,0,0,0
76,8477073,Kurtis MacDermid,L,NJD,30,0,0,0,0
76,8480874,Adam Ginning,D,PHI,24,0,0,0,0
76,8477473,Justin Bailey,R,SJS,29,0,0,0,0
76,8479066,Ryan Lomberg,L,CGY,30,0,0,0,0
76,8477070,Liam O'Brien,C,UTA,30,0,0,0,0
76,8474618,Marco Scandella,D,,34,0,0,0,0
76,8475797,Jarred Tinordi,D,,32,0,0,0,0
76,8481441,Joe Snively,C,DET,28,0,0,0,0
76,8477244,Chad Ruhwedel,D,NYR,34,0,0,0,0
76,8479772,Zack MacEwen,R,OTT,28,0,0,0,0
76,8481147,Reese Johnson,C,MIN,26,0,0,0,0
76,8481043,Cole Koepke,L,BOS,26,0,0,0,0
76,8483619,Filip Roos,D,OTT,25,0,0,0,0
76,8481541,Samuel Bolduc,D,NYI,24,0,0,0,0
76,8477810,Joel Hanley,D,CGY,33,0,0,0,0
76,8476907,Mackenzie MacEachern,L,,30,0,0,0,0
76,8482652,Walker Duehr,R,CGY,27,0,0,0,0
76,8477126,Jayson Megna,C,,34,0,0,0,0
76,8483398,Declan Carlile,D,TBL,31,0,0,0,0
76,8482929,Emil Lilleberg,D,TBL,23,0,0,0,0
76,8480880,Jakub Lauko,C,MIN,24,0,0,0,0
76,8480245,Olle Lycksell,R,PHI,25,0,0,0,0
76,8480252,Cole Guttman,C,CHI,25,0,0,0,0
76,8477467,Gustav Olofsson,D,SEA,30,0,0,0,0
76,8479968,Vinni Lettieri,C,BOS,29,0,0,0,0
76,8478400,Colin White,C,,27,0,0,0,0
76,8475755,Alexander Petrovic,D,DAL,32,0,0,0,0
76,8481812,Nikolai Knyzhov,D,,27,0,0,0,0
76,8481593,Jayden Struble,D,MTL,23,0,0,0,0
76,8481532,Alex Turcotte,C,LAK,23,0,0,0,0
76,8482126,Emil Andrae,D,PHI,31,0,0,0,0
76,8479944,Zach Aston-Reese,C,VGK,30,0,0,0,0
76,8471817,Ryan Reaves,R,TOR,37,0,0,0,0
76,8481206,John Ludvig,D,PIT,24,0,0,0,0
76,8481599,Victor Soderstrom,D,UTA,23,0,0,0,0
76,8480292,Carson Meyer,R,ANA,27,0,0,0,0
76,8482496,Nils Aman,C,VAN,24,0,0,0,0
76,8479718,Alex Barré-Boulet,C,MTL,27,0,0,0,0
76,8479994,Jaret Anderson-Dolan,C,WPG,25,0,0,0,0
76,8480184,Gustav Lindstrom,D,,26,0,0,0,0
76,8480890,Jan Jenik,R,OTT,24,0,0,0,0
76,8478067,Oskar Lindblom,L,,28,0,0,0,0
76,8476934,Brock McGinn,L,ANA,30,0,0,0,0
76,8479985,Cale Fleury,D,SEA,26,0,0,0,0
76,8484304,Uvis Balinskis,D,FLA,28,0,0,0,0
76,8479981,Jonah Gadjovich,L,FLA,26,0,0,0,0
76,8481716,Dmitri Voronkov,L,CBJ,24,0,0,0,0
76,8474709,Matt Martin,L,,35,0,0,0,0
76,8482634,Alex Steeves,C,TOR,25,0,0,0,0
76,8480823,Alexander Alexeyev,D,WSH,25,0,0,0,0
76,8477541,Dakota Mermis,D,TOR,30,0,0,0,0
76,8483491,Ivan Miroshnichenko,L,WSH,20,0,0,0,0
76,8478477,Mitchell Stephens,C,SEA,27,0,0,0,0
76,8481543,Nikita Alexandrov,C,STL,24,0,0,0,0
76,8479423,Alex Nylander,L,,26,0,0,0,0
76,8482451,Mikael Pyyhtia,L,CBJ,23,0,0,0,0
76,8478831,Kevin Stenlund,C,UTA,28,0,0,0,0
76,8480306,Grant Hutton,D,NYI,29,0,0,0,0
76,8478028,Fredrik Olofsson,L,,28,0,0,0,0
76,8477462,Robert Hagg,D,VGK,29,0,0,0,0
76,8477320,Anton Blidh,L,NYR,29,0,0,0,0
76,8482157,Will Cuylle,L,NYR,22,0,0,0,0
76,8482737,Zack Bolduc,C,STL,21,0,0,0,0
76,8481239,Samuel Fagemo,L,,24,0,0,0,0
76,8481600,Tobias Bjornfot,D,FLA,23,0,0,0,0
76,8478409,Anthony Richard,C,PHI,28,0,0,0,0
76,8474145,Robert Bortuzzo,D,,35,0,0,0,0
76,8475958,Michael Sgarbossa,C,WSH,32,0,0,0,0
76,8479986,Kole Lind,R,DAL,26,0,0,0,0
76,8479249,Andrew Poturalski,C,SJS,30,0,0,0,0
76,8479362,Riley Tufte,L,BOS,26,0,0,0,0
76,8479991,Jake Leschyshyn,C,NYR,25,0,0,0,0
76,8479587,Rhett Gardner,C,PHI,28,0,0,0,0
76,8482744,James Malatesta,L,CBJ,21,0,0,0,0
76,8478854,Ryan Shea,D,PIT,27,0,0,0,0
76,8481591,Sam Poulin,R,,23,0,0,0,0
76,8483512,Matt Savoie,C,EDM,20,0,0,0,0
76,8482102,Vasily Ponomarev,C,PIT,22,0,0,0,0
76,8482162,Roby Jarventie,L,EDM,22,0,0,0,0
76,8481016,Ruslan Iskhakov,C,,24,0,0,0,0
76,8482172,Landon Slaggert,L,CHI,22,0,0,0,0
76,8482747,Brennan Othmann,L,NYR,21,0,0,0,0
76,8480031,Maxime Comtois,L,,25,0,0,0,0
76,8480226,Marián Studenic,R,,26,0,0,0,0
76,8478408,Travis Dermott,D,,28,0,0,0,0
76,8481518,Nolan Foote,L,NJD,24,0,0,0,0
76,8479419,Brett Murray,L,BUF,26,0,0,0,0
76,8482088,Justin Sourdif,R,FLA,22,0,0,0,0
76,8482201,Gage Goncalves,C,TBL,23,0,0,0,0
76,8481578,Graeme Clarke,R,MIN,23,0,0,0,0
76,8482177,Marat Khusnutdinov,C,MIN,22,0,0,0,0
76,8481754,Nikita Nesterenko,C,ANA,23,0,0,0,0
76,8483531,Brian Halonen,L,NJD,25,0,0,0,0
76,8483920,Pierrick Dube,R,WSH,23,0,0,0,0
76,8480851,Akil Thomas,C,LAK,24,0,0,0,0
76,8475235,Nicolas Deslauriers,L,PHI,33,0,0,0,0
76,8482476,Emil Heineman,L,MTL,23,0,0,0,0
76,8477149,Scott Sabourin,R,SJS,32,0,0,0,0
76,8483549,Lucas Condotta,L,MTL,27,0,0,0,0
76,8482765,Isak Rosen,R,BUF,21,0,0,0,0
76,8481237,Kyle MacLean,C,NYI,25,0,0,0,0
76,8481024,Linus Karlsson,C,VAN,25,0,0,0,0
76,8481690,Tyler Angle,C,,24,0,0,0,0
76,8483570,Ben Meyers,C,SEA,26,0,0,0,0
76,8481655,Cole Schwindt,R,CGY,23,0,0,0,0
76,8481462,Mason Morelli,L,VGK,28,0,0,0,0
76,8483401,Marc Johnstone,R,PIT,28,0,0,0,0
76,8478956,Samuel Laberge,L,NJD,27,0,0,0,0
76,8479533,Joona Koppanen,L,,26,0,0,0,0
76,8482197,Adam Raska,R,MIN,23,0,0,0,0
76,8482250,Callahan Burke,C,VGK,27,0,0,0,0
76,8482784,Zach Dean,C,STL,21,0,0,0,0
76,8484255,Jason Polin,R,COL,25,0,0,0,0
76,8481077,John Leonard,L,,26,0,0,0,0
76,8481534,Raphael Lavoie,C,EDM,24,0,0,0,0
76,8483609,Adam Klapka,R,CGY,24,0,0,0,0
76,8482751,Ryan Winterton,C,SEA,21,0,0,0,0
76,8480267,Sammy Walker,C,MIN,25,0,0,0,0
76,8475766,Austin Watson,L,,32,0,0,0,0
76,8482460,Matt Rempe,C,NYR,22,0,0,0,0
76,8481065,Angus Crookshank,L,OTT,25,0,0,0,0
76,8481070,Hugh McGing,L,,26,0,0,0,0
76,8476323,Max McCormick,L,SEA,32,0,0,0,0
76,8483395,Arshdeep Bains,L,VAN,23,0,0,0,0
76,8484259,Ondrej Pavel,C,COL,31,0,0,0,0
76,8483432,Luca Del Bel Belluz,C,CBJ,31,0,0,0,0
76,8483045,Cameron Butler,R,CBJ,31,0,0,0,0
76,8482061,Brandon Biro,L,SEA,26,0,0,0,0
76,8477401,John Hayden,C,SEA,29,0,0,0,0
76,8475278,Byron Froese,C,,33,0,0,0,0
76,8478446,Glenn Gawdin,C,LAK,27,0,0,0,0
76,8477993,Justin Kirkland,C,CGY,28,0,0,0,0
76,8482147,Jean-Luc Foudy,C,COL,22,0,0,0,0
76,8480032,Shane Bowers,C,NJD,25,0,0,0,0
76,8479330,Brandon Gignac,C,MTL,27,0,0,0,0
76,8480776,Sheldon Rempal,R,,29,0,0,0,0
76,8475413,Justin Dowling,C,NJD,34,0,0,0,0
76,8481726,Adam Edstrom,C,NYR,24,0,0,0,0
76,8480844,Grigori Denisenko,L,VGK,24,0,0,0,0
76,8478147,Bokondji Imama,L,PIT,28,0,0,0,0
76,8478881,Brett Seney,L,CHI,28,0,0,0,0
76,8483630,Pavol Regenda,L,ANA,25,0,0,0,0
76,8480836,Jonathan Gruden,C,,24,0,0,0,0
76,8484314,Jiri Smejkal,L,,28,0,0,0,0
76,8475780,Chris Wagner,R,COL,33,0,0,0,0
76,8479546,Oskar Steen,C,,26,0,0,0,0
76,8483597,Milos Kelemen,L,UTA,25,0,0,0,0
76,8481789,Tye Kartye,L,SEA,23,0,0,0,0
76,8484325,Waltteri Merela,C,TBL,26,0,0,0,0
76,8479421,Jacob Moverare,D,LAK,26,0,0,0,0
76,8481585,Egor Afanasyev,L,SJS,23,0,0,0,0
76,8479547,Matthew Phillips,R,,26,0,0,0,0
76,8479367,William Lockwood,R,FLA,26,0,0,0,0
76,8476915,Jujhar Khaira,L,,30,0,0,0,0
76,8481422,Jacob Lucchini,C,NSH,29,0,0,0,0
76,8480468,James Hamblin,L,EDM,25,0,0,0,0
76,8478051,Max Willman,C,NJD,29,0,0,0,0
76,8481556,John Beecher,C,BOS,23,0,0,0,0
76,8478078,Rourke Chartier,C,,28,0,0,0,0
77,8478402,Connor McDavid,C,EDM,27,82,47,98,145
77,8476453,Nikita Kucherov,R,TBL,31,82,33,98,131
77,8479318,Auston Matthews,C,TOR,27,82,64,63,127
77,8477492,Nathan MacKinnon,C,COL,29,82,45,81,126
77,8478420,Mikko Rantanen,R,COL,28,82,42,83,125
77,8477934,Leon Draisaitl,C,EDM,29,82,42,77,119
77,8477956,David Pastrnak,R,BOS,28,82,44,72,116
77,8481559,Jack Hughes,C,NJD,23,82,45,70,115
77,8478550,Artemi Panarin,L,NYR,33,82,36,72,108
77,8479314,Matthew Tkachuk,L,FLA,27,82,34,69,103
77,8474600,Roman Josi,D,NSH,34,82,21,79,100
77,8477939,William Nylander,R,TOR,28,82,51,48,99
77,8480023,Robert Thomas,C,STL,25,82,28,70,98
77,8474564,Steven Stamkos,C,NSH,34,82,35,62,97
77,8478864,Kirill Kaprizov,L,MIN,27,82,45,51,96
77,8471675,Sidney Crosby,C,PIT,37,82,38,58,96
77,8480027,Jason Robertson,L,DAL,25,82,41,54,95
77,8476887,Filip Forsberg,L,NSH,30,82,40,55,95
77,8473419,Brad Marchand,L,BOS,36,82,46,47,93
77,8480012,Elias Pettersson,C,VAN,26,82,39,53,92
77,8480002,Nico Hischier,C,NJD,25,82,39,53,92
77,8477402,Pavel Buchnevich,L,STL,29,82,37,55,92
77,8482116,Tim Stützle,C,OTT,22,82,29,62,91
77,8480801,Brady Tkachuk,L,OTT,25,82,43,47,90
77,8475172,Nazem Kadri,C,CGY,34,82,36,53,89
77,8478449,Roope Hintz,C,DAL,28,82,40,48,88
77,8476389,Vincent Trocheck,C,NYR,31,82,38,50,88
77,8477949,Alex Tuch,R,BUF,28,82,32,56,88
77,8478445,Mathew Barzal,C,NYI,27,82,24,64,88
77,8481557,Matt Boldy,L,MIN,23,82,38,49,87
77,8480208,Drake Batherson,R,OTT,26,82,33,54,87
77,8476454,Ryan Nugent-Hopkins,C,EDM,31,82,22,65,87
77,8481523,Kirby Dach,C,MTL,23,82,14,71,85
77,8475786,Zach Hyman,L,EDM,32,82,46,38,84
77,8479385,Jordan Kyrou,C,STL,26,82,36,47,83
77,8477933,Sam Reinhart,C,FLA,29,82,34,49,83
77,8477493,Aleksander Barkov,C,FLA,29,82,28,55,83
77,8480069,Cale Makar,D,COL,26,82,24,58,82
77,8480036,Miro Heiskanen,D,DAL,25,82,17,64,81
77,8480800,Quinn Hughes,D,VAN,25,82,5,76,81
77,8478010,Brayden Point,C,TBL,28,82,41,39,80
77,8477404,Jake Guentzel,C,TBL,30,82,37,43,80
77,8476468,J.T. Miller,C,VAN,31,82,33,47,80
77,8476460,Mark Scheifele,C,WPG,31,82,33,47,80
77,8476448,William Karlsson,C,VGK,31,82,30,50,80
77,8477409,Carter Verhaeghe,C,FLA,29,82,37,42,79
77,8478427,Sebastian Aho,C,CAR,27,82,36,43,79
77,8475166,John Tavares,C,TOR,34,82,32,47,79
77,8476459,Mika Zibanejad,C,NYR,31,82,28,51,79
77,8477942,Kevin Fiala,L,LAK,28,82,28,51,79
77,8471215,Evgeni Malkin,C,PIT,38,82,36,42,78
77,8482093,Seth Jarvis,C,CAR,22,82,36,42,78
77,8479407,Jesper Bratt,L,NJD,26,82,33,45,78
77,8475913,Mark Stone,R,VGK,32,82,30,48,78
77,8476539,Jonathan Marchessault,R,NSH,34,82,42,34,76
77,8478398,Kyle Connor,L,WPG,28,82,35,41,76
77,8475184,Chris Kreider,L,NYR,33,82,49,26,75
77,8479337,Alex DeBrincat,R,DET,27,82,38,37,75
77,8478444,Brock Boeser,R,VAN,27,82,34,41,75
77,8478401,Pavel Zacha,C,BOS,27,82,31,44,75
77,8477946,Dylan Larkin,C,DET,28,82,27,47,74
77,8476853,Morgan Rielly,D,TOR,30,82,13,61,74
77,8475810,Bryan Rust,R,PIT,32,82,36,37,73
77,8481596,Shane Pinto,C,OTT,24,82,32,41,73
77,8476462,Dougie Hamilton,D,NJD,31,82,18,55,73
77,8476346,Johnny Gaudreau,L,CBJ,31,82,22,50,72
77,8475798,Mikael Granlund,C,SJS,32,82,20,52,72
77,8479323,Adam Fox,D,NYR,26,82,9,63,72
77,8478439,Travis Konecny,R,PHI,27,82,31,40,71
77,8475158,Ryan O'Reilly,C,NSH,33,82,29,42,71
77,8474578,Erik Karlsson,D,PIT,34,82,16,55,71
77,8479325,Charlie McAvoy,D,BOS,27,82,12,59,71
77,8479542,Brandon Hagel,L,TBL,26,82,34,36,70
77,8475784,Jeff Skinner,C,EDM,32,82,34,36,70
77,8478975,Mason Marchment,L,DAL,29,82,30,40,70
77,8473512,Claude Giroux,R,OTT,36,82,22,48,70
77,8479343,Clayton Keller,R,UTA,26,82,20,50,70
77,8480018,Nick Suzuki,C,MTL,25,82,16,54,70
77,8474141,Patrick Kane,R,DET,36,82,25,44,69
77,8482097,Jack Quinn,R,BUF,23,82,25,44,69
77,8478038,Devon Toews,D,COL,30,82,16,53,69
77,8479365,Trent Frederic,C,BOS,26,82,34,34,68
77,8480839,Rasmus Dahlin,D,BUF,24,82,20,48,68
77,8478407,Vince Dunn,D,SEA,28,82,16,52,68
77,8475692,Mats Zuccarello,R,MIN,37,82,15,53,68
77,8481540,Cole Caufield,R,MTL,23,82,32,35,67
77,8478403,Jack Eichel,C,VGK,28,82,29,38,67
77,8480830,Andrei Svechnikov,R,CAR,24,82,25,42,67
77,8477447,Shea Theodore,D,VGK,29,82,16,51,67
77,8471214,Alex Ovechkin,L,WSH,39,82,33,33,66
77,8477504,Josh Morrissey,D,WPG,29,82,16,50,66
77,8480865,Noah Dobson,D,NYI,24,82,12,54,66
77,8476881,Tomas Hertl,C,VGK,31,82,28,37,65
77,8477955,Jared McCann,L,SEA,28,82,35,29,64
77,8477496,Elias Lindholm,C,BOS,30,82,24,40,64
77,8478440,Dylan Strome,C,WSH,27,82,24,40,64
77,8482684,Luke Hughes,D,NJD,21,82,16,48,64
77,8480434,Sean Durzi,D,UTA,26,82,15,49,64
77,8477501,Valeri Nichushkin,R,COL,29,82,37,26,63
77,8477476,Artturi Lehkonen,L,COL,29,82,35,28,63
77,8477960,Adrian Kempe,R,LAK,28,82,32,31,63
77,8478042,Viktor Arvidsson,R,EDM,31,82,27,36,63
77,8477932,Aaron Ekblad,D,FLA,28,82,26,37,63
77,8478414,Timo Meier,R,NJD,28,82,26,37,63
77,8474102,David Perron,L,OTT,36,82,23,40,63
77,8476456,Jonathan Huberdeau,C,CGY,31,82,14,49,63
77,8479420,Tage Thompson,C,BUF,27,82,31,31,62
77,8475794,Tyler Seguin,C,DAL,32,82,30,32,62
77,8481528,Dylan Cozens,C,BUF,23,82,27,35,62
77,8478493,Joel Eriksson Ek,C,MIN,27,82,26,36,62
77,8477444,Andre Burakovsky,L,SEA,29,82,26,36,62
77,8478047,Michael Bunting,L,PIT,29,82,25,37,62
77,8477951,Nick Schmaltz,C,UTA,28,82,22,40,62
77,8471724,Kris Letang,D,PIT,37,82,15,47,62
77,8479675,Trevor Moore,L,LAK,29,82,34,27,61
77,8482665,Matty Beniers,C,SEA,22,82,29,32,61
77,8476479,Phillip Danault,C,LAK,31,82,22,39,61
77,8478460,Zach Werenski,D,CBJ,27,82,20,41,61
77,8475754,Brock Nelson,C,NYI,33,82,32,28,60
77,8478873,Troy Terry,R,ANA,27,82,30,30,60
77,8478856,Conor Garland,R,VAN,28,82,21,39,60
77,8480078,Filip Chytil,C,NYR,25,82,17,43,60
77,8482175,JJ Peterka,R,BUF,22,82,32,27,59
77,8477407,Anthony Duclair,L,NYI,29,82,30,29,59
77,8477500,Bo Horvat,C,NYI,29,82,29,30,59
77,8475170,Brayden Schenn,C,STL,33,82,28,31,59
77,8477935,Sam Bennett,C,FLA,28,82,24,35,59
77,8480015,Owen Tippett,R,PHI,25,82,31,27,58
77,8477940,Nikolaj Ehlers,L,WPG,28,82,30,28,58
77,8478233,Andrew Mangiapane,L,WSH,28,82,30,28,58
77,8480188,Fabian Zetterlund,L,SJS,25,82,26,32,58
77,8474679,Gustav Nyquist,C,NSH,35,82,24,34,58
77,8474586,Jordan Eberle,R,SEA,34,82,19,39,58
77,8478397,Rasmus Andersson,D,CGY,28,82,12,46,58
77,8475169,Evander Kane,L,EDM,33,82,28,29,57
77,8478462,Nicolas Roy,C,VGK,27,82,26,31,57
77,8480797,Joel Farabee,L,PHI,24,82,23,34,57
77,8474150,Mikael Backlund,C,CGY,35,82,20,37,57
77,8477416,Oliver Bjorkstrand,R,SEA,29,82,18,39,57
77,8481711,Matias Maccelli,L,UTA,24,82,14,43,57
77,8476483,Rickard Rakell,R,PIT,31,82,34,22,56
77,8479339,Patrik Laine,L,CBJ,26,82,27,29,56
77,8482078,Lucas Raymond,L,DET,22,82,22,34,56
77,8473994,Jamie Benn,L,DAL,35,82,20,36,56
77,8476826,Yanni Gourde,C,SEA,33,82,20,36,56
77,8475168,Matt Duchene,C,DAL,33,82,18,38,56
77,8480798,Philipp Kurashev,C,CHI,25,82,14,42,56
77,8482124,Quinton Byfield,R,LAK,22,82,11,45,56
77,8474565,Alex Pietrangelo,D,VGK,34,82,7,49,56
77,8475799,Nino Niederreiter,R,WPG,32,82,26,29,55
77,8478438,Tommy Novak,C,NSH,27,82,25,30,55
77,8477511,Anthony Mantha,R,CGY,30,82,35,19,54
77,8480014,Gabriel Vilardi,C,WPG,25,82,30,24,54
77,8478498,Jake DeBrusk,L,VAN,28,82,28,26,54
77,8482109,Alexis Lafrenière,L,NYR,23,82,26,28,54
77,8475726,Tyler Toffoli,C,SJS,32,82,24,30,54
77,8471685,Anze Kopitar,C,LAK,37,82,22,32,54
77,8482113,Anton Lundell,C,FLA,23,82,21,33,54
77,8476905,Chandler Stephenson,C,SEA,30,82,20,34,54
77,8475745,Charlie Coyle,C,BOS,32,82,23,30,53
77,8474563,Drew Doughty,D,LAK,35,82,11,42,53
77,8476869,Brady Skjei,D,NSH,30,82,8,45,53
77,8476399,Blake Coleman,C,CGY,33,82,28,24,52
77,8482740,Wyatt Johnston,C,DAL,21,82,28,24,52
77,8484144,Connor Bedard,C,CHI,19,82,28,24,52
77,8482699,Dylan Guenther,R,UTA,21,82,27,25,52
77,8480009,Eeli Tolvanen,R,SEA,25,82,21,31,52
77,8477494,Jonathan Drouin,L,COL,29,82,17,35,52
77,8478519,Anthony Cirelli,C,TBL,27,82,16,36,52
77,8474590,John Carlson,D,WSH,34,82,14,38,52
77,8480803,Evan Bouchard,D,EDM,25,82,12,40,52
77,8475167,Victor Hedman,D,TBL,34,82,9,43,52
77,8479400,Pierre-Luc Dubois,L,WSH,26,82,25,26,51
77,8475791,Taylor Hall,L,CHI,33,82,24,27,51
77,8481068,Yegor Sharangovich,C,CGY,26,82,23,28,51
77,8475765,Vladimir Tarasenko,R,DET,33,82,18,33,51
77,8477503,Max Domi,C,TOR,29,82,15,36,51
77,8477986,Brandon Montour,D,SEA,30,82,12,39,51
77,8479410,Mikhail Sergachev,D,UTA,26,82,8,43,51
77,8476438,Brandon Saad,L,STL,32,82,29,21,50
77,8477456,J.T. Compher,L,DET,29,82,24,26,50
77,8475151,Kyle Palmieri,C,NYI,33,82,23,27,50
77,8482149,Cole Perfetti,C,WPG,22,82,22,28,50
77,8480039,Martin Necas,C,CAR,25,82,18,32,50
77,8478474,Lawson Crouse,L,UTA,27,82,31,18,49
77,8479987,Morgan Geekie,C,BOS,26,82,25,24,49
77,8475314,Anders Lee,L,NYI,34,82,25,24,49
77,8475793,Ryan Johansen,C,PHI,32,82,23,26,49
77,8482110,Dawson Mercer,C,NJD,23,82,23,26,49
77,8474641,Adam Henrique,C,EDM,34,82,21,28,49
77,8473986,Alex Killorn,L,ANA,35,82,20,29,49
77,8477495,Seth Jones,D,CHI,30,82,14,35,49
77,8480028,Morgan Frost,C,PHI,25,82,12,37,49
77,8477497,Sean Monahan,C,CBJ,30,82,20,28,48
77,8475768,Jaden Schwartz,C,SEA,32,82,19,29,48
77,8478469,Thomas Chabot,D,OTT,27,82,12,36,48
77,8483808,Andrei Kuzmenko,L,CGY,28,82,22,25,47
77,8475191,Reilly Smith,R,NYR,33,82,19,28,47
77,8478046,Danton Heinen,L,VAN,29,82,19,28,47
77,8475287,Erik Haula,L,NJD,33,82,15,32,47
77,8479425,Filip Hronek,D,VAN,27,82,7,40,47
77,8476880,Tom Wilson,R,WSH,30,82,20,26,46
77,8479999,Casey Mittelstadt,C,COL,26,82,17,29,46
77,8477964,Ivan Barbashev,C,VGK,29,82,15,31,46
77,8478911,Matt Roy,D,WSH,29,82,15,31,46
77,8476461,Sean Couturier,C,PHI,32,82,14,32,46
77,8475218,Mattias Ekholm,D,EDM,34,82,9,37,46
77,8480064,Josh Norris,C,OTT,25,82,26,19,45
77,8482055,Drew O'Connor,L,PIT,26,82,22,23,45
77,8481533,Trevor Zegras,C,ANA,23,82,20,25,45
77,8476882,Teuvo Teravainen,L,CHI,30,82,17,28,45
77,8480871,Adam Boqvist,D,FLA,24,82,11,34,45
77,8481582,Nicholas Robertson,L,TOR,23,82,23,21,44
77,8481560,Arthur Kaliyev,R,LAK,23,82,22,22,44
77,8480220,Noah Cates,L,PHI,25,82,20,24,44
77,8478542,Evan Rodrigues,C,FLA,31,82,18,26,44
77,8482667,William Eklund,L,SJS,22,82,17,27,44
77,8475722,Jason Zucker,L,BUF,32,82,15,29,44
77,8482720,Matthew Knies,L,TOR,22,82,14,30,44
77,8476906,Shayne Gostisbehere,D,CAR,31,82,10,34,44
77,8480043,Timothy Liljegren,D,TOR,25,82,5,39,44
77,8477479,Tyler Bertuzzi,L,CHI,29,82,22,21,43
77,8482475,Yegor Chinakhov,R,CBJ,23,82,22,21,43
77,8476432,Boone Jenner,C,CBJ,31,82,21,22,43
77,8479941,Justin Danforth,R,CBJ,31,82,20,23,43
77,8477451,Ryan Hartman,R,MIN,30,82,18,25,43
77,8476792,Torey Krug,D,STL,33,82,14,29,43
77,8477948,Travis Sanheim,D,PHI,28,82,13,30,43
77,8476927,Teddy Blueger,C,VAN,30,82,13,30,43
77,8480873,Rasmus Sandin,D,WSH,24,82,5,38,43
77,8475714,Calle Jarnkrok,C,TOR,33,82,22,20,42
77,8481704,Juuso Parssinen,C,NSH,23,82,22,20,42
77,8471698,T.J. Oshie,R,WSH,38,82,21,21,42
77,8481604,Pavel Dorofeyev,L,VGK,24,82,20,22,42
77,8478891,Mason Appleton,C,WPG,28,82,17,25,42
77,8478458,Jack Roslovic,C,CAR,27,82,16,26,42
77,8480802,Ryan McLeod,C,BUF,25,82,15,27,42
77,8476897,Oskar Sundqvist,C,STL,30,82,15,27,42
77,8478055,Gustav Forsling,D,FLA,28,82,11,31,42
77,8476875,Mike Matheson,D,MTL,30,82,10,32,42
77,8473533,Jordan Staal,C,CAR,36,82,26,15,41
77,8476873,Mark Jankowski,C,NSH,30,82,23,18,41
77,8479525,Ross Colton,C,COL,28,82,21,20,41
77,8482745,Mason McTavish,C,ANA,21,82,18,23,41
77,8481656,Aliaksei Protas,C,WSH,23,82,16,25,41
77,8482159,Tyson Foerster,R,PHI,22,82,15,26,41
77,8478396,Noah Hanifin,D,VGK,27,82,13,28,41
77,8478472,Mathieu Joseph,R,STL,27,82,13,28,41
77,8475753,Justin Faulk,D,STL,32,82,12,29,41
77,8480893,Kirill Marchenko,R,CBJ,24,82,25,15,40
77,8477426,Nicholas Paul,L,TBL,29,82,22,18,40
77,8481032,Paul Cotter,C,NJD,25,82,21,19,40
77,8478057,Dakota Joshua,C,VAN,28,82,20,20,40
77,8480849,Barrett Hayton,C,UTA,24,82,19,21,40
77,8479996,Cody Glass,C,NSH,25,82,17,23,40
77,8476872,Scott Laughton,C,PHI,30,82,14,26,40
77,8476474,Stefan Noesen,R,NJD,31,82,28,11,39
77,8481618,Alex Newhook,C,MTL,23,82,21,18,39
77,8480068,Ryan Poehling,C,PHI,25,82,20,19,39
77,8478463,Anthony Beauvillier,L,PIT,27,82,20,19,39
77,8476925,Colton Sissons,C,NSH,31,82,17,22,39
77,8474053,Logan Couture,C,SJS,35,82,15,24,39
77,8481013,Jonatan Berggren,R,DET,24,82,14,25,39
77,8480817,K'Andre Miller,D,NYR,24,82,13,26,39
77,8476292,Ondrej Palat,L,NJD,33,82,12,27,39
77,8479992,Michael Rasmussen,C,DET,25,82,15,23,38
77,8482117,Lukas Reichel,L,CHI,22,82,15,23,38
77,8480185,Eetu Luostarinen,C,FLA,26,82,13,25,38
77,8482671,Owen Power,D,BUF,22,82,7,31,38
77,8481542,Moritz Seider,D,DET,23,82,6,32,38
77,8480145,Neal Pionk,D,WPG,29,82,6,32,38
77,8482089,Jake Neighbours,L,STL,22,82,22,15,37
77,8481535,Nils Hoglander,L,VAN,24,82,22,15,37
77,8482146,Luke Evangelista,R,NSH,22,82,18,19,37
77,8475171,Oliver Ekman-Larsson,D,TOR,33,82,14,23,37
77,8476921,Jordan Martinook,L,CAR,32,82,13,24,37
77,8479345,Jakob Chychrun,D,WSH,26,82,10,27,37
77,8477346,MacKenzie Weegar,D,CGY,30,82,9,28,37
77,8480336,Sean Walker,D,CAR,30,82,8,29,37
77,8477953,Kasperi Kapanen,R,STL,28,82,7,30,37
77,8477021,Alex Kerfoot,C,UTA,30,82,19,17,36
77,8481624,Ilya Mikheyev,R,CHI,30,82,19,17,36
77,8481554,Kaapo Kakko,R,NYR,23,82,18,18,36
77,8477947,Sonny Milano,L,WSH,28,82,14,22,36
77,8478133,Jake Evans,C,MTL,28,82,14,22,36
77,8479390,Taylor Raddysh,R,WSH,26,82,13,23,36
77,8481581,Thomas Harley,D,DAL,23,82,12,24,36
77,8470613,Brent Burns,D,CAR,39,82,8,28,36
77,8477507,Nikita Zadorov,D,BOS,29,82,8,28,36
77,8474574,Tyler Myers,D,VAN,34,82,5,31,36
77,8478507,John Marino,D,UTA,27,82,4,32,36
77,8477998,Warren Foegele,L,LAK,28,82,20,15,35
77,8479591,Michael Eyssimont,C,TBL,28,82,19,16,35
77,8478020,Michael Amadio,C,OTT,28,82,19,16,35
77,8483515,Juraj Slafkovsky,L,MTL,20,82,18,17,35
77,8478413,Jordan Greenway,L,BUF,27,82,17,18,35
77,8482660,Kent Johnson,C,CBJ,22,82,16,19,35
77,8476960,Andreas Athanasiou,C,CHI,30,82,14,21,35
77,8482624,Daniil Miromanov,D,CGY,27,82,11,24,35
77,8475848,Brendan Gallagher,R,MTL,32,82,8,27,35
77,8482105,Jake Sanderson,D,OTT,22,82,8,27,35
77,8477969,Marcus Pettersson,D,PIT,28,82,6,29,35
77,8482259,Bobby McMann,C,TOR,28,82,20,14,34
77,8476469,Joel Armia,R,MTL,31,82,19,15,34
77,8473422,Nick Foligno,L,CHI,37,82,17,17,34
77,8476480,Vladislav Namestnikov,C,WPG,32,82,15,19,34
77,8480113,Alex Iafallo,L,WPG,31,82,13,21,34
77,8474716,Jared Spurgeon,D,MIN,35,82,11,23,34
77,8480829,Jesperi Kotkaniemi,C,CAR,24,82,11,23,34
77,8479351,Sam Steel,C,DAL,26,82,11,23,34
77,8476854,Hampus Lindholm,D,BOS,30,82,7,27,34
77,8482073,Braden Schneider,D,NYR,23,82,7,27,34
77,8476958,Jaccob Slavin,D,CAR,30,82,4,30,34
77,8481093,Rafael Harvey-Pinard,L,MTL,25,82,18,15,33
77,8474149,Evgenii Dadonov,R,DAL,35,82,17,16,33
77,8480835,Jack Drury,C,CAR,24,82,15,18,33
77,8481522,Peyton Krebs,C,BUF,23,82,15,18,33
77,8480144,David Kampf,C,TOR,29,82,15,18,33
77,8482092,Ridly Greig,C,OTT,22,82,13,20,33
77,8477498,Darnell Nurse,D,EDM,29,82,12,21,33
77,8482142,Jamie Drysdale,D,PHI,22,82,9,24,33
77,8477989,Christian Dvorak,C,MTL,28,82,19,13,32
77,8477987,Ryan Donato,C,CHI,28,82,16,16,32
77,8474189,Lars Eller,C,PIT,35,82,14,18,32
77,8478109,Victor Olofsson,L,VGK,29,82,13,19,32
77,8476931,Jake McCabe,D,TOR,31,82,6,26,32
77,8476923,Damon Severson,D,CBJ,30,82,5,27,32
77,8478500,Ivan Provorov,D,CBJ,27,82,4,28,32
77,8479398,Samuel Girard,D,COL,26,82,4,28,32
77,8475764,Cam Fowler,D,ANA,33,82,1,31,32
77,8475760,Nick Bjugstad,C,UTA,32,82,19,12,31
77,8483431,Logan Cooley,C,UTA,20,82,19,12,31
77,8480459,Pius Suter,C,VAN,28,82,17,14,31
77,8476981,Josh Anderson,R,MTL,30,82,17,14,31
77,8477353,Tyler Motte,C,DET,29,82,17,14,31
77,8481186,Logan O'Connor,R,COL,28,82,17,14,31
77,8478366,Frank Vatrano,R,ANA,30,82,16,15,31
77,8476918,Jimmy Vesey,L,NYR,31,82,14,17,31
77,8470621,Corey Perry,R,EDM,39,82,12,19,31
77,8480074,Alexandre Texier,C,STL,25,82,11,20,31
77,8476392,Adam Lowry,C,WPG,31,82,10,21,31
77,8481553,Bobby Brink,R,PHI,23,82,10,21,31
77,8477429,Andrew Copp,C,DET,30,82,8,23,31
77,8473507,Jeff Petry,D,DET,37,82,8,23,31
77,8476329,Travis Boyd,C,MIN,31,82,6,25,31
77,8478882,Vladislav Gavrikov,D,LAK,29,82,6,25,31
77,8476979,Erik Gustafsson,D,DET,32,82,5,26,31
77,8477488,Brett Pesce,D,NJD,30,82,5,26,31
77,8476892,Colton Parayko,D,STL,31,82,4,27,31
77,8481014,Alexander Romanov,D,NYI,24,82,4,27,31
77,8480281,Alexey Toropchenko,R,STL,25,82,23,7,30
77,8482077,Dylan Holloway,L,EDM,23,82,21,9,30
77,8482079,Marco Rossi,C,MIN,23,82,18,12,30
77,8477425,Miles Wood,L,COL,29,82,16,14,30
77,8482133,Thomas Bordeleau,C,SJS,22,82,15,15,30
77,8479293,Brandon Tanev,L,SEA,33,82,15,15,30
77,8481580,Connor McMichael,C,WSH,23,82,14,16,30
77,8475763,Kevin Hayes,R,PIT,32,82,13,17,30
77,8480003,Jesper Boqvist,C,FLA,26,82,13,17,30
77,8482762,Simon Edvinsson,D,DET,21,82,13,17,30
77,8475231,Casey Cizikas,C,NYI,33,82,12,18,30
77,8476419,Jean-Gabriel Pageau,C,NYI,32,82,10,20,30
77,8482111,Justin Barron,D,MTL,23,82,9,21,30
77,8477220,Nate Schmidt,D,FLA,33,82,7,23,30
77,8476442,Matt Nieto,L,PIT,32,82,7,23,30
77,8476331,Dylan DeMelo,D,WPG,31,82,2,28,30
77,8480813,Joe Veleno,C,DET,24,82,16,13,29
77,8475193,Tomas Tatar,L,NJD,34,82,14,15,29
77,8479353,Brett Howden,C,VGK,26,82,12,17,29
77,8478115,Pierre Engvall,L,NYI,28,82,11,18,29
77,8482166,Shakir Mukhamadullin,D,SJS,22,82,10,19,29
77,8482702,Logan Stankoven,C,DAL,21,82,9,20,29
77,8476458,Ryan Strome,C,ANA,31,82,7,22,29
77,8481546,Cam York,D,PHI,23,82,5,24,29
77,8474151,Ryan McDonagh,D,TBL,35,82,5,24,29
77,8476891,Matt Grzelcyk,D,PIT,30,82,4,25,29
77,8478851,Alexandre Carrier,D,NSH,28,82,2,27,29
77,8482074,Connor Zary,C,CGY,23,82,16,12,28
77,8479414,Nathan Bastian,R,NJD,27,82,12,16,28
77,8484203,Bradly Nadeau,L,CAR,19,82,12,16,28
77,8482655,J.J. Moser,D,TBL,24,82,5,23,28
77,8474673,TJ Brodie,D,CHI,34,82,2,26,28
77,8479661,Tanner Jeannot,L,LAK,27,82,13,14,27
77,8484145,Zach Benson,L,BUF,19,82,13,14,27
77,8480855,Jack McBain,C,UTA,24,82,12,15,27
77,8481606,Jordan Spence,D,LAK,23,82,8,19,27
77,8475188,Brayden McNabb,D,VGK,33,82,7,20,27
77,8475233,David Savard,D,MTL,34,82,5,22,27
77,8480035,Henri Jokiharju,D,BUF,25,82,4,23,27
77,8475455,Brenden Dillon,D,NJD,34,82,3,24,27
77,8480025,MacKenzie Entwistle,R,FLA,25,82,16,10,26
77,8477406,Mattias Janmark,C,EDM,32,82,15,11,26
77,8479393,Noah Gregor,C,OTT,26,82,13,13,26
77,8477931,Tomas Nosek,L,FLA,32,82,12,14,26
77,8483457,Lane Hutson,D,MTL,20,82,10,16,26
77,8476885,Jacob Trouba,D,NYR,30,82,6,20,26
77,8480990,Declan Chisholm,D,MIN,24,82,5,21,26
77,8475343,Nic Dowd,C,WSH,34,82,11,14,25
77,8479368,Max Jones,L,BOS,26,82,11,14,25
77,8477450,Jason Dickinson,C,CHI,29,82,9,16,25
77,8478434,Keegan Kolesar,R,VGK,27,82,9,16,25
77,8482666,Scott Morrow,D,CAR,22,82,9,16,25
77,8480995,Pontus Holmberg,R,TOR,25,82,8,17,25
77,8480980,Connor Dewar,C,TOR,25,82,8,17,25
77,8483565,Nick Blankenburg,D,NSH,26,82,7,18,25
77,8482807,Ethan Del Mastro,D,CHI,21,82,6,19,25
77,8479976,Juuso Valimaki,D,UTA,26,82,5,20,25
77,8479402,Jake Bean,D,CGY,26,82,5,20,25
77,8473563,Nicklas Backstrom,C,WSH,37,82,4,21,25
77,8477845,Trevor van Riemsdyk,D,WSH,33,82,4,21,25
77,8479369,Andrew Peeke,D,BOS,26,82,3,22,25
77,8476917,Adam Pelech,D,NYI,30,82,3,22,25
77,8475462,Radko Gudas,D,ANA,34,82,2,23,25
77,8479371,Dante Fabbro,D,NSH,26,82,2,23,25
77,8482705,Cole Sillinger,C,CBJ,21,82,12,12,24
77,8482087,Kaiden Guhle,D,MTL,22,82,10,14,24
77,8476278,Colin Blackwell,C,DAL,31,82,9,15,24
77,8481708,Zac Jones,D,NYR,24,82,8,16,24
77,8483499,Liam Ohgren,L,MIN,20,82,8,16,24
77,8477839,Conor Sheary,L,TBL,32,82,7,17,24
77,8480878,Nils Lundkvist,D,DAL,24,82,6,18,24
77,8478013,Jake Walman,D,SJS,28,82,6,18,24
77,8478416,Erik Cernak,D,TBL,27,82,3,21,24
77,8480222,Sebastian Aho,D,PIT,28,82,3,21,24
77,8480049,Dylan Samberg,D,WPG,25,82,0,24,24
77,8474715,Cam Atkinson,R,TBL,35,82,14,9,23
77,8476878,Zemgus Girgensons,L,TBL,30,82,13,10,23
77,8483524,Shane Wright,C,SEA,20,82,10,13,23
77,8476624,Barclay Goodrow,C,SJS,31,82,9,14,23
77,8476422,Mike Reilly,D,NYI,31,82,8,15,23
77,8481477,Nico Sturm,C,SJS,29,82,8,15,23
77,8476374,Sean Kuraly,C,CBJ,31,82,8,15,23
77,8484166,Adam Fantilli,C,CBJ,20,82,7,16,23
77,8483490,Pavel Mintyukov,D,ANA,21,82,7,16,23
77,8477369,Carson Soucy,D,VAN,30,82,7,16,23
77,8476312,Josh Manson,D,COL,33,82,6,17,23
77,8477335,Kyle Burroughs,D,LAK,29,82,4,19,23
77,8476858,Phillip Di Giuseppe,L,VAN,31,82,16,6,22
77,8479316,Luke Kunin,C,SJS,27,82,14,8,22
77,8473453,Trevor Lewis,C,LAK,37,82,14,8,22
77,8482125,Alexander Holtz,R,VGK,22,82,13,9,22
77,8475842,Sam Carrick,C,NYR,32,82,11,11,22
77,8481517,Brett Leason,R,ANA,25,82,10,12,22
77,8484149,Gavin Brindley,C,CBJ,20,82,10,12,22
77,8481601,Simon Holmstrom,R,NYI,23,82,9,13,22
77,8475200,Dmitry Orlov,D,CAR,33,82,7,15,22
77,8476457,Adam Larsson,D,SEA,32,82,7,15,22
77,8483763,Maksymilian Szuber,D,UTA,22,82,7,15,22
77,8483493,Frank Nazar,C,CHI,20,82,7,15,22
77,8478840,Will Borgen,D,SEA,28,82,6,16,22
77,8479442,Troy Stecher,D,EDM,30,82,6,16,22
77,8482858,Ryker Evans,D,SEA,23,82,5,17,22
77,8480073,Erik Brannstrom,D,COL,25,82,5,17,22
77,8481481,Blake Lizotte,C,PIT,27,82,5,17,22
77,8480172,Jan Rutta,D,SJS,34,82,5,17,22
77,8475762,Derek Forbort,D,VAN,32,82,5,17,22
77,8475790,Erik Gudbranson,D,CBJ,32,82,4,18,22
77,8477506,Ryan Pulock,D,NYI,30,82,3,19,22
77,8476902,Esa Lindell,D,DAL,30,82,3,19,22
77,8476967,Brett Kulak,D,EDM,30,82,3,19,22
77,8482122,Brock Faber,D,MIN,22,82,2,20,22
77,8480879,Jacob Bernard-Docker,D,OTT,24,82,1,21,22
77,8478569,Noel Acciari,C,PIT,33,82,13,8,21
77,8477508,Curtis Lazar,C,NJD,29,82,11,10,21
77,8482141,Lukas Cormier,D,VGK,22,82,10,11,21
77,8482733,Logan Mailloux,D,MTL,31,82,10,11,21
77,8475855,Jesper Fast,R,CAR,33,82,8,13,21
77,8482062,Cole Smith,L,NSH,29,82,8,13,21
77,8482145,Mavrik Bourque,C,DAL,22,82,8,13,21
77,8483505,Matthew Poitras,C,BOS,20,82,7,14,21
77,8482749,Joshua Roy,R,MTL,21,82,7,14,21
77,8476889,Radek Faksa,C,STL,30,82,6,15,21
77,8476467,Jamie Oleksiak,D,SEA,32,82,6,15,21
77,8475181,Nick Leddy,D,STL,33,82,4,17,21
77,8480246,Nick Perbix,D,TBL,26,82,4,17,21
77,8475690,Chris Tanev,D,TOR,35,82,3,18,21
77,8475149,Marcus Johansson,L,MIN,34,82,10,10,20
77,8483468,Jiri Kulich,C,BUF,20,82,9,11,20
77,8480448,Parker Kelly,L,COL,25,82,8,12,20
77,8482809,Jackson Blake,R,CAR,21,82,6,14,20
77,8476429,Scott Mayfield,D,NYI,32,82,5,15,20
77,8476463,Jonas Brodin,D,MIN,31,82,4,16,20
77,8470600,Ryan Suter,D,STL,39,82,2,18,20
77,8478508,Yakov Trenin,C,MIN,27,82,12,7,19
77,8477392,Hudson Fasching,R,NYI,29,82,9,10,19
77,8481524,Bowen Byram,D,BUF,23,82,7,12,19
77,8480806,Isac Lundestrom,C,ANA,25,82,6,13,19
77,8479998,Mikey Anderson,D,LAK,25,82,3,16,19
77,8480807,Mattias Samuelsson,D,BUF,24,82,3,16,19
77,8476525,Colin Miller,D,WPG,32,82,3,16,19
77,8480950,Ilya Lyubushkin,D,DAL,30,82,2,17,19
77,8481028,Martin Pospisil,C,CGY,25,82,1,18,19
77,8477903,Garnet Hathaway,R,PHI,33,82,11,7,18
77,8477952,Robby Fabbri,C,ANA,28,82,10,8,18
77,8477919,Frederick Gaudreau,C,MIN,31,82,10,8,18
77,8482470,Ilya Solovyov,D,CGY,24,82,7,11,18
77,8478468,Jeremy Lauzon,D,NSH,27,82,6,12,18
77,8482245,Artem Zub,D,OTT,29,82,5,13,18
77,8474013,Ian Cole,D,UTA,35,82,5,13,18
77,8479980,Nicolas Hague,D,VGK,26,82,5,13,18
77,8481568,Alex Vlasic,D,CHI,23,82,4,14,18
77,8474567,Zach Bogosian,D,MIN,34,82,3,15,18
77,8477365,Connor Clifton,D,BUF,29,82,2,16,18
77,8476879,Cody Ceci,D,EDM,31,82,1,17,18
77,8476372,Nick Seeler,D,PHI,31,82,1,17,18
77,8478211,Dryden Hunt,L,CGY,29,82,9,8,17
77,8480789,Oliver Wahlstrom,R,NYI,24,82,9,8,17
77,8482679,Matt Coronato,R,CGY,22,82,9,8,17
77,8475279,Ben Chiarot,D,DET,33,82,7,10,17
77,8477015,Connor Brown,R,EDM,30,82,6,11,17
77,8479983,Mario Ferraro,D,SJS,26,82,5,12,17
77,8475177,Calvin de Haan,D,COL,33,82,3,14,17
77,8474612,Travis Hamonic,D,OTT,34,82,3,14,17
77,8477034,Jaycob Megna,D,FLA,32,82,2,15,17
77,8482155,Alex Laferriere,R,LAK,23,82,10,6,16
77,8475220,Marcus Foligno,L,MIN,33,82,7,9,16
77,8484153,Leo Carlsson,C,ANA,20,82,7,9,16
77,8479359,Beck Malenstyn,L,BUF,26,82,7,9,16
77,8482153,Brendan Brisson,C,VGK,23,82,7,9,16
77,8478432,Christian Fischer,R,DET,27,82,6,10,16
77,8478450,Parker Wotherspoon,D,BOS,27,82,6,10,16
77,8477938,Haydn Fleury,D,WPG,28,82,5,11,16
77,8480748,Kiefer Sherwood,L,VAN,29,82,3,13,16
77,8483460,David Jiricek,D,CBJ,21,82,3,13,16
77,8484911,Collin Graf,R,SJS,22,82,3,13,16
77,8475324,Nick Jensen,D,OTT,34,82,2,14,16
77,8478136,Jake Middleton,D,MIN,28,82,2,14,16
77,8481178,Egor Zamula,D,PHI,24,82,2,14,16
77,8474090,Brendan Smith,D,DAL,35,82,2,14,16
77,8480860,Kevin Bahl,D,CGY,24,82,0,16,16
77,8479638,Justin Brazeau,R,BOS,26,82,9,6,15
77,8482659,Josh Doan,R,UTA,22,82,9,6,15
77,8480021,Jack Studnicka,C,LAK,25,82,6,9,15
77,8477499,Rasmus Ristolainen,D,PHI,30,82,4,11,15
77,8477435,Ryan Graves,D,PIT,29,82,2,13,15
77,8478443,Brandon Carlo,D,BOS,28,82,2,13,15
77,8476473,Connor Murphy,D,CHI,31,82,1,14,15
77,8476822,Luke Glendening,C,TBL,35,82,9,5,14
77,8479291,Kevin Rooney,C,CGY,31,82,8,6,14
77,8482101,Danil Gushchin,L,SJS,22,82,7,7,14
77,8482803,Olen Zellweger,D,ANA,21,82,5,9,14
77,8483495,Simon Nemec,D,NJD,20,82,5,9,14
77,8482713,Mackie Samoskevich,R,FLA,22,82,5,9,14
77,8483482,Tristan Luneau,D,ANA,20,82,4,10,14
77,8480796,Martin Fehervary,D,WSH,25,82,4,10,14
77,8480834,Ty Emberson,D,SJS,24,82,3,11,14
77,8478178,Darren Raddysh,D,TBL,28,82,2,12,14
77,8481122,Simon Benoit,D,TOR,26,82,1,12,13
77,8482712,Oskar Olausson,R,COL,22,82,7,5,12
77,8482118,Sam Colangelo,R,ANA,23,82,6,6,12
77,8482859,Zack Ostapchuk,C,OTT,21,82,5,7,12
77,8483012,Logan Morrison,C,SEA,22,82,4,8,12
77,8483445,Cutter Gauthier,L,ANA,20,82,4,8,12
77,8481699,Aku Raty,R,UTA,23,82,4,8,12
77,8475718,Justin Holl,D,DET,32,82,3,9,12
77,8478399,Jonas Siegenthaler,D,NJD,27,82,2,10,12
77,8483466,Kevin Korchinski,D,CHI,20,82,0,12,12
77,8480870,Bo Groulx,C,NYR,24,82,7,4,11
77,8477505,Alexander Wennberg,C,SJS,30,82,6,5,11
77,8483397,Marc McLaughlin,C,BOS,25,82,5,6,11
77,8481641,Joel Kiviranta,L,COL,28,82,3,8,11
77,8479576,Vincent Desharnais,D,VAN,28,82,3,8,11
77,8483489,Fraser Minten,C,TOR,31,82,3,8,11
77,8478859,Niko Mikkola,D,FLA,28,82,2,9,11
77,8479324,Ryan Lindgren,D,NYR,26,82,1,10,11
77,8481567,Henry Thrun,D,SJS,23,82,1,10,11
77,8476441,Joel Edmundson,D,LAK,31,82,1,10,11
77,8481605,Jackson LaCombe,D,ANA,23,82,6,4,10
77,8482787,Nikita Chibrikov,R,WPG,31,82,3,7,10
77,8478874,Adam Gaudette,C,OTT,28,82,2,7,9
77,8471677,Jack Johnson,D,CBJ,37,82,2,7,9
77,8483567,Georgii Merkulov,C,BOS,24,82,2,6,8
77,8483471,Brad Lambert,C,WPG,31,82,0,8,8
77,8482516,Matthew Kessel,D,STL,24,82,2,5,7
77,8482070,Mitchell Chaffee,R,TBL,26,82,5,1,6
77,8474062,Riley Nash,C,NYR,35,82,4,2,6
77,8470794,Joe Pavelski,C,,40,0,0,0,0
77,8481703,Valtteri Puustinen,R,PIT,25,0,0,0,0
77,8477950,Tony DeAngelo,D,,29,0,0,0,0
77,8481577,Philip Tomasino,C,NSH,23,0,0,0,0
77,8475197,Tyson Barrie,D,,33,0,0,0,0
77,8471218,Blake Wheeler,R,,38,0,0,0,0
77,8474157,Max Pacioretty,L,,36,0,0,0,0
77,8478466,Daniel Sprong,R,VAN,27,0,0,0,0
77,8475744,Evgeny Kuznetsov,C,,32,0,0,0,0
77,8481019,David Gustafsson,C,WPG,24,0,0,0,0
77,8475906,John Klingberg,D,,32,0,0,0,0
77,8479348,Kale Clague,D,BUF,26,0,0,0,0
77,8476952,Dominic Toninato,C,WPG,30,0,0,0,0
77,8473473,Milan Lucic,L,,36,0,0,0,0
77,8474037,James van Riemsdyk,L,,35,0,0,0,0
77,8474602,Justin Schultz,D,,34,0,0,0,0
77,8482222,Alexander Barabanov,L,,30,0,0,0,0
77,8479372,Josh Mahura,D,SEA,26,0,0,0,0
77,8479982,Conor Timmins,D,TOR,26,0,0,0,0
77,8474031,Kevin Shattenkirk,D,,35,0,0,0,0
77,8480008,Adam Ruzicka,C,,25,0,0,0,0
77,8481059,Scott Perunovich,D,STL,26,0,0,0,0
77,8480884,Calen Addison,D,,24,0,0,0,0
77,8476994,Vinnie Hinostroza,C,NSH,30,0,0,0,0
77,8478452,Caleb Jones,D,LAK,27,0,0,0,0
77,8480157,Calle Rosen,D,COL,30,0,0,0,0
77,8481609,Vladislav Kolyachonok,D,UTA,23,0,0,0,0
77,8479415,Michael McLeod,C,,26,0,0,0,0
77,8476919,Chris Tierney,C,,30,0,0,0,0
77,8479639,Dylan Coghlan,D,WPG,26,0,0,0,0
77,8478146,Matthew Highmore,C,OTT,28,0,0,0,0
77,8478970,Jalen Chatfield,D,CAR,28,0,0,0,0
77,8480205,Emil Bemstrom,C,PIT,25,0,0,0,0
77,8474884,Mike Hoffman,C,,35,0,0,0,0
77,8471274,Alex Goligoski,D,,39,0,0,0,0
77,8478104,Sammy Blais,L,,28,0,0,0,0
77,8474870,Tyler Johnson,C,,34,0,0,0,0
77,8476913,Devin Shore,C,MIN,30,0,0,0,0
77,8481598,Philip Broberg,D,EDM,23,0,0,0,0
77,8480058,Pierre-Olivier Joseph,D,STL,25,0,0,0,0
77,8480891,Michael Kesselring,D,UTA,24,0,0,0,0
77,8477979,Nicolas Aube-Kubel,R,BUF,28,0,0,0,0
77,8476871,Tanner Pearson,L,,32,0,0,0,0
77,8476393,Nick Cousins,C,,31,0,0,0,0
77,8479977,Kailer Yamamoto,R,,26,0,0,0,0
77,8479543,Michael Pezzetta,L,MTL,26,0,0,0,0
77,8477018,Ben Hutton,D,VGK,31,0,0,0,0
77,8480762,Eric Robinson,L,CAR,29,0,0,0,0
77,8474034,Pat Maroon,L,CHI,36,0,0,0,0
77,8481058,Jesse Ylönen,R,,25,0,0,0,0
77,8475179,Dmitry Kulikov,D,FLA,34,0,0,0,0
77,8481527,Kaedan Korczak,D,VGK,23,0,0,0,0
77,8473449,Kyle Okposo,R,,36,0,0,0,0
77,8482192,Isaak Phillips,D,CHI,23,0,0,0,0
77,8480727,Zach Whitecloud,D,VGK,28,0,0,0,0
77,8479346,Dillon Dube,C,,26,0,0,0,0
77,8480821,Filip Zadina,R,,25,0,0,0,0
77,8480001,Urho Vaakanainen,D,ANA,25,0,0,0,0
77,8470966,Mark Giordano,D,,41,0,0,0,0
77,8480853,Liam Foudy,C,,24,0,0,0,0
77,8475225,Craig Smith,C,CHI,35,0,0,0,0
77,8479972,Mason Shaw,C,WPG,26,0,0,0,0
77,8478451,Ethan Bear,D,WSH,27,0,0,0,0
77,8474040,Sam Gagner,C,,35,0,0,0,0
77,8480196,Jacob Bryson,D,BUF,27,0,0,0,0
77,8479984,Cal Foote,D,,26,0,0,0,0
77,8480011,Klim Kostin,C,SJS,25,0,0,0,0
77,8482176,Wyatt Kaiser,D,CHI,22,0,0,0,0
77,8476988,Matt Benning,D,SJS,30,0,0,0,0
77,8479370,Tyson Jost,C,CAR,26,0,0,0,0
77,8477464,Nic Petan,C,,29,0,0,0,0
77,8477380,Jonny Brodzinski,C,NYR,31,0,0,0,0
77,8480070,Ian Mitchell,D,BOS,25,0,0,0,0
77,8479315,Joey Anderson,R,CHI,26,0,0,0,0
77,8478099,Kevin Labanc,R,,29,0,0,0,0
77,8476874,Olli Maatta,D,DET,30,0,0,0,0
77,8475208,Brian Dumoulin,D,ANA,33,0,0,0,0
77,8478430,Oliver Kylington,D,,27,0,0,0,0
77,8479536,Axel Jonsson-Fjallby,L,WPG,26,0,0,0,0
77,8479671,Mathieu Olivier,R,CBJ,27,0,0,0,0
77,8471709,Marc-Edouard Vlasic,D,SJS,37,0,0,0,0
77,8479328,Julien Gauthier,R,NYI,27,0,0,0,0
77,8478421,A.J. Greer,L,FLA,28,0,0,0,0
77,8477573,Nathan Walker,L,STL,30,0,0,0,0
77,8481537,Nikita Okhotiuk,D,CGY,24,0,0,0,0
77,8474166,Alec Martinez,D,CHI,37,0,0,0,0
77,8470610,Zach Parise,L,,40,0,0,0,0
77,8477478,William Carrier,L,CAR,30,0,0,0,0
77,8479344,Jesse Puljujarvi,R,PIT,26,0,0,0,0
77,8480887,Jordan Harris,D,MTL,24,0,0,0,0
77,8478502,Dennis Gilbert,D,BUF,28,0,0,0,0
77,8482730,Brandt Clarke,D,LAK,21,0,0,0,0
77,8480355,Mark Kastelic,C,BOS,25,0,0,0,0
77,8475750,Jon Merrill,D,MIN,32,0,0,0,0
77,8475164,Jakob Silfverberg,R,,34,0,0,0,0
77,8477944,Jakub Vrana,L,,28,0,0,0,0
77,8479439,Jacob MacDonald,D,COL,31,0,0,0,0
77,8474568,Luke Schenn,D,NSH,35,0,0,0,0
77,8478454,Noah Juulsen,D,VAN,27,0,0,0,0
77,8475752,Tyler Pitlick,C,,33,0,0,0,0
77,8482148,Hendrix Lapierre,C,WSH,22,0,0,0,0
77,8481167,Brayden Pachal,D,CGY,25,0,0,0,0
77,8478043,Sam Lafferty,C,BUF,29,0,0,0,0
77,8479321,Lucas Johansen,D,,27,0,0,0,0
77,8471699,Andrew Cogliano,C,,37,0,0,0,0
77,8481521,Ronnie Attard,D,PHI,25,0,0,0,0
77,8481161,Jake Christiansen,D,CBJ,25,0,0,0,0
77,8479458,Nikita Zaitsev,D,,33,0,0,0,0
77,8479619,Michael Carcone,L,UTA,28,0,0,0,0
77,8479026,Philippe Myers,D,TOR,27,0,0,0,0
77,8477330,Dominik Kubalik,L,,29,0,0,0,0
77,8481617,Vasily Podkolzin,R,VAN,23,0,0,0,0
77,8481701,Santeri Hatakka,D,NJD,23,0,0,0,0
77,8479514,Rem Pitlick,C,,27,0,0,0,0
77,8477446,Michael McCarron,R,NSH,29,0,0,0,0
77,8470604,Jeff Carter,C,,39,0,0,0,0
77,8482241,Radim Zohorna,L,,28,0,0,0,0
77,8480289,Morgan Barron,C,WPG,26,0,0,0,0
77,8479379,Givani Smith,R,SJS,26,0,0,0,0
77,8480216,Jacob Peterson,C,,25,0,0,0,0
77,8477851,Jordan Oesterle,D,BOS,32,0,0,0,0
77,8484258,Sam Malinski,D,COL,26,0,0,0,0
77,8478904,Steven Lorentz,C,,28,0,0,0,0
77,8482095,Tyler Kleven,D,OTT,22,0,0,0,0
77,8480848,Ty Dellandrea,C,SJS,24,0,0,0,0
77,8476884,Derrick Pouliot,D,,30,0,0,0,0
77,8479336,Carl Grundstrom,R,SJS,27,0,0,0,0
77,8482964,Arber Xhekaj,D,MTL,23,0,0,0,0
77,8471686,Marc Staal,D,,37,0,0,0,0
77,8477887,Patrick Brown,C,BOS,32,0,0,0,0
77,8478495,Denis Gurianov,R,,27,0,0,0,0
77,8473504,Cal Clutterbuck,R,,37,0,0,0,0
77,8481550,Adam Beckman,L,NJD,23,0,0,0,0
77,8480845,Rasmus Kupari,C,WPG,24,0,0,0,0
77,8474009,Nick Bonino,C,,36,0,0,0,0
77,8478585,Derek Ryan,C,EDM,38,0,0,0,0
77,8477962,Brendan Lemieux,L,CAR,28,0,0,0,0
77,8482861,Vincent Iorio,D,WSH,22,0,0,0,0
77,8479378,Logan Stanley,D,WPG,26,0,0,0,0
77,8473446,Erik Johnson,D,PHI,36,0,0,0,0
77,8481743,Marc Del Gaizo,D,NSH,25,0,0,0,0
77,8477384,Josh Brown,D,EDM,30,0,0,0,0
77,8482165,Yan Kuznetsov,D,CGY,22,0,0,0,0
77,8478424,Jansen Harkins,C,ANA,27,0,0,0,0
77,8482144,Jack Thompson,D,SJS,22,0,0,0,0
77,8478512,Austin Czarnik,C,,32,0,0,0,0
77,8477527,Ross Johnston,L,ANA,30,0,0,0,0
77,8479383,Boris Katchouk,L,,26,0,0,0,0
77,8482094,Daemon Hunt,D,MIN,22,0,0,0,0
77,8481719,Maxwell Crozier,D,TBL,24,0,0,0,0
77,8480192,Johnathan Kovacevic,D,NJD,27,0,0,0,0
77,8479376,Victor Mete,D,,26,0,0,0,0
77,8482511,Mason Lohrei,D,BOS,23,0,0,0,0
77,8475825,Jani Hakanpää,D,,32,0,0,0,0
77,8478021,William Lagesson,D,DET,28,0,0,0,0
77,8475795,Dylan McIlrath,D,WSH,32,0,0,0,0
77,8477846,Ryan Carpenter,C,,33,0,0,0,0
77,8481056,Spencer Stastney,D,NSH,24,0,0,0,0
77,8481564,Ryan Johnson,D,BUF,23,0,0,0,0
77,8478017,Mark Friedman,D,VAN,29,0,0,0,0
77,8479320,Max Lajoie,D,SEA,27,0,0,0,0
77,8480075,Cameron Crotty,D,MIN,25,0,0,0,0
77,8484287,Cole McWard,D,VAN,23,0,0,0,0
77,8484254,Akito Hirose,D,VAN,25,0,0,0,0
77,8483407,Brandon Scanlin,D,NYR,25,0,0,0,0
77,8480274,Philip Kemp,D,EDM,25,0,0,0,0
77,8479522,Hardy Haman Aktell,D,WSH,26,0,0,0,0
77,8480007,Jonas Rondbjerg,R,VGK,25,0,0,0,0
77,8477454,Adam Erne,L,,29,0,0,0,0
77,8481679,Maxence Guenette,D,OTT,23,0,0,0,0
77,8480441,Trey Fix-Wolansky,R,CBJ,25,0,0,0,0
77,8483546,Marshall Rifai,D,TOR,26,0,0,0,0
77,8480084,Nick DeSimone,D,NJD,30,0,0,0,0
77,8481030,Jack St. Ivany,D,PIT,25,0,0,0,0
77,8481592,Jakob Pelletier,L,CGY,23,0,0,0,0
77,8478011,Louie Belpedio,D,PHI,28,0,0,0,0
77,8477930,Pierre-Edouard Bellemare,L,,39,0,0,0,0
77,8484321,Nikolas Matinpalo,D,OTT,26,0,0,0,0
77,8482067,Connor Mackey,D,NYR,28,0,0,0,0
77,8481806,Louis Crevier,D,CHI,23,0,0,0,0
77,8484326,Patrik Koch,D,UTA,28,0,0,0,0
77,8477971,Andreas Englund,D,LAK,28,0,0,0,0
77,8481751,Lukas Rousek,R,BUF,25,0,0,0,0
77,8481006,Tyler Tucker,D,STL,24,0,0,0,0
77,8476867,Brendan Gaunce,C,MIN,30,0,0,0,0
77,8479520,Brandon Duhaime,R,WSH,27,0,0,0,0
77,8477073,Kurtis MacDermid,L,NJD,30,0,0,0,0
77,8480874,Adam Ginning,D,PHI,24,0,0,0,0
77,8477473,Justin Bailey,R,SJS,29,0,0,0,0
77,8479066,Ryan Lomberg,L,CGY,30,0,0,0,0
77,8477070,Liam O'Brien,C,UTA,30,0,0,0,0
77,8474618,Marco Scandella,D,,34,0,0,0,0
77,8475797,Jarred Tinordi,D,,32,0,0,0,0
77,8481441,Joe Snively,C,DET,28,0,0,0,0
77,8477244,Chad Ruhwedel,D,NYR,34,0,0,0,0
77,8479772,Zack MacEwen,R,OTT,28,0,0,0,0
77,8481147,Reese Johnson,C,MIN,26,0,0,0,0
77,8481043,Cole Koepke,L,BOS,26,0,0,0,0
77,8483619,Filip Roos,D,OTT,25,0,0,0,0
77,8481541,Samuel Bolduc,D,NYI,24,0,0,0,0
77,8477810,Joel Hanley,D,CGY,33,0,0,0,0
77,8476907,Mackenzie MacEachern,L,,30,0,0,0,0
77,8482652,Walker Duehr,R,CGY,27,0,0,0,0
77,8477126,Jayson Megna,C,,34,0,0,0,0
77,8483398,Declan Carlile,D,TBL,31,0,0,0,0
77,8482929,Emil Lilleberg,D,TBL,23,0,0,0,0
77,8480880,Jakub Lauko,C,MIN,24,0,0,0,0
77,8480245,Olle Lycksell,R,PHI,25,0,0,0,0
77,8480252,Cole Guttman,C,CHI,25,0,0,0,0
77,8477467,Gustav Olofsson,D,SEA,30,0,0,0,0
77,8479968,Vinni Lettieri,C,BOS,29,0,0,0,0
77,8478400,Colin White,C,,27,0,0,0,0
77,8475755,Alexander Petrovic,D,DAL,32,0,0,0,0
77,8481812,Nikolai Knyzhov,D,,27,0,0,0,0
77,8481593,Jayden Struble,D,MTL,23,0,0,0,0
77,8481532,Alex Turcotte,C,LAK,23,0,0,0,0
77,8482126,Emil Andrae,D,PHI,31,0,0,0,0
77,8479944,Zach Aston-Reese,C,VGK,30,0,0,0,0
77,8471817,Ryan Reaves,R,TOR,37,0,0,0,0
77,8481206,John Ludvig,D,PIT,24,0,0,0,0
77,8481599,Victor Soderstrom,D,UTA,23,0,0,0,0
77,8480292,Carson Meyer,R,ANA,27,0,0,0,0
77,8482496,Nils Aman,C,VAN,24,0,0,0,0
77,8479718,Alex Barré-Boulet,C,MTL,27,0,0,0,0
77,8479994,Jaret Anderson-Dolan,C,WPG,25,0,0,0,0
77,8480184,Gustav Lindstrom,D,,26,0,0,0,0
77,8480890,Jan Jenik,R,OTT,24,0,0,0,0
77,8478067,Oskar Lindblom,L,,28,0,0,0,0
77,8476934,Brock McGinn,L,ANA,30,0,0,0,0
77,8479985,Cale Fleury,D,SEA,26,0,0,0,0
77,8484304,Uvis Balinskis,D,FLA,28,0,0,0,0
77,8479981,Jonah Gadjovich,L,FLA,26,0,0,0,0
77,8481716,Dmitri Voronkov,L,CBJ,24,0,0,0,0
77,8474709,Matt Martin,L,,35,0,0,0,0
77,8482634,Alex Steeves,C,TOR,25,0,0,0,0
77,8480823,Alexander Alexeyev,D,WSH,25,0,0,0,0
77,8477541,Dakota Mermis,D,TOR,30,0,0,0,0
77,8483491,Ivan Miroshnichenko,L,WSH,20,0,0,0,0
77,8478477,Mitchell Stephens,C,SEA,27,0,0,0,0
77,8481543,Nikita Alexandrov,C,STL,24,0,0,0,0
77,8479423,Alex Nylander,L,,26,0,0,0,0
77,8482451,Mikael Pyyhtia,L,CBJ,23,0,0,0,0
77,8478831,Kevin Stenlund,C,UTA,28,0,0,0,0
77,8480306,Grant Hutton,D,NYI,29,0,0,0,0
77,8478028,Fredrik Olofsson,L,,28,0,0,0,0
77,8477462,Robert Hagg,D,VGK,29,0,0,0,0
77,8477320,Anton Blidh,L,NYR,29,0,0,0,0
77,8482157,Will Cuylle,L,NYR,22,0,0,0,0
77,8482737,Zack Bolduc,C,STL,21,0,0,0,0
77,8481239,Samuel Fagemo,L,,24,0,0,0,0
77,8481600,Tobias Bjornfot,D,FLA,23,0,0,0,0
77,8478409,Anthony Richard,C,PHI,28,0,0,0,0
77,8474145,Robert Bortuzzo,D,,35,0,0,0,0
77,8475958,Michael Sgarbossa,C,WSH,32,0,0,0,0
77,8479986,Kole Lind,R,DAL,26,0,0,0,0
77,8479249,Andrew Poturalski,C,SJS,30,0,0,0,0
77,8479362,Riley Tufte,L,BOS,26,0,0,0,0
77,8479991,Jake Leschyshyn,C,NYR,25,0,0,0,0
77,8479587,Rhett Gardner,C,PHI,28,0,0,0,0
77,8482744,James Malatesta,L,CBJ,21,0,0,0,0
77,8478854,Ryan Shea,D,PIT,27,0,0,0,0
77,8481591,Sam Poulin,R,,23,0,0,0,0
77,8483512,Matt Savoie,C,EDM,20,0,0,0,0
77,8482102,Vasily Ponomarev,C,PIT,22,0,0,0,0
77,8482162,Roby Jarventie,L,EDM,22,0,0,0,0
77,8481016,Ruslan Iskhakov,C,,24,0,0,0,0
77,8482172,Landon Slaggert,L,CHI,22,0,0,0,0
77,8482747,Brennan Othmann,L,NYR,21,0,0,0,0
77,8480031,Maxime Comtois,L,,25,0,0,0,0
77,8480226,Marián Studenic,R,,26,0,0,0,0
77,8478408,Travis Dermott,D,,28,0,0,0,0
77,8481518,Nolan Foote,L,NJD,24,0,0,0,0
77,8479419,Brett Murray,L,BUF,26,0,0,0,0
77,8482088,Justin Sourdif,R,FLA,22,0,0,0,0
77,8482201,Gage Goncalves,C,TBL,23,0,0,0,0
77,8481578,Graeme Clarke,R,MIN,23,0,0,0,0
77,8482177,Marat Khusnutdinov,C,MIN,22,0,0,0,0
77,8481754,Nikita Nesterenko,C,ANA,23,0,0,0,0
77,8483531,Brian Halonen,L,NJD,25,0,0,0,0
77,8483920,Pierrick Dube,R,WSH,23,0,0,0,0
77,8480851,Akil Thomas,C,LAK,24,0,0,0,0
77,8475235,Nicolas Deslauriers,L,PHI,33,0,0,0,0
77,8482476,Emil Heineman,L,MTL,23,0,0,0,0
77,8477149,Scott Sabourin,R,SJS,32,0,0,0,0
77,8483549,Lucas Condotta,L,MTL,27,0,0,0,0
77,8482765,Isak Rosen,R,BUF,21,0,0,0,0
77,8481237,Kyle MacLean,C,NYI,25,0,0,0,0
77,8481024,Linus Karlsson,C,VAN,25,0,0,0,0
77,8481690,Tyler Angle,C,,24,0,0,0,0
77,8483570,Ben Meyers,C,SEA,26,0,0,0,0
77,8481655,Cole Schwindt,R,CGY,23,0,0,0,0
77,8481462,Mason Morelli,L,VGK,28,0,0,0,0
77,8483401,Marc Johnstone,R,PIT,28,0,0,0,0
77,8478956,Samuel Laberge,L,NJD,27,0,0,0,0
77,8479533,Joona Koppanen,L,,26,0,0,0,0
77,8482197,Adam Raska,R,MIN,23,0,0,0,0
77,8482250,Callahan Burke,C,VGK,27,0,0,0,0
77,8482784,Zach Dean,C,STL,21,0,0,0,0
77,8484255,Jason Polin,R,COL,25,0,0,0,0
77,8481077,John Leonard,L,,26,0,0,0,0
77,8481534,Raphael Lavoie,C,EDM,24,0,0,0,0
77,8483609,Adam Klapka,R,CGY,24,0,0,0,0
77,8482751,Ryan Winterton,C,SEA,21,0,0,0,0
77,8480267,Sammy Walker,C,MIN,25,0,0,0,0
77,8475766,Austin Watson,L,,32,0,0,0,0
77,8482460,Matt Rempe,C,NYR,22,0,0,0,0
77,8481065,Angus Crookshank,L,OTT,25,0,0,0,0
77,8481070,Hugh McGing,L,,26,0,0,0,0
77,8476323,Max McCormick,L,SEA,32,0,0,0,0
77,8483395,Arshdeep Bains,L,VAN,23,0,0,0,0
77,8484259,Ondrej Pavel,C,COL,31,0,0,0,0
77,8483432,Luca Del Bel Belluz,C,CBJ,31,0,0,0,0
77,8483045,Cameron Butler,R,CBJ,31,0,0,0,0
77,8482061,Brandon Biro,L,SEA,26,0,0,0,0
77,8477401,John Hayden,C,SEA,29,0,0,0,0
77,8475278,Byron Froese,C,,33,0,0,0,0
77,8478446,Glenn Gawdin,C,LAK,27,0,0,0,0
77,8477993,Justin Kirkland,C,CGY,28,0,0,0,0
77,8482147,Jean-Luc Foudy,C,COL,22,0,0,0,0
77,8480032,Shane Bowers,C,NJD,25,0,0,0,0
77,8479330,Brandon Gignac,C,MTL,27,0,0,0,0
77,8480776,Sheldon Rempal,R,,29,0,0,0,0
77,8475413,Justin Dowling,C,NJD,34,0,0,0,0
77,8481726,Adam Edstrom,C,NYR,24,0,0,0,0
77,8480844,Grigori Denisenko,L,VGK,24,0,0,0,0
77,8478147,Bokondji Imama,L,PIT,28,0,0,0,0
77,8478881,Brett Seney,L,CHI,28,0,0,0,0
77,8483630,Pavol Regenda,L,ANA,25,0,0,0,0
77,8480836,Jonathan Gruden,C,,24,0,0,0,0
77,8484314,Jiri Smejkal,L,,28,0,0,0,0
77,8475780,Chris Wagner,R,COL,33,0,0,0,0
77,8479546,Oskar Steen,C,,26,0,0,0,0
77,8483597,Milos Kelemen,L,UTA,25,0,0,0,0
77,8481789,Tye Kartye,L,SEA,23,0,0,0,0
77,8484325,Waltteri Merela,C,TBL,26,0,0,0,0
77,8479421,Jacob Moverare,D,LAK,26,0,0,0,0
77,8481585,Egor Afanasyev,L,SJS,23,0,0,0,0
77,8479547,Matthew Phillips,R,,26,0,0,0,0
77,8479367,William Lockwood,R,FLA,26,0,0,0,0
77,8476915,Jujhar Khaira,L,,30,0,0,0,0
77,8481422,Jacob Lucchini,C,NSH,29,0,0,0,0
77,8480468,James Hamblin,L,EDM,25,0,0,0,0
77,8478051,Max Willman,C,NJD,29,0,0,0,0
77,8481556,John Beecher,C,BOS,23,0,0,0,0
77,8478078,Rourke Chartier,C,,28,0,0,0,0
78,8478402,Connor McDavid,C,EDM,27,82,49,107,156
78,8477934,Leon Draisaitl,C,EDM,29,82,46,91,137
78,8477956,David Pastrnak,R,BOS,28,82,52,72,124
78,8477492,Nathan MacKinnon,C,COL,29,82,49,73,122
78,8481559,Jack Hughes,C,NJD,23,82,45,70,115
78,8479318,Auston Matthews,C,TOR,27,82,55,58,113
78,8471675,Sidney Crosby,C,PIT,37,82,42,63,105
78,8480801,Brady Tkachuk,L,OTT,25,82,45,58,103
78,8478550,Artemi Panarin,L,NYR,33,82,25,78,103
78,8478864,Kirill Kaprizov,L,MIN,27,82,48,54,102
78,8479314,Matthew Tkachuk,L,FLA,27,82,34,68,102
78,8478420,Mikko Rantanen,R,COL,28,82,42,57,99
78,8477493,Aleksander Barkov,C,FLA,29,82,29,70,99
78,8476453,Nikita Kucherov,R,TBL,31,82,28,70,98
78,8477939,William Nylander,R,TOR,28,82,46,48,94
78,8477946,Dylan Larkin,C,DET,28,82,36,58,94
78,8479323,Adam Fox,D,NYR,26,82,18,76,94
78,8478403,Jack Eichel,C,VGK,28,82,43,50,93
78,8477409,Carter Verhaeghe,C,FLA,29,82,43,48,91
78,8471215,Evgeni Malkin,C,PIT,38,82,40,51,91
78,8479420,Tage Thompson,C,BUF,27,82,49,41,90
78,8475913,Mark Stone,R,VGK,32,82,29,61,90
78,8478445,Mathew Barzal,C,NYI,27,82,26,64,90
78,8479343,Clayton Keller,R,UTA,26,82,42,47,89
78,8476887,Filip Forsberg,L,NSH,30,82,41,48,89
78,8480012,Elias Pettersson,C,VAN,26,82,29,60,89
78,8480002,Nico Hischier,C,NJD,25,82,26,63,89
78,8480069,Cale Makar,D,COL,26,82,25,64,89
78,8475692,Mats Zuccarello,R,MIN,37,82,16,73,89
78,8479337,Alex DeBrincat,R,DET,27,82,33,55,88
78,8478427,Sebastian Aho,C,CAR,27,82,43,43,86
78,8480830,Andrei Svechnikov,R,CAR,24,82,35,51,86
78,8481523,Kirby Dach,C,MTL,23,82,19,67,86
78,8480027,Jason Robertson,L,DAL,25,82,34,51,85
78,8475172,Nazem Kadri,C,CGY,34,82,32,53,85
78,8477404,Jake Guentzel,C,TBL,30,82,37,47,84
78,8475810,Bryan Rust,R,PIT,32,82,37,46,83
78,8482116,Tim Stützle,C,OTT,22,82,32,51,83
78,8476459,Mika Zibanejad,C,NYR,31,82,33,49,82
78,8481540,Cole Caufield,R,MTL,23,82,37,44,81
78,8475166,John Tavares,C,TOR,34,82,34,47,81
78,8478493,Joel Eriksson Ek,C,MIN,27,82,33,48,81
78,8474564,Steven Stamkos,C,NSH,34,82,39,41,80
78,8473419,Brad Marchand,L,BOS,36,82,33,47,80
78,8478449,Roope Hintz,C,DAL,28,82,33,47,80
78,8479407,Jesper Bratt,L,NJD,26,82,33,47,80
78,8476456,Jonathan Huberdeau,C,CGY,31,82,16,64,80
78,8471214,Alex Ovechkin,L,WSH,39,82,40,39,79
78,8476468,J.T. Miller,C,VAN,31,82,29,50,79
78,8476389,Vincent Trocheck,C,NYR,31,82,28,51,79
78,8475786,Zach Hyman,L,EDM,32,82,40,38,78
78,8481557,Matt Boldy,L,MIN,23,82,34,44,78
78,8479385,Jordan Kyrou,C,STL,26,82,29,49,78
78,8476454,Ryan Nugent-Hopkins,C,EDM,31,82,24,54,78
78,8480800,Quinn Hughes,D,VAN,25,82,13,65,78
78,8478398,Kyle Connor,L,WPG,28,82,46,31,77
78,8476448,William Karlsson,C,VGK,31,82,39,38,77
78,8477949,Alex Tuch,R,BUF,28,82,24,53,77
78,8474600,Roman Josi,D,NSH,34,82,21,56,77
78,8475184,Chris Kreider,L,NYR,33,82,50,25,75
78,8473994,Jamie Benn,L,DAL,35,82,30,45,75
78,8478440,Dylan Strome,C,WSH,27,82,29,46,75
78,8480023,Robert Thomas,C,STL,25,82,22,53,75
78,8477940,Nikolaj Ehlers,L,WPG,28,82,29,45,74
78,8476460,Mark Scheifele,C,WPG,31,82,25,48,73
78,8475798,Mikael Granlund,C,SJS,32,82,20,53,73
78,8480803,Evan Bouchard,D,EDM,25,82,11,62,73
78,8478042,Viktor Arvidsson,R,EDM,31,82,35,37,72
78,8477933,Sam Reinhart,C,FLA,29,82,33,39,72
78,8478010,Brayden Point,C,TBL,28,82,32,40,72
78,8474141,Patrick Kane,R,DET,36,82,27,45,72
78,8478439,Travis Konecny,R,PHI,27,82,26,46,72
78,8477500,Bo Horvat,C,NYI,29,82,39,32,71
78,8477402,Pavel Buchnevich,L,STL,29,82,31,40,71
78,8478414,Timo Meier,R,NJD,28,82,31,40,71
78,8476432,Boone Jenner,C,CBJ,31,82,40,30,70
78,8482078,Lucas Raymond,L,DET,22,82,33,37,70
78,8477451,Ryan Hartman,R,MIN,30,82,27,43,70
78,8478396,Noah Hanifin,D,VGK,27,82,16,54,70
78,8476539,Jonathan Marchessault,R,NSH,34,82,40,29,69
78,8480014,Gabriel Vilardi,C,WPG,25,82,40,29,69
78,8475168,Matt Duchene,C,DAL,33,82,32,37,69
78,8480208,Drake Batherson,R,OTT,26,82,30,39,69
78,8477501,Valeri Nichushkin,R,COL,29,82,30,39,69
78,8473512,Claude Giroux,R,OTT,36,82,20,49,69
78,8476346,Johnny Gaudreau,L,CBJ,31,82,15,54,69
78,8480036,Miro Heiskanen,D,DAL,25,82,14,55,69
78,8475167,Victor Hedman,D,TBL,34,82,11,58,69
78,8480015,Owen Tippett,R,PHI,25,82,34,34,68
78,8476881,Tomas Hertl,C,VGK,31,82,30,37,67
78,8475754,Brock Nelson,C,NYI,33,82,30,37,67
78,8477942,Kevin Fiala,L,LAK,28,82,22,45,67
78,8480865,Noah Dobson,D,NYI,24,82,11,56,67
78,8480064,Josh Norris,C,OTT,25,82,32,34,66
78,8474150,Mikael Backlund,C,CGY,35,82,25,41,66
78,8478397,Rasmus Andersson,D,CGY,28,82,16,50,66
78,8474578,Erik Karlsson,D,PIT,34,82,12,54,66
78,8479339,Patrik Laine,L,CBJ,26,82,35,30,65
78,8481068,Yegor Sharangovich,C,CGY,26,82,30,35,65
78,8478498,Jake DeBrusk,L,VAN,28,82,26,39,65
78,8477960,Adrian Kempe,R,LAK,28,82,25,40,65
78,8475158,Ryan O'Reilly,C,NSH,33,82,24,41,65
78,8478873,Troy Terry,R,ANA,27,82,22,43,65
78,8476905,Chandler Stephenson,C,SEA,30,82,16,49,65
78,8476853,Morgan Rielly,D,TOR,30,82,13,52,65
78,8478401,Pavel Zacha,C,BOS,27,82,31,33,64
78,8478444,Brock Boeser,R,VAN,27,82,29,35,64
78,8475191,Reilly Smith,R,NYR,33,82,28,35,63
78,8471685,Anze Kopitar,C,LAK,37,82,27,36,63
78,8477504,Josh Morrissey,D,WPG,29,82,13,50,63
78,8475794,Tyler Seguin,C,DAL,32,82,33,29,62
78,8475726,Tyler Toffoli,C,SJS,32,82,32,30,62
78,8482667,William Eklund,L,SJS,22,82,32,30,62
78,8477951,Nick Schmaltz,C,UTA,28,82,31,31,62
78,8481596,Shane Pinto,C,OTT,24,82,26,36,62
78,8477416,Oliver Bjorkstrand,R,SEA,29,82,22,40,62
78,8478038,Devon Toews,D,COL,30,82,14,48,62
78,8480839,Rasmus Dahlin,D,BUF,24,82,11,51,62
78,8482740,Wyatt Johnston,C,DAL,21,82,30,31,61
78,8481528,Dylan Cozens,C,BUF,23,82,28,33,61
78,8476399,Blake Coleman,C,CGY,33,82,27,34,61
78,8479542,Brandon Hagel,L,TBL,26,82,32,28,60
78,8477955,Jared McCann,L,SEA,28,82,31,29,60
78,8480185,Eetu Luostarinen,C,FLA,26,82,23,37,60
78,8480039,Martin Necas,C,CAR,25,82,19,41,60
78,8475784,Jeff Skinner,C,EDM,32,82,32,27,59
78,8478047,Michael Bunting,L,PIT,29,82,23,36,59
78,8474565,Alex Pietrangelo,D,VGK,34,82,16,43,59
78,8474590,John Carlson,D,WSH,34,82,12,47,59
78,8482665,Matty Beniers,C,SEA,22,82,30,28,58
78,8474641,Adam Henrique,C,EDM,34,82,28,30,58
78,8476880,Tom Wilson,R,WSH,30,82,28,30,58
78,8482097,Jack Quinn,R,BUF,23,82,22,36,58
78,8477456,J.T. Compher,L,DET,29,82,21,37,58
78,8477346,MacKenzie Weegar,D,CGY,30,82,18,40,58
78,8477503,Max Domi,C,TOR,29,82,16,42,58
78,8478856,Conor Garland,R,VAN,28,82,30,27,57
78,8480797,Joel Farabee,L,PHI,24,82,24,33,57
78,8477932,Aaron Ekblad,D,FLA,28,82,23,34,57
78,8479400,Pierre-Luc Dubois,L,WSH,26,82,21,36,57
78,8482745,Mason McTavish,C,ANA,21,82,20,37,57
78,8476960,Andreas Athanasiou,C,CHI,30,82,20,37,57
78,8470613,Brent Burns,D,CAR,39,82,17,40,57
78,8482093,Seth Jarvis,C,CAR,22,82,32,24,56
78,8482113,Anton Lundell,C,FLA,23,82,21,35,56
78,8475745,Charlie Coyle,C,BOS,32,82,20,36,56
78,8471724,Kris Letang,D,PIT,37,82,13,43,56
78,8477447,Shea Theodore,D,VGK,29,82,10,46,56
78,8479325,Charlie McAvoy,D,BOS,27,82,8,48,56
78,8477407,Anthony Duclair,L,NYI,29,82,29,26,55
78,8478366,Frank Vatrano,R,ANA,30,82,27,28,55
78,8482109,Alexis Lafrenière,L,NYR,23,82,26,29,55
78,8473422,Nick Foligno,L,CHI,37,82,25,30,55
78,8480018,Nick Suzuki,C,MTL,25,82,21,34,55
78,8474563,Drew Doughty,D,LAK,35,82,19,36,55
78,8478438,Tommy Novak,C,NSH,27,82,16,39,55
78,8478460,Zach Werenski,D,CBJ,27,82,12,43,55
78,8478233,Andrew Mangiapane,L,WSH,28,82,22,32,54
78,8478462,Nicolas Roy,C,VGK,27,82,20,34,54
78,8481533,Trevor Zegras,C,ANA,23,82,20,34,54
78,8476479,Phillip Danault,C,LAK,31,82,19,35,54
78,8482684,Luke Hughes,D,NJD,21,82,14,40,54
78,8477986,Brandon Montour,D,SEA,30,82,14,40,54
78,8476826,Yanni Gourde,C,SEA,33,82,12,42,54
78,8479425,Filip Hronek,D,VAN,27,82,12,42,54
78,8479410,Mikhail Sergachev,D,UTA,26,82,10,44,54
78,8480028,Morgan Frost,C,PHI,25,82,24,29,53
78,8480078,Filip Chytil,C,NYR,25,82,19,34,53
78,8475151,Kyle Palmieri,C,NYI,33,82,19,34,53
78,8482055,Drew O'Connor,L,PIT,26,82,31,21,52
78,8483808,Andrei Kuzmenko,L,CGY,28,82,27,25,52
78,8477935,Sam Bennett,C,FLA,28,82,22,30,52
78,8477964,Ivan Barbashev,C,VGK,29,82,18,34,52
78,8478975,Mason Marchment,L,DAL,29,82,15,37,52
78,8480798,Philipp Kurashev,C,CHI,25,82,15,37,52
78,8476462,Dougie Hamilton,D,NJD,31,82,12,40,52
78,8477511,Anthony Mantha,R,CGY,30,82,25,26,51
78,8475765,Vladimir Tarasenko,R,DET,33,82,19,32,51
78,8475169,Evander Kane,L,EDM,33,82,29,21,50
78,8482110,Dawson Mercer,C,NJD,23,82,27,23,50
78,8474102,David Perron,L,OTT,36,82,23,27,50
78,8477494,Jonathan Drouin,L,COL,29,82,16,34,50
78,8476906,Shayne Gostisbehere,D,CAR,31,82,12,38,50
78,8476875,Mike Matheson,D,MTL,30,82,11,39,50
78,8478469,Thomas Chabot,D,OTT,27,82,10,40,50
78,8475753,Justin Faulk,D,STL,32,82,10,40,50
78,8475218,Mattias Ekholm,D,EDM,34,82,9,41,50
78,8476438,Brandon Saad,L,STL,32,82,32,17,49
78,8477479,Tyler Bertuzzi,L,CHI,29,82,29,20,49
78,8475170,Brayden Schenn,C,STL,33,82,24,25,49
78,8475799,Nino Niederreiter,R,WPG,32,82,23,26,49
78,8477426,Nicholas Paul,L,TBL,29,82,22,27,49
78,8481618,Alex Newhook,C,MTL,23,82,22,27,49
78,8482175,JJ Peterka,R,BUF,22,82,20,29,49
78,8477496,Elias Lindholm,C,BOS,30,82,19,30,49
78,8477497,Sean Monahan,C,CBJ,30,82,19,30,49
78,8482159,Tyson Foerster,R,PHI,22,82,19,30,49
78,8478458,Jack Roslovic,C,CAR,27,82,17,32,49
78,8478407,Vince Dunn,D,SEA,28,82,11,38,49
78,8474149,Evgenii Dadonov,R,DAL,35,82,28,20,48
78,8474053,Logan Couture,C,SJS,35,82,20,28,48
78,8473986,Alex Killorn,L,ANA,35,82,16,32,48
78,8479999,Casey Mittelstadt,C,COL,26,82,16,32,48
78,8474679,Gustav Nyquist,C,NSH,35,82,15,33,48
78,8478472,Mathieu Joseph,R,STL,27,82,12,36,48
78,8482117,Lukas Reichel,L,CHI,22,82,24,23,47
78,8474586,Jordan Eberle,R,SEA,34,82,23,24,47
78,8475768,Jaden Schwartz,C,SEA,32,82,20,27,47
78,8476854,Hampus Lindholm,D,BOS,30,82,10,37,47
78,8476292,Ondrej Palat,L,NJD,33,82,21,25,46
78,8480068,Ryan Poehling,C,PHI,25,82,19,27,46
78,8476882,Teuvo Teravainen,L,CHI,30,82,18,28,46
78,8475763,Kevin Hayes,R,PIT,32,82,18,28,46
78,8477444,Andre Burakovsky,L,SEA,29,82,15,31,46
78,8479345,Jakob Chychrun,D,WSH,26,82,14,32,46
78,8477495,Seth Jones,D,CHI,30,82,11,35,46
78,8480188,Fabian Zetterlund,L,SJS,25,82,27,18,45
78,8480995,Pontus Holmberg,R,TOR,25,82,26,19,45
78,8482149,Cole Perfetti,C,WPG,22,82,19,26,45
78,8479987,Morgan Geekie,C,BOS,26,82,17,28,45
78,8481711,Matias Maccelli,L,UTA,24,82,16,29,45
78,8476869,Brady Skjei,D,NSH,30,82,7,38,45
78,8476483,Rickard Rakell,R,PIT,31,82,22,22,44
78,8477476,Artturi Lehkonen,L,COL,29,82,21,23,44
78,8471698,T.J. Oshie,R,WSH,38,82,19,25,44
78,8478115,Pierre Engvall,L,NYI,28,82,19,25,44
78,8475287,Erik Haula,L,NJD,33,82,17,27,44
78,8476419,Jean-Gabriel Pageau,C,NYI,32,82,16,28,44
78,8482146,Luke Evangelista,R,NSH,22,82,15,29,44
78,8481546,Cam York,D,PHI,23,82,13,31,44
78,8477969,Marcus Pettersson,D,PIT,28,82,7,37,44
78,8478055,Gustav Forsling,D,FLA,28,82,6,38,44
78,8482699,Dylan Guenther,R,UTA,21,82,19,24,43
78,8479525,Ross Colton,C,COL,28,82,19,24,43
78,8479675,Trevor Moore,L,LAK,29,82,15,28,43
78,8482720,Matthew Knies,L,TOR,22,82,14,29,43
78,8476979,Erik Gustafsson,D,DET,32,82,11,32,43
78,8477947,Sonny Milano,L,WSH,28,82,10,33,43
78,8475760,Nick Bjugstad,C,UTA,32,82,23,19,42
78,8475314,Anders Lee,L,NYI,34,82,22,20,42
78,8482125,Alexander Holtz,R,VGK,22,82,20,22,42
78,8475791,Taylor Hall,L,CHI,33,82,16,26,42
78,8478542,Evan Rodrigues,C,FLA,31,82,16,26,42
78,8475149,Marcus Johansson,L,MIN,34,82,12,30,42
78,8480434,Sean Durzi,D,UTA,26,82,10,32,42
78,8475722,Jason Zucker,L,BUF,32,82,22,19,41
78,8476925,Colton Sissons,C,NSH,31,82,16,25,41
78,8482124,Quinton Byfield,R,LAK,22,82,13,28,41
78,8478463,Anthony Beauvillier,L,PIT,27,82,11,30,41
78,8482671,Owen Power,D,BUF,22,82,9,32,41
78,8476923,Damon Severson,D,CBJ,30,82,6,35,41
78,8481542,Moritz Seider,D,DET,23,82,4,37,41
78,8482089,Jake Neighbours,L,STL,22,82,25,15,40
78,8480829,Jesperi Kotkaniemi,C,CAR,24,82,22,18,40
78,8478519,Anthony Cirelli,C,TBL,27,82,19,21,40
78,8476872,Scott Laughton,C,PHI,30,82,18,22,40
78,8482705,Cole Sillinger,C,CBJ,21,82,18,22,40
78,8477953,Kasperi Kapanen,R,STL,28,82,12,28,40
78,8476329,Travis Boyd,C,MIN,31,82,8,32,40
78,8478057,Dakota Joshua,C,VAN,28,82,21,18,39
78,8478046,Danton Heinen,L,VAN,29,82,20,19,39
78,8474715,Cam Atkinson,R,TBL,35,82,20,19,39
78,8478474,Lawson Crouse,L,UTA,27,82,19,20,39
78,8473563,Nicklas Backstrom,C,WSH,37,82,14,25,39
78,8475171,Oliver Ekman-Larsson,D,TOR,33,82,13,26,39
78,8482660,Kent Johnson,C,CBJ,22,82,11,28,39
78,8480145,Neal Pionk,D,WPG,29,82,7,32,39
78,8482092,Ridly Greig,C,OTT,22,82,23,15,38
78,8477998,Warren Foegele,L,LAK,28,82,22,16,38
78,8476927,Teddy Blueger,C,VAN,30,82,14,24,38
78,8476392,Adam Lowry,C,WPG,31,82,14,24,38
78,8479351,Sam Steel,C,DAL,26,82,12,26,38
78,8481656,Aliaksei Protas,C,WSH,23,82,10,28,38
78,8476885,Jacob Trouba,D,NYR,30,82,7,31,38
78,8482105,Jake Sanderson,D,OTT,22,82,5,33,38
78,8476469,Joel Armia,R,MTL,31,82,22,15,37
78,8481554,Kaapo Kakko,R,NYR,23,82,21,16,37
78,8482079,Marco Rossi,C,MIN,23,82,21,16,37
78,8481560,Arthur Kaliyev,R,LAK,23,82,18,19,37
78,8481013,Jonatan Berggren,R,DET,24,82,18,19,37
78,8479353,Brett Howden,C,VGK,26,82,18,19,37
78,8480459,Pius Suter,C,VAN,28,82,17,20,37
78,8473533,Jordan Staal,C,CAR,36,82,16,21,37
78,8476897,Oskar Sundqvist,C,STL,30,82,15,22,37
78,8475848,Brendan Gallagher,R,MTL,32,82,15,22,37
78,8479992,Michael Rasmussen,C,DET,25,82,14,23,37
78,8476792,Torey Krug,D,STL,33,82,13,24,37
78,8477021,Alex Kerfoot,C,UTA,30,82,12,25,37
78,8481606,Jordan Spence,D,LAK,23,82,7,30,37
78,8480009,Eeli Tolvanen,R,SEA,25,82,21,15,36
78,8480813,Joe Veleno,C,DET,24,82,20,16,36
78,8482475,Yegor Chinakhov,R,CBJ,23,82,18,18,36
78,8480871,Adam Boqvist,D,FLA,24,82,15,21,36
78,8474716,Jared Spurgeon,D,MIN,35,82,15,21,36
78,8476458,Ryan Strome,C,ANA,31,82,15,21,36
78,8480113,Alex Iafallo,L,WPG,31,82,11,25,36
78,8478413,Jordan Greenway,L,BUF,27,82,9,27,36
78,8476981,Josh Anderson,R,MTL,30,82,22,13,35
78,8480893,Kirill Marchenko,R,CBJ,24,82,20,15,35
78,8470621,Corey Perry,R,EDM,39,82,18,17,35
78,8477429,Andrew Copp,C,DET,30,82,16,19,35
78,8477989,Christian Dvorak,C,MTL,28,82,15,20,35
78,8481186,Logan O'Connor,R,COL,28,82,13,22,35
78,8478109,Victor Olofsson,L,VGK,29,82,12,23,35
78,8482133,Thomas Bordeleau,C,SJS,22,82,10,25,35
78,8477498,Darnell Nurse,D,EDM,29,82,8,27,35
78,8480817,K'Andre Miller,D,NYR,24,82,7,28,35
78,8481624,Ilya Mikheyev,R,CHI,30,82,18,16,34
78,8479941,Justin Danforth,R,CBJ,31,82,17,17,34
78,8480980,Connor Dewar,C,TOR,25,82,15,19,34
78,8474189,Lars Eller,C,PIT,35,82,13,21,34
78,8476278,Colin Blackwell,C,DAL,31,82,12,22,34
78,8482073,Braden Schneider,D,NYR,23,82,7,27,34
78,8482142,Jamie Drysdale,D,PHI,22,82,5,29,34
78,8474151,Ryan McDonagh,D,TBL,35,82,5,29,34
78,8482624,Daniil Miromanov,D,CGY,27,82,15,18,33
78,8476461,Sean Couturier,C,PHI,32,82,13,20,33
78,8478569,Noel Acciari,C,PIT,33,82,12,21,33
78,8476958,Jaccob Slavin,D,CAR,30,82,10,23,33
78,8476463,Jonas Brodin,D,MIN,31,82,10,23,33
78,8475200,Dmitry Orlov,D,CAR,33,82,7,26,33
78,8477506,Ryan Pulock,D,NYI,30,82,7,26,33
78,8480043,Timothy Liljegren,D,TOR,25,82,6,27,33
78,8477948,Travis Sanheim,D,PHI,28,82,6,27,33
78,8480873,Rasmus Sandin,D,WSH,24,82,6,27,33
78,8480336,Sean Walker,D,CAR,30,82,6,27,33
78,8475764,Cam Fowler,D,ANA,33,82,4,29,33
78,8479983,Mario Ferraro,D,SJS,26,82,1,32,33
78,8480748,Kiefer Sherwood,L,VAN,29,82,17,15,32
78,8475343,Nic Dowd,C,WSH,34,82,16,16,32
78,8477508,Curtis Lazar,C,NJD,29,82,16,16,32
78,8475714,Calle Jarnkrok,C,TOR,33,82,15,17,32
78,8475855,Jesper Fast,R,CAR,33,82,14,18,32
78,8476480,Vladislav Namestnikov,C,WPG,32,82,13,19,32
78,8477919,Frederick Gaudreau,C,MIN,31,82,13,19,32
78,8476921,Jordan Martinook,L,CAR,32,82,12,20,32
78,8482702,Logan Stankoven,C,DAL,21,82,10,22,32
78,8481581,Thomas Harley,D,DAL,23,82,7,25,32
78,8479371,Dante Fabbro,D,NSH,26,82,4,28,32
78,8479365,Trent Frederic,C,BOS,26,82,16,15,31
78,8481604,Pavel Dorofeyev,L,VGK,24,82,16,15,31
78,8482259,Bobby McMann,C,TOR,28,82,15,16,31
78,8479414,Nathan Bastian,R,NJD,27,82,15,16,31
78,8475220,Marcus Foligno,L,MIN,33,82,14,17,31
78,8480835,Jack Drury,C,CAR,24,82,12,19,31
78,8480220,Noah Cates,L,PHI,25,82,10,21,31
78,8478891,Mason Appleton,C,WPG,28,82,9,22,31
78,8481568,Alex Vlasic,D,CHI,23,82,6,25,31
78,8480860,Kevin Bahl,D,CGY,24,82,3,28,31
78,8481535,Nils Hoglander,L,VAN,24,82,19,11,30
78,8479591,Michael Eyssimont,C,TBL,28,82,18,12,30
78,8481481,Blake Lizotte,C,PIT,27,82,17,13,30
78,8479393,Noah Gregor,C,OTT,26,82,16,14,30
78,8481580,Connor McMichael,C,WSH,23,82,15,15,30
78,8475793,Ryan Johansen,C,PHI,32,82,14,16,30
78,8478020,Michael Amadio,C,OTT,28,82,14,16,30
78,8478211,Dryden Hunt,L,CGY,29,82,12,18,30
78,8478432,Christian Fischer,R,DET,27,82,12,18,30
78,8483515,Juraj Slafkovsky,L,MTL,20,82,11,19,30
78,8484153,Leo Carlsson,C,ANA,20,82,11,19,30
78,8478911,Matt Roy,D,WSH,29,82,9,21,30
78,8475193,Tomas Tatar,L,NJD,34,82,9,21,30
78,8479402,Jake Bean,D,CGY,26,82,9,21,30
78,8476892,Colton Parayko,D,STL,31,82,5,25,30
78,8478507,John Marino,D,UTA,27,82,3,27,30
78,8482077,Dylan Holloway,L,EDM,23,82,20,9,29
78,8479390,Taylor Raddysh,R,WSH,26,82,15,14,29
78,8478508,Yakov Trenin,C,MIN,27,82,15,14,29
78,8484144,Connor Bedard,C,CHI,19,82,12,17,29
78,8476918,Jimmy Vesey,L,NYR,31,82,12,17,29
78,8477931,Tomas Nosek,L,FLA,32,82,12,17,29
78,8482111,Justin Barron,D,MTL,23,82,11,18,29
78,8478013,Jake Walman,D,SJS,28,82,11,18,29
78,8477507,Nikita Zadorov,D,BOS,29,82,10,19,29
78,8482122,Brock Faber,D,MIN,22,82,6,23,29
78,8481014,Alexander Romanov,D,NYI,24,82,4,25,29
78,8483431,Logan Cooley,C,UTA,20,82,14,14,28
78,8481524,Bowen Byram,D,BUF,23,82,14,14,28
78,8479293,Brandon Tanev,L,SEA,33,82,13,15,28
78,8482166,Shakir Mukhamadullin,D,SJS,22,82,13,15,28
78,8479661,Tanner Jeannot,L,LAK,27,82,11,17,28
78,8480789,Oliver Wahlstrom,R,NYI,24,82,11,17,28
78,8482141,Lukas Cormier,D,VGK,22,82,8,20,28
78,8477488,Brett Pesce,D,NJD,30,82,5,23,28
78,8476891,Matt Grzelcyk,D,PIT,30,82,3,25,28
78,8480049,Dylan Samberg,D,WPG,25,82,0,28,28
78,8483524,Shane Wright,C,SEA,20,82,15,12,27
78,8477952,Robby Fabbri,C,ANA,28,82,14,13,27
78,8479359,Beck Malenstyn,L,BUF,26,82,13,14,27
78,8481641,Joel Kiviranta,L,COL,28,82,13,14,27
78,8481522,Peyton Krebs,C,BUF,23,82,12,15,27
78,8477015,Connor Brown,R,EDM,30,82,11,16,27
78,8477987,Ryan Donato,C,CHI,28,82,9,18,27
78,8480003,Jesper Boqvist,C,FLA,26,82,9,18,27
78,8475279,Ben Chiarot,D,DET,33,82,7,20,27
78,8478133,Jake Evans,C,MTL,28,82,5,22,27
78,8477220,Nate Schmidt,D,FLA,33,82,5,22,27
78,8478851,Alexandre Carrier,D,NSH,28,82,5,22,27
78,8475181,Nick Leddy,D,STL,33,82,5,22,27
78,8478840,Will Borgen,D,SEA,28,82,4,23,27
78,8480849,Barrett Hayton,C,UTA,24,82,15,11,26
78,8477903,Garnet Hathaway,R,PHI,33,82,14,12,26
78,8475231,Casey Cizikas,C,NYI,33,82,13,13,26
78,8476442,Matt Nieto,L,PIT,32,82,13,13,26
78,8484145,Zach Benson,L,BUF,19,82,13,13,26
78,8477450,Jason Dickinson,C,CHI,29,82,12,14,26
78,8477365,Connor Clifton,D,BUF,29,82,8,18,26
78,8480144,David Kampf,C,TOR,29,82,7,19,26
78,8483457,Lane Hutson,D,MTL,20,82,7,19,26
78,8479980,Nicolas Hague,D,VGK,26,82,5,21,26
78,8478136,Jake Middleton,D,MIN,28,82,5,21,26
78,8481178,Egor Zamula,D,PHI,24,82,3,23,26
78,8484203,Bradly Nadeau,L,CAR,19,82,2,24,26
78,8479976,Juuso Valimaki,D,UTA,26,82,2,24,26
78,8479996,Cody Glass,C,NSH,25,82,13,12,25
78,8482074,Connor Zary,C,CGY,23,82,9,16,25
78,8480802,Ryan McLeod,C,BUF,25,82,8,17,25
78,8481708,Zac Jones,D,NYR,24,82,8,17,25
78,8476467,Jamie Oleksiak,D,SEA,32,82,7,18,25
78,8484149,Gavin Brindley,C,CBJ,20,82,6,19,25
78,8476312,Josh Manson,D,COL,33,82,4,21,25
78,8476429,Scott Mayfield,D,NYI,32,82,4,21,25
78,8476931,Jake McCabe,D,TOR,31,82,3,22,25
78,8475324,Nick Jensen,D,OTT,34,82,2,23,25
78,8481093,Rafael Harvey-Pinard,L,MTL,25,82,15,9,24
78,8480281,Alexey Toropchenko,R,STL,25,82,13,11,24
78,8481582,Nicholas Robertson,L,TOR,23,82,12,12,24
78,8481704,Juuso Parssinen,C,NSH,23,82,12,12,24
78,8483482,Tristan Luneau,D,ANA,20,82,12,12,24
78,8480855,Jack McBain,C,UTA,24,82,11,13,24
78,8476422,Mike Reilly,D,NYI,31,82,10,14,24
78,8480074,Alexandre Texier,C,STL,25,82,8,16,24
78,8479316,Luke Kunin,C,SJS,27,82,8,16,24
78,8478882,Vladislav Gavrikov,D,LAK,29,82,5,19,24
78,8476902,Esa Lindell,D,DAL,30,82,5,19,24
78,8475690,Chris Tanev,D,TOR,35,82,3,21,24
78,8476917,Adam Pelech,D,NYI,30,82,2,22,24
78,8481601,Simon Holmstrom,R,NYI,23,82,15,8,23
78,8476474,Stefan Noesen,R,NJD,31,82,12,11,23
78,8477425,Miles Wood,L,COL,29,82,12,11,23
78,8481553,Bobby Brink,R,PHI,23,82,11,12,23
78,8480222,Sebastian Aho,D,PIT,28,82,8,15,23
78,8482101,Danil Gushchin,L,SJS,22,82,6,17,23
78,8482087,Kaiden Guhle,D,MTL,22,82,2,21,23
78,8478399,Jonas Siegenthaler,D,NJD,27,82,2,21,23
78,8475790,Erik Gudbranson,D,CBJ,32,82,1,22,23
78,8482155,Alex Laferriere,R,LAK,23,82,15,7,22
78,8481028,Martin Pospisil,C,CGY,25,82,13,9,22
78,8475842,Sam Carrick,C,NYR,32,82,11,11,22
78,8476889,Radek Faksa,C,STL,30,82,11,11,22
78,8482679,Matt Coronato,R,CGY,22,82,10,12,22
78,8480025,MacKenzie Entwistle,R,FLA,25,82,9,13,22
78,8479324,Ryan Lindgren,D,NYR,26,82,5,17,22
78,8480834,Ty Emberson,D,SJS,24,82,4,18,22
78,8478178,Darren Raddysh,D,TBL,28,82,4,18,22
78,8479398,Samuel Girard,D,COL,26,82,3,19,22
78,8480035,Henri Jokiharju,D,BUF,25,82,3,19,22
78,8476457,Adam Larsson,D,SEA,32,82,3,19,22
78,8480807,Mattias Samuelsson,D,BUF,24,82,3,19,22
78,8477499,Rasmus Ristolainen,D,PHI,30,82,3,19,22
78,8482655,J.J. Moser,D,TBL,24,82,2,20,22
78,8479998,Mikey Anderson,D,LAK,25,82,1,21,22
78,8475718,Justin Holl,D,DET,32,82,0,22,22
78,8476374,Sean Kuraly,C,CBJ,31,82,11,10,21
78,8479368,Max Jones,L,BOS,26,82,9,12,21
78,8482809,Jackson Blake,R,CAR,21,82,9,12,21
78,8484166,Adam Fantilli,C,CBJ,20,82,8,13,21
78,8482807,Ethan Del Mastro,D,CHI,21,82,7,14,21
78,8476331,Dylan DeMelo,D,WPG,31,82,5,16,21
78,8474673,TJ Brodie,D,CHI,34,82,1,20,21
78,8483493,Frank Nazar,C,CHI,20,82,9,11,20
78,8483763,Maksymilian Szuber,D,UTA,22,82,7,13,20
78,8481699,Aku Raty,R,UTA,23,82,7,13,20
78,8476624,Barclay Goodrow,C,SJS,31,82,6,14,20
78,8483490,Pavel Mintyukov,D,ANA,21,82,6,14,20
78,8480950,Ilya Lyubushkin,D,DAL,30,82,5,15,20
78,8477369,Carson Soucy,D,VAN,30,82,4,16,20
78,8480021,Jack Studnicka,C,LAK,25,82,4,16,20
78,8481567,Henry Thrun,D,SJS,23,82,3,17,20
78,8481032,Paul Cotter,C,NJD,25,82,12,7,19
78,8477392,Hudson Fasching,R,NYI,29,82,11,8,19
78,8476873,Mark Jankowski,C,NSH,30,82,9,10,19
78,8481477,Nico Sturm,C,SJS,29,82,9,10,19
78,8479369,Andrew Peeke,D,BOS,26,82,6,13,19
78,8477839,Conor Sheary,L,TBL,32,82,6,13,19
78,8476525,Colin Miller,D,WPG,32,82,6,13,19
78,8475762,Derek Forbort,D,VAN,32,82,4,15,19
78,8480796,Martin Fehervary,D,WSH,25,82,4,15,19
78,8470600,Ryan Suter,D,STL,39,82,3,16,19
78,8478468,Jeremy Lauzon,D,NSH,27,82,3,16,19
78,8477435,Ryan Graves,D,PIT,29,82,3,16,19
78,8477505,Alexander Wennberg,C,SJS,30,82,11,7,18
78,8477406,Mattias Janmark,C,EDM,32,82,9,9,18
78,8481517,Brett Leason,R,ANA,25,82,9,9,18
78,8482470,Ilya Solovyov,D,CGY,24,82,9,9,18
78,8479291,Kevin Rooney,C,CGY,31,82,9,9,18
78,8477938,Haydn Fleury,D,WPG,28,82,7,11,18
78,8482712,Oskar Olausson,R,COL,22,82,7,11,18
78,8474574,Tyler Myers,D,VAN,34,82,6,12,18
78,8482858,Ryker Evans,D,SEA,23,82,6,12,18
78,8483468,Jiri Kulich,C,BUF,20,82,6,12,18
78,8478416,Erik Cernak,D,TBL,27,82,5,13,18
78,8483460,David Jiricek,D,CBJ,21,82,5,13,18
78,8473507,Jeff Petry,D,DET,37,82,3,15,18
78,8480878,Nils Lundkvist,D,DAL,24,82,3,15,18
78,8477335,Kyle Burroughs,D,LAK,29,82,3,15,18
78,8480073,Erik Brannstrom,D,COL,25,82,3,15,18
78,8477845,Trevor van Riemsdyk,D,WSH,33,82,2,16,18
78,8482245,Artem Zub,D,OTT,29,82,2,16,18
78,8475188,Brayden McNabb,D,VGK,33,82,1,17,18
78,8476878,Zemgus Girgensons,L,TBL,30,82,12,5,17
78,8473453,Trevor Lewis,C,LAK,37,82,11,6,17
78,8480806,Isac Lundestrom,C,ANA,25,82,7,10,17
78,8483495,Simon Nemec,D,NJD,20,82,5,12,17
78,8481122,Simon Benoit,D,TOR,26,82,4,13,17
78,8479576,Vincent Desharnais,D,VAN,28,82,4,13,17
78,8475462,Radko Gudas,D,ANA,34,82,3,14,17
78,8480172,Jan Rutta,D,SJS,34,82,3,14,17
78,8478500,Ivan Provorov,D,CBJ,27,82,2,15,17
78,8477034,Jaycob Megna,D,FLA,32,82,2,15,17
78,8480448,Parker Kelly,L,COL,25,82,12,4,16
78,8478434,Keegan Kolesar,R,VGK,27,82,8,8,16
78,8483012,Logan Morrison,C,SEA,22,82,8,8,16
78,8477353,Tyler Motte,C,DET,29,82,6,10,16
78,8476372,Nick Seeler,D,PHI,31,82,6,10,16
78,8476441,Joel Edmundson,D,LAK,31,82,6,10,16
78,8478443,Brandon Carlo,D,BOS,28,82,4,12,16
78,8476879,Cody Ceci,D,EDM,31,82,6,9,15
78,8475455,Brenden Dillon,D,NJD,34,82,4,11,15
78,8483565,Nick Blankenburg,D,NSH,26,82,3,12,15
78,8475177,Calvin de Haan,D,COL,33,82,3,12,15
78,8483445,Cutter Gauthier,L,ANA,20,82,3,12,15
78,8476967,Brett Kulak,D,EDM,30,82,0,15,15
78,8474013,Ian Cole,D,UTA,35,82,0,15,15
78,8482062,Cole Smith,L,NSH,29,82,10,4,14
78,8482153,Brendan Brisson,C,VGK,23,82,7,7,14
78,8483499,Liam Ohgren,L,MIN,20,82,6,8,14
78,8482659,Josh Doan,R,UTA,22,82,5,9,14
78,8476473,Connor Murphy,D,CHI,31,82,3,11,14
78,8481605,Jackson LaCombe,D,ANA,23,82,3,11,14
78,8479442,Troy Stecher,D,EDM,30,82,2,12,14
78,8483505,Matthew Poitras,C,BOS,20,82,8,5,13
78,8482762,Simon Edvinsson,D,DET,21,82,7,6,13
78,8482733,Logan Mailloux,D,MTL,31,82,6,7,13
78,8483471,Brad Lambert,C,WPG,31,82,5,8,13
78,8484911,Collin Graf,R,SJS,22,82,4,9,13
78,8475233,David Savard,D,MTL,34,82,0,13,13
78,8482070,Mitchell Chaffee,R,TBL,26,82,7,5,12
78,8479638,Justin Brazeau,R,BOS,26,82,6,6,12
78,8480870,Bo Groulx,C,NYR,24,82,6,6,12
78,8482145,Mavrik Bourque,C,DAL,22,82,4,8,12
78,8482516,Matthew Kessel,D,STL,24,82,3,9,12
78,8483397,Marc McLaughlin,C,BOS,25,82,6,5,11
78,8471677,Jack Johnson,D,CBJ,37,82,5,6,11
78,8476858,Phillip Di Giuseppe,L,VAN,31,82,4,7,11
78,8480246,Nick Perbix,D,TBL,26,82,3,8,11
78,8483567,Georgii Merkulov,C,BOS,24,82,3,8,11
78,8482666,Scott Morrow,D,CAR,22,82,2,9,11
78,8474567,Zach Bogosian,D,MIN,34,82,2,9,11
78,8483466,Kevin Korchinski,D,CHI,20,82,2,9,11
78,8478450,Parker Wotherspoon,D,BOS,27,82,1,10,11
78,8480879,Jacob Bernard-Docker,D,OTT,24,82,0,11,11
78,8482713,Mackie Samoskevich,R,FLA,22,82,5,5,10
78,8478859,Niko Mikkola,D,FLA,28,82,5,5,10
78,8480990,Declan Chisholm,D,MIN,24,82,3,7,10
78,8482749,Joshua Roy,R,MTL,21,82,3,7,10
78,8474090,Brendan Smith,D,DAL,35,82,3,7,10
78,8482859,Zack Ostapchuk,C,OTT,21,82,2,8,10
78,8478874,Adam Gaudette,C,OTT,28,82,1,9,10
78,8482787,Nikita Chibrikov,R,WPG,31,82,3,6,9
78,8476822,Luke Glendening,C,TBL,35,82,6,2,8
78,8482803,Olen Zellweger,D,ANA,21,82,3,5,8
78,8474612,Travis Hamonic,D,OTT,34,82,0,7,7
78,8474062,Riley Nash,C,NYR,35,82,3,3,6
78,8482118,Sam Colangelo,R,ANA,23,82,2,4,6
78,8483489,Fraser Minten,C,TOR,31,82,0,6,6
78,8470794,Joe Pavelski,C,,40,0,0,0,0
78,8481703,Valtteri Puustinen,R,PIT,25,0,0,0,0
78,8477950,Tony DeAngelo,D,,29,0,0,0,0
78,8481577,Philip Tomasino,C,NSH,23,0,0,0,0
78,8475197,Tyson Barrie,D,,33,0,0,0,0
78,8471218,Blake Wheeler,R,,38,0,0,0,0
78,8474157,Max Pacioretty,L,,36,0,0,0,0
78,8478466,Daniel Sprong,R,VAN,27,0,0,0,0
78,8475744,Evgeny Kuznetsov,C,,32,0,0,0,0
78,8481019,David Gustafsson,C,WPG,24,0,0,0,0
78,8475906,John Klingberg,D,,32,0,0,0,0
78,8479348,Kale Clague,D,BUF,26,0,0,0,0
78,8476952,Dominic Toninato,C,WPG,30,0,0,0,0
78,8473473,Milan Lucic,L,,36,0,0,0,0
78,8474037,James van Riemsdyk,L,,35,0,0,0,0
78,8474602,Justin Schultz,D,,34,0,0,0,0
78,8482222,Alexander Barabanov,L,,30,0,0,0,0
78,8479372,Josh Mahura,D,SEA,26,0,0,0,0
78,8479982,Conor Timmins,D,TOR,26,0,0,0,0
78,8474031,Kevin Shattenkirk,D,,35,0,0,0,0
78,8480008,Adam Ruzicka,C,,25,0,0,0,0
78,8481059,Scott Perunovich,D,STL,26,0,0,0,0
78,8480884,Calen Addison,D,,24,0,0,0,0
78,8476994,Vinnie Hinostroza,C,NSH,30,0,0,0,0
78,8478452,Caleb Jones,D,LAK,27,0,0,0,0
78,8480157,Calle Rosen,D,COL,30,0,0,0,0
78,8481609,Vladislav Kolyachonok,D,UTA,23,0,0,0,0
78,8479415,Michael McLeod,C,,26,0,0,0,0
78,8476919,Chris Tierney,C,,30,0,0,0,0
78,8479639,Dylan Coghlan,D,WPG,26,0,0,0,0
78,8478146,Matthew Highmore,C,OTT,28,0,0,0,0
78,8478970,Jalen Chatfield,D,CAR,28,0,0,0,0
78,8480205,Emil Bemstrom,C,PIT,25,0,0,0,0
78,8474884,Mike Hoffman,C,,35,0,0,0,0
78,8471274,Alex Goligoski,D,,39,0,0,0,0
78,8478104,Sammy Blais,L,,28,0,0,0,0
78,8474870,Tyler Johnson,C,,34,0,0,0,0
78,8476913,Devin Shore,C,MIN,30,0,0,0,0
78,8481598,Philip Broberg,D,EDM,23,0,0,0,0
78,8480058,Pierre-Olivier Joseph,D,STL,25,0,0,0,0
78,8480891,Michael Kesselring,D,UTA,24,0,0,0,0
78,8477979,Nicolas Aube-Kubel,R,BUF,28,0,0,0,0
78,8476871,Tanner Pearson,L,,32,0,0,0,0
78,8476393,Nick Cousins,C,,31,0,0,0,0
78,8479977,Kailer Yamamoto,R,,26,0,0,0,0
78,8479543,Michael Pezzetta,L,MTL,26,0,0,0,0
78,8477018,Ben Hutton,D,VGK,31,0,0,0,0
78,8480762,Eric Robinson,L,CAR,29,0,0,0,0
78,8474034,Pat Maroon,L,CHI,36,0,0,0,0
78,8481058,Jesse Ylönen,R,,25,0,0,0,0
78,8475179,Dmitry Kulikov,D,FLA,34,0,0,0,0
78,8481527,Kaedan Korczak,D,VGK,23,0,0,0,0
78,8473449,Kyle Okposo,R,,36,0,0,0,0
78,8482192,Isaak Phillips,D,CHI,23,0,0,0,0
78,8480727,Zach Whitecloud,D,VGK,28,0,0,0,0
78,8479346,Dillon Dube,C,,26,0,0,0,0
78,8480821,Filip Zadina,R,,25,0,0,0,0
78,8480001,Urho Vaakanainen,D,ANA,25,0,0,0,0
78,8470966,Mark Giordano,D,,41,0,0,0,0
78,8480853,Liam Foudy,C,,24,0,0,0,0
78,8475225,Craig Smith,C,CHI,35,0,0,0,0
78,8479972,Mason Shaw,C,WPG,26,0,0,0,0
78,8478451,Ethan Bear,D,WSH,27,0,0,0,0
78,8474040,Sam Gagner,C,,35,0,0,0,0
78,8480196,Jacob Bryson,D,BUF,27,0,0,0,0
78,8479984,Cal Foote,D,,26,0,0,0,0
78,8480011,Klim Kostin,C,SJS,25,0,0,0,0
78,8482176,Wyatt Kaiser,D,CHI,22,0,0,0,0
78,8476988,Matt Benning,D,SJS,30,0,0,0,0
78,8479370,Tyson Jost,C,CAR,26,0,0,0,0
78,8477464,Nic Petan,C,,29,0,0,0,0
78,8477380,Jonny Brodzinski,C,NYR,31,0,0,0,0
78,8480070,Ian Mitchell,D,BOS,25,0,0,0,0
78,8479315,Joey Anderson,R,CHI,26,0,0,0,0
78,8478099,Kevin Labanc,R,,29,0,0,0,0
78,8476874,Olli Maatta,D,DET,30,0,0,0,0
78,8475208,Brian Dumoulin,D,ANA,33,0,0,0,0
78,8478430,Oliver Kylington,D,,27,0,0,0,0
78,8479536,Axel Jonsson-Fjallby,L,WPG,26,0,0,0,0
78,8479671,Mathieu Olivier,R,CBJ,27,0,0,0,0
78,8471709,Marc-Edouard Vlasic,D,SJS,37,0,0,0,0
78,8479328,Julien Gauthier,R,NYI,27,0,0,0,0
78,8478421,A.J. Greer,L,FLA,28,0,0,0,0
78,8477573,Nathan Walker,L,STL,30,0,0,0,0
78,8481537,Nikita Okhotiuk,D,CGY,24,0,0,0,0
78,8474166,Alec Martinez,D,CHI,37,0,0,0,0
78,8470610,Zach Parise,L,,40,0,0,0,0
78,8477478,William Carrier,L,CAR,30,0,0,0,0
78,8479344,Jesse Puljujarvi,R,PIT,26,0,0,0,0
78,8480887,Jordan Harris,D,MTL,24,0,0,0,0
78,8478502,Dennis Gilbert,D,BUF,28,0,0,0,0
78,8482730,Brandt Clarke,D,LAK,21,0,0,0,0
78,8480355,Mark Kastelic,C,BOS,25,0,0,0,0
78,8475750,Jon Merrill,D,MIN,32,0,0,0,0
78,8475164,Jakob Silfverberg,R,,34,0,0,0,0
78,8477944,Jakub Vrana,L,,28,0,0,0,0
78,8479439,Jacob MacDonald,D,COL,31,0,0,0,0
78,8474568,Luke Schenn,D,NSH,35,0,0,0,0
78,8478454,Noah Juulsen,D,VAN,27,0,0,0,0
78,8475752,Tyler Pitlick,C,,33,0,0,0,0
78,8482148,Hendrix Lapierre,C,WSH,22,0,0,0,0
78,8481167,Brayden Pachal,D,CGY,25,0,0,0,0
78,8478043,Sam Lafferty,C,BUF,29,0,0,0,0
78,8479321,Lucas Johansen,D,,27,0,0,0,0
78,8471699,Andrew Cogliano,C,,37,0,0,0,0
78,8481521,Ronnie Attard,D,PHI,25,0,0,0,0
78,8481161,Jake Christiansen,D,CBJ,25,0,0,0,0
78,8479458,Nikita Zaitsev,D,,33,0,0,0,0
78,8479619,Michael Carcone,L,UTA,28,0,0,0,0
78,8479026,Philippe Myers,D,TOR,27,0,0,0,0
78,8477330,Dominik Kubalik,L,,29,0,0,0,0
78,8481617,Vasily Podkolzin,R,VAN,23,0,0,0,0
78,8481701,Santeri Hatakka,D,NJD,23,0,0,0,0
78,8479514,Rem Pitlick,C,,27,0,0,0,0
78,8477446,Michael McCarron,R,NSH,29,0,0,0,0
78,8470604,Jeff Carter,C,,39,0,0,0,0
78,8482241,Radim Zohorna,L,,28,0,0,0,0
78,8480289,Morgan Barron,C,WPG,26,0,0,0,0
78,8479379,Givani Smith,R,SJS,26,0,0,0,0
78,8480216,Jacob Peterson,C,,25,0,0,0,0
78,8477851,Jordan Oesterle,D,BOS,32,0,0,0,0
78,8484258,Sam Malinski,D,COL,26,0,0,0,0
78,8478904,Steven Lorentz,C,,28,0,0,0,0
78,8482095,Tyler Kleven,D,OTT,22,0,0,0,0
78,8480848,Ty Dellandrea,C,SJS,24,0,0,0,0
78,8476884,Derrick Pouliot,D,,30,0,0,0,0
78,8479336,Carl Grundstrom,R,SJS,27,0,0,0,0
78,8482964,Arber Xhekaj,D,MTL,23,0,0,0,0
78,8471686,Marc Staal,D,,37,0,0,0,0
78,8477887,Patrick Brown,C,BOS,32,0,0,0,0
78,8478495,Denis Gurianov,R,,27,0,0,0,0
78,8473504,Cal Clutterbuck,R,,37,0,0,0,0
78,8481550,Adam Beckman,L,NJD,23,0,0,0,0
78,8480845,Rasmus Kupari,C,WPG,24,0,0,0,0
78,8474009,Nick Bonino,C,,36,0,0,0,0
78,8478585,Derek Ryan,C,EDM,38,0,0,0,0
78,8477962,Brendan Lemieux,L,CAR,28,0,0,0,0
78,8482861,Vincent Iorio,D,WSH,22,0,0,0,0
78,8479378,Logan Stanley,D,WPG,26,0,0,0,0
78,8473446,Erik Johnson,D,PHI,36,0,0,0,0
78,8481743,Marc Del Gaizo,D,NSH,25,0,0,0,0
78,8477384,Josh Brown,D,EDM,30,0,0,0,0
78,8482165,Yan Kuznetsov,D,CGY,22,0,0,0,0
78,8478424,Jansen Harkins,C,ANA,27,0,0,0,0
78,8482144,Jack Thompson,D,SJS,22,0,0,0,0
78,8478512,Austin Czarnik,C,,32,0,0,0,0
78,8477527,Ross Johnston,L,ANA,30,0,0,0,0
78,8479383,Boris Katchouk,L,,26,0,0,0,0
78,8482094,Daemon Hunt,D,MIN,22,0,0,0,0
78,8481719,Maxwell Crozier,D,TBL,24,0,0,0,0
78,8480192,Johnathan Kovacevic,D,NJD,27,0,0,0,0
78,8479376,Victor Mete,D,,26,0,0,0,0
78,8482511,Mason Lohrei,D,BOS,23,0,0,0,0
78,8475825,Jani Hakanpää,D,,32,0,0,0,0
78,8478021,William Lagesson,D,DET,28,0,0,0,0
78,8475795,Dylan McIlrath,D,WSH,32,0,0,0,0
78,8477846,Ryan Carpenter,C,,33,0,0,0,0
78,8481056,Spencer Stastney,D,NSH,24,0,0,0,0
78,8481564,Ryan Johnson,D,BUF,23,0,0,0,0
78,8478017,Mark Friedman,D,VAN,29,0,0,0,0
78,8479320,Max Lajoie,D,SEA,27,0,0,0,0
78,8480075,Cameron Crotty,D,MIN,25,0,0,0,0
78,8484287,Cole McWard,D,VAN,23,0,0,0,0
78,8484254,Akito Hirose,D,VAN,25,0,0,0,0
78,8483407,Brandon Scanlin,D,NYR,25,0,0,0,0
78,8480274,Philip Kemp,D,EDM,25,0,0,0,0
78,8479522,Hardy Haman Aktell,D,WSH,26,0,0,0,0
78,8480007,Jonas Rondbjerg,R,VGK,25,0,0,0,0
78,8477454,Adam Erne,L,,29,0,0,0,0
78,8481679,Maxence Guenette,D,OTT,23,0,0,0,0
78,8480441,Trey Fix-Wolansky,R,CBJ,25,0,0,0,0
78,8483546,Marshall Rifai,D,TOR,26,0,0,0,0
78,8480084,Nick DeSimone,D,NJD,30,0,0,0,0
78,8481030,Jack St. Ivany,D,PIT,25,0,0,0,0
78,8481592,Jakob Pelletier,L,CGY,23,0,0,0,0
78,8478011,Louie Belpedio,D,PHI,28,0,0,0,0
78,8477930,Pierre-Edouard Bellemare,L,,39,0,0,0,0
78,8484321,Nikolas Matinpalo,D,OTT,26,0,0,0,0
78,8482067,Connor Mackey,D,NYR,28,0,0,0,0
78,8481806,Louis Crevier,D,CHI,23,0,0,0,0
78,8484326,Patrik Koch,D,UTA,28,0,0,0,0
78,8477971,Andreas Englund,D,LAK,28,0,0,0,0
78,8481751,Lukas Rousek,R,BUF,25,0,0,0,0
78,8481006,Tyler Tucker,D,STL,24,0,0,0,0
78,8476867,Brendan Gaunce,C,MIN,30,0,0,0,0
78,8479520,Brandon Duhaime,R,WSH,27,0,0,0,0
78,8477073,Kurtis MacDermid,L,NJD,30,0,0,0,0
78,8480874,Adam Ginning,D,PHI,24,0,0,0,0
78,8477473,Justin Bailey,R,SJS,29,0,0,0,0
78,8479066,Ryan Lomberg,L,CGY,30,0,0,0,0
78,8477070,Liam O'Brien,C,UTA,30,0,0,0,0
78,8474618,Marco Scandella,D,,34,0,0,0,0
78,8475797,Jarred Tinordi,D,,32,0,0,0,0
78,8481441,Joe Snively,C,DET,28,0,0,0,0
78,8477244,Chad Ruhwedel,D,NYR,34,0,0,0,0
78,8479772,Zack MacEwen,R,OTT,28,0,0,0,0
78,8481147,Reese Johnson,C,MIN,26,0,0,0,0
78,8481043,Cole Koepke,L,BOS,26,0,0,0,0
78,8483619,Filip Roos,D,OTT,25,0,0,0,0
78,8481541,Samuel Bolduc,D,NYI,24,0,0,0,0
78,8477810,Joel Hanley,D,CGY,33,0,0,0,0
78,8476907,Mackenzie MacEachern,L,,30,0,0,0,0
78,8482652,Walker Duehr,R,CGY,27,0,0,0,0
78,8477126,Jayson Megna,C,,34,0,0,0,0
78,8483398,Declan Carlile,D,TBL,31,0,0,0,0
78,8482929,Emil Lilleberg,D,TBL,23,0,0,0,0
78,8480880,Jakub Lauko,C,MIN,24,0,0,0,0
78,8480245,Olle Lycksell,R,PHI,25,0,0,0,0
78,8480252,Cole Guttman,C,CHI,25,0,0,0,0
78,8477467,Gustav Olofsson,D,SEA,30,0,0,0,0
78,8479968,Vinni Lettieri,C,BOS,29,0,0,0,0
78,8478400,Colin White,C,,27,0,0,0,0
78,8475755,Alexander Petrovic,D,DAL,32,0,0,0,0
78,8481812,Nikolai Knyzhov,D,,27,0,0,0,0
78,8481593,Jayden Struble,D,MTL,23,0,0,0,0
78,8481532,Alex Turcotte,C,LAK,23,0,0,0,0
78,8482126,Emil Andrae,D,PHI,31,0,0,0,0
78,8479944,Zach Aston-Reese,C,VGK,30,0,0,0,0
78,8471817,Ryan Reaves,R,TOR,37,0,0,0,0
78,8481206,John Ludvig,D,PIT,24,0,0,0,0
78,8481599,Victor Soderstrom,D,UTA,23,0,0,0,0
78,8480292,Carson Meyer,R,ANA,27,0,0,0,0
78,8482496,Nils Aman,C,VAN,24,0,0,0,0
78,8479718,Alex Barré-Boulet,C,MTL,27,0,0,0,0
78,8479994,Jaret Anderson-Dolan,C,WPG,25,0,0,0,0
78,8480184,Gustav Lindstrom,D,,26,0,0,0,0
78,8480890,Jan Jenik,R,OTT,24,0,0,0,0
78,8478067,Oskar Lindblom,L,,28,0,0,0,0
78,8476934,Brock McGinn,L,ANA,30,0,0,0,0
78,8479985,Cale Fleury,D,SEA,26,0,0,0,0
78,8484304,Uvis Balinskis,D,FLA,28,0,0,0,0
78,8479981,Jonah Gadjovich,L,FLA,26,0,0,0,0
78,8481716,Dmitri Voronkov,L,CBJ,24,0,0,0,0
78,8474709,Matt Martin,L,,35,0,0,0,0
78,8482634,Alex Steeves,C,TOR,25,0,0,0,0
78,8480823,Alexander Alexeyev,D,WSH,25,0,0,0,0
78,8477541,Dakota Mermis,D,TOR,30,0,0,0,0
78,8483491,Ivan Miroshnichenko,L,WSH,20,0,0,0,0
78,8478477,Mitchell Stephens,C,SEA,27,0,0,0,0
78,8481543,Nikita Alexandrov,C,STL,24,0,0,0,0
78,8479423,Alex Nylander,L,,26,0,0,0,0
78,8482451,Mikael Pyyhtia,L,CBJ,23,0,0,0,0
78,8478831,Kevin Stenlund,C,UTA,28,0,0,0,0
78,8480306,Grant Hutton,D,NYI,29,0,0,0,0
78,8478028,Fredrik Olofsson,L,,28,0,0,0,0
78,8477462,Robert Hagg,D,VGK,29,0,0,0,0
78,8477320,Anton Blidh,L,NYR,29,0,0,0,0
78,8482157,Will Cuylle,L,NYR,22,0,0,0,0
78,8482737,Zack Bolduc,C,STL,21,0,0,0,0
78,8481239,Samuel Fagemo,L,,24,0,0,0,0
78,8481600,Tobias Bjornfot,D,FLA,23,0,0,0,0
78,8478409,Anthony Richard,C,PHI,28,0,0,0,0
78,8474145,Robert Bortuzzo,D,,35,0,0,0,0
78,8475958,Michael Sgarbossa,C,WSH,32,0,0,0,0
78,8479986,Kole Lind,R,DAL,26,0,0,0,0
78,8479249,Andrew Poturalski,C,SJS,30,0,0,0,0
78,8479362,Riley Tufte,L,BOS,26,0,0,0,0
78,8479991,Jake Leschyshyn,C,NYR,25,0,0,0,0
78,8479587,Rhett Gardner,C,PHI,28,0,0,0,0
78,8482744,James Malatesta,L,CBJ,21,0,0,0,0
78,8478854,Ryan Shea,D,PIT,27,0,0,0,0
78,8481591,Sam Poulin,R,,23,0,0,0,0
78,8483512,Matt Savoie,C,EDM,20,0,0,0,0
78,8482102,Vasily Ponomarev,C,PIT,22,0,0,0,0
78,8482162,Roby Jarventie,L,EDM,22,0,0,0,0
78,8481016,Ruslan Iskhakov,C,,24,0,0,0,0
78,8482172,Landon Slaggert,L,CHI,22,0,0,0,0
78,8482747,Brennan Othmann,L,NYR,21,0,0,0,0
78,8480031,Maxime Comtois,L,,25,0,0,0,0
78,8480226,Marián Studenic,R,,26,0,0,0,0
78,8478408,Travis Dermott,D,,28,0,0,0,0
78,8481518,Nolan Foote,L,NJD,24,0,0,0,0
78,8479419,Brett Murray,L,BUF,26,0,0,0,0
78,8482088,Justin Sourdif,R,FLA,22,0,0,0,0
78,8482201,Gage Goncalves,C,TBL,23,0,0,0,0
78,8481578,Graeme Clarke,R,MIN,23,0,0,0,0
78,8482177,Marat Khusnutdinov,C,MIN,22,0,0,0,0
78,8481754,Nikita Nesterenko,C,ANA,23,0,0,0,0
78,8483531,Brian Halonen,L,NJD,25,0,0,0,0
78,8483920,Pierrick Dube,R,WSH,23,0,0,0,0
78,8480851,Akil Thomas,C,LAK,24,0,0,0,0
78,8475235,Nicolas Deslauriers,L,PHI,33,0,0,0,0
78,8482476,Emil Heineman,L,MTL,23,0,0,0,0
78,8477149,Scott Sabourin,R,SJS,32,0,0,0,0
78,8483549,Lucas Condotta,L,MTL,27,0,0,0,0
78,8482765,Isak Rosen,R,BUF,21,0,0,0,0
78,8481237,Kyle MacLean,C,NYI,25,0,0,0,0
78,8481024,Linus Karlsson,C,VAN,25,0,0,0,0
78,8481690,Tyler Angle,C,,24,0,0,0,0
78,8483570,Ben Meyers,C,SEA,26,0,0,0,0
78,8481655,Cole Schwindt,R,CGY,23,0,0,0,0
78,8481462,Mason Morelli,L,VGK,28,0,0,0,0
78,8483401,Marc Johnstone,R,PIT,28,0,0,0,0
78,8478956,Samuel Laberge,L,NJD,27,0,0,0,0
78,8479533,Joona Koppanen,L,,26,0,0,0,0
78,8482197,Adam Raska,R,MIN,23,0,0,0,0
78,8482250,Callahan Burke,C,VGK,27,0,0,0,0
78,8482784,Zach Dean,C,STL,21,0,0,0,0
78,8484255,Jason Polin,R,COL,25,0,0,0,0
78,8481077,John Leonard,L,,26,0,0,0,0
78,8481534,Raphael Lavoie,C,EDM,24,0,0,0,0
78,8483609,Adam Klapka,R,CGY,24,0,0,0,0
78,8482751,Ryan Winterton,C,SEA,21,0,0,0,0
78,8480267,Sammy Walker,C,MIN,25,0,0,0,0
78,8475766,Austin Watson,L,,32,0,0,0,0
78,8482460,Matt Rempe,C,NYR,22,0,0,0,0
78,8481065,Angus Crookshank,L,OTT,25,0,0,0,0
78,8481070,Hugh McGing,L,,26,0,0,0,0
78,8476323,Max McCormick,L,SEA,32,0,0,0,0
78,8483395,Arshdeep Bains,L,VAN,23,0,0,0,0
78,8484259,Ondrej Pavel,C,COL,31,0,0,0,0
78,8483432,Luca Del Bel Belluz,C,CBJ,31,0,0,0,0
78,8483045,Cameron Butler,R,CBJ,31,0,0,0,0
78,8482061,Brandon Biro,L,SEA,26,0,0,0,0
78,8477401,John Hayden,C,SEA,29,0,0,0,0
78,8475278,Byron Froese,C,,33,0,0,0,0
78,8478446,Glenn Gawdin,C,LAK,27,0,0,0,0
78,8477993,Justin Kirkland,C,CGY,28,0,0,0,0
78,8482147,Jean-Luc Foudy,C,COL,22,0,0,0,0
78,8480032,Shane Bowers,C,NJD,25,0,0,0,0
78,8479330,Brandon Gignac,C,MTL,27,0,0,0,0
78,8480776,Sheldon Rempal,R,,29,0,0,0,0
78,8475413,Justin Dowling,C,NJD,34,0,0,0,0
78,8481726,Adam Edstrom,C,NYR,24,0,0,0,0
78,8480844,Grigori Denisenko,L,VGK,24,0,0,0,0
78,8478147,Bokondji Imama,L,PIT,28,0,0,0,0
78,8478881,Brett Seney,L,CHI,28,0,0,0,0
78,8483630,Pavol Regenda,L,ANA,25,0,0,0,0
78,8480836,Jonathan Gruden,C,,24,0,0,0,0
78,8484314,Jiri Smejkal,L,,28,0,0,0,0
78,8475780,Chris Wagner,R,COL,33,0,0,0,0
78,8479546,Oskar Steen,C,,26,0,0,0,0
78,8483597,Milos Kelemen,L,UTA,25,0,0,0,0
78,8481789,Tye Kartye,L,SEA,23,0,0,0,0
78,8484325,Waltteri Merela,C,TBL,26,0,0,0,0
78,8479421,Jacob Moverare,D,LAK,26,0,0,0,0
78,8481585,Egor Afanasyev,L,SJS,23,0,0,0,0
78,8479547,Matthew Phillips,R,,26,0,0,0,0
78,8479367,William Lockwood,R,FLA,26,0,0,0,0
78,8476915,Jujhar Khaira,L,,30,0,0,0,0
78,8481422,Jacob Lucchini,C,NSH,29,0,0,0,0
78,8480468,James Hamblin,L,EDM,25,0,0,0,0
78,8478051,Max Willman,C,NJD,29,0,0,0,0
78,8481556,John Beecher,C,BOS,23,0,0,0,0
78,8478078,Rourke Chartier,C,,28,0,0,0,0
79,8478402,Connor McDavid,C,EDM,27,82,48,101,149
79,8477492,Nathan MacKinnon,C,COL,29,82,45,80,125
79,8479314,Matthew Tkachuk,L,FLA,27,82,34,77,111
79,8476453,Nikita Kucherov,R,TBL,31,82,34,75,109
79,8478864,Kirill Kaprizov,L,MIN,27,82,48,60,108
79,8478550,Artemi Panarin,L,NYR,33,82,40,67,107
79,8477934,Leon Draisaitl,C,EDM,29,82,32,73,105
79,8477493,Aleksander Barkov,C,FLA,29,82,32,73,105
79,8477939,William Nylander,R,TOR,28,82,43,60,103
79,8476468,J.T. Miller,C,VAN,31,82,35,68,103
79,8481559,Jack Hughes,C,NJD,23,82,31,72,103
79,8477956,David Pastrnak,R,BOS,28,82,51,50,101
79,8477949,Alex Tuch,R,BUF,28,82,40,61,101
79,8480012,Elias Pettersson,C,VAN,26,82,35,66,101
79,8480027,Jason Robertson,L,DAL,25,82,34,63,97
79,8479318,Auston Matthews,C,TOR,27,82,57,39,96
79,8478420,Mikko Rantanen,R,COL,28,82,39,57,96
79,8480023,Robert Thomas,C,STL,25,82,29,67,96
79,8480800,Quinn Hughes,D,VAN,25,82,13,83,96
79,8475913,Mark Stone,R,VGK,32,82,31,64,95
79,8471675,Sidney Crosby,C,PIT,37,82,38,56,94
79,8480865,Noah Dobson,D,NYI,24,82,21,72,93
79,8477960,Adrian Kempe,R,LAK,28,82,41,49,90
79,8477933,Sam Reinhart,C,FLA,29,82,39,51,90
79,8478427,Sebastian Aho,C,CAR,27,82,37,53,90
79,8478398,Kyle Connor,L,WPG,28,82,37,53,90
79,8480002,Nico Hischier,C,NJD,25,82,35,54,89
79,8480801,Brady Tkachuk,L,OTT,25,82,33,56,89
79,8478445,Mathew Barzal,C,NYI,27,82,22,67,89
79,8479385,Jordan Kyrou,C,STL,26,82,34,54,88
79,8474600,Roman Josi,D,NSH,34,82,17,71,88
79,8482116,Tim Stützle,C,OTT,22,82,31,55,86
79,8476887,Filip Forsberg,L,NSH,30,82,42,43,85
79,8477409,Carter Verhaeghe,C,FLA,29,82,37,48,85
79,8480069,Cale Makar,D,COL,26,82,23,62,85
79,8480839,Rasmus Dahlin,D,BUF,24,82,23,62,85
79,8479343,Clayton Keller,R,UTA,26,82,46,37,83
79,8481557,Matt Boldy,L,MIN,23,82,33,50,83
79,8480018,Nick Suzuki,C,MTL,25,82,27,56,83
79,8476454,Ryan Nugent-Hopkins,C,EDM,31,82,20,63,83
79,8480036,Miro Heiskanen,D,DAL,25,82,19,64,83
79,8475810,Bryan Rust,R,PIT,32,82,49,33,82
79,8477946,Dylan Larkin,C,DET,28,82,41,41,82
79,8477942,Kevin Fiala,L,LAK,28,82,37,45,82
79,8477402,Pavel Buchnevich,L,STL,29,82,31,51,82
79,8476346,Johnny Gaudreau,L,CBJ,31,82,20,62,82
79,8481523,Kirby Dach,C,MTL,23,82,14,68,82
79,8475166,John Tavares,C,TOR,34,82,39,42,81
79,8477404,Jake Guentzel,C,TBL,30,82,37,44,81
79,8478444,Brock Boeser,R,VAN,27,82,32,49,81
79,8480830,Andrei Svechnikov,R,CAR,24,82,33,47,80
79,8479407,Jesper Bratt,L,NJD,26,82,30,50,80
79,8478010,Brayden Point,C,TBL,28,82,38,41,79
79,8476459,Mika Zibanejad,C,NYR,31,82,30,49,79
79,8474564,Steven Stamkos,C,NSH,34,82,34,44,78
79,8478042,Viktor Arvidsson,R,EDM,31,82,30,48,78
79,8479323,Adam Fox,D,NYR,26,82,13,65,78
79,8479339,Patrik Laine,L,CBJ,26,82,33,44,77
79,8473419,Brad Marchand,L,BOS,36,82,30,47,77
79,8475692,Mats Zuccarello,R,MIN,37,82,15,62,77
79,8477504,Josh Morrissey,D,WPG,29,82,13,64,77
79,8482093,Seth Jarvis,C,CAR,22,82,38,38,76
79,8476389,Vincent Trocheck,C,NYR,31,82,34,42,76
79,8477940,Nikolaj Ehlers,L,WPG,28,82,33,43,76
79,8471215,Evgeni Malkin,C,PIT,38,82,29,46,75
79,8476460,Mark Scheifele,C,WPG,31,82,28,47,75
79,8471685,Anze Kopitar,C,LAK,37,82,20,55,75
79,8479420,Tage Thompson,C,BUF,27,82,36,38,74
79,8481533,Trevor Zegras,C,ANA,23,82,26,48,74
79,8474578,Erik Karlsson,D,PIT,34,82,17,57,74
79,8471724,Kris Letang,D,PIT,37,82,14,60,74
79,8477447,Shea Theodore,D,VGK,29,82,13,61,74
79,8477986,Brandon Montour,D,SEA,30,82,29,44,73
79,8477496,Elias Lindholm,C,BOS,30,82,28,44,72
79,8482078,Lucas Raymond,L,DET,22,82,26,46,72
79,8477497,Sean Monahan,C,CBJ,30,82,25,47,72
79,8473994,Jamie Benn,L,DAL,35,82,22,50,72
79,8475786,Zach Hyman,L,EDM,32,82,37,34,71
79,8476539,Jonathan Marchessault,R,NSH,34,82,37,34,71
79,8471214,Alex Ovechkin,L,WSH,39,82,35,36,71
79,8475784,Jeff Skinner,C,EDM,32,82,31,40,71
79,8479542,Brandon Hagel,L,TBL,26,82,28,43,71
79,8481540,Cole Caufield,R,MTL,23,82,40,30,70
79,8478403,Jack Eichel,C,VGK,28,82,32,38,70
79,8478856,Conor Garland,R,VAN,28,82,37,32,69
79,8478414,Timo Meier,R,NJD,28,82,31,38,69
79,8478440,Dylan Strome,C,WSH,27,82,23,46,69
79,8478873,Troy Terry,R,ANA,27,82,23,46,69
79,8475184,Chris Kreider,L,NYR,33,82,44,24,68
79,8482745,Mason McTavish,C,ANA,21,82,32,36,68
79,8481528,Dylan Cozens,C,BUF,23,82,31,37,68
79,8474586,Jordan Eberle,R,SEA,34,82,30,38,68
79,8475172,Nazem Kadri,C,CGY,34,82,26,42,68
79,8479999,Casey Mittelstadt,C,COL,26,82,26,42,68
79,8477951,Nick Schmaltz,C,UTA,28,82,24,44,68
79,8478449,Roope Hintz,C,DAL,28,82,38,29,67
79,8479325,Charlie McAvoy,D,BOS,27,82,11,56,67
79,8476853,Morgan Rielly,D,TOR,30,82,10,57,67
79,8477500,Bo Horvat,C,NYI,29,82,35,31,66
79,8478493,Joel Eriksson Ek,C,MIN,27,82,33,33,66
79,8478439,Travis Konecny,R,PHI,27,82,32,34,66
79,8479675,Trevor Moore,L,LAK,29,82,28,38,66
79,8477416,Oliver Bjorkstrand,R,SEA,29,82,26,40,66
79,8478047,Michael Bunting,L,PIT,29,82,25,41,66
79,8476875,Mike Matheson,D,MTL,30,82,16,50,66
79,8475168,Matt Duchene,C,DAL,33,82,35,30,65
79,8477955,Jared McCann,L,SEA,28,82,32,33,65
79,8476881,Tomas Hertl,C,VGK,31,82,24,41,65
79,8475726,Tyler Toffoli,C,SJS,32,82,33,31,64
79,8476448,William Karlsson,C,VGK,31,82,30,34,64
79,8481596,Shane Pinto,C,OTT,24,82,25,39,64
79,8476456,Jonathan Huberdeau,C,CGY,31,82,14,50,64
79,8480208,Drake Batherson,R,OTT,26,82,25,38,63
79,8476462,Dougie Hamilton,D,NJD,31,82,20,43,63
79,8477501,Valeri Nichushkin,R,COL,29,82,35,27,62
79,8478233,Andrew Mangiapane,L,WSH,28,82,23,38,61
79,8473512,Claude Giroux,R,OTT,36,82,22,39,61
79,8480803,Evan Bouchard,D,EDM,25,82,11,50,61
79,8480014,Gabriel Vilardi,C,WPG,25,82,37,23,60
79,8480015,Owen Tippett,R,PHI,25,82,30,30,60
79,8480113,Alex Iafallo,L,WPG,31,82,28,32,60
79,8475170,Brayden Schenn,C,STL,33,82,20,40,60
79,8476882,Teuvo Teravainen,L,CHI,30,82,20,40,60
79,8478396,Noah Hanifin,D,VGK,27,82,17,43,60
79,8478460,Zach Werenski,D,CBJ,27,82,12,48,60
79,8480064,Josh Norris,C,OTT,25,82,29,30,59
79,8479410,Mikhail Sergachev,D,UTA,26,82,9,50,59
79,8481068,Yegor Sharangovich,C,CGY,26,82,28,30,58
79,8477476,Artturi Lehkonen,L,COL,29,82,27,31,58
79,8475158,Ryan O'Reilly,C,NSH,33,82,25,33,58
79,8480434,Sean Durzi,D,UTA,26,82,13,45,58
79,8475745,Charlie Coyle,C,BOS,32,82,27,30,57
79,8474141,Patrick Kane,R,DET,36,82,24,33,57
79,8475765,Vladimir Tarasenko,R,DET,33,82,20,37,57
79,8476479,Phillip Danault,C,LAK,31,82,13,44,57
79,8478407,Vince Dunn,D,SEA,28,82,5,52,57
79,8475754,Brock Nelson,C,NYI,33,82,28,28,56
79,8479992,Michael Rasmussen,C,DET,25,82,24,32,56
79,8482097,Jack Quinn,R,BUF,23,82,23,33,56
79,8480078,Filip Chytil,C,NYR,25,82,22,34,56
79,8474679,Gustav Nyquist,C,NSH,35,82,20,36,56
79,8482665,Matty Beniers,C,SEA,22,82,19,37,56
79,8478458,Jack Roslovic,C,CAR,27,82,19,37,56
79,8481581,Thomas Harley,D,DAL,23,82,19,37,56
79,8480028,Morgan Frost,C,PHI,25,82,18,38,56
79,8474565,Alex Pietrangelo,D,VGK,34,82,16,40,56
79,8477346,MacKenzie Weegar,D,CGY,30,82,16,40,56
79,8478366,Frank Vatrano,R,ANA,30,82,28,27,55
79,8476905,Chandler Stephenson,C,SEA,30,82,20,35,55
79,8481711,Matias Maccelli,L,UTA,24,82,13,42,55
79,8476483,Rickard Rakell,R,PIT,31,82,27,27,54
79,8474641,Adam Henrique,C,EDM,34,82,23,31,54
79,8474150,Mikael Backlund,C,CGY,35,82,17,37,54
79,8476880,Tom Wilson,R,WSH,30,82,30,23,53
79,8475169,Evander Kane,L,EDM,33,82,30,23,53
79,8475314,Anders Lee,L,NYI,34,82,29,24,53
79,8475151,Kyle Palmieri,C,NYI,33,82,26,27,53
79,8477479,Tyler Bertuzzi,L,CHI,29,82,24,29,53
79,8482110,Dawson Mercer,C,NJD,23,82,23,30,53
79,8484144,Connor Bedard,C,CHI,19,82,22,31,53
79,8478542,Evan Rodrigues,C,FLA,31,82,20,33,53
79,8474590,John Carlson,D,WSH,34,82,13,40,53
79,8478469,Thomas Chabot,D,OTT,27,82,11,42,53
79,8476399,Blake Coleman,C,CGY,33,82,28,24,52
79,8482149,Cole Perfetti,C,WPG,22,82,23,29,52
79,8480039,Martin Necas,C,CAR,25,82,22,30,52
79,8478975,Mason Marchment,L,DAL,29,82,22,30,52
79,8475287,Erik Haula,L,NJD,33,82,22,30,52
79,8477932,Aaron Ekblad,D,FLA,28,82,17,35,52
79,8477495,Seth Jones,D,CHI,30,82,14,38,52
79,8476906,Shayne Gostisbehere,D,CAR,31,82,13,39,52
79,8475167,Victor Hedman,D,TBL,34,82,4,48,52
79,8481618,Alex Newhook,C,MTL,23,82,20,31,51
79,8473986,Alex Killorn,L,ANA,35,82,19,32,51
79,8478038,Devon Toews,D,COL,30,82,18,33,51
79,8482055,Drew O'Connor,L,PIT,26,82,18,33,51
79,8475798,Mikael Granlund,C,SJS,32,82,13,38,51
79,8470613,Brent Burns,D,CAR,39,82,13,38,51
79,8482113,Anton Lundell,C,FLA,23,82,32,18,50
79,8480188,Fabian Zetterlund,L,SJS,25,82,23,27,50
79,8479337,Alex DeBrincat,R,DET,27,82,17,33,50
79,8475791,Taylor Hall,L,CHI,33,82,17,33,50
79,8478133,Jake Evans,C,MTL,28,82,16,34,50
79,8481542,Moritz Seider,D,DET,23,82,5,45,50
79,8482699,Dylan Guenther,R,UTA,21,82,30,19,49
79,8475794,Tyler Seguin,C,DAL,32,82,25,24,49
79,8482705,Cole Sillinger,C,CBJ,21,82,21,28,49
79,8478462,Nicolas Roy,C,VGK,27,82,20,29,49
79,8479400,Pierre-Luc Dubois,L,WSH,26,82,17,32,49
79,8475763,Kevin Hayes,R,PIT,32,82,14,35,49
79,8477935,Sam Bennett,C,FLA,28,82,28,20,48
79,8476432,Boone Jenner,C,CBJ,31,82,27,21,48
79,8482159,Tyson Foerster,R,PHI,22,82,25,23,48
79,8476885,Jacob Trouba,D,NYR,30,82,12,36,48
79,8482684,Luke Hughes,D,NJD,21,82,11,37,48
79,8477511,Anthony Mantha,R,CGY,30,82,26,21,47
79,8471698,T.J. Oshie,R,WSH,38,82,25,22,47
79,8475799,Nino Niederreiter,R,WPG,32,82,24,23,47
79,8478474,Lawson Crouse,L,UTA,27,82,23,24,47
79,8478519,Anthony Cirelli,C,TBL,27,82,22,25,47
79,8474189,Lars Eller,C,PIT,35,82,21,26,47
79,8479316,Luke Kunin,C,SJS,27,82,20,27,47
79,8477444,Andre Burakovsky,L,SEA,29,82,16,31,47
79,8476792,Torey Krug,D,STL,33,82,14,33,47
79,8481624,Ilya Mikheyev,R,CHI,30,82,14,33,47
79,8482124,Quinton Byfield,R,LAK,22,82,13,34,47
79,8478397,Rasmus Andersson,D,CGY,28,82,10,37,47
79,8475764,Cam Fowler,D,ANA,33,82,9,38,47
79,8479425,Filip Hronek,D,VAN,27,82,6,41,47
79,8482109,Alexis Lafrenière,L,NYR,23,82,25,21,46
79,8481560,Arthur Kaliyev,R,LAK,23,82,25,21,46
79,8478438,Tommy Novak,C,NSH,27,82,24,22,46
79,8474102,David Perron,L,OTT,36,82,21,25,46
79,8475191,Reilly Smith,R,NYR,33,82,20,26,46
79,8477964,Ivan Barbashev,C,VGK,29,82,20,26,46
79,8482105,Jake Sanderson,D,OTT,22,82,19,27,46
79,8480871,Adam Boqvist,D,FLA,24,82,15,31,46
79,8477021,Alex Kerfoot,C,UTA,30,82,11,35,46
79,8477015,Connor Brown,R,EDM,30,82,22,23,45
79,8476826,Yanni Gourde,C,SEA,33,82,20,25,45
79,8479365,Trent Frederic,C,BOS,26,82,20,25,45
79,8483808,Andrei Kuzmenko,L,CGY,28,82,17,28,45
79,8480798,Philipp Kurashev,C,CHI,25,82,17,28,45
79,8477456,J.T. Compher,L,DET,29,82,16,29,45
79,8478891,Mason Appleton,C,WPG,28,82,14,31,45
79,8477948,Travis Sanheim,D,PHI,28,82,13,32,45
79,8474716,Jared Spurgeon,D,MIN,35,82,9,36,45
79,8476958,Jaccob Slavin,D,CAR,30,82,8,37,45
79,8478498,Jake DeBrusk,L,VAN,28,82,26,18,44
79,8477407,Anthony Duclair,L,NYI,29,82,21,23,44
79,8475848,Brendan Gallagher,R,MTL,32,82,20,24,44
79,8480185,Eetu Luostarinen,C,FLA,26,82,14,30,44
79,8477451,Ryan Hartman,R,MIN,30,82,21,22,43
79,8477953,Kasperi Kapanen,R,STL,28,82,20,23,43
79,8475768,Jaden Schwartz,C,SEA,32,82,18,25,43
79,8480459,Pius Suter,C,VAN,28,82,17,26,43
79,8479345,Jakob Chychrun,D,WSH,26,82,16,27,43
79,8482667,William Eklund,L,SJS,22,82,14,29,43
79,8476329,Travis Boyd,C,MIN,31,82,13,30,43
79,8477494,Jonathan Drouin,L,COL,29,82,10,33,43
79,8478057,Dakota Joshua,C,VAN,28,82,24,18,42
79,8478401,Pavel Zacha,C,BOS,27,82,20,22,42
79,8478463,Anthony Beauvillier,L,PIT,27,82,17,25,42
79,8482660,Kent Johnson,C,CBJ,22,82,10,32,42
79,8479293,Brandon Tanev,L,SEA,33,82,20,21,41
79,8474053,Logan Couture,C,SJS,35,82,13,28,41
79,8476927,Teddy Blueger,C,VAN,30,82,13,28,41
79,8481604,Pavel Dorofeyev,L,VGK,24,82,22,18,40
79,8476469,Joel Armia,R,MTL,31,82,21,19,40
79,8482117,Lukas Reichel,L,CHI,22,82,19,21,40
79,8470621,Corey Perry,R,EDM,39,82,19,21,40
79,8475793,Ryan Johansen,C,PHI,32,82,19,21,40
79,8480797,Joel Farabee,L,PHI,24,82,18,22,40
79,8477429,Andrew Copp,C,DET,30,82,18,22,40
79,8476458,Ryan Strome,C,ANA,31,82,17,23,40
79,8475722,Jason Zucker,L,BUF,32,82,16,24,40
79,8474149,Evgenii Dadonov,R,DAL,35,82,15,25,40
79,8482671,Owen Power,D,BUF,22,82,11,29,40
79,8477503,Max Domi,C,TOR,29,82,10,30,40
79,8475753,Justin Faulk,D,STL,32,82,10,30,40
79,8476292,Ondrej Palat,L,NJD,33,82,6,34,40
79,8482740,Wyatt Johnston,C,DAL,21,82,19,20,39
79,8476474,Stefan Noesen,R,NJD,31,82,18,21,39
79,8478472,Mathieu Joseph,R,STL,27,82,13,26,39
79,8477498,Darnell Nurse,D,EDM,29,82,11,28,39
79,8480145,Neal Pionk,D,WPG,29,82,10,29,39
79,8474563,Drew Doughty,D,LAK,35,82,9,30,39
79,8482087,Kaiden Guhle,D,MTL,22,82,6,33,39
79,8482089,Jake Neighbours,L,STL,22,82,24,14,38
79,8479941,Justin Danforth,R,CBJ,31,82,24,14,38
79,8475760,Nick Bjugstad,C,UTA,32,82,20,18,38
79,8477987,Ryan Donato,C,CHI,28,82,19,19,38
79,8480849,Barrett Hayton,C,UTA,24,82,18,20,38
79,8484145,Zach Benson,L,BUF,19,82,16,22,38
79,8480802,Ryan McLeod,C,BUF,25,82,15,23,38
79,8481546,Cam York,D,PHI,23,82,7,31,38
79,8481535,Nils Hoglander,L,VAN,24,82,25,12,37
79,8475193,Tomas Tatar,L,NJD,34,82,20,17,37
79,8473563,Nicklas Backstrom,C,WSH,37,82,16,21,37
79,8473422,Nick Foligno,L,CHI,37,82,13,24,37
79,8478055,Gustav Forsling,D,FLA,28,82,13,24,37
79,8476438,Brandon Saad,L,STL,32,82,24,12,36
79,8478046,Danton Heinen,L,VAN,29,82,23,13,36
79,8477426,Nicholas Paul,L,TBL,29,82,22,14,36
79,8480009,Eeli Tolvanen,R,SEA,25,82,21,15,36
79,8479987,Morgan Geekie,C,BOS,26,82,19,17,36
79,8476960,Andreas Athanasiou,C,CHI,30,82,17,19,36
79,8478115,Pierre Engvall,L,NYI,28,82,16,20,36
79,8479525,Ross Colton,C,COL,28,82,14,22,36
79,8481704,Juuso Parssinen,C,NSH,23,82,13,23,36
79,8481553,Bobby Brink,R,PHI,23,82,13,23,36
79,8476921,Jordan Martinook,L,CAR,32,82,11,25,36
79,8476419,Jean-Gabriel Pageau,C,NYI,32,82,10,26,36
79,8479402,Jake Bean,D,CGY,26,82,5,31,36
79,8476854,Hampus Lindholm,D,BOS,30,82,4,32,36
79,8480893,Kirill Marchenko,R,CBJ,24,82,16,19,35
79,8480835,Jack Drury,C,CAR,24,82,12,23,35
79,8478413,Jordan Greenway,L,BUF,27,82,9,26,35
79,8481606,Jordan Spence,D,LAK,23,82,7,28,35
79,8478851,Alexandre Carrier,D,NSH,28,82,7,28,35
79,8477969,Marcus Pettersson,D,PIT,28,82,3,32,35
79,8477998,Warren Foegele,L,LAK,28,82,20,14,34
79,8479368,Max Jones,L,BOS,26,82,13,21,34
79,8480789,Oliver Wahlstrom,R,NYI,24,82,12,22,34
79,8482142,Jamie Drysdale,D,PHI,22,82,8,26,34
79,8482122,Brock Faber,D,MIN,22,82,7,27,34
79,8481014,Alexander Romanov,D,NYI,24,82,7,27,34
79,8475855,Jesper Fast,R,CAR,33,82,18,15,33
79,8481580,Connor McMichael,C,WSH,23,82,17,16,33
79,8482475,Yegor Chinakhov,R,CBJ,23,82,16,17,33
79,8481186,Logan O'Connor,R,COL,28,82,16,17,33
79,8478109,Victor Olofsson,L,VGK,29,82,16,17,33
79,8477952,Robby Fabbri,C,ANA,28,82,16,17,33
79,8482092,Ridly Greig,C,OTT,22,82,14,19,33
79,8482133,Thomas Bordeleau,C,SJS,22,82,14,19,33
79,8478569,Noel Acciari,C,PIT,33,82,14,19,33
79,8484203,Bradly Nadeau,L,CAR,19,82,14,19,33
79,8473533,Jordan Staal,C,CAR,36,82,13,20,33
79,8479996,Cody Glass,C,NSH,25,82,13,20,33
79,8481656,Aliaksei Protas,C,WSH,23,82,11,22,33
79,8476897,Oskar Sundqvist,C,STL,30,82,11,22,33
79,8476872,Scott Laughton,C,PHI,30,82,9,24,33
79,8476979,Erik Gustafsson,D,DET,32,82,7,26,33
79,8478500,Ivan Provorov,D,CBJ,27,82,4,29,33
79,8479371,Dante Fabbro,D,NSH,26,82,3,30,33
79,8475714,Calle Jarnkrok,C,TOR,33,82,18,14,32
79,8477450,Jason Dickinson,C,CHI,29,82,17,15,32
79,8476981,Josh Anderson,R,MTL,30,82,16,16,32
79,8475220,Marcus Foligno,L,MIN,33,82,16,16,32
79,8476918,Jimmy Vesey,L,NYR,31,82,16,16,32
79,8474715,Cam Atkinson,R,TBL,35,82,15,17,32
79,8481554,Kaapo Kakko,R,NYR,23,82,15,17,32
79,8482146,Luke Evangelista,R,NSH,22,82,11,21,32
79,8482720,Matthew Knies,L,TOR,22,82,11,21,32
79,8482074,Connor Zary,C,CGY,23,82,11,21,32
79,8476923,Damon Severson,D,CBJ,30,82,9,23,32
79,8475171,Oliver Ekman-Larsson,D,TOR,33,82,8,24,32
79,8483457,Lane Hutson,D,MTL,20,82,8,24,32
79,8476917,Adam Pelech,D,NYI,30,82,8,24,32
79,8474574,Tyler Myers,D,VAN,34,82,8,24,32
79,8478911,Matt Roy,D,WSH,29,82,5,27,32
79,8476392,Adam Lowry,C,WPG,31,82,16,15,31
79,8477989,Christian Dvorak,C,MTL,28,82,16,15,31
79,8481582,Nicholas Robertson,L,TOR,23,82,16,15,31
79,8480855,Jack McBain,C,UTA,24,82,14,17,31
79,8476461,Sean Couturier,C,PHI,32,82,11,20,31
79,8480817,K'Andre Miller,D,NYR,24,82,6,25,31
79,8480873,Rasmus Sandin,D,WSH,24,82,5,26,31
79,8476331,Dylan DeMelo,D,WPG,31,82,5,26,31
79,8476931,Jake McCabe,D,TOR,31,82,3,28,31
79,8478508,Yakov Trenin,C,MIN,27,82,21,9,30
79,8482175,JJ Peterka,R,BUF,22,82,19,11,30
79,8481601,Simon Holmstrom,R,NYI,23,82,17,13,30
79,8482659,Josh Doan,R,UTA,22,82,17,13,30
79,8476869,Brady Skjei,D,NSH,30,82,12,18,30
79,8480336,Sean Walker,D,CAR,30,82,10,20,30
79,8477839,Conor Sheary,L,TBL,32,82,8,22,30
79,8477369,Carson Soucy,D,VAN,30,82,5,25,30
79,8479398,Samuel Girard,D,COL,26,82,3,27,30
79,8481013,Jonatan Berggren,R,DET,24,82,16,13,29
79,8482259,Bobby McMann,C,TOR,28,82,15,14,29
79,8477919,Frederick Gaudreau,C,MIN,31,82,14,15,29
79,8480068,Ryan Poehling,C,PHI,25,82,13,16,29
79,8476480,Vladislav Namestnikov,C,WPG,32,82,13,16,29
79,8480829,Jesperi Kotkaniemi,C,CAR,24,82,12,17,29
79,8480220,Noah Cates,L,PHI,25,82,12,17,29
79,8483515,Juraj Slafkovsky,L,MTL,20,82,11,18,29
79,8477947,Sonny Milano,L,WSH,28,82,7,22,29
79,8480035,Henri Jokiharju,D,BUF,25,82,3,26,29
79,8474673,TJ Brodie,D,CHI,34,82,2,27,29
79,8482125,Alexander Holtz,R,VGK,22,82,18,10,28
79,8476925,Colton Sissons,C,NSH,31,82,15,13,28
79,8479591,Michael Eyssimont,C,TBL,28,82,15,13,28
79,8480748,Kiefer Sherwood,L,VAN,29,82,14,14,28
79,8475343,Nic Dowd,C,WSH,34,82,14,14,28
79,8484166,Adam Fantilli,C,CBJ,20,82,13,15,28
79,8480980,Connor Dewar,C,TOR,25,82,12,16,28
79,8476442,Matt Nieto,L,PIT,32,82,12,16,28
79,8482079,Marco Rossi,C,MIN,23,82,11,17,28
79,8482111,Justin Barron,D,MTL,23,82,9,19,28
79,8480878,Nils Lundkvist,D,DAL,24,82,7,21,28
79,8475218,Mattias Ekholm,D,EDM,34,82,6,22,28
79,8482655,J.J. Moser,D,TBL,24,82,6,22,28
79,8476312,Josh Manson,D,COL,33,82,5,23,28
79,8478416,Erik Cernak,D,TBL,27,82,5,23,28
79,8475455,Brenden Dillon,D,NJD,34,82,5,23,28
79,8478882,Vladislav Gavrikov,D,LAK,29,82,4,24,28
79,8481517,Brett Leason,R,ANA,25,82,15,12,27
79,8483431,Logan Cooley,C,UTA,20,82,14,13,27
79,8480995,Pontus Holmberg,R,TOR,25,82,13,14,27
79,8480813,Joe Veleno,C,DET,24,82,13,14,27
79,8482624,Daniil Miromanov,D,CGY,27,82,13,14,27
79,8478432,Christian Fischer,R,DET,27,82,13,14,27
79,8480074,Alexandre Texier,C,STL,25,82,12,15,27
79,8475149,Marcus Johansson,L,MIN,34,82,10,17,27
79,8476889,Radek Faksa,C,STL,30,82,10,17,27
79,8479353,Brett Howden,C,VGK,26,82,9,18,27
79,8480806,Isac Lundestrom,C,ANA,25,82,9,18,27
79,8477506,Ryan Pulock,D,NYI,30,82,7,20,27
79,8484153,Leo Carlsson,C,ANA,20,82,7,20,27
79,8480144,David Kampf,C,TOR,29,82,7,20,27
79,8477488,Brett Pesce,D,NJD,30,82,6,21,27
79,8476467,Jamie Oleksiak,D,SEA,32,82,5,22,27
79,8475200,Dmitry Orlov,D,CAR,33,82,4,23,27
79,8476892,Colton Parayko,D,STL,31,82,4,23,27
79,8478507,John Marino,D,UTA,27,82,4,23,27
79,8483565,Nick Blankenburg,D,NSH,26,82,4,23,27
79,8476891,Matt Grzelcyk,D,PIT,30,82,2,25,27
79,8478840,Will Borgen,D,SEA,28,82,2,25,27
79,8478020,Michael Amadio,C,OTT,28,82,18,8,26
79,8473453,Trevor Lewis,C,LAK,37,82,14,12,26
79,8479369,Andrew Peeke,D,BOS,26,82,5,21,26
79,8474151,Ryan McDonagh,D,TBL,35,82,4,22,26
79,8476902,Esa Lindell,D,DAL,30,82,3,23,26
79,8479393,Noah Gregor,C,OTT,26,82,14,11,25
79,8482166,Shakir Mukhamadullin,D,SJS,22,82,12,13,25
79,8481477,Nico Sturm,C,SJS,29,82,11,14,25
79,8477507,Nikita Zadorov,D,BOS,29,82,9,16,25
79,8476278,Colin Blackwell,C,DAL,31,82,7,18,25
79,8479976,Juuso Valimaki,D,UTA,26,82,6,19,25
79,8481708,Zac Jones,D,NYR,24,82,6,19,25
79,8480222,Sebastian Aho,D,PIT,28,82,5,20,25
79,8482245,Artem Zub,D,OTT,29,82,5,20,25
79,8482073,Braden Schneider,D,NYR,23,82,2,23,25
79,8480049,Dylan Samberg,D,WPG,25,82,1,24,25
79,8481093,Rafael Harvey-Pinard,L,MTL,25,82,15,9,24
79,8479414,Nathan Bastian,R,NJD,27,82,13,11,24
79,8482077,Dylan Holloway,L,EDM,23,82,13,11,24
79,8477903,Garnet Hathaway,R,PHI,33,82,8,16,24
79,8477931,Tomas Nosek,L,FLA,32,82,7,17,24
79,8480003,Jesper Boqvist,C,FLA,26,82,7,17,24
79,8478178,Darren Raddysh,D,TBL,28,82,7,17,24
79,8475231,Casey Cizikas,C,NYI,33,82,6,18,24
79,8475188,Brayden McNabb,D,VGK,33,82,6,18,24
79,8479983,Mario Ferraro,D,SJS,26,82,4,20,24
79,8475181,Nick Leddy,D,STL,33,82,4,20,24
79,8479324,Ryan Lindgren,D,NYR,26,82,4,20,24
79,8476463,Jonas Brodin,D,MIN,31,82,3,21,24
79,8473507,Jeff Petry,D,DET,37,82,3,21,24
79,8482155,Alex Laferriere,R,LAK,23,82,19,4,23
79,8480281,Alexey Toropchenko,R,STL,25,82,13,10,23
79,8481481,Blake Lizotte,C,PIT,27,82,12,11,23
79,8482809,Jackson Blake,R,CAR,21,82,11,12,23
79,8477392,Hudson Fasching,R,NYI,29,82,11,12,23
79,8482702,Logan Stankoven,C,DAL,21,82,10,13,23
79,8479390,Taylor Raddysh,R,WSH,26,82,10,13,23
79,8483763,Maksymilian Szuber,D,UTA,22,82,10,13,23
79,8479661,Tanner Jeannot,L,LAK,27,82,9,14,23
79,8478013,Jake Walman,D,SJS,28,82,7,16,23
79,8480834,Ty Emberson,D,SJS,24,82,7,16,23
79,8481568,Alex Vlasic,D,CHI,23,82,6,17,23
79,8475279,Ben Chiarot,D,DET,33,82,5,18,23
79,8477220,Nate Schmidt,D,FLA,33,82,3,20,23
79,8476525,Colin Miller,D,WPG,32,82,1,22,23
79,8481032,Paul Cotter,C,NJD,25,82,14,8,22
79,8481641,Joel Kiviranta,L,COL,28,82,13,9,22
79,8481028,Martin Pospisil,C,CGY,25,82,12,10,22
79,8477406,Mattias Janmark,C,EDM,32,82,11,11,22
79,8475842,Sam Carrick,C,NYR,32,82,9,13,22
79,8484911,Collin Graf,R,SJS,22,82,9,13,22
79,8481522,Peyton Krebs,C,BUF,23,82,8,14,22
79,8480025,MacKenzie Entwistle,R,FLA,25,82,8,14,22
79,8476624,Barclay Goodrow,C,SJS,31,82,8,14,22
79,8481524,Bowen Byram,D,BUF,23,82,7,15,22
79,8480021,Jack Studnicka,C,LAK,25,82,7,15,22
79,8483490,Pavel Mintyukov,D,ANA,21,82,6,16,22
79,8483445,Cutter Gauthier,L,ANA,20,82,6,16,22
79,8480860,Kevin Bahl,D,CGY,24,82,5,17,22
79,8476457,Adam Larsson,D,SEA,32,82,5,17,22
79,8476967,Brett Kulak,D,EDM,30,82,5,17,22
79,8476879,Cody Ceci,D,EDM,31,82,4,18,22
79,8474013,Ian Cole,D,UTA,35,82,3,19,22
79,8477425,Miles Wood,L,COL,29,82,14,7,21
79,8479291,Kevin Rooney,C,CGY,31,82,11,10,21
79,8476374,Sean Kuraly,C,CBJ,31,82,10,11,21
79,8482749,Joshua Roy,R,MTL,21,82,9,12,21
79,8479351,Sam Steel,C,DAL,26,82,6,15,21
79,8483466,Kevin Korchinski,D,CHI,20,82,6,15,21
79,8482803,Olen Zellweger,D,ANA,21,82,5,16,21
79,8481567,Henry Thrun,D,SJS,23,82,4,17,21
79,8480172,Jan Rutta,D,SJS,34,82,4,17,21
79,8475690,Chris Tanev,D,TOR,35,82,1,20,21
79,8482807,Ethan Del Mastro,D,CHI,21,82,10,10,20
79,8476873,Mark Jankowski,C,NSH,30,82,8,12,20
79,8482666,Scott Morrow,D,CAR,22,82,7,13,20
79,8477499,Rasmus Ristolainen,D,PHI,30,82,5,15,20
79,8477845,Trevor van Riemsdyk,D,WSH,33,82,5,15,20
79,8478434,Keegan Kolesar,R,VGK,27,82,5,15,20
79,8483505,Matthew Poitras,C,BOS,20,82,4,16,20
79,8481178,Egor Zamula,D,PHI,24,82,3,17,20
79,8480796,Martin Fehervary,D,WSH,25,82,3,17,20
79,8476878,Zemgus Girgensons,L,TBL,30,82,12,7,19
79,8484149,Gavin Brindley,C,CBJ,20,82,8,11,19
79,8480448,Parker Kelly,L,COL,25,82,8,11,19
79,8482762,Simon Edvinsson,D,DET,21,82,8,11,19
79,8482733,Logan Mailloux,D,MTL,31,82,8,11,19
79,8482062,Cole Smith,L,NSH,29,82,7,12,19
79,8478211,Dryden Hunt,L,CGY,29,82,6,13,19
79,8475718,Justin Holl,D,DET,32,82,6,13,19
79,8483482,Tristan Luneau,D,ANA,20,82,4,15,19
79,8478399,Jonas Siegenthaler,D,NJD,27,82,4,15,19
79,8480807,Mattias Samuelsson,D,BUF,24,82,4,15,19
79,8477938,Haydn Fleury,D,WPG,28,82,4,15,19
79,8480043,Timothy Liljegren,D,TOR,25,82,2,17,19
79,8477508,Curtis Lazar,C,NJD,29,82,10,8,18
79,8483397,Marc McLaughlin,C,BOS,25,82,10,8,18
79,8476422,Mike Reilly,D,NYI,31,82,7,11,18
79,8476858,Phillip Di Giuseppe,L,VAN,31,82,7,11,18
79,8480990,Declan Chisholm,D,MIN,24,82,7,11,18
79,8483468,Jiri Kulich,C,BUF,20,82,6,12,18
79,8480073,Erik Brannstrom,D,COL,25,82,5,13,18
79,8476429,Scott Mayfield,D,NYI,32,82,3,15,18
79,8479998,Mikey Anderson,D,LAK,25,82,3,15,18
79,8475762,Derek Forbort,D,VAN,32,82,3,15,18
79,8482679,Matt Coronato,R,CGY,22,82,7,10,17
79,8482141,Lukas Cormier,D,VGK,22,82,6,11,17
79,8479980,Nicolas Hague,D,VGK,26,82,6,11,17
79,8477034,Jaycob Megna,D,FLA,32,82,6,11,17
79,8477365,Connor Clifton,D,BUF,29,82,3,14,17
79,8475233,David Savard,D,MTL,34,82,3,14,17
79,8479442,Troy Stecher,D,EDM,30,82,8,8,16
79,8482858,Ryker Evans,D,SEA,23,82,6,10,16
79,8480870,Bo Groulx,C,NYR,24,82,5,11,16
79,8478443,Brandon Carlo,D,BOS,28,82,3,13,16
79,8482713,Mackie Samoskevich,R,FLA,22,82,3,13,16
79,8479576,Vincent Desharnais,D,VAN,28,82,2,14,16
79,8476441,Joel Edmundson,D,LAK,31,82,0,16,16
79,8477353,Tyler Motte,C,DET,29,82,7,8,15
79,8477335,Kyle Burroughs,D,LAK,29,82,5,10,15
79,8476473,Connor Murphy,D,CHI,31,82,5,10,15
79,8483012,Logan Morrison,C,SEA,22,82,4,11,15
79,8478136,Jake Middleton,D,MIN,28,82,2,13,15
79,8475324,Nick Jensen,D,OTT,34,82,2,13,15
79,8475462,Radko Gudas,D,ANA,34,82,2,13,15
79,8481699,Aku Raty,R,UTA,23,82,7,7,14
79,8479359,Beck Malenstyn,L,BUF,26,82,4,10,14
79,8478450,Parker Wotherspoon,D,BOS,27,82,4,10,14
79,8480950,Ilya Lyubushkin,D,DAL,30,82,3,11,14
79,8478468,Jeremy Lauzon,D,NSH,27,82,3,11,14
79,8482153,Brendan Brisson,C,VGK,23,82,3,11,14
79,8475790,Erik Gudbranson,D,CBJ,32,82,2,12,14
79,8477435,Ryan Graves,D,PIT,29,82,2,12,14
79,8479638,Justin Brazeau,R,BOS,26,82,7,6,13
79,8483524,Shane Wright,C,SEA,20,82,6,7,13
79,8481605,Jackson LaCombe,D,ANA,23,82,4,9,13
79,8474090,Brendan Smith,D,DAL,35,82,4,9,13
79,8480879,Jacob Bernard-Docker,D,OTT,24,82,2,11,13
79,8481122,Simon Benoit,D,TOR,26,82,1,12,13
79,8480246,Nick Perbix,D,TBL,26,82,0,13,13
79,8483499,Liam Ohgren,L,MIN,20,82,6,6,12
79,8482145,Mavrik Bourque,C,DAL,22,82,6,6,12
79,8482470,Ilya Solovyov,D,CGY,24,82,5,7,12
79,8482516,Matthew Kessel,D,STL,24,82,4,8,12
79,8478859,Niko Mikkola,D,FLA,28,82,4,8,12
79,8476372,Nick Seeler,D,PHI,31,82,2,10,12
79,8475177,Calvin de Haan,D,COL,33,82,2,10,12
79,8476822,Luke Glendening,C,TBL,35,82,8,3,11
79,8483471,Brad Lambert,C,WPG,31,82,5,6,11
79,8474567,Zach Bogosian,D,MIN,34,82,0,11,11
79,8477505,Alexander Wennberg,C,SJS,30,82,7,3,10
79,8482101,Danil Gushchin,L,SJS,22,82,5,5,10
79,8482712,Oskar Olausson,R,COL,22,82,4,6,10
79,8483460,David Jiricek,D,CBJ,21,82,3,7,10
79,8470600,Ryan Suter,D,STL,39,82,2,8,10
79,8483495,Simon Nemec,D,NJD,20,82,1,9,10
79,8474612,Travis Hamonic,D,OTT,34,82,1,9,10
79,8483493,Frank Nazar,C,CHI,20,82,5,4,9
79,8482070,Mitchell Chaffee,R,TBL,26,82,4,5,9
79,8482859,Zack Ostapchuk,C,OTT,21,82,2,7,9
79,8478874,Adam Gaudette,C,OTT,28,82,2,7,9
79,8482118,Sam Colangelo,R,ANA,23,82,4,3,7
79,8482787,Nikita Chibrikov,R,WPG,31,82,3,4,7
79,8483489,Fraser Minten,C,TOR,31,82,3,4,7
79,8474062,Riley Nash,C,NYR,35,82,2,5,7
79,8483567,Georgii Merkulov,C,BOS,24,82,1,6,7
79,8471677,Jack Johnson,D,CBJ,37,82,0,5,5
79,8470794,Joe Pavelski,C,,40,0,0,0,0
79,8481703,Valtteri Puustinen,R,PIT,25,0,0,0,0
79,8477950,Tony DeAngelo,D,,29,0,0,0,0
79,8481577,Philip Tomasino,C,NSH,23,0,0,0,0
79,8475197,Tyson Barrie,D,,33,0,0,0,0
79,8471218,Blake Wheeler,R,,38,0,0,0,0
79,8474157,Max Pacioretty,L,,36,0,0,0,0
79,8478466,Daniel Sprong,R,VAN,27,0,0,0,0
79,8475744,Evgeny Kuznetsov,C,,32,0,0,0,0
79,8481019,David Gustafsson,C,WPG,24,0,0,0,0
79,8475906,John Klingberg,D,,32,0,0,0,0
79,8479348,Kale Clague,D,BUF,26,0,0,0,0
79,8476952,Dominic Toninato,C,WPG,30,0,0,0,0
79,8473473,Milan Lucic,L,,36,0,0,0,0
79,8474037,James van Riemsdyk,L,,35,0,0,0,0
79,8474602,Justin Schultz,D,,34,0,0,0,0
79,8482222,Alexander Barabanov,L,,30,0,0,0,0
79,8479372,Josh Mahura,D,SEA,26,0,0,0,0
79,8479982,Conor Timmins,D,TOR,26,0,0,0,0
79,8474031,Kevin Shattenkirk,D,,35,0,0,0,0
79,8480008,Adam Ruzicka,C,,25,0,0,0,0
79,8481059,Scott Perunovich,D,STL,26,0,0,0,0
79,8480884,Calen Addison,D,,24,0,0,0,0
79,8476994,Vinnie Hinostroza,C,NSH,30,0,0,0,0
79,8478452,Caleb Jones,D,LAK,27,0,0,0,0
79,8480157,Calle Rosen,D,COL,30,0,0,0,0
79,8481609,Vladislav Kolyachonok,D,UTA,23,0,0,0,0
79,8479415,Michael McLeod,C,,26,0,0,0,0
79,8476919,Chris Tierney,C,,30,0,0,0,0
79,8479639,Dylan Coghlan,D,WPG,26,0,0,0,0
79,8478146,Matthew Highmore,C,OTT,28,0,0,0,0
79,8478970,Jalen Chatfield,D,CAR,28,0,0,0,0
79,8480205,Emil Bemstrom,C,PIT,25,0,0,0,0
79,8474884,Mike Hoffman,C,,35,0,0,0,0
79,8471274,Alex Goligoski,D,,39,0,0,0,0
79,8478104,Sammy Blais,L,,28,0,0,0,0
79,8474870,Tyler Johnson,C,,34,0,0,0,0
79,8476913,Devin Shore,C,MIN,30,0,0,0,0
79,8481598,Philip Broberg,D,EDM,23,0,0,0,0
79,8480058,Pierre-Olivier Joseph,D,STL,25,0,0,0,0
79,8480891,Michael Kesselring,D,UTA,24,0,0,0,0
79,8477979,Nicolas Aube-Kubel,R,BUF,28,0,0,0,0
79,8476871,Tanner Pearson,L,,32,0,0,0,0
79,8476393,Nick Cousins,C,,31,0,0,0,0
79,8479977,Kailer Yamamoto,R,,26,0,0,0,0
79,8479543,Michael Pezzetta,L,MTL,26,0,0,0,0
79,8477018,Ben Hutton,D,VGK,31,0,0,0,0
79,8480762,Eric Robinson,L,CAR,29,0,0,0,0
79,8474034,Pat Maroon,L,CHI,36,0,0,0,0
79,8481058,Jesse Ylönen,R,,25,0,0,0,0
79,8475179,Dmitry Kulikov,D,FLA,34,0,0,0,0
79,8481527,Kaedan Korczak,D,VGK,23,0,0,0,0
79,8473449,Kyle Okposo,R,,36,0,0,0,0
79,8482192,Isaak Phillips,D,CHI,23,0,0,0,0
79,8480727,Zach Whitecloud,D,VGK,28,0,0,0,0
79,8479346,Dillon Dube,C,,26,0,0,0,0
79,8480821,Filip Zadina,R,,25,0,0,0,0
79,8480001,Urho Vaakanainen,D,ANA,25,0,0,0,0
79,8470966,Mark Giordano,D,,41,0,0,0,0
79,8480853,Liam Foudy,C,,24,0,0,0,0
79,8475225,Craig Smith,C,CHI,35,0,0,0,0
79,8479972,Mason Shaw,C,WPG,26,0,0,0,0
79,8478451,Ethan Bear,D,WSH,27,0,0,0,0
79,8474040,Sam Gagner,C,,35,0,0,0,0
79,8480196,Jacob Bryson,D,BUF,27,0,0,0,0
79,8479984,Cal Foote,D,,26,0,0,0,0
79,8480011,Klim Kostin,C,SJS,25,0,0,0,0
79,8482176,Wyatt Kaiser,D,CHI,22,0,0,0,0
79,8476988,Matt Benning,D,SJS,30,0,0,0,0
79,8479370,Tyson Jost,C,CAR,26,0,0,0,0
79,8477464,Nic Petan,C,,29,0,0,0,0
79,8477380,Jonny Brodzinski,C,NYR,31,0,0,0,0
79,8480070,Ian Mitchell,D,BOS,25,0,0,0,0
79,8479315,Joey Anderson,R,CHI,26,0,0,0,0
79,8478099,Kevin Labanc,R,,29,0,0,0,0
79,8476874,Olli Maatta,D,DET,30,0,0,0,0
79,8475208,Brian Dumoulin,D,ANA,33,0,0,0,0
79,8478430,Oliver Kylington,D,,27,0,0,0,0
79,8479536,Axel Jonsson-Fjallby,L,WPG,26,0,0,0,0
79,8479671,Mathieu Olivier,R,CBJ,27,0,0,0,0
79,8471709,Marc-Edouard Vlasic,D,SJS,37,0,0,0,0
79,8479328,Julien Gauthier,R,NYI,27,0,0,0,0
79,8478421,A.J. Greer,L,FLA,28,0,0,0,0
79,8477573,Nathan Walker,L,STL,30,0,0,0,0
79,8481537,Nikita Okhotiuk,D,CGY,24,0,0,0,0
79,8474166,Alec Martinez,D,CHI,37,0,0,0,0
79,8470610,Zach Parise,L,,40,0,0,0,0
79,8477478,William Carrier,L,CAR,30,0,0,0,0
79,8479344,Jesse Puljujarvi,R,PIT,26,0,0,0,0
79,8480887,Jordan Harris,D,MTL,24,0,0,0,0
79,8478502,Dennis Gilbert,D,BUF,28,0,0,0,0
79,8482730,Brandt Clarke,D,LAK,21,0,0,0,0
79,8480355,Mark Kastelic,C,BOS,25,0,0,0,0
79,8475750,Jon Merrill,D,MIN,32,0,0,0,0
79,8475164,Jakob Silfverberg,R,,34,0,0,0,0
79,8477944,Jakub Vrana,L,,28,0,0,0,0
79,8479439,Jacob MacDonald,D,COL,31,0,0,0,0
79,8474568,Luke Schenn,D,NSH,35,0,0,0,0
79,8478454,Noah Juulsen,D,VAN,27,0,0,0,0
79,8475752,Tyler Pitlick,C,,33,0,0,0,0
79,8482148,Hendrix Lapierre,C,WSH,22,0,0,0,0
79,8481167,Brayden Pachal,D,CGY,25,0,0,0,0
79,8478043,Sam Lafferty,C,BUF,29,0,0,0,0
79,8479321,Lucas Johansen,D,,27,0,0,0,0
79,8471699,Andrew Cogliano,C,,37,0,0,0,0
79,8481521,Ronnie Attard,D,PHI,25,0,0,0,0
79,8481161,Jake Christiansen,D,CBJ,25,0,0,0,0
79,8479458,Nikita Zaitsev,D,,33,0,0,0,0
79,8479619,Michael Carcone,L,UTA,28,0,0,0,0
79,8479026,Philippe Myers,D,TOR,27,0,0,0,0
79,8477330,Dominik Kubalik,L,,29,0,0,0,0
79,8481617,Vasily Podkolzin,R,VAN,23,0,0,0,0
79,8481701,Santeri Hatakka,D,NJD,23,0,0,0,0
79,8479514,Rem Pitlick,C,,27,0,0,0,0
79,8477446,Michael McCarron,R,NSH,29,0,0,0,0
79,8470604,Jeff Carter,C,,39,0,0,0,0
79,8482241,Radim Zohorna,L,,28,0,0,0,0
79,8480289,Morgan Barron,C,WPG,26,0,0,0,0
79,8479379,Givani Smith,R,SJS,26,0,0,0,0
79,8480216,Jacob Peterson,C,,25,0,0,0,0
79,8477851,Jordan Oesterle,D,BOS,32,0,0,0,0
79,8484258,Sam Malinski,D,COL,26,0,0,0,0
79,8478904,Steven Lorentz,C,,28,0,0,0,0
79,8482095,Tyler Kleven,D,OTT,22,0,0,0,0
79,8480848,Ty Dellandrea,C,SJS,24,0,0,0,0
79,8476884,Derrick Pouliot,D,,30,0,0,0,0
79,8479336,Carl Grundstrom,R,SJS,27,0,0,0,0
79,8482964,Arber Xhekaj,D,MTL,23,0,0,0,0
79,8471686,Marc Staal,D,,37,0,0,0,0
79,8477887,Patrick Brown,C,BOS,32,0,0,0,0
79,8478495,Denis Gurianov,R,,27,0,0,0,0
79,8473504,Cal Clutterbuck,R,,37,0,0,0,0
79,8481550,Adam Beckman,L,NJD,23,0,0,0,0
79,8480845,Rasmus Kupari,C,WPG,24,0,0,0,0
79,8474009,Nick Bonino,C,,36,0,0,0,0
79,8478585,Derek Ryan,C,EDM,38,0,0,0,0
79,8477962,Brendan Lemieux,L,CAR,28,0,0,0,0
79,8482861,Vincent Iorio,D,WSH,22,0,0,0,0
79,8479378,Logan Stanley,D,WPG,26,0,0,0,0
79,8473446,Erik Johnson,D,PHI,36,0,0,0,0
79,8481743,Marc Del Gaizo,D,NSH,25,0,0,0,0
79,8477384,Josh Brown,D,EDM,30,0,0,0,0
79,8482165,Yan Kuznetsov,D,CGY,22,0,0,0,0
79,8478424,Jansen Harkins,C,ANA,27,0,0,0,0
79,8482144,Jack Thompson,D,SJS,22,0,0,0,0
79,8478512,Austin Czarnik,C,,32,0,0,0,0
79,8477527,Ross Johnston,L,ANA,30,0,0,0,0
79,8479383,Boris Katchouk,L,,26,0,0,0,0
79,8482094,Daemon Hunt,D,MIN,22,0,0,0,0
79,8481719,Maxwell Crozier,D,TBL,24,0,0,0,0
79,8480192,Johnathan Kovacevic,D,NJD,27,0,0,0,0
79,8479376,Victor Mete,D,,26,0,0,0,0
79,8482511,Mason Lohrei,D,BOS,23,0,0,0,0
79,8475825,Jani Hakanpää,D,,32,0,0,0,0
79,8478021,William Lagesson,D,DET,28,0,0,0,0
79,8475795,Dylan McIlrath,D,WSH,32,0,0,0,0
79,8477846,Ryan Carpenter,C,,33,0,0,0,0
79,8481056,Spencer Stastney,D,NSH,24,0,0,0,0
79,8481564,Ryan Johnson,D,BUF,23,0,0,0,0
79,8478017,Mark Friedman,D,VAN,29,0,0,0,0
79,8479320,Max Lajoie,D,SEA,27,0,0,0,0
79,8480075,Cameron Crotty,D,MIN,25,0,0,0,0
79,8484287,Cole McWard,D,VAN,23,0,0,0,0
79,8484254,Akito Hirose,D,VAN,25,0,0,0,0
79,8483407,Brandon Scanlin,D,NYR,25,0,0,0,0
79,8480274,Philip Kemp,D,EDM,25,0,0,0,0
79,8479522,Hardy Haman Aktell,D,WSH,26,0,0,0,0
79,8480007,Jonas Rondbjerg,R,VGK,25,0,0,0,0
79,8477454,Adam Erne,L,,29,0,0,0,0
79,8481679,Maxence Guenette,D,OTT,23,0,0,0,0
79,8480441,Trey Fix-Wolansky,R,CBJ,25,0,0,0,0
79,8483546,Marshall Rifai,D,TOR,26,0,0,0,0
79,8480084,Nick DeSimone,D,NJD,30,0,0,0,0
79,8481030,Jack St. Ivany,D,PIT,25,0,0,0,0
79,8481592,Jakob Pelletier,L,CGY,23,0,0,0,0
79,8478011,Louie Belpedio,D,PHI,28,0,0,0,0
79,8477930,Pierre-Edouard Bellemare,L,,39,0,0,0,0
79,8484321,Nikolas Matinpalo,D,OTT,26,0,0,0,0
79,8482067,Connor Mackey,D,NYR,28,0,0,0,0
79,8481806,Louis Crevier,D,CHI,23,0,0,0,0
79,8484326,Patrik Koch,D,UTA,28,0,0,0,0
79,8477971,Andreas Englund,D,LAK,28,0,0,0,0
79,8481751,Lukas Rousek,R,BUF,25,0,0,0,0
79,8481006,Tyler Tucker,D,STL,24,0,0,0,0
79,8476867,Brendan Gaunce,C,MIN,30,0,0,0,0
79,8479520,Brandon Duhaime,R,WSH,27,0,0,0,0
79,8477073,Kurtis MacDermid,L,NJD,30,0,0,0,0
79,8480874,Adam Ginning,D,PHI,24,0,0,0,0
79,8477473,Justin Bailey,R,SJS,29,0,0,0,0
79,8479066,Ryan Lomberg,L,CGY,30,0,0,0,0
79,8477070,Liam O'Brien,C,UTA,30,0,0,0,0
79,8474618,Marco Scandella,D,,34,0,0,0,0
79,8475797,Jarred Tinordi,D,,32,0,0,0,0
79,8481441,Joe Snively,C,DET,28,0,0,0,0
79,8477244,Chad Ruhwedel,D,NYR,34,0,0,0,0
79,8479772,Zack MacEwen,R,OTT,28,0,0,0,0
79,8481147,Reese Johnson,C,MIN,26,0,0,0,0
79,8481043,Cole Koepke,L,BOS,26,0,0,0,0
79,8483619,Filip Roos,D,OTT,25,0,0,0,0
79,8481541,Samuel Bolduc,D,NYI,24,0,0,0,0
79,8477810,Joel Hanley,D,CGY,33,0,0,0,0
79,8476907,Mackenzie MacEachern,L,,30,0,0,0,0
79,8482652,Walker Duehr,R,CGY,27,0,0,0,0
79,8477126,Jayson Megna,C,,34,0,0,0,0
79,8483398,Declan Carlile,D,TBL,31,0,0,0,0
79,8482929,Emil Lilleberg,D,TBL,23,0,0,0,0
79,8480880,Jakub Lauko,C,MIN,24,0,0,0,0
79,8480245,Olle Lycksell,R,PHI,25,0,0,0,0
79,8480252,Cole Guttman,C,CHI,25,0,0,0,0
79,8477467,Gustav Olofsson,D,SEA,30,0,0,0,0
79,8479968,Vinni Lettieri,C,BOS,29,0,0,0,0
79,8478400,Colin White,C,,27,0,0,0,0
79,8475755,Alexander Petrovic,D,DAL,32,0,0,0,0
79,8481812,Nikolai Knyzhov,D,,27,0,0,0,0
79,8481593,Jayden Struble,D,MTL,23,0,0,0,0
79,8481532,Alex Turcotte,C,LAK,23,0,0,0,0
79,8482126,Emil Andrae,D,PHI,31,0,0,0,0
79,8479944,Zach Aston-Reese,C,VGK,30,0,0,0,0
79,8471817,Ryan Reaves,R,TOR,37,0,0,0,0
79,8481206,John Ludvig,D,PIT,24,0,0,0,0
79,8481599,Victor Soderstrom,D,UTA,23,0,0,0,0
79,8480292,Carson Meyer,R,ANA,27,0,0,0,0
79,8482496,Nils Aman,C,VAN,24,0,0,0,0
79,8479718,Alex Barré-Boulet,C,MTL,27,0,0,0,0
79,8479994,Jaret Anderson-Dolan,C,WPG,25,0,0,0,0
79,8480184,Gustav Lindstrom,D,,26,0,0,0,0
79,8480890,Jan Jenik,R,OTT,24,0,0,0,0
79,8478067,Oskar Lindblom,L,,28,0,0,0,0
79,8476934,Brock McGinn,L,ANA,30,0,0,0,0
79,8479985,Cale Fleury,D,SEA,26,0,0,0,0
79,8484304,Uvis Balinskis,D,FLA,28,0,0,0,0
79,8479981,Jonah Gadjovich,L,FLA,26,0,0,0,0
79,8481716,Dmitri Voronkov,L,CBJ,24,0,0,0,0
79,8474709,Matt Martin,L,,35,0,0,0,0
79,8482634,Alex Steeves,C,TOR,25,0,0,0,0
79,8480823,Alexander Alexeyev,D,WSH,25,0,0,0,0
79,8477541,Dakota Mermis,D,TOR,30,0,0,0,0
79,8483491,Ivan Miroshnichenko,L,WSH,20,0,0,0,0
79,8478477,Mitchell Stephens,C,SEA,27,0,0,0,0
79,8481543,Nikita Alexandrov,C,STL,24,0,0,0,0
79,8479423,Alex Nylander,L,,26,0,0,0,0
79,8482451,Mikael Pyyhtia,L,CBJ,23,0,0,0,0
79,8478831,Kevin Stenlund,C,UTA,28,0,0,0,0
79,8480306,Grant Hutton,D,NYI,29,0,0,0,0
79,8478028,Fredrik Olofsson,L,,28,0,0,0,0
79,8477462,Robert Hagg,D,VGK,29,0,0,0,0
79,8477320,Anton Blidh,L,NYR,29,0,0,0,0
79,8482157,Will Cuylle,L,NYR,22,0,0,0,0
79,8482737,Zack Bolduc,C,STL,21,0,0,0,0
79,8481239,Samuel Fagemo,L,,24,0,0,0,0
79,8481600,Tobias Bjornfot,D,FLA,23,0,0,0,0
79,8478409,Anthony Richard,C,PHI,28,0,0,0,0
79,8474145,Robert Bortuzzo,D,,35,0,0,0,0
79,8475958,Michael Sgarbossa,C,WSH,32,0,0,0,0
79,8479986,Kole Lind,R,DAL,26,0,0,0,0
79,8479249,Andrew Poturalski,C,SJS,30,0,0,0,0
79,8479362,Riley Tufte,L,BOS,26,0,0,0,0
79,8479991,Jake Leschyshyn,C,NYR,25,0,0,0,0
79,8479587,Rhett Gardner,C,PHI,28,0,0,0,0
79,8482744,James Malatesta,L,CBJ,21,0,0,0,0
79,8478854,Ryan Shea,D,PIT,27,0,0,0,0
79,8481591,Sam Poulin,R,,23,0,0,0,0
79,8483512,Matt Savoie,C,EDM,20,0,0,0,0
79,8482102,Vasily Ponomarev,C,PIT,22,0,0,0,0
79,8482162,Roby Jarventie,L,EDM,22,0,0,0,0
79,8481016,Ruslan Iskhakov,C,,24,0,0,0,0
79,8482172,Landon Slaggert,L,CHI,22,0,0,0,0
79,8482747,Brennan Othmann,L,NYR,21,0,0,0,0
79,8480031,Maxime Comtois,L,,25,0,0,0,0
79,8480226,Marián Studenic,R,,26,0,0,0,0
79,8478408,Travis Dermott,D,,28,0,0,0,0
79,8481518,Nolan Foote,L,NJD,24,0,0,0,0
79,8479419,Brett Murray,L,BUF,26,0,0,0,0
79,8482088,Justin Sourdif,R,FLA,22,0,0,0,0
79,8482201,Gage Goncalves,C,TBL,23,0,0,0,0
79,8481578,Graeme Clarke,R,MIN,23,0,0,0,0
79,8482177,Marat Khusnutdinov,C,MIN,22,0,0,0,0
79,8481754,Nikita Nesterenko,C,ANA,23,0,0,0,0
79,8483531,Brian Halonen,L,NJD,25,0,0,0,0
79,8483920,Pierrick Dube,R,WSH,23,0,0,0,0
79,8480851,Akil Thomas,C,LAK,24,0,0,0,0
79,8475235,Nicolas Deslauriers,L,PHI,33,0,0,0,0
79,8482476,Emil Heineman,L,MTL,23,0,0,0,0
79,8477149,Scott Sabourin,R,SJS,32,0,0,0,0
79,8483549,Lucas Condotta,L,MTL,27,0,0,0,0
79,8482765,Isak Rosen,R,BUF,21,0,0,0,0
79,8481237,Kyle MacLean,C,NYI,25,0,0,0,0
79,8481024,Linus Karlsson,C,VAN,25,0,0,0,0
79,8481690,Tyler Angle,C,,24,0,0,0,0
79,8483570,Ben Meyers,C,SEA,26,0,0,0,0
79,8481655,Cole Schwindt,R,CGY,23,0,0,0,0
79,8481462,Mason Morelli,L,VGK,28,0,0,0,0
79,8483401,Marc Johnstone,R,PIT,28,0,0,0,0
79,8478956,Samuel Laberge,L,NJD,27,0,0,0,0
79,8479533,Joona Koppanen,L,,26,0,0,0,0
79,8482197,Adam Raska,R,MIN,23,0,0,0,0
79,8482250,Callahan Burke,C,VGK,27,0,0,0,0
79,8482784,Zach Dean,C,STL,21,0,0,0,0
79,8484255,Jason Polin,R,COL,25,0,0,0,0
79,8481077,John Leonard,L,,26,0,0,0,0
79,8481534,Raphael Lavoie,C,EDM,24,0,0,0,0
79,8483609,Adam Klapka,R,CGY,24,0,0,0,0
79,8482751,Ryan Winterton,C,SEA,21,0,0,0,0
79,8480267,Sammy Walker,C,MIN,25,0,0,0,0
79,8475766,Austin Watson,L,,32,0,0,0,0
79,8482460,Matt Rempe,C,NYR,22,0,0,0,0
79,8481065,Angus Crookshank,L,OTT,25,0,0,0,0
79,8481070,Hugh McGing,L,,26,0,0,0,0
79,8476323,Max McCormick,L,SEA,32,0,0,0,0
79,8483395,Arshdeep Bains,L,VAN,23,0,0,0,0
79,8484259,Ondrej Pavel,C,COL,31,0,0,0,0
79,8483432,Luca Del Bel Belluz,C,CBJ,31,0,0,0,0
79,8483045,Cameron Butler,R,CBJ,31,0,0,0,0
79,8482061,Brandon Biro,L,SEA,26,0,0,0,0
79,8477401,John Hayden,C,SEA,29,0,0,0,0
79,8475278,Byron Froese,C,,33,0,0,0,0
79,8478446,Glenn Gawdin,C,LAK,27,0,0,0,0
79,8477993,Justin Kirkland,C,CGY,28,0,0,0,0
79,8482147,Jean-Luc Foudy,C,COL,22,0,0,0,0
79,8480032,Shane Bowers,C,NJD,25,0,0,0,0
79,8479330,Brandon Gignac,C,MTL,27,0,0,0,0
79,8480776,Sheldon Rempal,R,,29,0,0,0,0
79,8475413,Justin Dowling,C,NJD,34,0,0,0,0
79,8481726,Adam Edstrom,C,NYR,24,0,0,0,0
79,8480844,Grigori Denisenko,L,VGK,24,0,0,0,0
79,8478147,Bokondji Imama,L,PIT,28,0,0,0,0
79,8478881,Brett Seney,L,CHI,28,0,0,0,0
79,8483630,Pavol Regenda,L,ANA,25,0,0,0,0
79,8480836,Jonathan Gruden,C,,24,0,0,0,0
79,8484314,Jiri Smejkal,L,,28,0,0,0,0
79,8475780,Chris Wagner,R,COL,33,0,0,0,0
79,8479546,Oskar Steen,C,,26,0,0,0,0
79,8483597,Milos Kelemen,L,UTA,25,0,0,0,0
79,8481789,Tye Kartye,L,SEA,23,0,0,0,0
79,8484325,Waltteri Merela,C,TBL,26,0,0,0,0
79,8479421,Jacob Moverare,D,LAK,26,0,0,0,0
79,8481585,Egor Afanasyev,L,SJS,23,0,0,0,0
79,8479547,Matthew Phillips,R,,26,0,0,0,0
79,8479367,William Lockwood,R,FLA,26,0,0,0,0
79,8476915,Jujhar Khaira,L,,30,0,0,0,0
79,8481422,Jacob Lucchini,C,NSH,29,0,0,0,0
79,8480468,James Hamblin,L,EDM,25,0,0,0,0
79,8478051,Max Willman,C,NJD,29,0,0,0,0
79,8481556,John Beecher,C,BOS,23,0,0,0,0
79,8478078,Rourke Chartier,C,,28,0,0,0,0
80,8476453,Nikita Kucherov,R,TBL,31,82,44,97,141
80,8478402,Connor McDavid,C,EDM,27,82,39,88,127
80,8471675,Sidney Crosby,C,PIT,37,82,57,69,126
80,8480027,Jason Robertson,L,DAL,25,82,41,81,122
80,8478864,Kirill Kaprizov,L,MIN,27,82,60,58,118
80,8477934,Leon Draisaitl,C,EDM,29,82,51,65,116
80,8479314,Matthew Tkachuk,L,FLA,27,82,38,76,114
80,8477493,Aleksander Barkov,C,FLA,29,82,32,81,113
80,8478445,Mathew Barzal,C,NYI,27,82,40,72,112
80,8481559,Jack Hughes,C,NJD,23,82,45,66,111
80,8477492,Nathan MacKinnon,C,COL,29,82,42,69,111
80,8476468,J.T. Miller,C,VAN,31,82,46,64,110
80,8478550,Artemi Panarin,L,NYR,33,82,30,80,110
80,8478420,Mikko Rantanen,R,COL,28,82,53,55,108
80,8477956,David Pastrnak,R,BOS,28,82,48,58,106
80,8478398,Kyle Connor,L,WPG,28,82,47,58,105
80,8473419,Brad Marchand,L,BOS,36,82,42,59,101
80,8479318,Auston Matthews,C,TOR,27,82,48,51,99
80,8480800,Quinn Hughes,D,VAN,25,82,13,85,98
80,8476887,Filip Forsberg,L,NSH,30,82,43,54,97
80,8480012,Elias Pettersson,C,VAN,26,82,41,54,95
80,8479323,Adam Fox,D,NYR,26,82,25,70,95
80,8478010,Brayden Point,C,TBL,28,82,44,50,94
80,8480801,Brady Tkachuk,L,OTT,25,82,38,56,94
80,8477939,William Nylander,R,TOR,28,82,34,59,93
80,8480069,Cale Makar,D,COL,26,82,28,65,93
80,8478403,Jack Eichel,C,VGK,28,82,43,48,91
80,8475166,John Tavares,C,TOR,34,82,42,49,91
80,8477933,Sam Reinhart,C,FLA,29,82,46,44,90
80,8477409,Carter Verhaeghe,C,FLA,29,82,41,48,89
80,8477496,Elias Lindholm,C,BOS,30,82,35,54,89
80,8482116,Tim Stützle,C,OTT,22,82,25,64,89
80,8475810,Bryan Rust,R,PIT,32,82,43,45,88
80,8471215,Evgeni Malkin,C,PIT,38,82,34,54,88
80,8476460,Mark Scheifele,C,WPG,31,82,33,55,88
80,8480208,Drake Batherson,R,OTT,26,82,30,58,88
80,8479343,Clayton Keller,R,UTA,26,82,39,46,85
80,8477500,Bo Horvat,C,NYI,29,82,39,46,85
80,8476389,Vincent Trocheck,C,NYR,31,82,33,52,85
80,8477501,Valeri Nichushkin,R,COL,29,82,32,53,85
80,8477942,Kevin Fiala,L,LAK,28,82,29,56,85
80,8476459,Mika Zibanejad,C,NYR,31,82,36,48,84
80,8477504,Josh Morrissey,D,WPG,29,82,17,67,84
80,8478873,Troy Terry,R,ANA,27,82,32,50,82
80,8480002,Nico Hischier,C,NJD,25,82,25,57,82
80,8476881,Tomas Hertl,C,VGK,31,82,45,36,81
80,8477404,Jake Guentzel,C,TBL,30,82,31,50,81
80,8475913,Mark Stone,R,VGK,32,82,26,55,81
80,8478449,Roope Hintz,C,DAL,28,82,46,34,80
80,8478444,Brock Boeser,R,VAN,27,82,40,40,80
80,8474578,Erik Karlsson,D,PIT,34,82,24,56,80
80,8481557,Matt Boldy,L,MIN,23,82,34,45,79
80,8478427,Sebastian Aho,C,CAR,27,82,25,54,79
80,8471214,Alex Ovechkin,L,WSH,39,82,44,34,78
80,8477946,Dylan Larkin,C,DET,28,82,33,45,78
80,8474564,Steven Stamkos,C,NSH,34,82,33,45,78
80,8475172,Nazem Kadri,C,CGY,34,82,30,48,78
80,8477940,Nikolaj Ehlers,L,WPG,28,82,29,49,78
80,8477447,Shea Theodore,D,VGK,29,82,17,61,78
80,8481523,Kirby Dach,C,MTL,23,82,14,64,78
80,8482093,Seth Jarvis,C,CAR,22,82,42,35,77
80,8481540,Cole Caufield,R,MTL,23,82,31,46,77
80,8477964,Ivan Barbashev,C,VGK,29,82,31,46,77
80,8476346,Johnny Gaudreau,L,CBJ,31,82,27,50,77
80,8475692,Mats Zuccarello,R,MIN,37,82,22,55,77
80,8479407,Jesper Bratt,L,NJD,26,82,33,43,76
80,8480830,Andrei Svechnikov,R,CAR,24,82,31,45,76
80,8480014,Gabriel Vilardi,C,WPG,25,82,36,39,75
80,8480018,Nick Suzuki,C,MTL,25,82,31,44,75
80,8482665,Matty Beniers,C,SEA,22,82,30,44,74
80,8480023,Robert Thomas,C,STL,25,82,25,49,74
80,8478460,Zach Werenski,D,CBJ,27,82,17,57,74
80,8475784,Jeff Skinner,C,EDM,32,82,31,42,73
80,8479542,Brandon Hagel,L,TBL,26,82,37,35,72
80,8477960,Adrian Kempe,R,LAK,28,82,30,42,72
80,8478493,Joel Eriksson Ek,C,MIN,27,82,30,41,71
80,8476454,Ryan Nugent-Hopkins,C,EDM,31,82,23,48,71
80,8481533,Trevor Zegras,C,ANA,23,82,23,48,71
80,8476456,Jonathan Huberdeau,C,CGY,31,82,16,55,71
80,8479420,Tage Thompson,C,BUF,27,82,36,34,70
80,8475754,Brock Nelson,C,NYI,33,82,34,36,70
80,8479385,Jordan Kyrou,C,STL,26,82,30,39,69
80,8477949,Alex Tuch,R,BUF,28,82,29,40,69
80,8479325,Charlie McAvoy,D,BOS,27,82,10,59,69
80,8475184,Chris Kreider,L,NYR,33,82,34,34,68
80,8479337,Alex DeBrincat,R,DET,27,82,28,40,68
80,8475786,Zach Hyman,L,EDM,32,82,35,32,67
80,8478042,Viktor Arvidsson,R,EDM,31,82,26,41,67
80,8475765,Vladimir Tarasenko,R,DET,33,82,24,43,67
80,8478975,Mason Marchment,L,DAL,29,82,21,46,67
80,8474600,Roman Josi,D,NSH,34,82,16,51,67
80,8476853,Morgan Rielly,D,TOR,30,82,9,58,67
80,8482078,Lucas Raymond,L,DET,22,82,27,39,66
80,8478401,Pavel Zacha,C,BOS,27,82,26,40,66
80,8471685,Anze Kopitar,C,LAK,37,82,21,45,66
80,8480803,Evan Bouchard,D,EDM,25,82,7,59,66
80,8475745,Charlie Coyle,C,BOS,32,82,28,37,65
80,8479675,Trevor Moore,L,LAK,29,82,24,41,65
80,8476479,Phillip Danault,C,LAK,31,82,22,43,65
80,8477951,Nick Schmaltz,C,UTA,28,82,18,47,65
80,8478439,Travis Konecny,R,PHI,27,82,16,49,65
80,8475167,Victor Hedman,D,TBL,34,82,13,52,65
80,8480865,Noah Dobson,D,NYI,24,82,12,53,65
80,8475794,Tyler Seguin,C,DAL,32,82,31,33,64
80,8473994,Jamie Benn,L,DAL,35,82,21,43,64
80,8481711,Matias Maccelli,L,UTA,24,82,22,41,63
80,8473986,Alex Killorn,L,ANA,35,82,25,37,62
80,8474141,Patrick Kane,R,DET,36,82,22,40,62
80,8476882,Teuvo Teravainen,L,CHI,30,82,21,41,62
80,8475798,Mikael Granlund,C,SJS,32,82,19,43,62
80,8478407,Vince Dunn,D,SEA,28,82,16,46,62
80,8480036,Miro Heiskanen,D,DAL,25,82,10,52,62
80,8478414,Timo Meier,R,NJD,28,82,37,24,61
80,8476432,Boone Jenner,C,CBJ,31,82,34,27,61
80,8479339,Patrik Laine,L,CBJ,26,82,30,31,61
80,8484144,Connor Bedard,C,CHI,19,82,28,33,61
80,8481528,Dylan Cozens,C,BUF,23,82,26,35,61
80,8480028,Morgan Frost,C,PHI,25,82,24,37,61
80,8476448,William Karlsson,C,VGK,31,82,20,41,61
80,8473512,Claude Giroux,R,OTT,36,82,16,45,61
80,8480839,Rasmus Dahlin,D,BUF,24,82,14,47,61
80,8477935,Sam Bennett,C,FLA,28,82,33,27,60
80,8471724,Kris Letang,D,PIT,37,82,10,50,60
80,8474590,John Carlson,D,WSH,34,82,8,52,60
80,8478396,Noah Hanifin,D,VGK,27,82,16,43,59
80,8478055,Gustav Forsling,D,FLA,28,82,15,44,59
80,8482740,Wyatt Johnston,C,DAL,21,82,33,25,58
80,8475799,Nino Niederreiter,R,WPG,32,82,32,26,58
80,8481596,Shane Pinto,C,OTT,24,82,27,31,58
80,8482745,Mason McTavish,C,ANA,21,82,24,34,58
80,8476483,Rickard Rakell,R,PIT,31,82,24,34,58
80,8478469,Thomas Chabot,D,OTT,27,82,24,34,58
80,8477456,J.T. Compher,L,DET,29,82,31,26,57
80,8476399,Blake Coleman,C,CGY,33,82,29,28,57
80,8481068,Yegor Sharangovich,C,CGY,26,82,28,29,57
80,8478047,Michael Bunting,L,PIT,29,82,21,36,57
80,8481560,Arthur Kaliyev,R,LAK,23,82,32,24,56
80,8482175,JJ Peterka,R,BUF,22,82,28,28,56
80,8480015,Owen Tippett,R,PHI,25,82,26,30,56
80,8474150,Mikael Backlund,C,CGY,35,82,22,34,56
80,8477451,Ryan Hartman,R,MIN,30,82,22,34,56
80,8478856,Conor Garland,R,VAN,28,82,21,35,56
80,8474563,Drew Doughty,D,LAK,35,82,17,39,56
80,8476462,Dougie Hamilton,D,NJD,31,82,16,40,56
80,8478462,Nicolas Roy,C,VGK,27,82,16,40,56
80,8479410,Mikhail Sergachev,D,UTA,26,82,7,49,56
80,8475726,Tyler Toffoli,C,SJS,32,82,28,27,55
80,8482109,Alexis Lafrenière,L,NYR,23,82,27,28,55
80,8476392,Adam Lowry,C,WPG,31,82,18,37,55
80,8477346,MacKenzie Weegar,D,CGY,30,82,14,41,55
80,8477986,Brandon Montour,D,SEA,30,82,12,43,55
80,8475169,Evander Kane,L,EDM,33,82,31,23,54
80,8476539,Jonathan Marchessault,R,NSH,34,82,30,24,54
80,8477426,Nicholas Paul,L,TBL,29,82,27,27,54
80,8478366,Frank Vatrano,R,ANA,30,82,26,28,54
80,8480039,Martin Necas,C,CAR,25,82,24,30,54
80,8475168,Matt Duchene,C,DAL,33,82,22,32,54
80,8478440,Dylan Strome,C,WSH,27,82,20,34,54
80,8482660,Kent Johnson,C,CBJ,22,82,18,36,54
80,8474679,Gustav Nyquist,C,NSH,35,82,17,37,54
80,8482684,Luke Hughes,D,NJD,21,82,15,39,54
80,8480064,Josh Norris,C,OTT,25,82,28,25,53
80,8475191,Reilly Smith,R,NYR,33,82,28,25,53
80,8471698,T.J. Oshie,R,WSH,38,82,27,26,53
80,8477402,Pavel Buchnevich,L,STL,29,82,25,28,53
80,8477407,Anthony Duclair,L,NYI,29,82,21,32,53
80,8476905,Chandler Stephenson,C,SEA,30,82,17,36,53
80,8475287,Erik Haula,L,NJD,33,82,15,38,53
80,8476875,Mike Matheson,D,MTL,30,82,9,44,53
80,8479425,Filip Hronek,D,VAN,27,82,8,45,53
80,8482159,Tyson Foerster,R,PHI,22,82,29,23,52
80,8474641,Adam Henrique,C,EDM,34,82,23,29,52
80,8479999,Casey Mittelstadt,C,COL,26,82,15,37,52
80,8477932,Aaron Ekblad,D,FLA,28,82,14,38,52
80,8476792,Torey Krug,D,STL,33,82,12,40,52
80,8480113,Alex Iafallo,L,WPG,31,82,24,27,51
80,8470613,Brent Burns,D,CAR,39,82,20,31,51
80,8479400,Pierre-Luc Dubois,L,WSH,26,82,19,32,51
80,8475170,Brayden Schenn,C,STL,33,82,18,33,51
80,8477479,Tyler Bertuzzi,L,CHI,29,82,18,33,51
80,8482113,Anton Lundell,C,FLA,23,82,18,33,51
80,8478474,Lawson Crouse,L,UTA,27,82,28,22,50
80,8477987,Ryan Donato,C,CHI,28,82,24,26,50
80,8475791,Taylor Hall,L,CHI,33,82,19,31,50
80,8480434,Sean Durzi,D,UTA,26,82,10,40,50
80,8477416,Oliver Bjorkstrand,R,SEA,29,82,26,23,49
80,8475314,Anders Lee,L,NYI,34,82,26,23,49
80,8482699,Dylan Guenther,R,UTA,21,82,26,23,49
80,8482097,Jack Quinn,R,BUF,23,82,20,29,49
80,8479987,Morgan Geekie,C,BOS,26,82,18,31,49
80,8476927,Teddy Blueger,C,VAN,30,82,12,37,49
80,8476869,Brady Skjei,D,NSH,30,82,11,38,49
80,8478498,Jake DeBrusk,L,VAN,28,82,25,23,48
80,8476438,Brandon Saad,L,STL,32,82,25,23,48
80,8473422,Nick Foligno,L,CHI,37,82,21,27,48
80,8475151,Kyle Palmieri,C,NYI,33,82,20,28,48
80,8477494,Jonathan Drouin,L,COL,29,82,13,35,48
80,8477969,Marcus Pettersson,D,PIT,28,82,7,41,48
80,8482089,Jake Neighbours,L,STL,22,82,25,22,47
80,8480797,Joel Farabee,L,PHI,24,82,21,26,47
80,8482149,Cole Perfetti,C,WPG,22,82,20,27,47
80,8475722,Jason Zucker,L,BUF,32,82,19,28,47
80,8477955,Jared McCann,L,SEA,28,82,15,32,47
80,8476923,Damon Severson,D,CBJ,30,82,13,34,47
80,8480145,Neal Pionk,D,WPG,29,82,6,41,47
80,8476906,Shayne Gostisbehere,D,CAR,31,82,5,42,47
80,8474102,David Perron,L,OTT,36,82,26,20,46
80,8478233,Andrew Mangiapane,L,WSH,28,82,23,23,46
80,8475158,Ryan O'Reilly,C,NSH,33,82,20,26,46
80,8477444,Andre Burakovsky,L,SEA,29,82,17,29,46
80,8482720,Matthew Knies,L,TOR,22,82,17,29,46
80,8477503,Max Domi,C,TOR,29,82,16,30,46
80,8478519,Anthony Cirelli,C,TBL,27,82,14,32,46
80,8478458,Jack Roslovic,C,CAR,27,82,12,34,46
80,8480798,Philipp Kurashev,C,CHI,25,82,12,34,46
80,8474565,Alex Pietrangelo,D,VGK,34,82,8,38,46
80,8480009,Eeli Tolvanen,R,SEA,25,82,22,23,45
80,8480188,Fabian Zetterlund,L,SJS,25,82,19,26,45
80,8482146,Luke Evangelista,R,NSH,22,82,19,26,45
80,8480220,Noah Cates,L,PHI,25,82,19,26,45
80,8474586,Jordan Eberle,R,SEA,34,82,17,28,45
80,8477429,Andrew Copp,C,DET,30,82,17,28,45
80,8477495,Seth Jones,D,CHI,30,82,12,33,45
80,8478438,Tommy Novak,C,NSH,27,82,12,33,45
80,8475753,Justin Faulk,D,STL,32,82,11,34,45
80,8475171,Oliver Ekman-Larsson,D,TOR,33,82,8,37,45
80,8481542,Moritz Seider,D,DET,23,82,4,41,45
80,8481604,Pavel Dorofeyev,L,VGK,24,82,29,15,44
80,8481618,Alex Newhook,C,MTL,23,82,21,23,44
80,8477497,Sean Monahan,C,CBJ,30,82,18,26,44
80,8480185,Eetu Luostarinen,C,FLA,26,82,17,27,44
80,8477021,Alex Kerfoot,C,UTA,30,82,16,28,44
80,8482667,William Eklund,L,SJS,22,82,15,29,44
80,8482671,Owen Power,D,BUF,22,82,7,37,44
80,8476958,Jaccob Slavin,D,CAR,30,82,6,38,44
80,8477476,Artturi Lehkonen,L,COL,29,82,25,18,43
80,8483808,Andrei Kuzmenko,L,CGY,28,82,22,21,43
80,8482055,Drew O'Connor,L,PIT,26,82,21,22,43
80,8479365,Trent Frederic,C,BOS,26,82,21,22,43
80,8476826,Yanni Gourde,C,SEA,33,82,19,24,43
80,8478109,Victor Olofsson,L,VGK,29,82,16,27,43
80,8476292,Ondrej Palat,L,NJD,33,82,15,28,43
80,8482110,Dawson Mercer,C,NJD,23,82,21,21,42
80,8474053,Logan Couture,C,SJS,35,82,20,22,42
80,8475343,Nic Dowd,C,WSH,34,82,20,22,42
80,8476880,Tom Wilson,R,WSH,30,82,18,24,42
80,8474149,Evgenii Dadonov,R,DAL,35,82,18,24,42
80,8480817,K'Andre Miller,D,NYR,24,82,14,28,42
80,8477947,Sonny Milano,L,WSH,28,82,12,30,42
80,8476885,Jacob Trouba,D,NYR,30,82,8,34,42
80,8475764,Cam Fowler,D,ANA,33,82,6,36,42
80,8475760,Nick Bjugstad,C,UTA,32,82,23,18,41
80,8475768,Jaden Schwartz,C,SEA,32,82,22,19,41
80,8475714,Calle Jarnkrok,C,TOR,33,82,20,21,41
80,8483515,Juraj Slafkovsky,L,MTL,20,82,20,21,41
80,8478463,Anthony Beauvillier,L,PIT,27,82,19,22,41
80,8480078,Filip Chytil,C,NYR,25,82,18,23,41
80,8479525,Ross Colton,C,COL,28,82,17,24,41
80,8470621,Corey Perry,R,EDM,39,82,16,25,41
80,8478397,Rasmus Andersson,D,CGY,28,82,14,27,41
80,8480871,Adam Boqvist,D,FLA,24,82,12,29,41
80,8475218,Mattias Ekholm,D,EDM,34,82,12,29,41
80,8477511,Anthony Mantha,R,CGY,30,82,21,19,40
80,8479992,Michael Rasmussen,C,DET,25,82,20,20,40
80,8480849,Barrett Hayton,C,UTA,24,82,20,20,40
80,8479345,Jakob Chychrun,D,WSH,26,82,16,24,40
80,8478046,Danton Heinen,L,VAN,29,82,16,24,40
80,8478891,Mason Appleton,C,WPG,28,82,15,25,40
80,8481581,Thomas Harley,D,DAL,23,82,10,30,40
80,8478038,Devon Toews,D,COL,30,82,9,31,40
80,8476897,Oskar Sundqvist,C,STL,30,82,9,31,40
80,8478115,Pierre Engvall,L,NYI,28,82,20,19,39
80,8476925,Colton Sissons,C,NSH,31,82,13,26,39
80,8481553,Bobby Brink,R,PHI,23,82,11,28,39
80,8476854,Hampus Lindholm,D,BOS,30,82,10,29,39
80,8481186,Logan O'Connor,R,COL,28,82,21,17,38
80,8480459,Pius Suter,C,VAN,28,82,19,19,38
80,8476960,Andreas Athanasiou,C,CHI,30,82,16,22,38
80,8476458,Ryan Strome,C,ANA,31,82,15,23,38
80,8475855,Jesper Fast,R,CAR,33,82,13,25,38
80,8477498,Darnell Nurse,D,EDM,29,82,12,26,38
80,8482124,Quinton Byfield,R,LAK,22,82,8,30,38
80,8480068,Ryan Poehling,C,PHI,25,82,19,18,37
80,8480893,Kirill Marchenko,R,CBJ,24,82,17,20,37
80,8477919,Frederick Gaudreau,C,MIN,31,82,17,20,37
80,8476873,Mark Jankowski,C,NSH,30,82,17,20,37
80,8476419,Jean-Gabriel Pageau,C,NYI,32,82,16,21,37
80,8474715,Cam Atkinson,R,TBL,35,82,16,21,37
80,8473533,Jordan Staal,C,CAR,36,82,14,23,37
80,8481624,Ilya Mikheyev,R,CHI,30,82,13,24,37
80,8480789,Oliver Wahlstrom,R,NYI,24,82,13,24,37
80,8481606,Jordan Spence,D,LAK,23,82,8,29,37
80,8479402,Jake Bean,D,CGY,26,82,7,30,37
80,8481535,Nils Hoglander,L,VAN,24,82,23,13,36
80,8477998,Warren Foegele,L,LAK,28,82,20,16,36
80,8480144,David Kampf,C,TOR,29,82,17,19,36
80,8482705,Cole Sillinger,C,CBJ,21,82,15,21,36
80,8475763,Kevin Hayes,R,PIT,32,82,15,21,36
80,8479353,Brett Howden,C,VGK,26,82,15,21,36
80,8478413,Jordan Greenway,L,BUF,27,82,14,22,36
80,8480748,Kiefer Sherwood,L,VAN,29,82,11,25,36
80,8484145,Zach Benson,L,BUF,19,82,24,11,35
80,8481517,Brett Leason,R,ANA,25,82,19,16,35
80,8480835,Jack Drury,C,CAR,24,82,16,19,35
80,8482475,Yegor Chinakhov,R,CBJ,23,82,16,19,35
80,8480802,Ryan McLeod,C,BUF,25,82,13,22,35
80,8477948,Travis Sanheim,D,PHI,28,82,10,25,35
80,8474716,Jared Spurgeon,D,MIN,35,82,9,26,35
80,8483457,Lane Hutson,D,MTL,20,82,9,26,35
80,8478911,Matt Roy,D,WSH,29,82,6,29,35
80,8478057,Dakota Joshua,C,VAN,28,82,17,17,34
80,8479293,Brandon Tanev,L,SEA,33,82,17,17,34
80,8480829,Jesperi Kotkaniemi,C,CAR,24,82,17,17,34
80,8479661,Tanner Jeannot,L,LAK,27,82,17,17,34
80,8482117,Lukas Reichel,L,CHI,22,82,16,18,34
80,8475793,Ryan Johansen,C,PHI,32,82,16,18,34
80,8476480,Vladislav Namestnikov,C,WPG,32,82,16,18,34
80,8481481,Blake Lizotte,C,PIT,27,82,15,19,34
80,8480003,Jesper Boqvist,C,FLA,26,82,13,21,34
80,8479941,Justin Danforth,R,CBJ,31,82,10,24,34
80,8481546,Cam York,D,PHI,23,82,10,24,34
80,8476329,Travis Boyd,C,MIN,31,82,9,25,34
80,8480043,Timothy Liljegren,D,TOR,25,82,2,32,34
80,8479393,Noah Gregor,C,OTT,26,82,21,12,33
80,8476469,Joel Armia,R,MTL,31,82,16,17,33
80,8480855,Jack McBain,C,UTA,24,82,14,19,33
80,8476461,Sean Couturier,C,PHI,32,82,14,19,33
80,8477953,Kasperi Kapanen,R,STL,28,82,11,22,33
80,8475149,Marcus Johansson,L,MIN,34,82,10,23,33
80,8477506,Ryan Pulock,D,NYI,30,82,9,24,33
80,8477425,Miles Wood,L,COL,29,82,19,13,32
80,8477952,Robby Fabbri,C,ANA,28,82,18,14,32
80,8482092,Ridly Greig,C,OTT,22,82,18,14,32
80,8480806,Isac Lundestrom,C,ANA,25,82,18,14,32
80,8478020,Michael Amadio,C,OTT,28,82,17,15,32
80,8477488,Brett Pesce,D,NJD,30,82,11,21,32
80,8478211,Dryden Hunt,L,CGY,29,82,11,21,32
80,8480336,Sean Walker,D,CAR,30,82,10,22,32
80,8482141,Lukas Cormier,D,VGK,22,82,9,23,32
80,8482105,Jake Sanderson,D,OTT,22,82,5,27,32
80,8476917,Adam Pelech,D,NYI,30,82,3,29,32
80,8478507,John Marino,D,UTA,27,82,3,29,32
80,8481582,Nicholas Robertson,L,TOR,23,82,19,12,31
80,8479368,Max Jones,L,BOS,26,82,16,15,31
80,8482125,Alexander Holtz,R,VGK,22,82,16,15,31
80,8481093,Rafael Harvey-Pinard,L,MTL,25,82,16,15,31
80,8477015,Connor Brown,R,EDM,30,82,15,16,31
80,8478542,Evan Rodrigues,C,FLA,31,82,14,17,31
80,8476979,Erik Gustafsson,D,DET,32,82,7,24,31
80,8483431,Logan Cooley,C,UTA,20,82,20,10,30
80,8482062,Cole Smith,L,NSH,29,82,19,11,30
80,8477450,Jason Dickinson,C,CHI,29,82,16,14,30
80,8481554,Kaapo Kakko,R,NYR,23,82,16,14,30
80,8481656,Aliaksei Protas,C,WSH,23,82,14,16,30
80,8475200,Dmitry Orlov,D,CAR,33,82,10,20,30
80,8480246,Nick Perbix,D,TBL,26,82,9,21,30
80,8482133,Thomas Bordeleau,C,SJS,22,82,8,22,30
80,8479371,Dante Fabbro,D,NSH,26,82,6,24,30
80,8478882,Vladislav Gavrikov,D,LAK,29,82,4,26,30
80,8482155,Alex Laferriere,R,LAK,23,82,20,9,29
80,8474189,Lars Eller,C,PIT,35,82,15,14,29
80,8479316,Luke Kunin,C,SJS,27,82,14,15,29
80,8477392,Hudson Fasching,R,NYI,29,82,13,16,29
80,8475220,Marcus Foligno,L,MIN,33,82,12,17,29
80,8476474,Stefan Noesen,R,NJD,31,82,10,19,29
80,8477369,Carson Soucy,D,VAN,30,82,10,19,29
80,8476624,Barclay Goodrow,C,SJS,31,82,10,19,29
80,8481522,Peyton Krebs,C,BUF,23,82,9,20,29
80,8479351,Sam Steel,C,DAL,26,82,9,20,29
80,8482122,Brock Faber,D,MIN,22,82,7,22,29
80,8482111,Justin Barron,D,MTL,23,82,7,22,29
80,8481708,Zac Jones,D,NYR,24,82,7,22,29
80,8482807,Ethan Del Mastro,D,CHI,21,82,7,22,29
80,8479369,Andrew Peeke,D,BOS,26,82,6,23,29
80,8482245,Artem Zub,D,OTT,29,82,5,24,29
80,8479998,Mikey Anderson,D,LAK,25,82,4,25,29
80,8479398,Samuel Girard,D,COL,26,82,2,27,29
80,8480035,Henri Jokiharju,D,BUF,25,82,2,27,29
80,8478443,Brandon Carlo,D,BOS,28,82,2,27,29
80,8480281,Alexey Toropchenko,R,STL,25,82,19,9,28
80,8480980,Connor Dewar,C,TOR,25,82,17,11,28
80,8481704,Juuso Parssinen,C,NSH,23,82,15,13,28
80,8481013,Jonatan Berggren,R,DET,24,82,14,14,28
80,8475193,Tomas Tatar,L,NJD,34,82,13,15,28
80,8476918,Jimmy Vesey,L,NYR,31,82,13,15,28
80,8476921,Jordan Martinook,L,CAR,32,82,12,16,28
80,8480813,Joe Veleno,C,DET,24,82,12,16,28
80,8483397,Marc McLaughlin,C,BOS,25,82,12,16,28
80,8476374,Sean Kuraly,C,CBJ,31,82,9,19,28
80,8478472,Mathieu Joseph,R,STL,27,82,8,20,28
80,8474673,TJ Brodie,D,CHI,34,82,8,20,28
80,8476312,Josh Manson,D,COL,33,82,8,20,28
80,8473563,Nicklas Backstrom,C,WSH,37,82,7,21,28
80,8482166,Shakir Mukhamadullin,D,SJS,22,82,7,21,28
80,8479976,Juuso Valimaki,D,UTA,26,82,6,22,28
80,8474574,Tyler Myers,D,VAN,34,82,4,24,28
80,8475233,David Savard,D,MTL,34,82,4,24,28
80,8476278,Colin Blackwell,C,DAL,31,82,17,10,27
80,8475848,Brendan Gallagher,R,MTL,32,82,15,12,27
80,8477989,Christian Dvorak,C,MTL,28,82,14,13,27
80,8481477,Nico Sturm,C,SJS,29,82,13,14,27
80,8478133,Jake Evans,C,MTL,28,82,11,16,27
80,8484153,Leo Carlsson,C,ANA,20,82,10,17,27
80,8482074,Connor Zary,C,CGY,23,82,9,18,27
80,8479359,Beck Malenstyn,L,BUF,26,82,9,18,27
80,8477220,Nate Schmidt,D,FLA,33,82,8,19,27
80,8476422,Mike Reilly,D,NYI,31,82,6,21,27
80,8480878,Nils Lundkvist,D,DAL,24,82,5,22,27
80,8476331,Dylan DeMelo,D,WPG,31,82,3,24,27
80,8482655,J.J. Moser,D,TBL,24,82,2,25,27
80,8481580,Connor McMichael,C,WSH,23,82,16,10,26
80,8478432,Christian Fischer,R,DET,27,82,13,13,26
80,8480021,Jack Studnicka,C,LAK,25,82,12,14,26
80,8484203,Bradly Nadeau,L,CAR,19,82,11,15,26
80,8480995,Pontus Holmberg,R,TOR,25,82,11,15,26
80,8477406,Mattias Janmark,C,EDM,32,82,11,15,26
80,8481524,Bowen Byram,D,BUF,23,82,11,15,26
80,8481601,Simon Holmstrom,R,NYI,23,82,10,16,26
80,8482809,Jackson Blake,R,CAR,21,82,9,17,26
80,8478013,Jake Walman,D,SJS,28,82,6,20,26
80,8475188,Brayden McNabb,D,VGK,33,82,4,22,26
80,8476902,Esa Lindell,D,DAL,30,82,3,23,26
80,8480807,Mattias Samuelsson,D,BUF,24,82,1,25,26
80,8482077,Dylan Holloway,L,EDM,23,82,15,10,25
80,8476878,Zemgus Girgensons,L,TBL,30,82,14,11,25
80,8478569,Noel Acciari,C,PIT,33,82,12,13,25
80,8482079,Marco Rossi,C,MIN,23,82,11,14,25
80,8478434,Keegan Kolesar,R,VGK,27,82,11,14,25
80,8479996,Cody Glass,C,NSH,25,82,9,16,25
80,8476473,Connor Murphy,D,CHI,31,82,7,18,25
80,8475762,Derek Forbort,D,VAN,32,82,6,19,25
80,8478500,Ivan Provorov,D,CBJ,27,82,5,20,25
80,8478178,Darren Raddysh,D,TBL,28,82,5,20,25
80,8476463,Jonas Brodin,D,MIN,31,82,5,20,25
80,8477365,Connor Clifton,D,BUF,29,82,5,20,25
80,8477435,Ryan Graves,D,PIT,29,82,5,20,25
80,8478840,Will Borgen,D,SEA,28,82,3,22,25
80,8477845,Trevor van Riemsdyk,D,WSH,33,82,2,23,25
80,8482259,Bobby McMann,C,TOR,28,82,14,10,24
80,8480074,Alexandre Texier,C,STL,25,82,12,12,24
80,8476889,Radek Faksa,C,STL,30,82,12,12,24
80,8479390,Taylor Raddysh,R,WSH,26,82,11,13,24
80,8483524,Shane Wright,C,SEA,20,82,11,13,24
80,8476872,Scott Laughton,C,PHI,30,82,10,14,24
80,8483505,Matthew Poitras,C,BOS,20,82,9,15,24
80,8476442,Matt Nieto,L,PIT,32,82,8,16,24
80,8480025,MacKenzie Entwistle,R,FLA,25,82,8,16,24
80,8482087,Kaiden Guhle,D,MTL,22,82,6,18,24
80,8479980,Nicolas Hague,D,VGK,26,82,6,18,24
80,8478851,Alexandre Carrier,D,NSH,28,82,5,19,24
80,8476467,Jamie Oleksiak,D,SEA,32,82,5,19,24
80,8480879,Jacob Bernard-Docker,D,OTT,24,82,5,19,24
80,8476931,Jake McCabe,D,TOR,31,82,4,20,24
80,8480873,Rasmus Sandin,D,WSH,24,82,3,21,24
80,8475181,Nick Leddy,D,STL,33,82,3,21,24
80,8475690,Chris Tanev,D,TOR,35,82,3,21,24
80,8475790,Erik Gudbranson,D,CBJ,32,82,3,21,24
80,8479591,Michael Eyssimont,C,TBL,28,82,12,11,23
80,8482659,Josh Doan,R,UTA,22,82,10,13,23
80,8484166,Adam Fantilli,C,CBJ,20,82,9,14,23
80,8476457,Adam Larsson,D,SEA,32,82,6,17,23
80,8476981,Josh Anderson,R,MTL,30,82,14,8,22
80,8482666,Scott Morrow,D,CAR,22,82,13,9,22
80,8482679,Matt Coronato,R,CGY,22,82,13,9,22
80,8477353,Tyler Motte,C,DET,29,82,10,12,22
80,8477508,Curtis Lazar,C,NJD,29,82,9,13,22
80,8483471,Brad Lambert,C,WPG,31,82,8,14,22
80,8475231,Casey Cizikas,C,NYI,33,82,7,15,22
80,8479324,Ryan Lindgren,D,NYR,26,82,3,19,22
80,8477335,Kyle Burroughs,D,LAK,29,82,3,19,22
80,8478399,Jonas Siegenthaler,D,NJD,27,82,2,20,22
80,8478508,Yakov Trenin,C,MIN,27,82,11,10,21
80,8483763,Maksymilian Szuber,D,UTA,22,82,10,11,21
80,8481032,Paul Cotter,C,NJD,25,82,10,11,21
80,8483482,Tristan Luneau,D,ANA,20,82,9,12,21
80,8482762,Simon Edvinsson,D,DET,21,82,8,13,21
80,8477499,Rasmus Ristolainen,D,PHI,30,82,6,15,21
80,8480796,Martin Fehervary,D,WSH,25,82,6,15,21
80,8482073,Braden Schneider,D,NYR,23,82,5,16,21
80,8476892,Colton Parayko,D,STL,31,82,4,17,21
80,8476525,Colin Miller,D,WPG,32,82,4,17,21
80,8476372,Nick Seeler,D,PHI,31,82,3,18,21
80,8476879,Cody Ceci,D,EDM,31,82,2,19,21
80,8475842,Sam Carrick,C,NYR,32,82,9,11,20
80,8483460,David Jiricek,D,CBJ,21,82,7,13,20
80,8482858,Ryker Evans,D,SEA,23,82,6,14,20
80,8479414,Nathan Bastian,R,NJD,27,82,5,15,20
80,8483445,Cutter Gauthier,L,ANA,20,82,5,15,20
80,8479983,Mario Ferraro,D,SJS,26,82,4,16,20
80,8475462,Radko Gudas,D,ANA,34,82,4,16,20
80,8483495,Simon Nemec,D,NJD,20,82,4,16,20
80,8474151,Ryan McDonagh,D,TBL,35,82,2,18,20
80,8476429,Scott Mayfield,D,NYI,32,82,2,18,20
80,8481641,Joel Kiviranta,L,COL,28,82,11,8,19
80,8479638,Justin Brazeau,R,BOS,26,82,11,8,19
80,8477507,Nikita Zadorov,D,BOS,29,82,4,15,19
80,8476967,Brett Kulak,D,EDM,30,82,3,16,19
80,8474567,Zach Bogosian,D,MIN,34,82,3,16,19
80,8481014,Alexander Romanov,D,NYI,24,82,2,17,19
80,8478859,Niko Mikkola,D,FLA,28,82,2,17,19
80,8475455,Brenden Dillon,D,NJD,34,82,1,18,19
80,8481178,Egor Zamula,D,PHI,24,82,1,18,19
80,8476858,Phillip Di Giuseppe,L,VAN,31,82,13,5,18
80,8477839,Conor Sheary,L,TBL,32,82,9,9,18
80,8477931,Tomas Nosek,L,FLA,32,82,7,11,18
80,8480073,Erik Brannstrom,D,COL,25,82,5,13,18
80,8483499,Liam Ohgren,L,MIN,20,82,5,13,18
80,8478416,Erik Cernak,D,TBL,27,82,4,14,18
80,8481568,Alex Vlasic,D,CHI,23,82,4,14,18
80,8481567,Henry Thrun,D,SJS,23,82,4,14,18
80,8482142,Jamie Drysdale,D,PHI,22,82,3,15,18
80,8483490,Pavel Mintyukov,D,ANA,21,82,2,16,18
80,8480860,Kevin Bahl,D,CGY,24,82,2,16,18
80,8482702,Logan Stankoven,C,DAL,21,82,9,8,17
80,8477505,Alexander Wennberg,C,SJS,30,82,8,9,17
80,8480448,Parker Kelly,L,COL,25,82,6,11,17
80,8477903,Garnet Hathaway,R,PHI,33,82,4,13,17
80,8480222,Sebastian Aho,D,PIT,28,82,3,14,17
80,8482803,Olen Zellweger,D,ANA,21,82,3,14,17
80,8478136,Jake Middleton,D,MIN,28,82,1,16,17
80,8480049,Dylan Samberg,D,WPG,25,82,0,17,17
80,8482070,Mitchell Chaffee,R,TBL,26,82,8,8,16
80,8480990,Declan Chisholm,D,MIN,24,82,5,11,16
80,8482624,Daniil Miromanov,D,CGY,27,82,4,12,16
80,8475324,Nick Jensen,D,OTT,34,82,2,14,16
80,8481605,Jackson LaCombe,D,ANA,23,82,2,14,16
80,8475279,Ben Chiarot,D,DET,33,82,1,15,16
80,8473507,Jeff Petry,D,DET,37,82,0,16,16
80,8484911,Collin Graf,R,SJS,22,82,7,8,15
80,8484149,Gavin Brindley,C,CBJ,20,82,7,8,15
80,8483468,Jiri Kulich,C,BUF,20,82,7,8,15
80,8483012,Logan Morrison,C,SEA,22,82,7,8,15
80,8483493,Frank Nazar,C,CHI,20,82,5,10,15
80,8482145,Mavrik Bourque,C,DAL,22,82,4,11,15
80,8476441,Joel Edmundson,D,LAK,31,82,3,12,15
80,8482470,Ilya Solovyov,D,CGY,24,82,3,12,15
80,8483565,Nick Blankenburg,D,NSH,26,82,2,13,15
80,8480950,Ilya Lyubushkin,D,DAL,30,82,2,13,15
80,8482749,Joshua Roy,R,MTL,21,82,7,7,14
80,8482101,Danil Gushchin,L,SJS,22,82,7,7,14
80,8471677,Jack Johnson,D,CBJ,37,82,5,9,14
80,8477034,Jaycob Megna,D,FLA,32,82,4,10,14
80,8470600,Ryan Suter,D,STL,39,82,2,12,14
80,8474013,Ian Cole,D,UTA,35,82,1,13,14
80,8480172,Jan Rutta,D,SJS,34,82,1,13,14
80,8474612,Travis Hamonic,D,OTT,34,82,1,13,14
80,8482153,Brendan Brisson,C,VGK,23,82,6,7,13
80,8482733,Logan Mailloux,D,MTL,31,82,4,9,13
80,8479442,Troy Stecher,D,EDM,30,82,3,10,13
80,8474090,Brendan Smith,D,DAL,35,82,3,10,13
80,8476891,Matt Grzelcyk,D,PIT,30,82,2,11,13
80,8478468,Jeremy Lauzon,D,NSH,27,82,2,11,13
80,8475718,Justin Holl,D,DET,32,82,0,13,13
80,8473453,Trevor Lewis,C,LAK,37,82,7,5,12
80,8481028,Martin Pospisil,C,CGY,25,82,6,6,12
80,8481699,Aku Raty,R,UTA,23,82,6,6,12
80,8482712,Oskar Olausson,R,COL,22,82,6,6,12
80,8480834,Ty Emberson,D,SJS,24,82,5,7,12
80,8479291,Kevin Rooney,C,CGY,31,82,5,7,12
80,8480870,Bo Groulx,C,NYR,24,82,9,2,11
80,8477938,Haydn Fleury,D,WPG,28,82,7,4,11
80,8483567,Georgii Merkulov,C,BOS,24,82,6,5,11
80,8479576,Vincent Desharnais,D,VAN,28,82,2,9,11
80,8478450,Parker Wotherspoon,D,BOS,27,82,2,9,11
80,8475177,Calvin de Haan,D,COL,33,82,0,11,11
80,8483489,Fraser Minten,C,TOR,31,82,4,6,10
80,8483466,Kevin Korchinski,D,CHI,20,82,3,7,10
80,8482787,Nikita Chibrikov,R,WPG,31,82,7,2,9
80,8481122,Simon Benoit,D,TOR,26,82,0,9,9
80,8478874,Adam Gaudette,C,OTT,28,82,0,9,9
80,8476822,Luke Glendening,C,TBL,35,82,5,3,8
80,8482713,Mackie Samoskevich,R,FLA,22,82,3,5,8
80,8482516,Matthew Kessel,D,STL,24,82,2,6,8
80,8482118,Sam Colangelo,R,ANA,23,82,1,7,8
80,8482859,Zack Ostapchuk,C,OTT,21,82,1,6,7
80,8474062,Riley Nash,C,NYR,35,82,2,4,6
80,8470794,Joe Pavelski,C,,40,0,0,0,0
80,8481703,Valtteri Puustinen,R,PIT,25,0,0,0,0
80,8477950,Tony DeAngelo,D,,29,0,0,0,0
80,8481577,Philip Tomasino,C,NSH,23,0,0,0,0
80,8475197,Tyson Barrie,D,,33,0,0,0,0
80,8471218,Blake Wheeler,R,,38,0,0,0,0
80,8474157,Max Pacioretty,L,,36,0,0,0,0
80,8478466,Daniel Sprong,R,VAN,27,0,0,0,0
80,8475744,Evgeny Kuznetsov,C,,32,0,0,0,0
80,8481019,David Gustafsson,C,WPG,24,0,0,0,0
80,8475906,John Klingberg,D,,32,0,0,0,0
80,8479348,Kale Clague,D,BUF,26,0,0,0,0
80,8476952,Dominic Toninato,C,WPG,30,0,0,0,0
80,8473473,Milan Lucic,L,,36,0,0,0,0
80,8474037,James van Riemsdyk,L,,35,0,0,0,0
80,8474602,Justin Schultz,D,,34,0,0,0,0
80,8482222,Alexander Barabanov,L,,30,0,0,0,0
80,8479372,Josh Mahura,D,SEA,26,0,0,0,0
80,8479982,Conor Timmins,D,TOR,26,0,0,0,0
80,8474031,Kevin Shattenkirk,D,,35,0,0,0,0
80,8480008,Adam Ruzicka,C,,25,0,0,0,0
80,8481059,Scott Perunovich,D,STL,26,0,0,0,0
80,8480884,Calen Addison,D,,24,0,0,0,0
80,8476994,Vinnie Hinostroza,C,NSH,30,0,0,0,0
80,8478452,Caleb Jones,D,LAK,27,0,0,0,0
80,8480157,Calle Rosen,D,COL,30,0,0,0,0
80,8481609,Vladislav Kolyachonok,D,UTA,23,0,0,0,0
80,8479415,Michael McLeod,C,,26,0,0,0,0
80,8476919,Chris Tierney,C,,30,0,0,0,0
80,8479639,Dylan Coghlan,D,WPG,26,0,0,0,0
80,8478146,Matthew Highmore,C,OTT,28,0,0,0,0
80,8478970,Jalen Chatfield,D,CAR,28,0,0,0,0
80,8480205,Emil Bemstrom,C,PIT,25,0,0,0,0
80,8474884,Mike Hoffman,C,,35,0,0,0,0
80,8471274,Alex Goligoski,D,,39,0,0,0,0
80,8478104,Sammy Blais,L,,28,0,0,0,0
80,8474870,Tyler Johnson,C,,34,0,0,0,0
80,8476913,Devin Shore,C,MIN,30,0,0,0,0
80,8481598,Philip Broberg,D,EDM,23,0,0,0,0
80,8480058,Pierre-Olivier Joseph,D,STL,25,0,0,0,0
80,8480891,Michael Kesselring,D,UTA,24,0,0,0,0
80,8477979,Nicolas Aube-Kubel,R,BUF,28,0,0,0,0
80,8476871,Tanner Pearson,L,,32,0,0,0,0
80,8476393,Nick Cousins,C,,31,0,0,0,0
80,8479977,Kailer Yamamoto,R,,26,0,0,0,0
80,8479543,Michael Pezzetta,L,MTL,26,0,0,0,0
80,8477018,Ben Hutton,D,VGK,31,0,0,0,0
80,8480762,Eric Robinson,L,CAR,29,0,0,0,0
80,8474034,Pat Maroon,L,CHI,36,0,0,0,0
80,8481058,Jesse Ylönen,R,,25,0,0,0,0
80,8475179,Dmitry Kulikov,D,FLA,34,0,0,0,0
80,8481527,Kaedan Korczak,D,VGK,23,0,0,0,0
80,8473449,Kyle Okposo,R,,36,0,0,0,0
80,8482192,Isaak Phillips,D,CHI,23,0,0,0,0
80,8480727,Zach Whitecloud,D,VGK,28,0,0,0,0
80,8479346,Dillon Dube,C,,26,0,0,0,0
80,8480821,Filip Zadina,R,,25,0,0,0,0
80,8480001,Urho Vaakanainen,D,ANA,25,0,0,0,0
80,8470966,Mark Giordano,D,,41,0,0,0,0
80,8480853,Liam Foudy,C,,24,0,0,0,0
80,8475225,Craig Smith,C,CHI,35,0,0,0,0
80,8479972,Mason Shaw,C,WPG,26,0,0,0,0
80,8478451,Ethan Bear,D,WSH,27,0,0,0,0
80,8474040,Sam Gagner,C,,35,0,0,0,0
80,8480196,Jacob Bryson,D,BUF,27,0,0,0,0
80,8479984,Cal Foote,D,,26,0,0,0,0
80,8480011,Klim Kostin,C,SJS,25,0,0,0,0
80,8482176,Wyatt Kaiser,D,CHI,22,0,0,0,0
80,8476988,Matt Benning,D,SJS,30,0,0,0,0
80,8479370,Tyson Jost,C,CAR,26,0,0,0,0
80,8477464,Nic Petan,C,,29,0,0,0,0
80,8477380,Jonny Brodzinski,C,NYR,31,0,0,0,0
80,8480070,Ian Mitchell,D,BOS,25,0,0,0,0
80,8479315,Joey Anderson,R,CHI,26,0,0,0,0
80,8478099,Kevin Labanc,R,,29,0,0,0,0
80,8476874,Olli Maatta,D,DET,30,0,0,0,0
80,8475208,Brian Dumoulin,D,ANA,33,0,0,0,0
80,8478430,Oliver Kylington,D,,27,0,0,0,0
80,8479536,Axel Jonsson-Fjallby,L,WPG,26,0,0,0,0
80,8479671,Mathieu Olivier,R,CBJ,27,0,0,0,0
80,8471709,Marc-Edouard Vlasic,D,SJS,37,0,0,0,0
80,8479328,Julien Gauthier,R,NYI,27,0,0,0,0
80,8478421,A.J. Greer,L,FLA,28,0,0,0,0
80,8477573,Nathan Walker,L,STL,30,0,0,0,0
80,8481537,Nikita Okhotiuk,D,CGY,24,0,0,0,0
80,8474166,Alec Martinez,D,CHI,37,0,0,0,0
80,8470610,Zach Parise,L,,40,0,0,0,0
80,8477478,William Carrier,L,CAR,30,0,0,0,0
80,8479344,Jesse Puljujarvi,R,PIT,26,0,0,0,0
80,8480887,Jordan Harris,D,MTL,24,0,0,0,0
80,8478502,Dennis Gilbert,D,BUF,28,0,0,0,0
80,8482730,Brandt Clarke,D,LAK,21,0,0,0,0
80,8480355,Mark Kastelic,C,BOS,25,0,0,0,0
80,8475750,Jon Merrill,D,MIN,32,0,0,0,0
80,8475164,Jakob Silfverberg,R,,34,0,0,0,0
80,8477944,Jakub Vrana,L,,28,0,0,0,0
80,8479439,Jacob MacDonald,D,COL,31,0,0,0,0
80,8474568,Luke Schenn,D,NSH,35,0,0,0,0
80,8478454,Noah Juulsen,D,VAN,27,0,0,0,0
80,8475752,Tyler Pitlick,C,,33,0,0,0,0
80,8482148,Hendrix Lapierre,C,WSH,22,0,0,0,0
80,8481167,Brayden Pachal,D,CGY,25,0,0,0,0
80,8478043,Sam Lafferty,C,BUF,29,0,0,0,0
80,8479321,Lucas Johansen,D,,27,0,0,0,0
80,8471699,Andrew Cogliano,C,,37,0,0,0,0
80,8481521,Ronnie Attard,D,PHI,25,0,0,0,0
80,8481161,Jake Christiansen,D,CBJ,25,0,0,0,0
80,8479458,Nikita Zaitsev,D,,33,0,0,0,0
80,8479619,Michael Carcone,L,UTA,28,0,0,0,0
80,8479026,Philippe Myers,D,TOR,27,0,0,0,0
80,8477330,Dominik Kubalik,L,,29,0,0,0,0
80,8481617,Vasily Podkolzin,R,VAN,23,0,0,0,0
80,8481701,Santeri Hatakka,D,NJD,23,0,0,0,0
80,8479514,Rem Pitlick,C,,27,0,0,0,0
80,8477446,Michael McCarron,R,NSH,29,0,0,0,0
80,8470604,Jeff Carter,C,,39,0,0,0,0
80,8482241,Radim Zohorna,L,,28,0,0,0,0
80,8480289,Morgan Barron,C,WPG,26,0,0,0,0
80,8479379,Givani Smith,R,SJS,26,0,0,0,0
80,8480216,Jacob Peterson,C,,25,0,0,0,0
80,8477851,Jordan Oesterle,D,BOS,32,0,0,0,0
80,8484258,Sam Malinski,D,COL,26,0,0,0,0
80,8478904,Steven Lorentz,C,,28,0,0,0,0
80,8482095,Tyler Kleven,D,OTT,22,0,0,0,0
80,8480848,Ty Dellandrea,C,SJS,24,0,0,0,0
80,8476884,Derrick Pouliot,D,,30,0,0,0,0
80,8479336,Carl Grundstrom,R,SJS,27,0,0,0,0
80,8482964,Arber Xhekaj,D,MTL,23,0,0,0,0
80,8471686,Marc Staal,D,,37,0,0,0,0
80,8477887,Patrick Brown,C,BOS,32,0,0,0,0
80,8478495,Denis Gurianov,R,,27,0,0,0,0
80,8473504,Cal Clutterbuck,R,,37,0,0,0,0
80,8481550,Adam Beckman,L,NJD,23,0,0,0,0
80,8480845,Rasmus Kupari,C,WPG,24,0,0,0,0
80,8474009,Nick Bonino,C,,36,0,0,0,0
80,8478585,Derek Ryan,C,EDM,38,0,0,0,0
80,8477962,Brendan Lemieux,L,CAR,28,0,0,0,0
80,8482861,Vincent Iorio,D,WSH,22,0,0,0,0
80,8479378,Logan Stanley,D,WPG,26,0,0,0,0
80,8473446,Erik Johnson,D,PHI,36,0,0,0,0
80,8481743,Marc Del Gaizo,D,NSH,25,0,0,0,0
80,8477384,Josh Brown,D,EDM,30,0,0,0,0
80,8482165,Yan Kuznetsov,D,CGY,22,0,0,0,0
80,8478424,Jansen Harkins,C,ANA,27,0,0,0,0
80,8482144,Jack Thompson,D,SJS,22,0,0,0,0
80,8478512,Austin Czarnik,C,,32,0,0,0,0
80,8477527,Ross Johnston,L,ANA,30,0,0,0,0
80,8479383,Boris Katchouk,L,,26,0,0,0,0
80,8482094,Daemon Hunt,D,MIN,22,0,0,0,0
80,8481719,Maxwell Crozier,D,TBL,24,0,0,0,0
80,8480192,Johnathan Kovacevic,D,NJD,27,0,0,0,0
80,8479376,Victor Mete,D,,26,0,0,0,0
80,8482511,Mason Lohrei,D,BOS,23,0,0,0,0
80,8475825,Jani Hakanpää,D,,32,0,0,0,0
80,8478021,William Lagesson,D,DET,28,0,0,0,0
80,8475795,Dylan McIlrath,D,WSH,32,0,0,0,0
80,8477846,Ryan Carpenter,C,,33,0,0,0,0
80,8481056,Spencer Stastney,D,NSH,24,0,0,0,0
80,8481564,Ryan Johnson,D,BUF,23,0,0,0,0
80,8478017,Mark Friedman,D,VAN,29,0,0,0,0
80,8479320,Max Lajoie,D,SEA,27,0,0,0,0
80,8480075,Cameron Crotty,D,MIN,25,0,0,0,0
80,8484287,Cole McWard,D,VAN,23,0,0,0,0
80,8484254,Akito Hirose,D,VAN,25,0,0,0,0
80,8483407,Brandon Scanlin,D,NYR,25,0,0,0,0
80,8480274,Philip Kemp,D,EDM,25,0,0,0,0
80,8479522,Hardy Haman Aktell,D,WSH,26,0,0,0,0
80,8480007,Jonas Rondbjerg,R,VGK,25,0,0,0,0
80,8477454,Adam Erne,L,,29,0,0,0,0
80,8481679,Maxence Guenette,D,OTT,23,0,0,0,0
80,8480441,Trey Fix-Wolansky,R,CBJ,25,0,0,0,0
80,8483546,Marshall Rifai,D,TOR,26,0,0,0,0
80,8480084,Nick DeSimone,D,NJD,30,0,0,0,0
80,8481030,Jack St. Ivany,D,PIT,25,0,0,0,0
80,8481592,Jakob Pelletier,L,CGY,23,0,0,0,0
80,8478011,Louie Belpedio,D,PHI,28,0,0,0,0
80,8477930,Pierre-Edouard Bellemare,L,,39,0,0,0,0
80,8484321,Nikolas Matinpalo,D,OTT,26,0,0,0,0
80,8482067,Connor Mackey,D,NYR,28,0,0,0,0
80,8481806,Louis Crevier,D,CHI,23,0,0,0,0
80,8484326,Patrik Koch,D,UTA,28,0,0,0,0
80,8477971,Andreas Englund,D,LAK,28,0,0,0,0
80,8481751,Lukas Rousek,R,BUF,25,0,0,0,0
80,8481006,Tyler Tucker,D,STL,24,0,0,0,0
80,8476867,Brendan Gaunce,C,MIN,30,0,0,0,0
80,8479520,Brandon Duhaime,R,WSH,27,0,0,0,0
80,8477073,Kurtis MacDermid,L,NJD,30,0,0,0,0
80,8480874,Adam Ginning,D,PHI,24,0,0,0,0
80,8477473,Justin Bailey,R,SJS,29,0,0,0,0
80,8479066,Ryan Lomberg,L,CGY,30,0,0,0,0
80,8477070,Liam O'Brien,C,UTA,30,0,0,0,0
80,8474618,Marco Scandella,D,,34,0,0,0,0
80,8475797,Jarred Tinordi,D,,32,0,0,0,0
80,8481441,Joe Snively,C,DET,28,0,0,0,0
80,8477244,Chad Ruhwedel,D,NYR,34,0,0,0,0
80,8479772,Zack MacEwen,R,OTT,28,0,0,0,0
80,8481147,Reese Johnson,C,MIN,26,0,0,0,0
80,8481043,Cole Koepke,L,BOS,26,0,0,0,0
80,8483619,Filip Roos,D,OTT,25,0,0,0,0
80,8481541,Samuel Bolduc,D,NYI,24,0,0,0,0
80,8477810,Joel Hanley,D,CGY,33,0,0,0,0
80,8476907,Mackenzie MacEachern,L,,30,0,0,0,0
80,8482652,Walker Duehr,R,CGY,27,0,0,0,0
80,8477126,Jayson Megna,C,,34,0,0,0,0
80,8483398,Declan Carlile,D,TBL,31,0,0,0,0
80,8482929,Emil Lilleberg,D,TBL,23,0,0,0,0
80,8480880,Jakub Lauko,C,MIN,24,0,0,0,0
80,8480245,Olle Lycksell,R,PHI,25,0,0,0,0
80,8480252,Cole Guttman,C,CHI,25,0,0,0,0
80,8477467,Gustav Olofsson,D,SEA,30,0,0,0,0
80,8479968,Vinni Lettieri,C,BOS,29,0,0,0,0
80,8478400,Colin White,C,,27,0,0,0,0
80,8475755,Alexander Petrovic,D,DAL,32,0,0,0,0
80,8481812,Nikolai Knyzhov,D,,27,0,0,0,0
80,8481593,Jayden Struble,D,MTL,23,0,0,0,0
80,8481532,Alex Turcotte,C,LAK,23,0,0,0,0
80,8482126,Emil Andrae,D,PHI,31,0,0,0,0
80,8479944,Zach Aston-Reese,C,VGK,30,0,0,0,0
80,8471817,Ryan Reaves,R,TOR,37,0,0,0,0
80,8481206,John Ludvig,D,PIT,24,0,0,0,0
80,8481599,Victor Soderstrom,D,UTA,23,0,0,0,0
80,8480292,Carson Meyer,R,ANA,27,0,0,0,0
80,8482496,Nils Aman,C,VAN,24,0,0,0,0
80,8479718,Alex Barré-Boulet,C,MTL,27,0,0,0,0
80,8479994,Jaret Anderson-Dolan,C,WPG,25,0,0,0,0
80,8480184,Gustav Lindstrom,D,,26,0,0,0,0
80,8480890,Jan Jenik,R,OTT,24,0,0,0,0
80,8478067,Oskar Lindblom,L,,28,0,0,0,0
80,8476934,Brock McGinn,L,ANA,30,0,0,0,0
80,8479985,Cale Fleury,D,SEA,26,0,0,0,0
80,8484304,Uvis Balinskis,D,FLA,28,0,0,0,0
80,8479981,Jonah Gadjovich,L,FLA,26,0,0,0,0
80,8481716,Dmitri Voronkov,L,CBJ,24,0,0,0,0
80,8474709,Matt Martin,L,,35,0,0,0,0
80,8482634,Alex Steeves,C,TOR,25,0,0,0,0
80,8480823,Alexander Alexeyev,D,WSH,25,0,0,0,0
80,8477541,Dakota Mermis,D,TOR,30,0,0,0,0
80,8483491,Ivan Miroshnichenko,L,WSH,20,0,0,0,0
80,8478477,Mitchell Stephens,C,SEA,27,0,0,0,0
80,8481543,Nikita Alexandrov,C,STL,24,0,0,0,0
80,8479423,Alex Nylander,L,,26,0,0,0,0
80,8482451,Mikael Pyyhtia,L,CBJ,23,0,0,0,0
80,8478831,Kevin Stenlund,C,UTA,28,0,0,0,0
80,8480306,Grant Hutton,D,NYI,29,0,0,0,0
80,8478028,Fredrik Olofsson,L,,28,0,0,0,0
80,8477462,Robert Hagg,D,VGK,29,0,0,0,0
80,8477320,Anton Blidh,L,NYR,29,0,0,0,0
80,8482157,Will Cuylle,L,NYR,22,0,0,0,0
80,8482737,Zack Bolduc,C,STL,21,0,0,0,0
80,8481239,Samuel Fagemo,L,,24,0,0,0,0
80,8481600,Tobias Bjornfot,D,FLA,23,0,0,0,0
80,8478409,Anthony Richard,C,PHI,28,0,0,0,0
80,8474145,Robert Bortuzzo,D,,35,0,0,0,0
80,8475958,Michael Sgarbossa,C,WSH,32,0,0,0,0
80,8479986,Kole Lind,R,DAL,26,0,0,0,0
80,8479249,Andrew Poturalski,C,SJS,30,0,0,0,0
80,8479362,Riley Tufte,L,BOS,26,0,0,0,0
80,8479991,Jake Leschyshyn,C,NYR,25,0,0,0,0
80,8479587,Rhett Gardner,C,PHI,28,0,0,0,0
80,8482744,James Malatesta,L,CBJ,21,0,0,0,0
80,8478854,Ryan Shea,D,PIT,27,0,0,0,0
80,8481591,Sam Poulin,R,,23,0,0,0,0
80,8483512,Matt Savoie,C,EDM,20,0,0,0,0
80,8482102,Vasily Ponomarev,C,PIT,22,0,0,0,0
80,8482162,Roby Jarventie,L,EDM,22,0,0,0,0
80,8481016,Ruslan Iskhakov,C,,24,0,0,0,0
80,8482172,Landon Slaggert,L,CHI,22,0,0,0,0
80,8482747,Brennan Othmann,L,NYR,21,0,0,0,0
80,8480031,Maxime Comtois,L,,25,0,0,0,0
80,8480226,Marián Studenic,R,,26,0,0,0,0
80,8478408,Travis Dermott,D,,28,0,0,0,0
80,8481518,Nolan Foote,L,NJD,24,0,0,0,0
80,8479419,Brett Murray,L,BUF,26,0,0,0,0
80,8482088,Justin Sourdif,R,FLA,22,0,0,0,0
80,8482201,Gage Goncalves,C,TBL,23,0,0,0,0
80,8481578,Graeme Clarke,R,MIN,23,0,0,0,0
80,8482177,Marat Khusnutdinov,C,MIN,22,0,0,0,0
80,8481754,Nikita Nesterenko,C,ANA,23,0,0,0,0
80,8483531,Brian Halonen,L,NJD,25,0,0,0,0
80,8483920,Pierrick Dube,R,WSH,23,0,0,0,0
80,8480851,Akil Thomas,C,LAK,24,0,0,0,0
80,8475235,Nicolas Deslauriers,L,PHI,33,0,0,0,0
80,8482476,Emil Heineman,L,MTL,23,0,0,0,0
80,8477149,Scott Sabourin,R,SJS,32,0,0,0,0
80,8483549,Lucas Condotta,L,MTL,27,0,0,0,0
80,8482765,Isak Rosen,R,BUF,21,0,0,0,0
80,8481237,Kyle MacLean,C,NYI,25,0,0,0,0
80,8481024,Linus Karlsson,C,VAN,25,0,0,0,0
80,8481690,Tyler Angle,C,,24,0,0,0,0
80,8483570,Ben Meyers,C,SEA,26,0,0,0,0
80,8481655,Cole Schwindt,R,CGY,23,0,0,0,0
80,8481462,Mason Morelli,L,VGK,28,0,0,0,0
80,8483401,Marc Johnstone,R,PIT,28,0,0,0,0
80,8478956,Samuel Laberge,L,NJD,27,0,0,0,0
80,8479533,Joona Koppanen,L,,26,0,0,0,0
80,8482197,Adam Raska,R,MIN,23,0,0,0,0
80,8482250,Callahan Burke,C,VGK,27,0,0,0,0
80,8482784,Zach Dean,C,STL,21,0,0,0,0
80,8484255,Jason Polin,R,COL,25,0,0,0,0
80,8481077,John Leonard,L,,26,0,0,0,0
80,8481534,Raphael Lavoie,C,EDM,24,0,0,0,0
80,8483609,Adam Klapka,R,CGY,24,0,0,0,0
80,8482751,Ryan Winterton,C,SEA,21,0,0,0,0
80,8480267,Sammy Walker,C,MIN,25,0,0,0,0
80,8475766,Austin Watson,L,,32,0,0,0,0
80,8482460,Matt Rempe,C,NYR,22,0,0,0,0
80,8481065,Angus Crookshank,L,OTT,25,0,0,0,0
80,8481070,Hugh McGing,L,,26,0,0,0,0
80,8476323,Max McCormick,L,SEA,32,0,0,0,0
80,8483395,Arshdeep Bains,L,VAN,23,0,0,0,0
80,8484259,Ondrej Pavel,C,COL,31,0,0,0,0
80,8483432,Luca Del Bel Belluz,C,CBJ,31,0,0,0,0
80,8483045,Cameron Butler,R,CBJ,31,0,0,0,0
80,8482061,Brandon Biro,L,SEA,26,0,0,0,0
80,8477401,John Hayden,C,SEA,29,0,0,0,0
80,8475278,Byron Froese,C,,33,0,0,0,0
80,8478446,Glenn Gawdin,C,LAK,27,0,0,0,0
80,8477993,Justin Kirkland,C,CGY,28,0,0,0,0
80,8482147,Jean-Luc Foudy,C,COL,22,0,0,0,0
80,8480032,Shane Bowers,C,NJD,25,0,0,0,0
80,8479330,Brandon Gignac,C,MTL,27,0,0,0,0
80,8480776,Sheldon Rempal,R,,29,0,0,0,0
80,8475413,Justin Dowling,C,NJD,34,0,0,0,0
80,8481726,Adam Edstrom,C,NYR,24,0,0,0,0
80,8480844,Grigori Denisenko,L,VGK,24,0,0,0,0
80,8478147,Bokondji Imama,L,PIT,28,0,0,0,0
80,8478881,Brett Seney,L,CHI,28,0,0,0,0
80,8483630,Pavol Regenda,L,ANA,25,0,0,0,0
80,8480836,Jonathan Gruden,C,,24,0,0,0,0
80,8484314,Jiri Smejkal,L,,28,0,0,0,0
80,8475780,Chris Wagner,R,COL,33,0,0,0,0
80,8479546,Oskar Steen,C,,26,0,0,0,0
80,8483597,Milos Kelemen,L,UTA,25,0,0,0,0
80,8481789,Tye Kartye,L,SEA,23,0,0,0,0
80,8484325,Waltteri Merela,C,TBL,26,0,0,0,0
80,8479421,Jacob Moverare,D,LAK,26,0,0,0,0
80,8481585,Egor Afanasyev,L,SJS,23,0,0,0,0
80,8479547,Matthew Phillips,R,,26,0,0,0,0
80,8479367,William Lockwood,R,FLA,26,0,0,0,0
80,8476915,Jujhar Khaira,L,,30,0,0,0,0
80,8481422,Jacob Lucchini,C,NSH,29,0,0,0,0
80,8480468,James Hamblin,L,EDM,25,0,0,0,0
80,8478051,Max Willman,C,NJD,29,0,0,0,0
80,8481556,John Beecher,C,BOS,23,0,0,0,0
80,8478078,Rourke Chartier,C,,28,0,0,0,0
81,8478402,Connor McDavid,C,EDM,27,82,36,108,144
81,8477492,Nathan MacKinnon,C,COL,29,82,52,91,143
81,8481559,Jack Hughes,C,NJD,23,82,41,83,124
81,8476453,Nikita Kucherov,R,TBL,31,82,38,83,121
81,8478420,Mikko Rantanen,R,COL,28,82,54,60,114
81,8478864,Kirill Kaprizov,L,MIN,27,82,45,68,113
81,8479318,Auston Matthews,C,TOR,27,82,58,51,109
81,8477956,David Pastrnak,R,BOS,28,82,51,58,109
81,8477934,Leon Draisaitl,C,EDM,29,82,42,67,109
81,8480012,Elias Pettersson,C,VAN,26,82,46,61,107
81,8479314,Matthew Tkachuk,L,FLA,27,82,29,77,106
81,8477939,William Nylander,R,TOR,28,82,44,61,105
81,8476468,J.T. Miller,C,VAN,31,82,41,63,104
81,8478550,Artemi Panarin,L,NYR,33,82,38,66,104
81,8477493,Aleksander Barkov,C,FLA,29,82,35,68,103
81,8477942,Kevin Fiala,L,LAK,28,82,46,55,101
81,8480002,Nico Hischier,C,NJD,25,82,39,62,101
81,8476459,Mika Zibanejad,C,NYR,31,82,36,64,100
81,8479407,Jesper Bratt,L,NJD,26,82,34,66,100
81,8475172,Nazem Kadri,C,CGY,34,82,24,76,100
81,8478427,Sebastian Aho,C,CAR,27,82,33,63,96
81,8474600,Roman Josi,D,NSH,34,82,19,76,95
81,8471675,Sidney Crosby,C,PIT,37,82,40,53,93
81,8478439,Travis Konecny,R,PHI,27,82,39,54,93
81,8476887,Filip Forsberg,L,NSH,30,82,46,45,91
81,8479323,Adam Fox,D,NYR,26,82,12,78,90
81,8478010,Brayden Point,C,TBL,28,82,42,47,89
81,8479343,Clayton Keller,R,UTA,26,82,50,38,88
81,8474564,Steven Stamkos,C,NSH,34,82,41,46,87
81,8480027,Jason Robertson,L,DAL,25,82,33,54,87
81,8477402,Pavel Buchnevich,L,STL,29,82,33,54,87
81,8476460,Mark Scheifele,C,WPG,31,82,39,47,86
81,8477946,Dylan Larkin,C,DET,28,82,35,51,86
81,8475166,John Tavares,C,TOR,34,82,38,47,85
81,8480069,Cale Makar,D,COL,26,82,23,62,85
81,8481557,Matt Boldy,L,MIN,23,82,38,46,84
81,8477404,Jake Guentzel,C,TBL,30,82,33,51,84
81,8480023,Robert Thomas,C,STL,25,82,19,65,84
81,8480800,Quinn Hughes,D,VAN,25,82,16,68,84
81,8477501,Valeri Nichushkin,R,COL,29,82,45,38,83
81,8475913,Mark Stone,R,VGK,32,82,26,57,83
81,8477949,Alex Tuch,R,BUF,28,82,29,53,82
81,8481523,Kirby Dach,C,MTL,23,82,19,63,82
81,8478398,Kyle Connor,L,WPG,28,82,44,37,81
81,8477940,Nikolaj Ehlers,L,WPG,28,82,30,50,80
81,8478403,Jack Eichel,C,VGK,28,82,42,37,79
81,8478414,Timo Meier,R,NJD,28,82,40,39,79
81,8475798,Mikael Granlund,C,SJS,32,82,14,65,79
81,8479385,Jordan Kyrou,C,STL,26,82,42,36,78
81,8475726,Tyler Toffoli,C,SJS,32,82,42,36,78
81,8476346,Johnny Gaudreau,L,CBJ,31,82,19,59,78
81,8475784,Jeff Skinner,C,EDM,32,82,39,38,77
81,8477933,Sam Reinhart,C,FLA,29,82,36,41,77
81,8482116,Tim Stützle,C,OTT,22,82,33,44,77
81,8480801,Brady Tkachuk,L,OTT,25,82,38,38,76
81,8475810,Bryan Rust,R,PIT,32,82,32,44,76
81,8471215,Evgeni Malkin,C,PIT,38,82,27,49,76
81,8479420,Tage Thompson,C,BUF,27,82,36,39,75
81,8477409,Carter Verhaeghe,C,FLA,29,82,35,39,74
81,8475168,Matt Duchene,C,DAL,33,82,28,46,74
81,8473994,Jamie Benn,L,DAL,35,82,28,45,73
81,8480830,Andrei Svechnikov,R,CAR,24,82,25,48,73
81,8478460,Zach Werenski,D,CBJ,27,82,25,48,73
81,8476462,Dougie Hamilton,D,NJD,31,82,18,55,73
81,8480036,Miro Heiskanen,D,DAL,25,82,14,59,73
81,8477416,Oliver Bjorkstrand,R,SEA,29,82,31,41,72
81,8476853,Morgan Rielly,D,TOR,30,82,21,51,72
81,8479542,Brandon Hagel,L,TBL,26,82,38,33,71
81,8480018,Nick Suzuki,C,MTL,25,82,31,40,71
81,8479337,Alex DeBrincat,R,DET,27,82,28,43,71
81,8478445,Mathew Barzal,C,NYI,27,82,23,48,71
81,8474141,Patrick Kane,R,DET,36,82,22,49,71
81,8479325,Charlie McAvoy,D,BOS,27,82,15,56,71
81,8475167,Victor Hedman,D,TBL,34,82,11,60,71
81,8476881,Tomas Hertl,C,VGK,31,82,37,33,70
81,8478449,Roope Hintz,C,DAL,28,82,36,34,70
81,8480039,Martin Necas,C,CAR,25,82,29,41,70
81,8474150,Mikael Backlund,C,CGY,35,82,29,40,69
81,8477496,Elias Lindholm,C,BOS,30,82,23,46,69
81,8475692,Mats Zuccarello,R,MIN,37,82,20,49,69
81,8474578,Erik Karlsson,D,PIT,34,82,14,55,69
81,8476539,Jonathan Marchessault,R,NSH,34,82,36,32,68
81,8471214,Alex Ovechkin,L,WSH,39,82,33,35,68
81,8483808,Andrei Kuzmenko,L,CGY,28,82,32,36,68
81,8478873,Troy Terry,R,ANA,27,82,28,40,68
81,8477951,Nick Schmaltz,C,UTA,28,82,27,41,68
81,8476454,Ryan Nugent-Hopkins,C,EDM,31,82,19,49,68
81,8476456,Jonathan Huberdeau,C,CGY,31,82,16,52,68
81,8480865,Noah Dobson,D,NYI,24,82,10,58,68
81,8475184,Chris Kreider,L,NYR,33,82,41,26,67
81,8475786,Zach Hyman,L,EDM,32,82,38,29,67
81,8479339,Patrik Laine,L,CBJ,26,82,33,34,67
81,8482078,Lucas Raymond,L,DET,22,82,32,35,67
81,8476389,Vincent Trocheck,C,NYR,31,82,29,38,67
81,8475158,Ryan O'Reilly,C,NSH,33,82,24,43,67
81,8480208,Drake Batherson,R,OTT,26,82,18,49,67
81,8476479,Phillip Danault,C,LAK,31,82,29,37,66
81,8480803,Evan Bouchard,D,EDM,25,82,11,55,66
81,8482175,JJ Peterka,R,BUF,22,82,38,26,64
81,8475794,Tyler Seguin,C,DAL,32,82,35,29,64
81,8478047,Michael Bunting,L,PIT,29,82,25,39,64
81,8476905,Chandler Stephenson,C,SEA,30,82,16,48,64
81,8471685,Anze Kopitar,C,LAK,37,82,14,50,64
81,8482093,Seth Jarvis,C,CAR,22,82,37,26,63
81,8480015,Owen Tippett,R,PHI,25,82,30,33,63
81,8482097,Jack Quinn,R,BUF,23,82,28,35,63
81,8475765,Vladimir Tarasenko,R,DET,33,82,26,37,63
81,8473512,Claude Giroux,R,OTT,36,82,24,39,63
81,8473419,Brad Marchand,L,BOS,36,82,21,42,63
81,8480839,Rasmus Dahlin,D,BUF,24,82,18,45,63
81,8477504,Josh Morrissey,D,WPG,29,82,10,53,63
81,8477447,Shea Theodore,D,VGK,29,82,7,56,63
81,8480014,Gabriel Vilardi,C,WPG,25,82,41,21,62
81,8482109,Alexis Lafrenière,L,NYR,23,82,34,28,62
81,8481540,Cole Caufield,R,MTL,23,82,33,29,62
81,8482149,Cole Perfetti,C,WPG,22,82,27,35,62
81,8482665,Matty Beniers,C,SEA,22,82,24,38,62
81,8478493,Joel Eriksson Ek,C,MIN,27,82,22,40,62
81,8478444,Brock Boeser,R,VAN,27,82,24,37,61
81,8477960,Adrian Kempe,R,LAK,28,82,21,40,61
81,8475191,Reilly Smith,R,NYR,33,82,30,30,60
81,8477500,Bo Horvat,C,NYI,29,82,28,32,60
81,8477955,Jared McCann,L,SEA,28,82,32,27,59
81,8476875,Mike Matheson,D,MTL,30,82,14,45,59
81,8478975,Mason Marchment,L,DAL,29,82,27,31,58
81,8478042,Viktor Arvidsson,R,EDM,31,82,26,32,58
81,8478440,Dylan Strome,C,WSH,27,82,26,32,58
81,8482159,Tyson Foerster,R,PHI,22,82,26,32,58
81,8474679,Gustav Nyquist,C,NSH,35,82,20,38,58
81,8478038,Devon Toews,D,COL,30,82,13,45,58
81,8478366,Frank Vatrano,R,ANA,30,82,30,27,57
81,8478401,Pavel Zacha,C,BOS,27,82,24,33,57
81,8477964,Ivan Barbashev,C,VGK,29,82,23,34,57
81,8475745,Charlie Coyle,C,BOS,32,82,23,34,57
81,8479525,Ross Colton,C,COL,28,82,22,35,57
81,8478856,Conor Garland,R,VAN,28,82,20,37,57
81,8481596,Shane Pinto,C,OTT,24,82,26,30,56
81,8476438,Brandon Saad,L,STL,32,82,26,30,56
81,8476399,Blake Coleman,C,CGY,33,82,22,34,56
81,8476792,Torey Krug,D,STL,33,82,18,38,56
81,8474590,John Carlson,D,WSH,34,82,13,43,56
81,8482110,Dawson Mercer,C,NJD,23,82,30,25,55
81,8482740,Wyatt Johnston,C,DAL,21,82,28,27,55
81,8476882,Teuvo Teravainen,L,CHI,30,82,24,31,55
81,8477935,Sam Bennett,C,FLA,28,82,24,31,55
81,8476483,Rickard Rakell,R,PIT,31,82,24,31,55
81,8481528,Dylan Cozens,C,BUF,23,82,21,34,55
81,8475287,Erik Haula,L,NJD,33,82,20,35,55
81,8481711,Matias Maccelli,L,UTA,24,82,17,38,55
81,8479999,Casey Mittelstadt,C,COL,26,82,15,40,55
81,8471724,Kris Letang,D,PIT,37,82,9,46,55
81,8480064,Josh Norris,C,OTT,25,82,33,21,54
81,8478519,Anthony Cirelli,C,TBL,27,82,29,25,54
81,8479400,Pierre-Luc Dubois,L,WSH,26,82,26,28,54
81,8481533,Trevor Zegras,C,ANA,23,82,25,29,54
81,8475170,Brayden Schenn,C,STL,33,82,22,32,54
81,8473986,Alex Killorn,L,ANA,35,82,21,33,54
81,8480849,Barrett Hayton,C,UTA,24,82,19,35,54
81,8480434,Sean Durzi,D,UTA,26,82,10,44,54
81,8475151,Kyle Palmieri,C,NYI,33,82,34,19,53
81,8479675,Trevor Moore,L,LAK,29,82,22,31,53
81,8480797,Joel Farabee,L,PHI,24,82,18,35,53
81,8477346,MacKenzie Weegar,D,CGY,30,82,17,36,53
81,8470613,Brent Burns,D,CAR,39,82,11,42,53
81,8474565,Alex Pietrangelo,D,VGK,34,82,9,44,53
81,8475169,Evander Kane,L,EDM,33,82,31,21,52
81,8477456,J.T. Compher,L,DET,29,82,28,24,52
81,8482667,William Eklund,L,SJS,22,82,25,27,52
81,8482092,Ridly Greig,C,OTT,22,82,23,29,52
81,8477407,Anthony Duclair,L,NYI,29,82,20,32,52
81,8475768,Jaden Schwartz,C,SEA,32,82,19,33,52
81,8477494,Jonathan Drouin,L,COL,29,82,11,41,52
81,8476923,Damon Severson,D,CBJ,30,82,9,43,52
81,8482684,Luke Hughes,D,NJD,21,82,8,44,52
81,8479410,Mikhail Sergachev,D,UTA,26,82,7,45,52
81,8478474,Lawson Crouse,L,UTA,27,82,25,26,51
81,8482745,Mason McTavish,C,ANA,21,82,22,29,51
81,8480220,Noah Cates,L,PHI,25,82,21,30,51
81,8482105,Jake Sanderson,D,OTT,22,82,16,35,51
81,8477986,Brandon Montour,D,SEA,30,82,13,38,51
81,8476448,William Karlsson,C,VGK,31,82,26,24,50
81,8477479,Tyler Bertuzzi,L,CHI,29,82,24,26,50
81,8478438,Tommy Novak,C,NSH,27,82,20,30,50
81,8482660,Kent Johnson,C,CBJ,22,82,18,32,50
81,8478055,Gustav Forsling,D,FLA,28,82,14,36,50
81,8478472,Mathieu Joseph,R,STL,27,82,14,36,50
81,8477476,Artturi Lehkonen,L,COL,29,82,27,22,49
81,8482113,Anton Lundell,C,FLA,23,82,25,24,49
81,8482699,Dylan Guenther,R,UTA,21,82,25,24,49
81,8480009,Eeli Tolvanen,R,SEA,25,82,24,25,49
81,8482124,Quinton Byfield,R,LAK,22,82,21,28,49
81,8471698,T.J. Oshie,R,WSH,38,82,20,29,49
81,8475760,Nick Bjugstad,C,UTA,32,82,20,29,49
81,8475218,Mattias Ekholm,D,EDM,34,82,17,32,49
81,8478397,Rasmus Andersson,D,CGY,28,82,9,40,49
81,8481554,Kaapo Kakko,R,NYR,23,82,25,23,48
81,8475754,Brock Nelson,C,NYI,33,82,24,24,48
81,8481656,Aliaksei Protas,C,WSH,23,82,22,26,48
81,8480028,Morgan Frost,C,PHI,25,82,21,27,48
81,8480078,Filip Chytil,C,NYR,25,82,17,31,48
81,8476458,Ryan Strome,C,ANA,31,82,17,31,48
81,8478396,Noah Hanifin,D,VGK,27,82,9,39,48
81,8478407,Vince Dunn,D,SEA,28,82,7,41,48
81,8474641,Adam Henrique,C,EDM,34,82,23,24,47
81,8480188,Fabian Zetterlund,L,SJS,25,82,22,25,47
81,8477429,Andrew Copp,C,DET,30,82,16,31,47
81,8479992,Michael Rasmussen,C,DET,25,82,15,32,47
81,8480802,Ryan McLeod,C,BUF,25,82,15,32,47
81,8474563,Drew Doughty,D,LAK,35,82,5,42,47
81,8477497,Sean Monahan,C,CBJ,30,82,26,20,46
81,8476329,Travis Boyd,C,MIN,31,82,21,25,46
81,8478542,Evan Rodrigues,C,FLA,31,82,14,32,46
81,8476854,Hampus Lindholm,D,BOS,30,82,10,36,46
81,8478469,Thomas Chabot,D,OTT,27,82,8,38,46
81,8479425,Filip Hronek,D,VAN,27,82,8,38,46
81,8477932,Aaron Ekblad,D,FLA,28,82,8,38,46
81,8477998,Warren Foegele,L,LAK,28,82,27,18,45
81,8481068,Yegor Sharangovich,C,CGY,26,82,24,21,45
81,8474586,Jordan Eberle,R,SEA,34,82,24,21,45
81,8475714,Calle Jarnkrok,C,TOR,33,82,22,23,45
81,8477451,Ryan Hartman,R,MIN,30,82,21,24,45
81,8478020,Michael Amadio,C,OTT,28,82,15,30,45
81,8478458,Jack Roslovic,C,CAR,27,82,13,32,45
81,8480043,Timothy Liljegren,D,TOR,25,82,9,36,45
81,8477495,Seth Jones,D,CHI,30,82,8,37,45
81,8476906,Shayne Gostisbehere,D,CAR,31,82,7,38,45
81,8475764,Cam Fowler,D,ANA,33,82,5,40,45
81,8477426,Nicholas Paul,L,TBL,29,82,24,20,44
81,8476880,Tom Wilson,R,WSH,30,82,23,21,44
81,8476419,Jean-Gabriel Pageau,C,NYI,32,82,15,29,44
81,8475763,Kevin Hayes,R,PIT,32,82,15,29,44
81,8480003,Jesper Boqvist,C,FLA,26,82,15,29,44
81,8476958,Jaccob Slavin,D,CAR,30,82,11,33,44
81,8475193,Tomas Tatar,L,NJD,34,82,25,18,43
81,8481013,Jonatan Berggren,R,DET,24,82,22,21,43
81,8475799,Nino Niederreiter,R,WPG,32,82,20,23,43
81,8476292,Ondrej Palat,L,NJD,33,82,20,23,43
81,8481618,Alex Newhook,C,MTL,23,82,19,24,43
81,8473563,Nicklas Backstrom,C,WSH,37,82,14,29,43
81,8477503,Max Domi,C,TOR,29,82,12,31,43
81,8480798,Philipp Kurashev,C,CHI,25,82,11,32,43
81,8482655,J.J. Moser,D,TBL,24,82,8,35,43
81,8477511,Anthony Mantha,R,CGY,30,82,23,19,42
81,8481604,Pavel Dorofeyev,L,VGK,24,82,21,21,42
81,8476918,Jimmy Vesey,L,NYR,31,82,21,21,42
81,8475722,Jason Zucker,L,BUF,32,82,20,22,42
81,8483515,Juraj Slafkovsky,L,MTL,20,82,19,23,42
81,8475793,Ryan Johansen,C,PHI,32,82,18,24,42
81,8479365,Trent Frederic,C,BOS,26,82,16,26,42
81,8480145,Neal Pionk,D,WPG,29,82,13,29,42
81,8477948,Travis Sanheim,D,PHI,28,82,9,33,42
81,8480817,K'Andre Miller,D,NYR,24,82,6,36,42
81,8482475,Yegor Chinakhov,R,CBJ,23,82,16,25,41
81,8480829,Jesperi Kotkaniemi,C,CAR,24,82,16,25,41
81,8477021,Alex Kerfoot,C,UTA,30,82,12,29,41
81,8481581,Thomas Harley,D,DAL,23,82,11,30,41
81,8481542,Moritz Seider,D,DET,23,82,6,35,41
81,8478498,Jake DeBrusk,L,VAN,28,82,20,20,40
81,8477953,Kasperi Kapanen,R,STL,28,82,19,21,40
81,8478057,Dakota Joshua,C,VAN,28,82,18,22,40
81,8476872,Scott Laughton,C,PHI,30,82,18,22,40
81,8477952,Robby Fabbri,C,ANA,28,82,16,24,40
81,8484144,Connor Bedard,C,CHI,19,82,15,25,40
81,8474102,David Perron,L,OTT,36,82,14,26,40
81,8475753,Justin Faulk,D,STL,32,82,7,33,40
81,8477444,Andre Burakovsky,L,SEA,29,82,18,21,39
81,8480459,Pius Suter,C,VAN,28,82,18,21,39
81,8481560,Arthur Kaliyev,R,LAK,23,82,17,22,39
81,8478115,Pierre Engvall,L,NYI,28,82,17,22,39
81,8474149,Evgenii Dadonov,R,DAL,35,82,16,23,39
81,8479996,Cody Glass,C,NSH,25,82,16,23,39
81,8479345,Jakob Chychrun,D,WSH,26,82,14,25,39
81,8476392,Adam Lowry,C,WPG,31,82,12,27,39
81,8476925,Colton Sissons,C,NSH,31,82,10,29,39
81,8482055,Drew O'Connor,L,PIT,26,82,24,14,38
81,8481186,Logan O'Connor,R,COL,28,82,20,18,38
81,8479591,Michael Eyssimont,C,TBL,28,82,17,21,38
81,8484203,Bradly Nadeau,L,CAR,19,82,15,23,38
81,8480185,Eetu Luostarinen,C,FLA,26,82,10,28,38
81,8482671,Owen Power,D,BUF,22,82,8,30,38
81,8482125,Alexander Holtz,R,VGK,22,82,22,15,37
81,8479987,Morgan Geekie,C,BOS,26,82,21,16,37
81,8479293,Brandon Tanev,L,SEA,33,82,21,16,37
81,8476432,Boone Jenner,C,CBJ,31,82,20,17,37
81,8478233,Andrew Mangiapane,L,WSH,28,82,19,18,37
81,8478463,Anthony Beauvillier,L,PIT,27,82,18,19,37
81,8475791,Taylor Hall,L,CHI,33,82,16,21,37
81,8481582,Nicholas Robertson,L,TOR,23,82,12,25,37
81,8481606,Jordan Spence,D,LAK,23,82,9,28,37
81,8476927,Teddy Blueger,C,VAN,30,82,8,29,37
81,8476869,Brady Skjei,D,NSH,30,82,8,29,37
81,8477969,Marcus Pettersson,D,PIT,28,82,8,29,37
81,8477498,Darnell Nurse,D,EDM,29,82,8,29,37
81,8475314,Anders Lee,L,NYI,34,82,17,19,36
81,8474716,Jared Spurgeon,D,MIN,35,82,16,20,36
81,8476474,Stefan Noesen,R,NJD,31,82,15,21,36
81,8475149,Marcus Johansson,L,MIN,34,82,13,23,36
81,8476826,Yanni Gourde,C,SEA,33,82,12,24,36
81,8478413,Jordan Greenway,L,BUF,27,82,12,24,36
81,8478891,Mason Appleton,C,WPG,28,82,11,25,36
81,8476461,Sean Couturier,C,PHI,32,82,11,25,36
81,8481546,Cam York,D,PHI,23,82,10,26,36
81,8481708,Zac Jones,D,NYR,24,82,8,28,36
81,8473422,Nick Foligno,L,CHI,37,82,20,15,35
81,8482146,Luke Evangelista,R,NSH,22,82,17,18,35
81,8474189,Lars Eller,C,PIT,35,82,16,19,35
81,8480871,Adam Boqvist,D,FLA,24,82,15,20,35
81,8479351,Sam Steel,C,DAL,26,82,14,21,35
81,8482624,Daniil Miromanov,D,CGY,27,82,14,21,35
81,8478046,Danton Heinen,L,VAN,29,82,13,22,35
81,8476885,Jacob Trouba,D,NYR,30,82,5,30,35
81,8480068,Ryan Poehling,C,PHI,25,82,19,15,34
81,8481481,Blake Lizotte,C,PIT,27,82,19,15,34
81,8482705,Cole Sillinger,C,CBJ,21,82,15,19,34
81,8474715,Cam Atkinson,R,TBL,35,82,13,21,34
81,8479983,Mario Ferraro,D,SJS,26,82,8,26,34
81,8476331,Dylan DeMelo,D,WPG,31,82,7,27,34
81,8476979,Erik Gustafsson,D,DET,32,82,6,28,34
81,8480049,Dylan Samberg,D,WPG,25,82,4,30,34
81,8473507,Jeff Petry,D,DET,37,82,4,30,34
81,8483457,Lane Hutson,D,MTL,20,82,16,17,33
81,8475848,Brendan Gallagher,R,MTL,32,82,15,18,33
81,8476873,Mark Jankowski,C,NSH,30,82,14,19,33
81,8477919,Frederick Gaudreau,C,MIN,31,82,12,21,33
81,8477839,Conor Sheary,L,TBL,32,82,12,21,33
81,8481553,Bobby Brink,R,PHI,23,82,9,24,33
81,8476480,Vladislav Namestnikov,C,WPG,32,82,9,24,33
81,8482111,Justin Barron,D,MTL,23,82,8,25,33
81,8476931,Jake McCabe,D,TOR,31,82,5,28,33
81,8476902,Esa Lindell,D,DAL,30,82,2,31,33
81,8480873,Rasmus Sandin,D,WSH,24,82,2,31,33
81,8482155,Alex Laferriere,R,LAK,23,82,21,11,32
81,8482089,Jake Neighbours,L,STL,22,82,19,13,32
81,8481704,Juuso Parssinen,C,NSH,23,82,17,15,32
81,8477353,Tyler Motte,C,DET,29,82,17,15,32
81,8473533,Jordan Staal,C,CAR,36,82,16,16,32
81,8480748,Kiefer Sherwood,L,VAN,29,82,16,16,32
81,8476278,Colin Blackwell,C,DAL,31,82,13,19,32
81,8475200,Dmitry Orlov,D,CAR,33,82,9,23,32
81,8477488,Brett Pesce,D,NJD,30,82,5,27,32
81,8481032,Paul Cotter,C,NJD,25,82,18,13,31
81,8478462,Nicolas Roy,C,VGK,27,82,16,15,31
81,8476469,Joel Armia,R,MTL,31,82,13,18,31
81,8480336,Sean Walker,D,CAR,30,82,13,18,31
81,8482720,Matthew Knies,L,TOR,22,82,11,20,31
81,8474053,Logan Couture,C,SJS,35,82,11,20,31
81,8482133,Thomas Bordeleau,C,SJS,22,82,10,21,31
81,8475181,Nick Leddy,D,STL,33,82,10,21,31
81,8475343,Nic Dowd,C,WSH,34,82,8,23,31
81,8476917,Adam Pelech,D,NYI,30,82,8,23,31
81,8479398,Samuel Girard,D,COL,26,82,6,25,31
81,8476891,Matt Grzelcyk,D,PIT,30,82,3,28,31
81,8482122,Brock Faber,D,MIN,22,82,2,29,31
81,8478109,Victor Olofsson,L,VGK,29,82,18,12,30
81,8483431,Logan Cooley,C,UTA,20,82,17,13,30
81,8478569,Noel Acciari,C,PIT,33,82,16,14,30
81,8475855,Jesper Fast,R,CAR,33,82,14,16,30
81,8478508,Yakov Trenin,C,MIN,27,82,14,16,30
81,8477015,Connor Brown,R,EDM,30,82,13,17,30
81,8481580,Connor McMichael,C,WSH,23,82,13,17,30
81,8482809,Jackson Blake,R,CAR,21,82,13,17,30
81,8475220,Marcus Foligno,L,MIN,33,82,11,19,30
81,8477507,Nikita Zadorov,D,BOS,29,82,8,22,30
81,8475171,Oliver Ekman-Larsson,D,TOR,33,82,7,23,30
81,8474574,Tyler Myers,D,VAN,34,82,5,25,30
81,8476463,Jonas Brodin,D,MIN,31,82,5,25,30
81,8476467,Jamie Oleksiak,D,SEA,32,82,5,25,30
81,8480835,Jack Drury,C,CAR,24,82,18,11,29
81,8479941,Justin Danforth,R,CBJ,31,82,16,13,29
81,8480855,Jack McBain,C,UTA,24,82,12,17,29
81,8480813,Joe Veleno,C,DET,24,82,12,17,29
81,8478133,Jake Evans,C,MTL,28,82,12,17,29
81,8484166,Adam Fantilli,C,CBJ,20,82,11,18,29
81,8478013,Jake Walman,D,SJS,28,82,9,20,29
81,8483495,Simon Nemec,D,NJD,20,82,8,21,29
81,8479998,Mikey Anderson,D,LAK,25,82,7,22,29
81,8482245,Artem Zub,D,OTT,29,82,3,26,29
81,8481014,Alexander Romanov,D,NYI,24,82,3,26,29
81,8481178,Egor Zamula,D,PHI,24,82,3,26,29
81,8481535,Nils Hoglander,L,VAN,24,82,19,9,28
81,8477987,Ryan Donato,C,CHI,28,82,18,10,28
81,8482074,Connor Zary,C,CGY,23,82,18,10,28
81,8480113,Alex Iafallo,L,WPG,31,82,14,14,28
81,8480980,Connor Dewar,C,TOR,25,82,10,18,28
81,8479402,Jake Bean,D,CGY,26,82,7,21,28
81,8478911,Matt Roy,D,WSH,29,82,7,21,28
81,8476892,Colton Parayko,D,STL,31,82,7,21,28
81,8475790,Erik Gudbranson,D,CBJ,32,82,5,23,28
81,8479324,Ryan Lindgren,D,NYR,26,82,3,25,28
81,8479393,Noah Gregor,C,OTT,26,82,17,10,27
81,8477425,Miles Wood,L,COL,29,82,17,10,27
81,8478211,Dryden Hunt,L,CGY,29,82,15,12,27
81,8481477,Nico Sturm,C,SJS,29,82,15,12,27
81,8477931,Tomas Nosek,L,FLA,32,82,15,12,27
81,8481624,Ilya Mikheyev,R,CHI,30,82,14,13,27
81,8479390,Taylor Raddysh,R,WSH,26,82,12,15,27
81,8479359,Beck Malenstyn,L,BUF,26,82,8,19,27
81,8476921,Jordan Martinook,L,CAR,32,82,7,20,27
81,8475188,Brayden McNabb,D,VGK,33,82,4,23,27
81,8479368,Max Jones,L,BOS,26,82,17,9,26
81,8481093,Rafael Harvey-Pinard,L,MTL,25,82,17,9,26
81,8481517,Brett Leason,R,ANA,25,82,15,11,26
81,8482079,Marco Rossi,C,MIN,23,82,15,11,26
81,8479316,Luke Kunin,C,SJS,27,82,14,12,26
81,8477947,Sonny Milano,L,WSH,28,82,9,17,26
81,8477989,Christian Dvorak,C,MTL,28,82,9,17,26
81,8483505,Matthew Poitras,C,BOS,20,82,9,17,26
81,8477506,Ryan Pulock,D,NYI,30,82,6,20,26
81,8478882,Vladislav Gavrikov,D,LAK,29,82,6,20,26
81,8477435,Ryan Graves,D,PIT,29,82,6,20,26
81,8479976,Juuso Valimaki,D,UTA,26,82,3,23,26
81,8474151,Ryan McDonagh,D,TBL,35,82,3,23,26
81,8474673,TJ Brodie,D,CHI,34,82,1,25,26
81,8480281,Alexey Toropchenko,R,STL,25,82,15,10,25
81,8480893,Kirill Marchenko,R,CBJ,24,82,14,11,25
81,8482259,Bobby McMann,C,TOR,28,82,12,13,25
81,8479414,Nathan Bastian,R,NJD,27,82,12,13,25
81,8482117,Lukas Reichel,L,CHI,22,82,11,14,25
81,8475231,Casey Cizikas,C,NYI,33,82,11,14,25
81,8477903,Garnet Hathaway,R,PHI,33,82,11,14,25
81,8479353,Brett Howden,C,VGK,26,82,8,17,25
81,8478434,Keegan Kolesar,R,VGK,27,82,6,19,25
81,8479980,Nicolas Hague,D,VGK,26,82,6,19,25
81,8476422,Mike Reilly,D,NYI,31,82,5,20,25
81,8476879,Cody Ceci,D,EDM,31,82,5,20,25
81,8483490,Pavel Mintyukov,D,ANA,21,82,5,20,25
81,8475690,Chris Tanev,D,TOR,35,82,4,21,25
81,8480035,Henri Jokiharju,D,BUF,25,82,3,22,25
81,8478507,John Marino,D,UTA,27,82,1,24,25
81,8480995,Pontus Holmberg,R,TOR,25,82,12,12,24
81,8476858,Phillip Di Giuseppe,L,VAN,31,82,12,12,24
81,8478432,Christian Fischer,R,DET,27,82,11,13,24
81,8480144,David Kampf,C,TOR,29,82,10,14,24
81,8484153,Leo Carlsson,C,ANA,20,82,10,14,24
81,8476374,Sean Kuraly,C,CBJ,31,82,9,15,24
81,8476960,Andreas Athanasiou,C,CHI,30,82,7,17,24
81,8480950,Ilya Lyubushkin,D,DAL,30,82,7,17,24
81,8482807,Ethan Del Mastro,D,CHI,21,82,6,18,24
81,8475455,Brenden Dillon,D,NJD,34,82,5,19,24
81,8482142,Jamie Drysdale,D,PHI,22,82,3,21,24
81,8480860,Kevin Bahl,D,CGY,24,82,1,23,24
81,8477369,Carson Soucy,D,VAN,30,82,11,12,23
81,8480074,Alexandre Texier,C,STL,25,82,11,12,23
81,8481699,Aku Raty,R,UTA,23,82,11,12,23
81,8480789,Oliver Wahlstrom,R,NYI,24,82,10,13,23
81,8479661,Tanner Jeannot,L,LAK,27,82,10,13,23
81,8482141,Lukas Cormier,D,VGK,22,82,7,16,23
81,8483468,Jiri Kulich,C,BUF,20,82,7,16,23
81,8480878,Nils Lundkvist,D,DAL,24,82,4,19,23
81,8476525,Colin Miller,D,WPG,32,82,4,19,23
81,8479371,Dante Fabbro,D,NSH,26,82,2,21,23
81,8481568,Alex Vlasic,D,CHI,23,82,2,21,23
81,8476624,Barclay Goodrow,C,SJS,31,82,11,11,22
81,8478859,Niko Mikkola,D,FLA,28,82,8,14,22
81,8481522,Peyton Krebs,C,BUF,23,82,7,15,22
81,8476897,Oskar Sundqvist,C,STL,30,82,6,16,22
81,8482666,Scott Morrow,D,CAR,22,82,5,17,22
81,8482803,Olen Zellweger,D,ANA,21,82,5,17,22
81,8477220,Nate Schmidt,D,FLA,33,82,3,19,22
81,8478500,Ivan Provorov,D,CBJ,27,82,3,19,22
81,8478416,Erik Cernak,D,TBL,27,82,2,20,22
81,8476822,Luke Glendening,C,TBL,35,82,14,7,21
81,8480025,MacKenzie Entwistle,R,FLA,25,82,12,9,21
81,8482702,Logan Stankoven,C,DAL,21,82,11,10,21
81,8470621,Corey Perry,R,EDM,39,82,10,11,21
81,8484145,Zach Benson,L,BUF,19,82,9,12,21
81,8478443,Brandon Carlo,D,BOS,28,82,6,15,21
81,8480222,Sebastian Aho,D,PIT,28,82,5,16,21
81,8480879,Jacob Bernard-Docker,D,OTT,24,82,4,17,21
81,8476457,Adam Larsson,D,SEA,32,82,4,17,21
81,8475279,Ben Chiarot,D,DET,33,82,4,17,21
81,8475718,Justin Holl,D,DET,32,82,4,17,21
81,8475842,Sam Carrick,C,NYR,32,82,14,6,20
81,8476442,Matt Nieto,L,PIT,32,82,13,7,20
81,8480448,Parker Kelly,L,COL,25,82,12,8,20
81,8482679,Matt Coronato,R,CGY,22,82,11,9,20
81,8482077,Dylan Holloway,L,EDM,23,82,10,10,20
81,8480806,Isac Lundestrom,C,ANA,25,82,8,12,20
81,8477508,Curtis Lazar,C,NJD,29,82,8,12,20
81,8477505,Alexander Wennberg,C,SJS,30,82,8,12,20
81,8477450,Jason Dickinson,C,CHI,29,82,7,13,20
81,8482166,Shakir Mukhamadullin,D,SJS,22,82,6,14,20
81,8480990,Declan Chisholm,D,MIN,24,82,6,14,20
81,8476312,Josh Manson,D,COL,33,82,5,15,20
81,8482145,Mavrik Bourque,C,DAL,22,82,4,16,20
81,8475177,Calvin de Haan,D,COL,33,82,4,16,20
81,8480807,Mattias Samuelsson,D,BUF,24,82,3,17,20
81,8482087,Kaiden Guhle,D,MTL,22,82,1,19,20
81,8479291,Kevin Rooney,C,CGY,31,82,12,7,19
81,8477392,Hudson Fasching,R,NYI,29,82,11,8,19
81,8483763,Maksymilian Szuber,D,UTA,22,82,10,9,19
81,8482101,Danil Gushchin,L,SJS,22,82,10,9,19
81,8477406,Mattias Janmark,C,EDM,32,82,9,10,19
81,8477034,Jaycob Megna,D,FLA,32,82,7,12,19
81,8482153,Brendan Brisson,C,VGK,23,82,7,12,19
81,8483397,Marc McLaughlin,C,BOS,25,82,6,13,19
81,8483565,Nick Blankenburg,D,NSH,26,82,5,14,19
81,8477499,Rasmus Ristolainen,D,PHI,30,82,3,16,19
81,8480246,Nick Perbix,D,TBL,26,82,2,17,19
81,8478840,Will Borgen,D,SEA,28,82,2,17,19
81,8475462,Radko Gudas,D,ANA,34,82,2,17,19
81,8476429,Scott Mayfield,D,NYI,32,82,2,17,19
81,8482470,Ilya Solovyov,D,CGY,24,82,2,17,19
81,8480172,Jan Rutta,D,SJS,34,82,2,17,19
81,8477845,Trevor van Riemsdyk,D,WSH,33,82,1,18,19
81,8481524,Bowen Byram,D,BUF,23,82,11,7,18
81,8476878,Zemgus Girgensons,L,TBL,30,82,10,8,18
81,8476981,Josh Anderson,R,MTL,30,82,10,8,18
81,8476889,Radek Faksa,C,STL,30,82,9,9,18
81,8481028,Martin Pospisil,C,CGY,25,82,7,11,18
81,8479369,Andrew Peeke,D,BOS,26,82,4,14,18
81,8477335,Kyle Burroughs,D,LAK,29,82,4,14,18
81,8478399,Jonas Siegenthaler,D,NJD,27,82,4,14,18
81,8480834,Ty Emberson,D,SJS,24,82,3,15,18
81,8480073,Erik Brannstrom,D,COL,25,82,2,16,18
81,8483460,David Jiricek,D,CBJ,21,82,1,17,18
81,8482062,Cole Smith,L,NSH,29,82,6,11,17
81,8479638,Justin Brazeau,R,BOS,26,82,6,11,17
81,8484149,Gavin Brindley,C,CBJ,20,82,6,11,17
81,8478851,Alexandre Carrier,D,NSH,28,82,4,13,17
81,8473453,Trevor Lewis,C,LAK,37,82,4,13,17
81,8475324,Nick Jensen,D,OTT,34,82,3,14,17
81,8483471,Brad Lambert,C,WPG,31,82,2,15,17
81,8482762,Simon Edvinsson,D,DET,21,82,9,7,16
81,8483499,Liam Ohgren,L,MIN,20,82,7,9,16
81,8482858,Ryker Evans,D,SEA,23,82,6,10,16
81,8481641,Joel Kiviranta,L,COL,28,82,6,10,16
81,8474013,Ian Cole,D,UTA,35,82,4,12,16
81,8479442,Troy Stecher,D,EDM,30,82,4,12,16
81,8475233,David Savard,D,MTL,34,82,2,14,16
81,8477365,Connor Clifton,D,BUF,29,82,2,14,16
81,8481601,Simon Holmstrom,R,NYI,23,82,10,5,15
81,8483524,Shane Wright,C,SEA,20,82,9,6,15
81,8480870,Bo Groulx,C,NYR,24,82,9,6,15
81,8482659,Josh Doan,R,UTA,22,82,7,8,15
81,8483445,Cutter Gauthier,L,ANA,20,82,7,8,15
81,8480021,Jack Studnicka,C,LAK,25,82,6,9,15
81,8483482,Tristan Luneau,D,ANA,20,82,5,10,15
81,8480796,Martin Fehervary,D,WSH,25,82,5,10,15
81,8474090,Brendan Smith,D,DAL,35,82,3,12,15
81,8470600,Ryan Suter,D,STL,39,82,2,13,15
81,8482713,Mackie Samoskevich,R,FLA,22,82,8,6,14
81,8482516,Matthew Kessel,D,STL,24,82,5,9,14
81,8484911,Collin Graf,R,SJS,22,82,4,10,14
81,8482733,Logan Mailloux,D,MTL,31,82,4,10,14
81,8476441,Joel Edmundson,D,LAK,31,82,3,11,14
81,8476967,Brett Kulak,D,EDM,30,82,2,12,14
81,8482073,Braden Schneider,D,NYR,23,82,0,14,14
81,8483012,Logan Morrison,C,SEA,22,82,6,7,13
81,8483493,Frank Nazar,C,CHI,20,82,6,7,13
81,8478468,Jeremy Lauzon,D,NSH,27,82,5,8,13
81,8478136,Jake Middleton,D,MIN,28,82,3,10,13
81,8478450,Parker Wotherspoon,D,BOS,27,82,3,10,13
81,8474612,Travis Hamonic,D,OTT,34,82,0,13,13
81,8483466,Kevin Korchinski,D,CHI,20,82,7,5,12
81,8482712,Oskar Olausson,R,COL,22,82,3,9,12
81,8478178,Darren Raddysh,D,TBL,28,82,5,6,11
81,8483489,Fraser Minten,C,TOR,31,82,3,8,11
81,8475762,Derek Forbort,D,VAN,32,82,2,9,11
81,8474567,Zach Bogosian,D,MIN,34,82,0,11,11
81,8482749,Joshua Roy,R,MTL,21,82,4,6,10
81,8481567,Henry Thrun,D,SJS,23,82,3,7,10
81,8476473,Connor Murphy,D,CHI,31,82,2,8,10
81,8476372,Nick Seeler,D,PHI,31,82,2,8,10
81,8482070,Mitchell Chaffee,R,TBL,26,82,2,8,10
81,8482859,Zack Ostapchuk,C,OTT,21,82,1,9,10
81,8481605,Jackson LaCombe,D,ANA,23,82,0,10,10
81,8482118,Sam Colangelo,R,ANA,23,82,5,4,9
81,8477938,Haydn Fleury,D,WPG,28,82,2,7,9
81,8471677,Jack Johnson,D,CBJ,37,82,2,6,8
81,8479576,Vincent Desharnais,D,VAN,28,82,2,6,8
81,8482787,Nikita Chibrikov,R,WPG,31,82,2,5,7
81,8481122,Simon Benoit,D,TOR,26,82,2,5,7
81,8483567,Georgii Merkulov,C,BOS,24,82,2,4,6
81,8478874,Adam Gaudette,C,OTT,28,82,1,5,6
81,8474062,Riley Nash,C,NYR,35,82,1,4,5
81,8470794,Joe Pavelski,C,,40,0,0,0,0
81,8481703,Valtteri Puustinen,R,PIT,25,0,0,0,0
81,8477950,Tony DeAngelo,D,,29,0,0,0,0
81,8481577,Philip Tomasino,C,NSH,23,0,0,0,0
81,8475197,Tyson Barrie,D,,33,0,0,0,0
81,8471218,Blake Wheeler,R,,38,0,0,0,0
81,8474157,Max Pacioretty,L,,36,0,0,0,0
81,8478466,Daniel Sprong,R,VAN,27,0,0,0,0
81,8475744,Evgeny Kuznetsov,C,,32,0,0,0,0
81,8481019,David Gustafsson,C,WPG,24,0,0,0,0
81,8475906,John Klingberg,D,,32,0,0,0,0
81,8479348,Kale Clague,D,BUF,26,0,0,0,0
81,8476952,Dominic Toninato,C,WPG,30,0,0,0,0
81,8473473,Milan Lucic,L,,36,0,0,0,0
81,8474037,James van Riemsdyk,L,,35,0,0,0,0
81,8474602,Justin Schultz,D,,34,0,0,0,0
81,8482222,Alexander Barabanov,L,,30,0,0,0,0
81,8479372,Josh Mahura,D,SEA,26,0,0,0,0
81,8479982,Conor Timmins,D,TOR,26,0,0,0,0
81,8474031,Kevin Shattenkirk,D,,35,0,0,0,0
81,8480008,Adam Ruzicka,C,,25,0,0,0,0
81,8481059,Scott Perunovich,D,STL,26,0,0,0,0
81,8480884,Calen Addison,D,,24,0,0,0,0
81,8476994,Vinnie Hinostroza,C,NSH,30,0,0,0,0
81,8478452,Caleb Jones,D,LAK,27,0,0,0,0
81,8480157,Calle Rosen,D,COL,30,0,0,0,0
81,8481609,Vladislav Kolyachonok,D,UTA,23,0,0,0,0
81,8479415,Michael McLeod,C,,26,0,0,0,0
81,8476919,Chris Tierney,C,,30,0,0,0,0
81,8479639,Dylan Coghlan,D,WPG,26,0,0,0,0
81,8478146,Matthew Highmore,C,OTT,28,0,0,0,0
81,8478970,Jalen Chatfield,D,CAR,28,0,0,0,0
81,8480205,Emil Bemstrom,C,PIT,25,0,0,0,0
81,8474884,Mike Hoffman,C,,35,0,0,0,0
81,8471274,Alex Goligoski,D,,39,0,0,0,0
81,8478104,Sammy Blais,L,,28,0,0,0,0
81,8474870,Tyler Johnson,C,,34,0,0,0,0
81,8476913,Devin Shore,C,MIN,30,0,0,0,0
81,8481598,Philip Broberg,D,EDM,23,0,0,0,0
81,8480058,Pierre-Olivier Joseph,D,STL,25,0,0,0,0
81,8480891,Michael Kesselring,D,UTA,24,0,0,0,0
81,8477979,Nicolas Aube-Kubel,R,BUF,28,0,0,0,0
81,8476871,Tanner Pearson,L,,32,0,0,0,0
81,8476393,Nick Cousins,C,,31,0,0,0,0
81,8479977,Kailer Yamamoto,R,,26,0,0,0,0
81,8479543,Michael Pezzetta,L,MTL,26,0,0,0,0
81,8477018,Ben Hutton,D,VGK,31,0,0,0,0
81,8480762,Eric Robinson,L,CAR,29,0,0,0,0
81,8474034,Pat Maroon,L,CHI,36,0,0,0,0
81,8481058,Jesse Ylönen,R,,25,0,0,0,0
81,8475179,Dmitry Kulikov,D,FLA,34,0,0,0,0
81,8481527,Kaedan Korczak,D,VGK,23,0,0,0,0
81,8473449,Kyle Okposo,R,,36,0,0,0,0
81,8482192,Isaak Phillips,D,CHI,23,0,0,0,0
81,8480727,Zach Whitecloud,D,VGK,28,0,0,0,0
81,8479346,Dillon Dube,C,,26,0,0,0,0
81,8480821,Filip Zadina,R,,25,0,0,0,0
81,8480001,Urho Vaakanainen,D,ANA,25,0,0,0,0
81,8470966,Mark Giordano,D,,41,0,0,0,0
81,8480853,Liam Foudy,C,,24,0,0,0,0
81,8475225,Craig Smith,C,CHI,35,0,0,0,0
81,8479972,Mason Shaw,C,WPG,26,0,0,0,0
81,8478451,Ethan Bear,D,WSH,27,0,0,0,0
81,8474040,Sam Gagner,C,,35,0,0,0,0
81,8480196,Jacob Bryson,D,BUF,27,0,0,0,0
81,8479984,Cal Foote,D,,26,0,0,0,0
81,8480011,Klim Kostin,C,SJS,25,0,0,0,0
81,8482176,Wyatt Kaiser,D,CHI,22,0,0,0,0
81,8476988,Matt Benning,D,SJS,30,0,0,0,0
81,8479370,Tyson Jost,C,CAR,26,0,0,0,0
81,8477464,Nic Petan,C,,29,0,0,0,0
81,8477380,Jonny Brodzinski,C,NYR,31,0,0,0,0
81,8480070,Ian Mitchell,D,BOS,25,0,0,0,0
81,8479315,Joey Anderson,R,CHI,26,0,0,0,0
81,8478099,Kevin Labanc,R,,29,0,0,0,0
81,8476874,Olli Maatta,D,DET,30,0,0,0,0
81,8475208,Brian Dumoulin,D,ANA,33,0,0,0,0
81,8478430,Oliver Kylington,D,,27,0,0,0,0
81,8479536,Axel Jonsson-Fjallby,L,WPG,26,0,0,0,0
81,8479671,Mathieu Olivier,R,CBJ,27,0,0,0,0
81,8471709,Marc-Edouard Vlasic,D,SJS,37,0,0,0,0
81,8479328,Julien Gauthier,R,NYI,27,0,0,0,0
81,8478421,A.J. Greer,L,FLA,28,0,0,0,0
81,8477573,Nathan Walker,L,STL,30,0,0,0,0
81,8481537,Nikita Okhotiuk,D,CGY,24,0,0,0,0
81,8474166,Alec Martinez,D,CHI,37,0,0,0,0
81,8470610,Zach Parise,L,,40,0,0,0,0
81,8477478,William Carrier,L,CAR,30,0,0,0,0
81,8479344,Jesse Puljujarvi,R,PIT,26,0,0,0,0
81,8480887,Jordan Harris,D,MTL,24,0,0,0,0
81,8478502,Dennis Gilbert,D,BUF,28,0,0,0,0
81,8482730,Brandt Clarke,D,LAK,21,0,0,0,0
81,8480355,Mark Kastelic,C,BOS,25,0,0,0,0
81,8475750,Jon Merrill,D,MIN,32,0,0,0,0
81,8475164,Jakob Silfverberg,R,,34,0,0,0,0
81,8477944,Jakub Vrana,L,,28,0,0,0,0
81,8479439,Jacob MacDonald,D,COL,31,0,0,0,0
81,8474568,Luke Schenn,D,NSH,35,0,0,0,0
81,8478454,Noah Juulsen,D,VAN,27,0,0,0,0
81,8475752,Tyler Pitlick,C,,33,0,0,0,0
81,8482148,Hendrix Lapierre,C,WSH,22,0,0,0,0
81,8481167,Brayden Pachal,D,CGY,25,0,0,0,0
81,8478043,Sam Lafferty,C,BUF,29,0,0,0,0
81,8479321,Lucas Johansen,D,,27,0,0,0,0
81,8471699,Andrew Cogliano,C,,37,0,0,0,0
81,8481521,Ronnie Attard,D,PHI,25,0,0,0,0
81,8481161,Jake Christiansen,D,CBJ,25,0,0,0,0
81,8479458,Nikita Zaitsev,D,,33,0,0,0,0
81,8479619,Michael Carcone,L,UTA,28,0,0,0,0
81,8479026,Philippe Myers,D,TOR,27,0,0,0,0
81,8477330,Dominik Kubalik,L,,29,0,0,0,0
81,8481617,Vasily Podkolzin,R,VAN,23,0,0,0,0
81,8481701,Santeri Hatakka,D,NJD,23,0,0,0,0
81,8479514,Rem Pitlick,C,,27,0,0,0,0
81,8477446,Michael McCarron,R,NSH,29,0,0,0,0
81,8470604,Jeff Carter,C,,39,0,0,0,0
81,8482241,Radim Zohorna,L,,28,0,0,0,0
81,8480289,Morgan Barron,C,WPG,26,0,0,0,0
81,8479379,Givani Smith,R,SJS,26,0,0,0,0
81,8480216,Jacob Peterson,C,,25,0,0,0,0
81,8477851,Jordan Oesterle,D,BOS,32,0,0,0,0
81,8484258,Sam Malinski,D,COL,26,0,0,0,0
81,8478904,Steven Lorentz,C,,28,0,0,0,0
81,8482095,Tyler Kleven,D,OTT,22,0,0,0,0
81,8480848,Ty Dellandrea,C,SJS,24,0,0,0,0
81,8476884,Derrick Pouliot,D,,30,0,0,0,0
81,8479336,Carl Grundstrom,R,SJS,27,0,0,0,0
81,8482964,Arber Xhekaj,D,MTL,23,0,0,0,0
81,8471686,Marc Staal,D,,37,0,0,0,0
81,8477887,Patrick Brown,C,BOS,32,0,0,0,0
81,8478495,Denis Gurianov,R,,27,0,0,0,0
81,8473504,Cal Clutterbuck,R,,37,0,0,0,0
81,8481550,Adam Beckman,L,NJD,23,0,0,0,0
81,8480845,Rasmus Kupari,C,WPG,24,0,0,0,0
81,8474009,Nick Bonino,C,,36,0,0,0,0
81,8478585,Derek Ryan,C,EDM,38,0,0,0,0
81,8477962,Brendan Lemieux,L,CAR,28,0,0,0,0
81,8482861,Vincent Iorio,D,WSH,22,0,0,0,0
81,8479378,Logan Stanley,D,WPG,26,0,0,0,0
81,8473446,Erik Johnson,D,PHI,36,0,0,0,0
81,8481743,Marc Del Gaizo,D,NSH,25,0,0,0,0
81,8477384,Josh Brown,D,EDM,30,0,0,0,0
81,8482165,Yan Kuznetsov,D,CGY,22,0,0,0,0
81,8478424,Jansen Harkins,C,ANA,27,0,0,0,0
81,8482144,Jack Thompson,D,SJS,22,0,0,0,0
81,8478512,Austin Czarnik,C,,32,0,0,0,0
81,8477527,Ross Johnston,L,ANA,30,0,0,0,0
81,8479383,Boris Katchouk,L,,26,0,0,0,0
81,8482094,Daemon Hunt,D,MIN,22,0,0,0,0
81,8481719,Maxwell Crozier,D,TBL,24,0,0,0,0
81,8480192,Johnathan Kovacevic,D,NJD,27,0,0,0,0
81,8479376,Victor Mete,D,,26,0,0,0,0
81,8482511,Mason Lohrei,D,BOS,23,0,0,0,0
81,8475825,Jani Hakanpää,D,,32,0,0,0,0
81,8478021,William Lagesson,D,DET,28,0,0,0,0
81,8475795,Dylan McIlrath,D,WSH,32,0,0,0,0
81,8477846,Ryan Carpenter,C,,33,0,0,0,0
81,8481056,Spencer Stastney,D,NSH,24,0,0,0,0
81,8481564,Ryan Johnson,D,BUF,23,0,0,0,0
81,8478017,Mark Friedman,D,VAN,29,0,0,0,0
81,8479320,Max Lajoie,D,SEA,27,0,0,0,0
81,8480075,Cameron Crotty,D,MIN,25,0,0,0,0
81,8484287,Cole McWard,D,VAN,23,0,0,0,0
81,8484254,Akito Hirose,D,VAN,25,0,0,0,0
81,8483407,Brandon Scanlin,D,NYR,25,0,0,0,0
81,8480274,Philip Kemp,D,EDM,25,0,0,0,0
81,8479522,Hardy Haman Aktell,D,WSH,26,0,0,0,0
81,8480007,Jonas Rondbjerg,R,VGK,25,0,0,0,0
81,8477454,Adam Erne,L,,29,0,0,0,0
81,8481679,Maxence Guenette,D,OTT,23,0,0,0,0
81,8480441,Trey Fix-Wolansky,R,CBJ,25,0,0,0,0
81,8483546,Marshall Rifai,D,TOR,26,0,0,0,0
81,8480084,Nick DeSimone,D,NJD,30,0,0,0,0
81,8481030,Jack St. Ivany,D,PIT,25,0,0,0,0
81,8481592,Jakob Pelletier,L,CGY,23,0,0,0,0
81,8478011,Louie Belpedio,D,PHI,28,0,0,0,0
81,8477930,Pierre-Edouard Bellemare,L,,39,0,0,0,0
81,8484321,Nikolas Matinpalo,D,OTT,26,0,0,0,0
81,8482067,Connor Mackey,D,NYR,28,0,0,0,0
81,8481806,Louis Crevier,D,CHI,23,0,0,0,0
81,8484326,Patrik Koch,D,UTA,28,0,0,0,0
81,8477971,Andreas Englund,D,LAK,28,0,0,0,0
81,8481751,Lukas Rousek,R,BUF,25,0,0,0,0
81,8481006,Tyler Tucker,D,STL,24,0,0,0,0
81,8476867,Brendan Gaunce,C,MIN,30,0,0,0,0
81,8479520,Brandon Duhaime,R,WSH,27,0,0,0,0
81,8477073,Kurtis MacDermid,L,NJD,30,0,0,0,0
81,8480874,Adam Ginning,D,PHI,24,0,0,0,0
81,8477473,Justin Bailey,R,SJS,29,0,0,0,0
81,8479066,Ryan Lomberg,L,CGY,30,0,0,0,0
81,8477070,Liam O'Brien,C,UTA,30,0,0,0,0
81,8474618,Marco Scandella,D,,34,0,0,0,0
81,8475797,Jarred Tinordi,D,,32,0,0,0,0
81,8481441,Joe Snively,C,DET,28,0,0,0,0
81,8477244,Chad Ruhwedel,D,NYR,34,0,0,0,0
81,8479772,Zack MacEwen,R,OTT,28,0,0,0,0
81,8481147,Reese Johnson,C,MIN,26,0,0,0,0
81,8481043,Cole Koepke,L,BOS,26,0,0,0,0
81,8483619,Filip Roos,D,OTT,25,0,0,0,0
81,8481541,Samuel Bolduc,D,NYI,24,0,0,0,0
81,8477810,Joel Hanley,D,CGY,33,0,0,0,0
81,8476907,Mackenzie MacEachern,L,,30,0,0,0,0
81,8482652,Walker Duehr,R,CGY,27,0,0,0,0
81,8477126,Jayson Megna,C,,34,0,0,0,0
81,8483398,Declan Carlile,D,TBL,31,0,0,0,0
81,8482929,Emil Lilleberg,D,TBL,23,0,0,0,0
81,8480880,Jakub Lauko,C,MIN,24,0,0,0,0
81,8480245,Olle Lycksell,R,PHI,25,0,0,0,0
81,8480252,Cole Guttman,C,CHI,25,0,0,0,0
81,8477467,Gustav Olofsson,D,SEA,30,0,0,0,0
81,8479968,Vinni Lettieri,C,BOS,29,0,0,0,0
81,8478400,Colin White,C,,27,0,0,0,0
81,8475755,Alexander Petrovic,D,DAL,32,0,0,0,0
81,8481812,Nikolai Knyzhov,D,,27,0,0,0,0
81,8481593,Jayden Struble,D,MTL,23,0,0,0,0
81,8481532,Alex Turcotte,C,LAK,23,0,0,0,0
81,8482126,Emil Andrae,D,PHI,31,0,0,0,0
81,8479944,Zach Aston-Reese,C,VGK,30,0,0,0,0
81,8471817,Ryan Reaves,R,TOR,37,0,0,0,0
81,8481206,John Ludvig,D,PIT,24,0,0,0,0
81,8481599,Victor Soderstrom,D,UTA,23,0,0,0,0
81,8480292,Carson Meyer,R,ANA,27,0,0,0,0
81,8482496,Nils Aman,C,VAN,24,0,0,0,0
81,8479718,Alex Barré-Boulet,C,MTL,27,0,0,0,0
81,8479994,Jaret Anderson-Dolan,C,WPG,25,0,0,0,0
81,8480184,Gustav Lindstrom,D,,26,0,0,0,0
81,8480890,Jan Jenik,R,OTT,24,0,0,0,0
81,8478067,Oskar Lindblom,L,,28,0,0,0,0
81,8476934,Brock McGinn,L,ANA,30,0,0,0,0
81,8479985,Cale Fleury,D,SEA,26,0,0,0,0
81,8484304,Uvis Balinskis,D,FLA,28,0,0,0,0
81,8479981,Jonah Gadjovich,L,FLA,26,0,0,0,0
81,8481716,Dmitri Voronkov,L,CBJ,24,0,0,0,0
81,8474709,Matt Martin,L,,35,0,0,0,0
81,8482634,Alex Steeves,C,TOR,25,0,0,0,0
81,8480823,Alexander Alexeyev,D,WSH,25,0,0,0,0
81,8477541,Dakota Mermis,D,TOR,30,0,0,0,0
81,8483491,Ivan Miroshnichenko,L,WSH,20,0,0,0,0
81,8478477,Mitchell Stephens,C,SEA,27,0,0,0,0
81,8481543,Nikita Alexandrov,C,STL,24,0,0,0,0
81,8479423,Alex Nylander,L,,26,0,0,0,0
81,8482451,Mikael Pyyhtia,L,CBJ,23,0,0,0,0
81,8478831,Kevin Stenlund,C,UTA,28,0,0,0,0
81,8480306,Grant Hutton,D,NYI,29,0,0,0,0
81,8478028,Fredrik Olofsson,L,,28,0,0,0,0
81,8477462,Robert Hagg,D,VGK,29,0,0,0,0
81,8477320,Anton Blidh,L,NYR,29,0,0,0,0
81,8482157,Will Cuylle,L,NYR,22,0,0,0,0
81,8482737,Zack Bolduc,C,STL,21,0,0,0,0
81,8481239,Samuel Fagemo,L,,24,0,0,0,0
81,8481600,Tobias Bjornfot,D,FLA,23,0,0,0,0
81,8478409,Anthony Richard,C,PHI,28,0,0,0,0
81,8474145,Robert Bortuzzo,D,,35,0,0,0,0
81,8475958,Michael Sgarbossa,C,WSH,32,0,0,0,0
81,8479986,Kole Lind,R,DAL,26,0,0,0,0
81,8479249,Andrew Poturalski,C,SJS,30,0,0,0,0
81,8479362,Riley Tufte,L,BOS,26,0,0,0,0
81,8479991,Jake Leschyshyn,C,NYR,25,0,0,0,0
81,8479587,Rhett Gardner,C,PHI,28,0,0,0,0
81,8482744,James Malatesta,L,CBJ,21,0,0,0,0
81,8478854,Ryan Shea,D,PIT,27,0,0,0,0
81,8481591,Sam Poulin,R,,23,0,0,0,0
81,8483512,Matt Savoie,C,EDM,20,0,0,0,0
81,8482102,Vasily Ponomarev,C,PIT,22,0,0,0,0
81,8482162,Roby Jarventie,L,EDM,22,0,0,0,0
81,8481016,Ruslan Iskhakov,C,,24,0,0,0,0
81,8482172,Landon Slaggert,L,CHI,22,0,0,0,0
81,8482747,Brennan Othmann,L,NYR,21,0,0,0,0
81,8480031,Maxime Comtois,L,,25,0,0,0,0
81,8480226,Marián Studenic,R,,26,0,0,0,0
81,8478408,Travis Dermott,D,,28,0,0,0,0
81,8481518,Nolan Foote,L,NJD,24,0,0,0,0
81,8479419,Brett Murray,L,BUF,26,0,0,0,0
81,8482088,Justin Sourdif,R,FLA,22,0,0,0,0
81,8482201,Gage Goncalves,C,TBL,23,0,0,0,0
81,8481578,Graeme Clarke,R,MIN,23,0,0,0,0
81,8482177,Marat Khusnutdinov,C,MIN,22,0,0,0,0
81,8481754,Nikita Nesterenko,C,ANA,23,0,0,0,0
81,8483531,Brian Halonen,L,NJD,25,0,0,0,0
81,8483920,Pierrick Dube,R,WSH,23,0,0,0,0
81,8480851,Akil Thomas,C,LAK,24,0,0,0,0
81,8475235,Nicolas Deslauriers,L,PHI,33,0,0,0,0
81,8482476,Emil Heineman,L,MTL,23,0,0,0,0
81,8477149,Scott Sabourin,R,SJS,32,0,0,0,0
81,8483549,Lucas Condotta,L,MTL,27,0,0,0,0
81,8482765,Isak Rosen,R,BUF,21,0,0,0,0
81,8481237,Kyle MacLean,C,NYI,25,0,0,0,0
81,8481024,Linus Karlsson,C,VAN,25,0,0,0,0
81,8481690,Tyler Angle,C,,24,0,0,0,0
81,8483570,Ben Meyers,C,SEA,26,0,0,0,0
81,8481655,Cole Schwindt,R,CGY,23,0,0,0,0
81,8481462,Mason Morelli,L,VGK,28,0,0,0,0
81,8483401,Marc Johnstone,R,PIT,28,0,0,0,0
81,8478956,Samuel Laberge,L,NJD,27,0,0,0,0
81,8479533,Joona Koppanen,L,,26,0,0,0,0
81,8482197,Adam Raska,R,MIN,23,0,0,0,0
81,8482250,Callahan Burke,C,VGK,27,0,0,0,0
81,8482784,Zach Dean,C,STL,21,0,0,0,0
81,8484255,Jason Polin,R,COL,25,0,0,0,0
81,8481077,John Leonard,L,,26,0,0,0,0
81,8481534,Raphael Lavoie,C,EDM,24,0,0,0,0
81,8483609,Adam Klapka,R,CGY,24,0,0,0,0
81,8482751,Ryan Winterton,C,SEA,21,0,0,0,0
81,8480267,Sammy Walker,C,MIN,25,0,0,0,0
81,8475766,Austin Watson,L,,32,0,0,0,0
81,8482460,Matt Rempe,C,NYR,22,0,0,0,0
81,8481065,Angus Crookshank,L,OTT,25,0,0,0,0
81,8481070,Hugh McGing,L,,26,0,0,0,0
81,8476323,Max McCormick,L,SEA,32,0,0,0,0
81,8483395,Arshdeep Bains,L,VAN,23,0,0,0,0
81,8484259,Ondrej Pavel,C,COL,31,0,0,0,0
81,8483432,Luca Del Bel Belluz,C,CBJ,31,0,0,0,0
81,8483045,Cameron Butler,R,CBJ,31,0,0,0,0
81,8482061,Brandon Biro,L,SEA,26,0,0,0,0
81,8477401,John Hayden,C,SEA,29,0,0,0,0
81,8475278,Byron Froese,C,,33,0,0,0,0
81,8478446,Glenn Gawdin,C,LAK,27,0,0,0,0
81,8477993,Justin Kirkland,C,CGY,28,0,0,0,0
81,8482147,Jean-Luc Foudy,C,COL,22,0,0,0,0
81,8480032,Shane Bowers,C,NJD,25,0,0,0,0
81,8479330,Brandon Gignac,C,MTL,27,0,0,0,0
81,8480776,Sheldon Rempal,R,,29,0,0,0,0
81,8475413,Justin Dowling,C,NJD,34,0,0,0,0
81,8481726,Adam Edstrom,C,NYR,24,0,0,0,0
81,8480844,Grigori Denisenko,L,VGK,24,0,0,0,0
81,8478147,Bokondji Imama,L,PIT,28,0,0,0,0
81,8478881,Brett Seney,L,CHI,28,0,0,0,0
81,8483630,Pavol Regenda,L,ANA,25,0,0,0,0
81,8480836,Jonathan Gruden,C,,24,0,0,0,0
81,8484314,Jiri Smejkal,L,,28,0,0,0,0
81,8475780,Chris Wagner,R,COL,33,0,0,0,0
81,8479546,Oskar Steen,C,,26,0,0,0,0
81,8483597,Milos Kelemen,L,UTA,25,0,0,0,0
81,8481789,Tye Kartye,L,SEA,23,0,0,0,0
81,8484325,Waltteri Merela,C,TBL,26,0,0,0,0
81,8479421,Jacob Moverare,D,LAK,26,0,0,0,0
81,8481585,Egor Afanasyev,L,SJS,23,0,0,0,0
81,8479547,Matthew Phillips,R,,26,0,0,0,0
81,8479367,William Lockwood,R,FLA,26,0,0,0,0
81,8476915,Jujhar Khaira,L,,30,0,0,0,0
81,8481422,Jacob Lucchini,C,NSH,29,0,0,0,0
81,8480468,James Hamblin,L,EDM,25,0,0,0,0
81,8478051,Max Willman,C,NJD,29,0,0,0,0
81,8481556,John Beecher,C,BOS,23,0,0,0,0
81,8478078,Rourke Chartier,C,,28,0,0,0,0
82,8476453,Nikita Kucherov,R,TBL,31,82,41,92,133
82,8481559,Jack Hughes,C,NJD,23,82,49,76,125
82,8478402,Connor McDavid,C,EDM,27,82,30,95,125
82,8477956,David Pastrnak,R,BOS,28,82,57,64,121
82,8479318,Auston Matthews,C,TOR,27,82,66,51,117
82,8478864,Kirill Kaprizov,L,MIN,27,82,46,69,115
82,8477492,Nathan MacKinnon,C,COL,29,82,35,74,109
82,8471675,Sidney Crosby,C,PIT,37,82,46,62,108
82,8478420,Mikko Rantanen,R,COL,28,82,47,60,107
82,8477493,Aleksander Barkov,C,FLA,29,82,43,63,106
82,8478550,Artemi Panarin,L,NYR,33,82,33,72,105
82,8479314,Matthew Tkachuk,L,FLA,27,82,29,75,104
82,8477939,William Nylander,R,TOR,28,82,50,50,100
82,8481557,Matt Boldy,L,MIN,23,82,40,60,100
82,8477934,Leon Draisaitl,C,EDM,29,82,38,62,100
82,8476468,J.T. Miller,C,VAN,31,82,35,65,100
82,8480800,Quinn Hughes,D,VAN,25,82,17,83,100
82,8478439,Travis Konecny,R,PHI,27,82,43,55,98
82,8474600,Roman Josi,D,NSH,34,82,24,72,96
82,8477946,Dylan Larkin,C,DET,28,82,47,48,95
82,8476389,Vincent Trocheck,C,NYR,31,82,41,54,95
82,8480027,Jason Robertson,L,DAL,25,82,37,58,95
82,8482116,Tim Stützle,C,OTT,22,82,31,63,94
82,8477942,Kevin Fiala,L,LAK,28,82,32,60,92
82,8476887,Filip Forsberg,L,NSH,30,82,43,48,91
82,8481523,Kirby Dach,C,MTL,23,82,17,74,91
82,8479407,Jesper Bratt,L,NJD,26,82,29,61,90
82,8480023,Robert Thomas,C,STL,25,82,38,51,89
82,8477949,Alex Tuch,R,BUF,28,82,26,62,88
82,8479323,Adam Fox,D,NYR,26,82,17,71,88
82,8481540,Cole Caufield,R,MTL,23,82,42,45,87
82,8480012,Elias Pettersson,C,VAN,26,82,36,51,87
82,8475913,Mark Stone,R,VGK,32,82,28,59,87
82,8478010,Brayden Point,C,TBL,28,82,38,46,84
82,8480069,Cale Makar,D,COL,26,82,15,69,84
82,8476459,Mika Zibanejad,C,NYR,31,82,33,49,82
82,8478427,Sebastian Aho,C,CAR,27,82,28,54,82
82,8478403,Jack Eichel,C,VGK,28,82,39,42,81
82,8480036,Miro Heiskanen,D,DAL,25,82,17,64,81
82,8471214,Alex Ovechkin,L,WSH,39,82,41,39,80
82,8478449,Roope Hintz,C,DAL,28,82,29,51,80
82,8475172,Nazem Kadri,C,CGY,34,82,28,51,79
82,8478445,Mathew Barzal,C,NYI,27,82,13,66,79
82,8479343,Clayton Keller,R,UTA,26,82,41,37,78
82,8477933,Sam Reinhart,C,FLA,29,82,38,40,78
82,8476881,Tomas Hertl,C,VGK,31,82,35,43,78
82,8477447,Shea Theodore,D,VGK,29,82,15,63,78
82,8476346,Johnny Gaudreau,L,CBJ,31,82,21,56,77
82,8475184,Chris Kreider,L,NYR,33,82,43,33,76
82,8471685,Anze Kopitar,C,LAK,37,82,27,49,76
82,8474564,Steven Stamkos,C,NSH,34,82,36,39,75
82,8477409,Carter Verhaeghe,C,FLA,29,82,36,39,75
82,8474590,John Carlson,D,WSH,34,82,19,56,75
82,8478407,Vince Dunn,D,SEA,28,82,13,62,75
82,8477404,Jake Guentzel,C,TBL,30,82,38,36,74
82,8479420,Tage Thompson,C,BUF,27,82,36,38,74
82,8479337,Alex DeBrincat,R,DET,27,82,34,40,74
82,8480002,Nico Hischier,C,NJD,25,82,30,44,74
82,8479675,Trevor Moore,L,LAK,29,82,38,35,73
82,8477960,Adrian Kempe,R,LAK,28,82,33,40,73
82,8478401,Pavel Zacha,C,BOS,27,82,34,38,72
82,8478398,Kyle Connor,L,WPG,28,82,32,40,72
82,8477496,Elias Lindholm,C,BOS,30,82,27,45,72
82,8478440,Dylan Strome,C,WSH,27,82,24,48,72
82,8476853,Morgan Rielly,D,TOR,30,82,12,60,72
82,8478047,Michael Bunting,L,PIT,29,82,37,34,71
82,8477402,Pavel Buchnevich,L,STL,29,82,32,39,71
82,8474141,Patrick Kane,R,DET,36,82,30,41,71
82,8475166,John Tavares,C,TOR,34,82,26,45,71
82,8478493,Joel Eriksson Ek,C,MIN,27,82,37,33,70
82,8476454,Ryan Nugent-Hopkins,C,EDM,31,82,26,44,70
82,8480801,Brady Tkachuk,L,OTT,25,82,34,35,69
82,8479542,Brandon Hagel,L,TBL,26,82,28,41,69
82,8476882,Teuvo Teravainen,L,CHI,30,82,26,43,69
82,8478873,Troy Terry,R,ANA,27,82,21,48,69
82,8479385,Jordan Kyrou,C,STL,26,82,33,35,68
82,8475810,Bryan Rust,R,PIT,32,82,31,37,68
82,8473994,Jamie Benn,L,DAL,35,82,29,39,68
82,8475168,Matt Duchene,C,DAL,33,82,28,40,68
82,8480078,Filip Chytil,C,NYR,25,82,24,44,68
82,8473419,Brad Marchand,L,BOS,36,82,23,45,68
82,8480865,Noah Dobson,D,NYI,24,82,17,51,68
82,8475692,Mats Zuccarello,R,MIN,37,82,15,53,68
82,8477501,Valeri Nichushkin,R,COL,29,82,41,26,67
82,8480208,Drake Batherson,R,OTT,26,82,28,39,67
82,8478444,Brock Boeser,R,VAN,27,82,34,32,66
82,8482078,Lucas Raymond,L,DET,22,82,22,44,66
82,8480839,Rasmus Dahlin,D,BUF,24,82,15,51,66
82,8477955,Jared McCann,L,SEA,28,82,34,31,65
82,8480830,Andrei Svechnikov,R,CAR,24,82,32,33,65
82,8475158,Ryan O'Reilly,C,NSH,33,82,30,35,65
82,8476875,Mike Matheson,D,MTL,30,82,11,54,65
82,8476448,William Karlsson,C,VGK,31,82,25,39,64
82,8481528,Dylan Cozens,C,BUF,23,82,23,41,64
82,8475798,Mikael Granlund,C,SJS,32,82,16,48,64
82,8477500,Bo Horvat,C,NYI,29,82,34,29,63
82,8475784,Jeff Skinner,C,EDM,32,82,32,31,63
82,8476460,Mark Scheifele,C,WPG,31,82,31,32,63
82,8476483,Rickard Rakell,R,PIT,31,82,27,36,63
82,8471215,Evgeni Malkin,C,PIT,38,82,23,40,63
82,8473512,Claude Giroux,R,OTT,36,82,18,45,63
82,8475167,Victor Hedman,D,TBL,34,82,17,46,63
82,8477451,Ryan Hartman,R,MIN,30,82,27,35,62
82,8476792,Torey Krug,D,STL,33,82,17,45,62
82,8482740,Wyatt Johnston,C,DAL,21,82,34,27,61
82,8478042,Viktor Arvidsson,R,EDM,31,82,29,32,61
82,8476826,Yanni Gourde,C,SEA,33,82,24,37,61
82,8479345,Jakob Chychrun,D,WSH,26,82,22,39,61
82,8474102,David Perron,L,OTT,36,82,20,41,61
82,8478460,Zach Werenski,D,CBJ,27,82,12,49,61
82,8471724,Kris Letang,D,PIT,37,82,12,49,61
82,8480803,Evan Bouchard,D,EDM,25,82,11,50,61
82,8480014,Gabriel Vilardi,C,WPG,25,82,34,26,60
82,8477416,Oliver Bjorkstrand,R,SEA,29,82,27,33,60
82,8475765,Vladimir Tarasenko,R,DET,33,82,24,36,60
82,8475745,Charlie Coyle,C,BOS,32,82,21,39,60
82,8481711,Matias Maccelli,L,UTA,24,82,19,41,60
82,8480028,Morgan Frost,C,PHI,25,82,16,44,60
82,8484144,Connor Bedard,C,CHI,19,82,32,27,59
82,8482665,Matty Beniers,C,SEA,22,82,23,36,59
82,8478519,Anthony Cirelli,C,TBL,27,82,23,36,59
82,8477504,Josh Morrissey,D,WPG,29,82,18,41,59
82,8481581,Thomas Harley,D,DAL,23,82,17,42,59
82,8474563,Drew Doughty,D,LAK,35,82,14,45,59
82,8474578,Erik Karlsson,D,PIT,34,82,9,50,59
82,8476456,Jonathan Huberdeau,C,CGY,31,82,8,51,59
82,8475726,Tyler Toffoli,C,SJS,32,82,36,22,58
82,8480015,Owen Tippett,R,PHI,25,82,29,29,58
82,8473986,Alex Killorn,L,ANA,35,82,27,31,58
82,8480018,Nick Suzuki,C,MTL,25,82,20,38,58
82,8477940,Nikolaj Ehlers,L,WPG,28,82,19,39,58
82,8479999,Casey Mittelstadt,C,COL,26,82,19,39,58
82,8481596,Shane Pinto,C,OTT,24,82,28,29,57
82,8475791,Taylor Hall,L,CHI,33,82,24,33,57
82,8477476,Artturi Lehkonen,L,COL,29,82,23,34,57
82,8476905,Chandler Stephenson,C,SEA,30,82,22,35,57
82,8476539,Jonathan Marchessault,R,NSH,34,82,30,26,56
82,8478366,Frank Vatrano,R,ANA,30,82,29,27,56
82,8477951,Nick Schmaltz,C,UTA,28,82,22,34,56
82,8481533,Trevor Zegras,C,ANA,23,82,20,36,56
82,8475151,Kyle Palmieri,C,NYI,33,82,32,23,55
82,8475191,Reilly Smith,R,NYR,33,82,25,30,55
82,8478397,Rasmus Andersson,D,CGY,28,82,8,47,55
82,8480188,Fabian Zetterlund,L,SJS,25,82,24,30,54
82,8482699,Dylan Guenther,R,UTA,21,82,22,32,54
82,8481560,Arthur Kaliyev,R,LAK,23,82,20,34,54
82,8478856,Conor Garland,R,VAN,28,82,18,36,54
82,8477503,Max Domi,C,TOR,29,82,18,36,54
82,8471698,T.J. Oshie,R,WSH,38,82,17,37,54
82,8482109,Alexis Lafrenière,L,NYR,23,82,29,24,53
82,8482159,Tyson Foerster,R,PHI,22,82,29,24,53
82,8475768,Jaden Schwartz,C,SEA,32,82,28,25,53
82,8477964,Ivan Barbashev,C,VGK,29,82,27,26,53
82,8476399,Blake Coleman,C,CGY,33,82,27,26,53
82,8477935,Sam Bennett,C,FLA,28,82,27,26,53
82,8482093,Seth Jarvis,C,CAR,22,82,24,29,53
82,8478233,Andrew Mangiapane,L,WSH,28,82,24,29,53
82,8477497,Sean Monahan,C,CBJ,30,82,20,33,53
82,8478438,Tommy Novak,C,NSH,27,82,17,36,53
82,8482671,Owen Power,D,BUF,22,82,16,37,53
82,8479425,Filip Hronek,D,VAN,27,82,14,39,53
82,8476462,Dougie Hamilton,D,NJD,31,82,13,40,53
82,8475754,Brock Nelson,C,NYI,33,82,22,30,52
82,8475794,Tyler Seguin,C,DAL,32,82,21,31,52
82,8477495,Seth Jones,D,CHI,30,82,19,33,52
82,8477986,Brandon Montour,D,SEA,30,82,15,37,52
82,8476906,Shayne Gostisbehere,D,CAR,31,82,12,40,52
82,8480797,Joel Farabee,L,PHI,24,82,22,29,51
82,8478462,Nicolas Roy,C,VGK,27,82,19,32,51
82,8476872,Scott Laughton,C,PHI,30,82,18,33,51
82,8478414,Timo Meier,R,NJD,28,82,31,19,50
82,8481068,Yegor Sharangovich,C,CGY,26,82,31,19,50
82,8476432,Boone Jenner,C,CBJ,31,82,28,22,50
82,8482097,Jack Quinn,R,BUF,23,82,26,24,50
82,8478975,Mason Marchment,L,DAL,29,82,24,26,50
82,8477407,Anthony Duclair,L,NYI,29,82,22,28,50
82,8480039,Martin Necas,C,CAR,25,82,21,29,50
82,8479410,Mikhail Sergachev,D,UTA,26,82,11,39,50
82,8479325,Charlie McAvoy,D,BOS,27,82,8,42,50
82,8475169,Evander Kane,L,EDM,33,82,28,21,49
82,8475170,Brayden Schenn,C,STL,33,82,26,23,49
82,8478498,Jake DeBrusk,L,VAN,28,82,24,25,49
82,8474150,Mikael Backlund,C,CGY,35,82,20,29,49
82,8477426,Nicholas Paul,L,TBL,29,82,21,27,48
82,8474586,Jordan Eberle,R,SEA,34,82,20,28,48
82,8477479,Tyler Bertuzzi,L,CHI,29,82,14,34,48
82,8478458,Jack Roslovic,C,CAR,27,82,14,34,48
82,8480434,Sean Durzi,D,UTA,26,82,12,36,48
82,8482124,Quinton Byfield,R,LAK,22,82,18,29,47
82,8475287,Erik Haula,L,NJD,33,82,17,30,47
82,8478396,Noah Hanifin,D,VGK,27,82,10,37,47
82,8474716,Jared Spurgeon,D,MIN,35,82,10,37,47
82,8479525,Ross Colton,C,COL,28,82,26,20,46
82,8482475,Yegor Chinakhov,R,CBJ,23,82,21,25,46
82,8478133,Jake Evans,C,MTL,28,82,16,30,46
82,8478038,Devon Toews,D,COL,30,82,12,34,46
82,8480009,Eeli Tolvanen,R,SEA,25,82,27,18,45
82,8479339,Patrik Laine,L,CBJ,26,82,24,21,45
82,8475786,Zach Hyman,L,EDM,32,82,22,23,45
82,8476479,Phillip Danault,C,LAK,31,82,15,30,45
82,8480798,Philipp Kurashev,C,CHI,25,82,10,35,45
82,8478469,Thomas Chabot,D,OTT,27,82,3,42,45
82,8477456,J.T. Compher,L,DET,29,82,24,20,44
82,8477987,Ryan Donato,C,CHI,28,82,20,24,44
82,8480849,Barrett Hayton,C,UTA,24,82,19,25,44
82,8479400,Pierre-Luc Dubois,L,WSH,26,82,17,27,44
82,8475763,Kevin Hayes,R,PIT,32,82,16,28,44
82,8476869,Brady Skjei,D,NSH,30,82,14,30,44
82,8474679,Gustav Nyquist,C,NSH,35,82,13,31,44
82,8482175,JJ Peterka,R,BUF,22,82,23,20,43
82,8475848,Brendan Gallagher,R,MTL,32,82,23,20,43
82,8482667,William Eklund,L,SJS,22,82,21,22,43
82,8474641,Adam Henrique,C,EDM,34,82,20,23,43
82,8480829,Jesperi Kotkaniemi,C,CAR,24,82,20,23,43
82,8477425,Miles Wood,L,COL,29,82,20,23,43
82,8479591,Michael Eyssimont,C,TBL,28,82,16,27,43
82,8480871,Adam Boqvist,D,FLA,24,82,16,27,43
82,8477932,Aaron Ekblad,D,FLA,28,82,15,28,43
82,8482146,Luke Evangelista,R,NSH,22,82,15,28,43
82,8482684,Luke Hughes,D,NJD,21,82,11,32,43
82,8478472,Mathieu Joseph,R,STL,27,82,10,33,43
82,8475753,Justin Faulk,D,STL,32,82,9,34,43
82,8481542,Moritz Seider,D,DET,23,82,5,38,43
82,8483808,Andrei Kuzmenko,L,CGY,28,82,27,15,42
82,8480064,Josh Norris,C,OTT,25,82,25,17,42
82,8476474,Stefan Noesen,R,NJD,31,82,22,20,42
82,8474149,Evgenii Dadonov,R,DAL,35,82,19,23,42
82,8476461,Sean Couturier,C,PHI,32,82,12,30,42
82,8482660,Kent Johnson,C,CBJ,22,82,11,31,42
82,8477948,Travis Sanheim,D,PHI,28,82,9,33,42
82,8482110,Dawson Mercer,C,NJD,23,82,20,21,41
82,8478474,Lawson Crouse,L,UTA,27,82,20,21,41
82,8475799,Nino Niederreiter,R,WPG,32,82,20,21,41
82,8481624,Ilya Mikheyev,R,CHI,30,82,18,23,41
82,8475714,Calle Jarnkrok,C,TOR,33,82,16,25,41
82,8479351,Sam Steel,C,DAL,26,82,15,26,41
82,8476923,Damon Severson,D,CBJ,30,82,9,32,41
82,8476979,Erik Gustafsson,D,DET,32,82,6,35,41
82,8480893,Kirill Marchenko,R,CBJ,24,82,26,14,40
82,8476880,Tom Wilson,R,WSH,30,82,22,18,40
82,8482745,Mason McTavish,C,ANA,21,82,19,21,40
82,8473533,Jordan Staal,C,CAR,36,82,16,24,40
82,8477989,Christian Dvorak,C,MTL,28,82,16,24,40
82,8477429,Andrew Copp,C,DET,30,82,15,25,40
82,8476292,Ondrej Palat,L,NJD,33,82,15,25,40
82,8477346,MacKenzie Weegar,D,CGY,30,82,13,27,40
82,8476885,Jacob Trouba,D,NYR,30,82,10,30,40
82,8475764,Cam Fowler,D,ANA,33,82,8,32,40
82,8474565,Alex Pietrangelo,D,VGK,34,82,6,34,40
82,8474715,Cam Atkinson,R,TBL,35,82,20,19,39
82,8481554,Kaapo Kakko,R,NYR,23,82,17,22,39
82,8482149,Cole Perfetti,C,WPG,22,82,16,23,39
82,8480220,Noah Cates,L,PHI,25,82,16,23,39
82,8477953,Kasperi Kapanen,R,STL,28,82,16,23,39
82,8482113,Anton Lundell,C,FLA,23,82,15,24,39
82,8481656,Aliaksei Protas,C,WSH,23,82,15,24,39
82,8479992,Michael Rasmussen,C,DET,25,82,15,24,39
82,8477444,Andre Burakovsky,L,SEA,29,82,13,26,39
82,8479987,Morgan Geekie,C,BOS,26,82,13,26,39
82,8480185,Eetu Luostarinen,C,FLA,26,82,10,29,39
82,8476854,Hampus Lindholm,D,BOS,30,82,5,34,39
82,8481604,Pavel Dorofeyev,L,VGK,24,82,27,11,38
82,8478508,Yakov Trenin,C,MIN,27,82,24,14,38
82,8476419,Jean-Gabriel Pageau,C,NYI,32,82,17,21,38
82,8477494,Jonathan Drouin,L,COL,29,82,16,22,38
82,8475218,Mattias Ekholm,D,EDM,34,82,16,22,38
82,8478115,Pierre Engvall,L,NYI,28,82,16,22,38
82,8482125,Alexander Holtz,R,VGK,22,82,16,22,38
82,8477511,Anthony Mantha,R,CGY,30,82,15,23,38
82,8478542,Evan Rodrigues,C,FLA,31,82,14,24,38
82,8479398,Samuel Girard,D,COL,26,82,8,30,38
82,8480873,Rasmus Sandin,D,WSH,24,82,6,32,38
82,8475760,Nick Bjugstad,C,UTA,32,82,23,14,37
82,8482079,Marco Rossi,C,MIN,23,82,23,14,37
82,8479365,Trent Frederic,C,BOS,26,82,22,15,37
82,8477450,Jason Dickinson,C,CHI,29,82,21,16,37
82,8481704,Juuso Parssinen,C,NSH,23,82,19,18,37
82,8476469,Joel Armia,R,MTL,31,82,19,18,37
82,8474189,Lars Eller,C,PIT,35,82,18,19,37
82,8476438,Brandon Saad,L,STL,32,82,16,21,37
82,8481618,Alex Newhook,C,MTL,23,82,16,21,37
82,8473563,Nicklas Backstrom,C,WSH,37,82,16,21,37
82,8476927,Teddy Blueger,C,VAN,30,82,14,23,37
82,8482117,Lukas Reichel,L,CHI,22,82,14,23,37
82,8477015,Connor Brown,R,EDM,30,82,13,24,37
82,8475722,Jason Zucker,L,BUF,32,82,12,25,37
82,8475149,Marcus Johansson,L,MIN,34,82,12,25,37
82,8477021,Alex Kerfoot,C,UTA,30,82,11,26,37
82,8470613,Brent Burns,D,CAR,39,82,9,28,37
82,8481582,Nicholas Robertson,L,TOR,23,82,20,16,36
82,8479293,Brandon Tanev,L,SEA,33,82,17,19,36
82,8481580,Connor McMichael,C,WSH,23,82,17,19,36
82,8470621,Corey Perry,R,EDM,39,82,16,20,36
82,8475193,Tomas Tatar,L,NJD,34,82,15,21,36
82,8478046,Danton Heinen,L,VAN,29,82,11,25,36
82,8474053,Logan Couture,C,SJS,35,82,11,25,36
82,8480043,Timothy Liljegren,D,TOR,25,82,5,31,36
82,8477969,Marcus Pettersson,D,PIT,28,82,3,33,36
82,8475793,Ryan Johansen,C,PHI,32,82,19,16,35
82,8477952,Robby Fabbri,C,ANA,28,82,19,16,35
82,8483515,Juraj Slafkovsky,L,MTL,20,82,18,17,35
82,8480748,Kiefer Sherwood,L,VAN,29,82,17,18,35
82,8482720,Matthew Knies,L,TOR,22,82,17,18,35
82,8476960,Andreas Athanasiou,C,CHI,30,82,14,21,35
82,8473422,Nick Foligno,L,CHI,37,82,13,22,35
82,8482055,Drew O'Connor,L,PIT,26,82,10,25,35
82,8478463,Anthony Beauvillier,L,PIT,27,82,21,13,34
82,8480802,Ryan McLeod,C,BUF,25,82,17,17,34
82,8478891,Mason Appleton,C,WPG,28,82,14,20,34
82,8481546,Cam York,D,PHI,23,82,10,24,34
82,8476925,Colton Sissons,C,NSH,31,82,9,25,34
82,8476329,Travis Boyd,C,MIN,31,82,8,26,34
82,8481522,Peyton Krebs,C,BUF,23,82,6,28,34
82,8482087,Kaiden Guhle,D,MTL,22,82,6,28,34
82,8479402,Jake Bean,D,CGY,26,82,5,29,34
82,8473507,Jeff Petry,D,DET,37,82,4,30,34
82,8479976,Juuso Valimaki,D,UTA,26,82,4,30,34
82,8476931,Jake McCabe,D,TOR,31,82,3,31,34
82,8481178,Egor Zamula,D,PHI,24,82,0,34,34
82,8475314,Anders Lee,L,NYI,34,82,20,13,33
82,8477998,Warren Foegele,L,LAK,28,82,15,18,33
82,8479996,Cody Glass,C,NSH,25,82,15,18,33
82,8479353,Brett Howden,C,VGK,26,82,15,18,33
82,8478057,Dakota Joshua,C,VAN,28,82,14,19,33
82,8480459,Pius Suter,C,VAN,28,82,13,20,33
82,8476921,Jordan Martinook,L,CAR,32,82,13,20,33
82,8477947,Sonny Milano,L,WSH,28,82,13,20,33
82,8481186,Logan O'Connor,R,COL,28,82,12,21,33
82,8476458,Ryan Strome,C,ANA,31,82,9,24,33
82,8476958,Jaccob Slavin,D,CAR,30,82,6,27,33
82,8477506,Ryan Pulock,D,NYI,30,82,5,28,33
82,8478882,Vladislav Gavrikov,D,LAK,29,82,4,29,33
82,8478020,Michael Amadio,C,OTT,28,82,21,11,32
82,8483431,Logan Cooley,C,UTA,20,82,18,14,32
82,8480113,Alex Iafallo,L,WPG,31,82,14,18,32
82,8480806,Isac Lundestrom,C,ANA,25,82,12,20,32
82,8476392,Adam Lowry,C,WPG,31,82,10,22,32
82,8478055,Gustav Forsling,D,FLA,28,82,9,23,32
82,8484153,Leo Carlsson,C,ANA,20,82,9,23,32
82,8479390,Taylor Raddysh,R,WSH,26,82,19,12,31
82,8476981,Josh Anderson,R,MTL,30,82,18,13,31
82,8480003,Jesper Boqvist,C,FLA,26,82,12,19,31
82,8480855,Jack McBain,C,UTA,24,82,10,21,31
82,8478840,Will Borgen,D,SEA,28,82,6,25,31
82,8476917,Adam Pelech,D,NYI,30,82,5,26,31
82,8477498,Darnell Nurse,D,EDM,29,82,4,27,31
82,8482089,Jake Neighbours,L,STL,22,82,21,9,30
82,8481535,Nils Hoglander,L,VAN,24,82,21,9,30
82,8478413,Jordan Greenway,L,BUF,27,82,14,16,30
82,8476278,Colin Blackwell,C,DAL,31,82,13,17,30
82,8482807,Ethan Del Mastro,D,CHI,21,82,11,19,30
82,8480817,K'Andre Miller,D,NYR,24,82,10,20,30
82,8480813,Joe Veleno,C,DET,24,82,10,20,30
82,8474574,Tyler Myers,D,VAN,34,82,9,21,30
82,8476331,Dylan DeMelo,D,WPG,31,82,7,23,30
82,8476897,Oskar Sundqvist,C,STL,30,82,5,25,30
82,8474673,TJ Brodie,D,CHI,34,82,4,26,30
82,8478500,Ivan Provorov,D,CBJ,27,82,3,27,30
82,8482077,Dylan Holloway,L,EDM,23,82,17,12,29
82,8482092,Ridly Greig,C,OTT,22,82,16,13,29
82,8481481,Blake Lizotte,C,PIT,27,82,15,14,29
82,8482705,Cole Sillinger,C,CBJ,21,82,15,14,29
82,8478109,Victor Olofsson,L,VGK,29,82,15,14,29
82,8482259,Bobby McMann,C,TOR,28,82,15,14,29
82,8480835,Jack Drury,C,CAR,24,82,13,16,29
82,8482145,Mavrik Bourque,C,DAL,22,82,13,16,29
82,8477505,Alexander Wennberg,C,SJS,30,82,12,17,29
82,8481013,Jonatan Berggren,R,DET,24,82,11,18,29
82,8482133,Thomas Bordeleau,C,SJS,22,82,11,18,29
82,8480068,Ryan Poehling,C,PHI,25,82,10,19,29
82,8478432,Christian Fischer,R,DET,27,82,10,19,29
82,8482105,Jake Sanderson,D,OTT,22,82,9,20,29
82,8480878,Nils Lundkvist,D,DAL,24,82,9,20,29
82,8475171,Oliver Ekman-Larsson,D,TOR,33,82,7,22,29
82,8476463,Jonas Brodin,D,MIN,31,82,7,22,29
82,8481606,Jordan Spence,D,LAK,23,82,5,24,29
82,8476902,Esa Lindell,D,DAL,30,82,5,24,29
82,8482073,Braden Schneider,D,NYR,23,82,3,26,29
82,8483505,Matthew Poitras,C,BOS,20,82,16,12,28
82,8476918,Jimmy Vesey,L,NYR,31,82,15,13,28
82,8479661,Tanner Jeannot,L,LAK,27,82,14,14,28
82,8477839,Conor Sheary,L,TBL,32,82,12,16,28
82,8483457,Lane Hutson,D,MTL,20,82,11,17,28
82,8475200,Dmitry Orlov,D,CAR,33,82,6,22,28
82,8481568,Alex Vlasic,D,CHI,23,82,2,26,28
82,8475855,Jesper Fast,R,CAR,33,82,15,12,27
82,8481093,Rafael Harvey-Pinard,L,MTL,25,82,14,13,27
82,8480145,Neal Pionk,D,WPG,29,82,9,18,27
82,8481524,Bowen Byram,D,BUF,23,82,9,18,27
82,8481567,Henry Thrun,D,SJS,23,82,7,20,27
82,8476457,Adam Larsson,D,SEA,32,82,6,21,27
82,8479369,Andrew Peeke,D,BOS,26,82,4,23,27
82,8478851,Alexandre Carrier,D,NSH,28,82,4,23,27
82,8480246,Nick Perbix,D,TBL,26,82,2,25,27
82,8480789,Oliver Wahlstrom,R,NYI,24,82,14,12,26
82,8481553,Bobby Brink,R,PHI,23,82,12,14,26
82,8480980,Connor Dewar,C,TOR,25,82,12,14,26
82,8480448,Parker Kelly,L,COL,25,82,12,14,26
82,8476374,Sean Kuraly,C,CBJ,31,82,10,16,26
82,8482803,Olen Zellweger,D,ANA,21,82,10,16,26
82,8476480,Vladislav Namestnikov,C,WPG,32,82,8,18,26
82,8483495,Simon Nemec,D,NJD,20,82,8,18,26
82,8482142,Jamie Drysdale,D,PHI,22,82,8,18,26
82,8482122,Brock Faber,D,MIN,22,82,7,19,26
82,8482166,Shakir Mukhamadullin,D,SJS,22,82,7,19,26
82,8475462,Radko Gudas,D,ANA,34,82,6,20,26
82,8475188,Brayden McNabb,D,VGK,33,82,4,22,26
82,8476879,Cody Ceci,D,EDM,31,82,4,22,26
82,8479393,Noah Gregor,C,OTT,26,82,16,9,25
82,8479316,Luke Kunin,C,SJS,27,82,16,9,25
82,8484166,Adam Fantilli,C,CBJ,20,82,14,11,25
82,8482624,Daniil Miromanov,D,CGY,27,82,13,12,25
82,8482074,Connor Zary,C,CGY,23,82,13,12,25
82,8479359,Beck Malenstyn,L,BUF,26,82,11,14,25
82,8483468,Jiri Kulich,C,BUF,20,82,11,14,25
82,8480035,Henri Jokiharju,D,BUF,25,82,9,16,25
82,8476442,Matt Nieto,L,PIT,32,82,9,16,25
82,8481028,Martin Pospisil,C,CGY,25,82,9,16,25
82,8483490,Pavel Mintyukov,D,ANA,21,82,6,19,25
82,8478507,John Marino,D,UTA,27,82,6,19,25
82,8475220,Marcus Foligno,L,MIN,33,82,5,20,25
82,8482062,Cole Smith,L,NSH,29,82,16,8,24
82,8476878,Zemgus Girgensons,L,TBL,30,82,15,9,24
82,8483763,Maksymilian Szuber,D,UTA,22,82,10,14,24
82,8480222,Sebastian Aho,D,PIT,28,82,9,15,24
82,8482141,Lukas Cormier,D,VGK,22,82,8,16,24
82,8477220,Nate Schmidt,D,FLA,33,82,7,17,24
82,8479998,Mikey Anderson,D,LAK,25,82,5,19,24
82,8470600,Ryan Suter,D,STL,39,82,5,19,24
82,8478136,Jake Middleton,D,MIN,28,82,5,19,24
82,8482655,J.J. Moser,D,TBL,24,82,4,20,24
82,8482111,Justin Barron,D,MTL,23,82,4,20,24
82,8477507,Nikita Zadorov,D,BOS,29,82,4,20,24
82,8478911,Matt Roy,D,WSH,29,82,4,20,24
82,8483482,Tristan Luneau,D,ANA,20,82,4,20,24
82,8477435,Ryan Graves,D,PIT,29,82,3,21,24
82,8475324,Nick Jensen,D,OTT,34,82,3,21,24
82,8481601,Simon Holmstrom,R,NYI,23,82,12,11,23
82,8473453,Trevor Lewis,C,LAK,37,82,11,12,23
82,8476873,Mark Jankowski,C,NSH,30,82,8,15,23
82,8481477,Nico Sturm,C,SJS,29,82,6,17,23
82,8483565,Nick Blankenburg,D,NSH,26,82,5,18,23
82,8478416,Erik Cernak,D,TBL,27,82,4,19,23
82,8478468,Jeremy Lauzon,D,NSH,27,82,4,19,23
82,8482245,Artem Zub,D,OTT,29,82,3,20,23
82,8476312,Josh Manson,D,COL,33,82,3,20,23
82,8479941,Justin Danforth,R,CBJ,31,82,13,9,22
82,8482762,Simon Edvinsson,D,DET,21,82,13,9,22
82,8475231,Casey Cizikas,C,NYI,33,82,12,10,22
82,8480336,Sean Walker,D,CAR,30,82,11,11,22
82,8478211,Dryden Hunt,L,CGY,29,82,11,11,22
82,8481517,Brett Leason,R,ANA,25,82,11,11,22
82,8478013,Jake Walman,D,SJS,28,82,10,12,22
82,8477392,Hudson Fasching,R,NYI,29,82,10,12,22
82,8480995,Pontus Holmberg,R,TOR,25,82,8,14,22
82,8475343,Nic Dowd,C,WSH,34,82,5,17,22
82,8480807,Mattias Samuelsson,D,BUF,24,82,3,19,22
82,8480073,Erik Brannstrom,D,COL,25,82,3,19,22
82,8476467,Jamie Oleksiak,D,SEA,32,82,2,20,22
82,8474151,Ryan McDonagh,D,TBL,35,82,1,21,22
82,8477903,Garnet Hathaway,R,PHI,33,82,13,8,21
82,8481032,Paul Cotter,C,NJD,25,82,7,14,21
82,8477488,Brett Pesce,D,NJD,30,82,6,15,21
82,8476892,Colton Parayko,D,STL,31,82,6,15,21
82,8480074,Alexandre Texier,C,STL,25,82,5,16,21
82,8476525,Colin Miller,D,WPG,32,82,5,16,21
82,8475790,Erik Gudbranson,D,CBJ,32,82,4,17,21
82,8480144,David Kampf,C,TOR,29,82,4,17,21
82,8480049,Dylan Samberg,D,WPG,25,82,0,21,21
82,8479368,Max Jones,L,BOS,26,82,12,8,20
82,8479414,Nathan Bastian,R,NJD,27,82,10,10,20
82,8477369,Carson Soucy,D,VAN,30,82,10,10,20
82,8477919,Frederick Gaudreau,C,MIN,31,82,9,11,20
82,8478569,Noel Acciari,C,PIT,33,82,9,11,20
82,8480990,Declan Chisholm,D,MIN,24,82,9,11,20
82,8483499,Liam Ohgren,L,MIN,20,82,8,12,20
82,8477931,Tomas Nosek,L,FLA,32,82,7,13,20
82,8482702,Logan Stankoven,C,DAL,21,82,7,13,20
82,8479324,Ryan Lindgren,D,NYR,26,82,6,14,20
82,8482809,Jackson Blake,R,CAR,21,82,4,16,20
82,8477845,Trevor van Riemsdyk,D,WSH,33,82,4,16,20
82,8476422,Mike Reilly,D,NYI,31,82,3,17,20
82,8475181,Nick Leddy,D,STL,33,82,2,18,20
82,8475455,Brenden Dillon,D,NJD,34,82,1,19,20
82,8477406,Mattias Janmark,C,EDM,32,82,12,7,19
82,8482749,Joshua Roy,R,MTL,21,82,8,11,19
82,8476889,Radek Faksa,C,STL,30,82,7,12,19
82,8479983,Mario Ferraro,D,SJS,26,82,6,13,19
82,8476858,Phillip Di Giuseppe,L,VAN,31,82,8,10,18
82,8478434,Keegan Kolesar,R,VGK,27,82,6,12,18
82,8480025,MacKenzie Entwistle,R,FLA,25,82,6,12,18
82,8484145,Zach Benson,L,BUF,19,82,6,12,18
82,8475842,Sam Carrick,C,NYR,32,82,6,12,18
82,8479371,Dante Fabbro,D,NSH,26,82,4,14,18
82,8476624,Barclay Goodrow,C,SJS,31,82,4,14,18
82,8479442,Troy Stecher,D,EDM,30,82,4,14,18
82,8475233,David Savard,D,MTL,34,82,4,14,18
82,8475762,Derek Forbort,D,VAN,32,82,4,14,18
82,8476967,Brett Kulak,D,EDM,30,82,3,15,18
82,8480879,Jacob Bernard-Docker,D,OTT,24,82,2,16,18
82,8476441,Joel Edmundson,D,LAK,31,82,2,16,18
82,8478178,Darren Raddysh,D,TBL,28,82,2,16,18
82,8475690,Chris Tanev,D,TOR,35,82,1,17,18
82,8476429,Scott Mayfield,D,NYI,32,82,0,18,18
82,8476822,Luke Glendening,C,TBL,35,82,11,6,17
82,8479291,Kevin Rooney,C,CGY,31,82,9,8,17
82,8483445,Cutter Gauthier,L,ANA,20,82,8,9,17
82,8482101,Danil Gushchin,L,SJS,22,82,5,12,17
82,8483012,Logan Morrison,C,SEA,22,82,5,12,17
82,8483493,Frank Nazar,C,CHI,20,82,5,12,17
82,8482858,Ryker Evans,D,SEA,23,82,4,13,17
82,8474013,Ian Cole,D,UTA,35,82,4,13,17
82,8481708,Zac Jones,D,NYR,24,82,3,14,17
82,8481014,Alexander Romanov,D,NYI,24,82,3,14,17
82,8478443,Brandon Carlo,D,BOS,28,82,3,14,17
82,8477938,Haydn Fleury,D,WPG,28,82,3,14,17
82,8476891,Matt Grzelcyk,D,PIT,30,82,2,15,17
82,8478450,Parker Wotherspoon,D,BOS,27,82,2,15,17
82,8480021,Jack Studnicka,C,LAK,25,82,9,7,16
82,8482659,Josh Doan,R,UTA,22,82,8,8,16
82,8477353,Tyler Motte,C,DET,29,82,7,9,16
82,8477365,Connor Clifton,D,BUF,29,82,5,11,16
82,8474612,Travis Hamonic,D,OTT,34,82,5,11,16
82,8481699,Aku Raty,R,UTA,23,82,4,12,16
82,8471677,Jack Johnson,D,CBJ,37,82,3,13,16
82,8475718,Justin Holl,D,DET,32,82,2,14,16
82,8474090,Brendan Smith,D,DAL,35,82,2,14,16
82,8478399,Jonas Siegenthaler,D,NJD,27,82,0,16,16
82,8482118,Sam Colangelo,R,ANA,23,82,9,6,15
82,8484203,Bradly Nadeau,L,CAR,19,82,6,9,15
82,8477508,Curtis Lazar,C,NJD,29,82,6,9,15
82,8475279,Ben Chiarot,D,DET,33,82,3,12,15
82,8475177,Calvin de Haan,D,COL,33,82,3,12,15
82,8479980,Nicolas Hague,D,VGK,26,82,2,13,15
82,8482733,Logan Mailloux,D,MTL,31,82,6,8,14
82,8477335,Kyle Burroughs,D,LAK,29,82,5,9,14
82,8478859,Niko Mikkola,D,FLA,28,82,4,10,14
82,8482679,Matt Coronato,R,CGY,22,82,3,11,14
82,8476473,Connor Murphy,D,CHI,31,82,3,11,14
82,8477499,Rasmus Ristolainen,D,PHI,30,82,2,12,14
82,8480281,Alexey Toropchenko,R,STL,25,82,11,2,13
82,8481641,Joel Kiviranta,L,COL,28,82,10,3,13
82,8482153,Brendan Brisson,C,VGK,23,82,6,7,13
82,8482712,Oskar Olausson,R,COL,22,82,6,7,13
82,8482787,Nikita Chibrikov,R,WPG,31,82,6,7,13
82,8482713,Mackie Samoskevich,R,FLA,22,82,5,8,13
82,8482666,Scott Morrow,D,CAR,22,82,4,9,13
82,8480834,Ty Emberson,D,SJS,24,82,3,10,13
82,8480796,Martin Fehervary,D,WSH,25,82,3,10,13
82,8480950,Ilya Lyubushkin,D,DAL,30,82,2,11,13
82,8477034,Jaycob Megna,D,FLA,32,82,2,11,13
82,8480172,Jan Rutta,D,SJS,34,82,2,11,13
82,8474567,Zach Bogosian,D,MIN,34,82,2,11,13
82,8480870,Bo Groulx,C,NYR,24,82,6,6,12
82,8482470,Ilya Solovyov,D,CGY,24,82,3,9,12
82,8483524,Shane Wright,C,SEA,20,82,5,6,11
82,8481605,Jackson LaCombe,D,ANA,23,82,5,6,11
82,8483471,Brad Lambert,C,WPG,31,82,4,7,11
82,8482859,Zack Ostapchuk,C,OTT,21,82,4,7,11
82,8478874,Adam Gaudette,C,OTT,28,82,3,8,11
82,8476372,Nick Seeler,D,PHI,31,82,1,10,11
82,8483460,David Jiricek,D,CBJ,21,82,0,11,11
82,8482155,Alex Laferriere,R,LAK,23,82,6,4,10
82,8479576,Vincent Desharnais,D,VAN,28,82,3,7,10
82,8483466,Kevin Korchinski,D,CHI,20,82,2,8,10
82,8483567,Georgii Merkulov,C,BOS,24,82,6,3,9
82,8482070,Mitchell Chaffee,R,TBL,26,82,4,5,9
82,8484911,Collin Graf,R,SJS,22,82,3,6,9
82,8481122,Simon Benoit,D,TOR,26,82,2,7,9
82,8482516,Matthew Kessel,D,STL,24,82,3,5,8
82,8480860,Kevin Bahl,D,CGY,24,82,2,5,7
82,8484149,Gavin Brindley,C,CBJ,20,82,2,5,7
82,8479638,Justin Brazeau,R,BOS,26,82,1,6,7
82,8474062,Riley Nash,C,NYR,35,82,1,6,7
82,8483397,Marc McLaughlin,C,BOS,25,82,4,2,6
82,8483489,Fraser Minten,C,TOR,31,82,1,4,5
82,8470794,Joe Pavelski,C,,40,0,0,0,0
82,8481703,Valtteri Puustinen,R,PIT,25,0,0,0,0
82,8477950,Tony DeAngelo,D,,29,0,0,0,0
82,8481577,Philip Tomasino,C,NSH,23,0,0,0,0
82,8475197,Tyson Barrie,D,,33,0,0,0,0
82,8471218,Blake Wheeler,R,,38,0,0,0,0
82,8474157,Max Pacioretty,L,,36,0,0,0,0
82,8478466,Daniel Sprong,R,VAN,27,0,0,0,0
82,8475744,Evgeny Kuznetsov,C,,32,0,0,0,0
82,8481019,David Gustafsson,C,WPG,24,0,0,0,0
82,8475906,John Klingberg,D,,32,0,0,0,0
82,8479348,Kale Clague,D,BUF,26,0,0,0,0
82,8476952,Dominic Toninato,C,WPG,30,0,0,0,0
82,8473473,Milan Lucic,L,,36,0,0,0,0
82,8474037,James van Riemsdyk,L,,35,0,0,0,0
82,8474602,Justin Schultz,D,,34,0,0,0,0
82,8482222,Alexander Barabanov,L,,30,0,0,0,0
82,8479372,Josh Mahura,D,SEA,26,0,0,0,0
82,8479982,Conor Timmins,D,TOR,26,0,0,0,0
82,8474031,Kevin Shattenkirk,D,,35,0,0,0,0
82,8480008,Adam Ruzicka,C,,25,0,0,0,0
82,8481059,Scott Perunovich,D,STL,26,0,0,0,0
82,8480884,Calen Addison,D,,24,0,0,0,0
82,8476994,Vinnie Hinostroza,C,NSH,30,0,0,0,0
82,8478452,Caleb Jones,D,LAK,27,0,0,0,0
82,8480157,Calle Rosen,D,COL,30,0,0,0,0
82,8481609,Vladislav Kolyachonok,D,UTA,23,0,0,0,0
82,8479415,Michael McLeod,C,,26,0,0,0,0
82,8476919,Chris Tierney,C,,30,0,0,0,0
82,8479639,Dylan Coghlan,D,WPG,26,0,0,0,0
82,8478146,Matthew Highmore,C,OTT,28,0,0,0,0
82,8478970,Jalen Chatfield,D,CAR,28,0,0,0,0
82,8480205,Emil Bemstrom,C,PIT,25,0,0,0,0
82,8474884,Mike Hoffman,C,,35,0,0,0,0
82,8471274,Alex Goligoski,D,,39,0,0,0,0
82,8478104,Sammy Blais,L,,28,0,0,0,0
82,8474870,Tyler Johnson,C,,34,0,0,0,0
82,8476913,Devin Shore,C,MIN,30,0,0,0,0
82,8481598,Philip Broberg,D,EDM,23,0,0,0,0
82,8480058,Pierre-Olivier Joseph,D,STL,25,0,0,0,0
82,8480891,Michael Kesselring,D,UTA,24,0,0,0,0
82,8477979,Nicolas Aube-Kubel,R,BUF,28,0,0,0,0
82,8476871,Tanner Pearson,L,,32,0,0,0,0
82,8476393,Nick Cousins,C,,31,0,0,0,0
82,8479977,Kailer Yamamoto,R,,26,0,0,0,0
82,8479543,Michael Pezzetta,L,MTL,26,0,0,0,0
82,8477018,Ben Hutton,D,VGK,31,0,0,0,0
82,8480762,Eric Robinson,L,CAR,29,0,0,0,0
82,8474034,Pat Maroon,L,CHI,36,0,0,0,0
82,8481058,Jesse Ylönen,R,,25,0,0,0,0
82,8475179,Dmitry Kulikov,D,FLA,34,0,0,0,0
82,8481527,Kaedan Korczak,D,VGK,23,0,0,0,0
82,8473449,Kyle Okposo,R,,36,0,0,0,0
82,8482192,Isaak Phillips,D,CHI,23,0,0,0,0
82,8480727,Zach Whitecloud,D,VGK,28,0,0,0,0
82,8479346,Dillon Dube,C,,26,0,0,0,0
82,8480821,Filip Zadina,R,,25,0,0,0,0
82,8480001,Urho Vaakanainen,D,ANA,25,0,0,0,0
82,8470966,Mark Giordano,D,,41,0,0,0,0
82,8480853,Liam Foudy,C,,24,0,0,0,0
82,8475225,Craig Smith,C,CHI,35,0,0,0,0
82,8479972,Mason Shaw,C,WPG,26,0,0,0,0
82,8478451,Ethan Bear,D,WSH,27,0,0,0,0
82,8474040,Sam Gagner,C,,35,0,0,0,0
82,8480196,Jacob Bryson,D,BUF,27,0,0,0,0
82,8479984,Cal Foote,D,,26,0,0,0,0
82,8480011,Klim Kostin,C,SJS,25,0,0,0,0
82,8482176,Wyatt Kaiser,D,CHI,22,0,0,0,0
82,8476988,Matt Benning,D,SJS,30,0,0,0,0
82,8479370,Tyson Jost,C,CAR,26,0,0,0,0
82,8477464,Nic Petan,C,,29,0,0,0,0
82,8477380,Jonny Brodzinski,C,NYR,31,0,0,0,0
82,8480070,Ian Mitchell,D,BOS,25,0,0,0,0
82,8479315,Joey Anderson,R,CHI,26,0,0,0,0
82,8478099,Kevin Labanc,R,,29,0,0,0,0
82,8476874,Olli Maatta,D,DET,30,0,0,0,0
82,8475208,Brian Dumoulin,D,ANA,33,0,0,0,0
82,8478430,Oliver Kylington,D,,27,0,0,0,0
82,8479536,Axel Jonsson-Fjallby,L,WPG,26,0,0,0,0
82,8479671,Mathieu Olivier,R,CBJ,27,0,0,0,0
82,8471709,Marc-Edouard Vlasic,D,SJS,37,0,0,0,0
82,8479328,Julien Gauthier,R,NYI,27,0,0,0,0
82,8478421,A.J. Greer,L,FLA,28,0,0,0,0
82,8477573,Nathan Walker,L,STL,30,0,0,0,0
82,8481537,Nikita Okhotiuk,D,CGY,24,0,0,0,0
82,8474166,Alec Martinez,D,CHI,37,0,0,0,0
82,8470610,Zach Parise,L,,40,0,0,0,0
82,8477478,William Carrier,L,CAR,30,0,0,0,0
82,8479344,Jesse Puljujarvi,R,PIT,26,0,0,0,0
82,8480887,Jordan Harris,D,MTL,24,0,0,0,0
82,8478502,Dennis Gilbert,D,BUF,28,0,0,0,0
82,8482730,Brandt Clarke,D,LAK,21,0,0,0,0
82,8480355,Mark Kastelic,C,BOS,25,0,0,0,0
82,8475750,Jon Merrill,D,MIN,32,0,0,0,0
82,8475164,Jakob Silfverberg,R,,34,0,0,0,0
82,8477944,Jakub Vrana,L,,28,0,0,0,0
82,8479439,Jacob MacDonald,D,COL,31,0,0,0,0
82,8474568,Luke Schenn,D,NSH,35,0,0,0,0
82,8478454,Noah Juulsen,D,VAN,27,0,0,0,0
82,8475752,Tyler Pitlick,C,,33,0,0,0,0
82,8482148,Hendrix Lapierre,C,WSH,22,0,0,0,0
82,8481167,Brayden Pachal,D,CGY,25,0,0,0,0
82,8478043,Sam Lafferty,C,BUF,29,0,0,0,0
82,8479321,Lucas Johansen,D,,27,0,0,0,0
82,8471699,Andrew Cogliano,C,,37,0,0,0,0
82,8481521,Ronnie Attard,D,PHI,25,0,0,0,0
82,8481161,Jake Christiansen,D,CBJ,25,0,0,0,0
82,8479458,Nikita Zaitsev,D,,33,0,0,0,0
82,8479619,Michael Carcone,L,UTA,28,0,0,0,0
82,8479026,Philippe Myers,D,TOR,27,0,0,0,0
82,8477330,Dominik Kubalik,L,,29,0,0,0,0
82,8481617,Vasily Podkolzin,R,VAN,23,0,0,0,0
82,8481701,Santeri Hatakka,D,NJD,23,0,0,0,0
82,8479514,Rem Pitlick,C,,27,0,0,0,0
82,8477446,Michael McCarron,R,NSH,29,0,0,0,0
82,8470604,Jeff Carter,C,,39,0,0,0,0
82,8482241,Radim Zohorna,L,,28,0,0,0,0
82,8480289,Morgan Barron,C,WPG,26,0,0,0,0
82,8479379,Givani Smith,R,SJS,26,0,0,0,0
82,8480216,Jacob Peterson,C,,25,0,0,0,0
82,8477851,Jordan Oesterle,D,BOS,32,0,0,0,0
82,8484258,Sam Malinski,D,COL,26,0,0,0,0
82,8478904,Steven Lorentz,C,,28,0,0,0,0
82,8482095,Tyler Kleven,D,OTT,22,0,0,0,0
82,8480848,Ty Dellandrea,C,SJS,24,0,0,0,0
82,8476884,Derrick Pouliot,D,,30,0,0,0,0
82,8479336,Carl Grundstrom,R,SJS,27,0,0,0,0
82,8482964,Arber Xhekaj,D,MTL,23,0,0,0,0
82,8471686,Marc Staal,D,,37,0,0,0,0
82,8477887,Patrick Brown,C,BOS,32,0,0,0,0
82,8478495,Denis Gurianov,R,,27,0,0,0,0
82,8473504,Cal Clutterbuck,R,,37,0,0,0,0
82,8481550,Adam Beckman,L,NJD,23,0,0,0,0
82,8480845,Rasmus Kupari,C,WPG,24,0,0,0,0
82,8474009,Nick Bonino,C,,36,0,0,0,0
82,8478585,Derek Ryan,C,EDM,38,0,0,0,0
82,8477962,Brendan Lemieux,L,CAR,28,0,0,0,0
82,8482861,Vincent Iorio,D,WSH,22,0,0,0,0
82,8479378,Logan Stanley,D,WPG,26,0,0,0,0
82,8473446,Erik Johnson,D,PHI,36,0,0,0,0
82,8481743,Marc Del Gaizo,D,NSH,25,0,0,0,0
82,8477384,Josh Brown,D,EDM,30,0,0,0,0
82,8482165,Yan Kuznetsov,D,CGY,22,0,0,0,0
82,8478424,Jansen Harkins,C,ANA,27,0,0,0,0
82,8482144,Jack Thompson,D,SJS,22,0,0,0,0
82,8478512,Austin Czarnik,C,,32,0,0,0,0
82,8477527,Ross Johnston,L,ANA,30,0,0,0,0
82,8479383,Boris Katchouk,L,,26,0,0,0,0
82,8482094,Daemon Hunt,D,MIN,22,0,0,0,0
82,8481719,Maxwell Crozier,D,TBL,24,0,0,0,0
82,8480192,Johnathan Kovacevic,D,NJD,27,0,0,0,0
82,8479376,Victor Mete,D,,26,0,0,0,0
82,8482511,Mason Lohrei,D,BOS,23,0,0,0,0
82,8475825,Jani Hakanpää,D,,32,0,0,0,0
82,8478021,William Lagesson,D,DET,28,0,0,0,0
82,8475795,Dylan McIlrath,D,WSH,32,0,0,0,0
82,8477846,Ryan Carpenter,C,,33,0,0,0,0
82,8481056,Spencer Stastney,D,NSH,24,0,0,0,0
82,8481564,Ryan Johnson,D,BUF,23,0,0,0,0
82,8478017,Mark Friedman,D,VAN,29,0,0,0,0
82,8479320,Max Lajoie,D,SEA,27,0,0,0,0
82,8480075,Cameron Crotty,D,MIN,25,0,0,0,0
82,8484287,Cole McWard,D,VAN,23,0,0,0,0
82,8484254,Akito Hirose,D,VAN,25,0,0,0,0
82,8483407,Brandon Scanlin,D,NYR,25,0,0,0,0
82,8480274,Philip Kemp,D,EDM,25,0,0,0,0
82,8479522,Hardy Haman Aktell,D,WSH,26,0,0,0,0
82,8480007,Jonas Rondbjerg,R,VGK,25,0,0,0,0
82,8477454,Adam Erne,L,,29,0,0,0,0
82,8481679,Maxence Guenette,D,OTT,23,0,0,0,0
82,8480441,Trey Fix-Wolansky,R,CBJ,25,0,0,0,0
82,8483546,Marshall Rifai,D,TOR,26,0,0,0,0
82,8480084,Nick DeSimone,D,NJD,30,0,0,0,0
82,8481030,Jack St. Ivany,D,PIT,25,0,0,0,0
82,8481592,Jakob Pelletier,L,CGY,23,0,0,0,0
82,8478011,Louie Belpedio,D,PHI,28,0,0,0,0
82,8477930,Pierre-Edouard Bellemare,L,,39,0,0,0,0
82,8484321,Nikolas Matinpalo,D,OTT,26,0,0,0,0
82,8482067,Connor Mackey,D,NYR,28,0,0,0,0
82,8481806,Louis Crevier,D,CHI,23,0,0,0,0
82,8484326,Patrik Koch,D,UTA,28,0,0,0,0
82,8477971,Andreas Englund,D,LAK,28,0,0,0,0
82,8481751,Lukas Rousek,R,BUF,25,0,0,0,0
82,8481006,Tyler Tucker,D,STL,24,0,0,0,0
82,8476867,Brendan Gaunce,C,MIN,30,0,0,0,0
82,8479520,Brandon Duhaime,R,WSH,27,0,0,0,0
82,8477073,Kurtis MacDermid,L,NJD,30,0,0,0,0
82,8480874,Adam Ginning,D,PHI,24,0,0,0,0
82,8477473,Justin Bailey,R,SJS,29,0,0,0,0
82,8479066,Ryan Lomberg,L,CGY,30,0,0,0,0
82,8477070,Liam O'Brien,C,UTA,30,0,0,0,0
82,8474618,Marco Scandella,D,,34,0,0,0,0
82,8475797,Jarred Tinordi,D,,32,0,0,0,0
82,8481441,Joe Snively,C,DET,28,0,0,0,0
82,8477244,Chad Ruhwedel,D,NYR,34,0,0,0,0
82,8479772,Zack MacEwen,R,OTT,28,0,0,0,0
82,8481147,Reese Johnson,C,MIN,26,0,0,0,0
82,8481043,Cole Koepke,L,BOS,26,0,0,0,0
82,8483619,Filip Roos,D,OTT,25,0,0,0,0
82,8481541,Samuel Bolduc,D,NYI,24,0,0,0,0
82,8477810,Joel Hanley,D,CGY,33,0,0,0,0
82,8476907,Mackenzie MacEachern,L,,30,0,0,0,0
82,8482652,Walker Duehr,R,CGY,27,0,0,0,0
82,8477126,Jayson Megna,C,,34,0,0,0,0
82,8483398,Declan Carlile,D,TBL,31,0,0,0,0
82,8482929,Emil Lilleberg,D,TBL,23,0,0,0,0
82,8480880,Jakub Lauko,C,MIN,24,0,0,0,0
82,8480245,Olle Lycksell,R,PHI,25,0,0,0,0
82,8480252,Cole Guttman,C,CHI,25,0,0,0,0
82,8477467,Gustav Olofsson,D,SEA,30,0,0,0,0
82,8479968,Vinni Lettieri,C,BOS,29,0,0,0,0
82,8478400,Colin White,C,,27,0,0,0,0
82,8475755,Alexander Petrovic,D,DAL,32,0,0,0,0
82,8481812,Nikolai Knyzhov,D,,27,0,0,0,0
82,8481593,Jayden Struble,D,MTL,23,0,0,0,0
82,8481532,Alex Turcotte,C,LAK,23,0,0,0,0
82,8482126,Emil Andrae,D,PHI,31,0,0,0,0
82,8479944,Zach Aston-Reese,C,VGK,30,0,0,0,0
82,8471817,Ryan Reaves,R,TOR,37,0,0,0,0
82,8481206,John Ludvig,D,PIT,24,0,0,0,0
82,8481599,Victor Soderstrom,D,UTA,23,0,0,0,0
82,8480292,Carson Meyer,R,ANA,27,0,0,0,0
82,8482496,Nils Aman,C,VAN,24,0,0,0,0
82,8479718,Alex Barré-Boulet,C,MTL,27,0,0,0,0
82,8479994,Jaret Anderson-Dolan,C,WPG,25,0,0,0,0
82,8480184,Gustav Lindstrom,D,,26,0,0,0,0
82,8480890,Jan Jenik,R,OTT,24,0,0,0,0
82,8478067,Oskar Lindblom,L,,28,0,0,0,0
82,8476934,Brock McGinn,L,ANA,30,0,0,0,0
82,8479985,Cale Fleury,D,SEA,26,0,0,0,0
82,8484304,Uvis Balinskis,D,FLA,28,0,0,0,0
82,8479981,Jonah Gadjovich,L,FLA,26,0,0,0,0
82,8481716,Dmitri Voronkov,L,CBJ,24,0,0,0,0
82,8474709,Matt Martin,L,,35,0,0,0,0
82,8482634,Alex Steeves,C,TOR,25,0,0,0,0
82,8480823,Alexander Alexeyev,D,WSH,25,0,0,0,0
82,8477541,Dakota Mermis,D,TOR,30,0,0,0,0
82,8483491,Ivan Miroshnichenko,L,WSH,20,0,0,0,0
82,8478477,Mitchell Stephens,C,SEA,27,0,0,0,0
82,8481543,Nikita Alexandrov,C,STL,24,0,0,0,0
82,8479423,Alex Nylander,L,,26,0,0,0,0
82,8482451,Mikael Pyyhtia,L,CBJ,23,0,0,0,0
82,8478831,Kevin Stenlund,C,UTA,28,0,0,0,0
82,8480306,Grant Hutton,D,NYI,29,0,0,0,0
82,8478028,Fredrik Olofsson,L,,28,0,0,0,0
82,8477462,Robert Hagg,D,VGK,29,0,0,0,0
82,8477320,Anton Blidh,L,NYR,29,0,0,0,0
82,8482157,Will Cuylle,L,NYR,22,0,0,0,0
82,8482737,Zack Bolduc,C,STL,21,0,0,0,0
82,8481239,Samuel Fagemo,L,,24,0,0,0,0
82,8481600,Tobias Bjornfot,D,FLA,23,0,0,0,0
82,8478409,Anthony Richard,C,PHI,28,0,0,0,0
82,8474145,Robert Bortuzzo,D,,35,0,0,0,0
82,8475958,Michael Sgarbossa,C,WSH,32,0,0,0,0
82,8479986,Kole Lind,R,DAL,26,0,0,0,0
82,8479249,Andrew Poturalski,C,SJS,30,0,0,0,0
82,8479362,Riley Tufte,L,BOS,26,0,0,0,0
82,8479991,Jake Leschyshyn,C,NYR,25,0,0,0,0
82,8479587,Rhett Gardner,C,PHI,28,0,0,0,0
82,8482744,James Malatesta,L,CBJ,21,0,0,0,0
82,8478854,Ryan Shea,D,PIT,27,0,0,0,0
82,8481591,Sam Poulin,R,,23,0,0,0,0
82,8483512,Matt Savoie,C,EDM,20,0,0,0,0
82,8482102,Vasily Ponomarev,C,PIT,22,0,0,0,0
82,8482162,Roby Jarventie,L,EDM,22,0,0,0,0
82,8481016,Ruslan Iskhakov,C,,24,0,0,0,0
82,8482172,Landon Slaggert,L,CHI,22,0,0,0,0
82,8482747,Brennan Othmann,L,NYR,21,0,0,0,0
82,8480031,Maxime Comtois,L,,25,0,0,0,0
82,8480226,Marián Studenic,R,,26,0,0,0,0
82,8478408,Travis Dermott,D,,28,0,0,0,0
82,8481518,Nolan Foote,L,NJD,24,0,0,0,0
82,8479419,Brett Murray,L,BUF,26,0,0,0,0
82,8482088,Justin Sourdif,R,FLA,22,0,0,0,0
82,8482201,Gage Goncalves,C,TBL,23,0,0,0,0
82,8481578,Graeme Clarke,R,MIN,23,0,0,0,0
82,8482177,Marat Khusnutdinov,C,MIN,22,0,0,0,0
82,8481754,Nikita Nesterenko,C,ANA,23,0,0,0,0
82,8483531,Brian Halonen,L,NJD,25,0,0,0,0
82,8483920,Pierrick Dube,R,WSH,23,0,0,0,0
82,8480851,Akil Thomas,C,LAK,24,0,0,0,0
82,8475235,Nicolas Deslauriers,L,PHI,33,0,0,0,0
82,8482476,Emil Heineman,L,MTL,23,0,0,0,0
82,8477149,Scott Sabourin,R,SJS,32,0,0,0,0
82,8483549,Lucas Condotta,L,MTL,27,0,0,0,0
82,8482765,Isak Rosen,R,BUF,21,0,0,0,0
82,8481237,Kyle MacLean,C,NYI,25,0,0,0,0
82,8481024,Linus Karlsson,C,VAN,25,0,0,0,0
82,8481690,Tyler Angle,C,,24,0,0,0,0
82,8483570,Ben Meyers,C,SEA,26,0,0,0,0
82,8481655,Cole Schwindt,R,CGY,23,0,0,0,0
82,8481462,Mason Morelli,L,VGK,28,0,0,0,0
82,8483401,Marc Johnstone,R,PIT,28,0,0,0,0
82,8478956,Samuel Laberge,L,NJD,27,0,0,0,0
82,8479533,Joona Koppanen,L,,26,0,0,0,0
82,8482197,Adam Raska,R,MIN,23,0,0,0,0
82,8482250,Callahan Burke,C,VGK,27,0,0,0,0
82,8482784,Zach Dean,C,STL,21,0,0,0,0
82,8484255,Jason Polin,R,COL,25,0,0,0,0
82,8481077,John Leonard,L,,26,0,0,0,0
82,8481534,Raphael Lavoie,C,EDM,24,0,0,0,0
82,8483609,Adam Klapka,R,CGY,24,0,0,0,0
82,8482751,Ryan Winterton,C,SEA,21,0,0,0,0
82,8480267,Sammy Walker,C,MIN,25,0,0,0,0
82,8475766,Austin Watson,L,,32,0,0,0,0
82,8482460,Matt Rempe,C,NYR,22,0,0,0,0
82,8481065,Angus Crookshank,L,OTT,25,0,0,0,0
82,8481070,Hugh McGing,L,,26,0,0,0,0
82,8476323,Max McCormick,L,SEA,32,0,0,0,0
82,8483395,Arshdeep Bains,L,VAN,23,0,0,0,0
82,8484259,Ondrej Pavel,C,COL,31,0,0,0,0
82,8483432,Luca Del Bel Belluz,C,CBJ,31,0,0,0,0
82,8483045,Cameron Butler,R,CBJ,31,0,0,0,0
82,8482061,Brandon Biro,L,SEA,26,0,0,0,0
82,8477401,John Hayden,C,SEA,29,0,0,0,0
82,8475278,Byron Froese,C,,33,0,0,0,0
82,8478446,Glenn Gawdin,C,LAK,27,0,0,0,0
82,8477993,Justin Kirkland,C,CGY,28,0,0,0,0
82,8482147,Jean-Luc Foudy,C,COL,22,0,0,0,0
82,8480032,Shane Bowers,C,NJD,25,0,0,0,0
82,8479330,Brandon Gignac,C,MTL,27,0,0,0,0
82,8480776,Sheldon Rempal,R,,29,0,0,0,0
82,8475413,Justin Dowling,C,NJD,34,0,0,0,0
82,8481726,Adam Edstrom,C,NYR,24,0,0,0,0
82,8480844,Grigori Denisenko,L,VGK,24,0,0,0,0
82,8478147,Bokondji Imama,L,PIT,28,0,0,0,0
82,8478881,Brett Seney,L,CHI,28,0,0,0,0
82,8483630,Pavol Regenda,L,ANA,25,0,0,0,0
82,8480836,Jonathan Gruden,C,,24,0,0,0,0
82,8484314,Jiri Smejkal,L,,28,0,0,0,0
82,8475780,Chris Wagner,R,COL,33,0,0,0,0
82,8479546,Oskar Steen,C,,26,0,0,0,0
82,8483597,Milos Kelemen,L,UTA,25,0,0,0,0
82,8481789,Tye Kartye,L,SEA,23,0,0,0,0
82,8484325,Waltteri Merela,C,TBL,26,0,0,0,0
82,8479421,Jacob Moverare,D,LAK,26,0,0,0,0
82,8481585,Egor Afanasyev,L,SJS,23,0,0,0,0
82,8479547,Matthew Phillips,R,,26,0,0,0,0
82,8479367,William Lockwood,R,FLA,26,0,0,0,0
82,8476915,Jujhar Khaira,L,,30,0,0,0,0
82,8481422,Jacob Lucchini,C,NSH,29,0,0,0,0
82,8480468,James Hamblin,L,EDM,25,0,0,0,0
82,8478051,Max Willman,C,NJD,29,0,0,0,0
82,8481556,John Beecher,C,BOS,23,0,0,0,0
82,8478078,Rourke Chartier,C,,28,0,0,0,0
83,8478402,Connor McDavid,C,EDM,27,82,46,102,148
83,8476468,J.T. Miller,C,VAN,31,82,47,90,137
83,8479318,Auston Matthews,C,TOR,27,82,65,69,134
83,8476453,Nikita Kucherov,R,TBL,31,82,37,95,132
83,8478550,Artemi Panarin,L,NYR,33,82,51,78,129
83,8477934,Leon Draisaitl,C,EDM,29,82,42,85,127
83,8481559,Jack Hughes,C,NJD,23,82,48,71,119
83,8477956,David Pastrnak,R,BOS,28,82,57,60,117
83,8477492,Nathan MacKinnon,C,COL,29,82,39,76,115
83,8480027,Jason Robertson,L,DAL,25,82,42,67,109
83,8480012,Elias Pettersson,C,VAN,26,82,40,66,106
83,8471675,Sidney Crosby,C,PIT,37,82,44,61,105
83,8478420,Mikko Rantanen,R,COL,28,82,40,65,105
83,8475913,Mark Stone,R,VGK,32,82,42,62,104
83,8480800,Quinn Hughes,D,VAN,25,82,20,83,103
83,8478864,Kirill Kaprizov,L,MIN,27,82,43,57,100
83,8477404,Jake Guentzel,C,TBL,30,82,48,48,96
83,8475172,Nazem Kadri,C,CGY,34,82,39,56,95
83,8477939,William Nylander,R,TOR,28,82,44,49,93
83,8477409,Carter Verhaeghe,C,FLA,29,82,54,37,91
83,8480069,Cale Makar,D,COL,26,82,18,73,91
83,8477933,Sam Reinhart,C,FLA,29,82,39,51,90
83,8477493,Aleksander Barkov,C,FLA,29,82,27,63,90
83,8476389,Vincent Trocheck,C,NYR,31,82,40,49,89
83,8480002,Nico Hischier,C,NJD,25,82,38,51,89
83,8479407,Jesper Bratt,L,NJD,26,82,33,55,88
83,8476454,Ryan Nugent-Hopkins,C,EDM,31,82,29,59,88
83,8477942,Kevin Fiala,L,LAK,28,82,24,62,86
83,8478445,Mathew Barzal,C,NYI,27,82,22,64,86
83,8476853,Morgan Rielly,D,TOR,30,82,19,67,86
83,8478010,Brayden Point,C,TBL,28,82,46,39,85
83,8480801,Brady Tkachuk,L,OTT,25,82,38,46,84
83,8477402,Pavel Buchnevich,L,STL,29,82,38,45,83
83,8475167,Victor Hedman,D,TBL,34,82,15,68,83
83,8479314,Matthew Tkachuk,L,FLA,27,82,34,48,82
83,8476887,Filip Forsberg,L,NSH,30,82,38,43,81
83,8475798,Mikael Granlund,C,SJS,32,82,23,58,81
83,8479343,Clayton Keller,R,UTA,26,82,41,39,80
83,8478042,Viktor Arvidsson,R,EDM,31,82,39,41,80
83,8481068,Yegor Sharangovich,C,CGY,26,82,36,44,80
83,8482116,Tim Stützle,C,OTT,22,82,30,50,80
83,8478460,Zach Werenski,D,CBJ,27,82,20,60,80
83,8475786,Zach Hyman,L,EDM,32,82,45,34,79
83,8480023,Robert Thomas,C,STL,25,82,18,61,79
83,8480036,Miro Heiskanen,D,DAL,25,82,10,69,79
83,8475184,Chris Kreider,L,NYR,33,82,47,31,78
83,8479337,Alex DeBrincat,R,DET,27,82,37,41,78
83,8481523,Kirby Dach,C,MTL,23,82,14,64,78
83,8479420,Tage Thompson,C,BUF,27,82,39,38,77
83,8477496,Elias Lindholm,C,BOS,30,82,37,40,77
83,8478403,Jack Eichel,C,VGK,28,82,36,41,77
83,8481557,Matt Boldy,L,MIN,23,82,34,43,77
83,8478444,Brock Boeser,R,VAN,27,82,33,44,77
83,8475166,John Tavares,C,TOR,34,82,32,45,77
83,8476346,Johnny Gaudreau,L,CBJ,31,82,21,56,77
83,8478975,Mason Marchment,L,DAL,29,82,34,42,76
83,8474600,Roman Josi,D,NSH,34,82,19,57,76
83,8478439,Travis Konecny,R,PHI,27,82,32,43,75
83,8473419,Brad Marchand,L,BOS,36,82,29,46,75
83,8474141,Patrick Kane,R,DET,36,82,28,47,75
83,8480208,Drake Batherson,R,OTT,26,82,26,49,75
83,8478493,Joel Eriksson Ek,C,MIN,27,82,24,51,75
83,8479323,Adam Fox,D,NYR,26,82,14,61,75
83,8478449,Roope Hintz,C,DAL,28,82,36,38,74
83,8478440,Dylan Strome,C,WSH,27,82,33,41,74
83,8477946,Dylan Larkin,C,DET,28,82,32,42,74
83,8477960,Adrian Kempe,R,LAK,28,82,37,36,73
83,8474564,Steven Stamkos,C,NSH,34,82,36,37,73
83,8480018,Nick Suzuki,C,MTL,25,82,31,42,73
83,8482665,Matty Beniers,C,SEA,22,82,29,44,73
83,8476456,Jonathan Huberdeau,C,CGY,31,82,17,56,73
83,8480865,Noah Dobson,D,NYI,24,82,14,59,73
83,8476539,Jonathan Marchessault,R,NSH,34,82,36,36,72
83,8478398,Kyle Connor,L,WPG,28,82,35,37,72
83,8482078,Lucas Raymond,L,DET,22,82,25,47,72
83,8479675,Trevor Moore,L,LAK,29,82,37,34,71
83,8475726,Tyler Toffoli,C,SJS,32,82,34,37,71
83,8476460,Mark Scheifele,C,WPG,31,82,29,42,71
83,8475168,Matt Duchene,C,DAL,33,82,23,48,71
83,8480839,Rasmus Dahlin,D,BUF,24,82,17,54,71
83,8477501,Valeri Nichushkin,R,COL,29,82,37,33,70
83,8481540,Cole Caufield,R,MTL,23,82,35,35,70
83,8476881,Tomas Hertl,C,VGK,31,82,35,35,70
83,8478414,Timo Meier,R,NJD,28,82,35,35,70
83,8479542,Brandon Hagel,L,TBL,26,82,34,36,70
83,8477949,Alex Tuch,R,BUF,28,82,30,39,69
83,8480830,Andrei Svechnikov,R,CAR,24,82,24,45,69
83,8471215,Evgeni Malkin,C,PIT,38,82,23,46,69
83,8478427,Sebastian Aho,C,CAR,27,82,29,39,68
83,8473994,Jamie Benn,L,DAL,35,82,29,39,68
83,8481528,Dylan Cozens,C,BUF,23,82,24,44,68
83,8475692,Mats Zuccarello,R,MIN,37,82,15,53,68
83,8477476,Artturi Lehkonen,L,COL,29,82,41,26,67
83,8476459,Mika Zibanejad,C,NYR,31,82,31,36,67
83,8479385,Jordan Kyrou,C,STL,26,82,29,38,67
83,8481711,Matias Maccelli,L,UTA,24,82,19,48,67
83,8474578,Erik Karlsson,D,PIT,34,82,17,50,67
83,8477500,Bo Horvat,C,NYI,29,82,32,34,66
83,8475169,Evander Kane,L,EDM,33,82,29,37,66
83,8477951,Nick Schmaltz,C,UTA,28,82,20,46,66
83,8475314,Anders Lee,L,NYI,34,82,38,27,65
83,8475754,Brock Nelson,C,NYI,33,82,31,34,65
83,8478462,Nicolas Roy,C,VGK,27,82,17,48,65
83,8477447,Shea Theodore,D,VGK,29,82,13,52,65
83,8474150,Mikael Backlund,C,CGY,35,82,27,37,64
83,8475810,Bryan Rust,R,PIT,32,82,38,25,63
83,8476448,William Karlsson,C,VGK,31,82,25,38,63
83,8482110,Dawson Mercer,C,NJD,23,82,29,33,62
83,8477416,Oliver Bjorkstrand,R,SEA,29,82,25,37,62
83,8477940,Nikolaj Ehlers,L,WPG,28,82,25,37,62
83,8471724,Kris Letang,D,PIT,37,82,12,50,62
83,8476432,Boone Jenner,C,CBJ,31,82,37,24,61
83,8478856,Conor Garland,R,VAN,28,82,26,35,61
83,8476483,Rickard Rakell,R,PIT,31,82,24,37,61
83,8474102,David Perron,L,OTT,36,82,23,38,61
83,8477494,Jonathan Drouin,L,COL,29,82,18,43,61
83,8475745,Charlie Coyle,C,BOS,32,82,16,45,61
83,8476462,Dougie Hamilton,D,NJD,31,82,16,45,61
83,8474590,John Carlson,D,WSH,34,82,13,48,61
83,8476875,Mike Matheson,D,MTL,30,82,13,48,61
83,8478038,Devon Toews,D,COL,30,82,13,48,61
83,8479339,Patrik Laine,L,CBJ,26,82,25,35,60
83,8474563,Drew Doughty,D,LAK,35,82,10,50,60
83,8478366,Frank Vatrano,R,ANA,30,82,30,29,59
83,8483808,Andrei Kuzmenko,L,CGY,28,82,28,31,59
83,8479987,Morgan Geekie,C,BOS,26,82,24,35,59
83,8478396,Noah Hanifin,D,VGK,27,82,9,50,59
83,8482093,Seth Jarvis,C,CAR,22,82,28,30,58
83,8477955,Jared McCann,L,SEA,28,82,27,31,58
83,8474586,Jordan Eberle,R,SEA,34,82,26,32,58
83,8475784,Jeff Skinner,C,EDM,32,82,20,38,58
83,8474679,Gustav Nyquist,C,NSH,35,82,19,39,58
83,8473512,Claude Giroux,R,OTT,36,82,17,41,58
83,8480803,Evan Bouchard,D,EDM,25,82,9,49,58
83,8478474,Lawson Crouse,L,UTA,27,82,35,22,57
83,8478498,Jake DeBrusk,L,VAN,28,82,29,28,57
83,8478047,Michael Bunting,L,PIT,29,82,23,34,57
83,8471214,Alex Ovechkin,L,WSH,39,82,29,27,56
83,8477935,Sam Bennett,C,FLA,28,82,27,29,56
83,8477964,Ivan Barbashev,C,VGK,29,82,25,31,56
83,8475170,Brayden Schenn,C,STL,33,82,23,33,56
83,8474565,Alex Pietrangelo,D,VGK,34,82,10,46,56
83,8482159,Tyson Foerster,R,PHI,22,82,32,23,55
83,8475794,Tyler Seguin,C,DAL,32,82,30,25,55
83,8471685,Anze Kopitar,C,LAK,37,82,26,29,55
83,8480015,Owen Tippett,R,PHI,25,82,26,29,55
83,8478519,Anthony Cirelli,C,TBL,27,82,25,30,55
83,8477503,Max Domi,C,TOR,29,82,18,37,55
83,8479410,Mikhail Sergachev,D,UTA,26,82,8,47,55
83,8478873,Troy Terry,R,ANA,27,82,16,38,54
83,8477504,Josh Morrissey,D,WPG,29,82,10,44,54
83,8479325,Charlie McAvoy,D,BOS,27,82,10,44,54
83,8476880,Tom Wilson,R,WSH,30,82,29,24,53
83,8477497,Sean Monahan,C,CBJ,30,82,26,27,53
83,8476479,Phillip Danault,C,LAK,31,82,21,32,53
83,8470613,Brent Burns,D,CAR,39,82,18,35,53
83,8482684,Luke Hughes,D,NJD,21,82,13,40,53
83,8477346,MacKenzie Weegar,D,CGY,30,82,12,41,53
83,8476438,Brandon Saad,L,STL,32,82,30,22,52
83,8482097,Jack Quinn,R,BUF,23,82,27,25,52
83,8478401,Pavel Zacha,C,BOS,27,82,24,28,52
83,8475158,Ryan O'Reilly,C,NSH,33,82,20,32,52
83,8480078,Filip Chytil,C,NYR,25,82,18,34,52
83,8471698,T.J. Oshie,R,WSH,38,82,25,26,51
83,8482699,Dylan Guenther,R,UTA,21,82,23,28,51
83,8475191,Reilly Smith,R,NYR,33,82,13,38,51
83,8480893,Kirill Marchenko,R,CBJ,24,82,32,18,50
83,8477987,Ryan Donato,C,CHI,28,82,24,26,50
83,8479999,Casey Mittelstadt,C,COL,26,82,23,27,50
83,8474053,Logan Couture,C,SJS,35,82,23,27,50
83,8482124,Quinton Byfield,R,LAK,22,82,15,35,50
83,8476872,Scott Laughton,C,PHI,30,82,13,37,50
83,8480014,Gabriel Vilardi,C,WPG,25,82,31,18,49
83,8475799,Nino Niederreiter,R,WPG,32,82,27,22,49
83,8476399,Blake Coleman,C,CGY,33,82,26,23,49
83,8477998,Warren Foegele,L,LAK,28,82,25,24,49
83,8477451,Ryan Hartman,R,MIN,30,82,21,28,49
83,8473986,Alex Killorn,L,ANA,35,82,21,28,49
83,8477456,J.T. Compher,L,DET,29,82,18,31,49
83,8479425,Filip Hronek,D,VAN,27,82,17,32,49
83,8478407,Vince Dunn,D,SEA,28,82,14,35,49
83,8480871,Adam Boqvist,D,FLA,24,82,13,36,49
83,8476792,Torey Krug,D,STL,33,82,11,38,49
83,8482740,Wyatt Johnston,C,DAL,21,82,22,26,48
83,8475765,Vladimir Tarasenko,R,DET,33,82,21,27,48
83,8480009,Eeli Tolvanen,R,SEA,25,82,21,27,48
83,8480798,Philipp Kurashev,C,CHI,25,82,16,32,48
83,8477495,Seth Jones,D,CHI,30,82,15,33,48
83,8482113,Anton Lundell,C,FLA,23,82,13,35,48
83,8482109,Alexis Lafrenière,L,NYR,23,82,22,25,47
83,8476329,Travis Boyd,C,MIN,31,82,19,28,47
83,8477932,Aaron Ekblad,D,FLA,28,82,13,34,47
83,8476869,Brady Skjei,D,NSH,30,82,11,36,47
83,8482055,Drew O'Connor,L,PIT,26,82,28,18,46
83,8475151,Kyle Palmieri,C,NYI,33,82,24,22,46
83,8481533,Trevor Zegras,C,ANA,23,82,19,27,46
83,8482667,William Eklund,L,SJS,22,82,19,27,46
83,8478413,Jordan Greenway,L,BUF,27,82,19,27,46
83,8475768,Jaden Schwartz,C,SEA,32,82,16,30,46
83,8480220,Noah Cates,L,PHI,25,82,16,30,46
83,8477479,Tyler Bertuzzi,L,CHI,29,82,15,31,46
83,8480064,Josh Norris,C,OTT,25,82,26,19,45
83,8481186,Logan O'Connor,R,COL,28,82,25,20,45
83,8479400,Pierre-Luc Dubois,L,WSH,26,82,23,22,45
83,8482175,JJ Peterka,R,BUF,22,82,23,22,45
83,8478458,Jack Roslovic,C,CAR,27,82,16,29,45
83,8477021,Alex Kerfoot,C,UTA,30,82,16,29,45
83,8479345,Jakob Chychrun,D,WSH,26,82,14,31,45
83,8480434,Sean Durzi,D,UTA,26,82,14,31,45
83,8478055,Gustav Forsling,D,FLA,28,82,13,32,45
83,8477948,Travis Sanheim,D,PHI,28,82,12,33,45
83,8477498,Darnell Nurse,D,EDM,29,82,12,33,45
83,8482660,Kent Johnson,C,CBJ,22,82,11,34,45
83,8480145,Neal Pionk,D,WPG,29,82,9,36,45
83,8478397,Rasmus Andersson,D,CGY,28,82,6,39,45
83,8480873,Rasmus Sandin,D,WSH,24,82,2,43,45
83,8481604,Pavel Dorofeyev,L,VGK,24,82,31,13,44
83,8484144,Connor Bedard,C,CHI,19,82,22,22,44
83,8480188,Fabian Zetterlund,L,SJS,25,82,20,24,44
83,8481554,Kaapo Kakko,R,NYR,23,82,19,25,44
83,8480185,Eetu Luostarinen,C,FLA,26,82,16,28,44
83,8481596,Shane Pinto,C,OTT,24,82,15,29,44
83,8478469,Thomas Chabot,D,OTT,27,82,5,39,44
83,8477429,Andrew Copp,C,DET,30,82,21,22,43
83,8475193,Tomas Tatar,L,NJD,34,82,19,24,43
83,8482705,Cole Sillinger,C,CBJ,21,82,18,25,43
83,8478046,Danton Heinen,L,VAN,29,82,17,26,43
83,8480748,Kiefer Sherwood,L,VAN,29,82,17,26,43
83,8476905,Chandler Stephenson,C,SEA,30,82,16,27,43
83,8478438,Tommy Novak,C,NSH,27,82,11,32,43
83,8476854,Hampus Lindholm,D,BOS,30,82,10,33,43
83,8476906,Shayne Gostisbehere,D,CAR,31,82,7,36,43
83,8480039,Martin Necas,C,CAR,25,82,21,21,42
83,8474641,Adam Henrique,C,EDM,34,82,21,21,42
83,8477986,Brandon Montour,D,SEA,30,82,12,30,42
83,8481581,Thomas Harley,D,DAL,23,82,11,31,42
83,8478057,Dakota Joshua,C,VAN,28,82,21,20,41
83,8481535,Nils Hoglander,L,VAN,24,82,21,20,41
83,8481618,Alex Newhook,C,MTL,23,82,20,21,41
83,8473563,Nicklas Backstrom,C,WSH,37,82,18,23,41
83,8482149,Cole Perfetti,C,WPG,22,82,15,26,41
83,8478463,Anthony Beauvillier,L,PIT,27,82,14,27,41
83,8475791,Taylor Hall,L,CHI,33,82,11,30,41
83,8476458,Ryan Strome,C,ANA,31,82,9,32,41
83,8481560,Arthur Kaliyev,R,LAK,23,82,22,18,40
83,8475722,Jason Zucker,L,BUF,32,82,21,19,40
83,8476392,Adam Lowry,C,WPG,31,82,18,22,40
83,8480797,Joel Farabee,L,PHI,24,82,17,23,40
83,8482745,Mason McTavish,C,ANA,21,82,17,23,40
83,8480817,K'Andre Miller,D,NYR,24,82,7,33,40
83,8482655,J.J. Moser,D,TBL,24,82,6,34,40
83,8476925,Colton Sissons,C,NSH,31,82,24,15,39
83,8477407,Anthony Duclair,L,NYI,29,82,20,19,39
83,8475714,Calle Jarnkrok,C,TOR,33,82,20,19,39
83,8475760,Nick Bjugstad,C,UTA,32,82,19,20,39
83,8475793,Ryan Johansen,C,PHI,32,82,19,20,39
83,8473533,Jordan Staal,C,CAR,36,82,18,21,39
83,8477511,Anthony Mantha,R,CGY,30,82,16,23,39
83,8480835,Jack Drury,C,CAR,24,82,16,23,39
83,8481093,Rafael Harvey-Pinard,L,MTL,25,82,16,23,39
83,8477919,Frederick Gaudreau,C,MIN,31,82,16,23,39
83,8480028,Morgan Frost,C,PHI,25,82,15,24,39
83,8480068,Ryan Poehling,C,PHI,25,82,15,24,39
83,8479941,Justin Danforth,R,CBJ,31,82,15,24,39
83,8480113,Alex Iafallo,L,WPG,31,82,14,25,39
83,8475753,Justin Faulk,D,STL,32,82,8,31,39
83,8478911,Matt Roy,D,WSH,29,82,6,33,39
83,8474149,Evgenii Dadonov,R,DAL,35,82,18,20,38
83,8476960,Andreas Athanasiou,C,CHI,30,82,17,21,38
83,8480459,Pius Suter,C,VAN,28,82,17,21,38
83,8475763,Kevin Hayes,R,PIT,32,82,16,22,38
83,8476882,Teuvo Teravainen,L,CHI,30,82,15,23,38
83,8478233,Andrew Mangiapane,L,WSH,28,82,15,23,38
83,8476278,Colin Blackwell,C,DAL,31,82,19,18,37
83,8482475,Yegor Chinakhov,R,CBJ,23,82,15,22,37
83,8477947,Sonny Milano,L,WSH,28,82,12,25,37
83,8476461,Sean Couturier,C,PHI,32,82,11,26,37
83,8475171,Oliver Ekman-Larsson,D,TOR,33,82,8,29,37
83,8476917,Adam Pelech,D,NYI,30,82,7,30,37
83,8476892,Colton Parayko,D,STL,31,82,2,35,37
83,8482089,Jake Neighbours,L,STL,22,82,26,10,36
83,8479359,Beck Malenstyn,L,BUF,26,82,20,16,36
83,8477426,Nicholas Paul,L,TBL,29,82,15,21,36
83,8476826,Yanni Gourde,C,SEA,33,82,11,25,36
83,8477444,Andre Burakovsky,L,SEA,29,82,11,25,36
83,8476419,Jean-Gabriel Pageau,C,NYI,32,82,8,28,36
83,8478507,John Marino,D,UTA,27,82,8,28,36
83,8481542,Moritz Seider,D,DET,23,82,5,31,36
83,8476923,Damon Severson,D,CBJ,30,82,5,31,36
83,8481624,Ilya Mikheyev,R,CHI,30,82,15,20,35
83,8481704,Juuso Parssinen,C,NSH,23,82,15,20,35
83,8478891,Mason Appleton,C,WPG,28,82,13,22,35
83,8478013,Jake Walman,D,SJS,28,82,13,22,35
83,8474716,Jared Spurgeon,D,MIN,35,82,12,23,35
83,8475287,Erik Haula,L,NJD,33,82,8,27,35
83,8478472,Mathieu Joseph,R,STL,27,82,8,27,35
83,8476885,Jacob Trouba,D,NYR,30,82,8,27,35
83,8482720,Matthew Knies,L,TOR,22,82,17,17,34
83,8477953,Kasperi Kapanen,R,STL,28,82,16,18,34
83,8479525,Ross Colton,C,COL,28,82,15,19,34
83,8476918,Jimmy Vesey,L,NYR,31,82,15,19,34
83,8480849,Barrett Hayton,C,UTA,24,82,11,23,34
83,8474189,Lars Eller,C,PIT,35,82,11,23,34
83,8475181,Nick Leddy,D,STL,33,82,9,25,34
83,8476958,Jaccob Slavin,D,CAR,30,82,8,26,34
83,8476979,Erik Gustafsson,D,DET,32,82,7,27,34
83,8478500,Ivan Provorov,D,CBJ,27,82,7,27,34
83,8477450,Jason Dickinson,C,CHI,29,82,18,15,33
83,8480995,Pontus Holmberg,R,TOR,25,82,17,16,33
83,8483515,Juraj Slafkovsky,L,MTL,20,82,16,17,33
83,8475848,Brendan Gallagher,R,MTL,32,82,13,20,33
83,8480802,Ryan McLeod,C,BUF,25,82,13,20,33
83,8478542,Evan Rodrigues,C,FLA,31,82,12,21,33
83,8477353,Tyler Motte,C,DET,29,82,12,21,33
83,8481522,Peyton Krebs,C,BUF,23,82,10,23,33
83,8477506,Ryan Pulock,D,NYI,30,82,5,28,33
83,8480789,Oliver Wahlstrom,R,NYI,24,82,18,14,32
83,8476981,Josh Anderson,R,MTL,30,82,17,15,32
83,8482105,Jake Sanderson,D,OTT,22,82,17,15,32
83,8479992,Michael Rasmussen,C,DET,25,82,14,18,32
83,8479353,Brett Howden,C,VGK,26,82,14,18,32
83,8475855,Jesper Fast,R,CAR,33,82,14,18,32
83,8482074,Connor Zary,C,CGY,23,82,14,18,32
83,8480336,Sean Walker,D,CAR,30,82,14,18,32
83,8478115,Pierre Engvall,L,NYI,28,82,12,20,32
83,8481032,Paul Cotter,C,NJD,25,82,12,20,32
83,8480144,David Kampf,C,TOR,29,82,11,21,32
83,8477508,Curtis Lazar,C,NJD,29,82,9,23,32
83,8482133,Thomas Bordeleau,C,SJS,22,82,8,24,32
83,8477969,Marcus Pettersson,D,PIT,28,82,6,26,32
83,8477952,Robby Fabbri,C,ANA,28,82,20,11,31
83,8481553,Bobby Brink,R,PHI,23,82,15,16,31
83,8479996,Cody Glass,C,NSH,25,82,12,19,31
83,8478109,Victor Olofsson,L,VGK,29,82,12,19,31
83,8475200,Dmitry Orlov,D,CAR,33,82,10,21,31
83,8481606,Jordan Spence,D,LAK,23,82,9,22,31
83,8476312,Josh Manson,D,COL,33,82,8,23,31
83,8482671,Owen Power,D,BUF,22,82,5,26,31
83,8475218,Mattias Ekholm,D,EDM,34,82,5,26,31
83,8475764,Cam Fowler,D,ANA,33,82,3,28,31
83,8483431,Logan Cooley,C,UTA,20,82,17,13,30
83,8475343,Nic Dowd,C,WSH,34,82,17,13,30
83,8477392,Hudson Fasching,R,NYI,29,82,15,15,30
83,8482146,Luke Evangelista,R,NSH,22,82,13,17,30
83,8479393,Noah Gregor,C,OTT,26,82,13,17,30
83,8475149,Marcus Johansson,L,MIN,34,82,11,19,30
83,8482092,Ridly Greig,C,OTT,22,82,10,20,30
83,8477903,Garnet Hathaway,R,PHI,33,82,10,20,30
83,8476422,Mike Reilly,D,NYI,31,82,9,21,30
83,8479983,Mario Ferraro,D,SJS,26,82,8,22,30
83,8476331,Dylan DeMelo,D,WPG,31,82,6,24,30
83,8482245,Artem Zub,D,OTT,29,82,6,24,30
83,8480049,Dylan Samberg,D,WPG,25,82,1,29,30
83,8475220,Marcus Foligno,L,MIN,33,82,16,13,29
83,8476474,Stefan Noesen,R,NJD,31,82,15,14,29
83,8480003,Jesper Boqvist,C,FLA,26,82,10,19,29
83,8476897,Oskar Sundqvist,C,STL,30,82,10,19,29
83,8481546,Cam York,D,PHI,23,82,8,21,29
83,8476902,Esa Lindell,D,DAL,30,82,4,25,29
83,8481601,Simon Holmstrom,R,NYI,23,82,13,15,28
83,8479316,Luke Kunin,C,SJS,27,82,11,17,28
83,8478211,Dryden Hunt,L,CGY,29,82,11,17,28
83,8480829,Jesperi Kotkaniemi,C,CAR,24,82,10,18,28
83,8476442,Matt Nieto,L,PIT,32,82,10,18,28
83,8476463,Jonas Brodin,D,MIN,31,82,8,20,28
83,8478133,Jake Evans,C,MTL,28,82,7,21,28
83,8476292,Ondrej Palat,L,NJD,33,82,7,21,28
83,8475233,David Savard,D,MTL,34,82,6,22,28
83,8479398,Samuel Girard,D,COL,26,82,4,24,28
83,8481014,Alexander Romanov,D,NYI,24,82,1,27,28
83,8479365,Trent Frederic,C,BOS,26,82,16,11,27
83,8482077,Dylan Holloway,L,EDM,23,82,16,11,27
83,8473422,Nick Foligno,L,CHI,37,82,15,12,27
83,8482125,Alexander Holtz,R,VGK,22,82,14,13,27
83,8478020,Michael Amadio,C,OTT,28,82,14,13,27
83,8475842,Sam Carrick,C,NYR,32,82,14,13,27
83,8480855,Jack McBain,C,UTA,24,82,13,14,27
83,8481481,Blake Lizotte,C,PIT,27,82,12,15,27
83,8481477,Nico Sturm,C,SJS,29,82,11,16,27
83,8480074,Alexandre Texier,C,STL,25,82,7,20,27
83,8476429,Scott Mayfield,D,NYI,32,82,5,22,27
83,8480878,Nils Lundkvist,D,DAL,24,82,4,23,27
83,8478569,Noel Acciari,C,PIT,33,82,16,10,26
83,8477425,Miles Wood,L,COL,29,82,15,11,26
83,8479390,Taylor Raddysh,R,WSH,26,82,13,13,26
83,8482062,Cole Smith,L,NSH,29,82,12,14,26
83,8479661,Tanner Jeannot,L,LAK,27,82,11,15,26
83,8483457,Lane Hutson,D,MTL,20,82,11,15,26
83,8479351,Sam Steel,C,DAL,26,82,10,16,26
83,8484166,Adam Fantilli,C,CBJ,20,82,10,16,26
83,8476624,Barclay Goodrow,C,SJS,31,82,10,16,26
83,8477499,Rasmus Ristolainen,D,PHI,30,82,9,17,26
83,8482122,Brock Faber,D,MIN,22,82,6,20,26
83,8483565,Nick Blankenburg,D,NSH,26,82,5,21,26
83,8481568,Alex Vlasic,D,CHI,23,82,2,24,26
83,8475231,Casey Cizikas,C,NYI,33,82,15,10,25
83,8477505,Alexander Wennberg,C,SJS,30,82,14,11,25
83,8476469,Joel Armia,R,MTL,31,82,13,12,25
83,8482702,Logan Stankoven,C,DAL,21,82,12,13,25
83,8479591,Michael Eyssimont,C,TBL,28,82,11,14,25
83,8476873,Mark Jankowski,C,NSH,30,82,10,15,25
83,8479368,Max Jones,L,BOS,26,82,9,16,25
83,8483763,Maksymilian Szuber,D,UTA,22,82,8,17,25
83,8479442,Troy Stecher,D,EDM,30,82,8,17,25
83,8484145,Zach Benson,L,BUF,19,82,7,18,25
83,8480246,Nick Perbix,D,TBL,26,82,6,19,25
83,8477220,Nate Schmidt,D,FLA,33,82,6,19,25
83,8476879,Cody Ceci,D,EDM,31,82,5,20,25
83,8474151,Ryan McDonagh,D,TBL,35,82,5,20,25
83,8479369,Andrew Peeke,D,BOS,26,82,4,21,25
83,8478136,Jake Middleton,D,MIN,28,82,4,21,25
83,8476891,Matt Grzelcyk,D,PIT,30,82,4,21,25
83,8474673,TJ Brodie,D,CHI,34,82,3,22,25
83,8477488,Brett Pesce,D,NJD,30,82,3,22,25
83,8480807,Mattias Samuelsson,D,BUF,24,82,2,23,25
83,8480281,Alexey Toropchenko,R,STL,25,82,19,5,24
83,8476927,Teddy Blueger,C,VAN,30,82,9,15,24
83,8478434,Keegan Kolesar,R,VGK,27,82,9,15,24
83,8480025,MacKenzie Entwistle,R,FLA,25,82,8,16,24
83,8484203,Bradly Nadeau,L,CAR,19,82,8,16,24
83,8474574,Tyler Myers,D,VAN,34,82,5,19,24
83,8477369,Carson Soucy,D,VAN,30,82,5,19,24
83,8482073,Braden Schneider,D,NYR,23,82,4,20,24
83,8482142,Jamie Drysdale,D,PHI,22,82,3,21,24
83,8474090,Brendan Smith,D,DAL,35,82,3,21,24
83,8482079,Marco Rossi,C,MIN,23,82,14,9,23
83,8470621,Corey Perry,R,EDM,39,82,14,9,23
83,8483499,Liam Ohgren,L,MIN,20,82,11,12,23
83,8482145,Mavrik Bourque,C,DAL,22,82,9,14,23
83,8477507,Nikita Zadorov,D,BOS,29,82,9,14,23
83,8480073,Erik Brannstrom,D,COL,25,82,9,14,23
83,8479293,Brandon Tanev,L,SEA,33,82,8,15,23
83,8475762,Derek Forbort,D,VAN,32,82,7,16,23
83,8482624,Daniil Miromanov,D,CGY,27,82,6,17,23
83,8478882,Vladislav Gavrikov,D,LAK,29,82,5,18,23
83,8475279,Ben Chiarot,D,DET,33,82,5,18,23
83,8479980,Nicolas Hague,D,VGK,26,82,5,18,23
83,8479976,Juuso Valimaki,D,UTA,26,82,4,19,23
83,8481178,Egor Zamula,D,PHI,24,82,4,19,23
83,8475790,Erik Gudbranson,D,CBJ,32,82,4,19,23
83,8478443,Brandon Carlo,D,BOS,28,82,4,19,23
83,8479402,Jake Bean,D,CGY,26,82,3,20,23
83,8475188,Brayden McNabb,D,VGK,33,82,3,20,23
83,8480035,Henri Jokiharju,D,BUF,25,82,2,21,23
83,8481708,Zac Jones,D,NYR,24,82,2,21,23
83,8482141,Lukas Cormier,D,VGK,22,82,12,10,22
83,8481582,Nicholas Robertson,L,TOR,23,82,11,11,22
83,8476374,Sean Kuraly,C,CBJ,31,82,10,12,22
83,8482679,Matt Coronato,R,CGY,22,82,10,12,22
83,8480806,Isac Lundestrom,C,ANA,25,82,8,14,22
83,8477839,Conor Sheary,L,TBL,32,82,7,15,22
83,8482166,Shakir Mukhamadullin,D,SJS,22,82,7,15,22
83,8482803,Olen Zellweger,D,ANA,21,82,6,16,22
83,8482666,Scott Morrow,D,CAR,22,82,6,16,22
83,8480043,Timothy Liljegren,D,TOR,25,82,4,18,22
83,8480860,Kevin Bahl,D,CGY,24,82,4,18,22
83,8483524,Shane Wright,C,SEA,20,82,12,9,21
83,8479414,Nathan Bastian,R,NJD,27,82,11,10,21
83,8476889,Radek Faksa,C,STL,30,82,11,10,21
83,8482659,Josh Doan,R,UTA,22,82,10,11,21
83,8476480,Vladislav Namestnikov,C,WPG,32,82,9,12,21
83,8483505,Matthew Poitras,C,BOS,20,82,8,13,21
83,8475324,Nick Jensen,D,OTT,34,82,7,14,21
83,8481567,Henry Thrun,D,SJS,23,82,6,15,21
83,8470600,Ryan Suter,D,STL,39,82,6,15,21
83,8477406,Mattias Janmark,C,EDM,32,82,6,15,21
83,8479371,Dante Fabbro,D,NSH,26,82,6,15,21
83,8483495,Simon Nemec,D,NJD,20,82,5,16,21
83,8476931,Jake McCabe,D,TOR,31,82,4,17,21
83,8477365,Connor Clifton,D,BUF,29,82,2,19,21
83,8479291,Kevin Rooney,C,CGY,31,82,11,9,20
83,8477989,Christian Dvorak,C,MTL,28,82,10,10,20
83,8481656,Aliaksei Protas,C,WSH,23,82,10,10,20
83,8482733,Logan Mailloux,D,MTL,31,82,10,10,20
83,8477015,Connor Brown,R,EDM,30,82,9,11,20
83,8476921,Jordan Martinook,L,CAR,32,82,9,11,20
83,8482259,Bobby McMann,C,TOR,28,82,9,11,20
83,8478178,Darren Raddysh,D,TBL,28,82,9,11,20
83,8481028,Martin Pospisil,C,CGY,25,82,8,12,20
83,8480448,Parker Kelly,L,COL,25,82,7,13,20
83,8482111,Justin Barron,D,MTL,23,82,5,15,20
83,8480950,Ilya Lyubushkin,D,DAL,30,82,5,15,20
83,8476372,Nick Seeler,D,PHI,31,82,4,16,20
83,8476467,Jamie Oleksiak,D,SEA,32,82,3,17,20
83,8479998,Mikey Anderson,D,LAK,25,82,2,18,20
83,8475718,Justin Holl,D,DET,32,82,2,18,20
83,8474715,Cam Atkinson,R,TBL,35,82,10,9,19
83,8480813,Joe Veleno,C,DET,24,82,10,9,19
83,8484911,Collin Graf,R,SJS,22,82,6,13,19
83,8482087,Kaiden Guhle,D,MTL,22,82,5,14,19
83,8481013,Jonatan Berggren,R,DET,24,82,5,14,19
83,8480222,Sebastian Aho,D,PIT,28,82,5,14,19
83,8475455,Brenden Dillon,D,NJD,34,82,3,16,19
83,8483468,Jiri Kulich,C,BUF,20,82,2,17,19
83,8477435,Ryan Graves,D,PIT,29,82,2,17,19
83,8475690,Chris Tanev,D,TOR,35,82,2,17,19
83,8478508,Yakov Trenin,C,MIN,27,82,8,10,18
83,8482118,Sam Colangelo,R,ANA,23,82,8,10,18
83,8480796,Martin Fehervary,D,WSH,25,82,7,11,18
83,8476878,Zemgus Girgensons,L,TBL,30,82,6,12,18
83,8475462,Radko Gudas,D,ANA,34,82,4,14,18
83,8480879,Jacob Bernard-Docker,D,OTT,24,82,4,14,18
83,8474013,Ian Cole,D,UTA,35,82,4,14,18
83,8473507,Jeff Petry,D,DET,37,82,3,15,18
83,8477335,Kyle Burroughs,D,LAK,29,82,3,15,18
83,8478416,Erik Cernak,D,TBL,27,82,2,16,18
83,8476967,Brett Kulak,D,EDM,30,82,2,16,18
83,8480980,Connor Dewar,C,TOR,25,82,10,7,17
83,8478432,Christian Fischer,R,DET,27,82,9,8,17
83,8482153,Brendan Brisson,C,VGK,23,82,9,8,17
83,8483397,Marc McLaughlin,C,BOS,25,82,9,8,17
83,8481524,Bowen Byram,D,BUF,23,82,7,10,17
83,8484153,Leo Carlsson,C,ANA,20,82,6,11,17
83,8482155,Alex Laferriere,R,LAK,23,82,6,11,17
83,8476457,Adam Larsson,D,SEA,32,82,4,13,17
83,8478450,Parker Wotherspoon,D,BOS,27,82,4,13,17
83,8481580,Connor McMichael,C,WSH,23,82,3,14,17
83,8482101,Danil Gushchin,L,SJS,22,82,3,14,17
83,8483460,David Jiricek,D,CBJ,21,82,3,14,17
83,8479324,Ryan Lindgren,D,NYR,26,82,2,15,17
83,8477845,Trevor van Riemsdyk,D,WSH,33,82,0,17,17
83,8482713,Mackie Samoskevich,R,FLA,22,82,9,7,16
83,8483445,Cutter Gauthier,L,ANA,20,82,7,9,16
83,8481699,Aku Raty,R,UTA,23,82,7,9,16
83,8483471,Brad Lambert,C,WPG,31,82,7,9,16
83,8476525,Colin Miller,D,WPG,32,82,5,11,16
83,8478468,Jeremy Lauzon,D,NSH,27,82,4,12,16
83,8480172,Jan Rutta,D,SJS,34,82,3,13,16
83,8482809,Jackson Blake,R,CAR,21,82,2,14,16
83,8478859,Niko Mikkola,D,FLA,28,82,2,14,16
83,8478851,Alexandre Carrier,D,NSH,28,82,0,16,16
83,8476858,Phillip Di Giuseppe,L,VAN,31,82,9,6,15
83,8481517,Brett Leason,R,ANA,25,82,7,8,15
83,8477931,Tomas Nosek,L,FLA,32,82,7,8,15
83,8482858,Ryker Evans,D,SEA,23,82,7,8,15
83,8481605,Jackson LaCombe,D,ANA,23,82,7,8,15
83,8482117,Lukas Reichel,L,CHI,22,82,6,9,15
83,8483482,Tristan Luneau,D,ANA,20,82,6,9,15
83,8482762,Simon Edvinsson,D,DET,21,82,6,9,15
83,8480990,Declan Chisholm,D,MIN,24,82,5,10,15
83,8478399,Jonas Siegenthaler,D,NJD,27,82,4,11,15
83,8480834,Ty Emberson,D,SJS,24,82,4,11,15
83,8484149,Gavin Brindley,C,CBJ,20,82,6,8,14
83,8482807,Ethan Del Mastro,D,CHI,21,82,5,9,14
83,8482470,Ilya Solovyov,D,CGY,24,82,4,10,14
83,8479576,Vincent Desharnais,D,VAN,28,82,4,10,14
83,8483489,Fraser Minten,C,TOR,31,82,4,10,14
83,8483466,Kevin Korchinski,D,CHI,20,82,3,11,14
83,8482516,Matthew Kessel,D,STL,24,82,3,11,14
83,8478840,Will Borgen,D,SEA,28,82,1,13,14
83,8483493,Frank Nazar,C,CHI,20,82,6,7,13
83,8482749,Joshua Roy,R,MTL,21,82,4,9,13
83,8481641,Joel Kiviranta,L,COL,28,82,4,9,13
83,8474612,Travis Hamonic,D,OTT,34,82,3,10,13
83,8471677,Jack Johnson,D,CBJ,37,82,3,10,13
83,8476441,Joel Edmundson,D,LAK,31,82,2,11,13
83,8473453,Trevor Lewis,C,LAK,37,82,5,7,12
83,8477938,Haydn Fleury,D,WPG,28,82,5,7,12
83,8483567,Georgii Merkulov,C,BOS,24,82,5,7,12
83,8483490,Pavel Mintyukov,D,ANA,21,82,1,11,12
83,8481122,Simon Benoit,D,TOR,26,82,0,12,12
83,8476822,Luke Glendening,C,TBL,35,82,7,4,11
83,8479638,Justin Brazeau,R,BOS,26,82,7,4,11
83,8483012,Logan Morrison,C,SEA,22,82,6,5,11
83,8482070,Mitchell Chaffee,R,TBL,26,82,6,4,10
83,8480021,Jack Studnicka,C,LAK,25,82,4,6,10
83,8474567,Zach Bogosian,D,MIN,34,82,1,9,10
83,8480870,Bo Groulx,C,NYR,24,82,5,4,9
83,8482712,Oskar Olausson,R,COL,22,82,3,5,8
83,8475177,Calvin de Haan,D,COL,33,82,2,5,7
83,8482787,Nikita Chibrikov,R,WPG,31,82,2,5,7
83,8474062,Riley Nash,C,NYR,35,82,2,4,6
83,8476473,Connor Murphy,D,CHI,31,82,1,5,6
83,8477034,Jaycob Megna,D,FLA,32,82,1,5,6
83,8478874,Adam Gaudette,C,OTT,28,82,0,6,6
83,8482859,Zack Ostapchuk,C,OTT,21,82,4,1,5
83,8470794,Joe Pavelski,C,,40,0,0,0,0
83,8481703,Valtteri Puustinen,R,PIT,25,0,0,0,0
83,8477950,Tony DeAngelo,D,,29,0,0,0,0
83,8481577,Philip Tomasino,C,NSH,23,0,0,0,0
83,8475197,Tyson Barrie,D,,33,0,0,0,0
83,8471218,Blake Wheeler,R,,38,0,0,0,0
83,8474157,Max Pacioretty,L,,36,0,0,0,0
83,8478466,Daniel Sprong,R,VAN,27,0,0,0,0
83,8475744,Evgeny Kuznetsov,C,,32,0,0,0,0
83,8481019,David Gustafsson,C,WPG,24,0,0,0,0
83,8475906,John Klingberg,D,,32,0,0,0,0
83,8479348,Kale Clague,D,BUF,26,0,0,0,0
83,8476952,Dominic Toninato,C,WPG,30,0,0,0,0
83,8473473,Milan Lucic,L,,36,0,0,0,0
83,8474037,James van Riemsdyk,L,,35,0,0,0,0
83,8474602,Justin Schultz,D,,34,0,0,0,0
83,8482222,Alexander Barabanov,L,,30,0,0,0,0
83,8479372,Josh Mahura,D,SEA,26,0,0,0,0
83,8479982,Conor Timmins,D,TOR,26,0,0,0,0
83,8474031,Kevin Shattenkirk,D,,35,0,0,0,0
83,8480008,Adam Ruzicka,C,,25,0,0,0,0
83,8481059,Scott Perunovich,D,STL,26,0,0,0,0
83,8480884,Calen Addison,D,,24,0,0,0,0
83,8476994,Vinnie Hinostroza,C,NSH,30,0,0,0,0
83,8478452,Caleb Jones,D,LAK,27,0,0,0,0
83,8480157,Calle Rosen,D,COL,30,0,0,0,0
83,8481609,Vladislav Kolyachonok,D,UTA,23,0,0,0,0
83,8479415,Michael McLeod,C,,26,0,0,0,0
83,8476919,Chris Tierney,C,,30,0,0,0,0
83,8479639,Dylan Coghlan,D,WPG,26,0,0,0,0
83,8478146,Matthew Highmore,C,OTT,28,0,0,0,0
83,8478970,Jalen Chatfield,D,CAR,28,0,0,0,0
83,8480205,Emil Bemstrom,C,PIT,25,0,0,0,0
83,8474884,Mike Hoffman,C,,35,0,0,0,0
83,8471274,Alex Goligoski,D,,39,0,0,0,0
83,8478104,Sammy Blais,L,,28,0,0,0,0
83,8474870,Tyler Johnson,C,,34,0,0,0,0
83,8476913,Devin Shore,C,MIN,30,0,0,0,0
83,8481598,Philip Broberg,D,EDM,23,0,0,0,0
83,8480058,Pierre-Olivier Joseph,D,STL,25,0,0,0,0
83,8480891,Michael Kesselring,D,UTA,24,0,0,0,0
83,8477979,Nicolas Aube-Kubel,R,BUF,28,0,0,0,0
83,8476871,Tanner Pearson,L,,32,0,0,0,0
83,8476393,Nick Cousins,C,,31,0,0,0,0
83,8479977,Kailer Yamamoto,R,,26,0,0,0,0
83,8479543,Michael Pezzetta,L,MTL,26,0,0,0,0
83,8477018,Ben Hutton,D,VGK,31,0,0,0,0
83,8480762,Eric Robinson,L,CAR,29,0,0,0,0
83,8474034,Pat Maroon,L,CHI,36,0,0,0,0
83,8481058,Jesse Ylönen,R,,25,0,0,0,0
83,8475179,Dmitry Kulikov,D,FLA,34,0,0,0,0
83,8481527,Kaedan Korczak,D,VGK,23,0,0,0,0
83,8473449,Kyle Okposo,R,,36,0,0,0,0
83,8482192,Isaak Phillips,D,CHI,23,0,0,0,0
83,8480727,Zach Whitecloud,D,VGK,28,0,0,0,0
83,8479346,Dillon Dube,C,,26,0,0,0,0
83,8480821,Filip Zadina,R,,25,0,0,0,0
83,8480001,Urho Vaakanainen,D,ANA,25,0,0,0,0
83,8470966,Mark Giordano,D,,41,0,0,0,0
83,8480853,Liam Foudy,C,,24,0,0,0,0
83,8475225,Craig Smith,C,CHI,35,0,0,0,0
83,8479972,Mason Shaw,C,WPG,26,0,0,0,0
83,8478451,Ethan Bear,D,WSH,27,0,0,0,0
83,8474040,Sam Gagner,C,,35,0,0,0,0
83,8480196,Jacob Bryson,D,BUF,27,0,0,0,0
83,8479984,Cal Foote,D,,26,0,0,0,0
83,8480011,Klim Kostin,C,SJS,25,0,0,0,0
83,8482176,Wyatt Kaiser,D,CHI,22,0,0,0,0
83,8476988,Matt Benning,D,SJS,30,0,0,0,0
83,8479370,Tyson Jost,C,CAR,26,0,0,0,0
83,8477464,Nic Petan,C,,29,0,0,0,0
83,8477380,Jonny Brodzinski,C,NYR,31,0,0,0,0
83,8480070,Ian Mitchell,D,BOS,25,0,0,0,0
83,8479315,Joey Anderson,R,CHI,26,0,0,0,0
83,8478099,Kevin Labanc,R,,29,0,0,0,0
83,8476874,Olli Maatta,D,DET,30,0,0,0,0
83,8475208,Brian Dumoulin,D,ANA,33,0,0,0,0
83,8478430,Oliver Kylington,D,,27,0,0,0,0
83,8479536,Axel Jonsson-Fjallby,L,WPG,26,0,0,0,0
83,8479671,Mathieu Olivier,R,CBJ,27,0,0,0,0
83,8471709,Marc-Edouard Vlasic,D,SJS,37,0,0,0,0
83,8479328,Julien Gauthier,R,NYI,27,0,0,0,0
83,8478421,A.J. Greer,L,FLA,28,0,0,0,0
83,8477573,Nathan Walker,L,STL,30,0,0,0,0
83,8481537,Nikita Okhotiuk,D,CGY,24,0,0,0,0
83,8474166,Alec Martinez,D,CHI,37,0,0,0,0
83,8470610,Zach Parise,L,,40,0,0,0,0
83,8477478,William Carrier,L,CAR,30,0,0,0,0
83,8479344,Jesse Puljujarvi,R,PIT,26,0,0,0,0
83,8480887,Jordan Harris,D,MTL,24,0,0,0,0
83,8478502,Dennis Gilbert,D,BUF,28,0,0,0,0
83,8482730,Brandt Clarke,D,LAK,21,0,0,0,0
83,8480355,Mark Kastelic,C,BOS,25,0,0,0,0
83,8475750,Jon Merrill,D,MIN,32,0,0,0,0
83,8475164,Jakob Silfverberg,R,,34,0,0,0,0
83,8477944,Jakub Vrana,L,,28,0,0,0,0
83,8479439,Jacob MacDonald,D,COL,31,0,0,0,0
83,8474568,Luke Schenn,D,NSH,35,0,0,0,0
83,8478454,Noah Juulsen,D,VAN,27,0,0,0,0
83,8475752,Tyler Pitlick,C,,33,0,0,0,0
83,8482148,Hendrix Lapierre,C,WSH,22,0,0,0,0
83,8481167,Brayden Pachal,D,CGY,25,0,0,0,0
83,8478043,Sam Lafferty,C,BUF,29,0,0,0,0
83,8479321,Lucas Johansen,D,,27,0,0,0,0
83,8471699,Andrew Cogliano,C,,37,0,0,0,0
83,8481521,Ronnie Attard,D,PHI,25,0,0,0,0
83,8481161,Jake Christiansen,D,CBJ,25,0,0,0,0
83,8479458,Nikita Zaitsev,D,,33,0,0,0,0
83,8479619,Michael Carcone,L,UTA,28,0,0,0,0
83,8479026,Philippe Myers,D,TOR,27,0,0,0,0
83,8477330,Dominik Kubalik,L,,29,0,0,0,0
83,8481617,Vasily Podkolzin,R,VAN,23,0,0,0,0
83,8481701,Santeri Hatakka,D,NJD,23,0,0,0,0
83,8479514,Rem Pitlick,C,,27,0,0,0,0
83,8477446,Michael McCarron,R,NSH,29,0,0,0,0
83,8470604,Jeff Carter,C,,39,0,0,0,0
83,8482241,Radim Zohorna,L,,28,0,0,0,0
83,8480289,Morgan Barron,C,WPG,26,0,0,0,0
83,8479379,Givani Smith,R,SJS,26,0,0,0,0
83,8480216,Jacob Peterson,C,,25,0,0,0,0
83,8477851,Jordan Oesterle,D,BOS,32,0,0,0,0
83,8484258,Sam Malinski,D,COL,26,0,0,0,0
83,8478904,Steven Lorentz,C,,28,0,0,0,0
83,8482095,Tyler Kleven,D,OTT,22,0,0,0,0
83,8480848,Ty Dellandrea,C,SJS,24,0,0,0,0
83,8476884,Derrick Pouliot,D,,30,0,0,0,0
83,8479336,Carl Grundstrom,R,SJS,27,0,0,0,0
83,8482964,Arber Xhekaj,D,MTL,23,0,0,0,0
83,8471686,Marc Staal,D,,37,0,0,0,0
83,8477887,Patrick Brown,C,BOS,32,0,0,0,0
83,8478495,Denis Gurianov,R,,27,0,0,0,0
83,8473504,Cal Clutterbuck,R,,37,0,0,0,0
83,8481550,Adam Beckman,L,NJD,23,0,0,0,0
83,8480845,Rasmus Kupari,C,WPG,24,0,0,0,0
83,8474009,Nick Bonino,C,,36,0,0,0,0
83,8478585,Derek Ryan,C,EDM,38,0,0,0,0
83,8477962,Brendan Lemieux,L,CAR,28,0,0,0,0
83,8482861,Vincent Iorio,D,WSH,22,0,0,0,0
83,8479378,Logan Stanley,D,WPG,26,0,0,0,0
83,8473446,Erik Johnson,D,PHI,36,0,0,0,0
83,8481743,Marc Del Gaizo,D,NSH,25,0,0,0,0
83,8477384,Josh Brown,D,EDM,30,0,0,0,0
83,8482165,Yan Kuznetsov,D,CGY,22,0,0,0,0
83,8478424,Jansen Harkins,C,ANA,27,0,0,0,0
83,8482144,Jack Thompson,D,SJS,22,0,0,0,0
83,8478512,Austin Czarnik,C,,32,0,0,0,0
83,8477527,Ross Johnston,L,ANA,30,0,0,0,0
83,8479383,Boris Katchouk,L,,26,0,0,0,0
83,8482094,Daemon Hunt,D,MIN,22,0,0,0,0
83,8481719,Maxwell Crozier,D,TBL,24,0,0,0,0
83,8480192,Johnathan Kovacevic,D,NJD,27,0,0,0,0
83,8479376,Victor Mete,D,,26,0,0,0,0
83,8482511,Mason Lohrei,D,BOS,23,0,0,0,0
83,8475825,Jani Hakanpää,D,,32,0,0,0,0
83,8478021,William Lagesson,D,DET,28,0,0,0,0
83,8475795,Dylan McIlrath,D,WSH,32,0,0,0,0
83,8477846,Ryan Carpenter,C,,33,0,0,0,0
83,8481056,Spencer Stastney,D,NSH,24,0,0,0,0
83,8481564,Ryan Johnson,D,BUF,23,0,0,0,0
83,8478017,Mark Friedman,D,VAN,29,0,0,0,0
83,8479320,Max Lajoie,D,SEA,27,0,0,0,0
83,8480075,Cameron Crotty,D,MIN,25,0,0,0,0
83,8484287,Cole McWard,D,VAN,23,0,0,0,0
83,8484254,Akito Hirose,D,VAN,25,0,0,0,0
83,8483407,Brandon Scanlin,D,NYR,25,0,0,0,0
83,8480274,Philip Kemp,D,EDM,25,0,0,0,0
83,8479522,Hardy Haman Aktell,D,WSH,26,0,0,0,0
83,8480007,Jonas Rondbjerg,R,VGK,25,0,0,0,0
83,8477454,Adam Erne,L,,29,0,0,0,0
83,8481679,Maxence Guenette,D,OTT,23,0,0,0,0
83,8480441,Trey Fix-Wolansky,R,CBJ,25,0,0,0,0
83,8483546,Marshall Rifai,D,TOR,26,0,0,0,0
83,8480084,Nick DeSimone,D,NJD,30,0,0,0,0
83,8481030,Jack St. Ivany,D,PIT,25,0,0,0,0
83,8481592,Jakob Pelletier,L,CGY,23,0,0,0,0
83,8478011,Louie Belpedio,D,PHI,28,0,0,0,0
83,8477930,Pierre-Edouard Bellemare,L,,39,0,0,0,0
83,8484321,Nikolas Matinpalo,D,OTT,26,0,0,0,0
83,8482067,Connor Mackey,D,NYR,28,0,0,0,0
83,8481806,Louis Crevier,D,CHI,23,0,0,0,0
83,8484326,Patrik Koch,D,UTA,28,0,0,0,0
83,8477971,Andreas Englund,D,LAK,28,0,0,0,0
83,8481751,Lukas Rousek,R,BUF,25,0,0,0,0
83,8481006,Tyler Tucker,D,STL,24,0,0,0,0
83,8476867,Brendan Gaunce,C,MIN,30,0,0,0,0
83,8479520,Brandon Duhaime,R,WSH,27,0,0,0,0
83,8477073,Kurtis MacDermid,L,NJD,30,0,0,0,0
83,8480874,Adam Ginning,D,PHI,24,0,0,0,0
83,8477473,Justin Bailey,R,SJS,29,0,0,0,0
83,8479066,Ryan Lomberg,L,CGY,30,0,0,0,0
83,8477070,Liam O'Brien,C,UTA,30,0,0,0,0
83,8474618,Marco Scandella,D,,34,0,0,0,0
83,8475797,Jarred Tinordi,D,,32,0,0,0,0
83,8481441,Joe Snively,C,DET,28,0,0,0,0
83,8477244,Chad Ruhwedel,D,NYR,34,0,0,0,0
83,8479772,Zack MacEwen,R,OTT,28,0,0,0,0
83,8481147,Reese Johnson,C,MIN,26,0,0,0,0
83,8481043,Cole Koepke,L,BOS,26,0,0,0,0
83,8483619,Filip Roos,D,OTT,25,0,0,0,0
83,8481541,Samuel Bolduc,D,NYI,24,0,0,0,0
83,8477810,Joel Hanley,D,CGY,33,0,0,0,0
83,8476907,Mackenzie MacEachern,L,,30,0,0,0,0
83,8482652,Walker Duehr,R,CGY,27,0,0,0,0
83,8477126,Jayson Megna,C,,34,0,0,0,0
83,8483398,Declan Carlile,D,TBL,31,0,0,0,0
83,8482929,Emil Lilleberg,D,TBL,23,0,0,0,0
83,8480880,Jakub Lauko,C,MIN,24,0,0,0,0
83,8480245,Olle Lycksell,R,PHI,25,0,0,0,0
83,8480252,Cole Guttman,C,CHI,25,0,0,0,0
83,8477467,Gustav Olofsson,D,SEA,30,0,0,0,0
83,8479968,Vinni Lettieri,C,BOS,29,0,0,0,0
83,8478400,Colin White,C,,27,0,0,0,0
83,8475755,Alexander Petrovic,D,DAL,32,0,0,0,0
83,8481812,Nikolai Knyzhov,D,,27,0,0,0,0
83,8481593,Jayden Struble,D,MTL,23,0,0,0,0
83,8481532,Alex Turcotte,C,LAK,23,0,0,0,0
83,8482126,Emil Andrae,D,PHI,31,0,0,0,0
83,8479944,Zach Aston-Reese,C,VGK,30,0,0,0,0
83,8471817,Ryan Reaves,R,TOR,37,0,0,0,0
83,8481206,John Ludvig,D,PIT,24,0,0,0,0
83,8481599,Victor Soderstrom,D,UTA,23,0,0,0,0
83,8480292,Carson Meyer,R,ANA,27,0,0,0,0
83,8482496,Nils Aman,C,VAN,24,0,0,0,0
83,8479718,Alex Barré-Boulet,C,MTL,27,0,0,0,0
83,8479994,Jaret Anderson-Dolan,C,WPG,25,0,0,0,0
83,8480184,Gustav Lindstrom,D,,26,0,0,0,0
83,8480890,Jan Jenik,R,OTT,24,0,0,0,0
83,8478067,Oskar Lindblom,L,,28,0,0,0,0
83,8476934,Brock McGinn,L,ANA,30,0,0,0,0
83,8479985,Cale Fleury,D,SEA,26,0,0,0,0
83,8484304,Uvis Balinskis,D,FLA,28,0,0,0,0
83,8479981,Jonah Gadjovich,L,FLA,26,0,0,0,0
83,8481716,Dmitri Voronkov,L,CBJ,24,0,0,0,0
83,8474709,Matt Martin,L,,35,0,0,0,0
83,8482634,Alex Steeves,C,TOR,25,0,0,0,0
83,8480823,Alexander Alexeyev,D,WSH,25,0,0,0,0
83,8477541,Dakota Mermis,D,TOR,30,0,0,0,0
83,8483491,Ivan Miroshnichenko,L,WSH,20,0,0,0,0
83,8478477,Mitchell Stephens,C,SEA,27,0,0,0,0
83,8481543,Nikita Alexandrov,C,STL,24,0,0,0,0
83,8479423,Alex Nylander,L,,26,0,0,0,0
83,8482451,Mikael Pyyhtia,L,CBJ,23,0,0,0,0
83,8478831,Kevin Stenlund,C,UTA,28,0,0,0,0
83,8480306,Grant Hutton,D,NYI,29,0,0,0,0
83,8478028,Fredrik Olofsson,L,,28,0,0,0,0
83,8477462,Robert Hagg,D,VGK,29,0,0,0,0
83,8477320,Anton Blidh,L,NYR,29,0,0,0,0
83,8482157,Will Cuylle,L,NYR,22,0,0,0,0
83,8482737,Zack Bolduc,C,STL,21,0,0,0,0
83,8481239,Samuel Fagemo,L,,24,0,0,0,0
83,8481600,Tobias Bjornfot,D,FLA,23,0,0,0,0
83,8478409,Anthony Richard,C,PHI,28,0,0,0,0
83,8474145,Robert Bortuzzo,D,,35,0,0,0,0
83,8475958,Michael Sgarbossa,C,WSH,32,0,0,0,0
83,8479986,Kole Lind,R,DAL,26,0,0,0,0
83,8479249,Andrew Poturalski,C,SJS,30,0,0,0,0
83,8479362,Riley Tufte,L,BOS,26,0,0,0,0
83,8479991,Jake Leschyshyn,C,NYR,25,0,0,0,0
83,8479587,Rhett Gardner,C,PHI,28,0,0,0,0
83,8482744,James Malatesta,L,CBJ,21,0,0,0,0
83,8478854,Ryan Shea,D,PIT,27,0,0,0,0
83,8481591,Sam Poulin,R,,23,0,0,0,0
83,8483512,Matt Savoie,C,EDM,20,0,0,0,0
83,8482102,Vasily Ponomarev,C,PIT,22,0,0,0,0
83,8482162,Roby Jarventie,L,EDM,22,0,0,0,0
83,8481016,Ruslan Iskhakov,C,,24,0,0,0,0
83,8482172,Landon Slaggert,L,CHI,22,0,0,0,0
83,8482747,Brennan Othmann,L,NYR,21,0,0,0,0
83,8480031,Maxime Comtois,L,,25,0,0,0,0
83,8480226,Marián Studenic,R,,26,0,0,0,0
83,8478408,Travis Dermott,D,,28,0,0,0,0
83,8481518,Nolan Foote,L,NJD,24,0,0,0,0
83,8479419,Brett Murray,L,BUF,26,0,0,0,0
83,8482088,Justin Sourdif,R,FLA,22,0,0,0,0
83,8482201,Gage Goncalves,C,TBL,23,0,0,0,0
83,8481578,Graeme Clarke,R,MIN,23,0,0,0,0
83,8482177,Marat Khusnutdinov,C,MIN,22,0,0,0,0
83,8481754,Nikita Nesterenko,C,ANA,23,0,0,0,0
83,8483531,Brian Halonen,L,NJD,25,0,0,0,0
83,8483920,Pierrick Dube,R,WSH,23,0,0,0,0
83,8480851,Akil Thomas,C,LAK,24,0,0,0,0
83,8475235,Nicolas Deslauriers,L,PHI,33,0,0,0,0
83,8482476,Emil Heineman,L,MTL,23,0,0,0,0
83,8477149,Scott Sabourin,R,SJS,32,0,0,0,0
83,8483549,Lucas Condotta,L,MTL,27,0,0,0,0
83,8482765,Isak Rosen,R,BUF,21,0,0,0,0
83,8481237,Kyle MacLean,C,NYI,25,0,0,0,0
83,8481024,Linus Karlsson,C,VAN,25,0,0,0,0
83,8481690,Tyler Angle,C,,24,0,0,0,0
83,8483570,Ben Meyers,C,SEA,26,0,0,0,0
83,8481655,Cole Schwindt,R,CGY,23,0,0,0,0
83,8481462,Mason Morelli,L,VGK,28,0,0,0,0
83,8483401,Marc Johnstone,R,PIT,28,0,0,0,0
83,8478956,Samuel Laberge,L,NJD,27,0,0,0,0
83,8479533,Joona Koppanen,L,,26,0,0,0,0
83,8482197,Adam Raska,R,MIN,23,0,0,0,0
83,8482250,Callahan Burke,C,VGK,27,0,0,0,0
83,8482784,Zach Dean,C,STL,21,0,0,0,0
83,8484255,Jason Polin,R,COL,25,0,0,0,0
83,8481077,John Leonard,L,,26,0,0,0,0
83,8481534,Raphael Lavoie,C,EDM,24,0,0,0,0
83,8483609,Adam Klapka,R,CGY,24,0,0,0,0
83,8482751,Ryan Winterton,C,SEA,21,0,0,0,0
83,8480267,Sammy Walker,C,MIN,25,0,0,0,0
83,8475766,Austin Watson,L,,32,0,0,0,0
83,8482460,Matt Rempe,C,NYR,22,0,0,0,0
83,8481065,Angus Crookshank,L,OTT,25,0,0,0,0
83,8481070,Hugh McGing,L,,26,0,0,0,0
83,8476323,Max McCormick,L,SEA,32,0,0,0,0
83,8483395,Arshdeep Bains,L,VAN,23,0,0,0,0
83,8484259,Ondrej Pavel,C,COL,31,0,0,0,0
83,8483432,Luca Del Bel Belluz,C,CBJ,31,0,0,0,0
83,8483045,Cameron Butler,R,CBJ,31,0,0,0,0
83,8482061,Brandon Biro,L,SEA,26,0,0,0,0
83,8477401,John Hayden,C,SEA,29,0,0,0,0
83,8475278,Byron Froese,C,,33,0,0,0,0
83,8478446,Glenn Gawdin,C,LAK,27,0,0,0,0
83,8477993,Justin Kirkland,C,CGY,28,0,0,0,0
83,8482147,Jean-Luc Foudy,C,COL,22,0,0,0,0
83,8480032,Shane Bowers,C,NJD,25,0,0,0,0
83,8479330,Brandon Gignac,C,MTL,27,0,0,0,0
83,8480776,Sheldon Rempal,R,,29,0,0,0,0
83,8475413,Justin Dowling,C,NJD,34,0,0,0,0
83,8481726,Adam Edstrom,C,NYR,24,0,0,0,0
83,8480844,Grigori Denisenko,L,VGK,24,0,0,0,0
83,8478147,Bokondji Imama,L,PIT,28,0,0,0,0
83,8478881,Brett Seney,L,CHI,28,0,0,0,0
83,8483630,Pavol Regenda,L,ANA,25,0,0,0,0
83,8480836,Jonathan Gruden,C,,24,0,0,0,0
83,8484314,Jiri Smejkal,L,,28,0,0,0,0
83,8475780,Chris Wagner,R,COL,33,0,0,0,0
83,8479546,Oskar Steen,C,,26,0,0,0,0
83,8483597,Milos Kelemen,L,UTA,25,0,0,0,0
83,8481789,Tye Kartye,L,SEA,23,0,0,0,0
83,8484325,Waltteri Merela,C,TBL,26,0,0,0,0
83,8479421,Jacob Moverare,D,LAK,26,0,0,0,0
83,8481585,Egor Afanasyev,L,SJS,23,0,0,0,0
83,8479547,Matthew Phillips,R,,26,0,0,0,0
83,8479367,William Lockwood,R,FLA,26,0,0,0,0
83,8476915,Jujhar Khaira,L,,30,0,0,0,0
83,8481422,Jacob Lucchini,C,NSH,29,0,0,0,0
83,8480468,James Hamblin,L,EDM,25,0,0,0,0
83,8478051,Max Willman,C,NJD,29,0,0,0,0
83,8481556,John Beecher,C,BOS,23,0,0,0,0
83,8478078,Rourke Chartier,C,,28,0,0,0,0
84,8478402,Connor McDavid,C,EDM,27,82,41,94,135
84,8476453,Nikita Kucherov,R,TBL,31,82,45,76,121
84,8477492,Nathan MacKinnon,C,COL,29,82,44,76,120
84,8478420,Mikko Rantanen,R,COL,28,82,60,57,117
84,8481559,Jack Hughes,C,NJD,23,82,43,74,117
84,8478550,Artemi Panarin,L,NYR,33,82,38,78,116
84,8477939,William Nylander,R,TOR,28,82,48,67,115
84,8479318,Auston Matthews,C,TOR,27,82,52,60,112
84,8477493,Aleksander Barkov,C,FLA,29,82,35,76,111
84,8481523,Kirby Dach,C,MTL,23,82,24,84,108
84,8477956,David Pastrnak,R,BOS,28,82,55,52,107
84,8477934,Leon Draisaitl,C,EDM,29,82,42,65,107
84,8478427,Sebastian Aho,C,CAR,27,82,43,59,102
84,8478864,Kirill Kaprizov,L,MIN,27,82,39,61,100
84,8480069,Cale Makar,D,COL,26,82,19,79,98
84,8477409,Carter Verhaeghe,C,FLA,29,82,50,44,94
84,8478403,Jack Eichel,C,VGK,28,82,45,48,93
84,8480027,Jason Robertson,L,DAL,25,82,39,54,93
84,8479314,Matthew Tkachuk,L,FLA,27,82,36,57,93
84,8476468,J.T. Miller,C,VAN,31,82,35,57,92
84,8480800,Quinn Hughes,D,VAN,25,82,12,80,92
84,8478010,Brayden Point,C,TBL,28,82,37,54,91
84,8477942,Kevin Fiala,L,LAK,28,82,36,54,90
84,8477946,Dylan Larkin,C,DET,28,82,36,54,90
84,8479343,Clayton Keller,R,UTA,26,82,37,52,89
84,8479407,Jesper Bratt,L,NJD,26,82,31,58,89
84,8479385,Jordan Kyrou,C,STL,26,82,28,60,88
84,8475913,Mark Stone,R,VGK,32,82,35,52,87
84,8471675,Sidney Crosby,C,PIT,37,82,37,49,86
84,8480801,Brady Tkachuk,L,OTT,25,82,42,43,85
84,8476460,Mark Scheifele,C,WPG,31,82,39,46,85
84,8480839,Rasmus Dahlin,D,BUF,24,82,16,69,85
84,8480002,Nico Hischier,C,NJD,25,82,29,55,84
84,8480036,Miro Heiskanen,D,DAL,25,82,21,62,83
84,8477501,Valeri Nichushkin,R,COL,29,82,42,40,82
84,8474564,Steven Stamkos,C,NSH,34,82,34,48,82
84,8478445,Mathew Barzal,C,NYI,27,82,23,59,82
84,8479323,Adam Fox,D,NYR,26,82,15,67,82
84,8475166,John Tavares,C,TOR,34,82,42,39,81
84,8482078,Lucas Raymond,L,DET,22,82,35,45,80
84,8474141,Patrick Kane,R,DET,36,82,33,47,80
84,8476881,Tomas Hertl,C,VGK,31,82,35,44,79
84,8477504,Josh Morrissey,D,WPG,29,82,15,64,79
84,8477960,Adrian Kempe,R,LAK,28,82,34,44,78
84,8476459,Mika Zibanejad,C,NYR,31,82,31,47,78
84,8475172,Nazem Kadri,C,CGY,34,82,23,55,78
84,8476456,Jonathan Huberdeau,C,CGY,31,82,21,57,78
84,8477955,Jared McCann,L,SEA,28,82,40,37,77
84,8477933,Sam Reinhart,C,FLA,29,82,28,49,77
84,8482116,Tim Stützle,C,OTT,22,82,24,53,77
84,8481557,Matt Boldy,L,MIN,23,82,24,53,77
84,8476454,Ryan Nugent-Hopkins,C,EDM,31,82,16,61,77
84,8475184,Chris Kreider,L,NYR,33,82,46,30,76
84,8477404,Jake Guentzel,C,TBL,30,82,41,35,76
84,8476539,Jonathan Marchessault,R,NSH,34,82,41,35,76
84,8475810,Bryan Rust,R,PIT,32,82,37,39,76
84,8478449,Roope Hintz,C,DAL,28,82,34,42,76
84,8474586,Jordan Eberle,R,SEA,34,82,31,45,76
84,8476389,Vincent Trocheck,C,NYR,31,82,26,50,76
84,8476887,Filip Forsberg,L,NSH,30,82,34,41,75
84,8477949,Alex Tuch,R,BUF,28,82,26,49,75
84,8476346,Johnny Gaudreau,L,CBJ,31,82,20,55,75
84,8477447,Shea Theodore,D,VGK,29,82,12,63,75
84,8480015,Owen Tippett,R,PHI,25,82,37,37,74
84,8477500,Bo Horvat,C,NYI,29,82,35,39,74
84,8480012,Elias Pettersson,C,VAN,26,82,33,41,74
84,8478439,Travis Konecny,R,PHI,27,82,29,45,74
84,8478398,Kyle Connor,L,WPG,28,82,23,51,74
84,8481540,Cole Caufield,R,MTL,23,82,34,39,73
84,8477402,Pavel Buchnevich,L,STL,29,82,29,44,73
84,8475168,Matt Duchene,C,DAL,33,82,29,44,73
84,8474578,Erik Karlsson,D,PIT,34,82,13,60,73
84,8471214,Alex Ovechkin,L,WSH,39,82,35,37,72
84,8479420,Tage Thompson,C,BUF,27,82,33,39,72
84,8479337,Alex DeBrincat,R,DET,27,82,31,41,72
84,8480023,Robert Thomas,C,STL,25,82,21,51,72
84,8474600,Roman Josi,D,NSH,34,82,14,58,72
84,8477496,Elias Lindholm,C,BOS,30,82,27,44,71
84,8473419,Brad Marchand,L,BOS,36,82,27,44,71
84,8478042,Viktor Arvidsson,R,EDM,31,82,25,46,71
84,8480830,Andrei Svechnikov,R,CAR,24,82,29,41,70
84,8475765,Vladimir Tarasenko,R,DET,33,82,27,43,70
84,8477951,Nick Schmaltz,C,UTA,28,82,23,47,70
84,8478444,Brock Boeser,R,VAN,27,82,32,37,69
84,8477416,Oliver Bjorkstrand,R,SEA,29,82,27,42,69
84,8479542,Brandon Hagel,L,TBL,26,82,28,40,68
84,8476875,Mike Matheson,D,MTL,30,82,15,53,68
84,8482665,Matty Beniers,C,SEA,22,82,31,36,67
84,8478975,Mason Marchment,L,DAL,29,82,29,38,67
84,8477940,Nikolaj Ehlers,L,WPG,28,82,28,39,67
84,8478873,Troy Terry,R,ANA,27,82,21,46,67
84,8478414,Timo Meier,R,NJD,28,82,34,32,66
84,8482097,Jack Quinn,R,BUF,23,82,32,34,66
84,8474679,Gustav Nyquist,C,NSH,35,82,24,42,66
84,8475692,Mats Zuccarello,R,MIN,37,82,19,47,66
84,8477503,Max Domi,C,TOR,29,82,16,50,66
84,8480803,Evan Bouchard,D,EDM,25,82,9,57,66
84,8482110,Dawson Mercer,C,NJD,23,82,39,26,65
84,8475170,Brayden Schenn,C,STL,33,82,31,34,65
84,8479339,Patrik Laine,L,CBJ,26,82,28,37,65
84,8481533,Trevor Zegras,C,ANA,23,82,23,42,65
84,8471215,Evgeni Malkin,C,PIT,38,82,22,43,65
84,8479999,Casey Mittelstadt,C,COL,26,82,22,43,65
84,8477986,Brandon Montour,D,SEA,30,82,19,46,65
84,8478407,Vince Dunn,D,SEA,28,82,10,55,65
84,8480018,Nick Suzuki,C,MTL,25,82,21,43,64
84,8479675,Trevor Moore,L,LAK,29,82,34,29,63
84,8475191,Reilly Smith,R,NYR,33,82,27,36,63
84,8479425,Filip Hronek,D,VAN,27,82,16,47,63
84,8475167,Victor Hedman,D,TBL,34,82,11,52,63
84,8475784,Jeff Skinner,C,EDM,32,82,32,30,62
84,8477497,Sean Monahan,C,CBJ,30,82,28,34,62
84,8477451,Ryan Hartman,R,MIN,30,82,23,39,62
84,8473512,Claude Giroux,R,OTT,36,82,15,47,62
84,8473994,Jamie Benn,L,DAL,35,82,28,33,61
84,8474102,David Perron,L,OTT,36,82,24,37,61
84,8479325,Charlie McAvoy,D,BOS,27,82,10,51,61
84,8475786,Zach Hyman,L,EDM,32,82,30,30,60
84,8478047,Michael Bunting,L,PIT,29,82,24,36,60
84,8476448,William Karlsson,C,VGK,31,82,22,38,60
84,8480208,Drake Batherson,R,OTT,26,82,12,48,60
84,8476853,Morgan Rielly,D,TOR,30,82,10,50,60
84,8475726,Tyler Toffoli,C,SJS,32,82,38,21,59
84,8477494,Jonathan Drouin,L,COL,29,82,19,40,59
84,8477444,Andre Burakovsky,L,SEA,29,82,19,40,59
84,8471724,Kris Letang,D,PIT,37,82,13,46,59
84,8478493,Joel Eriksson Ek,C,MIN,27,82,32,26,58
84,8478460,Zach Werenski,D,CBJ,27,82,20,38,58
84,8480865,Noah Dobson,D,NYI,24,82,8,50,58
84,8475768,Jaden Schwartz,C,SEA,32,82,28,29,57
84,8480188,Fabian Zetterlund,L,SJS,25,82,24,33,57
84,8481528,Dylan Cozens,C,BUF,23,82,23,34,57
84,8476882,Teuvo Teravainen,L,CHI,30,82,21,36,57
84,8478397,Rasmus Andersson,D,CGY,28,82,12,45,57
84,8475169,Evander Kane,L,EDM,33,82,35,21,56
84,8480039,Martin Necas,C,CAR,25,82,26,30,56
84,8481068,Yegor Sharangovich,C,CGY,26,82,25,31,56
84,8479410,Mikhail Sergachev,D,UTA,26,82,15,41,56
84,8476905,Chandler Stephenson,C,SEA,30,82,15,41,56
84,8478519,Anthony Cirelli,C,TBL,27,82,28,27,55
84,8480078,Filip Chytil,C,NYR,25,82,24,31,55
84,8476826,Yanni Gourde,C,SEA,33,82,20,35,55
84,8478396,Noah Hanifin,D,VGK,27,82,11,44,55
84,8476906,Shayne Gostisbehere,D,CAR,31,82,8,47,55
84,8475754,Brock Nelson,C,NYI,33,82,29,25,54
84,8478366,Frank Vatrano,R,ANA,30,82,29,25,54
84,8478498,Jake DeBrusk,L,VAN,28,82,29,25,54
84,8477964,Ivan Barbashev,C,VGK,29,82,24,30,54
84,8476462,Dougie Hamilton,D,NJD,31,82,19,35,54
84,8478440,Dylan Strome,C,WSH,27,82,16,38,54
84,8477495,Seth Jones,D,CHI,30,82,9,45,54
84,8481542,Moritz Seider,D,DET,23,82,8,46,54
84,8482740,Wyatt Johnston,C,DAL,21,82,28,25,53
84,8482109,Alexis Lafrenière,L,NYR,23,82,27,26,53
84,8475794,Tyler Seguin,C,DAL,32,82,22,31,53
84,8478401,Pavel Zacha,C,BOS,27,82,22,31,53
84,8477479,Tyler Bertuzzi,L,CHI,29,82,22,31,53
84,8474150,Mikael Backlund,C,CGY,35,82,16,37,53
84,8476923,Damon Severson,D,CBJ,30,82,12,41,53
84,8475753,Justin Faulk,D,STL,32,82,11,42,53
84,8474563,Drew Doughty,D,LAK,35,82,8,45,53
84,8480014,Gabriel Vilardi,C,WPG,25,82,30,22,52
84,8476399,Blake Coleman,C,CGY,33,82,30,22,52
84,8478542,Evan Rodrigues,C,FLA,31,82,16,36,52
84,8475158,Ryan O'Reilly,C,NSH,33,82,25,26,51
84,8475722,Jason Zucker,L,BUF,32,82,24,27,51
84,8482159,Tyson Foerster,R,PHI,22,82,23,28,51
84,8482113,Anton Lundell,C,FLA,23,82,22,29,51
84,8476880,Tom Wilson,R,WSH,30,82,21,30,51
84,8473422,Nick Foligno,L,CHI,37,82,21,30,51
84,8480798,Philipp Kurashev,C,CHI,25,82,17,34,51
84,8482124,Quinton Byfield,R,LAK,22,82,15,36,51
84,8480009,Eeli Tolvanen,R,SEA,25,82,32,18,50
84,8476432,Boone Jenner,C,CBJ,31,82,31,19,50
84,8477426,Nicholas Paul,L,TBL,29,82,26,24,50
84,8477998,Warren Foegele,L,LAK,28,82,25,25,50
84,8475745,Charlie Coyle,C,BOS,32,82,22,28,50
84,8480064,Josh Norris,C,OTT,25,82,22,28,50
84,8474590,John Carlson,D,WSH,34,82,17,33,50
84,8482684,Luke Hughes,D,NJD,21,82,11,39,50
84,8477511,Anthony Mantha,R,CGY,30,82,25,24,49
84,8476461,Sean Couturier,C,PHI,32,82,25,24,49
84,8478109,Victor Olofsson,L,VGK,29,82,23,26,49
84,8478462,Nicolas Roy,C,VGK,27,82,22,27,49
84,8482699,Dylan Guenther,R,UTA,21,82,21,28,49
84,8474053,Logan Couture,C,SJS,35,82,21,28,49
84,8482093,Seth Jarvis,C,CAR,22,82,20,29,49
84,8471685,Anze Kopitar,C,LAK,37,82,15,34,49
84,8482667,William Eklund,L,SJS,22,82,12,37,49
84,8474641,Adam Henrique,C,EDM,34,82,29,19,48
84,8484144,Connor Bedard,C,CHI,19,82,24,24,48
84,8477476,Artturi Lehkonen,L,COL,29,82,18,30,48
84,8473986,Alex Killorn,L,ANA,35,82,15,33,48
84,8480434,Sean Durzi,D,UTA,26,82,10,38,48
84,8482175,JJ Peterka,R,BUF,22,82,30,17,47
84,8477935,Sam Bennett,C,FLA,28,82,29,18,47
84,8471698,T.J. Oshie,R,WSH,38,82,27,20,47
84,8479525,Ross Colton,C,COL,28,82,25,22,47
84,8478856,Conor Garland,R,VAN,28,82,15,32,47
84,8470613,Brent Burns,D,CAR,39,82,14,33,47
84,8478055,Gustav Forsling,D,FLA,28,82,11,36,47
84,8476869,Brady Skjei,D,NSH,30,82,10,37,47
84,8479992,Michael Rasmussen,C,DET,25,82,18,28,46
84,8480797,Joel Farabee,L,PHI,24,82,17,29,46
84,8477407,Anthony Duclair,L,NYI,29,82,17,29,46
84,8475287,Erik Haula,L,NJD,33,82,14,32,46
84,8477346,MacKenzie Weegar,D,CGY,30,82,9,37,46
84,8478038,Devon Toews,D,COL,30,82,8,38,46
84,8476438,Brandon Saad,L,STL,32,82,26,19,45
84,8482720,Matthew Knies,L,TOR,22,82,23,22,45
84,8481618,Alex Newhook,C,MTL,23,82,22,23,45
84,8479365,Trent Frederic,C,BOS,26,82,21,24,45
84,8477456,J.T. Compher,L,DET,29,82,15,30,45
84,8481535,Nils Hoglander,L,VAN,24,82,15,30,45
84,8476329,Travis Boyd,C,MIN,31,82,14,31,45
84,8479345,Jakob Chychrun,D,WSH,26,82,14,31,45
84,8481656,Aliaksei Protas,C,WSH,23,82,14,31,45
84,8482745,Mason McTavish,C,ANA,21,82,13,32,45
84,8474565,Alex Pietrangelo,D,VGK,34,82,7,38,45
84,8480829,Jesperi Kotkaniemi,C,CAR,24,82,26,18,44
84,8478474,Lawson Crouse,L,UTA,27,82,21,23,44
84,8475793,Ryan Johansen,C,PHI,32,82,21,23,44
84,8479400,Pierre-Luc Dubois,L,WSH,26,82,20,24,44
84,8480220,Noah Cates,L,PHI,25,82,17,27,44
84,8477948,Travis Sanheim,D,PHI,28,82,17,27,44
84,8480185,Eetu Luostarinen,C,FLA,26,82,16,28,44
84,8481711,Matias Maccelli,L,UTA,24,82,15,29,44
84,8475791,Taylor Hall,L,CHI,33,82,15,29,44
84,8478438,Tommy Novak,C,NSH,27,82,14,30,44
84,8482149,Cole Perfetti,C,WPG,22,82,14,30,44
84,8481581,Thomas Harley,D,DAL,23,82,12,32,44
84,8476292,Ondrej Palat,L,NJD,33,82,11,33,44
84,8475151,Kyle Palmieri,C,NYI,33,82,23,20,43
84,8481624,Ilya Mikheyev,R,CHI,30,82,22,21,43
84,8481560,Arthur Kaliyev,R,LAK,23,82,19,24,43
84,8477450,Jason Dickinson,C,CHI,29,82,19,24,43
84,8479996,Cody Glass,C,NSH,25,82,19,24,43
84,8477987,Ryan Donato,C,CHI,28,82,14,29,43
84,8476458,Ryan Strome,C,ANA,31,82,14,29,43
84,8476927,Teddy Blueger,C,VAN,30,82,14,29,43
84,8480028,Morgan Frost,C,PHI,25,82,13,30,43
84,8477932,Aaron Ekblad,D,FLA,28,82,10,33,43
84,8475798,Mikael Granlund,C,SJS,32,82,8,35,43
84,8482705,Cole Sillinger,C,CBJ,21,82,22,20,42
84,8481582,Nicholas Robertson,L,TOR,23,82,21,21,42
84,8480849,Barrett Hayton,C,UTA,24,82,20,22,42
84,8476479,Phillip Danault,C,LAK,31,82,19,23,42
84,8479390,Taylor Raddysh,R,WSH,26,82,16,26,42
84,8482660,Kent Johnson,C,CBJ,22,82,9,33,42
84,8476419,Jean-Gabriel Pageau,C,NYI,32,82,22,19,41
84,8480802,Ryan McLeod,C,BUF,25,82,20,21,41
84,8475314,Anders Lee,L,NYI,34,82,19,22,41
84,8480113,Alex Iafallo,L,WPG,31,82,17,24,41
84,8478133,Jake Evans,C,MTL,28,82,17,24,41
84,8475714,Calle Jarnkrok,C,TOR,33,82,16,25,41
84,8483515,Juraj Slafkovsky,L,MTL,20,82,16,25,41
84,8475171,Oliver Ekman-Larsson,D,TOR,33,82,8,33,41
84,8481546,Cam York,D,PHI,23,82,8,33,41
84,8478020,Michael Amadio,C,OTT,28,82,27,13,40
84,8482092,Ridly Greig,C,OTT,22,82,22,18,40
84,8482079,Marco Rossi,C,MIN,23,82,22,18,40
84,8483808,Andrei Kuzmenko,L,CGY,28,82,21,19,40
84,8475848,Brendan Gallagher,R,MTL,32,82,20,20,40
84,8481596,Shane Pinto,C,OTT,24,82,19,21,40
84,8476872,Scott Laughton,C,PHI,30,82,13,27,40
84,8476958,Jaccob Slavin,D,CAR,30,82,10,30,40
84,8480145,Neal Pionk,D,WPG,29,82,9,31,40
84,8477989,Christian Dvorak,C,MTL,28,82,21,18,39
84,8481604,Pavel Dorofeyev,L,VGK,24,82,20,19,39
84,8476483,Rickard Rakell,R,PIT,31,82,18,21,39
84,8476921,Jordan Martinook,L,CAR,32,82,15,24,39
84,8478463,Anthony Beauvillier,L,PIT,27,82,14,25,39
84,8474149,Evgenii Dadonov,R,DAL,35,82,14,25,39
84,8476918,Jimmy Vesey,L,NYR,31,82,13,26,39
84,8480459,Pius Suter,C,VAN,28,82,23,15,38
84,8475799,Nino Niederreiter,R,WPG,32,82,22,16,38
84,8481554,Kaapo Kakko,R,NYR,23,82,19,19,38
84,8477021,Alex Kerfoot,C,UTA,30,82,18,20,38
84,8477952,Robby Fabbri,C,ANA,28,82,18,20,38
84,8475763,Kevin Hayes,R,PIT,32,82,16,22,38
84,8478233,Andrew Mangiapane,L,WSH,28,82,14,24,38
84,8478472,Mathieu Joseph,R,STL,27,82,14,24,38
84,8476885,Jacob Trouba,D,NYR,30,82,11,27,38
84,8478057,Dakota Joshua,C,VAN,28,82,23,14,37
84,8480893,Kirill Marchenko,R,CBJ,24,82,21,16,37
84,8483431,Logan Cooley,C,UTA,20,82,20,17,37
84,8477498,Darnell Nurse,D,EDM,29,82,14,23,37
84,8478413,Jordan Greenway,L,BUF,27,82,13,24,37
84,8480871,Adam Boqvist,D,FLA,24,82,9,28,37
84,8474151,Ryan McDonagh,D,TBL,35,82,4,33,37
84,8480068,Ryan Poehling,C,PHI,25,82,19,17,36
84,8482475,Yegor Chinakhov,R,CBJ,23,82,18,18,36
84,8479293,Brandon Tanev,L,SEA,33,82,17,19,36
84,8478115,Pierre Engvall,L,NYI,28,82,14,22,36
84,8476474,Stefan Noesen,R,NJD,31,82,14,22,36
84,8479591,Michael Eyssimont,C,TBL,28,82,14,22,36
84,8476854,Hampus Lindholm,D,BOS,30,82,12,24,36
84,8478458,Jack Roslovic,C,CAR,27,82,10,26,36
84,8476792,Torey Krug,D,STL,33,82,9,27,36
84,8481606,Jordan Spence,D,LAK,23,82,9,27,36
84,8480336,Sean Walker,D,CAR,30,82,7,29,36
84,8482089,Jake Neighbours,L,STL,22,82,19,16,35
84,8475193,Tomas Tatar,L,NJD,34,82,16,19,35
84,8473533,Jordan Staal,C,CAR,36,82,16,19,35
84,8477919,Frederick Gaudreau,C,MIN,31,82,12,23,35
84,8482142,Jamie Drysdale,D,PHI,22,82,5,30,35
84,8476897,Oskar Sundqvist,C,STL,30,82,17,17,34
84,8481580,Connor McMichael,C,WSH,23,82,17,17,34
84,8482111,Justin Barron,D,MTL,23,82,16,18,34
84,8477429,Andrew Copp,C,DET,30,82,15,19,34
84,8477953,Kasperi Kapanen,R,STL,28,82,13,21,34
84,8477947,Sonny Milano,L,WSH,28,82,12,22,34
84,8475218,Mattias Ekholm,D,EDM,34,82,10,24,34
84,8474716,Jared Spurgeon,D,MIN,35,82,9,25,34
84,8482671,Owen Power,D,BUF,22,82,9,25,34
84,8475200,Dmitry Orlov,D,CAR,33,82,7,27,34
84,8480873,Rasmus Sandin,D,WSH,24,82,5,29,34
84,8479976,Juuso Valimaki,D,UTA,26,82,5,29,34
84,8475764,Cam Fowler,D,ANA,33,82,3,31,34
84,8476892,Colton Parayko,D,STL,31,82,2,32,34
84,8478046,Danton Heinen,L,VAN,29,82,18,15,33
84,8482062,Cole Smith,L,NSH,29,82,18,15,33
84,8481601,Simon Holmstrom,R,NYI,23,82,17,16,33
84,8480835,Jack Drury,C,CAR,24,82,16,17,33
84,8476981,Josh Anderson,R,MTL,30,82,15,18,33
84,8474715,Cam Atkinson,R,TBL,35,82,15,18,33
84,8479941,Justin Danforth,R,CBJ,31,82,14,19,33
84,8480995,Pontus Holmberg,R,TOR,25,82,14,19,33
84,8479987,Morgan Geekie,C,BOS,26,82,11,22,33
84,8481186,Logan O'Connor,R,COL,28,82,11,22,33
84,8482117,Lukas Reichel,L,CHI,22,82,10,23,33
84,8482105,Jake Sanderson,D,OTT,22,82,8,25,33
84,8478851,Alexandre Carrier,D,NSH,28,82,7,26,33
84,8477969,Marcus Pettersson,D,PIT,28,82,6,27,33
84,8478882,Vladislav Gavrikov,D,LAK,29,82,6,27,33
84,8482087,Kaiden Guhle,D,MTL,22,82,5,28,33
84,8475855,Jesper Fast,R,CAR,33,82,20,12,32
84,8477931,Tomas Nosek,L,FLA,32,82,18,14,32
84,8482055,Drew O'Connor,L,PIT,26,82,17,15,32
84,8479351,Sam Steel,C,DAL,26,82,17,15,32
84,8484145,Zach Benson,L,BUF,19,82,14,18,32
84,8478891,Mason Appleton,C,WPG,28,82,12,20,32
84,8479393,Noah Gregor,C,OTT,26,82,12,20,32
84,8475220,Marcus Foligno,L,MIN,33,82,11,21,32
84,8470621,Corey Perry,R,EDM,39,82,11,21,32
84,8478469,Thomas Chabot,D,OTT,27,82,10,22,32
84,8477488,Brett Pesce,D,NJD,30,82,9,23,32
84,8476979,Erik Gustafsson,D,DET,32,82,5,27,32
84,8482655,J.J. Moser,D,TBL,24,82,4,28,32
84,8481178,Egor Zamula,D,PHI,24,82,4,28,32
84,8476392,Adam Lowry,C,WPG,31,82,19,12,31
84,8480074,Alexandre Texier,C,STL,25,82,16,15,31
84,8481553,Bobby Brink,R,PHI,23,82,15,16,31
84,8476960,Andreas Athanasiou,C,CHI,30,82,14,17,31
84,8481013,Jonatan Berggren,R,DET,24,82,13,18,31
84,8476525,Colin Miller,D,WPG,32,82,13,18,31
84,8480806,Isac Lundestrom,C,ANA,25,82,10,21,31
84,8480817,K'Andre Miller,D,NYR,24,82,7,24,31
84,8477839,Conor Sheary,L,TBL,32,82,7,24,31
84,8479398,Samuel Girard,D,COL,26,82,4,27,31
84,8476873,Mark Jankowski,C,NSH,30,82,14,16,30
84,8476925,Colton Sissons,C,NSH,31,82,13,17,30
84,8478013,Jake Walman,D,SJS,28,82,12,18,30
84,8475343,Nic Dowd,C,WSH,34,82,12,18,30
84,8482146,Luke Evangelista,R,NSH,22,82,12,18,30
84,8481704,Juuso Parssinen,C,NSH,23,82,11,19,30
84,8481522,Peyton Krebs,C,BUF,23,82,9,21,30
84,8477507,Nikita Zadorov,D,BOS,29,82,8,22,30
84,8476467,Jamie Oleksiak,D,SEA,32,82,8,22,30
84,8473563,Nicklas Backstrom,C,WSH,37,82,7,23,30
84,8477220,Nate Schmidt,D,FLA,33,82,6,24,30
84,8478500,Ivan Provorov,D,CBJ,27,82,3,27,30
84,8475718,Justin Holl,D,DET,32,82,2,28,30
84,8479661,Tanner Jeannot,L,LAK,27,82,16,13,29
84,8475149,Marcus Johansson,L,MIN,34,82,14,15,29
84,8478432,Christian Fischer,R,DET,27,82,13,16,29
84,8475760,Nick Bjugstad,C,UTA,32,82,11,18,29
84,8479353,Brett Howden,C,VGK,26,82,11,18,29
84,8475188,Brayden McNabb,D,VGK,33,82,7,22,29
84,8473507,Jeff Petry,D,DET,37,82,7,22,29
84,8482133,Thomas Bordeleau,C,SJS,22,82,6,23,29
84,8476457,Adam Larsson,D,SEA,32,82,6,23,29
84,8481517,Brett Leason,R,ANA,25,82,17,11,28
84,8476889,Radek Faksa,C,STL,30,82,9,19,28
84,8482259,Bobby McMann,C,TOR,28,82,17,10,27
84,8480748,Kiefer Sherwood,L,VAN,29,82,13,14,27
84,8479316,Luke Kunin,C,SJS,27,82,13,14,27
84,8482624,Daniil Miromanov,D,CGY,27,82,12,15,27
84,8477353,Tyler Motte,C,DET,29,82,11,16,27
84,8479368,Max Jones,L,BOS,26,82,11,16,27
84,8483490,Pavel Mintyukov,D,ANA,21,82,9,18,27
84,8482122,Brock Faber,D,MIN,22,82,8,19,27
84,8482141,Lukas Cormier,D,VGK,22,82,8,19,27
84,8482245,Artem Zub,D,OTT,29,82,6,21,27
84,8479402,Jake Bean,D,CGY,26,82,6,21,27
84,8476917,Adam Pelech,D,NYI,30,82,5,22,27
84,8478840,Will Borgen,D,SEA,28,82,3,24,27
84,8482155,Alex Laferriere,R,LAK,23,82,17,9,26
84,8477508,Curtis Lazar,C,NJD,29,82,12,14,26
84,8480855,Jack McBain,C,UTA,24,82,12,14,26
84,8484153,Leo Carlsson,C,ANA,20,82,12,14,26
84,8477015,Connor Brown,R,EDM,30,82,11,15,26
84,8479359,Beck Malenstyn,L,BUF,26,82,10,16,26
84,8478911,Matt Roy,D,WSH,29,82,9,17,26
84,8478434,Keegan Kolesar,R,VGK,27,82,8,18,26
84,8482166,Shakir Mukhamadullin,D,SJS,22,82,7,19,26
84,8481567,Henry Thrun,D,SJS,23,82,7,19,26
84,8481708,Zac Jones,D,NYR,24,82,5,21,26
84,8476931,Jake McCabe,D,TOR,31,82,3,23,26
84,8478507,John Marino,D,UTA,27,82,2,24,26
84,8477506,Ryan Pulock,D,NYI,30,82,2,24,26
84,8475842,Sam Carrick,C,NYR,32,82,12,13,25
84,8480144,David Kampf,C,TOR,29,82,8,17,25
84,8480980,Connor Dewar,C,TOR,25,82,7,18,25
84,8475233,David Savard,D,MTL,34,82,6,19,25
84,8484166,Adam Fantilli,C,CBJ,20,82,5,20,25
84,8481568,Alex Vlasic,D,CHI,23,82,5,20,25
84,8482803,Olen Zellweger,D,ANA,21,82,10,14,24
84,8476442,Matt Nieto,L,PIT,32,82,9,15,24
84,8476463,Jonas Brodin,D,MIN,31,82,7,17,24
84,8476331,Dylan DeMelo,D,WPG,31,82,6,18,24
84,8479414,Nathan Bastian,R,NJD,27,82,6,18,24
84,8480043,Timothy Liljegren,D,TOR,25,82,3,21,24
84,8476902,Esa Lindell,D,DAL,30,82,2,22,24
84,8482125,Alexander Holtz,R,VGK,22,82,15,8,23
84,8480448,Parker Kelly,L,COL,25,82,15,8,23
84,8477425,Miles Wood,L,COL,29,82,14,9,23
84,8480813,Joe Veleno,C,DET,24,82,14,9,23
84,8480025,MacKenzie Entwistle,R,FLA,25,82,13,10,23
84,8481477,Nico Sturm,C,SJS,29,82,10,13,23
84,8483763,Maksymilian Szuber,D,UTA,22,82,10,13,23
84,8476878,Zemgus Girgensons,L,TBL,30,82,10,13,23
84,8476374,Sean Kuraly,C,CBJ,31,82,9,14,23
84,8483524,Shane Wright,C,SEA,20,82,8,15,23
84,8476422,Mike Reilly,D,NYI,31,82,6,17,23
84,8474673,TJ Brodie,D,CHI,34,82,4,19,23
84,8478136,Jake Middleton,D,MIN,28,82,3,20,23
84,8479998,Mikey Anderson,D,LAK,25,82,2,21,23
84,8480878,Nils Lundkvist,D,DAL,24,82,1,22,23
84,8481481,Blake Lizotte,C,PIT,27,82,16,6,22
84,8481032,Paul Cotter,C,NJD,25,82,10,12,22
84,8481028,Martin Pospisil,C,CGY,25,82,10,12,22
84,8478508,Yakov Trenin,C,MIN,27,82,10,12,22
84,8477365,Connor Clifton,D,BUF,29,82,7,15,22
84,8482807,Ethan Del Mastro,D,CHI,21,82,7,15,22
84,8483457,Lane Hutson,D,MTL,20,82,6,16,22
84,8483468,Jiri Kulich,C,BUF,20,82,6,16,22
84,8484203,Bradly Nadeau,L,CAR,19,82,5,17,22
84,8480073,Erik Brannstrom,D,COL,25,82,4,18,22
84,8478443,Brandon Carlo,D,BOS,28,82,4,18,22
84,8477845,Trevor van Riemsdyk,D,WSH,33,82,4,18,22
84,8480035,Henri Jokiharju,D,BUF,25,82,3,19,22
84,8480789,Oliver Wahlstrom,R,NYI,24,82,11,10,21
84,8476624,Barclay Goodrow,C,SJS,31,82,7,14,21
84,8477369,Carson Soucy,D,VAN,30,82,6,15,21
84,8476480,Vladislav Namestnikov,C,WPG,32,82,5,16,21
84,8477435,Ryan Graves,D,PIT,29,82,4,17,21
84,8480049,Dylan Samberg,D,WPG,25,82,3,18,21
84,8480807,Mattias Samuelsson,D,BUF,24,82,3,18,21
84,8478399,Jonas Siegenthaler,D,NJD,27,82,3,18,21
84,8481014,Alexander Romanov,D,NYI,24,82,1,20,21
84,8482073,Braden Schneider,D,NYR,23,82,1,20,21
84,8479371,Dante Fabbro,D,NSH,26,82,1,20,21
84,8474189,Lars Eller,C,PIT,35,82,10,10,20
84,8482733,Logan Mailloux,D,MTL,31,82,10,10,20
84,8481524,Bowen Byram,D,BUF,23,82,10,10,20
84,8484149,Gavin Brindley,C,CBJ,20,82,10,10,20
84,8483499,Liam Ohgren,L,MIN,20,82,9,11,20
84,8476278,Colin Blackwell,C,DAL,31,82,8,12,20
84,8482074,Connor Zary,C,CGY,23,82,8,12,20
84,8475279,Ben Chiarot,D,DET,33,82,7,13,20
84,8483495,Simon Nemec,D,NJD,20,82,7,13,20
84,8479369,Andrew Peeke,D,BOS,26,82,6,14,20
84,8483460,David Jiricek,D,CBJ,21,82,5,15,20
84,8475455,Brenden Dillon,D,NJD,34,82,2,18,20
84,8481093,Rafael Harvey-Pinard,L,MTL,25,82,12,7,19
84,8478569,Noel Acciari,C,PIT,33,82,10,9,19
84,8475231,Casey Cizikas,C,NYI,33,82,8,11,19
84,8476858,Phillip Di Giuseppe,L,VAN,31,82,8,11,19
84,8483493,Frank Nazar,C,CHI,20,82,8,11,19
84,8476312,Josh Manson,D,COL,33,82,7,12,19
84,8480003,Jesper Boqvist,C,FLA,26,82,6,13,19
84,8479983,Mario Ferraro,D,SJS,26,82,5,14,19
84,8475324,Nick Jensen,D,OTT,34,82,5,14,19
84,8478468,Jeremy Lauzon,D,NSH,27,82,5,14,19
84,8480246,Nick Perbix,D,TBL,26,82,1,18,19
84,8478211,Dryden Hunt,L,CGY,29,82,11,7,18
84,8482659,Josh Doan,R,UTA,22,82,9,9,18
84,8478178,Darren Raddysh,D,TBL,28,82,9,9,18
84,8476469,Joel Armia,R,MTL,31,82,6,12,18
84,8483505,Matthew Poitras,C,BOS,20,82,6,12,18
84,8478859,Niko Mikkola,D,FLA,28,82,6,12,18
84,8482118,Sam Colangelo,R,ANA,23,82,4,14,18
84,8482713,Mackie Samoskevich,R,FLA,22,82,4,14,18
84,8478416,Erik Cernak,D,TBL,27,82,3,15,18
84,8479980,Nicolas Hague,D,VGK,26,82,2,16,18
84,8476967,Brett Kulak,D,EDM,30,82,2,16,18
84,8475181,Nick Leddy,D,STL,33,82,0,18,18
84,8483466,Kevin Korchinski,D,CHI,20,82,9,8,17
84,8477903,Garnet Hathaway,R,PHI,33,82,7,10,17
84,8482470,Ilya Solovyov,D,CGY,24,82,6,11,17
84,8475690,Chris Tanev,D,TOR,35,82,3,14,17
84,8474013,Ian Cole,D,UTA,35,82,3,14,17
84,8476441,Joel Edmundson,D,LAK,31,82,3,14,17
84,8480860,Kevin Bahl,D,CGY,24,82,2,15,17
84,8480879,Jacob Bernard-Docker,D,OTT,24,82,2,15,17
84,8480281,Alexey Toropchenko,R,STL,25,82,12,4,16
84,8480870,Bo Groulx,C,NYR,24,82,9,7,16
84,8484911,Collin Graf,R,SJS,22,82,8,8,16
84,8483397,Marc McLaughlin,C,BOS,25,82,7,9,16
84,8477392,Hudson Fasching,R,NYI,29,82,6,10,16
84,8473453,Trevor Lewis,C,LAK,37,82,6,10,16
84,8483565,Nick Blankenburg,D,NSH,26,82,4,12,16
84,8482666,Scott Morrow,D,CAR,22,82,4,12,16
84,8483012,Logan Morrison,C,SEA,22,82,4,12,16
84,8477499,Rasmus Ristolainen,D,PHI,30,82,3,13,16
84,8476372,Nick Seeler,D,PHI,31,82,3,13,16
84,8474574,Tyler Myers,D,VAN,34,82,2,14,16
84,8482712,Oskar Olausson,R,COL,22,82,10,5,15
84,8483445,Cutter Gauthier,L,ANA,20,82,6,9,15
84,8481699,Aku Raty,R,UTA,23,82,6,9,15
84,8482101,Danil Gushchin,L,SJS,22,82,5,10,15
84,8470600,Ryan Suter,D,STL,39,82,4,11,15
84,8480796,Martin Fehervary,D,WSH,25,82,4,11,15
84,8476473,Connor Murphy,D,CHI,31,82,4,11,15
84,8475790,Erik Gudbranson,D,CBJ,32,82,3,12,15
84,8480222,Sebastian Aho,D,PIT,28,82,2,13,15
84,8476879,Cody Ceci,D,EDM,31,82,1,14,15
84,8480950,Ilya Lyubushkin,D,DAL,30,82,1,14,15
84,8482077,Dylan Holloway,L,EDM,23,82,11,3,14
84,8481641,Joel Kiviranta,L,COL,28,82,6,8,14
84,8481605,Jackson LaCombe,D,ANA,23,82,5,9,14
84,8475462,Radko Gudas,D,ANA,34,82,3,11,14
84,8476891,Matt Grzelcyk,D,PIT,30,82,2,12,14
84,8479576,Vincent Desharnais,D,VAN,28,82,1,13,14
84,8477938,Haydn Fleury,D,WPG,28,82,5,8,13
84,8482702,Logan Stankoven,C,DAL,21,82,4,9,13
84,8476822,Luke Glendening,C,TBL,35,82,4,9,13
84,8475177,Calvin de Haan,D,COL,33,82,3,10,13
84,8476429,Scott Mayfield,D,NYI,32,82,2,11,13
84,8475762,Derek Forbort,D,VAN,32,82,2,11,13
84,8477335,Kyle Burroughs,D,LAK,29,82,2,11,13
84,8478450,Parker Wotherspoon,D,BOS,27,82,2,11,13
84,8479291,Kevin Rooney,C,CGY,31,82,7,5,12
84,8479638,Justin Brazeau,R,BOS,26,82,7,5,12
84,8483482,Tristan Luneau,D,ANA,20,82,6,6,12
84,8482070,Mitchell Chaffee,R,TBL,26,82,6,6,12
84,8482762,Simon Edvinsson,D,DET,21,82,5,7,12
84,8479442,Troy Stecher,D,EDM,30,82,4,8,12
84,8482749,Joshua Roy,R,MTL,21,82,4,8,12
84,8482145,Mavrik Bourque,C,DAL,22,82,3,9,12
84,8482809,Jackson Blake,R,CAR,21,82,3,9,12
84,8471677,Jack Johnson,D,CBJ,37,82,5,6,11
84,8480021,Jack Studnicka,C,LAK,25,82,5,6,11
84,8477406,Mattias Janmark,C,EDM,32,82,4,7,11
84,8483567,Georgii Merkulov,C,BOS,24,82,4,7,11
84,8474062,Riley Nash,C,NYR,35,82,4,7,11
84,8477505,Alexander Wennberg,C,SJS,30,82,3,8,11
84,8480172,Jan Rutta,D,SJS,34,82,3,8,11
84,8481122,Simon Benoit,D,TOR,26,82,3,8,11
84,8474090,Brendan Smith,D,DAL,35,82,2,9,11
84,8482858,Ryker Evans,D,SEA,23,82,2,9,11
84,8479324,Ryan Lindgren,D,NYR,26,82,1,10,11
84,8482153,Brendan Brisson,C,VGK,23,82,6,4,10
84,8483471,Brad Lambert,C,WPG,31,82,4,6,10
84,8480990,Declan Chisholm,D,MIN,24,82,4,6,10
84,8482679,Matt Coronato,R,CGY,22,82,6,3,9
84,8482516,Matthew Kessel,D,STL,24,82,3,6,9
84,8480834,Ty Emberson,D,SJS,24,82,2,7,9
84,8474567,Zach Bogosian,D,MIN,34,82,2,6,8
84,8482859,Zack Ostapchuk,C,OTT,21,82,2,6,8
84,8483489,Fraser Minten,C,TOR,31,82,0,8,8
84,8482787,Nikita Chibrikov,R,WPG,31,82,2,5,7
84,8474612,Travis Hamonic,D,OTT,34,82,1,6,7
84,8478874,Adam Gaudette,C,OTT,28,82,1,6,7
84,8477034,Jaycob Megna,D,FLA,32,82,1,4,5
84,8470794,Joe Pavelski,C,,40,0,0,0,0
84,8481703,Valtteri Puustinen,R,PIT,25,0,0,0,0
84,8477950,Tony DeAngelo,D,,29,0,0,0,0
84,8481577,Philip Tomasino,C,NSH,23,0,0,0,0
84,8475197,Tyson Barrie,D,,33,0,0,0,0
84,8471218,Blake Wheeler,R,,38,0,0,0,0
84,8474157,Max Pacioretty,L,,36,0,0,0,0
84,8478466,Daniel Sprong,R,VAN,27,0,0,0,0
84,8475744,Evgeny Kuznetsov,C,,32,0,0,0,0
84,8481019,David Gustafsson,C,WPG,24,0,0,0,0
84,8475906,John Klingberg,D,,32,0,0,0,0
84,8479348,Kale Clague,D,BUF,26,0,0,0,0
84,8476952,Dominic Toninato,C,WPG,30,0,0,0,0
84,8473473,Milan Lucic,L,,36,0,0,0,0
84,8474037,James van Riemsdyk,L,,35,0,0,0,0
84,8474602,Justin Schultz,D,,34,0,0,0,0
84,8482222,Alexander Barabanov,L,,30,0,0,0,0
84,8479372,Josh Mahura,D,SEA,26,0,0,0,0
84,8479982,Conor Timmins,D,TOR,26,0,0,0,0
84,8474031,Kevin Shattenkirk,D,,35,0,0,0,0
84,8480008,Adam Ruzicka,C,,25,0,0,0,0
84,8481059,Scott Perunovich,D,STL,26,0,0,0,0
84,8480884,Calen Addison,D,,24,0,0,0,0
84,8476994,Vinnie Hinostroza,C,NSH,30,0,0,0,0
84,8478452,Caleb Jones,D,LAK,27,0,0,0,0
84,8480157,Calle Rosen,D,COL,30,0,0,0,0
84,8481609,Vladislav Kolyachonok,D,UTA,23,0,0,0,0
84,8479415,Michael McLeod,C,,26,0,0,0,0
84,8476919,Chris Tierney,C,,30,0,0,0,0
84,8479639,Dylan Coghlan,D,WPG,26,0,0,0,0
84,8478146,Matthew Highmore,C,OTT,28,0,0,0,0
84,8478970,Jalen Chatfield,D,CAR,28,0,0,0,0
84,8480205,Emil Bemstrom,C,PIT,25,0,0,0,0
84,8474884,Mike Hoffman,C,,35,0,0,0,0
84,8471274,Alex Goligoski,D,,39,0,0,0,0
84,8478104,Sammy Blais,L,,28,0,0,0,0
84,8474870,Tyler Johnson,C,,34,0,0,0,0
84,8476913,Devin Shore,C,MIN,30,0,0,0,0
84,8481598,Philip Broberg,D,EDM,23,0,0,0,0
84,8480058,Pierre-Olivier Joseph,D,STL,25,0,0,0,0
84,8480891,Michael Kesselring,D,UTA,24,0,0,0,0
84,8477979,Nicolas Aube-Kubel,R,BUF,28,0,0,0,0
84,8476871,Tanner Pearson,L,,32,0,0,0,0
84,8476393,Nick Cousins,C,,31,0,0,0,0
84,8479977,Kailer Yamamoto,R,,26,0,0,0,0
84,8479543,Michael Pezzetta,L,MTL,26,0,0,0,0
84,8477018,Ben Hutton,D,VGK,31,0,0,0,0
84,8480762,Eric Robinson,L,CAR,29,0,0,0,0
84,8474034,Pat Maroon,L,CHI,36,0,0,0,0
84,8481058,Jesse Ylönen,R,,25,0,0,0,0
84,8475179,Dmitry Kulikov,D,FLA,34,0,0,0,0
84,8481527,Kaedan Korczak,D,VGK,23,0,0,0,0
84,8473449,Kyle Okposo,R,,36,0,0,0,0
84,8482192,Isaak Phillips,D,CHI,23,0,0,0,0
84,8480727,Zach Whitecloud,D,VGK,28,0,0,0,0
84,8479346,Dillon Dube,C,,26,0,0,0,0
84,8480821,Filip Zadina,R,,25,0,0,0,0
84,8480001,Urho Vaakanainen,D,ANA,25,0,0,0,0
84,8470966,Mark Giordano,D,,41,0,0,0,0
84,8480853,Liam Foudy,C,,24,0,0,0,0
84,8475225,Craig Smith,C,CHI,35,0,0,0,0
84,8479972,Mason Shaw,C,WPG,26,0,0,0,0
84,8478451,Ethan Bear,D,WSH,27,0,0,0,0
84,8474040,Sam Gagner,C,,35,0,0,0,0
84,8480196,Jacob Bryson,D,BUF,27,0,0,0,0
84,8479984,Cal Foote,D,,26,0,0,0,0
84,8480011,Klim Kostin,C,SJS,25,0,0,0,0
84,8482176,Wyatt Kaiser,D,CHI,22,0,0,0,0
84,8476988,Matt Benning,D,SJS,30,0,0,0,0
84,8479370,Tyson Jost,C,CAR,26,0,0,0,0
84,8477464,Nic Petan,C,,29,0,0,0,0
84,8477380,Jonny Brodzinski,C,NYR,31,0,0,0,0
84,8480070,Ian Mitchell,D,BOS,25,0,0,0,0
84,8479315,Joey Anderson,R,CHI,26,0,0,0,0
84,8478099,Kevin Labanc,R,,29,0,0,0,0
84,8476874,Olli Maatta,D,DET,30,0,0,0,0
84,8475208,Brian Dumoulin,D,ANA,33,0,0,0,0
84,8478430,Oliver Kylington,D,,27,0,0,0,0
84,8479536,Axel Jonsson-Fjallby,L,WPG,26,0,0,0,0
84,8479671,Mathieu Olivier,R,CBJ,27,0,0,0,0
84,8471709,Marc-Edouard Vlasic,D,SJS,37,0,0,0,0
84,8479328,Julien Gauthier,R,NYI,27,0,0,0,0
84,8478421,A.J. Greer,L,FLA,28,0,0,0,0
84,8477573,Nathan Walker,L,STL,30,0,0,0,0
84,8481537,Nikita Okhotiuk,D,CGY,24,0,0,0,0
84,8474166,Alec Martinez,D,CHI,37,0,0,0,0
84,8470610,Zach Parise,L,,40,0,0,0,0
84,8477478,William Carrier,L,CAR,30,0,0,0,0
84,8479344,Jesse Puljujarvi,R,PIT,26,0,0,0,0
84,8480887,Jordan Harris,D,MTL,24,0,0,0,0
84,8478502,Dennis Gilbert,D,BUF,28,0,0,0,0
84,8482730,Brandt Clarke,D,LAK,21,0,0,0,0
84,8480355,Mark Kastelic,C,BOS,25,0,0,0,0
84,8475750,Jon Merrill,D,MIN,32,0,0,0,0
84,8475164,Jakob Silfverberg,R,,34,0,0,0,0
84,8477944,Jakub Vrana,L,,28,0,0,0,0
84,8479439,Jacob MacDonald,D,COL,31,0,0,0,0
84,8474568,Luke Schenn,D,NSH,35,0,0,0,0
84,8478454,Noah Juulsen,D,VAN,27,0,0,0,0
84,8475752,Tyler Pitlick,C,,33,0,0,0,0
84,8482148,Hendrix Lapierre,C,WSH,22,0,0,0,0
84,8481167,Brayden Pachal,D,CGY,25,0,0,0,0
84,8478043,Sam Lafferty,C,BUF,29,0,0,0,0
84,8479321,Lucas Johansen,D,,27,0,0,0,0
84,8471699,Andrew Cogliano,C,,37,0,0,0,0
84,8481521,Ronnie Attard,D,PHI,25,0,0,0,0
84,8481161,Jake Christiansen,D,CBJ,25,0,0,0,0
84,8479458,Nikita Zaitsev,D,,33,0,0,0,0
84,8479619,Michael Carcone,L,UTA,28,0,0,0,0
84,8479026,Philippe Myers,D,TOR,27,0,0,0,0
84,8477330,Dominik Kubalik,L,,29,0,0,0,0
84,8481617,Vasily Podkolzin,R,VAN,23,0,0,0,0
84,8481701,Santeri Hatakka,D,NJD,23,0,0,0,0
84,8479514,Rem Pitlick,C,,27,0,0,0,0
84,8477446,Michael McCarron,R,NSH,29,0,0,0,0
84,8470604,Jeff Carter,C,,39,0,0,0,0
84,8482241,Radim Zohorna,L,,28,0,0,0,0
84,8480289,Morgan Barron,C,WPG,26,0,0,0,0
84,8479379,Givani Smith,R,SJS,26,0,0,0,0
84,8480216,Jacob Peterson,C,,25,0,0,0,0
84,8477851,Jordan Oesterle,D,BOS,32,0,0,0,0
84,8484258,Sam Malinski,D,COL,26,0,0,0,0
84,8478904,Steven Lorentz,C,,28,0,0,0,0
84,8482095,Tyler Kleven,D,OTT,22,0,0,0,0
84,8480848,Ty Dellandrea,C,SJS,24,0,0,0,0
84,8476884,Derrick Pouliot,D,,30,0,0,0,0
84,8479336,Carl Grundstrom,R,SJS,27,0,0,0,0
84,8482964,Arber Xhekaj,D,MTL,23,0,0,0,0
84,8471686,Marc Staal,D,,37,0,0,0,0
84,8477887,Patrick Brown,C,BOS,32,0,0,0,0
84,8478495,Denis Gurianov,R,,27,0,0,0,0
84,8473504,Cal Clutterbuck,R,,37,0,0,0,0
84,8481550,Adam Beckman,L,NJD,23,0,0,0,0
84,8480845,Rasmus Kupari,C,WPG,24,0,0,0,0
84,8474009,Nick Bonino,C,,36,0,0,0,0
84,8478585,Derek Ryan,C,EDM,38,0,0,0,0
84,8477962,Brendan Lemieux,L,CAR,28,0,0,0,0
84,8482861,Vincent Iorio,D,WSH,22,0,0,0,0
84,8479378,Logan Stanley,D,WPG,26,0,0,0,0
84,8473446,Erik Johnson,D,PHI,36,0,0,0,0
84,8481743,Marc Del Gaizo,D,NSH,25,0,0,0,0
84,8477384,Josh Brown,D,EDM,30,0,0,0,0
84,8482165,Yan Kuznetsov,D,CGY,22,0,0,0,0
84,8478424,Jansen Harkins,C,ANA,27,0,0,0,0
84,8482144,Jack Thompson,D,SJS,22,0,0,0,0
84,8478512,Austin Czarnik,C,,32,0,0,0,0
84,8477527,Ross Johnston,L,ANA,30,0,0,0,0
84,8479383,Boris Katchouk,L,,26,0,0,0,0
84,8482094,Daemon Hunt,D,MIN,22,0,0,0,0
84,8481719,Maxwell Crozier,D,TBL,24,0,0,0,0
84,8480192,Johnathan Kovacevic,D,NJD,27,0,0,0,0
84,8479376,Victor Mete,D,,26,0,0,0,0
84,8482511,Mason Lohrei,D,BOS,23,0,0,0,0
84,8475825,Jani Hakanpää,D,,32,0,0,0,0
84,8478021,William Lagesson,D,DET,28,0,0,0,0
84,8475795,Dylan McIlrath,D,WSH,32,0,0,0,0
84,8477846,Ryan Carpenter,C,,33,0,0,0,0
84,8481056,Spencer Stastney,D,NSH,24,0,0,0,0
84,8481564,Ryan Johnson,D,BUF,23,0,0,0,0
84,8478017,Mark Friedman,D,VAN,29,0,0,0,0
84,8479320,Max Lajoie,D,SEA,27,0,0,0,0
84,8480075,Cameron Crotty,D,MIN,25,0,0,0,0
84,8484287,Cole McWard,D,VAN,23,0,0,0,0
84,8484254,Akito Hirose,D,VAN,25,0,0,0,0
84,8483407,Brandon Scanlin,D,NYR,25,0,0,0,0
84,8480274,Philip Kemp,D,EDM,25,0,0,0,0
84,8479522,Hardy Haman Aktell,D,WSH,26,0,0,0,0
84,8480007,Jonas Rondbjerg,R,VGK,25,0,0,0,0
84,8477454,Adam Erne,L,,29,0,0,0,0
84,8481679,Maxence Guenette,D,OTT,23,0,0,0,0
84,8480441,Trey Fix-Wolansky,R,CBJ,25,0,0,0,0
84,8483546,Marshall Rifai,D,TOR,26,0,0,0,0
84,8480084,Nick DeSimone,D,NJD,30,0,0,0,0
84,8481030,Jack St. Ivany,D,PIT,25,0,0,0,0
84,8481592,Jakob Pelletier,L,CGY,23,0,0,0,0
84,8478011,Louie Belpedio,D,PHI,28,0,0,0,0
84,8477930,Pierre-Edouard Bellemare,L,,39,0,0,0,0
84,8484321,Nikolas Matinpalo,D,OTT,26,0,0,0,0
84,8482067,Connor Mackey,D,NYR,28,0,0,0,0
84,8481806,Louis Crevier,D,CHI,23,0,0,0,0
84,8484326,Patrik Koch,D,UTA,28,0,0,0,0
84,8477971,Andreas Englund,D,LAK,28,0,0,0,0
84,8481751,Lukas Rousek,R,BUF,25,0,0,0,0
84,8481006,Tyler Tucker,D,STL,24,0,0,0,0
84,8476867,Brendan Gaunce,C,MIN,30,0,0,0,0
84,8479520,Brandon Duhaime,R,WSH,27,0,0,0,0
84,8477073,Kurtis MacDermid,L,NJD,30,0,0,0,0
84,8480874,Adam Ginning,D,PHI,24,0,0,0,0
84,8477473,Justin Bailey,R,SJS,29,0,0,0,0
84,8479066,Ryan Lomberg,L,CGY,30,0,0,0,0
84,8477070,Liam O'Brien,C,UTA,30,0,0,0,0
84,8474618,Marco Scandella,D,,34,0,0,0,0
84,8475797,Jarred Tinordi,D,,32,0,0,0,0
84,8481441,Joe Snively,C,DET,28,0,0,0,0
84,8477244,Chad Ruhwedel,D,NYR,34,0,0,0,0
84,8479772,Zack MacEwen,R,OTT,28,0,0,0,0
84,8481147,Reese Johnson,C,MIN,26,0,0,0,0
84,8481043,Cole Koepke,L,BOS,26,0,0,0,0
84,8483619,Filip Roos,D,OTT,25,0,0,0,0
84,8481541,Samuel Bolduc,D,NYI,24,0,0,0,0
84,8477810,Joel Hanley,D,CGY,33,0,0,0,0
84,8476907,Mackenzie MacEachern,L,,30,0,0,0,0
84,8482652,Walker Duehr,R,CGY,27,0,0,0,0
84,8477126,Jayson Megna,C,,34,0,0,0,0
84,8483398,Declan Carlile,D,TBL,31,0,0,0,0
84,8482929,Emil Lilleberg,D,TBL,23,0,0,0,0
84,8480880,Jakub Lauko,C,MIN,24,0,0,0,0
84,8480245,Olle Lycksell,R,PHI,25,0,0,0,0
84,8480252,Cole Guttman,C,CHI,25,0,0,0,0
84,8477467,Gustav Olofsson,D,SEA,30,0,0,0,0
84,8479968,Vinni Lettieri,C,BOS,29,0,0,0,0
84,8478400,Colin White,C,,27,0,0,0,0
84,8475755,Alexander Petrovic,D,DAL,32,0,0,0,0
84,8481812,Nikolai Knyzhov,D,,27,0,0,0,0
84,8481593,Jayden Struble,D,MTL,23,0,0,0,0
84,8481532,Alex Turcotte,C,LAK,23,0,0,0,0
84,8482126,Emil Andrae,D,PHI,31,0,0,0,0
84,8479944,Zach Aston-Reese,C,VGK,30,0,0,0,0
84,8471817,Ryan Reaves,R,TOR,37,0,0,0,0
84,8481206,John Ludvig,D,PIT,24,0,0,0,0
84,8481599,Victor Soderstrom,D,UTA,23,0,0,0,0
84,8480292,Carson Meyer,R,ANA,27,0,0,0,0
84,8482496,Nils Aman,C,VAN,24,0,0,0,0
84,8479718,Alex Barré-Boulet,C,MTL,27,0,0,0,0
84,8479994,Jaret Anderson-Dolan,C,WPG,25,0,0,0,0
84,8480184,Gustav Lindstrom,D,,26,0,0,0,0
84,8480890,Jan Jenik,R,OTT,24,0,0,0,0
84,8478067,Oskar Lindblom,L,,28,0,0,0,0
84,8476934,Brock McGinn,L,ANA,30,0,0,0,0
84,8479985,Cale Fleury,D,SEA,26,0,0,0,0
84,8484304,Uvis Balinskis,D,FLA,28,0,0,0,0
84,8479981,Jonah Gadjovich,L,FLA,26,0,0,0,0
84,8481716,Dmitri Voronkov,L,CBJ,24,0,0,0,0
84,8474709,Matt Martin,L,,35,0,0,0,0
84,8482634,Alex Steeves,C,TOR,25,0,0,0,0
84,8480823,Alexander Alexeyev,D,WSH,25,0,0,0,0
84,8477541,Dakota Mermis,D,TOR,30,0,0,0,0
84,8483491,Ivan Miroshnichenko,L,WSH,20,0,0,0,0
84,8478477,Mitchell Stephens,C,SEA,27,0,0,0,0
84,8481543,Nikita Alexandrov,C,STL,24,0,0,0,0
84,8479423,Alex Nylander,L,,26,0,0,0,0
84,8482451,Mikael Pyyhtia,L,CBJ,23,0,0,0,0
84,8478831,Kevin Stenlund,C,UTA,28,0,0,0,0
84,8480306,Grant Hutton,D,NYI,29,0,0,0,0
84,8478028,Fredrik Olofsson,L,,28,0,0,0,0
84,8477462,Robert Hagg,D,VGK,29,0,0,0,0
84,8477320,Anton Blidh,L,NYR,29,0,0,0,0
84,8482157,Will Cuylle,L,NYR,22,0,0,0,0
84,8482737,Zack Bolduc,C,STL,21,0,0,0,0
84,8481239,Samuel Fagemo,L,,24,0,0,0,0
84,8481600,Tobias Bjornfot,D,FLA,23,0,0,0,0
84,8478409,Anthony Richard,C,PHI,28,0,0,0,0
84,8474145,Robert Bortuzzo,D,,35,0,0,0,0
84,8475958,Michael Sgarbossa,C,WSH,32,0,0,0,0
84,8479986,Kole Lind,R,DAL,26,0,0,0,0
84,8479249,Andrew Poturalski,C,SJS,30,0,0,0,0
84,8479362,Riley Tufte,L,BOS,26,0,0,0,0
84,8479991,Jake Leschyshyn,C,NYR,25,0,0,0,0
84,8479587,Rhett Gardner,C,PHI,28,0,0,0,0
84,8482744,James Malatesta,L,CBJ,21,0,0,0,0
84,8478854,Ryan Shea,D,PIT,27,0,0,0,0
84,8481591,Sam Poulin,R,,23,0,0,0,0
84,8483512,Matt Savoie,C,EDM,20,0,0,0,0
84,8482102,Vasily Ponomarev,C,PIT,22,0,0,0,0
84,8482162,Roby Jarventie,L,EDM,22,0,0,0,0
84,8481016,Ruslan Iskhakov,C,,24,0,0,0,0
84,8482172,Landon Slaggert,L,CHI,22,0,0,0,0
84,8482747,Brennan Othmann,L,NYR,21,0,0,0,0
84,8480031,Maxime Comtois,L,,25,0,0,0,0
84,8480226,Marián Studenic,R,,26,0,0,0,0
84,8478408,Travis Dermott,D,,28,0,0,0,0
84,8481518,Nolan Foote,L,NJD,24,0,0,0,0
84,8479419,Brett Murray,L,BUF,26,0,0,0,0
84,8482088,Justin Sourdif,R,FLA,22,0,0,0,0
84,8482201,Gage Goncalves,C,TBL,23,0,0,0,0
84,8481578,Graeme Clarke,R,MIN,23,0,0,0,0
84,8482177,Marat Khusnutdinov,C,MIN,22,0,0,0,0
84,8481754,Nikita Nesterenko,C,ANA,23,0,0,0,0
84,8483531,Brian Halonen,L,NJD,25,0,0,0,0
84,8483920,Pierrick Dube,R,WSH,23,0,0,0,0
84,8480851,Akil Thomas,C,LAK,24,0,0,0,0
84,8475235,Nicolas Deslauriers,L,PHI,33,0,0,0,0
84,8482476,Emil Heineman,L,MTL,23,0,0,0,0
84,8477149,Scott Sabourin,R,SJS,32,0,0,0,0
84,8483549,Lucas Condotta,L,MTL,27,0,0,0,0
84,8482765,Isak Rosen,R,BUF,21,0,0,0,0
84,8481237,Kyle MacLean,C,NYI,25,0,0,0,0
84,8481024,Linus Karlsson,C,VAN,25,0,0,0,0
84,8481690,Tyler Angle,C,,24,0,0,0,0
84,8483570,Ben Meyers,C,SEA,26,0,0,0,0
84,8481655,Cole Schwindt,R,CGY,23,0,0,0,0
84,8481462,Mason Morelli,L,VGK,28,0,0,0,0
84,8483401,Marc Johnstone,R,PIT,28,0,0,0,0
84,8478956,Samuel Laberge,L,NJD,27,0,0,0,0
84,8479533,Joona Koppanen,L,,26,0,0,0,0
84,8482197,Adam Raska,R,MIN,23,0,0,0,0
84,8482250,Callahan Burke,C,VGK,27,0,0,0,0
84,8482784,Zach Dean,C,STL,21,0,0,0,0
84,8484255,Jason Polin,R,COL,25,0,0,0,0
84,8481077,John Leonard,L,,26,0,0,0,0
84,8481534,Raphael Lavoie,C,EDM,24,0,0,0,0
84,8483609,Adam Klapka,R,CGY,24,0,0,0,0
84,8482751,Ryan Winterton,C,SEA,21,0,0,0,0
84,8480267,Sammy Walker,C,MIN,25,0,0,0,0
84,8475766,Austin Watson,L,,32,0,0,0,0
84,8482460,Matt Rempe,C,NYR,22,0,0,0,0
84,8481065,Angus Crookshank,L,OTT,25,0,0,0,0
84,8481070,Hugh McGing,L,,26,0,0,0,0
84,8476323,Max McCormick,L,SEA,32,0,0,0,0
84,8483395,Arshdeep Bains,L,VAN,23,0,0,0,0
84,8484259,Ondrej Pavel,C,COL,31,0,0,0,0
84,8483432,Luca Del Bel Belluz,C,CBJ,31,0,0,0,0
84,8483045,Cameron Butler,R,CBJ,31,0,0,0,0
84,8482061,Brandon Biro,L,SEA,26,0,0,0,0
84,8477401,John Hayden,C,SEA,29,0,0,0,0
84,8475278,Byron Froese,C,,33,0,0,0,0
84,8478446,Glenn Gawdin,C,LAK,27,0,0,0,0
84,8477993,Justin Kirkland,C,CGY,28,0,0,0,0
84,8482147,Jean-Luc Foudy,C,COL,22,0,0,0,0
84,8480032,Shane Bowers,C,NJD,25,0,0,0,0
84,8479330,Brandon Gignac,C,MTL,27,0,0,0,0
84,8480776,Sheldon Rempal,R,,29,0,0,0,0
84,8475413,Justin Dowling,C,NJD,34,0,0,0,0
84,8481726,Adam Edstrom,C,NYR,24,0,0,0,0
84,8480844,Grigori Denisenko,L,VGK,24,0,0,0,0
84,8478147,Bokondji Imama,L,PIT,28,0,0,0,0
84,8478881,Brett Seney,L,CHI,28,0,0,0,0
84,8483630,Pavol Regenda,L,ANA,25,0,0,0,0
84,8480836,Jonathan Gruden,C,,24,0,0,0,0
84,8484314,Jiri Smejkal,L,,28,0,0,0,0
84,8475780,Chris Wagner,R,COL,33,0,0,0,0
84,8479546,Oskar Steen,C,,26,0,0,0,0
84,8483597,Milos Kelemen,L,UTA,25,0,0,0,0
84,8481789,Tye Kartye,L,SEA,23,0,0,0,0
84,8484325,Waltteri Merela,C,TBL,26,0,0,0,0
84,8479421,Jacob Moverare,D,LAK,26,0,0,0,0
84,8481585,Egor Afanasyev,L,SJS,23,0,0,0,0
84,8479547,Matthew Phillips,R,,26,0,0,0,0
84,8479367,William Lockwood,R,FLA,26,0,0,0,0
84,8476915,Jujhar Khaira,L,,30,0,0,0,0
84,8481422,Jacob Lucchini,C,NSH,29,0,0,0,0
84,8480468,James Hamblin,L,EDM,25,0,0,0,0
84,8478051,Max Willman,C,NJD,29,0,0,0,0
84,8481556,John Beecher,C,BOS,23,0,0,0,0
84,8478078,Rourke Chartier,C,,28,0,0,0,0
85,8476453,Nikita Kucherov,R,TBL,31,82,50,96,146
85,8478402,Connor McDavid,C,EDM,27,82,39,95,134
85,8477956,David Pastrnak,R,BOS,28,82,68,61,129
85,8478864,Kirill Kaprizov,L,MIN,27,82,55,71,126
85,8477492,Nathan MacKinnon,C,COL,29,82,55,70,125
85,8479318,Auston Matthews,C,TOR,27,82,63,60,123
85,8477939,William Nylander,R,TOR,28,82,55,58,113
85,8481559,Jack Hughes,C,NJD,23,82,40,69,109
85,8477933,Sam Reinhart,C,FLA,29,82,45,62,107
85,8471675,Sidney Crosby,C,PIT,37,82,44,63,107
85,8480023,Robert Thomas,C,STL,25,82,34,70,104
85,8479314,Matthew Tkachuk,L,FLA,27,82,37,64,101
85,8477934,Leon Draisaitl,C,EDM,29,82,39,60,99
85,8478550,Artemi Panarin,L,NYR,33,82,33,66,99
85,8476887,Filip Forsberg,L,NSH,30,82,40,57,97
85,8480002,Nico Hischier,C,NJD,25,82,35,60,95
85,8477493,Aleksander Barkov,C,FLA,29,82,32,63,95
85,8482116,Tim Stützle,C,OTT,22,82,38,56,94
85,8476468,J.T. Miller,C,VAN,31,82,31,62,93
85,8480027,Jason Robertson,L,DAL,25,82,36,54,90
85,8476454,Ryan Nugent-Hopkins,C,EDM,31,82,22,68,90
85,8479343,Clayton Keller,R,UTA,26,82,38,51,89
85,8475172,Nazem Kadri,C,CGY,34,82,32,57,89
85,8478420,Mikko Rantanen,R,COL,28,82,37,51,88
85,8481523,Kirby Dach,C,MTL,23,82,22,66,88
85,8479420,Tage Thompson,C,BUF,27,82,44,43,87
85,8478427,Sebastian Aho,C,CAR,27,82,33,54,87
85,8477940,Nikolaj Ehlers,L,WPG,28,82,30,57,87
85,8481557,Matt Boldy,L,MIN,23,82,39,47,86
85,8480012,Elias Pettersson,C,VAN,26,82,29,57,86
85,8480069,Cale Makar,D,COL,26,82,22,63,85
85,8480800,Quinn Hughes,D,VAN,25,82,12,73,85
85,8476460,Mark Scheifele,C,WPG,31,82,36,48,84
85,8480830,Andrei Svechnikov,R,CAR,24,82,33,51,84
85,8478398,Kyle Connor,L,WPG,28,82,42,41,83
85,8474564,Steven Stamkos,C,NSH,34,82,32,51,83
85,8477949,Alex Tuch,R,BUF,28,82,28,55,83
85,8478403,Jack Eichel,C,VGK,28,82,35,47,82
85,8480801,Brady Tkachuk,L,OTT,25,82,34,48,82
85,8477504,Josh Morrissey,D,WPG,29,82,18,64,82
85,8477404,Jake Guentzel,C,TBL,30,82,32,49,81
85,8480208,Drake Batherson,R,OTT,26,82,30,51,81
85,8479407,Jesper Bratt,L,NJD,26,82,29,52,81
85,8479323,Adam Fox,D,NYR,26,82,17,64,81
85,8477955,Jared McCann,L,SEA,28,82,41,39,80
85,8476456,Jonathan Huberdeau,C,CGY,31,82,22,58,80
85,8477942,Kevin Fiala,L,LAK,28,82,29,49,78
85,8477409,Carter Verhaeghe,C,FLA,29,82,41,36,77
85,8476459,Mika Zibanejad,C,NYR,31,82,35,41,76
85,8478449,Roope Hintz,C,DAL,28,82,33,43,76
85,8479385,Jordan Kyrou,C,STL,26,82,31,45,76
85,8480036,Miro Heiskanen,D,DAL,25,82,14,62,76
85,8481068,Yegor Sharangovich,C,CGY,26,82,43,32,75
85,8477500,Bo Horvat,C,NYI,29,82,38,37,75
85,8477946,Dylan Larkin,C,DET,28,82,34,41,75
85,8471724,Kris Letang,D,PIT,37,82,17,58,75
85,8480018,Nick Suzuki,C,MTL,25,82,16,59,75
85,8478010,Brayden Point,C,TBL,28,82,35,39,74
85,8478873,Troy Terry,R,ANA,27,82,34,40,74
85,8482093,Seth Jarvis,C,CAR,22,82,34,40,74
85,8475913,Mark Stone,R,VGK,32,82,27,47,74
85,8475810,Bryan Rust,R,PIT,32,82,37,36,73
85,8478439,Travis Konecny,R,PHI,27,82,26,47,73
85,8478444,Brock Boeser,R,VAN,27,82,26,47,73
85,8475168,Matt Duchene,C,DAL,33,82,22,51,73
85,8471214,Alex Ovechkin,L,WSH,39,82,37,35,72
85,8478414,Timo Meier,R,NJD,28,82,34,38,72
85,8481528,Dylan Cozens,C,BUF,23,82,24,48,72
85,8475158,Ryan O'Reilly,C,NSH,33,82,22,50,72
85,8476346,Johnny Gaudreau,L,CBJ,31,82,17,55,72
85,8475784,Jeff Skinner,C,EDM,32,82,37,34,71
85,8481540,Cole Caufield,R,MTL,23,82,34,37,71
85,8482745,Mason McTavish,C,ANA,21,82,28,43,71
85,8477416,Oliver Bjorkstrand,R,SEA,29,82,25,46,71
85,8476881,Tomas Hertl,C,VGK,31,82,23,48,71
85,8474600,Roman Josi,D,NSH,34,82,23,48,71
85,8478440,Dylan Strome,C,WSH,27,82,31,39,70
85,8477960,Adrian Kempe,R,LAK,28,82,30,40,70
85,8476389,Vincent Trocheck,C,NYR,31,82,27,43,70
85,8477447,Shea Theodore,D,VGK,29,82,19,51,70
85,8479339,Patrik Laine,L,CBJ,26,82,28,41,69
85,8483808,Andrei Kuzmenko,L,CGY,28,82,28,41,69
85,8475166,John Tavares,C,TOR,34,82,26,43,69
85,8478396,Noah Hanifin,D,VGK,27,82,24,45,69
85,8475798,Mikael Granlund,C,SJS,32,82,17,52,69
85,8474578,Erik Karlsson,D,PIT,34,82,13,56,69
85,8479542,Brandon Hagel,L,TBL,26,82,36,32,68
85,8473986,Alex Killorn,L,ANA,35,82,32,36,68
85,8477402,Pavel Buchnevich,L,STL,29,82,27,41,68
85,8477951,Nick Schmaltz,C,UTA,28,82,24,44,68
85,8476905,Chandler Stephenson,C,SEA,30,82,19,49,68
85,8480839,Rasmus Dahlin,D,BUF,24,82,17,51,68
85,8477501,Valeri Nichushkin,R,COL,29,82,31,36,67
85,8476853,Morgan Rielly,D,TOR,30,82,7,60,67
85,8478856,Conor Garland,R,VAN,28,82,25,41,66
85,8474565,Alex Pietrangelo,D,VGK,34,82,20,46,66
85,8477986,Brandon Montour,D,SEA,30,82,16,50,66
85,8479425,Filip Hronek,D,VAN,27,82,13,53,66
85,8476483,Rickard Rakell,R,PIT,31,82,32,33,65
85,8478047,Michael Bunting,L,PIT,29,82,24,41,65
85,8473419,Brad Marchand,L,BOS,36,82,22,43,65
85,8471215,Evgeni Malkin,C,PIT,38,82,22,43,65
85,8475692,Mats Zuccarello,R,MIN,37,82,19,46,65
85,8476875,Mike Matheson,D,MTL,30,82,18,47,65
85,8482665,Matty Beniers,C,SEA,22,82,32,32,64
85,8475786,Zach Hyman,L,EDM,32,82,32,32,64
85,8478401,Pavel Zacha,C,BOS,27,82,30,34,64
85,8478042,Viktor Arvidsson,R,EDM,31,82,28,36,64
85,8476462,Dougie Hamilton,D,NJD,31,82,21,43,64
85,8480015,Owen Tippett,R,PHI,25,82,35,28,63
85,8474141,Patrick Kane,R,DET,36,82,27,36,63
85,8478407,Vince Dunn,D,SEA,28,82,17,46,63
85,8482097,Jack Quinn,R,BUF,23,82,29,33,62
85,8478975,Mason Marchment,L,DAL,29,82,26,36,62
85,8481533,Trevor Zegras,C,ANA,23,82,24,38,62
85,8471685,Anze Kopitar,C,LAK,37,82,20,42,62
85,8478445,Mathew Barzal,C,NYI,27,82,19,43,62
85,8475167,Victor Hedman,D,TBL,34,82,11,51,62
85,8475754,Brock Nelson,C,NYI,33,82,28,33,61
85,8477476,Artturi Lehkonen,L,COL,29,82,26,35,61
85,8474586,Jordan Eberle,R,SEA,34,82,25,36,61
85,8478493,Joel Eriksson Ek,C,MIN,27,82,24,37,61
85,8482684,Luke Hughes,D,NJD,21,82,20,41,61
85,8475765,Vladimir Tarasenko,R,DET,33,82,30,30,60
85,8482078,Lucas Raymond,L,DET,22,82,26,34,60
85,8477496,Elias Lindholm,C,BOS,30,82,24,36,60
85,8474590,John Carlson,D,WSH,34,82,11,49,60
85,8480188,Fabian Zetterlund,L,SJS,25,82,27,32,59
85,8473512,Claude Giroux,R,OTT,36,82,24,35,59
85,8479400,Pierre-Luc Dubois,L,WSH,26,82,23,36,59
85,8475768,Jaden Schwartz,C,SEA,32,82,34,24,58
85,8476432,Boone Jenner,C,CBJ,31,82,30,28,58
85,8479345,Jakob Chychrun,D,WSH,26,82,21,37,58
85,8479410,Mikhail Sergachev,D,UTA,26,82,15,43,58
85,8476792,Torey Krug,D,STL,33,82,14,44,58
85,8477021,Alex Kerfoot,C,UTA,30,82,9,49,58
85,8479337,Alex DeBrincat,R,DET,27,82,32,25,57
85,8475794,Tyler Seguin,C,DAL,32,82,29,28,57
85,8478233,Andrew Mangiapane,L,WSH,28,82,25,32,57
85,8474150,Mikael Backlund,C,CGY,35,82,24,33,57
85,8477503,Max Domi,C,TOR,29,82,20,37,57
85,8473994,Jamie Benn,L,DAL,35,82,20,37,57
85,8475753,Justin Faulk,D,STL,32,82,15,42,57
85,8480865,Noah Dobson,D,NYI,24,82,11,46,57
85,8477407,Anthony Duclair,L,NYI,29,82,25,31,56
85,8474679,Gustav Nyquist,C,NSH,35,82,21,35,56
85,8475191,Reilly Smith,R,NYR,33,82,21,35,56
85,8475745,Charlie Coyle,C,BOS,32,82,21,35,56
85,8478438,Tommy Novak,C,NSH,27,82,16,40,56
85,8480014,Gabriel Vilardi,C,WPG,25,82,31,24,55
85,8476399,Blake Coleman,C,CGY,33,82,31,24,55
85,8482740,Wyatt Johnston,C,DAL,21,82,27,28,55
85,8480064,Josh Norris,C,OTT,25,82,27,28,55
85,8477346,MacKenzie Weegar,D,CGY,30,82,11,44,55
85,8476539,Jonathan Marchessault,R,NSH,34,82,29,25,54
85,8478462,Nicolas Roy,C,VGK,27,82,22,32,54
85,8480803,Evan Bouchard,D,EDM,25,82,15,39,54
85,8479999,Casey Mittelstadt,C,COL,26,82,13,41,54
85,8482699,Dylan Guenther,R,UTA,21,82,30,23,53
85,8477497,Sean Monahan,C,CBJ,30,82,22,31,53
85,8475726,Tyler Toffoli,C,SJS,32,82,20,33,53
85,8480798,Philipp Kurashev,C,CHI,25,82,20,33,53
85,8479675,Trevor Moore,L,LAK,29,82,18,35,53
85,8478498,Jake DeBrusk,L,VAN,28,82,35,17,52
85,8478366,Frank Vatrano,R,ANA,30,82,27,25,52
85,8482720,Matthew Knies,L,TOR,22,82,19,33,52
85,8480028,Morgan Frost,C,PHI,25,82,18,34,52
85,8480797,Joel Farabee,L,PHI,24,82,17,35,52
85,8480434,Sean Durzi,D,UTA,26,82,16,36,52
85,8477494,Jonathan Drouin,L,COL,29,82,15,37,52
85,8476458,Ryan Strome,C,ANA,31,82,15,37,52
85,8474102,David Perron,L,OTT,36,82,13,39,52
85,8481711,Matias Maccelli,L,UTA,24,82,11,41,52
85,8482475,Yegor Chinakhov,R,CBJ,23,82,28,23,51
85,8475184,Chris Kreider,L,NYR,33,82,27,24,51
85,8471698,T.J. Oshie,R,WSH,38,82,26,25,51
85,8475763,Kevin Hayes,R,PIT,32,82,25,26,51
85,8482109,Alexis Lafrenière,L,NYR,23,82,23,28,51
85,8475314,Anders Lee,L,NYI,34,82,23,28,51
85,8481618,Alex Newhook,C,MTL,23,82,22,29,51
85,8475170,Brayden Schenn,C,STL,33,82,21,30,51
85,8478469,Thomas Chabot,D,OTT,27,82,15,36,51
85,8482159,Tyson Foerster,R,PHI,22,82,26,24,50
85,8480039,Martin Necas,C,CAR,25,82,25,25,50
85,8477511,Anthony Mantha,R,CGY,30,82,25,25,50
85,8476882,Teuvo Teravainen,L,CHI,30,82,21,29,50
85,8481596,Shane Pinto,C,OTT,24,82,21,29,50
85,8477429,Andrew Copp,C,DET,30,82,12,38,50
85,8482146,Luke Evangelista,R,NSH,22,82,25,24,49
85,8478115,Pierre Engvall,L,NYI,28,82,24,25,49
85,8478474,Lawson Crouse,L,UTA,27,82,20,29,49
85,8476448,William Karlsson,C,VGK,31,82,18,31,49
85,8478460,Zach Werenski,D,CBJ,27,82,15,34,49
85,8478542,Evan Rodrigues,C,FLA,31,82,15,34,49
85,8474563,Drew Doughty,D,LAK,35,82,14,35,49
85,8477948,Travis Sanheim,D,PHI,28,82,8,41,49
85,8479525,Ross Colton,C,COL,28,82,26,22,48
85,8482110,Dawson Mercer,C,NJD,23,82,25,23,48
85,8480220,Noah Cates,L,PHI,25,82,23,25,48
85,8478463,Anthony Beauvillier,L,PIT,27,82,22,26,48
85,8476880,Tom Wilson,R,WSH,30,82,21,27,48
85,8475287,Erik Haula,L,NJD,33,82,19,29,48
85,8477444,Andre Burakovsky,L,SEA,29,82,16,32,48
85,8476479,Phillip Danault,C,LAK,31,82,13,35,48
85,8476854,Hampus Lindholm,D,BOS,30,82,10,38,48
85,8478397,Rasmus Andersson,D,CGY,28,82,8,40,48
85,8477479,Tyler Bertuzzi,L,CHI,29,82,23,24,47
85,8478046,Danton Heinen,L,VAN,29,82,22,25,47
85,8477935,Sam Bennett,C,FLA,28,82,21,26,47
85,8476826,Yanni Gourde,C,SEA,33,82,19,28,47
85,8482124,Quinton Byfield,R,LAK,22,82,17,30,47
85,8475791,Taylor Hall,L,CHI,33,82,15,32,47
85,8474053,Logan Couture,C,SJS,35,82,24,22,46
85,8480113,Alex Iafallo,L,WPG,31,82,24,22,46
85,8482175,JJ Peterka,R,BUF,22,82,23,23,46
85,8480185,Eetu Luostarinen,C,FLA,26,82,19,27,46
85,8479992,Michael Rasmussen,C,DET,25,82,17,29,46
85,8482149,Cole Perfetti,C,WPG,22,82,16,30,46
85,8479365,Trent Frederic,C,BOS,26,82,13,33,46
85,8475169,Evander Kane,L,EDM,33,82,28,17,45
85,8480009,Eeli Tolvanen,R,SEA,25,82,25,20,45
85,8475799,Nino Niederreiter,R,WPG,32,82,25,20,45
85,8475793,Ryan Johansen,C,PHI,32,82,23,22,45
85,8477451,Ryan Hartman,R,MIN,30,82,20,25,45
85,8475714,Calle Jarnkrok,C,TOR,33,82,19,26,45
85,8477964,Ivan Barbashev,C,VGK,29,82,17,28,45
85,8478458,Jack Roslovic,C,CAR,27,82,16,29,45
85,8475149,Marcus Johansson,L,MIN,34,82,15,30,45
85,8477495,Seth Jones,D,CHI,30,82,14,31,45
85,8480459,Pius Suter,C,VAN,28,82,26,18,44
85,8482113,Anton Lundell,C,FLA,23,82,20,24,44
85,8478519,Anthony Cirelli,C,TBL,27,82,19,25,44
85,8478891,Mason Appleton,C,WPG,28,82,19,25,44
85,8479987,Morgan Geekie,C,BOS,26,82,17,27,44
85,8476419,Jean-Gabriel Pageau,C,NYI,32,82,14,30,44
85,8480078,Filip Chytil,C,NYR,25,82,13,31,44
85,8482667,William Eklund,L,SJS,22,82,13,31,44
85,8476906,Shayne Gostisbehere,D,CAR,31,82,11,33,44
85,8480893,Kirill Marchenko,R,CBJ,24,82,24,19,43
85,8476981,Josh Anderson,R,MTL,30,82,24,19,43
85,8477426,Nicholas Paul,L,TBL,29,82,23,20,43
85,8475151,Kyle Palmieri,C,NYI,33,82,22,21,43
85,8478020,Michael Amadio,C,OTT,28,82,22,21,43
85,8475760,Nick Bjugstad,C,UTA,32,82,21,22,43
85,8474641,Adam Henrique,C,EDM,34,82,19,24,43
85,8470613,Brent Burns,D,CAR,39,82,13,30,43
85,8482671,Owen Power,D,BUF,22,82,10,33,43
85,8476958,Jaccob Slavin,D,CAR,30,82,7,36,43
85,8484144,Connor Bedard,C,CHI,19,82,21,21,42
85,8475848,Brendan Gallagher,R,MTL,32,82,21,21,42
85,8480829,Jesperi Kotkaniemi,C,CAR,24,82,20,22,42
85,8475193,Tomas Tatar,L,NJD,34,82,20,22,42
85,8483515,Juraj Slafkovsky,L,MTL,20,82,17,25,42
85,8473563,Nicklas Backstrom,C,WSH,37,82,15,27,42
85,8481624,Ilya Mikheyev,R,CHI,30,82,14,28,42
85,8476979,Erik Gustafsson,D,DET,32,82,5,37,42
85,8477952,Robby Fabbri,C,ANA,28,82,25,16,41
85,8478057,Dakota Joshua,C,VAN,28,82,20,21,41
85,8482092,Ridly Greig,C,OTT,22,82,18,23,41
85,8481093,Rafael Harvey-Pinard,L,MTL,25,82,18,23,41
85,8475722,Jason Zucker,L,BUF,32,82,17,24,41
85,8476927,Teddy Blueger,C,VAN,30,82,16,25,41
85,8476869,Brady Skjei,D,NSH,30,82,10,31,41
85,8482089,Jake Neighbours,L,STL,22,82,29,11,40
85,8479996,Cody Glass,C,NSH,25,82,21,19,40
85,8477998,Warren Foegele,L,LAK,28,82,18,22,40
85,8476474,Stefan Noesen,R,NJD,31,82,18,22,40
85,8478013,Jake Walman,D,SJS,28,82,18,22,40
85,8479941,Justin Danforth,R,CBJ,31,82,17,23,40
85,8475220,Marcus Foligno,L,MIN,33,82,16,24,40
85,8476480,Vladislav Namestnikov,C,WPG,32,82,15,25,40
85,8482660,Kent Johnson,C,CBJ,22,82,14,26,40
85,8480074,Alexandre Texier,C,STL,25,82,13,27,40
85,8477932,Aaron Ekblad,D,FLA,28,82,12,28,40
85,8484153,Leo Carlsson,C,ANA,20,82,10,30,40
85,8476463,Jonas Brodin,D,MIN,31,82,8,32,40
85,8479325,Charlie McAvoy,D,BOS,27,82,6,34,40
85,8482079,Marco Rossi,C,MIN,23,82,24,15,39
85,8474189,Lars Eller,C,PIT,35,82,22,17,39
85,8476960,Andreas Athanasiou,C,CHI,30,82,14,25,39
85,8481013,Jonatan Berggren,R,DET,24,82,13,26,39
85,8481542,Moritz Seider,D,DET,23,82,6,33,39
85,8475764,Cam Fowler,D,ANA,33,82,3,36,39
85,8480068,Ryan Poehling,C,PHI,25,82,23,15,38
85,8482055,Drew O'Connor,L,PIT,26,82,22,16,38
85,8480849,Barrett Hayton,C,UTA,24,82,19,19,38
85,8477456,J.T. Compher,L,DET,29,82,14,24,38
85,8477947,Sonny Milano,L,WSH,28,82,14,24,38
85,8476873,Mark Jankowski,C,NSH,30,82,14,24,38
85,8476461,Sean Couturier,C,PHI,32,82,12,26,38
85,8480878,Nils Lundkvist,D,DAL,24,82,11,27,38
85,8478055,Gustav Forsling,D,FLA,28,82,9,29,38
85,8476872,Scott Laughton,C,PHI,30,82,8,30,38
85,8481554,Kaapo Kakko,R,NYR,23,82,24,13,37
85,8477425,Miles Wood,L,COL,29,82,21,16,37
85,8473533,Jordan Staal,C,CAR,36,82,18,19,37
85,8478472,Mathieu Joseph,R,STL,27,82,17,20,37
85,8482705,Cole Sillinger,C,CBJ,21,82,15,22,37
85,8478413,Jordan Greenway,L,BUF,27,82,14,23,37
85,8476329,Travis Boyd,C,MIN,31,82,11,26,37
85,8474716,Jared Spurgeon,D,MIN,35,82,11,26,37
85,8475200,Dmitry Orlov,D,CAR,33,82,10,27,37
85,8480145,Neal Pionk,D,WPG,29,82,8,29,37
85,8483431,Logan Cooley,C,UTA,20,82,21,15,36
85,8481560,Arthur Kaliyev,R,LAK,23,82,20,16,36
85,8476921,Jordan Martinook,L,CAR,32,82,20,16,36
85,8484166,Adam Fantilli,C,CBJ,20,82,20,16,36
85,8477953,Kasperi Kapanen,R,STL,28,82,17,19,36
85,8481604,Pavel Dorofeyev,L,VGK,24,82,16,20,36
85,8476925,Colton Sissons,C,NSH,31,82,13,23,36
85,8482624,Daniil Miromanov,D,CGY,27,82,12,24,36
85,8477488,Brett Pesce,D,NJD,30,82,10,26,36
85,8473422,Nick Foligno,L,CHI,37,82,17,18,35
85,8477369,Carson Soucy,D,VAN,30,82,13,22,35
85,8480813,Joe Veleno,C,DET,24,82,12,23,35
85,8479402,Jake Bean,D,CGY,26,82,7,28,35
85,8480043,Timothy Liljegren,D,TOR,25,82,4,31,35
85,8478109,Victor Olofsson,L,VGK,29,82,20,14,34
85,8475343,Nic Dowd,C,WSH,34,82,20,14,34
85,8480835,Jack Drury,C,CAR,24,82,19,15,34
85,8481535,Nils Hoglander,L,VAN,24,82,18,16,34
85,8479316,Luke Kunin,C,SJS,27,82,16,18,34
85,8474149,Evgenii Dadonov,R,DAL,35,82,15,19,34
85,8480871,Adam Boqvist,D,FLA,24,82,15,19,34
85,8482111,Justin Barron,D,MTL,23,82,15,19,34
85,8476438,Brandon Saad,L,STL,32,82,14,20,34
85,8481032,Paul Cotter,C,NJD,25,82,14,20,34
85,8481477,Nico Sturm,C,SJS,29,82,13,21,34
85,8482087,Kaiden Guhle,D,MTL,22,82,7,27,34
85,8480817,K'Andre Miller,D,NYR,24,82,7,27,34
85,8479390,Taylor Raddysh,R,WSH,26,82,18,15,33
85,8477903,Garnet Hathaway,R,PHI,33,82,16,17,33
85,8480748,Kiefer Sherwood,L,VAN,29,82,14,19,33
85,8476374,Sean Kuraly,C,CBJ,31,82,14,19,33
85,8478038,Devon Toews,D,COL,30,82,7,26,33
85,8479976,Juuso Valimaki,D,UTA,26,82,5,28,33
85,8474673,TJ Brodie,D,CHI,34,82,5,28,33
85,8474715,Cam Atkinson,R,TBL,35,82,18,14,32
85,8477450,Jason Dickinson,C,CHI,29,82,9,23,32
85,8481546,Cam York,D,PHI,23,82,9,23,32
85,8482105,Jake Sanderson,D,OTT,22,82,9,23,32
85,8476885,Jacob Trouba,D,NYR,30,82,8,24,32
85,8475218,Mattias Ekholm,D,EDM,34,82,4,28,32
85,8482122,Brock Faber,D,MIN,22,82,3,29,32
85,8480873,Rasmus Sandin,D,WSH,24,82,2,30,32
85,8476917,Adam Pelech,D,NYI,30,82,2,30,32
85,8482117,Lukas Reichel,L,CHI,22,82,18,13,31
85,8482125,Alexander Holtz,R,VGK,22,82,16,15,31
85,8481481,Blake Lizotte,C,PIT,27,82,14,17,31
85,8479293,Brandon Tanev,L,SEA,33,82,13,18,31
85,8481580,Connor McMichael,C,WSH,23,82,13,18,31
85,8483468,Jiri Kulich,C,BUF,20,82,13,18,31
85,8477989,Christian Dvorak,C,MTL,28,82,12,19,31
85,8483457,Lane Hutson,D,MTL,20,82,12,19,31
85,8481581,Thomas Harley,D,DAL,23,82,11,20,31
85,8481582,Nicholas Robertson,L,TOR,23,82,11,20,31
85,8477919,Frederick Gaudreau,C,MIN,31,82,11,20,31
85,8476292,Ondrej Palat,L,NJD,33,82,10,21,31
85,8477498,Darnell Nurse,D,EDM,29,82,8,23,31
85,8479591,Michael Eyssimont,C,TBL,28,82,8,23,31
85,8476422,Mike Reilly,D,NYI,31,82,3,28,31
85,8480802,Ryan McLeod,C,BUF,25,82,13,17,30
85,8480806,Isac Lundestrom,C,ANA,25,82,13,17,30
85,8479353,Brett Howden,C,VGK,26,82,11,19,30
85,8480144,David Kampf,C,TOR,29,82,9,21,30
85,8480003,Jesper Boqvist,C,FLA,26,82,8,22,30
85,8474574,Tyler Myers,D,VAN,34,82,7,23,30
85,8477365,Connor Clifton,D,BUF,29,82,5,25,30
85,8476312,Josh Manson,D,COL,33,82,5,25,30
85,8475181,Nick Leddy,D,STL,33,82,3,27,30
85,8470621,Corey Perry,R,EDM,39,82,16,13,29
85,8482074,Connor Zary,C,CGY,23,82,15,14,29
85,8481186,Logan O'Connor,R,COL,28,82,11,18,29
85,8476897,Oskar Sundqvist,C,STL,30,82,9,20,29
85,8476392,Adam Lowry,C,WPG,31,82,8,21,29
85,8479980,Nicolas Hague,D,VGK,26,82,8,21,29
85,8478851,Alexandre Carrier,D,NSH,28,82,5,24,29
85,8477506,Ryan Pulock,D,NYI,30,82,4,25,29
85,8476891,Matt Grzelcyk,D,PIT,30,82,4,25,29
85,8476923,Damon Severson,D,CBJ,30,82,3,26,29
85,8480336,Sean Walker,D,CAR,30,82,2,27,29
85,8476278,Colin Blackwell,C,DAL,31,82,19,9,28
85,8476469,Joel Armia,R,MTL,31,82,18,10,28
85,8477987,Ryan Donato,C,CHI,28,82,14,14,28
85,8481704,Juuso Parssinen,C,NSH,23,82,12,16,28
85,8478508,Yakov Trenin,C,MIN,27,82,12,16,28
85,8484203,Bradly Nadeau,L,CAR,19,82,12,16,28
85,8481656,Aliaksei Protas,C,WSH,23,82,11,17,28
85,8476624,Barclay Goodrow,C,SJS,31,82,9,19,28
85,8476525,Colin Miller,D,WPG,32,82,7,21,28
85,8477435,Ryan Graves,D,PIT,29,82,0,28,28
85,8484145,Zach Benson,L,BUF,19,82,19,8,27
85,8479661,Tanner Jeannot,L,LAK,27,82,12,15,27
85,8479351,Sam Steel,C,DAL,26,82,9,18,27
85,8478432,Christian Fischer,R,DET,27,82,9,18,27
85,8479324,Ryan Lindgren,D,NYR,26,82,7,20,27
85,8475171,Oliver Ekman-Larsson,D,TOR,33,82,5,22,27
85,8479398,Samuel Girard,D,COL,26,82,5,22,27
85,8481014,Alexander Romanov,D,NYI,24,82,5,22,27
85,8482655,J.J. Moser,D,TBL,24,82,4,23,27
85,8480246,Nick Perbix,D,TBL,26,82,4,23,27
85,8480222,Sebastian Aho,D,PIT,28,82,4,23,27
85,8476892,Colton Parayko,D,STL,31,82,2,25,27
85,8479371,Dante Fabbro,D,NSH,26,82,1,26,27
85,8480860,Kevin Bahl,D,CGY,24,82,0,27,27
85,8476858,Phillip Di Giuseppe,L,VAN,31,82,16,10,26
85,8482077,Dylan Holloway,L,EDM,23,82,15,11,26
85,8480855,Jack McBain,C,UTA,24,82,13,13,26
85,8481553,Bobby Brink,R,PHI,23,82,12,14,26
85,8480980,Connor Dewar,C,TOR,25,82,12,14,26
85,8481028,Martin Pospisil,C,CGY,25,82,12,14,26
85,8482733,Logan Mailloux,D,MTL,31,82,11,15,26
85,8477508,Curtis Lazar,C,NJD,29,82,10,16,26
85,8481606,Jordan Spence,D,LAK,23,82,8,18,26
85,8475188,Brayden McNabb,D,VGK,33,82,8,18,26
85,8478507,John Marino,D,UTA,27,82,7,19,26
85,8476931,Jake McCabe,D,TOR,31,82,6,20,26
85,8482133,Thomas Bordeleau,C,SJS,22,82,5,21,26
85,8478911,Matt Roy,D,WSH,29,82,5,21,26
85,8475324,Nick Jensen,D,OTT,34,82,5,21,26
85,8482142,Jamie Drysdale,D,PHI,22,82,4,22,26
85,8476457,Adam Larsson,D,SEA,32,82,4,22,26
85,8475233,David Savard,D,MTL,34,82,4,22,26
85,8481601,Simon Holmstrom,R,NYI,23,82,14,11,25
85,8477839,Conor Sheary,L,TBL,32,82,13,12,25
85,8482166,Shakir Mukhamadullin,D,SJS,22,82,10,15,25
85,8483565,Nick Blankenburg,D,NSH,26,82,9,16,25
85,8477969,Marcus Pettersson,D,PIT,28,82,5,20,25
85,8483490,Pavel Mintyukov,D,ANA,21,82,5,20,25
85,8474151,Ryan McDonagh,D,TBL,35,82,2,23,25
85,8478500,Ivan Provorov,D,CBJ,27,82,2,23,25
85,8480035,Henri Jokiharju,D,BUF,25,82,2,23,25
85,8476918,Jimmy Vesey,L,NYR,31,82,14,10,24
85,8477392,Hudson Fasching,R,NYI,29,82,14,10,24
85,8478434,Keegan Kolesar,R,VGK,27,82,10,14,24
85,8481524,Bowen Byram,D,BUF,23,82,9,15,24
85,8479291,Kevin Rooney,C,CGY,31,82,9,15,24
85,8483445,Cutter Gauthier,L,ANA,20,82,7,17,24
85,8482809,Jackson Blake,R,CAR,21,82,7,17,24
85,8480172,Jan Rutta,D,SJS,34,82,5,19,24
85,8482073,Braden Schneider,D,NYR,23,82,3,21,24
85,8476889,Radek Faksa,C,STL,30,82,14,9,23
85,8476442,Matt Nieto,L,PIT,32,82,14,9,23
85,8477505,Alexander Wennberg,C,SJS,30,82,12,11,23
85,8481517,Brett Leason,R,ANA,25,82,10,13,23
85,8478133,Jake Evans,C,MTL,28,82,9,14,23
85,8477507,Nikita Zadorov,D,BOS,29,82,9,14,23
85,8482141,Lukas Cormier,D,VGK,22,82,9,14,23
85,8475231,Casey Cizikas,C,NYI,33,82,9,14,23
85,8479983,Mario Ferraro,D,SJS,26,82,7,16,23
85,8481708,Zac Jones,D,NYR,24,82,6,17,23
85,8483495,Simon Nemec,D,NJD,20,82,5,18,23
85,8480807,Mattias Samuelsson,D,BUF,24,82,2,21,23
85,8475462,Radko Gudas,D,ANA,34,82,2,21,23
85,8482259,Bobby McMann,C,TOR,28,82,14,8,22
85,8480995,Pontus Holmberg,R,TOR,25,82,12,10,22
85,8481699,Aku Raty,R,UTA,23,82,9,13,22
85,8483493,Frank Nazar,C,CHI,20,82,7,15,22
85,8478443,Brandon Carlo,D,BOS,28,82,5,17,22
85,8478178,Darren Raddysh,D,TBL,28,82,5,17,22
85,8482245,Artem Zub,D,OTT,29,82,4,18,22
85,8474013,Ian Cole,D,UTA,35,82,4,18,22
85,8476331,Dylan DeMelo,D,WPG,31,82,3,19,22
85,8480073,Erik Brannstrom,D,COL,25,82,3,19,22
85,8476467,Jamie Oleksiak,D,SEA,32,82,2,20,22
85,8476902,Esa Lindell,D,DAL,30,82,2,20,22
85,8480281,Alexey Toropchenko,R,STL,25,82,13,8,21
85,8483499,Liam Ohgren,L,MIN,20,82,12,9,21
85,8479393,Noah Gregor,C,OTT,26,82,11,10,21
85,8482062,Cole Smith,L,NSH,29,82,10,11,21
85,8475855,Jesper Fast,R,CAR,33,82,7,14,21
85,8482803,Olen Zellweger,D,ANA,21,82,5,16,21
85,8478468,Jeremy Lauzon,D,NSH,27,82,5,16,21
85,8479442,Troy Stecher,D,EDM,30,82,5,16,21
85,8478136,Jake Middleton,D,MIN,28,82,3,18,21
85,8483460,David Jiricek,D,CBJ,21,82,3,18,21
85,8476967,Brett Kulak,D,EDM,30,82,3,18,21
85,8477499,Rasmus Ristolainen,D,PHI,30,82,3,18,21
85,8478840,Will Borgen,D,SEA,28,82,2,19,21
85,8477845,Trevor van Riemsdyk,D,WSH,33,82,0,21,21
85,8475842,Sam Carrick,C,NYR,32,82,11,9,20
85,8473453,Trevor Lewis,C,LAK,37,82,9,11,20
85,8480025,MacKenzie Entwistle,R,FLA,25,82,8,12,20
85,8479998,Mikey Anderson,D,LAK,25,82,7,13,20
85,8481567,Henry Thrun,D,SJS,23,82,6,14,20
85,8484149,Gavin Brindley,C,CBJ,20,82,5,15,20
85,8478399,Jonas Siegenthaler,D,NJD,27,82,3,17,20
85,8477406,Mattias Janmark,C,EDM,32,82,2,18,20
85,8482155,Alex Laferriere,R,LAK,23,82,14,5,19
85,8482702,Logan Stankoven,C,DAL,21,82,10,9,19
85,8477353,Tyler Motte,C,DET,29,82,9,10,19
85,8480021,Jack Studnicka,C,LAK,25,82,8,11,19
85,8484911,Collin Graf,R,SJS,22,82,7,12,19
85,8481522,Peyton Krebs,C,BUF,23,82,6,13,19
85,8483524,Shane Wright,C,SEA,20,82,6,13,19
85,8480796,Martin Fehervary,D,WSH,25,82,6,13,19
85,8473507,Jeff Petry,D,DET,37,82,4,15,19
85,8478416,Erik Cernak,D,TBL,27,82,4,15,19
85,8482470,Ilya Solovyov,D,CGY,24,82,4,15,19
85,8481178,Egor Zamula,D,PHI,24,82,3,16,19
85,8480879,Jacob Bernard-Docker,D,OTT,24,82,3,16,19
85,8478882,Vladislav Gavrikov,D,LAK,29,82,2,17,19
85,8480049,Dylan Samberg,D,WPG,25,82,2,17,19
85,8475790,Erik Gudbranson,D,CBJ,32,82,2,17,19
85,8482118,Sam Colangelo,R,ANA,23,82,10,8,18
85,8482101,Danil Gushchin,L,SJS,22,82,10,8,18
85,8479359,Beck Malenstyn,L,BUF,26,82,9,9,18
85,8482659,Josh Doan,R,UTA,22,82,9,9,18
85,8477015,Connor Brown,R,EDM,30,82,8,10,18
85,8482666,Scott Morrow,D,CAR,22,82,5,13,18
85,8476879,Cody Ceci,D,EDM,31,82,5,13,18
85,8483482,Tristan Luneau,D,ANA,20,82,5,13,18
85,8475690,Chris Tanev,D,TOR,35,82,2,16,18
85,8479369,Andrew Peeke,D,BOS,26,82,1,17,18
85,8476429,Scott Mayfield,D,NYI,32,82,1,17,18
85,8478211,Dryden Hunt,L,CGY,29,82,8,9,17
85,8479368,Max Jones,L,BOS,26,82,7,10,17
85,8478569,Noel Acciari,C,PIT,33,82,7,10,17
85,8482749,Joshua Roy,R,MTL,21,82,7,10,17
85,8478450,Parker Wotherspoon,D,BOS,27,82,5,12,17
85,8482679,Matt Coronato,R,CGY,22,82,5,12,17
85,8477220,Nate Schmidt,D,FLA,33,82,2,15,17
85,8483763,Maksymilian Szuber,D,UTA,22,82,8,8,16
85,8482712,Oskar Olausson,R,COL,22,82,8,8,16
85,8483505,Matthew Poitras,C,BOS,20,82,6,10,16
85,8479414,Nathan Bastian,R,NJD,27,82,5,11,16
85,8480448,Parker Kelly,L,COL,25,82,5,11,16
85,8475455,Brenden Dillon,D,NJD,34,82,5,11,16
85,8476372,Nick Seeler,D,PHI,31,82,5,11,16
85,8483012,Logan Morrison,C,SEA,22,82,4,12,16
85,8477938,Haydn Fleury,D,WPG,28,82,3,13,16
85,8482762,Simon Edvinsson,D,DET,21,82,3,13,16
85,8470600,Ryan Suter,D,STL,39,82,2,14,16
85,8481641,Joel Kiviranta,L,COL,28,82,9,6,15
85,8480870,Bo Groulx,C,NYR,24,82,6,9,15
85,8482807,Ethan Del Mastro,D,CHI,21,82,4,11,15
85,8475279,Ben Chiarot,D,DET,33,82,3,12,15
85,8481605,Jackson LaCombe,D,ANA,23,82,3,12,15
85,8474612,Travis Hamonic,D,OTT,34,82,3,12,15
85,8478859,Niko Mikkola,D,FLA,28,82,2,13,15
85,8480789,Oliver Wahlstrom,R,NYI,24,82,7,7,14
85,8480834,Ty Emberson,D,SJS,24,82,6,8,14
85,8477931,Tomas Nosek,L,FLA,32,82,5,9,14
85,8475762,Derek Forbort,D,VAN,32,82,5,9,14
85,8479638,Justin Brazeau,R,BOS,26,82,5,9,14
85,8475177,Calvin de Haan,D,COL,33,82,4,10,14
85,8474567,Zach Bogosian,D,MIN,34,82,4,10,14
85,8476441,Joel Edmundson,D,LAK,31,82,3,11,14
85,8471677,Jack Johnson,D,CBJ,37,82,3,11,14
85,8481122,Simon Benoit,D,TOR,26,82,3,11,14
85,8481568,Alex Vlasic,D,CHI,23,82,2,12,14
85,8483397,Marc McLaughlin,C,BOS,25,82,8,5,13
85,8482516,Matthew Kessel,D,STL,24,82,6,7,13
85,8474090,Brendan Smith,D,DAL,35,82,4,9,13
85,8483471,Brad Lambert,C,WPG,31,82,4,9,13
85,8477034,Jaycob Megna,D,FLA,32,82,4,9,13
85,8479576,Vincent Desharnais,D,VAN,28,82,2,11,13
85,8476878,Zemgus Girgensons,L,TBL,30,82,5,7,12
85,8482713,Mackie Samoskevich,R,FLA,22,82,5,7,12
85,8480950,Ilya Lyubushkin,D,DAL,30,82,4,8,12
85,8482153,Brendan Brisson,C,VGK,23,82,4,8,12
85,8480990,Declan Chisholm,D,MIN,24,82,4,8,12
85,8476473,Connor Murphy,D,CHI,31,82,2,10,12
85,8475718,Justin Holl,D,DET,32,82,1,11,12
85,8476822,Luke Glendening,C,TBL,35,82,9,2,11
85,8483466,Kevin Korchinski,D,CHI,20,82,6,5,11
85,8482858,Ryker Evans,D,SEA,23,82,4,7,11
85,8483489,Fraser Minten,C,TOR,31,82,4,7,11
85,8482070,Mitchell Chaffee,R,TBL,26,82,5,5,10
85,8482145,Mavrik Bourque,C,DAL,22,82,4,6,10
85,8483567,Georgii Merkulov,C,BOS,24,82,4,6,10
85,8478874,Adam Gaudette,C,OTT,28,82,0,10,10
85,8482859,Zack Ostapchuk,C,OTT,21,82,4,5,9
85,8477335,Kyle Burroughs,D,LAK,29,82,4,3,7
85,8482787,Nikita Chibrikov,R,WPG,31,82,3,2,5
85,8474062,Riley Nash,C,NYR,35,82,0,4,4
85,8470794,Joe Pavelski,C,,40,0,0,0,0
85,8481703,Valtteri Puustinen,R,PIT,25,0,0,0,0
85,8477950,Tony DeAngelo,D,,29,0,0,0,0
85,8481577,Philip Tomasino,C,NSH,23,0,0,0,0
85,8475197,Tyson Barrie,D,,33,0,0,0,0
85,8471218,Blake Wheeler,R,,38,0,0,0,0
85,8474157,Max Pacioretty,L,,36,0,0,0,0
85,8478466,Daniel Sprong,R,VAN,27,0,0,0,0
85,8475744,Evgeny Kuznetsov,C,,32,0,0,0,0
85,8481019,David Gustafsson,C,WPG,24,0,0,0,0
85,8475906,John Klingberg,D,,32,0,0,0,0
85,8479348,Kale Clague,D,BUF,26,0,0,0,0
85,8476952,Dominic Toninato,C,WPG,30,0,0,0,0
85,8473473,Milan Lucic,L,,36,0,0,0,0
85,8474037,James van Riemsdyk,L,,35,0,0,0,0
85,8474602,Justin Schultz,D,,34,0,0,0,0
85,8482222,Alexander Barabanov,L,,30,0,0,0,0
85,8479372,Josh Mahura,D,SEA,26,0,0,0,0
85,8479982,Conor Timmins,D,TOR,26,0,0,0,0
85,8474031,Kevin Shattenkirk,D,,35,0,0,0,0
85,8480008,Adam Ruzicka,C,,25,0,0,0,0
85,8481059,Scott Perunovich,D,STL,26,0,0,0,0
85,8480884,Calen Addison,D,,24,0,0,0,0
85,8476994,Vinnie Hinostroza,C,NSH,30,0,0,0,0
85,8478452,Caleb Jones,D,LAK,27,0,0,0,0
85,8480157,Calle Rosen,D,COL,30,0,0,0,0
85,8481609,Vladislav Kolyachonok,D,UTA,23,0,0,0,0
85,8479415,Michael McLeod,C,,26,0,0,0,0
85,8476919,Chris Tierney,C,,30,0,0,0,0
85,8479639,Dylan Coghlan,D,WPG,26,0,0,0,0
85,8478146,Matthew Highmore,C,OTT,28,0,0,0,0
85,8478970,Jalen Chatfield,D,CAR,28,0,0,0,0
85,8480205,Emil Bemstrom,C,PIT,25,0,0,0,0
85,8474884,Mike Hoffman,C,,35,0,0,0,0
85,8471274,Alex Goligoski,D,,39,0,0,0,0
85,8478104,Sammy Blais,L,,28,0,0,0,0
85,8474870,Tyler Johnson,C,,34,0,0,0,0
85,8476913,Devin Shore,C,MIN,30,0,0,0,0
85,8481598,Philip Broberg,D,EDM,23,0,0,0,0
85,8480058,Pierre-Olivier Joseph,D,STL,25,0,0,0,0
85,8480891,Michael Kesselring,D,UTA,24,0,0,0,0
85,8477979,Nicolas Aube-Kubel,R,BUF,28,0,0,0,0
85,8476871,Tanner Pearson,L,,32,0,0,0,0
85,8476393,Nick Cousins,C,,31,0,0,0,0
85,8479977,Kailer Yamamoto,R,,26,0,0,0,0
85,8479543,Michael Pezzetta,L,MTL,26,0,0,0,0
85,8477018,Ben Hutton,D,VGK,31,0,0,0,0
85,8480762,Eric Robinson,L,CAR,29,0,0,0,0
85,8474034,Pat Maroon,L,CHI,36,0,0,0,0
85,8481058,Jesse Ylönen,R,,25,0,0,0,0
85,8475179,Dmitry Kulikov,D,FLA,34,0,0,0,0
85,8481527,Kaedan Korczak,D,VGK,23,0,0,0,0
85,8473449,Kyle Okposo,R,,36,0,0,0,0
85,8482192,Isaak Phillips,D,CHI,23,0,0,0,0
85,8480727,Zach Whitecloud,D,VGK,28,0,0,0,0
85,8479346,Dillon Dube,C,,26,0,0,0,0
85,8480821,Filip Zadina,R,,25,0,0,0,0
85,8480001,Urho Vaakanainen,D,ANA,25,0,0,0,0
85,8470966,Mark Giordano,D,,41,0,0,0,0
85,8480853,Liam Foudy,C,,24,0,0,0,0
85,8475225,Craig Smith,C,CHI,35,0,0,0,0
85,8479972,Mason Shaw,C,WPG,26,0,0,0,0
85,8478451,Ethan Bear,D,WSH,27,0,0,0,0
85,8474040,Sam Gagner,C,,35,0,0,0,0
85,8480196,Jacob Bryson,D,BUF,27,0,0,0,0
85,8479984,Cal Foote,D,,26,0,0,0,0
85,8480011,Klim Kostin,C,SJS,25,0,0,0,0
85,8482176,Wyatt Kaiser,D,CHI,22,0,0,0,0
85,8476988,Matt Benning,D,SJS,30,0,0,0,0
85,8479370,Tyson Jost,C,CAR,26,0,0,0,0
85,8477464,Nic Petan,C,,29,0,0,0,0
85,8477380,Jonny Brodzinski,C,NYR,31,0,0,0,0
85,8480070,Ian Mitchell,D,BOS,25,0,0,0,0
85,8479315,Joey Anderson,R,CHI,26,0,0,0,0
85,8478099,Kevin Labanc,R,,29,0,0,0,0
85,8476874,Olli Maatta,D,DET,30,0,0,0,0
85,8475208,Brian Dumoulin,D,ANA,33,0,0,0,0
85,8478430,Oliver Kylington,D,,27,0,0,0,0
85,8479536,Axel Jonsson-Fjallby,L,WPG,26,0,0,0,0
85,8479671,Mathieu Olivier,R,CBJ,27,0,0,0,0
85,8471709,Marc-Edouard Vlasic,D,SJS,37,0,0,0,0
85,8479328,Julien Gauthier,R,NYI,27,0,0,0,0
85,8478421,A.J. Greer,L,FLA,28,0,0,0,0
85,8477573,Nathan Walker,L,STL,30,0,0,0,0
85,8481537,Nikita Okhotiuk,D,CGY,24,0,0,0,0
85,8474166,Alec Martinez,D,CHI,37,0,0,0,0
85,8470610,Zach Parise,L,,40,0,0,0,0
85,8477478,William Carrier,L,CAR,30,0,0,0,0
85,8479344,Jesse Puljujarvi,R,PIT,26,0,0,0,0
85,8480887,Jordan Harris,D,MTL,24,0,0,0,0
85,8478502,Dennis Gilbert,D,BUF,28,0,0,0,0
85,8482730,Brandt Clarke,D,LAK,21,0,0,0,0
85,8480355,Mark Kastelic,C,BOS,25,0,0,0,0
85,8475750,Jon Merrill,D,MIN,32,0,0,0,0
85,8475164,Jakob Silfverberg,R,,34,0,0,0,0
85,8477944,Jakub Vrana,L,,28,0,0,0,0
85,8479439,Jacob MacDonald,D,COL,31,0,0,0,0
85,8474568,Luke Schenn,D,NSH,35,0,0,0,0
85,8478454,Noah Juulsen,D,VAN,27,0,0,0,0
85,8475752,Tyler Pitlick,C,,33,0,0,0,0
85,8482148,Hendrix Lapierre,C,WSH,22,0,0,0,0
85,8481167,Brayden Pachal,D,CGY,25,0,0,0,0
85,8478043,Sam Lafferty,C,BUF,29,0,0,0,0
85,8479321,Lucas Johansen,D,,27,0,0,0,0
85,8471699,Andrew Cogliano,C,,37,0,0,0,0
85,8481521,Ronnie Attard,D,PHI,25,0,0,0,0
85,8481161,Jake Christiansen,D,CBJ,25,0,0,0,0
85,8479458,Nikita Zaitsev,D,,33,0,0,0,0
85,8479619,Michael Carcone,L,UTA,28,0,0,0,0
85,8479026,Philippe Myers,D,TOR,27,0,0,0,0
85,8477330,Dominik Kubalik,L,,29,0,0,0,0
85,8481617,Vasily Podkolzin,R,VAN,23,0,0,0,0
85,8481701,Santeri Hatakka,D,NJD,23,0,0,0,0
85,8479514,Rem Pitlick,C,,27,0,0,0,0
85,8477446,Michael McCarron,R,NSH,29,0,0,0,0
85,8470604,Jeff Carter,C,,39,0,0,0,0
85,8482241,Radim Zohorna,L,,28,0,0,0,0
85,8480289,Morgan Barron,C,WPG,26,0,0,0,0
85,8479379,Givani Smith,R,SJS,26,0,0,0,0
85,8480216,Jacob Peterson,C,,25,0,0,0,0
85,8477851,Jordan Oesterle,D,BOS,32,0,0,0,0
85,8484258,Sam Malinski,D,COL,26,0,0,0,0
85,8478904,Steven Lorentz,C,,28,0,0,0,0
85,8482095,Tyler Kleven,D,OTT,22,0,0,0,0
85,8480848,Ty Dellandrea,C,SJS,24,0,0,0,0
85,8476884,Derrick Pouliot,D,,30,0,0,0,0
85,8479336,Carl Grundstrom,R,SJS,27,0,0,0,0
85,8482964,Arber Xhekaj,D,MTL,23,0,0,0,0
85,8471686,Marc Staal,D,,37,0,0,0,0
85,8477887,Patrick Brown,C,BOS,32,0,0,0,0
85,8478495,Denis Gurianov,R,,27,0,0,0,0
85,8473504,Cal Clutterbuck,R,,37,0,0,0,0
85,8481550,Adam Beckman,L,NJD,23,0,0,0,0
85,8480845,Rasmus Kupari,C,WPG,24,0,0,0,0
85,8474009,Nick Bonino,C,,36,0,0,0,0
85,8478585,Derek Ryan,C,EDM,38,0,0,0,0
85,8477962,Brendan Lemieux,L,CAR,28,0,0,0,0
85,8482861,Vincent Iorio,D,WSH,22,0,0,0,0
85,8479378,Logan Stanley,D,WPG,26,0,0,0,0
85,8473446,Erik Johnson,D,PHI,36,0,0,0,0
85,8481743,Marc Del Gaizo,D,NSH,25,0,0,0,0
85,8477384,Josh Brown,D,EDM,30,0,0,0,0
85,8482165,Yan Kuznetsov,D,CGY,22,0,0,0,0
85,8478424,Jansen Harkins,C,ANA,27,0,0,0,0
85,8482144,Jack Thompson,D,SJS,22,0,0,0,0
85,8478512,Austin Czarnik,C,,32,0,0,0,0
85,8477527,Ross Johnston,L,ANA,30,0,0,0,0
85,8479383,Boris Katchouk,L,,26,0,0,0,0
85,8482094,Daemon Hunt,D,MIN,22,0,0,0,0
85,8481719,Maxwell Crozier,D,TBL,24,0,0,0,0
85,8480192,Johnathan Kovacevic,D,NJD,27,0,0,0,0
85,8479376,Victor Mete,D,,26,0,0,0,0
85,8482511,Mason Lohrei,D,BOS,23,0,0,0,0
85,8475825,Jani Hakanpää,D,,32,0,0,0,0
85,8478021,William Lagesson,D,DET,28,0,0,0,0
85,8475795,Dylan McIlrath,D,WSH,32,0,0,0,0
85,8477846,Ryan Carpenter,C,,33,0,0,0,0
85,8481056,Spencer Stastney,D,NSH,24,0,0,0,0
85,8481564,Ryan Johnson,D,BUF,23,0,0,0,0
85,8478017,Mark Friedman,D,VAN,29,0,0,0,0
85,8479320,Max Lajoie,D,SEA,27,0,0,0,0
85,8480075,Cameron Crotty,D,MIN,25,0,0,0,0
85,8484287,Cole McWard,D,VAN,23,0,0,0,0
85,8484254,Akito Hirose,D,VAN,25,0,0,0,0
85,8483407,Brandon Scanlin,D,NYR,25,0,0,0,0
85,8480274,Philip Kemp,D,EDM,25,0,0,0,0
85,8479522,Hardy Haman Aktell,D,WSH,26,0,0,0,0
85,8480007,Jonas Rondbjerg,R,VGK,25,0,0,0,0
85,8477454,Adam Erne,L,,29,0,0,0,0
85,8481679,Maxence Guenette,D,OTT,23,0,0,0,0
85,8480441,Trey Fix-Wolansky,R,CBJ,25,0,0,0,0
85,8483546,Marshall Rifai,D,TOR,26,0,0,0,0
85,8480084,Nick DeSimone,D,NJD,30,0,0,0,0
85,8481030,Jack St. Ivany,D,PIT,25,0,0,0,0
85,8481592,Jakob Pelletier,L,CGY,23,0,0,0,0
85,8478011,Louie Belpedio,D,PHI,28,0,0,0,0
85,8477930,Pierre-Edouard Bellemare,L,,39,0,0,0,0
85,8484321,Nikolas Matinpalo,D,OTT,26,0,0,0,0
85,8482067,Connor Mackey,D,NYR,28,0,0,0,0
85,8481806,Louis Crevier,D,CHI,23,0,0,0,0
85,8484326,Patrik Koch,D,UTA,28,0,0,0,0
85,8477971,Andreas Englund,D,LAK,28,0,0,0,0
85,8481751,Lukas Rousek,R,BUF,25,0,0,0,0
85,8481006,Tyler Tucker,D,STL,24,0,0,0,0
85,8476867,Brendan Gaunce,C,MIN,30,0,0,0,0
85,8479520,Brandon Duhaime,R,WSH,27,0,0,0,0
85,8477073,Kurtis MacDermid,L,NJD,30,0,0,0,0
85,8480874,Adam Ginning,D,PHI,24,0,0,0,0
85,8477473,Justin Bailey,R,SJS,29,0,0,0,0
85,8479066,Ryan Lomberg,L,CGY,30,0,0,0,0
85,8477070,Liam O'Brien,C,UTA,30,0,0,0,0
85,8474618,Marco Scandella,D,,34,0,0,0,0
85,8475797,Jarred Tinordi,D,,32,0,0,0,0
85,8481441,Joe Snively,C,DET,28,0,0,0,0
85,8477244,Chad Ruhwedel,D,NYR,34,0,0,0,0
85,8479772,Zack MacEwen,R,OTT,28,0,0,0,0
85,8481147,Reese Johnson,C,MIN,26,0,0,0,0
85,8481043,Cole Koepke,L,BOS,26,0,0,0,0
85,8483619,Filip Roos,D,OTT,25,0,0,0,0
85,8481541,Samuel Bolduc,D,NYI,24,0,0,0,0
85,8477810,Joel Hanley,D,CGY,33,0,0,0,0
85,8476907,Mackenzie MacEachern,L,,30,0,0,0,0
85,8482652,Walker Duehr,R,CGY,27,0,0,0,0
85,8477126,Jayson Megna,C,,34,0,0,0,0
85,8483398,Declan Carlile,D,TBL,31,0,0,0,0
85,8482929,Emil Lilleberg,D,TBL,23,0,0,0,0
85,8480880,Jakub Lauko,C,MIN,24,0,0,0,0
85,8480245,Olle Lycksell,R,PHI,25,0,0,0,0
85,8480252,Cole Guttman,C,CHI,25,0,0,0,0
85,8477467,Gustav Olofsson,D,SEA,30,0,0,0,0
85,8479968,Vinni Lettieri,C,BOS,29,0,0,0,0
85,8478400,Colin White,C,,27,0,0,0,0
85,8475755,Alexander Petrovic,D,DAL,32,0,0,0,0
85,8481812,Nikolai Knyzhov,D,,27,0,0,0,0
85,8481593,Jayden Struble,D,MTL,23,0,0,0,0
85,8481532,Alex Turcotte,C,LAK,23,0,0,0,0
85,8482126,Emil Andrae,D,PHI,31,0,0,0,0
85,8479944,Zach Aston-Reese,C,VGK,30,0,0,0,0
85,8471817,Ryan Reaves,R,TOR,37,0,0,0,0
85,8481206,John Ludvig,D,PIT,24,0,0,0,0
85,8481599,Victor Soderstrom,D,UTA,23,0,0,0,0
85,8480292,Carson Meyer,R,ANA,27,0,0,0,0
85,8482496,Nils Aman,C,VAN,24,0,0,0,0
85,8479718,Alex Barré-Boulet,C,MTL,27,0,0,0,0
85,8479994,Jaret Anderson-Dolan,C,WPG,25,0,0,0,0
85,8480184,Gustav Lindstrom,D,,26,0,0,0,0
85,8480890,Jan Jenik,R,OTT,24,0,0,0,0
85,8478067,Oskar Lindblom,L,,28,0,0,0,0
85,8476934,Brock McGinn,L,ANA,30,0,0,0,0
85,8479985,Cale Fleury,D,SEA,26,0,0,0,0
85,8484304,Uvis Balinskis,D,FLA,28,0,0,0,0
85,8479981,Jonah Gadjovich,L,FLA,26,0,0,0,0
85,8481716,Dmitri Voronkov,L,CBJ,24,0,0,0,0
85,8474709,Matt Martin,L,,35,0,0,0,0
85,8482634,Alex Steeves,C,TOR,25,0,0,0,0
85,8480823,Alexander Alexeyev,D,WSH,25,0,0,0,0
85,8477541,Dakota Mermis,D,TOR,30,0,0,0,0
85,8483491,Ivan Miroshnichenko,L,WSH,20,0,0,0,0
85,8478477,Mitchell Stephens,C,SEA,27,0,0,0,0
85,8481543,Nikita Alexandrov,C,STL,24,0,0,0,0
85,8479423,Alex Nylander,L,,26,0,0,0,0
85,8482451,Mikael Pyyhtia,L,CBJ,23,0,0,0,0
85,8478831,Kevin Stenlund,C,UTA,28,0,0,0,0
85,8480306,Grant Hutton,D,NYI,29,0,0,0,0
85,8478028,Fredrik Olofsson,L,,28,0,0,0,0
85,8477462,Robert Hagg,D,VGK,29,0,0,0,0
85,8477320,Anton Blidh,L,NYR,29,0,0,0,0
85,8482157,Will Cuylle,L,NYR,22,0,0,0,0
85,8482737,Zack Bolduc,C,STL,21,0,0,0,0
85,8481239,Samuel Fagemo,L,,24,0,0,0,0
85,8481600,Tobias Bjornfot,D,FLA,23,0,0,0,0
85,8478409,Anthony Richard,C,PHI,28,0,0,0,0
85,8474145,Robert Bortuzzo,D,,35,0,0,0,0
85,8475958,Michael Sgarbossa,C,WSH,32,0,0,0,0
85,8479986,Kole Lind,R,DAL,26,0,0,0,0
85,8479249,Andrew Poturalski,C,SJS,30,0,0,0,0
85,8479362,Riley Tufte,L,BOS,26,0,0,0,0
85,8479991,Jake Leschyshyn,C,NYR,25,0,0,0,0
85,8479587,Rhett Gardner,C,PHI,28,0,0,0,0
85,8482744,James Malatesta,L,CBJ,21,0,0,0,0
85,8478854,Ryan Shea,D,PIT,27,0,0,0,0
85,8481591,Sam Poulin,R,,23,0,0,0,0
85,8483512,Matt Savoie,C,EDM,20,0,0,0,0
85,8482102,Vasily Ponomarev,C,PIT,22,0,0,0,0
85,8482162,Roby Jarventie,L,EDM,22,0,0,0,0
85,8481016,Ruslan Iskhakov,C,,24,0,0,0,0
85,8482172,Landon Slaggert,L,CHI,22,0,0,0,0
85,8482747,Brennan Othmann,L,NYR,21,0,0,0,0
85,8480031,Maxime Comtois,L,,25,0,0,0,0
85,8480226,Marián Studenic,R,,26,0,0,0,0
85,8478408,Travis Dermott,D,,28,0,0,0,0
85,8481518,Nolan Foote,L,NJD,24,0,0,0,0
85,8479419,Brett Murray,L,BUF,26,0,0,0,0
85,8482088,Justin Sourdif,R,FLA,22,0,0,0,0
85,8482201,Gage Goncalves,C,TBL,23,0,0,0,0
85,8481578,Graeme Clarke,R,MIN,23,0,0,0,0
85,8482177,Marat Khusnutdinov,C,MIN,22,0,0,0,0
85,8481754,Nikita Nesterenko,C,ANA,23,0,0,0,0
85,8483531,Brian Halonen,L,NJD,25,0,0,0,0
85,8483920,Pierrick Dube,R,WSH,23,0,0,0,0
85,8480851,Akil Thomas,C,LAK,24,0,0,0,0
85,8475235,Nicolas Deslauriers,L,PHI,33,0,0,0,0
85,8482476,Emil Heineman,L,MTL,23,0,0,0,0
85,8477149,Scott Sabourin,R,SJS,32,0,0,0,0
85,8483549,Lucas Condotta,L,MTL,27,0,0,0,0
85,8482765,Isak Rosen,R,BUF,21,0,0,0,0
85,8481237,Kyle MacLean,C,NYI,25,0,0,0,0
85,8481024,Linus Karlsson,C,VAN,25,0,0,0,0
85,8481690,Tyler Angle,C,,24,0,0,0,0
85,8483570,Ben Meyers,C,SEA,26,0,0,0,0
85,8481655,Cole Schwindt,R,CGY,23,0,0,0,0
85,8481462,Mason Morelli,L,VGK,28,0,0,0,0
85,8483401,Marc Johnstone,R,PIT,28,0,0,0,0
85,8478956,Samuel Laberge,L,NJD,27,0,0,0,0
85,8479533,Joona Koppanen,L,,26,0,0,0,0
85,8482197,Adam Raska,R,MIN,23,0,0,0,0
85,8482250,Callahan Burke,C,VGK,27,0,0,0,0
85,8482784,Zach Dean,C,STL,21,0,0,0,0
85,8484255,Jason Polin,R,COL,25,0,0,0,0
85,8481077,John Leonard,L,,26,0,0,0,0
85,8481534,Raphael Lavoie,C,EDM,24,0,0,0,0
85,8483609,Adam Klapka,R,CGY,24,0,0,0,0
85,8482751,Ryan Winterton,C,SEA,21,0,0,0,0
85,8480267,Sammy Walker,C,MIN,25,0,0,0,0
85,8475766,Austin Watson,L,,32,0,0,0,0
85,8482460,Matt Rempe,C,NYR,22,0,0,0,0
85,8481065,Angus Crookshank,L,OTT,25,0,0,0,0
85,8481070,Hugh McGing,L,,26,0,0,0,0
85,8476323,Max McCormick,L,SEA,32,0,0,0,0
85,8483395,Arshdeep Bains,L,VAN,23,0,0,0,0
85,8484259,Ondrej Pavel,C,COL,31,0,0,0,0
85,8483432,Luca Del Bel Belluz,C,CBJ,31,0,0,0,0
85,8483045,Cameron Butler,R,CBJ,31,0,0,0,0
85,8482061,Brandon Biro,L,SEA,26,0,0,0,0
85,8477401,John Hayden,C,SEA,29,0,0,0,0
85,8475278,Byron Froese,C,,33,0,0,0,0
85,8478446,Glenn Gawdin,C,LAK,27,0,0,0,0
85,8477993,Justin Kirkland,C,CGY,28,0,0,0,0
85,8482147,Jean-Luc Foudy,C,COL,22,0,0,0,0
85,8480032,Shane Bowers,C,NJD,25,0,0,0,0
85,8479330,Brandon Gignac,C,MTL,27,0,0,0,0
85,8480776,Sheldon Rempal,R,,29,0,0,0,0
85,8475413,Justin Dowling,C,NJD,34,0,0,0,0
85,8481726,Adam Edstrom,C,NYR,24,0,0,0,0
85,8480844,Grigori Denisenko,L,VGK,24,0,0,0,0
85,8478147,Bokondji Imama,L,PIT,28,0,0,0,0
85,8478881,Brett Seney,L,CHI,28,0,0,0,0
85,8483630,Pavol Regenda,L,ANA,25,0,0,0,0
85,8480836,Jonathan Gruden,C,,24,0,0,0,0
85,8484314,Jiri Smejkal,L,,28,0,0,0,0
85,8475780,Chris Wagner,R,COL,33,0,0,0,0
85,8479546,Oskar Steen,C,,26,0,0,0,0
85,8483597,Milos Kelemen,L,UTA,25,0,0,0,0
85,8481789,Tye Kartye,L,SEA,23,0,0,0,0
85,8484325,Waltteri Merela,C,TBL,26,0,0,0,0
85,8479421,Jacob Moverare,D,LAK,26,0,0,0,0
85,8481585,Egor Afanasyev,L,SJS,23,0,0,0,0
85,8479547,Matthew Phillips,R,,26,0,0,0,0
85,8479367,William Lockwood,R,FLA,26,0,0,0,0
85,8476915,Jujhar Khaira,L,,30,0,0,0,0
85,8481422,Jacob Lucchini,C,NSH,29,0,0,0,0
85,8480468,James Hamblin,L,EDM,25,0,0,0,0
85,8478051,Max Willman,C,NJD,29,0,0,0,0
85,8481556,John Beecher,C,BOS,23,0,0,0,0
85,8478078,Rourke Chartier,C,,28,0,0,0,0
86,8478402,Connor McDavid,C,EDM,27,82,41,101,142
86,8477492,Nathan MacKinnon,C,COL,29,82,47,81,128
86,8478420,Mikko Rantanen,R,COL,28,82,46,81,127
86,8479318,Auston Matthews,C,TOR,27,82,68,55,123
86,8471675,Sidney Crosby,C,PIT,37,82,53,70,123
86,8476453,Nikita Kucherov,R,TBL,31,82,30,93,123
86,8477934,Leon Draisaitl,C,EDM,29,82,48,67,115
86,8477956,David Pastrnak,R,BOS,28,82,55,55,110
86,8478550,Artemi Panarin,L,NYR,33,82,41,69,110
86,8480069,Cale Makar,D,COL,26,82,30,80,110
86,8477939,William Nylander,R,TOR,28,82,43,65,108
86,8478010,Brayden Point,C,TBL,28,82,58,48,106
86,8479314,Matthew Tkachuk,L,FLA,27,82,31,74,105
86,8477933,Sam Reinhart,C,FLA,29,82,52,52,104
86,8481559,Jack Hughes,C,NJD,23,82,47,56,103
86,8480012,Elias Pettersson,C,VAN,26,82,35,68,103
86,8476887,Filip Forsberg,L,NSH,30,82,48,54,102
86,8477493,Aleksander Barkov,C,FLA,29,82,33,69,102
86,8478445,Mathew Barzal,C,NYI,27,82,22,77,99
86,8478864,Kirill Kaprizov,L,MIN,27,82,46,51,97
86,8476468,J.T. Miller,C,VAN,31,82,38,59,97
86,8477942,Kevin Fiala,L,LAK,28,82,37,58,95
86,8477404,Jake Guentzel,C,TBL,30,82,39,55,94
86,8480830,Andrei Svechnikov,R,CAR,24,82,41,52,93
86,8474564,Steven Stamkos,C,NSH,34,82,40,53,93
86,8480027,Jason Robertson,L,DAL,25,82,36,56,92
86,8478398,Kyle Connor,L,WPG,28,82,41,49,90
86,8477946,Dylan Larkin,C,DET,28,82,44,45,89
86,8477409,Carter Verhaeghe,C,FLA,29,82,42,46,88
86,8475166,John Tavares,C,TOR,34,82,36,52,88
86,8471215,Evgeni Malkin,C,PIT,38,82,31,57,88
86,8474600,Roman Josi,D,NSH,34,82,19,69,88
86,8480800,Quinn Hughes,D,VAN,25,82,17,71,88
86,8471214,Alex Ovechkin,L,WSH,39,82,44,42,86
86,8478403,Jack Eichel,C,VGK,28,82,38,48,86
86,8479407,Jesper Bratt,L,NJD,26,82,37,49,86
86,8480839,Rasmus Dahlin,D,BUF,24,82,21,64,85
86,8477949,Alex Tuch,R,BUF,28,82,27,57,84
86,8479343,Clayton Keller,R,UTA,26,82,32,51,83
86,8475172,Nazem Kadri,C,CGY,34,82,30,53,83
86,8475798,Mikael Granlund,C,SJS,32,82,24,59,83
86,8478873,Troy Terry,R,ANA,27,82,31,51,82
86,8480036,Miro Heiskanen,D,DAL,25,82,20,62,82
86,8482116,Tim Stützle,C,OTT,22,82,23,58,81
86,8480023,Robert Thomas,C,STL,25,82,19,62,81
86,8480865,Noah Dobson,D,NYI,24,82,13,67,80
86,8479420,Tage Thompson,C,BUF,27,82,37,42,79
86,8476460,Mark Scheifele,C,WPG,31,82,37,42,79
86,8478427,Sebastian Aho,C,CAR,27,82,33,46,79
86,8481557,Matt Boldy,L,MIN,23,82,39,39,78
86,8478439,Travis Konecny,R,PHI,27,82,37,41,78
86,8479542,Brandon Hagel,L,TBL,26,82,35,43,78
86,8480801,Brady Tkachuk,L,OTT,25,82,33,45,78
86,8478440,Dylan Strome,C,WSH,27,82,24,54,78
86,8479385,Jordan Kyrou,C,STL,26,82,39,36,75
86,8477500,Bo Horvat,C,NYI,29,82,32,43,75
86,8478042,Viktor Arvidsson,R,EDM,31,82,30,45,75
86,8473419,Brad Marchand,L,BOS,36,82,18,57,75
86,8476539,Jonathan Marchessault,R,NSH,34,82,42,32,74
86,8476454,Ryan Nugent-Hopkins,C,EDM,31,82,30,44,74
86,8480018,Nick Suzuki,C,MTL,25,82,24,50,74
86,8476346,Johnny Gaudreau,L,CBJ,31,82,11,63,74
86,8479337,Alex DeBrincat,R,DET,27,82,31,42,73
86,8478414,Timo Meier,R,NJD,28,82,29,44,73
86,8475167,Victor Hedman,D,TBL,34,82,16,57,73
86,8476456,Jonathan Huberdeau,C,CGY,31,82,24,48,72
86,8479323,Adam Fox,D,NYR,26,82,9,63,72
86,8475786,Zach Hyman,L,EDM,32,82,38,33,71
86,8476459,Mika Zibanejad,C,NYR,31,82,28,43,71
86,8475692,Mats Zuccarello,R,MIN,37,82,15,56,71
86,8481523,Kirby Dach,C,MTL,23,82,14,57,71
86,8478493,Joel Eriksson Ek,C,MIN,27,82,42,28,70
86,8478444,Brock Boeser,R,VAN,27,82,37,33,70
86,8476853,Morgan Rielly,D,TOR,30,82,10,60,70
86,8482093,Seth Jarvis,C,CAR,22,82,27,42,69
86,8478449,Roope Hintz,C,DAL,28,82,24,45,69
86,8477951,Nick Schmaltz,C,UTA,28,82,22,47,69
86,8475168,Matt Duchene,C,DAL,33,82,35,33,68
86,8479675,Trevor Moore,L,LAK,29,82,28,40,68
86,8480002,Nico Hischier,C,NJD,25,82,26,42,68
86,8477504,Josh Morrissey,D,WPG,29,82,15,53,68
86,8477960,Adrian Kempe,R,LAK,28,82,33,34,67
86,8476399,Blake Coleman,C,CGY,33,82,31,36,67
86,8480015,Owen Tippett,R,PHI,25,82,26,41,67
86,8477402,Pavel Buchnevich,L,STL,29,82,25,42,67
86,8475754,Brock Nelson,C,NYI,33,82,35,31,66
86,8475784,Jeff Skinner,C,EDM,32,82,30,36,66
86,8477501,Valeri Nichushkin,R,COL,29,82,36,29,65
86,8477940,Nikolaj Ehlers,L,WPG,28,82,24,41,65
86,8475745,Charlie Coyle,C,BOS,32,82,23,42,65
86,8482078,Lucas Raymond,L,DET,22,82,22,43,65
86,8480208,Drake Batherson,R,OTT,26,82,21,44,65
86,8474679,Gustav Nyquist,C,NSH,35,82,19,46,65
86,8479325,Charlie McAvoy,D,BOS,27,82,19,46,65
86,8476881,Tomas Hertl,C,VGK,31,82,35,29,64
86,8477476,Artturi Lehkonen,L,COL,29,82,32,32,64
86,8475810,Bryan Rust,R,PIT,32,82,28,36,64
86,8473512,Claude Giroux,R,OTT,36,82,28,36,64
86,8475913,Mark Stone,R,VGK,32,82,23,41,64
86,8473994,Jamie Benn,L,DAL,35,82,22,42,64
86,8478038,Devon Toews,D,COL,30,82,12,52,64
86,8475726,Tyler Toffoli,C,SJS,32,82,36,27,63
86,8471685,Anze Kopitar,C,LAK,37,82,25,38,63
86,8477932,Aaron Ekblad,D,FLA,28,82,21,42,63
86,8478047,Michael Bunting,L,PIT,29,82,34,28,62
86,8471698,T.J. Oshie,R,WSH,38,82,30,32,62
86,8477479,Tyler Bertuzzi,L,CHI,29,82,30,32,62
86,8482124,Quinton Byfield,R,LAK,22,82,21,41,62
86,8478396,Noah Hanifin,D,VGK,27,82,12,50,62
86,8481540,Cole Caufield,R,MTL,23,82,31,30,61
86,8477426,Nicholas Paul,L,TBL,29,82,31,30,61
86,8479400,Pierre-Luc Dubois,L,WSH,26,82,26,35,61
86,8473986,Alex Killorn,L,ANA,35,82,22,39,61
86,8477496,Elias Lindholm,C,BOS,30,82,22,39,61
86,8480039,Martin Necas,C,CAR,25,82,19,42,61
86,8475794,Tyler Seguin,C,DAL,32,82,33,27,60
86,8474102,David Perron,L,OTT,36,82,27,33,60
86,8476882,Teuvo Teravainen,L,CHI,30,82,22,38,60
86,8482745,Mason McTavish,C,ANA,21,82,29,30,59
86,8477986,Brandon Montour,D,SEA,30,82,17,42,59
86,8480803,Evan Bouchard,D,EDM,25,82,11,48,59
86,8476483,Rickard Rakell,R,PIT,31,82,28,30,58
86,8476448,William Karlsson,C,VGK,31,82,24,34,58
86,8477451,Ryan Hartman,R,MIN,30,82,23,35,58
86,8478519,Anthony Cirelli,C,TBL,27,82,20,38,58
86,8481533,Trevor Zegras,C,ANA,23,82,19,39,58
86,8476875,Mike Matheson,D,MTL,30,82,15,43,58
86,8478407,Vince Dunn,D,SEA,28,82,15,43,58
86,8479339,Patrik Laine,L,CBJ,26,82,27,30,57
86,8476389,Vincent Trocheck,C,NYR,31,82,26,31,57
86,8482097,Jack Quinn,R,BUF,23,82,26,31,57
86,8481596,Shane Pinto,C,OTT,24,82,26,31,57
86,8478458,Jack Roslovic,C,CAR,27,82,26,31,57
86,8481068,Yegor Sharangovich,C,CGY,26,82,21,36,57
86,8476479,Phillip Danault,C,LAK,31,82,21,36,57
86,8480797,Joel Farabee,L,PHI,24,82,20,37,57
86,8475158,Ryan O'Reilly,C,NSH,33,82,18,39,57
86,8476462,Dougie Hamilton,D,NJD,31,82,16,41,57
86,8474578,Erik Karlsson,D,PIT,34,82,14,43,57
86,8478460,Zach Werenski,D,CBJ,27,82,14,43,57
86,8475753,Justin Faulk,D,STL,32,82,13,44,57
86,8477935,Sam Bennett,C,FLA,28,82,27,29,56
86,8480028,Morgan Frost,C,PHI,25,82,21,35,56
86,8475791,Taylor Hall,L,CHI,33,82,19,37,56
86,8477447,Shea Theodore,D,VGK,29,82,13,43,56
86,8479999,Casey Mittelstadt,C,COL,26,82,13,43,56
86,8482665,Matty Beniers,C,SEA,22,82,17,38,55
86,8475184,Chris Kreider,L,NYR,33,82,29,25,54
86,8483808,Andrei Kuzmenko,L,CGY,28,82,27,27,54
86,8482109,Alexis Lafrenière,L,NYR,23,82,26,28,54
86,8475765,Vladimir Tarasenko,R,DET,33,82,23,31,54
86,8478401,Pavel Zacha,C,BOS,27,82,21,33,54
86,8476438,Brandon Saad,L,STL,32,82,31,22,53
86,8480014,Gabriel Vilardi,C,WPG,25,82,24,29,53
86,8482667,William Eklund,L,SJS,22,82,16,37,53
86,8476906,Shayne Gostisbehere,D,CAR,31,82,14,39,53
86,8478397,Rasmus Andersson,D,CGY,28,82,12,41,53
86,8478055,Gustav Forsling,D,FLA,28,82,12,41,53
86,8482684,Luke Hughes,D,NJD,21,82,11,42,53
86,8471724,Kris Letang,D,PIT,37,82,10,43,53
86,8478366,Frank Vatrano,R,ANA,30,82,29,23,52
86,8475169,Evander Kane,L,EDM,33,82,26,26,52
86,8475151,Kyle Palmieri,C,NYI,33,82,26,26,52
86,8478975,Mason Marchment,L,DAL,29,82,19,33,52
86,8481711,Matias Maccelli,L,UTA,24,82,17,35,52
86,8477495,Seth Jones,D,CHI,30,82,14,38,52
86,8476869,Brady Skjei,D,NSH,30,82,11,41,52
86,8477955,Jared McCann,L,SEA,28,82,29,22,51
86,8477407,Anthony Duclair,L,NYI,29,82,25,26,51
86,8482159,Tyson Foerster,R,PHI,22,82,23,28,51
86,8478498,Jake DeBrusk,L,VAN,28,82,21,30,51
86,8477964,Ivan Barbashev,C,VGK,29,82,21,30,51
86,8476872,Scott Laughton,C,PHI,30,82,18,33,51
86,8474141,Patrick Kane,R,DET,36,82,17,34,51
86,8479425,Filip Hronek,D,VAN,27,82,8,43,51
86,8475793,Ryan Johansen,C,PHI,32,82,23,27,50
86,8482149,Cole Perfetti,C,WPG,22,82,18,32,50
86,8477494,Jonathan Drouin,L,COL,29,82,16,34,50
86,8474590,John Carlson,D,WSH,34,82,14,36,50
86,8474563,Drew Doughty,D,LAK,35,82,14,36,50
86,8476432,Boone Jenner,C,CBJ,31,82,28,21,49
86,8478438,Tommy Novak,C,NSH,27,82,23,26,49
86,8477511,Anthony Mantha,R,CGY,30,82,23,26,49
86,8477416,Oliver Bjorkstrand,R,SEA,29,82,21,28,49
86,8478233,Andrew Mangiapane,L,WSH,28,82,19,30,49
86,8479345,Jakob Chychrun,D,WSH,26,82,16,33,49
86,8477021,Alex Kerfoot,C,UTA,30,82,16,33,49
86,8476958,Jaccob Slavin,D,CAR,30,82,12,37,49
86,8474565,Alex Pietrangelo,D,VGK,34,82,10,39,49
86,8482699,Dylan Guenther,R,UTA,21,82,24,24,48
86,8482110,Dawson Mercer,C,NJD,23,82,24,24,48
86,8480064,Josh Norris,C,OTT,25,82,22,26,48
86,8482475,Yegor Chinakhov,R,CBJ,23,82,20,28,48
86,8479987,Morgan Geekie,C,BOS,26,82,19,29,48
86,8477998,Warren Foegele,L,LAK,28,82,19,29,48
86,8482175,JJ Peterka,R,BUF,22,82,32,15,47
86,8475314,Anders Lee,L,NYI,34,82,24,23,47
86,8481560,Arthur Kaliyev,R,LAK,23,82,24,23,47
86,8474641,Adam Henrique,C,EDM,34,82,20,27,47
86,8474586,Jordan Eberle,R,SEA,34,82,19,28,47
86,8482146,Luke Evangelista,R,NSH,22,82,19,28,47
86,8478462,Nicolas Roy,C,VGK,27,82,18,29,47
86,8478856,Conor Garland,R,VAN,28,82,17,30,47
86,8482113,Anton Lundell,C,FLA,23,82,17,30,47
86,8478469,Thomas Chabot,D,OTT,27,82,12,35,47
86,8477503,Max Domi,C,TOR,29,82,10,37,47
86,8476923,Damon Severson,D,CBJ,30,82,10,37,47
86,8481528,Dylan Cozens,C,BUF,23,82,22,24,46
86,8480798,Philipp Kurashev,C,CHI,25,82,17,29,46
86,8481618,Alex Newhook,C,MTL,23,82,17,29,46
86,8477429,Andrew Copp,C,DET,30,82,15,31,46
86,8476458,Ryan Strome,C,ANA,31,82,14,32,46
86,8481581,Thomas Harley,D,DAL,23,82,12,34,46
86,8477948,Travis Sanheim,D,PHI,28,82,11,35,46
86,8470613,Brent Burns,D,CAR,39,82,10,36,46
86,8482671,Owen Power,D,BUF,22,82,10,36,46
86,8479410,Mikhail Sergachev,D,UTA,26,82,6,40,46
86,8478046,Danton Heinen,L,VAN,29,82,28,17,45
86,8475714,Calle Jarnkrok,C,TOR,33,82,21,24,45
86,8484144,Connor Bedard,C,CHI,19,82,20,25,45
86,8475170,Brayden Schenn,C,STL,33,82,16,29,45
86,8481186,Logan O'Connor,R,COL,28,82,25,19,44
86,8482740,Wyatt Johnston,C,DAL,21,82,22,22,44
86,8478115,Pierre Engvall,L,NYI,28,82,22,22,44
86,8474053,Logan Couture,C,SJS,35,82,19,25,44
86,8477497,Sean Monahan,C,CBJ,30,82,18,26,44
86,8476826,Yanni Gourde,C,SEA,33,82,15,29,44
86,8475764,Cam Fowler,D,ANA,33,82,3,41,44
86,8479525,Ross Colton,C,COL,28,82,22,21,43
86,8477456,J.T. Compher,L,DET,29,82,17,26,43
86,8476792,Torey Krug,D,STL,33,82,13,30,43
86,8480185,Eetu Luostarinen,C,FLA,26,82,19,23,42
86,8480078,Filip Chytil,C,NYR,25,82,19,23,42
86,8481604,Pavel Dorofeyev,L,VGK,24,82,19,23,42
86,8477444,Andre Burakovsky,L,SEA,29,82,13,29,42
86,8476905,Chandler Stephenson,C,SEA,30,82,12,30,42
86,8473563,Nicklas Backstrom,C,WSH,37,82,9,33,42
86,8476329,Travis Boyd,C,MIN,31,82,9,33,42
86,8481542,Moritz Seider,D,DET,23,82,6,36,42
86,8478474,Lawson Crouse,L,UTA,27,82,22,19,41
86,8476880,Tom Wilson,R,WSH,30,82,21,20,41
86,8475287,Erik Haula,L,NJD,33,82,17,24,41
86,8482720,Matthew Knies,L,TOR,22,82,16,25,41
86,8480817,K'Andre Miller,D,NYR,24,82,9,32,41
86,8480145,Neal Pionk,D,WPG,29,82,7,34,41
86,8482055,Drew O'Connor,L,PIT,26,82,28,12,40
86,8483515,Juraj Slafkovsky,L,MTL,20,82,19,21,40
86,8482705,Cole Sillinger,C,CBJ,21,82,15,25,40
86,8476917,Adam Pelech,D,NYI,30,82,4,36,40
86,8480459,Pius Suter,C,VAN,28,82,21,18,39
86,8477987,Ryan Donato,C,CHI,28,82,18,21,39
86,8478109,Victor Olofsson,L,VGK,29,82,17,22,39
86,8474150,Mikael Backlund,C,CGY,35,82,16,23,39
86,8476461,Sean Couturier,C,PHI,32,82,16,23,39
86,8478020,Michael Amadio,C,OTT,28,82,15,24,39
86,8481624,Ilya Mikheyev,R,CHI,30,82,15,24,39
86,8482660,Kent Johnson,C,CBJ,22,82,15,24,39
86,8475722,Jason Zucker,L,BUF,32,82,14,25,39
86,8475200,Dmitry Orlov,D,CAR,33,82,13,26,39
86,8481656,Aliaksei Protas,C,WSH,23,82,13,26,39
86,8479365,Trent Frederic,C,BOS,26,82,25,13,38
86,8480009,Eeli Tolvanen,R,SEA,25,82,19,19,38
86,8478463,Anthony Beauvillier,L,PIT,27,82,18,20,38
86,8480220,Noah Cates,L,PHI,25,82,15,23,38
86,8477947,Sonny Milano,L,WSH,28,82,14,24,38
86,8481704,Juuso Parssinen,C,NSH,23,82,14,24,38
86,8481546,Cam York,D,PHI,23,82,12,26,38
86,8477346,MacKenzie Weegar,D,CGY,30,82,8,30,38
86,8476854,Hampus Lindholm,D,BOS,30,82,7,31,38
86,8476292,Ondrej Palat,L,NJD,33,82,18,19,37
86,8475760,Nick Bjugstad,C,UTA,32,82,17,20,37
86,8476480,Vladislav Namestnikov,C,WPG,32,82,16,21,37
86,8474715,Cam Atkinson,R,TBL,35,82,16,21,37
86,8480871,Adam Boqvist,D,FLA,24,82,15,22,37
86,8481553,Bobby Brink,R,PHI,23,82,15,22,37
86,8475763,Kevin Hayes,R,PIT,32,82,12,25,37
86,8479398,Samuel Girard,D,COL,26,82,10,27,37
86,8480873,Rasmus Sandin,D,WSH,24,82,5,32,37
86,8473422,Nick Foligno,L,CHI,37,82,19,17,36
86,8480188,Fabian Zetterlund,L,SJS,25,82,18,18,36
86,8474716,Jared Spurgeon,D,MIN,35,82,7,29,36
86,8480336,Sean Walker,D,CAR,30,82,7,29,36
86,8482089,Jake Neighbours,L,STL,22,82,24,11,35
86,8482125,Alexander Holtz,R,VGK,22,82,18,17,35
86,8478057,Dakota Joshua,C,VAN,28,82,15,20,35
86,8480806,Isac Lundestrom,C,ANA,25,82,10,25,35
86,8482803,Olen Zellweger,D,ANA,21,82,9,26,35
86,8476892,Colton Parayko,D,STL,31,82,5,30,35
86,8475799,Nino Niederreiter,R,WPG,32,82,19,15,34
86,8480802,Ryan McLeod,C,BUF,25,82,19,15,34
86,8481535,Nils Hoglander,L,VAN,24,82,17,17,34
86,8476392,Adam Lowry,C,WPG,31,82,17,17,34
86,8475848,Brendan Gallagher,R,MTL,32,82,16,18,34
86,8480068,Ryan Poehling,C,PHI,25,82,16,18,34
86,8479992,Michael Rasmussen,C,DET,25,82,15,19,34
86,8474189,Lars Eller,C,PIT,35,82,15,19,34
86,8476419,Jean-Gabriel Pageau,C,NYI,32,82,14,20,34
86,8476925,Colton Sissons,C,NSH,31,82,14,20,34
86,8481582,Nicholas Robertson,L,TOR,23,82,14,20,34
86,8475193,Tomas Tatar,L,NJD,34,82,12,22,34
86,8477498,Darnell Nurse,D,EDM,29,82,12,22,34
86,8475191,Reilly Smith,R,NYR,33,82,11,23,34
86,8478413,Jordan Greenway,L,BUF,27,82,9,25,34
86,8475218,Mattias Ekholm,D,EDM,34,82,9,25,34
86,8480434,Sean Durzi,D,UTA,26,82,7,27,34
86,8482655,J.J. Moser,D,TBL,24,82,5,29,34
86,8478507,John Marino,D,UTA,27,82,5,29,34
86,8483431,Logan Cooley,C,UTA,20,82,23,10,33
86,8476921,Jordan Martinook,L,CAR,32,82,16,17,33
86,8475768,Jaden Schwartz,C,SEA,32,82,15,18,33
86,8475149,Marcus Johansson,L,MIN,34,82,15,18,33
86,8476927,Teddy Blueger,C,VAN,30,82,14,19,33
86,8482105,Jake Sanderson,D,OTT,22,82,14,19,33
86,8477989,Christian Dvorak,C,MTL,28,82,14,19,33
86,8480748,Kiefer Sherwood,L,VAN,29,82,13,20,33
86,8479661,Tanner Jeannot,L,LAK,27,82,13,20,33
86,8484153,Leo Carlsson,C,ANA,20,82,11,22,33
86,8480113,Alex Iafallo,L,WPG,31,82,10,23,33
86,8476624,Barclay Goodrow,C,SJS,31,82,10,23,33
86,8480043,Timothy Liljegren,D,TOR,25,82,3,30,33
86,8479293,Brandon Tanev,L,SEA,33,82,16,16,32
86,8478542,Evan Rodrigues,C,FLA,31,82,15,17,32
86,8476474,Stefan Noesen,R,NJD,31,82,15,17,32
86,8478891,Mason Appleton,C,WPG,28,82,13,19,32
86,8479941,Justin Danforth,R,CBJ,31,82,12,20,32
86,8480144,David Kampf,C,TOR,29,82,12,20,32
86,8477507,Nikita Zadorov,D,BOS,29,82,11,21,32
86,8481032,Paul Cotter,C,NJD,25,82,10,22,32
86,8481481,Blake Lizotte,C,PIT,27,82,10,22,32
86,8477839,Conor Sheary,L,TBL,32,82,10,22,32
86,8478472,Mathieu Joseph,R,STL,27,82,9,23,32
86,8479390,Taylor Raddysh,R,WSH,26,82,9,23,32
86,8479371,Dante Fabbro,D,NSH,26,82,6,26,32
86,8476331,Dylan DeMelo,D,WPG,31,82,5,27,32
86,8480835,Jack Drury,C,CAR,24,82,16,15,31
86,8474149,Evgenii Dadonov,R,DAL,35,82,16,15,31
86,8476312,Josh Manson,D,COL,33,82,12,19,31
86,8476889,Radek Faksa,C,STL,30,82,11,20,31
86,8475171,Oliver Ekman-Larsson,D,TOR,33,82,10,21,31
86,8478500,Ivan Provorov,D,CBJ,27,82,6,25,31
86,8481606,Jordan Spence,D,LAK,23,82,5,26,31
86,8480849,Barrett Hayton,C,UTA,24,82,19,11,30
86,8476873,Mark Jankowski,C,NSH,30,82,15,15,30
86,8479316,Luke Kunin,C,SJS,27,82,15,15,30
86,8477450,Jason Dickinson,C,CHI,29,82,14,16,30
86,8482092,Ridly Greig,C,OTT,22,82,13,17,30
86,8475220,Marcus Foligno,L,MIN,33,82,12,18,30
86,8476897,Oskar Sundqvist,C,STL,30,82,11,19,30
86,8482666,Scott Morrow,D,CAR,22,82,10,20,30
86,8480003,Jesper Boqvist,C,FLA,26,82,9,21,30
86,8476885,Jacob Trouba,D,NYR,30,82,8,22,30
86,8475188,Brayden McNabb,D,VGK,33,82,7,23,30
86,8479402,Jake Bean,D,CGY,26,82,5,25,30
86,8481580,Connor McMichael,C,WSH,23,82,19,10,29
86,8481093,Rafael Harvey-Pinard,L,MTL,25,82,16,13,29
86,8481554,Kaapo Kakko,R,NYR,23,82,14,15,29
86,8479591,Michael Eyssimont,C,TBL,28,82,13,16,29
86,8478508,Yakov Trenin,C,MIN,27,82,12,17,29
86,8482122,Brock Faber,D,MIN,22,82,6,23,29
86,8480073,Erik Brannstrom,D,COL,25,82,5,24,29
86,8474574,Tyler Myers,D,VAN,34,82,4,25,29
86,8477969,Marcus Pettersson,D,PIT,28,82,4,25,29
86,8478882,Vladislav Gavrikov,D,LAK,29,82,4,25,29
86,8480893,Kirill Marchenko,R,CBJ,24,82,19,9,28
86,8476981,Josh Anderson,R,MTL,30,82,18,10,28
86,8477952,Robby Fabbri,C,ANA,28,82,18,10,28
86,8477953,Kasperi Kapanen,R,STL,28,82,14,14,28
86,8482133,Thomas Bordeleau,C,SJS,22,82,13,15,28
86,8480829,Jesperi Kotkaniemi,C,CAR,24,82,12,16,28
86,8476960,Andreas Athanasiou,C,CHI,30,82,11,17,28
86,8478013,Jake Walman,D,SJS,28,82,7,21,28
86,8479998,Mikey Anderson,D,LAK,25,82,7,21,28
86,8480855,Jack McBain,C,UTA,24,82,6,22,28
86,8478859,Niko Mikkola,D,FLA,28,82,5,23,28
86,8481568,Alex Vlasic,D,CHI,23,82,3,25,28
86,8481028,Martin Pospisil,C,CGY,25,82,16,11,27
86,8482111,Justin Barron,D,MTL,23,82,9,18,27
86,8482074,Connor Zary,C,CGY,23,82,9,18,27
86,8475855,Jesper Fast,R,CAR,33,82,9,18,27
86,8478911,Matt Roy,D,WSH,29,82,6,21,27
86,8480807,Mattias Samuelsson,D,BUF,24,82,4,23,27
86,8480281,Alexey Toropchenko,R,STL,25,82,18,8,26
86,8475842,Sam Carrick,C,NYR,32,82,16,10,26
86,8482077,Dylan Holloway,L,EDM,23,82,14,12,26
86,8479353,Brett Howden,C,VGK,26,82,12,14,26
86,8477903,Garnet Hathaway,R,PHI,33,82,11,15,26
86,8473533,Jordan Staal,C,CAR,36,82,10,16,26
86,8482117,Lukas Reichel,L,CHI,22,82,10,16,26
86,8476422,Mike Reilly,D,NYI,31,82,10,16,26
86,8482679,Matt Coronato,R,CGY,22,82,10,16,26
86,8480074,Alexandre Texier,C,STL,25,82,8,18,26
86,8477488,Brett Pesce,D,NJD,30,82,8,18,26
86,8477015,Connor Brown,R,EDM,30,82,7,19,26
86,8477369,Carson Soucy,D,VAN,30,82,6,20,26
86,8480172,Jan Rutta,D,SJS,34,82,6,20,26
86,8476429,Scott Mayfield,D,NYI,32,82,6,20,26
86,8477499,Rasmus Ristolainen,D,PHI,30,82,5,21,26
86,8476931,Jake McCabe,D,TOR,31,82,4,22,26
86,8475462,Radko Gudas,D,ANA,34,82,4,22,26
86,8473507,Jeff Petry,D,DET,37,82,3,23,26
86,8475690,Chris Tanev,D,TOR,35,82,2,24,26
86,8481477,Nico Sturm,C,SJS,29,82,12,13,25
86,8477931,Tomas Nosek,L,FLA,32,82,11,14,25
86,8481013,Jonatan Berggren,R,DET,24,82,10,15,25
86,8479996,Cody Glass,C,NSH,25,82,9,16,25
86,8476902,Esa Lindell,D,DAL,30,82,8,17,25
86,8479351,Sam Steel,C,DAL,26,82,7,18,25
86,8476525,Colin Miller,D,WPG,32,82,6,19,25
86,8476463,Jonas Brodin,D,MIN,31,82,5,20,25
86,8478851,Alexandre Carrier,D,NSH,28,82,5,20,25
86,8480049,Dylan Samberg,D,WPG,25,82,4,21,25
86,8481601,Simon Holmstrom,R,NYI,23,82,15,9,24
86,8476878,Zemgus Girgensons,L,TBL,30,82,15,9,24
86,8470621,Corey Perry,R,EDM,39,82,14,10,24
86,8484145,Zach Benson,L,BUF,19,82,14,10,24
86,8475343,Nic Dowd,C,WSH,34,82,13,11,24
86,8476278,Colin Blackwell,C,DAL,31,82,13,11,24
86,8479291,Kevin Rooney,C,CGY,31,82,11,13,24
86,8477392,Hudson Fasching,R,NYI,29,82,10,14,24
86,8477406,Mattias Janmark,C,EDM,32,82,9,15,24
86,8482624,Daniil Miromanov,D,CGY,27,82,8,16,24
86,8482141,Lukas Cormier,D,VGK,22,82,8,16,24
86,8480879,Jacob Bernard-Docker,D,OTT,24,82,8,16,24
86,8480878,Nils Lundkvist,D,DAL,24,82,7,17,24
86,8479980,Nicolas Hague,D,VGK,26,82,6,18,24
86,8476979,Erik Gustafsson,D,DET,32,82,5,19,24
86,8477435,Ryan Graves,D,PIT,29,82,5,19,24
86,8481178,Egor Zamula,D,PHI,24,82,3,21,24
86,8480813,Joe Veleno,C,DET,24,82,12,11,23
86,8475231,Casey Cizikas,C,NYI,33,82,12,11,23
86,8479393,Noah Gregor,C,OTT,26,82,12,11,23
86,8479414,Nathan Bastian,R,NJD,27,82,9,14,23
86,8480980,Connor Dewar,C,TOR,25,82,8,15,23
86,8483565,Nick Blankenburg,D,NSH,26,82,8,15,23
86,8482101,Danil Gushchin,L,SJS,22,82,6,17,23
86,8477506,Ryan Pulock,D,NYI,30,82,5,18,23
86,8474151,Ryan McDonagh,D,TBL,35,82,4,19,23
86,8478133,Jake Evans,C,MTL,28,82,4,19,23
86,8483490,Pavel Mintyukov,D,ANA,21,82,3,20,23
86,8476879,Cody Ceci,D,EDM,31,82,3,20,23
86,8475324,Nick Jensen,D,OTT,34,82,1,22,23
86,8480995,Pontus Holmberg,R,TOR,25,82,13,9,22
86,8484166,Adam Fantilli,C,CBJ,20,82,12,10,22
86,8482079,Marco Rossi,C,MIN,23,82,11,11,22
86,8484203,Bradly Nadeau,L,CAR,19,82,10,12,22
86,8479368,Max Jones,L,BOS,26,82,10,12,22
86,8478569,Noel Acciari,C,PIT,33,82,10,12,22
86,8478434,Keegan Kolesar,R,VGK,27,82,9,13,22
86,8483457,Lane Hutson,D,MTL,20,82,8,14,22
86,8480222,Sebastian Aho,D,PIT,28,82,4,18,22
86,8479983,Mario Ferraro,D,SJS,26,82,4,18,22
86,8482142,Jamie Drysdale,D,PHI,22,82,2,20,22
86,8482073,Braden Schneider,D,NYR,23,82,2,20,22
86,8476891,Matt Grzelcyk,D,PIT,30,82,1,21,22
86,8476967,Brett Kulak,D,EDM,30,82,1,21,22
86,8482155,Alex Laferriere,R,LAK,23,82,14,7,21
86,8477425,Miles Wood,L,COL,29,82,13,8,21
86,8482762,Simon Edvinsson,D,DET,21,82,11,10,21
86,8476442,Matt Nieto,L,PIT,32,82,10,11,21
86,8481517,Brett Leason,R,ANA,25,82,10,11,21
86,8483482,Tristan Luneau,D,ANA,20,82,10,11,21
86,8480789,Oliver Wahlstrom,R,NYI,24,82,10,11,21
86,8477220,Nate Schmidt,D,FLA,33,82,9,12,21
86,8478399,Jonas Siegenthaler,D,NJD,27,82,5,16,21
86,8478443,Brandon Carlo,D,BOS,28,82,4,17,21
86,8474013,Ian Cole,D,UTA,35,82,4,17,21
86,8477365,Connor Clifton,D,BUF,29,82,3,18,21
86,8475181,Nick Leddy,D,STL,33,82,3,18,21
86,8475233,David Savard,D,MTL,34,82,3,18,21
86,8480035,Henri Jokiharju,D,BUF,25,82,3,18,21
86,8477034,Jaycob Megna,D,FLA,32,82,3,18,21
86,8475718,Justin Holl,D,DET,32,82,2,19,21
86,8482259,Bobby McMann,C,TOR,28,82,14,6,20
86,8483524,Shane Wright,C,SEA,20,82,12,8,20
86,8476374,Sean Kuraly,C,CBJ,31,82,11,9,20
86,8480448,Parker Kelly,L,COL,25,82,10,10,20
86,8476469,Joel Armia,R,MTL,31,82,9,11,20
86,8482153,Brendan Brisson,C,VGK,23,82,7,13,20
86,8479324,Ryan Lindgren,D,NYR,26,82,6,14,20
86,8477919,Frederick Gaudreau,C,MIN,31,82,5,15,20
86,8475279,Ben Chiarot,D,DET,33,82,5,15,20
86,8470600,Ryan Suter,D,STL,39,82,4,16,20
86,8480860,Kevin Bahl,D,CGY,24,82,3,17,20
86,8478136,Jake Middleton,D,MIN,28,82,3,17,20
86,8477335,Kyle Burroughs,D,LAK,29,82,3,17,20
86,8476457,Adam Larsson,D,SEA,32,82,2,18,20
86,8482087,Kaiden Guhle,D,MTL,22,82,7,12,19
86,8479976,Juuso Valimaki,D,UTA,26,82,7,12,19
86,8477845,Trevor van Riemsdyk,D,WSH,33,82,6,13,19
86,8473453,Trevor Lewis,C,LAK,37,82,5,14,19
86,8481567,Henry Thrun,D,SJS,23,82,4,15,19
86,8482245,Artem Zub,D,OTT,29,82,2,17,19
86,8474673,TJ Brodie,D,CHI,34,82,1,18,19
86,8478416,Erik Cernak,D,TBL,27,82,1,18,19
86,8477353,Tyler Motte,C,DET,29,82,10,8,18
86,8481524,Bowen Byram,D,BUF,23,82,9,9,18
86,8478432,Christian Fischer,R,DET,27,82,8,10,18
86,8484149,Gavin Brindley,C,CBJ,20,82,8,10,18
86,8471677,Jack Johnson,D,CBJ,37,82,8,10,18
86,8481641,Joel Kiviranta,L,COL,28,82,7,11,18
86,8480990,Declan Chisholm,D,MIN,24,82,6,12,18
86,8475455,Brenden Dillon,D,NJD,34,82,5,13,18
86,8480246,Nick Perbix,D,TBL,26,82,1,17,18
86,8476858,Phillip Di Giuseppe,L,VAN,31,82,11,6,17
86,8476918,Jimmy Vesey,L,NYR,31,82,10,7,17
86,8480025,MacKenzie Entwistle,R,FLA,25,82,9,8,17
86,8483397,Marc McLaughlin,C,BOS,25,82,8,9,17
86,8481699,Aku Raty,R,UTA,23,82,7,10,17
86,8476467,Jamie Oleksiak,D,SEA,32,82,7,10,17
86,8482062,Cole Smith,L,NSH,29,82,7,10,17
86,8482659,Josh Doan,R,UTA,22,82,7,10,17
86,8478211,Dryden Hunt,L,CGY,29,82,6,11,17
86,8478178,Darren Raddysh,D,TBL,28,82,5,12,17
86,8477508,Curtis Lazar,C,NJD,29,82,3,14,17
86,8482809,Jackson Blake,R,CAR,21,82,3,14,17
86,8481708,Zac Jones,D,NYR,24,82,3,14,17
86,8478450,Parker Wotherspoon,D,BOS,27,82,2,15,17
86,8481014,Alexander Romanov,D,NYI,24,82,0,17,17
86,8482749,Joshua Roy,R,MTL,21,82,8,8,16
86,8482712,Oskar Olausson,R,COL,22,82,8,8,16
86,8483499,Liam Ohgren,L,MIN,20,82,7,9,16
86,8480021,Jack Studnicka,C,LAK,25,82,7,9,16
86,8483763,Maksymilian Szuber,D,UTA,22,82,6,10,16
86,8482858,Ryker Evans,D,SEA,23,82,5,11,16
86,8478468,Jeremy Lauzon,D,NSH,27,82,4,12,16
86,8481522,Peyton Krebs,C,BUF,23,82,3,13,16
86,8480950,Ilya Lyubushkin,D,DAL,30,82,3,13,16
86,8480834,Ty Emberson,D,SJS,24,82,2,14,16
86,8474567,Zach Bogosian,D,MIN,34,82,0,16,16
86,8480870,Bo Groulx,C,NYR,24,82,10,5,15
86,8483567,Georgii Merkulov,C,BOS,24,82,9,6,15
86,8482702,Logan Stankoven,C,DAL,21,82,7,8,15
86,8479359,Beck Malenstyn,L,BUF,26,82,7,8,15
86,8483468,Jiri Kulich,C,BUF,20,82,6,9,15
86,8483445,Cutter Gauthier,L,ANA,20,82,6,9,15
86,8483493,Frank Nazar,C,CHI,20,82,6,9,15
86,8483495,Simon Nemec,D,NJD,20,82,3,12,15
86,8478840,Will Borgen,D,SEA,28,82,3,12,15
86,8477938,Haydn Fleury,D,WPG,28,82,2,13,15
86,8479369,Andrew Peeke,D,BOS,26,82,0,15,15
86,8479638,Justin Brazeau,R,BOS,26,82,9,5,14
86,8482807,Ethan Del Mastro,D,CHI,21,82,8,6,14
86,8482733,Logan Mailloux,D,MTL,31,82,3,11,14
86,8476441,Joel Edmundson,D,LAK,31,82,3,11,14
86,8476822,Luke Glendening,C,TBL,35,82,7,6,13
86,8477505,Alexander Wennberg,C,SJS,30,82,6,7,13
86,8475177,Calvin de Haan,D,COL,33,82,5,8,13
86,8482516,Matthew Kessel,D,STL,24,82,5,8,13
86,8482145,Mavrik Bourque,C,DAL,22,82,5,8,13
86,8482470,Ilya Solovyov,D,CGY,24,82,3,10,13
86,8475762,Derek Forbort,D,VAN,32,82,2,11,13
86,8479442,Troy Stecher,D,EDM,30,82,3,9,12
86,8480796,Martin Fehervary,D,WSH,25,82,3,9,12
86,8481605,Jackson LaCombe,D,ANA,23,82,3,9,12
86,8474090,Brendan Smith,D,DAL,35,82,2,10,12
86,8483460,David Jiricek,D,CBJ,21,82,6,5,11
86,8482787,Nikita Chibrikov,R,WPG,31,82,6,5,11
86,8482859,Zack Ostapchuk,C,OTT,21,82,5,6,11
86,8483466,Kevin Korchinski,D,CHI,20,82,3,8,11
86,8474612,Travis Hamonic,D,OTT,34,82,1,10,11
86,8483012,Logan Morrison,C,SEA,22,82,5,5,10
86,8483471,Brad Lambert,C,WPG,31,82,4,6,10
86,8484911,Collin Graf,R,SJS,22,82,3,7,10
86,8481122,Simon Benoit,D,TOR,26,82,3,7,10
86,8482118,Sam Colangelo,R,ANA,23,82,6,3,9
86,8482166,Shakir Mukhamadullin,D,SJS,22,82,4,5,9
86,8483505,Matthew Poitras,C,BOS,20,82,3,6,9
86,8483489,Fraser Minten,C,TOR,31,82,2,7,9
86,8478874,Adam Gaudette,C,OTT,28,82,2,6,8
86,8482070,Mitchell Chaffee,R,TBL,26,82,5,2,7
86,8482713,Mackie Samoskevich,R,FLA,22,82,1,6,7
86,8476473,Connor Murphy,D,CHI,31,82,1,5,6
86,8476372,Nick Seeler,D,PHI,31,82,0,6,6
86,8474062,Riley Nash,C,NYR,35,82,0,6,6
86,8479576,Vincent Desharnais,D,VAN,28,82,2,3,5
86,8475790,Erik Gudbranson,D,CBJ,32,82,0,5,5
86,8470794,Joe Pavelski,C,,40,0,0,0,0
86,8481703,Valtteri Puustinen,R,PIT,25,0,0,0,0
86,8477950,Tony DeAngelo,D,,29,0,0,0,0
86,8481577,Philip Tomasino,C,NSH,23,0,0,0,0
86,8475197,Tyson Barrie,D,,33,0,0,0,0
86,8471218,Blake Wheeler,R,,38,0,0,0,0
86,8474157,Max Pacioretty,L,,36,0,0,0,0
86,8478466,Daniel Sprong,R,VAN,27,0,0,0,0
86,8475744,Evgeny Kuznetsov,C,,32,0,0,0,0
86,8481019,David Gustafsson,C,WPG,24,0,0,0,0
86,8475906,John Klingberg,D,,32,0,0,0,0
86,8479348,Kale Clague,D,BUF,26,0,0,0,0
86,8476952,Dominic Toninato,C,WPG,30,0,0,0,0
86,8473473,Milan Lucic,L,,36,0,0,0,0
86,8474037,James van Riemsdyk,L,,35,0,0,0,0
86,8474602,Justin Schultz,D,,34,0,0,0,0
86,8482222,Alexander Barabanov,L,,30,0,0,0,0
86,8479372,Josh Mahura,D,SEA,26,0,0,0,0
86,8479982,Conor Timmins,D,TOR,26,0,0,0,0
86,8474031,Kevin Shattenkirk,D,,35,0,0,0,0
86,8480008,Adam Ruzicka,C,,25,0,0,0,0
86,8481059,Scott Perunovich,D,STL,26,0,0,0,0
86,8480884,Calen Addison,D,,24,0,0,0,0
86,8476994,Vinnie Hinostroza,C,NSH,30,0,0,0,0
86,8478452,Caleb Jones,D,LAK,27,0,0,0,0
86,8480157,Calle Rosen,D,COL,30,0,0,0,0
86,8481609,Vladislav Kolyachonok,D,UTA,23,0,0,0,0
86,8479415,Michael McLeod,C,,26,0,0,0,0
86,8476919,Chris Tierney,C,,30,0,0,0,0
86,8479639,Dylan Coghlan,D,WPG,26,0,0,0,0
86,8478146,Matthew Highmore,C,OTT,28,0,0,0,0
86,8478970,Jalen Chatfield,D,CAR,28,0,0,0,0
86,8480205,Emil Bemstrom,C,PIT,25,0,0,0,0
86,8474884,Mike Hoffman,C,,35,0,0,0,0
86,8471274,Alex Goligoski,D,,39,0,0,0,0
86,8478104,Sammy Blais,L,,28,0,0,0,0
86,8474870,Tyler Johnson,C,,34,0,0,0,0
86,8476913,Devin Shore,C,MIN,30,0,0,0,0
86,8481598,Philip Broberg,D,EDM,23,0,0,0,0
86,8480058,Pierre-Olivier Joseph,D,STL,25,0,0,0,0
86,8480891,Michael Kesselring,D,UTA,24,0,0,0,0
86,8477979,Nicolas Aube-Kubel,R,BUF,28,0,0,0,0
86,8476871,Tanner Pearson,L,,32,0,0,0,0
86,8476393,Nick Cousins,C,,31,0,0,0,0
86,8479977,Kailer Yamamoto,R,,26,0,0,0,0
86,8479543,Michael Pezzetta,L,MTL,26,0,0,0,0
86,8477018,Ben Hutton,D,VGK,31,0,0,0,0
86,8480762,Eric Robinson,L,CAR,29,0,0,0,0
86,8474034,Pat Maroon,L,CHI,36,0,0,0,0
86,8481058,Jesse Ylönen,R,,25,0,0,0,0
86,8475179,Dmitry Kulikov,D,FLA,34,0,0,0,0
86,8481527,Kaedan Korczak,D,VGK,23,0,0,0,0
86,8473449,Kyle Okposo,R,,36,0,0,0,0
86,8482192,Isaak Phillips,D,CHI,23,0,0,0,0
86,8480727,Zach Whitecloud,D,VGK,28,0,0,0,0
86,8479346,Dillon Dube,C,,26,0,0,0,0
86,8480821,Filip Zadina,R,,25,0,0,0,0
86,8480001,Urho Vaakanainen,D,ANA,25,0,0,0,0
86,8470966,Mark Giordano,D,,41,0,0,0,0
86,8480853,Liam Foudy,C,,24,0,0,0,0
86,8475225,Craig Smith,C,CHI,35,0,0,0,0
86,8479972,Mason Shaw,C,WPG,26,0,0,0,0
86,8478451,Ethan Bear,D,WSH,27,0,0,0,0
86,8474040,Sam Gagner,C,,35,0,0,0,0
86,8480196,Jacob Bryson,D,BUF,27,0,0,0,0
86,8479984,Cal Foote,D,,26,0,0,0,0
86,8480011,Klim Kostin,C,SJS,25,0,0,0,0
86,8482176,Wyatt Kaiser,D,CHI,22,0,0,0,0
86,8476988,Matt Benning,D,SJS,30,0,0,0,0
86,8479370,Tyson Jost,C,CAR,26,0,0,0,0
86,8477464,Nic Petan,C,,29,0,0,0,0
86,8477380,Jonny Brodzinski,C,NYR,31,0,0,0,0
86,8480070,Ian Mitchell,D,BOS,25,0,0,0,0
86,8479315,Joey Anderson,R,CHI,26,0,0,0,0
86,8478099,Kevin Labanc,R,,29,0,0,0,0
86,8476874,Olli Maatta,D,DET,30,0,0,0,0
86,8475208,Brian Dumoulin,D,ANA,33,0,0,0,0
86,8478430,Oliver Kylington,D,,27,0,0,0,0
86,8479536,Axel Jonsson-Fjallby,L,WPG,26,0,0,0,0
86,8479671,Mathieu Olivier,R,CBJ,27,0,0,0,0
86,8471709,Marc-Edouard Vlasic,D,SJS,37,0,0,0,0
86,8479328,Julien Gauthier,R,NYI,27,0,0,0,0
86,8478421,A.J. Greer,L,FLA,28,0,0,0,0
86,8477573,Nathan Walker,L,STL,30,0,0,0,0
86,8481537,Nikita Okhotiuk,D,CGY,24,0,0,0,0
86,8474166,Alec Martinez,D,CHI,37,0,0,0,0
86,8470610,Zach Parise,L,,40,0,0,0,0
86,8477478,William Carrier,L,CAR,30,0,0,0,0
86,8479344,Jesse Puljujarvi,R,PIT,26,0,0,0,0
86,8480887,Jordan Harris,D,MTL,24,0,0,0,0
86,8478502,Dennis Gilbert,D,BUF,28,0,0,0,0
86,8482730,Brandt Clarke,D,LAK,21,0,0,0,0
86,8480355,Mark Kastelic,C,BOS,25,0,0,0,0
86,8475750,Jon Merrill,D,MIN,32,0,0,0,0
86,8475164,Jakob Silfverberg,R,,34,0,0,0,0
86,8477944,Jakub Vrana,L,,28,0,0,0,0
86,8479439,Jacob MacDonald,D,COL,31,0,0,0,0
86,8474568,Luke Schenn,D,NSH,35,0,0,0,0
86,8478454,Noah Juulsen,D,VAN,27,0,0,0,0
86,8475752,Tyler Pitlick,C,,33,0,0,0,0
86,8482148,Hendrix Lapierre,C,WSH,22,0,0,0,0
86,8481167,Brayden Pachal,D,CGY,25,0,0,0,0
86,8478043,Sam Lafferty,C,BUF,29,0,0,0,0
86,8479321,Lucas Johansen,D,,27,0,0,0,0
86,8471699,Andrew Cogliano,C,,37,0,0,0,0
86,8481521,Ronnie Attard,D,PHI,25,0,0,0,0
86,8481161,Jake Christiansen,D,CBJ,25,0,0,0,0
86,8479458,Nikita Zaitsev,D,,33,0,0,0,0
86,8479619,Michael Carcone,L,UTA,28,0,0,0,0
86,8479026,Philippe Myers,D,TOR,27,0,0,0,0
86,8477330,Dominik Kubalik,L,,29,0,0,0,0
86,8481617,Vasily Podkolzin,R,VAN,23,0,0,0,0
86,8481701,Santeri Hatakka,D,NJD,23,0,0,0,0
86,8479514,Rem Pitlick,C,,27,0,0,0,0
86,8477446,Michael McCarron,R,NSH,29,0,0,0,0
86,8470604,Jeff Carter,C,,39,0,0,0,0
86,8482241,Radim Zohorna,L,,28,0,0,0,0
86,8480289,Morgan Barron,C,WPG,26,0,0,0,0
86,8479379,Givani Smith,R,SJS,26,0,0,0,0
86,8480216,Jacob Peterson,C,,25,0,0,0,0
86,8477851,Jordan Oesterle,D,BOS,32,0,0,0,0
86,8484258,Sam Malinski,D,COL,26,0,0,0,0
86,8478904,Steven Lorentz,C,,28,0,0,0,0
86,8482095,Tyler Kleven,D,OTT,22,0,0,0,0
86,8480848,Ty Dellandrea,C,SJS,24,0,0,0,0
86,8476884,Derrick Pouliot,D,,30,0,0,0,0
86,8479336,Carl Grundstrom,R,SJS,27,0,0,0,0
86,8482964,Arber Xhekaj,D,MTL,23,0,0,0,0
86,8471686,Marc Staal,D,,37,0,0,0,0
86,8477887,Patrick Brown,C,BOS,32,0,0,0,0
86,8478495,Denis Gurianov,R,,27,0,0,0,0
86,8473504,Cal Clutterbuck,R,,37,0,0,0,0
86,8481550,Adam Beckman,L,NJD,23,0,0,0,0
86,8480845,Rasmus Kupari,C,WPG,24,0,0,0,0
86,8474009,Nick Bonino,C,,36,0,0,0,0
86,8478585,Derek Ryan,C,EDM,38,0,0,0,0
86,8477962,Brendan Lemieux,L,CAR,28,0,0,0,0
86,8482861,Vincent Iorio,D,WSH,22,0,0,0,0
86,8479378,Logan Stanley,D,WPG,26,0,0,0,0
86,8473446,Erik Johnson,D,PHI,36,0,0,0,0
86,8481743,Marc Del Gaizo,D,NSH,25,0,0,0,0
86,8477384,Josh Brown,D,EDM,30,0,0,0,0
86,8482165,Yan Kuznetsov,D,CGY,22,0,0,0,0
86,8478424,Jansen Harkins,C,ANA,27,0,0,0,0
86,8482144,Jack Thompson,D,SJS,22,0,0,0,0
86,8478512,Austin Czarnik,C,,32,0,0,0,0
86,8477527,Ross Johnston,L,ANA,30,0,0,0,0
86,8479383,Boris Katchouk,L,,26,0,0,0,0
86,8482094,Daemon Hunt,D,MIN,22,0,0,0,0
86,8481719,Maxwell Crozier,D,TBL,24,0,0,0,0
86,8480192,Johnathan Kovacevic,D,NJD,27,0,0,0,0
86,8479376,Victor Mete,D,,26,0,0,0,0
86,8482511,Mason Lohrei,D,BOS,23,0,0,0,0
86,8475825,Jani Hakanpää,D,,32,0,0,0,0
86,8478021,William Lagesson,D,DET,28,0,0,0,0
86,8475795,Dylan McIlrath,D,WSH,32,0,0,0,0
86,8477846,Ryan Carpenter,C,,33,0,0,0,0
86,8481056,Spencer Stastney,D,NSH,24,0,0,0,0
86,8481564,Ryan Johnson,D,BUF,23,0,0,0,0
86,8478017,Mark Friedman,D,VAN,29,0,0,0,0
86,8479320,Max Lajoie,D,SEA,27,0,0,0,0
86,8480075,Cameron Crotty,D,MIN,25,0,0,0,0
86,8484287,Cole McWard,D,VAN,23,0,0,0,0
86,8484254,Akito Hirose,D,VAN,25,0,0,0,0
86,8483407,Brandon Scanlin,D,NYR,25,0,0,0,0
86,8480274,Philip Kemp,D,EDM,25,0,0,0,0
86,8479522,Hardy Haman Aktell,D,WSH,26,0,0,0,0
86,8480007,Jonas Rondbjerg,R,VGK,25,0,0,0,0
86,8477454,Adam Erne,L,,29,0,0,0,0
86,8481679,Maxence Guenette,D,OTT,23,0,0,0,0
86,8480441,Trey Fix-Wolansky,R,CBJ,25,0,0,0,0
86,8483546,Marshall Rifai,D,TOR,26,0,0,0,0
86,8480084,Nick DeSimone,D,NJD,30,0,0,0,0
86,8481030,Jack St. Ivany,D,PIT,25,0,0,0,0
86,8481592,Jakob Pelletier,L,CGY,23,0,0,0,0
86,8478011,Louie Belpedio,D,PHI,28,0,0,0,0
86,8477930,Pierre-Edouard Bellemare,L,,39,0,0,0,0
86,8484321,Nikolas Matinpalo,D,OTT,26,0,0,0,0
86,8482067,Connor Mackey,D,NYR,28,0,0,0,0
86,8481806,Louis Crevier,D,CHI,23,0,0,0,0
86,8484326,Patrik Koch,D,UTA,28,0,0,0,0
86,8477971,Andreas Englund,D,LAK,28,0,0,0,0
86,8481751,Lukas Rousek,R,BUF,25,0,0,0,0
86,8481006,Tyler Tucker,D,STL,24,0,0,0,0
86,8476867,Brendan Gaunce,C,MIN,30,0,0,0,0
86,8479520,Brandon Duhaime,R,WSH,27,0,0,0,0
86,8477073,Kurtis MacDermid,L,NJD,30,0,0,0,0
86,8480874,Adam Ginning,D,PHI,24,0,0,0,0
86,8477473,Justin Bailey,R,SJS,29,0,0,0,0
86,8479066,Ryan Lomberg,L,CGY,30,0,0,0,0
86,8477070,Liam O'Brien,C,UTA,30,0,0,0,0
86,8474618,Marco Scandella,D,,34,0,0,0,0
86,8475797,Jarred Tinordi,D,,32,0,0,0,0
86,8481441,Joe Snively,C,DET,28,0,0,0,0
86,8477244,Chad Ruhwedel,D,NYR,34,0,0,0,0
86,8479772,Zack MacEwen,R,OTT,28,0,0,0,0
86,8481147,Reese Johnson,C,MIN,26,0,0,0,0
86,8481043,Cole Koepke,L,BOS,26,0,0,0,0
86,8483619,Filip Roos,D,OTT,25,0,0,0,0
86,8481541,Samuel Bolduc,D,NYI,24,0,0,0,0
86,8477810,Joel Hanley,D,CGY,33,0,0,0,0
86,8476907,Mackenzie MacEachern,L,,30,0,0,0,0
86,8482652,Walker Duehr,R,CGY,27,0,0,0,0
86,8477126,Jayson Megna,C,,34,0,0,0,0
86,8483398,Declan Carlile,D,TBL,31,0,0,0,0
86,8482929,Emil Lilleberg,D,TBL,23,0,0,0,0
86,8480880,Jakub Lauko,C,MIN,24,0,0,0,0
86,8480245,Olle Lycksell,R,PHI,25,0,0,0,0
86,8480252,Cole Guttman,C,CHI,25,0,0,0,0
86,8477467,Gustav Olofsson,D,SEA,30,0,0,0,0
86,8479968,Vinni Lettieri,C,BOS,29,0,0,0,0
86,8478400,Colin White,C,,27,0,0,0,0
86,8475755,Alexander Petrovic,D,DAL,32,0,0,0,0
86,8481812,Nikolai Knyzhov,D,,27,0,0,0,0
86,8481593,Jayden Struble,D,MTL,23,0,0,0,0
86,8481532,Alex Turcotte,C,LAK,23,0,0,0,0
86,8482126,Emil Andrae,D,PHI,31,0,0,0,0
86,8479944,Zach Aston-Reese,C,VGK,30,0,0,0,0
86,8471817,Ryan Reaves,R,TOR,37,0,0,0,0
86,8481206,John Ludvig,D,PIT,24,0,0,0,0
86,8481599,Victor Soderstrom,D,UTA,23,0,0,0,0
86,8480292,Carson Meyer,R,ANA,27,0,0,0,0
86,8482496,Nils Aman,C,VAN,24,0,0,0,0
86,8479718,Alex Barré-Boulet,C,MTL,27,0,0,0,0
86,8479994,Jaret Anderson-Dolan,C,WPG,25,0,0,0,0
86,8480184,Gustav Lindstrom,D,,26,0,0,0,0
86,8480890,Jan Jenik,R,OTT,24,0,0,0,0
86,8478067,Oskar Lindblom,L,,28,0,0,0,0
86,8476934,Brock McGinn,L,ANA,30,0,0,0,0
86,8479985,Cale Fleury,D,SEA,26,0,0,0,0
86,8484304,Uvis Balinskis,D,FLA,28,0,0,0,0
86,8479981,Jonah Gadjovich,L,FLA,26,0,0,0,0
86,8481716,Dmitri Voronkov,L,CBJ,24,0,0,0,0
86,8474709,Matt Martin,L,,35,0,0,0,0
86,8482634,Alex Steeves,C,TOR,25,0,0,0,0
86,8480823,Alexander Alexeyev,D,WSH,25,0,0,0,0
86,8477541,Dakota Mermis,D,TOR,30,0,0,0,0
86,8483491,Ivan Miroshnichenko,L,WSH,20,0,0,0,0
86,8478477,Mitchell Stephens,C,SEA,27,0,0,0,0
86,8481543,Nikita Alexandrov,C,STL,24,0,0,0,0
86,8479423,Alex Nylander,L,,26,0,0,0,0
86,8482451,Mikael Pyyhtia,L,CBJ,23,0,0,0,0
86,8478831,Kevin Stenlund,C,UTA,28,0,0,0,0
86,8480306,Grant Hutton,D,NYI,29,0,0,0,0
86,8478028,Fredrik Olofsson,L,,28,0,0,0,0
86,8477462,Robert Hagg,D,VGK,29,0,0,0,0
86,8477320,Anton Blidh,L,NYR,29,0,0,0,0
86,8482157,Will Cuylle,L,NYR,22,0,0,0,0
86,8482737,Zack Bolduc,C,STL,21,0,0,0,0
86,8481239,Samuel Fagemo,L,,24,0,0,0,0
86,8481600,Tobias Bjornfot,D,FLA,23,0,0,0,0
86,8478409,Anthony Richard,C,PHI,28,0,0,0,0
86,8474145,Robert Bortuzzo,D,,35,0,0,0,0
86,8475958,Michael Sgarbossa,C,WSH,32,0,0,0,0
86,8479986,Kole Lind,R,DAL,26,0,0,0,0
86,8479249,Andrew Poturalski,C,SJS,30,0,0,0,0
86,8479362,Riley Tufte,L,BOS,26,0,0,0,0
86,8479991,Jake Leschyshyn,C,NYR,25,0,0,0,0
86,8479587,Rhett Gardner,C,PHI,28,0,0,0,0
86,8482744,James Malatesta,L,CBJ,21,0,0,0,0
86,8478854,Ryan Shea,D,PIT,27,0,0,0,0
86,8481591,Sam Poulin,R,,23,0,0,0,0
86,8483512,Matt Savoie,C,EDM,20,0,0,0,0
86,8482102,Vasily Ponomarev,C,PIT,22,0,0,0,0
86,8482162,Roby Jarventie,L,EDM,22,0,0,0,0
86,8481016,Ruslan Iskhakov,C,,24,0,0,0,0
86,8482172,Landon Slaggert,L,CHI,22,0,0,0,0
86,8482747,Brennan Othmann,L,NYR,21,0,0,0,0
86,8480031,Maxime Comtois,L,,25,0,0,0,0
86,8480226,Marián Studenic,R,,26,0,0,0,0
86,8478408,Travis Dermott,D,,28,0,0,0,0
86,8481518,Nolan Foote,L,NJD,24,0,0,0,0
86,8479419,Brett Murray,L,BUF,26,0,0,0,0
86,8482088,Justin Sourdif,R,FLA,22,0,0,0,0
86,8482201,Gage Goncalves,C,TBL,23,0,0,0,0
86,8481578,Graeme Clarke,R,MIN,23,0,0,0,0
86,8482177,Marat Khusnutdinov,C,MIN,22,0,0,0,0
86,8481754,Nikita Nesterenko,C,ANA,23,0,0,0,0
86,8483531,Brian Halonen,L,NJD,25,0,0,0,0
86,8483920,Pierrick Dube,R,WSH,23,0,0,0,0
86,8480851,Akil Thomas,C,LAK,24,0,0,0,0
86,8475235,Nicolas Deslauriers,L,PHI,33,0,0,0,0
86,8482476,Emil Heineman,L,MTL,23,0,0,0,0
86,8477149,Scott Sabourin,R,SJS,32,0,0,0,0
86,8483549,Lucas Condotta,L,MTL,27,0,0,0,0
86,8482765,Isak Rosen,R,BUF,21,0,0,0,0
86,8481237,Kyle MacLean,C,NYI,25,0,0,0,0
86,8481024,Linus Karlsson,C,VAN,25,0,0,0,0
86,8481690,Tyler Angle,C,,24,0,0,0,0
86,8483570,Ben Meyers,C,SEA,26,0,0,0,0
86,8481655,Cole Schwindt,R,CGY,23,0,0,0,0
86,8481462,Mason Morelli,L,VGK,28,0,0,0,0
86,8483401,Marc Johnstone,R,PIT,28,0,0,0,0
86,8478956,Samuel Laberge,L,NJD,27,0,0,0,0
86,8479533,Joona Koppanen,L,,26,0,0,0,0
86,8482197,Adam Raska,R,MIN,23,0,0,0,0
86,8482250,Callahan Burke,C,VGK,27,0,0,0,0
86,8482784,Zach Dean,C,STL,21,0,0,0,0
86,8484255,Jason Polin,R,COL,25,0,0,0,0
86,8481077,John Leonard,L,,26,0,0,0,0
86,8481534,Raphael Lavoie,C,EDM,24,0,0,0,0
86,8483609,Adam Klapka,R,CGY,24,0,0,0,0
86,8482751,Ryan Winterton,C,SEA,21,0,0,0,0
86,8480267,Sammy Walker,C,MIN,25,0,0,0,0
86,8475766,Austin Watson,L,,32,0,0,0,0
86,8482460,Matt Rempe,C,NYR,22,0,0,0,0
86,8481065,Angus Crookshank,L,OTT,25,0,0,0,0
86,8481070,Hugh McGing,L,,26,0,0,0,0
86,8476323,Max McCormick,L,SEA,32,0,0,0,0
86,8483395,Arshdeep Bains,L,VAN,23,0,0,0,0
86,8484259,Ondrej Pavel,C,COL,31,0,0,0,0
86,8483432,Luca Del Bel Belluz,C,CBJ,31,0,0,0,0
86,8483045,Cameron Butler,R,CBJ,31,0,0,0,0
86,8482061,Brandon Biro,L,SEA,26,0,0,0,0
86,8477401,John Hayden,C,SEA,29,0,0,0,0
86,8475278,Byron Froese,C,,33,0,0,0,0
86,8478446,Glenn Gawdin,C,LAK,27,0,0,0,0
86,8477993,Justin Kirkland,C,CGY,28,0,0,0,0
86,8482147,Jean-Luc Foudy,C,COL,22,0,0,0,0
86,8480032,Shane Bowers,C,NJD,25,0,0,0,0
86,8479330,Brandon Gignac,C,MTL,27,0,0,0,0
86,8480776,Sheldon Rempal,R,,29,0,0,0,0
86,8475413,Justin Dowling,C,NJD,34,0,0,0,0
86,8481726,Adam Edstrom,C,NYR,24,0,0,0,0
86,8480844,Grigori Denisenko,L,VGK,24,0,0,0,0
86,8478147,Bokondji Imama,L,PIT,28,0,0,0,0
86,8478881,Brett Seney,L,CHI,28,0,0,0,0
86,8483630,Pavol Regenda,L,ANA,25,0,0,0,0
86,8480836,Jonathan Gruden,C,,24,0,0,0,0
86,8484314,Jiri Smejkal,L,,28,0,0,0,0
86,8475780,Chris Wagner,R,COL,33,0,0,0,0
86,8479546,Oskar Steen,C,,26,0,0,0,0
86,8483597,Milos Kelemen,L,UTA,25,0,0,0,0
86,8481789,Tye Kartye,L,SEA,23,0,0,0,0
86,8484325,Waltteri Merela,C,TBL,26,0,0,0,0
86,8479421,Jacob Moverare,D,LAK,26,0,0,0,0
86,8481585,Egor Afanasyev,L,SJS,23,0,0,0,0
86,8479547,Matthew Phillips,R,,26,0,0,0,0
86,8479367,William Lockwood,R,FLA,26,0,0,0,0
86,8476915,Jujhar Khaira,L,,30,0,0,0,0
86,8481422,Jacob Lucchini,C,NSH,29,0,0,0,0
86,8480468,James Hamblin,L,EDM,25,0,0,0,0
86,8478051,Max Willman,C,NJD,29,0,0,0,0
86,8481556,John Beecher,C,BOS,23,0,0,0,0
86,8478078,Rourke Chartier,C,,28,0,0,0,0
87,8476453,Nikita Kucherov,R,TBL,31,82,41,105,146
87,8477492,Nathan MacKinnon,C,COL,29,82,50,85,135
87,8479318,Auston Matthews,C,TOR,27,82,66,66,132
87,8478402,Connor McDavid,C,EDM,27,82,45,83,128
87,8477939,William Nylander,R,TOR,28,82,46,75,121
87,8482116,Tim Stützle,C,OTT,22,82,32,82,114
87,8477956,David Pastrnak,R,BOS,28,82,53,60,113
87,8480069,Cale Makar,D,COL,26,82,23,88,111
87,8478550,Artemi Panarin,L,NYR,33,82,42,68,110
87,8481559,Jack Hughes,C,NJD,23,82,39,70,109
87,8480800,Quinn Hughes,D,VAN,25,82,11,93,104
87,8476468,J.T. Miller,C,VAN,31,82,40,62,102
87,8475913,Mark Stone,R,VGK,32,82,32,70,102
87,8477404,Jake Guentzel,C,TBL,30,82,54,47,101
87,8480027,Jason Robertson,L,DAL,25,82,38,62,100
87,8479314,Matthew Tkachuk,L,FLA,27,82,31,68,99
87,8471675,Sidney Crosby,C,PIT,37,82,42,56,98
87,8477493,Aleksander Barkov,C,FLA,29,82,28,70,98
87,8478864,Kirill Kaprizov,L,MIN,27,82,41,56,97
87,8480208,Drake Batherson,R,OTT,26,82,37,59,96
87,8475172,Nazem Kadri,C,CGY,34,82,33,61,94
87,8479323,Adam Fox,D,NYR,26,82,21,72,93
87,8478445,Mathew Barzal,C,NYI,27,82,28,64,92
87,8479420,Tage Thompson,C,BUF,27,82,43,48,91
87,8479343,Clayton Keller,R,UTA,26,82,38,52,90
87,8478398,Kyle Connor,L,WPG,28,82,30,60,90
87,8478403,Jack Eichel,C,VGK,28,82,40,49,89
87,8476460,Mark Scheifele,C,WPG,31,82,40,49,89
87,8478439,Travis Konecny,R,PHI,27,82,34,55,89
87,8477946,Dylan Larkin,C,DET,28,82,33,56,89
87,8477933,Sam Reinhart,C,FLA,29,82,46,41,87
87,8478427,Sebastian Aho,C,CAR,27,82,38,49,87
87,8476389,Vincent Trocheck,C,NYR,31,82,37,50,87
87,8476459,Mika Zibanejad,C,NYR,31,82,34,53,87
87,8478420,Mikko Rantanen,R,COL,28,82,41,45,86
87,8478010,Brayden Point,C,TBL,28,82,40,46,86
87,8479337,Alex DeBrincat,R,DET,27,82,26,60,86
87,8479385,Jordan Kyrou,C,STL,26,82,44,40,84
87,8480801,Brady Tkachuk,L,OTT,25,82,34,50,84
87,8477942,Kevin Fiala,L,LAK,28,82,30,54,84
87,8480023,Robert Thomas,C,STL,25,82,23,61,84
87,8476346,Johnny Gaudreau,L,CBJ,31,82,22,62,84
87,8477409,Carter Verhaeghe,C,FLA,29,82,39,44,83
87,8480839,Rasmus Dahlin,D,BUF,24,82,18,65,83
87,8476887,Filip Forsberg,L,NSH,30,82,39,43,82
87,8477934,Leon Draisaitl,C,EDM,29,82,34,48,82
87,8477949,Alex Tuch,R,BUF,28,82,33,48,81
87,8474564,Steven Stamkos,C,NSH,34,82,32,48,80
87,8480002,Nico Hischier,C,NJD,25,82,36,43,79
87,8471215,Evgeni Malkin,C,PIT,38,82,33,45,78
87,8476881,Tomas Hertl,C,VGK,31,82,29,49,78
87,8481523,Kirby Dach,C,MTL,23,82,14,64,78
87,8479407,Jesper Bratt,L,NJD,26,82,25,52,77
87,8474141,Patrick Kane,R,DET,36,82,32,44,76
87,8478975,Mason Marchment,L,DAL,29,82,27,49,76
87,8476539,Jonathan Marchessault,R,NSH,34,82,44,31,75
87,8475166,John Tavares,C,TOR,34,82,31,44,75
87,8476905,Chandler Stephenson,C,SEA,30,82,25,50,75
87,8475810,Bryan Rust,R,PIT,32,82,37,37,74
87,8477496,Elias Lindholm,C,BOS,30,82,32,42,74
87,8474150,Mikael Backlund,C,CGY,35,82,26,48,74
87,8476853,Morgan Rielly,D,TOR,30,82,10,64,74
87,8481540,Cole Caufield,R,MTL,23,82,37,36,73
87,8475794,Tyler Seguin,C,DAL,32,82,34,39,73
87,8477951,Nick Schmaltz,C,UTA,28,82,29,44,73
87,8476454,Ryan Nugent-Hopkins,C,EDM,31,82,20,53,73
87,8471214,Alex Ovechkin,L,WSH,39,82,41,31,72
87,8481557,Matt Boldy,L,MIN,23,82,32,40,72
87,8479542,Brandon Hagel,L,TBL,26,82,32,40,72
87,8476462,Dougie Hamilton,D,NJD,31,82,22,50,72
87,8480830,Andrei Svechnikov,R,CAR,24,82,34,37,71
87,8480036,Miro Heiskanen,D,DAL,25,82,14,57,71
87,8480012,Elias Pettersson,C,VAN,26,82,35,35,70
87,8478440,Dylan Strome,C,WSH,27,82,20,50,70
87,8480803,Evan Bouchard,D,EDM,25,82,9,61,70
87,8477500,Bo Horvat,C,NYI,29,82,31,38,69
87,8475168,Matt Duchene,C,DAL,33,82,28,41,69
87,8477447,Shea Theodore,D,VGK,29,82,19,50,69
87,8482159,Tyson Foerster,R,PHI,22,82,39,29,68
87,8478042,Viktor Arvidsson,R,EDM,31,82,32,36,68
87,8476456,Jonathan Huberdeau,C,CGY,31,82,20,48,68
87,8478438,Tommy Novak,C,NSH,27,82,19,49,68
87,8475167,Victor Hedman,D,TBL,34,82,12,56,68
87,8477960,Adrian Kempe,R,LAK,28,82,33,34,67
87,8481596,Shane Pinto,C,OTT,24,82,26,41,67
87,8475158,Ryan O'Reilly,C,NSH,33,82,26,41,67
87,8474679,Gustav Nyquist,C,NSH,35,82,21,45,66
87,8473512,Claude Giroux,R,OTT,36,82,20,46,66
87,8476448,William Karlsson,C,VGK,31,82,38,27,65
87,8477402,Pavel Buchnevich,L,STL,29,82,27,38,65
87,8482078,Lucas Raymond,L,DET,22,82,24,41,65
87,8474590,John Carlson,D,WSH,34,82,14,51,65
87,8475754,Brock Nelson,C,NYI,33,82,32,32,64
87,8482093,Seth Jarvis,C,CAR,22,82,31,33,64
87,8477940,Nikolaj Ehlers,L,WPG,28,82,26,38,64
87,8481711,Matias Maccelli,L,UTA,24,82,24,40,64
87,8474600,Roman Josi,D,NSH,34,82,18,46,64
87,8478460,Zach Werenski,D,CBJ,27,82,18,46,64
87,8480865,Noah Dobson,D,NYI,24,82,9,55,64
87,8474578,Erik Karlsson,D,PIT,34,82,8,56,64
87,8477501,Valeri Nichushkin,R,COL,29,82,33,30,63
87,8478873,Troy Terry,R,ANA,27,82,29,34,63
87,8482745,Mason McTavish,C,ANA,21,82,27,36,63
87,8482149,Cole Perfetti,C,WPG,22,82,26,37,63
87,8477407,Anthony Duclair,L,NYI,29,82,24,39,63
87,8475170,Brayden Schenn,C,STL,33,82,21,42,63
87,8475692,Mats Zuccarello,R,MIN,37,82,20,43,63
87,8478414,Timo Meier,R,NJD,28,82,33,29,62
87,8481068,Yegor Sharangovich,C,CGY,26,82,33,29,62
87,8479400,Pierre-Luc Dubois,L,WSH,26,82,29,33,62
87,8475184,Chris Kreider,L,NYR,33,82,29,33,62
87,8475765,Vladimir Tarasenko,R,DET,33,82,26,36,62
87,8480039,Martin Necas,C,CAR,25,82,23,39,62
87,8478038,Devon Toews,D,COL,30,82,17,45,62
87,8477932,Aaron Ekblad,D,FLA,28,82,16,46,62
87,8478047,Michael Bunting,L,PIT,29,82,20,41,61
87,8476882,Teuvo Teravainen,L,CHI,30,82,18,43,61
87,8475726,Tyler Toffoli,C,SJS,32,82,27,33,60
87,8482124,Quinton Byfield,R,LAK,22,82,25,35,60
87,8474102,David Perron,L,OTT,36,82,25,35,60
87,8475191,Reilly Smith,R,NYR,33,82,23,37,60
87,8481528,Dylan Cozens,C,BUF,23,82,19,41,60
87,8471724,Kris Letang,D,PIT,37,82,15,45,60
87,8475786,Zach Hyman,L,EDM,32,82,30,29,59
87,8478519,Anthony Cirelli,C,TBL,27,82,28,31,59
87,8482097,Jack Quinn,R,BUF,23,82,28,31,59
87,8473419,Brad Marchand,L,BOS,36,82,27,32,59
87,8476483,Rickard Rakell,R,PIT,31,82,27,32,59
87,8473994,Jamie Benn,L,DAL,35,82,26,33,59
87,8477497,Sean Monahan,C,CBJ,30,82,26,33,59
87,8478449,Roope Hintz,C,DAL,28,82,24,35,59
87,8477504,Josh Morrissey,D,WPG,29,82,12,47,59
87,8475169,Evander Kane,L,EDM,33,82,28,30,58
87,8477503,Max Domi,C,TOR,29,82,15,43,58
87,8478474,Lawson Crouse,L,UTA,27,82,33,24,57
87,8475768,Jaden Schwartz,C,SEA,32,82,23,34,57
87,8477451,Ryan Hartman,R,MIN,30,82,22,35,57
87,8471685,Anze Kopitar,C,LAK,37,82,20,37,57
87,8478407,Vince Dunn,D,SEA,28,82,10,47,57
87,8477935,Sam Bennett,C,FLA,28,82,30,26,56
87,8479675,Trevor Moore,L,LAK,29,82,28,28,56
87,8474053,Logan Couture,C,SJS,35,82,26,30,56
87,8480015,Owen Tippett,R,PHI,25,82,25,31,56
87,8482665,Matty Beniers,C,SEA,22,82,24,32,56
87,8477416,Oliver Bjorkstrand,R,SEA,29,82,20,36,56
87,8478396,Noah Hanifin,D,VGK,27,82,13,43,56
87,8478469,Thomas Chabot,D,OTT,27,82,11,45,56
87,8475784,Jeff Skinner,C,EDM,32,82,30,25,55
87,8476438,Brandon Saad,L,STL,32,82,28,27,55
87,8480797,Joel Farabee,L,PHI,24,82,25,30,55
87,8478493,Joel Eriksson Ek,C,MIN,27,82,21,34,55
87,8482113,Anton Lundell,C,FLA,23,82,21,34,55
87,8480018,Nick Suzuki,C,MTL,25,82,20,35,55
87,8481533,Trevor Zegras,C,ANA,23,82,19,36,55
87,8478462,Nicolas Roy,C,VGK,27,82,19,36,55
87,8474565,Alex Pietrangelo,D,VGK,34,82,17,38,55
87,8481560,Arthur Kaliyev,R,LAK,23,82,30,24,54
87,8475791,Taylor Hall,L,CHI,33,82,25,29,54
87,8478046,Danton Heinen,L,VAN,29,82,25,29,54
87,8473986,Alex Killorn,L,ANA,35,82,22,32,54
87,8475745,Charlie Coyle,C,BOS,32,82,20,34,54
87,8478542,Evan Rodrigues,C,FLA,31,82,18,36,54
87,8478397,Rasmus Andersson,D,CGY,28,82,15,39,54
87,8482175,JJ Peterka,R,BUF,22,82,30,23,53
87,8475314,Anders Lee,L,NYI,34,82,27,26,53
87,8479339,Patrik Laine,L,CBJ,26,82,20,33,53
87,8477948,Travis Sanheim,D,PHI,28,82,17,36,53
87,8478856,Conor Garland,R,VAN,28,82,15,38,53
87,8479325,Charlie McAvoy,D,BOS,27,82,11,42,53
87,8480014,Gabriel Vilardi,C,WPG,25,82,34,18,52
87,8478366,Frank Vatrano,R,ANA,30,82,28,24,52
87,8477479,Tyler Bertuzzi,L,CHI,29,82,23,29,52
87,8476399,Blake Coleman,C,CGY,33,82,22,30,52
87,8479999,Casey Mittelstadt,C,COL,26,82,21,31,52
87,8477986,Brandon Montour,D,SEA,30,82,16,36,52
87,8482671,Owen Power,D,BUF,22,82,11,41,52
87,8480028,Morgan Frost,C,PHI,25,82,10,42,52
87,8481542,Moritz Seider,D,DET,23,82,10,42,52
87,8480064,Josh Norris,C,OTT,25,82,31,20,51
87,8478444,Brock Boeser,R,VAN,27,82,27,24,51
87,8482740,Wyatt Johnston,C,DAL,21,82,27,24,51
87,8479992,Michael Rasmussen,C,DET,25,82,25,26,51
87,8477494,Jonathan Drouin,L,COL,29,82,14,37,51
87,8478472,Mathieu Joseph,R,STL,27,82,13,38,51
87,8477955,Jared McCann,L,SEA,28,82,20,30,50
87,8476872,Scott Laughton,C,PHI,30,82,13,37,50
87,8482110,Dawson Mercer,C,NJD,23,82,22,27,49
87,8484144,Connor Bedard,C,CHI,19,82,22,27,49
87,8482109,Alexis Lafrenière,L,NYR,23,82,18,31,49
87,8477495,Seth Jones,D,CHI,30,82,12,37,49
87,8477426,Nicholas Paul,L,TBL,29,82,25,23,48
87,8477476,Artturi Lehkonen,L,COL,29,82,22,26,48
87,8482667,William Eklund,L,SJS,22,82,21,27,48
87,8479987,Morgan Geekie,C,BOS,26,82,16,32,48
87,8476792,Torey Krug,D,STL,33,82,15,33,48
87,8481186,Logan O'Connor,R,COL,28,82,27,20,47
87,8471698,T.J. Oshie,R,WSH,38,82,26,21,47
87,8478498,Jake DeBrusk,L,VAN,28,82,26,21,47
87,8482146,Luke Evangelista,R,NSH,22,82,26,21,47
87,8480078,Filip Chytil,C,NYR,25,82,18,29,47
87,8482705,Cole Sillinger,C,CBJ,21,82,15,32,47
87,8470613,Brent Burns,D,CAR,39,82,13,34,47
87,8479345,Jakob Chychrun,D,WSH,26,82,10,37,47
87,8482055,Drew O'Connor,L,PIT,26,82,29,17,46
87,8477998,Warren Foegele,L,LAK,28,82,17,29,46
87,8476479,Phillip Danault,C,LAK,31,82,16,30,46
87,8480188,Fabian Zetterlund,L,SJS,25,82,16,30,46
87,8476875,Mike Matheson,D,MTL,30,82,12,34,46
87,8475753,Justin Faulk,D,STL,32,82,11,35,46
87,8481581,Thomas Harley,D,DAL,23,82,10,36,46
87,8476432,Boone Jenner,C,CBJ,31,82,30,15,45
87,8475722,Jason Zucker,L,BUF,32,82,23,22,45
87,8476880,Tom Wilson,R,WSH,30,82,22,23,45
87,8480849,Barrett Hayton,C,UTA,24,82,21,24,45
87,8480220,Noah Cates,L,PHI,25,82,20,25,45
87,8478057,Dakota Joshua,C,VAN,28,82,20,25,45
87,8475760,Nick Bjugstad,C,UTA,32,82,19,26,45
87,8475151,Kyle Palmieri,C,NYI,33,82,17,28,45
87,8474586,Jordan Eberle,R,SEA,34,82,17,28,45
87,8482684,Luke Hughes,D,NJD,21,82,16,29,45
87,8476906,Shayne Gostisbehere,D,CAR,31,82,11,34,45
87,8477498,Darnell Nurse,D,EDM,29,82,10,35,45
87,8479410,Mikhail Sergachev,D,UTA,26,82,7,38,45
87,8481554,Kaapo Kakko,R,NYR,23,82,27,17,44
87,8477456,J.T. Compher,L,DET,29,82,20,24,44
87,8481553,Bobby Brink,R,PHI,23,82,19,25,44
87,8475793,Ryan Johansen,C,PHI,32,82,17,27,44
87,8480798,Philipp Kurashev,C,CHI,25,82,16,28,44
87,8475798,Mikael Granlund,C,SJS,32,82,15,29,44
87,8477964,Ivan Barbashev,C,VGK,29,82,15,29,44
87,8476292,Ondrej Palat,L,NJD,33,82,14,30,44
87,8478401,Pavel Zacha,C,BOS,27,82,12,32,44
87,8481604,Pavel Dorofeyev,L,VGK,24,82,25,18,43
87,8480009,Eeli Tolvanen,R,SEA,25,82,21,22,43
87,8482699,Dylan Guenther,R,UTA,21,82,18,25,43
87,8476925,Colton Sissons,C,NSH,31,82,18,25,43
87,8482660,Kent Johnson,C,CBJ,22,82,15,28,43
87,8480434,Sean Durzi,D,UTA,26,82,13,30,43
87,8477987,Ryan Donato,C,CHI,28,82,12,31,43
87,8476958,Jaccob Slavin,D,CAR,30,82,11,32,43
87,8480145,Neal Pionk,D,WPG,29,82,8,35,43
87,8481582,Nicholas Robertson,L,TOR,23,82,24,18,42
87,8482092,Ridly Greig,C,OTT,22,82,23,19,42
87,8476419,Jean-Gabriel Pageau,C,NYI,32,82,20,22,42
87,8475218,Mattias Ekholm,D,EDM,34,82,13,29,42
87,8477952,Robby Fabbri,C,ANA,28,82,12,30,42
87,8479425,Filip Hronek,D,VAN,27,82,10,32,42
87,8477021,Alex Kerfoot,C,UTA,30,82,10,32,42
87,8476869,Brady Skjei,D,NSH,30,82,8,34,42
87,8475763,Kevin Hayes,R,PIT,32,82,21,20,41
87,8475714,Calle Jarnkrok,C,TOR,33,82,20,21,41
87,8483808,Andrei Kuzmenko,L,CGY,28,82,25,15,40
87,8481624,Ilya Mikheyev,R,CHI,30,82,22,18,40
87,8478115,Pierre Engvall,L,NYI,28,82,21,19,40
87,8474641,Adam Henrique,C,EDM,34,82,19,21,40
87,8480748,Kiefer Sherwood,L,VAN,29,82,19,21,40
87,8480817,K'Andre Miller,D,NYR,24,82,17,23,40
87,8478233,Andrew Mangiapane,L,WSH,28,82,16,24,40
87,8477444,Andre Burakovsky,L,SEA,29,82,15,25,40
87,8477429,Andrew Copp,C,DET,30,82,12,28,40
87,8477346,MacKenzie Weegar,D,CGY,30,82,6,34,40
87,8483431,Logan Cooley,C,UTA,20,82,21,18,39
87,8478463,Anthony Beauvillier,L,PIT,27,82,20,19,39
87,8479365,Trent Frederic,C,BOS,26,82,19,20,39
87,8475848,Brendan Gallagher,R,MTL,32,82,19,20,39
87,8477953,Kasperi Kapanen,R,STL,28,82,17,22,39
87,8475287,Erik Haula,L,NJD,33,82,16,23,39
87,8482720,Matthew Knies,L,TOR,22,82,16,23,39
87,8474149,Evgenii Dadonov,R,DAL,35,82,15,24,39
87,8474715,Cam Atkinson,R,TBL,35,82,14,25,39
87,8482125,Alexander Holtz,R,VGK,22,82,14,25,39
87,8476960,Andreas Athanasiou,C,CHI,30,82,13,26,39
87,8478458,Jack Roslovic,C,CAR,27,82,12,27,39
87,8479525,Ross Colton,C,COL,28,82,22,16,38
87,8481580,Connor McMichael,C,WSH,23,82,22,16,38
87,8475799,Nino Niederreiter,R,WPG,32,82,20,18,38
87,8478055,Gustav Forsling,D,FLA,28,82,14,24,38
87,8482105,Jake Sanderson,D,OTT,22,82,12,26,38
87,8481546,Cam York,D,PHI,23,82,11,27,38
87,8480873,Rasmus Sandin,D,WSH,24,82,6,32,38
87,8480043,Timothy Liljegren,D,TOR,25,82,4,34,38
87,8474563,Drew Doughty,D,LAK,35,82,3,35,38
87,8476918,Jimmy Vesey,L,NYR,31,82,23,14,37
87,8477450,Jason Dickinson,C,CHI,29,82,20,17,37
87,8481656,Aliaksei Protas,C,WSH,23,82,16,21,37
87,8480855,Jack McBain,C,UTA,24,82,16,21,37
87,8477839,Conor Sheary,L,TBL,32,82,14,23,37
87,8476458,Ryan Strome,C,ANA,31,82,13,24,37
87,8480459,Pius Suter,C,VAN,28,82,13,24,37
87,8475343,Nic Dowd,C,WSH,34,82,11,26,37
87,8479293,Brandon Tanev,L,SEA,33,82,20,16,36
87,8476392,Adam Lowry,C,WPG,31,82,19,17,36
87,8475149,Marcus Johansson,L,MIN,34,82,17,19,36
87,8477511,Anthony Mantha,R,CGY,30,82,15,21,36
87,8477947,Sonny Milano,L,WSH,28,82,14,22,36
87,8474189,Lars Eller,C,PIT,35,82,11,25,36
87,8476885,Jacob Trouba,D,NYR,30,82,11,25,36
87,8475764,Cam Fowler,D,ANA,33,82,7,29,36
87,8475171,Oliver Ekman-Larsson,D,TOR,33,82,7,29,36
87,8479390,Taylor Raddysh,R,WSH,26,82,21,14,35
87,8481535,Nils Hoglander,L,VAN,24,82,16,19,35
87,8480829,Jesperi Kotkaniemi,C,CAR,24,82,14,21,35
87,8480074,Alexandre Texier,C,STL,25,82,14,21,35
87,8473563,Nicklas Backstrom,C,WSH,37,82,13,22,35
87,8476474,Stefan Noesen,R,NJD,31,82,13,22,35
87,8478413,Jordan Greenway,L,BUF,27,82,10,25,35
87,8476854,Hampus Lindholm,D,BOS,30,82,7,28,35
87,8476917,Adam Pelech,D,NYI,30,82,6,29,35
87,8475200,Dmitry Orlov,D,CAR,33,82,6,29,35
87,8478851,Alexandre Carrier,D,NSH,28,82,5,30,35
87,8482089,Jake Neighbours,L,STL,22,82,25,9,34
87,8479996,Cody Glass,C,NSH,25,82,20,14,34
87,8480802,Ryan McLeod,C,BUF,25,82,19,15,34
87,8480185,Eetu Luostarinen,C,FLA,26,82,18,16,34
87,8480835,Jack Drury,C,CAR,24,82,15,19,34
87,8476927,Teddy Blueger,C,VAN,30,82,11,23,34
87,8476329,Travis Boyd,C,MIN,31,82,10,24,34
87,8482133,Thomas Bordeleau,C,SJS,22,82,9,25,34
87,8476923,Damon Severson,D,CBJ,30,82,4,30,34
87,8477969,Marcus Pettersson,D,PIT,28,82,3,31,34
87,8476981,Josh Anderson,R,MTL,30,82,20,13,33
87,8477425,Miles Wood,L,COL,29,82,20,13,33
87,8478109,Victor Olofsson,L,VGK,29,82,18,15,33
87,8480893,Kirill Marchenko,R,CBJ,24,82,18,15,33
87,8482079,Marco Rossi,C,MIN,23,82,18,15,33
87,8481618,Alex Newhook,C,MTL,23,82,15,18,33
87,8479661,Tanner Jeannot,L,LAK,27,82,15,18,33
87,8482655,J.J. Moser,D,TBL,24,82,4,29,33
87,8476979,Erik Gustafsson,D,DET,32,82,4,29,33
87,8474151,Ryan McDonagh,D,TBL,35,82,4,29,33
87,8477506,Ryan Pulock,D,NYI,30,82,3,30,33
87,8483515,Juraj Slafkovsky,L,MTL,20,82,16,16,32
87,8480068,Ryan Poehling,C,PHI,25,82,12,20,32
87,8479591,Michael Eyssimont,C,TBL,28,82,12,20,32
87,8478133,Jake Evans,C,MTL,28,82,8,24,32
87,8480878,Nils Lundkvist,D,DAL,24,82,7,25,32
87,8479976,Juuso Valimaki,D,UTA,26,82,3,29,32
87,8479324,Ryan Lindgren,D,NYR,26,82,1,31,32
87,8478508,Yakov Trenin,C,MIN,27,82,17,14,31
87,8476469,Joel Armia,R,MTL,31,82,15,16,31
87,8478434,Keegan Kolesar,R,VGK,27,82,11,20,31
87,8480871,Adam Boqvist,D,FLA,24,82,10,21,31
87,8473422,Nick Foligno,L,CHI,37,82,10,21,31
87,8481093,Rafael Harvey-Pinard,L,MTL,25,82,10,21,31
87,8476480,Vladislav Namestnikov,C,WPG,32,82,9,22,31
87,8475324,Nick Jensen,D,OTT,34,82,7,24,31
87,8477365,Connor Clifton,D,BUF,29,82,6,25,31
87,8480073,Erik Brannstrom,D,COL,25,82,5,26,31
87,8478020,Michael Amadio,C,OTT,28,82,21,9,30
87,8484166,Adam Fantilli,C,CBJ,20,82,18,12,30
87,8482475,Yegor Chinakhov,R,CBJ,23,82,16,14,30
87,8470621,Corey Perry,R,EDM,39,82,16,14,30
87,8477989,Christian Dvorak,C,MTL,28,82,14,16,30
87,8476457,Adam Larsson,D,SEA,32,82,6,24,30
87,8476463,Jonas Brodin,D,MIN,31,82,5,25,30
87,8481606,Jordan Spence,D,LAK,23,82,4,26,30
87,8475181,Nick Leddy,D,STL,33,82,4,26,30
87,8478178,Darren Raddysh,D,TBL,28,82,4,26,30
87,8476422,Mike Reilly,D,NYI,31,82,14,15,29
87,8480113,Alex Iafallo,L,WPG,31,82,12,17,29
87,8476374,Sean Kuraly,C,CBJ,31,82,12,17,29
87,8478013,Jake Walman,D,SJS,28,82,10,19,29
87,8476897,Oskar Sundqvist,C,STL,30,82,8,21,29
87,8476461,Sean Couturier,C,PHI,32,82,7,22,29
87,8480003,Jesper Boqvist,C,FLA,26,82,7,22,29
87,8480049,Dylan Samberg,D,WPG,25,82,3,26,29
87,8476892,Colton Parayko,D,STL,31,82,2,27,29
87,8481477,Nico Sturm,C,SJS,29,82,15,13,28
87,8481013,Jonatan Berggren,R,DET,24,82,13,15,28
87,8480813,Joe Veleno,C,DET,24,82,13,15,28
87,8479353,Brett Howden,C,VGK,26,82,12,16,28
87,8481522,Peyton Krebs,C,BUF,23,82,11,17,28
87,8473533,Jordan Staal,C,CAR,36,82,10,18,28
87,8482142,Jamie Drysdale,D,PHI,22,82,8,20,28
87,8483565,Nick Blankenburg,D,NSH,26,82,6,22,28
87,8478416,Erik Cernak,D,TBL,27,82,4,24,28
87,8478507,John Marino,D,UTA,27,82,3,25,28
87,8478891,Mason Appleton,C,WPG,28,82,16,11,27
87,8481032,Paul Cotter,C,NJD,25,82,16,11,27
87,8481601,Simon Holmstrom,R,NYI,23,82,15,12,27
87,8482259,Bobby McMann,C,TOR,28,82,15,12,27
87,8479941,Justin Danforth,R,CBJ,31,82,13,14,27
87,8482074,Connor Zary,C,CGY,23,82,10,17,27
87,8476624,Barclay Goodrow,C,SJS,31,82,8,19,27
87,8482166,Shakir Mukhamadullin,D,SJS,22,82,7,20,27
87,8475188,Brayden McNabb,D,VGK,33,82,6,21,27
87,8480860,Kevin Bahl,D,CGY,24,82,6,21,27
87,8475231,Casey Cizikas,C,NYI,33,82,15,11,26
87,8484153,Leo Carlsson,C,ANA,20,82,13,13,26
87,8476873,Mark Jankowski,C,NSH,30,82,12,14,26
87,8482117,Lukas Reichel,L,CHI,22,82,12,14,26
87,8478569,Noel Acciari,C,PIT,33,82,12,14,26
87,8481704,Juuso Parssinen,C,NSH,23,82,11,15,26
87,8477392,Hudson Fasching,R,NYI,29,82,11,15,26
87,8483457,Lane Hutson,D,MTL,20,82,11,15,26
87,8479359,Beck Malenstyn,L,BUF,26,82,11,15,26
87,8475193,Tomas Tatar,L,NJD,34,82,10,16,26
87,8480025,MacKenzie Entwistle,R,FLA,25,82,10,16,26
87,8481517,Brett Leason,R,ANA,25,82,9,17,26
87,8477919,Frederick Gaudreau,C,MIN,31,82,9,17,26
87,8482062,Cole Smith,L,NSH,29,82,8,18,26
87,8476312,Josh Manson,D,COL,33,82,5,21,26
87,8476931,Jake McCabe,D,TOR,31,82,5,21,26
87,8479369,Andrew Peeke,D,BOS,26,82,5,21,26
87,8479980,Nicolas Hague,D,VGK,26,82,4,22,26
87,8479371,Dante Fabbro,D,NSH,26,82,2,24,26
87,8477488,Brett Pesce,D,NJD,30,82,2,24,26
87,8477845,Trevor van Riemsdyk,D,WSH,33,82,1,25,26
87,8481028,Martin Pospisil,C,CGY,25,82,17,8,25
87,8476889,Radek Faksa,C,STL,30,82,15,10,25
87,8478432,Christian Fischer,R,DET,27,82,15,10,25
87,8476278,Colin Blackwell,C,DAL,31,82,14,11,25
87,8484145,Zach Benson,L,BUF,19,82,13,12,25
87,8479368,Max Jones,L,BOS,26,82,11,14,25
87,8481699,Aku Raty,R,UTA,23,82,9,16,25
87,8480789,Oliver Wahlstrom,R,NYI,24,82,8,17,25
87,8474716,Jared Spurgeon,D,MIN,35,82,6,19,25
87,8480336,Sean Walker,D,CAR,30,82,5,20,25
87,8479402,Jake Bean,D,CGY,26,82,5,20,25
87,8477220,Nate Schmidt,D,FLA,33,82,5,20,25
87,8482111,Justin Barron,D,MTL,23,82,4,21,25
87,8476891,Matt Grzelcyk,D,PIT,30,82,2,23,25
87,8481014,Alexander Romanov,D,NYI,24,82,1,24,25
87,8481481,Blake Lizotte,C,PIT,27,82,13,11,24
87,8480980,Connor Dewar,C,TOR,25,82,13,11,24
87,8476858,Phillip Di Giuseppe,L,VAN,31,82,12,12,24
87,8479316,Luke Kunin,C,SJS,27,82,10,14,24
87,8477903,Garnet Hathaway,R,PHI,33,82,10,14,24
87,8484203,Bradly Nadeau,L,CAR,19,82,10,14,24
87,8477507,Nikita Zadorov,D,BOS,29,82,9,15,24
87,8475279,Ben Chiarot,D,DET,33,82,9,15,24
87,8480144,David Kampf,C,TOR,29,82,8,16,24
87,8475220,Marcus Foligno,L,MIN,33,82,8,16,24
87,8480807,Mattias Samuelsson,D,BUF,24,82,6,18,24
87,8475790,Erik Gudbranson,D,CBJ,32,82,6,18,24
87,8473507,Jeff Petry,D,DET,37,82,5,19,24
87,8477499,Rasmus Ristolainen,D,PHI,30,82,4,20,24
87,8475690,Chris Tanev,D,TOR,35,82,4,20,24
87,8482073,Braden Schneider,D,NYR,23,82,3,21,24
87,8479398,Samuel Girard,D,COL,26,82,2,22,24
87,8476826,Yanni Gourde,C,SEA,33,82,13,10,23
87,8479291,Kevin Rooney,C,CGY,31,82,11,12,23
87,8480806,Isac Lundestrom,C,ANA,25,82,10,13,23
87,8477406,Mattias Janmark,C,EDM,32,82,10,13,23
87,8479351,Sam Steel,C,DAL,26,82,9,14,23
87,8477508,Curtis Lazar,C,NJD,29,82,8,15,23
87,8482141,Lukas Cormier,D,VGK,22,82,7,16,23
87,8477435,Ryan Graves,D,PIT,29,82,7,16,23
87,8482122,Brock Faber,D,MIN,22,82,6,17,23
87,8474574,Tyler Myers,D,VAN,34,82,6,17,23
87,8478468,Jeremy Lauzon,D,NSH,27,82,5,18,23
87,8483490,Pavel Mintyukov,D,ANA,21,82,4,19,23
87,8476967,Brett Kulak,D,EDM,30,82,4,19,23
87,8482245,Artem Zub,D,OTT,29,82,2,21,23
87,8476331,Dylan DeMelo,D,WPG,31,82,1,22,23
87,8478882,Vladislav Gavrikov,D,LAK,29,82,1,22,23
87,8482077,Dylan Holloway,L,EDM,23,82,13,9,22
87,8476902,Esa Lindell,D,DAL,30,82,11,11,22
87,8477369,Carson Soucy,D,VAN,30,82,9,13,22
87,8473453,Trevor Lewis,C,LAK,37,82,9,13,22
87,8483763,Maksymilian Szuber,D,UTA,22,82,8,14,22
87,8482666,Scott Morrow,D,CAR,22,82,7,15,22
87,8475855,Jesper Fast,R,CAR,33,82,7,15,22
87,8477015,Connor Brown,R,EDM,30,82,5,17,22
87,8478500,Ivan Provorov,D,CBJ,27,82,4,18,22
87,8481708,Zac Jones,D,NYR,24,82,1,21,22
87,8482762,Simon Edvinsson,D,DET,21,82,9,12,21
87,8482679,Matt Coronato,R,CGY,22,82,6,15,21
87,8482470,Ilya Solovyov,D,CGY,24,82,6,15,21
87,8477335,Kyle Burroughs,D,LAK,29,82,5,16,21
87,8480246,Nick Perbix,D,TBL,26,82,3,18,21
87,8479998,Mikey Anderson,D,LAK,25,82,2,19,21
87,8478399,Jonas Siegenthaler,D,NJD,27,82,2,19,21
87,8475455,Brenden Dillon,D,NJD,34,82,2,19,21
87,8476879,Cody Ceci,D,EDM,31,82,1,20,21
87,8476921,Jordan Martinook,L,CAR,32,82,12,8,20
87,8476822,Luke Glendening,C,TBL,35,82,9,11,20
87,8482809,Jackson Blake,R,CAR,21,82,8,12,20
87,8482858,Ryker Evans,D,SEA,23,82,8,12,20
87,8483468,Jiri Kulich,C,BUF,20,82,7,13,20
87,8483445,Cutter Gauthier,L,ANA,20,82,7,13,20
87,8482702,Logan Stankoven,C,DAL,21,82,6,14,20
87,8484911,Collin Graf,R,SJS,22,82,5,15,20
87,8481568,Alex Vlasic,D,CHI,23,82,4,16,20
87,8478911,Matt Roy,D,WSH,29,82,2,18,20
87,8475233,David Savard,D,MTL,34,82,1,19,20
87,8479393,Noah Gregor,C,OTT,26,82,15,4,19
87,8482155,Alex Laferriere,R,LAK,23,82,11,8,19
87,8480021,Jack Studnicka,C,LAK,25,82,11,8,19
87,8482070,Mitchell Chaffee,R,TBL,26,82,10,9,19
87,8481524,Bowen Byram,D,BUF,23,82,9,10,19
87,8478211,Dryden Hunt,L,CGY,29,82,9,10,19
87,8476442,Matt Nieto,L,PIT,32,82,8,11,19
87,8482624,Daniil Miromanov,D,CGY,27,82,6,13,19
87,8480796,Martin Fehervary,D,WSH,25,82,5,14,19
87,8478136,Jake Middleton,D,MIN,28,82,2,17,19
87,8480281,Alexey Toropchenko,R,STL,25,82,14,4,18
87,8479414,Nathan Bastian,R,NJD,27,82,14,4,18
87,8475462,Radko Gudas,D,ANA,34,82,8,10,18
87,8479983,Mario Ferraro,D,SJS,26,82,8,10,18
87,8483495,Simon Nemec,D,NJD,20,82,8,10,18
87,8480172,Jan Rutta,D,SJS,34,82,5,13,18
87,8475718,Justin Holl,D,DET,32,82,3,15,18
87,8479442,Troy Stecher,D,EDM,30,82,3,15,18
87,8476473,Connor Murphy,D,CHI,31,82,3,15,18
87,8476429,Scott Mayfield,D,NYI,32,82,2,16,18
87,8474673,TJ Brodie,D,CHI,34,82,2,16,18
87,8482118,Sam Colangelo,R,ANA,23,82,2,16,18
87,8480222,Sebastian Aho,D,PIT,28,82,0,18,18
87,8476878,Zemgus Girgensons,L,TBL,30,82,9,8,17
87,8477353,Tyler Motte,C,DET,29,82,9,8,17
87,8480870,Bo Groulx,C,NYR,24,82,9,8,17
87,8477931,Tomas Nosek,L,FLA,32,82,8,9,17
87,8482803,Olen Zellweger,D,ANA,21,82,7,10,17
87,8481567,Henry Thrun,D,SJS,23,82,7,10,17
87,8482807,Ethan Del Mastro,D,CHI,21,82,4,13,17
87,8476372,Nick Seeler,D,PHI,31,82,4,13,17
87,8483499,Liam Ohgren,L,MIN,20,82,3,14,17
87,8478859,Niko Mikkola,D,FLA,28,82,2,15,17
87,8480035,Henri Jokiharju,D,BUF,25,82,0,17,17
87,8483012,Logan Morrison,C,SEA,22,82,9,7,16
87,8482101,Danil Gushchin,L,SJS,22,82,7,9,16
87,8480448,Parker Kelly,L,COL,25,82,7,9,16
87,8477505,Alexander Wennberg,C,SJS,30,82,5,11,16
87,8476467,Jamie Oleksiak,D,SEA,32,82,4,12,16
87,8480879,Jacob Bernard-Docker,D,OTT,24,82,2,14,16
87,8477034,Jaycob Megna,D,FLA,32,82,2,14,16
87,8483524,Shane Wright,C,SEA,20,82,12,3,15
87,8480995,Pontus Holmberg,R,TOR,25,82,8,7,15
87,8483397,Marc McLaughlin,C,BOS,25,82,6,9,15
87,8482712,Oskar Olausson,R,COL,22,82,6,9,15
87,8484149,Gavin Brindley,C,CBJ,20,82,5,10,15
87,8483471,Brad Lambert,C,WPG,31,82,5,10,15
87,8482087,Kaiden Guhle,D,MTL,22,82,3,12,15
87,8474013,Ian Cole,D,UTA,35,82,2,13,15
87,8483493,Frank Nazar,C,CHI,20,82,10,4,14
87,8483505,Matthew Poitras,C,BOS,20,82,6,8,14
87,8482659,Josh Doan,R,UTA,22,82,5,9,14
87,8482859,Zack Ostapchuk,C,OTT,21,82,5,9,14
87,8478443,Brandon Carlo,D,BOS,28,82,4,10,14
87,8481641,Joel Kiviranta,L,COL,28,82,4,10,14
87,8480990,Declan Chisholm,D,MIN,24,82,2,12,14
87,8481122,Simon Benoit,D,TOR,26,82,2,12,14
87,8474612,Travis Hamonic,D,OTT,34,82,1,13,14
87,8476441,Joel Edmundson,D,LAK,31,82,7,6,13
87,8483466,Kevin Korchinski,D,CHI,20,82,5,8,13
87,8475842,Sam Carrick,C,NYR,32,82,4,9,13
87,8480950,Ilya Lyubushkin,D,DAL,30,82,4,9,13
87,8475177,Calvin de Haan,D,COL,33,82,4,9,13
87,8482145,Mavrik Bourque,C,DAL,22,82,4,9,13
87,8482713,Mackie Samoskevich,R,FLA,22,82,3,10,13
87,8478840,Will Borgen,D,SEA,28,82,2,11,13
87,8470600,Ryan Suter,D,STL,39,82,1,12,13
87,8480834,Ty Emberson,D,SJS,24,82,0,13,13
87,8479638,Justin Brazeau,R,BOS,26,82,8,4,12
87,8483489,Fraser Minten,C,TOR,31,82,7,5,12
87,8482153,Brendan Brisson,C,VGK,23,82,5,7,12
87,8474567,Zach Bogosian,D,MIN,34,82,5,7,12
87,8476525,Colin Miller,D,WPG,32,82,4,8,12
87,8483482,Tristan Luneau,D,ANA,20,82,4,8,12
87,8482733,Logan Mailloux,D,MTL,31,82,4,8,12
87,8483567,Georgii Merkulov,C,BOS,24,82,3,9,12
87,8479576,Vincent Desharnais,D,VAN,28,82,3,9,12
87,8477938,Haydn Fleury,D,WPG,28,82,2,10,12
87,8481178,Egor Zamula,D,PHI,24,82,1,11,12
87,8478450,Parker Wotherspoon,D,BOS,27,82,1,11,12
87,8471677,Jack Johnson,D,CBJ,37,82,3,8,11
87,8482749,Joshua Roy,R,MTL,21,82,4,6,10
87,8475762,Derek Forbort,D,VAN,32,82,3,7,10
87,8483460,David Jiricek,D,CBJ,21,82,3,7,10
87,8482787,Nikita Chibrikov,R,WPG,31,82,2,8,10
87,8478874,Adam Gaudette,C,OTT,28,82,5,4,9
87,8482516,Matthew Kessel,D,STL,24,82,1,8,9
87,8474090,Brendan Smith,D,DAL,35,82,1,8,9
87,8474062,Riley Nash,C,NYR,35,82,3,4,7
87,8481605,Jackson LaCombe,D,ANA,23,82,2,5,7
87,8470794,Joe Pavelski,C,,40,0,0,0,0
87,8481703,Valtteri Puustinen,R,PIT,25,0,0,0,0
87,8477950,Tony DeAngelo,D,,29,0,0,0,0
87,8481577,Philip Tomasino,C,NSH,23,0,0,0,0
87,8475197,Tyson Barrie,D,,33,0,0,0,0
87,8471218,Blake Wheeler,R,,38,0,0,0,0
87,8474157,Max Pacioretty,L,,36,0,0,0,0
87,8478466,Daniel Sprong,R,VAN,27,0,0,0,0
87,8475744,Evgeny Kuznetsov,C,,32,0,0,0,0
87,8481019,David Gustafsson,C,WPG,24,0,0,0,0
87,8475906,John Klingberg,D,,32,0,0,0,0
87,8479348,Kale Clague,D,BUF,26,0,0,0,0
87,8476952,Dominic Toninato,C,WPG,30,0,0,0,0
87,8473473,Milan Lucic,L,,36,0,0,0,0
87,8474037,James van Riemsdyk,L,,35,0,0,0,0
87,8474602,Justin Schultz,D,,34,0,0,0,0
87,8482222,Alexander Barabanov,L,,30,0,0,0,0
87,8479372,Josh Mahura,D,SEA,26,0,0,0,0
87,8479982,Conor Timmins,D,TOR,26,0,0,0,0
87,8474031,Kevin Shattenkirk,D,,35,0,0,0,0
87,8480008,Adam Ruzicka,C,,25,0,0,0,0
87,8481059,Scott Perunovich,D,STL,26,0,0,0,0
87,8480884,Calen Addison,D,,24,0,0,0,0
87,8476994,Vinnie Hinostroza,C,NSH,30,0,0,0,0
87,8478452,Caleb Jones,D,LAK,27,0,0,0,0
87,8480157,Calle Rosen,D,COL,30,0,0,0,0
87,8481609,Vladislav Kolyachonok,D,UTA,23,0,0,0,0
87,8479415,Michael McLeod,C,,26,0,0,0,0
87,8476919,Chris Tierney,C,,30,0,0,0,0
87,8479639,Dylan Coghlan,D,WPG,26,0,0,0,0
87,8478146,Matthew Highmore,C,OTT,28,0,0,0,0
87,8478970,Jalen Chatfield,D,CAR,28,0,0,0,0
87,8480205,Emil Bemstrom,C,PIT,25,0,0,0,0
87,8474884,Mike Hoffman,C,,35,0,0,0,0
87,8471274,Alex Goligoski,D,,39,0,0,0,0
87,8478104,Sammy Blais,L,,28,0,0,0,0
87,8474870,Tyler Johnson,C,,34,0,0,0,0
87,8476913,Devin Shore,C,MIN,30,0,0,0,0
87,8481598,Philip Broberg,D,EDM,23,0,0,0,0
87,8480058,Pierre-Olivier Joseph,D,STL,25,0,0,0,0
87,8480891,Michael Kesselring,D,UTA,24,0,0,0,0
87,8477979,Nicolas Aube-Kubel,R,BUF,28,0,0,0,0
87,8476871,Tanner Pearson,L,,32,0,0,0,0
87,8476393,Nick Cousins,C,,31,0,0,0,0
87,8479977,Kailer Yamamoto,R,,26,0,0,0,0
87,8479543,Michael Pezzetta,L,MTL,26,0,0,0,0
87,8477018,Ben Hutton,D,VGK,31,0,0,0,0
87,8480762,Eric Robinson,L,CAR,29,0,0,0,0
87,8474034,Pat Maroon,L,CHI,36,0,0,0,0
87,8481058,Jesse Ylönen,R,,25,0,0,0,0
87,8475179,Dmitry Kulikov,D,FLA,34,0,0,0,0
87,8481527,Kaedan Korczak,D,VGK,23,0,0,0,0
87,8473449,Kyle Okposo,R,,36,0,0,0,0
87,8482192,Isaak Phillips,D,CHI,23,0,0,0,0
87,8480727,Zach Whitecloud,D,VGK,28,0,0,0,0
87,8479346,Dillon Dube,C,,26,0,0,0,0
87,8480821,Filip Zadina,R,,25,0,0,0,0
87,8480001,Urho Vaakanainen,D,ANA,25,0,0,0,0
87,8470966,Mark Giordano,D,,41,0,0,0,0
87,8480853,Liam Foudy,C,,24,0,0,0,0
87,8475225,Craig Smith,C,CHI,35,0,0,0,0
87,8479972,Mason Shaw,C,WPG,26,0,0,0,0
87,8478451,Ethan Bear,D,WSH,27,0,0,0,0
87,8474040,Sam Gagner,C,,35,0,0,0,0
87,8480196,Jacob Bryson,D,BUF,27,0,0,0,0
87,8479984,Cal Foote,D,,26,0,0,0,0
87,8480011,Klim Kostin,C,SJS,25,0,0,0,0
87,8482176,Wyatt Kaiser,D,CHI,22,0,0,0,0
87,8476988,Matt Benning,D,SJS,30,0,0,0,0
87,8479370,Tyson Jost,C,CAR,26,0,0,0,0
87,8477464,Nic Petan,C,,29,0,0,0,0
87,8477380,Jonny Brodzinski,C,NYR,31,0,0,0,0
87,8480070,Ian Mitchell,D,BOS,25,0,0,0,0
87,8479315,Joey Anderson,R,CHI,26,0,0,0,0
87,8478099,Kevin Labanc,R,,29,0,0,0,0
87,8476874,Olli Maatta,D,DET,30,0,0,0,0
87,8475208,Brian Dumoulin,D,ANA,33,0,0,0,0
87,8478430,Oliver Kylington,D,,27,0,0,0,0
87,8479536,Axel Jonsson-Fjallby,L,WPG,26,0,0,0,0
87,8479671,Mathieu Olivier,R,CBJ,27,0,0,0,0
87,8471709,Marc-Edouard Vlasic,D,SJS,37,0,0,0,0
87,8479328,Julien Gauthier,R,NYI,27,0,0,0,0
87,8478421,A.J. Greer,L,FLA,28,0,0,0,0
87,8477573,Nathan Walker,L,STL,30,0,0,0,0
87,8481537,Nikita Okhotiuk,D,CGY,24,0,0,0,0
87,8474166,Alec Martinez,D,CHI,37,0,0,0,0
87,8470610,Zach Parise,L,,40,0,0,0,0
87,8477478,William Carrier,L,CAR,30,0,0,0,0
87,8479344,Jesse Puljujarvi,R,PIT,26,0,0,0,0
87,8480887,Jordan Harris,D,MTL,24,0,0,0,0
87,8478502,Dennis Gilbert,D,BUF,28,0,0,0,0
87,8482730,Brandt Clarke,D,LAK,21,0,0,0,0
87,8480355,Mark Kastelic,C,BOS,25,0,0,0,0
87,8475750,Jon Merrill,D,MIN,32,0,0,0,0
87,8475164,Jakob Silfverberg,R,,34,0,0,0,0
87,8477944,Jakub Vrana,L,,28,0,0,0,0
87,8479439,Jacob MacDonald,D,COL,31,0,0,0,0
87,8474568,Luke Schenn,D,NSH,35,0,0,0,0
87,8478454,Noah Juulsen,D,VAN,27,0,0,0,0
87,8475752,Tyler Pitlick,C,,33,0,0,0,0
87,8482148,Hendrix Lapierre,C,WSH,22,0,0,0,0
87,8481167,Brayden Pachal,D,CGY,25,0,0,0,0
87,8478043,Sam Lafferty,C,BUF,29,0,0,0,0
87,8479321,Lucas Johansen,D,,27,0,0,0,0
87,8471699,Andrew Cogliano,C,,37,0,0,0,0
87,8481521,Ronnie Attard,D,PHI,25,0,0,0,0
87,8481161,Jake Christiansen,D,CBJ,25,0,0,0,0
87,8479458,Nikita Zaitsev,D,,33,0,0,0,0
87,8479619,Michael Carcone,L,UTA,28,0,0,0,0
87,8479026,Philippe Myers,D,TOR,27,0,0,0,0
87,8477330,Dominik Kubalik,L,,29,0,0,0,0
87,8481617,Vasily Podkolzin,R,VAN,23,0,0,0,0
87,8481701,Santeri Hatakka,D,NJD,23,0,0,0,0
87,8479514,Rem Pitlick,C,,27,0,0,0,0
87,8477446,Michael McCarron,R,NSH,29,0,0,0,0
87,8470604,Jeff Carter,C,,39,0,0,0,0
87,8482241,Radim Zohorna,L,,28,0,0,0,0
87,8480289,Morgan Barron,C,WPG,26,0,0,0,0
87,8479379,Givani Smith,R,SJS,26,0,0,0,0
87,8480216,Jacob Peterson,C,,25,0,0,0,0
87,8477851,Jordan Oesterle,D,BOS,32,0,0,0,0
87,8484258,Sam Malinski,D,COL,26,0,0,0,0
87,8478904,Steven Lorentz,C,,28,0,0,0,0
87,8482095,Tyler Kleven,D,OTT,22,0,0,0,0
87,8480848,Ty Dellandrea,C,SJS,24,0,0,0,0
87,8476884,Derrick Pouliot,D,,30,0,0,0,0
87,8479336,Carl Grundstrom,R,SJS,27,0,0,0,0
87,8482964,Arber Xhekaj,D,MTL,23,0,0,0,0
87,8471686,Marc Staal,D,,37,0,0,0,0
87,8477887,Patrick Brown,C,BOS,32,0,0,0,0
87,8478495,Denis Gurianov,R,,27,0,0,0,0
87,8473504,Cal Clutterbuck,R,,37,0,0,0,0
87,8481550,Adam Beckman,L,NJD,23,0,0,0,0
87,8480845,Rasmus Kupari,C,WPG,24,0,0,0,0
87,8474009,Nick Bonino,C,,36,0,0,0,0
87,8478585,Derek Ryan,C,EDM,38,0,0,0,0
87,8477962,Brendan Lemieux,L,CAR,28,0,0,0,0
87,8482861,Vincent Iorio,D,WSH,22,0,0,0,0
87,8479378,Logan Stanley,D,WPG,26,0,0,0,0
87,8473446,Erik Johnson,D,PHI,36,0,0,0,0
87,8481743,Marc Del Gaizo,D,NSH,25,0,0,0,0
87,8477384,Josh Brown,D,EDM,30,0,0,0,0
87,8482165,Yan Kuznetsov,D,CGY,22,0,0,0,0
87,8478424,Jansen Harkins,C,ANA,27,0,0,0,0
87,8482144,Jack Thompson,D,SJS,22,0,0,0,0
87,8478512,Austin Czarnik,C,,32,0,0,0,0
87,8477527,Ross Johnston,L,ANA,30,0,0,0,0
87,8479383,Boris Katchouk,L,,26,0,0,0,0
87,8482094,Daemon Hunt,D,MIN,22,0,0,0,0
87,8481719,Maxwell Crozier,D,TBL,24,0,0,0,0
87,8480192,Johnathan Kovacevic,D,NJD,27,0,0,0,0
87,8479376,Victor Mete,D,,26,0,0,0,0
87,8482511,Mason Lohrei,D,BOS,23,0,0,0,0
87,8475825,Jani Hakanpää,D,,32,0,0,0,0
87,8478021,William Lagesson,D,DET,28,0,0,0,0
87,8475795,Dylan McIlrath,D,WSH,32,0,0,0,0
87,8477846,Ryan Carpenter,C,,33,0,0,0,0
87,8481056,Spencer Stastney,D,NSH,24,0,0,0,0
87,8481564,Ryan Johnson,D,BUF,23,0,0,0,0
87,8478017,Mark Friedman,D,VAN,29,0,0,0,0
87,8479320,Max Lajoie,D,SEA,27,0,0,0,0
87,8480075,Cameron Crotty,D,MIN,25,0,0,0,0
87,8484287,Cole McWard,D,VAN,23,0,0,0,0
87,8484254,Akito Hirose,D,VAN,25,0,0,0,0
87,8483407,Brandon Scanlin,D,NYR,25,0,0,0,0
87,8480274,Philip Kemp,D,EDM,25,0,0,0,0
87,8479522,Hardy Haman Aktell,D,WSH,26,0,0,0,0
87,8480007,Jonas Rondbjerg,R,VGK,25,0,0,0,0
87,8477454,Adam Erne,L,,29,0,0,0,0
87,8481679,Maxence Guenette,D,OTT,23,0,0,0,0
87,8480441,Trey Fix-Wolansky,R,CBJ,25,0,0,0,0
87,8483546,Marshall Rifai,D,TOR,26,0,0,0,0
87,8480084,Nick DeSimone,D,NJD,30,0,0,0,0
87,8481030,Jack St. Ivany,D,PIT,25,0,0,0,0
87,8481592,Jakob Pelletier,L,CGY,23,0,0,0,0
87,8478011,Louie Belpedio,D,PHI,28,0,0,0,0
87,8477930,Pierre-Edouard Bellemare,L,,39,0,0,0,0
87,8484321,Nikolas Matinpalo,D,OTT,26,0,0,0,0
87,8482067,Connor Mackey,D,NYR,28,0,0,0,0
87,8481806,Louis Crevier,D,CHI,23,0,0,0,0
87,8484326,Patrik Koch,D,UTA,28,0,0,0,0
87,8477971,Andreas Englund,D,LAK,28,0,0,0,0
87,8481751,Lukas Rousek,R,BUF,25,0,0,0,0
87,8481006,Tyler Tucker,D,STL,24,0,0,0,0
87,8476867,Brendan Gaunce,C,MIN,30,0,0,0,0
87,8479520,Brandon Duhaime,R,WSH,27,0,0,0,0
87,8477073,Kurtis MacDermid,L,NJD,30,0,0,0,0
87,8480874,Adam Ginning,D,PHI,24,0,0,0,0
87,8477473,Justin Bailey,R,SJS,29,0,0,0,0
87,8479066,Ryan Lomberg,L,CGY,30,0,0,0,0
87,8477070,Liam O'Brien,C,UTA,30,0,0,0,0
87,8474618,Marco Scandella,D,,34,0,0,0,0
87,8475797,Jarred Tinordi,D,,32,0,0,0,0
87,8481441,Joe Snively,C,DET,28,0,0,0,0
87,8477244,Chad Ruhwedel,D,NYR,34,0,0,0,0
87,8479772,Zack MacEwen,R,OTT,28,0,0,0,0
87,8481147,Reese Johnson,C,MIN,26,0,0,0,0
87,8481043,Cole Koepke,L,BOS,26,0,0,0,0
87,8483619,Filip Roos,D,OTT,25,0,0,0,0
87,8481541,Samuel Bolduc,D,NYI,24,0,0,0,0
87,8477810,Joel Hanley,D,CGY,33,0,0,0,0
87,8476907,Mackenzie MacEachern,L,,30,0,0,0,0
87,8482652,Walker Duehr,R,CGY,27,0,0,0,0
87,8477126,Jayson Megna,C,,34,0,0,0,0
87,8483398,Declan Carlile,D,TBL,31,0,0,0,0
87,8482929,Emil Lilleberg,D,TBL,23,0,0,0,0
87,8480880,Jakub Lauko,C,MIN,24,0,0,0,0
87,8480245,Olle Lycksell,R,PHI,25,0,0,0,0
87,8480252,Cole Guttman,C,CHI,25,0,0,0,0
87,8477467,Gustav Olofsson,D,SEA,30,0,0,0,0
87,8479968,Vinni Lettieri,C,BOS,29,0,0,0,0
87,8478400,Colin White,C,,27,0,0,0,0
87,8475755,Alexander Petrovic,D,DAL,32,0,0,0,0
87,8481812,Nikolai Knyzhov,D,,27,0,0,0,0
87,8481593,Jayden Struble,D,MTL,23,0,0,0,0
87,8481532,Alex Turcotte,C,LAK,23,0,0,0,0
87,8482126,Emil Andrae,D,PHI,31,0,0,0,0
87,8479944,Zach Aston-Reese,C,VGK,30,0,0,0,0
87,8471817,Ryan Reaves,R,TOR,37,0,0,0,0
87,8481206,John Ludvig,D,PIT,24,0,0,0,0
87,8481599,Victor Soderstrom,D,UTA,23,0,0,0,0
87,8480292,Carson Meyer,R,ANA,27,0,0,0,0
87,8482496,Nils Aman,C,VAN,24,0,0,0,0
87,8479718,Alex Barré-Boulet,C,MTL,27,0,0,0,0
87,8479994,Jaret Anderson-Dolan,C,WPG,25,0,0,0,0
87,8480184,Gustav Lindstrom,D,,26,0,0,0,0
87,8480890,Jan Jenik,R,OTT,24,0,0,0,0
87,8478067,Oskar Lindblom,L,,28,0,0,0,0
87,8476934,Brock McGinn,L,ANA,30,0,0,0,0
87,8479985,Cale Fleury,D,SEA,26,0,0,0,0
87,8484304,Uvis Balinskis,D,FLA,28,0,0,0,0
87,8479981,Jonah Gadjovich,L,FLA,26,0,0,0,0
87,8481716,Dmitri Voronkov,L,CBJ,24,0,0,0,0
87,8474709,Matt Martin,L,,35,0,0,0,0
87,8482634,Alex Steeves,C,TOR,25,0,0,0,0
87,8480823,Alexander Alexeyev,D,WSH,25,0,0,0,0
87,8477541,Dakota Mermis,D,TOR,30,0,0,0,0
87,8483491,Ivan Miroshnichenko,L,WSH,20,0,0,0,0
87,8478477,Mitchell Stephens,C,SEA,27,0,0,0,0
87,8481543,Nikita Alexandrov,C,STL,24,0,0,0,0
87,8479423,Alex Nylander,L,,26,0,0,0,0
87,8482451,Mikael Pyyhtia,L,CBJ,23,0,0,0,0
87,8478831,Kevin Stenlund,C,UTA,28,0,0,0,0
87,8480306,Grant Hutton,D,NYI,29,0,0,0,0
87,8478028,Fredrik Olofsson,L,,28,0,0,0,0
87,8477462,Robert Hagg,D,VGK,29,0,0,0,0
87,8477320,Anton Blidh,L,NYR,29,0,0,0,0
87,8482157,Will Cuylle,L,NYR,22,0,0,0,0
87,8482737,Zack Bolduc,C,STL,21,0,0,0,0
87,8481239,Samuel Fagemo,L,,24,0,0,0,0
87,8481600,Tobias Bjornfot,D,FLA,23,0,0,0,0
87,8478409,Anthony Richard,C,PHI,28,0,0,0,0
87,8474145,Robert Bortuzzo,D,,35,0,0,0,0
87,8475958,Michael Sgarbossa,C,WSH,32,0,0,0,0
87,8479986,Kole Lind,R,DAL,26,0,0,0,0
87,8479249,Andrew Poturalski,C,SJS,30,0,0,0,0
87,8479362,Riley Tufte,L,BOS,26,0,0,0,0
87,8479991,Jake Leschyshyn,C,NYR,25,0,0,0,0
87,8479587,Rhett Gardner,C,PHI,28,0,0,0,0
87,8482744,James Malatesta,L,CBJ,21,0,0,0,0
87,8478854,Ryan Shea,D,PIT,27,0,0,0,0
87,8481591,Sam Poulin,R,,23,0,0,0,0
87,8483512,Matt Savoie,C,EDM,20,0,0,0,0
87,8482102,Vasily Ponomarev,C,PIT,22,0,0,0,0
87,8482162,Roby Jarventie,L,EDM,22,0,0,0,0
87,8481016,Ruslan Iskhakov,C,,24,0,0,0,0
87,8482172,Landon Slaggert,L,CHI,22,0,0,0,0
87,8482747,Brennan Othmann,L,NYR,21,0,0,0,0
87,8480031,Maxime Comtois,L,,25,0,0,0,0
87,8480226,Marián Studenic,R,,26,0,0,0,0
87,8478408,Travis Dermott,D,,28,0,0,0,0
87,8481518,Nolan Foote,L,NJD,24,0,0,0,0
87,8479419,Brett Murray,L,BUF,26,0,0,0,0
87,8482088,Justin Sourdif,R,FLA,22,0,0,0,0
87,8482201,Gage Goncalves,C,TBL,23,0,0,0,0
87,8481578,Graeme Clarke,R,MIN,23,0,0,0,0
87,8482177,Marat Khusnutdinov,C,MIN,22,0,0,0,0
87,8481754,Nikita Nesterenko,C,ANA,23,0,0,0,0
87,8483531,Brian Halonen,L,NJD,25,0,0,0,0
87,8483920,Pierrick Dube,R,WSH,23,0,0,0,0
87,8480851,Akil Thomas,C,LAK,24,0,0,0,0
87,8475235,Nicolas Deslauriers,L,PHI,33,0,0,0,0
87,8482476,Emil Heineman,L,MTL,23,0,0,0,0
87,8477149,Scott Sabourin,R,SJS,32,0,0,0,0
87,8483549,Lucas Condotta,L,MTL,27,0,0,0,0
87,8482765,Isak Rosen,R,BUF,21,0,0,0,0
87,8481237,Kyle MacLean,C,NYI,25,0,0,0,0
87,8481024,Linus Karlsson,C,VAN,25,0,0,0,0
87,8481690,Tyler Angle,C,,24,0,0,0,0
87,8483570,Ben Meyers,C,SEA,26,0,0,0,0
87,8481655,Cole Schwindt,R,CGY,23,0,0,0,0
87,8481462,Mason Morelli,L,VGK,28,0,0,0,0
87,8483401,Marc Johnstone,R,PIT,28,0,0,0,0
87,8478956,Samuel Laberge,L,NJD,27,0,0,0,0
87,8479533,Joona Koppanen,L,,26,0,0,0,0
87,8482197,Adam Raska,R,MIN,23,0,0,0,0
87,8482250,Callahan Burke,C,VGK,27,0,0,0,0
87,8482784,Zach Dean,C,STL,21,0,0,0,0
87,8484255,Jason Polin,R,COL,25,0,0,0,0
87,8481077,John Leonard,L,,26,0,0,0,0
87,8481534,Raphael Lavoie,C,EDM,24,0,0,0,0
87,8483609,Adam Klapka,R,CGY,24,0,0,0,0
87,8482751,Ryan Winterton,C,SEA,21,0,0,0,0
87,8480267,Sammy Walker,C,MIN,25,0,0,0,0
87,8475766,Austin Watson,L,,32,0,0,0,0
87,8482460,Matt Rempe,C,NYR,22,0,0,0,0
87,8481065,Angus Crookshank,L,OTT,25,0,0,0,0
87,8481070,Hugh McGing,L,,26,0,0,0,0
87,8476323,Max McCormick,L,SEA,32,0,0,0,0
87,8483395,Arshdeep Bains,L,VAN,23,0,0,0,0
87,8484259,Ondrej Pavel,C,COL,31,0,0,0,0
87,8483432,Luca Del Bel Belluz,C,CBJ,31,0,0,0,0
87,8483045,Cameron Butler,R,CBJ,31,0,0,0,0
87,8482061,Brandon Biro,L,SEA,26,0,0,0,0
87,8477401,John Hayden,C,SEA,29,0,0,0,0
87,8475278,Byron Froese,C,,33,0,0,0,0
87,8478446,Glenn Gawdin,C,LAK,27,0,0,0,0
87,8477993,Justin Kirkland,C,CGY,28,0,0,0,0
87,8482147,Jean-Luc Foudy,C,COL,22,0,0,0,0
87,8480032,Shane Bowers,C,NJD,25,0,0,0,0
87,8479330,Brandon Gignac,C,MTL,27,0,0,0,0
87,8480776,Sheldon Rempal,R,,29,0,0,0,0
87,8475413,Justin Dowling,C,NJD,34,0,0,0,0
87,8481726,Adam Edstrom,C,NYR,24,0,0,0,0
87,8480844,Grigori Denisenko,L,VGK,24,0,0,0,0
87,8478147,Bokondji Imama,L,PIT,28,0,0,0,0
87,8478881,Brett Seney,L,CHI,28,0,0,0,0
87,8483630,Pavol Regenda,L,ANA,25,0,0,0,0
87,8480836,Jonathan Gruden,C,,24,0,0,0,0
87,8484314,Jiri Smejkal,L,,28,0,0,0,0
87,8475780,Chris Wagner,R,COL,33,0,0,0,0
87,8479546,Oskar Steen,C,,26,0,0,0,0
87,8483597,Milos Kelemen,L,UTA,25,0,0,0,0
87,8481789,Tye Kartye,L,SEA,23,0,0,0,0
87,8484325,Waltteri Merela,C,TBL,26,0,0,0,0
87,8479421,Jacob Moverare,D,LAK,26,0,0,0,0
87,8481585,Egor Afanasyev,L,SJS,23,0,0,0,0
87,8479547,Matthew Phillips,R,,26,0,0,0,0
87,8479367,William Lockwood,R,FLA,26,0,0,0,0
87,8476915,Jujhar Khaira,L,,30,0,0,0,0
87,8481422,Jacob Lucchini,C,NSH,29,0,0,0,0
87,8480468,James Hamblin,L,EDM,25,0,0,0,0
87,8478051,Max Willman,C,NJD,29,0,0,0,0
87,8481556,John Beecher,C,BOS,23,0,0,0,0
87,8478078,Rourke Chartier,C,,28,0,0,0,0
88,8478402,Connor McDavid,C,EDM,27,82,59,107,166
88,8476453,Nikita Kucherov,R,TBL,31,82,43,103,146
88,8477492,Nathan MacKinnon,C,COL,29,82,53,91,144
88,8479318,Auston Matthews,C,TOR,27,82,69,54,123
88,8478550,Artemi Panarin,L,NYR,33,82,32,82,114
88,8480002,Nico Hischier,C,NJD,25,82,42,70,112
88,8478439,Travis Konecny,R,PHI,27,82,42,65,107
88,8477956,David Pastrnak,R,BOS,28,82,56,50,106
88,8481559,Jack Hughes,C,NJD,23,82,37,68,105
88,8477934,Leon Draisaitl,C,EDM,29,82,35,70,105
88,8480027,Jason Robertson,L,DAL,25,82,42,62,104
88,8476468,J.T. Miller,C,VAN,31,82,30,74,104
88,8477942,Kevin Fiala,L,LAK,28,82,39,64,103
88,8479314,Matthew Tkachuk,L,FLA,27,82,35,68,103
88,8477493,Aleksander Barkov,C,FLA,29,82,28,75,103
88,8478403,Jack Eichel,C,VGK,28,82,51,47,98
88,8478010,Brayden Point,C,TBL,28,82,49,45,94
88,8478420,Mikko Rantanen,R,COL,28,82,46,48,94
88,8477939,William Nylander,R,TOR,28,82,36,58,94
88,8479407,Jesper Bratt,L,NJD,26,82,36,58,94
88,8480012,Elias Pettersson,C,VAN,26,82,33,60,93
88,8471675,Sidney Crosby,C,PIT,37,82,36,55,91
88,8482116,Tim Stützle,C,OTT,22,82,33,58,91
88,8479323,Adam Fox,D,NYR,26,82,18,72,90
88,8475172,Nazem Kadri,C,CGY,34,82,42,47,89
88,8479337,Alex DeBrincat,R,DET,27,82,40,48,88
88,8476887,Filip Forsberg,L,NSH,30,82,37,51,88
88,8480830,Andrei Svechnikov,R,CAR,24,82,35,53,88
88,8481557,Matt Boldy,L,MIN,23,82,37,50,87
88,8474600,Roman Josi,D,NSH,34,82,24,63,87
88,8480800,Quinn Hughes,D,VAN,25,82,13,74,87
88,8474564,Steven Stamkos,C,NSH,34,82,38,48,86
88,8476454,Ryan Nugent-Hopkins,C,EDM,31,82,23,63,86
88,8478864,Kirill Kaprizov,L,MIN,27,82,38,47,85
88,8477409,Carter Verhaeghe,C,FLA,29,82,38,47,85
88,8477404,Jake Guentzel,C,TBL,30,82,36,49,85
88,8476460,Mark Scheifele,C,WPG,31,82,36,49,85
88,8478444,Brock Boeser,R,VAN,27,82,34,51,85
88,8475913,Mark Stone,R,VGK,32,82,30,55,85
88,8480801,Brady Tkachuk,L,OTT,25,82,34,50,84
88,8475184,Chris Kreider,L,NYR,33,82,53,30,83
88,8477946,Dylan Larkin,C,DET,28,82,37,45,82
88,8476459,Mika Zibanejad,C,NYR,31,82,29,53,82
88,8478398,Kyle Connor,L,WPG,28,82,41,40,81
88,8481523,Kirby Dach,C,MTL,23,82,15,66,81
88,8477949,Alex Tuch,R,BUF,28,82,29,51,80
88,8479420,Tage Thompson,C,BUF,27,82,41,38,79
88,8478414,Timo Meier,R,NJD,28,82,38,41,79
88,8478975,Mason Marchment,L,DAL,29,82,33,46,79
88,8473419,Brad Marchand,L,BOS,36,82,32,47,79
88,8480015,Owen Tippett,R,PHI,25,82,30,49,79
88,8475166,John Tavares,C,TOR,34,82,26,53,79
88,8478460,Zach Werenski,D,CBJ,27,82,19,60,79
88,8480839,Rasmus Dahlin,D,BUF,24,82,17,62,79
88,8477501,Valeri Nichushkin,R,COL,29,82,37,41,78
88,8477933,Sam Reinhart,C,FLA,29,82,36,42,78
88,8480069,Cale Makar,D,COL,26,82,21,57,78
88,8479675,Trevor Moore,L,LAK,29,82,35,42,77
88,8478427,Sebastian Aho,C,CAR,27,82,28,49,77
88,8473994,Jamie Benn,L,DAL,35,82,21,56,77
88,8477940,Nikolaj Ehlers,L,WPG,28,82,28,48,76
88,8476456,Jonathan Huberdeau,C,CGY,31,82,22,54,76
88,8476389,Vincent Trocheck,C,NYR,31,82,34,41,75
88,8475167,Victor Hedman,D,TBL,34,82,15,60,75
88,8480036,Miro Heiskanen,D,DAL,25,82,12,63,75
88,8480865,Noah Dobson,D,NYI,24,82,12,62,74
88,8477500,Bo Horvat,C,NYI,29,82,34,39,73
88,8473512,Claude Giroux,R,OTT,36,82,21,52,73
88,8477447,Shea Theodore,D,VGK,29,82,18,55,73
88,8479343,Clayton Keller,R,UTA,26,82,39,33,72
88,8478449,Roope Hintz,C,DAL,28,82,38,33,71
88,8475810,Bryan Rust,R,PIT,32,82,36,35,71
88,8475784,Jeff Skinner,C,EDM,32,82,33,37,70
88,8475765,Vladimir Tarasenko,R,DET,33,82,31,39,70
88,8477960,Adrian Kempe,R,LAK,28,82,29,41,70
88,8471685,Anze Kopitar,C,LAK,37,82,21,49,70
88,8481528,Dylan Cozens,C,BUF,23,82,39,30,69
88,8478042,Viktor Arvidsson,R,EDM,31,82,28,41,69
88,8478445,Mathew Barzal,C,NYI,27,82,18,51,69
88,8477504,Josh Morrissey,D,WPG,29,82,10,59,69
88,8475754,Brock Nelson,C,NYI,33,82,31,37,68
88,8479410,Mikhail Sergachev,D,UTA,26,82,17,51,68
88,8475794,Tyler Seguin,C,DAL,32,82,30,37,67
88,8474141,Patrick Kane,R,DET,36,82,29,38,67
88,8481540,Cole Caufield,R,MTL,23,82,35,31,66
88,8482667,William Eklund,L,SJS,22,82,29,37,66
88,8475158,Ryan O'Reilly,C,NSH,33,82,28,38,66
88,8482093,Seth Jarvis,C,CAR,22,82,27,39,66
88,8475168,Matt Duchene,C,DAL,33,82,24,42,66
88,8476479,Phillip Danault,C,LAK,31,82,23,43,66
88,8478366,Frank Vatrano,R,ANA,30,82,35,30,65
88,8480023,Robert Thomas,C,STL,25,82,18,47,65
88,8478498,Jake DeBrusk,L,VAN,28,82,34,30,64
88,8471214,Alex Ovechkin,L,WSH,39,82,28,36,64
88,8475692,Mats Zuccarello,R,MIN,37,82,20,44,64
88,8476346,Johnny Gaudreau,L,CBJ,31,82,15,49,64
88,8479385,Jordan Kyrou,C,STL,26,82,34,29,63
88,8476539,Jonathan Marchessault,R,NSH,34,82,31,32,63
88,8471215,Evgeni Malkin,C,PIT,38,82,27,36,63
88,8477496,Elias Lindholm,C,BOS,30,82,27,36,63
88,8479542,Brandon Hagel,L,TBL,26,82,26,37,63
88,8477456,J.T. Compher,L,DET,29,82,24,39,63
88,8477494,Jonathan Drouin,L,COL,29,82,19,44,63
88,8475798,Mikael Granlund,C,SJS,32,82,14,49,63
88,8480803,Evan Bouchard,D,EDM,25,82,13,50,63
88,8477402,Pavel Buchnevich,L,STL,29,82,23,39,62
88,8476448,William Karlsson,C,VGK,31,82,21,41,62
88,8474679,Gustav Nyquist,C,NSH,35,82,19,43,62
88,8482110,Dawson Mercer,C,NJD,23,82,29,32,61
88,8476462,Dougie Hamilton,D,NJD,31,82,19,42,61
88,8478873,Troy Terry,R,ANA,27,82,14,47,61
88,8479339,Patrik Laine,L,CBJ,26,82,32,28,60
88,8482078,Lucas Raymond,L,DET,22,82,26,34,60
88,8475726,Tyler Toffoli,C,SJS,32,82,26,34,60
88,8480188,Fabian Zetterlund,L,SJS,25,82,24,36,60
88,8480039,Martin Necas,C,CAR,25,82,23,37,60
88,8478401,Pavel Zacha,C,BOS,27,82,20,40,60
88,8477503,Max Domi,C,TOR,29,82,14,46,60
88,8475786,Zach Hyman,L,EDM,32,82,33,26,59
88,8476399,Blake Coleman,C,CGY,33,82,30,28,58
88,8475151,Kyle Palmieri,C,NYI,33,82,28,30,58
88,8476881,Tomas Hertl,C,VGK,31,82,22,36,58
88,8480078,Filip Chytil,C,NYR,25,82,17,41,58
88,8478038,Devon Toews,D,COL,30,82,13,45,58
88,8476906,Shayne Gostisbehere,D,CAR,31,82,13,45,58
88,8481542,Moritz Seider,D,DET,23,82,7,51,58
88,8476882,Teuvo Teravainen,L,CHI,30,82,24,33,57
88,8475314,Anders Lee,L,NYI,34,82,24,33,57
88,8482124,Quinton Byfield,R,LAK,22,82,23,34,57
88,8475714,Calle Jarnkrok,C,TOR,33,82,19,38,57
88,8478397,Rasmus Andersson,D,CGY,28,82,14,43,57
88,8476853,Morgan Rielly,D,TOR,30,82,13,44,57
88,8477346,MacKenzie Weegar,D,CGY,30,82,11,46,57
88,8482109,Alexis Lafrenière,L,NYR,23,82,27,29,56
88,8474578,Erik Karlsson,D,PIT,34,82,16,40,56
88,8482684,Luke Hughes,D,NJD,21,82,11,45,56
88,8478407,Vince Dunn,D,SEA,28,82,10,46,56
88,8476880,Tom Wilson,R,WSH,30,82,32,23,55
88,8478440,Dylan Strome,C,WSH,27,82,27,28,55
88,8475170,Brayden Schenn,C,STL,33,82,23,32,55
88,8478856,Conor Garland,R,VAN,28,82,22,33,55
88,8473986,Alex Killorn,L,ANA,35,82,21,34,55
88,8481533,Trevor Zegras,C,ANA,23,82,20,35,55
88,8478462,Nicolas Roy,C,VGK,27,82,19,36,55
88,8474150,Mikael Backlund,C,CGY,35,82,17,38,55
88,8471698,T.J. Oshie,R,WSH,38,82,31,23,54
88,8478493,Joel Eriksson Ek,C,MIN,27,82,26,28,54
88,8474586,Jordan Eberle,R,SEA,34,82,25,29,54
88,8482113,Anton Lundell,C,FLA,23,82,24,30,54
88,8477021,Alex Kerfoot,C,UTA,30,82,22,32,54
88,8474102,David Perron,L,OTT,36,82,21,33,54
88,8479999,Casey Mittelstadt,C,COL,26,82,17,37,54
88,8477951,Nick Schmaltz,C,UTA,28,82,16,38,54
88,8476875,Mike Matheson,D,MTL,30,82,16,38,54
88,8483515,Juraj Slafkovsky,L,MTL,20,82,28,25,53
88,8478047,Michael Bunting,L,PIT,29,82,26,27,53
88,8475722,Jason Zucker,L,BUF,32,82,25,28,53
88,8477935,Sam Bennett,C,FLA,28,82,21,32,53
88,8475169,Evander Kane,L,EDM,33,82,16,37,53
88,8482671,Owen Power,D,BUF,22,82,11,42,53
88,8478542,Evan Rodrigues,C,FLA,31,82,28,24,52
88,8477476,Artturi Lehkonen,L,COL,29,82,28,24,52
88,8482745,Mason McTavish,C,ANA,21,82,27,25,52
88,8482699,Dylan Guenther,R,UTA,21,82,27,25,52
88,8477407,Anthony Duclair,L,NYI,29,82,25,27,52
88,8482175,JJ Peterka,R,BUF,22,82,24,28,52
88,8482665,Matty Beniers,C,SEA,22,82,23,29,52
88,8481618,Alex Newhook,C,MTL,23,82,23,29,52
88,8479425,Filip Hronek,D,VAN,27,82,11,41,52
88,8480018,Nick Suzuki,C,MTL,25,82,19,32,51
88,8475745,Charlie Coyle,C,BOS,32,82,19,32,51
88,8476869,Brady Skjei,D,NSH,30,82,18,33,51
88,8481711,Matias Maccelli,L,UTA,24,82,17,34,51
88,8474563,Drew Doughty,D,LAK,35,82,14,37,51
88,8478469,Thomas Chabot,D,OTT,27,82,12,39,51
88,8479325,Charlie McAvoy,D,BOS,27,82,8,43,51
88,8481068,Yegor Sharangovich,C,CGY,26,82,24,26,50
88,8484144,Connor Bedard,C,CHI,19,82,23,27,50
88,8475193,Tomas Tatar,L,NJD,34,82,23,27,50
88,8480208,Drake Batherson,R,OTT,26,82,21,29,50
88,8476826,Yanni Gourde,C,SEA,33,82,19,31,50
88,8480028,Morgan Frost,C,PHI,25,82,15,35,50
88,8480434,Sean Durzi,D,UTA,26,82,11,39,50
88,8477426,Nicholas Paul,L,TBL,29,82,26,23,49
88,8482740,Wyatt Johnston,C,DAL,21,82,25,24,49
88,8483808,Andrei Kuzmenko,L,CGY,28,82,25,24,49
88,8482149,Cole Perfetti,C,WPG,22,82,23,26,49
88,8475191,Reilly Smith,R,NYR,33,82,20,29,49
88,8475791,Taylor Hall,L,CHI,33,82,20,29,49
88,8475763,Kevin Hayes,R,PIT,32,82,19,30,49
88,8478055,Gustav Forsling,D,FLA,28,82,18,31,49
88,8477498,Darnell Nurse,D,EDM,29,82,17,32,49
88,8477416,Oliver Bjorkstrand,R,SEA,29,82,16,33,49
88,8476458,Ryan Strome,C,ANA,31,82,16,33,49
88,8477932,Aaron Ekblad,D,FLA,28,82,14,35,49
88,8475753,Justin Faulk,D,STL,32,82,11,38,49
88,8479525,Ross Colton,C,COL,28,82,22,26,48
88,8475793,Ryan Johansen,C,PHI,32,82,19,29,48
88,8476461,Sean Couturier,C,PHI,32,82,19,29,48
88,8478438,Tommy Novak,C,NSH,27,82,16,32,48
88,8481596,Shane Pinto,C,OTT,24,82,27,20,47
88,8480849,Barrett Hayton,C,UTA,24,82,19,28,47
88,8477479,Tyler Bertuzzi,L,CHI,29,82,18,29,47
88,8477497,Sean Monahan,C,CBJ,30,82,17,30,47
88,8482159,Tyson Foerster,R,PHI,22,82,25,21,46
88,8480797,Joel Farabee,L,PHI,24,82,20,26,46
88,8481581,Thomas Harley,D,DAL,23,82,13,33,46
88,8477429,Andrew Copp,C,DET,30,82,13,33,46
88,8479345,Jakob Chychrun,D,WSH,26,82,11,35,46
88,8474590,John Carlson,D,WSH,34,82,10,36,46
88,8480014,Gabriel Vilardi,C,WPG,25,82,25,20,45
88,8477952,Robby Fabbri,C,ANA,28,82,22,23,45
88,8474641,Adam Henrique,C,EDM,34,82,22,23,45
88,8478057,Dakota Joshua,C,VAN,28,82,20,25,45
88,8476872,Scott Laughton,C,PHI,30,82,19,26,45
88,8477495,Seth Jones,D,CHI,30,82,12,33,45
88,8470613,Brent Burns,D,CAR,39,82,12,33,45
88,8480817,K'Andre Miller,D,NYR,24,82,12,33,45
88,8476905,Chandler Stephenson,C,SEA,30,82,10,35,45
88,8474565,Alex Pietrangelo,D,VGK,34,82,10,35,45
88,8476958,Jaccob Slavin,D,CAR,30,82,7,38,45
88,8478519,Anthony Cirelli,C,TBL,27,82,23,21,44
88,8476483,Rickard Rakell,R,PIT,31,82,21,23,44
88,8476927,Teddy Blueger,C,VAN,30,82,20,24,44
88,8477511,Anthony Mantha,R,CGY,30,82,15,29,44
88,8476921,Jordan Martinook,L,CAR,32,82,23,20,43
88,8481560,Arthur Kaliyev,R,LAK,23,82,20,23,43
88,8482097,Jack Quinn,R,BUF,23,82,19,24,43
88,8478046,Danton Heinen,L,VAN,29,82,19,24,43
88,8480829,Jesperi Kotkaniemi,C,CAR,24,82,18,25,43
88,8482055,Drew O'Connor,L,PIT,26,82,16,27,43
88,8478891,Mason Appleton,C,WPG,28,82,16,27,43
88,8475218,Mattias Ekholm,D,EDM,34,82,14,29,43
88,8476792,Torey Krug,D,STL,33,82,8,35,43
88,8478396,Noah Hanifin,D,VGK,27,82,6,37,43
88,8481582,Nicholas Robertson,L,TOR,23,82,25,17,42
88,8478474,Lawson Crouse,L,UTA,27,82,23,19,42
88,8481186,Logan O'Connor,R,COL,28,82,23,19,42
88,8478020,Michael Amadio,C,OTT,28,82,22,20,42
88,8479996,Cody Glass,C,NSH,25,82,21,21,42
88,8482146,Luke Evangelista,R,NSH,22,82,17,25,42
88,8474053,Logan Couture,C,SJS,35,82,15,27,42
88,8480220,Noah Cates,L,PHI,25,82,15,27,42
88,8481481,Blake Lizotte,C,PIT,27,82,15,27,42
88,8477444,Andre Burakovsky,L,SEA,29,82,14,28,42
88,8480871,Adam Boqvist,D,FLA,24,82,12,30,42
88,8471724,Kris Letang,D,PIT,37,82,9,33,42
88,8475760,Nick Bjugstad,C,UTA,32,82,27,14,41
88,8481535,Nils Hoglander,L,VAN,24,82,24,17,41
88,8482079,Marco Rossi,C,MIN,23,82,21,20,41
88,8480835,Jack Drury,C,CAR,24,82,20,21,41
88,8476480,Vladislav Namestnikov,C,WPG,32,82,15,26,41
88,8480798,Philipp Kurashev,C,CHI,25,82,14,27,41
88,8479992,Michael Rasmussen,C,DET,25,82,13,28,41
88,8480145,Neal Pionk,D,WPG,29,82,13,28,41
88,8476292,Ondrej Palat,L,NJD,33,82,12,29,41
88,8476438,Brandon Saad,L,STL,32,82,27,13,40
88,8476432,Boone Jenner,C,CBJ,31,82,24,16,40
88,8475768,Jaden Schwartz,C,SEA,32,82,23,17,40
88,8481554,Kaapo Kakko,R,NYR,23,82,23,17,40
88,8475799,Nino Niederreiter,R,WPG,32,82,23,17,40
88,8470621,Corey Perry,R,EDM,39,82,22,18,40
88,8480113,Alex Iafallo,L,WPG,31,82,21,19,40
88,8477987,Ryan Donato,C,CHI,28,82,17,23,40
88,8475848,Brendan Gallagher,R,MTL,32,82,16,24,40
88,8482720,Matthew Knies,L,TOR,22,82,16,24,40
88,8477948,Travis Sanheim,D,PHI,28,82,13,27,40
88,8477955,Jared McCann,L,SEA,28,82,13,27,40
88,8477986,Brandon Montour,D,SEA,30,82,9,31,40
88,8481546,Cam York,D,PHI,23,82,9,31,40
88,8479941,Justin Danforth,R,CBJ,31,82,21,18,39
88,8479987,Morgan Geekie,C,BOS,26,82,18,21,39
88,8473422,Nick Foligno,L,CHI,37,82,18,21,39
88,8474716,Jared Spurgeon,D,MIN,35,82,18,21,39
88,8478115,Pierre Engvall,L,NYI,28,82,17,22,39
88,8477964,Ivan Barbashev,C,VGK,29,82,16,23,39
88,8477015,Connor Brown,R,EDM,30,82,16,23,39
88,8475287,Erik Haula,L,NJD,33,82,11,28,39
88,8475149,Marcus Johansson,L,MIN,34,82,6,33,39
88,8477451,Ryan Hartman,R,MIN,30,82,17,21,38
88,8482475,Yegor Chinakhov,R,CBJ,23,82,17,21,38
88,8479976,Juuso Valimaki,D,UTA,26,82,4,34,38
88,8480893,Kirill Marchenko,R,CBJ,24,82,21,16,37
88,8480185,Eetu Luostarinen,C,FLA,26,82,18,19,37
88,8476419,Jean-Gabriel Pageau,C,NYI,32,82,16,21,37
88,8480068,Ryan Poehling,C,PHI,25,82,16,21,37
88,8478463,Anthony Beauvillier,L,PIT,27,82,15,22,37
88,8483457,Lane Hutson,D,MTL,20,82,13,24,37
88,8482092,Ridly Greig,C,OTT,22,82,16,20,36
88,8484203,Bradly Nadeau,L,CAR,19,82,16,20,36
88,8482133,Thomas Bordeleau,C,SJS,22,82,14,22,36
88,8481624,Ilya Mikheyev,R,CHI,30,82,13,23,36
88,8476960,Andreas Athanasiou,C,CHI,30,82,13,23,36
88,8481093,Rafael Harvey-Pinard,L,MTL,25,82,13,23,36
88,8480878,Nils Lundkvist,D,DAL,24,82,11,25,36
88,8478472,Mathieu Joseph,R,STL,27,82,10,26,36
88,8480802,Ryan McLeod,C,BUF,25,82,10,26,36
88,8476854,Hampus Lindholm,D,BOS,30,82,9,27,36
88,8476981,Josh Anderson,R,MTL,30,82,19,16,35
88,8481704,Juuso Parssinen,C,NSH,23,82,19,16,35
88,8476469,Joel Armia,R,MTL,31,82,13,22,35
88,8478413,Jordan Greenway,L,BUF,27,82,12,23,35
88,8479400,Pierre-Luc Dubois,L,WSH,26,82,11,24,35
88,8474189,Lars Eller,C,PIT,35,82,11,24,35
88,8475200,Dmitry Orlov,D,CAR,33,82,11,24,35
88,8481028,Martin Pospisil,C,CGY,25,82,11,24,35
88,8476923,Damon Severson,D,CBJ,30,82,8,27,35
88,8482705,Cole Sillinger,C,CBJ,21,82,17,17,34
88,8477450,Jason Dickinson,C,CHI,29,82,17,17,34
88,8477998,Warren Foegele,L,LAK,28,82,16,18,34
88,8476474,Stefan Noesen,R,NJD,31,82,15,19,34
88,8478233,Andrew Mangiapane,L,WSH,28,82,14,20,34
88,8477839,Conor Sheary,L,TBL,32,82,13,21,34
88,8476331,Dylan DeMelo,D,WPG,31,82,6,28,34
88,8475171,Oliver Ekman-Larsson,D,TOR,33,82,5,29,34
88,8482122,Brock Faber,D,MIN,22,82,3,31,34
88,8473533,Jordan Staal,C,CAR,36,82,19,14,33
88,8482117,Lukas Reichel,L,CHI,22,82,17,16,33
88,8476925,Colton Sissons,C,NSH,31,82,14,19,33
88,8480459,Pius Suter,C,VAN,28,82,13,20,33
88,8480064,Josh Norris,C,OTT,25,82,12,21,33
88,8479351,Sam Steel,C,DAL,26,82,12,21,33
88,8478458,Jack Roslovic,C,CAR,27,82,11,22,33
88,8476892,Colton Parayko,D,STL,31,82,8,25,33
88,8478882,Vladislav Gavrikov,D,LAK,29,82,8,25,33
88,8476979,Erik Gustafsson,D,DET,32,82,4,29,33
88,8479398,Samuel Girard,D,COL,26,82,1,32,33
88,8480748,Kiefer Sherwood,L,VAN,29,82,17,15,32
88,8479353,Brett Howden,C,VGK,26,82,16,16,32
88,8476624,Barclay Goodrow,C,SJS,31,82,13,19,32
88,8483431,Logan Cooley,C,UTA,20,82,12,20,32
88,8475343,Nic Dowd,C,WSH,34,82,12,20,32
88,8476463,Jonas Brodin,D,MIN,31,82,10,22,32
88,8481606,Jordan Spence,D,LAK,23,82,8,24,32
88,8476897,Oskar Sundqvist,C,STL,30,82,8,24,32
88,8477969,Marcus Pettersson,D,PIT,28,82,5,27,32
88,8475764,Cam Fowler,D,ANA,33,82,3,29,32
88,8477425,Miles Wood,L,COL,29,82,17,14,31
88,8474715,Cam Atkinson,R,TBL,35,82,16,15,31
88,8479365,Trent Frederic,C,BOS,26,82,15,16,31
88,8481032,Paul Cotter,C,NJD,25,82,15,16,31
88,8480813,Joe Veleno,C,DET,24,82,14,17,31
88,8476889,Radek Faksa,C,STL,30,82,14,17,31
88,8480144,David Kampf,C,TOR,29,82,14,17,31
88,8478911,Matt Roy,D,WSH,29,82,11,20,31
88,8480789,Oliver Wahlstrom,R,NYI,24,82,9,22,31
88,8480222,Sebastian Aho,D,PIT,28,82,6,25,31
88,8477220,Nate Schmidt,D,FLA,33,82,3,28,31
88,8475233,David Savard,D,MTL,34,82,3,28,31
88,8481013,Jonatan Berggren,R,DET,24,82,19,11,30
88,8482089,Jake Neighbours,L,STL,22,82,18,12,30
88,8481604,Pavel Dorofeyev,L,VGK,24,82,17,13,30
88,8481656,Aliaksei Protas,C,WSH,23,82,15,15,30
88,8482074,Connor Zary,C,CGY,23,82,13,17,30
88,8482105,Jake Sanderson,D,OTT,22,82,11,19,30
88,8477947,Sonny Milano,L,WSH,28,82,11,19,30
88,8478133,Jake Evans,C,MTL,28,82,10,20,30
88,8482807,Ethan Del Mastro,D,CHI,21,82,10,20,30
88,8479591,Michael Eyssimont,C,TBL,28,82,9,21,30
88,8473563,Nicklas Backstrom,C,WSH,37,82,7,23,30
88,8478851,Alexandre Carrier,D,NSH,28,82,6,24,30
88,8476931,Jake McCabe,D,TOR,31,82,6,24,30
88,8475324,Nick Jensen,D,OTT,34,82,5,25,30
88,8482655,J.J. Moser,D,TBL,24,82,4,26,30
88,8478508,Yakov Trenin,C,MIN,27,82,18,11,29
88,8476278,Colin Blackwell,C,DAL,31,82,16,13,29
88,8481553,Bobby Brink,R,PHI,23,82,12,17,29
88,8482111,Justin Barron,D,MTL,23,82,12,17,29
88,8478109,Victor Olofsson,L,VGK,29,82,11,18,29
88,8478013,Jake Walman,D,SJS,28,82,11,18,29
88,8476329,Travis Boyd,C,MIN,31,82,9,20,29
88,8475855,Jesper Fast,R,CAR,33,82,9,20,29
88,8480246,Nick Perbix,D,TBL,26,82,5,24,29
88,8480873,Rasmus Sandin,D,WSH,24,82,4,25,29
88,8477989,Christian Dvorak,C,MTL,28,82,4,25,29
88,8474673,TJ Brodie,D,CHI,34,82,2,27,29
88,8480009,Eeli Tolvanen,R,SEA,25,82,19,9,28
88,8481601,Simon Holmstrom,R,NYI,23,82,16,12,28
88,8479393,Noah Gregor,C,OTT,26,82,14,14,28
88,8480855,Jack McBain,C,UTA,24,82,11,17,28
88,8481517,Brett Leason,R,ANA,25,82,11,17,28
88,8480336,Sean Walker,D,CAR,30,82,8,20,28
88,8474574,Tyler Myers,D,VAN,34,82,8,20,28
88,8479402,Jake Bean,D,CGY,26,82,7,21,28
88,8476879,Cody Ceci,D,EDM,31,82,6,22,28
88,8474151,Ryan McDonagh,D,TBL,35,82,3,25,28
88,8482141,Lukas Cormier,D,VGK,22,82,13,14,27
88,8481477,Nico Sturm,C,SJS,29,82,12,15,27
88,8475220,Marcus Foligno,L,MIN,33,82,11,16,27
88,8477919,Frederick Gaudreau,C,MIN,31,82,10,17,27
88,8482624,Daniil Miromanov,D,CGY,27,82,10,17,27
88,8483490,Pavel Mintyukov,D,ANA,21,82,8,19,27
88,8480043,Timothy Liljegren,D,TOR,25,82,6,21,27
88,8479983,Mario Ferraro,D,SJS,26,82,4,23,27
88,8482259,Bobby McMann,C,TOR,28,82,15,11,26
88,8477953,Kasperi Kapanen,R,STL,28,82,14,12,26
88,8484145,Zach Benson,L,BUF,19,82,11,15,26
88,8480806,Isac Lundestrom,C,ANA,25,82,11,15,26
88,8477508,Curtis Lazar,C,NJD,29,82,11,15,26
88,8482733,Logan Mailloux,D,MTL,31,82,11,15,26
88,8474149,Evgenii Dadonov,R,DAL,35,82,9,17,26
88,8479661,Tanner Jeannot,L,LAK,27,82,9,17,26
88,8482660,Kent Johnson,C,CBJ,22,82,8,18,26
88,8481567,Henry Thrun,D,SJS,23,82,7,19,26
88,8480796,Martin Fehervary,D,WSH,25,82,4,22,26
88,8480049,Dylan Samberg,D,WPG,25,82,1,25,26
88,8482145,Mavrik Bourque,C,DAL,22,82,16,9,25
88,8484166,Adam Fantilli,C,CBJ,20,82,14,11,25
88,8482155,Alex Laferriere,R,LAK,23,82,13,12,25
88,8477903,Garnet Hathaway,R,PHI,33,82,12,13,25
88,8477369,Carson Soucy,D,VAN,30,82,12,13,25
88,8477507,Nikita Zadorov,D,BOS,29,82,10,15,25
88,8479316,Luke Kunin,C,SJS,27,82,9,16,25
88,8476902,Esa Lindell,D,DAL,30,82,8,17,25
88,8476392,Adam Lowry,C,WPG,31,82,7,18,25
88,8482087,Kaiden Guhle,D,MTL,22,82,6,19,25
88,8477506,Ryan Pulock,D,NYI,30,82,5,20,25
88,8480807,Mattias Samuelsson,D,BUF,24,82,5,20,25
88,8482142,Jamie Drysdale,D,PHI,22,82,4,21,25
88,8483565,Nick Blankenburg,D,NSH,26,82,4,21,25
88,8476891,Matt Grzelcyk,D,PIT,30,82,3,22,25
88,8480035,Henri Jokiharju,D,BUF,25,82,3,22,25
88,8479293,Brandon Tanev,L,SEA,33,82,18,6,24
88,8481580,Connor McMichael,C,WSH,23,82,12,12,24
88,8482125,Alexander Holtz,R,VGK,22,82,11,13,24
88,8480448,Parker Kelly,L,COL,25,82,11,13,24
88,8479390,Taylor Raddysh,R,WSH,26,82,10,14,24
88,8482666,Scott Morrow,D,CAR,22,82,8,16,24
88,8475279,Ben Chiarot,D,DET,33,82,4,20,24
88,8476917,Adam Pelech,D,NYI,30,82,3,21,24
88,8473507,Jeff Petry,D,DET,37,82,3,21,24
88,8484911,Collin Graf,R,SJS,22,82,15,8,23
88,8476918,Jimmy Vesey,L,NYR,31,82,12,11,23
88,8477392,Hudson Fasching,R,NYI,29,82,12,11,23
88,8479414,Nathan Bastian,R,NJD,27,82,12,11,23
88,8481522,Peyton Krebs,C,BUF,23,82,10,13,23
88,8480980,Connor Dewar,C,TOR,25,82,10,13,23
88,8480021,Jack Studnicka,C,LAK,25,82,9,14,23
88,8480995,Pontus Holmberg,R,TOR,25,82,9,14,23
88,8476442,Matt Nieto,L,PIT,32,82,8,15,23
88,8482679,Matt Coronato,R,CGY,22,82,7,16,23
88,8475188,Brayden McNabb,D,VGK,33,82,6,17,23
88,8477435,Ryan Graves,D,PIT,29,82,6,17,23
88,8479371,Dante Fabbro,D,NSH,26,82,5,18,23
88,8478507,John Marino,D,UTA,27,82,4,19,23
88,8476312,Josh Manson,D,COL,33,82,3,20,23
88,8482073,Braden Schneider,D,NYR,23,82,3,20,23
88,8481568,Alex Vlasic,D,CHI,23,82,3,20,23
88,8481178,Egor Zamula,D,PHI,24,82,2,21,23
88,8478500,Ivan Provorov,D,CBJ,27,82,0,23,23
88,8482077,Dylan Holloway,L,EDM,23,82,16,6,22
88,8482762,Simon Edvinsson,D,DET,21,82,13,9,22
88,8479359,Beck Malenstyn,L,BUF,26,82,11,11,22
88,8478434,Keegan Kolesar,R,VGK,27,82,10,12,22
88,8482166,Shakir Mukhamadullin,D,SJS,22,82,10,12,22
88,8477406,Mattias Janmark,C,EDM,32,82,10,12,22
88,8478211,Dryden Hunt,L,CGY,29,82,8,14,22
88,8480172,Jan Rutta,D,SJS,34,82,5,17,22
88,8476885,Jacob Trouba,D,NYR,30,82,4,18,22
88,8479324,Ryan Lindgren,D,NYR,26,82,3,19,22
88,8475181,Nick Leddy,D,STL,33,82,3,19,22
88,8478399,Jonas Siegenthaler,D,NJD,27,82,3,19,22
88,8480860,Kevin Bahl,D,CGY,24,82,2,20,22
88,8477845,Trevor van Riemsdyk,D,WSH,33,82,1,21,22
88,8483445,Cutter Gauthier,L,ANA,20,82,8,13,21
88,8483493,Frank Nazar,C,CHI,20,82,8,13,21
88,8482470,Ilya Solovyov,D,CGY,24,82,6,15,21
88,8483505,Matthew Poitras,C,BOS,20,82,5,16,21
88,8476525,Colin Miller,D,WPG,32,82,4,17,21
88,8480073,Erik Brannstrom,D,COL,25,82,3,18,21
88,8481708,Zac Jones,D,NYR,24,82,3,18,21
88,8478840,Will Borgen,D,SEA,28,82,3,18,21
88,8479369,Andrew Peeke,D,BOS,26,82,1,20,21
88,8482245,Artem Zub,D,OTT,29,82,1,20,21
88,8476878,Zemgus Girgensons,L,TBL,30,82,12,8,20
88,8475842,Sam Carrick,C,NYR,32,82,11,9,20
88,8484153,Leo Carlsson,C,ANA,20,82,10,10,20
88,8476873,Mark Jankowski,C,NSH,30,82,8,12,20
88,8478432,Christian Fischer,R,DET,27,82,8,12,20
88,8479368,Max Jones,L,BOS,26,82,8,12,20
88,8477931,Tomas Nosek,L,FLA,32,82,8,12,20
88,8473453,Trevor Lewis,C,LAK,37,82,7,13,20
88,8477938,Haydn Fleury,D,WPG,28,82,6,14,20
88,8478416,Erik Cernak,D,TBL,27,82,5,15,20
88,8478859,Niko Mikkola,D,FLA,28,82,5,15,20
88,8477365,Connor Clifton,D,BUF,29,82,3,17,20
88,8479998,Mikey Anderson,D,LAK,25,82,3,17,20
88,8482659,Josh Doan,R,UTA,22,82,10,9,19
88,8477335,Kyle Burroughs,D,LAK,29,82,8,11,19
88,8476374,Sean Kuraly,C,CBJ,31,82,6,13,19
88,8476422,Mike Reilly,D,NYI,31,82,5,14,19
88,8478178,Darren Raddysh,D,TBL,28,82,4,15,19
88,8480879,Jacob Bernard-Docker,D,OTT,24,82,4,15,19
88,8478136,Jake Middleton,D,MIN,28,82,3,16,19
88,8478569,Noel Acciari,C,PIT,33,82,13,5,18
88,8480870,Bo Groulx,C,NYR,24,82,10,8,18
88,8480025,MacKenzie Entwistle,R,FLA,25,82,8,10,18
88,8476457,Adam Larsson,D,SEA,32,82,7,11,18
88,8480003,Jesper Boqvist,C,FLA,26,82,6,12,18
88,8475231,Casey Cizikas,C,NYI,33,82,6,12,18
88,8479980,Nicolas Hague,D,VGK,26,82,6,12,18
88,8482118,Sam Colangelo,R,ANA,23,82,6,12,18
88,8482712,Oskar Olausson,R,COL,22,82,6,12,18
88,8481014,Alexander Romanov,D,NYI,24,82,3,15,18
88,8476822,Luke Glendening,C,TBL,35,82,9,8,17
88,8477505,Alexander Wennberg,C,SJS,30,82,9,8,17
88,8482702,Logan Stankoven,C,DAL,21,82,8,9,17
88,8483495,Simon Nemec,D,NJD,20,82,7,10,17
88,8476467,Jamie Oleksiak,D,SEA,32,82,6,11,17
88,8477353,Tyler Motte,C,DET,29,82,5,12,17
88,8478443,Brandon Carlo,D,BOS,28,82,4,13,17
88,8482062,Cole Smith,L,NSH,29,82,8,8,16
88,8483524,Shane Wright,C,SEA,20,82,8,8,16
88,8477488,Brett Pesce,D,NJD,30,82,4,12,16
88,8476967,Brett Kulak,D,EDM,30,82,4,12,16
88,8483499,Liam Ohgren,L,MIN,20,82,4,12,16
88,8475177,Calvin de Haan,D,COL,33,82,4,12,16
88,8477034,Jaycob Megna,D,FLA,32,82,3,13,16
88,8483460,David Jiricek,D,CBJ,21,82,3,13,16
88,8475690,Chris Tanev,D,TOR,35,82,2,14,16
88,8476429,Scott Mayfield,D,NYI,32,82,2,14,16
88,8474013,Ian Cole,D,UTA,35,82,2,14,16
88,8480834,Ty Emberson,D,SJS,24,82,2,14,16
88,8482749,Joshua Roy,R,MTL,21,82,8,7,15
88,8476441,Joel Edmundson,D,LAK,31,82,7,8,15
88,8475462,Radko Gudas,D,ANA,34,82,4,11,15
88,8470600,Ryan Suter,D,STL,39,82,3,12,15
88,8475790,Erik Gudbranson,D,CBJ,32,82,2,13,15
88,8478468,Jeremy Lauzon,D,NSH,27,82,2,13,15
88,8476372,Nick Seeler,D,PHI,31,82,2,13,15
88,8480950,Ilya Lyubushkin,D,DAL,30,82,2,13,15
88,8483468,Jiri Kulich,C,BUF,20,82,1,14,15
88,8479291,Kevin Rooney,C,CGY,31,82,8,6,14
88,8480281,Alexey Toropchenko,R,STL,25,82,8,6,14
88,8480074,Alexandre Texier,C,STL,25,82,6,8,14
88,8483482,Tristan Luneau,D,ANA,20,82,6,8,14
88,8475718,Justin Holl,D,DET,32,82,5,9,14
88,8483397,Marc McLaughlin,C,BOS,25,82,5,9,14
88,8483489,Fraser Minten,C,TOR,31,82,5,9,14
88,8482809,Jackson Blake,R,CAR,21,82,4,10,14
88,8480990,Declan Chisholm,D,MIN,24,82,4,10,14
88,8474567,Zach Bogosian,D,MIN,34,82,4,10,14
88,8474090,Brendan Smith,D,DAL,35,82,2,12,14
88,8477499,Rasmus Ristolainen,D,PHI,30,82,8,5,13
88,8483763,Maksymilian Szuber,D,UTA,22,82,5,8,13
88,8483471,Brad Lambert,C,WPG,31,82,5,8,13
88,8475762,Derek Forbort,D,VAN,32,82,2,11,13
88,8481699,Aku Raty,R,UTA,23,82,1,12,13
88,8482803,Olen Zellweger,D,ANA,21,82,4,8,12
88,8482516,Matthew Kessel,D,STL,24,82,4,8,12
88,8481524,Bowen Byram,D,BUF,23,82,3,9,12
88,8484149,Gavin Brindley,C,CBJ,20,82,3,9,12
88,8474612,Travis Hamonic,D,OTT,34,82,2,10,12
88,8481605,Jackson LaCombe,D,ANA,23,82,2,10,12
88,8476473,Connor Murphy,D,CHI,31,82,1,11,12
88,8476858,Phillip Di Giuseppe,L,VAN,31,82,7,4,11
88,8482153,Brendan Brisson,C,VGK,23,82,6,5,11
88,8475455,Brenden Dillon,D,NJD,34,82,3,8,11
88,8482858,Ryker Evans,D,SEA,23,82,3,8,11
88,8479638,Justin Brazeau,R,BOS,26,82,3,8,11
88,8482070,Mitchell Chaffee,R,TBL,26,82,4,6,10
88,8481122,Simon Benoit,D,TOR,26,82,3,7,10
88,8483466,Kevin Korchinski,D,CHI,20,82,3,7,10
88,8482713,Mackie Samoskevich,R,FLA,22,82,3,7,10
88,8479442,Troy Stecher,D,EDM,30,82,1,9,10
88,8478874,Adam Gaudette,C,OTT,28,82,1,9,10
88,8481641,Joel Kiviranta,L,COL,28,82,7,2,9
88,8482859,Zack Ostapchuk,C,OTT,21,82,4,5,9
88,8483567,Georgii Merkulov,C,BOS,24,82,3,6,9
88,8482101,Danil Gushchin,L,SJS,22,82,2,7,9
88,8479576,Vincent Desharnais,D,VAN,28,82,0,9,9
88,8482787,Nikita Chibrikov,R,WPG,31,82,5,3,8
88,8483012,Logan Morrison,C,SEA,22,82,1,7,8
88,8471677,Jack Johnson,D,CBJ,37,82,1,7,8
88,8478450,Parker Wotherspoon,D,BOS,27,82,2,5,7
88,8474062,Riley Nash,C,NYR,35,82,1,2,3
88,8470794,Joe Pavelski,C,,40,0,0,0,0
88,8481703,Valtteri Puustinen,R,PIT,25,0,0,0,0
88,8477950,Tony DeAngelo,D,,29,0,0,0,0
88,8481577,Philip Tomasino,C,NSH,23,0,0,0,0
88,8475197,Tyson Barrie,D,,33,0,0,0,0
88,8471218,Blake Wheeler,R,,38,0,0,0,0
88,8474157,Max Pacioretty,L,,36,0,0,0,0
88,8478466,Daniel Sprong,R,VAN,27,0,0,0,0
88,8475744,Evgeny Kuznetsov,C,,32,0,0,0,0
88,8481019,David Gustafsson,C,WPG,24,0,0,0,0
88,8475906,John Klingberg,D,,32,0,0,0,0
88,8479348,Kale Clague,D,BUF,26,0,0,0,0
88,8476952,Dominic Toninato,C,WPG,30,0,0,0,0
88,8473473,Milan Lucic,L,,36,0,0,0,0
88,8474037,James van Riemsdyk,L,,35,0,0,0,0
88,8474602,Justin Schultz,D,,34,0,0,0,0
88,8482222,Alexander Barabanov,L,,30,0,0,0,0
88,8479372,Josh Mahura,D,SEA,26,0,0,0,0
88,8479982,Conor Timmins,D,TOR,26,0,0,0,0
88,8474031,Kevin Shattenkirk,D,,35,0,0,0,0
88,8480008,Adam Ruzicka,C,,25,0,0,0,0
88,8481059,Scott Perunovich,D,STL,26,0,0,0,0
88,8480884,Calen Addison,D,,24,0,0,0,0
88,8476994,Vinnie Hinostroza,C,NSH,30,0,0,0,0
88,8478452,Caleb Jones,D,LAK,27,0,0,0,0
88,8480157,Calle Rosen,D,COL,30,0,0,0,0
88,8481609,Vladislav Kolyachonok,D,UTA,23,0,0,0,0
88,8479415,Michael McLeod,C,,26,0,0,0,0
88,8476919,Chris Tierney,C,,30,0,0,0,0
88,8479639,Dylan Coghlan,D,WPG,26,0,0,0,0
88,8478146,Matthew Highmore,C,OTT,28,0,0,0,0
88,8478970,Jalen Chatfield,D,CAR,28,0,0,0,0
88,8480205,Emil Bemstrom,C,PIT,25,0,0,0,0
88,8474884,Mike Hoffman,C,,35,0,0,0,0
88,8471274,Alex Goligoski,D,,39,0,0,0,0
88,8478104,Sammy Blais,L,,28,0,0,0,0
88,8474870,Tyler Johnson,C,,34,0,0,0,0
88,8476913,Devin Shore,C,MIN,30,0,0,0,0
88,8481598,Philip Broberg,D,EDM,23,0,0,0,0
88,8480058,Pierre-Olivier Joseph,D,STL,25,0,0,0,0
88,8480891,Michael Kesselring,D,UTA,24,0,0,0,0
88,8477979,Nicolas Aube-Kubel,R,BUF,28,0,0,0,0
88,8476871,Tanner Pearson,L,,32,0,0,0,0
88,8476393,Nick Cousins,C,,31,0,0,0,0
88,8479977,Kailer Yamamoto,R,,26,0,0,0,0
88,8479543,Michael Pezzetta,L,MTL,26,0,0,0,0
88,8477018,Ben Hutton,D,VGK,31,0,0,0,0
88,8480762,Eric Robinson,L,CAR,29,0,0,0,0
88,8474034,Pat Maroon,L,CHI,36,0,0,0,0
88,8481058,Jesse Ylönen,R,,25,0,0,0,0
88,8475179,Dmitry Kulikov,D,FLA,34,0,0,0,0
88,8481527,Kaedan Korczak,D,VGK,23,0,0,0,0
88,8473449,Kyle Okposo,R,,36,0,0,0,0
88,8482192,Isaak Phillips,D,CHI,23,0,0,0,0
88,8480727,Zach Whitecloud,D,VGK,28,0,0,0,0
88,8479346,Dillon Dube,C,,26,0,0,0,0
88,8480821,Filip Zadina,R,,25,0,0,0,0
88,8480001,Urho Vaakanainen,D,ANA,25,0,0,0,0
88,8470966,Mark Giordano,D,,41,0,0,0,0
88,8480853,Liam Foudy,C,,24,0,0,0,0
88,8475225,Craig Smith,C,CHI,35,0,0,0,0
88,8479972,Mason Shaw,C,WPG,26,0,0,0,0
88,8478451,Ethan Bear,D,WSH,27,0,0,0,0
88,8474040,Sam Gagner,C,,35,0,0,0,0
88,8480196,Jacob Bryson,D,BUF,27,0,0,0,0
88,8479984,Cal Foote,D,,26,0,0,0,0
88,8480011,Klim Kostin,C,SJS,25,0,0,0,0
88,8482176,Wyatt Kaiser,D,CHI,22,0,0,0,0
88,8476988,Matt Benning,D,SJS,30,0,0,0,0
88,8479370,Tyson Jost,C,CAR,26,0,0,0,0
88,8477464,Nic Petan,C,,29,0,0,0,0
88,8477380,Jonny Brodzinski,C,NYR,31,0,0,0,0
88,8480070,Ian Mitchell,D,BOS,25,0,0,0,0
88,8479315,Joey Anderson,R,CHI,26,0,0,0,0
88,8478099,Kevin Labanc,R,,29,0,0,0,0
88,8476874,Olli Maatta,D,DET,30,0,0,0,0
88,8475208,Brian Dumoulin,D,ANA,33,0,0,0,0
88,8478430,Oliver Kylington,D,,27,0,0,0,0
88,8479536,Axel Jonsson-Fjallby,L,WPG,26,0,0,0,0
88,8479671,Mathieu Olivier,R,CBJ,27,0,0,0,0
88,8471709,Marc-Edouard Vlasic,D,SJS,37,0,0,0,0
88,8479328,Julien Gauthier,R,NYI,27,0,0,0,0
88,8478421,A.J. Greer,L,FLA,28,0,0,0,0
88,8477573,Nathan Walker,L,STL,30,0,0,0,0
88,8481537,Nikita Okhotiuk,D,CGY,24,0,0,0,0
88,8474166,Alec Martinez,D,CHI,37,0,0,0,0
88,8470610,Zach Parise,L,,40,0,0,0,0
88,8477478,William Carrier,L,CAR,30,0,0,0,0
88,8479344,Jesse Puljujarvi,R,PIT,26,0,0,0,0
88,8480887,Jordan Harris,D,MTL,24,0,0,0,0
88,8478502,Dennis Gilbert,D,BUF,28,0,0,0,0
88,8482730,Brandt Clarke,D,LAK,21,0,0,0,0
88,8480355,Mark Kastelic,C,BOS,25,0,0,0,0
88,8475750,Jon Merrill,D,MIN,32,0,0,0,0
88,8475164,Jakob Silfverberg,R,,34,0,0,0,0
88,8477944,Jakub Vrana,L,,28,0,0,0,0
88,8479439,Jacob MacDonald,D,COL,31,0,0,0,0
88,8474568,Luke Schenn,D,NSH,35,0,0,0,0
88,8478454,Noah Juulsen,D,VAN,27,0,0,0,0
88,8475752,Tyler Pitlick,C,,33,0,0,0,0
88,8482148,Hendrix Lapierre,C,WSH,22,0,0,0,0
88,8481167,Brayden Pachal,D,CGY,25,0,0,0,0
88,8478043,Sam Lafferty,C,BUF,29,0,0,0,0
88,8479321,Lucas Johansen,D,,27,0,0,0,0
88,8471699,Andrew Cogliano,C,,37,0,0,0,0
88,8481521,Ronnie Attard,D,PHI,25,0,0,0,0
88,8481161,Jake Christiansen,D,CBJ,25,0,0,0,0
88,8479458,Nikita Zaitsev,D,,33,0,0,0,0
88,8479619,Michael Carcone,L,UTA,28,0,0,0,0
88,8479026,Philippe Myers,D,TOR,27,0,0,0,0
88,8477330,Dominik Kubalik,L,,29,0,0,0,0
88,8481617,Vasily Podkolzin,R,VAN,23,0,0,0,0
88,8481701,Santeri Hatakka,D,NJD,23,0,0,0,0
88,8479514,Rem Pitlick,C,,27,0,0,0,0
88,8477446,Michael McCarron,R,NSH,29,0,0,0,0
88,8470604,Jeff Carter,C,,39,0,0,0,0
88,8482241,Radim Zohorna,L,,28,0,0,0,0
88,8480289,Morgan Barron,C,WPG,26,0,0,0,0
88,8479379,Givani Smith,R,SJS,26,0,0,0,0
88,8480216,Jacob Peterson,C,,25,0,0,0,0
88,8477851,Jordan Oesterle,D,BOS,32,0,0,0,0
88,8484258,Sam Malinski,D,COL,26,0,0,0,0
88,8478904,Steven Lorentz,C,,28,0,0,0,0
88,8482095,Tyler Kleven,D,OTT,22,0,0,0,0
88,8480848,Ty Dellandrea,C,SJS,24,0,0,0,0
88,8476884,Derrick Pouliot,D,,30,0,0,0,0
88,8479336,Carl Grundstrom,R,SJS,27,0,0,0,0
88,8482964,Arber Xhekaj,D,MTL,23,0,0,0,0
88,8471686,Marc Staal,D,,37,0,0,0,0
88,8477887,Patrick Brown,C,BOS,32,0,0,0,0
88,8478495,Denis Gurianov,R,,27,0,0,0,0
88,8473504,Cal Clutterbuck,R,,37,0,0,0,0
88,8481550,Adam Beckman,L,NJD,23,0,0,0,0
88,8480845,Rasmus Kupari,C,WPG,24,0,0,0,0
88,8474009,Nick Bonino,C,,36,0,0,0,0
88,8478585,Derek Ryan,C,EDM,38,0,0,0,0
88,8477962,Brendan Lemieux,L,CAR,28,0,0,0,0
88,8482861,Vincent Iorio,D,WSH,22,0,0,0,0
88,8479378,Logan Stanley,D,WPG,26,0,0,0,0
88,8473446,Erik Johnson,D,PHI,36,0,0,0,0
88,8481743,Marc Del Gaizo,D,NSH,25,0,0,0,0
88,8477384,Josh Brown,D,EDM,30,0,0,0,0
88,8482165,Yan Kuznetsov,D,CGY,22,0,0,0,0
88,8478424,Jansen Harkins,C,ANA,27,0,0,0,0
88,8482144,Jack Thompson,D,SJS,22,0,0,0,0
88,8478512,Austin Czarnik,C,,32,0,0,0,0
88,8477527,Ross Johnston,L,ANA,30,0,0,0,0
88,8479383,Boris Katchouk,L,,26,0,0,0,0
88,8482094,Daemon Hunt,D,MIN,22,0,0,0,0
88,8481719,Maxwell Crozier,D,TBL,24,0,0,0,0
88,8480192,Johnathan Kovacevic,D,NJD,27,0,0,0,0
88,8479376,Victor Mete,D,,26,0,0,0,0
88,8482511,Mason Lohrei,D,BOS,23,0,0,0,0
88,8475825,Jani Hakanpää,D,,32,0,0,0,0
88,8478021,William Lagesson,D,DET,28,0,0,0,0
88,8475795,Dylan McIlrath,D,WSH,32,0,0,0,0
88,8477846,Ryan Carpenter,C,,33,0,0,0,0
88,8481056,Spencer Stastney,D,NSH,24,0,0,0,0
88,8481564,Ryan Johnson,D,BUF,23,0,0,0,0
88,8478017,Mark Friedman,D,VAN,29,0,0,0,0
88,8479320,Max Lajoie,D,SEA,27,0,0,0,0
88,8480075,Cameron Crotty,D,MIN,25,0,0,0,0
88,8484287,Cole McWard,D,VAN,23,0,0,0,0
88,8484254,Akito Hirose,D,VAN,25,0,0,0,0
88,8483407,Brandon Scanlin,D,NYR,25,0,0,0,0
88,8480274,Philip Kemp,D,EDM,25,0,0,0,0
88,8479522,Hardy Haman Aktell,D,WSH,26,0,0,0,0
88,8480007,Jonas Rondbjerg,R,VGK,25,0,0,0,0
88,8477454,Adam Erne,L,,29,0,0,0,0
88,8481679,Maxence Guenette,D,OTT,23,0,0,0,0
88,8480441,Trey Fix-Wolansky,R,CBJ,25,0,0,0,0
88,8483546,Marshall Rifai,D,TOR,26,0,0,0,0
88,8480084,Nick DeSimone,D,NJD,30,0,0,0,0
88,8481030,Jack St. Ivany,D,PIT,25,0,0,0,0
88,8481592,Jakob Pelletier,L,CGY,23,0,0,0,0
88,8478011,Louie Belpedio,D,PHI,28,0,0,0,0
88,8477930,Pierre-Edouard Bellemare,L,,39,0,0,0,0
88,8484321,Nikolas Matinpalo,D,OTT,26,0,0,0,0
88,8482067,Connor Mackey,D,NYR,28,0,0,0,0
88,8481806,Louis Crevier,D,CHI,23,0,0,0,0
88,8484326,Patrik Koch,D,UTA,28,0,0,0,0
88,8477971,Andreas Englund,D,LAK,28,0,0,0,0
88,8481751,Lukas Rousek,R,BUF,25,0,0,0,0
88,8481006,Tyler Tucker,D,STL,24,0,0,0,0
88,8476867,Brendan Gaunce,C,MIN,30,0,0,0,0
88,8479520,Brandon Duhaime,R,WSH,27,0,0,0,0
88,8477073,Kurtis MacDermid,L,NJD,30,0,0,0,0
88,8480874,Adam Ginning,D,PHI,24,0,0,0,0
88,8477473,Justin Bailey,R,SJS,29,0,0,0,0
88,8479066,Ryan Lomberg,L,CGY,30,0,0,0,0
88,8477070,Liam O'Brien,C,UTA,30,0,0,0,0
88,8474618,Marco Scandella,D,,34,0,0,0,0
88,8475797,Jarred Tinordi,D,,32,0,0,0,0
88,8481441,Joe Snively,C,DET,28,0,0,0,0
88,8477244,Chad Ruhwedel,D,NYR,34,0,0,0,0
88,8479772,Zack MacEwen,R,OTT,28,0,0,0,0
88,8481147,Reese Johnson,C,MIN,26,0,0,0,0
88,8481043,Cole Koepke,L,BOS,26,0,0,0,0
88,8483619,Filip Roos,D,OTT,25,0,0,0,0
88,8481541,Samuel Bolduc,D,NYI,24,0,0,0,0
88,8477810,Joel Hanley,D,CGY,33,0,0,0,0
88,8476907,Mackenzie MacEachern,L,,30,0,0,0,0
88,8482652,Walker Duehr,R,CGY,27,0,0,0,0
88,8477126,Jayson Megna,C,,34,0,0,0,0
88,8483398,Declan Carlile,D,TBL,31,0,0,0,0
88,8482929,Emil Lilleberg,D,TBL,23,0,0,0,0
88,8480880,Jakub Lauko,C,MIN,24,0,0,0,0
88,8480245,Olle Lycksell,R,PHI,25,0,0,0,0
88,8480252,Cole Guttman,C,CHI,25,0,0,0,0
88,8477467,Gustav Olofsson,D,SEA,30,0,0,0,0
88,8479968,Vinni Lettieri,C,BOS,29,0,0,0,0
88,8478400,Colin White,C,,27,0,0,0,0
88,8475755,Alexander Petrovic,D,DAL,32,0,0,0,0
88,8481812,Nikolai Knyzhov,D,,27,0,0,0,0
88,8481593,Jayden Struble,D,MTL,23,0,0,0,0
88,8481532,Alex Turcotte,C,LAK,23,0,0,0,0
88,8482126,Emil Andrae,D,PHI,31,0,0,0,0
88,8479944,Zach Aston-Reese,C,VGK,30,0,0,0,0
88,8471817,Ryan Reaves,R,TOR,37,0,0,0,0
88,8481206,John Ludvig,D,PIT,24,0,0,0,0
88,8481599,Victor Soderstrom,D,UTA,23,0,0,0,0
88,8480292,Carson Meyer,R,ANA,27,0,0,0,0
88,8482496,Nils Aman,C,VAN,24,0,0,0,0
88,8479718,Alex Barré-Boulet,C,MTL,27,0,0,0,0
88,8479994,Jaret Anderson-Dolan,C,WPG,25,0,0,0,0
88,8480184,Gustav Lindstrom,D,,26,0,0,0,0
88,8480890,Jan Jenik,R,OTT,24,0,0,0,0
88,8478067,Oskar Lindblom,L,,28,0,0,0,0
88,8476934,Brock McGinn,L,ANA,30,0,0,0,0
88,8479985,Cale Fleury,D,SEA,26,0,0,0,0
88,8484304,Uvis Balinskis,D,FLA,28,0,0,0,0
88,8479981,Jonah Gadjovich,L,FLA,26,0,0,0,0
88,8481716,Dmitri Voronkov,L,CBJ,24,0,0,0,0
88,8474709,Matt Martin,L,,35,0,0,0,0
88,8482634,Alex Steeves,C,TOR,25,0,0,0,0
88,8480823,Alexander Alexeyev,D,WSH,25,0,0,0,0
88,8477541,Dakota Mermis,D,TOR,30,0,0,0,0
88,8483491,Ivan Miroshnichenko,L,WSH,20,0,0,0,0
88,8478477,Mitchell Stephens,C,SEA,27,0,0,0,0
88,8481543,Nikita Alexandrov,C,STL,24,0,0,0,0
88,8479423,Alex Nylander,L,,26,0,0,0,0
88,8482451,Mikael Pyyhtia,L,CBJ,23,0,0,0,0
88,8478831,Kevin Stenlund,C,UTA,28,0,0,0,0
88,8480306,Grant Hutton,D,NYI,29,0,0,0,0
88,8478028,Fredrik Olofsson,L,,28,0,0,0,0
88,8477462,Robert Hagg,D,VGK,29,0,0,0,0
88,8477320,Anton Blidh,L,NYR,29,0,0,0,0
88,8482157,Will Cuylle,L,NYR,22,0,0,0,0
88,8482737,Zack Bolduc,C,STL,21,0,0,0,0
88,8481239,Samuel Fagemo,L,,24,0,0,0,0
88,8481600,Tobias Bjornfot,D,FLA,23,0,0,0,0
88,8478409,Anthony Richard,C,PHI,28,0,0,0,0
88,8474145,Robert Bortuzzo,D,,35,0,0,0,0
88,8475958,Michael Sgarbossa,C,WSH,32,0,0,0,0
88,8479986,Kole Lind,R,DAL,26,0,0,0,0
88,8479249,Andrew Poturalski,C,SJS,30,0,0,0,0
88,8479362,Riley Tufte,L,BOS,26,0,0,0,0
88,8479991,Jake Leschyshyn,C,NYR,25,0,0,0,0
88,8479587,Rhett Gardner,C,PHI,28,0,0,0,0
88,8482744,James Malatesta,L,CBJ,21,0,0,0,0
88,8478854,Ryan Shea,D,PIT,27,0,0,0,0
88,8481591,Sam Poulin,R,,23,0,0,0,0
88,8483512,Matt Savoie,C,EDM,20,0,0,0,0
88,8482102,Vasily Ponomarev,C,PIT,22,0,0,0,0
88,8482162,Roby Jarventie,L,EDM,22,0,0,0,0
88,8481016,Ruslan Iskhakov,C,,24,0,0,0,0
88,8482172,Landon Slaggert,L,CHI,22,0,0,0,0
88,8482747,Brennan Othmann,L,NYR,21,0,0,0,0
88,8480031,Maxime Comtois,L,,25,0,0,0,0
88,8480226,Marián Studenic,R,,26,0,0,0,0
88,8478408,Travis Dermott,D,,28,0,0,0,0
88,8481518,Nolan Foote,L,NJD,24,0,0,0,0
88,8479419,Brett Murray,L,BUF,26,0,0,0,0
88,8482088,Justin Sourdif,R,FLA,22,0,0,0,0
88,8482201,Gage Goncalves,C,TBL,23,0,0,0,0
88,8481578,Graeme Clarke,R,MIN,23,0,0,0,0
88,8482177,Marat Khusnutdinov,C,MIN,22,0,0,0,0
88,8481754,Nikita Nesterenko,C,ANA,23,0,0,0,0
88,8483531,Brian Halonen,L,NJD,25,0,0,0,0
88,8483920,Pierrick Dube,R,WSH,23,0,0,0,0
88,8480851,Akil Thomas,C,LAK,24,0,0,0,0
88,8475235,Nicolas Deslauriers,L,PHI,33,0,0,0,0
88,8482476,Emil Heineman,L,MTL,23,0,0,0,0
88,8477149,Scott Sabourin,R,SJS,32,0,0,0,0
88,8483549,Lucas Condotta,L,MTL,27,0,0,0,0
88,8482765,Isak Rosen,R,BUF,21,0,0,0,0
88,8481237,Kyle MacLean,C,NYI,25,0,0,0,0
88,8481024,Linus Karlsson,C,VAN,25,0,0,0,0
88,8481690,Tyler Angle,C,,24,0,0,0,0
88,8483570,Ben Meyers,C,SEA,26,0,0,0,0
88,8481655,Cole Schwindt,R,CGY,23,0,0,0,0
88,8481462,Mason Morelli,L,VGK,28,0,0,0,0
88,8483401,Marc Johnstone,R,PIT,28,0,0,0,0
88,8478956,Samuel Laberge,L,NJD,27,0,0,0,0
88,8479533,Joona Koppanen,L,,26,0,0,0,0
88,8482197,Adam Raska,R,MIN,23,0,0,0,0
88,8482250,Callahan Burke,C,VGK,27,0,0,0,0
88,8482784,Zach Dean,C,STL,21,0,0,0,0
88,8484255,Jason Polin,R,COL,25,0,0,0,0
88,8481077,John Leonard,L,,26,0,0,0,0
88,8481534,Raphael Lavoie,C,EDM,24,0,0,0,0
88,8483609,Adam Klapka,R,CGY,24,0,0,0,0
88,8482751,Ryan Winterton,C,SEA,21,0,0,0,0
88,8480267,Sammy Walker,C,MIN,25,0,0,0,0
88,8475766,Austin Watson,L,,32,0,0,0,0
88,8482460,Matt Rempe,C,NYR,22,0,0,0,0
88,8481065,Angus Crookshank,L,OTT,25,0,0,0,0
88,8481070,Hugh McGing,L,,26,0,0,0,0
88,8476323,Max McCormick,L,SEA,32,0,0,0,0
88,8483395,Arshdeep Bains,L,VAN,23,0,0,0,0
88,8484259,Ondrej Pavel,C,COL,31,0,0,0,0
88,8483432,Luca Del Bel Belluz,C,CBJ,31,0,0,0,0
88,8483045,Cameron Butler,R,CBJ,31,0,0,0,0
88,8482061,Brandon Biro,L,SEA,26,0,0,0,0
88,8477401,John Hayden,C,SEA,29,0,0,0,0
88,8475278,Byron Froese,C,,33,0,0,0,0
88,8478446,Glenn Gawdin,C,LAK,27,0,0,0,0
88,8477993,Justin Kirkland,C,CGY,28,0,0,0,0
88,8482147,Jean-Luc Foudy,C,COL,22,0,0,0,0
88,8480032,Shane Bowers,C,NJD,25,0,0,0,0
88,8479330,Brandon Gignac,C,MTL,27,0,0,0,0
88,8480776,Sheldon Rempal,R,,29,0,0,0,0
88,8475413,Justin Dowling,C,NJD,34,0,0,0,0
88,8481726,Adam Edstrom,C,NYR,24,0,0,0,0
88,8480844,Grigori Denisenko,L,VGK,24,0,0,0,0
88,8478147,Bokondji Imama,L,PIT,28,0,0,0,0
88,8478881,Brett Seney,L,CHI,28,0,0,0,0
88,8483630,Pavol Regenda,L,ANA,25,0,0,0,0
88,8480836,Jonathan Gruden,C,,24,0,0,0,0
88,8484314,Jiri Smejkal,L,,28,0,0,0,0
88,8475780,Chris Wagner,R,COL,33,0,0,0,0
88,8479546,Oskar Steen,C,,26,0,0,0,0
88,8483597,Milos Kelemen,L,UTA,25,0,0,0,0
88,8481789,Tye Kartye,L,SEA,23,0,0,0,0
88,8484325,Waltteri Merela,C,TBL,26,0,0,0,0
88,8479421,Jacob Moverare,D,LAK,26,0,0,0,0
88,8481585,Egor Afanasyev,L,SJS,23,0,0,0,0
88,8479547,Matthew Phillips,R,,26,0,0,0,0
88,8479367,William Lockwood,R,FLA,26,0,0,0,0
88,8476915,Jujhar Khaira,L,,30,0,0,0,0
88,8481422,Jacob Lucchini,C,NSH,29,0,0,0,0
88,8480468,James Hamblin,L,EDM,25,0,0,0,0
88,8478051,Max Willman,C,NJD,29,0,0,0,0
88,8481556,John Beecher,C,BOS,23,0,0,0,0
88,8478078,Rourke Chartier,C,,28,0,0,0,0
89,8477492,Nathan MacKinnon,C,COL,29,82,62,86,148
89,8478402,Connor McDavid,C,EDM,27,82,40,99,139
89,8476453,Nikita Kucherov,R,TBL,31,82,41,89,130
89,8477934,Leon Draisaitl,C,EDM,29,82,48,71,119
89,8477956,David Pastrnak,R,BOS,28,82,54,60,114
89,8479318,Auston Matthews,C,TOR,27,82,56,51,107
89,8480069,Cale Makar,D,COL,26,82,25,81,106
89,8474600,Roman Josi,D,NSH,34,82,27,77,104
89,8478420,Mikko Rantanen,R,COL,28,82,43,60,103
89,8479407,Jesper Bratt,L,NJD,26,82,32,69,101
89,8480027,Jason Robertson,L,DAL,25,82,28,72,100
89,8477404,Jake Guentzel,C,TBL,30,82,43,56,99
89,8480012,Elias Pettersson,C,VAN,26,82,40,59,99
89,8476468,J.T. Miller,C,VAN,31,82,37,61,98
89,8479323,Adam Fox,D,NYR,26,82,23,75,98
89,8477939,William Nylander,R,TOR,28,82,44,53,97
89,8478550,Artemi Panarin,L,NYR,33,82,33,64,97
89,8474564,Steven Stamkos,C,NSH,34,82,40,55,95
89,8480023,Robert Thomas,C,STL,25,82,30,65,95
89,8477946,Dylan Larkin,C,DET,28,82,37,57,94
89,8478010,Brayden Point,C,TBL,28,82,42,51,93
89,8475913,Mark Stone,R,VGK,32,82,33,60,93
89,8479314,Matthew Tkachuk,L,FLA,27,82,30,62,92
89,8473419,Brad Marchand,L,BOS,36,82,26,66,92
89,8478449,Roope Hintz,C,DAL,28,82,48,43,91
89,8475172,Nazem Kadri,C,CGY,34,82,40,51,91
89,8476887,Filip Forsberg,L,NSH,30,82,37,54,91
89,8481559,Jack Hughes,C,NJD,23,82,32,59,91
89,8478427,Sebastian Aho,C,CAR,27,82,31,60,91
89,8482116,Tim Stützle,C,OTT,22,82,34,56,90
89,8480036,Miro Heiskanen,D,DAL,25,82,17,73,90
89,8480800,Quinn Hughes,D,VAN,25,82,13,77,90
89,8478398,Kyle Connor,L,WPG,28,82,40,46,86
89,8481557,Matt Boldy,L,MIN,23,82,33,52,85
89,8477933,Sam Reinhart,C,FLA,29,82,31,54,85
89,8471675,Sidney Crosby,C,PIT,37,82,40,44,84
89,8475786,Zach Hyman,L,EDM,32,82,42,41,83
89,8477409,Carter Verhaeghe,C,FLA,29,82,35,48,83
89,8478864,Kirill Kaprizov,L,MIN,27,82,34,49,83
89,8481523,Kirby Dach,C,MTL,23,82,13,70,83
89,8480801,Brady Tkachuk,L,OTT,25,82,40,42,82
89,8477949,Alex Tuch,R,BUF,28,82,31,51,82
89,8475184,Chris Kreider,L,NYR,33,82,47,33,80
89,8475166,John Tavares,C,TOR,34,82,36,44,80
89,8477493,Aleksander Barkov,C,FLA,29,82,29,51,80
89,8477504,Josh Morrissey,D,WPG,29,82,17,62,79
89,8479343,Clayton Keller,R,UTA,26,82,41,37,78
89,8476389,Vincent Trocheck,C,NYR,31,82,30,48,78
89,8479420,Tage Thompson,C,BUF,27,82,35,42,77
89,8478444,Brock Boeser,R,VAN,27,82,33,44,77
89,8476346,Johnny Gaudreau,L,CBJ,31,82,21,56,77
89,8478038,Devon Toews,D,COL,30,82,19,58,77
89,8474578,Erik Karlsson,D,PIT,34,82,19,58,77
89,8474590,John Carlson,D,WSH,34,82,16,61,77
89,8471214,Alex Ovechkin,L,WSH,39,82,38,38,76
89,8477501,Valeri Nichushkin,R,COL,29,82,37,39,76
89,8479385,Jordan Kyrou,C,STL,26,82,30,46,76
89,8477942,Kevin Fiala,L,LAK,28,82,28,48,76
89,8478445,Mathew Barzal,C,NYI,27,82,23,53,76
89,8475754,Brock Nelson,C,NYI,33,82,37,38,75
89,8476539,Jonathan Marchessault,R,NSH,34,82,35,40,75
89,8477402,Pavel Buchnevich,L,STL,29,82,30,45,75
89,8478439,Travis Konecny,R,PHI,27,82,26,48,74
89,8478047,Michael Bunting,L,PIT,29,82,32,41,73
89,8477960,Adrian Kempe,R,LAK,28,82,31,42,73
89,8478414,Timo Meier,R,NJD,28,82,29,44,73
89,8476456,Jonathan Huberdeau,C,CGY,31,82,26,47,73
89,8480839,Rasmus Dahlin,D,BUF,24,82,18,55,73
89,8480002,Nico Hischier,C,NJD,25,82,35,37,72
89,8479542,Brandon Hagel,L,TBL,26,82,34,38,72
89,8480830,Andrei Svechnikov,R,CAR,24,82,32,40,72
89,8480803,Evan Bouchard,D,EDM,25,82,15,57,72
89,8475158,Ryan O'Reilly,C,NSH,33,82,30,41,71
89,8482078,Lucas Raymond,L,DET,22,82,28,43,71
89,8475167,Victor Hedman,D,TBL,34,82,13,58,71
89,8475765,Vladimir Tarasenko,R,DET,33,82,26,44,70
89,8476454,Ryan Nugent-Hopkins,C,EDM,31,82,23,47,70
89,8478403,Jack Eichel,C,VGK,28,82,33,36,69
89,8481540,Cole Caufield,R,MTL,23,82,28,41,69
89,8471685,Anze Kopitar,C,LAK,37,82,23,45,68
89,8477447,Shea Theodore,D,VGK,29,82,11,57,68
89,8477500,Bo Horvat,C,NYI,29,82,39,28,67
89,8477496,Elias Lindholm,C,BOS,30,82,29,38,67
89,8479339,Patrik Laine,L,CBJ,26,82,26,41,67
89,8476448,William Karlsson,C,VGK,31,82,23,44,67
89,8478460,Zach Werenski,D,CBJ,27,82,15,52,67
89,8477955,Jared McCann,L,SEA,28,82,37,29,66
89,8476880,Tom Wilson,R,WSH,30,82,32,34,66
89,8475170,Brayden Schenn,C,STL,33,82,31,35,66
89,8475745,Charlie Coyle,C,BOS,32,82,25,41,66
89,8476459,Mika Zibanejad,C,NYR,31,82,24,42,66
89,8473512,Claude Giroux,R,OTT,36,82,21,45,66
89,8478519,Anthony Cirelli,C,TBL,27,82,32,33,65
89,8475810,Bryan Rust,R,PIT,32,82,29,36,65
89,8476460,Mark Scheifele,C,WPG,31,82,18,47,65
89,8477964,Ivan Barbashev,C,VGK,29,82,33,31,64
89,8478440,Dylan Strome,C,WSH,27,82,23,41,64
89,8474679,Gustav Nyquist,C,NSH,35,82,18,46,64
89,8477940,Nikolaj Ehlers,L,WPG,28,82,30,33,63
89,8476483,Rickard Rakell,R,PIT,31,82,29,34,63
89,8475784,Jeff Skinner,C,EDM,32,82,26,37,63
89,8481528,Dylan Cozens,C,BUF,23,82,26,37,63
89,8480018,Nick Suzuki,C,MTL,25,82,23,40,63
89,8476479,Phillip Danault,C,LAK,31,82,21,42,63
89,8480208,Drake Batherson,R,OTT,26,82,19,44,63
89,8479325,Charlie McAvoy,D,BOS,27,82,17,46,63
89,8480865,Noah Dobson,D,NYI,24,82,11,52,63
89,8476432,Boone Jenner,C,CBJ,31,82,43,19,62
89,8482740,Wyatt Johnston,C,DAL,21,82,29,33,62
89,8479337,Alex DeBrincat,R,DET,27,82,27,35,62
89,8482097,Jack Quinn,R,BUF,23,82,27,35,62
89,8481618,Alex Newhook,C,MTL,23,82,26,36,62
89,8476875,Mike Matheson,D,MTL,30,82,17,45,62
89,8475692,Mats Zuccarello,R,MIN,37,82,12,50,62
89,8482093,Seth Jarvis,C,CAR,22,82,29,32,61
89,8478975,Mason Marchment,L,DAL,29,82,27,34,61
89,8476882,Teuvo Teravainen,L,CHI,30,82,22,39,61
89,8475798,Mikael Granlund,C,SJS,32,82,19,42,61
89,8476792,Torey Krug,D,STL,33,82,17,44,61
89,8477416,Oliver Bjorkstrand,R,SEA,29,82,28,32,60
89,8478233,Andrew Mangiapane,L,WSH,28,82,25,35,60
89,8477951,Nick Schmaltz,C,UTA,28,82,22,38,60
89,8474150,Mikael Backlund,C,CGY,35,82,13,47,60
89,8477476,Artturi Lehkonen,L,COL,29,82,32,27,59
89,8480014,Gabriel Vilardi,C,WPG,25,82,27,32,59
89,8477935,Sam Bennett,C,FLA,28,82,23,36,59
89,8474565,Alex Pietrangelo,D,VGK,34,82,19,40,59
89,8475794,Tyler Seguin,C,DAL,32,82,34,24,58
89,8478498,Jake DeBrusk,L,VAN,28,82,34,24,58
89,8480015,Owen Tippett,R,PHI,25,82,32,26,58
89,8482159,Tyson Foerster,R,PHI,22,82,29,29,58
89,8479675,Trevor Moore,L,LAK,29,82,25,33,58
89,8478438,Tommy Novak,C,NSH,27,82,23,35,58
89,8475791,Taylor Hall,L,CHI,33,82,21,37,58
89,8479400,Pierre-Luc Dubois,L,WSH,26,82,21,37,58
89,8477986,Brandon Montour,D,SEA,30,82,15,43,58
89,8477494,Jonathan Drouin,L,COL,29,82,11,47,58
89,8478407,Vince Dunn,D,SEA,28,82,7,51,58
89,8482146,Luke Evangelista,R,NSH,22,82,23,34,57
89,8475168,Matt Duchene,C,DAL,33,82,22,35,57
89,8482124,Quinton Byfield,R,LAK,22,82,22,35,57
89,8474586,Jordan Eberle,R,SEA,34,82,20,37,57
89,8481711,Matias Maccelli,L,UTA,24,82,18,39,57
89,8477497,Sean Monahan,C,CBJ,30,82,17,40,57
89,8471724,Kris Letang,D,PIT,37,82,15,42,57
89,8477346,MacKenzie Weegar,D,CGY,30,82,9,48,57
89,8475799,Nino Niederreiter,R,WPG,32,82,30,26,56
89,8476399,Blake Coleman,C,CGY,33,82,29,27,56
89,8481604,Pavel Dorofeyev,L,VGK,24,82,28,28,56
89,8475726,Tyler Toffoli,C,SJS,32,82,25,31,56
89,8477479,Tyler Bertuzzi,L,CHI,29,82,23,33,56
89,8478042,Viktor Arvidsson,R,EDM,31,82,22,34,56
89,8478401,Pavel Zacha,C,BOS,27,82,19,37,56
89,8476853,Morgan Rielly,D,TOR,30,82,8,48,56
89,8475191,Reilly Smith,R,NYR,33,82,28,27,55
89,8473986,Alex Killorn,L,ANA,35,82,25,30,55
89,8477511,Anthony Mantha,R,CGY,30,82,22,33,55
89,8476826,Yanni Gourde,C,SEA,33,82,20,35,55
89,8478493,Joel Eriksson Ek,C,MIN,27,82,25,29,54
89,8480849,Barrett Hayton,C,UTA,24,82,22,32,54
89,8480078,Filip Chytil,C,NYR,25,82,15,39,54
89,8478469,Thomas Chabot,D,OTT,27,82,14,40,54
89,8480028,Morgan Frost,C,PHI,25,82,13,41,54
89,8479345,Jakob Chychrun,D,WSH,26,82,12,42,54
89,8480434,Sean Durzi,D,UTA,26,82,8,46,54
89,8481068,Yegor Sharangovich,C,CGY,26,82,29,24,53
89,8482665,Matty Beniers,C,SEA,22,82,22,31,53
89,8479999,Casey Mittelstadt,C,COL,26,82,17,36,53
89,8477503,Max Domi,C,TOR,29,82,16,37,53
89,8474563,Drew Doughty,D,LAK,35,82,12,41,53
89,8482089,Jake Neighbours,L,STL,22,82,28,24,52
89,8478462,Nicolas Roy,C,VGK,27,82,21,31,52
89,8478397,Rasmus Andersson,D,CGY,28,82,9,43,52
89,8480039,Martin Necas,C,CAR,25,82,27,24,51
89,8476392,Adam Lowry,C,WPG,31,82,26,25,51
89,8477407,Anthony Duclair,L,NYI,29,82,20,31,51
89,8474141,Patrick Kane,R,DET,36,82,15,36,51
89,8481581,Thomas Harley,D,DAL,23,82,15,36,51
89,8479410,Mikhail Sergachev,D,UTA,26,82,8,43,51
89,8475151,Kyle Palmieri,C,NYI,33,82,23,27,50
89,8478458,Jack Roslovic,C,CAR,27,82,19,31,50
89,8476905,Chandler Stephenson,C,SEA,30,82,16,34,50
89,8475768,Jaden Schwartz,C,SEA,32,82,23,26,49
89,8471215,Evgeni Malkin,C,PIT,38,82,22,27,49
89,8482745,Mason McTavish,C,ANA,21,82,21,28,49
89,8480798,Philipp Kurashev,C,CHI,25,82,15,34,49
89,8478891,Mason Appleton,C,WPG,28,82,14,35,49
89,8476869,Brady Skjei,D,NSH,30,82,11,38,49
89,8476854,Hampus Lindholm,D,BOS,30,82,7,42,49
89,8477456,J.T. Compher,L,DET,29,82,24,24,48
89,8471698,T.J. Oshie,R,WSH,38,82,24,24,48
89,8477426,Nicholas Paul,L,TBL,29,82,24,24,48
89,8475760,Nick Bjugstad,C,UTA,32,82,24,24,48
89,8482109,Alexis Lafrenière,L,NYR,23,82,22,26,48
89,8477021,Alex Kerfoot,C,UTA,30,82,17,31,48
89,8482671,Owen Power,D,BUF,22,82,15,33,48
89,8482175,JJ Peterka,R,BUF,22,82,29,18,47
89,8478474,Lawson Crouse,L,UTA,27,82,27,20,47
89,8482110,Dawson Mercer,C,NJD,23,82,23,24,47
89,8476462,Dougie Hamilton,D,NJD,31,82,16,31,47
89,8477932,Aaron Ekblad,D,FLA,28,82,15,32,47
89,8476925,Colton Sissons,C,NSH,31,82,14,33,47
89,8482699,Dylan Guenther,R,UTA,21,82,28,18,46
89,8480220,Noah Cates,L,PHI,25,82,26,20,46
89,8474641,Adam Henrique,C,EDM,34,82,24,22,46
89,8475714,Calle Jarnkrok,C,TOR,33,82,22,24,46
89,8483808,Andrei Kuzmenko,L,CGY,28,82,22,24,46
89,8478046,Danton Heinen,L,VAN,29,82,22,24,46
89,8476881,Tomas Hertl,C,VGK,31,82,20,26,46
89,8474102,David Perron,L,OTT,36,82,18,28,46
89,8473994,Jamie Benn,L,DAL,35,82,13,33,46
89,8476927,Teddy Blueger,C,VAN,30,82,11,35,46
89,8475793,Ryan Johansen,C,PHI,32,82,30,15,45
89,8478873,Troy Terry,R,ANA,27,82,16,29,45
89,8480893,Kirill Marchenko,R,CBJ,24,82,24,20,44
89,8481560,Arthur Kaliyev,R,LAK,23,82,23,21,44
89,8481554,Kaapo Kakko,R,NYR,23,82,23,21,44
89,8478057,Dakota Joshua,C,VAN,28,82,21,23,44
89,8478472,Mathieu Joseph,R,STL,27,82,18,26,44
89,8478396,Noah Hanifin,D,VGK,27,82,17,27,44
89,8476461,Sean Couturier,C,PHI,32,82,14,30,44
89,8478911,Matt Roy,D,WSH,29,82,10,34,44
89,8478133,Jake Evans,C,MTL,28,82,9,35,44
89,8481582,Nicholas Robertson,L,TOR,23,82,23,20,43
89,8479996,Cody Glass,C,NSH,25,82,21,22,43
89,8482113,Anton Lundell,C,FLA,23,82,20,23,43
89,8478055,Gustav Forsling,D,FLA,28,82,15,28,43
89,8482660,Kent Johnson,C,CBJ,22,82,14,29,43
89,8470613,Brent Burns,D,CAR,39,82,11,32,43
89,8477948,Travis Sanheim,D,PHI,28,82,7,36,43
89,8475169,Evander Kane,L,EDM,33,82,31,11,42
89,8480064,Josh Norris,C,OTT,25,82,23,19,42
89,8482667,William Eklund,L,SJS,22,82,20,22,42
89,8484144,Connor Bedard,C,CHI,19,82,17,25,42
89,8482684,Luke Hughes,D,NJD,21,82,8,34,42
89,8476981,Josh Anderson,R,MTL,30,82,26,15,41
89,8477987,Ryan Donato,C,CHI,28,82,19,22,41
89,8482149,Cole Perfetti,C,WPG,22,82,18,23,41
89,8479987,Morgan Geekie,C,BOS,26,82,16,25,41
89,8482117,Lukas Reichel,L,CHI,22,82,16,25,41
89,8481542,Moritz Seider,D,DET,23,82,5,36,41
89,8473422,Nick Foligno,L,CHI,37,82,22,18,40
89,8476873,Mark Jankowski,C,NSH,30,82,20,20,40
89,8478463,Anthony Beauvillier,L,PIT,27,82,18,22,40
89,8477429,Andrew Copp,C,DET,30,82,15,25,40
89,8475287,Erik Haula,L,NJD,33,82,15,25,40
89,8476885,Jacob Trouba,D,NYR,30,82,11,29,40
89,8475753,Justin Faulk,D,STL,32,82,10,30,40
89,8480145,Neal Pionk,D,WPG,29,82,9,31,40
89,8476419,Jean-Gabriel Pageau,C,NYI,32,82,6,34,40
89,8475314,Anders Lee,L,NYI,34,82,23,16,39
89,8481624,Ilya Mikheyev,R,CHI,30,82,22,17,39
89,8482705,Cole Sillinger,C,CBJ,21,82,20,19,39
89,8477444,Andre Burakovsky,L,SEA,29,82,19,20,39
89,8481596,Shane Pinto,C,OTT,24,82,16,23,39
89,8477947,Sonny Milano,L,WSH,28,82,16,23,39
89,8479353,Brett Howden,C,VGK,26,82,15,24,39
89,8477451,Ryan Hartman,R,MIN,30,82,14,25,39
89,8476960,Andreas Athanasiou,C,CHI,30,82,14,25,39
89,8480113,Alex Iafallo,L,WPG,31,82,13,26,39
89,8477498,Darnell Nurse,D,EDM,29,82,12,27,39
89,8477495,Seth Jones,D,CHI,30,82,12,27,39
89,8480873,Rasmus Sandin,D,WSH,24,82,8,31,39
89,8479425,Filip Hronek,D,VAN,27,82,7,32,39
89,8480817,K'Andre Miller,D,NYR,24,82,5,34,39
89,8483515,Juraj Slafkovsky,L,MTL,20,82,22,16,38
89,8482055,Drew O'Connor,L,PIT,26,82,19,19,38
89,8478115,Pierre Engvall,L,NYI,28,82,19,19,38
89,8474715,Cam Atkinson,R,TBL,35,82,18,20,38
89,8476897,Oskar Sundqvist,C,STL,30,82,11,27,38
89,8480043,Timothy Liljegren,D,TOR,25,82,2,36,38
89,8478366,Frank Vatrano,R,ANA,30,82,25,12,37
89,8475722,Jason Zucker,L,BUF,32,82,21,16,37
89,8479525,Ross Colton,C,COL,28,82,20,17,37
89,8481535,Nils Hoglander,L,VAN,24,82,19,18,37
89,8482720,Matthew Knies,L,TOR,22,82,19,18,37
89,8476474,Stefan Noesen,R,NJD,31,82,19,18,37
89,8475848,Brendan Gallagher,R,MTL,32,82,18,19,37
89,8479992,Michael Rasmussen,C,DET,25,82,17,20,37
89,8482475,Yegor Chinakhov,R,CBJ,23,82,17,20,37
89,8480855,Jack McBain,C,UTA,24,82,15,22,37
89,8481704,Juuso Parssinen,C,NSH,23,82,14,23,37
89,8476872,Scott Laughton,C,PHI,30,82,13,24,37
89,8482105,Jake Sanderson,D,OTT,22,82,10,27,37
89,8475763,Kevin Hayes,R,PIT,32,82,9,28,37
89,8474151,Ryan McDonagh,D,TBL,35,82,9,28,37
89,8475764,Cam Fowler,D,ANA,33,82,3,34,37
89,8479941,Justin Danforth,R,CBJ,31,82,22,14,36
89,8480185,Eetu Luostarinen,C,FLA,26,82,21,15,36
89,8475220,Marcus Foligno,L,MIN,33,82,20,16,36
89,8481580,Connor McMichael,C,WSH,23,82,19,17,36
89,8476438,Brandon Saad,L,STL,32,82,18,18,36
89,8482079,Marco Rossi,C,MIN,23,82,17,19,36
89,8481533,Trevor Zegras,C,ANA,23,82,14,22,36
89,8478856,Conor Garland,R,VAN,28,82,13,23,36
89,8478542,Evan Rodrigues,C,FLA,31,82,11,25,36
89,8476906,Shayne Gostisbehere,D,CAR,31,82,10,26,36
89,8480459,Pius Suter,C,VAN,28,82,17,18,35
89,8481186,Logan O'Connor,R,COL,28,82,15,20,35
89,8476480,Vladislav Namestnikov,C,WPG,32,82,11,24,35
89,8476923,Damon Severson,D,CBJ,30,82,5,30,35
89,8475188,Brayden McNabb,D,VGK,33,82,4,31,35
89,8480188,Fabian Zetterlund,L,SJS,25,82,22,12,34
89,8482074,Connor Zary,C,CGY,23,82,21,13,34
89,8470621,Corey Perry,R,EDM,39,82,18,16,34
89,8480829,Jesperi Kotkaniemi,C,CAR,24,82,15,19,34
89,8476458,Ryan Strome,C,ANA,31,82,12,22,34
89,8482624,Daniil Miromanov,D,CGY,27,82,11,23,34
89,8477969,Marcus Pettersson,D,PIT,28,82,6,28,34
89,8476958,Jaccob Slavin,D,CAR,30,82,5,29,34
89,8480748,Kiefer Sherwood,L,VAN,29,82,15,18,33
89,8482125,Alexander Holtz,R,VGK,22,82,15,18,33
89,8480789,Oliver Wahlstrom,R,NYI,24,82,14,19,33
89,8477989,Christian Dvorak,C,MTL,28,82,14,19,33
89,8476292,Ondrej Palat,L,NJD,33,82,10,23,33
89,8476463,Jonas Brodin,D,MIN,31,82,10,23,33
89,8475231,Casey Cizikas,C,NYI,33,82,10,23,33
89,8474716,Jared Spurgeon,D,MIN,35,82,9,24,33
89,8473563,Nicklas Backstrom,C,WSH,37,82,9,24,33
89,8476902,Esa Lindell,D,DAL,30,82,6,27,33
89,8475218,Mattias Ekholm,D,EDM,34,82,5,28,33
89,8473533,Jordan Staal,C,CAR,36,82,16,16,32
89,8481032,Paul Cotter,C,NJD,25,82,16,16,32
89,8480797,Joel Farabee,L,PHI,24,82,14,18,32
89,8477450,Jason Dickinson,C,CHI,29,82,11,21,32
89,8476921,Jordan Martinook,L,CAR,32,82,9,23,32
89,8477506,Ryan Pulock,D,NYI,30,82,5,27,32
89,8476917,Adam Pelech,D,NYI,30,82,5,27,32
89,8481014,Alexander Romanov,D,NYI,24,82,5,27,32
89,8476331,Dylan DeMelo,D,WPG,31,82,4,28,32
89,8475455,Brenden Dillon,D,NJD,34,82,4,28,32
89,8476879,Cody Ceci,D,EDM,31,82,3,29,32
89,8479365,Trent Frederic,C,BOS,26,82,20,11,31
89,8480813,Joe Veleno,C,DET,24,82,18,13,31
89,8483431,Logan Cooley,C,UTA,20,82,17,14,31
89,8474149,Evgenii Dadonov,R,DAL,35,82,17,14,31
89,8477998,Warren Foegele,L,LAK,28,82,16,15,31
89,8479393,Noah Gregor,C,OTT,26,82,16,15,31
89,8480448,Parker Kelly,L,COL,25,82,16,15,31
89,8478508,Yakov Trenin,C,MIN,27,82,15,16,31
89,8478109,Victor Olofsson,L,VGK,29,82,15,16,31
89,8478020,Michael Amadio,C,OTT,28,82,14,17,31
89,8477425,Miles Wood,L,COL,29,82,14,17,31
89,8481481,Blake Lizotte,C,PIT,27,82,11,20,31
89,8477839,Conor Sheary,L,TBL,32,82,11,20,31
89,8474053,Logan Couture,C,SJS,35,82,9,22,31
89,8478413,Jordan Greenway,L,BUF,27,82,9,22,31
89,8482142,Jamie Drysdale,D,PHI,22,82,7,24,31
89,8481546,Cam York,D,PHI,23,82,4,27,31
89,8478882,Vladislav Gavrikov,D,LAK,29,82,3,28,31
89,8478500,Ivan Provorov,D,CBJ,27,82,2,29,31
89,8475343,Nic Dowd,C,WSH,34,82,19,11,30
89,8476278,Colin Blackwell,C,DAL,31,82,16,14,30
89,8475193,Tomas Tatar,L,NJD,34,82,14,16,30
89,8480871,Adam Boqvist,D,FLA,24,82,13,17,30
89,8480003,Jesper Boqvist,C,FLA,26,82,12,18,30
89,8483457,Lane Hutson,D,MTL,20,82,9,21,30
89,8476329,Travis Boyd,C,MIN,31,82,9,21,30
89,8477953,Kasperi Kapanen,R,STL,28,82,9,21,30
89,8482166,Shakir Mukhamadullin,D,SJS,22,82,9,21,30
89,8480336,Sean Walker,D,CAR,30,82,8,22,30
89,8481606,Jordan Spence,D,LAK,23,82,7,23,30
89,8479398,Samuel Girard,D,COL,26,82,3,27,30
89,8478840,Will Borgen,D,SEA,28,82,3,27,30
89,8476469,Joel Armia,R,MTL,31,82,17,12,29
89,8482062,Cole Smith,L,NSH,29,82,17,12,29
89,8478432,Christian Fischer,R,DET,27,82,15,14,29
89,8474189,Lars Eller,C,PIT,35,82,12,17,29
89,8484166,Adam Fantilli,C,CBJ,20,82,12,17,29
89,8479368,Max Jones,L,BOS,26,82,11,18,29
89,8477369,Carson Soucy,D,VAN,30,82,9,20,29
89,8481522,Peyton Krebs,C,BUF,23,82,8,21,29
89,8480049,Dylan Samberg,D,WPG,25,82,6,23,29
89,8480009,Eeli Tolvanen,R,SEA,25,82,18,10,28
89,8481013,Jonatan Berggren,R,DET,24,82,17,11,28
89,8482092,Ridly Greig,C,OTT,22,82,15,13,28
89,8480835,Jack Drury,C,CAR,24,82,13,15,28
89,8475149,Marcus Johansson,L,MIN,34,82,13,15,28
89,8477392,Hudson Fasching,R,NYI,29,82,12,16,28
89,8476878,Zemgus Girgensons,L,TBL,30,82,12,16,28
89,8475200,Dmitry Orlov,D,CAR,33,82,10,18,28
89,8476422,Mike Reilly,D,NYI,31,82,10,18,28
89,8475171,Oliver Ekman-Larsson,D,TOR,33,82,6,22,28
89,8482122,Brock Faber,D,MIN,22,82,6,22,28
89,8479976,Juuso Valimaki,D,UTA,26,82,4,24,28
89,8477435,Ryan Graves,D,PIT,29,82,4,24,28
89,8478416,Erik Cernak,D,TBL,27,82,3,25,28
89,8482259,Bobby McMann,C,TOR,28,82,17,10,27
89,8479293,Brandon Tanev,L,SEA,33,82,17,10,27
89,8481477,Nico Sturm,C,SJS,29,82,15,12,27
89,8481028,Martin Pospisil,C,CGY,25,82,13,14,27
89,8480074,Alexandre Texier,C,STL,25,82,13,14,27
89,8476889,Radek Faksa,C,STL,30,82,12,15,27
89,8477919,Frederick Gaudreau,C,MIN,31,82,12,15,27
89,8481553,Bobby Brink,R,PHI,23,82,10,17,27
89,8483565,Nick Blankenburg,D,NSH,26,82,10,17,27
89,8480068,Ryan Poehling,C,PHI,25,82,9,18,27
89,8478851,Alexandre Carrier,D,NSH,28,82,7,20,27
89,8477488,Brett Pesce,D,NJD,30,82,7,20,27
89,8482133,Thomas Bordeleau,C,SJS,22,82,6,21,27
89,8479402,Jake Bean,D,CGY,26,82,5,22,27
89,8477220,Nate Schmidt,D,FLA,33,82,3,24,27
89,8473507,Jeff Petry,D,DET,37,82,2,25,27
89,8479661,Tanner Jeannot,L,LAK,27,82,17,9,26
89,8478569,Noel Acciari,C,PIT,33,82,15,11,26
89,8477015,Connor Brown,R,EDM,30,82,12,14,26
89,8480802,Ryan McLeod,C,BUF,25,82,12,14,26
89,8481656,Aliaksei Protas,C,WSH,23,82,12,14,26
89,8480980,Connor Dewar,C,TOR,25,82,10,16,26
89,8482111,Justin Barron,D,MTL,23,82,9,17,26
89,8479351,Sam Steel,C,DAL,26,82,8,18,26
89,8479371,Dante Fabbro,D,NSH,26,82,5,21,26
89,8477952,Robby Fabbri,C,ANA,28,82,12,13,25
89,8476918,Jimmy Vesey,L,NYR,31,82,12,13,25
89,8479591,Michael Eyssimont,C,TBL,28,82,11,14,25
89,8476312,Josh Manson,D,COL,33,82,11,14,25
89,8484153,Leo Carlsson,C,ANA,20,82,11,14,25
89,8482807,Ethan Del Mastro,D,CHI,21,82,9,16,25
89,8475855,Jesper Fast,R,CAR,33,82,9,16,25
89,8480144,David Kampf,C,TOR,29,82,8,17,25
89,8480878,Nils Lundkvist,D,DAL,24,82,7,18,25
89,8482073,Braden Schneider,D,NYR,23,82,7,18,25
89,8476891,Matt Grzelcyk,D,PIT,30,82,6,19,25
89,8479998,Mikey Anderson,D,LAK,25,82,6,19,25
89,8480246,Nick Perbix,D,TBL,26,82,5,20,25
89,8477507,Nikita Zadorov,D,BOS,29,82,4,21,25
89,8475181,Nick Leddy,D,STL,33,82,4,21,25
89,8475690,Chris Tanev,D,TOR,35,82,4,21,25
89,8478507,John Marino,D,UTA,27,82,3,22,25
89,8476931,Jake McCabe,D,TOR,31,82,1,24,25
89,8482655,J.J. Moser,D,TBL,24,82,1,24,25
89,8481178,Egor Zamula,D,PHI,24,82,1,24,25
89,8481093,Rafael Harvey-Pinard,L,MTL,25,82,16,8,24
89,8479414,Nathan Bastian,R,NJD,27,82,15,9,24
89,8477903,Garnet Hathaway,R,PHI,33,82,13,11,24
89,8481517,Brett Leason,R,ANA,25,82,12,12,24
89,8477406,Mattias Janmark,C,EDM,32,82,10,14,24
89,8484203,Bradly Nadeau,L,CAR,19,82,7,17,24
89,8477353,Tyler Motte,C,DET,29,82,6,18,24
89,8474574,Tyler Myers,D,VAN,34,82,5,19,24
89,8480860,Kevin Bahl,D,CGY,24,82,5,19,24
89,8476457,Adam Larsson,D,SEA,32,82,4,20,24
89,8476467,Jamie Oleksiak,D,SEA,32,82,4,20,24
89,8476979,Erik Gustafsson,D,DET,32,82,3,21,24
89,8475233,David Savard,D,MTL,34,82,3,21,24
89,8482087,Kaiden Guhle,D,MTL,22,82,1,23,24
89,8479390,Taylor Raddysh,R,WSH,26,82,12,11,23
89,8480995,Pontus Holmberg,R,TOR,25,82,10,13,23
89,8482702,Logan Stankoven,C,DAL,21,82,8,15,23
89,8483763,Maksymilian Szuber,D,UTA,22,82,7,16,23
89,8478013,Jake Walman,D,SJS,28,82,5,18,23
89,8475279,Ben Chiarot,D,DET,33,82,4,19,23
89,8476525,Colin Miller,D,WPG,32,82,3,20,23
89,8480073,Erik Brannstrom,D,COL,25,82,3,20,23
89,8475462,Radko Gudas,D,ANA,34,82,1,22,23
89,8482155,Alex Laferriere,R,LAK,23,82,12,10,22
89,8480025,MacKenzie Entwistle,R,FLA,25,82,12,10,22
89,8482141,Lukas Cormier,D,VGK,22,82,11,11,22
89,8480806,Isac Lundestrom,C,ANA,25,82,10,12,22
89,8482762,Simon Edvinsson,D,DET,21,82,9,13,22
89,8480796,Martin Fehervary,D,WSH,25,82,8,14,22
89,8477931,Tomas Nosek,L,FLA,32,82,8,14,22
89,8476858,Phillip Di Giuseppe,L,VAN,31,82,8,14,22
89,8479359,Beck Malenstyn,L,BUF,26,82,7,15,22
89,8484149,Gavin Brindley,C,CBJ,20,82,7,15,22
89,8476624,Barclay Goodrow,C,SJS,31,82,5,17,22
89,8479983,Mario Ferraro,D,SJS,26,82,5,17,22
89,8474013,Ian Cole,D,UTA,35,82,5,17,22
89,8482470,Ilya Solovyov,D,CGY,24,82,3,19,22
89,8476892,Colton Parayko,D,STL,31,82,2,20,22
89,8481601,Simon Holmstrom,R,NYI,23,82,12,9,21
89,8483471,Brad Lambert,C,WPG,31,82,12,9,21
89,8479316,Luke Kunin,C,SJS,27,82,11,10,21
89,8476442,Matt Nieto,L,PIT,32,82,10,11,21
89,8476374,Sean Kuraly,C,CBJ,31,82,10,11,21
89,8482659,Josh Doan,R,UTA,22,82,8,13,21
89,8479369,Andrew Peeke,D,BOS,26,82,5,16,21
89,8478136,Jake Middleton,D,MIN,28,82,4,17,21
89,8482245,Artem Zub,D,OTT,29,82,3,18,21
89,8482077,Dylan Holloway,L,EDM,23,82,11,9,20
89,8483493,Frank Nazar,C,CHI,20,82,9,11,20
89,8481708,Zac Jones,D,NYR,24,82,6,14,20
89,8480807,Mattias Samuelsson,D,BUF,24,82,4,16,20
89,8480035,Henri Jokiharju,D,BUF,25,82,0,20,20
89,8480281,Alexey Toropchenko,R,STL,25,82,14,5,19
89,8480021,Jack Studnicka,C,LAK,25,82,9,10,19
89,8483445,Cutter Gauthier,L,ANA,20,82,9,10,19
89,8482679,Matt Coronato,R,CGY,22,82,8,11,19
89,8483482,Tristan Luneau,D,ANA,20,82,8,11,19
89,8481524,Bowen Byram,D,BUF,23,82,7,12,19
89,8482858,Ryker Evans,D,SEA,23,82,7,12,19
89,8482666,Scott Morrow,D,CAR,22,82,3,16,19
89,8477335,Kyle Burroughs,D,LAK,29,82,3,16,19
89,8474673,TJ Brodie,D,CHI,34,82,2,17,19
89,8481568,Alex Vlasic,D,CHI,23,82,2,17,19
89,8477845,Trevor van Riemsdyk,D,WSH,33,82,1,18,19
89,8470600,Ryan Suter,D,STL,39,82,0,19,19
89,8479291,Kevin Rooney,C,CGY,31,82,11,7,18
89,8473453,Trevor Lewis,C,LAK,37,82,10,8,18
89,8483495,Simon Nemec,D,NJD,20,82,6,12,18
89,8478443,Brandon Carlo,D,BOS,28,82,6,12,18
89,8477499,Rasmus Ristolainen,D,PHI,30,82,4,14,18
89,8475324,Nick Jensen,D,OTT,34,82,3,15,18
89,8475790,Erik Gudbranson,D,CBJ,32,82,3,15,18
89,8476429,Scott Mayfield,D,NYI,32,82,1,17,18
89,8477365,Connor Clifton,D,BUF,29,82,0,18,18
89,8482733,Logan Mailloux,D,MTL,31,82,7,10,17
89,8480222,Sebastian Aho,D,PIT,28,82,4,13,17
89,8478434,Keegan Kolesar,R,VGK,27,82,4,13,17
89,8481567,Henry Thrun,D,SJS,23,82,3,14,17
89,8481605,Jackson LaCombe,D,ANA,23,82,3,14,17
89,8476967,Brett Kulak,D,EDM,30,82,2,15,17
89,8478211,Dryden Hunt,L,CGY,29,82,10,6,16
89,8484911,Collin Graf,R,SJS,22,82,9,7,16
89,8482809,Jackson Blake,R,CAR,21,82,8,8,16
89,8481699,Aku Raty,R,UTA,23,82,7,9,16
89,8480950,Ilya Lyubushkin,D,DAL,30,82,6,10,16
89,8478178,Darren Raddysh,D,TBL,28,82,4,12,16
89,8475718,Justin Holl,D,DET,32,82,4,12,16
89,8483490,Pavel Mintyukov,D,ANA,21,82,2,14,16
89,8478399,Jonas Siegenthaler,D,NJD,27,82,1,15,16
89,8480834,Ty Emberson,D,SJS,24,82,0,16,16
89,8484145,Zach Benson,L,BUF,19,82,8,7,15
89,8483397,Marc McLaughlin,C,BOS,25,82,8,7,15
89,8477938,Haydn Fleury,D,WPG,28,82,6,9,15
89,8476372,Nick Seeler,D,PHI,31,82,4,11,15
89,8478450,Parker Wotherspoon,D,BOS,27,82,4,11,15
89,8482153,Brendan Brisson,C,VGK,23,82,2,13,15
89,8479324,Ryan Lindgren,D,NYR,26,82,1,14,15
89,8479980,Nicolas Hague,D,VGK,26,82,0,15,15
89,8475842,Sam Carrick,C,NYR,32,82,12,2,14
89,8481641,Joel Kiviranta,L,COL,28,82,10,4,14
89,8483505,Matthew Poitras,C,BOS,20,82,9,5,14
89,8479638,Justin Brazeau,R,BOS,26,82,9,5,14
89,8477508,Curtis Lazar,C,NJD,29,82,6,8,14
89,8482803,Olen Zellweger,D,ANA,21,82,6,8,14
89,8475177,Calvin de Haan,D,COL,33,82,4,10,14
89,8480990,Declan Chisholm,D,MIN,24,82,4,10,14
89,8478859,Niko Mikkola,D,FLA,28,82,2,12,14
89,8476441,Joel Edmundson,D,LAK,31,82,2,12,14
89,8481122,Simon Benoit,D,TOR,26,82,2,12,14
89,8471677,Jack Johnson,D,CBJ,37,82,2,12,14
89,8477505,Alexander Wennberg,C,SJS,30,82,10,3,13
89,8476822,Luke Glendening,C,TBL,35,82,8,5,13
89,8480870,Bo Groulx,C,NYR,24,82,7,6,13
89,8482749,Joshua Roy,R,MTL,21,82,6,7,13
89,8482145,Mavrik Bourque,C,DAL,22,82,5,8,13
89,8475762,Derek Forbort,D,VAN,32,82,5,8,13
89,8482118,Sam Colangelo,R,ANA,23,82,4,9,13
89,8479442,Troy Stecher,D,EDM,30,82,4,9,13
89,8482101,Danil Gushchin,L,SJS,22,82,4,9,13
89,8483012,Logan Morrison,C,SEA,22,82,4,9,13
89,8479576,Vincent Desharnais,D,VAN,28,82,3,10,13
89,8480172,Jan Rutta,D,SJS,34,82,2,11,13
89,8483466,Kevin Korchinski,D,CHI,20,82,2,11,13
89,8478468,Jeremy Lauzon,D,NSH,27,82,0,13,13
89,8482787,Nikita Chibrikov,R,WPG,31,82,8,4,12
89,8482070,Mitchell Chaffee,R,TBL,26,82,6,6,12
89,8482859,Zack Ostapchuk,C,OTT,21,82,5,7,12
89,8482712,Oskar Olausson,R,COL,22,82,4,8,12
89,8483468,Jiri Kulich,C,BUF,20,82,4,7,11
89,8477034,Jaycob Megna,D,FLA,32,82,3,8,11
89,8474090,Brendan Smith,D,DAL,35,82,0,11,11
89,8474612,Travis Hamonic,D,OTT,34,82,0,11,11
89,8483499,Liam Ohgren,L,MIN,20,82,5,5,10
89,8474567,Zach Bogosian,D,MIN,34,82,3,7,10
89,8482516,Matthew Kessel,D,STL,24,82,3,7,10
89,8476473,Connor Murphy,D,CHI,31,82,2,8,10
89,8483567,Georgii Merkulov,C,BOS,24,82,5,4,9
89,8483489,Fraser Minten,C,TOR,31,82,4,5,9
89,8483524,Shane Wright,C,SEA,20,82,3,6,9
89,8478874,Adam Gaudette,C,OTT,28,82,2,7,9
89,8480879,Jacob Bernard-Docker,D,OTT,24,82,2,6,8
89,8474062,Riley Nash,C,NYR,35,82,2,5,7
89,8483460,David Jiricek,D,CBJ,21,82,1,6,7
89,8482713,Mackie Samoskevich,R,FLA,22,82,1,3,4
89,8470794,Joe Pavelski,C,,40,0,0,0,0
89,8481703,Valtteri Puustinen,R,PIT,25,0,0,0,0
89,8477950,Tony DeAngelo,D,,29,0,0,0,0
89,8481577,Philip Tomasino,C,NSH,23,0,0,0,0
89,8475197,Tyson Barrie,D,,33,0,0,0,0
89,8471218,Blake Wheeler,R,,38,0,0,0,0
89,8474157,Max Pacioretty,L,,36,0,0,0,0
89,8478466,Daniel Sprong,R,VAN,27,0,0,0,0
89,8475744,Evgeny Kuznetsov,C,,32,0,0,0,0
89,8481019,David Gustafsson,C,WPG,24,0,0,0,0
89,8475906,John Klingberg,D,,32,0,0,0,0
89,8479348,Kale Clague,D,BUF,26,0,0,0,0
89,8476952,Dominic Toninato,C,WPG,30,0,0,0,0
89,8473473,Milan Lucic,L,,36,0,0,0,0
89,8474037,James van Riemsdyk,L,,35,0,0,0,0
89,8474602,Justin Schultz,D,,34,0,0,0,0
89,8482222,Alexander Barabanov,L,,30,0,0,0,0
89,8479372,Josh Mahura,D,SEA,26,0,0,0,0
89,8479982,Conor Timmins,D,TOR,26,0,0,0,0
89,8474031,Kevin Shattenkirk,D,,35,0,0,0,0
89,8480008,Adam Ruzicka,C,,25,0,0,0,0
89,8481059,Scott Perunovich,D,STL,26,0,0,0,0
89,8480884,Calen Addison,D,,24,0,0,0,0
89,8476994,Vinnie Hinostroza,C,NSH,30,0,0,0,0
89,8478452,Caleb Jones,D,LAK,27,0,0,0,0
89,8480157,Calle Rosen,D,COL,30,0,0,0,0
89,8481609,Vladislav Kolyachonok,D,UTA,23,0,0,0,0
89,8479415,Michael McLeod,C,,26,0,0,0,0
89,8476919,Chris Tierney,C,,30,0,0,0,0
89,8479639,Dylan Coghlan,D,WPG,26,0,0,0,0
89,8478146,Matthew Highmore,C,OTT,28,0,0,0,0
89,8478970,Jalen Chatfield,D,CAR,28,0,0,0,0
89,8480205,Emil Bemstrom,C,PIT,25,0,0,0,0
89,8474884,Mike Hoffman,C,,35,0,0,0,0
89,8471274,Alex Goligoski,D,,39,0,0,0,0
89,8478104,Sammy Blais,L,,28,0,0,0,0
89,8474870,Tyler Johnson,C,,34,0,0,0,0
89,8476913,Devin Shore,C,MIN,30,0,0,0,0
89,8481598,Philip Broberg,D,EDM,23,0,0,0,0
89,8480058,Pierre-Olivier Joseph,D,STL,25,0,0,0,0
89,8480891,Michael Kesselring,D,UTA,24,0,0,0,0
89,8477979,Nicolas Aube-Kubel,R,BUF,28,0,0,0,0
89,8476871,Tanner Pearson,L,,32,0,0,0,0
89,8476393,Nick Cousins,C,,31,0,0,0,0
89,8479977,Kailer Yamamoto,R,,26,0,0,0,0
89,8479543,Michael Pezzetta,L,MTL,26,0,0,0,0
89,8477018,Ben Hutton,D,VGK,31,0,0,0,0
89,8480762,Eric Robinson,L,CAR,29,0,0,0,0
89,8474034,Pat Maroon,L,CHI,36,0,0,0,0
89,8481058,Jesse Ylönen,R,,25,0,0,0,0
89,8475179,Dmitry Kulikov,D,FLA,34,0,0,0,0
89,8481527,Kaedan Korczak,D,VGK,23,0,0,0,0
89,8473449,Kyle Okposo,R,,36,0,0,0,0
89,8482192,Isaak Phillips,D,CHI,23,0,0,0,0
89,8480727,Zach Whitecloud,D,VGK,28,0,0,0,0
89,8479346,Dillon Dube,C,,26,0,0,0,0
89,8480821,Filip Zadina,R,,25,0,0,0,0
89,8480001,Urho Vaakanainen,D,ANA,25,0,0,0,0
89,8470966,Mark Giordano,D,,41,0,0,0,0
89,8480853,Liam Foudy,C,,24,0,0,0,0
89,8475225,Craig Smith,C,CHI,35,0,0,0,0
89,8479972,Mason Shaw,C,WPG,26,0,0,0,0
89,8478451,Ethan Bear,D,WSH,27,0,0,0,0
89,8474040,Sam Gagner,C,,35,0,0,0,0
89,8480196,Jacob Bryson,D,BUF,27,0,0,0,0
89,8479984,Cal Foote,D,,26,0,0,0,0
89,8480011,Klim Kostin,C,SJS,25,0,0,0,0
89,8482176,Wyatt Kaiser,D,CHI,22,0,0,0,0
89,8476988,Matt Benning,D,SJS,30,0,0,0,0
89,8479370,Tyson Jost,C,CAR,26,0,0,0,0
89,8477464,Nic Petan,C,,29,0,0,0,0
89,8477380,Jonny Brodzinski,C,NYR,31,0,0,0,0
89,8480070,Ian Mitchell,D,BOS,25,0,0,0,0
89,8479315,Joey Anderson,R,CHI,26,0,0,0,0
89,8478099,Kevin Labanc,R,,29,0,0,0,0
89,8476874,Olli Maatta,D,DET,30,0,0,0,0
89,8475208,Brian Dumoulin,D,ANA,33,0,0,0,0
89,8478430,Oliver Kylington,D,,27,0,0,0,0
89,8479536,Axel Jonsson-Fjallby,L,WPG,26,0,0,0,0
89,8479671,Mathieu Olivier,R,CBJ,27,0,0,0,0
89,8471709,Marc-Edouard Vlasic,D,SJS,37,0,0,0,0
89,8479328,Julien Gauthier,R,NYI,27,0,0,0,0
89,8478421,A.J. Greer,L,FLA,28,0,0,0,0
89,8477573,Nathan Walker,L,STL,30,0,0,0,0
89,8481537,Nikita Okhotiuk,D,CGY,24,0,0,0,0
89,8474166,Alec Martinez,D,CHI,37,0,0,0,0
89,8470610,Zach Parise,L,,40,0,0,0,0
89,8477478,William Carrier,L,CAR,30,0,0,0,0
89,8479344,Jesse Puljujarvi,R,PIT,26,0,0,0,0
89,8480887,Jordan Harris,D,MTL,24,0,0,0,0
89,8478502,Dennis Gilbert,D,BUF,28,0,0,0,0
89,8482730,Brandt Clarke,D,LAK,21,0,0,0,0
89,8480355,Mark Kastelic,C,BOS,25,0,0,0,0
89,8475750,Jon Merrill,D,MIN,32,0,0,0,0
89,8475164,Jakob Silfverberg,R,,34,0,0,0,0
89,8477944,Jakub Vrana,L,,28,0,0,0,0
89,8479439,Jacob MacDonald,D,COL,31,0,0,0,0
89,8474568,Luke Schenn,D,NSH,35,0,0,0,0
89,8478454,Noah Juulsen,D,VAN,27,0,0,0,0
89,8475752,Tyler Pitlick,C,,33,0,0,0,0
89,8482148,Hendrix Lapierre,C,WSH,22,0,0,0,0
89,8481167,Brayden Pachal,D,CGY,25,0,0,0,0
89,8478043,Sam Lafferty,C,BUF,29,0,0,0,0
89,8479321,Lucas Johansen,D,,27,0,0,0,0
89,8471699,Andrew Cogliano,C,,37,0,0,0,0
89,8481521,Ronnie Attard,D,PHI,25,0,0,0,0
89,8481161,Jake Christiansen,D,CBJ,25,0,0,0,0
89,8479458,Nikita Zaitsev,D,,33,0,0,0,0
89,8479619,Michael Carcone,L,UTA,28,0,0,0,0
89,8479026,Philippe Myers,D,TOR,27,0,0,0,0
89,8477330,Dominik Kubalik,L,,29,0,0,0,0
89,8481617,Vasily Podkolzin,R,VAN,23,0,0,0,0
89,8481701,Santeri Hatakka,D,NJD,23,0,0,0,0
89,8479514,Rem Pitlick,C,,27,0,0,0,0
89,8477446,Michael McCarron,R,NSH,29,0,0,0,0
89,8470604,Jeff Carter,C,,39,0,0,0,0
89,8482241,Radim Zohorna,L,,28,0,0,0,0
89,8480289,Morgan Barron,C,WPG,26,0,0,0,0
89,8479379,Givani Smith,R,SJS,26,0,0,0,0
89,8480216,Jacob Peterson,C,,25,0,0,0,0
89,8477851,Jordan Oesterle,D,BOS,32,0,0,0,0
89,8484258,Sam Malinski,D,COL,26,0,0,0,0
89,8478904,Steven Lorentz,C,,28,0,0,0,0
89,8482095,Tyler Kleven,D,OTT,22,0,0,0,0
89,8480848,Ty Dellandrea,C,SJS,24,0,0,0,0
89,8476884,Derrick Pouliot,D,,30,0,0,0,0
89,8479336,Carl Grundstrom,R,SJS,27,0,0,0,0
89,8482964,Arber Xhekaj,D,MTL,23,0,0,0,0
89,8471686,Marc Staal,D,,37,0,0,0,0
89,8477887,Patrick Brown,C,BOS,32,0,0,0,0
89,8478495,Denis Gurianov,R,,27,0,0,0,0
89,8473504,Cal Clutterbuck,R,,37,0,0,0,0
89,8481550,Adam Beckman,L,NJD,23,0,0,0,0
89,8480845,Rasmus Kupari,C,WPG,24,0,0,0,0
89,8474009,Nick Bonino,C,,36,0,0,0,0
89,8478585,Derek Ryan,C,EDM,38,0,0,0,0
89,8477962,Brendan Lemieux,L,CAR,28,0,0,0,0
89,8482861,Vincent Iorio,D,WSH,22,0,0,0,0
89,8479378,Logan Stanley,D,WPG,26,0,0,0,0
89,8473446,Erik Johnson,D,PHI,36,0,0,0,0
89,8481743,Marc Del Gaizo,D,NSH,25,0,0,0,0
89,8477384,Josh Brown,D,EDM,30,0,0,0,0
89,8482165,Yan Kuznetsov,D,CGY,22,0,0,0,0
89,8478424,Jansen Harkins,C,ANA,27,0,0,0,0
89,8482144,Jack Thompson,D,SJS,22,0,0,0,0
89,8478512,Austin Czarnik,C,,32,0,0,0,0
89,8477527,Ross Johnston,L,ANA,30,0,0,0,0
89,8479383,Boris Katchouk,L,,26,0,0,0,0
89,8482094,Daemon Hunt,D,MIN,22,0,0,0,0
89,8481719,Maxwell Crozier,D,TBL,24,0,0,0,0
89,8480192,Johnathan Kovacevic,D,NJD,27,0,0,0,0
89,8479376,Victor Mete,D,,26,0,0,0,0
89,8482511,Mason Lohrei,D,BOS,23,0,0,0,0
89,8475825,Jani Hakanpää,D,,32,0,0,0,0
89,8478021,William Lagesson,D,DET,28,0,0,0,0
89,8475795,Dylan McIlrath,D,WSH,32,0,0,0,0
89,8477846,Ryan Carpenter,C,,33,0,0,0,0
89,8481056,Spencer Stastney,D,NSH,24,0,0,0,0
89,8481564,Ryan Johnson,D,BUF,23,0,0,0,0
89,8478017,Mark Friedman,D,VAN,29,0,0,0,0
89,8479320,Max Lajoie,D,SEA,27,0,0,0,0
89,8480075,Cameron Crotty,D,MIN,25,0,0,0,0
89,8484287,Cole McWard,D,VAN,23,0,0,0,0
89,8484254,Akito Hirose,D,VAN,25,0,0,0,0
89,8483407,Brandon Scanlin,D,NYR,25,0,0,0,0
89,8480274,Philip Kemp,D,EDM,25,0,0,0,0
89,8479522,Hardy Haman Aktell,D,WSH,26,0,0,0,0
89,8480007,Jonas Rondbjerg,R,VGK,25,0,0,0,0
89,8477454,Adam Erne,L,,29,0,0,0,0
89,8481679,Maxence Guenette,D,OTT,23,0,0,0,0
89,8480441,Trey Fix-Wolansky,R,CBJ,25,0,0,0,0
89,8483546,Marshall Rifai,D,TOR,26,0,0,0,0
89,8480084,Nick DeSimone,D,NJD,30,0,0,0,0
89,8481030,Jack St. Ivany,D,PIT,25,0,0,0,0
89,8481592,Jakob Pelletier,L,CGY,23,0,0,0,0
89,8478011,Louie Belpedio,D,PHI,28,0,0,0,0
89,8477930,Pierre-Edouard Bellemare,L,,39,0,0,0,0
89,8484321,Nikolas Matinpalo,D,OTT,26,0,0,0,0
89,8482067,Connor Mackey,D,NYR,28,0,0,0,0
89,8481806,Louis Crevier,D,CHI,23,0,0,0,0
89,8484326,Patrik Koch,D,UTA,28,0,0,0,0
89,8477971,Andreas Englund,D,LAK,28,0,0,0,0
89,8481751,Lukas Rousek,R,BUF,25,0,0,0,0
89,8481006,Tyler Tucker,D,STL,24,0,0,0,0
89,8476867,Brendan Gaunce,C,MIN,30,0,0,0,0
89,8479520,Brandon Duhaime,R,WSH,27,0,0,0,0
89,8477073,Kurtis MacDermid,L,NJD,30,0,0,0,0
89,8480874,Adam Ginning,D,PHI,24,0,0,0,0
89,8477473,Justin Bailey,R,SJS,29,0,0,0,0
89,8479066,Ryan Lomberg,L,CGY,30,0,0,0,0
89,8477070,Liam O'Brien,C,UTA,30,0,0,0,0
89,8474618,Marco Scandella,D,,34,0,0,0,0
89,8475797,Jarred Tinordi,D,,32,0,0,0,0
89,8481441,Joe Snively,C,DET,28,0,0,0,0
89,8477244,Chad Ruhwedel,D,NYR,34,0,0,0,0
89,8479772,Zack MacEwen,R,OTT,28,0,0,0,0
89,8481147,Reese Johnson,C,MIN,26,0,0,0,0
89,8481043,Cole Koepke,L,BOS,26,0,0,0,0
89,8483619,Filip Roos,D,OTT,25,0,0,0,0
89,8481541,Samuel Bolduc,D,NYI,24,0,0,0,0
89,8477810,Joel Hanley,D,CGY,33,0,0,0,0
89,8476907,Mackenzie MacEachern,L,,30,0,0,0,0
89,8482652,Walker Duehr,R,CGY,27,0,0,0,0
89,8477126,Jayson Megna,C,,34,0,0,0,0
89,8483398,Declan Carlile,D,TBL,31,0,0,0,0
89,8482929,Emil Lilleberg,D,TBL,23,0,0,0,0
89,8480880,Jakub Lauko,C,MIN,24,0,0,0,0
89,8480245,Olle Lycksell,R,PHI,25,0,0,0,0
89,8480252,Cole Guttman,C,CHI,25,0,0,0,0
89,8477467,Gustav Olofsson,D,SEA,30,0,0,0,0
89,8479968,Vinni Lettieri,C,BOS,29,0,0,0,0
89,8478400,Colin White,C,,27,0,0,0,0
89,8475755,Alexander Petrovic,D,DAL,32,0,0,0,0
89,8481812,Nikolai Knyzhov,D,,27,0,0,0,0
89,8481593,Jayden Struble,D,MTL,23,0,0,0,0
89,8481532,Alex Turcotte,C,LAK,23,0,0,0,0
89,8482126,Emil Andrae,D,PHI,31,0,0,0,0
89,8479944,Zach Aston-Reese,C,VGK,30,0,0,0,0
89,8471817,Ryan Reaves,R,TOR,37,0,0,0,0
89,8481206,John Ludvig,D,PIT,24,0,0,0,0
89,8481599,Victor Soderstrom,D,UTA,23,0,0,0,0
89,8480292,Carson Meyer,R,ANA,27,0,0,0,0
89,8482496,Nils Aman,C,VAN,24,0,0,0,0
89,8479718,Alex Barré-Boulet,C,MTL,27,0,0,0,0
89,8479994,Jaret Anderson-Dolan,C,WPG,25,0,0,0,0
89,8480184,Gustav Lindstrom,D,,26,0,0,0,0
89,8480890,Jan Jenik,R,OTT,24,0,0,0,0
89,8478067,Oskar Lindblom,L,,28,0,0,0,0
89,8476934,Brock McGinn,L,ANA,30,0,0,0,0
89,8479985,Cale Fleury,D,SEA,26,0,0,0,0
89,8484304,Uvis Balinskis,D,FLA,28,0,0,0,0
89,8479981,Jonah Gadjovich,L,FLA,26,0,0,0,0
89,8481716,Dmitri Voronkov,L,CBJ,24,0,0,0,0
89,8474709,Matt Martin,L,,35,0,0,0,0
89,8482634,Alex Steeves,C,TOR,25,0,0,0,0
89,8480823,Alexander Alexeyev,D,WSH,25,0,0,0,0
89,8477541,Dakota Mermis,D,TOR,30,0,0,0,0
89,8483491,Ivan Miroshnichenko,L,WSH,20,0,0,0,0
89,8478477,Mitchell Stephens,C,SEA,27,0,0,0,0
89,8481543,Nikita Alexandrov,C,STL,24,0,0,0,0
89,8479423,Alex Nylander,L,,26,0,0,0,0
89,8482451,Mikael Pyyhtia,L,CBJ,23,0,0,0,0
89,8478831,Kevin Stenlund,C,UTA,28,0,0,0,0
89,8480306,Grant Hutton,D,NYI,29,0,0,0,0
89,8478028,Fredrik Olofsson,L,,28,0,0,0,0
89,8477462,Robert Hagg,D,VGK,29,0,0,0,0
89,8477320,Anton Blidh,L,NYR,29,0,0,0,0
89,8482157,Will Cuylle,L,NYR,22,0,0,0,0
89,8482737,Zack Bolduc,C,STL,21,0,0,0,0
89,8481239,Samuel Fagemo,L,,24,0,0,0,0
89,8481600,Tobias Bjornfot,D,FLA,23,0,0,0,0
89,8478409,Anthony Richard,C,PHI,28,0,0,0,0
89,8474145,Robert Bortuzzo,D,,35,0,0,0,0
89,8475958,Michael Sgarbossa,C,WSH,32,0,0,0,0
89,8479986,Kole Lind,R,DAL,26,0,0,0,0
89,8479249,Andrew Poturalski,C,SJS,30,0,0,0,0
89,8479362,Riley Tufte,L,BOS,26,0,0,0,0
89,8479991,Jake Leschyshyn,C,NYR,25,0,0,0,0
89,8479587,Rhett Gardner,C,PHI,28,0,0,0,0
89,8482744,James Malatesta,L,CBJ,21,0,0,0,0
89,8478854,Ryan Shea,D,PIT,27,0,0,0,0
89,8481591,Sam Poulin,R,,23,0,0,0,0
89,8483512,Matt Savoie,C,EDM,20,0,0,0,0
89,8482102,Vasily Ponomarev,C,PIT,22,0,0,0,0
89,8482162,Roby Jarventie,L,EDM,22,0,0,0,0
89,8481016,Ruslan Iskhakov,C,,24,0,0,0,0
89,8482172,Landon Slaggert,L,CHI,22,0,0,0,0
89,8482747,Brennan Othmann,L,NYR,21,0,0,0,0
89,8480031,Maxime Comtois,L,,25,0,0,0,0
89,8480226,Marián Studenic,R,,26,0,0,0,0
89,8478408,Travis Dermott,D,,28,0,0,0,0
89,8481518,Nolan Foote,L,NJD,24,0,0,0,0
89,8479419,Brett Murray,L,BUF,26,0,0,0,0
89,8482088,Justin Sourdif,R,FLA,22,0,0,0,0
89,8482201,Gage Goncalves,C,TBL,23,0,0,0,0
89,8481578,Graeme Clarke,R,MIN,23,0,0,0,0
89,8482177,Marat Khusnutdinov,C,MIN,22,0,0,0,0
89,8481754,Nikita Nesterenko,C,ANA,23,0,0,0,0
89,8483531,Brian Halonen,L,NJD,25,0,0,0,0
89,8483920,Pierrick Dube,R,WSH,23,0,0,0,0
89,8480851,Akil Thomas,C,LAK,24,0,0,0,0
89,8475235,Nicolas Deslauriers,L,PHI,33,0,0,0,0
89,8482476,Emil Heineman,L,MTL,23,0,0,0,0
89,8477149,Scott Sabourin,R,SJS,32,0,0,0,0
89,8483549,Lucas Condotta,L,MTL,27,0,0,0,0
89,8482765,Isak Rosen,R,BUF,21,0,0,0,0
89,8481237,Kyle MacLean,C,NYI,25,0,0,0,0
89,8481024,Linus Karlsson,C,VAN,25,0,0,0,0
89,8481690,Tyler Angle,C,,24,0,0,0,0
89,8483570,Ben Meyers,C,SEA,26,0,0,0,0
89,8481655,Cole Schwindt,R,CGY,23,0,0,0,0
89,8481462,Mason Morelli,L,VGK,28,0,0,0,0
89,8483401,Marc Johnstone,R,PIT,28,0,0,0,0
89,8478956,Samuel Laberge,L,NJD,27,0,0,0,0
89,8479533,Joona Koppanen,L,,26,0,0,0,0
89,8482197,Adam Raska,R,MIN,23,0,0,0,0
89,8482250,Callahan Burke,C,VGK,27,0,0,0,0
89,8482784,Zach Dean,C,STL,21,0,0,0,0
89,8484255,Jason Polin,R,COL,25,0,0,0,0
89,8481077,John Leonard,L,,26,0,0,0,0
89,8481534,Raphael Lavoie,C,EDM,24,0,0,0,0
89,8483609,Adam Klapka,R,CGY,24,0,0,0,0
89,8482751,Ryan Winterton,C,SEA,21,0,0,0,0
89,8480267,Sammy Walker,C,MIN,25,0,0,0,0
89,8475766,Austin Watson,L,,32,0,0,0,0
89,8482460,Matt Rempe,C,NYR,22,0,0,0,0
89,8481065,Angus Crookshank,L,OTT,25,0,0,0,0
89,8481070,Hugh McGing,L,,26,0,0,0,0
89,8476323,Max McCormick,L,SEA,32,0,0,0,0
89,8483395,Arshdeep Bains,L,VAN,23,0,0,0,0
89,8484259,Ondrej Pavel,C,COL,31,0,0,0,0
89,8483432,Luca Del Bel Belluz,C,CBJ,31,0,0,0,0
89,8483045,Cameron Butler,R,CBJ,31,0,0,0,0
89,8482061,Brandon Biro,L,SEA,26,0,0,0,0
89,8477401,John Hayden,C,SEA,29,0,0,0,0
89,8475278,Byron Froese,C,,33,0,0,0,0
89,8478446,Glenn Gawdin,C,LAK,27,0,0,0,0
89,8477993,Justin Kirkland,C,CGY,28,0,0,0,0
89,8482147,Jean-Luc Foudy,C,COL,22,0,0,0,0
89,8480032,Shane Bowers,C,NJD,25,0,0,0,0
89,8479330,Brandon Gignac,C,MTL,27,0,0,0,0
89,8480776,Sheldon Rempal,R,,29,0,0,0,0
89,8475413,Justin Dowling,C,NJD,34,0,0,0,0
89,8481726,Adam Edstrom,C,NYR,24,0,0,0,0
89,8480844,Grigori Denisenko,L,VGK,24,0,0,0,0
89,8478147,Bokondji Imama,L,PIT,28,0,0,0,0
89,8478881,Brett Seney,L,CHI,28,0,0,0,0
89,8483630,Pavol Regenda,L,ANA,25,0,0,0,0
89,8480836,Jonathan Gruden,C,,24,0,0,0,0
89,8484314,Jiri Smejkal,L,,28,0,0,0,0
89,8475780,Chris Wagner,R,COL,33,0,0,0,0
89,8479546,Oskar Steen,C,,26,0,0,0,0
89,8483597,Milos Kelemen,L,UTA,25,0,0,0,0
89,8481789,Tye Kartye,L,SEA,23,0,0,0,0
89,8484325,Waltteri Merela,C,TBL,26,0,0,0,0
89,8479421,Jacob Moverare,D,LAK,26,0,0,0,0
89,8481585,Egor Afanasyev,L,SJS,23,0,0,0,0
89,8479547,Matthew Phillips,R,,26,0,0,0,0
89,8479367,William Lockwood,R,FLA,26,0,0,0,0
89,8476915,Jujhar Khaira,L,,30,0,0,0,0
89,8481422,Jacob Lucchini,C,NSH,29,0,0,0,0
89,8480468,James Hamblin,L,EDM,25,0,0,0,0
89,8478051,Max Willman,C,NJD,29,0,0,0,0
89,8481556,John Beecher,C,BOS,23,0,0,0,0
89,8478078,Rourke Chartier,C,,28,0,0,0,0
90,8478402,Connor McDavid,C,EDM,27,82,45,105,150
90,8477492,Nathan MacKinnon,C,COL,29,82,61,80,141
90,8477956,David Pastrnak,R,BOS,28,82,62,68,130
90,8481559,Jack Hughes,C,NJD,23,82,50,73,123
90,8478864,Kirill Kaprizov,L,MIN,27,82,48,70,118
90,8476453,Nikita Kucherov,R,TBL,31,82,42,76,118
90,8477493,Aleksander Barkov,C,FLA,29,82,28,85,113
90,8478550,Artemi Panarin,L,NYR,33,82,31,77,108
90,8479318,Auston Matthews,C,TOR,27,82,57,50,107
90,8471675,Sidney Crosby,C,PIT,37,82,38,68,106
90,8476468,J.T. Miller,C,VAN,31,82,34,68,102
90,8473419,Brad Marchand,L,BOS,36,82,35,63,98
90,8477934,Leon Draisaitl,C,EDM,29,82,36,59,95
90,8478420,Mikko Rantanen,R,COL,28,82,46,48,94
90,8479343,Clayton Keller,R,UTA,26,82,45,49,94
90,8482116,Tim Stützle,C,OTT,22,82,32,62,94
90,8480069,Cale Makar,D,COL,26,82,22,72,94
90,8477500,Bo Horvat,C,NYI,29,82,47,46,93
90,8475913,Mark Stone,R,VGK,32,82,35,58,93
90,8476454,Ryan Nugent-Hopkins,C,EDM,31,82,27,65,92
90,8478445,Mathew Barzal,C,NYI,27,82,22,70,92
90,8477933,Sam Reinhart,C,FLA,29,82,49,42,91
90,8480027,Jason Robertson,L,DAL,25,82,35,55,90
90,8479314,Matthew Tkachuk,L,FLA,27,82,33,56,89
90,8480801,Brady Tkachuk,L,OTT,25,82,43,45,88
90,8477939,William Nylander,R,TOR,28,82,39,49,88
90,8475166,John Tavares,C,TOR,34,82,34,54,88
90,8480800,Quinn Hughes,D,VAN,25,82,8,80,88
90,8471215,Evgeni Malkin,C,PIT,38,82,39,48,87
90,8476460,Mark Scheifele,C,WPG,31,82,38,47,85
90,8475172,Nazem Kadri,C,CGY,34,82,31,54,85
90,8480023,Robert Thomas,C,STL,25,82,29,56,85
90,8478439,Travis Konecny,R,PHI,27,82,28,57,85
90,8480839,Rasmus Dahlin,D,BUF,24,82,22,63,85
90,8479420,Tage Thompson,C,BUF,27,82,39,45,84
90,8478440,Dylan Strome,C,WSH,27,82,35,49,84
90,8477404,Jake Guentzel,C,TBL,30,82,29,55,84
90,8480018,Nick Suzuki,C,MTL,25,82,30,53,83
90,8471214,Alex Ovechkin,L,WSH,39,82,42,40,82
90,8480002,Nico Hischier,C,NJD,25,82,35,47,82
90,8481557,Matt Boldy,L,MIN,23,82,33,49,82
90,8477942,Kevin Fiala,L,LAK,28,82,27,54,81
90,8478427,Sebastian Aho,C,CAR,27,82,26,55,81
90,8481523,Kirby Dach,C,MTL,23,82,15,66,81
90,8475692,Mats Zuccarello,R,MIN,37,82,27,53,80
90,8477946,Dylan Larkin,C,DET,28,82,43,36,79
90,8479385,Jordan Kyrou,C,STL,26,82,30,49,79
90,8479323,Adam Fox,D,NYR,26,82,21,58,79
90,8480012,Elias Pettersson,C,VAN,26,82,35,43,78
90,8476389,Vincent Trocheck,C,NYR,31,82,32,46,78
90,8478403,Jack Eichel,C,VGK,28,82,30,48,78
90,8477949,Alex Tuch,R,BUF,28,82,20,58,78
90,8476887,Filip Forsberg,L,NSH,30,82,36,41,77
90,8478493,Joel Eriksson Ek,C,MIN,27,82,28,48,76
90,8478401,Pavel Zacha,C,BOS,27,82,37,38,75
90,8479675,Trevor Moore,L,LAK,29,82,35,40,75
90,8477501,Valeri Nichushkin,R,COL,29,82,28,47,75
90,8476853,Morgan Rielly,D,TOR,30,82,17,58,75
90,8476456,Jonathan Huberdeau,C,CGY,31,82,15,60,75
90,8478398,Kyle Connor,L,WPG,28,82,39,35,74
90,8478010,Brayden Point,C,TBL,28,82,35,39,74
90,8478444,Brock Boeser,R,VAN,27,82,32,42,74
90,8480830,Andrei Svechnikov,R,CAR,24,82,24,50,74
90,8474578,Erik Karlsson,D,PIT,34,82,14,60,74
90,8477402,Pavel Buchnevich,L,STL,29,82,39,34,73
90,8481068,Yegor Sharangovich,C,CGY,26,82,35,38,73
90,8473512,Claude Giroux,R,OTT,36,82,34,39,73
90,8475786,Zach Hyman,L,EDM,32,82,33,40,73
90,8478414,Timo Meier,R,NJD,28,82,31,42,73
90,8474150,Mikael Backlund,C,CGY,35,82,29,44,73
90,8476881,Tomas Hertl,C,VGK,31,82,29,44,73
90,8475810,Bryan Rust,R,PIT,32,82,39,33,72
90,8477409,Carter Verhaeghe,C,FLA,29,82,36,36,72
90,8479542,Brandon Hagel,L,TBL,26,82,30,42,72
90,8475754,Brock Nelson,C,NYI,33,82,29,43,72
90,8479407,Jesper Bratt,L,NJD,26,82,26,46,72
90,8476459,Mika Zibanejad,C,NYR,31,82,30,40,70
90,8475168,Matt Duchene,C,DAL,33,82,30,40,70
90,8480208,Drake Batherson,R,OTT,26,82,27,43,70
90,8479337,Alex DeBrincat,R,DET,27,82,25,45,70
90,8477504,Josh Morrissey,D,WPG,29,82,15,55,70
90,8477447,Shea Theodore,D,VGK,29,82,15,55,70
90,8480865,Noah Dobson,D,NYI,24,82,9,61,70
90,8478449,Roope Hintz,C,DAL,28,82,36,33,69
90,8478047,Michael Bunting,L,PIT,29,82,31,38,69
90,8474102,David Perron,L,OTT,36,82,26,43,69
90,8475765,Vladimir Tarasenko,R,DET,33,82,25,44,69
90,8482093,Seth Jarvis,C,CAR,22,82,30,38,68
90,8474590,John Carlson,D,WSH,34,82,15,53,68
90,8478498,Jake DeBrusk,L,VAN,28,82,38,29,67
90,8477935,Sam Bennett,C,FLA,28,82,33,34,67
90,8478975,Mason Marchment,L,DAL,29,82,30,37,67
90,8475158,Ryan O'Reilly,C,NSH,33,82,28,39,67
90,8474600,Roman Josi,D,NSH,34,82,17,50,67
90,8477960,Adrian Kempe,R,LAK,28,82,30,36,66
90,8474564,Steven Stamkos,C,NSH,34,82,24,42,66
90,8473994,Jamie Benn,L,DAL,35,82,24,42,66
90,8475170,Brayden Schenn,C,STL,33,82,30,35,65
90,8479339,Patrik Laine,L,CBJ,26,82,28,37,65
90,8477451,Ryan Hartman,R,MIN,30,82,34,30,64
90,8478042,Viktor Arvidsson,R,EDM,31,82,30,34,64
90,8482665,Matty Beniers,C,SEA,22,82,25,39,64
90,8474141,Patrick Kane,R,DET,36,82,24,40,64
90,8477940,Nikolaj Ehlers,L,WPG,28,82,19,45,64
90,8476792,Torey Krug,D,STL,33,82,19,45,64
90,8476346,Johnny Gaudreau,L,CBJ,31,82,18,46,64
90,8471685,Anze Kopitar,C,LAK,37,82,22,41,63
90,8476539,Jonathan Marchessault,R,NSH,34,82,29,33,62
90,8475784,Jeff Skinner,C,EDM,32,82,26,36,62
90,8477951,Nick Schmaltz,C,UTA,28,82,24,38,62
90,8476483,Rickard Rakell,R,PIT,31,82,22,40,62
90,8480803,Evan Bouchard,D,EDM,25,82,15,47,62
90,8480036,Miro Heiskanen,D,DAL,25,82,13,49,62
90,8476432,Boone Jenner,C,CBJ,31,82,29,31,60
90,8480015,Owen Tippett,R,PHI,25,82,28,32,60
90,8477496,Elias Lindholm,C,BOS,30,82,21,39,60
90,8476462,Dougie Hamilton,D,NJD,31,82,18,42,60
90,8476875,Mike Matheson,D,MTL,30,82,10,50,60
90,8475314,Anders Lee,L,NYI,34,82,32,27,59
90,8476399,Blake Coleman,C,CGY,33,82,28,31,59
90,8478856,Conor Garland,R,VAN,28,82,27,32,59
90,8475745,Charlie Coyle,C,BOS,32,82,19,40,59
90,8479345,Jakob Chychrun,D,WSH,26,82,18,41,59
90,8479425,Filip Hronek,D,VAN,27,82,14,45,59
90,8476958,Jaccob Slavin,D,CAR,30,82,12,47,59
90,8480064,Josh Norris,C,OTT,25,82,33,25,58
90,8476448,William Karlsson,C,VGK,31,82,29,29,58
90,8477407,Anthony Duclair,L,NYI,29,82,25,33,58
90,8480188,Fabian Zetterlund,L,SJS,25,82,24,34,58
90,8478438,Tommy Novak,C,NSH,27,82,23,35,58
90,8479999,Casey Mittelstadt,C,COL,26,82,21,37,58
90,8479325,Charlie McAvoy,D,BOS,27,82,17,41,58
90,8477346,MacKenzie Weegar,D,CGY,30,82,15,43,58
90,8475184,Chris Kreider,L,NYR,33,82,32,25,57
90,8482078,Lucas Raymond,L,DET,22,82,23,34,57
90,8481596,Shane Pinto,C,OTT,24,82,23,34,57
90,8475167,Victor Hedman,D,TBL,34,82,14,43,57
90,8478460,Zach Werenski,D,CBJ,27,82,14,43,57
90,8479410,Mikhail Sergachev,D,UTA,26,82,7,50,57
90,8473986,Alex Killorn,L,ANA,35,82,19,37,56
90,8482097,Jack Quinn,R,BUF,23,82,18,38,56
90,8478396,Noah Hanifin,D,VGK,27,82,14,42,56
90,8480798,Philipp Kurashev,C,CHI,25,82,13,43,56
90,8477986,Brandon Montour,D,SEA,30,82,18,37,55
90,8478407,Vince Dunn,D,SEA,28,82,15,40,55
90,8475753,Justin Faulk,D,STL,32,82,10,45,55
90,8471724,Kris Letang,D,PIT,37,82,6,49,55
90,8477497,Sean Monahan,C,CBJ,30,82,23,31,54
90,8479400,Pierre-Luc Dubois,L,WSH,26,82,22,32,54
90,8476905,Chandler Stephenson,C,SEA,30,82,22,32,54
90,8476882,Teuvo Teravainen,L,CHI,30,82,17,37,54
90,8478873,Troy Terry,R,ANA,27,82,17,37,54
90,8478055,Gustav Forsling,D,FLA,28,82,13,41,54
90,8480039,Martin Necas,C,CAR,25,82,25,28,53
90,8474586,Jordan Eberle,R,SEA,34,82,24,29,53
90,8478413,Jordan Greenway,L,BUF,27,82,24,29,53
90,8481528,Dylan Cozens,C,BUF,23,82,23,30,53
90,8480797,Joel Farabee,L,PHI,24,82,23,30,53
90,8475794,Tyler Seguin,C,DAL,32,82,19,34,53
90,8480434,Sean Durzi,D,UTA,26,82,14,39,53
90,8478469,Thomas Chabot,D,OTT,27,82,11,42,53
90,8482740,Wyatt Johnston,C,DAL,21,82,28,24,52
90,8481618,Alex Newhook,C,MTL,23,82,25,27,52
90,8482109,Alexis Lafrenière,L,NYR,23,82,21,31,52
90,8477456,J.T. Compher,L,DET,29,82,20,32,52
90,8477998,Warren Foegele,L,LAK,28,82,20,32,52
90,8476479,Phillip Danault,C,LAK,31,82,18,34,52
90,8477494,Jonathan Drouin,L,COL,29,82,13,39,52
90,8482159,Tyson Foerster,R,PHI,22,82,28,23,51
90,8478366,Frank Vatrano,R,ANA,30,82,27,24,51
90,8479365,Trent Frederic,C,BOS,26,82,23,28,51
90,8477416,Oliver Bjorkstrand,R,SEA,29,82,22,29,51
90,8475218,Mattias Ekholm,D,EDM,34,82,19,32,51
90,8475798,Mikael Granlund,C,SJS,32,82,14,37,51
90,8476854,Hampus Lindholm,D,BOS,30,82,14,37,51
90,8478038,Devon Toews,D,COL,30,82,12,39,51
90,8477955,Jared McCann,L,SEA,28,82,27,23,50
90,8483515,Juraj Slafkovsky,L,MTL,20,82,25,25,50
90,8476329,Travis Boyd,C,MIN,31,82,20,30,50
90,8480028,Morgan Frost,C,PHI,25,82,18,32,50
90,8477429,Andrew Copp,C,DET,30,82,17,33,50
90,8477503,Max Domi,C,TOR,29,82,13,37,50
90,8477932,Aaron Ekblad,D,FLA,28,82,10,40,50
90,8481540,Cole Caufield,R,MTL,23,82,31,18,49
90,8474641,Adam Henrique,C,EDM,34,82,27,22,49
90,8479992,Michael Rasmussen,C,DET,25,82,24,25,49
90,8478462,Nicolas Roy,C,VGK,27,82,23,26,49
90,8470613,Brent Burns,D,CAR,39,82,19,30,49
90,8478397,Rasmus Andersson,D,CGY,28,82,12,37,49
90,8475726,Tyler Toffoli,C,SJS,32,82,32,16,48
90,8477444,Andre Burakovsky,L,SEA,29,82,16,32,48
90,8476906,Shayne Gostisbehere,D,CAR,31,82,16,32,48
90,8478472,Mathieu Joseph,R,STL,27,82,15,33,48
90,8474563,Drew Doughty,D,LAK,35,82,7,41,48
90,8475793,Ryan Johansen,C,PHI,32,82,27,20,47
90,8477511,Anthony Mantha,R,CGY,30,82,24,23,47
90,8479393,Noah Gregor,C,OTT,26,82,24,23,47
90,8476438,Brandon Saad,L,STL,32,82,21,26,47
90,8478233,Andrew Mangiapane,L,WSH,28,82,19,28,47
90,8482660,Kent Johnson,C,CBJ,22,82,19,28,47
90,8479987,Morgan Geekie,C,BOS,26,82,18,29,47
90,8481711,Matias Maccelli,L,UTA,24,82,13,34,47
90,8480336,Sean Walker,D,CAR,30,82,12,35,47
90,8482699,Dylan Guenther,R,UTA,21,82,27,19,46
90,8476826,Yanni Gourde,C,SEA,33,82,21,25,46
90,8480829,Jesperi Kotkaniemi,C,CAR,24,82,21,25,46
90,8477021,Alex Kerfoot,C,UTA,30,82,19,27,46
90,8481535,Nils Hoglander,L,VAN,24,82,19,27,46
90,8476872,Scott Laughton,C,PHI,30,82,17,29,46
90,8481533,Trevor Zegras,C,ANA,23,82,17,29,46
90,8482175,JJ Peterka,R,BUF,22,82,24,21,45
90,8475169,Evander Kane,L,EDM,33,82,24,21,45
90,8482110,Dawson Mercer,C,NJD,23,82,22,23,45
90,8475763,Kevin Hayes,R,PIT,32,82,22,23,45
90,8476392,Adam Lowry,C,WPG,31,82,21,24,45
90,8482124,Quinton Byfield,R,LAK,22,82,17,28,45
90,8476869,Brady Skjei,D,NSH,30,82,16,29,45
90,8476458,Ryan Strome,C,ANA,31,82,12,33,45
90,8482671,Owen Power,D,BUF,22,82,10,35,45
90,8476923,Damon Severson,D,CBJ,30,82,9,36,45
90,8482745,Mason McTavish,C,ANA,21,82,25,19,44
90,8480014,Gabriel Vilardi,C,WPG,25,82,23,21,44
90,8477426,Nicholas Paul,L,TBL,29,82,23,21,44
90,8482149,Cole Perfetti,C,WPG,22,82,21,23,44
90,8478458,Jack Roslovic,C,CAR,27,82,12,32,44
90,8482105,Jake Sanderson,D,OTT,22,82,11,33,44
90,8482055,Drew O'Connor,L,PIT,26,82,23,20,43
90,8478519,Anthony Cirelli,C,TBL,27,82,20,23,43
90,8475848,Brendan Gallagher,R,MTL,32,82,20,23,43
90,8483808,Andrei Kuzmenko,L,CGY,28,82,19,24,43
90,8480835,Jack Drury,C,CAR,24,82,18,25,43
90,8476927,Teddy Blueger,C,VAN,30,82,17,26,43
90,8478057,Dakota Joshua,C,VAN,28,82,16,27,43
90,8471698,T.J. Oshie,R,WSH,38,82,12,31,43
90,8473563,Nicklas Backstrom,C,WSH,37,82,11,32,43
90,8476469,Joel Armia,R,MTL,31,82,26,16,42
90,8482089,Jake Neighbours,L,STL,22,82,25,17,42
90,8475151,Kyle Palmieri,C,NYI,33,82,25,17,42
90,8475799,Nino Niederreiter,R,WPG,32,82,21,21,42
90,8476880,Tom Wilson,R,WSH,30,82,20,22,42
90,8481582,Nicholas Robertson,L,TOR,23,82,20,22,42
90,8482705,Cole Sillinger,C,CBJ,21,82,20,22,42
90,8477476,Artturi Lehkonen,L,COL,29,82,18,24,42
90,8476419,Jean-Gabriel Pageau,C,NYI,32,82,16,26,42
90,8484144,Connor Bedard,C,CHI,19,82,10,32,42
90,8476960,Andreas Athanasiou,C,CHI,30,82,21,20,41
90,8480855,Jack McBain,C,UTA,24,82,21,20,41
90,8474189,Lars Eller,C,PIT,35,82,21,20,41
90,8478046,Danton Heinen,L,VAN,29,82,20,21,41
90,8476461,Sean Couturier,C,PHI,32,82,19,22,41
90,8480806,Isac Lundestrom,C,ANA,25,82,19,22,41
90,8475191,Reilly Smith,R,NYR,33,82,15,26,41
90,8475149,Marcus Johansson,L,MIN,34,82,15,26,41
90,8476925,Colton Sissons,C,NSH,31,82,14,27,41
90,8474679,Gustav Nyquist,C,NSH,35,82,11,30,41
90,8474565,Alex Pietrangelo,D,VGK,34,82,11,30,41
90,8477964,Ivan Barbashev,C,VGK,29,82,17,23,40
90,8475760,Nick Bjugstad,C,UTA,32,82,16,24,40
90,8476480,Vladislav Namestnikov,C,WPG,32,82,16,24,40
90,8480849,Barrett Hayton,C,UTA,24,82,15,25,40
90,8479525,Ross Colton,C,COL,28,82,15,25,40
90,8480220,Noah Cates,L,PHI,25,82,13,27,40
90,8480074,Alexandre Texier,C,STL,25,82,13,27,40
90,8480003,Jesper Boqvist,C,FLA,26,82,23,16,39
90,8478115,Pierre Engvall,L,NYI,28,82,21,18,39
90,8481604,Pavel Dorofeyev,L,VGK,24,82,19,20,39
90,8482475,Yegor Chinakhov,R,CBJ,23,82,19,20,39
90,8475791,Taylor Hall,L,CHI,33,82,16,23,39
90,8477479,Tyler Bertuzzi,L,CHI,29,82,15,24,39
90,8477953,Kasperi Kapanen,R,STL,28,82,14,25,39
90,8482113,Anton Lundell,C,FLA,23,82,12,27,39
90,8478891,Mason Appleton,C,WPG,28,82,11,28,39
90,8478542,Evan Rodrigues,C,FLA,31,82,11,28,39
90,8475764,Cam Fowler,D,ANA,33,82,7,32,39
90,8475714,Calle Jarnkrok,C,TOR,33,82,20,18,38
90,8477952,Robby Fabbri,C,ANA,28,82,19,19,38
90,8478474,Lawson Crouse,L,UTA,27,82,18,20,38
90,8475768,Jaden Schwartz,C,SEA,32,82,13,25,38
90,8482667,William Eklund,L,SJS,22,82,12,26,38
90,8477498,Darnell Nurse,D,EDM,29,82,12,26,38
90,8480145,Neal Pionk,D,WPG,29,82,9,29,38
90,8477220,Nate Schmidt,D,FLA,33,82,5,33,38
90,8473533,Jordan Staal,C,CAR,36,82,20,17,37
90,8478020,Michael Amadio,C,OTT,28,82,19,18,37
90,8480068,Ryan Poehling,C,PHI,25,82,19,18,37
90,8480113,Alex Iafallo,L,WPG,31,82,17,20,37
90,8478463,Anthony Beauvillier,L,PIT,27,82,15,22,37
90,8475722,Jason Zucker,L,BUF,32,82,15,22,37
90,8476292,Ondrej Palat,L,NJD,33,82,15,22,37
90,8481013,Jonatan Berggren,R,DET,24,82,15,22,37
90,8480078,Filip Chytil,C,NYR,25,82,14,23,37
90,8477989,Christian Dvorak,C,MTL,28,82,13,24,37
90,8477495,Seth Jones,D,CHI,30,82,12,25,37
90,8482684,Luke Hughes,D,NJD,21,82,9,28,37
90,8476917,Adam Pelech,D,NYI,30,82,8,29,37
90,8473507,Jeff Petry,D,DET,37,82,8,29,37
90,8477435,Ryan Graves,D,PIT,29,82,7,30,37
90,8477947,Sonny Milano,L,WSH,28,82,16,20,36
90,8477919,Frederick Gaudreau,C,MIN,31,82,15,21,36
90,8482079,Marco Rossi,C,MIN,23,82,14,22,36
90,8476474,Stefan Noesen,R,NJD,31,82,13,23,36
90,8476902,Esa Lindell,D,DAL,30,82,11,25,36
90,8481553,Bobby Brink,R,PHI,23,82,10,26,36
90,8480873,Rasmus Sandin,D,WSH,24,82,6,30,36
90,8479402,Jake Bean,D,CGY,26,82,6,30,36
90,8477948,Travis Sanheim,D,PHI,28,82,3,33,36
90,8474151,Ryan McDonagh,D,TBL,35,82,2,34,36
90,8481624,Ilya Mikheyev,R,CHI,30,82,19,16,35
90,8481580,Connor McMichael,C,WSH,23,82,19,16,35
90,8480893,Kirill Marchenko,R,CBJ,24,82,18,17,35
90,8481186,Logan O'Connor,R,COL,28,82,18,17,35
90,8482117,Lukas Reichel,L,CHI,22,82,13,22,35
90,8474716,Jared Spurgeon,D,MIN,35,82,12,23,35
90,8475220,Marcus Foligno,L,MIN,33,82,11,24,35
90,8474053,Logan Couture,C,SJS,35,82,11,24,35
90,8476979,Erik Gustafsson,D,DET,32,82,9,26,35
90,8482245,Artem Zub,D,OTT,29,82,2,33,35
90,8476981,Josh Anderson,R,MTL,30,82,20,14,34
90,8480459,Pius Suter,C,VAN,28,82,20,14,34
90,8483431,Logan Cooley,C,UTA,20,82,19,15,34
90,8480009,Eeli Tolvanen,R,SEA,25,82,19,15,34
90,8481560,Arthur Kaliyev,R,LAK,23,82,18,16,34
90,8473422,Nick Foligno,L,CHI,37,82,18,16,34
90,8476921,Jordan Martinook,L,CAR,32,82,17,17,34
90,8481481,Blake Lizotte,C,PIT,27,82,16,18,34
90,8476918,Jimmy Vesey,L,NYR,31,82,14,20,34
90,8480817,K'Andre Miller,D,NYR,24,82,11,23,34
90,8479351,Sam Steel,C,DAL,26,82,7,27,34
90,8482166,Shakir Mukhamadullin,D,SJS,22,82,6,28,34
90,8478507,John Marino,D,UTA,27,82,4,30,34
90,8475287,Erik Haula,L,NJD,33,82,18,15,33
90,8478109,Victor Olofsson,L,VGK,29,82,15,18,33
90,8479293,Brandon Tanev,L,SEA,33,82,15,18,33
90,8480748,Kiefer Sherwood,L,VAN,29,82,13,20,33
90,8475231,Casey Cizikas,C,NYI,33,82,9,24,33
90,8481546,Cam York,D,PHI,23,82,9,24,33
90,8478882,Vladislav Gavrikov,D,LAK,29,82,8,25,33
90,8482142,Jamie Drysdale,D,PHI,22,82,6,27,33
90,8477987,Ryan Donato,C,CHI,28,82,17,15,32
90,8481554,Kaapo Kakko,R,NYR,23,82,16,16,32
90,8480185,Eetu Luostarinen,C,FLA,26,82,16,16,32
90,8482074,Connor Zary,C,CGY,23,82,16,16,32
90,8474149,Evgenii Dadonov,R,DAL,35,82,13,19,32
90,8476885,Jacob Trouba,D,NYR,30,82,11,21,32
90,8479353,Brett Howden,C,VGK,26,82,11,21,32
90,8477839,Conor Sheary,L,TBL,32,82,10,22,32
90,8481581,Thomas Harley,D,DAL,23,82,7,25,32
90,8481542,Moritz Seider,D,DET,23,82,5,27,32
90,8477392,Hudson Fasching,R,NYI,29,82,17,14,31
90,8477903,Garnet Hathaway,R,PHI,33,82,16,15,31
90,8476873,Mark Jankowski,C,NSH,30,82,14,17,31
90,8475343,Nic Dowd,C,WSH,34,82,14,17,31
90,8479941,Justin Danforth,R,CBJ,31,82,12,19,31
90,8479591,Michael Eyssimont,C,TBL,28,82,12,19,31
90,8482133,Thomas Bordeleau,C,SJS,22,82,11,20,31
90,8479369,Andrew Peeke,D,BOS,26,82,7,24,31
90,8483495,Simon Nemec,D,NJD,20,82,6,25,31
90,8476892,Colton Parayko,D,STL,31,82,5,26,31
90,8482655,J.J. Moser,D,TBL,24,82,4,27,31
90,8482125,Alexander Holtz,R,VGK,22,82,18,12,30
90,8476889,Radek Faksa,C,STL,30,82,17,13,30
90,8478508,Yakov Trenin,C,MIN,27,82,16,14,30
90,8479390,Taylor Raddysh,R,WSH,26,82,14,16,30
90,8480802,Ryan McLeod,C,BUF,25,82,13,17,30
90,8479316,Luke Kunin,C,SJS,27,82,12,18,30
90,8482720,Matthew Knies,L,TOR,22,82,9,21,30
90,8477488,Brett Pesce,D,NJD,30,82,8,22,30
90,8476422,Mike Reilly,D,NYI,31,82,7,23,30
90,8479976,Juuso Valimaki,D,UTA,26,82,6,24,30
90,8478133,Jake Evans,C,MTL,28,82,5,25,30
90,8475188,Brayden McNabb,D,VGK,33,82,5,25,30
90,8478500,Ivan Provorov,D,CBJ,27,82,3,27,30
90,8478443,Brandon Carlo,D,BOS,28,82,3,27,30
90,8478569,Noel Acciari,C,PIT,33,82,17,12,29
90,8480813,Joe Veleno,C,DET,24,82,16,13,29
90,8480871,Adam Boqvist,D,FLA,24,82,11,18,29
90,8476312,Josh Manson,D,COL,33,82,11,18,29
90,8480025,MacKenzie Entwistle,R,FLA,25,82,11,18,29
90,8482111,Justin Barron,D,MTL,23,82,10,19,29
90,8476897,Oskar Sundqvist,C,STL,30,82,9,20,29
90,8474574,Tyler Myers,D,VAN,34,82,7,22,29
90,8480043,Timothy Liljegren,D,TOR,25,82,5,24,29
90,8481606,Jordan Spence,D,LAK,23,82,3,26,29
90,8477507,Nikita Zadorov,D,BOS,29,82,3,26,29
90,8476931,Jake McCabe,D,TOR,31,82,3,26,29
90,8481477,Nico Sturm,C,SJS,29,82,19,9,28
90,8481704,Juuso Parssinen,C,NSH,23,82,15,13,28
90,8477406,Mattias Janmark,C,EDM,32,82,14,14,28
90,8482762,Simon Edvinsson,D,DET,21,82,14,14,28
90,8476624,Barclay Goodrow,C,SJS,31,82,14,14,28
90,8479996,Cody Glass,C,NSH,25,82,13,15,28
90,8482092,Ridly Greig,C,OTT,22,82,11,17,28
90,8475200,Dmitry Orlov,D,CAR,33,82,10,18,28
90,8481028,Martin Pospisil,C,CGY,25,82,9,19,28
90,8477015,Connor Brown,R,EDM,30,82,9,19,28
90,8475171,Oliver Ekman-Larsson,D,TOR,33,82,6,22,28
90,8478840,Will Borgen,D,SEA,28,82,5,23,28
90,8478851,Alexandre Carrier,D,NSH,28,82,2,26,28
90,8475324,Nick Jensen,D,OTT,34,82,1,27,28
90,8479359,Beck Malenstyn,L,BUF,26,82,17,10,27
90,8482679,Matt Coronato,R,CGY,22,82,16,11,27
90,8477450,Jason Dickinson,C,CHI,29,82,15,12,27
90,8483524,Shane Wright,C,SEA,20,82,14,13,27
90,8480789,Oliver Wahlstrom,R,NYI,24,82,12,15,27
90,8476278,Colin Blackwell,C,DAL,31,82,10,17,27
90,8482122,Brock Faber,D,MIN,22,82,7,20,27
90,8481522,Peyton Krebs,C,BUF,23,82,6,21,27
90,8476891,Matt Grzelcyk,D,PIT,30,82,6,21,27
90,8481178,Egor Zamula,D,PHI,24,82,5,22,27
90,8476525,Colin Miller,D,WPG,32,82,5,22,27
90,8476463,Jonas Brodin,D,MIN,31,82,1,26,27
90,8477845,Trevor van Riemsdyk,D,WSH,33,82,0,27,27
90,8482155,Alex Laferriere,R,LAK,23,82,14,12,26
90,8470621,Corey Perry,R,EDM,39,82,12,14,26
90,8475855,Jesper Fast,R,CAR,33,82,11,15,26
90,8480980,Connor Dewar,C,TOR,25,82,10,16,26
90,8481656,Aliaksei Protas,C,WSH,23,82,7,19,26
90,8482470,Ilya Solovyov,D,CGY,24,82,7,19,26
90,8479371,Dante Fabbro,D,NSH,26,82,4,22,26
90,8475181,Nick Leddy,D,STL,33,82,3,23,26
90,8476331,Dylan DeMelo,D,WPG,31,82,2,24,26
90,8482087,Kaiden Guhle,D,MTL,22,82,2,24,26
90,8482146,Luke Evangelista,R,NSH,22,82,14,11,25
90,8479368,Max Jones,L,BOS,26,82,12,13,25
90,8484153,Leo Carlsson,C,ANA,20,82,10,15,25
90,8483445,Cutter Gauthier,L,ANA,20,82,9,16,25
90,8477508,Curtis Lazar,C,NJD,29,82,9,16,25
90,8482624,Daniil Miromanov,D,CGY,27,82,7,18,25
90,8480073,Erik Brannstrom,D,COL,25,82,7,18,25
90,8476442,Matt Nieto,L,PIT,32,82,7,18,25
90,8479983,Mario Ferraro,D,SJS,26,82,6,19,25
90,8477969,Marcus Pettersson,D,PIT,28,82,3,22,25
90,8484166,Adam Fantilli,C,CBJ,20,82,15,9,24
90,8475193,Tomas Tatar,L,NJD,34,82,14,10,24
90,8482807,Ethan Del Mastro,D,CHI,21,82,13,11,24
90,8480448,Parker Kelly,L,COL,25,82,12,12,24
90,8476858,Phillip Di Giuseppe,L,VAN,31,82,11,13,24
90,8482077,Dylan Holloway,L,EDM,23,82,9,15,24
90,8478432,Christian Fischer,R,DET,27,82,6,18,24
90,8483565,Nick Blankenburg,D,NSH,26,82,6,18,24
90,8481014,Alexander Romanov,D,NYI,24,82,5,19,24
90,8479998,Mikey Anderson,D,LAK,25,82,5,19,24
90,8476467,Jamie Oleksiak,D,SEA,32,82,3,21,24
90,8478136,Jake Middleton,D,MIN,28,82,3,21,24
90,8480049,Dylan Samberg,D,WPG,25,82,2,22,24
90,8474715,Cam Atkinson,R,TBL,35,82,14,9,23
90,8482259,Bobby McMann,C,TOR,28,82,14,9,23
90,8481517,Brett Leason,R,ANA,25,82,13,10,23
90,8480995,Pontus Holmberg,R,TOR,25,82,12,11,23
90,8482062,Cole Smith,L,NSH,29,82,11,12,23
90,8478211,Dryden Hunt,L,CGY,29,82,10,13,23
90,8476374,Sean Kuraly,C,CBJ,31,82,9,14,23
90,8478434,Keegan Kolesar,R,VGK,27,82,9,14,23
90,8479442,Troy Stecher,D,EDM,30,82,8,15,23
90,8480990,Declan Chisholm,D,MIN,24,82,7,16,23
90,8478859,Niko Mikkola,D,FLA,28,82,7,16,23
90,8477506,Ryan Pulock,D,NYI,30,82,4,19,23
90,8475455,Brenden Dillon,D,NJD,34,82,4,19,23
90,8475233,David Savard,D,MTL,34,82,3,20,23
90,8474673,TJ Brodie,D,CHI,34,82,3,20,23
90,8484145,Zach Benson,L,BUF,19,82,13,9,22
90,8479661,Tanner Jeannot,L,LAK,27,82,12,10,22
90,8481601,Simon Holmstrom,R,NYI,23,82,11,11,22
90,8482733,Logan Mailloux,D,MTL,31,82,8,14,22
90,8478911,Matt Roy,D,WSH,29,82,6,16,22
90,8483457,Lane Hutson,D,MTL,20,82,6,16,22
90,8476878,Zemgus Girgensons,L,TBL,30,82,11,10,21
90,8481093,Rafael Harvey-Pinard,L,MTL,25,82,10,11,21
90,8483471,Brad Lambert,C,WPG,31,82,10,11,21
90,8473453,Trevor Lewis,C,LAK,37,82,10,11,21
90,8477369,Carson Soucy,D,VAN,30,82,7,14,21
90,8474090,Brendan Smith,D,DAL,35,82,7,14,21
90,8474013,Ian Cole,D,UTA,35,82,6,15,21
90,8477365,Connor Clifton,D,BUF,29,82,4,17,21
90,8483490,Pavel Mintyukov,D,ANA,21,82,4,17,21
90,8484203,Bradly Nadeau,L,CAR,19,82,10,10,20
90,8478013,Jake Walman,D,SJS,28,82,10,10,20
90,8482659,Josh Doan,R,UTA,22,82,9,11,20
90,8477353,Tyler Motte,C,DET,29,82,8,12,20
90,8483493,Frank Nazar,C,CHI,20,82,8,12,20
90,8482666,Scott Morrow,D,CAR,22,82,7,13,20
90,8482101,Danil Gushchin,L,SJS,22,82,7,13,20
90,8480878,Nils Lundkvist,D,DAL,24,82,6,14,20
90,8475690,Chris Tanev,D,TOR,35,82,4,16,20
90,8481708,Zac Jones,D,NYR,24,82,4,16,20
90,8470600,Ryan Suter,D,STL,39,82,4,16,20
90,8476879,Cody Ceci,D,EDM,31,82,3,17,20
90,8478416,Erik Cernak,D,TBL,27,82,3,17,20
90,8475462,Radko Gudas,D,ANA,34,82,3,17,20
90,8480222,Sebastian Aho,D,PIT,28,82,3,17,20
90,8479398,Samuel Girard,D,COL,26,82,2,18,20
90,8475718,Justin Holl,D,DET,32,82,1,19,20
90,8483397,Marc McLaughlin,C,BOS,25,82,13,6,19
90,8477425,Miles Wood,L,COL,29,82,9,10,19
90,8482141,Lukas Cormier,D,VGK,22,82,9,10,19
90,8481524,Bowen Byram,D,BUF,23,82,8,11,19
90,8483505,Matthew Poitras,C,BOS,20,82,8,11,19
90,8477931,Tomas Nosek,L,FLA,32,82,7,12,19
90,8483482,Tristan Luneau,D,ANA,20,82,7,12,19
90,8483012,Logan Morrison,C,SEA,22,82,6,13,19
90,8480246,Nick Perbix,D,TBL,26,82,5,14,19
90,8475279,Ben Chiarot,D,DET,33,82,5,14,19
90,8481605,Jackson LaCombe,D,ANA,23,82,4,15,19
90,8480860,Kevin Bahl,D,CGY,24,82,2,17,19
90,8480807,Mattias Samuelsson,D,BUF,24,82,1,18,19
90,8483468,Jiri Kulich,C,BUF,20,82,13,5,18
90,8484149,Gavin Brindley,C,CBJ,20,82,7,11,18
90,8480035,Henri Jokiharju,D,BUF,25,82,5,13,18
90,8478178,Darren Raddysh,D,TBL,28,82,3,15,18
90,8478399,Jonas Siegenthaler,D,NJD,27,82,2,16,18
90,8476429,Scott Mayfield,D,NYI,32,82,0,18,18
90,8480281,Alexey Toropchenko,R,STL,25,82,11,6,17
90,8475842,Sam Carrick,C,NYR,32,82,11,6,17
90,8482702,Logan Stankoven,C,DAL,21,82,9,8,17
90,8479291,Kevin Rooney,C,CGY,31,82,9,8,17
90,8477505,Alexander Wennberg,C,SJS,30,82,8,9,17
90,8474567,Zach Bogosian,D,MIN,34,82,8,9,17
90,8483763,Maksymilian Szuber,D,UTA,22,82,6,11,17
90,8480796,Martin Fehervary,D,WSH,25,82,6,11,17
90,8477499,Rasmus Ristolainen,D,PHI,30,82,5,12,17
90,8478450,Parker Wotherspoon,D,BOS,27,82,5,12,17
90,8471677,Jack Johnson,D,CBJ,37,82,5,12,17
90,8481567,Henry Thrun,D,SJS,23,82,4,13,17
90,8476441,Joel Edmundson,D,LAK,31,82,3,14,17
90,8475790,Erik Gudbranson,D,CBJ,32,82,2,15,17
90,8482073,Braden Schneider,D,NYR,23,82,0,17,17
90,8479414,Nathan Bastian,R,NJD,27,82,7,9,16
90,8479324,Ryan Lindgren,D,NYR,26,82,5,11,16
90,8482803,Olen Zellweger,D,ANA,21,82,5,11,16
90,8480834,Ty Emberson,D,SJS,24,82,4,12,16
90,8477034,Jaycob Megna,D,FLA,32,82,4,12,16
90,8479980,Nicolas Hague,D,VGK,26,82,3,13,16
90,8481122,Simon Benoit,D,TOR,26,82,3,13,16
90,8481568,Alex Vlasic,D,CHI,23,82,1,15,16
90,8481032,Paul Cotter,C,NJD,25,82,8,7,15
90,8482858,Ryker Evans,D,SEA,23,82,7,8,15
90,8481641,Joel Kiviranta,L,COL,28,82,6,9,15
90,8475177,Calvin de Haan,D,COL,33,82,5,10,15
90,8477335,Kyle Burroughs,D,LAK,29,82,4,11,15
90,8476967,Brett Kulak,D,EDM,30,82,4,11,15
90,8484911,Collin Graf,R,SJS,22,82,2,13,15
90,8480879,Jacob Bernard-Docker,D,OTT,24,82,2,13,15
90,8475762,Derek Forbort,D,VAN,32,82,5,9,14
90,8483499,Liam Ohgren,L,MIN,20,82,5,9,14
90,8478874,Adam Gaudette,C,OTT,28,82,5,9,14
90,8480144,David Kampf,C,TOR,29,82,4,10,14
90,8478468,Jeremy Lauzon,D,NSH,27,82,2,12,14
90,8480172,Jan Rutta,D,SJS,34,82,1,13,14
90,8482145,Mavrik Bourque,C,DAL,22,82,7,6,13
90,8481699,Aku Raty,R,UTA,23,82,6,7,13
90,8483567,Georgii Merkulov,C,BOS,24,82,6,7,13
90,8483460,David Jiricek,D,CBJ,21,82,3,10,13
90,8480021,Jack Studnicka,C,LAK,25,82,4,8,12
90,8482712,Oskar Olausson,R,COL,22,82,4,8,12
90,8482713,Mackie Samoskevich,R,FLA,22,82,4,8,12
90,8479576,Vincent Desharnais,D,VAN,28,82,3,9,12
90,8476457,Adam Larsson,D,SEA,32,82,1,11,12
90,8480950,Ilya Lyubushkin,D,DAL,30,82,1,11,12
90,8476822,Luke Glendening,C,TBL,35,82,7,3,10
90,8482809,Jackson Blake,R,CAR,21,82,5,5,10
90,8477938,Haydn Fleury,D,WPG,28,82,3,7,10
90,8476473,Connor Murphy,D,CHI,31,82,3,7,10
90,8476372,Nick Seeler,D,PHI,31,82,2,8,10
90,8482118,Sam Colangelo,R,ANA,23,82,2,8,10
90,8482516,Matthew Kessel,D,STL,24,82,2,8,10
90,8474612,Travis Hamonic,D,OTT,34,82,1,9,10
90,8482070,Mitchell Chaffee,R,TBL,26,82,6,3,9
90,8482749,Joshua Roy,R,MTL,21,82,4,5,9
90,8480870,Bo Groulx,C,NYR,24,82,3,6,9
90,8483466,Kevin Korchinski,D,CHI,20,82,2,7,9
90,8479638,Justin Brazeau,R,BOS,26,82,4,4,8
90,8482153,Brendan Brisson,C,VGK,23,82,2,6,8
90,8482787,Nikita Chibrikov,R,WPG,31,82,1,7,8
90,8482859,Zack Ostapchuk,C,OTT,21,82,3,4,7
90,8483489,Fraser Minten,C,TOR,31,82,2,4,6
90,8474062,Riley Nash,C,NYR,35,82,2,4,6
90,8470794,Joe Pavelski,C,,40,0,0,0,0
90,8481703,Valtteri Puustinen,R,PIT,25,0,0,0,0
90,8477950,Tony DeAngelo,D,,29,0,0,0,0
90,8481577,Philip Tomasino,C,NSH,23,0,0,0,0
90,8475197,Tyson Barrie,D,,33,0,0,0,0
90,8471218,Blake Wheeler,R,,38,0,0,0,0
90,8474157,Max Pacioretty,L,,36,0,0,0,0
90,8478466,Daniel Sprong,R,VAN,27,0,0,0,0
90,8475744,Evgeny Kuznetsov,C,,32,0,0,0,0
90,8481019,David Gustafsson,C,WPG,24,0,0,0,0
90,8475906,John Klingberg,D,,32,0,0,0,0
90,8479348,Kale Clague,D,BUF,26,0,0,0,0
90,8476952,Dominic Toninato,C,WPG,30,0,0,0,0
90,8473473,Milan Lucic,L,,36,0,0,0,0
90,8474037,James van Riemsdyk,L,,35,0,0,0,0
90,8474602,Justin Schultz,D,,34,0,0,0,0
90,8482222,Alexander Barabanov,L,,30,0,0,0,0
90,8479372,Josh Mahura,D,SEA,26,0,0,0,0
90,8479982,Conor Timmins,D,TOR,26,0,0,0,0
90,8474031,Kevin Shattenkirk,D,,35,0,0,0,0
90,8480008,Adam Ruzicka,C,,25,0,0,0,0
90,8481059,Scott Perunovich,D,STL,26,0,0,0,0
90,8480884,Calen Addison,D,,24,0,0,0,0
90,8476994,Vinnie Hinostroza,C,NSH,30,0,0,0,0
90,8478452,Caleb Jones,D,LAK,27,0,0,0,0
90,8480157,Calle Rosen,D,COL,30,0,0,0,0
90,8481609,Vladislav Kolyachonok,D,UTA,23,0,0,0,0
90,8479415,Michael McLeod,C,,26,0,0,0,0
90,8476919,Chris Tierney,C,,30,0,0,0,0
90,8479639,Dylan Coghlan,D,WPG,26,0,0,0,0
90,8478146,Matthew Highmore,C,OTT,28,0,0,0,0
90,8478970,Jalen Chatfield,D,CAR,28,0,0,0,0
90,8480205,Emil Bemstrom,C,PIT,25,0,0,0,0
90,8474884,Mike Hoffman,C,,35,0,0,0,0
90,8471274,Alex Goligoski,D,,39,0,0,0,0
90,8478104,Sammy Blais,L,,28,0,0,0,0
90,8474870,Tyler Johnson,C,,34,0,0,0,0
90,8476913,Devin Shore,C,MIN,30,0,0,0,0
90,8481598,Philip Broberg,D,EDM,23,0,0,0,0
90,8480058,Pierre-Olivier Joseph,D,STL,25,0,0,0,0
90,8480891,Michael Kesselring,D,UTA,24,0,0,0,0
90,8477979,Nicolas Aube-Kubel,R,BUF,28,0,0,0,0
90,8476871,Tanner Pearson,L,,32,0,0,0,0
90,8476393,Nick Cousins,C,,31,0,0,0,0
90,8479977,Kailer Yamamoto,R,,26,0,0,0,0
90,8479543,Michael Pezzetta,L,MTL,26,0,0,0,0
90,8477018,Ben Hutton,D,VGK,31,0,0,0,0
90,8480762,Eric Robinson,L,CAR,29,0,0,0,0
90,8474034,Pat Maroon,L,CHI,36,0,0,0,0
90,8481058,Jesse Ylönen,R,,25,0,0,0,0
90,8475179,Dmitry Kulikov,D,FLA,34,0,0,0,0
90,8481527,Kaedan Korczak,D,VGK,23,0,0,0,0
90,8473449,Kyle Okposo,R,,36,0,0,0,0
90,8482192,Isaak Phillips,D,CHI,23,0,0,0,0
90,8480727,Zach Whitecloud,D,VGK,28,0,0,0,0
90,8479346,Dillon Dube,C,,26,0,0,0,0
90,8480821,Filip Zadina,R,,25,0,0,0,0
90,8480001,Urho Vaakanainen,D,ANA,25,0,0,0,0
90,8470966,Mark Giordano,D,,41,0,0,0,0
90,8480853,Liam Foudy,C,,24,0,0,0,0
90,8475225,Craig Smith,C,CHI,35,0,0,0,0
90,8479972,Mason Shaw,C,WPG,26,0,0,0,0
90,8478451,Ethan Bear,D,WSH,27,0,0,0,0
90,8474040,Sam Gagner,C,,35,0,0,0,0
90,8480196,Jacob Bryson,D,BUF,27,0,0,0,0
90,8479984,Cal Foote,D,,26,0,0,0,0
90,8480011,Klim Kostin,C,SJS,25,0,0,0,0
90,8482176,Wyatt Kaiser,D,CHI,22,0,0,0,0
90,8476988,Matt Benning,D,SJS,30,0,0,0,0
90,8479370,Tyson Jost,C,CAR,26,0,0,0,0
90,8477464,Nic Petan,C,,29,0,0,0,0
90,8477380,Jonny Brodzinski,C,NYR,31,0,0,0,0
90,8480070,Ian Mitchell,D,BOS,25,0,0,0,0
90,8479315,Joey Anderson,R,CHI,26,0,0,0,0
90,8478099,Kevin Labanc,R,,29,0,0,0,0
90,8476874,Olli Maatta,D,DET,30,0,0,0,0
90,8475208,Brian Dumoulin,D,ANA,33,0,0,0,0
90,8478430,Oliver Kylington,D,,27,0,0,0,0
90,8479536,Axel Jonsson-Fjallby,L,WPG,26,0,0,0,0
90,8479671,Mathieu Olivier,R,CBJ,27,0,0,0,0
90,8471709,Marc-Edouard Vlasic,D,SJS,37,0,0,0,0
90,8479328,Julien Gauthier,R,NYI,27,0,0,0,0
90,8478421,A.J. Greer,L,FLA,28,0,0,0,0
90,8477573,Nathan Walker,L,STL,30,0,0,0,0
90,8481537,Nikita Okhotiuk,D,CGY,24,0,0,0,0
90,8474166,Alec Martinez,D,CHI,37,0,0,0,0
90,8470610,Zach Parise,L,,40,0,0,0,0
90,8477478,William Carrier,L,CAR,30,0,0,0,0
90,8479344,Jesse Puljujarvi,R,PIT,26,0,0,0,0
90,8480887,Jordan Harris,D,MTL,24,0,0,0,0
90,8478502,Dennis Gilbert,D,BUF,28,0,0,0,0
90,8482730,Brandt Clarke,D,LAK,21,0,0,0,0
90,8480355,Mark Kastelic,C,BOS,25,0,0,0,0
90,8475750,Jon Merrill,D,MIN,32,0,0,0,0
90,8475164,Jakob Silfverberg,R,,34,0,0,0,0
90,8477944,Jakub Vrana,L,,28,0,0,0,0
90,8479439,Jacob MacDonald,D,COL,31,0,0,0,0
90,8474568,Luke Schenn,D,NSH,35,0,0,0,0
90,8478454,Noah Juulsen,D,VAN,27,0,0,0,0
90,8475752,Tyler Pitlick,C,,33,0,0,0,0
90,8482148,Hendrix Lapierre,C,WSH,22,0,0,0,0
90,8481167,Brayden Pachal,D,CGY,25,0,0,0,0
90,8478043,Sam Lafferty,C,BUF,29,0,0,0,0
90,8479321,Lucas Johansen,D,,27,0,0,0,0
90,8471699,Andrew Cogliano,C,,37,0,0,0,0
90,8481521,Ronnie Attard,D,PHI,25,0,0,0,0
90,8481161,Jake Christiansen,D,CBJ,25,0,0,0,0
90,8479458,Nikita Zaitsev,D,,33,0,0,0,0
90,8479619,Michael Carcone,L,UTA,28,0,0,0,0
90,8479026,Philippe Myers,D,TOR,27,0,0,0,0
90,8477330,Dominik Kubalik,L,,29,0,0,0,0
90,8481617,Vasily Podkolzin,R,VAN,23,0,0,0,0
90,8481701,Santeri Hatakka,D,NJD,23,0,0,0,0
90,8479514,Rem Pitlick,C,,27,0,0,0,0
90,8477446,Michael McCarron,R,NSH,29,0,0,0,0
90,8470604,Jeff Carter,C,,39,0,0,0,0
90,8482241,Radim Zohorna,L,,28,0,0,0,0
90,8480289,Morgan Barron,C,WPG,26,0,0,0,0
90,8479379,Givani Smith,R,SJS,26,0,0,0,0
90,8480216,Jacob Peterson,C,,25,0,0,0,0
90,8477851,Jordan Oesterle,D,BOS,32,0,0,0,0
90,8484258,Sam Malinski,D,COL,26,0,0,0,0
90,8478904,Steven Lorentz,C,,28,0,0,0,0
90,8482095,Tyler Kleven,D,OTT,22,0,0,0,0
90,8480848,Ty Dellandrea,C,SJS,24,0,0,0,0
90,8476884,Derrick Pouliot,D,,30,0,0,0,0
90,8479336,Carl Grundstrom,R,SJS,27,0,0,0,0
90,8482964,Arber Xhekaj,D,MTL,23,0,0,0,0
90,8471686,Marc Staal,D,,37,0,0,0,0
90,8477887,Patrick Brown,C,BOS,32,0,0,0,0
90,8478495,Denis Gurianov,R,,27,0,0,0,0
90,8473504,Cal Clutterbuck,R,,37,0,0,0,0
90,8481550,Adam Beckman,L,NJD,23,0,0,0,0
90,8480845,Rasmus Kupari,C,WPG,24,0,0,0,0
90,8474009,Nick Bonino,C,,36,0,0,0,0
90,8478585,Derek Ryan,C,EDM,38,0,0,0,0
90,8477962,Brendan Lemieux,L,CAR,28,0,0,0,0
90,8482861,Vincent Iorio,D,WSH,22,0,0,0,0
90,8479378,Logan Stanley,D,WPG,26,0,0,0,0
90,8473446,Erik Johnson,D,PHI,36,0,0,0,0
90,8481743,Marc Del Gaizo,D,NSH,25,0,0,0,0
90,8477384,Josh Brown,D,EDM,30,0,0,0,0
90,8482165,Yan Kuznetsov,D,CGY,22,0,0,0,0
90,8478424,Jansen Harkins,C,ANA,27,0,0,0,0
90,8482144,Jack Thompson,D,SJS,22,0,0,0,0
90,8478512,Austin Czarnik,C,,32,0,0,0,0
90,8477527,Ross Johnston,L,ANA,30,0,0,0,0
90,8479383,Boris Katchouk,L,,26,0,0,0,0
90,8482094,Daemon Hunt,D,MIN,22,0,0,0,0
90,8481719,Maxwell Crozier,D,TBL,24,0,0,0,0
90,8480192,Johnathan Kovacevic,D,NJD,27,0,0,0,0
90,8479376,Victor Mete,D,,26,0,0,0,0
90,8482511,Mason Lohrei,D,BOS,23,0,0,0,0
90,8475825,Jani Hakanpää,D,,32,0,0,0,0
90,8478021,William Lagesson,D,DET,28,0,0,0,0
90,8475795,Dylan McIlrath,D,WSH,32,0,0,0,0
90,8477846,Ryan Carpenter,C,,33,0,0,0,0
90,8481056,Spencer Stastney,D,NSH,24,0,0,0,0
90,8481564,Ryan Johnson,D,BUF,23,0,0,0,0
90,8478017,Mark Friedman,D,VAN,29,0,0,0,0
90,8479320,Max Lajoie,D,SEA,27,0,0,0,0
90,8480075,Cameron Crotty,D,MIN,25,0,0,0,0
90,8484287,Cole McWard,D,VAN,23,0,0,0,0
90,8484254,Akito Hirose,D,VAN,25,0,0,0,0
90,8483407,Brandon Scanlin,D,NYR,25,0,0,0,0
90,8480274,Philip Kemp,D,EDM,25,0,0,0,0
90,8479522,Hardy Haman Aktell,D,WSH,26,0,0,0,0
90,8480007,Jonas Rondbjerg,R,VGK,25,0,0,0,0
90,8477454,Adam Erne,L,,29,0,0,0,0
90,8481679,Maxence Guenette,D,OTT,23,0,0,0,0
90,8480441,Trey Fix-Wolansky,R,CBJ,25,0,0,0,0
90,8483546,Marshall Rifai,D,TOR,26,0,0,0,0
90,8480084,Nick DeSimone,D,NJD,30,0,0,0,0
90,8481030,Jack St. Ivany,D,PIT,25,0,0,0,0
90,8481592,Jakob Pelletier,L,CGY,23,0,0,0,0
90,8478011,Louie Belpedio,D,PHI,28,0,0,0,0
90,8477930,Pierre-Edouard Bellemare,L,,39,0,0,0,0
90,8484321,Nikolas Matinpalo,D,OTT,26,0,0,0,0
90,8482067,Connor Mackey,D,NYR,28,0,0,0,0
90,8481806,Louis Crevier,D,CHI,23,0,0,0,0
90,8484326,Patrik Koch,D,UTA,28,0,0,0,0
90,8477971,Andreas Englund,D,LAK,28,0,0,0,0
90,8481751,Lukas Rousek,R,BUF,25,0,0,0,0
90,8481006,Tyler Tucker,D,STL,24,0,0,0,0
90,8476867,Brendan Gaunce,C,MIN,30,0,0,0,0
90,8479520,Brandon Duhaime,R,WSH,27,0,0,0,0
90,8477073,Kurtis MacDermid,L,NJD,30,0,0,0,0
90,8480874,Adam Ginning,D,PHI,24,0,0,0,0
90,8477473,Justin Bailey,R,SJS,29,0,0,0,0
90,8479066,Ryan Lomberg,L,CGY,30,0,0,0,0
90,8477070,Liam O'Brien,C,UTA,30,0,0,0,0
90,8474618,Marco Scandella,D,,34,0,0,0,0
90,8475797,Jarred Tinordi,D,,32,0,0,0,0
90,8481441,Joe Snively,C,DET,28,0,0,0,0
90,8477244,Chad Ruhwedel,D,NYR,34,0,0,0,0
90,8479772,Zack MacEwen,R,OTT,28,0,0,0,0
90,8481147,Reese Johnson,C,MIN,26,0,0,0,0
90,8481043,Cole Koepke,L,BOS,26,0,0,0,0
90,8483619,Filip Roos,D,OTT,25,0,0,0,0
90,8481541,Samuel Bolduc,D,NYI,24,0,0,0,0
90,8477810,Joel Hanley,D,CGY,33,0,0,0,0
90,8476907,Mackenzie MacEachern,L,,30,0,0,0,0
90,8482652,Walker Duehr,R,CGY,27,0,0,0,0
90,8477126,Jayson Megna,C,,34,0,0,0,0
90,8483398,Declan Carlile,D,TBL,31,0,0,0,0
90,8482929,Emil Lilleberg,D,TBL,23,0,0,0,0
90,8480880,Jakub Lauko,C,MIN,24,0,0,0,0
90,8480245,Olle Lycksell,R,PHI,25,0,0,0,0
90,8480252,Cole Guttman,C,CHI,25,0,0,0,0
90,8477467,Gustav Olofsson,D,SEA,30,0,0,0,0
90,8479968,Vinni Lettieri,C,BOS,29,0,0,0,0
90,8478400,Colin White,C,,27,0,0,0,0
90,8475755,Alexander Petrovic,D,DAL,32,0,0,0,0
90,8481812,Nikolai Knyzhov,D,,27,0,0,0,0
90,8481593,Jayden Struble,D,MTL,23,0,0,0,0
90,8481532,Alex Turcotte,C,LAK,23,0,0,0,0
90,8482126,Emil Andrae,D,PHI,31,0,0,0,0
90,8479944,Zach Aston-Reese,C,VGK,30,0,0,0,0
90,8471817,Ryan Reaves,R,TOR,37,0,0,0,0
90,8481206,John Ludvig,D,PIT,24,0,0,0,0
90,8481599,Victor Soderstrom,D,UTA,23,0,0,0,0
90,8480292,Carson Meyer,R,ANA,27,0,0,0,0
90,8482496,Nils Aman,C,VAN,24,0,0,0,0
90,8479718,Alex Barré-Boulet,C,MTL,27,0,0,0,0
90,8479994,Jaret Anderson-Dolan,C,WPG,25,0,0,0,0
90,8480184,Gustav Lindstrom,D,,26,0,0,0,0
90,8480890,Jan Jenik,R,OTT,24,0,0,0,0
90,8478067,Oskar Lindblom,L,,28,0,0,0,0
90,8476934,Brock McGinn,L,ANA,30,0,0,0,0
90,8479985,Cale Fleury,D,SEA,26,0,0,0,0
90,8484304,Uvis Balinskis,D,FLA,28,0,0,0,0
90,8479981,Jonah Gadjovich,L,FLA,26,0,0,0,0
90,8481716,Dmitri Voronkov,L,CBJ,24,0,0,0,0
90,8474709,Matt Martin,L,,35,0,0,0,0
90,8482634,Alex Steeves,C,TOR,25,0,0,0,0
90,8480823,Alexander Alexeyev,D,WSH,25,0,0,0,0
90,8477541,Dakota Mermis,D,TOR,30,0,0,0,0
90,8483491,Ivan Miroshnichenko,L,WSH,20,0,0,0,0
90,8478477,Mitchell Stephens,C,SEA,27,0,0,0,0
90,8481543,Nikita Alexandrov,C,STL,24,0,0,0,0
90,8479423,Alex Nylander,L,,26,0,0,0,0
90,8482451,Mikael Pyyhtia,L,CBJ,23,0,0,0,0
90,8478831,Kevin Stenlund,C,UTA,28,0,0,0,0
90,8480306,Grant Hutton,D,NYI,29,0,0,0,0
90,8478028,Fredrik Olofsson,L,,28,0,0,0,0
90,8477462,Robert Hagg,D,VGK,29,0,0,0,0
90,8477320,Anton Blidh,L,NYR,29,0,0,0,0
90,8482157,Will Cuylle,L,NYR,22,0,0,0,0
90,8482737,Zack Bolduc,C,STL,21,0,0,0,0
90,8481239,Samuel Fagemo,L,,24,0,0,0,0
90,8481600,Tobias Bjornfot,D,FLA,23,0,0,0,0
90,8478409,Anthony Richard,C,PHI,28,0,0,0,0
90,8474145,Robert Bortuzzo,D,,35,0,0,0,0
90,8475958,Michael Sgarbossa,C,WSH,32,0,0,0,0
90,8479986,Kole Lind,R,DAL,26,0,0,0,0
90,8479249,Andrew Poturalski,C,SJS,30,0,0,0,0
90,8479362,Riley Tufte,L,BOS,26,0,0,0,0
90,8479991,Jake Leschyshyn,C,NYR,25,0,0,0,0
90,8479587,Rhett Gardner,C,PHI,28,0,0,0,0
90,8482744,James Malatesta,L,CBJ,21,0,0,0,0
90,8478854,Ryan Shea,D,PIT,27,0,0,0,0
90,8481591,Sam Poulin,R,,23,0,0,0,0
90,8483512,Matt Savoie,C,EDM,20,0,0,0,0
90,8482102,Vasily Ponomarev,C,PIT,22,0,0,0,0
90,8482162,Roby Jarventie,L,EDM,22,0,0,0,0
90,8481016,Ruslan Iskhakov,C,,24,0,0,0,0
90,8482172,Landon Slaggert,L,CHI,22,0,0,0,0
90,8482747,Brennan Othmann,L,NYR,21,0,0,0,0
90,8480031,Maxime Comtois,L,,25,0,0,0,0
90,8480226,Marián Studenic,R,,26,0,0,0,0
90,8478408,Travis Dermott,D,,28,0,0,0,0
90,8481518,Nolan Foote,L,NJD,24,0,0,0,0
90,8479419,Brett Murray,L,BUF,26,0,0,0,0
90,8482088,Justin Sourdif,R,FLA,22,0,0,0,0
90,8482201,Gage Goncalves,C,TBL,23,0,0,0,0
90,8481578,Graeme Clarke,R,MIN,23,0,0,0,0
90,8482177,Marat Khusnutdinov,C,MIN,22,0,0,0,0
90,8481754,Nikita Nesterenko,C,ANA,23,0,0,0,0
90,8483531,Brian Halonen,L,NJD,25,0,0,0,0
90,8483920,Pierrick Dube,R,WSH,23,0,0,0,0
90,8480851,Akil Thomas,C,LAK,24,0,0,0,0
90,8475235,Nicolas Deslauriers,L,PHI,33,0,0,0,0
90,8482476,Emil Heineman,L,MTL,23,0,0,0,0
90,8477149,Scott Sabourin,R,SJS,32,0,0,0,0
90,8483549,Lucas Condotta,L,MTL,27,0,0,0,0
90,8482765,Isak Rosen,R,BUF,21,0,0,0,0
90,8481237,Kyle MacLean,C,NYI,25,0,0,0,0
90,8481024,Linus Karlsson,C,VAN,25,0,0,0,0
90,8481690,Tyler Angle,C,,24,0,0,0,0
90,8483570,Ben Meyers,C,SEA,26,0,0,0,0
90,8481655,Cole Schwindt,R,CGY,23,0,0,0,0
90,8481462,Mason Morelli,L,VGK,28,0,0,0,0
90,8483401,Marc Johnstone,R,PIT,28,0,0,0,0
90,8478956,Samuel Laberge,L,NJD,27,0,0,0,0
90,8479533,Joona Koppanen,L,,26,0,0,0,0
90,8482197,Adam Raska,R,MIN,23,0,0,0,0
90,8482250,Callahan Burke,C,VGK,27,0,0,0,0
90,8482784,Zach Dean,C,STL,21,0,0,0,0
90,8484255,Jason Polin,R,COL,25,0,0,0,0
90,8481077,John Leonard,L,,26,0,0,0,0
90,8481534,Raphael Lavoie,C,EDM,24,0,0,0,0
90,8483609,Adam Klapka,R,CGY,24,0,0,0,0
90,8482751,Ryan Winterton,C,SEA,21,0,0,0,0
90,8480267,Sammy Walker,C,MIN,25,0,0,0,0
90,8475766,Austin Watson,L,,32,0,0,0,0
90,8482460,Matt Rempe,C,NYR,22,0,0,0,0
90,8481065,Angus Crookshank,L,OTT,25,0,0,0,0
90,8481070,Hugh McGing,L,,26,0,0,0,0
90,8476323,Max McCormick,L,SEA,32,0,0,0,0
90,8483395,Arshdeep Bains,L,VAN,23,0,0,0,0
90,8484259,Ondrej Pavel,C,COL,31,0,0,0,0
90,8483432,Luca Del Bel Belluz,C,CBJ,31,0,0,0,0
90,8483045,Cameron Butler,R,CBJ,31,0,0,0,0
90,8482061,Brandon Biro,L,SEA,26,0,0,0,0
90,8477401,John Hayden,C,SEA,29,0,0,0,0
90,8475278,Byron Froese,C,,33,0,0,0,0
90,8478446,Glenn Gawdin,C,LAK,27,0,0,0,0
90,8477993,Justin Kirkland,C,CGY,28,0,0,0,0
90,8482147,Jean-Luc Foudy,C,COL,22,0,0,0,0
90,8480032,Shane Bowers,C,NJD,25,0,0,0,0
90,8479330,Brandon Gignac,C,MTL,27,0,0,0,0
90,8480776,Sheldon Rempal,R,,29,0,0,0,0
90,8475413,Justin Dowling,C,NJD,34,0,0,0,0
90,8481726,Adam Edstrom,C,NYR,24,0,0,0,0
90,8480844,Grigori Denisenko,L,VGK,24,0,0,0,0
90,8478147,Bokondji Imama,L,PIT,28,0,0,0,0
90,8478881,Brett Seney,L,CHI,28,0,0,0,0
90,8483630,Pavol Regenda,L,ANA,25,0,0,0,0
90,8480836,Jonathan Gruden,C,,24,0,0,0,0
90,8484314,Jiri Smejkal,L,,28,0,0,0,0
90,8475780,Chris Wagner,R,COL,33,0,0,0,0
90,8479546,Oskar Steen,C,,26,0,0,0,0
90,8483597,Milos Kelemen,L,UTA,25,0,0,0,0
90,8481789,Tye Kartye,L,SEA,23,0,0,0,0
90,8484325,Waltteri Merela,C,TBL,26,0,0,0,0
90,8479421,Jacob Moverare,D,LAK,26,0,0,0,0
90,8481585,Egor Afanasyev,L,SJS,23,0,0,0,0
90,8479547,Matthew Phillips,R,,26,0,0,0,0
90,8479367,William Lockwood,R,FLA,26,0,0,0,0
90,8476915,Jujhar Khaira,L,,30,0,0,0,0
90,8481422,Jacob Lucchini,C,NSH,29,0,0,0,0
90,8480468,James Hamblin,L,EDM,25,0,0,0,0
90,8478051,Max Willman,C,NJD,29,0,0,0,0
90,8481556,John Beecher,C,BOS,23,0,0,0,0
90,8478078,Rourke Chartier,C,,28,0,0,0,0
91,8478402,Connor McDavid,C,EDM,27,82,44,114,158
91,8476453,Nikita Kucherov,R,TBL,31,82,40,103,143
91,8481559,Jack Hughes,C,NJD,23,82,48,69,117
91,8477956,David Pastrnak,R,BOS,28,82,55,61,116
91,8476468,J.T. Miller,C,VAN,31,82,40,76,116
91,8477492,Nathan MacKinnon,C,COL,29,82,42,73,115
91,8480069,Cale Makar,D,COL,26,82,28,87,115
91,8479318,Auston Matthews,C,TOR,27,82,54,52,106
91,8479385,Jordan Kyrou,C,STL,26,82,48,57,105
91,8478550,Artemi Panarin,L,NYR,33,82,36,69,105
91,8480012,Elias Pettersson,C,VAN,26,82,33,72,105
91,8478398,Kyle Connor,L,WPG,28,82,46,56,102
91,8478427,Sebastian Aho,C,CAR,27,82,45,56,101
91,8476887,Filip Forsberg,L,NSH,30,82,50,50,100
91,8478864,Kirill Kaprizov,L,MIN,27,82,49,51,100
91,8475913,Mark Stone,R,VGK,32,82,41,59,100
91,8477939,William Nylander,R,TOR,28,82,39,61,100
91,8479407,Jesper Bratt,L,NJD,26,82,38,60,98
91,8478445,Mathew Barzal,C,NYI,27,82,25,73,98
91,8477933,Sam Reinhart,C,FLA,29,82,45,49,94
91,8477404,Jake Guentzel,C,TBL,30,82,43,50,93
91,8478420,Mikko Rantanen,R,COL,28,82,40,53,93
91,8477501,Valeri Nichushkin,R,COL,29,82,58,34,92
91,8477934,Leon Draisaitl,C,EDM,29,82,22,70,92
91,8475166,John Tavares,C,TOR,34,82,42,49,91
91,8474564,Steven Stamkos,C,NSH,34,82,40,51,91
91,8480036,Miro Heiskanen,D,DAL,25,82,26,65,91
91,8480027,Jason Robertson,L,DAL,25,82,35,55,90
91,8477942,Kevin Fiala,L,LAK,28,82,36,53,89
91,8480002,Nico Hischier,C,NJD,25,82,29,60,89
91,8480865,Noah Dobson,D,NYI,24,82,21,68,89
91,8480800,Quinn Hughes,D,VAN,25,82,16,71,87
91,8478010,Brayden Point,C,TBL,28,82,43,42,85
91,8480830,Andrei Svechnikov,R,CAR,24,82,38,47,85
91,8475798,Mikael Granlund,C,SJS,32,82,20,65,85
91,8481533,Trevor Zegras,C,ANA,23,82,34,50,84
91,8477946,Dylan Larkin,C,DET,28,82,30,54,84
91,8478439,Travis Konecny,R,PHI,27,82,31,52,83
91,8482116,Tim Stützle,C,OTT,22,82,27,56,83
91,8479314,Matthew Tkachuk,L,FLA,27,82,24,59,83
91,8475786,Zach Hyman,L,EDM,32,82,47,35,82
91,8478403,Jack Eichel,C,VGK,28,82,40,42,82
91,8481557,Matt Boldy,L,MIN,23,82,38,44,82
91,8480801,Brady Tkachuk,L,OTT,25,82,34,48,82
91,8476389,Vincent Trocheck,C,NYR,31,82,32,50,82
91,8474141,Patrick Kane,R,DET,36,82,32,49,81
91,8477493,Aleksander Barkov,C,FLA,29,82,22,59,81
91,8480208,Drake Batherson,R,OTT,26,82,41,39,80
91,8471675,Sidney Crosby,C,PIT,37,82,33,46,79
91,8477409,Carter Verhaeghe,C,FLA,29,82,36,42,78
91,8473419,Brad Marchand,L,BOS,36,82,35,43,78
91,8480023,Robert Thomas,C,STL,25,82,24,54,78
91,8477496,Elias Lindholm,C,BOS,30,82,30,47,77
91,8479343,Clayton Keller,R,UTA,26,82,33,43,76
91,8475784,Jeff Skinner,C,EDM,32,82,32,44,76
91,8478493,Joel Eriksson Ek,C,MIN,27,82,35,40,75
91,8477949,Alex Tuch,R,BUF,28,82,22,53,75
91,8481523,Kirby Dach,C,MTL,23,82,11,64,75
91,8475184,Chris Kreider,L,NYR,33,82,41,33,74
91,8478449,Roope Hintz,C,DAL,28,82,37,37,74
91,8475168,Matt Duchene,C,DAL,33,82,33,41,74
91,8479323,Adam Fox,D,NYR,26,82,19,55,74
91,8477500,Bo Horvat,C,NYI,29,82,32,41,73
91,8476448,William Karlsson,C,VGK,31,82,28,45,73
91,8475692,Mats Zuccarello,R,MIN,37,82,22,51,73
91,8473512,Claude Giroux,R,OTT,36,82,20,53,73
91,8476875,Mike Matheson,D,MTL,30,82,18,55,73
91,8480803,Evan Bouchard,D,EDM,25,82,16,57,73
91,8474600,Roman Josi,D,NSH,34,82,15,58,73
91,8478366,Frank Vatrano,R,ANA,30,82,34,38,72
91,8475158,Ryan O'Reilly,C,NSH,33,82,32,40,72
91,8477402,Pavel Buchnevich,L,STL,29,82,26,46,72
91,8476346,Johnny Gaudreau,L,CBJ,31,82,18,54,72
91,8479420,Tage Thompson,C,BUF,27,82,37,34,71
91,8478414,Timo Meier,R,NJD,28,82,37,34,71
91,8475172,Nazem Kadri,C,CGY,34,82,29,42,71
91,8473986,Alex Killorn,L,ANA,35,82,26,45,71
91,8474590,John Carlson,D,WSH,34,82,17,54,71
91,8477346,MacKenzie Weegar,D,CGY,30,82,13,58,71
91,8476460,Mark Scheifele,C,WPG,31,82,27,43,70
91,8475726,Tyler Toffoli,C,SJS,32,82,41,28,69
91,8475754,Brock Nelson,C,NYI,33,82,40,29,69
91,8477476,Artturi Lehkonen,L,COL,29,82,36,33,69
91,8479542,Brandon Hagel,L,TBL,26,82,38,30,68
91,8480018,Nick Suzuki,C,MTL,25,82,29,39,68
91,8471215,Evgeni Malkin,C,PIT,38,82,28,40,68
91,8477940,Nikolaj Ehlers,L,WPG,28,82,22,46,68
91,8478444,Brock Boeser,R,VAN,27,82,36,31,67
91,8479337,Alex DeBrincat,R,DET,27,82,36,31,67
91,8476881,Tomas Hertl,C,VGK,31,82,29,38,67
91,8478873,Troy Terry,R,ANA,27,82,26,41,67
91,8476454,Ryan Nugent-Hopkins,C,EDM,31,82,22,45,67
91,8482078,Lucas Raymond,L,DET,22,82,22,45,67
91,8477495,Seth Jones,D,CHI,30,82,19,48,67
91,8478460,Zach Werenski,D,CBJ,27,82,12,55,67
91,8477935,Sam Bennett,C,FLA,28,82,41,25,66
91,8474150,Mikael Backlund,C,CGY,35,82,25,41,66
91,8478042,Viktor Arvidsson,R,EDM,31,82,22,44,66
91,8480839,Rasmus Dahlin,D,BUF,24,82,16,50,66
91,8476459,Mika Zibanejad,C,NYR,31,82,16,50,66
91,8473994,Jamie Benn,L,DAL,35,82,30,35,65
91,8481711,Matias Maccelli,L,UTA,24,82,18,47,65
91,8476539,Jonathan Marchessault,R,NSH,34,82,29,35,64
91,8471214,Alex Ovechkin,L,WSH,39,82,34,29,63
91,8481528,Dylan Cozens,C,BUF,23,82,28,35,63
91,8475810,Bryan Rust,R,PIT,32,82,27,36,63
91,8475170,Brayden Schenn,C,STL,33,82,23,40,63
91,8471685,Anze Kopitar,C,LAK,37,82,27,35,62
91,8482097,Jack Quinn,R,BUF,23,82,20,42,62
91,8477494,Jonathan Drouin,L,COL,29,82,19,43,62
91,8479325,Charlie McAvoy,D,BOS,27,82,7,55,62
91,8478047,Michael Bunting,L,PIT,29,82,27,34,61
91,8477951,Nick Schmaltz,C,UTA,28,82,25,36,61
91,8478401,Pavel Zacha,C,BOS,27,82,24,37,61
91,8474578,Erik Karlsson,D,PIT,34,82,20,41,61
91,8476462,Dougie Hamilton,D,NJD,31,82,18,43,61
91,8476456,Jonathan Huberdeau,C,CGY,31,82,17,44,61
91,8480014,Gabriel Vilardi,C,WPG,25,82,35,25,60
91,8475765,Vladimir Tarasenko,R,DET,33,82,32,28,60
91,8482093,Seth Jarvis,C,CAR,22,82,27,33,60
91,8477416,Oliver Bjorkstrand,R,SEA,29,82,25,35,60
91,8477504,Josh Morrissey,D,WPG,29,82,16,44,60
91,8478038,Devon Toews,D,COL,30,82,14,46,60
91,8478396,Noah Hanifin,D,VGK,27,82,13,47,60
91,8482175,JJ Peterka,R,BUF,22,82,29,30,59
91,8482159,Tyson Foerster,R,PHI,22,82,26,33,59
91,8478975,Mason Marchment,L,DAL,29,82,19,40,59
91,8477503,Max Domi,C,TOR,29,82,17,42,59
91,8476792,Torey Krug,D,STL,33,82,13,46,59
91,8475167,Victor Hedman,D,TBL,34,82,9,50,59
91,8477479,Tyler Bertuzzi,L,CHI,29,82,26,32,58
91,8478438,Tommy Novak,C,NSH,27,82,18,40,58
91,8478397,Rasmus Andersson,D,CGY,28,82,17,41,58
91,8476853,Morgan Rielly,D,TOR,30,82,11,47,58
91,8476399,Blake Coleman,C,CGY,33,82,31,26,57
91,8480039,Martin Necas,C,CAR,25,82,27,30,57
91,8483808,Andrei Kuzmenko,L,CGY,28,82,25,32,57
91,8482113,Anton Lundell,C,FLA,23,82,24,33,57
91,8477447,Shea Theodore,D,VGK,29,82,12,45,57
91,8475314,Anders Lee,L,NYI,34,82,24,32,56
91,8477986,Brandon Montour,D,SEA,30,82,24,32,56
91,8479400,Pierre-Luc Dubois,L,WSH,26,82,24,32,56
91,8477955,Jared McCann,L,SEA,28,82,22,34,56
91,8475287,Erik Haula,L,NJD,33,82,21,35,56
91,8478440,Dylan Strome,C,WSH,27,82,19,37,56
91,8475745,Charlie Coyle,C,BOS,32,82,19,37,56
91,8476438,Brandon Saad,L,STL,32,82,29,26,55
91,8480188,Fabian Zetterlund,L,SJS,25,82,26,29,55
91,8479999,Casey Mittelstadt,C,COL,26,82,20,35,55
91,8476432,Boone Jenner,C,CBJ,31,82,34,20,54
91,8474641,Adam Henrique,C,EDM,34,82,31,23,54
91,8482110,Dawson Mercer,C,NJD,23,82,29,25,54
91,8477960,Adrian Kempe,R,LAK,28,82,28,26,54
91,8481540,Cole Caufield,R,MTL,23,82,28,26,54
91,8480798,Philipp Kurashev,C,CHI,25,82,21,33,54
91,8474563,Drew Doughty,D,LAK,35,82,21,33,54
91,8476872,Scott Laughton,C,PHI,30,82,17,37,54
91,8475151,Kyle Palmieri,C,NYI,33,82,28,25,53
91,8480015,Owen Tippett,R,PHI,25,82,27,26,53
91,8478498,Jake DeBrusk,L,VAN,28,82,25,28,53
91,8477497,Sean Monahan,C,CBJ,30,82,21,32,53
91,8474679,Gustav Nyquist,C,NSH,35,82,16,37,53
91,8475794,Tyler Seguin,C,DAL,32,82,25,27,52
91,8479339,Patrik Laine,L,CBJ,26,82,21,31,52
91,8475191,Reilly Smith,R,NYR,33,82,19,33,52
91,8482667,William Eklund,L,SJS,22,82,18,34,52
91,8480028,Morgan Frost,C,PHI,25,82,14,38,52
91,8482124,Quinton Byfield,R,LAK,22,82,13,39,52
91,8481581,Thomas Harley,D,DAL,23,82,11,41,52
91,8481068,Yegor Sharangovich,C,CGY,26,82,27,24,51
91,8481186,Logan O'Connor,R,COL,28,82,26,25,51
91,8477998,Warren Foegele,L,LAK,28,82,24,27,51
91,8476925,Colton Sissons,C,NSH,31,82,22,29,51
91,8475791,Taylor Hall,L,CHI,33,82,17,34,51
91,8476905,Chandler Stephenson,C,SEA,30,82,15,36,51
91,8478407,Vince Dunn,D,SEA,28,82,9,42,51
91,8471724,Kris Letang,D,PIT,37,82,8,43,51
91,8477407,Anthony Duclair,L,NYI,29,82,28,22,50
91,8482745,Mason McTavish,C,ANA,21,82,22,28,50
91,8482705,Cole Sillinger,C,CBJ,21,82,22,28,50
91,8482149,Cole Perfetti,C,WPG,22,82,18,32,50
91,8480802,Ryan McLeod,C,BUF,25,82,17,33,50
91,8474565,Alex Pietrangelo,D,VGK,34,82,10,40,50
91,8482740,Wyatt Johnston,C,DAL,21,82,25,24,49
91,8475169,Evander Kane,L,EDM,33,82,25,24,49
91,8477964,Ivan Barbashev,C,VGK,29,82,22,27,49
91,8476458,Ryan Strome,C,ANA,31,82,14,35,49
91,8470613,Brent Burns,D,CAR,39,82,12,37,49
91,8482699,Dylan Guenther,R,UTA,21,82,29,19,48
91,8480064,Josh Norris,C,OTT,25,82,28,20,48
91,8477451,Ryan Hartman,R,MIN,30,82,23,25,48
91,8479675,Trevor Moore,L,LAK,29,82,22,26,48
91,8476882,Teuvo Teravainen,L,CHI,30,82,19,29,48
91,8476479,Phillip Danault,C,LAK,31,82,19,29,48
91,8475722,Jason Zucker,L,BUF,32,82,19,29,48
91,8480185,Eetu Luostarinen,C,FLA,26,82,17,31,48
91,8480434,Sean Durzi,D,UTA,26,82,16,32,48
91,8479345,Jakob Chychrun,D,WSH,26,82,15,33,48
91,8475753,Justin Faulk,D,STL,32,82,13,35,48
91,8482660,Kent Johnson,C,CBJ,22,82,13,35,48
91,8482684,Luke Hughes,D,NJD,21,82,7,41,48
91,8479941,Justin Danforth,R,CBJ,31,82,24,23,47
91,8479525,Ross Colton,C,COL,28,82,23,24,47
91,8475799,Nino Niederreiter,R,WPG,32,82,21,26,47
91,8475218,Mattias Ekholm,D,EDM,34,82,14,33,47
91,8482109,Alexis Lafrenière,L,NYR,23,82,25,21,46
91,8474586,Jordan Eberle,R,SEA,34,82,23,23,46
91,8477456,J.T. Compher,L,DET,29,82,20,26,46
91,8478469,Thomas Chabot,D,OTT,27,82,16,30,46
91,8479987,Morgan Geekie,C,BOS,26,82,16,30,46
91,8475171,Oliver Ekman-Larsson,D,TOR,33,82,13,33,46
91,8479996,Cody Glass,C,NSH,25,82,25,20,45
91,8481560,Arthur Kaliyev,R,LAK,23,82,20,25,45
91,8474102,David Perron,L,OTT,36,82,16,29,45
91,8479365,Trent Frederic,C,BOS,26,82,16,29,45
91,8478519,Anthony Cirelli,C,TBL,27,82,24,20,44
91,8482092,Ridly Greig,C,OTT,22,82,22,22,44
91,8476880,Tom Wilson,R,WSH,30,82,21,23,44
91,8478474,Lawson Crouse,L,UTA,27,82,18,26,44
91,8481596,Shane Pinto,C,OTT,24,82,15,29,44
91,8478462,Nicolas Roy,C,VGK,27,82,15,29,44
91,8482665,Matty Beniers,C,SEA,22,82,14,30,44
91,8479425,Filip Hronek,D,VAN,27,82,13,31,44
91,8476392,Adam Lowry,C,WPG,31,82,12,32,44
91,8478055,Gustav Forsling,D,FLA,28,82,11,33,44
91,8474053,Logan Couture,C,SJS,35,82,11,33,44
91,8476869,Brady Skjei,D,NSH,30,82,10,34,44
91,8476958,Jaccob Slavin,D,CAR,30,82,7,37,44
91,8483515,Juraj Slafkovsky,L,MTL,20,82,23,20,43
91,8480459,Pius Suter,C,VAN,28,82,21,22,43
91,8480829,Jesperi Kotkaniemi,C,CAR,24,82,20,23,43
91,8478458,Jack Roslovic,C,CAR,27,82,16,27,43
91,8480113,Alex Iafallo,L,WPG,31,82,15,28,43
91,8480078,Filip Chytil,C,NYR,25,82,15,28,43
91,8481656,Aliaksei Protas,C,WSH,23,82,14,29,43
91,8476854,Hampus Lindholm,D,BOS,30,82,10,33,43
91,8480145,Neal Pionk,D,WPG,29,82,9,34,43
91,8481604,Pavel Dorofeyev,L,VGK,24,82,23,19,42
91,8478891,Mason Appleton,C,WPG,28,82,22,20,42
91,8477511,Anthony Mantha,R,CGY,30,82,19,23,42
91,8477932,Aaron Ekblad,D,FLA,28,82,10,32,42
91,8476329,Travis Boyd,C,MIN,31,82,9,33,42
91,8480336,Sean Walker,D,CAR,30,82,9,33,42
91,8477021,Alex Kerfoot,C,UTA,30,82,9,33,42
91,8471698,T.J. Oshie,R,WSH,38,82,23,18,41
91,8476483,Rickard Rakell,R,PIT,31,82,22,19,41
91,8477953,Kasperi Kapanen,R,STL,28,82,18,23,41
91,8473533,Jordan Staal,C,CAR,36,82,18,23,41
91,8481618,Alex Newhook,C,MTL,23,82,15,26,41
91,8476927,Teddy Blueger,C,VAN,30,82,15,26,41
91,8478233,Andrew Mangiapane,L,WSH,28,82,14,27,41
91,8480835,Jack Drury,C,CAR,24,82,14,27,41
91,8476923,Damon Severson,D,CBJ,30,82,9,32,41
91,8482475,Yegor Chinakhov,R,CBJ,23,82,21,19,40
91,8481554,Kaapo Kakko,R,NYR,23,82,20,20,40
91,8478542,Evan Rodrigues,C,FLA,31,82,17,23,40
91,8476419,Jean-Gabriel Pageau,C,NYI,32,82,13,27,40
91,8477444,Andre Burakovsky,L,SEA,29,82,12,28,40
91,8477948,Travis Sanheim,D,PHI,28,82,8,32,40
91,8476906,Shayne Gostisbehere,D,CAR,31,82,7,33,40
91,8480009,Eeli Tolvanen,R,SEA,25,82,26,13,39
91,8480220,Noah Cates,L,PHI,25,82,19,20,39
91,8476461,Sean Couturier,C,PHI,32,82,18,21,39
91,8476480,Vladislav Namestnikov,C,WPG,32,82,13,26,39
91,8476885,Jacob Trouba,D,NYR,30,82,11,28,39
91,8473563,Nicklas Backstrom,C,WSH,37,82,10,29,39
91,8475764,Cam Fowler,D,ANA,33,82,4,35,39
91,8478046,Danton Heinen,L,VAN,29,82,20,18,38
91,8479591,Michael Eyssimont,C,TBL,28,82,18,20,38
91,8477429,Andrew Copp,C,DET,30,82,15,23,38
91,8481546,Cam York,D,PHI,23,82,15,23,38
91,8474149,Evgenii Dadonov,R,DAL,35,82,14,24,38
91,8479359,Beck Malenstyn,L,BUF,26,82,14,24,38
91,8475760,Nick Bjugstad,C,UTA,32,82,22,15,37
91,8473422,Nick Foligno,L,CHI,37,82,20,17,37
91,8478856,Conor Garland,R,VAN,28,82,18,19,37
91,8481535,Nils Hoglander,L,VAN,24,82,18,19,37
91,8478057,Dakota Joshua,C,VAN,28,82,16,21,37
91,8482117,Lukas Reichel,L,CHI,22,82,14,23,37
91,8480797,Joel Farabee,L,PHI,24,82,13,24,37
91,8476921,Jordan Martinook,L,CAR,32,82,13,24,37
91,8479351,Sam Steel,C,DAL,26,82,11,26,37
91,8475149,Marcus Johansson,L,MIN,34,82,8,29,37
91,8473507,Jeff Petry,D,DET,37,82,5,32,37
91,8475793,Ryan Johansen,C,PHI,32,82,20,16,36
91,8484166,Adam Fantilli,C,CBJ,20,82,19,17,36
91,8478109,Victor Olofsson,L,VGK,29,82,14,22,36
91,8482146,Luke Evangelista,R,NSH,22,82,14,22,36
91,8481624,Ilya Mikheyev,R,CHI,30,82,10,26,36
91,8477839,Conor Sheary,L,TBL,32,82,10,26,36
91,8475763,Kevin Hayes,R,PIT,32,82,9,27,36
91,8476312,Josh Manson,D,COL,33,82,9,27,36
91,8482089,Jake Neighbours,L,STL,22,82,19,16,35
91,8475768,Jaden Schwartz,C,SEA,32,82,17,18,35
91,8484153,Leo Carlsson,C,ANA,20,82,17,18,35
91,8476826,Yanni Gourde,C,SEA,33,82,16,19,35
91,8481013,Jonatan Berggren,R,DET,24,82,13,22,35
91,8477989,Christian Dvorak,C,MTL,28,82,12,23,35
91,8482062,Cole Smith,L,NSH,29,82,10,25,35
91,8475200,Dmitry Orlov,D,CAR,33,82,7,28,35
91,8482655,J.J. Moser,D,TBL,24,82,6,29,35
91,8477365,Connor Clifton,D,BUF,29,82,6,29,35
91,8476981,Josh Anderson,R,MTL,30,82,22,12,34
91,8480893,Kirill Marchenko,R,CBJ,24,82,19,15,34
91,8479393,Noah Gregor,C,OTT,26,82,18,16,34
91,8470621,Corey Perry,R,EDM,39,82,18,16,34
91,8478508,Yakov Trenin,C,MIN,27,82,17,17,34
91,8475714,Calle Jarnkrok,C,TOR,33,82,16,18,34
91,8481704,Juuso Parssinen,C,NSH,23,82,16,18,34
91,8482720,Matthew Knies,L,TOR,22,82,14,20,34
91,8477498,Darnell Nurse,D,EDM,29,82,13,21,34
91,8482105,Jake Sanderson,D,OTT,22,82,11,23,34
91,8480871,Adam Boqvist,D,FLA,24,82,11,23,34
91,8481542,Moritz Seider,D,DET,23,82,7,27,34
91,8480073,Erik Brannstrom,D,COL,25,82,7,27,34
91,8479410,Mikhail Sergachev,D,UTA,26,82,6,28,34
91,8474151,Ryan McDonagh,D,TBL,35,82,5,29,34
91,8477952,Robby Fabbri,C,ANA,28,82,19,14,33
91,8478020,Michael Amadio,C,OTT,28,82,17,16,33
91,8477450,Jason Dickinson,C,CHI,29,82,17,16,33
91,8477426,Nicholas Paul,L,TBL,29,82,16,17,33
91,8482079,Marco Rossi,C,MIN,23,82,16,17,33
91,8480003,Jesper Boqvist,C,FLA,26,82,15,18,33
91,8475193,Tomas Tatar,L,NJD,34,82,12,21,33
91,8480817,K'Andre Miller,D,NYR,24,82,9,24,33
91,8482142,Jamie Drysdale,D,PHI,22,82,8,25,33
91,8478507,John Marino,D,UTA,27,82,7,26,33
91,8478851,Alexandre Carrier,D,NSH,28,82,7,26,33
91,8476892,Colton Parayko,D,STL,31,82,5,28,33
91,8482055,Drew O'Connor,L,PIT,26,82,20,12,32
91,8484144,Connor Bedard,C,CHI,19,82,18,14,32
91,8479390,Taylor Raddysh,R,WSH,26,82,18,14,32
91,8476474,Stefan Noesen,R,NJD,31,82,17,15,32
91,8478413,Jordan Greenway,L,BUF,27,82,15,17,32
91,8480074,Alexandre Texier,C,STL,25,82,15,17,32
91,8480789,Oliver Wahlstrom,R,NYI,24,82,12,20,32
91,8477425,Miles Wood,L,COL,29,82,12,20,32
91,8482803,Olen Zellweger,D,ANA,21,82,10,22,32
91,8478472,Mathieu Joseph,R,STL,27,82,9,23,32
91,8476292,Ondrej Palat,L,NJD,33,82,9,23,32
91,8480748,Kiefer Sherwood,L,VAN,29,82,16,15,31
91,8476278,Colin Blackwell,C,DAL,31,82,15,16,31
91,8482111,Justin Barron,D,MTL,23,82,14,17,31
91,8479992,Michael Rasmussen,C,DET,25,82,12,19,31
91,8480068,Ryan Poehling,C,PHI,25,82,11,20,31
91,8479353,Brett Howden,C,VGK,26,82,11,20,31
91,8475343,Nic Dowd,C,WSH,34,82,11,20,31
91,8481481,Blake Lizotte,C,PIT,27,82,9,22,31
91,8476897,Oskar Sundqvist,C,STL,30,82,9,22,31
91,8483457,Lane Hutson,D,MTL,20,82,9,22,31
91,8478133,Jake Evans,C,MTL,28,82,7,24,31
91,8474716,Jared Spurgeon,D,MIN,35,82,6,25,31
91,8479402,Jake Bean,D,CGY,26,82,3,28,31
91,8482125,Alexander Holtz,R,VGK,22,82,18,12,30
91,8481580,Connor McMichael,C,WSH,23,82,17,13,30
91,8479316,Luke Kunin,C,SJS,27,82,16,14,30
91,8477987,Ryan Donato,C,CHI,28,82,15,15,30
91,8475848,Brendan Gallagher,R,MTL,32,82,14,16,30
91,8481601,Simon Holmstrom,R,NYI,23,82,13,17,30
91,8477947,Sonny Milano,L,WSH,28,82,12,18,30
91,8476873,Mark Jankowski,C,NSH,30,82,12,18,30
91,8482624,Daniil Miromanov,D,CGY,27,82,12,18,30
91,8475855,Jesper Fast,R,CAR,33,82,11,19,30
91,8478882,Vladislav Gavrikov,D,LAK,29,82,6,24,30
91,8477488,Brett Pesce,D,NJD,30,82,6,24,30
91,8480873,Rasmus Sandin,D,WSH,24,82,5,25,30
91,8476931,Jake McCabe,D,TOR,31,82,4,26,30
91,8479398,Samuel Girard,D,COL,26,82,1,29,30
91,8480281,Alexey Toropchenko,R,STL,25,82,21,8,29
91,8476469,Joel Armia,R,MTL,31,82,16,13,29
91,8474189,Lars Eller,C,PIT,35,82,14,15,29
91,8478911,Matt Roy,D,WSH,29,82,11,18,29
91,8482671,Owen Power,D,BUF,22,82,7,22,29
91,8476902,Esa Lindell,D,DAL,30,82,5,24,29
91,8475324,Nick Jensen,D,OTT,34,82,5,24,29
91,8478500,Ivan Provorov,D,CBJ,27,82,0,29,29
91,8478432,Christian Fischer,R,DET,27,82,15,13,28
91,8477015,Connor Brown,R,EDM,30,82,14,14,28
91,8476960,Andreas Athanasiou,C,CHI,30,82,12,16,28
91,8480448,Parker Kelly,L,COL,25,82,10,18,28
91,8482702,Logan Stankoven,C,DAL,21,82,9,19,28
91,8477507,Nikita Zadorov,D,BOS,29,82,7,21,28
91,8476878,Zemgus Girgensons,L,TBL,30,82,16,11,27
91,8480025,MacKenzie Entwistle,R,FLA,25,82,14,13,27
91,8478463,Anthony Beauvillier,L,PIT,27,82,13,14,27
91,8475231,Casey Cizikas,C,NYI,33,82,13,14,27
91,8481032,Paul Cotter,C,NJD,25,82,13,14,27
91,8477919,Frederick Gaudreau,C,MIN,31,82,11,16,27
91,8477406,Mattias Janmark,C,EDM,32,82,11,16,27
91,8477931,Tomas Nosek,L,FLA,32,82,11,16,27
91,8481582,Nicholas Robertson,L,TOR,23,82,10,17,27
91,8480806,Isac Lundestrom,C,ANA,25,82,10,17,27
91,8482166,Shakir Mukhamadullin,D,SJS,22,82,10,17,27
91,8476624,Barclay Goodrow,C,SJS,31,82,9,18,27
91,8478013,Jake Walman,D,SJS,28,82,9,18,27
91,8482141,Lukas Cormier,D,VGK,22,82,8,19,27
91,8484149,Gavin Brindley,C,CBJ,20,82,6,21,27
91,8477220,Nate Schmidt,D,FLA,33,82,5,22,27
91,8476463,Jonas Brodin,D,MIN,31,82,5,22,27
91,8476457,Adam Larsson,D,SEA,32,82,5,22,27
91,8477969,Marcus Pettersson,D,PIT,28,82,3,24,27
91,8476917,Adam Pelech,D,NYI,30,82,2,25,27
91,8475842,Sam Carrick,C,NYR,32,82,17,9,26
91,8481517,Brett Leason,R,ANA,25,82,12,14,26
91,8478115,Pierre Engvall,L,NYI,28,82,11,15,26
91,8480813,Joe Veleno,C,DET,24,82,10,16,26
91,8482245,Artem Zub,D,OTT,29,82,7,19,26
91,8482122,Brock Faber,D,MIN,22,82,7,19,26
91,8475279,Ben Chiarot,D,DET,33,82,6,20,26
91,8480878,Nils Lundkvist,D,DAL,24,82,3,23,26
91,8477845,Trevor van Riemsdyk,D,WSH,33,82,2,24,26
91,8482259,Bobby McMann,C,TOR,28,82,15,10,25
91,8479661,Tanner Jeannot,L,LAK,27,82,10,15,25
91,8482666,Scott Morrow,D,CAR,22,82,8,17,25
91,8475220,Marcus Foligno,L,MIN,33,82,7,18,25
91,8476979,Erik Gustafsson,D,DET,32,82,5,20,25
91,8479983,Mario Ferraro,D,SJS,26,82,4,21,25
91,8477506,Ryan Pulock,D,NYI,30,82,4,21,25
91,8480172,Jan Rutta,D,SJS,34,82,4,21,25
91,8482087,Kaiden Guhle,D,MTL,22,82,3,22,25
91,8474673,TJ Brodie,D,CHI,34,82,3,22,25
91,8478178,Darren Raddysh,D,TBL,28,82,3,22,25
91,8481014,Alexander Romanov,D,NYI,24,82,2,23,25
91,8482074,Connor Zary,C,CGY,23,82,17,7,24
91,8477392,Hudson Fasching,R,NYI,29,82,14,10,24
91,8476374,Sean Kuraly,C,CBJ,31,82,13,11,24
91,8478569,Noel Acciari,C,PIT,33,82,11,13,24
91,8478434,Keegan Kolesar,R,VGK,27,82,11,13,24
91,8483493,Frank Nazar,C,CHI,20,82,11,13,24
91,8482133,Thomas Bordeleau,C,SJS,22,82,10,14,24
91,8476442,Matt Nieto,L,PIT,32,82,10,14,24
91,8478468,Jeremy Lauzon,D,NSH,27,82,6,18,24
91,8483490,Pavel Mintyukov,D,ANA,21,82,5,19,24
91,8479293,Brandon Tanev,L,SEA,33,82,12,11,23
91,8477903,Garnet Hathaway,R,PHI,33,82,11,12,23
91,8480849,Barrett Hayton,C,UTA,24,82,10,13,23
91,8474715,Cam Atkinson,R,TBL,35,82,10,13,23
91,8480995,Pontus Holmberg,R,TOR,25,82,10,13,23
91,8481553,Bobby Brink,R,PHI,23,82,9,14,23
91,8476918,Jimmy Vesey,L,NYR,31,82,8,15,23
91,8481028,Martin Pospisil,C,CGY,25,82,7,16,23
91,8477369,Carson Soucy,D,VAN,30,82,7,16,23
91,8476331,Dylan DeMelo,D,WPG,31,82,6,17,23
91,8480246,Nick Perbix,D,TBL,26,82,6,17,23
91,8481522,Peyton Krebs,C,BUF,23,82,5,18,23
91,8476891,Matt Grzelcyk,D,PIT,30,82,5,18,23
91,8479980,Nicolas Hague,D,VGK,26,82,5,18,23
91,8480035,Henri Jokiharju,D,BUF,25,82,3,20,23
91,8479371,Dante Fabbro,D,NSH,26,82,2,21,23
91,8483431,Logan Cooley,C,UTA,20,82,16,6,22
91,8484203,Bradly Nadeau,L,CAR,19,82,14,8,22
91,8481477,Nico Sturm,C,SJS,29,82,12,10,22
91,8483495,Simon Nemec,D,NJD,20,82,7,15,22
91,8476422,Mike Reilly,D,NYI,31,82,7,15,22
91,8479976,Juuso Valimaki,D,UTA,26,82,7,15,22
91,8476525,Colin Miller,D,WPG,32,82,4,18,22
91,8476467,Jamie Oleksiak,D,SEA,32,82,4,18,22
91,8476429,Scott Mayfield,D,NYI,32,82,4,18,22
91,8477435,Ryan Graves,D,PIT,29,82,3,19,22
91,8481606,Jordan Spence,D,LAK,23,82,3,19,22
91,8483482,Tristan Luneau,D,ANA,20,82,3,19,22
91,8475188,Brayden McNabb,D,VGK,33,82,2,20,22
91,8482073,Braden Schneider,D,NYR,23,82,2,20,22
91,8474574,Tyler Myers,D,VAN,34,82,0,22,22
91,8481568,Alex Vlasic,D,CHI,23,82,0,22,22
91,8479368,Max Jones,L,BOS,26,82,14,7,21
91,8483397,Marc McLaughlin,C,BOS,25,82,14,7,21
91,8481093,Rafael Harvey-Pinard,L,MTL,25,82,13,8,21
91,8482809,Jackson Blake,R,CAR,21,82,7,14,21
91,8483445,Cutter Gauthier,L,ANA,20,82,5,16,21
91,8477499,Rasmus Ristolainen,D,PHI,30,82,5,16,21
91,8481567,Henry Thrun,D,SJS,23,82,5,16,21
91,8483565,Nick Blankenburg,D,NSH,26,82,4,17,21
91,8478840,Will Borgen,D,SEA,28,82,3,18,21
91,8470600,Ryan Suter,D,STL,39,82,3,18,21
91,8476879,Cody Ceci,D,EDM,31,82,3,18,21
91,8478416,Erik Cernak,D,TBL,27,82,3,18,21
91,8480144,David Kampf,C,TOR,29,82,3,18,21
91,8475455,Brenden Dillon,D,NJD,34,82,2,19,21
91,8475181,Nick Leddy,D,STL,33,82,1,20,21
91,8484145,Zach Benson,L,BUF,19,82,12,8,20
91,8476889,Radek Faksa,C,STL,30,82,11,9,20
91,8478211,Dryden Hunt,L,CGY,29,82,10,10,20
91,8477508,Curtis Lazar,C,NJD,29,82,6,14,20
91,8482807,Ethan Del Mastro,D,CHI,21,82,5,15,20
91,8480021,Jack Studnicka,C,LAK,25,82,5,15,20
91,8479369,Andrew Peeke,D,BOS,26,82,3,17,20
91,8475690,Chris Tanev,D,TOR,35,82,3,17,20
91,8479998,Mikey Anderson,D,LAK,25,82,2,18,20
91,8483468,Jiri Kulich,C,BUF,20,82,10,9,19
91,8483524,Shane Wright,C,SEA,20,82,9,10,19
91,8484911,Collin Graf,R,SJS,22,82,8,11,19
91,8480855,Jack McBain,C,UTA,24,82,7,12,19
91,8482516,Matthew Kessel,D,STL,24,82,7,12,19
91,8482762,Simon Edvinsson,D,DET,21,82,5,14,19
91,8483471,Brad Lambert,C,WPG,31,82,5,14,19
91,8478859,Niko Mikkola,D,FLA,28,82,4,15,19
91,8474013,Ian Cole,D,UTA,35,82,3,16,19
91,8480860,Kevin Bahl,D,CGY,24,82,1,18,19
91,8476967,Brett Kulak,D,EDM,30,82,1,18,19
91,8479414,Nathan Bastian,R,NJD,27,82,14,4,18
91,8482153,Brendan Brisson,C,VGK,23,82,9,9,18
91,8480222,Sebastian Aho,D,PIT,28,82,6,12,18
91,8480796,Martin Fehervary,D,WSH,25,82,5,13,18
91,8475790,Erik Gudbranson,D,CBJ,32,82,4,14,18
91,8478443,Brandon Carlo,D,BOS,28,82,3,15,18
91,8480049,Dylan Samberg,D,WPG,25,82,1,17,18
91,8475233,David Savard,D,MTL,34,82,1,17,18
91,8483505,Matthew Poitras,C,BOS,20,82,9,8,17
91,8479291,Kevin Rooney,C,CGY,31,82,9,8,17
91,8473453,Trevor Lewis,C,LAK,37,82,5,12,17
91,8475462,Radko Gudas,D,ANA,34,82,5,12,17
91,8479324,Ryan Lindgren,D,NYR,26,82,5,12,17
91,8477938,Haydn Fleury,D,WPG,28,82,5,12,17
91,8478136,Jake Middleton,D,MIN,28,82,4,13,17
91,8482712,Oskar Olausson,R,COL,22,82,4,13,17
91,8483466,Kevin Korchinski,D,CHI,20,82,4,13,17
91,8481708,Zac Jones,D,NYR,24,82,3,14,17
91,8475718,Justin Holl,D,DET,32,82,3,14,17
91,8482077,Dylan Holloway,L,EDM,23,82,10,6,16
91,8482101,Danil Gushchin,L,SJS,22,82,10,6,16
91,8476858,Phillip Di Giuseppe,L,VAN,31,82,9,7,16
91,8477505,Alexander Wennberg,C,SJS,30,82,7,9,16
91,8480043,Timothy Liljegren,D,TOR,25,82,6,10,16
91,8475177,Calvin de Haan,D,COL,33,82,3,13,16
91,8480950,Ilya Lyubushkin,D,DAL,30,82,3,13,16
91,8483763,Maksymilian Szuber,D,UTA,22,82,2,14,16
91,8482155,Alex Laferriere,R,LAK,23,82,8,7,15
91,8483567,Georgii Merkulov,C,BOS,24,82,7,8,15
91,8482659,Josh Doan,R,UTA,22,82,6,9,15
91,8481524,Bowen Byram,D,BUF,23,82,6,9,15
91,8482470,Ilya Solovyov,D,CGY,24,82,5,10,15
91,8476473,Connor Murphy,D,CHI,31,82,5,10,15
91,8471677,Jack Johnson,D,CBJ,37,82,3,12,15
91,8474612,Travis Hamonic,D,OTT,34,82,2,13,15
91,8475762,Derek Forbort,D,VAN,32,82,1,14,15
91,8481641,Joel Kiviranta,L,COL,28,82,9,5,14
91,8480870,Bo Groulx,C,NYR,24,82,9,5,14
91,8482679,Matt Coronato,R,CGY,22,82,6,8,14
91,8479442,Troy Stecher,D,EDM,30,82,5,9,14
91,8482145,Mavrik Bourque,C,DAL,22,82,4,10,14
91,8481122,Simon Benoit,D,TOR,26,82,3,11,14
91,8483460,David Jiricek,D,CBJ,21,82,3,11,14
91,8478399,Jonas Siegenthaler,D,NJD,27,82,2,12,14
91,8480879,Jacob Bernard-Docker,D,OTT,24,82,1,13,14
91,8482749,Joshua Roy,R,MTL,21,82,6,7,13
91,8482118,Sam Colangelo,R,ANA,23,82,4,9,13
91,8482859,Zack Ostapchuk,C,OTT,21,82,4,9,13
91,8480834,Ty Emberson,D,SJS,24,82,3,10,13
91,8474567,Zach Bogosian,D,MIN,34,82,2,11,13
91,8478450,Parker Wotherspoon,D,BOS,27,82,2,11,13
91,8481178,Egor Zamula,D,PHI,24,82,0,13,13
91,8477353,Tyler Motte,C,DET,29,82,6,6,12
91,8480980,Connor Dewar,C,TOR,25,82,5,7,12
91,8482733,Logan Mailloux,D,MTL,31,82,5,7,12
91,8483012,Logan Morrison,C,SEA,22,82,4,8,12
91,8483499,Liam Ohgren,L,MIN,20,82,3,9,12
91,8476372,Nick Seeler,D,PHI,31,82,3,9,12
91,8480990,Declan Chisholm,D,MIN,24,82,2,10,12
91,8480807,Mattias Samuelsson,D,BUF,24,82,2,10,12
91,8481605,Jackson LaCombe,D,ANA,23,82,5,6,11
91,8481699,Aku Raty,R,UTA,23,82,3,8,11
91,8479576,Vincent Desharnais,D,VAN,28,82,2,9,11
91,8477335,Kyle Burroughs,D,LAK,29,82,1,10,11
91,8476822,Luke Glendening,C,TBL,35,82,9,1,10
91,8479638,Justin Brazeau,R,BOS,26,82,5,5,10
91,8482787,Nikita Chibrikov,R,WPG,31,82,5,5,10
91,8482858,Ryker Evans,D,SEA,23,82,3,7,10
91,8474062,Riley Nash,C,NYR,35,82,2,8,10
91,8483489,Fraser Minten,C,TOR,31,82,3,6,9
91,8482713,Mackie Samoskevich,R,FLA,22,82,1,8,9
91,8477034,Jaycob Megna,D,FLA,32,82,0,9,9
91,8482070,Mitchell Chaffee,R,TBL,26,82,5,3,8
91,8474090,Brendan Smith,D,DAL,35,82,2,4,6
91,8476441,Joel Edmundson,D,LAK,31,82,1,5,6
91,8478874,Adam Gaudette,C,OTT,28,82,1,5,6
91,8470794,Joe Pavelski,C,,40,0,0,0,0
91,8481703,Valtteri Puustinen,R,PIT,25,0,0,0,0
91,8477950,Tony DeAngelo,D,,29,0,0,0,0
91,8481577,Philip Tomasino,C,NSH,23,0,0,0,0
91,8475197,Tyson Barrie,D,,33,0,0,0,0
91,8471218,Blake Wheeler,R,,38,0,0,0,0
91,8474157,Max Pacioretty,L,,36,0,0,0,0
91,8478466,Daniel Sprong,R,VAN,27,0,0,0,0
91,8475744,Evgeny Kuznetsov,C,,32,0,0,0,0
91,8481019,David Gustafsson,C,WPG,24,0,0,0,0
91,8475906,John Klingberg,D,,32,0,0,0,0
91,8479348,Kale Clague,D,BUF,26,0,0,0,0
91,8476952,Dominic Toninato,C,WPG,30,0,0,0,0
91,8473473,Milan Lucic,L,,36,0,0,0,0
91,8474037,James van Riemsdyk,L,,35,0,0,0,0
91,8474602,Justin Schultz,D,,34,0,0,0,0
91,8482222,Alexander Barabanov,L,,30,0,0,0,0
91,8479372,Josh Mahura,D,SEA,26,0,0,0,0
91,8479982,Conor Timmins,D,TOR,26,0,0,0,0
91,8474031,Kevin Shattenkirk,D,,35,0,0,0,0
91,8480008,Adam Ruzicka,C,,25,0,0,0,0
91,8481059,Scott Perunovich,D,STL,26,0,0,0,0
91,8480884,Calen Addison,D,,24,0,0,0,0
91,8476994,Vinnie Hinostroza,C,NSH,30,0,0,0,0
91,8478452,Caleb Jones,D,LAK,27,0,0,0,0
91,8480157,Calle Rosen,D,COL,30,0,0,0,0
91,8481609,Vladislav Kolyachonok,D,UTA,23,0,0,0,0
91,8479415,Michael McLeod,C,,26,0,0,0,0
91,8476919,Chris Tierney,C,,30,0,0,0,0
91,8479639,Dylan Coghlan,D,WPG,26,0,0,0,0
91,8478146,Matthew Highmore,C,OTT,28,0,0,0,0
91,8478970,Jalen Chatfield,D,CAR,28,0,0,0,0
91,8480205,Emil Bemstrom,C,PIT,25,0,0,0,0
91,8474884,Mike Hoffman,C,,35,0,0,0,0
91,8471274,Alex Goligoski,D,,39,0,0,0,0
91,8478104,Sammy Blais,L,,28,0,0,0,0
91,8474870,Tyler Johnson,C,,34,0,0,0,0
91,8476913,Devin Shore,C,MIN,30,0,0,0,0
91,8481598,Philip Broberg,D,EDM,23,0,0,0,0
91,8480058,Pierre-Olivier Joseph,D,STL,25,0,0,0,0
91,8480891,Michael Kesselring,D,UTA,24,0,0,0,0
91,8477979,Nicolas Aube-Kubel,R,BUF,28,0,0,0,0
91,8476871,Tanner Pearson,L,,32,0,0,0,0
91,8476393,Nick Cousins,C,,31,0,0,0,0
91,8479977,Kailer Yamamoto,R,,26,0,0,0,0
91,8479543,Michael Pezzetta,L,MTL,26,0,0,0,0
91,8477018,Ben Hutton,D,VGK,31,0,0,0,0
91,8480762,Eric Robinson,L,CAR,29,0,0,0,0
91,8474034,Pat Maroon,L,CHI,36,0,0,0,0
91,8481058,Jesse Ylönen,R,,25,0,0,0,0
91,8475179,Dmitry Kulikov,D,FLA,34,0,0,0,0
91,8481527,Kaedan Korczak,D,VGK,23,0,0,0,0
91,8473449,Kyle Okposo,R,,36,0,0,0,0
91,8482192,Isaak Phillips,D,CHI,23,0,0,0,0
91,8480727,Zach Whitecloud,D,VGK,28,0,0,0,0
91,8479346,Dillon Dube,C,,26,0,0,0,0
91,8480821,Filip Zadina,R,,25,0,0,0,0
91,8480001,Urho Vaakanainen,D,ANA,25,0,0,0,0
91,8470966,Mark Giordano,D,,41,0,0,0,0
91,8480853,Liam Foudy,C,,24,0,0,0,0
91,8475225,Craig Smith,C,CHI,35,0,0,0,0
91,8479972,Mason Shaw,C,WPG,26,0,0,0,0
91,8478451,Ethan Bear,D,WSH,27,0,0,0,0
91,8474040,Sam Gagner,C,,35,0,0,0,0
91,8480196,Jacob Bryson,D,BUF,27,0,0,0,0
91,8479984,Cal Foote,D,,26,0,0,0,0
91,8480011,Klim Kostin,C,SJS,25,0,0,0,0
91,8482176,Wyatt Kaiser,D,CHI,22,0,0,0,0
91,8476988,Matt Benning,D,SJS,30,0,0,0,0
91,8479370,Tyson Jost,C,CAR,26,0,0,0,0
91,8477464,Nic Petan,C,,29,0,0,0,0
91,8477380,Jonny Brodzinski,C,NYR,31,0,0,0,0
91,8480070,Ian Mitchell,D,BOS,25,0,0,0,0
91,8479315,Joey Anderson,R,CHI,26,0,0,0,0
91,8478099,Kevin Labanc,R,,29,0,0,0,0
91,8476874,Olli Maatta,D,DET,30,0,0,0,0
91,8475208,Brian Dumoulin,D,ANA,33,0,0,0,0
91,8478430,Oliver Kylington,D,,27,0,0,0,0
91,8479536,Axel Jonsson-Fjallby,L,WPG,26,0,0,0,0
91,8479671,Mathieu Olivier,R,CBJ,27,0,0,0,0
91,8471709,Marc-Edouard Vlasic,D,SJS,37,0,0,0,0
91,8479328,Julien Gauthier,R,NYI,27,0,0,0,0
91,8478421,A.J. Greer,L,FLA,28,0,0,0,0
91,8477573,Nathan Walker,L,STL,30,0,0,0,0
91,8481537,Nikita Okhotiuk,D,CGY,24,0,0,0,0
91,8474166,Alec Martinez,D,CHI,37,0,0,0,0
91,8470610,Zach Parise,L,,40,0,0,0,0
91,8477478,William Carrier,L,CAR,30,0,0,0,0
91,8479344,Jesse Puljujarvi,R,PIT,26,0,0,0,0
91,8480887,Jordan Harris,D,MTL,24,0,0,0,0
91,8478502,Dennis Gilbert,D,BUF,28,0,0,0,0
91,8482730,Brandt Clarke,D,LAK,21,0,0,0,0
91,8480355,Mark Kastelic,C,BOS,25,0,0,0,0
91,8475750,Jon Merrill,D,MIN,32,0,0,0,0
91,8475164,Jakob Silfverberg,R,,34,0,0,0,0
91,8477944,Jakub Vrana,L,,28,0,0,0,0
91,8479439,Jacob MacDonald,D,COL,31,0,0,0,0
91,8474568,Luke Schenn,D,NSH,35,0,0,0,0
91,8478454,Noah Juulsen,D,VAN,27,0,0,0,0
91,8475752,Tyler Pitlick,C,,33,0,0,0,0
91,8482148,Hendrix Lapierre,C,WSH,22,0,0,0,0
91,8481167,Brayden Pachal,D,CGY,25,0,0,0,0
91,8478043,Sam Lafferty,C,BUF,29,0,0,0,0
91,8479321,Lucas Johansen,D,,27,0,0,0,0
91,8471699,Andrew Cogliano,C,,37,0,0,0,0
91,8481521,Ronnie Attard,D,PHI,25,0,0,0,0
91,8481161,Jake Christiansen,D,CBJ,25,0,0,0,0
91,8479458,Nikita Zaitsev,D,,33,0,0,0,0
91,8479619,Michael Carcone,L,UTA,28,0,0,0,0
91,8479026,Philippe Myers,D,TOR,27,0,0,0,0
91,8477330,Dominik Kubalik,L,,29,0,0,0,0
91,8481617,Vasily Podkolzin,R,VAN,23,0,0,0,0
91,8481701,Santeri Hatakka,D,NJD,23,0,0,0,0
91,8479514,Rem Pitlick,C,,27,0,0,0,0
91,8477446,Michael McCarron,R,NSH,29,0,0,0,0
91,8470604,Jeff Carter,C,,39,0,0,0,0
91,8482241,Radim Zohorna,L,,28,0,0,0,0
91,8480289,Morgan Barron,C,WPG,26,0,0,0,0
91,8479379,Givani Smith,R,SJS,26,0,0,0,0
91,8480216,Jacob Peterson,C,,25,0,0,0,0
91,8477851,Jordan Oesterle,D,BOS,32,0,0,0,0
91,8484258,Sam Malinski,D,COL,26,0,0,0,0
91,8478904,Steven Lorentz,C,,28,0,0,0,0
91,8482095,Tyler Kleven,D,OTT,22,0,0,0,0
91,8480848,Ty Dellandrea,C,SJS,24,0,0,0,0
91,8476884,Derrick Pouliot,D,,30,0,0,0,0
91,8479336,Carl Grundstrom,R,SJS,27,0,0,0,0
91,8482964,Arber Xhekaj,D,MTL,23,0,0,0,0
91,8471686,Marc Staal,D,,37,0,0,0,0
91,8477887,Patrick Brown,C,BOS,32,0,0,0,0
91,8478495,Denis Gurianov,R,,27,0,0,0,0
91,8473504,Cal Clutterbuck,R,,37,0,0,0,0
91,8481550,Adam Beckman,L,NJD,23,0,0,0,0
91,8480845,Rasmus Kupari,C,WPG,24,0,0,0,0
91,8474009,Nick Bonino,C,,36,0,0,0,0
91,8478585,Derek Ryan,C,EDM,38,0,0,0,0
91,8477962,Brendan Lemieux,L,CAR,28,0,0,0,0
91,8482861,Vincent Iorio,D,WSH,22,0,0,0,0
91,8479378,Logan Stanley,D,WPG,26,0,0,0,0
91,8473446,Erik Johnson,D,PHI,36,0,0,0,0
91,8481743,Marc Del Gaizo,D,NSH,25,0,0,0,0
91,8477384,Josh Brown,D,EDM,30,0,0,0,0
91,8482165,Yan Kuznetsov,D,CGY,22,0,0,0,0
91,8478424,Jansen Harkins,C,ANA,27,0,0,0,0
91,8482144,Jack Thompson,D,SJS,22,0,0,0,0
91,8478512,Austin Czarnik,C,,32,0,0,0,0
91,8477527,Ross Johnston,L,ANA,30,0,0,0,0
91,8479383,Boris Katchouk,L,,26,0,0,0,0
91,8482094,Daemon Hunt,D,MIN,22,0,0,0,0
91,8481719,Maxwell Crozier,D,TBL,24,0,0,0,0
91,8480192,Johnathan Kovacevic,D,NJD,27,0,0,0,0
91,8479376,Victor Mete,D,,26,0,0,0,0
91,8482511,Mason Lohrei,D,BOS,23,0,0,0,0
91,8475825,Jani Hakanpää,D,,32,0,0,0,0
91,8478021,William Lagesson,D,DET,28,0,0,0,0
91,8475795,Dylan McIlrath,D,WSH,32,0,0,0,0
91,8477846,Ryan Carpenter,C,,33,0,0,0,0
91,8481056,Spencer Stastney,D,NSH,24,0,0,0,0
91,8481564,Ryan Johnson,D,BUF,23,0,0,0,0
91,8478017,Mark Friedman,D,VAN,29,0,0,0,0
91,8479320,Max Lajoie,D,SEA,27,0,0,0,0
91,8480075,Cameron Crotty,D,MIN,25,0,0,0,0
91,8484287,Cole McWard,D,VAN,23,0,0,0,0
91,8484254,Akito Hirose,D,VAN,25,0,0,0,0
91,8483407,Brandon Scanlin,D,NYR,25,0,0,0,0
91,8480274,Philip Kemp,D,EDM,25,0,0,0,0
91,8479522,Hardy Haman Aktell,D,WSH,26,0,0,0,0
91,8480007,Jonas Rondbjerg,R,VGK,25,0,0,0,0
91,8477454,Adam Erne,L,,29,0,0,0,0
91,8481679,Maxence Guenette,D,OTT,23,0,0,0,0
91,8480441,Trey Fix-Wolansky,R,CBJ,25,0,0,0,0
91,8483546,Marshall Rifai,D,TOR,26,0,0,0,0
91,8480084,Nick DeSimone,D,NJD,30,0,0,0,0
91,8481030,Jack St. Ivany,D,PIT,25,0,0,0,0
91,8481592,Jakob Pelletier,L,CGY,23,0,0,0,0
91,8478011,Louie Belpedio,D,PHI,28,0,0,0,0
91,8477930,Pierre-Edouard Bellemare,L,,39,0,0,0,0
91,8484321,Nikolas Matinpalo,D,OTT,26,0,0,0,0
91,8482067,Connor Mackey,D,NYR,28,0,0,0,0
91,8481806,Louis Crevier,D,CHI,23,0,0,0,0
91,8484326,Patrik Koch,D,UTA,28,0,0,0,0
91,8477971,Andreas Englund,D,LAK,28,0,0,0,0
91,8481751,Lukas Rousek,R,BUF,25,0,0,0,0
91,8481006,Tyler Tucker,D,STL,24,0,0,0,0
91,8476867,Brendan Gaunce,C,MIN,30,0,0,0,0
91,8479520,Brandon Duhaime,R,WSH,27,0,0,0,0
91,8477073,Kurtis MacDermid,L,NJD,30,0,0,0,0
91,8480874,Adam Ginning,D,PHI,24,0,0,0,0
91,8477473,Justin Bailey,R,SJS,29,0,0,0,0
91,8479066,Ryan Lomberg,L,CGY,30,0,0,0,0
91,8477070,Liam O'Brien,C,UTA,30,0,0,0,0
91,8474618,Marco Scandella,D,,34,0,0,0,0
91,8475797,Jarred Tinordi,D,,32,0,0,0,0
91,8481441,Joe Snively,C,DET,28,0,0,0,0
91,8477244,Chad Ruhwedel,D,NYR,34,0,0,0,0
91,8479772,Zack MacEwen,R,OTT,28,0,0,0,0
91,8481147,Reese Johnson,C,MIN,26,0,0,0,0
91,8481043,Cole Koepke,L,BOS,26,0,0,0,0
91,8483619,Filip Roos,D,OTT,25,0,0,0,0
91,8481541,Samuel Bolduc,D,NYI,24,0,0,0,0
91,8477810,Joel Hanley,D,CGY,33,0,0,0,0
91,8476907,Mackenzie MacEachern,L,,30,0,0,0,0
91,8482652,Walker Duehr,R,CGY,27,0,0,0,0
91,8477126,Jayson Megna,C,,34,0,0,0,0
91,8483398,Declan Carlile,D,TBL,31,0,0,0,0
91,8482929,Emil Lilleberg,D,TBL,23,0,0,0,0
91,8480880,Jakub Lauko,C,MIN,24,0,0,0,0
91,8480245,Olle Lycksell,R,PHI,25,0,0,0,0
91,8480252,Cole Guttman,C,CHI,25,0,0,0,0
91,8477467,Gustav Olofsson,D,SEA,30,0,0,0,0
91,8479968,Vinni Lettieri,C,BOS,29,0,0,0,0
91,8478400,Colin White,C,,27,0,0,0,0
91,8475755,Alexander Petrovic,D,DAL,32,0,0,0,0
91,8481812,Nikolai Knyzhov,D,,27,0,0,0,0
91,8481593,Jayden Struble,D,MTL,23,0,0,0,0
91,8481532,Alex Turcotte,C,LAK,23,0,0,0,0
91,8482126,Emil Andrae,D,PHI,31,0,0,0,0
91,8479944,Zach Aston-Reese,C,VGK,30,0,0,0,0
91,8471817,Ryan Reaves,R,TOR,37,0,0,0,0
91,8481206,John Ludvig,D,PIT,24,0,0,0,0
91,8481599,Victor Soderstrom,D,UTA,23,0,0,0,0
91,8480292,Carson Meyer,R,ANA,27,0,0,0,0
91,8482496,Nils Aman,C,VAN,24,0,0,0,0
91,8479718,Alex Barré-Boulet,C,MTL,27,0,0,0,0
91,8479994,Jaret Anderson-Dolan,C,WPG,25,0,0,0,0
91,8480184,Gustav Lindstrom,D,,26,0,0,0,0
91,8480890,Jan Jenik,R,OTT,24,0,0,0,0
91,8478067,Oskar Lindblom,L,,28,0,0,0,0
91,8476934,Brock McGinn,L,ANA,30,0,0,0,0
91,8479985,Cale Fleury,D,SEA,26,0,0,0,0
91,8484304,Uvis Balinskis,D,FLA,28,0,0,0,0
91,8479981,Jonah Gadjovich,L,FLA,26,0,0,0,0
91,8481716,Dmitri Voronkov,L,CBJ,24,0,0,0,0
91,8474709,Matt Martin,L,,35,0,0,0,0
91,8482634,Alex Steeves,C,TOR,25,0,0,0,0
91,8480823,Alexander Alexeyev,D,WSH,25,0,0,0,0
91,8477541,Dakota Mermis,D,TOR,30,0,0,0,0
91,8483491,Ivan Miroshnichenko,L,WSH,20,0,0,0,0
91,8478477,Mitchell Stephens,C,SEA,27,0,0,0,0
91,8481543,Nikita Alexandrov,C,STL,24,0,0,0,0
91,8479423,Alex Nylander,L,,26,0,0,0,0
91,8482451,Mikael Pyyhtia,L,CBJ,23,0,0,0,0
91,8478831,Kevin Stenlund,C,UTA,28,0,0,0,0
91,8480306,Grant Hutton,D,NYI,29,0,0,0,0
91,8478028,Fredrik Olofsson,L,,28,0,0,0,0
91,8477462,Robert Hagg,D,VGK,29,0,0,0,0
91,8477320,Anton Blidh,L,NYR,29,0,0,0,0
91,8482157,Will Cuylle,L,NYR,22,0,0,0,0
91,8482737,Zack Bolduc,C,STL,21,0,0,0,0
91,8481239,Samuel Fagemo,L,,24,0,0,0,0
91,8481600,Tobias Bjornfot,D,FLA,23,0,0,0,0
91,8478409,Anthony Richard,C,PHI,28,0,0,0,0
91,8474145,Robert Bortuzzo,D,,35,0,0,0,0
91,8475958,Michael Sgarbossa,C,WSH,32,0,0,0,0
91,8479986,Kole Lind,R,DAL,26,0,0,0,0
91,8479249,Andrew Poturalski,C,SJS,30,0,0,0,0
91,8479362,Riley Tufte,L,BOS,26,0,0,0,0
91,8479991,Jake Leschyshyn,C,NYR,25,0,0,0,0
91,8479587,Rhett Gardner,C,PHI,28,0,0,0,0
91,8482744,James Malatesta,L,CBJ,21,0,0,0,0
91,8478854,Ryan Shea,D,PIT,27,0,0,0,0
91,8481591,Sam Poulin,R,,23,0,0,0,0
91,8483512,Matt Savoie,C,EDM,20,0,0,0,0
91,8482102,Vasily Ponomarev,C,PIT,22,0,0,0,0
91,8482162,Roby Jarventie,L,EDM,22,0,0,0,0
91,8481016,Ruslan Iskhakov,C,,24,0,0,0,0
91,8482172,Landon Slaggert,L,CHI,22,0,0,0,0
91,8482747,Brennan Othmann,L,NYR,21,0,0,0,0
91,8480031,Maxime Comtois,L,,25,0,0,0,0
91,8480226,Marián Studenic,R,,26,0,0,0,0
91,8478408,Travis Dermott,D,,28,0,0,0,0
91,8481518,Nolan Foote,L,NJD,24,0,0,0,0
91,8479419,Brett Murray,L,BUF,26,0,0,0,0
91,8482088,Justin Sourdif,R,FLA,22,0,0,0,0
91,8482201,Gage Goncalves,C,TBL,23,0,0,0,0
91,8481578,Graeme Clarke,R,MIN,23,0,0,0,0
91,8482177,Marat Khusnutdinov,C,MIN,22,0,0,0,0
91,8481754,Nikita Nesterenko,C,ANA,23,0,0,0,0
91,8483531,Brian Halonen,L,NJD,25,0,0,0,0
91,8483920,Pierrick Dube,R,WSH,23,0,0,0,0
91,8480851,Akil Thomas,C,LAK,24,0,0,0,0
91,8475235,Nicolas Deslauriers,L,PHI,33,0,0,0,0
91,8482476,Emil Heineman,L,MTL,23,0,0,0,0
91,8477149,Scott Sabourin,R,SJS,32,0,0,0,0
91,8483549,Lucas Condotta,L,MTL,27,0,0,0,0
91,8482765,Isak Rosen,R,BUF,21,0,0,0,0
91,8481237,Kyle MacLean,C,NYI,25,0,0,0,0
91,8481024,Linus Karlsson,C,VAN,25,0,0,0,0
91,8481690,Tyler Angle,C,,24,0,0,0,0
91,8483570,Ben Meyers,C,SEA,26,0,0,0,0
91,8481655,Cole Schwindt,R,CGY,23,0,0,0,0
91,8481462,Mason Morelli,L,VGK,28,0,0,0,0
91,8483401,Marc Johnstone,R,PIT,28,0,0,0,0
91,8478956,Samuel Laberge,L,NJD,27,0,0,0,0
91,8479533,Joona Koppanen,L,,26,0,0,0,0
91,8482197,Adam Raska,R,MIN,23,0,0,0,0
91,8482250,Callahan Burke,C,VGK,27,0,0,0,0
91,8482784,Zach Dean,C,STL,21,0,0,0,0
91,8484255,Jason Polin,R,COL,25,0,0,0,0
91,8481077,John Leonard,L,,26,0,0,0,0
91,8481534,Raphael Lavoie,C,EDM,24,0,0,0,0
91,8483609,Adam Klapka,R,CGY,24,0,0,0,0
91,8482751,Ryan Winterton,C,SEA,21,0,0,0,0
91,8480267,Sammy Walker,C,MIN,25,0,0,0,0
91,8475766,Austin Watson,L,,32,0,0,0,0
91,8482460,Matt Rempe,C,NYR,22,0,0,0,0
91,8481065,Angus Crookshank,L,OTT,25,0,0,0,0
91,8481070,Hugh McGing,L,,26,0,0,0,0
91,8476323,Max McCormick,L,SEA,32,0,0,0,0
91,8483395,Arshdeep Bains,L,VAN,23,0,0,0,0
91,8484259,Ondrej Pavel,C,COL,31,0,0,0,0
91,8483432,Luca Del Bel Belluz,C,CBJ,31,0,0,0,0
91,8483045,Cameron Butler,R,CBJ,31,0,0,0,0
91,8482061,Brandon Biro,L,SEA,26,0,0,0,0
91,8477401,John Hayden,C,SEA,29,0,0,0,0
91,8475278,Byron Froese,C,,33,0,0,0,0
91,8478446,Glenn Gawdin,C,LAK,27,0,0,0,0
91,8477993,Justin Kirkland,C,CGY,28,0,0,0,0
91,8482147,Jean-Luc Foudy,C,COL,22,0,0,0,0
91,8480032,Shane Bowers,C,NJD,25,0,0,0,0
91,8479330,Brandon Gignac,C,MTL,27,0,0,0,0
91,8480776,Sheldon Rempal,R,,29,0,0,0,0
91,8475413,Justin Dowling,C,NJD,34,0,0,0,0
91,8481726,Adam Edstrom,C,NYR,24,0,0,0,0
91,8480844,Grigori Denisenko,L,VGK,24,0,0,0,0
91,8478147,Bokondji Imama,L,PIT,28,0,0,0,0
91,8478881,Brett Seney,L,CHI,28,0,0,0,0
91,8483630,Pavol Regenda,L,ANA,25,0,0,0,0
91,8480836,Jonathan Gruden,C,,24,0,0,0,0
91,8484314,Jiri Smejkal,L,,28,0,0,0,0
91,8475780,Chris Wagner,R,COL,33,0,0,0,0
91,8479546,Oskar Steen,C,,26,0,0,0,0
91,8483597,Milos Kelemen,L,UTA,25,0,0,0,0
91,8481789,Tye Kartye,L,SEA,23,0,0,0,0
91,8484325,Waltteri Merela,C,TBL,26,0,0,0,0
91,8479421,Jacob Moverare,D,LAK,26,0,0,0,0
91,8481585,Egor Afanasyev,L,SJS,23,0,0,0,0
91,8479547,Matthew Phillips,R,,26,0,0,0,0
91,8479367,William Lockwood,R,FLA,26,0,0,0,0
91,8476915,Jujhar Khaira,L,,30,0,0,0,0
91,8481422,Jacob Lucchini,C,NSH,29,0,0,0,0
91,8480468,James Hamblin,L,EDM,25,0,0,0,0
91,8478051,Max Willman,C,NJD,29,0,0,0,0
91,8481556,John Beecher,C,BOS,23,0,0,0,0
91,8478078,Rourke Chartier,C,,28,0,0,0,0
92,8476453,Nikita Kucherov,R,TBL,31,82,50,104,154
92,8479318,Auston Matthews,C,TOR,27,82,77,73,150
92,8478402,Connor McDavid,C,EDM,27,82,50,98,148
92,8477492,Nathan MacKinnon,C,COL,29,82,61,86,147
92,8481559,Jack Hughes,C,NJD,23,82,54,79,133
92,8477956,David Pastrnak,R,BOS,28,82,51,69,120
92,8480012,Elias Pettersson,C,VAN,26,82,44,67,111
92,8478864,Kirill Kaprizov,L,MIN,27,82,48,62,110
92,8478403,Jack Eichel,C,VGK,28,82,46,64,110
92,8477934,Leon Draisaitl,C,EDM,29,82,35,72,107
92,8477939,William Nylander,R,TOR,28,82,49,57,106
92,8479314,Matthew Tkachuk,L,FLA,27,82,42,61,103
92,8478420,Mikko Rantanen,R,COL,28,82,39,63,102
92,8475172,Nazem Kadri,C,CGY,34,82,41,60,101
92,8477946,Dylan Larkin,C,DET,28,82,48,52,100
92,8481557,Matt Boldy,L,MIN,23,82,33,66,99
92,8480069,Cale Makar,D,COL,26,82,18,81,99
92,8480027,Jason Robertson,L,DAL,25,82,36,60,96
92,8477933,Sam Reinhart,C,FLA,29,82,51,43,94
92,8482116,Tim Stützle,C,OTT,22,82,33,61,94
92,8479407,Jesper Bratt,L,NJD,26,82,29,65,94
92,8477409,Carter Verhaeghe,C,FLA,29,82,43,49,92
92,8477404,Jake Guentzel,C,TBL,30,82,42,50,92
92,8475166,John Tavares,C,TOR,34,82,40,51,91
92,8474564,Steven Stamkos,C,NSH,34,82,32,59,91
92,8478427,Sebastian Aho,C,CAR,27,82,39,51,90
92,8480036,Miro Heiskanen,D,DAL,25,82,15,75,90
92,8471675,Sidney Crosby,C,PIT,37,82,24,65,89
92,8477942,Kevin Fiala,L,LAK,28,82,28,60,88
92,8475913,Mark Stone,R,VGK,32,82,35,52,87
92,8477493,Aleksander Barkov,C,FLA,29,82,30,57,87
92,8476887,Filip Forsberg,L,NSH,30,82,41,45,86
92,8479420,Tage Thompson,C,BUF,27,82,51,34,85
92,8477949,Alex Tuch,R,BUF,28,82,31,54,85
92,8478445,Mathew Barzal,C,NYI,27,82,19,66,85
92,8476881,Tomas Hertl,C,VGK,31,82,40,44,84
92,8476468,J.T. Miller,C,VAN,31,82,29,55,84
92,8479323,Adam Fox,D,NYR,26,82,11,73,84
92,8478042,Viktor Arvidsson,R,EDM,31,82,37,45,82
92,8480208,Drake Batherson,R,OTT,26,82,39,42,81
92,8479343,Clayton Keller,R,UTA,26,82,38,43,81
92,8471215,Evgeni Malkin,C,PIT,38,82,34,47,81
92,8479337,Alex DeBrincat,R,DET,27,82,28,53,81
92,8476456,Jonathan Huberdeau,C,CGY,31,82,27,54,81
92,8478550,Artemi Panarin,L,NYR,33,82,25,56,81
92,8481523,Kirby Dach,C,MTL,23,82,20,61,81
92,8477955,Jared McCann,L,SEA,28,82,40,40,80
92,8480023,Robert Thomas,C,STL,25,82,24,56,80
92,8473419,Brad Marchand,L,BOS,36,82,35,44,79
92,8479385,Jordan Kyrou,C,STL,26,82,34,45,79
92,8480830,Andrei Svechnikov,R,CAR,24,82,28,51,79
92,8478439,Travis Konecny,R,PHI,27,82,28,51,79
92,8480801,Brady Tkachuk,L,OTT,25,82,28,50,78
92,8480800,Quinn Hughes,D,VAN,25,82,16,62,78
92,8478010,Brayden Point,C,TBL,28,82,42,35,77
92,8476389,Vincent Trocheck,C,NYR,31,82,39,38,77
92,8478449,Roope Hintz,C,DAL,28,82,37,39,76
92,8478444,Brock Boeser,R,VAN,27,82,30,46,76
92,8474600,Roman Josi,D,NSH,34,82,27,49,76
92,8476853,Morgan Rielly,D,TOR,30,82,10,66,76
92,8479339,Patrik Laine,L,CBJ,26,82,37,37,74
92,8475784,Jeff Skinner,C,EDM,32,82,27,47,74
92,8475692,Mats Zuccarello,R,MIN,37,82,19,55,74
92,8476346,Johnny Gaudreau,L,CBJ,31,82,17,57,74
92,8480803,Evan Bouchard,D,EDM,25,82,15,59,74
92,8480002,Nico Hischier,C,NJD,25,82,33,40,73
92,8479325,Charlie McAvoy,D,BOS,27,82,16,57,73
92,8476454,Ryan Nugent-Hopkins,C,EDM,31,82,28,44,72
92,8476459,Mika Zibanejad,C,NYR,31,82,27,45,72
92,8477986,Brandon Montour,D,SEA,30,82,23,49,72
92,8478440,Dylan Strome,C,WSH,27,82,23,49,72
92,8480865,Noah Dobson,D,NYI,24,82,12,60,72
92,8478414,Timo Meier,R,NJD,28,82,37,34,71
92,8477476,Artturi Lehkonen,L,COL,29,82,34,37,71
92,8477951,Nick Schmaltz,C,UTA,28,82,30,41,71
92,8471685,Anze Kopitar,C,LAK,37,82,29,42,71
92,8473512,Claude Giroux,R,OTT,36,82,23,48,71
92,8475798,Mikael Granlund,C,SJS,32,82,15,56,71
92,8475810,Bryan Rust,R,PIT,32,82,34,36,70
92,8474578,Erik Karlsson,D,PIT,34,82,20,50,70
92,8478498,Jake DeBrusk,L,VAN,28,82,40,29,69
92,8477501,Valeri Nichushkin,R,COL,29,82,35,34,69
92,8477940,Nikolaj Ehlers,L,WPG,28,82,30,39,69
92,8478873,Troy Terry,R,ANA,27,82,27,42,69
92,8475786,Zach Hyman,L,EDM,32,82,34,34,68
92,8479675,Trevor Moore,L,LAK,29,82,29,39,68
92,8473994,Jamie Benn,L,DAL,35,82,22,46,68
92,8475167,Victor Hedman,D,TBL,34,82,17,51,68
92,8482093,Seth Jarvis,C,CAR,22,82,36,31,67
92,8477960,Adrian Kempe,R,LAK,28,82,35,32,67
92,8477500,Bo Horvat,C,NYI,29,82,34,33,67
92,8476448,William Karlsson,C,VGK,31,82,31,36,67
92,8477416,Oliver Bjorkstrand,R,SEA,29,82,26,41,67
92,8477402,Pavel Buchnevich,L,STL,29,82,25,42,67
92,8481533,Trevor Zegras,C,ANA,23,82,24,43,67
92,8479542,Brandon Hagel,L,TBL,26,82,30,36,66
92,8475726,Tyler Toffoli,C,SJS,32,82,27,39,66
92,8477497,Sean Monahan,C,CBJ,30,82,24,42,66
92,8476462,Dougie Hamilton,D,NJD,31,82,17,49,66
92,8480839,Rasmus Dahlin,D,BUF,24,82,16,50,66
92,8478460,Zach Werenski,D,CBJ,27,82,15,51,66
92,8477447,Shea Theodore,D,VGK,29,82,14,51,65
92,8475184,Chris Kreider,L,NYR,33,82,42,21,63
92,8483808,Andrei Kuzmenko,L,CGY,28,82,34,29,63
92,8474141,Patrick Kane,R,DET,36,82,29,34,63
92,8478398,Kyle Connor,L,WPG,28,82,27,36,63
92,8478047,Michael Bunting,L,PIT,29,82,22,41,63
92,8477503,Max Domi,C,TOR,29,82,20,43,63
92,8482745,Mason McTavish,C,ANA,21,82,35,27,62
92,8478493,Joel Eriksson Ek,C,MIN,27,82,25,37,62
92,8480018,Nick Suzuki,C,MTL,25,82,25,37,62
92,8478401,Pavel Zacha,C,BOS,27,82,25,37,62
92,8476880,Tom Wilson,R,WSH,30,82,32,29,61
92,8476539,Jonathan Marchessault,R,NSH,34,82,31,30,61
92,8480039,Martin Necas,C,CAR,25,82,29,32,61
92,8478038,Devon Toews,D,COL,30,82,21,40,61
92,8471724,Kris Letang,D,PIT,37,82,11,50,61
92,8482699,Dylan Guenther,R,UTA,21,82,38,22,60
92,8475169,Evander Kane,L,EDM,33,82,33,27,60
92,8475158,Ryan O'Reilly,C,NSH,33,82,19,41,60
92,8474565,Alex Pietrangelo,D,VGK,34,82,10,49,59
92,8476432,Boone Jenner,C,CBJ,31,82,31,27,58
92,8477496,Elias Lindholm,C,BOS,30,82,27,31,58
92,8478366,Frank Vatrano,R,ANA,30,82,26,32,58
92,8482078,Lucas Raymond,L,DET,22,82,26,32,58
92,8475765,Vladimir Tarasenko,R,DET,33,82,26,32,58
92,8474102,David Perron,L,OTT,36,82,21,37,58
92,8474150,Mikael Backlund,C,CGY,35,82,17,41,58
92,8476905,Chandler Stephenson,C,SEA,30,82,15,43,58
92,8478397,Rasmus Andersson,D,CGY,28,82,11,47,58
92,8478407,Vince Dunn,D,SEA,28,82,7,51,58
92,8475754,Brock Nelson,C,NYI,33,82,32,25,57
92,8476483,Rickard Rakell,R,PIT,31,82,26,31,57
92,8474586,Jordan Eberle,R,SEA,34,82,23,34,57
92,8477451,Ryan Hartman,R,MIN,30,82,22,35,57
92,8475168,Matt Duchene,C,DAL,33,82,20,37,57
92,8474679,Gustav Nyquist,C,NSH,35,82,16,41,57
92,8474563,Drew Doughty,D,LAK,35,82,14,43,57
92,8476875,Mike Matheson,D,MTL,30,82,9,48,57
92,8477504,Josh Morrissey,D,WPG,29,82,7,50,57
92,8478856,Conor Garland,R,VAN,28,82,29,27,56
92,8476460,Mark Scheifele,C,WPG,31,82,25,31,56
92,8477346,MacKenzie Weegar,D,CGY,30,82,15,41,56
92,8473986,Alex Killorn,L,ANA,35,82,29,26,55
92,8478975,Mason Marchment,L,DAL,29,82,24,31,55
92,8475170,Brayden Schenn,C,STL,33,82,22,33,55
92,8482124,Quinton Byfield,R,LAK,22,82,22,33,55
92,8481528,Dylan Cozens,C,BUF,23,82,21,34,55
92,8478458,Jack Roslovic,C,CAR,27,82,14,41,55
92,8477426,Nicholas Paul,L,TBL,29,82,32,22,54
92,8482159,Tyson Foerster,R,PHI,22,82,27,27,54
92,8475794,Tyler Seguin,C,DAL,32,82,25,29,54
92,8477494,Jonathan Drouin,L,COL,29,82,16,38,54
92,8474590,John Carlson,D,WSH,34,82,14,40,54
92,8478469,Thomas Chabot,D,OTT,27,82,10,44,54
92,8476792,Torey Krug,D,STL,33,82,9,45,54
92,8478462,Nicolas Roy,C,VGK,27,82,21,32,53
92,8477964,Ivan Barbashev,C,VGK,29,82,19,34,53
92,8479425,Filip Hronek,D,VAN,27,82,7,46,53
92,8480064,Josh Norris,C,OTT,25,82,28,24,52
92,8478233,Andrew Mangiapane,L,WSH,28,82,27,25,52
92,8482665,Matty Beniers,C,SEA,22,82,21,31,52
92,8479999,Casey Mittelstadt,C,COL,26,82,17,35,52
92,8480185,Eetu Luostarinen,C,FLA,26,82,17,35,52
92,8482740,Wyatt Johnston,C,DAL,21,82,30,21,51
92,8475799,Nino Niederreiter,R,WPG,32,82,28,23,51
92,8481540,Cole Caufield,R,MTL,23,82,27,24,51
92,8478438,Tommy Novak,C,NSH,27,82,25,26,51
92,8475151,Kyle Palmieri,C,NYI,33,82,25,26,51
92,8475191,Reilly Smith,R,NYR,33,82,25,26,51
92,8477407,Anthony Duclair,L,NYI,29,82,25,26,51
92,8482149,Cole Perfetti,C,WPG,22,82,20,31,51
92,8475745,Charlie Coyle,C,BOS,32,82,17,34,51
92,8476869,Brady Skjei,D,NSH,30,82,16,35,51
92,8479410,Mikhail Sergachev,D,UTA,26,82,3,48,51
92,8482175,JJ Peterka,R,BUF,22,82,32,18,50
92,8482110,Dawson Mercer,C,NJD,23,82,27,23,50
92,8476399,Blake Coleman,C,CGY,33,82,25,25,50
92,8474641,Adam Henrique,C,EDM,34,82,24,26,50
92,8471214,Alex Ovechkin,L,WSH,39,82,22,28,50
92,8476882,Teuvo Teravainen,L,CHI,30,82,22,28,50
92,8482667,William Eklund,L,SJS,22,82,19,31,50
92,8476854,Hampus Lindholm,D,BOS,30,82,7,43,50
92,8480014,Gabriel Vilardi,C,WPG,25,82,30,19,49
92,8477511,Anthony Mantha,R,CGY,30,82,22,27,49
92,8478472,Mathieu Joseph,R,STL,27,82,17,32,49
92,8476872,Scott Laughton,C,PHI,30,82,16,33,49
92,8476479,Phillip Danault,C,LAK,31,82,14,35,49
92,8478396,Noah Hanifin,D,VGK,27,82,12,37,49
92,8474053,Logan Couture,C,SJS,35,82,23,25,48
92,8478046,Danton Heinen,L,VAN,29,82,23,25,48
92,8481711,Matias Maccelli,L,UTA,24,82,21,27,48
92,8480797,Joel Farabee,L,PHI,24,82,17,31,48
92,8475753,Justin Faulk,D,STL,32,82,15,33,48
92,8477429,Andrew Copp,C,DET,30,82,14,34,48
92,8481618,Alex Newhook,C,MTL,23,82,25,22,47
92,8477998,Warren Foegele,L,LAK,28,82,23,24,47
92,8475722,Jason Zucker,L,BUF,32,82,22,25,47
92,8480829,Jesperi Kotkaniemi,C,CAR,24,82,21,26,47
92,8482475,Yegor Chinakhov,R,CBJ,23,82,21,26,47
92,8480188,Fabian Zetterlund,L,SJS,25,82,20,27,47
92,8470613,Brent Burns,D,CAR,39,82,11,36,47
92,8481542,Moritz Seider,D,DET,23,82,7,40,47
92,8478463,Anthony Beauvillier,L,PIT,27,82,25,21,46
92,8482092,Ridly Greig,C,OTT,22,82,23,23,46
92,8480009,Eeli Tolvanen,R,SEA,25,82,23,23,46
92,8477935,Sam Bennett,C,FLA,28,82,22,24,46
92,8479400,Pierre-Luc Dubois,L,WSH,26,82,21,25,46
92,8482146,Luke Evangelista,R,NSH,22,82,18,28,46
92,8476392,Adam Lowry,C,WPG,31,82,17,29,46
92,8476906,Shayne Gostisbehere,D,CAR,31,82,15,31,46
92,8482113,Anton Lundell,C,FLA,23,82,13,33,46
92,8479345,Jakob Chychrun,D,WSH,26,82,13,33,46
92,8481068,Yegor Sharangovich,C,CGY,26,82,22,23,45
92,8478519,Anthony Cirelli,C,TBL,27,82,20,25,45
92,8482705,Cole Sillinger,C,CBJ,21,82,18,27,45
92,8476419,Jean-Gabriel Pageau,C,NYI,32,82,18,27,45
92,8482097,Jack Quinn,R,BUF,23,82,16,29,45
92,8475287,Erik Haula,L,NJD,33,82,16,29,45
92,8480078,Filip Chytil,C,NYR,25,82,13,32,45
92,8480028,Morgan Frost,C,PHI,25,82,12,33,45
92,8476458,Ryan Strome,C,ANA,31,82,10,35,45
92,8482684,Luke Hughes,D,NJD,21,82,7,38,45
92,8482055,Drew O'Connor,L,PIT,26,82,25,19,44
92,8481186,Logan O'Connor,R,COL,28,82,23,21,44
92,8480015,Owen Tippett,R,PHI,25,82,22,22,44
92,8475848,Brendan Gallagher,R,MTL,32,82,20,24,44
92,8481596,Shane Pinto,C,OTT,24,82,18,26,44
92,8476329,Travis Boyd,C,MIN,31,82,17,27,44
92,8476826,Yanni Gourde,C,SEA,33,82,17,27,44
92,8479941,Justin Danforth,R,CBJ,31,82,25,18,43
92,8479987,Morgan Geekie,C,BOS,26,82,21,22,43
92,8481604,Pavel Dorofeyev,L,VGK,24,82,21,22,43
92,8479525,Ross Colton,C,COL,28,82,19,24,43
92,8477456,J.T. Compher,L,DET,29,82,19,24,43
92,8477498,Darnell Nurse,D,EDM,29,82,18,25,43
92,8480434,Sean Durzi,D,UTA,26,82,11,32,43
92,8474189,Lars Eller,C,PIT,35,82,23,19,42
92,8482720,Matthew Knies,L,TOR,22,82,20,22,42
92,8484144,Connor Bedard,C,CHI,19,82,18,24,42
92,8478055,Gustav Forsling,D,FLA,28,82,10,32,42
92,8475314,Anders Lee,L,NYI,34,82,25,16,41
92,8476438,Brandon Saad,L,STL,32,82,25,16,41
92,8479390,Taylor Raddysh,R,WSH,26,82,23,18,41
92,8477953,Kasperi Kapanen,R,STL,28,82,19,22,41
92,8480113,Alex Iafallo,L,WPG,31,82,18,23,41
92,8480798,Philipp Kurashev,C,CHI,25,82,17,24,41
92,8475768,Jaden Schwartz,C,SEA,32,82,16,25,41
92,8476925,Colton Sissons,C,NSH,31,82,14,27,41
92,8480459,Pius Suter,C,VAN,28,82,13,28,41
92,8475171,Oliver Ekman-Larsson,D,TOR,33,82,8,33,41
92,8479398,Samuel Girard,D,COL,26,82,5,36,41
92,8478474,Lawson Crouse,L,UTA,27,82,21,19,40
92,8475714,Calle Jarnkrok,C,TOR,33,82,20,20,40
92,8471698,T.J. Oshie,R,WSH,38,82,19,21,40
92,8482105,Jake Sanderson,D,OTT,22,82,17,23,40
92,8479992,Michael Rasmussen,C,DET,25,82,16,24,40
92,8478115,Pierre Engvall,L,NYI,28,82,15,25,40
92,8477444,Andre Burakovsky,L,SEA,29,82,14,26,40
92,8482660,Kent Johnson,C,CBJ,22,82,13,27,40
92,8478542,Evan Rodrigues,C,FLA,31,82,12,28,40
92,8482259,Bobby McMann,C,TOR,28,82,22,17,39
92,8480849,Barrett Hayton,C,UTA,24,82,18,21,39
92,8475763,Kevin Hayes,R,PIT,32,82,12,27,39
92,8480835,Jack Drury,C,CAR,24,82,21,17,38
92,8478057,Dakota Joshua,C,VAN,28,82,18,20,38
92,8476474,Stefan Noesen,R,NJD,31,82,17,21,38
92,8479365,Trent Frederic,C,BOS,26,82,16,22,38
92,8475218,Mattias Ekholm,D,EDM,34,82,13,25,38
92,8480043,Timothy Liljegren,D,TOR,25,82,2,36,38
92,8479353,Brett Howden,C,VGK,26,82,15,22,37
92,8480748,Kiefer Sherwood,L,VAN,29,82,13,24,37
92,8477021,Alex Kerfoot,C,UTA,30,82,11,26,37
92,8477507,Nikita Zadorov,D,BOS,29,82,11,26,37
92,8481546,Cam York,D,PHI,23,82,9,28,37
92,8482655,J.J. Moser,D,TBL,24,82,6,31,37
92,8482671,Owen Power,D,BUF,22,82,5,32,37
92,8475764,Cam Fowler,D,ANA,33,82,4,33,37
92,8480873,Rasmus Sandin,D,WSH,24,82,4,33,37
92,8476927,Teddy Blueger,C,VAN,30,82,18,18,36
92,8483515,Juraj Slafkovsky,L,MTL,20,82,16,20,36
92,8476921,Jordan Martinook,L,CAR,32,82,15,21,36
92,8481581,Thomas Harley,D,DAL,23,82,13,23,36
92,8481656,Aliaksei Protas,C,WSH,23,82,7,29,36
92,8476463,Jonas Brodin,D,MIN,31,82,7,29,36
92,8477488,Brett Pesce,D,NJD,30,82,6,30,36
92,8475220,Marcus Foligno,L,MIN,33,82,17,18,35
92,8483431,Logan Cooley,C,UTA,20,82,17,18,35
92,8480003,Jesper Boqvist,C,FLA,26,82,16,19,35
92,8476878,Zemgus Girgensons,L,TBL,30,82,15,20,35
92,8479393,Noah Gregor,C,OTT,26,82,14,21,35
92,8475791,Taylor Hall,L,CHI,33,82,13,22,35
92,8475149,Marcus Johansson,L,MIN,34,82,13,22,35
92,8478891,Mason Appleton,C,WPG,28,82,12,23,35
92,8475200,Dmitry Orlov,D,CAR,33,82,12,23,35
92,8477948,Travis Sanheim,D,PHI,28,82,6,29,35
92,8475793,Ryan Johansen,C,PHI,32,82,19,15,34
92,8482109,Alexis Lafrenière,L,NYR,23,82,18,16,34
92,8476469,Joel Armia,R,MTL,31,82,18,16,34
92,8478109,Victor Olofsson,L,VGK,29,82,16,18,34
92,8477425,Miles Wood,L,COL,29,82,16,18,34
92,8477987,Ryan Donato,C,CHI,28,82,16,18,34
92,8475193,Tomas Tatar,L,NJD,34,82,14,20,34
92,8474716,Jared Spurgeon,D,MIN,35,82,14,20,34
92,8482133,Thomas Bordeleau,C,SJS,22,82,10,24,34
92,8477495,Seth Jones,D,CHI,30,82,9,25,34
92,8482624,Daniil Miromanov,D,CGY,27,82,7,27,34
92,8480871,Adam Boqvist,D,FLA,24,82,6,28,34
92,8476917,Adam Pelech,D,NYI,30,82,6,28,34
92,8476958,Jaccob Slavin,D,CAR,30,82,5,29,34
92,8479293,Brandon Tanev,L,SEA,33,82,20,13,33
92,8481624,Ilya Mikheyev,R,CHI,30,82,16,17,33
92,8477479,Tyler Bertuzzi,L,CHI,29,82,15,18,33
92,8481582,Nicholas Robertson,L,TOR,23,82,14,19,33
92,8470621,Corey Perry,R,EDM,39,82,13,20,33
92,8477932,Aaron Ekblad,D,FLA,28,82,12,21,33
92,8474149,Evgenii Dadonov,R,DAL,35,82,11,22,33
92,8477952,Robby Fabbri,C,ANA,28,82,17,15,32
92,8478020,Michael Amadio,C,OTT,28,82,17,15,32
92,8480813,Joe Veleno,C,DET,24,82,17,15,32
92,8481477,Nico Sturm,C,SJS,29,82,15,17,32
92,8484166,Adam Fantilli,C,CBJ,20,82,14,18,32
92,8473533,Jordan Staal,C,CAR,36,82,10,22,32
92,8476457,Adam Larsson,D,SEA,32,82,9,23,32
92,8476422,Mike Reilly,D,NYI,31,82,9,23,32
92,8476931,Jake McCabe,D,TOR,31,82,8,24,32
92,8476923,Damon Severson,D,CBJ,30,82,5,27,32
92,8480893,Kirill Marchenko,R,CBJ,24,82,19,12,31
92,8481535,Nils Hoglander,L,VAN,24,82,18,13,31
92,8482702,Logan Stankoven,C,DAL,21,82,17,14,31
92,8474715,Cam Atkinson,R,TBL,35,82,14,17,31
92,8478413,Jordan Greenway,L,BUF,27,82,10,21,31
92,8473563,Nicklas Backstrom,C,WSH,37,82,9,22,31
92,8475760,Nick Bjugstad,C,UTA,32,82,9,22,31
92,8482245,Artem Zub,D,OTT,29,82,8,23,31
92,8473507,Jeff Petry,D,DET,37,82,5,26,31
92,8480860,Kevin Bahl,D,CGY,24,82,5,26,31
92,8482089,Jake Neighbours,L,STL,22,82,21,9,30
92,8480068,Ryan Poehling,C,PHI,25,82,18,12,30
92,8479351,Sam Steel,C,DAL,26,82,12,18,30
92,8476292,Ondrej Palat,L,NJD,33,82,12,18,30
92,8480802,Ryan McLeod,C,BUF,25,82,11,19,30
92,8479996,Cody Glass,C,NSH,25,82,11,19,30
92,8478133,Jake Evans,C,MTL,28,82,11,19,30
92,8477947,Sonny Milano,L,WSH,28,82,9,21,30
92,8476979,Erik Gustafsson,D,DET,32,82,9,21,30
92,8482122,Brock Faber,D,MIN,22,82,5,25,30
92,8479976,Juuso Valimaki,D,UTA,26,82,1,29,30
92,8481704,Juuso Parssinen,C,NSH,23,82,15,14,29
92,8479661,Tanner Jeannot,L,LAK,27,82,14,15,29
92,8480220,Noah Cates,L,PHI,25,82,13,16,29
92,8475343,Nic Dowd,C,WSH,34,82,13,16,29
92,8476897,Oskar Sundqvist,C,STL,30,82,11,18,29
92,8476461,Sean Couturier,C,PHI,32,82,9,20,29
92,8475188,Brayden McNabb,D,VGK,33,82,9,20,29
92,8479402,Jake Bean,D,CGY,26,82,8,21,29
92,8480145,Neal Pionk,D,WPG,29,82,7,22,29
92,8480336,Sean Walker,D,CAR,30,82,7,22,29
92,8478911,Matt Roy,D,WSH,29,82,7,22,29
92,8477989,Christian Dvorak,C,MTL,28,82,6,23,29
92,8478840,Will Borgen,D,SEA,28,82,5,24,29
92,8478507,John Marino,D,UTA,27,82,4,25,29
92,8480049,Dylan Samberg,D,WPG,25,82,1,28,29
92,8478434,Keegan Kolesar,R,VGK,27,82,17,11,28
92,8476981,Josh Anderson,R,MTL,30,82,16,12,28
92,8481580,Connor McMichael,C,WSH,23,82,16,12,28
92,8481032,Paul Cotter,C,NJD,25,82,14,14,28
92,8473422,Nick Foligno,L,CHI,37,82,13,15,28
92,8479591,Michael Eyssimont,C,TBL,28,82,12,16,28
92,8482117,Lukas Reichel,L,CHI,22,82,11,17,28
92,8480995,Pontus Holmberg,R,TOR,25,82,11,17,28
92,8476889,Radek Faksa,C,STL,30,82,11,17,28
92,8476624,Barclay Goodrow,C,SJS,31,82,10,18,28
92,8481553,Bobby Brink,R,PHI,23,82,9,19,28
92,8483763,Maksymilian Szuber,D,UTA,22,82,9,19,28
92,8482142,Jamie Drysdale,D,PHI,22,82,7,21,28
92,8480817,K'Andre Miller,D,NYR,24,82,6,22,28
92,8480246,Nick Perbix,D,TBL,26,82,4,24,28
92,8480789,Oliver Wahlstrom,R,NYI,24,82,17,10,27
92,8477406,Mattias Janmark,C,EDM,32,82,17,10,27
92,8478569,Noel Acciari,C,PIT,33,82,17,10,27
92,8482079,Marco Rossi,C,MIN,23,82,16,11,27
92,8476312,Josh Manson,D,COL,33,82,14,13,27
92,8476278,Colin Blackwell,C,DAL,31,82,14,13,27
92,8477919,Frederick Gaudreau,C,MIN,31,82,11,16,27
92,8484153,Leo Carlsson,C,ANA,20,82,10,17,27
92,8481013,Jonatan Berggren,R,DET,24,82,8,19,27
92,8474673,TJ Brodie,D,CHI,34,82,5,22,27
92,8477506,Ryan Pulock,D,NYI,30,82,3,24,27
92,8478416,Erik Cernak,D,TBL,27,82,2,25,27
92,8478508,Yakov Trenin,C,MIN,27,82,18,8,26
92,8478432,Christian Fischer,R,DET,27,82,13,13,26
92,8480021,Jack Studnicka,C,LAK,25,82,12,14,26
92,8476960,Andreas Athanasiou,C,CHI,30,82,11,15,26
92,8477931,Tomas Nosek,L,FLA,32,82,11,15,26
92,8481606,Jordan Spence,D,LAK,23,82,8,18,26
92,8476885,Jacob Trouba,D,NYR,30,82,7,19,26
92,8480074,Alexandre Texier,C,STL,25,82,7,19,26
92,8483457,Lane Hutson,D,MTL,20,82,7,19,26
92,8481481,Blake Lizotte,C,PIT,27,82,6,20,26
92,8478178,Darren Raddysh,D,TBL,28,82,6,20,26
92,8480144,David Kampf,C,TOR,29,82,4,22,26
92,8478136,Jake Middleton,D,MIN,28,82,4,22,26
92,8484145,Zach Benson,L,BUF,19,82,13,12,25
92,8482155,Alex Laferriere,R,LAK,23,82,13,12,25
92,8481560,Arthur Kaliyev,R,LAK,23,82,7,18,25
92,8478882,Vladislav Gavrikov,D,LAK,29,82,7,18,25
92,8476892,Colton Parayko,D,STL,31,82,6,19,25
92,8481522,Peyton Krebs,C,BUF,23,82,5,20,25
92,8479369,Andrew Peeke,D,BOS,26,82,5,20,25
92,8476902,Esa Lindell,D,DAL,30,82,4,21,25
92,8474574,Tyler Myers,D,VAN,34,82,4,21,25
92,8477365,Connor Clifton,D,BUF,29,82,3,22,25
92,8477969,Marcus Pettersson,D,PIT,28,82,3,22,25
92,8475718,Justin Holl,D,DET,32,82,2,23,25
92,8481014,Alexander Romanov,D,NYI,24,82,1,24,25
92,8479371,Dante Fabbro,D,NSH,26,82,1,24,25
92,8476918,Jimmy Vesey,L,NYR,31,82,13,11,24
92,8477505,Alexander Wennberg,C,SJS,30,82,13,11,24
92,8479316,Luke Kunin,C,SJS,27,82,12,12,24
92,8475855,Jesper Fast,R,CAR,33,82,11,13,24
92,8477353,Tyler Motte,C,DET,29,82,11,13,24
92,8477839,Conor Sheary,L,TBL,32,82,9,15,24
92,8482111,Justin Barron,D,MTL,23,82,9,15,24
92,8476480,Vladislav Namestnikov,C,WPG,32,82,6,18,24
92,8476467,Jamie Oleksiak,D,SEA,32,82,4,20,24
92,8476879,Cody Ceci,D,EDM,31,82,2,22,24
92,8475462,Radko Gudas,D,ANA,34,82,2,22,24
92,8482074,Connor Zary,C,CGY,23,82,14,9,23
92,8475231,Casey Cizikas,C,NYI,33,82,13,10,23
92,8483397,Marc McLaughlin,C,BOS,25,82,13,10,23
92,8476374,Sean Kuraly,C,CBJ,31,82,11,12,23
92,8477369,Carson Soucy,D,VAN,30,82,10,13,23
92,8480448,Parker Kelly,L,COL,25,82,9,14,23
92,8477508,Curtis Lazar,C,NJD,29,82,9,14,23
92,8480172,Jan Rutta,D,SJS,34,82,6,17,23
92,8482087,Kaiden Guhle,D,MTL,22,82,6,17,23
92,8478851,Alexandre Carrier,D,NSH,28,82,5,18,23
92,8479998,Mikey Anderson,D,LAK,25,82,5,18,23
92,8480035,Henri Jokiharju,D,BUF,25,82,1,22,23
92,8477903,Garnet Hathaway,R,PHI,33,82,12,10,22
92,8481028,Martin Pospisil,C,CGY,25,82,12,10,22
92,8483524,Shane Wright,C,SEA,20,82,12,10,22
92,8482125,Alexander Holtz,R,VGK,22,82,9,13,22
92,8480806,Isac Lundestrom,C,ANA,25,82,8,14,22
92,8482166,Shakir Mukhamadullin,D,SJS,22,82,8,14,22
92,8482809,Jackson Blake,R,CAR,21,82,8,14,22
92,8483445,Cutter Gauthier,L,ANA,20,82,7,15,22
92,8483565,Nick Blankenburg,D,NSH,26,82,7,15,22
92,8482101,Danil Gushchin,L,SJS,22,82,7,15,22
92,8478443,Brandon Carlo,D,BOS,28,82,6,16,22
92,8478500,Ivan Provorov,D,CBJ,27,82,5,17,22
92,8474013,Ian Cole,D,UTA,35,82,5,17,22
92,8482073,Braden Schneider,D,NYR,23,82,4,18,22
92,8478468,Jeremy Lauzon,D,NSH,27,82,3,19,22
92,8475233,David Savard,D,MTL,34,82,2,20,22
92,8481567,Henry Thrun,D,SJS,23,82,10,11,21
92,8482679,Matt Coronato,R,CGY,22,82,10,11,21
92,8480980,Connor Dewar,C,TOR,25,82,9,12,21
92,8475181,Nick Leddy,D,STL,33,82,6,15,21
92,8475177,Calvin de Haan,D,COL,33,82,4,17,21
92,8474151,Ryan McDonagh,D,TBL,35,82,2,19,21
92,8476429,Scott Mayfield,D,NYI,32,82,2,19,21
92,8475790,Erik Gudbranson,D,CBJ,32,82,2,19,21
92,8479368,Max Jones,L,BOS,26,82,10,10,20
92,8481554,Kaapo Kakko,R,NYR,23,82,9,11,20
92,8480855,Jack McBain,C,UTA,24,82,9,11,20
92,8483495,Simon Nemec,D,NJD,20,82,6,14,20
92,8477435,Ryan Graves,D,PIT,29,82,6,14,20
92,8481517,Brett Leason,R,ANA,25,82,5,15,20
92,8482807,Ethan Del Mastro,D,CHI,21,82,5,15,20
92,8480222,Sebastian Aho,D,PIT,28,82,4,16,20
92,8480807,Mattias Samuelsson,D,BUF,24,82,4,16,20
92,8476441,Joel Edmundson,D,LAK,31,82,4,16,20
92,8482470,Ilya Solovyov,D,CGY,24,82,3,17,20
92,8474090,Brendan Smith,D,DAL,35,82,3,17,20
92,8480878,Nils Lundkvist,D,DAL,24,82,1,19,20
92,8470600,Ryan Suter,D,STL,39,82,1,19,20
92,8480025,MacKenzie Entwistle,R,FLA,25,82,10,9,19
92,8477450,Jason Dickinson,C,CHI,29,82,9,10,19
92,8476873,Mark Jankowski,C,NSH,30,82,9,10,19
92,8481601,Simon Holmstrom,R,NYI,23,82,8,11,19
92,8476525,Colin Miller,D,WPG,32,82,7,12,19
92,8473453,Trevor Lewis,C,LAK,37,82,7,12,19
92,8480073,Erik Brannstrom,D,COL,25,82,6,13,19
92,8477015,Connor Brown,R,EDM,30,82,6,13,19
92,8478211,Dryden Hunt,L,CGY,29,82,6,13,19
92,8484203,Bradly Nadeau,L,CAR,19,82,5,14,19
92,8475324,Nick Jensen,D,OTT,34,82,4,15,19
92,8476331,Dylan DeMelo,D,WPG,31,82,3,16,19
92,8476967,Brett Kulak,D,EDM,30,82,3,16,19
92,8479324,Ryan Lindgren,D,NYR,26,82,2,17,19
92,8476891,Matt Grzelcyk,D,PIT,30,82,1,18,19
92,8478399,Jonas Siegenthaler,D,NJD,27,82,1,18,19
92,8481178,Egor Zamula,D,PHI,24,82,1,18,19
92,8475455,Brenden Dillon,D,NJD,34,82,0,19,19
92,8480281,Alexey Toropchenko,R,STL,25,82,13,5,18
92,8481641,Joel Kiviranta,L,COL,28,82,13,5,18
92,8481093,Rafael Harvey-Pinard,L,MTL,25,82,11,7,18
92,8479638,Justin Brazeau,R,BOS,26,82,10,8,18
92,8479359,Beck Malenstyn,L,BUF,26,82,9,9,18
92,8482659,Josh Doan,R,UTA,22,82,8,10,18
92,8482666,Scott Morrow,D,CAR,22,82,7,11,18
92,8480796,Martin Fehervary,D,WSH,25,82,6,12,18
92,8483505,Matthew Poitras,C,BOS,20,82,5,13,18
92,8481708,Zac Jones,D,NYR,24,82,5,13,18
92,8479980,Nicolas Hague,D,VGK,26,82,4,14,18
92,8477220,Nate Schmidt,D,FLA,33,82,3,15,18
92,8477034,Jaycob Megna,D,FLA,32,82,3,15,18
92,8475690,Chris Tanev,D,TOR,35,82,2,16,18
92,8474567,Zach Bogosian,D,MIN,34,82,2,16,18
92,8482077,Dylan Holloway,L,EDM,23,82,11,6,17
92,8483482,Tristan Luneau,D,ANA,20,82,10,7,17
92,8483468,Jiri Kulich,C,BUF,20,82,7,10,17
92,8477499,Rasmus Ristolainen,D,PHI,30,82,6,11,17
92,8476858,Phillip Di Giuseppe,L,VAN,31,82,6,11,17
92,8483466,Kevin Korchinski,D,CHI,20,82,5,12,17
92,8481524,Bowen Byram,D,BUF,23,82,4,13,17
92,8480834,Ty Emberson,D,SJS,24,82,4,13,17
92,8479414,Nathan Bastian,R,NJD,27,82,9,7,16
92,8482749,Joshua Roy,R,MTL,21,82,8,8,16
92,8475842,Sam Carrick,C,NYR,32,82,7,9,16
92,8484911,Collin Graf,R,SJS,22,82,7,9,16
92,8479983,Mario Ferraro,D,SJS,26,82,6,10,16
92,8483493,Frank Nazar,C,CHI,20,82,6,10,16
92,8483012,Logan Morrison,C,SEA,22,82,6,10,16
92,8484149,Gavin Brindley,C,CBJ,20,82,5,11,16
92,8482733,Logan Mailloux,D,MTL,31,82,5,11,16
92,8482858,Ryker Evans,D,SEA,23,82,5,11,16
92,8478013,Jake Walman,D,SJS,28,82,4,12,16
92,8474612,Travis Hamonic,D,OTT,34,82,4,12,16
92,8480879,Jacob Bernard-Docker,D,OTT,24,82,4,12,16
92,8482859,Zack Ostapchuk,C,OTT,21,82,4,12,16
92,8478859,Niko Mikkola,D,FLA,28,82,2,14,16
92,8476822,Luke Glendening,C,TBL,35,82,11,4,15
92,8482803,Olen Zellweger,D,ANA,21,82,7,8,15
92,8476442,Matt Nieto,L,PIT,32,82,7,8,15
92,8477392,Hudson Fasching,R,NYI,29,82,6,9,15
92,8482141,Lukas Cormier,D,VGK,22,82,4,11,15
92,8479442,Troy Stecher,D,EDM,30,82,4,11,15
92,8482787,Nikita Chibrikov,R,WPG,31,82,4,11,15
92,8482713,Mackie Samoskevich,R,FLA,22,82,4,11,15
92,8483460,David Jiricek,D,CBJ,21,82,3,12,15
92,8480950,Ilya Lyubushkin,D,DAL,30,82,2,13,15
92,8482062,Cole Smith,L,NSH,29,82,9,5,14
92,8483567,Georgii Merkulov,C,BOS,24,82,7,7,14
92,8477938,Haydn Fleury,D,WPG,28,82,5,9,14
92,8477845,Trevor van Riemsdyk,D,WSH,33,82,3,11,14
92,8475762,Derek Forbort,D,VAN,32,82,2,12,14
92,8481568,Alex Vlasic,D,CHI,23,82,0,14,14
92,8483471,Brad Lambert,C,WPG,31,82,8,5,13
92,8480870,Bo Groulx,C,NYR,24,82,7,6,13
92,8479291,Kevin Rooney,C,CGY,31,82,5,8,13
92,8482145,Mavrik Bourque,C,DAL,22,82,5,8,13
92,8482762,Simon Edvinsson,D,DET,21,82,4,9,13
92,8482118,Sam Colangelo,R,ANA,23,82,4,9,13
92,8482070,Mitchell Chaffee,R,TBL,26,82,4,9,13
92,8482712,Oskar Olausson,R,COL,22,82,3,10,13
92,8481122,Simon Benoit,D,TOR,26,82,3,10,13
92,8471677,Jack Johnson,D,CBJ,37,82,2,11,13
92,8482153,Brendan Brisson,C,VGK,23,82,5,7,12
92,8476372,Nick Seeler,D,PHI,31,82,4,8,12
92,8483490,Pavel Mintyukov,D,ANA,21,82,3,9,12
92,8483499,Liam Ohgren,L,MIN,20,82,3,9,12
92,8483489,Fraser Minten,C,TOR,31,82,3,9,12
92,8476473,Connor Murphy,D,CHI,31,82,2,10,12
92,8477335,Kyle Burroughs,D,LAK,29,82,4,7,11
92,8475279,Ben Chiarot,D,DET,33,82,3,8,11
92,8481605,Jackson LaCombe,D,ANA,23,82,2,9,11
92,8478874,Adam Gaudette,C,OTT,28,82,0,11,11
92,8482516,Matthew Kessel,D,STL,24,82,4,6,10
92,8479576,Vincent Desharnais,D,VAN,28,82,3,7,10
92,8481699,Aku Raty,R,UTA,23,82,4,5,9
92,8480990,Declan Chisholm,D,MIN,24,82,3,6,9
92,8478450,Parker Wotherspoon,D,BOS,27,82,0,7,7
92,8474062,Riley Nash,C,NYR,35,82,3,3,6
92,8470794,Joe Pavelski,C,,40,0,0,0,0
92,8481703,Valtteri Puustinen,R,PIT,25,0,0,0,0
92,8477950,Tony DeAngelo,D,,29,0,0,0,0
92,8481577,Philip Tomasino,C,NSH,23,0,0,0,0
92,8475197,Tyson Barrie,D,,33,0,0,0,0
92,8471218,Blake Wheeler,R,,38,0,0,0,0
92,8474157,Max Pacioretty,L,,36,0,0,0,0
92,8478466,Daniel Sprong,R,VAN,27,0,0,0,0
92,8475744,Evgeny Kuznetsov,C,,32,0,0,0,0
92,8481019,David Gustafsson,C,WPG,24,0,0,0,0
92,8475906,John Klingberg,D,,32,0,0,0,0
92,8479348,Kale Clague,D,BUF,26,0,0,0,0
92,8476952,Dominic Toninato,C,WPG,30,0,0,0,0
92,8473473,Milan Lucic,L,,36,0,0,0,0
92,8474037,James van Riemsdyk,L,,35,0,0,0,0
92,8474602,Justin Schultz,D,,34,0,0,0,0
92,8482222,Alexander Barabanov,L,,30,0,0,0,0
92,8479372,Josh Mahura,D,SEA,26,0,0,0,0
92,8479982,Conor Timmins,D,TOR,26,0,0,0,0
92,8474031,Kevin Shattenkirk,D,,35,0,0,0,0
92,8480008,Adam Ruzicka,C,,25,0,0,0,0
92,8481059,Scott Perunovich,D,STL,26,0,0,0,0
92,8480884,Calen Addison,D,,24,0,0,0,0
92,8476994,Vinnie Hinostroza,C,NSH,30,0,0,0,0
92,8478452,Caleb Jones,D,LAK,27,0,0,0,0
92,8480157,Calle Rosen,D,COL,30,0,0,0,0
92,8481609,Vladislav Kolyachonok,D,UTA,23,0,0,0,0
92,8479415,Michael McLeod,C,,26,0,0,0,0
92,8476919,Chris Tierney,C,,30,0,0,0,0
92,8479639,Dylan Coghlan,D,WPG,26,0,0,0,0
92,8478146,Matthew Highmore,C,OTT,28,0,0,0,0
92,8478970,Jalen Chatfield,D,CAR,28,0,0,0,0
92,8480205,Emil Bemstrom,C,PIT,25,0,0,0,0
92,8474884,Mike Hoffman,C,,35,0,0,0,0
92,8471274,Alex Goligoski,D,,39,0,0,0,0
92,8478104,Sammy Blais,L,,28,0,0,0,0
92,8474870,Tyler Johnson,C,,34,0,0,0,0
92,8476913,Devin Shore,C,MIN,30,0,0,0,0
92,8481598,Philip Broberg,D,EDM,23,0,0,0,0
92,8480058,Pierre-Olivier Joseph,D,STL,25,0,0,0,0
92,8480891,Michael Kesselring,D,UTA,24,0,0,0,0
92,8477979,Nicolas Aube-Kubel,R,BUF,28,0,0,0,0
92,8476871,Tanner Pearson,L,,32,0,0,0,0
92,8476393,Nick Cousins,C,,31,0,0,0,0
92,8479977,Kailer Yamamoto,R,,26,0,0,0,0
92,8479543,Michael Pezzetta,L,MTL,26,0,0,0,0
92,8477018,Ben Hutton,D,VGK,31,0,0,0,0
92,8480762,Eric Robinson,L,CAR,29,0,0,0,0
92,8474034,Pat Maroon,L,CHI,36,0,0,0,0
92,8481058,Jesse Ylönen,R,,25,0,0,0,0
92,8475179,Dmitry Kulikov,D,FLA,34,0,0,0,0
92,8481527,Kaedan Korczak,D,VGK,23,0,0,0,0
92,8473449,Kyle Okposo,R,,36,0,0,0,0
92,8482192,Isaak Phillips,D,CHI,23,0,0,0,0
92,8480727,Zach Whitecloud,D,VGK,28,0,0,0,0
92,8479346,Dillon Dube,C,,26,0,0,0,0
92,8480821,Filip Zadina,R,,25,0,0,0,0
92,8480001,Urho Vaakanainen,D,ANA,25,0,0,0,0
92,8470966,Mark Giordano,D,,41,0,0,0,0
92,8480853,Liam Foudy,C,,24,0,0,0,0
92,8475225,Craig Smith,C,CHI,35,0,0,0,0
92,8479972,Mason Shaw,C,WPG,26,0,0,0,0
92,8478451,Ethan Bear,D,WSH,27,0,0,0,0
92,8474040,Sam Gagner,C,,35,0,0,0,0
92,8480196,Jacob Bryson,D,BUF,27,0,0,0,0
92,8479984,Cal Foote,D,,26,0,0,0,0
92,8480011,Klim Kostin,C,SJS,25,0,0,0,0
92,8482176,Wyatt Kaiser,D,CHI,22,0,0,0,0
92,8476988,Matt Benning,D,SJS,30,0,0,0,0
92,8479370,Tyson Jost,C,CAR,26,0,0,0,0
92,8477464,Nic Petan,C,,29,0,0,0,0
92,8477380,Jonny Brodzinski,C,NYR,31,0,0,0,0
92,8480070,Ian Mitchell,D,BOS,25,0,0,0,0
92,8479315,Joey Anderson,R,CHI,26,0,0,0,0
92,8478099,Kevin Labanc,R,,29,0,0,0,0
92,8476874,Olli Maatta,D,DET,30,0,0,0,0
92,8475208,Brian Dumoulin,D,ANA,33,0,0,0,0
92,8478430,Oliver Kylington,D,,27,0,0,0,0
92,8479536,Axel Jonsson-Fjallby,L,WPG,26,0,0,0,0
92,8479671,Mathieu Olivier,R,CBJ,27,0,0,0,0
92,8471709,Marc-Edouard Vlasic,D,SJS,37,0,0,0,0
92,8479328,Julien Gauthier,R,NYI,27,0,0,0,0
92,8478421,A.J. Greer,L,FLA,28,0,0,0,0
92,8477573,Nathan Walker,L,STL,30,0,0,0,0
92,8481537,Nikita Okhotiuk,D,CGY,24,0,0,0,0
92,8474166,Alec Martinez,D,CHI,37,0,0,0,0
92,8470610,Zach Parise,L,,40,0,0,0,0
92,8477478,William Carrier,L,CAR,30,0,0,0,0
92,8479344,Jesse Puljujarvi,R,PIT,26,0,0,0,0
92,8480887,Jordan Harris,D,MTL,24,0,0,0,0
92,8478502,Dennis Gilbert,D,BUF,28,0,0,0,0
92,8482730,Brandt Clarke,D,LAK,21,0,0,0,0
92,8480355,Mark Kastelic,C,BOS,25,0,0,0,0
92,8475750,Jon Merrill,D,MIN,32,0,0,0,0
92,8475164,Jakob Silfverberg,R,,34,0,0,0,0
92,8477944,Jakub Vrana,L,,28,0,0,0,0
92,8479439,Jacob MacDonald,D,COL,31,0,0,0,0
92,8474568,Luke Schenn,D,NSH,35,0,0,0,0
92,8478454,Noah Juulsen,D,VAN,27,0,0,0,0
92,8475752,Tyler Pitlick,C,,33,0,0,0,0
92,8482148,Hendrix Lapierre,C,WSH,22,0,0,0,0
92,8481167,Brayden Pachal,D,CGY,25,0,0,0,0
92,8478043,Sam Lafferty,C,BUF,29,0,0,0,0
92,8479321,Lucas Johansen,D,,27,0,0,0,0
92,8471699,Andrew Cogliano,C,,37,0,0,0,0
92,8481521,Ronnie Attard,D,PHI,25,0,0,0,0
92,8481161,Jake Christiansen,D,CBJ,25,0,0,0,0
92,8479458,Nikita Zaitsev,D,,33,0,0,0,0
92,8479619,Michael Carcone,L,UTA,28,0,0,0,0
92,8479026,Philippe Myers,D,TOR,27,0,0,0,0
92,8477330,Dominik Kubalik,L,,29,0,0,0,0
92,8481617,Vasily Podkolzin,R,VAN,23,0,0,0,0
92,8481701,Santeri Hatakka,D,NJD,23,0,0,0,0
92,8479514,Rem Pitlick,C,,27,0,0,0,0
92,8477446,Michael McCarron,R,NSH,29,0,0,0,0
92,8470604,Jeff Carter,C,,39,0,0,0,0
92,8482241,Radim Zohorna,L,,28,0,0,0,0
92,8480289,Morgan Barron,C,WPG,26,0,0,0,0
92,8479379,Givani Smith,R,SJS,26,0,0,0,0
92,8480216,Jacob Peterson,C,,25,0,0,0,0
92,8477851,Jordan Oesterle,D,BOS,32,0,0,0,0
92,8484258,Sam Malinski,D,COL,26,0,0,0,0
92,8478904,Steven Lorentz,C,,28,0,0,0,0
92,8482095,Tyler Kleven,D,OTT,22,0,0,0,0
92,8480848,Ty Dellandrea,C,SJS,24,0,0,0,0
92,8476884,Derrick Pouliot,D,,30,0,0,0,0
92,8479336,Carl Grundstrom,R,SJS,27,0,0,0,0
92,8482964,Arber Xhekaj,D,MTL,23,0,0,0,0
92,8471686,Marc Staal,D,,37,0,0,0,0
92,8477887,Patrick Brown,C,BOS,32,0,0,0,0
92,8478495,Denis Gurianov,R,,27,0,0,0,0
92,8473504,Cal Clutterbuck,R,,37,0,0,0,0
92,8481550,Adam Beckman,L,NJD,23,0,0,0,0
92,8480845,Rasmus Kupari,C,WPG,24,0,0,0,0
92,8474009,Nick Bonino,C,,36,0,0,0,0
92,8478585,Derek Ryan,C,EDM,38,0,0,0,0
92,8477962,Brendan Lemieux,L,CAR,28,0,0,0,0
92,8482861,Vincent Iorio,D,WSH,22,0,0,0,0
92,8479378,Logan Stanley,D,WPG,26,0,0,0,0
92,8473446,Erik Johnson,D,PHI,36,0,0,0,0
92,8481743,Marc Del Gaizo,D,NSH,25,0,0,0,0
92,8477384,Josh Brown,D,EDM,30,0,0,0,0
92,8482165,Yan Kuznetsov,D,CGY,22,0,0,0,0
92,8478424,Jansen Harkins,C,ANA,27,0,0,0,0
92,8482144,Jack Thompson,D,SJS,22,0,0,0,0
92,8478512,Austin Czarnik,C,,32,0,0,0,0
92,8477527,Ross Johnston,L,ANA,30,0,0,0,0
92,8479383,Boris Katchouk,L,,26,0,0,0,0
92,8482094,Daemon Hunt,D,MIN,22,0,0,0,0
92,8481719,Maxwell Crozier,D,TBL,24,0,0,0,0
92,8480192,Johnathan Kovacevic,D,NJD,27,0,0,0,0
92,8479376,Victor Mete,D,,26,0,0,0,0
92,8482511,Mason Lohrei,D,BOS,23,0,0,0,0
92,8475825,Jani Hakanpää,D,,32,0,0,0,0
92,8478021,William Lagesson,D,DET,28,0,0,0,0
92,8475795,Dylan McIlrath,D,WSH,32,0,0,0,0
92,8477846,Ryan Carpenter,C,,33,0,0,0,0
92,8481056,Spencer Stastney,D,NSH,24,0,0,0,0
92,8481564,Ryan Johnson,D,BUF,23,0,0,0,0
92,8478017,Mark Friedman,D,VAN,29,0,0,0,0
92,8479320,Max Lajoie,D,SEA,27,0,0,0,0
92,8480075,Cameron Crotty,D,MIN,25,0,0,0,0
92,8484287,Cole McWard,D,VAN,23,0,0,0,0
92,8484254,Akito Hirose,D,VAN,25,0,0,0,0
92,8483407,Brandon Scanlin,D,NYR,25,0,0,0,0
92,8480274,Philip Kemp,D,EDM,25,0,0,0,0
92,8479522,Hardy Haman Aktell,D,WSH,26,0,0,0,0
92,8480007,Jonas Rondbjerg,R,VGK,25,0,0,0,0
92,8477454,Adam Erne,L,,29,0,0,0,0
92,8481679,Maxence Guenette,D,OTT,23,0,0,0,0
92,8480441,Trey Fix-Wolansky,R,CBJ,25,0,0,0,0
92,8483546,Marshall Rifai,D,TOR,26,0,0,0,0
92,8480084,Nick DeSimone,D,NJD,30,0,0,0,0
92,8481030,Jack St. Ivany,D,PIT,25,0,0,0,0
92,8481592,Jakob Pelletier,L,CGY,23,0,0,0,0
92,8478011,Louie Belpedio,D,PHI,28,0,0,0,0
92,8477930,Pierre-Edouard Bellemare,L,,39,0,0,0,0
92,8484321,Nikolas Matinpalo,D,OTT,26,0,0,0,0
92,8482067,Connor Mackey,D,NYR,28,0,0,0,0
92,8481806,Louis Crevier,D,CHI,23,0,0,0,0
92,8484326,Patrik Koch,D,UTA,28,0,0,0,0
92,8477971,Andreas Englund,D,LAK,28,0,0,0,0
92,8481751,Lukas Rousek,R,BUF,25,0,0,0,0
92,8481006,Tyler Tucker,D,STL,24,0,0,0,0
92,8476867,Brendan Gaunce,C,MIN,30,0,0,0,0
92,8479520,Brandon Duhaime,R,WSH,27,0,0,0,0
92,8477073,Kurtis MacDermid,L,NJD,30,0,0,0,0
92,8480874,Adam Ginning,D,PHI,24,0,0,0,0
92,8477473,Justin Bailey,R,SJS,29,0,0,0,0
92,8479066,Ryan Lomberg,L,CGY,30,0,0,0,0
92,8477070,Liam O'Brien,C,UTA,30,0,0,0,0
92,8474618,Marco Scandella,D,,34,0,0,0,0
92,8475797,Jarred Tinordi,D,,32,0,0,0,0
92,8481441,Joe Snively,C,DET,28,0,0,0,0
92,8477244,Chad Ruhwedel,D,NYR,34,0,0,0,0
92,8479772,Zack MacEwen,R,OTT,28,0,0,0,0
92,8481147,Reese Johnson,C,MIN,26,0,0,0,0
92,8481043,Cole Koepke,L,BOS,26,0,0,0,0
92,8483619,Filip Roos,D,OTT,25,0,0,0,0
92,8481541,Samuel Bolduc,D,NYI,24,0,0,0,0
92,8477810,Joel Hanley,D,CGY,33,0,0,0,0
92,8476907,Mackenzie MacEachern,L,,30,0,0,0,0
92,8482652,Walker Duehr,R,CGY,27,0,0,0,0
92,8477126,Jayson Megna,C,,34,0,0,0,0
92,8483398,Declan Carlile,D,TBL,31,0,0,0,0
92,8482929,Emil Lilleberg,D,TBL,23,0,0,0,0
92,8480880,Jakub Lauko,C,MIN,24,0,0,0,0
92,8480245,Olle Lycksell,R,PHI,25,0,0,0,0
92,8480252,Cole Guttman,C,CHI,25,0,0,0,0
92,8477467,Gustav Olofsson,D,SEA,30,0,0,0,0
92,8479968,Vinni Lettieri,C,BOS,29,0,0,0,0
92,8478400,Colin White,C,,27,0,0,0,0
92,8475755,Alexander Petrovic,D,DAL,32,0,0,0,0
92,8481812,Nikolai Knyzhov,D,,27,0,0,0,0
92,8481593,Jayden Struble,D,MTL,23,0,0,0,0
92,8481532,Alex Turcotte,C,LAK,23,0,0,0,0
92,8482126,Emil Andrae,D,PHI,31,0,0,0,0
92,8479944,Zach Aston-Reese,C,VGK,30,0,0,0,0
92,8471817,Ryan Reaves,R,TOR,37,0,0,0,0
92,8481206,John Ludvig,D,PIT,24,0,0,0,0
92,8481599,Victor Soderstrom,D,UTA,23,0,0,0,0
92,8480292,Carson Meyer,R,ANA,27,0,0,0,0
92,8482496,Nils Aman,C,VAN,24,0,0,0,0
92,8479718,Alex Barré-Boulet,C,MTL,27,0,0,0,0
92,8479994,Jaret Anderson-Dolan,C,WPG,25,0,0,0,0
92,8480184,Gustav Lindstrom,D,,26,0,0,0,0
92,8480890,Jan Jenik,R,OTT,24,0,0,0,0
92,8478067,Oskar Lindblom,L,,28,0,0,0,0
92,8476934,Brock McGinn,L,ANA,30,0,0,0,0
92,8479985,Cale Fleury,D,SEA,26,0,0,0,0
92,8484304,Uvis Balinskis,D,FLA,28,0,0,0,0
92,8479981,Jonah Gadjovich,L,FLA,26,0,0,0,0
92,8481716,Dmitri Voronkov,L,CBJ,24,0,0,0,0
92,8474709,Matt Martin,L,,35,0,0,0,0
92,8482634,Alex Steeves,C,TOR,25,0,0,0,0
92,8480823,Alexander Alexeyev,D,WSH,25,0,0,0,0
92,8477541,Dakota Mermis,D,TOR,30,0,0,0,0
92,8483491,Ivan Miroshnichenko,L,WSH,20,0,0,0,0
92,8478477,Mitchell Stephens,C,SEA,27,0,0,0,0
92,8481543,Nikita Alexandrov,C,STL,24,0,0,0,0
92,8479423,Alex Nylander,L,,26,0,0,0,0
92,8482451,Mikael Pyyhtia,L,CBJ,23,0,0,0,0
92,8478831,Kevin Stenlund,C,UTA,28,0,0,0,0
92,8480306,Grant Hutton,D,NYI,29,0,0,0,0
92,8478028,Fredrik Olofsson,L,,28,0,0,0,0
92,8477462,Robert Hagg,D,VGK,29,0,0,0,0
92,8477320,Anton Blidh,L,NYR,29,0,0,0,0
92,8482157,Will Cuylle,L,NYR,22,0,0,0,0
92,8482737,Zack Bolduc,C,STL,21,0,0,0,0
92,8481239,Samuel Fagemo,L,,24,0,0,0,0
92,8481600,Tobias Bjornfot,D,FLA,23,0,0,0,0
92,8478409,Anthony Richard,C,PHI,28,0,0,0,0
92,8474145,Robert Bortuzzo,D,,35,0,0,0,0
92,8475958,Michael Sgarbossa,C,WSH,32,0,0,0,0
92,8479986,Kole Lind,R,DAL,26,0,0,0,0
92,8479249,Andrew Poturalski,C,SJS,30,0,0,0,0
92,8479362,Riley Tufte,L,BOS,26,0,0,0,0
92,8479991,Jake Leschyshyn,C,NYR,25,0,0,0,0
92,8479587,Rhett Gardner,C,PHI,28,0,0,0,0
92,8482744,James Malatesta,L,CBJ,21,0,0,0,0
92,8478854,Ryan Shea,D,PIT,27,0,0,0,0
92,8481591,Sam Poulin,R,,23,0,0,0,0
92,8483512,Matt Savoie,C,EDM,20,0,0,0,0
92,8482102,Vasily Ponomarev,C,PIT,22,0,0,0,0
92,8482162,Roby Jarventie,L,EDM,22,0,0,0,0
92,8481016,Ruslan Iskhakov,C,,24,0,0,0,0
92,8482172,Landon Slaggert,L,CHI,22,0,0,0,0
92,8482747,Brennan Othmann,L,NYR,21,0,0,0,0
92,8480031,Maxime Comtois,L,,25,0,0,0,0
92,8480226,Marián Studenic,R,,26,0,0,0,0
92,8478408,Travis Dermott,D,,28,0,0,0,0
92,8481518,Nolan Foote,L,NJD,24,0,0,0,0
92,8479419,Brett Murray,L,BUF,26,0,0,0,0
92,8482088,Justin Sourdif,R,FLA,22,0,0,0,0
92,8482201,Gage Goncalves,C,TBL,23,0,0,0,0
92,8481578,Graeme Clarke,R,MIN,23,0,0,0,0
92,8482177,Marat Khusnutdinov,C,MIN,22,0,0,0,0
92,8481754,Nikita Nesterenko,C,ANA,23,0,0,0,0
92,8483531,Brian Halonen,L,NJD,25,0,0,0,0
92,8483920,Pierrick Dube,R,WSH,23,0,0,0,0
92,8480851,Akil Thomas,C,LAK,24,0,0,0,0
92,8475235,Nicolas Deslauriers,L,PHI,33,0,0,0,0
92,8482476,Emil Heineman,L,MTL,23,0,0,0,0
92,8477149,Scott Sabourin,R,SJS,32,0,0,0,0
92,8483549,Lucas Condotta,L,MTL,27,0,0,0,0
92,8482765,Isak Rosen,R,BUF,21,0,0,0,0
92,8481237,Kyle MacLean,C,NYI,25,0,0,0,0
92,8481024,Linus Karlsson,C,VAN,25,0,0,0,0
92,8481690,Tyler Angle,C,,24,0,0,0,0
92,8483570,Ben Meyers,C,SEA,26,0,0,0,0
92,8481655,Cole Schwindt,R,CGY,23,0,0,0,0
92,8481462,Mason Morelli,L,VGK,28,0,0,0,0
92,8483401,Marc Johnstone,R,PIT,28,0,0,0,0
92,8478956,Samuel Laberge,L,NJD,27,0,0,0,0
92,8479533,Joona Koppanen,L,,26,0,0,0,0
92,8482197,Adam Raska,R,MIN,23,0,0,0,0
92,8482250,Callahan Burke,C,VGK,27,0,0,0,0
92,8482784,Zach Dean,C,STL,21,0,0,0,0
92,8484255,Jason Polin,R,COL,25,0,0,0,0
92,8481077,John Leonard,L,,26,0,0,0,0
92,8481534,Raphael Lavoie,C,EDM,24,0,0,0,0
92,8483609,Adam Klapka,R,CGY,24,0,0,0,0
92,8482751,Ryan Winterton,C,SEA,21,0,0,0,0
92,8480267,Sammy Walker,C,MIN,25,0,0,0,0
92,8475766,Austin Watson,L,,32,0,0,0,0
92,8482460,Matt Rempe,C,NYR,22,0,0,0,0
92,8481065,Angus Crookshank,L,OTT,25,0,0,0,0
92,8481070,Hugh McGing,L,,26,0,0,0,0
92,8476323,Max McCormick,L,SEA,32,0,0,0,0
92,8483395,Arshdeep Bains,L,VAN,23,0,0,0,0
92,8484259,Ondrej Pavel,C,COL,31,0,0,0,0
92,8483432,Luca Del Bel Belluz,C,CBJ,31,0,0,0,0
92,8483045,Cameron Butler,R,CBJ,31,0,0,0,0
92,8482061,Brandon Biro,L,SEA,26,0,0,0,0
92,8477401,John Hayden,C,SEA,29,0,0,0,0
92,8475278,Byron Froese,C,,33,0,0,0,0
92,8478446,Glenn Gawdin,C,LAK,27,0,0,0,0
92,8477993,Justin Kirkland,C,CGY,28,0,0,0,0
92,8482147,Jean-Luc Foudy,C,COL,22,0,0,0,0
92,8480032,Shane Bowers,C,NJD,25,0,0,0,0
92,8479330,Brandon Gignac,C,MTL,27,0,0,0,0
92,8480776,Sheldon Rempal,R,,29,0,0,0,0
92,8475413,Justin Dowling,C,NJD,34,0,0,0,0
92,8481726,Adam Edstrom,C,NYR,24,0,0,0,0
92,8480844,Grigori Denisenko,L,VGK,24,0,0,0,0
92,8478147,Bokondji Imama,L,PIT,28,0,0,0,0
92,8478881,Brett Seney,L,CHI,28,0,0,0,0
92,8483630,Pavol Regenda,L,ANA,25,0,0,0,0
92,8480836,Jonathan Gruden,C,,24,0,0,0,0
92,8484314,Jiri Smejkal,L,,28,0,0,0,0
92,8475780,Chris Wagner,R,COL,33,0,0,0,0
92,8479546,Oskar Steen,C,,26,0,0,0,0
92,8483597,Milos Kelemen,L,UTA,25,0,0,0,0
92,8481789,Tye Kartye,L,SEA,23,0,0,0,0
92,8484325,Waltteri Merela,C,TBL,26,0,0,0,0
92,8479421,Jacob Moverare,D,LAK,26,0,0,0,0
92,8481585,Egor Afanasyev,L,SJS,23,0,0,0,0
92,8479547,Matthew Phillips,R,,26,0,0,0,0
92,8479367,William Lockwood,R,FLA,26,0,0,0,0
92,8476915,Jujhar Khaira,L,,30,0,0,0,0
92,8481422,Jacob Lucchini,C,NSH,29,0,0,0,0
92,8480468,James Hamblin,L,EDM,25,0,0,0,0
92,8478051,Max Willman,C,NJD,29,0,0,0,0
92,8481556,John Beecher,C,BOS,23,0,0,0,0
92,8478078,Rourke Chartier,C,,28,0,0,0,0
93,8477956,David Pastrnak,R,BOS,28,82,62,78,140
93,8478402,Connor McDavid,C,EDM,27,82,44,94,138
93,8477934,Leon Draisaitl,C,EDM,29,82,39,91,130
93,8477492,Nathan MacKinnon,C,COL,29,82,51,73,124
93,8478420,Mikko Rantanen,R,COL,28,82,54,64,118
93,8476453,Nikita Kucherov,R,TBL,31,82,37,81,118
93,8479314,Matthew Tkachuk,L,FLA,27,82,36,82,118
93,8476887,Filip Forsberg,L,NSH,30,82,60,54,114
93,8476468,J.T. Miller,C,VAN,31,82,47,63,110
93,8481559,Jack Hughes,C,NJD,23,82,43,63,106
93,8479343,Clayton Keller,R,UTA,26,82,48,57,105
93,8480027,Jason Robertson,L,DAL,25,82,36,69,105
93,8478403,Jack Eichel,C,VGK,28,82,51,52,103
93,8471675,Sidney Crosby,C,PIT,37,82,44,59,103
93,8474564,Steven Stamkos,C,NSH,34,82,41,62,103
93,8478550,Artemi Panarin,L,NYR,33,82,37,66,103
93,8476853,Morgan Rielly,D,TOR,30,82,19,82,101
93,8477939,William Nylander,R,TOR,28,82,45,55,100
93,8474600,Roman Josi,D,NSH,34,82,20,80,100
93,8479318,Auston Matthews,C,TOR,27,82,49,50,99
93,8478864,Kirill Kaprizov,L,MIN,27,82,33,66,99
93,8477946,Dylan Larkin,C,DET,28,82,48,50,98
93,8480800,Quinn Hughes,D,VAN,25,82,15,83,98
93,8480801,Brady Tkachuk,L,OTT,25,82,45,52,97
93,8480012,Elias Pettersson,C,VAN,26,82,36,60,96
93,8480023,Robert Thomas,C,STL,25,82,29,67,96
93,8477933,Sam Reinhart,C,FLA,29,82,49,45,94
93,8480002,Nico Hischier,C,NJD,25,82,33,59,92
93,8477409,Carter Verhaeghe,C,FLA,29,82,44,47,91
93,8477949,Alex Tuch,R,BUF,28,82,31,60,91
93,8477493,Aleksander Barkov,C,FLA,29,82,29,62,91
93,8477404,Jake Guentzel,C,TBL,30,82,42,48,90
93,8482116,Tim Stützle,C,OTT,22,82,26,64,90
93,8480069,Cale Makar,D,COL,26,82,21,68,89
93,8479385,Jordan Kyrou,C,STL,26,82,36,50,86
93,8476346,Johnny Gaudreau,L,CBJ,31,82,21,65,86
93,8480830,Andrei Svechnikov,R,CAR,24,82,27,58,85
93,8476460,Mark Scheifele,C,WPG,31,82,34,50,84
93,8478445,Mathew Barzal,C,NYI,27,82,28,55,83
93,8475810,Bryan Rust,R,PIT,32,82,38,43,81
93,8477951,Nick Schmaltz,C,UTA,28,82,35,46,81
93,8481557,Matt Boldy,L,MIN,23,82,32,49,81
93,8473994,Jamie Benn,L,DAL,35,82,25,56,81
93,8480036,Miro Heiskanen,D,DAL,25,82,15,66,81
93,8477501,Valeri Nichushkin,R,COL,29,82,39,41,80
93,8477942,Kevin Fiala,L,LAK,28,82,36,44,80
93,8481523,Kirby Dach,C,MTL,23,82,18,62,80
93,8477960,Adrian Kempe,R,LAK,28,82,34,45,79
93,8477955,Jared McCann,L,SEA,28,82,33,46,79
93,8475913,Mark Stone,R,VGK,32,82,20,59,79
93,8476389,Vincent Trocheck,C,NYR,31,82,41,37,78
93,8475172,Nazem Kadri,C,CGY,34,82,30,48,78
93,8478440,Dylan Strome,C,WSH,27,82,27,51,78
93,8478010,Brayden Point,C,TBL,28,82,41,36,77
93,8471214,Alex Ovechkin,L,WSH,39,82,26,50,76
93,8480839,Rasmus Dahlin,D,BUF,24,82,20,56,76
93,8478427,Sebastian Aho,C,CAR,27,82,39,36,75
93,8474578,Erik Karlsson,D,PIT,34,82,11,64,75
93,8478398,Kyle Connor,L,WPG,28,82,34,40,74
93,8480208,Drake Batherson,R,OTT,26,82,30,44,74
93,8476459,Mika Zibanejad,C,NYR,31,82,22,52,74
93,8476905,Chandler Stephenson,C,SEA,30,82,17,57,74
93,8476448,William Karlsson,C,VGK,31,82,39,34,73
93,8476539,Jonathan Marchessault,R,NSH,34,82,38,35,73
93,8476881,Tomas Hertl,C,VGK,31,82,36,37,73
93,8478449,Roope Hintz,C,DAL,28,82,35,38,73
93,8482078,Lucas Raymond,L,DET,22,82,33,40,73
93,8475158,Ryan O'Reilly,C,NSH,33,82,29,44,73
93,8478439,Travis Konecny,R,PHI,27,82,25,48,73
93,8476454,Ryan Nugent-Hopkins,C,EDM,31,82,21,52,73
93,8475166,John Tavares,C,TOR,34,82,34,38,72
93,8477496,Elias Lindholm,C,BOS,30,82,27,45,72
93,8478401,Pavel Zacha,C,BOS,27,82,26,46,72
93,8480803,Evan Bouchard,D,EDM,25,82,24,48,72
93,8481540,Cole Caufield,R,MTL,23,82,38,33,71
93,8471685,Anze Kopitar,C,LAK,37,82,24,47,71
93,8477504,Josh Morrissey,D,WPG,29,82,18,53,71
93,8480865,Noah Dobson,D,NYI,24,82,12,59,71
93,8477447,Shea Theodore,D,VGK,29,82,10,61,71
93,8478975,Mason Marchment,L,DAL,29,82,33,37,70
93,8480188,Fabian Zetterlund,L,SJS,25,82,32,38,70
93,8478873,Troy Terry,R,ANA,27,82,25,45,70
93,8477402,Pavel Buchnevich,L,STL,29,82,22,48,70
93,8479425,Filip Hronek,D,VAN,27,82,17,53,70
93,8479407,Jesper Bratt,L,NJD,26,82,25,44,69
93,8474141,Patrick Kane,R,DET,36,82,23,46,69
93,8471215,Evgeni Malkin,C,PIT,38,82,19,50,69
93,8479323,Adam Fox,D,NYR,26,82,17,52,69
93,8476456,Jonathan Huberdeau,C,CGY,31,82,16,53,69
93,8479337,Alex DeBrincat,R,DET,27,82,29,39,68
93,8475726,Tyler Toffoli,C,SJS,32,82,33,34,67
93,8478444,Brock Boeser,R,VAN,27,82,31,36,67
93,8478042,Viktor Arvidsson,R,EDM,31,82,30,37,67
93,8475765,Vladimir Tarasenko,R,DET,33,82,30,37,67
93,8473419,Brad Marchand,L,BOS,36,82,29,38,67
93,8475168,Matt Duchene,C,DAL,33,82,27,40,67
93,8475786,Zach Hyman,L,EDM,32,82,36,30,66
93,8482097,Jack Quinn,R,BUF,23,82,26,40,66
93,8477940,Nikolaj Ehlers,L,WPG,28,82,22,44,66
93,8474563,Drew Doughty,D,LAK,35,82,13,53,66
93,8478047,Michael Bunting,L,PIT,29,82,33,32,65
93,8481533,Trevor Zegras,C,ANA,23,82,30,35,65
93,8475692,Mats Zuccarello,R,MIN,37,82,22,43,65
93,8482665,Matty Beniers,C,SEA,22,82,21,44,65
93,8479420,Tage Thompson,C,BUF,27,82,27,37,64
93,8478856,Conor Garland,R,VAN,28,82,24,40,64
93,8476462,Dougie Hamilton,D,NJD,31,82,19,45,64
93,8477500,Bo Horvat,C,NYI,29,82,39,24,63
93,8482175,JJ Peterka,R,BUF,22,82,36,27,63
93,8479400,Pierre-Luc Dubois,L,WSH,26,82,31,32,63
93,8482699,Dylan Guenther,R,UTA,21,82,26,37,63
93,8478397,Rasmus Andersson,D,CGY,28,82,12,51,63
93,8474590,John Carlson,D,WSH,34,82,9,54,63
93,8475184,Chris Kreider,L,NYR,33,82,39,23,62
93,8479339,Patrik Laine,L,CBJ,26,82,33,29,62
93,8478414,Timo Meier,R,NJD,28,82,32,30,62
93,8481528,Dylan Cozens,C,BUF,23,82,28,34,62
93,8478038,Devon Toews,D,COL,30,82,13,49,62
93,8477456,J.T. Compher,L,DET,29,82,28,33,61
93,8475170,Brayden Schenn,C,STL,33,82,20,41,61
93,8479542,Brandon Hagel,L,TBL,26,82,30,30,60
93,8474586,Jordan Eberle,R,SEA,34,82,28,32,60
93,8475794,Tyler Seguin,C,DAL,32,82,27,33,60
93,8473986,Alex Killorn,L,ANA,35,82,25,35,60
93,8479325,Charlie McAvoy,D,BOS,27,82,15,45,60
93,8475798,Mikael Granlund,C,SJS,32,82,15,45,60
93,8477476,Artturi Lehkonen,L,COL,29,82,34,24,58
93,8478498,Jake DeBrusk,L,VAN,28,82,26,32,58
93,8480018,Nick Suzuki,C,MTL,25,82,15,43,58
93,8477986,Brandon Montour,D,SEA,30,82,11,47,58
93,8482093,Seth Jarvis,C,CAR,22,82,28,29,57
93,8478493,Joel Eriksson Ek,C,MIN,27,82,26,31,57
93,8479675,Trevor Moore,L,LAK,29,82,24,33,57
93,8480039,Martin Necas,C,CAR,25,82,22,35,57
93,8480015,Owen Tippett,R,PHI,25,82,21,36,57
93,8477497,Sean Monahan,C,CBJ,30,82,19,38,57
93,8476869,Brady Skjei,D,NSH,30,82,17,40,57
93,8478366,Frank Vatrano,R,ANA,30,82,31,25,56
93,8477416,Oliver Bjorkstrand,R,SEA,29,82,23,33,56
93,8478460,Zach Werenski,D,CBJ,27,82,15,41,56
93,8478055,Gustav Forsling,D,FLA,28,82,15,41,56
93,8475722,Jason Zucker,L,BUF,32,82,28,27,55
93,8480064,Josh Norris,C,OTT,25,82,27,28,55
93,8477444,Andre Burakovsky,L,SEA,29,82,24,31,55
93,8473512,Claude Giroux,R,OTT,36,82,20,35,55
93,8476479,Phillip Danault,C,LAK,31,82,14,41,55
93,8478407,Vince Dunn,D,SEA,28,82,12,43,55
93,8476432,Boone Jenner,C,CBJ,31,82,31,23,54
93,8482740,Wyatt Johnston,C,DAL,21,82,30,24,54
93,8481068,Yegor Sharangovich,C,CGY,26,82,27,27,54
93,8481618,Alex Newhook,C,MTL,23,82,17,37,54
93,8476438,Brandon Saad,L,STL,32,82,28,25,53
93,8475768,Jaden Schwartz,C,SEA,32,82,23,30,53
93,8482113,Anton Lundell,C,FLA,23,82,21,32,53
93,8481542,Moritz Seider,D,DET,23,82,15,38,53
93,8482124,Quinton Byfield,R,LAK,22,82,14,39,53
93,8477964,Ivan Barbashev,C,VGK,29,82,26,26,52
93,8482667,William Eklund,L,SJS,22,82,23,29,52
93,8474679,Gustav Nyquist,C,NSH,35,82,19,33,52
93,8477503,Max Domi,C,TOR,29,82,17,35,52
93,8475745,Charlie Coyle,C,BOS,32,82,16,36,52
93,8480434,Sean Durzi,D,UTA,26,82,10,42,52
93,8475754,Brock Nelson,C,NYI,33,82,27,24,51
93,8475791,Taylor Hall,L,CHI,33,82,17,34,51
93,8477511,Anthony Mantha,R,CGY,30,82,23,27,50
93,8482149,Cole Perfetti,C,WPG,22,82,22,28,50
93,8476399,Blake Coleman,C,CGY,33,82,21,29,50
93,8480078,Filip Chytil,C,NYR,25,82,17,33,50
93,8476925,Colton Sissons,C,NSH,31,82,16,34,50
93,8476906,Shayne Gostisbehere,D,CAR,31,82,12,38,50
93,8475167,Victor Hedman,D,TBL,34,82,7,43,50
93,8482745,Mason McTavish,C,ANA,21,82,24,25,49
93,8482475,Yegor Chinakhov,R,CBJ,23,82,20,29,49
93,8478046,Danton Heinen,L,VAN,29,82,19,30,49
93,8480459,Pius Suter,C,VAN,28,82,19,30,49
93,8476875,Mike Matheson,D,MTL,30,82,16,33,49
93,8476882,Teuvo Teravainen,L,CHI,30,82,16,33,49
93,8471724,Kris Letang,D,PIT,37,82,10,39,49
93,8478233,Andrew Mangiapane,L,WSH,28,82,26,22,48
93,8475784,Jeff Skinner,C,EDM,32,82,24,24,48
93,8481711,Matias Maccelli,L,UTA,24,82,21,27,48
93,8477935,Sam Bennett,C,FLA,28,82,20,28,48
93,8476872,Scott Laughton,C,PHI,30,82,18,30,48
93,8480028,Morgan Frost,C,PHI,25,82,17,31,48
93,8480145,Neal Pionk,D,WPG,29,82,10,38,48
93,8475169,Evander Kane,L,EDM,33,82,25,22,47
93,8482159,Tyson Foerster,R,PHI,22,82,23,24,47
93,8478413,Jordan Greenway,L,BUF,27,82,19,28,47
93,8478519,Anthony Cirelli,C,TBL,27,82,15,32,47
93,8474565,Alex Pietrangelo,D,VGK,34,82,14,33,47
93,8477429,Andrew Copp,C,DET,30,82,14,33,47
93,8482684,Luke Hughes,D,NJD,21,82,7,40,47
93,8481596,Shane Pinto,C,OTT,24,82,24,22,46
93,8475714,Calle Jarnkrok,C,TOR,33,82,24,22,46
93,8477998,Warren Foegele,L,LAK,28,82,22,24,46
93,8476483,Rickard Rakell,R,PIT,31,82,20,26,46
93,8476826,Yanni Gourde,C,SEA,33,82,19,27,46
93,8477479,Tyler Bertuzzi,L,CHI,29,82,19,27,46
93,8474150,Mikael Backlund,C,CGY,35,82,18,28,46
93,8482110,Dawson Mercer,C,NJD,23,82,16,30,46
93,8476458,Ryan Strome,C,ANA,31,82,16,30,46
93,8479345,Jakob Chychrun,D,WSH,26,82,14,32,46
93,8477021,Alex Kerfoot,C,UTA,30,82,13,33,46
93,8477346,MacKenzie Weegar,D,CGY,30,82,12,34,46
93,8476923,Damon Severson,D,CBJ,30,82,9,37,46
93,8478396,Noah Hanifin,D,VGK,27,82,8,38,46
93,8481560,Arthur Kaliyev,R,LAK,23,82,25,20,45
93,8482146,Luke Evangelista,R,NSH,22,82,23,22,45
93,8477987,Ryan Donato,C,CHI,28,82,20,25,45
93,8474102,David Perron,L,OTT,36,82,16,29,45
93,8482109,Alexis Lafrenière,L,NYR,23,82,15,30,45
93,8476792,Torey Krug,D,STL,33,82,13,32,45
93,8482671,Owen Power,D,BUF,22,82,8,37,45
93,8476979,Erik Gustafsson,D,DET,32,82,7,38,45
93,8471698,T.J. Oshie,R,WSH,38,82,26,18,44
93,8483808,Andrei Kuzmenko,L,CGY,28,82,21,23,44
93,8475753,Justin Faulk,D,STL,32,82,18,26,44
93,8482092,Ridly Greig,C,OTT,22,82,18,26,44
93,8477948,Travis Sanheim,D,PHI,28,82,14,30,44
93,8477953,Kasperi Kapanen,R,STL,28,82,13,31,44
93,8478438,Tommy Novak,C,NSH,27,82,11,33,44
93,8479999,Casey Mittelstadt,C,COL,26,82,8,36,44
93,8476958,Jaccob Slavin,D,CAR,30,82,6,38,44
93,8474641,Adam Henrique,C,EDM,34,82,24,19,43
93,8475793,Ryan Johansen,C,PHI,32,82,23,20,43
93,8478057,Dakota Joshua,C,VAN,28,82,22,21,43
93,8475314,Anders Lee,L,NYI,34,82,18,25,43
93,8480113,Alex Iafallo,L,WPG,31,82,17,26,43
93,8479987,Morgan Geekie,C,BOS,26,82,15,28,43
93,8482133,Thomas Bordeleau,C,SJS,22,82,15,28,43
93,8478469,Thomas Chabot,D,OTT,27,82,14,29,43
93,8480797,Joel Farabee,L,PHI,24,82,12,31,43
93,8478500,Ivan Provorov,D,CBJ,27,82,5,38,43
93,8480014,Gabriel Vilardi,C,WPG,25,82,27,15,42
93,8479293,Brandon Tanev,L,SEA,33,82,25,17,42
93,8481535,Nils Hoglander,L,VAN,24,82,25,17,42
93,8476880,Tom Wilson,R,WSH,30,82,21,21,42
93,8477425,Miles Wood,L,COL,29,82,17,25,42
93,8475287,Erik Haula,L,NJD,33,82,16,26,42
93,8477932,Aaron Ekblad,D,FLA,28,82,14,28,42
93,8482660,Kent Johnson,C,CBJ,22,82,13,29,42
93,8482245,Artem Zub,D,OTT,29,82,9,33,42
93,8479410,Mikhail Sergachev,D,UTA,26,82,7,35,42
93,8481581,Thomas Harley,D,DAL,23,82,7,35,42
93,8475151,Kyle Palmieri,C,NYI,33,82,22,19,41
93,8477407,Anthony Duclair,L,NYI,29,82,21,20,41
93,8476927,Teddy Blueger,C,VAN,30,82,18,23,41
93,8473563,Nicklas Backstrom,C,WSH,37,82,14,27,41
93,8470613,Brent Burns,D,CAR,39,82,7,34,41
93,8482055,Drew O'Connor,L,PIT,26,82,24,16,40
93,8477451,Ryan Hartman,R,MIN,30,82,18,22,40
93,8474053,Logan Couture,C,SJS,35,82,18,22,40
93,8478542,Evan Rodrigues,C,FLA,31,82,15,25,40
93,8475218,Mattias Ekholm,D,EDM,34,82,12,28,40
93,8477494,Jonathan Drouin,L,COL,29,82,9,31,40
93,8480817,K'Andre Miller,D,NYR,24,82,7,33,40
93,8475193,Tomas Tatar,L,NJD,34,82,21,18,39
93,8479992,Michael Rasmussen,C,DET,25,82,20,19,39
93,8480220,Noah Cates,L,PHI,25,82,19,20,39
93,8480798,Philipp Kurashev,C,CHI,25,82,13,26,39
93,8481554,Kaapo Kakko,R,NYR,23,82,19,19,38
93,8475191,Reilly Smith,R,NYR,33,82,18,20,38
93,8481093,Rafael Harvey-Pinard,L,MTL,25,82,18,20,38
93,8478472,Mathieu Joseph,R,STL,27,82,17,21,38
93,8476392,Adam Lowry,C,WPG,31,82,17,21,38
93,8478474,Lawson Crouse,L,UTA,27,82,17,21,38
93,8484144,Connor Bedard,C,CHI,19,82,16,22,38
93,8476480,Vladislav Namestnikov,C,WPG,32,82,16,22,38
93,8476461,Sean Couturier,C,PHI,32,82,15,23,38
93,8478115,Pierre Engvall,L,NYI,28,82,14,24,38
93,8481546,Cam York,D,PHI,23,82,11,27,38
93,8479371,Dante Fabbro,D,NSH,26,82,5,33,38
93,8473507,Jeff Petry,D,DET,37,82,3,35,38
93,8478109,Victor Olofsson,L,VGK,29,82,21,16,37
93,8475760,Nick Bjugstad,C,UTA,32,82,19,18,37
93,8479368,Max Jones,L,BOS,26,82,19,18,37
93,8482720,Matthew Knies,L,TOR,22,82,18,19,37
93,8479525,Ross Colton,C,COL,28,82,17,20,37
93,8475799,Nino Niederreiter,R,WPG,32,82,16,21,37
93,8479941,Justin Danforth,R,CBJ,31,82,16,21,37
93,8480813,Joe Veleno,C,DET,24,82,15,22,37
93,8473533,Jordan Staal,C,CAR,36,82,14,23,37
93,8476292,Ondrej Palat,L,NJD,33,82,13,24,37
93,8478462,Nicolas Roy,C,VGK,27,82,9,28,37
93,8476931,Jake McCabe,D,TOR,31,82,6,31,37
93,8477495,Seth Jones,D,CHI,30,82,5,32,37
93,8479390,Taylor Raddysh,R,WSH,26,82,17,19,36
93,8475149,Marcus Johansson,L,MIN,34,82,17,19,36
93,8477989,Christian Dvorak,C,MTL,28,82,15,21,36
93,8475764,Cam Fowler,D,ANA,33,82,0,36,36
93,8477426,Nicholas Paul,L,TBL,29,82,19,16,35
93,8480748,Kiefer Sherwood,L,VAN,29,82,18,17,35
93,8480829,Jesperi Kotkaniemi,C,CAR,24,82,17,18,35
93,8477952,Robby Fabbri,C,ANA,28,82,15,20,35
93,8477947,Sonny Milano,L,WSH,28,82,15,20,35
93,8483431,Logan Cooley,C,UTA,20,82,14,21,35
93,8482105,Jake Sanderson,D,OTT,22,82,13,22,35
93,8470621,Corey Perry,R,EDM,39,82,13,22,35
93,8480009,Eeli Tolvanen,R,SEA,25,82,12,23,35
93,8475171,Oliver Ekman-Larsson,D,TOR,33,82,12,23,35
93,8476329,Travis Boyd,C,MIN,31,82,9,26,35
93,8478911,Matt Roy,D,WSH,29,82,9,26,35
93,8478882,Vladislav Gavrikov,D,LAK,29,82,7,28,35
93,8480043,Timothy Liljegren,D,TOR,25,82,5,30,35
93,8480281,Alexey Toropchenko,R,STL,25,82,23,11,34
93,8477450,Jason Dickinson,C,CHI,29,82,20,14,34
93,8482089,Jake Neighbours,L,STL,22,82,19,15,34
93,8481704,Juuso Parssinen,C,NSH,23,82,16,18,34
93,8473422,Nick Foligno,L,CHI,37,82,16,18,34
93,8480802,Ryan McLeod,C,BUF,25,82,14,20,34
93,8482117,Lukas Reichel,L,CHI,22,82,11,23,34
93,8482655,J.J. Moser,D,TBL,24,82,3,31,34
93,8476873,Mark Jankowski,C,NSH,30,82,19,14,33
93,8480849,Barrett Hayton,C,UTA,24,82,17,16,33
93,8481582,Nicholas Robertson,L,TOR,23,82,17,16,33
93,8479661,Tanner Jeannot,L,LAK,27,82,17,16,33
93,8480995,Pontus Holmberg,R,TOR,25,82,17,16,33
93,8480806,Isac Lundestrom,C,ANA,25,82,17,16,33
93,8474149,Evgenii Dadonov,R,DAL,35,82,16,17,33
93,8478020,Michael Amadio,C,OTT,28,82,15,18,33
93,8477839,Conor Sheary,L,TBL,32,82,15,18,33
93,8482705,Cole Sillinger,C,CBJ,21,82,14,19,33
93,8477498,Darnell Nurse,D,EDM,29,82,12,21,33
93,8480185,Eetu Luostarinen,C,FLA,26,82,10,23,33
93,8480855,Jack McBain,C,UTA,24,82,16,16,32
93,8475763,Kevin Hayes,R,PIT,32,82,15,17,32
93,8480074,Alexandre Texier,C,STL,25,82,15,17,32
93,8478891,Mason Appleton,C,WPG,28,82,14,18,32
93,8480068,Ryan Poehling,C,PHI,25,82,14,18,32
93,8481656,Aliaksei Protas,C,WSH,23,82,11,21,32
93,8479351,Sam Steel,C,DAL,26,82,11,21,32
93,8475200,Dmitry Orlov,D,CAR,33,82,10,22,32
93,8477919,Frederick Gaudreau,C,MIN,31,82,10,22,32
93,8480873,Rasmus Sandin,D,WSH,24,82,3,29,32
93,8480893,Kirill Marchenko,R,CBJ,24,82,22,9,31
93,8476960,Andreas Athanasiou,C,CHI,30,82,19,12,31
93,8481604,Pavel Dorofeyev,L,VGK,24,82,18,13,31
93,8476469,Joel Armia,R,MTL,31,82,18,13,31
93,8479365,Trent Frederic,C,BOS,26,82,14,17,31
93,8479996,Cody Glass,C,NSH,25,82,13,18,31
93,8479316,Luke Kunin,C,SJS,27,82,13,18,31
93,8479591,Michael Eyssimont,C,TBL,28,82,17,13,30
93,8478508,Yakov Trenin,C,MIN,27,82,16,14,30
93,8481624,Ilya Mikheyev,R,CHI,30,82,15,15,30
93,8476278,Colin Blackwell,C,DAL,31,82,15,15,30
93,8481013,Jonatan Berggren,R,DET,24,82,14,16,30
93,8477903,Garnet Hathaway,R,PHI,33,82,14,16,30
93,8478133,Jake Evans,C,MTL,28,82,12,18,30
93,8478458,Jack Roslovic,C,CAR,27,82,9,21,30
93,8475343,Nic Dowd,C,WSH,34,82,9,21,30
93,8476885,Jacob Trouba,D,NYR,30,82,9,21,30
93,8477220,Nate Schmidt,D,FLA,33,82,8,22,30
93,8480871,Adam Boqvist,D,FLA,24,82,7,23,30
93,8482079,Marco Rossi,C,MIN,23,82,21,8,29
93,8475848,Brendan Gallagher,R,MTL,32,82,15,14,29
93,8477508,Curtis Lazar,C,NJD,29,82,14,15,29
93,8478463,Anthony Beauvillier,L,PIT,27,82,13,16,29
93,8474189,Lars Eller,C,PIT,35,82,13,16,29
93,8476374,Sean Kuraly,C,CBJ,31,82,13,16,29
93,8479414,Nathan Bastian,R,NJD,27,82,13,16,29
93,8476897,Oskar Sundqvist,C,STL,30,82,12,17,29
93,8481580,Connor McMichael,C,WSH,23,82,12,17,29
93,8482062,Cole Smith,L,NSH,29,82,12,17,29
93,8476474,Stefan Noesen,R,NJD,31,82,9,20,29
93,8480336,Sean Walker,D,CAR,30,82,9,20,29
93,8483445,Cutter Gauthier,L,ANA,20,82,9,20,29
93,8480878,Nils Lundkvist,D,DAL,24,82,9,20,29
93,8476463,Jonas Brodin,D,MIN,31,82,7,22,29
93,8481606,Jordan Spence,D,LAK,23,82,7,22,29
93,8476917,Adam Pelech,D,NYI,30,82,3,26,29
93,8476889,Radek Faksa,C,STL,30,82,17,11,28
93,8481028,Martin Pospisil,C,CGY,25,82,14,14,28
93,8476981,Josh Anderson,R,MTL,30,82,13,15,28
93,8474716,Jared Spurgeon,D,MIN,35,82,11,17,28
93,8481522,Peyton Krebs,C,BUF,23,82,11,17,28
93,8477406,Mattias Janmark,C,EDM,32,82,10,18,28
93,8474574,Tyler Myers,D,VAN,34,82,10,18,28
93,8480003,Jesper Boqvist,C,FLA,26,82,9,19,28
93,8482141,Lukas Cormier,D,VGK,22,82,7,21,28
93,8476854,Hampus Lindholm,D,BOS,30,82,6,22,28
93,8483565,Nick Blankenburg,D,NSH,26,82,6,22,28
93,8479402,Jake Bean,D,CGY,26,82,4,24,28
93,8479976,Juuso Valimaki,D,UTA,26,82,3,25,28
93,8476892,Colton Parayko,D,STL,31,82,0,28,28
93,8483515,Juraj Slafkovsky,L,MTL,20,82,17,10,27
93,8484145,Zach Benson,L,BUF,19,82,17,10,27
93,8480835,Jack Drury,C,CAR,24,82,15,12,27
93,8480448,Parker Kelly,L,COL,25,82,15,12,27
93,8481477,Nico Sturm,C,SJS,29,82,14,13,27
93,8476624,Barclay Goodrow,C,SJS,31,82,9,18,27
93,8478013,Jake Walman,D,SJS,28,82,8,19,27
93,8476902,Esa Lindell,D,DAL,30,82,7,20,27
93,8477488,Brett Pesce,D,NJD,30,82,6,21,27
93,8480860,Kevin Bahl,D,CGY,24,82,6,21,27
93,8477506,Ryan Pulock,D,NYI,30,82,6,21,27
93,8477969,Marcus Pettersson,D,PIT,28,82,5,22,27
93,8479398,Samuel Girard,D,COL,26,82,3,24,27
93,8474013,Ian Cole,D,UTA,35,82,3,24,27
93,8476331,Dylan DeMelo,D,WPG,31,82,3,24,27
93,8481032,Paul Cotter,C,NJD,25,82,15,11,26
93,8476918,Jimmy Vesey,L,NYR,31,82,13,13,26
93,8476419,Jean-Gabriel Pageau,C,NYI,32,82,12,14,26
93,8475231,Casey Cizikas,C,NYI,33,82,12,14,26
93,8476921,Jordan Martinook,L,CAR,32,82,11,15,26
93,8475220,Marcus Foligno,L,MIN,33,82,11,15,26
93,8482762,Simon Edvinsson,D,DET,21,82,11,15,26
93,8477845,Trevor van Riemsdyk,D,WSH,33,82,7,19,26
93,8482122,Brock Faber,D,MIN,22,82,5,21,26
93,8480807,Mattias Samuelsson,D,BUF,24,82,2,24,26
93,8481186,Logan O'Connor,R,COL,28,82,13,12,25
93,8479353,Brett Howden,C,VGK,26,82,11,14,25
93,8482858,Ryker Evans,D,SEA,23,82,11,14,25
93,8481481,Blake Lizotte,C,PIT,27,82,10,15,25
93,8478569,Noel Acciari,C,PIT,33,82,9,16,25
93,8476422,Mike Reilly,D,NYI,31,82,8,17,25
93,8478211,Dryden Hunt,L,CGY,29,82,6,19,25
93,8481014,Alexander Romanov,D,NYI,24,82,5,20,25
93,8482142,Jamie Drysdale,D,PHI,22,82,4,21,25
93,8478136,Jake Middleton,D,MIN,28,82,4,21,25
93,8475188,Brayden McNabb,D,VGK,33,82,2,23,25
93,8479393,Noah Gregor,C,OTT,26,82,14,10,24
93,8475842,Sam Carrick,C,NYR,32,82,13,11,24
93,8477369,Carson Soucy,D,VAN,30,82,10,14,24
93,8482111,Justin Barron,D,MTL,23,82,8,16,24
93,8483490,Pavel Mintyukov,D,ANA,21,82,8,16,24
93,8479980,Nicolas Hague,D,VGK,26,82,7,17,24
93,8481524,Bowen Byram,D,BUF,23,82,5,19,24
93,8482516,Matthew Kessel,D,STL,24,82,5,19,24
93,8482087,Kaiden Guhle,D,MTL,22,82,4,20,24
93,8474090,Brendan Smith,D,DAL,35,82,4,20,24
93,8475181,Nick Leddy,D,STL,33,82,2,22,24
93,8476878,Zemgus Girgensons,L,TBL,30,82,12,11,23
93,8484166,Adam Fantilli,C,CBJ,20,82,12,11,23
93,8481641,Joel Kiviranta,L,COL,28,82,12,11,23
93,8478434,Keegan Kolesar,R,VGK,27,82,9,14,23
93,8476457,Adam Larsson,D,SEA,32,82,7,16,23
93,8477392,Hudson Fasching,R,NYI,29,82,7,16,23
93,8478443,Brandon Carlo,D,BOS,28,82,5,18,23
93,8479359,Beck Malenstyn,L,BUF,26,82,5,18,23
93,8479983,Mario Ferraro,D,SJS,26,82,5,18,23
93,8481567,Henry Thrun,D,SJS,23,82,4,19,23
93,8481708,Zac Jones,D,NYR,24,82,4,19,23
93,8479324,Ryan Lindgren,D,NYR,26,82,2,21,23
93,8476429,Scott Mayfield,D,NYI,32,82,1,22,23
93,8484153,Leo Carlsson,C,ANA,20,82,14,8,22
93,8478432,Christian Fischer,R,DET,27,82,9,13,22
93,8480144,David Kampf,C,TOR,29,82,8,14,22
93,8484203,Bradly Nadeau,L,CAR,19,82,8,14,22
93,8484911,Collin Graf,R,SJS,22,82,8,14,22
93,8478840,Will Borgen,D,SEA,28,82,5,17,22
93,8480049,Dylan Samberg,D,WPG,25,82,5,17,22
93,8478468,Jeremy Lauzon,D,NSH,27,82,5,17,22
93,8482166,Shakir Mukhamadullin,D,SJS,22,82,4,18,22
93,8483482,Tristan Luneau,D,ANA,20,82,4,18,22
93,8481568,Alex Vlasic,D,CHI,23,82,3,19,22
93,8481122,Simon Benoit,D,TOR,26,82,3,19,22
93,8478851,Alexandre Carrier,D,NSH,28,82,2,20,22
93,8475279,Ben Chiarot,D,DET,33,82,2,20,22
93,8483524,Shane Wright,C,SEA,20,82,14,7,21
93,8482666,Scott Morrow,D,CAR,22,82,13,8,21
93,8482624,Daniil Miromanov,D,CGY,27,82,12,9,21
93,8473453,Trevor Lewis,C,LAK,37,82,12,9,21
93,8474715,Cam Atkinson,R,TBL,35,82,11,10,21
93,8482125,Alexander Holtz,R,VGK,22,82,11,10,21
93,8477015,Connor Brown,R,EDM,30,82,10,11,21
93,8480980,Connor Dewar,C,TOR,25,82,8,13,21
93,8481699,Aku Raty,R,UTA,23,82,8,13,21
93,8476441,Joel Edmundson,D,LAK,31,82,6,15,21
93,8482807,Ethan Del Mastro,D,CHI,21,82,5,16,21
93,8476312,Josh Manson,D,COL,33,82,4,17,21
93,8470600,Ryan Suter,D,STL,39,82,4,17,21
93,8474151,Ryan McDonagh,D,TBL,35,82,3,18,21
93,8483495,Simon Nemec,D,NJD,20,82,3,18,21
93,8479369,Andrew Peeke,D,BOS,26,82,2,19,21
93,8476967,Brett Kulak,D,EDM,30,82,1,20,21
93,8477435,Ryan Graves,D,PIT,29,82,0,21,21
93,8482155,Alex Laferriere,R,LAK,23,82,15,5,20
93,8482809,Jackson Blake,R,CAR,21,82,11,9,20
93,8482077,Dylan Holloway,L,EDM,23,82,9,11,20
93,8482733,Logan Mailloux,D,MTL,31,82,7,13,20
93,8474673,TJ Brodie,D,CHI,34,82,4,16,20
93,8483457,Lane Hutson,D,MTL,20,82,4,16,20
93,8478178,Darren Raddysh,D,TBL,28,82,4,16,20
93,8480073,Erik Brannstrom,D,COL,25,82,4,16,20
93,8475233,David Savard,D,MTL,34,82,2,18,20
93,8482145,Mavrik Bourque,C,DAL,22,82,12,7,19
93,8482074,Connor Zary,C,CGY,23,82,11,8,19
93,8477353,Tyler Motte,C,DET,29,82,9,10,19
93,8482679,Matt Coronato,R,CGY,22,82,8,11,19
93,8483493,Frank Nazar,C,CHI,20,82,7,12,19
93,8484149,Gavin Brindley,C,CBJ,20,82,7,12,19
93,8480789,Oliver Wahlstrom,R,NYI,24,82,6,13,19
93,8479442,Troy Stecher,D,EDM,30,82,6,13,19
93,8480222,Sebastian Aho,D,PIT,28,82,5,14,19
93,8476467,Jamie Oleksiak,D,SEA,32,82,4,15,19
93,8475177,Calvin de Haan,D,COL,33,82,3,16,19
93,8477335,Kyle Burroughs,D,LAK,29,82,3,16,19
93,8476879,Cody Ceci,D,EDM,31,82,2,17,19
93,8480172,Jan Rutta,D,SJS,34,82,2,17,19
93,8482259,Bobby McMann,C,TOR,28,82,11,7,18
93,8480025,MacKenzie Entwistle,R,FLA,25,82,11,7,18
93,8482659,Josh Doan,R,UTA,22,82,9,9,18
93,8481553,Bobby Brink,R,PHI,23,82,8,10,18
93,8478399,Jonas Siegenthaler,D,NJD,27,82,5,13,18
93,8476525,Colin Miller,D,WPG,32,82,4,14,18
93,8476891,Matt Grzelcyk,D,PIT,30,82,4,14,18
93,8480796,Martin Fehervary,D,WSH,25,82,4,14,18
93,8480035,Henri Jokiharju,D,BUF,25,82,2,16,18
93,8480879,Jacob Bernard-Docker,D,OTT,24,82,2,16,18
93,8481601,Simon Holmstrom,R,NYI,23,82,10,7,17
93,8481517,Brett Leason,R,ANA,25,82,9,8,17
93,8482749,Joshua Roy,R,MTL,21,82,9,8,17
93,8475855,Jesper Fast,R,CAR,33,82,8,9,17
93,8482702,Logan Stankoven,C,DAL,21,82,7,10,17
93,8482101,Danil Gushchin,L,SJS,22,82,7,10,17
93,8483763,Maksymilian Szuber,D,UTA,22,82,6,11,17
93,8483468,Jiri Kulich,C,BUF,20,82,6,11,17
93,8476473,Connor Murphy,D,CHI,31,82,6,11,17
93,8482073,Braden Schneider,D,NYR,23,82,4,13,17
93,8481178,Egor Zamula,D,PHI,24,82,3,14,17
93,8475324,Nick Jensen,D,OTT,34,82,2,15,17
93,8474567,Zach Bogosian,D,MIN,34,82,2,15,17
93,8475462,Radko Gudas,D,ANA,34,82,1,16,17
93,8477505,Alexander Wennberg,C,SJS,30,82,9,7,16
93,8483505,Matthew Poitras,C,BOS,20,82,8,8,16
93,8476442,Matt Nieto,L,PIT,32,82,6,10,16
93,8477507,Nikita Zadorov,D,BOS,29,82,4,12,16
93,8482803,Olen Zellweger,D,ANA,21,82,4,12,16
93,8478507,John Marino,D,UTA,27,82,3,13,16
93,8480950,Ilya Lyubushkin,D,DAL,30,82,3,13,16
93,8479576,Vincent Desharnais,D,VAN,28,82,3,13,16
93,8478859,Niko Mikkola,D,FLA,28,82,2,14,16
93,8480021,Jack Studnicka,C,LAK,25,82,7,8,15
93,8476858,Phillip Di Giuseppe,L,VAN,31,82,6,9,15
93,8483567,Georgii Merkulov,C,BOS,24,82,6,9,15
93,8482153,Brendan Brisson,C,VGK,23,82,6,9,15
93,8477931,Tomas Nosek,L,FLA,32,82,5,10,15
93,8475790,Erik Gudbranson,D,CBJ,32,82,4,11,15
93,8480870,Bo Groulx,C,NYR,24,82,4,11,15
93,8483499,Liam Ohgren,L,MIN,20,82,4,11,15
93,8477365,Connor Clifton,D,BUF,29,82,3,12,15
93,8477499,Rasmus Ristolainen,D,PHI,30,82,3,12,15
93,8480246,Nick Perbix,D,TBL,26,82,2,13,15
93,8479998,Mikey Anderson,D,LAK,25,82,2,13,15
93,8481605,Jackson LaCombe,D,ANA,23,82,1,14,15
93,8483397,Marc McLaughlin,C,BOS,25,82,7,7,14
93,8479291,Kevin Rooney,C,CGY,31,82,6,8,14
93,8476372,Nick Seeler,D,PHI,31,82,4,10,14
93,8482118,Sam Colangelo,R,ANA,23,82,3,11,14
93,8478416,Erik Cernak,D,TBL,27,82,2,12,14
93,8475690,Chris Tanev,D,TOR,35,82,1,13,14
93,8479638,Justin Brazeau,R,BOS,26,82,8,5,13
93,8482712,Oskar Olausson,R,COL,22,82,6,7,13
93,8475762,Derek Forbort,D,VAN,32,82,5,8,13
93,8483471,Brad Lambert,C,WPG,31,82,5,8,13
93,8480834,Ty Emberson,D,SJS,24,82,1,12,13
93,8482070,Mitchell Chaffee,R,TBL,26,82,6,6,12
93,8477938,Haydn Fleury,D,WPG,28,82,5,7,12
93,8471677,Jack Johnson,D,CBJ,37,82,3,9,12
93,8475718,Justin Holl,D,DET,32,82,1,11,12
93,8482470,Ilya Solovyov,D,CGY,24,82,6,5,11
93,8482859,Zack Ostapchuk,C,OTT,21,82,4,7,11
93,8475455,Brenden Dillon,D,NJD,34,82,0,11,11
93,8482713,Mackie Samoskevich,R,FLA,22,82,7,3,10
93,8483012,Logan Morrison,C,SEA,22,82,3,7,10
93,8483460,David Jiricek,D,CBJ,21,82,3,7,10
93,8483489,Fraser Minten,C,TOR,31,82,3,7,10
93,8478874,Adam Gaudette,C,OTT,28,82,2,8,10
93,8478450,Parker Wotherspoon,D,BOS,27,82,1,9,10
93,8477034,Jaycob Megna,D,FLA,32,82,0,10,10
93,8476822,Luke Glendening,C,TBL,35,82,1,8,9
93,8483466,Kevin Korchinski,D,CHI,20,82,3,5,8
93,8480990,Declan Chisholm,D,MIN,24,82,2,6,8
93,8474612,Travis Hamonic,D,OTT,34,82,0,6,6
93,8482787,Nikita Chibrikov,R,WPG,31,82,1,3,4
93,8474062,Riley Nash,C,NYR,35,82,1,3,4
93,8470794,Joe Pavelski,C,,40,0,0,0,0
93,8481703,Valtteri Puustinen,R,PIT,25,0,0,0,0
93,8477950,Tony DeAngelo,D,,29,0,0,0,0
93,8481577,Philip Tomasino,C,NSH,23,0,0,0,0
93,8475197,Tyson Barrie,D,,33,0,0,0,0
93,8471218,Blake Wheeler,R,,38,0,0,0,0
93,8474157,Max Pacioretty,L,,36,0,0,0,0
93,8478466,Daniel Sprong,R,VAN,27,0,0,0,0
93,8475744,Evgeny Kuznetsov,C,,32,0,0,0,0
93,8481019,David Gustafsson,C,WPG,24,0,0,0,0
93,8475906,John Klingberg,D,,32,0,0,0,0
93,8479348,Kale Clague,D,BUF,26,0,0,0,0
93,8476952,Dominic Toninato,C,WPG,30,0,0,0,0
93,8473473,Milan Lucic,L,,36,0,0,0,0
93,8474037,James van Riemsdyk,L,,35,0,0,0,0
93,8474602,Justin Schultz,D,,34,0,0,0,0
93,8482222,Alexander Barabanov,L,,30,0,0,0,0
93,8479372,Josh Mahura,D,SEA,26,0,0,0,0
93,8479982,Conor Timmins,D,TOR,26,0,0,0,0
93,8474031,Kevin Shattenkirk,D,,35,0,0,0,0
93,8480008,Adam Ruzicka,C,,25,0,0,0,0
93,8481059,Scott Perunovich,D,STL,26,0,0,0,0
93,8480884,Calen Addison,D,,24,0,0,0,0
93,8476994,Vinnie Hinostroza,C,NSH,30,0,0,0,0
93,8478452,Caleb Jones,D,LAK,27,0,0,0,0
93,8480157,Calle Rosen,D,COL,30,0,0,0,0
93,8481609,Vladislav Kolyachonok,D,UTA,23,0,0,0,0
93,8479415,Michael McLeod,C,,26,0,0,0,0
93,8476919,Chris Tierney,C,,30,0,0,0,0
93,8479639,Dylan Coghlan,D,WPG,26,0,0,0,0
93,8478146,Matthew Highmore,C,OTT,28,0,0,0,0
93,8478970,Jalen Chatfield,D,CAR,28,0,0,0,0
93,8480205,Emil Bemstrom,C,PIT,25,0,0,0,0
93,8474884,Mike Hoffman,C,,35,0,0,0,0
93,8471274,Alex Goligoski,D,,39,0,0,0,0
93,8478104,Sammy Blais,L,,28,0,0,0,0
93,8474870,Tyler Johnson,C,,34,0,0,0,0
93,8476913,Devin Shore,C,MIN,30,0,0,0,0
93,8481598,Philip Broberg,D,EDM,23,0,0,0,0
93,8480058,Pierre-Olivier Joseph,D,STL,25,0,0,0,0
93,8480891,Michael Kesselring,D,UTA,24,0,0,0,0
93,8477979,Nicolas Aube-Kubel,R,BUF,28,0,0,0,0
93,8476871,Tanner Pearson,L,,32,0,0,0,0
93,8476393,Nick Cousins,C,,31,0,0,0,0
93,8479977,Kailer Yamamoto,R,,26,0,0,0,0
93,8479543,Michael Pezzetta,L,MTL,26,0,0,0,0
93,8477018,Ben Hutton,D,VGK,31,0,0,0,0
93,8480762,Eric Robinson,L,CAR,29,0,0,0,0
93,8474034,Pat Maroon,L,CHI,36,0,0,0,0
93,8481058,Jesse Ylönen,R,,25,0,0,0,0
93,8475179,Dmitry Kulikov,D,FLA,34,0,0,0,0
93,8481527,Kaedan Korczak,D,VGK,23,0,0,0,0
93,8473449,Kyle Okposo,R,,36,0,0,0,0
93,8482192,Isaak Phillips,D,CHI,23,0,0,0,0
93,8480727,Zach Whitecloud,D,VGK,28,0,0,0,0
93,8479346,Dillon Dube,C,,26,0,0,0,0
93,8480821,Filip Zadina,R,,25,0,0,0,0
93,8480001,Urho Vaakanainen,D,ANA,25,0,0,0,0
93,8470966,Mark Giordano,D,,41,0,0,0,0
93,8480853,Liam Foudy,C,,24,0,0,0,0
93,8475225,Craig Smith,C,CHI,35,0,0,0,0
93,8479972,Mason Shaw,C,WPG,26,0,0,0,0
93,8478451,Ethan Bear,D,WSH,27,0,0,0,0
93,8474040,Sam Gagner,C,,35,0,0,0,0
93,8480196,Jacob Bryson,D,BUF,27,0,0,0,0
93,8479984,Cal Foote,D,,26,0,0,0,0
93,8480011,Klim Kostin,C,SJS,25,0,0,0,0
93,8482176,Wyatt Kaiser,D,CHI,22,0,0,0,0
93,8476988,Matt Benning,D,SJS,30,0,0,0,0
93,8479370,Tyson Jost,C,CAR,26,0,0,0,0
93,8477464,Nic Petan,C,,29,0,0,0,0
93,8477380,Jonny Brodzinski,C,NYR,31,0,0,0,0
93,8480070,Ian Mitchell,D,BOS,25,0,0,0,0
93,8479315,Joey Anderson,R,CHI,26,0,0,0,0
93,8478099,Kevin Labanc,R,,29,0,0,0,0
93,8476874,Olli Maatta,D,DET,30,0,0,0,0
93,8475208,Brian Dumoulin,D,ANA,33,0,0,0,0
93,8478430,Oliver Kylington,D,,27,0,0,0,0
93,8479536,Axel Jonsson-Fjallby,L,WPG,26,0,0,0,0
93,8479671,Mathieu Olivier,R,CBJ,27,0,0,0,0
93,8471709,Marc-Edouard Vlasic,D,SJS,37,0,0,0,0
93,8479328,Julien Gauthier,R,NYI,27,0,0,0,0
93,8478421,A.J. Greer,L,FLA,28,0,0,0,0
93,8477573,Nathan Walker,L,STL,30,0,0,0,0
93,8481537,Nikita Okhotiuk,D,CGY,24,0,0,0,0
93,8474166,Alec Martinez,D,CHI,37,0,0,0,0
93,8470610,Zach Parise,L,,40,0,0,0,0
93,8477478,William Carrier,L,CAR,30,0,0,0,0
93,8479344,Jesse Puljujarvi,R,PIT,26,0,0,0,0
93,8480887,Jordan Harris,D,MTL,24,0,0,0,0
93,8478502,Dennis Gilbert,D,BUF,28,0,0,0,0
93,8482730,Brandt Clarke,D,LAK,21,0,0,0,0
93,8480355,Mark Kastelic,C,BOS,25,0,0,0,0
93,8475750,Jon Merrill,D,MIN,32,0,0,0,0
93,8475164,Jakob Silfverberg,R,,34,0,0,0,0
93,8477944,Jakub Vrana,L,,28,0,0,0,0
93,8479439,Jacob MacDonald,D,COL,31,0,0,0,0
93,8474568,Luke Schenn,D,NSH,35,0,0,0,0
93,8478454,Noah Juulsen,D,VAN,27,0,0,0,0
93,8475752,Tyler Pitlick,C,,33,0,0,0,0
93,8482148,Hendrix Lapierre,C,WSH,22,0,0,0,0
93,8481167,Brayden Pachal,D,CGY,25,0,0,0,0
93,8478043,Sam Lafferty,C,BUF,29,0,0,0,0
93,8479321,Lucas Johansen,D,,27,0,0,0,0
93,8471699,Andrew Cogliano,C,,37,0,0,0,0
93,8481521,Ronnie Attard,D,PHI,25,0,0,0,0
93,8481161,Jake Christiansen,D,CBJ,25,0,0,0,0
93,8479458,Nikita Zaitsev,D,,33,0,0,0,0
93,8479619,Michael Carcone,L,UTA,28,0,0,0,0
93,8479026,Philippe Myers,D,TOR,27,0,0,0,0
93,8477330,Dominik Kubalik,L,,29,0,0,0,0
93,8481617,Vasily Podkolzin,R,VAN,23,0,0,0,0
93,8481701,Santeri Hatakka,D,NJD,23,0,0,0,0
93,8479514,Rem Pitlick,C,,27,0,0,0,0
93,8477446,Michael McCarron,R,NSH,29,0,0,0,0
93,8470604,Jeff Carter,C,,39,0,0,0,0
93,8482241,Radim Zohorna,L,,28,0,0,0,0
93,8480289,Morgan Barron,C,WPG,26,0,0,0,0
93,8479379,Givani Smith,R,SJS,26,0,0,0,0
93,8480216,Jacob Peterson,C,,25,0,0,0,0
93,8477851,Jordan Oesterle,D,BOS,32,0,0,0,0
93,8484258,Sam Malinski,D,COL,26,0,0,0,0
93,8478904,Steven Lorentz,C,,28,0,0,0,0
93,8482095,Tyler Kleven,D,OTT,22,0,0,0,0
93,8480848,Ty Dellandrea,C,SJS,24,0,0,0,0
93,8476884,Derrick Pouliot,D,,30,0,0,0,0
93,8479336,Carl Grundstrom,R,SJS,27,0,0,0,0
93,8482964,Arber Xhekaj,D,MTL,23,0,0,0,0
93,8471686,Marc Staal,D,,37,0,0,0,0
93,8477887,Patrick Brown,C,BOS,32,0,0,0,0
93,8478495,Denis Gurianov,R,,27,0,0,0,0
93,8473504,Cal Clutterbuck,R,,37,0,0,0,0
93,8481550,Adam Beckman,L,NJD,23,0,0,0,0
93,8480845,Rasmus Kupari,C,WPG,24,0,0,0,0
93,8474009,Nick Bonino,C,,36,0,0,0,0
93,8478585,Derek Ryan,C,EDM,38,0,0,0,0
93,8477962,Brendan Lemieux,L,CAR,28,0,0,0,0
93,8482861,Vincent Iorio,D,WSH,22,0,0,0,0
93,8479378,Logan Stanley,D,WPG,26,0,0,0,0
93,8473446,Erik Johnson,D,PHI,36,0,0,0,0
93,8481743,Marc Del Gaizo,D,NSH,25,0,0,0,0
93,8477384,Josh Brown,D,EDM,30,0,0,0,0
93,8482165,Yan Kuznetsov,D,CGY,22,0,0,0,0
93,8478424,Jansen Harkins,C,ANA,27,0,0,0,0
93,8482144,Jack Thompson,D,SJS,22,0,0,0,0
93,8478512,Austin Czarnik,C,,32,0,0,0,0
93,8477527,Ross Johnston,L,ANA,30,0,0,0,0
93,8479383,Boris Katchouk,L,,26,0,0,0,0
93,8482094,Daemon Hunt,D,MIN,22,0,0,0,0
93,8481719,Maxwell Crozier,D,TBL,24,0,0,0,0
93,8480192,Johnathan Kovacevic,D,NJD,27,0,0,0,0
93,8479376,Victor Mete,D,,26,0,0,0,0
93,8482511,Mason Lohrei,D,BOS,23,0,0,0,0
93,8475825,Jani Hakanpää,D,,32,0,0,0,0
93,8478021,William Lagesson,D,DET,28,0,0,0,0
93,8475795,Dylan McIlrath,D,WSH,32,0,0,0,0
93,8477846,Ryan Carpenter,C,,33,0,0,0,0
93,8481056,Spencer Stastney,D,NSH,24,0,0,0,0
93,8481564,Ryan Johnson,D,BUF,23,0,0,0,0
93,8478017,Mark Friedman,D,VAN,29,0,0,0,0
93,8479320,Max Lajoie,D,SEA,27,0,0,0,0
93,8480075,Cameron Crotty,D,MIN,25,0,0,0,0
93,8484287,Cole McWard,D,VAN,23,0,0,0,0
93,8484254,Akito Hirose,D,VAN,25,0,0,0,0
93,8483407,Brandon Scanlin,D,NYR,25,0,0,0,0
93,8480274,Philip Kemp,D,EDM,25,0,0,0,0
93,8479522,Hardy Haman Aktell,D,WSH,26,0,0,0,0
93,8480007,Jonas Rondbjerg,R,VGK,25,0,0,0,0
93,8477454,Adam Erne,L,,29,0,0,0,0
93,8481679,Maxence Guenette,D,OTT,23,0,0,0,0
93,8480441,Trey Fix-Wolansky,R,CBJ,25,0,0,0,0
93,8483546,Marshall Rifai,D,TOR,26,0,0,0,0
93,8480084,Nick DeSimone,D,NJD,30,0,0,0,0
93,8481030,Jack St. Ivany,D,PIT,25,0,0,0,0
93,8481592,Jakob Pelletier,L,CGY,23,0,0,0,0
93,8478011,Louie Belpedio,D,PHI,28,0,0,0,0
93,8477930,Pierre-Edouard Bellemare,L,,39,0,0,0,0
93,8484321,Nikolas Matinpalo,D,OTT,26,0,0,0,0
93,8482067,Connor Mackey,D,NYR,28,0,0,0,0
93,8481806,Louis Crevier,D,CHI,23,0,0,0,0
93,8484326,Patrik Koch,D,UTA,28,0,0,0,0
93,8477971,Andreas Englund,D,LAK,28,0,0,0,0
93,8481751,Lukas Rousek,R,BUF,25,0,0,0,0
93,8481006,Tyler Tucker,D,STL,24,0,0,0,0
93,8476867,Brendan Gaunce,C,MIN,30,0,0,0,0
93,8479520,Brandon Duhaime,R,WSH,27,0,0,0,0
93,8477073,Kurtis MacDermid,L,NJD,30,0,0,0,0
93,8480874,Adam Ginning,D,PHI,24,0,0,0,0
93,8477473,Justin Bailey,R,SJS,29,0,0,0,0
93,8479066,Ryan Lomberg,L,CGY,30,0,0,0,0
93,8477070,Liam O'Brien,C,UTA,30,0,0,0,0
93,8474618,Marco Scandella,D,,34,0,0,0,0
93,8475797,Jarred Tinordi,D,,32,0,0,0,0
93,8481441,Joe Snively,C,DET,28,0,0,0,0
93,8477244,Chad Ruhwedel,D,NYR,34,0,0,0,0
93,8479772,Zack MacEwen,R,OTT,28,0,0,0,0
93,8481147,Reese Johnson,C,MIN,26,0,0,0,0
93,8481043,Cole Koepke,L,BOS,26,0,0,0,0
93,8483619,Filip Roos,D,OTT,25,0,0,0,0
93,8481541,Samuel Bolduc,D,NYI,24,0,0,0,0
93,8477810,Joel Hanley,D,CGY,33,0,0,0,0
93,8476907,Mackenzie MacEachern,L,,30,0,0,0,0
93,8482652,Walker Duehr,R,CGY,27,0,0,0,0
93,8477126,Jayson Megna,C,,34,0,0,0,0
93,8483398,Declan Carlile,D,TBL,31,0,0,0,0
93,8482929,Emil Lilleberg,D,TBL,23,0,0,0,0
93,8480880,Jakub Lauko,C,MIN,24,0,0,0,0
93,8480245,Olle Lycksell,R,PHI,25,0,0,0,0
93,8480252,Cole Guttman,C,CHI,25,0,0,0,0
93,8477467,Gustav Olofsson,D,SEA,30,0,0,0,0
93,8479968,Vinni Lettieri,C,BOS,29,0,0,0,0
93,8478400,Colin White,C,,27,0,0,0,0
93,8475755,Alexander Petrovic,D,DAL,32,0,0,0,0
93,8481812,Nikolai Knyzhov,D,,27,0,0,0,0
93,8481593,Jayden Struble,D,MTL,23,0,0,0,0
93,8481532,Alex Turcotte,C,LAK,23,0,0,0,0
93,8482126,Emil Andrae,D,PHI,31,0,0,0,0
93,8479944,Zach Aston-Reese,C,VGK,30,0,0,0,0
93,8471817,Ryan Reaves,R,TOR,37,0,0,0,0
93,8481206,John Ludvig,D,PIT,24,0,0,0,0
93,8481599,Victor Soderstrom,D,UTA,23,0,0,0,0
93,8480292,Carson Meyer,R,ANA,27,0,0,0,0
93,8482496,Nils Aman,C,VAN,24,0,0,0,0
93,8479718,Alex Barré-Boulet,C,MTL,27,0,0,0,0
93,8479994,Jaret Anderson-Dolan,C,WPG,25,0,0,0,0
93,8480184,Gustav Lindstrom,D,,26,0,0,0,0
93,8480890,Jan Jenik,R,OTT,24,0,0,0,0
93,8478067,Oskar Lindblom,L,,28,0,0,0,0
93,8476934,Brock McGinn,L,ANA,30,0,0,0,0
93,8479985,Cale Fleury,D,SEA,26,0,0,0,0
93,8484304,Uvis Balinskis,D,FLA,28,0,0,0,0
93,8479981,Jonah Gadjovich,L,FLA,26,0,0,0,0
93,8481716,Dmitri Voronkov,L,CBJ,24,0,0,0,0
93,8474709,Matt Martin,L,,35,0,0,0,0
93,8482634,Alex Steeves,C,TOR,25,0,0,0,0
93,8480823,Alexander Alexeyev,D,WSH,25,0,0,0,0
93,8477541,Dakota Mermis,D,TOR,30,0,0,0,0
93,8483491,Ivan Miroshnichenko,L,WSH,20,0,0,0,0
93,8478477,Mitchell Stephens,C,SEA,27,0,0,0,0
93,8481543,Nikita Alexandrov,C,STL,24,0,0,0,0
93,8479423,Alex Nylander,L,,26,0,0,0,0
93,8482451,Mikael Pyyhtia,L,CBJ,23,0,0,0,0
93,8478831,Kevin Stenlund,C,UTA,28,0,0,0,0
93,8480306,Grant Hutton,D,NYI,29,0,0,0,0
93,8478028,Fredrik Olofsson,L,,28,0,0,0,0
93,8477462,Robert Hagg,D,VGK,29,0,0,0,0
93,8477320,Anton Blidh,L,NYR,29,0,0,0,0
93,8482157,Will Cuylle,L,NYR,22,0,0,0,0
93,8482737,Zack Bolduc,C,STL,21,0,0,0,0
93,8481239,Samuel Fagemo,L,,24,0,0,0,0
93,8481600,Tobias Bjornfot,D,FLA,23,0,0,0,0
93,8478409,Anthony Richard,C,PHI,28,0,0,0,0
93,8474145,Robert Bortuzzo,D,,35,0,0,0,0
93,8475958,Michael Sgarbossa,C,WSH,32,0,0,0,0
93,8479986,Kole Lind,R,DAL,26,0,0,0,0
93,8479249,Andrew Poturalski,C,SJS,30,0,0,0,0
93,8479362,Riley Tufte,L,BOS,26,0,0,0,0
93,8479991,Jake Leschyshyn,C,NYR,25,0,0,0,0
93,8479587,Rhett Gardner,C,PHI,28,0,0,0,0
93,8482744,James Malatesta,L,CBJ,21,0,0,0,0
93,8478854,Ryan Shea,D,PIT,27,0,0,0,0
93,8481591,Sam Poulin,R,,23,0,0,0,0
93,8483512,Matt Savoie,C,EDM,20,0,0,0,0
93,8482102,Vasily Ponomarev,C,PIT,22,0,0,0,0
93,8482162,Roby Jarventie,L,EDM,22,0,0,0,0
93,8481016,Ruslan Iskhakov,C,,24,0,0,0,0
93,8482172,Landon Slaggert,L,CHI,22,0,0,0,0
93,8482747,Brennan Othmann,L,NYR,21,0,0,0,0
93,8480031,Maxime Comtois,L,,25,0,0,0,0
93,8480226,Marián Studenic,R,,26,0,0,0,0
93,8478408,Travis Dermott,D,,28,0,0,0,0
93,8481518,Nolan Foote,L,NJD,24,0,0,0,0
93,8479419,Brett Murray,L,BUF,26,0,0,0,0
93,8482088,Justin Sourdif,R,FLA,22,0,0,0,0
93,8482201,Gage Goncalves,C,TBL,23,0,0,0,0
93,8481578,Graeme Clarke,R,MIN,23,0,0,0,0
93,8482177,Marat Khusnutdinov,C,MIN,22,0,0,0,0
93,8481754,Nikita Nesterenko,C,ANA,23,0,0,0,0
93,8483531,Brian Halonen,L,NJD,25,0,0,0,0
93,8483920,Pierrick Dube,R,WSH,23,0,0,0,0
93,8480851,Akil Thomas,C,LAK,24,0,0,0,0
93,8475235,Nicolas Deslauriers,L,PHI,33,0,0,0,0
93,8482476,Emil Heineman,L,MTL,23,0,0,0,0
93,8477149,Scott Sabourin,R,SJS,32,0,0,0,0
93,8483549,Lucas Condotta,L,MTL,27,0,0,0,0
93,8482765,Isak Rosen,R,BUF,21,0,0,0,0
93,8481237,Kyle MacLean,C,NYI,25,0,0,0,0
93,8481024,Linus Karlsson,C,VAN,25,0,0,0,0
93,8481690,Tyler Angle,C,,24,0,0,0,0
93,8483570,Ben Meyers,C,SEA,26,0,0,0,0
93,8481655,Cole Schwindt,R,CGY,23,0,0,0,0
93,8481462,Mason Morelli,L,VGK,28,0,0,0,0
93,8483401,Marc Johnstone,R,PIT,28,0,0,0,0
93,8478956,Samuel Laberge,L,NJD,27,0,0,0,0
93,8479533,Joona Koppanen,L,,26,0,0,0,0
93,8482197,Adam Raska,R,MIN,23,0,0,0,0
93,8482250,Callahan Burke,C,VGK,27,0,0,0,0
93,8482784,Zach Dean,C,STL,21,0,0,0,0
93,8484255,Jason Polin,R,COL,25,0,0,0,0
93,8481077,John Leonard,L,,26,0,0,0,0
93,8481534,Raphael Lavoie,C,EDM,24,0,0,0,0
93,8483609,Adam Klapka,R,CGY,24,0,0,0,0
93,8482751,Ryan Winterton,C,SEA,21,0,0,0,0
93,8480267,Sammy Walker,C,MIN,25,0,0,0,0
93,8475766,Austin Watson,L,,32,0,0,0,0
93,8482460,Matt Rempe,C,NYR,22,0,0,0,0
93,8481065,Angus Crookshank,L,OTT,25,0,0,0,0
93,8481070,Hugh McGing,L,,26,0,0,0,0
93,8476323,Max McCormick,L,SEA,32,0,0,0,0
93,8483395,Arshdeep Bains,L,VAN,23,0,0,0,0
93,8484259,Ondrej Pavel,C,COL,31,0,0,0,0
93,8483432,Luca Del Bel Belluz,C,CBJ,31,0,0,0,0
93,8483045,Cameron Butler,R,CBJ,31,0,0,0,0
93,8482061,Brandon Biro,L,SEA,26,0,0,0,0
93,8477401,John Hayden,C,SEA,29,0,0,0,0
93,8475278,Byron Froese,C,,33,0,0,0,0
93,8478446,Glenn Gawdin,C,LAK,27,0,0,0,0
93,8477993,Justin Kirkland,C,CGY,28,0,0,0,0
93,8482147,Jean-Luc Foudy,C,COL,22,0,0,0,0
93,8480032,Shane Bowers,C,NJD,25,0,0,0,0
93,8479330,Brandon Gignac,C,MTL,27,0,0,0,0
93,8480776,Sheldon Rempal,R,,29,0,0,0,0
93,8475413,Justin Dowling,C,NJD,34,0,0,0,0
93,8481726,Adam Edstrom,C,NYR,24,0,0,0,0
93,8480844,Grigori Denisenko,L,VGK,24,0,0,0,0
93,8478147,Bokondji Imama,L,PIT,28,0,0,0,0
93,8478881,Brett Seney,L,CHI,28,0,0,0,0
93,8483630,Pavol Regenda,L,ANA,25,0,0,0,0
93,8480836,Jonathan Gruden,C,,24,0,0,0,0
93,8484314,Jiri Smejkal,L,,28,0,0,0,0
93,8475780,Chris Wagner,R,COL,33,0,0,0,0
93,8479546,Oskar Steen,C,,26,0,0,0,0
93,8483597,Milos Kelemen,L,UTA,25,0,0,0,0
93,8481789,Tye Kartye,L,SEA,23,0,0,0,0
93,8484325,Waltteri Merela,C,TBL,26,0,0,0,0
93,8479421,Jacob Moverare,D,LAK,26,0,0,0,0
93,8481585,Egor Afanasyev,L,SJS,23,0,0,0,0
93,8479547,Matthew Phillips,R,,26,0,0,0,0
93,8479367,William Lockwood,R,FLA,26,0,0,0,0
93,8476915,Jujhar Khaira,L,,30,0,0,0,0
93,8481422,Jacob Lucchini,C,NSH,29,0,0,0,0
93,8480468,James Hamblin,L,EDM,25,0,0,0,0
93,8478051,Max Willman,C,NJD,29,0,0,0,0
93,8481556,John Beecher,C,BOS,23,0,0,0,0
93,8478078,Rourke Chartier,C,,28,0,0,0,0
94,8479318,Auston Matthews,C,TOR,27,82,66,65,131
94,8476453,Nikita Kucherov,R,TBL,31,82,31,98,129
94,8477492,Nathan MacKinnon,C,COL,29,82,54,70,124
94,8478402,Connor McDavid,C,EDM,27,82,31,91,122
94,8481559,Jack Hughes,C,NJD,23,82,39,80,119
94,8478550,Artemi Panarin,L,NYR,33,82,43,71,114
94,8477934,Leon Draisaitl,C,EDM,29,82,46,67,113
94,8478864,Kirill Kaprizov,L,MIN,27,82,49,56,105
94,8478439,Travis Konecny,R,PHI,27,82,40,64,104
94,8476887,Filip Forsberg,L,NSH,30,82,43,59,102
94,8480023,Robert Thomas,C,STL,25,82,41,59,100
94,8474564,Steven Stamkos,C,NSH,34,82,40,60,100
94,8477404,Jake Guentzel,C,TBL,30,82,45,54,99
94,8476468,J.T. Miller,C,VAN,31,82,31,68,99
94,8471675,Sidney Crosby,C,PIT,37,82,43,55,98
94,8479343,Clayton Keller,R,UTA,26,82,42,56,98
94,8477939,William Nylander,R,TOR,28,82,42,56,98
94,8480027,Jason Robertson,L,DAL,25,82,38,60,98
94,8479314,Matthew Tkachuk,L,FLA,27,82,28,70,98
94,8475166,John Tavares,C,TOR,34,82,44,53,97
94,8475172,Nazem Kadri,C,CGY,34,82,34,63,97
94,8478427,Sebastian Aho,C,CAR,27,82,35,61,96
94,8478420,Mikko Rantanen,R,COL,28,82,38,56,94
94,8482116,Tim Stützle,C,OTT,22,82,25,69,94
94,8477409,Carter Verhaeghe,C,FLA,29,82,44,49,93
94,8477956,David Pastrnak,R,BOS,28,82,43,49,92
94,8480012,Elias Pettersson,C,VAN,26,82,36,56,92
94,8476454,Ryan Nugent-Hopkins,C,EDM,31,82,23,67,90
94,8478398,Kyle Connor,L,WPG,28,82,40,49,89
94,8480002,Nico Hischier,C,NJD,25,82,32,57,89
94,8478010,Brayden Point,C,TBL,28,82,44,43,87
94,8478449,Roope Hintz,C,DAL,28,82,38,48,86
94,8477501,Valeri Nichushkin,R,COL,29,82,37,49,86
94,8476539,Jonathan Marchessault,R,NSH,34,82,48,37,85
94,8476459,Mika Zibanejad,C,NYR,31,82,29,56,85
94,8474600,Roman Josi,D,NSH,34,82,27,58,85
94,8480069,Cale Makar,D,COL,26,82,27,58,85
94,8477946,Dylan Larkin,C,DET,28,82,37,47,84
94,8476460,Mark Scheifele,C,WPG,31,82,35,49,84
94,8481557,Matt Boldy,L,MIN,23,82,29,54,83
94,8475810,Bryan Rust,R,PIT,32,82,30,52,82
94,8479407,Jesper Bratt,L,NJD,26,82,29,53,82
94,8477493,Aleksander Barkov,C,FLA,29,82,26,56,82
94,8474578,Erik Karlsson,D,PIT,34,82,21,60,81
94,8479542,Brandon Hagel,L,TBL,26,82,39,41,80
94,8478445,Mathew Barzal,C,NYI,27,82,27,53,80
94,8475786,Zach Hyman,L,EDM,32,82,41,38,79
94,8476456,Jonathan Huberdeau,C,CGY,31,82,23,56,79
94,8480800,Quinn Hughes,D,VAN,25,82,8,71,79
94,8480830,Andrei Svechnikov,R,CAR,24,82,31,46,77
94,8471214,Alex Ovechkin,L,WSH,39,82,44,32,76
94,8478444,Brock Boeser,R,VAN,27,82,40,36,76
94,8476881,Tomas Hertl,C,VGK,31,82,35,41,76
94,8473419,Brad Marchand,L,BOS,36,82,33,43,76
94,8477949,Alex Tuch,R,BUF,28,82,21,55,76
94,8478414,Timo Meier,R,NJD,28,82,40,35,75
94,8480801,Brady Tkachuk,L,OTT,25,82,35,40,75
94,8476905,Chandler Stephenson,C,SEA,30,82,28,47,75
94,8477942,Kevin Fiala,L,LAK,28,82,23,52,75
94,8476906,Shayne Gostisbehere,D,CAR,31,82,15,60,75
94,8477940,Nikolaj Ehlers,L,WPG,28,82,35,39,74
94,8477500,Bo Horvat,C,NYI,29,82,33,40,73
94,8480208,Drake Batherson,R,OTT,26,82,30,43,73
94,8478047,Michael Bunting,L,PIT,29,82,29,44,73
94,8479420,Tage Thompson,C,BUF,27,82,29,44,73
94,8482078,Lucas Raymond,L,DET,22,82,24,49,73
94,8480036,Miro Heiskanen,D,DAL,25,82,17,56,73
94,8476853,Morgan Rielly,D,TOR,30,82,16,57,73
94,8481523,Kirby Dach,C,MTL,23,82,11,62,73
94,8478403,Jack Eichel,C,VGK,28,82,36,36,72
94,8479337,Alex DeBrincat,R,DET,27,82,31,41,72
94,8475692,Mats Zuccarello,R,MIN,37,82,20,52,72
94,8481533,Trevor Zegras,C,ANA,23,82,34,37,71
94,8479385,Jordan Kyrou,C,STL,26,82,32,39,71
94,8480865,Noah Dobson,D,NYI,24,82,12,59,71
94,8477402,Pavel Buchnevich,L,STL,29,82,31,39,70
94,8475784,Jeff Skinner,C,EDM,32,82,31,39,70
94,8477960,Adrian Kempe,R,LAK,28,82,28,42,70
94,8480839,Rasmus Dahlin,D,BUF,24,82,28,42,70
94,8475913,Mark Stone,R,VGK,32,82,21,49,70
94,8476346,Johnny Gaudreau,L,CBJ,31,82,18,52,70
94,8477933,Sam Reinhart,C,FLA,29,82,34,35,69
94,8478975,Mason Marchment,L,DAL,29,82,31,38,69
94,8478873,Troy Terry,R,ANA,27,82,24,45,69
94,8480039,Martin Necas,C,CAR,25,82,28,40,68
94,8477416,Oliver Bjorkstrand,R,SEA,29,82,24,44,68
94,8475167,Victor Hedman,D,TBL,34,82,19,49,68
94,8476483,Rickard Rakell,R,PIT,31,82,32,35,67
94,8477986,Brandon Montour,D,SEA,30,82,21,46,67
94,8478460,Zach Werenski,D,CBJ,27,82,13,54,67
94,8480803,Evan Bouchard,D,EDM,25,82,12,55,67
94,8477447,Shea Theodore,D,VGK,29,82,11,56,67
94,8479339,Patrik Laine,L,CBJ,26,82,34,32,66
94,8475765,Vladimir Tarasenko,R,DET,33,82,29,37,66
94,8479323,Adam Fox,D,NYR,26,82,22,44,66
94,8474590,John Carlson,D,WSH,34,82,12,54,66
94,8477504,Josh Morrissey,D,WPG,29,82,10,56,66
94,8475726,Tyler Toffoli,C,SJS,32,82,27,38,65
94,8480018,Nick Suzuki,C,MTL,25,82,27,38,65
94,8480014,Gabriel Vilardi,C,WPG,25,82,34,30,64
94,8478493,Joel Eriksson Ek,C,MIN,27,82,27,37,64
94,8471215,Evgeni Malkin,C,PIT,38,82,25,39,64
94,8471685,Anze Kopitar,C,LAK,37,82,22,42,64
94,8482093,Seth Jarvis,C,CAR,22,82,20,44,64
94,8473512,Claude Giroux,R,OTT,36,82,19,45,64
94,8475184,Chris Kreider,L,NYR,33,82,38,25,63
94,8473986,Alex Killorn,L,ANA,35,82,31,31,62
94,8481540,Cole Caufield,R,MTL,23,82,30,32,62
94,8475754,Brock Nelson,C,NYI,33,82,23,39,62
94,8477955,Jared McCann,L,SEA,28,82,20,42,62
94,8478438,Tommy Novak,C,NSH,27,82,14,48,62
94,8478042,Viktor Arvidsson,R,EDM,31,82,30,31,61
94,8482665,Matty Beniers,C,SEA,22,82,22,39,61
94,8481068,Yegor Sharangovich,C,CGY,26,82,22,39,61
94,8476399,Blake Coleman,C,CGY,33,82,32,28,60
94,8474141,Patrick Kane,R,DET,36,82,27,33,60
94,8475158,Ryan O'Reilly,C,NSH,33,82,26,34,60
94,8477479,Tyler Bertuzzi,L,CHI,29,82,24,36,60
94,8477935,Sam Bennett,C,FLA,28,82,31,28,59
94,8477964,Ivan Barbashev,C,VGK,29,82,29,30,59
94,8482097,Jack Quinn,R,BUF,23,82,27,32,59
94,8477951,Nick Schmaltz,C,UTA,28,82,25,34,59
94,8476389,Vincent Trocheck,C,NYR,31,82,21,38,59
94,8479345,Jakob Chychrun,D,WSH,26,82,15,44,59
94,8474565,Alex Pietrangelo,D,VGK,34,82,13,46,59
94,8477495,Seth Jones,D,CHI,30,82,12,47,59
94,8476792,Torey Krug,D,STL,33,82,10,49,59
94,8479987,Morgan Geekie,C,BOS,26,82,27,31,58
94,8478462,Nicolas Roy,C,VGK,27,82,27,31,58
94,8475168,Matt Duchene,C,DAL,33,82,26,32,58
94,8474150,Mikael Backlund,C,CGY,35,82,23,35,58
94,8482684,Luke Hughes,D,NJD,21,82,14,44,58
94,8475798,Mikael Granlund,C,SJS,32,82,12,46,58
94,8475169,Evander Kane,L,EDM,33,82,34,23,57
94,8477496,Elias Lindholm,C,BOS,30,82,20,37,57
94,8477932,Aaron Ekblad,D,FLA,28,82,19,38,57
94,8478407,Vince Dunn,D,SEA,28,82,17,40,57
94,8477494,Jonathan Drouin,L,COL,29,82,27,29,56
94,8481711,Matias Maccelli,L,UTA,24,82,21,35,56
94,8481528,Dylan Cozens,C,BUF,23,82,20,36,56
94,8476448,William Karlsson,C,VGK,31,82,16,40,56
94,8479325,Charlie McAvoy,D,BOS,27,82,13,43,56
94,8478055,Gustav Forsling,D,FLA,28,82,10,46,56
94,8471724,Kris Letang,D,PIT,37,82,8,48,56
94,8482109,Alexis Lafrenière,L,NYR,23,82,29,26,55
94,8474586,Jordan Eberle,R,SEA,34,82,25,30,55
94,8476875,Mike Matheson,D,MTL,30,82,14,41,55
94,8477021,Alex Kerfoot,C,UTA,30,82,14,41,55
94,8474679,Gustav Nyquist,C,NSH,35,82,13,42,55
94,8476432,Boone Jenner,C,CBJ,31,82,38,16,54
94,8482159,Tyson Foerster,R,PHI,22,82,29,25,54
94,8476882,Teuvo Teravainen,L,CHI,30,82,21,33,54
94,8484144,Connor Bedard,C,CHI,19,82,19,35,54
94,8474641,Adam Henrique,C,EDM,34,82,15,39,54
94,8479425,Filip Hronek,D,VAN,27,82,11,43,54
94,8476462,Dougie Hamilton,D,NJD,31,82,11,43,54
94,8477346,MacKenzie Weegar,D,CGY,30,82,8,46,54
94,8480015,Owen Tippett,R,PHI,25,82,29,24,53
94,8482110,Dawson Mercer,C,NJD,23,82,25,28,53
94,8475768,Jaden Schwartz,C,SEA,32,82,23,30,53
94,8475714,Calle Jarnkrok,C,TOR,33,82,23,30,53
94,8482149,Cole Perfetti,C,WPG,22,82,22,31,53
94,8480798,Philipp Kurashev,C,CHI,25,82,22,31,53
94,8478440,Dylan Strome,C,WSH,27,82,18,35,53
94,8482124,Quinton Byfield,R,LAK,22,82,18,35,53
94,8481618,Alex Newhook,C,MTL,23,82,16,37,53
94,8478397,Rasmus Andersson,D,CGY,28,82,11,42,53
94,8478498,Jake DeBrusk,L,VAN,28,82,30,22,52
94,8475170,Brayden Schenn,C,STL,33,82,23,29,52
94,8475794,Tyler Seguin,C,DAL,32,82,23,29,52
94,8478856,Conor Garland,R,VAN,28,82,18,34,52
94,8473994,Jamie Benn,L,DAL,35,82,13,39,52
94,8483808,Andrei Kuzmenko,L,CGY,28,82,29,22,51
94,8475745,Charlie Coyle,C,BOS,32,82,20,31,51
94,8480078,Filip Chytil,C,NYR,25,82,14,37,51
94,8478396,Noah Hanifin,D,VGK,27,82,11,40,51
94,8482699,Dylan Guenther,R,UTA,21,82,24,26,50
94,8471698,T.J. Oshie,R,WSH,38,82,24,26,50
94,8476458,Ryan Strome,C,ANA,31,82,21,29,50
94,8482745,Mason McTavish,C,ANA,21,82,20,30,50
94,8478458,Jack Roslovic,C,CAR,27,82,16,34,50
94,8479999,Casey Mittelstadt,C,COL,26,82,14,36,50
94,8474563,Drew Doughty,D,LAK,35,82,8,42,50
94,8475287,Erik Haula,L,NJD,33,82,29,20,49
94,8481624,Ilya Mikheyev,R,CHI,30,82,21,28,49
94,8476925,Colton Sissons,C,NSH,31,82,19,30,49
94,8480028,Morgan Frost,C,PHI,25,82,19,30,49
94,8476826,Yanni Gourde,C,SEA,33,82,19,30,49
94,8470613,Brent Burns,D,CAR,39,82,12,37,49
94,8477948,Travis Sanheim,D,PHI,28,82,10,39,49
94,8475151,Kyle Palmieri,C,NYI,33,82,29,19,48
94,8477511,Anthony Mantha,R,CGY,30,82,26,22,48
94,8480220,Noah Cates,L,PHI,25,82,25,23,48
94,8480064,Josh Norris,C,OTT,25,82,23,25,48
94,8477407,Anthony Duclair,L,NYI,29,82,21,27,48
94,8478401,Pavel Zacha,C,BOS,27,82,17,31,48
94,8476872,Scott Laughton,C,PHI,30,82,17,31,48
94,8478542,Evan Rodrigues,C,FLA,31,82,17,31,48
94,8476419,Jean-Gabriel Pageau,C,NYI,32,82,14,34,48
94,8480829,Jesperi Kotkaniemi,C,CAR,24,82,29,18,47
94,8474102,David Perron,L,OTT,36,82,23,24,47
94,8475791,Taylor Hall,L,CHI,33,82,20,27,47
94,8482146,Luke Evangelista,R,NSH,22,82,20,27,47
94,8478115,Pierre Engvall,L,NYI,28,82,19,28,47
94,8482475,Yegor Chinakhov,R,CBJ,23,82,18,29,47
94,8477503,Max Domi,C,TOR,29,82,13,34,47
94,8475753,Justin Faulk,D,STL,32,82,13,34,47
94,8482740,Wyatt Johnston,C,DAL,21,82,22,24,46
94,8482113,Anton Lundell,C,FLA,23,82,21,25,46
94,8475799,Nino Niederreiter,R,WPG,32,82,20,26,46
94,8474189,Lars Eller,C,PIT,35,82,20,26,46
94,8480188,Fabian Zetterlund,L,SJS,25,82,19,27,46
94,8477444,Andre Burakovsky,L,SEA,29,82,19,27,46
94,8475763,Kevin Hayes,R,PIT,32,82,19,27,46
94,8478469,Thomas Chabot,D,OTT,27,82,18,28,46
94,8477497,Sean Monahan,C,CBJ,30,82,17,29,46
94,8477498,Darnell Nurse,D,EDM,29,82,17,29,46
94,8477476,Artturi Lehkonen,L,COL,29,82,16,30,46
94,8476292,Ondrej Palat,L,NJD,33,82,15,31,46
94,8482175,JJ Peterka,R,BUF,22,82,27,18,45
94,8475760,Nick Bjugstad,C,UTA,32,82,27,18,45
94,8476479,Phillip Danault,C,LAK,31,82,25,20,45
94,8480893,Kirill Marchenko,R,CBJ,24,82,25,20,45
94,8476438,Brandon Saad,L,STL,32,82,24,21,45
94,8478366,Frank Vatrano,R,ANA,30,82,22,23,45
94,8475793,Ryan Johansen,C,PHI,32,82,21,24,45
94,8475848,Brendan Gallagher,R,MTL,32,82,22,22,44
94,8476880,Tom Wilson,R,WSH,30,82,21,23,44
94,8478233,Andrew Mangiapane,L,WSH,28,82,20,24,44
94,8478519,Anthony Cirelli,C,TBL,27,82,20,24,44
94,8478463,Anthony Beauvillier,L,PIT,27,82,19,25,44
94,8475218,Mattias Ekholm,D,EDM,34,82,18,26,44
94,8477456,J.T. Compher,L,DET,29,82,16,28,44
94,8475149,Marcus Johansson,L,MIN,34,82,15,29,44
94,8481581,Thomas Harley,D,DAL,23,82,14,30,44
94,8480871,Adam Boqvist,D,FLA,24,82,12,32,44
94,8475171,Oliver Ekman-Larsson,D,TOR,33,82,8,36,44
94,8475722,Jason Zucker,L,BUF,32,82,22,21,43
94,8476854,Hampus Lindholm,D,BOS,30,82,14,29,43
94,8481546,Cam York,D,PHI,23,82,9,34,43
94,8478038,Devon Toews,D,COL,30,82,4,39,43
94,8481596,Shane Pinto,C,OTT,24,82,21,21,42
94,8477426,Nicholas Paul,L,TBL,29,82,20,22,42
94,8480797,Joel Farabee,L,PHI,24,82,14,28,42
94,8475191,Reilly Smith,R,NYR,33,82,12,30,42
94,8476885,Jacob Trouba,D,NYR,30,82,7,35,42
94,8479410,Mikhail Sergachev,D,UTA,26,82,5,37,42
94,8479976,Juuso Valimaki,D,UTA,26,82,5,37,42
94,8481560,Arthur Kaliyev,R,LAK,23,82,19,22,41
94,8476480,Vladislav Namestnikov,C,WPG,32,82,15,26,41
94,8482105,Jake Sanderson,D,OTT,22,82,14,27,41
94,8480336,Sean Walker,D,CAR,30,82,10,31,41
94,8482055,Drew O'Connor,L,PIT,26,82,23,17,40
94,8478046,Danton Heinen,L,VAN,29,82,22,18,40
94,8475314,Anders Lee,L,NYI,34,82,22,18,40
94,8479675,Trevor Moore,L,LAK,29,82,21,19,40
94,8480009,Eeli Tolvanen,R,SEA,25,82,19,21,40
94,8481704,Juuso Parssinen,C,NSH,23,82,19,21,40
94,8479400,Pierre-Luc Dubois,L,WSH,26,82,18,22,40
94,8479365,Trent Frederic,C,BOS,26,82,18,22,40
94,8477451,Ryan Hartman,R,MIN,30,82,17,23,40
94,8479992,Michael Rasmussen,C,DET,25,82,15,25,40
94,8477919,Frederick Gaudreau,C,MIN,31,82,13,27,40
94,8481606,Jordan Spence,D,LAK,23,82,11,29,40
94,8481535,Nils Hoglander,L,VAN,24,82,22,17,39
94,8476474,Stefan Noesen,R,NJD,31,82,21,18,39
94,8475193,Tomas Tatar,L,NJD,34,82,19,20,39
94,8476960,Andreas Athanasiou,C,CHI,30,82,16,23,39
94,8477989,Christian Dvorak,C,MTL,28,82,15,24,39
94,8482667,William Eklund,L,SJS,22,82,13,26,39
94,8480043,Timothy Liljegren,D,TOR,25,82,6,33,39
94,8477506,Ryan Pulock,D,NYI,30,82,6,33,39
94,8482092,Ridly Greig,C,OTT,22,82,22,16,38
94,8480855,Jack McBain,C,UTA,24,82,18,20,38
94,8482074,Connor Zary,C,CGY,23,82,16,22,38
94,8477429,Andrew Copp,C,DET,30,82,14,24,38
94,8479351,Sam Steel,C,DAL,26,82,14,24,38
94,8480068,Ryan Poehling,C,PHI,25,82,13,25,38
94,8477998,Warren Foegele,L,LAK,28,82,12,26,38
94,8480145,Neal Pionk,D,WPG,29,82,6,32,38
94,8476918,Jimmy Vesey,L,NYR,31,82,21,16,37
94,8481582,Nicholas Robertson,L,TOR,23,82,19,18,37
94,8481604,Pavel Dorofeyev,L,VGK,24,82,19,18,37
94,8479591,Michael Eyssimont,C,TBL,28,82,17,20,37
94,8482624,Daniil Miromanov,D,CGY,27,82,17,20,37
94,8474053,Logan Couture,C,SJS,35,82,16,21,37
94,8481481,Blake Lizotte,C,PIT,27,82,16,21,37
94,8476461,Sean Couturier,C,PHI,32,82,12,25,37
94,8482720,Matthew Knies,L,TOR,22,82,9,28,37
94,8476869,Brady Skjei,D,NSH,30,82,8,29,37
94,8476923,Damon Severson,D,CBJ,30,82,6,31,37
94,8481032,Paul Cotter,C,NJD,25,82,19,17,36
94,8480459,Pius Suter,C,VAN,28,82,17,19,36
94,8479525,Ross Colton,C,COL,28,82,17,19,36
94,8478020,Michael Amadio,C,OTT,28,82,16,20,36
94,8473563,Nicklas Backstrom,C,WSH,37,82,15,21,36
94,8480748,Kiefer Sherwood,L,VAN,29,82,13,23,36
94,8477953,Kasperi Kapanen,R,STL,28,82,12,24,36
94,8476422,Mike Reilly,D,NYI,31,82,8,28,36
94,8476463,Jonas Brodin,D,MIN,31,82,7,29,36
94,8482079,Marco Rossi,C,MIN,23,82,23,12,35
94,8476981,Josh Anderson,R,MTL,30,82,23,12,35
94,8480835,Jack Drury,C,CAR,24,82,20,15,35
94,8475231,Casey Cizikas,C,NYI,33,82,19,16,35
94,8481186,Logan O'Connor,R,COL,28,82,18,17,35
94,8480849,Barrett Hayton,C,UTA,24,82,17,18,35
94,8482705,Cole Sillinger,C,CBJ,21,82,17,18,35
94,8474149,Evgenii Dadonov,R,DAL,35,82,15,20,35
94,8479996,Cody Glass,C,NSH,25,82,15,20,35
94,8483457,Lane Hutson,D,MTL,20,82,13,22,35
94,8478472,Mathieu Joseph,R,STL,27,82,12,23,35
94,8473507,Jeff Petry,D,DET,37,82,8,27,35
94,8476958,Jaccob Slavin,D,CAR,30,82,6,29,35
94,8476979,Erik Gustafsson,D,DET,32,82,5,30,35
94,8482077,Dylan Holloway,L,EDM,23,82,22,12,34
94,8470621,Corey Perry,R,EDM,39,82,19,15,34
94,8473533,Jordan Staal,C,CAR,36,82,17,17,34
94,8480185,Eetu Luostarinen,C,FLA,26,82,17,17,34
94,8483515,Juraj Slafkovsky,L,MTL,20,82,16,18,34
94,8477903,Garnet Hathaway,R,PHI,33,82,15,19,34
94,8482133,Thomas Bordeleau,C,SJS,22,82,12,22,34
94,8482671,Owen Power,D,BUF,22,82,8,26,34
94,8478911,Matt Roy,D,WSH,29,82,8,26,34
94,8475764,Cam Fowler,D,ANA,33,82,2,32,34
94,8476469,Joel Armia,R,MTL,31,82,23,10,33
94,8478474,Lawson Crouse,L,UTA,27,82,19,14,33
94,8479661,Tanner Jeannot,L,LAK,27,82,18,15,33
94,8479941,Justin Danforth,R,CBJ,31,82,17,16,33
94,8477952,Robby Fabbri,C,ANA,28,82,17,16,33
94,8483431,Logan Cooley,C,UTA,20,82,16,17,33
94,8480802,Ryan McLeod,C,BUF,25,82,16,17,33
94,8476921,Jordan Martinook,L,CAR,32,82,13,20,33
94,8474716,Jared Spurgeon,D,MIN,35,82,11,22,33
94,8476927,Teddy Blueger,C,VAN,30,82,9,24,33
94,8480434,Sean Durzi,D,UTA,26,82,8,25,33
94,8476329,Travis Boyd,C,MIN,31,82,8,25,33
94,8480806,Isac Lundestrom,C,ANA,25,82,8,25,33
94,8476917,Adam Pelech,D,NYI,30,82,5,28,33
94,8482142,Jamie Drysdale,D,PHI,22,82,3,30,33
94,8482089,Jake Neighbours,L,STL,22,82,20,12,32
94,8476392,Adam Lowry,C,WPG,31,82,18,14,32
94,8477987,Ryan Donato,C,CHI,28,82,12,20,32
94,8482111,Justin Barron,D,MTL,23,82,12,20,32
94,8480113,Alex Iafallo,L,WPG,31,82,9,23,32
94,8484145,Zach Benson,L,BUF,19,82,12,19,31
94,8480817,K'Andre Miller,D,NYR,24,82,10,21,31
94,8480144,David Kampf,C,TOR,29,82,10,21,31
94,8481178,Egor Zamula,D,PHI,24,82,4,27,31
94,8481542,Moritz Seider,D,DET,23,82,2,29,31
94,8479402,Jake Bean,D,CGY,26,82,2,29,31
94,8476892,Colton Parayko,D,STL,31,82,2,29,31
94,8481601,Simon Holmstrom,R,NYI,23,82,20,10,30
94,8476278,Colin Blackwell,C,DAL,31,82,17,13,30
94,8478891,Mason Appleton,C,WPG,28,82,16,14,30
94,8481553,Bobby Brink,R,PHI,23,82,16,14,30
94,8478057,Dakota Joshua,C,VAN,28,82,15,15,30
94,8473422,Nick Foligno,L,CHI,37,82,15,15,30
94,8482117,Lukas Reichel,L,CHI,22,82,15,15,30
94,8484203,Bradly Nadeau,L,CAR,19,82,14,16,30
94,8476897,Oskar Sundqvist,C,STL,30,82,10,20,30
94,8479983,Mario Ferraro,D,SJS,26,82,9,21,30
94,8474715,Cam Atkinson,R,TBL,35,82,8,22,30
94,8480878,Nils Lundkvist,D,DAL,24,82,6,24,30
94,8476331,Dylan DeMelo,D,WPG,31,82,2,28,30
94,8480813,Joe Veleno,C,DET,24,82,17,12,29
94,8481013,Jonatan Berggren,R,DET,24,82,16,13,29
94,8477392,Hudson Fasching,R,NYI,29,82,15,14,29
94,8480789,Oliver Wahlstrom,R,NYI,24,82,14,15,29
94,8478569,Noel Acciari,C,PIT,33,82,13,16,29
94,8479353,Brett Howden,C,VGK,26,82,11,18,29
94,8478500,Ivan Provorov,D,CBJ,27,82,7,22,29
94,8480873,Rasmus Sandin,D,WSH,24,82,5,24,29
94,8478851,Alexandre Carrier,D,NSH,28,82,5,24,29
94,8478399,Jonas Siegenthaler,D,NJD,27,82,5,24,29
94,8480049,Dylan Samberg,D,WPG,25,82,3,26,29
94,8479293,Brandon Tanev,L,SEA,33,82,16,12,28
94,8480995,Pontus Holmberg,R,TOR,25,82,15,13,28
94,8480003,Jesper Boqvist,C,FLA,26,82,15,13,28
94,8478013,Jake Walman,D,SJS,28,82,15,13,28
94,8478508,Yakov Trenin,C,MIN,27,82,14,14,28
94,8481554,Kaapo Kakko,R,NYR,23,82,11,17,28
94,8475220,Marcus Foligno,L,MIN,33,82,11,17,28
94,8478109,Victor Olofsson,L,VGK,29,82,10,18,28
94,8484149,Gavin Brindley,C,CBJ,20,82,5,23,28
94,8480073,Erik Brannstrom,D,COL,25,82,4,24,28
94,8476902,Esa Lindell,D,DAL,30,82,3,25,28
94,8477938,Haydn Fleury,D,WPG,28,82,3,25,28
94,8479390,Taylor Raddysh,R,WSH,26,82,14,13,27
94,8476873,Mark Jankowski,C,NSH,30,82,14,13,27
94,8478211,Dryden Hunt,L,CGY,29,82,14,13,27
94,8479393,Noah Gregor,C,OTT,26,82,14,13,27
94,8482666,Scott Morrow,D,CAR,22,82,14,13,27
94,8479359,Beck Malenstyn,L,BUF,26,82,13,14,27
94,8477947,Sonny Milano,L,WSH,28,82,12,15,27
94,8475343,Nic Dowd,C,WSH,34,82,12,15,27
94,8478413,Jordan Greenway,L,BUF,27,82,11,16,27
94,8484153,Leo Carlsson,C,ANA,20,82,11,16,27
94,8477931,Tomas Nosek,L,FLA,32,82,11,16,27
94,8475855,Jesper Fast,R,CAR,33,82,10,17,27
94,8482660,Kent Johnson,C,CBJ,22,82,9,18,27
94,8478133,Jake Evans,C,MTL,28,82,5,22,27
94,8481014,Alexander Romanov,D,NYI,24,82,5,22,27
94,8483490,Pavel Mintyukov,D,ANA,21,82,4,23,27
94,8482073,Braden Schneider,D,NYR,23,82,4,23,27
94,8475324,Nick Jensen,D,OTT,34,82,3,24,27
94,8475233,David Savard,D,MTL,34,82,2,25,27
94,8482733,Logan Mailloux,D,MTL,31,82,12,14,26
94,8477499,Rasmus Ristolainen,D,PHI,30,82,11,15,26
94,8483445,Cutter Gauthier,L,ANA,20,82,10,16,26
94,8480025,MacKenzie Entwistle,R,FLA,25,82,10,16,26
94,8477839,Conor Sheary,L,TBL,32,82,9,17,26
94,8481656,Aliaksei Protas,C,WSH,23,82,9,17,26
94,8476374,Sean Kuraly,C,CBJ,31,82,8,18,26
94,8482062,Cole Smith,L,NSH,29,82,8,18,26
94,8479980,Nicolas Hague,D,VGK,26,82,8,18,26
94,8480796,Martin Fehervary,D,WSH,25,82,7,19,26
94,8482803,Olen Zellweger,D,ANA,21,82,7,19,26
94,8482122,Brock Faber,D,MIN,22,82,6,20,26
94,8482245,Artem Zub,D,OTT,29,82,4,22,26
94,8474574,Tyler Myers,D,VAN,34,82,3,23,26
94,8480246,Nick Perbix,D,TBL,26,82,3,23,26
94,8476931,Jake McCabe,D,TOR,31,82,2,24,26
94,8478434,Keegan Kolesar,R,VGK,27,82,11,14,25
94,8480980,Connor Dewar,C,TOR,25,82,11,14,25
94,8477425,Miles Wood,L,COL,29,82,10,15,25
94,8473453,Trevor Lewis,C,LAK,37,82,10,15,25
94,8481522,Peyton Krebs,C,BUF,23,82,7,18,25
94,8479369,Andrew Peeke,D,BOS,26,82,6,19,25
94,8477507,Nikita Zadorov,D,BOS,29,82,5,20,25
94,8475279,Ben Chiarot,D,DET,33,82,4,21,25
94,8482125,Alexander Holtz,R,VGK,22,82,14,10,24
94,8477450,Jason Dickinson,C,CHI,29,82,10,14,24
94,8484166,Adam Fantilli,C,CBJ,20,82,10,14,24
94,8480074,Alexandre Texier,C,STL,25,82,7,17,24
94,8477220,Nate Schmidt,D,FLA,33,82,7,17,24
94,8476624,Barclay Goodrow,C,SJS,31,82,7,17,24
94,8478882,Vladislav Gavrikov,D,LAK,29,82,3,21,24
94,8476429,Scott Mayfield,D,NYI,32,82,3,21,24
94,8481568,Alex Vlasic,D,CHI,23,82,3,21,24
94,8475690,Chris Tanev,D,TOR,35,82,3,21,24
94,8474673,TJ Brodie,D,CHI,34,82,2,22,24
94,8476442,Matt Nieto,L,PIT,32,82,12,11,23
94,8477015,Connor Brown,R,EDM,30,82,9,14,23
94,8482679,Matt Coronato,R,CGY,22,82,9,14,23
94,8475200,Dmitry Orlov,D,CAR,33,82,8,15,23
94,8477488,Brett Pesce,D,NJD,30,82,7,16,23
94,8475188,Brayden McNabb,D,VGK,33,82,7,16,23
94,8480807,Mattias Samuelsson,D,BUF,24,82,5,18,23
94,8477845,Trevor van Riemsdyk,D,WSH,33,82,4,19,23
94,8482655,J.J. Moser,D,TBL,24,82,3,20,23
94,8470600,Ryan Suter,D,STL,39,82,3,20,23
94,8478507,John Marino,D,UTA,27,82,3,20,23
94,8474013,Ian Cole,D,UTA,35,82,2,21,23
94,8483524,Shane Wright,C,SEA,20,82,14,8,22
94,8480281,Alexey Toropchenko,R,STL,25,82,11,11,22
94,8479414,Nathan Bastian,R,NJD,27,82,9,13,22
94,8482141,Lukas Cormier,D,VGK,22,82,9,13,22
94,8476467,Jamie Oleksiak,D,SEA,32,82,8,14,22
94,8483495,Simon Nemec,D,NJD,20,82,7,15,22
94,8476525,Colin Miller,D,WPG,32,82,7,15,22
94,8482858,Ryker Evans,D,SEA,23,82,6,16,22
94,8477369,Carson Soucy,D,VAN,30,82,6,16,22
94,8482470,Ilya Solovyov,D,CGY,24,82,6,16,22
94,8483763,Maksymilian Szuber,D,UTA,22,82,5,17,22
94,8474151,Ryan McDonagh,D,TBL,35,82,4,18,22
94,8475790,Erik Gudbranson,D,CBJ,32,82,3,19,22
94,8477969,Marcus Pettersson,D,PIT,28,82,2,20,22
94,8481477,Nico Sturm,C,SJS,29,82,12,9,21
94,8477508,Curtis Lazar,C,NJD,29,82,8,13,21
94,8479442,Troy Stecher,D,EDM,30,82,8,13,21
94,8480021,Jack Studnicka,C,LAK,25,82,8,13,21
94,8478136,Jake Middleton,D,MIN,28,82,7,14,21
94,8479324,Ryan Lindgren,D,NYR,26,82,6,15,21
94,8478178,Darren Raddysh,D,TBL,28,82,6,15,21
94,8481605,Jackson LaCombe,D,ANA,23,82,5,16,21
94,8479398,Samuel Girard,D,COL,26,82,4,17,21
94,8481524,Bowen Byram,D,BUF,23,82,4,17,21
94,8480035,Henri Jokiharju,D,BUF,25,82,4,17,21
94,8483468,Jiri Kulich,C,BUF,20,82,4,17,21
94,8479371,Dante Fabbro,D,NSH,26,82,2,19,21
94,8478840,Will Borgen,D,SEA,28,82,1,20,21
94,8476878,Zemgus Girgensons,L,TBL,30,82,11,9,20
94,8481517,Brett Leason,R,ANA,25,82,11,9,20
94,8481028,Martin Pospisil,C,CGY,25,82,10,10,20
94,8482166,Shakir Mukhamadullin,D,SJS,22,82,10,10,20
94,8476889,Radek Faksa,C,STL,30,82,9,11,20
94,8478468,Jeremy Lauzon,D,NSH,27,82,5,15,20
94,8476312,Josh Manson,D,COL,33,82,4,16,20
94,8482087,Kaiden Guhle,D,MTL,22,82,2,18,20
94,8480222,Sebastian Aho,D,PIT,28,82,0,20,20
94,8479316,Luke Kunin,C,SJS,27,82,11,8,19
94,8482259,Bobby McMann,C,TOR,28,82,10,9,19
94,8481580,Connor McMichael,C,WSH,23,82,9,10,19
94,8478432,Christian Fischer,R,DET,27,82,9,10,19
94,8482807,Ethan Del Mastro,D,CHI,21,82,9,10,19
94,8475455,Brenden Dillon,D,NJD,34,82,4,15,19
94,8475181,Nick Leddy,D,STL,33,82,2,17,19
94,8480172,Jan Rutta,D,SJS,34,82,2,17,19
94,8481641,Joel Kiviranta,L,COL,28,82,11,7,18
94,8477353,Tyler Motte,C,DET,29,82,8,10,18
94,8481699,Aku Raty,R,UTA,23,82,7,11,18
94,8476372,Nick Seeler,D,PHI,31,82,6,12,18
94,8483489,Fraser Minten,C,TOR,31,82,6,12,18
94,8481708,Zac Jones,D,NYR,24,82,4,14,18
94,8476473,Connor Murphy,D,CHI,31,82,4,14,18
94,8483565,Nick Blankenburg,D,NSH,26,82,3,15,18
94,8478443,Brandon Carlo,D,BOS,28,82,3,15,18
94,8478416,Erik Cernak,D,TBL,27,82,1,17,18
94,8479368,Max Jones,L,BOS,26,82,10,7,17
94,8475842,Sam Carrick,C,NYR,32,82,10,7,17
94,8476858,Phillip Di Giuseppe,L,VAN,31,82,10,7,17
94,8482155,Alex Laferriere,R,LAK,23,82,8,9,17
94,8482145,Mavrik Bourque,C,DAL,22,82,8,9,17
94,8476457,Adam Larsson,D,SEA,32,82,7,10,17
94,8483499,Liam Ohgren,L,MIN,20,82,7,10,17
94,8482762,Simon Edvinsson,D,DET,21,82,6,11,17
94,8477406,Mattias Janmark,C,EDM,32,82,4,13,17
94,8475177,Calvin de Haan,D,COL,33,82,4,13,17
94,8476879,Cody Ceci,D,EDM,31,82,4,13,17
94,8475462,Radko Gudas,D,ANA,34,82,4,13,17
94,8477365,Connor Clifton,D,BUF,29,82,4,13,17
94,8474567,Zach Bogosian,D,MIN,34,82,3,14,17
94,8478874,Adam Gaudette,C,OTT,28,82,3,14,17
94,8477435,Ryan Graves,D,PIT,29,82,1,16,17
94,8481093,Rafael Harvey-Pinard,L,MTL,25,82,12,4,16
94,8476822,Luke Glendening,C,TBL,35,82,12,4,16
94,8479291,Kevin Rooney,C,CGY,31,82,10,6,16
94,8483471,Brad Lambert,C,WPG,31,82,9,7,16
94,8482153,Brendan Brisson,C,VGK,23,82,8,8,16
94,8483397,Marc McLaughlin,C,BOS,25,82,7,9,16
94,8483482,Tristan Luneau,D,ANA,20,82,5,11,16
94,8481122,Simon Benoit,D,TOR,26,82,5,11,16
94,8483505,Matthew Poitras,C,BOS,20,82,5,11,16
94,8480860,Kevin Bahl,D,CGY,24,82,4,12,16
94,8481567,Henry Thrun,D,SJS,23,82,3,13,16
94,8475718,Justin Holl,D,DET,32,82,3,13,16
94,8480990,Declan Chisholm,D,MIN,24,82,3,13,16
94,8482659,Josh Doan,R,UTA,22,82,9,6,15
94,8482702,Logan Stankoven,C,DAL,21,82,8,7,15
94,8483493,Frank Nazar,C,CHI,20,82,7,8,15
94,8480448,Parker Kelly,L,COL,25,82,6,9,15
94,8476967,Brett Kulak,D,EDM,30,82,1,14,15
94,8474090,Brendan Smith,D,DAL,35,82,4,10,14
94,8482749,Joshua Roy,R,MTL,21,82,3,11,14
94,8480834,Ty Emberson,D,SJS,24,82,2,12,14
94,8478450,Parker Wotherspoon,D,BOS,27,82,2,12,14
94,8477335,Kyle Burroughs,D,LAK,29,82,5,8,13
94,8476441,Joel Edmundson,D,LAK,31,82,4,9,13
94,8483460,David Jiricek,D,CBJ,21,82,4,9,13
94,8474612,Travis Hamonic,D,OTT,34,82,4,9,13
94,8476891,Matt Grzelcyk,D,PIT,30,82,1,12,13
94,8477034,Jaycob Megna,D,FLA,32,82,1,12,13
94,8480879,Jacob Bernard-Docker,D,OTT,24,82,0,13,13
94,8482809,Jackson Blake,R,CAR,21,82,6,6,12
94,8482101,Danil Gushchin,L,SJS,22,82,6,6,12
94,8482516,Matthew Kessel,D,STL,24,82,5,7,12
94,8477505,Alexander Wennberg,C,SJS,30,82,5,7,12
94,8482118,Sam Colangelo,R,ANA,23,82,3,9,12
94,8479998,Mikey Anderson,D,LAK,25,82,2,10,12
94,8480950,Ilya Lyubushkin,D,DAL,30,82,1,11,12
94,8478859,Niko Mikkola,D,FLA,28,82,2,9,11
94,8484911,Collin Graf,R,SJS,22,82,5,5,10
94,8483012,Logan Morrison,C,SEA,22,82,2,8,10
94,8483466,Kevin Korchinski,D,CHI,20,82,2,8,10
94,8479576,Vincent Desharnais,D,VAN,28,82,1,8,9
94,8482712,Oskar Olausson,R,COL,22,82,4,4,8
94,8479638,Justin Brazeau,R,BOS,26,82,2,6,8
94,8482713,Mackie Samoskevich,R,FLA,22,82,1,7,8
94,8483567,Georgii Merkulov,C,BOS,24,82,6,1,7
94,8482859,Zack Ostapchuk,C,OTT,21,82,3,4,7
94,8471677,Jack Johnson,D,CBJ,37,82,1,6,7
94,8480870,Bo Groulx,C,NYR,24,82,1,5,6
94,8474062,Riley Nash,C,NYR,35,82,0,6,6
94,8482070,Mitchell Chaffee,R,TBL,26,82,3,2,5
94,8482787,Nikita Chibrikov,R,WPG,31,82,3,1,4
94,8475762,Derek Forbort,D,VAN,32,82,0,4,4
94,8470794,Joe Pavelski,C,,40,0,0,0,0
94,8481703,Valtteri Puustinen,R,PIT,25,0,0,0,0
94,8477950,Tony DeAngelo,D,,29,0,0,0,0
94,8481577,Philip Tomasino,C,NSH,23,0,0,0,0
94,8475197,Tyson Barrie,D,,33,0,0,0,0
94,8471218,Blake Wheeler,R,,38,0,0,0,0
94,8474157,Max Pacioretty,L,,36,0,0,0,0
94,8478466,Daniel Sprong,R,VAN,27,0,0,0,0
94,8475744,Evgeny Kuznetsov,C,,32,0,0,0,0
94,8481019,David Gustafsson,C,WPG,24,0,0,0,0
94,8475906,John Klingberg,D,,32,0,0,0,0
94,8479348,Kale Clague,D,BUF,26,0,0,0,0
94,8476952,Dominic Toninato,C,WPG,30,0,0,0,0
94,8473473,Milan Lucic,L,,36,0,0,0,0
94,8474037,James van Riemsdyk,L,,35,0,0,0,0
94,8474602,Justin Schultz,D,,34,0,0,0,0
94,8482222,Alexander Barabanov,L,,30,0,0,0,0
94,8479372,Josh Mahura,D,SEA,26,0,0,0,0
94,8479982,Conor Timmins,D,TOR,26,0,0,0,0
94,8474031,Kevin Shattenkirk,D,,35,0,0,0,0
94,8480008,Adam Ruzicka,C,,25,0,0,0,0
94,8481059,Scott Perunovich,D,STL,26,0,0,0,0
94,8480884,Calen Addison,D,,24,0,0,0,0
94,8476994,Vinnie Hinostroza,C,NSH,30,0,0,0,0
94,8478452,Caleb Jones,D,LAK,27,0,0,0,0
94,8480157,Calle Rosen,D,COL,30,0,0,0,0
94,8481609,Vladislav Kolyachonok,D,UTA,23,0,0,0,0
94,8479415,Michael McLeod,C,,26,0,0,0,0
94,8476919,Chris Tierney,C,,30,0,0,0,0
94,8479639,Dylan Coghlan,D,WPG,26,0,0,0,0
94,8478146,Matthew Highmore,C,OTT,28,0,0,0,0
94,8478970,Jalen Chatfield,D,CAR,28,0,0,0,0
94,8480205,Emil Bemstrom,C,PIT,25,0,0,0,0
94,8474884,Mike Hoffman,C,,35,0,0,0,0
94,8471274,Alex Goligoski,D,,39,0,0,0,0
94,8478104,Sammy Blais,L,,28,0,0,0,0
94,8474870,Tyler Johnson,C,,34,0,0,0,0
94,8476913,Devin Shore,C,MIN,30,0,0,0,0
94,8481598,Philip Broberg,D,EDM,23,0,0,0,0
94,8480058,Pierre-Olivier Joseph,D,STL,25,0,0,0,0
94,8480891,Michael Kesselring,D,UTA,24,0,0,0,0
94,8477979,Nicolas Aube-Kubel,R,BUF,28,0,0,0,0
94,8476871,Tanner Pearson,L,,32,0,0,0,0
94,8476393,Nick Cousins,C,,31,0,0,0,0
94,8479977,Kailer Yamamoto,R,,26,0,0,0,0
94,8479543,Michael Pezzetta,L,MTL,26,0,0,0,0
94,8477018,Ben Hutton,D,VGK,31,0,0,0,0
94,8480762,Eric Robinson,L,CAR,29,0,0,0,0
94,8474034,Pat Maroon,L,CHI,36,0,0,0,0
94,8481058,Jesse Ylönen,R,,25,0,0,0,0
94,8475179,Dmitry Kulikov,D,FLA,34,0,0,0,0
94,8481527,Kaedan Korczak,D,VGK,23,0,0,0,0
94,8473449,Kyle Okposo,R,,36,0,0,0,0
94,8482192,Isaak Phillips,D,CHI,23,0,0,0,0
94,8480727,Zach Whitecloud,D,VGK,28,0,0,0,0
94,8479346,Dillon Dube,C,,26,0,0,0,0
94,8480821,Filip Zadina,R,,25,0,0,0,0
94,8480001,Urho Vaakanainen,D,ANA,25,0,0,0,0
94,8470966,Mark Giordano,D,,41,0,0,0,0
94,8480853,Liam Foudy,C,,24,0,0,0,0
94,8475225,Craig Smith,C,CHI,35,0,0,0,0
94,8479972,Mason Shaw,C,WPG,26,0,0,0,0
94,8478451,Ethan Bear,D,WSH,27,0,0,0,0
94,8474040,Sam Gagner,C,,35,0,0,0,0
94,8480196,Jacob Bryson,D,BUF,27,0,0,0,0
94,8479984,Cal Foote,D,,26,0,0,0,0
94,8480011,Klim Kostin,C,SJS,25,0,0,0,0
94,8482176,Wyatt Kaiser,D,CHI,22,0,0,0,0
94,8476988,Matt Benning,D,SJS,30,0,0,0,0
94,8479370,Tyson Jost,C,CAR,26,0,0,0,0
94,8477464,Nic Petan,C,,29,0,0,0,0
94,8477380,Jonny Brodzinski,C,NYR,31,0,0,0,0
94,8480070,Ian Mitchell,D,BOS,25,0,0,0,0
94,8479315,Joey Anderson,R,CHI,26,0,0,0,0
94,8478099,Kevin Labanc,R,,29,0,0,0,0
94,8476874,Olli Maatta,D,DET,30,0,0,0,0
94,8475208,Brian Dumoulin,D,ANA,33,0,0,0,0
94,8478430,Oliver Kylington,D,,27,0,0,0,0
94,8479536,Axel Jonsson-Fjallby,L,WPG,26,0,0,0,0
94,8479671,Mathieu Olivier,R,CBJ,27,0,0,0,0
94,8471709,Marc-Edouard Vlasic,D,SJS,37,0,0,0,0
94,8479328,Julien Gauthier,R,NYI,27,0,0,0,0
94,8478421,A.J. Greer,L,FLA,28,0,0,0,0
94,8477573,Nathan Walker,L,STL,30,0,0,0,0
94,8481537,Nikita Okhotiuk,D,CGY,24,0,0,0,0
94,8474166,Alec Martinez,D,CHI,37,0,0,0,0
94,8470610,Zach Parise,L,,40,0,0,0,0
94,8477478,William Carrier,L,CAR,30,0,0,0,0
94,8479344,Jesse Puljujarvi,R,PIT,26,0,0,0,0
94,8480887,Jordan Harris,D,MTL,24,0,0,0,0
94,8478502,Dennis Gilbert,D,BUF,28,0,0,0,0
94,8482730,Brandt Clarke,D,LAK,21,0,0,0,0
94,8480355,Mark Kastelic,C,BOS,25,0,0,0,0
94,8475750,Jon Merrill,D,MIN,32,0,0,0,0
94,8475164,Jakob Silfverberg,R,,34,0,0,0,0
94,8477944,Jakub Vrana,L,,28,0,0,0,0
94,8479439,Jacob MacDonald,D,COL,31,0,0,0,0
94,8474568,Luke Schenn,D,NSH,35,0,0,0,0
94,8478454,Noah Juulsen,D,VAN,27,0,0,0,0
94,8475752,Tyler Pitlick,C,,33,0,0,0,0
94,8482148,Hendrix Lapierre,C,WSH,22,0,0,0,0
94,8481167,Brayden Pachal,D,CGY,25,0,0,0,0
94,8478043,Sam Lafferty,C,BUF,29,0,0,0,0
94,8479321,Lucas Johansen,D,,27,0,0,0,0
94,8471699,Andrew Cogliano,C,,37,0,0,0,0
94,8481521,Ronnie Attard,D,PHI,25,0,0,0,0
94,8481161,Jake Christiansen,D,CBJ,25,0,0,0,0
94,8479458,Nikita Zaitsev,D,,33,0,0,0,0
94,8479619,Michael Carcone,L,UTA,28,0,0,0,0
94,8479026,Philippe Myers,D,TOR,27,0,0,0,0
94,8477330,Dominik Kubalik,L,,29,0,0,0,0
94,8481617,Vasily Podkolzin,R,VAN,23,0,0,0,0
94,8481701,Santeri Hatakka,D,NJD,23,0,0,0,0
94,8479514,Rem Pitlick,C,,27,0,0,0,0
94,8477446,Michael McCarron,R,NSH,29,0,0,0,0
94,8470604,Jeff Carter,C,,39,0,0,0,0
94,8482241,Radim Zohorna,L,,28,0,0,0,0
94,8480289,Morgan Barron,C,WPG,26,0,0,0,0
94,8479379,Givani Smith,R,SJS,26,0,0,0,0
94,8480216,Jacob Peterson,C,,25,0,0,0,0
94,8477851,Jordan Oesterle,D,BOS,32,0,0,0,0
94,8484258,Sam Malinski,D,COL,26,0,0,0,0
94,8478904,Steven Lorentz,C,,28,0,0,0,0
94,8482095,Tyler Kleven,D,OTT,22,0,0,0,0
94,8480848,Ty Dellandrea,C,SJS,24,0,0,0,0
94,8476884,Derrick Pouliot,D,,30,0,0,0,0
94,8479336,Carl Grundstrom,R,SJS,27,0,0,0,0
94,8482964,Arber Xhekaj,D,MTL,23,0,0,0,0
94,8471686,Marc Staal,D,,37,0,0,0,0
94,8477887,Patrick Brown,C,BOS,32,0,0,0,0
94,8478495,Denis Gurianov,R,,27,0,0,0,0
94,8473504,Cal Clutterbuck,R,,37,0,0,0,0
94,8481550,Adam Beckman,L,NJD,23,0,0,0,0
94,8480845,Rasmus Kupari,C,WPG,24,0,0,0,0
94,8474009,Nick Bonino,C,,36,0,0,0,0
94,8478585,Derek Ryan,C,EDM,38,0,0,0,0
94,8477962,Brendan Lemieux,L,CAR,28,0,0,0,0
94,8482861,Vincent Iorio,D,WSH,22,0,0,0,0
94,8479378,Logan Stanley,D,WPG,26,0,0,0,0
94,8473446,Erik Johnson,D,PHI,36,0,0,0,0
94,8481743,Marc Del Gaizo,D,NSH,25,0,0,0,0
94,8477384,Josh Brown,D,EDM,30,0,0,0,0
94,8482165,Yan Kuznetsov,D,CGY,22,0,0,0,0
94,8478424,Jansen Harkins,C,ANA,27,0,0,0,0
94,8482144,Jack Thompson,D,SJS,22,0,0,0,0
94,8478512,Austin Czarnik,C,,32,0,0,0,0
94,8477527,Ross Johnston,L,ANA,30,0,0,0,0
94,8479383,Boris Katchouk,L,,26,0,0,0,0
94,8482094,Daemon Hunt,D,MIN,22,0,0,0,0
94,8481719,Maxwell Crozier,D,TBL,24,0,0,0,0
94,8480192,Johnathan Kovacevic,D,NJD,27,0,0,0,0
94,8479376,Victor Mete,D,,26,0,0,0,0
94,8482511,Mason Lohrei,D,BOS,23,0,0,0,0
94,8475825,Jani Hakanpää,D,,32,0,0,0,0
94,8478021,William Lagesson,D,DET,28,0,0,0,0
94,8475795,Dylan McIlrath,D,WSH,32,0,0,0,0
94,8477846,Ryan Carpenter,C,,33,0,0,0,0
94,8481056,Spencer Stastney,D,NSH,24,0,0,0,0
94,8481564,Ryan Johnson,D,BUF,23,0,0,0,0
94,8478017,Mark Friedman,D,VAN,29,0,0,0,0
94,8479320,Max Lajoie,D,SEA,27,0,0,0,0
94,8480075,Cameron Crotty,D,MIN,25,0,0,0,0
94,8484287,Cole McWard,D,VAN,23,0,0,0,0
94,8484254,Akito Hirose,D,VAN,25,0,0,0,0
94,8483407,Brandon Scanlin,D,NYR,25,0,0,0,0
94,8480274,Philip Kemp,D,EDM,25,0,0,0,0
94,8479522,Hardy Haman Aktell,D,WSH,26,0,0,0,0
94,8480007,Jonas Rondbjerg,R,VGK,25,0,0,0,0
94,8477454,Adam Erne,L,,29,0,0,0,0
94,8481679,Maxence Guenette,D,OTT,23,0,0,0,0
94,8480441,Trey Fix-Wolansky,R,CBJ,25,0,0,0,0
94,8483546,Marshall Rifai,D,TOR,26,0,0,0,0
94,8480084,Nick DeSimone,D,NJD,30,0,0,0,0
94,8481030,Jack St. Ivany,D,PIT,25,0,0,0,0
94,8481592,Jakob Pelletier,L,CGY,23,0,0,0,0
94,8478011,Louie Belpedio,D,PHI,28,0,0,0,0
94,8477930,Pierre-Edouard Bellemare,L,,39,0,0,0,0
94,8484321,Nikolas Matinpalo,D,OTT,26,0,0,0,0
94,8482067,Connor Mackey,D,NYR,28,0,0,0,0
94,8481806,Louis Crevier,D,CHI,23,0,0,0,0
94,8484326,Patrik Koch,D,UTA,28,0,0,0,0
94,8477971,Andreas Englund,D,LAK,28,0,0,0,0
94,8481751,Lukas Rousek,R,BUF,25,0,0,0,0
94,8481006,Tyler Tucker,D,STL,24,0,0,0,0
94,8476867,Brendan Gaunce,C,MIN,30,0,0,0,0
94,8479520,Brandon Duhaime,R,WSH,27,0,0,0,0
94,8477073,Kurtis MacDermid,L,NJD,30,0,0,0,0
94,8480874,Adam Ginning,D,PHI,24,0,0,0,0
94,8477473,Justin Bailey,R,SJS,29,0,0,0,0
94,8479066,Ryan Lomberg,L,CGY,30,0,0,0,0
94,8477070,Liam O'Brien,C,UTA,30,0,0,0,0
94,8474618,Marco Scandella,D,,34,0,0,0,0
94,8475797,Jarred Tinordi,D,,32,0,0,0,0
94,8481441,Joe Snively,C,DET,28,0,0,0,0
94,8477244,Chad Ruhwedel,D,NYR,34,0,0,0,0
94,8479772,Zack MacEwen,R,OTT,28,0,0,0,0
94,8481147,Reese Johnson,C,MIN,26,0,0,0,0
94,8481043,Cole Koepke,L,BOS,26,0,0,0,0
94,8483619,Filip Roos,D,OTT,25,0,0,0,0
94,8481541,Samuel Bolduc,D,NYI,24,0,0,0,0
94,8477810,Joel Hanley,D,CGY,33,0,0,0,0
94,8476907,Mackenzie MacEachern,L,,30,0,0,0,0
94,8482652,Walker Duehr,R,CGY,27,0,0,0,0
94,8477126,Jayson Megna,C,,34,0,0,0,0
94,8483398,Declan Carlile,D,TBL,31,0,0,0,0
94,8482929,Emil Lilleberg,D,TBL,23,0,0,0,0
94,8480880,Jakub Lauko,C,MIN,24,0,0,0,0
94,8480245,Olle Lycksell,R,PHI,25,0,0,0,0
94,8480252,Cole Guttman,C,CHI,25,0,0,0,0
94,8477467,Gustav Olofsson,D,SEA,30,0,0,0,0
94,8479968,Vinni Lettieri,C,BOS,29,0,0,0,0
94,8478400,Colin White,C,,27,0,0,0,0
94,8475755,Alexander Petrovic,D,DAL,32,0,0,0,0
94,8481812,Nikolai Knyzhov,D,,27,0,0,0,0
94,8481593,Jayden Struble,D,MTL,23,0,0,0,0
94,8481532,Alex Turcotte,C,LAK,23,0,0,0,0
94,8482126,Emil Andrae,D,PHI,31,0,0,0,0
94,8479944,Zach Aston-Reese,C,VGK,30,0,0,0,0
94,8471817,Ryan Reaves,R,TOR,37,0,0,0,0
94,8481206,John Ludvig,D,PIT,24,0,0,0,0
94,8481599,Victor Soderstrom,D,UTA,23,0,0,0,0
94,8480292,Carson Meyer,R,ANA,27,0,0,0,0
94,8482496,Nils Aman,C,VAN,24,0,0,0,0
94,8479718,Alex Barré-Boulet,C,MTL,27,0,0,0,0
94,8479994,Jaret Anderson-Dolan,C,WPG,25,0,0,0,0
94,8480184,Gustav Lindstrom,D,,26,0,0,0,0
94,8480890,Jan Jenik,R,OTT,24,0,0,0,0
94,8478067,Oskar Lindblom,L,,28,0,0,0,0
94,8476934,Brock McGinn,L,ANA,30,0,0,0,0
94,8479985,Cale Fleury,D,SEA,26,0,0,0,0
94,8484304,Uvis Balinskis,D,FLA,28,0,0,0,0
94,8479981,Jonah Gadjovich,L,FLA,26,0,0,0,0
94,8481716,Dmitri Voronkov,L,CBJ,24,0,0,0,0
94,8474709,Matt Martin,L,,35,0,0,0,0
94,8482634,Alex Steeves,C,TOR,25,0,0,0,0
94,8480823,Alexander Alexeyev,D,WSH,25,0,0,0,0
94,8477541,Dakota Mermis,D,TOR,30,0,0,0,0
94,8483491,Ivan Miroshnichenko,L,WSH,20,0,0,0,0
94,8478477,Mitchell Stephens,C,SEA,27,0,0,0,0
94,8481543,Nikita Alexandrov,C,STL,24,0,0,0,0
94,8479423,Alex Nylander,L,,26,0,0,0,0
94,8482451,Mikael Pyyhtia,L,CBJ,23,0,0,0,0
94,8478831,Kevin Stenlund,C,UTA,28,0,0,0,0
94,8480306,Grant Hutton,D,NYI,29,0,0,0,0
94,8478028,Fredrik Olofsson,L,,28,0,0,0,0
94,8477462,Robert Hagg,D,VGK,29,0,0,0,0
94,8477320,Anton Blidh,L,NYR,29,0,0,0,0
94,8482157,Will Cuylle,L,NYR,22,0,0,0,0
94,8482737,Zack Bolduc,C,STL,21,0,0,0,0
94,8481239,Samuel Fagemo,L,,24,0,0,0,0
94,8481600,Tobias Bjornfot,D,FLA,23,0,0,0,0
94,8478409,Anthony Richard,C,PHI,28,0,0,0,0
94,8474145,Robert Bortuzzo,D,,35,0,0,0,0
94,8475958,Michael Sgarbossa,C,WSH,32,0,0,0,0
94,8479986,Kole Lind,R,DAL,26,0,0,0,0
94,8479249,Andrew Poturalski,C,SJS,30,0,0,0,0
94,8479362,Riley Tufte,L,BOS,26,0,0,0,0
94,8479991,Jake Leschyshyn,C,NYR,25,0,0,0,0
94,8479587,Rhett Gardner,C,PHI,28,0,0,0,0
94,8482744,James Malatesta,L,CBJ,21,0,0,0,0
94,8478854,Ryan Shea,D,PIT,27,0,0,0,0
94,8481591,Sam Poulin,R,,23,0,0,0,0
94,8483512,Matt Savoie,C,EDM,20,0,0,0,0
94,8482102,Vasily Ponomarev,C,PIT,22,0,0,0,0
94,8482162,Roby Jarventie,L,EDM,22,0,0,0,0
94,8481016,Ruslan Iskhakov,C,,24,0,0,0,0
94,8482172,Landon Slaggert,L,CHI,22,0,0,0,0
94,8482747,Brennan Othmann,L,NYR,21,0,0,0,0
94,8480031,Maxime Comtois,L,,25,0,0,0,0
94,8480226,Marián Studenic,R,,26,0,0,0,0
94,8478408,Travis Dermott,D,,28,0,0,0,0
94,8481518,Nolan Foote,L,NJD,24,0,0,0,0
94,8479419,Brett Murray,L,BUF,26,0,0,0,0
94,8482088,Justin Sourdif,R,FLA,22,0,0,0,0
94,8482201,Gage Goncalves,C,TBL,23,0,0,0,0
94,8481578,Graeme Clarke,R,MIN,23,0,0,0,0
94,8482177,Marat Khusnutdinov,C,MIN,22,0,0,0,0
94,8481754,Nikita Nesterenko,C,ANA,23,0,0,0,0
94,8483531,Brian Halonen,L,NJD,25,0,0,0,0
94,8483920,Pierrick Dube,R,WSH,23,0,0,0,0
94,8480851,Akil Thomas,C,LAK,24,0,0,0,0
94,8475235,Nicolas Deslauriers,L,PHI,33,0,0,0,0
94,8482476,Emil Heineman,L,MTL,23,0,0,0,0
94,8477149,Scott Sabourin,R,SJS,32,0,0,0,0
94,8483549,Lucas Condotta,L,MTL,27,0,0,0,0
94,8482765,Isak Rosen,R,BUF,21,0,0,0,0
94,8481237,Kyle MacLean,C,NYI,25,0,0,0,0
94,8481024,Linus Karlsson,C,VAN,25,0,0,0,0
94,8481690,Tyler Angle,C,,24,0,0,0,0
94,8483570,Ben Meyers,C,SEA,26,0,0,0,0
94,8481655,Cole Schwindt,R,CGY,23,0,0,0,0
94,8481462,Mason Morelli,L,VGK,28,0,0,0,0
94,8483401,Marc Johnstone,R,PIT,28,0,0,0,0
94,8478956,Samuel Laberge,L,NJD,27,0,0,0,0
94,8479533,Joona Koppanen,L,,26,0,0,0,0
94,8482197,Adam Raska,R,MIN,23,0,0,0,0
94,8482250,Callahan Burke,C,VGK,27,0,0,0,0
94,8482784,Zach Dean,C,STL,21,0,0,0,0
94,8484255,Jason Polin,R,COL,25,0,0,0,0
94,8481077,John Leonard,L,,26,0,0,0,0
94,8481534,Raphael Lavoie,C,EDM,24,0,0,0,0
94,8483609,Adam Klapka,R,CGY,24,0,0,0,0
94,8482751,Ryan Winterton,C,SEA,21,0,0,0,0
94,8480267,Sammy Walker,C,MIN,25,0,0,0,0
94,8475766,Austin Watson,L,,32,0,0,0,0
94,8482460,Matt Rempe,C,NYR,22,0,0,0,0
94,8481065,Angus Crookshank,L,OTT,25,0,0,0,0
94,8481070,Hugh McGing,L,,26,0,0,0,0
94,8476323,Max McCormick,L,SEA,32,0,0,0,0
94,8483395,Arshdeep Bains,L,VAN,23,0,0,0,0
94,8484259,Ondrej Pavel,C,COL,31,0,0,0,0
94,8483432,Luca Del Bel Belluz,C,CBJ,31,0,0,0,0
94,8483045,Cameron Butler,R,CBJ,31,0,0,0,0
94,8482061,Brandon Biro,L,SEA,26,0,0,0,0
94,8477401,John Hayden,C,SEA,29,0,0,0,0
94,8475278,Byron Froese,C,,33,0,0,0,0
94,8478446,Glenn Gawdin,C,LAK,27,0,0,0,0
94,8477993,Justin Kirkland,C,CGY,28,0,0,0,0
94,8482147,Jean-Luc Foudy,C,COL,22,0,0,0,0
94,8480032,Shane Bowers,C,NJD,25,0,0,0,0
94,8479330,Brandon Gignac,C,MTL,27,0,0,0,0
94,8480776,Sheldon Rempal,R,,29,0,0,0,0
94,8475413,Justin Dowling,C,NJD,34,0,0,0,0
94,8481726,Adam Edstrom,C,NYR,24,0,0,0,0
94,8480844,Grigori Denisenko,L,VGK,24,0,0,0,0
94,8478147,Bokondji Imama,L,PIT,28,0,0,0,0
94,8478881,Brett Seney,L,CHI,28,0,0,0,0
94,8483630,Pavol Regenda,L,ANA,25,0,0,0,0
94,8480836,Jonathan Gruden,C,,24,0,0,0,0
94,8484314,Jiri Smejkal,L,,28,0,0,0,0
94,8475780,Chris Wagner,R,COL,33,0,0,0,0
94,8479546,Oskar Steen,C,,26,0,0,0,0
94,8483597,Milos Kelemen,L,UTA,25,0,0,0,0
94,8481789,Tye Kartye,L,SEA,23,0,0,0,0
94,8484325,Waltteri Merela,C,TBL,26,0,0,0,0
94,8479421,Jacob Moverare,D,LAK,26,0,0,0,0
94,8481585,Egor Afanasyev,L,SJS,23,0,0,0,0
94,8479547,Matthew Phillips,R,,26,0,0,0,0
94,8479367,William Lockwood,R,FLA,26,0,0,0,0
94,8476915,Jujhar Khaira,L,,30,0,0,0,0
94,8481422,Jacob Lucchini,C,NSH,29,0,0,0,0
94,8480468,James Hamblin,L,EDM,25,0,0,0,0
94,8478051,Max Willman,C,NJD,29,0,0,0,0
94,8481556,John Beecher,C,BOS,23,0,0,0,0
94,8478078,Rourke Chartier,C,,28,0,0,0,0
95,8477934,Leon Draisaitl,C,EDM,29,82,51,83,134
95,8477492,Nathan MacKinnon,C,COL,29,82,47,84,131
95,8478402,Connor McDavid,C,EDM,27,82,43,80,123
95,8481559,Jack Hughes,C,NJD,23,82,46,75,121
95,8479318,Auston Matthews,C,TOR,27,82,65,55,120
95,8478550,Artemi Panarin,L,NYR,33,82,40,74,114
95,8476453,Nikita Kucherov,R,TBL,31,82,39,75,114
95,8477404,Jake Guentzel,C,TBL,30,82,43,68,111
95,8477939,William Nylander,R,TOR,28,82,40,71,111
95,8480027,Jason Robertson,L,DAL,25,82,51,58,109
95,8478864,Kirill Kaprizov,L,MIN,27,82,50,59,109
95,8477493,Aleksander Barkov,C,FLA,29,82,38,71,109
95,8478420,Mikko Rantanen,R,COL,28,82,52,55,107
95,8476468,J.T. Miller,C,VAN,31,82,47,57,104
95,8479314,Matthew Tkachuk,L,FLA,27,82,36,66,102
95,8477956,David Pastrnak,R,BOS,28,82,47,54,101
95,8477942,Kevin Fiala,L,LAK,28,82,34,67,101
95,8481557,Matt Boldy,L,MIN,23,82,32,68,100
95,8480069,Cale Makar,D,COL,26,82,20,80,100
95,8480800,Quinn Hughes,D,VAN,25,82,15,80,95
95,8478403,Jack Eichel,C,VGK,28,82,46,46,92
95,8478010,Brayden Point,C,TBL,28,82,51,40,91
95,8477946,Dylan Larkin,C,DET,28,82,30,61,91
95,8476887,Filip Forsberg,L,NSH,30,82,41,49,90
95,8480012,Elias Pettersson,C,VAN,26,82,30,60,90
95,8474600,Roman Josi,D,NSH,34,82,19,71,90
95,8478398,Kyle Connor,L,WPG,28,82,50,39,89
95,8480002,Nico Hischier,C,NJD,25,82,24,64,88
95,8480208,Drake Batherson,R,OTT,26,82,34,52,86
95,8471675,Sidney Crosby,C,PIT,37,82,36,48,84
95,8482116,Tim Stützle,C,OTT,22,82,33,51,84
95,8475166,John Tavares,C,TOR,34,82,26,58,84
95,8479337,Alex DeBrincat,R,DET,27,82,48,35,83
95,8477501,Valeri Nichushkin,R,COL,29,82,43,40,83
95,8476389,Vincent Trocheck,C,NYR,31,82,40,43,83
95,8480023,Robert Thomas,C,STL,25,82,25,58,83
95,8479343,Clayton Keller,R,UTA,26,82,36,46,82
95,8479420,Tage Thompson,C,BUF,27,82,35,47,82
95,8477402,Pavel Buchnevich,L,STL,29,82,34,48,82
95,8480803,Evan Bouchard,D,EDM,25,82,21,60,81
95,8479323,Adam Fox,D,NYR,26,82,17,64,81
95,8475168,Matt Duchene,C,DAL,33,82,33,47,80
95,8481523,Kirby Dach,C,MTL,23,82,20,60,80
95,8476346,Johnny Gaudreau,L,CBJ,31,82,20,60,80
95,8478445,Mathew Barzal,C,NYI,27,82,17,63,80
95,8482093,Seth Jarvis,C,CAR,22,82,36,43,79
95,8478414,Timo Meier,R,NJD,28,82,32,47,79
95,8471215,Evgeni Malkin,C,PIT,38,82,30,49,79
95,8473419,Brad Marchand,L,BOS,36,82,27,52,79
95,8476454,Ryan Nugent-Hopkins,C,EDM,31,82,24,55,79
95,8480830,Andrei Svechnikov,R,CAR,24,82,38,40,78
95,8478439,Travis Konecny,R,PHI,27,82,26,52,78
95,8478444,Brock Boeser,R,VAN,27,82,39,38,77
95,8477960,Adrian Kempe,R,LAK,28,82,37,40,77
95,8480801,Brady Tkachuk,L,OTT,25,82,31,45,76
95,8476459,Mika Zibanejad,C,NYR,31,82,28,48,76
95,8475692,Mats Zuccarello,R,MIN,37,82,20,56,76
95,8475798,Mikael Granlund,C,SJS,32,82,15,61,76
95,8477500,Bo Horvat,C,NYI,29,82,44,31,75
95,8480014,Gabriel Vilardi,C,WPG,25,82,38,37,75
95,8475172,Nazem Kadri,C,CGY,34,82,35,40,75
95,8477949,Alex Tuch,R,BUF,28,82,34,41,75
95,8475794,Tyler Seguin,C,DAL,32,82,32,43,75
95,8478460,Zach Werenski,D,CBJ,27,82,18,56,74
95,8480188,Fabian Zetterlund,L,SJS,25,82,35,38,73
95,8477940,Nikolaj Ehlers,L,WPG,28,82,26,47,73
95,8479542,Brandon Hagel,L,TBL,26,82,25,48,73
95,8479999,Casey Mittelstadt,C,COL,26,82,22,51,73
95,8480036,Miro Heiskanen,D,DAL,25,82,18,55,73
95,8476853,Morgan Rielly,D,TOR,30,82,16,57,73
95,8474578,Erik Karlsson,D,PIT,34,82,15,58,73
95,8478427,Sebastian Aho,C,CAR,27,82,36,36,72
95,8477933,Sam Reinhart,C,FLA,29,82,33,39,72
95,8478449,Roope Hintz,C,DAL,28,82,31,41,72
95,8479385,Jordan Kyrou,C,STL,26,82,31,41,72
95,8476905,Chandler Stephenson,C,SEA,30,82,19,53,72
95,8475786,Zach Hyman,L,EDM,32,82,39,32,71
95,8476456,Jonathan Huberdeau,C,CGY,31,82,13,58,71
95,8477409,Carter Verhaeghe,C,FLA,29,82,35,35,70
95,8475754,Brock Nelson,C,NYI,33,82,29,41,70
95,8480039,Martin Necas,C,CAR,25,82,27,43,70
95,8475913,Mark Stone,R,VGK,32,82,23,47,70
95,8475167,Victor Hedman,D,TBL,34,82,16,54,70
95,8474564,Steven Stamkos,C,NSH,34,82,33,36,69
95,8478873,Troy Terry,R,ANA,27,82,27,42,69
95,8474141,Patrick Kane,R,DET,36,82,25,44,69
95,8482665,Matty Beniers,C,SEA,22,82,23,45,68
95,8478493,Joel Eriksson Ek,C,MIN,27,82,31,36,67
95,8481540,Cole Caufield,R,MTL,23,82,34,32,66
95,8479675,Trevor Moore,L,LAK,29,82,26,40,66
95,8475158,Ryan O'Reilly,C,NSH,33,82,25,41,66
95,8477447,Shea Theodore,D,VGK,29,82,10,56,66
95,8476539,Jonathan Marchessault,R,NSH,34,82,38,27,65
95,8477503,Max Domi,C,TOR,29,82,24,41,65
95,8479407,Jesper Bratt,L,NJD,26,82,21,44,65
95,8477504,Josh Morrissey,D,WPG,29,82,18,47,65
95,8478366,Frank Vatrano,R,ANA,30,82,35,29,64
95,8475810,Bryan Rust,R,PIT,32,82,32,32,64
95,8474586,Jordan Eberle,R,SEA,34,82,25,39,64
95,8471685,Anze Kopitar,C,LAK,37,82,23,41,64
95,8473994,Jamie Benn,L,DAL,35,82,23,41,64
95,8478975,Mason Marchment,L,DAL,29,82,21,43,64
95,8475184,Chris Kreider,L,NYR,33,82,41,22,63
95,8476881,Tomas Hertl,C,VGK,31,82,24,39,63
95,8480839,Rasmus Dahlin,D,BUF,24,82,19,44,63
95,8480018,Nick Suzuki,C,MTL,25,82,19,44,63
95,8477955,Jared McCann,L,SEA,28,82,32,30,62
95,8477479,Tyler Bertuzzi,L,CHI,29,82,29,33,62
95,8473512,Claude Giroux,R,OTT,36,82,27,35,62
95,8475765,Vladimir Tarasenko,R,DET,33,82,26,36,62
95,8482097,Jack Quinn,R,BUF,23,82,22,40,62
95,8481711,Matias Maccelli,L,UTA,24,82,20,42,62
95,8476460,Mark Scheifele,C,WPG,31,82,18,44,62
95,8478407,Vince Dunn,D,SEA,28,82,16,46,62
95,8478038,Devon Toews,D,COL,30,82,13,49,62
95,8478047,Michael Bunting,L,PIT,29,82,29,32,61
95,8481528,Dylan Cozens,C,BUF,23,82,27,34,61
95,8477456,J.T. Compher,L,DET,29,82,26,35,61
95,8477476,Artturi Lehkonen,L,COL,29,82,30,30,60
95,8477986,Brandon Montour,D,SEA,30,82,20,40,60
95,8474565,Alex Pietrangelo,D,VGK,34,82,17,43,60
95,8479410,Mikhail Sergachev,D,UTA,26,82,13,47,60
95,8476875,Mike Matheson,D,MTL,30,82,11,49,60
95,8479425,Filip Hronek,D,VAN,27,82,11,49,60
95,8482745,Mason McTavish,C,ANA,21,82,29,30,59
95,8478440,Dylan Strome,C,WSH,27,82,23,36,59
95,8482078,Lucas Raymond,L,DET,22,82,22,37,59
95,8481581,Thomas Harley,D,DAL,23,82,21,38,59
95,8473986,Alex Killorn,L,ANA,35,82,20,39,59
95,8482124,Quinton Byfield,R,LAK,22,82,19,40,59
95,8476792,Torey Krug,D,STL,33,82,17,42,59
95,8471214,Alex Ovechkin,L,WSH,39,82,32,26,58
95,8480015,Owen Tippett,R,PHI,25,82,31,27,58
95,8478542,Evan Rodrigues,C,FLA,31,82,27,31,58
95,8476882,Teuvo Teravainen,L,CHI,30,82,22,36,58
95,8480797,Joel Farabee,L,PHI,24,82,21,37,58
95,8478042,Viktor Arvidsson,R,EDM,31,82,17,41,58
95,8478396,Noah Hanifin,D,VGK,27,82,13,45,58
95,8477495,Seth Jones,D,CHI,30,82,12,46,58
95,8471724,Kris Letang,D,PIT,37,82,10,48,58
95,8476432,Boone Jenner,C,CBJ,31,82,35,22,57
95,8475726,Tyler Toffoli,C,SJS,32,82,27,30,57
95,8475714,Calle Jarnkrok,C,TOR,33,82,26,31,57
95,8481533,Trevor Zegras,C,ANA,23,82,24,33,57
95,8478856,Conor Garland,R,VAN,28,82,22,35,57
95,8474679,Gustav Nyquist,C,NSH,35,82,16,41,57
95,8482684,Luke Hughes,D,NJD,21,82,12,45,57
95,8476906,Shayne Gostisbehere,D,CAR,31,82,11,46,57
95,8480865,Noah Dobson,D,NYI,24,82,10,47,57
95,8474563,Drew Doughty,D,LAK,35,82,8,49,57
95,8477496,Elias Lindholm,C,BOS,30,82,28,28,56
95,8482109,Alexis Lafrenière,L,NYR,23,82,28,28,56
95,8476399,Blake Coleman,C,CGY,33,82,26,30,56
95,8479339,Patrik Laine,L,CBJ,26,82,23,33,56
95,8481068,Yegor Sharangovich,C,CGY,26,82,26,29,55
95,8477416,Oliver Bjorkstrand,R,SEA,29,82,24,31,55
95,8475784,Jeff Skinner,C,EDM,32,82,23,32,55
95,8477494,Jonathan Drouin,L,COL,29,82,18,37,55
95,8475745,Charlie Coyle,C,BOS,32,82,18,37,55
95,8476462,Dougie Hamilton,D,NJD,31,82,15,40,55
95,8476869,Brady Skjei,D,NSH,30,82,12,43,55
95,8475768,Jaden Schwartz,C,SEA,32,82,24,30,54
95,8478469,Thomas Chabot,D,OTT,27,82,17,37,54
95,8475169,Evander Kane,L,EDM,33,82,31,22,53
95,8478498,Jake DeBrusk,L,VAN,28,82,26,27,53
95,8482699,Dylan Guenther,R,UTA,21,82,25,28,53
95,8475170,Brayden Schenn,C,STL,33,82,24,29,53
95,8475848,Brendan Gallagher,R,MTL,32,82,23,30,53
95,8476826,Yanni Gourde,C,SEA,33,82,17,36,53
95,8478397,Rasmus Andersson,D,CGY,28,82,7,46,53
95,8477511,Anthony Mantha,R,CGY,30,82,31,21,52
95,8477951,Nick Schmaltz,C,UTA,28,82,27,25,52
95,8478462,Nicolas Roy,C,VGK,27,82,23,29,52
95,8482159,Tyson Foerster,R,PHI,22,82,23,29,52
95,8475799,Nino Niederreiter,R,WPG,32,82,21,31,52
95,8480798,Philipp Kurashev,C,CHI,25,82,19,33,52
95,8477497,Sean Monahan,C,CBJ,30,82,17,35,52
95,8475753,Justin Faulk,D,STL,32,82,14,38,52
95,8476438,Brandon Saad,L,STL,32,82,36,15,51
95,8475151,Kyle Palmieri,C,NYI,33,82,24,27,51
95,8482740,Wyatt Johnston,C,DAL,21,82,21,30,51
95,8475191,Reilly Smith,R,NYR,33,82,19,32,51
95,8478438,Tommy Novak,C,NSH,27,82,17,34,51
95,8474102,David Perron,L,OTT,36,82,17,34,51
95,8470613,Brent Burns,D,CAR,39,82,9,42,51
95,8480043,Timothy Liljegren,D,TOR,25,82,6,45,51
95,8480434,Sean Durzi,D,UTA,26,82,2,49,51
95,8477998,Warren Foegele,L,LAK,28,82,26,24,50
95,8477407,Anthony Duclair,L,NYI,29,82,25,25,50
95,8477451,Ryan Hartman,R,MIN,30,82,21,29,50
95,8478401,Pavel Zacha,C,BOS,27,82,19,31,50
95,8476458,Ryan Strome,C,ANA,31,82,14,36,50
95,8481542,Moritz Seider,D,DET,23,82,14,36,50
95,8482475,Yegor Chinakhov,R,CBJ,23,82,27,22,49
95,8484144,Connor Bedard,C,CHI,19,82,23,26,49
95,8482667,William Eklund,L,SJS,22,82,23,26,49
95,8476483,Rickard Rakell,R,PIT,31,82,22,27,49
95,8476921,Jordan Martinook,L,CAR,32,82,21,28,49
95,8481618,Alex Newhook,C,MTL,23,82,20,29,49
95,8482113,Anton Lundell,C,FLA,23,82,19,30,49
95,8481596,Shane Pinto,C,OTT,24,82,18,31,49
95,8480078,Filip Chytil,C,NYR,25,82,15,34,49
95,8474590,John Carlson,D,WSH,34,82,13,36,49
95,8479345,Jakob Chychrun,D,WSH,26,82,13,36,49
95,8475764,Cam Fowler,D,ANA,33,82,4,45,49
95,8480064,Josh Norris,C,OTT,25,82,22,26,48
95,8482117,Lukas Reichel,L,CHI,22,82,20,28,48
95,8478458,Jack Roslovic,C,CAR,27,82,17,31,48
95,8479525,Ross Colton,C,COL,28,82,25,22,47
95,8482146,Luke Evangelista,R,NSH,22,82,24,23,47
95,8482149,Cole Perfetti,C,WPG,22,82,18,29,47
95,8477444,Andre Burakovsky,L,SEA,29,82,17,30,47
95,8476448,William Karlsson,C,VGK,31,82,16,31,47
95,8482110,Dawson Mercer,C,NJD,23,82,26,20,46
95,8480113,Alex Iafallo,L,WPG,31,82,25,21,46
95,8482055,Drew O'Connor,L,PIT,26,82,21,25,46
95,8476479,Phillip Danault,C,LAK,31,82,18,28,46
95,8481546,Cam York,D,PHI,23,82,9,37,46
95,8476474,Stefan Noesen,R,NJD,31,82,24,21,45
95,8477952,Robby Fabbri,C,ANA,28,82,24,21,45
95,8478233,Andrew Mangiapane,L,WSH,28,82,20,25,45
95,8476880,Tom Wilson,R,WSH,30,82,19,26,45
95,8477021,Alex Kerfoot,C,UTA,30,82,16,29,45
95,8477932,Aaron Ekblad,D,FLA,28,82,15,30,45
95,8478519,Anthony Cirelli,C,TBL,27,82,13,32,45
95,8474150,Mikael Backlund,C,CGY,35,82,12,33,45
95,8474574,Tyler Myers,D,VAN,34,82,10,35,45
95,8478055,Gustav Forsling,D,FLA,28,82,9,36,45
95,8477964,Ivan Barbashev,C,VGK,29,82,24,20,44
95,8479365,Trent Frederic,C,BOS,26,82,22,22,44
95,8474715,Cam Atkinson,R,TBL,35,82,22,22,44
95,8473533,Jordan Staal,C,CAR,36,82,21,23,44
95,8481554,Kaapo Kakko,R,NYR,23,82,18,26,44
95,8480028,Morgan Frost,C,PHI,25,82,17,27,44
95,8476292,Ondrej Palat,L,NJD,33,82,17,27,44
95,8475287,Erik Haula,L,NJD,33,82,14,30,44
95,8476419,Jean-Gabriel Pageau,C,NYI,32,82,14,30,44
95,8476925,Colton Sissons,C,NSH,31,82,13,31,44
95,8476854,Hampus Lindholm,D,BOS,30,82,12,32,44
95,8477948,Travis Sanheim,D,PHI,28,82,8,36,44
95,8479325,Charlie McAvoy,D,BOS,27,82,3,41,44
95,8475793,Ryan Johansen,C,PHI,32,82,25,18,43
95,8477935,Sam Bennett,C,FLA,28,82,21,22,43
95,8476960,Andreas Athanasiou,C,CHI,30,82,20,23,43
95,8478474,Lawson Crouse,L,UTA,27,82,19,24,43
95,8478057,Dakota Joshua,C,VAN,28,82,18,25,43
95,8476872,Scott Laughton,C,PHI,30,82,15,28,43
95,8476329,Travis Boyd,C,MIN,31,82,15,28,43
95,8474053,Logan Couture,C,SJS,35,82,18,24,42
95,8475763,Kevin Hayes,R,PIT,32,82,17,25,42
95,8478046,Danton Heinen,L,VAN,29,82,17,25,42
95,8476958,Jaccob Slavin,D,CAR,30,82,10,32,42
95,8476923,Damon Severson,D,CBJ,30,82,2,40,42
95,8481580,Connor McMichael,C,WSH,23,82,21,20,41
95,8475193,Tomas Tatar,L,NJD,34,82,20,21,41
95,8479992,Michael Rasmussen,C,DET,25,82,19,22,41
95,8481560,Arthur Kaliyev,R,LAK,23,82,18,23,41
95,8479400,Pierre-Luc Dubois,L,WSH,26,82,18,23,41
95,8479996,Cody Glass,C,NSH,25,82,18,23,41
95,8480185,Eetu Luostarinen,C,FLA,26,82,18,23,41
95,8480009,Eeli Tolvanen,R,SEA,25,82,16,25,41
95,8482105,Jake Sanderson,D,OTT,22,82,15,26,41
95,8476927,Teddy Blueger,C,VAN,30,82,15,26,41
95,8478472,Mathieu Joseph,R,STL,27,82,11,30,41
95,8480893,Kirill Marchenko,R,CBJ,24,82,25,15,40
95,8482705,Cole Sillinger,C,CBJ,21,82,20,20,40
95,8483515,Juraj Slafkovsky,L,MTL,20,82,20,20,40
95,8480220,Noah Cates,L,PHI,25,82,18,22,40
95,8476480,Vladislav Namestnikov,C,WPG,32,82,16,24,40
95,8478115,Pierre Engvall,L,NYI,28,82,13,27,40
95,8477987,Ryan Donato,C,CHI,28,82,12,28,40
95,8477498,Darnell Nurse,D,EDM,29,82,9,31,40
95,8477346,MacKenzie Weegar,D,CGY,30,82,8,32,40
95,8480995,Pontus Holmberg,R,TOR,25,82,24,15,39
95,8481624,Ilya Mikheyev,R,CHI,30,82,20,19,39
95,8482175,JJ Peterka,R,BUF,22,82,20,19,39
95,8478463,Anthony Beauvillier,L,PIT,27,82,19,20,39
95,8477426,Nicholas Paul,L,TBL,29,82,19,20,39
95,8475314,Anders Lee,L,NYI,34,82,19,20,39
95,8482720,Matthew Knies,L,TOR,22,82,18,21,39
95,8479351,Sam Steel,C,DAL,26,82,16,23,39
95,8475218,Mattias Ekholm,D,EDM,34,82,8,31,39
95,8478020,Michael Amadio,C,OTT,28,82,21,17,38
95,8483808,Andrei Kuzmenko,L,CGY,28,82,20,18,38
95,8474641,Adam Henrique,C,EDM,34,82,16,22,38
95,8475722,Jason Zucker,L,BUF,32,82,15,23,38
95,8476461,Sean Couturier,C,PHI,32,82,14,24,38
95,8479393,Noah Gregor,C,OTT,26,82,17,20,37
95,8479987,Morgan Geekie,C,BOS,26,82,15,22,37
95,8482660,Kent Johnson,C,CBJ,22,82,13,24,37
95,8478891,Mason Appleton,C,WPG,28,82,11,26,37
95,8476885,Jacob Trouba,D,NYR,30,82,7,30,37
95,8481032,Paul Cotter,C,NJD,25,82,23,13,36
95,8477989,Christian Dvorak,C,MTL,28,82,17,19,36
95,8475791,Taylor Hall,L,CHI,33,82,16,20,36
95,8481606,Jordan Spence,D,LAK,23,82,15,21,36
95,8481481,Blake Lizotte,C,PIT,27,82,15,21,36
95,8480871,Adam Boqvist,D,FLA,24,82,9,27,36
95,8482133,Thomas Bordeleau,C,SJS,22,82,9,27,36
95,8480878,Nils Lundkvist,D,DAL,24,82,9,27,36
95,8475200,Dmitry Orlov,D,CAR,33,82,8,28,36
95,8480817,K'Andre Miller,D,NYR,24,82,7,29,36
95,8474151,Ryan McDonagh,D,TBL,35,82,5,31,36
95,8476979,Erik Gustafsson,D,DET,32,82,4,32,36
95,8476931,Jake McCabe,D,TOR,31,82,4,32,36
95,8475760,Nick Bjugstad,C,UTA,32,82,22,13,35
95,8481535,Nils Hoglander,L,VAN,24,82,19,16,35
95,8480459,Pius Suter,C,VAN,28,82,17,18,35
95,8482092,Ridly Greig,C,OTT,22,82,16,19,35
95,8471698,T.J. Oshie,R,WSH,38,82,14,21,35
95,8477953,Kasperi Kapanen,R,STL,28,82,14,21,35
95,8480849,Barrett Hayton,C,UTA,24,82,14,21,35
95,8475171,Oliver Ekman-Larsson,D,TOR,33,82,12,23,35
95,8475855,Jesper Fast,R,CAR,33,82,11,24,35
95,8475149,Marcus Johansson,L,MIN,34,82,6,29,35
95,8476902,Esa Lindell,D,DAL,30,82,5,30,35
95,8481604,Pavel Dorofeyev,L,VGK,24,82,21,13,34
95,8482079,Marco Rossi,C,MIN,23,82,19,15,34
95,8480829,Jesperi Kotkaniemi,C,CAR,24,82,18,16,34
95,8477919,Frederick Gaudreau,C,MIN,31,82,18,16,34
95,8475220,Marcus Foligno,L,MIN,33,82,18,16,34
95,8479591,Michael Eyssimont,C,TBL,28,82,16,18,34
95,8478413,Jordan Greenway,L,BUF,27,82,13,21,34
95,8477429,Andrew Copp,C,DET,30,82,11,23,34
95,8473563,Nicklas Backstrom,C,WSH,37,82,11,23,34
95,8482671,Owen Power,D,BUF,22,82,7,27,34
95,8477969,Marcus Pettersson,D,PIT,28,82,6,28,34
95,8474189,Lars Eller,C,PIT,35,82,18,15,33
95,8476469,Joel Armia,R,MTL,31,82,17,16,33
95,8480802,Ryan McLeod,C,BUF,25,82,17,16,33
95,8481582,Nicholas Robertson,L,TOR,23,82,14,19,33
95,8481553,Bobby Brink,R,PHI,23,82,12,21,33
95,8478109,Victor Olofsson,L,VGK,29,82,12,21,33
95,8477450,Jason Dickinson,C,CHI,29,82,11,22,33
95,8480073,Erik Brannstrom,D,COL,25,82,10,23,33
95,8480336,Sean Walker,D,CAR,30,82,9,24,33
95,8477508,Curtis Lazar,C,NJD,29,82,9,24,33
95,8480145,Neal Pionk,D,WPG,29,82,6,27,33
95,8478882,Vladislav Gavrikov,D,LAK,29,82,6,27,33
95,8480035,Henri Jokiharju,D,BUF,25,82,4,29,33
95,8479293,Brandon Tanev,L,SEA,33,82,19,13,32
95,8476374,Sean Kuraly,C,CBJ,31,82,15,17,32
95,8481656,Aliaksei Protas,C,WSH,23,82,14,18,32
95,8477425,Miles Wood,L,COL,29,82,14,18,32
95,8477015,Connor Brown,R,EDM,30,82,13,19,32
95,8476463,Jonas Brodin,D,MIN,31,82,8,24,32
95,8479980,Nicolas Hague,D,VGK,26,82,7,25,32
95,8482245,Artem Zub,D,OTT,29,82,7,25,32
95,8480855,Jack McBain,C,UTA,24,82,19,12,31
95,8484145,Zach Benson,L,BUF,19,82,16,15,31
95,8479390,Taylor Raddysh,R,WSH,26,82,16,15,31
95,8481186,Logan O'Connor,R,COL,28,82,15,16,31
95,8477839,Conor Sheary,L,TBL,32,82,12,19,31
95,8479316,Luke Kunin,C,SJS,27,82,11,20,31
95,8473422,Nick Foligno,L,CHI,37,82,9,22,31
95,8478911,Matt Roy,D,WSH,29,82,8,23,31
95,8483431,Logan Cooley,C,UTA,20,82,20,10,30
95,8482089,Jake Neighbours,L,STL,22,82,19,11,30
95,8478508,Yakov Trenin,C,MIN,27,82,17,13,30
95,8480835,Jack Drury,C,CAR,24,82,14,16,30
95,8480748,Kiefer Sherwood,L,VAN,29,82,12,18,30
95,8481567,Henry Thrun,D,SJS,23,82,6,24,30
95,8476331,Dylan DeMelo,D,WPG,31,82,2,28,30
95,8480873,Rasmus Sandin,D,WSH,24,82,2,28,30
95,8479398,Samuel Girard,D,COL,26,82,2,28,30
95,8484166,Adam Fantilli,C,CBJ,20,82,18,11,29
95,8478013,Jake Walman,D,SJS,28,82,15,14,29
95,8478211,Dryden Hunt,L,CGY,29,82,15,14,29
95,8476897,Oskar Sundqvist,C,STL,30,82,14,15,29
95,8482141,Lukas Cormier,D,VGK,22,82,13,16,29
95,8480813,Joe Veleno,C,DET,24,82,11,18,29
95,8484153,Leo Carlsson,C,ANA,20,82,11,18,29
95,8480025,MacKenzie Entwistle,R,FLA,25,82,9,20,29
95,8476917,Adam Pelech,D,NYI,30,82,8,21,29
95,8479983,Mario Ferraro,D,SJS,26,82,8,21,29
95,8477507,Nikita Zadorov,D,BOS,29,82,8,21,29
95,8478840,Will Borgen,D,SEA,28,82,5,24,29
95,8479402,Jake Bean,D,CGY,26,82,4,25,29
95,8476879,Cody Ceci,D,EDM,31,82,4,25,29
95,8475181,Nick Leddy,D,STL,33,82,3,26,29
95,8479353,Brett Howden,C,VGK,26,82,19,9,28
95,8476981,Josh Anderson,R,MTL,30,82,17,11,28
95,8482624,Daniil Miromanov,D,CGY,27,82,13,15,28
95,8481013,Jonatan Berggren,R,DET,24,82,11,17,28
95,8477353,Tyler Motte,C,DET,29,82,11,17,28
95,8481093,Rafael Harvey-Pinard,L,MTL,25,82,11,17,28
95,8477435,Ryan Graves,D,PIT,29,82,6,22,28
95,8479371,Dante Fabbro,D,NSH,26,82,5,23,28
95,8477392,Hudson Fasching,R,NYI,29,82,16,11,27
95,8477903,Garnet Hathaway,R,PHI,33,82,14,13,27
95,8476278,Colin Blackwell,C,DAL,31,82,14,13,27
95,8479414,Nathan Bastian,R,NJD,27,82,14,13,27
95,8480448,Parker Kelly,L,COL,25,82,14,13,27
95,8479661,Tanner Jeannot,L,LAK,27,82,12,15,27
95,8477938,Haydn Fleury,D,WPG,28,82,11,16,27
95,8481704,Juuso Parssinen,C,NSH,23,82,10,17,27
95,8480068,Ryan Poehling,C,PHI,25,82,10,17,27
95,8474149,Evgenii Dadonov,R,DAL,35,82,9,18,27
95,8480144,David Kampf,C,TOR,29,82,8,19,27
95,8483495,Simon Nemec,D,NJD,20,82,8,19,27
95,8474716,Jared Spurgeon,D,MIN,35,82,7,20,27
95,8480806,Isac Lundestrom,C,ANA,25,82,7,20,27
95,8476312,Josh Manson,D,COL,33,82,7,20,27
95,8483490,Pavel Mintyukov,D,ANA,21,82,5,22,27
95,8475690,Chris Tanev,D,TOR,35,82,3,24,27
95,8474673,TJ Brodie,D,CHI,34,82,1,26,27
95,8480281,Alexey Toropchenko,R,STL,25,82,17,9,26
95,8476873,Mark Jankowski,C,NSH,30,82,15,11,26
95,8476392,Adam Lowry,C,WPG,31,82,13,13,26
95,8481517,Brett Leason,R,ANA,25,82,12,14,26
95,8470621,Corey Perry,R,EDM,39,82,11,15,26
95,8480074,Alexandre Texier,C,STL,25,82,9,17,26
95,8477506,Ryan Pulock,D,NYI,30,82,5,21,26
95,8475455,Brenden Dillon,D,NJD,34,82,5,21,26
95,8483565,Nick Blankenburg,D,NSH,26,82,5,21,26
95,8476422,Mike Reilly,D,NYI,31,82,3,23,26
95,8481014,Alexander Romanov,D,NYI,24,82,3,23,26
95,8482655,J.J. Moser,D,TBL,24,82,3,23,26
95,8478507,John Marino,D,UTA,27,82,2,24,26
95,8476918,Jimmy Vesey,L,NYR,31,82,16,9,25
95,8478569,Noel Acciari,C,PIT,33,82,14,11,25
95,8475231,Casey Cizikas,C,NYI,33,82,12,13,25
95,8480980,Connor Dewar,C,TOR,25,82,12,13,25
95,8478432,Christian Fischer,R,DET,27,82,12,13,25
95,8478399,Jonas Siegenthaler,D,NJD,27,82,7,18,25
95,8481522,Peyton Krebs,C,BUF,23,82,6,19,25
95,8478416,Erik Cernak,D,TBL,27,82,6,19,25
95,8483457,Lane Hutson,D,MTL,20,82,5,20,25
95,8479369,Andrew Peeke,D,BOS,26,82,4,21,25
95,8481028,Martin Pospisil,C,CGY,25,82,13,11,24
95,8482111,Justin Barron,D,MTL,23,82,10,14,24
95,8476442,Matt Nieto,L,PIT,32,82,10,14,24
95,8478178,Darren Raddysh,D,TBL,28,82,7,17,24
95,8475233,David Savard,D,MTL,34,82,3,21,24
95,8479976,Juuso Valimaki,D,UTA,26,82,2,22,24
95,8482122,Brock Faber,D,MIN,22,82,2,22,24
95,8480860,Kevin Bahl,D,CGY,24,82,0,24,24
95,8479941,Justin Danforth,R,CBJ,31,82,15,8,23
95,8476889,Radek Faksa,C,STL,30,82,11,12,23
95,8482166,Shakir Mukhamadullin,D,SJS,22,82,9,14,23
95,8478859,Niko Mikkola,D,FLA,28,82,7,16,23
95,8476429,Scott Mayfield,D,NYI,32,82,3,20,23
95,8478136,Jake Middleton,D,MIN,28,82,3,20,23
95,8482259,Bobby McMann,C,TOR,28,82,17,5,22
95,8482155,Alex Laferriere,R,LAK,23,82,13,9,22
95,8476624,Barclay Goodrow,C,SJS,31,82,11,11,22
95,8477406,Mattias Janmark,C,EDM,32,82,11,11,22
95,8481477,Nico Sturm,C,SJS,29,82,10,12,22
95,8480789,Oliver Wahlstrom,R,NYI,24,82,9,13,22
95,8478434,Keegan Kolesar,R,VGK,27,82,9,13,22
95,8482101,Danil Gushchin,L,SJS,22,82,9,13,22
95,8483505,Matthew Poitras,C,BOS,20,82,8,14,22
95,8480003,Jesper Boqvist,C,FLA,26,82,7,15,22
95,8476467,Jamie Oleksiak,D,SEA,32,82,7,15,22
95,8473507,Jeff Petry,D,DET,37,82,5,17,22
95,8476457,Adam Larsson,D,SEA,32,82,4,18,22
95,8475324,Nick Jensen,D,OTT,34,82,3,19,22
95,8476525,Colin Miller,D,WPG,32,82,3,19,22
95,8482087,Kaiden Guhle,D,MTL,22,82,3,19,22
95,8475188,Brayden McNabb,D,VGK,33,82,2,20,22
95,8479324,Ryan Lindgren,D,NYR,26,82,2,20,22
95,8476858,Phillip Di Giuseppe,L,VAN,31,82,15,6,21
95,8481641,Joel Kiviranta,L,COL,28,82,13,8,21
95,8482125,Alexander Holtz,R,VGK,22,82,10,11,21
95,8483763,Maksymilian Szuber,D,UTA,22,82,10,11,21
95,8475343,Nic Dowd,C,WSH,34,82,9,12,21
95,8482062,Cole Smith,L,NSH,29,82,9,12,21
95,8480246,Nick Perbix,D,TBL,26,82,7,14,21
95,8484203,Bradly Nadeau,L,CAR,19,82,6,15,21
95,8483445,Cutter Gauthier,L,ANA,20,82,6,15,21
95,8475279,Ben Chiarot,D,DET,33,82,6,15,21
95,8477220,Nate Schmidt,D,FLA,33,82,5,16,21
95,8475762,Derek Forbort,D,VAN,32,82,4,17,21
95,8478500,Ivan Provorov,D,CBJ,27,82,3,18,21
95,8482073,Braden Schneider,D,NYR,23,82,3,18,21
95,8470600,Ryan Suter,D,STL,39,82,2,19,21
95,8476892,Colton Parayko,D,STL,31,82,1,20,21
95,8480879,Jacob Bernard-Docker,D,OTT,24,82,1,20,21
95,8482679,Matt Coronato,R,CGY,22,82,10,10,20
95,8480870,Bo Groulx,C,NYR,24,82,10,10,20
95,8477505,Alexander Wennberg,C,SJS,30,82,9,11,20
95,8481708,Zac Jones,D,NYR,24,82,6,14,20
95,8477947,Sonny Milano,L,WSH,28,82,5,15,20
95,8480222,Sebastian Aho,D,PIT,28,82,5,15,20
95,8476891,Matt Grzelcyk,D,PIT,30,82,4,16,20
95,8482142,Jamie Drysdale,D,PHI,22,82,3,17,20
95,8478851,Alexandre Carrier,D,NSH,28,82,3,17,20
95,8480807,Mattias Samuelsson,D,BUF,24,82,1,19,20
95,8480049,Dylan Samberg,D,WPG,25,82,0,20,20
95,8481601,Simon Holmstrom,R,NYI,23,82,13,6,19
95,8482749,Joshua Roy,R,MTL,21,82,11,8,19
95,8482659,Josh Doan,R,UTA,22,82,10,9,19
95,8482153,Brendan Brisson,C,VGK,23,82,9,10,19
95,8477931,Tomas Nosek,L,FLA,32,82,8,11,19
95,8480021,Jack Studnicka,C,LAK,25,82,8,11,19
95,8483499,Liam Ohgren,L,MIN,20,82,8,11,19
95,8483468,Jiri Kulich,C,BUF,20,82,7,12,19
95,8478133,Jake Evans,C,MTL,28,82,6,13,19
95,8481178,Egor Zamula,D,PHI,24,82,5,14,19
95,8477365,Connor Clifton,D,BUF,29,82,5,14,19
95,8482713,Mackie Samoskevich,R,FLA,22,82,5,14,19
95,8477499,Rasmus Ristolainen,D,PHI,30,82,4,15,19
95,8482803,Olen Zellweger,D,ANA,21,82,4,15,19
95,8479998,Mikey Anderson,D,LAK,25,82,1,18,19
95,8483524,Shane Wright,C,SEA,20,82,13,5,18
95,8482733,Logan Mailloux,D,MTL,31,82,9,9,18
95,8481524,Bowen Byram,D,BUF,23,82,9,9,18
95,8482858,Ryker Evans,D,SEA,23,82,6,12,18
95,8483482,Tristan Luneau,D,ANA,20,82,5,13,18
95,8474090,Brendan Smith,D,DAL,35,82,5,13,18
95,8475462,Radko Gudas,D,ANA,34,82,4,14,18
95,8484149,Gavin Brindley,C,CBJ,20,82,3,15,18
95,8477488,Brett Pesce,D,NJD,30,82,2,16,18
95,8477845,Trevor van Riemsdyk,D,WSH,33,82,2,16,18
95,8475790,Erik Gudbranson,D,CBJ,32,82,2,16,18
95,8483012,Logan Morrison,C,SEA,22,82,11,6,17
95,8482666,Scott Morrow,D,CAR,22,82,8,9,17
95,8481568,Alex Vlasic,D,CHI,23,82,5,12,17
95,8482762,Simon Edvinsson,D,DET,21,82,5,12,17
95,8480172,Jan Rutta,D,SJS,34,82,4,13,17
95,8480990,Declan Chisholm,D,MIN,24,82,4,13,17
95,8483493,Frank Nazar,C,CHI,20,82,3,14,17
95,8483397,Marc McLaughlin,C,BOS,25,82,11,5,16
95,8482074,Connor Zary,C,CGY,23,82,9,7,16
95,8479368,Max Jones,L,BOS,26,82,8,8,16
95,8475842,Sam Carrick,C,NYR,32,82,7,9,16
95,8479359,Beck Malenstyn,L,BUF,26,82,6,10,16
95,8478450,Parker Wotherspoon,D,BOS,27,82,6,10,16
95,8482145,Mavrik Bourque,C,DAL,22,82,5,11,16
95,8480950,Ilya Lyubushkin,D,DAL,30,82,4,12,16
95,8479638,Justin Brazeau,R,BOS,26,82,4,12,16
95,8471677,Jack Johnson,D,CBJ,37,82,2,14,16
95,8476822,Luke Glendening,C,TBL,35,82,12,3,15
95,8482077,Dylan Holloway,L,EDM,23,82,11,4,15
95,8473453,Trevor Lewis,C,LAK,37,82,7,8,15
95,8476878,Zemgus Girgensons,L,TBL,30,82,7,8,15
95,8479291,Kevin Rooney,C,CGY,31,82,7,8,15
95,8483466,Kevin Korchinski,D,CHI,20,82,6,9,15
95,8479442,Troy Stecher,D,EDM,30,82,5,10,15
95,8482702,Logan Stankoven,C,DAL,21,82,5,10,15
95,8477335,Kyle Burroughs,D,LAK,29,82,5,10,15
95,8476441,Joel Edmundson,D,LAK,31,82,3,12,15
95,8474013,Ian Cole,D,UTA,35,82,2,13,15
95,8478874,Adam Gaudette,C,OTT,28,82,2,13,15
95,8476967,Brett Kulak,D,EDM,30,82,2,13,15
95,8481699,Aku Raty,R,UTA,23,82,7,7,14
95,8482712,Oskar Olausson,R,COL,22,82,7,7,14
95,8482118,Sam Colangelo,R,ANA,23,82,6,8,14
95,8478468,Jeremy Lauzon,D,NSH,27,82,5,9,14
95,8484911,Collin Graf,R,SJS,22,82,5,9,14
95,8482470,Ilya Solovyov,D,CGY,24,82,2,12,14
95,8480834,Ty Emberson,D,SJS,24,82,2,12,14
95,8483460,David Jiricek,D,CBJ,21,82,2,12,14
95,8476372,Nick Seeler,D,PHI,31,82,1,13,14
95,8478443,Brandon Carlo,D,BOS,28,82,0,14,14
95,8481122,Simon Benoit,D,TOR,26,82,8,5,13
95,8482807,Ethan Del Mastro,D,CHI,21,82,7,6,13
95,8483567,Georgii Merkulov,C,BOS,24,82,6,7,13
95,8477369,Carson Soucy,D,VAN,30,82,4,9,13
95,8476473,Connor Murphy,D,CHI,31,82,4,9,13
95,8474612,Travis Hamonic,D,OTT,34,82,3,10,13
95,8480796,Martin Fehervary,D,WSH,25,82,5,7,12
95,8474567,Zach Bogosian,D,MIN,34,82,5,7,12
95,8475177,Calvin de Haan,D,COL,33,82,4,8,12
95,8482809,Jackson Blake,R,CAR,21,82,4,8,12
95,8483471,Brad Lambert,C,WPG,31,82,1,11,12
95,8482859,Zack Ostapchuk,C,OTT,21,82,4,7,11
95,8482516,Matthew Kessel,D,STL,24,82,3,8,11
95,8477034,Jaycob Megna,D,FLA,32,82,2,9,11
95,8475718,Justin Holl,D,DET,32,82,1,10,11
95,8481605,Jackson LaCombe,D,ANA,23,82,3,7,10
95,8483489,Fraser Minten,C,TOR,31,82,3,7,10
95,8479576,Vincent Desharnais,D,VAN,28,82,2,8,10
95,8482787,Nikita Chibrikov,R,WPG,31,82,3,3,6
95,8482070,Mitchell Chaffee,R,TBL,26,82,1,2,3
95,8474062,Riley Nash,C,NYR,35,82,2,0,2
95,8470794,Joe Pavelski,C,,40,0,0,0,0
95,8481703,Valtteri Puustinen,R,PIT,25,0,0,0,0
95,8477950,Tony DeAngelo,D,,29,0,0,0,0
95,8481577,Philip Tomasino,C,NSH,23,0,0,0,0
95,8475197,Tyson Barrie,D,,33,0,0,0,0
95,8471218,Blake Wheeler,R,,38,0,0,0,0
95,8474157,Max Pacioretty,L,,36,0,0,0,0
95,8478466,Daniel Sprong,R,VAN,27,0,0,0,0
95,8475744,Evgeny Kuznetsov,C,,32,0,0,0,0
95,8481019,David Gustafsson,C,WPG,24,0,0,0,0
95,8475906,John Klingberg,D,,32,0,0,0,0
95,8479348,Kale Clague,D,BUF,26,0,0,0,0
95,8476952,Dominic Toninato,C,WPG,30,0,0,0,0
95,8473473,Milan Lucic,L,,36,0,0,0,0
95,8474037,James van Riemsdyk,L,,35,0,0,0,0
95,8474602,Justin Schultz,D,,34,0,0,0,0
95,8482222,Alexander Barabanov,L,,30,0,0,0,0
95,8479372,Josh Mahura,D,SEA,26,0,0,0,0
95,8479982,Conor Timmins,D,TOR,26,0,0,0,0
95,8474031,Kevin Shattenkirk,D,,35,0,0,0,0
95,8480008,Adam Ruzicka,C,,25,0,0,0,0
95,8481059,Scott Perunovich,D,STL,26,0,0,0,0
95,8480884,Calen Addison,D,,24,0,0,0,0
95,8476994,Vinnie Hinostroza,C,NSH,30,0,0,0,0
95,8478452,Caleb Jones,D,LAK,27,0,0,0,0
95,8480157,Calle Rosen,D,COL,30,0,0,0,0
95,8481609,Vladislav Kolyachonok,D,UTA,23,0,0,0,0
95,8479415,Michael McLeod,C,,26,0,0,0,0
95,8476919,Chris Tierney,C,,30,0,0,0,0
95,8479639,Dylan Coghlan,D,WPG,26,0,0,0,0
95,8478146,Matthew Highmore,C,OTT,28,0,0,0,0
95,8478970,Jalen Chatfield,D,CAR,28,0,0,0,0
95,8480205,Emil Bemstrom,C,PIT,25,0,0,0,0
95,8474884,Mike Hoffman,C,,35,0,0,0,0
95,8471274,Alex Goligoski,D,,39,0,0,0,0
95,8478104,Sammy Blais,L,,28,0,0,0,0
95,8474870,Tyler Johnson,C,,34,0,0,0,0
95,8476913,Devin Shore,C,MIN,30,0,0,0,0
95,8481598,Philip Broberg,D,EDM,23,0,0,0,0
95,8480058,Pierre-Olivier Joseph,D,STL,25,0,0,0,0
95,8480891,Michael Kesselring,D,UTA,24,0,0,0,0
95,8477979,Nicolas Aube-Kubel,R,BUF,28,0,0,0,0
95,8476871,Tanner Pearson,L,,32,0,0,0,0
95,8476393,Nick Cousins,C,,31,0,0,0,0
95,8479977,Kailer Yamamoto,R,,26,0,0,0,0
95,8479543,Michael Pezzetta,L,MTL,26,0,0,0,0
95,8477018,Ben Hutton,D,VGK,31,0,0,0,0
95,8480762,Eric Robinson,L,CAR,29,0,0,0,0
95,8474034,Pat Maroon,L,CHI,36,0,0,0,0
95,8481058,Jesse Ylönen,R,,25,0,0,0,0
95,8475179,Dmitry Kulikov,D,FLA,34,0,0,0,0
95,8481527,Kaedan Korczak,D,VGK,23,0,0,0,0
95,8473449,Kyle Okposo,R,,36,0,0,0,0
95,8482192,Isaak Phillips,D,CHI,23,0,0,0,0
95,8480727,Zach Whitecloud,D,VGK,28,0,0,0,0
95,8479346,Dillon Dube,C,,26,0,0,0,0
95,8480821,Filip Zadina,R,,25,0,0,0,0
95,8480001,Urho Vaakanainen,D,ANA,25,0,0,0,0
95,8470966,Mark Giordano,D,,41,0,0,0,0
95,8480853,Liam Foudy,C,,24,0,0,0,0
95,8475225,Craig Smith,C,CHI,35,0,0,0,0
95,8479972,Mason Shaw,C,WPG,26,0,0,0,0
95,8478451,Ethan Bear,D,WSH,27,0,0,0,0
95,8474040,Sam Gagner,C,,35,0,0,0,0
95,8480196,Jacob Bryson,D,BUF,27,0,0,0,0
95,8479984,Cal Foote,D,,26,0,0,0,0
95,8480011,Klim Kostin,C,SJS,25,0,0,0,0
95,8482176,Wyatt Kaiser,D,CHI,22,0,0,0,0
95,8476988,Matt Benning,D,SJS,30,0,0,0,0
95,8479370,Tyson Jost,C,CAR,26,0,0,0,0
95,8477464,Nic Petan,C,,29,0,0,0,0
95,8477380,Jonny Brodzinski,C,NYR,31,0,0,0,0
95,8480070,Ian Mitchell,D,BOS,25,0,0,0,0
95,8479315,Joey Anderson,R,CHI,26,0,0,0,0
95,8478099,Kevin Labanc,R,,29,0,0,0,0
95,8476874,Olli Maatta,D,DET,30,0,0,0,0
95,8475208,Brian Dumoulin,D,ANA,33,0,0,0,0
95,8478430,Oliver Kylington,D,,27,0,0,0,0
95,8479536,Axel Jonsson-Fjallby,L,WPG,26,0,0,0,0
95,8479671,Mathieu Olivier,R,CBJ,27,0,0,0,0
95,8471709,Marc-Edouard Vlasic,D,SJS,37,0,0,0,0
95,8479328,Julien Gauthier,R,NYI,27,0,0,0,0
95,8478421,A.J. Greer,L,FLA,28,0,0,0,0
95,8477573,Nathan Walker,L,STL,30,0,0,0,0
95,8481537,Nikita Okhotiuk,D,CGY,24,0,0,0,0
95,8474166,Alec Martinez,D,CHI,37,0,0,0,0
95,8470610,Zach Parise,L,,40,0,0,0,0
95,8477478,William Carrier,L,CAR,30,0,0,0,0
95,8479344,Jesse Puljujarvi,R,PIT,26,0,0,0,0
95,8480887,Jordan Harris,D,MTL,24,0,0,0,0
95,8478502,Dennis Gilbert,D,BUF,28,0,0,0,0
95,8482730,Brandt Clarke,D,LAK,21,0,0,0,0
95,8480355,Mark Kastelic,C,BOS,25,0,0,0,0
95,8475750,Jon Merrill,D,MIN,32,0,0,0,0
95,8475164,Jakob Silfverberg,R,,34,0,0,0,0
95,8477944,Jakub Vrana,L,,28,0,0,0,0
95,8479439,Jacob MacDonald,D,COL,31,0,0,0,0
95,8474568,Luke Schenn,D,NSH,35,0,0,0,0
95,8478454,Noah Juulsen,D,VAN,27,0,0,0,0
95,8475752,Tyler Pitlick,C,,33,0,0,0,0
95,8482148,Hendrix Lapierre,C,WSH,22,0,0,0,0
95,8481167,Brayden Pachal,D,CGY,25,0,0,0,0
95,8478043,Sam Lafferty,C,BUF,29,0,0,0,0
95,8479321,Lucas Johansen,D,,27,0,0,0,0
95,8471699,Andrew Cogliano,C,,37,0,0,0,0
95,8481521,Ronnie Attard,D,PHI,25,0,0,0,0
95,8481161,Jake Christiansen,D,CBJ,25,0,0,0,0
95,8479458,Nikita Zaitsev,D,,33,0,0,0,0
95,8479619,Michael Carcone,L,UTA,28,0,0,0,0
95,8479026,Philippe Myers,D,TOR,27,0,0,0,0
95,8477330,Dominik Kubalik,L,,29,0,0,0,0
95,8481617,Vasily Podkolzin,R,VAN,23,0,0,0,0
95,8481701,Santeri Hatakka,D,NJD,23,0,0,0,0
95,8479514,Rem Pitlick,C,,27,0,0,0,0
95,8477446,Michael McCarron,R,NSH,29,0,0,0,0
95,8470604,Jeff Carter,C,,39,0,0,0,0
95,8482241,Radim Zohorna,L,,28,0,0,0,0
95,8480289,Morgan Barron,C,WPG,26,0,0,0,0
95,8479379,Givani Smith,R,SJS,26,0,0,0,0
95,8480216,Jacob Peterson,C,,25,0,0,0,0
95,8477851,Jordan Oesterle,D,BOS,32,0,0,0,0
95,8484258,Sam Malinski,D,COL,26,0,0,0,0
95,8478904,Steven Lorentz,C,,28,0,0,0,0
95,8482095,Tyler Kleven,D,OTT,22,0,0,0,0
95,8480848,Ty Dellandrea,C,SJS,24,0,0,0,0
95,8476884,Derrick Pouliot,D,,30,0,0,0,0
95,8479336,Carl Grundstrom,R,SJS,27,0,0,0,0
95,8482964,Arber Xhekaj,D,MTL,23,0,0,0,0
95,8471686,Marc Staal,D,,37,0,0,0,0
95,8477887,Patrick Brown,C,BOS,32,0,0,0,0
95,8478495,Denis Gurianov,R,,27,0,0,0,0
95,8473504,Cal Clutterbuck,R,,37,0,0,0,0
95,8481550,Adam Beckman,L,NJD,23,0,0,0,0
95,8480845,Rasmus Kupari,C,WPG,24,0,0,0,0
95,8474009,Nick Bonino,C,,36,0,0,0,0
95,8478585,Derek Ryan,C,EDM,38,0,0,0,0
95,8477962,Brendan Lemieux,L,CAR,28,0,0,0,0
95,8482861,Vincent Iorio,D,WSH,22,0,0,0,0
95,8479378,Logan Stanley,D,WPG,26,0,0,0,0
95,8473446,Erik Johnson,D,PHI,36,0,0,0,0
95,8481743,Marc Del Gaizo,D,NSH,25,0,0,0,0
95,8477384,Josh Brown,D,EDM,30,0,0,0,0
95,8482165,Yan Kuznetsov,D,CGY,22,0,0,0,0
95,8478424,Jansen Harkins,C,ANA,27,0,0,0,0
95,8482144,Jack Thompson,D,SJS,22,0,0,0,0
95,8478512,Austin Czarnik,C,,32,0,0,0,0
95,8477527,Ross Johnston,L,ANA,30,0,0,0,0
95,8479383,Boris Katchouk,L,,26,0,0,0,0
95,8482094,Daemon Hunt,D,MIN,22,0,0,0,0
95,8481719,Maxwell Crozier,D,TBL,24,0,0,0,0
95,8480192,Johnathan Kovacevic,D,NJD,27,0,0,0,0
95,8479376,Victor Mete,D,,26,0,0,0,0
95,8482511,Mason Lohrei,D,BOS,23,0,0,0,0
95,8475825,Jani Hakanpää,D,,32,0,0,0,0
95,8478021,William Lagesson,D,DET,28,0,0,0,0
95,8475795,Dylan McIlrath,D,WSH,32,0,0,0,0
95,8477846,Ryan Carpenter,C,,33,0,0,0,0
95,8481056,Spencer Stastney,D,NSH,24,0,0,0,0
95,8481564,Ryan Johnson,D,BUF,23,0,0,0,0
95,8478017,Mark Friedman,D,VAN,29,0,0,0,0
95,8479320,Max Lajoie,D,SEA,27,0,0,0,0
95,8480075,Cameron Crotty,D,MIN,25,0,0,0,0
95,8484287,Cole McWard,D,VAN,23,0,0,0,0
95,8484254,Akito Hirose,D,VAN,25,0,0,0,0
95,8483407,Brandon Scanlin,D,NYR,25,0,0,0,0
95,8480274,Philip Kemp,D,EDM,25,0,0,0,0
95,8479522,Hardy Haman Aktell,D,WSH,26,0,0,0,0
95,8480007,Jonas Rondbjerg,R,VGK,25,0,0,0,0
95,8477454,Adam Erne,L,,29,0,0,0,0
95,8481679,Maxence Guenette,D,OTT,23,0,0,0,0
95,8480441,Trey Fix-Wolansky,R,CBJ,25,0,0,0,0
95,8483546,Marshall Rifai,D,TOR,26,0,0,0,0
95,8480084,Nick DeSimone,D,NJD,30,0,0,0,0
95,8481030,Jack St. Ivany,D,PIT,25,0,0,0,0
95,8481592,Jakob Pelletier,L,CGY,23,0,0,0,0
95,8478011,Louie Belpedio,D,PHI,28,0,0,0,0
95,8477930,Pierre-Edouard Bellemare,L,,39,0,0,0,0
95,8484321,Nikolas Matinpalo,D,OTT,26,0,0,0,0
95,8482067,Connor Mackey,D,NYR,28,0,0,0,0
95,8481806,Louis Crevier,D,CHI,23,0,0,0,0
95,8484326,Patrik Koch,D,UTA,28,0,0,0,0
95,8477971,Andreas Englund,D,LAK,28,0,0,0,0
95,8481751,Lukas Rousek,R,BUF,25,0,0,0,0
95,8481006,Tyler Tucker,D,STL,24,0,0,0,0
95,8476867,Brendan Gaunce,C,MIN,30,0,0,0,0
95,8479520,Brandon Duhaime,R,WSH,27,0,0,0,0
95,8477073,Kurtis MacDermid,L,NJD,30,0,0,0,0
95,8480874,Adam Ginning,D,PHI,24,0,0,0,0
95,8477473,Justin Bailey,R,SJS,29,0,0,0,0
95,8479066,Ryan Lomberg,L,CGY,30,0,0,0,0
95,8477070,Liam O'Brien,C,UTA,30,0,0,0,0
95,8474618,Marco Scandella,D,,34,0,0,0,0
95,8475797,Jarred Tinordi,D,,32,0,0,0,0
95,8481441,Joe Snively,C,DET,28,0,0,0,0
95,8477244,Chad Ruhwedel,D,NYR,34,0,0,0,0
95,8479772,Zack MacEwen,R,OTT,28,0,0,0,0
95,8481147,Reese Johnson,C,MIN,26,0,0,0,0
95,8481043,Cole Koepke,L,BOS,26,0,0,0,0
95,8483619,Filip Roos,D,OTT,25,0,0,0,0
95,8481541,Samuel Bolduc,D,NYI,24,0,0,0,0
95,8477810,Joel Hanley,D,CGY,33,0,0,0,0
95,8476907,Mackenzie MacEachern,L,,30,0,0,0,0
95,8482652,Walker Duehr,R,CGY,27,0,0,0,0
95,8477126,Jayson Megna,C,,34,0,0,0,0
95,8483398,Declan Carlile,D,TBL,31,0,0,0,0
95,8482929,Emil Lilleberg,D,TBL,23,0,0,0,0
95,8480880,Jakub Lauko,C,MIN,24,0,0,0,0
95,8480245,Olle Lycksell,R,PHI,25,0,0,0,0
95,8480252,Cole Guttman,C,CHI,25,0,0,0,0
95,8477467,Gustav Olofsson,D,SEA,30,0,0,0,0
95,8479968,Vinni Lettieri,C,BOS,29,0,0,0,0
95,8478400,Colin White,C,,27,0,0,0,0
95,8475755,Alexander Petrovic,D,DAL,32,0,0,0,0
95,8481812,Nikolai Knyzhov,D,,27,0,0,0,0
95,8481593,Jayden Struble,D,MTL,23,0,0,0,0
95,8481532,Alex Turcotte,C,LAK,23,0,0,0,0
95,8482126,Emil Andrae,D,PHI,31,0,0,0,0
95,8479944,Zach Aston-Reese,C,VGK,30,0,0,0,0
95,8471817,Ryan Reaves,R,TOR,37,0,0,0,0
95,8481206,John Ludvig,D,PIT,24,0,0,0,0
95,8481599,Victor Soderstrom,D,UTA,23,0,0,0,0
95,8480292,Carson Meyer,R,ANA,27,0,0,0,0
95,8482496,Nils Aman,C,VAN,24,0,0,0,0
95,8479718,Alex Barré-Boulet,C,MTL,27,0,0,0,0
95,8479994,Jaret Anderson-Dolan,C,WPG,25,0,0,0,0
95,8480184,Gustav Lindstrom,D,,26,0,0,0,0
95,8480890,Jan Jenik,R,OTT,24,0,0,0,0
95,8478067,Oskar Lindblom,L,,28,0,0,0,0
95,8476934,Brock McGinn,L,ANA,30,0,0,0,0
95,8479985,Cale Fleury,D,SEA,26,0,0,0,0
95,8484304,Uvis Balinskis,D,FLA,28,0,0,0,0
95,8479981,Jonah Gadjovich,L,FLA,26,0,0,0,0
95,8481716,Dmitri Voronkov,L,CBJ,24,0,0,0,0
95,8474709,Matt Martin,L,,35,0,0,0,0
95,8482634,Alex Steeves,C,TOR,25,0,0,0,0
95,8480823,Alexander Alexeyev,D,WSH,25,0,0,0,0
95,8477541,Dakota Mermis,D,TOR,30,0,0,0,0
95,8483491,Ivan Miroshnichenko,L,WSH,20,0,0,0,0
95,8478477,Mitchell Stephens,C,SEA,27,0,0,0,0
95,8481543,Nikita Alexandrov,C,STL,24,0,0,0,0
95,8479423,Alex Nylander,L,,26,0,0,0,0
95,8482451,Mikael Pyyhtia,L,CBJ,23,0,0,0,0
95,8478831,Kevin Stenlund,C,UTA,28,0,0,0,0
95,8480306,Grant Hutton,D,NYI,29,0,0,0,0
95,8478028,Fredrik Olofsson,L,,28,0,0,0,0
95,8477462,Robert Hagg,D,VGK,29,0,0,0,0
95,8477320,Anton Blidh,L,NYR,29,0,0,0,0
95,8482157,Will Cuylle,L,NYR,22,0,0,0,0
95,8482737,Zack Bolduc,C,STL,21,0,0,0,0
95,8481239,Samuel Fagemo,L,,24,0,0,0,0
95,8481600,Tobias Bjornfot,D,FLA,23,0,0,0,0
95,8478409,Anthony Richard,C,PHI,28,0,0,0,0
95,8474145,Robert Bortuzzo,D,,35,0,0,0,0
95,8475958,Michael Sgarbossa,C,WSH,32,0,0,0,0
95,8479986,Kole Lind,R,DAL,26,0,0,0,0
95,8479249,Andrew Poturalski,C,SJS,30,0,0,0,0
95,8479362,Riley Tufte,L,BOS,26,0,0,0,0
95,8479991,Jake Leschyshyn,C,NYR,25,0,0,0,0
95,8479587,Rhett Gardner,C,PHI,28,0,0,0,0
95,8482744,James Malatesta,L,CBJ,21,0,0,0,0
95,8478854,Ryan Shea,D,PIT,27,0,0,0,0
95,8481591,Sam Poulin,R,,23,0,0,0,0
95,8483512,Matt Savoie,C,EDM,20,0,0,0,0
95,8482102,Vasily Ponomarev,C,PIT,22,0,0,0,0
95,8482162,Roby Jarventie,L,EDM,22,0,0,0,0
95,8481016,Ruslan Iskhakov,C,,24,0,0,0,0
95,8482172,Landon Slaggert,L,CHI,22,0,0,0,0
95,8482747,Brennan Othmann,L,NYR,21,0,0,0,0
95,8480031,Maxime Comtois,L,,25,0,0,0,0
95,8480226,Marián Studenic,R,,26,0,0,0,0
95,8478408,Travis Dermott,D,,28,0,0,0,0
95,8481518,Nolan Foote,L,NJD,24,0,0,0,0
95,8479419,Brett Murray,L,BUF,26,0,0,0,0
95,8482088,Justin Sourdif,R,FLA,22,0,0,0,0
95,8482201,Gage Goncalves,C,TBL,23,0,0,0,0
95,8481578,Graeme Clarke,R,MIN,23,0,0,0,0
95,8482177,Marat Khusnutdinov,C,MIN,22,0,0,0,0
95,8481754,Nikita Nesterenko,C,ANA,23,0,0,0,0
95,8483531,Brian Halonen,L,NJD,25,0,0,0,0
95,8483920,Pierrick Dube,R,WSH,23,0,0,0,0
95,8480851,Akil Thomas,C,LAK,24,0,0,0,0
95,8475235,Nicolas Deslauriers,L,PHI,33,0,0,0,0
95,8482476,Emil Heineman,L,MTL,23,0,0,0,0
95,8477149,Scott Sabourin,R,SJS,32,0,0,0,0
95,8483549,Lucas Condotta,L,MTL,27,0,0,0,0
95,8482765,Isak Rosen,R,BUF,21,0,0,0,0
95,8481237,Kyle MacLean,C,NYI,25,0,0,0,0
95,8481024,Linus Karlsson,C,VAN,25,0,0,0,0
95,8481690,Tyler Angle,C,,24,0,0,0,0
95,8483570,Ben Meyers,C,SEA,26,0,0,0,0
95,8481655,Cole Schwindt,R,CGY,23,0,0,0,0
95,8481462,Mason Morelli,L,VGK,28,0,0,0,0
95,8483401,Marc Johnstone,R,PIT,28,0,0,0,0
95,8478956,Samuel Laberge,L,NJD,27,0,0,0,0
95,8479533,Joona Koppanen,L,,26,0,0,0,0
95,8482197,Adam Raska,R,MIN,23,0,0,0,0
95,8482250,Callahan Burke,C,VGK,27,0,0,0,0
95,8482784,Zach Dean,C,STL,21,0,0,0,0
95,8484255,Jason Polin,R,COL,25,0,0,0,0
95,8481077,John Leonard,L,,26,0,0,0,0
95,8481534,Raphael Lavoie,C,EDM,24,0,0,0,0
95,8483609,Adam Klapka,R,CGY,24,0,0,0,0
95,8482751,Ryan Winterton,C,SEA,21,0,0,0,0
95,8480267,Sammy Walker,C,MIN,25,0,0,0,0
95,8475766,Austin Watson,L,,32,0,0,0,0
95,8482460,Matt Rempe,C,NYR,22,0,0,0,0
95,8481065,Angus Crookshank,L,OTT,25,0,0,0,0
95,8481070,Hugh McGing,L,,26,0,0,0,0
95,8476323,Max McCormick,L,SEA,32,0,0,0,0
95,8483395,Arshdeep Bains,L,VAN,23,0,0,0,0
95,8484259,Ondrej Pavel,C,COL,31,0,0,0,0
95,8483432,Luca Del Bel Belluz,C,CBJ,31,0,0,0,0
95,8483045,Cameron Butler,R,CBJ,31,0,0,0,0
95,8482061,Brandon Biro,L,SEA,26,0,0,0,0
95,8477401,John Hayden,C,SEA,29,0,0,0,0
95,8475278,Byron Froese,C,,33,0,0,0,0
95,8478446,Glenn Gawdin,C,LAK,27,0,0,0,0
95,8477993,Justin Kirkland,C,CGY,28,0,0,0,0
95,8482147,Jean-Luc Foudy,C,COL,22,0,0,0,0
95,8480032,Shane Bowers,C,NJD,25,0,0,0,0
95,8479330,Brandon Gignac,C,MTL,27,0,0,0,0
95,8480776,Sheldon Rempal,R,,29,0,0,0,0
95,8475413,Justin Dowling,C,NJD,34,0,0,0,0
95,8481726,Adam Edstrom,C,NYR,24,0,0,0,0
95,8480844,Grigori Denisenko,L,VGK,24,0,0,0,0
95,8478147,Bokondji Imama,L,PIT,28,0,0,0,0
95,8478881,Brett Seney,L,CHI,28,0,0,0,0
95,8483630,Pavol Regenda,L,ANA,25,0,0,0,0
95,8480836,Jonathan Gruden,C,,24,0,0,0,0
95,8484314,Jiri Smejkal,L,,28,0,0,0,0
95,8475780,Chris Wagner,R,COL,33,0,0,0,0
95,8479546,Oskar Steen,C,,26,0,0,0,0
95,8483597,Milos Kelemen,L,UTA,25,0,0,0,0
95,8481789,Tye Kartye,L,SEA,23,0,0,0,0
95,8484325,Waltteri Merela,C,TBL,26,0,0,0,0
95,8479421,Jacob Moverare,D,LAK,26,0,0,0,0
95,8481585,Egor Afanasyev,L,SJS,23,0,0,0,0
95,8479547,Matthew Phillips,R,,26,0,0,0,0
95,8479367,William Lockwood,R,FLA,26,0,0,0,0
95,8476915,Jujhar Khaira,L,,30,0,0,0,0
95,8481422,Jacob Lucchini,C,NSH,29,0,0,0,0
95,8480468,James Hamblin,L,EDM,25,0,0,0,0
95,8478051,Max Willman,C,NJD,29,0,0,0,0
95,8481556,John Beecher,C,BOS,23,0,0,0,0
95,8478078,Rourke Chartier,C,,28,0,0,0,0
96,8477492,Nathan MacKinnon,C,COL,29,82,60,82,142
96,8479318,Auston Matthews,C,TOR,27,82,71,66,137
96,8478402,Connor McDavid,C,EDM,27,82,47,88,135
96,8481559,Jack Hughes,C,NJD,23,82,54,76,130
96,8476453,Nikita Kucherov,R,TBL,31,82,34,95,129
96,8477956,David Pastrnak,R,BOS,28,82,56,59,115
96,8478550,Artemi Panarin,L,NYR,33,82,35,78,113
96,8476887,Filip Forsberg,L,NSH,30,82,47,65,112
96,8478864,Kirill Kaprizov,L,MIN,27,82,53,58,111
96,8477939,William Nylander,R,TOR,28,82,42,69,111
96,8478420,Mikko Rantanen,R,COL,28,82,54,56,110
96,8478445,Mathew Barzal,C,NYI,27,82,22,88,110
96,8477942,Kevin Fiala,L,LAK,28,82,41,62,103
96,8480027,Jason Robertson,L,DAL,25,82,38,62,100
96,8477934,Leon Draisaitl,C,EDM,29,82,34,63,97
96,8477940,Nikolaj Ehlers,L,WPG,28,82,43,53,96
96,8480208,Drake Batherson,R,OTT,26,82,40,56,96
96,8476468,J.T. Miller,C,VAN,31,82,37,59,96
96,8475172,Nazem Kadri,C,CGY,34,82,43,52,95
96,8481557,Matt Boldy,L,MIN,23,82,36,59,95
96,8475166,John Tavares,C,TOR,34,82,35,60,95
96,8477933,Sam Reinhart,C,FLA,29,82,40,54,94
96,8479407,Jesper Bratt,L,NJD,26,82,32,62,94
96,8480012,Elias Pettersson,C,VAN,26,82,43,50,93
96,8475692,Mats Zuccarello,R,MIN,37,82,25,68,93
96,8477404,Jake Guentzel,C,TBL,30,82,36,56,92
96,8480069,Cale Makar,D,COL,26,82,22,70,92
96,8479337,Alex DeBrincat,R,DET,27,82,39,52,91
96,8479314,Matthew Tkachuk,L,FLA,27,82,28,63,91
96,8480800,Quinn Hughes,D,VAN,25,82,12,79,91
96,8476460,Mark Scheifele,C,WPG,31,82,34,56,90
96,8480036,Miro Heiskanen,D,DAL,25,82,23,67,90
96,8480023,Robert Thomas,C,STL,25,82,33,56,89
96,8480830,Andrei Svechnikov,R,CAR,24,82,29,60,89
96,8482116,Tim Stützle,C,OTT,22,82,27,62,89
96,8480801,Brady Tkachuk,L,OTT,25,82,49,39,88
96,8471675,Sidney Crosby,C,PIT,37,82,38,50,88
96,8478427,Sebastian Aho,C,CAR,27,82,38,49,87
96,8473419,Brad Marchand,L,BOS,36,82,27,60,87
96,8477946,Dylan Larkin,C,DET,28,82,42,44,86
96,8478010,Brayden Point,C,TBL,28,82,39,46,85
96,8474564,Steven Stamkos,C,NSH,34,82,38,47,85
96,8477496,Elias Lindholm,C,BOS,30,82,36,49,85
96,8481523,Kirby Dach,C,MTL,23,82,19,66,85
96,8478449,Roope Hintz,C,DAL,28,82,39,45,84
96,8478403,Jack Eichel,C,VGK,28,82,34,49,83
96,8476346,Johnny Gaudreau,L,CBJ,31,82,20,63,83
96,8474600,Roman Josi,D,NSH,34,82,20,62,82
96,8479420,Tage Thompson,C,BUF,27,82,42,39,81
96,8477409,Carter Verhaeghe,C,FLA,29,82,40,41,81
96,8477493,Aleksander Barkov,C,FLA,29,82,33,48,81
96,8476454,Ryan Nugent-Hopkins,C,EDM,31,82,28,53,81
96,8477501,Valeri Nichushkin,R,COL,29,82,36,44,80
96,8482078,Lucas Raymond,L,DET,22,82,36,44,80
96,8471214,Alex Ovechkin,L,WSH,39,82,36,43,79
96,8478398,Kyle Connor,L,WPG,28,82,34,45,79
96,8478460,Zach Werenski,D,CBJ,27,82,19,60,79
96,8475786,Zach Hyman,L,EDM,32,82,41,37,78
96,8476459,Mika Zibanejad,C,NYR,31,82,29,49,78
96,8480002,Nico Hischier,C,NJD,25,82,21,56,77
96,8477500,Bo Horvat,C,NYI,29,82,41,35,76
96,8475765,Vladimir Tarasenko,R,DET,33,82,33,43,76
96,8477402,Pavel Buchnevich,L,STL,29,82,32,44,76
96,8476456,Jonathan Huberdeau,C,CGY,31,82,16,60,76
96,8471215,Evgeni Malkin,C,PIT,38,82,29,46,75
96,8478493,Joel Eriksson Ek,C,MIN,27,82,25,50,75
96,8476853,Morgan Rielly,D,TOR,30,82,15,60,75
96,8475784,Jeff Skinner,C,EDM,32,82,32,42,74
96,8475167,Victor Hedman,D,TBL,34,82,17,57,74
96,8479385,Jordan Kyrou,C,STL,26,82,31,42,73
96,8471685,Anze Kopitar,C,LAK,37,82,22,51,73
96,8473512,Claude Giroux,R,OTT,36,82,20,53,73
96,8477960,Adrian Kempe,R,LAK,28,82,36,36,72
96,8478440,Dylan Strome,C,WSH,27,82,20,52,72
96,8480865,Noah Dobson,D,NYI,24,82,15,57,72
96,8477504,Josh Morrissey,D,WPG,29,82,22,49,71
96,8475754,Brock Nelson,C,NYI,33,82,31,39,70
96,8478873,Troy Terry,R,ANA,27,82,31,39,70
96,8476389,Vincent Trocheck,C,NYR,31,82,26,44,70
96,8477949,Alex Tuch,R,BUF,28,82,23,47,70
96,8477407,Anthony Duclair,L,NYI,29,82,32,37,69
96,8476881,Tomas Hertl,C,VGK,31,82,35,33,68
96,8479343,Clayton Keller,R,UTA,26,82,34,34,68
96,8475158,Ryan O'Reilly,C,NSH,33,82,29,39,68
96,8475913,Mark Stone,R,VGK,32,82,28,40,68
96,8474141,Patrick Kane,R,DET,36,82,24,44,68
96,8478038,Devon Toews,D,COL,30,82,15,53,68
96,8479323,Adam Fox,D,NYR,26,82,16,51,67
96,8479325,Charlie McAvoy,D,BOS,27,82,13,54,67
96,8478414,Timo Meier,R,NJD,28,82,32,34,66
96,8476539,Jonathan Marchessault,R,NSH,34,82,32,34,66
96,8476448,William Karlsson,C,VGK,31,82,26,40,66
96,8478439,Travis Konecny,R,PHI,27,82,22,44,66
96,8475168,Matt Duchene,C,DAL,33,82,21,45,66
96,8480018,Nick Suzuki,C,MTL,25,82,14,52,66
96,8482740,Wyatt Johnston,C,DAL,21,82,39,26,65
96,8473994,Jamie Benn,L,DAL,35,82,24,41,65
96,8476882,Teuvo Teravainen,L,CHI,30,82,23,42,65
96,8474578,Erik Karlsson,D,PIT,34,82,12,53,65
96,8481540,Cole Caufield,R,MTL,23,82,34,30,64
96,8479542,Brandon Hagel,L,TBL,26,82,29,35,64
96,8474586,Jordan Eberle,R,SEA,34,82,23,41,64
96,8477955,Jared McCann,L,SEA,28,82,22,42,64
96,8475798,Mikael Granlund,C,SJS,32,82,21,43,64
96,8475810,Bryan Rust,R,PIT,32,82,37,26,63
96,8477451,Ryan Hartman,R,MIN,30,82,32,31,63
96,8479999,Casey Mittelstadt,C,COL,26,82,29,34,63
96,8478047,Michael Bunting,L,PIT,29,82,24,39,63
96,8475170,Brayden Schenn,C,STL,33,82,24,39,63
96,8476479,Phillip Danault,C,LAK,31,82,23,40,63
96,8480839,Rasmus Dahlin,D,BUF,24,82,16,47,63
96,8478407,Vince Dunn,D,SEA,28,82,14,49,63
96,8481533,Trevor Zegras,C,ANA,23,82,32,30,62
96,8470613,Brent Burns,D,CAR,39,82,19,43,62
96,8482149,Cole Perfetti,C,WPG,22,82,19,43,62
96,8471724,Kris Letang,D,PIT,37,82,12,50,62
96,8477935,Sam Bennett,C,FLA,28,82,31,30,61
96,8478042,Viktor Arvidsson,R,EDM,31,82,24,37,61
96,8477503,Max Domi,C,TOR,29,82,22,39,61
96,8481528,Dylan Cozens,C,BUF,23,82,21,40,61
96,8476906,Shayne Gostisbehere,D,CAR,31,82,21,40,61
96,8474679,Gustav Nyquist,C,NSH,35,82,18,43,61
96,8477497,Sean Monahan,C,CBJ,30,82,18,43,61
96,8478444,Brock Boeser,R,VAN,27,82,33,27,60
96,8477476,Artturi Lehkonen,L,COL,29,82,30,30,60
96,8482665,Matty Beniers,C,SEA,22,82,28,32,60
96,8480015,Owen Tippett,R,PHI,25,82,21,39,60
96,8477951,Nick Schmaltz,C,UTA,28,82,21,39,60
96,8478401,Pavel Zacha,C,BOS,27,82,21,39,60
96,8475753,Justin Faulk,D,STL,32,82,20,40,60
96,8476462,Dougie Hamilton,D,NJD,31,82,19,41,60
96,8479339,Patrik Laine,L,CBJ,26,82,33,26,59
96,8482097,Jack Quinn,R,BUF,23,82,27,32,59
96,8482093,Seth Jarvis,C,CAR,22,82,22,37,59
96,8474590,John Carlson,D,WSH,34,82,11,48,59
96,8482699,Dylan Guenther,R,UTA,21,82,31,27,58
96,8477511,Anthony Mantha,R,CGY,30,82,30,28,58
96,8480220,Noah Cates,L,PHI,25,82,24,34,58
96,8480064,Josh Norris,C,OTT,25,82,23,35,58
96,8479400,Pierre-Luc Dubois,L,WSH,26,82,14,44,58
96,8482109,Alexis Lafrenière,L,NYR,23,82,32,25,57
96,8478856,Conor Garland,R,VAN,28,82,27,30,57
96,8477346,MacKenzie Weegar,D,CGY,30,82,19,38,57
96,8482124,Quinton Byfield,R,LAK,22,82,17,40,57
96,8482475,Yegor Chinakhov,R,CBJ,23,82,31,25,56
96,8478519,Anthony Cirelli,C,TBL,27,82,26,30,56
96,8477494,Jonathan Drouin,L,COL,29,82,16,40,56
96,8480078,Filip Chytil,C,NYR,25,82,25,30,55
96,8476905,Chandler Stephenson,C,SEA,30,82,22,33,55
96,8481596,Shane Pinto,C,OTT,24,82,22,33,55
96,8477986,Brandon Montour,D,SEA,30,82,15,40,55
96,8478397,Rasmus Andersson,D,CGY,28,82,11,44,55
96,8476432,Boone Jenner,C,CBJ,31,82,30,24,54
96,8477426,Nicholas Paul,L,TBL,29,82,29,25,54
96,8480028,Morgan Frost,C,PHI,25,82,24,30,54
96,8478462,Nicolas Roy,C,VGK,27,82,22,32,54
96,8477479,Tyler Bertuzzi,L,CHI,29,82,18,36,54
96,8476292,Ondrej Palat,L,NJD,33,82,17,37,54
96,8479345,Jakob Chychrun,D,WSH,26,82,15,39,54
96,8477932,Aaron Ekblad,D,FLA,28,82,14,40,54
96,8477447,Shea Theodore,D,VGK,29,82,11,43,54
96,8475169,Evander Kane,L,EDM,33,82,29,24,53
96,8476399,Blake Coleman,C,CGY,33,82,25,28,53
96,8475745,Charlie Coyle,C,BOS,32,82,21,32,53
96,8481711,Matias Maccelli,L,UTA,24,82,19,34,53
96,8480014,Gabriel Vilardi,C,WPG,25,82,28,24,52
96,8475151,Kyle Palmieri,C,NYI,33,82,27,25,52
96,8479675,Trevor Moore,L,LAK,29,82,24,28,52
96,8474563,Drew Doughty,D,LAK,35,82,17,35,52
96,8478396,Noah Hanifin,D,VGK,27,82,14,38,52
96,8474102,David Perron,L,OTT,36,82,14,38,52
96,8481542,Moritz Seider,D,DET,23,82,8,44,52
96,8479410,Mikhail Sergachev,D,UTA,26,82,7,45,52
96,8475794,Tyler Seguin,C,DAL,32,82,29,22,51
96,8475184,Chris Kreider,L,NYR,33,82,29,22,51
96,8477987,Ryan Donato,C,CHI,28,82,24,27,51
96,8482113,Anton Lundell,C,FLA,23,82,23,28,51
96,8480039,Martin Necas,C,CAR,25,82,18,33,51
96,8477021,Alex Kerfoot,C,UTA,30,82,10,41,51
96,8480803,Evan Bouchard,D,EDM,25,82,9,42,51
96,8478055,Gustav Forsling,D,FLA,28,82,8,43,51
96,8476438,Brandon Saad,L,STL,32,82,31,19,50
96,8471698,T.J. Oshie,R,WSH,38,82,29,21,50
96,8478366,Frank Vatrano,R,ANA,30,82,28,22,50
96,8481068,Yegor Sharangovich,C,CGY,26,82,26,24,50
96,8480849,Barrett Hayton,C,UTA,24,82,25,25,50
96,8482175,JJ Peterka,R,BUF,22,82,24,26,50
96,8476826,Yanni Gourde,C,SEA,33,82,19,31,50
96,8478469,Thomas Chabot,D,OTT,27,82,16,34,50
96,8475793,Ryan Johansen,C,PHI,32,82,16,34,50
96,8477998,Warren Foegele,L,LAK,28,82,15,35,50
96,8478474,Lawson Crouse,L,UTA,27,82,27,22,49
96,8481560,Arthur Kaliyev,R,LAK,23,82,27,22,49
96,8483808,Andrei Kuzmenko,L,CGY,28,82,26,23,49
96,8482159,Tyson Foerster,R,PHI,22,82,24,25,49
96,8476872,Scott Laughton,C,PHI,30,82,18,31,49
96,8482667,William Eklund,L,SJS,22,82,16,33,49
96,8476869,Brady Skjei,D,NSH,30,82,14,35,49
96,8479425,Filip Hronek,D,VAN,27,82,9,40,49
96,8480434,Sean Durzi,D,UTA,26,82,7,42,49
96,8478498,Jake DeBrusk,L,VAN,28,82,25,23,48
96,8477416,Oliver Bjorkstrand,R,SEA,29,82,24,24,48
96,8475726,Tyler Toffoli,C,SJS,32,82,20,28,48
96,8477456,J.T. Compher,L,DET,29,82,16,32,48
96,8474150,Mikael Backlund,C,CGY,35,82,12,36,48
96,8477444,Andre Burakovsky,L,SEA,29,82,10,38,48
96,8476854,Hampus Lindholm,D,BOS,30,82,7,41,48
96,8476483,Rickard Rakell,R,PIT,31,82,21,26,47
96,8483515,Juraj Slafkovsky,L,MTL,20,82,18,29,47
96,8476419,Jean-Gabriel Pageau,C,NYI,32,82,16,31,47
96,8477953,Kasperi Kapanen,R,STL,28,82,14,33,47
96,8476792,Torey Krug,D,STL,33,82,9,38,47
96,8480145,Neal Pionk,D,WPG,29,82,9,38,47
96,8475799,Nino Niederreiter,R,WPG,32,82,26,20,46
96,8479365,Trent Frederic,C,BOS,26,82,20,26,46
96,8474565,Alex Pietrangelo,D,VGK,34,82,12,34,46
96,8480188,Fabian Zetterlund,L,SJS,25,82,21,24,45
96,8482705,Cole Sillinger,C,CBJ,21,82,16,29,45
96,8482684,Luke Hughes,D,NJD,21,82,8,37,45
96,8475314,Anders Lee,L,NYI,34,82,25,19,44
96,8482110,Dawson Mercer,C,NJD,23,82,22,22,44
96,8479293,Brandon Tanev,L,SEA,33,82,22,22,44
96,8478233,Andrew Mangiapane,L,WSH,28,82,21,23,44
96,8478438,Tommy Novak,C,NSH,27,82,20,24,44
96,8479992,Michael Rasmussen,C,DET,25,82,17,27,44
96,8477429,Andrew Copp,C,DET,30,82,17,27,44
96,8480798,Philipp Kurashev,C,CHI,25,82,16,28,44
96,8482660,Kent Johnson,C,CBJ,22,82,13,31,44
96,8477495,Seth Jones,D,CHI,30,82,8,36,44
96,8480043,Timothy Liljegren,D,TOR,25,82,7,37,44
96,8480893,Kirill Marchenko,R,CBJ,24,82,29,14,43
96,8478975,Mason Marchment,L,DAL,29,82,23,20,43
96,8480797,Joel Farabee,L,PHI,24,82,23,20,43
96,8481186,Logan O'Connor,R,COL,28,82,21,22,43
96,8484144,Connor Bedard,C,CHI,19,82,20,23,43
96,8478891,Mason Appleton,C,WPG,28,82,18,25,43
96,8480871,Adam Boqvist,D,FLA,24,82,17,26,43
96,8478413,Jordan Greenway,L,BUF,27,82,17,26,43
96,8481618,Alex Newhook,C,MTL,23,82,16,27,43
96,8477948,Travis Sanheim,D,PHI,28,82,12,31,43
96,8476958,Jaccob Slavin,D,CAR,30,82,11,32,43
96,8475768,Jaden Schwartz,C,SEA,32,82,23,19,42
96,8480185,Eetu Luostarinen,C,FLA,26,82,21,21,42
96,8479661,Tanner Jeannot,L,LAK,27,82,20,22,42
96,8476925,Colton Sissons,C,NSH,31,82,18,24,42
96,8475191,Reilly Smith,R,NYR,33,82,17,25,42
96,8473986,Alex Killorn,L,ANA,35,82,16,26,42
96,8478115,Pierre Engvall,L,NYI,28,82,16,26,42
96,8477498,Darnell Nurse,D,EDM,29,82,15,27,42
96,8475791,Taylor Hall,L,CHI,33,82,12,30,42
96,8482671,Owen Power,D,BUF,22,82,12,30,42
96,8475764,Cam Fowler,D,ANA,33,82,7,35,42
96,8478882,Vladislav Gavrikov,D,LAK,29,82,5,37,42
96,8476880,Tom Wilson,R,WSH,30,82,23,18,41
96,8474641,Adam Henrique,C,EDM,34,82,21,20,41
96,8482720,Matthew Knies,L,TOR,22,82,19,22,41
96,8476392,Adam Lowry,C,WPG,31,82,18,23,41
96,8475763,Kevin Hayes,R,PIT,32,82,16,25,41
96,8473563,Nicklas Backstrom,C,WSH,37,82,15,26,41
96,8481581,Thomas Harley,D,DAL,23,82,13,28,41
96,8476875,Mike Matheson,D,MTL,30,82,11,30,41
96,8475848,Brendan Gallagher,R,MTL,32,82,24,16,40
96,8479941,Justin Danforth,R,CBJ,31,82,24,16,40
96,8481582,Nicholas Robertson,L,TOR,23,82,21,19,40
96,8475193,Tomas Tatar,L,NJD,34,82,19,21,40
96,8477964,Ivan Barbashev,C,VGK,29,82,16,24,40
96,8474053,Logan Couture,C,SJS,35,82,16,24,40
96,8480336,Sean Walker,D,CAR,30,82,15,25,40
96,8479525,Ross Colton,C,COL,28,82,14,26,40
96,8476923,Damon Severson,D,CBJ,30,82,11,29,40
96,8476480,Vladislav Namestnikov,C,WPG,32,82,10,30,40
96,8475287,Erik Haula,L,NJD,33,82,19,20,39
96,8480789,Oliver Wahlstrom,R,NYI,24,82,17,22,39
96,8474149,Evgenii Dadonov,R,DAL,35,82,14,25,39
96,8476458,Ryan Strome,C,ANA,31,82,11,28,39
96,8475218,Mattias Ekholm,D,EDM,34,82,11,28,39
96,8480873,Rasmus Sandin,D,WSH,24,82,4,35,39
96,8470621,Corey Perry,R,EDM,39,82,25,13,38
96,8482055,Drew O'Connor,L,PIT,26,82,19,19,38
96,8478057,Dakota Joshua,C,VAN,28,82,19,19,38
96,8475722,Jason Zucker,L,BUF,32,82,18,20,38
96,8480855,Jack McBain,C,UTA,24,82,18,20,38
96,8482745,Mason McTavish,C,ANA,21,82,13,25,38
96,8478458,Jack Roslovic,C,CAR,27,82,13,25,38
96,8476329,Travis Boyd,C,MIN,31,82,10,28,38
96,8476917,Adam Pelech,D,NYI,30,82,5,33,38
96,8477947,Sonny Milano,L,WSH,28,82,23,14,37
96,8480068,Ryan Poehling,C,PHI,25,82,21,16,37
96,8475714,Calle Jarnkrok,C,TOR,33,82,18,19,37
96,8476960,Andreas Athanasiou,C,CHI,30,82,18,19,37
96,8481704,Juuso Parssinen,C,NSH,23,82,17,20,37
96,8481601,Simon Holmstrom,R,NYI,23,82,22,14,36
96,8475760,Nick Bjugstad,C,UTA,32,82,18,18,36
96,8479390,Taylor Raddysh,R,WSH,26,82,17,19,36
96,8480113,Alex Iafallo,L,WPG,31,82,16,20,36
96,8478020,Michael Amadio,C,OTT,28,82,16,20,36
96,8480829,Jesperi Kotkaniemi,C,CAR,24,82,15,21,36
96,8478109,Victor Olofsson,L,VGK,29,82,13,23,36
96,8479996,Cody Glass,C,NSH,25,82,11,25,36
96,8478472,Mathieu Joseph,R,STL,27,82,11,25,36
96,8475171,Oliver Ekman-Larsson,D,TOR,33,82,11,25,36
96,8477435,Ryan Graves,D,PIT,29,82,9,27,36
96,8477969,Marcus Pettersson,D,PIT,28,82,6,30,36
96,8482146,Luke Evangelista,R,NSH,22,82,21,14,35
96,8481624,Ilya Mikheyev,R,CHI,30,82,19,16,35
96,8480835,Jack Drury,C,CAR,24,82,17,18,35
96,8476921,Jordan Martinook,L,CAR,32,82,14,21,35
96,8473533,Jordan Staal,C,CAR,36,82,14,21,35
96,8478542,Evan Rodrigues,C,FLA,31,82,12,23,35
96,8478507,John Marino,D,UTA,27,82,6,29,35
96,8477425,Miles Wood,L,COL,29,82,18,16,34
96,8477839,Conor Sheary,L,TBL,32,82,17,17,34
96,8479987,Morgan Geekie,C,BOS,26,82,16,18,34
96,8479591,Michael Eyssimont,C,TBL,28,82,15,19,34
96,8480009,Eeli Tolvanen,R,SEA,25,82,14,20,34
96,8476461,Sean Couturier,C,PHI,32,82,14,20,34
96,8482117,Lukas Reichel,L,CHI,22,82,13,21,34
96,8482105,Jake Sanderson,D,OTT,22,82,13,21,34
96,8474716,Jared Spurgeon,D,MIN,35,82,12,22,34
96,8481656,Aliaksei Protas,C,WSH,23,82,11,23,34
96,8478851,Alexandre Carrier,D,NSH,28,82,4,30,34
96,8477989,Christian Dvorak,C,MTL,28,82,18,15,33
96,8481554,Kaapo Kakko,R,NYR,23,82,17,16,33
96,8478046,Danton Heinen,L,VAN,29,82,17,16,33
96,8480748,Kiefer Sherwood,L,VAN,29,82,17,16,33
96,8480995,Pontus Holmberg,R,TOR,25,82,16,17,33
96,8475220,Marcus Foligno,L,MIN,33,82,16,17,33
96,8482077,Dylan Holloway,L,EDM,23,82,16,17,33
96,8481604,Pavel Dorofeyev,L,VGK,24,82,15,18,33
96,8480074,Alexandre Texier,C,STL,25,82,14,19,33
96,8477919,Frederick Gaudreau,C,MIN,31,82,13,20,33
96,8480003,Jesper Boqvist,C,FLA,26,82,13,20,33
96,8473422,Nick Foligno,L,CHI,37,82,12,21,33
96,8481606,Jordan Spence,D,LAK,23,82,8,25,33
96,8476927,Teddy Blueger,C,VAN,30,82,7,26,33
96,8481546,Cam York,D,PHI,23,82,6,27,33
96,8479398,Samuel Girard,D,COL,26,82,5,28,33
96,8478500,Ivan Provorov,D,CBJ,27,82,5,28,33
96,8477506,Ryan Pulock,D,NYI,30,82,3,30,33
96,8481580,Connor McMichael,C,WSH,23,82,17,15,32
96,8480448,Parker Kelly,L,COL,25,82,15,17,32
96,8478463,Anthony Beauvillier,L,PIT,27,82,14,18,32
96,8482092,Ridly Greig,C,OTT,22,82,14,18,32
96,8480802,Ryan McLeod,C,BUF,25,82,12,20,32
96,8484153,Leo Carlsson,C,ANA,20,82,12,20,32
96,8476463,Jonas Brodin,D,MIN,31,82,8,24,32
96,8480817,K'Andre Miller,D,NYR,24,82,7,25,32
96,8479976,Juuso Valimaki,D,UTA,26,82,5,27,32
96,8482087,Kaiden Guhle,D,MTL,22,82,4,28,32
96,8478508,Yakov Trenin,C,MIN,27,82,18,13,31
96,8481032,Paul Cotter,C,NJD,25,82,16,15,31
96,8475149,Marcus Johansson,L,MIN,34,82,12,19,31
96,8474715,Cam Atkinson,R,TBL,35,82,11,20,31
96,8482122,Brock Faber,D,MIN,22,82,10,21,31
96,8480459,Pius Suter,C,VAN,28,82,8,23,31
96,8481093,Rafael Harvey-Pinard,L,MTL,25,82,19,11,30
96,8476873,Mark Jankowski,C,NSH,30,82,17,13,30
96,8481028,Martin Pospisil,C,CGY,25,82,16,14,30
96,8477508,Curtis Lazar,C,NJD,29,82,15,15,30
96,8477952,Robby Fabbri,C,ANA,28,82,14,16,30
96,8481535,Nils Hoglander,L,VAN,24,82,13,17,30
96,8482079,Marco Rossi,C,MIN,23,82,13,17,30
96,8476931,Jake McCabe,D,TOR,31,82,9,21,30
96,8481553,Bobby Brink,R,PHI,23,82,9,21,30
96,8482133,Thomas Bordeleau,C,SJS,22,82,7,23,30
96,8482655,J.J. Moser,D,TBL,24,82,6,24,30
96,8473507,Jeff Petry,D,DET,37,82,4,26,30
96,8477488,Brett Pesce,D,NJD,30,82,4,26,30
96,8481568,Alex Vlasic,D,CHI,23,82,4,26,30
96,8482245,Artem Zub,D,OTT,29,82,3,27,30
96,8476885,Jacob Trouba,D,NYR,30,82,7,22,29
96,8474574,Tyler Myers,D,VAN,34,82,4,25,29
96,8476979,Erik Gustafsson,D,DET,32,82,3,26,29
96,8476892,Colton Parayko,D,STL,31,82,2,27,29
96,8480281,Alexey Toropchenko,R,STL,25,82,17,11,28
96,8477392,Hudson Fasching,R,NYI,29,82,16,12,28
96,8479316,Luke Kunin,C,SJS,27,82,15,13,28
96,8476278,Colin Blackwell,C,DAL,31,82,14,14,28
96,8476469,Joel Armia,R,MTL,31,82,13,15,28
96,8484166,Adam Fantilli,C,CBJ,20,82,13,15,28
96,8480144,David Kampf,C,TOR,29,82,10,18,28
96,8479351,Sam Steel,C,DAL,26,82,9,19,28
96,8482142,Jamie Drysdale,D,PHI,22,82,7,21,28
96,8476429,Scott Mayfield,D,NYI,32,82,6,22,28
96,8478840,Will Borgen,D,SEA,28,82,4,24,28
96,8477845,Trevor van Riemsdyk,D,WSH,33,82,4,24,28
96,8479402,Jake Bean,D,CGY,26,82,3,25,28
96,8479414,Nathan Bastian,R,NJD,27,82,18,9,27
96,8476474,Stefan Noesen,R,NJD,31,82,15,12,27
96,8475343,Nic Dowd,C,WSH,34,82,15,12,27
96,8474189,Lars Eller,C,PIT,35,82,13,14,27
96,8483505,Matthew Poitras,C,BOS,20,82,13,14,27
96,8482624,Daniil Miromanov,D,CGY,27,82,9,18,27
96,8482111,Justin Barron,D,MTL,23,82,9,18,27
96,8478911,Matt Roy,D,WSH,29,82,8,19,27
96,8475233,David Savard,D,MTL,34,82,8,19,27
96,8478133,Jake Evans,C,MTL,28,82,8,19,27
96,8480806,Isac Lundestrom,C,ANA,25,82,7,20,27
96,8480980,Connor Dewar,C,TOR,25,82,6,21,27
96,8482073,Braden Schneider,D,NYR,23,82,6,21,27
96,8476902,Esa Lindell,D,DAL,30,82,5,22,27
96,8475790,Erik Gudbranson,D,CBJ,32,82,3,24,27
96,8475181,Nick Leddy,D,STL,33,82,2,25,27
96,8480049,Dylan Samberg,D,WPG,25,82,2,25,27
96,8476918,Jimmy Vesey,L,NYR,31,82,14,12,26
96,8482155,Alex Laferriere,R,LAK,23,82,14,12,26
96,8477903,Garnet Hathaway,R,PHI,33,82,13,13,26
96,8480878,Nils Lundkvist,D,DAL,24,82,4,22,26
96,8476312,Josh Manson,D,COL,33,82,2,24,26
96,8476967,Brett Kulak,D,EDM,30,82,2,24,26
96,8482089,Jake Neighbours,L,STL,22,82,14,11,25
96,8476981,Josh Anderson,R,MTL,30,82,14,11,25
96,8481517,Brett Leason,R,ANA,25,82,14,11,25
96,8478211,Dryden Hunt,L,CGY,29,82,13,12,25
96,8481013,Jonatan Berggren,R,DET,24,82,13,12,25
96,8479393,Noah Gregor,C,OTT,26,82,11,14,25
96,8475855,Jesper Fast,R,CAR,33,82,9,16,25
96,8477499,Rasmus Ristolainen,D,PHI,30,82,8,17,25
96,8477220,Nate Schmidt,D,FLA,33,82,7,18,25
96,8475690,Chris Tanev,D,TOR,35,82,5,20,25
96,8480246,Nick Perbix,D,TBL,26,82,5,20,25
96,8477015,Connor Brown,R,EDM,30,82,4,21,25
96,8475188,Brayden McNabb,D,VGK,33,82,3,22,25
96,8475462,Radko Gudas,D,ANA,34,82,3,22,25
96,8476897,Oskar Sundqvist,C,STL,30,82,12,12,24
96,8480813,Joe Veleno,C,DET,24,82,10,14,24
96,8482807,Ethan Del Mastro,D,CHI,21,82,10,14,24
96,8479353,Brett Howden,C,VGK,26,82,9,15,24
96,8475200,Dmitry Orlov,D,CAR,33,82,8,16,24
96,8476374,Sean Kuraly,C,CBJ,31,82,8,16,24
96,8479324,Ryan Lindgren,D,NYR,26,82,5,19,24
96,8480807,Mattias Samuelsson,D,BUF,24,82,5,19,24
96,8479983,Mario Ferraro,D,SJS,26,82,4,20,24
96,8480035,Henri Jokiharju,D,BUF,25,82,3,21,24
96,8477450,Jason Dickinson,C,CHI,29,82,13,10,23
96,8478013,Jake Walman,D,SJS,28,82,13,10,23
96,8482074,Connor Zary,C,CGY,23,82,13,10,23
96,8483524,Shane Wright,C,SEA,20,82,12,11,23
96,8482062,Cole Smith,L,NSH,29,82,8,15,23
96,8479368,Max Jones,L,BOS,26,82,8,15,23
96,8476372,Nick Seeler,D,PHI,31,82,8,15,23
96,8478136,Jake Middleton,D,MIN,28,82,7,16,23
96,8483490,Pavel Mintyukov,D,ANA,21,82,6,17,23
96,8484149,Gavin Brindley,C,CBJ,20,82,5,18,23
96,8482702,Logan Stankoven,C,DAL,21,82,5,18,23
96,8476879,Cody Ceci,D,EDM,31,82,3,20,23
96,8476331,Dylan DeMelo,D,WPG,31,82,1,22,23
96,8481477,Nico Sturm,C,SJS,29,82,11,11,22
96,8484203,Bradly Nadeau,L,CAR,19,82,10,12,22
96,8482858,Ryker Evans,D,SEA,23,82,9,13,22
96,8481481,Blake Lizotte,C,PIT,27,82,8,14,22
96,8477406,Mattias Janmark,C,EDM,32,82,8,14,22
96,8478432,Christian Fischer,R,DET,27,82,7,15,22
96,8480834,Ty Emberson,D,SJS,24,82,7,15,22
96,8480796,Martin Fehervary,D,WSH,25,82,7,15,22
96,8483565,Nick Blankenburg,D,NSH,26,82,6,16,22
96,8478416,Erik Cernak,D,TBL,27,82,6,16,22
96,8483457,Lane Hutson,D,MTL,20,82,6,16,22
96,8482101,Danil Gushchin,L,SJS,22,82,6,16,22
96,8474151,Ryan McDonagh,D,TBL,35,82,4,18,22
96,8481014,Alexander Romanov,D,NYI,24,82,4,18,22
96,8475324,Nick Jensen,D,OTT,34,82,3,19,22
96,8481178,Egor Zamula,D,PHI,24,82,0,22,22
96,8482749,Joshua Roy,R,MTL,21,82,13,8,21
96,8480021,Jack Studnicka,C,LAK,25,82,11,10,21
96,8476422,Mike Reilly,D,NYI,31,82,10,11,21
96,8482679,Matt Coronato,R,CGY,22,82,8,13,21
96,8477369,Carson Soucy,D,VAN,30,82,8,13,21
96,8475177,Calvin de Haan,D,COL,33,82,7,14,21
96,8482118,Sam Colangelo,R,ANA,23,82,6,15,21
96,8482141,Lukas Cormier,D,VGK,22,82,5,16,21
96,8477507,Nikita Zadorov,D,BOS,29,82,5,16,21
96,8477938,Haydn Fleury,D,WPG,28,82,5,16,21
96,8483482,Tristan Luneau,D,ANA,20,82,5,16,21
96,8480073,Erik Brannstrom,D,COL,25,82,4,17,21
96,8477365,Connor Clifton,D,BUF,29,82,3,18,21
96,8479998,Mikey Anderson,D,LAK,25,82,1,20,21
96,8477353,Tyler Motte,C,DET,29,82,13,7,20
96,8479359,Beck Malenstyn,L,BUF,26,82,9,11,20
96,8476889,Radek Faksa,C,STL,30,82,8,12,20
96,8473453,Trevor Lewis,C,LAK,37,82,7,13,20
96,8476525,Colin Miller,D,WPG,32,82,6,14,20
96,8476457,Adam Larsson,D,SEA,32,82,5,15,20
96,8474013,Ian Cole,D,UTA,35,82,5,15,20
96,8481122,Simon Benoit,D,TOR,26,82,5,15,20
96,8478468,Jeremy Lauzon,D,NSH,27,82,4,16,20
96,8474567,Zach Bogosian,D,MIN,34,82,4,16,20
96,8482125,Alexander Holtz,R,VGK,22,82,15,4,19
96,8484145,Zach Benson,L,BUF,19,82,10,9,19
96,8482166,Shakir Mukhamadullin,D,SJS,22,82,10,9,19
96,8481699,Aku Raty,R,UTA,23,82,9,10,19
96,8481522,Peyton Krebs,C,BUF,23,82,7,12,19
96,8480025,MacKenzie Entwistle,R,FLA,25,82,6,13,19
96,8476467,Jamie Oleksiak,D,SEA,32,82,6,13,19
96,8480222,Sebastian Aho,D,PIT,28,82,6,13,19
96,8474673,TJ Brodie,D,CHI,34,82,4,15,19
96,8481567,Henry Thrun,D,SJS,23,82,3,16,19
96,8476891,Matt Grzelcyk,D,PIT,30,82,2,17,19
96,8481708,Zac Jones,D,NYR,24,82,1,18,19
96,8483431,Logan Cooley,C,UTA,20,82,10,8,18
96,8481641,Joel Kiviranta,L,COL,28,82,10,8,18
96,8475842,Sam Carrick,C,NYR,32,82,10,8,18
96,8476442,Matt Nieto,L,PIT,32,82,8,10,18
96,8478434,Keegan Kolesar,R,VGK,27,82,8,10,18
96,8483445,Cutter Gauthier,L,ANA,20,82,8,10,18
96,8483493,Frank Nazar,C,CHI,20,82,8,10,18
96,8479638,Justin Brazeau,R,BOS,26,82,7,11,18
96,8475279,Ben Chiarot,D,DET,33,82,6,12,18
96,8478859,Niko Mikkola,D,FLA,28,82,5,13,18
96,8483499,Liam Ohgren,L,MIN,20,82,5,13,18
96,8474090,Brendan Smith,D,DAL,35,82,4,14,18
96,8479371,Dante Fabbro,D,NSH,26,82,3,15,18
96,8483495,Simon Nemec,D,NJD,20,82,3,15,18
96,8479442,Troy Stecher,D,EDM,30,82,3,15,18
96,8480860,Kevin Bahl,D,CGY,24,82,1,17,18
96,8480950,Ilya Lyubushkin,D,DAL,30,82,1,17,18
96,8478569,Noel Acciari,C,PIT,33,82,9,8,17
96,8482659,Josh Doan,R,UTA,22,82,9,8,17
96,8479291,Kevin Rooney,C,CGY,31,82,8,9,17
96,8476624,Barclay Goodrow,C,SJS,31,82,4,13,17
96,8480879,Jacob Bernard-Docker,D,OTT,24,82,3,14,17
96,8480172,Jan Rutta,D,SJS,34,82,3,14,17
96,8477505,Alexander Wennberg,C,SJS,30,82,9,7,16
96,8482666,Scott Morrow,D,CAR,22,82,9,7,16
96,8476878,Zemgus Girgensons,L,TBL,30,82,7,9,16
96,8482803,Olen Zellweger,D,ANA,21,82,6,10,16
96,8483489,Fraser Minten,C,TOR,31,82,5,11,16
96,8479980,Nicolas Hague,D,VGK,26,82,4,12,16
96,8477034,Jaycob Megna,D,FLA,32,82,4,12,16
96,8478178,Darren Raddysh,D,TBL,28,82,2,14,16
96,8478399,Jonas Siegenthaler,D,NJD,27,82,1,15,16
96,8476822,Luke Glendening,C,TBL,35,82,11,4,15
96,8482470,Ilya Solovyov,D,CGY,24,82,7,8,15
96,8484911,Collin Graf,R,SJS,22,82,6,9,15
96,8482809,Jackson Blake,R,CAR,21,82,6,9,15
96,8475231,Casey Cizikas,C,NYI,33,82,5,10,15
96,8470600,Ryan Suter,D,STL,39,82,4,11,15
96,8474612,Travis Hamonic,D,OTT,34,82,4,11,15
96,8483763,Maksymilian Szuber,D,UTA,22,82,3,12,15
96,8482733,Logan Mailloux,D,MTL,31,82,3,12,15
96,8478443,Brandon Carlo,D,BOS,28,82,2,13,15
96,8479369,Andrew Peeke,D,BOS,26,82,1,14,15
96,8483397,Marc McLaughlin,C,BOS,25,82,12,2,14
96,8483468,Jiri Kulich,C,BUF,20,82,6,8,14
96,8482145,Mavrik Bourque,C,DAL,22,82,5,9,14
96,8482787,Nikita Chibrikov,R,WPG,31,82,5,9,14
96,8477931,Tomas Nosek,L,FLA,32,82,4,10,14
96,8476473,Connor Murphy,D,CHI,31,82,3,11,14
96,8475455,Brenden Dillon,D,NJD,34,82,0,14,14
96,8482259,Bobby McMann,C,TOR,28,82,9,4,13
96,8482713,Mackie Samoskevich,R,FLA,22,82,5,8,13
96,8471677,Jack Johnson,D,CBJ,37,82,5,8,13
96,8475762,Derek Forbort,D,VAN,32,82,3,10,13
96,8478450,Parker Wotherspoon,D,BOS,27,82,2,11,13
96,8477335,Kyle Burroughs,D,LAK,29,82,4,8,12
96,8479576,Vincent Desharnais,D,VAN,28,82,3,9,12
96,8476858,Phillip Di Giuseppe,L,VAN,31,82,10,1,11
96,8483471,Brad Lambert,C,WPG,31,82,5,6,11
96,8482153,Brendan Brisson,C,VGK,23,82,4,7,11
96,8483466,Kevin Korchinski,D,CHI,20,82,3,8,11
96,8475718,Justin Holl,D,DET,32,82,2,9,11
96,8483567,Georgii Merkulov,C,BOS,24,82,8,2,10
96,8482762,Simon Edvinsson,D,DET,21,82,5,5,10
96,8481524,Bowen Byram,D,BUF,23,82,3,7,10
96,8480990,Declan Chisholm,D,MIN,24,82,2,8,10
96,8482712,Oskar Olausson,R,COL,22,82,1,9,10
96,8483460,David Jiricek,D,CBJ,21,82,1,9,10
96,8482070,Mitchell Chaffee,R,TBL,26,82,5,4,9
96,8480870,Bo Groulx,C,NYR,24,82,3,6,9
96,8481605,Jackson LaCombe,D,ANA,23,82,2,7,9
96,8482859,Zack Ostapchuk,C,OTT,21,82,5,3,8
96,8476441,Joel Edmundson,D,LAK,31,82,3,5,8
96,8482516,Matthew Kessel,D,STL,24,82,0,8,8
96,8483012,Logan Morrison,C,SEA,22,82,5,2,7
96,8478874,Adam Gaudette,C,OTT,28,82,4,3,7
96,8474062,Riley Nash,C,NYR,35,82,0,3,3
96,8470794,Joe Pavelski,C,,40,0,0,0,0
96,8481703,Valtteri Puustinen,R,PIT,25,0,0,0,0
96,8477950,Tony DeAngelo,D,,29,0,0,0,0
96,8481577,Philip Tomasino,C,NSH,23,0,0,0,0
96,8475197,Tyson Barrie,D,,33,0,0,0,0
96,8471218,Blake Wheeler,R,,38,0,0,0,0
96,8474157,Max Pacioretty,L,,36,0,0,0,0
96,8478466,Daniel Sprong,R,VAN,27,0,0,0,0
96,8475744,Evgeny Kuznetsov,C,,32,0,0,0,0
96,8481019,David Gustafsson,C,WPG,24,0,0,0,0
96,8475906,John Klingberg,D,,32,0,0,0,0
96,8479348,Kale Clague,D,BUF,26,0,0,0,0
96,8476952,Dominic Toninato,C,WPG,30,0,0,0,0
96,8473473,Milan Lucic,L,,36,0,0,0,0
96,8474037,James van Riemsdyk,L,,35,0,0,0,0
96,8474602,Justin Schultz,D,,34,0,0,0,0
96,8482222,Alexander Barabanov,L,,30,0,0,0,0
96,8479372,Josh Mahura,D,SEA,26,0,0,0,0
96,8479982,Conor Timmins,D,TOR,26,0,0,0,0
96,8474031,Kevin Shattenkirk,D,,35,0,0,0,0
96,8480008,Adam Ruzicka,C,,25,0,0,0,0
96,8481059,Scott Perunovich,D,STL,26,0,0,0,0
96,8480884,Calen Addison,D,,24,0,0,0,0
96,8476994,Vinnie Hinostroza,C,NSH,30,0,0,0,0
96,8478452,Caleb Jones,D,LAK,27,0,0,0,0
96,8480157,Calle Rosen,D,COL,30,0,0,0,0
96,8481609,Vladislav Kolyachonok,D,UTA,23,0,0,0,0
96,8479415,Michael McLeod,C,,26,0,0,0,0
96,8476919,Chris Tierney,C,,30,0,0,0,0
96,8479639,Dylan Coghlan,D,WPG,26,0,0,0,0
96,8478146,Matthew Highmore,C,OTT,28,0,0,0,0
96,8478970,Jalen Chatfield,D,CAR,28,0,0,0,0
96,8480205,Emil Bemstrom,C,PIT,25,0,0,0,0
96,8474884,Mike Hoffman,C,,35,0,0,0,0
96,8471274,Alex Goligoski,D,,39,0,0,0,0
96,8478104,Sammy Blais,L,,28,0,0,0,0
96,8474870,Tyler Johnson,C,,34,0,0,0,0
96,8476913,Devin Shore,C,MIN,30,0,0,0,0
96,8481598,Philip Broberg,D,EDM,23,0,0,0,0
96,8480058,Pierre-Olivier Joseph,D,STL,25,0,0,0,0
96,8480891,Michael Kesselring,D,UTA,24,0,0,0,0
96,8477979,Nicolas Aube-Kubel,R,BUF,28,0,0,0,0
96,8476871,Tanner Pearson,L,,32,0,0,0,0
96,8476393,Nick Cousins,C,,31,0,0,0,0
96,8479977,Kailer Yamamoto,R,,26,0,0,0,0
96,8479543,Michael Pezzetta,L,MTL,26,0,0,0,0
96,8477018,Ben Hutton,D,VGK,31,0,0,0,0
96,8480762,Eric Robinson,L,CAR,29,0,0,0,0
96,8474034,Pat Maroon,L,CHI,36,0,0,0,0
96,8481058,Jesse Ylönen,R,,25,0,0,0,0
96,8475179,Dmitry Kulikov,D,FLA,34,0,0,0,0
96,8481527,Kaedan Korczak,D,VGK,23,0,0,0,0
96,8473449,Kyle Okposo,R,,36,0,0,0,0
96,8482192,Isaak Phillips,D,CHI,23,0,0,0,0
96,8480727,Zach Whitecloud,D,VGK,28,0,0,0,0
96,8479346,Dillon Dube,C,,26,0,0,0,0
96,8480821,Filip Zadina,R,,25,0,0,0,0
96,8480001,Urho Vaakanainen,D,ANA,25,0,0,0,0
96,8470966,Mark Giordano,D,,41,0,0,0,0
96,8480853,Liam Foudy,C,,24,0,0,0,0
96,8475225,Craig Smith,C,CHI,35,0,0,0,0
96,8479972,Mason Shaw,C,WPG,26,0,0,0,0
96,8478451,Ethan Bear,D,WSH,27,0,0,0,0
96,8474040,Sam Gagner,C,,35,0,0,0,0
96,8480196,Jacob Bryson,D,BUF,27,0,0,0,0
96,8479984,Cal Foote,D,,26,0,0,0,0
96,8480011,Klim Kostin,C,SJS,25,0,0,0,0
96,8482176,Wyatt Kaiser,D,CHI,22,0,0,0,0
96,8476988,Matt Benning,D,SJS,30,0,0,0,0
96,8479370,Tyson Jost,C,CAR,26,0,0,0,0
96,8477464,Nic Petan,C,,29,0,0,0,0
96,8477380,Jonny Brodzinski,C,NYR,31,0,0,0,0
96,8480070,Ian Mitchell,D,BOS,25,0,0,0,0
96,8479315,Joey Anderson,R,CHI,26,0,0,0,0
96,8478099,Kevin Labanc,R,,29,0,0,0,0
96,8476874,Olli Maatta,D,DET,30,0,0,0,0
96,8475208,Brian Dumoulin,D,ANA,33,0,0,0,0
96,8478430,Oliver Kylington,D,,27,0,0,0,0
96,8479536,Axel Jonsson-Fjallby,L,WPG,26,0,0,0,0
96,8479671,Mathieu Olivier,R,CBJ,27,0,0,0,0
96,8471709,Marc-Edouard Vlasic,D,SJS,37,0,0,0,0
96,8479328,Julien Gauthier,R,NYI,27,0,0,0,0
96,8478421,A.J. Greer,L,FLA,28,0,0,0,0
96,8477573,Nathan Walker,L,STL,30,0,0,0,0
96,8481537,Nikita Okhotiuk,D,CGY,24,0,0,0,0
96,8474166,Alec Martinez,D,CHI,37,0,0,0,0
96,8470610,Zach Parise,L,,40,0,0,0,0
96,8477478,William Carrier,L,CAR,30,0,0,0,0
96,8479344,Jesse Puljujarvi,R,PIT,26,0,0,0,0
96,8480887,Jordan Harris,D,MTL,24,0,0,0,0
96,8478502,Dennis Gilbert,D,BUF,28,0,0,0,0
96,8482730,Brandt Clarke,D,LAK,21,0,0,0,0
96,8480355,Mark Kastelic,C,BOS,25,0,0,0,0
96,8475750,Jon Merrill,D,MIN,32,0,0,0,0
96,8475164,Jakob Silfverberg,R,,34,0,0,0,0
96,8477944,Jakub Vrana,L,,28,0,0,0,0
96,8479439,Jacob MacDonald,D,COL,31,0,0,0,0
96,8474568,Luke Schenn,D,NSH,35,0,0,0,0
96,8478454,Noah Juulsen,D,VAN,27,0,0,0,0
96,8475752,Tyler Pitlick,C,,33,0,0,0,0
96,8482148,Hendrix Lapierre,C,WSH,22,0,0,0,0
96,8481167,Brayden Pachal,D,CGY,25,0,0,0,0
96,8478043,Sam Lafferty,C,BUF,29,0,0,0,0
96,8479321,Lucas Johansen,D,,27,0,0,0,0
96,8471699,Andrew Cogliano,C,,37,0,0,0,0
96,8481521,Ronnie Attard,D,PHI,25,0,0,0,0
96,8481161,Jake Christiansen,D,CBJ,25,0,0,0,0
96,8479458,Nikita Zaitsev,D,,33,0,0,0,0
96,8479619,Michael Carcone,L,UTA,28,0,0,0,0
96,8479026,Philippe Myers,D,TOR,27,0,0,0,0
96,8477330,Dominik Kubalik,L,,29,0,0,0,0
96,8481617,Vasily Podkolzin,R,VAN,23,0,0,0,0
96,8481701,Santeri Hatakka,D,NJD,23,0,0,0,0
96,8479514,Rem Pitlick,C,,27,0,0,0,0
96,8477446,Michael McCarron,R,NSH,29,0,0,0,0
96,8470604,Jeff Carter,C,,39,0,0,0,0
96,8482241,Radim Zohorna,L,,28,0,0,0,0
96,8480289,Morgan Barron,C,WPG,26,0,0,0,0
96,8479379,Givani Smith,R,SJS,26,0,0,0,0
96,8480216,Jacob Peterson,C,,25,0,0,0,0
96,8477851,Jordan Oesterle,D,BOS,32,0,0,0,0
96,8484258,Sam Malinski,D,COL,26,0,0,0,0
96,8478904,Steven Lorentz,C,,28,0,0,0,0
96,8482095,Tyler Kleven,D,OTT,22,0,0,0,0
96,8480848,Ty Dellandrea,C,SJS,24,0,0,0,0
96,8476884,Derrick Pouliot,D,,30,0,0,0,0
96,8479336,Carl Grundstrom,R,SJS,27,0,0,0,0
96,8482964,Arber Xhekaj,D,MTL,23,0,0,0,0
96,8471686,Marc Staal,D,,37,0,0,0,0
96,8477887,Patrick Brown,C,BOS,32,0,0,0,0
96,8478495,Denis Gurianov,R,,27,0,0,0,0
96,8473504,Cal Clutterbuck,R,,37,0,0,0,0
96,8481550,Adam Beckman,L,NJD,23,0,0,0,0
96,8480845,Rasmus Kupari,C,WPG,24,0,0,0,0
96,8474009,Nick Bonino,C,,36,0,0,0,0
96,8478585,Derek Ryan,C,EDM,38,0,0,0,0
96,8477962,Brendan Lemieux,L,CAR,28,0,0,0,0
96,8482861,Vincent Iorio,D,WSH,22,0,0,0,0
96,8479378,Logan Stanley,D,WPG,26,0,0,0,0
96,8473446,Erik Johnson,D,PHI,36,0,0,0,0
96,8481743,Marc Del Gaizo,D,NSH,25,0,0,0,0
96,8477384,Josh Brown,D,EDM,30,0,0,0,0
96,8482165,Yan Kuznetsov,D,CGY,22,0,0,0,0
96,8478424,Jansen Harkins,C,ANA,27,0,0,0,0
96,8482144,Jack Thompson,D,SJS,22,0,0,0,0
96,8478512,Austin Czarnik,C,,32,0,0,0,0
96,8477527,Ross Johnston,L,ANA,30,0,0,0,0
96,8479383,Boris Katchouk,L,,26,0,0,0,0
96,8482094,Daemon Hunt,D,MIN,22,0,0,0,0
96,8481719,Maxwell Crozier,D,TBL,24,0,0,0,0
96,8480192,Johnathan Kovacevic,D,NJD,27,0,0,0,0
96,8479376,Victor Mete,D,,26,0,0,0,0
96,8482511,Mason Lohrei,D,BOS,23,0,0,0,0
96,8475825,Jani Hakanpää,D,,32,0,0,0,0
96,8478021,William Lagesson,D,DET,28,0,0,0,0
96,8475795,Dylan McIlrath,D,WSH,32,0,0,0,0
96,8477846,Ryan Carpenter,C,,33,0,0,0,0
96,8481056,Spencer Stastney,D,NSH,24,0,0,0,0
96,8481564,Ryan Johnson,D,BUF,23,0,0,0,0
96,8478017,Mark Friedman,D,VAN,29,0,0,0,0
96,8479320,Max Lajoie,D,SEA,27,0,0,0,0
96,8480075,Cameron Crotty,D,MIN,25,0,0,0,0
96,8484287,Cole McWard,D,VAN,23,0,0,0,0
96,8484254,Akito Hirose,D,VAN,25,0,0,0,0
96,8483407,Brandon Scanlin,D,NYR,25,0,0,0,0
96,8480274,Philip Kemp,D,EDM,25,0,0,0,0
96,8479522,Hardy Haman Aktell,D,WSH,26,0,0,0,0
96,8480007,Jonas Rondbjerg,R,VGK,25,0,0,0,0
96,8477454,Adam Erne,L,,29,0,0,0,0
96,8481679,Maxence Guenette,D,OTT,23,0,0,0,0
96,8480441,Trey Fix-Wolansky,R,CBJ,25,0,0,0,0
96,8483546,Marshall Rifai,D,TOR,26,0,0,0,0
96,8480084,Nick DeSimone,D,NJD,30,0,0,0,0
96,8481030,Jack St. Ivany,D,PIT,25,0,0,0,0
96,8481592,Jakob Pelletier,L,CGY,23,0,0,0,0
96,8478011,Louie Belpedio,D,PHI,28,0,0,0,0
96,8477930,Pierre-Edouard Bellemare,L,,39,0,0,0,0
96,8484321,Nikolas Matinpalo,D,OTT,26,0,0,0,0
96,8482067,Connor Mackey,D,NYR,28,0,0,0,0
96,8481806,Louis Crevier,D,CHI,23,0,0,0,0
96,8484326,Patrik Koch,D,UTA,28,0,0,0,0
96,8477971,Andreas Englund,D,LAK,28,0,0,0,0
96,8481751,Lukas Rousek,R,BUF,25,0,0,0,0
96,8481006,Tyler Tucker,D,STL,24,0,0,0,0
96,8476867,Brendan Gaunce,C,MIN,30,0,0,0,0
96,8479520,Brandon Duhaime,R,WSH,27,0,0,0,0
96,8477073,Kurtis MacDermid,L,NJD,30,0,0,0,0
96,8480874,Adam Ginning,D,PHI,24,0,0,0,0
96,8477473,Justin Bailey,R,SJS,29,0,0,0,0
96,8479066,Ryan Lomberg,L,CGY,30,0,0,0,0
96,8477070,Liam O'Brien,C,UTA,30,0,0,0,0
96,8474618,Marco Scandella,D,,34,0,0,0,0
96,8475797,Jarred Tinordi,D,,32,0,0,0,0
96,8481441,Joe Snively,C,DET,28,0,0,0,0
96,8477244,Chad Ruhwedel,D,NYR,34,0,0,0,0
96,8479772,Zack MacEwen,R,OTT,28,0,0,0,0
96,8481147,Reese Johnson,C,MIN,26,0,0,0,0
96,8481043,Cole Koepke,L,BOS,26,0,0,0,0
96,8483619,Filip Roos,D,OTT,25,0,0,0,0
96,8481541,Samuel Bolduc,D,NYI,24,0,0,0,0
96,8477810,Joel Hanley,D,CGY,33,0,0,0,0
96,8476907,Mackenzie MacEachern,L,,30,0,0,0,0
96,8482652,Walker Duehr,R,CGY,27,0,0,0,0
96,8477126,Jayson Megna,C,,34,0,0,0,0
96,8483398,Declan Carlile,D,TBL,31,0,0,0,0
96,8482929,Emil Lilleberg,D,TBL,23,0,0,0,0
96,8480880,Jakub Lauko,C,MIN,24,0,0,0,0
96,8480245,Olle Lycksell,R,PHI,25,0,0,0,0
96,8480252,Cole Guttman,C,CHI,25,0,0,0,0
96,8477467,Gustav Olofsson,D,SEA,30,0,0,0,0
96,8479968,Vinni Lettieri,C,BOS,29,0,0,0,0
96,8478400,Colin White,C,,27,0,0,0,0
96,8475755,Alexander Petrovic,D,DAL,32,0,0,0,0
96,8481812,Nikolai Knyzhov,D,,27,0,0,0,0
96,8481593,Jayden Struble,D,MTL,23,0,0,0,0
96,8481532,Alex Turcotte,C,LAK,23,0,0,0,0
96,8482126,Emil Andrae,D,PHI,31,0,0,0,0
96,8479944,Zach Aston-Reese,C,VGK,30,0,0,0,0
96,8471817,Ryan Reaves,R,TOR,37,0,0,0,0
96,8481206,John Ludvig,D,PIT,24,0,0,0,0
96,8481599,Victor Soderstrom,D,UTA,23,0,0,0,0
96,8480292,Carson Meyer,R,ANA,27,0,0,0,0
96,8482496,Nils Aman,C,VAN,24,0,0,0,0
96,8479718,Alex Barré-Boulet,C,MTL,27,0,0,0,0
96,8479994,Jaret Anderson-Dolan,C,WPG,25,0,0,0,0
96,8480184,Gustav Lindstrom,D,,26,0,0,0,0
96,8480890,Jan Jenik,R,OTT,24,0,0,0,0
96,8478067,Oskar Lindblom,L,,28,0,0,0,0
96,8476934,Brock McGinn,L,ANA,30,0,0,0,0
96,8479985,Cale Fleury,D,SEA,26,0,0,0,0
96,8484304,Uvis Balinskis,D,FLA,28,0,0,0,0
96,8479981,Jonah Gadjovich,L,FLA,26,0,0,0,0
96,8481716,Dmitri Voronkov,L,CBJ,24,0,0,0,0
96,8474709,Matt Martin,L,,35,0,0,0,0
96,8482634,Alex Steeves,C,TOR,25,0,0,0,0
96,8480823,Alexander Alexeyev,D,WSH,25,0,0,0,0
96,8477541,Dakota Mermis,D,TOR,30,0,0,0,0
96,8483491,Ivan Miroshnichenko,L,WSH,20,0,0,0,0
96,8478477,Mitchell Stephens,C,SEA,27,0,0,0,0
96,8481543,Nikita Alexandrov,C,STL,24,0,0,0,0
96,8479423,Alex Nylander,L,,26,0,0,0,0
96,8482451,Mikael Pyyhtia,L,CBJ,23,0,0,0,0
96,8478831,Kevin Stenlund,C,UTA,28,0,0,0,0
96,8480306,Grant Hutton,D,NYI,29,0,0,0,0
96,8478028,Fredrik Olofsson,L,,28,0,0,0,0
96,8477462,Robert Hagg,D,VGK,29,0,0,0,0
96,8477320,Anton Blidh,L,NYR,29,0,0,0,0
96,8482157,Will Cuylle,L,NYR,22,0,0,0,0
96,8482737,Zack Bolduc,C,STL,21,0,0,0,0
96,8481239,Samuel Fagemo,L,,24,0,0,0,0
96,8481600,Tobias Bjornfot,D,FLA,23,0,0,0,0
96,8478409,Anthony Richard,C,PHI,28,0,0,0,0
96,8474145,Robert Bortuzzo,D,,35,0,0,0,0
96,8475958,Michael Sgarbossa,C,WSH,32,0,0,0,0
96,8479986,Kole Lind,R,DAL,26,0,0,0,0
96,8479249,Andrew Poturalski,C,SJS,30,0,0,0,0
96,8479362,Riley Tufte,L,BOS,26,0,0,0,0
96,8479991,Jake Leschyshyn,C,NYR,25,0,0,0,0
96,8479587,Rhett Gardner,C,PHI,28,0,0,0,0
96,8482744,James Malatesta,L,CBJ,21,0,0,0,0
96,8478854,Ryan Shea,D,PIT,27,0,0,0,0
96,8481591,Sam Poulin,R,,23,0,0,0,0
96,8483512,Matt Savoie,C,EDM,20,0,0,0,0
96,8482102,Vasily Ponomarev,C,PIT,22,0,0,0,0
96,8482162,Roby Jarventie,L,EDM,22,0,0,0,0
96,8481016,Ruslan Iskhakov,C,,24,0,0,0,0
96,8482172,Landon Slaggert,L,CHI,22,0,0,0,0
96,8482747,Brennan Othmann,L,NYR,21,0,0,0,0
96,8480031,Maxime Comtois,L,,25,0,0,0,0
96,8480226,Marián Studenic,R,,26,0,0,0,0
96,8478408,Travis Dermott,D,,28,0,0,0,0
96,8481518,Nolan Foote,L,NJD,24,0,0,0,0
96,8479419,Brett Murray,L,BUF,26,0,0,0,0
96,8482088,Justin Sourdif,R,FLA,22,0,0,0,0
96,8482201,Gage Goncalves,C,TBL,23,0,0,0,0
96,8481578,Graeme Clarke,R,MIN,23,0,0,0,0
96,8482177,Marat Khusnutdinov,C,MIN,22,0,0,0,0
96,8481754,Nikita Nesterenko,C,ANA,23,0,0,0,0
96,8483531,Brian Halonen,L,NJD,25,0,0,0,0
96,8483920,Pierrick Dube,R,WSH,23,0,0,0,0
96,8480851,Akil Thomas,C,LAK,24,0,0,0,0
96,8475235,Nicolas Deslauriers,L,PHI,33,0,0,0,0
96,8482476,Emil Heineman,L,MTL,23,0,0,0,0
96,8477149,Scott Sabourin,R,SJS,32,0,0,0,0
96,8483549,Lucas Condotta,L,MTL,27,0,0,0,0
96,8482765,Isak Rosen,R,BUF,21,0,0,0,0
96,8481237,Kyle MacLean,C,NYI,25,0,0,0,0
96,8481024,Linus Karlsson,C,VAN,25,0,0,0,0
96,8481690,Tyler Angle,C,,24,0,0,0,0
96,8483570,Ben Meyers,C,SEA,26,0,0,0,0
96,8481655,Cole Schwindt,R,CGY,23,0,0,0,0
96,8481462,Mason Morelli,L,VGK,28,0,0,0,0
96,8483401,Marc Johnstone,R,PIT,28,0,0,0,0
96,8478956,Samuel Laberge,L,NJD,27,0,0,0,0
96,8479533,Joona Koppanen,L,,26,0,0,0,0
96,8482197,Adam Raska,R,MIN,23,0,0,0,0
96,8482250,Callahan Burke,C,VGK,27,0,0,0,0
96,8482784,Zach Dean,C,STL,21,0,0,0,0
96,8484255,Jason Polin,R,COL,25,0,0,0,0
96,8481077,John Leonard,L,,26,0,0,0,0
96,8481534,Raphael Lavoie,C,EDM,24,0,0,0,0
96,8483609,Adam Klapka,R,CGY,24,0,0,0,0
96,8482751,Ryan Winterton,C,SEA,21,0,0,0,0
96,8480267,Sammy Walker,C,MIN,25,0,0,0,0
96,8475766,Austin Watson,L,,32,0,0,0,0
96,8482460,Matt Rempe,C,NYR,22,0,0,0,0
96,8481065,Angus Crookshank,L,OTT,25,0,0,0,0
96,8481070,Hugh McGing,L,,26,0,0,0,0
96,8476323,Max McCormick,L,SEA,32,0,0,0,0
96,8483395,Arshdeep Bains,L,VAN,23,0,0,0,0
96,8484259,Ondrej Pavel,C,COL,31,0,0,0,0
96,8483432,Luca Del Bel Belluz,C,CBJ,31,0,0,0,0
96,8483045,Cameron Butler,R,CBJ,31,0,0,0,0
96,8482061,Brandon Biro,L,SEA,26,0,0,0,0
96,8477401,John Hayden,C,SEA,29,0,0,0,0
96,8475278,Byron Froese,C,,33,0,0,0,0
96,8478446,Glenn Gawdin,C,LAK,27,0,0,0,0
96,8477993,Justin Kirkland,C,CGY,28,0,0,0,0
96,8482147,Jean-Luc Foudy,C,COL,22,0,0,0,0
96,8480032,Shane Bowers,C,NJD,25,0,0,0,0
96,8479330,Brandon Gignac,C,MTL,27,0,0,0,0
96,8480776,Sheldon Rempal,R,,29,0,0,0,0
96,8475413,Justin Dowling,C,NJD,34,0,0,0,0
96,8481726,Adam Edstrom,C,NYR,24,0,0,0,0
96,8480844,Grigori Denisenko,L,VGK,24,0,0,0,0
96,8478147,Bokondji Imama,L,PIT,28,0,0,0,0
96,8478881,Brett Seney,L,CHI,28,0,0,0,0
96,8483630,Pavol Regenda,L,ANA,25,0,0,0,0
96,8480836,Jonathan Gruden,C,,24,0,0,0,0
96,8484314,Jiri Smejkal,L,,28,0,0,0,0
96,8475780,Chris Wagner,R,COL,33,0,0,0,0
96,8479546,Oskar Steen,C,,26,0,0,0,0
96,8483597,Milos Kelemen,L,UTA,25,0,0,0,0
96,8481789,Tye Kartye,L,SEA,23,0,0,0,0
96,8484325,Waltteri Merela,C,TBL,26,0,0,0,0
96,8479421,Jacob Moverare,D,LAK,26,0,0,0,0
96,8481585,Egor Afanasyev,L,SJS,23,0,0,0,0
96,8479547,Matthew Phillips,R,,26,0,0,0,0
96,8479367,William Lockwood,R,FLA,26,0,0,0,0
96,8476915,Jujhar Khaira,L,,30,0,0,0,0
96,8481422,Jacob Lucchini,C,NSH,29,0,0,0,0
96,8480468,James Hamblin,L,EDM,25,0,0,0,0
96,8478051,Max Willman,C,NJD,29,0,0,0,0
96,8481556,John Beecher,C,BOS,23,0,0,0,0
96,8478078,Rourke Chartier,C,,28,0,0,0,0
97,8477492,Nathan MacKinnon,C,COL,29,82,51,107,158
97,8476453,Nikita Kucherov,R,TBL,31,82,54,87,141
97,8478402,Connor McDavid,C,EDM,27,82,39,96,135
97,8481559,Jack Hughes,C,NJD,23,82,49,77,126
97,8479318,Auston Matthews,C,TOR,27,82,65,53,118
97,8479314,Matthew Tkachuk,L,FLA,27,82,30,84,114
97,8477942,Kevin Fiala,L,LAK,28,82,43,70,113
97,8477934,Leon Draisaitl,C,EDM,29,82,40,73,113
97,8478427,Sebastian Aho,C,CAR,27,82,55,57,112
97,8477933,Sam Reinhart,C,FLA,29,82,57,50,107
97,8476468,J.T. Miller,C,VAN,31,82,39,67,106
97,8478420,Mikko Rantanen,R,COL,28,82,46,54,100
97,8478864,Kirill Kaprizov,L,MIN,27,82,54,45,99
97,8481557,Matt Boldy,L,MIN,23,82,45,54,99
97,8480012,Elias Pettersson,C,VAN,26,82,39,59,98
97,8471675,Sidney Crosby,C,PIT,37,82,39,58,97
97,8480027,Jason Robertson,L,DAL,25,82,39,55,94
97,8480800,Quinn Hughes,D,VAN,25,82,10,84,94
97,8475166,John Tavares,C,TOR,34,82,40,53,93
97,8480002,Nico Hischier,C,NJD,25,82,33,60,93
97,8477939,William Nylander,R,TOR,28,82,29,64,93
97,8477956,David Pastrnak,R,BOS,28,82,48,43,91
97,8476887,Filip Forsberg,L,NSH,30,82,44,47,91
97,8480801,Brady Tkachuk,L,OTT,25,82,37,54,91
97,8478550,Artemi Panarin,L,NYR,33,82,34,54,88
97,8480069,Cale Makar,D,COL,26,82,23,65,88
97,8477404,Jake Guentzel,C,TBL,30,82,39,48,87
97,8477940,Nikolaj Ehlers,L,WPG,28,82,35,52,87
97,8474600,Roman Josi,D,NSH,34,82,18,69,87
97,8481523,Kirby Dach,C,MTL,23,82,16,71,87
97,8477946,Dylan Larkin,C,DET,28,82,40,46,86
97,8475692,Mats Zuccarello,R,MIN,37,82,17,69,86
97,8478010,Brayden Point,C,TBL,28,82,46,39,85
97,8477409,Carter Verhaeghe,C,FLA,29,82,46,38,84
97,8474564,Steven Stamkos,C,NSH,34,82,38,46,84
97,8475172,Nazem Kadri,C,CGY,34,82,31,53,84
97,8478403,Jack Eichel,C,VGK,28,82,41,42,83
97,8478445,Mathew Barzal,C,NYI,27,82,19,63,82
97,8482684,Luke Hughes,D,NJD,21,82,15,67,82
97,8479407,Jesper Bratt,L,NJD,26,82,34,47,81
97,8477951,Nick Schmaltz,C,UTA,28,82,32,49,81
97,8471215,Evgeni Malkin,C,PIT,38,82,31,50,81
97,8482116,Tim Stützle,C,OTT,22,82,29,52,81
97,8479385,Jordan Kyrou,C,STL,26,82,37,43,80
97,8477493,Aleksander Barkov,C,FLA,29,82,30,50,80
97,8475810,Bryan Rust,R,PIT,32,82,37,42,79
97,8478449,Roope Hintz,C,DAL,28,82,30,49,79
97,8478439,Travis Konecny,R,PHI,27,82,29,50,79
97,8481533,Trevor Zegras,C,ANA,23,82,29,50,79
97,8475168,Matt Duchene,C,DAL,33,82,26,53,79
97,8476853,Morgan Rielly,D,TOR,30,82,13,66,79
97,8478398,Kyle Connor,L,WPG,28,82,41,37,78
97,8479343,Clayton Keller,R,UTA,26,82,36,42,78
97,8478440,Dylan Strome,C,WSH,27,82,33,45,78
97,8477949,Alex Tuch,R,BUF,28,82,22,55,77
97,8476346,Johnny Gaudreau,L,CBJ,31,82,15,62,77
97,8476389,Vincent Trocheck,C,NYR,31,82,26,50,76
97,8473512,Claude Giroux,R,OTT,36,82,23,53,76
97,8480023,Robert Thomas,C,STL,25,82,21,55,76
97,8477447,Shea Theodore,D,VGK,29,82,15,61,76
97,8475754,Brock Nelson,C,NYI,33,82,33,42,75
97,8475158,Ryan O'Reilly,C,NSH,33,82,33,42,75
97,8480830,Andrei Svechnikov,R,CAR,24,82,31,44,75
97,8476459,Mika Zibanejad,C,NYR,31,82,28,47,75
97,8482078,Lucas Raymond,L,DET,22,82,26,49,75
97,8479675,Trevor Moore,L,LAK,29,82,43,31,74
97,8477402,Pavel Buchnevich,L,STL,29,82,31,43,74
97,8476881,Tomas Hertl,C,VGK,31,82,30,44,74
97,8479323,Adam Fox,D,NYR,26,82,13,61,74
97,8476539,Jonathan Marchessault,R,NSH,34,82,37,36,73
97,8477501,Valeri Nichushkin,R,COL,29,82,35,38,73
97,8475184,Chris Kreider,L,NYR,33,82,47,25,72
97,8478414,Timo Meier,R,NJD,28,82,35,37,72
97,8475913,Mark Stone,R,VGK,32,82,29,43,72
97,8480018,Nick Suzuki,C,MTL,25,82,26,46,72
97,8479999,Casey Mittelstadt,C,COL,26,82,22,50,72
97,8478493,Joel Eriksson Ek,C,MIN,27,82,40,31,71
97,8478444,Brock Boeser,R,VAN,27,82,30,41,71
97,8471685,Anze Kopitar,C,LAK,37,82,20,51,71
97,8481540,Cole Caufield,R,MTL,23,82,37,33,70
97,8476875,Mike Matheson,D,MTL,30,82,17,53,70
97,8473994,Jamie Benn,L,DAL,35,82,30,39,69
97,8476460,Mark Scheifele,C,WPG,31,82,21,48,69
97,8477504,Josh Morrissey,D,WPG,29,82,15,54,69
97,8475167,Victor Hedman,D,TBL,34,82,11,58,69
97,8480803,Evan Bouchard,D,EDM,25,82,11,58,69
97,8480865,Noah Dobson,D,NYI,24,82,9,60,69
97,8482093,Seth Jarvis,C,CAR,22,82,35,33,68
97,8474578,Erik Karlsson,D,PIT,34,82,20,48,68
97,8476456,Jonathan Huberdeau,C,CGY,31,82,18,49,67
97,8477346,MacKenzie Weegar,D,CGY,30,82,12,55,67
97,8477476,Artturi Lehkonen,L,COL,29,82,34,32,66
97,8482740,Wyatt Johnston,C,DAL,21,82,32,34,66
97,8471214,Alex Ovechkin,L,WSH,39,82,29,37,66
97,8480208,Drake Batherson,R,OTT,26,82,28,38,66
97,8480036,Miro Heiskanen,D,DAL,25,82,10,56,66
97,8477500,Bo Horvat,C,NYI,29,82,36,29,65
97,8480434,Sean Durzi,D,UTA,26,82,15,50,65
97,8480014,Gabriel Vilardi,C,WPG,25,82,39,25,64
97,8479420,Tage Thompson,C,BUF,27,82,37,27,64
97,8478856,Conor Garland,R,VAN,28,82,32,32,64
97,8475784,Jeff Skinner,C,EDM,32,82,29,35,64
97,8477960,Adrian Kempe,R,LAK,28,82,28,36,64
97,8476448,William Karlsson,C,VGK,31,82,22,42,64
97,8476462,Dougie Hamilton,D,NJD,31,82,18,46,64
97,8476483,Rickard Rakell,R,PIT,31,82,35,28,63
97,8477955,Jared McCann,L,SEA,28,82,28,35,63
97,8475794,Tyler Seguin,C,DAL,32,82,26,37,63
97,8479542,Brandon Hagel,L,TBL,26,82,21,42,63
97,8482124,Quinton Byfield,R,LAK,22,82,18,45,63
97,8479325,Charlie McAvoy,D,BOS,27,82,15,48,63
97,8478407,Vince Dunn,D,SEA,28,82,12,51,63
97,8475786,Zach Hyman,L,EDM,32,82,35,27,62
97,8477935,Sam Bennett,C,FLA,28,82,34,28,62
97,8478873,Troy Terry,R,ANA,27,82,25,37,62
97,8473419,Brad Marchand,L,BOS,36,82,23,39,62
97,8479400,Pierre-Luc Dubois,L,WSH,26,82,34,27,61
97,8482665,Matty Beniers,C,SEA,22,82,20,41,61
97,8478038,Devon Toews,D,COL,30,82,14,47,61
97,8480839,Rasmus Dahlin,D,BUF,24,82,12,49,61
97,8476479,Phillip Danault,C,LAK,31,82,30,30,60
97,8476882,Teuvo Teravainen,L,CHI,30,82,29,31,60
97,8479339,Patrik Laine,L,CBJ,26,82,28,32,60
97,8474141,Patrick Kane,R,DET,36,82,23,37,60
97,8476454,Ryan Nugent-Hopkins,C,EDM,31,82,19,41,60
97,8474590,John Carlson,D,WSH,34,82,13,47,60
97,8478498,Jake DeBrusk,L,VAN,28,82,31,28,59
97,8477416,Oliver Bjorkstrand,R,SEA,29,82,31,28,59
97,8478975,Mason Marchment,L,DAL,29,82,28,31,59
97,8481596,Shane Pinto,C,OTT,24,82,27,32,59
97,8478438,Tommy Novak,C,NSH,27,82,16,43,59
97,8475726,Tyler Toffoli,C,SJS,32,82,27,31,58
97,8476826,Yanni Gourde,C,SEA,33,82,22,36,58
97,8477479,Tyler Bertuzzi,L,CHI,29,82,21,37,58
97,8481711,Matias Maccelli,L,UTA,24,82,20,38,58
97,8475798,Mikael Granlund,C,SJS,32,82,12,46,58
97,8478047,Michael Bunting,L,PIT,29,82,24,33,57
97,8480797,Joel Farabee,L,PHI,24,82,24,33,57
97,8481528,Dylan Cozens,C,BUF,23,82,22,35,57
97,8477932,Aaron Ekblad,D,FLA,28,82,14,43,57
97,8474563,Drew Doughty,D,LAK,35,82,12,45,57
97,8480064,Josh Norris,C,OTT,25,82,37,19,56
97,8477407,Anthony Duclair,L,NYI,29,82,25,31,56
97,8482113,Anton Lundell,C,FLA,23,82,24,32,56
97,8477456,J.T. Compher,L,DET,29,82,23,33,56
97,8482745,Mason McTavish,C,ANA,21,82,22,34,56
97,8476905,Chandler Stephenson,C,SEA,30,82,12,44,56
97,8476906,Shayne Gostisbehere,D,CAR,31,82,10,46,56
97,8475170,Brayden Schenn,C,STL,33,82,25,30,55
97,8477503,Max Domi,C,TOR,29,82,20,35,55
97,8476880,Tom Wilson,R,WSH,30,82,20,35,55
97,8477496,Elias Lindholm,C,BOS,30,82,19,36,55
97,8476432,Boone Jenner,C,CBJ,31,82,28,26,54
97,8475768,Jaden Schwartz,C,SEA,32,82,28,26,54
97,8473986,Alex Killorn,L,ANA,35,82,26,28,54
97,8478042,Viktor Arvidsson,R,EDM,31,82,20,34,54
97,8480028,Morgan Frost,C,PHI,25,82,20,34,54
97,8480078,Filip Chytil,C,NYR,25,82,17,37,54
97,8477511,Anthony Mantha,R,CGY,30,82,27,26,53
97,8478233,Andrew Mangiapane,L,WSH,28,82,26,27,53
97,8477998,Warren Foegele,L,LAK,28,82,21,32,53
97,8475191,Reilly Smith,R,NYR,33,82,18,35,53
97,8476419,Jean-Gabriel Pageau,C,NYI,32,82,16,37,53
97,8479425,Filip Hronek,D,VAN,27,82,12,41,53
97,8476438,Brandon Saad,L,STL,32,82,28,24,52
97,8475169,Evander Kane,L,EDM,33,82,25,27,52
97,8482720,Matthew Knies,L,TOR,22,82,22,30,52
97,8474679,Gustav Nyquist,C,NSH,35,82,19,33,52
97,8478460,Zach Werenski,D,CBJ,27,82,17,35,52
97,8478055,Gustav Forsling,D,FLA,28,82,14,38,52
97,8471724,Kris Letang,D,PIT,37,82,11,41,52
97,8475765,Vladimir Tarasenko,R,DET,33,82,23,28,51
97,8476872,Scott Laughton,C,PHI,30,82,23,28,51
97,8477494,Jonathan Drouin,L,COL,29,82,16,35,51
97,8480798,Philipp Kurashev,C,CHI,25,82,14,37,51
97,8481656,Aliaksei Protas,C,WSH,23,82,12,39,51
97,8475753,Justin Faulk,D,STL,32,82,11,40,51
97,8478109,Victor Olofsson,L,VGK,29,82,29,21,50
97,8476399,Blake Coleman,C,CGY,33,82,25,25,50
97,8474149,Evgenii Dadonov,R,DAL,35,82,24,26,50
97,8475714,Calle Jarnkrok,C,TOR,33,82,18,32,50
97,8477021,Alex Kerfoot,C,UTA,30,82,17,33,50
97,8478396,Noah Hanifin,D,VGK,27,82,14,36,50
97,8476792,Torey Krug,D,STL,33,82,9,41,50
97,8480145,Neal Pionk,D,WPG,29,82,8,42,50
97,8479410,Mikhail Sergachev,D,UTA,26,82,7,43,50
97,8474641,Adam Henrique,C,EDM,34,82,23,26,49
97,8479337,Alex DeBrincat,R,DET,27,82,22,27,49
97,8480039,Martin Necas,C,CAR,25,82,22,27,49
97,8478057,Dakota Joshua,C,VAN,28,82,19,30,49
97,8475793,Ryan Johansen,C,PHI,32,82,18,31,49
97,8475763,Kevin Hayes,R,PIT,32,82,16,33,49
97,8482159,Tyson Foerster,R,PHI,22,82,24,24,48
97,8481068,Yegor Sharangovich,C,CGY,26,82,20,28,48
97,8476292,Ondrej Palat,L,NJD,33,82,16,32,48
97,8474565,Alex Pietrangelo,D,VGK,34,82,16,32,48
97,8478519,Anthony Cirelli,C,TBL,27,82,13,35,48
97,8470613,Brent Burns,D,CAR,39,82,11,37,48
97,8476931,Jake McCabe,D,TOR,31,82,11,37,48
97,8477497,Sean Monahan,C,CBJ,30,82,29,18,47
97,8478474,Lawson Crouse,L,UTA,27,82,23,24,47
97,8474102,David Perron,L,OTT,36,82,19,28,47
97,8482149,Cole Perfetti,C,WPG,22,82,18,29,47
97,8475745,Charlie Coyle,C,BOS,32,82,17,30,47
97,8484144,Connor Bedard,C,CHI,19,82,17,30,47
97,8483515,Juraj Slafkovsky,L,MTL,20,82,16,31,47
97,8477986,Brandon Montour,D,SEA,30,82,10,37,47
97,8478469,Thomas Chabot,D,OTT,27,82,10,37,47
97,8477953,Kasperi Kapanen,R,STL,28,82,10,37,47
97,8478458,Jack Roslovic,C,CAR,27,82,8,39,47
97,8479525,Ross Colton,C,COL,28,82,24,22,46
97,8478401,Pavel Zacha,C,BOS,27,82,19,27,46
97,8482109,Alexis Lafrenière,L,NYR,23,82,19,27,46
97,8475193,Tomas Tatar,L,NJD,34,82,12,34,46
97,8478397,Rasmus Andersson,D,CGY,28,82,10,36,46
97,8482105,Jake Sanderson,D,OTT,22,82,9,37,46
97,8481542,Moritz Seider,D,DET,23,82,8,38,46
97,8475799,Nino Niederreiter,R,WPG,32,82,27,18,45
97,8478542,Evan Rodrigues,C,FLA,31,82,21,24,45
97,8482705,Cole Sillinger,C,CBJ,21,82,20,25,45
97,8476458,Ryan Strome,C,ANA,31,82,19,26,45
97,8476480,Vladislav Namestnikov,C,WPG,32,82,16,29,45
97,8471698,T.J. Oshie,R,WSH,38,82,15,30,45
97,8474150,Mikael Backlund,C,CGY,35,82,15,30,45
97,8476917,Adam Pelech,D,NYI,30,82,8,37,45
97,8475314,Anders Lee,L,NYI,34,82,26,18,44
97,8482699,Dylan Guenther,R,UTA,21,82,23,21,44
97,8482667,William Eklund,L,SJS,22,82,22,22,44
97,8479365,Trent Frederic,C,BOS,26,82,22,22,44
97,8475151,Kyle Palmieri,C,NYI,33,82,21,23,44
97,8478046,Danton Heinen,L,VAN,29,82,21,23,44
97,8481535,Nils Hoglander,L,VAN,24,82,21,23,44
97,8475760,Nick Bjugstad,C,UTA,32,82,23,20,43
97,8477426,Nicholas Paul,L,TBL,29,82,22,21,43
97,8475287,Erik Haula,L,NJD,33,82,22,21,43
97,8478020,Michael Amadio,C,OTT,28,82,21,22,43
97,8477451,Ryan Hartman,R,MIN,30,82,20,23,43
97,8482097,Jack Quinn,R,BUF,23,82,20,23,43
97,8480849,Barrett Hayton,C,UTA,24,82,20,23,43
97,8475848,Brendan Gallagher,R,MTL,32,82,20,23,43
97,8480015,Owen Tippett,R,PHI,25,82,18,25,43
97,8480871,Adam Boqvist,D,FLA,24,82,14,29,43
97,8481581,Thomas Harley,D,DAL,23,82,14,29,43
97,8479345,Jakob Chychrun,D,WSH,26,82,12,31,43
97,8475200,Dmitry Orlov,D,CAR,33,82,10,33,43
97,8477947,Sonny Milano,L,WSH,28,82,26,16,42
97,8478462,Nicolas Roy,C,VGK,27,82,21,21,42
97,8480113,Alex Iafallo,L,WPG,31,82,19,23,42
97,8482660,Kent Johnson,C,CBJ,22,82,17,25,42
97,8477498,Darnell Nurse,D,EDM,29,82,14,28,42
97,8482092,Ridly Greig,C,OTT,22,82,14,28,42
97,8475149,Marcus Johansson,L,MIN,34,82,14,28,42
97,8477964,Ivan Barbashev,C,VGK,29,82,13,29,42
97,8481606,Jordan Spence,D,LAK,23,82,11,31,42
97,8481546,Cam York,D,PHI,23,82,8,34,42
97,8479316,Luke Kunin,C,SJS,27,82,23,18,41
97,8480835,Jack Drury,C,CAR,24,82,18,23,41
97,8474053,Logan Couture,C,SJS,35,82,16,25,41
97,8480748,Kiefer Sherwood,L,VAN,29,82,15,26,41
97,8475791,Taylor Hall,L,CHI,33,82,14,27,41
97,8474716,Jared Spurgeon,D,MIN,35,82,14,27,41
97,8477952,Robby Fabbri,C,ANA,28,82,25,15,40
97,8479293,Brandon Tanev,L,SEA,33,82,22,18,40
97,8482110,Dawson Mercer,C,NJD,23,82,20,20,40
97,8477429,Andrew Copp,C,DET,30,82,13,27,40
97,8475218,Mattias Ekholm,D,EDM,34,82,12,28,40
97,8476869,Brady Skjei,D,NSH,30,82,10,30,40
97,8476854,Hampus Lindholm,D,BOS,30,82,10,30,40
97,8478115,Pierre Engvall,L,NYI,28,82,20,19,39
97,8475722,Jason Zucker,L,BUF,32,82,20,19,39
97,8478366,Frank Vatrano,R,ANA,30,82,19,20,39
97,8479941,Justin Danforth,R,CBJ,31,82,19,20,39
97,8476981,Josh Anderson,R,MTL,30,82,18,21,39
97,8480185,Eetu Luostarinen,C,FLA,26,82,11,28,39
97,8475764,Cam Fowler,D,ANA,33,82,6,33,39
97,8480459,Pius Suter,C,VAN,28,82,24,14,38
97,8481554,Kaapo Kakko,R,NYR,23,82,21,17,38
97,8479996,Cody Glass,C,NSH,25,82,20,18,38
97,8480188,Fabian Zetterlund,L,SJS,25,82,15,23,38
97,8476392,Adam Lowry,C,WPG,31,82,14,24,38
97,8477495,Seth Jones,D,CHI,30,82,10,28,38
97,8481032,Paul Cotter,C,NJD,25,82,21,16,37
97,8481604,Pavel Dorofeyev,L,VGK,24,82,20,17,37
97,8482055,Drew O'Connor,L,PIT,26,82,16,21,37
97,8476873,Mark Jankowski,C,NSH,30,82,15,22,37
97,8481618,Alex Newhook,C,MTL,23,82,14,23,37
97,8476927,Teddy Blueger,C,VAN,30,82,13,24,37
97,8478472,Mathieu Joseph,R,STL,27,82,12,25,37
97,8477444,Andre Burakovsky,L,SEA,29,82,15,21,36
97,8482475,Yegor Chinakhov,R,CBJ,23,82,13,23,36
97,8483431,Logan Cooley,C,UTA,20,82,22,13,35
97,8478413,Jordan Greenway,L,BUF,27,82,20,15,35
97,8473422,Nick Foligno,L,CHI,37,82,18,17,35
97,8481560,Arthur Kaliyev,R,LAK,23,82,13,22,35
97,8475855,Jesper Fast,R,CAR,33,82,13,22,35
97,8476958,Jaccob Slavin,D,CAR,30,82,8,27,35
97,8480817,K'Andre Miller,D,NYR,24,82,8,27,35
97,8475171,Oliver Ekman-Larsson,D,TOR,33,82,6,29,35
97,8476923,Damon Severson,D,CBJ,30,82,5,30,35
97,8481582,Nicholas Robertson,L,TOR,23,82,21,13,34
97,8482175,JJ Peterka,R,BUF,22,82,20,14,34
97,8476474,Stefan Noesen,R,NJD,31,82,20,14,34
97,8480009,Eeli Tolvanen,R,SEA,25,82,19,15,34
97,8481186,Logan O'Connor,R,COL,28,82,15,19,34
97,8473563,Nicklas Backstrom,C,WSH,37,82,15,19,34
97,8476925,Colton Sissons,C,NSH,31,82,12,22,34
97,8476329,Travis Boyd,C,MIN,31,82,10,24,34
97,8478891,Mason Appleton,C,WPG,28,82,9,25,34
97,8476525,Colin Miller,D,WPG,32,82,4,30,34
97,8482089,Jake Neighbours,L,STL,22,82,22,11,33
97,8480893,Kirill Marchenko,R,CBJ,24,82,19,14,33
97,8473533,Jordan Staal,C,CAR,36,82,17,16,33
97,8483808,Andrei Kuzmenko,L,CGY,28,82,16,17,33
97,8482117,Lukas Reichel,L,CHI,22,82,16,17,33
97,8470621,Corey Perry,R,EDM,39,82,15,18,33
97,8480003,Jesper Boqvist,C,FLA,26,82,12,21,33
97,8477948,Travis Sanheim,D,PHI,28,82,9,24,33
97,8477969,Marcus Pettersson,D,PIT,28,82,5,28,33
97,8480043,Timothy Liljegren,D,TOR,25,82,4,29,33
97,8481093,Rafael Harvey-Pinard,L,MTL,25,82,15,17,32
97,8479353,Brett Howden,C,VGK,26,82,9,23,32
97,8477507,Nikita Zadorov,D,BOS,29,82,8,24,32
97,8476979,Erik Gustafsson,D,DET,32,82,2,30,32
97,8477450,Jason Dickinson,C,CHI,29,82,18,13,31
97,8476921,Jordan Martinook,L,CAR,32,82,16,15,31
97,8478133,Jake Evans,C,MTL,28,82,15,16,31
97,8479390,Taylor Raddysh,R,WSH,26,82,14,17,31
97,8482146,Luke Evangelista,R,NSH,22,82,14,17,31
97,8477839,Conor Sheary,L,TBL,32,82,14,17,31
97,8476889,Radek Faksa,C,STL,30,82,12,19,31
97,8482671,Owen Power,D,BUF,22,82,9,22,31
97,8476902,Esa Lindell,D,DAL,30,82,9,22,31
97,8475220,Marcus Foligno,L,MIN,33,82,8,23,31
97,8476624,Barclay Goodrow,C,SJS,31,82,8,23,31
97,8481178,Egor Zamula,D,PHI,24,82,7,24,31
97,8477220,Nate Schmidt,D,FLA,33,82,6,25,31
97,8477488,Brett Pesce,D,NJD,30,82,5,26,31
97,8478911,Matt Roy,D,WSH,29,82,4,27,31
97,8476463,Jonas Brodin,D,MIN,31,82,3,28,31
97,8480873,Rasmus Sandin,D,WSH,24,82,2,29,31
97,8477506,Ryan Pulock,D,NYI,30,82,2,29,31
97,8479992,Michael Rasmussen,C,DET,25,82,17,13,30
97,8480813,Joe Veleno,C,DET,24,82,17,13,30
97,8474586,Jordan Eberle,R,SEA,34,82,15,15,30
97,8480144,David Kampf,C,TOR,29,82,15,15,30
97,8478463,Anthony Beauvillier,L,PIT,27,82,14,16,30
97,8480802,Ryan McLeod,C,BUF,25,82,14,16,30
97,8480829,Jesperi Kotkaniemi,C,CAR,24,82,13,17,30
97,8480995,Pontus Holmberg,R,TOR,25,82,13,17,30
97,8480220,Noah Cates,L,PHI,25,82,12,18,30
97,8480074,Alexandre Texier,C,STL,25,82,12,18,30
97,8482666,Scott Morrow,D,CAR,22,82,11,19,30
97,8479368,Max Jones,L,BOS,26,82,10,20,30
97,8474151,Ryan McDonagh,D,TBL,35,82,5,25,30
97,8482077,Dylan Holloway,L,EDM,23,82,18,11,29
97,8480789,Oliver Wahlstrom,R,NYI,24,82,15,14,29
97,8479393,Noah Gregor,C,OTT,26,82,15,14,29
97,8479661,Tanner Jeannot,L,LAK,27,82,13,16,29
97,8476885,Jacob Trouba,D,NYR,30,82,12,17,29
97,8476278,Colin Blackwell,C,DAL,31,82,12,17,29
97,8481013,Jonatan Berggren,R,DET,24,82,11,18,29
97,8475279,Ben Chiarot,D,DET,33,82,11,18,29
97,8476461,Sean Couturier,C,PHI,32,82,7,22,29
97,8482624,Daniil Miromanov,D,CGY,27,82,7,22,29
97,8482087,Kaiden Guhle,D,MTL,22,82,5,24,29
97,8479351,Sam Steel,C,DAL,26,82,5,24,29
97,8475231,Casey Cizikas,C,NYI,33,82,15,13,28
97,8480336,Sean Walker,D,CAR,30,82,13,15,28
97,8479987,Morgan Geekie,C,BOS,26,82,13,15,28
97,8481553,Bobby Brink,R,PHI,23,82,12,16,28
97,8480806,Isac Lundestrom,C,ANA,25,82,12,16,28
97,8480855,Jack McBain,C,UTA,24,82,11,17,28
97,8479983,Mario Ferraro,D,SJS,26,82,11,17,28
97,8476879,Cody Ceci,D,EDM,31,82,9,19,28
97,8480878,Nils Lundkvist,D,DAL,24,82,8,20,28
97,8482073,Braden Schneider,D,NYR,23,82,6,22,28
97,8477369,Carson Soucy,D,VAN,30,82,6,22,28
97,8481014,Alexander Romanov,D,NYI,24,82,3,25,28
97,8479591,Michael Eyssimont,C,TBL,28,82,15,12,27
97,8479414,Nathan Bastian,R,NJD,27,82,15,12,27
97,8484153,Leo Carlsson,C,ANA,20,82,13,14,27
97,8476918,Jimmy Vesey,L,NYR,31,82,12,15,27
97,8478882,Vladislav Gavrikov,D,LAK,29,82,10,17,27
97,8482807,Ethan Del Mastro,D,CHI,21,82,9,18,27
97,8484203,Bradly Nadeau,L,CAR,19,82,8,19,27
97,8476467,Jamie Oleksiak,D,SEA,32,82,7,20,27
97,8483445,Cutter Gauthier,L,ANA,20,82,6,21,27
97,8476892,Colton Parayko,D,STL,31,82,5,22,27
97,8477425,Miles Wood,L,COL,29,82,17,9,26
97,8476442,Matt Nieto,L,PIT,32,82,16,10,26
97,8481624,Ilya Mikheyev,R,CHI,30,82,13,13,26
97,8483763,Maksymilian Szuber,D,UTA,22,82,13,13,26
97,8476457,Adam Larsson,D,SEA,32,82,8,18,26
97,8474189,Lars Eller,C,PIT,35,82,7,19,26
97,8479976,Juuso Valimaki,D,UTA,26,82,6,20,26
97,8482245,Artem Zub,D,OTT,29,82,6,20,26
97,8483457,Lane Hutson,D,MTL,20,82,6,20,26
97,8483490,Pavel Mintyukov,D,ANA,21,82,5,21,26
97,8479998,Mikey Anderson,D,LAK,25,82,4,22,26
97,8481517,Brett Leason,R,ANA,25,82,3,23,26
97,8479398,Samuel Girard,D,COL,26,82,2,24,26
97,8478840,Will Borgen,D,SEA,28,82,2,24,26
97,8481601,Simon Holmstrom,R,NYI,23,82,16,9,25
97,8478508,Yakov Trenin,C,MIN,27,82,16,9,25
97,8476469,Joel Armia,R,MTL,31,82,16,9,25
97,8480068,Ryan Poehling,C,PHI,25,82,15,10,25
97,8474715,Cam Atkinson,R,TBL,35,82,13,12,25
97,8482111,Justin Barron,D,MTL,23,82,12,13,25
97,8477987,Ryan Donato,C,CHI,28,82,9,16,25
97,8476960,Andreas Athanasiou,C,CHI,30,82,9,16,25
97,8482155,Alex Laferriere,R,LAK,23,82,9,16,25
97,8477435,Ryan Graves,D,PIT,29,82,6,19,25
97,8483505,Matthew Poitras,C,BOS,20,82,6,19,25
97,8480246,Nick Perbix,D,TBL,26,82,6,19,25
97,8482142,Jamie Drysdale,D,PHI,22,82,4,21,25
97,8482079,Marco Rossi,C,MIN,23,82,14,10,24
97,8482166,Shakir Mukhamadullin,D,SJS,22,82,13,11,24
97,8481580,Connor McMichael,C,WSH,23,82,11,13,24
97,8482062,Cole Smith,L,NSH,29,82,9,15,24
97,8482803,Olen Zellweger,D,ANA,21,82,7,17,24
97,8482133,Thomas Bordeleau,C,SJS,22,82,6,18,24
97,8480990,Declan Chisholm,D,MIN,24,82,6,18,24
97,8480222,Sebastian Aho,D,PIT,28,82,5,19,24
97,8481568,Alex Vlasic,D,CHI,23,82,3,21,24
97,8475790,Erik Gudbranson,D,CBJ,32,82,2,22,24
97,8478859,Niko Mikkola,D,FLA,28,82,2,22,24
97,8479371,Dante Fabbro,D,NSH,26,82,2,22,24
97,8478507,John Marino,D,UTA,27,82,1,23,24
97,8475233,David Savard,D,MTL,34,82,1,23,24
97,8475181,Nick Leddy,D,STL,33,82,1,23,24
97,8482749,Joshua Roy,R,MTL,21,82,15,8,23
97,8482259,Bobby McMann,C,TOR,28,82,14,9,23
97,8481028,Martin Pospisil,C,CGY,25,82,13,10,23
97,8477903,Garnet Hathaway,R,PHI,33,82,13,10,23
97,8479291,Kevin Rooney,C,CGY,31,82,13,10,23
97,8478569,Noel Acciari,C,PIT,33,82,12,11,23
97,8480025,MacKenzie Entwistle,R,FLA,25,82,10,13,23
97,8477989,Christian Dvorak,C,MTL,28,82,9,14,23
97,8483524,Shane Wright,C,SEA,20,82,9,14,23
97,8484166,Adam Fantilli,C,CBJ,20,82,4,19,23
97,8474574,Tyler Myers,D,VAN,34,82,3,20,23
97,8475188,Brayden McNabb,D,VGK,33,82,3,20,23
97,8476331,Dylan DeMelo,D,WPG,31,82,3,20,23
97,8482125,Alexander Holtz,R,VGK,22,82,12,10,22
97,8476878,Zemgus Girgensons,L,TBL,30,82,12,10,22
97,8477931,Tomas Nosek,L,FLA,32,82,11,11,22
97,8475343,Nic Dowd,C,WSH,34,82,9,13,22
97,8483012,Logan Morrison,C,SEA,22,82,7,15,22
97,8477499,Rasmus Ristolainen,D,PHI,30,82,5,17,22
97,8474673,TJ Brodie,D,CHI,34,82,5,17,22
97,8473507,Jeff Petry,D,DET,37,82,4,18,22
97,8483495,Simon Nemec,D,NJD,20,82,4,18,22
97,8481477,Nico Sturm,C,SJS,29,82,13,8,21
97,8482074,Connor Zary,C,CGY,23,82,12,9,21
97,8481704,Juuso Parssinen,C,NSH,23,82,9,12,21
97,8477392,Hudson Fasching,R,NYI,29,82,9,12,21
97,8479402,Jake Bean,D,CGY,26,82,9,12,21
97,8481524,Bowen Byram,D,BUF,23,82,9,12,21
97,8482122,Brock Faber,D,MIN,22,82,7,14,21
97,8475462,Radko Gudas,D,ANA,34,82,6,15,21
97,8483565,Nick Blankenburg,D,NSH,26,82,6,15,21
97,8481522,Peyton Krebs,C,BUF,23,82,5,16,21
97,8479980,Nicolas Hague,D,VGK,26,82,4,17,21
97,8482470,Ilya Solovyov,D,CGY,24,82,4,17,21
97,8475455,Brenden Dillon,D,NJD,34,82,3,18,21
97,8478500,Ivan Provorov,D,CBJ,27,82,2,19,21
97,8475324,Nick Jensen,D,OTT,34,82,2,19,21
97,8480879,Jacob Bernard-Docker,D,OTT,24,82,2,19,21
97,8477508,Curtis Lazar,C,NJD,29,82,11,9,20
97,8477406,Mattias Janmark,C,EDM,32,82,8,12,20
97,8482809,Jackson Blake,R,CAR,21,82,8,12,20
97,8482141,Lukas Cormier,D,VGK,22,82,7,13,20
97,8481481,Blake Lizotte,C,PIT,27,82,6,14,20
97,8477919,Frederick Gaudreau,C,MIN,31,82,4,16,20
97,8476422,Mike Reilly,D,NYI,31,82,4,16,20
97,8477938,Haydn Fleury,D,WPG,28,82,4,16,20
97,8480073,Erik Brannstrom,D,COL,25,82,4,16,20
97,8477034,Jaycob Megna,D,FLA,32,82,4,16,20
97,8484911,Collin Graf,R,SJS,22,82,4,16,20
97,8474567,Zach Bogosian,D,MIN,34,82,3,17,20
97,8483499,Liam Ohgren,L,MIN,20,82,3,17,20
97,8479369,Andrew Peeke,D,BOS,26,82,3,17,20
97,8477845,Trevor van Riemsdyk,D,WSH,33,82,0,20,20
97,8476897,Oskar Sundqvist,C,STL,30,82,11,8,19
97,8482733,Logan Mailloux,D,MTL,31,82,10,9,19
97,8476858,Phillip Di Giuseppe,L,VAN,31,82,10,9,19
97,8483482,Tristan Luneau,D,ANA,20,82,9,10,19
97,8478136,Jake Middleton,D,MIN,28,82,5,14,19
97,8482118,Sam Colangelo,R,ANA,23,82,4,15,19
97,8476429,Scott Mayfield,D,NYI,32,82,3,16,19
97,8481708,Zac Jones,D,NYR,24,82,3,16,19
97,8483468,Jiri Kulich,C,BUF,20,82,3,16,19
97,8477365,Connor Clifton,D,BUF,29,82,2,17,19
97,8476891,Matt Grzelcyk,D,PIT,30,82,2,17,19
97,8477335,Kyle Burroughs,D,LAK,29,82,2,17,19
97,8474013,Ian Cole,D,UTA,35,82,0,19,19
97,8480021,Jack Studnicka,C,LAK,25,82,12,6,18
97,8480980,Connor Dewar,C,TOR,25,82,8,10,18
97,8482516,Matthew Kessel,D,STL,24,82,8,10,18
97,8474090,Brendan Smith,D,DAL,35,82,7,11,18
97,8481122,Simon Benoit,D,TOR,26,82,5,13,18
97,8480049,Dylan Samberg,D,WPG,25,82,3,15,18
97,8481567,Henry Thrun,D,SJS,23,82,2,16,18
97,8475762,Derek Forbort,D,VAN,32,82,2,16,18
97,8481641,Joel Kiviranta,L,COL,28,82,12,5,17
97,8477353,Tyler Motte,C,DET,29,82,8,9,17
97,8478851,Alexandre Carrier,D,NSH,28,82,6,11,17
97,8478013,Jake Walman,D,SJS,28,82,6,11,17
97,8475690,Chris Tanev,D,TOR,35,82,3,14,17
97,8478416,Erik Cernak,D,TBL,27,82,3,14,17
97,8478178,Darren Raddysh,D,TBL,28,82,3,14,17
97,8470600,Ryan Suter,D,STL,39,82,3,14,17
97,8480172,Jan Rutta,D,SJS,34,82,2,15,17
97,8478399,Jonas Siegenthaler,D,NJD,27,82,2,15,17
97,8475718,Justin Holl,D,DET,32,82,2,15,17
97,8482679,Matt Coronato,R,CGY,22,82,8,8,16
97,8479359,Beck Malenstyn,L,BUF,26,82,8,8,16
97,8478434,Keegan Kolesar,R,VGK,27,82,5,11,16
97,8476312,Josh Manson,D,COL,33,82,4,12,16
97,8482858,Ryker Evans,D,SEA,23,82,4,12,16
97,8480834,Ty Emberson,D,SJS,24,82,4,12,16
97,8474612,Travis Hamonic,D,OTT,34,82,2,14,16
97,8480807,Mattias Samuelsson,D,BUF,24,82,1,15,16
97,8476441,Joel Edmundson,D,LAK,31,82,1,15,16
97,8480281,Alexey Toropchenko,R,STL,25,82,10,5,15
97,8480448,Parker Kelly,L,COL,25,82,9,6,15
97,8477505,Alexander Wennberg,C,SJS,30,82,9,6,15
97,8484149,Gavin Brindley,C,CBJ,20,82,8,7,15
97,8482702,Logan Stankoven,C,DAL,21,82,8,7,15
97,8482762,Simon Edvinsson,D,DET,21,82,7,8,15
97,8482712,Oskar Olausson,R,COL,22,82,7,8,15
97,8479442,Troy Stecher,D,EDM,30,82,4,11,15
97,8476372,Nick Seeler,D,PHI,31,82,3,12,15
97,8481699,Aku Raty,R,UTA,23,82,3,12,15
97,8477015,Connor Brown,R,EDM,30,82,12,2,14
97,8483397,Marc McLaughlin,C,BOS,25,82,6,8,14
97,8478211,Dryden Hunt,L,CGY,29,82,5,9,14
97,8482101,Danil Gushchin,L,SJS,22,82,5,9,14
97,8484145,Zach Benson,L,BUF,19,82,5,9,14
97,8476374,Sean Kuraly,C,CBJ,31,82,4,10,14
97,8480796,Martin Fehervary,D,WSH,25,82,4,10,14
97,8475177,Calvin de Haan,D,COL,33,82,3,11,14
97,8480950,Ilya Lyubushkin,D,DAL,30,82,2,12,14
97,8476967,Brett Kulak,D,EDM,30,82,1,13,14
97,8480035,Henri Jokiharju,D,BUF,25,82,1,13,14
97,8475842,Sam Carrick,C,NYR,32,82,9,4,13
97,8479638,Justin Brazeau,R,BOS,26,82,8,5,13
97,8473453,Trevor Lewis,C,LAK,37,82,5,8,13
97,8482153,Brendan Brisson,C,VGK,23,82,5,8,13
97,8479324,Ryan Lindgren,D,NYR,26,82,3,10,13
97,8478432,Christian Fischer,R,DET,27,82,3,10,13
97,8476822,Luke Glendening,C,TBL,35,82,3,10,13
97,8478443,Brandon Carlo,D,BOS,28,82,3,10,13
97,8482655,J.J. Moser,D,TBL,24,82,2,11,13
97,8482659,Josh Doan,R,UTA,22,82,7,5,12
97,8476473,Connor Murphy,D,CHI,31,82,2,10,12
97,8483471,Brad Lambert,C,WPG,31,82,8,3,11
97,8482070,Mitchell Chaffee,R,TBL,26,82,5,6,11
97,8482713,Mackie Samoskevich,R,FLA,22,82,4,7,11
97,8479576,Vincent Desharnais,D,VAN,28,82,2,9,11
97,8483489,Fraser Minten,C,TOR,31,82,4,6,10
97,8482859,Zack Ostapchuk,C,OTT,21,82,4,6,10
97,8480860,Kevin Bahl,D,CGY,24,82,3,7,10
97,8482145,Mavrik Bourque,C,DAL,22,82,3,7,10
97,8478450,Parker Wotherspoon,D,BOS,27,82,2,8,10
97,8483493,Frank Nazar,C,CHI,20,82,5,4,9
97,8483466,Kevin Korchinski,D,CHI,20,82,2,7,9
97,8481605,Jackson LaCombe,D,ANA,23,82,1,8,9
97,8478468,Jeremy Lauzon,D,NSH,27,82,0,9,9
97,8483567,Georgii Merkulov,C,BOS,24,82,2,6,8
97,8474062,Riley Nash,C,NYR,35,82,1,7,8
97,8480870,Bo Groulx,C,NYR,24,82,5,2,7
97,8483460,David Jiricek,D,CBJ,21,82,2,5,7
97,8482787,Nikita Chibrikov,R,WPG,31,82,2,4,6
97,8478874,Adam Gaudette,C,OTT,28,82,0,4,4
97,8471677,Jack Johnson,D,CBJ,37,82,1,2,3
97,8470794,Joe Pavelski,C,,40,0,0,0,0
97,8481703,Valtteri Puustinen,R,PIT,25,0,0,0,0
97,8477950,Tony DeAngelo,D,,29,0,0,0,0
97,8481577,Philip Tomasino,C,NSH,23,0,0,0,0
97,8475197,Tyson Barrie,D,,33,0,0,0,0
97,8471218,Blake Wheeler,R,,38,0,0,0,0
97,8474157,Max Pacioretty,L,,36,0,0,0,0
97,8478466,Daniel Sprong,R,VAN,27,0,0,0,0
97,8475744,Evgeny Kuznetsov,C,,32,0,0,0,0
97,8481019,David Gustafsson,C,WPG,24,0,0,0,0
97,8475906,John Klingberg,D,,32,0,0,0,0
97,8479348,Kale Clague,D,BUF,26,0,0,0,0
97,8476952,Dominic Toninato,C,WPG,30,0,0,0,0
97,8473473,Milan Lucic,L,,36,0,0,0,0
97,8474037,James van Riemsdyk,L,,35,0,0,0,0
97,8474602,Justin Schultz,D,,34,0,0,0,0
97,8482222,Alexander Barabanov,L,,30,0,0,0,0
97,8479372,Josh Mahura,D,SEA,26,0,0,0,0
97,8479982,Conor Timmins,D,TOR,26,0,0,0,0
97,8474031,Kevin Shattenkirk,D,,35,0,0,0,0
97,8480008,Adam Ruzicka,C,,25,0,0,0,0
97,8481059,Scott Perunovich,D,STL,26,0,0,0,0
97,8480884,Calen Addison,D,,24,0,0,0,0
97,8476994,Vinnie Hinostroza,C,NSH,30,0,0,0,0
97,8478452,Caleb Jones,D,LAK,27,0,0,0,0
97,8480157,Calle Rosen,D,COL,30,0,0,0,0
97,8481609,Vladislav Kolyachonok,D,UTA,23,0,0,0,0
97,8479415,Michael McLeod,C,,26,0,0,0,0
97,8476919,Chris Tierney,C,,30,0,0,0,0
97,8479639,Dylan Coghlan,D,WPG,26,0,0,0,0
97,8478146,Matthew Highmore,C,OTT,28,0,0,0,0
97,8478970,Jalen Chatfield,D,CAR,28,0,0,0,0
97,8480205,Emil Bemstrom,C,PIT,25,0,0,0,0
97,8474884,Mike Hoffman,C,,35,0,0,0,0
97,8471274,Alex Goligoski,D,,39,0,0,0,0
97,8478104,Sammy Blais,L,,28,0,0,0,0
97,8474870,Tyler Johnson,C,,34,0,0,0,0
97,8476913,Devin Shore,C,MIN,30,0,0,0,0
97,8481598,Philip Broberg,D,EDM,23,0,0,0,0
97,8480058,Pierre-Olivier Joseph,D,STL,25,0,0,0,0
97,8480891,Michael Kesselring,D,UTA,24,0,0,0,0
97,8477979,Nicolas Aube-Kubel,R,BUF,28,0,0,0,0
97,8476871,Tanner Pearson,L,,32,0,0,0,0
97,8476393,Nick Cousins,C,,31,0,0,0,0
97,8479977,Kailer Yamamoto,R,,26,0,0,0,0
97,8479543,Michael Pezzetta,L,MTL,26,0,0,0,0
97,8477018,Ben Hutton,D,VGK,31,0,0,0,0
97,8480762,Eric Robinson,L,CAR,29,0,0,0,0
97,8474034,Pat Maroon,L,CHI,36,0,0,0,0
97,8481058,Jesse Ylönen,R,,25,0,0,0,0
97,8475179,Dmitry Kulikov,D,FLA,34,0,0,0,0
97,8481527,Kaedan Korczak,D,VGK,23,0,0,0,0
97,8473449,Kyle Okposo,R,,36,0,0,0,0
97,8482192,Isaak Phillips,D,CHI,23,0,0,0,0
97,8480727,Zach Whitecloud,D,VGK,28,0,0,0,0
97,8479346,Dillon Dube,C,,26,0,0,0,0
97,8480821,Filip Zadina,R,,25,0,0,0,0
97,8480001,Urho Vaakanainen,D,ANA,25,0,0,0,0
97,8470966,Mark Giordano,D,,41,0,0,0,0
97,8480853,Liam Foudy,C,,24,0,0,0,0
97,8475225,Craig Smith,C,CHI,35,0,0,0,0
97,8479972,Mason Shaw,C,WPG,26,0,0,0,0
97,8478451,Ethan Bear,D,WSH,27,0,0,0,0
97,8474040,Sam Gagner,C,,35,0,0,0,0
97,8480196,Jacob Bryson,D,BUF,27,0,0,0,0
97,8479984,Cal Foote,D,,26,0,0,0,0
97,8480011,Klim Kostin,C,SJS,25,0,0,0,0
97,8482176,Wyatt Kaiser,D,CHI,22,0,0,0,0
97,8476988,Matt Benning,D,SJS,30,0,0,0,0
97,8479370,Tyson Jost,C,CAR,26,0,0,0,0
97,8477464,Nic Petan,C,,29,0,0,0,0
97,8477380,Jonny Brodzinski,C,NYR,31,0,0,0,0
97,8480070,Ian Mitchell,D,BOS,25,0,0,0,0
97,8479315,Joey Anderson,R,CHI,26,0,0,0,0
97,8478099,Kevin Labanc,R,,29,0,0,0,0
97,8476874,Olli Maatta,D,DET,30,0,0,0,0
97,8475208,Brian Dumoulin,D,ANA,33,0,0,0,0
97,8478430,Oliver Kylington,D,,27,0,0,0,0
97,8479536,Axel Jonsson-Fjallby,L,WPG,26,0,0,0,0
97,8479671,Mathieu Olivier,R,CBJ,27,0,0,0,0
97,8471709,Marc-Edouard Vlasic,D,SJS,37,0,0,0,0
97,8479328,Julien Gauthier,R,NYI,27,0,0,0,0
97,8478421,A.J. Greer,L,FLA,28,0,0,0,0
97,8477573,Nathan Walker,L,STL,30,0,0,0,0
97,8481537,Nikita Okhotiuk,D,CGY,24,0,0,0,0
97,8474166,Alec Martinez,D,CHI,37,0,0,0,0
97,8470610,Zach Parise,L,,40,0,0,0,0
97,8477478,William Carrier,L,CAR,30,0,0,0,0
97,8479344,Jesse Puljujarvi,R,PIT,26,0,0,0,0
97,8480887,Jordan Harris,D,MTL,24,0,0,0,0
97,8478502,Dennis Gilbert,D,BUF,28,0,0,0,0
97,8482730,Brandt Clarke,D,LAK,21,0,0,0,0
97,8480355,Mark Kastelic,C,BOS,25,0,0,0,0
97,8475750,Jon Merrill,D,MIN,32,0,0,0,0
97,8475164,Jakob Silfverberg,R,,34,0,0,0,0
97,8477944,Jakub Vrana,L,,28,0,0,0,0
97,8479439,Jacob MacDonald,D,COL,31,0,0,0,0
97,8474568,Luke Schenn,D,NSH,35,0,0,0,0
97,8478454,Noah Juulsen,D,VAN,27,0,0,0,0
97,8475752,Tyler Pitlick,C,,33,0,0,0,0
97,8482148,Hendrix Lapierre,C,WSH,22,0,0,0,0
97,8481167,Brayden Pachal,D,CGY,25,0,0,0,0
97,8478043,Sam Lafferty,C,BUF,29,0,0,0,0
97,8479321,Lucas Johansen,D,,27,0,0,0,0
97,8471699,Andrew Cogliano,C,,37,0,0,0,0
97,8481521,Ronnie Attard,D,PHI,25,0,0,0,0
97,8481161,Jake Christiansen,D,CBJ,25,0,0,0,0
97,8479458,Nikita Zaitsev,D,,33,0,0,0,0
97,8479619,Michael Carcone,L,UTA,28,0,0,0,0
97,8479026,Philippe Myers,D,TOR,27,0,0,0,0
97,8477330,Dominik Kubalik,L,,29,0,0,0,0
97,8481617,Vasily Podkolzin,R,VAN,23,0,0,0,0
97,8481701,Santeri Hatakka,D,NJD,23,0,0,0,0
97,8479514,Rem Pitlick,C,,27,0,0,0,0
97,8477446,Michael McCarron,R,NSH,29,0,0,0,0
97,8470604,Jeff Carter,C,,39,0,0,0,0
97,8482241,Radim Zohorna,L,,28,0,0,0,0
97,8480289,Morgan Barron,C,WPG,26,0,0,0,0
97,8479379,Givani Smith,R,SJS,26,0,0,0,0
97,8480216,Jacob Peterson,C,,25,0,0,0,0
97,8477851,Jordan Oesterle,D,BOS,32,0,0,0,0
97,8484258,Sam Malinski,D,COL,26,0,0,0,0
97,8478904,Steven Lorentz,C,,28,0,0,0,0
97,8482095,Tyler Kleven,D,OTT,22,0,0,0,0
97,8480848,Ty Dellandrea,C,SJS,24,0,0,0,0
97,8476884,Derrick Pouliot,D,,30,0,0,0,0
97,8479336,Carl Grundstrom,R,SJS,27,0,0,0,0
97,8482964,Arber Xhekaj,D,MTL,23,0,0,0,0
97,8471686,Marc Staal,D,,37,0,0,0,0
97,8477887,Patrick Brown,C,BOS,32,0,0,0,0
97,8478495,Denis Gurianov,R,,27,0,0,0,0
97,8473504,Cal Clutterbuck,R,,37,0,0,0,0
97,8481550,Adam Beckman,L,NJD,23,0,0,0,0
97,8480845,Rasmus Kupari,C,WPG,24,0,0,0,0
97,8474009,Nick Bonino,C,,36,0,0,0,0
97,8478585,Derek Ryan,C,EDM,38,0,0,0,0
97,8477962,Brendan Lemieux,L,CAR,28,0,0,0,0
97,8482861,Vincent Iorio,D,WSH,22,0,0,0,0
97,8479378,Logan Stanley,D,WPG,26,0,0,0,0
97,8473446,Erik Johnson,D,PHI,36,0,0,0,0
97,8481743,Marc Del Gaizo,D,NSH,25,0,0,0,0
97,8477384,Josh Brown,D,EDM,30,0,0,0,0
97,8482165,Yan Kuznetsov,D,CGY,22,0,0,0,0
97,8478424,Jansen Harkins,C,ANA,27,0,0,0,0
97,8482144,Jack Thompson,D,SJS,22,0,0,0,0
97,8478512,Austin Czarnik,C,,32,0,0,0,0
97,8477527,Ross Johnston,L,ANA,30,0,0,0,0
97,8479383,Boris Katchouk,L,,26,0,0,0,0
97,8482094,Daemon Hunt,D,MIN,22,0,0,0,0
97,8481719,Maxwell Crozier,D,TBL,24,0,0,0,0
97,8480192,Johnathan Kovacevic,D,NJD,27,0,0,0,0
97,8479376,Victor Mete,D,,26,0,0,0,0
97,8482511,Mason Lohrei,D,BOS,23,0,0,0,0
97,8475825,Jani Hakanpää,D,,32,0,0,0,0
97,8478021,William Lagesson,D,DET,28,0,0,0,0
97,8475795,Dylan McIlrath,D,WSH,32,0,0,0,0
97,8477846,Ryan Carpenter,C,,33,0,0,0,0
97,8481056,Spencer Stastney,D,NSH,24,0,0,0,0
97,8481564,Ryan Johnson,D,BUF,23,0,0,0,0
97,8478017,Mark Friedman,D,VAN,29,0,0,0,0
97,8479320,Max Lajoie,D,SEA,27,0,0,0,0
97,8480075,Cameron Crotty,D,MIN,25,0,0,0,0
97,8484287,Cole McWard,D,VAN,23,0,0,0,0
97,8484254,Akito Hirose,D,VAN,25,0,0,0,0
97,8483407,Brandon Scanlin,D,NYR,25,0,0,0,0
97,8480274,Philip Kemp,D,EDM,25,0,0,0,0
97,8479522,Hardy Haman Aktell,D,WSH,26,0,0,0,0
97,8480007,Jonas Rondbjerg,R,VGK,25,0,0,0,0
97,8477454,Adam Erne,L,,29,0,0,0,0
97,8481679,Maxence Guenette,D,OTT,23,0,0,0,0
97,8480441,Trey Fix-Wolansky,R,CBJ,25,0,0,0,0
97,8483546,Marshall Rifai,D,TOR,26,0,0,0,0
97,8480084,Nick DeSimone,D,NJD,30,0,0,0,0
97,8481030,Jack St. Ivany,D,PIT,25,0,0,0,0
97,8481592,Jakob Pelletier,L,CGY,23,0,0,0,0
97,8478011,Louie Belpedio,D,PHI,28,0,0,0,0
97,8477930,Pierre-Edouard Bellemare,L,,39,0,0,0,0
97,8484321,Nikolas Matinpalo,D,OTT,26,0,0,0,0
97,8482067,Connor Mackey,D,NYR,28,0,0,0,0
97,8481806,Louis Crevier,D,CHI,23,0,0,0,0
97,8484326,Patrik Koch,D,UTA,28,0,0,0,0
97,8477971,Andreas Englund,D,LAK,28,0,0,0,0
97,8481751,Lukas Rousek,R,BUF,25,0,0,0,0
97,8481006,Tyler Tucker,D,STL,24,0,0,0,0
97,8476867,Brendan Gaunce,C,MIN,30,0,0,0,0
97,8479520,Brandon Duhaime,R,WSH,27,0,0,0,0
97,8477073,Kurtis MacDermid,L,NJD,30,0,0,0,0
97,8480874,Adam Ginning,D,PHI,24,0,0,0,0
97,8477473,Justin Bailey,R,SJS,29,0,0,0,0
97,8479066,Ryan Lomberg,L,CGY,30,0,0,0,0
97,8477070,Liam O'Brien,C,UTA,30,0,0,0,0
97,8474618,Marco Scandella,D,,34,0,0,0,0
97,8475797,Jarred Tinordi,D,,32,0,0,0,0
97,8481441,Joe Snively,C,DET,28,0,0,0,0
97,8477244,Chad Ruhwedel,D,NYR,34,0,0,0,0
97,8479772,Zack MacEwen,R,OTT,28,0,0,0,0
97,8481147,Reese Johnson,C,MIN,26,0,0,0,0
97,8481043,Cole Koepke,L,BOS,26,0,0,0,0
97,8483619,Filip Roos,D,OTT,25,0,0,0,0
97,8481541,Samuel Bolduc,D,NYI,24,0,0,0,0
97,8477810,Joel Hanley,D,CGY,33,0,0,0,0
97,8476907,Mackenzie MacEachern,L,,30,0,0,0,0
97,8482652,Walker Duehr,R,CGY,27,0,0,0,0
97,8477126,Jayson Megna,C,,34,0,0,0,0
97,8483398,Declan Carlile,D,TBL,31,0,0,0,0
97,8482929,Emil Lilleberg,D,TBL,23,0,0,0,0
97,8480880,Jakub Lauko,C,MIN,24,0,0,0,0
97,8480245,Olle Lycksell,R,PHI,25,0,0,0,0
97,8480252,Cole Guttman,C,CHI,25,0,0,0,0
97,8477467,Gustav Olofsson,D,SEA,30,0,0,0,0
97,8479968,Vinni Lettieri,C,BOS,29,0,0,0,0
97,8478400,Colin White,C,,27,0,0,0,0
97,8475755,Alexander Petrovic,D,DAL,32,0,0,0,0
97,8481812,Nikolai Knyzhov,D,,27,0,0,0,0
97,8481593,Jayden Struble,D,MTL,23,0,0,0,0
97,8481532,Alex Turcotte,C,LAK,23,0,0,0,0
97,8482126,Emil Andrae,D,PHI,31,0,0,0,0
97,8479944,Zach Aston-Reese,C,VGK,30,0,0,0,0
97,8471817,Ryan Reaves,R,TOR,37,0,0,0,0
97,8481206,John Ludvig,D,PIT,24,0,0,0,0
97,8481599,Victor Soderstrom,D,UTA,23,0,0,0,0
97,8480292,Carson Meyer,R,ANA,27,0,0,0,0
97,8482496,Nils Aman,C,VAN,24,0,0,0,0
97,8479718,Alex Barré-Boulet,C,MTL,27,0,0,0,0
97,8479994,Jaret Anderson-Dolan,C,WPG,25,0,0,0,0
97,8480184,Gustav Lindstrom,D,,26,0,0,0,0
97,8480890,Jan Jenik,R,OTT,24,0,0,0,0
97,8478067,Oskar Lindblom,L,,28,0,0,0,0
97,8476934,Brock McGinn,L,ANA,30,0,0,0,0
97,8479985,Cale Fleury,D,SEA,26,0,0,0,0
97,8484304,Uvis Balinskis,D,FLA,28,0,0,0,0
97,8479981,Jonah Gadjovich,L,FLA,26,0,0,0,0
97,8481716,Dmitri Voronkov,L,CBJ,24,0,0,0,0
97,8474709,Matt Martin,L,,35,0,0,0,0
97,8482634,Alex Steeves,C,TOR,25,0,0,0,0
97,8480823,Alexander Alexeyev,D,WSH,25,0,0,0,0
97,8477541,Dakota Mermis,D,TOR,30,0,0,0,0
97,8483491,Ivan Miroshnichenko,L,WSH,20,0,0,0,0
97,8478477,Mitchell Stephens,C,SEA,27,0,0,0,0
97,8481543,Nikita Alexandrov,C,STL,24,0,0,0,0
97,8479423,Alex Nylander,L,,26,0,0,0,0
97,8482451,Mikael Pyyhtia,L,CBJ,23,0,0,0,0
97,8478831,Kevin Stenlund,C,UTA,28,0,0,0,0
97,8480306,Grant Hutton,D,NYI,29,0,0,0,0
97,8478028,Fredrik Olofsson,L,,28,0,0,0,0
97,8477462,Robert Hagg,D,VGK,29,0,0,0,0
97,8477320,Anton Blidh,L,NYR,29,0,0,0,0
97,8482157,Will Cuylle,L,NYR,22,0,0,0,0
97,8482737,Zack Bolduc,C,STL,21,0,0,0,0
97,8481239,Samuel Fagemo,L,,24,0,0,0,0
97,8481600,Tobias Bjornfot,D,FLA,23,0,0,0,0
97,8478409,Anthony Richard,C,PHI,28,0,0,0,0
97,8474145,Robert Bortuzzo,D,,35,0,0,0,0
97,8475958,Michael Sgarbossa,C,WSH,32,0,0,0,0
97,8479986,Kole Lind,R,DAL,26,0,0,0,0
97,8479249,Andrew Poturalski,C,SJS,30,0,0,0,0
97,8479362,Riley Tufte,L,BOS,26,0,0,0,0
97,8479991,Jake Leschyshyn,C,NYR,25,0,0,0,0
97,8479587,Rhett Gardner,C,PHI,28,0,0,0,0
97,8482744,James Malatesta,L,CBJ,21,0,0,0,0
97,8478854,Ryan Shea,D,PIT,27,0,0,0,0
97,8481591,Sam Poulin,R,,23,0,0,0,0
97,8483512,Matt Savoie,C,EDM,20,0,0,0,0
97,8482102,Vasily Ponomarev,C,PIT,22,0,0,0,0
97,8482162,Roby Jarventie,L,EDM,22,0,0,0,0
97,8481016,Ruslan Iskhakov,C,,24,0,0,0,0
97,8482172,Landon Slaggert,L,CHI,22,0,0,0,0
97,8482747,Brennan Othmann,L,NYR,21,0,0,0,0
97,8480031,Maxime Comtois,L,,25,0,0,0,0
97,8480226,Marián Studenic,R,,26,0,0,0,0
97,8478408,Travis Dermott,D,,28,0,0,0,0
97,8481518,Nolan Foote,L,NJD,24,0,0,0,0
97,8479419,Brett Murray,L,BUF,26,0,0,0,0
97,8482088,Justin Sourdif,R,FLA,22,0,0,0,0
97,8482201,Gage Goncalves,C,TBL,23,0,0,0,0
97,8481578,Graeme Clarke,R,MIN,23,0,0,0,0
97,8482177,Marat Khusnutdinov,C,MIN,22,0,0,0,0
97,8481754,Nikita Nesterenko,C,ANA,23,0,0,0,0
97,8483531,Brian Halonen,L,NJD,25,0,0,0,0
97,8483920,Pierrick Dube,R,WSH,23,0,0,0,0
97,8480851,Akil Thomas,C,LAK,24,0,0,0,0
97,8475235,Nicolas Deslauriers,L,PHI,33,0,0,0,0
97,8482476,Emil Heineman,L,MTL,23,0,0,0,0
97,8477149,Scott Sabourin,R,SJS,32,0,0,0,0
97,8483549,Lucas Condotta,L,MTL,27,0,0,0,0
97,8482765,Isak Rosen,R,BUF,21,0,0,0,0
97,8481237,Kyle MacLean,C,NYI,25,0,0,0,0
97,8481024,Linus Karlsson,C,VAN,25,0,0,0,0
97,8481690,Tyler Angle,C,,24,0,0,0,0
97,8483570,Ben Meyers,C,SEA,26,0,0,0,0
97,8481655,Cole Schwindt,R,CGY,23,0,0,0,0
97,8481462,Mason Morelli,L,VGK,28,0,0,0,0
97,8483401,Marc Johnstone,R,PIT,28,0,0,0,0
97,8478956,Samuel Laberge,L,NJD,27,0,0,0,0
97,8479533,Joona Koppanen,L,,26,0,0,0,0
97,8482197,Adam Raska,R,MIN,23,0,0,0,0
97,8482250,Callahan Burke,C,VGK,27,0,0,0,0
97,8482784,Zach Dean,C,STL,21,0,0,0,0
97,8484255,Jason Polin,R,COL,25,0,0,0,0
97,8481077,John Leonard,L,,26,0,0,0,0
97,8481534,Raphael Lavoie,C,EDM,24,0,0,0,0
97,8483609,Adam Klapka,R,CGY,24,0,0,0,0
97,8482751,Ryan Winterton,C,SEA,21,0,0,0,0
97,8480267,Sammy Walker,C,MIN,25,0,0,0,0
97,8475766,Austin Watson,L,,32,0,0,0,0
97,8482460,Matt Rempe,C,NYR,22,0,0,0,0
97,8481065,Angus Crookshank,L,OTT,25,0,0,0,0
97,8481070,Hugh McGing,L,,26,0,0,0,0
97,8476323,Max McCormick,L,SEA,32,0,0,0,0
97,8483395,Arshdeep Bains,L,VAN,23,0,0,0,0
97,8484259,Ondrej Pavel,C,COL,31,0,0,0,0
97,8483432,Luca Del Bel Belluz,C,CBJ,31,0,0,0,0
97,8483045,Cameron Butler,R,CBJ,31,0,0,0,0
97,8482061,Brandon Biro,L,SEA,26,0,0,0,0
97,8477401,John Hayden,C,SEA,29,0,0,0,0
97,8475278,Byron Froese,C,,33,0,0,0,0
97,8478446,Glenn Gawdin,C,LAK,27,0,0,0,0
97,8477993,Justin Kirkland,C,CGY,28,0,0,0,0
97,8482147,Jean-Luc Foudy,C,COL,22,0,0,0,0
97,8480032,Shane Bowers,C,NJD,25,0,0,0,0
97,8479330,Brandon Gignac,C,MTL,27,0,0,0,0
97,8480776,Sheldon Rempal,R,,29,0,0,0,0
97,8475413,Justin Dowling,C,NJD,34,0,0,0,0
97,8481726,Adam Edstrom,C,NYR,24,0,0,0,0
97,8480844,Grigori Denisenko,L,VGK,24,0,0,0,0
97,8478147,Bokondji Imama,L,PIT,28,0,0,0,0
97,8478881,Brett Seney,L,CHI,28,0,0,0,0
97,8483630,Pavol Regenda,L,ANA,25,0,0,0,0
97,8480836,Jonathan Gruden,C,,24,0,0,0,0
97,8484314,Jiri Smejkal,L,,28,0,0,0,0
97,8475780,Chris Wagner,R,COL,33,0,0,0,0
97,8479546,Oskar Steen,C,,26,0,0,0,0
97,8483597,Milos Kelemen,L,UTA,25,0,0,0,0
97,8481789,Tye Kartye,L,SEA,23,0,0,0,0
97,8484325,Waltteri Merela,C,TBL,26,0,0,0,0
97,8479421,Jacob Moverare,D,LAK,26,0,0,0,0
97,8481585,Egor Afanasyev,L,SJS,23,0,0,0,0
97,8479547,Matthew Phillips,R,,26,0,0,0,0
97,8479367,William Lockwood,R,FLA,26,0,0,0,0
97,8476915,Jujhar Khaira,L,,30,0,0,0,0
97,8481422,Jacob Lucchini,C,NSH,29,0,0,0,0
97,8480468,James Hamblin,L,EDM,25,0,0,0,0
97,8478051,Max Willman,C,NJD,29,0,0,0,0
97,8481556,John Beecher,C,BOS,23,0,0,0,0
97,8478078,Rourke Chartier,C,,28,0,0,0,0
98,8478402,Connor McDavid,C,EDM,27,82,48,114,162
98,8477956,David Pastrnak,R,BOS,28,82,55,79,134
98,8477492,Nathan MacKinnon,C,COL,29,82,54,80,134
98,8478420,Mikko Rantanen,R,COL,28,82,58,68,126
98,8476453,Nikita Kucherov,R,TBL,31,82,33,84,117
98,8479314,Matthew Tkachuk,L,FLA,27,82,34,81,115
98,8478864,Kirill Kaprizov,L,MIN,27,82,48,65,113
98,8481559,Jack Hughes,C,NJD,23,82,48,64,112
98,8479318,Auston Matthews,C,TOR,27,82,61,50,111
98,8478427,Sebastian Aho,C,CAR,27,82,40,63,103
98,8477493,Aleksander Barkov,C,FLA,29,82,31,69,100
98,8480002,Nico Hischier,C,NJD,25,82,33,64,97
98,8477934,Leon Draisaitl,C,EDM,29,82,41,55,96
98,8480012,Elias Pettersson,C,VAN,26,82,38,58,96
98,8477939,William Nylander,R,TOR,28,82,51,44,95
98,8480027,Jason Robertson,L,DAL,25,82,33,62,95
98,8478445,Mathew Barzal,C,NYI,27,82,33,61,94
98,8476468,J.T. Miller,C,VAN,31,82,31,63,94
98,8474600,Roman Josi,D,NSH,34,82,23,71,94
98,8476389,Vincent Trocheck,C,NYR,31,82,38,55,93
98,8478550,Artemi Panarin,L,NYR,33,82,34,59,93
98,8480830,Andrei Svechnikov,R,CAR,24,82,40,52,92
98,8477933,Sam Reinhart,C,FLA,29,82,46,45,91
98,8475913,Mark Stone,R,VGK,32,82,33,58,91
98,8481557,Matt Boldy,L,MIN,23,82,42,48,90
98,8478398,Kyle Connor,L,WPG,28,82,38,52,90
98,8480069,Cale Makar,D,COL,26,82,26,64,90
98,8480801,Brady Tkachuk,L,OTT,25,82,38,51,89
98,8480800,Quinn Hughes,D,VAN,25,82,11,78,89
98,8477942,Kevin Fiala,L,LAK,28,82,33,54,87
98,8471675,Sidney Crosby,C,PIT,37,82,37,49,86
98,8479343,Clayton Keller,R,UTA,26,82,33,53,86
98,8479323,Adam Fox,D,NYR,26,82,14,72,86
98,8476887,Filip Forsberg,L,NSH,30,82,37,48,85
98,8475172,Nazem Kadri,C,CGY,34,82,27,58,85
98,8480023,Robert Thomas,C,STL,25,82,26,59,85
98,8478460,Zach Werenski,D,CBJ,27,82,18,67,85
98,8471214,Alex Ovechkin,L,WSH,39,82,38,46,84
98,8478449,Roope Hintz,C,DAL,28,82,34,50,84
98,8476346,Johnny Gaudreau,L,CBJ,31,82,20,64,84
98,8482116,Tim Stützle,C,OTT,22,82,30,53,83
98,8477501,Valeri Nichushkin,R,COL,29,82,42,40,82
98,8479407,Jesper Bratt,L,NJD,26,82,21,61,82
98,8471215,Evgeni Malkin,C,PIT,38,82,39,42,81
98,8477409,Carter Verhaeghe,C,FLA,29,82,34,47,81
98,8474564,Steven Stamkos,C,NSH,34,82,32,49,81
98,8477404,Jake Guentzel,C,TBL,30,82,40,40,80
98,8478403,Jack Eichel,C,VGK,28,82,40,40,80
98,8473994,Jamie Benn,L,DAL,35,82,30,50,80
98,8477447,Shea Theodore,D,VGK,29,82,14,65,79
98,8474578,Erik Karlsson,D,PIT,34,82,18,60,78
98,8476881,Tomas Hertl,C,VGK,31,82,35,42,77
98,8482093,Seth Jarvis,C,CAR,22,82,34,43,77
98,8474141,Patrick Kane,R,DET,36,82,23,54,77
98,8481523,Kirby Dach,C,MTL,23,82,18,59,77
98,8475692,Mats Zuccarello,R,MIN,37,82,17,60,77
98,8478414,Timo Meier,R,NJD,28,82,45,30,75
98,8480036,Miro Heiskanen,D,DAL,25,82,13,62,75
98,8475184,Chris Kreider,L,NYR,33,82,49,25,74
98,8477496,Elias Lindholm,C,BOS,30,82,35,39,74
98,8476539,Jonathan Marchessault,R,NSH,34,82,32,42,74
98,8475810,Bryan Rust,R,PIT,32,82,27,47,74
98,8473419,Brad Marchand,L,BOS,36,82,22,52,74
98,8477960,Adrian Kempe,R,LAK,28,82,34,39,73
98,8479420,Tage Thompson,C,BUF,27,82,42,30,72
98,8477402,Pavel Buchnevich,L,STL,29,82,28,44,72
98,8475166,John Tavares,C,TOR,34,82,24,48,72
98,8476454,Ryan Nugent-Hopkins,C,EDM,31,82,24,48,72
98,8476462,Dougie Hamilton,D,NJD,31,82,28,43,71
98,8477955,Jared McCann,L,SEA,28,82,33,37,70
98,8478439,Travis Konecny,R,PHI,27,82,32,38,70
98,8477949,Alex Tuch,R,BUF,28,82,24,46,70
98,8481533,Trevor Zegras,C,ANA,23,82,20,50,70
98,8479325,Charlie McAvoy,D,BOS,27,82,19,51,70
98,8476853,Morgan Rielly,D,TOR,30,82,6,64,70
98,8477946,Dylan Larkin,C,DET,28,82,37,32,69
98,8477500,Bo Horvat,C,NYI,29,82,36,33,69
98,8480018,Nick Suzuki,C,MTL,25,82,29,40,69
98,8476460,Mark Scheifele,C,WPG,31,82,26,43,69
98,8478444,Brock Boeser,R,VAN,27,82,35,33,68
98,8478440,Dylan Strome,C,WSH,27,82,25,43,68
98,8478047,Michael Bunting,L,PIT,29,82,31,36,67
98,8479542,Brandon Hagel,L,TBL,26,82,30,37,67
98,8478401,Pavel Zacha,C,BOS,27,82,23,44,67
98,8480014,Gabriel Vilardi,C,WPG,25,82,41,25,66
98,8475754,Brock Nelson,C,NYI,33,82,33,33,66
98,8477494,Jonathan Drouin,L,COL,29,82,18,48,66
98,8475167,Victor Hedman,D,TBL,34,82,14,52,66
98,8477504,Josh Morrissey,D,WPG,29,82,10,56,66
98,8478010,Brayden Point,C,TBL,28,82,31,34,65
98,8479385,Jordan Kyrou,C,STL,26,82,29,36,65
98,8478438,Tommy Novak,C,NSH,27,82,27,38,65
98,8477503,Max Domi,C,TOR,29,82,17,48,65
98,8476432,Boone Jenner,C,CBJ,31,82,36,28,64
98,8475168,Matt Duchene,C,DAL,33,82,33,31,64
98,8477476,Artturi Lehkonen,L,COL,29,82,33,31,64
98,8478493,Joel Eriksson Ek,C,MIN,27,82,32,32,64
98,8475726,Tyler Toffoli,C,SJS,32,82,30,34,64
98,8476483,Rickard Rakell,R,PIT,31,82,28,36,64
98,8480208,Drake Batherson,R,OTT,26,82,24,40,64
98,8478042,Viktor Arvidsson,R,EDM,31,82,22,42,64
98,8476456,Jonathan Huberdeau,C,CGY,31,82,18,46,64
98,8480839,Rasmus Dahlin,D,BUF,24,82,17,47,64
98,8479425,Filip Hronek,D,VAN,27,82,12,52,64
98,8479339,Patrik Laine,L,CBJ,26,82,32,31,63
98,8475170,Brayden Schenn,C,STL,33,82,25,38,63
98,8482097,Jack Quinn,R,BUF,23,82,23,40,63
98,8471685,Anze Kopitar,C,LAK,37,82,21,42,63
98,8482684,Luke Hughes,D,NJD,21,82,6,57,63
98,8482110,Dawson Mercer,C,NJD,23,82,31,31,62
98,8481540,Cole Caufield,R,MTL,23,82,29,33,62
98,8478873,Troy Terry,R,ANA,27,82,22,40,62
98,8475798,Mikael Granlund,C,SJS,32,82,19,43,62
98,8475794,Tyler Seguin,C,DAL,32,82,36,25,61
98,8475786,Zach Hyman,L,EDM,32,82,29,32,61
98,8479675,Trevor Moore,L,LAK,29,82,25,36,61
98,8479999,Casey Mittelstadt,C,COL,26,82,22,39,61
98,8476479,Phillip Danault,C,LAK,31,82,21,40,61
98,8477407,Anthony Duclair,L,NYI,29,82,21,40,61
98,8475784,Jeff Skinner,C,EDM,32,82,31,29,60
98,8476448,William Karlsson,C,VGK,31,82,30,30,60
98,8475745,Charlie Coyle,C,BOS,32,82,21,39,60
98,8476459,Mika Zibanejad,C,NYR,31,82,20,40,60
98,8470613,Brent Burns,D,CAR,39,82,19,41,60
98,8478038,Devon Toews,D,COL,30,82,15,45,60
98,8477940,Nikolaj Ehlers,L,WPG,28,82,29,30,59
98,8477951,Nick Schmaltz,C,UTA,28,82,24,35,59
98,8481711,Matias Maccelli,L,UTA,24,82,24,35,59
98,8476882,Teuvo Teravainen,L,CHI,30,82,21,38,59
98,8480803,Evan Bouchard,D,EDM,25,82,10,49,59
98,8482745,Mason McTavish,C,ANA,21,82,28,30,58
98,8474679,Gustav Nyquist,C,NSH,35,82,25,33,58
98,8477935,Sam Bennett,C,FLA,28,82,23,35,58
98,8473512,Claude Giroux,R,OTT,36,82,13,45,58
98,8480865,Noah Dobson,D,NYI,24,82,9,49,58
98,8481618,Alex Newhook,C,MTL,23,82,30,27,57
98,8482113,Anton Lundell,C,FLA,23,82,25,32,57
98,8477497,Sean Monahan,C,CBJ,30,82,24,33,57
98,8482078,Lucas Raymond,L,DET,22,82,22,35,57
98,8474102,David Perron,L,OTT,36,82,22,35,57
98,8482667,William Eklund,L,SJS,22,82,22,35,57
98,8477932,Aaron Ekblad,D,FLA,28,82,16,41,57
98,8474641,Adam Henrique,C,EDM,34,82,30,26,56
98,8478474,Lawson Crouse,L,UTA,27,82,30,26,56
98,8477451,Ryan Hartman,R,MIN,30,82,31,24,55
98,8483808,Andrei Kuzmenko,L,CGY,28,82,27,28,55
98,8480015,Owen Tippett,R,PHI,25,82,25,30,55
98,8479337,Alex DeBrincat,R,DET,27,82,23,32,55
98,8481528,Dylan Cozens,C,BUF,23,82,19,36,55
98,8478055,Gustav Forsling,D,FLA,28,82,17,38,55
98,8478498,Jake DeBrusk,L,VAN,28,82,29,25,54
98,8476399,Blake Coleman,C,CGY,33,82,27,27,54
98,8481068,Yegor Sharangovich,C,CGY,26,82,25,29,54
98,8480829,Jesperi Kotkaniemi,C,CAR,24,82,22,32,54
98,8474565,Alex Pietrangelo,D,VGK,34,82,15,39,54
98,8476875,Mike Matheson,D,MTL,30,82,7,47,54
98,8478519,Anthony Cirelli,C,TBL,27,82,25,28,53
98,8482740,Wyatt Johnston,C,DAL,21,82,24,29,53
98,8477416,Oliver Bjorkstrand,R,SEA,29,82,22,31,53
98,8480039,Martin Necas,C,CAR,25,82,19,34,53
98,8474150,Mikael Backlund,C,CGY,35,82,15,38,53
98,8478397,Rasmus Andersson,D,CGY,28,82,14,39,53
98,8476869,Brady Skjei,D,NSH,30,82,10,43,53
98,8478407,Vince Dunn,D,SEA,28,82,7,46,53
98,8481542,Moritz Seider,D,DET,23,82,5,48,53
98,8477456,J.T. Compher,L,DET,29,82,25,27,52
98,8478975,Mason Marchment,L,DAL,29,82,24,28,52
98,8475765,Vladimir Tarasenko,R,DET,33,82,20,32,52
98,8481581,Thomas Harley,D,DAL,23,82,15,37,52
98,8477952,Robby Fabbri,C,ANA,28,82,25,26,51
98,8484144,Connor Bedard,C,CHI,19,82,24,27,51
98,8481596,Shane Pinto,C,OTT,24,82,22,29,51
98,8475158,Ryan O'Reilly,C,NSH,33,82,19,32,51
98,8477479,Tyler Bertuzzi,L,CHI,29,82,16,35,51
98,8482149,Cole Perfetti,C,WPG,22,82,16,35,51
98,8479400,Pierre-Luc Dubois,L,WSH,26,82,24,26,50
98,8482475,Yegor Chinakhov,R,CBJ,23,82,23,27,50
98,8475191,Reilly Smith,R,NYR,33,82,21,29,50
98,8482699,Dylan Guenther,R,UTA,21,82,20,30,50
98,8478463,Anthony Beauvillier,L,PIT,27,82,17,33,50
98,8476458,Ryan Strome,C,ANA,31,82,16,34,50
98,8479987,Morgan Geekie,C,BOS,26,82,15,35,50
98,8471724,Kris Letang,D,PIT,37,82,10,40,50
98,8473986,Alex Killorn,L,ANA,35,82,28,21,49
98,8482055,Drew O'Connor,L,PIT,26,82,26,23,49
98,8478462,Nicolas Roy,C,VGK,27,82,19,30,49
98,8482159,Tyson Foerster,R,PHI,22,82,24,24,48
98,8480188,Fabian Zetterlund,L,SJS,25,82,21,27,48
98,8476292,Ondrej Palat,L,NJD,33,82,18,30,48
98,8478542,Evan Rodrigues,C,FLA,31,82,17,31,48
98,8480078,Filip Chytil,C,NYR,25,82,16,32,48
98,8478856,Conor Garland,R,VAN,28,82,15,33,48
98,8478469,Thomas Chabot,D,OTT,27,82,15,33,48
98,8473422,Nick Foligno,L,CHI,37,82,14,34,48
98,8480064,Josh Norris,C,OTT,25,82,26,21,47
98,8471698,T.J. Oshie,R,WSH,38,82,26,21,47
98,8476927,Teddy Blueger,C,VAN,30,82,26,21,47
98,8474586,Jordan Eberle,R,SEA,34,82,26,21,47
98,8476438,Brandon Saad,L,STL,32,82,24,23,47
98,8477511,Anthony Mantha,R,CGY,30,82,22,25,47
98,8476826,Yanni Gourde,C,SEA,33,82,21,26,47
98,8474590,John Carlson,D,WSH,34,82,11,36,47
98,8475753,Justin Faulk,D,STL,32,82,9,38,47
98,8478366,Frank Vatrano,R,ANA,30,82,21,25,46
98,8482105,Jake Sanderson,D,OTT,22,82,18,28,46
98,8482665,Matty Beniers,C,SEA,22,82,17,29,46
98,8475768,Jaden Schwartz,C,SEA,32,82,15,31,46
98,8480220,Noah Cates,L,PHI,25,82,13,33,46
98,8478396,Noah Hanifin,D,VGK,27,82,12,34,46
98,8477495,Seth Jones,D,CHI,30,82,11,35,46
98,8478458,Jack Roslovic,C,CAR,27,82,8,38,46
98,8479976,Juuso Valimaki,D,UTA,26,82,7,39,46
98,8475151,Kyle Palmieri,C,NYI,33,82,22,23,45
98,8474149,Evgenii Dadonov,R,DAL,35,82,21,24,45
98,8483515,Juraj Slafkovsky,L,MTL,20,82,19,26,45
98,8478057,Dakota Joshua,C,VAN,28,82,18,27,45
98,8482660,Kent Johnson,C,CBJ,22,82,15,30,45
98,8476329,Travis Boyd,C,MIN,31,82,13,32,45
98,8480336,Sean Walker,D,CAR,30,82,13,32,45
98,8479345,Jakob Chychrun,D,WSH,26,82,12,33,45
98,8479410,Mikhail Sergachev,D,UTA,26,82,8,37,45
98,8475314,Anders Lee,L,NYI,34,82,25,19,44
98,8480797,Joel Farabee,L,PHI,24,82,24,20,44
98,8478046,Danton Heinen,L,VAN,29,82,17,27,44
98,8478233,Andrew Mangiapane,L,WSH,28,82,15,29,44
98,8477021,Alex Kerfoot,C,UTA,30,82,14,30,44
98,8476872,Scott Laughton,C,PHI,30,82,13,31,44
98,8476897,Oskar Sundqvist,C,STL,30,82,13,31,44
98,8479365,Trent Frederic,C,BOS,26,82,23,20,43
98,8480459,Pius Suter,C,VAN,28,82,22,21,43
98,8480849,Barrett Hayton,C,UTA,24,82,21,22,43
98,8481624,Ilya Mikheyev,R,CHI,30,82,19,24,43
98,8480798,Philipp Kurashev,C,CHI,25,82,17,26,43
98,8474053,Logan Couture,C,SJS,35,82,15,28,43
98,8476480,Vladislav Namestnikov,C,WPG,32,82,12,31,43
98,8474563,Drew Doughty,D,LAK,35,82,11,32,43
98,8476923,Damon Severson,D,CBJ,30,82,6,37,43
98,8475169,Evander Kane,L,EDM,33,82,25,17,42
98,8477998,Warren Foegele,L,LAK,28,82,23,19,42
98,8475799,Nino Niederreiter,R,WPG,32,82,23,19,42
98,8480893,Kirill Marchenko,R,CBJ,24,82,22,20,42
98,8480113,Alex Iafallo,L,WPG,31,82,21,21,42
98,8475763,Kevin Hayes,R,PIT,32,82,20,22,42
98,8482109,Alexis Lafrenière,L,NYR,23,82,15,27,42
98,8477919,Frederick Gaudreau,C,MIN,31,82,15,27,42
98,8475287,Erik Haula,L,NJD,33,82,14,28,42
98,8476979,Erik Gustafsson,D,DET,32,82,8,34,42
98,8482089,Jake Neighbours,L,STL,22,82,27,14,41
98,8481186,Logan O'Connor,R,COL,28,82,18,23,41
98,8476905,Chandler Stephenson,C,SEA,30,82,14,27,41
98,8474716,Jared Spurgeon,D,MIN,35,82,11,30,41
98,8476880,Tom Wilson,R,WSH,30,82,24,16,40
98,8475760,Nick Bjugstad,C,UTA,32,82,22,18,40
98,8477964,Ivan Barbashev,C,VGK,29,82,18,22,40
98,8475714,Calle Jarnkrok,C,TOR,33,82,16,24,40
98,8482175,JJ Peterka,R,BUF,22,82,16,24,40
98,8477426,Nicholas Paul,L,TBL,29,82,14,26,40
98,8477498,Darnell Nurse,D,EDM,29,82,14,26,40
98,8477346,MacKenzie Weegar,D,CGY,30,82,12,28,40
98,8477986,Brandon Montour,D,SEA,30,82,12,28,40
98,8476958,Jaccob Slavin,D,CAR,30,82,11,29,40
98,8476792,Torey Krug,D,STL,33,82,10,30,40
98,8480145,Neal Pionk,D,WPG,29,82,9,31,40
98,8473563,Nicklas Backstrom,C,WSH,37,82,9,31,40
98,8475200,Dmitry Orlov,D,CAR,33,82,6,34,40
98,8475764,Cam Fowler,D,ANA,33,82,6,34,40
98,8481604,Pavel Dorofeyev,L,VGK,24,82,20,19,39
98,8482124,Quinton Byfield,R,LAK,22,82,17,22,39
98,8475793,Ryan Johansen,C,PHI,32,82,16,23,39
98,8475848,Brendan Gallagher,R,MTL,32,82,16,23,39
98,8476906,Shayne Gostisbehere,D,CAR,31,82,12,27,39
98,8476885,Jacob Trouba,D,NYR,30,82,9,30,39
98,8477425,Miles Wood,L,COL,29,82,19,19,38
98,8480802,Ryan McLeod,C,BUF,25,82,18,20,38
98,8482705,Cole Sillinger,C,CBJ,21,82,17,21,38
98,8476419,Jean-Gabriel Pageau,C,NYI,32,82,12,26,38
98,8480434,Sean Durzi,D,UTA,26,82,9,29,38
98,8480817,K'Andre Miller,D,NYR,24,82,6,32,38
98,8475791,Taylor Hall,L,CHI,33,82,21,16,37
98,8477429,Andrew Copp,C,DET,30,82,16,21,37
98,8478472,Mathieu Joseph,R,STL,27,82,16,21,37
98,8480871,Adam Boqvist,D,FLA,24,82,13,24,37
98,8481546,Cam York,D,PHI,23,82,10,27,37
98,8478911,Matt Roy,D,WSH,29,82,6,31,37
98,8481554,Kaapo Kakko,R,NYR,23,82,22,14,36
98,8477987,Ryan Donato,C,CHI,28,82,19,17,36
98,8479293,Brandon Tanev,L,SEA,33,82,18,18,36
98,8480028,Morgan Frost,C,PHI,25,82,15,21,36
98,8473533,Jordan Staal,C,CAR,36,82,15,21,36
98,8482133,Thomas Bordeleau,C,SJS,22,82,12,24,36
98,8476461,Sean Couturier,C,PHI,32,82,10,26,36
98,8482720,Matthew Knies,L,TOR,22,82,9,27,36
98,8477488,Brett Pesce,D,NJD,30,82,9,27,36
98,8480813,Joe Veleno,C,DET,24,82,21,14,35
98,8478413,Jordan Greenway,L,BUF,27,82,17,18,35
98,8482092,Ridly Greig,C,OTT,22,82,16,19,35
98,8479393,Noah Gregor,C,OTT,26,82,16,19,35
98,8479996,Cody Glass,C,NSH,25,82,14,21,35
98,8480068,Ryan Poehling,C,PHI,25,82,14,21,35
98,8475218,Mattias Ekholm,D,EDM,34,82,9,26,35
98,8478882,Vladislav Gavrikov,D,LAK,29,82,5,30,35
98,8480009,Eeli Tolvanen,R,SEA,25,82,17,17,34
98,8480003,Jesper Boqvist,C,FLA,26,82,16,18,34
98,8477903,Garnet Hathaway,R,PHI,33,82,16,18,34
98,8477948,Travis Sanheim,D,PHI,28,82,11,23,34
98,8475220,Marcus Foligno,L,MIN,33,82,11,23,34
98,8480144,David Kampf,C,TOR,29,82,9,25,34
98,8476463,Jonas Brodin,D,MIN,31,82,6,28,34
98,8476854,Hampus Lindholm,D,BOS,30,82,3,31,34
98,8484166,Adam Fantilli,C,CBJ,20,82,16,17,33
98,8475343,Nic Dowd,C,WSH,34,82,16,17,33
98,8478891,Mason Appleton,C,WPG,28,82,15,18,33
98,8482146,Luke Evangelista,R,NSH,22,82,15,18,33
98,8476921,Jordan Martinook,L,CAR,32,82,13,20,33
98,8480806,Isac Lundestrom,C,ANA,25,82,12,21,33
98,8482111,Justin Barron,D,MTL,23,82,12,21,33
98,8479398,Samuel Girard,D,COL,26,82,5,28,33
98,8474151,Ryan McDonagh,D,TBL,35,82,3,30,33
98,8477450,Jason Dickinson,C,CHI,29,82,18,14,32
98,8481582,Nicholas Robertson,L,TOR,23,82,16,16,32
98,8476918,Jimmy Vesey,L,NYR,31,82,16,16,32
98,8481013,Jonatan Berggren,R,DET,24,82,14,18,32
98,8477839,Conor Sheary,L,TBL,32,82,13,19,32
98,8480855,Jack McBain,C,UTA,24,82,13,19,32
98,8484145,Zach Benson,L,BUF,19,82,12,20,32
98,8483457,Lane Hutson,D,MTL,20,82,11,21,32
98,8476892,Colton Parayko,D,STL,31,82,7,25,32
98,8480049,Dylan Samberg,D,WPG,25,82,3,29,32
98,8481535,Nils Hoglander,L,VAN,24,82,20,11,31
98,8476278,Colin Blackwell,C,DAL,31,82,16,15,31
98,8479414,Nathan Bastian,R,NJD,27,82,16,15,31
98,8481032,Paul Cotter,C,NJD,25,82,15,16,31
98,8477947,Sonny Milano,L,WSH,28,82,14,17,31
98,8482117,Lukas Reichel,L,CHI,22,82,14,17,31
98,8480835,Jack Drury,C,CAR,24,82,13,18,31
98,8476392,Adam Lowry,C,WPG,31,82,12,19,31
98,8477989,Christian Dvorak,C,MTL,28,82,10,21,31
98,8482122,Brock Faber,D,MIN,22,82,7,24,31
98,8479998,Mikey Anderson,D,LAK,25,82,2,29,31
98,8478020,Michael Amadio,C,OTT,28,82,20,10,30
98,8476374,Sean Kuraly,C,CBJ,31,82,18,12,30
98,8476474,Stefan Noesen,R,NJD,31,82,15,15,30
98,8480980,Connor Dewar,C,TOR,25,82,14,16,30
98,8478115,Pierre Engvall,L,NYI,28,82,13,17,30
98,8475722,Jason Zucker,L,BUF,32,82,11,19,30
98,8478133,Jake Evans,C,MTL,28,82,11,19,30
98,8480074,Alexandre Texier,C,STL,25,82,11,19,30
98,8480789,Oliver Wahlstrom,R,NYI,24,82,10,20,30
98,8482087,Kaiden Guhle,D,MTL,22,82,10,20,30
98,8477369,Carson Soucy,D,VAN,30,82,8,22,30
98,8479402,Jake Bean,D,CGY,26,82,7,23,30
98,8479351,Sam Steel,C,DAL,26,82,5,25,30
98,8480873,Rasmus Sandin,D,WSH,24,82,1,29,30
98,8476981,Josh Anderson,R,MTL,30,82,19,10,29
98,8476925,Colton Sissons,C,NSH,31,82,18,11,29
98,8481656,Aliaksei Protas,C,WSH,23,82,15,14,29
98,8481093,Rafael Harvey-Pinard,L,MTL,25,82,15,14,29
98,8478109,Victor Olofsson,L,VGK,29,82,14,15,29
98,8480281,Alexey Toropchenko,R,STL,25,82,14,15,29
98,8474715,Cam Atkinson,R,TBL,35,82,13,16,29
98,8479353,Brett Howden,C,VGK,26,82,11,18,29
98,8483490,Pavel Mintyukov,D,ANA,21,82,9,20,29
98,8481606,Jordan Spence,D,LAK,23,82,8,21,29
98,8476422,Mike Reilly,D,NYI,31,82,8,21,29
98,8476902,Esa Lindell,D,DAL,30,82,5,24,29
98,8478136,Jake Middleton,D,MIN,28,82,5,24,29
98,8476931,Jake McCabe,D,TOR,31,82,4,25,29
98,8479390,Taylor Raddysh,R,WSH,26,82,14,14,28
98,8481560,Arthur Kaliyev,R,LAK,23,82,13,15,28
98,8477444,Andre Burakovsky,L,SEA,29,82,11,17,28
98,8476889,Radek Faksa,C,STL,30,82,11,17,28
98,8474189,Lars Eller,C,PIT,35,82,10,18,28
98,8475193,Tomas Tatar,L,NJD,34,82,8,20,28
98,8475149,Marcus Johansson,L,MIN,34,82,7,21,28
98,8480035,Henri Jokiharju,D,BUF,25,82,6,22,28
98,8479371,Dante Fabbro,D,NSH,26,82,5,23,28
98,8475324,Nick Jensen,D,OTT,34,82,4,24,28
98,8480860,Kevin Bahl,D,CGY,24,82,4,24,28
98,8482079,Marco Rossi,C,MIN,23,82,15,12,27
98,8483431,Logan Cooley,C,UTA,20,82,14,13,27
98,8480748,Kiefer Sherwood,L,VAN,29,82,13,14,27
98,8482074,Connor Zary,C,CGY,23,82,13,14,27
98,8479525,Ross Colton,C,COL,28,82,12,15,27
98,8480185,Eetu Luostarinen,C,FLA,26,82,12,15,27
98,8482125,Alexander Holtz,R,VGK,22,82,12,15,27
98,8475171,Oliver Ekman-Larsson,D,TOR,33,82,8,19,27
98,8479983,Mario Ferraro,D,SJS,26,82,6,21,27
98,8476891,Matt Grzelcyk,D,PIT,30,82,6,21,27
98,8480043,Timothy Liljegren,D,TOR,25,82,4,23,27
98,8480878,Nils Lundkvist,D,DAL,24,82,4,23,27
98,8478507,John Marino,D,UTA,27,82,4,23,27
98,8478500,Ivan Provorov,D,CBJ,27,82,2,25,27
98,8481601,Simon Holmstrom,R,NYI,23,82,17,9,26
98,8470621,Corey Perry,R,EDM,39,82,15,11,26
98,8482077,Dylan Holloway,L,EDM,23,82,15,11,26
98,8482624,Daniil Miromanov,D,CGY,27,82,15,11,26
98,8475842,Sam Carrick,C,NYR,32,82,14,12,26
98,8479992,Michael Rasmussen,C,DET,25,82,13,13,26
98,8477953,Kasperi Kapanen,R,STL,28,82,12,14,26
98,8479591,Michael Eyssimont,C,TBL,28,82,12,14,26
98,8477508,Curtis Lazar,C,NJD,29,82,11,15,26
98,8482666,Scott Morrow,D,CAR,22,82,10,16,26
98,8482141,Lukas Cormier,D,VGK,22,82,8,18,26
98,8475181,Nick Leddy,D,STL,33,82,7,19,26
98,8477435,Ryan Graves,D,PIT,29,82,6,20,26
98,8474574,Tyler Myers,D,VAN,34,82,6,20,26
98,8481708,Zac Jones,D,NYR,24,82,5,21,26
98,8477506,Ryan Pulock,D,NYI,30,82,2,24,26
98,8482259,Bobby McMann,C,TOR,28,82,17,8,25
98,8481477,Nico Sturm,C,SJS,29,82,15,10,25
98,8476469,Joel Armia,R,MTL,31,82,13,12,25
98,8481481,Blake Lizotte,C,PIT,27,82,12,13,25
98,8476873,Mark Jankowski,C,NSH,30,82,11,14,25
98,8484153,Leo Carlsson,C,ANA,20,82,11,14,25
98,8476960,Andreas Athanasiou,C,CHI,30,82,11,14,25
98,8477015,Connor Brown,R,EDM,30,82,9,16,25
98,8482671,Owen Power,D,BUF,22,82,6,19,25
98,8476879,Cody Ceci,D,EDM,31,82,3,22,25
98,8478840,Will Borgen,D,SEA,28,82,2,23,25
98,8475790,Erik Gudbranson,D,CBJ,32,82,2,23,25
98,8482245,Artem Zub,D,OTT,29,82,0,25,25
98,8482166,Shakir Mukhamadullin,D,SJS,22,82,14,10,24
98,8481704,Juuso Parssinen,C,NSH,23,82,13,11,24
98,8484203,Bradly Nadeau,L,CAR,19,82,11,13,24
98,8481580,Connor McMichael,C,WSH,23,82,11,13,24
98,8478569,Noel Acciari,C,PIT,33,82,11,13,24
98,8478432,Christian Fischer,R,DET,27,82,11,13,24
98,8477392,Hudson Fasching,R,NYI,29,82,10,14,24
98,8477220,Nate Schmidt,D,FLA,33,82,8,16,24
98,8482762,Simon Edvinsson,D,DET,21,82,8,16,24
98,8476312,Josh Manson,D,COL,33,82,7,17,24
98,8477931,Tomas Nosek,L,FLA,32,82,6,18,24
98,8483495,Simon Nemec,D,NJD,20,82,6,18,24
98,8482073,Braden Schneider,D,NYR,23,82,4,20,24
98,8482803,Olen Zellweger,D,ANA,21,82,4,20,24
98,8481568,Alex Vlasic,D,CHI,23,82,4,20,24
98,8478399,Jonas Siegenthaler,D,NJD,27,82,4,20,24
98,8476525,Colin Miller,D,WPG,32,82,2,22,24
98,8479941,Justin Danforth,R,CBJ,31,82,16,7,23
98,8480995,Pontus Holmberg,R,TOR,25,82,12,11,23
98,8475855,Jesper Fast,R,CAR,33,82,11,12,23
98,8478013,Jake Walman,D,SJS,28,82,9,14,23
98,8483499,Liam Ohgren,L,MIN,20,82,8,15,23
98,8482858,Ryker Evans,D,SEA,23,82,8,15,23
98,8482702,Logan Stankoven,C,DAL,21,82,8,15,23
98,8483471,Brad Lambert,C,WPG,31,82,8,15,23
98,8479316,Luke Kunin,C,SJS,27,82,7,16,23
98,8480448,Parker Kelly,L,COL,25,82,7,16,23
98,8477969,Marcus Pettersson,D,PIT,28,82,6,17,23
98,8475690,Chris Tanev,D,TOR,35,82,5,18,23
98,8481178,Egor Zamula,D,PHI,24,82,4,19,23
98,8480246,Nick Perbix,D,TBL,26,82,4,19,23
98,8476331,Dylan DeMelo,D,WPG,31,82,4,19,23
98,8475233,David Savard,D,MTL,34,82,3,20,23
98,8482807,Ethan Del Mastro,D,CHI,21,82,2,21,23
98,8482062,Cole Smith,L,NSH,29,82,9,13,22
98,8481553,Bobby Brink,R,PHI,23,82,8,14,22
98,8483493,Frank Nazar,C,CHI,20,82,8,14,22
98,8475188,Brayden McNabb,D,VGK,33,82,6,16,22
98,8475177,Calvin de Haan,D,COL,33,82,6,16,22
98,8476467,Jamie Oleksiak,D,SEA,32,82,5,17,22
98,8482142,Jamie Drysdale,D,PHI,22,82,5,17,22
98,8479369,Andrew Peeke,D,BOS,26,82,4,18,22
98,8473507,Jeff Petry,D,DET,37,82,3,19,22
98,8477845,Trevor van Riemsdyk,D,WSH,33,82,3,19,22
98,8478851,Alexandre Carrier,D,NSH,28,82,3,19,22
98,8478211,Dryden Hunt,L,CGY,29,82,8,13,21
98,8477507,Nikita Zadorov,D,BOS,29,82,7,14,21
98,8482470,Ilya Solovyov,D,CGY,24,82,4,17,21
98,8482101,Danil Gushchin,L,SJS,22,82,4,17,21
98,8476457,Adam Larsson,D,SEA,32,82,3,18,21
98,8477034,Jaycob Megna,D,FLA,32,82,3,18,21
98,8475455,Brenden Dillon,D,NJD,34,82,1,20,21
98,8473453,Trevor Lewis,C,LAK,37,82,10,10,20
98,8481522,Peyton Krebs,C,BUF,23,82,9,11,20
98,8477505,Alexander Wennberg,C,SJS,30,82,8,12,20
98,8481567,Henry Thrun,D,SJS,23,82,7,13,20
98,8478178,Darren Raddysh,D,TBL,28,82,7,13,20
98,8482655,J.J. Moser,D,TBL,24,82,5,15,20
98,8480073,Erik Brannstrom,D,COL,25,82,4,16,20
98,8474013,Ian Cole,D,UTA,35,82,4,16,20
98,8482712,Oskar Olausson,R,COL,22,82,4,16,20
98,8479661,Tanner Jeannot,L,LAK,27,82,13,6,19
98,8481028,Martin Pospisil,C,CGY,25,82,12,7,19
98,8481524,Bowen Byram,D,BUF,23,82,12,7,19
98,8483445,Cutter Gauthier,L,ANA,20,82,9,10,19
98,8479359,Beck Malenstyn,L,BUF,26,82,9,10,19
98,8478508,Yakov Trenin,C,MIN,27,82,8,11,19
98,8482809,Jackson Blake,R,CAR,21,82,8,11,19
98,8479638,Justin Brazeau,R,BOS,26,82,8,11,19
98,8483763,Maksymilian Szuber,D,UTA,22,82,7,12,19
98,8483505,Matthew Poitras,C,BOS,20,82,7,12,19
98,8482145,Mavrik Bourque,C,DAL,22,82,7,12,19
98,8477406,Mattias Janmark,C,EDM,32,82,6,13,19
98,8476917,Adam Pelech,D,NYI,30,82,4,15,19
98,8475462,Radko Gudas,D,ANA,34,82,4,15,19
98,8478416,Erik Cernak,D,TBL,27,82,3,16,19
98,8474673,TJ Brodie,D,CHI,34,82,0,19,19
98,8476878,Zemgus Girgensons,L,TBL,30,82,11,7,18
98,8480021,Jack Studnicka,C,LAK,25,82,11,7,18
98,8479368,Max Jones,L,BOS,26,82,10,8,18
98,8480025,MacKenzie Entwistle,R,FLA,25,82,10,8,18
98,8481517,Brett Leason,R,ANA,25,82,8,10,18
98,8480990,Declan Chisholm,D,MIN,24,82,8,10,18
98,8483524,Shane Wright,C,SEA,20,82,8,10,18
98,8477353,Tyler Motte,C,DET,29,82,8,10,18
98,8484911,Collin Graf,R,SJS,22,82,7,11,18
98,8476624,Barclay Goodrow,C,SJS,31,82,6,12,18
98,8482787,Nikita Chibrikov,R,WPG,31,82,6,12,18
98,8483460,David Jiricek,D,CBJ,21,82,5,13,18
98,8478443,Brandon Carlo,D,BOS,28,82,4,14,18
98,8476442,Matt Nieto,L,PIT,32,82,3,15,18
98,8480222,Sebastian Aho,D,PIT,28,82,3,15,18
98,8479980,Nicolas Hague,D,VGK,26,82,3,15,18
98,8477365,Connor Clifton,D,BUF,29,82,3,15,18
98,8477335,Kyle Burroughs,D,LAK,29,82,2,16,18
98,8483397,Marc McLaughlin,C,BOS,25,82,12,5,17
98,8482659,Josh Doan,R,UTA,22,82,6,11,17
98,8483012,Logan Morrison,C,SEA,22,82,5,12,17
98,8480807,Mattias Samuelsson,D,BUF,24,82,5,12,17
98,8482749,Joshua Roy,R,MTL,21,82,4,13,17
98,8475718,Justin Holl,D,DET,32,82,3,14,17
98,8476858,Phillip Di Giuseppe,L,VAN,31,82,10,6,16
98,8482155,Alex Laferriere,R,LAK,23,82,6,10,16
98,8483468,Jiri Kulich,C,BUF,20,82,6,10,16
98,8478434,Keegan Kolesar,R,VGK,27,82,6,10,16
98,8480879,Jacob Bernard-Docker,D,OTT,24,82,3,13,16
98,8480834,Ty Emberson,D,SJS,24,82,3,13,16
98,8476967,Brett Kulak,D,EDM,30,82,3,13,16
98,8475279,Ben Chiarot,D,DET,33,82,2,14,16
98,8481014,Alexander Romanov,D,NYI,24,82,1,15,16
98,8482679,Matt Coronato,R,CGY,22,82,7,8,15
98,8475231,Casey Cizikas,C,NYI,33,82,6,9,15
98,8482859,Zack Ostapchuk,C,OTT,21,82,6,9,15
98,8480870,Bo Groulx,C,NYR,24,82,6,9,15
98,8478859,Niko Mikkola,D,FLA,28,82,4,11,15
98,8483466,Kevin Korchinski,D,CHI,20,82,4,11,15
98,8474612,Travis Hamonic,D,OTT,34,82,3,12,15
98,8479324,Ryan Lindgren,D,NYR,26,82,2,13,15
98,8476429,Scott Mayfield,D,NYI,32,82,1,14,15
98,8476372,Nick Seeler,D,PHI,31,82,1,14,15
98,8480796,Martin Fehervary,D,WSH,25,82,1,14,15
98,8481641,Joel Kiviranta,L,COL,28,82,6,8,14
98,8482516,Matthew Kessel,D,STL,24,82,5,9,14
98,8479442,Troy Stecher,D,EDM,30,82,5,9,14
98,8483565,Nick Blankenburg,D,NSH,26,82,4,10,14
98,8482733,Logan Mailloux,D,MTL,31,82,4,10,14
98,8483482,Tristan Luneau,D,ANA,20,82,4,10,14
98,8480172,Jan Rutta,D,SJS,34,82,3,11,14
98,8478468,Jeremy Lauzon,D,NSH,27,82,2,12,14
98,8479291,Kevin Rooney,C,CGY,31,82,5,8,13
98,8481122,Simon Benoit,D,TOR,26,82,4,9,13
98,8475762,Derek Forbort,D,VAN,32,82,2,11,13
98,8479576,Vincent Desharnais,D,VAN,28,82,1,12,13
98,8481699,Aku Raty,R,UTA,23,82,7,5,12
98,8477938,Haydn Fleury,D,WPG,28,82,4,8,12
98,8482153,Brendan Brisson,C,VGK,23,82,4,8,12
98,8477499,Rasmus Ristolainen,D,PHI,30,82,3,9,12
98,8476473,Connor Murphy,D,CHI,31,82,3,9,12
98,8481605,Jackson LaCombe,D,ANA,23,82,2,10,12
98,8482118,Sam Colangelo,R,ANA,23,82,7,4,11
98,8474567,Zach Bogosian,D,MIN,34,82,4,7,11
98,8474090,Brendan Smith,D,DAL,35,82,2,9,11
98,8484149,Gavin Brindley,C,CBJ,20,82,4,6,10
98,8480950,Ilya Lyubushkin,D,DAL,30,82,3,7,10
98,8478450,Parker Wotherspoon,D,BOS,27,82,3,7,10
98,8483489,Fraser Minten,C,TOR,31,82,6,3,9
98,8482713,Mackie Samoskevich,R,FLA,22,82,5,4,9
98,8478874,Adam Gaudette,C,OTT,28,82,3,6,9
98,8471677,Jack Johnson,D,CBJ,37,82,3,6,9
98,8476822,Luke Glendening,C,TBL,35,82,5,3,8
98,8476441,Joel Edmundson,D,LAK,31,82,4,4,8
98,8474062,Riley Nash,C,NYR,35,82,2,6,8
98,8483567,Georgii Merkulov,C,BOS,24,82,3,4,7
98,8470600,Ryan Suter,D,STL,39,82,2,4,6
98,8482070,Mitchell Chaffee,R,TBL,26,82,4,0,4
98,8470794,Joe Pavelski,C,,40,0,0,0,0
98,8481703,Valtteri Puustinen,R,PIT,25,0,0,0,0
98,8477950,Tony DeAngelo,D,,29,0,0,0,0
98,8481577,Philip Tomasino,C,NSH,23,0,0,0,0
98,8475197,Tyson Barrie,D,,33,0,0,0,0
98,8471218,Blake Wheeler,R,,38,0,0,0,0
98,8474157,Max Pacioretty,L,,36,0,0,0,0
98,8478466,Daniel Sprong,R,VAN,27,0,0,0,0
98,8475744,Evgeny Kuznetsov,C,,32,0,0,0,0
98,8481019,David Gustafsson,C,WPG,24,0,0,0,0
98,8475906,John Klingberg,D,,32,0,0,0,0
98,8479348,Kale Clague,D,BUF,26,0,0,0,0
98,8476952,Dominic Toninato,C,WPG,30,0,0,0,0
98,8473473,Milan Lucic,L,,36,0,0,0,0
98,8474037,James van Riemsdyk,L,,35,0,0,0,0
98,8474602,Justin Schultz,D,,34,0,0,0,0
98,8482222,Alexander Barabanov,L,,30,0,0,0,0
98,8479372,Josh Mahura,D,SEA,26,0,0,0,0
98,8479982,Conor Timmins,D,TOR,26,0,0,0,0
98,8474031,Kevin Shattenkirk,D,,35,0,0,0,0
98,8480008,Adam Ruzicka,C,,25,0,0,0,0
98,8481059,Scott Perunovich,D,STL,26,0,0,0,0
98,8480884,Calen Addison,D,,24,0,0,0,0
98,8476994,Vinnie Hinostroza,C,NSH,30,0,0,0,0
98,8478452,Caleb Jones,D,LAK,27,0,0,0,0
98,8480157,Calle Rosen,D,COL,30,0,0,0,0
98,8481609,Vladislav Kolyachonok,D,UTA,23,0,0,0,0
98,8479415,Michael McLeod,C,,26,0,0,0,0
98,8476919,Chris Tierney,C,,30,0,0,0,0
98,8479639,Dylan Coghlan,D,WPG,26,0,0,0,0
98,8478146,Matthew Highmore,C,OTT,28,0,0,0,0
98,8478970,Jalen Chatfield,D,CAR,28,0,0,0,0
98,8480205,Emil Bemstrom,C,PIT,25,0,0,0,0
98,8474884,Mike Hoffman,C,,35,0,0,0,0
98,8471274,Alex Goligoski,D,,39,0,0,0,0
98,8478104,Sammy Blais,L,,28,0,0,0,0
98,8474870,Tyler Johnson,C,,34,0,0,0,0
98,8476913,Devin Shore,C,MIN,30,0,0,0,0
98,8481598,Philip Broberg,D,EDM,23,0,0,0,0
98,8480058,Pierre-Olivier Joseph,D,STL,25,0,0,0,0
98,8480891,Michael Kesselring,D,UTA,24,0,0,0,0
98,8477979,Nicolas Aube-Kubel,R,BUF,28,0,0,0,0
98,8476871,Tanner Pearson,L,,32,0,0,0,0
98,8476393,Nick Cousins,C,,31,0,0,0,0
98,8479977,Kailer Yamamoto,R,,26,0,0,0,0
98,8479543,Michael Pezzetta,L,MTL,26,0,0,0,0
98,8477018,Ben Hutton,D,VGK,31,0,0,0,0
98,8480762,Eric Robinson,L,CAR,29,0,0,0,0
98,8474034,Pat Maroon,L,CHI,36,0,0,0,0
98,8481058,Jesse Ylönen,R,,25,0,0,0,0
98,8475179,Dmitry Kulikov,D,FLA,34,0,0,0,0
98,8481527,Kaedan Korczak,D,VGK,23,0,0,0,0
98,8473449,Kyle Okposo,R,,36,0,0,0,0
98,8482192,Isaak Phillips,D,CHI,23,0,0,0,0
98,8480727,Zach Whitecloud,D,VGK,28,0,0,0,0
98,8479346,Dillon Dube,C,,26,0,0,0,0
98,8480821,Filip Zadina,R,,25,0,0,0,0
98,8480001,Urho Vaakanainen,D,ANA,25,0,0,0,0
98,8470966,Mark Giordano,D,,41,0,0,0,0
98,8480853,Liam Foudy,C,,24,0,0,0,0
98,8475225,Craig Smith,C,CHI,35,0,0,0,0
98,8479972,Mason Shaw,C,WPG,26,0,0,0,0
98,8478451,Ethan Bear,D,WSH,27,0,0,0,0
98,8474040,Sam Gagner,C,,35,0,0,0,0
98,8480196,Jacob Bryson,D,BUF,27,0,0,0,0
98,8479984,Cal Foote,D,,26,0,0,0,0
98,8480011,Klim Kostin,C,SJS,25,0,0,0,0
98,8482176,Wyatt Kaiser,D,CHI,22,0,0,0,0
98,8476988,Matt Benning,D,SJS,30,0,0,0,0
98,8479370,Tyson Jost,C,CAR,26,0,0,0,0
98,8477464,Nic Petan,C,,29,0,0,0,0
98,8477380,Jonny Brodzinski,C,NYR,31,0,0,0,0
98,8480070,Ian Mitchell,D,BOS,25,0,0,0,0
98,8479315,Joey Anderson,R,CHI,26,0,0,0,0
98,8478099,Kevin Labanc,R,,29,0,0,0,0
98,8476874,Olli Maatta,D,DET,30,0,0,0,0
98,8475208,Brian Dumoulin,D,ANA,33,0,0,0,0
98,8478430,Oliver Kylington,D,,27,0,0,0,0
98,8479536,Axel Jonsson-Fjallby,L,WPG,26,0,0,0,0
98,8479671,Mathieu Olivier,R,CBJ,27,0,0,0,0
98,8471709,Marc-Edouard Vlasic,D,SJS,37,0,0,0,0
98,8479328,Julien Gauthier,R,NYI,27,0,0,0,0
98,8478421,A.J. Greer,L,FLA,28,0,0,0,0
98,8477573,Nathan Walker,L,STL,30,0,0,0,0
98,8481537,Nikita Okhotiuk,D,CGY,24,0,0,0,0
98,8474166,Alec Martinez,D,CHI,37,0,0,0,0
98,8470610,Zach Parise,L,,40,0,0,0,0
98,8477478,William Carrier,L,CAR,30,0,0,0,0
98,8479344,Jesse Puljujarvi,R,PIT,26,0,0,0,0
98,8480887,Jordan Harris,D,MTL,24,0,0,0,0
98,8478502,Dennis Gilbert,D,BUF,28,0,0,0,0
98,8482730,Brandt Clarke,D,LAK,21,0,0,0,0
98,8480355,Mark Kastelic,C,BOS,25,0,0,0,0
98,8475750,Jon Merrill,D,MIN,32,0,0,0,0
98,8475164,Jakob Silfverberg,R,,34,0,0,0,0
98,8477944,Jakub Vrana,L,,28,0,0,0,0
98,8479439,Jacob MacDonald,D,COL,31,0,0,0,0
98,8474568,Luke Schenn,D,NSH,35,0,0,0,0
98,8478454,Noah Juulsen,D,VAN,27,0,0,0,0
98,8475752,Tyler Pitlick,C,,33,0,0,0,0
98,8482148,Hendrix Lapierre,C,WSH,22,0,0,0,0
98,8481167,Brayden Pachal,D,CGY,25,0,0,0,0
98,8478043,Sam Lafferty,C,BUF,29,0,0,0,0
98,8479321,Lucas Johansen,D,,27,0,0,0,0
98,8471699,Andrew Cogliano,C,,37,0,0,0,0
98,8481521,Ronnie Attard,D,PHI,25,0,0,0,0
98,8481161,Jake Christiansen,D,CBJ,25,0,0,0,0
98,8479458,Nikita Zaitsev,D,,33,0,0,0,0
98,8479619,Michael Carcone,L,UTA,28,0,0,0,0
98,8479026,Philippe Myers,D,TOR,27,0,0,0,0
98,8477330,Dominik Kubalik,L,,29,0,0,0,0
98,8481617,Vasily Podkolzin,R,VAN,23,0,0,0,0
98,8481701,Santeri Hatakka,D,NJD,23,0,0,0,0
98,8479514,Rem Pitlick,C,,27,0,0,0,0
98,8477446,Michael McCarron,R,NSH,29,0,0,0,0
98,8470604,Jeff Carter,C,,39,0,0,0,0
98,8482241,Radim Zohorna,L,,28,0,0,0,0
98,8480289,Morgan Barron,C,WPG,26,0,0,0,0
98,8479379,Givani Smith,R,SJS,26,0,0,0,0
98,8480216,Jacob Peterson,C,,25,0,0,0,0
98,8477851,Jordan Oesterle,D,BOS,32,0,0,0,0
98,8484258,Sam Malinski,D,COL,26,0,0,0,0
98,8478904,Steven Lorentz,C,,28,0,0,0,0
98,8482095,Tyler Kleven,D,OTT,22,0,0,0,0
98,8480848,Ty Dellandrea,C,SJS,24,0,0,0,0
98,8476884,Derrick Pouliot,D,,30,0,0,0,0
98,8479336,Carl Grundstrom,R,SJS,27,0,0,0,0
98,8482964,Arber Xhekaj,D,MTL,23,0,0,0,0
98,8471686,Marc Staal,D,,37,0,0,0,0
98,8477887,Patrick Brown,C,BOS,32,0,0,0,0
98,8478495,Denis Gurianov,R,,27,0,0,0,0
98,8473504,Cal Clutterbuck,R,,37,0,0,0,0
98,8481550,Adam Beckman,L,NJD,23,0,0,0,0
98,8480845,Rasmus Kupari,C,WPG,24,0,0,0,0
98,8474009,Nick Bonino,C,,36,0,0,0,0
98,8478585,Derek Ryan,C,EDM,38,0,0,0,0
98,8477962,Brendan Lemieux,L,CAR,28,0,0,0,0
98,8482861,Vincent Iorio,D,WSH,22,0,0,0,0
98,8479378,Logan Stanley,D,WPG,26,0,0,0,0
98,8473446,Erik Johnson,D,PHI,36,0,0,0,0
98,8481743,Marc Del Gaizo,D,NSH,25,0,0,0,0
98,8477384,Josh Brown,D,EDM,30,0,0,0,0
98,8482165,Yan Kuznetsov,D,CGY,22,0,0,0,0
98,8478424,Jansen Harkins,C,ANA,27,0,0,0,0
98,8482144,Jack Thompson,D,SJS,22,0,0,0,0
98,8478512,Austin Czarnik,C,,32,0,0,0,0
98,8477527,Ross Johnston,L,ANA,30,0,0,0,0
98,8479383,Boris Katchouk,L,,26,0,0,0,0
98,8482094,Daemon Hunt,D,MIN,22,0,0,0,0
98,8481719,Maxwell Crozier,D,TBL,24,0,0,0,0
98,8480192,Johnathan Kovacevic,D,NJD,27,0,0,0,0
98,8479376,Victor Mete,D,,26,0,0,0,0
98,8482511,Mason Lohrei,D,BOS,23,0,0,0,0
98,8475825,Jani Hakanpää,D,,32,0,0,0,0
98,8478021,William Lagesson,D,DET,28,0,0,0,0
98,8475795,Dylan McIlrath,D,WSH,32,0,0,0,0
98,8477846,Ryan Carpenter,C,,33,0,0,0,0
98,8481056,Spencer Stastney,D,NSH,24,0,0,0,0
98,8481564,Ryan Johnson,D,BUF,23,0,0,0,0
98,8478017,Mark Friedman,D,VAN,29,0,0,0,0
98,8479320,Max Lajoie,D,SEA,27,0,0,0,0
98,8480075,Cameron Crotty,D,MIN,25,0,0,0,0
98,8484287,Cole McWard,D,VAN,23,0,0,0,0
98,8484254,Akito Hirose,D,VAN,25,0,0,0,0
98,8483407,Brandon Scanlin,D,NYR,25,0,0,0,0
98,8480274,Philip Kemp,D,EDM,25,0,0,0,0
98,8479522,Hardy Haman Aktell,D,WSH,26,0,0,0,0
98,8480007,Jonas Rondbjerg,R,VGK,25,0,0,0,0
98,8477454,Adam Erne,L,,29,0,0,0,0
98,8481679,Maxence Guenette,D,OTT,23,0,0,0,0
98,8480441,Trey Fix-Wolansky,R,CBJ,25,0,0,0,0
98,8483546,Marshall Rifai,D,TOR,26,0,0,0,0
98,8480084,Nick DeSimone,D,NJD,30,0,0,0,0
98,8481030,Jack St. Ivany,D,PIT,25,0,0,0,0
98,8481592,Jakob Pelletier,L,CGY,23,0,0,0,0
98,8478011,Louie Belpedio,D,PHI,28,0,0,0,0
98,8477930,Pierre-Edouard Bellemare,L,,39,0,0,0,0
98,8484321,Nikolas Matinpalo,D,OTT,26,0,0,0,0
98,8482067,Connor Mackey,D,NYR,28,0,0,0,0
98,8481806,Louis Crevier,D,CHI,23,0,0,0,0
98,8484326,Patrik Koch,D,UTA,28,0,0,0,0
98,8477971,Andreas Englund,D,LAK,28,0,0,0,0
98,8481751,Lukas Rousek,R,BUF,25,0,0,0,0
98,8481006,Tyler Tucker,D,STL,24,0,0,0,0
98,8476867,Brendan Gaunce,C,MIN,30,0,0,0,0
98,8479520,Brandon Duhaime,R,WSH,27,0,0,0,0
98,8477073,Kurtis MacDermid,L,NJD,30,0,0,0,0
98,8480874,Adam Ginning,D,PHI,24,0,0,0,0
98,8477473,Justin Bailey,R,SJS,29,0,0,0,0
98,8479066,Ryan Lomberg,L,CGY,30,0,0,0,0
98,8477070,Liam O'Brien,C,UTA,30,0,0,0,0
98,8474618,Marco Scandella,D,,34,0,0,0,0
98,8475797,Jarred Tinordi,D,,32,0,0,0,0
98,8481441,Joe Snively,C,DET,28,0,0,0,0
98,8477244,Chad Ruhwedel,D,NYR,34,0,0,0,0
98,8479772,Zack MacEwen,R,OTT,28,0,0,0,0
98,8481147,Reese Johnson,C,MIN,26,0,0,0,0
98,8481043,Cole Koepke,L,BOS,26,0,0,0,0
98,8483619,Filip Roos,D,OTT,25,0,0,0,0
98,8481541,Samuel Bolduc,D,NYI,24,0,0,0,0
98,8477810,Joel Hanley,D,CGY,33,0,0,0,0
98,8476907,Mackenzie MacEachern,L,,30,0,0,0,0
98,8482652,Walker Duehr,R,CGY,27,0,0,0,0
98,8477126,Jayson Megna,C,,34,0,0,0,0
98,8483398,Declan Carlile,D,TBL,31,0,0,0,0
98,8482929,Emil Lilleberg,D,TBL,23,0,0,0,0
98,8480880,Jakub Lauko,C,MIN,24,0,0,0,0
98,8480245,Olle Lycksell,R,PHI,25,0,0,0,0
98,8480252,Cole Guttman,C,CHI,25,0,0,0,0
98,8477467,Gustav Olofsson,D,SEA,30,0,0,0,0
98,8479968,Vinni Lettieri,C,BOS,29,0,0,0,0
98,8478400,Colin White,C,,27,0,0,0,0
98,8475755,Alexander Petrovic,D,DAL,32,0,0,0,0
98,8481812,Nikolai Knyzhov,D,,27,0,0,0,0
98,8481593,Jayden Struble,D,MTL,23,0,0,0,0
98,8481532,Alex Turcotte,C,LAK,23,0,0,0,0
98,8482126,Emil Andrae,D,PHI,31,0,0,0,0
98,8479944,Zach Aston-Reese,C,VGK,30,0,0,0,0
98,8471817,Ryan Reaves,R,TOR,37,0,0,0,0
98,8481206,John Ludvig,D,PIT,24,0,0,0,0
98,8481599,Victor Soderstrom,D,UTA,23,0,0,0,0
98,8480292,Carson Meyer,R,ANA,27,0,0,0,0
98,8482496,Nils Aman,C,VAN,24,0,0,0,0
98,8479718,Alex Barré-Boulet,C,MTL,27,0,0,0,0
98,8479994,Jaret Anderson-Dolan,C,WPG,25,0,0,0,0
98,8480184,Gustav Lindstrom,D,,26,0,0,0,0
98,8480890,Jan Jenik,R,OTT,24,0,0,0,0
98,8478067,Oskar Lindblom,L,,28,0,0,0,0
98,8476934,Brock McGinn,L,ANA,30,0,0,0,0
98,8479985,Cale Fleury,D,SEA,26,0,0,0,0
98,8484304,Uvis Balinskis,D,FLA,28,0,0,0,0
98,8479981,Jonah Gadjovich,L,FLA,26,0,0,0,0
98,8481716,Dmitri Voronkov,L,CBJ,24,0,0,0,0
98,8474709,Matt Martin,L,,35,0,0,0,0
98,8482634,Alex Steeves,C,TOR,25,0,0,0,0
98,8480823,Alexander Alexeyev,D,WSH,25,0,0,0,0
98,8477541,Dakota Mermis,D,TOR,30,0,0,0,0
98,8483491,Ivan Miroshnichenko,L,WSH,20,0,0,0,0
98,8478477,Mitchell Stephens,C,SEA,27,0,0,0,0
98,8481543,Nikita Alexandrov,C,STL,24,0,0,0,0
98,8479423,Alex Nylander,L,,26,0,0,0,0
98,8482451,Mikael Pyyhtia,L,CBJ,23,0,0,0,0
98,8478831,Kevin Stenlund,C,UTA,28,0,0,0,0
98,8480306,Grant Hutton,D,NYI,29,0,0,0,0
98,8478028,Fredrik Olofsson,L,,28,0,0,0,0
98,8477462,Robert Hagg,D,VGK,29,0,0,0,0
98,8477320,Anton Blidh,L,NYR,29,0,0,0,0
98,8482157,Will Cuylle,L,NYR,22,0,0,0,0
98,8482737,Zack Bolduc,C,STL,21,0,0,0,0
98,8481239,Samuel Fagemo,L,,24,0,0,0,0
98,8481600,Tobias Bjornfot,D,FLA,23,0,0,0,0
98,8478409,Anthony Richard,C,PHI,28,0,0,0,0
98,8474145,Robert Bortuzzo,D,,35,0,0,0,0
98,8475958,Michael Sgarbossa,C,WSH,32,0,0,0,0
98,8479986,Kole Lind,R,DAL,26,0,0,0,0
98,8479249,Andrew Poturalski,C,SJS,30,0,0,0,0
98,8479362,Riley Tufte,L,BOS,26,0,0,0,0
98,8479991,Jake Leschyshyn,C,NYR,25,0,0,0,0
98,8479587,Rhett Gardner,C,PHI,28,0,0,0,0
98,8482744,James Malatesta,L,CBJ,21,0,0,0,0
98,8478854,Ryan Shea,D,PIT,27,0,0,0,0
98,8481591,Sam Poulin,R,,23,0,0,0,0
98,8483512,Matt Savoie,C,EDM,20,0,0,0,0
98,8482102,Vasily Ponomarev,C,PIT,22,0,0,0,0
98,8482162,Roby Jarventie,L,EDM,22,0,0,0,0
98,8481016,Ruslan Iskhakov,C,,24,0,0,0,0
98,8482172,Landon Slaggert,L,CHI,22,0,0,0,0
98,8482747,Brennan Othmann,L,NYR,21,0,0,0,0
98,8480031,Maxime Comtois,L,,25,0,0,0,0
98,8480226,Marián Studenic,R,,26,0,0,0,0
98,8478408,Travis Dermott,D,,28,0,0,0,0
98,8481518,Nolan Foote,L,NJD,24,0,0,0,0
98,8479419,Brett Murray,L,BUF,26,0,0,0,0
98,8482088,Justin Sourdif,R,FLA,22,0,0,0,0
98,8482201,Gage Goncalves,C,TBL,23,0,0,0,0
98,8481578,Graeme Clarke,R,MIN,23,0,0,0,0
98,8482177,Marat Khusnutdinov,C,MIN,22,0,0,0,0
98,8481754,Nikita Nesterenko,C,ANA,23,0,0,0,0
98,8483531,Brian Halonen,L,NJD,25,0,0,0,0
98,8483920,Pierrick Dube,R,WSH,23,0,0,0,0
98,8480851,Akil Thomas,C,LAK,24,0,0,0,0
98,8475235,Nicolas Deslauriers,L,PHI,33,0,0,0,0
98,8482476,Emil Heineman,L,MTL,23,0,0,0,0
98,8477149,Scott Sabourin,R,SJS,32,0,0,0,0
98,8483549,Lucas Condotta,L,MTL,27,0,0,0,0
98,8482765,Isak Rosen,R,BUF,21,0,0,0,0
98,8481237,Kyle MacLean,C,NYI,25,0,0,0,0
98,8481024,Linus Karlsson,C,VAN,25,0,0,0,0
98,8481690,Tyler Angle,C,,24,0,0,0,0
98,8483570,Ben Meyers,C,SEA,26,0,0,0,0
98,8481655,Cole Schwindt,R,CGY,23,0,0,0,0
98,8481462,Mason Morelli,L,VGK,28,0,0,0,0
98,8483401,Marc Johnstone,R,PIT,28,0,0,0,0
98,8478956,Samuel Laberge,L,NJD,27,0,0,0,0
98,8479533,Joona Koppanen,L,,26,0,0,0,0
98,8482197,Adam Raska,R,MIN,23,0,0,0,0
98,8482250,Callahan Burke,C,VGK,27,0,0,0,0
98,8482784,Zach Dean,C,STL,21,0,0,0,0
98,8484255,Jason Polin,R,COL,25,0,0,0,0
98,8481077,John Leonard,L,,26,0,0,0,0
98,8481534,Raphael Lavoie,C,EDM,24,0,0,0,0
98,8483609,Adam Klapka,R,CGY,24,0,0,0,0
98,8482751,Ryan Winterton,C,SEA,21,0,0,0,0
98,8480267,Sammy Walker,C,MIN,25,0,0,0,0
98,8475766,Austin Watson,L,,32,0,0,0,0
98,8482460,Matt Rempe,C,NYR,22,0,0,0,0
98,8481065,Angus Crookshank,L,OTT,25,0,0,0,0
98,8481070,Hugh McGing,L,,26,0,0,0,0
98,8476323,Max McCormick,L,SEA,32,0,0,0,0
98,8483395,Arshdeep Bains,L,VAN,23,0,0,0,0
98,8484259,Ondrej Pavel,C,COL,31,0,0,0,0
98,8483432,Luca Del Bel Belluz,C,CBJ,31,0,0,0,0
98,8483045,Cameron Butler,R,CBJ,31,0,0,0,0
98,8482061,Brandon Biro,L,SEA,26,0,0,0,0
98,8477401,John Hayden,C,SEA,29,0,0,0,0
98,8475278,Byron Froese,C,,33,0,0,0,0
98,8478446,Glenn Gawdin,C,LAK,27,0,0,0,0
98,8477993,Justin Kirkland,C,CGY,28,0,0,0,0
98,8482147,Jean-Luc Foudy,C,COL,22,0,0,0,0
98,8480032,Shane Bowers,C,NJD,25,0,0,0,0
98,8479330,Brandon Gignac,C,MTL,27,0,0,0,0
98,8480776,Sheldon Rempal,R,,29,0,0,0,0
98,8475413,Justin Dowling,C,NJD,34,0,0,0,0
98,8481726,Adam Edstrom,C,NYR,24,0,0,0,0
98,8480844,Grigori Denisenko,L,VGK,24,0,0,0,0
98,8478147,Bokondji Imama,L,PIT,28,0,0,0,0
98,8478881,Brett Seney,L,CHI,28,0,0,0,0
98,8483630,Pavol Regenda,L,ANA,25,0,0,0,0
98,8480836,Jonathan Gruden,C,,24,0,0,0,0
98,8484314,Jiri Smejkal,L,,28,0,0,0,0
98,8475780,Chris Wagner,R,COL,33,0,0,0,0
98,8479546,Oskar Steen,C,,26,0,0,0,0
98,8483597,Milos Kelemen,L,UTA,25,0,0,0,0
98,8481789,Tye Kartye,L,SEA,23,0,0,0,0
98,8484325,Waltteri Merela,C,TBL,26,0,0,0,0
98,8479421,Jacob Moverare,D,LAK,26,0,0,0,0
98,8481585,Egor Afanasyev,L,SJS,23,0,0,0,0
98,8479547,Matthew Phillips,R,,26,0,0,0,0
98,8479367,William Lockwood,R,FLA,26,0,0,0,0
98,8476915,Jujhar Khaira,L,,30,0,0,0,0
98,8481422,Jacob Lucchini,C,NSH,29,0,0,0,0
98,8480468,James Hamblin,L,EDM,25,0,0,0,0
98,8478051,Max Willman,C,NJD,29,0,0,0,0
98,8481556,John Beecher,C,BOS,23,0,0,0,0
98,8478078,Rourke Chartier,C,,28,0,0,0,0
99,8479318,Auston Matthews,C,TOR,27,82,83,57,140
99,8478402,Connor McDavid,C,EDM,27,82,43,97,140
99,8477492,Nathan MacKinnon,C,COL,29,82,45,94,139
99,8478550,Artemi Panarin,L,NYR,33,82,36,85,121
99,8477934,Leon Draisaitl,C,EDM,29,82,44,73,117
99,8479314,Matthew Tkachuk,L,FLA,27,82,40,77,117
99,8477956,David Pastrnak,R,BOS,28,82,52,61,113
99,8476453,Nikita Kucherov,R,TBL,31,82,34,79,113
99,8481559,Jack Hughes,C,NJD,23,82,45,64,109
99,8477946,Dylan Larkin,C,DET,28,82,45,64,109
99,8477939,William Nylander,R,TOR,28,82,45,63,108
99,8476468,J.T. Miller,C,VAN,31,82,37,70,107
99,8477942,Kevin Fiala,L,LAK,28,82,34,70,104
99,8480800,Quinn Hughes,D,VAN,25,82,15,87,102
99,8471675,Sidney Crosby,C,PIT,37,82,35,66,101
99,8479407,Jesper Bratt,L,NJD,26,82,40,58,98
99,8480069,Cale Makar,D,COL,26,82,31,67,98
99,8479343,Clayton Keller,R,UTA,26,82,50,47,97
99,8480801,Brady Tkachuk,L,OTT,25,82,47,50,97
99,8477493,Aleksander Barkov,C,FLA,29,82,21,76,97
99,8478445,Mathew Barzal,C,NYI,27,82,27,69,96
99,8471214,Alex Ovechkin,L,WSH,39,82,50,45,95
99,8478864,Kirill Kaprizov,L,MIN,27,82,37,58,95
99,8480012,Elias Pettersson,C,VAN,26,82,35,59,94
99,8480023,Robert Thomas,C,STL,25,82,25,69,94
99,8474600,Roman Josi,D,NSH,34,82,18,75,93
99,8477933,Sam Reinhart,C,FLA,29,82,41,51,92
99,8477409,Carter Verhaeghe,C,FLA,29,82,43,48,91
99,8475913,Mark Stone,R,VGK,32,82,38,52,90
99,8478420,Mikko Rantanen,R,COL,28,82,31,59,90
99,8476887,Filip Forsberg,L,NSH,30,82,39,49,88
99,8480027,Jason Robertson,L,DAL,25,82,36,51,87
99,8476454,Ryan Nugent-Hopkins,C,EDM,31,82,18,69,87
99,8478010,Brayden Point,C,TBL,28,82,41,45,86
99,8474564,Steven Stamkos,C,NSH,34,82,39,47,86
99,8478403,Jack Eichel,C,VGK,28,82,38,48,86
99,8475166,John Tavares,C,TOR,34,82,32,54,86
99,8480002,Nico Hischier,C,NJD,25,82,34,51,85
99,8481523,Kirby Dach,C,MTL,23,82,14,71,85
99,8477951,Nick Schmaltz,C,UTA,28,82,29,55,84
99,8475786,Zach Hyman,L,EDM,32,82,49,34,83
99,8482078,Lucas Raymond,L,DET,22,82,29,54,83
99,8476346,Johnny Gaudreau,L,CBJ,31,82,25,57,82
99,8479385,Jordan Kyrou,C,STL,26,82,46,35,81
99,8479323,Adam Fox,D,NYR,26,82,14,67,81
99,8476853,Morgan Rielly,D,TOR,30,82,14,67,81
99,8477404,Jake Guentzel,C,TBL,30,82,36,44,80
99,8477402,Pavel Buchnevich,L,STL,29,82,36,44,80
99,8475184,Chris Kreider,L,NYR,33,82,50,29,79
99,8477949,Alex Tuch,R,BUF,28,82,29,50,79
99,8478427,Sebastian Aho,C,CAR,27,82,26,53,79
99,8478493,Joel Eriksson Ek,C,MIN,27,82,39,39,78
99,8475810,Bryan Rust,R,PIT,32,82,38,40,78
99,8477960,Adrian Kempe,R,LAK,28,82,34,44,78
99,8479337,Alex DeBrincat,R,DET,27,82,34,44,78
99,8475172,Nazem Kadri,C,CGY,34,82,31,46,77
99,8475726,Tyler Toffoli,C,SJS,32,82,31,46,77
99,8480830,Andrei Svechnikov,R,CAR,24,82,27,50,77
99,8475798,Mikael Granlund,C,SJS,32,82,21,56,77
99,8475754,Brock Nelson,C,NYI,33,82,38,38,76
99,8471215,Evgeni Malkin,C,PIT,38,82,31,45,76
99,8479542,Brandon Hagel,L,TBL,26,82,30,46,76
99,8475692,Mats Zuccarello,R,MIN,37,82,17,59,76
99,8473419,Brad Marchand,L,BOS,36,82,36,39,75
99,8479420,Tage Thompson,C,BUF,27,82,34,41,75
99,8478398,Kyle Connor,L,WPG,28,82,33,42,75
99,8476389,Vincent Trocheck,C,NYR,31,82,36,38,74
99,8474141,Patrick Kane,R,DET,36,82,28,46,74
99,8481557,Matt Boldy,L,MIN,23,82,24,50,74
99,8471685,Anze Kopitar,C,LAK,37,82,23,51,74
99,8476448,William Karlsson,C,VGK,31,82,39,34,73
99,8475784,Jeff Skinner,C,EDM,32,82,32,40,72
99,8476462,Dougie Hamilton,D,NJD,31,82,26,46,72
99,8482684,Luke Hughes,D,NJD,21,82,12,59,71
99,8477501,Valeri Nichushkin,R,COL,29,82,32,38,70
99,8478444,Brock Boeser,R,VAN,27,82,31,39,70
99,8478439,Travis Konecny,R,PHI,27,82,28,42,70
99,8480208,Drake Batherson,R,OTT,26,82,27,43,70
99,8477940,Nikolaj Ehlers,L,WPG,28,82,25,45,70
99,8478975,Mason Marchment,L,DAL,29,82,25,45,70
99,8482116,Tim Stützle,C,OTT,22,82,24,46,70
99,8478401,Pavel Zacha,C,BOS,27,82,23,47,70
99,8477503,Max Domi,C,TOR,29,82,21,49,70
99,8477504,Josh Morrissey,D,WPG,29,82,15,55,70
99,8482665,Matty Beniers,C,SEA,22,82,30,39,69
99,8479999,Casey Mittelstadt,C,COL,26,82,26,43,69
99,8475168,Matt Duchene,C,DAL,33,82,24,45,69
99,8477955,Jared McCann,L,SEA,28,82,35,33,68
99,8477500,Bo Horvat,C,NYI,29,82,33,35,68
99,8478449,Roope Hintz,C,DAL,28,82,31,37,68
99,8480018,Nick Suzuki,C,MTL,25,82,25,43,68
99,8478440,Dylan Strome,C,WSH,27,82,24,44,68
99,8476539,Jonathan Marchessault,R,NSH,34,82,38,29,67
99,8479339,Patrik Laine,L,CBJ,26,82,37,30,67
99,8476459,Mika Zibanejad,C,NYR,31,82,20,47,67
99,8474590,John Carlson,D,WSH,34,82,15,52,67
99,8476460,Mark Scheifele,C,WPG,31,82,31,35,66
99,8481068,Yegor Sharangovich,C,CGY,26,82,27,39,66
99,8478047,Michael Bunting,L,PIT,29,82,25,41,66
99,8475167,Victor Hedman,D,TBL,34,82,12,54,66
99,8475158,Ryan O'Reilly,C,NSH,33,82,33,32,65
99,8480803,Evan Bouchard,D,EDM,25,82,13,52,65
99,8476826,Yanni Gourde,C,SEA,33,82,26,38,64
99,8477476,Artturi Lehkonen,L,COL,29,82,25,39,64
99,8482124,Quinton Byfield,R,LAK,22,82,23,41,64
99,8474578,Erik Karlsson,D,PIT,34,82,14,50,64
99,8481540,Cole Caufield,R,MTL,23,82,37,26,63
99,8479675,Trevor Moore,L,LAK,29,82,29,34,63
99,8475765,Vladimir Tarasenko,R,DET,33,82,28,35,63
99,8481528,Dylan Cozens,C,BUF,23,82,18,45,63
99,8480036,Miro Heiskanen,D,DAL,25,82,14,49,63
99,8482109,Alexis Lafrenière,L,NYR,23,82,30,32,62
99,8478469,Thomas Chabot,D,OTT,27,82,15,47,62
99,8479325,Charlie McAvoy,D,BOS,27,82,7,55,62
99,8480014,Gabriel Vilardi,C,WPG,25,82,32,29,61
99,8475763,Kevin Hayes,R,PIT,32,82,26,35,61
99,8478042,Viktor Arvidsson,R,EDM,31,82,21,40,61
99,8478498,Jake DeBrusk,L,VAN,28,82,35,25,60
99,8477416,Oliver Bjorkstrand,R,SEA,29,82,28,32,60
99,8475170,Brayden Schenn,C,STL,33,82,27,33,60
99,8476456,Jonathan Huberdeau,C,CGY,31,82,17,43,60
99,8476905,Chandler Stephenson,C,SEA,30,82,13,47,60
99,8477407,Anthony Duclair,L,NYI,29,82,31,28,59
99,8480849,Barrett Hayton,C,UTA,24,82,28,31,59
99,8482093,Seth Jarvis,C,CAR,22,82,26,33,59
99,8480220,Noah Cates,L,PHI,25,82,25,34,59
99,8477496,Elias Lindholm,C,BOS,30,82,22,37,59
99,8478460,Zach Werenski,D,CBJ,27,82,15,44,59
99,8480434,Sean Durzi,D,UTA,26,82,9,50,59
99,8478366,Frank Vatrano,R,ANA,30,82,32,26,58
99,8482740,Wyatt Johnston,C,DAL,21,82,25,33,58
99,8479425,Filip Hronek,D,VAN,27,82,12,46,58
99,8478414,Timo Meier,R,NJD,28,82,30,27,57
99,8477935,Sam Bennett,C,FLA,28,82,27,30,57
99,8476880,Tom Wilson,R,WSH,30,82,27,30,57
99,8475151,Kyle Palmieri,C,NYI,33,82,26,31,57
99,8477511,Anthony Mantha,R,CGY,30,82,24,33,57
99,8479400,Pierre-Luc Dubois,L,WSH,26,82,23,34,57
99,8475794,Tyler Seguin,C,DAL,32,82,22,35,57
99,8473986,Alex Killorn,L,ANA,35,82,22,35,57
99,8478873,Troy Terry,R,ANA,27,82,20,37,57
99,8480839,Rasmus Dahlin,D,BUF,24,82,19,38,57
99,8477447,Shea Theodore,D,VGK,29,82,13,44,57
99,8477497,Sean Monahan,C,CBJ,30,82,24,32,56
99,8474102,David Perron,L,OTT,36,82,23,33,56
99,8473994,Jamie Benn,L,DAL,35,82,20,36,56
99,8481596,Shane Pinto,C,OTT,24,82,17,39,56
99,8480893,Kirill Marchenko,R,CBJ,24,82,30,25,55
99,8471698,T.J. Oshie,R,WSH,38,82,29,26,55
99,8480009,Eeli Tolvanen,R,SEA,25,82,29,26,55
99,8480039,Martin Necas,C,CAR,25,82,28,27,55
99,8482097,Jack Quinn,R,BUF,23,82,24,31,55
99,8473512,Claude Giroux,R,OTT,36,82,23,32,55
99,8477021,Alex Kerfoot,C,UTA,30,82,22,33,55
99,8474563,Drew Doughty,D,LAK,35,82,16,39,55
99,8482159,Tyson Foerster,R,PHI,22,82,31,23,54
99,8477494,Jonathan Drouin,L,COL,29,82,28,26,54
99,8481533,Trevor Zegras,C,ANA,23,82,24,30,54
99,8476881,Tomas Hertl,C,VGK,31,82,20,34,54
99,8482149,Cole Perfetti,C,WPG,22,82,15,39,54
99,8478397,Rasmus Andersson,D,CGY,28,82,12,42,54
99,8476432,Boone Jenner,C,CBJ,31,82,34,19,53
99,8480064,Josh Norris,C,OTT,25,82,30,23,53
99,8476399,Blake Coleman,C,CGY,33,82,29,24,53
99,8474679,Gustav Nyquist,C,NSH,35,82,19,34,53
99,8478438,Tommy Novak,C,NSH,27,82,18,35,53
99,8477495,Seth Jones,D,CHI,30,82,17,36,53
99,8473422,Nick Foligno,L,CHI,37,82,15,38,53
99,8479525,Ross Colton,C,COL,28,82,31,21,52
99,8478233,Andrew Mangiapane,L,WSH,28,82,26,26,52
99,8480188,Fabian Zetterlund,L,SJS,25,82,23,29,52
99,8481581,Thomas Harley,D,DAL,23,82,19,33,52
99,8480028,Morgan Frost,C,PHI,25,82,15,37,52
99,8471724,Kris Letang,D,PIT,37,82,13,39,52
99,8480798,Philipp Kurashev,C,CHI,25,82,12,40,52
99,8476483,Rickard Rakell,R,PIT,31,82,27,24,51
99,8482110,Dawson Mercer,C,NJD,23,82,25,26,51
99,8474641,Adam Henrique,C,EDM,34,82,24,27,51
99,8477964,Ivan Barbashev,C,VGK,29,82,22,29,51
99,8478856,Conor Garland,R,VAN,28,82,18,33,51
99,8477444,Andre Burakovsky,L,SEA,29,82,18,33,51
99,8478407,Vince Dunn,D,SEA,28,82,15,36,51
99,8477986,Brandon Montour,D,SEA,30,82,13,38,51
99,8480797,Joel Farabee,L,PHI,24,82,25,25,50
99,8477429,Andrew Copp,C,DET,30,82,18,32,50
99,8480865,Noah Dobson,D,NYI,24,82,5,45,50
99,8476882,Teuvo Teravainen,L,CHI,30,82,21,28,49
99,8478891,Mason Appleton,C,WPG,28,82,17,32,49
99,8474586,Jordan Eberle,R,SEA,34,82,15,34,49
99,8478057,Dakota Joshua,C,VAN,28,82,32,16,48
99,8482113,Anton Lundell,C,FLA,23,82,26,22,48
99,8480185,Eetu Luostarinen,C,FLA,26,82,20,28,48
99,8474150,Mikael Backlund,C,CGY,35,82,19,29,48
99,8476458,Ryan Strome,C,ANA,31,82,18,30,48
99,8477953,Kasperi Kapanen,R,STL,28,82,18,30,48
99,8477948,Travis Sanheim,D,PHI,28,82,15,33,48
99,8477346,MacKenzie Weegar,D,CGY,30,82,13,35,48
99,8476875,Mike Matheson,D,MTL,30,82,12,36,48
99,8480015,Owen Tippett,R,PHI,25,82,25,22,47
99,8482175,JJ Peterka,R,BUF,22,82,24,23,47
99,8475191,Reilly Smith,R,NYR,33,82,19,28,47
99,8478472,Mathieu Joseph,R,STL,27,82,16,31,47
99,8480871,Adam Boqvist,D,FLA,24,82,12,35,47
99,8476869,Brady Skjei,D,NSH,30,82,11,36,47
99,8477456,J.T. Compher,L,DET,29,82,22,24,46
99,8482745,Mason McTavish,C,ANA,21,82,21,25,46
99,8475791,Taylor Hall,L,CHI,33,82,19,27,46
99,8475149,Marcus Johansson,L,MIN,34,82,19,27,46
99,8474053,Logan Couture,C,SJS,35,82,17,29,46
99,8480113,Alex Iafallo,L,WPG,31,82,17,29,46
99,8481560,Arthur Kaliyev,R,LAK,23,82,17,29,46
99,8478519,Anthony Cirelli,C,TBL,27,82,15,31,46
99,8477451,Ryan Hartman,R,MIN,30,82,14,32,46
99,8475169,Evander Kane,L,EDM,33,82,25,20,45
99,8476480,Vladislav Namestnikov,C,WPG,32,82,22,23,45
99,8482720,Matthew Knies,L,TOR,22,82,21,24,45
99,8474149,Evgenii Dadonov,R,DAL,35,82,20,25,45
99,8476479,Phillip Danault,C,LAK,31,82,17,28,45
99,8482105,Jake Sanderson,D,OTT,22,82,14,31,45
99,8481711,Matias Maccelli,L,UTA,24,82,12,33,45
99,8475799,Nino Niederreiter,R,WPG,32,82,25,19,44
99,8481580,Connor McMichael,C,WSH,23,82,24,20,44
99,8483808,Andrei Kuzmenko,L,CGY,28,82,22,22,44
99,8478542,Evan Rodrigues,C,FLA,31,82,21,23,44
99,8476292,Ondrej Palat,L,NJD,33,82,14,30,44
99,8482667,William Eklund,L,SJS,22,82,13,31,44
99,8475287,Erik Haula,L,NJD,33,82,10,34,44
99,8478396,Noah Hanifin,D,VGK,27,82,8,36,44
99,8480873,Rasmus Sandin,D,WSH,24,82,6,38,44
99,8480043,Timothy Liljegren,D,TOR,25,82,6,38,44
99,8480855,Jack McBain,C,UTA,24,82,26,17,43
99,8477426,Nicholas Paul,L,TBL,29,82,22,21,43
99,8481604,Pavel Dorofeyev,L,VGK,24,82,22,21,43
99,8475745,Charlie Coyle,C,BOS,32,82,21,22,43
99,8482699,Dylan Guenther,R,UTA,21,82,21,22,43
99,8475768,Jaden Schwartz,C,SEA,32,82,21,22,43
99,8480813,Joe Veleno,C,DET,24,82,21,22,43
99,8482055,Drew O'Connor,L,PIT,26,82,19,24,43
99,8480078,Filip Chytil,C,NYR,25,82,18,25,43
99,8477479,Tyler Bertuzzi,L,CHI,29,82,17,26,43
99,8476392,Adam Lowry,C,WPG,31,82,16,27,43
99,8477932,Aaron Ekblad,D,FLA,28,82,13,30,43
99,8481546,Cam York,D,PHI,23,82,7,36,43
99,8476474,Stefan Noesen,R,NJD,31,82,24,18,42
99,8475220,Marcus Foligno,L,MIN,33,82,21,21,42
99,8481582,Nicholas Robertson,L,TOR,23,82,21,21,42
99,8478458,Jack Roslovic,C,CAR,27,82,16,26,42
99,8476885,Jacob Trouba,D,NYR,30,82,10,32,42
99,8474565,Alex Pietrangelo,D,VGK,34,82,8,34,42
99,8475848,Brendan Gallagher,R,MTL,32,82,20,21,41
99,8477498,Darnell Nurse,D,EDM,29,82,17,24,41
99,8478474,Lawson Crouse,L,UTA,27,82,16,25,41
99,8476872,Scott Laughton,C,PHI,30,82,13,28,41
99,8476792,Torey Krug,D,STL,33,82,11,30,41
99,8481542,Moritz Seider,D,DET,23,82,8,33,41
99,8479345,Jakob Chychrun,D,WSH,26,82,8,33,41
99,8477987,Ryan Donato,C,CHI,28,82,21,19,40
99,8479987,Morgan Geekie,C,BOS,26,82,18,22,40
99,8476419,Jean-Gabriel Pageau,C,NYI,32,82,14,26,40
99,8480145,Neal Pionk,D,WPG,29,82,13,27,40
99,8476923,Damon Severson,D,CBJ,30,82,11,29,40
99,8481656,Aliaksei Protas,C,WSH,23,82,8,32,40
99,8476892,Colton Parayko,D,STL,31,82,7,33,40
99,8476958,Jaccob Slavin,D,CAR,30,82,6,34,40
99,8480829,Jesperi Kotkaniemi,C,CAR,24,82,20,19,39
99,8478463,Anthony Beauvillier,L,PIT,27,82,19,20,39
99,8477952,Robby Fabbri,C,ANA,28,82,18,21,39
99,8475714,Calle Jarnkrok,C,TOR,33,82,18,21,39
99,8480144,David Kampf,C,TOR,29,82,15,24,39
99,8479351,Sam Steel,C,DAL,26,82,15,24,39
99,8482475,Yegor Chinakhov,R,CBJ,23,82,12,27,39
99,8482660,Kent Johnson,C,CBJ,22,82,12,27,39
99,8476461,Sean Couturier,C,PHI,32,82,12,27,39
99,8476906,Shayne Gostisbehere,D,CAR,31,82,10,29,39
99,8475753,Justin Faulk,D,STL,32,82,9,30,39
99,8475764,Cam Fowler,D,ANA,33,82,4,35,39
99,8475314,Anders Lee,L,NYI,34,82,23,15,38
99,8481535,Nils Hoglander,L,VAN,24,82,21,17,38
99,8474715,Cam Atkinson,R,TBL,35,82,20,18,38
99,8478413,Jordan Greenway,L,BUF,27,82,17,21,38
99,8481013,Jonatan Berggren,R,DET,24,82,15,23,38
99,8480802,Ryan McLeod,C,BUF,25,82,14,24,38
99,8476463,Jonas Brodin,D,MIN,31,82,9,29,38
99,8476854,Hampus Lindholm,D,BOS,30,82,8,30,38
99,8484144,Connor Bedard,C,CHI,19,82,22,15,37
99,8476927,Teddy Blueger,C,VAN,30,82,17,20,37
99,8478046,Danton Heinen,L,VAN,29,82,16,21,37
99,8478462,Nicolas Roy,C,VGK,27,82,14,23,37
99,8475722,Jason Zucker,L,BUF,32,82,13,24,37
99,8477989,Christian Dvorak,C,MTL,28,82,12,25,37
99,8480817,K'Andre Miller,D,NYR,24,82,9,28,37
99,8479410,Mikhail Sergachev,D,UTA,26,82,6,31,37
99,8481554,Kaapo Kakko,R,NYR,23,82,22,14,36
99,8476981,Josh Anderson,R,MTL,30,82,22,14,36
99,8482089,Jake Neighbours,L,STL,22,82,18,18,36
99,8475793,Ryan Johansen,C,PHI,32,82,18,18,36
99,8480336,Sean Walker,D,CAR,30,82,13,23,36
99,8482146,Luke Evangelista,R,NSH,22,82,13,23,36
99,8479353,Brett Howden,C,VGK,26,82,13,23,36
99,8470613,Brent Burns,D,CAR,39,82,12,24,36
99,8479293,Brandon Tanev,L,SEA,33,82,18,17,35
99,8482092,Ridly Greig,C,OTT,22,82,18,17,35
99,8475193,Tomas Tatar,L,NJD,34,82,16,19,35
99,8482117,Lukas Reichel,L,CHI,22,82,14,21,35
99,8476329,Travis Boyd,C,MIN,31,82,13,22,35
99,8477947,Sonny Milano,L,WSH,28,82,11,24,35
99,8475200,Dmitry Orlov,D,CAR,33,82,9,26,35
99,8480003,Jesper Boqvist,C,FLA,26,82,9,26,35
99,8476925,Colton Sissons,C,NSH,31,82,9,26,35
99,8478038,Devon Toews,D,COL,30,82,6,29,35
99,8477506,Ryan Pulock,D,NYI,30,82,6,29,35
99,8477969,Marcus Pettersson,D,PIT,28,82,2,33,35
99,8476469,Joel Armia,R,MTL,31,82,19,15,34
99,8478432,Christian Fischer,R,DET,27,82,15,19,34
99,8483515,Juraj Slafkovsky,L,MTL,20,82,13,21,34
99,8480074,Alexandre Texier,C,STL,25,82,13,21,34
99,8480789,Oliver Wahlstrom,R,NYI,24,82,13,21,34
99,8481704,Juuso Parssinen,C,NSH,23,82,13,21,34
99,8479591,Michael Eyssimont,C,TBL,28,82,12,22,34
99,8473563,Nicklas Backstrom,C,WSH,37,82,11,23,34
99,8479976,Juuso Valimaki,D,UTA,26,82,7,27,34
99,8476979,Erik Gustafsson,D,DET,32,82,5,29,34
99,8476902,Esa Lindell,D,DAL,30,82,5,29,34
99,8482079,Marco Rossi,C,MIN,23,82,18,15,33
99,8476438,Brandon Saad,L,STL,32,82,17,16,33
99,8480806,Isac Lundestrom,C,ANA,25,82,16,17,33
99,8474189,Lars Eller,C,PIT,35,82,16,17,33
99,8477919,Frederick Gaudreau,C,MIN,31,82,15,18,33
99,8477450,Jason Dickinson,C,CHI,29,82,15,18,33
99,8478109,Victor Olofsson,L,VGK,29,82,13,20,33
99,8483482,Tristan Luneau,D,ANA,20,82,13,20,33
99,8478055,Gustav Forsling,D,FLA,28,82,11,22,33
99,8480068,Ryan Poehling,C,PHI,25,82,10,23,33
99,8483445,Cutter Gauthier,L,ANA,20,82,9,24,33
99,8479998,Mikey Anderson,D,LAK,25,82,2,31,33
99,8476931,Jake McCabe,D,TOR,31,82,2,31,33
99,8479365,Trent Frederic,C,BOS,26,82,19,13,32
99,8479996,Cody Glass,C,NSH,25,82,19,13,32
99,8479941,Justin Danforth,R,CBJ,31,82,18,14,32
99,8470621,Corey Perry,R,EDM,39,82,17,15,32
99,8473533,Jordan Staal,C,CAR,36,82,15,17,32
99,8476278,Colin Blackwell,C,DAL,31,82,15,17,32
99,8481618,Alex Newhook,C,MTL,23,82,14,18,32
99,8477998,Warren Foegele,L,LAK,28,82,14,18,32
99,8481481,Blake Lizotte,C,PIT,27,82,14,18,32
99,8481553,Bobby Brink,R,PHI,23,82,12,20,32
99,8476624,Barclay Goodrow,C,SJS,31,82,11,21,32
99,8475218,Mattias Ekholm,D,EDM,34,82,6,26,32
99,8482087,Kaiden Guhle,D,MTL,22,82,5,27,32
99,8482142,Jamie Drysdale,D,PHI,22,82,2,30,32
99,8476918,Jimmy Vesey,L,NYR,31,82,17,14,31
99,8480835,Jack Drury,C,CAR,24,82,17,14,31
99,8479992,Michael Rasmussen,C,DET,25,82,13,18,31
99,8476960,Andreas Athanasiou,C,CHI,30,82,13,18,31
99,8476442,Matt Nieto,L,PIT,32,82,13,18,31
99,8476374,Sean Kuraly,C,CBJ,31,82,11,20,31
99,8482705,Cole Sillinger,C,CBJ,21,82,10,21,31
99,8480748,Kiefer Sherwood,L,VAN,29,82,10,21,31
99,8476422,Mike Reilly,D,NYI,31,82,9,22,31
99,8473507,Jeff Petry,D,DET,37,82,6,25,31
99,8475690,Chris Tanev,D,TOR,35,82,2,29,31
99,8479398,Samuel Girard,D,COL,26,82,1,30,31
99,8481093,Rafael Harvey-Pinard,L,MTL,25,82,20,10,30
99,8479393,Noah Gregor,C,OTT,26,82,18,12,30
99,8483431,Logan Cooley,C,UTA,20,82,16,14,30
99,8479390,Taylor Raddysh,R,WSH,26,82,14,16,30
99,8476897,Oskar Sundqvist,C,STL,30,82,10,20,30
99,8480995,Pontus Holmberg,R,TOR,25,82,10,20,30
99,8481606,Jordan Spence,D,LAK,23,82,8,22,30
99,8482122,Brock Faber,D,MIN,22,82,7,23,30
99,8482671,Owen Power,D,BUF,22,82,6,24,30
99,8478115,Pierre Engvall,L,NYI,28,82,16,13,29
99,8479414,Nathan Bastian,R,NJD,27,82,15,14,29
99,8475855,Jesper Fast,R,CAR,33,82,15,14,29
99,8479661,Tanner Jeannot,L,LAK,27,82,15,14,29
99,8479368,Max Jones,L,BOS,26,82,15,14,29
99,8475760,Nick Bjugstad,C,UTA,32,82,14,15,29
99,8481624,Ilya Mikheyev,R,CHI,30,82,13,16,29
99,8477369,Carson Soucy,D,VAN,30,82,12,17,29
99,8477353,Tyler Motte,C,DET,29,82,12,17,29
99,8482133,Thomas Bordeleau,C,SJS,22,82,11,18,29
99,8482807,Ethan Del Mastro,D,CHI,21,82,11,18,29
99,8483468,Jiri Kulich,C,BUF,20,82,10,19,29
99,8478911,Matt Roy,D,WSH,29,82,8,21,29
99,8478133,Jake Evans,C,MTL,28,82,8,21,29
99,8475171,Oliver Ekman-Larsson,D,TOR,33,82,6,23,29
99,8477435,Ryan Graves,D,PIT,29,82,6,23,29
99,8478507,John Marino,D,UTA,27,82,3,26,29
99,8474574,Tyler Myers,D,VAN,34,82,3,26,29
99,8482259,Bobby McMann,C,TOR,28,82,18,10,28
99,8480459,Pius Suter,C,VAN,28,82,16,12,28
99,8482125,Alexander Holtz,R,VGK,22,82,12,16,28
99,8482702,Logan Stankoven,C,DAL,21,82,12,16,28
99,8476921,Jordan Martinook,L,CAR,32,82,10,18,28
99,8481522,Peyton Krebs,C,BUF,23,82,9,19,28
99,8474716,Jared Spurgeon,D,MIN,35,82,8,20,28
99,8484166,Adam Fantilli,C,CBJ,20,82,7,21,28
99,8475188,Brayden McNabb,D,VGK,33,82,6,22,28
99,8481178,Egor Zamula,D,PHI,24,82,4,24,28
99,8482655,J.J. Moser,D,TBL,24,82,1,27,28
99,8477015,Connor Brown,R,EDM,30,82,16,11,27
99,8476878,Zemgus Girgensons,L,TBL,30,82,16,11,27
99,8479291,Kevin Rooney,C,CGY,31,82,15,12,27
99,8477903,Garnet Hathaway,R,PHI,33,82,13,14,27
99,8481032,Paul Cotter,C,NJD,25,82,11,16,27
99,8482803,Olen Zellweger,D,ANA,21,82,8,19,27
99,8482111,Justin Barron,D,MTL,23,82,7,20,27
99,8474673,TJ Brodie,D,CHI,34,82,7,20,27
99,8470600,Ryan Suter,D,STL,39,82,5,22,27
99,8478882,Vladislav Gavrikov,D,LAK,29,82,4,23,27
99,8479402,Jake Bean,D,CGY,26,82,3,24,27
99,8478136,Jake Middleton,D,MIN,28,82,3,24,27
99,8475324,Nick Jensen,D,OTT,34,82,3,24,27
99,8475181,Nick Leddy,D,STL,33,82,3,24,27
99,8476429,Scott Mayfield,D,NYI,32,82,3,24,27
99,8480021,Jack Studnicka,C,LAK,25,82,14,12,26
99,8484145,Zach Benson,L,BUF,19,82,13,13,26
99,8477425,Miles Wood,L,COL,29,82,11,15,26
99,8480980,Connor Dewar,C,TOR,25,82,11,15,26
99,8475343,Nic Dowd,C,WSH,34,82,8,18,26
99,8480222,Sebastian Aho,D,PIT,28,82,4,22,26
99,8479371,Dante Fabbro,D,NSH,26,82,2,24,26
99,8476873,Mark Jankowski,C,NSH,30,82,14,11,25
99,8482074,Connor Zary,C,CGY,23,82,13,12,25
99,8481186,Logan O'Connor,R,COL,28,82,12,13,25
99,8477507,Nikita Zadorov,D,BOS,29,82,8,17,25
99,8477931,Tomas Nosek,L,FLA,32,82,6,19,25
99,8481014,Alexander Romanov,D,NYI,24,82,6,19,25
99,8474151,Ryan McDonagh,D,TBL,35,82,5,20,25
99,8476331,Dylan DeMelo,D,WPG,31,82,4,21,25
99,8479369,Andrew Peeke,D,BOS,26,82,4,21,25
99,8476457,Adam Larsson,D,SEA,32,82,4,21,25
99,8476879,Cody Ceci,D,EDM,31,82,3,22,25
99,8478500,Ivan Provorov,D,CBJ,27,82,2,23,25
99,8476467,Jamie Oleksiak,D,SEA,32,82,2,23,25
99,8478851,Alexandre Carrier,D,NSH,28,82,1,24,25
99,8477839,Conor Sheary,L,TBL,32,82,13,11,24
99,8483457,Lane Hutson,D,MTL,20,82,13,11,24
99,8479316,Luke Kunin,C,SJS,27,82,12,12,24
99,8481517,Brett Leason,R,ANA,25,82,10,14,24
99,8484153,Leo Carlsson,C,ANA,20,82,9,15,24
99,8478211,Dryden Hunt,L,CGY,29,82,9,15,24
99,8476312,Josh Manson,D,COL,33,82,7,17,24
99,8482624,Daniil Miromanov,D,CGY,27,82,6,18,24
99,8481568,Alex Vlasic,D,CHI,23,82,5,19,24
99,8482073,Braden Schneider,D,NYR,23,82,4,20,24
99,8476967,Brett Kulak,D,EDM,30,82,4,20,24
99,8482245,Artem Zub,D,OTT,29,82,2,22,24
99,8478443,Brandon Carlo,D,BOS,28,82,2,22,24
99,8478020,Michael Amadio,C,OTT,28,82,12,11,23
99,8480025,MacKenzie Entwistle,R,FLA,25,82,12,11,23
99,8478508,Yakov Trenin,C,MIN,27,82,11,12,23
99,8478013,Jake Walman,D,SJS,28,82,9,14,23
99,8481028,Martin Pospisil,C,CGY,25,82,8,15,23
99,8475462,Radko Gudas,D,ANA,34,82,5,18,23
99,8480049,Dylan Samberg,D,WPG,25,82,4,19,23
99,8481708,Zac Jones,D,NYR,24,82,3,20,23
99,8481567,Henry Thrun,D,SJS,23,82,3,20,23
99,8484203,Bradly Nadeau,L,CAR,19,82,2,21,23
99,8475455,Brenden Dillon,D,NJD,34,82,2,21,23
99,8478416,Erik Cernak,D,TBL,27,82,2,21,23
99,8482155,Alex Laferriere,R,LAK,23,82,18,4,22
99,8482062,Cole Smith,L,NSH,29,82,15,7,22
99,8483567,Georgii Merkulov,C,BOS,24,82,13,9,22
99,8481477,Nico Sturm,C,SJS,29,82,11,11,22
99,8478569,Noel Acciari,C,PIT,33,82,11,11,22
99,8482153,Brendan Brisson,C,VGK,23,82,8,14,22
99,8477488,Brett Pesce,D,NJD,30,82,6,16,22
99,8477845,Trevor van Riemsdyk,D,WSH,33,82,4,18,22
99,8480281,Alexey Toropchenko,R,STL,25,82,14,7,21
99,8473453,Trevor Lewis,C,LAK,37,82,13,8,21
99,8477392,Hudson Fasching,R,NYI,29,82,8,13,21
99,8480796,Martin Fehervary,D,WSH,25,82,7,14,21
99,8483565,Nick Blankenburg,D,NSH,26,82,6,15,21
99,8477499,Rasmus Ristolainen,D,PHI,30,82,6,15,21
99,8479980,Nicolas Hague,D,VGK,26,82,5,16,21
99,8483490,Pavel Mintyukov,D,ANA,21,82,3,18,21
99,8478840,Will Borgen,D,SEA,28,82,3,18,21
99,8475790,Erik Gudbranson,D,CBJ,32,82,3,18,21
99,8475279,Ben Chiarot,D,DET,33,82,3,18,21
99,8476891,Matt Grzelcyk,D,PIT,30,82,2,19,21
99,8476917,Adam Pelech,D,NYI,30,82,2,19,21
99,8479324,Ryan Lindgren,D,NYR,26,82,2,19,21
99,8481601,Simon Holmstrom,R,NYI,23,82,10,10,20
99,8477508,Curtis Lazar,C,NJD,29,82,10,10,20
99,8482666,Scott Morrow,D,CAR,22,82,10,10,20
99,8479359,Beck Malenstyn,L,BUF,26,82,8,12,20
99,8483505,Matthew Poitras,C,BOS,20,82,8,12,20
99,8483471,Brad Lambert,C,WPG,31,82,7,13,20
99,8481122,Simon Benoit,D,TOR,26,82,6,14,20
99,8480035,Henri Jokiharju,D,BUF,25,82,3,17,20
99,8475718,Justin Holl,D,DET,32,82,2,18,20
99,8477505,Alexander Wennberg,C,SJS,30,82,12,7,19
99,8475231,Casey Cizikas,C,NYI,33,82,11,8,19
99,8482077,Dylan Holloway,L,EDM,23,82,10,9,19
99,8482809,Jackson Blake,R,CAR,21,82,8,11,19
99,8477406,Mattias Janmark,C,EDM,32,82,7,12,19
99,8477034,Jaycob Megna,D,FLA,32,82,5,14,19
99,8482679,Matt Coronato,R,CGY,22,82,5,14,19
99,8480879,Jacob Bernard-Docker,D,OTT,24,82,4,15,19
99,8482733,Logan Mailloux,D,MTL,31,82,4,15,19
99,8475233,David Savard,D,MTL,34,82,3,16,19
99,8478399,Jonas Siegenthaler,D,NJD,27,82,2,17,19
99,8480950,Ilya Lyubushkin,D,DAL,30,82,1,18,19
99,8475842,Sam Carrick,C,NYR,32,82,10,8,18
99,8482762,Simon Edvinsson,D,DET,21,82,10,8,18
99,8482859,Zack Ostapchuk,C,OTT,21,82,7,11,18
99,8480246,Nick Perbix,D,TBL,26,82,3,15,18
99,8476858,Phillip Di Giuseppe,L,VAN,31,82,9,8,17
99,8482166,Shakir Mukhamadullin,D,SJS,22,82,7,10,17
99,8480448,Parker Kelly,L,COL,25,82,7,10,17
99,8482101,Danil Gushchin,L,SJS,22,82,7,10,17
99,8484911,Collin Graf,R,SJS,22,82,6,11,17
99,8477938,Haydn Fleury,D,WPG,28,82,6,11,17
99,8480878,Nils Lundkvist,D,DAL,24,82,5,12,17
99,8482749,Joshua Roy,R,MTL,21,82,5,12,17
99,8480073,Erik Brannstrom,D,COL,25,82,3,14,17
99,8481699,Aku Raty,R,UTA,23,82,10,6,16
99,8483524,Shane Wright,C,SEA,20,82,7,9,16
99,8477220,Nate Schmidt,D,FLA,33,82,6,10,16
99,8476889,Radek Faksa,C,STL,30,82,5,11,16
99,8479983,Mario Ferraro,D,SJS,26,82,5,11,16
99,8477335,Kyle Burroughs,D,LAK,29,82,4,12,16
99,8478468,Jeremy Lauzon,D,NSH,27,82,4,12,16
99,8483495,Simon Nemec,D,NJD,20,82,3,13,16
99,8476525,Colin Miller,D,WPG,32,82,3,13,16
99,8476372,Nick Seeler,D,PHI,31,82,3,13,16
99,8480172,Jan Rutta,D,SJS,34,82,3,13,16
99,8483460,David Jiricek,D,CBJ,21,82,2,14,16
99,8477365,Connor Clifton,D,BUF,29,82,1,15,16
99,8476822,Luke Glendening,C,TBL,35,82,12,3,15
99,8482141,Lukas Cormier,D,VGK,22,82,4,11,15
99,8482858,Ryker Evans,D,SEA,23,82,4,11,15
99,8483466,Kevin Korchinski,D,CHI,20,82,3,12,15
99,8479442,Troy Stecher,D,EDM,30,82,2,13,15
99,8480860,Kevin Bahl,D,CGY,24,82,1,14,15
99,8481524,Bowen Byram,D,BUF,23,82,7,7,14
99,8475177,Calvin de Haan,D,COL,33,82,6,8,14
99,8482118,Sam Colangelo,R,ANA,23,82,5,9,14
99,8483763,Maksymilian Szuber,D,UTA,22,82,3,11,14
99,8480807,Mattias Samuelsson,D,BUF,24,82,3,11,14
99,8478859,Niko Mikkola,D,FLA,28,82,3,11,14
99,8474090,Brendan Smith,D,DAL,35,82,3,11,14
99,8478874,Adam Gaudette,C,OTT,28,82,3,11,14
99,8478450,Parker Wotherspoon,D,BOS,27,82,2,12,14
99,8476441,Joel Edmundson,D,LAK,31,82,2,12,14
99,8482145,Mavrik Bourque,C,DAL,22,82,7,6,13
99,8480990,Declan Chisholm,D,MIN,24,82,7,6,13
99,8482787,Nikita Chibrikov,R,WPG,31,82,6,7,13
99,8480834,Ty Emberson,D,SJS,24,82,6,7,13
99,8481605,Jackson LaCombe,D,ANA,23,82,3,10,13
99,8474612,Travis Hamonic,D,OTT,34,82,2,11,13
99,8478178,Darren Raddysh,D,TBL,28,82,1,12,13
99,8474567,Zach Bogosian,D,MIN,34,82,6,6,12
99,8482516,Matthew Kessel,D,STL,24,82,5,7,12
99,8482712,Oskar Olausson,R,COL,22,82,4,8,12
99,8474013,Ian Cole,D,UTA,35,82,2,10,12
99,8475762,Derek Forbort,D,VAN,32,82,2,10,12
99,8482070,Mitchell Chaffee,R,TBL,26,82,9,2,11
99,8478434,Keegan Kolesar,R,VGK,27,82,5,6,11
99,8483499,Liam Ohgren,L,MIN,20,82,4,7,11
99,8484149,Gavin Brindley,C,CBJ,20,82,2,9,11
99,8483489,Fraser Minten,C,TOR,31,82,2,9,11
99,8483397,Marc McLaughlin,C,BOS,25,82,3,7,10
99,8471677,Jack Johnson,D,CBJ,37,82,3,7,10
99,8483493,Frank Nazar,C,CHI,20,82,2,8,10
99,8482713,Mackie Samoskevich,R,FLA,22,82,2,8,10
99,8479576,Vincent Desharnais,D,VAN,28,82,1,9,10
99,8482659,Josh Doan,R,UTA,22,82,6,3,9
99,8479638,Justin Brazeau,R,BOS,26,82,5,4,9
99,8481641,Joel Kiviranta,L,COL,28,82,5,4,9
99,8480870,Bo Groulx,C,NYR,24,82,3,6,9
99,8482470,Ilya Solovyov,D,CGY,24,82,4,4,8
99,8483012,Logan Morrison,C,SEA,22,82,4,4,8
99,8474062,Riley Nash,C,NYR,35,82,3,5,8
99,8476473,Connor Murphy,D,CHI,31,82,2,5,7
99,8470794,Joe Pavelski,C,,40,0,0,0,0
99,8481703,Valtteri Puustinen,R,PIT,25,0,0,0,0
99,8477950,Tony DeAngelo,D,,29,0,0,0,0
99,8481577,Philip Tomasino,C,NSH,23,0,0,0,0
99,8475197,Tyson Barrie,D,,33,0,0,0,0
99,8471218,Blake Wheeler,R,,38,0,0,0,0
99,8474157,Max Pacioretty,L,,36,0,0,0,0
99,8478466,Daniel Sprong,R,VAN,27,0,0,0,0
99,8475744,Evgeny Kuznetsov,C,,32,0,0,0,0
99,8481019,David Gustafsson,C,WPG,24,0,0,0,0
99,8475906,John Klingberg,D,,32,0,0,0,0
99,8479348,Kale Clague,D,BUF,26,0,0,0,0
99,8476952,Dominic Toninato,C,WPG,30,0,0,0,0
99,8473473,Milan Lucic,L,,36,0,0,0,0
99,8474037,James van Riemsdyk,L,,35,0,0,0,0
99,8474602,Justin Schultz,D,,34,0,0,0,0
99,8482222,Alexander Barabanov,L,,30,0,0,0,0
99,8479372,Josh Mahura,D,SEA,26,0,0,0,0
99,8479982,Conor Timmins,D,TOR,26,0,0,0,0
99,8474031,Kevin Shattenkirk,D,,35,0,0,0,0
99,8480008,Adam Ruzicka,C,,25,0,0,0,0
99,8481059,Scott Perunovich,D,STL,26,0,0,0,0
99,8480884,Calen Addison,D,,24,0,0,0,0
99,8476994,Vinnie Hinostroza,C,NSH,30,0,0,0,0
99,8478452,Caleb Jones,D,LAK,27,0,0,0,0
99,8480157,Calle Rosen,D,COL,30,0,0,0,0
99,8481609,Vladislav Kolyachonok,D,UTA,23,0,0,0,0
99,8479415,Michael McLeod,C,,26,0,0,0,0
99,8476919,Chris Tierney,C,,30,0,0,0,0
99,8479639,Dylan Coghlan,D,WPG,26,0,0,0,0
99,8478146,Matthew Highmore,C,OTT,28,0,0,0,0
99,8478970,Jalen Chatfield,D,CAR,28,0,0,0,0
99,8480205,Emil Bemstrom,C,PIT,25,0,0,0,0
99,8474884,Mike Hoffman,C,,35,0,0,0,0
99,8471274,Alex Goligoski,D,,39,0,0,0,0
99,8478104,Sammy Blais,L,,28,0,0,0,0
99,8474870,Tyler Johnson,C,,34,0,0,0,0
99,8476913,Devin Shore,C,MIN,30,0,0,0,0
99,8481598,Philip Broberg,D,EDM,23,0,0,0,0
99,8480058,Pierre-Olivier Joseph,D,STL,25,0,0,0,0
99,8480891,Michael Kesselring,D,UTA,24,0,0,0,0
99,8477979,Nicolas Aube-Kubel,R,BUF,28,0,0,0,0
99,8476871,Tanner Pearson,L,,32,0,0,0,0
99,8476393,Nick Cousins,C,,31,0,0,0,0
99,8479977,Kailer Yamamoto,R,,26,0,0,0,0
99,8479543,Michael Pezzetta,L,MTL,26,0,0,0,0
99,8477018,Ben Hutton,D,VGK,31,0,0,0,0
99,8480762,Eric Robinson,L,CAR,29,0,0,0,0
99,8474034,Pat Maroon,L,CHI,36,0,0,0,0
99,8481058,Jesse Ylönen,R,,25,0,0,0,0
99,8475179,Dmitry Kulikov,D,FLA,34,0,0,0,0
99,8481527,Kaedan Korczak,D,VGK,23,0,0,0,0
99,8473449,Kyle Okposo,R,,36,0,0,0,0
99,8482192,Isaak Phillips,D,CHI,23,0,0,0,0
99,8480727,Zach Whitecloud,D,VGK,28,0,0,0,0
99,8479346,Dillon Dube,C,,26,0,0,0,0
99,8480821,Filip Zadina,R,,25,0,0,0,0
99,8480001,Urho Vaakanainen,D,ANA,25,0,0,0,0
99,8470966,Mark Giordano,D,,41,0,0,0,0
99,8480853,Liam Foudy,C,,24,0,0,0,0
99,8475225,Craig Smith,C,CHI,35,0,0,0,0
99,8479972,Mason Shaw,C,WPG,26,0,0,0,0
99,8478451,Ethan Bear,D,WSH,27,0,0,0,0
99,8474040,Sam Gagner,C,,35,0,0,0,0
99,8480196,Jacob Bryson,D,BUF,27,0,0,0,0
99,8479984,Cal Foote,D,,26,0,0,0,0
99,8480011,Klim Kostin,C,SJS,25,0,0,0,0
99,8482176,Wyatt Kaiser,D,CHI,22,0,0,0,0
99,8476988,Matt Benning,D,SJS,30,0,0,0,0
99,8479370,Tyson Jost,C,CAR,26,0,0,0,0
99,8477464,Nic Petan,C,,29,0,0,0,0
99,8477380,Jonny Brodzinski,C,NYR,31,0,0,0,0
99,8480070,Ian Mitchell,D,BOS,25,0,0,0,0
99,8479315,Joey Anderson,R,CHI,26,0,0,0,0
99,8478099,Kevin Labanc,R,,29,0,0,0,0
99,8476874,Olli Maatta,D,DET,30,0,0,0,0
99,8475208,Brian Dumoulin,D,ANA,33,0,0,0,0
99,8478430,Oliver Kylington,D,,27,0,0,0,0
99,8479536,Axel Jonsson-Fjallby,L,WPG,26,0,0,0,0
99,8479671,Mathieu Olivier,R,CBJ,27,0,0,0,0
99,8471709,Marc-Edouard Vlasic,D,SJS,37,0,0,0,0
99,8479328,Julien Gauthier,R,NYI,27,0,0,0,0
99,8478421,A.J. Greer,L,FLA,28,0,0,0,0
99,8477573,Nathan Walker,L,STL,30,0,0,0,0
99,8481537,Nikita Okhotiuk,D,CGY,24,0,0,0,0
99,8474166,Alec Martinez,D,CHI,37,0,0,0,0
99,8470610,Zach Parise,L,,40,0,0,0,0
99,8477478,William Carrier,L,CAR,30,0,0,0,0
99,8479344,Jesse Puljujarvi,R,PIT,26,0,0,0,0
99,8480887,Jordan Harris,D,MTL,24,0,0,0,0
99,8478502,Dennis Gilbert,D,BUF,28,0,0,0,0
99,8482730,Brandt Clarke,D,LAK,21,0,0,0,0
99,8480355,Mark Kastelic,C,BOS,25,0,0,0,0
99,8475750,Jon Merrill,D,MIN,32,0,0,0,0
99,8475164,Jakob Silfverberg,R,,34,0,0,0,0
99,8477944,Jakub Vrana,L,,28,0,0,0,0
99,8479439,Jacob MacDonald,D,COL,31,0,0,0,0
99,8474568,Luke Schenn,D,NSH,35,0,0,0,0
99,8478454,Noah Juulsen,D,VAN,27,0,0,0,0
99,8475752,Tyler Pitlick,C,,33,0,0,0,0
99,8482148,Hendrix Lapierre,C,WSH,22,0,0,0,0
99,8481167,Brayden Pachal,D,CGY,25,0,0,0,0
99,8478043,Sam Lafferty,C,BUF,29,0,0,0,0
99,8479321,Lucas Johansen,D,,27,0,0,0,0
99,8471699,Andrew Cogliano,C,,37,0,0,0,0
99,8481521,Ronnie Attard,D,PHI,25,0,0,0,0
99,8481161,Jake Christiansen,D,CBJ,25,0,0,0,0
99,8479458,Nikita Zaitsev,D,,33,0,0,0,0
99,8479619,Michael Carcone,L,UTA,28,0,0,0,0
99,8479026,Philippe Myers,D,TOR,27,0,0,0,0
99,8477330,Dominik Kubalik,L,,29,0,0,0,0
99,8481617,Vasily Podkolzin,R,VAN,23,0,0,0,0
99,8481701,Santeri Hatakka,D,NJD,23,0,0,0,0
99,8479514,Rem Pitlick,C,,27,0,0,0,0
99,8477446,Michael McCarron,R,NSH,29,0,0,0,0
99,8470604,Jeff Carter,C,,39,0,0,0,0
99,8482241,Radim Zohorna,L,,28,0,0,0,0
99,8480289,Morgan Barron,C,WPG,26,0,0,0,0
99,8479379,Givani Smith,R,SJS,26,0,0,0,0
99,8480216,Jacob Peterson,C,,25,0,0,0,0
99,8477851,Jordan Oesterle,D,BOS,32,0,0,0,0
99,8484258,Sam Malinski,D,COL,26,0,0,0,0
99,8478904,Steven Lorentz,C,,28,0,0,0,0
99,8482095,Tyler Kleven,D,OTT,22,0,0,0,0
99,8480848,Ty Dellandrea,C,SJS,24,0,0,0,0
99,8476884,Derrick Pouliot,D,,30,0,0,0,0
99,8479336,Carl Grundstrom,R,SJS,27,0,0,0,0
99,8482964,Arber Xhekaj,D,MTL,23,0,0,0,0
99,8471686,Marc Staal,D,,37,0,0,0,0
99,8477887,Patrick Brown,C,BOS,32,0,0,0,0
99,8478495,Denis Gurianov,R,,27,0,0,0,0
99,8473504,Cal Clutterbuck,R,,37,0,0,0,0
99,8481550,Adam Beckman,L,NJD,23,0,0,0,0
99,8480845,Rasmus Kupari,C,WPG,24,0,0,0,0
99,8474009,Nick Bonino,C,,36,0,0,0,0
99,8478585,Derek Ryan,C,EDM,38,0,0,0,0
99,8477962,Brendan Lemieux,L,CAR,28,0,0,0,0
99,8482861,Vincent Iorio,D,WSH,22,0,0,0,0
99,8479378,Logan Stanley,D,WPG,26,0,0,0,0
99,8473446,Erik Johnson,D,PHI,36,0,0,0,0
99,8481743,Marc Del Gaizo,D,NSH,25,0,0,0,0
99,8477384,Josh Brown,D,EDM,30,0,0,0,0
99,8482165,Yan Kuznetsov,D,CGY,22,0,0,0,0
99,8478424,Jansen Harkins,C,ANA,27,0,0,0,0
99,8482144,Jack Thompson,D,SJS,22,0,0,0,0
99,8478512,Austin Czarnik,C,,32,0,0,0,0
99,8477527,Ross Johnston,L,ANA,30,0,0,0,0
99,8479383,Boris Katchouk,L,,26,0,0,0,0
99,8482094,Daemon Hunt,D,MIN,22,0,0,0,0
99,8481719,Maxwell Crozier,D,TBL,24,0,0,0,0
99,8480192,Johnathan Kovacevic,D,NJD,27,0,0,0,0
99,8479376,Victor Mete,D,,26,0,0,0,0
99,8482511,Mason Lohrei,D,BOS,23,0,0,0,0
99,8475825,Jani Hakanpää,D,,32,0,0,0,0
99,8478021,William Lagesson,D,DET,28,0,0,0,0
99,8475795,Dylan McIlrath,D,WSH,32,0,0,0,0
99,8477846,Ryan Carpenter,C,,33,0,0,0,0
99,8481056,Spencer Stastney,D,NSH,24,0,0,0,0
99,8481564,Ryan Johnson,D,BUF,23,0,0,0,0
99,8478017,Mark Friedman,D,VAN,29,0,0,0,0
99,8479320,Max Lajoie,D,SEA,27,0,0,0,0
99,8480075,Cameron Crotty,D,MIN,25,0,0,0,0
99,8484287,Cole McWard,D,VAN,23,0,0,0,0
99,8484254,Akito Hirose,D,VAN,25,0,0,0,0
99,8483407,Brandon Scanlin,D,NYR,25,0,0,0,0
99,8480274,Philip Kemp,D,EDM,25,0,0,0,0
99,8479522,Hardy Haman Aktell,D,WSH,26,0,0,0,0
99,8480007,Jonas Rondbjerg,R,VGK,25,0,0,0,0
99,8477454,Adam Erne,L,,29,0,0,0,0
99,8481679,Maxence Guenette,D,OTT,23,0,0,0,0
99,8480441,Trey Fix-Wolansky,R,CBJ,25,0,0,0,0
99,8483546,Marshall Rifai,D,TOR,26,0,0,0,0
99,8480084,Nick DeSimone,D,NJD,30,0,0,0,0
99,8481030,Jack St. Ivany,D,PIT,25,0,0,0,0
99,8481592,Jakob Pelletier,L,CGY,23,0,0,0,0
99,8478011,Louie Belpedio,D,PHI,28,0,0,0,0
99,8477930,Pierre-Edouard Bellemare,L,,39,0,0,0,0
99,8484321,Nikolas Matinpalo,D,OTT,26,0,0,0,0
99,8482067,Connor Mackey,D,NYR,28,0,0,0,0
99,8481806,Louis Crevier,D,CHI,23,0,0,0,0
99,8484326,Patrik Koch,D,UTA,28,0,0,0,0
99,8477971,Andreas Englund,D,LAK,28,0,0,0,0
99,8481751,Lukas Rousek,R,BUF,25,0,0,0,0
99,8481006,Tyler Tucker,D,STL,24,0,0,0,0
99,8476867,Brendan Gaunce,C,MIN,30,0,0,0,0
99,8479520,Brandon Duhaime,R,WSH,27,0,0,0,0
99,8477073,Kurtis MacDermid,L,NJD,30,0,0,0,0
99,8480874,Adam Ginning,D,PHI,24,0,0,0,0
99,8477473,Justin Bailey,R,SJS,29,0,0,0,0
99,8479066,Ryan Lomberg,L,CGY,30,0,0,0,0
99,8477070,Liam O'Brien,C,UTA,30,0,0,0,0
99,8474618,Marco Scandella,D,,34,0,0,0,0
99,8475797,Jarred Tinordi,D,,32,0,0,0,0
99,8481441,Joe Snively,C,DET,28,0,0,0,0
99,8477244,Chad Ruhwedel,D,NYR,34,0,0,0,0
99,8479772,Zack MacEwen,R,OTT,28,0,0,0,0
99,8481147,Reese Johnson,C,MIN,26,0,0,0,0
99,8481043,Cole Koepke,L,BOS,26,0,0,0,0
99,8483619,Filip Roos,D,OTT,25,0,0,0,0
99,8481541,Samuel Bolduc,D,NYI,24,0,0,0,0
99,8477810,Joel Hanley,D,CGY,33,0,0,0,0
99,8476907,Mackenzie MacEachern,L,,30,0,0,0,0
99,8482652,Walker Duehr,R,CGY,27,0,0,0,0
99,8477126,Jayson Megna,C,,34,0,0,0,0
99,8483398,Declan Carlile,D,TBL,31,0,0,0,0
99,8482929,Emil Lilleberg,D,TBL,23,0,0,0,0
99,8480880,Jakub Lauko,C,MIN,24,0,0,0,0
99,8480245,Olle Lycksell,R,PHI,25,0,0,0,0
99,8480252,Cole Guttman,C,CHI,25,0,0,0,0
99,8477467,Gustav Olofsson,D,SEA,30,0,0,0,0
99,8479968,Vinni Lettieri,C,BOS,29,0,0,0,0
99,8478400,Colin White,C,,27,0,0,0,0
99,8475755,Alexander Petrovic,D,DAL,32,0,0,0,0
99,8481812,Nikolai Knyzhov,D,,27,0,0,0,0
99,8481593,Jayden Struble,D,MTL,23,0,0,0,0
99,8481532,Alex Turcotte,C,LAK,23,0,0,0,0
99,8482126,Emil Andrae,D,PHI,31,0,0,0,0
99,8479944,Zach Aston-Reese,C,VGK,30,0,0,0,0
99,8471817,Ryan Reaves,R,TOR,37,0,0,0,0
99,8481206,John Ludvig,D,PIT,24,0,0,0,0
99,8481599,Victor Soderstrom,D,UTA,23,0,0,0,0
99,8480292,Carson Meyer,R,ANA,27,0,0,0,0
99,8482496,Nils Aman,C,VAN,24,0,0,0,0
99,8479718,Alex Barré-Boulet,C,MTL,27,0,0,0,0
99,8479994,Jaret Anderson-Dolan,C,WPG,25,0,0,0,0
99,8480184,Gustav Lindstrom,D,,26,0,0,0,0
99,8480890,Jan Jenik,R,OTT,24,0,0,0,0
99,8478067,Oskar Lindblom,L,,28,0,0,0,0
99,8476934,Brock McGinn,L,ANA,30,0,0,0,0
99,8479985,Cale Fleury,D,SEA,26,0,0,0,0
99,8484304,Uvis Balinskis,D,FLA,28,0,0,0,0
99,8479981,Jonah Gadjovich,L,FLA,26,0,0,0,0
99,8481716,Dmitri Voronkov,L,CBJ,24,0,0,0,0
99,8474709,Matt Martin,L,,35,0,0,0,0
99,8482634,Alex Steeves,C,TOR,25,0,0,0,0
99,8480823,Alexander Alexeyev,D,WSH,25,0,0,0,0
99,8477541,Dakota Mermis,D,TOR,30,0,0,0,0
99,8483491,Ivan Miroshnichenko,L,WSH,20,0,0,0,0
99,8478477,Mitchell Stephens,C,SEA,27,0,0,0,0
99,8481543,Nikita Alexandrov,C,STL,24,0,0,0,0
99,8479423,Alex Nylander,L,,26,0,0,0,0
99,8482451,Mikael Pyyhtia,L,CBJ,23,0,0,0,0
99,8478831,Kevin Stenlund,C,UTA,28,0,0,0,0
99,8480306,Grant Hutton,D,NYI,29,0,0,0,0
99,8478028,Fredrik Olofsson,L,,28,0,0,0,0
99,8477462,Robert Hagg,D,VGK,29,0,0,0,0
99,8477320,Anton Blidh,L,NYR,29,0,0,0,0
99,8482157,Will Cuylle,L,NYR,22,0,0,0,0
99,8482737,Zack Bolduc,C,STL,21,0,0,0,0
99,8481239,Samuel Fagemo,L,,24,0,0,0,0
99,8481600,Tobias Bjornfot,D,FLA,23,0,0,0,0
99,8478409,Anthony Richard,C,PHI,28,0,0,0,0
99,8474145,Robert Bortuzzo,D,,35,0,0,0,0
99,8475958,Michael Sgarbossa,C,WSH,32,0,0,0,0
99,8479986,Kole Lind,R,DAL,26,0,0,0,0
99,8479249,Andrew Poturalski,C,SJS,30,0,0,0,0
99,8479362,Riley Tufte,L,BOS,26,0,0,0,0
99,8479991,Jake Leschyshyn,C,NYR,25,0,0,0,0
99,8479587,Rhett Gardner,C,PHI,28,0,0,0,0
99,8482744,James Malatesta,L,CBJ,21,0,0,0,0
99,8478854,Ryan Shea,D,PIT,27,0,0,0,0
99,8481591,Sam Poulin,R,,23,0,0,0,0
99,8483512,Matt Savoie,C,EDM,20,0,0,0,0
99,8482102,Vasily Ponomarev,C,PIT,22,0,0,0,0
99,8482162,Roby Jarventie,L,EDM,22,0,0,0,0
99,8481016,Ruslan Iskhakov,C,,24,0,0,0,0
99,8482172,Landon Slaggert,L,CHI,22,0,0,0,0
99,8482747,Brennan Othmann,L,NYR,21,0,0,0,0
99,8480031,Maxime Comtois,L,,25,0,0,0,0
99,8480226,Marián Studenic,R,,26,0,0,0,0
99,8478408,Travis Dermott,D,,28,0,0,0,0
99,8481518,Nolan Foote,L,NJD,24,0,0,0,0
99,8479419,Brett Murray,L,BUF,26,0,0,0,0
99,8482088,Justin Sourdif,R,FLA,22,0,0,0,0
99,8482201,Gage Goncalves,C,TBL,23,0,0,0,0
99,8481578,Graeme Clarke,R,MIN,23,0,0,0,0
99,8482177,Marat Khusnutdinov,C,MIN,22,0,0,0,0
99,8481754,Nikita Nesterenko,C,ANA,23,0,0,0,0
99,8483531,Brian Halonen,L,NJD,25,0,0,0,0
99,8483920,Pierrick Dube,R,WSH,23,0,0,0,0
99,8480851,Akil Thomas,C,LAK,24,0,0,0,0
99,8475235,Nicolas Deslauriers,L,PHI,33,0,0,0,0
99,8482476,Emil Heineman,L,MTL,23,0,0,0,0
99,8477149,Scott Sabourin,R,SJS,32,0,0,0,0
99,8483549,Lucas Condotta,L,MTL,27,0,0,0,0
99,8482765,Isak Rosen,R,BUF,21,0,0,0,0
99,8481237,Kyle MacLean,C,NYI,25,0,0,0,0
99,8481024,Linus Karlsson,C,VAN,25,0,0,0,0
99,8481690,Tyler Angle,C,,24,0,0,0,0
99,8483570,Ben Meyers,C,SEA,26,0,0,0,0
99,8481655,Cole Schwindt,R,CGY,23,0,0,0,0
99,8481462,Mason Morelli,L,VGK,28,0,0,0,0
99,8483401,Marc Johnstone,R,PIT,28,0,0,0,0
99,8478956,Samuel Laberge,L,NJD,27,0,0,0,0
99,8479533,Joona Koppanen,L,,26,0,0,0,0
99,8482197,Adam Raska,R,MIN,23,0,0,0,0
99,8482250,Callahan Burke,C,VGK,27,0,0,0,0
99,8482784,Zach Dean,C,STL,21,0,0,0,0
99,8484255,Jason Polin,R,COL,25,0,0,0,0
99,8481077,John Leonard,L,,26,0,0,0,0
99,8481534,Raphael Lavoie,C,EDM,24,0,0,0,0
99,8483609,Adam Klapka,R,CGY,24,0,0,0,0
99,8482751,Ryan Winterton,C,SEA,21,0,0,0,0
99,8480267,Sammy Walker,C,MIN,25,0,0,0,0
99,8475766,Austin Watson,L,,32,0,0,0,0
99,8482460,Matt Rempe,C,NYR,22,0,0,0,0
99,8481065,Angus Crookshank,L,OTT,25,0,0,0,0
99,8481070,Hugh McGing,L,,26,0,0,0,0
99,8476323,Max McCormick,L,SEA,32,0,0,0,0
99,8483395,Arshdeep Bains,L,VAN,23,0,0,0,0
99,8484259,Ondrej Pavel,C,COL,31,0,0,0,0
99,8483432,Luca Del Bel Belluz,C,CBJ,31,0,0,0,0
99,8483045,Cameron Butler,R,CBJ,31,0,0,0,0
99,8482061,Brandon Biro,L,SEA,26,0,0,0,0
99,8477401,John Hayden,C,SEA,29,0,0,0,0
99,8475278,Byron Froese,C,,33,0,0,0,0
99,8478446,Glenn Gawdin,C,LAK,27,0,0,0,0
99,8477993,Justin Kirkland,C,CGY,28,0,0,0,0
99,8482147,Jean-Luc Foudy,C,COL,22,0,0,0,0
99,8480032,Shane Bowers,C,NJD,25,0,0,0,0
99,8479330,Brandon Gignac,C,MTL,27,0,0,0,0
99,8480776,Sheldon Rempal,R,,29,0,0,0,0
99,8475413,Justin Dowling,C,NJD,34,0,0,0,0
99,8481726,Adam Edstrom,C,NYR,24,0,0,0,0
99,8480844,Grigori Denisenko,L,VGK,24,0,0,0,0
99,8478147,Bokondji Imama,L,PIT,28,0,0,0,0
99,8478881,Brett Seney,L,CHI,28,0,0,0,0
99,8483630,Pavol Regenda,L,ANA,25,0,0,0,0
99,8480836,Jonathan Gruden,C,,24,0,0,0,0
99,8484314,Jiri Smejkal,L,,28,0,0,0,0
99,8475780,Chris Wagner,R,COL,33,0,0,0,0
99,8479546,Oskar Steen,C,,26,0,0,0,0
99,8483597,Milos Kelemen,L,UTA,25,0,0,0,0
99,8481789,Tye Kartye,L,SEA,23,0,0,0,0
99,8484325,Waltteri Merela,C,TBL,26,0,0,0,0
99,8479421,Jacob Moverare,D,LAK,26,0,0,0,0
99,8481585,Egor Afanasyev,L,SJS,23,0,0,0,0
99,8479547,Matthew Phillips,R,,26,0,0,0,0
99,8479367,William Lockwood,R,FLA,26,0,0,0,0
99,8476915,Jujhar Khaira,L,,30,0,0,0,0
99,8481422,Jacob Lucchini,C,NSH,29,0,0,0,0
99,8480468,James Hamblin,L,EDM,25,0,0,0,0
99,8478051,Max Willman,C,NJD,29,0,0,0,0
99,8481556,John Beecher,C,BOS,23,0,0,0,0
99,8478078,Rourke Chartier,C,,28,0,0,0,0
100,8478402,Connor McDavid,C,EDM,27,82,42,97,139
100,8479318,Auston Matthews,C,TOR,27,82,82,52,134
100,8476453,Nikita Kucherov,R,TBL,31,82,35,89,124
100,8477492,Nathan MacKinnon,C,COL,29,82,47,72,119
100,8477956,David Pastrnak,R,BOS,28,82,67,49,116
100,8476887,Filip Forsberg,L,NSH,30,82,58,56,114
100,8478550,Artemi Panarin,L,NYR,33,82,41,73,114
100,8481559,Jack Hughes,C,NJD,23,82,38,70,108
100,8477934,Leon Draisaitl,C,EDM,29,82,44,61,105
100,8476468,J.T. Miller,C,VAN,31,82,35,68,103
100,8477939,William Nylander,R,TOR,28,82,40,61,101
100,8480023,Robert Thomas,C,STL,25,82,32,69,101
100,8471675,Sidney Crosby,C,PIT,37,82,38,62,100
100,8479385,Jordan Kyrou,C,STL,26,82,49,50,99
100,8477942,Kevin Fiala,L,LAK,28,82,36,63,99
100,8479343,Clayton Keller,R,UTA,26,82,41,56,97
100,8478398,Kyle Connor,L,WPG,28,82,38,59,97
100,8477493,Aleksander Barkov,C,FLA,29,82,31,66,97
100,8478403,Jack Eichel,C,VGK,28,82,48,48,96
100,8474600,Roman Josi,D,NSH,34,82,31,65,96
100,8480069,Cale Makar,D,COL,26,82,20,75,95
100,8479314,Matthew Tkachuk,L,FLA,27,82,31,63,94
100,8475166,John Tavares,C,TOR,34,82,36,57,93
100,8480012,Elias Pettersson,C,VAN,26,82,41,49,90
100,8478420,Mikko Rantanen,R,COL,28,82,31,59,90
100,8480002,Nico Hischier,C,NJD,25,82,26,63,89
100,8481557,Matt Boldy,L,MIN,23,82,48,40,88
100,8476346,Johnny Gaudreau,L,CBJ,31,82,23,65,88
100,8478010,Brayden Point,C,TBL,28,82,45,42,87
100,8482116,Tim Stützle,C,OTT,22,82,25,62,87
100,8480801,Brady Tkachuk,L,OTT,25,82,38,48,86
100,8476389,Vincent Trocheck,C,NYR,31,82,34,52,86
100,8475786,Zach Hyman,L,EDM,32,82,46,39,85
100,8477946,Dylan Larkin,C,DET,28,82,38,47,85
100,8477404,Jake Guentzel,C,TBL,30,82,37,48,85
100,8478427,Sebastian Aho,C,CAR,27,82,31,54,85
100,8480800,Quinn Hughes,D,VAN,25,82,15,68,83
100,8475810,Bryan Rust,R,PIT,32,82,47,35,82
100,8478439,Travis Konecny,R,PHI,27,82,37,45,82
100,8478445,Mathew Barzal,C,NYI,27,82,20,62,82
100,8477409,Carter Verhaeghe,C,FLA,29,82,41,40,81
100,8476456,Jonathan Huberdeau,C,CGY,31,82,18,63,81
100,8479407,Jesper Bratt,L,NJD,26,82,32,48,80
100,8478864,Kirill Kaprizov,L,MIN,27,82,36,43,79
100,8479323,Adam Fox,D,NYR,26,82,11,68,79
100,8477933,Sam Reinhart,C,FLA,29,82,36,42,78
100,8475913,Mark Stone,R,VGK,32,82,27,51,78
100,8475172,Nazem Kadri,C,CGY,34,82,27,51,78
100,8480027,Jason Robertson,L,DAL,25,82,22,56,78
100,8481523,Kirby Dach,C,MTL,23,82,18,60,78
100,8481068,Yegor Sharangovich,C,CGY,26,82,41,35,76
100,8478414,Timo Meier,R,NJD,28,82,41,35,76
100,8476881,Tomas Hertl,C,VGK,31,82,26,50,76
100,8471214,Alex Ovechkin,L,WSH,39,82,41,34,75
100,8475798,Mikael Granlund,C,SJS,32,82,25,50,75
100,8478449,Roope Hintz,C,DAL,28,82,40,34,74
100,8473512,Claude Giroux,R,OTT,36,82,37,37,74
100,8476459,Mika Zibanejad,C,NYR,31,82,25,49,74
100,8471685,Anze Kopitar,C,LAK,37,82,24,50,74
100,8478440,Dylan Strome,C,WSH,27,82,24,50,74
100,8473419,Brad Marchand,L,BOS,36,82,33,40,73
100,8477416,Oliver Bjorkstrand,R,SEA,29,82,32,40,72
100,8482093,Seth Jarvis,C,CAR,22,82,31,41,72
100,8474564,Steven Stamkos,C,NSH,34,82,21,51,72
100,8477447,Shea Theodore,D,VGK,29,82,16,56,72
100,8480803,Evan Bouchard,D,EDM,25,82,14,58,72
100,8476539,Jonathan Marchessault,R,NSH,34,82,36,35,71
100,8475170,Brayden Schenn,C,STL,33,82,35,36,71
100,8482665,Matty Beniers,C,SEA,22,82,30,41,71
100,8480036,Miro Heiskanen,D,DAL,25,82,19,52,71
100,8480039,Martin Necas,C,CAR,25,82,28,42,70
100,8477402,Pavel Buchnevich,L,STL,29,82,24,46,70
100,8471215,Evgeni Malkin,C,PIT,38,82,22,48,70
100,8481711,Matias Maccelli,L,UTA,24,82,22,48,70
100,8477501,Valeri Nichushkin,R,COL,29,82,31,38,69
100,8477940,Nikolaj Ehlers,L,WPG,28,82,29,40,69
100,8477456,J.T. Compher,L,DET,29,82,29,40,69
100,8477986,Brandon Montour,D,SEA,30,82,25,44,69
100,8474141,Patrick Kane,R,DET,36,82,21,48,69
100,8475754,Brock Nelson,C,NYI,33,82,28,40,68
100,8475692,Mats Zuccarello,R,MIN,37,82,19,49,68
100,8479325,Charlie McAvoy,D,BOS,27,82,14,54,68
100,8477496,Elias Lindholm,C,BOS,30,82,28,39,67
100,8479999,Casey Mittelstadt,C,COL,26,82,24,43,67
100,8482684,Luke Hughes,D,NJD,21,82,12,55,67
100,8480015,Owen Tippett,R,PHI,25,82,32,34,66
100,8478438,Tommy Novak,C,NSH,27,82,24,42,66
100,8476454,Ryan Nugent-Hopkins,C,EDM,31,82,18,48,66
100,8474578,Erik Karlsson,D,PIT,34,82,14,52,66
100,8475167,Victor Hedman,D,TBL,34,82,11,55,66
100,8477960,Adrian Kempe,R,LAK,28,82,31,34,65
100,8478444,Brock Boeser,R,VAN,27,82,26,39,65
100,8479542,Brandon Hagel,L,TBL,26,82,33,31,64
100,8477951,Nick Schmaltz,C,UTA,28,82,30,34,64
100,8480830,Andrei Svechnikov,R,CAR,24,82,27,37,64
100,8479420,Tage Thompson,C,BUF,27,82,27,37,64
100,8480208,Drake Batherson,R,OTT,26,82,25,39,64
100,8480188,Fabian Zetterlund,L,SJS,25,82,25,39,64
100,8477504,Josh Morrissey,D,WPG,29,82,19,45,64
100,8475745,Charlie Coyle,C,BOS,32,82,18,46,64
100,8476853,Morgan Rielly,D,TOR,30,82,8,56,64
100,8475765,Vladimir Tarasenko,R,DET,33,82,29,34,63
100,8476448,William Karlsson,C,VGK,31,82,27,36,63
100,8482124,Quinton Byfield,R,LAK,22,82,21,42,63
100,8480434,Sean Durzi,D,UTA,26,82,17,46,63
100,8474563,Drew Doughty,D,LAK,35,82,14,49,63
100,8480865,Noah Dobson,D,NYI,24,82,13,50,63
100,8475184,Chris Kreider,L,NYR,33,82,33,29,62
100,8477500,Bo Horvat,C,NYI,29,82,31,31,62
100,8482109,Alexis Lafrenière,L,NYR,23,82,30,32,62
100,8477494,Jonathan Drouin,L,COL,29,82,26,36,62
100,8479337,Alex DeBrincat,R,DET,27,82,25,37,62
100,8481533,Trevor Zegras,C,ANA,23,82,20,42,62
100,8475753,Justin Faulk,D,STL,32,82,18,44,62
100,8481540,Cole Caufield,R,MTL,23,82,35,26,61
100,8478975,Mason Marchment,L,DAL,29,82,19,42,61
100,8478873,Troy Terry,R,ANA,27,82,26,34,60
100,8478401,Pavel Zacha,C,BOS,27,82,23,37,60
100,8478469,Thomas Chabot,D,OTT,27,82,14,46,60
100,8478397,Rasmus Andersson,D,CGY,28,82,10,50,60
100,8477935,Sam Bennett,C,FLA,28,82,30,29,59
100,8476460,Mark Scheifele,C,WPG,31,82,29,30,59
100,8478047,Michael Bunting,L,PIT,29,82,29,30,59
100,8481528,Dylan Cozens,C,BUF,23,82,26,33,59
100,8475168,Matt Duchene,C,DAL,33,82,24,35,59
100,8475158,Ryan O'Reilly,C,NSH,33,82,21,38,59
100,8480014,Gabriel Vilardi,C,WPG,25,82,35,23,58
100,8477949,Alex Tuch,R,BUF,28,82,27,31,58
100,8476875,Mike Matheson,D,MTL,30,82,13,45,58
100,8480459,Pius Suter,C,VAN,28,82,23,34,57
100,8477444,Andre Burakovsky,L,SEA,29,82,17,40,57
100,8482667,William Eklund,L,SJS,22,82,17,40,57
100,8478460,Zach Werenski,D,CBJ,27,82,13,44,57
100,8480839,Rasmus Dahlin,D,BUF,24,82,13,44,57
100,8481618,Alex Newhook,C,MTL,23,82,30,26,56
100,8482113,Anton Lundell,C,FLA,23,82,27,29,56
100,8478493,Joel Eriksson Ek,C,MIN,27,82,26,30,56
100,8474586,Jordan Eberle,R,SEA,34,82,25,31,56
100,8482078,Lucas Raymond,L,DET,22,82,22,34,56
100,8473986,Alex Killorn,L,ANA,35,82,20,36,56
100,8477955,Jared McCann,L,SEA,28,82,33,22,55
100,8473994,Jamie Benn,L,DAL,35,82,29,26,55
100,8479675,Trevor Moore,L,LAK,29,82,20,35,55
100,8478046,Danton Heinen,L,VAN,29,82,30,24,54
100,8475726,Tyler Toffoli,C,SJS,32,82,27,27,54
100,8476880,Tom Wilson,R,WSH,30,82,27,27,54
100,8476882,Teuvo Teravainen,L,CHI,30,82,26,28,54
100,8478042,Viktor Arvidsson,R,EDM,31,82,25,29,54
100,8477476,Artturi Lehkonen,L,COL,29,82,23,31,54
100,8475791,Taylor Hall,L,CHI,33,82,19,35,54
100,8470613,Brent Burns,D,CAR,39,82,14,40,54
100,8479410,Mikhail Sergachev,D,UTA,26,82,7,47,54
100,8474590,John Carlson,D,WSH,34,82,6,48,54
100,8475784,Jeff Skinner,C,EDM,32,82,27,26,53
100,8481596,Shane Pinto,C,OTT,24,82,21,32,53
100,8479425,Filip Hronek,D,VAN,27,82,15,38,53
100,8478407,Vince Dunn,D,SEA,28,82,8,45,53
100,8478474,Lawson Crouse,L,UTA,27,82,28,24,52
100,8478498,Jake DeBrusk,L,VAN,28,82,26,26,52
100,8480078,Filip Chytil,C,NYR,25,82,25,27,52
100,8475169,Evander Kane,L,EDM,33,82,20,32,52
100,8474679,Gustav Nyquist,C,NSH,35,82,17,35,52
100,8478396,Noah Hanifin,D,VGK,27,82,14,38,52
100,8483808,Andrei Kuzmenko,L,CGY,28,82,25,26,51
100,8482720,Matthew Knies,L,TOR,22,82,23,28,51
100,8477497,Sean Monahan,C,CBJ,30,82,18,33,51
100,8479339,Patrik Laine,L,CBJ,26,82,17,34,51
100,8481656,Aliaksei Protas,C,WSH,23,82,13,38,51
100,8480018,Nick Suzuki,C,MTL,25,82,11,40,51
100,8478519,Anthony Cirelli,C,TBL,27,82,27,23,50
100,8477511,Anthony Mantha,R,CGY,30,82,25,25,50
100,8484144,Connor Bedard,C,CHI,19,82,23,27,50
100,8479400,Pierre-Luc Dubois,L,WSH,26,82,20,30,50
100,8474641,Adam Henrique,C,EDM,34,82,20,30,50
100,8480797,Joel Farabee,L,PHI,24,82,19,31,50
100,8479987,Morgan Geekie,C,BOS,26,82,19,31,50
100,8480028,Morgan Frost,C,PHI,25,82,18,32,50
100,8482745,Mason McTavish,C,ANA,21,82,18,32,50
100,8476462,Dougie Hamilton,D,NJD,31,82,16,34,50
100,8477503,Max Domi,C,TOR,29,82,16,34,50
100,8482149,Cole Perfetti,C,WPG,22,82,14,36,50
100,8474565,Alex Pietrangelo,D,VGK,34,82,14,36,50
100,8476905,Chandler Stephenson,C,SEA,30,82,11,39,50
100,8478366,Frank Vatrano,R,ANA,30,82,32,17,49
100,8475151,Kyle Palmieri,C,NYI,33,82,27,22,49
100,8475794,Tyler Seguin,C,DAL,32,82,27,22,49
100,8482089,Jake Neighbours,L,STL,22,82,23,26,49
100,8482705,Cole Sillinger,C,CBJ,21,82,22,27,49
100,8479345,Jakob Chychrun,D,WSH,26,82,20,29,49
100,8477451,Ryan Hartman,R,MIN,30,82,17,32,49
100,8481581,Thomas Harley,D,DAL,23,82,13,36,49
100,8476906,Shayne Gostisbehere,D,CAR,31,82,7,42,49
100,8474102,David Perron,L,OTT,36,82,21,27,48
100,8478462,Nicolas Roy,C,VGK,27,82,19,29,48
100,8480829,Jesperi Kotkaniemi,C,CAR,24,82,17,31,48
100,8474715,Cam Atkinson,R,TBL,35,82,16,32,48
100,8476792,Torey Krug,D,STL,33,82,15,33,48
100,8471724,Kris Letang,D,PIT,37,82,13,35,48
100,8478055,Gustav Forsling,D,FLA,28,82,9,39,48
100,8482159,Tyson Foerster,R,PHI,22,82,26,21,47
100,8476432,Boone Jenner,C,CBJ,31,82,25,22,47
100,8479525,Ross Colton,C,COL,28,82,24,23,47
100,8476921,Jordan Martinook,L,CAR,32,82,21,26,47
100,8476826,Yanni Gourde,C,SEA,33,82,19,28,47
100,8476479,Phillip Danault,C,LAK,31,82,17,30,47
100,8477407,Anthony Duclair,L,NYI,29,82,15,32,47
100,8477964,Ivan Barbashev,C,VGK,29,82,13,34,47
100,8476892,Colton Parayko,D,STL,31,82,9,38,47
100,8478038,Devon Toews,D,COL,30,82,8,39,47
100,8477969,Marcus Pettersson,D,PIT,28,82,6,41,47
100,8480849,Barrett Hayton,C,UTA,24,82,24,22,46
100,8482110,Dawson Mercer,C,NJD,23,82,23,23,46
100,8480185,Eetu Luostarinen,C,FLA,26,82,23,23,46
100,8475768,Jaden Schwartz,C,SEA,32,82,21,25,46
100,8476461,Sean Couturier,C,PHI,32,82,18,28,46
100,8476399,Blake Coleman,C,CGY,33,82,17,29,46
100,8474150,Mikael Backlund,C,CGY,35,82,15,31,46
100,8476458,Ryan Strome,C,ANA,31,82,14,32,46
100,8477021,Alex Kerfoot,C,UTA,30,82,13,33,46
100,8477346,MacKenzie Weegar,D,CGY,30,82,13,33,46
100,8481542,Moritz Seider,D,DET,23,82,5,41,46
100,8480064,Josh Norris,C,OTT,25,82,23,22,45
100,8475191,Reilly Smith,R,NYR,33,82,23,22,45
100,8478233,Andrew Mangiapane,L,WSH,28,82,22,23,45
100,8482699,Dylan Guenther,R,UTA,21,82,22,23,45
100,8475793,Ryan Johansen,C,PHI,32,82,22,23,45
100,8478856,Conor Garland,R,VAN,28,82,15,30,45
100,8476869,Brady Skjei,D,NSH,30,82,14,31,45
100,8470621,Corey Perry,R,EDM,39,82,30,14,44
100,8482475,Yegor Chinakhov,R,CBJ,23,82,24,20,44
100,8476438,Brandon Saad,L,STL,32,82,20,24,44
100,8478057,Dakota Joshua,C,VAN,28,82,19,25,44
100,8473422,Nick Foligno,L,CHI,37,82,15,29,44
100,8478472,Mathieu Joseph,R,STL,27,82,9,35,44
100,8475764,Cam Fowler,D,ANA,33,82,8,36,44
100,8477425,Miles Wood,L,COL,29,82,23,20,43
100,8478542,Evan Rodrigues,C,FLA,31,82,20,23,43
100,8477952,Robby Fabbri,C,ANA,28,82,20,23,43
100,8477479,Tyler Bertuzzi,L,CHI,29,82,19,24,43
100,8480220,Noah Cates,L,PHI,25,82,17,26,43
100,8478458,Jack Roslovic,C,CAR,27,82,17,26,43
100,8475714,Calle Jarnkrok,C,TOR,33,82,16,27,43
100,8480748,Kiefer Sherwood,L,VAN,29,82,16,27,43
100,8476927,Teddy Blueger,C,VAN,30,82,15,28,43
100,8482105,Jake Sanderson,D,OTT,22,82,14,29,43
100,8475149,Marcus Johansson,L,MIN,34,82,13,30,43
100,8478891,Mason Appleton,C,WPG,28,82,20,22,42
100,8476419,Jean-Gabriel Pageau,C,NYI,32,82,19,23,42
100,8477998,Warren Foegele,L,LAK,28,82,18,24,42
100,8480871,Adam Boqvist,D,FLA,24,82,9,33,42
100,8476981,Josh Anderson,R,MTL,30,82,24,17,41
100,8475314,Anders Lee,L,NYI,34,82,21,20,41
100,8479996,Cody Glass,C,NSH,25,82,18,23,41
100,8476897,Oskar Sundqvist,C,STL,30,82,15,26,41
100,8477498,Darnell Nurse,D,EDM,29,82,11,30,41
100,8480003,Jesper Boqvist,C,FLA,26,82,10,31,41
100,8477932,Aaron Ekblad,D,FLA,28,82,9,32,41
100,8475171,Oliver Ekman-Larsson,D,TOR,33,82,9,32,41
100,8476480,Vladislav Namestnikov,C,WPG,32,82,14,26,40
100,8480817,K'Andre Miller,D,NYR,24,82,11,29,40
100,8477495,Seth Jones,D,CHI,30,82,6,34,40
100,8476931,Jake McCabe,D,TOR,31,82,4,36,40
100,8482740,Wyatt Johnston,C,DAL,21,82,23,16,39
100,8478109,Victor Olofsson,L,VGK,29,82,23,16,39
100,8471698,T.J. Oshie,R,WSH,38,82,22,17,39
100,8481560,Arthur Kaliyev,R,LAK,23,82,21,18,39
100,8476292,Ondrej Palat,L,NJD,33,82,20,19,39
100,8481535,Nils Hoglander,L,VAN,24,82,19,20,39
100,8475220,Marcus Foligno,L,MIN,33,82,18,21,39
100,8475763,Kevin Hayes,R,PIT,32,82,14,25,39
100,8476925,Colton Sissons,C,NSH,31,82,14,25,39
100,8475287,Erik Haula,L,NJD,33,82,13,26,39
100,8482097,Jack Quinn,R,BUF,23,82,8,31,39
100,8479393,Noah Gregor,C,OTT,26,82,23,15,38
100,8482092,Ridly Greig,C,OTT,22,82,20,18,38
100,8475760,Nick Bjugstad,C,UTA,32,82,20,18,38
100,8480798,Philipp Kurashev,C,CHI,25,82,13,25,38
100,8476872,Scott Laughton,C,PHI,30,82,12,26,38
100,8482122,Brock Faber,D,MIN,22,82,8,30,38
100,8476979,Erik Gustafsson,D,DET,32,82,5,33,38
100,8480043,Timothy Liljegren,D,TOR,25,82,4,34,38
100,8479371,Dante Fabbro,D,NSH,26,82,4,34,38
100,8481704,Juuso Parssinen,C,NSH,23,82,23,14,37
100,8481554,Kaapo Kakko,R,NYR,23,82,21,16,37
100,8479414,Nathan Bastian,R,NJD,27,82,20,17,37
100,8481477,Nico Sturm,C,SJS,29,82,20,17,37
100,8477953,Kasperi Kapanen,R,STL,28,82,18,19,37
100,8475799,Nino Niederreiter,R,WPG,32,82,16,21,37
100,8481093,Rafael Harvey-Pinard,L,MTL,25,82,16,21,37
100,8481553,Bobby Brink,R,PHI,23,82,10,27,37
100,8478133,Jake Evans,C,MTL,28,82,9,28,37
100,8480873,Rasmus Sandin,D,WSH,24,82,6,31,37
100,8482079,Marco Rossi,C,MIN,23,82,17,19,36
100,8477987,Ryan Donato,C,CHI,28,82,16,20,36
100,8480009,Eeli Tolvanen,R,SEA,25,82,15,21,36
100,8475218,Mattias Ekholm,D,EDM,34,82,10,26,36
100,8482175,JJ Peterka,R,BUF,22,82,20,15,35
100,8477903,Garnet Hathaway,R,PHI,33,82,18,17,35
100,8477426,Nicholas Paul,L,TBL,29,82,16,19,35
100,8478413,Jordan Greenway,L,BUF,27,82,16,19,35
100,8478020,Michael Amadio,C,OTT,28,82,15,20,35
100,8473563,Nicklas Backstrom,C,WSH,37,82,14,21,35
100,8479365,Trent Frederic,C,BOS,26,82,14,21,35
100,8476392,Adam Lowry,C,WPG,31,82,13,22,35
100,8476958,Jaccob Slavin,D,CAR,30,82,11,24,35
100,8475188,Brayden McNabb,D,VGK,33,82,4,31,35
100,8481580,Connor McMichael,C,WSH,23,82,22,12,34
100,8476483,Rickard Rakell,R,PIT,31,82,20,14,34
100,8481604,Pavel Dorofeyev,L,VGK,24,82,17,17,34
100,8474053,Logan Couture,C,SJS,35,82,12,22,34
100,8480068,Ryan Poehling,C,PHI,25,82,12,22,34
100,8480144,David Kampf,C,TOR,29,82,11,23,34
100,8483457,Lane Hutson,D,MTL,20,82,11,23,34
100,8475343,Nic Dowd,C,WSH,34,82,12,21,33
100,8476960,Andreas Athanasiou,C,CHI,30,82,11,22,33
100,8476329,Travis Boyd,C,MIN,31,82,9,24,33
100,8482671,Owen Power,D,BUF,22,82,8,25,33
100,8476885,Jacob Trouba,D,NYR,30,82,5,28,33
100,8479369,Andrew Peeke,D,BOS,26,82,3,30,33
100,8478115,Pierre Engvall,L,NYI,28,82,18,14,32
100,8482146,Luke Evangelista,R,NSH,22,82,17,15,32
100,8484153,Leo Carlsson,C,ANA,20,82,15,17,32
100,8476469,Joel Armia,R,MTL,31,82,13,19,32
100,8480145,Neal Pionk,D,WPG,29,82,8,24,32
100,8474673,TJ Brodie,D,CHI,34,82,7,25,32
100,8476854,Hampus Lindholm,D,BOS,30,82,6,26,32
100,8479976,Juuso Valimaki,D,UTA,26,82,6,26,32
100,8479398,Samuel Girard,D,COL,26,82,4,28,32
100,8476879,Cody Ceci,D,EDM,31,82,4,28,32
100,8480893,Kirill Marchenko,R,CBJ,24,82,20,11,31
100,8479992,Michael Rasmussen,C,DET,25,82,17,14,31
100,8481186,Logan O'Connor,R,COL,28,82,17,14,31
100,8479316,Luke Kunin,C,SJS,27,82,15,16,31
100,8478463,Anthony Beauvillier,L,PIT,27,82,13,18,31
100,8482117,Lukas Reichel,L,CHI,22,82,13,18,31
100,8483431,Logan Cooley,C,UTA,20,82,13,18,31
100,8480113,Alex Iafallo,L,WPG,31,82,11,20,31
100,8474149,Evgenii Dadonov,R,DAL,35,82,11,20,31
100,8483490,Pavel Mintyukov,D,ANA,21,82,8,23,31
100,8477947,Sonny Milano,L,WSH,28,82,6,25,31
100,8477948,Travis Sanheim,D,PHI,28,82,4,27,31
100,8477450,Jason Dickinson,C,CHI,29,82,18,12,30
100,8481582,Nicholas Robertson,L,TOR,23,82,17,13,30
100,8483515,Juraj Slafkovsky,L,MTL,20,82,17,13,30
100,8482055,Drew O'Connor,L,PIT,26,82,16,14,30
100,8479353,Brett Howden,C,VGK,26,82,15,15,30
100,8475855,Jesper Fast,R,CAR,33,82,15,15,30
100,8482624,Daniil Miromanov,D,CGY,27,82,15,15,30
100,8476624,Barclay Goodrow,C,SJS,31,82,14,16,30
100,8475848,Brendan Gallagher,R,MTL,32,82,13,17,30
100,8477989,Christian Dvorak,C,MTL,28,82,13,17,30
100,8484203,Bradly Nadeau,L,CAR,19,82,13,17,30
100,8483499,Liam Ohgren,L,MIN,20,82,13,17,30
100,8475193,Tomas Tatar,L,NJD,34,82,12,18,30
100,8481481,Blake Lizotte,C,PIT,27,82,12,18,30
100,8477508,Curtis Lazar,C,NJD,29,82,12,18,30
100,8477353,Tyler Motte,C,DET,29,82,11,19,30
100,8482655,J.J. Moser,D,TBL,24,82,10,20,30
100,8474716,Jared Spurgeon,D,MIN,35,82,9,21,30
100,8476312,Josh Manson,D,COL,33,82,9,21,30
100,8476422,Mike Reilly,D,NYI,31,82,7,23,30
100,8480049,Dylan Samberg,D,WPG,25,82,6,24,30
100,8475722,Jason Zucker,L,BUF,32,82,16,13,29
100,8476889,Radek Faksa,C,STL,30,82,15,14,29
100,8484145,Zach Benson,L,BUF,19,82,14,15,29
100,8481013,Jonatan Berggren,R,DET,24,82,13,16,29
100,8476474,Stefan Noesen,R,NJD,31,82,12,17,29
100,8474189,Lars Eller,C,PIT,35,82,12,17,29
100,8480025,MacKenzie Entwistle,R,FLA,25,82,12,17,29
100,8481546,Cam York,D,PHI,23,82,9,20,29
100,8477369,Carson Soucy,D,VAN,30,82,9,20,29
100,8482062,Cole Smith,L,NSH,29,82,8,21,29
100,8478882,Vladislav Gavrikov,D,LAK,29,82,6,23,29
100,8479402,Jake Bean,D,CGY,26,82,6,23,29
100,8475181,Nick Leddy,D,STL,33,82,6,23,29
100,8482142,Jamie Drysdale,D,PHI,22,82,5,24,29
100,8480813,Joe Veleno,C,DET,24,82,17,11,28
100,8482125,Alexander Holtz,R,VGK,22,82,16,12,28
100,8478013,Jake Walman,D,SJS,28,82,14,14,28
100,8481624,Ilya Mikheyev,R,CHI,30,82,12,16,28
100,8482111,Justin Barron,D,MTL,23,82,11,17,28
100,8482073,Braden Schneider,D,NYR,23,82,7,21,28
100,8476463,Jonas Brodin,D,MIN,31,82,4,24,28
100,8474151,Ryan McDonagh,D,TBL,35,82,4,24,28
100,8476917,Adam Pelech,D,NYI,30,82,4,24,28
100,8479661,Tanner Jeannot,L,LAK,27,82,17,10,27
100,8477429,Andrew Copp,C,DET,30,82,13,14,27
100,8473533,Jordan Staal,C,CAR,36,82,13,14,27
100,8479390,Taylor Raddysh,R,WSH,26,82,13,14,27
100,8479368,Max Jones,L,BOS,26,82,12,15,27
100,8478434,Keegan Kolesar,R,VGK,27,82,12,15,27
100,8484166,Adam Fantilli,C,CBJ,20,82,11,16,27
100,8477931,Tomas Nosek,L,FLA,32,82,8,19,27
100,8480802,Ryan McLeod,C,BUF,25,82,7,20,27
100,8477220,Nate Schmidt,D,FLA,33,82,7,20,27
100,8479983,Mario Ferraro,D,SJS,26,82,6,21,27
100,8480336,Sean Walker,D,CAR,30,82,4,23,27
100,8480073,Erik Brannstrom,D,COL,25,82,4,23,27
100,8481178,Egor Zamula,D,PHI,24,82,3,24,27
100,8478851,Alexandre Carrier,D,NSH,28,82,3,24,27
100,8479941,Justin Danforth,R,CBJ,31,82,17,9,26
100,8479291,Kevin Rooney,C,CGY,31,82,13,13,26
100,8476374,Sean Kuraly,C,CBJ,31,82,11,15,26
100,8482762,Simon Edvinsson,D,DET,21,82,11,15,26
100,8479293,Brandon Tanev,L,SEA,33,82,10,16,26
100,8480806,Isac Lundestrom,C,ANA,25,82,9,17,26
100,8477015,Connor Brown,R,EDM,30,82,9,17,26
100,8476457,Adam Larsson,D,SEA,32,82,8,18,26
100,8481606,Jordan Spence,D,LAK,23,82,7,19,26
100,8475200,Dmitry Orlov,D,CAR,33,82,6,20,26
100,8477919,Frederick Gaudreau,C,MIN,31,82,6,20,26
100,8478507,John Marino,D,UTA,27,82,6,20,26
100,8475324,Nick Jensen,D,OTT,34,82,4,22,26
100,8478500,Ivan Provorov,D,CBJ,27,82,4,22,26
100,8479324,Ryan Lindgren,D,NYR,26,82,4,22,26
100,8476873,Mark Jankowski,C,NSH,30,82,11,14,25
100,8478569,Noel Acciari,C,PIT,33,82,11,14,25
100,8483493,Frank Nazar,C,CHI,20,82,9,16,25
100,8482087,Kaiden Guhle,D,MTL,22,82,6,19,25
100,8476467,Jamie Oleksiak,D,SEA,32,82,6,19,25
100,8481568,Alex Vlasic,D,CHI,23,82,2,23,25
100,8475462,Radko Gudas,D,ANA,34,82,2,23,25
100,8478508,Yakov Trenin,C,MIN,27,82,16,8,24
100,8481517,Brett Leason,R,ANA,25,82,15,9,24
100,8476918,Jimmy Vesey,L,NYR,31,82,12,12,24
100,8481522,Peyton Krebs,C,BUF,23,82,9,15,24
100,8482660,Kent Johnson,C,CBJ,22,82,8,16,24
100,8477507,Nikita Zadorov,D,BOS,29,82,8,16,24
100,8482133,Thomas Bordeleau,C,SJS,22,82,7,17,24
100,8478178,Darren Raddysh,D,TBL,28,82,7,17,24
100,8476331,Dylan DeMelo,D,WPG,31,82,6,18,24
100,8477839,Conor Sheary,L,TBL,32,82,5,19,24
100,8476923,Damon Severson,D,CBJ,30,82,4,20,24
100,8479980,Nicolas Hague,D,VGK,26,82,4,20,24
100,8473507,Jeff Petry,D,DET,37,82,3,21,24
100,8480835,Jack Drury,C,CAR,24,82,15,8,23
100,8480855,Jack McBain,C,UTA,24,82,9,14,23
100,8483524,Shane Wright,C,SEA,20,82,9,14,23
100,8479351,Sam Steel,C,DAL,26,82,8,15,23
100,8479591,Michael Eyssimont,C,TBL,28,82,8,15,23
100,8474574,Tyler Myers,D,VAN,34,82,6,17,23
100,8476891,Matt Grzelcyk,D,PIT,30,82,4,19,23
100,8482245,Artem Zub,D,OTT,29,82,3,20,23
100,8477506,Ryan Pulock,D,NYI,30,82,2,21,23
100,8482702,Logan Stankoven,C,DAL,21,82,12,10,22
100,8482074,Connor Zary,C,CGY,23,82,12,10,22
100,8480878,Nils Lundkvist,D,DAL,24,82,8,14,22
100,8482141,Lukas Cormier,D,VGK,22,82,8,14,22
100,8478859,Niko Mikkola,D,FLA,28,82,8,14,22
100,8483565,Nick Blankenburg,D,NSH,26,82,7,15,22
100,8477406,Mattias Janmark,C,EDM,32,82,7,15,22
100,8483763,Maksymilian Szuber,D,UTA,22,82,6,16,22
100,8480796,Martin Fehervary,D,WSH,25,82,4,18,22
100,8480281,Alexey Toropchenko,R,STL,25,82,11,10,21
100,8473453,Trevor Lewis,C,LAK,37,82,11,10,21
100,8482166,Shakir Mukhamadullin,D,SJS,22,82,9,12,21
100,8480789,Oliver Wahlstrom,R,NYI,24,82,8,13,21
100,8478443,Brandon Carlo,D,BOS,28,82,8,13,21
100,8478911,Matt Roy,D,WSH,29,82,4,17,21
100,8476372,Nick Seeler,D,PHI,31,82,4,17,21
100,8481567,Henry Thrun,D,SJS,23,82,3,18,21
100,8481032,Paul Cotter,C,NJD,25,82,15,5,20
100,8482659,Josh Doan,R,UTA,22,82,11,9,20
100,8481699,Aku Raty,R,UTA,23,82,9,11,20
100,8480990,Declan Chisholm,D,MIN,24,82,9,11,20
100,8477505,Alexander Wennberg,C,SJS,30,82,8,12,20
100,8475842,Sam Carrick,C,NYR,32,82,8,12,20
100,8482787,Nikita Chibrikov,R,WPG,31,82,8,12,20
100,8482470,Ilya Solovyov,D,CGY,24,82,8,12,20
100,8483495,Simon Nemec,D,NJD,20,82,7,13,20
100,8480222,Sebastian Aho,D,PIT,28,82,5,15,20
100,8477499,Rasmus Ristolainen,D,PHI,30,82,4,16,20
100,8475279,Ben Chiarot,D,DET,33,82,4,16,20
100,8476525,Colin Miller,D,WPG,32,82,4,16,20
100,8479442,Troy Stecher,D,EDM,30,82,4,16,20
100,8478416,Erik Cernak,D,TBL,27,82,3,17,20
100,8475233,David Savard,D,MTL,34,82,3,17,20
100,8470600,Ryan Suter,D,STL,39,82,2,18,20
100,8475455,Brenden Dillon,D,NJD,34,82,2,18,20
100,8474090,Brendan Smith,D,DAL,35,82,2,18,20
100,8480995,Pontus Holmberg,R,TOR,25,82,13,6,19
100,8482077,Dylan Holloway,L,EDM,23,82,12,7,19
100,8477392,Hudson Fasching,R,NYI,29,82,11,8,19
100,8476858,Phillip Di Giuseppe,L,VAN,31,82,11,8,19
100,8480980,Connor Dewar,C,TOR,25,82,8,11,19
100,8481605,Jackson LaCombe,D,ANA,23,82,8,11,19
100,8483397,Marc McLaughlin,C,BOS,25,82,8,11,19
100,8483468,Jiri Kulich,C,BUF,20,82,7,12,19
100,8484149,Gavin Brindley,C,CBJ,20,82,7,12,19
100,8480074,Alexandre Texier,C,STL,25,82,6,13,19
100,8481708,Zac Jones,D,NYR,24,82,4,15,19
100,8477845,Trevor van Riemsdyk,D,WSH,33,82,3,16,19
100,8482679,Matt Coronato,R,CGY,22,82,11,7,18
100,8475231,Casey Cizikas,C,NYI,33,82,10,8,18
100,8483482,Tristan Luneau,D,ANA,20,82,8,10,18
100,8483445,Cutter Gauthier,L,ANA,20,82,6,12,18
100,8482118,Sam Colangelo,R,ANA,23,82,6,12,18
100,8478211,Dryden Hunt,L,CGY,29,82,5,13,18
100,8474013,Ian Cole,D,UTA,35,82,5,13,18
100,8476902,Esa Lindell,D,DAL,30,82,4,14,18
100,8479998,Mikey Anderson,D,LAK,25,82,4,14,18
100,8477938,Haydn Fleury,D,WPG,28,82,4,14,18
100,8475690,Chris Tanev,D,TOR,35,82,3,15,18
100,8482803,Olen Zellweger,D,ANA,21,82,3,15,18
100,8478136,Jake Middleton,D,MIN,28,82,2,16,18
100,8480950,Ilya Lyubushkin,D,DAL,30,82,2,16,18
100,8476278,Colin Blackwell,C,DAL,31,82,10,7,17
100,8482101,Danil Gushchin,L,SJS,22,82,7,10,17
100,8483505,Matthew Poitras,C,BOS,20,82,6,11,17
100,8476442,Matt Nieto,L,PIT,32,82,5,12,17
100,8481641,Joel Kiviranta,L,COL,28,82,5,12,17
100,8483567,Georgii Merkulov,C,BOS,24,82,4,13,17
100,8480807,Mattias Samuelsson,D,BUF,24,82,4,13,17
100,8481014,Alexander Romanov,D,NYI,24,82,3,14,17
100,8477488,Brett Pesce,D,NJD,30,82,3,14,17
100,8478840,Will Borgen,D,SEA,28,82,3,14,17
100,8480246,Nick Perbix,D,TBL,26,82,3,14,17
100,8477435,Ryan Graves,D,PIT,29,82,2,15,17
100,8480035,Henri Jokiharju,D,BUF,25,82,1,16,17
100,8477365,Connor Clifton,D,BUF,29,82,1,16,17
100,8481601,Simon Holmstrom,R,NYI,23,82,11,5,16
100,8482259,Bobby McMann,C,TOR,28,82,10,6,16
100,8479359,Beck Malenstyn,L,BUF,26,82,9,7,16
100,8475177,Calvin de Haan,D,COL,33,82,8,8,16
100,8478432,Christian Fischer,R,DET,27,82,7,9,16
100,8482713,Mackie Samoskevich,R,FLA,22,82,7,9,16
100,8483012,Logan Morrison,C,SEA,22,82,6,10,16
100,8482733,Logan Mailloux,D,MTL,31,82,5,11,16
100,8476429,Scott Mayfield,D,NYI,32,82,4,12,16
100,8475790,Erik Gudbranson,D,CBJ,32,82,4,12,16
100,8484911,Collin Graf,R,SJS,22,82,2,14,16
100,8482809,Jackson Blake,R,CAR,21,82,8,7,15
100,8479638,Justin Brazeau,R,BOS,26,82,8,7,15
100,8482666,Scott Morrow,D,CAR,22,82,6,9,15
100,8482153,Brendan Brisson,C,VGK,23,82,5,10,15
100,8480834,Ty Emberson,D,SJS,24,82,5,10,15
100,8476473,Connor Murphy,D,CHI,31,82,3,12,15
100,8476967,Brett Kulak,D,EDM,30,82,2,13,15
100,8482145,Mavrik Bourque,C,DAL,22,82,2,13,15
100,8480860,Kevin Bahl,D,CGY,24,82,1,14,15
100,8474567,Zach Bogosian,D,MIN,34,82,1,14,15
100,8478399,Jonas Siegenthaler,D,NJD,27,82,0,15,15
100,8482155,Alex Laferriere,R,LAK,23,82,7,7,14
100,8482858,Ryker Evans,D,SEA,23,82,5,9,14
100,8482807,Ethan Del Mastro,D,CHI,21,82,4,10,14
100,8481122,Simon Benoit,D,TOR,26,82,3,11,14
100,8474612,Travis Hamonic,D,OTT,34,82,3,11,14
100,8477335,Kyle Burroughs,D,LAK,29,82,2,12,14
100,8480172,Jan Rutta,D,SJS,34,82,2,12,14
100,8478450,Parker Wotherspoon,D,BOS,27,82,2,12,14
100,8480870,Bo Groulx,C,NYR,24,82,7,6,13
100,8477034,Jaycob Megna,D,FLA,32,82,5,8,13
100,8482712,Oskar Olausson,R,COL,22,82,5,8,13
100,8479576,Vincent Desharnais,D,VAN,28,82,5,8,13
100,8481524,Bowen Byram,D,BUF,23,82,3,10,13
100,8480879,Jacob Bernard-Docker,D,OTT,24,82,1,12,13
100,8475762,Derek Forbort,D,VAN,32,82,1,12,13
100,8475718,Justin Holl,D,DET,32,82,0,13,13
100,8480448,Parker Kelly,L,COL,25,82,9,3,12
100,8482749,Joshua Roy,R,MTL,21,82,9,3,12
100,8476822,Luke Glendening,C,TBL,35,82,7,5,12
100,8482070,Mitchell Chaffee,R,TBL,26,82,5,7,12
100,8476878,Zemgus Girgensons,L,TBL,30,82,7,4,11
100,8480021,Jack Studnicka,C,LAK,25,82,5,6,11
100,8476441,Joel Edmundson,D,LAK,31,82,2,9,11
100,8478468,Jeremy Lauzon,D,NSH,27,82,1,10,11
100,8483460,David Jiricek,D,CBJ,21,82,1,10,11
100,8471677,Jack Johnson,D,CBJ,37,82,3,7,10
100,8481028,Martin Pospisil,C,CGY,25,82,4,5,9
100,8483471,Brad Lambert,C,WPG,31,82,3,6,9
100,8482859,Zack Ostapchuk,C,OTT,21,82,3,6,9
100,8483466,Kevin Korchinski,D,CHI,20,82,3,6,9
100,8478874,Adam Gaudette,C,OTT,28,82,0,9,9
100,8482516,Matthew Kessel,D,STL,24,82,2,6,8
100,8474062,Riley Nash,C,NYR,35,82,1,7,8
100,8483489,Fraser Minten,C,TOR,31,82,1,6,7
100,8470794,Joe Pavelski,C,,40,0,0,0,0
100,8481703,Valtteri Puustinen,R,PIT,25,0,0,0,0
100,8477950,Tony DeAngelo,D,,29,0,0,0,0
100,8481577,Philip Tomasino,C,NSH,23,0,0,0,0
100,8475197,Tyson Barrie,D,,33,0,0,0,0
100,8471218,Blake Wheeler,R,,38,0,0,0,0
100,8474157,Max Pacioretty,L,,36,0,0,0,0
100,8478466,Daniel Sprong,R,VAN,27,0,0,0,0
100,8475744,Evgeny Kuznetsov,C,,32,0,0,0,0
100,8481019,David Gustafsson,C,WPG,24,0,0,0,0
100,8475906,John Klingberg,D,,32,0,0,0,0
100,8479348,Kale Clague,D,BUF,26,0,0,0,0
100,8476952,Dominic Toninato,C,WPG,30,0,0,0,0
100,8473473,Milan Lucic,L,,36,0,0,0,0
100,8474037,James van Riemsdyk,L,,35,0,0,0,0
100,8474602,Justin Schultz,D,,34,0,0,0,0
100,8482222,Alexander Barabanov,L,,30,0,0,0,0
100,8479372,Josh Mahura,D,SEA,26,0,0,0,0
100,8479982,Conor Timmins,D,TOR,26,0,0,0,0
100,8474031,Kevin Shattenkirk,D,,35,0,0,0,0
100,8480008,Adam Ruzicka,C,,25,0,0,0,0
100,8481059,Scott Perunovich,D,STL,26,0,0,0,0
100,8480884,Calen Addison,D,,24,0,0,0,0
100,8476994,Vinnie Hinostroza,C,NSH,30,0,0,0,0
100,8478452,Caleb Jones,D,LAK,27,0,0,0,0
100,8480157,Calle Rosen,D,COL,30,0,0,0,0
100,8481609,Vladislav Kolyachonok,D,UTA,23,0,0,0,0
100,8479415,Michael McLeod,C,,26,0,0,0,0
100,8476919,Chris Tierney,C,,30,0,0,0,0
100,8479639,Dylan Coghlan,D,WPG,26,0,0,0,0
100,8478146,Matthew Highmore,C,OTT,28,0,0,0,0
100,8478970,Jalen Chatfield,D,CAR,28,0,0,0,0
100,8480205,Emil Bemstrom,C,PIT,25,0,0,0,0
100,8474884,Mike Hoffman,C,,35,0,0,0,0
100,8471274,Alex Goligoski,D,,39,0,0,0,0
100,8478104,Sammy Blais,L,,28,0,0,0,0
100,8474870,Tyler Johnson,C,,34,0,0,0,0
100,8476913,Devin Shore,C,MIN,30,0,0,0,0
100,8481598,Philip Broberg,D,EDM,23,0,0,0,0
100,8480058,Pierre-Olivier Joseph,D,STL,25,0,0,0,0
100,8480891,Michael Kesselring,D,UTA,24,0,0,0,0
100,8477979,Nicolas Aube-Kubel,R,BUF,28,0,0,0,0
100,8476871,Tanner Pearson,L,,32,0,0,0,0
100,8476393,Nick Cousins,C,,31,0,0,0,0
100,8479977,Kailer Yamamoto,R,,26,0,0,0,0
100,8479543,Michael Pezzetta,L,MTL,26,0,0,0,0
100,8477018,Ben Hutton,D,VGK,31,0,0,0,0
100,8480762,Eric Robinson,L,CAR,29,0,0,0,0
100,8474034,Pat Maroon,L,CHI,36,0,0,0,0
100,8481058,Jesse Ylönen,R,,25,0,0,0,0
100,8475179,Dmitry Kulikov,D,FLA,34,0,0,0,0
100,8481527,Kaedan Korczak,D,VGK,23,0,0,0,0
100,8473449,Kyle Okposo,R,,36,0,0,0,0
100,8482192,Isaak Phillips,D,CHI,23,0,0,0,0
100,8480727,Zach Whitecloud,D,VGK,28,0,0,0,0
100,8479346,Dillon Dube,C,,26,0,0,0,0
100,8480821,Filip Zadina,R,,25,0,0,0,0
100,8480001,Urho Vaakanainen,D,ANA,25,0,0,0,0
100,8470966,Mark Giordano,D,,41,0,0,0,0
100,8480853,Liam Foudy,C,,24,0,0,0,0
100,8475225,Craig Smith,C,CHI,35,0,0,0,0
100,8479972,Mason Shaw,C,WPG,26,0,0,0,0
100,8478451,Ethan Bear,D,WSH,27,0,0,0,0
100,8474040,Sam Gagner,C,,35,0,0,0,0
100,8480196,Jacob Bryson,D,BUF,27,0,0,0,0
100,8479984,Cal Foote,D,,26,0,0,0,0
100,8480011,Klim Kostin,C,SJS,25,0,0,0,0
100,8482176,Wyatt Kaiser,D,CHI,22,0,0,0,0
100,8476988,Matt Benning,D,SJS,30,0,0,0,0
100,8479370,Tyson Jost,C,CAR,26,0,0,0,0
100,8477464,Nic Petan,C,,29,0,0,0,0
100,8477380,Jonny Brodzinski,C,NYR,31,0,0,0,0
100,8480070,Ian Mitchell,D,BOS,25,0,0,0,0
100,8479315,Joey Anderson,R,CHI,26,0,0,0,0
100,8478099,Kevin Labanc,R,,29,0,0,0,0
100,8476874,Olli Maatta,D,DET,30,0,0,0,0
100,8475208,Brian Dumoulin,D,ANA,33,0,0,0,0
100,8478430,Oliver Kylington,D,,27,0,0,0,0
100,8479536,Axel Jonsson-Fjallby,L,WPG,26,0,0,0,0
100,8479671,Mathieu Olivier,R,CBJ,27,0,0,0,0
100,8471709,Marc-Edouard Vlasic,D,SJS,37,0,0,0,0
100,8479328,Julien Gauthier,R,NYI,27,0,0,0,0
100,8478421,A.J. Greer,L,FLA,28,0,0,0,0
100,8477573,Nathan Walker,L,STL,30,0,0,0,0
100,8481537,Nikita Okhotiuk,D,CGY,24,0,0,0,0
100,8474166,Alec Martinez,D,CHI,37,0,0,0,0
100,8470610,Zach Parise,L,,40,0,0,0,0
100,8477478,William Carrier,L,CAR,30,0,0,0,0
100,8479344,Jesse Puljujarvi,R,PIT,26,0,0,0,0
100,8480887,Jordan Harris,D,MTL,24,0,0,0,0
100,8478502,Dennis Gilbert,D,BUF,28,0,0,0,0
100,8482730,Brandt Clarke,D,LAK,21,0,0,0,0
100,8480355,Mark Kastelic,C,BOS,25,0,0,0,0
100,8475750,Jon Merrill,D,MIN,32,0,0,0,0
100,8475164,Jakob Silfverberg,R,,34,0,0,0,0
100,8477944,Jakub Vrana,L,,28,0,0,0,0
100,8479439,Jacob MacDonald,D,COL,31,0,0,0,0
100,8474568,Luke Schenn,D,NSH,35,0,0,0,0
100,8478454,Noah Juulsen,D,VAN,27,0,0,0,0
100,8475752,Tyler Pitlick,C,,33,0,0,0,0
100,8482148,Hendrix Lapierre,C,WSH,22,0,0,0,0
100,8481167,Brayden Pachal,D,CGY,25,0,0,0,0
100,8478043,Sam Lafferty,C,BUF,29,0,0,0,0
100,8479321,Lucas Johansen,D,,27,0,0,0,0
100,8471699,Andrew Cogliano,C,,37,0,0,0,0
100,8481521,Ronnie Attard,D,PHI,25,0,0,0,0
100,8481161,Jake Christiansen,D,CBJ,25,0,0,0,0
100,8479458,Nikita Zaitsev,D,,33,0,0,0,0
100,8479619,Michael Carcone,L,UTA,28,0,0,0,0
100,8479026,Philippe Myers,D,TOR,27,0,0,0,0
100,8477330,Dominik Kubalik,L,,29,0,0,0,0
100,8481617,Vasily Podkolzin,R,VAN,23,0,0,0,0
100,8481701,Santeri Hatakka,D,NJD,23,0,0,0,0
100,8479514,Rem Pitlick,C,,27,0,0,0,0
100,8477446,Michael McCarron,R,NSH,29,0,0,0,0
100,8470604,Jeff Carter,C,,39,0,0,0,0
100,8482241,Radim Zohorna,L,,28,0,0,0,0
100,8480289,Morgan Barron,C,WPG,26,0,0,0,0
100,8479379,Givani Smith,R,SJS,26,0,0,0,0
100,8480216,Jacob Peterson,C,,25,0,0,0,0
100,8477851,Jordan Oesterle,D,BOS,32,0,0,0,0
100,8484258,Sam Malinski,D,COL,26,0,0,0,0
100,8478904,Steven Lorentz,C,,28,0,0,0,0
100,8482095,Tyler Kleven,D,OTT,22,0,0,0,0
100,8480848,Ty Dellandrea,C,SJS,24,0,0,0,0
100,8476884,Derrick Pouliot,D,,30,0,0,0,0
100,8479336,Carl Grundstrom,R,SJS,27,0,0,0,0
100,8482964,Arber Xhekaj,D,MTL,23,0,0,0,0
100,8471686,Marc Staal,D,,37,0,0,0,0
100,8477887,Patrick Brown,C,BOS,32,0,0,0,0
100,8478495,Denis Gurianov,R,,27,0,0,0,0
100,8473504,Cal Clutterbuck,R,,37,0,0,0,0
100,8481550,Adam Beckman,L,NJD,23,0,0,0,0
100,8480845,Rasmus Kupari,C,WPG,24,0,0,0,0
100,8474009,Nick Bonino,C,,36,0,0,0,0
100,8478585,Derek Ryan,C,EDM,38,0,0,0,0
100,8477962,Brendan Lemieux,L,CAR,28,0,0,0,0
100,8482861,Vincent Iorio,D,WSH,22,0,0,0,0
100,8479378,Logan Stanley,D,WPG,26,0,0,0,0
100,8473446,Erik Johnson,D,PHI,36,0,0,0,0
100,8481743,Marc Del Gaizo,D,NSH,25,0,0,0,0
100,8477384,Josh Brown,D,EDM,30,0,0,0,0
100,8482165,Yan Kuznetsov,D,CGY,22,0,0,0,0
100,8478424,Jansen Harkins,C,ANA,27,0,0,0,0
100,8482144,Jack Thompson,D,SJS,22,0,0,0,0
100,8478512,Austin Czarnik,C,,32,0,0,0,0
100,8477527,Ross Johnston,L,ANA,30,0,0,0,0
100,8479383,Boris Katchouk,L,,26,0,0,0,0
100,8482094,Daemon Hunt,D,MIN,22,0,0,0,0
100,8481719,Maxwell Crozier,D,TBL,24,0,0,0,0
100,8480192,Johnathan Kovacevic,D,NJD,27,0,0,0,0
100,8479376,Victor Mete,D,,26,0,0,0,0
100,8482511,Mason Lohrei,D,BOS,23,0,0,0,0
100,8475825,Jani Hakanpää,D,,32,0,0,0,0
100,8478021,William Lagesson,D,DET,28,0,0,0,0
100,8475795,Dylan McIlrath,D,WSH,32,0,0,0,0
100,8477846,Ryan Carpenter,C,,33,0,0,0,0
100,8481056,Spencer Stastney,D,NSH,24,0,0,0,0
100,8481564,Ryan Johnson,D,BUF,23,0,0,0,0
100,8478017,Mark Friedman,D,VAN,29,0,0,0,0
100,8479320,Max Lajoie,D,SEA,27,0,0,0,0
100,8480075,Cameron Crotty,D,MIN,25,0,0,0,0
100,8484287,Cole McWard,D,VAN,23,0,0,0,0
100,8484254,Akito Hirose,D,VAN,25,0,0,0,0
100,8483407,Brandon Scanlin,D,NYR,25,0,0,0,0
100,8480274,Philip Kemp,D,EDM,25,0,0,0,0
100,8479522,Hardy Haman Aktell,D,WSH,26,0,0,0,0
100,8480007,Jonas Rondbjerg,R,VGK,25,0,0,0,0
100,8477454,Adam Erne,L,,29,0,0,0,0
100,8481679,Maxence Guenette,D,OTT,23,0,0,0,0
100,8480441,Trey Fix-Wolansky,R,CBJ,25,0,0,0,0
100,8483546,Marshall Rifai,D,TOR,26,0,0,0,0
100,8480084,Nick DeSimone,D,NJD,30,0,0,0,0
100,8481030,Jack St. Ivany,D,PIT,25,0,0,0,0
100,8481592,Jakob Pelletier,L,CGY,23,0,0,0,0
100,8478011,Louie Belpedio,D,PHI,28,0,0,0,0
100,8477930,Pierre-Edouard Bellemare,L,,39,0,0,0,0
100,8484321,Nikolas Matinpalo,D,OTT,26,0,0,0,0
100,8482067,Connor Mackey,D,NYR,28,0,0,0,0
100,8481806,Louis Crevier,D,CHI,23,0,0,0,0
100,8484326,Patrik Koch,D,UTA,28,0,0,0,0
100,8477971,Andreas Englund,D,LAK,28,0,0,0,0
100,8481751,Lukas Rousek,R,BUF,25,0,0,0,0
100,8481006,Tyler Tucker,D,STL,24,0,0,0,0
100,8476867,Brendan Gaunce,C,MIN,30,0,0,0,0
100,8479520,Brandon Duhaime,R,WSH,27,0,0,0,0
100,8477073,Kurtis MacDermid,L,NJD,30,0,0,0,0
100,8480874,Adam Ginning,D,PHI,24,0,0,0,0
100,8477473,Justin Bailey,R,SJS,29,0,0,0,0
100,8479066,Ryan Lomberg,L,CGY,30,0,0,0,0
100,8477070,Liam O'Brien,C,UTA,30,0,0,0,0
100,8474618,Marco Scandella,D,,34,0,0,0,0
100,8475797,Jarred Tinordi,D,,32,0,0,0,0
100,8481441,Joe Snively,C,DET,28,0,0,0,0
100,8477244,Chad Ruhwedel,D,NYR,34,0,0,0,0
100,8479772,Zack MacEwen,R,OTT,28,0,0,0,0
100,8481147,Reese Johnson,C,MIN,26,0,0,0,0
100,8481043,Cole Koepke,L,BOS,26,0,0,0,0
100,8483619,Filip Roos,D,OTT,25,0,0,0,0
100,8481541,Samuel Bolduc,D,NYI,24,0,0,0,0
100,8477810,Joel Hanley,D,CGY,33,0,0,0,0
100,8476907,Mackenzie MacEachern,L,,30,0,0,0,0
100,8482652,Walker Duehr,R,CGY,27,0,0,0,0
100,8477126,Jayson Megna,C,,34,0,0,0,0
100,8483398,Declan Carlile,D,TBL,31,0,0,0,0
100,8482929,Emil Lilleberg,D,TBL,23,0,0,0,0
100,8480880,Jakub Lauko,C,MIN,24,0,0,0,0
100,8480245,Olle Lycksell,R,PHI,25,0,0,0,0
100,8480252,Cole Guttman,C,CHI,25,0,0,0,0
100,8477467,Gustav Olofsson,D,SEA,30,0,0,0,0
100,8479968,Vinni Lettieri,C,BOS,29,0,0,0,0
100,8478400,Colin White,C,,27,0,0,0,0
100,8475755,Alexander Petrovic,D,DAL,32,0,0,0,0
100,8481812,Nikolai Knyzhov,D,,27,0,0,0,0
100,8481593,Jayden Struble,D,MTL,23,0,0,0,0
100,8481532,Alex Turcotte,C,LAK,23,0,0,0,0
100,8482126,Emil Andrae,D,PHI,31,0,0,0,0
100,8479944,Zach Aston-Reese,C,VGK,30,0,0,0,0
100,8471817,Ryan Reaves,R,TOR,37,0,0,0,0
100,8481206,John Ludvig,D,PIT,24,0,0,0,0
100,8481599,Victor Soderstrom,D,UTA,23,0,0,0,0
100,8480292,Carson Meyer,R,ANA,27,0,0,0,0
100,8482496,Nils Aman,C,VAN,24,0,0,0,0
100,8479718,Alex Barré-Boulet,C,MTL,27,0,0,0,0
100,8479994,Jaret Anderson-Dolan,C,WPG,25,0,0,0,0
100,8480184,Gustav Lindstrom,D,,26,0,0,0,0
100,8480890,Jan Jenik,R,OTT,24,0,0,0,0
100,8478067,Oskar Lindblom,L,,28,0,0,0,0
100,8476934,Brock McGinn,L,ANA,30,0,0,0,0
100,8479985,Cale Fleury,D,SEA,26,0,0,0,0
100,8484304,Uvis Balinskis,D,FLA,28,0,0,0,0
100,8479981,Jonah Gadjovich,L,FLA,26,0,0,0,0
100,8481716,Dmitri Voronkov,L,CBJ,24,0,0,0,0
100,8474709,Matt Martin,L,,35,0,0,0,0
100,8482634,Alex Steeves,C,TOR,25,0,0,0,0
100,8480823,Alexander Alexeyev,D,WSH,25,0,0,0,0
100,8477541,Dakota Mermis,D,TOR,30,0,0,0,0
100,8483491,Ivan Miroshnichenko,L,WSH,20,0,0,0,0
100,8478477,Mitchell Stephens,C,SEA,27,0,0,0,0
100,8481543,Nikita Alexandrov,C,STL,24,0,0,0,0
100,8479423,Alex Nylander,L,,26,0,0,0,0
100,8482451,Mikael Pyyhtia,L,CBJ,23,0,0,0,0
100,8478831,Kevin Stenlund,C,UTA,28,0,0,0,0
100,8480306,Grant Hutton,D,NYI,29,0,0,0,0
100,8478028,Fredrik Olofsson,L,,28,0,0,0,0
100,8477462,Robert Hagg,D,VGK,29,0,0,0,0
100,8477320,Anton Blidh,L,NYR,29,0,0,0,0
100,8482157,Will Cuylle,L,NYR,22,0,0,0,0
100,8482737,Zack Bolduc,C,STL,21,0,0,0,0
100,8481239,Samuel Fagemo,L,,24,0,0,0,0
100,8481600,Tobias Bjornfot,D,FLA,23,0,0,0,0
100,8478409,Anthony Richard,C,PHI,28,0,0,0,0
100,8474145,Robert Bortuzzo,D,,35,0,0,0,0
100,8475958,Michael Sgarbossa,C,WSH,32,0,0,0,0
100,8479986,Kole Lind,R,DAL,26,0,0,0,0
100,8479249,Andrew Poturalski,C,SJS,30,0,0,0,0
100,8479362,Riley Tufte,L,BOS,26,0,0,0,0
100,8479991,Jake Leschyshyn,C,NYR,25,0,0,0,0
100,8479587,Rhett Gardner,C,PHI,28,0,0,0,0
100,8482744,James Malatesta,L,CBJ,21,0,0,0,0
100,8478854,Ryan Shea,D,PIT,27,0,0,0,0
100,8481591,Sam Poulin,R,,23,0,0,0,0
100,8483512,Matt Savoie,C,EDM,20,0,0,0,0
100,8482102,Vasily Ponomarev,C,PIT,22,0,0,0,0
100,8482162,Roby Jarventie,L,EDM,22,0,0,0,0
100,8481016,Ruslan Iskhakov,C,,24,0,0,0,0
100,8482172,Landon Slaggert,L,CHI,22,0,0,0,0
100,8482747,Brennan Othmann,L,NYR,21,0,0,0,0
100,8480031,Maxime Comtois,L,,25,0,0,0,0
100,8480226,Marián Studenic,R,,26,0,0,0,0
100,8478408,Travis Dermott,D,,28,0,0,0,0
100,8481518,Nolan Foote,L,NJD,24,0,0,0,0
100,8479419,Brett Murray,L,BUF,26,0,0,0,0
100,8482088,Justin Sourdif,R,FLA,22,0,0,0,0
100,8482201,Gage Goncalves,C,TBL,23,0,0,0,0
100,8481578,Graeme Clarke,R,MIN,23,0,0,0,0
100,8482177,Marat Khusnutdinov,C,MIN,22,0,0,0,0
100,8481754,Nikita Nesterenko,C,ANA,23,0,0,0,0
100,8483531,Brian Halonen,L,NJD,25,0,0,0,0
100,8483920,Pierrick Dube,R,WSH,23,0,0,0,0
100,8480851,Akil Thomas,C,LAK,24,0,0,0,0
100,8475235,Nicolas Deslauriers,L,PHI,33,0,0,0,0
100,8482476,Emil Heineman,L,MTL,23,0,0,0,0
100,8477149,Scott Sabourin,R,SJS,32,0,0,0,0
100,8483549,Lucas Condotta,L,MTL,27,0,0,0,0
100,8482765,Isak Rosen,R,BUF,21,0,0,0,0
100,8481237,Kyle MacLean,C,NYI,25,0,0,0,0
100,8481024,Linus Karlsson,C,VAN,25,0,0,0,0
100,8481690,Tyler Angle,C,,24,0,0,0,0
100,8483570,Ben Meyers,C,SEA,26,0,0,0,0
100,8481655,Cole Schwindt,R,CGY,23,0,0,0,0
100,8481462,Mason Morelli,L,VGK,28,0,0,0,0
100,8483401,Marc Johnstone,R,PIT,28,0,0,0,0
100,8478956,Samuel Laberge,L,NJD,27,0,0,0,0
100,8479533,Joona Koppanen,L,,26,0,0,0,0
100,8482197,Adam Raska,R,MIN,23,0,0,0,0
100,8482250,Callahan Burke,C,VGK,27,0,0,0,0
100,8482784,Zach Dean,C,STL,21,0,0,0,0
100,8484255,Jason Polin,R,COL,25,0,0,0,0
100,8481077,John Leonard,L,,26,0,0,0,0
100,8481534,Raphael Lavoie,C,EDM,24,0,0,0,0
100,8483609,Adam Klapka,R,CGY,24,0,0,0,0
100,8482751,Ryan Winterton,C,SEA,21,0,0,0,0
100,8480267,Sammy Walker,C,MIN,25,0,0,0,0
100,8475766,Austin Watson,L,,32,0,0,0,0
100,8482460,Matt Rempe,C,NYR,22,0,0,0,0
100,8481065,Angus Crookshank,L,OTT,25,0,0,0,0
100,8481070,Hugh McGing,L,,26,0,0,0,0
100,8476323,Max McCormick,L,SEA,32,0,0,0,0
100,8483395,Arshdeep Bains,L,VAN,23,0,0,0,0
100,8484259,Ondrej Pavel,C,COL,31,0,0,0,0
100,8483432,Luca Del Bel Belluz,C,CBJ,31,0,0,0,0
100,8483045,Cameron Butler,R,CBJ,31,0,0,0,0
100,8482061,Brandon Biro,L,SEA,26,0,0,0,0
100,8477401,John Hayden,C,SEA,29,0,0,0,0
100,8475278,Byron Froese,C,,33,0,0,0,0
100,8478446,Glenn Gawdin,C,LAK,27,0,0,0,0
100,8477993,Justin Kirkland,C,CGY,28,0,0,0,0
100,8482147,Jean-Luc Foudy,C,COL,22,0,0,0,0
100,8480032,Shane Bowers,C,NJD,25,0,0,0,0
100,8479330,Brandon Gignac,C,MTL,27,0,0,0,0
100,8480776,Sheldon Rempal,R,,29,0,0,0,0
100,8475413,Justin Dowling,C,NJD,34,0,0,0,0
100,8481726,Adam Edstrom,C,NYR,24,0,0,0,0
100,8480844,Grigori Denisenko,L,VGK,24,0,0,0,0
100,8478147,Bokondji Imama,L,PIT,28,0,0,0,0
100,8478881,Brett Seney,L,CHI,28,0,0,0,0
100,8483630,Pavol Regenda,L,ANA,25,0,0,0,0
100,8480836,Jonathan Gruden,C,,24,0,0,0,0
100,8484314,Jiri Smejkal,L,,28,0,0,0,0
100,8475780,Chris Wagner,R,COL,33,0,0,0,0
100,8479546,Oskar Steen,C,,26,0,0,0,0
100,8483597,Milos Kelemen,L,UTA,25,0,0,0,0
100,8481789,Tye Kartye,L,SEA,23,0,0,0,0
100,8484325,Waltteri Merela,C,TBL,26,0,0,0,0
100,8479421,Jacob Moverare,D,LAK,26,0,0,0,0
100,8481585,Egor Afanasyev,L,SJS,23,0,0,0,0
100,8479547,Matthew Phillips,R,,26,0,0,0,0
100,8479367,William Lockwood,R,FLA,26,0,0,0,0
100,8476915,Jujhar Khaira,L,,30,0,0,0,0
100,8481422,Jacob Lucchini,C,NSH,29,0,0,0,0
100,8480468,James Hamblin,L,EDM,25,0,0,0,0
100,8478051,Max Willman,C,NJD,29,0,0,0,0
100,8481556,John Beecher,C,BOS,23,0,0,0,0
100,8478078,Rourke Chartier,C,,28,0,0,0,0
