Simulation,PlayerID,Player,Position,Team,Age,Games Played,Goals,Assists,Points
1,8478402,Connor McDavid,C,EDM,27,82,25,90,115
1,8477492,Nathan MacKinnon,C,COL,29,82,44,66,110
1,8477934,Leon Draisaitl,C,EDM,29,82,49,57,106
1,8476453,Nikita Kucherov,R,TBL,31,82,28,69,97
1,8479318,Auston Matthews,C,TOR,27,82,63,32,95
1,8478864,Kirill Kaprizov,L,MIN,27,82,47,46,93
1,8481559,Jack Hughes,C,NJD,23,82,40,53,93
1,8477956,David Pastrnak,R,BOS,28,82,37,56,93
1,8479314,Matthew Tkachuk,L,FLA,27,82,31,61,92
1,8476887,Filip Forsberg,L,NSH,30,82,46,44,90
1,8477933,Sam Reinhart,C,FLA,29,82,37,53,90
1,8479407,Jesper Bratt,L,NJD,26,82,26,60,86
1,8477939,William Nylander,R,TOR,28,82,39,45,84
1,8477493,Aleksander Barkov,C,FLA,29,82,26,58,84
1,8479323,Adam Fox,D,NYR,26,82,19,65,84
1,8478550,Artemi Panarin,L,NYR,33,82,35,48,83
1,8475786,Zach Hyman,L,EDM,32,82,43,39,82
1,8480023,Robert Thomas,C,STL,25,82,29,53,82
1,8482116,Tim Stützle,C,OTT,22,82,28,54,82
1,8477942,Kevin Fiala,L,LAK,28,82,26,54,80
1,8478420,Mikko Rantanen,R,COL,28,82,42,37,79
1,8476459,Mika Zibanejad,C,NYR,31,82,31,47,78
1,8480027,Jason Robertson,L,DAL,25,82,21,57,78
1,8471214,Alex Ovechkin,L,WSH,39,82,39,37,76
1,8474564,Steven Stamkos,C,TBL,34,82,37,38,75
1,8480012,Elias Pettersson,C,VAN,26,82,22,53,75
1,8475166,John Tavares,C,TOR,34,82,30,44,74
1,8477949,Alex Tuch,R,BUF,28,82,25,49,74
1,8479343,Clayton Keller,R,ARI,26,82,21,53,74
1,8471675,Sidney Crosby,C,PIT,37,82,45,28,73
1,8478398,Kyle Connor,L,WPG,28,82,37,36,73
1,8478010,Brayden Point,C,TBL,28,82,34,39,73
1,8478427,Sebastian Aho,C,CAR,27,82,32,41,73
1,8475784,Jeff Skinner,C,BUF,32,82,39,33,72
1,8479325,Charlie McAvoy,D,BOS,27,82,16,56,72
1,8476853,Morgan Rielly,D,TOR,30,82,6,66,72
1,8475810,Bryan Rust,R,PIT,32,82,32,39,71
1,8476468,J.T. Miller,C,VAN,31,82,31,40,71
1,8478042,Viktor Arvidsson,R,LAK,31,82,31,40,71
1,8481557,Matt Boldy,L,MIN,23,82,30,41,71
1,8473419,Brad Marchand,L,BOS,36,82,25,46,71
1,8477416,Oliver Bjorkstrand,R,SEA,29,82,31,39,70
1,8474600,Roman Josi,D,NSH,34,82,23,47,70
1,8480069,Cale Makar,D,COL,26,82,20,50,70
1,8478445,Mathew Barzal,C,NYI,27,82,19,51,70
1,8475765,Vladimir Tarasenko,R,FLA,33,82,36,33,69
1,8480208,Drake Batherson,R,OTT,26,82,28,41,69
1,8478407,Vince Dunn,D,SEA,28,82,13,56,69
1,8479542,Brandon Hagel,L,TBL,26,82,37,31,68
1,8476460,Mark Scheifele,C,WPG,31,82,30,38,68
1,8479385,Jordan Kyrou,C,STL,26,82,28,40,68
1,8475172,Nazem Kadri,C,CGY,34,82,24,44,68
1,8480801,Brady Tkachuk,L,OTT,25,82,33,34,67
1,8478440,Dylan Strome,C,WSH,27,82,26,41,67
1,8475158,Ryan O'Reilly,C,NSH,33,82,24,43,67
1,8477402,Pavel Buchnevich,L,STL,29,82,22,45,67
1,8477940,Nikolaj Ehlers,L,WPG,28,82,22,45,67
1,8480002,Nico Hischier,C,NJD,25,82,30,36,66
1,8473512,Claude Giroux,R,OTT,36,82,18,48,66
1,8476454,Ryan Nugent-Hopkins,C,EDM,31,82,18,48,66
1,8478449,Roope Hintz,C,DAL,28,82,38,27,65
1,8478414,Timo Meier,R,NJD,28,82,36,29,65
1,8482097,Jack Quinn,R,BUF,23,82,27,38,65
1,8478403,Jack Eichel,C,VGK,28,82,25,40,65
1,8477404,Jake Guentzel,C,CAR,30,82,24,41,65
1,8482684,Luke Hughes,D,NJD,21,82,22,43,65
1,8481523,Kirby Dach,C,MTL,23,82,14,51,65
1,8477946,Dylan Larkin,C,DET,28,82,29,35,64
1,8477955,Jared McCann,L,SEA,28,82,28,36,64
1,8476346,Johnny Gaudreau,L,CBJ,31,82,26,38,64
1,8479339,Patrik Laine,L,CBJ,26,82,32,31,63
1,8480015,Owen Tippett,R,PHI,25,82,30,33,63
1,8480036,Miro Heiskanen,D,DAL,25,82,10,53,63
1,8475754,Brock Nelson,C,NYI,33,82,32,30,62
1,8477496,Elias Lindholm,C,VAN,30,82,29,33,62
1,8478401,Pavel Zacha,C,BOS,27,82,29,33,62
1,8471215,Evgeni Malkin,C,PIT,38,82,20,42,62
1,8477503,Max Domi,C,TOR,29,82,19,43,62
1,8480839,Rasmus Dahlin,D,BUF,24,82,17,45,62
1,8479420,Tage Thompson,C,BUF,27,82,34,27,61
1,8477479,Tyler Bertuzzi,L,TOR,29,82,33,28,61
1,8476539,Jonathan Marchessault,R,VGK,34,82,31,30,61
1,8477960,Adrian Kempe,R,LAK,28,82,24,37,61
1,8475913,Mark Stone,R,VGK,32,82,23,38,61
1,8482078,Lucas Raymond,L,DET,22,82,21,40,61
1,8479675,Trevor Moore,L,LAK,29,82,35,25,60
1,8477501,Valeri Nichushkin,R,COL,29,82,27,33,60
1,8475745,Charlie Coyle,C,BOS,32,82,19,41,60
1,8475167,Victor Hedman,D,TBL,34,82,14,46,60
1,8482745,Mason McTavish,C,ANA,21,82,26,33,59
1,8478439,Travis Konecny,R,PHI,27,82,24,35,59
1,8475692,Mats Zuccarello,R,MIN,37,82,13,46,59
1,8478493,Joel Eriksson Ek,C,MIN,27,82,32,26,58
1,8477500,Bo Horvat,C,NYI,29,82,29,29,58
1,8477951,Nick Schmaltz,C,ARI,28,82,26,32,58
1,8480018,Nick Suzuki,C,MTL,25,82,23,35,58
1,8476456,Jonathan Huberdeau,C,CGY,31,82,19,39,58
1,8480803,Evan Bouchard,D,EDM,25,82,14,44,58
1,8474578,Erik Karlsson,D,PIT,34,82,12,46,58
1,8480830,Andrei Svechnikov,R,CAR,24,82,23,34,57
1,8476905,Chandler Stephenson,C,VGK,30,82,18,39,57
1,8477409,Carter Verhaeghe,C,FLA,29,82,29,27,56
1,8479337,Alex DeBrincat,R,DET,27,82,28,28,56
1,8478873,Troy Terry,R,ANA,27,82,21,35,56
1,8474102,David Perron,L,DET,36,82,19,37,56
1,8479410,Mikhail Sergachev,D,TBL,26,82,8,48,56
1,8476432,Boone Jenner,C,CBJ,31,82,27,28,55
1,8476462,Dougie Hamilton,D,NJD,31,82,19,36,55
1,8470794,Joe Pavelski,C,DAL,40,82,19,36,55
1,8477504,Josh Morrissey,D,WPG,29,82,8,47,55
1,8481540,Cole Caufield,R,MTL,23,82,35,19,54
1,8476389,Vincent Trocheck,C,NYR,31,82,25,29,54
1,8476483,Rickard Rakell,R,PIT,31,82,30,23,53
1,8482109,Alexis Lafrenière,L,NYR,23,82,24,29,53
1,8474141,Patrick Kane,R,DET,36,82,20,33,53
1,8482124,Quinton Byfield,R,LAK,22,82,17,36,53
1,8474586,Jordan Eberle,R,SEA,34,82,14,39,53
1,8481711,Matias Maccelli,L,ARI,24,82,12,41,53
1,8478444,Brock Boeser,R,VAN,27,82,28,24,52
1,8478856,Conor Garland,R,VAN,28,82,21,31,52
1,8481533,Trevor Zegras,C,ANA,23,82,16,36,52
1,8476826,Yanni Gourde,C,SEA,33,82,16,36,52
1,8471685,Anze Kopitar,C,LAK,37,82,15,37,52
1,8478038,Devon Toews,D,COL,30,82,9,43,52
1,8478498,Jake DeBrusk,L,BOS,28,82,26,25,51
1,8474157,Max Pacioretty,L,WSH,36,82,24,27,51
1,8482665,Matty Beniers,C,SEA,22,82,21,30,51
1,8480865,Noah Dobson,D,NYI,24,82,18,33,51
1,8473994,Jamie Benn,L,DAL,35,82,18,33,51
1,8477964,Ivan Barbashev,C,VGK,29,82,17,34,51
1,8475798,Mikael Granlund,C,SJS,32,82,16,35,51
1,8482093,Seth Jarvis,C,CAR,22,82,16,35,51
1,8478047,Michael Bunting,L,PIT,29,82,16,35,51
1,8480031,Maxime Comtois,L,CAR,25,82,16,35,51
1,8476875,Mike Matheson,D,MTL,30,82,9,42,51
1,8471724,Kris Letang,D,PIT,37,82,3,48,51
1,8478366,Frank Vatrano,R,ANA,30,82,31,19,50
1,8481528,Dylan Cozens,C,BUF,23,82,16,34,50
1,8474563,Drew Doughty,D,LAK,35,82,10,40,50
1,8475726,Tyler Toffoli,C,WPG,32,82,26,23,49
1,8476479,Phillip Danault,C,LAK,31,82,22,27,49
1,8475170,Brayden Schenn,C,STL,33,82,18,31,49
1,8478975,Mason Marchment,L,DAL,29,82,18,31,49
1,8480078,Filip Chytil,C,NYR,25,82,18,31,49
1,8480798,Philipp Kurashev,C,CHI,25,82,17,32,49
1,8473986,Alex Killorn,L,ANA,35,82,24,24,48
1,8478519,Anthony Cirelli,C,TBL,27,82,20,28,48
1,8474679,Gustav Nyquist,C,NSH,35,82,19,29,48
1,8477456,J.T. Compher,L,DET,29,82,15,33,48
1,8475744,Evgeny Kuznetsov,C,CAR,32,82,15,33,48
1,8478469,Thomas Chabot,D,OTT,27,82,13,35,48
1,8478460,Zach Werenski,D,CBJ,27,82,10,38,48
1,8474590,John Carlson,D,WSH,34,82,6,42,48
1,8481699,Aku Raty,R,ARI,23,82,1,47,48
1,8480064,Josh Norris,C,OTT,25,82,24,23,47
1,8482705,Cole Sillinger,C,CBJ,21,82,20,27,47
1,8483808,Andrei Kuzmenko,L,CGY,28,82,19,28,47
1,8479999,Casey Mittelstadt,C,COL,26,82,18,29,47
1,8482175,JJ Peterka,R,BUF,22,82,18,29,47
1,8478438,Tommy Novak,C,NSH,27,82,16,31,47
1,8475184,Chris Kreider,L,NYR,33,82,29,17,46
1,8482699,Dylan Guenther,R,ARI,21,82,28,18,46
1,8475760,Nick Bjugstad,C,ARI,32,82,26,20,46
1,8475314,Anders Lee,L,NYI,34,82,25,21,46
1,8476448,William Karlsson,C,VGK,31,82,23,23,46
1,8475169,Evander Kane,L,EDM,33,82,20,26,46
1,8480434,Sean Durzi,D,ARI,26,82,17,29,46
1,8480800,Quinn Hughes,D,VAN,25,82,5,41,46
1,8476438,Brandon Saad,L,STL,32,82,25,20,45
1,8475722,Jason Zucker,L,NSH,32,82,23,22,45
1,8482092,Ridly Greig,C,OTT,22,82,22,23,45
1,8474641,Adam Henrique,C,EDM,34,82,21,24,45
1,8475791,Taylor Hall,L,CHI,33,82,21,24,45
1,8482667,William Eklund,L,SJS,22,82,19,26,45
1,8478542,Evan Rodrigues,C,FLA,31,82,19,26,45
1,8477447,Shea Theodore,D,VGK,29,82,5,40,45
1,8483524,Shane Wright,C,SEA,20,82,37,7,44
1,8480014,Gabriel Vilardi,C,WPG,25,82,29,15,44
1,8476880,Tom Wilson,R,WSH,30,82,28,16,44
1,8482101,Danil Gushchin,L,SJS,22,82,24,20,44
1,8479345,Jakob Chychrun,D,OTT,26,82,19,25,44
1,8482105,Jake Sanderson,D,OTT,22,82,8,36,44
1,8475168,Matt Duchene,C,DAL,33,82,20,23,43
1,8481596,Shane Pinto,C,OTT,24,82,19,24,43
1,8471698,T.J. Oshie,R,WSH,38,82,19,24,43
1,8482110,Dawson Mercer,C,NJD,23,82,16,27,43
1,8477932,Aaron Ekblad,D,FLA,28,82,14,29,43
1,8482720,Matthew Knies,L,TOR,22,82,13,30,43
1,8477948,Travis Sanheim,D,PHI,28,82,9,34,43
1,8484144,Connor Bedard,C,CHI,19,82,21,21,42
1,8482740,Wyatt Johnston,C,DAL,21,82,21,21,42
1,8475794,Tyler Seguin,C,DAL,32,82,20,22,42
1,8477451,Ryan Hartman,R,MIN,30,82,19,23,42
1,8477444,Andre Burakovsky,L,SEA,29,82,12,30,42
1,8477986,Brandon Montour,D,FLA,30,82,11,31,42
1,8478397,Rasmus Andersson,D,CGY,28,82,8,34,42
1,8478500,Ivan Provorov,D,CBJ,27,82,7,35,42
1,8482133,Thomas Bordeleau,C,SJS,22,82,7,35,42
1,8481542,Moritz Seider,D,DET,23,82,6,36,42
1,8483397,Marc McLaughlin,C,BOS,25,82,36,5,41
1,8475151,Kyle Palmieri,C,NYI,33,82,24,17,41
1,8476881,Tomas Hertl,C,VGK,31,82,20,21,41
1,8477935,Sam Bennett,C,FLA,28,82,20,21,41
1,8481068,Yegor Sharangovich,C,CGY,26,82,19,22,41
1,8482475,Yegor Chinakhov,R,CBJ,23,82,17,24,41
1,8477429,Andrew Copp,C,DET,30,82,14,27,41
1,8475197,Tyson Barrie,D,NSH,33,82,6,35,41
1,8479423,Alex Nylander,L,CBJ,26,82,20,20,40
1,8476872,Scott Laughton,C,PHI,30,82,16,24,40
1,8478396,Noah Hanifin,D,VGK,27,82,11,29,40
1,8477495,Seth Jones,D,CHI,30,82,10,30,40
1,8483445,Cutter Gauthier,L,ANA,20,82,10,30,40
1,8476958,Jaccob Slavin,D,CAR,30,82,8,32,40
1,8477494,Jonathan Drouin,L,COL,29,82,8,32,40
1,8475218,Mattias Ekholm,D,EDM,34,82,4,36,40
1,8478474,Lawson Crouse,L,ARI,27,82,23,16,39
1,8481604,Pavel Dorofeyev,L,VGK,24,82,23,16,39
1,8477998,Warren Foegele,L,EDM,28,82,21,18,39
1,8484153,Leo Carlsson,C,ANA,20,82,20,19,39
1,8476399,Blake Coleman,C,CGY,33,82,20,19,39
1,8471218,Blake Wheeler,R,NYR,38,82,18,21,39
1,8482159,Tyson Foerster,R,PHI,22,82,17,22,39
1,8475768,Jaden Schwartz,C,SEA,32,82,17,22,39
1,8477407,Anthony Duclair,L,TBL,29,82,17,22,39
1,8474884,Mike Hoffman,C,SJS,35,82,17,22,39
1,8479987,Morgan Geekie,C,BOS,26,82,16,23,39
1,8476882,Teuvo Teravainen,L,CAR,30,82,15,24,39
1,8479996,Cody Glass,C,NSH,25,82,15,24,39
1,8478055,Gustav Forsling,D,FLA,28,82,10,29,39
1,8474565,Alex Pietrangelo,D,VGK,34,82,7,32,39
1,8478458,Jack Roslovic,C,NYR,27,82,7,32,39
1,8480871,Adam Boqvist,D,CBJ,24,82,4,35,39
1,8478233,Andrew Mangiapane,L,CGY,28,82,20,18,38
1,8477426,Nicholas Paul,L,TBL,29,82,19,19,38
1,8479400,Pierre-Luc Dubois,L,LAK,26,82,18,20,38
1,8478466,Daniel Sprong,R,DET,27,82,18,20,38
1,8478413,Jordan Greenway,L,BUF,27,82,15,23,38
1,8479365,Trent Frederic,C,BOS,26,82,15,23,38
1,8474149,Evgenii Dadonov,R,DAL,35,82,14,24,38
1,8476906,Shayne Gostisbehere,D,DET,31,82,9,29,38
1,8470613,Brent Burns,D,CAR,39,82,7,31,38
1,8482113,Anton Lundell,C,FLA,23,82,18,19,37
1,8479415,Michael McLeod,C,NJD,26,82,18,19,37
1,8480855,Jack McBain,C,ARI,24,82,18,19,37
1,8478462,Nicolas Roy,C,VGK,27,82,17,20,37
1,8484166,Adam Fantilli,C,CBJ,20,82,15,22,37
1,8482142,Jamie Drysdale,D,PHI,22,82,13,24,37
1,8475753,Justin Faulk,D,STL,32,82,11,26,37
1,8482624,Daniil Miromanov,D,CGY,27,82,9,28,37
1,8480188,Fabian Zetterlund,L,SJS,25,82,18,18,36
1,8476925,Colton Sissons,C,NSH,31,82,17,19,36
1,8480821,Filip Zadina,R,SJS,25,82,17,19,36
1,8478046,Danton Heinen,L,BOS,29,82,15,21,36
1,8474150,Mikael Backlund,C,CGY,35,82,14,22,36
1,8476869,Brady Skjei,D,CAR,30,82,13,23,36
1,8479353,Brett Howden,C,VGK,26,82,13,23,36
1,8477021,Alex Kerfoot,C,ARI,30,82,12,24,36
1,8482055,Drew O'Connor,L,PIT,26,82,12,24,36
1,8478057,Dakota Joshua,C,VAN,28,82,12,24,36
1,8473422,Nick Foligno,L,CHI,37,82,11,25,36
1,8475171,Oliver Ekman-Larsson,D,FLA,33,82,10,26,36
1,8482733,Logan Mailloux,D,MTL,31,82,8,28,36
1,8477346,MacKenzie Weegar,D,CGY,30,82,6,30,36
1,8483471,Brad Lambert,C,WPG,31,82,3,33,36
1,8475764,Cam Fowler,D,ANA,33,82,2,34,36
1,8475191,Reilly Smith,R,PIT,33,82,19,16,35
1,8482702,Logan Stankoven,C,DAL,21,82,18,17,35
1,8480849,Barrett Hayton,C,ARI,24,82,16,19,35
1,8481618,Alex Newhook,C,MTL,23,82,16,19,35
1,8474037,James van Riemsdyk,L,BOS,35,82,16,19,35
1,8479316,Luke Kunin,C,SJS,27,82,13,22,35
1,8480797,Joel Farabee,L,PHI,24,82,11,24,35
1,8476854,Hampus Lindholm,D,BOS,30,82,9,26,35
1,8476458,Ryan Strome,C,ANA,31,82,9,26,35
1,8477969,Marcus Pettersson,D,PIT,28,82,4,31,35
1,8475799,Nino Niederreiter,R,WPG,32,82,22,12,34
1,8480009,Eeli Tolvanen,R,SEA,25,82,21,13,34
1,8478115,Pierre Engvall,L,NYI,28,82,17,17,34
1,8482222,Alexander Barabanov,L,SJS,30,82,13,21,34
1,8481013,Jonatan Berggren,R,DET,24,82,13,21,34
1,8477497,Sean Monahan,C,WPG,30,82,12,22,34
1,8476419,Jean-Gabriel Pageau,C,NYI,32,82,12,22,34
1,8480028,Morgan Frost,C,PHI,25,82,10,24,34
1,8482146,Luke Evangelista,R,NSH,22,82,10,24,34
1,8476792,Torey Krug,D,STL,33,82,5,29,34
1,8478463,Anthony Beauvillier,L,NSH,27,82,16,17,33
1,8475200,Dmitry Orlov,D,CAR,33,82,15,18,33
1,8480039,Martin Necas,C,CAR,25,82,15,18,33
1,8475848,Brendan Gallagher,R,MTL,32,82,15,18,33
1,8481186,Logan O'Connor,R,COL,28,82,10,23,33
1,8474053,Logan Couture,C,SJS,35,82,9,24,33
1,8476960,Andreas Athanasiou,C,CHI,30,82,8,25,33
1,8478851,Alexandre Carrier,D,NSH,28,82,7,26,33
1,8480145,Neal Pionk,D,WPG,29,82,6,27,33
1,8475287,Erik Haula,L,NJD,33,82,15,17,32
1,8477476,Artturi Lehkonen,L,COL,29,82,14,18,32
1,8483431,Logan Cooley,C,ARI,20,82,14,18,32
1,8476329,Travis Boyd,C,ARI,31,82,12,20,32
1,8476480,Vladislav Namestnikov,C,WPG,32,82,10,22,32
1,8481656,Aliaksei Protas,C,WSH,23,82,9,23,32
1,8476457,Adam Larsson,D,SEA,32,82,8,24,32
1,8475906,John Klingberg,D,TOR,32,82,7,25,32
1,8477330,Dominik Kubalik,L,OTT,29,82,15,16,31
1,8474870,Tyler Johnson,C,CHI,34,82,14,17,31
1,8480459,Pius Suter,C,VAN,28,82,14,17,31
1,8479941,Justin Danforth,R,CBJ,31,82,14,17,31
1,8476392,Adam Lowry,C,WPG,31,82,12,19,31
1,8482079,Marco Rossi,C,MIN,23,82,11,20,31
1,8481703,Valtteri Puustinen,R,PIT,25,82,9,22,31
1,8476885,Jacob Trouba,D,NYR,30,82,8,23,31
1,8476923,Damon Severson,D,CBJ,30,82,8,23,31
1,8478891,Mason Appleton,C,WPG,28,82,8,23,31
1,8478882,Vladislav Gavrikov,D,LAK,29,82,7,24,31
1,8476927,Teddy Blueger,C,VAN,30,82,6,25,31
1,8482122,Brock Faber,D,MIN,22,82,5,26,31
1,8481016,Ruslan Iskhakov,C,NYI,24,82,3,28,31
1,8481581,Thomas Harley,D,DAL,23,82,2,29,31
1,8482145,Mavrik Bourque,C,DAL,22,82,26,4,30
1,8479525,Ross Colton,C,COL,28,82,20,10,30
1,8477511,Anthony Mantha,R,VGK,30,82,17,13,30
1,8474715,Cam Atkinson,R,PHI,35,82,16,14,30
1,8475763,Kevin Hayes,R,STL,32,82,13,17,30
1,8477425,Miles Wood,L,COL,29,82,12,18,30
1,8480220,Noah Cates,L,PHI,25,82,10,20,30
1,8477015,Connor Brown,R,EDM,30,82,10,20,30
1,8479425,Filip Hronek,D,VAN,27,82,7,23,30
1,8476902,Esa Lindell,D,DAL,30,82,7,23,30
1,8480246,Nick Perbix,D,TBL,26,82,5,25,30
1,8476981,Josh Anderson,R,MTL,30,82,20,9,29
1,8477952,Robby Fabbri,C,DET,28,82,18,11,29
1,8470621,Corey Perry,R,EDM,39,82,18,11,29
1,8477947,Sonny Milano,L,WSH,28,82,15,14,29
1,8473533,Jordan Staal,C,CAR,36,82,13,16,29
1,8479293,Brandon Tanev,L,SEA,33,82,13,16,29
1,8480185,Eetu Luostarinen,C,FLA,26,82,10,19,29
1,8480817,K'Andre Miller,D,NYR,24,82,8,21,29
1,8476892,Colton Parayko,D,STL,31,82,7,22,29
1,8475149,Marcus Johansson,L,MIN,34,82,6,23,29
1,8476463,Jonas Brodin,D,MIN,31,82,5,24,29
1,8476979,Erik Gustafsson,D,NYR,32,82,5,24,29
1,8475233,David Savard,D,MTL,34,82,3,26,29
1,8477989,Christian Dvorak,C,MTL,28,82,12,16,28
1,8481704,Juuso Parssinen,C,NSH,23,82,12,16,28
1,8479977,Kailer Yamamoto,R,SEA,26,82,12,16,28
1,8477353,Tyler Motte,C,TBL,29,82,12,16,28
1,8473449,Kyle Okposo,R,FLA,36,82,10,18,28
1,8477953,Kasperi Kapanen,R,STL,28,82,9,19,28
1,8477488,Brett Pesce,D,CAR,30,82,7,21,28
1,8478840,Will Borgen,D,SEA,28,82,6,22,28
1,8477506,Ryan Pulock,D,NYI,30,82,2,26,28
1,8481560,Arthur Kaliyev,R,LAK,23,82,18,9,27
1,8477944,Jakub Vrana,L,STL,28,82,16,11,27
1,8474189,Lars Eller,C,PIT,35,82,15,12,27
1,8482089,Jake Neighbours,L,STL,22,82,15,12,27
1,8476374,Sean Kuraly,C,CBJ,31,82,15,12,27
1,8479393,Noah Gregor,C,TOR,26,82,14,13,27
1,8479661,Tanner Jeannot,L,TBL,27,82,13,14,27
1,8482125,Alexander Holtz,R,NJD,22,82,13,14,27
1,8477450,Jason Dickinson,C,CHI,29,82,12,15,27
1,8473563,Nicklas Backstrom,C,WSH,37,82,12,15,27
1,8476461,Sean Couturier,C,PHI,32,82,11,16,27
1,8478109,Victor Olofsson,L,BUF,29,82,11,16,27
1,8476873,Mark Jankowski,C,NSH,30,82,10,17,27
1,8477839,Conor Sheary,L,TBL,32,82,10,17,27
1,8480336,Sean Walker,D,COL,30,82,9,18,27
1,8478472,Mathieu Joseph,R,OTT,27,82,8,19,27
1,8482117,Lukas Reichel,L,CHI,22,82,8,19,27
1,8482671,Owen Power,D,BUF,22,82,6,21,27
1,8477498,Darnell Nurse,D,EDM,29,82,6,21,27
1,8482655,J.J. Moser,D,ARI,24,82,5,22,27
1,8480873,Rasmus Sandin,D,WSH,24,82,4,23,27
1,8475343,Nic Dowd,C,WSH,34,82,4,23,27
1,8475179,Dmitry Kulikov,D,FLA,34,82,1,26,27
1,8481554,Kaapo Kakko,R,NYR,23,82,16,10,26
1,8470604,Jeff Carter,C,PIT,39,82,15,11,26
1,8479383,Boris Katchouk,L,OTT,26,82,14,12,26
1,8481553,Bobby Brink,R,PHI,23,82,13,13,26
1,8479992,Michael Rasmussen,C,DET,25,82,12,14,26
1,8481535,Nils Hoglander,L,VAN,24,82,12,14,26
1,8479390,Taylor Raddysh,R,CHI,26,82,10,16,26
1,8482074,Connor Zary,C,CGY,23,82,10,16,26
1,8481546,Cam York,D,PHI,23,82,9,17,26
1,8475714,Calle Jarnkrok,C,TOR,33,82,8,18,26
1,8474673,TJ Brodie,D,TOR,34,82,7,19,26
1,8483495,Simon Nemec,D,NJD,20,82,7,19,26
1,8478911,Matt Roy,D,LAK,29,82,6,20,26
1,8479976,Juuso Valimaki,D,ARI,26,82,6,20,26
1,8476292,Ondrej Palat,L,NJD,33,82,6,20,26
1,8480068,Ryan Poehling,C,PHI,25,82,6,20,26
1,8481606,Jordan Spence,D,LAK,23,82,4,22,26
1,8481624,Ilya Mikheyev,R,VAN,30,82,16,9,25
1,8480113,Alex Iafallo,L,WPG,31,82,12,13,25
1,8470610,Zach Parise,L,COL,40,82,12,13,25
1,8480893,Kirill Marchenko,R,CBJ,24,82,11,14,25
1,8479514,Rem Pitlick,C,CHI,27,82,10,15,25
1,8482111,Justin Barron,D,MTL,23,82,9,16,25
1,8476278,Colin Blackwell,C,CHI,31,82,9,16,25
1,8481601,Simon Holmstrom,R,NYI,23,82,9,16,25
1,8474034,Pat Maroon,L,BOS,36,82,8,17,25
1,8477435,Ryan Graves,D,PIT,29,82,6,19,25
1,8482259,Bobby McMann,C,TOR,28,82,6,19,25
1,8476312,Josh Manson,D,COL,33,82,5,20,25
1,8476331,Dylan DeMelo,D,WPG,31,82,4,21,25
1,8474574,Tyler Myers,D,VAN,34,82,4,21,25
1,8477220,Nate Schmidt,D,WPG,33,82,4,21,25
1,8475793,Ryan Johansen,C,PHI,32,82,4,21,25
1,8481567,Henry Thrun,D,SJS,23,82,2,23,25
1,8478178,Darren Raddysh,D,TBL,28,82,2,23,25
1,8475790,Erik Gudbranson,D,CBJ,32,82,1,24,25
1,8481477,Nico Sturm,C,SJS,29,82,16,8,24
1,8484203,Bradly Nadeau,L,CAR,19,82,15,9,24
1,8478020,Michael Amadio,C,VGK,28,82,13,11,24
1,8476897,Oskar Sundqvist,C,STL,30,82,11,13,24
1,8478043,Sam Lafferty,C,VAN,29,82,11,13,24
1,8479351,Sam Steel,C,DAL,26,82,10,14,24
1,8477919,Frederick Gaudreau,C,MIN,31,82,9,15,24
1,8482062,Cole Smith,L,NSH,29,82,9,15,24
1,8483490,Pavel Mintyukov,D,ANA,21,82,7,17,24
1,8474151,Ryan McDonagh,D,NSH,35,82,4,20,24
1,8475324,Nick Jensen,D,WSH,34,82,4,20,24
1,8470600,Ryan Suter,D,DAL,39,82,4,20,24
1,8470966,Mark Giordano,D,TOR,41,82,4,20,24
1,8483505,Matthew Poitras,C,BOS,20,82,4,20,24
1,8480281,Alexey Toropchenko,R,STL,25,82,16,7,23
1,8484145,Zach Benson,L,BUF,19,82,14,9,23
1,8482155,Alex Laferriere,R,LAK,23,82,14,9,23
1,8477507,Nikita Zadorov,D,VAN,29,82,11,12,23
1,8476921,Jordan Martinook,L,CAR,32,82,11,12,23
1,8483482,Tristan Luneau,D,ANA,20,82,9,14,23
1,8482245,Artem Zub,D,OTT,29,82,8,15,23
1,8479998,Mikey Anderson,D,LAK,25,82,8,15,23
1,8478133,Jake Evans,C,MTL,28,82,8,15,23
1,8477508,Curtis Lazar,C,NJD,29,82,8,15,23
1,8479591,Michael Eyssimont,C,TBL,28,82,8,15,23
1,8480980,Connor Dewar,C,TOR,25,82,7,16,23
1,8481568,Alex Vlasic,D,CHI,23,82,6,17,23
1,8478507,John Marino,D,NJD,27,82,3,20,23
1,8475690,Chris Tanev,D,DAL,35,82,3,20,23
1,8475188,Brayden McNabb,D,VGK,33,82,2,21,23
1,8477845,Trevor van Riemsdyk,D,WSH,33,82,2,21,23
1,8478508,Yakov Trenin,C,COL,27,82,14,8,22
1,8480802,Ryan McLeod,C,EDM,25,82,14,8,22
1,8480834,Ty Emberson,D,SJS,24,82,9,13,22
1,8476871,Tanner Pearson,L,MTL,32,82,9,13,22
1,8476442,Matt Nieto,L,PIT,32,82,8,14,22
1,8479983,Mario Ferraro,D,SJS,26,82,7,15,22
1,8482166,Shakir Mukhamadullin,D,SJS,22,82,7,15,22
1,8483515,Juraj Slafkovsky,L,MTL,20,82,7,15,22
1,8484911,Collin Graf,R,SJS,22,82,7,15,22
1,8480796,Martin Fehervary,D,WSH,25,82,6,16,22
1,8480860,Kevin Bahl,D,NJD,24,82,5,17,22
1,8476878,Zemgus Girgensons,L,BUF,30,82,4,18,22
1,8479980,Nicolas Hague,D,VGK,26,82,3,19,22
1,8478399,Jonas Siegenthaler,D,NJD,27,82,2,20,22
1,8476891,Matt Grzelcyk,D,BOS,30,82,2,20,22
1,8481605,Jackson LaCombe,D,ANA,23,82,1,21,22
1,8482118,Sam Colangelo,R,ANA,23,82,18,3,21
1,8483493,Frank Nazar,C,CHI,20,82,15,6,21
1,8476469,Joel Armia,R,MTL,31,82,15,6,21
1,8482679,Matt Coronato,R,CGY,22,82,12,9,21
1,8483491,Ivan Miroshnichenko,L,WSH,20,82,12,9,21
1,8479346,Dillon Dube,C,CGY,26,82,10,11,21
1,8475220,Marcus Foligno,L,MIN,33,82,8,13,21
1,8480035,Henri Jokiharju,D,BUF,25,82,6,15,21
1,8475462,Radko Gudas,D,ANA,34,82,5,16,21
1,8474166,Alec Martinez,D,VGK,37,82,5,16,21
1,8480806,Isac Lundestrom,C,ANA,25,82,5,16,21
1,8482730,Brandt Clarke,D,LAK,21,82,5,16,21
1,8480043,Timothy Liljegren,D,TOR,25,82,4,17,21
1,8483457,Lane Hutson,D,MTL,20,82,3,18,21
1,8476917,Adam Pelech,D,NYI,30,82,3,18,21
1,8479398,Samuel Girard,D,COL,26,82,3,18,21
1,8479369,Andrew Peeke,D,BOS,26,82,3,18,21
1,8475208,Brian Dumoulin,D,SEA,33,82,3,18,21
1,8476879,Cody Ceci,D,EDM,31,82,2,19,21
1,8476467,Jamie Oleksiak,D,SEA,32,82,1,20,21
1,8481093,Rafael Harvey-Pinard,L,MTL,25,82,13,7,20
1,8477406,Mattias Janmark,C,EDM,32,82,11,9,20
1,8482809,Jackson Blake,R,CAR,21,82,10,10,20
1,8481028,Martin Pospisil,C,CGY,25,82,8,12,20
1,8481178,Egor Zamula,D,PHI,24,82,7,13,20
1,8479324,Ryan Lindgren,D,NYR,26,82,6,14,20
1,8474013,Ian Cole,D,VAN,35,82,5,15,20
1,8476422,Mike Reilly,D,NYI,31,82,5,15,20
1,8477505,Alexander Wennberg,C,NYR,30,82,4,16,20
1,8479371,Dante Fabbro,D,NSH,26,82,4,16,20
1,8482087,Kaiden Guhle,D,MTL,22,82,3,17,20
1,8481014,Alexander Romanov,D,NYI,24,82,3,17,20
1,8475762,Derek Forbort,D,BOS,32,82,1,19,20
1,8482712,Oskar Olausson,R,COL,22,82,1,19,20
1,8482762,Simon Edvinsson,D,DET,21,82,11,8,19
1,8476624,Barclay Goodrow,C,NYR,31,82,11,8,19
1,8481580,Connor McMichael,C,WSH,23,82,10,9,19
1,8480448,Parker Kelly,L,OTT,25,82,7,12,19
1,8475181,Nick Leddy,D,STL,33,82,6,13,19
1,8482803,Olen Zellweger,D,ANA,21,82,5,14,19
1,8478416,Erik Cernak,D,TBL,27,82,5,14,19
1,8481522,Peyton Krebs,C,BUF,23,82,5,14,19
1,8474716,Jared Spurgeon,D,MIN,35,82,4,15,19
1,8482470,Ilya Solovyov,D,CGY,24,82,4,15,19
1,8482073,Braden Schneider,D,NYR,23,82,3,16,19
1,8480879,Jacob Bernard-Docker,D,OTT,24,82,3,16,19
1,8476429,Scott Mayfield,D,NYI,32,82,2,17,19
1,8480074,Alexandre Texier,C,CBJ,25,82,11,7,18
1,8478569,Noel Acciari,C,PIT,33,82,10,8,18
1,8475842,Sam Carrick,C,EDM,32,82,10,8,18
1,8480813,Joe Veleno,C,DET,24,82,9,9,18
1,8478468,Jeremy Lauzon,D,NSH,27,82,6,12,18
1,8477931,Tomas Nosek,L,NJD,32,82,6,12,18
1,8474009,Nick Bonino,C,NYR,36,82,5,13,18
1,8482177,Marat Khusnutdinov,C,MIN,22,82,4,14,18
1,8483466,Kevin Korchinski,D,CHI,20,82,3,15,18
1,8480807,Mattias Samuelsson,D,BUF,24,82,2,16,18
1,8473507,Jeff Petry,D,DET,37,82,1,17,18
1,8480073,Erik Brannstrom,D,OTT,25,82,0,18,18
1,8483565,Nick Blankenburg,D,CBJ,26,82,7,10,17
1,8481599,Victor Soderstrom,D,ARI,23,82,6,11,17
1,8475177,Calvin de Haan,D,TBL,33,82,5,12,17
1,8476931,Jake McCabe,D,TOR,31,82,4,13,17
1,8478451,Ethan Bear,D,WSH,27,82,3,14,17
1,8482516,Matthew Kessel,D,STL,24,82,1,16,17
1,8479359,Beck Malenstyn,L,WSH,26,82,9,7,16
1,8475231,Casey Cizikas,C,NYI,33,82,7,9,16
1,8477392,Hudson Fasching,R,NYI,29,82,7,9,16
1,8477499,Rasmus Ristolainen,D,PHI,30,82,6,10,16
1,8480144,David Kampf,C,TOR,29,82,6,10,16
1,8477369,Carson Soucy,D,VAN,30,82,5,11,16
1,8477335,Kyle Burroughs,D,SJS,29,82,4,12,16
1,8479442,Troy Stecher,D,EDM,30,82,2,14,16
1,8476372,Nick Seeler,D,PHI,31,82,6,9,15
1,8473504,Cal Clutterbuck,R,NYI,37,82,5,10,15
1,8481524,Bowen Byram,D,BUF,23,82,4,11,15
1,8476967,Brett Kulak,D,EDM,30,82,4,11,15
1,8478859,Niko Mikkola,D,FLA,28,82,2,13,15
1,8474567,Zach Bogosian,D,MIN,34,82,2,13,15
1,8478136,Jake Middleton,D,MIN,28,82,7,7,14
1,8481481,Blake Lizotte,C,LAK,27,82,7,7,14
1,8476822,Luke Glendening,C,TBL,35,82,7,7,14
1,8481537,Nikita Okhotiuk,D,CGY,24,82,6,8,14
1,8473453,Trevor Lewis,C,LAK,37,82,6,8,14
1,8475279,Ben Chiarot,D,DET,33,82,5,9,14
1,8478013,Jake Walman,D,DET,28,82,5,9,14
1,8483012,Logan Morrison,C,SEA,22,82,5,9,14
1,8481517,Brett Leason,R,ANA,25,82,5,9,14
1,8482737,Zack Bolduc,C,STL,21,82,5,9,14
1,8476525,Colin Miller,D,WPG,32,82,4,10,14
1,8480058,Pierre-Olivier Joseph,D,PIT,25,82,4,10,14
1,8475455,Brenden Dillon,D,WPG,34,82,3,11,14
1,8477034,Jaycob Megna,D,CHI,32,82,3,11,14
1,8483499,Liam Ohgren,L,MIN,20,82,3,11,14
1,8471677,Jack Johnson,D,COL,37,82,1,13,14
1,8481059,Scott Perunovich,D,STL,26,82,0,14,14
1,8476915,Jujhar Khaira,L,MIN,30,82,8,5,13
1,8481578,Graeme Clarke,R,NJD,23,82,8,5,13
1,8476858,Phillip Di Giuseppe,L,VAN,31,82,7,6,13
1,8484149,Gavin Brindley,C,CBJ,20,82,5,8,13
1,8482666,Scott Morrow,D,CAR,22,82,4,9,13
1,8475825,Jani Hakanpää,D,DAL,32,82,2,11,13
1,8478831,Kevin Stenlund,C,FLA,28,82,8,4,12
1,8475164,Jakob Silfverberg,R,ANA,34,82,6,6,12
1,8482858,Ryker Evans,D,SEA,23,82,4,8,12
1,8478443,Brandon Carlo,D,BOS,28,82,3,9,12
1,8480990,Declan Chisholm,D,MIN,24,82,3,9,12
1,8483468,Jiri Kulich,C,BUF,20,82,2,10,12
1,8479291,Kevin Rooney,C,CGY,31,82,5,6,11
1,8478430,Oliver Kylington,D,CGY,27,82,2,9,11
1,8477365,Connor Clifton,D,BUF,29,82,1,10,11
1,8483763,Maksymilian Szuber,D,ARI,22,82,5,5,10
1,8476473,Connor Murphy,D,CHI,31,82,3,7,10
1,8482807,Ethan Del Mastro,D,CHI,21,82,4,5,9
1,8483489,Fraser Minten,C,TOR,31,82,4,5,9
1,8480172,Jan Rutta,D,SJS,34,82,2,7,9
1,8481030,Jack St. Ivany,D,PIT,25,82,2,6,8
1,8482859,Zack Ostapchuk,C,OTT,21,82,1,7,8
1,8482713,Mackie Samoskevich,R,FLA,22,82,4,3,7
1,8478408,Travis Dermott,D,ARI,28,82,1,4,5
1,8482141,Lukas Cormier,D,VGK,22,0,0,0,0
1,8476988,Matt Benning,D,SJS,30,0,0,0,0
1,8480727,Zach Whitecloud,D,VGK,28,0,0,0,0
1,8480887,Jordan Harris,D,MTL,24,0,0,0,0
1,8478450,Parker Wotherspoon,D,BOS,27,0,0,0,0
1,8481812,Nikolai Knyzhov,D,SJS,27,0,0,0,0
1,8480001,Urho Vaakanainen,D,ANA,25,0,0,0,0
1,8482176,Wyatt Kaiser,D,CHI,22,0,0,0,0
1,8481122,Simon Benoit,D,TOR,26,0,0,0,0
1,8476441,Joel Edmundson,D,TOR,31,0,0,0,0
1,8480884,Calen Addison,D,SJS,24,0,0,0,0
1,8482511,Mason Lohrei,D,BOS,23,0,0,0,0
1,8482192,Isaak Phillips,D,CHI,23,0,0,0,0
1,8480950,Ilya Lyubushkin,D,TOR,30,0,0,0,0
1,8474031,Kevin Shattenkirk,D,BOS,35,0,0,0,0
1,8475718,Justin Holl,D,DET,32,0,0,0,0
1,8479402,Jake Bean,D,CBJ,26,0,0,0,0
1,8474602,Justin Schultz,D,SEA,34,0,0,0,0
1,8477950,Tony DeAngelo,D,CAR,29,0,0,0,0
1,8481743,Marc Del Gaizo,D,NSH,25,0,0,0,0
1,8481527,Kaedan Korczak,D,VGK,23,0,0,0,0
1,8480192,Johnathan Kovacevic,D,MTL,27,0,0,0,0
1,8476874,Olli Maatta,D,DET,30,0,0,0,0
1,8482144,Jack Thompson,D,SJS,22,0,0,0,0
1,8480222,Sebastian Aho,D,NYI,28,0,0,0,0
1,8479458,Nikita Zaitsev,D,CHI,33,0,0,0,0
1,8471709,Marc-Edouard Vlasic,D,SJS,37,0,0,0,0
1,8482929,Emil Lilleberg,D,TBL,23,0,0,0,0
1,8477018,Ben Hutton,D,VGK,31,0,0,0,0
1,8481056,Spencer Stastney,D,NSH,24,0,0,0,0
1,8481593,Jayden Struble,D,MTL,23,0,0,0,0
1,8479982,Conor Timmins,D,TOR,26,0,0,0,0
1,8474090,Brendan Smith,D,NJD,35,0,0,0,0
1,8482964,Arber Xhekaj,D,MTL,23,0,0,0,0
1,8480891,Michael Kesselring,D,ARI,24,0,0,0,0
1,8477938,Haydn Fleury,D,TBL,28,0,0,0,0
1,8481806,Louis Crevier,D,CHI,23,0,0,0,0
1,8471274,Alex Goligoski,D,MIN,39,0,0,0,0
1,8481600,Tobias Bjornfot,D,FLA,23,0,0,0,0
1,8475797,Jarred Tinordi,D,CHI,32,0,0,0,0
1,8481521,Ronnie Attard,D,PHI,25,0,0,0,0
1,8474612,Travis Hamonic,D,OTT,34,0,0,0,0
1,8479576,Vincent Desharnais,D,EDM,28,0,0,0,0
1,8480049,Dylan Samberg,D,WPG,25,0,0,0,0
1,8483619,Filip Roos,D,CHI,25,0,0,0,0
1,8474568,Luke Schenn,D,NSH,35,0,0,0,0
1,8480184,Gustav Lindstrom,D,ANA,26,0,0,0,0
1,8480070,Ian Mitchell,D,BOS,25,0,0,0,0
1,8480196,Jacob Bryson,D,BUF,27,0,0,0,0
1,8471686,Marc Staal,D,PHI,37,0,0,0,0
1,8477467,Gustav Olofsson,D,SEA,30,0,0,0,0
1,8478970,Jalen Chatfield,D,CAR,28,0,0,0,0
1,8479348,Kale Clague,D,BUF,26,0,0,0,0
1,8473446,Erik Johnson,D,PHI,36,0,0,0,0
1,8477462,Robert Hagg,D,ANA,29,0,0,0,0
1,8478454,Noah Juulsen,D,VAN,27,0,0,0,0
1,8477384,Josh Brown,D,ARI,30,0,0,0,0
1,8481708,Zac Jones,D,NYR,24,0,0,0,0
1,8481167,Brayden Pachal,D,CGY,25,0,0,0,0
1,8482067,Connor Mackey,D,NYR,28,0,0,0,0
1,8483460,David Jiricek,D,CBJ,21,0,0,0,0
1,8481701,Santeri Hatakka,D,NJD,23,0,0,0,0
1,8478021,William Lagesson,D,ANA,28,0,0,0,0
1,8477851,Jordan Oesterle,D,CGY,32,0,0,0,0
1,8478452,Caleb Jones,D,COL,27,0,0,0,0
1,8479984,Cal Foote,D,NJD,26,0,0,0,0
1,8479639,Dylan Coghlan,D,CAR,26,0,0,0,0
1,8480874,Adam Ginning,D,PHI,24,0,0,0,0
1,8479321,Lucas Johansen,D,WSH,27,0,0,0,0
1,8480878,Nils Lundkvist,D,DAL,24,0,0,0,0
1,8482165,Yan Kuznetsov,D,CGY,22,0,0,0,0
1,8484258,Sam Malinski,D,COL,26,0,0,0,0
1,8480157,Calle Rosen,D,STL,30,0,0,0,0
1,8484304,Uvis Balinskis,D,FLA,28,0,0,0,0
1,8479985,Cale Fleury,D,SEA,26,0,0,0,0
1,8479378,Logan Stanley,D,WPG,26,0,0,0,0
1,8477541,Dakota Mermis,D,MIN,30,0,0,0,0
1,8481609,Vladislav Kolyachonok,D,ARI,23,0,0,0,0
1,8480823,Alexander Alexeyev,D,WSH,25,0,0,0,0
1,8481679,Maxence Guenette,D,OTT,23,0,0,0,0
1,8481564,Ryan Johnson,D,BUF,23,0,0,0,0
1,8479376,Victor Mete,D,PHI,26,0,0,0,0
1,8484254,Akito Hirose,D,VAN,25,0,0,0,0
1,8482660,Kent Johnson,C,CBJ,22,0,0,0,0
1,8482149,Cole Perfetti,C,WPG,22,0,0,0,0
1,8477987,Ryan Donato,C,CHI,28,0,0,0,0
1,8475755,Alexander Petrovic,D,DAL,32,0,0,0,0
1,8477810,Joel Hanley,D,CGY,33,0,0,0,0
1,8474145,Robert Bortuzzo,D,NYI,35,0,0,0,0
1,8481161,Jake Christiansen,D,CBJ,25,0,0,0,0
1,8476884,Derrick Pouliot,D,DAL,30,0,0,0,0
1,8481716,Dmitri Voronkov,L,CBJ,24,0,0,0,0
1,8480084,Nick DeSimone,D,NJD,30,0,0,0,0
1,8475750,Jon Merrill,D,MIN,32,0,0,0,0
1,8479315,Joey Anderson,R,CHI,26,0,0,0,0
1,8478011,Louie Belpedio,D,PHI,28,0,0,0,0
1,8482451,Mikael Pyyhtia,L,CBJ,23,0,0,0,0
1,8481541,Samuel Bolduc,D,NYI,24,0,0,0,0
1,8482126,Emil Andrae,D,PHI,31,0,0,0,0
1,8474618,Marco Scandella,D,STL,34,0,0,0,0
1,8477244,Chad Ruhwedel,D,NYR,34,0,0,0,0
1,8477971,Andreas Englund,D,LAK,28,0,0,0,0
1,8480829,Jesperi Kotkaniemi,C,CAR,24,0,0,0,0
1,8479372,Josh Mahura,D,FLA,26,0,0,0,0
1,8482095,Tyler Kleven,D,OTT,22,0,0,0,0
1,8481719,Maxwell Crozier,D,TBL,24,0,0,0,0
1,8475855,Jesper Fast,R,CAR,33,0,0,0,0
1,8480848,Ty Dellandrea,C,DAL,24,0,0,0,0
1,8475193,Tomas Tatar,L,SEA,34,0,0,0,0
1,8476889,Radek Faksa,C,DAL,30,0,0,0,0
1,8478495,Denis Gurianov,R,PHI,27,0,0,0,0
1,8480216,Jacob Peterson,C,SJS,25,0,0,0,0
1,8480252,Cole Guttman,C,CHI,25,0,0,0,0
1,8479026,Philippe Myers,D,TBL,27,0,0,0,0
1,8481006,Tyler Tucker,D,STL,24,0,0,0,0
1,8481032,Paul Cotter,C,VGK,25,0,0,0,0
1,8481577,Philip Tomasino,C,NSH,23,0,0,0,0
1,8476918,Jimmy Vesey,L,NYR,31,0,0,0,0
1,8479320,Max Lajoie,D,TOR,27,0,0,0,0
1,8478017,Mark Friedman,D,VAN,29,0,0,0,0
1,8481754,Nikita Nesterenko,C,ANA,23,0,0,0,0
1,8483407,Brandon Scanlin,D,NYR,25,0,0,0,0
1,8482659,Josh Doan,R,ARI,22,0,0,0,0
1,8477446,Michael McCarron,R,NSH,29,0,0,0,0
1,8477903,Garnet Hathaway,R,PHI,33,0,0,0,0
1,8482153,Brendan Brisson,C,VGK,23,0,0,0,0
1,8483546,Marshall Rifai,D,TOR,26,0,0,0,0
1,8484287,Cole McWard,D,VAN,23,0,0,0,0
1,8478854,Ryan Shea,D,PIT,27,0,0,0,0
1,8481585,Egor Afanasyev,L,NSH,23,0,0,0,0
1,8483398,Declan Carlile,D,TBL,31,0,0,0,0
1,8478502,Dennis Gilbert,D,CGY,28,0,0,0,0
1,8482749,Joshua Roy,R,MTL,21,0,0,0,0
1,8481598,Philip Broberg,D,EDM,23,0,0,0,0
1,8480835,Jack Drury,C,CAR,24,0,0,0,0
1,8480748,Kiefer Sherwood,L,NSH,29,0,0,0,0
1,8476934,Brock McGinn,L,ANA,30,0,0,0,0
1,8480870,Bo Groulx,C,ANA,24,0,0,0,0
1,8479368,Max Jones,L,ANA,26,0,0,0,0
1,8478099,Kevin Labanc,R,SJS,29,0,0,0,0
1,8478067,Oskar Lindblom,L,SJS,28,0,0,0,0
1,8476393,Nick Cousins,C,FLA,31,0,0,0,0
1,8483395,Arshdeep Bains,L,VAN,23,0,0,0,0
1,8480762,Eric Robinson,L,BUF,29,0,0,0,0
1,8479439,Jacob MacDonald,D,SJS,31,0,0,0,0
1,8476474,Stefan Noesen,R,CAR,31,0,0,0,0
1,8482787,Nikita Chibrikov,R,WPG,31,0,0,0,0
1,8478432,Christian Fischer,R,DET,27,0,0,0,0
1,8477979,Nicolas Aube-Kubel,R,WSH,28,0,0,0,0
1,8481789,Tye Kartye,L,SEA,23,0,0,0,0
1,8479330,Brandon Gignac,C,MTL,27,0,0,0,0
1,8480075,Cameron Crotty,D,ARI,25,0,0,0,0
1,8473473,Milan Lucic,L,BOS,36,0,0,0,0
1,8482094,Daemon Hunt,D,MIN,22,0,0,0,0
1,8481206,John Ludvig,D,PIT,24,0,0,0,0
1,8483630,Pavol Regenda,L,ANA,25,0,0,0,0
1,8481617,Vasily Podkolzin,R,VAN,23,0,0,0,0
1,8480306,Grant Hutton,D,NYI,29,0,0,0,0
1,8480995,Pontus Holmberg,R,TOR,25,0,0,0,0
1,8482148,Hendrix Lapierre,C,WSH,22,0,0,0,0
1,8477478,William Carrier,L,VGK,30,0,0,0,0
1,8480003,Jesper Boqvist,C,BOS,26,0,0,0,0
1,8482172,Landon Slaggert,L,CHI,22,0,0,0,0
1,8480789,Oliver Wahlstrom,R,NYI,24,0,0,0,0
1,8474062,Riley Nash,C,NYR,35,0,0,0,0
1,8480021,Jack Studnicka,C,SJS,25,0,0,0,0
1,8480025,MacKenzie Entwistle,R,CHI,25,0,0,0,0
1,8481582,Nicholas Robertson,L,TOR,23,0,0,0,0
1,8476867,Brendan Gaunce,C,CBJ,30,0,0,0,0
1,8479619,Michael Carcone,L,ARI,28,0,0,0,0
1,8479370,Tyson Jost,C,BUF,26,0,0,0,0
1,8479671,Mathieu Olivier,R,CBJ,27,0,0,0,0
1,8476994,Vinnie Hinostroza,C,PIT,30,0,0,0,0
1,8482070,Mitchell Chaffee,R,TBL,26,0,0,0,0
1,8477473,Justin Bailey,R,SJS,29,0,0,0,0
1,8479344,Jesse Puljujarvi,R,PIT,26,0,0,0,0
1,8480205,Emil Bemstrom,C,PIT,25,0,0,0,0
1,8479718,Alex Barré-Boulet,C,TBL,27,0,0,0,0
1,8482061,Brandon Biro,L,BUF,26,0,0,0,0
1,8479638,Justin Brazeau,R,BOS,26,0,0,0,0
1,8474040,Sam Gagner,C,EDM,35,0,0,0,0
1,8477846,Ryan Carpenter,C,SJS,33,0,0,0,0
1,8482077,Dylan Holloway,L,EDM,23,0,0,0,0
1,8482157,Will Cuylle,L,NYR,22,0,0,0,0
1,8480007,Jonas Rondbjerg,R,VGK,25,0,0,0,0
1,8478874,Adam Gaudette,C,STL,28,0,0,0,0
1,8478434,Keegan Kolesar,R,VGK,27,0,0,0,0
1,8480441,Trey Fix-Wolansky,R,CBJ,25,0,0,0,0
1,8479994,Jaret Anderson-Dolan,C,NSH,25,0,0,0,0
1,8483567,Georgii Merkulov,C,BOS,24,0,0,0,0
1,8477380,Jonny Brodzinski,C,NYR,31,0,0,0,0
1,8482201,Gage Goncalves,C,TBL,23,0,0,0,0
1,8478211,Dryden Hunt,L,CGY,29,0,0,0,0
1,8471699,Andrew Cogliano,C,COL,37,0,0,0,0
1,8479421,Jacob Moverare,D,LAK,26,0,0,0,0
1,8478881,Brett Seney,L,CHI,28,0,0,0,0
1,8477464,Nic Petan,C,MIN,29,0,0,0,0
1,8475958,Michael Sgarbossa,C,WSH,32,0,0,0,0
1,8481147,Reese Johnson,C,CHI,26,0,0,0,0
1,8479336,Carl Grundstrom,R,LAK,27,0,0,0,0
1,8480853,Liam Foudy,C,NSH,24,0,0,0,0
1,8479522,Hardy Haman Aktell,D,WSH,26,0,0,0,0
1,8481462,Mason Morelli,L,VGK,28,0,0,0,0
1,8482102,Vasily Ponomarev,C,CAR,22,0,0,0,0
1,8480844,Grigori Denisenko,L,VGK,24,0,0,0,0
1,8479944,Zach Aston-Reese,C,DET,30,0,0,0,0
1,8482784,Zach Dean,C,STL,21,0,0,0,0
1,8479419,Brett Murray,L,BUF,26,0,0,0,0
1,8479520,Brandon Duhaime,R,COL,27,0,0,0,0
1,8477573,Nathan Walker,L,STL,30,0,0,0,0
1,8478078,Rourke Chartier,C,OTT,28,0,0,0,0
1,8475795,Dylan McIlrath,D,WSH,32,0,0,0,0
1,8482496,Nils Aman,C,VAN,24,0,0,0,0
1,8480289,Morgan Barron,C,WPG,26,0,0,0,0
1,8481751,Lukas Rousek,R,BUF,25,0,0,0,0
1,8480011,Klim Kostin,C,SJS,25,0,0,0,0
1,8481556,John Beecher,C,BOS,23,0,0,0,0
1,8475278,Byron Froese,C,VGK,33,0,0,0,0
1,8475225,Craig Smith,C,DAL,35,0,0,0,0
1,8484326,Patrik Koch,D,ARI,28,0,0,0,0
1,8477930,Pierre-Edouard Bellemare,L,SEA,39,0,0,0,0
1,8478409,Anthony Richard,C,BOS,28,0,0,0,0
1,8481024,Linus Karlsson,C,VAN,25,0,0,0,0
1,8479986,Kole Lind,R,SEA,26,0,0,0,0
1,8479414,Nathan Bastian,R,NJD,27,0,0,0,0
1,8479362,Riley Tufte,L,COL,26,0,0,0,0
1,8481058,Jesse Ylönen,R,MTL,25,0,0,0,0
1,8482476,Emil Heineman,L,MTL,23,0,0,0,0
1,8482861,Vincent Iorio,D,WSH,22,0,0,0,0
1,8483432,Luca Del Bel Belluz,C,CBJ,31,0,0,0,0
1,8482744,James Malatesta,L,CBJ,21,0,0,0,0
1,8477887,Patrick Brown,C,BOS,32,0,0,0,0
1,8478585,Derek Ryan,C,EDM,38,0,0,0,0
1,8481441,Joe Snively,C,WSH,28,0,0,0,0
1,8481592,Jakob Pelletier,L,CGY,23,0,0,0,0
1,8482634,Alex Steeves,C,TOR,25,0,0,0,0
1,8477126,Jayson Megna,C,BOS,34,0,0,0,0
1,8475752,Tyler Pitlick,C,NYR,33,0,0,0,0
1,8480008,Adam Ruzicka,C,ARI,25,0,0,0,0
1,8481065,Angus Crookshank,L,OTT,25,0,0,0,0
1,8479547,Matthew Phillips,R,WSH,26,0,0,0,0
1,8480226,Marián Studenic,R,SEA,26,0,0,0,0
1,8481237,Kyle MacLean,C,NYI,25,0,0,0,0
1,8475413,Justin Dowling,C,NJD,34,0,0,0,0
1,8481641,Joel Kiviranta,L,COL,28,0,0,0,0
1,8478104,Sammy Blais,L,STL,28,0,0,0,0
1,8477454,Adam Erne,L,EDM,29,0,0,0,0
1,8481518,Nolan Foote,L,NJD,24,0,0,0,0
1,8480245,Olle Lycksell,R,PHI,25,0,0,0,0
1,8483570,Ben Meyers,C,ANA,26,0,0,0,0
1,8480776,Sheldon Rempal,R,VGK,29,0,0,0,0
1,8483920,Pierrick Dube,R,WSH,23,0,0,0,0
1,8480267,Sammy Walker,C,MIN,25,0,0,0,0
1,8482747,Brennan Othmann,L,NYR,21,0,0,0,0
1,8479991,Jake Leschyshyn,C,NYR,25,0,0,0,0
1,8478400,Colin White,C,MTL,27,0,0,0,0
1,8479328,Julien Gauthier,R,NYI,27,0,0,0,0
1,8484325,Waltteri Merela,C,TBL,26,0,0,0,0
1,8479066,Ryan Lomberg,L,FLA,30,0,0,0,0
1,8477070,Liam O'Brien,C,ARI,30,0,0,0,0
1,8478146,Matthew Highmore,C,OTT,28,0,0,0,0
1,8478028,Fredrik Olofsson,L,COL,28,0,0,0,0
1,8480880,Jakub Lauko,C,BOS,24,0,0,0,0
1,8479968,Vinni Lettieri,C,MIN,29,0,0,0,0
1,8474709,Matt Martin,L,NYI,35,0,0,0,0
1,8480845,Rasmus Kupari,C,WPG,24,0,0,0,0
1,8481550,Adam Beckman,L,MIN,23,0,0,0,0
1,8481422,Jacob Lucchini,C,MIN,29,0,0,0,0
1,8477401,John Hayden,C,SEA,29,0,0,0,0
1,8478904,Steven Lorentz,C,FLA,28,0,0,0,0
1,8482088,Justin Sourdif,R,FLA,22,0,0,0,0
1,8482751,Ryan Winterton,C,SEA,21,0,0,0,0
1,8482241,Radim Zohorna,L,PIT,28,0,0,0,0
1,8481690,Tyler Angle,C,CBJ,24,0,0,0,0
1,8476952,Dominic Toninato,C,WPG,30,0,0,0,0
1,8476919,Chris Tierney,C,NJD,30,0,0,0,0
1,8480032,Shane Bowers,C,NJD,25,0,0,0,0
1,8484314,Jiri Smejkal,L,OTT,28,0,0,0,0
1,8481239,Samuel Fagemo,L,LAK,24,0,0,0,0
1,8481532,Alex Turcotte,C,LAK,23,0,0,0,0
1,8481019,David Gustafsson,C,WPG,24,0,0,0,0
1,8478477,Mitchell Stephens,C,MTL,27,0,0,0,0
1,8479546,Oskar Steen,C,BOS,26,0,0,0,0
1,8480292,Carson Meyer,R,CBJ,27,0,0,0,0
1,8478446,Glenn Gawdin,C,ANA,27,0,0,0,0
1,8483531,Brian Halonen,L,NJD,25,0,0,0,0
1,8477149,Scott Sabourin,R,SJS,32,0,0,0,0
1,8479972,Mason Shaw,C,MIN,26,0,0,0,0
1,8480890,Jan Jenik,R,ARI,24,0,0,0,0
1,8478051,Max Willman,C,NJD,29,0,0,0,0
1,8480851,Akil Thomas,C,LAK,24,0,0,0,0
1,8482765,Isak Rosen,R,BUF,21,0,0,0,0
1,8478421,A.J. Greer,L,CGY,28,0,0,0,0
1,8478512,Austin Czarnik,C,DET,32,0,0,0,0
1,8479536,Axel Jonsson-Fjallby,L,WPG,26,0,0,0,0
1,8477320,Anton Blidh,L,NYR,29,0,0,0,0
1,8481543,Nikita Alexandrov,C,STL,24,0,0,0,0
1,8475235,Nicolas Deslauriers,L,PHI,33,0,0,0,0
1,8481070,Hugh McGing,L,STL,26,0,0,0,0
1,8480836,Jonathan Gruden,C,PIT,24,0,0,0,0
1,8481591,Sam Poulin,R,PIT,23,0,0,0,0
1,8477962,Brendan Lemieux,L,CAR,28,0,0,0,0
1,8483401,Marc Johnstone,R,PIT,28,0,0,0,0
1,8482250,Callahan Burke,C,CAR,27,0,0,0,0
1,8481726,Adam Edstrom,C,NYR,24,0,0,0,0
1,8471817,Ryan Reaves,R,TOR,37,0,0,0,0
1,8479587,Rhett Gardner,C,PHI,28,0,0,0,0
1,8475766,Austin Watson,L,TBL,32,0,0,0,0
1,8479367,William Lockwood,R,FLA,26,0,0,0,0
1,8478424,Jansen Harkins,C,PIT,27,0,0,0,0
1,8476913,Devin Shore,C,SEA,30,0,0,0,0
1,8482652,Walker Duehr,R,CGY,27,0,0,0,0
1,8477527,Ross Johnston,L,ANA,30,0,0,0,0
1,8481077,John Leonard,L,ARI,26,0,0,0,0
1,8483549,Lucas Condotta,L,MTL,27,0,0,0,0
1,8480468,James Hamblin,L,EDM,25,0,0,0,0
1,8476907,Mackenzie MacEachern,L,STL,30,0,0,0,0
1,8479543,Michael Pezzetta,L,MTL,26,0,0,0,0
1,8480355,Mark Kastelic,C,OTT,25,0,0,0,0
1,8482162,Roby Jarventie,L,OTT,22,0,0,0,0
1,8479772,Zack MacEwen,R,OTT,28,0,0,0,0
1,8483597,Milos Kelemen,L,ARI,25,0,0,0,0
1,8479379,Givani Smith,R,SJS,26,0,0,0,0
1,8481655,Cole Schwindt,R,CGY,23,0,0,0,0
1,8479981,Jonah Gadjovich,L,FLA,26,0,0,0,0
1,8482147,Jean-Luc Foudy,C,COL,22,0,0,0,0
1,8484255,Jason Polin,R,COL,25,0,0,0,0
1,8477993,Justin Kirkland,C,ARI,28,0,0,0,0
1,8479249,Andrew Poturalski,C,SEA,30,0,0,0,0
1,8482197,Adam Raska,R,MIN,23,0,0,0,0
1,8475780,Chris Wagner,R,COL,33,0,0,0,0
1,8479533,Joona Koppanen,L,PIT,26,0,0,0,0
1,8481534,Raphael Lavoie,C,EDM,24,0,0,0,0
1,8484321,Nikolas Matinpalo,D,OTT,26,0,0,0,0
1,8481043,Cole Koepke,L,TBL,26,0,0,0,0
1,8476323,Max McCormick,L,SEA,32,0,0,0,0
1,8483609,Adam Klapka,R,CGY,24,0,0,0,0
1,8483512,Matt Savoie,C,BUF,20,0,0,0,0
1,8484259,Ondrej Pavel,C,COL,31,0,0,0,0
1,8478147,Bokondji Imama,L,OTT,28,0,0,0,0
1,8482460,Matt Rempe,C,NYR,22,0,0,0,0
1,8477073,Kurtis MacDermid,L,NJD,30,0,0,0,0
1,8480274,Philip Kemp,D,EDM,25,0,0,0,0
1,8478956,Samuel Laberge,L,NJD,27,0,0,0,0
1,8483045,Cameron Butler,R,CBJ,31,0,0,0,0
2,8478402,Connor McDavid,C,EDM,27,82,44,85,129
2,8477956,David Pastrnak,R,BOS,28,82,52,69,121
2,8477492,Nathan MacKinnon,C,COL,29,82,41,80,121
2,8479318,Auston Matthews,C,TOR,27,82,62,43,105
2,8476453,Nikita Kucherov,R,TBL,31,82,40,65,105
2,8477934,Leon Draisaitl,C,EDM,29,82,37,67,104
2,8481559,Jack Hughes,C,NJD,23,82,33,70,103
2,8478550,Artemi Panarin,L,NYR,33,82,38,62,100
2,8477404,Jake Guentzel,C,CAR,30,82,44,47,91
2,8476459,Mika Zibanejad,C,NYR,31,82,39,51,90
2,8480012,Elias Pettersson,C,VAN,26,82,35,55,90
2,8478420,Mikko Rantanen,R,COL,28,82,39,50,89
2,8478427,Sebastian Aho,C,CAR,27,82,34,53,87
2,8476460,Mark Scheifele,C,WPG,31,82,33,50,83
2,8477504,Josh Morrissey,D,WPG,29,82,20,63,83
2,8471675,Sidney Crosby,C,PIT,37,82,33,49,82
2,8480027,Jason Robertson,L,DAL,25,82,31,51,82
2,8478864,Kirill Kaprizov,L,MIN,27,82,31,49,80
2,8477939,William Nylander,R,TOR,28,82,31,49,80
2,8479407,Jesper Bratt,L,NJD,26,82,25,55,80
2,8471214,Alex Ovechkin,L,WSH,39,82,37,42,79
2,8480023,Robert Thomas,C,STL,25,82,20,59,79
2,8476887,Filip Forsberg,L,NSH,30,82,35,43,78
2,8477933,Sam Reinhart,C,FLA,29,82,32,46,78
2,8474600,Roman Josi,D,NSH,34,82,26,52,78
2,8479420,Tage Thompson,C,BUF,27,82,37,39,76
2,8477946,Dylan Larkin,C,DET,28,82,36,40,76
2,8476468,J.T. Miller,C,VAN,31,82,26,50,76
2,8477493,Aleksander Barkov,C,FLA,29,82,23,53,76
2,8478444,Brock Boeser,R,VAN,27,82,40,35,75
2,8479314,Matthew Tkachuk,L,FLA,27,82,33,41,74
2,8475172,Nazem Kadri,C,CGY,34,82,29,45,74
2,8478445,Mathew Barzal,C,NYI,27,82,19,55,74
2,8480801,Brady Tkachuk,L,OTT,25,82,29,44,73
2,8477402,Pavel Buchnevich,L,STL,29,82,28,45,73
2,8477501,Valeri Nichushkin,R,COL,29,82,41,31,72
2,8471215,Evgeni Malkin,C,PIT,38,82,26,46,72
2,8473419,Brad Marchand,L,BOS,36,82,23,49,72
2,8480803,Evan Bouchard,D,EDM,25,82,21,51,72
2,8480069,Cale Makar,D,COL,26,82,19,53,72
2,8476456,Jonathan Huberdeau,C,CGY,31,82,19,53,72
2,8478493,Joel Eriksson Ek,C,MIN,27,82,25,46,71
2,8475167,Victor Hedman,D,TBL,34,82,16,55,71
2,8478414,Timo Meier,R,NJD,28,82,32,38,70
2,8475166,John Tavares,C,TOR,34,82,30,40,70
2,8481557,Matt Boldy,L,MIN,23,82,25,45,70
2,8477955,Jared McCann,L,SEA,28,82,32,37,69
2,8475786,Zach Hyman,L,EDM,32,82,43,24,67
2,8475692,Mats Zuccarello,R,MIN,37,82,17,50,67
2,8477409,Carter Verhaeghe,C,FLA,29,82,33,33,66
2,8479337,Alex DeBrincat,R,DET,27,82,26,40,66
2,8478873,Troy Terry,R,ANA,27,82,24,42,66
2,8476454,Ryan Nugent-Hopkins,C,EDM,31,82,21,45,66
2,8474578,Erik Karlsson,D,PIT,34,82,16,50,66
2,8480036,Miro Heiskanen,D,DAL,25,82,11,55,66
2,8478398,Kyle Connor,L,WPG,28,82,32,33,65
2,8475913,Mark Stone,R,VGK,32,82,28,37,65
2,8482684,Luke Hughes,D,NJD,21,82,25,40,65
2,8477942,Kevin Fiala,L,LAK,28,82,28,36,64
2,8479339,Patrik Laine,L,CBJ,26,82,32,31,63
2,8478047,Michael Bunting,L,PIT,29,82,29,34,63
2,8480018,Nick Suzuki,C,MTL,25,82,22,41,63
2,8475184,Chris Kreider,L,NYR,33,82,35,27,62
2,8478439,Travis Konecny,R,PHI,27,82,29,33,62
2,8477951,Nick Schmaltz,C,ARI,28,82,27,35,62
2,8480002,Nico Hischier,C,NJD,25,82,25,37,62
2,8470794,Joe Pavelski,C,DAL,40,82,22,40,62
2,8480800,Quinn Hughes,D,VAN,25,82,12,50,62
2,8480830,Andrei Svechnikov,R,CAR,24,82,23,38,61
2,8481068,Yegor Sharangovich,C,CGY,26,82,26,34,60
2,8478403,Jack Eichel,C,VGK,28,82,25,35,60
2,8479325,Charlie McAvoy,D,BOS,27,82,13,47,60
2,8478010,Brayden Point,C,TBL,28,82,32,27,59
2,8482116,Tim Stützle,C,OTT,22,82,27,32,59
2,8479385,Jordan Kyrou,C,STL,26,82,26,33,59
2,8473994,Jamie Benn,L,DAL,35,82,26,33,59
2,8482093,Seth Jarvis,C,CAR,22,82,26,33,59
2,8478401,Pavel Zacha,C,BOS,27,82,21,38,59
2,8475784,Jeff Skinner,C,BUF,32,82,29,29,58
2,8479542,Brandon Hagel,L,TBL,26,82,23,35,58
2,8477940,Nikolaj Ehlers,L,WPG,28,82,22,36,58
2,8474141,Patrick Kane,R,DET,36,82,22,36,58
2,8477500,Bo Horvat,C,NYI,29,82,33,24,57
2,8478498,Jake DeBrusk,L,BOS,28,82,27,30,57
2,8478042,Viktor Arvidsson,R,LAK,31,82,26,31,57
2,8474679,Gustav Nyquist,C,NSH,35,82,26,31,57
2,8482109,Alexis Lafrenière,L,NYR,23,82,25,32,57
2,8475810,Bryan Rust,R,PIT,32,82,24,33,57
2,8476389,Vincent Trocheck,C,NYR,31,82,22,35,57
2,8478460,Zach Werenski,D,CBJ,27,82,11,46,57
2,8476853,Morgan Rielly,D,TOR,30,82,8,49,57
2,8478440,Dylan Strome,C,WSH,27,82,22,34,56
2,8481523,Kirby Dach,C,MTL,23,82,12,44,56
2,8477497,Sean Monahan,C,WPG,30,82,24,31,55
2,8477960,Adrian Kempe,R,LAK,28,82,23,32,55
2,8473512,Claude Giroux,R,OTT,36,82,20,35,55
2,8477949,Alex Tuch,R,BUF,28,82,16,39,55
2,8477416,Oliver Bjorkstrand,R,SEA,29,82,15,40,55
2,8479323,Adam Fox,D,NYR,26,82,11,44,55
2,8476448,William Karlsson,C,VGK,31,82,28,26,54
2,8482740,Wyatt Johnston,C,DAL,21,82,26,28,54
2,8476483,Rickard Rakell,R,PIT,31,82,22,32,54
2,8474564,Steven Stamkos,C,TBL,34,82,21,33,54
2,8478449,Roope Hintz,C,DAL,28,82,21,33,54
2,8476875,Mike Matheson,D,MTL,30,82,19,35,54
2,8474563,Drew Doughty,D,LAK,35,82,7,47,54
2,8480015,Owen Tippett,R,PHI,25,82,27,26,53
2,8478233,Andrew Mangiapane,L,CGY,28,82,17,36,53
2,8476792,Torey Krug,D,STL,33,82,12,41,53
2,8478469,Thomas Chabot,D,OTT,27,82,11,42,53
2,8474590,John Carlson,D,WSH,34,82,10,43,53
2,8481699,Aku Raty,R,ARI,23,82,5,48,53
2,8480208,Drake Batherson,R,OTT,26,82,26,26,52
2,8479400,Pierre-Luc Dubois,L,LAK,26,82,20,32,52
2,8473986,Alex Killorn,L,ANA,35,82,22,29,51
2,8475191,Reilly Smith,R,PIT,33,82,22,29,51
2,8471685,Anze Kopitar,C,LAK,37,82,17,34,51
2,8477429,Andrew Copp,C,DET,30,82,13,38,51
2,8475798,Mikael Granlund,C,SJS,32,82,12,39,51
2,8481540,Cole Caufield,R,MTL,23,82,32,18,50
2,8475754,Brock Nelson,C,NYI,33,82,27,23,50
2,8475765,Vladimir Tarasenko,R,FLA,33,82,20,30,50
2,8475726,Tyler Toffoli,C,WPG,32,82,27,22,49
2,8479675,Trevor Moore,L,LAK,29,82,26,23,49
2,8477451,Ryan Hartman,R,MIN,30,82,23,26,49
2,8477479,Tyler Bertuzzi,L,TOR,29,82,20,29,49
2,8482078,Lucas Raymond,L,DET,22,82,18,31,49
2,8476826,Yanni Gourde,C,SEA,33,82,18,31,49
2,8476462,Dougie Hamilton,D,NJD,31,82,17,32,49
2,8480865,Noah Dobson,D,NYI,24,82,11,38,49
2,8478407,Vince Dunn,D,SEA,28,82,9,40,49
2,8477447,Shea Theodore,D,VGK,29,82,3,46,49
2,8479343,Clayton Keller,R,ARI,26,82,24,24,48
2,8476539,Jonathan Marchessault,R,VGK,34,82,24,24,48
2,8475791,Taylor Hall,L,CHI,33,82,22,26,48
2,8476880,Tom Wilson,R,WSH,30,82,20,28,48
2,8476346,Johnny Gaudreau,L,CBJ,31,82,18,30,48
2,8476906,Shayne Gostisbehere,D,DET,31,82,11,37,48
2,8476905,Chandler Stephenson,C,VGK,30,82,9,39,48
2,8478462,Nicolas Roy,C,VGK,27,82,20,27,47
2,8477346,MacKenzie Weegar,D,CGY,30,82,19,28,47
2,8477496,Elias Lindholm,C,VAN,30,82,16,31,47
2,8482124,Quinton Byfield,R,LAK,22,82,16,31,47
2,8476479,Phillip Danault,C,LAK,31,82,15,32,47
2,8480014,Gabriel Vilardi,C,WPG,25,82,24,22,46
2,8475794,Tyler Seguin,C,DAL,32,82,23,23,46
2,8480188,Fabian Zetterlund,L,SJS,25,82,22,24,46
2,8480078,Filip Chytil,C,NYR,25,82,17,29,46
2,8475168,Matt Duchene,C,DAL,33,82,17,29,46
2,8480839,Rasmus Dahlin,D,BUF,24,82,10,36,46
2,8478055,Gustav Forsling,D,FLA,28,82,9,37,46
2,8478397,Rasmus Andersson,D,CGY,28,82,8,38,46
2,8481533,Trevor Zegras,C,ANA,23,82,20,25,45
2,8477964,Ivan Barbashev,C,VGK,29,82,17,28,45
2,8482113,Anton Lundell,C,FLA,23,82,17,28,45
2,8474586,Jordan Eberle,R,SEA,34,82,15,30,45
2,8477494,Jonathan Drouin,L,COL,29,82,12,33,45
2,8471724,Kris Letang,D,PIT,37,82,11,34,45
2,8475848,Brendan Gallagher,R,MTL,32,82,26,18,44
2,8475314,Anders Lee,L,NYI,34,82,25,19,44
2,8477935,Sam Bennett,C,FLA,28,82,20,24,44
2,8475158,Ryan O'Reilly,C,NSH,33,82,19,25,44
2,8477476,Artturi Lehkonen,L,COL,29,82,19,25,44
2,8475170,Brayden Schenn,C,STL,33,82,18,26,44
2,8475745,Charlie Coyle,C,BOS,32,82,17,27,44
2,8475768,Jaden Schwartz,C,SEA,32,82,17,27,44
2,8475169,Evander Kane,L,EDM,33,82,15,29,44
2,8476458,Ryan Strome,C,ANA,31,82,15,29,44
2,8478038,Devon Toews,D,COL,30,82,8,36,44
2,8483397,Marc McLaughlin,C,BOS,25,82,39,4,43
2,8476399,Blake Coleman,C,CGY,33,82,23,20,43
2,8475714,Calle Jarnkrok,C,TOR,33,82,21,22,43
2,8482097,Jack Quinn,R,BUF,23,82,19,24,43
2,8480028,Morgan Frost,C,PHI,25,82,18,25,43
2,8474150,Mikael Backlund,C,CGY,35,82,14,29,43
2,8477986,Brandon Montour,D,FLA,30,82,13,30,43
2,8482222,Alexander Barabanov,L,SJS,30,82,9,34,43
2,8480434,Sean Durzi,D,ARI,26,82,7,36,43
2,8477503,Max Domi,C,TOR,29,82,6,37,43
2,8474157,Max Pacioretty,L,WSH,36,82,23,19,42
2,8477456,J.T. Compher,L,DET,29,82,20,22,42
2,8474641,Adam Henrique,C,EDM,34,82,20,22,42
2,8476432,Boone Jenner,C,CBJ,31,82,17,25,42
2,8478438,Tommy Novak,C,NSH,27,82,16,26,42
2,8479987,Morgan Geekie,C,BOS,26,82,15,27,42
2,8474102,David Perron,L,DET,36,82,13,29,42
2,8480031,Maxime Comtois,L,CAR,25,82,8,34,42
2,8475722,Jason Zucker,L,NSH,32,82,24,17,41
2,8476981,Josh Anderson,R,MTL,30,82,24,17,41
2,8476392,Adam Lowry,C,WPG,31,82,23,18,41
2,8482699,Dylan Guenther,R,ARI,21,82,15,26,41
2,8478396,Noah Hanifin,D,VGK,27,82,12,29,41
2,8483431,Logan Cooley,C,ARI,20,82,26,14,40
2,8482101,Danil Gushchin,L,SJS,22,82,20,20,40
2,8483808,Andrei Kuzmenko,L,CGY,28,82,18,22,40
2,8478856,Conor Garland,R,VAN,28,82,17,23,40
2,8482745,Mason McTavish,C,ANA,21,82,16,24,40
2,8481596,Shane Pinto,C,OTT,24,82,16,24,40
2,8471698,T.J. Oshie,R,WSH,38,82,16,24,40
2,8478472,Mathieu Joseph,R,OTT,27,82,15,25,40
2,8481711,Matias Maccelli,L,ARI,24,82,13,27,40
2,8475753,Justin Faulk,D,STL,32,82,11,29,40
2,8477495,Seth Jones,D,CHI,30,82,10,30,40
2,8475744,Evgeny Kuznetsov,C,CAR,32,82,9,31,40
2,8476869,Brady Skjei,D,CAR,30,82,7,33,40
2,8482089,Jake Neighbours,L,STL,22,82,22,17,39
2,8478542,Evan Rodrigues,C,FLA,31,82,21,18,39
2,8480798,Philipp Kurashev,C,CHI,25,82,16,23,39
2,8481528,Dylan Cozens,C,BUF,23,82,15,24,39
2,8482475,Yegor Chinakhov,R,CBJ,23,82,14,25,39
2,8477021,Alex Kerfoot,C,ARI,30,82,14,25,39
2,8478975,Mason Marchment,L,DAL,29,82,13,26,39
2,8475197,Tyson Barrie,D,NSH,33,82,8,31,39
2,8483457,Lane Hutson,D,MTL,20,82,6,33,39
2,8476438,Brandon Saad,L,STL,32,82,20,18,38
2,8475151,Kyle Palmieri,C,NYI,33,82,20,18,38
2,8482159,Tyson Foerster,R,PHI,22,82,20,18,38
2,8476881,Tomas Hertl,C,VGK,31,82,17,21,38
2,8484144,Connor Bedard,C,CHI,19,82,15,23,38
2,8479415,Michael McLeod,C,NJD,26,82,15,23,38
2,8482133,Thomas Bordeleau,C,SJS,22,82,14,24,38
2,8480797,Joel Farabee,L,PHI,24,82,13,25,38
2,8476872,Scott Laughton,C,PHI,30,82,9,29,38
2,8477426,Nicholas Paul,L,TBL,29,82,23,14,37
2,8477952,Robby Fabbri,C,DET,28,82,20,17,37
2,8480113,Alex Iafallo,L,WPG,31,82,19,18,37
2,8475287,Erik Haula,L,NJD,33,82,17,20,37
2,8482110,Dawson Mercer,C,NJD,23,82,16,21,37
2,8478458,Jack Roslovic,C,NYR,27,82,14,23,37
2,8474037,James van Riemsdyk,L,BOS,35,82,14,23,37
2,8478519,Anthony Cirelli,C,TBL,27,82,13,24,37
2,8478046,Danton Heinen,L,BOS,29,82,12,25,37
2,8477932,Aaron Ekblad,D,FLA,28,82,11,26,37
2,8484166,Adam Fantilli,C,CBJ,20,82,19,17,36
2,8482667,William Eklund,L,SJS,22,82,18,18,36
2,8481553,Bobby Brink,R,PHI,23,82,16,20,36
2,8478366,Frank Vatrano,R,ANA,30,82,15,21,36
2,8482146,Luke Evangelista,R,NSH,22,82,15,21,36
2,8475149,Marcus Johansson,L,MIN,34,82,15,21,36
2,8479345,Jakob Chychrun,D,OTT,26,82,14,22,36
2,8477444,Andre Burakovsky,L,SEA,29,82,14,22,36
2,8479353,Brett Howden,C,VGK,26,82,14,22,36
2,8474870,Tyler Johnson,C,CHI,34,82,14,22,36
2,8483515,Juraj Slafkovsky,L,MTL,20,82,13,23,36
2,8480873,Rasmus Sandin,D,WSH,24,82,10,26,36
2,8480817,K'Andre Miller,D,NYR,24,82,8,28,36
2,8475906,John Klingberg,D,TOR,32,82,7,29,36
2,8476979,Erik Gustafsson,D,NYR,32,82,7,29,36
2,8475218,Mattias Ekholm,D,EDM,34,82,6,30,36
2,8481016,Ruslan Iskhakov,C,NYI,24,82,6,30,36
2,8483524,Shane Wright,C,SEA,20,82,26,9,35
2,8477944,Jakub Vrana,L,STL,28,82,19,16,35
2,8470604,Jeff Carter,C,PIT,39,82,19,16,35
2,8480064,Josh Norris,C,OTT,25,82,18,17,35
2,8478057,Dakota Joshua,C,VAN,28,82,18,17,35
2,8476419,Jean-Gabriel Pageau,C,NYI,32,82,15,20,35
2,8476960,Andreas Athanasiou,C,CHI,30,82,15,20,35
2,8480802,Ryan McLeod,C,EDM,25,82,15,20,35
2,8479365,Trent Frederic,C,BOS,26,82,14,21,35
2,8482055,Drew O'Connor,L,PIT,26,82,14,21,35
2,8480039,Martin Necas,C,CAR,25,82,13,22,35
2,8474053,Logan Couture,C,SJS,35,82,12,23,35
2,8481581,Thomas Harley,D,DAL,23,82,12,23,35
2,8481546,Cam York,D,PHI,23,82,12,23,35
2,8479999,Casey Mittelstadt,C,COL,26,82,11,24,35
2,8470613,Brent Burns,D,CAR,39,82,9,26,35
2,8482671,Owen Power,D,BUF,22,82,8,27,35
2,8480145,Neal Pionk,D,WPG,29,82,5,30,35
2,8477919,Frederick Gaudreau,C,MIN,31,82,19,15,34
2,8479992,Michael Rasmussen,C,DET,25,82,17,17,34
2,8479525,Ross Colton,C,COL,28,82,15,19,34
2,8478115,Pierre Engvall,L,NYI,28,82,14,20,34
2,8482665,Matty Beniers,C,SEA,22,82,13,21,34
2,8476923,Damon Severson,D,CBJ,30,82,10,24,34
2,8482720,Matthew Knies,L,TOR,22,82,9,25,34
2,8483471,Brad Lambert,C,WPG,31,82,5,29,34
2,8479410,Mikhail Sergachev,D,TBL,26,82,3,31,34
2,8480849,Barrett Hayton,C,ARI,24,82,18,15,33
2,8481624,Ilya Mikheyev,R,VAN,30,82,18,15,33
2,8481186,Logan O'Connor,R,COL,28,82,16,17,33
2,8482175,JJ Peterka,R,BUF,22,82,15,18,33
2,8470621,Corey Perry,R,EDM,39,82,12,21,33
2,8471218,Blake Wheeler,R,NYR,38,82,11,22,33
2,8478891,Mason Appleton,C,WPG,28,82,11,22,33
2,8483445,Cutter Gauthier,L,ANA,20,82,6,27,33
2,8479425,Filip Hronek,D,VAN,27,82,5,28,33
2,8484153,Leo Carlsson,C,ANA,20,82,15,17,32
2,8477511,Anthony Mantha,R,VGK,30,82,15,17,32
2,8476469,Joel Armia,R,MTL,31,82,15,17,32
2,8478466,Daniel Sprong,R,DET,27,82,14,18,32
2,8477407,Anthony Duclair,L,TBL,29,82,12,20,32
2,8474189,Lars Eller,C,PIT,35,82,12,20,32
2,8479996,Cody Glass,C,NSH,25,82,11,21,32
2,8481013,Jonatan Berggren,R,DET,24,82,11,21,32
2,8477953,Kasperi Kapanen,R,STL,28,82,11,21,32
2,8482105,Jake Sanderson,D,OTT,22,82,7,25,32
2,8476882,Teuvo Teravainen,L,CAR,30,82,6,26,32
2,8474716,Jared Spurgeon,D,MIN,35,82,6,26,32
2,8481542,Moritz Seider,D,DET,23,82,4,28,32
2,8481604,Pavel Dorofeyev,L,VGK,24,82,21,10,31
2,8482259,Bobby McMann,C,TOR,28,82,20,11,31
2,8484203,Bradly Nadeau,L,CAR,19,82,19,12,31
2,8482092,Ridly Greig,C,OTT,22,82,16,15,31
2,8480893,Kirill Marchenko,R,CBJ,24,82,16,15,31
2,8479423,Alex Nylander,L,CBJ,26,82,15,16,31
2,8478109,Victor Olofsson,L,BUF,29,82,15,16,31
2,8475763,Kevin Hayes,R,STL,32,82,13,18,31
2,8479293,Brandon Tanev,L,SEA,33,82,13,18,31
2,8473563,Nicklas Backstrom,C,WSH,37,82,11,20,31
2,8476292,Ondrej Palat,L,NJD,33,82,7,24,31
2,8476422,Mike Reilly,D,NYI,31,82,7,24,31
2,8476854,Hampus Lindholm,D,BOS,30,82,3,28,31
2,8474565,Alex Pietrangelo,D,VGK,34,82,2,29,31
2,8478474,Lawson Crouse,L,ARI,27,82,17,13,30
2,8475793,Ryan Johansen,C,PHI,32,82,15,15,30
2,8481580,Connor McMichael,C,WSH,23,82,15,15,30
2,8480459,Pius Suter,C,VAN,28,82,14,16,30
2,8482155,Alex Laferriere,R,LAK,23,82,12,18,30
2,8477998,Warren Foegele,L,EDM,28,82,10,20,30
2,8473422,Nick Foligno,L,CHI,37,82,10,20,30
2,8474149,Evgenii Dadonov,R,DAL,35,82,9,21,30
2,8480220,Noah Cates,L,PHI,25,82,8,22,30
2,8476885,Jacob Trouba,D,NYR,30,82,7,23,30
2,8477948,Travis Sanheim,D,PHI,28,82,4,26,30
2,8475324,Nick Jensen,D,WSH,34,82,4,26,30
2,8478500,Ivan Provorov,D,CBJ,27,82,3,27,30
2,8470610,Zach Parise,L,COL,40,82,18,11,29
2,8479661,Tanner Jeannot,L,TBL,27,82,16,13,29
2,8475799,Nino Niederreiter,R,WPG,32,82,15,14,29
2,8477498,Darnell Nurse,D,EDM,29,82,12,17,29
2,8478133,Jake Evans,C,MTL,28,82,12,17,29
2,8480185,Eetu Luostarinen,C,FLA,26,82,9,20,29
2,8480246,Nick Perbix,D,TBL,26,82,3,26,29
2,8480043,Timothy Liljegren,D,TOR,25,82,2,27,29
2,8476331,Dylan DeMelo,D,WPG,31,82,1,28,29
2,8479346,Dillon Dube,C,CGY,26,82,18,10,28
2,8474715,Cam Atkinson,R,PHI,35,82,15,13,28
2,8482125,Alexander Holtz,R,NJD,22,82,15,13,28
2,8476878,Zemgus Girgensons,L,BUF,30,82,14,14,28
2,8481618,Alex Newhook,C,MTL,23,82,13,15,28
2,8478020,Michael Amadio,C,VGK,28,82,13,15,28
2,8480821,Filip Zadina,R,SJS,25,82,12,16,28
2,8477947,Sonny Milano,L,WSH,28,82,11,17,28
2,8482074,Connor Zary,C,CGY,23,82,11,17,28
2,8484145,Zach Benson,L,BUF,19,82,11,17,28
2,8482624,Daniil Miromanov,D,CGY,27,82,9,19,28
2,8476312,Josh Manson,D,COL,33,82,9,19,28
2,8480336,Sean Walker,D,COL,30,82,8,20,28
2,8482087,Kaiden Guhle,D,MTL,22,82,8,20,28
2,8481656,Aliaksei Protas,C,WSH,23,82,7,21,28
2,8482117,Lukas Reichel,L,CHI,22,82,6,22,28
2,8476902,Esa Lindell,D,DAL,30,82,5,23,28
2,8482733,Logan Mailloux,D,MTL,31,82,2,26,28
2,8481703,Valtteri Puustinen,R,PIT,25,82,2,26,28
2,8476873,Mark Jankowski,C,NSH,30,82,17,10,27
2,8478508,Yakov Trenin,C,COL,27,82,15,12,27
2,8476480,Vladislav Namestnikov,C,WPG,32,82,12,15,27
2,8481560,Arthur Kaliyev,R,LAK,23,82,12,15,27
2,8476921,Jordan Martinook,L,CAR,32,82,12,15,27
2,8475200,Dmitry Orlov,D,CAR,33,82,11,16,27
2,8477839,Conor Sheary,L,TBL,32,82,10,17,27
2,8478851,Alexandre Carrier,D,NSH,28,82,8,19,27
2,8479398,Samuel Girard,D,COL,26,82,8,19,27
2,8481522,Peyton Krebs,C,BUF,23,82,7,20,27
2,8474884,Mike Hoffman,C,SJS,35,82,16,10,26
2,8480009,Eeli Tolvanen,R,SEA,25,82,12,14,26
2,8478463,Anthony Beauvillier,L,NSH,27,82,12,14,26
2,8482079,Marco Rossi,C,MIN,23,82,12,14,26
2,8476897,Oskar Sundqvist,C,STL,30,82,11,15,26
2,8479514,Rem Pitlick,C,CHI,27,82,9,17,26
2,8476871,Tanner Pearson,L,MTL,32,82,8,18,26
2,8476927,Teddy Blueger,C,VAN,30,82,5,21,26
2,8476958,Jaccob Slavin,D,CAR,30,82,4,22,26
2,8475764,Cam Fowler,D,ANA,33,82,4,22,26
2,8478443,Brandon Carlo,D,BOS,28,82,4,22,26
2,8482145,Mavrik Bourque,C,DAL,22,82,23,2,25
2,8477330,Dominik Kubalik,L,OTT,29,82,15,10,25
2,8481554,Kaapo Kakko,R,NYR,23,82,14,11,25
2,8481535,Nils Hoglander,L,VAN,24,82,14,11,25
2,8476278,Colin Blackwell,C,CHI,31,82,13,12,25
2,8482702,Logan Stankoven,C,DAL,21,82,12,13,25
2,8473533,Jordan Staal,C,CAR,36,82,9,16,25
2,8475343,Nic Dowd,C,WSH,34,82,9,16,25
2,8480068,Ryan Poehling,C,PHI,25,82,9,16,25
2,8478178,Darren Raddysh,D,TBL,28,82,9,16,25
2,8475220,Marcus Foligno,L,MIN,33,82,9,16,25
2,8476329,Travis Boyd,C,ARI,31,82,8,17,25
2,8477435,Ryan Graves,D,PIT,29,82,7,18,25
2,8479980,Nicolas Hague,D,VGK,26,82,7,18,25
2,8475279,Ben Chiarot,D,DET,33,82,7,18,25
2,8476925,Colton Sissons,C,NSH,31,82,6,19,25
2,8482073,Braden Schneider,D,NYR,23,82,5,20,25
2,8478013,Jake Walman,D,DET,28,82,5,20,25
2,8481568,Alex Vlasic,D,CHI,23,82,4,21,25
2,8475208,Brian Dumoulin,D,SEA,33,82,4,21,25
2,8473507,Jeff Petry,D,DET,37,82,3,22,25
2,8483493,Frank Nazar,C,CHI,20,82,20,4,24
2,8483499,Liam Ohgren,L,MIN,20,82,14,10,24
2,8481704,Juuso Parssinen,C,NSH,23,82,12,12,24
2,8479390,Taylor Raddysh,R,CHI,26,82,11,13,24
2,8481093,Rafael Harvey-Pinard,L,MTL,25,82,10,14,24
2,8482655,J.J. Moser,D,ARI,24,82,9,15,24
2,8483505,Matthew Poitras,C,BOS,20,82,9,15,24
2,8481601,Simon Holmstrom,R,NYI,23,82,8,16,24
2,8477507,Nikita Zadorov,D,VAN,29,82,8,16,24
2,8477425,Miles Wood,L,COL,29,82,7,17,24
2,8481567,Henry Thrun,D,SJS,23,82,6,18,24
2,8477969,Marcus Pettersson,D,PIT,28,82,4,20,24
2,8482122,Brock Faber,D,MIN,22,82,4,20,24
2,8478507,John Marino,D,NJD,27,82,3,21,24
2,8479976,Juuso Valimaki,D,ARI,26,82,1,23,24
2,8475760,Nick Bjugstad,C,ARI,32,82,12,11,23
2,8477353,Tyler Motte,C,TBL,29,82,12,11,23
2,8482737,Zack Bolduc,C,STL,21,82,12,11,23
2,8479316,Luke Kunin,C,SJS,27,82,10,13,23
2,8479393,Noah Gregor,C,TOR,26,82,10,13,23
2,8477989,Christian Dvorak,C,MTL,28,82,9,14,23
2,8481537,Nikita Okhotiuk,D,CGY,24,82,9,14,23
2,8474034,Pat Maroon,L,BOS,36,82,8,15,23
2,8482705,Cole Sillinger,C,CBJ,21,82,7,16,23
2,8477508,Curtis Lazar,C,NJD,29,82,6,17,23
2,8476463,Jonas Brodin,D,MIN,31,82,4,19,23
2,8482245,Artem Zub,D,OTT,29,82,3,20,23
2,8481178,Egor Zamula,D,PHI,24,82,3,20,23
2,8476457,Adam Larsson,D,SEA,32,82,2,21,23
2,8478569,Noel Acciari,C,PIT,33,82,13,9,22
2,8480860,Kevin Bahl,D,NJD,24,82,9,13,22
2,8483565,Nick Blankenburg,D,CBJ,26,82,8,14,22
2,8478430,Oliver Kylington,D,CGY,27,82,8,14,22
2,8482679,Matt Coronato,R,CGY,22,82,7,15,22
2,8478413,Jordan Greenway,L,BUF,27,82,6,16,22
2,8479351,Sam Steel,C,DAL,26,82,6,16,22
2,8474673,TJ Brodie,D,TOR,34,82,2,20,22
2,8479591,Michael Eyssimont,C,TBL,28,82,12,9,21
2,8477392,Hudson Fasching,R,NYI,29,82,10,11,21
2,8479977,Kailer Yamamoto,R,SEA,26,82,9,12,21
2,8477488,Brett Pesce,D,CAR,30,82,8,13,21
2,8477506,Ryan Pulock,D,NYI,30,82,8,13,21
2,8478043,Sam Lafferty,C,VAN,29,82,8,13,21
2,8481014,Alexander Romanov,D,NYI,24,82,7,14,21
2,8477931,Tomas Nosek,L,NJD,32,82,7,14,21
2,8479941,Justin Danforth,R,CBJ,31,82,5,16,21
2,8478840,Will Borgen,D,SEA,28,82,5,16,21
2,8478136,Jake Middleton,D,MIN,28,82,5,16,21
2,8476917,Adam Pelech,D,NYI,30,82,4,17,21
2,8482712,Oskar Olausson,R,COL,22,82,4,17,21
2,8475171,Oliver Ekman-Larsson,D,FLA,33,82,3,18,21
2,8480834,Ty Emberson,D,SJS,24,82,3,18,21
2,8473449,Kyle Okposo,R,FLA,36,82,12,8,20
2,8476374,Sean Kuraly,C,CBJ,31,82,9,11,20
2,8482730,Brandt Clarke,D,LAK,21,82,9,11,20
2,8476461,Sean Couturier,C,PHI,32,82,8,12,20
2,8478399,Jonas Siegenthaler,D,NJD,27,82,8,12,20
2,8481524,Bowen Byram,D,BUF,23,82,8,12,20
2,8477369,Carson Soucy,D,VAN,30,82,6,14,20
2,8480871,Adam Boqvist,D,CBJ,24,82,5,15,20
2,8476892,Colton Parayko,D,STL,31,82,5,15,20
2,8479369,Andrew Peeke,D,BOS,26,82,5,15,20
2,8483495,Simon Nemec,D,NJD,20,82,4,16,20
2,8483490,Pavel Mintyukov,D,ANA,21,82,4,16,20
2,8481606,Jordan Spence,D,LAK,23,82,3,17,20
2,8482062,Cole Smith,L,NSH,29,82,3,17,20
2,8475181,Nick Leddy,D,STL,33,82,2,18,20
2,8480281,Alexey Toropchenko,R,STL,25,82,16,3,19
2,8483012,Logan Morrison,C,SEA,22,82,13,6,19
2,8480806,Isac Lundestrom,C,ANA,25,82,10,9,19
2,8481517,Brett Leason,R,ANA,25,82,10,9,19
2,8476442,Matt Nieto,L,PIT,32,82,9,10,19
2,8480813,Joe Veleno,C,DET,24,82,8,11,19
2,8476624,Barclay Goodrow,C,NYR,31,82,7,12,19
2,8479359,Beck Malenstyn,L,WSH,26,82,6,13,19
2,8475790,Erik Gudbranson,D,CBJ,32,82,5,14,19
2,8482111,Justin Barron,D,MTL,23,82,4,15,19
2,8476891,Matt Grzelcyk,D,BOS,30,82,3,16,19
2,8479983,Mario Ferraro,D,SJS,26,82,2,17,19
2,8478416,Erik Cernak,D,TBL,27,82,1,18,19
2,8479383,Boris Katchouk,L,OTT,26,82,11,7,18
2,8480855,Jack McBain,C,ARI,24,82,9,9,18
2,8475164,Jakob Silfverberg,R,ANA,34,82,9,9,18
2,8480074,Alexandre Texier,C,CBJ,25,82,8,10,18
2,8479324,Ryan Lindgren,D,NYR,26,82,7,11,18
2,8476879,Cody Ceci,D,EDM,31,82,6,12,18
2,8480073,Erik Brannstrom,D,OTT,25,82,6,12,18
2,8480796,Martin Fehervary,D,WSH,25,82,5,13,18
2,8478911,Matt Roy,D,LAK,29,82,4,14,18
2,8475690,Chris Tanev,D,DAL,35,82,4,14,18
2,8480807,Mattias Samuelsson,D,BUF,24,82,4,14,18
2,8482142,Jamie Drysdale,D,PHI,22,82,3,15,18
2,8477220,Nate Schmidt,D,WPG,33,82,3,15,18
2,8482807,Ethan Del Mastro,D,CHI,21,82,3,15,18
2,8475179,Dmitry Kulikov,D,FLA,34,82,2,16,18
2,8475762,Derek Forbort,D,BOS,32,82,1,17,18
2,8481059,Scott Perunovich,D,STL,26,82,1,17,18
2,8480144,David Kampf,C,TOR,29,82,9,8,17
2,8475842,Sam Carrick,C,EDM,32,82,7,10,17
2,8475231,Casey Cizikas,C,NYI,33,82,7,10,17
2,8477365,Connor Clifton,D,BUF,29,82,6,11,17
2,8479998,Mikey Anderson,D,LAK,25,82,5,12,17
2,8483491,Ivan Miroshnichenko,L,WSH,20,82,5,12,17
2,8474166,Alec Martinez,D,VGK,37,82,5,12,17
2,8477499,Rasmus Ristolainen,D,PHI,30,82,5,12,17
2,8476467,Jamie Oleksiak,D,SEA,32,82,4,13,17
2,8480879,Jacob Bernard-Docker,D,OTT,24,82,4,13,17
2,8480058,Pierre-Olivier Joseph,D,PIT,25,82,3,14,17
2,8482858,Ryker Evans,D,SEA,23,82,3,14,17
2,8482516,Matthew Kessel,D,STL,24,82,2,15,17
2,8478882,Vladislav Gavrikov,D,LAK,29,82,1,16,17
2,8474151,Ryan McDonagh,D,NSH,35,82,1,16,17
2,8482809,Jackson Blake,R,CAR,21,82,12,4,16
2,8480980,Connor Dewar,C,TOR,25,82,6,10,16
2,8477505,Alexander Wennberg,C,NYR,30,82,6,10,16
2,8477034,Jaycob Megna,D,CHI,32,82,6,10,16
2,8475188,Brayden McNabb,D,VGK,33,82,4,12,16
2,8475233,David Savard,D,MTL,34,82,3,13,16
2,8477845,Trevor van Riemsdyk,D,WSH,33,82,3,13,16
2,8480035,Henri Jokiharju,D,BUF,25,82,3,13,16
2,8479371,Dante Fabbro,D,NSH,26,82,3,13,16
2,8478859,Niko Mikkola,D,FLA,28,82,3,13,16
2,8482118,Sam Colangelo,R,ANA,23,82,10,5,15
2,8477450,Jason Dickinson,C,CHI,29,82,7,8,15
2,8477015,Connor Brown,R,EDM,30,82,6,9,15
2,8470600,Ryan Suter,D,DAL,39,82,4,11,15
2,8478468,Jeremy Lauzon,D,NSH,27,82,4,11,15
2,8475462,Radko Gudas,D,ANA,34,82,3,12,15
2,8482803,Olen Zellweger,D,ANA,21,82,3,12,15
2,8483466,Kevin Korchinski,D,CHI,20,82,3,12,15
2,8476372,Nick Seeler,D,PHI,31,82,3,12,15
2,8475455,Brenden Dillon,D,WPG,34,82,3,12,15
2,8476473,Connor Murphy,D,CHI,31,82,3,12,15
2,8482470,Ilya Solovyov,D,CGY,24,82,2,13,15
2,8476429,Scott Mayfield,D,NYI,32,82,2,13,15
2,8481477,Nico Sturm,C,SJS,29,82,7,7,14
2,8480990,Declan Chisholm,D,MIN,24,82,7,7,14
2,8482166,Shakir Mukhamadullin,D,SJS,22,82,5,9,14
2,8476858,Phillip Di Giuseppe,L,VAN,31,82,5,9,14
2,8474574,Tyler Myers,D,VAN,34,82,4,10,14
2,8474567,Zach Bogosian,D,MIN,34,82,4,10,14
2,8483763,Maksymilian Szuber,D,ARI,22,82,4,10,14
2,8477406,Mattias Janmark,C,EDM,32,82,7,6,13
2,8476915,Jujhar Khaira,L,MIN,30,82,7,6,13
2,8481481,Blake Lizotte,C,LAK,27,82,5,8,13
2,8476931,Jake McCabe,D,TOR,31,82,3,10,13
2,8479442,Troy Stecher,D,EDM,30,82,3,10,13
2,8481605,Jackson LaCombe,D,ANA,23,82,2,11,13
2,8483482,Tristan Luneau,D,ANA,20,82,8,4,12
2,8473453,Trevor Lewis,C,LAK,37,82,8,4,12
2,8478451,Ethan Bear,D,WSH,27,82,6,6,12
2,8473504,Cal Clutterbuck,R,NYI,37,82,5,7,12
2,8481599,Victor Soderstrom,D,ARI,23,82,4,8,12
2,8480172,Jan Rutta,D,SJS,34,82,4,8,12
2,8484911,Collin Graf,R,SJS,22,82,3,9,12
2,8478831,Kevin Stenlund,C,FLA,28,82,3,9,12
2,8476525,Colin Miller,D,WPG,32,82,2,10,12
2,8482177,Marat Khusnutdinov,C,MIN,22,82,1,11,12
2,8482762,Simon Edvinsson,D,DET,21,82,6,5,11
2,8481030,Jack St. Ivany,D,PIT,25,82,6,5,11
2,8474009,Nick Bonino,C,NYR,36,82,5,6,11
2,8476822,Luke Glendening,C,TBL,35,82,4,7,11
2,8481028,Martin Pospisil,C,CGY,25,82,3,8,11
2,8471677,Jack Johnson,D,COL,37,82,1,10,11
2,8477335,Kyle Burroughs,D,SJS,29,82,4,6,10
2,8484149,Gavin Brindley,C,CBJ,20,82,4,6,10
2,8475177,Calvin de Haan,D,TBL,33,82,3,7,10
2,8480448,Parker Kelly,L,OTT,25,82,2,8,10
2,8476967,Brett Kulak,D,EDM,30,82,2,8,10
2,8475825,Jani Hakanpää,D,DAL,32,82,2,8,10
2,8470966,Mark Giordano,D,TOR,41,82,1,9,10
2,8482666,Scott Morrow,D,CAR,22,82,4,5,9
2,8474013,Ian Cole,D,VAN,35,82,3,6,9
2,8478408,Travis Dermott,D,ARI,28,82,3,6,9
2,8479291,Kevin Rooney,C,CGY,31,82,2,7,9
2,8483468,Jiri Kulich,C,BUF,20,82,0,7,7
2,8483489,Fraser Minten,C,TOR,31,82,4,2,6
2,8481578,Graeme Clarke,R,NJD,23,82,3,3,6
2,8482713,Mackie Samoskevich,R,FLA,22,82,2,4,6
2,8482859,Zack Ostapchuk,C,OTT,21,82,0,5,5
2,8482141,Lukas Cormier,D,VGK,22,0,0,0,0
2,8476988,Matt Benning,D,SJS,30,0,0,0,0
2,8480727,Zach Whitecloud,D,VGK,28,0,0,0,0
2,8480887,Jordan Harris,D,MTL,24,0,0,0,0
2,8478450,Parker Wotherspoon,D,BOS,27,0,0,0,0
2,8481812,Nikolai Knyzhov,D,SJS,27,0,0,0,0
2,8480001,Urho Vaakanainen,D,ANA,25,0,0,0,0
2,8482176,Wyatt Kaiser,D,CHI,22,0,0,0,0
2,8481122,Simon Benoit,D,TOR,26,0,0,0,0
2,8476441,Joel Edmundson,D,TOR,31,0,0,0,0
2,8480884,Calen Addison,D,SJS,24,0,0,0,0
2,8482511,Mason Lohrei,D,BOS,23,0,0,0,0
2,8482192,Isaak Phillips,D,CHI,23,0,0,0,0
2,8480950,Ilya Lyubushkin,D,TOR,30,0,0,0,0
2,8474031,Kevin Shattenkirk,D,BOS,35,0,0,0,0
2,8475718,Justin Holl,D,DET,32,0,0,0,0
2,8479402,Jake Bean,D,CBJ,26,0,0,0,0
2,8474602,Justin Schultz,D,SEA,34,0,0,0,0
2,8477950,Tony DeAngelo,D,CAR,29,0,0,0,0
2,8481743,Marc Del Gaizo,D,NSH,25,0,0,0,0
2,8481527,Kaedan Korczak,D,VGK,23,0,0,0,0
2,8480192,Johnathan Kovacevic,D,MTL,27,0,0,0,0
2,8476874,Olli Maatta,D,DET,30,0,0,0,0
2,8482144,Jack Thompson,D,SJS,22,0,0,0,0
2,8480222,Sebastian Aho,D,NYI,28,0,0,0,0
2,8479458,Nikita Zaitsev,D,CHI,33,0,0,0,0
2,8471709,Marc-Edouard Vlasic,D,SJS,37,0,0,0,0
2,8482929,Emil Lilleberg,D,TBL,23,0,0,0,0
2,8477018,Ben Hutton,D,VGK,31,0,0,0,0
2,8481056,Spencer Stastney,D,NSH,24,0,0,0,0
2,8481593,Jayden Struble,D,MTL,23,0,0,0,0
2,8479982,Conor Timmins,D,TOR,26,0,0,0,0
2,8474090,Brendan Smith,D,NJD,35,0,0,0,0
2,8482964,Arber Xhekaj,D,MTL,23,0,0,0,0
2,8480891,Michael Kesselring,D,ARI,24,0,0,0,0
2,8477938,Haydn Fleury,D,TBL,28,0,0,0,0
2,8481806,Louis Crevier,D,CHI,23,0,0,0,0
2,8471274,Alex Goligoski,D,MIN,39,0,0,0,0
2,8481600,Tobias Bjornfot,D,FLA,23,0,0,0,0
2,8475797,Jarred Tinordi,D,CHI,32,0,0,0,0
2,8481521,Ronnie Attard,D,PHI,25,0,0,0,0
2,8474612,Travis Hamonic,D,OTT,34,0,0,0,0
2,8479576,Vincent Desharnais,D,EDM,28,0,0,0,0
2,8480049,Dylan Samberg,D,WPG,25,0,0,0,0
2,8483619,Filip Roos,D,CHI,25,0,0,0,0
2,8474568,Luke Schenn,D,NSH,35,0,0,0,0
2,8480184,Gustav Lindstrom,D,ANA,26,0,0,0,0
2,8480070,Ian Mitchell,D,BOS,25,0,0,0,0
2,8480196,Jacob Bryson,D,BUF,27,0,0,0,0
2,8471686,Marc Staal,D,PHI,37,0,0,0,0
2,8477467,Gustav Olofsson,D,SEA,30,0,0,0,0
2,8478970,Jalen Chatfield,D,CAR,28,0,0,0,0
2,8479348,Kale Clague,D,BUF,26,0,0,0,0
2,8473446,Erik Johnson,D,PHI,36,0,0,0,0
2,8477462,Robert Hagg,D,ANA,29,0,0,0,0
2,8478454,Noah Juulsen,D,VAN,27,0,0,0,0
2,8477384,Josh Brown,D,ARI,30,0,0,0,0
2,8481708,Zac Jones,D,NYR,24,0,0,0,0
2,8481167,Brayden Pachal,D,CGY,25,0,0,0,0
2,8482067,Connor Mackey,D,NYR,28,0,0,0,0
2,8483460,David Jiricek,D,CBJ,21,0,0,0,0
2,8481701,Santeri Hatakka,D,NJD,23,0,0,0,0
2,8478021,William Lagesson,D,ANA,28,0,0,0,0
2,8477851,Jordan Oesterle,D,CGY,32,0,0,0,0
2,8478452,Caleb Jones,D,COL,27,0,0,0,0
2,8479984,Cal Foote,D,NJD,26,0,0,0,0
2,8479639,Dylan Coghlan,D,CAR,26,0,0,0,0
2,8480874,Adam Ginning,D,PHI,24,0,0,0,0
2,8479321,Lucas Johansen,D,WSH,27,0,0,0,0
2,8480878,Nils Lundkvist,D,DAL,24,0,0,0,0
2,8482165,Yan Kuznetsov,D,CGY,22,0,0,0,0
2,8484258,Sam Malinski,D,COL,26,0,0,0,0
2,8480157,Calle Rosen,D,STL,30,0,0,0,0
2,8484304,Uvis Balinskis,D,FLA,28,0,0,0,0
2,8479985,Cale Fleury,D,SEA,26,0,0,0,0
2,8479378,Logan Stanley,D,WPG,26,0,0,0,0
2,8477541,Dakota Mermis,D,MIN,30,0,0,0,0
2,8481609,Vladislav Kolyachonok,D,ARI,23,0,0,0,0
2,8480823,Alexander Alexeyev,D,WSH,25,0,0,0,0
2,8481679,Maxence Guenette,D,OTT,23,0,0,0,0
2,8481564,Ryan Johnson,D,BUF,23,0,0,0,0
2,8479376,Victor Mete,D,PHI,26,0,0,0,0
2,8484254,Akito Hirose,D,VAN,25,0,0,0,0
2,8482660,Kent Johnson,C,CBJ,22,0,0,0,0
2,8482149,Cole Perfetti,C,WPG,22,0,0,0,0
2,8477987,Ryan Donato,C,CHI,28,0,0,0,0
2,8475755,Alexander Petrovic,D,DAL,32,0,0,0,0
2,8477810,Joel Hanley,D,CGY,33,0,0,0,0
2,8474145,Robert Bortuzzo,D,NYI,35,0,0,0,0
2,8481161,Jake Christiansen,D,CBJ,25,0,0,0,0
2,8476884,Derrick Pouliot,D,DAL,30,0,0,0,0
2,8481716,Dmitri Voronkov,L,CBJ,24,0,0,0,0
2,8480084,Nick DeSimone,D,NJD,30,0,0,0,0
2,8475750,Jon Merrill,D,MIN,32,0,0,0,0
2,8479315,Joey Anderson,R,CHI,26,0,0,0,0
2,8478011,Louie Belpedio,D,PHI,28,0,0,0,0
2,8482451,Mikael Pyyhtia,L,CBJ,23,0,0,0,0
2,8481541,Samuel Bolduc,D,NYI,24,0,0,0,0
2,8482126,Emil Andrae,D,PHI,31,0,0,0,0
2,8474618,Marco Scandella,D,STL,34,0,0,0,0
2,8477244,Chad Ruhwedel,D,NYR,34,0,0,0,0
2,8477971,Andreas Englund,D,LAK,28,0,0,0,0
2,8480829,Jesperi Kotkaniemi,C,CAR,24,0,0,0,0
2,8479372,Josh Mahura,D,FLA,26,0,0,0,0
2,8482095,Tyler Kleven,D,OTT,22,0,0,0,0
2,8481719,Maxwell Crozier,D,TBL,24,0,0,0,0
2,8475855,Jesper Fast,R,CAR,33,0,0,0,0
2,8480848,Ty Dellandrea,C,DAL,24,0,0,0,0
2,8475193,Tomas Tatar,L,SEA,34,0,0,0,0
2,8476889,Radek Faksa,C,DAL,30,0,0,0,0
2,8478495,Denis Gurianov,R,PHI,27,0,0,0,0
2,8480216,Jacob Peterson,C,SJS,25,0,0,0,0
2,8480252,Cole Guttman,C,CHI,25,0,0,0,0
2,8479026,Philippe Myers,D,TBL,27,0,0,0,0
2,8481006,Tyler Tucker,D,STL,24,0,0,0,0
2,8481032,Paul Cotter,C,VGK,25,0,0,0,0
2,8481577,Philip Tomasino,C,NSH,23,0,0,0,0
2,8476918,Jimmy Vesey,L,NYR,31,0,0,0,0
2,8479320,Max Lajoie,D,TOR,27,0,0,0,0
2,8478017,Mark Friedman,D,VAN,29,0,0,0,0
2,8481754,Nikita Nesterenko,C,ANA,23,0,0,0,0
2,8483407,Brandon Scanlin,D,NYR,25,0,0,0,0
2,8482659,Josh Doan,R,ARI,22,0,0,0,0
2,8477446,Michael McCarron,R,NSH,29,0,0,0,0
2,8477903,Garnet Hathaway,R,PHI,33,0,0,0,0
2,8482153,Brendan Brisson,C,VGK,23,0,0,0,0
2,8483546,Marshall Rifai,D,TOR,26,0,0,0,0
2,8484287,Cole McWard,D,VAN,23,0,0,0,0
2,8478854,Ryan Shea,D,PIT,27,0,0,0,0
2,8481585,Egor Afanasyev,L,NSH,23,0,0,0,0
2,8483398,Declan Carlile,D,TBL,31,0,0,0,0
2,8478502,Dennis Gilbert,D,CGY,28,0,0,0,0
2,8482749,Joshua Roy,R,MTL,21,0,0,0,0
2,8481598,Philip Broberg,D,EDM,23,0,0,0,0
2,8480835,Jack Drury,C,CAR,24,0,0,0,0
2,8480748,Kiefer Sherwood,L,NSH,29,0,0,0,0
2,8476934,Brock McGinn,L,ANA,30,0,0,0,0
2,8480870,Bo Groulx,C,ANA,24,0,0,0,0
2,8479368,Max Jones,L,ANA,26,0,0,0,0
2,8478099,Kevin Labanc,R,SJS,29,0,0,0,0
2,8478067,Oskar Lindblom,L,SJS,28,0,0,0,0
2,8476393,Nick Cousins,C,FLA,31,0,0,0,0
2,8483395,Arshdeep Bains,L,VAN,23,0,0,0,0
2,8480762,Eric Robinson,L,BUF,29,0,0,0,0
2,8479439,Jacob MacDonald,D,SJS,31,0,0,0,0
2,8476474,Stefan Noesen,R,CAR,31,0,0,0,0
2,8482787,Nikita Chibrikov,R,WPG,31,0,0,0,0
2,8478432,Christian Fischer,R,DET,27,0,0,0,0
2,8477979,Nicolas Aube-Kubel,R,WSH,28,0,0,0,0
2,8481789,Tye Kartye,L,SEA,23,0,0,0,0
2,8479330,Brandon Gignac,C,MTL,27,0,0,0,0
2,8480075,Cameron Crotty,D,ARI,25,0,0,0,0
2,8473473,Milan Lucic,L,BOS,36,0,0,0,0
2,8482094,Daemon Hunt,D,MIN,22,0,0,0,0
2,8481206,John Ludvig,D,PIT,24,0,0,0,0
2,8483630,Pavol Regenda,L,ANA,25,0,0,0,0
2,8481617,Vasily Podkolzin,R,VAN,23,0,0,0,0
2,8480306,Grant Hutton,D,NYI,29,0,0,0,0
2,8480995,Pontus Holmberg,R,TOR,25,0,0,0,0
2,8482148,Hendrix Lapierre,C,WSH,22,0,0,0,0
2,8477478,William Carrier,L,VGK,30,0,0,0,0
2,8480003,Jesper Boqvist,C,BOS,26,0,0,0,0
2,8482172,Landon Slaggert,L,CHI,22,0,0,0,0
2,8480789,Oliver Wahlstrom,R,NYI,24,0,0,0,0
2,8474062,Riley Nash,C,NYR,35,0,0,0,0
2,8480021,Jack Studnicka,C,SJS,25,0,0,0,0
2,8480025,MacKenzie Entwistle,R,CHI,25,0,0,0,0
2,8481582,Nicholas Robertson,L,TOR,23,0,0,0,0
2,8476867,Brendan Gaunce,C,CBJ,30,0,0,0,0
2,8479619,Michael Carcone,L,ARI,28,0,0,0,0
2,8479370,Tyson Jost,C,BUF,26,0,0,0,0
2,8479671,Mathieu Olivier,R,CBJ,27,0,0,0,0
2,8476994,Vinnie Hinostroza,C,PIT,30,0,0,0,0
2,8482070,Mitchell Chaffee,R,TBL,26,0,0,0,0
2,8477473,Justin Bailey,R,SJS,29,0,0,0,0
2,8479344,Jesse Puljujarvi,R,PIT,26,0,0,0,0
2,8480205,Emil Bemstrom,C,PIT,25,0,0,0,0
2,8479718,Alex Barré-Boulet,C,TBL,27,0,0,0,0
2,8482061,Brandon Biro,L,BUF,26,0,0,0,0
2,8479638,Justin Brazeau,R,BOS,26,0,0,0,0
2,8474040,Sam Gagner,C,EDM,35,0,0,0,0
2,8477846,Ryan Carpenter,C,SJS,33,0,0,0,0
2,8482077,Dylan Holloway,L,EDM,23,0,0,0,0
2,8482157,Will Cuylle,L,NYR,22,0,0,0,0
2,8480007,Jonas Rondbjerg,R,VGK,25,0,0,0,0
2,8478874,Adam Gaudette,C,STL,28,0,0,0,0
2,8478434,Keegan Kolesar,R,VGK,27,0,0,0,0
2,8480441,Trey Fix-Wolansky,R,CBJ,25,0,0,0,0
2,8479994,Jaret Anderson-Dolan,C,NSH,25,0,0,0,0
2,8483567,Georgii Merkulov,C,BOS,24,0,0,0,0
2,8477380,Jonny Brodzinski,C,NYR,31,0,0,0,0
2,8482201,Gage Goncalves,C,TBL,23,0,0,0,0
2,8478211,Dryden Hunt,L,CGY,29,0,0,0,0
2,8471699,Andrew Cogliano,C,COL,37,0,0,0,0
2,8479421,Jacob Moverare,D,LAK,26,0,0,0,0
2,8478881,Brett Seney,L,CHI,28,0,0,0,0
2,8477464,Nic Petan,C,MIN,29,0,0,0,0
2,8475958,Michael Sgarbossa,C,WSH,32,0,0,0,0
2,8481147,Reese Johnson,C,CHI,26,0,0,0,0
2,8479336,Carl Grundstrom,R,LAK,27,0,0,0,0
2,8480853,Liam Foudy,C,NSH,24,0,0,0,0
2,8479522,Hardy Haman Aktell,D,WSH,26,0,0,0,0
2,8481462,Mason Morelli,L,VGK,28,0,0,0,0
2,8482102,Vasily Ponomarev,C,CAR,22,0,0,0,0
2,8480844,Grigori Denisenko,L,VGK,24,0,0,0,0
2,8479944,Zach Aston-Reese,C,DET,30,0,0,0,0
2,8482784,Zach Dean,C,STL,21,0,0,0,0
2,8479419,Brett Murray,L,BUF,26,0,0,0,0
2,8479520,Brandon Duhaime,R,COL,27,0,0,0,0
2,8477573,Nathan Walker,L,STL,30,0,0,0,0
2,8478078,Rourke Chartier,C,OTT,28,0,0,0,0
2,8475795,Dylan McIlrath,D,WSH,32,0,0,0,0
2,8482496,Nils Aman,C,VAN,24,0,0,0,0
2,8480289,Morgan Barron,C,WPG,26,0,0,0,0
2,8481751,Lukas Rousek,R,BUF,25,0,0,0,0
2,8480011,Klim Kostin,C,SJS,25,0,0,0,0
2,8481556,John Beecher,C,BOS,23,0,0,0,0
2,8475278,Byron Froese,C,VGK,33,0,0,0,0
2,8475225,Craig Smith,C,DAL,35,0,0,0,0
2,8484326,Patrik Koch,D,ARI,28,0,0,0,0
2,8477930,Pierre-Edouard Bellemare,L,SEA,39,0,0,0,0
2,8478409,Anthony Richard,C,BOS,28,0,0,0,0
2,8481024,Linus Karlsson,C,VAN,25,0,0,0,0
2,8479986,Kole Lind,R,SEA,26,0,0,0,0
2,8479414,Nathan Bastian,R,NJD,27,0,0,0,0
2,8479362,Riley Tufte,L,COL,26,0,0,0,0
2,8481058,Jesse Ylönen,R,MTL,25,0,0,0,0
2,8482476,Emil Heineman,L,MTL,23,0,0,0,0
2,8482861,Vincent Iorio,D,WSH,22,0,0,0,0
2,8483432,Luca Del Bel Belluz,C,CBJ,31,0,0,0,0
2,8482744,James Malatesta,L,CBJ,21,0,0,0,0
2,8477887,Patrick Brown,C,BOS,32,0,0,0,0
2,8478585,Derek Ryan,C,EDM,38,0,0,0,0
2,8481441,Joe Snively,C,WSH,28,0,0,0,0
2,8481592,Jakob Pelletier,L,CGY,23,0,0,0,0
2,8482634,Alex Steeves,C,TOR,25,0,0,0,0
2,8477126,Jayson Megna,C,BOS,34,0,0,0,0
2,8475752,Tyler Pitlick,C,NYR,33,0,0,0,0
2,8480008,Adam Ruzicka,C,ARI,25,0,0,0,0
2,8481065,Angus Crookshank,L,OTT,25,0,0,0,0
2,8479547,Matthew Phillips,R,WSH,26,0,0,0,0
2,8480226,Marián Studenic,R,SEA,26,0,0,0,0
2,8481237,Kyle MacLean,C,NYI,25,0,0,0,0
2,8475413,Justin Dowling,C,NJD,34,0,0,0,0
2,8481641,Joel Kiviranta,L,COL,28,0,0,0,0
2,8478104,Sammy Blais,L,STL,28,0,0,0,0
2,8477454,Adam Erne,L,EDM,29,0,0,0,0
2,8481518,Nolan Foote,L,NJD,24,0,0,0,0
2,8480245,Olle Lycksell,R,PHI,25,0,0,0,0
2,8483570,Ben Meyers,C,ANA,26,0,0,0,0
2,8480776,Sheldon Rempal,R,VGK,29,0,0,0,0
2,8483920,Pierrick Dube,R,WSH,23,0,0,0,0
2,8480267,Sammy Walker,C,MIN,25,0,0,0,0
2,8482747,Brennan Othmann,L,NYR,21,0,0,0,0
2,8479991,Jake Leschyshyn,C,NYR,25,0,0,0,0
2,8478400,Colin White,C,MTL,27,0,0,0,0
2,8479328,Julien Gauthier,R,NYI,27,0,0,0,0
2,8484325,Waltteri Merela,C,TBL,26,0,0,0,0
2,8479066,Ryan Lomberg,L,FLA,30,0,0,0,0
2,8477070,Liam O'Brien,C,ARI,30,0,0,0,0
2,8478146,Matthew Highmore,C,OTT,28,0,0,0,0
2,8478028,Fredrik Olofsson,L,COL,28,0,0,0,0
2,8480880,Jakub Lauko,C,BOS,24,0,0,0,0
2,8479968,Vinni Lettieri,C,MIN,29,0,0,0,0
2,8474709,Matt Martin,L,NYI,35,0,0,0,0
2,8480845,Rasmus Kupari,C,WPG,24,0,0,0,0
2,8481550,Adam Beckman,L,MIN,23,0,0,0,0
2,8481422,Jacob Lucchini,C,MIN,29,0,0,0,0
2,8477401,John Hayden,C,SEA,29,0,0,0,0
2,8478904,Steven Lorentz,C,FLA,28,0,0,0,0
2,8482088,Justin Sourdif,R,FLA,22,0,0,0,0
2,8482751,Ryan Winterton,C,SEA,21,0,0,0,0
2,8482241,Radim Zohorna,L,PIT,28,0,0,0,0
2,8481690,Tyler Angle,C,CBJ,24,0,0,0,0
2,8476952,Dominic Toninato,C,WPG,30,0,0,0,0
2,8476919,Chris Tierney,C,NJD,30,0,0,0,0
2,8480032,Shane Bowers,C,NJD,25,0,0,0,0
2,8484314,Jiri Smejkal,L,OTT,28,0,0,0,0
2,8481239,Samuel Fagemo,L,LAK,24,0,0,0,0
2,8481532,Alex Turcotte,C,LAK,23,0,0,0,0
2,8481019,David Gustafsson,C,WPG,24,0,0,0,0
2,8478477,Mitchell Stephens,C,MTL,27,0,0,0,0
2,8479546,Oskar Steen,C,BOS,26,0,0,0,0
2,8480292,Carson Meyer,R,CBJ,27,0,0,0,0
2,8478446,Glenn Gawdin,C,ANA,27,0,0,0,0
2,8483531,Brian Halonen,L,NJD,25,0,0,0,0
2,8477149,Scott Sabourin,R,SJS,32,0,0,0,0
2,8479972,Mason Shaw,C,MIN,26,0,0,0,0
2,8480890,Jan Jenik,R,ARI,24,0,0,0,0
2,8478051,Max Willman,C,NJD,29,0,0,0,0
2,8480851,Akil Thomas,C,LAK,24,0,0,0,0
2,8482765,Isak Rosen,R,BUF,21,0,0,0,0
2,8478421,A.J. Greer,L,CGY,28,0,0,0,0
2,8478512,Austin Czarnik,C,DET,32,0,0,0,0
2,8479536,Axel Jonsson-Fjallby,L,WPG,26,0,0,0,0
2,8477320,Anton Blidh,L,NYR,29,0,0,0,0
2,8481543,Nikita Alexandrov,C,STL,24,0,0,0,0
2,8475235,Nicolas Deslauriers,L,PHI,33,0,0,0,0
2,8481070,Hugh McGing,L,STL,26,0,0,0,0
2,8480836,Jonathan Gruden,C,PIT,24,0,0,0,0
2,8481591,Sam Poulin,R,PIT,23,0,0,0,0
2,8477962,Brendan Lemieux,L,CAR,28,0,0,0,0
2,8483401,Marc Johnstone,R,PIT,28,0,0,0,0
2,8482250,Callahan Burke,C,CAR,27,0,0,0,0
2,8481726,Adam Edstrom,C,NYR,24,0,0,0,0
2,8471817,Ryan Reaves,R,TOR,37,0,0,0,0
2,8479587,Rhett Gardner,C,PHI,28,0,0,0,0
2,8475766,Austin Watson,L,TBL,32,0,0,0,0
2,8479367,William Lockwood,R,FLA,26,0,0,0,0
2,8478424,Jansen Harkins,C,PIT,27,0,0,0,0
2,8476913,Devin Shore,C,SEA,30,0,0,0,0
2,8482652,Walker Duehr,R,CGY,27,0,0,0,0
2,8477527,Ross Johnston,L,ANA,30,0,0,0,0
2,8481077,John Leonard,L,ARI,26,0,0,0,0
2,8483549,Lucas Condotta,L,MTL,27,0,0,0,0
2,8480468,James Hamblin,L,EDM,25,0,0,0,0
2,8476907,Mackenzie MacEachern,L,STL,30,0,0,0,0
2,8479543,Michael Pezzetta,L,MTL,26,0,0,0,0
2,8480355,Mark Kastelic,C,OTT,25,0,0,0,0
2,8482162,Roby Jarventie,L,OTT,22,0,0,0,0
2,8479772,Zack MacEwen,R,OTT,28,0,0,0,0
2,8483597,Milos Kelemen,L,ARI,25,0,0,0,0
2,8479379,Givani Smith,R,SJS,26,0,0,0,0
2,8481655,Cole Schwindt,R,CGY,23,0,0,0,0
2,8479981,Jonah Gadjovich,L,FLA,26,0,0,0,0
2,8482147,Jean-Luc Foudy,C,COL,22,0,0,0,0
2,8484255,Jason Polin,R,COL,25,0,0,0,0
2,8477993,Justin Kirkland,C,ARI,28,0,0,0,0
2,8479249,Andrew Poturalski,C,SEA,30,0,0,0,0
2,8482197,Adam Raska,R,MIN,23,0,0,0,0
2,8475780,Chris Wagner,R,COL,33,0,0,0,0
2,8479533,Joona Koppanen,L,PIT,26,0,0,0,0
2,8481534,Raphael Lavoie,C,EDM,24,0,0,0,0
2,8484321,Nikolas Matinpalo,D,OTT,26,0,0,0,0
2,8481043,Cole Koepke,L,TBL,26,0,0,0,0
2,8476323,Max McCormick,L,SEA,32,0,0,0,0
2,8483609,Adam Klapka,R,CGY,24,0,0,0,0
2,8483512,Matt Savoie,C,BUF,20,0,0,0,0
2,8484259,Ondrej Pavel,C,COL,31,0,0,0,0
2,8478147,Bokondji Imama,L,OTT,28,0,0,0,0
2,8482460,Matt Rempe,C,NYR,22,0,0,0,0
2,8477073,Kurtis MacDermid,L,NJD,30,0,0,0,0
2,8480274,Philip Kemp,D,EDM,25,0,0,0,0
2,8478956,Samuel Laberge,L,NJD,27,0,0,0,0
2,8483045,Cameron Butler,R,CBJ,31,0,0,0,0
3,8478402,Connor McDavid,C,EDM,27,82,48,90,138
3,8479318,Auston Matthews,C,TOR,27,82,61,52,113
3,8476453,Nikita Kucherov,R,TBL,31,82,36,77,113
3,8477934,Leon Draisaitl,C,EDM,29,82,45,61,106
3,8478420,Mikko Rantanen,R,COL,28,82,50,55,105
3,8478864,Kirill Kaprizov,L,MIN,27,82,42,58,100
3,8479314,Matthew Tkachuk,L,FLA,27,82,39,60,99
3,8477492,Nathan MacKinnon,C,COL,29,82,38,61,99
3,8478010,Brayden Point,C,TBL,28,82,51,47,98
3,8481559,Jack Hughes,C,NJD,23,82,32,66,98
3,8477404,Jake Guentzel,C,CAR,30,82,47,46,93
3,8478550,Artemi Panarin,L,NYR,33,82,39,54,93
3,8476887,Filip Forsberg,L,NSH,30,82,46,46,92
3,8477939,William Nylander,R,TOR,28,82,34,57,91
3,8479407,Jesper Bratt,L,NJD,26,82,29,61,90
3,8480069,Cale Makar,D,COL,26,82,17,72,89
3,8477956,David Pastrnak,R,BOS,28,82,39,49,88
3,8477402,Pavel Buchnevich,L,STL,29,82,37,51,88
3,8475166,John Tavares,C,TOR,34,82,44,40,84
3,8471675,Sidney Crosby,C,PIT,37,82,34,49,83
3,8473419,Brad Marchand,L,BOS,36,82,21,62,83
3,8476853,Morgan Rielly,D,TOR,30,82,11,72,83
3,8479343,Clayton Keller,R,ARI,26,82,33,49,82
3,8480027,Jason Robertson,L,DAL,25,82,31,51,82
3,8474600,Roman Josi,D,NSH,34,82,21,61,82
3,8481523,Kirby Dach,C,MTL,23,82,19,63,82
3,8479323,Adam Fox,D,NYR,26,82,18,64,82
3,8475172,Nazem Kadri,C,CGY,34,82,35,46,81
3,8477933,Sam Reinhart,C,FLA,29,82,34,46,80
3,8477949,Alex Tuch,R,BUF,28,82,40,38,78
3,8480012,Elias Pettersson,C,VAN,26,82,36,42,78
3,8478403,Jack Eichel,C,VGK,28,82,35,43,78
3,8481557,Matt Boldy,L,MIN,23,82,32,43,75
3,8480830,Andrei Svechnikov,R,CAR,24,82,30,45,75
3,8482116,Tim Stützle,C,OTT,22,82,24,51,75
3,8477409,Carter Verhaeghe,C,FLA,29,82,36,38,74
3,8476459,Mika Zibanejad,C,NYR,31,82,29,45,74
3,8475786,Zach Hyman,L,EDM,32,82,33,40,73
3,8474564,Steven Stamkos,C,TBL,34,82,31,42,73
3,8480002,Nico Hischier,C,NJD,25,82,33,39,72
3,8480800,Quinn Hughes,D,VAN,25,82,16,56,72
3,8475798,Mikael Granlund,C,SJS,32,82,13,59,72
3,8476460,Mark Scheifele,C,WPG,31,82,35,36,71
3,8477493,Aleksander Barkov,C,FLA,29,82,27,44,71
3,8478873,Troy Terry,R,ANA,27,82,32,38,70
3,8476346,Johnny Gaudreau,L,CBJ,31,82,16,54,70
3,8480208,Drake Batherson,R,OTT,26,82,32,37,69
3,8478445,Mathew Barzal,C,NYI,27,82,22,47,69
3,8476468,J.T. Miller,C,VAN,31,82,20,49,69
3,8478414,Timo Meier,R,NJD,28,82,40,28,68
3,8481540,Cole Caufield,R,MTL,23,82,37,31,68
3,8477960,Adrian Kempe,R,LAK,28,82,36,32,68
3,8478493,Joel Eriksson Ek,C,MIN,27,82,32,36,68
3,8480801,Brady Tkachuk,L,OTT,25,82,30,38,68
3,8482684,Luke Hughes,D,NJD,21,82,21,47,68
3,8480803,Evan Bouchard,D,EDM,25,82,18,50,68
3,8477955,Jared McCann,L,SEA,28,82,26,41,67
3,8480023,Robert Thomas,C,STL,25,82,24,43,67
3,8477479,Tyler Bertuzzi,L,TOR,29,82,34,32,66
3,8479385,Jordan Kyrou,C,STL,26,82,27,39,66
3,8480018,Nick Suzuki,C,MTL,25,82,25,41,66
3,8478439,Travis Konecny,R,PHI,27,82,26,39,65
3,8482078,Lucas Raymond,L,DET,22,82,19,46,65
3,8471214,Alex Ovechkin,L,WSH,39,82,36,28,64
3,8478449,Roope Hintz,C,DAL,28,82,33,31,64
3,8477946,Dylan Larkin,C,DET,28,82,31,33,64
3,8478407,Vince Dunn,D,SEA,28,82,14,49,63
3,8478427,Sebastian Aho,C,CAR,27,82,25,37,62
3,8476389,Vincent Trocheck,C,NYR,31,82,24,38,62
3,8475754,Brock Nelson,C,NYI,33,82,29,32,61
3,8471215,Evgeni Malkin,C,PIT,38,82,24,37,61
3,8475692,Mats Zuccarello,R,MIN,37,82,20,41,61
3,8473512,Claude Giroux,R,OTT,36,82,17,44,61
3,8476454,Ryan Nugent-Hopkins,C,EDM,31,82,15,46,61
3,8477942,Kevin Fiala,L,LAK,28,82,19,41,60
3,8480839,Rasmus Dahlin,D,BUF,24,82,16,44,60
3,8477447,Shea Theodore,D,VGK,29,82,10,50,60
3,8477501,Valeri Nichushkin,R,COL,29,82,29,30,59
3,8475726,Tyler Toffoli,C,WPG,32,82,28,31,59
3,8479337,Alex DeBrincat,R,DET,27,82,27,32,59
3,8478398,Kyle Connor,L,WPG,28,82,26,33,59
3,8475913,Mark Stone,R,VGK,32,82,25,34,59
3,8475168,Matt Duchene,C,DAL,33,82,25,34,59
3,8478047,Michael Bunting,L,PIT,29,82,24,35,59
3,8477951,Nick Schmaltz,C,ARI,28,82,22,37,59
3,8479542,Brandon Hagel,L,TBL,26,82,21,38,59
3,8474141,Patrick Kane,R,DET,36,82,19,40,59
3,8482097,Jack Quinn,R,BUF,23,82,19,40,59
3,8474590,John Carlson,D,WSH,34,82,17,42,59
3,8477500,Bo Horvat,C,NYI,29,82,33,25,58
3,8476539,Jonathan Marchessault,R,VGK,34,82,30,28,58
3,8482740,Wyatt Johnston,C,DAL,21,82,27,31,58
3,8473986,Alex Killorn,L,ANA,35,82,25,33,58
3,8471685,Anze Kopitar,C,LAK,37,82,19,39,58
3,8482665,Matty Beniers,C,SEA,22,82,16,42,58
3,8477504,Josh Morrissey,D,WPG,29,82,8,50,58
3,8477451,Ryan Hartman,R,MIN,30,82,28,29,57
3,8478440,Dylan Strome,C,WSH,27,82,21,36,57
3,8476881,Tomas Hertl,C,VGK,31,82,35,21,56
3,8475791,Taylor Hall,L,CHI,33,82,24,32,56
3,8475794,Tyler Seguin,C,DAL,32,82,22,34,56
3,8474578,Erik Karlsson,D,PIT,34,82,15,41,56
3,8476456,Jonathan Huberdeau,C,CGY,31,82,12,44,56
3,8478498,Jake DeBrusk,L,BOS,28,82,26,29,55
3,8476448,William Karlsson,C,VGK,31,82,25,30,55
3,8480039,Martin Necas,C,CAR,25,82,23,32,55
3,8478519,Anthony Cirelli,C,TBL,27,82,19,36,55
3,8479325,Charlie McAvoy,D,BOS,27,82,13,42,55
3,8476462,Dougie Hamilton,D,NJD,31,82,12,43,55
3,8475167,Victor Hedman,D,TBL,34,82,9,46,55
3,8477940,Nikolaj Ehlers,L,WPG,28,82,24,30,54
3,8478042,Viktor Arvidsson,R,LAK,31,82,22,32,54
3,8478975,Mason Marchment,L,DAL,29,82,21,33,54
3,8477496,Elias Lindholm,C,VAN,30,82,20,34,54
3,8478460,Zach Werenski,D,CBJ,27,82,13,41,54
3,8474565,Alex Pietrangelo,D,VGK,34,82,7,47,54
3,8475784,Jeff Skinner,C,BUF,32,82,27,26,53
3,8476399,Blake Coleman,C,CGY,33,82,27,26,53
3,8479420,Tage Thompson,C,BUF,27,82,26,27,53
3,8474157,Max Pacioretty,L,WSH,36,82,25,28,53
3,8476882,Teuvo Teravainen,L,CAR,30,82,12,41,53
3,8480036,Miro Heiskanen,D,DAL,25,82,11,42,53
3,8476792,Torey Krug,D,STL,33,82,9,44,53
3,8476905,Chandler Stephenson,C,VGK,30,82,9,44,53
3,8475184,Chris Kreider,L,NYR,33,82,35,17,52
3,8478366,Frank Vatrano,R,ANA,30,82,29,23,52
3,8483808,Andrei Kuzmenko,L,CGY,28,82,28,24,52
3,8479339,Patrik Laine,L,CBJ,26,82,25,27,52
3,8474679,Gustav Nyquist,C,NSH,35,82,19,33,52
3,8482745,Mason McTavish,C,ANA,21,82,18,34,52
3,8477416,Oliver Bjorkstrand,R,SEA,29,82,16,36,52
3,8481528,Dylan Cozens,C,BUF,23,82,16,36,52
3,8476880,Tom Wilson,R,WSH,30,82,23,28,51
3,8477444,Andre Burakovsky,L,SEA,29,82,18,33,51
3,8476906,Shayne Gostisbehere,D,DET,31,82,12,39,51
3,8483445,Cutter Gauthier,L,ANA,20,82,10,41,51
3,8476981,Josh Anderson,R,MTL,30,82,28,22,50
3,8480188,Fabian Zetterlund,L,SJS,25,82,25,25,50
3,8478438,Tommy Novak,C,NSH,27,82,19,31,50
3,8475745,Charlie Coyle,C,BOS,32,82,17,33,50
3,8483397,Marc McLaughlin,C,BOS,25,82,41,8,49
3,8481068,Yegor Sharangovich,C,CGY,26,82,25,24,49
3,8482109,Alexis Lafrenière,L,NYR,23,82,23,26,49
3,8477407,Anthony Duclair,L,TBL,29,82,23,26,49
3,8476826,Yanni Gourde,C,SEA,33,82,17,32,49
3,8478469,Thomas Chabot,D,OTT,27,82,15,34,49
3,8482159,Tyson Foerster,R,PHI,22,82,24,24,48
3,8479999,Casey Mittelstadt,C,COL,26,82,19,29,48
3,8470794,Joe Pavelski,C,DAL,40,82,17,31,48
3,8475765,Vladimir Tarasenko,R,FLA,33,82,17,31,48
3,8470613,Brent Burns,D,CAR,39,82,16,32,48
3,8476958,Jaccob Slavin,D,CAR,30,82,9,39,48
3,8481618,Alex Newhook,C,MTL,23,82,25,22,47
3,8482146,Luke Evangelista,R,NSH,22,82,17,30,47
3,8471724,Kris Letang,D,PIT,37,82,12,35,47
3,8478396,Noah Hanifin,D,VGK,27,82,12,35,47
3,8477346,MacKenzie Weegar,D,CGY,30,82,9,38,47
3,8475906,John Klingberg,D,TOR,32,82,6,41,47
3,8481016,Ruslan Iskhakov,C,NYI,24,82,5,42,47
3,8476432,Boone Jenner,C,CBJ,31,82,29,17,46
3,8475169,Evander Kane,L,EDM,33,82,25,21,46
3,8476458,Ryan Strome,C,ANA,31,82,23,23,46
3,8475810,Bryan Rust,R,PIT,32,82,22,24,46
3,8476483,Rickard Rakell,R,PIT,31,82,22,24,46
3,8479675,Trevor Moore,L,LAK,29,82,20,26,46
3,8475768,Jaden Schwartz,C,SEA,32,82,19,27,46
3,8474150,Mikael Backlund,C,CGY,35,82,19,27,46
3,8477503,Max Domi,C,TOR,29,82,15,31,46
3,8480798,Philipp Kurashev,C,CHI,25,82,14,32,46
3,8478401,Pavel Zacha,C,BOS,27,82,13,33,46
3,8475744,Evgeny Kuznetsov,C,CAR,32,82,13,33,46
3,8478397,Rasmus Andersson,D,CGY,28,82,8,38,46
3,8478444,Brock Boeser,R,VAN,27,82,21,24,45
3,8482092,Ridly Greig,C,OTT,22,82,16,29,45
3,8481533,Trevor Zegras,C,ANA,23,82,14,31,45
3,8475753,Justin Faulk,D,STL,32,82,9,36,45
3,8479410,Mikhail Sergachev,D,TBL,26,82,5,40,45
3,8475158,Ryan O'Reilly,C,NSH,33,82,21,23,44
3,8474586,Jordan Eberle,R,SEA,34,82,19,25,44
3,8478856,Conor Garland,R,VAN,28,82,19,25,44
3,8473994,Jamie Benn,L,DAL,35,82,18,26,44
3,8480797,Joel Farabee,L,PHI,24,82,18,26,44
3,8471218,Blake Wheeler,R,NYR,38,82,11,33,44
3,8476875,Mike Matheson,D,MTL,30,82,10,34,44
3,8474563,Drew Doughty,D,LAK,35,82,9,35,44
3,8483471,Brad Lambert,C,WPG,31,82,8,36,44
3,8475191,Reilly Smith,R,PIT,33,82,21,22,43
3,8480014,Gabriel Vilardi,C,WPG,25,82,21,22,43
3,8480064,Josh Norris,C,OTT,25,82,21,22,43
3,8482093,Seth Jarvis,C,CAR,22,82,18,25,43
3,8478046,Danton Heinen,L,BOS,29,82,17,26,43
3,8474053,Logan Couture,C,SJS,35,82,16,27,43
3,8475170,Brayden Schenn,C,STL,33,82,15,28,43
3,8482113,Anton Lundell,C,FLA,23,82,14,29,43
3,8480031,Maxime Comtois,L,CAR,25,82,12,31,43
3,8475314,Anders Lee,L,NYI,34,82,24,18,42
3,8477947,Sonny Milano,L,WSH,28,82,15,27,42
3,8480865,Noah Dobson,D,NYI,24,82,14,28,42
3,8481542,Moritz Seider,D,DET,23,82,5,37,42
3,8475722,Jason Zucker,L,NSH,32,82,22,19,41
3,8482699,Dylan Guenther,R,ARI,21,82,22,19,41
3,8480015,Owen Tippett,R,PHI,25,82,21,20,41
3,8481560,Arthur Kaliyev,R,LAK,23,82,21,20,41
3,8480802,Ryan McLeod,C,EDM,25,82,19,22,41
3,8477456,J.T. Compher,L,DET,29,82,17,24,41
3,8482667,William Eklund,L,SJS,22,82,16,25,41
3,8482475,Yegor Chinakhov,R,CBJ,23,82,15,26,41
3,8482124,Quinton Byfield,R,LAK,22,82,14,27,41
3,8480028,Morgan Frost,C,PHI,25,82,14,27,41
3,8482110,Dawson Mercer,C,NJD,23,82,13,28,41
3,8476438,Brandon Saad,L,STL,32,82,24,16,40
3,8480009,Eeli Tolvanen,R,SEA,25,82,20,20,40
3,8478458,Jack Roslovic,C,NYR,27,82,19,21,40
3,8477998,Warren Foegele,L,EDM,28,82,19,21,40
3,8475714,Calle Jarnkrok,C,TOR,33,82,18,22,40
3,8476869,Brady Skjei,D,CAR,30,82,17,23,40
3,8482705,Cole Sillinger,C,CBJ,21,82,16,24,40
3,8479345,Jakob Chychrun,D,OTT,26,82,15,25,40
3,8478542,Evan Rodrigues,C,FLA,31,82,12,28,40
3,8481581,Thomas Harley,D,DAL,23,82,11,29,40
3,8476923,Damon Severson,D,CBJ,30,82,10,30,40
3,8475218,Mattias Ekholm,D,EDM,34,82,7,33,40
3,8478466,Daniel Sprong,R,DET,27,82,25,14,39
3,8477935,Sam Bennett,C,FLA,28,82,20,19,39
3,8481596,Shane Pinto,C,OTT,24,82,18,21,39
3,8484144,Connor Bedard,C,CHI,19,82,17,22,39
3,8480113,Alex Iafallo,L,WPG,31,82,16,23,39
3,8476480,Vladislav Namestnikov,C,WPG,32,82,16,23,39
3,8476872,Scott Laughton,C,PHI,30,82,14,25,39
3,8479425,Filip Hronek,D,VAN,27,82,13,26,39
3,8481546,Cam York,D,PHI,23,82,11,28,39
3,8477495,Seth Jones,D,CHI,30,82,9,30,39
3,8480043,Timothy Liljegren,D,TOR,25,82,7,32,39
3,8476925,Colton Sissons,C,NSH,31,82,21,17,38
3,8479400,Pierre-Luc Dubois,L,LAK,26,82,19,19,38
3,8478891,Mason Appleton,C,WPG,28,82,17,21,38
3,8477932,Aaron Ekblad,D,FLA,28,82,14,24,38
3,8479996,Cody Glass,C,NSH,25,82,14,24,38
3,8478463,Anthony Beauvillier,L,NSH,27,82,14,24,38
3,8477964,Ivan Barbashev,C,VGK,29,82,12,26,38
3,8471698,T.J. Oshie,R,WSH,38,82,12,26,38
3,8476292,Ondrej Palat,L,NJD,33,82,12,26,38
3,8476479,Phillip Danault,C,LAK,31,82,11,27,38
3,8477986,Brandon Montour,D,FLA,30,82,8,30,38
3,8482671,Owen Power,D,BUF,22,82,8,30,38
3,8474870,Tyler Johnson,C,CHI,34,82,22,15,37
3,8474641,Adam Henrique,C,EDM,34,82,21,16,37
3,8483515,Juraj Slafkovsky,L,MTL,20,82,18,19,37
3,8477497,Sean Monahan,C,WPG,30,82,12,25,37
3,8478462,Nicolas Roy,C,VGK,27,82,12,25,37
3,8477476,Artturi Lehkonen,L,COL,29,82,20,16,36
3,8480849,Barrett Hayton,C,ARI,24,82,19,17,36
3,8474102,David Perron,L,DET,36,82,16,20,36
3,8477952,Robby Fabbri,C,DET,28,82,16,20,36
3,8480078,Filip Chytil,C,NYR,25,82,11,25,36
3,8474149,Evgenii Dadonov,R,DAL,35,82,11,25,36
3,8483457,Lane Hutson,D,MTL,20,82,3,33,36
3,8483524,Shane Wright,C,SEA,20,82,24,11,35
3,8475151,Kyle Palmieri,C,NYI,33,82,22,13,35
3,8475799,Nino Niederreiter,R,WPG,32,82,20,15,35
3,8482175,JJ Peterka,R,BUF,22,82,17,18,35
3,8478233,Andrew Mangiapane,L,CGY,28,82,16,19,35
3,8477021,Alex Kerfoot,C,ARI,30,82,14,21,35
3,8475197,Tyson Barrie,D,NSH,33,82,14,21,35
3,8478413,Jordan Greenway,L,BUF,27,82,13,22,35
3,8477426,Nicholas Paul,L,TBL,29,82,11,24,35
3,8482105,Jake Sanderson,D,OTT,22,82,10,25,35
3,8477948,Travis Sanheim,D,PHI,28,82,4,31,35
3,8482101,Danil Gushchin,L,SJS,22,82,20,14,34
3,8482702,Logan Stankoven,C,DAL,21,82,19,15,34
3,8479423,Alex Nylander,L,CBJ,26,82,18,16,34
3,8479365,Trent Frederic,C,BOS,26,82,15,19,34
3,8475287,Erik Haula,L,NJD,33,82,14,20,34
3,8476392,Adam Lowry,C,WPG,31,82,13,21,34
3,8481711,Matias Maccelli,L,ARI,24,82,13,21,34
3,8474037,James van Riemsdyk,L,BOS,35,82,13,21,34
3,8478472,Mathieu Joseph,R,OTT,27,82,12,22,34
3,8482133,Thomas Bordeleau,C,SJS,22,82,12,22,34
3,8479987,Morgan Geekie,C,BOS,26,82,9,25,34
3,8474151,Ryan McDonagh,D,NSH,35,82,3,31,34
3,8481699,Aku Raty,R,ARI,23,82,0,34,34
3,8478474,Lawson Crouse,L,ARI,27,82,22,11,33
3,8476469,Joel Armia,R,MTL,31,82,20,13,33
3,8482222,Alexander Barabanov,L,SJS,30,82,17,16,33
3,8482079,Marco Rossi,C,MIN,23,82,16,17,33
3,8475793,Ryan Johansen,C,PHI,32,82,14,19,33
3,8480185,Eetu Luostarinen,C,FLA,26,82,12,21,33
3,8482624,Daniil Miromanov,D,CGY,27,82,12,21,33
3,8482720,Matthew Knies,L,TOR,22,82,10,23,33
3,8481013,Jonatan Berggren,R,DET,24,82,10,23,33
3,8480434,Sean Durzi,D,ARI,26,82,9,24,33
3,8478178,Darren Raddysh,D,TBL,28,82,9,24,33
3,8475763,Kevin Hayes,R,STL,32,82,8,25,33
3,8477969,Marcus Pettersson,D,PIT,28,82,7,26,33
3,8474673,TJ Brodie,D,TOR,34,82,6,27,33
3,8475848,Brendan Gallagher,R,MTL,32,82,18,14,32
3,8480281,Alexey Toropchenko,R,STL,25,82,14,18,32
3,8475343,Nic Dowd,C,WSH,34,82,13,19,32
3,8475760,Nick Bjugstad,C,ARI,32,82,13,19,32
3,8482055,Drew O'Connor,L,PIT,26,82,12,20,32
3,8478057,Dakota Joshua,C,VAN,28,82,11,21,32
3,8476979,Erik Gustafsson,D,NYR,32,82,9,23,32
3,8477511,Anthony Mantha,R,VGK,30,82,9,23,32
3,8479371,Dante Fabbro,D,NSH,26,82,5,27,32
3,8482122,Brock Faber,D,MIN,22,82,1,31,32
3,8483493,Frank Nazar,C,CHI,20,82,21,10,31
3,8482089,Jake Neighbours,L,STL,22,82,18,13,31
3,8473449,Kyle Okposo,R,FLA,36,82,15,16,31
3,8481580,Connor McMichael,C,WSH,23,82,14,17,31
3,8481601,Simon Holmstrom,R,NYI,23,82,13,18,31
3,8480220,Noah Cates,L,PHI,25,82,12,19,31
3,8477989,Christian Dvorak,C,MTL,28,82,10,21,31
3,8481656,Aliaksei Protas,C,WSH,23,82,8,23,31
3,8480871,Adam Boqvist,D,CBJ,24,82,5,26,31
3,8474716,Jared Spurgeon,D,MIN,35,82,1,30,31
3,8474189,Lars Eller,C,PIT,35,82,18,12,30
3,8478508,Yakov Trenin,C,COL,27,82,18,12,30
3,8479353,Brett Howden,C,VGK,26,82,14,16,30
3,8479525,Ross Colton,C,COL,28,82,13,17,30
3,8480448,Parker Kelly,L,OTT,25,82,13,17,30
3,8470621,Corey Perry,R,EDM,39,82,12,18,30
3,8484153,Leo Carlsson,C,ANA,20,82,12,18,30
3,8480893,Kirill Marchenko,R,CBJ,24,82,10,20,30
3,8476329,Travis Boyd,C,ARI,31,82,9,21,30
3,8480336,Sean Walker,D,COL,30,82,7,23,30
3,8479941,Justin Danforth,R,CBJ,31,82,16,13,29
3,8477330,Dominik Kubalik,L,OTT,29,82,15,14,29
3,8478020,Michael Amadio,C,VGK,28,82,14,15,29
3,8478115,Pierre Engvall,L,NYI,28,82,12,17,29
3,8479316,Luke Kunin,C,SJS,27,82,12,17,29
3,8475764,Cam Fowler,D,ANA,33,82,4,25,29
3,8482733,Logan Mailloux,D,MTL,31,82,3,26,29
3,8482118,Sam Colangelo,R,ANA,23,82,24,4,28
3,8480813,Joe Veleno,C,DET,24,82,12,16,28
3,8477919,Frederick Gaudreau,C,MIN,31,82,10,18,28
3,8478500,Ivan Provorov,D,CBJ,27,82,10,18,28
3,8476885,Jacob Trouba,D,NYR,30,82,8,20,28
3,8477494,Jonathan Drouin,L,COL,29,82,7,21,28
3,8477953,Kasperi Kapanen,R,STL,28,82,7,21,28
3,8482111,Justin Barron,D,MTL,23,82,7,21,28
3,8476892,Colton Parayko,D,STL,31,82,6,22,28
3,8482245,Artem Zub,D,OTT,29,82,5,23,28
3,8482142,Jamie Drysdale,D,PHI,22,82,5,23,28
3,8475179,Dmitry Kulikov,D,FLA,34,82,3,25,28
3,8481604,Pavel Dorofeyev,L,VGK,24,82,19,8,27
3,8481624,Ilya Mikheyev,R,VAN,30,82,17,10,27
3,8482259,Bobby McMann,C,TOR,28,82,14,13,27
3,8479591,Michael Eyssimont,C,TBL,28,82,13,14,27
3,8476419,Jean-Gabriel Pageau,C,NYI,32,82,12,15,27
3,8479346,Dillon Dube,C,CGY,26,82,12,15,27
3,8476960,Andreas Athanasiou,C,CHI,30,82,11,16,27
3,8484145,Zach Benson,L,BUF,19,82,11,16,27
3,8474884,Mike Hoffman,C,SJS,35,82,11,16,27
3,8476927,Teddy Blueger,C,VAN,30,82,9,18,27
3,8476897,Oskar Sundqvist,C,STL,30,82,8,19,27
3,8480873,Rasmus Sandin,D,WSH,24,82,7,20,27
3,8475462,Radko Gudas,D,ANA,34,82,7,20,27
3,8478038,Devon Toews,D,COL,30,82,6,21,27
3,8479398,Samuel Girard,D,COL,26,82,6,21,27
3,8476463,Jonas Brodin,D,MIN,31,82,5,22,27
3,8476854,Hampus Lindholm,D,BOS,30,82,4,23,27
3,8477944,Jakub Vrana,L,STL,28,82,19,7,26
3,8481535,Nils Hoglander,L,VAN,24,82,16,10,26
3,8481186,Logan O'Connor,R,COL,28,82,12,14,26
3,8482074,Connor Zary,C,CGY,23,82,12,14,26
3,8479415,Michael McLeod,C,NJD,26,82,9,17,26
3,8479992,Michael Rasmussen,C,DET,25,82,9,17,26
3,8473563,Nicklas Backstrom,C,WSH,37,82,9,17,26
3,8476891,Matt Grzelcyk,D,BOS,30,82,4,22,26
3,8479393,Noah Gregor,C,TOR,26,82,17,8,25
3,8479977,Kailer Yamamoto,R,SEA,26,82,13,12,25
3,8473533,Jordan Staal,C,CAR,36,82,11,14,25
3,8477450,Jason Dickinson,C,CHI,29,82,11,14,25
3,8478109,Victor Olofsson,L,BUF,29,82,9,16,25
3,8476871,Tanner Pearson,L,MTL,32,82,9,16,25
3,8478133,Jake Evans,C,MTL,28,82,7,18,25
3,8482712,Oskar Olausson,R,COL,22,82,7,18,25
3,8477498,Darnell Nurse,D,EDM,29,82,5,20,25
3,8480796,Martin Fehervary,D,WSH,25,82,5,20,25
3,8482087,Kaiden Guhle,D,MTL,22,82,4,21,25
3,8481606,Jordan Spence,D,LAK,23,82,4,21,25
3,8476931,Jake McCabe,D,TOR,31,82,4,21,25
3,8477506,Ryan Pulock,D,NYI,30,82,3,22,25
3,8476917,Adam Pelech,D,NYI,30,82,3,22,25
3,8476331,Dylan DeMelo,D,WPG,31,82,1,24,25
3,8476921,Jordan Martinook,L,CAR,32,82,12,12,24
3,8481554,Kaapo Kakko,R,NYR,23,82,12,12,24
3,8470604,Jeff Carter,C,PIT,39,82,10,14,24
3,8479390,Taylor Raddysh,R,CHI,26,82,9,15,24
3,8483505,Matthew Poitras,C,BOS,20,82,9,15,24
3,8479351,Sam Steel,C,DAL,26,82,8,16,24
3,8481028,Martin Pospisil,C,CGY,25,82,8,16,24
3,8475171,Oliver Ekman-Larsson,D,FLA,33,82,7,17,24
3,8482730,Brandt Clarke,D,LAK,21,82,7,17,24
3,8475790,Erik Gudbranson,D,CBJ,32,82,7,17,24
3,8475200,Dmitry Orlov,D,CAR,33,82,6,18,24
3,8478430,Oliver Kylington,D,CGY,27,82,6,18,24
3,8480058,Pierre-Olivier Joseph,D,PIT,25,82,6,18,24
3,8481537,Nikita Okhotiuk,D,CGY,24,82,5,19,24
3,8483499,Liam Ohgren,L,MIN,20,82,15,8,23
3,8481093,Rafael Harvey-Pinard,L,MTL,25,82,14,9,23
3,8470610,Zach Parise,L,COL,40,82,12,11,23
3,8481704,Juuso Parssinen,C,NSH,23,82,12,11,23
3,8476461,Sean Couturier,C,PHI,32,82,11,12,23
3,8481477,Nico Sturm,C,SJS,29,82,10,13,23
3,8483431,Logan Cooley,C,ARI,20,82,9,14,23
3,8477392,Hudson Fasching,R,NYI,29,82,9,14,23
3,8478882,Vladislav Gavrikov,D,LAK,29,82,9,14,23
3,8479980,Nicolas Hague,D,VGK,26,82,8,15,23
3,8475164,Jakob Silfverberg,R,ANA,34,82,8,15,23
3,8481522,Peyton Krebs,C,BUF,23,82,7,16,23
3,8480879,Jacob Bernard-Docker,D,OTT,24,82,7,16,23
3,8475149,Marcus Johansson,L,MIN,34,82,6,17,23
3,8478399,Jonas Siegenthaler,D,NJD,27,82,6,17,23
3,8480144,David Kampf,C,TOR,29,82,6,17,23
3,8476525,Colin Miller,D,WPG,32,82,6,17,23
3,8476312,Josh Manson,D,COL,33,82,5,18,23
3,8478851,Alexandre Carrier,D,NSH,28,82,5,18,23
3,8475181,Nick Leddy,D,STL,33,82,5,18,23
3,8479983,Mario Ferraro,D,SJS,26,82,5,18,23
3,8480145,Neal Pionk,D,WPG,29,82,4,19,23
3,8481014,Alexander Romanov,D,NYI,24,82,4,19,23
3,8475690,Chris Tanev,D,DAL,35,82,2,21,23
3,8478013,Jake Walman,D,DET,28,82,13,9,22
3,8483491,Ivan Miroshnichenko,L,WSH,20,82,9,13,22
3,8482062,Cole Smith,L,NSH,29,82,8,14,22
3,8482655,J.J. Moser,D,ARI,24,82,7,15,22
3,8480806,Isac Lundestrom,C,ANA,25,82,6,16,22
3,8477429,Andrew Copp,C,DET,30,82,5,17,22
3,8482073,Braden Schneider,D,NYR,23,82,5,17,22
3,8478859,Niko Mikkola,D,FLA,28,82,4,18,22
3,8476879,Cody Ceci,D,EDM,31,82,3,19,22
3,8480821,Filip Zadina,R,SJS,25,82,20,1,21
3,8479661,Tanner Jeannot,L,TBL,27,82,11,10,21
3,8483012,Logan Morrison,C,SEA,22,82,11,10,21
3,8482117,Lukas Reichel,L,CHI,22,82,9,12,21
3,8477425,Miles Wood,L,COL,29,82,9,12,21
3,8479359,Beck Malenstyn,L,WSH,26,82,9,12,21
3,8480855,Jack McBain,C,ARI,24,82,9,12,21
3,8480074,Alexandre Texier,C,CBJ,25,82,9,12,21
3,8478055,Gustav Forsling,D,FLA,28,82,8,13,21
3,8483495,Simon Nemec,D,NJD,20,82,8,13,21
3,8481481,Blake Lizotte,C,LAK,27,82,8,13,21
3,8475279,Ben Chiarot,D,DET,33,82,7,14,21
3,8476442,Matt Nieto,L,PIT,32,82,6,15,21
3,8476457,Adam Larsson,D,SEA,32,82,5,16,21
3,8480807,Mattias Samuelsson,D,BUF,24,82,5,16,21
3,8477488,Brett Pesce,D,CAR,30,82,4,17,21
3,8483490,Pavel Mintyukov,D,ANA,21,82,3,18,21
3,8480834,Ty Emberson,D,SJS,24,82,2,19,21
3,8481605,Jackson LaCombe,D,ANA,23,82,2,19,21
3,8475231,Casey Cizikas,C,NYI,33,82,11,9,20
3,8474715,Cam Atkinson,R,PHI,35,82,9,11,20
3,8481553,Bobby Brink,R,PHI,23,82,8,12,20
3,8476878,Zemgus Girgensons,L,BUF,30,82,8,12,20
3,8478507,John Marino,D,NJD,27,82,8,12,20
3,8476873,Mark Jankowski,C,NSH,30,82,7,13,20
3,8481567,Henry Thrun,D,SJS,23,82,7,13,20
3,8476374,Sean Kuraly,C,CBJ,31,82,7,13,20
3,8481703,Valtteri Puustinen,R,PIT,25,82,5,15,20
3,8480860,Kevin Bahl,D,NJD,24,82,5,15,20
3,8477931,Tomas Nosek,L,NJD,32,82,4,16,20
3,8475324,Nick Jensen,D,WSH,34,82,3,17,20
3,8484166,Adam Fantilli,C,CBJ,20,82,13,6,19
3,8479293,Brandon Tanev,L,SEA,33,82,11,8,19
3,8477839,Conor Sheary,L,TBL,32,82,11,8,19
3,8477406,Mattias Janmark,C,EDM,32,82,11,8,19
3,8476278,Colin Blackwell,C,CHI,31,82,7,12,19
3,8474034,Pat Maroon,L,BOS,36,82,7,12,19
3,8478911,Matt Roy,D,LAK,29,82,7,12,19
3,8477015,Connor Brown,R,EDM,30,82,7,12,19
3,8482803,Olen Zellweger,D,ANA,21,82,5,14,19
3,8475455,Brenden Dillon,D,WPG,34,82,4,15,19
3,8477435,Ryan Graves,D,PIT,29,82,3,16,19
3,8481524,Bowen Byram,D,BUF,23,82,3,16,19
3,8477505,Alexander Wennberg,C,NYR,30,82,3,16,19
3,8473507,Jeff Petry,D,DET,37,82,2,17,19
3,8479998,Mikey Anderson,D,LAK,25,82,2,17,19
3,8482125,Alexander Holtz,R,NJD,22,82,13,5,18
3,8478043,Sam Lafferty,C,VAN,29,82,11,7,18
3,8482809,Jackson Blake,R,CAR,21,82,11,7,18
3,8478569,Noel Acciari,C,PIT,33,82,8,10,18
3,8481517,Brett Leason,R,ANA,25,82,8,10,18
3,8473422,Nick Foligno,L,CHI,37,82,7,11,18
3,8478468,Jeremy Lauzon,D,NSH,27,82,6,12,18
3,8481178,Egor Zamula,D,PHI,24,82,4,14,18
3,8474574,Tyler Myers,D,VAN,34,82,4,14,18
3,8476902,Esa Lindell,D,DAL,30,82,3,15,18
3,8479369,Andrew Peeke,D,BOS,26,82,3,15,18
3,8479324,Ryan Lindgren,D,NYR,26,82,3,15,18
3,8483466,Kevin Korchinski,D,CHI,20,82,2,16,18
3,8479976,Juuso Valimaki,D,ARI,26,82,1,17,18
3,8478840,Will Borgen,D,SEA,28,82,1,17,18
3,8482145,Mavrik Bourque,C,DAL,22,82,12,5,17
3,8484203,Bradly Nadeau,L,CAR,19,82,9,8,17
3,8475220,Marcus Foligno,L,MIN,33,82,7,10,17
3,8477353,Tyler Motte,C,TBL,29,82,6,11,17
3,8478416,Erik Cernak,D,TBL,27,82,4,13,17
3,8477845,Trevor van Riemsdyk,D,WSH,33,82,4,13,17
3,8480246,Nick Perbix,D,TBL,26,82,2,15,17
3,8475233,David Savard,D,MTL,34,82,2,15,17
3,8483565,Nick Blankenburg,D,CBJ,26,82,1,16,17
3,8477034,Jaycob Megna,D,CHI,32,82,1,16,17
3,8482177,Marat Khusnutdinov,C,MIN,22,82,0,17,17
3,8480459,Pius Suter,C,VAN,28,82,9,7,16
3,8478136,Jake Middleton,D,MIN,28,82,8,8,16
3,8473453,Trevor Lewis,C,LAK,37,82,7,9,16
3,8478831,Kevin Stenlund,C,FLA,28,82,7,9,16
3,8477507,Nikita Zadorov,D,VAN,29,82,4,12,16
3,8475762,Derek Forbort,D,BOS,32,82,4,12,16
3,8483482,Tristan Luneau,D,ANA,20,82,4,12,16
3,8477335,Kyle Burroughs,D,SJS,29,82,4,12,16
3,8481059,Scott Perunovich,D,STL,26,82,3,13,16
3,8480817,K'Andre Miller,D,NYR,24,82,2,14,16
3,8481568,Alex Vlasic,D,CHI,23,82,2,14,16
3,8480172,Jan Rutta,D,SJS,34,82,2,14,16
3,8480035,Henri Jokiharju,D,BUF,25,82,1,15,16
3,8482737,Zack Bolduc,C,STL,21,82,13,2,15
3,8479514,Rem Pitlick,C,CHI,27,82,8,7,15
3,8478443,Brandon Carlo,D,BOS,28,82,8,7,15
3,8476822,Luke Glendening,C,TBL,35,82,8,7,15
3,8480980,Connor Dewar,C,TOR,25,82,7,8,15
3,8480068,Ryan Poehling,C,PHI,25,82,6,9,15
3,8476624,Barclay Goodrow,C,NYR,31,82,6,9,15
3,8477220,Nate Schmidt,D,WPG,33,82,3,12,15
3,8482807,Ethan Del Mastro,D,CHI,21,82,3,12,15
3,8470600,Ryan Suter,D,DAL,39,82,3,12,15
3,8482166,Shakir Mukhamadullin,D,SJS,22,82,3,12,15
3,8483763,Maksymilian Szuber,D,ARI,22,82,3,12,15
3,8480073,Erik Brannstrom,D,OTT,25,82,2,13,15
3,8475188,Brayden McNabb,D,VGK,33,82,2,13,15
3,8482155,Alex Laferriere,R,LAK,23,82,7,7,14
3,8477508,Curtis Lazar,C,NJD,29,82,5,9,14
3,8476467,Jamie Oleksiak,D,SEA,32,82,5,9,14
3,8480990,Declan Chisholm,D,MIN,24,82,5,9,14
3,8475208,Brian Dumoulin,D,SEA,33,82,4,10,14
3,8482679,Matt Coronato,R,CGY,22,82,4,10,14
3,8474166,Alec Martinez,D,VGK,37,82,2,12,14
3,8484911,Collin Graf,R,SJS,22,82,2,12,14
3,8476429,Scott Mayfield,D,NYI,32,82,0,14,14
3,8479383,Boris Katchouk,L,OTT,26,82,7,6,13
3,8479291,Kevin Rooney,C,CGY,31,82,7,6,13
3,8475842,Sam Carrick,C,EDM,32,82,6,7,13
3,8475177,Calvin de Haan,D,TBL,33,82,6,7,13
3,8482666,Scott Morrow,D,CAR,22,82,4,9,13
3,8477365,Connor Clifton,D,BUF,29,82,3,10,13
3,8476473,Connor Murphy,D,CHI,31,82,3,10,13
3,8476422,Mike Reilly,D,NYI,31,82,2,11,13
3,8482858,Ryker Evans,D,SEA,23,82,2,11,13
3,8475825,Jani Hakanpää,D,DAL,32,82,2,11,13
3,8478451,Ethan Bear,D,WSH,27,82,0,13,13
3,8476858,Phillip Di Giuseppe,L,VAN,31,82,6,6,12
3,8481578,Graeme Clarke,R,NJD,23,82,6,6,12
3,8477499,Rasmus Ristolainen,D,PHI,30,82,4,8,12
3,8474009,Nick Bonino,C,NYR,36,82,4,8,12
3,8482859,Zack Ostapchuk,C,OTT,21,82,4,8,12
3,8473504,Cal Clutterbuck,R,NYI,37,82,3,9,12
3,8474013,Ian Cole,D,VAN,35,82,1,11,12
3,8481599,Victor Soderstrom,D,ARI,23,82,5,6,11
3,8477369,Carson Soucy,D,VAN,30,82,4,7,11
3,8474567,Zach Bogosian,D,MIN,34,82,4,7,11
3,8470966,Mark Giordano,D,TOR,41,82,4,7,11
3,8482762,Simon Edvinsson,D,DET,21,82,3,8,11
3,8482470,Ilya Solovyov,D,CGY,24,82,2,9,11
3,8476915,Jujhar Khaira,L,MIN,30,82,6,4,10
3,8482713,Mackie Samoskevich,R,FLA,22,82,5,5,10
3,8482516,Matthew Kessel,D,STL,24,82,3,6,9
3,8479442,Troy Stecher,D,EDM,30,82,2,7,9
3,8481030,Jack St. Ivany,D,PIT,25,82,1,8,9
3,8476967,Brett Kulak,D,EDM,30,82,1,8,9
3,8483468,Jiri Kulich,C,BUF,20,82,3,5,8
3,8471677,Jack Johnson,D,COL,37,82,1,7,8
3,8483489,Fraser Minten,C,TOR,31,82,3,4,7
3,8478408,Travis Dermott,D,ARI,28,82,2,5,7
3,8476372,Nick Seeler,D,PHI,31,82,1,3,4
3,8484149,Gavin Brindley,C,CBJ,20,82,2,1,3
3,8482141,Lukas Cormier,D,VGK,22,0,0,0,0
3,8476988,Matt Benning,D,SJS,30,0,0,0,0
3,8480727,Zach Whitecloud,D,VGK,28,0,0,0,0
3,8480887,Jordan Harris,D,MTL,24,0,0,0,0
3,8478450,Parker Wotherspoon,D,BOS,27,0,0,0,0
3,8481812,Nikolai Knyzhov,D,SJS,27,0,0,0,0
3,8480001,Urho Vaakanainen,D,ANA,25,0,0,0,0
3,8482176,Wyatt Kaiser,D,CHI,22,0,0,0,0
3,8481122,Simon Benoit,D,TOR,26,0,0,0,0
3,8476441,Joel Edmundson,D,TOR,31,0,0,0,0
3,8480884,Calen Addison,D,SJS,24,0,0,0,0
3,8482511,Mason Lohrei,D,BOS,23,0,0,0,0
3,8482192,Isaak Phillips,D,CHI,23,0,0,0,0
3,8480950,Ilya Lyubushkin,D,TOR,30,0,0,0,0
3,8474031,Kevin Shattenkirk,D,BOS,35,0,0,0,0
3,8475718,Justin Holl,D,DET,32,0,0,0,0
3,8479402,Jake Bean,D,CBJ,26,0,0,0,0
3,8474602,Justin Schultz,D,SEA,34,0,0,0,0
3,8477950,Tony DeAngelo,D,CAR,29,0,0,0,0
3,8481743,Marc Del Gaizo,D,NSH,25,0,0,0,0
3,8481527,Kaedan Korczak,D,VGK,23,0,0,0,0
3,8480192,Johnathan Kovacevic,D,MTL,27,0,0,0,0
3,8476874,Olli Maatta,D,DET,30,0,0,0,0
3,8482144,Jack Thompson,D,SJS,22,0,0,0,0
3,8480222,Sebastian Aho,D,NYI,28,0,0,0,0
3,8479458,Nikita Zaitsev,D,CHI,33,0,0,0,0
3,8471709,Marc-Edouard Vlasic,D,SJS,37,0,0,0,0
3,8482929,Emil Lilleberg,D,TBL,23,0,0,0,0
3,8477018,Ben Hutton,D,VGK,31,0,0,0,0
3,8481056,Spencer Stastney,D,NSH,24,0,0,0,0
3,8481593,Jayden Struble,D,MTL,23,0,0,0,0
3,8479982,Conor Timmins,D,TOR,26,0,0,0,0
3,8474090,Brendan Smith,D,NJD,35,0,0,0,0
3,8482964,Arber Xhekaj,D,MTL,23,0,0,0,0
3,8480891,Michael Kesselring,D,ARI,24,0,0,0,0
3,8477938,Haydn Fleury,D,TBL,28,0,0,0,0
3,8481806,Louis Crevier,D,CHI,23,0,0,0,0
3,8471274,Alex Goligoski,D,MIN,39,0,0,0,0
3,8481600,Tobias Bjornfot,D,FLA,23,0,0,0,0
3,8475797,Jarred Tinordi,D,CHI,32,0,0,0,0
3,8481521,Ronnie Attard,D,PHI,25,0,0,0,0
3,8474612,Travis Hamonic,D,OTT,34,0,0,0,0
3,8479576,Vincent Desharnais,D,EDM,28,0,0,0,0
3,8480049,Dylan Samberg,D,WPG,25,0,0,0,0
3,8483619,Filip Roos,D,CHI,25,0,0,0,0
3,8474568,Luke Schenn,D,NSH,35,0,0,0,0
3,8480184,Gustav Lindstrom,D,ANA,26,0,0,0,0
3,8480070,Ian Mitchell,D,BOS,25,0,0,0,0
3,8480196,Jacob Bryson,D,BUF,27,0,0,0,0
3,8471686,Marc Staal,D,PHI,37,0,0,0,0
3,8477467,Gustav Olofsson,D,SEA,30,0,0,0,0
3,8478970,Jalen Chatfield,D,CAR,28,0,0,0,0
3,8479348,Kale Clague,D,BUF,26,0,0,0,0
3,8473446,Erik Johnson,D,PHI,36,0,0,0,0
3,8477462,Robert Hagg,D,ANA,29,0,0,0,0
3,8478454,Noah Juulsen,D,VAN,27,0,0,0,0
3,8477384,Josh Brown,D,ARI,30,0,0,0,0
3,8481708,Zac Jones,D,NYR,24,0,0,0,0
3,8481167,Brayden Pachal,D,CGY,25,0,0,0,0
3,8482067,Connor Mackey,D,NYR,28,0,0,0,0
3,8483460,David Jiricek,D,CBJ,21,0,0,0,0
3,8481701,Santeri Hatakka,D,NJD,23,0,0,0,0
3,8478021,William Lagesson,D,ANA,28,0,0,0,0
3,8477851,Jordan Oesterle,D,CGY,32,0,0,0,0
3,8478452,Caleb Jones,D,COL,27,0,0,0,0
3,8479984,Cal Foote,D,NJD,26,0,0,0,0
3,8479639,Dylan Coghlan,D,CAR,26,0,0,0,0
3,8480874,Adam Ginning,D,PHI,24,0,0,0,0
3,8479321,Lucas Johansen,D,WSH,27,0,0,0,0
3,8480878,Nils Lundkvist,D,DAL,24,0,0,0,0
3,8482165,Yan Kuznetsov,D,CGY,22,0,0,0,0
3,8484258,Sam Malinski,D,COL,26,0,0,0,0
3,8480157,Calle Rosen,D,STL,30,0,0,0,0
3,8484304,Uvis Balinskis,D,FLA,28,0,0,0,0
3,8479985,Cale Fleury,D,SEA,26,0,0,0,0
3,8479378,Logan Stanley,D,WPG,26,0,0,0,0
3,8477541,Dakota Mermis,D,MIN,30,0,0,0,0
3,8481609,Vladislav Kolyachonok,D,ARI,23,0,0,0,0
3,8480823,Alexander Alexeyev,D,WSH,25,0,0,0,0
3,8481679,Maxence Guenette,D,OTT,23,0,0,0,0
3,8481564,Ryan Johnson,D,BUF,23,0,0,0,0
3,8479376,Victor Mete,D,PHI,26,0,0,0,0
3,8484254,Akito Hirose,D,VAN,25,0,0,0,0
3,8482660,Kent Johnson,C,CBJ,22,0,0,0,0
3,8482149,Cole Perfetti,C,WPG,22,0,0,0,0
3,8477987,Ryan Donato,C,CHI,28,0,0,0,0
3,8475755,Alexander Petrovic,D,DAL,32,0,0,0,0
3,8477810,Joel Hanley,D,CGY,33,0,0,0,0
3,8474145,Robert Bortuzzo,D,NYI,35,0,0,0,0
3,8481161,Jake Christiansen,D,CBJ,25,0,0,0,0
3,8476884,Derrick Pouliot,D,DAL,30,0,0,0,0
3,8481716,Dmitri Voronkov,L,CBJ,24,0,0,0,0
3,8480084,Nick DeSimone,D,NJD,30,0,0,0,0
3,8475750,Jon Merrill,D,MIN,32,0,0,0,0
3,8479315,Joey Anderson,R,CHI,26,0,0,0,0
3,8478011,Louie Belpedio,D,PHI,28,0,0,0,0
3,8482451,Mikael Pyyhtia,L,CBJ,23,0,0,0,0
3,8481541,Samuel Bolduc,D,NYI,24,0,0,0,0
3,8482126,Emil Andrae,D,PHI,31,0,0,0,0
3,8474618,Marco Scandella,D,STL,34,0,0,0,0
3,8477244,Chad Ruhwedel,D,NYR,34,0,0,0,0
3,8477971,Andreas Englund,D,LAK,28,0,0,0,0
3,8480829,Jesperi Kotkaniemi,C,CAR,24,0,0,0,0
3,8479372,Josh Mahura,D,FLA,26,0,0,0,0
3,8482095,Tyler Kleven,D,OTT,22,0,0,0,0
3,8481719,Maxwell Crozier,D,TBL,24,0,0,0,0
3,8475855,Jesper Fast,R,CAR,33,0,0,0,0
3,8480848,Ty Dellandrea,C,DAL,24,0,0,0,0
3,8475193,Tomas Tatar,L,SEA,34,0,0,0,0
3,8476889,Radek Faksa,C,DAL,30,0,0,0,0
3,8478495,Denis Gurianov,R,PHI,27,0,0,0,0
3,8480216,Jacob Peterson,C,SJS,25,0,0,0,0
3,8480252,Cole Guttman,C,CHI,25,0,0,0,0
3,8479026,Philippe Myers,D,TBL,27,0,0,0,0
3,8481006,Tyler Tucker,D,STL,24,0,0,0,0
3,8481032,Paul Cotter,C,VGK,25,0,0,0,0
3,8481577,Philip Tomasino,C,NSH,23,0,0,0,0
3,8476918,Jimmy Vesey,L,NYR,31,0,0,0,0
3,8479320,Max Lajoie,D,TOR,27,0,0,0,0
3,8478017,Mark Friedman,D,VAN,29,0,0,0,0
3,8481754,Nikita Nesterenko,C,ANA,23,0,0,0,0
3,8483407,Brandon Scanlin,D,NYR,25,0,0,0,0
3,8482659,Josh Doan,R,ARI,22,0,0,0,0
3,8477446,Michael McCarron,R,NSH,29,0,0,0,0
3,8477903,Garnet Hathaway,R,PHI,33,0,0,0,0
3,8482153,Brendan Brisson,C,VGK,23,0,0,0,0
3,8483546,Marshall Rifai,D,TOR,26,0,0,0,0
3,8484287,Cole McWard,D,VAN,23,0,0,0,0
3,8478854,Ryan Shea,D,PIT,27,0,0,0,0
3,8481585,Egor Afanasyev,L,NSH,23,0,0,0,0
3,8483398,Declan Carlile,D,TBL,31,0,0,0,0
3,8478502,Dennis Gilbert,D,CGY,28,0,0,0,0
3,8482749,Joshua Roy,R,MTL,21,0,0,0,0
3,8481598,Philip Broberg,D,EDM,23,0,0,0,0
3,8480835,Jack Drury,C,CAR,24,0,0,0,0
3,8480748,Kiefer Sherwood,L,NSH,29,0,0,0,0
3,8476934,Brock McGinn,L,ANA,30,0,0,0,0
3,8480870,Bo Groulx,C,ANA,24,0,0,0,0
3,8479368,Max Jones,L,ANA,26,0,0,0,0
3,8478099,Kevin Labanc,R,SJS,29,0,0,0,0
3,8478067,Oskar Lindblom,L,SJS,28,0,0,0,0
3,8476393,Nick Cousins,C,FLA,31,0,0,0,0
3,8483395,Arshdeep Bains,L,VAN,23,0,0,0,0
3,8480762,Eric Robinson,L,BUF,29,0,0,0,0
3,8479439,Jacob MacDonald,D,SJS,31,0,0,0,0
3,8476474,Stefan Noesen,R,CAR,31,0,0,0,0
3,8482787,Nikita Chibrikov,R,WPG,31,0,0,0,0
3,8478432,Christian Fischer,R,DET,27,0,0,0,0
3,8477979,Nicolas Aube-Kubel,R,WSH,28,0,0,0,0
3,8481789,Tye Kartye,L,SEA,23,0,0,0,0
3,8479330,Brandon Gignac,C,MTL,27,0,0,0,0
3,8480075,Cameron Crotty,D,ARI,25,0,0,0,0
3,8473473,Milan Lucic,L,BOS,36,0,0,0,0
3,8482094,Daemon Hunt,D,MIN,22,0,0,0,0
3,8481206,John Ludvig,D,PIT,24,0,0,0,0
3,8483630,Pavol Regenda,L,ANA,25,0,0,0,0
3,8481617,Vasily Podkolzin,R,VAN,23,0,0,0,0
3,8480306,Grant Hutton,D,NYI,29,0,0,0,0
3,8480995,Pontus Holmberg,R,TOR,25,0,0,0,0
3,8482148,Hendrix Lapierre,C,WSH,22,0,0,0,0
3,8477478,William Carrier,L,VGK,30,0,0,0,0
3,8480003,Jesper Boqvist,C,BOS,26,0,0,0,0
3,8482172,Landon Slaggert,L,CHI,22,0,0,0,0
3,8480789,Oliver Wahlstrom,R,NYI,24,0,0,0,0
3,8474062,Riley Nash,C,NYR,35,0,0,0,0
3,8480021,Jack Studnicka,C,SJS,25,0,0,0,0
3,8480025,MacKenzie Entwistle,R,CHI,25,0,0,0,0
3,8481582,Nicholas Robertson,L,TOR,23,0,0,0,0
3,8476867,Brendan Gaunce,C,CBJ,30,0,0,0,0
3,8479619,Michael Carcone,L,ARI,28,0,0,0,0
3,8479370,Tyson Jost,C,BUF,26,0,0,0,0
3,8479671,Mathieu Olivier,R,CBJ,27,0,0,0,0
3,8476994,Vinnie Hinostroza,C,PIT,30,0,0,0,0
3,8482070,Mitchell Chaffee,R,TBL,26,0,0,0,0
3,8477473,Justin Bailey,R,SJS,29,0,0,0,0
3,8479344,Jesse Puljujarvi,R,PIT,26,0,0,0,0
3,8480205,Emil Bemstrom,C,PIT,25,0,0,0,0
3,8479718,Alex Barré-Boulet,C,TBL,27,0,0,0,0
3,8482061,Brandon Biro,L,BUF,26,0,0,0,0
3,8479638,Justin Brazeau,R,BOS,26,0,0,0,0
3,8474040,Sam Gagner,C,EDM,35,0,0,0,0
3,8477846,Ryan Carpenter,C,SJS,33,0,0,0,0
3,8482077,Dylan Holloway,L,EDM,23,0,0,0,0
3,8482157,Will Cuylle,L,NYR,22,0,0,0,0
3,8480007,Jonas Rondbjerg,R,VGK,25,0,0,0,0
3,8478874,Adam Gaudette,C,STL,28,0,0,0,0
3,8478434,Keegan Kolesar,R,VGK,27,0,0,0,0
3,8480441,Trey Fix-Wolansky,R,CBJ,25,0,0,0,0
3,8479994,Jaret Anderson-Dolan,C,NSH,25,0,0,0,0
3,8483567,Georgii Merkulov,C,BOS,24,0,0,0,0
3,8477380,Jonny Brodzinski,C,NYR,31,0,0,0,0
3,8482201,Gage Goncalves,C,TBL,23,0,0,0,0
3,8478211,Dryden Hunt,L,CGY,29,0,0,0,0
3,8471699,Andrew Cogliano,C,COL,37,0,0,0,0
3,8479421,Jacob Moverare,D,LAK,26,0,0,0,0
3,8478881,Brett Seney,L,CHI,28,0,0,0,0
3,8477464,Nic Petan,C,MIN,29,0,0,0,0
3,8475958,Michael Sgarbossa,C,WSH,32,0,0,0,0
3,8481147,Reese Johnson,C,CHI,26,0,0,0,0
3,8479336,Carl Grundstrom,R,LAK,27,0,0,0,0
3,8480853,Liam Foudy,C,NSH,24,0,0,0,0
3,8479522,Hardy Haman Aktell,D,WSH,26,0,0,0,0
3,8481462,Mason Morelli,L,VGK,28,0,0,0,0
3,8482102,Vasily Ponomarev,C,CAR,22,0,0,0,0
3,8480844,Grigori Denisenko,L,VGK,24,0,0,0,0
3,8479944,Zach Aston-Reese,C,DET,30,0,0,0,0
3,8482784,Zach Dean,C,STL,21,0,0,0,0
3,8479419,Brett Murray,L,BUF,26,0,0,0,0
3,8479520,Brandon Duhaime,R,COL,27,0,0,0,0
3,8477573,Nathan Walker,L,STL,30,0,0,0,0
3,8478078,Rourke Chartier,C,OTT,28,0,0,0,0
3,8475795,Dylan McIlrath,D,WSH,32,0,0,0,0
3,8482496,Nils Aman,C,VAN,24,0,0,0,0
3,8480289,Morgan Barron,C,WPG,26,0,0,0,0
3,8481751,Lukas Rousek,R,BUF,25,0,0,0,0
3,8480011,Klim Kostin,C,SJS,25,0,0,0,0
3,8481556,John Beecher,C,BOS,23,0,0,0,0
3,8475278,Byron Froese,C,VGK,33,0,0,0,0
3,8475225,Craig Smith,C,DAL,35,0,0,0,0
3,8484326,Patrik Koch,D,ARI,28,0,0,0,0
3,8477930,Pierre-Edouard Bellemare,L,SEA,39,0,0,0,0
3,8478409,Anthony Richard,C,BOS,28,0,0,0,0
3,8481024,Linus Karlsson,C,VAN,25,0,0,0,0
3,8479986,Kole Lind,R,SEA,26,0,0,0,0
3,8479414,Nathan Bastian,R,NJD,27,0,0,0,0
3,8479362,Riley Tufte,L,COL,26,0,0,0,0
3,8481058,Jesse Ylönen,R,MTL,25,0,0,0,0
3,8482476,Emil Heineman,L,MTL,23,0,0,0,0
3,8482861,Vincent Iorio,D,WSH,22,0,0,0,0
3,8483432,Luca Del Bel Belluz,C,CBJ,31,0,0,0,0
3,8482744,James Malatesta,L,CBJ,21,0,0,0,0
3,8477887,Patrick Brown,C,BOS,32,0,0,0,0
3,8478585,Derek Ryan,C,EDM,38,0,0,0,0
3,8481441,Joe Snively,C,WSH,28,0,0,0,0
3,8481592,Jakob Pelletier,L,CGY,23,0,0,0,0
3,8482634,Alex Steeves,C,TOR,25,0,0,0,0
3,8477126,Jayson Megna,C,BOS,34,0,0,0,0
3,8475752,Tyler Pitlick,C,NYR,33,0,0,0,0
3,8480008,Adam Ruzicka,C,ARI,25,0,0,0,0
3,8481065,Angus Crookshank,L,OTT,25,0,0,0,0
3,8479547,Matthew Phillips,R,WSH,26,0,0,0,0
3,8480226,Marián Studenic,R,SEA,26,0,0,0,0
3,8481237,Kyle MacLean,C,NYI,25,0,0,0,0
3,8475413,Justin Dowling,C,NJD,34,0,0,0,0
3,8481641,Joel Kiviranta,L,COL,28,0,0,0,0
3,8478104,Sammy Blais,L,STL,28,0,0,0,0
3,8477454,Adam Erne,L,EDM,29,0,0,0,0
3,8481518,Nolan Foote,L,NJD,24,0,0,0,0
3,8480245,Olle Lycksell,R,PHI,25,0,0,0,0
3,8483570,Ben Meyers,C,ANA,26,0,0,0,0
3,8480776,Sheldon Rempal,R,VGK,29,0,0,0,0
3,8483920,Pierrick Dube,R,WSH,23,0,0,0,0
3,8480267,Sammy Walker,C,MIN,25,0,0,0,0
3,8482747,Brennan Othmann,L,NYR,21,0,0,0,0
3,8479991,Jake Leschyshyn,C,NYR,25,0,0,0,0
3,8478400,Colin White,C,MTL,27,0,0,0,0
3,8479328,Julien Gauthier,R,NYI,27,0,0,0,0
3,8484325,Waltteri Merela,C,TBL,26,0,0,0,0
3,8479066,Ryan Lomberg,L,FLA,30,0,0,0,0
3,8477070,Liam O'Brien,C,ARI,30,0,0,0,0
3,8478146,Matthew Highmore,C,OTT,28,0,0,0,0
3,8478028,Fredrik Olofsson,L,COL,28,0,0,0,0
3,8480880,Jakub Lauko,C,BOS,24,0,0,0,0
3,8479968,Vinni Lettieri,C,MIN,29,0,0,0,0
3,8474709,Matt Martin,L,NYI,35,0,0,0,0
3,8480845,Rasmus Kupari,C,WPG,24,0,0,0,0
3,8481550,Adam Beckman,L,MIN,23,0,0,0,0
3,8481422,Jacob Lucchini,C,MIN,29,0,0,0,0
3,8477401,John Hayden,C,SEA,29,0,0,0,0
3,8478904,Steven Lorentz,C,FLA,28,0,0,0,0
3,8482088,Justin Sourdif,R,FLA,22,0,0,0,0
3,8482751,Ryan Winterton,C,SEA,21,0,0,0,0
3,8482241,Radim Zohorna,L,PIT,28,0,0,0,0
3,8481690,Tyler Angle,C,CBJ,24,0,0,0,0
3,8476952,Dominic Toninato,C,WPG,30,0,0,0,0
3,8476919,Chris Tierney,C,NJD,30,0,0,0,0
3,8480032,Shane Bowers,C,NJD,25,0,0,0,0
3,8484314,Jiri Smejkal,L,OTT,28,0,0,0,0
3,8481239,Samuel Fagemo,L,LAK,24,0,0,0,0
3,8481532,Alex Turcotte,C,LAK,23,0,0,0,0
3,8481019,David Gustafsson,C,WPG,24,0,0,0,0
3,8478477,Mitchell Stephens,C,MTL,27,0,0,0,0
3,8479546,Oskar Steen,C,BOS,26,0,0,0,0
3,8480292,Carson Meyer,R,CBJ,27,0,0,0,0
3,8478446,Glenn Gawdin,C,ANA,27,0,0,0,0
3,8483531,Brian Halonen,L,NJD,25,0,0,0,0
3,8477149,Scott Sabourin,R,SJS,32,0,0,0,0
3,8479972,Mason Shaw,C,MIN,26,0,0,0,0
3,8480890,Jan Jenik,R,ARI,24,0,0,0,0
3,8478051,Max Willman,C,NJD,29,0,0,0,0
3,8480851,Akil Thomas,C,LAK,24,0,0,0,0
3,8482765,Isak Rosen,R,BUF,21,0,0,0,0
3,8478421,A.J. Greer,L,CGY,28,0,0,0,0
3,8478512,Austin Czarnik,C,DET,32,0,0,0,0
3,8479536,Axel Jonsson-Fjallby,L,WPG,26,0,0,0,0
3,8477320,Anton Blidh,L,NYR,29,0,0,0,0
3,8481543,Nikita Alexandrov,C,STL,24,0,0,0,0
3,8475235,Nicolas Deslauriers,L,PHI,33,0,0,0,0
3,8481070,Hugh McGing,L,STL,26,0,0,0,0
3,8480836,Jonathan Gruden,C,PIT,24,0,0,0,0
3,8481591,Sam Poulin,R,PIT,23,0,0,0,0
3,8477962,Brendan Lemieux,L,CAR,28,0,0,0,0
3,8483401,Marc Johnstone,R,PIT,28,0,0,0,0
3,8482250,Callahan Burke,C,CAR,27,0,0,0,0
3,8481726,Adam Edstrom,C,NYR,24,0,0,0,0
3,8471817,Ryan Reaves,R,TOR,37,0,0,0,0
3,8479587,Rhett Gardner,C,PHI,28,0,0,0,0
3,8475766,Austin Watson,L,TBL,32,0,0,0,0
3,8479367,William Lockwood,R,FLA,26,0,0,0,0
3,8478424,Jansen Harkins,C,PIT,27,0,0,0,0
3,8476913,Devin Shore,C,SEA,30,0,0,0,0
3,8482652,Walker Duehr,R,CGY,27,0,0,0,0
3,8477527,Ross Johnston,L,ANA,30,0,0,0,0
3,8481077,John Leonard,L,ARI,26,0,0,0,0
3,8483549,Lucas Condotta,L,MTL,27,0,0,0,0
3,8480468,James Hamblin,L,EDM,25,0,0,0,0
3,8476907,Mackenzie MacEachern,L,STL,30,0,0,0,0
3,8479543,Michael Pezzetta,L,MTL,26,0,0,0,0
3,8480355,Mark Kastelic,C,OTT,25,0,0,0,0
3,8482162,Roby Jarventie,L,OTT,22,0,0,0,0
3,8479772,Zack MacEwen,R,OTT,28,0,0,0,0
3,8483597,Milos Kelemen,L,ARI,25,0,0,0,0
3,8479379,Givani Smith,R,SJS,26,0,0,0,0
3,8481655,Cole Schwindt,R,CGY,23,0,0,0,0
3,8479981,Jonah Gadjovich,L,FLA,26,0,0,0,0
3,8482147,Jean-Luc Foudy,C,COL,22,0,0,0,0
3,8484255,Jason Polin,R,COL,25,0,0,0,0
3,8477993,Justin Kirkland,C,ARI,28,0,0,0,0
3,8479249,Andrew Poturalski,C,SEA,30,0,0,0,0
3,8482197,Adam Raska,R,MIN,23,0,0,0,0
3,8475780,Chris Wagner,R,COL,33,0,0,0,0
3,8479533,Joona Koppanen,L,PIT,26,0,0,0,0
3,8481534,Raphael Lavoie,C,EDM,24,0,0,0,0
3,8484321,Nikolas Matinpalo,D,OTT,26,0,0,0,0
3,8481043,Cole Koepke,L,TBL,26,0,0,0,0
3,8476323,Max McCormick,L,SEA,32,0,0,0,0
3,8483609,Adam Klapka,R,CGY,24,0,0,0,0
3,8483512,Matt Savoie,C,BUF,20,0,0,0,0
3,8484259,Ondrej Pavel,C,COL,31,0,0,0,0
3,8478147,Bokondji Imama,L,OTT,28,0,0,0,0
3,8482460,Matt Rempe,C,NYR,22,0,0,0,0
3,8477073,Kurtis MacDermid,L,NJD,30,0,0,0,0
3,8480274,Philip Kemp,D,EDM,25,0,0,0,0
3,8478956,Samuel Laberge,L,NJD,27,0,0,0,0
3,8483045,Cameron Butler,R,CBJ,31,0,0,0,0
4,8479318,Auston Matthews,C,TOR,27,82,63,56,119
4,8476453,Nikita Kucherov,R,TBL,31,82,36,73,109
4,8477492,Nathan MacKinnon,C,COL,29,82,40,63,103
4,8478402,Connor McDavid,C,EDM,27,82,31,69,100
4,8474600,Roman Josi,D,NSH,34,82,25,75,100
4,8477956,David Pastrnak,R,BOS,28,82,43,56,99
4,8478550,Artemi Panarin,L,NYR,33,82,31,67,98
4,8477934,Leon Draisaitl,C,EDM,29,82,40,56,96
4,8480027,Jason Robertson,L,DAL,25,82,35,61,96
4,8479323,Adam Fox,D,NYR,26,82,14,81,95
4,8478864,Kirill Kaprizov,L,MIN,27,82,47,47,94
4,8476887,Filip Forsberg,L,NSH,30,82,48,45,93
4,8480801,Brady Tkachuk,L,OTT,25,82,53,39,92
4,8476468,J.T. Miller,C,VAN,31,82,29,60,89
4,8477493,Aleksander Barkov,C,FLA,29,82,26,63,89
4,8480069,Cale Makar,D,COL,26,82,15,73,88
4,8478420,Mikko Rantanen,R,COL,28,82,47,38,85
4,8481559,Jack Hughes,C,NJD,23,82,28,55,83
4,8478445,Mathew Barzal,C,NYI,27,82,23,60,83
4,8477939,William Nylander,R,TOR,28,82,35,46,81
4,8473419,Brad Marchand,L,BOS,36,82,29,52,81
4,8476454,Ryan Nugent-Hopkins,C,EDM,31,82,26,55,81
4,8480012,Elias Pettersson,C,VAN,26,82,33,46,79
4,8474564,Steven Stamkos,C,TBL,34,82,39,39,78
4,8478403,Jack Eichel,C,VGK,28,82,30,48,78
4,8479314,Matthew Tkachuk,L,FLA,27,82,29,49,78
4,8477933,Sam Reinhart,C,FLA,29,82,45,32,77
4,8476459,Mika Zibanejad,C,NYR,31,82,39,38,77
4,8478439,Travis Konecny,R,PHI,27,82,33,44,77
4,8471675,Sidney Crosby,C,PIT,37,82,27,49,76
4,8477402,Pavel Buchnevich,L,STL,29,82,39,35,74
4,8475786,Zach Hyman,L,EDM,32,82,39,35,74
4,8475754,Brock Nelson,C,NYI,33,82,41,32,73
4,8477404,Jake Guentzel,C,CAR,30,82,40,33,73
4,8475166,John Tavares,C,TOR,34,82,36,36,72
4,8475692,Mats Zuccarello,R,MIN,37,82,26,46,72
4,8473512,Claude Giroux,R,OTT,36,82,22,50,72
4,8480800,Quinn Hughes,D,VAN,25,82,12,60,72
4,8476539,Jonathan Marchessault,R,VGK,34,82,34,37,71
4,8475172,Nazem Kadri,C,CGY,34,82,26,45,71
4,8475913,Mark Stone,R,VGK,32,82,26,45,71
4,8478427,Sebastian Aho,C,CAR,27,82,33,37,70
4,8477501,Valeri Nichushkin,R,COL,29,82,30,40,70
4,8481557,Matt Boldy,L,MIN,23,82,28,42,70
4,8480023,Robert Thomas,C,STL,25,82,16,54,70
4,8478414,Timo Meier,R,NJD,28,82,28,41,69
4,8477942,Kevin Fiala,L,LAK,28,82,20,49,69
4,8476456,Jonathan Huberdeau,C,CGY,31,82,15,54,69
4,8479420,Tage Thompson,C,BUF,27,82,32,36,68
4,8480830,Andrei Svechnikov,R,CAR,24,82,31,37,68
4,8482740,Wyatt Johnston,C,DAL,21,82,30,38,68
4,8482116,Tim Stützle,C,OTT,22,82,23,45,68
4,8477409,Carter Verhaeghe,C,FLA,29,82,34,33,67
4,8478010,Brayden Point,C,TBL,28,82,30,37,67
4,8478493,Joel Eriksson Ek,C,MIN,27,82,28,39,67
4,8479343,Clayton Keller,R,ARI,26,82,33,33,66
4,8481540,Cole Caufield,R,MTL,23,82,33,33,66
4,8475810,Bryan Rust,R,PIT,32,82,30,36,66
4,8476389,Vincent Trocheck,C,NYR,31,82,29,37,66
4,8471685,Anze Kopitar,C,LAK,37,82,23,43,66
4,8475168,Matt Duchene,C,DAL,33,82,30,35,65
4,8471215,Evgeni Malkin,C,PIT,38,82,29,36,65
4,8481528,Dylan Cozens,C,BUF,23,82,23,42,65
4,8475184,Chris Kreider,L,NYR,33,82,33,31,64
4,8475784,Jeff Skinner,C,BUF,32,82,26,38,64
4,8478047,Michael Bunting,L,PIT,29,82,24,40,64
4,8480865,Noah Dobson,D,NYI,24,82,12,52,64
4,8475158,Ryan O'Reilly,C,NSH,33,82,26,37,63
4,8476460,Mark Scheifele,C,WPG,31,82,25,38,63
4,8477960,Adrian Kempe,R,LAK,28,82,33,29,62
4,8471214,Alex Ovechkin,L,WSH,39,82,33,29,62
4,8479407,Jesper Bratt,L,NJD,26,82,27,35,62
4,8477955,Jared McCann,L,SEA,28,82,27,35,62
4,8478042,Viktor Arvidsson,R,LAK,31,82,22,40,62
4,8470794,Joe Pavelski,C,DAL,40,82,22,40,62
4,8475167,Victor Hedman,D,TBL,34,82,11,51,62
4,8477946,Dylan Larkin,C,DET,28,82,32,29,61
4,8478873,Troy Terry,R,ANA,27,82,27,34,61
4,8475765,Vladimir Tarasenko,R,FLA,33,82,23,38,61
4,8478233,Andrew Mangiapane,L,CGY,28,82,23,38,61
4,8480018,Nick Suzuki,C,MTL,25,82,22,39,61
4,8475794,Tyler Seguin,C,DAL,32,82,22,39,61
4,8480839,Rasmus Dahlin,D,BUF,24,82,20,41,61
4,8478440,Dylan Strome,C,WSH,27,82,19,42,61
4,8477504,Josh Morrissey,D,WPG,29,82,11,50,61
4,8477500,Bo Horvat,C,NYI,29,82,31,29,60
4,8477451,Ryan Hartman,R,MIN,30,82,27,33,60
4,8481533,Trevor Zegras,C,ANA,23,82,22,38,60
4,8478398,Kyle Connor,L,WPG,28,82,32,27,59
4,8477949,Alex Tuch,R,BUF,28,82,18,41,59
4,8483808,Andrei Kuzmenko,L,CGY,28,82,26,32,58
4,8480015,Owen Tippett,R,PHI,25,82,23,35,58
4,8482665,Matty Beniers,C,SEA,22,82,22,36,58
4,8481523,Kirby Dach,C,MTL,23,82,14,44,58
4,8477496,Elias Lindholm,C,VAN,30,82,28,29,57
4,8482093,Seth Jarvis,C,CAR,22,82,21,36,57
4,8482097,Jack Quinn,R,BUF,23,82,19,38,57
4,8477951,Nick Schmaltz,C,ARI,28,82,18,39,57
4,8475191,Reilly Smith,R,PIT,33,82,18,39,57
4,8477447,Shea Theodore,D,VGK,29,82,7,50,57
4,8481068,Yegor Sharangovich,C,CGY,26,82,26,30,56
4,8478444,Brock Boeser,R,VAN,27,82,25,31,56
4,8482078,Lucas Raymond,L,DET,22,82,23,33,56
4,8474141,Patrick Kane,R,DET,36,82,16,40,56
4,8482124,Quinton Byfield,R,LAK,22,82,15,41,56
4,8478397,Rasmus Andersson,D,CGY,28,82,14,42,56
4,8480031,Maxime Comtois,L,CAR,25,82,11,45,56
4,8476853,Morgan Rielly,D,TOR,30,82,8,48,56
4,8478407,Vince Dunn,D,SEA,28,82,8,48,56
4,8476432,Boone Jenner,C,CBJ,31,82,27,28,55
4,8482745,Mason McTavish,C,ANA,21,82,23,32,55
4,8474150,Mikael Backlund,C,CGY,35,82,17,38,55
4,8479325,Charlie McAvoy,D,BOS,27,82,10,45,55
4,8476399,Blake Coleman,C,CGY,33,82,29,25,54
4,8476448,William Karlsson,C,VGK,31,82,25,29,54
4,8475798,Mikael Granlund,C,SJS,32,82,20,34,54
4,8473994,Jamie Benn,L,DAL,35,82,20,34,54
4,8474578,Erik Karlsson,D,PIT,34,82,10,44,54
4,8476462,Dougie Hamilton,D,NJD,31,82,21,32,53
4,8478856,Conor Garland,R,VAN,28,82,19,34,53
4,8482684,Luke Hughes,D,NJD,21,82,14,39,53
4,8480185,Eetu Luostarinen,C,FLA,26,82,21,31,52
4,8480039,Martin Necas,C,CAR,25,82,20,32,52
4,8475726,Tyler Toffoli,C,WPG,32,82,28,23,51
4,8477476,Artturi Lehkonen,L,COL,29,82,26,25,51
4,8478366,Frank Vatrano,R,ANA,30,82,25,26,51
4,8478449,Roope Hintz,C,DAL,28,82,23,28,51
4,8480002,Nico Hischier,C,NJD,25,82,21,30,51
4,8475793,Ryan Johansen,C,PHI,32,82,18,33,51
4,8476419,Jean-Gabriel Pageau,C,NYI,32,82,18,33,51
4,8483397,Marc McLaughlin,C,BOS,25,82,45,5,50
4,8475151,Kyle Palmieri,C,NYI,33,82,27,23,50
4,8474157,Max Pacioretty,L,WSH,36,82,23,27,50
4,8477935,Sam Bennett,C,FLA,28,82,22,28,50
4,8476438,Brandon Saad,L,STL,32,82,21,29,50
4,8478975,Mason Marchment,L,DAL,29,82,20,30,50
4,8475170,Brayden Schenn,C,STL,33,82,19,31,50
4,8478401,Pavel Zacha,C,BOS,27,82,18,32,50
4,8476882,Teuvo Teravainen,L,CAR,30,82,17,33,50
4,8477940,Nikolaj Ehlers,L,WPG,28,82,16,34,50
4,8478460,Zach Werenski,D,CBJ,27,82,15,35,50
4,8480803,Evan Bouchard,D,EDM,25,82,14,36,50
4,8474565,Alex Pietrangelo,D,VGK,34,82,13,37,50
4,8477986,Brandon Montour,D,FLA,30,82,12,38,50
4,8476905,Chandler Stephenson,C,VGK,30,82,11,39,50
4,8474590,John Carlson,D,WSH,34,82,9,41,50
4,8479400,Pierre-Luc Dubois,L,LAK,26,82,25,24,49
4,8475722,Jason Zucker,L,NSH,32,82,24,25,49
4,8475768,Jaden Schwartz,C,SEA,32,82,23,26,49
4,8478438,Tommy Novak,C,NSH,27,82,22,27,49
4,8479675,Trevor Moore,L,LAK,29,82,21,28,49
4,8477498,Darnell Nurse,D,EDM,29,82,16,33,49
4,8479999,Casey Mittelstadt,C,COL,26,82,11,38,49
4,8471724,Kris Letang,D,PIT,37,82,11,38,49
4,8482109,Alexis Lafrenière,L,NYR,23,82,27,21,48
4,8474586,Jordan Eberle,R,SEA,34,82,22,26,48
4,8479337,Alex DeBrincat,R,DET,27,82,19,29,48
4,8479339,Patrik Laine,L,CBJ,26,82,18,30,48
4,8477444,Andre Burakovsky,L,SEA,29,82,17,31,48
4,8476458,Ryan Strome,C,ANA,31,82,13,35,48
4,8475791,Taylor Hall,L,CHI,33,82,20,27,47
4,8479542,Brandon Hagel,L,TBL,26,82,18,29,47
4,8478458,Jack Roslovic,C,NYR,27,82,18,29,47
4,8478542,Evan Rodrigues,C,FLA,31,82,12,35,47
4,8481581,Thomas Harley,D,DAL,23,82,7,40,47
4,8475169,Evander Kane,L,EDM,33,82,25,21,46
4,8482175,JJ Peterka,R,BUF,22,82,22,24,46
4,8473986,Alex Killorn,L,ANA,35,82,17,29,46
4,8479385,Jordan Kyrou,C,STL,26,82,15,31,46
4,8483445,Cutter Gauthier,L,ANA,20,82,14,32,46
4,8477346,MacKenzie Weegar,D,CGY,30,82,11,35,46
4,8482699,Dylan Guenther,R,ARI,21,82,24,21,45
4,8480009,Eeli Tolvanen,R,SEA,25,82,23,22,45
4,8475314,Anders Lee,L,NYI,34,82,22,23,45
4,8480208,Drake Batherson,R,OTT,26,82,17,28,45
4,8474679,Gustav Nyquist,C,NSH,35,82,14,31,45
4,8477416,Oliver Bjorkstrand,R,SEA,29,82,13,32,45
4,8479425,Filip Hronek,D,VAN,27,82,8,37,45
4,8475197,Tyson Barrie,D,NSH,33,82,7,38,45
4,8480064,Josh Norris,C,OTT,25,82,26,18,44
4,8482101,Danil Gushchin,L,SJS,22,82,25,19,44
4,8482055,Drew O'Connor,L,PIT,26,82,23,21,44
4,8479345,Jakob Chychrun,D,OTT,26,82,17,27,44
4,8474563,Drew Doughty,D,LAK,35,82,12,32,44
4,8482113,Anton Lundell,C,FLA,23,82,12,32,44
4,8480434,Sean Durzi,D,ARI,26,82,11,33,44
4,8480036,Miro Heiskanen,D,DAL,25,82,10,34,44
4,8478472,Mathieu Joseph,R,OTT,27,82,10,34,44
4,8478396,Noah Hanifin,D,VGK,27,82,7,37,44
4,8478498,Jake DeBrusk,L,BOS,28,82,26,17,43
4,8476881,Tomas Hertl,C,VGK,31,82,22,21,43
4,8477511,Anthony Mantha,R,VGK,30,82,18,25,43
4,8477503,Max Domi,C,TOR,29,82,8,35,43
4,8476346,Johnny Gaudreau,L,CBJ,31,82,3,40,43
4,8481699,Aku Raty,R,ARI,23,82,3,40,43
4,8483524,Shane Wright,C,SEA,20,82,28,14,42
4,8475799,Nino Niederreiter,R,WPG,32,82,22,20,42
4,8475848,Brendan Gallagher,R,MTL,32,82,21,21,42
4,8480188,Fabian Zetterlund,L,SJS,25,82,19,23,42
4,8482146,Luke Evangelista,R,NSH,22,82,14,28,42
4,8478469,Thomas Chabot,D,OTT,27,82,13,29,42
4,8476872,Scott Laughton,C,PHI,30,82,13,29,42
4,8482671,Owen Power,D,BUF,22,82,11,31,42
4,8476869,Brady Skjei,D,CAR,30,82,8,34,42
4,8476792,Torey Krug,D,STL,33,82,5,37,42
4,8477407,Anthony Duclair,L,TBL,29,82,19,22,41
4,8482159,Tyson Foerster,R,PHI,22,82,19,22,41
4,8480028,Morgan Frost,C,PHI,25,82,16,25,41
4,8481596,Shane Pinto,C,OTT,24,82,15,26,41
4,8478413,Jordan Greenway,L,BUF,27,82,15,26,41
4,8476925,Colton Sissons,C,NSH,31,82,14,27,41
4,8480798,Philipp Kurashev,C,CHI,25,82,11,30,41
4,8477479,Tyler Bertuzzi,L,TOR,29,82,22,18,40
4,8478519,Anthony Cirelli,C,TBL,27,82,18,22,40
4,8477964,Ivan Barbashev,C,VGK,29,82,17,23,40
4,8480078,Filip Chytil,C,NYR,25,82,17,23,40
4,8480855,Jack McBain,C,ARI,24,82,16,24,40
4,8478046,Danton Heinen,L,BOS,29,82,14,26,40
4,8474037,James van Riemsdyk,L,BOS,35,82,14,26,40
4,8482667,William Eklund,L,SJS,22,82,13,27,40
4,8479987,Morgan Geekie,C,BOS,26,82,13,27,40
4,8478038,Devon Toews,D,COL,30,82,7,33,40
4,8482702,Logan Stankoven,C,DAL,21,82,23,16,39
4,8480849,Barrett Hayton,C,ARI,24,82,21,18,39
4,8476479,Phillip Danault,C,LAK,31,82,19,20,39
4,8471698,T.J. Oshie,R,WSH,38,82,17,22,39
4,8475745,Charlie Coyle,C,BOS,32,82,15,24,39
4,8475149,Marcus Johansson,L,MIN,34,82,15,24,39
4,8482733,Logan Mailloux,D,MTL,31,82,10,29,39
4,8479410,Mikhail Sergachev,D,TBL,26,82,4,35,39
4,8480220,Noah Cates,L,PHI,25,82,18,20,38
4,8477497,Sean Monahan,C,WPG,30,82,17,21,38
4,8477998,Warren Foegele,L,EDM,28,82,14,24,38
4,8474102,David Perron,L,DET,36,82,12,26,38
4,8477021,Alex Kerfoot,C,ARI,30,82,11,27,38
4,8476480,Vladislav Namestnikov,C,WPG,32,82,10,28,38
4,8481546,Cam York,D,PHI,23,82,8,30,38
4,8481016,Ruslan Iskhakov,C,NYI,24,82,6,32,38
4,8475764,Cam Fowler,D,ANA,33,82,3,35,38
4,8483471,Brad Lambert,C,WPG,31,82,1,37,38
4,8476483,Rickard Rakell,R,PIT,31,82,24,13,37
4,8481535,Nils Hoglander,L,VAN,24,82,21,16,37
4,8481704,Juuso Parssinen,C,NSH,23,82,21,16,37
4,8478474,Lawson Crouse,L,ARI,27,82,20,17,37
4,8471218,Blake Wheeler,R,NYR,38,82,12,25,37
4,8481711,Matias Maccelli,L,ARI,24,82,12,25,37
4,8477948,Travis Sanheim,D,PHI,28,82,8,29,37
4,8480873,Rasmus Sandin,D,WSH,24,82,8,29,37
4,8479293,Brandon Tanev,L,SEA,33,82,20,16,36
4,8476461,Sean Couturier,C,PHI,32,82,19,17,36
4,8481554,Kaapo Kakko,R,NYR,23,82,18,18,36
4,8475763,Kevin Hayes,R,STL,32,82,17,19,36
4,8474715,Cam Atkinson,R,PHI,35,82,17,19,36
4,8482475,Yegor Chinakhov,R,CBJ,23,82,16,20,36
4,8478462,Nicolas Roy,C,VGK,27,82,14,22,36
4,8475287,Erik Haula,L,NJD,33,82,13,23,36
4,8476875,Mike Matheson,D,MTL,30,82,11,25,36
4,8473422,Nick Foligno,L,CHI,37,82,11,25,36
4,8470613,Brent Burns,D,CAR,39,82,9,27,36
4,8475906,John Klingberg,D,TOR,32,82,9,27,36
4,8475218,Mattias Ekholm,D,EDM,34,82,9,27,36
4,8482089,Jake Neighbours,L,STL,22,82,20,15,35
4,8480014,Gabriel Vilardi,C,WPG,25,82,19,16,35
4,8477952,Robby Fabbri,C,DET,28,82,16,19,35
4,8477932,Aaron Ekblad,D,FLA,28,82,15,20,35
4,8479365,Trent Frederic,C,BOS,26,82,14,21,35
4,8474870,Tyler Johnson,C,CHI,34,82,12,23,35
4,8482624,Daniil Miromanov,D,CGY,27,82,12,23,35
4,8476960,Andreas Athanasiou,C,CHI,30,82,12,23,35
4,8477429,Andrew Copp,C,DET,30,82,10,25,35
4,8477495,Seth Jones,D,CHI,30,82,7,28,35
4,8476885,Jacob Trouba,D,NYR,30,82,7,28,35
4,8478882,Vladislav Gavrikov,D,LAK,29,82,6,29,35
4,8476906,Shayne Gostisbehere,D,DET,31,82,5,30,35
4,8476880,Tom Wilson,R,WSH,30,82,21,13,34
4,8475760,Nick Bjugstad,C,ARI,32,82,17,17,34
4,8482705,Cole Sillinger,C,CBJ,21,82,14,20,34
4,8482092,Ridly Greig,C,OTT,22,82,12,22,34
4,8480797,Joel Farabee,L,PHI,24,82,11,23,34
4,8475753,Justin Faulk,D,STL,32,82,10,24,34
4,8480817,K'Andre Miller,D,NYR,24,82,9,25,34
4,8481542,Moritz Seider,D,DET,23,82,8,26,34
4,8481604,Pavel Dorofeyev,L,VGK,24,82,19,14,33
4,8484144,Connor Bedard,C,CHI,19,82,18,15,33
4,8482679,Matt Coronato,R,CGY,22,82,17,16,33
4,8474189,Lars Eller,C,PIT,35,82,16,17,33
4,8478508,Yakov Trenin,C,COL,27,82,16,17,33
4,8481481,Blake Lizotte,C,LAK,27,82,16,17,33
4,8474641,Adam Henrique,C,EDM,34,82,15,18,33
4,8476392,Adam Lowry,C,WPG,31,82,15,18,33
4,8478463,Anthony Beauvillier,L,NSH,27,82,14,19,33
4,8476897,Oskar Sundqvist,C,STL,30,82,14,19,33
4,8482117,Lukas Reichel,L,CHI,22,82,13,20,33
4,8482074,Connor Zary,C,CGY,23,82,12,21,33
4,8476921,Jordan Martinook,L,CAR,32,82,12,21,33
4,8481013,Jonatan Berggren,R,DET,24,82,10,23,33
4,8476826,Yanni Gourde,C,SEA,33,82,8,25,33
4,8479996,Cody Glass,C,NSH,25,82,16,16,32
4,8475714,Calle Jarnkrok,C,TOR,33,82,13,19,32
4,8481186,Logan O'Connor,R,COL,28,82,13,19,32
4,8478055,Gustav Forsling,D,FLA,28,82,13,19,32
4,8478891,Mason Appleton,C,WPG,28,82,12,20,32
4,8482222,Alexander Barabanov,L,SJS,30,82,11,21,32
4,8477494,Jonathan Drouin,L,COL,29,82,11,21,32
4,8474716,Jared Spurgeon,D,MIN,35,82,8,24,32
4,8476892,Colton Parayko,D,STL,31,82,8,24,32
4,8473563,Nicklas Backstrom,C,WSH,37,82,5,27,32
4,8476917,Adam Pelech,D,NYI,30,82,3,29,32
4,8482118,Sam Colangelo,R,ANA,23,82,23,8,31
4,8481624,Ilya Mikheyev,R,VAN,30,82,20,11,31
4,8477426,Nicholas Paul,L,TBL,29,82,15,16,31
4,8480459,Pius Suter,C,VAN,28,82,15,16,31
4,8477456,J.T. Compher,L,DET,29,82,14,17,31
4,8476927,Teddy Blueger,C,VAN,30,82,10,21,31
4,8475181,Nick Leddy,D,STL,33,82,7,24,31
4,8479415,Michael McLeod,C,NJD,26,82,15,15,30
4,8478466,Daniel Sprong,R,DET,27,82,13,17,30
4,8480113,Alex Iafallo,L,WPG,31,82,12,18,30
4,8479351,Sam Steel,C,DAL,26,82,9,21,30
4,8475744,Evgeny Kuznetsov,C,CAR,32,82,8,22,30
4,8476979,Erik Gustafsson,D,NYR,32,82,5,25,30
4,8483457,Lane Hutson,D,MTL,20,82,4,26,30
4,8479423,Alex Nylander,L,CBJ,26,82,14,15,29
4,8473449,Kyle Okposo,R,FLA,36,82,13,16,29
4,8481618,Alex Newhook,C,MTL,23,82,12,17,29
4,8483515,Juraj Slafkovsky,L,MTL,20,82,12,17,29
4,8470610,Zach Parise,L,COL,40,82,12,17,29
4,8481703,Valtteri Puustinen,R,PIT,25,82,10,19,29
4,8476422,Mike Reilly,D,NYI,31,82,10,19,29
4,8480802,Ryan McLeod,C,EDM,25,82,9,20,29
4,8476854,Hampus Lindholm,D,BOS,30,82,8,21,29
4,8479369,Andrew Peeke,D,BOS,26,82,8,21,29
4,8480145,Neal Pionk,D,WPG,29,82,7,22,29
4,8482720,Matthew Knies,L,TOR,22,82,5,24,29
4,8478057,Dakota Joshua,C,VAN,28,82,18,10,28
4,8481560,Arthur Kaliyev,R,LAK,23,82,17,11,28
4,8479525,Ross Colton,C,COL,28,82,17,11,28
4,8479941,Justin Danforth,R,CBJ,31,82,17,11,28
4,8479591,Michael Eyssimont,C,TBL,28,82,13,15,28
4,8482155,Alex Laferriere,R,LAK,23,82,13,15,28
4,8478020,Michael Amadio,C,VGK,28,82,12,16,28
4,8479514,Rem Pitlick,C,CHI,27,82,12,16,28
4,8476329,Travis Boyd,C,ARI,31,82,11,17,28
4,8482079,Marco Rossi,C,MIN,23,82,9,19,28
4,8476958,Jaccob Slavin,D,CAR,30,82,7,21,28
4,8476923,Damon Severson,D,CBJ,30,82,7,21,28
4,8475171,Oliver Ekman-Larsson,D,FLA,33,82,6,22,28
4,8481178,Egor Zamula,D,PHI,24,82,4,24,28
4,8483493,Frank Nazar,C,CHI,20,82,18,9,27
4,8476469,Joel Armia,R,MTL,31,82,15,12,27
4,8479992,Michael Rasmussen,C,DET,25,82,15,12,27
4,8479346,Dillon Dube,C,CGY,26,82,14,13,27
4,8476292,Ondrej Palat,L,NJD,33,82,13,14,27
4,8484153,Leo Carlsson,C,ANA,20,82,13,14,27
4,8478115,Pierre Engvall,L,NYI,28,82,13,14,27
4,8474149,Evgenii Dadonov,R,DAL,35,82,12,15,27
4,8477450,Jason Dickinson,C,CHI,29,82,12,15,27
4,8478569,Noel Acciari,C,PIT,33,82,12,15,27
4,8474053,Logan Couture,C,SJS,35,82,11,16,27
4,8475164,Jakob Silfverberg,R,ANA,34,82,10,17,27
4,8481553,Bobby Brink,R,PHI,23,82,10,17,27
4,8482142,Jamie Drysdale,D,PHI,22,82,7,20,27
4,8475279,Ben Chiarot,D,DET,33,82,7,20,27
4,8480043,Timothy Liljegren,D,TOR,25,82,5,22,27
4,8482105,Jake Sanderson,D,OTT,22,82,5,22,27
4,8482712,Oskar Olausson,R,COL,22,82,5,22,27
4,8479998,Mikey Anderson,D,LAK,25,82,4,23,27
4,8479393,Noah Gregor,C,TOR,26,82,16,10,26
4,8479977,Kailer Yamamoto,R,SEA,26,82,14,12,26
4,8483431,Logan Cooley,C,ARI,20,82,14,12,26
4,8480821,Filip Zadina,R,SJS,25,82,14,12,26
4,8481028,Martin Pospisil,C,CGY,25,82,11,15,26
4,8477330,Dominik Kubalik,L,OTT,29,82,10,16,26
4,8476278,Colin Blackwell,C,CHI,31,82,10,16,26
4,8482655,J.J. Moser,D,ARI,24,82,9,17,26
4,8482730,Brandt Clarke,D,LAK,21,82,8,18,26
4,8483505,Matthew Poitras,C,BOS,20,82,7,19,26
4,8479371,Dante Fabbro,D,NSH,26,82,6,20,26
4,8477969,Marcus Pettersson,D,PIT,28,82,4,22,26
4,8477488,Brett Pesce,D,CAR,30,82,4,22,26
4,8478840,Will Borgen,D,SEA,28,82,2,24,26
4,8479353,Brett Howden,C,VGK,26,82,13,12,25
4,8484203,Bradly Nadeau,L,CAR,19,82,13,12,25
4,8480806,Isac Lundestrom,C,ANA,25,82,12,13,25
4,8475220,Marcus Foligno,L,MIN,33,82,8,17,25
4,8480871,Adam Boqvist,D,CBJ,24,82,6,19,25
4,8482122,Brock Faber,D,MIN,22,82,5,20,25
4,8482087,Kaiden Guhle,D,MTL,22,82,5,20,25
4,8473507,Jeff Petry,D,DET,37,82,5,20,25
4,8480246,Nick Perbix,D,TBL,26,82,3,22,25
4,8483491,Ivan Miroshnichenko,L,WSH,20,82,19,5,24
4,8476624,Barclay Goodrow,C,NYR,31,82,14,10,24
4,8480068,Ryan Poehling,C,PHI,25,82,13,11,24
4,8476312,Josh Manson,D,COL,33,82,12,12,24
4,8482110,Dawson Mercer,C,NJD,23,82,11,13,24
4,8479316,Luke Kunin,C,SJS,27,82,10,14,24
4,8477919,Frederick Gaudreau,C,MIN,31,82,10,14,24
4,8480893,Kirill Marchenko,R,CBJ,24,82,7,17,24
4,8481606,Jordan Spence,D,LAK,23,82,7,17,24
4,8476931,Jake McCabe,D,TOR,31,82,7,17,24
4,8476891,Matt Grzelcyk,D,BOS,30,82,3,21,24
4,8479390,Taylor Raddysh,R,CHI,26,82,16,7,23
4,8470621,Corey Perry,R,EDM,39,82,15,8,23
4,8477944,Jakub Vrana,L,STL,28,82,15,8,23
4,8479661,Tanner Jeannot,L,TBL,27,82,15,8,23
4,8478043,Sam Lafferty,C,VAN,29,82,13,10,23
4,8470604,Jeff Carter,C,PIT,39,82,12,11,23
4,8478013,Jake Walman,D,DET,28,82,12,11,23
4,8477839,Conor Sheary,L,TBL,32,82,12,11,23
4,8477989,Christian Dvorak,C,MTL,28,82,11,12,23
4,8482259,Bobby McMann,C,TOR,28,82,11,12,23
4,8481656,Aliaksei Protas,C,WSH,23,82,8,15,23
4,8482073,Braden Schneider,D,NYR,23,82,8,15,23
4,8483499,Liam Ohgren,L,MIN,20,82,6,17,23
4,8476467,Jamie Oleksiak,D,SEA,32,82,6,17,23
4,8475825,Jani Hakanpää,D,DAL,32,82,6,17,23
4,8482111,Justin Barron,D,MTL,23,82,5,18,23
4,8478500,Ivan Provorov,D,CBJ,27,82,4,19,23
4,8476902,Esa Lindell,D,DAL,30,82,4,19,23
4,8474673,TJ Brodie,D,TOR,34,82,2,21,23
4,8476967,Brett Kulak,D,EDM,30,82,0,23,23
4,8478109,Victor Olofsson,L,BUF,29,82,15,7,22
4,8481093,Rafael Harvey-Pinard,L,MTL,25,82,15,7,22
4,8476871,Tanner Pearson,L,MTL,32,82,14,8,22
4,8482133,Thomas Bordeleau,C,SJS,22,82,9,13,22
4,8477953,Kasperi Kapanen,R,STL,28,82,9,13,22
4,8477507,Nikita Zadorov,D,VAN,29,82,9,13,22
4,8474034,Pat Maroon,L,BOS,36,82,8,14,22
4,8476525,Colin Miller,D,WPG,32,82,6,16,22
4,8478911,Matt Roy,D,LAK,29,82,6,16,22
4,8476463,Jonas Brodin,D,MIN,31,82,5,17,22
4,8479324,Ryan Lindgren,D,NYR,26,82,5,17,22
4,8477506,Ryan Pulock,D,NYI,30,82,4,18,22
4,8476331,Dylan DeMelo,D,WPG,31,82,4,18,22
4,8482858,Ryker Evans,D,SEA,23,82,4,18,22
4,8479976,Juuso Valimaki,D,ARI,26,82,3,19,22
4,8476873,Mark Jankowski,C,NSH,30,82,12,9,21
4,8481580,Connor McMichael,C,WSH,23,82,11,10,21
4,8484166,Adam Fantilli,C,CBJ,20,82,11,10,21
4,8473533,Jordan Staal,C,CAR,36,82,10,11,21
4,8477425,Miles Wood,L,COL,29,82,10,11,21
4,8478430,Oliver Kylington,D,CGY,27,82,9,12,21
4,8474884,Mike Hoffman,C,SJS,35,82,8,13,21
4,8479980,Nicolas Hague,D,VGK,26,82,8,13,21
4,8477931,Tomas Nosek,L,NJD,32,82,8,13,21
4,8478133,Jake Evans,C,MTL,28,82,7,14,21
4,8474151,Ryan McDonagh,D,NSH,35,82,6,15,21
4,8479398,Samuel Girard,D,COL,26,82,6,15,21
4,8477505,Alexander Wennberg,C,NYR,30,82,6,15,21
4,8482470,Ilya Solovyov,D,CGY,24,82,6,15,21
4,8480058,Pierre-Olivier Joseph,D,PIT,25,82,3,18,21
4,8475690,Chris Tanev,D,DAL,35,82,3,18,21
4,8476457,Adam Larsson,D,SEA,32,82,2,19,21
4,8474574,Tyler Myers,D,VAN,34,82,2,19,21
4,8480073,Erik Brannstrom,D,OTT,25,82,1,20,21
4,8476981,Josh Anderson,R,MTL,30,82,12,8,20
4,8480281,Alexey Toropchenko,R,STL,25,82,12,8,20
4,8475231,Casey Cizikas,C,NYI,33,82,12,8,20
4,8475842,Sam Carrick,C,EDM,32,82,10,10,20
4,8482666,Scott Morrow,D,CAR,22,82,10,10,20
4,8473504,Cal Clutterbuck,R,NYI,37,82,9,11,20
4,8477392,Hudson Fasching,R,NYI,29,82,8,12,20
4,8482125,Alexander Holtz,R,NJD,22,82,8,12,20
4,8477220,Nate Schmidt,D,WPG,33,82,8,12,20
4,8481601,Simon Holmstrom,R,NYI,23,82,7,13,20
4,8475200,Dmitry Orlov,D,CAR,33,82,6,14,20
4,8477365,Connor Clifton,D,BUF,29,82,6,14,20
4,8481014,Alexander Romanov,D,NYI,24,82,5,15,20
4,8483466,Kevin Korchinski,D,CHI,20,82,5,15,20
4,8480172,Jan Rutta,D,SJS,34,82,5,15,20
4,8475324,Nick Jensen,D,WSH,34,82,4,16,20
4,8479983,Mario Ferraro,D,SJS,26,82,3,17,20
4,8482062,Cole Smith,L,NSH,29,82,3,17,20
4,8478416,Erik Cernak,D,TBL,27,82,3,17,20
4,8475179,Dmitry Kulikov,D,FLA,34,82,2,18,20
4,8481477,Nico Sturm,C,SJS,29,82,11,8,19
4,8481522,Peyton Krebs,C,BUF,23,82,11,8,19
4,8480448,Parker Kelly,L,OTT,25,82,10,9,19
4,8477947,Sonny Milano,L,WSH,28,82,8,11,19
4,8481517,Brett Leason,R,ANA,25,82,8,11,19
4,8482737,Zack Bolduc,C,STL,21,82,7,12,19
4,8474567,Zach Bogosian,D,MIN,34,82,7,12,19
4,8483482,Tristan Luneau,D,ANA,20,82,6,13,19
4,8484145,Zach Benson,L,BUF,19,82,5,14,19
4,8480796,Martin Fehervary,D,WSH,25,82,5,14,19
4,8478178,Darren Raddysh,D,TBL,28,82,3,16,19
4,8475455,Brenden Dillon,D,WPG,34,82,3,16,19
4,8475233,David Savard,D,MTL,34,82,2,17,19
4,8481568,Alex Vlasic,D,CHI,23,82,2,17,19
4,8480813,Joe Veleno,C,DET,24,82,8,10,18
4,8477406,Mattias Janmark,C,EDM,32,82,8,10,18
4,8475343,Nic Dowd,C,WSH,34,82,6,12,18
4,8483565,Nick Blankenburg,D,CBJ,26,82,6,12,18
4,8482166,Shakir Mukhamadullin,D,SJS,22,82,6,12,18
4,8480336,Sean Walker,D,COL,30,82,5,13,18
4,8476878,Zemgus Girgensons,L,BUF,30,82,5,13,18
4,8478507,John Marino,D,NJD,27,82,5,13,18
4,8478831,Kevin Stenlund,C,FLA,28,82,5,13,18
4,8481537,Nikita Okhotiuk,D,CGY,24,82,3,15,18
4,8477845,Trevor van Riemsdyk,D,WSH,33,82,3,15,18
4,8475188,Brayden McNabb,D,VGK,33,82,3,15,18
4,8477369,Carson Soucy,D,VAN,30,82,3,15,18
4,8478851,Alexandre Carrier,D,NSH,28,82,2,16,18
4,8475762,Derek Forbort,D,BOS,32,82,1,17,18
4,8480074,Alexandre Texier,C,CBJ,25,82,8,9,17
4,8477499,Rasmus Ristolainen,D,PHI,30,82,5,12,17
4,8482177,Marat Khusnutdinov,C,MIN,22,82,4,13,17
4,8476429,Scott Mayfield,D,NYI,32,82,4,13,17
4,8482245,Artem Zub,D,OTT,29,82,3,14,17
4,8480834,Ty Emberson,D,SJS,24,82,3,14,17
4,8478451,Ethan Bear,D,WSH,27,82,3,14,17
4,8480807,Mattias Samuelsson,D,BUF,24,82,2,15,17
4,8480860,Kevin Bahl,D,NJD,24,82,1,16,17
4,8475208,Brian Dumoulin,D,SEA,33,82,1,16,17
4,8481059,Scott Perunovich,D,STL,26,82,0,17,17
4,8479291,Kevin Rooney,C,CGY,31,82,9,7,16
4,8480980,Connor Dewar,C,TOR,25,82,7,9,16
4,8477353,Tyler Motte,C,TBL,29,82,6,10,16
4,8483490,Pavel Mintyukov,D,ANA,21,82,5,11,16
4,8479442,Troy Stecher,D,EDM,30,82,5,11,16
4,8478443,Brandon Carlo,D,BOS,28,82,4,12,16
4,8483763,Maksymilian Szuber,D,ARI,22,82,4,12,16
4,8478399,Jonas Siegenthaler,D,NJD,27,82,3,13,16
4,8481567,Henry Thrun,D,SJS,23,82,3,13,16
4,8477435,Ryan Graves,D,PIT,29,82,3,13,16
4,8484911,Collin Graf,R,SJS,22,82,3,13,16
4,8474013,Ian Cole,D,VAN,35,82,2,14,16
4,8476879,Cody Ceci,D,EDM,31,82,0,16,16
4,8476374,Sean Kuraly,C,CBJ,31,82,8,7,15
4,8481578,Graeme Clarke,R,NJD,23,82,7,8,15
4,8474009,Nick Bonino,C,NYR,36,82,7,8,15
4,8478468,Jeremy Lauzon,D,NSH,27,82,5,10,15
4,8471677,Jack Johnson,D,COL,37,82,4,11,15
4,8480035,Henri Jokiharju,D,BUF,25,82,3,12,15
4,8478136,Jake Middleton,D,MIN,28,82,2,13,15
4,8477508,Curtis Lazar,C,NJD,29,82,6,8,14
4,8479359,Beck Malenstyn,L,WSH,26,82,4,10,14
4,8480879,Jacob Bernard-Docker,D,OTT,24,82,2,12,14
4,8481524,Bowen Byram,D,BUF,23,82,7,6,13
4,8484149,Gavin Brindley,C,CBJ,20,82,6,7,13
4,8477015,Connor Brown,R,EDM,30,82,5,8,13
4,8477034,Jaycob Megna,D,CHI,32,82,4,9,13
4,8476473,Connor Murphy,D,CHI,31,82,3,10,13
4,8475462,Radko Gudas,D,ANA,34,82,2,11,13
4,8482516,Matthew Kessel,D,STL,24,82,2,11,13
4,8480144,David Kampf,C,TOR,29,82,1,12,13
4,8482809,Jackson Blake,R,CAR,21,82,7,5,12
4,8476858,Phillip Di Giuseppe,L,VAN,31,82,6,6,12
4,8483012,Logan Morrison,C,SEA,22,82,5,7,12
4,8483495,Simon Nemec,D,NJD,20,82,4,8,12
4,8476915,Jujhar Khaira,L,MIN,30,82,4,8,12
4,8481030,Jack St. Ivany,D,PIT,25,82,4,8,12
4,8482807,Ethan Del Mastro,D,CHI,21,82,2,10,12
4,8478859,Niko Mikkola,D,FLA,28,82,1,11,12
4,8482803,Olen Zellweger,D,ANA,21,82,1,11,12
4,8475790,Erik Gudbranson,D,CBJ,32,82,0,12,12
4,8479383,Boris Katchouk,L,OTT,26,82,7,4,11
4,8476442,Matt Nieto,L,PIT,32,82,6,5,11
4,8477335,Kyle Burroughs,D,SJS,29,82,5,6,11
4,8482762,Simon Edvinsson,D,DET,21,82,5,6,11
4,8481605,Jackson LaCombe,D,ANA,23,82,4,7,11
4,8473453,Trevor Lewis,C,LAK,37,82,4,7,11
4,8474166,Alec Martinez,D,VGK,37,82,4,7,11
4,8470600,Ryan Suter,D,DAL,39,82,1,10,11
4,8482145,Mavrik Bourque,C,DAL,22,82,9,1,10
4,8478408,Travis Dermott,D,ARI,28,82,4,6,10
4,8476372,Nick Seeler,D,PHI,31,82,3,7,10
4,8476822,Luke Glendening,C,TBL,35,82,6,3,9
4,8483468,Jiri Kulich,C,BUF,20,82,3,6,9
4,8470966,Mark Giordano,D,TOR,41,82,0,9,9
4,8480990,Declan Chisholm,D,MIN,24,82,5,3,8
4,8481599,Victor Soderstrom,D,ARI,23,82,2,6,8
4,8482713,Mackie Samoskevich,R,FLA,22,82,2,6,8
4,8475177,Calvin de Haan,D,TBL,33,82,4,2,6
4,8482859,Zack Ostapchuk,C,OTT,21,82,1,4,5
4,8483489,Fraser Minten,C,TOR,31,82,2,1,3
4,8482141,Lukas Cormier,D,VGK,22,0,0,0,0
4,8476988,Matt Benning,D,SJS,30,0,0,0,0
4,8480727,Zach Whitecloud,D,VGK,28,0,0,0,0
4,8480887,Jordan Harris,D,MTL,24,0,0,0,0
4,8478450,Parker Wotherspoon,D,BOS,27,0,0,0,0
4,8481812,Nikolai Knyzhov,D,SJS,27,0,0,0,0
4,8480001,Urho Vaakanainen,D,ANA,25,0,0,0,0
4,8482176,Wyatt Kaiser,D,CHI,22,0,0,0,0
4,8481122,Simon Benoit,D,TOR,26,0,0,0,0
4,8476441,Joel Edmundson,D,TOR,31,0,0,0,0
4,8480884,Calen Addison,D,SJS,24,0,0,0,0
4,8482511,Mason Lohrei,D,BOS,23,0,0,0,0
4,8482192,Isaak Phillips,D,CHI,23,0,0,0,0
4,8480950,Ilya Lyubushkin,D,TOR,30,0,0,0,0
4,8474031,Kevin Shattenkirk,D,BOS,35,0,0,0,0
4,8475718,Justin Holl,D,DET,32,0,0,0,0
4,8479402,Jake Bean,D,CBJ,26,0,0,0,0
4,8474602,Justin Schultz,D,SEA,34,0,0,0,0
4,8477950,Tony DeAngelo,D,CAR,29,0,0,0,0
4,8481743,Marc Del Gaizo,D,NSH,25,0,0,0,0
4,8481527,Kaedan Korczak,D,VGK,23,0,0,0,0
4,8480192,Johnathan Kovacevic,D,MTL,27,0,0,0,0
4,8476874,Olli Maatta,D,DET,30,0,0,0,0
4,8482144,Jack Thompson,D,SJS,22,0,0,0,0
4,8480222,Sebastian Aho,D,NYI,28,0,0,0,0
4,8479458,Nikita Zaitsev,D,CHI,33,0,0,0,0
4,8471709,Marc-Edouard Vlasic,D,SJS,37,0,0,0,0
4,8482929,Emil Lilleberg,D,TBL,23,0,0,0,0
4,8477018,Ben Hutton,D,VGK,31,0,0,0,0
4,8481056,Spencer Stastney,D,NSH,24,0,0,0,0
4,8481593,Jayden Struble,D,MTL,23,0,0,0,0
4,8479982,Conor Timmins,D,TOR,26,0,0,0,0
4,8474090,Brendan Smith,D,NJD,35,0,0,0,0
4,8482964,Arber Xhekaj,D,MTL,23,0,0,0,0
4,8480891,Michael Kesselring,D,ARI,24,0,0,0,0
4,8477938,Haydn Fleury,D,TBL,28,0,0,0,0
4,8481806,Louis Crevier,D,CHI,23,0,0,0,0
4,8471274,Alex Goligoski,D,MIN,39,0,0,0,0
4,8481600,Tobias Bjornfot,D,FLA,23,0,0,0,0
4,8475797,Jarred Tinordi,D,CHI,32,0,0,0,0
4,8481521,Ronnie Attard,D,PHI,25,0,0,0,0
4,8474612,Travis Hamonic,D,OTT,34,0,0,0,0
4,8479576,Vincent Desharnais,D,EDM,28,0,0,0,0
4,8480049,Dylan Samberg,D,WPG,25,0,0,0,0
4,8483619,Filip Roos,D,CHI,25,0,0,0,0
4,8474568,Luke Schenn,D,NSH,35,0,0,0,0
4,8480184,Gustav Lindstrom,D,ANA,26,0,0,0,0
4,8480070,Ian Mitchell,D,BOS,25,0,0,0,0
4,8480196,Jacob Bryson,D,BUF,27,0,0,0,0
4,8471686,Marc Staal,D,PHI,37,0,0,0,0
4,8477467,Gustav Olofsson,D,SEA,30,0,0,0,0
4,8478970,Jalen Chatfield,D,CAR,28,0,0,0,0
4,8479348,Kale Clague,D,BUF,26,0,0,0,0
4,8473446,Erik Johnson,D,PHI,36,0,0,0,0
4,8477462,Robert Hagg,D,ANA,29,0,0,0,0
4,8478454,Noah Juulsen,D,VAN,27,0,0,0,0
4,8477384,Josh Brown,D,ARI,30,0,0,0,0
4,8481708,Zac Jones,D,NYR,24,0,0,0,0
4,8481167,Brayden Pachal,D,CGY,25,0,0,0,0
4,8482067,Connor Mackey,D,NYR,28,0,0,0,0
4,8483460,David Jiricek,D,CBJ,21,0,0,0,0
4,8481701,Santeri Hatakka,D,NJD,23,0,0,0,0
4,8478021,William Lagesson,D,ANA,28,0,0,0,0
4,8477851,Jordan Oesterle,D,CGY,32,0,0,0,0
4,8478452,Caleb Jones,D,COL,27,0,0,0,0
4,8479984,Cal Foote,D,NJD,26,0,0,0,0
4,8479639,Dylan Coghlan,D,CAR,26,0,0,0,0
4,8480874,Adam Ginning,D,PHI,24,0,0,0,0
4,8479321,Lucas Johansen,D,WSH,27,0,0,0,0
4,8480878,Nils Lundkvist,D,DAL,24,0,0,0,0
4,8482165,Yan Kuznetsov,D,CGY,22,0,0,0,0
4,8484258,Sam Malinski,D,COL,26,0,0,0,0
4,8480157,Calle Rosen,D,STL,30,0,0,0,0
4,8484304,Uvis Balinskis,D,FLA,28,0,0,0,0
4,8479985,Cale Fleury,D,SEA,26,0,0,0,0
4,8479378,Logan Stanley,D,WPG,26,0,0,0,0
4,8477541,Dakota Mermis,D,MIN,30,0,0,0,0
4,8481609,Vladislav Kolyachonok,D,ARI,23,0,0,0,0
4,8480823,Alexander Alexeyev,D,WSH,25,0,0,0,0
4,8481679,Maxence Guenette,D,OTT,23,0,0,0,0
4,8481564,Ryan Johnson,D,BUF,23,0,0,0,0
4,8479376,Victor Mete,D,PHI,26,0,0,0,0
4,8484254,Akito Hirose,D,VAN,25,0,0,0,0
4,8482660,Kent Johnson,C,CBJ,22,0,0,0,0
4,8482149,Cole Perfetti,C,WPG,22,0,0,0,0
4,8477987,Ryan Donato,C,CHI,28,0,0,0,0
4,8475755,Alexander Petrovic,D,DAL,32,0,0,0,0
4,8477810,Joel Hanley,D,CGY,33,0,0,0,0
4,8474145,Robert Bortuzzo,D,NYI,35,0,0,0,0
4,8481161,Jake Christiansen,D,CBJ,25,0,0,0,0
4,8476884,Derrick Pouliot,D,DAL,30,0,0,0,0
4,8481716,Dmitri Voronkov,L,CBJ,24,0,0,0,0
4,8480084,Nick DeSimone,D,NJD,30,0,0,0,0
4,8475750,Jon Merrill,D,MIN,32,0,0,0,0
4,8479315,Joey Anderson,R,CHI,26,0,0,0,0
4,8478011,Louie Belpedio,D,PHI,28,0,0,0,0
4,8482451,Mikael Pyyhtia,L,CBJ,23,0,0,0,0
4,8481541,Samuel Bolduc,D,NYI,24,0,0,0,0
4,8482126,Emil Andrae,D,PHI,31,0,0,0,0
4,8474618,Marco Scandella,D,STL,34,0,0,0,0
4,8477244,Chad Ruhwedel,D,NYR,34,0,0,0,0
4,8477971,Andreas Englund,D,LAK,28,0,0,0,0
4,8480829,Jesperi Kotkaniemi,C,CAR,24,0,0,0,0
4,8479372,Josh Mahura,D,FLA,26,0,0,0,0
4,8482095,Tyler Kleven,D,OTT,22,0,0,0,0
4,8481719,Maxwell Crozier,D,TBL,24,0,0,0,0
4,8475855,Jesper Fast,R,CAR,33,0,0,0,0
4,8480848,Ty Dellandrea,C,DAL,24,0,0,0,0
4,8475193,Tomas Tatar,L,SEA,34,0,0,0,0
4,8476889,Radek Faksa,C,DAL,30,0,0,0,0
4,8478495,Denis Gurianov,R,PHI,27,0,0,0,0
4,8480216,Jacob Peterson,C,SJS,25,0,0,0,0
4,8480252,Cole Guttman,C,CHI,25,0,0,0,0
4,8479026,Philippe Myers,D,TBL,27,0,0,0,0
4,8481006,Tyler Tucker,D,STL,24,0,0,0,0
4,8481032,Paul Cotter,C,VGK,25,0,0,0,0
4,8481577,Philip Tomasino,C,NSH,23,0,0,0,0
4,8476918,Jimmy Vesey,L,NYR,31,0,0,0,0
4,8479320,Max Lajoie,D,TOR,27,0,0,0,0
4,8478017,Mark Friedman,D,VAN,29,0,0,0,0
4,8481754,Nikita Nesterenko,C,ANA,23,0,0,0,0
4,8483407,Brandon Scanlin,D,NYR,25,0,0,0,0
4,8482659,Josh Doan,R,ARI,22,0,0,0,0
4,8477446,Michael McCarron,R,NSH,29,0,0,0,0
4,8477903,Garnet Hathaway,R,PHI,33,0,0,0,0
4,8482153,Brendan Brisson,C,VGK,23,0,0,0,0
4,8483546,Marshall Rifai,D,TOR,26,0,0,0,0
4,8484287,Cole McWard,D,VAN,23,0,0,0,0
4,8478854,Ryan Shea,D,PIT,27,0,0,0,0
4,8481585,Egor Afanasyev,L,NSH,23,0,0,0,0
4,8483398,Declan Carlile,D,TBL,31,0,0,0,0
4,8478502,Dennis Gilbert,D,CGY,28,0,0,0,0
4,8482749,Joshua Roy,R,MTL,21,0,0,0,0
4,8481598,Philip Broberg,D,EDM,23,0,0,0,0
4,8480835,Jack Drury,C,CAR,24,0,0,0,0
4,8480748,Kiefer Sherwood,L,NSH,29,0,0,0,0
4,8476934,Brock McGinn,L,ANA,30,0,0,0,0
4,8480870,Bo Groulx,C,ANA,24,0,0,0,0
4,8479368,Max Jones,L,ANA,26,0,0,0,0
4,8478099,Kevin Labanc,R,SJS,29,0,0,0,0
4,8478067,Oskar Lindblom,L,SJS,28,0,0,0,0
4,8476393,Nick Cousins,C,FLA,31,0,0,0,0
4,8483395,Arshdeep Bains,L,VAN,23,0,0,0,0
4,8480762,Eric Robinson,L,BUF,29,0,0,0,0
4,8479439,Jacob MacDonald,D,SJS,31,0,0,0,0
4,8476474,Stefan Noesen,R,CAR,31,0,0,0,0
4,8482787,Nikita Chibrikov,R,WPG,31,0,0,0,0
4,8478432,Christian Fischer,R,DET,27,0,0,0,0
4,8477979,Nicolas Aube-Kubel,R,WSH,28,0,0,0,0
4,8481789,Tye Kartye,L,SEA,23,0,0,0,0
4,8479330,Brandon Gignac,C,MTL,27,0,0,0,0
4,8480075,Cameron Crotty,D,ARI,25,0,0,0,0
4,8473473,Milan Lucic,L,BOS,36,0,0,0,0
4,8482094,Daemon Hunt,D,MIN,22,0,0,0,0
4,8481206,John Ludvig,D,PIT,24,0,0,0,0
4,8483630,Pavol Regenda,L,ANA,25,0,0,0,0
4,8481617,Vasily Podkolzin,R,VAN,23,0,0,0,0
4,8480306,Grant Hutton,D,NYI,29,0,0,0,0
4,8480995,Pontus Holmberg,R,TOR,25,0,0,0,0
4,8482148,Hendrix Lapierre,C,WSH,22,0,0,0,0
4,8477478,William Carrier,L,VGK,30,0,0,0,0
4,8480003,Jesper Boqvist,C,BOS,26,0,0,0,0
4,8482172,Landon Slaggert,L,CHI,22,0,0,0,0
4,8480789,Oliver Wahlstrom,R,NYI,24,0,0,0,0
4,8474062,Riley Nash,C,NYR,35,0,0,0,0
4,8480021,Jack Studnicka,C,SJS,25,0,0,0,0
4,8480025,MacKenzie Entwistle,R,CHI,25,0,0,0,0
4,8481582,Nicholas Robertson,L,TOR,23,0,0,0,0
4,8476867,Brendan Gaunce,C,CBJ,30,0,0,0,0
4,8479619,Michael Carcone,L,ARI,28,0,0,0,0
4,8479370,Tyson Jost,C,BUF,26,0,0,0,0
4,8479671,Mathieu Olivier,R,CBJ,27,0,0,0,0
4,8476994,Vinnie Hinostroza,C,PIT,30,0,0,0,0
4,8482070,Mitchell Chaffee,R,TBL,26,0,0,0,0
4,8477473,Justin Bailey,R,SJS,29,0,0,0,0
4,8479344,Jesse Puljujarvi,R,PIT,26,0,0,0,0
4,8480205,Emil Bemstrom,C,PIT,25,0,0,0,0
4,8479718,Alex Barré-Boulet,C,TBL,27,0,0,0,0
4,8482061,Brandon Biro,L,BUF,26,0,0,0,0
4,8479638,Justin Brazeau,R,BOS,26,0,0,0,0
4,8474040,Sam Gagner,C,EDM,35,0,0,0,0
4,8477846,Ryan Carpenter,C,SJS,33,0,0,0,0
4,8482077,Dylan Holloway,L,EDM,23,0,0,0,0
4,8482157,Will Cuylle,L,NYR,22,0,0,0,0
4,8480007,Jonas Rondbjerg,R,VGK,25,0,0,0,0
4,8478874,Adam Gaudette,C,STL,28,0,0,0,0
4,8478434,Keegan Kolesar,R,VGK,27,0,0,0,0
4,8480441,Trey Fix-Wolansky,R,CBJ,25,0,0,0,0
4,8479994,Jaret Anderson-Dolan,C,NSH,25,0,0,0,0
4,8483567,Georgii Merkulov,C,BOS,24,0,0,0,0
4,8477380,Jonny Brodzinski,C,NYR,31,0,0,0,0
4,8482201,Gage Goncalves,C,TBL,23,0,0,0,0
4,8478211,Dryden Hunt,L,CGY,29,0,0,0,0
4,8471699,Andrew Cogliano,C,COL,37,0,0,0,0
4,8479421,Jacob Moverare,D,LAK,26,0,0,0,0
4,8478881,Brett Seney,L,CHI,28,0,0,0,0
4,8477464,Nic Petan,C,MIN,29,0,0,0,0
4,8475958,Michael Sgarbossa,C,WSH,32,0,0,0,0
4,8481147,Reese Johnson,C,CHI,26,0,0,0,0
4,8479336,Carl Grundstrom,R,LAK,27,0,0,0,0
4,8480853,Liam Foudy,C,NSH,24,0,0,0,0
4,8479522,Hardy Haman Aktell,D,WSH,26,0,0,0,0
4,8481462,Mason Morelli,L,VGK,28,0,0,0,0
4,8482102,Vasily Ponomarev,C,CAR,22,0,0,0,0
4,8480844,Grigori Denisenko,L,VGK,24,0,0,0,0
4,8479944,Zach Aston-Reese,C,DET,30,0,0,0,0
4,8482784,Zach Dean,C,STL,21,0,0,0,0
4,8479419,Brett Murray,L,BUF,26,0,0,0,0
4,8479520,Brandon Duhaime,R,COL,27,0,0,0,0
4,8477573,Nathan Walker,L,STL,30,0,0,0,0
4,8478078,Rourke Chartier,C,OTT,28,0,0,0,0
4,8475795,Dylan McIlrath,D,WSH,32,0,0,0,0
4,8482496,Nils Aman,C,VAN,24,0,0,0,0
4,8480289,Morgan Barron,C,WPG,26,0,0,0,0
4,8481751,Lukas Rousek,R,BUF,25,0,0,0,0
4,8480011,Klim Kostin,C,SJS,25,0,0,0,0
4,8481556,John Beecher,C,BOS,23,0,0,0,0
4,8475278,Byron Froese,C,VGK,33,0,0,0,0
4,8475225,Craig Smith,C,DAL,35,0,0,0,0
4,8484326,Patrik Koch,D,ARI,28,0,0,0,0
4,8477930,Pierre-Edouard Bellemare,L,SEA,39,0,0,0,0
4,8478409,Anthony Richard,C,BOS,28,0,0,0,0
4,8481024,Linus Karlsson,C,VAN,25,0,0,0,0
4,8479986,Kole Lind,R,SEA,26,0,0,0,0
4,8479414,Nathan Bastian,R,NJD,27,0,0,0,0
4,8479362,Riley Tufte,L,COL,26,0,0,0,0
4,8481058,Jesse Ylönen,R,MTL,25,0,0,0,0
4,8482476,Emil Heineman,L,MTL,23,0,0,0,0
4,8482861,Vincent Iorio,D,WSH,22,0,0,0,0
4,8483432,Luca Del Bel Belluz,C,CBJ,31,0,0,0,0
4,8482744,James Malatesta,L,CBJ,21,0,0,0,0
4,8477887,Patrick Brown,C,BOS,32,0,0,0,0
4,8478585,Derek Ryan,C,EDM,38,0,0,0,0
4,8481441,Joe Snively,C,WSH,28,0,0,0,0
4,8481592,Jakob Pelletier,L,CGY,23,0,0,0,0
4,8482634,Alex Steeves,C,TOR,25,0,0,0,0
4,8477126,Jayson Megna,C,BOS,34,0,0,0,0
4,8475752,Tyler Pitlick,C,NYR,33,0,0,0,0
4,8480008,Adam Ruzicka,C,ARI,25,0,0,0,0
4,8481065,Angus Crookshank,L,OTT,25,0,0,0,0
4,8479547,Matthew Phillips,R,WSH,26,0,0,0,0
4,8480226,Marián Studenic,R,SEA,26,0,0,0,0
4,8481237,Kyle MacLean,C,NYI,25,0,0,0,0
4,8475413,Justin Dowling,C,NJD,34,0,0,0,0
4,8481641,Joel Kiviranta,L,COL,28,0,0,0,0
4,8478104,Sammy Blais,L,STL,28,0,0,0,0
4,8477454,Adam Erne,L,EDM,29,0,0,0,0
4,8481518,Nolan Foote,L,NJD,24,0,0,0,0
4,8480245,Olle Lycksell,R,PHI,25,0,0,0,0
4,8483570,Ben Meyers,C,ANA,26,0,0,0,0
4,8480776,Sheldon Rempal,R,VGK,29,0,0,0,0
4,8483920,Pierrick Dube,R,WSH,23,0,0,0,0
4,8480267,Sammy Walker,C,MIN,25,0,0,0,0
4,8482747,Brennan Othmann,L,NYR,21,0,0,0,0
4,8479991,Jake Leschyshyn,C,NYR,25,0,0,0,0
4,8478400,Colin White,C,MTL,27,0,0,0,0
4,8479328,Julien Gauthier,R,NYI,27,0,0,0,0
4,8484325,Waltteri Merela,C,TBL,26,0,0,0,0
4,8479066,Ryan Lomberg,L,FLA,30,0,0,0,0
4,8477070,Liam O'Brien,C,ARI,30,0,0,0,0
4,8478146,Matthew Highmore,C,OTT,28,0,0,0,0
4,8478028,Fredrik Olofsson,L,COL,28,0,0,0,0
4,8480880,Jakub Lauko,C,BOS,24,0,0,0,0
4,8479968,Vinni Lettieri,C,MIN,29,0,0,0,0
4,8474709,Matt Martin,L,NYI,35,0,0,0,0
4,8480845,Rasmus Kupari,C,WPG,24,0,0,0,0
4,8481550,Adam Beckman,L,MIN,23,0,0,0,0
4,8481422,Jacob Lucchini,C,MIN,29,0,0,0,0
4,8477401,John Hayden,C,SEA,29,0,0,0,0
4,8478904,Steven Lorentz,C,FLA,28,0,0,0,0
4,8482088,Justin Sourdif,R,FLA,22,0,0,0,0
4,8482751,Ryan Winterton,C,SEA,21,0,0,0,0
4,8482241,Radim Zohorna,L,PIT,28,0,0,0,0
4,8481690,Tyler Angle,C,CBJ,24,0,0,0,0
4,8476952,Dominic Toninato,C,WPG,30,0,0,0,0
4,8476919,Chris Tierney,C,NJD,30,0,0,0,0
4,8480032,Shane Bowers,C,NJD,25,0,0,0,0
4,8484314,Jiri Smejkal,L,OTT,28,0,0,0,0
4,8481239,Samuel Fagemo,L,LAK,24,0,0,0,0
4,8481532,Alex Turcotte,C,LAK,23,0,0,0,0
4,8481019,David Gustafsson,C,WPG,24,0,0,0,0
4,8478477,Mitchell Stephens,C,MTL,27,0,0,0,0
4,8479546,Oskar Steen,C,BOS,26,0,0,0,0
4,8480292,Carson Meyer,R,CBJ,27,0,0,0,0
4,8478446,Glenn Gawdin,C,ANA,27,0,0,0,0
4,8483531,Brian Halonen,L,NJD,25,0,0,0,0
4,8477149,Scott Sabourin,R,SJS,32,0,0,0,0
4,8479972,Mason Shaw,C,MIN,26,0,0,0,0
4,8480890,Jan Jenik,R,ARI,24,0,0,0,0
4,8478051,Max Willman,C,NJD,29,0,0,0,0
4,8480851,Akil Thomas,C,LAK,24,0,0,0,0
4,8482765,Isak Rosen,R,BUF,21,0,0,0,0
4,8478421,A.J. Greer,L,CGY,28,0,0,0,0
4,8478512,Austin Czarnik,C,DET,32,0,0,0,0
4,8479536,Axel Jonsson-Fjallby,L,WPG,26,0,0,0,0
4,8477320,Anton Blidh,L,NYR,29,0,0,0,0
4,8481543,Nikita Alexandrov,C,STL,24,0,0,0,0
4,8475235,Nicolas Deslauriers,L,PHI,33,0,0,0,0
4,8481070,Hugh McGing,L,STL,26,0,0,0,0
4,8480836,Jonathan Gruden,C,PIT,24,0,0,0,0
4,8481591,Sam Poulin,R,PIT,23,0,0,0,0
4,8477962,Brendan Lemieux,L,CAR,28,0,0,0,0
4,8483401,Marc Johnstone,R,PIT,28,0,0,0,0
4,8482250,Callahan Burke,C,CAR,27,0,0,0,0
4,8481726,Adam Edstrom,C,NYR,24,0,0,0,0
4,8471817,Ryan Reaves,R,TOR,37,0,0,0,0
4,8479587,Rhett Gardner,C,PHI,28,0,0,0,0
4,8475766,Austin Watson,L,TBL,32,0,0,0,0
4,8479367,William Lockwood,R,FLA,26,0,0,0,0
4,8478424,Jansen Harkins,C,PIT,27,0,0,0,0
4,8476913,Devin Shore,C,SEA,30,0,0,0,0
4,8482652,Walker Duehr,R,CGY,27,0,0,0,0
4,8477527,Ross Johnston,L,ANA,30,0,0,0,0
4,8481077,John Leonard,L,ARI,26,0,0,0,0
4,8483549,Lucas Condotta,L,MTL,27,0,0,0,0
4,8480468,James Hamblin,L,EDM,25,0,0,0,0
4,8476907,Mackenzie MacEachern,L,STL,30,0,0,0,0
4,8479543,Michael Pezzetta,L,MTL,26,0,0,0,0
4,8480355,Mark Kastelic,C,OTT,25,0,0,0,0
4,8482162,Roby Jarventie,L,OTT,22,0,0,0,0
4,8479772,Zack MacEwen,R,OTT,28,0,0,0,0
4,8483597,Milos Kelemen,L,ARI,25,0,0,0,0
4,8479379,Givani Smith,R,SJS,26,0,0,0,0
4,8481655,Cole Schwindt,R,CGY,23,0,0,0,0
4,8479981,Jonah Gadjovich,L,FLA,26,0,0,0,0
4,8482147,Jean-Luc Foudy,C,COL,22,0,0,0,0
4,8484255,Jason Polin,R,COL,25,0,0,0,0
4,8477993,Justin Kirkland,C,ARI,28,0,0,0,0
4,8479249,Andrew Poturalski,C,SEA,30,0,0,0,0
4,8482197,Adam Raska,R,MIN,23,0,0,0,0
4,8475780,Chris Wagner,R,COL,33,0,0,0,0
4,8479533,Joona Koppanen,L,PIT,26,0,0,0,0
4,8481534,Raphael Lavoie,C,EDM,24,0,0,0,0
4,8484321,Nikolas Matinpalo,D,OTT,26,0,0,0,0
4,8481043,Cole Koepke,L,TBL,26,0,0,0,0
4,8476323,Max McCormick,L,SEA,32,0,0,0,0
4,8483609,Adam Klapka,R,CGY,24,0,0,0,0
4,8483512,Matt Savoie,C,BUF,20,0,0,0,0
4,8484259,Ondrej Pavel,C,COL,31,0,0,0,0
4,8478147,Bokondji Imama,L,OTT,28,0,0,0,0
4,8482460,Matt Rempe,C,NYR,22,0,0,0,0
4,8477073,Kurtis MacDermid,L,NJD,30,0,0,0,0
4,8480274,Philip Kemp,D,EDM,25,0,0,0,0
4,8478956,Samuel Laberge,L,NJD,27,0,0,0,0
4,8483045,Cameron Butler,R,CBJ,31,0,0,0,0
5,8477492,Nathan MacKinnon,C,COL,29,82,51,74,125
5,8478402,Connor McDavid,C,EDM,27,82,33,91,124
5,8479318,Auston Matthews,C,TOR,27,82,62,45,107
5,8477956,David Pastrnak,R,BOS,28,82,47,60,107
5,8476453,Nikita Kucherov,R,TBL,31,82,28,77,105
5,8478864,Kirill Kaprizov,L,MIN,27,82,52,52,104
5,8480069,Cale Makar,D,COL,26,82,22,77,99
5,8479314,Matthew Tkachuk,L,FLA,27,82,32,62,94
5,8471675,Sidney Crosby,C,PIT,37,82,39,53,92
5,8477934,Leon Draisaitl,C,EDM,29,82,31,61,92
5,8476887,Filip Forsberg,L,NSH,30,82,40,50,90
5,8478550,Artemi Panarin,L,NYR,33,82,28,62,90
5,8481559,Jack Hughes,C,NJD,23,82,33,56,89
5,8477493,Aleksander Barkov,C,FLA,29,82,28,58,86
5,8478420,Mikko Rantanen,R,COL,28,82,33,52,85
5,8479337,Alex DeBrincat,R,DET,27,82,33,52,85
5,8477416,Oliver Bjorkstrand,R,SEA,29,82,33,52,85
5,8474600,Roman Josi,D,NSH,34,82,23,61,84
5,8479385,Jordan Kyrou,C,STL,26,82,42,40,82
5,8477939,William Nylander,R,TOR,28,82,27,55,82
5,8480801,Brady Tkachuk,L,OTT,25,82,41,39,80
5,8478010,Brayden Point,C,TBL,28,82,38,42,80
5,8479343,Clayton Keller,R,ARI,26,82,36,44,80
5,8480012,Elias Pettersson,C,VAN,26,82,30,50,80
5,8478445,Mathew Barzal,C,NYI,27,82,23,55,78
5,8474141,Patrick Kane,R,DET,36,82,26,51,77
5,8476346,Johnny Gaudreau,L,CBJ,31,82,25,52,77
5,8477501,Valeri Nichushkin,R,COL,29,82,33,43,76
5,8479323,Adam Fox,D,NYR,26,82,14,61,75
5,8477933,Sam Reinhart,C,FLA,29,82,38,36,74
5,8477942,Kevin Fiala,L,LAK,28,82,29,45,74
5,8479420,Tage Thompson,C,BUF,27,82,35,38,73
5,8480002,Nico Hischier,C,NJD,25,82,33,40,73
5,8481557,Matt Boldy,L,MIN,23,82,32,41,73
5,8478427,Sebastian Aho,C,CAR,27,82,31,42,73
5,8477409,Carter Verhaeghe,C,FLA,29,82,30,43,73
5,8475172,Nazem Kadri,C,CGY,34,82,27,46,73
5,8473419,Brad Marchand,L,BOS,36,82,30,42,72
5,8475913,Mark Stone,R,VGK,32,82,30,42,72
5,8478398,Kyle Connor,L,WPG,28,82,32,39,71
5,8480027,Jason Robertson,L,DAL,25,82,26,45,71
5,8479325,Charlie McAvoy,D,BOS,27,82,14,57,71
5,8475786,Zach Hyman,L,EDM,32,82,44,26,70
5,8474564,Steven Stamkos,C,TBL,34,82,31,39,70
5,8480036,Miro Heiskanen,D,DAL,25,82,17,53,70
5,8480800,Quinn Hughes,D,VAN,25,82,13,57,70
5,8477951,Nick Schmaltz,C,ARI,28,82,32,37,69
5,8478439,Travis Konecny,R,PHI,27,82,31,38,69
5,8475166,John Tavares,C,TOR,34,82,36,31,67
5,8477935,Sam Bennett,C,FLA,28,82,36,31,67
5,8478403,Jack Eichel,C,VGK,28,82,35,32,67
5,8480208,Drake Batherson,R,OTT,26,82,33,34,67
5,8476389,Vincent Trocheck,C,NYR,31,82,28,39,67
5,8480018,Nick Suzuki,C,MTL,25,82,28,39,67
5,8477404,Jake Guentzel,C,CAR,30,82,27,40,67
5,8476468,J.T. Miller,C,VAN,31,82,25,42,67
5,8477949,Alex Tuch,R,BUF,28,82,25,42,67
5,8480023,Robert Thomas,C,STL,25,82,19,48,67
5,8482116,Tim Stützle,C,OTT,22,82,14,53,67
5,8475784,Jeff Skinner,C,BUF,32,82,33,33,66
5,8480865,Noah Dobson,D,NYI,24,82,12,54,66
5,8475754,Brock Nelson,C,NYI,33,82,32,33,65
5,8471215,Evgeni Malkin,C,PIT,38,82,28,37,65
5,8478440,Dylan Strome,C,WSH,27,82,23,42,65
5,8475745,Charlie Coyle,C,BOS,32,82,22,43,65
5,8481523,Kirby Dach,C,MTL,23,82,13,52,65
5,8478414,Timo Meier,R,NJD,28,82,34,30,64
5,8477940,Nikolaj Ehlers,L,WPG,28,82,32,32,64
5,8475158,Ryan O'Reilly,C,NSH,33,82,22,42,64
5,8480031,Maxime Comtois,L,CAR,25,82,21,43,64
5,8480839,Rasmus Dahlin,D,BUF,24,82,17,47,64
5,8477946,Dylan Larkin,C,DET,28,82,34,29,63
5,8476462,Dougie Hamilton,D,NJD,31,82,15,48,63
5,8482093,Seth Jarvis,C,CAR,22,82,31,31,62
5,8478975,Mason Marchment,L,DAL,29,82,29,33,62
5,8478042,Viktor Arvidsson,R,LAK,31,82,28,34,62
5,8476459,Mika Zibanejad,C,NYR,31,82,27,35,62
5,8482078,Lucas Raymond,L,DET,22,82,25,37,62
5,8475798,Mikael Granlund,C,SJS,32,82,17,45,62
5,8478444,Brock Boeser,R,VAN,27,82,29,32,61
5,8471214,Alex Ovechkin,L,WSH,39,82,27,34,61
5,8473994,Jamie Benn,L,DAL,35,82,26,35,61
5,8476454,Ryan Nugent-Hopkins,C,EDM,31,82,21,40,61
5,8475168,Matt Duchene,C,DAL,33,82,25,35,60
5,8480830,Andrei Svechnikov,R,CAR,24,82,20,40,60
5,8474586,Jordan Eberle,R,SEA,34,82,17,43,60
5,8479407,Jesper Bratt,L,NJD,26,82,26,33,59
5,8475765,Vladimir Tarasenko,R,FLA,33,82,21,38,59
5,8478438,Tommy Novak,C,NSH,27,82,18,41,59
5,8475810,Bryan Rust,R,PIT,32,82,28,30,58
5,8479339,Patrik Laine,L,CBJ,26,82,24,34,58
5,8470794,Joe Pavelski,C,DAL,40,82,19,39,58
5,8477402,Pavel Buchnevich,L,STL,29,82,28,29,57
5,8477500,Bo Horvat,C,NYI,29,82,27,30,57
5,8477504,Josh Morrissey,D,WPG,29,82,16,41,57
5,8482097,Jack Quinn,R,BUF,23,82,16,41,57
5,8475692,Mats Zuccarello,R,MIN,37,82,13,44,57
5,8474590,John Carlson,D,WSH,34,82,12,45,57
5,8479542,Brandon Hagel,L,TBL,26,82,26,30,56
5,8480039,Martin Necas,C,CAR,25,82,21,35,56
5,8482684,Luke Hughes,D,NJD,21,82,13,43,56
5,8475726,Tyler Toffoli,C,WPG,32,82,31,24,55
5,8477955,Jared McCann,L,SEA,28,82,24,31,55
5,8471685,Anze Kopitar,C,LAK,37,82,23,32,55
5,8475167,Victor Hedman,D,TBL,34,82,7,48,55
5,8473512,Claude Giroux,R,OTT,36,82,27,27,54
5,8475184,Chris Kreider,L,NYR,33,82,26,28,54
5,8478401,Pavel Zacha,C,BOS,27,82,19,35,54
5,8481542,Moritz Seider,D,DET,23,82,18,36,54
5,8478038,Devon Toews,D,COL,30,82,14,40,54
5,8481528,Dylan Cozens,C,BUF,23,82,23,30,53
5,8478493,Joel Eriksson Ek,C,MIN,27,82,22,31,53
5,8482745,Mason McTavish,C,ANA,21,82,20,33,53
5,8476432,Boone Jenner,C,CBJ,31,82,31,21,52
5,8478449,Roope Hintz,C,DAL,28,82,21,31,52
5,8474102,David Perron,L,DET,36,82,21,31,52
5,8478047,Michael Bunting,L,PIT,29,82,15,37,52
5,8477503,Max Domi,C,TOR,29,82,14,38,52
5,8476456,Jonathan Huberdeau,C,CGY,31,82,13,39,52
5,8474679,Gustav Nyquist,C,NSH,35,82,13,39,52
5,8477495,Seth Jones,D,CHI,30,82,13,39,52
5,8475794,Tyler Seguin,C,DAL,32,82,24,27,51
5,8477496,Elias Lindholm,C,VAN,30,82,24,27,51
5,8481618,Alex Newhook,C,MTL,23,82,23,28,51
5,8478873,Troy Terry,R,ANA,27,82,21,30,51
5,8482667,William Eklund,L,SJS,22,82,21,30,51
5,8481533,Trevor Zegras,C,ANA,23,82,20,31,51
5,8475744,Evgeny Kuznetsov,C,CAR,32,82,13,38,51
5,8478396,Noah Hanifin,D,VGK,27,82,12,39,51
5,8478407,Vince Dunn,D,SEA,28,82,9,42,51
5,8481581,Thomas Harley,D,DAL,23,82,9,42,51
5,8481540,Cole Caufield,R,MTL,23,82,32,18,50
5,8482740,Wyatt Johnston,C,DAL,21,82,28,22,50
5,8484144,Connor Bedard,C,CHI,19,82,25,25,50
5,8476880,Tom Wilson,R,WSH,30,82,22,28,50
5,8476882,Teuvo Teravainen,L,CAR,30,82,19,31,50
5,8478542,Evan Rodrigues,C,FLA,31,82,17,33,50
5,8475753,Justin Faulk,D,STL,32,82,15,35,50
5,8481711,Matias Maccelli,L,ARI,24,82,13,37,50
5,8474578,Erik Karlsson,D,PIT,34,82,7,43,50
5,8483397,Marc McLaughlin,C,BOS,25,82,42,7,49
5,8483524,Shane Wright,C,SEA,20,82,38,11,49
5,8477476,Artturi Lehkonen,L,COL,29,82,29,20,49
5,8477960,Adrian Kempe,R,LAK,28,82,20,29,49
5,8476483,Rickard Rakell,R,PIT,31,82,18,31,49
5,8474563,Drew Doughty,D,LAK,35,82,15,34,49
5,8476906,Shayne Gostisbehere,D,DET,31,82,15,34,49
5,8480803,Evan Bouchard,D,EDM,25,82,7,42,49
5,8482109,Alexis Lafrenière,L,NYR,23,82,29,19,48
5,8476399,Blake Coleman,C,CGY,33,82,28,20,48
5,8478233,Andrew Mangiapane,L,CGY,28,82,25,23,48
5,8475151,Kyle Palmieri,C,NYI,33,82,25,23,48
5,8480188,Fabian Zetterlund,L,SJS,25,82,25,23,48
5,8481596,Shane Pinto,C,OTT,24,82,22,26,48
5,8482665,Matty Beniers,C,SEA,22,82,18,30,48
5,8482124,Quinton Byfield,R,LAK,22,82,18,30,48
5,8475170,Brayden Schenn,C,STL,33,82,17,31,48
5,8479345,Jakob Chychrun,D,OTT,26,82,15,33,48
5,8480434,Sean Durzi,D,ARI,26,82,11,37,48
5,8477447,Shea Theodore,D,VGK,29,82,10,38,48
5,8476853,Morgan Rielly,D,TOR,30,82,7,41,48
5,8480015,Owen Tippett,R,PHI,25,82,26,21,47
5,8474157,Max Pacioretty,L,WSH,36,82,28,18,46
5,8477451,Ryan Hartman,R,MIN,30,82,25,21,46
5,8478498,Jake DeBrusk,L,BOS,28,82,20,26,46
5,8476869,Brady Skjei,D,CAR,30,82,15,31,46
5,8480797,Joel Farabee,L,PHI,24,82,14,32,46
5,8475763,Kevin Hayes,R,STL,32,82,13,33,46
5,8482110,Dawson Mercer,C,NJD,23,82,23,22,45
5,8481624,Ilya Mikheyev,R,VAN,30,82,22,23,45
5,8477964,Ivan Barbashev,C,VGK,29,82,20,25,45
5,8481068,Yegor Sharangovich,C,CGY,26,82,19,26,45
5,8479400,Pierre-Luc Dubois,L,LAK,26,82,18,27,45
5,8473986,Alex Killorn,L,ANA,35,82,14,31,45
5,8478460,Zach Werenski,D,CBJ,27,82,12,33,45
5,8470613,Brent Burns,D,CAR,39,82,12,33,45
5,8474565,Alex Pietrangelo,D,VGK,34,82,7,38,45
5,8479410,Mikhail Sergachev,D,TBL,26,82,7,38,45
5,8475314,Anders Lee,L,NYI,34,82,29,15,44
5,8480014,Gabriel Vilardi,C,WPG,25,82,26,18,44
5,8476460,Mark Scheifele,C,WPG,31,82,23,21,44
5,8478366,Frank Vatrano,R,ANA,30,82,20,24,44
5,8478519,Anthony Cirelli,C,TBL,27,82,20,24,44
5,8477444,Andre Burakovsky,L,SEA,29,82,15,29,44
5,8476479,Phillip Danault,C,LAK,31,82,21,22,43
5,8482175,JJ Peterka,R,BUF,22,82,20,23,43
5,8478046,Danton Heinen,L,BOS,29,82,19,24,43
5,8475791,Taylor Hall,L,CHI,33,82,16,27,43
5,8479999,Casey Mittelstadt,C,COL,26,82,15,28,43
5,8475191,Reilly Smith,R,PIT,33,82,14,29,43
5,8482475,Yegor Chinakhov,R,CBJ,23,82,14,29,43
5,8475197,Tyson Barrie,D,NSH,33,82,13,30,43
5,8479987,Morgan Geekie,C,BOS,26,82,9,34,43
5,8471724,Kris Letang,D,PIT,37,82,8,35,43
5,8476925,Colton Sissons,C,NSH,31,82,22,20,42
5,8476539,Jonathan Marchessault,R,VGK,34,82,21,21,42
5,8476448,William Karlsson,C,VGK,31,82,19,23,42
5,8476881,Tomas Hertl,C,VGK,31,82,19,23,42
5,8479996,Cody Glass,C,NSH,25,82,19,23,42
5,8483445,Cutter Gauthier,L,ANA,20,82,18,24,42
5,8479992,Michael Rasmussen,C,DET,25,82,18,24,42
5,8479425,Filip Hronek,D,VAN,27,82,7,35,42
5,8484166,Adam Fantilli,C,CBJ,20,82,26,15,41
5,8477932,Aaron Ekblad,D,FLA,28,82,18,23,41
5,8477407,Anthony Duclair,L,TBL,29,82,17,24,41
5,8482113,Anton Lundell,C,FLA,23,82,16,25,41
5,8477479,Tyler Bertuzzi,L,TOR,29,82,15,26,41
5,8476419,Jean-Gabriel Pageau,C,NYI,32,82,13,28,41
5,8480113,Alex Iafallo,L,WPG,31,82,12,29,41
5,8477456,J.T. Compher,L,DET,29,82,11,30,41
5,8477494,Jonathan Drouin,L,COL,29,82,9,32,41
5,8477346,MacKenzie Weegar,D,CGY,30,82,8,33,41
5,8478397,Rasmus Andersson,D,CGY,28,82,4,37,41
5,8475760,Nick Bjugstad,C,ARI,32,82,23,17,40
5,8479675,Trevor Moore,L,LAK,29,82,16,24,40
5,8480185,Eetu Luostarinen,C,FLA,26,82,15,25,40
5,8476458,Ryan Strome,C,ANA,31,82,15,25,40
5,8477021,Alex Kerfoot,C,ARI,30,82,13,27,40
5,8482671,Owen Power,D,BUF,22,82,12,28,40
5,8481699,Aku Raty,R,ARI,23,82,0,40,40
5,8480849,Barrett Hayton,C,ARI,24,82,22,17,39
5,8474641,Adam Henrique,C,EDM,34,82,20,19,39
5,8483808,Andrei Kuzmenko,L,CGY,28,82,19,20,39
5,8474884,Mike Hoffman,C,SJS,35,82,17,22,39
5,8477986,Brandon Montour,D,FLA,30,82,12,27,39
5,8478472,Mathieu Joseph,R,OTT,27,82,10,29,39
5,8482055,Drew O'Connor,L,PIT,26,82,23,15,38
5,8480009,Eeli Tolvanen,R,SEA,25,82,21,17,38
5,8478856,Conor Garland,R,VAN,28,82,19,19,38
5,8482159,Tyson Foerster,R,PHI,22,82,19,19,38
5,8476981,Josh Anderson,R,MTL,30,82,19,19,38
5,8477497,Sean Monahan,C,WPG,30,82,14,24,38
5,8480802,Ryan McLeod,C,EDM,25,82,14,24,38
5,8476875,Mike Matheson,D,MTL,30,82,13,25,38
5,8478462,Nicolas Roy,C,VGK,27,82,12,26,38
5,8479423,Alex Nylander,L,CBJ,26,82,23,14,37
5,8480064,Josh Norris,C,OTT,25,82,22,15,37
5,8479941,Justin Danforth,R,CBJ,31,82,20,17,37
5,8475848,Brendan Gallagher,R,MTL,32,82,18,19,37
5,8474037,James van Riemsdyk,L,BOS,35,82,16,21,37
5,8476438,Brandon Saad,L,STL,32,82,15,22,37
5,8482705,Cole Sillinger,C,CBJ,21,82,15,22,37
5,8480220,Noah Cates,L,PHI,25,82,14,23,37
5,8480043,Timothy Liljegren,D,TOR,25,82,10,27,37
5,8480871,Adam Boqvist,D,CBJ,24,82,9,28,37
5,8476905,Chandler Stephenson,C,VGK,30,82,8,29,37
5,8483457,Lane Hutson,D,MTL,20,82,1,36,37
5,8482101,Danil Gushchin,L,SJS,22,82,22,14,36
5,8475169,Evander Kane,L,EDM,33,82,18,18,36
5,8482699,Dylan Guenther,R,ARI,21,82,18,18,36
5,8478466,Daniel Sprong,R,DET,27,82,18,18,36
5,8476392,Adam Lowry,C,WPG,31,82,16,20,36
5,8480028,Morgan Frost,C,PHI,25,82,15,21,36
5,8477429,Andrew Copp,C,DET,30,82,15,21,36
5,8481580,Connor McMichael,C,WSH,23,82,15,21,36
5,8476826,Yanni Gourde,C,SEA,33,82,11,25,36
5,8478055,Gustav Forsling,D,FLA,28,82,10,26,36
5,8476329,Travis Boyd,C,ARI,31,82,9,27,36
5,8482702,Logan Stankoven,C,DAL,21,82,22,13,35
5,8483515,Juraj Slafkovsky,L,MTL,20,82,15,20,35
5,8474715,Cam Atkinson,R,PHI,35,82,14,21,35
5,8481481,Blake Lizotte,C,LAK,27,82,14,21,35
5,8480855,Jack McBain,C,ARI,24,82,13,22,35
5,8479365,Trent Frederic,C,BOS,26,82,13,22,35
5,8475799,Nino Niederreiter,R,WPG,32,82,12,23,35
5,8474150,Mikael Backlund,C,CGY,35,82,11,24,35
5,8476792,Torey Krug,D,STL,33,82,8,27,35
5,8482105,Jake Sanderson,D,OTT,22,82,7,28,35
5,8480873,Rasmus Sandin,D,WSH,24,82,6,29,35
5,8477426,Nicholas Paul,L,TBL,29,82,22,12,34
5,8476885,Jacob Trouba,D,NYR,30,82,15,19,34
5,8478891,Mason Appleton,C,WPG,28,82,11,23,34
5,8482092,Ridly Greig,C,OTT,22,82,9,25,34
5,8476927,Teddy Blueger,C,VAN,30,82,9,25,34
5,8481703,Valtteri Puustinen,R,PIT,25,82,7,27,34
5,8478474,Lawson Crouse,L,ARI,27,82,16,17,33
5,8478458,Jack Roslovic,C,NYR,27,82,14,19,33
5,8473422,Nick Foligno,L,CHI,37,82,12,21,33
5,8482222,Alexander Barabanov,L,SJS,30,82,12,21,33
5,8475768,Jaden Schwartz,C,SEA,32,82,11,22,33
5,8478469,Thomas Chabot,D,OTT,27,82,10,23,33
5,8474716,Jared Spurgeon,D,MIN,35,82,9,24,33
5,8480336,Sean Walker,D,COL,30,82,9,24,33
5,8480817,K'Andre Miller,D,NYR,24,82,7,26,33
5,8475764,Cam Fowler,D,ANA,33,82,2,31,33
5,8477998,Warren Foegele,L,EDM,28,82,17,15,32
5,8477947,Sonny Milano,L,WSH,28,82,15,17,32
5,8478463,Anthony Beauvillier,L,NSH,27,82,14,18,32
5,8479415,Michael McLeod,C,NJD,26,82,14,18,32
5,8477498,Darnell Nurse,D,EDM,29,82,13,19,32
5,8480459,Pius Suter,C,VAN,28,82,13,19,32
5,8478057,Dakota Joshua,C,VAN,28,82,13,19,32
5,8480798,Philipp Kurashev,C,CHI,25,82,12,20,32
5,8476292,Ondrej Palat,L,NJD,33,82,10,22,32
5,8474673,TJ Brodie,D,TOR,34,82,10,22,32
5,8478133,Jake Evans,C,MTL,28,82,10,22,32
5,8482133,Thomas Bordeleau,C,SJS,22,82,8,24,32
5,8481016,Ruslan Iskhakov,C,NYI,24,82,4,28,32
5,8476931,Jake McCabe,D,TOR,31,82,4,28,32
5,8483471,Brad Lambert,C,WPG,31,82,3,29,32
5,8477952,Robby Fabbri,C,DET,28,82,16,15,31
5,8481560,Arthur Kaliyev,R,LAK,23,82,16,15,31
5,8473533,Jordan Staal,C,CAR,36,82,16,15,31
5,8477511,Anthony Mantha,R,VGK,30,82,15,16,31
5,8480078,Filip Chytil,C,NYR,25,82,12,19,31
5,8476921,Jordan Martinook,L,CAR,32,82,12,19,31
5,8477488,Brett Pesce,D,CAR,30,82,7,24,31
5,8474151,Ryan McDonagh,D,NSH,35,82,5,26,31
5,8476854,Hampus Lindholm,D,BOS,30,82,4,27,31
5,8480145,Neal Pionk,D,WPG,29,82,4,27,31
5,8475171,Oliver Ekman-Larsson,D,FLA,33,82,4,27,31
5,8482122,Brock Faber,D,MIN,22,82,3,28,31
5,8477944,Jakub Vrana,L,STL,28,82,20,10,30
5,8478109,Victor Olofsson,L,BUF,29,82,18,12,30
5,8479977,Kailer Yamamoto,R,SEA,26,82,14,16,30
5,8478413,Jordan Greenway,L,BUF,27,82,13,17,30
5,8471698,T.J. Oshie,R,WSH,38,82,13,17,30
5,8477508,Curtis Lazar,C,NJD,29,82,13,17,30
5,8479353,Brett Howden,C,VGK,26,82,11,19,30
5,8475220,Marcus Foligno,L,MIN,33,82,11,19,30
5,8474053,Logan Couture,C,SJS,35,82,10,20,30
5,8477839,Conor Sheary,L,TBL,32,82,10,20,30
5,8476979,Erik Gustafsson,D,NYR,32,82,5,25,30
5,8476958,Jaccob Slavin,D,CAR,30,82,2,28,30
5,8475722,Jason Zucker,L,NSH,32,82,20,9,29
5,8474870,Tyler Johnson,C,CHI,34,82,15,14,29
5,8479525,Ross Colton,C,COL,28,82,15,14,29
5,8483499,Liam Ohgren,L,MIN,20,82,14,15,29
5,8481601,Simon Holmstrom,R,NYI,23,82,14,15,29
5,8481186,Logan O'Connor,R,COL,28,82,12,17,29
5,8481656,Aliaksei Protas,C,WSH,23,82,11,18,29
5,8476960,Andreas Athanasiou,C,CHI,30,82,10,19,29
5,8481013,Jonatan Berggren,R,DET,24,82,10,19,29
5,8480068,Ryan Poehling,C,PHI,25,82,10,19,29
5,8479390,Taylor Raddysh,R,CHI,26,82,9,20,29
5,8476457,Adam Larsson,D,SEA,32,82,9,20,29
5,8481522,Peyton Krebs,C,BUF,23,82,8,21,29
5,8479369,Andrew Peeke,D,BOS,26,82,5,24,29
5,8476923,Damon Severson,D,CBJ,30,82,4,25,29
5,8480821,Filip Zadina,R,SJS,25,82,16,12,28
5,8475343,Nic Dowd,C,WSH,34,82,13,15,28
5,8471218,Blake Wheeler,R,NYR,38,82,12,16,28
5,8476469,Joel Armia,R,MTL,31,82,12,16,28
5,8475714,Calle Jarnkrok,C,TOR,33,82,11,17,28
5,8475287,Erik Haula,L,NJD,33,82,10,18,28
5,8475149,Marcus Johansson,L,MIN,34,82,9,19,28
5,8476312,Josh Manson,D,COL,33,82,8,20,28
5,8473507,Jeff Petry,D,DET,37,82,3,25,28
5,8481604,Pavel Dorofeyev,L,VGK,24,82,15,12,27
5,8478020,Michael Amadio,C,VGK,28,82,15,12,27
5,8477330,Dominik Kubalik,L,OTT,29,82,15,12,27
5,8478115,Pierre Engvall,L,NYI,28,82,14,13,27
5,8470604,Jeff Carter,C,PIT,39,82,14,13,27
5,8474189,Lars Eller,C,PIT,35,82,13,14,27
5,8476624,Barclay Goodrow,C,NYR,31,82,13,14,27
5,8481517,Brett Leason,R,ANA,25,82,13,14,27
5,8480144,David Kampf,C,TOR,29,82,13,14,27
5,8482624,Daniil Miromanov,D,CGY,27,82,11,16,27
5,8482111,Justin Barron,D,MTL,23,82,10,17,27
5,8474149,Evgenii Dadonov,R,DAL,35,82,9,18,27
5,8475218,Mattias Ekholm,D,EDM,34,82,8,19,27
5,8473563,Nicklas Backstrom,C,WSH,37,82,8,19,27
5,8475181,Nick Leddy,D,STL,33,82,6,21,27
5,8475790,Erik Gudbranson,D,CBJ,32,82,6,21,27
5,8477506,Ryan Pulock,D,NYI,30,82,5,22,27
5,8478500,Ivan Provorov,D,CBJ,27,82,3,24,27
5,8482146,Luke Evangelista,R,NSH,22,82,13,13,26
5,8477989,Christian Dvorak,C,MTL,28,82,13,13,26
5,8483505,Matthew Poitras,C,BOS,20,82,12,14,26
5,8477425,Miles Wood,L,COL,29,82,12,14,26
5,8479293,Brandon Tanev,L,SEA,33,82,11,15,26
5,8482089,Jake Neighbours,L,STL,22,82,11,15,26
5,8484153,Leo Carlsson,C,ANA,20,82,11,15,26
5,8480893,Kirill Marchenko,R,CBJ,24,82,11,15,26
5,8478013,Jake Walman,D,DET,28,82,11,15,26
5,8480813,Joe Veleno,C,DET,24,82,11,15,26
5,8482079,Marco Rossi,C,MIN,23,82,9,17,26
5,8477953,Kasperi Kapanen,R,STL,28,82,9,17,26
5,8477505,Alexander Wennberg,C,NYR,30,82,9,17,26
5,8482720,Matthew Knies,L,TOR,22,82,8,18,26
5,8481537,Nikita Okhotiuk,D,CGY,24,82,8,18,26
5,8481546,Cam York,D,PHI,23,82,6,20,26
5,8475279,Ben Chiarot,D,DET,33,82,6,20,26
5,8481606,Jordan Spence,D,LAK,23,82,6,20,26
5,8477435,Ryan Graves,D,PIT,29,82,6,20,26
5,8476467,Jamie Oleksiak,D,SEA,32,82,5,21,26
5,8476331,Dylan DeMelo,D,WPG,31,82,3,23,26
5,8477220,Nate Schmidt,D,WPG,33,82,2,24,26
5,8470610,Zach Parise,L,COL,40,82,18,7,25
5,8483431,Logan Cooley,C,ARI,20,82,16,9,25
5,8476872,Scott Laughton,C,PHI,30,82,14,11,25
5,8479316,Luke Kunin,C,SJS,27,82,13,12,25
5,8483491,Ivan Miroshnichenko,L,WSH,20,82,12,13,25
5,8476873,Mark Jankowski,C,NSH,30,82,12,13,25
5,8478569,Noel Acciari,C,PIT,33,82,11,14,25
5,8479351,Sam Steel,C,DAL,26,82,8,17,25
5,8479514,Rem Pitlick,C,CHI,27,82,7,18,25
5,8478911,Matt Roy,D,LAK,29,82,6,19,25
5,8476879,Cody Ceci,D,EDM,31,82,6,19,25
5,8482073,Braden Schneider,D,NYR,23,82,5,20,25
5,8481568,Alex Vlasic,D,CHI,23,82,4,21,25
5,8475906,John Klingberg,D,TOR,32,82,3,22,25
5,8476917,Adam Pelech,D,NYI,30,82,3,22,25
5,8482655,J.J. Moser,D,ARI,24,82,3,22,25
5,8478508,Yakov Trenin,C,COL,27,82,18,6,24
5,8470621,Corey Perry,R,EDM,39,82,16,8,24
5,8476480,Vladislav Namestnikov,C,WPG,32,82,13,11,24
5,8482074,Connor Zary,C,CGY,23,82,13,11,24
5,8480806,Isac Lundestrom,C,ANA,25,82,11,13,24
5,8482259,Bobby McMann,C,TOR,28,82,10,14,24
5,8477507,Nikita Zadorov,D,VAN,29,82,10,14,24
5,8482117,Lukas Reichel,L,CHI,22,82,8,16,24
5,8475200,Dmitry Orlov,D,CAR,33,82,8,16,24
5,8475793,Ryan Johansen,C,PHI,32,82,7,17,24
5,8477919,Frederick Gaudreau,C,MIN,31,82,5,19,24
5,8479976,Juuso Valimaki,D,ARI,26,82,5,19,24
5,8474574,Tyler Myers,D,VAN,34,82,4,20,24
5,8478507,John Marino,D,NJD,27,82,4,20,24
5,8477948,Travis Sanheim,D,PHI,28,82,2,22,24
5,8483493,Frank Nazar,C,CHI,20,82,17,6,23
5,8477450,Jason Dickinson,C,CHI,29,82,14,9,23
5,8479393,Noah Gregor,C,TOR,26,82,14,9,23
5,8476278,Colin Blackwell,C,CHI,31,82,9,14,23
5,8483490,Pavel Mintyukov,D,ANA,21,82,8,15,23
5,8476892,Colton Parayko,D,STL,31,82,6,17,23
5,8478882,Vladislav Gavrikov,D,LAK,29,82,5,18,23
5,8482087,Kaiden Guhle,D,MTL,22,82,5,18,23
5,8482803,Olen Zellweger,D,ANA,21,82,5,18,23
5,8476897,Oskar Sundqvist,C,STL,30,82,4,19,23
5,8476463,Jonas Brodin,D,MIN,31,82,3,20,23
5,8478851,Alexandre Carrier,D,NSH,28,82,3,20,23
5,8482142,Jamie Drysdale,D,PHI,22,82,1,22,23
5,8479398,Samuel Girard,D,COL,26,82,1,22,23
5,8475188,Brayden McNabb,D,VGK,33,82,0,23,23
5,8481554,Kaapo Kakko,R,NYR,23,82,15,7,22
5,8481093,Rafael Harvey-Pinard,L,MTL,25,82,14,8,22
5,8484145,Zach Benson,L,BUF,19,82,13,9,22
5,8484203,Bradly Nadeau,L,CAR,19,82,12,10,22
5,8476461,Sean Couturier,C,PHI,32,82,11,11,22
5,8477969,Marcus Pettersson,D,PIT,28,82,11,11,22
5,8477392,Hudson Fasching,R,NYI,29,82,11,11,22
5,8482062,Cole Smith,L,NSH,29,82,10,12,22
5,8479591,Michael Eyssimont,C,TBL,28,82,9,13,22
5,8473453,Trevor Lewis,C,LAK,37,82,8,14,22
5,8478178,Darren Raddysh,D,TBL,28,82,7,15,22
5,8476374,Sean Kuraly,C,CBJ,31,82,6,16,22
5,8476902,Esa Lindell,D,DAL,30,82,4,18,22
5,8481178,Egor Zamula,D,PHI,24,82,3,19,22
5,8480035,Henri Jokiharju,D,BUF,25,82,1,21,22
5,8482733,Logan Mailloux,D,MTL,31,82,0,22,22
5,8482118,Sam Colangelo,R,ANA,23,82,16,5,21
5,8482666,Scott Morrow,D,CAR,22,82,14,7,21
5,8481535,Nils Hoglander,L,VAN,24,82,11,10,21
5,8473449,Kyle Okposo,R,FLA,36,82,10,11,21
5,8477353,Tyler Motte,C,TBL,29,82,10,11,21
5,8482737,Zack Bolduc,C,STL,21,82,8,13,21
5,8476871,Tanner Pearson,L,MTL,32,82,7,14,21
5,8478443,Brandon Carlo,D,BOS,28,82,7,14,21
5,8476422,Mike Reilly,D,NYI,31,82,5,16,21
5,8478430,Oliver Kylington,D,CGY,27,82,5,16,21
5,8477365,Connor Clifton,D,BUF,29,82,5,16,21
5,8478468,Jeremy Lauzon,D,NSH,27,82,5,16,21
5,8482730,Brandt Clarke,D,LAK,21,82,3,18,21
5,8483466,Kevin Korchinski,D,CHI,20,82,3,18,21
5,8480172,Jan Rutta,D,SJS,34,82,3,18,21
5,8482245,Artem Zub,D,OTT,29,82,3,18,21
5,8482809,Jackson Blake,R,CAR,21,82,14,6,20
5,8479291,Kevin Rooney,C,CGY,31,82,10,10,20
5,8481028,Martin Pospisil,C,CGY,25,82,9,11,20
5,8474166,Alec Martinez,D,VGK,37,82,8,12,20
5,8474034,Pat Maroon,L,BOS,36,82,7,13,20
5,8479998,Mikey Anderson,D,LAK,25,82,5,15,20
5,8480074,Alexandre Texier,C,CBJ,25,82,4,16,20
5,8476891,Matt Grzelcyk,D,BOS,30,82,2,18,20
5,8470966,Mark Giordano,D,TOR,41,82,2,18,20
5,8481553,Bobby Brink,R,PHI,23,82,9,10,19
5,8479346,Dillon Dube,C,CGY,26,82,8,11,19
5,8483482,Tristan Luneau,D,ANA,20,82,7,12,19
5,8476473,Connor Murphy,D,CHI,31,82,6,13,19
5,8475233,David Savard,D,MTL,34,82,5,14,19
5,8477034,Jaycob Megna,D,CHI,32,82,5,14,19
5,8476525,Colin Miller,D,WPG,32,82,3,16,19
5,8480073,Erik Brannstrom,D,OTT,25,82,3,16,19
5,8482712,Oskar Olausson,R,COL,22,82,2,17,19
5,8477845,Trevor van Riemsdyk,D,WSH,33,82,2,17,19
5,8470600,Ryan Suter,D,DAL,39,82,2,17,19
5,8475690,Chris Tanev,D,DAL,35,82,1,18,19
5,8481704,Juuso Parssinen,C,NSH,23,82,9,9,18
5,8476858,Phillip Di Giuseppe,L,VAN,31,82,9,9,18
5,8477406,Mattias Janmark,C,EDM,32,82,8,10,18
5,8482762,Simon Edvinsson,D,DET,21,82,7,11,18
5,8482155,Alex Laferriere,R,LAK,23,82,6,12,18
5,8478136,Jake Middleton,D,MIN,28,82,6,12,18
5,8483495,Simon Nemec,D,NJD,20,82,6,12,18
5,8482470,Ilya Solovyov,D,CGY,24,82,5,13,18
5,8476967,Brett Kulak,D,EDM,30,82,4,14,18
5,8477335,Kyle Burroughs,D,SJS,29,82,4,14,18
5,8482166,Shakir Mukhamadullin,D,SJS,22,82,3,15,18
5,8478859,Niko Mikkola,D,FLA,28,82,3,15,18
5,8480246,Nick Perbix,D,TBL,26,82,2,16,18
5,8480807,Mattias Samuelsson,D,BUF,24,82,1,17,18
5,8479661,Tanner Jeannot,L,TBL,27,82,10,7,17
5,8480980,Connor Dewar,C,TOR,25,82,9,8,17
5,8479359,Beck Malenstyn,L,WSH,26,82,8,9,17
5,8475231,Casey Cizikas,C,NYI,33,82,7,10,17
5,8478831,Kevin Stenlund,C,FLA,28,82,7,10,17
5,8482125,Alexander Holtz,R,NJD,22,82,6,11,17
5,8484911,Collin Graf,R,SJS,22,82,6,11,17
5,8478399,Jonas Siegenthaler,D,NJD,27,82,5,12,17
5,8481524,Bowen Byram,D,BUF,23,82,5,12,17
5,8479980,Nicolas Hague,D,VGK,26,82,4,13,17
5,8483565,Nick Blankenburg,D,CBJ,26,82,3,14,17
5,8477369,Carson Soucy,D,VAN,30,82,3,14,17
5,8480834,Ty Emberson,D,SJS,24,82,3,14,17
5,8481567,Henry Thrun,D,SJS,23,82,2,15,17
5,8482145,Mavrik Bourque,C,DAL,22,82,15,1,16
5,8478043,Sam Lafferty,C,VAN,29,82,11,5,16
5,8476878,Zemgus Girgensons,L,BUF,30,82,10,6,16
5,8483012,Logan Morrison,C,SEA,22,82,8,8,16
5,8478451,Ethan Bear,D,WSH,27,82,7,9,16
5,8476429,Scott Mayfield,D,NYI,32,82,5,11,16
5,8475179,Dmitry Kulikov,D,FLA,34,82,4,12,16
5,8481605,Jackson LaCombe,D,ANA,23,82,4,12,16
5,8479371,Dante Fabbro,D,NSH,26,82,2,14,16
5,8481477,Nico Sturm,C,SJS,29,82,9,6,15
5,8480281,Alexey Toropchenko,R,STL,25,82,8,7,15
5,8476442,Matt Nieto,L,PIT,32,82,7,8,15
5,8473504,Cal Clutterbuck,R,NYI,37,82,6,9,15
5,8482679,Matt Coronato,R,CGY,22,82,4,11,15
5,8481059,Scott Perunovich,D,STL,26,82,4,11,15
5,8479442,Troy Stecher,D,EDM,30,82,4,11,15
5,8475208,Brian Dumoulin,D,SEA,33,82,3,12,15
5,8478416,Erik Cernak,D,TBL,27,82,1,14,15
5,8474009,Nick Bonino,C,NYR,36,82,8,6,14
5,8476915,Jujhar Khaira,L,MIN,30,82,8,6,14
5,8475164,Jakob Silfverberg,R,ANA,34,82,5,9,14
5,8477931,Tomas Nosek,L,NJD,32,82,5,9,14
5,8475842,Sam Carrick,C,EDM,32,82,5,9,14
5,8481014,Alexander Romanov,D,NYI,24,82,5,9,14
5,8481578,Graeme Clarke,R,NJD,23,82,4,10,14
5,8482516,Matthew Kessel,D,STL,24,82,4,10,14
5,8478840,Will Borgen,D,SEA,28,82,3,11,14
5,8474013,Ian Cole,D,VAN,35,82,3,11,14
5,8479324,Ryan Lindgren,D,NYR,26,82,2,12,14
5,8480990,Declan Chisholm,D,MIN,24,82,4,9,13
5,8479983,Mario Ferraro,D,SJS,26,82,3,10,13
5,8475825,Jani Hakanpää,D,DAL,32,82,2,11,13
5,8475762,Derek Forbort,D,BOS,32,82,1,12,13
5,8475462,Radko Gudas,D,ANA,34,82,1,12,13
5,8483763,Maksymilian Szuber,D,ARI,22,82,5,7,12
5,8477499,Rasmus Ristolainen,D,PHI,30,82,4,8,12
5,8477015,Connor Brown,R,EDM,30,82,3,9,12
5,8480860,Kevin Bahl,D,NJD,24,82,1,11,12
5,8474567,Zach Bogosian,D,MIN,34,82,0,12,12
5,8482858,Ryker Evans,D,SEA,23,82,3,8,11
5,8482713,Mackie Samoskevich,R,FLA,22,82,3,8,11
5,8480796,Martin Fehervary,D,WSH,25,82,2,9,11
5,8480058,Pierre-Olivier Joseph,D,PIT,25,82,1,10,11
5,8471677,Jack Johnson,D,COL,37,82,0,11,11
5,8481599,Victor Soderstrom,D,ARI,23,82,6,4,10
5,8479383,Boris Katchouk,L,OTT,26,82,4,6,10
5,8484149,Gavin Brindley,C,CBJ,20,82,3,7,10
5,8483489,Fraser Minten,C,TOR,31,82,3,7,10
5,8483468,Jiri Kulich,C,BUF,20,82,1,9,10
5,8475177,Calvin de Haan,D,TBL,33,82,1,9,10
5,8482859,Zack Ostapchuk,C,OTT,21,82,0,10,10
5,8476822,Luke Glendening,C,TBL,35,82,6,3,9
5,8481030,Jack St. Ivany,D,PIT,25,82,5,4,9
5,8480448,Parker Kelly,L,OTT,25,82,3,6,9
5,8478408,Travis Dermott,D,ARI,28,82,3,6,9
5,8475455,Brenden Dillon,D,WPG,34,82,2,7,9
5,8475324,Nick Jensen,D,WSH,34,82,0,9,9
5,8480879,Jacob Bernard-Docker,D,OTT,24,82,1,7,8
5,8476372,Nick Seeler,D,PHI,31,82,0,8,8
5,8482807,Ethan Del Mastro,D,CHI,21,82,3,4,7
5,8482177,Marat Khusnutdinov,C,MIN,22,82,1,4,5
5,8482141,Lukas Cormier,D,VGK,22,0,0,0,0
5,8476988,Matt Benning,D,SJS,30,0,0,0,0
5,8480727,Zach Whitecloud,D,VGK,28,0,0,0,0
5,8480887,Jordan Harris,D,MTL,24,0,0,0,0
5,8478450,Parker Wotherspoon,D,BOS,27,0,0,0,0
5,8481812,Nikolai Knyzhov,D,SJS,27,0,0,0,0
5,8480001,Urho Vaakanainen,D,ANA,25,0,0,0,0
5,8482176,Wyatt Kaiser,D,CHI,22,0,0,0,0
5,8481122,Simon Benoit,D,TOR,26,0,0,0,0
5,8476441,Joel Edmundson,D,TOR,31,0,0,0,0
5,8480884,Calen Addison,D,SJS,24,0,0,0,0
5,8482511,Mason Lohrei,D,BOS,23,0,0,0,0
5,8482192,Isaak Phillips,D,CHI,23,0,0,0,0
5,8480950,Ilya Lyubushkin,D,TOR,30,0,0,0,0
5,8474031,Kevin Shattenkirk,D,BOS,35,0,0,0,0
5,8475718,Justin Holl,D,DET,32,0,0,0,0
5,8479402,Jake Bean,D,CBJ,26,0,0,0,0
5,8474602,Justin Schultz,D,SEA,34,0,0,0,0
5,8477950,Tony DeAngelo,D,CAR,29,0,0,0,0
5,8481743,Marc Del Gaizo,D,NSH,25,0,0,0,0
5,8481527,Kaedan Korczak,D,VGK,23,0,0,0,0
5,8480192,Johnathan Kovacevic,D,MTL,27,0,0,0,0
5,8476874,Olli Maatta,D,DET,30,0,0,0,0
5,8482144,Jack Thompson,D,SJS,22,0,0,0,0
5,8480222,Sebastian Aho,D,NYI,28,0,0,0,0
5,8479458,Nikita Zaitsev,D,CHI,33,0,0,0,0
5,8471709,Marc-Edouard Vlasic,D,SJS,37,0,0,0,0
5,8482929,Emil Lilleberg,D,TBL,23,0,0,0,0
5,8477018,Ben Hutton,D,VGK,31,0,0,0,0
5,8481056,Spencer Stastney,D,NSH,24,0,0,0,0
5,8481593,Jayden Struble,D,MTL,23,0,0,0,0
5,8479982,Conor Timmins,D,TOR,26,0,0,0,0
5,8474090,Brendan Smith,D,NJD,35,0,0,0,0
5,8482964,Arber Xhekaj,D,MTL,23,0,0,0,0
5,8480891,Michael Kesselring,D,ARI,24,0,0,0,0
5,8477938,Haydn Fleury,D,TBL,28,0,0,0,0
5,8481806,Louis Crevier,D,CHI,23,0,0,0,0
5,8471274,Alex Goligoski,D,MIN,39,0,0,0,0
5,8481600,Tobias Bjornfot,D,FLA,23,0,0,0,0
5,8475797,Jarred Tinordi,D,CHI,32,0,0,0,0
5,8481521,Ronnie Attard,D,PHI,25,0,0,0,0
5,8474612,Travis Hamonic,D,OTT,34,0,0,0,0
5,8479576,Vincent Desharnais,D,EDM,28,0,0,0,0
5,8480049,Dylan Samberg,D,WPG,25,0,0,0,0
5,8483619,Filip Roos,D,CHI,25,0,0,0,0
5,8474568,Luke Schenn,D,NSH,35,0,0,0,0
5,8480184,Gustav Lindstrom,D,ANA,26,0,0,0,0
5,8480070,Ian Mitchell,D,BOS,25,0,0,0,0
5,8480196,Jacob Bryson,D,BUF,27,0,0,0,0
5,8471686,Marc Staal,D,PHI,37,0,0,0,0
5,8477467,Gustav Olofsson,D,SEA,30,0,0,0,0
5,8478970,Jalen Chatfield,D,CAR,28,0,0,0,0
5,8479348,Kale Clague,D,BUF,26,0,0,0,0
5,8473446,Erik Johnson,D,PHI,36,0,0,0,0
5,8477462,Robert Hagg,D,ANA,29,0,0,0,0
5,8478454,Noah Juulsen,D,VAN,27,0,0,0,0
5,8477384,Josh Brown,D,ARI,30,0,0,0,0
5,8481708,Zac Jones,D,NYR,24,0,0,0,0
5,8481167,Brayden Pachal,D,CGY,25,0,0,0,0
5,8482067,Connor Mackey,D,NYR,28,0,0,0,0
5,8483460,David Jiricek,D,CBJ,21,0,0,0,0
5,8481701,Santeri Hatakka,D,NJD,23,0,0,0,0
5,8478021,William Lagesson,D,ANA,28,0,0,0,0
5,8477851,Jordan Oesterle,D,CGY,32,0,0,0,0
5,8478452,Caleb Jones,D,COL,27,0,0,0,0
5,8479984,Cal Foote,D,NJD,26,0,0,0,0
5,8479639,Dylan Coghlan,D,CAR,26,0,0,0,0
5,8480874,Adam Ginning,D,PHI,24,0,0,0,0
5,8479321,Lucas Johansen,D,WSH,27,0,0,0,0
5,8480878,Nils Lundkvist,D,DAL,24,0,0,0,0
5,8482165,Yan Kuznetsov,D,CGY,22,0,0,0,0
5,8484258,Sam Malinski,D,COL,26,0,0,0,0
5,8480157,Calle Rosen,D,STL,30,0,0,0,0
5,8484304,Uvis Balinskis,D,FLA,28,0,0,0,0
5,8479985,Cale Fleury,D,SEA,26,0,0,0,0
5,8479378,Logan Stanley,D,WPG,26,0,0,0,0
5,8477541,Dakota Mermis,D,MIN,30,0,0,0,0
5,8481609,Vladislav Kolyachonok,D,ARI,23,0,0,0,0
5,8480823,Alexander Alexeyev,D,WSH,25,0,0,0,0
5,8481679,Maxence Guenette,D,OTT,23,0,0,0,0
5,8481564,Ryan Johnson,D,BUF,23,0,0,0,0
5,8479376,Victor Mete,D,PHI,26,0,0,0,0
5,8484254,Akito Hirose,D,VAN,25,0,0,0,0
5,8482660,Kent Johnson,C,CBJ,22,0,0,0,0
5,8482149,Cole Perfetti,C,WPG,22,0,0,0,0
5,8477987,Ryan Donato,C,CHI,28,0,0,0,0
5,8475755,Alexander Petrovic,D,DAL,32,0,0,0,0
5,8477810,Joel Hanley,D,CGY,33,0,0,0,0
5,8474145,Robert Bortuzzo,D,NYI,35,0,0,0,0
5,8481161,Jake Christiansen,D,CBJ,25,0,0,0,0
5,8476884,Derrick Pouliot,D,DAL,30,0,0,0,0
5,8481716,Dmitri Voronkov,L,CBJ,24,0,0,0,0
5,8480084,Nick DeSimone,D,NJD,30,0,0,0,0
5,8475750,Jon Merrill,D,MIN,32,0,0,0,0
5,8479315,Joey Anderson,R,CHI,26,0,0,0,0
5,8478011,Louie Belpedio,D,PHI,28,0,0,0,0
5,8482451,Mikael Pyyhtia,L,CBJ,23,0,0,0,0
5,8481541,Samuel Bolduc,D,NYI,24,0,0,0,0
5,8482126,Emil Andrae,D,PHI,31,0,0,0,0
5,8474618,Marco Scandella,D,STL,34,0,0,0,0
5,8477244,Chad Ruhwedel,D,NYR,34,0,0,0,0
5,8477971,Andreas Englund,D,LAK,28,0,0,0,0
5,8480829,Jesperi Kotkaniemi,C,CAR,24,0,0,0,0
5,8479372,Josh Mahura,D,FLA,26,0,0,0,0
5,8482095,Tyler Kleven,D,OTT,22,0,0,0,0
5,8481719,Maxwell Crozier,D,TBL,24,0,0,0,0
5,8475855,Jesper Fast,R,CAR,33,0,0,0,0
5,8480848,Ty Dellandrea,C,DAL,24,0,0,0,0
5,8475193,Tomas Tatar,L,SEA,34,0,0,0,0
5,8476889,Radek Faksa,C,DAL,30,0,0,0,0
5,8478495,Denis Gurianov,R,PHI,27,0,0,0,0
5,8480216,Jacob Peterson,C,SJS,25,0,0,0,0
5,8480252,Cole Guttman,C,CHI,25,0,0,0,0
5,8479026,Philippe Myers,D,TBL,27,0,0,0,0
5,8481006,Tyler Tucker,D,STL,24,0,0,0,0
5,8481032,Paul Cotter,C,VGK,25,0,0,0,0
5,8481577,Philip Tomasino,C,NSH,23,0,0,0,0
5,8476918,Jimmy Vesey,L,NYR,31,0,0,0,0
5,8479320,Max Lajoie,D,TOR,27,0,0,0,0
5,8478017,Mark Friedman,D,VAN,29,0,0,0,0
5,8481754,Nikita Nesterenko,C,ANA,23,0,0,0,0
5,8483407,Brandon Scanlin,D,NYR,25,0,0,0,0
5,8482659,Josh Doan,R,ARI,22,0,0,0,0
5,8477446,Michael McCarron,R,NSH,29,0,0,0,0
5,8477903,Garnet Hathaway,R,PHI,33,0,0,0,0
5,8482153,Brendan Brisson,C,VGK,23,0,0,0,0
5,8483546,Marshall Rifai,D,TOR,26,0,0,0,0
5,8484287,Cole McWard,D,VAN,23,0,0,0,0
5,8478854,Ryan Shea,D,PIT,27,0,0,0,0
5,8481585,Egor Afanasyev,L,NSH,23,0,0,0,0
5,8483398,Declan Carlile,D,TBL,31,0,0,0,0
5,8478502,Dennis Gilbert,D,CGY,28,0,0,0,0
5,8482749,Joshua Roy,R,MTL,21,0,0,0,0
5,8481598,Philip Broberg,D,EDM,23,0,0,0,0
5,8480835,Jack Drury,C,CAR,24,0,0,0,0
5,8480748,Kiefer Sherwood,L,NSH,29,0,0,0,0
5,8476934,Brock McGinn,L,ANA,30,0,0,0,0
5,8480870,Bo Groulx,C,ANA,24,0,0,0,0
5,8479368,Max Jones,L,ANA,26,0,0,0,0
5,8478099,Kevin Labanc,R,SJS,29,0,0,0,0
5,8478067,Oskar Lindblom,L,SJS,28,0,0,0,0
5,8476393,Nick Cousins,C,FLA,31,0,0,0,0
5,8483395,Arshdeep Bains,L,VAN,23,0,0,0,0
5,8480762,Eric Robinson,L,BUF,29,0,0,0,0
5,8479439,Jacob MacDonald,D,SJS,31,0,0,0,0
5,8476474,Stefan Noesen,R,CAR,31,0,0,0,0
5,8482787,Nikita Chibrikov,R,WPG,31,0,0,0,0
5,8478432,Christian Fischer,R,DET,27,0,0,0,0
5,8477979,Nicolas Aube-Kubel,R,WSH,28,0,0,0,0
5,8481789,Tye Kartye,L,SEA,23,0,0,0,0
5,8479330,Brandon Gignac,C,MTL,27,0,0,0,0
5,8480075,Cameron Crotty,D,ARI,25,0,0,0,0
5,8473473,Milan Lucic,L,BOS,36,0,0,0,0
5,8482094,Daemon Hunt,D,MIN,22,0,0,0,0
5,8481206,John Ludvig,D,PIT,24,0,0,0,0
5,8483630,Pavol Regenda,L,ANA,25,0,0,0,0
5,8481617,Vasily Podkolzin,R,VAN,23,0,0,0,0
5,8480306,Grant Hutton,D,NYI,29,0,0,0,0
5,8480995,Pontus Holmberg,R,TOR,25,0,0,0,0
5,8482148,Hendrix Lapierre,C,WSH,22,0,0,0,0
5,8477478,William Carrier,L,VGK,30,0,0,0,0
5,8480003,Jesper Boqvist,C,BOS,26,0,0,0,0
5,8482172,Landon Slaggert,L,CHI,22,0,0,0,0
5,8480789,Oliver Wahlstrom,R,NYI,24,0,0,0,0
5,8474062,Riley Nash,C,NYR,35,0,0,0,0
5,8480021,Jack Studnicka,C,SJS,25,0,0,0,0
5,8480025,MacKenzie Entwistle,R,CHI,25,0,0,0,0
5,8481582,Nicholas Robertson,L,TOR,23,0,0,0,0
5,8476867,Brendan Gaunce,C,CBJ,30,0,0,0,0
5,8479619,Michael Carcone,L,ARI,28,0,0,0,0
5,8479370,Tyson Jost,C,BUF,26,0,0,0,0
5,8479671,Mathieu Olivier,R,CBJ,27,0,0,0,0
5,8476994,Vinnie Hinostroza,C,PIT,30,0,0,0,0
5,8482070,Mitchell Chaffee,R,TBL,26,0,0,0,0
5,8477473,Justin Bailey,R,SJS,29,0,0,0,0
5,8479344,Jesse Puljujarvi,R,PIT,26,0,0,0,0
5,8480205,Emil Bemstrom,C,PIT,25,0,0,0,0
5,8479718,Alex Barré-Boulet,C,TBL,27,0,0,0,0
5,8482061,Brandon Biro,L,BUF,26,0,0,0,0
5,8479638,Justin Brazeau,R,BOS,26,0,0,0,0
5,8474040,Sam Gagner,C,EDM,35,0,0,0,0
5,8477846,Ryan Carpenter,C,SJS,33,0,0,0,0
5,8482077,Dylan Holloway,L,EDM,23,0,0,0,0
5,8482157,Will Cuylle,L,NYR,22,0,0,0,0
5,8480007,Jonas Rondbjerg,R,VGK,25,0,0,0,0
5,8478874,Adam Gaudette,C,STL,28,0,0,0,0
5,8478434,Keegan Kolesar,R,VGK,27,0,0,0,0
5,8480441,Trey Fix-Wolansky,R,CBJ,25,0,0,0,0
5,8479994,Jaret Anderson-Dolan,C,NSH,25,0,0,0,0
5,8483567,Georgii Merkulov,C,BOS,24,0,0,0,0
5,8477380,Jonny Brodzinski,C,NYR,31,0,0,0,0
5,8482201,Gage Goncalves,C,TBL,23,0,0,0,0
5,8478211,Dryden Hunt,L,CGY,29,0,0,0,0
5,8471699,Andrew Cogliano,C,COL,37,0,0,0,0
5,8479421,Jacob Moverare,D,LAK,26,0,0,0,0
5,8478881,Brett Seney,L,CHI,28,0,0,0,0
5,8477464,Nic Petan,C,MIN,29,0,0,0,0
5,8475958,Michael Sgarbossa,C,WSH,32,0,0,0,0
5,8481147,Reese Johnson,C,CHI,26,0,0,0,0
5,8479336,Carl Grundstrom,R,LAK,27,0,0,0,0
5,8480853,Liam Foudy,C,NSH,24,0,0,0,0
5,8479522,Hardy Haman Aktell,D,WSH,26,0,0,0,0
5,8481462,Mason Morelli,L,VGK,28,0,0,0,0
5,8482102,Vasily Ponomarev,C,CAR,22,0,0,0,0
5,8480844,Grigori Denisenko,L,VGK,24,0,0,0,0
5,8479944,Zach Aston-Reese,C,DET,30,0,0,0,0
5,8482784,Zach Dean,C,STL,21,0,0,0,0
5,8479419,Brett Murray,L,BUF,26,0,0,0,0
5,8479520,Brandon Duhaime,R,COL,27,0,0,0,0
5,8477573,Nathan Walker,L,STL,30,0,0,0,0
5,8478078,Rourke Chartier,C,OTT,28,0,0,0,0
5,8475795,Dylan McIlrath,D,WSH,32,0,0,0,0
5,8482496,Nils Aman,C,VAN,24,0,0,0,0
5,8480289,Morgan Barron,C,WPG,26,0,0,0,0
5,8481751,Lukas Rousek,R,BUF,25,0,0,0,0
5,8480011,Klim Kostin,C,SJS,25,0,0,0,0
5,8481556,John Beecher,C,BOS,23,0,0,0,0
5,8475278,Byron Froese,C,VGK,33,0,0,0,0
5,8475225,Craig Smith,C,DAL,35,0,0,0,0
5,8484326,Patrik Koch,D,ARI,28,0,0,0,0
5,8477930,Pierre-Edouard Bellemare,L,SEA,39,0,0,0,0
5,8478409,Anthony Richard,C,BOS,28,0,0,0,0
5,8481024,Linus Karlsson,C,VAN,25,0,0,0,0
5,8479986,Kole Lind,R,SEA,26,0,0,0,0
5,8479414,Nathan Bastian,R,NJD,27,0,0,0,0
5,8479362,Riley Tufte,L,COL,26,0,0,0,0
5,8481058,Jesse Ylönen,R,MTL,25,0,0,0,0
5,8482476,Emil Heineman,L,MTL,23,0,0,0,0
5,8482861,Vincent Iorio,D,WSH,22,0,0,0,0
5,8483432,Luca Del Bel Belluz,C,CBJ,31,0,0,0,0
5,8482744,James Malatesta,L,CBJ,21,0,0,0,0
5,8477887,Patrick Brown,C,BOS,32,0,0,0,0
5,8478585,Derek Ryan,C,EDM,38,0,0,0,0
5,8481441,Joe Snively,C,WSH,28,0,0,0,0
5,8481592,Jakob Pelletier,L,CGY,23,0,0,0,0
5,8482634,Alex Steeves,C,TOR,25,0,0,0,0
5,8477126,Jayson Megna,C,BOS,34,0,0,0,0
5,8475752,Tyler Pitlick,C,NYR,33,0,0,0,0
5,8480008,Adam Ruzicka,C,ARI,25,0,0,0,0
5,8481065,Angus Crookshank,L,OTT,25,0,0,0,0
5,8479547,Matthew Phillips,R,WSH,26,0,0,0,0
5,8480226,Marián Studenic,R,SEA,26,0,0,0,0
5,8481237,Kyle MacLean,C,NYI,25,0,0,0,0
5,8475413,Justin Dowling,C,NJD,34,0,0,0,0
5,8481641,Joel Kiviranta,L,COL,28,0,0,0,0
5,8478104,Sammy Blais,L,STL,28,0,0,0,0
5,8477454,Adam Erne,L,EDM,29,0,0,0,0
5,8481518,Nolan Foote,L,NJD,24,0,0,0,0
5,8480245,Olle Lycksell,R,PHI,25,0,0,0,0
5,8483570,Ben Meyers,C,ANA,26,0,0,0,0
5,8480776,Sheldon Rempal,R,VGK,29,0,0,0,0
5,8483920,Pierrick Dube,R,WSH,23,0,0,0,0
5,8480267,Sammy Walker,C,MIN,25,0,0,0,0
5,8482747,Brennan Othmann,L,NYR,21,0,0,0,0
5,8479991,Jake Leschyshyn,C,NYR,25,0,0,0,0
5,8478400,Colin White,C,MTL,27,0,0,0,0
5,8479328,Julien Gauthier,R,NYI,27,0,0,0,0
5,8484325,Waltteri Merela,C,TBL,26,0,0,0,0
5,8479066,Ryan Lomberg,L,FLA,30,0,0,0,0
5,8477070,Liam O'Brien,C,ARI,30,0,0,0,0
5,8478146,Matthew Highmore,C,OTT,28,0,0,0,0
5,8478028,Fredrik Olofsson,L,COL,28,0,0,0,0
5,8480880,Jakub Lauko,C,BOS,24,0,0,0,0
5,8479968,Vinni Lettieri,C,MIN,29,0,0,0,0
5,8474709,Matt Martin,L,NYI,35,0,0,0,0
5,8480845,Rasmus Kupari,C,WPG,24,0,0,0,0
5,8481550,Adam Beckman,L,MIN,23,0,0,0,0
5,8481422,Jacob Lucchini,C,MIN,29,0,0,0,0
5,8477401,John Hayden,C,SEA,29,0,0,0,0
5,8478904,Steven Lorentz,C,FLA,28,0,0,0,0
5,8482088,Justin Sourdif,R,FLA,22,0,0,0,0
5,8482751,Ryan Winterton,C,SEA,21,0,0,0,0
5,8482241,Radim Zohorna,L,PIT,28,0,0,0,0
5,8481690,Tyler Angle,C,CBJ,24,0,0,0,0
5,8476952,Dominic Toninato,C,WPG,30,0,0,0,0
5,8476919,Chris Tierney,C,NJD,30,0,0,0,0
5,8480032,Shane Bowers,C,NJD,25,0,0,0,0
5,8484314,Jiri Smejkal,L,OTT,28,0,0,0,0
5,8481239,Samuel Fagemo,L,LAK,24,0,0,0,0
5,8481532,Alex Turcotte,C,LAK,23,0,0,0,0
5,8481019,David Gustafsson,C,WPG,24,0,0,0,0
5,8478477,Mitchell Stephens,C,MTL,27,0,0,0,0
5,8479546,Oskar Steen,C,BOS,26,0,0,0,0
5,8480292,Carson Meyer,R,CBJ,27,0,0,0,0
5,8478446,Glenn Gawdin,C,ANA,27,0,0,0,0
5,8483531,Brian Halonen,L,NJD,25,0,0,0,0
5,8477149,Scott Sabourin,R,SJS,32,0,0,0,0
5,8479972,Mason Shaw,C,MIN,26,0,0,0,0
5,8480890,Jan Jenik,R,ARI,24,0,0,0,0
5,8478051,Max Willman,C,NJD,29,0,0,0,0
5,8480851,Akil Thomas,C,LAK,24,0,0,0,0
5,8482765,Isak Rosen,R,BUF,21,0,0,0,0
5,8478421,A.J. Greer,L,CGY,28,0,0,0,0
5,8478512,Austin Czarnik,C,DET,32,0,0,0,0
5,8479536,Axel Jonsson-Fjallby,L,WPG,26,0,0,0,0
5,8477320,Anton Blidh,L,NYR,29,0,0,0,0
5,8481543,Nikita Alexandrov,C,STL,24,0,0,0,0
5,8475235,Nicolas Deslauriers,L,PHI,33,0,0,0,0
5,8481070,Hugh McGing,L,STL,26,0,0,0,0
5,8480836,Jonathan Gruden,C,PIT,24,0,0,0,0
5,8481591,Sam Poulin,R,PIT,23,0,0,0,0
5,8477962,Brendan Lemieux,L,CAR,28,0,0,0,0
5,8483401,Marc Johnstone,R,PIT,28,0,0,0,0
5,8482250,Callahan Burke,C,CAR,27,0,0,0,0
5,8481726,Adam Edstrom,C,NYR,24,0,0,0,0
5,8471817,Ryan Reaves,R,TOR,37,0,0,0,0
5,8479587,Rhett Gardner,C,PHI,28,0,0,0,0
5,8475766,Austin Watson,L,TBL,32,0,0,0,0
5,8479367,William Lockwood,R,FLA,26,0,0,0,0
5,8478424,Jansen Harkins,C,PIT,27,0,0,0,0
5,8476913,Devin Shore,C,SEA,30,0,0,0,0
5,8482652,Walker Duehr,R,CGY,27,0,0,0,0
5,8477527,Ross Johnston,L,ANA,30,0,0,0,0
5,8481077,John Leonard,L,ARI,26,0,0,0,0
5,8483549,Lucas Condotta,L,MTL,27,0,0,0,0
5,8480468,James Hamblin,L,EDM,25,0,0,0,0
5,8476907,Mackenzie MacEachern,L,STL,30,0,0,0,0
5,8479543,Michael Pezzetta,L,MTL,26,0,0,0,0
5,8480355,Mark Kastelic,C,OTT,25,0,0,0,0
5,8482162,Roby Jarventie,L,OTT,22,0,0,0,0
5,8479772,Zack MacEwen,R,OTT,28,0,0,0,0
5,8483597,Milos Kelemen,L,ARI,25,0,0,0,0
5,8479379,Givani Smith,R,SJS,26,0,0,0,0
5,8481655,Cole Schwindt,R,CGY,23,0,0,0,0
5,8479981,Jonah Gadjovich,L,FLA,26,0,0,0,0
5,8482147,Jean-Luc Foudy,C,COL,22,0,0,0,0
5,8484255,Jason Polin,R,COL,25,0,0,0,0
5,8477993,Justin Kirkland,C,ARI,28,0,0,0,0
5,8479249,Andrew Poturalski,C,SEA,30,0,0,0,0
5,8482197,Adam Raska,R,MIN,23,0,0,0,0
5,8475780,Chris Wagner,R,COL,33,0,0,0,0
5,8479533,Joona Koppanen,L,PIT,26,0,0,0,0
5,8481534,Raphael Lavoie,C,EDM,24,0,0,0,0
5,8484321,Nikolas Matinpalo,D,OTT,26,0,0,0,0
5,8481043,Cole Koepke,L,TBL,26,0,0,0,0
5,8476323,Max McCormick,L,SEA,32,0,0,0,0
5,8483609,Adam Klapka,R,CGY,24,0,0,0,0
5,8483512,Matt Savoie,C,BUF,20,0,0,0,0
5,8484259,Ondrej Pavel,C,COL,31,0,0,0,0
5,8478147,Bokondji Imama,L,OTT,28,0,0,0,0
5,8482460,Matt Rempe,C,NYR,22,0,0,0,0
5,8477073,Kurtis MacDermid,L,NJD,30,0,0,0,0
5,8480274,Philip Kemp,D,EDM,25,0,0,0,0
5,8478956,Samuel Laberge,L,NJD,27,0,0,0,0
5,8483045,Cameron Butler,R,CBJ,31,0,0,0,0
6,8478402,Connor McDavid,C,EDM,27,82,35,92,127
6,8477956,David Pastrnak,R,BOS,28,82,53,66,119
6,8476887,Filip Forsberg,L,NSH,30,82,44,60,104
6,8479318,Auston Matthews,C,TOR,27,82,51,49,100
6,8476453,Nikita Kucherov,R,TBL,31,82,31,67,98
6,8477492,Nathan MacKinnon,C,COL,29,82,41,53,94
6,8477934,Leon Draisaitl,C,EDM,29,82,34,59,93
6,8479314,Matthew Tkachuk,L,FLA,27,82,35,56,91
6,8480027,Jason Robertson,L,DAL,25,82,33,58,91
6,8478420,Mikko Rantanen,R,COL,28,82,36,53,89
6,8478010,Brayden Point,C,TBL,28,82,48,40,88
6,8481559,Jack Hughes,C,NJD,23,82,29,59,88
6,8480069,Cale Makar,D,COL,26,82,20,68,88
6,8482116,Tim Stützle,C,OTT,22,82,22,65,87
6,8474600,Roman Josi,D,NSH,34,82,27,59,86
6,8475913,Mark Stone,R,VGK,32,82,28,57,85
6,8476346,Johnny Gaudreau,L,CBJ,31,82,21,64,85
6,8478550,Artemi Panarin,L,NYR,33,82,33,51,84
6,8479407,Jesper Bratt,L,NJD,26,82,30,53,83
6,8477939,William Nylander,R,TOR,28,82,34,46,80
6,8478864,Kirill Kaprizov,L,MIN,27,82,32,48,80
6,8477493,Aleksander Barkov,C,FLA,29,82,20,60,80
6,8476468,J.T. Miller,C,VAN,31,82,31,47,78
6,8480002,Nico Hischier,C,NJD,25,82,28,50,78
6,8478427,Sebastian Aho,C,CAR,27,82,28,50,78
6,8473512,Claude Giroux,R,OTT,36,82,27,51,78
6,8478493,Joel Eriksson Ek,C,MIN,27,82,31,46,77
6,8471675,Sidney Crosby,C,PIT,37,82,24,53,77
6,8478398,Kyle Connor,L,WPG,28,82,37,38,75
6,8478439,Travis Konecny,R,PHI,27,82,37,38,75
6,8476460,Mark Scheifele,C,WPG,31,82,32,43,75
6,8474564,Steven Stamkos,C,TBL,34,82,31,44,75
6,8477946,Dylan Larkin,C,DET,28,82,29,46,75
6,8481523,Kirby Dach,C,MTL,23,82,19,56,75
6,8481557,Matt Boldy,L,MIN,23,82,29,45,74
6,8477949,Alex Tuch,R,BUF,28,82,29,45,74
6,8478445,Mathew Barzal,C,NYI,27,82,24,50,74
6,8480800,Quinn Hughes,D,VAN,25,82,16,58,74
6,8480801,Brady Tkachuk,L,OTT,25,82,32,41,73
6,8475172,Nazem Kadri,C,CGY,34,82,31,42,73
6,8480023,Robert Thomas,C,STL,25,82,22,50,72
6,8479323,Adam Fox,D,NYR,26,82,15,57,72
6,8478403,Jack Eichel,C,VGK,28,82,35,36,71
6,8480012,Elias Pettersson,C,VAN,26,82,33,38,71
6,8475168,Matt Duchene,C,DAL,33,82,33,38,71
6,8479385,Jordan Kyrou,C,STL,26,82,27,44,71
6,8480208,Drake Batherson,R,OTT,26,82,21,50,71
6,8475786,Zach Hyman,L,EDM,32,82,40,30,70
6,8476881,Tomas Hertl,C,VGK,31,82,34,36,70
6,8471215,Evgeni Malkin,C,PIT,38,82,31,39,70
6,8475166,John Tavares,C,TOR,34,82,27,43,70
6,8477501,Valeri Nichushkin,R,COL,29,82,38,31,69
6,8477933,Sam Reinhart,C,FLA,29,82,31,38,69
6,8476456,Jonathan Huberdeau,C,CGY,31,82,23,46,69
6,8478401,Pavel Zacha,C,BOS,27,82,18,51,69
6,8470794,Joe Pavelski,C,DAL,40,82,19,49,68
6,8477409,Carter Verhaeghe,C,FLA,29,82,37,30,67
6,8478975,Mason Marchment,L,DAL,29,82,32,35,67
6,8478444,Brock Boeser,R,VAN,27,82,30,37,67
6,8477447,Shea Theodore,D,VGK,29,82,13,54,67
6,8475184,Chris Kreider,L,NYR,33,82,44,22,66
6,8475754,Brock Nelson,C,NYI,33,82,36,30,66
6,8476459,Mika Zibanejad,C,NYR,31,82,33,33,66
6,8477404,Jake Guentzel,C,CAR,30,82,30,36,66
6,8479420,Tage Thompson,C,BUF,27,82,31,34,65
6,8475726,Tyler Toffoli,C,WPG,32,82,31,34,65
6,8480830,Andrei Svechnikov,R,CAR,24,82,22,43,65
6,8477951,Nick Schmaltz,C,ARI,28,82,19,46,65
6,8475810,Bryan Rust,R,PIT,32,82,32,32,64
6,8478873,Troy Terry,R,ANA,27,82,32,32,64
6,8478414,Timo Meier,R,NJD,28,82,34,29,63
6,8478042,Viktor Arvidsson,R,LAK,31,82,27,36,63
6,8478047,Michael Bunting,L,PIT,29,82,26,37,63
6,8471685,Anze Kopitar,C,LAK,37,82,17,46,63
6,8477940,Nikolaj Ehlers,L,WPG,28,82,16,47,63
6,8475692,Mats Zuccarello,R,MIN,37,82,12,51,63
6,8477500,Bo Horvat,C,NYI,29,82,39,23,62
6,8478438,Tommy Novak,C,NSH,27,82,22,40,62
6,8473419,Brad Marchand,L,BOS,36,82,19,43,62
6,8473994,Jamie Benn,L,DAL,35,82,18,43,61
6,8482110,Dawson Mercer,C,NJD,23,82,28,32,60
6,8479343,Clayton Keller,R,ARI,26,82,27,33,60
6,8475794,Tyler Seguin,C,DAL,32,82,25,35,60
6,8478460,Zach Werenski,D,CBJ,27,82,19,41,60
6,8480028,Morgan Frost,C,PHI,25,82,18,42,60
6,8476454,Ryan Nugent-Hopkins,C,EDM,31,82,14,46,60
6,8478366,Frank Vatrano,R,ANA,30,82,35,24,59
6,8477476,Artturi Lehkonen,L,COL,29,82,24,35,59
6,8482665,Matty Beniers,C,SEA,22,82,22,37,59
6,8477942,Kevin Fiala,L,LAK,28,82,20,39,59
6,8476389,Vincent Trocheck,C,NYR,31,82,18,41,59
6,8480839,Rasmus Dahlin,D,BUF,24,82,18,41,59
6,8476853,Morgan Rielly,D,TOR,30,82,14,45,59
6,8477402,Pavel Buchnevich,L,STL,29,82,30,28,58
6,8481540,Cole Caufield,R,MTL,23,82,30,28,58
6,8480188,Fabian Zetterlund,L,SJS,25,82,29,29,58
6,8478498,Jake DeBrusk,L,BOS,28,82,29,29,58
6,8475791,Taylor Hall,L,CHI,33,82,25,33,58
6,8482745,Mason McTavish,C,ANA,21,82,21,36,57
6,8475798,Mikael Granlund,C,SJS,32,82,13,44,57
6,8482740,Wyatt Johnston,C,DAL,21,82,30,26,56
6,8475169,Evander Kane,L,EDM,33,82,29,27,56
6,8474141,Patrick Kane,R,DET,36,82,21,35,56
6,8479337,Alex DeBrincat,R,DET,27,82,18,38,56
6,8478440,Dylan Strome,C,WSH,27,82,18,38,56
6,8474578,Erik Karlsson,D,PIT,34,82,16,40,56
6,8476539,Jonathan Marchessault,R,VGK,34,82,30,25,55
6,8471214,Alex Ovechkin,L,WSH,39,82,25,30,55
6,8481618,Alex Newhook,C,MTL,23,82,25,30,55
6,8479325,Charlie McAvoy,D,BOS,27,82,11,44,55
6,8482097,Jack Quinn,R,BUF,23,82,21,33,54
6,8480031,Maxime Comtois,L,CAR,25,82,20,34,54
6,8475158,Ryan O'Reilly,C,NSH,33,82,19,35,54
6,8477935,Sam Bennett,C,FLA,28,82,32,21,53
6,8477479,Tyler Bertuzzi,L,TOR,29,82,23,30,53
6,8479339,Patrik Laine,L,CBJ,26,82,22,31,53
6,8482684,Luke Hughes,D,NJD,21,82,14,39,53
6,8480803,Evan Bouchard,D,EDM,25,82,13,40,53
6,8477495,Seth Jones,D,CHI,30,82,9,44,53
6,8475167,Victor Hedman,D,TBL,34,82,7,46,53
6,8475784,Jeff Skinner,C,BUF,32,82,25,27,52
6,8473422,Nick Foligno,L,CHI,37,82,23,29,52
6,8477496,Elias Lindholm,C,VAN,30,82,18,34,52
6,8481581,Thomas Harley,D,DAL,23,82,17,35,52
6,8481533,Trevor Zegras,C,ANA,23,82,16,36,52
6,8480865,Noah Dobson,D,NYI,24,82,6,46,52
6,8475151,Kyle Palmieri,C,NYI,33,82,27,24,51
6,8477960,Adrian Kempe,R,LAK,28,82,23,28,51
6,8482667,William Eklund,L,SJS,22,82,21,30,51
6,8474590,John Carlson,D,WSH,34,82,13,38,51
6,8478407,Vince Dunn,D,SEA,28,82,11,40,51
6,8478397,Rasmus Andersson,D,CGY,28,82,10,41,51
6,8477504,Josh Morrissey,D,WPG,29,82,9,42,51
6,8479410,Mikhail Sergachev,D,TBL,26,82,9,42,51
6,8477451,Ryan Hartman,R,MIN,30,82,30,20,50
6,8480064,Josh Norris,C,OTT,25,82,25,25,50
6,8476483,Rickard Rakell,R,PIT,31,82,24,26,50
6,8475287,Erik Haula,L,NJD,33,82,24,26,50
6,8481596,Shane Pinto,C,OTT,24,82,21,29,50
6,8475191,Reilly Smith,R,PIT,33,82,19,31,50
6,8478449,Roope Hintz,C,DAL,28,82,17,33,50
6,8475170,Brayden Schenn,C,STL,33,82,12,38,50
6,8480798,Philipp Kurashev,C,CHI,25,82,12,38,50
6,8480036,Miro Heiskanen,D,DAL,25,82,11,39,50
6,8483808,Andrei Kuzmenko,L,CGY,28,82,25,24,49
6,8479542,Brandon Hagel,L,TBL,26,82,22,27,49
6,8481528,Dylan Cozens,C,BUF,23,82,19,30,49
6,8476882,Teuvo Teravainen,L,CAR,30,82,15,34,49
6,8478038,Devon Toews,D,COL,30,82,7,42,49
6,8474641,Adam Henrique,C,EDM,34,82,24,24,48
6,8477955,Jared McCann,L,SEA,28,82,20,28,48
6,8477964,Ivan Barbashev,C,VGK,29,82,20,28,48
6,8482078,Lucas Raymond,L,DET,22,82,19,29,48
6,8480018,Nick Suzuki,C,MTL,25,82,18,30,48
6,8475765,Vladimir Tarasenko,R,FLA,33,82,17,31,48
6,8478462,Nicolas Roy,C,VGK,27,82,17,31,48
6,8476448,William Karlsson,C,VGK,31,82,13,35,48
6,8477346,MacKenzie Weegar,D,CGY,30,82,10,38,48
6,8483524,Shane Wright,C,SEA,20,82,30,17,47
6,8484144,Connor Bedard,C,CHI,19,82,23,24,47
6,8479345,Jakob Chychrun,D,OTT,26,82,16,31,47
6,8475314,Anders Lee,L,NYI,34,82,22,24,46
6,8474679,Gustav Nyquist,C,NSH,35,82,18,28,46
6,8482093,Seth Jarvis,C,CAR,22,82,16,30,46
6,8475745,Charlie Coyle,C,BOS,32,82,15,31,46
6,8478856,Conor Garland,R,VAN,28,82,12,34,46
6,8475197,Tyson Barrie,D,NSH,33,82,11,35,46
6,8475753,Justin Faulk,D,STL,32,82,6,40,46
6,8478474,Lawson Crouse,L,ARI,27,82,27,18,45
6,8480113,Alex Iafallo,L,WPG,31,82,21,24,45
6,8473986,Alex Killorn,L,ANA,35,82,19,26,45
6,8476479,Phillip Danault,C,LAK,31,82,18,27,45
6,8479999,Casey Mittelstadt,C,COL,26,82,12,33,45
6,8476880,Tom Wilson,R,WSH,30,82,23,21,44
6,8479400,Pierre-Luc Dubois,L,LAK,26,82,21,23,44
6,8476462,Dougie Hamilton,D,NJD,31,82,17,27,44
6,8481068,Yegor Sharangovich,C,CGY,26,82,17,27,44
6,8474150,Mikael Backlund,C,CGY,35,82,17,27,44
6,8476869,Brady Skjei,D,CAR,30,82,11,33,44
6,8476792,Torey Krug,D,STL,33,82,9,35,44
6,8471724,Kris Letang,D,PIT,37,82,7,37,44
6,8479425,Filip Hronek,D,VAN,27,82,7,37,44
6,8480014,Gabriel Vilardi,C,WPG,25,82,25,18,43
6,8479423,Alex Nylander,L,CBJ,26,82,25,18,43
6,8476432,Boone Jenner,C,CBJ,31,82,23,20,43
6,8480893,Kirill Marchenko,R,CBJ,24,82,22,21,43
6,8477407,Anthony Duclair,L,TBL,29,82,21,22,43
6,8478046,Danton Heinen,L,BOS,29,82,20,23,43
6,8477497,Sean Monahan,C,WPG,30,82,20,23,43
6,8482109,Alexis Lafrenière,L,NYR,23,82,17,26,43
6,8476399,Blake Coleman,C,CGY,33,82,16,27,43
6,8475763,Kevin Hayes,R,STL,32,82,16,27,43
6,8477932,Aaron Ekblad,D,FLA,28,82,15,28,43
6,8480185,Eetu Luostarinen,C,FLA,26,82,15,28,43
6,8477986,Brandon Montour,D,FLA,30,82,15,28,43
6,8480220,Noah Cates,L,PHI,25,82,15,28,43
6,8474053,Logan Couture,C,SJS,35,82,15,28,43
6,8481542,Moritz Seider,D,DET,23,82,9,34,43
6,8475764,Cam Fowler,D,ANA,33,82,5,38,43
6,8475799,Nino Niederreiter,R,WPG,32,82,28,14,42
6,8479415,Michael McLeod,C,NJD,26,82,20,22,42
6,8477416,Oliver Bjorkstrand,R,SEA,29,82,19,23,42
6,8475768,Jaden Schwartz,C,SEA,32,82,19,23,42
6,8475906,John Klingberg,D,TOR,32,82,9,33,42
6,8483471,Brad Lambert,C,WPG,31,82,8,34,42
6,8483397,Marc McLaughlin,C,BOS,25,82,36,5,41
6,8482124,Quinton Byfield,R,LAK,22,82,21,20,41
6,8474037,James van Riemsdyk,L,BOS,35,82,20,21,41
6,8477456,J.T. Compher,L,DET,29,82,17,24,41
6,8474586,Jordan Eberle,R,SEA,34,82,13,28,41
6,8476906,Shayne Gostisbehere,D,DET,31,82,11,30,41
6,8476905,Chandler Stephenson,C,VGK,30,82,10,31,41
6,8481703,Valtteri Puustinen,R,PIT,25,82,8,33,41
6,8481699,Aku Raty,R,ARI,23,82,1,40,41
6,8478233,Andrew Mangiapane,L,CGY,28,82,16,24,40
6,8478519,Anthony Cirelli,C,TBL,27,82,15,25,40
6,8475744,Evgeny Kuznetsov,C,CAR,32,82,12,28,40
6,8480434,Sean Durzi,D,ARI,26,82,10,30,40
6,8474565,Alex Pietrangelo,D,VGK,34,82,9,31,40
6,8483445,Cutter Gauthier,L,ANA,20,82,8,32,40
6,8474157,Max Pacioretty,L,WSH,36,82,22,17,39
6,8481624,Ilya Mikheyev,R,VAN,30,82,22,17,39
6,8482475,Yegor Chinakhov,R,CBJ,23,82,21,18,39
6,8482055,Drew O'Connor,L,PIT,26,82,21,18,39
6,8475722,Jason Zucker,L,NSH,32,82,20,19,39
6,8482089,Jake Neighbours,L,STL,22,82,20,19,39
6,8478466,Daniel Sprong,R,DET,27,82,19,20,39
6,8482159,Tyson Foerster,R,PHI,22,82,18,21,39
6,8474102,David Perron,L,DET,36,82,17,22,39
6,8476960,Andreas Athanasiou,C,CHI,30,82,17,22,39
6,8479675,Trevor Moore,L,LAK,29,82,16,23,39
6,8480009,Eeli Tolvanen,R,SEA,25,82,15,24,39
6,8477429,Andrew Copp,C,DET,30,82,15,24,39
6,8470613,Brent Burns,D,CAR,39,82,11,28,39
6,8476826,Yanni Gourde,C,SEA,33,82,11,28,39
6,8477944,Jakub Vrana,L,STL,28,82,27,11,38
6,8477426,Nicholas Paul,L,TBL,29,82,20,18,38
6,8482117,Lukas Reichel,L,CHI,22,82,16,22,38
6,8480797,Joel Farabee,L,PHI,24,82,14,24,38
6,8482705,Cole Sillinger,C,CBJ,21,82,13,25,38
6,8481711,Matias Maccelli,L,ARI,24,82,11,27,38
6,8475218,Mattias Ekholm,D,EDM,34,82,11,27,38
6,8480039,Martin Necas,C,CAR,25,82,19,18,37
6,8481554,Kaapo Kakko,R,NYR,23,82,19,18,37
6,8475848,Brendan Gallagher,R,MTL,32,82,18,19,37
6,8482092,Ridly Greig,C,OTT,22,82,18,19,37
6,8475793,Ryan Johansen,C,PHI,32,82,18,19,37
6,8478057,Dakota Joshua,C,VAN,28,82,15,22,37
6,8477425,Miles Wood,L,COL,29,82,14,23,37
6,8477444,Andre Burakovsky,L,SEA,29,82,13,24,37
6,8474563,Drew Doughty,D,LAK,35,82,6,31,37
6,8481016,Ruslan Iskhakov,C,NYI,24,82,5,32,37
6,8477998,Warren Foegele,L,EDM,28,82,17,19,36
6,8477511,Anthony Mantha,R,VGK,30,82,17,19,36
6,8479992,Michael Rasmussen,C,DET,25,82,16,20,36
6,8479987,Morgan Geekie,C,BOS,26,82,13,23,36
6,8477503,Max Domi,C,TOR,29,82,12,24,36
6,8476458,Ryan Strome,C,ANA,31,82,11,25,36
6,8480871,Adam Boqvist,D,CBJ,24,82,5,31,36
6,8476854,Hampus Lindholm,D,BOS,30,82,5,31,36
6,8476438,Brandon Saad,L,STL,32,82,21,14,35
6,8477450,Jason Dickinson,C,CHI,29,82,19,16,35
6,8481535,Nils Hoglander,L,VAN,24,82,19,16,35
6,8481186,Logan O'Connor,R,COL,28,82,17,18,35
6,8482146,Luke Evangelista,R,NSH,22,82,17,18,35
6,8482175,JJ Peterka,R,BUF,22,82,16,19,35
6,8475164,Jakob Silfverberg,R,ANA,34,82,15,20,35
6,8477498,Darnell Nurse,D,EDM,29,82,13,22,35
6,8482105,Jake Sanderson,D,OTT,22,82,10,25,35
6,8478396,Noah Hanifin,D,VGK,27,82,9,26,35
6,8477494,Jonathan Drouin,L,COL,29,82,15,19,34
6,8477952,Robby Fabbri,C,DET,28,82,15,19,34
6,8470621,Corey Perry,R,EDM,39,82,15,19,34
6,8481560,Arthur Kaliyev,R,LAK,23,82,14,20,34
6,8479351,Sam Steel,C,DAL,26,82,13,21,34
6,8480078,Filip Chytil,C,NYR,25,82,11,23,34
6,8482720,Matthew Knies,L,TOR,22,82,11,23,34
6,8476979,Erik Gustafsson,D,NYR,32,82,4,30,34
6,8479941,Justin Danforth,R,CBJ,31,82,20,13,33
6,8482101,Danil Gushchin,L,SJS,22,82,17,16,33
6,8478472,Mathieu Joseph,R,OTT,27,82,16,17,33
6,8471218,Blake Wheeler,R,NYR,38,82,16,17,33
6,8480015,Owen Tippett,R,PHI,25,82,15,18,33
6,8476329,Travis Boyd,C,ARI,31,82,13,20,33
6,8483515,Juraj Slafkovsky,L,MTL,20,82,13,20,33
6,8476872,Scott Laughton,C,PHI,30,82,13,20,33
6,8484166,Adam Fantilli,C,CBJ,20,82,10,23,33
6,8476917,Adam Pelech,D,NYI,30,82,9,24,33
6,8482702,Logan Stankoven,C,DAL,21,82,18,14,32
6,8478891,Mason Appleton,C,WPG,28,82,15,17,32
6,8478458,Jack Roslovic,C,NYR,27,82,14,18,32
6,8478469,Thomas Chabot,D,OTT,27,82,14,18,32
6,8471698,T.J. Oshie,R,WSH,38,82,14,18,32
6,8476925,Colton Sissons,C,NSH,31,82,12,20,32
6,8482222,Alexander Barabanov,L,SJS,30,82,11,21,32
6,8477947,Sonny Milano,L,WSH,28,82,11,21,32
6,8479398,Samuel Girard,D,COL,26,82,9,23,32
6,8481546,Cam York,D,PHI,23,82,8,24,32
6,8477021,Alex Kerfoot,C,ARI,30,82,7,25,32
6,8476875,Mike Matheson,D,MTL,30,82,7,25,32
6,8480145,Neal Pionk,D,WPG,29,82,7,25,32
6,8478500,Ivan Provorov,D,CBJ,27,82,5,27,32
6,8479996,Cody Glass,C,NSH,25,82,17,14,31
6,8478463,Anthony Beauvillier,L,NSH,27,82,17,14,31
6,8475149,Marcus Johansson,L,MIN,34,82,14,17,31
6,8484153,Leo Carlsson,C,ANA,20,82,13,18,31
6,8476469,Joel Armia,R,MTL,31,82,12,19,31
6,8478115,Pierre Engvall,L,NYI,28,82,11,20,31
6,8478911,Matt Roy,D,LAK,29,82,8,23,31
6,8476480,Vladislav Namestnikov,C,WPG,32,82,4,27,31
6,8476958,Jaccob Slavin,D,CAR,30,82,3,28,31
6,8482699,Dylan Guenther,R,ARI,21,82,16,14,30
6,8479977,Kailer Yamamoto,R,SEA,26,82,16,14,30
6,8476921,Jordan Martinook,L,CAR,32,82,13,17,30
6,8475220,Marcus Foligno,L,MIN,33,82,12,18,30
6,8473563,Nicklas Backstrom,C,WSH,37,82,12,18,30
6,8477953,Kasperi Kapanen,R,STL,28,82,12,18,30
6,8479346,Dillon Dube,C,CGY,26,82,12,18,30
6,8480459,Pius Suter,C,VAN,28,82,10,20,30
6,8481606,Jordan Spence,D,LAK,23,82,6,24,30
6,8476419,Jean-Gabriel Pageau,C,NYI,32,82,5,25,30
6,8482122,Brock Faber,D,MIN,22,82,5,25,30
6,8476981,Josh Anderson,R,MTL,30,82,19,10,29
6,8478020,Michael Amadio,C,VGK,28,82,16,13,29
6,8474870,Tyler Johnson,C,CHI,34,82,15,14,29
6,8478043,Sam Lafferty,C,VAN,29,82,15,14,29
6,8482113,Anton Lundell,C,FLA,23,82,12,17,29
6,8479525,Ross Colton,C,COL,28,82,12,17,29
6,8480821,Filip Zadina,R,SJS,25,82,12,17,29
6,8478542,Evan Rodrigues,C,FLA,31,82,10,19,29
6,8478413,Jordan Greenway,L,BUF,27,82,10,19,29
6,8477948,Travis Sanheim,D,PHI,28,82,6,23,29
6,8479371,Dante Fabbro,D,NSH,26,82,5,24,29
6,8475714,Calle Jarnkrok,C,TOR,33,82,18,10,28
6,8477330,Dominik Kubalik,L,OTT,29,82,17,11,28
6,8480281,Alexey Toropchenko,R,STL,25,82,17,11,28
6,8482074,Connor Zary,C,CGY,23,82,16,12,28
6,8476871,Tanner Pearson,L,MTL,32,82,13,15,28
6,8476392,Adam Lowry,C,WPG,31,82,10,18,28
6,8481656,Aliaksei Protas,C,WSH,23,82,7,21,28
6,8474673,TJ Brodie,D,TOR,34,82,6,22,28
6,8476931,Jake McCabe,D,TOR,31,82,6,22,28
6,8476892,Colton Parayko,D,STL,31,82,6,22,28
6,8481568,Alex Vlasic,D,CHI,23,82,3,25,28
6,8476879,Cody Ceci,D,EDM,31,82,2,26,28
6,8479316,Luke Kunin,C,SJS,27,82,16,11,27
6,8482145,Mavrik Bourque,C,DAL,22,82,16,11,27
6,8481477,Nico Sturm,C,SJS,29,82,15,12,27
6,8478109,Victor Olofsson,L,BUF,29,82,14,13,27
6,8473533,Jordan Staal,C,CAR,36,82,11,16,27
6,8479661,Tanner Jeannot,L,TBL,27,82,11,16,27
6,8476461,Sean Couturier,C,PHI,32,82,10,17,27
6,8474189,Lars Eller,C,PIT,35,82,9,18,27
6,8482671,Owen Power,D,BUF,22,82,8,19,27
6,8477506,Ryan Pulock,D,NYI,30,82,8,19,27
6,8474574,Tyler Myers,D,VAN,34,82,4,23,27
6,8478399,Jonas Siegenthaler,D,NJD,27,82,4,23,27
6,8482245,Artem Zub,D,OTT,29,82,3,24,27
6,8474151,Ryan McDonagh,D,NSH,35,82,2,25,27
6,8470604,Jeff Carter,C,PIT,39,82,20,6,26
6,8483493,Frank Nazar,C,CHI,20,82,17,9,26
6,8475760,Nick Bjugstad,C,ARI,32,82,15,11,26
6,8474149,Evgenii Dadonov,R,DAL,35,82,14,12,26
6,8480074,Alexandre Texier,C,CBJ,25,82,13,13,26
6,8481580,Connor McMichael,C,WSH,23,82,10,16,26
6,8480068,Ryan Poehling,C,PHI,25,82,10,16,26
6,8476927,Teddy Blueger,C,VAN,30,82,9,17,26
6,8482624,Daniil Miromanov,D,CGY,27,82,9,17,26
6,8482133,Thomas Bordeleau,C,SJS,22,82,8,18,26
6,8482730,Brandt Clarke,D,LAK,21,82,8,18,26
6,8483482,Tristan Luneau,D,ANA,20,82,8,18,26
6,8480043,Timothy Liljegren,D,TOR,25,82,6,20,26
6,8480817,K'Andre Miller,D,NYR,24,82,5,21,26
6,8479976,Juuso Valimaki,D,ARI,26,82,4,22,26
6,8481567,Henry Thrun,D,SJS,23,82,1,25,26
6,8479591,Michael Eyssimont,C,TBL,28,82,16,9,25
6,8483431,Logan Cooley,C,ARI,20,82,12,13,25
6,8479514,Rem Pitlick,C,CHI,27,82,12,13,25
6,8477369,Carson Soucy,D,VAN,30,82,12,13,25
6,8477989,Christian Dvorak,C,MTL,28,82,10,15,25
6,8480035,Henri Jokiharju,D,BUF,25,82,10,15,25
6,8476292,Ondrej Palat,L,NJD,33,82,9,16,25
6,8484145,Zach Benson,L,BUF,19,82,9,16,25
6,8480802,Ryan McLeod,C,EDM,25,82,8,17,25
6,8479365,Trent Frederic,C,BOS,26,82,7,18,25
6,8478055,Gustav Forsling,D,FLA,28,82,5,20,25
6,8476923,Damon Severson,D,CBJ,30,82,4,21,25
6,8476331,Dylan DeMelo,D,WPG,31,82,2,23,25
6,8480246,Nick Perbix,D,TBL,26,82,0,25,25
6,8481013,Jonatan Berggren,R,DET,24,82,15,9,24
6,8480849,Barrett Hayton,C,ARI,24,82,13,11,24
6,8474884,Mike Hoffman,C,SJS,35,82,12,12,24
6,8481604,Pavel Dorofeyev,L,VGK,24,82,11,13,24
6,8477353,Tyler Motte,C,TBL,29,82,11,13,24
6,8481517,Brett Leason,R,ANA,25,82,10,14,24
6,8477392,Hudson Fasching,R,NYI,29,82,10,14,24
6,8479353,Brett Howden,C,VGK,26,82,9,15,24
6,8480813,Joe Veleno,C,DET,24,82,9,15,24
6,8482079,Marco Rossi,C,MIN,23,82,9,15,24
6,8477015,Connor Brown,R,EDM,30,82,9,15,24
6,8483505,Matthew Poitras,C,BOS,20,82,8,16,24
6,8479393,Noah Gregor,C,TOR,26,82,8,16,24
6,8477508,Curtis Lazar,C,NJD,29,82,7,17,24
6,8476457,Adam Larsson,D,SEA,32,82,7,17,24
6,8477931,Tomas Nosek,L,NJD,32,82,7,17,24
6,8481014,Alexander Romanov,D,NYI,24,82,7,17,24
6,8478133,Jake Evans,C,MTL,28,82,6,18,24
6,8478882,Vladislav Gavrikov,D,LAK,29,82,6,18,24
6,8476885,Jacob Trouba,D,NYR,30,82,4,20,24
6,8484203,Bradly Nadeau,L,CAR,19,82,18,5,23
6,8483491,Ivan Miroshnichenko,L,WSH,20,82,15,8,23
6,8470610,Zach Parise,L,COL,40,82,13,10,23
6,8481601,Simon Holmstrom,R,NYI,23,82,12,11,23
6,8473504,Cal Clutterbuck,R,NYI,37,82,11,12,23
6,8475233,David Savard,D,MTL,34,82,9,14,23
6,8476278,Colin Blackwell,C,CHI,31,82,8,15,23
6,8475171,Oliver Ekman-Larsson,D,FLA,33,82,6,17,23
6,8477435,Ryan Graves,D,PIT,29,82,6,17,23
6,8475200,Dmitry Orlov,D,CAR,33,82,6,17,23
6,8477499,Rasmus Ristolainen,D,PHI,30,82,6,17,23
6,8482142,Jamie Drysdale,D,PHI,22,82,5,18,23
6,8470966,Mark Giordano,D,TOR,41,82,5,18,23
6,8477488,Brett Pesce,D,CAR,30,82,4,19,23
6,8482655,J.J. Moser,D,ARI,24,82,4,19,23
6,8483457,Lane Hutson,D,MTL,20,82,1,22,23
6,8482155,Alex Laferriere,R,LAK,23,82,15,7,22
6,8479293,Brandon Tanev,L,SEA,33,82,12,10,22
6,8481481,Blake Lizotte,C,LAK,27,82,11,11,22
6,8483499,Liam Ohgren,L,MIN,20,82,11,11,22
6,8482062,Cole Smith,L,NSH,29,82,9,13,22
6,8480980,Connor Dewar,C,TOR,25,82,8,14,22
6,8479359,Beck Malenstyn,L,WSH,26,82,8,14,22
6,8482259,Bobby McMann,C,TOR,28,82,7,15,22
6,8483565,Nick Blankenburg,D,CBJ,26,82,7,15,22
6,8476897,Oskar Sundqvist,C,STL,30,82,6,16,22
6,8483495,Simon Nemec,D,NJD,20,82,5,17,22
6,8483466,Kevin Korchinski,D,CHI,20,82,4,18,22
6,8475790,Erik Gudbranson,D,CBJ,32,82,3,19,22
6,8477969,Marcus Pettersson,D,PIT,28,82,3,19,22
6,8478178,Darren Raddysh,D,TBL,28,82,3,19,22
6,8476467,Jamie Oleksiak,D,SEA,32,82,1,21,22
6,8482809,Jackson Blake,R,CAR,21,82,16,5,21
6,8482737,Zack Bolduc,C,STL,21,82,13,8,21
6,8480855,Jack McBain,C,ARI,24,82,11,10,21
6,8478468,Jeremy Lauzon,D,NSH,27,82,9,12,21
6,8480796,Martin Fehervary,D,WSH,25,82,8,13,21
6,8482087,Kaiden Guhle,D,MTL,22,82,6,15,21
6,8481524,Bowen Byram,D,BUF,23,82,6,15,21
6,8478840,Will Borgen,D,SEA,28,82,6,15,21
6,8479390,Taylor Raddysh,R,CHI,26,82,4,17,21
6,8475181,Nick Leddy,D,STL,33,82,4,17,21
6,8480873,Rasmus Sandin,D,WSH,24,82,3,18,21
6,8482733,Logan Mailloux,D,MTL,31,82,3,18,21
6,8476902,Esa Lindell,D,DAL,30,82,2,19,21
6,8475762,Derek Forbort,D,BOS,32,82,1,20,21
6,8473507,Jeff Petry,D,DET,37,82,0,21,21
6,8474715,Cam Atkinson,R,PHI,35,82,9,11,20
6,8476374,Sean Kuraly,C,CBJ,31,82,9,11,20
6,8475343,Nic Dowd,C,WSH,34,82,8,12,20
6,8482111,Justin Barron,D,MTL,23,82,7,13,20
6,8474716,Jared Spurgeon,D,MIN,35,82,6,14,20
6,8477406,Mattias Janmark,C,EDM,32,82,6,14,20
6,8476422,Mike Reilly,D,NYI,31,82,5,15,20
6,8470600,Ryan Suter,D,DAL,39,82,5,15,20
6,8476967,Brett Kulak,D,EDM,30,82,5,15,20
6,8477365,Connor Clifton,D,BUF,29,82,4,16,20
6,8474013,Ian Cole,D,VAN,35,82,4,16,20
6,8480807,Mattias Samuelsson,D,BUF,24,82,3,17,20
6,8476858,Phillip Di Giuseppe,L,VAN,31,82,11,8,19
6,8473449,Kyle Okposo,R,FLA,36,82,8,11,19
6,8482803,Olen Zellweger,D,ANA,21,82,7,12,19
6,8481522,Peyton Krebs,C,BUF,23,82,6,13,19
6,8476312,Josh Manson,D,COL,33,82,6,13,19
6,8476873,Mark Jankowski,C,NSH,30,82,5,14,19
6,8474034,Pat Maroon,L,BOS,36,82,5,14,19
6,8476525,Colin Miller,D,WPG,32,82,5,14,19
6,8478507,John Marino,D,NJD,27,82,4,15,19
6,8480172,Jan Rutta,D,SJS,34,82,4,15,19
6,8475179,Dmitry Kulikov,D,FLA,34,82,4,15,19
6,8477839,Conor Sheary,L,TBL,32,82,3,16,19
6,8481178,Egor Zamula,D,PHI,24,82,3,16,19
6,8477845,Trevor van Riemsdyk,D,WSH,33,82,3,16,19
6,8475188,Brayden McNabb,D,VGK,33,82,2,17,19
6,8479383,Boris Katchouk,L,OTT,26,82,12,6,18
6,8478569,Noel Acciari,C,PIT,33,82,10,8,18
6,8477919,Frederick Gaudreau,C,MIN,31,82,10,8,18
6,8479980,Nicolas Hague,D,VGK,26,82,8,10,18
6,8476463,Jonas Brodin,D,MIN,31,82,7,11,18
6,8479442,Troy Stecher,D,EDM,30,82,7,11,18
6,8475231,Casey Cizikas,C,NYI,33,82,6,12,18
6,8480806,Isac Lundestrom,C,ANA,25,82,5,13,18
6,8478851,Alexandre Carrier,D,NSH,28,82,5,13,18
6,8482166,Shakir Mukhamadullin,D,SJS,22,82,5,13,18
6,8480073,Erik Brannstrom,D,OTT,25,82,4,14,18
6,8480834,Ty Emberson,D,SJS,24,82,4,14,18
6,8480336,Sean Walker,D,COL,30,82,3,15,18
6,8481605,Jackson LaCombe,D,ANA,23,82,3,15,18
6,8475690,Chris Tanev,D,DAL,35,82,2,16,18
6,8479291,Kevin Rooney,C,CGY,31,82,10,7,17
6,8477505,Alexander Wennberg,C,NYR,30,82,7,10,17
6,8481553,Bobby Brink,R,PHI,23,82,7,10,17
6,8482679,Matt Coronato,R,CGY,22,82,7,10,17
6,8478416,Erik Cernak,D,TBL,27,82,7,10,17
6,8480448,Parker Kelly,L,OTT,25,82,7,10,17
6,8474166,Alec Martinez,D,VGK,37,82,6,11,17
6,8478430,Oliver Kylington,D,CGY,27,82,5,12,17
6,8481028,Martin Pospisil,C,CGY,25,82,5,12,17
6,8476891,Matt Grzelcyk,D,BOS,30,82,5,12,17
6,8480058,Pierre-Olivier Joseph,D,PIT,25,82,5,12,17
6,8482858,Ryker Evans,D,SEA,23,82,4,13,17
6,8475825,Jani Hakanpää,D,DAL,32,82,3,14,17
6,8475455,Brenden Dillon,D,WPG,34,82,3,14,17
6,8484911,Collin Graf,R,SJS,22,82,2,15,17
6,8480860,Kevin Bahl,D,NJD,24,82,2,15,17
6,8481059,Scott Perunovich,D,STL,26,82,1,16,17
6,8482118,Sam Colangelo,R,ANA,23,82,13,3,16
6,8478508,Yakov Trenin,C,COL,27,82,12,4,16
6,8475842,Sam Carrick,C,EDM,32,82,11,5,16
6,8478013,Jake Walman,D,DET,28,82,8,8,16
6,8476878,Zemgus Girgensons,L,BUF,30,82,8,8,16
6,8478831,Kevin Stenlund,C,FLA,28,82,7,9,16
6,8482125,Alexander Holtz,R,NJD,22,82,7,9,16
6,8478136,Jake Middleton,D,MIN,28,82,5,11,16
6,8475324,Nick Jensen,D,WSH,34,82,3,13,16
6,8479324,Ryan Lindgren,D,NYR,26,82,2,14,16
6,8476624,Barclay Goodrow,C,NYR,31,82,5,10,15
6,8482073,Braden Schneider,D,NYR,23,82,5,10,15
6,8477507,Nikita Zadorov,D,VAN,29,82,5,10,15
6,8476442,Matt Nieto,L,PIT,32,82,5,10,15
6,8475279,Ben Chiarot,D,DET,33,82,4,11,15
6,8479983,Mario Ferraro,D,SJS,26,82,4,11,15
6,8479369,Andrew Peeke,D,BOS,26,82,3,12,15
6,8477220,Nate Schmidt,D,WPG,33,82,3,12,15
6,8475208,Brian Dumoulin,D,SEA,33,82,2,13,15
6,8481537,Nikita Okhotiuk,D,CGY,24,82,1,14,15
6,8483490,Pavel Mintyukov,D,ANA,21,82,1,14,15
6,8478443,Brandon Carlo,D,BOS,28,82,6,8,14
6,8481704,Juuso Parssinen,C,NSH,23,82,5,9,14
6,8476372,Nick Seeler,D,PHI,31,82,5,9,14
6,8480144,David Kampf,C,TOR,29,82,3,11,14
6,8477034,Jaycob Megna,D,CHI,32,82,2,12,14
6,8483763,Maksymilian Szuber,D,ARI,22,82,2,12,14
6,8475462,Radko Gudas,D,ANA,34,82,1,13,14
6,8474009,Nick Bonino,C,NYR,36,82,7,6,13
6,8482666,Scott Morrow,D,CAR,22,82,6,7,13
6,8480990,Declan Chisholm,D,MIN,24,82,3,10,13
6,8482712,Oskar Olausson,R,COL,22,82,2,11,13
6,8482470,Ilya Solovyov,D,CGY,24,82,2,11,13
6,8471677,Jack Johnson,D,COL,37,82,2,11,13
6,8476429,Scott Mayfield,D,NYI,32,82,0,13,13
6,8483489,Fraser Minten,C,TOR,31,82,9,3,12
6,8481093,Rafael Harvey-Pinard,L,MTL,25,82,5,7,12
6,8483468,Jiri Kulich,C,BUF,20,82,5,7,12
6,8482807,Ethan Del Mastro,D,CHI,21,82,5,7,12
6,8477335,Kyle Burroughs,D,SJS,29,82,4,8,12
6,8476473,Connor Murphy,D,CHI,31,82,2,10,12
6,8478859,Niko Mikkola,D,FLA,28,82,2,10,12
6,8473453,Trevor Lewis,C,LAK,37,82,5,6,11
6,8483012,Logan Morrison,C,SEA,22,82,5,6,11
6,8474567,Zach Bogosian,D,MIN,34,82,3,8,11
6,8479998,Mikey Anderson,D,LAK,25,82,1,10,11
6,8478451,Ethan Bear,D,WSH,27,82,1,10,11
6,8481599,Victor Soderstrom,D,ARI,23,82,8,2,10
6,8476822,Luke Glendening,C,TBL,35,82,6,4,10
6,8482762,Simon Edvinsson,D,DET,21,82,5,5,10
6,8482177,Marat Khusnutdinov,C,MIN,22,82,5,5,10
6,8475177,Calvin de Haan,D,TBL,33,82,4,6,10
6,8476915,Jujhar Khaira,L,MIN,30,82,3,7,10
6,8482516,Matthew Kessel,D,STL,24,82,3,7,10
6,8478408,Travis Dermott,D,ARI,28,82,3,7,10
6,8480879,Jacob Bernard-Docker,D,OTT,24,82,2,7,9
6,8481578,Graeme Clarke,R,NJD,23,82,4,4,8
6,8482713,Mackie Samoskevich,R,FLA,22,82,4,4,8
6,8482859,Zack Ostapchuk,C,OTT,21,82,0,8,8
6,8484149,Gavin Brindley,C,CBJ,20,82,0,5,5
6,8481030,Jack St. Ivany,D,PIT,25,82,0,5,5
6,8482141,Lukas Cormier,D,VGK,22,0,0,0,0
6,8476988,Matt Benning,D,SJS,30,0,0,0,0
6,8480727,Zach Whitecloud,D,VGK,28,0,0,0,0
6,8480887,Jordan Harris,D,MTL,24,0,0,0,0
6,8478450,Parker Wotherspoon,D,BOS,27,0,0,0,0
6,8481812,Nikolai Knyzhov,D,SJS,27,0,0,0,0
6,8480001,Urho Vaakanainen,D,ANA,25,0,0,0,0
6,8482176,Wyatt Kaiser,D,CHI,22,0,0,0,0
6,8481122,Simon Benoit,D,TOR,26,0,0,0,0
6,8476441,Joel Edmundson,D,TOR,31,0,0,0,0
6,8480884,Calen Addison,D,SJS,24,0,0,0,0
6,8482511,Mason Lohrei,D,BOS,23,0,0,0,0
6,8482192,Isaak Phillips,D,CHI,23,0,0,0,0
6,8480950,Ilya Lyubushkin,D,TOR,30,0,0,0,0
6,8474031,Kevin Shattenkirk,D,BOS,35,0,0,0,0
6,8475718,Justin Holl,D,DET,32,0,0,0,0
6,8479402,Jake Bean,D,CBJ,26,0,0,0,0
6,8474602,Justin Schultz,D,SEA,34,0,0,0,0
6,8477950,Tony DeAngelo,D,CAR,29,0,0,0,0
6,8481743,Marc Del Gaizo,D,NSH,25,0,0,0,0
6,8481527,Kaedan Korczak,D,VGK,23,0,0,0,0
6,8480192,Johnathan Kovacevic,D,MTL,27,0,0,0,0
6,8476874,Olli Maatta,D,DET,30,0,0,0,0
6,8482144,Jack Thompson,D,SJS,22,0,0,0,0
6,8480222,Sebastian Aho,D,NYI,28,0,0,0,0
6,8479458,Nikita Zaitsev,D,CHI,33,0,0,0,0
6,8471709,Marc-Edouard Vlasic,D,SJS,37,0,0,0,0
6,8482929,Emil Lilleberg,D,TBL,23,0,0,0,0
6,8477018,Ben Hutton,D,VGK,31,0,0,0,0
6,8481056,Spencer Stastney,D,NSH,24,0,0,0,0
6,8481593,Jayden Struble,D,MTL,23,0,0,0,0
6,8479982,Conor Timmins,D,TOR,26,0,0,0,0
6,8474090,Brendan Smith,D,NJD,35,0,0,0,0
6,8482964,Arber Xhekaj,D,MTL,23,0,0,0,0
6,8480891,Michael Kesselring,D,ARI,24,0,0,0,0
6,8477938,Haydn Fleury,D,TBL,28,0,0,0,0
6,8481806,Louis Crevier,D,CHI,23,0,0,0,0
6,8471274,Alex Goligoski,D,MIN,39,0,0,0,0
6,8481600,Tobias Bjornfot,D,FLA,23,0,0,0,0
6,8475797,Jarred Tinordi,D,CHI,32,0,0,0,0
6,8481521,Ronnie Attard,D,PHI,25,0,0,0,0
6,8474612,Travis Hamonic,D,OTT,34,0,0,0,0
6,8479576,Vincent Desharnais,D,EDM,28,0,0,0,0
6,8480049,Dylan Samberg,D,WPG,25,0,0,0,0
6,8483619,Filip Roos,D,CHI,25,0,0,0,0
6,8474568,Luke Schenn,D,NSH,35,0,0,0,0
6,8480184,Gustav Lindstrom,D,ANA,26,0,0,0,0
6,8480070,Ian Mitchell,D,BOS,25,0,0,0,0
6,8480196,Jacob Bryson,D,BUF,27,0,0,0,0
6,8471686,Marc Staal,D,PHI,37,0,0,0,0
6,8477467,Gustav Olofsson,D,SEA,30,0,0,0,0
6,8478970,Jalen Chatfield,D,CAR,28,0,0,0,0
6,8479348,Kale Clague,D,BUF,26,0,0,0,0
6,8473446,Erik Johnson,D,PHI,36,0,0,0,0
6,8477462,Robert Hagg,D,ANA,29,0,0,0,0
6,8478454,Noah Juulsen,D,VAN,27,0,0,0,0
6,8477384,Josh Brown,D,ARI,30,0,0,0,0
6,8481708,Zac Jones,D,NYR,24,0,0,0,0
6,8481167,Brayden Pachal,D,CGY,25,0,0,0,0
6,8482067,Connor Mackey,D,NYR,28,0,0,0,0
6,8483460,David Jiricek,D,CBJ,21,0,0,0,0
6,8481701,Santeri Hatakka,D,NJD,23,0,0,0,0
6,8478021,William Lagesson,D,ANA,28,0,0,0,0
6,8477851,Jordan Oesterle,D,CGY,32,0,0,0,0
6,8478452,Caleb Jones,D,COL,27,0,0,0,0
6,8479984,Cal Foote,D,NJD,26,0,0,0,0
6,8479639,Dylan Coghlan,D,CAR,26,0,0,0,0
6,8480874,Adam Ginning,D,PHI,24,0,0,0,0
6,8479321,Lucas Johansen,D,WSH,27,0,0,0,0
6,8480878,Nils Lundkvist,D,DAL,24,0,0,0,0
6,8482165,Yan Kuznetsov,D,CGY,22,0,0,0,0
6,8484258,Sam Malinski,D,COL,26,0,0,0,0
6,8480157,Calle Rosen,D,STL,30,0,0,0,0
6,8484304,Uvis Balinskis,D,FLA,28,0,0,0,0
6,8479985,Cale Fleury,D,SEA,26,0,0,0,0
6,8479378,Logan Stanley,D,WPG,26,0,0,0,0
6,8477541,Dakota Mermis,D,MIN,30,0,0,0,0
6,8481609,Vladislav Kolyachonok,D,ARI,23,0,0,0,0
6,8480823,Alexander Alexeyev,D,WSH,25,0,0,0,0
6,8481679,Maxence Guenette,D,OTT,23,0,0,0,0
6,8481564,Ryan Johnson,D,BUF,23,0,0,0,0
6,8479376,Victor Mete,D,PHI,26,0,0,0,0
6,8484254,Akito Hirose,D,VAN,25,0,0,0,0
6,8482660,Kent Johnson,C,CBJ,22,0,0,0,0
6,8482149,Cole Perfetti,C,WPG,22,0,0,0,0
6,8477987,Ryan Donato,C,CHI,28,0,0,0,0
6,8475755,Alexander Petrovic,D,DAL,32,0,0,0,0
6,8477810,Joel Hanley,D,CGY,33,0,0,0,0
6,8474145,Robert Bortuzzo,D,NYI,35,0,0,0,0
6,8481161,Jake Christiansen,D,CBJ,25,0,0,0,0
6,8476884,Derrick Pouliot,D,DAL,30,0,0,0,0
6,8481716,Dmitri Voronkov,L,CBJ,24,0,0,0,0
6,8480084,Nick DeSimone,D,NJD,30,0,0,0,0
6,8475750,Jon Merrill,D,MIN,32,0,0,0,0
6,8479315,Joey Anderson,R,CHI,26,0,0,0,0
6,8478011,Louie Belpedio,D,PHI,28,0,0,0,0
6,8482451,Mikael Pyyhtia,L,CBJ,23,0,0,0,0
6,8481541,Samuel Bolduc,D,NYI,24,0,0,0,0
6,8482126,Emil Andrae,D,PHI,31,0,0,0,0
6,8474618,Marco Scandella,D,STL,34,0,0,0,0
6,8477244,Chad Ruhwedel,D,NYR,34,0,0,0,0
6,8477971,Andreas Englund,D,LAK,28,0,0,0,0
6,8480829,Jesperi Kotkaniemi,C,CAR,24,0,0,0,0
6,8479372,Josh Mahura,D,FLA,26,0,0,0,0
6,8482095,Tyler Kleven,D,OTT,22,0,0,0,0
6,8481719,Maxwell Crozier,D,TBL,24,0,0,0,0
6,8475855,Jesper Fast,R,CAR,33,0,0,0,0
6,8480848,Ty Dellandrea,C,DAL,24,0,0,0,0
6,8475193,Tomas Tatar,L,SEA,34,0,0,0,0
6,8476889,Radek Faksa,C,DAL,30,0,0,0,0
6,8478495,Denis Gurianov,R,PHI,27,0,0,0,0
6,8480216,Jacob Peterson,C,SJS,25,0,0,0,0
6,8480252,Cole Guttman,C,CHI,25,0,0,0,0
6,8479026,Philippe Myers,D,TBL,27,0,0,0,0
6,8481006,Tyler Tucker,D,STL,24,0,0,0,0
6,8481032,Paul Cotter,C,VGK,25,0,0,0,0
6,8481577,Philip Tomasino,C,NSH,23,0,0,0,0
6,8476918,Jimmy Vesey,L,NYR,31,0,0,0,0
6,8479320,Max Lajoie,D,TOR,27,0,0,0,0
6,8478017,Mark Friedman,D,VAN,29,0,0,0,0
6,8481754,Nikita Nesterenko,C,ANA,23,0,0,0,0
6,8483407,Brandon Scanlin,D,NYR,25,0,0,0,0
6,8482659,Josh Doan,R,ARI,22,0,0,0,0
6,8477446,Michael McCarron,R,NSH,29,0,0,0,0
6,8477903,Garnet Hathaway,R,PHI,33,0,0,0,0
6,8482153,Brendan Brisson,C,VGK,23,0,0,0,0
6,8483546,Marshall Rifai,D,TOR,26,0,0,0,0
6,8484287,Cole McWard,D,VAN,23,0,0,0,0
6,8478854,Ryan Shea,D,PIT,27,0,0,0,0
6,8481585,Egor Afanasyev,L,NSH,23,0,0,0,0
6,8483398,Declan Carlile,D,TBL,31,0,0,0,0
6,8478502,Dennis Gilbert,D,CGY,28,0,0,0,0
6,8482749,Joshua Roy,R,MTL,21,0,0,0,0
6,8481598,Philip Broberg,D,EDM,23,0,0,0,0
6,8480835,Jack Drury,C,CAR,24,0,0,0,0
6,8480748,Kiefer Sherwood,L,NSH,29,0,0,0,0
6,8476934,Brock McGinn,L,ANA,30,0,0,0,0
6,8480870,Bo Groulx,C,ANA,24,0,0,0,0
6,8479368,Max Jones,L,ANA,26,0,0,0,0
6,8478099,Kevin Labanc,R,SJS,29,0,0,0,0
6,8478067,Oskar Lindblom,L,SJS,28,0,0,0,0
6,8476393,Nick Cousins,C,FLA,31,0,0,0,0
6,8483395,Arshdeep Bains,L,VAN,23,0,0,0,0
6,8480762,Eric Robinson,L,BUF,29,0,0,0,0
6,8479439,Jacob MacDonald,D,SJS,31,0,0,0,0
6,8476474,Stefan Noesen,R,CAR,31,0,0,0,0
6,8482787,Nikita Chibrikov,R,WPG,31,0,0,0,0
6,8478432,Christian Fischer,R,DET,27,0,0,0,0
6,8477979,Nicolas Aube-Kubel,R,WSH,28,0,0,0,0
6,8481789,Tye Kartye,L,SEA,23,0,0,0,0
6,8479330,Brandon Gignac,C,MTL,27,0,0,0,0
6,8480075,Cameron Crotty,D,ARI,25,0,0,0,0
6,8473473,Milan Lucic,L,BOS,36,0,0,0,0
6,8482094,Daemon Hunt,D,MIN,22,0,0,0,0
6,8481206,John Ludvig,D,PIT,24,0,0,0,0
6,8483630,Pavol Regenda,L,ANA,25,0,0,0,0
6,8481617,Vasily Podkolzin,R,VAN,23,0,0,0,0
6,8480306,Grant Hutton,D,NYI,29,0,0,0,0
6,8480995,Pontus Holmberg,R,TOR,25,0,0,0,0
6,8482148,Hendrix Lapierre,C,WSH,22,0,0,0,0
6,8477478,William Carrier,L,VGK,30,0,0,0,0
6,8480003,Jesper Boqvist,C,BOS,26,0,0,0,0
6,8482172,Landon Slaggert,L,CHI,22,0,0,0,0
6,8480789,Oliver Wahlstrom,R,NYI,24,0,0,0,0
6,8474062,Riley Nash,C,NYR,35,0,0,0,0
6,8480021,Jack Studnicka,C,SJS,25,0,0,0,0
6,8480025,MacKenzie Entwistle,R,CHI,25,0,0,0,0
6,8481582,Nicholas Robertson,L,TOR,23,0,0,0,0
6,8476867,Brendan Gaunce,C,CBJ,30,0,0,0,0
6,8479619,Michael Carcone,L,ARI,28,0,0,0,0
6,8479370,Tyson Jost,C,BUF,26,0,0,0,0
6,8479671,Mathieu Olivier,R,CBJ,27,0,0,0,0
6,8476994,Vinnie Hinostroza,C,PIT,30,0,0,0,0
6,8482070,Mitchell Chaffee,R,TBL,26,0,0,0,0
6,8477473,Justin Bailey,R,SJS,29,0,0,0,0
6,8479344,Jesse Puljujarvi,R,PIT,26,0,0,0,0
6,8480205,Emil Bemstrom,C,PIT,25,0,0,0,0
6,8479718,Alex Barré-Boulet,C,TBL,27,0,0,0,0
6,8482061,Brandon Biro,L,BUF,26,0,0,0,0
6,8479638,Justin Brazeau,R,BOS,26,0,0,0,0
6,8474040,Sam Gagner,C,EDM,35,0,0,0,0
6,8477846,Ryan Carpenter,C,SJS,33,0,0,0,0
6,8482077,Dylan Holloway,L,EDM,23,0,0,0,0
6,8482157,Will Cuylle,L,NYR,22,0,0,0,0
6,8480007,Jonas Rondbjerg,R,VGK,25,0,0,0,0
6,8478874,Adam Gaudette,C,STL,28,0,0,0,0
6,8478434,Keegan Kolesar,R,VGK,27,0,0,0,0
6,8480441,Trey Fix-Wolansky,R,CBJ,25,0,0,0,0
6,8479994,Jaret Anderson-Dolan,C,NSH,25,0,0,0,0
6,8483567,Georgii Merkulov,C,BOS,24,0,0,0,0
6,8477380,Jonny Brodzinski,C,NYR,31,0,0,0,0
6,8482201,Gage Goncalves,C,TBL,23,0,0,0,0
6,8478211,Dryden Hunt,L,CGY,29,0,0,0,0
6,8471699,Andrew Cogliano,C,COL,37,0,0,0,0
6,8479421,Jacob Moverare,D,LAK,26,0,0,0,0
6,8478881,Brett Seney,L,CHI,28,0,0,0,0
6,8477464,Nic Petan,C,MIN,29,0,0,0,0
6,8475958,Michael Sgarbossa,C,WSH,32,0,0,0,0
6,8481147,Reese Johnson,C,CHI,26,0,0,0,0
6,8479336,Carl Grundstrom,R,LAK,27,0,0,0,0
6,8480853,Liam Foudy,C,NSH,24,0,0,0,0
6,8479522,Hardy Haman Aktell,D,WSH,26,0,0,0,0
6,8481462,Mason Morelli,L,VGK,28,0,0,0,0
6,8482102,Vasily Ponomarev,C,CAR,22,0,0,0,0
6,8480844,Grigori Denisenko,L,VGK,24,0,0,0,0
6,8479944,Zach Aston-Reese,C,DET,30,0,0,0,0
6,8482784,Zach Dean,C,STL,21,0,0,0,0
6,8479419,Brett Murray,L,BUF,26,0,0,0,0
6,8479520,Brandon Duhaime,R,COL,27,0,0,0,0
6,8477573,Nathan Walker,L,STL,30,0,0,0,0
6,8478078,Rourke Chartier,C,OTT,28,0,0,0,0
6,8475795,Dylan McIlrath,D,WSH,32,0,0,0,0
6,8482496,Nils Aman,C,VAN,24,0,0,0,0
6,8480289,Morgan Barron,C,WPG,26,0,0,0,0
6,8481751,Lukas Rousek,R,BUF,25,0,0,0,0
6,8480011,Klim Kostin,C,SJS,25,0,0,0,0
6,8481556,John Beecher,C,BOS,23,0,0,0,0
6,8475278,Byron Froese,C,VGK,33,0,0,0,0
6,8475225,Craig Smith,C,DAL,35,0,0,0,0
6,8484326,Patrik Koch,D,ARI,28,0,0,0,0
6,8477930,Pierre-Edouard Bellemare,L,SEA,39,0,0,0,0
6,8478409,Anthony Richard,C,BOS,28,0,0,0,0
6,8481024,Linus Karlsson,C,VAN,25,0,0,0,0
6,8479986,Kole Lind,R,SEA,26,0,0,0,0
6,8479414,Nathan Bastian,R,NJD,27,0,0,0,0
6,8479362,Riley Tufte,L,COL,26,0,0,0,0
6,8481058,Jesse Ylönen,R,MTL,25,0,0,0,0
6,8482476,Emil Heineman,L,MTL,23,0,0,0,0
6,8482861,Vincent Iorio,D,WSH,22,0,0,0,0
6,8483432,Luca Del Bel Belluz,C,CBJ,31,0,0,0,0
6,8482744,James Malatesta,L,CBJ,21,0,0,0,0
6,8477887,Patrick Brown,C,BOS,32,0,0,0,0
6,8478585,Derek Ryan,C,EDM,38,0,0,0,0
6,8481441,Joe Snively,C,WSH,28,0,0,0,0
6,8481592,Jakob Pelletier,L,CGY,23,0,0,0,0
6,8482634,Alex Steeves,C,TOR,25,0,0,0,0
6,8477126,Jayson Megna,C,BOS,34,0,0,0,0
6,8475752,Tyler Pitlick,C,NYR,33,0,0,0,0
6,8480008,Adam Ruzicka,C,ARI,25,0,0,0,0
6,8481065,Angus Crookshank,L,OTT,25,0,0,0,0
6,8479547,Matthew Phillips,R,WSH,26,0,0,0,0
6,8480226,Marián Studenic,R,SEA,26,0,0,0,0
6,8481237,Kyle MacLean,C,NYI,25,0,0,0,0
6,8475413,Justin Dowling,C,NJD,34,0,0,0,0
6,8481641,Joel Kiviranta,L,COL,28,0,0,0,0
6,8478104,Sammy Blais,L,STL,28,0,0,0,0
6,8477454,Adam Erne,L,EDM,29,0,0,0,0
6,8481518,Nolan Foote,L,NJD,24,0,0,0,0
6,8480245,Olle Lycksell,R,PHI,25,0,0,0,0
6,8483570,Ben Meyers,C,ANA,26,0,0,0,0
6,8480776,Sheldon Rempal,R,VGK,29,0,0,0,0
6,8483920,Pierrick Dube,R,WSH,23,0,0,0,0
6,8480267,Sammy Walker,C,MIN,25,0,0,0,0
6,8482747,Brennan Othmann,L,NYR,21,0,0,0,0
6,8479991,Jake Leschyshyn,C,NYR,25,0,0,0,0
6,8478400,Colin White,C,MTL,27,0,0,0,0
6,8479328,Julien Gauthier,R,NYI,27,0,0,0,0
6,8484325,Waltteri Merela,C,TBL,26,0,0,0,0
6,8479066,Ryan Lomberg,L,FLA,30,0,0,0,0
6,8477070,Liam O'Brien,C,ARI,30,0,0,0,0
6,8478146,Matthew Highmore,C,OTT,28,0,0,0,0
6,8478028,Fredrik Olofsson,L,COL,28,0,0,0,0
6,8480880,Jakub Lauko,C,BOS,24,0,0,0,0
6,8479968,Vinni Lettieri,C,MIN,29,0,0,0,0
6,8474709,Matt Martin,L,NYI,35,0,0,0,0
6,8480845,Rasmus Kupari,C,WPG,24,0,0,0,0
6,8481550,Adam Beckman,L,MIN,23,0,0,0,0
6,8481422,Jacob Lucchini,C,MIN,29,0,0,0,0
6,8477401,John Hayden,C,SEA,29,0,0,0,0
6,8478904,Steven Lorentz,C,FLA,28,0,0,0,0
6,8482088,Justin Sourdif,R,FLA,22,0,0,0,0
6,8482751,Ryan Winterton,C,SEA,21,0,0,0,0
6,8482241,Radim Zohorna,L,PIT,28,0,0,0,0
6,8481690,Tyler Angle,C,CBJ,24,0,0,0,0
6,8476952,Dominic Toninato,C,WPG,30,0,0,0,0
6,8476919,Chris Tierney,C,NJD,30,0,0,0,0
6,8480032,Shane Bowers,C,NJD,25,0,0,0,0
6,8484314,Jiri Smejkal,L,OTT,28,0,0,0,0
6,8481239,Samuel Fagemo,L,LAK,24,0,0,0,0
6,8481532,Alex Turcotte,C,LAK,23,0,0,0,0
6,8481019,David Gustafsson,C,WPG,24,0,0,0,0
6,8478477,Mitchell Stephens,C,MTL,27,0,0,0,0
6,8479546,Oskar Steen,C,BOS,26,0,0,0,0
6,8480292,Carson Meyer,R,CBJ,27,0,0,0,0
6,8478446,Glenn Gawdin,C,ANA,27,0,0,0,0
6,8483531,Brian Halonen,L,NJD,25,0,0,0,0
6,8477149,Scott Sabourin,R,SJS,32,0,0,0,0
6,8479972,Mason Shaw,C,MIN,26,0,0,0,0
6,8480890,Jan Jenik,R,ARI,24,0,0,0,0
6,8478051,Max Willman,C,NJD,29,0,0,0,0
6,8480851,Akil Thomas,C,LAK,24,0,0,0,0
6,8482765,Isak Rosen,R,BUF,21,0,0,0,0
6,8478421,A.J. Greer,L,CGY,28,0,0,0,0
6,8478512,Austin Czarnik,C,DET,32,0,0,0,0
6,8479536,Axel Jonsson-Fjallby,L,WPG,26,0,0,0,0
6,8477320,Anton Blidh,L,NYR,29,0,0,0,0
6,8481543,Nikita Alexandrov,C,STL,24,0,0,0,0
6,8475235,Nicolas Deslauriers,L,PHI,33,0,0,0,0
6,8481070,Hugh McGing,L,STL,26,0,0,0,0
6,8480836,Jonathan Gruden,C,PIT,24,0,0,0,0
6,8481591,Sam Poulin,R,PIT,23,0,0,0,0
6,8477962,Brendan Lemieux,L,CAR,28,0,0,0,0
6,8483401,Marc Johnstone,R,PIT,28,0,0,0,0
6,8482250,Callahan Burke,C,CAR,27,0,0,0,0
6,8481726,Adam Edstrom,C,NYR,24,0,0,0,0
6,8471817,Ryan Reaves,R,TOR,37,0,0,0,0
6,8479587,Rhett Gardner,C,PHI,28,0,0,0,0
6,8475766,Austin Watson,L,TBL,32,0,0,0,0
6,8479367,William Lockwood,R,FLA,26,0,0,0,0
6,8478424,Jansen Harkins,C,PIT,27,0,0,0,0
6,8476913,Devin Shore,C,SEA,30,0,0,0,0
6,8482652,Walker Duehr,R,CGY,27,0,0,0,0
6,8477527,Ross Johnston,L,ANA,30,0,0,0,0
6,8481077,John Leonard,L,ARI,26,0,0,0,0
6,8483549,Lucas Condotta,L,MTL,27,0,0,0,0
6,8480468,James Hamblin,L,EDM,25,0,0,0,0
6,8476907,Mackenzie MacEachern,L,STL,30,0,0,0,0
6,8479543,Michael Pezzetta,L,MTL,26,0,0,0,0
6,8480355,Mark Kastelic,C,OTT,25,0,0,0,0
6,8482162,Roby Jarventie,L,OTT,22,0,0,0,0
6,8479772,Zack MacEwen,R,OTT,28,0,0,0,0
6,8483597,Milos Kelemen,L,ARI,25,0,0,0,0
6,8479379,Givani Smith,R,SJS,26,0,0,0,0
6,8481655,Cole Schwindt,R,CGY,23,0,0,0,0
6,8479981,Jonah Gadjovich,L,FLA,26,0,0,0,0
6,8482147,Jean-Luc Foudy,C,COL,22,0,0,0,0
6,8484255,Jason Polin,R,COL,25,0,0,0,0
6,8477993,Justin Kirkland,C,ARI,28,0,0,0,0
6,8479249,Andrew Poturalski,C,SEA,30,0,0,0,0
6,8482197,Adam Raska,R,MIN,23,0,0,0,0
6,8475780,Chris Wagner,R,COL,33,0,0,0,0
6,8479533,Joona Koppanen,L,PIT,26,0,0,0,0
6,8481534,Raphael Lavoie,C,EDM,24,0,0,0,0
6,8484321,Nikolas Matinpalo,D,OTT,26,0,0,0,0
6,8481043,Cole Koepke,L,TBL,26,0,0,0,0
6,8476323,Max McCormick,L,SEA,32,0,0,0,0
6,8483609,Adam Klapka,R,CGY,24,0,0,0,0
6,8483512,Matt Savoie,C,BUF,20,0,0,0,0
6,8484259,Ondrej Pavel,C,COL,31,0,0,0,0
6,8478147,Bokondji Imama,L,OTT,28,0,0,0,0
6,8482460,Matt Rempe,C,NYR,22,0,0,0,0
6,8477073,Kurtis MacDermid,L,NJD,30,0,0,0,0
6,8480274,Philip Kemp,D,EDM,25,0,0,0,0
6,8478956,Samuel Laberge,L,NJD,27,0,0,0,0
6,8483045,Cameron Butler,R,CBJ,31,0,0,0,0
7,8478402,Connor McDavid,C,EDM,27,82,45,82,127
7,8479318,Auston Matthews,C,TOR,27,82,58,59,117
7,8476453,Nikita Kucherov,R,TBL,31,82,39,75,114
7,8477956,David Pastrnak,R,BOS,28,82,46,58,104
7,8477934,Leon Draisaitl,C,EDM,29,82,40,63,103
7,8481559,Jack Hughes,C,NJD,23,82,48,53,101
7,8477939,William Nylander,R,TOR,28,82,45,56,101
7,8478550,Artemi Panarin,L,NYR,33,82,36,64,100
7,8477492,Nathan MacKinnon,C,COL,29,82,40,56,96
7,8478420,Mikko Rantanen,R,COL,28,82,39,54,93
7,8479314,Matthew Tkachuk,L,FLA,27,82,29,64,93
7,8476468,J.T. Miller,C,VAN,31,82,39,53,92
7,8478864,Kirill Kaprizov,L,MIN,27,82,46,43,89
7,8478427,Sebastian Aho,C,CAR,27,82,29,59,88
7,8479343,Clayton Keller,R,ARI,26,82,30,57,87
7,8471675,Sidney Crosby,C,PIT,37,82,36,49,85
7,8477940,Nikolaj Ehlers,L,WPG,28,82,38,46,84
7,8477402,Pavel Buchnevich,L,STL,29,82,31,51,82
7,8478010,Brayden Point,C,TBL,28,82,45,36,81
7,8477942,Kevin Fiala,L,LAK,28,82,29,51,80
7,8480027,Jason Robertson,L,DAL,25,82,25,55,80
7,8480069,Cale Makar,D,COL,26,82,23,57,80
7,8477946,Dylan Larkin,C,DET,28,82,32,47,79
7,8482116,Tim Stützle,C,OTT,22,82,27,52,79
7,8477933,Sam Reinhart,C,FLA,29,82,50,28,78
7,8475913,Mark Stone,R,VGK,32,82,29,48,77
7,8481523,Kirby Dach,C,MTL,23,82,20,57,77
7,8478440,Dylan Strome,C,WSH,27,82,32,43,75
7,8480002,Nico Hischier,C,NJD,25,82,27,48,75
7,8474141,Patrick Kane,R,DET,36,82,28,46,74
7,8480023,Robert Thomas,C,STL,25,82,21,53,74
7,8471214,Alex Ovechkin,L,WSH,39,82,34,38,72
7,8480012,Elias Pettersson,C,VAN,26,82,31,41,72
7,8476887,Filip Forsberg,L,NSH,30,82,30,42,72
7,8479385,Jordan Kyrou,C,STL,26,82,30,42,72
7,8475692,Mats Zuccarello,R,MIN,37,82,22,50,72
7,8476456,Jonathan Huberdeau,C,CGY,31,82,15,57,72
7,8478403,Jack Eichel,C,VGK,28,82,33,37,70
7,8480018,Nick Suzuki,C,MTL,25,82,28,42,70
7,8477951,Nick Schmaltz,C,ARI,28,82,22,48,70
7,8478445,Mathew Barzal,C,NYI,27,82,18,52,70
7,8481557,Matt Boldy,L,MIN,23,82,34,35,69
7,8477493,Aleksander Barkov,C,FLA,29,82,21,48,69
7,8479323,Adam Fox,D,NYR,26,82,16,53,69
7,8481540,Cole Caufield,R,MTL,23,82,37,31,68
7,8477960,Adrian Kempe,R,LAK,28,82,30,38,68
7,8479407,Jesper Bratt,L,NJD,26,82,25,43,68
7,8478460,Zach Werenski,D,CBJ,27,82,13,55,68
7,8474564,Steven Stamkos,C,TBL,34,82,33,34,67
7,8480188,Fabian Zetterlund,L,SJS,25,82,29,38,67
7,8477949,Alex Tuch,R,BUF,28,82,26,41,67
7,8476454,Ryan Nugent-Hopkins,C,EDM,31,82,22,45,67
7,8480865,Noah Dobson,D,NYI,24,82,10,57,67
7,8477500,Bo Horvat,C,NYI,29,82,39,27,66
7,8475810,Bryan Rust,R,PIT,32,82,29,37,66
7,8480801,Brady Tkachuk,L,OTT,25,82,33,32,65
7,8476459,Mika Zibanejad,C,NYR,31,82,32,33,65
7,8478444,Brock Boeser,R,VAN,27,82,31,34,65
7,8478439,Travis Konecny,R,PHI,27,82,29,36,65
7,8473419,Brad Marchand,L,BOS,36,82,28,37,65
7,8473994,Jamie Benn,L,DAL,35,82,27,38,65
7,8479337,Alex DeBrincat,R,DET,27,82,26,39,65
7,8474150,Mikael Backlund,C,CGY,35,82,22,43,65
7,8475798,Mikael Granlund,C,SJS,32,82,19,46,65
7,8475184,Chris Kreider,L,NYR,33,82,42,22,64
7,8475166,John Tavares,C,TOR,34,82,29,35,64
7,8478493,Joel Eriksson Ek,C,MIN,27,82,28,36,64
7,8482684,Luke Hughes,D,NJD,21,82,24,40,64
7,8475167,Victor Hedman,D,TBL,34,82,14,50,64
7,8478873,Troy Terry,R,ANA,27,82,32,31,63
7,8478042,Viktor Arvidsson,R,LAK,31,82,21,42,63
7,8474600,Roman Josi,D,NSH,34,82,17,46,63
7,8477447,Shea Theodore,D,VGK,29,82,13,50,63
7,8480800,Quinn Hughes,D,VAN,25,82,8,55,63
7,8475786,Zach Hyman,L,EDM,32,82,39,23,62
7,8475754,Brock Nelson,C,NYI,33,82,31,31,62
7,8475784,Jeff Skinner,C,BUF,32,82,25,37,62
7,8476389,Vincent Trocheck,C,NYR,31,82,23,39,62
7,8471215,Evgeni Malkin,C,PIT,38,82,16,46,62
7,8478398,Kyle Connor,L,WPG,28,82,25,36,61
7,8477409,Carter Verhaeghe,C,FLA,29,82,24,37,61
7,8477479,Tyler Bertuzzi,L,TOR,29,82,24,37,61
7,8473512,Claude Giroux,R,OTT,36,82,22,39,61
7,8475726,Tyler Toffoli,C,WPG,32,82,27,33,60
7,8480039,Martin Necas,C,CAR,25,82,21,39,60
7,8482093,Seth Jarvis,C,CAR,22,82,27,32,59
7,8479420,Tage Thompson,C,BUF,27,82,24,35,59
7,8480830,Andrei Svechnikov,R,CAR,24,82,20,39,59
7,8477496,Elias Lindholm,C,VAN,30,82,20,39,59
7,8477416,Oliver Bjorkstrand,R,SEA,29,82,18,41,59
7,8471685,Anze Kopitar,C,LAK,37,82,16,43,59
7,8482078,Lucas Raymond,L,DET,22,82,23,35,58
7,8476460,Mark Scheifele,C,WPG,31,82,21,37,58
7,8470794,Joe Pavelski,C,DAL,40,82,20,38,58
7,8479999,Casey Mittelstadt,C,COL,26,82,15,43,58
7,8477501,Valeri Nichushkin,R,COL,29,82,30,27,57
7,8476483,Rickard Rakell,R,PIT,31,82,27,30,57
7,8474157,Max Pacioretty,L,WSH,36,82,27,30,57
7,8475170,Brayden Schenn,C,STL,33,82,21,36,57
7,8474590,John Carlson,D,WSH,34,82,12,45,57
7,8476881,Tomas Hertl,C,VGK,31,82,36,20,56
7,8483808,Andrei Kuzmenko,L,CGY,28,82,30,26,56
7,8477404,Jake Guentzel,C,CAR,30,82,28,28,56
7,8478414,Timo Meier,R,NJD,28,82,27,29,56
7,8482720,Matthew Knies,L,TOR,22,82,16,40,56
7,8476853,Morgan Rielly,D,TOR,30,82,6,50,56
7,8476399,Blake Coleman,C,CGY,33,82,31,24,55
7,8478474,Lawson Crouse,L,ARI,27,82,29,26,55
7,8479339,Patrik Laine,L,CBJ,26,82,28,27,55
7,8479400,Pierre-Luc Dubois,L,LAK,26,82,26,29,55
7,8480208,Drake Batherson,R,OTT,26,82,25,30,55
7,8475172,Nazem Kadri,C,CGY,34,82,21,34,55
7,8482745,Mason McTavish,C,ANA,21,82,21,34,55
7,8480839,Rasmus Dahlin,D,BUF,24,82,16,39,55
7,8482740,Wyatt Johnston,C,DAL,21,82,24,30,54
7,8480803,Evan Bouchard,D,EDM,25,82,9,45,54
7,8476539,Jonathan Marchessault,R,VGK,34,82,23,30,53
7,8477935,Sam Bennett,C,FLA,28,82,23,30,53
7,8475745,Charlie Coyle,C,BOS,32,82,20,33,53
7,8476346,Johnny Gaudreau,L,CBJ,31,82,19,34,53
7,8481533,Trevor Zegras,C,ANA,23,82,18,35,53
7,8476882,Teuvo Teravainen,L,CAR,30,82,18,35,53
7,8479325,Charlie McAvoy,D,BOS,27,82,10,43,53
7,8481542,Moritz Seider,D,DET,23,82,9,44,53
7,8480064,Josh Norris,C,OTT,25,82,32,20,52
7,8482699,Dylan Guenther,R,ARI,21,82,29,23,52
7,8478466,Daniel Sprong,R,DET,27,82,25,27,52
7,8474037,James van Riemsdyk,L,BOS,35,82,18,34,52
7,8477504,Josh Morrissey,D,WPG,29,82,15,37,52
7,8480797,Joel Farabee,L,PHI,24,82,15,37,52
7,8480798,Philipp Kurashev,C,CHI,25,82,14,38,52
7,8480036,Miro Heiskanen,D,DAL,25,82,11,41,52
7,8476432,Boone Jenner,C,CBJ,31,82,29,22,51
7,8481528,Dylan Cozens,C,BUF,23,82,22,29,51
7,8482097,Jack Quinn,R,BUF,23,82,20,31,51
7,8477497,Sean Monahan,C,WPG,30,82,19,32,51
7,8479675,Trevor Moore,L,LAK,29,82,19,32,51
7,8479410,Mikhail Sergachev,D,TBL,26,82,8,43,51
7,8480014,Gabriel Vilardi,C,WPG,25,82,33,17,50
7,8478498,Jake DeBrusk,L,BOS,28,82,24,26,50
7,8479542,Brandon Hagel,L,TBL,26,82,23,27,50
7,8482110,Dawson Mercer,C,NJD,23,82,22,28,50
7,8481711,Matias Maccelli,L,ARI,24,82,13,37,50
7,8476906,Shayne Gostisbehere,D,DET,31,82,7,43,50
7,8477955,Jared McCann,L,SEA,28,82,27,22,49
7,8477932,Aaron Ekblad,D,FLA,28,82,12,37,49
7,8480031,Maxime Comtois,L,CAR,25,82,10,39,49
7,8479992,Michael Rasmussen,C,DET,25,82,24,24,48
7,8478047,Michael Bunting,L,PIT,29,82,23,25,48
7,8482665,Matty Beniers,C,SEA,22,82,22,26,48
7,8475722,Jason Zucker,L,NSH,32,82,22,26,48
7,8478975,Mason Marchment,L,DAL,29,82,19,29,48
7,8476479,Phillip Danault,C,LAK,31,82,18,30,48
7,8476462,Dougie Hamilton,D,NJD,31,82,18,30,48
7,8482667,William Eklund,L,SJS,22,82,15,33,48
7,8479345,Jakob Chychrun,D,OTT,26,82,15,33,48
7,8474586,Jordan Eberle,R,SEA,34,82,14,34,48
7,8474578,Erik Karlsson,D,PIT,34,82,10,38,48
7,8478397,Rasmus Andersson,D,CGY,28,82,10,38,48
7,8478366,Frank Vatrano,R,ANA,30,82,25,22,47
7,8475794,Tyler Seguin,C,DAL,32,82,18,29,47
7,8478401,Pavel Zacha,C,BOS,27,82,15,32,47
7,8475906,John Klingberg,D,TOR,32,82,12,35,47
7,8477503,Max Domi,C,TOR,29,82,11,36,47
7,8476448,William Karlsson,C,VGK,31,82,22,24,46
7,8475191,Reilly Smith,R,PIT,33,82,20,26,46
7,8477021,Alex Kerfoot,C,ARI,30,82,20,26,46
7,8475765,Vladimir Tarasenko,R,FLA,33,82,17,29,46
7,8478856,Conor Garland,R,VAN,28,82,16,30,46
7,8475168,Matt Duchene,C,DAL,33,82,14,32,46
7,8482124,Quinton Byfield,R,LAK,22,82,14,32,46
7,8483445,Cutter Gauthier,L,ANA,20,82,12,34,46
7,8483397,Marc McLaughlin,C,BOS,25,82,41,4,45
7,8482101,Danil Gushchin,L,SJS,22,82,27,18,45
7,8482159,Tyson Foerster,R,PHI,22,82,22,23,45
7,8478057,Dakota Joshua,C,VAN,28,82,21,24,45
7,8474679,Gustav Nyquist,C,NSH,35,82,19,26,45
7,8483515,Juraj Slafkovsky,L,MTL,20,82,18,27,45
7,8475753,Justin Faulk,D,STL,32,82,9,36,45
7,8474565,Alex Pietrangelo,D,VGK,34,82,7,38,45
7,8476905,Chandler Stephenson,C,VGK,30,82,3,42,45
7,8484166,Adam Fantilli,C,CBJ,20,82,24,20,44
7,8475151,Kyle Palmieri,C,NYI,33,82,23,21,44
7,8477346,MacKenzie Weegar,D,CGY,30,82,18,26,44
7,8478449,Roope Hintz,C,DAL,28,82,17,27,44
7,8476826,Yanni Gourde,C,SEA,33,82,13,31,44
7,8480078,Filip Chytil,C,NYR,25,82,13,31,44
7,8476329,Travis Boyd,C,ARI,31,82,12,32,44
7,8478038,Devon Toews,D,COL,30,82,11,33,44
7,8478396,Noah Hanifin,D,VGK,27,82,9,35,44
7,8479425,Filip Hronek,D,VAN,27,82,7,37,44
7,8475169,Evander Kane,L,EDM,33,82,26,17,43
7,8478462,Nicolas Roy,C,VGK,27,82,16,27,43
7,8481596,Shane Pinto,C,OTT,24,82,14,29,43
7,8478911,Matt Roy,D,LAK,29,82,14,29,43
7,8477986,Brandon Montour,D,FLA,30,82,11,32,43
7,8477495,Seth Jones,D,CHI,30,82,8,35,43
7,8482175,JJ Peterka,R,BUF,22,82,19,23,42
7,8478233,Andrew Mangiapane,L,CGY,28,82,17,25,42
7,8470613,Brent Burns,D,CAR,39,82,15,27,42
7,8482105,Jake Sanderson,D,OTT,22,82,8,34,42
7,8483471,Brad Lambert,C,WPG,31,82,3,39,42
7,8475314,Anders Lee,L,NYI,34,82,25,16,41
7,8478469,Thomas Chabot,D,OTT,27,82,19,22,41
7,8477476,Artturi Lehkonen,L,COL,29,82,18,23,41
7,8475158,Ryan O'Reilly,C,NSH,33,82,17,24,41
7,8481068,Yegor Sharangovich,C,CGY,26,82,17,24,41
7,8478472,Mathieu Joseph,R,OTT,27,82,15,26,41
7,8477444,Andre Burakovsky,L,SEA,29,82,14,27,41
7,8477429,Andrew Copp,C,DET,30,82,13,28,41
7,8477494,Jonathan Drouin,L,COL,29,82,10,31,41
7,8480028,Morgan Frost,C,PHI,25,82,9,32,41
7,8479525,Ross Colton,C,COL,28,82,23,17,40
7,8475799,Nino Niederreiter,R,WPG,32,82,19,21,40
7,8477456,J.T. Compher,L,DET,29,82,18,22,40
7,8471218,Blake Wheeler,R,NYR,38,82,15,25,40
7,8478542,Evan Rodrigues,C,FLA,31,82,12,28,40
7,8478055,Gustav Forsling,D,FLA,28,82,12,28,40
7,8476869,Brady Skjei,D,CAR,30,82,11,29,40
7,8479365,Trent Frederic,C,BOS,26,82,11,29,40
7,8481656,Aliaksei Protas,C,WSH,23,82,10,30,40
7,8471724,Kris Letang,D,PIT,37,82,7,33,40
7,8479316,Luke Kunin,C,SJS,27,82,25,14,39
7,8474149,Evgenii Dadonov,R,DAL,35,82,19,20,39
7,8481013,Jonatan Berggren,R,DET,24,82,18,21,39
7,8478046,Danton Heinen,L,BOS,29,82,17,22,39
7,8477998,Warren Foegele,L,EDM,28,82,17,22,39
7,8476872,Scott Laughton,C,PHI,30,82,17,22,39
7,8477407,Anthony Duclair,L,TBL,29,82,15,24,39
7,8476927,Teddy Blueger,C,VAN,30,82,12,27,39
7,8480434,Sean Durzi,D,ARI,26,82,9,30,39
7,8478882,Vladislav Gavrikov,D,LAK,29,82,8,31,39
7,8481699,Aku Raty,R,ARI,23,82,2,37,39
7,8481016,Ruslan Iskhakov,C,NYI,24,82,2,37,39
7,8480015,Owen Tippett,R,PHI,25,82,23,15,38
7,8481624,Ilya Mikheyev,R,VAN,30,82,18,20,38
7,8474641,Adam Henrique,C,EDM,34,82,17,21,38
7,8484144,Connor Bedard,C,CHI,19,82,17,21,38
7,8477426,Nicholas Paul,L,TBL,29,82,17,21,38
7,8482475,Yegor Chinakhov,R,CBJ,23,82,16,22,38
7,8481186,Logan O'Connor,R,COL,28,82,16,22,38
7,8477952,Robby Fabbri,C,DET,28,82,16,22,38
7,8475744,Evgeny Kuznetsov,C,CAR,32,82,14,24,38
7,8480009,Eeli Tolvanen,R,SEA,25,82,14,24,38
7,8475197,Tyson Barrie,D,NSH,33,82,11,27,38
7,8474870,Tyler Johnson,C,CHI,34,82,11,27,38
7,8475149,Marcus Johansson,L,MIN,34,82,9,29,38
7,8475218,Mattias Ekholm,D,EDM,34,82,7,31,38
7,8482122,Brock Faber,D,MIN,22,82,7,31,38
7,8480871,Adam Boqvist,D,CBJ,24,82,4,34,38
7,8483524,Shane Wright,C,SEA,20,82,26,11,37
7,8481560,Arthur Kaliyev,R,LAK,23,82,22,15,37
7,8471698,T.J. Oshie,R,WSH,38,82,20,17,37
7,8480849,Barrett Hayton,C,ARI,24,82,20,17,37
7,8475791,Taylor Hall,L,CHI,33,82,18,19,37
7,8473533,Jordan Staal,C,CAR,36,82,18,19,37
7,8482109,Alexis Lafrenière,L,NYR,23,82,17,20,37
7,8479423,Alex Nylander,L,CBJ,26,82,16,21,37
7,8477947,Sonny Milano,L,WSH,28,82,16,21,37
7,8477451,Ryan Hartman,R,MIN,30,82,15,22,37
7,8476960,Andreas Athanasiou,C,CHI,30,82,15,22,37
7,8478438,Tommy Novak,C,NSH,27,82,12,25,37
7,8481703,Valtteri Puustinen,R,PIT,25,82,11,26,37
7,8480873,Rasmus Sandin,D,WSH,24,82,9,28,37
7,8475764,Cam Fowler,D,ANA,33,82,8,29,37
7,8475200,Dmitry Orlov,D,CAR,33,82,6,31,37
7,8480459,Pius Suter,C,VAN,28,82,22,14,36
7,8476880,Tom Wilson,R,WSH,30,82,18,18,36
7,8479987,Morgan Geekie,C,BOS,26,82,18,18,36
7,8474102,David Perron,L,DET,36,82,17,19,36
7,8476438,Brandon Saad,L,STL,32,82,16,20,36
7,8480113,Alex Iafallo,L,WPG,31,82,15,21,36
7,8482055,Drew O'Connor,L,PIT,26,82,15,21,36
7,8476458,Ryan Strome,C,ANA,31,82,9,27,36
7,8478407,Vince Dunn,D,SEA,28,82,5,31,36
7,8476792,Torey Krug,D,STL,33,82,5,31,36
7,8480145,Neal Pionk,D,WPG,29,82,5,31,36
7,8476981,Josh Anderson,R,MTL,30,82,17,18,35
7,8478519,Anthony Cirelli,C,TBL,27,82,16,19,35
7,8482146,Luke Evangelista,R,NSH,22,82,14,21,35
7,8481618,Alex Newhook,C,MTL,23,82,13,22,35
7,8474053,Logan Couture,C,SJS,35,82,13,22,35
7,8479415,Michael McLeod,C,NJD,26,82,12,23,35
7,8478458,Jack Roslovic,C,NYR,27,82,12,23,35
7,8476875,Mike Matheson,D,MTL,30,82,8,27,35
7,8476885,Jacob Trouba,D,NYR,30,82,6,29,35
7,8482089,Jake Neighbours,L,STL,22,82,21,13,34
7,8480893,Kirill Marchenko,R,CBJ,24,82,15,19,34
7,8480821,Filip Zadina,R,SJS,25,82,15,19,34
7,8482705,Cole Sillinger,C,CBJ,21,82,12,22,34
7,8482113,Anton Lundell,C,FLA,23,82,12,22,34
7,8476979,Erik Gustafsson,D,NYR,32,82,9,25,34
7,8480817,K'Andre Miller,D,NYR,24,82,6,28,34
7,8476921,Jordan Martinook,L,CAR,32,82,17,16,33
7,8475763,Kevin Hayes,R,STL,32,82,16,17,33
7,8479353,Brett Howden,C,VGK,26,82,14,19,33
7,8481546,Cam York,D,PHI,23,82,8,25,33
7,8476958,Jaccob Slavin,D,CAR,30,82,7,26,33
7,8476854,Hampus Lindholm,D,BOS,30,82,4,29,33
7,8482702,Logan Stankoven,C,DAL,21,82,21,11,32
7,8480185,Eetu Luostarinen,C,FLA,26,82,16,16,32
7,8482074,Connor Zary,C,CGY,23,82,13,19,32
7,8478133,Jake Evans,C,MTL,28,82,12,20,32
7,8478891,Mason Appleton,C,WPG,28,82,11,21,32
7,8477839,Conor Sheary,L,TBL,32,82,11,21,32
7,8475768,Jaden Schwartz,C,SEA,32,82,10,22,32
7,8474563,Drew Doughty,D,LAK,35,82,10,22,32
7,8473422,Nick Foligno,L,CHI,37,82,9,23,32
7,8477498,Darnell Nurse,D,EDM,29,82,8,24,32
7,8480043,Timothy Liljegren,D,TOR,25,82,4,28,32
7,8482733,Logan Mailloux,D,MTL,31,82,3,29,32
7,8481604,Pavel Dorofeyev,L,VGK,24,82,21,10,31
7,8481535,Nils Hoglander,L,VAN,24,82,18,13,31
7,8479393,Noah Gregor,C,TOR,26,82,16,15,31
7,8475287,Erik Haula,L,NJD,33,82,11,20,31
7,8481522,Peyton Krebs,C,BUF,23,82,11,20,31
7,8477964,Ivan Barbashev,C,VGK,29,82,10,21,31
7,8482624,Daniil Miromanov,D,CGY,27,82,10,21,31
7,8478500,Ivan Provorov,D,CBJ,27,82,8,23,31
7,8476892,Colton Parayko,D,STL,31,82,6,25,31
7,8475760,Nick Bjugstad,C,ARI,32,82,21,9,30
7,8477989,Christian Dvorak,C,MTL,28,82,20,10,30
7,8479390,Taylor Raddysh,R,CHI,26,82,20,10,30
7,8476469,Joel Armia,R,MTL,31,82,17,13,30
7,8473449,Kyle Okposo,R,FLA,36,82,17,13,30
7,8477511,Anthony Mantha,R,VGK,30,82,14,16,30
7,8476897,Oskar Sundqvist,C,STL,30,82,14,16,30
7,8481581,Thomas Harley,D,DAL,23,82,7,23,30
7,8476923,Damon Severson,D,CBJ,30,82,5,25,30
7,8477969,Marcus Pettersson,D,PIT,28,82,3,27,30
7,8478569,Noel Acciari,C,PIT,33,82,19,10,29
7,8475793,Ryan Johansen,C,PHI,32,82,15,14,29
7,8482679,Matt Coronato,R,CGY,22,82,14,15,29
7,8480074,Alexandre Texier,C,CBJ,25,82,13,16,29
7,8480220,Noah Cates,L,PHI,25,82,11,18,29
7,8476480,Vladislav Namestnikov,C,WPG,32,82,9,20,29
7,8477948,Travis Sanheim,D,PHI,28,82,9,20,29
7,8481567,Henry Thrun,D,SJS,23,82,9,20,29
7,8475181,Nick Leddy,D,STL,33,82,9,20,29
7,8482222,Alexander Barabanov,L,SJS,30,82,8,21,29
7,8479976,Juuso Valimaki,D,ARI,26,82,6,23,29
7,8481537,Nikita Okhotiuk,D,CGY,24,82,6,23,29
7,8480336,Sean Walker,D,COL,30,82,5,24,29
7,8476331,Dylan DeMelo,D,WPG,31,82,0,29,29
7,8484203,Bradly Nadeau,L,CAR,19,82,20,8,28
7,8470604,Jeff Carter,C,PIT,39,82,17,11,28
7,8477425,Miles Wood,L,COL,29,82,16,12,28
7,8476873,Mark Jankowski,C,NSH,30,82,16,12,28
7,8477953,Kasperi Kapanen,R,STL,28,82,15,13,28
7,8481580,Connor McMichael,C,WSH,23,82,14,14,28
7,8476392,Adam Lowry,C,WPG,31,82,13,15,28
7,8480855,Jack McBain,C,ARI,24,82,13,15,28
7,8483431,Logan Cooley,C,ARI,20,82,12,16,28
7,8475343,Nic Dowd,C,WSH,34,82,12,16,28
7,8478463,Anthony Beauvillier,L,NSH,27,82,11,17,28
7,8480802,Ryan McLeod,C,EDM,25,82,10,18,28
7,8479293,Brandon Tanev,L,SEA,33,82,9,19,28
7,8481606,Jordan Spence,D,LAK,23,82,8,20,28
7,8476461,Sean Couturier,C,PHI,32,82,8,20,28
7,8475171,Oliver Ekman-Larsson,D,FLA,33,82,8,20,28
7,8477919,Frederick Gaudreau,C,MIN,31,82,8,20,28
7,8476463,Jonas Brodin,D,MIN,31,82,6,22,28
7,8483457,Lane Hutson,D,MTL,20,82,3,25,28
7,8478507,John Marino,D,NJD,27,82,1,27,28
7,8482145,Mavrik Bourque,C,DAL,22,82,20,7,27
7,8479996,Cody Glass,C,NSH,25,82,14,13,27
7,8483499,Liam Ohgren,L,MIN,20,82,14,13,27
7,8480813,Joe Veleno,C,DET,24,82,13,14,27
7,8482737,Zack Bolduc,C,STL,21,82,13,14,27
7,8475714,Calle Jarnkrok,C,TOR,33,82,12,15,27
7,8478430,Oliver Kylington,D,CGY,27,82,12,15,27
7,8482730,Brandt Clarke,D,LAK,21,82,10,17,27
7,8483491,Ivan Miroshnichenko,L,WSH,20,82,10,17,27
7,8477488,Brett Pesce,D,CAR,30,82,8,19,27
7,8482133,Thomas Bordeleau,C,SJS,22,82,7,20,27
7,8476292,Ondrej Palat,L,NJD,33,82,6,21,27
7,8482142,Jamie Drysdale,D,PHI,22,82,6,21,27
7,8480281,Alexey Toropchenko,R,STL,25,82,16,10,26
7,8481704,Juuso Parssinen,C,NSH,23,82,16,10,26
7,8479977,Kailer Yamamoto,R,SEA,26,82,15,11,26
7,8478115,Pierre Engvall,L,NYI,28,82,14,12,26
7,8477353,Tyler Motte,C,TBL,29,82,12,14,26
7,8482079,Marco Rossi,C,MIN,23,82,12,14,26
7,8481481,Blake Lizotte,C,LAK,27,82,12,14,26
7,8477392,Hudson Fasching,R,NYI,29,82,11,15,26
7,8476931,Jake McCabe,D,TOR,31,82,10,16,26
7,8479591,Michael Eyssimont,C,TBL,28,82,10,16,26
7,8484153,Leo Carlsson,C,ANA,20,82,9,17,26
7,8478413,Jordan Greenway,L,BUF,27,82,7,19,26
7,8482245,Artem Zub,D,OTT,29,82,5,21,26
7,8479369,Andrew Peeke,D,BOS,26,82,5,21,26
7,8470621,Corey Perry,R,EDM,39,82,15,10,25
7,8473986,Alex Killorn,L,ANA,35,82,14,11,25
7,8477944,Jakub Vrana,L,STL,28,82,14,11,25
7,8482125,Alexander Holtz,R,NJD,22,82,13,12,25
7,8481477,Nico Sturm,C,SJS,29,82,12,13,25
7,8479661,Tanner Jeannot,L,TBL,27,82,12,13,25
7,8475220,Marcus Foligno,L,MIN,33,82,11,14,25
7,8479346,Dillon Dube,C,CGY,26,82,10,15,25
7,8478013,Jake Walman,D,DET,28,82,9,16,25
7,8476419,Jean-Gabriel Pageau,C,NYI,32,82,8,17,25
7,8478399,Jonas Siegenthaler,D,NJD,27,82,4,21,25
7,8474151,Ryan McDonagh,D,NSH,35,82,4,21,25
7,8473507,Jeff Petry,D,DET,37,82,3,22,25
7,8483493,Frank Nazar,C,CHI,20,82,15,9,24
7,8477406,Mattias Janmark,C,EDM,32,82,15,9,24
7,8470610,Zach Parise,L,COL,40,82,13,11,24
7,8474884,Mike Hoffman,C,SJS,35,82,12,12,24
7,8476525,Colin Miller,D,WPG,32,82,12,12,24
7,8480068,Ryan Poehling,C,PHI,25,82,9,15,24
7,8475848,Brendan Gallagher,R,MTL,32,82,8,16,24
7,8474009,Nick Bonino,C,NYR,36,82,8,16,24
7,8473563,Nicklas Backstrom,C,WSH,37,82,6,18,24
7,8482087,Kaiden Guhle,D,MTL,22,82,6,18,24
7,8477507,Nikita Zadorov,D,VAN,29,82,6,18,24
7,8481524,Bowen Byram,D,BUF,23,82,5,19,24
7,8480073,Erik Brannstrom,D,OTT,25,82,5,19,24
7,8480058,Pierre-Olivier Joseph,D,PIT,25,82,5,19,24
7,8480172,Jan Rutta,D,SJS,34,82,4,20,24
7,8480035,Henri Jokiharju,D,BUF,25,82,3,21,24
7,8479442,Troy Stecher,D,EDM,30,82,3,21,24
7,8478109,Victor Olofsson,L,BUF,29,82,11,12,23
7,8479359,Beck Malenstyn,L,WSH,26,82,8,15,23
7,8476925,Colton Sissons,C,NSH,31,82,7,16,23
7,8477015,Connor Brown,R,EDM,30,82,7,16,23
7,8476902,Esa Lindell,D,DAL,30,82,7,16,23
7,8476312,Josh Manson,D,COL,33,82,7,16,23
7,8477369,Carson Soucy,D,VAN,30,82,6,17,23
7,8483490,Pavel Mintyukov,D,ANA,21,82,6,17,23
7,8478136,Jake Middleton,D,MIN,28,82,5,18,23
7,8480144,David Kampf,C,TOR,29,82,5,18,23
7,8479324,Ryan Lindgren,D,NYR,26,82,4,19,23
7,8478443,Brandon Carlo,D,BOS,28,82,3,20,23
7,8477508,Curtis Lazar,C,NJD,29,82,10,12,22
7,8482259,Bobby McMann,C,TOR,28,82,10,12,22
7,8478043,Sam Lafferty,C,VAN,29,82,8,14,22
7,8482655,J.J. Moser,D,ARI,24,82,7,15,22
7,8482671,Owen Power,D,BUF,22,82,6,16,22
7,8475455,Brenden Dillon,D,WPG,34,82,5,17,22
7,8476457,Adam Larsson,D,SEA,32,82,4,18,22
7,8475233,David Savard,D,MTL,34,82,2,20,22
7,8480246,Nick Perbix,D,TBL,26,82,1,21,22
7,8482118,Sam Colangelo,R,ANA,23,82,16,5,21
7,8484145,Zach Benson,L,BUF,19,82,12,9,21
7,8476278,Colin Blackwell,C,CHI,31,82,11,10,21
7,8481554,Kaapo Kakko,R,NYR,23,82,10,11,21
7,8478020,Michael Amadio,C,VGK,28,82,10,11,21
7,8482062,Cole Smith,L,NSH,29,82,9,12,21
7,8477506,Ryan Pulock,D,NYI,30,82,7,14,21
7,8479398,Samuel Girard,D,COL,26,82,6,15,21
7,8479983,Mario Ferraro,D,SJS,26,82,6,15,21
7,8475462,Radko Gudas,D,ANA,34,82,5,16,21
7,8481568,Alex Vlasic,D,CHI,23,82,4,17,21
7,8476467,Jamie Oleksiak,D,SEA,32,82,4,17,21
7,8483482,Tristan Luneau,D,ANA,20,82,3,18,21
7,8477435,Ryan Graves,D,PIT,29,82,2,19,21
7,8475188,Brayden McNabb,D,VGK,33,82,2,19,21
7,8484911,Collin Graf,R,SJS,22,82,1,20,21
7,8476442,Matt Nieto,L,PIT,32,82,13,7,20
7,8482155,Alex Laferriere,R,LAK,23,82,11,9,20
7,8481601,Simon Holmstrom,R,NYI,23,82,8,12,20
7,8481178,Egor Zamula,D,PHI,24,82,8,12,20
7,8482117,Lukas Reichel,L,CHI,22,82,7,13,20
7,8480448,Parker Kelly,L,OTT,25,82,7,13,20
7,8482092,Ridly Greig,C,OTT,22,82,6,14,20
7,8482166,Shakir Mukhamadullin,D,SJS,22,82,6,14,20
7,8483495,Simon Nemec,D,NJD,20,82,5,15,20
7,8478840,Will Borgen,D,SEA,28,82,5,15,20
7,8476967,Brett Kulak,D,EDM,30,82,4,16,20
7,8474574,Tyler Myers,D,VAN,34,82,3,17,20
7,8482470,Ilya Solovyov,D,CGY,24,82,1,19,20
7,8483012,Logan Morrison,C,SEA,22,82,15,4,19
7,8480980,Connor Dewar,C,TOR,25,82,12,7,19
7,8481093,Rafael Harvey-Pinard,L,MTL,25,82,12,7,19
7,8480806,Isac Lundestrom,C,ANA,25,82,10,9,19
7,8476871,Tanner Pearson,L,MTL,32,82,9,10,19
7,8475164,Jakob Silfverberg,R,ANA,34,82,8,11,19
7,8482111,Justin Barron,D,MTL,23,82,7,12,19
7,8481028,Martin Pospisil,C,CGY,25,82,7,12,19
7,8470600,Ryan Suter,D,DAL,39,82,5,14,19
7,8474716,Jared Spurgeon,D,MIN,35,82,4,15,19
7,8482803,Olen Zellweger,D,ANA,21,82,4,15,19
7,8478851,Alexandre Carrier,D,NSH,28,82,4,15,19
7,8475208,Brian Dumoulin,D,SEA,33,82,4,15,19
7,8479371,Dante Fabbro,D,NSH,26,82,2,17,19
7,8482809,Jackson Blake,R,CAR,21,82,11,7,18
7,8475842,Sam Carrick,C,EDM,32,82,10,8,18
7,8481553,Bobby Brink,R,PHI,23,82,9,9,18
7,8476858,Phillip Di Giuseppe,L,VAN,31,82,8,10,18
7,8479514,Rem Pitlick,C,CHI,27,82,6,12,18
7,8479351,Sam Steel,C,DAL,26,82,5,13,18
7,8475790,Erik Gudbranson,D,CBJ,32,82,5,13,18
7,8474013,Ian Cole,D,VAN,35,82,4,14,18
7,8481014,Alexander Romanov,D,NYI,24,82,3,15,18
7,8478416,Erik Cernak,D,TBL,27,82,2,16,18
7,8476878,Zemgus Girgensons,L,BUF,30,82,12,5,17
7,8474189,Lars Eller,C,PIT,35,82,8,9,17
7,8474715,Cam Atkinson,R,PHI,35,82,6,11,17
7,8483565,Nick Blankenburg,D,CBJ,26,82,5,12,17
7,8479980,Nicolas Hague,D,VGK,26,82,5,12,17
7,8474166,Alec Martinez,D,VGK,37,82,5,12,17
7,8475690,Chris Tanev,D,DAL,35,82,4,13,17
7,8477220,Nate Schmidt,D,WPG,33,82,4,13,17
7,8483466,Kevin Korchinski,D,CHI,20,82,3,14,17
7,8475762,Derek Forbort,D,BOS,32,82,2,15,17
7,8477845,Trevor van Riemsdyk,D,WSH,33,82,2,15,17
7,8476917,Adam Pelech,D,NYI,30,82,1,16,17
7,8476879,Cody Ceci,D,EDM,31,82,1,16,17
7,8477499,Rasmus Ristolainen,D,PHI,30,82,1,16,17
7,8482712,Oskar Olausson,R,COL,22,82,1,16,17
7,8479941,Justin Danforth,R,CBJ,31,82,9,7,16
7,8477330,Dominik Kubalik,L,OTT,29,82,8,8,16
7,8477931,Tomas Nosek,L,NJD,32,82,8,8,16
7,8478178,Darren Raddysh,D,TBL,28,82,6,10,16
7,8476374,Sean Kuraly,C,CBJ,31,82,6,10,16
7,8474034,Pat Maroon,L,BOS,36,82,6,10,16
7,8478468,Jeremy Lauzon,D,NSH,27,82,5,11,16
7,8480990,Declan Chisholm,D,MIN,24,82,5,11,16
7,8476422,Mike Reilly,D,NYI,31,82,2,14,16
7,8479998,Mikey Anderson,D,LAK,25,82,2,14,16
7,8475324,Nick Jensen,D,WSH,34,82,0,16,16
7,8475231,Casey Cizikas,C,NYI,33,82,8,7,15
7,8478508,Yakov Trenin,C,COL,27,82,8,7,15
7,8477450,Jason Dickinson,C,CHI,29,82,7,8,15
7,8477505,Alexander Wennberg,C,NYR,30,82,7,8,15
7,8482666,Scott Morrow,D,CAR,22,82,7,8,15
7,8473453,Trevor Lewis,C,LAK,37,82,7,8,15
7,8476624,Barclay Goodrow,C,NYR,31,82,6,9,15
7,8482073,Braden Schneider,D,NYR,23,82,5,10,15
7,8478859,Niko Mikkola,D,FLA,28,82,4,11,15
7,8476822,Luke Glendening,C,TBL,35,82,4,11,15
7,8481605,Jackson LaCombe,D,ANA,23,82,3,12,15
7,8480860,Kevin Bahl,D,NJD,24,82,2,13,15
7,8477335,Kyle Burroughs,D,SJS,29,82,2,13,15
7,8478451,Ethan Bear,D,WSH,27,82,2,13,15
7,8482762,Simon Edvinsson,D,DET,21,82,9,5,14
7,8481517,Brett Leason,R,ANA,25,82,7,7,14
7,8473504,Cal Clutterbuck,R,NYI,37,82,7,7,14
7,8483505,Matthew Poitras,C,BOS,20,82,6,8,14
7,8478408,Travis Dermott,D,ARI,28,82,4,10,14
7,8482516,Matthew Kessel,D,STL,24,82,3,11,14
7,8475279,Ben Chiarot,D,DET,33,82,2,12,14
7,8474567,Zach Bogosian,D,MIN,34,82,2,12,14
7,8480879,Jacob Bernard-Docker,D,OTT,24,82,0,14,14
7,8479291,Kevin Rooney,C,CGY,31,82,5,8,13
7,8474673,TJ Brodie,D,TOR,34,82,4,9,13
7,8480796,Martin Fehervary,D,WSH,25,82,4,9,13
7,8480807,Mattias Samuelsson,D,BUF,24,82,0,13,13
7,8475179,Dmitry Kulikov,D,FLA,34,82,0,13,13
7,8482858,Ryker Evans,D,SEA,23,82,4,8,12
7,8477365,Connor Clifton,D,BUF,29,82,3,9,12
7,8482177,Marat Khusnutdinov,C,MIN,22,82,3,9,12
7,8481030,Jack St. Ivany,D,PIT,25,82,3,9,12
7,8480834,Ty Emberson,D,SJS,24,82,2,10,12
7,8476891,Matt Grzelcyk,D,BOS,30,82,1,11,12
7,8479383,Boris Katchouk,L,OTT,26,82,5,6,11
7,8476372,Nick Seeler,D,PHI,31,82,4,7,11
7,8483468,Jiri Kulich,C,BUF,20,82,4,7,11
7,8471677,Jack Johnson,D,COL,37,82,2,9,11
7,8476429,Scott Mayfield,D,NYI,32,82,2,9,11
7,8483489,Fraser Minten,C,TOR,31,82,6,4,10
7,8478831,Kevin Stenlund,C,FLA,28,82,5,5,10
7,8482713,Mackie Samoskevich,R,FLA,22,82,5,5,10
7,8481599,Victor Soderstrom,D,ARI,23,82,4,6,10
7,8470966,Mark Giordano,D,TOR,41,82,3,7,10
7,8481059,Scott Perunovich,D,STL,26,82,3,7,10
7,8476915,Jujhar Khaira,L,MIN,30,82,2,8,10
7,8476473,Connor Murphy,D,CHI,31,82,1,9,10
7,8475177,Calvin de Haan,D,TBL,33,82,3,6,9
7,8484149,Gavin Brindley,C,CBJ,20,82,2,7,9
7,8482859,Zack Ostapchuk,C,OTT,21,82,1,7,8
7,8477034,Jaycob Megna,D,CHI,32,82,2,5,7
7,8483763,Maksymilian Szuber,D,ARI,22,82,2,5,7
7,8482807,Ethan Del Mastro,D,CHI,21,82,1,5,6
7,8481578,Graeme Clarke,R,NJD,23,82,2,3,5
7,8475825,Jani Hakanpää,D,DAL,32,82,0,5,5
7,8482141,Lukas Cormier,D,VGK,22,0,0,0,0
7,8476988,Matt Benning,D,SJS,30,0,0,0,0
7,8480727,Zach Whitecloud,D,VGK,28,0,0,0,0
7,8480887,Jordan Harris,D,MTL,24,0,0,0,0
7,8478450,Parker Wotherspoon,D,BOS,27,0,0,0,0
7,8481812,Nikolai Knyzhov,D,SJS,27,0,0,0,0
7,8480001,Urho Vaakanainen,D,ANA,25,0,0,0,0
7,8482176,Wyatt Kaiser,D,CHI,22,0,0,0,0
7,8481122,Simon Benoit,D,TOR,26,0,0,0,0
7,8476441,Joel Edmundson,D,TOR,31,0,0,0,0
7,8480884,Calen Addison,D,SJS,24,0,0,0,0
7,8482511,Mason Lohrei,D,BOS,23,0,0,0,0
7,8482192,Isaak Phillips,D,CHI,23,0,0,0,0
7,8480950,Ilya Lyubushkin,D,TOR,30,0,0,0,0
7,8474031,Kevin Shattenkirk,D,BOS,35,0,0,0,0
7,8475718,Justin Holl,D,DET,32,0,0,0,0
7,8479402,Jake Bean,D,CBJ,26,0,0,0,0
7,8474602,Justin Schultz,D,SEA,34,0,0,0,0
7,8477950,Tony DeAngelo,D,CAR,29,0,0,0,0
7,8481743,Marc Del Gaizo,D,NSH,25,0,0,0,0
7,8481527,Kaedan Korczak,D,VGK,23,0,0,0,0
7,8480192,Johnathan Kovacevic,D,MTL,27,0,0,0,0
7,8476874,Olli Maatta,D,DET,30,0,0,0,0
7,8482144,Jack Thompson,D,SJS,22,0,0,0,0
7,8480222,Sebastian Aho,D,NYI,28,0,0,0,0
7,8479458,Nikita Zaitsev,D,CHI,33,0,0,0,0
7,8471709,Marc-Edouard Vlasic,D,SJS,37,0,0,0,0
7,8482929,Emil Lilleberg,D,TBL,23,0,0,0,0
7,8477018,Ben Hutton,D,VGK,31,0,0,0,0
7,8481056,Spencer Stastney,D,NSH,24,0,0,0,0
7,8481593,Jayden Struble,D,MTL,23,0,0,0,0
7,8479982,Conor Timmins,D,TOR,26,0,0,0,0
7,8474090,Brendan Smith,D,NJD,35,0,0,0,0
7,8482964,Arber Xhekaj,D,MTL,23,0,0,0,0
7,8480891,Michael Kesselring,D,ARI,24,0,0,0,0
7,8477938,Haydn Fleury,D,TBL,28,0,0,0,0
7,8481806,Louis Crevier,D,CHI,23,0,0,0,0
7,8471274,Alex Goligoski,D,MIN,39,0,0,0,0
7,8481600,Tobias Bjornfot,D,FLA,23,0,0,0,0
7,8475797,Jarred Tinordi,D,CHI,32,0,0,0,0
7,8481521,Ronnie Attard,D,PHI,25,0,0,0,0
7,8474612,Travis Hamonic,D,OTT,34,0,0,0,0
7,8479576,Vincent Desharnais,D,EDM,28,0,0,0,0
7,8480049,Dylan Samberg,D,WPG,25,0,0,0,0
7,8483619,Filip Roos,D,CHI,25,0,0,0,0
7,8474568,Luke Schenn,D,NSH,35,0,0,0,0
7,8480184,Gustav Lindstrom,D,ANA,26,0,0,0,0
7,8480070,Ian Mitchell,D,BOS,25,0,0,0,0
7,8480196,Jacob Bryson,D,BUF,27,0,0,0,0
7,8471686,Marc Staal,D,PHI,37,0,0,0,0
7,8477467,Gustav Olofsson,D,SEA,30,0,0,0,0
7,8478970,Jalen Chatfield,D,CAR,28,0,0,0,0
7,8479348,Kale Clague,D,BUF,26,0,0,0,0
7,8473446,Erik Johnson,D,PHI,36,0,0,0,0
7,8477462,Robert Hagg,D,ANA,29,0,0,0,0
7,8478454,Noah Juulsen,D,VAN,27,0,0,0,0
7,8477384,Josh Brown,D,ARI,30,0,0,0,0
7,8481708,Zac Jones,D,NYR,24,0,0,0,0
7,8481167,Brayden Pachal,D,CGY,25,0,0,0,0
7,8482067,Connor Mackey,D,NYR,28,0,0,0,0
7,8483460,David Jiricek,D,CBJ,21,0,0,0,0
7,8481701,Santeri Hatakka,D,NJD,23,0,0,0,0
7,8478021,William Lagesson,D,ANA,28,0,0,0,0
7,8477851,Jordan Oesterle,D,CGY,32,0,0,0,0
7,8478452,Caleb Jones,D,COL,27,0,0,0,0
7,8479984,Cal Foote,D,NJD,26,0,0,0,0
7,8479639,Dylan Coghlan,D,CAR,26,0,0,0,0
7,8480874,Adam Ginning,D,PHI,24,0,0,0,0
7,8479321,Lucas Johansen,D,WSH,27,0,0,0,0
7,8480878,Nils Lundkvist,D,DAL,24,0,0,0,0
7,8482165,Yan Kuznetsov,D,CGY,22,0,0,0,0
7,8484258,Sam Malinski,D,COL,26,0,0,0,0
7,8480157,Calle Rosen,D,STL,30,0,0,0,0
7,8484304,Uvis Balinskis,D,FLA,28,0,0,0,0
7,8479985,Cale Fleury,D,SEA,26,0,0,0,0
7,8479378,Logan Stanley,D,WPG,26,0,0,0,0
7,8477541,Dakota Mermis,D,MIN,30,0,0,0,0
7,8481609,Vladislav Kolyachonok,D,ARI,23,0,0,0,0
7,8480823,Alexander Alexeyev,D,WSH,25,0,0,0,0
7,8481679,Maxence Guenette,D,OTT,23,0,0,0,0
7,8481564,Ryan Johnson,D,BUF,23,0,0,0,0
7,8479376,Victor Mete,D,PHI,26,0,0,0,0
7,8484254,Akito Hirose,D,VAN,25,0,0,0,0
7,8482660,Kent Johnson,C,CBJ,22,0,0,0,0
7,8482149,Cole Perfetti,C,WPG,22,0,0,0,0
7,8477987,Ryan Donato,C,CHI,28,0,0,0,0
7,8475755,Alexander Petrovic,D,DAL,32,0,0,0,0
7,8477810,Joel Hanley,D,CGY,33,0,0,0,0
7,8474145,Robert Bortuzzo,D,NYI,35,0,0,0,0
7,8481161,Jake Christiansen,D,CBJ,25,0,0,0,0
7,8476884,Derrick Pouliot,D,DAL,30,0,0,0,0
7,8481716,Dmitri Voronkov,L,CBJ,24,0,0,0,0
7,8480084,Nick DeSimone,D,NJD,30,0,0,0,0
7,8475750,Jon Merrill,D,MIN,32,0,0,0,0
7,8479315,Joey Anderson,R,CHI,26,0,0,0,0
7,8478011,Louie Belpedio,D,PHI,28,0,0,0,0
7,8482451,Mikael Pyyhtia,L,CBJ,23,0,0,0,0
7,8481541,Samuel Bolduc,D,NYI,24,0,0,0,0
7,8482126,Emil Andrae,D,PHI,31,0,0,0,0
7,8474618,Marco Scandella,D,STL,34,0,0,0,0
7,8477244,Chad Ruhwedel,D,NYR,34,0,0,0,0
7,8477971,Andreas Englund,D,LAK,28,0,0,0,0
7,8480829,Jesperi Kotkaniemi,C,CAR,24,0,0,0,0
7,8479372,Josh Mahura,D,FLA,26,0,0,0,0
7,8482095,Tyler Kleven,D,OTT,22,0,0,0,0
7,8481719,Maxwell Crozier,D,TBL,24,0,0,0,0
7,8475855,Jesper Fast,R,CAR,33,0,0,0,0
7,8480848,Ty Dellandrea,C,DAL,24,0,0,0,0
7,8475193,Tomas Tatar,L,SEA,34,0,0,0,0
7,8476889,Radek Faksa,C,DAL,30,0,0,0,0
7,8478495,Denis Gurianov,R,PHI,27,0,0,0,0
7,8480216,Jacob Peterson,C,SJS,25,0,0,0,0
7,8480252,Cole Guttman,C,CHI,25,0,0,0,0
7,8479026,Philippe Myers,D,TBL,27,0,0,0,0
7,8481006,Tyler Tucker,D,STL,24,0,0,0,0
7,8481032,Paul Cotter,C,VGK,25,0,0,0,0
7,8481577,Philip Tomasino,C,NSH,23,0,0,0,0
7,8476918,Jimmy Vesey,L,NYR,31,0,0,0,0
7,8479320,Max Lajoie,D,TOR,27,0,0,0,0
7,8478017,Mark Friedman,D,VAN,29,0,0,0,0
7,8481754,Nikita Nesterenko,C,ANA,23,0,0,0,0
7,8483407,Brandon Scanlin,D,NYR,25,0,0,0,0
7,8482659,Josh Doan,R,ARI,22,0,0,0,0
7,8477446,Michael McCarron,R,NSH,29,0,0,0,0
7,8477903,Garnet Hathaway,R,PHI,33,0,0,0,0
7,8482153,Brendan Brisson,C,VGK,23,0,0,0,0
7,8483546,Marshall Rifai,D,TOR,26,0,0,0,0
7,8484287,Cole McWard,D,VAN,23,0,0,0,0
7,8478854,Ryan Shea,D,PIT,27,0,0,0,0
7,8481585,Egor Afanasyev,L,NSH,23,0,0,0,0
7,8483398,Declan Carlile,D,TBL,31,0,0,0,0
7,8478502,Dennis Gilbert,D,CGY,28,0,0,0,0
7,8482749,Joshua Roy,R,MTL,21,0,0,0,0
7,8481598,Philip Broberg,D,EDM,23,0,0,0,0
7,8480835,Jack Drury,C,CAR,24,0,0,0,0
7,8480748,Kiefer Sherwood,L,NSH,29,0,0,0,0
7,8476934,Brock McGinn,L,ANA,30,0,0,0,0
7,8480870,Bo Groulx,C,ANA,24,0,0,0,0
7,8479368,Max Jones,L,ANA,26,0,0,0,0
7,8478099,Kevin Labanc,R,SJS,29,0,0,0,0
7,8478067,Oskar Lindblom,L,SJS,28,0,0,0,0
7,8476393,Nick Cousins,C,FLA,31,0,0,0,0
7,8483395,Arshdeep Bains,L,VAN,23,0,0,0,0
7,8480762,Eric Robinson,L,BUF,29,0,0,0,0
7,8479439,Jacob MacDonald,D,SJS,31,0,0,0,0
7,8476474,Stefan Noesen,R,CAR,31,0,0,0,0
7,8482787,Nikita Chibrikov,R,WPG,31,0,0,0,0
7,8478432,Christian Fischer,R,DET,27,0,0,0,0
7,8477979,Nicolas Aube-Kubel,R,WSH,28,0,0,0,0
7,8481789,Tye Kartye,L,SEA,23,0,0,0,0
7,8479330,Brandon Gignac,C,MTL,27,0,0,0,0
7,8480075,Cameron Crotty,D,ARI,25,0,0,0,0
7,8473473,Milan Lucic,L,BOS,36,0,0,0,0
7,8482094,Daemon Hunt,D,MIN,22,0,0,0,0
7,8481206,John Ludvig,D,PIT,24,0,0,0,0
7,8483630,Pavol Regenda,L,ANA,25,0,0,0,0
7,8481617,Vasily Podkolzin,R,VAN,23,0,0,0,0
7,8480306,Grant Hutton,D,NYI,29,0,0,0,0
7,8480995,Pontus Holmberg,R,TOR,25,0,0,0,0
7,8482148,Hendrix Lapierre,C,WSH,22,0,0,0,0
7,8477478,William Carrier,L,VGK,30,0,0,0,0
7,8480003,Jesper Boqvist,C,BOS,26,0,0,0,0
7,8482172,Landon Slaggert,L,CHI,22,0,0,0,0
7,8480789,Oliver Wahlstrom,R,NYI,24,0,0,0,0
7,8474062,Riley Nash,C,NYR,35,0,0,0,0
7,8480021,Jack Studnicka,C,SJS,25,0,0,0,0
7,8480025,MacKenzie Entwistle,R,CHI,25,0,0,0,0
7,8481582,Nicholas Robertson,L,TOR,23,0,0,0,0
7,8476867,Brendan Gaunce,C,CBJ,30,0,0,0,0
7,8479619,Michael Carcone,L,ARI,28,0,0,0,0
7,8479370,Tyson Jost,C,BUF,26,0,0,0,0
7,8479671,Mathieu Olivier,R,CBJ,27,0,0,0,0
7,8476994,Vinnie Hinostroza,C,PIT,30,0,0,0,0
7,8482070,Mitchell Chaffee,R,TBL,26,0,0,0,0
7,8477473,Justin Bailey,R,SJS,29,0,0,0,0
7,8479344,Jesse Puljujarvi,R,PIT,26,0,0,0,0
7,8480205,Emil Bemstrom,C,PIT,25,0,0,0,0
7,8479718,Alex Barré-Boulet,C,TBL,27,0,0,0,0
7,8482061,Brandon Biro,L,BUF,26,0,0,0,0
7,8479638,Justin Brazeau,R,BOS,26,0,0,0,0
7,8474040,Sam Gagner,C,EDM,35,0,0,0,0
7,8477846,Ryan Carpenter,C,SJS,33,0,0,0,0
7,8482077,Dylan Holloway,L,EDM,23,0,0,0,0
7,8482157,Will Cuylle,L,NYR,22,0,0,0,0
7,8480007,Jonas Rondbjerg,R,VGK,25,0,0,0,0
7,8478874,Adam Gaudette,C,STL,28,0,0,0,0
7,8478434,Keegan Kolesar,R,VGK,27,0,0,0,0
7,8480441,Trey Fix-Wolansky,R,CBJ,25,0,0,0,0
7,8479994,Jaret Anderson-Dolan,C,NSH,25,0,0,0,0
7,8483567,Georgii Merkulov,C,BOS,24,0,0,0,0
7,8477380,Jonny Brodzinski,C,NYR,31,0,0,0,0
7,8482201,Gage Goncalves,C,TBL,23,0,0,0,0
7,8478211,Dryden Hunt,L,CGY,29,0,0,0,0
7,8471699,Andrew Cogliano,C,COL,37,0,0,0,0
7,8479421,Jacob Moverare,D,LAK,26,0,0,0,0
7,8478881,Brett Seney,L,CHI,28,0,0,0,0
7,8477464,Nic Petan,C,MIN,29,0,0,0,0
7,8475958,Michael Sgarbossa,C,WSH,32,0,0,0,0
7,8481147,Reese Johnson,C,CHI,26,0,0,0,0
7,8479336,Carl Grundstrom,R,LAK,27,0,0,0,0
7,8480853,Liam Foudy,C,NSH,24,0,0,0,0
7,8479522,Hardy Haman Aktell,D,WSH,26,0,0,0,0
7,8481462,Mason Morelli,L,VGK,28,0,0,0,0
7,8482102,Vasily Ponomarev,C,CAR,22,0,0,0,0
7,8480844,Grigori Denisenko,L,VGK,24,0,0,0,0
7,8479944,Zach Aston-Reese,C,DET,30,0,0,0,0
7,8482784,Zach Dean,C,STL,21,0,0,0,0
7,8479419,Brett Murray,L,BUF,26,0,0,0,0
7,8479520,Brandon Duhaime,R,COL,27,0,0,0,0
7,8477573,Nathan Walker,L,STL,30,0,0,0,0
7,8478078,Rourke Chartier,C,OTT,28,0,0,0,0
7,8475795,Dylan McIlrath,D,WSH,32,0,0,0,0
7,8482496,Nils Aman,C,VAN,24,0,0,0,0
7,8480289,Morgan Barron,C,WPG,26,0,0,0,0
7,8481751,Lukas Rousek,R,BUF,25,0,0,0,0
7,8480011,Klim Kostin,C,SJS,25,0,0,0,0
7,8481556,John Beecher,C,BOS,23,0,0,0,0
7,8475278,Byron Froese,C,VGK,33,0,0,0,0
7,8475225,Craig Smith,C,DAL,35,0,0,0,0
7,8484326,Patrik Koch,D,ARI,28,0,0,0,0
7,8477930,Pierre-Edouard Bellemare,L,SEA,39,0,0,0,0
7,8478409,Anthony Richard,C,BOS,28,0,0,0,0
7,8481024,Linus Karlsson,C,VAN,25,0,0,0,0
7,8479986,Kole Lind,R,SEA,26,0,0,0,0
7,8479414,Nathan Bastian,R,NJD,27,0,0,0,0
7,8479362,Riley Tufte,L,COL,26,0,0,0,0
7,8481058,Jesse Ylönen,R,MTL,25,0,0,0,0
7,8482476,Emil Heineman,L,MTL,23,0,0,0,0
7,8482861,Vincent Iorio,D,WSH,22,0,0,0,0
7,8483432,Luca Del Bel Belluz,C,CBJ,31,0,0,0,0
7,8482744,James Malatesta,L,CBJ,21,0,0,0,0
7,8477887,Patrick Brown,C,BOS,32,0,0,0,0
7,8478585,Derek Ryan,C,EDM,38,0,0,0,0
7,8481441,Joe Snively,C,WSH,28,0,0,0,0
7,8481592,Jakob Pelletier,L,CGY,23,0,0,0,0
7,8482634,Alex Steeves,C,TOR,25,0,0,0,0
7,8477126,Jayson Megna,C,BOS,34,0,0,0,0
7,8475752,Tyler Pitlick,C,NYR,33,0,0,0,0
7,8480008,Adam Ruzicka,C,ARI,25,0,0,0,0
7,8481065,Angus Crookshank,L,OTT,25,0,0,0,0
7,8479547,Matthew Phillips,R,WSH,26,0,0,0,0
7,8480226,Marián Studenic,R,SEA,26,0,0,0,0
7,8481237,Kyle MacLean,C,NYI,25,0,0,0,0
7,8475413,Justin Dowling,C,NJD,34,0,0,0,0
7,8481641,Joel Kiviranta,L,COL,28,0,0,0,0
7,8478104,Sammy Blais,L,STL,28,0,0,0,0
7,8477454,Adam Erne,L,EDM,29,0,0,0,0
7,8481518,Nolan Foote,L,NJD,24,0,0,0,0
7,8480245,Olle Lycksell,R,PHI,25,0,0,0,0
7,8483570,Ben Meyers,C,ANA,26,0,0,0,0
7,8480776,Sheldon Rempal,R,VGK,29,0,0,0,0
7,8483920,Pierrick Dube,R,WSH,23,0,0,0,0
7,8480267,Sammy Walker,C,MIN,25,0,0,0,0
7,8482747,Brennan Othmann,L,NYR,21,0,0,0,0
7,8479991,Jake Leschyshyn,C,NYR,25,0,0,0,0
7,8478400,Colin White,C,MTL,27,0,0,0,0
7,8479328,Julien Gauthier,R,NYI,27,0,0,0,0
7,8484325,Waltteri Merela,C,TBL,26,0,0,0,0
7,8479066,Ryan Lomberg,L,FLA,30,0,0,0,0
7,8477070,Liam O'Brien,C,ARI,30,0,0,0,0
7,8478146,Matthew Highmore,C,OTT,28,0,0,0,0
7,8478028,Fredrik Olofsson,L,COL,28,0,0,0,0
7,8480880,Jakub Lauko,C,BOS,24,0,0,0,0
7,8479968,Vinni Lettieri,C,MIN,29,0,0,0,0
7,8474709,Matt Martin,L,NYI,35,0,0,0,0
7,8480845,Rasmus Kupari,C,WPG,24,0,0,0,0
7,8481550,Adam Beckman,L,MIN,23,0,0,0,0
7,8481422,Jacob Lucchini,C,MIN,29,0,0,0,0
7,8477401,John Hayden,C,SEA,29,0,0,0,0
7,8478904,Steven Lorentz,C,FLA,28,0,0,0,0
7,8482088,Justin Sourdif,R,FLA,22,0,0,0,0
7,8482751,Ryan Winterton,C,SEA,21,0,0,0,0
7,8482241,Radim Zohorna,L,PIT,28,0,0,0,0
7,8481690,Tyler Angle,C,CBJ,24,0,0,0,0
7,8476952,Dominic Toninato,C,WPG,30,0,0,0,0
7,8476919,Chris Tierney,C,NJD,30,0,0,0,0
7,8480032,Shane Bowers,C,NJD,25,0,0,0,0
7,8484314,Jiri Smejkal,L,OTT,28,0,0,0,0
7,8481239,Samuel Fagemo,L,LAK,24,0,0,0,0
7,8481532,Alex Turcotte,C,LAK,23,0,0,0,0
7,8481019,David Gustafsson,C,WPG,24,0,0,0,0
7,8478477,Mitchell Stephens,C,MTL,27,0,0,0,0
7,8479546,Oskar Steen,C,BOS,26,0,0,0,0
7,8480292,Carson Meyer,R,CBJ,27,0,0,0,0
7,8478446,Glenn Gawdin,C,ANA,27,0,0,0,0
7,8483531,Brian Halonen,L,NJD,25,0,0,0,0
7,8477149,Scott Sabourin,R,SJS,32,0,0,0,0
7,8479972,Mason Shaw,C,MIN,26,0,0,0,0
7,8480890,Jan Jenik,R,ARI,24,0,0,0,0
7,8478051,Max Willman,C,NJD,29,0,0,0,0
7,8480851,Akil Thomas,C,LAK,24,0,0,0,0
7,8482765,Isak Rosen,R,BUF,21,0,0,0,0
7,8478421,A.J. Greer,L,CGY,28,0,0,0,0
7,8478512,Austin Czarnik,C,DET,32,0,0,0,0
7,8479536,Axel Jonsson-Fjallby,L,WPG,26,0,0,0,0
7,8477320,Anton Blidh,L,NYR,29,0,0,0,0
7,8481543,Nikita Alexandrov,C,STL,24,0,0,0,0
7,8475235,Nicolas Deslauriers,L,PHI,33,0,0,0,0
7,8481070,Hugh McGing,L,STL,26,0,0,0,0
7,8480836,Jonathan Gruden,C,PIT,24,0,0,0,0
7,8481591,Sam Poulin,R,PIT,23,0,0,0,0
7,8477962,Brendan Lemieux,L,CAR,28,0,0,0,0
7,8483401,Marc Johnstone,R,PIT,28,0,0,0,0
7,8482250,Callahan Burke,C,CAR,27,0,0,0,0
7,8481726,Adam Edstrom,C,NYR,24,0,0,0,0
7,8471817,Ryan Reaves,R,TOR,37,0,0,0,0
7,8479587,Rhett Gardner,C,PHI,28,0,0,0,0
7,8475766,Austin Watson,L,TBL,32,0,0,0,0
7,8479367,William Lockwood,R,FLA,26,0,0,0,0
7,8478424,Jansen Harkins,C,PIT,27,0,0,0,0
7,8476913,Devin Shore,C,SEA,30,0,0,0,0
7,8482652,Walker Duehr,R,CGY,27,0,0,0,0
7,8477527,Ross Johnston,L,ANA,30,0,0,0,0
7,8481077,John Leonard,L,ARI,26,0,0,0,0
7,8483549,Lucas Condotta,L,MTL,27,0,0,0,0
7,8480468,James Hamblin,L,EDM,25,0,0,0,0
7,8476907,Mackenzie MacEachern,L,STL,30,0,0,0,0
7,8479543,Michael Pezzetta,L,MTL,26,0,0,0,0
7,8480355,Mark Kastelic,C,OTT,25,0,0,0,0
7,8482162,Roby Jarventie,L,OTT,22,0,0,0,0
7,8479772,Zack MacEwen,R,OTT,28,0,0,0,0
7,8483597,Milos Kelemen,L,ARI,25,0,0,0,0
7,8479379,Givani Smith,R,SJS,26,0,0,0,0
7,8481655,Cole Schwindt,R,CGY,23,0,0,0,0
7,8479981,Jonah Gadjovich,L,FLA,26,0,0,0,0
7,8482147,Jean-Luc Foudy,C,COL,22,0,0,0,0
7,8484255,Jason Polin,R,COL,25,0,0,0,0
7,8477993,Justin Kirkland,C,ARI,28,0,0,0,0
7,8479249,Andrew Poturalski,C,SEA,30,0,0,0,0
7,8482197,Adam Raska,R,MIN,23,0,0,0,0
7,8475780,Chris Wagner,R,COL,33,0,0,0,0
7,8479533,Joona Koppanen,L,PIT,26,0,0,0,0
7,8481534,Raphael Lavoie,C,EDM,24,0,0,0,0
7,8484321,Nikolas Matinpalo,D,OTT,26,0,0,0,0
7,8481043,Cole Koepke,L,TBL,26,0,0,0,0
7,8476323,Max McCormick,L,SEA,32,0,0,0,0
7,8483609,Adam Klapka,R,CGY,24,0,0,0,0
7,8483512,Matt Savoie,C,BUF,20,0,0,0,0
7,8484259,Ondrej Pavel,C,COL,31,0,0,0,0
7,8478147,Bokondji Imama,L,OTT,28,0,0,0,0
7,8482460,Matt Rempe,C,NYR,22,0,0,0,0
7,8477073,Kurtis MacDermid,L,NJD,30,0,0,0,0
7,8480274,Philip Kemp,D,EDM,25,0,0,0,0
7,8478956,Samuel Laberge,L,NJD,27,0,0,0,0
7,8483045,Cameron Butler,R,CBJ,31,0,0,0,0
8,8478402,Connor McDavid,C,EDM,27,82,37,96,133
8,8477492,Nathan MacKinnon,C,COL,29,82,42,75,117
8,8476453,Nikita Kucherov,R,TBL,31,82,27,86,113
8,8478864,Kirill Kaprizov,L,MIN,27,82,47,56,103
8,8477956,David Pastrnak,R,BOS,28,82,38,56,94
8,8479314,Matthew Tkachuk,L,FLA,27,82,36,57,93
8,8476468,J.T. Miller,C,VAN,31,82,27,66,93
8,8479318,Auston Matthews,C,TOR,27,82,50,40,90
8,8478420,Mikko Rantanen,R,COL,28,82,41,49,90
8,8481559,Jack Hughes,C,NJD,23,82,37,53,90
8,8477934,Leon Draisaitl,C,EDM,29,82,31,57,88
8,8476460,Mark Scheifele,C,WPG,31,82,31,57,88
8,8477933,Sam Reinhart,C,FLA,29,82,39,44,83
8,8477404,Jake Guentzel,C,CAR,30,82,33,50,83
8,8480002,Nico Hischier,C,NJD,25,82,27,56,83
8,8478427,Sebastian Aho,C,CAR,27,82,43,39,82
8,8476887,Filip Forsberg,L,NSH,30,82,40,42,82
8,8475166,John Tavares,C,TOR,34,82,37,45,82
8,8475172,Nazem Kadri,C,CGY,34,82,29,53,82
8,8477939,William Nylander,R,TOR,28,82,38,43,81
8,8474600,Roman Josi,D,NSH,34,82,18,63,81
8,8477942,Kevin Fiala,L,LAK,28,82,30,50,80
8,8476346,Johnny Gaudreau,L,CBJ,31,82,20,60,80
8,8478010,Brayden Point,C,TBL,28,82,43,36,79
8,8477409,Carter Verhaeghe,C,FLA,29,82,38,41,79
8,8480023,Robert Thomas,C,STL,25,82,26,52,78
8,8481523,Kirby Dach,C,MTL,23,82,15,63,78
8,8475786,Zach Hyman,L,EDM,32,82,49,28,77
8,8478403,Jack Eichel,C,VGK,28,82,36,41,77
8,8480027,Jason Robertson,L,DAL,25,82,29,48,77
8,8478398,Kyle Connor,L,WPG,28,82,34,42,76
8,8478550,Artemi Panarin,L,NYR,33,82,23,53,76
8,8480069,Cale Makar,D,COL,26,82,16,60,76
8,8475170,Brayden Schenn,C,STL,33,82,29,46,75
8,8479407,Jesper Bratt,L,NJD,26,82,24,51,75
8,8476456,Jonathan Huberdeau,C,CGY,31,82,23,51,74
8,8471675,Sidney Crosby,C,PIT,37,82,31,41,72
8,8477960,Adrian Kempe,R,LAK,28,82,27,45,72
8,8480800,Quinn Hughes,D,VAN,25,82,16,56,72
8,8474564,Steven Stamkos,C,TBL,34,82,38,33,71
8,8479343,Clayton Keller,R,ARI,26,82,37,34,71
8,8477402,Pavel Buchnevich,L,STL,29,82,28,43,71
8,8480012,Elias Pettersson,C,VAN,26,82,28,43,71
8,8477493,Aleksander Barkov,C,FLA,29,82,27,44,71
8,8479323,Adam Fox,D,NYR,26,82,18,53,71
8,8475184,Chris Kreider,L,NYR,33,82,39,31,70
8,8480801,Brady Tkachuk,L,OTT,25,82,29,39,68
8,8478440,Dylan Strome,C,WSH,27,82,24,43,67
8,8482078,Lucas Raymond,L,DET,22,82,22,45,67
8,8477946,Dylan Larkin,C,DET,28,82,37,29,66
8,8477496,Elias Lindholm,C,VAN,30,82,30,36,66
8,8473512,Claude Giroux,R,OTT,36,82,20,46,66
8,8482097,Jack Quinn,R,BUF,23,82,28,37,65
8,8477500,Bo Horvat,C,NYI,29,82,29,35,64
8,8477940,Nikolaj Ehlers,L,WPG,28,82,26,38,64
8,8480803,Evan Bouchard,D,EDM,25,82,15,49,64
8,8476875,Mike Matheson,D,MTL,30,82,9,55,64
8,8478042,Viktor Arvidsson,R,LAK,31,82,21,42,63
8,8476454,Ryan Nugent-Hopkins,C,EDM,31,82,15,48,63
8,8479385,Jordan Kyrou,C,STL,26,82,31,31,62
8,8478439,Travis Konecny,R,PHI,27,82,26,36,62
8,8479337,Alex DeBrincat,R,DET,27,82,26,36,62
8,8473419,Brad Marchand,L,BOS,36,82,24,38,62
8,8478414,Timo Meier,R,NJD,28,82,24,38,62
8,8477951,Nick Schmaltz,C,ARI,28,82,22,40,62
8,8480839,Rasmus Dahlin,D,BUF,24,82,21,41,62
8,8478445,Mathew Barzal,C,NYI,27,82,19,43,62
8,8475167,Victor Hedman,D,TBL,34,82,13,49,62
8,8478407,Vince Dunn,D,SEA,28,82,10,52,62
8,8479325,Charlie McAvoy,D,BOS,27,82,8,54,62
8,8481540,Cole Caufield,R,MTL,23,82,37,24,61
8,8481557,Matt Boldy,L,MIN,23,82,29,32,61
8,8478449,Roope Hintz,C,DAL,28,82,24,37,61
8,8476389,Vincent Trocheck,C,NYR,31,82,23,38,61
8,8478401,Pavel Zacha,C,BOS,27,82,21,40,61
8,8483524,Shane Wright,C,SEA,20,82,43,17,60
8,8474141,Patrick Kane,R,DET,36,82,29,31,60
8,8479999,Casey Mittelstadt,C,COL,26,82,26,34,60
8,8474157,Max Pacioretty,L,WSH,36,82,26,34,60
8,8477501,Valeri Nichushkin,R,COL,29,82,23,37,60
8,8477416,Oliver Bjorkstrand,R,SEA,29,82,22,38,60
8,8471214,Alex Ovechkin,L,WSH,39,82,32,27,59
8,8480064,Josh Norris,C,OTT,25,82,29,30,59
8,8478047,Michael Bunting,L,PIT,29,82,26,33,59
8,8481068,Yegor Sharangovich,C,CGY,26,82,26,33,59
8,8471215,Evgeni Malkin,C,PIT,38,82,25,34,59
8,8479542,Brandon Hagel,L,TBL,26,82,25,34,59
8,8477949,Alex Tuch,R,BUF,28,82,23,36,59
8,8480830,Andrei Svechnikov,R,CAR,24,82,19,40,59
8,8475692,Mats Zuccarello,R,MIN,37,82,17,42,59
8,8480036,Miro Heiskanen,D,DAL,25,82,10,49,59
8,8475151,Kyle Palmieri,C,NYI,33,82,31,27,58
8,8478498,Jake DeBrusk,L,BOS,28,82,28,30,58
8,8478873,Troy Terry,R,ANA,27,82,25,33,58
8,8482110,Dawson Mercer,C,NJD,23,82,23,35,58
8,8474578,Erik Karlsson,D,PIT,34,82,10,48,58
8,8480018,Nick Suzuki,C,MTL,25,82,30,27,57
8,8477497,Sean Monahan,C,WPG,30,82,24,33,57
8,8475745,Charlie Coyle,C,BOS,32,82,21,36,57
8,8482093,Seth Jarvis,C,CAR,22,82,27,29,56
8,8476882,Teuvo Teravainen,L,CAR,30,82,20,36,56
8,8474150,Mikael Backlund,C,CGY,35,82,32,23,55
8,8476399,Blake Coleman,C,CGY,33,82,32,23,55
8,8475726,Tyler Toffoli,C,WPG,32,82,29,26,55
8,8475754,Brock Nelson,C,NYI,33,82,25,30,55
8,8476459,Mika Zibanejad,C,NYR,31,82,23,32,55
8,8482113,Anton Lundell,C,FLA,23,82,27,27,54
8,8478444,Brock Boeser,R,VAN,27,82,26,28,54
8,8476905,Chandler Stephenson,C,VGK,30,82,19,35,54
8,8473994,Jamie Benn,L,DAL,35,82,18,36,54
8,8482116,Tim Stützle,C,OTT,22,82,12,42,54
8,8479675,Trevor Moore,L,LAK,29,82,27,26,53
8,8470794,Joe Pavelski,C,DAL,40,82,21,32,53
8,8481528,Dylan Cozens,C,BUF,23,82,20,33,53
8,8478462,Nicolas Roy,C,VGK,27,82,16,37,53
8,8474679,Gustav Nyquist,C,NSH,35,82,14,39,53
8,8478038,Devon Toews,D,COL,30,82,13,40,53
8,8479420,Tage Thompson,C,BUF,27,82,29,23,52
8,8477407,Anthony Duclair,L,TBL,29,82,28,24,52
8,8477986,Brandon Montour,D,FLA,30,82,15,37,52
8,8478396,Noah Hanifin,D,VGK,27,82,13,39,52
8,8478397,Rasmus Andersson,D,CGY,28,82,11,41,52
8,8478233,Andrew Mangiapane,L,CGY,28,82,24,27,51
8,8475810,Bryan Rust,R,PIT,32,82,23,28,51
8,8477479,Tyler Bertuzzi,L,TOR,29,82,23,28,51
8,8481711,Matias Maccelli,L,ARI,24,82,17,34,51
8,8475791,Taylor Hall,L,CHI,33,82,15,36,51
8,8474590,John Carlson,D,WSH,34,82,10,41,51
8,8483471,Brad Lambert,C,WPG,31,82,10,41,51
8,8477447,Shea Theodore,D,VGK,29,82,6,45,51
8,8480014,Gabriel Vilardi,C,WPG,25,82,32,18,50
8,8480188,Fabian Zetterlund,L,SJS,25,82,31,19,50
8,8475287,Erik Haula,L,NJD,33,82,28,22,50
8,8477476,Artturi Lehkonen,L,COL,29,82,24,26,50
8,8478493,Joel Eriksson Ek,C,MIN,27,82,22,28,50
8,8478046,Danton Heinen,L,BOS,29,82,21,29,50
8,8482684,Luke Hughes,D,NJD,21,82,20,30,50
8,8480208,Drake Batherson,R,OTT,26,82,20,30,50
8,8476881,Tomas Hertl,C,VGK,31,82,16,34,50
8,8475765,Vladimir Tarasenko,R,FLA,33,82,13,37,50
8,8479410,Mikhail Sergachev,D,TBL,26,82,10,40,50
8,8477495,Seth Jones,D,CHI,30,82,10,40,50
8,8481596,Shane Pinto,C,OTT,24,82,20,29,49
8,8478975,Mason Marchment,L,DAL,29,82,19,30,49
8,8476462,Dougie Hamilton,D,NJD,31,82,15,34,49
8,8474102,David Perron,L,DET,36,82,11,38,49
8,8476853,Morgan Rielly,D,TOR,30,82,8,41,49
8,8476448,William Karlsson,C,VGK,31,82,21,27,48
8,8483515,Juraj Slafkovsky,L,MTL,20,82,21,27,48
8,8482133,Thomas Bordeleau,C,SJS,22,82,16,32,48
8,8477932,Aaron Ekblad,D,FLA,28,82,13,35,48
8,8475798,Mikael Granlund,C,SJS,32,82,11,37,48
8,8476539,Jonathan Marchessault,R,VGK,34,82,25,22,47
8,8482740,Wyatt Johnston,C,DAL,21,82,24,23,47
8,8475913,Mark Stone,R,VGK,32,82,19,28,47
8,8477955,Jared McCann,L,SEA,28,82,18,29,47
8,8480039,Martin Necas,C,CAR,25,82,17,30,47
8,8477346,MacKenzie Weegar,D,CGY,30,82,17,30,47
8,8478438,Tommy Novak,C,NSH,27,82,17,30,47
8,8482745,Mason McTavish,C,ANA,21,82,14,33,47
8,8477504,Josh Morrissey,D,WPG,29,82,11,36,47
8,8473986,Alex Killorn,L,ANA,35,82,24,22,46
8,8476479,Phillip Danault,C,LAK,31,82,18,28,46
8,8475168,Matt Duchene,C,DAL,33,82,15,31,46
8,8477964,Ivan Barbashev,C,VGK,29,82,15,31,46
8,8474563,Drew Doughty,D,LAK,35,82,13,33,46
8,8471685,Anze Kopitar,C,LAK,37,82,11,35,46
8,8480865,Noah Dobson,D,NYI,24,82,8,38,46
8,8476792,Torey Krug,D,STL,33,82,4,42,46
8,8475169,Evander Kane,L,EDM,33,82,26,19,45
8,8479525,Ross Colton,C,COL,28,82,23,22,45
8,8478460,Zach Werenski,D,CBJ,27,82,18,27,45
8,8475784,Jeff Skinner,C,BUF,32,82,17,28,45
8,8481618,Alex Newhook,C,MTL,23,82,16,29,45
8,8476458,Ryan Strome,C,ANA,31,82,13,32,45
8,8481542,Moritz Seider,D,DET,23,82,10,35,45
8,8482122,Brock Faber,D,MIN,22,82,4,41,45
8,8479400,Pierre-Luc Dubois,L,LAK,26,82,26,18,44
8,8478856,Conor Garland,R,VAN,28,82,26,18,44
8,8479339,Patrik Laine,L,CBJ,26,82,21,23,44
8,8477935,Sam Bennett,C,FLA,28,82,21,23,44
8,8475763,Kevin Hayes,R,STL,32,82,21,23,44
8,8475768,Jaden Schwartz,C,SEA,32,82,20,24,44
8,8482109,Alexis Lafrenière,L,NYR,23,82,19,25,44
8,8477451,Ryan Hartman,R,MIN,30,82,18,26,44
8,8483808,Andrei Kuzmenko,L,CGY,28,82,16,28,44
8,8474565,Alex Pietrangelo,D,VGK,34,82,16,28,44
8,8478891,Mason Appleton,C,WPG,28,82,12,32,44
8,8477503,Max Domi,C,TOR,29,82,8,36,44
8,8477998,Warren Foegele,L,EDM,28,82,27,16,43
8,8476880,Tom Wilson,R,WSH,30,82,21,22,43
8,8475794,Tyler Seguin,C,DAL,32,82,19,24,43
8,8476483,Rickard Rakell,R,PIT,31,82,18,25,43
8,8480028,Morgan Frost,C,PHI,25,82,18,25,43
8,8480078,Filip Chytil,C,NYR,25,82,14,29,43
8,8475744,Evgeny Kuznetsov,C,CAR,32,82,13,30,43
8,8471724,Kris Letang,D,PIT,37,82,7,36,43
8,8482159,Tyson Foerster,R,PHI,22,82,25,17,42
8,8475314,Anders Lee,L,NYI,34,82,25,17,42
8,8478115,Pierre Engvall,L,NYI,28,82,20,22,42
8,8471218,Blake Wheeler,R,NYR,38,82,19,23,42
8,8482055,Drew O'Connor,L,PIT,26,82,18,24,42
8,8482665,Matty Beniers,C,SEA,22,82,15,27,42
8,8475218,Mattias Ekholm,D,EDM,34,82,14,28,42
8,8475848,Brendan Gallagher,R,MTL,32,82,30,11,41
8,8484144,Connor Bedard,C,CHI,19,82,20,21,41
8,8479992,Michael Rasmussen,C,DET,25,82,19,22,41
8,8482699,Dylan Guenther,R,ARI,21,82,17,24,41
8,8480797,Joel Farabee,L,PHI,24,82,15,26,41
8,8480798,Philipp Kurashev,C,CHI,25,82,12,29,41
8,8479425,Filip Hronek,D,VAN,27,82,10,31,41
8,8479345,Jakob Chychrun,D,OTT,26,82,9,32,41
8,8477021,Alex Kerfoot,C,ARI,30,82,9,32,41
8,8476432,Boone Jenner,C,CBJ,31,82,24,16,40
8,8481533,Trevor Zegras,C,ANA,23,82,20,20,40
8,8475799,Nino Niederreiter,R,WPG,32,82,20,20,40
8,8476292,Ondrej Palat,L,NJD,33,82,17,23,40
8,8482667,William Eklund,L,SJS,22,82,13,27,40
8,8475753,Justin Faulk,D,STL,32,82,10,30,40
8,8477426,Nicholas Paul,L,TBL,29,82,25,14,39
8,8476438,Brandon Saad,L,STL,32,82,20,19,39
8,8470610,Zach Parise,L,COL,40,82,17,22,39
8,8477456,J.T. Compher,L,DET,29,82,16,23,39
8,8480015,Owen Tippett,R,PHI,25,82,15,24,39
8,8475158,Ryan O'Reilly,C,NSH,33,82,14,25,39
8,8480031,Maxime Comtois,L,CAR,25,82,12,27,39
8,8476826,Yanni Gourde,C,SEA,33,82,9,30,39
8,8478458,Jack Roslovic,C,NYR,27,82,9,30,39
8,8482089,Jake Neighbours,L,STL,22,82,20,18,38
8,8482079,Marco Rossi,C,MIN,23,82,19,19,38
8,8477425,Miles Wood,L,COL,29,82,18,20,38
8,8474037,James van Riemsdyk,L,BOS,35,82,17,21,38
8,8476419,Jean-Gabriel Pageau,C,NYI,32,82,15,23,38
8,8478519,Anthony Cirelli,C,TBL,27,82,12,26,38
8,8476854,Hampus Lindholm,D,BOS,30,82,9,29,38
8,8473563,Nicklas Backstrom,C,WSH,37,82,8,30,38
8,8476923,Damon Severson,D,CBJ,30,82,6,32,38
8,8481699,Aku Raty,R,ARI,23,82,2,36,38
8,8475722,Jason Zucker,L,NSH,32,82,22,15,37
8,8474053,Logan Couture,C,SJS,35,82,18,19,37
8,8479423,Alex Nylander,L,CBJ,26,82,16,21,37
8,8480434,Sean Durzi,D,ARI,26,82,13,24,37
8,8476329,Travis Boyd,C,ARI,31,82,11,26,37
8,8476927,Teddy Blueger,C,VAN,30,82,10,27,37
8,8476892,Colton Parayko,D,STL,31,82,10,27,37
8,8481656,Aliaksei Protas,C,WSH,23,82,9,28,37
8,8475906,John Klingberg,D,TOR,32,82,4,33,37
8,8481560,Arthur Kaliyev,R,LAK,23,82,18,18,36
8,8481624,Ilya Mikheyev,R,VAN,30,82,16,20,36
8,8477989,Christian Dvorak,C,MTL,28,82,15,21,36
8,8482222,Alexander Barabanov,L,SJS,30,82,15,21,36
8,8474884,Mike Hoffman,C,SJS,35,82,15,21,36
8,8478466,Daniel Sprong,R,DET,27,82,12,24,36
8,8482105,Jake Sanderson,D,OTT,22,82,12,24,36
8,8478542,Evan Rodrigues,C,FLA,31,82,11,25,36
8,8483445,Cutter Gauthier,L,ANA,20,82,9,27,36
8,8470613,Brent Burns,D,CAR,39,82,9,27,36
8,8478469,Thomas Chabot,D,OTT,27,82,9,27,36
8,8480145,Neal Pionk,D,WPG,29,82,9,27,36
8,8481546,Cam York,D,PHI,23,82,9,27,36
8,8482101,Danil Gushchin,L,SJS,22,82,21,14,35
8,8481186,Logan O'Connor,R,COL,28,82,17,18,35
8,8471698,T.J. Oshie,R,WSH,38,82,17,18,35
8,8476469,Joel Armia,R,MTL,31,82,16,19,35
8,8475191,Reilly Smith,R,PIT,33,82,15,20,35
8,8482124,Quinton Byfield,R,LAK,22,82,12,23,35
8,8475197,Tyson Barrie,D,NSH,33,82,10,25,35
8,8480802,Ryan McLeod,C,EDM,25,82,10,25,35
8,8476906,Shayne Gostisbehere,D,DET,31,82,7,28,35
8,8477494,Jonathan Drouin,L,COL,29,82,7,28,35
8,8481703,Valtteri Puustinen,R,PIT,25,82,4,31,35
8,8483397,Marc McLaughlin,C,BOS,25,82,29,5,34
8,8477330,Dominik Kubalik,L,OTT,29,82,24,10,34
8,8478474,Lawson Crouse,L,ARI,27,82,19,15,34
8,8480893,Kirill Marchenko,R,CBJ,24,82,18,16,34
8,8475793,Ryan Johansen,C,PHI,32,82,16,18,34
8,8478020,Michael Amadio,C,VGK,28,82,16,18,34
8,8482175,JJ Peterka,R,BUF,22,82,15,19,34
8,8474149,Evgenii Dadonov,R,DAL,35,82,15,19,34
8,8481013,Jonatan Berggren,R,DET,24,82,13,21,34
8,8477444,Andre Burakovsky,L,SEA,29,82,12,22,34
8,8477429,Andrew Copp,C,DET,30,82,11,23,34
8,8481581,Thomas Harley,D,DAL,23,82,11,23,34
8,8482720,Matthew Knies,L,TOR,22,82,10,24,34
8,8474586,Jordan Eberle,R,SEA,34,82,10,24,34
8,8477498,Darnell Nurse,D,EDM,29,82,10,24,34
8,8481537,Nikita Okhotiuk,D,CGY,24,82,7,27,34
8,8483457,Lane Hutson,D,MTL,20,82,3,31,34
8,8481535,Nils Hoglander,L,VAN,24,82,21,12,33
8,8483493,Frank Nazar,C,CHI,20,82,18,15,33
8,8474189,Lars Eller,C,PIT,35,82,18,15,33
8,8480849,Barrett Hayton,C,ARI,24,82,16,17,33
8,8479941,Justin Danforth,R,CBJ,31,82,16,17,33
8,8480185,Eetu Luostarinen,C,FLA,26,82,12,21,33
8,8476921,Jordan Martinook,L,CAR,32,82,8,25,33
8,8479398,Samuel Girard,D,COL,26,82,8,25,33
8,8476958,Jaccob Slavin,D,CAR,30,82,7,26,33
8,8480873,Rasmus Sandin,D,WSH,24,82,6,27,33
8,8475171,Oliver Ekman-Larsson,D,FLA,33,82,6,27,33
8,8481016,Ruslan Iskhakov,C,NYI,24,82,3,30,33
8,8484203,Bradly Nadeau,L,CAR,19,82,23,9,32
8,8478366,Frank Vatrano,R,ANA,30,82,18,14,32
8,8480220,Noah Cates,L,PHI,25,82,17,15,32
8,8483431,Logan Cooley,C,ARI,20,82,16,16,32
8,8474641,Adam Henrique,C,EDM,34,82,15,17,32
8,8475343,Nic Dowd,C,WSH,34,82,15,17,32
8,8478463,Anthony Beauvillier,L,NSH,27,82,15,17,32
8,8482117,Lukas Reichel,L,CHI,22,82,15,17,32
8,8479365,Trent Frederic,C,BOS,26,82,14,18,32
8,8478055,Gustav Forsling,D,FLA,28,82,10,22,32
8,8475764,Cam Fowler,D,ANA,33,82,2,30,32
8,8479353,Brett Howden,C,VGK,26,82,19,12,31
8,8474870,Tyler Johnson,C,CHI,34,82,17,14,31
8,8475760,Nick Bjugstad,C,ARI,32,82,16,15,31
8,8476897,Oskar Sundqvist,C,STL,30,82,14,17,31
8,8476872,Scott Laughton,C,PHI,30,82,13,18,31
8,8476960,Andreas Athanasiou,C,CHI,30,82,13,18,31
8,8479987,Morgan Geekie,C,BOS,26,82,12,19,31
8,8479415,Michael McLeod,C,NJD,26,82,12,19,31
8,8476525,Colin Miller,D,WPG,32,82,11,20,31
8,8479980,Nicolas Hague,D,VGK,26,82,7,24,31
8,8475181,Nick Leddy,D,STL,33,82,6,25,31
8,8477506,Ryan Pulock,D,NYI,30,82,5,26,31
8,8482624,Daniil Miromanov,D,CGY,27,82,4,27,31
8,8481580,Connor McMichael,C,WSH,23,82,15,15,30
8,8476392,Adam Lowry,C,WPG,31,82,15,15,30
8,8473422,Nick Foligno,L,CHI,37,82,12,18,30
8,8476925,Colton Sissons,C,NSH,31,82,11,19,30
8,8477450,Jason Dickinson,C,CHI,29,82,9,21,30
8,8474716,Jared Spurgeon,D,MIN,35,82,8,22,30
8,8478851,Alexandre Carrier,D,NSH,28,82,8,22,30
8,8477953,Kasperi Kapanen,R,STL,28,82,7,23,30
8,8481606,Jordan Spence,D,LAK,23,82,5,25,30
8,8482142,Jamie Drysdale,D,PHI,22,82,4,26,30
8,8476331,Dylan DeMelo,D,WPG,31,82,1,29,30
8,8476981,Josh Anderson,R,MTL,30,82,16,13,29
8,8479316,Luke Kunin,C,SJS,27,82,15,14,29
8,8482679,Matt Coronato,R,CGY,22,82,12,17,29
8,8479346,Dillon Dube,C,CGY,26,82,12,17,29
8,8477511,Anthony Mantha,R,VGK,30,82,11,18,29
8,8480009,Eeli Tolvanen,R,SEA,25,82,10,19,29
8,8476869,Brady Skjei,D,CAR,30,82,8,21,29
8,8482146,Luke Evangelista,R,NSH,22,82,8,21,29
8,8478500,Ivan Provorov,D,CBJ,27,82,5,24,29
8,8482087,Kaiden Guhle,D,MTL,22,82,5,24,29
8,8477944,Jakub Vrana,L,STL,28,82,19,9,28
8,8477947,Sonny Milano,L,WSH,28,82,14,14,28
8,8473449,Kyle Okposo,R,FLA,36,82,14,14,28
8,8482702,Logan Stankoven,C,DAL,21,82,13,15,28
8,8479393,Noah Gregor,C,TOR,26,82,13,15,28
8,8480855,Jack McBain,C,ARI,24,82,13,15,28
8,8473533,Jordan Staal,C,CAR,36,82,10,18,28
8,8475714,Calle Jarnkrok,C,TOR,33,82,10,18,28
8,8473453,Trevor Lewis,C,LAK,37,82,10,18,28
8,8480821,Filip Zadina,R,SJS,25,82,9,19,28
8,8482111,Justin Barron,D,MTL,23,82,9,19,28
8,8479351,Sam Steel,C,DAL,26,82,9,19,28
8,8481604,Pavel Dorofeyev,L,VGK,24,82,16,11,27
8,8478057,Dakota Joshua,C,VAN,28,82,9,18,27
8,8478472,Mathieu Joseph,R,OTT,27,82,7,20,27
8,8477948,Travis Sanheim,D,PHI,28,82,7,20,27
8,8475149,Marcus Johansson,L,MIN,34,82,15,11,26
8,8479390,Taylor Raddysh,R,CHI,26,82,14,12,26
8,8479293,Brandon Tanev,L,SEA,33,82,14,12,26
8,8480144,David Kampf,C,TOR,29,82,13,13,26
8,8483491,Ivan Miroshnichenko,L,WSH,20,82,12,14,26
8,8479983,Mario Ferraro,D,SJS,26,82,11,15,26
8,8481601,Simon Holmstrom,R,NYI,23,82,11,15,26
8,8482074,Connor Zary,C,CGY,23,82,10,16,26
8,8477508,Curtis Lazar,C,NJD,29,82,10,16,26
8,8478133,Jake Evans,C,MTL,28,82,9,17,26
8,8481524,Bowen Byram,D,BUF,23,82,9,17,26
8,8477969,Marcus Pettersson,D,PIT,28,82,7,19,26
8,8476463,Jonas Brodin,D,MIN,31,82,6,20,26
8,8476312,Josh Manson,D,COL,33,82,4,22,26
8,8476917,Adam Pelech,D,NYI,30,82,4,22,26
8,8476879,Cody Ceci,D,EDM,31,82,4,22,26
8,8476461,Sean Couturier,C,PHI,32,82,14,11,25
8,8479977,Kailer Yamamoto,R,SEA,26,82,13,12,25
8,8476278,Colin Blackwell,C,CHI,31,82,12,13,25
8,8480113,Alex Iafallo,L,WPG,31,82,11,14,25
8,8481477,Nico Sturm,C,SJS,29,82,11,14,25
8,8481553,Bobby Brink,R,PHI,23,82,10,15,25
8,8482125,Alexander Holtz,R,NJD,22,82,9,16,25
8,8480336,Sean Walker,D,COL,30,82,8,17,25
8,8481568,Alex Vlasic,D,CHI,23,82,8,17,25
8,8482733,Logan Mailloux,D,MTL,31,82,7,18,25
8,8476480,Vladislav Namestnikov,C,WPG,32,82,7,18,25
8,8474151,Ryan McDonagh,D,NSH,35,82,1,24,25
8,8478043,Sam Lafferty,C,VAN,29,82,19,5,24
8,8477952,Robby Fabbri,C,DET,28,82,12,12,24
8,8482705,Cole Sillinger,C,CBJ,21,82,11,13,24
8,8479996,Cody Glass,C,NSH,25,82,11,13,24
8,8484153,Leo Carlsson,C,ANA,20,82,11,13,24
8,8470621,Corey Perry,R,EDM,39,82,11,13,24
8,8478109,Victor Olofsson,L,BUF,29,82,11,13,24
8,8479324,Ryan Lindgren,D,NYR,26,82,11,13,24
8,8482475,Yegor Chinakhov,R,CBJ,23,82,10,14,24
8,8477919,Frederick Gaudreau,C,MIN,31,82,10,14,24
8,8474034,Pat Maroon,L,BOS,36,82,10,14,24
8,8479591,Michael Eyssimont,C,TBL,28,82,9,15,24
8,8482730,Brandt Clarke,D,LAK,21,82,8,16,24
8,8476422,Mike Reilly,D,NYI,31,82,8,16,24
8,8480817,K'Andre Miller,D,NYR,24,82,7,17,24
8,8477392,Hudson Fasching,R,NYI,29,82,7,17,24
8,8475220,Marcus Foligno,L,MIN,33,82,7,17,24
8,8482166,Shakir Mukhamadullin,D,SJS,22,82,6,18,24
8,8482655,J.J. Moser,D,ARI,24,82,5,19,24
8,8476457,Adam Larsson,D,SEA,32,82,5,19,24
8,8480043,Timothy Liljegren,D,TOR,25,82,3,21,24
8,8482145,Mavrik Bourque,C,DAL,22,82,18,5,23
8,8482809,Jackson Blake,R,CAR,21,82,18,5,23
8,8476873,Mark Jankowski,C,NSH,30,82,17,6,23
8,8480459,Pius Suter,C,VAN,28,82,15,8,23
8,8481704,Juuso Parssinen,C,NSH,23,82,14,9,23
8,8480074,Alexandre Texier,C,CBJ,25,82,11,12,23
8,8484166,Adam Fantilli,C,CBJ,20,82,10,13,23
8,8479514,Rem Pitlick,C,CHI,27,82,10,13,23
8,8482803,Olen Zellweger,D,ANA,21,82,7,16,23
8,8478882,Vladislav Gavrikov,D,LAK,29,82,6,17,23
8,8477353,Tyler Motte,C,TBL,29,82,6,17,23
8,8476902,Esa Lindell,D,DAL,30,82,6,17,23
8,8477845,Trevor van Riemsdyk,D,WSH,33,82,6,17,23
8,8482062,Cole Smith,L,NSH,29,82,4,19,23
8,8479976,Juuso Valimaki,D,ARI,26,82,3,20,23
8,8476979,Erik Gustafsson,D,NYR,32,82,1,22,23
8,8474574,Tyler Myers,D,VAN,34,82,0,23,23
8,8483499,Liam Ohgren,L,MIN,20,82,11,11,22
8,8480068,Ryan Poehling,C,PHI,25,82,8,14,22
8,8476871,Tanner Pearson,L,MTL,32,82,7,15,22
8,8481028,Martin Pospisil,C,CGY,25,82,7,15,22
8,8478911,Matt Roy,D,LAK,29,82,6,16,22
8,8480058,Pierre-Olivier Joseph,D,PIT,25,82,5,17,22
8,8478413,Jordan Greenway,L,BUF,27,82,4,18,22
8,8482671,Owen Power,D,BUF,22,82,4,18,22
8,8478443,Brandon Carlo,D,BOS,28,82,3,19,22
8,8478840,Will Borgen,D,SEA,28,82,2,20,22
8,8478507,John Marino,D,NJD,27,82,1,21,22
8,8481554,Kaapo Kakko,R,NYR,23,82,19,2,21
8,8478831,Kevin Stenlund,C,FLA,28,82,12,9,21
8,8478508,Yakov Trenin,C,COL,27,82,10,11,21
8,8473504,Cal Clutterbuck,R,NYI,37,82,8,13,21
8,8477507,Nikita Zadorov,D,VAN,29,82,6,15,21
8,8483495,Simon Nemec,D,NJD,20,82,6,15,21
8,8479442,Troy Stecher,D,EDM,30,82,5,16,21
8,8482712,Oskar Olausson,R,COL,22,82,5,16,21
8,8480796,Martin Fehervary,D,WSH,25,82,5,16,21
8,8475455,Brenden Dillon,D,WPG,34,82,4,17,21
8,8480073,Erik Brannstrom,D,OTT,25,82,3,18,21
8,8481605,Jackson LaCombe,D,ANA,23,82,3,18,21
8,8482073,Braden Schneider,D,NYR,23,82,2,19,21
8,8480246,Nick Perbix,D,TBL,26,82,1,20,21
8,8478569,Noel Acciari,C,PIT,33,82,10,10,20
8,8478013,Jake Walman,D,DET,28,82,10,10,20
8,8474009,Nick Bonino,C,NYR,36,82,10,10,20
8,8482118,Sam Colangelo,R,ANA,23,82,10,10,20
8,8483482,Tristan Luneau,D,ANA,20,82,10,10,20
8,8482259,Bobby McMann,C,TOR,28,82,9,11,20
8,8475164,Jakob Silfverberg,R,ANA,34,82,8,12,20
8,8479998,Mikey Anderson,D,LAK,25,82,7,13,20
8,8479359,Beck Malenstyn,L,WSH,26,82,6,14,20
8,8478430,Oliver Kylington,D,CGY,27,82,5,15,20
8,8483490,Pavel Mintyukov,D,ANA,21,82,5,15,20
8,8478136,Jake Middleton,D,MIN,28,82,3,17,20
8,8473507,Jeff Petry,D,DET,37,82,2,18,20
8,8480871,Adam Boqvist,D,CBJ,24,82,1,19,20
8,8482762,Simon Edvinsson,D,DET,21,82,9,10,19
8,8479661,Tanner Jeannot,L,TBL,27,82,8,11,19
8,8477931,Tomas Nosek,L,NJD,32,82,8,11,19
8,8481481,Blake Lizotte,C,LAK,27,82,7,12,19
8,8478399,Jonas Siegenthaler,D,NJD,27,82,6,13,19
8,8477015,Connor Brown,R,EDM,30,82,6,13,19
8,8483763,Maksymilian Szuber,D,ARI,22,82,6,13,19
8,8481014,Alexander Romanov,D,NYI,24,82,5,14,19
8,8474166,Alec Martinez,D,VGK,37,82,5,14,19
8,8480807,Mattias Samuelsson,D,BUF,24,82,4,15,19
8,8477435,Ryan Graves,D,PIT,29,82,3,16,19
8,8480834,Ty Emberson,D,SJS,24,82,3,16,19
8,8476891,Matt Grzelcyk,D,BOS,30,82,3,16,19
8,8477488,Brett Pesce,D,CAR,30,82,2,17,19
8,8481178,Egor Zamula,D,PHI,24,82,1,18,19
8,8475231,Casey Cizikas,C,NYI,33,82,11,7,18
8,8480806,Isac Lundestrom,C,ANA,25,82,10,8,18
8,8474715,Cam Atkinson,R,PHI,35,82,10,8,18
8,8477839,Conor Sheary,L,TBL,32,82,9,9,18
8,8482092,Ridly Greig,C,OTT,22,82,8,10,18
8,8483565,Nick Blankenburg,D,CBJ,26,82,7,11,18
8,8477369,Carson Soucy,D,VAN,30,82,6,12,18
8,8475842,Sam Carrick,C,EDM,32,82,6,12,18
8,8483505,Matthew Poitras,C,BOS,20,82,6,12,18
8,8482470,Ilya Solovyov,D,CGY,24,82,5,13,18
8,8475462,Radko Gudas,D,ANA,34,82,4,14,18
8,8475188,Brayden McNabb,D,VGK,33,82,3,15,18
8,8477499,Rasmus Ristolainen,D,PHI,30,82,3,15,18
8,8474673,TJ Brodie,D,TOR,34,82,3,15,18
8,8477220,Nate Schmidt,D,WPG,33,82,2,16,18
8,8477406,Mattias Janmark,C,EDM,32,82,10,7,17
8,8484145,Zach Benson,L,BUF,19,82,10,7,17
8,8482737,Zack Bolduc,C,STL,21,82,9,8,17
8,8476374,Sean Kuraly,C,CBJ,31,82,9,8,17
8,8480813,Joe Veleno,C,DET,24,82,8,9,17
8,8480990,Declan Chisholm,D,MIN,24,82,8,9,17
8,8481522,Peyton Krebs,C,BUF,23,82,6,11,17
8,8482858,Ryker Evans,D,SEA,23,82,5,12,17
8,8478178,Darren Raddysh,D,TBL,28,82,4,13,17
8,8482516,Matthew Kessel,D,STL,24,82,4,13,17
8,8480172,Jan Rutta,D,SJS,34,82,1,16,17
8,8475233,David Savard,D,MTL,34,82,1,16,17
8,8470604,Jeff Carter,C,PIT,39,82,9,7,16
8,8480281,Alexey Toropchenko,R,STL,25,82,7,9,16
8,8479369,Andrew Peeke,D,BOS,26,82,7,9,16
8,8480035,Henri Jokiharju,D,BUF,25,82,6,10,16
8,8474567,Zach Bogosian,D,MIN,34,82,5,11,16
8,8477365,Connor Clifton,D,BUF,29,82,3,13,16
8,8476473,Connor Murphy,D,CHI,31,82,3,13,16
8,8476885,Jacob Trouba,D,NYR,30,82,2,14,16
8,8474013,Ian Cole,D,VAN,35,82,2,14,16
8,8475690,Chris Tanev,D,DAL,35,82,2,14,16
8,8476442,Matt Nieto,L,PIT,32,82,10,5,15
8,8479383,Boris Katchouk,L,OTT,26,82,10,5,15
8,8482245,Artem Zub,D,OTT,29,82,8,7,15
8,8476624,Barclay Goodrow,C,NYR,31,82,8,7,15
8,8478451,Ethan Bear,D,WSH,27,82,6,9,15
8,8476878,Zemgus Girgensons,L,BUF,30,82,5,10,15
8,8476858,Phillip Di Giuseppe,L,VAN,31,82,3,12,15
8,8478859,Niko Mikkola,D,FLA,28,82,3,12,15
8,8480860,Kevin Bahl,D,NJD,24,82,3,12,15
8,8475200,Dmitry Orlov,D,CAR,33,82,2,13,15
8,8475790,Erik Gudbranson,D,CBJ,32,82,2,13,15
8,8475324,Nick Jensen,D,WSH,34,82,2,13,15
8,8481567,Henry Thrun,D,SJS,23,82,0,15,15
8,8482155,Alex Laferriere,R,LAK,23,82,6,8,14
8,8475279,Ben Chiarot,D,DET,33,82,3,11,14
8,8477034,Jaycob Megna,D,CHI,32,82,3,11,14
8,8483466,Kevin Korchinski,D,CHI,20,82,2,12,14
8,8475762,Derek Forbort,D,BOS,32,82,2,12,14
8,8484911,Collin Graf,R,SJS,22,82,1,13,14
8,8481093,Rafael Harvey-Pinard,L,MTL,25,82,9,4,13
8,8483012,Logan Morrison,C,SEA,22,82,8,5,13
8,8479291,Kevin Rooney,C,CGY,31,82,6,7,13
8,8480879,Jacob Bernard-Docker,D,OTT,24,82,5,8,13
8,8476967,Brett Kulak,D,EDM,30,82,4,9,13
8,8478416,Erik Cernak,D,TBL,27,82,3,10,13
8,8476467,Jamie Oleksiak,D,SEA,32,82,2,11,13
8,8481059,Scott Perunovich,D,STL,26,82,0,13,13
8,8483489,Fraser Minten,C,TOR,31,82,7,5,12
8,8482713,Mackie Samoskevich,R,FLA,22,82,7,5,12
8,8477505,Alexander Wennberg,C,NYR,30,82,4,8,12
8,8482666,Scott Morrow,D,CAR,22,82,4,8,12
8,8480980,Connor Dewar,C,TOR,25,82,3,9,12
8,8470600,Ryan Suter,D,DAL,39,82,3,9,12
8,8482807,Ethan Del Mastro,D,CHI,21,82,2,10,12
8,8483468,Jiri Kulich,C,BUF,20,82,1,11,12
8,8475179,Dmitry Kulikov,D,FLA,34,82,0,12,12
8,8476429,Scott Mayfield,D,NYI,32,82,0,12,12
8,8478468,Jeremy Lauzon,D,NSH,27,82,6,5,11
8,8478408,Travis Dermott,D,ARI,28,82,5,6,11
8,8471677,Jack Johnson,D,COL,37,82,4,7,11
8,8481578,Graeme Clarke,R,NJD,23,82,4,7,11
8,8476931,Jake McCabe,D,TOR,31,82,3,8,11
8,8475208,Brian Dumoulin,D,SEA,33,82,3,8,11
8,8481030,Jack St. Ivany,D,PIT,25,82,3,8,11
8,8475177,Calvin de Haan,D,TBL,33,82,2,9,11
8,8480448,Parker Kelly,L,OTT,25,82,5,5,10
8,8470966,Mark Giordano,D,TOR,41,82,5,5,10
8,8477335,Kyle Burroughs,D,SJS,29,82,2,8,10
8,8481517,Brett Leason,R,ANA,25,82,6,3,9
8,8481599,Victor Soderstrom,D,ARI,23,82,3,6,9
8,8479371,Dante Fabbro,D,NSH,26,82,2,7,9
8,8475825,Jani Hakanpää,D,DAL,32,82,0,9,9
8,8476822,Luke Glendening,C,TBL,35,82,3,5,8
8,8482177,Marat Khusnutdinov,C,MIN,22,82,1,7,8
8,8484149,Gavin Brindley,C,CBJ,20,82,1,7,8
8,8476915,Jujhar Khaira,L,MIN,30,82,4,3,7
8,8476372,Nick Seeler,D,PHI,31,82,2,5,7
8,8482859,Zack Ostapchuk,C,OTT,21,82,2,3,5
8,8482141,Lukas Cormier,D,VGK,22,0,0,0,0
8,8476988,Matt Benning,D,SJS,30,0,0,0,0
8,8480727,Zach Whitecloud,D,VGK,28,0,0,0,0
8,8480887,Jordan Harris,D,MTL,24,0,0,0,0
8,8478450,Parker Wotherspoon,D,BOS,27,0,0,0,0
8,8481812,Nikolai Knyzhov,D,SJS,27,0,0,0,0
8,8480001,Urho Vaakanainen,D,ANA,25,0,0,0,0
8,8482176,Wyatt Kaiser,D,CHI,22,0,0,0,0
8,8481122,Simon Benoit,D,TOR,26,0,0,0,0
8,8476441,Joel Edmundson,D,TOR,31,0,0,0,0
8,8480884,Calen Addison,D,SJS,24,0,0,0,0
8,8482511,Mason Lohrei,D,BOS,23,0,0,0,0
8,8482192,Isaak Phillips,D,CHI,23,0,0,0,0
8,8480950,Ilya Lyubushkin,D,TOR,30,0,0,0,0
8,8474031,Kevin Shattenkirk,D,BOS,35,0,0,0,0
8,8475718,Justin Holl,D,DET,32,0,0,0,0
8,8479402,Jake Bean,D,CBJ,26,0,0,0,0
8,8474602,Justin Schultz,D,SEA,34,0,0,0,0
8,8477950,Tony DeAngelo,D,CAR,29,0,0,0,0
8,8481743,Marc Del Gaizo,D,NSH,25,0,0,0,0
8,8481527,Kaedan Korczak,D,VGK,23,0,0,0,0
8,8480192,Johnathan Kovacevic,D,MTL,27,0,0,0,0
8,8476874,Olli Maatta,D,DET,30,0,0,0,0
8,8482144,Jack Thompson,D,SJS,22,0,0,0,0
8,8480222,Sebastian Aho,D,NYI,28,0,0,0,0
8,8479458,Nikita Zaitsev,D,CHI,33,0,0,0,0
8,8471709,Marc-Edouard Vlasic,D,SJS,37,0,0,0,0
8,8482929,Emil Lilleberg,D,TBL,23,0,0,0,0
8,8477018,Ben Hutton,D,VGK,31,0,0,0,0
8,8481056,Spencer Stastney,D,NSH,24,0,0,0,0
8,8481593,Jayden Struble,D,MTL,23,0,0,0,0
8,8479982,Conor Timmins,D,TOR,26,0,0,0,0
8,8474090,Brendan Smith,D,NJD,35,0,0,0,0
8,8482964,Arber Xhekaj,D,MTL,23,0,0,0,0
8,8480891,Michael Kesselring,D,ARI,24,0,0,0,0
8,8477938,Haydn Fleury,D,TBL,28,0,0,0,0
8,8481806,Louis Crevier,D,CHI,23,0,0,0,0
8,8471274,Alex Goligoski,D,MIN,39,0,0,0,0
8,8481600,Tobias Bjornfot,D,FLA,23,0,0,0,0
8,8475797,Jarred Tinordi,D,CHI,32,0,0,0,0
8,8481521,Ronnie Attard,D,PHI,25,0,0,0,0
8,8474612,Travis Hamonic,D,OTT,34,0,0,0,0
8,8479576,Vincent Desharnais,D,EDM,28,0,0,0,0
8,8480049,Dylan Samberg,D,WPG,25,0,0,0,0
8,8483619,Filip Roos,D,CHI,25,0,0,0,0
8,8474568,Luke Schenn,D,NSH,35,0,0,0,0
8,8480184,Gustav Lindstrom,D,ANA,26,0,0,0,0
8,8480070,Ian Mitchell,D,BOS,25,0,0,0,0
8,8480196,Jacob Bryson,D,BUF,27,0,0,0,0
8,8471686,Marc Staal,D,PHI,37,0,0,0,0
8,8477467,Gustav Olofsson,D,SEA,30,0,0,0,0
8,8478970,Jalen Chatfield,D,CAR,28,0,0,0,0
8,8479348,Kale Clague,D,BUF,26,0,0,0,0
8,8473446,Erik Johnson,D,PHI,36,0,0,0,0
8,8477462,Robert Hagg,D,ANA,29,0,0,0,0
8,8478454,Noah Juulsen,D,VAN,27,0,0,0,0
8,8477384,Josh Brown,D,ARI,30,0,0,0,0
8,8481708,Zac Jones,D,NYR,24,0,0,0,0
8,8481167,Brayden Pachal,D,CGY,25,0,0,0,0
8,8482067,Connor Mackey,D,NYR,28,0,0,0,0
8,8483460,David Jiricek,D,CBJ,21,0,0,0,0
8,8481701,Santeri Hatakka,D,NJD,23,0,0,0,0
8,8478021,William Lagesson,D,ANA,28,0,0,0,0
8,8477851,Jordan Oesterle,D,CGY,32,0,0,0,0
8,8478452,Caleb Jones,D,COL,27,0,0,0,0
8,8479984,Cal Foote,D,NJD,26,0,0,0,0
8,8479639,Dylan Coghlan,D,CAR,26,0,0,0,0
8,8480874,Adam Ginning,D,PHI,24,0,0,0,0
8,8479321,Lucas Johansen,D,WSH,27,0,0,0,0
8,8480878,Nils Lundkvist,D,DAL,24,0,0,0,0
8,8482165,Yan Kuznetsov,D,CGY,22,0,0,0,0
8,8484258,Sam Malinski,D,COL,26,0,0,0,0
8,8480157,Calle Rosen,D,STL,30,0,0,0,0
8,8484304,Uvis Balinskis,D,FLA,28,0,0,0,0
8,8479985,Cale Fleury,D,SEA,26,0,0,0,0
8,8479378,Logan Stanley,D,WPG,26,0,0,0,0
8,8477541,Dakota Mermis,D,MIN,30,0,0,0,0
8,8481609,Vladislav Kolyachonok,D,ARI,23,0,0,0,0
8,8480823,Alexander Alexeyev,D,WSH,25,0,0,0,0
8,8481679,Maxence Guenette,D,OTT,23,0,0,0,0
8,8481564,Ryan Johnson,D,BUF,23,0,0,0,0
8,8479376,Victor Mete,D,PHI,26,0,0,0,0
8,8484254,Akito Hirose,D,VAN,25,0,0,0,0
8,8482660,Kent Johnson,C,CBJ,22,0,0,0,0
8,8482149,Cole Perfetti,C,WPG,22,0,0,0,0
8,8477987,Ryan Donato,C,CHI,28,0,0,0,0
8,8475755,Alexander Petrovic,D,DAL,32,0,0,0,0
8,8477810,Joel Hanley,D,CGY,33,0,0,0,0
8,8474145,Robert Bortuzzo,D,NYI,35,0,0,0,0
8,8481161,Jake Christiansen,D,CBJ,25,0,0,0,0
8,8476884,Derrick Pouliot,D,DAL,30,0,0,0,0
8,8481716,Dmitri Voronkov,L,CBJ,24,0,0,0,0
8,8480084,Nick DeSimone,D,NJD,30,0,0,0,0
8,8475750,Jon Merrill,D,MIN,32,0,0,0,0
8,8479315,Joey Anderson,R,CHI,26,0,0,0,0
8,8478011,Louie Belpedio,D,PHI,28,0,0,0,0
8,8482451,Mikael Pyyhtia,L,CBJ,23,0,0,0,0
8,8481541,Samuel Bolduc,D,NYI,24,0,0,0,0
8,8482126,Emil Andrae,D,PHI,31,0,0,0,0
8,8474618,Marco Scandella,D,STL,34,0,0,0,0
8,8477244,Chad Ruhwedel,D,NYR,34,0,0,0,0
8,8477971,Andreas Englund,D,LAK,28,0,0,0,0
8,8480829,Jesperi Kotkaniemi,C,CAR,24,0,0,0,0
8,8479372,Josh Mahura,D,FLA,26,0,0,0,0
8,8482095,Tyler Kleven,D,OTT,22,0,0,0,0
8,8481719,Maxwell Crozier,D,TBL,24,0,0,0,0
8,8475855,Jesper Fast,R,CAR,33,0,0,0,0
8,8480848,Ty Dellandrea,C,DAL,24,0,0,0,0
8,8475193,Tomas Tatar,L,SEA,34,0,0,0,0
8,8476889,Radek Faksa,C,DAL,30,0,0,0,0
8,8478495,Denis Gurianov,R,PHI,27,0,0,0,0
8,8480216,Jacob Peterson,C,SJS,25,0,0,0,0
8,8480252,Cole Guttman,C,CHI,25,0,0,0,0
8,8479026,Philippe Myers,D,TBL,27,0,0,0,0
8,8481006,Tyler Tucker,D,STL,24,0,0,0,0
8,8481032,Paul Cotter,C,VGK,25,0,0,0,0
8,8481577,Philip Tomasino,C,NSH,23,0,0,0,0
8,8476918,Jimmy Vesey,L,NYR,31,0,0,0,0
8,8479320,Max Lajoie,D,TOR,27,0,0,0,0
8,8478017,Mark Friedman,D,VAN,29,0,0,0,0
8,8481754,Nikita Nesterenko,C,ANA,23,0,0,0,0
8,8483407,Brandon Scanlin,D,NYR,25,0,0,0,0
8,8482659,Josh Doan,R,ARI,22,0,0,0,0
8,8477446,Michael McCarron,R,NSH,29,0,0,0,0
8,8477903,Garnet Hathaway,R,PHI,33,0,0,0,0
8,8482153,Brendan Brisson,C,VGK,23,0,0,0,0
8,8483546,Marshall Rifai,D,TOR,26,0,0,0,0
8,8484287,Cole McWard,D,VAN,23,0,0,0,0
8,8478854,Ryan Shea,D,PIT,27,0,0,0,0
8,8481585,Egor Afanasyev,L,NSH,23,0,0,0,0
8,8483398,Declan Carlile,D,TBL,31,0,0,0,0
8,8478502,Dennis Gilbert,D,CGY,28,0,0,0,0
8,8482749,Joshua Roy,R,MTL,21,0,0,0,0
8,8481598,Philip Broberg,D,EDM,23,0,0,0,0
8,8480835,Jack Drury,C,CAR,24,0,0,0,0
8,8480748,Kiefer Sherwood,L,NSH,29,0,0,0,0
8,8476934,Brock McGinn,L,ANA,30,0,0,0,0
8,8480870,Bo Groulx,C,ANA,24,0,0,0,0
8,8479368,Max Jones,L,ANA,26,0,0,0,0
8,8478099,Kevin Labanc,R,SJS,29,0,0,0,0
8,8478067,Oskar Lindblom,L,SJS,28,0,0,0,0
8,8476393,Nick Cousins,C,FLA,31,0,0,0,0
8,8483395,Arshdeep Bains,L,VAN,23,0,0,0,0
8,8480762,Eric Robinson,L,BUF,29,0,0,0,0
8,8479439,Jacob MacDonald,D,SJS,31,0,0,0,0
8,8476474,Stefan Noesen,R,CAR,31,0,0,0,0
8,8482787,Nikita Chibrikov,R,WPG,31,0,0,0,0
8,8478432,Christian Fischer,R,DET,27,0,0,0,0
8,8477979,Nicolas Aube-Kubel,R,WSH,28,0,0,0,0
8,8481789,Tye Kartye,L,SEA,23,0,0,0,0
8,8479330,Brandon Gignac,C,MTL,27,0,0,0,0
8,8480075,Cameron Crotty,D,ARI,25,0,0,0,0
8,8473473,Milan Lucic,L,BOS,36,0,0,0,0
8,8482094,Daemon Hunt,D,MIN,22,0,0,0,0
8,8481206,John Ludvig,D,PIT,24,0,0,0,0
8,8483630,Pavol Regenda,L,ANA,25,0,0,0,0
8,8481617,Vasily Podkolzin,R,VAN,23,0,0,0,0
8,8480306,Grant Hutton,D,NYI,29,0,0,0,0
8,8480995,Pontus Holmberg,R,TOR,25,0,0,0,0
8,8482148,Hendrix Lapierre,C,WSH,22,0,0,0,0
8,8477478,William Carrier,L,VGK,30,0,0,0,0
8,8480003,Jesper Boqvist,C,BOS,26,0,0,0,0
8,8482172,Landon Slaggert,L,CHI,22,0,0,0,0
8,8480789,Oliver Wahlstrom,R,NYI,24,0,0,0,0
8,8474062,Riley Nash,C,NYR,35,0,0,0,0
8,8480021,Jack Studnicka,C,SJS,25,0,0,0,0
8,8480025,MacKenzie Entwistle,R,CHI,25,0,0,0,0
8,8481582,Nicholas Robertson,L,TOR,23,0,0,0,0
8,8476867,Brendan Gaunce,C,CBJ,30,0,0,0,0
8,8479619,Michael Carcone,L,ARI,28,0,0,0,0
8,8479370,Tyson Jost,C,BUF,26,0,0,0,0
8,8479671,Mathieu Olivier,R,CBJ,27,0,0,0,0
8,8476994,Vinnie Hinostroza,C,PIT,30,0,0,0,0
8,8482070,Mitchell Chaffee,R,TBL,26,0,0,0,0
8,8477473,Justin Bailey,R,SJS,29,0,0,0,0
8,8479344,Jesse Puljujarvi,R,PIT,26,0,0,0,0
8,8480205,Emil Bemstrom,C,PIT,25,0,0,0,0
8,8479718,Alex Barré-Boulet,C,TBL,27,0,0,0,0
8,8482061,Brandon Biro,L,BUF,26,0,0,0,0
8,8479638,Justin Brazeau,R,BOS,26,0,0,0,0
8,8474040,Sam Gagner,C,EDM,35,0,0,0,0
8,8477846,Ryan Carpenter,C,SJS,33,0,0,0,0
8,8482077,Dylan Holloway,L,EDM,23,0,0,0,0
8,8482157,Will Cuylle,L,NYR,22,0,0,0,0
8,8480007,Jonas Rondbjerg,R,VGK,25,0,0,0,0
8,8478874,Adam Gaudette,C,STL,28,0,0,0,0
8,8478434,Keegan Kolesar,R,VGK,27,0,0,0,0
8,8480441,Trey Fix-Wolansky,R,CBJ,25,0,0,0,0
8,8479994,Jaret Anderson-Dolan,C,NSH,25,0,0,0,0
8,8483567,Georgii Merkulov,C,BOS,24,0,0,0,0
8,8477380,Jonny Brodzinski,C,NYR,31,0,0,0,0
8,8482201,Gage Goncalves,C,TBL,23,0,0,0,0
8,8478211,Dryden Hunt,L,CGY,29,0,0,0,0
8,8471699,Andrew Cogliano,C,COL,37,0,0,0,0
8,8479421,Jacob Moverare,D,LAK,26,0,0,0,0
8,8478881,Brett Seney,L,CHI,28,0,0,0,0
8,8477464,Nic Petan,C,MIN,29,0,0,0,0
8,8475958,Michael Sgarbossa,C,WSH,32,0,0,0,0
8,8481147,Reese Johnson,C,CHI,26,0,0,0,0
8,8479336,Carl Grundstrom,R,LAK,27,0,0,0,0
8,8480853,Liam Foudy,C,NSH,24,0,0,0,0
8,8479522,Hardy Haman Aktell,D,WSH,26,0,0,0,0
8,8481462,Mason Morelli,L,VGK,28,0,0,0,0
8,8482102,Vasily Ponomarev,C,CAR,22,0,0,0,0
8,8480844,Grigori Denisenko,L,VGK,24,0,0,0,0
8,8479944,Zach Aston-Reese,C,DET,30,0,0,0,0
8,8482784,Zach Dean,C,STL,21,0,0,0,0
8,8479419,Brett Murray,L,BUF,26,0,0,0,0
8,8479520,Brandon Duhaime,R,COL,27,0,0,0,0
8,8477573,Nathan Walker,L,STL,30,0,0,0,0
8,8478078,Rourke Chartier,C,OTT,28,0,0,0,0
8,8475795,Dylan McIlrath,D,WSH,32,0,0,0,0
8,8482496,Nils Aman,C,VAN,24,0,0,0,0
8,8480289,Morgan Barron,C,WPG,26,0,0,0,0
8,8481751,Lukas Rousek,R,BUF,25,0,0,0,0
8,8480011,Klim Kostin,C,SJS,25,0,0,0,0
8,8481556,John Beecher,C,BOS,23,0,0,0,0
8,8475278,Byron Froese,C,VGK,33,0,0,0,0
8,8475225,Craig Smith,C,DAL,35,0,0,0,0
8,8484326,Patrik Koch,D,ARI,28,0,0,0,0
8,8477930,Pierre-Edouard Bellemare,L,SEA,39,0,0,0,0
8,8478409,Anthony Richard,C,BOS,28,0,0,0,0
8,8481024,Linus Karlsson,C,VAN,25,0,0,0,0
8,8479986,Kole Lind,R,SEA,26,0,0,0,0
8,8479414,Nathan Bastian,R,NJD,27,0,0,0,0
8,8479362,Riley Tufte,L,COL,26,0,0,0,0
8,8481058,Jesse Ylönen,R,MTL,25,0,0,0,0
8,8482476,Emil Heineman,L,MTL,23,0,0,0,0
8,8482861,Vincent Iorio,D,WSH,22,0,0,0,0
8,8483432,Luca Del Bel Belluz,C,CBJ,31,0,0,0,0
8,8482744,James Malatesta,L,CBJ,21,0,0,0,0
8,8477887,Patrick Brown,C,BOS,32,0,0,0,0
8,8478585,Derek Ryan,C,EDM,38,0,0,0,0
8,8481441,Joe Snively,C,WSH,28,0,0,0,0
8,8481592,Jakob Pelletier,L,CGY,23,0,0,0,0
8,8482634,Alex Steeves,C,TOR,25,0,0,0,0
8,8477126,Jayson Megna,C,BOS,34,0,0,0,0
8,8475752,Tyler Pitlick,C,NYR,33,0,0,0,0
8,8480008,Adam Ruzicka,C,ARI,25,0,0,0,0
8,8481065,Angus Crookshank,L,OTT,25,0,0,0,0
8,8479547,Matthew Phillips,R,WSH,26,0,0,0,0
8,8480226,Marián Studenic,R,SEA,26,0,0,0,0
8,8481237,Kyle MacLean,C,NYI,25,0,0,0,0
8,8475413,Justin Dowling,C,NJD,34,0,0,0,0
8,8481641,Joel Kiviranta,L,COL,28,0,0,0,0
8,8478104,Sammy Blais,L,STL,28,0,0,0,0
8,8477454,Adam Erne,L,EDM,29,0,0,0,0
8,8481518,Nolan Foote,L,NJD,24,0,0,0,0
8,8480245,Olle Lycksell,R,PHI,25,0,0,0,0
8,8483570,Ben Meyers,C,ANA,26,0,0,0,0
8,8480776,Sheldon Rempal,R,VGK,29,0,0,0,0
8,8483920,Pierrick Dube,R,WSH,23,0,0,0,0
8,8480267,Sammy Walker,C,MIN,25,0,0,0,0
8,8482747,Brennan Othmann,L,NYR,21,0,0,0,0
8,8479991,Jake Leschyshyn,C,NYR,25,0,0,0,0
8,8478400,Colin White,C,MTL,27,0,0,0,0
8,8479328,Julien Gauthier,R,NYI,27,0,0,0,0
8,8484325,Waltteri Merela,C,TBL,26,0,0,0,0
8,8479066,Ryan Lomberg,L,FLA,30,0,0,0,0
8,8477070,Liam O'Brien,C,ARI,30,0,0,0,0
8,8478146,Matthew Highmore,C,OTT,28,0,0,0,0
8,8478028,Fredrik Olofsson,L,COL,28,0,0,0,0
8,8480880,Jakub Lauko,C,BOS,24,0,0,0,0
8,8479968,Vinni Lettieri,C,MIN,29,0,0,0,0
8,8474709,Matt Martin,L,NYI,35,0,0,0,0
8,8480845,Rasmus Kupari,C,WPG,24,0,0,0,0
8,8481550,Adam Beckman,L,MIN,23,0,0,0,0
8,8481422,Jacob Lucchini,C,MIN,29,0,0,0,0
8,8477401,John Hayden,C,SEA,29,0,0,0,0
8,8478904,Steven Lorentz,C,FLA,28,0,0,0,0
8,8482088,Justin Sourdif,R,FLA,22,0,0,0,0
8,8482751,Ryan Winterton,C,SEA,21,0,0,0,0
8,8482241,Radim Zohorna,L,PIT,28,0,0,0,0
8,8481690,Tyler Angle,C,CBJ,24,0,0,0,0
8,8476952,Dominic Toninato,C,WPG,30,0,0,0,0
8,8476919,Chris Tierney,C,NJD,30,0,0,0,0
8,8480032,Shane Bowers,C,NJD,25,0,0,0,0
8,8484314,Jiri Smejkal,L,OTT,28,0,0,0,0
8,8481239,Samuel Fagemo,L,LAK,24,0,0,0,0
8,8481532,Alex Turcotte,C,LAK,23,0,0,0,0
8,8481019,David Gustafsson,C,WPG,24,0,0,0,0
8,8478477,Mitchell Stephens,C,MTL,27,0,0,0,0
8,8479546,Oskar Steen,C,BOS,26,0,0,0,0
8,8480292,Carson Meyer,R,CBJ,27,0,0,0,0
8,8478446,Glenn Gawdin,C,ANA,27,0,0,0,0
8,8483531,Brian Halonen,L,NJD,25,0,0,0,0
8,8477149,Scott Sabourin,R,SJS,32,0,0,0,0
8,8479972,Mason Shaw,C,MIN,26,0,0,0,0
8,8480890,Jan Jenik,R,ARI,24,0,0,0,0
8,8478051,Max Willman,C,NJD,29,0,0,0,0
8,8480851,Akil Thomas,C,LAK,24,0,0,0,0
8,8482765,Isak Rosen,R,BUF,21,0,0,0,0
8,8478421,A.J. Greer,L,CGY,28,0,0,0,0
8,8478512,Austin Czarnik,C,DET,32,0,0,0,0
8,8479536,Axel Jonsson-Fjallby,L,WPG,26,0,0,0,0
8,8477320,Anton Blidh,L,NYR,29,0,0,0,0
8,8481543,Nikita Alexandrov,C,STL,24,0,0,0,0
8,8475235,Nicolas Deslauriers,L,PHI,33,0,0,0,0
8,8481070,Hugh McGing,L,STL,26,0,0,0,0
8,8480836,Jonathan Gruden,C,PIT,24,0,0,0,0
8,8481591,Sam Poulin,R,PIT,23,0,0,0,0
8,8477962,Brendan Lemieux,L,CAR,28,0,0,0,0
8,8483401,Marc Johnstone,R,PIT,28,0,0,0,0
8,8482250,Callahan Burke,C,CAR,27,0,0,0,0
8,8481726,Adam Edstrom,C,NYR,24,0,0,0,0
8,8471817,Ryan Reaves,R,TOR,37,0,0,0,0
8,8479587,Rhett Gardner,C,PHI,28,0,0,0,0
8,8475766,Austin Watson,L,TBL,32,0,0,0,0
8,8479367,William Lockwood,R,FLA,26,0,0,0,0
8,8478424,Jansen Harkins,C,PIT,27,0,0,0,0
8,8476913,Devin Shore,C,SEA,30,0,0,0,0
8,8482652,Walker Duehr,R,CGY,27,0,0,0,0
8,8477527,Ross Johnston,L,ANA,30,0,0,0,0
8,8481077,John Leonard,L,ARI,26,0,0,0,0
8,8483549,Lucas Condotta,L,MTL,27,0,0,0,0
8,8480468,James Hamblin,L,EDM,25,0,0,0,0
8,8476907,Mackenzie MacEachern,L,STL,30,0,0,0,0
8,8479543,Michael Pezzetta,L,MTL,26,0,0,0,0
8,8480355,Mark Kastelic,C,OTT,25,0,0,0,0
8,8482162,Roby Jarventie,L,OTT,22,0,0,0,0
8,8479772,Zack MacEwen,R,OTT,28,0,0,0,0
8,8483597,Milos Kelemen,L,ARI,25,0,0,0,0
8,8479379,Givani Smith,R,SJS,26,0,0,0,0
8,8481655,Cole Schwindt,R,CGY,23,0,0,0,0
8,8479981,Jonah Gadjovich,L,FLA,26,0,0,0,0
8,8482147,Jean-Luc Foudy,C,COL,22,0,0,0,0
8,8484255,Jason Polin,R,COL,25,0,0,0,0
8,8477993,Justin Kirkland,C,ARI,28,0,0,0,0
8,8479249,Andrew Poturalski,C,SEA,30,0,0,0,0
8,8482197,Adam Raska,R,MIN,23,0,0,0,0
8,8475780,Chris Wagner,R,COL,33,0,0,0,0
8,8479533,Joona Koppanen,L,PIT,26,0,0,0,0
8,8481534,Raphael Lavoie,C,EDM,24,0,0,0,0
8,8484321,Nikolas Matinpalo,D,OTT,26,0,0,0,0
8,8481043,Cole Koepke,L,TBL,26,0,0,0,0
8,8476323,Max McCormick,L,SEA,32,0,0,0,0
8,8483609,Adam Klapka,R,CGY,24,0,0,0,0
8,8483512,Matt Savoie,C,BUF,20,0,0,0,0
8,8484259,Ondrej Pavel,C,COL,31,0,0,0,0
8,8478147,Bokondji Imama,L,OTT,28,0,0,0,0
8,8482460,Matt Rempe,C,NYR,22,0,0,0,0
8,8477073,Kurtis MacDermid,L,NJD,30,0,0,0,0
8,8480274,Philip Kemp,D,EDM,25,0,0,0,0
8,8478956,Samuel Laberge,L,NJD,27,0,0,0,0
8,8483045,Cameron Butler,R,CBJ,31,0,0,0,0
9,8478402,Connor McDavid,C,EDM,27,82,52,85,137
9,8477956,David Pastrnak,R,BOS,28,82,49,66,115
9,8477492,Nathan MacKinnon,C,COL,29,82,45,68,113
9,8477934,Leon Draisaitl,C,EDM,29,82,36,75,111
9,8476453,Nikita Kucherov,R,TBL,31,82,31,76,107
9,8479314,Matthew Tkachuk,L,FLA,27,82,43,63,106
9,8476887,Filip Forsberg,L,NSH,30,82,48,55,103
9,8478420,Mikko Rantanen,R,COL,28,82,36,62,98
9,8480002,Nico Hischier,C,NJD,25,82,34,57,91
9,8478445,Mathew Barzal,C,NYI,27,82,27,64,91
9,8481559,Jack Hughes,C,NJD,23,82,42,47,89
9,8477942,Kevin Fiala,L,LAK,28,82,30,57,87
9,8474600,Roman Josi,D,NSH,34,82,24,63,87
9,8479318,Auston Matthews,C,TOR,27,82,38,48,86
9,8477493,Aleksander Barkov,C,FLA,29,82,32,54,86
9,8480069,Cale Makar,D,COL,26,82,26,60,86
9,8477404,Jake Guentzel,C,CAR,30,82,35,50,85
9,8477960,Adrian Kempe,R,LAK,28,82,43,40,83
9,8478010,Brayden Point,C,TBL,28,82,43,39,82
9,8480801,Brady Tkachuk,L,OTT,25,82,41,41,82
9,8477946,Dylan Larkin,C,DET,28,82,38,43,81
9,8475172,Nazem Kadri,C,CGY,34,82,29,51,80
9,8480800,Quinn Hughes,D,VAN,25,82,16,64,80
9,8478550,Artemi Panarin,L,NYR,33,82,33,46,79
9,8476460,Mark Scheifele,C,WPG,31,82,26,53,79
9,8480012,Elias Pettersson,C,VAN,26,82,24,55,79
9,8471675,Sidney Crosby,C,PIT,37,82,28,50,78
9,8477402,Pavel Buchnevich,L,STL,29,82,23,55,78
9,8478403,Jack Eichel,C,VGK,28,82,32,45,77
9,8476454,Ryan Nugent-Hopkins,C,EDM,31,82,28,49,77
9,8480023,Robert Thomas,C,STL,25,82,26,51,77
9,8473419,Brad Marchand,L,BOS,36,82,28,47,75
9,8474141,Patrick Kane,R,DET,36,82,26,49,75
9,8475166,John Tavares,C,TOR,34,82,29,45,74
9,8477409,Carter Verhaeghe,C,FLA,29,82,27,47,74
9,8476456,Jonathan Huberdeau,C,CGY,31,82,17,56,73
9,8478407,Vince Dunn,D,SEA,28,82,14,59,73
9,8478427,Sebastian Aho,C,CAR,27,82,25,47,72
9,8479407,Jesper Bratt,L,NJD,26,82,24,48,72
9,8471685,Anze Kopitar,C,LAK,37,82,11,61,72
9,8474564,Steven Stamkos,C,TBL,34,82,37,34,71
9,8479385,Jordan Kyrou,C,STL,26,82,34,37,71
9,8482116,Tim Stützle,C,OTT,22,82,29,41,70
9,8471215,Evgeni Malkin,C,PIT,38,82,26,44,70
9,8477949,Alex Tuch,R,BUF,28,82,23,46,69
9,8478444,Brock Boeser,R,VAN,27,82,34,34,68
9,8480036,Miro Heiskanen,D,DAL,25,82,16,52,68
9,8478398,Kyle Connor,L,WPG,28,82,34,33,67
9,8471214,Alex Ovechkin,L,WSH,39,82,33,34,67
9,8478864,Kirill Kaprizov,L,MIN,27,82,30,37,67
9,8481557,Matt Boldy,L,MIN,23,82,25,42,67
9,8478414,Timo Meier,R,NJD,28,82,31,35,66
9,8476468,J.T. Miller,C,VAN,31,82,29,37,66
9,8477939,William Nylander,R,TOR,28,82,29,37,66
9,8480027,Jason Robertson,L,DAL,25,82,28,38,66
9,8478042,Viktor Arvidsson,R,LAK,31,82,26,40,66
9,8482684,Luke Hughes,D,NJD,21,82,13,53,66
9,8480188,Fabian Zetterlund,L,SJS,25,82,36,29,65
9,8478439,Travis Konecny,R,PHI,27,82,32,33,65
9,8475158,Ryan O'Reilly,C,NSH,33,82,26,39,65
9,8482093,Seth Jarvis,C,CAR,22,82,24,41,65
9,8475798,Mikael Granlund,C,SJS,32,82,23,42,65
9,8475184,Chris Kreider,L,NYR,33,82,34,30,64
9,8477501,Valeri Nichushkin,R,COL,29,82,34,30,64
9,8478449,Roope Hintz,C,DAL,28,82,32,32,64
9,8480865,Noah Dobson,D,NYI,24,82,14,50,64
9,8479325,Charlie McAvoy,D,BOS,27,82,13,51,64
9,8477476,Artturi Lehkonen,L,COL,29,82,31,32,63
9,8477933,Sam Reinhart,C,FLA,29,82,26,37,63
9,8479343,Clayton Keller,R,ARI,26,82,24,39,63
9,8480039,Martin Necas,C,CAR,25,82,23,40,63
9,8480803,Evan Bouchard,D,EDM,25,82,16,47,63
9,8481540,Cole Caufield,R,MTL,23,82,35,27,62
9,8482665,Matty Beniers,C,SEA,22,82,28,34,62
9,8481528,Dylan Cozens,C,BUF,23,82,25,37,62
9,8479337,Alex DeBrincat,R,DET,27,82,21,41,62
9,8475810,Bryan Rust,R,PIT,32,82,30,31,61
9,8474679,Gustav Nyquist,C,NSH,35,82,17,44,61
9,8475692,Mats Zuccarello,R,MIN,37,82,12,49,61
9,8475786,Zach Hyman,L,EDM,32,82,35,25,60
9,8476459,Mika Zibanejad,C,NYR,31,82,27,33,60
9,8480018,Nick Suzuki,C,MTL,25,82,24,36,60
9,8477940,Nikolaj Ehlers,L,WPG,28,82,22,38,60
9,8475167,Victor Hedman,D,TBL,34,82,10,50,60
9,8481523,Kirby Dach,C,MTL,23,82,9,51,60
9,8481068,Yegor Sharangovich,C,CGY,26,82,35,24,59
9,8479400,Pierre-Luc Dubois,L,LAK,26,82,29,30,59
9,8475726,Tyler Toffoli,C,WPG,32,82,27,32,59
9,8479339,Patrik Laine,L,CBJ,26,82,26,33,59
9,8470794,Joe Pavelski,C,DAL,40,82,20,39,59
9,8475765,Vladimir Tarasenko,R,FLA,33,82,20,39,59
9,8473994,Jamie Benn,L,DAL,35,82,17,42,59
9,8477447,Shea Theodore,D,VGK,29,82,11,48,59
9,8477497,Sean Monahan,C,WPG,30,82,28,30,58
9,8482097,Jack Quinn,R,BUF,23,82,24,34,58
9,8480830,Andrei Svechnikov,R,CAR,24,82,23,35,58
9,8479410,Mikhail Sergachev,D,TBL,26,82,12,46,58
9,8479420,Tage Thompson,C,BUF,27,82,29,28,57
9,8475784,Jeff Skinner,C,BUF,32,82,27,30,57
9,8479542,Brandon Hagel,L,TBL,26,82,26,31,57
9,8477986,Brandon Montour,D,FLA,30,82,23,34,57
9,8481711,Matias Maccelli,L,ARI,24,82,23,34,57
9,8483808,Andrei Kuzmenko,L,CGY,28,82,20,37,57
9,8476389,Vincent Trocheck,C,NYR,31,82,18,39,57
9,8478047,Michael Bunting,L,PIT,29,82,18,39,57
9,8476448,William Karlsson,C,VGK,31,82,18,39,57
9,8479323,Adam Fox,D,NYR,26,82,10,47,57
9,8471724,Kris Letang,D,PIT,37,82,9,48,57
9,8478493,Joel Eriksson Ek,C,MIN,27,82,34,22,56
9,8475913,Mark Stone,R,VGK,32,82,26,30,56
9,8475794,Tyler Seguin,C,DAL,32,82,24,32,56
9,8479675,Trevor Moore,L,LAK,29,82,23,33,56
9,8478401,Pavel Zacha,C,BOS,27,82,19,37,56
9,8476462,Dougie Hamilton,D,NJD,31,82,17,39,56
9,8473512,Claude Giroux,R,OTT,36,82,20,35,55
9,8476346,Johnny Gaudreau,L,CBJ,31,82,19,36,55
9,8480208,Drake Batherson,R,OTT,26,82,18,37,55
9,8479999,Casey Mittelstadt,C,COL,26,82,16,39,55
9,8481699,Aku Raty,R,ARI,23,82,4,51,55
9,8478498,Jake DeBrusk,L,BOS,28,82,24,30,54
9,8475745,Charlie Coyle,C,BOS,32,82,15,39,54
9,8477504,Josh Morrissey,D,WPG,29,82,11,43,54
9,8474578,Erik Karlsson,D,PIT,34,82,9,45,54
9,8482078,Lucas Raymond,L,DET,22,82,28,25,53
9,8475754,Brock Nelson,C,NYI,33,82,26,27,53
9,8478975,Mason Marchment,L,DAL,29,82,17,36,53
9,8474037,James van Riemsdyk,L,BOS,35,82,17,36,53
9,8476881,Tomas Hertl,C,VGK,31,82,25,27,52
9,8476539,Jonathan Marchessault,R,VGK,34,82,25,27,52
9,8482740,Wyatt Johnston,C,DAL,21,82,25,27,52
9,8477951,Nick Schmaltz,C,ARI,28,82,19,33,52
9,8478460,Zach Werenski,D,CBJ,27,82,9,43,52
9,8474590,John Carlson,D,WSH,34,82,8,44,52
9,8480014,Gabriel Vilardi,C,WPG,25,82,35,16,51
9,8477496,Elias Lindholm,C,VAN,30,82,19,32,51
9,8477416,Oliver Bjorkstrand,R,SEA,29,82,15,36,51
9,8476853,Morgan Rielly,D,TOR,30,82,14,37,51
9,8482105,Jake Sanderson,D,OTT,22,82,12,39,51
9,8477955,Jared McCann,L,SEA,28,82,28,22,50
9,8476479,Phillip Danault,C,LAK,31,82,26,24,50
9,8477935,Sam Bennett,C,FLA,28,82,24,26,50
9,8478873,Troy Terry,R,ANA,27,82,23,27,50
9,8480839,Rasmus Dahlin,D,BUF,24,82,11,39,50
9,8478856,Conor Garland,R,VAN,28,82,21,28,49
9,8478438,Tommy Novak,C,NSH,27,82,17,32,49
9,8478396,Noah Hanifin,D,VGK,27,82,8,41,49
9,8477451,Ryan Hartman,R,MIN,30,82,22,26,48
9,8481596,Shane Pinto,C,OTT,24,82,20,28,48
9,8475170,Brayden Schenn,C,STL,33,82,19,29,48
9,8477444,Andre Burakovsky,L,SEA,29,82,15,33,48
9,8476329,Travis Boyd,C,ARI,31,82,13,35,48
9,8477503,Max Domi,C,TOR,29,82,11,37,48
9,8476483,Rickard Rakell,R,PIT,31,82,25,22,47
9,8475169,Evander Kane,L,EDM,33,82,22,25,47
9,8478542,Evan Rodrigues,C,FLA,31,82,22,25,47
9,8476399,Blake Coleman,C,CGY,33,82,20,27,47
9,8478440,Dylan Strome,C,WSH,27,82,16,31,47
9,8479987,Morgan Geekie,C,BOS,26,82,16,31,47
9,8477426,Nicholas Paul,L,TBL,29,82,15,32,47
9,8475287,Erik Haula,L,NJD,33,82,25,21,46
9,8475791,Taylor Hall,L,CHI,33,82,24,22,46
9,8473986,Alex Killorn,L,ANA,35,82,19,27,46
9,8474102,David Perron,L,DET,36,82,15,31,46
9,8470613,Brent Burns,D,CAR,39,82,12,34,46
9,8481542,Moritz Seider,D,DET,23,82,7,39,46
9,8475764,Cam Fowler,D,ANA,33,82,5,41,46
9,8482745,Mason McTavish,C,ANA,21,82,22,23,45
9,8477964,Ivan Barbashev,C,VGK,29,82,18,27,45
9,8481533,Trevor Zegras,C,ANA,23,82,18,27,45
9,8480078,Filip Chytil,C,NYR,25,82,17,28,45
9,8475168,Matt Duchene,C,DAL,33,82,16,29,45
9,8477495,Seth Jones,D,CHI,30,82,9,36,45
9,8479996,Cody Glass,C,NSH,25,82,25,19,44
9,8479525,Ross Colton,C,COL,28,82,22,22,44
9,8481624,Ilya Mikheyev,R,VAN,30,82,21,23,44
9,8477429,Andrew Copp,C,DET,30,82,21,23,44
9,8482146,Luke Evangelista,R,NSH,22,82,19,25,44
9,8477021,Alex Kerfoot,C,ARI,30,82,16,28,44
9,8471698,T.J. Oshie,R,WSH,38,82,16,28,44
9,8474641,Adam Henrique,C,EDM,34,82,15,29,44
9,8474586,Jordan Eberle,R,SEA,34,82,13,31,44
9,8479425,Filip Hronek,D,VAN,27,82,11,33,44
9,8477494,Jonathan Drouin,L,COL,29,82,11,33,44
9,8480031,Maxime Comtois,L,CAR,25,82,9,35,44
9,8475760,Nick Bjugstad,C,ARI,32,82,20,23,43
9,8478458,Jack Roslovic,C,NYR,27,82,17,26,43
9,8480893,Kirill Marchenko,R,CBJ,24,82,17,26,43
9,8482175,JJ Peterka,R,BUF,22,82,17,26,43
9,8480798,Philipp Kurashev,C,CHI,25,82,15,28,43
9,8476458,Ryan Strome,C,ANA,31,82,12,31,43
9,8476826,Yanni Gourde,C,SEA,33,82,12,31,43
9,8476882,Teuvo Teravainen,L,CAR,30,82,11,32,43
9,8483471,Brad Lambert,C,WPG,31,82,3,40,43
9,8483397,Marc McLaughlin,C,BOS,25,82,37,5,42
9,8475768,Jaden Schwartz,C,SEA,32,82,22,20,42
9,8478233,Andrew Mangiapane,L,CGY,28,82,21,21,42
9,8477500,Bo Horvat,C,NYI,29,82,18,24,42
9,8478462,Nicolas Roy,C,VGK,27,82,17,25,42
9,8482109,Alexis Lafrenière,L,NYR,23,82,17,25,42
9,8471218,Blake Wheeler,R,NYR,38,82,17,25,42
9,8482222,Alexander Barabanov,L,SJS,30,82,16,26,42
9,8476905,Chandler Stephenson,C,VGK,30,82,11,31,42
9,8476906,Shayne Gostisbehere,D,DET,31,82,5,37,42
9,8484203,Bradly Nadeau,L,CAR,19,82,34,7,41
9,8482089,Jake Neighbours,L,STL,22,82,31,10,41
9,8480064,Josh Norris,C,OTT,25,82,28,13,41
9,8480009,Eeli Tolvanen,R,SEA,25,82,24,17,41
9,8482699,Dylan Guenther,R,ARI,21,82,23,18,41
9,8482055,Drew O'Connor,L,PIT,26,82,22,19,41
9,8476432,Boone Jenner,C,CBJ,31,82,13,28,41
9,8482671,Owen Power,D,BUF,22,82,12,29,41
9,8475151,Kyle Palmieri,C,NYI,33,82,20,20,40
9,8482702,Logan Stankoven,C,DAL,21,82,16,24,40
9,8483445,Cutter Gauthier,L,ANA,20,82,11,29,40
9,8480871,Adam Boqvist,D,CBJ,24,82,8,32,40
9,8474157,Max Pacioretty,L,WSH,36,82,24,15,39
9,8478366,Frank Vatrano,R,ANA,30,82,23,16,39
9,8475191,Reilly Smith,R,PIT,33,82,19,20,39
9,8474150,Mikael Backlund,C,CGY,35,82,17,22,39
9,8478463,Anthony Beauvillier,L,NSH,27,82,17,22,39
9,8482124,Quinton Byfield,R,LAK,22,82,15,24,39
9,8484144,Connor Bedard,C,CHI,19,82,14,25,39
9,8476792,Torey Krug,D,STL,33,82,13,26,39
9,8482133,Thomas Bordeleau,C,SJS,22,82,8,31,39
9,8474563,Drew Doughty,D,LAK,35,82,8,31,39
9,8474565,Alex Pietrangelo,D,VGK,34,82,8,31,39
9,8478038,Devon Toews,D,COL,30,82,6,33,39
9,8478397,Rasmus Andersson,D,CGY,28,82,6,33,39
9,8475722,Jason Zucker,L,NSH,32,82,17,21,38
9,8475763,Kevin Hayes,R,STL,32,82,16,22,38
9,8477456,J.T. Compher,L,DET,29,82,15,23,38
9,8479365,Trent Frederic,C,BOS,26,82,15,23,38
9,8476292,Ondrej Palat,L,NJD,33,82,14,24,38
9,8477498,Darnell Nurse,D,EDM,29,82,13,25,38
9,8479423,Alex Nylander,L,CBJ,26,82,23,14,37
9,8477479,Tyler Bertuzzi,L,TOR,29,82,20,17,37
9,8482110,Dawson Mercer,C,NJD,23,82,19,18,37
9,8480028,Morgan Frost,C,PHI,25,82,18,19,37
9,8481560,Arthur Kaliyev,R,LAK,23,82,17,20,37
9,8482113,Anton Lundell,C,FLA,23,82,16,21,37
9,8476438,Brandon Saad,L,STL,32,82,15,22,37
9,8474149,Evgenii Dadonov,R,DAL,35,82,15,22,37
9,8475799,Nino Niederreiter,R,WPG,32,82,14,23,37
9,8476392,Adam Lowry,C,WPG,31,82,14,23,37
9,8476875,Mike Matheson,D,MTL,30,82,13,24,37
9,8481546,Cam York,D,PHI,23,82,6,31,37
9,8478055,Gustav Forsling,D,FLA,28,82,6,31,37
9,8478474,Lawson Crouse,L,ARI,27,82,24,12,36
9,8483431,Logan Cooley,C,ARI,20,82,24,12,36
9,8478466,Daniel Sprong,R,DET,27,82,23,13,36
9,8482159,Tyson Foerster,R,PHI,22,82,18,18,36
9,8476960,Andreas Athanasiou,C,CHI,30,82,18,18,36
9,8482074,Connor Zary,C,CGY,23,82,17,19,36
9,8483515,Juraj Slafkovsky,L,MTL,20,82,16,20,36
9,8478519,Anthony Cirelli,C,TBL,27,82,14,22,36
9,8475714,Calle Jarnkrok,C,TOR,33,82,14,22,36
9,8481704,Juuso Parssinen,C,NSH,23,82,14,22,36
9,8475793,Ryan Johansen,C,PHI,32,82,13,23,36
9,8475744,Evgeny Kuznetsov,C,CAR,32,82,9,27,36
9,8477969,Marcus Pettersson,D,PIT,28,82,6,30,36
9,8481656,Aliaksei Protas,C,WSH,23,82,5,31,36
9,8482101,Danil Gushchin,L,SJS,22,82,23,12,35
9,8476921,Jordan Martinook,L,CAR,32,82,20,15,35
9,8481535,Nils Hoglander,L,VAN,24,82,16,19,35
9,8477952,Robby Fabbri,C,DET,28,82,16,19,35
9,8481618,Alex Newhook,C,MTL,23,82,13,22,35
9,8476958,Jaccob Slavin,D,CAR,30,82,11,24,35
9,8476869,Brady Skjei,D,CAR,30,82,9,26,35
9,8475753,Justin Faulk,D,STL,32,82,8,27,35
9,8476854,Hampus Lindholm,D,BOS,30,82,7,28,35
9,8478508,Yakov Trenin,C,COL,27,82,21,13,34
9,8480015,Owen Tippett,R,PHI,25,82,20,14,34
9,8484166,Adam Fantilli,C,CBJ,20,82,20,14,34
9,8479415,Michael McLeod,C,NJD,26,82,16,18,34
9,8480855,Jack McBain,C,ARI,24,82,14,20,34
9,8480802,Ryan McLeod,C,EDM,25,82,11,23,34
9,8482720,Matthew Knies,L,TOR,22,82,10,24,34
9,8477932,Aaron Ekblad,D,FLA,28,82,9,25,34
9,8475218,Mattias Ekholm,D,EDM,34,82,9,25,34
9,8478469,Thomas Chabot,D,OTT,27,82,7,27,34
9,8481093,Rafael Harvey-Pinard,L,MTL,25,82,18,15,33
9,8476419,Jean-Gabriel Pageau,C,NYI,32,82,16,17,33
9,8483505,Matthew Poitras,C,BOS,20,82,14,19,33
9,8481013,Jonatan Berggren,R,DET,24,82,9,24,33
9,8480434,Sean Durzi,D,ARI,26,82,8,25,33
9,8475197,Tyson Barrie,D,NSH,33,82,3,30,33
9,8476463,Jonas Brodin,D,MIN,31,82,3,30,33
9,8482145,Mavrik Bourque,C,DAL,22,82,23,9,32
9,8480821,Filip Zadina,R,SJS,25,82,20,12,32
9,8483499,Liam Ohgren,L,MIN,20,82,20,12,32
9,8474189,Lars Eller,C,PIT,35,82,19,13,32
9,8477944,Jakub Vrana,L,STL,28,82,18,14,32
9,8477425,Miles Wood,L,COL,29,82,17,15,32
9,8480849,Barrett Hayton,C,ARI,24,82,17,15,32
9,8476880,Tom Wilson,R,WSH,30,82,15,17,32
9,8470621,Corey Perry,R,EDM,39,82,15,17,32
9,8476873,Mark Jankowski,C,NSH,30,82,15,17,32
9,8478046,Danton Heinen,L,BOS,29,82,14,18,32
9,8477511,Anthony Mantha,R,VGK,30,82,12,20,32
9,8480817,K'Andre Miller,D,NYR,24,82,9,23,32
9,8480113,Alex Iafallo,L,WPG,31,82,8,24,32
9,8477346,MacKenzie Weegar,D,CGY,30,82,7,25,32
9,8481703,Valtteri Puustinen,R,PIT,25,82,7,25,32
9,8476429,Scott Mayfield,D,NYI,32,82,5,27,32
9,8481016,Ruslan Iskhakov,C,NYI,24,82,4,28,32
9,8475314,Anders Lee,L,NYI,34,82,19,12,31
9,8481186,Logan O'Connor,R,COL,28,82,19,12,31
9,8477407,Anthony Duclair,L,TBL,29,82,15,16,31
9,8479514,Rem Pitlick,C,CHI,27,82,14,17,31
9,8482624,Daniil Miromanov,D,CGY,27,82,12,19,31
9,8480459,Pius Suter,C,VAN,28,82,12,19,31
9,8476923,Damon Severson,D,CBJ,30,82,8,23,31
9,8476927,Teddy Blueger,C,VAN,30,82,8,23,31
9,8476892,Colton Parayko,D,STL,31,82,7,24,31
9,8481606,Jordan Spence,D,LAK,23,82,7,24,31
9,8478472,Mathieu Joseph,R,OTT,27,82,6,25,31
9,8477948,Travis Sanheim,D,PHI,28,82,6,25,31
9,8479398,Samuel Girard,D,COL,26,82,4,27,31
9,8483457,Lane Hutson,D,MTL,20,82,2,29,31
9,8470610,Zach Parise,L,COL,40,82,19,11,30
9,8474053,Logan Couture,C,SJS,35,82,14,16,30
9,8482475,Yegor Chinakhov,R,CBJ,23,82,12,18,30
9,8480145,Neal Pionk,D,WPG,29,82,11,19,30
9,8482667,William Eklund,L,SJS,22,82,7,23,30
9,8478500,Ivan Provorov,D,CBJ,27,82,7,23,30
9,8476312,Josh Manson,D,COL,33,82,7,23,30
9,8479977,Kailer Yamamoto,R,SEA,26,82,18,11,29
9,8482079,Marco Rossi,C,MIN,23,82,17,12,29
9,8479346,Dillon Dube,C,CGY,26,82,17,12,29
9,8476925,Colton Sissons,C,NSH,31,82,15,14,29
9,8478891,Mason Appleton,C,WPG,28,82,14,15,29
9,8477989,Christian Dvorak,C,MTL,28,82,14,15,29
9,8474884,Mike Hoffman,C,SJS,35,82,14,15,29
9,8476872,Scott Laughton,C,PHI,30,82,12,17,29
9,8478013,Jake Walman,D,DET,28,82,12,17,29
9,8473449,Kyle Okposo,R,FLA,36,82,11,18,29
9,8479345,Jakob Chychrun,D,OTT,26,82,9,20,29
9,8481581,Thomas Harley,D,DAL,23,82,9,20,29
9,8482705,Cole Sillinger,C,CBJ,21,82,8,21,29
9,8477919,Frederick Gaudreau,C,MIN,31,82,8,21,29
9,8476931,Jake McCabe,D,TOR,31,82,8,21,29
9,8475906,John Klingberg,D,TOR,32,82,5,24,29
9,8475181,Nick Leddy,D,STL,33,82,3,26,29
9,8481604,Pavel Dorofeyev,L,VGK,24,82,20,8,28
9,8476981,Josh Anderson,R,MTL,30,82,18,10,28
9,8481554,Kaapo Kakko,R,NYR,23,82,13,15,28
9,8477839,Conor Sheary,L,TBL,32,82,13,15,28
9,8480797,Joel Farabee,L,PHI,24,82,12,16,28
9,8480185,Eetu Luostarinen,C,FLA,26,82,12,16,28
9,8481580,Connor McMichael,C,WSH,23,82,12,16,28
9,8477947,Sonny Milano,L,WSH,28,82,12,16,28
9,8479351,Sam Steel,C,DAL,26,82,9,19,28
9,8480796,Martin Fehervary,D,WSH,25,82,9,19,28
9,8482122,Brock Faber,D,MIN,22,82,6,22,28
9,8475690,Chris Tanev,D,DAL,35,82,6,22,28
9,8478911,Matt Roy,D,LAK,29,82,4,24,28
9,8474151,Ryan McDonagh,D,NSH,35,82,3,25,28
9,8477353,Tyler Motte,C,TBL,29,82,15,12,27
9,8476469,Joel Armia,R,MTL,31,82,14,13,27
9,8480813,Joe Veleno,C,DET,24,82,14,13,27
9,8475220,Marcus Foligno,L,MIN,33,82,12,15,27
9,8482092,Ridly Greig,C,OTT,22,82,12,15,27
9,8477505,Alexander Wennberg,C,NYR,30,82,12,15,27
9,8480220,Noah Cates,L,PHI,25,82,11,16,27
9,8478851,Alexandre Carrier,D,NSH,28,82,11,16,27
9,8479390,Taylor Raddysh,R,CHI,26,82,10,17,27
9,8482142,Jamie Drysdale,D,PHI,22,82,6,21,27
9,8476917,Adam Pelech,D,NYI,30,82,6,21,27
9,8480448,Parker Kelly,L,OTT,25,82,6,21,27
9,8475171,Oliver Ekman-Larsson,D,FLA,33,82,5,22,27
9,8477953,Kasperi Kapanen,R,STL,28,82,5,22,27
9,8476891,Matt Grzelcyk,D,BOS,30,82,5,22,27
9,8480873,Rasmus Sandin,D,WSH,24,82,4,23,27
9,8480246,Nick Perbix,D,TBL,26,82,3,24,27
9,8480860,Kevin Bahl,D,NJD,24,82,3,24,27
9,8475848,Brendan Gallagher,R,MTL,32,82,14,12,26
9,8478020,Michael Amadio,C,VGK,28,82,14,12,26
9,8479353,Brett Howden,C,VGK,26,82,12,14,26
9,8482166,Shakir Mukhamadullin,D,SJS,22,82,10,16,26
9,8478430,Oliver Kylington,D,CGY,27,82,10,16,26
9,8475149,Marcus Johansson,L,MIN,34,82,9,17,26
9,8476480,Vladislav Namestnikov,C,WPG,32,82,8,18,26
9,8475200,Dmitry Orlov,D,CAR,33,82,7,19,26
9,8478178,Darren Raddysh,D,TBL,28,82,6,20,26
9,8480035,Henri Jokiharju,D,BUF,25,82,6,20,26
9,8477506,Ryan Pulock,D,NYI,30,82,4,22,26
9,8482733,Logan Mailloux,D,MTL,31,82,2,24,26
9,8483524,Shane Wright,C,SEA,20,82,18,7,25
9,8478115,Pierre Engvall,L,NYI,28,82,11,14,25
9,8479941,Justin Danforth,R,CBJ,31,82,11,14,25
9,8473422,Nick Foligno,L,CHI,37,82,11,14,25
9,8484153,Leo Carlsson,C,ANA,20,82,11,14,25
9,8476897,Oskar Sundqvist,C,STL,30,82,9,16,25
9,8484145,Zach Benson,L,BUF,19,82,9,16,25
9,8482125,Alexander Holtz,R,NJD,22,82,8,17,25
9,8480043,Timothy Liljegren,D,TOR,25,82,5,20,25
9,8474673,TJ Brodie,D,TOR,34,82,4,21,25
9,8476979,Erik Gustafsson,D,NYR,32,82,1,24,25
9,8480980,Connor Dewar,C,TOR,25,82,16,8,24
9,8470604,Jeff Carter,C,PIT,39,82,15,9,24
9,8478043,Sam Lafferty,C,VAN,29,82,13,11,24
9,8482737,Zack Bolduc,C,STL,21,82,13,11,24
9,8476278,Colin Blackwell,C,CHI,31,82,12,12,24
9,8478413,Jordan Greenway,L,BUF,27,82,12,12,24
9,8478109,Victor Olofsson,L,BUF,29,82,11,13,24
9,8481522,Peyton Krebs,C,BUF,23,82,10,14,24
9,8474870,Tyler Johnson,C,CHI,34,82,8,16,24
9,8482111,Justin Barron,D,MTL,23,82,8,16,24
9,8479316,Luke Kunin,C,SJS,27,82,7,17,24
9,8475164,Jakob Silfverberg,R,ANA,34,82,7,17,24
9,8479371,Dante Fabbro,D,NSH,26,82,7,17,24
9,8476525,Colin Miller,D,WPG,32,82,6,18,24
9,8476885,Jacob Trouba,D,NYR,30,82,5,19,24
9,8478133,Jake Evans,C,MTL,28,82,4,20,24
9,8482712,Oskar Olausson,R,COL,22,82,4,20,24
9,8473507,Jeff Petry,D,DET,37,82,4,20,24
9,8479369,Andrew Peeke,D,BOS,26,82,2,22,24
9,8478569,Noel Acciari,C,PIT,33,82,13,10,23
9,8479591,Michael Eyssimont,C,TBL,28,82,11,12,23
9,8477998,Warren Foegele,L,EDM,28,82,10,13,23
9,8479293,Brandon Tanev,L,SEA,33,82,10,13,23
9,8483490,Pavel Mintyukov,D,ANA,21,82,10,13,23
9,8481014,Alexander Romanov,D,NYI,24,82,9,14,23
9,8479998,Mikey Anderson,D,LAK,25,82,4,19,23
9,8478136,Jake Middleton,D,MIN,28,82,2,21,23
9,8477450,Jason Dickinson,C,CHI,29,82,12,10,22
9,8480144,David Kampf,C,TOR,29,82,10,12,22
9,8481477,Nico Sturm,C,SJS,29,82,10,12,22
9,8482117,Lukas Reichel,L,CHI,22,82,9,13,22
9,8480068,Ryan Poehling,C,PHI,25,82,9,13,22
9,8478057,Dakota Joshua,C,VAN,28,82,8,14,22
9,8474034,Pat Maroon,L,BOS,36,82,8,14,22
9,8475179,Dmitry Kulikov,D,FLA,34,82,5,17,22
9,8477845,Trevor van Riemsdyk,D,WSH,33,82,3,19,22
9,8474716,Jared Spurgeon,D,MIN,35,82,2,20,22
9,8481567,Henry Thrun,D,SJS,23,82,2,20,22
9,8476374,Sean Kuraly,C,CBJ,31,82,13,8,21
9,8482809,Jackson Blake,R,CAR,21,82,12,9,21
9,8482730,Brandt Clarke,D,LAK,21,82,11,10,21
9,8479992,Michael Rasmussen,C,DET,25,82,10,11,21
9,8482155,Alex Laferriere,R,LAK,23,82,10,11,21
9,8478451,Ethan Bear,D,WSH,27,82,8,13,21
9,8477499,Rasmus Ristolainen,D,PHI,30,82,6,15,21
9,8482679,Matt Coronato,R,CGY,22,82,5,16,21
9,8475790,Erik Gudbranson,D,CBJ,32,82,5,16,21
9,8484911,Collin Graf,R,SJS,22,82,5,16,21
9,8480336,Sean Walker,D,COL,30,82,4,17,21
9,8478507,John Marino,D,NJD,27,82,4,17,21
9,8476879,Cody Ceci,D,EDM,31,82,3,18,21
9,8476467,Jamie Oleksiak,D,SEA,32,82,1,20,21
9,8483491,Ivan Miroshnichenko,L,WSH,20,82,12,8,20
9,8479661,Tanner Jeannot,L,TBL,27,82,12,8,20
9,8481517,Brett Leason,R,ANA,25,82,11,9,20
9,8476461,Sean Couturier,C,PHI,32,82,10,10,20
9,8476442,Matt Nieto,L,PIT,32,82,8,12,20
9,8473533,Jordan Staal,C,CAR,36,82,7,13,20
9,8478840,Will Borgen,D,SEA,28,82,6,14,20
9,8477488,Brett Pesce,D,CAR,30,82,6,14,20
9,8476331,Dylan DeMelo,D,WPG,31,82,5,15,20
9,8482073,Braden Schneider,D,NYR,23,82,5,15,20
9,8475188,Brayden McNabb,D,VGK,33,82,5,15,20
9,8479976,Juuso Valimaki,D,ARI,26,82,4,16,20
9,8475208,Brian Dumoulin,D,SEA,33,82,4,16,20
9,8480058,Pierre-Olivier Joseph,D,PIT,25,82,3,17,20
9,8475324,Nick Jensen,D,WSH,34,82,2,18,20
9,8481553,Bobby Brink,R,PHI,23,82,11,8,19
9,8481601,Simon Holmstrom,R,NYI,23,82,10,9,19
9,8480281,Alexey Toropchenko,R,STL,25,82,10,9,19
9,8473563,Nicklas Backstrom,C,WSH,37,82,8,11,19
9,8475343,Nic Dowd,C,WSH,34,82,8,11,19
9,8479980,Nicolas Hague,D,VGK,26,82,8,11,19
9,8480074,Alexandre Texier,C,CBJ,25,82,7,12,19
9,8482087,Kaiden Guhle,D,MTL,22,82,5,14,19
9,8476902,Esa Lindell,D,DAL,30,82,5,14,19
9,8476871,Tanner Pearson,L,MTL,32,82,5,14,19
9,8478416,Erik Cernak,D,TBL,27,82,5,14,19
9,8478408,Travis Dermott,D,ARI,28,82,5,14,19
9,8477335,Kyle Burroughs,D,SJS,29,82,5,14,19
9,8476457,Adam Larsson,D,SEA,32,82,4,15,19
9,8474574,Tyler Myers,D,VAN,34,82,4,15,19
9,8475455,Brenden Dillon,D,WPG,34,82,4,15,19
9,8482655,J.J. Moser,D,ARI,24,82,3,16,19
9,8478859,Niko Mikkola,D,FLA,28,82,2,17,19
9,8482118,Sam Colangelo,R,ANA,23,82,17,1,18
9,8474715,Cam Atkinson,R,PHI,35,82,10,8,18
9,8481028,Martin Pospisil,C,CGY,25,82,9,9,18
9,8482062,Cole Smith,L,NSH,29,82,8,10,18
9,8473504,Cal Clutterbuck,R,NYI,37,82,8,10,18
9,8474009,Nick Bonino,C,NYR,36,82,8,10,18
9,8481481,Blake Lizotte,C,LAK,27,82,7,11,18
9,8475231,Casey Cizikas,C,NYI,33,82,7,11,18
9,8475825,Jani Hakanpää,D,DAL,32,82,6,12,18
9,8477435,Ryan Graves,D,PIT,29,82,4,14,18
9,8480807,Mattias Samuelsson,D,BUF,24,82,3,15,18
9,8482470,Ilya Solovyov,D,CGY,24,82,3,15,18
9,8479983,Mario Ferraro,D,SJS,26,82,2,16,18
9,8481568,Alex Vlasic,D,CHI,23,82,2,16,18
9,8483466,Kevin Korchinski,D,CHI,20,82,2,16,18
9,8480834,Ty Emberson,D,SJS,24,82,0,18,18
9,8483493,Frank Nazar,C,CHI,20,82,13,4,17
9,8479393,Noah Gregor,C,TOR,26,82,10,7,17
9,8477392,Hudson Fasching,R,NYI,29,82,10,7,17
9,8482259,Bobby McMann,C,TOR,28,82,10,7,17
9,8477508,Curtis Lazar,C,NJD,29,82,9,8,17
9,8475177,Calvin de Haan,D,TBL,33,82,8,9,17
9,8482666,Scott Morrow,D,CAR,22,82,7,10,17
9,8477365,Connor Clifton,D,BUF,29,82,4,13,17
9,8481524,Bowen Byram,D,BUF,23,82,3,14,17
9,8481605,Jackson LaCombe,D,ANA,23,82,3,14,17
9,8482803,Olen Zellweger,D,ANA,21,82,2,15,17
9,8481178,Egor Zamula,D,PHI,24,82,2,15,17
9,8479359,Beck Malenstyn,L,WSH,26,82,12,4,16
9,8477507,Nikita Zadorov,D,VAN,29,82,8,8,16
9,8474567,Zach Bogosian,D,MIN,34,82,6,10,16
9,8476624,Barclay Goodrow,C,NYR,31,82,6,10,16
9,8479324,Ryan Lindgren,D,NYR,26,82,5,11,16
9,8481059,Scott Perunovich,D,STL,26,82,4,12,16
9,8480073,Erik Brannstrom,D,OTT,25,82,3,13,16
9,8475233,David Savard,D,MTL,34,82,3,13,16
9,8475462,Radko Gudas,D,ANA,34,82,2,14,16
9,8470600,Ryan Suter,D,DAL,39,82,2,14,16
9,8477406,Mattias Janmark,C,EDM,32,82,8,7,15
9,8483565,Nick Blankenburg,D,CBJ,26,82,7,8,15
9,8475842,Sam Carrick,C,EDM,32,82,7,8,15
9,8476422,Mike Reilly,D,NYI,31,82,6,9,15
9,8473453,Trevor Lewis,C,LAK,37,82,5,10,15
9,8478831,Kevin Stenlund,C,FLA,28,82,5,10,15
9,8483495,Simon Nemec,D,NJD,20,82,5,10,15
9,8471677,Jack Johnson,D,COL,37,82,5,10,15
9,8480806,Isac Lundestrom,C,ANA,25,82,4,11,15
9,8479291,Kevin Rooney,C,CGY,31,82,4,11,15
9,8483468,Jiri Kulich,C,BUF,20,82,4,11,15
9,8470966,Mark Giordano,D,TOR,41,82,4,11,15
9,8476858,Phillip Di Giuseppe,L,VAN,31,82,9,5,14
9,8477330,Dominik Kubalik,L,OTT,29,82,8,6,14
9,8482762,Simon Edvinsson,D,DET,21,82,7,7,14
9,8477015,Connor Brown,R,EDM,30,82,7,7,14
9,8477369,Carson Soucy,D,VAN,30,82,6,8,14
9,8478399,Jonas Siegenthaler,D,NJD,27,82,5,9,14
9,8476822,Luke Glendening,C,TBL,35,82,5,9,14
9,8482177,Marat Khusnutdinov,C,MIN,22,82,5,9,14
9,8478882,Vladislav Gavrikov,D,LAK,29,82,3,11,14
9,8482245,Artem Zub,D,OTT,29,82,3,11,14
9,8476372,Nick Seeler,D,PHI,31,82,3,11,14
9,8481537,Nikita Okhotiuk,D,CGY,24,82,2,12,14
9,8476967,Brett Kulak,D,EDM,30,82,2,12,14
9,8475279,Ben Chiarot,D,DET,33,82,1,13,14
9,8483012,Logan Morrison,C,SEA,22,82,6,7,13
9,8482858,Ryker Evans,D,SEA,23,82,3,10,13
9,8482516,Matthew Kessel,D,STL,24,82,2,11,13
9,8481030,Jack St. Ivany,D,PIT,25,82,2,11,13
9,8479442,Troy Stecher,D,EDM,30,82,1,12,13
9,8474013,Ian Cole,D,VAN,35,82,1,12,13
9,8476878,Zemgus Girgensons,L,BUF,30,82,7,5,12
9,8479383,Boris Katchouk,L,OTT,26,82,6,6,12
9,8483482,Tristan Luneau,D,ANA,20,82,3,9,12
9,8478443,Brandon Carlo,D,BOS,28,82,2,10,12
9,8477034,Jaycob Megna,D,CHI,32,82,1,11,12
9,8478468,Jeremy Lauzon,D,NSH,27,82,0,12,12
9,8477931,Tomas Nosek,L,NJD,32,82,3,8,11
9,8480172,Jan Rutta,D,SJS,34,82,2,9,11
9,8475762,Derek Forbort,D,BOS,32,82,2,9,11
9,8484149,Gavin Brindley,C,CBJ,20,82,6,4,10
9,8480990,Declan Chisholm,D,MIN,24,82,4,6,10
9,8474166,Alec Martinez,D,VGK,37,82,2,8,10
9,8477220,Nate Schmidt,D,WPG,33,82,2,8,10
9,8480879,Jacob Bernard-Docker,D,OTT,24,82,2,8,10
9,8483763,Maksymilian Szuber,D,ARI,22,82,2,7,9
9,8482713,Mackie Samoskevich,R,FLA,22,82,1,8,9
9,8481599,Victor Soderstrom,D,ARI,23,82,0,9,9
9,8482807,Ethan Del Mastro,D,CHI,21,82,3,4,7
9,8476915,Jujhar Khaira,L,MIN,30,82,3,4,7
9,8481578,Graeme Clarke,R,NJD,23,82,2,5,7
9,8483489,Fraser Minten,C,TOR,31,82,1,5,6
9,8482859,Zack Ostapchuk,C,OTT,21,82,1,3,4
9,8476473,Connor Murphy,D,CHI,31,82,0,4,4
9,8482141,Lukas Cormier,D,VGK,22,0,0,0,0
9,8476988,Matt Benning,D,SJS,30,0,0,0,0
9,8480727,Zach Whitecloud,D,VGK,28,0,0,0,0
9,8480887,Jordan Harris,D,MTL,24,0,0,0,0
9,8478450,Parker Wotherspoon,D,BOS,27,0,0,0,0
9,8481812,Nikolai Knyzhov,D,SJS,27,0,0,0,0
9,8480001,Urho Vaakanainen,D,ANA,25,0,0,0,0
9,8482176,Wyatt Kaiser,D,CHI,22,0,0,0,0
9,8481122,Simon Benoit,D,TOR,26,0,0,0,0
9,8476441,Joel Edmundson,D,TOR,31,0,0,0,0
9,8480884,Calen Addison,D,SJS,24,0,0,0,0
9,8482511,Mason Lohrei,D,BOS,23,0,0,0,0
9,8482192,Isaak Phillips,D,CHI,23,0,0,0,0
9,8480950,Ilya Lyubushkin,D,TOR,30,0,0,0,0
9,8474031,Kevin Shattenkirk,D,BOS,35,0,0,0,0
9,8475718,Justin Holl,D,DET,32,0,0,0,0
9,8479402,Jake Bean,D,CBJ,26,0,0,0,0
9,8474602,Justin Schultz,D,SEA,34,0,0,0,0
9,8477950,Tony DeAngelo,D,CAR,29,0,0,0,0
9,8481743,Marc Del Gaizo,D,NSH,25,0,0,0,0
9,8481527,Kaedan Korczak,D,VGK,23,0,0,0,0
9,8480192,Johnathan Kovacevic,D,MTL,27,0,0,0,0
9,8476874,Olli Maatta,D,DET,30,0,0,0,0
9,8482144,Jack Thompson,D,SJS,22,0,0,0,0
9,8480222,Sebastian Aho,D,NYI,28,0,0,0,0
9,8479458,Nikita Zaitsev,D,CHI,33,0,0,0,0
9,8471709,Marc-Edouard Vlasic,D,SJS,37,0,0,0,0
9,8482929,Emil Lilleberg,D,TBL,23,0,0,0,0
9,8477018,Ben Hutton,D,VGK,31,0,0,0,0
9,8481056,Spencer Stastney,D,NSH,24,0,0,0,0
9,8481593,Jayden Struble,D,MTL,23,0,0,0,0
9,8479982,Conor Timmins,D,TOR,26,0,0,0,0
9,8474090,Brendan Smith,D,NJD,35,0,0,0,0
9,8482964,Arber Xhekaj,D,MTL,23,0,0,0,0
9,8480891,Michael Kesselring,D,ARI,24,0,0,0,0
9,8477938,Haydn Fleury,D,TBL,28,0,0,0,0
9,8481806,Louis Crevier,D,CHI,23,0,0,0,0
9,8471274,Alex Goligoski,D,MIN,39,0,0,0,0
9,8481600,Tobias Bjornfot,D,FLA,23,0,0,0,0
9,8475797,Jarred Tinordi,D,CHI,32,0,0,0,0
9,8481521,Ronnie Attard,D,PHI,25,0,0,0,0
9,8474612,Travis Hamonic,D,OTT,34,0,0,0,0
9,8479576,Vincent Desharnais,D,EDM,28,0,0,0,0
9,8480049,Dylan Samberg,D,WPG,25,0,0,0,0
9,8483619,Filip Roos,D,CHI,25,0,0,0,0
9,8474568,Luke Schenn,D,NSH,35,0,0,0,0
9,8480184,Gustav Lindstrom,D,ANA,26,0,0,0,0
9,8480070,Ian Mitchell,D,BOS,25,0,0,0,0
9,8480196,Jacob Bryson,D,BUF,27,0,0,0,0
9,8471686,Marc Staal,D,PHI,37,0,0,0,0
9,8477467,Gustav Olofsson,D,SEA,30,0,0,0,0
9,8478970,Jalen Chatfield,D,CAR,28,0,0,0,0
9,8479348,Kale Clague,D,BUF,26,0,0,0,0
9,8473446,Erik Johnson,D,PHI,36,0,0,0,0
9,8477462,Robert Hagg,D,ANA,29,0,0,0,0
9,8478454,Noah Juulsen,D,VAN,27,0,0,0,0
9,8477384,Josh Brown,D,ARI,30,0,0,0,0
9,8481708,Zac Jones,D,NYR,24,0,0,0,0
9,8481167,Brayden Pachal,D,CGY,25,0,0,0,0
9,8482067,Connor Mackey,D,NYR,28,0,0,0,0
9,8483460,David Jiricek,D,CBJ,21,0,0,0,0
9,8481701,Santeri Hatakka,D,NJD,23,0,0,0,0
9,8478021,William Lagesson,D,ANA,28,0,0,0,0
9,8477851,Jordan Oesterle,D,CGY,32,0,0,0,0
9,8478452,Caleb Jones,D,COL,27,0,0,0,0
9,8479984,Cal Foote,D,NJD,26,0,0,0,0
9,8479639,Dylan Coghlan,D,CAR,26,0,0,0,0
9,8480874,Adam Ginning,D,PHI,24,0,0,0,0
9,8479321,Lucas Johansen,D,WSH,27,0,0,0,0
9,8480878,Nils Lundkvist,D,DAL,24,0,0,0,0
9,8482165,Yan Kuznetsov,D,CGY,22,0,0,0,0
9,8484258,Sam Malinski,D,COL,26,0,0,0,0
9,8480157,Calle Rosen,D,STL,30,0,0,0,0
9,8484304,Uvis Balinskis,D,FLA,28,0,0,0,0
9,8479985,Cale Fleury,D,SEA,26,0,0,0,0
9,8479378,Logan Stanley,D,WPG,26,0,0,0,0
9,8477541,Dakota Mermis,D,MIN,30,0,0,0,0
9,8481609,Vladislav Kolyachonok,D,ARI,23,0,0,0,0
9,8480823,Alexander Alexeyev,D,WSH,25,0,0,0,0
9,8481679,Maxence Guenette,D,OTT,23,0,0,0,0
9,8481564,Ryan Johnson,D,BUF,23,0,0,0,0
9,8479376,Victor Mete,D,PHI,26,0,0,0,0
9,8484254,Akito Hirose,D,VAN,25,0,0,0,0
9,8482660,Kent Johnson,C,CBJ,22,0,0,0,0
9,8482149,Cole Perfetti,C,WPG,22,0,0,0,0
9,8477987,Ryan Donato,C,CHI,28,0,0,0,0
9,8475755,Alexander Petrovic,D,DAL,32,0,0,0,0
9,8477810,Joel Hanley,D,CGY,33,0,0,0,0
9,8474145,Robert Bortuzzo,D,NYI,35,0,0,0,0
9,8481161,Jake Christiansen,D,CBJ,25,0,0,0,0
9,8476884,Derrick Pouliot,D,DAL,30,0,0,0,0
9,8481716,Dmitri Voronkov,L,CBJ,24,0,0,0,0
9,8480084,Nick DeSimone,D,NJD,30,0,0,0,0
9,8475750,Jon Merrill,D,MIN,32,0,0,0,0
9,8479315,Joey Anderson,R,CHI,26,0,0,0,0
9,8478011,Louie Belpedio,D,PHI,28,0,0,0,0
9,8482451,Mikael Pyyhtia,L,CBJ,23,0,0,0,0
9,8481541,Samuel Bolduc,D,NYI,24,0,0,0,0
9,8482126,Emil Andrae,D,PHI,31,0,0,0,0
9,8474618,Marco Scandella,D,STL,34,0,0,0,0
9,8477244,Chad Ruhwedel,D,NYR,34,0,0,0,0
9,8477971,Andreas Englund,D,LAK,28,0,0,0,0
9,8480829,Jesperi Kotkaniemi,C,CAR,24,0,0,0,0
9,8479372,Josh Mahura,D,FLA,26,0,0,0,0
9,8482095,Tyler Kleven,D,OTT,22,0,0,0,0
9,8481719,Maxwell Crozier,D,TBL,24,0,0,0,0
9,8475855,Jesper Fast,R,CAR,33,0,0,0,0
9,8480848,Ty Dellandrea,C,DAL,24,0,0,0,0
9,8475193,Tomas Tatar,L,SEA,34,0,0,0,0
9,8476889,Radek Faksa,C,DAL,30,0,0,0,0
9,8478495,Denis Gurianov,R,PHI,27,0,0,0,0
9,8480216,Jacob Peterson,C,SJS,25,0,0,0,0
9,8480252,Cole Guttman,C,CHI,25,0,0,0,0
9,8479026,Philippe Myers,D,TBL,27,0,0,0,0
9,8481006,Tyler Tucker,D,STL,24,0,0,0,0
9,8481032,Paul Cotter,C,VGK,25,0,0,0,0
9,8481577,Philip Tomasino,C,NSH,23,0,0,0,0
9,8476918,Jimmy Vesey,L,NYR,31,0,0,0,0
9,8479320,Max Lajoie,D,TOR,27,0,0,0,0
9,8478017,Mark Friedman,D,VAN,29,0,0,0,0
9,8481754,Nikita Nesterenko,C,ANA,23,0,0,0,0
9,8483407,Brandon Scanlin,D,NYR,25,0,0,0,0
9,8482659,Josh Doan,R,ARI,22,0,0,0,0
9,8477446,Michael McCarron,R,NSH,29,0,0,0,0
9,8477903,Garnet Hathaway,R,PHI,33,0,0,0,0
9,8482153,Brendan Brisson,C,VGK,23,0,0,0,0
9,8483546,Marshall Rifai,D,TOR,26,0,0,0,0
9,8484287,Cole McWard,D,VAN,23,0,0,0,0
9,8478854,Ryan Shea,D,PIT,27,0,0,0,0
9,8481585,Egor Afanasyev,L,NSH,23,0,0,0,0
9,8483398,Declan Carlile,D,TBL,31,0,0,0,0
9,8478502,Dennis Gilbert,D,CGY,28,0,0,0,0
9,8482749,Joshua Roy,R,MTL,21,0,0,0,0
9,8481598,Philip Broberg,D,EDM,23,0,0,0,0
9,8480835,Jack Drury,C,CAR,24,0,0,0,0
9,8480748,Kiefer Sherwood,L,NSH,29,0,0,0,0
9,8476934,Brock McGinn,L,ANA,30,0,0,0,0
9,8480870,Bo Groulx,C,ANA,24,0,0,0,0
9,8479368,Max Jones,L,ANA,26,0,0,0,0
9,8478099,Kevin Labanc,R,SJS,29,0,0,0,0
9,8478067,Oskar Lindblom,L,SJS,28,0,0,0,0
9,8476393,Nick Cousins,C,FLA,31,0,0,0,0
9,8483395,Arshdeep Bains,L,VAN,23,0,0,0,0
9,8480762,Eric Robinson,L,BUF,29,0,0,0,0
9,8479439,Jacob MacDonald,D,SJS,31,0,0,0,0
9,8476474,Stefan Noesen,R,CAR,31,0,0,0,0
9,8482787,Nikita Chibrikov,R,WPG,31,0,0,0,0
9,8478432,Christian Fischer,R,DET,27,0,0,0,0
9,8477979,Nicolas Aube-Kubel,R,WSH,28,0,0,0,0
9,8481789,Tye Kartye,L,SEA,23,0,0,0,0
9,8479330,Brandon Gignac,C,MTL,27,0,0,0,0
9,8480075,Cameron Crotty,D,ARI,25,0,0,0,0
9,8473473,Milan Lucic,L,BOS,36,0,0,0,0
9,8482094,Daemon Hunt,D,MIN,22,0,0,0,0
9,8481206,John Ludvig,D,PIT,24,0,0,0,0
9,8483630,Pavol Regenda,L,ANA,25,0,0,0,0
9,8481617,Vasily Podkolzin,R,VAN,23,0,0,0,0
9,8480306,Grant Hutton,D,NYI,29,0,0,0,0
9,8480995,Pontus Holmberg,R,TOR,25,0,0,0,0
9,8482148,Hendrix Lapierre,C,WSH,22,0,0,0,0
9,8477478,William Carrier,L,VGK,30,0,0,0,0
9,8480003,Jesper Boqvist,C,BOS,26,0,0,0,0
9,8482172,Landon Slaggert,L,CHI,22,0,0,0,0
9,8480789,Oliver Wahlstrom,R,NYI,24,0,0,0,0
9,8474062,Riley Nash,C,NYR,35,0,0,0,0
9,8480021,Jack Studnicka,C,SJS,25,0,0,0,0
9,8480025,MacKenzie Entwistle,R,CHI,25,0,0,0,0
9,8481582,Nicholas Robertson,L,TOR,23,0,0,0,0
9,8476867,Brendan Gaunce,C,CBJ,30,0,0,0,0
9,8479619,Michael Carcone,L,ARI,28,0,0,0,0
9,8479370,Tyson Jost,C,BUF,26,0,0,0,0
9,8479671,Mathieu Olivier,R,CBJ,27,0,0,0,0
9,8476994,Vinnie Hinostroza,C,PIT,30,0,0,0,0
9,8482070,Mitchell Chaffee,R,TBL,26,0,0,0,0
9,8477473,Justin Bailey,R,SJS,29,0,0,0,0
9,8479344,Jesse Puljujarvi,R,PIT,26,0,0,0,0
9,8480205,Emil Bemstrom,C,PIT,25,0,0,0,0
9,8479718,Alex Barré-Boulet,C,TBL,27,0,0,0,0
9,8482061,Brandon Biro,L,BUF,26,0,0,0,0
9,8479638,Justin Brazeau,R,BOS,26,0,0,0,0
9,8474040,Sam Gagner,C,EDM,35,0,0,0,0
9,8477846,Ryan Carpenter,C,SJS,33,0,0,0,0
9,8482077,Dylan Holloway,L,EDM,23,0,0,0,0
9,8482157,Will Cuylle,L,NYR,22,0,0,0,0
9,8480007,Jonas Rondbjerg,R,VGK,25,0,0,0,0
9,8478874,Adam Gaudette,C,STL,28,0,0,0,0
9,8478434,Keegan Kolesar,R,VGK,27,0,0,0,0
9,8480441,Trey Fix-Wolansky,R,CBJ,25,0,0,0,0
9,8479994,Jaret Anderson-Dolan,C,NSH,25,0,0,0,0
9,8483567,Georgii Merkulov,C,BOS,24,0,0,0,0
9,8477380,Jonny Brodzinski,C,NYR,31,0,0,0,0
9,8482201,Gage Goncalves,C,TBL,23,0,0,0,0
9,8478211,Dryden Hunt,L,CGY,29,0,0,0,0
9,8471699,Andrew Cogliano,C,COL,37,0,0,0,0
9,8479421,Jacob Moverare,D,LAK,26,0,0,0,0
9,8478881,Brett Seney,L,CHI,28,0,0,0,0
9,8477464,Nic Petan,C,MIN,29,0,0,0,0
9,8475958,Michael Sgarbossa,C,WSH,32,0,0,0,0
9,8481147,Reese Johnson,C,CHI,26,0,0,0,0
9,8479336,Carl Grundstrom,R,LAK,27,0,0,0,0
9,8480853,Liam Foudy,C,NSH,24,0,0,0,0
9,8479522,Hardy Haman Aktell,D,WSH,26,0,0,0,0
9,8481462,Mason Morelli,L,VGK,28,0,0,0,0
9,8482102,Vasily Ponomarev,C,CAR,22,0,0,0,0
9,8480844,Grigori Denisenko,L,VGK,24,0,0,0,0
9,8479944,Zach Aston-Reese,C,DET,30,0,0,0,0
9,8482784,Zach Dean,C,STL,21,0,0,0,0
9,8479419,Brett Murray,L,BUF,26,0,0,0,0
9,8479520,Brandon Duhaime,R,COL,27,0,0,0,0
9,8477573,Nathan Walker,L,STL,30,0,0,0,0
9,8478078,Rourke Chartier,C,OTT,28,0,0,0,0
9,8475795,Dylan McIlrath,D,WSH,32,0,0,0,0
9,8482496,Nils Aman,C,VAN,24,0,0,0,0
9,8480289,Morgan Barron,C,WPG,26,0,0,0,0
9,8481751,Lukas Rousek,R,BUF,25,0,0,0,0
9,8480011,Klim Kostin,C,SJS,25,0,0,0,0
9,8481556,John Beecher,C,BOS,23,0,0,0,0
9,8475278,Byron Froese,C,VGK,33,0,0,0,0
9,8475225,Craig Smith,C,DAL,35,0,0,0,0
9,8484326,Patrik Koch,D,ARI,28,0,0,0,0
9,8477930,Pierre-Edouard Bellemare,L,SEA,39,0,0,0,0
9,8478409,Anthony Richard,C,BOS,28,0,0,0,0
9,8481024,Linus Karlsson,C,VAN,25,0,0,0,0
9,8479986,Kole Lind,R,SEA,26,0,0,0,0
9,8479414,Nathan Bastian,R,NJD,27,0,0,0,0
9,8479362,Riley Tufte,L,COL,26,0,0,0,0
9,8481058,Jesse Ylönen,R,MTL,25,0,0,0,0
9,8482476,Emil Heineman,L,MTL,23,0,0,0,0
9,8482861,Vincent Iorio,D,WSH,22,0,0,0,0
9,8483432,Luca Del Bel Belluz,C,CBJ,31,0,0,0,0
9,8482744,James Malatesta,L,CBJ,21,0,0,0,0
9,8477887,Patrick Brown,C,BOS,32,0,0,0,0
9,8478585,Derek Ryan,C,EDM,38,0,0,0,0
9,8481441,Joe Snively,C,WSH,28,0,0,0,0
9,8481592,Jakob Pelletier,L,CGY,23,0,0,0,0
9,8482634,Alex Steeves,C,TOR,25,0,0,0,0
9,8477126,Jayson Megna,C,BOS,34,0,0,0,0
9,8475752,Tyler Pitlick,C,NYR,33,0,0,0,0
9,8480008,Adam Ruzicka,C,ARI,25,0,0,0,0
9,8481065,Angus Crookshank,L,OTT,25,0,0,0,0
9,8479547,Matthew Phillips,R,WSH,26,0,0,0,0
9,8480226,Marián Studenic,R,SEA,26,0,0,0,0
9,8481237,Kyle MacLean,C,NYI,25,0,0,0,0
9,8475413,Justin Dowling,C,NJD,34,0,0,0,0
9,8481641,Joel Kiviranta,L,COL,28,0,0,0,0
9,8478104,Sammy Blais,L,STL,28,0,0,0,0
9,8477454,Adam Erne,L,EDM,29,0,0,0,0
9,8481518,Nolan Foote,L,NJD,24,0,0,0,0
9,8480245,Olle Lycksell,R,PHI,25,0,0,0,0
9,8483570,Ben Meyers,C,ANA,26,0,0,0,0
9,8480776,Sheldon Rempal,R,VGK,29,0,0,0,0
9,8483920,Pierrick Dube,R,WSH,23,0,0,0,0
9,8480267,Sammy Walker,C,MIN,25,0,0,0,0
9,8482747,Brennan Othmann,L,NYR,21,0,0,0,0
9,8479991,Jake Leschyshyn,C,NYR,25,0,0,0,0
9,8478400,Colin White,C,MTL,27,0,0,0,0
9,8479328,Julien Gauthier,R,NYI,27,0,0,0,0
9,8484325,Waltteri Merela,C,TBL,26,0,0,0,0
9,8479066,Ryan Lomberg,L,FLA,30,0,0,0,0
9,8477070,Liam O'Brien,C,ARI,30,0,0,0,0
9,8478146,Matthew Highmore,C,OTT,28,0,0,0,0
9,8478028,Fredrik Olofsson,L,COL,28,0,0,0,0
9,8480880,Jakub Lauko,C,BOS,24,0,0,0,0
9,8479968,Vinni Lettieri,C,MIN,29,0,0,0,0
9,8474709,Matt Martin,L,NYI,35,0,0,0,0
9,8480845,Rasmus Kupari,C,WPG,24,0,0,0,0
9,8481550,Adam Beckman,L,MIN,23,0,0,0,0
9,8481422,Jacob Lucchini,C,MIN,29,0,0,0,0
9,8477401,John Hayden,C,SEA,29,0,0,0,0
9,8478904,Steven Lorentz,C,FLA,28,0,0,0,0
9,8482088,Justin Sourdif,R,FLA,22,0,0,0,0
9,8482751,Ryan Winterton,C,SEA,21,0,0,0,0
9,8482241,Radim Zohorna,L,PIT,28,0,0,0,0
9,8481690,Tyler Angle,C,CBJ,24,0,0,0,0
9,8476952,Dominic Toninato,C,WPG,30,0,0,0,0
9,8476919,Chris Tierney,C,NJD,30,0,0,0,0
9,8480032,Shane Bowers,C,NJD,25,0,0,0,0
9,8484314,Jiri Smejkal,L,OTT,28,0,0,0,0
9,8481239,Samuel Fagemo,L,LAK,24,0,0,0,0
9,8481532,Alex Turcotte,C,LAK,23,0,0,0,0
9,8481019,David Gustafsson,C,WPG,24,0,0,0,0
9,8478477,Mitchell Stephens,C,MTL,27,0,0,0,0
9,8479546,Oskar Steen,C,BOS,26,0,0,0,0
9,8480292,Carson Meyer,R,CBJ,27,0,0,0,0
9,8478446,Glenn Gawdin,C,ANA,27,0,0,0,0
9,8483531,Brian Halonen,L,NJD,25,0,0,0,0
9,8477149,Scott Sabourin,R,SJS,32,0,0,0,0
9,8479972,Mason Shaw,C,MIN,26,0,0,0,0
9,8480890,Jan Jenik,R,ARI,24,0,0,0,0
9,8478051,Max Willman,C,NJD,29,0,0,0,0
9,8480851,Akil Thomas,C,LAK,24,0,0,0,0
9,8482765,Isak Rosen,R,BUF,21,0,0,0,0
9,8478421,A.J. Greer,L,CGY,28,0,0,0,0
9,8478512,Austin Czarnik,C,DET,32,0,0,0,0
9,8479536,Axel Jonsson-Fjallby,L,WPG,26,0,0,0,0
9,8477320,Anton Blidh,L,NYR,29,0,0,0,0
9,8481543,Nikita Alexandrov,C,STL,24,0,0,0,0
9,8475235,Nicolas Deslauriers,L,PHI,33,0,0,0,0
9,8481070,Hugh McGing,L,STL,26,0,0,0,0
9,8480836,Jonathan Gruden,C,PIT,24,0,0,0,0
9,8481591,Sam Poulin,R,PIT,23,0,0,0,0
9,8477962,Brendan Lemieux,L,CAR,28,0,0,0,0
9,8483401,Marc Johnstone,R,PIT,28,0,0,0,0
9,8482250,Callahan Burke,C,CAR,27,0,0,0,0
9,8481726,Adam Edstrom,C,NYR,24,0,0,0,0
9,8471817,Ryan Reaves,R,TOR,37,0,0,0,0
9,8479587,Rhett Gardner,C,PHI,28,0,0,0,0
9,8475766,Austin Watson,L,TBL,32,0,0,0,0
9,8479367,William Lockwood,R,FLA,26,0,0,0,0
9,8478424,Jansen Harkins,C,PIT,27,0,0,0,0
9,8476913,Devin Shore,C,SEA,30,0,0,0,0
9,8482652,Walker Duehr,R,CGY,27,0,0,0,0
9,8477527,Ross Johnston,L,ANA,30,0,0,0,0
9,8481077,John Leonard,L,ARI,26,0,0,0,0
9,8483549,Lucas Condotta,L,MTL,27,0,0,0,0
9,8480468,James Hamblin,L,EDM,25,0,0,0,0
9,8476907,Mackenzie MacEachern,L,STL,30,0,0,0,0
9,8479543,Michael Pezzetta,L,MTL,26,0,0,0,0
9,8480355,Mark Kastelic,C,OTT,25,0,0,0,0
9,8482162,Roby Jarventie,L,OTT,22,0,0,0,0
9,8479772,Zack MacEwen,R,OTT,28,0,0,0,0
9,8483597,Milos Kelemen,L,ARI,25,0,0,0,0
9,8479379,Givani Smith,R,SJS,26,0,0,0,0
9,8481655,Cole Schwindt,R,CGY,23,0,0,0,0
9,8479981,Jonah Gadjovich,L,FLA,26,0,0,0,0
9,8482147,Jean-Luc Foudy,C,COL,22,0,0,0,0
9,8484255,Jason Polin,R,COL,25,0,0,0,0
9,8477993,Justin Kirkland,C,ARI,28,0,0,0,0
9,8479249,Andrew Poturalski,C,SEA,30,0,0,0,0
9,8482197,Adam Raska,R,MIN,23,0,0,0,0
9,8475780,Chris Wagner,R,COL,33,0,0,0,0
9,8479533,Joona Koppanen,L,PIT,26,0,0,0,0
9,8481534,Raphael Lavoie,C,EDM,24,0,0,0,0
9,8484321,Nikolas Matinpalo,D,OTT,26,0,0,0,0
9,8481043,Cole Koepke,L,TBL,26,0,0,0,0
9,8476323,Max McCormick,L,SEA,32,0,0,0,0
9,8483609,Adam Klapka,R,CGY,24,0,0,0,0
9,8483512,Matt Savoie,C,BUF,20,0,0,0,0
9,8484259,Ondrej Pavel,C,COL,31,0,0,0,0
9,8478147,Bokondji Imama,L,OTT,28,0,0,0,0
9,8482460,Matt Rempe,C,NYR,22,0,0,0,0
9,8477073,Kurtis MacDermid,L,NJD,30,0,0,0,0
9,8480274,Philip Kemp,D,EDM,25,0,0,0,0
9,8478956,Samuel Laberge,L,NJD,27,0,0,0,0
9,8483045,Cameron Butler,R,CBJ,31,0,0,0,0
10,8479318,Auston Matthews,C,TOR,27,82,62,57,119
10,8476453,Nikita Kucherov,R,TBL,31,82,45,73,118
10,8478402,Connor McDavid,C,EDM,27,82,32,76,108
10,8480027,Jason Robertson,L,DAL,25,82,32,67,99
10,8479314,Matthew Tkachuk,L,FLA,27,82,29,70,99
10,8477492,Nathan MacKinnon,C,COL,29,82,47,51,98
10,8481559,Jack Hughes,C,NJD,23,82,39,59,98
10,8477934,Leon Draisaitl,C,EDM,29,82,38,59,97
10,8478550,Artemi Panarin,L,NYR,33,82,34,61,95
10,8477956,David Pastrnak,R,BOS,28,82,43,51,94
10,8478420,Mikko Rantanen,R,COL,28,82,38,53,91
10,8477933,Sam Reinhart,C,FLA,29,82,35,54,89
10,8475166,John Tavares,C,TOR,34,82,46,42,88
10,8478427,Sebastian Aho,C,CAR,27,82,36,49,85
10,8478864,Kirill Kaprizov,L,MIN,27,82,36,49,85
10,8480069,Cale Makar,D,COL,26,82,23,62,85
10,8476468,J.T. Miller,C,VAN,31,82,23,62,85
10,8480012,Elias Pettersson,C,VAN,26,82,35,46,81
10,8471675,Sidney Crosby,C,PIT,37,82,27,54,81
10,8477493,Aleksander Barkov,C,FLA,29,82,24,57,81
10,8480830,Andrei Svechnikov,R,CAR,24,82,34,46,80
10,8476887,Filip Forsberg,L,NSH,30,82,31,49,80
10,8479407,Jesper Bratt,L,NJD,26,82,43,35,78
10,8480801,Brady Tkachuk,L,OTT,25,82,42,33,75
10,8477404,Jake Guentzel,C,CAR,30,82,35,40,75
10,8477409,Carter Verhaeghe,C,FLA,29,82,38,36,74
10,8478449,Roope Hintz,C,DAL,28,82,31,42,73
10,8477942,Kevin Fiala,L,LAK,28,82,24,49,73
10,8480002,Nico Hischier,C,NJD,25,82,22,51,73
10,8480023,Robert Thomas,C,STL,25,82,14,59,73
10,8475168,Matt Duchene,C,DAL,33,82,37,35,72
10,8475172,Nazem Kadri,C,CGY,34,82,32,40,72
10,8477946,Dylan Larkin,C,DET,28,82,30,42,72
10,8480800,Quinn Hughes,D,VAN,25,82,11,61,72
10,8478010,Brayden Point,C,TBL,28,82,37,34,71
10,8477951,Nick Schmaltz,C,ARI,28,82,30,41,71
10,8477939,William Nylander,R,TOR,28,82,25,46,71
10,8480039,Martin Necas,C,CAR,25,82,26,44,70
10,8479343,Clayton Keller,R,ARI,26,82,25,45,70
10,8474564,Steven Stamkos,C,TBL,34,82,24,46,70
10,8477501,Valeri Nichushkin,R,COL,29,82,33,35,68
10,8480208,Drake Batherson,R,OTT,26,82,32,36,68
10,8482116,Tim Stützle,C,OTT,22,82,26,42,68
10,8482740,Wyatt Johnston,C,DAL,21,82,41,26,67
10,8481540,Cole Caufield,R,MTL,23,82,37,30,67
10,8479420,Tage Thompson,C,BUF,27,82,37,30,67
10,8482684,Luke Hughes,D,NJD,21,82,22,45,67
10,8480839,Rasmus Dahlin,D,BUF,24,82,14,53,67
10,8479323,Adam Fox,D,NYR,26,82,12,55,67
10,8478414,Timo Meier,R,NJD,28,82,35,31,66
10,8478403,Jack Eichel,C,VGK,28,82,29,37,66
10,8470794,Joe Pavelski,C,DAL,40,82,23,43,66
10,8481523,Kirby Dach,C,MTL,23,82,19,47,66
10,8479675,Trevor Moore,L,LAK,29,82,30,35,65
10,8481557,Matt Boldy,L,MIN,23,82,26,39,65
10,8473512,Claude Giroux,R,OTT,36,82,18,47,65
10,8478407,Vince Dunn,D,SEA,28,82,14,51,65
10,8476853,Morgan Rielly,D,TOR,30,82,11,54,65
10,8475810,Bryan Rust,R,PIT,32,82,39,25,64
10,8474600,Roman Josi,D,NSH,34,82,14,50,64
10,8480036,Miro Heiskanen,D,DAL,25,82,12,52,64
10,8475798,Mikael Granlund,C,SJS,32,82,12,52,64
10,8482078,Lucas Raymond,L,DET,22,82,29,34,63
10,8471215,Evgeni Malkin,C,PIT,38,82,27,36,63
10,8478439,Travis Konecny,R,PHI,27,82,27,36,63
10,8478873,Troy Terry,R,ANA,27,82,21,42,63
10,8479385,Jordan Kyrou,C,STL,26,82,29,33,62
10,8478042,Viktor Arvidsson,R,LAK,31,82,23,39,62
10,8482093,Seth Jarvis,C,CAR,22,82,22,40,62
10,8476456,Jonathan Huberdeau,C,CGY,31,82,15,47,62
10,8474590,John Carlson,D,WSH,34,82,13,49,62
10,8471214,Alex Ovechkin,L,WSH,39,82,34,27,61
10,8476389,Vincent Trocheck,C,NYR,31,82,31,29,60
10,8478493,Joel Eriksson Ek,C,MIN,27,82,27,33,60
10,8478975,Mason Marchment,L,DAL,29,82,24,36,60
10,8478445,Mathew Barzal,C,NYI,27,82,22,38,60
10,8473419,Brad Marchand,L,BOS,36,82,22,38,60
10,8479999,Casey Mittelstadt,C,COL,26,82,21,39,60
10,8476454,Ryan Nugent-Hopkins,C,EDM,31,82,15,45,60
10,8479337,Alex DeBrincat,R,DET,27,82,25,34,59
10,8477504,Josh Morrissey,D,WPG,29,82,14,45,59
10,8471685,Anze Kopitar,C,LAK,37,82,13,46,59
10,8477496,Elias Lindholm,C,VAN,30,82,28,30,58
10,8476459,Mika Zibanejad,C,NYR,31,82,22,36,58
10,8480018,Nick Suzuki,C,MTL,25,82,21,37,58
10,8475913,Mark Stone,R,VGK,32,82,17,41,58
10,8474141,Patrick Kane,R,DET,36,82,24,33,57
10,8477402,Pavel Buchnevich,L,STL,29,82,22,35,57
10,8477960,Adrian Kempe,R,LAK,28,82,20,37,57
10,8480803,Evan Bouchard,D,EDM,25,82,13,44,57
10,8478444,Brock Boeser,R,VAN,27,82,34,22,56
10,8478398,Kyle Connor,L,WPG,28,82,29,27,56
10,8479542,Brandon Hagel,L,TBL,26,82,27,29,56
10,8478438,Tommy Novak,C,NSH,27,82,27,29,56
10,8475158,Ryan O'Reilly,C,NSH,33,82,24,32,56
10,8477949,Alex Tuch,R,BUF,28,82,22,34,56
10,8482097,Jack Quinn,R,BUF,23,82,22,34,56
10,8480865,Noah Dobson,D,NYI,24,82,12,44,56
10,8476399,Blake Coleman,C,CGY,33,82,35,20,55
10,8475184,Chris Kreider,L,NYR,33,82,34,21,55
10,8475786,Zach Hyman,L,EDM,32,82,34,21,55
10,8482745,Mason McTavish,C,ANA,21,82,25,30,55
10,8475784,Jeff Skinner,C,BUF,32,82,24,31,55
10,8475754,Brock Nelson,C,NYI,33,82,24,31,55
10,8478047,Michael Bunting,L,PIT,29,82,22,33,55
10,8482092,Ridly Greig,C,OTT,22,82,22,33,55
10,8476483,Rickard Rakell,R,PIT,31,82,19,36,55
10,8475692,Mats Zuccarello,R,MIN,37,82,14,41,55
10,8477503,Max Domi,C,TOR,29,82,14,41,55
10,8478460,Zach Werenski,D,CBJ,27,82,12,42,54
10,8476479,Phillip Danault,C,LAK,31,82,28,25,53
10,8475765,Vladimir Tarasenko,R,FLA,33,82,26,27,53
10,8475794,Tyler Seguin,C,DAL,32,82,24,29,53
10,8477407,Anthony Duclair,L,TBL,29,82,21,32,53
10,8478440,Dylan Strome,C,WSH,27,82,20,33,53
10,8471724,Kris Letang,D,PIT,37,82,12,41,53
10,8479425,Filip Hronek,D,VAN,27,82,12,41,53
10,8477500,Bo Horvat,C,NYI,29,82,25,27,52
10,8476346,Johnny Gaudreau,L,CBJ,31,82,17,35,52
10,8475768,Jaden Schwartz,C,SEA,32,82,14,38,52
10,8478038,Devon Toews,D,COL,30,82,8,44,52
10,8477479,Tyler Bertuzzi,L,TOR,29,82,25,26,51
10,8476462,Dougie Hamilton,D,NJD,31,82,17,34,51
10,8481528,Dylan Cozens,C,BUF,23,82,26,24,50
10,8476460,Mark Scheifele,C,WPG,31,82,25,25,50
10,8477476,Artturi Lehkonen,L,COL,29,82,25,25,50
10,8474586,Jordan Eberle,R,SEA,34,82,21,29,50
10,8477986,Brandon Montour,D,FLA,30,82,14,36,50
10,8474150,Mikael Backlund,C,CGY,35,82,14,36,50
10,8474578,Erik Karlsson,D,PIT,34,82,11,39,50
10,8480188,Fabian Zetterlund,L,SJS,25,82,24,25,49
10,8478519,Anthony Cirelli,C,TBL,27,82,22,27,49
10,8482113,Anton Lundell,C,FLA,23,82,18,31,49
10,8476329,Travis Boyd,C,ARI,31,82,13,36,49
10,8475167,Victor Hedman,D,TBL,34,82,12,37,49
10,8477955,Jared McCann,L,SEA,28,82,29,19,48
10,8475763,Kevin Hayes,R,STL,32,82,24,24,48
10,8476539,Jonathan Marchessault,R,VGK,34,82,23,25,48
10,8474563,Drew Doughty,D,LAK,35,82,13,35,48
10,8475197,Tyson Barrie,D,NSH,33,82,12,36,48
10,8474053,Logan Couture,C,SJS,35,82,22,25,47
10,8478542,Evan Rodrigues,C,FLA,31,82,20,27,47
10,8477416,Oliver Bjorkstrand,R,SEA,29,82,18,29,47
10,8476881,Tomas Hertl,C,VGK,31,82,15,32,47
10,8477444,Andre Burakovsky,L,SEA,29,82,15,32,47
10,8483457,Lane Hutson,D,MTL,20,82,6,41,47
10,8479325,Charlie McAvoy,D,BOS,27,82,4,43,47
10,8480014,Gabriel Vilardi,C,WPG,25,82,25,21,46
10,8482109,Alexis Lafrenière,L,NYR,23,82,25,21,46
10,8474157,Max Pacioretty,L,WSH,36,82,23,23,46
10,8475726,Tyler Toffoli,C,WPG,32,82,20,26,46
10,8482667,William Eklund,L,SJS,22,82,18,28,46
10,8477447,Shea Theodore,D,VGK,29,82,13,33,46
10,8476869,Brady Skjei,D,CAR,30,82,11,35,46
10,8482055,Drew O'Connor,L,PIT,26,82,30,15,45
10,8477935,Sam Bennett,C,FLA,28,82,23,22,45
10,8478366,Frank Vatrano,R,ANA,30,82,23,22,45
10,8480064,Josh Norris,C,OTT,25,82,21,24,45
10,8475745,Charlie Coyle,C,BOS,32,82,20,25,45
10,8482110,Dawson Mercer,C,NJD,23,82,20,25,45
10,8478856,Conor Garland,R,VAN,28,82,18,27,45
10,8475287,Erik Haula,L,NJD,33,82,18,27,45
10,8476826,Yanni Gourde,C,SEA,33,82,17,28,45
10,8481596,Shane Pinto,C,OTT,24,82,16,29,45
10,8477021,Alex Kerfoot,C,ARI,30,82,16,29,45
10,8484144,Connor Bedard,C,CHI,19,82,16,29,45
10,8478458,Jack Roslovic,C,NYR,27,82,15,30,45
10,8483445,Cutter Gauthier,L,ANA,20,82,13,32,45
10,8475722,Jason Zucker,L,NSH,32,82,23,21,44
10,8478498,Jake DeBrusk,L,BOS,28,82,20,24,44
10,8477940,Nikolaj Ehlers,L,WPG,28,82,18,26,44
10,8478401,Pavel Zacha,C,BOS,27,82,18,26,44
10,8476872,Scott Laughton,C,PHI,30,82,16,28,44
10,8473994,Jamie Benn,L,DAL,35,82,12,32,44
10,8477932,Aaron Ekblad,D,FLA,28,82,9,35,44
10,8478469,Thomas Chabot,D,OTT,27,82,9,35,44
10,8479410,Mikhail Sergachev,D,TBL,26,82,8,36,44
10,8478397,Rasmus Andersson,D,CGY,28,82,8,36,44
10,8483397,Marc McLaughlin,C,BOS,25,82,39,4,43
10,8474884,Mike Hoffman,C,SJS,35,82,18,25,43
10,8471218,Blake Wheeler,R,NYR,38,82,17,26,43
10,8480078,Filip Chytil,C,NYR,25,82,14,29,43
10,8481533,Trevor Zegras,C,ANA,23,82,12,31,43
10,8481581,Thomas Harley,D,DAL,23,82,8,35,43
10,8482159,Tyson Foerster,R,PHI,22,82,27,15,42
10,8479400,Pierre-Luc Dubois,L,LAK,26,82,20,22,42
10,8482101,Danil Gushchin,L,SJS,22,82,20,22,42
10,8473986,Alex Killorn,L,ANA,35,82,19,23,42
10,8474102,David Perron,L,DET,36,82,15,27,42
10,8476292,Ondrej Palat,L,NJD,33,82,14,28,42
10,8481618,Alex Newhook,C,MTL,23,82,21,20,41
10,8481186,Logan O'Connor,R,COL,28,82,21,20,41
10,8475314,Anders Lee,L,NYI,34,82,19,22,41
10,8478413,Jordan Greenway,L,BUF,27,82,19,22,41
10,8483808,Andrei Kuzmenko,L,CGY,28,82,16,25,41
10,8476458,Ryan Strome,C,ANA,31,82,15,26,41
10,8478466,Daniel Sprong,R,DET,27,82,15,26,41
10,8480797,Joel Farabee,L,PHI,24,82,15,26,41
10,8478472,Mathieu Joseph,R,OTT,27,82,14,27,41
10,8477346,MacKenzie Weegar,D,CGY,30,82,13,28,41
10,8478046,Danton Heinen,L,BOS,29,82,7,34,41
10,8483471,Brad Lambert,C,WPG,31,82,6,35,41
10,8476906,Shayne Gostisbehere,D,DET,31,82,6,35,41
10,8475760,Nick Bjugstad,C,ARI,32,82,26,14,40
10,8476432,Boone Jenner,C,CBJ,31,82,24,16,40
10,8480015,Owen Tippett,R,PHI,25,82,24,16,40
10,8475169,Evander Kane,L,EDM,33,82,23,17,40
10,8482699,Dylan Guenther,R,ARI,21,82,23,17,40
10,8481560,Arthur Kaliyev,R,LAK,23,82,20,20,40
10,8476419,Jean-Gabriel Pageau,C,NYI,32,82,20,20,40
10,8475151,Kyle Palmieri,C,NYI,33,82,19,21,40
10,8477429,Andrew Copp,C,DET,30,82,17,23,40
10,8471698,T.J. Oshie,R,WSH,38,82,17,23,40
10,8482133,Thomas Bordeleau,C,SJS,22,82,16,24,40
10,8479996,Cody Glass,C,NSH,25,82,15,25,40
10,8480031,Maxime Comtois,L,CAR,25,82,14,26,40
10,8477495,Seth Jones,D,CHI,30,82,12,28,40
10,8477456,J.T. Compher,L,DET,29,82,12,28,40
10,8479345,Jakob Chychrun,D,OTT,26,82,12,28,40
10,8475744,Evgeny Kuznetsov,C,CAR,32,82,9,31,40
10,8476448,William Karlsson,C,VGK,31,82,19,20,39
10,8480802,Ryan McLeod,C,EDM,25,82,19,20,39
10,8481068,Yegor Sharangovich,C,CGY,26,82,16,23,39
10,8476392,Adam Lowry,C,WPG,31,82,15,24,39
10,8477998,Warren Foegele,L,EDM,28,82,13,26,39
10,8482105,Jake Sanderson,D,OTT,22,82,11,28,39
10,8477494,Jonathan Drouin,L,COL,29,82,7,32,39
10,8481542,Moritz Seider,D,DET,23,82,5,34,39
10,8478462,Nicolas Roy,C,VGK,27,82,20,18,38
10,8475799,Nino Niederreiter,R,WPG,32,82,19,19,38
10,8479339,Patrik Laine,L,CBJ,26,82,16,22,38
10,8474641,Adam Henrique,C,EDM,34,82,15,23,38
10,8482124,Quinton Byfield,R,LAK,22,82,15,23,38
10,8473533,Jordan Staal,C,CAR,36,82,12,26,38
10,8479987,Morgan Geekie,C,BOS,26,82,10,28,38
10,8483524,Shane Wright,C,SEA,20,82,24,13,37
10,8476438,Brandon Saad,L,STL,32,82,19,18,37
10,8477497,Sean Monahan,C,WPG,30,82,17,20,37
10,8475220,Marcus Foligno,L,MIN,33,82,14,23,37
10,8475170,Brayden Schenn,C,STL,33,82,11,26,37
10,8478055,Gustav Forsling,D,FLA,28,82,10,27,37
10,8478396,Noah Hanifin,D,VGK,27,82,8,29,37
10,8481703,Valtteri Puustinen,R,PIT,25,82,4,33,37
10,8481699,Aku Raty,R,ARI,23,82,1,36,37
10,8480893,Kirill Marchenko,R,CBJ,24,82,19,17,36
10,8482705,Cole Sillinger,C,CBJ,21,82,18,18,36
10,8477989,Christian Dvorak,C,MTL,28,82,17,19,36
10,8482665,Matty Beniers,C,SEA,22,82,14,22,36
10,8482222,Alexander Barabanov,L,SJS,30,82,14,22,36
10,8481711,Matias Maccelli,L,ARI,24,82,13,23,36
10,8476882,Teuvo Teravainen,L,CAR,30,82,13,23,36
10,8473422,Nick Foligno,L,CHI,37,82,13,23,36
10,8478109,Victor Olofsson,L,BUF,29,82,12,24,36
10,8480798,Philipp Kurashev,C,CHI,25,82,11,25,36
10,8476905,Chandler Stephenson,C,VGK,30,82,10,26,36
10,8478133,Jake Evans,C,MTL,28,82,8,28,36
10,8477426,Nicholas Paul,L,TBL,29,82,22,13,35
10,8478233,Andrew Mangiapane,L,CGY,28,82,22,13,35
10,8478474,Lawson Crouse,L,ARI,27,82,22,13,35
10,8482089,Jake Neighbours,L,STL,22,82,19,16,35
10,8481535,Nils Hoglander,L,VAN,24,82,19,16,35
10,8474679,Gustav Nyquist,C,NSH,35,82,18,17,35
10,8478115,Pierre Engvall,L,NYI,28,82,18,17,35
10,8480009,Eeli Tolvanen,R,SEA,25,82,15,20,35
10,8477948,Travis Sanheim,D,PHI,28,82,13,22,35
10,8480434,Sean Durzi,D,ARI,26,82,12,23,35
10,8480220,Noah Cates,L,PHI,25,82,12,23,35
10,8476875,Mike Matheson,D,MTL,30,82,11,24,35
10,8480336,Sean Walker,D,COL,30,82,11,24,35
10,8480185,Eetu Luostarinen,C,FLA,26,82,9,26,35
10,8475753,Justin Faulk,D,STL,32,82,6,29,35
10,8478507,John Marino,D,NJD,27,82,5,30,35
10,8482146,Luke Evangelista,R,NSH,22,82,16,18,34
10,8482671,Owen Power,D,BUF,22,82,11,23,34
10,8475791,Taylor Hall,L,CHI,33,82,9,25,34
10,8479423,Alex Nylander,L,CBJ,26,82,18,15,33
10,8478020,Michael Amadio,C,VGK,28,82,18,15,33
10,8483431,Logan Cooley,C,ARI,20,82,17,16,33
10,8477947,Sonny Milano,L,WSH,28,82,15,18,33
10,8478013,Jake Walman,D,DET,28,82,13,20,33
10,8482720,Matthew Knies,L,TOR,22,82,12,21,33
10,8482117,Lukas Reichel,L,CHI,22,82,11,22,33
10,8477488,Brett Pesce,D,CAR,30,82,9,24,33
10,8475764,Cam Fowler,D,ANA,33,82,8,25,33
10,8476958,Jaccob Slavin,D,CAR,30,82,5,28,33
10,8480855,Jack McBain,C,ARI,24,82,16,16,32
10,8477952,Robby Fabbri,C,DET,28,82,15,17,32
10,8477451,Ryan Hartman,R,MIN,30,82,14,18,32
10,8479316,Luke Kunin,C,SJS,27,82,14,18,32
10,8482475,Yegor Chinakhov,R,CBJ,23,82,13,19,32
10,8482175,JJ Peterka,R,BUF,22,82,9,23,32
10,8476461,Sean Couturier,C,PHI,32,82,9,23,32
10,8481656,Aliaksei Protas,C,WSH,23,82,8,24,32
10,8480043,Timothy Liljegren,D,TOR,25,82,7,25,32
10,8480821,Filip Zadina,R,SJS,25,82,19,12,31
10,8479365,Trent Frederic,C,BOS,26,82,17,14,31
10,8474870,Tyler Johnson,C,CHI,34,82,15,16,31
10,8484166,Adam Fantilli,C,CBJ,20,82,14,17,31
10,8476960,Andreas Athanasiou,C,CHI,30,82,12,19,31
10,8480028,Morgan Frost,C,PHI,25,82,11,20,31
10,8475714,Calle Jarnkrok,C,TOR,33,82,9,22,31
10,8475218,Mattias Ekholm,D,EDM,34,82,9,22,31
10,8476885,Jacob Trouba,D,NYR,30,82,8,23,31
10,8480871,Adam Boqvist,D,CBJ,24,82,6,25,31
10,8476979,Erik Gustafsson,D,NYR,32,82,6,25,31
10,8479390,Taylor Raddysh,R,CHI,26,82,18,12,30
10,8476880,Tom Wilson,R,WSH,30,82,17,13,30
10,8482702,Logan Stankoven,C,DAL,21,82,16,14,30
10,8481704,Juuso Parssinen,C,NSH,23,82,16,14,30
10,8475149,Marcus Johansson,L,MIN,34,82,16,14,30
10,8479525,Ross Colton,C,COL,28,82,15,15,30
10,8477964,Ivan Barbashev,C,VGK,29,82,13,17,30
10,8477944,Jakub Vrana,L,STL,28,82,13,17,30
10,8483515,Juraj Slafkovsky,L,MTL,20,82,12,18,30
10,8479591,Michael Eyssimont,C,TBL,28,82,11,19,30
10,8478851,Alexandre Carrier,D,NSH,28,82,10,20,30
10,8482073,Braden Schneider,D,NYR,23,82,7,23,30
10,8477969,Marcus Pettersson,D,PIT,28,82,5,25,30
10,8482122,Brock Faber,D,MIN,22,82,2,28,30
10,8483499,Liam Ohgren,L,MIN,20,82,16,13,29
10,8481624,Ilya Mikheyev,R,VAN,30,82,13,16,29
10,8475191,Reilly Smith,R,PIT,33,82,9,20,29
10,8480849,Barrett Hayton,C,ARI,24,82,9,20,29
10,8474037,James van Riemsdyk,L,BOS,35,82,7,22,29
10,8470613,Brent Burns,D,CAR,39,82,7,22,29
10,8481546,Cam York,D,PHI,23,82,6,23,29
10,8476312,Josh Manson,D,COL,33,82,5,24,29
10,8475906,John Klingberg,D,TOR,32,82,3,26,29
10,8482733,Logan Mailloux,D,MTL,31,82,3,26,29
10,8481604,Pavel Dorofeyev,L,VGK,24,82,20,8,28
10,8482809,Jackson Blake,R,CAR,21,82,19,9,28
10,8476981,Josh Anderson,R,MTL,30,82,18,10,28
10,8476921,Jordan Martinook,L,CAR,32,82,13,15,28
10,8477511,Anthony Mantha,R,VGK,30,82,13,15,28
10,8478057,Dakota Joshua,C,VAN,28,82,13,15,28
10,8476871,Tanner Pearson,L,MTL,32,82,12,16,28
10,8477425,Miles Wood,L,COL,29,82,11,17,28
10,8473563,Nicklas Backstrom,C,WSH,37,82,7,21,28
10,8478911,Matt Roy,D,LAK,29,82,6,22,28
10,8484153,Leo Carlsson,C,ANA,20,82,14,13,27
10,8482624,Daniil Miromanov,D,CGY,27,82,12,15,27
10,8476469,Joel Armia,R,MTL,31,82,12,15,27
10,8480448,Parker Kelly,L,OTT,25,82,12,15,27
10,8475793,Ryan Johansen,C,PHI,32,82,11,16,27
10,8481554,Kaapo Kakko,R,NYR,23,82,11,16,27
10,8477450,Jason Dickinson,C,CHI,29,82,11,16,27
10,8476480,Vladislav Namestnikov,C,WPG,32,82,10,17,27
10,8481028,Martin Pospisil,C,CGY,25,82,10,17,27
10,8482730,Brandt Clarke,D,LAK,21,82,8,19,27
10,8478840,Will Borgen,D,SEA,28,82,5,22,27
10,8476923,Damon Severson,D,CBJ,30,82,4,23,27
10,8479398,Samuel Girard,D,COL,26,82,3,24,27
10,8478500,Ivan Provorov,D,CBJ,27,82,3,24,27
10,8474673,TJ Brodie,D,TOR,34,82,3,24,27
10,8477330,Dominik Kubalik,L,OTT,29,82,15,11,26
10,8470610,Zach Parise,L,COL,40,82,13,13,26
10,8482259,Bobby McMann,C,TOR,28,82,13,13,26
10,8476878,Zemgus Girgensons,L,BUF,30,82,13,13,26
10,8479351,Sam Steel,C,DAL,26,82,12,14,26
10,8470621,Corey Perry,R,EDM,39,82,11,15,26
10,8475848,Brendan Gallagher,R,MTL,32,82,11,15,26
10,8482803,Olen Zellweger,D,ANA,21,82,10,16,26
10,8478451,Ethan Bear,D,WSH,27,82,9,17,26
10,8481481,Blake Lizotte,C,LAK,27,82,9,17,26
10,8477507,Nikita Zadorov,D,VAN,29,82,8,18,26
10,8475343,Nic Dowd,C,WSH,34,82,6,20,26
10,8478882,Vladislav Gavrikov,D,LAK,29,82,5,21,26
10,8476792,Torey Krug,D,STL,33,82,4,22,26
10,8482655,J.J. Moser,D,ARI,24,82,4,22,26
10,8481568,Alex Vlasic,D,CHI,23,82,4,22,26
10,8474151,Ryan McDonagh,D,NSH,35,82,2,24,26
10,8483491,Ivan Miroshnichenko,L,WSH,20,82,15,10,25
10,8470604,Jeff Carter,C,PIT,39,82,11,14,25
10,8484145,Zach Benson,L,BUF,19,82,10,15,25
10,8477508,Curtis Lazar,C,NJD,29,82,10,15,25
10,8477506,Ryan Pulock,D,NYI,30,82,9,16,25
10,8476927,Teddy Blueger,C,VAN,30,82,6,19,25
10,8476902,Esa Lindell,D,DAL,30,82,6,19,25
10,8478463,Anthony Beauvillier,L,NSH,27,82,5,20,25
10,8473449,Kyle Okposo,R,FLA,36,82,14,10,24
10,8474715,Cam Atkinson,R,PHI,35,82,14,10,24
10,8480074,Alexandre Texier,C,CBJ,25,82,11,13,24
10,8475171,Oliver Ekman-Larsson,D,FLA,33,82,9,15,24
10,8476422,Mike Reilly,D,NYI,31,82,9,15,24
10,8480113,Alex Iafallo,L,WPG,31,82,8,16,24
10,8478891,Mason Appleton,C,WPG,28,82,8,16,24
10,8477498,Darnell Nurse,D,EDM,29,82,5,19,24
10,8476463,Jonas Brodin,D,MIN,31,82,5,19,24
10,8482166,Shakir Mukhamadullin,D,SJS,22,82,5,19,24
10,8481016,Ruslan Iskhakov,C,NYI,24,82,4,20,24
10,8479983,Mario Ferraro,D,SJS,26,82,4,20,24
10,8480246,Nick Perbix,D,TBL,26,82,2,22,24
10,8482145,Mavrik Bourque,C,DAL,22,82,15,8,23
10,8479977,Kailer Yamamoto,R,SEA,26,82,14,9,23
10,8482111,Justin Barron,D,MTL,23,82,12,11,23
10,8481580,Connor McMichael,C,WSH,23,82,11,12,23
10,8480813,Joe Veleno,C,DET,24,82,10,13,23
10,8479415,Michael McLeod,C,NJD,26,82,9,14,23
10,8477505,Alexander Wennberg,C,NYR,30,82,9,14,23
10,8480806,Isac Lundestrom,C,ANA,25,82,8,15,23
10,8477353,Tyler Motte,C,TBL,29,82,7,16,23
10,8479992,Michael Rasmussen,C,DET,25,82,7,16,23
10,8474574,Tyler Myers,D,VAN,34,82,7,16,23
10,8476891,Matt Grzelcyk,D,BOS,30,82,6,17,23
10,8480873,Rasmus Sandin,D,WSH,24,82,4,19,23
10,8475233,David Savard,D,MTL,34,82,4,19,23
10,8474149,Evgenii Dadonov,R,DAL,35,82,3,20,23
10,8482118,Sam Colangelo,R,ANA,23,82,18,4,22
10,8478508,Yakov Trenin,C,COL,27,82,13,9,22
10,8482079,Marco Rossi,C,MIN,23,82,11,11,22
10,8477953,Kasperi Kapanen,R,STL,28,82,11,11,22
10,8477015,Connor Brown,R,EDM,30,82,11,11,22
10,8474189,Lars Eller,C,PIT,35,82,10,12,22
10,8480144,David Kampf,C,TOR,29,82,9,13,22
10,8476278,Colin Blackwell,C,CHI,31,82,8,14,22
10,8477365,Connor Clifton,D,BUF,29,82,8,14,22
10,8480796,Martin Fehervary,D,WSH,25,82,7,15,22
10,8483565,Nick Blankenburg,D,CBJ,26,82,6,16,22
10,8482087,Kaiden Guhle,D,MTL,22,82,5,17,22
10,8480073,Erik Brannstrom,D,OTT,25,82,5,17,22
10,8478443,Brandon Carlo,D,BOS,28,82,5,17,22
10,8482142,Jamie Drysdale,D,PHI,22,82,4,18,22
10,8480145,Neal Pionk,D,WPG,29,82,3,19,22
10,8475177,Calvin de Haan,D,TBL,33,82,3,19,22
10,8482858,Ryker Evans,D,SEA,23,82,3,19,22
10,8476429,Scott Mayfield,D,NYI,32,82,2,20,22
10,8476931,Jake McCabe,D,TOR,31,82,1,21,22
10,8476925,Colton Sissons,C,NSH,31,82,13,8,21
10,8482737,Zack Bolduc,C,STL,21,82,12,9,21
10,8482155,Alex Laferriere,R,LAK,23,82,12,9,21
10,8481601,Simon Holmstrom,R,NYI,23,82,11,10,21
10,8482125,Alexander Holtz,R,NJD,22,82,10,11,21
10,8477392,Hudson Fasching,R,NYI,29,82,10,11,21
10,8481013,Jonatan Berggren,R,DET,24,82,9,12,21
10,8479346,Dillon Dube,C,CGY,26,82,8,13,21
10,8481553,Bobby Brink,R,PHI,23,82,8,13,21
10,8476372,Nick Seeler,D,PHI,31,82,8,13,21
10,8479353,Brett Howden,C,VGK,26,82,7,14,21
10,8478430,Oliver Kylington,D,CGY,27,82,6,15,21
10,8478178,Darren Raddysh,D,TBL,28,82,5,16,21
10,8478569,Noel Acciari,C,PIT,33,82,5,16,21
10,8474034,Pat Maroon,L,BOS,36,82,5,16,21
10,8470966,Mark Giordano,D,TOR,41,82,4,17,21
10,8479371,Dante Fabbro,D,NSH,26,82,3,18,21
10,8483490,Pavel Mintyukov,D,ANA,21,82,3,18,21
10,8479976,Juuso Valimaki,D,ARI,26,82,3,18,21
10,8482245,Artem Zub,D,OTT,29,82,3,18,21
10,8476917,Adam Pelech,D,NYI,30,82,2,19,21
10,8483493,Frank Nazar,C,CHI,20,82,15,5,20
10,8484203,Bradly Nadeau,L,CAR,19,82,13,7,20
10,8482666,Scott Morrow,D,CAR,22,82,13,7,20
10,8479941,Justin Danforth,R,CBJ,31,82,12,8,20
10,8479393,Noah Gregor,C,TOR,26,82,12,8,20
10,8476873,Mark Jankowski,C,NSH,30,82,10,10,20
10,8479514,Rem Pitlick,C,CHI,27,82,10,10,20
10,8482679,Matt Coronato,R,CGY,22,82,9,11,20
10,8481537,Nikita Okhotiuk,D,CGY,24,82,7,13,20
10,8474565,Alex Pietrangelo,D,VGK,34,82,6,14,20
10,8479293,Brandon Tanev,L,SEA,33,82,6,14,20
10,8480172,Jan Rutta,D,SJS,34,82,6,14,20
10,8480817,K'Andre Miller,D,NYR,24,82,5,15,20
10,8476525,Colin Miller,D,WPG,32,82,5,15,20
10,8480068,Ryan Poehling,C,PHI,25,82,5,15,20
10,8482074,Connor Zary,C,CGY,23,82,4,16,20
10,8474716,Jared Spurgeon,D,MIN,35,82,4,16,20
10,8478416,Erik Cernak,D,TBL,27,82,4,16,20
10,8479324,Ryan Lindgren,D,NYR,26,82,4,16,20
10,8476854,Hampus Lindholm,D,BOS,30,82,3,17,20
10,8476892,Colton Parayko,D,STL,31,82,3,17,20
10,8480807,Mattias Samuelsson,D,BUF,24,82,3,17,20
10,8475462,Radko Gudas,D,ANA,34,82,2,18,20
10,8480459,Pius Suter,C,VAN,28,82,12,7,19
10,8477839,Conor Sheary,L,TBL,32,82,9,10,19
10,8476374,Sean Kuraly,C,CBJ,31,82,8,11,19
10,8476442,Matt Nieto,L,PIT,32,82,8,11,19
10,8478043,Sam Lafferty,C,VAN,29,82,7,12,19
10,8481606,Jordan Spence,D,LAK,23,82,6,13,19
10,8484911,Collin Graf,R,SJS,22,82,5,14,19
10,8480035,Henri Jokiharju,D,BUF,25,82,4,15,19
10,8478399,Jonas Siegenthaler,D,NJD,27,82,4,15,19
10,8480860,Kevin Bahl,D,NJD,24,82,3,16,19
10,8475179,Dmitry Kulikov,D,FLA,34,82,2,17,19
10,8476457,Adam Larsson,D,SEA,32,82,2,17,19
10,8481524,Bowen Byram,D,BUF,23,82,2,17,19
10,8475790,Erik Gudbranson,D,CBJ,32,82,0,19,19
10,8481477,Nico Sturm,C,SJS,29,82,9,9,18
10,8478831,Kevin Stenlund,C,FLA,28,82,9,9,18
10,8482712,Oskar Olausson,R,COL,22,82,7,11,18
10,8480058,Pierre-Olivier Joseph,D,PIT,25,82,7,11,18
10,8473453,Trevor Lewis,C,LAK,37,82,7,11,18
10,8482062,Cole Smith,L,NSH,29,82,6,12,18
10,8481014,Alexander Romanov,D,NYI,24,82,5,13,18
10,8478136,Jake Middleton,D,MIN,28,82,5,13,18
10,8482762,Simon Edvinsson,D,DET,21,82,5,13,18
10,8475181,Nick Leddy,D,STL,33,82,4,14,18
10,8479369,Andrew Peeke,D,BOS,26,82,3,15,18
10,8475324,Nick Jensen,D,WSH,34,82,3,15,18
10,8481178,Egor Zamula,D,PHI,24,82,3,15,18
10,8475188,Brayden McNabb,D,VGK,33,82,2,16,18
10,8481567,Henry Thrun,D,SJS,23,82,1,17,18
10,8477406,Mattias Janmark,C,EDM,32,82,10,7,17
10,8481517,Brett Leason,R,ANA,25,82,9,8,17
10,8476624,Barclay Goodrow,C,NYR,31,82,9,8,17
10,8479383,Boris Katchouk,L,OTT,26,82,8,9,17
10,8481093,Rafael Harvey-Pinard,L,MTL,25,82,6,11,17
10,8476331,Dylan DeMelo,D,WPG,31,82,6,11,17
10,8476858,Phillip Di Giuseppe,L,VAN,31,82,6,11,17
10,8478468,Jeremy Lauzon,D,NSH,27,82,5,12,17
10,8475164,Jakob Silfverberg,R,ANA,34,82,4,13,17
10,8477335,Kyle Burroughs,D,SJS,29,82,4,13,17
10,8480879,Jacob Bernard-Docker,D,OTT,24,82,4,13,17
10,8483466,Kevin Korchinski,D,CHI,20,82,3,14,17
10,8475690,Chris Tanev,D,DAL,35,82,2,15,17
10,8474567,Zach Bogosian,D,MIN,34,82,2,15,17
10,8479661,Tanner Jeannot,L,TBL,27,82,10,6,16
10,8480281,Alexey Toropchenko,R,STL,25,82,9,7,16
10,8476897,Oskar Sundqvist,C,STL,30,82,5,11,16
10,8470600,Ryan Suter,D,DAL,39,82,5,11,16
10,8477919,Frederick Gaudreau,C,MIN,31,82,4,12,16
10,8476967,Brett Kulak,D,EDM,30,82,4,12,16
10,8475455,Brenden Dillon,D,WPG,34,82,3,13,16
10,8480834,Ty Emberson,D,SJS,24,82,3,13,16
10,8478859,Niko Mikkola,D,FLA,28,82,8,7,15
10,8483505,Matthew Poitras,C,BOS,20,82,7,8,15
10,8477220,Nate Schmidt,D,WPG,33,82,6,9,15
10,8476467,Jamie Oleksiak,D,SEA,32,82,5,10,15
10,8475825,Jani Hakanpää,D,DAL,32,82,5,10,15
10,8479291,Kevin Rooney,C,CGY,31,82,5,10,15
10,8473507,Jeff Petry,D,DET,37,82,4,11,15
10,8479980,Nicolas Hague,D,VGK,26,82,4,11,15
10,8481059,Scott Perunovich,D,STL,26,82,4,11,15
10,8475762,Derek Forbort,D,BOS,32,82,3,12,15
10,8477845,Trevor van Riemsdyk,D,WSH,33,82,2,13,15
10,8483495,Simon Nemec,D,NJD,20,82,1,14,15
10,8481522,Peyton Krebs,C,BUF,23,82,5,9,14
10,8479359,Beck Malenstyn,L,WSH,26,82,5,9,14
10,8477369,Carson Soucy,D,VAN,30,82,5,9,14
10,8479998,Mikey Anderson,D,LAK,25,82,4,10,14
10,8475279,Ben Chiarot,D,DET,33,82,4,10,14
10,8474013,Ian Cole,D,VAN,35,82,4,10,14
10,8483482,Tristan Luneau,D,ANA,20,82,4,10,14
10,8477499,Rasmus Ristolainen,D,PHI,30,82,1,13,14
10,8476879,Cody Ceci,D,EDM,31,82,1,13,14
10,8480990,Declan Chisholm,D,MIN,24,82,8,5,13
10,8475231,Casey Cizikas,C,NYI,33,82,5,8,13
10,8476822,Luke Glendening,C,TBL,35,82,5,8,13
10,8481605,Jackson LaCombe,D,ANA,23,82,4,9,13
10,8477931,Tomas Nosek,L,NJD,32,82,4,9,13
10,8471677,Jack Johnson,D,COL,37,82,3,10,13
10,8477034,Jaycob Megna,D,CHI,32,82,3,10,13
10,8474166,Alec Martinez,D,VGK,37,82,3,10,13
10,8475208,Brian Dumoulin,D,SEA,33,82,2,11,13
10,8475842,Sam Carrick,C,EDM,32,82,2,11,13
10,8482470,Ilya Solovyov,D,CGY,24,82,1,12,13
10,8482177,Marat Khusnutdinov,C,MIN,22,82,5,7,12
10,8477435,Ryan Graves,D,PIT,29,82,4,8,12
10,8475200,Dmitry Orlov,D,CAR,33,82,3,9,12
10,8478408,Travis Dermott,D,ARI,28,82,2,10,12
10,8476473,Connor Murphy,D,CHI,31,82,4,7,11
10,8483763,Maksymilian Szuber,D,ARI,22,82,3,8,11
10,8476915,Jujhar Khaira,L,MIN,30,82,3,8,11
10,8480980,Connor Dewar,C,TOR,25,82,2,9,11
10,8473504,Cal Clutterbuck,R,NYI,37,82,1,10,11
10,8483489,Fraser Minten,C,TOR,31,82,6,4,10
10,8483012,Logan Morrison,C,SEA,22,82,5,5,10
10,8481578,Graeme Clarke,R,NJD,23,82,4,6,10
10,8481599,Victor Soderstrom,D,ARI,23,82,3,6,9
10,8479442,Troy Stecher,D,EDM,30,82,2,7,9
10,8484149,Gavin Brindley,C,CBJ,20,82,2,7,9
10,8481030,Jack St. Ivany,D,PIT,25,82,4,4,8
10,8474009,Nick Bonino,C,NYR,36,82,2,6,8
10,8482713,Mackie Samoskevich,R,FLA,22,82,3,4,7
10,8482516,Matthew Kessel,D,STL,24,82,1,6,7
10,8483468,Jiri Kulich,C,BUF,20,82,2,4,6
10,8482859,Zack Ostapchuk,C,OTT,21,82,0,6,6
10,8482807,Ethan Del Mastro,D,CHI,21,82,1,4,5
10,8482141,Lukas Cormier,D,VGK,22,0,0,0,0
10,8476988,Matt Benning,D,SJS,30,0,0,0,0
10,8480727,Zach Whitecloud,D,VGK,28,0,0,0,0
10,8480887,Jordan Harris,D,MTL,24,0,0,0,0
10,8478450,Parker Wotherspoon,D,BOS,27,0,0,0,0
10,8481812,Nikolai Knyzhov,D,SJS,27,0,0,0,0
10,8480001,Urho Vaakanainen,D,ANA,25,0,0,0,0
10,8482176,Wyatt Kaiser,D,CHI,22,0,0,0,0
10,8481122,Simon Benoit,D,TOR,26,0,0,0,0
10,8476441,Joel Edmundson,D,TOR,31,0,0,0,0
10,8480884,Calen Addison,D,SJS,24,0,0,0,0
10,8482511,Mason Lohrei,D,BOS,23,0,0,0,0
10,8482192,Isaak Phillips,D,CHI,23,0,0,0,0
10,8480950,Ilya Lyubushkin,D,TOR,30,0,0,0,0
10,8474031,Kevin Shattenkirk,D,BOS,35,0,0,0,0
10,8475718,Justin Holl,D,DET,32,0,0,0,0
10,8479402,Jake Bean,D,CBJ,26,0,0,0,0
10,8474602,Justin Schultz,D,SEA,34,0,0,0,0
10,8477950,Tony DeAngelo,D,CAR,29,0,0,0,0
10,8481743,Marc Del Gaizo,D,NSH,25,0,0,0,0
10,8481527,Kaedan Korczak,D,VGK,23,0,0,0,0
10,8480192,Johnathan Kovacevic,D,MTL,27,0,0,0,0
10,8476874,Olli Maatta,D,DET,30,0,0,0,0
10,8482144,Jack Thompson,D,SJS,22,0,0,0,0
10,8480222,Sebastian Aho,D,NYI,28,0,0,0,0
10,8479458,Nikita Zaitsev,D,CHI,33,0,0,0,0
10,8471709,Marc-Edouard Vlasic,D,SJS,37,0,0,0,0
10,8482929,Emil Lilleberg,D,TBL,23,0,0,0,0
10,8477018,Ben Hutton,D,VGK,31,0,0,0,0
10,8481056,Spencer Stastney,D,NSH,24,0,0,0,0
10,8481593,Jayden Struble,D,MTL,23,0,0,0,0
10,8479982,Conor Timmins,D,TOR,26,0,0,0,0
10,8474090,Brendan Smith,D,NJD,35,0,0,0,0
10,8482964,Arber Xhekaj,D,MTL,23,0,0,0,0
10,8480891,Michael Kesselring,D,ARI,24,0,0,0,0
10,8477938,Haydn Fleury,D,TBL,28,0,0,0,0
10,8481806,Louis Crevier,D,CHI,23,0,0,0,0
10,8471274,Alex Goligoski,D,MIN,39,0,0,0,0
10,8481600,Tobias Bjornfot,D,FLA,23,0,0,0,0
10,8475797,Jarred Tinordi,D,CHI,32,0,0,0,0
10,8481521,Ronnie Attard,D,PHI,25,0,0,0,0
10,8474612,Travis Hamonic,D,OTT,34,0,0,0,0
10,8479576,Vincent Desharnais,D,EDM,28,0,0,0,0
10,8480049,Dylan Samberg,D,WPG,25,0,0,0,0
10,8483619,Filip Roos,D,CHI,25,0,0,0,0
10,8474568,Luke Schenn,D,NSH,35,0,0,0,0
10,8480184,Gustav Lindstrom,D,ANA,26,0,0,0,0
10,8480070,Ian Mitchell,D,BOS,25,0,0,0,0
10,8480196,Jacob Bryson,D,BUF,27,0,0,0,0
10,8471686,Marc Staal,D,PHI,37,0,0,0,0
10,8477467,Gustav Olofsson,D,SEA,30,0,0,0,0
10,8478970,Jalen Chatfield,D,CAR,28,0,0,0,0
10,8479348,Kale Clague,D,BUF,26,0,0,0,0
10,8473446,Erik Johnson,D,PHI,36,0,0,0,0
10,8477462,Robert Hagg,D,ANA,29,0,0,0,0
10,8478454,Noah Juulsen,D,VAN,27,0,0,0,0
10,8477384,Josh Brown,D,ARI,30,0,0,0,0
10,8481708,Zac Jones,D,NYR,24,0,0,0,0
10,8481167,Brayden Pachal,D,CGY,25,0,0,0,0
10,8482067,Connor Mackey,D,NYR,28,0,0,0,0
10,8483460,David Jiricek,D,CBJ,21,0,0,0,0
10,8481701,Santeri Hatakka,D,NJD,23,0,0,0,0
10,8478021,William Lagesson,D,ANA,28,0,0,0,0
10,8477851,Jordan Oesterle,D,CGY,32,0,0,0,0
10,8478452,Caleb Jones,D,COL,27,0,0,0,0
10,8479984,Cal Foote,D,NJD,26,0,0,0,0
10,8479639,Dylan Coghlan,D,CAR,26,0,0,0,0
10,8480874,Adam Ginning,D,PHI,24,0,0,0,0
10,8479321,Lucas Johansen,D,WSH,27,0,0,0,0
10,8480878,Nils Lundkvist,D,DAL,24,0,0,0,0
10,8482165,Yan Kuznetsov,D,CGY,22,0,0,0,0
10,8484258,Sam Malinski,D,COL,26,0,0,0,0
10,8480157,Calle Rosen,D,STL,30,0,0,0,0
10,8484304,Uvis Balinskis,D,FLA,28,0,0,0,0
10,8479985,Cale Fleury,D,SEA,26,0,0,0,0
10,8479378,Logan Stanley,D,WPG,26,0,0,0,0
10,8477541,Dakota Mermis,D,MIN,30,0,0,0,0
10,8481609,Vladislav Kolyachonok,D,ARI,23,0,0,0,0
10,8480823,Alexander Alexeyev,D,WSH,25,0,0,0,0
10,8481679,Maxence Guenette,D,OTT,23,0,0,0,0
10,8481564,Ryan Johnson,D,BUF,23,0,0,0,0
10,8479376,Victor Mete,D,PHI,26,0,0,0,0
10,8484254,Akito Hirose,D,VAN,25,0,0,0,0
10,8482660,Kent Johnson,C,CBJ,22,0,0,0,0
10,8482149,Cole Perfetti,C,WPG,22,0,0,0,0
10,8477987,Ryan Donato,C,CHI,28,0,0,0,0
10,8475755,Alexander Petrovic,D,DAL,32,0,0,0,0
10,8477810,Joel Hanley,D,CGY,33,0,0,0,0
10,8474145,Robert Bortuzzo,D,NYI,35,0,0,0,0
10,8481161,Jake Christiansen,D,CBJ,25,0,0,0,0
10,8476884,Derrick Pouliot,D,DAL,30,0,0,0,0
10,8481716,Dmitri Voronkov,L,CBJ,24,0,0,0,0
10,8480084,Nick DeSimone,D,NJD,30,0,0,0,0
10,8475750,Jon Merrill,D,MIN,32,0,0,0,0
10,8479315,Joey Anderson,R,CHI,26,0,0,0,0
10,8478011,Louie Belpedio,D,PHI,28,0,0,0,0
10,8482451,Mikael Pyyhtia,L,CBJ,23,0,0,0,0
10,8481541,Samuel Bolduc,D,NYI,24,0,0,0,0
10,8482126,Emil Andrae,D,PHI,31,0,0,0,0
10,8474618,Marco Scandella,D,STL,34,0,0,0,0
10,8477244,Chad Ruhwedel,D,NYR,34,0,0,0,0
10,8477971,Andreas Englund,D,LAK,28,0,0,0,0
10,8480829,Jesperi Kotkaniemi,C,CAR,24,0,0,0,0
10,8479372,Josh Mahura,D,FLA,26,0,0,0,0
10,8482095,Tyler Kleven,D,OTT,22,0,0,0,0
10,8481719,Maxwell Crozier,D,TBL,24,0,0,0,0
10,8475855,Jesper Fast,R,CAR,33,0,0,0,0
10,8480848,Ty Dellandrea,C,DAL,24,0,0,0,0
10,8475193,Tomas Tatar,L,SEA,34,0,0,0,0
10,8476889,Radek Faksa,C,DAL,30,0,0,0,0
10,8478495,Denis Gurianov,R,PHI,27,0,0,0,0
10,8480216,Jacob Peterson,C,SJS,25,0,0,0,0
10,8480252,Cole Guttman,C,CHI,25,0,0,0,0
10,8479026,Philippe Myers,D,TBL,27,0,0,0,0
10,8481006,Tyler Tucker,D,STL,24,0,0,0,0
10,8481032,Paul Cotter,C,VGK,25,0,0,0,0
10,8481577,Philip Tomasino,C,NSH,23,0,0,0,0
10,8476918,Jimmy Vesey,L,NYR,31,0,0,0,0
10,8479320,Max Lajoie,D,TOR,27,0,0,0,0
10,8478017,Mark Friedman,D,VAN,29,0,0,0,0
10,8481754,Nikita Nesterenko,C,ANA,23,0,0,0,0
10,8483407,Brandon Scanlin,D,NYR,25,0,0,0,0
10,8482659,Josh Doan,R,ARI,22,0,0,0,0
10,8477446,Michael McCarron,R,NSH,29,0,0,0,0
10,8477903,Garnet Hathaway,R,PHI,33,0,0,0,0
10,8482153,Brendan Brisson,C,VGK,23,0,0,0,0
10,8483546,Marshall Rifai,D,TOR,26,0,0,0,0
10,8484287,Cole McWard,D,VAN,23,0,0,0,0
10,8478854,Ryan Shea,D,PIT,27,0,0,0,0
10,8481585,Egor Afanasyev,L,NSH,23,0,0,0,0
10,8483398,Declan Carlile,D,TBL,31,0,0,0,0
10,8478502,Dennis Gilbert,D,CGY,28,0,0,0,0
10,8482749,Joshua Roy,R,MTL,21,0,0,0,0
10,8481598,Philip Broberg,D,EDM,23,0,0,0,0
10,8480835,Jack Drury,C,CAR,24,0,0,0,0
10,8480748,Kiefer Sherwood,L,NSH,29,0,0,0,0
10,8476934,Brock McGinn,L,ANA,30,0,0,0,0
10,8480870,Bo Groulx,C,ANA,24,0,0,0,0
10,8479368,Max Jones,L,ANA,26,0,0,0,0
10,8478099,Kevin Labanc,R,SJS,29,0,0,0,0
10,8478067,Oskar Lindblom,L,SJS,28,0,0,0,0
10,8476393,Nick Cousins,C,FLA,31,0,0,0,0
10,8483395,Arshdeep Bains,L,VAN,23,0,0,0,0
10,8480762,Eric Robinson,L,BUF,29,0,0,0,0
10,8479439,Jacob MacDonald,D,SJS,31,0,0,0,0
10,8476474,Stefan Noesen,R,CAR,31,0,0,0,0
10,8482787,Nikita Chibrikov,R,WPG,31,0,0,0,0
10,8478432,Christian Fischer,R,DET,27,0,0,0,0
10,8477979,Nicolas Aube-Kubel,R,WSH,28,0,0,0,0
10,8481789,Tye Kartye,L,SEA,23,0,0,0,0
10,8479330,Brandon Gignac,C,MTL,27,0,0,0,0
10,8480075,Cameron Crotty,D,ARI,25,0,0,0,0
10,8473473,Milan Lucic,L,BOS,36,0,0,0,0
10,8482094,Daemon Hunt,D,MIN,22,0,0,0,0
10,8481206,John Ludvig,D,PIT,24,0,0,0,0
10,8483630,Pavol Regenda,L,ANA,25,0,0,0,0
10,8481617,Vasily Podkolzin,R,VAN,23,0,0,0,0
10,8480306,Grant Hutton,D,NYI,29,0,0,0,0
10,8480995,Pontus Holmberg,R,TOR,25,0,0,0,0
10,8482148,Hendrix Lapierre,C,WSH,22,0,0,0,0
10,8477478,William Carrier,L,VGK,30,0,0,0,0
10,8480003,Jesper Boqvist,C,BOS,26,0,0,0,0
10,8482172,Landon Slaggert,L,CHI,22,0,0,0,0
10,8480789,Oliver Wahlstrom,R,NYI,24,0,0,0,0
10,8474062,Riley Nash,C,NYR,35,0,0,0,0
10,8480021,Jack Studnicka,C,SJS,25,0,0,0,0
10,8480025,MacKenzie Entwistle,R,CHI,25,0,0,0,0
10,8481582,Nicholas Robertson,L,TOR,23,0,0,0,0
10,8476867,Brendan Gaunce,C,CBJ,30,0,0,0,0
10,8479619,Michael Carcone,L,ARI,28,0,0,0,0
10,8479370,Tyson Jost,C,BUF,26,0,0,0,0
10,8479671,Mathieu Olivier,R,CBJ,27,0,0,0,0
10,8476994,Vinnie Hinostroza,C,PIT,30,0,0,0,0
10,8482070,Mitchell Chaffee,R,TBL,26,0,0,0,0
10,8477473,Justin Bailey,R,SJS,29,0,0,0,0
10,8479344,Jesse Puljujarvi,R,PIT,26,0,0,0,0
10,8480205,Emil Bemstrom,C,PIT,25,0,0,0,0
10,8479718,Alex Barré-Boulet,C,TBL,27,0,0,0,0
10,8482061,Brandon Biro,L,BUF,26,0,0,0,0
10,8479638,Justin Brazeau,R,BOS,26,0,0,0,0
10,8474040,Sam Gagner,C,EDM,35,0,0,0,0
10,8477846,Ryan Carpenter,C,SJS,33,0,0,0,0
10,8482077,Dylan Holloway,L,EDM,23,0,0,0,0
10,8482157,Will Cuylle,L,NYR,22,0,0,0,0
10,8480007,Jonas Rondbjerg,R,VGK,25,0,0,0,0
10,8478874,Adam Gaudette,C,STL,28,0,0,0,0
10,8478434,Keegan Kolesar,R,VGK,27,0,0,0,0
10,8480441,Trey Fix-Wolansky,R,CBJ,25,0,0,0,0
10,8479994,Jaret Anderson-Dolan,C,NSH,25,0,0,0,0
10,8483567,Georgii Merkulov,C,BOS,24,0,0,0,0
10,8477380,Jonny Brodzinski,C,NYR,31,0,0,0,0
10,8482201,Gage Goncalves,C,TBL,23,0,0,0,0
10,8478211,Dryden Hunt,L,CGY,29,0,0,0,0
10,8471699,Andrew Cogliano,C,COL,37,0,0,0,0
10,8479421,Jacob Moverare,D,LAK,26,0,0,0,0
10,8478881,Brett Seney,L,CHI,28,0,0,0,0
10,8477464,Nic Petan,C,MIN,29,0,0,0,0
10,8475958,Michael Sgarbossa,C,WSH,32,0,0,0,0
10,8481147,Reese Johnson,C,CHI,26,0,0,0,0
10,8479336,Carl Grundstrom,R,LAK,27,0,0,0,0
10,8480853,Liam Foudy,C,NSH,24,0,0,0,0
10,8479522,Hardy Haman Aktell,D,WSH,26,0,0,0,0
10,8481462,Mason Morelli,L,VGK,28,0,0,0,0
10,8482102,Vasily Ponomarev,C,CAR,22,0,0,0,0
10,8480844,Grigori Denisenko,L,VGK,24,0,0,0,0
10,8479944,Zach Aston-Reese,C,DET,30,0,0,0,0
10,8482784,Zach Dean,C,STL,21,0,0,0,0
10,8479419,Brett Murray,L,BUF,26,0,0,0,0
10,8479520,Brandon Duhaime,R,COL,27,0,0,0,0
10,8477573,Nathan Walker,L,STL,30,0,0,0,0
10,8478078,Rourke Chartier,C,OTT,28,0,0,0,0
10,8475795,Dylan McIlrath,D,WSH,32,0,0,0,0
10,8482496,Nils Aman,C,VAN,24,0,0,0,0
10,8480289,Morgan Barron,C,WPG,26,0,0,0,0
10,8481751,Lukas Rousek,R,BUF,25,0,0,0,0
10,8480011,Klim Kostin,C,SJS,25,0,0,0,0
10,8481556,John Beecher,C,BOS,23,0,0,0,0
10,8475278,Byron Froese,C,VGK,33,0,0,0,0
10,8475225,Craig Smith,C,DAL,35,0,0,0,0
10,8484326,Patrik Koch,D,ARI,28,0,0,0,0
10,8477930,Pierre-Edouard Bellemare,L,SEA,39,0,0,0,0
10,8478409,Anthony Richard,C,BOS,28,0,0,0,0
10,8481024,Linus Karlsson,C,VAN,25,0,0,0,0
10,8479986,Kole Lind,R,SEA,26,0,0,0,0
10,8479414,Nathan Bastian,R,NJD,27,0,0,0,0
10,8479362,Riley Tufte,L,COL,26,0,0,0,0
10,8481058,Jesse Ylönen,R,MTL,25,0,0,0,0
10,8482476,Emil Heineman,L,MTL,23,0,0,0,0
10,8482861,Vincent Iorio,D,WSH,22,0,0,0,0
10,8483432,Luca Del Bel Belluz,C,CBJ,31,0,0,0,0
10,8482744,James Malatesta,L,CBJ,21,0,0,0,0
10,8477887,Patrick Brown,C,BOS,32,0,0,0,0
10,8478585,Derek Ryan,C,EDM,38,0,0,0,0
10,8481441,Joe Snively,C,WSH,28,0,0,0,0
10,8481592,Jakob Pelletier,L,CGY,23,0,0,0,0
10,8482634,Alex Steeves,C,TOR,25,0,0,0,0
10,8477126,Jayson Megna,C,BOS,34,0,0,0,0
10,8475752,Tyler Pitlick,C,NYR,33,0,0,0,0
10,8480008,Adam Ruzicka,C,ARI,25,0,0,0,0
10,8481065,Angus Crookshank,L,OTT,25,0,0,0,0
10,8479547,Matthew Phillips,R,WSH,26,0,0,0,0
10,8480226,Marián Studenic,R,SEA,26,0,0,0,0
10,8481237,Kyle MacLean,C,NYI,25,0,0,0,0
10,8475413,Justin Dowling,C,NJD,34,0,0,0,0
10,8481641,Joel Kiviranta,L,COL,28,0,0,0,0
10,8478104,Sammy Blais,L,STL,28,0,0,0,0
10,8477454,Adam Erne,L,EDM,29,0,0,0,0
10,8481518,Nolan Foote,L,NJD,24,0,0,0,0
10,8480245,Olle Lycksell,R,PHI,25,0,0,0,0
10,8483570,Ben Meyers,C,ANA,26,0,0,0,0
10,8480776,Sheldon Rempal,R,VGK,29,0,0,0,0
10,8483920,Pierrick Dube,R,WSH,23,0,0,0,0
10,8480267,Sammy Walker,C,MIN,25,0,0,0,0
10,8482747,Brennan Othmann,L,NYR,21,0,0,0,0
10,8479991,Jake Leschyshyn,C,NYR,25,0,0,0,0
10,8478400,Colin White,C,MTL,27,0,0,0,0
10,8479328,Julien Gauthier,R,NYI,27,0,0,0,0
10,8484325,Waltteri Merela,C,TBL,26,0,0,0,0
10,8479066,Ryan Lomberg,L,FLA,30,0,0,0,0
10,8477070,Liam O'Brien,C,ARI,30,0,0,0,0
10,8478146,Matthew Highmore,C,OTT,28,0,0,0,0
10,8478028,Fredrik Olofsson,L,COL,28,0,0,0,0
10,8480880,Jakub Lauko,C,BOS,24,0,0,0,0
10,8479968,Vinni Lettieri,C,MIN,29,0,0,0,0
10,8474709,Matt Martin,L,NYI,35,0,0,0,0
10,8480845,Rasmus Kupari,C,WPG,24,0,0,0,0
10,8481550,Adam Beckman,L,MIN,23,0,0,0,0
10,8481422,Jacob Lucchini,C,MIN,29,0,0,0,0
10,8477401,John Hayden,C,SEA,29,0,0,0,0
10,8478904,Steven Lorentz,C,FLA,28,0,0,0,0
10,8482088,Justin Sourdif,R,FLA,22,0,0,0,0
10,8482751,Ryan Winterton,C,SEA,21,0,0,0,0
10,8482241,Radim Zohorna,L,PIT,28,0,0,0,0
10,8481690,Tyler Angle,C,CBJ,24,0,0,0,0
10,8476952,Dominic Toninato,C,WPG,30,0,0,0,0
10,8476919,Chris Tierney,C,NJD,30,0,0,0,0
10,8480032,Shane Bowers,C,NJD,25,0,0,0,0
10,8484314,Jiri Smejkal,L,OTT,28,0,0,0,0
10,8481239,Samuel Fagemo,L,LAK,24,0,0,0,0
10,8481532,Alex Turcotte,C,LAK,23,0,0,0,0
10,8481019,David Gustafsson,C,WPG,24,0,0,0,0
10,8478477,Mitchell Stephens,C,MTL,27,0,0,0,0
10,8479546,Oskar Steen,C,BOS,26,0,0,0,0
10,8480292,Carson Meyer,R,CBJ,27,0,0,0,0
10,8478446,Glenn Gawdin,C,ANA,27,0,0,0,0
10,8483531,Brian Halonen,L,NJD,25,0,0,0,0
10,8477149,Scott Sabourin,R,SJS,32,0,0,0,0
10,8479972,Mason Shaw,C,MIN,26,0,0,0,0
10,8480890,Jan Jenik,R,ARI,24,0,0,0,0
10,8478051,Max Willman,C,NJD,29,0,0,0,0
10,8480851,Akil Thomas,C,LAK,24,0,0,0,0
10,8482765,Isak Rosen,R,BUF,21,0,0,0,0
10,8478421,A.J. Greer,L,CGY,28,0,0,0,0
10,8478512,Austin Czarnik,C,DET,32,0,0,0,0
10,8479536,Axel Jonsson-Fjallby,L,WPG,26,0,0,0,0
10,8477320,Anton Blidh,L,NYR,29,0,0,0,0
10,8481543,Nikita Alexandrov,C,STL,24,0,0,0,0
10,8475235,Nicolas Deslauriers,L,PHI,33,0,0,0,0
10,8481070,Hugh McGing,L,STL,26,0,0,0,0
10,8480836,Jonathan Gruden,C,PIT,24,0,0,0,0
10,8481591,Sam Poulin,R,PIT,23,0,0,0,0
10,8477962,Brendan Lemieux,L,CAR,28,0,0,0,0
10,8483401,Marc Johnstone,R,PIT,28,0,0,0,0
10,8482250,Callahan Burke,C,CAR,27,0,0,0,0
10,8481726,Adam Edstrom,C,NYR,24,0,0,0,0
10,8471817,Ryan Reaves,R,TOR,37,0,0,0,0
10,8479587,Rhett Gardner,C,PHI,28,0,0,0,0
10,8475766,Austin Watson,L,TBL,32,0,0,0,0
10,8479367,William Lockwood,R,FLA,26,0,0,0,0
10,8478424,Jansen Harkins,C,PIT,27,0,0,0,0
10,8476913,Devin Shore,C,SEA,30,0,0,0,0
10,8482652,Walker Duehr,R,CGY,27,0,0,0,0
10,8477527,Ross Johnston,L,ANA,30,0,0,0,0
10,8481077,John Leonard,L,ARI,26,0,0,0,0
10,8483549,Lucas Condotta,L,MTL,27,0,0,0,0
10,8480468,James Hamblin,L,EDM,25,0,0,0,0
10,8476907,Mackenzie MacEachern,L,STL,30,0,0,0,0
10,8479543,Michael Pezzetta,L,MTL,26,0,0,0,0
10,8480355,Mark Kastelic,C,OTT,25,0,0,0,0
10,8482162,Roby Jarventie,L,OTT,22,0,0,0,0
10,8479772,Zack MacEwen,R,OTT,28,0,0,0,0
10,8483597,Milos Kelemen,L,ARI,25,0,0,0,0
10,8479379,Givani Smith,R,SJS,26,0,0,0,0
10,8481655,Cole Schwindt,R,CGY,23,0,0,0,0
10,8479981,Jonah Gadjovich,L,FLA,26,0,0,0,0
10,8482147,Jean-Luc Foudy,C,COL,22,0,0,0,0
10,8484255,Jason Polin,R,COL,25,0,0,0,0
10,8477993,Justin Kirkland,C,ARI,28,0,0,0,0
10,8479249,Andrew Poturalski,C,SEA,30,0,0,0,0
10,8482197,Adam Raska,R,MIN,23,0,0,0,0
10,8475780,Chris Wagner,R,COL,33,0,0,0,0
10,8479533,Joona Koppanen,L,PIT,26,0,0,0,0
10,8481534,Raphael Lavoie,C,EDM,24,0,0,0,0
10,8484321,Nikolas Matinpalo,D,OTT,26,0,0,0,0
10,8481043,Cole Koepke,L,TBL,26,0,0,0,0
10,8476323,Max McCormick,L,SEA,32,0,0,0,0
10,8483609,Adam Klapka,R,CGY,24,0,0,0,0
10,8483512,Matt Savoie,C,BUF,20,0,0,0,0
10,8484259,Ondrej Pavel,C,COL,31,0,0,0,0
10,8478147,Bokondji Imama,L,OTT,28,0,0,0,0
10,8482460,Matt Rempe,C,NYR,22,0,0,0,0
10,8477073,Kurtis MacDermid,L,NJD,30,0,0,0,0
10,8480274,Philip Kemp,D,EDM,25,0,0,0,0
10,8478956,Samuel Laberge,L,NJD,27,0,0,0,0
10,8483045,Cameron Butler,R,CBJ,31,0,0,0,0
11,8476453,Nikita Kucherov,R,TBL,31,82,37,97,134
11,8479318,Auston Matthews,C,TOR,27,82,65,45,110
11,8478402,Connor McDavid,C,EDM,27,82,34,76,110
11,8477934,Leon Draisaitl,C,EDM,29,82,44,63,107
11,8477492,Nathan MacKinnon,C,COL,29,82,40,66,106
11,8478010,Brayden Point,C,TBL,28,82,62,42,104
11,8481559,Jack Hughes,C,NJD,23,82,36,64,100
11,8471675,Sidney Crosby,C,PIT,37,82,42,52,94
11,8478550,Artemi Panarin,L,NYR,33,82,36,57,93
11,8480012,Elias Pettersson,C,VAN,26,82,31,59,90
11,8475166,John Tavares,C,TOR,34,82,40,48,88
11,8477402,Pavel Buchnevich,L,STL,29,82,30,58,88
11,8477949,Alex Tuch,R,BUF,28,82,24,63,87
11,8480023,Robert Thomas,C,STL,25,82,21,65,86
11,8478864,Kirill Kaprizov,L,MIN,27,82,44,41,85
11,8480027,Jason Robertson,L,DAL,25,82,27,58,85
11,8476887,Filip Forsberg,L,NSH,30,82,43,38,81
11,8481523,Kirby Dach,C,MTL,23,82,11,70,81
11,8478420,Mikko Rantanen,R,COL,28,82,34,46,80
11,8479314,Matthew Tkachuk,L,FLA,27,82,30,49,79
11,8482116,Tim Stützle,C,OTT,22,82,25,54,79
11,8477956,David Pastrnak,R,BOS,28,82,31,47,78
11,8480069,Cale Makar,D,COL,26,82,18,60,78
11,8480801,Brady Tkachuk,L,OTT,25,82,32,45,77
11,8479337,Alex DeBrincat,R,DET,27,82,28,49,77
11,8477946,Dylan Larkin,C,DET,28,82,32,44,76
11,8478427,Sebastian Aho,C,CAR,27,82,31,45,76
11,8477939,William Nylander,R,TOR,28,82,27,49,76
11,8478444,Brock Boeser,R,VAN,27,82,37,37,74
11,8477955,Jared McCann,L,SEA,28,82,36,38,74
11,8478398,Kyle Connor,L,WPG,28,82,27,47,74
11,8476454,Ryan Nugent-Hopkins,C,EDM,31,82,22,52,74
11,8474600,Roman Josi,D,NSH,34,82,21,53,74
11,8477942,Kevin Fiala,L,LAK,28,82,28,45,73
11,8479385,Jordan Kyrou,C,STL,26,82,36,36,72
11,8475172,Nazem Kadri,C,CGY,34,82,30,42,72
11,8475786,Zach Hyman,L,EDM,32,82,39,32,71
11,8479343,Clayton Keller,R,ARI,26,82,28,43,71
11,8476389,Vincent Trocheck,C,NYR,31,82,25,46,71
11,8475692,Mats Zuccarello,R,MIN,37,82,16,55,71
11,8476459,Mika Zibanejad,C,NYR,31,82,34,36,70
11,8480002,Nico Hischier,C,NJD,25,82,30,40,70
11,8477960,Adrian Kempe,R,LAK,28,82,30,40,70
11,8475784,Jeff Skinner,C,BUF,32,82,30,40,70
11,8471215,Evgeni Malkin,C,PIT,38,82,26,44,70
11,8481540,Cole Caufield,R,MTL,23,82,37,32,69
11,8476460,Mark Scheifele,C,WPG,31,82,35,34,69
11,8481557,Matt Boldy,L,MIN,23,82,28,41,69
11,8476468,J.T. Miller,C,VAN,31,82,27,42,69
11,8477933,Sam Reinhart,C,FLA,29,82,34,34,68
11,8483808,Andrei Kuzmenko,L,CGY,28,82,30,38,68
11,8473419,Brad Marchand,L,BOS,36,82,28,40,68
11,8474141,Patrick Kane,R,DET,36,82,28,40,68
11,8477493,Aleksander Barkov,C,FLA,29,82,18,50,68
11,8478445,Mathew Barzal,C,NYI,27,82,23,44,67
11,8479323,Adam Fox,D,NYR,26,82,9,58,67
11,8477404,Jake Guentzel,C,CAR,30,82,31,34,65
11,8479542,Brandon Hagel,L,TBL,26,82,24,41,65
11,8476456,Jonathan Huberdeau,C,CGY,31,82,11,54,65
11,8478449,Roope Hintz,C,DAL,28,82,34,30,64
11,8475810,Bryan Rust,R,PIT,32,82,28,36,64
11,8482740,Wyatt Johnston,C,DAL,21,82,24,40,64
11,8479407,Jesper Bratt,L,NJD,26,82,21,43,64
11,8477447,Shea Theodore,D,VGK,29,82,12,51,63
11,8481596,Shane Pinto,C,OTT,24,82,31,31,62
11,8481533,Trevor Zegras,C,ANA,23,82,28,34,62
11,8478873,Troy Terry,R,ANA,27,82,26,36,62
11,8470794,Joe Pavelski,C,DAL,40,82,24,38,62
11,8480839,Rasmus Dahlin,D,BUF,24,82,13,49,62
11,8480800,Quinn Hughes,D,VAN,25,82,8,54,62
11,8478493,Joel Eriksson Ek,C,MIN,27,82,34,27,61
11,8478439,Travis Konecny,R,PHI,27,82,31,30,61
11,8482078,Lucas Raymond,L,DET,22,82,23,38,61
11,8478440,Dylan Strome,C,WSH,27,82,21,40,61
11,8476346,Johnny Gaudreau,L,CBJ,31,82,13,48,61
11,8475168,Matt Duchene,C,DAL,33,82,27,33,60
11,8474564,Steven Stamkos,C,TBL,34,82,24,36,60
11,8476881,Tomas Hertl,C,VGK,31,82,23,37,60
11,8477504,Josh Morrissey,D,WPG,29,82,17,43,60
11,8480208,Drake Batherson,R,OTT,26,82,30,29,59
11,8479420,Tage Thompson,C,BUF,27,82,30,29,59
11,8475726,Tyler Toffoli,C,WPG,32,82,30,29,59
11,8478414,Timo Meier,R,NJD,28,82,29,30,59
11,8477951,Nick Schmaltz,C,ARI,28,82,21,38,59
11,8477501,Valeri Nichushkin,R,COL,29,82,29,29,58
11,8471214,Alex Ovechkin,L,WSH,39,82,27,31,58
11,8477935,Sam Bennett,C,FLA,28,82,27,31,58
11,8478403,Jack Eichel,C,VGK,28,82,25,33,58
11,8477496,Elias Lindholm,C,VAN,30,82,25,33,58
11,8474578,Erik Karlsson,D,PIT,34,82,21,37,58
11,8480018,Nick Suzuki,C,MTL,25,82,18,40,58
11,8478460,Zach Werenski,D,CBJ,27,82,14,44,58
11,8475184,Chris Kreider,L,NYR,33,82,32,25,57
11,8476539,Jonathan Marchessault,R,VGK,34,82,32,25,57
11,8475170,Brayden Schenn,C,STL,33,82,22,35,57
11,8478047,Michael Bunting,L,PIT,29,82,20,37,57
11,8478856,Conor Garland,R,VAN,28,82,19,38,57
11,8482684,Luke Hughes,D,NJD,21,82,18,39,57
11,8480830,Andrei Svechnikov,R,CAR,24,82,22,34,56
11,8480078,Filip Chytil,C,NYR,25,82,22,34,56
11,8477986,Brandon Montour,D,FLA,30,82,18,38,56
11,8477940,Nikolaj Ehlers,L,WPG,28,82,17,39,56
11,8475167,Victor Hedman,D,TBL,34,82,8,48,56
11,8475158,Ryan O'Reilly,C,NSH,33,82,25,30,55
11,8476853,Morgan Rielly,D,TOR,30,82,8,47,55
11,8471685,Anze Kopitar,C,LAK,37,82,25,29,54
11,8475913,Mark Stone,R,VGK,32,82,21,33,54
11,8475754,Brock Nelson,C,NYI,33,82,21,33,54
11,8478038,Devon Toews,D,COL,30,82,10,44,54
11,8479425,Filip Hronek,D,VAN,27,82,6,48,54
11,8478042,Viktor Arvidsson,R,LAK,31,82,28,25,53
11,8484144,Connor Bedard,C,CHI,19,82,26,27,53
11,8482475,Yegor Chinakhov,R,CBJ,23,82,26,27,53
11,8475191,Reilly Smith,R,PIT,33,82,22,31,53
11,8478407,Vince Dunn,D,SEA,28,82,11,42,53
11,8480865,Noah Dobson,D,NYI,24,82,11,42,53
11,8477500,Bo Horvat,C,NYI,29,82,31,21,52
11,8475765,Vladimir Tarasenko,R,FLA,33,82,23,29,52
11,8479999,Casey Mittelstadt,C,COL,26,82,13,39,52
11,8477479,Tyler Bertuzzi,L,TOR,29,82,28,23,51
11,8481528,Dylan Cozens,C,BUF,23,82,23,28,51
11,8474586,Jordan Eberle,R,SEA,34,82,21,30,51
11,8478975,Mason Marchment,L,DAL,29,82,17,34,51
11,8475794,Tyler Seguin,C,DAL,32,82,17,34,51
11,8471724,Kris Letang,D,PIT,37,82,13,38,51
11,8478498,Jake DeBrusk,L,BOS,28,82,31,19,50
11,8476880,Tom Wilson,R,WSH,30,82,30,20,50
11,8477426,Nicholas Paul,L,TBL,29,82,26,24,50
11,8482745,Mason McTavish,C,ANA,21,82,19,31,50
11,8476448,William Karlsson,C,VGK,31,82,19,31,50
11,8475791,Taylor Hall,L,CHI,33,82,17,33,50
11,8474563,Drew Doughty,D,LAK,35,82,11,39,50
11,8480803,Evan Bouchard,D,EDM,25,82,10,40,50
11,8479325,Charlie McAvoy,D,BOS,27,82,7,43,50
11,8475169,Evander Kane,L,EDM,33,82,29,20,49
11,8479675,Trevor Moore,L,LAK,29,82,25,24,49
11,8476483,Rickard Rakell,R,PIT,31,82,21,28,49
11,8477451,Ryan Hartman,R,MIN,30,82,20,29,49
11,8476905,Chandler Stephenson,C,VGK,30,82,15,34,49
11,8483445,Cutter Gauthier,L,ANA,20,82,14,35,49
11,8473512,Claude Giroux,R,OTT,36,82,13,36,49
11,8480036,Miro Heiskanen,D,DAL,25,82,11,38,49
11,8476462,Dougie Hamilton,D,NJD,31,82,11,38,49
11,8480009,Eeli Tolvanen,R,SEA,25,82,25,23,48
11,8482175,JJ Peterka,R,BUF,22,82,25,23,48
11,8479339,Patrik Laine,L,CBJ,26,82,14,34,48
11,8478397,Rasmus Andersson,D,CGY,28,82,12,36,48
11,8476869,Brady Skjei,D,CAR,30,82,11,37,48
11,8478396,Noah Hanifin,D,VGK,27,82,8,40,48
11,8475714,Calle Jarnkrok,C,TOR,33,82,21,26,47
11,8477409,Carter Verhaeghe,C,FLA,29,82,20,27,47
11,8475314,Anders Lee,L,NYI,34,82,19,28,47
11,8480039,Martin Necas,C,CAR,25,82,18,29,47
11,8477497,Sean Monahan,C,WPG,30,82,18,29,47
11,8482665,Matty Beniers,C,SEA,22,82,15,32,47
11,8480014,Gabriel Vilardi,C,WPG,25,82,29,17,46
11,8478474,Lawson Crouse,L,ARI,27,82,25,21,46
11,8479400,Pierre-Luc Dubois,L,LAK,26,82,16,30,46
11,8480031,Maxime Comtois,L,CAR,25,82,13,33,46
11,8478469,Thomas Chabot,D,OTT,27,82,12,34,46
11,8476906,Shayne Gostisbehere,D,DET,31,82,12,34,46
11,8481542,Moritz Seider,D,DET,23,82,8,38,46
11,8483397,Marc McLaughlin,C,BOS,25,82,40,5,45
11,8481624,Ilya Mikheyev,R,VAN,30,82,27,18,45
11,8474102,David Perron,L,DET,36,82,20,25,45
11,8482699,Dylan Guenther,R,ARI,21,82,19,26,45
11,8480028,Morgan Frost,C,PHI,25,82,19,26,45
11,8474150,Mikael Backlund,C,CGY,35,82,17,28,45
11,8475798,Mikael Granlund,C,SJS,32,82,11,34,45
11,8480798,Philipp Kurashev,C,CHI,25,82,10,35,45
11,8479410,Mikhail Sergachev,D,TBL,26,82,5,40,45
11,8475763,Kevin Hayes,R,STL,32,82,21,23,44
11,8482667,William Eklund,L,SJS,22,82,19,25,44
11,8482097,Jack Quinn,R,BUF,23,82,18,26,44
11,8478519,Anthony Cirelli,C,TBL,27,82,18,26,44
11,8477511,Anthony Mantha,R,VGK,30,82,18,26,44
11,8480188,Fabian Zetterlund,L,SJS,25,82,17,27,44
11,8473994,Jamie Benn,L,DAL,35,82,17,27,44
11,8478438,Tommy Novak,C,NSH,27,82,16,28,44
11,8478458,Jack Roslovic,C,NYR,27,82,16,28,44
11,8477494,Jonathan Drouin,L,COL,29,82,15,29,44
11,8474590,John Carlson,D,WSH,34,82,5,39,44
11,8480043,Timothy Liljegren,D,TOR,25,82,3,41,44
11,8480015,Owen Tippett,R,PHI,25,82,27,16,43
11,8482159,Tyson Foerster,R,PHI,22,82,22,21,43
11,8475151,Kyle Palmieri,C,NYI,33,82,22,21,43
11,8477416,Oliver Bjorkstrand,R,SEA,29,82,15,28,43
11,8476826,Yanni Gourde,C,SEA,33,82,15,28,43
11,8478462,Nicolas Roy,C,VGK,27,82,15,28,43
11,8474679,Gustav Nyquist,C,NSH,35,82,15,28,43
11,8477346,MacKenzie Weegar,D,CGY,30,82,11,32,43
11,8482124,Quinton Byfield,R,LAK,22,82,10,33,43
11,8478055,Gustav Forsling,D,FLA,28,82,8,35,43
11,8481618,Alex Newhook,C,MTL,23,82,26,16,42
11,8477944,Jakub Vrana,L,STL,28,82,26,16,42
11,8473986,Alex Killorn,L,ANA,35,82,23,19,42
11,8482055,Drew O'Connor,L,PIT,26,82,21,21,42
11,8478366,Frank Vatrano,R,ANA,30,82,21,21,42
11,8476882,Teuvo Teravainen,L,CAR,30,82,20,22,42
11,8478466,Daniel Sprong,R,DET,27,82,17,25,42
11,8477932,Aaron Ekblad,D,FLA,28,82,13,29,42
11,8481711,Matias Maccelli,L,ARI,24,82,11,31,42
11,8477407,Anthony Duclair,L,TBL,29,82,24,17,41
11,8476925,Colton Sissons,C,NSH,31,82,23,18,41
11,8478233,Andrew Mangiapane,L,CGY,28,82,22,19,41
11,8482109,Alexis Lafrenière,L,NYR,23,82,21,20,41
11,8477456,J.T. Compher,L,DET,29,82,21,20,41
11,8476479,Phillip Danault,C,LAK,31,82,19,22,41
11,8482222,Alexander Barabanov,L,SJS,30,82,16,25,41
11,8477964,Ivan Barbashev,C,VGK,29,82,16,25,41
11,8474565,Alex Pietrangelo,D,VGK,34,82,13,28,41
11,8476792,Torey Krug,D,STL,33,82,8,33,41
11,8476438,Brandon Saad,L,STL,32,82,25,15,40
11,8482110,Dawson Mercer,C,NJD,23,82,22,18,40
11,8480459,Pius Suter,C,VAN,28,82,21,19,40
11,8475768,Jaden Schwartz,C,SEA,32,82,20,20,40
11,8481068,Yegor Sharangovich,C,CGY,26,82,20,20,40
11,8482146,Luke Evangelista,R,NSH,22,82,16,24,40
11,8476458,Ryan Strome,C,ANA,31,82,15,25,40
11,8474641,Adam Henrique,C,EDM,34,82,15,25,40
11,8482671,Owen Power,D,BUF,22,82,14,26,40
11,8477021,Alex Kerfoot,C,ARI,30,82,13,27,40
11,8478401,Pavel Zacha,C,BOS,27,82,13,27,40
11,8480434,Sean Durzi,D,ARI,26,82,13,27,40
11,8476923,Damon Severson,D,CBJ,30,82,13,27,40
11,8477503,Max Domi,C,TOR,29,82,12,28,40
11,8477948,Travis Sanheim,D,PHI,28,82,7,33,40
11,8475799,Nino Niederreiter,R,WPG,32,82,25,14,39
11,8482089,Jake Neighbours,L,STL,22,82,23,16,39
11,8480064,Josh Norris,C,OTT,25,82,21,18,39
11,8478046,Danton Heinen,L,BOS,29,82,18,21,39
11,8476399,Blake Coleman,C,CGY,33,82,17,22,39
11,8477476,Artturi Lehkonen,L,COL,29,82,17,22,39
11,8480797,Joel Farabee,L,PHI,24,82,16,23,39
11,8477429,Andrew Copp,C,DET,30,82,14,25,39
11,8477495,Seth Jones,D,CHI,30,82,10,29,39
11,8483524,Shane Wright,C,SEA,20,82,24,14,38
11,8474157,Max Pacioretty,L,WSH,36,82,23,15,38
11,8474037,James van Riemsdyk,L,BOS,35,82,16,22,38
11,8476292,Ondrej Palat,L,NJD,33,82,14,24,38
11,8477444,Andre Burakovsky,L,SEA,29,82,8,30,38
11,8482093,Seth Jarvis,C,CAR,22,82,16,21,37
11,8482702,Logan Stankoven,C,DAL,21,82,16,21,37
11,8480893,Kirill Marchenko,R,CBJ,24,82,14,23,37
11,8478463,Anthony Beauvillier,L,NSH,27,82,13,24,37
11,8475745,Charlie Coyle,C,BOS,32,82,10,27,37
11,8476432,Boone Jenner,C,CBJ,31,82,25,11,36
11,8475760,Nick Bjugstad,C,ARI,32,82,22,14,36
11,8479525,Ross Colton,C,COL,28,82,21,15,36
11,8482101,Danil Gushchin,L,SJS,22,82,18,18,36
11,8476461,Sean Couturier,C,PHI,32,82,13,23,36
11,8470613,Brent Burns,D,CAR,39,82,8,28,36
11,8481699,Aku Raty,R,ARI,23,82,4,32,36
11,8474716,Jared Spurgeon,D,MIN,35,82,4,32,36
11,8476854,Hampus Lindholm,D,BOS,30,82,3,33,36
11,8471698,T.J. Oshie,R,WSH,38,82,23,12,35
11,8479423,Alex Nylander,L,CBJ,26,82,23,12,35
11,8478057,Dakota Joshua,C,VAN,28,82,22,13,35
11,8482113,Anton Lundell,C,FLA,23,82,18,17,35
11,8478115,Pierre Engvall,L,NYI,28,82,17,18,35
11,8482079,Marco Rossi,C,MIN,23,82,16,19,35
11,8478472,Mathieu Joseph,R,OTT,27,82,13,22,35
11,8479351,Sam Steel,C,DAL,26,82,13,22,35
11,8475218,Mattias Ekholm,D,EDM,34,82,11,24,35
11,8478109,Victor Olofsson,L,BUF,29,82,19,15,34
11,8476927,Teddy Blueger,C,VAN,30,82,17,17,34
11,8475287,Erik Haula,L,NJD,33,82,16,18,34
11,8478542,Evan Rodrigues,C,FLA,31,82,15,19,34
11,8474870,Tyler Johnson,C,CHI,34,82,15,19,34
11,8476885,Jacob Trouba,D,NYR,30,82,13,21,34
11,8482624,Daniil Miromanov,D,CGY,27,82,12,22,34
11,8478891,Mason Appleton,C,WPG,28,82,11,23,34
11,8481581,Thomas Harley,D,DAL,23,82,10,24,34
11,8476875,Mike Matheson,D,MTL,30,82,5,29,34
11,8483431,Logan Cooley,C,ARI,20,82,19,14,33
11,8480220,Noah Cates,L,PHI,25,82,13,20,33
11,8483490,Pavel Mintyukov,D,ANA,21,82,9,24,33
11,8479987,Morgan Geekie,C,BOS,26,82,8,25,33
11,8476892,Colton Parayko,D,STL,31,82,7,26,33
11,8482142,Jamie Drysdale,D,PHI,22,82,6,27,33
11,8483471,Brad Lambert,C,WPG,31,82,5,28,33
11,8478178,Darren Raddysh,D,TBL,28,82,5,28,33
11,8476958,Jaccob Slavin,D,CAR,30,82,4,29,33
11,8478508,Yakov Trenin,C,COL,27,82,20,12,32
11,8479661,Tanner Jeannot,L,TBL,27,82,14,18,32
11,8474149,Evgenii Dadonov,R,DAL,35,82,13,19,32
11,8471218,Blake Wheeler,R,NYR,38,82,11,21,32
11,8473563,Nicklas Backstrom,C,WSH,37,82,11,21,32
11,8475906,John Klingberg,D,TOR,32,82,8,24,32
11,8477969,Marcus Pettersson,D,PIT,28,82,6,26,32
11,8475753,Justin Faulk,D,STL,32,82,4,28,32
11,8481568,Alex Vlasic,D,CHI,23,82,3,29,32
11,8481016,Ruslan Iskhakov,C,NYI,24,82,3,29,32
11,8483457,Lane Hutson,D,MTL,20,82,2,30,32
11,8480281,Alexey Toropchenko,R,STL,25,82,18,13,31
11,8478413,Jordan Greenway,L,BUF,27,82,16,15,31
11,8476469,Joel Armia,R,MTL,31,82,16,15,31
11,8477919,Frederick Gaudreau,C,MIN,31,82,16,15,31
11,8482092,Ridly Greig,C,OTT,22,82,14,17,31
11,8482117,Lukas Reichel,L,CHI,22,82,14,17,31
11,8480113,Alex Iafallo,L,WPG,31,82,14,17,31
11,8476872,Scott Laughton,C,PHI,30,82,13,18,31
11,8480849,Barrett Hayton,C,ARI,24,82,13,18,31
11,8482705,Cole Sillinger,C,CBJ,21,82,12,19,31
11,8477947,Sonny Milano,L,WSH,28,82,12,19,31
11,8479365,Trent Frederic,C,BOS,26,82,12,19,31
11,8479345,Jakob Chychrun,D,OTT,26,82,9,22,31
11,8480806,Isac Lundestrom,C,ANA,25,82,8,23,31
11,8473422,Nick Foligno,L,CHI,37,82,7,24,31
11,8482720,Matthew Knies,L,TOR,22,82,6,25,31
11,8482133,Thomas Bordeleau,C,SJS,22,82,5,26,31
11,8481606,Jordan Spence,D,LAK,23,82,4,27,31
11,8482122,Brock Faber,D,MIN,22,82,2,29,31
11,8476960,Andreas Athanasiou,C,CHI,30,82,19,11,30
11,8480802,Ryan McLeod,C,EDM,25,82,16,14,30
11,8477450,Jason Dickinson,C,CHI,29,82,15,15,30
11,8481013,Jonatan Berggren,R,DET,24,82,14,16,30
11,8480185,Eetu Luostarinen,C,FLA,26,82,13,17,30
11,8476921,Jordan Martinook,L,CAR,32,82,13,17,30
11,8480068,Ryan Poehling,C,PHI,25,82,13,17,30
11,8476419,Jean-Gabriel Pageau,C,NYI,32,82,11,19,30
11,8476897,Oskar Sundqvist,C,STL,30,82,10,20,30
11,8475197,Tyson Barrie,D,NSH,33,82,8,22,30
11,8477488,Brett Pesce,D,CAR,30,82,6,24,30
11,8481546,Cam York,D,PHI,23,82,6,24,30
11,8478500,Ivan Provorov,D,CBJ,27,82,5,25,30
11,8476981,Josh Anderson,R,MTL,30,82,18,11,29
11,8480821,Filip Zadina,R,SJS,25,82,15,14,29
11,8481604,Pavel Dorofeyev,L,VGK,24,82,15,14,29
11,8476278,Colin Blackwell,C,CHI,31,82,15,14,29
11,8480074,Alexandre Texier,C,CBJ,25,82,14,15,29
11,8479353,Brett Howden,C,VGK,26,82,14,15,29
11,8473449,Kyle Okposo,R,FLA,36,82,12,17,29
11,8476329,Travis Boyd,C,ARI,31,82,11,18,29
11,8481553,Bobby Brink,R,PHI,23,82,11,18,29
11,8474053,Logan Couture,C,SJS,35,82,10,19,29
11,8478133,Jake Evans,C,MTL,28,82,10,19,29
11,8479415,Michael McLeod,C,NJD,26,82,10,19,29
11,8480873,Rasmus Sandin,D,WSH,24,82,9,20,29
11,8480145,Neal Pionk,D,WPG,29,82,9,20,29
11,8481703,Valtteri Puustinen,R,PIT,25,82,7,22,29
11,8476891,Matt Grzelcyk,D,BOS,30,82,7,22,29
11,8474673,TJ Brodie,D,TOR,34,82,6,23,29
11,8475171,Oliver Ekman-Larsson,D,FLA,33,82,6,23,29
11,8482118,Sam Colangelo,R,ANA,23,82,21,7,28
11,8484203,Bradly Nadeau,L,CAR,19,82,16,12,28
11,8481554,Kaapo Kakko,R,NYR,23,82,13,15,28
11,8481186,Logan O'Connor,R,COL,28,82,12,16,28
11,8476392,Adam Lowry,C,WPG,31,82,12,16,28
11,8477998,Warren Foegele,L,EDM,28,82,12,16,28
11,8484153,Leo Carlsson,C,ANA,20,82,11,17,28
11,8480855,Jack McBain,C,ARI,24,82,10,18,28
11,8477498,Darnell Nurse,D,EDM,29,82,10,18,28
11,8475722,Jason Zucker,L,NSH,32,82,9,19,28
11,8476463,Jonas Brodin,D,MIN,31,82,8,20,28
11,8482105,Jake Sanderson,D,OTT,22,82,7,21,28
11,8479998,Mikey Anderson,D,LAK,25,82,7,21,28
11,8476917,Adam Pelech,D,NYI,30,82,4,24,28
11,8476467,Jamie Oleksiak,D,SEA,32,82,4,24,28
11,8475764,Cam Fowler,D,ANA,33,82,2,26,28
11,8481560,Arthur Kaliyev,R,LAK,23,82,16,11,27
11,8476873,Mark Jankowski,C,NSH,30,82,16,11,27
11,8475848,Brendan Gallagher,R,MTL,32,82,13,14,27
11,8483499,Liam Ohgren,L,MIN,20,82,12,15,27
11,8476374,Sean Kuraly,C,CBJ,31,82,12,15,27
11,8479977,Kailer Yamamoto,R,SEA,26,82,10,17,27
11,8480817,K'Andre Miller,D,NYR,24,82,7,20,27
11,8481656,Aliaksei Protas,C,WSH,23,82,6,21,27
11,8482087,Kaiden Guhle,D,MTL,22,82,6,21,27
11,8475690,Chris Tanev,D,DAL,35,82,6,21,27
11,8479976,Juuso Valimaki,D,ARI,26,82,2,25,27
11,8476331,Dylan DeMelo,D,WPG,31,82,2,25,27
11,8483493,Frank Nazar,C,CHI,20,82,20,6,26
11,8479293,Brandon Tanev,L,SEA,33,82,17,9,26
11,8480336,Sean Walker,D,COL,30,82,14,12,26
11,8477989,Christian Dvorak,C,MTL,28,82,13,13,26
11,8479316,Luke Kunin,C,SJS,27,82,13,13,26
11,8481580,Connor McMichael,C,WSH,23,82,12,14,26
11,8477952,Robby Fabbri,C,DET,28,82,11,15,26
11,8478013,Jake Walman,D,DET,28,82,10,16,26
11,8476871,Tanner Pearson,L,MTL,32,82,10,16,26
11,8479346,Dillon Dube,C,CGY,26,82,10,16,26
11,8475164,Jakob Silfverberg,R,ANA,34,82,10,16,26
11,8479390,Taylor Raddysh,R,CHI,26,82,9,17,26
11,8477507,Nikita Zadorov,D,VAN,29,82,9,17,26
11,8478851,Alexandre Carrier,D,NSH,28,82,7,19,26
11,8476902,Esa Lindell,D,DAL,30,82,6,20,26
11,8481059,Scott Perunovich,D,STL,26,82,6,20,26
11,8478507,John Marino,D,NJD,27,82,5,21,26
11,8482733,Logan Mailloux,D,MTL,31,82,5,21,26
11,8475462,Radko Gudas,D,ANA,34,82,5,21,26
11,8477845,Trevor van Riemsdyk,D,WSH,33,82,4,22,26
11,8482145,Mavrik Bourque,C,DAL,22,82,17,8,25
11,8482155,Alex Laferriere,R,LAK,23,82,15,10,25
11,8482125,Alexander Holtz,R,NJD,22,82,13,12,25
11,8479941,Justin Danforth,R,CBJ,31,82,13,12,25
11,8477353,Tyler Motte,C,TBL,29,82,10,15,25
11,8476312,Josh Manson,D,COL,33,82,8,17,25
11,8483482,Tristan Luneau,D,ANA,20,82,8,17,25
11,8482730,Brandt Clarke,D,LAK,21,82,7,18,25
11,8480058,Pierre-Olivier Joseph,D,PIT,25,82,5,20,25
11,8476457,Adam Larsson,D,SEA,32,82,4,21,25
11,8476979,Erik Gustafsson,D,NYR,32,82,2,23,25
11,8473507,Jeff Petry,D,DET,37,82,2,23,25
11,8476624,Barclay Goodrow,C,NYR,31,82,15,9,24
11,8474884,Mike Hoffman,C,SJS,35,82,14,10,24
11,8479996,Cody Glass,C,NSH,25,82,12,12,24
11,8474715,Cam Atkinson,R,PHI,35,82,11,13,24
11,8476931,Jake McCabe,D,TOR,31,82,9,15,24
11,8475279,Ben Chiarot,D,DET,33,82,9,15,24
11,8475793,Ryan Johansen,C,PHI,32,82,8,16,24
11,8474034,Pat Maroon,L,BOS,36,82,8,16,24
11,8475744,Evgeny Kuznetsov,C,CAR,32,82,6,18,24
11,8477953,Kasperi Kapanen,R,STL,28,82,6,18,24
11,8480035,Henri Jokiharju,D,BUF,25,82,6,18,24
11,8474574,Tyler Myers,D,VAN,34,82,4,20,24
11,8475181,Nick Leddy,D,STL,33,82,3,21,24
11,8479980,Nicolas Hague,D,VGK,26,82,3,21,24
11,8478882,Vladislav Gavrikov,D,LAK,29,82,2,22,24
11,8474151,Ryan McDonagh,D,NSH,35,82,1,23,24
11,8479591,Michael Eyssimont,C,TBL,28,82,12,11,23
11,8482111,Justin Barron,D,MTL,23,82,12,11,23
11,8481601,Simon Holmstrom,R,NYI,23,82,11,12,23
11,8481477,Nico Sturm,C,SJS,29,82,11,12,23
11,8481517,Brett Leason,R,ANA,25,82,11,12,23
11,8483515,Juraj Slafkovsky,L,MTL,20,82,10,13,23
11,8477425,Miles Wood,L,COL,29,82,10,13,23
11,8479514,Rem Pitlick,C,CHI,27,82,8,15,23
11,8477499,Rasmus Ristolainen,D,PHI,30,82,7,16,23
11,8480860,Kevin Bahl,D,NJD,24,82,6,17,23
11,8478911,Matt Roy,D,LAK,29,82,5,18,23
11,8479398,Samuel Girard,D,COL,26,82,3,20,23
11,8480144,David Kampf,C,TOR,29,82,3,20,23
11,8470610,Zach Parise,L,COL,40,82,15,7,22
11,8470604,Jeff Carter,C,PIT,39,82,12,10,22
11,8482259,Bobby McMann,C,TOR,28,82,11,11,22
11,8476878,Zemgus Girgensons,L,BUF,30,82,8,14,22
11,8476480,Vladislav Namestnikov,C,WPG,32,82,7,15,22
11,8476429,Scott Mayfield,D,NYI,32,82,7,15,22
11,8481522,Peyton Krebs,C,BUF,23,82,7,15,22
11,8478840,Will Borgen,D,SEA,28,82,6,16,22
11,8477015,Connor Brown,R,EDM,30,82,6,16,22
11,8470600,Ryan Suter,D,DAL,39,82,6,16,22
11,8479359,Beck Malenstyn,L,WSH,26,82,6,16,22
11,8477435,Ryan Graves,D,PIT,29,82,5,17,22
11,8475200,Dmitry Orlov,D,CAR,33,82,5,17,22
11,8479369,Andrew Peeke,D,BOS,26,82,4,18,22
11,8481535,Nils Hoglander,L,VAN,24,82,14,7,21
11,8479393,Noah Gregor,C,TOR,26,82,12,9,21
11,8480813,Joe Veleno,C,DET,24,82,10,11,21
11,8480448,Parker Kelly,L,OTT,25,82,9,12,21
11,8483491,Ivan Miroshnichenko,L,WSH,20,82,8,13,21
11,8484145,Zach Benson,L,BUF,19,82,7,14,21
11,8477839,Conor Sheary,L,TBL,32,82,7,14,21
11,8482655,J.J. Moser,D,ARI,24,82,6,15,21
11,8476967,Brett Kulak,D,EDM,30,82,5,16,21
11,8480871,Adam Boqvist,D,CBJ,24,82,4,17,21
11,8477505,Alexander Wennberg,C,NYR,30,82,4,17,21
11,8480073,Erik Brannstrom,D,OTT,25,82,3,18,21
11,8481524,Bowen Byram,D,BUF,23,82,2,19,21
11,8477330,Dominik Kubalik,L,OTT,29,82,14,6,20
11,8482074,Connor Zary,C,CGY,23,82,13,7,20
11,8470621,Corey Perry,R,EDM,39,82,12,8,20
11,8474189,Lars Eller,C,PIT,35,82,9,11,20
11,8478569,Noel Acciari,C,PIT,33,82,9,11,20
11,8475220,Marcus Foligno,L,MIN,33,82,8,12,20
11,8481028,Martin Pospisil,C,CGY,25,82,8,12,20
11,8473533,Jordan Staal,C,CAR,36,82,7,13,20
11,8477506,Ryan Pulock,D,NYI,30,82,7,13,20
11,8479992,Michael Rasmussen,C,DET,25,82,7,13,20
11,8481481,Blake Lizotte,C,LAK,27,82,5,15,20
11,8482166,Shakir Mukhamadullin,D,SJS,22,82,5,15,20
11,8483466,Kevin Korchinski,D,CHI,20,82,5,15,20
11,8483565,Nick Blankenburg,D,CBJ,26,82,4,16,20
11,8475188,Brayden McNabb,D,VGK,33,82,4,16,20
11,8476879,Cody Ceci,D,EDM,31,82,2,18,20
11,8481605,Jackson LaCombe,D,ANA,23,82,2,18,20
11,8478020,Michael Amadio,C,VGK,28,82,12,7,19
11,8475231,Casey Cizikas,C,NYI,33,82,11,8,19
11,8473504,Cal Clutterbuck,R,NYI,37,82,10,9,19
11,8482737,Zack Bolduc,C,STL,21,82,8,11,19
11,8478831,Kevin Stenlund,C,FLA,28,82,8,11,19
11,8483495,Simon Nemec,D,NJD,20,82,7,12,19
11,8475149,Marcus Johansson,L,MIN,34,82,5,14,19
11,8482803,Olen Zellweger,D,ANA,21,82,3,16,19
11,8478430,Oliver Kylington,D,CGY,27,82,3,16,19
11,8475790,Erik Gudbranson,D,CBJ,32,82,2,17,19
11,8481178,Egor Zamula,D,PHI,24,82,1,18,19
11,8482666,Scott Morrow,D,CAR,22,82,12,6,18
11,8482679,Matt Coronato,R,CGY,22,82,11,7,18
11,8484166,Adam Fantilli,C,CBJ,20,82,9,9,18
11,8478451,Ethan Bear,D,WSH,27,82,6,12,18
11,8476858,Phillip Di Giuseppe,L,VAN,31,82,6,12,18
11,8475233,David Savard,D,MTL,34,82,5,13,18
11,8480796,Martin Fehervary,D,WSH,25,82,5,13,18
11,8476525,Colin Miller,D,WPG,32,82,2,16,18
11,8482809,Jackson Blake,R,CAR,21,82,11,6,17
11,8483012,Logan Morrison,C,SEA,22,82,10,7,17
11,8475343,Nic Dowd,C,WSH,34,82,9,8,17
11,8482073,Braden Schneider,D,NYR,23,82,6,11,17
11,8480879,Jacob Bernard-Docker,D,OTT,24,82,6,11,17
11,8475842,Sam Carrick,C,EDM,32,82,6,11,17
11,8479371,Dante Fabbro,D,NSH,26,82,4,13,17
11,8475208,Brian Dumoulin,D,SEA,33,82,3,14,17
11,8481567,Henry Thrun,D,SJS,23,82,2,15,17
11,8477369,Carson Soucy,D,VAN,30,82,2,15,17
11,8478399,Jonas Siegenthaler,D,NJD,27,82,1,16,17
11,8478859,Niko Mikkola,D,FLA,28,82,9,7,16
11,8480980,Connor Dewar,C,TOR,25,82,6,10,16
11,8479983,Mario Ferraro,D,SJS,26,82,5,11,16
11,8479324,Ryan Lindgren,D,NYR,26,82,5,11,16
11,8475825,Jani Hakanpää,D,DAL,32,82,5,11,16
11,8481014,Alexander Romanov,D,NYI,24,82,4,12,16
11,8477931,Tomas Nosek,L,NJD,32,82,4,12,16
11,8474013,Ian Cole,D,VAN,35,82,3,13,16
11,8482470,Ilya Solovyov,D,CGY,24,82,2,14,16
11,8477220,Nate Schmidt,D,WPG,33,82,1,15,16
11,8483489,Fraser Minten,C,TOR,31,82,9,6,15
11,8482177,Marat Khusnutdinov,C,MIN,22,82,7,8,15
11,8477406,Mattias Janmark,C,EDM,32,82,6,9,15
11,8477508,Curtis Lazar,C,NJD,29,82,5,10,15
11,8476442,Matt Nieto,L,PIT,32,82,5,10,15
11,8483505,Matthew Poitras,C,BOS,20,82,5,10,15
11,8480990,Declan Chisholm,D,MIN,24,82,5,10,15
11,8474166,Alec Martinez,D,VGK,37,82,5,10,15
11,8477365,Connor Clifton,D,BUF,29,82,3,12,15
11,8482062,Cole Smith,L,NSH,29,82,3,12,15
11,8475324,Nick Jensen,D,WSH,34,82,3,12,15
11,8478443,Brandon Carlo,D,BOS,28,82,2,13,15
11,8480807,Mattias Samuelsson,D,BUF,24,82,2,13,15
11,8475455,Brenden Dillon,D,WPG,34,82,2,13,15
11,8481093,Rafael Harvey-Pinard,L,MTL,25,82,12,2,14
11,8478043,Sam Lafferty,C,VAN,29,82,8,6,14
11,8479383,Boris Katchouk,L,OTT,26,82,5,9,14
11,8474009,Nick Bonino,C,NYR,36,82,4,10,14
11,8483468,Jiri Kulich,C,BUF,20,82,4,10,14
11,8480246,Nick Perbix,D,TBL,26,82,2,12,14
11,8482245,Artem Zub,D,OTT,29,82,2,12,14
11,8484911,Collin Graf,R,SJS,22,82,2,12,14
11,8478136,Jake Middleton,D,MIN,28,82,2,12,14
11,8482762,Simon Edvinsson,D,DET,21,82,6,7,13
11,8476422,Mike Reilly,D,NYI,31,82,5,8,13
11,8475177,Calvin de Haan,D,TBL,33,82,5,8,13
11,8477392,Hudson Fasching,R,NYI,29,82,5,8,13
11,8481704,Juuso Parssinen,C,NSH,23,82,3,10,13
11,8481537,Nikita Okhotiuk,D,CGY,24,82,3,10,13
11,8478416,Erik Cernak,D,TBL,27,82,3,10,13
11,8471677,Jack Johnson,D,COL,37,82,3,10,13
11,8479442,Troy Stecher,D,EDM,30,82,3,10,13
11,8476473,Connor Murphy,D,CHI,31,82,1,12,13
11,8473453,Trevor Lewis,C,LAK,37,82,8,4,12
11,8476822,Luke Glendening,C,TBL,35,82,8,4,12
11,8476372,Nick Seeler,D,PHI,31,82,3,9,12
11,8475762,Derek Forbort,D,BOS,32,82,2,10,12
11,8477034,Jaycob Megna,D,CHI,32,82,2,10,12
11,8482858,Ryker Evans,D,SEA,23,82,0,12,12
11,8482713,Mackie Samoskevich,R,FLA,22,82,5,6,11
11,8478408,Travis Dermott,D,ARI,28,82,3,8,11
11,8482859,Zack Ostapchuk,C,OTT,21,82,2,9,11
11,8475179,Dmitry Kulikov,D,FLA,34,82,1,10,11
11,8482516,Matthew Kessel,D,STL,24,82,0,11,11
11,8470966,Mark Giordano,D,TOR,41,82,3,7,10
11,8482712,Oskar Olausson,R,COL,22,82,3,7,10
11,8480834,Ty Emberson,D,SJS,24,82,4,5,9
11,8478468,Jeremy Lauzon,D,NSH,27,82,2,7,9
11,8480172,Jan Rutta,D,SJS,34,82,3,5,8
11,8479291,Kevin Rooney,C,CGY,31,82,3,5,8
11,8483763,Maksymilian Szuber,D,ARI,22,82,3,5,8
11,8474567,Zach Bogosian,D,MIN,34,82,2,6,8
11,8481030,Jack St. Ivany,D,PIT,25,82,1,7,8
11,8477335,Kyle Burroughs,D,SJS,29,82,4,3,7
11,8481578,Graeme Clarke,R,NJD,23,82,2,5,7
11,8484149,Gavin Brindley,C,CBJ,20,82,2,5,7
11,8482807,Ethan Del Mastro,D,CHI,21,82,2,5,7
11,8476915,Jujhar Khaira,L,MIN,30,82,1,4,5
11,8481599,Victor Soderstrom,D,ARI,23,82,0,5,5
11,8482141,Lukas Cormier,D,VGK,22,0,0,0,0
11,8476988,Matt Benning,D,SJS,30,0,0,0,0
11,8480727,Zach Whitecloud,D,VGK,28,0,0,0,0
11,8480887,Jordan Harris,D,MTL,24,0,0,0,0
11,8478450,Parker Wotherspoon,D,BOS,27,0,0,0,0
11,8481812,Nikolai Knyzhov,D,SJS,27,0,0,0,0
11,8480001,Urho Vaakanainen,D,ANA,25,0,0,0,0
11,8482176,Wyatt Kaiser,D,CHI,22,0,0,0,0
11,8481122,Simon Benoit,D,TOR,26,0,0,0,0
11,8476441,Joel Edmundson,D,TOR,31,0,0,0,0
11,8480884,Calen Addison,D,SJS,24,0,0,0,0
11,8482511,Mason Lohrei,D,BOS,23,0,0,0,0
11,8482192,Isaak Phillips,D,CHI,23,0,0,0,0
11,8480950,Ilya Lyubushkin,D,TOR,30,0,0,0,0
11,8474031,Kevin Shattenkirk,D,BOS,35,0,0,0,0
11,8475718,Justin Holl,D,DET,32,0,0,0,0
11,8479402,Jake Bean,D,CBJ,26,0,0,0,0
11,8474602,Justin Schultz,D,SEA,34,0,0,0,0
11,8477950,Tony DeAngelo,D,CAR,29,0,0,0,0
11,8481743,Marc Del Gaizo,D,NSH,25,0,0,0,0
11,8481527,Kaedan Korczak,D,VGK,23,0,0,0,0
11,8480192,Johnathan Kovacevic,D,MTL,27,0,0,0,0
11,8476874,Olli Maatta,D,DET,30,0,0,0,0
11,8482144,Jack Thompson,D,SJS,22,0,0,0,0
11,8480222,Sebastian Aho,D,NYI,28,0,0,0,0
11,8479458,Nikita Zaitsev,D,CHI,33,0,0,0,0
11,8471709,Marc-Edouard Vlasic,D,SJS,37,0,0,0,0
11,8482929,Emil Lilleberg,D,TBL,23,0,0,0,0
11,8477018,Ben Hutton,D,VGK,31,0,0,0,0
11,8481056,Spencer Stastney,D,NSH,24,0,0,0,0
11,8481593,Jayden Struble,D,MTL,23,0,0,0,0
11,8479982,Conor Timmins,D,TOR,26,0,0,0,0
11,8474090,Brendan Smith,D,NJD,35,0,0,0,0
11,8482964,Arber Xhekaj,D,MTL,23,0,0,0,0
11,8480891,Michael Kesselring,D,ARI,24,0,0,0,0
11,8477938,Haydn Fleury,D,TBL,28,0,0,0,0
11,8481806,Louis Crevier,D,CHI,23,0,0,0,0
11,8471274,Alex Goligoski,D,MIN,39,0,0,0,0
11,8481600,Tobias Bjornfot,D,FLA,23,0,0,0,0
11,8475797,Jarred Tinordi,D,CHI,32,0,0,0,0
11,8481521,Ronnie Attard,D,PHI,25,0,0,0,0
11,8474612,Travis Hamonic,D,OTT,34,0,0,0,0
11,8479576,Vincent Desharnais,D,EDM,28,0,0,0,0
11,8480049,Dylan Samberg,D,WPG,25,0,0,0,0
11,8483619,Filip Roos,D,CHI,25,0,0,0,0
11,8474568,Luke Schenn,D,NSH,35,0,0,0,0
11,8480184,Gustav Lindstrom,D,ANA,26,0,0,0,0
11,8480070,Ian Mitchell,D,BOS,25,0,0,0,0
11,8480196,Jacob Bryson,D,BUF,27,0,0,0,0
11,8471686,Marc Staal,D,PHI,37,0,0,0,0
11,8477467,Gustav Olofsson,D,SEA,30,0,0,0,0
11,8478970,Jalen Chatfield,D,CAR,28,0,0,0,0
11,8479348,Kale Clague,D,BUF,26,0,0,0,0
11,8473446,Erik Johnson,D,PHI,36,0,0,0,0
11,8477462,Robert Hagg,D,ANA,29,0,0,0,0
11,8478454,Noah Juulsen,D,VAN,27,0,0,0,0
11,8477384,Josh Brown,D,ARI,30,0,0,0,0
11,8481708,Zac Jones,D,NYR,24,0,0,0,0
11,8481167,Brayden Pachal,D,CGY,25,0,0,0,0
11,8482067,Connor Mackey,D,NYR,28,0,0,0,0
11,8483460,David Jiricek,D,CBJ,21,0,0,0,0
11,8481701,Santeri Hatakka,D,NJD,23,0,0,0,0
11,8478021,William Lagesson,D,ANA,28,0,0,0,0
11,8477851,Jordan Oesterle,D,CGY,32,0,0,0,0
11,8478452,Caleb Jones,D,COL,27,0,0,0,0
11,8479984,Cal Foote,D,NJD,26,0,0,0,0
11,8479639,Dylan Coghlan,D,CAR,26,0,0,0,0
11,8480874,Adam Ginning,D,PHI,24,0,0,0,0
11,8479321,Lucas Johansen,D,WSH,27,0,0,0,0
11,8480878,Nils Lundkvist,D,DAL,24,0,0,0,0
11,8482165,Yan Kuznetsov,D,CGY,22,0,0,0,0
11,8484258,Sam Malinski,D,COL,26,0,0,0,0
11,8480157,Calle Rosen,D,STL,30,0,0,0,0
11,8484304,Uvis Balinskis,D,FLA,28,0,0,0,0
11,8479985,Cale Fleury,D,SEA,26,0,0,0,0
11,8479378,Logan Stanley,D,WPG,26,0,0,0,0
11,8477541,Dakota Mermis,D,MIN,30,0,0,0,0
11,8481609,Vladislav Kolyachonok,D,ARI,23,0,0,0,0
11,8480823,Alexander Alexeyev,D,WSH,25,0,0,0,0
11,8481679,Maxence Guenette,D,OTT,23,0,0,0,0
11,8481564,Ryan Johnson,D,BUF,23,0,0,0,0
11,8479376,Victor Mete,D,PHI,26,0,0,0,0
11,8484254,Akito Hirose,D,VAN,25,0,0,0,0
11,8482660,Kent Johnson,C,CBJ,22,0,0,0,0
11,8482149,Cole Perfetti,C,WPG,22,0,0,0,0
11,8477987,Ryan Donato,C,CHI,28,0,0,0,0
11,8475755,Alexander Petrovic,D,DAL,32,0,0,0,0
11,8477810,Joel Hanley,D,CGY,33,0,0,0,0
11,8474145,Robert Bortuzzo,D,NYI,35,0,0,0,0
11,8481161,Jake Christiansen,D,CBJ,25,0,0,0,0
11,8476884,Derrick Pouliot,D,DAL,30,0,0,0,0
11,8481716,Dmitri Voronkov,L,CBJ,24,0,0,0,0
11,8480084,Nick DeSimone,D,NJD,30,0,0,0,0
11,8475750,Jon Merrill,D,MIN,32,0,0,0,0
11,8479315,Joey Anderson,R,CHI,26,0,0,0,0
11,8478011,Louie Belpedio,D,PHI,28,0,0,0,0
11,8482451,Mikael Pyyhtia,L,CBJ,23,0,0,0,0
11,8481541,Samuel Bolduc,D,NYI,24,0,0,0,0
11,8482126,Emil Andrae,D,PHI,31,0,0,0,0
11,8474618,Marco Scandella,D,STL,34,0,0,0,0
11,8477244,Chad Ruhwedel,D,NYR,34,0,0,0,0
11,8477971,Andreas Englund,D,LAK,28,0,0,0,0
11,8480829,Jesperi Kotkaniemi,C,CAR,24,0,0,0,0
11,8479372,Josh Mahura,D,FLA,26,0,0,0,0
11,8482095,Tyler Kleven,D,OTT,22,0,0,0,0
11,8481719,Maxwell Crozier,D,TBL,24,0,0,0,0
11,8475855,Jesper Fast,R,CAR,33,0,0,0,0
11,8480848,Ty Dellandrea,C,DAL,24,0,0,0,0
11,8475193,Tomas Tatar,L,SEA,34,0,0,0,0
11,8476889,Radek Faksa,C,DAL,30,0,0,0,0
11,8478495,Denis Gurianov,R,PHI,27,0,0,0,0
11,8480216,Jacob Peterson,C,SJS,25,0,0,0,0
11,8480252,Cole Guttman,C,CHI,25,0,0,0,0
11,8479026,Philippe Myers,D,TBL,27,0,0,0,0
11,8481006,Tyler Tucker,D,STL,24,0,0,0,0
11,8481032,Paul Cotter,C,VGK,25,0,0,0,0
11,8481577,Philip Tomasino,C,NSH,23,0,0,0,0
11,8476918,Jimmy Vesey,L,NYR,31,0,0,0,0
11,8479320,Max Lajoie,D,TOR,27,0,0,0,0
11,8478017,Mark Friedman,D,VAN,29,0,0,0,0
11,8481754,Nikita Nesterenko,C,ANA,23,0,0,0,0
11,8483407,Brandon Scanlin,D,NYR,25,0,0,0,0
11,8482659,Josh Doan,R,ARI,22,0,0,0,0
11,8477446,Michael McCarron,R,NSH,29,0,0,0,0
11,8477903,Garnet Hathaway,R,PHI,33,0,0,0,0
11,8482153,Brendan Brisson,C,VGK,23,0,0,0,0
11,8483546,Marshall Rifai,D,TOR,26,0,0,0,0
11,8484287,Cole McWard,D,VAN,23,0,0,0,0
11,8478854,Ryan Shea,D,PIT,27,0,0,0,0
11,8481585,Egor Afanasyev,L,NSH,23,0,0,0,0
11,8483398,Declan Carlile,D,TBL,31,0,0,0,0
11,8478502,Dennis Gilbert,D,CGY,28,0,0,0,0
11,8482749,Joshua Roy,R,MTL,21,0,0,0,0
11,8481598,Philip Broberg,D,EDM,23,0,0,0,0
11,8480835,Jack Drury,C,CAR,24,0,0,0,0
11,8480748,Kiefer Sherwood,L,NSH,29,0,0,0,0
11,8476934,Brock McGinn,L,ANA,30,0,0,0,0
11,8480870,Bo Groulx,C,ANA,24,0,0,0,0
11,8479368,Max Jones,L,ANA,26,0,0,0,0
11,8478099,Kevin Labanc,R,SJS,29,0,0,0,0
11,8478067,Oskar Lindblom,L,SJS,28,0,0,0,0
11,8476393,Nick Cousins,C,FLA,31,0,0,0,0
11,8483395,Arshdeep Bains,L,VAN,23,0,0,0,0
11,8480762,Eric Robinson,L,BUF,29,0,0,0,0
11,8479439,Jacob MacDonald,D,SJS,31,0,0,0,0
11,8476474,Stefan Noesen,R,CAR,31,0,0,0,0
11,8482787,Nikita Chibrikov,R,WPG,31,0,0,0,0
11,8478432,Christian Fischer,R,DET,27,0,0,0,0
11,8477979,Nicolas Aube-Kubel,R,WSH,28,0,0,0,0
11,8481789,Tye Kartye,L,SEA,23,0,0,0,0
11,8479330,Brandon Gignac,C,MTL,27,0,0,0,0
11,8480075,Cameron Crotty,D,ARI,25,0,0,0,0
11,8473473,Milan Lucic,L,BOS,36,0,0,0,0
11,8482094,Daemon Hunt,D,MIN,22,0,0,0,0
11,8481206,John Ludvig,D,PIT,24,0,0,0,0
11,8483630,Pavol Regenda,L,ANA,25,0,0,0,0
11,8481617,Vasily Podkolzin,R,VAN,23,0,0,0,0
11,8480306,Grant Hutton,D,NYI,29,0,0,0,0
11,8480995,Pontus Holmberg,R,TOR,25,0,0,0,0
11,8482148,Hendrix Lapierre,C,WSH,22,0,0,0,0
11,8477478,William Carrier,L,VGK,30,0,0,0,0
11,8480003,Jesper Boqvist,C,BOS,26,0,0,0,0
11,8482172,Landon Slaggert,L,CHI,22,0,0,0,0
11,8480789,Oliver Wahlstrom,R,NYI,24,0,0,0,0
11,8474062,Riley Nash,C,NYR,35,0,0,0,0
11,8480021,Jack Studnicka,C,SJS,25,0,0,0,0
11,8480025,MacKenzie Entwistle,R,CHI,25,0,0,0,0
11,8481582,Nicholas Robertson,L,TOR,23,0,0,0,0
11,8476867,Brendan Gaunce,C,CBJ,30,0,0,0,0
11,8479619,Michael Carcone,L,ARI,28,0,0,0,0
11,8479370,Tyson Jost,C,BUF,26,0,0,0,0
11,8479671,Mathieu Olivier,R,CBJ,27,0,0,0,0
11,8476994,Vinnie Hinostroza,C,PIT,30,0,0,0,0
11,8482070,Mitchell Chaffee,R,TBL,26,0,0,0,0
11,8477473,Justin Bailey,R,SJS,29,0,0,0,0
11,8479344,Jesse Puljujarvi,R,PIT,26,0,0,0,0
11,8480205,Emil Bemstrom,C,PIT,25,0,0,0,0
11,8479718,Alex Barré-Boulet,C,TBL,27,0,0,0,0
11,8482061,Brandon Biro,L,BUF,26,0,0,0,0
11,8479638,Justin Brazeau,R,BOS,26,0,0,0,0
11,8474040,Sam Gagner,C,EDM,35,0,0,0,0
11,8477846,Ryan Carpenter,C,SJS,33,0,0,0,0
11,8482077,Dylan Holloway,L,EDM,23,0,0,0,0
11,8482157,Will Cuylle,L,NYR,22,0,0,0,0
11,8480007,Jonas Rondbjerg,R,VGK,25,0,0,0,0
11,8478874,Adam Gaudette,C,STL,28,0,0,0,0
11,8478434,Keegan Kolesar,R,VGK,27,0,0,0,0
11,8480441,Trey Fix-Wolansky,R,CBJ,25,0,0,0,0
11,8479994,Jaret Anderson-Dolan,C,NSH,25,0,0,0,0
11,8483567,Georgii Merkulov,C,BOS,24,0,0,0,0
11,8477380,Jonny Brodzinski,C,NYR,31,0,0,0,0
11,8482201,Gage Goncalves,C,TBL,23,0,0,0,0
11,8478211,Dryden Hunt,L,CGY,29,0,0,0,0
11,8471699,Andrew Cogliano,C,COL,37,0,0,0,0
11,8479421,Jacob Moverare,D,LAK,26,0,0,0,0
11,8478881,Brett Seney,L,CHI,28,0,0,0,0
11,8477464,Nic Petan,C,MIN,29,0,0,0,0
11,8475958,Michael Sgarbossa,C,WSH,32,0,0,0,0
11,8481147,Reese Johnson,C,CHI,26,0,0,0,0
11,8479336,Carl Grundstrom,R,LAK,27,0,0,0,0
11,8480853,Liam Foudy,C,NSH,24,0,0,0,0
11,8479522,Hardy Haman Aktell,D,WSH,26,0,0,0,0
11,8481462,Mason Morelli,L,VGK,28,0,0,0,0
11,8482102,Vasily Ponomarev,C,CAR,22,0,0,0,0
11,8480844,Grigori Denisenko,L,VGK,24,0,0,0,0
11,8479944,Zach Aston-Reese,C,DET,30,0,0,0,0
11,8482784,Zach Dean,C,STL,21,0,0,0,0
11,8479419,Brett Murray,L,BUF,26,0,0,0,0
11,8479520,Brandon Duhaime,R,COL,27,0,0,0,0
11,8477573,Nathan Walker,L,STL,30,0,0,0,0
11,8478078,Rourke Chartier,C,OTT,28,0,0,0,0
11,8475795,Dylan McIlrath,D,WSH,32,0,0,0,0
11,8482496,Nils Aman,C,VAN,24,0,0,0,0
11,8480289,Morgan Barron,C,WPG,26,0,0,0,0
11,8481751,Lukas Rousek,R,BUF,25,0,0,0,0
11,8480011,Klim Kostin,C,SJS,25,0,0,0,0
11,8481556,John Beecher,C,BOS,23,0,0,0,0
11,8475278,Byron Froese,C,VGK,33,0,0,0,0
11,8475225,Craig Smith,C,DAL,35,0,0,0,0
11,8484326,Patrik Koch,D,ARI,28,0,0,0,0
11,8477930,Pierre-Edouard Bellemare,L,SEA,39,0,0,0,0
11,8478409,Anthony Richard,C,BOS,28,0,0,0,0
11,8481024,Linus Karlsson,C,VAN,25,0,0,0,0
11,8479986,Kole Lind,R,SEA,26,0,0,0,0
11,8479414,Nathan Bastian,R,NJD,27,0,0,0,0
11,8479362,Riley Tufte,L,COL,26,0,0,0,0
11,8481058,Jesse Ylönen,R,MTL,25,0,0,0,0
11,8482476,Emil Heineman,L,MTL,23,0,0,0,0
11,8482861,Vincent Iorio,D,WSH,22,0,0,0,0
11,8483432,Luca Del Bel Belluz,C,CBJ,31,0,0,0,0
11,8482744,James Malatesta,L,CBJ,21,0,0,0,0
11,8477887,Patrick Brown,C,BOS,32,0,0,0,0
11,8478585,Derek Ryan,C,EDM,38,0,0,0,0
11,8481441,Joe Snively,C,WSH,28,0,0,0,0
11,8481592,Jakob Pelletier,L,CGY,23,0,0,0,0
11,8482634,Alex Steeves,C,TOR,25,0,0,0,0
11,8477126,Jayson Megna,C,BOS,34,0,0,0,0
11,8475752,Tyler Pitlick,C,NYR,33,0,0,0,0
11,8480008,Adam Ruzicka,C,ARI,25,0,0,0,0
11,8481065,Angus Crookshank,L,OTT,25,0,0,0,0
11,8479547,Matthew Phillips,R,WSH,26,0,0,0,0
11,8480226,Marián Studenic,R,SEA,26,0,0,0,0
11,8481237,Kyle MacLean,C,NYI,25,0,0,0,0
11,8475413,Justin Dowling,C,NJD,34,0,0,0,0
11,8481641,Joel Kiviranta,L,COL,28,0,0,0,0
11,8478104,Sammy Blais,L,STL,28,0,0,0,0
11,8477454,Adam Erne,L,EDM,29,0,0,0,0
11,8481518,Nolan Foote,L,NJD,24,0,0,0,0
11,8480245,Olle Lycksell,R,PHI,25,0,0,0,0
11,8483570,Ben Meyers,C,ANA,26,0,0,0,0
11,8480776,Sheldon Rempal,R,VGK,29,0,0,0,0
11,8483920,Pierrick Dube,R,WSH,23,0,0,0,0
11,8480267,Sammy Walker,C,MIN,25,0,0,0,0
11,8482747,Brennan Othmann,L,NYR,21,0,0,0,0
11,8479991,Jake Leschyshyn,C,NYR,25,0,0,0,0
11,8478400,Colin White,C,MTL,27,0,0,0,0
11,8479328,Julien Gauthier,R,NYI,27,0,0,0,0
11,8484325,Waltteri Merela,C,TBL,26,0,0,0,0
11,8479066,Ryan Lomberg,L,FLA,30,0,0,0,0
11,8477070,Liam O'Brien,C,ARI,30,0,0,0,0
11,8478146,Matthew Highmore,C,OTT,28,0,0,0,0
11,8478028,Fredrik Olofsson,L,COL,28,0,0,0,0
11,8480880,Jakub Lauko,C,BOS,24,0,0,0,0
11,8479968,Vinni Lettieri,C,MIN,29,0,0,0,0
11,8474709,Matt Martin,L,NYI,35,0,0,0,0
11,8480845,Rasmus Kupari,C,WPG,24,0,0,0,0
11,8481550,Adam Beckman,L,MIN,23,0,0,0,0
11,8481422,Jacob Lucchini,C,MIN,29,0,0,0,0
11,8477401,John Hayden,C,SEA,29,0,0,0,0
11,8478904,Steven Lorentz,C,FLA,28,0,0,0,0
11,8482088,Justin Sourdif,R,FLA,22,0,0,0,0
11,8482751,Ryan Winterton,C,SEA,21,0,0,0,0
11,8482241,Radim Zohorna,L,PIT,28,0,0,0,0
11,8481690,Tyler Angle,C,CBJ,24,0,0,0,0
11,8476952,Dominic Toninato,C,WPG,30,0,0,0,0
11,8476919,Chris Tierney,C,NJD,30,0,0,0,0
11,8480032,Shane Bowers,C,NJD,25,0,0,0,0
11,8484314,Jiri Smejkal,L,OTT,28,0,0,0,0
11,8481239,Samuel Fagemo,L,LAK,24,0,0,0,0
11,8481532,Alex Turcotte,C,LAK,23,0,0,0,0
11,8481019,David Gustafsson,C,WPG,24,0,0,0,0
11,8478477,Mitchell Stephens,C,MTL,27,0,0,0,0
11,8479546,Oskar Steen,C,BOS,26,0,0,0,0
11,8480292,Carson Meyer,R,CBJ,27,0,0,0,0
11,8478446,Glenn Gawdin,C,ANA,27,0,0,0,0
11,8483531,Brian Halonen,L,NJD,25,0,0,0,0
11,8477149,Scott Sabourin,R,SJS,32,0,0,0,0
11,8479972,Mason Shaw,C,MIN,26,0,0,0,0
11,8480890,Jan Jenik,R,ARI,24,0,0,0,0
11,8478051,Max Willman,C,NJD,29,0,0,0,0
11,8480851,Akil Thomas,C,LAK,24,0,0,0,0
11,8482765,Isak Rosen,R,BUF,21,0,0,0,0
11,8478421,A.J. Greer,L,CGY,28,0,0,0,0
11,8478512,Austin Czarnik,C,DET,32,0,0,0,0
11,8479536,Axel Jonsson-Fjallby,L,WPG,26,0,0,0,0
11,8477320,Anton Blidh,L,NYR,29,0,0,0,0
11,8481543,Nikita Alexandrov,C,STL,24,0,0,0,0
11,8475235,Nicolas Deslauriers,L,PHI,33,0,0,0,0
11,8481070,Hugh McGing,L,STL,26,0,0,0,0
11,8480836,Jonathan Gruden,C,PIT,24,0,0,0,0
11,8481591,Sam Poulin,R,PIT,23,0,0,0,0
11,8477962,Brendan Lemieux,L,CAR,28,0,0,0,0
11,8483401,Marc Johnstone,R,PIT,28,0,0,0,0
11,8482250,Callahan Burke,C,CAR,27,0,0,0,0
11,8481726,Adam Edstrom,C,NYR,24,0,0,0,0
11,8471817,Ryan Reaves,R,TOR,37,0,0,0,0
11,8479587,Rhett Gardner,C,PHI,28,0,0,0,0
11,8475766,Austin Watson,L,TBL,32,0,0,0,0
11,8479367,William Lockwood,R,FLA,26,0,0,0,0
11,8478424,Jansen Harkins,C,PIT,27,0,0,0,0
11,8476913,Devin Shore,C,SEA,30,0,0,0,0
11,8482652,Walker Duehr,R,CGY,27,0,0,0,0
11,8477527,Ross Johnston,L,ANA,30,0,0,0,0
11,8481077,John Leonard,L,ARI,26,0,0,0,0
11,8483549,Lucas Condotta,L,MTL,27,0,0,0,0
11,8480468,James Hamblin,L,EDM,25,0,0,0,0
11,8476907,Mackenzie MacEachern,L,STL,30,0,0,0,0
11,8479543,Michael Pezzetta,L,MTL,26,0,0,0,0
11,8480355,Mark Kastelic,C,OTT,25,0,0,0,0
11,8482162,Roby Jarventie,L,OTT,22,0,0,0,0
11,8479772,Zack MacEwen,R,OTT,28,0,0,0,0
11,8483597,Milos Kelemen,L,ARI,25,0,0,0,0
11,8479379,Givani Smith,R,SJS,26,0,0,0,0
11,8481655,Cole Schwindt,R,CGY,23,0,0,0,0
11,8479981,Jonah Gadjovich,L,FLA,26,0,0,0,0
11,8482147,Jean-Luc Foudy,C,COL,22,0,0,0,0
11,8484255,Jason Polin,R,COL,25,0,0,0,0
11,8477993,Justin Kirkland,C,ARI,28,0,0,0,0
11,8479249,Andrew Poturalski,C,SEA,30,0,0,0,0
11,8482197,Adam Raska,R,MIN,23,0,0,0,0
11,8475780,Chris Wagner,R,COL,33,0,0,0,0
11,8479533,Joona Koppanen,L,PIT,26,0,0,0,0
11,8481534,Raphael Lavoie,C,EDM,24,0,0,0,0
11,8484321,Nikolas Matinpalo,D,OTT,26,0,0,0,0
11,8481043,Cole Koepke,L,TBL,26,0,0,0,0
11,8476323,Max McCormick,L,SEA,32,0,0,0,0
11,8483609,Adam Klapka,R,CGY,24,0,0,0,0
11,8483512,Matt Savoie,C,BUF,20,0,0,0,0
11,8484259,Ondrej Pavel,C,COL,31,0,0,0,0
11,8478147,Bokondji Imama,L,OTT,28,0,0,0,0
11,8482460,Matt Rempe,C,NYR,22,0,0,0,0
11,8477073,Kurtis MacDermid,L,NJD,30,0,0,0,0
11,8480274,Philip Kemp,D,EDM,25,0,0,0,0
11,8478956,Samuel Laberge,L,NJD,27,0,0,0,0
11,8483045,Cameron Butler,R,CBJ,31,0,0,0,0
12,8481559,Jack Hughes,C,NJD,23,82,52,67,119
12,8477492,Nathan MacKinnon,C,COL,29,82,43,75,118
12,8478402,Connor McDavid,C,EDM,27,82,35,79,114
12,8479318,Auston Matthews,C,TOR,27,82,56,56,112
12,8477934,Leon Draisaitl,C,EDM,29,82,41,70,111
12,8476453,Nikita Kucherov,R,TBL,31,82,32,76,108
12,8477956,David Pastrnak,R,BOS,28,82,48,57,105
12,8480027,Jason Robertson,L,DAL,25,82,37,61,98
12,8478864,Kirill Kaprizov,L,MIN,27,82,43,49,92
12,8478550,Artemi Panarin,L,NYR,33,82,38,52,90
12,8479314,Matthew Tkachuk,L,FLA,27,82,35,52,87
12,8477404,Jake Guentzel,C,CAR,30,82,36,50,86
12,8476468,J.T. Miller,C,VAN,31,82,34,51,85
12,8475172,Nazem Kadri,C,CGY,34,82,36,47,83
12,8477949,Alex Tuch,R,BUF,28,82,25,58,83
12,8478439,Travis Konecny,R,PHI,27,82,40,42,82
12,8478398,Kyle Connor,L,WPG,28,82,39,43,82
12,8478420,Mikko Rantanen,R,COL,28,82,38,44,82
12,8480002,Nico Hischier,C,NJD,25,82,29,53,82
12,8476460,Mark Scheifele,C,WPG,31,82,27,55,82
12,8477933,Sam Reinhart,C,FLA,29,82,40,39,79
12,8481523,Kirby Dach,C,MTL,23,82,14,65,79
12,8476887,Filip Forsberg,L,NSH,30,82,38,40,78
12,8477501,Valeri Nichushkin,R,COL,29,82,34,44,78
12,8480012,Elias Pettersson,C,VAN,26,82,25,53,78
12,8482093,Seth Jarvis,C,CAR,22,82,32,45,77
12,8479407,Jesper Bratt,L,NJD,26,82,27,50,77
12,8477942,Kevin Fiala,L,LAK,28,82,27,49,76
12,8476456,Jonathan Huberdeau,C,CGY,31,82,16,60,76
12,8482116,Tim Stützle,C,OTT,22,82,28,47,75
12,8476346,Johnny Gaudreau,L,CBJ,31,82,18,57,75
12,8478427,Sebastian Aho,C,CAR,27,82,35,39,74
12,8475913,Mark Stone,R,VGK,32,82,26,48,74
12,8476454,Ryan Nugent-Hopkins,C,EDM,31,82,22,52,74
12,8480069,Cale Makar,D,COL,26,82,18,55,73
12,8478403,Jack Eichel,C,VGK,28,82,37,35,72
12,8479343,Clayton Keller,R,ARI,26,82,35,37,72
12,8477402,Pavel Buchnevich,L,STL,29,82,29,43,72
12,8480023,Robert Thomas,C,STL,25,82,25,47,72
12,8479323,Adam Fox,D,NYR,26,82,13,59,72
12,8478010,Brayden Point,C,TBL,28,82,39,32,71
12,8477940,Nikolaj Ehlers,L,WPG,28,82,25,46,71
12,8480036,Miro Heiskanen,D,DAL,25,82,22,49,71
12,8480014,Gabriel Vilardi,C,WPG,25,82,38,32,70
12,8475810,Bryan Rust,R,PIT,32,82,27,43,70
12,8474600,Roman Josi,D,NSH,34,82,18,52,70
12,8477493,Aleksander Barkov,C,FLA,29,82,25,44,69
12,8475754,Brock Nelson,C,NYI,33,82,38,30,68
12,8478414,Timo Meier,R,NJD,28,82,34,34,68
12,8477960,Adrian Kempe,R,LAK,28,82,33,35,68
12,8470794,Joe Pavelski,C,DAL,40,82,31,37,68
12,8480018,Nick Suzuki,C,MTL,25,82,26,42,68
12,8480801,Brady Tkachuk,L,OTT,25,82,38,29,67
12,8471675,Sidney Crosby,C,PIT,37,82,30,37,67
12,8474564,Steven Stamkos,C,TBL,34,82,30,37,67
12,8473419,Brad Marchand,L,BOS,36,82,25,42,67
12,8471685,Anze Kopitar,C,LAK,37,82,24,43,67
12,8477409,Carter Verhaeghe,C,FLA,29,82,30,36,66
12,8478449,Roope Hintz,C,DAL,28,82,29,37,66
12,8475798,Mikael Granlund,C,SJS,32,82,16,50,66
12,8479385,Jordan Kyrou,C,STL,26,82,27,38,65
12,8478460,Zach Werenski,D,CBJ,27,82,17,48,65
12,8477939,William Nylander,R,TOR,28,82,26,38,64
12,8481557,Matt Boldy,L,MIN,23,82,24,40,64
12,8476389,Vincent Trocheck,C,NYR,31,82,21,43,64
12,8480800,Quinn Hughes,D,VAN,25,82,14,50,64
12,8478440,Dylan Strome,C,WSH,27,82,28,35,63
12,8478445,Mathew Barzal,C,NYI,27,82,21,42,63
12,8471215,Evgeni Malkin,C,PIT,38,82,20,43,63
12,8479420,Tage Thompson,C,BUF,27,82,33,29,62
12,8477955,Jared McCann,L,SEA,28,82,31,31,62
12,8478444,Brock Boeser,R,VAN,27,82,29,33,62
12,8474578,Erik Karlsson,D,PIT,34,82,23,39,62
12,8476462,Dougie Hamilton,D,NJD,31,82,22,40,62
12,8475167,Victor Hedman,D,TBL,34,82,9,53,62
12,8479339,Patrik Laine,L,CBJ,26,82,28,33,61
12,8475166,John Tavares,C,TOR,34,82,26,35,61
12,8476881,Tomas Hertl,C,VGK,31,82,22,39,61
12,8479999,Casey Mittelstadt,C,COL,26,82,20,41,61
12,8471214,Alex Ovechkin,L,WSH,39,82,29,31,60
12,8475794,Tyler Seguin,C,DAL,32,82,26,34,60
12,8477504,Josh Morrissey,D,WPG,29,82,18,42,60
12,8482684,Luke Hughes,D,NJD,21,82,17,43,60
12,8475692,Mats Zuccarello,R,MIN,37,82,15,45,60
12,8479425,Filip Hronek,D,VAN,27,82,9,51,60
12,8480015,Owen Tippett,R,PHI,25,82,30,29,59
12,8478493,Joel Eriksson Ek,C,MIN,27,82,29,30,59
12,8482740,Wyatt Johnston,C,DAL,21,82,26,33,59
12,8481528,Dylan Cozens,C,BUF,23,82,24,35,59
12,8478042,Viktor Arvidsson,R,LAK,31,82,23,36,59
12,8480830,Andrei Svechnikov,R,CAR,24,82,15,44,59
12,8480839,Rasmus Dahlin,D,BUF,24,82,14,45,59
12,8475786,Zach Hyman,L,EDM,32,82,39,19,58
12,8475158,Ryan O'Reilly,C,NSH,33,82,27,31,58
12,8477451,Ryan Hartman,R,MIN,30,82,26,32,58
12,8475168,Matt Duchene,C,DAL,33,82,24,34,58
12,8478873,Troy Terry,R,ANA,27,82,26,31,57
12,8481068,Yegor Sharangovich,C,CGY,26,82,26,31,57
12,8477496,Elias Lindholm,C,VAN,30,82,25,32,57
12,8482078,Lucas Raymond,L,DET,22,82,23,34,57
12,8473512,Claude Giroux,R,OTT,36,82,19,38,57
12,8480031,Maxime Comtois,L,CAR,25,82,15,42,57
12,8476853,Morgan Rielly,D,TOR,30,82,8,49,57
12,8474641,Adam Henrique,C,EDM,34,82,30,26,56
12,8476448,William Karlsson,C,VGK,31,82,23,33,56
12,8477946,Dylan Larkin,C,DET,28,82,19,37,56
12,8477964,Ivan Barbashev,C,VGK,29,82,19,37,56
12,8474590,John Carlson,D,WSH,34,82,16,40,56
12,8476905,Chandler Stephenson,C,VGK,30,82,13,43,56
12,8480803,Evan Bouchard,D,EDM,25,82,9,47,56
12,8475184,Chris Kreider,L,NYR,33,82,29,26,55
12,8477500,Bo Horvat,C,NYI,29,82,26,29,55
12,8475784,Jeff Skinner,C,BUF,32,82,25,30,55
12,8481533,Trevor Zegras,C,ANA,23,82,17,38,55
12,8482745,Mason McTavish,C,ANA,21,82,31,23,54
12,8475765,Vladimir Tarasenko,R,FLA,33,82,27,27,54
12,8478975,Mason Marchment,L,DAL,29,82,23,31,54
12,8476459,Mika Zibanejad,C,NYR,31,82,20,34,54
12,8481540,Cole Caufield,R,MTL,23,82,30,23,53
12,8477494,Jonathan Drouin,L,COL,29,82,19,34,53
12,8480078,Filip Chytil,C,NYR,25,82,15,38,53
12,8474141,Patrick Kane,R,DET,36,82,13,40,53
12,8478397,Rasmus Andersson,D,CGY,28,82,12,41,53
12,8478438,Tommy Novak,C,NSH,27,82,22,30,52
12,8480039,Martin Necas,C,CAR,25,82,21,31,52
12,8479400,Pierre-Luc Dubois,L,LAK,26,82,21,31,52
12,8480434,Sean Durzi,D,ARI,26,82,17,35,52
12,8474150,Mikael Backlund,C,CGY,35,82,16,36,52
12,8480865,Noah Dobson,D,NYI,24,82,14,38,52
12,8478047,Michael Bunting,L,PIT,29,82,23,28,51
12,8477416,Oliver Bjorkstrand,R,SEA,29,82,21,30,51
12,8479675,Trevor Moore,L,LAK,29,82,20,31,51
12,8474679,Gustav Nyquist,C,NSH,35,82,17,34,51
12,8476479,Phillip Danault,C,LAK,31,82,15,36,51
12,8477495,Seth Jones,D,CHI,30,82,14,37,51
12,8482109,Alexis Lafrenière,L,NYR,23,82,29,21,50
12,8479337,Alex DeBrincat,R,DET,27,82,28,22,50
12,8480188,Fabian Zetterlund,L,SJS,25,82,28,22,50
12,8475314,Anders Lee,L,NYI,34,82,26,24,50
12,8477479,Tyler Bertuzzi,L,TOR,29,82,21,29,50
12,8478407,Vince Dunn,D,SEA,28,82,8,42,50
12,8480208,Drake Batherson,R,OTT,26,82,28,21,49
12,8479525,Ross Colton,C,COL,28,82,27,22,49
12,8483808,Andrei Kuzmenko,L,CGY,28,82,25,24,49
12,8475151,Kyle Palmieri,C,NYI,33,82,16,33,49
12,8479325,Charlie McAvoy,D,BOS,27,82,11,38,49
12,8476792,Torey Krug,D,STL,33,82,7,42,49
12,8477476,Artturi Lehkonen,L,COL,29,82,23,25,48
12,8482159,Tyson Foerster,R,PHI,22,82,21,27,48
12,8481596,Shane Pinto,C,OTT,24,82,19,29,48
12,8474053,Logan Couture,C,SJS,35,82,19,29,48
12,8477986,Brandon Montour,D,FLA,30,82,16,32,48
12,8477444,Andre Burakovsky,L,SEA,29,82,15,33,48
12,8471724,Kris Letang,D,PIT,37,82,8,40,48
12,8475197,Tyson Barrie,D,NSH,33,82,7,41,48
12,8476539,Jonathan Marchessault,R,VGK,34,82,29,18,47
12,8475169,Evander Kane,L,EDM,33,82,24,23,47
12,8473986,Alex Killorn,L,ANA,35,82,18,29,47
12,8473994,Jamie Benn,L,DAL,35,82,15,32,47
12,8476875,Mike Matheson,D,MTL,30,82,12,35,47
12,8475753,Justin Faulk,D,STL,32,82,5,42,47
12,8478519,Anthony Cirelli,C,TBL,27,82,22,24,46
12,8478462,Nicolas Roy,C,VGK,27,82,20,26,46
12,8482665,Matty Beniers,C,SEA,22,82,17,29,46
12,8478396,Noah Hanifin,D,VGK,27,82,10,36,46
12,8477447,Shea Theodore,D,VGK,29,82,9,37,46
12,8477951,Nick Schmaltz,C,ARI,28,82,9,37,46
12,8477935,Sam Bennett,C,FLA,28,82,22,23,45
12,8479345,Jakob Chychrun,D,OTT,26,82,16,29,45
12,8477021,Alex Kerfoot,C,ARI,30,82,13,32,45
12,8478401,Pavel Zacha,C,BOS,27,82,13,32,45
12,8474586,Jordan Eberle,R,SEA,34,82,11,34,45
12,8476906,Shayne Gostisbehere,D,DET,31,82,8,37,45
12,8479410,Mikhail Sergachev,D,TBL,26,82,8,37,45
12,8478498,Jake DeBrusk,L,BOS,28,82,25,19,44
12,8477497,Sean Monahan,C,WPG,30,82,22,22,44
12,8476292,Ondrej Palat,L,NJD,33,82,20,24,44
12,8476432,Boone Jenner,C,CBJ,31,82,20,24,44
12,8476399,Blake Coleman,C,CGY,33,82,19,25,44
12,8477456,J.T. Compher,L,DET,29,82,17,27,44
12,8471218,Blake Wheeler,R,NYR,38,82,17,27,44
12,8476329,Travis Boyd,C,ARI,31,82,15,29,44
12,8482146,Luke Evangelista,R,NSH,22,82,14,30,44
12,8482667,William Eklund,L,SJS,22,82,13,31,44
12,8482101,Danil Gushchin,L,SJS,22,82,28,15,43
12,8476483,Rickard Rakell,R,PIT,31,82,26,17,43
12,8475726,Tyler Toffoli,C,WPG,32,82,22,21,43
12,8475791,Taylor Hall,L,CHI,33,82,19,24,43
12,8478366,Frank Vatrano,R,ANA,30,82,25,17,42
12,8482089,Jake Neighbours,L,STL,22,82,25,17,42
12,8477407,Anthony Duclair,L,TBL,29,82,24,18,42
12,8475768,Jaden Schwartz,C,SEA,32,82,20,22,42
12,8480797,Joel Farabee,L,PHI,24,82,16,26,42
12,8475793,Ryan Johansen,C,PHI,32,82,15,27,42
12,8483515,Juraj Slafkovsky,L,MTL,20,82,15,27,42
12,8475218,Mattias Ekholm,D,EDM,34,82,13,29,42
12,8479987,Morgan Geekie,C,BOS,26,82,13,29,42
12,8476880,Tom Wilson,R,WSH,30,82,24,17,41
12,8474102,David Perron,L,DET,36,82,23,18,41
12,8479423,Alex Nylander,L,CBJ,26,82,20,21,41
12,8477953,Kasperi Kapanen,R,STL,28,82,18,23,41
12,8480220,Noah Cates,L,PHI,25,82,14,27,41
12,8482671,Owen Power,D,BUF,22,82,7,34,41
12,8483397,Marc McLaughlin,C,BOS,25,82,34,6,40
12,8478466,Daniel Sprong,R,DET,27,82,24,16,40
12,8482097,Jack Quinn,R,BUF,23,82,21,19,40
12,8477503,Max Domi,C,TOR,29,82,16,24,40
12,8476826,Yanni Gourde,C,SEA,33,82,15,25,40
12,8475287,Erik Haula,L,NJD,33,82,15,25,40
12,8477932,Aaron Ekblad,D,FLA,28,82,12,28,40
12,8480336,Sean Walker,D,COL,30,82,12,28,40
12,8474565,Alex Pietrangelo,D,VGK,34,82,11,29,40
12,8483524,Shane Wright,C,SEA,20,82,26,13,39
12,8482699,Dylan Guenther,R,ARI,21,82,24,15,39
12,8477426,Nicholas Paul,L,TBL,29,82,20,19,39
12,8482175,JJ Peterka,R,BUF,22,82,19,20,39
12,8476438,Brandon Saad,L,STL,32,82,18,21,39
12,8474157,Max Pacioretty,L,WSH,36,82,17,22,39
12,8482124,Quinton Byfield,R,LAK,22,82,16,23,39
12,8475191,Reilly Smith,R,PIT,33,82,14,25,39
12,8478233,Andrew Mangiapane,L,CGY,28,82,14,25,39
12,8475744,Evgeny Kuznetsov,C,CAR,32,82,13,26,39
12,8480064,Josh Norris,C,OTT,25,82,12,27,39
12,8476461,Sean Couturier,C,PHI,32,82,12,27,39
12,8478055,Gustav Forsling,D,FLA,28,82,9,30,39
12,8476923,Damon Severson,D,CBJ,30,82,6,33,39
12,8481546,Cam York,D,PHI,23,82,6,33,39
12,8479542,Brandon Hagel,L,TBL,26,82,21,17,38
12,8478474,Lawson Crouse,L,ARI,27,82,21,17,38
12,8481560,Arthur Kaliyev,R,LAK,23,82,21,17,38
12,8482113,Anton Lundell,C,FLA,23,82,19,19,38
12,8475170,Brayden Schenn,C,STL,33,82,17,21,38
12,8475763,Kevin Hayes,R,STL,32,82,16,22,38
12,8476882,Teuvo Teravainen,L,CAR,30,82,16,22,38
12,8477998,Warren Foegele,L,EDM,28,82,15,23,38
12,8476872,Scott Laughton,C,PHI,30,82,12,26,38
12,8474884,Mike Hoffman,C,SJS,35,82,10,28,38
12,8476458,Ryan Strome,C,ANA,31,82,9,29,38
12,8475760,Nick Bjugstad,C,ARI,32,82,21,16,37
12,8480893,Kirill Marchenko,R,CBJ,24,82,20,17,37
12,8475848,Brendan Gallagher,R,MTL,32,82,20,17,37
12,8470610,Zach Parise,L,COL,40,82,20,17,37
12,8476925,Colton Sissons,C,NSH,31,82,18,19,37
12,8480849,Barrett Hayton,C,ARI,24,82,18,19,37
12,8475722,Jason Zucker,L,NSH,32,82,17,20,37
12,8471698,T.J. Oshie,R,WSH,38,82,16,21,37
12,8484144,Connor Bedard,C,CHI,19,82,15,22,37
12,8482079,Marco Rossi,C,MIN,23,82,12,25,37
12,8478891,Mason Appleton,C,WPG,28,82,12,25,37
12,8482117,Lukas Reichel,L,CHI,22,82,12,25,37
12,8481542,Moritz Seider,D,DET,23,82,8,29,37
12,8481711,Matias Maccelli,L,ARI,24,82,8,29,37
12,8470613,Brent Burns,D,CAR,39,82,7,30,37
12,8476958,Jaccob Slavin,D,CAR,30,82,7,30,37
12,8478038,Devon Toews,D,COL,30,82,6,31,37
12,8475171,Oliver Ekman-Larsson,D,FLA,33,82,2,35,37
12,8475799,Nino Niederreiter,R,WPG,32,82,22,14,36
12,8482055,Drew O'Connor,L,PIT,26,82,18,18,36
12,8482110,Dawson Mercer,C,NJD,23,82,16,20,36
12,8480028,Morgan Frost,C,PHI,25,82,15,21,36
12,8475745,Charlie Coyle,C,BOS,32,82,12,24,36
12,8480798,Philipp Kurashev,C,CHI,25,82,10,26,36
12,8477511,Anthony Mantha,R,VGK,30,82,10,26,36
12,8481016,Ruslan Iskhakov,C,NYI,24,82,5,31,36
12,8483457,Lane Hutson,D,MTL,20,82,4,32,36
12,8482733,Logan Mailloux,D,MTL,31,82,2,34,36
12,8484203,Bradly Nadeau,L,CAR,19,82,27,8,35
12,8474870,Tyler Johnson,C,CHI,34,82,19,16,35
12,8478856,Conor Garland,R,VAN,28,82,15,20,35
12,8476392,Adam Lowry,C,WPG,31,82,15,20,35
12,8474037,James van Riemsdyk,L,BOS,35,82,13,22,35
12,8479415,Michael McLeod,C,NJD,26,82,12,23,35
12,8477346,MacKenzie Weegar,D,CGY,30,82,10,25,35
12,8481013,Jonatan Berggren,R,DET,24,82,10,25,35
12,8475764,Cam Fowler,D,ANA,33,82,8,27,35
12,8477948,Travis Sanheim,D,PHI,28,82,6,29,35
12,8476981,Josh Anderson,R,MTL,30,82,18,16,34
12,8482092,Ridly Greig,C,OTT,22,82,16,18,34
12,8474563,Drew Doughty,D,LAK,35,82,9,25,34
12,8482105,Jake Sanderson,D,OTT,22,82,8,26,34
12,8475906,John Klingberg,D,TOR,32,82,7,27,34
12,8481699,Aku Raty,R,ARI,23,82,2,32,34
12,8478115,Pierre Engvall,L,NYI,28,82,18,15,33
12,8482111,Justin Barron,D,MTL,23,82,17,16,33
12,8483505,Matthew Poitras,C,BOS,20,82,17,16,33
12,8481618,Alex Newhook,C,MTL,23,82,16,17,33
12,8480855,Jack McBain,C,ARI,24,82,15,18,33
12,8477947,Sonny Milano,L,WSH,28,82,14,19,33
12,8484153,Leo Carlsson,C,ANA,20,82,14,19,33
12,8478046,Danton Heinen,L,BOS,29,82,13,20,33
12,8477429,Andrew Copp,C,DET,30,82,13,20,33
12,8476960,Andreas Athanasiou,C,CHI,30,82,13,20,33
12,8479591,Michael Eyssimont,C,TBL,28,82,13,20,33
12,8483445,Cutter Gauthier,L,ANA,20,82,8,25,33
12,8478469,Thomas Chabot,D,OTT,27,82,8,25,33
12,8476854,Hampus Lindholm,D,BOS,30,82,7,26,33
12,8480817,K'Andre Miller,D,NYR,24,82,7,26,33
12,8481581,Thomas Harley,D,DAL,23,82,6,27,33
12,8480871,Adam Boqvist,D,CBJ,24,82,5,28,33
12,8482475,Yegor Chinakhov,R,CBJ,23,82,21,11,32
12,8476419,Jean-Gabriel Pageau,C,NYI,32,82,18,14,32
12,8474189,Lars Eller,C,PIT,35,82,18,14,32
12,8476873,Mark Jankowski,C,NSH,30,82,17,15,32
12,8478542,Evan Rodrigues,C,FLA,31,82,15,17,32
12,8482679,Matt Coronato,R,CGY,22,82,15,17,32
12,8482624,Daniil Miromanov,D,CGY,27,82,13,19,32
12,8479992,Michael Rasmussen,C,DET,25,82,11,21,32
12,8482133,Thomas Bordeleau,C,SJS,22,82,10,22,32
12,8483471,Brad Lambert,C,WPG,31,82,5,27,32
12,8481604,Pavel Dorofeyev,L,VGK,24,82,20,11,31
12,8476878,Zemgus Girgensons,L,BUF,30,82,20,11,31
12,8477989,Christian Dvorak,C,MTL,28,82,16,15,31
12,8482074,Connor Zary,C,CGY,23,82,16,15,31
12,8483431,Logan Cooley,C,ARI,20,82,14,17,31
12,8479365,Trent Frederic,C,BOS,26,82,13,18,31
12,8480009,Eeli Tolvanen,R,SEA,25,82,12,19,31
12,8482720,Matthew Knies,L,TOR,22,82,10,21,31
12,8480185,Eetu Luostarinen,C,FLA,26,82,10,21,31
12,8473563,Nicklas Backstrom,C,WSH,37,82,7,24,31
12,8477498,Darnell Nurse,D,EDM,29,82,6,25,31
12,8479398,Samuel Girard,D,COL,26,82,4,27,31
12,8481624,Ilya Mikheyev,R,VAN,30,82,17,13,30
12,8478057,Dakota Joshua,C,VAN,28,82,17,13,30
12,8482125,Alexander Holtz,R,NJD,22,82,14,16,30
12,8477353,Tyler Motte,C,TBL,29,82,14,16,30
12,8478463,Anthony Beauvillier,L,NSH,27,82,13,17,30
12,8477450,Jason Dickinson,C,CHI,29,82,11,19,30
12,8478458,Jack Roslovic,C,NYR,27,82,9,21,30
12,8481014,Alexander Romanov,D,NYI,24,82,8,22,30
12,8480043,Timothy Liljegren,D,TOR,25,82,6,24,30
12,8477506,Ryan Pulock,D,NYI,30,82,4,26,30
12,8481535,Nils Hoglander,L,VAN,24,82,17,12,29
12,8480068,Ryan Poehling,C,PHI,25,82,13,16,29
12,8473533,Jordan Staal,C,CAR,36,82,12,17,29
12,8478472,Mathieu Joseph,R,OTT,27,82,10,19,29
12,8478133,Jake Evans,C,MTL,28,82,8,21,29
12,8482655,J.J. Moser,D,ARI,24,82,8,21,29
12,8473422,Nick Foligno,L,CHI,37,82,7,22,29
12,8479351,Sam Steel,C,DAL,26,82,6,23,29
12,8479998,Mikey Anderson,D,LAK,25,82,5,24,29
12,8475690,Chris Tanev,D,DAL,35,82,5,24,29
12,8477507,Nikita Zadorov,D,VAN,29,82,5,24,29
12,8478500,Ivan Provorov,D,CBJ,27,82,4,25,29
12,8479316,Luke Kunin,C,SJS,27,82,18,10,28
12,8479346,Dillon Dube,C,CGY,26,82,17,11,28
12,8481580,Connor McMichael,C,WSH,23,82,12,16,28
12,8476480,Vladislav Namestnikov,C,WPG,32,82,12,16,28
12,8474149,Evgenii Dadonov,R,DAL,35,82,10,18,28
12,8478413,Jordan Greenway,L,BUF,27,82,10,18,28
12,8479977,Kailer Yamamoto,R,SEA,26,82,10,18,28
12,8476885,Jacob Trouba,D,NYR,30,82,8,20,28
12,8482142,Jamie Drysdale,D,PHI,22,82,8,20,28
12,8480873,Rasmus Sandin,D,WSH,24,82,5,23,28
12,8482155,Alex Laferriere,R,LAK,23,82,17,10,27
12,8470604,Jeff Carter,C,PIT,39,82,16,11,27
12,8481186,Logan O'Connor,R,COL,28,82,14,13,27
12,8482702,Logan Stankoven,C,DAL,21,82,13,14,27
12,8478109,Victor Olofsson,L,BUF,29,82,13,14,27
12,8479293,Brandon Tanev,L,SEA,33,82,13,14,27
12,8478020,Michael Amadio,C,VGK,28,82,13,14,27
12,8482705,Cole Sillinger,C,CBJ,21,82,12,15,27
12,8479390,Taylor Raddysh,R,CHI,26,82,12,15,27
12,8480813,Joe Veleno,C,DET,24,82,12,15,27
12,8476422,Mike Reilly,D,NYI,31,82,10,17,27
12,8477508,Curtis Lazar,C,NJD,29,82,9,18,27
12,8480796,Martin Fehervary,D,WSH,25,82,7,20,27
12,8476457,Adam Larsson,D,SEA,32,82,6,21,27
12,8478911,Matt Roy,D,LAK,29,82,5,22,27
12,8483495,Simon Nemec,D,NJD,20,82,5,22,27
12,8479369,Andrew Peeke,D,BOS,26,82,2,25,27
12,8483493,Frank Nazar,C,CHI,20,82,19,7,26
12,8480821,Filip Zadina,R,SJS,25,82,15,11,26
12,8475714,Calle Jarnkrok,C,TOR,33,82,14,12,26
12,8480802,Ryan McLeod,C,EDM,25,82,13,13,26
12,8476871,Tanner Pearson,L,MTL,32,82,13,13,26
12,8481704,Juuso Parssinen,C,NSH,23,82,13,13,26
12,8477425,Miles Wood,L,COL,29,82,11,15,26
12,8479393,Noah Gregor,C,TOR,26,82,11,15,26
12,8470621,Corey Perry,R,EDM,39,82,11,15,26
12,8481524,Bowen Byram,D,BUF,23,82,10,16,26
12,8482073,Braden Schneider,D,NYR,23,82,10,16,26
12,8478508,Yakov Trenin,C,COL,27,82,9,17,26
12,8484145,Zach Benson,L,BUF,19,82,9,17,26
12,8476869,Brady Skjei,D,CAR,30,82,7,19,26
12,8480145,Neal Pionk,D,WPG,29,82,7,19,26
12,8481656,Aliaksei Protas,C,WSH,23,82,7,19,26
12,8481606,Jordan Spence,D,LAK,23,82,6,20,26
12,8481703,Valtteri Puustinen,R,PIT,25,82,6,20,26
12,8482087,Kaiden Guhle,D,MTL,22,82,6,20,26
12,8475181,Nick Leddy,D,STL,33,82,5,21,26
12,8482712,Oskar Olausson,R,COL,22,82,4,22,26
12,8474716,Jared Spurgeon,D,MIN,35,82,3,23,26
12,8478507,John Marino,D,NJD,27,82,3,23,26
12,8476891,Matt Grzelcyk,D,BOS,30,82,1,25,26
12,8479996,Cody Glass,C,NSH,25,82,13,12,25
12,8480144,David Kampf,C,TOR,29,82,13,12,25
12,8481553,Bobby Brink,R,PHI,23,82,11,14,25
12,8482259,Bobby McMann,C,TOR,28,82,11,14,25
12,8481537,Nikita Okhotiuk,D,CGY,24,82,9,16,25
12,8473449,Kyle Okposo,R,FLA,36,82,8,17,25
12,8481522,Peyton Krebs,C,BUF,23,82,8,17,25
12,8475149,Marcus Johansson,L,MIN,34,82,8,17,25
12,8474151,Ryan McDonagh,D,NSH,35,82,5,20,25
12,8478851,Alexandre Carrier,D,NSH,28,82,3,22,25
12,8481178,Egor Zamula,D,PHI,24,82,2,23,25
12,8475208,Brian Dumoulin,D,SEA,33,82,2,23,25
12,8474715,Cam Atkinson,R,PHI,35,82,13,11,24
12,8479353,Brett Howden,C,VGK,26,82,10,14,24
12,8479661,Tanner Jeannot,L,TBL,27,82,8,16,24
12,8480113,Alex Iafallo,L,WPG,31,82,8,16,24
12,8474034,Pat Maroon,L,BOS,36,82,8,16,24
12,8476921,Jordan Martinook,L,CAR,32,82,6,18,24
12,8476463,Jonas Brodin,D,MIN,31,82,6,18,24
12,8478178,Darren Raddysh,D,TBL,28,82,4,20,24
12,8477220,Nate Schmidt,D,WPG,33,82,4,20,24
12,8476979,Erik Gustafsson,D,NYR,32,82,3,21,24
12,8480246,Nick Perbix,D,TBL,26,82,1,23,24
12,8479941,Justin Danforth,R,CBJ,31,82,16,7,23
12,8477944,Jakub Vrana,L,STL,28,82,14,9,23
12,8476927,Teddy Blueger,C,VAN,30,82,10,13,23
12,8475164,Jakob Silfverberg,R,ANA,34,82,9,14,23
12,8480806,Isac Lundestrom,C,ANA,25,82,8,15,23
12,8477392,Hudson Fasching,R,NYI,29,82,8,15,23
12,8475200,Dmitry Orlov,D,CAR,33,82,7,16,23
12,8478399,Jonas Siegenthaler,D,NJD,27,82,7,16,23
12,8479980,Nicolas Hague,D,VGK,26,82,6,17,23
12,8476931,Jake McCabe,D,TOR,31,82,5,18,23
12,8480073,Erik Brannstrom,D,OTT,25,82,5,18,23
12,8476897,Oskar Sundqvist,C,STL,30,82,4,19,23
12,8477488,Brett Pesce,D,CAR,30,82,4,19,23
12,8478882,Vladislav Gavrikov,D,LAK,29,82,4,19,23
12,8475790,Erik Gudbranson,D,CBJ,32,82,4,19,23
12,8482062,Cole Smith,L,NSH,29,82,4,19,23
12,8477969,Marcus Pettersson,D,PIT,28,82,0,23,23
12,8484166,Adam Fantilli,C,CBJ,20,82,16,6,22
12,8481554,Kaapo Kakko,R,NYR,23,82,14,8,22
12,8477952,Robby Fabbri,C,DET,28,82,12,10,22
12,8480281,Alexey Toropchenko,R,STL,25,82,11,11,22
12,8477919,Frederick Gaudreau,C,MIN,31,82,10,12,22
12,8483499,Liam Ohgren,L,MIN,20,82,10,12,22
12,8473453,Trevor Lewis,C,LAK,37,82,10,12,22
12,8476312,Josh Manson,D,COL,33,82,9,13,22
12,8478451,Ethan Bear,D,WSH,27,82,8,14,22
12,8478840,Will Borgen,D,SEA,28,82,6,16,22
12,8470600,Ryan Suter,D,DAL,39,82,5,17,22
12,8476892,Colton Parayko,D,STL,31,82,4,18,22
12,8481568,Alex Vlasic,D,CHI,23,82,4,18,22
12,8479514,Rem Pitlick,C,CHI,27,82,4,18,22
12,8480035,Henri Jokiharju,D,BUF,25,82,3,19,22
12,8476429,Scott Mayfield,D,NYI,32,82,3,19,22
12,8473507,Jeff Petry,D,DET,37,82,1,21,22
12,8480459,Pius Suter,C,VAN,28,82,15,6,21
12,8481093,Rafael Harvey-Pinard,L,MTL,25,82,15,6,21
12,8475220,Marcus Foligno,L,MIN,33,82,10,11,21
12,8476624,Barclay Goodrow,C,NYR,31,82,9,12,21
12,8481028,Martin Pospisil,C,CGY,25,82,9,12,21
12,8479383,Boris Katchouk,L,OTT,26,82,9,12,21
12,8481481,Blake Lizotte,C,LAK,27,82,8,13,21
12,8475343,Nic Dowd,C,WSH,34,82,8,13,21
12,8479983,Mario Ferraro,D,SJS,26,82,6,15,21
12,8474166,Alec Martinez,D,VGK,37,82,6,15,21
12,8482222,Alexander Barabanov,L,SJS,30,82,5,16,21
12,8478430,Oliver Kylington,D,CGY,27,82,4,17,21
12,8481477,Nico Sturm,C,SJS,29,82,10,10,20
12,8477839,Conor Sheary,L,TBL,32,82,9,11,20
12,8475231,Casey Cizikas,C,NYI,33,82,9,11,20
12,8478043,Sam Lafferty,C,VAN,29,82,9,11,20
12,8476278,Colin Blackwell,C,CHI,31,82,8,12,20
12,8480860,Kevin Bahl,D,NJD,24,82,6,14,20
12,8482730,Brandt Clarke,D,LAK,21,82,5,15,20
12,8483490,Pavel Mintyukov,D,ANA,21,82,4,16,20
12,8480058,Pierre-Olivier Joseph,D,PIT,25,82,4,16,20
12,8476331,Dylan DeMelo,D,WPG,31,82,2,18,20
12,8476902,Esa Lindell,D,DAL,30,82,2,18,20
12,8476469,Joel Armia,R,MTL,31,82,13,6,19
12,8477330,Dominik Kubalik,L,OTT,29,82,11,8,19
12,8480980,Connor Dewar,C,TOR,25,82,11,8,19
12,8477931,Tomas Nosek,L,NJD,32,82,9,10,19
12,8480448,Parker Kelly,L,OTT,25,82,5,14,19
12,8473504,Cal Clutterbuck,R,NYI,37,82,5,14,19
12,8476374,Sean Kuraly,C,CBJ,31,82,4,15,19
12,8479976,Juuso Valimaki,D,ARI,26,82,4,15,19
12,8478859,Niko Mikkola,D,FLA,28,82,3,16,19
12,8477435,Ryan Graves,D,PIT,29,82,1,18,19
12,8475179,Dmitry Kulikov,D,FLA,34,82,0,19,19
12,8483012,Logan Morrison,C,SEA,22,82,13,5,18
12,8482737,Zack Bolduc,C,STL,21,82,11,7,18
12,8477505,Alexander Wennberg,C,NYR,30,82,10,8,18
12,8482166,Shakir Mukhamadullin,D,SJS,22,82,6,12,18
12,8474009,Nick Bonino,C,NYR,36,82,6,12,18
12,8478013,Jake Walman,D,DET,28,82,5,13,18
12,8481601,Simon Holmstrom,R,NYI,23,82,5,13,18
12,8478468,Jeremy Lauzon,D,NSH,27,82,5,13,18
12,8483491,Ivan Miroshnichenko,L,WSH,20,82,4,14,18
12,8475462,Radko Gudas,D,ANA,34,82,2,16,18
12,8481567,Henry Thrun,D,SJS,23,82,2,16,18
12,8480807,Mattias Samuelsson,D,BUF,24,82,2,16,18
12,8482145,Mavrik Bourque,C,DAL,22,82,14,3,17
12,8475842,Sam Carrick,C,EDM,32,82,11,6,17
12,8482762,Simon Edvinsson,D,DET,21,82,9,8,17
12,8481517,Brett Leason,R,ANA,25,82,8,9,17
12,8478831,Kevin Stenlund,C,FLA,28,82,7,10,17
12,8481059,Scott Perunovich,D,STL,26,82,6,11,17
12,8481578,Graeme Clarke,R,NJD,23,82,5,12,17
12,8483482,Tristan Luneau,D,ANA,20,82,4,13,17
12,8474013,Ian Cole,D,VAN,35,82,4,13,17
12,8482122,Brock Faber,D,MIN,22,82,3,14,17
12,8476917,Adam Pelech,D,NYI,30,82,3,14,17
12,8475279,Ben Chiarot,D,DET,33,82,3,14,17
12,8476967,Brett Kulak,D,EDM,30,82,2,15,17
12,8477406,Mattias Janmark,C,EDM,32,82,8,8,16
12,8481030,Jack St. Ivany,D,PIT,25,82,8,8,16
12,8483468,Jiri Kulich,C,BUF,20,82,7,9,16
12,8479359,Beck Malenstyn,L,WSH,26,82,6,10,16
12,8483565,Nick Blankenburg,D,CBJ,26,82,5,11,16
12,8476467,Jamie Oleksiak,D,SEA,32,82,4,12,16
12,8476442,Matt Nieto,L,PIT,32,82,4,12,16
12,8476879,Cody Ceci,D,EDM,31,82,3,13,16
12,8475188,Brayden McNabb,D,VGK,33,82,1,15,16
12,8475455,Brenden Dillon,D,WPG,34,82,1,15,16
12,8478408,Travis Dermott,D,ARI,28,82,1,15,16
12,8475324,Nick Jensen,D,WSH,34,82,0,16,16
12,8478569,Noel Acciari,C,PIT,33,82,9,6,15
12,8477499,Rasmus Ristolainen,D,PHI,30,82,5,10,15
12,8476858,Phillip Di Giuseppe,L,VAN,31,82,5,10,15
12,8471677,Jack Johnson,D,COL,37,82,4,11,15
12,8475233,David Savard,D,MTL,34,82,3,12,15
12,8482858,Ryker Evans,D,SEA,23,82,3,12,15
12,8474574,Tyler Myers,D,VAN,34,82,1,14,15
12,8481605,Jackson LaCombe,D,ANA,23,82,1,14,15
12,8474673,TJ Brodie,D,TOR,34,82,0,15,15
12,8482118,Sam Colangelo,R,ANA,23,82,9,5,14
12,8482809,Jackson Blake,R,CAR,21,82,9,5,14
12,8477015,Connor Brown,R,EDM,30,82,7,7,14
12,8476372,Nick Seeler,D,PHI,31,82,6,8,14
12,8480879,Jacob Bernard-Docker,D,OTT,24,82,4,10,14
12,8479371,Dante Fabbro,D,NSH,26,82,4,10,14
12,8478136,Jake Middleton,D,MIN,28,82,4,10,14
12,8482245,Artem Zub,D,OTT,29,82,3,11,14
12,8477845,Trevor van Riemsdyk,D,WSH,33,82,1,13,14
12,8476915,Jujhar Khaira,L,MIN,30,82,6,7,13
12,8480074,Alexandre Texier,C,CBJ,25,82,4,9,13
12,8482803,Olen Zellweger,D,ANA,21,82,4,9,13
12,8477034,Jaycob Megna,D,CHI,32,82,4,9,13
12,8477365,Connor Clifton,D,BUF,29,82,3,10,13
12,8484911,Collin Graf,R,SJS,22,82,3,10,13
12,8482470,Ilya Solovyov,D,CGY,24,82,1,12,13
12,8479291,Kevin Rooney,C,CGY,31,82,7,5,12
12,8475825,Jani Hakanpää,D,DAL,32,82,6,6,12
12,8476822,Luke Glendening,C,TBL,35,82,5,7,12
12,8470966,Mark Giordano,D,TOR,41,82,5,7,12
12,8482666,Scott Morrow,D,CAR,22,82,4,8,12
12,8477369,Carson Soucy,D,VAN,30,82,3,9,12
12,8479324,Ryan Lindgren,D,NYR,26,82,3,9,12
12,8475762,Derek Forbort,D,BOS,32,82,3,9,12
12,8480834,Ty Emberson,D,SJS,24,82,2,10,12
12,8478416,Erik Cernak,D,TBL,27,82,1,11,12
12,8479442,Troy Stecher,D,EDM,30,82,1,11,12
12,8480172,Jan Rutta,D,SJS,34,82,4,7,11
12,8482177,Marat Khusnutdinov,C,MIN,22,82,3,8,11
12,8478443,Brandon Carlo,D,BOS,28,82,3,8,11
12,8482807,Ethan Del Mastro,D,CHI,21,82,3,8,11
12,8476525,Colin Miller,D,WPG,32,82,2,9,11
12,8477335,Kyle Burroughs,D,SJS,29,82,1,10,11
12,8475177,Calvin de Haan,D,TBL,33,82,4,6,10
12,8484149,Gavin Brindley,C,CBJ,20,82,4,6,10
12,8481599,Victor Soderstrom,D,ARI,23,82,4,6,10
12,8482516,Matthew Kessel,D,STL,24,82,3,7,10
12,8474567,Zach Bogosian,D,MIN,34,82,3,6,9
12,8476473,Connor Murphy,D,CHI,31,82,1,8,9
12,8483763,Maksymilian Szuber,D,ARI,22,82,3,5,8
12,8482713,Mackie Samoskevich,R,FLA,22,82,1,7,8
12,8482859,Zack Ostapchuk,C,OTT,21,82,0,8,8
12,8483489,Fraser Minten,C,TOR,31,82,3,4,7
12,8480990,Declan Chisholm,D,MIN,24,82,3,4,7
12,8483466,Kevin Korchinski,D,CHI,20,82,2,5,7
12,8482141,Lukas Cormier,D,VGK,22,0,0,0,0
12,8476988,Matt Benning,D,SJS,30,0,0,0,0
12,8480727,Zach Whitecloud,D,VGK,28,0,0,0,0
12,8480887,Jordan Harris,D,MTL,24,0,0,0,0
12,8478450,Parker Wotherspoon,D,BOS,27,0,0,0,0
12,8481812,Nikolai Knyzhov,D,SJS,27,0,0,0,0
12,8480001,Urho Vaakanainen,D,ANA,25,0,0,0,0
12,8482176,Wyatt Kaiser,D,CHI,22,0,0,0,0
12,8481122,Simon Benoit,D,TOR,26,0,0,0,0
12,8476441,Joel Edmundson,D,TOR,31,0,0,0,0
12,8480884,Calen Addison,D,SJS,24,0,0,0,0
12,8482511,Mason Lohrei,D,BOS,23,0,0,0,0
12,8482192,Isaak Phillips,D,CHI,23,0,0,0,0
12,8480950,Ilya Lyubushkin,D,TOR,30,0,0,0,0
12,8474031,Kevin Shattenkirk,D,BOS,35,0,0,0,0
12,8475718,Justin Holl,D,DET,32,0,0,0,0
12,8479402,Jake Bean,D,CBJ,26,0,0,0,0
12,8474602,Justin Schultz,D,SEA,34,0,0,0,0
12,8477950,Tony DeAngelo,D,CAR,29,0,0,0,0
12,8481743,Marc Del Gaizo,D,NSH,25,0,0,0,0
12,8481527,Kaedan Korczak,D,VGK,23,0,0,0,0
12,8480192,Johnathan Kovacevic,D,MTL,27,0,0,0,0
12,8476874,Olli Maatta,D,DET,30,0,0,0,0
12,8482144,Jack Thompson,D,SJS,22,0,0,0,0
12,8480222,Sebastian Aho,D,NYI,28,0,0,0,0
12,8479458,Nikita Zaitsev,D,CHI,33,0,0,0,0
12,8471709,Marc-Edouard Vlasic,D,SJS,37,0,0,0,0
12,8482929,Emil Lilleberg,D,TBL,23,0,0,0,0
12,8477018,Ben Hutton,D,VGK,31,0,0,0,0
12,8481056,Spencer Stastney,D,NSH,24,0,0,0,0
12,8481593,Jayden Struble,D,MTL,23,0,0,0,0
12,8479982,Conor Timmins,D,TOR,26,0,0,0,0
12,8474090,Brendan Smith,D,NJD,35,0,0,0,0
12,8482964,Arber Xhekaj,D,MTL,23,0,0,0,0
12,8480891,Michael Kesselring,D,ARI,24,0,0,0,0
12,8477938,Haydn Fleury,D,TBL,28,0,0,0,0
12,8481806,Louis Crevier,D,CHI,23,0,0,0,0
12,8471274,Alex Goligoski,D,MIN,39,0,0,0,0
12,8481600,Tobias Bjornfot,D,FLA,23,0,0,0,0
12,8475797,Jarred Tinordi,D,CHI,32,0,0,0,0
12,8481521,Ronnie Attard,D,PHI,25,0,0,0,0
12,8474612,Travis Hamonic,D,OTT,34,0,0,0,0
12,8479576,Vincent Desharnais,D,EDM,28,0,0,0,0
12,8480049,Dylan Samberg,D,WPG,25,0,0,0,0
12,8483619,Filip Roos,D,CHI,25,0,0,0,0
12,8474568,Luke Schenn,D,NSH,35,0,0,0,0
12,8480184,Gustav Lindstrom,D,ANA,26,0,0,0,0
12,8480070,Ian Mitchell,D,BOS,25,0,0,0,0
12,8480196,Jacob Bryson,D,BUF,27,0,0,0,0
12,8471686,Marc Staal,D,PHI,37,0,0,0,0
12,8477467,Gustav Olofsson,D,SEA,30,0,0,0,0
12,8478970,Jalen Chatfield,D,CAR,28,0,0,0,0
12,8479348,Kale Clague,D,BUF,26,0,0,0,0
12,8473446,Erik Johnson,D,PHI,36,0,0,0,0
12,8477462,Robert Hagg,D,ANA,29,0,0,0,0
12,8478454,Noah Juulsen,D,VAN,27,0,0,0,0
12,8477384,Josh Brown,D,ARI,30,0,0,0,0
12,8481708,Zac Jones,D,NYR,24,0,0,0,0
12,8481167,Brayden Pachal,D,CGY,25,0,0,0,0
12,8482067,Connor Mackey,D,NYR,28,0,0,0,0
12,8483460,David Jiricek,D,CBJ,21,0,0,0,0
12,8481701,Santeri Hatakka,D,NJD,23,0,0,0,0
12,8478021,William Lagesson,D,ANA,28,0,0,0,0
12,8477851,Jordan Oesterle,D,CGY,32,0,0,0,0
12,8478452,Caleb Jones,D,COL,27,0,0,0,0
12,8479984,Cal Foote,D,NJD,26,0,0,0,0
12,8479639,Dylan Coghlan,D,CAR,26,0,0,0,0
12,8480874,Adam Ginning,D,PHI,24,0,0,0,0
12,8479321,Lucas Johansen,D,WSH,27,0,0,0,0
12,8480878,Nils Lundkvist,D,DAL,24,0,0,0,0
12,8482165,Yan Kuznetsov,D,CGY,22,0,0,0,0
12,8484258,Sam Malinski,D,COL,26,0,0,0,0
12,8480157,Calle Rosen,D,STL,30,0,0,0,0
12,8484304,Uvis Balinskis,D,FLA,28,0,0,0,0
12,8479985,Cale Fleury,D,SEA,26,0,0,0,0
12,8479378,Logan Stanley,D,WPG,26,0,0,0,0
12,8477541,Dakota Mermis,D,MIN,30,0,0,0,0
12,8481609,Vladislav Kolyachonok,D,ARI,23,0,0,0,0
12,8480823,Alexander Alexeyev,D,WSH,25,0,0,0,0
12,8481679,Maxence Guenette,D,OTT,23,0,0,0,0
12,8481564,Ryan Johnson,D,BUF,23,0,0,0,0
12,8479376,Victor Mete,D,PHI,26,0,0,0,0
12,8484254,Akito Hirose,D,VAN,25,0,0,0,0
12,8482660,Kent Johnson,C,CBJ,22,0,0,0,0
12,8482149,Cole Perfetti,C,WPG,22,0,0,0,0
12,8477987,Ryan Donato,C,CHI,28,0,0,0,0
12,8475755,Alexander Petrovic,D,DAL,32,0,0,0,0
12,8477810,Joel Hanley,D,CGY,33,0,0,0,0
12,8474145,Robert Bortuzzo,D,NYI,35,0,0,0,0
12,8481161,Jake Christiansen,D,CBJ,25,0,0,0,0
12,8476884,Derrick Pouliot,D,DAL,30,0,0,0,0
12,8481716,Dmitri Voronkov,L,CBJ,24,0,0,0,0
12,8480084,Nick DeSimone,D,NJD,30,0,0,0,0
12,8475750,Jon Merrill,D,MIN,32,0,0,0,0
12,8479315,Joey Anderson,R,CHI,26,0,0,0,0
12,8478011,Louie Belpedio,D,PHI,28,0,0,0,0
12,8482451,Mikael Pyyhtia,L,CBJ,23,0,0,0,0
12,8481541,Samuel Bolduc,D,NYI,24,0,0,0,0
12,8482126,Emil Andrae,D,PHI,31,0,0,0,0
12,8474618,Marco Scandella,D,STL,34,0,0,0,0
12,8477244,Chad Ruhwedel,D,NYR,34,0,0,0,0
12,8477971,Andreas Englund,D,LAK,28,0,0,0,0
12,8480829,Jesperi Kotkaniemi,C,CAR,24,0,0,0,0
12,8479372,Josh Mahura,D,FLA,26,0,0,0,0
12,8482095,Tyler Kleven,D,OTT,22,0,0,0,0
12,8481719,Maxwell Crozier,D,TBL,24,0,0,0,0
12,8475855,Jesper Fast,R,CAR,33,0,0,0,0
12,8480848,Ty Dellandrea,C,DAL,24,0,0,0,0
12,8475193,Tomas Tatar,L,SEA,34,0,0,0,0
12,8476889,Radek Faksa,C,DAL,30,0,0,0,0
12,8478495,Denis Gurianov,R,PHI,27,0,0,0,0
12,8480216,Jacob Peterson,C,SJS,25,0,0,0,0
12,8480252,Cole Guttman,C,CHI,25,0,0,0,0
12,8479026,Philippe Myers,D,TBL,27,0,0,0,0
12,8481006,Tyler Tucker,D,STL,24,0,0,0,0
12,8481032,Paul Cotter,C,VGK,25,0,0,0,0
12,8481577,Philip Tomasino,C,NSH,23,0,0,0,0
12,8476918,Jimmy Vesey,L,NYR,31,0,0,0,0
12,8479320,Max Lajoie,D,TOR,27,0,0,0,0
12,8478017,Mark Friedman,D,VAN,29,0,0,0,0
12,8481754,Nikita Nesterenko,C,ANA,23,0,0,0,0
12,8483407,Brandon Scanlin,D,NYR,25,0,0,0,0
12,8482659,Josh Doan,R,ARI,22,0,0,0,0
12,8477446,Michael McCarron,R,NSH,29,0,0,0,0
12,8477903,Garnet Hathaway,R,PHI,33,0,0,0,0
12,8482153,Brendan Brisson,C,VGK,23,0,0,0,0
12,8483546,Marshall Rifai,D,TOR,26,0,0,0,0
12,8484287,Cole McWard,D,VAN,23,0,0,0,0
12,8478854,Ryan Shea,D,PIT,27,0,0,0,0
12,8481585,Egor Afanasyev,L,NSH,23,0,0,0,0
12,8483398,Declan Carlile,D,TBL,31,0,0,0,0
12,8478502,Dennis Gilbert,D,CGY,28,0,0,0,0
12,8482749,Joshua Roy,R,MTL,21,0,0,0,0
12,8481598,Philip Broberg,D,EDM,23,0,0,0,0
12,8480835,Jack Drury,C,CAR,24,0,0,0,0
12,8480748,Kiefer Sherwood,L,NSH,29,0,0,0,0
12,8476934,Brock McGinn,L,ANA,30,0,0,0,0
12,8480870,Bo Groulx,C,ANA,24,0,0,0,0
12,8479368,Max Jones,L,ANA,26,0,0,0,0
12,8478099,Kevin Labanc,R,SJS,29,0,0,0,0
12,8478067,Oskar Lindblom,L,SJS,28,0,0,0,0
12,8476393,Nick Cousins,C,FLA,31,0,0,0,0
12,8483395,Arshdeep Bains,L,VAN,23,0,0,0,0
12,8480762,Eric Robinson,L,BUF,29,0,0,0,0
12,8479439,Jacob MacDonald,D,SJS,31,0,0,0,0
12,8476474,Stefan Noesen,R,CAR,31,0,0,0,0
12,8482787,Nikita Chibrikov,R,WPG,31,0,0,0,0
12,8478432,Christian Fischer,R,DET,27,0,0,0,0
12,8477979,Nicolas Aube-Kubel,R,WSH,28,0,0,0,0
12,8481789,Tye Kartye,L,SEA,23,0,0,0,0
12,8479330,Brandon Gignac,C,MTL,27,0,0,0,0
12,8480075,Cameron Crotty,D,ARI,25,0,0,0,0
12,8473473,Milan Lucic,L,BOS,36,0,0,0,0
12,8482094,Daemon Hunt,D,MIN,22,0,0,0,0
12,8481206,John Ludvig,D,PIT,24,0,0,0,0
12,8483630,Pavol Regenda,L,ANA,25,0,0,0,0
12,8481617,Vasily Podkolzin,R,VAN,23,0,0,0,0
12,8480306,Grant Hutton,D,NYI,29,0,0,0,0
12,8480995,Pontus Holmberg,R,TOR,25,0,0,0,0
12,8482148,Hendrix Lapierre,C,WSH,22,0,0,0,0
12,8477478,William Carrier,L,VGK,30,0,0,0,0
12,8480003,Jesper Boqvist,C,BOS,26,0,0,0,0
12,8482172,Landon Slaggert,L,CHI,22,0,0,0,0
12,8480789,Oliver Wahlstrom,R,NYI,24,0,0,0,0
12,8474062,Riley Nash,C,NYR,35,0,0,0,0
12,8480021,Jack Studnicka,C,SJS,25,0,0,0,0
12,8480025,MacKenzie Entwistle,R,CHI,25,0,0,0,0
12,8481582,Nicholas Robertson,L,TOR,23,0,0,0,0
12,8476867,Brendan Gaunce,C,CBJ,30,0,0,0,0
12,8479619,Michael Carcone,L,ARI,28,0,0,0,0
12,8479370,Tyson Jost,C,BUF,26,0,0,0,0
12,8479671,Mathieu Olivier,R,CBJ,27,0,0,0,0
12,8476994,Vinnie Hinostroza,C,PIT,30,0,0,0,0
12,8482070,Mitchell Chaffee,R,TBL,26,0,0,0,0
12,8477473,Justin Bailey,R,SJS,29,0,0,0,0
12,8479344,Jesse Puljujarvi,R,PIT,26,0,0,0,0
12,8480205,Emil Bemstrom,C,PIT,25,0,0,0,0
12,8479718,Alex Barré-Boulet,C,TBL,27,0,0,0,0
12,8482061,Brandon Biro,L,BUF,26,0,0,0,0
12,8479638,Justin Brazeau,R,BOS,26,0,0,0,0
12,8474040,Sam Gagner,C,EDM,35,0,0,0,0
12,8477846,Ryan Carpenter,C,SJS,33,0,0,0,0
12,8482077,Dylan Holloway,L,EDM,23,0,0,0,0
12,8482157,Will Cuylle,L,NYR,22,0,0,0,0
12,8480007,Jonas Rondbjerg,R,VGK,25,0,0,0,0
12,8478874,Adam Gaudette,C,STL,28,0,0,0,0
12,8478434,Keegan Kolesar,R,VGK,27,0,0,0,0
12,8480441,Trey Fix-Wolansky,R,CBJ,25,0,0,0,0
12,8479994,Jaret Anderson-Dolan,C,NSH,25,0,0,0,0
12,8483567,Georgii Merkulov,C,BOS,24,0,0,0,0
12,8477380,Jonny Brodzinski,C,NYR,31,0,0,0,0
12,8482201,Gage Goncalves,C,TBL,23,0,0,0,0
12,8478211,Dryden Hunt,L,CGY,29,0,0,0,0
12,8471699,Andrew Cogliano,C,COL,37,0,0,0,0
12,8479421,Jacob Moverare,D,LAK,26,0,0,0,0
12,8478881,Brett Seney,L,CHI,28,0,0,0,0
12,8477464,Nic Petan,C,MIN,29,0,0,0,0
12,8475958,Michael Sgarbossa,C,WSH,32,0,0,0,0
12,8481147,Reese Johnson,C,CHI,26,0,0,0,0
12,8479336,Carl Grundstrom,R,LAK,27,0,0,0,0
12,8480853,Liam Foudy,C,NSH,24,0,0,0,0
12,8479522,Hardy Haman Aktell,D,WSH,26,0,0,0,0
12,8481462,Mason Morelli,L,VGK,28,0,0,0,0
12,8482102,Vasily Ponomarev,C,CAR,22,0,0,0,0
12,8480844,Grigori Denisenko,L,VGK,24,0,0,0,0
12,8479944,Zach Aston-Reese,C,DET,30,0,0,0,0
12,8482784,Zach Dean,C,STL,21,0,0,0,0
12,8479419,Brett Murray,L,BUF,26,0,0,0,0
12,8479520,Brandon Duhaime,R,COL,27,0,0,0,0
12,8477573,Nathan Walker,L,STL,30,0,0,0,0
12,8478078,Rourke Chartier,C,OTT,28,0,0,0,0
12,8475795,Dylan McIlrath,D,WSH,32,0,0,0,0
12,8482496,Nils Aman,C,VAN,24,0,0,0,0
12,8480289,Morgan Barron,C,WPG,26,0,0,0,0
12,8481751,Lukas Rousek,R,BUF,25,0,0,0,0
12,8480011,Klim Kostin,C,SJS,25,0,0,0,0
12,8481556,John Beecher,C,BOS,23,0,0,0,0
12,8475278,Byron Froese,C,VGK,33,0,0,0,0
12,8475225,Craig Smith,C,DAL,35,0,0,0,0
12,8484326,Patrik Koch,D,ARI,28,0,0,0,0
12,8477930,Pierre-Edouard Bellemare,L,SEA,39,0,0,0,0
12,8478409,Anthony Richard,C,BOS,28,0,0,0,0
12,8481024,Linus Karlsson,C,VAN,25,0,0,0,0
12,8479986,Kole Lind,R,SEA,26,0,0,0,0
12,8479414,Nathan Bastian,R,NJD,27,0,0,0,0
12,8479362,Riley Tufte,L,COL,26,0,0,0,0
12,8481058,Jesse Ylönen,R,MTL,25,0,0,0,0
12,8482476,Emil Heineman,L,MTL,23,0,0,0,0
12,8482861,Vincent Iorio,D,WSH,22,0,0,0,0
12,8483432,Luca Del Bel Belluz,C,CBJ,31,0,0,0,0
12,8482744,James Malatesta,L,CBJ,21,0,0,0,0
12,8477887,Patrick Brown,C,BOS,32,0,0,0,0
12,8478585,Derek Ryan,C,EDM,38,0,0,0,0
12,8481441,Joe Snively,C,WSH,28,0,0,0,0
12,8481592,Jakob Pelletier,L,CGY,23,0,0,0,0
12,8482634,Alex Steeves,C,TOR,25,0,0,0,0
12,8477126,Jayson Megna,C,BOS,34,0,0,0,0
12,8475752,Tyler Pitlick,C,NYR,33,0,0,0,0
12,8480008,Adam Ruzicka,C,ARI,25,0,0,0,0
12,8481065,Angus Crookshank,L,OTT,25,0,0,0,0
12,8479547,Matthew Phillips,R,WSH,26,0,0,0,0
12,8480226,Marián Studenic,R,SEA,26,0,0,0,0
12,8481237,Kyle MacLean,C,NYI,25,0,0,0,0
12,8475413,Justin Dowling,C,NJD,34,0,0,0,0
12,8481641,Joel Kiviranta,L,COL,28,0,0,0,0
12,8478104,Sammy Blais,L,STL,28,0,0,0,0
12,8477454,Adam Erne,L,EDM,29,0,0,0,0
12,8481518,Nolan Foote,L,NJD,24,0,0,0,0
12,8480245,Olle Lycksell,R,PHI,25,0,0,0,0
12,8483570,Ben Meyers,C,ANA,26,0,0,0,0
12,8480776,Sheldon Rempal,R,VGK,29,0,0,0,0
12,8483920,Pierrick Dube,R,WSH,23,0,0,0,0
12,8480267,Sammy Walker,C,MIN,25,0,0,0,0
12,8482747,Brennan Othmann,L,NYR,21,0,0,0,0
12,8479991,Jake Leschyshyn,C,NYR,25,0,0,0,0
12,8478400,Colin White,C,MTL,27,0,0,0,0
12,8479328,Julien Gauthier,R,NYI,27,0,0,0,0
12,8484325,Waltteri Merela,C,TBL,26,0,0,0,0
12,8479066,Ryan Lomberg,L,FLA,30,0,0,0,0
12,8477070,Liam O'Brien,C,ARI,30,0,0,0,0
12,8478146,Matthew Highmore,C,OTT,28,0,0,0,0
12,8478028,Fredrik Olofsson,L,COL,28,0,0,0,0
12,8480880,Jakub Lauko,C,BOS,24,0,0,0,0
12,8479968,Vinni Lettieri,C,MIN,29,0,0,0,0
12,8474709,Matt Martin,L,NYI,35,0,0,0,0
12,8480845,Rasmus Kupari,C,WPG,24,0,0,0,0
12,8481550,Adam Beckman,L,MIN,23,0,0,0,0
12,8481422,Jacob Lucchini,C,MIN,29,0,0,0,0
12,8477401,John Hayden,C,SEA,29,0,0,0,0
12,8478904,Steven Lorentz,C,FLA,28,0,0,0,0
12,8482088,Justin Sourdif,R,FLA,22,0,0,0,0
12,8482751,Ryan Winterton,C,SEA,21,0,0,0,0
12,8482241,Radim Zohorna,L,PIT,28,0,0,0,0
12,8481690,Tyler Angle,C,CBJ,24,0,0,0,0
12,8476952,Dominic Toninato,C,WPG,30,0,0,0,0
12,8476919,Chris Tierney,C,NJD,30,0,0,0,0
12,8480032,Shane Bowers,C,NJD,25,0,0,0,0
12,8484314,Jiri Smejkal,L,OTT,28,0,0,0,0
12,8481239,Samuel Fagemo,L,LAK,24,0,0,0,0
12,8481532,Alex Turcotte,C,LAK,23,0,0,0,0
12,8481019,David Gustafsson,C,WPG,24,0,0,0,0
12,8478477,Mitchell Stephens,C,MTL,27,0,0,0,0
12,8479546,Oskar Steen,C,BOS,26,0,0,0,0
12,8480292,Carson Meyer,R,CBJ,27,0,0,0,0
12,8478446,Glenn Gawdin,C,ANA,27,0,0,0,0
12,8483531,Brian Halonen,L,NJD,25,0,0,0,0
12,8477149,Scott Sabourin,R,SJS,32,0,0,0,0
12,8479972,Mason Shaw,C,MIN,26,0,0,0,0
12,8480890,Jan Jenik,R,ARI,24,0,0,0,0
12,8478051,Max Willman,C,NJD,29,0,0,0,0
12,8480851,Akil Thomas,C,LAK,24,0,0,0,0
12,8482765,Isak Rosen,R,BUF,21,0,0,0,0
12,8478421,A.J. Greer,L,CGY,28,0,0,0,0
12,8478512,Austin Czarnik,C,DET,32,0,0,0,0
12,8479536,Axel Jonsson-Fjallby,L,WPG,26,0,0,0,0
12,8477320,Anton Blidh,L,NYR,29,0,0,0,0
12,8481543,Nikita Alexandrov,C,STL,24,0,0,0,0
12,8475235,Nicolas Deslauriers,L,PHI,33,0,0,0,0
12,8481070,Hugh McGing,L,STL,26,0,0,0,0
12,8480836,Jonathan Gruden,C,PIT,24,0,0,0,0
12,8481591,Sam Poulin,R,PIT,23,0,0,0,0
12,8477962,Brendan Lemieux,L,CAR,28,0,0,0,0
12,8483401,Marc Johnstone,R,PIT,28,0,0,0,0
12,8482250,Callahan Burke,C,CAR,27,0,0,0,0
12,8481726,Adam Edstrom,C,NYR,24,0,0,0,0
12,8471817,Ryan Reaves,R,TOR,37,0,0,0,0
12,8479587,Rhett Gardner,C,PHI,28,0,0,0,0
12,8475766,Austin Watson,L,TBL,32,0,0,0,0
12,8479367,William Lockwood,R,FLA,26,0,0,0,0
12,8478424,Jansen Harkins,C,PIT,27,0,0,0,0
12,8476913,Devin Shore,C,SEA,30,0,0,0,0
12,8482652,Walker Duehr,R,CGY,27,0,0,0,0
12,8477527,Ross Johnston,L,ANA,30,0,0,0,0
12,8481077,John Leonard,L,ARI,26,0,0,0,0
12,8483549,Lucas Condotta,L,MTL,27,0,0,0,0
12,8480468,James Hamblin,L,EDM,25,0,0,0,0
12,8476907,Mackenzie MacEachern,L,STL,30,0,0,0,0
12,8479543,Michael Pezzetta,L,MTL,26,0,0,0,0
12,8480355,Mark Kastelic,C,OTT,25,0,0,0,0
12,8482162,Roby Jarventie,L,OTT,22,0,0,0,0
12,8479772,Zack MacEwen,R,OTT,28,0,0,0,0
12,8483597,Milos Kelemen,L,ARI,25,0,0,0,0
12,8479379,Givani Smith,R,SJS,26,0,0,0,0
12,8481655,Cole Schwindt,R,CGY,23,0,0,0,0
12,8479981,Jonah Gadjovich,L,FLA,26,0,0,0,0
12,8482147,Jean-Luc Foudy,C,COL,22,0,0,0,0
12,8484255,Jason Polin,R,COL,25,0,0,0,0
12,8477993,Justin Kirkland,C,ARI,28,0,0,0,0
12,8479249,Andrew Poturalski,C,SEA,30,0,0,0,0
12,8482197,Adam Raska,R,MIN,23,0,0,0,0
12,8475780,Chris Wagner,R,COL,33,0,0,0,0
12,8479533,Joona Koppanen,L,PIT,26,0,0,0,0
12,8481534,Raphael Lavoie,C,EDM,24,0,0,0,0
12,8484321,Nikolas Matinpalo,D,OTT,26,0,0,0,0
12,8481043,Cole Koepke,L,TBL,26,0,0,0,0
12,8476323,Max McCormick,L,SEA,32,0,0,0,0
12,8483609,Adam Klapka,R,CGY,24,0,0,0,0
12,8483512,Matt Savoie,C,BUF,20,0,0,0,0
12,8484259,Ondrej Pavel,C,COL,31,0,0,0,0
12,8478147,Bokondji Imama,L,OTT,28,0,0,0,0
12,8482460,Matt Rempe,C,NYR,22,0,0,0,0
12,8477073,Kurtis MacDermid,L,NJD,30,0,0,0,0
12,8480274,Philip Kemp,D,EDM,25,0,0,0,0
12,8478956,Samuel Laberge,L,NJD,27,0,0,0,0
12,8483045,Cameron Butler,R,CBJ,31,0,0,0,0
13,8476453,Nikita Kucherov,R,TBL,31,82,42,77,119
13,8478420,Mikko Rantanen,R,COL,28,82,48,68,116
13,8477492,Nathan MacKinnon,C,COL,29,82,52,62,114
13,8478402,Connor McDavid,C,EDM,27,82,25,84,109
13,8479318,Auston Matthews,C,TOR,27,82,64,43,107
13,8478864,Kirill Kaprizov,L,MIN,27,82,45,60,105
13,8477956,David Pastrnak,R,BOS,28,82,41,63,104
13,8478550,Artemi Panarin,L,NYR,33,82,50,50,100
13,8481559,Jack Hughes,C,NJD,23,82,38,62,100
13,8481557,Matt Boldy,L,MIN,23,82,48,49,97
13,8477934,Leon Draisaitl,C,EDM,29,82,42,52,94
13,8477939,William Nylander,R,TOR,28,82,35,58,93
13,8476459,Mika Zibanejad,C,NYR,31,82,37,50,87
13,8475166,John Tavares,C,TOR,34,82,36,49,85
13,8477404,Jake Guentzel,C,CAR,30,82,34,51,85
13,8480023,Robert Thomas,C,STL,25,82,25,60,85
13,8474564,Steven Stamkos,C,TBL,34,82,44,40,84
13,8479407,Jesper Bratt,L,NJD,26,82,31,52,83
13,8471214,Alex Ovechkin,L,WSH,39,82,38,44,82
13,8480012,Elias Pettersson,C,VAN,26,82,29,53,82
13,8478427,Sebastian Aho,C,CAR,27,82,43,38,81
13,8476468,J.T. Miller,C,VAN,31,82,30,51,81
13,8479314,Matthew Tkachuk,L,FLA,27,82,25,56,81
13,8481523,Kirby Dach,C,MTL,23,82,13,67,80
13,8482116,Tim Stützle,C,OTT,22,82,29,50,79
13,8471675,Sidney Crosby,C,PIT,37,82,27,52,79
13,8479323,Adam Fox,D,NYR,26,82,14,65,79
13,8480027,Jason Robertson,L,DAL,25,82,25,53,78
13,8476346,Johnny Gaudreau,L,CBJ,31,82,19,57,76
13,8479385,Jordan Kyrou,C,STL,26,82,36,39,75
13,8476887,Filip Forsberg,L,NSH,30,82,35,40,75
13,8478042,Viktor Arvidsson,R,LAK,31,82,34,41,75
13,8480069,Cale Makar,D,COL,26,82,25,50,75
13,8480801,Brady Tkachuk,L,OTT,25,82,40,34,74
13,8478439,Travis Konecny,R,PHI,27,82,30,44,74
13,8477942,Kevin Fiala,L,LAK,28,82,28,46,74
13,8477402,Pavel Buchnevich,L,STL,29,82,34,39,73
13,8482078,Lucas Raymond,L,DET,22,82,29,44,73
13,8475786,Zach Hyman,L,EDM,32,82,42,30,72
13,8477933,Sam Reinhart,C,FLA,29,82,41,31,72
13,8478010,Brayden Point,C,TBL,28,82,40,32,72
13,8475692,Mats Zuccarello,R,MIN,37,82,14,58,72
13,8478403,Jack Eichel,C,VGK,28,82,27,43,70
13,8476389,Vincent Trocheck,C,NYR,31,82,22,47,69
13,8481540,Cole Caufield,R,MTL,23,82,42,26,68
13,8475167,Victor Hedman,D,TBL,34,82,10,58,68
13,8478460,Zach Werenski,D,CBJ,27,82,20,47,67
13,8478401,Pavel Zacha,C,BOS,27,82,19,48,67
13,8477493,Aleksander Barkov,C,FLA,29,82,21,45,66
13,8477416,Oliver Bjorkstrand,R,SEA,29,82,21,45,66
13,8475172,Nazem Kadri,C,CGY,34,82,18,48,66
13,8476456,Jonathan Huberdeau,C,CGY,31,82,16,50,66
13,8478873,Troy Terry,R,ANA,27,82,32,33,65
13,8473512,Claude Giroux,R,OTT,36,82,27,38,65
13,8473419,Brad Marchand,L,BOS,36,82,23,42,65
13,8476460,Mark Scheifele,C,WPG,31,82,22,43,65
13,8476462,Dougie Hamilton,D,NJD,31,82,20,45,65
13,8478445,Mathew Barzal,C,NYI,27,82,17,48,65
13,8479337,Alex DeBrincat,R,DET,27,82,30,34,64
13,8476539,Jonathan Marchessault,R,VGK,34,82,29,35,64
13,8480039,Martin Necas,C,CAR,25,82,25,39,64
13,8475765,Vladimir Tarasenko,R,FLA,33,82,22,42,64
13,8474600,Roman Josi,D,NSH,34,82,16,48,64
13,8479420,Tage Thompson,C,BUF,27,82,31,32,63
13,8475810,Bryan Rust,R,PIT,32,82,27,36,63
13,8478398,Kyle Connor,L,WPG,28,82,35,27,62
13,8477960,Adrian Kempe,R,LAK,28,82,30,32,62
13,8471685,Anze Kopitar,C,LAK,37,82,23,39,62
13,8478498,Jake DeBrusk,L,BOS,28,82,32,29,61
13,8477476,Artturi Lehkonen,L,COL,29,82,28,33,61
13,8476880,Tom Wilson,R,WSH,30,82,28,33,61
13,8477946,Dylan Larkin,C,DET,28,82,26,35,61
13,8478440,Dylan Strome,C,WSH,27,82,23,38,61
13,8477501,Valeri Nichushkin,R,COL,29,82,22,39,61
13,8481533,Trevor Zegras,C,ANA,23,82,18,43,61
13,8477504,Josh Morrissey,D,WPG,29,82,17,44,61
13,8475184,Chris Kreider,L,NYR,33,82,36,24,60
13,8477949,Alex Tuch,R,BUF,28,82,27,33,60
13,8480002,Nico Hischier,C,NJD,25,82,25,35,60
13,8479542,Brandon Hagel,L,TBL,26,82,24,36,60
13,8474679,Gustav Nyquist,C,NSH,35,82,21,39,60
13,8479675,Trevor Moore,L,LAK,29,82,20,40,60
13,8476853,Morgan Rielly,D,TOR,30,82,9,51,60
13,8480036,Miro Heiskanen,D,DAL,25,82,7,53,60
13,8478493,Joel Eriksson Ek,C,MIN,27,82,30,29,59
13,8478444,Brock Boeser,R,VAN,27,82,24,35,59
13,8475170,Brayden Schenn,C,STL,33,82,23,36,59
13,8482124,Quinton Byfield,R,LAK,22,82,16,43,59
13,8480800,Quinn Hughes,D,VAN,25,82,12,47,59
13,8478407,Vince Dunn,D,SEA,28,82,10,49,59
13,8477447,Shea Theodore,D,VGK,29,82,10,49,59
13,8477496,Elias Lindholm,C,VAN,30,82,25,33,58
13,8477951,Nick Schmaltz,C,ARI,28,82,23,35,58
13,8474141,Patrick Kane,R,DET,36,82,15,43,58
13,8475798,Mikael Granlund,C,SJS,32,82,14,44,58
13,8478469,Thomas Chabot,D,OTT,27,82,9,49,58
13,8477409,Carter Verhaeghe,C,FLA,29,82,33,24,57
13,8480208,Drake Batherson,R,OTT,26,82,26,31,57
13,8474157,Max Pacioretty,L,WSH,36,82,26,31,57
13,8481528,Dylan Cozens,C,BUF,23,82,25,32,57
13,8482665,Matty Beniers,C,SEA,22,82,24,33,57
13,8471215,Evgeni Malkin,C,PIT,38,82,19,38,57
13,8479325,Charlie McAvoy,D,BOS,27,82,14,43,57
13,8474590,John Carlson,D,WSH,34,82,12,45,57
13,8477955,Jared McCann,L,SEA,28,82,34,22,56
13,8480018,Nick Suzuki,C,MTL,25,82,23,33,56
13,8476454,Ryan Nugent-Hopkins,C,EDM,31,82,22,34,56
13,8475913,Mark Stone,R,VGK,32,82,21,35,56
13,8477503,Max Domi,C,TOR,29,82,17,39,56
13,8476875,Mike Matheson,D,MTL,30,82,14,42,56
13,8478414,Timo Meier,R,NJD,28,82,30,25,55
13,8479343,Clayton Keller,R,ARI,26,82,22,33,55
13,8479345,Jakob Chychrun,D,OTT,26,82,19,36,55
13,8475784,Jeff Skinner,C,BUF,32,82,27,27,54
13,8475726,Tyler Toffoli,C,WPG,32,82,27,27,54
13,8478462,Nicolas Roy,C,VGK,27,82,20,34,54
13,8480839,Rasmus Dahlin,D,BUF,24,82,12,42,54
13,8481542,Moritz Seider,D,DET,23,82,9,45,54
13,8475714,Calle Jarnkrok,C,TOR,33,82,30,23,53
13,8478449,Roope Hintz,C,DAL,28,82,29,24,53
13,8476448,William Karlsson,C,VGK,31,82,28,25,53
13,8479999,Casey Mittelstadt,C,COL,26,82,22,31,53
13,8482745,Mason McTavish,C,ANA,21,82,22,31,53
13,8478975,Mason Marchment,L,DAL,29,82,18,35,53
13,8482109,Alexis Lafrenière,L,NYR,23,82,31,21,52
13,8480015,Owen Tippett,R,PHI,25,82,28,24,52
13,8482699,Dylan Guenther,R,ARI,21,82,27,25,52
13,8475168,Matt Duchene,C,DAL,33,82,24,28,52
13,8477940,Nikolaj Ehlers,L,WPG,28,82,23,29,52
13,8478542,Evan Rodrigues,C,FLA,31,82,18,34,52
13,8482684,Luke Hughes,D,NJD,21,82,12,40,52
13,8478038,Devon Toews,D,COL,30,82,12,40,52
13,8480064,Josh Norris,C,OTT,25,82,35,16,51
13,8471698,T.J. Oshie,R,WSH,38,82,31,20,51
13,8470794,Joe Pavelski,C,DAL,40,82,21,30,51
13,8476479,Phillip Danault,C,LAK,31,82,19,32,51
13,8477479,Tyler Bertuzzi,L,TOR,29,82,19,32,51
13,8480865,Noah Dobson,D,NYI,24,82,17,34,51
13,8480803,Evan Bouchard,D,EDM,25,82,7,44,51
13,8474102,David Perron,L,DET,36,82,21,29,50
13,8477494,Jonathan Drouin,L,COL,29,82,17,33,50
13,8480830,Andrei Svechnikov,R,CAR,24,82,16,34,50
13,8471724,Kris Letang,D,PIT,37,82,9,41,50
13,8483524,Shane Wright,C,SEA,20,82,30,19,49
13,8482101,Danil Gushchin,L,SJS,22,82,26,23,49
13,8480014,Gabriel Vilardi,C,WPG,25,82,24,25,49
13,8477451,Ryan Hartman,R,MIN,30,82,22,27,49
13,8482175,JJ Peterka,R,BUF,22,82,22,27,49
13,8474037,James van Riemsdyk,L,BOS,35,82,19,30,49
13,8478438,Tommy Novak,C,NSH,27,82,16,33,49
13,8478047,Michael Bunting,L,PIT,29,82,16,33,49
13,8477444,Andre Burakovsky,L,SEA,29,82,15,34,49
13,8479410,Mikhail Sergachev,D,TBL,26,82,8,41,49
13,8480043,Timothy Liljegren,D,TOR,25,82,8,41,49
13,8483397,Marc McLaughlin,C,BOS,25,82,43,5,48
13,8477500,Bo Horvat,C,NYI,29,82,28,20,48
13,8475791,Taylor Hall,L,CHI,33,82,27,21,48
13,8482740,Wyatt Johnston,C,DAL,21,82,18,30,48
13,8481711,Matias Maccelli,L,ARI,24,82,18,30,48
13,8479339,Patrik Laine,L,CBJ,26,82,17,31,48
13,8476826,Yanni Gourde,C,SEA,33,82,15,33,48
13,8476905,Chandler Stephenson,C,VGK,30,82,12,36,48
13,8482105,Jake Sanderson,D,OTT,22,82,6,42,48
13,8475314,Anders Lee,L,NYI,34,82,29,18,47
13,8479400,Pierre-Luc Dubois,L,LAK,26,82,23,24,47
13,8475191,Reilly Smith,R,PIT,33,82,23,24,47
13,8478233,Andrew Mangiapane,L,CGY,28,82,20,27,47
13,8482093,Seth Jarvis,C,CAR,22,82,19,28,47
13,8482720,Matthew Knies,L,TOR,22,82,16,31,47
13,8474586,Jordan Eberle,R,SEA,34,82,15,32,47
13,8477986,Brandon Montour,D,FLA,30,82,11,36,47
13,8483445,Cutter Gauthier,L,ANA,20,82,11,36,47
13,8475906,John Klingberg,D,TOR,32,82,8,39,47
13,8483808,Andrei Kuzmenko,L,CGY,28,82,27,19,46
13,8473986,Alex Killorn,L,ANA,35,82,25,21,46
13,8475754,Brock Nelson,C,NYI,33,82,22,24,46
13,8476432,Boone Jenner,C,CBJ,31,82,21,25,46
13,8480188,Fabian Zetterlund,L,SJS,25,82,20,26,46
13,8477998,Warren Foegele,L,EDM,28,82,19,27,46
13,8475763,Kevin Hayes,R,STL,32,82,16,30,46
13,8481068,Yegor Sharangovich,C,CGY,26,82,25,20,45
13,8477429,Andrew Copp,C,DET,30,82,18,27,45
13,8481596,Shane Pinto,C,OTT,24,82,17,28,45
13,8482133,Thomas Bordeleau,C,SJS,22,82,17,28,45
13,8476881,Tomas Hertl,C,VGK,31,82,16,29,45
13,8479987,Morgan Geekie,C,BOS,26,82,16,29,45
13,8477346,MacKenzie Weegar,D,CGY,30,82,12,33,45
13,8478472,Mathieu Joseph,R,OTT,27,82,11,34,45
13,8476892,Colton Parayko,D,STL,31,82,9,36,45
13,8481699,Aku Raty,R,ARI,23,82,2,43,45
13,8480797,Joel Farabee,L,PHI,24,82,18,26,44
13,8482097,Jack Quinn,R,BUF,23,82,15,29,44
13,8478133,Jake Evans,C,MTL,28,82,12,32,44
13,8480434,Sean Durzi,D,ARI,26,82,10,34,44
13,8476906,Shayne Gostisbehere,D,DET,31,82,5,39,44
13,8477456,J.T. Compher,L,DET,29,82,18,25,43
13,8480078,Filip Chytil,C,NYR,25,82,8,35,43
13,8476483,Rickard Rakell,R,PIT,31,82,28,14,42
13,8477426,Nicholas Paul,L,TBL,29,82,25,17,42
13,8475151,Kyle Palmieri,C,NYI,33,82,22,20,42
13,8478856,Conor Garland,R,VAN,28,82,22,20,42
13,8477935,Sam Bennett,C,FLA,28,82,20,22,42
13,8482222,Alexander Barabanov,L,SJS,30,82,19,23,42
13,8477511,Anthony Mantha,R,VGK,30,82,17,25,42
13,8482667,William Eklund,L,SJS,22,82,16,26,42
13,8478458,Jack Roslovic,C,NYR,27,82,13,29,42
13,8475848,Brendan Gallagher,R,MTL,32,82,21,20,41
13,8473994,Jamie Benn,L,DAL,35,82,20,21,41
13,8482159,Tyson Foerster,R,PHI,22,82,19,22,41
13,8476872,Scott Laughton,C,PHI,30,82,17,24,41
13,8477021,Alex Kerfoot,C,ARI,30,82,13,28,41
13,8483515,Juraj Slafkovsky,L,MTL,20,82,12,29,41
13,8475744,Evgeny Kuznetsov,C,CAR,32,82,12,29,41
13,8478474,Lawson Crouse,L,ARI,27,82,25,15,40
13,8475760,Nick Bjugstad,C,ARI,32,82,21,19,40
13,8481618,Alex Newhook,C,MTL,23,82,20,20,40
13,8475793,Ryan Johansen,C,PHI,32,82,18,22,40
13,8482110,Dawson Mercer,C,NJD,23,82,18,22,40
13,8475745,Charlie Coyle,C,BOS,32,82,13,27,40
13,8478396,Noah Hanifin,D,VGK,27,82,12,28,40
13,8475768,Jaden Schwartz,C,SEA,32,82,11,29,40
13,8476958,Jaccob Slavin,D,CAR,30,82,8,32,40
13,8470613,Brent Burns,D,CAR,39,82,7,33,40
13,8476869,Brady Skjei,D,CAR,30,82,7,33,40
13,8476923,Damon Severson,D,CBJ,30,82,5,35,40
13,8479525,Ross Colton,C,COL,28,82,19,20,39
13,8478463,Anthony Beauvillier,L,NSH,27,82,19,20,39
13,8475158,Ryan O'Reilly,C,NSH,33,82,16,23,39
13,8482475,Yegor Chinakhov,R,CBJ,23,82,16,23,39
13,8476458,Ryan Strome,C,ANA,31,82,13,26,39
13,8478046,Danton Heinen,L,BOS,29,82,13,26,39
13,8478519,Anthony Cirelli,C,TBL,27,82,11,28,39
13,8479425,Filip Hronek,D,VAN,27,82,10,29,39
13,8474578,Erik Karlsson,D,PIT,34,82,9,30,39
13,8477932,Aaron Ekblad,D,FLA,28,82,6,33,39
13,8482733,Logan Mailloux,D,MTL,31,82,5,34,39
13,8475169,Evander Kane,L,EDM,33,82,22,16,38
13,8479977,Kailer Yamamoto,R,SEA,26,82,20,18,38
13,8477497,Sean Monahan,C,WPG,30,82,18,20,38
13,8480849,Barrett Hayton,C,ARI,24,82,16,22,38
13,8481580,Connor McMichael,C,WSH,23,82,15,23,38
13,8480220,Noah Cates,L,PHI,25,82,14,24,38
13,8476329,Travis Boyd,C,ARI,31,82,13,25,38
13,8480031,Maxime Comtois,L,CAR,25,82,10,28,38
13,8479423,Alex Nylander,L,CBJ,26,82,21,16,37
13,8475722,Jason Zucker,L,NSH,32,82,21,16,37
13,8483431,Logan Cooley,C,ARI,20,82,20,17,37
13,8475287,Erik Haula,L,NJD,33,82,18,19,37
13,8480009,Eeli Tolvanen,R,SEA,25,82,16,21,37
13,8474641,Adam Henrique,C,EDM,34,82,15,22,37
13,8478366,Frank Vatrano,R,ANA,30,82,15,22,37
13,8476792,Torey Krug,D,STL,33,82,9,28,37
13,8475197,Tyson Barrie,D,NSH,33,82,7,30,37
13,8480873,Rasmus Sandin,D,WSH,24,82,7,30,37
13,8483457,Lane Hutson,D,MTL,20,82,4,33,37
13,8478397,Rasmus Andersson,D,CGY,28,82,3,34,37
13,8476292,Ondrej Palat,L,NJD,33,82,17,19,36
13,8482092,Ridly Greig,C,OTT,22,82,13,23,36
13,8477947,Sonny Milano,L,WSH,28,82,13,23,36
13,8475753,Justin Faulk,D,STL,32,82,9,27,36
13,8476854,Hampus Lindholm,D,BOS,30,82,6,30,36
13,8477488,Brett Pesce,D,CAR,30,82,6,30,36
13,8478466,Daniel Sprong,R,DET,27,82,18,17,35
13,8481624,Ilya Mikheyev,R,VAN,30,82,18,17,35
13,8480185,Eetu Luostarinen,C,FLA,26,82,16,19,35
13,8480802,Ryan McLeod,C,EDM,25,82,16,19,35
13,8476438,Brandon Saad,L,STL,32,82,15,20,35
13,8478057,Dakota Joshua,C,VAN,28,82,12,23,35
13,8474053,Logan Couture,C,SJS,35,82,11,24,35
13,8477953,Kasperi Kapanen,R,STL,28,82,11,24,35
13,8474563,Drew Doughty,D,LAK,35,82,9,26,35
13,8482655,J.J. Moser,D,ARI,24,82,8,27,35
13,8478507,John Marino,D,NJD,27,82,8,27,35
13,8482705,Cole Sillinger,C,CBJ,21,82,19,15,34
13,8474189,Lars Eller,C,PIT,35,82,16,18,34
13,8477407,Anthony Duclair,L,TBL,29,82,12,22,34
13,8479415,Michael McLeod,C,NJD,26,82,12,22,34
13,8480806,Isac Lundestrom,C,ANA,25,82,12,22,34
13,8474565,Alex Pietrangelo,D,VGK,34,82,8,26,34
13,8480871,Adam Boqvist,D,CBJ,24,82,7,27,34
13,8477948,Travis Sanheim,D,PHI,28,82,4,30,34
13,8477952,Robby Fabbri,C,DET,28,82,19,14,33
13,8479941,Justin Danforth,R,CBJ,31,82,17,16,33
13,8482113,Anton Lundell,C,FLA,23,82,16,17,33
13,8480893,Kirill Marchenko,R,CBJ,24,82,16,17,33
13,8484144,Connor Bedard,C,CHI,19,82,16,17,33
13,8476882,Teuvo Teravainen,L,CAR,30,82,14,19,33
13,8476480,Vladislav Namestnikov,C,WPG,32,82,14,19,33
13,8478891,Mason Appleton,C,WPG,28,82,12,21,33
13,8475218,Mattias Ekholm,D,EDM,34,82,8,25,33
13,8481656,Aliaksei Protas,C,WSH,23,82,7,26,33
13,8476463,Jonas Brodin,D,MIN,31,82,7,26,33
13,8481093,Rafael Harvey-Pinard,L,MTL,25,82,19,13,32
13,8476399,Blake Coleman,C,CGY,33,82,18,14,32
13,8476981,Josh Anderson,R,MTL,30,82,17,15,32
13,8481560,Arthur Kaliyev,R,LAK,23,82,15,17,32
13,8482055,Drew O'Connor,L,PIT,26,82,15,17,32
13,8477964,Ivan Barbashev,C,VGK,29,82,14,18,32
13,8474884,Mike Hoffman,C,SJS,35,82,14,18,32
13,8476897,Oskar Sundqvist,C,STL,30,82,14,18,32
13,8476419,Jean-Gabriel Pageau,C,NYI,32,82,11,21,32
13,8475149,Marcus Johansson,L,MIN,34,82,10,22,32
13,8474716,Jared Spurgeon,D,MIN,35,82,9,23,32
13,8478451,Ethan Bear,D,WSH,27,82,9,23,32
13,8483471,Brad Lambert,C,WPG,31,82,3,29,32
13,8482089,Jake Neighbours,L,STL,22,82,17,14,31
13,8476925,Colton Sissons,C,NSH,31,82,16,15,31
13,8480028,Morgan Frost,C,PHI,25,82,13,18,31
13,8481013,Jonatan Berggren,R,DET,24,82,13,18,31
13,8478413,Jordan Greenway,L,BUF,27,82,11,20,31
13,8483495,Simon Nemec,D,NJD,20,82,6,25,31
13,8474151,Ryan McDonagh,D,NSH,35,82,4,27,31
13,8480459,Pius Suter,C,VAN,28,82,17,13,30
13,8479996,Cody Glass,C,NSH,25,82,15,15,30
13,8482624,Daniil Miromanov,D,CGY,27,82,14,16,30
13,8481186,Logan O'Connor,R,COL,28,82,12,18,30
13,8478013,Jake Walman,D,DET,28,82,11,19,30
13,8482146,Luke Evangelista,R,NSH,22,82,10,20,30
13,8477425,Miles Wood,L,COL,29,82,9,21,30
13,8476891,Matt Grzelcyk,D,BOS,30,82,4,26,30
13,8475764,Cam Fowler,D,ANA,33,82,0,30,30
13,8482079,Marco Rossi,C,MIN,23,82,16,13,29
13,8482111,Justin Barron,D,MTL,23,82,16,13,29
13,8481553,Bobby Brink,R,PHI,23,82,15,14,29
13,8475343,Nic Dowd,C,WSH,34,82,15,14,29
13,8476921,Jordan Martinook,L,CAR,32,82,14,15,29
13,8474150,Mikael Backlund,C,CGY,35,82,11,18,29
13,8480855,Jack McBain,C,ARI,24,82,11,18,29
13,8475794,Tyler Seguin,C,DAL,32,82,10,19,29
13,8479353,Brett Howden,C,VGK,26,82,10,19,29
13,8481546,Cam York,D,PHI,23,82,9,20,29
13,8481581,Thomas Harley,D,DAL,23,82,9,20,29
13,8480113,Alex Iafallo,L,WPG,31,82,9,20,29
13,8480336,Sean Walker,D,COL,30,82,8,21,29
13,8476979,Erik Gustafsson,D,NYR,32,82,7,22,29
13,8478055,Gustav Forsling,D,FLA,28,82,6,23,29
13,8481016,Ruslan Iskhakov,C,NYI,24,82,5,24,29
13,8475181,Nick Leddy,D,STL,33,82,5,24,29
13,8477944,Jakub Vrana,L,STL,28,82,21,7,28
13,8474870,Tyler Johnson,C,CHI,34,82,15,13,28
13,8482702,Logan Stankoven,C,DAL,21,82,15,13,28
13,8484166,Adam Fantilli,C,CBJ,20,82,14,14,28
13,8479351,Sam Steel,C,DAL,26,82,13,15,28
13,8479983,Mario Ferraro,D,SJS,26,82,11,17,28
13,8483491,Ivan Miroshnichenko,L,WSH,20,82,10,18,28
13,8474149,Evgenii Dadonov,R,DAL,35,82,9,19,28
13,8480798,Philipp Kurashev,C,CHI,25,82,8,20,28
13,8477498,Darnell Nurse,D,EDM,29,82,8,20,28
13,8478911,Matt Roy,D,LAK,29,82,8,20,28
13,8481028,Martin Pospisil,C,CGY,25,82,8,20,28
13,8480145,Neal Pionk,D,WPG,29,82,2,26,28
13,8478020,Michael Amadio,C,VGK,28,82,19,8,27
13,8481604,Pavel Dorofeyev,L,VGK,24,82,18,9,27
13,8476392,Adam Lowry,C,WPG,31,82,14,13,27
13,8481704,Juuso Parssinen,C,NSH,23,82,14,13,27
13,8470604,Jeff Carter,C,PIT,39,82,13,14,27
13,8474715,Cam Atkinson,R,PHI,35,82,12,15,27
13,8479316,Luke Kunin,C,SJS,27,82,11,16,27
13,8477450,Jason Dickinson,C,CHI,29,82,10,17,27
13,8482087,Kaiden Guhle,D,MTL,22,82,9,18,27
13,8476873,Mark Jankowski,C,NSH,30,82,8,19,27
13,8480068,Ryan Poehling,C,PHI,25,82,8,19,27
13,8474673,TJ Brodie,D,TOR,34,82,7,20,27
13,8476931,Jake McCabe,D,TOR,31,82,6,21,27
13,8482117,Lukas Reichel,L,CHI,22,82,4,23,27
13,8481606,Jordan Spence,D,LAK,23,82,3,24,27
13,8484153,Leo Carlsson,C,ANA,20,82,17,9,26
13,8473533,Jordan Staal,C,CAR,36,82,15,11,26
13,8479393,Noah Gregor,C,TOR,26,82,15,11,26
13,8476469,Joel Armia,R,MTL,31,82,15,11,26
13,8481554,Kaapo Kakko,R,NYR,23,82,14,12,26
13,8476871,Tanner Pearson,L,MTL,32,82,13,13,26
13,8480821,Filip Zadina,R,SJS,25,82,12,14,26
13,8479992,Michael Rasmussen,C,DET,25,82,11,15,26
13,8479346,Dillon Dube,C,CGY,26,82,11,15,26
13,8477330,Dominik Kubalik,L,OTT,29,82,10,16,26
13,8481535,Nils Hoglander,L,VAN,24,82,9,17,26
13,8481522,Peyton Krebs,C,BUF,23,82,9,17,26
13,8482671,Owen Power,D,BUF,22,82,6,20,26
13,8476331,Dylan DeMelo,D,WPG,31,82,6,20,26
13,8480073,Erik Brannstrom,D,OTT,25,82,5,21,26
13,8479398,Samuel Girard,D,COL,26,82,3,23,26
13,8483493,Frank Nazar,C,CHI,20,82,18,7,25
13,8471218,Blake Wheeler,R,NYR,38,82,11,14,25
13,8477919,Frederick Gaudreau,C,MIN,31,82,11,14,25
13,8477406,Mattias Janmark,C,EDM,32,82,10,15,25
13,8479359,Beck Malenstyn,L,WSH,26,82,10,15,25
13,8479591,Michael Eyssimont,C,TBL,28,82,9,16,25
13,8478109,Victor Olofsson,L,BUF,29,82,9,16,25
13,8482730,Brandt Clarke,D,LAK,21,82,9,16,25
13,8476858,Phillip Di Giuseppe,L,VAN,31,82,9,16,25
13,8477505,Alexander Wennberg,C,NYR,30,82,7,18,25
13,8482142,Jamie Drysdale,D,PHI,22,82,5,20,25
13,8477495,Seth Jones,D,CHI,30,82,4,21,25
13,8482122,Brock Faber,D,MIN,22,82,3,22,25
13,8475233,David Savard,D,MTL,34,82,3,22,25
13,8470610,Zach Parise,L,COL,40,82,13,11,24
13,8479365,Trent Frederic,C,BOS,26,82,13,11,24
13,8476927,Teddy Blueger,C,VAN,30,82,12,12,24
13,8480074,Alexandre Texier,C,CBJ,25,82,10,14,24
13,8470621,Corey Perry,R,EDM,39,82,9,15,24
13,8477353,Tyler Motte,C,TBL,29,82,8,16,24
13,8476461,Sean Couturier,C,PHI,32,82,7,17,24
13,8480144,David Kampf,C,TOR,29,82,7,17,24
13,8477969,Marcus Pettersson,D,PIT,28,82,7,17,24
13,8480834,Ty Emberson,D,SJS,24,82,7,17,24
13,8478468,Jeremy Lauzon,D,NSH,27,82,6,18,24
13,8475455,Brenden Dillon,D,WPG,34,82,5,19,24
13,8479324,Ryan Lindgren,D,NYR,26,82,3,21,24
13,8479369,Andrew Peeke,D,BOS,26,82,2,22,24
13,8476374,Sean Kuraly,C,CBJ,31,82,15,8,23
13,8482155,Alex Laferriere,R,LAK,23,82,14,9,23
13,8478508,Yakov Trenin,C,COL,27,82,13,10,23
13,8482679,Matt Coronato,R,CGY,22,82,12,11,23
13,8482737,Zack Bolduc,C,STL,21,82,11,12,23
13,8475799,Nino Niederreiter,R,WPG,32,82,10,13,23
13,8482125,Alexander Holtz,R,NJD,22,82,10,13,23
13,8477392,Hudson Fasching,R,NYI,29,82,9,14,23
13,8482803,Olen Zellweger,D,ANA,21,82,6,17,23
13,8476885,Jacob Trouba,D,NYR,30,82,4,19,23
13,8481524,Bowen Byram,D,BUF,23,82,4,19,23
13,8481703,Valtteri Puustinen,R,PIT,25,82,4,19,23
13,8473507,Jeff Petry,D,DET,37,82,4,19,23
13,8477499,Rasmus Ristolainen,D,PHI,30,82,4,19,23
13,8482145,Mavrik Bourque,C,DAL,22,82,17,5,22
13,8476878,Zemgus Girgensons,L,BUF,30,82,12,10,22
13,8477989,Christian Dvorak,C,MTL,28,82,12,10,22
13,8479293,Brandon Tanev,L,SEA,33,82,11,11,22
13,8479661,Tanner Jeannot,L,TBL,27,82,11,11,22
13,8482166,Shakir Mukhamadullin,D,SJS,22,82,9,13,22
13,8477508,Curtis Lazar,C,NJD,29,82,8,14,22
13,8480796,Martin Fehervary,D,WSH,25,82,8,14,22
13,8477839,Conor Sheary,L,TBL,32,82,8,14,22
13,8476312,Josh Manson,D,COL,33,82,7,15,22
13,8479514,Rem Pitlick,C,CHI,27,82,7,15,22
13,8476624,Barclay Goodrow,C,NYR,31,82,7,15,22
13,8473449,Kyle Okposo,R,FLA,36,82,6,16,22
13,8483466,Kevin Korchinski,D,CHI,20,82,6,16,22
13,8478851,Alexandre Carrier,D,NSH,28,82,5,17,22
13,8479998,Mikey Anderson,D,LAK,25,82,4,18,22
13,8481178,Egor Zamula,D,PHI,24,82,4,18,22
13,8478178,Darren Raddysh,D,TBL,28,82,3,19,22
13,8481568,Alex Vlasic,D,CHI,23,82,0,22,22
13,8475220,Marcus Foligno,L,MIN,33,82,10,11,21
13,8481481,Blake Lizotte,C,LAK,27,82,9,12,21
13,8478831,Kevin Stenlund,C,FLA,28,82,9,12,21
13,8476960,Andreas Athanasiou,C,CHI,30,82,7,14,21
13,8473422,Nick Foligno,L,CHI,37,82,7,14,21
13,8475164,Jakob Silfverberg,R,ANA,34,82,7,14,21
13,8478430,Oliver Kylington,D,CGY,27,82,7,14,21
13,8483490,Pavel Mintyukov,D,ANA,21,82,7,14,21
13,8479976,Juuso Valimaki,D,ARI,26,82,7,14,21
13,8473563,Nicklas Backstrom,C,WSH,37,82,6,15,21
13,8478840,Will Borgen,D,SEA,28,82,6,15,21
13,8474013,Ian Cole,D,VAN,35,82,6,15,21
13,8480879,Jacob Bernard-Docker,D,OTT,24,82,5,16,21
13,8480035,Henri Jokiharju,D,BUF,25,82,3,18,21
13,8470966,Mark Giordano,D,TOR,41,82,3,18,21
13,8482118,Sam Colangelo,R,ANA,23,82,9,11,20
13,8476278,Colin Blackwell,C,CHI,31,82,8,12,20
13,8474034,Pat Maroon,L,BOS,36,82,7,13,20
13,8482062,Cole Smith,L,NSH,29,82,7,13,20
13,8480817,K'Andre Miller,D,NYR,24,82,5,15,20
13,8482073,Braden Schneider,D,NYR,23,82,4,16,20
13,8476467,Jamie Oleksiak,D,SEA,32,82,4,16,20
13,8481059,Scott Perunovich,D,STL,26,82,2,18,20
13,8478115,Pierre Engvall,L,NYI,28,82,10,9,19
13,8479390,Taylor Raddysh,R,CHI,26,82,10,9,19
13,8480281,Alexey Toropchenko,R,STL,25,82,10,9,19
13,8480980,Connor Dewar,C,TOR,25,82,10,9,19
13,8481601,Simon Holmstrom,R,NYI,23,82,9,10,19
13,8484145,Zach Benson,L,BUF,19,82,7,12,19
13,8477015,Connor Brown,R,EDM,30,82,7,12,19
13,8482245,Artem Zub,D,OTT,29,82,5,14,19
13,8476902,Esa Lindell,D,DAL,30,82,4,15,19
13,8476457,Adam Larsson,D,SEA,32,82,3,16,19
13,8474574,Tyler Myers,D,VAN,34,82,3,16,19
13,8480246,Nick Perbix,D,TBL,26,82,2,17,19
13,8478399,Jonas Siegenthaler,D,NJD,27,82,2,17,19
13,8480860,Kevin Bahl,D,NJD,24,82,2,17,19
13,8474567,Zach Bogosian,D,MIN,34,82,2,17,19
13,8484203,Bradly Nadeau,L,CAR,19,82,16,2,18
13,8481517,Brett Leason,R,ANA,25,82,12,6,18
13,8474009,Nick Bonino,C,NYR,36,82,8,10,18
13,8483505,Matthew Poitras,C,BOS,20,82,6,12,18
13,8481567,Henry Thrun,D,SJS,23,82,6,12,18
13,8475279,Ben Chiarot,D,DET,33,82,5,13,18
13,8478882,Vladislav Gavrikov,D,LAK,29,82,4,14,18
13,8484911,Collin Graf,R,SJS,22,82,1,17,18
13,8473453,Trevor Lewis,C,LAK,37,82,8,9,17
13,8478043,Sam Lafferty,C,VAN,29,82,8,9,17
13,8481477,Nico Sturm,C,SJS,29,82,7,10,17
13,8480448,Parker Kelly,L,OTT,25,82,7,10,17
13,8478859,Niko Mikkola,D,FLA,28,82,7,10,17
13,8477506,Ryan Pulock,D,NYI,30,82,5,12,17
13,8475200,Dmitry Orlov,D,CAR,33,82,5,12,17
13,8473504,Cal Clutterbuck,R,NYI,37,82,5,12,17
13,8483482,Tristan Luneau,D,ANA,20,82,5,12,17
13,8477365,Connor Clifton,D,BUF,29,82,5,12,17
13,8479980,Nicolas Hague,D,VGK,26,82,4,13,17
13,8475790,Erik Gudbranson,D,CBJ,32,82,4,13,17
13,8475462,Radko Gudas,D,ANA,34,82,4,13,17
13,8475171,Oliver Ekman-Larsson,D,FLA,33,82,3,14,17
13,8475825,Jani Hakanpää,D,DAL,32,82,3,14,17
13,8475208,Brian Dumoulin,D,SEA,33,82,2,15,17
13,8476917,Adam Pelech,D,NYI,30,82,2,15,17
13,8482470,Ilya Solovyov,D,CGY,24,82,2,15,17
13,8477220,Nate Schmidt,D,WPG,33,82,1,16,17
13,8477931,Tomas Nosek,L,NJD,32,82,9,7,16
13,8480813,Joe Veleno,C,DET,24,82,8,8,16
13,8479383,Boris Katchouk,L,OTT,26,82,6,10,16
13,8479291,Kevin Rooney,C,CGY,31,82,6,10,16
13,8478500,Ivan Provorov,D,CBJ,27,82,5,11,16
13,8480058,Pierre-Olivier Joseph,D,PIT,25,82,5,11,16
13,8483565,Nick Blankenburg,D,CBJ,26,82,4,12,16
13,8477034,Jaycob Megna,D,CHI,32,82,4,12,16
13,8476879,Cody Ceci,D,EDM,31,82,2,14,16
13,8483499,Liam Ohgren,L,MIN,20,82,9,6,15
13,8481537,Nikita Okhotiuk,D,CGY,24,82,7,8,15
13,8476915,Jujhar Khaira,L,MIN,30,82,7,8,15
13,8475231,Casey Cizikas,C,NYI,33,82,5,10,15
13,8476442,Matt Nieto,L,PIT,32,82,5,10,15
13,8476473,Connor Murphy,D,CHI,31,82,4,11,15
13,8482858,Ryker Evans,D,SEA,23,82,3,12,15
13,8481014,Alexander Romanov,D,NYI,24,82,2,13,15
13,8477845,Trevor van Riemsdyk,D,WSH,33,82,0,15,15
13,8482259,Bobby McMann,C,TOR,28,82,8,6,14
13,8482762,Simon Edvinsson,D,DET,21,82,8,6,14
13,8482666,Scott Morrow,D,CAR,22,82,7,7,14
13,8475177,Calvin de Haan,D,TBL,33,82,6,8,14
13,8482074,Connor Zary,C,CGY,23,82,5,9,14
13,8482809,Jackson Blake,R,CAR,21,82,5,9,14
13,8476525,Colin Miller,D,WPG,32,82,5,9,14
13,8477507,Nikita Zadorov,D,VAN,29,82,4,10,14
13,8482177,Marat Khusnutdinov,C,MIN,22,82,4,10,14
13,8477435,Ryan Graves,D,PIT,29,82,3,11,14
13,8483468,Jiri Kulich,C,BUF,20,82,3,11,14
13,8480172,Jan Rutta,D,SJS,34,82,3,11,14
13,8478443,Brandon Carlo,D,BOS,28,82,3,11,14
13,8476422,Mike Reilly,D,NYI,31,82,2,12,14
13,8482712,Oskar Olausson,R,COL,22,82,1,13,14
13,8478136,Jake Middleton,D,MIN,28,82,1,13,14
13,8478408,Travis Dermott,D,ARI,28,82,4,9,13
13,8479442,Troy Stecher,D,EDM,30,82,4,9,13
13,8477335,Kyle Burroughs,D,SJS,29,82,4,9,13
13,8481599,Victor Soderstrom,D,ARI,23,82,4,9,13
13,8476372,Nick Seeler,D,PHI,31,82,3,10,13
13,8475179,Dmitry Kulikov,D,FLA,34,82,2,11,13
13,8475188,Brayden McNabb,D,VGK,33,82,2,11,13
13,8476429,Scott Mayfield,D,NYI,32,82,1,12,13
13,8474166,Alec Martinez,D,VGK,37,82,1,12,13
13,8475324,Nick Jensen,D,WSH,34,82,1,12,13
13,8471677,Jack Johnson,D,COL,37,82,0,13,13
13,8475842,Sam Carrick,C,EDM,32,82,8,4,12
13,8483489,Fraser Minten,C,TOR,31,82,6,6,12
13,8475690,Chris Tanev,D,DAL,35,82,5,7,12
13,8480807,Mattias Samuelsson,D,BUF,24,82,3,9,12
13,8484149,Gavin Brindley,C,CBJ,20,82,3,9,12
13,8481605,Jackson LaCombe,D,ANA,23,82,2,10,12
13,8482516,Matthew Kessel,D,STL,24,82,1,11,12
13,8478569,Noel Acciari,C,PIT,33,82,8,3,11
13,8476967,Brett Kulak,D,EDM,30,82,3,8,11
13,8480990,Declan Chisholm,D,MIN,24,82,2,9,11
13,8479371,Dante Fabbro,D,NSH,26,82,3,7,10
13,8475762,Derek Forbort,D,BOS,32,82,3,7,10
13,8478416,Erik Cernak,D,TBL,27,82,3,7,10
13,8470600,Ryan Suter,D,DAL,39,82,1,8,9
13,8483763,Maksymilian Szuber,D,ARI,22,82,1,8,9
13,8477369,Carson Soucy,D,VAN,30,82,2,6,8
13,8483012,Logan Morrison,C,SEA,22,82,3,4,7
13,8481030,Jack St. Ivany,D,PIT,25,82,3,4,7
13,8476822,Luke Glendening,C,TBL,35,82,3,4,7
13,8481578,Graeme Clarke,R,NJD,23,82,4,2,6
13,8482807,Ethan Del Mastro,D,CHI,21,82,1,5,6
13,8482859,Zack Ostapchuk,C,OTT,21,82,1,5,6
13,8482713,Mackie Samoskevich,R,FLA,22,82,0,6,6
13,8482141,Lukas Cormier,D,VGK,22,0,0,0,0
13,8476988,Matt Benning,D,SJS,30,0,0,0,0
13,8480727,Zach Whitecloud,D,VGK,28,0,0,0,0
13,8480887,Jordan Harris,D,MTL,24,0,0,0,0
13,8478450,Parker Wotherspoon,D,BOS,27,0,0,0,0
13,8481812,Nikolai Knyzhov,D,SJS,27,0,0,0,0
13,8480001,Urho Vaakanainen,D,ANA,25,0,0,0,0
13,8482176,Wyatt Kaiser,D,CHI,22,0,0,0,0
13,8481122,Simon Benoit,D,TOR,26,0,0,0,0
13,8476441,Joel Edmundson,D,TOR,31,0,0,0,0
13,8480884,Calen Addison,D,SJS,24,0,0,0,0
13,8482511,Mason Lohrei,D,BOS,23,0,0,0,0
13,8482192,Isaak Phillips,D,CHI,23,0,0,0,0
13,8480950,Ilya Lyubushkin,D,TOR,30,0,0,0,0
13,8474031,Kevin Shattenkirk,D,BOS,35,0,0,0,0
13,8475718,Justin Holl,D,DET,32,0,0,0,0
13,8479402,Jake Bean,D,CBJ,26,0,0,0,0
13,8474602,Justin Schultz,D,SEA,34,0,0,0,0
13,8477950,Tony DeAngelo,D,CAR,29,0,0,0,0
13,8481743,Marc Del Gaizo,D,NSH,25,0,0,0,0
13,8481527,Kaedan Korczak,D,VGK,23,0,0,0,0
13,8480192,Johnathan Kovacevic,D,MTL,27,0,0,0,0
13,8476874,Olli Maatta,D,DET,30,0,0,0,0
13,8482144,Jack Thompson,D,SJS,22,0,0,0,0
13,8480222,Sebastian Aho,D,NYI,28,0,0,0,0
13,8479458,Nikita Zaitsev,D,CHI,33,0,0,0,0
13,8471709,Marc-Edouard Vlasic,D,SJS,37,0,0,0,0
13,8482929,Emil Lilleberg,D,TBL,23,0,0,0,0
13,8477018,Ben Hutton,D,VGK,31,0,0,0,0
13,8481056,Spencer Stastney,D,NSH,24,0,0,0,0
13,8481593,Jayden Struble,D,MTL,23,0,0,0,0
13,8479982,Conor Timmins,D,TOR,26,0,0,0,0
13,8474090,Brendan Smith,D,NJD,35,0,0,0,0
13,8482964,Arber Xhekaj,D,MTL,23,0,0,0,0
13,8480891,Michael Kesselring,D,ARI,24,0,0,0,0
13,8477938,Haydn Fleury,D,TBL,28,0,0,0,0
13,8481806,Louis Crevier,D,CHI,23,0,0,0,0
13,8471274,Alex Goligoski,D,MIN,39,0,0,0,0
13,8481600,Tobias Bjornfot,D,FLA,23,0,0,0,0
13,8475797,Jarred Tinordi,D,CHI,32,0,0,0,0
13,8481521,Ronnie Attard,D,PHI,25,0,0,0,0
13,8474612,Travis Hamonic,D,OTT,34,0,0,0,0
13,8479576,Vincent Desharnais,D,EDM,28,0,0,0,0
13,8480049,Dylan Samberg,D,WPG,25,0,0,0,0
13,8483619,Filip Roos,D,CHI,25,0,0,0,0
13,8474568,Luke Schenn,D,NSH,35,0,0,0,0
13,8480184,Gustav Lindstrom,D,ANA,26,0,0,0,0
13,8480070,Ian Mitchell,D,BOS,25,0,0,0,0
13,8480196,Jacob Bryson,D,BUF,27,0,0,0,0
13,8471686,Marc Staal,D,PHI,37,0,0,0,0
13,8477467,Gustav Olofsson,D,SEA,30,0,0,0,0
13,8478970,Jalen Chatfield,D,CAR,28,0,0,0,0
13,8479348,Kale Clague,D,BUF,26,0,0,0,0
13,8473446,Erik Johnson,D,PHI,36,0,0,0,0
13,8477462,Robert Hagg,D,ANA,29,0,0,0,0
13,8478454,Noah Juulsen,D,VAN,27,0,0,0,0
13,8477384,Josh Brown,D,ARI,30,0,0,0,0
13,8481708,Zac Jones,D,NYR,24,0,0,0,0
13,8481167,Brayden Pachal,D,CGY,25,0,0,0,0
13,8482067,Connor Mackey,D,NYR,28,0,0,0,0
13,8483460,David Jiricek,D,CBJ,21,0,0,0,0
13,8481701,Santeri Hatakka,D,NJD,23,0,0,0,0
13,8478021,William Lagesson,D,ANA,28,0,0,0,0
13,8477851,Jordan Oesterle,D,CGY,32,0,0,0,0
13,8478452,Caleb Jones,D,COL,27,0,0,0,0
13,8479984,Cal Foote,D,NJD,26,0,0,0,0
13,8479639,Dylan Coghlan,D,CAR,26,0,0,0,0
13,8480874,Adam Ginning,D,PHI,24,0,0,0,0
13,8479321,Lucas Johansen,D,WSH,27,0,0,0,0
13,8480878,Nils Lundkvist,D,DAL,24,0,0,0,0
13,8482165,Yan Kuznetsov,D,CGY,22,0,0,0,0
13,8484258,Sam Malinski,D,COL,26,0,0,0,0
13,8480157,Calle Rosen,D,STL,30,0,0,0,0
13,8484304,Uvis Balinskis,D,FLA,28,0,0,0,0
13,8479985,Cale Fleury,D,SEA,26,0,0,0,0
13,8479378,Logan Stanley,D,WPG,26,0,0,0,0
13,8477541,Dakota Mermis,D,MIN,30,0,0,0,0
13,8481609,Vladislav Kolyachonok,D,ARI,23,0,0,0,0
13,8480823,Alexander Alexeyev,D,WSH,25,0,0,0,0
13,8481679,Maxence Guenette,D,OTT,23,0,0,0,0
13,8481564,Ryan Johnson,D,BUF,23,0,0,0,0
13,8479376,Victor Mete,D,PHI,26,0,0,0,0
13,8484254,Akito Hirose,D,VAN,25,0,0,0,0
13,8482660,Kent Johnson,C,CBJ,22,0,0,0,0
13,8482149,Cole Perfetti,C,WPG,22,0,0,0,0
13,8477987,Ryan Donato,C,CHI,28,0,0,0,0
13,8475755,Alexander Petrovic,D,DAL,32,0,0,0,0
13,8477810,Joel Hanley,D,CGY,33,0,0,0,0
13,8474145,Robert Bortuzzo,D,NYI,35,0,0,0,0
13,8481161,Jake Christiansen,D,CBJ,25,0,0,0,0
13,8476884,Derrick Pouliot,D,DAL,30,0,0,0,0
13,8481716,Dmitri Voronkov,L,CBJ,24,0,0,0,0
13,8480084,Nick DeSimone,D,NJD,30,0,0,0,0
13,8475750,Jon Merrill,D,MIN,32,0,0,0,0
13,8479315,Joey Anderson,R,CHI,26,0,0,0,0
13,8478011,Louie Belpedio,D,PHI,28,0,0,0,0
13,8482451,Mikael Pyyhtia,L,CBJ,23,0,0,0,0
13,8481541,Samuel Bolduc,D,NYI,24,0,0,0,0
13,8482126,Emil Andrae,D,PHI,31,0,0,0,0
13,8474618,Marco Scandella,D,STL,34,0,0,0,0
13,8477244,Chad Ruhwedel,D,NYR,34,0,0,0,0
13,8477971,Andreas Englund,D,LAK,28,0,0,0,0
13,8480829,Jesperi Kotkaniemi,C,CAR,24,0,0,0,0
13,8479372,Josh Mahura,D,FLA,26,0,0,0,0
13,8482095,Tyler Kleven,D,OTT,22,0,0,0,0
13,8481719,Maxwell Crozier,D,TBL,24,0,0,0,0
13,8475855,Jesper Fast,R,CAR,33,0,0,0,0
13,8480848,Ty Dellandrea,C,DAL,24,0,0,0,0
13,8475193,Tomas Tatar,L,SEA,34,0,0,0,0
13,8476889,Radek Faksa,C,DAL,30,0,0,0,0
13,8478495,Denis Gurianov,R,PHI,27,0,0,0,0
13,8480216,Jacob Peterson,C,SJS,25,0,0,0,0
13,8480252,Cole Guttman,C,CHI,25,0,0,0,0
13,8479026,Philippe Myers,D,TBL,27,0,0,0,0
13,8481006,Tyler Tucker,D,STL,24,0,0,0,0
13,8481032,Paul Cotter,C,VGK,25,0,0,0,0
13,8481577,Philip Tomasino,C,NSH,23,0,0,0,0
13,8476918,Jimmy Vesey,L,NYR,31,0,0,0,0
13,8479320,Max Lajoie,D,TOR,27,0,0,0,0
13,8478017,Mark Friedman,D,VAN,29,0,0,0,0
13,8481754,Nikita Nesterenko,C,ANA,23,0,0,0,0
13,8483407,Brandon Scanlin,D,NYR,25,0,0,0,0
13,8482659,Josh Doan,R,ARI,22,0,0,0,0
13,8477446,Michael McCarron,R,NSH,29,0,0,0,0
13,8477903,Garnet Hathaway,R,PHI,33,0,0,0,0
13,8482153,Brendan Brisson,C,VGK,23,0,0,0,0
13,8483546,Marshall Rifai,D,TOR,26,0,0,0,0
13,8484287,Cole McWard,D,VAN,23,0,0,0,0
13,8478854,Ryan Shea,D,PIT,27,0,0,0,0
13,8481585,Egor Afanasyev,L,NSH,23,0,0,0,0
13,8483398,Declan Carlile,D,TBL,31,0,0,0,0
13,8478502,Dennis Gilbert,D,CGY,28,0,0,0,0
13,8482749,Joshua Roy,R,MTL,21,0,0,0,0
13,8481598,Philip Broberg,D,EDM,23,0,0,0,0
13,8480835,Jack Drury,C,CAR,24,0,0,0,0
13,8480748,Kiefer Sherwood,L,NSH,29,0,0,0,0
13,8476934,Brock McGinn,L,ANA,30,0,0,0,0
13,8480870,Bo Groulx,C,ANA,24,0,0,0,0
13,8479368,Max Jones,L,ANA,26,0,0,0,0
13,8478099,Kevin Labanc,R,SJS,29,0,0,0,0
13,8478067,Oskar Lindblom,L,SJS,28,0,0,0,0
13,8476393,Nick Cousins,C,FLA,31,0,0,0,0
13,8483395,Arshdeep Bains,L,VAN,23,0,0,0,0
13,8480762,Eric Robinson,L,BUF,29,0,0,0,0
13,8479439,Jacob MacDonald,D,SJS,31,0,0,0,0
13,8476474,Stefan Noesen,R,CAR,31,0,0,0,0
13,8482787,Nikita Chibrikov,R,WPG,31,0,0,0,0
13,8478432,Christian Fischer,R,DET,27,0,0,0,0
13,8477979,Nicolas Aube-Kubel,R,WSH,28,0,0,0,0
13,8481789,Tye Kartye,L,SEA,23,0,0,0,0
13,8479330,Brandon Gignac,C,MTL,27,0,0,0,0
13,8480075,Cameron Crotty,D,ARI,25,0,0,0,0
13,8473473,Milan Lucic,L,BOS,36,0,0,0,0
13,8482094,Daemon Hunt,D,MIN,22,0,0,0,0
13,8481206,John Ludvig,D,PIT,24,0,0,0,0
13,8483630,Pavol Regenda,L,ANA,25,0,0,0,0
13,8481617,Vasily Podkolzin,R,VAN,23,0,0,0,0
13,8480306,Grant Hutton,D,NYI,29,0,0,0,0
13,8480995,Pontus Holmberg,R,TOR,25,0,0,0,0
13,8482148,Hendrix Lapierre,C,WSH,22,0,0,0,0
13,8477478,William Carrier,L,VGK,30,0,0,0,0
13,8480003,Jesper Boqvist,C,BOS,26,0,0,0,0
13,8482172,Landon Slaggert,L,CHI,22,0,0,0,0
13,8480789,Oliver Wahlstrom,R,NYI,24,0,0,0,0
13,8474062,Riley Nash,C,NYR,35,0,0,0,0
13,8480021,Jack Studnicka,C,SJS,25,0,0,0,0
13,8480025,MacKenzie Entwistle,R,CHI,25,0,0,0,0
13,8481582,Nicholas Robertson,L,TOR,23,0,0,0,0
13,8476867,Brendan Gaunce,C,CBJ,30,0,0,0,0
13,8479619,Michael Carcone,L,ARI,28,0,0,0,0
13,8479370,Tyson Jost,C,BUF,26,0,0,0,0
13,8479671,Mathieu Olivier,R,CBJ,27,0,0,0,0
13,8476994,Vinnie Hinostroza,C,PIT,30,0,0,0,0
13,8482070,Mitchell Chaffee,R,TBL,26,0,0,0,0
13,8477473,Justin Bailey,R,SJS,29,0,0,0,0
13,8479344,Jesse Puljujarvi,R,PIT,26,0,0,0,0
13,8480205,Emil Bemstrom,C,PIT,25,0,0,0,0
13,8479718,Alex Barré-Boulet,C,TBL,27,0,0,0,0
13,8482061,Brandon Biro,L,BUF,26,0,0,0,0
13,8479638,Justin Brazeau,R,BOS,26,0,0,0,0
13,8474040,Sam Gagner,C,EDM,35,0,0,0,0
13,8477846,Ryan Carpenter,C,SJS,33,0,0,0,0
13,8482077,Dylan Holloway,L,EDM,23,0,0,0,0
13,8482157,Will Cuylle,L,NYR,22,0,0,0,0
13,8480007,Jonas Rondbjerg,R,VGK,25,0,0,0,0
13,8478874,Adam Gaudette,C,STL,28,0,0,0,0
13,8478434,Keegan Kolesar,R,VGK,27,0,0,0,0
13,8480441,Trey Fix-Wolansky,R,CBJ,25,0,0,0,0
13,8479994,Jaret Anderson-Dolan,C,NSH,25,0,0,0,0
13,8483567,Georgii Merkulov,C,BOS,24,0,0,0,0
13,8477380,Jonny Brodzinski,C,NYR,31,0,0,0,0
13,8482201,Gage Goncalves,C,TBL,23,0,0,0,0
13,8478211,Dryden Hunt,L,CGY,29,0,0,0,0
13,8471699,Andrew Cogliano,C,COL,37,0,0,0,0
13,8479421,Jacob Moverare,D,LAK,26,0,0,0,0
13,8478881,Brett Seney,L,CHI,28,0,0,0,0
13,8477464,Nic Petan,C,MIN,29,0,0,0,0
13,8475958,Michael Sgarbossa,C,WSH,32,0,0,0,0
13,8481147,Reese Johnson,C,CHI,26,0,0,0,0
13,8479336,Carl Grundstrom,R,LAK,27,0,0,0,0
13,8480853,Liam Foudy,C,NSH,24,0,0,0,0
13,8479522,Hardy Haman Aktell,D,WSH,26,0,0,0,0
13,8481462,Mason Morelli,L,VGK,28,0,0,0,0
13,8482102,Vasily Ponomarev,C,CAR,22,0,0,0,0
13,8480844,Grigori Denisenko,L,VGK,24,0,0,0,0
13,8479944,Zach Aston-Reese,C,DET,30,0,0,0,0
13,8482784,Zach Dean,C,STL,21,0,0,0,0
13,8479419,Brett Murray,L,BUF,26,0,0,0,0
13,8479520,Brandon Duhaime,R,COL,27,0,0,0,0
13,8477573,Nathan Walker,L,STL,30,0,0,0,0
13,8478078,Rourke Chartier,C,OTT,28,0,0,0,0
13,8475795,Dylan McIlrath,D,WSH,32,0,0,0,0
13,8482496,Nils Aman,C,VAN,24,0,0,0,0
13,8480289,Morgan Barron,C,WPG,26,0,0,0,0
13,8481751,Lukas Rousek,R,BUF,25,0,0,0,0
13,8480011,Klim Kostin,C,SJS,25,0,0,0,0
13,8481556,John Beecher,C,BOS,23,0,0,0,0
13,8475278,Byron Froese,C,VGK,33,0,0,0,0
13,8475225,Craig Smith,C,DAL,35,0,0,0,0
13,8484326,Patrik Koch,D,ARI,28,0,0,0,0
13,8477930,Pierre-Edouard Bellemare,L,SEA,39,0,0,0,0
13,8478409,Anthony Richard,C,BOS,28,0,0,0,0
13,8481024,Linus Karlsson,C,VAN,25,0,0,0,0
13,8479986,Kole Lind,R,SEA,26,0,0,0,0
13,8479414,Nathan Bastian,R,NJD,27,0,0,0,0
13,8479362,Riley Tufte,L,COL,26,0,0,0,0
13,8481058,Jesse Ylönen,R,MTL,25,0,0,0,0
13,8482476,Emil Heineman,L,MTL,23,0,0,0,0
13,8482861,Vincent Iorio,D,WSH,22,0,0,0,0
13,8483432,Luca Del Bel Belluz,C,CBJ,31,0,0,0,0
13,8482744,James Malatesta,L,CBJ,21,0,0,0,0
13,8477887,Patrick Brown,C,BOS,32,0,0,0,0
13,8478585,Derek Ryan,C,EDM,38,0,0,0,0
13,8481441,Joe Snively,C,WSH,28,0,0,0,0
13,8481592,Jakob Pelletier,L,CGY,23,0,0,0,0
13,8482634,Alex Steeves,C,TOR,25,0,0,0,0
13,8477126,Jayson Megna,C,BOS,34,0,0,0,0
13,8475752,Tyler Pitlick,C,NYR,33,0,0,0,0
13,8480008,Adam Ruzicka,C,ARI,25,0,0,0,0
13,8481065,Angus Crookshank,L,OTT,25,0,0,0,0
13,8479547,Matthew Phillips,R,WSH,26,0,0,0,0
13,8480226,Marián Studenic,R,SEA,26,0,0,0,0
13,8481237,Kyle MacLean,C,NYI,25,0,0,0,0
13,8475413,Justin Dowling,C,NJD,34,0,0,0,0
13,8481641,Joel Kiviranta,L,COL,28,0,0,0,0
13,8478104,Sammy Blais,L,STL,28,0,0,0,0
13,8477454,Adam Erne,L,EDM,29,0,0,0,0
13,8481518,Nolan Foote,L,NJD,24,0,0,0,0
13,8480245,Olle Lycksell,R,PHI,25,0,0,0,0
13,8483570,Ben Meyers,C,ANA,26,0,0,0,0
13,8480776,Sheldon Rempal,R,VGK,29,0,0,0,0
13,8483920,Pierrick Dube,R,WSH,23,0,0,0,0
13,8480267,Sammy Walker,C,MIN,25,0,0,0,0
13,8482747,Brennan Othmann,L,NYR,21,0,0,0,0
13,8479991,Jake Leschyshyn,C,NYR,25,0,0,0,0
13,8478400,Colin White,C,MTL,27,0,0,0,0
13,8479328,Julien Gauthier,R,NYI,27,0,0,0,0
13,8484325,Waltteri Merela,C,TBL,26,0,0,0,0
13,8479066,Ryan Lomberg,L,FLA,30,0,0,0,0
13,8477070,Liam O'Brien,C,ARI,30,0,0,0,0
13,8478146,Matthew Highmore,C,OTT,28,0,0,0,0
13,8478028,Fredrik Olofsson,L,COL,28,0,0,0,0
13,8480880,Jakub Lauko,C,BOS,24,0,0,0,0
13,8479968,Vinni Lettieri,C,MIN,29,0,0,0,0
13,8474709,Matt Martin,L,NYI,35,0,0,0,0
13,8480845,Rasmus Kupari,C,WPG,24,0,0,0,0
13,8481550,Adam Beckman,L,MIN,23,0,0,0,0
13,8481422,Jacob Lucchini,C,MIN,29,0,0,0,0
13,8477401,John Hayden,C,SEA,29,0,0,0,0
13,8478904,Steven Lorentz,C,FLA,28,0,0,0,0
13,8482088,Justin Sourdif,R,FLA,22,0,0,0,0
13,8482751,Ryan Winterton,C,SEA,21,0,0,0,0
13,8482241,Radim Zohorna,L,PIT,28,0,0,0,0
13,8481690,Tyler Angle,C,CBJ,24,0,0,0,0
13,8476952,Dominic Toninato,C,WPG,30,0,0,0,0
13,8476919,Chris Tierney,C,NJD,30,0,0,0,0
13,8480032,Shane Bowers,C,NJD,25,0,0,0,0
13,8484314,Jiri Smejkal,L,OTT,28,0,0,0,0
13,8481239,Samuel Fagemo,L,LAK,24,0,0,0,0
13,8481532,Alex Turcotte,C,LAK,23,0,0,0,0
13,8481019,David Gustafsson,C,WPG,24,0,0,0,0
13,8478477,Mitchell Stephens,C,MTL,27,0,0,0,0
13,8479546,Oskar Steen,C,BOS,26,0,0,0,0
13,8480292,Carson Meyer,R,CBJ,27,0,0,0,0
13,8478446,Glenn Gawdin,C,ANA,27,0,0,0,0
13,8483531,Brian Halonen,L,NJD,25,0,0,0,0
13,8477149,Scott Sabourin,R,SJS,32,0,0,0,0
13,8479972,Mason Shaw,C,MIN,26,0,0,0,0
13,8480890,Jan Jenik,R,ARI,24,0,0,0,0
13,8478051,Max Willman,C,NJD,29,0,0,0,0
13,8480851,Akil Thomas,C,LAK,24,0,0,0,0
13,8482765,Isak Rosen,R,BUF,21,0,0,0,0
13,8478421,A.J. Greer,L,CGY,28,0,0,0,0
13,8478512,Austin Czarnik,C,DET,32,0,0,0,0
13,8479536,Axel Jonsson-Fjallby,L,WPG,26,0,0,0,0
13,8477320,Anton Blidh,L,NYR,29,0,0,0,0
13,8481543,Nikita Alexandrov,C,STL,24,0,0,0,0
13,8475235,Nicolas Deslauriers,L,PHI,33,0,0,0,0
13,8481070,Hugh McGing,L,STL,26,0,0,0,0
13,8480836,Jonathan Gruden,C,PIT,24,0,0,0,0
13,8481591,Sam Poulin,R,PIT,23,0,0,0,0
13,8477962,Brendan Lemieux,L,CAR,28,0,0,0,0
13,8483401,Marc Johnstone,R,PIT,28,0,0,0,0
13,8482250,Callahan Burke,C,CAR,27,0,0,0,0
13,8481726,Adam Edstrom,C,NYR,24,0,0,0,0
13,8471817,Ryan Reaves,R,TOR,37,0,0,0,0
13,8479587,Rhett Gardner,C,PHI,28,0,0,0,0
13,8475766,Austin Watson,L,TBL,32,0,0,0,0
13,8479367,William Lockwood,R,FLA,26,0,0,0,0
13,8478424,Jansen Harkins,C,PIT,27,0,0,0,0
13,8476913,Devin Shore,C,SEA,30,0,0,0,0
13,8482652,Walker Duehr,R,CGY,27,0,0,0,0
13,8477527,Ross Johnston,L,ANA,30,0,0,0,0
13,8481077,John Leonard,L,ARI,26,0,0,0,0
13,8483549,Lucas Condotta,L,MTL,27,0,0,0,0
13,8480468,James Hamblin,L,EDM,25,0,0,0,0
13,8476907,Mackenzie MacEachern,L,STL,30,0,0,0,0
13,8479543,Michael Pezzetta,L,MTL,26,0,0,0,0
13,8480355,Mark Kastelic,C,OTT,25,0,0,0,0
13,8482162,Roby Jarventie,L,OTT,22,0,0,0,0
13,8479772,Zack MacEwen,R,OTT,28,0,0,0,0
13,8483597,Milos Kelemen,L,ARI,25,0,0,0,0
13,8479379,Givani Smith,R,SJS,26,0,0,0,0
13,8481655,Cole Schwindt,R,CGY,23,0,0,0,0
13,8479981,Jonah Gadjovich,L,FLA,26,0,0,0,0
13,8482147,Jean-Luc Foudy,C,COL,22,0,0,0,0
13,8484255,Jason Polin,R,COL,25,0,0,0,0
13,8477993,Justin Kirkland,C,ARI,28,0,0,0,0
13,8479249,Andrew Poturalski,C,SEA,30,0,0,0,0
13,8482197,Adam Raska,R,MIN,23,0,0,0,0
13,8475780,Chris Wagner,R,COL,33,0,0,0,0
13,8479533,Joona Koppanen,L,PIT,26,0,0,0,0
13,8481534,Raphael Lavoie,C,EDM,24,0,0,0,0
13,8484321,Nikolas Matinpalo,D,OTT,26,0,0,0,0
13,8481043,Cole Koepke,L,TBL,26,0,0,0,0
13,8476323,Max McCormick,L,SEA,32,0,0,0,0
13,8483609,Adam Klapka,R,CGY,24,0,0,0,0
13,8483512,Matt Savoie,C,BUF,20,0,0,0,0
13,8484259,Ondrej Pavel,C,COL,31,0,0,0,0
13,8478147,Bokondji Imama,L,OTT,28,0,0,0,0
13,8482460,Matt Rempe,C,NYR,22,0,0,0,0
13,8477073,Kurtis MacDermid,L,NJD,30,0,0,0,0
13,8480274,Philip Kemp,D,EDM,25,0,0,0,0
13,8478956,Samuel Laberge,L,NJD,27,0,0,0,0
13,8483045,Cameron Butler,R,CBJ,31,0,0,0,0
14,8478402,Connor McDavid,C,EDM,27,82,53,71,124
14,8476453,Nikita Kucherov,R,TBL,31,82,30,81,111
14,8478550,Artemi Panarin,L,NYR,33,82,39,68,107
14,8479318,Auston Matthews,C,TOR,27,82,52,48,100
14,8477492,Nathan MacKinnon,C,COL,29,82,31,69,100
14,8477956,David Pastrnak,R,BOS,28,82,38,59,97
14,8481559,Jack Hughes,C,NJD,23,82,31,65,96
14,8477939,William Nylander,R,TOR,28,82,44,49,93
14,8478403,Jack Eichel,C,VGK,28,82,42,51,93
14,8477934,Leon Draisaitl,C,EDM,29,82,38,55,93
14,8479314,Matthew Tkachuk,L,FLA,27,82,23,67,90
14,8474564,Steven Stamkos,C,TBL,34,82,41,48,89
14,8480801,Brady Tkachuk,L,OTT,25,82,45,43,88
14,8479337,Alex DeBrincat,R,DET,27,82,36,51,87
14,8480012,Elias Pettersson,C,VAN,26,82,31,56,87
14,8480023,Robert Thomas,C,STL,25,82,30,56,86
14,8477493,Aleksander Barkov,C,FLA,29,82,41,44,85
14,8479407,Jesper Bratt,L,NJD,26,82,30,55,85
14,8477933,Sam Reinhart,C,FLA,29,82,36,48,84
14,8479323,Adam Fox,D,NYR,26,82,14,70,84
14,8481557,Matt Boldy,L,MIN,23,82,31,51,82
14,8478864,Kirill Kaprizov,L,MIN,27,82,38,43,81
14,8477946,Dylan Larkin,C,DET,28,82,35,46,81
14,8480027,Jason Robertson,L,DAL,25,82,23,58,81
14,8480069,Cale Makar,D,COL,26,82,19,62,81
14,8482116,Tim Stützle,C,OTT,22,82,24,56,80
14,8478427,Sebastian Aho,C,CAR,27,82,41,38,79
14,8481523,Kirby Dach,C,MTL,23,82,15,64,79
14,8476887,Filip Forsberg,L,NSH,30,82,45,33,78
14,8480002,Nico Hischier,C,NJD,25,82,29,48,77
14,8475913,Mark Stone,R,VGK,32,82,27,50,77
14,8478445,Mathew Barzal,C,NYI,27,82,24,53,77
14,8474600,Roman Josi,D,NSH,34,82,23,54,77
14,8479420,Tage Thompson,C,BUF,27,82,36,40,76
14,8471675,Sidney Crosby,C,PIT,37,82,32,42,74
14,8476459,Mika Zibanejad,C,NYR,31,82,29,45,74
14,8480830,Andrei Svechnikov,R,CAR,24,82,29,45,74
14,8480800,Quinn Hughes,D,VAN,25,82,16,58,74
14,8475786,Zach Hyman,L,EDM,32,82,40,33,73
14,8471215,Evgeni Malkin,C,PIT,38,82,27,45,72
14,8476346,Johnny Gaudreau,L,CBJ,31,82,18,54,72
14,8482740,Wyatt Johnston,C,DAL,21,82,42,29,71
14,8476468,J.T. Miller,C,VAN,31,82,28,43,71
14,8477942,Kevin Fiala,L,LAK,28,82,28,43,71
14,8478420,Mikko Rantanen,R,COL,28,82,27,44,71
14,8482093,Seth Jarvis,C,CAR,22,82,26,45,71
14,8482078,Lucas Raymond,L,DET,22,82,25,46,71
14,8480839,Rasmus Dahlin,D,BUF,24,82,18,52,70
14,8478414,Timo Meier,R,NJD,28,82,38,31,69
14,8477955,Jared McCann,L,SEA,28,82,37,32,69
14,8481068,Yegor Sharangovich,C,CGY,26,82,37,32,69
14,8475172,Nazem Kadri,C,CGY,34,82,26,43,69
14,8476454,Ryan Nugent-Hopkins,C,EDM,31,82,14,55,69
14,8475810,Bryan Rust,R,PIT,32,82,36,32,68
14,8471214,Alex Ovechkin,L,WSH,39,82,35,33,68
14,8477404,Jake Guentzel,C,CAR,30,82,33,35,68
14,8478440,Dylan Strome,C,WSH,27,82,31,37,68
14,8478010,Brayden Point,C,TBL,28,82,40,27,67
14,8476881,Tomas Hertl,C,VGK,31,82,27,40,67
14,8473419,Brad Marchand,L,BOS,36,82,23,44,67
14,8480803,Evan Bouchard,D,EDM,25,82,19,48,67
14,8477949,Alex Tuch,R,BUF,28,82,34,32,66
14,8478397,Rasmus Andersson,D,CGY,28,82,16,50,66
14,8479343,Clayton Keller,R,ARI,26,82,32,33,65
14,8475158,Ryan O'Reilly,C,NSH,33,82,29,36,65
14,8477409,Carter Verhaeghe,C,FLA,29,82,27,38,65
14,8474578,Erik Karlsson,D,PIT,34,82,13,52,65
14,8477501,Valeri Nichushkin,R,COL,29,82,36,28,64
14,8478439,Travis Konecny,R,PHI,27,82,29,35,64
14,8482684,Luke Hughes,D,NJD,21,82,19,44,63
14,8478401,Pavel Zacha,C,BOS,27,82,16,47,63
14,8474141,Patrick Kane,R,DET,36,82,22,40,62
14,8480798,Philipp Kurashev,C,CHI,25,82,20,42,62
14,8481540,Cole Caufield,R,MTL,23,82,33,28,61
14,8476448,William Karlsson,C,VGK,31,82,31,30,61
14,8478444,Brock Boeser,R,VAN,27,82,26,35,61
14,8475692,Mats Zuccarello,R,MIN,37,82,17,44,61
14,8476905,Chandler Stephenson,C,VGK,30,82,15,46,61
14,8476853,Morgan Rielly,D,TOR,30,82,9,52,61
14,8478398,Kyle Connor,L,WPG,28,82,30,30,60
14,8476460,Mark Scheifele,C,WPG,31,82,27,33,60
14,8477447,Shea Theodore,D,VGK,29,82,9,51,60
14,8474590,John Carlson,D,WSH,34,82,8,52,60
14,8476399,Blake Coleman,C,CGY,33,82,30,29,59
14,8474102,David Perron,L,DET,36,82,16,43,59
14,8478449,Roope Hintz,C,DAL,28,82,26,32,58
14,8475754,Brock Nelson,C,NYI,33,82,26,32,58
14,8476389,Vincent Trocheck,C,NYR,31,82,25,33,58
14,8475166,John Tavares,C,TOR,34,82,23,35,58
14,8479542,Brandon Hagel,L,TBL,26,82,23,35,58
14,8482667,William Eklund,L,SJS,22,82,20,38,58
14,8475184,Chris Kreider,L,NYR,33,82,36,21,57
14,8476539,Jonathan Marchessault,R,VGK,34,82,33,24,57
14,8477500,Bo Horvat,C,NYI,29,82,28,29,57
14,8473986,Alex Killorn,L,ANA,35,82,26,31,57
14,8478975,Mason Marchment,L,DAL,29,82,24,33,57
14,8482745,Mason McTavish,C,ANA,21,82,19,38,57
14,8481528,Dylan Cozens,C,BUF,23,82,17,40,57
14,8478438,Tommy Novak,C,NSH,27,82,14,43,57
14,8478498,Jake DeBrusk,L,BOS,28,82,28,28,56
14,8478493,Joel Eriksson Ek,C,MIN,27,82,24,32,56
14,8475745,Charlie Coyle,C,BOS,32,82,22,34,56
14,8476462,Dougie Hamilton,D,NJD,31,82,20,36,56
14,8473994,Jamie Benn,L,DAL,35,82,20,36,56
14,8470794,Joe Pavelski,C,DAL,40,82,15,41,56
14,8477504,Josh Morrissey,D,WPG,29,82,7,49,56
14,8479385,Jordan Kyrou,C,STL,26,82,28,27,55
14,8474679,Gustav Nyquist,C,NSH,35,82,24,31,55
14,8477402,Pavel Buchnevich,L,STL,29,82,21,34,55
14,8477503,Max Domi,C,TOR,29,82,15,40,55
14,8480018,Nick Suzuki,C,MTL,25,82,29,25,54
14,8478047,Michael Bunting,L,PIT,29,82,25,29,54
14,8478366,Frank Vatrano,R,ANA,30,82,31,22,53
14,8475794,Tyler Seguin,C,DAL,32,82,30,23,53
14,8477451,Ryan Hartman,R,MIN,30,82,27,26,53
14,8478856,Conor Garland,R,VAN,28,82,24,29,53
14,8482665,Matty Beniers,C,SEA,22,82,23,30,53
14,8478233,Andrew Mangiapane,L,CGY,28,82,22,31,53
14,8477951,Nick Schmaltz,C,ARI,28,82,19,34,53
14,8477940,Nikolaj Ehlers,L,WPG,28,82,18,35,53
14,8478873,Troy Terry,R,ANA,27,82,17,36,53
14,8479410,Mikhail Sergachev,D,TBL,26,82,8,45,53
14,8482699,Dylan Guenther,R,ARI,21,82,22,30,52
14,8479339,Patrik Laine,L,CBJ,26,82,21,31,52
14,8476483,Rickard Rakell,R,PIT,31,82,21,31,52
14,8479345,Jakob Chychrun,D,OTT,26,82,14,38,52
14,8481711,Matias Maccelli,L,ARI,24,82,14,38,52
14,8478407,Vince Dunn,D,SEA,28,82,12,40,52
14,8476456,Jonathan Huberdeau,C,CGY,31,82,10,42,52
14,8479325,Charlie McAvoy,D,BOS,27,82,8,44,52
14,8480064,Josh Norris,C,OTT,25,82,29,22,51
14,8475168,Matt Duchene,C,DAL,33,82,21,30,51
14,8477479,Tyler Bertuzzi,L,TOR,29,82,20,31,51
14,8483808,Andrei Kuzmenko,L,CGY,28,82,19,32,51
14,8473512,Claude Giroux,R,OTT,36,82,16,35,51
14,8478469,Thomas Chabot,D,OTT,27,82,16,35,51
14,8475784,Jeff Skinner,C,BUF,32,82,30,20,50
14,8478458,Jack Roslovic,C,NYR,27,82,16,34,50
14,8477346,MacKenzie Weegar,D,CGY,30,82,14,36,50
14,8475167,Victor Hedman,D,TBL,34,82,11,39,50
14,8480036,Miro Heiskanen,D,DAL,25,82,9,41,50
14,8475151,Kyle Palmieri,C,NYI,33,82,29,20,49
14,8477935,Sam Bennett,C,FLA,28,82,23,26,49
14,8480208,Drake Batherson,R,OTT,26,82,19,30,49
14,8476432,Boone Jenner,C,CBJ,31,82,19,30,49
14,8479425,Filip Hronek,D,VAN,27,82,14,35,49
14,8475169,Evander Kane,L,EDM,33,82,28,20,48
14,8475726,Tyler Toffoli,C,WPG,32,82,24,24,48
14,8482097,Jack Quinn,R,BUF,23,82,24,24,48
14,8478519,Anthony Cirelli,C,TBL,27,82,23,25,48
14,8478042,Viktor Arvidsson,R,LAK,31,82,20,28,48
14,8479675,Trevor Moore,L,LAK,29,82,19,29,48
14,8477496,Elias Lindholm,C,VAN,30,82,19,29,48
14,8480015,Owen Tippett,R,PHI,25,82,18,30,48
14,8477407,Anthony Duclair,L,TBL,29,82,18,30,48
14,8480865,Noah Dobson,D,NYI,24,82,11,37,48
14,8478462,Nicolas Roy,C,VGK,27,82,22,25,47
14,8478460,Zach Werenski,D,CBJ,27,82,14,33,47
14,8476329,Travis Boyd,C,ARI,31,82,14,33,47
14,8474150,Mikael Backlund,C,CGY,35,82,13,34,47
14,8478396,Noah Hanifin,D,VGK,27,82,12,35,47
14,8481656,Aliaksei Protas,C,WSH,23,82,12,35,47
14,8476875,Mike Matheson,D,MTL,30,82,11,36,47
14,8477495,Seth Jones,D,CHI,30,82,11,36,47
14,8474565,Alex Pietrangelo,D,VGK,34,82,7,40,47
14,8480014,Gabriel Vilardi,C,WPG,25,82,31,15,46
14,8484144,Connor Bedard,C,CHI,19,82,17,29,46
14,8476458,Ryan Strome,C,ANA,31,82,15,31,46
14,8475744,Evgeny Kuznetsov,C,CAR,32,82,13,33,46
14,8477494,Jonathan Drouin,L,COL,29,82,11,35,46
14,8482109,Alexis Lafrenière,L,NYR,23,82,30,15,45
14,8480188,Fabian Zetterlund,L,SJS,25,82,21,24,45
14,8477416,Oliver Bjorkstrand,R,SEA,29,82,19,26,45
14,8479400,Pierre-Luc Dubois,L,LAK,26,82,19,26,45
14,8475765,Vladimir Tarasenko,R,FLA,33,82,17,28,45
14,8480434,Sean Durzi,D,ARI,26,82,13,32,45
14,8471724,Kris Letang,D,PIT,37,82,9,36,45
14,8475287,Erik Haula,L,NJD,33,82,25,19,44
14,8474641,Adam Henrique,C,EDM,34,82,22,22,44
14,8474157,Max Pacioretty,L,WSH,36,82,20,24,44
14,8478466,Daniel Sprong,R,DET,27,82,18,26,44
14,8482110,Dawson Mercer,C,NJD,23,82,17,27,44
14,8478542,Evan Rodrigues,C,FLA,31,82,16,28,44
14,8482146,Luke Evangelista,R,NSH,22,82,16,28,44
14,8476826,Yanni Gourde,C,SEA,33,82,14,30,44
14,8470613,Brent Burns,D,CAR,39,82,12,32,44
14,8476906,Shayne Gostisbehere,D,DET,31,82,11,33,44
14,8481580,Connor McMichael,C,WSH,23,82,25,18,43
14,8477960,Adrian Kempe,R,LAK,28,82,22,21,43
14,8477511,Anthony Mantha,R,VGK,30,82,22,21,43
14,8480893,Kirill Marchenko,R,CBJ,24,82,22,21,43
14,8480039,Martin Necas,C,CAR,25,82,19,24,43
14,8477456,J.T. Compher,L,DET,29,82,19,24,43
14,8480078,Filip Chytil,C,NYR,25,82,19,24,43
14,8477497,Sean Monahan,C,WPG,30,82,18,25,43
14,8476292,Ondrej Palat,L,NJD,33,82,14,29,43
14,8482105,Jake Sanderson,D,OTT,22,82,11,32,43
14,8480031,Maxime Comtois,L,CAR,25,82,11,32,43
14,8483471,Brad Lambert,C,WPG,31,82,3,40,43
14,8482118,Sam Colangelo,R,ANA,23,82,31,11,42
14,8475798,Mikael Granlund,C,SJS,32,82,18,24,42
14,8481596,Shane Pinto,C,OTT,24,82,17,25,42
14,8481604,Pavel Dorofeyev,L,VGK,24,82,17,25,42
14,8480855,Jack McBain,C,ARI,24,82,16,26,42
14,8479999,Casey Mittelstadt,C,COL,26,82,15,27,42
14,8476479,Phillip Danault,C,LAK,31,82,15,27,42
14,8475722,Jason Zucker,L,NSH,32,82,15,27,42
14,8480817,K'Andre Miller,D,NYR,24,82,11,31,42
14,8483445,Cutter Gauthier,L,ANA,20,82,6,36,42
14,8476880,Tom Wilson,R,WSH,30,82,23,18,41
14,8478046,Danton Heinen,L,BOS,29,82,18,23,41
14,8476958,Jaccob Slavin,D,CAR,30,82,8,33,41
14,8482475,Yegor Chinakhov,R,CBJ,23,82,20,20,40
14,8482159,Tyson Foerster,R,PHI,22,82,19,21,40
14,8477330,Dominik Kubalik,L,OTT,29,82,19,21,40
14,8477998,Warren Foegele,L,EDM,28,82,18,22,40
14,8475170,Brayden Schenn,C,STL,33,82,15,25,40
14,8476392,Adam Lowry,C,WPG,31,82,14,26,40
14,8476882,Teuvo Teravainen,L,CAR,30,82,13,27,40
14,8471685,Anze Kopitar,C,LAK,37,82,10,30,40
14,8482720,Matthew Knies,L,TOR,22,82,9,31,40
14,8480145,Neal Pionk,D,WPG,29,82,8,32,40
14,8475314,Anders Lee,L,NYI,34,82,28,11,39
14,8482089,Jake Neighbours,L,STL,22,82,21,18,39
14,8474037,James van Riemsdyk,L,BOS,35,82,20,19,39
14,8481624,Ilya Mikheyev,R,VAN,30,82,19,20,39
14,8475793,Ryan Johansen,C,PHI,32,82,18,21,39
14,8476927,Teddy Blueger,C,VAN,30,82,18,21,39
14,8481533,Trevor Zegras,C,ANA,23,82,9,30,39
14,8476925,Colton Sissons,C,NSH,31,82,9,30,39
14,8481581,Thomas Harley,D,DAL,23,82,9,30,39
14,8474563,Drew Doughty,D,LAK,35,82,7,32,39
14,8477476,Artturi Lehkonen,L,COL,29,82,20,18,38
14,8471698,T.J. Oshie,R,WSH,38,82,19,19,38
14,8476438,Brandon Saad,L,STL,32,82,19,19,38
14,8480113,Alex Iafallo,L,WPG,31,82,19,19,38
14,8480009,Eeli Tolvanen,R,SEA,25,82,18,20,38
14,8482730,Brandt Clarke,D,LAK,21,82,17,21,38
14,8480849,Barrett Hayton,C,ARI,24,82,16,22,38
14,8473533,Jordan Staal,C,CAR,36,82,15,23,38
14,8482113,Anton Lundell,C,FLA,23,82,14,24,38
14,8482124,Quinton Byfield,R,LAK,22,82,12,26,38
14,8481013,Jonatan Berggren,R,DET,24,82,10,28,38
14,8475197,Tyson Barrie,D,NSH,33,82,6,32,38
14,8482702,Logan Stankoven,C,DAL,21,82,23,14,37
14,8475848,Brendan Gallagher,R,MTL,32,82,21,16,37
14,8480185,Eetu Luostarinen,C,FLA,26,82,19,18,37
14,8480028,Morgan Frost,C,PHI,25,82,18,19,37
14,8477426,Nicholas Paul,L,TBL,29,82,16,21,37
14,8479992,Michael Rasmussen,C,DET,25,82,16,21,37
14,8482222,Alexander Barabanov,L,SJS,30,82,15,22,37
14,8477964,Ivan Barbashev,C,VGK,29,82,14,23,37
14,8477948,Travis Sanheim,D,PHI,28,82,13,24,37
14,8476960,Andreas Athanasiou,C,CHI,30,82,13,24,37
14,8482624,Daniil Miromanov,D,CGY,27,82,12,25,37
14,8473563,Nicklas Backstrom,C,WSH,37,82,7,30,37
14,8474716,Jared Spurgeon,D,MIN,35,82,6,31,37
14,8481554,Kaapo Kakko,R,NYR,23,82,19,17,36
14,8475763,Kevin Hayes,R,STL,32,82,17,19,36
14,8478463,Anthony Beauvillier,L,NSH,27,82,16,20,36
14,8475791,Taylor Hall,L,CHI,33,82,15,21,36
14,8470621,Corey Perry,R,EDM,39,82,15,21,36
14,8477498,Darnell Nurse,D,EDM,29,82,12,24,36
14,8476792,Torey Krug,D,STL,33,82,10,26,36
14,8475764,Cam Fowler,D,ANA,33,82,9,27,36
14,8481699,Aku Raty,R,ARI,23,82,2,34,36
14,8475760,Nick Bjugstad,C,ARI,32,82,20,15,35
14,8482101,Danil Gushchin,L,SJS,22,82,19,16,35
14,8477947,Sonny Milano,L,WSH,28,82,15,20,35
14,8480797,Joel Farabee,L,PHI,24,82,14,21,35
14,8474586,Jordan Eberle,R,SEA,34,82,11,24,35
14,8482671,Owen Power,D,BUF,22,82,10,25,35
14,8477444,Andre Burakovsky,L,SEA,29,82,9,26,35
14,8480873,Rasmus Sandin,D,WSH,24,82,5,30,35
14,8483524,Shane Wright,C,SEA,20,82,23,11,34
14,8477944,Jakub Vrana,L,STL,28,82,19,15,34
14,8476469,Joel Armia,R,MTL,31,82,17,17,34
14,8475191,Reilly Smith,R,PIT,33,82,16,18,34
14,8474884,Mike Hoffman,C,SJS,35,82,15,19,34
14,8475768,Jaden Schwartz,C,SEA,32,82,14,20,34
14,8474053,Logan Couture,C,SJS,35,82,12,22,34
14,8476869,Brady Skjei,D,CAR,30,82,11,23,34
14,8474151,Ryan McDonagh,D,NSH,35,82,8,26,34
14,8475906,John Klingberg,D,TOR,32,82,3,31,34
14,8476879,Cody Ceci,D,EDM,31,82,3,31,34
14,8478474,Lawson Crouse,L,ARI,27,82,19,14,33
14,8470610,Zach Parise,L,COL,40,82,19,14,33
14,8481535,Nils Hoglander,L,VAN,24,82,16,17,33
14,8482079,Marco Rossi,C,MIN,23,82,15,18,33
14,8474870,Tyler Johnson,C,CHI,34,82,15,18,33
14,8475714,Calle Jarnkrok,C,TOR,33,82,13,20,33
14,8480802,Ryan McLeod,C,EDM,25,82,12,21,33
14,8476419,Jean-Gabriel Pageau,C,NYI,32,82,12,21,33
14,8481542,Moritz Seider,D,DET,23,82,8,25,33
14,8477932,Aaron Ekblad,D,FLA,28,82,8,25,33
14,8482733,Logan Mailloux,D,MTL,31,82,1,32,33
14,8478508,Yakov Trenin,C,COL,27,82,20,12,32
14,8481704,Juuso Parssinen,C,NSH,23,82,17,15,32
14,8482705,Cole Sillinger,C,CBJ,21,82,15,17,32
14,8483515,Juraj Slafkovsky,L,MTL,20,82,14,18,32
14,8477429,Andrew Copp,C,DET,30,82,13,19,32
14,8483431,Logan Cooley,C,ARI,20,82,12,20,32
14,8479353,Brett Howden,C,VGK,26,82,12,20,32
14,8478413,Jordan Greenway,L,BUF,27,82,11,21,32
14,8481703,Valtteri Puustinen,R,PIT,25,82,10,22,32
14,8477986,Brandon Montour,D,FLA,30,82,9,23,32
14,8477506,Ryan Pulock,D,NYI,30,82,8,24,32
14,8481537,Nikita Okhotiuk,D,CGY,24,82,8,24,32
14,8478055,Gustav Forsling,D,FLA,28,82,7,25,32
14,8478038,Devon Toews,D,COL,30,82,4,28,32
14,8476917,Adam Pelech,D,NYI,30,82,4,28,32
14,8478507,John Marino,D,NJD,27,82,3,29,32
14,8477952,Robby Fabbri,C,DET,28,82,18,13,31
14,8481186,Logan O'Connor,R,COL,28,82,18,13,31
14,8479661,Tanner Jeannot,L,TBL,27,82,16,15,31
14,8481618,Alex Newhook,C,MTL,23,82,15,16,31
14,8479987,Morgan Geekie,C,BOS,26,82,14,17,31
14,8478109,Victor Olofsson,L,BUF,29,82,14,17,31
14,8476480,Vladislav Namestnikov,C,WPG,32,82,13,18,31
14,8482074,Connor Zary,C,CGY,23,82,12,19,31
14,8473422,Nick Foligno,L,CHI,37,82,11,20,31
14,8478133,Jake Evans,C,MTL,28,82,10,21,31
14,8482133,Thomas Bordeleau,C,SJS,22,82,7,24,31
14,8476979,Erik Gustafsson,D,NYR,32,82,2,29,31
14,8477969,Marcus Pettersson,D,PIT,28,82,2,29,31
14,8479423,Alex Nylander,L,CBJ,26,82,16,14,30
14,8478891,Mason Appleton,C,WPG,28,82,16,14,30
14,8482055,Drew O'Connor,L,PIT,26,82,15,15,30
14,8471218,Blake Wheeler,R,NYR,38,82,11,19,30
14,8475753,Justin Faulk,D,STL,32,82,7,23,30
14,8476422,Mike Reilly,D,NYI,31,82,6,24,30
14,8481568,Alex Vlasic,D,CHI,23,82,4,26,30
14,8476892,Colton Parayko,D,STL,31,82,3,27,30
14,8483397,Marc McLaughlin,C,BOS,25,82,25,4,29
14,8480459,Pius Suter,C,VAN,28,82,16,13,29
14,8479365,Trent Frederic,C,BOS,26,82,16,13,29
14,8482175,JJ Peterka,R,BUF,22,82,13,16,29
14,8475343,Nic Dowd,C,WSH,34,82,11,18,29
14,8475220,Marcus Foligno,L,MIN,33,82,9,20,29
14,8480871,Adam Boqvist,D,CBJ,24,82,5,24,29
14,8476923,Damon Severson,D,CBJ,30,82,3,26,29
14,8474013,Ian Cole,D,VAN,35,82,3,26,29
14,8481093,Rafael Harvey-Pinard,L,MTL,25,82,19,9,28
14,8478057,Dakota Joshua,C,VAN,28,82,17,11,28
14,8478115,Pierre Engvall,L,NYI,28,82,15,13,28
14,8476871,Tanner Pearson,L,MTL,32,82,12,16,28
14,8477021,Alex Kerfoot,C,ARI,30,82,11,17,28
14,8476872,Scott Laughton,C,PHI,30,82,9,19,28
14,8476873,Mark Jankowski,C,NSH,30,82,9,19,28
14,8484153,Leo Carlsson,C,ANA,20,82,9,19,28
14,8478472,Mathieu Joseph,R,OTT,27,82,7,21,28
14,8480220,Noah Cates,L,PHI,25,82,7,21,28
14,8482117,Lukas Reichel,L,CHI,22,82,7,21,28
14,8476467,Jamie Oleksiak,D,SEA,32,82,6,22,28
14,8476854,Hampus Lindholm,D,BOS,30,82,4,24,28
14,8481560,Arthur Kaliyev,R,LAK,23,82,14,13,27
14,8481028,Martin Pospisil,C,CGY,25,82,14,13,27
14,8480074,Alexandre Texier,C,CBJ,25,82,14,13,27
14,8473449,Kyle Okposo,R,FLA,36,82,13,14,27
14,8480813,Joe Veleno,C,DET,24,82,12,15,27
14,8480058,Pierre-Olivier Joseph,D,PIT,25,82,11,16,27
14,8477953,Kasperi Kapanen,R,STL,28,82,10,17,27
14,8476374,Sean Kuraly,C,CBJ,31,82,10,17,27
14,8476981,Josh Anderson,R,MTL,30,82,9,18,27
14,8475790,Erik Gudbranson,D,CBJ,32,82,9,18,27
14,8479976,Juuso Valimaki,D,ARI,26,82,8,19,27
14,8481546,Cam York,D,PHI,23,82,7,20,27
14,8480043,Timothy Liljegren,D,TOR,25,82,5,22,27
14,8478500,Ivan Provorov,D,CBJ,27,82,5,22,27
14,8481016,Ruslan Iskhakov,C,NYI,24,82,2,25,27
14,8480807,Mattias Samuelsson,D,BUF,24,82,2,25,27
14,8484203,Bradly Nadeau,L,CAR,19,82,20,6,26
14,8470604,Jeff Carter,C,PIT,39,82,15,11,26
14,8479591,Michael Eyssimont,C,TBL,28,82,15,11,26
14,8479525,Ross Colton,C,COL,28,82,14,12,26
14,8479977,Kailer Yamamoto,R,SEA,26,82,14,12,26
14,8477450,Jason Dickinson,C,CHI,29,82,13,13,26
14,8475799,Nino Niederreiter,R,WPG,32,82,11,15,26
14,8481524,Bowen Byram,D,BUF,23,82,8,18,26
14,8482245,Artem Zub,D,OTT,29,82,8,18,26
14,8478851,Alexandre Carrier,D,NSH,28,82,7,19,26
14,8475171,Oliver Ekman-Larsson,D,FLA,33,82,7,19,26
14,8475200,Dmitry Orlov,D,CAR,33,82,4,22,26
14,8475218,Mattias Ekholm,D,EDM,34,82,2,24,26
14,8479393,Noah Gregor,C,TOR,26,82,16,9,25
14,8479316,Luke Kunin,C,SJS,27,82,15,10,25
14,8483491,Ivan Miroshnichenko,L,WSH,20,82,13,12,25
14,8478020,Michael Amadio,C,VGK,28,82,13,12,25
14,8477989,Christian Dvorak,C,MTL,28,82,11,14,25
14,8482062,Cole Smith,L,NSH,29,82,9,16,25
14,8479351,Sam Steel,C,DAL,26,82,8,17,25
14,8476429,Scott Mayfield,D,NYI,32,82,8,17,25
14,8480336,Sean Walker,D,COL,30,82,7,18,25
14,8477931,Tomas Nosek,L,NJD,32,82,7,18,25
14,8479371,Dante Fabbro,D,NSH,26,82,7,18,25
14,8479983,Mario Ferraro,D,SJS,26,82,6,19,25
14,8481606,Jordan Spence,D,LAK,23,82,5,20,25
14,8475188,Brayden McNabb,D,VGK,33,82,4,21,25
14,8476902,Esa Lindell,D,DAL,30,82,3,22,25
14,8482259,Bobby McMann,C,TOR,28,82,17,7,24
14,8479996,Cody Glass,C,NSH,25,82,14,10,24
14,8480821,Filip Zadina,R,SJS,25,82,14,10,24
14,8474149,Evgenii Dadonov,R,DAL,35,82,13,11,24
14,8482125,Alexander Holtz,R,NJD,22,82,12,12,24
14,8479390,Taylor Raddysh,R,CHI,26,82,12,12,24
14,8484166,Adam Fantilli,C,CBJ,20,82,11,13,24
14,8479293,Brandon Tanev,L,SEA,33,82,11,13,24
14,8476461,Sean Couturier,C,PHI,32,82,10,14,24
14,8475279,Ben Chiarot,D,DET,33,82,10,14,24
14,8477425,Miles Wood,L,COL,29,82,7,17,24
14,8476885,Jacob Trouba,D,NYR,30,82,7,17,24
14,8477839,Conor Sheary,L,TBL,32,82,7,17,24
14,8476931,Jake McCabe,D,TOR,31,82,5,19,24
14,8483457,Lane Hutson,D,MTL,20,82,3,21,24
14,8482142,Jamie Drysdale,D,PHI,22,82,3,21,24
14,8481567,Henry Thrun,D,SJS,23,82,3,21,24
14,8479980,Nicolas Hague,D,VGK,26,82,3,21,24
14,8477435,Ryan Graves,D,PIT,29,82,2,22,24
14,8480448,Parker Kelly,L,OTT,25,82,14,9,23
14,8483499,Liam Ohgren,L,MIN,20,82,12,11,23
14,8480068,Ryan Poehling,C,PHI,25,82,10,13,23
14,8475149,Marcus Johansson,L,MIN,34,82,8,15,23
14,8476312,Josh Manson,D,COL,33,82,7,16,23
14,8476457,Adam Larsson,D,SEA,32,82,7,16,23
14,8477220,Nate Schmidt,D,WPG,33,82,6,17,23
14,8477507,Nikita Zadorov,D,VAN,29,82,6,17,23
14,8481481,Blake Lizotte,C,LAK,27,82,5,18,23
14,8476967,Brett Kulak,D,EDM,30,82,5,18,23
14,8476463,Jonas Brodin,D,MIN,31,82,4,19,23
14,8480035,Henri Jokiharju,D,BUF,25,82,4,19,23
14,8481014,Alexander Romanov,D,NYI,24,82,4,19,23
14,8474574,Tyler Myers,D,VAN,34,82,3,20,23
14,8480860,Kevin Bahl,D,NJD,24,82,3,20,23
14,8482516,Matthew Kessel,D,STL,24,82,3,20,23
14,8480246,Nick Perbix,D,TBL,26,82,2,21,23
14,8482122,Brock Faber,D,MIN,22,82,1,22,23
14,8475231,Casey Cizikas,C,NYI,33,82,12,10,22
14,8482737,Zack Bolduc,C,STL,21,82,11,11,22
14,8481477,Nico Sturm,C,SJS,29,82,11,11,22
14,8482092,Ridly Greig,C,OTT,22,82,9,13,22
14,8479415,Michael McLeod,C,NJD,26,82,9,13,22
14,8479359,Beck Malenstyn,L,WSH,26,82,9,13,22
14,8477353,Tyler Motte,C,TBL,29,82,9,13,22
14,8482655,J.J. Moser,D,ARI,24,82,7,15,22
14,8482166,Shakir Mukhamadullin,D,SJS,22,82,4,18,22
14,8482087,Kaiden Guhle,D,MTL,22,82,3,19,22
14,8478840,Will Borgen,D,SEA,28,82,3,19,22
14,8475324,Nick Jensen,D,WSH,34,82,3,19,22
14,8474673,TJ Brodie,D,TOR,34,82,1,21,22
14,8483493,Frank Nazar,C,CHI,20,82,16,5,21
14,8480806,Isac Lundestrom,C,ANA,25,82,11,10,21
14,8479941,Justin Danforth,R,CBJ,31,82,11,10,21
14,8478043,Sam Lafferty,C,VAN,29,82,10,11,21
14,8479383,Boris Katchouk,L,OTT,26,82,10,11,21
14,8482111,Justin Barron,D,MTL,23,82,9,12,21
14,8474009,Nick Bonino,C,NYR,36,82,9,12,21
14,8478569,Noel Acciari,C,PIT,33,82,9,12,21
14,8476921,Jordan Martinook,L,CAR,32,82,8,13,21
14,8477015,Connor Brown,R,EDM,30,82,8,13,21
14,8478911,Matt Roy,D,LAK,29,82,7,14,21
14,8478430,Oliver Kylington,D,CGY,27,82,7,14,21
14,8477369,Carson Soucy,D,VAN,30,82,7,14,21
14,8476891,Matt Grzelcyk,D,BOS,30,82,5,16,21
14,8480796,Martin Fehervary,D,WSH,25,82,5,16,21
14,8481178,Egor Zamula,D,PHI,24,82,4,17,21
14,8483490,Pavel Mintyukov,D,ANA,21,82,4,17,21
14,8476331,Dylan DeMelo,D,WPG,31,82,3,18,21
14,8475181,Nick Leddy,D,STL,33,82,2,19,21
14,8481517,Brett Leason,R,ANA,25,82,13,7,20
14,8479346,Dillon Dube,C,CGY,26,82,11,9,20
14,8474189,Lars Eller,C,PIT,35,82,8,12,20
14,8474715,Cam Atkinson,R,PHI,35,82,8,12,20
14,8477508,Curtis Lazar,C,NJD,29,82,8,12,20
14,8484145,Zach Benson,L,BUF,19,82,8,12,20
14,8482803,Olen Zellweger,D,ANA,21,82,7,13,20
14,8483505,Matthew Poitras,C,BOS,20,82,7,13,20
14,8481522,Peyton Krebs,C,BUF,23,82,4,16,20
14,8479398,Samuel Girard,D,COL,26,82,4,16,20
14,8478882,Vladislav Gavrikov,D,LAK,29,82,3,17,20
14,8474166,Alec Martinez,D,VGK,37,82,3,17,20
14,8482145,Mavrik Bourque,C,DAL,22,82,14,5,19
14,8482155,Alex Laferriere,R,LAK,23,82,11,8,19
14,8482679,Matt Coronato,R,CGY,22,82,10,9,19
14,8479514,Rem Pitlick,C,CHI,27,82,8,11,19
14,8476624,Barclay Goodrow,C,NYR,31,82,7,12,19
14,8478178,Darren Raddysh,D,TBL,28,82,7,12,19
14,8475842,Sam Carrick,C,EDM,32,82,6,13,19
14,8477488,Brett Pesce,D,CAR,30,82,5,14,19
14,8475462,Radko Gudas,D,ANA,34,82,4,15,19
14,8476525,Colin Miller,D,WPG,32,82,4,15,19
14,8477365,Connor Clifton,D,BUF,29,82,1,18,19
14,8475690,Chris Tanev,D,DAL,35,82,1,18,19
14,8477392,Hudson Fasching,R,NYI,29,82,10,8,18
14,8478013,Jake Walman,D,DET,28,82,8,10,18
14,8480144,David Kampf,C,TOR,29,82,7,11,18
14,8483482,Tristan Luneau,D,ANA,20,82,7,11,18
14,8483565,Nick Blankenburg,D,CBJ,26,82,7,11,18
14,8477406,Mattias Janmark,C,EDM,32,82,6,12,18
14,8483495,Simon Nemec,D,NJD,20,82,5,13,18
14,8479369,Andrew Peeke,D,BOS,26,82,4,14,18
14,8482712,Oskar Olausson,R,COL,22,82,3,15,18
14,8482809,Jackson Blake,R,CAR,21,82,10,7,17
14,8477919,Frederick Gaudreau,C,MIN,31,82,9,8,17
14,8480281,Alexey Toropchenko,R,STL,25,82,9,8,17
14,8476858,Phillip Di Giuseppe,L,VAN,31,82,6,11,17
14,8470966,Mark Giordano,D,TOR,41,82,6,11,17
14,8475164,Jakob Silfverberg,R,ANA,34,82,5,12,17
14,8482762,Simon Edvinsson,D,DET,21,82,5,12,17
14,8478451,Ethan Bear,D,WSH,27,82,4,13,17
14,8477845,Trevor van Riemsdyk,D,WSH,33,82,4,13,17
14,8477335,Kyle Burroughs,D,SJS,29,82,4,13,17
14,8482470,Ilya Solovyov,D,CGY,24,82,3,14,17
14,8475233,David Savard,D,MTL,34,82,2,15,17
14,8480834,Ty Emberson,D,SJS,24,82,1,16,17
14,8483466,Kevin Korchinski,D,CHI,20,82,8,8,16
14,8473453,Trevor Lewis,C,LAK,37,82,7,9,16
14,8478408,Travis Dermott,D,ARI,28,82,7,9,16
14,8478468,Jeremy Lauzon,D,NSH,27,82,5,11,16
14,8474034,Pat Maroon,L,BOS,36,82,5,11,16
14,8481605,Jackson LaCombe,D,ANA,23,82,5,11,16
14,8476897,Oskar Sundqvist,C,STL,30,82,4,12,16
14,8475455,Brenden Dillon,D,WPG,34,82,4,12,16
14,8476442,Matt Nieto,L,PIT,32,82,4,12,16
14,8478859,Niko Mikkola,D,FLA,28,82,3,13,16
14,8478416,Erik Cernak,D,TBL,27,82,2,14,16
14,8470600,Ryan Suter,D,DAL,39,82,1,15,16
14,8481553,Bobby Brink,R,PHI,23,82,8,7,15
14,8482666,Scott Morrow,D,CAR,22,82,7,8,15
14,8478831,Kevin Stenlund,C,FLA,28,82,5,10,15
14,8480879,Jacob Bernard-Docker,D,OTT,24,82,4,11,15
14,8482073,Braden Schneider,D,NYR,23,82,4,11,15
14,8478399,Jonas Siegenthaler,D,NJD,27,82,4,11,15
14,8473504,Cal Clutterbuck,R,NYI,37,82,3,12,15
14,8482858,Ryker Evans,D,SEA,23,82,3,12,15
14,8477034,Jaycob Megna,D,CHI,32,82,2,13,15
14,8473507,Jeff Petry,D,DET,37,82,1,14,15
14,8477505,Alexander Wennberg,C,NYR,30,82,0,15,15
14,8475208,Brian Dumoulin,D,SEA,33,82,0,15,15
14,8479291,Kevin Rooney,C,CGY,31,82,9,5,14
14,8476878,Zemgus Girgensons,L,BUF,30,82,6,8,14
14,8480073,Erik Brannstrom,D,OTT,25,82,3,11,14
14,8478136,Jake Middleton,D,MIN,28,82,3,11,14
14,8477499,Rasmus Ristolainen,D,PHI,30,82,2,12,14
14,8476278,Colin Blackwell,C,CHI,31,82,8,5,13
14,8481601,Simon Holmstrom,R,NYI,23,82,5,8,13
14,8481578,Graeme Clarke,R,NJD,23,82,4,9,13
14,8484911,Collin Graf,R,SJS,22,82,1,12,13
14,8480980,Connor Dewar,C,TOR,25,82,6,6,12
14,8482177,Marat Khusnutdinov,C,MIN,22,82,6,6,12
14,8483763,Maksymilian Szuber,D,ARI,22,82,5,7,12
14,8482807,Ethan Del Mastro,D,CHI,21,82,4,8,12
14,8481059,Scott Perunovich,D,STL,26,82,2,10,12
14,8479442,Troy Stecher,D,EDM,30,82,1,11,12
14,8475825,Jani Hakanpää,D,DAL,32,82,0,12,12
14,8483489,Fraser Minten,C,TOR,31,82,4,7,11
14,8483012,Logan Morrison,C,SEA,22,82,6,4,10
14,8479324,Ryan Lindgren,D,NYR,26,82,4,6,10
14,8480172,Jan Rutta,D,SJS,34,82,2,8,10
14,8478443,Brandon Carlo,D,BOS,28,82,2,8,10
14,8476473,Connor Murphy,D,CHI,31,82,1,9,10
14,8481599,Victor Soderstrom,D,ARI,23,82,5,4,9
14,8479998,Mikey Anderson,D,LAK,25,82,4,5,9
14,8482713,Mackie Samoskevich,R,FLA,22,82,4,5,9
14,8475177,Calvin de Haan,D,TBL,33,82,3,6,9
14,8471677,Jack Johnson,D,COL,37,82,3,6,9
14,8475179,Dmitry Kulikov,D,FLA,34,82,2,7,9
14,8481030,Jack St. Ivany,D,PIT,25,82,2,7,9
14,8475762,Derek Forbort,D,BOS,32,82,0,9,9
14,8476822,Luke Glendening,C,TBL,35,82,8,0,8
14,8480990,Declan Chisholm,D,MIN,24,82,4,4,8
14,8476372,Nick Seeler,D,PHI,31,82,3,5,8
14,8483468,Jiri Kulich,C,BUF,20,82,1,7,8
14,8476915,Jujhar Khaira,L,MIN,30,82,5,2,7
14,8474567,Zach Bogosian,D,MIN,34,82,0,6,6
14,8484149,Gavin Brindley,C,CBJ,20,82,1,4,5
14,8482859,Zack Ostapchuk,C,OTT,21,82,0,4,4
14,8482141,Lukas Cormier,D,VGK,22,0,0,0,0
14,8476988,Matt Benning,D,SJS,30,0,0,0,0
14,8480727,Zach Whitecloud,D,VGK,28,0,0,0,0
14,8480887,Jordan Harris,D,MTL,24,0,0,0,0
14,8478450,Parker Wotherspoon,D,BOS,27,0,0,0,0
14,8481812,Nikolai Knyzhov,D,SJS,27,0,0,0,0
14,8480001,Urho Vaakanainen,D,ANA,25,0,0,0,0
14,8482176,Wyatt Kaiser,D,CHI,22,0,0,0,0
14,8481122,Simon Benoit,D,TOR,26,0,0,0,0
14,8476441,Joel Edmundson,D,TOR,31,0,0,0,0
14,8480884,Calen Addison,D,SJS,24,0,0,0,0
14,8482511,Mason Lohrei,D,BOS,23,0,0,0,0
14,8482192,Isaak Phillips,D,CHI,23,0,0,0,0
14,8480950,Ilya Lyubushkin,D,TOR,30,0,0,0,0
14,8474031,Kevin Shattenkirk,D,BOS,35,0,0,0,0
14,8475718,Justin Holl,D,DET,32,0,0,0,0
14,8479402,Jake Bean,D,CBJ,26,0,0,0,0
14,8474602,Justin Schultz,D,SEA,34,0,0,0,0
14,8477950,Tony DeAngelo,D,CAR,29,0,0,0,0
14,8481743,Marc Del Gaizo,D,NSH,25,0,0,0,0
14,8481527,Kaedan Korczak,D,VGK,23,0,0,0,0
14,8480192,Johnathan Kovacevic,D,MTL,27,0,0,0,0
14,8476874,Olli Maatta,D,DET,30,0,0,0,0
14,8482144,Jack Thompson,D,SJS,22,0,0,0,0
14,8480222,Sebastian Aho,D,NYI,28,0,0,0,0
14,8479458,Nikita Zaitsev,D,CHI,33,0,0,0,0
14,8471709,Marc-Edouard Vlasic,D,SJS,37,0,0,0,0
14,8482929,Emil Lilleberg,D,TBL,23,0,0,0,0
14,8477018,Ben Hutton,D,VGK,31,0,0,0,0
14,8481056,Spencer Stastney,D,NSH,24,0,0,0,0
14,8481593,Jayden Struble,D,MTL,23,0,0,0,0
14,8479982,Conor Timmins,D,TOR,26,0,0,0,0
14,8474090,Brendan Smith,D,NJD,35,0,0,0,0
14,8482964,Arber Xhekaj,D,MTL,23,0,0,0,0
14,8480891,Michael Kesselring,D,ARI,24,0,0,0,0
14,8477938,Haydn Fleury,D,TBL,28,0,0,0,0
14,8481806,Louis Crevier,D,CHI,23,0,0,0,0
14,8471274,Alex Goligoski,D,MIN,39,0,0,0,0
14,8481600,Tobias Bjornfot,D,FLA,23,0,0,0,0
14,8475797,Jarred Tinordi,D,CHI,32,0,0,0,0
14,8481521,Ronnie Attard,D,PHI,25,0,0,0,0
14,8474612,Travis Hamonic,D,OTT,34,0,0,0,0
14,8479576,Vincent Desharnais,D,EDM,28,0,0,0,0
14,8480049,Dylan Samberg,D,WPG,25,0,0,0,0
14,8483619,Filip Roos,D,CHI,25,0,0,0,0
14,8474568,Luke Schenn,D,NSH,35,0,0,0,0
14,8480184,Gustav Lindstrom,D,ANA,26,0,0,0,0
14,8480070,Ian Mitchell,D,BOS,25,0,0,0,0
14,8480196,Jacob Bryson,D,BUF,27,0,0,0,0
14,8471686,Marc Staal,D,PHI,37,0,0,0,0
14,8477467,Gustav Olofsson,D,SEA,30,0,0,0,0
14,8478970,Jalen Chatfield,D,CAR,28,0,0,0,0
14,8479348,Kale Clague,D,BUF,26,0,0,0,0
14,8473446,Erik Johnson,D,PHI,36,0,0,0,0
14,8477462,Robert Hagg,D,ANA,29,0,0,0,0
14,8478454,Noah Juulsen,D,VAN,27,0,0,0,0
14,8477384,Josh Brown,D,ARI,30,0,0,0,0
14,8481708,Zac Jones,D,NYR,24,0,0,0,0
14,8481167,Brayden Pachal,D,CGY,25,0,0,0,0
14,8482067,Connor Mackey,D,NYR,28,0,0,0,0
14,8483460,David Jiricek,D,CBJ,21,0,0,0,0
14,8481701,Santeri Hatakka,D,NJD,23,0,0,0,0
14,8478021,William Lagesson,D,ANA,28,0,0,0,0
14,8477851,Jordan Oesterle,D,CGY,32,0,0,0,0
14,8478452,Caleb Jones,D,COL,27,0,0,0,0
14,8479984,Cal Foote,D,NJD,26,0,0,0,0
14,8479639,Dylan Coghlan,D,CAR,26,0,0,0,0
14,8480874,Adam Ginning,D,PHI,24,0,0,0,0
14,8479321,Lucas Johansen,D,WSH,27,0,0,0,0
14,8480878,Nils Lundkvist,D,DAL,24,0,0,0,0
14,8482165,Yan Kuznetsov,D,CGY,22,0,0,0,0
14,8484258,Sam Malinski,D,COL,26,0,0,0,0
14,8480157,Calle Rosen,D,STL,30,0,0,0,0
14,8484304,Uvis Balinskis,D,FLA,28,0,0,0,0
14,8479985,Cale Fleury,D,SEA,26,0,0,0,0
14,8479378,Logan Stanley,D,WPG,26,0,0,0,0
14,8477541,Dakota Mermis,D,MIN,30,0,0,0,0
14,8481609,Vladislav Kolyachonok,D,ARI,23,0,0,0,0
14,8480823,Alexander Alexeyev,D,WSH,25,0,0,0,0
14,8481679,Maxence Guenette,D,OTT,23,0,0,0,0
14,8481564,Ryan Johnson,D,BUF,23,0,0,0,0
14,8479376,Victor Mete,D,PHI,26,0,0,0,0
14,8484254,Akito Hirose,D,VAN,25,0,0,0,0
14,8482660,Kent Johnson,C,CBJ,22,0,0,0,0
14,8482149,Cole Perfetti,C,WPG,22,0,0,0,0
14,8477987,Ryan Donato,C,CHI,28,0,0,0,0
14,8475755,Alexander Petrovic,D,DAL,32,0,0,0,0
14,8477810,Joel Hanley,D,CGY,33,0,0,0,0
14,8474145,Robert Bortuzzo,D,NYI,35,0,0,0,0
14,8481161,Jake Christiansen,D,CBJ,25,0,0,0,0
14,8476884,Derrick Pouliot,D,DAL,30,0,0,0,0
14,8481716,Dmitri Voronkov,L,CBJ,24,0,0,0,0
14,8480084,Nick DeSimone,D,NJD,30,0,0,0,0
14,8475750,Jon Merrill,D,MIN,32,0,0,0,0
14,8479315,Joey Anderson,R,CHI,26,0,0,0,0
14,8478011,Louie Belpedio,D,PHI,28,0,0,0,0
14,8482451,Mikael Pyyhtia,L,CBJ,23,0,0,0,0
14,8481541,Samuel Bolduc,D,NYI,24,0,0,0,0
14,8482126,Emil Andrae,D,PHI,31,0,0,0,0
14,8474618,Marco Scandella,D,STL,34,0,0,0,0
14,8477244,Chad Ruhwedel,D,NYR,34,0,0,0,0
14,8477971,Andreas Englund,D,LAK,28,0,0,0,0
14,8480829,Jesperi Kotkaniemi,C,CAR,24,0,0,0,0
14,8479372,Josh Mahura,D,FLA,26,0,0,0,0
14,8482095,Tyler Kleven,D,OTT,22,0,0,0,0
14,8481719,Maxwell Crozier,D,TBL,24,0,0,0,0
14,8475855,Jesper Fast,R,CAR,33,0,0,0,0
14,8480848,Ty Dellandrea,C,DAL,24,0,0,0,0
14,8475193,Tomas Tatar,L,SEA,34,0,0,0,0
14,8476889,Radek Faksa,C,DAL,30,0,0,0,0
14,8478495,Denis Gurianov,R,PHI,27,0,0,0,0
14,8480216,Jacob Peterson,C,SJS,25,0,0,0,0
14,8480252,Cole Guttman,C,CHI,25,0,0,0,0
14,8479026,Philippe Myers,D,TBL,27,0,0,0,0
14,8481006,Tyler Tucker,D,STL,24,0,0,0,0
14,8481032,Paul Cotter,C,VGK,25,0,0,0,0
14,8481577,Philip Tomasino,C,NSH,23,0,0,0,0
14,8476918,Jimmy Vesey,L,NYR,31,0,0,0,0
14,8479320,Max Lajoie,D,TOR,27,0,0,0,0
14,8478017,Mark Friedman,D,VAN,29,0,0,0,0
14,8481754,Nikita Nesterenko,C,ANA,23,0,0,0,0
14,8483407,Brandon Scanlin,D,NYR,25,0,0,0,0
14,8482659,Josh Doan,R,ARI,22,0,0,0,0
14,8477446,Michael McCarron,R,NSH,29,0,0,0,0
14,8477903,Garnet Hathaway,R,PHI,33,0,0,0,0
14,8482153,Brendan Brisson,C,VGK,23,0,0,0,0
14,8483546,Marshall Rifai,D,TOR,26,0,0,0,0
14,8484287,Cole McWard,D,VAN,23,0,0,0,0
14,8478854,Ryan Shea,D,PIT,27,0,0,0,0
14,8481585,Egor Afanasyev,L,NSH,23,0,0,0,0
14,8483398,Declan Carlile,D,TBL,31,0,0,0,0
14,8478502,Dennis Gilbert,D,CGY,28,0,0,0,0
14,8482749,Joshua Roy,R,MTL,21,0,0,0,0
14,8481598,Philip Broberg,D,EDM,23,0,0,0,0
14,8480835,Jack Drury,C,CAR,24,0,0,0,0
14,8480748,Kiefer Sherwood,L,NSH,29,0,0,0,0
14,8476934,Brock McGinn,L,ANA,30,0,0,0,0
14,8480870,Bo Groulx,C,ANA,24,0,0,0,0
14,8479368,Max Jones,L,ANA,26,0,0,0,0
14,8478099,Kevin Labanc,R,SJS,29,0,0,0,0
14,8478067,Oskar Lindblom,L,SJS,28,0,0,0,0
14,8476393,Nick Cousins,C,FLA,31,0,0,0,0
14,8483395,Arshdeep Bains,L,VAN,23,0,0,0,0
14,8480762,Eric Robinson,L,BUF,29,0,0,0,0
14,8479439,Jacob MacDonald,D,SJS,31,0,0,0,0
14,8476474,Stefan Noesen,R,CAR,31,0,0,0,0
14,8482787,Nikita Chibrikov,R,WPG,31,0,0,0,0
14,8478432,Christian Fischer,R,DET,27,0,0,0,0
14,8477979,Nicolas Aube-Kubel,R,WSH,28,0,0,0,0
14,8481789,Tye Kartye,L,SEA,23,0,0,0,0
14,8479330,Brandon Gignac,C,MTL,27,0,0,0,0
14,8480075,Cameron Crotty,D,ARI,25,0,0,0,0
14,8473473,Milan Lucic,L,BOS,36,0,0,0,0
14,8482094,Daemon Hunt,D,MIN,22,0,0,0,0
14,8481206,John Ludvig,D,PIT,24,0,0,0,0
14,8483630,Pavol Regenda,L,ANA,25,0,0,0,0
14,8481617,Vasily Podkolzin,R,VAN,23,0,0,0,0
14,8480306,Grant Hutton,D,NYI,29,0,0,0,0
14,8480995,Pontus Holmberg,R,TOR,25,0,0,0,0
14,8482148,Hendrix Lapierre,C,WSH,22,0,0,0,0
14,8477478,William Carrier,L,VGK,30,0,0,0,0
14,8480003,Jesper Boqvist,C,BOS,26,0,0,0,0
14,8482172,Landon Slaggert,L,CHI,22,0,0,0,0
14,8480789,Oliver Wahlstrom,R,NYI,24,0,0,0,0
14,8474062,Riley Nash,C,NYR,35,0,0,0,0
14,8480021,Jack Studnicka,C,SJS,25,0,0,0,0
14,8480025,MacKenzie Entwistle,R,CHI,25,0,0,0,0
14,8481582,Nicholas Robertson,L,TOR,23,0,0,0,0
14,8476867,Brendan Gaunce,C,CBJ,30,0,0,0,0
14,8479619,Michael Carcone,L,ARI,28,0,0,0,0
14,8479370,Tyson Jost,C,BUF,26,0,0,0,0
14,8479671,Mathieu Olivier,R,CBJ,27,0,0,0,0
14,8476994,Vinnie Hinostroza,C,PIT,30,0,0,0,0
14,8482070,Mitchell Chaffee,R,TBL,26,0,0,0,0
14,8477473,Justin Bailey,R,SJS,29,0,0,0,0
14,8479344,Jesse Puljujarvi,R,PIT,26,0,0,0,0
14,8480205,Emil Bemstrom,C,PIT,25,0,0,0,0
14,8479718,Alex Barré-Boulet,C,TBL,27,0,0,0,0
14,8482061,Brandon Biro,L,BUF,26,0,0,0,0
14,8479638,Justin Brazeau,R,BOS,26,0,0,0,0
14,8474040,Sam Gagner,C,EDM,35,0,0,0,0
14,8477846,Ryan Carpenter,C,SJS,33,0,0,0,0
14,8482077,Dylan Holloway,L,EDM,23,0,0,0,0
14,8482157,Will Cuylle,L,NYR,22,0,0,0,0
14,8480007,Jonas Rondbjerg,R,VGK,25,0,0,0,0
14,8478874,Adam Gaudette,C,STL,28,0,0,0,0
14,8478434,Keegan Kolesar,R,VGK,27,0,0,0,0
14,8480441,Trey Fix-Wolansky,R,CBJ,25,0,0,0,0
14,8479994,Jaret Anderson-Dolan,C,NSH,25,0,0,0,0
14,8483567,Georgii Merkulov,C,BOS,24,0,0,0,0
14,8477380,Jonny Brodzinski,C,NYR,31,0,0,0,0
14,8482201,Gage Goncalves,C,TBL,23,0,0,0,0
14,8478211,Dryden Hunt,L,CGY,29,0,0,0,0
14,8471699,Andrew Cogliano,C,COL,37,0,0,0,0
14,8479421,Jacob Moverare,D,LAK,26,0,0,0,0
14,8478881,Brett Seney,L,CHI,28,0,0,0,0
14,8477464,Nic Petan,C,MIN,29,0,0,0,0
14,8475958,Michael Sgarbossa,C,WSH,32,0,0,0,0
14,8481147,Reese Johnson,C,CHI,26,0,0,0,0
14,8479336,Carl Grundstrom,R,LAK,27,0,0,0,0
14,8480853,Liam Foudy,C,NSH,24,0,0,0,0
14,8479522,Hardy Haman Aktell,D,WSH,26,0,0,0,0
14,8481462,Mason Morelli,L,VGK,28,0,0,0,0
14,8482102,Vasily Ponomarev,C,CAR,22,0,0,0,0
14,8480844,Grigori Denisenko,L,VGK,24,0,0,0,0
14,8479944,Zach Aston-Reese,C,DET,30,0,0,0,0
14,8482784,Zach Dean,C,STL,21,0,0,0,0
14,8479419,Brett Murray,L,BUF,26,0,0,0,0
14,8479520,Brandon Duhaime,R,COL,27,0,0,0,0
14,8477573,Nathan Walker,L,STL,30,0,0,0,0
14,8478078,Rourke Chartier,C,OTT,28,0,0,0,0
14,8475795,Dylan McIlrath,D,WSH,32,0,0,0,0
14,8482496,Nils Aman,C,VAN,24,0,0,0,0
14,8480289,Morgan Barron,C,WPG,26,0,0,0,0
14,8481751,Lukas Rousek,R,BUF,25,0,0,0,0
14,8480011,Klim Kostin,C,SJS,25,0,0,0,0
14,8481556,John Beecher,C,BOS,23,0,0,0,0
14,8475278,Byron Froese,C,VGK,33,0,0,0,0
14,8475225,Craig Smith,C,DAL,35,0,0,0,0
14,8484326,Patrik Koch,D,ARI,28,0,0,0,0
14,8477930,Pierre-Edouard Bellemare,L,SEA,39,0,0,0,0
14,8478409,Anthony Richard,C,BOS,28,0,0,0,0
14,8481024,Linus Karlsson,C,VAN,25,0,0,0,0
14,8479986,Kole Lind,R,SEA,26,0,0,0,0
14,8479414,Nathan Bastian,R,NJD,27,0,0,0,0
14,8479362,Riley Tufte,L,COL,26,0,0,0,0
14,8481058,Jesse Ylönen,R,MTL,25,0,0,0,0
14,8482476,Emil Heineman,L,MTL,23,0,0,0,0
14,8482861,Vincent Iorio,D,WSH,22,0,0,0,0
14,8483432,Luca Del Bel Belluz,C,CBJ,31,0,0,0,0
14,8482744,James Malatesta,L,CBJ,21,0,0,0,0
14,8477887,Patrick Brown,C,BOS,32,0,0,0,0
14,8478585,Derek Ryan,C,EDM,38,0,0,0,0
14,8481441,Joe Snively,C,WSH,28,0,0,0,0
14,8481592,Jakob Pelletier,L,CGY,23,0,0,0,0
14,8482634,Alex Steeves,C,TOR,25,0,0,0,0
14,8477126,Jayson Megna,C,BOS,34,0,0,0,0
14,8475752,Tyler Pitlick,C,NYR,33,0,0,0,0
14,8480008,Adam Ruzicka,C,ARI,25,0,0,0,0
14,8481065,Angus Crookshank,L,OTT,25,0,0,0,0
14,8479547,Matthew Phillips,R,WSH,26,0,0,0,0
14,8480226,Marián Studenic,R,SEA,26,0,0,0,0
14,8481237,Kyle MacLean,C,NYI,25,0,0,0,0
14,8475413,Justin Dowling,C,NJD,34,0,0,0,0
14,8481641,Joel Kiviranta,L,COL,28,0,0,0,0
14,8478104,Sammy Blais,L,STL,28,0,0,0,0
14,8477454,Adam Erne,L,EDM,29,0,0,0,0
14,8481518,Nolan Foote,L,NJD,24,0,0,0,0
14,8480245,Olle Lycksell,R,PHI,25,0,0,0,0
14,8483570,Ben Meyers,C,ANA,26,0,0,0,0
14,8480776,Sheldon Rempal,R,VGK,29,0,0,0,0
14,8483920,Pierrick Dube,R,WSH,23,0,0,0,0
14,8480267,Sammy Walker,C,MIN,25,0,0,0,0
14,8482747,Brennan Othmann,L,NYR,21,0,0,0,0
14,8479991,Jake Leschyshyn,C,NYR,25,0,0,0,0
14,8478400,Colin White,C,MTL,27,0,0,0,0
14,8479328,Julien Gauthier,R,NYI,27,0,0,0,0
14,8484325,Waltteri Merela,C,TBL,26,0,0,0,0
14,8479066,Ryan Lomberg,L,FLA,30,0,0,0,0
14,8477070,Liam O'Brien,C,ARI,30,0,0,0,0
14,8478146,Matthew Highmore,C,OTT,28,0,0,0,0
14,8478028,Fredrik Olofsson,L,COL,28,0,0,0,0
14,8480880,Jakub Lauko,C,BOS,24,0,0,0,0
14,8479968,Vinni Lettieri,C,MIN,29,0,0,0,0
14,8474709,Matt Martin,L,NYI,35,0,0,0,0
14,8480845,Rasmus Kupari,C,WPG,24,0,0,0,0
14,8481550,Adam Beckman,L,MIN,23,0,0,0,0
14,8481422,Jacob Lucchini,C,MIN,29,0,0,0,0
14,8477401,John Hayden,C,SEA,29,0,0,0,0
14,8478904,Steven Lorentz,C,FLA,28,0,0,0,0
14,8482088,Justin Sourdif,R,FLA,22,0,0,0,0
14,8482751,Ryan Winterton,C,SEA,21,0,0,0,0
14,8482241,Radim Zohorna,L,PIT,28,0,0,0,0
14,8481690,Tyler Angle,C,CBJ,24,0,0,0,0
14,8476952,Dominic Toninato,C,WPG,30,0,0,0,0
14,8476919,Chris Tierney,C,NJD,30,0,0,0,0
14,8480032,Shane Bowers,C,NJD,25,0,0,0,0
14,8484314,Jiri Smejkal,L,OTT,28,0,0,0,0
14,8481239,Samuel Fagemo,L,LAK,24,0,0,0,0
14,8481532,Alex Turcotte,C,LAK,23,0,0,0,0
14,8481019,David Gustafsson,C,WPG,24,0,0,0,0
14,8478477,Mitchell Stephens,C,MTL,27,0,0,0,0
14,8479546,Oskar Steen,C,BOS,26,0,0,0,0
14,8480292,Carson Meyer,R,CBJ,27,0,0,0,0
14,8478446,Glenn Gawdin,C,ANA,27,0,0,0,0
14,8483531,Brian Halonen,L,NJD,25,0,0,0,0
14,8477149,Scott Sabourin,R,SJS,32,0,0,0,0
14,8479972,Mason Shaw,C,MIN,26,0,0,0,0
14,8480890,Jan Jenik,R,ARI,24,0,0,0,0
14,8478051,Max Willman,C,NJD,29,0,0,0,0
14,8480851,Akil Thomas,C,LAK,24,0,0,0,0
14,8482765,Isak Rosen,R,BUF,21,0,0,0,0
14,8478421,A.J. Greer,L,CGY,28,0,0,0,0
14,8478512,Austin Czarnik,C,DET,32,0,0,0,0
14,8479536,Axel Jonsson-Fjallby,L,WPG,26,0,0,0,0
14,8477320,Anton Blidh,L,NYR,29,0,0,0,0
14,8481543,Nikita Alexandrov,C,STL,24,0,0,0,0
14,8475235,Nicolas Deslauriers,L,PHI,33,0,0,0,0
14,8481070,Hugh McGing,L,STL,26,0,0,0,0
14,8480836,Jonathan Gruden,C,PIT,24,0,0,0,0
14,8481591,Sam Poulin,R,PIT,23,0,0,0,0
14,8477962,Brendan Lemieux,L,CAR,28,0,0,0,0
14,8483401,Marc Johnstone,R,PIT,28,0,0,0,0
14,8482250,Callahan Burke,C,CAR,27,0,0,0,0
14,8481726,Adam Edstrom,C,NYR,24,0,0,0,0
14,8471817,Ryan Reaves,R,TOR,37,0,0,0,0
14,8479587,Rhett Gardner,C,PHI,28,0,0,0,0
14,8475766,Austin Watson,L,TBL,32,0,0,0,0
14,8479367,William Lockwood,R,FLA,26,0,0,0,0
14,8478424,Jansen Harkins,C,PIT,27,0,0,0,0
14,8476913,Devin Shore,C,SEA,30,0,0,0,0
14,8482652,Walker Duehr,R,CGY,27,0,0,0,0
14,8477527,Ross Johnston,L,ANA,30,0,0,0,0
14,8481077,John Leonard,L,ARI,26,0,0,0,0
14,8483549,Lucas Condotta,L,MTL,27,0,0,0,0
14,8480468,James Hamblin,L,EDM,25,0,0,0,0
14,8476907,Mackenzie MacEachern,L,STL,30,0,0,0,0
14,8479543,Michael Pezzetta,L,MTL,26,0,0,0,0
14,8480355,Mark Kastelic,C,OTT,25,0,0,0,0
14,8482162,Roby Jarventie,L,OTT,22,0,0,0,0
14,8479772,Zack MacEwen,R,OTT,28,0,0,0,0
14,8483597,Milos Kelemen,L,ARI,25,0,0,0,0
14,8479379,Givani Smith,R,SJS,26,0,0,0,0
14,8481655,Cole Schwindt,R,CGY,23,0,0,0,0
14,8479981,Jonah Gadjovich,L,FLA,26,0,0,0,0
14,8482147,Jean-Luc Foudy,C,COL,22,0,0,0,0
14,8484255,Jason Polin,R,COL,25,0,0,0,0
14,8477993,Justin Kirkland,C,ARI,28,0,0,0,0
14,8479249,Andrew Poturalski,C,SEA,30,0,0,0,0
14,8482197,Adam Raska,R,MIN,23,0,0,0,0
14,8475780,Chris Wagner,R,COL,33,0,0,0,0
14,8479533,Joona Koppanen,L,PIT,26,0,0,0,0
14,8481534,Raphael Lavoie,C,EDM,24,0,0,0,0
14,8484321,Nikolas Matinpalo,D,OTT,26,0,0,0,0
14,8481043,Cole Koepke,L,TBL,26,0,0,0,0
14,8476323,Max McCormick,L,SEA,32,0,0,0,0
14,8483609,Adam Klapka,R,CGY,24,0,0,0,0
14,8483512,Matt Savoie,C,BUF,20,0,0,0,0
14,8484259,Ondrej Pavel,C,COL,31,0,0,0,0
14,8478147,Bokondji Imama,L,OTT,28,0,0,0,0
14,8482460,Matt Rempe,C,NYR,22,0,0,0,0
14,8477073,Kurtis MacDermid,L,NJD,30,0,0,0,0
14,8480274,Philip Kemp,D,EDM,25,0,0,0,0
14,8478956,Samuel Laberge,L,NJD,27,0,0,0,0
14,8483045,Cameron Butler,R,CBJ,31,0,0,0,0
15,8476453,Nikita Kucherov,R,TBL,31,82,40,86,126
15,8477492,Nathan MacKinnon,C,COL,29,82,49,74,123
15,8478550,Artemi Panarin,L,NYR,33,82,48,75,123
15,8479318,Auston Matthews,C,TOR,27,82,66,50,116
15,8477956,David Pastrnak,R,BOS,28,82,46,58,104
15,8478402,Connor McDavid,C,EDM,27,82,37,62,99
15,8471675,Sidney Crosby,C,PIT,37,82,37,60,97
15,8481559,Jack Hughes,C,NJD,23,82,36,60,96
15,8481557,Matt Boldy,L,MIN,23,82,41,51,92
15,8478010,Brayden Point,C,TBL,28,82,44,45,89
15,8480027,Jason Robertson,L,DAL,25,82,34,55,89
15,8479314,Matthew Tkachuk,L,FLA,27,82,38,50,88
15,8476459,Mika Zibanejad,C,NYR,31,82,38,49,87
15,8480800,Quinn Hughes,D,VAN,25,82,10,76,86
15,8480012,Elias Pettersson,C,VAN,26,82,33,51,84
15,8480002,Nico Hischier,C,NJD,25,82,28,56,84
15,8478864,Kirill Kaprizov,L,MIN,27,82,35,48,83
15,8479343,Clayton Keller,R,ARI,26,82,28,55,83
15,8477946,Dylan Larkin,C,DET,28,82,31,51,82
15,8478420,Mikko Rantanen,R,COL,28,82,33,48,81
15,8477939,William Nylander,R,TOR,28,82,38,41,79
15,8478403,Jack Eichel,C,VGK,28,82,37,41,78
15,8477402,Pavel Buchnevich,L,STL,29,82,30,48,78
15,8480023,Robert Thomas,C,STL,25,82,24,54,78
15,8477447,Shea Theodore,D,VGK,29,82,16,62,78
15,8477501,Valeri Nichushkin,R,COL,29,82,40,37,77
15,8479407,Jesper Bratt,L,NJD,26,82,37,39,76
15,8478398,Kyle Connor,L,WPG,28,82,32,44,76
15,8475692,Mats Zuccarello,R,MIN,37,82,20,56,76
15,8477500,Bo Horvat,C,NYI,29,82,38,37,75
15,8480830,Andrei Svechnikov,R,CAR,24,82,28,47,75
15,8477934,Leon Draisaitl,C,EDM,29,82,23,52,75
15,8478445,Mathew Barzal,C,NYI,27,82,20,55,75
15,8479420,Tage Thompson,C,BUF,27,82,42,32,74
15,8473419,Brad Marchand,L,BOS,36,82,29,45,74
15,8482116,Tim Stützle,C,OTT,22,82,25,49,74
15,8476456,Jonathan Huberdeau,C,CGY,31,82,21,53,74
15,8480069,Cale Makar,D,COL,26,82,20,54,74
15,8477949,Alex Tuch,R,BUF,28,82,20,53,73
15,8474564,Steven Stamkos,C,TBL,34,82,37,35,72
15,8475166,John Tavares,C,TOR,34,82,30,42,72
15,8476454,Ryan Nugent-Hopkins,C,EDM,31,82,20,52,72
15,8471214,Alex Ovechkin,L,WSH,39,82,36,35,71
15,8476468,J.T. Miller,C,VAN,31,82,32,39,71
15,8477942,Kevin Fiala,L,LAK,28,82,29,42,71
15,8478427,Sebastian Aho,C,CAR,27,82,34,36,70
15,8477951,Nick Schmaltz,C,ARI,28,82,16,54,70
15,8476399,Blake Coleman,C,CGY,33,82,42,27,69
15,8478439,Travis Konecny,R,PHI,27,82,29,40,69
15,8479323,Adam Fox,D,NYR,26,82,12,57,69
15,8477409,Carter Verhaeghe,C,FLA,29,82,38,30,68
15,8475151,Kyle Palmieri,C,NYI,33,82,38,30,68
15,8480801,Brady Tkachuk,L,OTT,25,82,31,37,68
15,8477493,Aleksander Barkov,C,FLA,29,82,17,51,68
15,8478397,Rasmus Andersson,D,CGY,28,82,13,55,68
15,8475810,Bryan Rust,R,PIT,32,82,38,29,67
15,8475786,Zach Hyman,L,EDM,32,82,35,32,67
15,8477933,Sam Reinhart,C,FLA,29,82,34,33,67
15,8478493,Joel Eriksson Ek,C,MIN,27,82,34,33,67
15,8475172,Nazem Kadri,C,CGY,34,82,21,46,67
15,8475168,Matt Duchene,C,DAL,33,82,29,37,66
15,8479337,Alex DeBrincat,R,DET,27,82,25,41,66
15,8473512,Claude Giroux,R,OTT,36,82,25,41,66
15,8481523,Kirby Dach,C,MTL,23,82,14,52,66
15,8481528,Dylan Cozens,C,BUF,23,82,31,34,65
15,8476887,Filip Forsberg,L,NSH,30,82,30,35,65
15,8479385,Jordan Kyrou,C,STL,26,82,29,36,65
15,8480839,Rasmus Dahlin,D,BUF,24,82,13,52,65
15,8476346,Johnny Gaudreau,L,CBJ,31,82,12,53,65
15,8477960,Adrian Kempe,R,LAK,28,82,36,28,64
15,8477940,Nikolaj Ehlers,L,WPG,28,82,26,38,64
15,8478460,Zach Werenski,D,CBJ,27,82,11,53,64
15,8478414,Timo Meier,R,NJD,28,82,35,28,63
15,8471685,Anze Kopitar,C,LAK,37,82,31,32,63
15,8477404,Jake Guentzel,C,CAR,30,82,27,36,63
15,8476448,William Karlsson,C,VGK,31,82,23,40,63
15,8479999,Casey Mittelstadt,C,COL,26,82,22,41,63
15,8476853,Morgan Rielly,D,TOR,30,82,8,55,63
15,8480208,Drake Batherson,R,OTT,26,82,30,32,62
15,8478449,Roope Hintz,C,DAL,28,82,26,36,62
15,8476389,Vincent Trocheck,C,NYR,31,82,31,30,61
15,8476881,Tomas Hertl,C,VGK,31,82,27,34,61
15,8477496,Elias Lindholm,C,VAN,30,82,21,40,61
15,8482665,Matty Beniers,C,SEA,22,82,18,43,61
15,8476462,Dougie Hamilton,D,NJD,31,82,17,44,61
15,8475744,Evgeny Kuznetsov,C,CAR,32,82,24,36,60
15,8479400,Pierre-Luc Dubois,L,LAK,26,82,24,36,60
15,8475184,Chris Kreider,L,NYR,33,82,31,28,59
15,8478873,Troy Terry,R,ANA,27,82,25,34,59
15,8470794,Joe Pavelski,C,DAL,40,82,22,37,59
15,8477416,Oliver Bjorkstrand,R,SEA,29,82,21,38,59
15,8475167,Victor Hedman,D,TBL,34,82,11,48,59
15,8478047,Michael Bunting,L,PIT,29,82,25,33,58
15,8479542,Brandon Hagel,L,TBL,26,82,24,34,58
15,8476460,Mark Scheifele,C,WPG,31,82,21,37,58
15,8480018,Nick Suzuki,C,MTL,25,82,20,38,58
15,8474578,Erik Karlsson,D,PIT,34,82,8,50,58
15,8482699,Dylan Guenther,R,ARI,21,82,34,23,57
15,8482109,Alexis Lafrenière,L,NYR,23,82,27,30,57
15,8476880,Tom Wilson,R,WSH,30,82,24,33,57
15,8478042,Viktor Arvidsson,R,LAK,31,82,23,34,57
15,8482097,Jack Quinn,R,BUF,23,82,21,36,57
15,8476905,Chandler Stephenson,C,VGK,30,82,20,37,57
15,8483808,Andrei Kuzmenko,L,CGY,28,82,25,31,56
15,8475754,Brock Nelson,C,NYI,33,82,22,34,56
15,8474141,Patrick Kane,R,DET,36,82,18,38,56
15,8479339,Patrik Laine,L,CBJ,26,82,17,39,56
15,8480039,Martin Necas,C,CAR,25,82,25,30,55
15,8482078,Lucas Raymond,L,DET,22,82,24,31,55
15,8474600,Roman Josi,D,NSH,34,82,19,36,55
15,8475170,Brayden Schenn,C,STL,33,82,19,36,55
15,8475745,Charlie Coyle,C,BOS,32,82,17,38,55
15,8480036,Miro Heiskanen,D,DAL,25,82,9,46,55
15,8482745,Mason McTavish,C,ANA,21,82,23,31,54
15,8475765,Vladimir Tarasenko,R,FLA,33,82,18,36,54
15,8475753,Justin Faulk,D,STL,32,82,12,42,54
15,8478407,Vince Dunn,D,SEA,28,82,10,44,54
15,8477986,Brandon Montour,D,FLA,30,82,10,44,54
15,8478401,Pavel Zacha,C,BOS,27,82,25,28,53
15,8482740,Wyatt Johnston,C,DAL,21,82,24,29,53
15,8480015,Owen Tippett,R,PHI,25,82,22,31,53
15,8471215,Evgeni Malkin,C,PIT,38,82,20,33,53
15,8479410,Mikhail Sergachev,D,TBL,26,82,10,43,53
15,8475784,Jeff Skinner,C,BUF,32,82,25,27,52
15,8478440,Dylan Strome,C,WSH,27,82,20,32,52
15,8475794,Tyler Seguin,C,DAL,32,82,18,34,52
15,8480078,Filip Chytil,C,NYR,25,82,18,34,52
15,8482684,Luke Hughes,D,NJD,21,82,15,37,52
15,8476539,Jonathan Marchessault,R,VGK,34,82,26,25,51
15,8480798,Philipp Kurashev,C,CHI,25,82,16,35,51
15,8475798,Mikael Granlund,C,SJS,32,82,13,38,51
15,8481540,Cole Caufield,R,MTL,23,82,29,21,50
15,8475169,Evander Kane,L,EDM,33,82,28,22,50
15,8477955,Jared McCann,L,SEA,28,82,25,25,50
15,8478366,Frank Vatrano,R,ANA,30,82,24,26,50
15,8475158,Ryan O'Reilly,C,NSH,33,82,14,36,50
15,8481699,Aku Raty,R,ARI,23,82,6,44,50
15,8482159,Tyson Foerster,R,PHI,22,82,26,23,49
15,8479675,Trevor Moore,L,LAK,29,82,20,29,49
15,8475913,Mark Stone,R,VGK,32,82,19,30,49
15,8478233,Andrew Mangiapane,L,CGY,28,82,18,31,49
15,8476882,Teuvo Teravainen,L,CAR,30,82,18,31,49
15,8480803,Evan Bouchard,D,EDM,25,82,11,38,49
15,8477504,Josh Morrissey,D,WPG,29,82,11,38,49
15,8480893,Kirill Marchenko,R,CBJ,24,82,25,23,48
15,8478498,Jake DeBrusk,L,BOS,28,82,23,25,48
15,8475763,Kevin Hayes,R,STL,32,82,21,27,48
15,8480797,Joel Farabee,L,PHI,24,82,21,27,48
15,8477935,Sam Bennett,C,FLA,28,82,19,29,48
15,8481711,Matias Maccelli,L,ARI,24,82,17,31,48
15,8478519,Anthony Cirelli,C,TBL,27,82,16,32,48
15,8476458,Ryan Strome,C,ANA,31,82,16,32,48
15,8471724,Kris Letang,D,PIT,37,82,9,39,48
15,8476906,Shayne Gostisbehere,D,DET,31,82,7,41,48
15,8475764,Cam Fowler,D,ANA,33,82,6,42,48
15,8480064,Josh Norris,C,OTT,25,82,24,23,47
15,8477476,Artturi Lehkonen,L,COL,29,82,23,24,47
15,8474102,David Perron,L,DET,36,82,17,30,47
15,8482124,Quinton Byfield,R,LAK,22,82,16,31,47
15,8479345,Jakob Chychrun,D,OTT,26,82,14,33,47
15,8477964,Ivan Barbashev,C,VGK,29,82,14,33,47
15,8474586,Jordan Eberle,R,SEA,34,82,12,35,47
15,8480865,Noah Dobson,D,NYI,24,82,9,38,47
15,8479325,Charlie McAvoy,D,BOS,27,82,8,39,47
15,8473986,Alex Killorn,L,ANA,35,82,25,21,46
15,8478444,Brock Boeser,R,VAN,27,82,23,23,46
15,8473994,Jamie Benn,L,DAL,35,82,21,25,46
15,8477346,MacKenzie Weegar,D,CGY,30,82,17,29,46
15,8480014,Gabriel Vilardi,C,WPG,25,82,25,20,45
15,8481068,Yegor Sharangovich,C,CGY,26,82,18,27,45
15,8477451,Ryan Hartman,R,MIN,30,82,18,27,45
15,8475768,Jaden Schwartz,C,SEA,32,82,18,27,45
15,8476479,Phillip Danault,C,LAK,31,82,17,28,45
15,8476292,Ondrej Palat,L,NJD,33,82,15,30,45
15,8480031,Maxime Comtois,L,CAR,25,82,12,33,45
15,8470613,Brent Burns,D,CAR,39,82,11,34,45
15,8476432,Boone Jenner,C,CBJ,31,82,31,13,44
15,8475726,Tyler Toffoli,C,WPG,32,82,25,19,44
15,8475760,Nick Bjugstad,C,ARI,32,82,22,22,44
15,8478046,Danton Heinen,L,BOS,29,82,20,24,44
15,8480009,Eeli Tolvanen,R,SEA,25,82,17,27,44
15,8484144,Connor Bedard,C,CHI,19,82,16,28,44
15,8476875,Mike Matheson,D,MTL,30,82,13,31,44
15,8478038,Devon Toews,D,COL,30,82,11,33,44
15,8481542,Moritz Seider,D,DET,23,82,10,34,44
15,8478856,Conor Garland,R,VAN,28,82,20,23,43
15,8477497,Sean Monahan,C,WPG,30,82,17,26,43
15,8481596,Shane Pinto,C,OTT,24,82,16,27,43
15,8477456,J.T. Compher,L,DET,29,82,15,28,43
15,8471218,Blake Wheeler,R,NYR,38,82,15,28,43
15,8482222,Alexander Barabanov,L,SJS,30,82,14,29,43
15,8474590,John Carlson,D,WSH,34,82,5,38,43
15,8483397,Marc McLaughlin,C,BOS,25,82,32,10,42
15,8477407,Anthony Duclair,L,TBL,29,82,25,17,42
15,8471698,T.J. Oshie,R,WSH,38,82,24,18,42
15,8478474,Lawson Crouse,L,ARI,27,82,22,20,42
15,8478542,Evan Rodrigues,C,FLA,31,82,15,27,42
15,8480220,Noah Cates,L,PHI,25,82,13,29,42
15,8478466,Daniel Sprong,R,DET,27,82,23,18,41
15,8480188,Fabian Zetterlund,L,SJS,25,82,21,20,41
15,8481624,Ilya Mikheyev,R,VAN,30,82,21,20,41
15,8476826,Yanni Gourde,C,SEA,33,82,19,22,41
15,8481618,Alex Newhook,C,MTL,23,82,19,22,41
15,8474150,Mikael Backlund,C,CGY,35,82,14,27,41
15,8482093,Seth Jarvis,C,CAR,22,82,13,28,41
15,8482105,Jake Sanderson,D,OTT,22,82,10,31,41
15,8477932,Aaron Ekblad,D,FLA,28,82,10,31,41
15,8477495,Seth Jones,D,CHI,30,82,9,32,41
15,8474563,Drew Doughty,D,LAK,35,82,6,35,41
15,8480434,Sean Durzi,D,ARI,26,82,4,37,41
15,8483457,Lane Hutson,D,MTL,20,82,0,41,41
15,8483524,Shane Wright,C,SEA,20,82,24,16,40
15,8477998,Warren Foegele,L,EDM,28,82,21,19,40
15,8477479,Tyler Bertuzzi,L,TOR,29,82,20,20,40
15,8477021,Alex Kerfoot,C,ARI,30,82,16,24,40
15,8482113,Anton Lundell,C,FLA,23,82,14,26,40
15,8474679,Gustav Nyquist,C,NSH,35,82,12,28,40
15,8480028,Morgan Frost,C,PHI,25,82,12,28,40
15,8479425,Filip Hronek,D,VAN,27,82,9,31,40
15,8478396,Noah Hanifin,D,VGK,27,82,5,35,40
15,8476483,Rickard Rakell,R,PIT,31,82,18,21,39
15,8477503,Max Domi,C,TOR,29,82,17,22,39
15,8476925,Colton Sissons,C,NSH,31,82,17,22,39
15,8475791,Taylor Hall,L,CHI,33,82,17,22,39
15,8482092,Ridly Greig,C,OTT,22,82,17,22,39
15,8473422,Nick Foligno,L,CHI,37,82,16,23,39
15,8477429,Andrew Copp,C,DET,30,82,15,24,39
15,8478438,Tommy Novak,C,NSH,27,82,14,25,39
15,8477511,Anthony Mantha,R,VGK,30,82,14,25,39
15,8478975,Mason Marchment,L,DAL,29,82,13,26,39
15,8478472,Mathieu Joseph,R,OTT,27,82,13,26,39
15,8483445,Cutter Gauthier,L,ANA,20,82,11,28,39
15,8475314,Anders Lee,L,NYI,34,82,25,13,38
15,8475287,Erik Haula,L,NJD,33,82,19,19,38
15,8478462,Nicolas Roy,C,VGK,27,82,17,21,38
15,8474053,Logan Couture,C,SJS,35,82,17,21,38
15,8474641,Adam Henrique,C,EDM,34,82,16,22,38
15,8476892,Colton Parayko,D,STL,31,82,16,22,38
15,8482146,Luke Evangelista,R,NSH,22,82,14,24,38
15,8478469,Thomas Chabot,D,OTT,27,82,11,27,38
15,8477494,Jonathan Drouin,L,COL,29,82,11,27,38
15,8474565,Alex Pietrangelo,D,VGK,34,82,10,28,38
15,8482671,Owen Power,D,BUF,22,82,9,29,38
15,8483471,Brad Lambert,C,WPG,31,82,3,35,38
15,8478057,Dakota Joshua,C,VAN,28,82,24,13,37
15,8481604,Pavel Dorofeyev,L,VGK,24,82,22,15,37
15,8482089,Jake Neighbours,L,STL,22,82,21,16,37
15,8476438,Brandon Saad,L,STL,32,82,20,17,37
15,8475722,Jason Zucker,L,NSH,32,82,17,20,37
15,8474037,James van Riemsdyk,L,BOS,35,82,14,23,37
15,8478458,Jack Roslovic,C,NYR,27,82,13,24,37
15,8481533,Trevor Zegras,C,ANA,23,82,13,24,37
15,8478891,Mason Appleton,C,WPG,28,82,12,25,37
15,8476329,Travis Boyd,C,ARI,31,82,11,26,37
15,8477444,Andre Burakovsky,L,SEA,29,82,11,26,37
15,8480817,K'Andre Miller,D,NYR,24,82,7,30,37
15,8476960,Andreas Athanasiou,C,CHI,30,82,20,16,36
15,8475848,Brendan Gallagher,R,MTL,32,82,18,18,36
15,8480185,Eetu Luostarinen,C,FLA,26,82,18,18,36
15,8479293,Brandon Tanev,L,SEA,33,82,17,19,36
15,8476872,Scott Laughton,C,PHI,30,82,16,20,36
15,8477952,Robby Fabbri,C,DET,28,82,12,24,36
15,8477948,Travis Sanheim,D,PHI,28,82,10,26,36
15,8473563,Nicklas Backstrom,C,WSH,37,82,8,28,36
15,8476981,Josh Anderson,R,MTL,30,82,21,14,35
15,8482110,Dawson Mercer,C,NJD,23,82,19,16,35
15,8479415,Michael McLeod,C,NJD,26,82,16,19,35
15,8478109,Victor Olofsson,L,BUF,29,82,11,24,35
15,8481481,Blake Lizotte,C,LAK,27,82,11,24,35
15,8478055,Gustav Forsling,D,FLA,28,82,9,26,35
15,8481016,Ruslan Iskhakov,C,NYI,24,82,4,31,35
15,8481560,Arthur Kaliyev,R,LAK,23,82,22,12,34
15,8475799,Nino Niederreiter,R,WPG,32,82,16,18,34
15,8477947,Sonny Milano,L,WSH,28,82,15,19,34
15,8470610,Zach Parise,L,COL,40,82,12,22,34
15,8480802,Ryan McLeod,C,EDM,25,82,11,23,34
15,8476419,Jean-Gabriel Pageau,C,NYI,32,82,9,25,34
15,8476792,Torey Krug,D,STL,33,82,6,28,34
15,8474151,Ryan McDonagh,D,NSH,35,82,6,28,34
15,8483431,Logan Cooley,C,ARI,20,82,19,14,33
15,8484166,Adam Fantilli,C,CBJ,20,82,16,17,33
15,8480113,Alex Iafallo,L,WPG,31,82,14,19,33
15,8476480,Vladislav Namestnikov,C,WPG,32,82,14,19,33
15,8482175,JJ Peterka,R,BUF,22,82,14,19,33
15,8474870,Tyler Johnson,C,CHI,34,82,13,20,33
15,8479992,Michael Rasmussen,C,DET,25,82,12,21,33
15,8477450,Jason Dickinson,C,CHI,29,82,11,22,33
15,8482624,Daniil Miromanov,D,CGY,27,82,10,23,33
15,8478500,Ivan Provorov,D,CBJ,27,82,6,27,33
15,8476885,Jacob Trouba,D,NYR,30,82,6,27,33
15,8483493,Frank Nazar,C,CHI,20,82,24,8,32
15,8483515,Juraj Slafkovsky,L,MTL,20,82,16,16,32
15,8482667,William Eklund,L,SJS,22,82,15,17,32
15,8475714,Calle Jarnkrok,C,TOR,33,82,14,18,32
15,8478413,Jordan Greenway,L,BUF,27,82,14,18,32
15,8479365,Trent Frederic,C,BOS,26,82,14,18,32
15,8477425,Miles Wood,L,COL,29,82,12,20,32
15,8475793,Ryan Johansen,C,PHI,32,82,10,22,32
15,8480336,Sean Walker,D,COL,30,82,10,22,32
15,8476897,Oskar Sundqvist,C,STL,30,82,10,22,32
15,8474157,Max Pacioretty,L,WSH,36,82,9,23,32
15,8482720,Matthew Knies,L,TOR,22,82,9,23,32
15,8481581,Thomas Harley,D,DAL,23,82,8,24,32
15,8481656,Aliaksei Protas,C,WSH,23,82,4,28,32
15,8483466,Kevin Korchinski,D,CHI,20,82,4,28,32
15,8482733,Logan Mailloux,D,MTL,31,82,3,29,32
15,8477426,Nicholas Paul,L,TBL,29,82,18,13,31
15,8475220,Marcus Foligno,L,MIN,33,82,18,13,31
15,8482055,Drew O'Connor,L,PIT,26,82,15,16,31
15,8480855,Jack McBain,C,ARI,24,82,14,17,31
15,8477944,Jakub Vrana,L,STL,28,82,14,17,31
15,8475191,Reilly Smith,R,PIT,33,82,14,17,31
15,8482133,Thomas Bordeleau,C,SJS,22,82,13,18,31
15,8476921,Jordan Martinook,L,CAR,32,82,13,18,31
15,8480849,Barrett Hayton,C,ARI,24,82,12,19,31
15,8474715,Cam Atkinson,R,PHI,35,82,12,19,31
15,8480144,David Kampf,C,TOR,29,82,11,20,31
15,8477498,Darnell Nurse,D,EDM,29,82,8,23,31
15,8476958,Jaccob Slavin,D,CAR,30,82,6,25,31
15,8476923,Damon Severson,D,CBJ,30,82,4,27,31
15,8475218,Mattias Ekholm,D,EDM,34,82,4,27,31
15,8478508,Yakov Trenin,C,COL,27,82,20,10,30
15,8475343,Nic Dowd,C,WSH,34,82,15,15,30
15,8478020,Michael Amadio,C,VGK,28,82,15,15,30
15,8479525,Ross Colton,C,COL,28,82,14,16,30
15,8479987,Morgan Geekie,C,BOS,26,82,12,18,30
15,8477919,Frederick Gaudreau,C,MIN,31,82,12,18,30
15,8482122,Brock Faber,D,MIN,22,82,6,24,30
15,8478911,Matt Roy,D,LAK,29,82,6,24,30
15,8479398,Samuel Girard,D,COL,26,82,6,24,30
15,8481546,Cam York,D,PHI,23,82,5,25,30
15,8478882,Vladislav Gavrikov,D,LAK,29,82,5,25,30
15,8476979,Erik Gustafsson,D,NYR,32,82,4,26,30
15,8481554,Kaapo Kakko,R,NYR,23,82,20,9,29
15,8481535,Nils Hoglander,L,VAN,24,82,19,10,29
15,8481580,Connor McMichael,C,WSH,23,82,13,16,29
15,8481013,Jonatan Berggren,R,DET,24,82,12,17,29
15,8477969,Marcus Pettersson,D,PIT,28,82,10,19,29
15,8476927,Teddy Blueger,C,VAN,30,82,9,20,29
15,8479998,Mikey Anderson,D,LAK,25,82,8,21,29
15,8481703,Valtteri Puustinen,R,PIT,25,82,7,22,29
15,8476331,Dylan DeMelo,D,WPG,31,82,5,24,29
15,8482101,Danil Gushchin,L,SJS,22,82,17,11,28
15,8481477,Nico Sturm,C,SJS,29,82,16,12,28
15,8479390,Taylor Raddysh,R,CHI,26,82,15,13,28
15,8479359,Beck Malenstyn,L,WSH,26,82,15,13,28
15,8477989,Christian Dvorak,C,MTL,28,82,13,15,28
15,8480068,Ryan Poehling,C,PHI,25,82,13,15,28
15,8475149,Marcus Johansson,L,MIN,34,82,13,15,28
15,8479346,Dillon Dube,C,CGY,26,82,13,15,28
15,8480806,Isac Lundestrom,C,ANA,25,82,10,18,28
15,8484153,Leo Carlsson,C,ANA,20,82,8,20,28
15,8476869,Brady Skjei,D,CAR,30,82,7,21,28
15,8479976,Juuso Valimaki,D,ARI,26,82,6,22,28
15,8475171,Oliver Ekman-Larsson,D,FLA,33,82,6,22,28
15,8482142,Jamie Drysdale,D,PHI,22,82,5,23,28
15,8475181,Nick Leddy,D,STL,33,82,4,24,28
15,8480035,Henri Jokiharju,D,BUF,25,82,3,25,28
15,8476854,Hampus Lindholm,D,BOS,30,82,2,26,28
15,8479423,Alex Nylander,L,CBJ,26,82,16,11,27
15,8482475,Yegor Chinakhov,R,CBJ,23,82,15,12,27
15,8482679,Matt Coronato,R,CGY,22,82,14,13,27
15,8476392,Adam Lowry,C,WPG,31,82,11,16,27
15,8482117,Lukas Reichel,L,CHI,22,82,10,17,27
15,8482125,Alexander Holtz,R,NJD,22,82,9,18,27
15,8476278,Colin Blackwell,C,CHI,31,82,9,18,27
15,8480459,Pius Suter,C,VAN,28,82,8,19,27
15,8474189,Lars Eller,C,PIT,35,82,6,21,27
15,8482730,Brandt Clarke,D,LAK,21,82,4,23,27
15,8474716,Jared Spurgeon,D,MIN,35,82,3,24,27
15,8482118,Sam Colangelo,R,ANA,23,82,19,7,26
15,8481601,Simon Holmstrom,R,NYI,23,82,14,12,26
15,8482074,Connor Zary,C,CGY,23,82,12,14,26
15,8478463,Anthony Beauvillier,L,NSH,27,82,11,15,26
15,8482705,Cole Sillinger,C,CBJ,21,82,11,15,26
15,8480074,Alexandre Texier,C,CBJ,25,82,11,15,26
15,8478115,Pierre Engvall,L,NYI,28,82,10,16,26
15,8479983,Mario Ferraro,D,SJS,26,82,10,16,26
15,8475279,Ben Chiarot,D,DET,33,82,10,16,26
15,8475200,Dmitry Orlov,D,CAR,33,82,9,17,26
15,8476461,Sean Couturier,C,PHI,32,82,9,17,26
15,8478013,Jake Walman,D,DET,28,82,9,17,26
15,8480871,Adam Boqvist,D,CBJ,24,82,6,20,26
15,8473507,Jeff Petry,D,DET,37,82,6,20,26
15,8481568,Alex Vlasic,D,CHI,23,82,4,22,26
15,8478507,John Marino,D,NJD,27,82,3,23,26
15,8479996,Cody Glass,C,NSH,25,82,18,7,25
15,8470621,Corey Perry,R,EDM,39,82,16,9,25
15,8482702,Logan Stankoven,C,DAL,21,82,13,12,25
15,8479353,Brett Howden,C,VGK,26,82,11,14,25
15,8481028,Martin Pospisil,C,CGY,25,82,10,15,25
15,8477353,Tyler Motte,C,TBL,29,82,10,15,25
15,8478468,Jeremy Lauzon,D,NSH,27,82,10,15,25
15,8473533,Jordan Staal,C,CAR,36,82,9,16,25
15,8481186,Logan O'Connor,R,COL,28,82,9,16,25
15,8476312,Josh Manson,D,COL,33,82,9,16,25
15,8474884,Mike Hoffman,C,SJS,35,82,8,17,25
15,8480821,Filip Zadina,R,SJS,25,82,8,17,25
15,8480145,Neal Pionk,D,WPG,29,82,7,18,25
15,8477365,Connor Clifton,D,BUF,29,82,7,18,25
15,8483505,Matthew Poitras,C,BOS,20,82,3,22,25
15,8475906,John Klingberg,D,TOR,32,82,2,23,25
15,8479941,Justin Danforth,R,CBJ,31,82,17,7,24
15,8484203,Bradly Nadeau,L,CAR,19,82,15,9,24
15,8479351,Sam Steel,C,DAL,26,82,13,11,24
15,8480043,Timothy Liljegren,D,TOR,25,82,9,15,24
15,8479393,Noah Gregor,C,TOR,26,82,9,15,24
15,8482079,Marco Rossi,C,MIN,23,82,8,16,24
15,8477506,Ryan Pulock,D,NYI,30,82,8,16,24
15,8478133,Jake Evans,C,MTL,28,82,8,16,24
15,8481014,Alexander Romanov,D,NYI,24,82,8,16,24
15,8478178,Darren Raddysh,D,TBL,28,82,7,17,24
15,8482259,Bobby McMann,C,TOR,28,82,6,18,24
15,8482712,Oskar Olausson,R,COL,22,82,6,18,24
15,8478416,Erik Cernak,D,TBL,27,82,6,18,24
15,8481606,Jordan Spence,D,LAK,23,82,3,21,24
15,8482145,Mavrik Bourque,C,DAL,22,82,18,5,23
15,8484145,Zach Benson,L,BUF,19,82,15,8,23
15,8476873,Mark Jankowski,C,NSH,30,82,13,10,23
15,8478831,Kevin Stenlund,C,FLA,28,82,12,11,23
15,8473449,Kyle Okposo,R,FLA,36,82,11,12,23
15,8476442,Matt Nieto,L,PIT,32,82,11,12,23
15,8477839,Conor Sheary,L,TBL,32,82,10,13,23
15,8477330,Dominik Kubalik,L,OTT,29,82,9,14,23
15,8477953,Kasperi Kapanen,R,STL,28,82,9,14,23
15,8476967,Brett Kulak,D,EDM,30,82,7,16,23
15,8479514,Rem Pitlick,C,CHI,27,82,7,16,23
15,8475197,Tyson Barrie,D,NSH,33,82,6,17,23
15,8478840,Will Borgen,D,SEA,28,82,5,18,23
15,8475164,Jakob Silfverberg,R,ANA,34,82,5,18,23
15,8476931,Jake McCabe,D,TOR,31,82,4,19,23
15,8482073,Braden Schneider,D,NYR,23,82,3,20,23
15,8482737,Zack Bolduc,C,STL,21,82,11,11,22
15,8477406,Mattias Janmark,C,EDM,32,82,10,12,22
15,8481553,Bobby Brink,R,PHI,23,82,10,12,22
15,8476871,Tanner Pearson,L,MTL,32,82,9,13,22
15,8473453,Trevor Lewis,C,LAK,37,82,9,13,22
15,8474149,Evgenii Dadonov,R,DAL,35,82,7,15,22
15,8476457,Adam Larsson,D,SEA,32,82,7,15,22
15,8477507,Nikita Zadorov,D,VAN,29,82,7,15,22
15,8475179,Dmitry Kulikov,D,FLA,34,82,6,16,22
15,8477488,Brett Pesce,D,CAR,30,82,4,18,22
15,8476429,Scott Mayfield,D,NYI,32,82,2,20,22
15,8474574,Tyler Myers,D,VAN,34,82,2,20,22
15,8476469,Joel Armia,R,MTL,31,82,14,7,21
15,8479316,Luke Kunin,C,SJS,27,82,14,7,21
15,8470604,Jeff Carter,C,PIT,39,82,10,11,21
15,8480448,Parker Kelly,L,OTT,25,82,10,11,21
15,8478043,Sam Lafferty,C,VAN,29,82,10,11,21
15,8481524,Bowen Byram,D,BUF,23,82,8,13,21
15,8476878,Zemgus Girgensons,L,BUF,30,82,8,13,21
15,8481537,Nikita Okhotiuk,D,CGY,24,82,7,14,21
15,8477369,Carson Soucy,D,VAN,30,82,7,14,21
15,8474034,Pat Maroon,L,BOS,36,82,7,14,21
15,8482655,J.J. Moser,D,ARI,24,82,6,15,21
15,8480873,Rasmus Sandin,D,WSH,24,82,5,16,21
15,8477435,Ryan Graves,D,PIT,29,82,4,17,21
15,8476891,Matt Grzelcyk,D,BOS,30,82,4,17,21
15,8483490,Pavel Mintyukov,D,ANA,21,82,4,17,21
15,8478859,Niko Mikkola,D,FLA,28,82,4,17,21
15,8478851,Alexandre Carrier,D,NSH,28,82,2,19,21
15,8476374,Sean Kuraly,C,CBJ,31,82,9,11,20
15,8476902,Esa Lindell,D,DAL,30,82,9,11,20
15,8483482,Tristan Luneau,D,ANA,20,82,8,12,20
15,8475231,Casey Cizikas,C,NYI,33,82,7,13,20
15,8475790,Erik Gudbranson,D,CBJ,32,82,5,15,20
15,8482087,Kaiden Guhle,D,MTL,22,82,5,15,20
15,8478430,Oliver Kylington,D,CGY,27,82,5,15,20
15,8475233,David Savard,D,MTL,34,82,5,15,20
15,8478136,Jake Middleton,D,MIN,28,82,5,15,20
15,8480807,Mattias Samuelsson,D,BUF,24,82,4,16,20
15,8480172,Jan Rutta,D,SJS,34,82,4,16,20
15,8479369,Andrew Peeke,D,BOS,26,82,3,17,20
15,8481605,Jackson LaCombe,D,ANA,23,82,3,17,20
15,8474567,Zach Bogosian,D,MIN,34,82,3,17,20
15,8480073,Erik Brannstrom,D,OTT,25,82,2,18,20
15,8474673,TJ Brodie,D,TOR,34,82,0,20,20
15,8480813,Joe Veleno,C,DET,24,82,15,4,19
15,8479977,Kailer Yamamoto,R,SEA,26,82,13,6,19
15,8483491,Ivan Miroshnichenko,L,WSH,20,82,11,8,19
15,8481517,Brett Leason,R,ANA,25,82,10,9,19
15,8482809,Jackson Blake,R,CAR,21,82,9,10,19
15,8483499,Liam Ohgren,L,MIN,20,82,8,11,19
15,8477015,Connor Brown,R,EDM,30,82,8,11,19
15,8481704,Juuso Parssinen,C,NSH,23,82,7,12,19
15,8483565,Nick Blankenburg,D,CBJ,26,82,6,13,19
15,8477220,Nate Schmidt,D,WPG,33,82,5,14,19
15,8480860,Kevin Bahl,D,NJD,24,82,5,14,19
15,8476624,Barclay Goodrow,C,NYR,31,82,5,14,19
15,8477505,Alexander Wennberg,C,NYR,30,82,7,11,18
15,8476917,Adam Pelech,D,NYI,30,82,6,12,18
15,8476422,Mike Reilly,D,NYI,31,82,4,14,18
15,8479591,Michael Eyssimont,C,TBL,28,82,4,14,18
15,8475462,Radko Gudas,D,ANA,34,82,3,15,18
15,8476463,Jonas Brodin,D,MIN,31,82,2,16,18
15,8475324,Nick Jensen,D,WSH,34,82,2,16,18
15,8475690,Chris Tanev,D,DAL,35,82,2,16,18
15,8483495,Simon Nemec,D,NJD,20,82,1,17,18
15,8481093,Rafael Harvey-Pinard,L,MTL,25,82,13,4,17
15,8482062,Cole Smith,L,NSH,29,82,7,10,17
15,8473504,Cal Clutterbuck,R,NYI,37,82,7,10,17
15,8480980,Connor Dewar,C,TOR,25,82,7,10,17
15,8482111,Justin Barron,D,MTL,23,82,6,11,17
15,8477508,Curtis Lazar,C,NJD,29,82,6,11,17
15,8479324,Ryan Lindgren,D,NYR,26,82,5,12,17
15,8482516,Matthew Kessel,D,STL,24,82,4,13,17
15,8476525,Colin Miller,D,WPG,32,82,4,13,17
15,8477335,Kyle Burroughs,D,SJS,29,82,3,14,17
15,8480834,Ty Emberson,D,SJS,24,82,3,14,17
15,8475455,Brenden Dillon,D,WPG,34,82,3,14,17
15,8478569,Noel Acciari,C,PIT,33,82,9,7,16
15,8479980,Nicolas Hague,D,VGK,26,82,7,9,16
15,8477392,Hudson Fasching,R,NYI,29,82,7,9,16
15,8480281,Alexey Toropchenko,R,STL,25,82,7,9,16
15,8480058,Pierre-Olivier Joseph,D,PIT,25,82,6,10,16
15,8477931,Tomas Nosek,L,NJD,32,82,5,11,16
15,8480246,Nick Perbix,D,TBL,26,82,4,12,16
15,8478451,Ethan Bear,D,WSH,27,82,4,12,16
15,8475188,Brayden McNabb,D,VGK,33,82,3,13,16
15,8476473,Connor Murphy,D,CHI,31,82,3,13,16
15,8481567,Henry Thrun,D,SJS,23,82,2,14,16
15,8470600,Ryan Suter,D,DAL,39,82,2,14,16
15,8478399,Jonas Siegenthaler,D,NJD,27,82,2,14,16
15,8474166,Alec Martinez,D,VGK,37,82,1,15,16
15,8483012,Logan Morrison,C,SEA,22,82,9,6,15
15,8481059,Scott Perunovich,D,STL,26,82,6,9,15
15,8479371,Dante Fabbro,D,NSH,26,82,5,10,15
15,8474009,Nick Bonino,C,NYR,36,82,5,10,15
15,8481522,Peyton Krebs,C,BUF,23,82,5,10,15
15,8480796,Martin Fehervary,D,WSH,25,82,4,11,15
15,8477845,Trevor van Riemsdyk,D,WSH,33,82,4,11,15
15,8482245,Artem Zub,D,OTT,29,82,3,12,15
15,8471677,Jack Johnson,D,COL,37,82,2,13,15
15,8476879,Cody Ceci,D,EDM,31,82,1,14,15
15,8482177,Marat Khusnutdinov,C,MIN,22,82,1,14,15
15,8475208,Brian Dumoulin,D,SEA,33,82,0,15,15
15,8476915,Jujhar Khaira,L,MIN,30,82,8,6,14
15,8479661,Tanner Jeannot,L,TBL,27,82,5,9,14
15,8482858,Ryker Evans,D,SEA,23,82,5,9,14
15,8481178,Egor Zamula,D,PHI,24,82,3,11,14
15,8482859,Zack Ostapchuk,C,OTT,21,82,3,11,14
15,8477034,Jaycob Megna,D,CHI,32,82,2,12,14
15,8475177,Calvin de Haan,D,TBL,33,82,2,12,14
15,8480879,Jacob Bernard-Docker,D,OTT,24,82,5,8,13
15,8482166,Shakir Mukhamadullin,D,SJS,22,82,3,10,13
15,8470966,Mark Giordano,D,TOR,41,82,2,11,13
15,8475762,Derek Forbort,D,BOS,32,82,1,12,13
15,8482470,Ilya Solovyov,D,CGY,24,82,0,13,13
15,8478408,Travis Dermott,D,ARI,28,82,8,4,12
15,8476822,Luke Glendening,C,TBL,35,82,8,4,12
15,8475842,Sam Carrick,C,EDM,32,82,6,6,12
15,8479442,Troy Stecher,D,EDM,30,82,6,6,12
15,8479291,Kevin Rooney,C,CGY,31,82,5,7,12
15,8483763,Maksymilian Szuber,D,ARI,22,82,5,7,12
15,8480990,Declan Chisholm,D,MIN,24,82,5,7,12
15,8482803,Olen Zellweger,D,ANA,21,82,4,8,12
15,8474013,Ian Cole,D,VAN,35,82,3,9,12
15,8482155,Alex Laferriere,R,LAK,23,82,6,5,11
15,8482807,Ethan Del Mastro,D,CHI,21,82,4,7,11
15,8477499,Rasmus Ristolainen,D,PHI,30,82,3,8,11
15,8475825,Jani Hakanpää,D,DAL,32,82,2,9,11
15,8484911,Collin Graf,R,SJS,22,82,1,10,11
15,8476372,Nick Seeler,D,PHI,31,82,5,5,10
15,8483468,Jiri Kulich,C,BUF,20,82,2,8,10
15,8476858,Phillip Di Giuseppe,L,VAN,31,82,5,4,9
15,8481599,Victor Soderstrom,D,ARI,23,82,4,5,9
15,8481030,Jack St. Ivany,D,PIT,25,82,4,5,9
15,8482762,Simon Edvinsson,D,DET,21,82,3,6,9
15,8482666,Scott Morrow,D,CAR,22,82,3,6,9
15,8476467,Jamie Oleksiak,D,SEA,32,82,1,8,9
15,8483489,Fraser Minten,C,TOR,31,82,2,6,8
15,8478443,Brandon Carlo,D,BOS,28,82,1,7,8
15,8482713,Mackie Samoskevich,R,FLA,22,82,3,4,7
15,8479383,Boris Katchouk,L,OTT,26,82,2,5,7
15,8484149,Gavin Brindley,C,CBJ,20,82,1,5,6
15,8481578,Graeme Clarke,R,NJD,23,82,2,3,5
15,8482141,Lukas Cormier,D,VGK,22,0,0,0,0
15,8476988,Matt Benning,D,SJS,30,0,0,0,0
15,8480727,Zach Whitecloud,D,VGK,28,0,0,0,0
15,8480887,Jordan Harris,D,MTL,24,0,0,0,0
15,8478450,Parker Wotherspoon,D,BOS,27,0,0,0,0
15,8481812,Nikolai Knyzhov,D,SJS,27,0,0,0,0
15,8480001,Urho Vaakanainen,D,ANA,25,0,0,0,0
15,8482176,Wyatt Kaiser,D,CHI,22,0,0,0,0
15,8481122,Simon Benoit,D,TOR,26,0,0,0,0
15,8476441,Joel Edmundson,D,TOR,31,0,0,0,0
15,8480884,Calen Addison,D,SJS,24,0,0,0,0
15,8482511,Mason Lohrei,D,BOS,23,0,0,0,0
15,8482192,Isaak Phillips,D,CHI,23,0,0,0,0
15,8480950,Ilya Lyubushkin,D,TOR,30,0,0,0,0
15,8474031,Kevin Shattenkirk,D,BOS,35,0,0,0,0
15,8475718,Justin Holl,D,DET,32,0,0,0,0
15,8479402,Jake Bean,D,CBJ,26,0,0,0,0
15,8474602,Justin Schultz,D,SEA,34,0,0,0,0
15,8477950,Tony DeAngelo,D,CAR,29,0,0,0,0
15,8481743,Marc Del Gaizo,D,NSH,25,0,0,0,0
15,8481527,Kaedan Korczak,D,VGK,23,0,0,0,0
15,8480192,Johnathan Kovacevic,D,MTL,27,0,0,0,0
15,8476874,Olli Maatta,D,DET,30,0,0,0,0
15,8482144,Jack Thompson,D,SJS,22,0,0,0,0
15,8480222,Sebastian Aho,D,NYI,28,0,0,0,0
15,8479458,Nikita Zaitsev,D,CHI,33,0,0,0,0
15,8471709,Marc-Edouard Vlasic,D,SJS,37,0,0,0,0
15,8482929,Emil Lilleberg,D,TBL,23,0,0,0,0
15,8477018,Ben Hutton,D,VGK,31,0,0,0,0
15,8481056,Spencer Stastney,D,NSH,24,0,0,0,0
15,8481593,Jayden Struble,D,MTL,23,0,0,0,0
15,8479982,Conor Timmins,D,TOR,26,0,0,0,0
15,8474090,Brendan Smith,D,NJD,35,0,0,0,0
15,8482964,Arber Xhekaj,D,MTL,23,0,0,0,0
15,8480891,Michael Kesselring,D,ARI,24,0,0,0,0
15,8477938,Haydn Fleury,D,TBL,28,0,0,0,0
15,8481806,Louis Crevier,D,CHI,23,0,0,0,0
15,8471274,Alex Goligoski,D,MIN,39,0,0,0,0
15,8481600,Tobias Bjornfot,D,FLA,23,0,0,0,0
15,8475797,Jarred Tinordi,D,CHI,32,0,0,0,0
15,8481521,Ronnie Attard,D,PHI,25,0,0,0,0
15,8474612,Travis Hamonic,D,OTT,34,0,0,0,0
15,8479576,Vincent Desharnais,D,EDM,28,0,0,0,0
15,8480049,Dylan Samberg,D,WPG,25,0,0,0,0
15,8483619,Filip Roos,D,CHI,25,0,0,0,0
15,8474568,Luke Schenn,D,NSH,35,0,0,0,0
15,8480184,Gustav Lindstrom,D,ANA,26,0,0,0,0
15,8480070,Ian Mitchell,D,BOS,25,0,0,0,0
15,8480196,Jacob Bryson,D,BUF,27,0,0,0,0
15,8471686,Marc Staal,D,PHI,37,0,0,0,0
15,8477467,Gustav Olofsson,D,SEA,30,0,0,0,0
15,8478970,Jalen Chatfield,D,CAR,28,0,0,0,0
15,8479348,Kale Clague,D,BUF,26,0,0,0,0
15,8473446,Erik Johnson,D,PHI,36,0,0,0,0
15,8477462,Robert Hagg,D,ANA,29,0,0,0,0
15,8478454,Noah Juulsen,D,VAN,27,0,0,0,0
15,8477384,Josh Brown,D,ARI,30,0,0,0,0
15,8481708,Zac Jones,D,NYR,24,0,0,0,0
15,8481167,Brayden Pachal,D,CGY,25,0,0,0,0
15,8482067,Connor Mackey,D,NYR,28,0,0,0,0
15,8483460,David Jiricek,D,CBJ,21,0,0,0,0
15,8481701,Santeri Hatakka,D,NJD,23,0,0,0,0
15,8478021,William Lagesson,D,ANA,28,0,0,0,0
15,8477851,Jordan Oesterle,D,CGY,32,0,0,0,0
15,8478452,Caleb Jones,D,COL,27,0,0,0,0
15,8479984,Cal Foote,D,NJD,26,0,0,0,0
15,8479639,Dylan Coghlan,D,CAR,26,0,0,0,0
15,8480874,Adam Ginning,D,PHI,24,0,0,0,0
15,8479321,Lucas Johansen,D,WSH,27,0,0,0,0
15,8480878,Nils Lundkvist,D,DAL,24,0,0,0,0
15,8482165,Yan Kuznetsov,D,CGY,22,0,0,0,0
15,8484258,Sam Malinski,D,COL,26,0,0,0,0
15,8480157,Calle Rosen,D,STL,30,0,0,0,0
15,8484304,Uvis Balinskis,D,FLA,28,0,0,0,0
15,8479985,Cale Fleury,D,SEA,26,0,0,0,0
15,8479378,Logan Stanley,D,WPG,26,0,0,0,0
15,8477541,Dakota Mermis,D,MIN,30,0,0,0,0
15,8481609,Vladislav Kolyachonok,D,ARI,23,0,0,0,0
15,8480823,Alexander Alexeyev,D,WSH,25,0,0,0,0
15,8481679,Maxence Guenette,D,OTT,23,0,0,0,0
15,8481564,Ryan Johnson,D,BUF,23,0,0,0,0
15,8479376,Victor Mete,D,PHI,26,0,0,0,0
15,8484254,Akito Hirose,D,VAN,25,0,0,0,0
15,8482660,Kent Johnson,C,CBJ,22,0,0,0,0
15,8482149,Cole Perfetti,C,WPG,22,0,0,0,0
15,8477987,Ryan Donato,C,CHI,28,0,0,0,0
15,8475755,Alexander Petrovic,D,DAL,32,0,0,0,0
15,8477810,Joel Hanley,D,CGY,33,0,0,0,0
15,8474145,Robert Bortuzzo,D,NYI,35,0,0,0,0
15,8481161,Jake Christiansen,D,CBJ,25,0,0,0,0
15,8476884,Derrick Pouliot,D,DAL,30,0,0,0,0
15,8481716,Dmitri Voronkov,L,CBJ,24,0,0,0,0
15,8480084,Nick DeSimone,D,NJD,30,0,0,0,0
15,8475750,Jon Merrill,D,MIN,32,0,0,0,0
15,8479315,Joey Anderson,R,CHI,26,0,0,0,0
15,8478011,Louie Belpedio,D,PHI,28,0,0,0,0
15,8482451,Mikael Pyyhtia,L,CBJ,23,0,0,0,0
15,8481541,Samuel Bolduc,D,NYI,24,0,0,0,0
15,8482126,Emil Andrae,D,PHI,31,0,0,0,0
15,8474618,Marco Scandella,D,STL,34,0,0,0,0
15,8477244,Chad Ruhwedel,D,NYR,34,0,0,0,0
15,8477971,Andreas Englund,D,LAK,28,0,0,0,0
15,8480829,Jesperi Kotkaniemi,C,CAR,24,0,0,0,0
15,8479372,Josh Mahura,D,FLA,26,0,0,0,0
15,8482095,Tyler Kleven,D,OTT,22,0,0,0,0
15,8481719,Maxwell Crozier,D,TBL,24,0,0,0,0
15,8475855,Jesper Fast,R,CAR,33,0,0,0,0
15,8480848,Ty Dellandrea,C,DAL,24,0,0,0,0
15,8475193,Tomas Tatar,L,SEA,34,0,0,0,0
15,8476889,Radek Faksa,C,DAL,30,0,0,0,0
15,8478495,Denis Gurianov,R,PHI,27,0,0,0,0
15,8480216,Jacob Peterson,C,SJS,25,0,0,0,0
15,8480252,Cole Guttman,C,CHI,25,0,0,0,0
15,8479026,Philippe Myers,D,TBL,27,0,0,0,0
15,8481006,Tyler Tucker,D,STL,24,0,0,0,0
15,8481032,Paul Cotter,C,VGK,25,0,0,0,0
15,8481577,Philip Tomasino,C,NSH,23,0,0,0,0
15,8476918,Jimmy Vesey,L,NYR,31,0,0,0,0
15,8479320,Max Lajoie,D,TOR,27,0,0,0,0
15,8478017,Mark Friedman,D,VAN,29,0,0,0,0
15,8481754,Nikita Nesterenko,C,ANA,23,0,0,0,0
15,8483407,Brandon Scanlin,D,NYR,25,0,0,0,0
15,8482659,Josh Doan,R,ARI,22,0,0,0,0
15,8477446,Michael McCarron,R,NSH,29,0,0,0,0
15,8477903,Garnet Hathaway,R,PHI,33,0,0,0,0
15,8482153,Brendan Brisson,C,VGK,23,0,0,0,0
15,8483546,Marshall Rifai,D,TOR,26,0,0,0,0
15,8484287,Cole McWard,D,VAN,23,0,0,0,0
15,8478854,Ryan Shea,D,PIT,27,0,0,0,0
15,8481585,Egor Afanasyev,L,NSH,23,0,0,0,0
15,8483398,Declan Carlile,D,TBL,31,0,0,0,0
15,8478502,Dennis Gilbert,D,CGY,28,0,0,0,0
15,8482749,Joshua Roy,R,MTL,21,0,0,0,0
15,8481598,Philip Broberg,D,EDM,23,0,0,0,0
15,8480835,Jack Drury,C,CAR,24,0,0,0,0
15,8480748,Kiefer Sherwood,L,NSH,29,0,0,0,0
15,8476934,Brock McGinn,L,ANA,30,0,0,0,0
15,8480870,Bo Groulx,C,ANA,24,0,0,0,0
15,8479368,Max Jones,L,ANA,26,0,0,0,0
15,8478099,Kevin Labanc,R,SJS,29,0,0,0,0
15,8478067,Oskar Lindblom,L,SJS,28,0,0,0,0
15,8476393,Nick Cousins,C,FLA,31,0,0,0,0
15,8483395,Arshdeep Bains,L,VAN,23,0,0,0,0
15,8480762,Eric Robinson,L,BUF,29,0,0,0,0
15,8479439,Jacob MacDonald,D,SJS,31,0,0,0,0
15,8476474,Stefan Noesen,R,CAR,31,0,0,0,0
15,8482787,Nikita Chibrikov,R,WPG,31,0,0,0,0
15,8478432,Christian Fischer,R,DET,27,0,0,0,0
15,8477979,Nicolas Aube-Kubel,R,WSH,28,0,0,0,0
15,8481789,Tye Kartye,L,SEA,23,0,0,0,0
15,8479330,Brandon Gignac,C,MTL,27,0,0,0,0
15,8480075,Cameron Crotty,D,ARI,25,0,0,0,0
15,8473473,Milan Lucic,L,BOS,36,0,0,0,0
15,8482094,Daemon Hunt,D,MIN,22,0,0,0,0
15,8481206,John Ludvig,D,PIT,24,0,0,0,0
15,8483630,Pavol Regenda,L,ANA,25,0,0,0,0
15,8481617,Vasily Podkolzin,R,VAN,23,0,0,0,0
15,8480306,Grant Hutton,D,NYI,29,0,0,0,0
15,8480995,Pontus Holmberg,R,TOR,25,0,0,0,0
15,8482148,Hendrix Lapierre,C,WSH,22,0,0,0,0
15,8477478,William Carrier,L,VGK,30,0,0,0,0
15,8480003,Jesper Boqvist,C,BOS,26,0,0,0,0
15,8482172,Landon Slaggert,L,CHI,22,0,0,0,0
15,8480789,Oliver Wahlstrom,R,NYI,24,0,0,0,0
15,8474062,Riley Nash,C,NYR,35,0,0,0,0
15,8480021,Jack Studnicka,C,SJS,25,0,0,0,0
15,8480025,MacKenzie Entwistle,R,CHI,25,0,0,0,0
15,8481582,Nicholas Robertson,L,TOR,23,0,0,0,0
15,8476867,Brendan Gaunce,C,CBJ,30,0,0,0,0
15,8479619,Michael Carcone,L,ARI,28,0,0,0,0
15,8479370,Tyson Jost,C,BUF,26,0,0,0,0
15,8479671,Mathieu Olivier,R,CBJ,27,0,0,0,0
15,8476994,Vinnie Hinostroza,C,PIT,30,0,0,0,0
15,8482070,Mitchell Chaffee,R,TBL,26,0,0,0,0
15,8477473,Justin Bailey,R,SJS,29,0,0,0,0
15,8479344,Jesse Puljujarvi,R,PIT,26,0,0,0,0
15,8480205,Emil Bemstrom,C,PIT,25,0,0,0,0
15,8479718,Alex Barré-Boulet,C,TBL,27,0,0,0,0
15,8482061,Brandon Biro,L,BUF,26,0,0,0,0
15,8479638,Justin Brazeau,R,BOS,26,0,0,0,0
15,8474040,Sam Gagner,C,EDM,35,0,0,0,0
15,8477846,Ryan Carpenter,C,SJS,33,0,0,0,0
15,8482077,Dylan Holloway,L,EDM,23,0,0,0,0
15,8482157,Will Cuylle,L,NYR,22,0,0,0,0
15,8480007,Jonas Rondbjerg,R,VGK,25,0,0,0,0
15,8478874,Adam Gaudette,C,STL,28,0,0,0,0
15,8478434,Keegan Kolesar,R,VGK,27,0,0,0,0
15,8480441,Trey Fix-Wolansky,R,CBJ,25,0,0,0,0
15,8479994,Jaret Anderson-Dolan,C,NSH,25,0,0,0,0
15,8483567,Georgii Merkulov,C,BOS,24,0,0,0,0
15,8477380,Jonny Brodzinski,C,NYR,31,0,0,0,0
15,8482201,Gage Goncalves,C,TBL,23,0,0,0,0
15,8478211,Dryden Hunt,L,CGY,29,0,0,0,0
15,8471699,Andrew Cogliano,C,COL,37,0,0,0,0
15,8479421,Jacob Moverare,D,LAK,26,0,0,0,0
15,8478881,Brett Seney,L,CHI,28,0,0,0,0
15,8477464,Nic Petan,C,MIN,29,0,0,0,0
15,8475958,Michael Sgarbossa,C,WSH,32,0,0,0,0
15,8481147,Reese Johnson,C,CHI,26,0,0,0,0
15,8479336,Carl Grundstrom,R,LAK,27,0,0,0,0
15,8480853,Liam Foudy,C,NSH,24,0,0,0,0
15,8479522,Hardy Haman Aktell,D,WSH,26,0,0,0,0
15,8481462,Mason Morelli,L,VGK,28,0,0,0,0
15,8482102,Vasily Ponomarev,C,CAR,22,0,0,0,0
15,8480844,Grigori Denisenko,L,VGK,24,0,0,0,0
15,8479944,Zach Aston-Reese,C,DET,30,0,0,0,0
15,8482784,Zach Dean,C,STL,21,0,0,0,0
15,8479419,Brett Murray,L,BUF,26,0,0,0,0
15,8479520,Brandon Duhaime,R,COL,27,0,0,0,0
15,8477573,Nathan Walker,L,STL,30,0,0,0,0
15,8478078,Rourke Chartier,C,OTT,28,0,0,0,0
15,8475795,Dylan McIlrath,D,WSH,32,0,0,0,0
15,8482496,Nils Aman,C,VAN,24,0,0,0,0
15,8480289,Morgan Barron,C,WPG,26,0,0,0,0
15,8481751,Lukas Rousek,R,BUF,25,0,0,0,0
15,8480011,Klim Kostin,C,SJS,25,0,0,0,0
15,8481556,John Beecher,C,BOS,23,0,0,0,0
15,8475278,Byron Froese,C,VGK,33,0,0,0,0
15,8475225,Craig Smith,C,DAL,35,0,0,0,0
15,8484326,Patrik Koch,D,ARI,28,0,0,0,0
15,8477930,Pierre-Edouard Bellemare,L,SEA,39,0,0,0,0
15,8478409,Anthony Richard,C,BOS,28,0,0,0,0
15,8481024,Linus Karlsson,C,VAN,25,0,0,0,0
15,8479986,Kole Lind,R,SEA,26,0,0,0,0
15,8479414,Nathan Bastian,R,NJD,27,0,0,0,0
15,8479362,Riley Tufte,L,COL,26,0,0,0,0
15,8481058,Jesse Ylönen,R,MTL,25,0,0,0,0
15,8482476,Emil Heineman,L,MTL,23,0,0,0,0
15,8482861,Vincent Iorio,D,WSH,22,0,0,0,0
15,8483432,Luca Del Bel Belluz,C,CBJ,31,0,0,0,0
15,8482744,James Malatesta,L,CBJ,21,0,0,0,0
15,8477887,Patrick Brown,C,BOS,32,0,0,0,0
15,8478585,Derek Ryan,C,EDM,38,0,0,0,0
15,8481441,Joe Snively,C,WSH,28,0,0,0,0
15,8481592,Jakob Pelletier,L,CGY,23,0,0,0,0
15,8482634,Alex Steeves,C,TOR,25,0,0,0,0
15,8477126,Jayson Megna,C,BOS,34,0,0,0,0
15,8475752,Tyler Pitlick,C,NYR,33,0,0,0,0
15,8480008,Adam Ruzicka,C,ARI,25,0,0,0,0
15,8481065,Angus Crookshank,L,OTT,25,0,0,0,0
15,8479547,Matthew Phillips,R,WSH,26,0,0,0,0
15,8480226,Marián Studenic,R,SEA,26,0,0,0,0
15,8481237,Kyle MacLean,C,NYI,25,0,0,0,0
15,8475413,Justin Dowling,C,NJD,34,0,0,0,0
15,8481641,Joel Kiviranta,L,COL,28,0,0,0,0
15,8478104,Sammy Blais,L,STL,28,0,0,0,0
15,8477454,Adam Erne,L,EDM,29,0,0,0,0
15,8481518,Nolan Foote,L,NJD,24,0,0,0,0
15,8480245,Olle Lycksell,R,PHI,25,0,0,0,0
15,8483570,Ben Meyers,C,ANA,26,0,0,0,0
15,8480776,Sheldon Rempal,R,VGK,29,0,0,0,0
15,8483920,Pierrick Dube,R,WSH,23,0,0,0,0
15,8480267,Sammy Walker,C,MIN,25,0,0,0,0
15,8482747,Brennan Othmann,L,NYR,21,0,0,0,0
15,8479991,Jake Leschyshyn,C,NYR,25,0,0,0,0
15,8478400,Colin White,C,MTL,27,0,0,0,0
15,8479328,Julien Gauthier,R,NYI,27,0,0,0,0
15,8484325,Waltteri Merela,C,TBL,26,0,0,0,0
15,8479066,Ryan Lomberg,L,FLA,30,0,0,0,0
15,8477070,Liam O'Brien,C,ARI,30,0,0,0,0
15,8478146,Matthew Highmore,C,OTT,28,0,0,0,0
15,8478028,Fredrik Olofsson,L,COL,28,0,0,0,0
15,8480880,Jakub Lauko,C,BOS,24,0,0,0,0
15,8479968,Vinni Lettieri,C,MIN,29,0,0,0,0
15,8474709,Matt Martin,L,NYI,35,0,0,0,0
15,8480845,Rasmus Kupari,C,WPG,24,0,0,0,0
15,8481550,Adam Beckman,L,MIN,23,0,0,0,0
15,8481422,Jacob Lucchini,C,MIN,29,0,0,0,0
15,8477401,John Hayden,C,SEA,29,0,0,0,0
15,8478904,Steven Lorentz,C,FLA,28,0,0,0,0
15,8482088,Justin Sourdif,R,FLA,22,0,0,0,0
15,8482751,Ryan Winterton,C,SEA,21,0,0,0,0
15,8482241,Radim Zohorna,L,PIT,28,0,0,0,0
15,8481690,Tyler Angle,C,CBJ,24,0,0,0,0
15,8476952,Dominic Toninato,C,WPG,30,0,0,0,0
15,8476919,Chris Tierney,C,NJD,30,0,0,0,0
15,8480032,Shane Bowers,C,NJD,25,0,0,0,0
15,8484314,Jiri Smejkal,L,OTT,28,0,0,0,0
15,8481239,Samuel Fagemo,L,LAK,24,0,0,0,0
15,8481532,Alex Turcotte,C,LAK,23,0,0,0,0
15,8481019,David Gustafsson,C,WPG,24,0,0,0,0
15,8478477,Mitchell Stephens,C,MTL,27,0,0,0,0
15,8479546,Oskar Steen,C,BOS,26,0,0,0,0
15,8480292,Carson Meyer,R,CBJ,27,0,0,0,0
15,8478446,Glenn Gawdin,C,ANA,27,0,0,0,0
15,8483531,Brian Halonen,L,NJD,25,0,0,0,0
15,8477149,Scott Sabourin,R,SJS,32,0,0,0,0
15,8479972,Mason Shaw,C,MIN,26,0,0,0,0
15,8480890,Jan Jenik,R,ARI,24,0,0,0,0
15,8478051,Max Willman,C,NJD,29,0,0,0,0
15,8480851,Akil Thomas,C,LAK,24,0,0,0,0
15,8482765,Isak Rosen,R,BUF,21,0,0,0,0
15,8478421,A.J. Greer,L,CGY,28,0,0,0,0
15,8478512,Austin Czarnik,C,DET,32,0,0,0,0
15,8479536,Axel Jonsson-Fjallby,L,WPG,26,0,0,0,0
15,8477320,Anton Blidh,L,NYR,29,0,0,0,0
15,8481543,Nikita Alexandrov,C,STL,24,0,0,0,0
15,8475235,Nicolas Deslauriers,L,PHI,33,0,0,0,0
15,8481070,Hugh McGing,L,STL,26,0,0,0,0
15,8480836,Jonathan Gruden,C,PIT,24,0,0,0,0
15,8481591,Sam Poulin,R,PIT,23,0,0,0,0
15,8477962,Brendan Lemieux,L,CAR,28,0,0,0,0
15,8483401,Marc Johnstone,R,PIT,28,0,0,0,0
15,8482250,Callahan Burke,C,CAR,27,0,0,0,0
15,8481726,Adam Edstrom,C,NYR,24,0,0,0,0
15,8471817,Ryan Reaves,R,TOR,37,0,0,0,0
15,8479587,Rhett Gardner,C,PHI,28,0,0,0,0
15,8475766,Austin Watson,L,TBL,32,0,0,0,0
15,8479367,William Lockwood,R,FLA,26,0,0,0,0
15,8478424,Jansen Harkins,C,PIT,27,0,0,0,0
15,8476913,Devin Shore,C,SEA,30,0,0,0,0
15,8482652,Walker Duehr,R,CGY,27,0,0,0,0
15,8477527,Ross Johnston,L,ANA,30,0,0,0,0
15,8481077,John Leonard,L,ARI,26,0,0,0,0
15,8483549,Lucas Condotta,L,MTL,27,0,0,0,0
15,8480468,James Hamblin,L,EDM,25,0,0,0,0
15,8476907,Mackenzie MacEachern,L,STL,30,0,0,0,0
15,8479543,Michael Pezzetta,L,MTL,26,0,0,0,0
15,8480355,Mark Kastelic,C,OTT,25,0,0,0,0
15,8482162,Roby Jarventie,L,OTT,22,0,0,0,0
15,8479772,Zack MacEwen,R,OTT,28,0,0,0,0
15,8483597,Milos Kelemen,L,ARI,25,0,0,0,0
15,8479379,Givani Smith,R,SJS,26,0,0,0,0
15,8481655,Cole Schwindt,R,CGY,23,0,0,0,0
15,8479981,Jonah Gadjovich,L,FLA,26,0,0,0,0
15,8482147,Jean-Luc Foudy,C,COL,22,0,0,0,0
15,8484255,Jason Polin,R,COL,25,0,0,0,0
15,8477993,Justin Kirkland,C,ARI,28,0,0,0,0
15,8479249,Andrew Poturalski,C,SEA,30,0,0,0,0
15,8482197,Adam Raska,R,MIN,23,0,0,0,0
15,8475780,Chris Wagner,R,COL,33,0,0,0,0
15,8479533,Joona Koppanen,L,PIT,26,0,0,0,0
15,8481534,Raphael Lavoie,C,EDM,24,0,0,0,0
15,8484321,Nikolas Matinpalo,D,OTT,26,0,0,0,0
15,8481043,Cole Koepke,L,TBL,26,0,0,0,0
15,8476323,Max McCormick,L,SEA,32,0,0,0,0
15,8483609,Adam Klapka,R,CGY,24,0,0,0,0
15,8483512,Matt Savoie,C,BUF,20,0,0,0,0
15,8484259,Ondrej Pavel,C,COL,31,0,0,0,0
15,8478147,Bokondji Imama,L,OTT,28,0,0,0,0
15,8482460,Matt Rempe,C,NYR,22,0,0,0,0
15,8477073,Kurtis MacDermid,L,NJD,30,0,0,0,0
15,8480274,Philip Kemp,D,EDM,25,0,0,0,0
15,8478956,Samuel Laberge,L,NJD,27,0,0,0,0
15,8483045,Cameron Butler,R,CBJ,31,0,0,0,0
16,8477492,Nathan MacKinnon,C,COL,29,82,48,69,117
16,8476453,Nikita Kucherov,R,TBL,31,82,38,79,117
16,8478402,Connor McDavid,C,EDM,27,82,34,79,113
16,8479318,Auston Matthews,C,TOR,27,82,60,48,108
16,8477404,Jake Guentzel,C,CAR,30,82,42,52,94
16,8476887,Filip Forsberg,L,NSH,30,82,41,53,94
16,8480069,Cale Makar,D,COL,26,82,36,58,94
16,8481559,Jack Hughes,C,NJD,23,82,34,59,93
16,8477934,Leon Draisaitl,C,EDM,29,82,32,60,92
16,8478864,Kirill Kaprizov,L,MIN,27,82,40,47,87
16,8479314,Matthew Tkachuk,L,FLA,27,82,36,51,87
16,8477946,Dylan Larkin,C,DET,28,82,35,52,87
16,8477956,David Pastrnak,R,BOS,28,82,38,48,86
16,8478420,Mikko Rantanen,R,COL,28,82,42,43,85
16,8477402,Pavel Buchnevich,L,STL,29,82,31,54,85
16,8476468,J.T. Miller,C,VAN,31,82,36,48,84
16,8482116,Tim Stützle,C,OTT,22,82,29,53,82
16,8475166,John Tavares,C,TOR,34,82,37,44,81
16,8478550,Artemi Panarin,L,NYR,33,82,25,56,81
16,8478403,Jack Eichel,C,VGK,28,82,41,39,80
16,8478439,Travis Konecny,R,PHI,27,82,32,48,80
16,8474564,Steven Stamkos,C,TBL,34,82,35,44,79
16,8474600,Roman Josi,D,NSH,34,82,21,57,78
16,8480002,Nico Hischier,C,NJD,25,82,34,42,76
16,8477960,Adrian Kempe,R,LAK,28,82,34,42,76
16,8480027,Jason Robertson,L,DAL,25,82,32,43,75
16,8475172,Nazem Kadri,C,CGY,34,82,28,47,75
16,8479407,Jesper Bratt,L,NJD,26,82,31,43,74
16,8480830,Andrei Svechnikov,R,CAR,24,82,26,48,74
16,8479343,Clayton Keller,R,ARI,26,82,33,40,73
16,8477493,Aleksander Barkov,C,FLA,29,82,27,46,73
16,8477409,Carter Verhaeghe,C,FLA,29,82,37,35,72
16,8479323,Adam Fox,D,NYR,26,82,20,52,72
16,8478873,Troy Terry,R,ANA,27,82,29,42,71
16,8473419,Brad Marchand,L,BOS,36,82,26,45,71
16,8475167,Victor Hedman,D,TBL,34,82,15,56,71
16,8481523,Kirby Dach,C,MTL,23,82,10,61,71
16,8477933,Sam Reinhart,C,FLA,29,82,38,32,70
16,8478010,Brayden Point,C,TBL,28,82,35,35,70
16,8477939,William Nylander,R,TOR,28,82,32,38,70
16,8471215,Evgeni Malkin,C,PIT,38,82,27,43,70
16,8478445,Mathew Barzal,C,NYI,27,82,16,54,70
16,8480801,Brady Tkachuk,L,OTT,25,82,29,40,69
16,8476454,Ryan Nugent-Hopkins,C,EDM,31,82,27,42,69
16,8481557,Matt Boldy,L,MIN,23,82,33,35,68
16,8479337,Alex DeBrincat,R,DET,27,82,28,40,68
16,8479675,Trevor Moore,L,LAK,29,82,38,29,67
16,8478398,Kyle Connor,L,WPG,28,82,33,34,67
16,8475786,Zach Hyman,L,EDM,32,82,31,36,67
16,8480018,Nick Suzuki,C,MTL,25,82,28,38,66
16,8478042,Viktor Arvidsson,R,LAK,31,82,27,39,66
16,8478440,Dylan Strome,C,WSH,27,82,21,45,66
16,8475692,Mats Zuccarello,R,MIN,37,82,15,50,65
16,8480800,Quinn Hughes,D,VAN,25,82,11,54,65
16,8477955,Jared McCann,L,SEA,28,82,23,41,64
16,8477942,Kevin Fiala,L,LAK,28,82,21,43,64
16,8476346,Johnny Gaudreau,L,CBJ,31,82,16,48,64
16,8476853,Morgan Rielly,D,TOR,30,82,13,51,64
16,8477500,Bo Horvat,C,NYI,29,82,36,27,63
16,8474679,Gustav Nyquist,C,NSH,35,82,27,36,63
16,8471685,Anze Kopitar,C,LAK,37,82,19,44,63
16,8476539,Jonathan Marchessault,R,VGK,34,82,31,31,62
16,8471214,Alex Ovechkin,L,WSH,39,82,30,32,62
16,8479385,Jordan Kyrou,C,STL,26,82,30,32,62
16,8476459,Mika Zibanejad,C,NYR,31,82,23,39,62
16,8471675,Sidney Crosby,C,PIT,37,82,20,42,62
16,8474578,Erik Karlsson,D,PIT,34,82,12,50,62
16,8474590,John Carlson,D,WSH,34,82,10,52,62
16,8478427,Sebastian Aho,C,CAR,27,82,29,32,61
16,8480023,Robert Thomas,C,STL,25,82,27,34,61
16,8475168,Matt Duchene,C,DAL,33,82,25,36,61
16,8480012,Elias Pettersson,C,VAN,26,82,22,39,61
16,8477951,Nick Schmaltz,C,ARI,28,82,23,37,60
16,8477949,Alex Tuch,R,BUF,28,82,19,41,60
16,8476456,Jonathan Huberdeau,C,CGY,31,82,15,45,60
16,8480036,Miro Heiskanen,D,DAL,25,82,9,51,60
16,8479542,Brandon Hagel,L,TBL,26,82,33,26,59
16,8482745,Mason McTavish,C,ANA,21,82,23,36,59
16,8475913,Mark Stone,R,VGK,32,82,17,42,59
16,8475810,Bryan Rust,R,PIT,32,82,33,25,58
16,8478414,Timo Meier,R,NJD,28,82,24,34,58
16,8479325,Charlie McAvoy,D,BOS,27,82,11,47,58
16,8482740,Wyatt Johnston,C,DAL,21,82,31,26,57
16,8479420,Tage Thompson,C,BUF,27,82,28,29,57
16,8482124,Quinton Byfield,R,LAK,22,82,21,36,57
16,8477501,Valeri Nichushkin,R,COL,29,82,34,22,56
16,8475765,Vladimir Tarasenko,R,FLA,33,82,21,35,56
16,8476389,Vincent Trocheck,C,NYR,31,82,18,38,56
16,8478396,Noah Hanifin,D,VGK,27,82,8,48,56
16,8481540,Cole Caufield,R,MTL,23,82,38,17,55
16,8475184,Chris Kreider,L,NYR,33,82,30,25,55
16,8476460,Mark Scheifele,C,WPG,31,82,26,29,55
16,8480039,Martin Necas,C,CAR,25,82,21,34,55
16,8480865,Noah Dobson,D,NYI,24,82,11,44,55
16,8478444,Brock Boeser,R,VAN,27,82,29,25,54
16,8482667,William Eklund,L,SJS,22,82,22,32,54
16,8476881,Tomas Hertl,C,VGK,31,82,19,35,54
16,8477444,Andre Burakovsky,L,SEA,29,82,19,35,54
16,8479999,Casey Mittelstadt,C,COL,26,82,14,40,54
16,8480803,Evan Bouchard,D,EDM,25,82,11,43,54
16,8482159,Tyson Foerster,R,PHI,22,82,19,34,53
16,8478493,Joel Eriksson Ek,C,MIN,27,82,31,21,52
16,8475169,Evander Kane,L,EDM,33,82,30,22,52
16,8477940,Nikolaj Ehlers,L,WPG,28,82,26,26,52
16,8477479,Tyler Bertuzzi,L,TOR,29,82,26,26,52
16,8480839,Rasmus Dahlin,D,BUF,24,82,14,38,52
16,8477447,Shea Theodore,D,VGK,29,82,10,42,52
16,8482097,Jack Quinn,R,BUF,23,82,21,30,51
16,8474157,Max Pacioretty,L,WSH,36,82,21,30,51
16,8481533,Trevor Zegras,C,ANA,23,82,17,34,51
16,8481699,Aku Raty,R,ARI,23,82,3,48,51
16,8478474,Lawson Crouse,L,ARI,27,82,31,19,50
16,8473512,Claude Giroux,R,OTT,36,82,29,21,50
16,8477935,Sam Bennett,C,FLA,28,82,24,26,50
16,8477496,Elias Lindholm,C,VAN,30,82,22,28,50
16,8477416,Oliver Bjorkstrand,R,SEA,29,82,22,28,50
16,8474586,Jordan Eberle,R,SEA,34,82,18,32,50
16,8478975,Mason Marchment,L,DAL,29,82,17,33,50
16,8479400,Pierre-Luc Dubois,L,LAK,26,82,16,34,50
16,8480031,Maxime Comtois,L,CAR,25,82,15,35,50
16,8475798,Mikael Granlund,C,SJS,32,82,11,39,50
16,8478407,Vince Dunn,D,SEA,28,82,9,41,50
16,8478366,Frank Vatrano,R,ANA,30,82,27,22,49
16,8478449,Roope Hintz,C,DAL,28,82,24,25,49
16,8482093,Seth Jarvis,C,CAR,22,82,24,25,49
16,8480014,Gabriel Vilardi,C,WPG,25,82,22,27,49
16,8470794,Joe Pavelski,C,DAL,40,82,21,28,49
16,8478233,Andrew Mangiapane,L,CGY,28,82,21,28,49
16,8477947,Sonny Milano,L,WSH,28,82,20,29,49
16,8482078,Lucas Raymond,L,DET,22,82,19,30,49
16,8475158,Ryan O'Reilly,C,NSH,33,82,19,30,49
16,8478401,Pavel Zacha,C,BOS,27,82,14,35,49
16,8477986,Brandon Montour,D,FLA,30,82,10,39,49
16,8476448,William Karlsson,C,VGK,31,82,27,21,48
16,8475754,Brock Nelson,C,NYI,33,82,26,22,48
16,8480015,Owen Tippett,R,PHI,25,82,25,23,48
16,8474141,Patrick Kane,R,DET,36,82,22,26,48
16,8480208,Drake Batherson,R,OTT,26,82,20,28,48
16,8482684,Luke Hughes,D,NJD,21,82,18,30,48
16,8481711,Matias Maccelli,L,ARI,24,82,12,36,48
16,8482109,Alexis Lafrenière,L,NYR,23,82,25,22,47
16,8476432,Boone Jenner,C,CBJ,31,82,24,23,47
16,8483808,Andrei Kuzmenko,L,CGY,28,82,22,25,47
16,8477476,Artturi Lehkonen,L,COL,29,82,21,26,47
16,8476292,Ondrej Palat,L,NJD,33,82,20,27,47
16,8474641,Adam Henrique,C,EDM,34,82,19,28,47
16,8479339,Patrik Laine,L,CBJ,26,82,15,32,47
16,8475170,Brayden Schenn,C,STL,33,82,14,33,47
16,8479410,Mikhail Sergachev,D,TBL,26,82,11,36,47
16,8483445,Cutter Gauthier,L,ANA,20,82,11,36,47
16,8475794,Tyler Seguin,C,DAL,32,82,17,29,46
16,8478047,Michael Bunting,L,PIT,29,82,16,30,46
16,8473994,Jamie Benn,L,DAL,35,82,15,31,46
16,8476958,Jaccob Slavin,D,CAR,30,82,12,34,46
16,8476399,Blake Coleman,C,CGY,33,82,26,19,45
16,8473986,Alex Killorn,L,ANA,35,82,24,21,45
16,8482101,Danil Gushchin,L,SJS,22,82,22,23,45
16,8478460,Zach Werenski,D,CBJ,27,82,10,35,45
16,8478038,Devon Toews,D,COL,30,82,10,35,45
16,8474565,Alex Pietrangelo,D,VGK,34,82,9,36,45
16,8482699,Dylan Guenther,R,ARI,21,82,25,19,44
16,8476462,Dougie Hamilton,D,NJD,31,82,20,24,44
16,8476869,Brady Skjei,D,CAR,30,82,13,31,44
16,8480798,Philipp Kurashev,C,CHI,25,82,9,35,44
16,8476458,Ryan Strome,C,ANA,31,82,9,35,44
16,8476483,Rickard Rakell,R,PIT,31,82,25,18,43
16,8475791,Taylor Hall,L,CHI,33,82,17,26,43
16,8481481,Blake Lizotte,C,LAK,27,82,14,29,43
16,8475744,Evgeny Kuznetsov,C,CAR,32,82,12,31,43
16,8481618,Alex Newhook,C,MTL,23,82,11,32,43
16,8475151,Kyle Palmieri,C,NYI,33,82,20,22,42
16,8481068,Yegor Sharangovich,C,CGY,26,82,19,23,42
16,8475287,Erik Haula,L,NJD,33,82,17,25,42
16,8477497,Sean Monahan,C,WPG,30,82,16,26,42
16,8474563,Drew Doughty,D,LAK,35,82,5,37,42
16,8483524,Shane Wright,C,SEA,20,82,30,11,41
16,8480797,Joel Farabee,L,PHI,24,82,18,23,41
16,8478542,Evan Rodrigues,C,FLA,31,82,18,23,41
16,8475745,Charlie Coyle,C,BOS,32,82,17,24,41
16,8481596,Shane Pinto,C,OTT,24,82,16,25,41
16,8476905,Chandler Stephenson,C,VGK,30,82,15,26,41
16,8471218,Blake Wheeler,R,NYR,38,82,14,27,41
16,8478397,Rasmus Andersson,D,CGY,28,82,11,30,41
16,8479345,Jakob Chychrun,D,OTT,26,82,11,30,41
16,8477346,MacKenzie Weegar,D,CGY,30,82,7,34,41
16,8476479,Phillip Danault,C,LAK,31,82,23,17,40
16,8475726,Tyler Toffoli,C,WPG,32,82,19,21,40
16,8480188,Fabian Zetterlund,L,SJS,25,82,19,21,40
16,8478438,Tommy Novak,C,NSH,27,82,18,22,40
16,8475784,Jeff Skinner,C,BUF,32,82,17,23,40
16,8479987,Morgan Geekie,C,BOS,26,82,16,24,40
16,8476880,Tom Wilson,R,WSH,30,82,15,25,40
16,8482110,Dawson Mercer,C,NJD,23,82,15,25,40
16,8475753,Justin Faulk,D,STL,32,82,6,34,40
16,8476392,Adam Lowry,C,WPG,31,82,18,21,39
16,8477451,Ryan Hartman,R,MIN,30,82,17,22,39
16,8478458,Jack Roslovic,C,NYR,27,82,17,22,39
16,8475763,Kevin Hayes,R,STL,32,82,15,24,39
16,8480078,Filip Chytil,C,NYR,25,82,14,25,39
16,8476826,Yanni Gourde,C,SEA,33,82,14,25,39
16,8482113,Anton Lundell,C,FLA,23,82,13,26,39
16,8477494,Jonathan Drouin,L,COL,29,82,13,26,39
16,8479996,Cody Glass,C,NSH,25,82,13,26,39
16,8470613,Brent Burns,D,CAR,39,82,7,32,39
16,8475764,Cam Fowler,D,ANA,33,82,4,35,39
16,8477407,Anthony Duclair,L,TBL,29,82,23,15,38
16,8484144,Connor Bedard,C,CHI,19,82,17,21,38
16,8476329,Travis Boyd,C,ARI,31,82,17,21,38
16,8478856,Conor Garland,R,VAN,28,82,16,22,38
16,8481528,Dylan Cozens,C,BUF,23,82,15,23,38
16,8474037,James van Riemsdyk,L,BOS,35,82,14,24,38
16,8482146,Luke Evangelista,R,NSH,22,82,13,25,38
16,8474149,Evgenii Dadonov,R,DAL,35,82,12,26,38
16,8476875,Mike Matheson,D,MTL,30,82,10,28,38
16,8479425,Filip Hronek,D,VAN,27,82,9,29,38
16,8475906,John Klingberg,D,TOR,32,82,9,29,38
16,8477948,Travis Sanheim,D,PHI,28,82,6,32,38
16,8477495,Seth Jones,D,CHI,30,82,4,34,38
16,8480064,Josh Norris,C,OTT,25,82,24,13,37
16,8474870,Tyler Johnson,C,CHI,34,82,21,16,37
16,8478498,Jake DeBrusk,L,BOS,28,82,17,20,37
16,8478519,Anthony Cirelli,C,TBL,27,82,17,20,37
16,8474102,David Perron,L,DET,36,82,17,20,37
16,8478472,Mathieu Joseph,R,OTT,27,82,16,21,37
16,8481624,Ilya Mikheyev,R,VAN,30,82,14,23,37
16,8478462,Nicolas Roy,C,VGK,27,82,14,23,37
16,8478413,Jordan Greenway,L,BUF,27,82,14,23,37
16,8480185,Eetu Luostarinen,C,FLA,26,82,12,25,37
16,8482133,Thomas Bordeleau,C,SJS,22,82,11,26,37
16,8482665,Matty Beniers,C,SEA,22,82,9,28,37
16,8475197,Tyson Barrie,D,NSH,33,82,9,28,37
16,8480434,Sean Durzi,D,ARI,26,82,6,31,37
16,8477504,Josh Morrissey,D,WPG,29,82,3,34,37
16,8479423,Alex Nylander,L,CBJ,26,82,21,15,36
16,8482475,Yegor Chinakhov,R,CBJ,23,82,19,17,36
16,8471698,T.J. Oshie,R,WSH,38,82,16,20,36
16,8480028,Morgan Frost,C,PHI,25,82,16,20,36
16,8477964,Ivan Barbashev,C,VGK,29,82,15,21,36
16,8479992,Michael Rasmussen,C,DET,25,82,15,21,36
16,8474150,Mikael Backlund,C,CGY,35,82,14,22,36
16,8479365,Trent Frederic,C,BOS,26,82,14,22,36
16,8478055,Gustav Forsling,D,FLA,28,82,13,23,36
16,8476882,Teuvo Teravainen,L,CAR,30,82,12,24,36
16,8477021,Alex Kerfoot,C,ARI,30,82,12,24,36
16,8480817,K'Andre Miller,D,NYR,24,82,12,24,36
16,8482079,Marco Rossi,C,MIN,23,82,12,24,36
16,8473449,Kyle Okposo,R,FLA,36,82,12,24,36
16,8478469,Thomas Chabot,D,OTT,27,82,9,27,36
16,8481542,Moritz Seider,D,DET,23,82,6,30,36
16,8476438,Brandon Saad,L,STL,32,82,24,11,35
16,8475314,Anders Lee,L,NYI,34,82,21,14,35
16,8477944,Jakub Vrana,L,STL,28,82,19,16,35
16,8475191,Reilly Smith,R,PIT,33,82,19,16,35
16,8478057,Dakota Joshua,C,VAN,28,82,15,20,35
16,8478046,Danton Heinen,L,BOS,29,82,13,22,35
16,8477932,Aaron Ekblad,D,FLA,28,82,10,25,35
16,8483397,Marc McLaughlin,C,BOS,25,82,28,6,34
16,8475760,Nick Bjugstad,C,ARI,32,82,21,13,34
16,8481604,Pavel Dorofeyev,L,VGK,24,82,20,14,34
16,8475722,Jason Zucker,L,NSH,32,82,20,14,34
16,8475793,Ryan Johansen,C,PHI,32,82,19,15,34
16,8475799,Nino Niederreiter,R,WPG,32,82,17,17,34
16,8474884,Mike Hoffman,C,SJS,35,82,17,17,34
16,8479415,Michael McLeod,C,NJD,26,82,16,18,34
16,8478466,Daniel Sprong,R,DET,27,82,15,19,34
16,8480220,Noah Cates,L,PHI,25,82,12,22,34
16,8474053,Logan Couture,C,SJS,35,82,12,22,34
16,8475149,Marcus Johansson,L,MIN,34,82,12,22,34
16,8481581,Thomas Harley,D,DAL,23,82,8,26,34
16,8476906,Shayne Gostisbehere,D,DET,31,82,6,28,34
16,8482105,Jake Sanderson,D,OTT,22,82,6,28,34
16,8477511,Anthony Mantha,R,VGK,30,82,20,13,33
16,8477450,Jason Dickinson,C,CHI,29,82,15,18,33
16,8475714,Calle Jarnkrok,C,TOR,33,82,14,19,33
16,8480849,Barrett Hayton,C,ARI,24,82,13,20,33
16,8477426,Nicholas Paul,L,TBL,29,82,12,21,33
16,8482705,Cole Sillinger,C,CBJ,21,82,12,21,33
16,8476925,Colton Sissons,C,NSH,31,82,11,22,33
16,8482671,Owen Power,D,BUF,22,82,11,22,33
16,8481013,Jonatan Berggren,R,DET,24,82,11,22,33
16,8477953,Kasperi Kapanen,R,STL,28,82,11,22,33
16,8482624,Daniil Miromanov,D,CGY,27,82,9,24,33
16,8482720,Matthew Knies,L,TOR,22,82,8,25,33
16,8481554,Kaapo Kakko,R,NYR,23,82,20,12,32
16,8475768,Jaden Schwartz,C,SEA,32,82,17,15,32
16,8482702,Logan Stankoven,C,DAL,21,82,16,16,32
16,8483499,Liam Ohgren,L,MIN,20,82,16,16,32
16,8477456,J.T. Compher,L,DET,29,82,13,19,32
16,8479353,Brett Howden,C,VGK,26,82,13,19,32
16,8477998,Warren Foegele,L,EDM,28,82,12,20,32
16,8476897,Oskar Sundqvist,C,STL,30,82,9,23,32
16,8482142,Jamie Drysdale,D,PHI,22,82,8,24,32
16,8476931,Jake McCabe,D,TOR,31,82,7,25,32
16,8481580,Connor McMichael,C,WSH,23,82,15,16,31
16,8480068,Ryan Poehling,C,PHI,25,82,14,17,31
16,8477503,Max Domi,C,TOR,29,82,9,22,31
16,8477429,Andrew Copp,C,DET,30,82,9,22,31
16,8478133,Jake Evans,C,MTL,28,82,9,22,31
16,8471724,Kris Letang,D,PIT,37,82,8,23,31
16,8476979,Erik Gustafsson,D,NYR,32,82,5,26,31
16,8481606,Jordan Spence,D,LAK,23,82,5,26,31
16,8483515,Juraj Slafkovsky,L,MTL,20,82,17,13,30
16,8482055,Drew O'Connor,L,PIT,26,82,16,14,30
16,8476419,Jean-Gabriel Pageau,C,NYI,32,82,13,17,30
16,8478463,Anthony Beauvillier,L,NSH,27,82,13,17,30
16,8481186,Logan O'Connor,R,COL,28,82,11,19,30
16,8477498,Darnell Nurse,D,EDM,29,82,10,20,30
16,8479525,Ross Colton,C,COL,28,82,9,21,30
16,8482125,Alexander Holtz,R,NJD,22,82,9,21,30
16,8480873,Rasmus Sandin,D,WSH,24,82,7,23,30
16,8476923,Damon Severson,D,CBJ,30,82,6,24,30
16,8479976,Juuso Valimaki,D,ARI,26,82,3,27,30
16,8479591,Michael Eyssimont,C,TBL,28,82,18,11,29
16,8470610,Zach Parise,L,COL,40,82,17,12,29
16,8481535,Nils Hoglander,L,VAN,24,82,17,12,29
16,8484203,Bradly Nadeau,L,CAR,19,82,17,12,29
16,8480806,Isac Lundestrom,C,ANA,25,82,15,14,29
16,8481560,Arthur Kaliyev,R,LAK,23,82,14,15,29
16,8481656,Aliaksei Protas,C,WSH,23,82,11,18,29
16,8476921,Jordan Martinook,L,CAR,32,82,11,18,29
16,8480871,Adam Boqvist,D,CBJ,24,82,10,19,29
16,8481703,Valtteri Puustinen,R,PIT,25,82,8,21,29
16,8474034,Pat Maroon,L,BOS,36,82,8,21,29
16,8475181,Nick Leddy,D,STL,33,82,4,25,29
16,8480145,Neal Pionk,D,WPG,29,82,4,25,29
16,8483471,Brad Lambert,C,WPG,31,82,3,26,29
16,8482733,Logan Mailloux,D,MTL,31,82,3,26,29
16,8480893,Kirill Marchenko,R,CBJ,24,82,19,9,28
16,8479293,Brandon Tanev,L,SEA,33,82,17,11,28
16,8482074,Connor Zary,C,CGY,23,82,17,11,28
16,8481477,Nico Sturm,C,SJS,29,82,16,12,28
16,8475848,Brendan Gallagher,R,MTL,32,82,14,14,28
16,8478115,Pierre Engvall,L,NYI,28,82,14,14,28
16,8474715,Cam Atkinson,R,PHI,35,82,13,15,28
16,8480459,Pius Suter,C,VAN,28,82,12,16,28
16,8479514,Rem Pitlick,C,CHI,27,82,12,16,28
16,8478013,Jake Walman,D,DET,28,82,11,17,28
16,8481553,Bobby Brink,R,PHI,23,82,11,17,28
16,8484153,Leo Carlsson,C,ANA,20,82,10,18,28
16,8479977,Kailer Yamamoto,R,SEA,26,82,10,18,28
16,8476854,Hampus Lindholm,D,BOS,30,82,9,19,28
16,8477488,Brett Pesce,D,CAR,30,82,4,24,28
16,8483457,Lane Hutson,D,MTL,20,82,2,26,28
16,8480246,Nick Perbix,D,TBL,26,82,1,27,28
16,8482089,Jake Neighbours,L,STL,22,82,18,9,27
16,8482222,Alexander Barabanov,L,SJS,30,82,15,12,27
16,8480802,Ryan McLeod,C,EDM,25,82,13,14,27
16,8480855,Jack McBain,C,ARI,24,82,13,14,27
16,8477989,Christian Dvorak,C,MTL,28,82,13,14,27
16,8484145,Zach Benson,L,BUF,19,82,11,16,27
16,8480009,Eeli Tolvanen,R,SEA,25,82,8,19,27
16,8476927,Teddy Blueger,C,VAN,30,82,7,20,27
16,8480834,Ty Emberson,D,SJS,24,82,7,20,27
16,8476792,Torey Krug,D,STL,33,82,2,25,27
16,8479359,Beck Malenstyn,L,WSH,26,82,15,11,26
16,8475220,Marcus Foligno,L,MIN,33,82,12,14,26
16,8482175,JJ Peterka,R,BUF,22,82,10,16,26
16,8482092,Ridly Greig,C,OTT,22,82,9,17,26
16,8480113,Alex Iafallo,L,WPG,31,82,9,17,26
16,8478911,Matt Roy,D,LAK,29,82,9,17,26
16,8479351,Sam Steel,C,DAL,26,82,9,17,26
16,8476312,Josh Manson,D,COL,33,82,8,18,26
16,8476457,Adam Larsson,D,SEA,32,82,8,18,26
16,8480043,Timothy Liljegren,D,TOR,25,82,6,20,26
16,8479398,Samuel Girard,D,COL,26,82,5,21,26
16,8482117,Lukas Reichel,L,CHI,22,82,5,21,26
16,8479983,Mario Ferraro,D,SJS,26,82,5,21,26
16,8478859,Niko Mikkola,D,FLA,28,82,4,22,26
16,8480035,Henri Jokiharju,D,BUF,25,82,3,23,26
16,8476981,Josh Anderson,R,MTL,30,82,17,8,25
16,8484166,Adam Fantilli,C,CBJ,20,82,16,9,25
16,8478109,Victor Olofsson,L,BUF,29,82,15,10,25
16,8479346,Dillon Dube,C,CGY,26,82,15,10,25
16,8481093,Rafael Harvey-Pinard,L,MTL,25,82,15,10,25
16,8479390,Taylor Raddysh,R,CHI,26,82,14,11,25
16,8476469,Joel Armia,R,MTL,31,82,14,11,25
16,8476892,Colton Parayko,D,STL,31,82,10,15,25
16,8473563,Nicklas Backstrom,C,WSH,37,82,9,16,25
16,8477839,Conor Sheary,L,TBL,32,82,7,18,25
16,8478451,Ethan Bear,D,WSH,27,82,7,18,25
16,8477506,Ryan Pulock,D,NYI,30,82,6,19,25
16,8476967,Brett Kulak,D,EDM,30,82,6,19,25
16,8482166,Shakir Mukhamadullin,D,SJS,22,82,6,19,25
16,8478851,Alexandre Carrier,D,NSH,28,82,5,20,25
16,8478840,Will Borgen,D,SEA,28,82,4,21,25
16,8475171,Oliver Ekman-Larsson,D,FLA,33,82,3,22,25
16,8477969,Marcus Pettersson,D,PIT,28,82,1,24,25
16,8475790,Erik Gudbranson,D,CBJ,32,82,1,24,25
16,8479941,Justin Danforth,R,CBJ,31,82,14,10,24
16,8475343,Nic Dowd,C,WSH,34,82,13,11,24
16,8474189,Lars Eller,C,PIT,35,82,13,11,24
16,8476960,Andreas Athanasiou,C,CHI,30,82,12,12,24
16,8477952,Robby Fabbri,C,DET,28,82,12,12,24
16,8473533,Jordan Staal,C,CAR,36,82,12,12,24
16,8479316,Luke Kunin,C,SJS,27,82,11,13,24
16,8475231,Casey Cizikas,C,NYI,33,82,8,16,24
16,8481546,Cam York,D,PHI,23,82,6,18,24
16,8481178,Egor Zamula,D,PHI,24,82,6,18,24
16,8480144,David Kampf,C,TOR,29,82,3,21,24
16,8481568,Alex Vlasic,D,CHI,23,82,3,21,24
16,8474673,TJ Brodie,D,TOR,34,82,1,23,24
16,8481517,Brett Leason,R,ANA,25,82,15,8,23
16,8473422,Nick Foligno,L,CHI,37,82,11,12,23
16,8476872,Scott Laughton,C,PHI,30,82,9,14,23
16,8476885,Jacob Trouba,D,NYR,30,82,9,14,23
16,8476871,Tanner Pearson,L,MTL,32,82,9,14,23
16,8478891,Mason Appleton,C,WPG,28,82,8,15,23
16,8476461,Sean Couturier,C,PHI,32,82,8,15,23
16,8475218,Mattias Ekholm,D,EDM,34,82,7,16,23
16,8475177,Calvin de Haan,D,TBL,33,82,7,16,23
16,8480813,Joe Veleno,C,DET,24,82,6,17,23
16,8478430,Oliver Kylington,D,CGY,27,82,5,18,23
16,8481016,Ruslan Iskhakov,C,NYI,24,82,4,19,23
16,8478178,Darren Raddysh,D,TBL,28,82,4,19,23
16,8478500,Ivan Provorov,D,CBJ,27,82,3,20,23
16,8475179,Dmitry Kulikov,D,FLA,34,82,2,21,23
16,8482122,Brock Faber,D,MIN,22,82,1,22,23
16,8482118,Sam Colangelo,R,ANA,23,82,14,8,22
16,8478569,Noel Acciari,C,PIT,33,82,12,10,22
16,8477425,Miles Wood,L,COL,29,82,9,13,22
16,8475200,Dmitry Orlov,D,CAR,33,82,7,15,22
16,8482073,Braden Schneider,D,NYR,23,82,7,15,22
16,8477919,Frederick Gaudreau,C,MIN,31,82,6,16,22
16,8475462,Radko Gudas,D,ANA,34,82,5,17,22
16,8470600,Ryan Suter,D,DAL,39,82,4,18,22
16,8474716,Jared Spurgeon,D,MIN,35,82,3,19,22
16,8478507,John Marino,D,NJD,27,82,2,20,22
16,8483493,Frank Nazar,C,CHI,20,82,15,6,21
16,8482809,Jackson Blake,R,CAR,21,82,13,8,21
16,8476374,Sean Kuraly,C,CBJ,31,82,10,11,21
16,8480980,Connor Dewar,C,TOR,25,82,10,11,21
16,8476278,Colin Blackwell,C,CHI,31,82,9,12,21
16,8478020,Michael Amadio,C,VGK,28,82,8,13,21
16,8478043,Sam Lafferty,C,VAN,29,82,8,13,21
16,8482062,Cole Smith,L,NSH,29,82,8,13,21
16,8481601,Simon Holmstrom,R,NYI,23,82,7,14,21
16,8481522,Peyton Krebs,C,BUF,23,82,7,14,21
16,8476902,Esa Lindell,D,DAL,30,82,6,15,21
16,8474151,Ryan McDonagh,D,NSH,35,82,5,16,21
16,8481524,Bowen Byram,D,BUF,23,82,4,17,21
16,8474574,Tyler Myers,D,VAN,34,82,3,18,21
16,8470621,Corey Perry,R,EDM,39,82,13,7,20
16,8483431,Logan Cooley,C,ARI,20,82,12,8,20
16,8479393,Noah Gregor,C,TOR,26,82,11,9,20
16,8483505,Matthew Poitras,C,BOS,20,82,10,10,20
16,8479661,Tanner Jeannot,L,TBL,27,82,10,10,20
16,8482155,Alex Laferriere,R,LAK,23,82,10,10,20
16,8482737,Zack Bolduc,C,STL,21,82,7,13,20
16,8475690,Chris Tanev,D,DAL,35,82,6,14,20
16,8481028,Martin Pospisil,C,CGY,25,82,5,15,20
16,8481014,Alexander Romanov,D,NYI,24,82,5,15,20
16,8482655,J.J. Moser,D,ARI,24,82,4,16,20
16,8475188,Brayden McNabb,D,VGK,33,82,3,17,20
16,8478508,Yakov Trenin,C,COL,27,82,12,7,19
16,8476873,Mark Jankowski,C,NSH,30,82,11,8,19
16,8483491,Ivan Miroshnichenko,L,WSH,20,82,11,8,19
16,8476858,Phillip Di Giuseppe,L,VAN,31,82,8,11,19
16,8483482,Tristan Luneau,D,ANA,20,82,7,12,19
16,8477508,Curtis Lazar,C,NJD,29,82,6,13,19
16,8477507,Nikita Zadorov,D,VAN,29,82,5,14,19
16,8478882,Vladislav Gavrikov,D,LAK,29,82,3,16,19
16,8476463,Jonas Brodin,D,MIN,31,82,3,16,19
16,8476879,Cody Ceci,D,EDM,31,82,3,16,19
16,8482712,Oskar Olausson,R,COL,22,82,2,17,19
16,8478136,Jake Middleton,D,MIN,28,82,2,17,19
16,8476917,Adam Pelech,D,NYI,30,82,2,17,19
16,8479371,Dante Fabbro,D,NSH,26,82,2,17,19
16,8480336,Sean Walker,D,COL,30,82,1,18,19
16,8477330,Dominik Kubalik,L,OTT,29,82,10,8,18
16,8475164,Jakob Silfverberg,R,ANA,34,82,10,8,18
16,8477406,Mattias Janmark,C,EDM,32,82,9,9,18
16,8482679,Matt Coronato,R,CGY,22,82,8,10,18
16,8476480,Vladislav Namestnikov,C,WPG,32,82,7,11,18
16,8474166,Alec Martinez,D,VGK,37,82,5,13,18
16,8480073,Erik Brannstrom,D,OTT,25,82,4,14,18
16,8475762,Derek Forbort,D,BOS,32,82,4,14,18
16,8477499,Rasmus Ristolainen,D,PHI,30,82,4,14,18
16,8473507,Jeff Petry,D,DET,37,82,3,15,18
16,8481605,Jackson LaCombe,D,ANA,23,82,3,15,18
16,8476878,Zemgus Girgensons,L,BUF,30,82,10,7,17
16,8481704,Juuso Parssinen,C,NSH,23,82,8,9,17
16,8483489,Fraser Minten,C,TOR,31,82,7,10,17
16,8482730,Brandt Clarke,D,LAK,21,82,6,11,17
16,8476442,Matt Nieto,L,PIT,32,82,6,11,17
16,8473453,Trevor Lewis,C,LAK,37,82,6,11,17
16,8477392,Hudson Fasching,R,NYI,29,82,6,11,17
16,8475324,Nick Jensen,D,WSH,34,82,5,12,17
16,8483495,Simon Nemec,D,NJD,20,82,5,12,17
16,8476331,Dylan DeMelo,D,WPG,31,82,4,13,17
16,8477365,Connor Clifton,D,BUF,29,82,4,13,17
16,8477435,Ryan Graves,D,PIT,29,82,4,13,17
16,8480807,Mattias Samuelsson,D,BUF,24,82,4,13,17
16,8479369,Andrew Peeke,D,BOS,26,82,4,13,17
16,8483565,Nick Blankenburg,D,CBJ,26,82,4,13,17
16,8479980,Nicolas Hague,D,VGK,26,82,4,13,17
16,8470966,Mark Giordano,D,TOR,41,82,4,13,17
16,8482087,Kaiden Guhle,D,MTL,22,82,3,14,17
16,8480172,Jan Rutta,D,SJS,34,82,2,15,17
16,8480796,Martin Fehervary,D,WSH,25,82,2,15,17
16,8478416,Erik Cernak,D,TBL,27,82,1,16,17
16,8475233,David Savard,D,MTL,34,82,0,17,17
16,8482145,Mavrik Bourque,C,DAL,22,82,12,4,16
16,8477353,Tyler Motte,C,TBL,29,82,9,7,16
16,8478468,Jeremy Lauzon,D,NSH,27,82,9,7,16
16,8481537,Nikita Okhotiuk,D,CGY,24,82,9,7,16
16,8477931,Tomas Nosek,L,NJD,32,82,7,9,16
16,8477335,Kyle Burroughs,D,SJS,29,82,5,11,16
16,8475825,Jani Hakanpää,D,DAL,32,82,3,13,16
16,8478443,Brandon Carlo,D,BOS,28,82,3,13,16
16,8480058,Pierre-Olivier Joseph,D,PIT,25,82,2,14,16
16,8480879,Jacob Bernard-Docker,D,OTT,24,82,2,14,16
16,8480821,Filip Zadina,R,SJS,25,82,11,4,15
16,8480281,Alexey Toropchenko,R,STL,25,82,9,6,15
16,8476624,Barclay Goodrow,C,NYR,31,82,7,8,15
16,8473504,Cal Clutterbuck,R,NYI,37,82,6,9,15
16,8479383,Boris Katchouk,L,OTT,26,82,6,9,15
16,8480074,Alexandre Texier,C,CBJ,25,82,5,10,15
16,8480860,Kevin Bahl,D,NJD,24,82,3,12,15
16,8483490,Pavel Mintyukov,D,ANA,21,82,2,13,15
16,8477505,Alexander Wennberg,C,NYR,30,82,2,13,15
16,8475455,Brenden Dillon,D,WPG,34,82,2,13,15
16,8478399,Jonas Siegenthaler,D,NJD,27,82,1,14,15
16,8481059,Scott Perunovich,D,STL,26,82,1,14,15
16,8482259,Bobby McMann,C,TOR,28,82,7,7,14
16,8470604,Jeff Carter,C,PIT,39,82,5,9,14
16,8482803,Olen Zellweger,D,ANA,21,82,4,10,14
16,8482807,Ethan Del Mastro,D,CHI,21,82,4,10,14
16,8483468,Jiri Kulich,C,BUF,20,82,4,10,14
16,8482245,Artem Zub,D,OTT,29,82,3,11,14
16,8476891,Matt Grzelcyk,D,BOS,30,82,2,12,14
16,8477845,Trevor van Riemsdyk,D,WSH,33,82,2,12,14
16,8475208,Brian Dumoulin,D,SEA,33,82,2,12,14
16,8482470,Ilya Solovyov,D,CGY,24,82,1,13,14
16,8484911,Collin Graf,R,SJS,22,82,1,13,14
16,8477220,Nate Schmidt,D,WPG,33,82,0,14,14
16,8481030,Jack St. Ivany,D,PIT,25,82,5,8,13
16,8475279,Ben Chiarot,D,DET,33,82,4,9,13
16,8475842,Sam Carrick,C,EDM,32,82,4,9,13
16,8476372,Nick Seeler,D,PHI,31,82,4,9,13
16,8476525,Colin Miller,D,WPG,32,82,3,10,13
16,8474009,Nick Bonino,C,NYR,36,82,3,10,13
16,8477034,Jaycob Megna,D,CHI,32,82,3,10,13
16,8483466,Kevin Korchinski,D,CHI,20,82,2,11,13
16,8476429,Scott Mayfield,D,NYI,32,82,2,11,13
16,8482516,Matthew Kessel,D,STL,24,82,2,11,13
16,8477369,Carson Soucy,D,VAN,30,82,7,5,12
16,8482762,Simon Edvinsson,D,DET,21,82,7,5,12
16,8476422,Mike Reilly,D,NYI,31,82,6,6,12
16,8482111,Justin Barron,D,MTL,23,82,6,6,12
16,8482666,Scott Morrow,D,CAR,22,82,5,7,12
16,8481578,Graeme Clarke,R,NJD,23,82,5,7,12
16,8480448,Parker Kelly,L,OTT,25,82,4,8,12
16,8482177,Marat Khusnutdinov,C,MIN,22,82,3,9,12
16,8476467,Jamie Oleksiak,D,SEA,32,82,2,10,12
16,8478408,Travis Dermott,D,ARI,28,82,6,5,11
16,8477015,Connor Brown,R,EDM,30,82,4,7,11
16,8481567,Henry Thrun,D,SJS,23,82,4,7,11
16,8483763,Maksymilian Szuber,D,ARI,22,82,3,8,11
16,8471677,Jack Johnson,D,COL,37,82,0,11,11
16,8476473,Connor Murphy,D,CHI,31,82,6,4,10
16,8480990,Declan Chisholm,D,MIN,24,82,4,6,10
16,8478831,Kevin Stenlund,C,FLA,28,82,3,7,10
16,8476822,Luke Glendening,C,TBL,35,82,7,2,9
16,8479291,Kevin Rooney,C,CGY,31,82,7,2,9
16,8483012,Logan Morrison,C,SEA,22,82,6,3,9
16,8482859,Zack Ostapchuk,C,OTT,21,82,2,7,9
16,8481599,Victor Soderstrom,D,ARI,23,82,1,8,9
16,8479998,Mikey Anderson,D,LAK,25,82,3,5,8
16,8476915,Jujhar Khaira,L,MIN,30,82,2,6,8
16,8482858,Ryker Evans,D,SEA,23,82,2,6,8
16,8474013,Ian Cole,D,VAN,35,82,2,6,8
16,8482713,Mackie Samoskevich,R,FLA,22,82,5,2,7
16,8479442,Troy Stecher,D,EDM,30,82,2,5,7
16,8484149,Gavin Brindley,C,CBJ,20,82,2,5,7
16,8474567,Zach Bogosian,D,MIN,34,82,0,7,7
16,8479324,Ryan Lindgren,D,NYR,26,82,0,7,7
16,8482141,Lukas Cormier,D,VGK,22,0,0,0,0
16,8476988,Matt Benning,D,SJS,30,0,0,0,0
16,8480727,Zach Whitecloud,D,VGK,28,0,0,0,0
16,8480887,Jordan Harris,D,MTL,24,0,0,0,0
16,8478450,Parker Wotherspoon,D,BOS,27,0,0,0,0
16,8481812,Nikolai Knyzhov,D,SJS,27,0,0,0,0
16,8480001,Urho Vaakanainen,D,ANA,25,0,0,0,0
16,8482176,Wyatt Kaiser,D,CHI,22,0,0,0,0
16,8481122,Simon Benoit,D,TOR,26,0,0,0,0
16,8476441,Joel Edmundson,D,TOR,31,0,0,0,0
16,8480884,Calen Addison,D,SJS,24,0,0,0,0
16,8482511,Mason Lohrei,D,BOS,23,0,0,0,0
16,8482192,Isaak Phillips,D,CHI,23,0,0,0,0
16,8480950,Ilya Lyubushkin,D,TOR,30,0,0,0,0
16,8474031,Kevin Shattenkirk,D,BOS,35,0,0,0,0
16,8475718,Justin Holl,D,DET,32,0,0,0,0
16,8479402,Jake Bean,D,CBJ,26,0,0,0,0
16,8474602,Justin Schultz,D,SEA,34,0,0,0,0
16,8477950,Tony DeAngelo,D,CAR,29,0,0,0,0
16,8481743,Marc Del Gaizo,D,NSH,25,0,0,0,0
16,8481527,Kaedan Korczak,D,VGK,23,0,0,0,0
16,8480192,Johnathan Kovacevic,D,MTL,27,0,0,0,0
16,8476874,Olli Maatta,D,DET,30,0,0,0,0
16,8482144,Jack Thompson,D,SJS,22,0,0,0,0
16,8480222,Sebastian Aho,D,NYI,28,0,0,0,0
16,8479458,Nikita Zaitsev,D,CHI,33,0,0,0,0
16,8471709,Marc-Edouard Vlasic,D,SJS,37,0,0,0,0
16,8482929,Emil Lilleberg,D,TBL,23,0,0,0,0
16,8477018,Ben Hutton,D,VGK,31,0,0,0,0
16,8481056,Spencer Stastney,D,NSH,24,0,0,0,0
16,8481593,Jayden Struble,D,MTL,23,0,0,0,0
16,8479982,Conor Timmins,D,TOR,26,0,0,0,0
16,8474090,Brendan Smith,D,NJD,35,0,0,0,0
16,8482964,Arber Xhekaj,D,MTL,23,0,0,0,0
16,8480891,Michael Kesselring,D,ARI,24,0,0,0,0
16,8477938,Haydn Fleury,D,TBL,28,0,0,0,0
16,8481806,Louis Crevier,D,CHI,23,0,0,0,0
16,8471274,Alex Goligoski,D,MIN,39,0,0,0,0
16,8481600,Tobias Bjornfot,D,FLA,23,0,0,0,0
16,8475797,Jarred Tinordi,D,CHI,32,0,0,0,0
16,8481521,Ronnie Attard,D,PHI,25,0,0,0,0
16,8474612,Travis Hamonic,D,OTT,34,0,0,0,0
16,8479576,Vincent Desharnais,D,EDM,28,0,0,0,0
16,8480049,Dylan Samberg,D,WPG,25,0,0,0,0
16,8483619,Filip Roos,D,CHI,25,0,0,0,0
16,8474568,Luke Schenn,D,NSH,35,0,0,0,0
16,8480184,Gustav Lindstrom,D,ANA,26,0,0,0,0
16,8480070,Ian Mitchell,D,BOS,25,0,0,0,0
16,8480196,Jacob Bryson,D,BUF,27,0,0,0,0
16,8471686,Marc Staal,D,PHI,37,0,0,0,0
16,8477467,Gustav Olofsson,D,SEA,30,0,0,0,0
16,8478970,Jalen Chatfield,D,CAR,28,0,0,0,0
16,8479348,Kale Clague,D,BUF,26,0,0,0,0
16,8473446,Erik Johnson,D,PHI,36,0,0,0,0
16,8477462,Robert Hagg,D,ANA,29,0,0,0,0
16,8478454,Noah Juulsen,D,VAN,27,0,0,0,0
16,8477384,Josh Brown,D,ARI,30,0,0,0,0
16,8481708,Zac Jones,D,NYR,24,0,0,0,0
16,8481167,Brayden Pachal,D,CGY,25,0,0,0,0
16,8482067,Connor Mackey,D,NYR,28,0,0,0,0
16,8483460,David Jiricek,D,CBJ,21,0,0,0,0
16,8481701,Santeri Hatakka,D,NJD,23,0,0,0,0
16,8478021,William Lagesson,D,ANA,28,0,0,0,0
16,8477851,Jordan Oesterle,D,CGY,32,0,0,0,0
16,8478452,Caleb Jones,D,COL,27,0,0,0,0
16,8479984,Cal Foote,D,NJD,26,0,0,0,0
16,8479639,Dylan Coghlan,D,CAR,26,0,0,0,0
16,8480874,Adam Ginning,D,PHI,24,0,0,0,0
16,8479321,Lucas Johansen,D,WSH,27,0,0,0,0
16,8480878,Nils Lundkvist,D,DAL,24,0,0,0,0
16,8482165,Yan Kuznetsov,D,CGY,22,0,0,0,0
16,8484258,Sam Malinski,D,COL,26,0,0,0,0
16,8480157,Calle Rosen,D,STL,30,0,0,0,0
16,8484304,Uvis Balinskis,D,FLA,28,0,0,0,0
16,8479985,Cale Fleury,D,SEA,26,0,0,0,0
16,8479378,Logan Stanley,D,WPG,26,0,0,0,0
16,8477541,Dakota Mermis,D,MIN,30,0,0,0,0
16,8481609,Vladislav Kolyachonok,D,ARI,23,0,0,0,0
16,8480823,Alexander Alexeyev,D,WSH,25,0,0,0,0
16,8481679,Maxence Guenette,D,OTT,23,0,0,0,0
16,8481564,Ryan Johnson,D,BUF,23,0,0,0,0
16,8479376,Victor Mete,D,PHI,26,0,0,0,0
16,8484254,Akito Hirose,D,VAN,25,0,0,0,0
16,8482660,Kent Johnson,C,CBJ,22,0,0,0,0
16,8482149,Cole Perfetti,C,WPG,22,0,0,0,0
16,8477987,Ryan Donato,C,CHI,28,0,0,0,0
16,8475755,Alexander Petrovic,D,DAL,32,0,0,0,0
16,8477810,Joel Hanley,D,CGY,33,0,0,0,0
16,8474145,Robert Bortuzzo,D,NYI,35,0,0,0,0
16,8481161,Jake Christiansen,D,CBJ,25,0,0,0,0
16,8476884,Derrick Pouliot,D,DAL,30,0,0,0,0
16,8481716,Dmitri Voronkov,L,CBJ,24,0,0,0,0
16,8480084,Nick DeSimone,D,NJD,30,0,0,0,0
16,8475750,Jon Merrill,D,MIN,32,0,0,0,0
16,8479315,Joey Anderson,R,CHI,26,0,0,0,0
16,8478011,Louie Belpedio,D,PHI,28,0,0,0,0
16,8482451,Mikael Pyyhtia,L,CBJ,23,0,0,0,0
16,8481541,Samuel Bolduc,D,NYI,24,0,0,0,0
16,8482126,Emil Andrae,D,PHI,31,0,0,0,0
16,8474618,Marco Scandella,D,STL,34,0,0,0,0
16,8477244,Chad Ruhwedel,D,NYR,34,0,0,0,0
16,8477971,Andreas Englund,D,LAK,28,0,0,0,0
16,8480829,Jesperi Kotkaniemi,C,CAR,24,0,0,0,0
16,8479372,Josh Mahura,D,FLA,26,0,0,0,0
16,8482095,Tyler Kleven,D,OTT,22,0,0,0,0
16,8481719,Maxwell Crozier,D,TBL,24,0,0,0,0
16,8475855,Jesper Fast,R,CAR,33,0,0,0,0
16,8480848,Ty Dellandrea,C,DAL,24,0,0,0,0
16,8475193,Tomas Tatar,L,SEA,34,0,0,0,0
16,8476889,Radek Faksa,C,DAL,30,0,0,0,0
16,8478495,Denis Gurianov,R,PHI,27,0,0,0,0
16,8480216,Jacob Peterson,C,SJS,25,0,0,0,0
16,8480252,Cole Guttman,C,CHI,25,0,0,0,0
16,8479026,Philippe Myers,D,TBL,27,0,0,0,0
16,8481006,Tyler Tucker,D,STL,24,0,0,0,0
16,8481032,Paul Cotter,C,VGK,25,0,0,0,0
16,8481577,Philip Tomasino,C,NSH,23,0,0,0,0
16,8476918,Jimmy Vesey,L,NYR,31,0,0,0,0
16,8479320,Max Lajoie,D,TOR,27,0,0,0,0
16,8478017,Mark Friedman,D,VAN,29,0,0,0,0
16,8481754,Nikita Nesterenko,C,ANA,23,0,0,0,0
16,8483407,Brandon Scanlin,D,NYR,25,0,0,0,0
16,8482659,Josh Doan,R,ARI,22,0,0,0,0
16,8477446,Michael McCarron,R,NSH,29,0,0,0,0
16,8477903,Garnet Hathaway,R,PHI,33,0,0,0,0
16,8482153,Brendan Brisson,C,VGK,23,0,0,0,0
16,8483546,Marshall Rifai,D,TOR,26,0,0,0,0
16,8484287,Cole McWard,D,VAN,23,0,0,0,0
16,8478854,Ryan Shea,D,PIT,27,0,0,0,0
16,8481585,Egor Afanasyev,L,NSH,23,0,0,0,0
16,8483398,Declan Carlile,D,TBL,31,0,0,0,0
16,8478502,Dennis Gilbert,D,CGY,28,0,0,0,0
16,8482749,Joshua Roy,R,MTL,21,0,0,0,0
16,8481598,Philip Broberg,D,EDM,23,0,0,0,0
16,8480835,Jack Drury,C,CAR,24,0,0,0,0
16,8480748,Kiefer Sherwood,L,NSH,29,0,0,0,0
16,8476934,Brock McGinn,L,ANA,30,0,0,0,0
16,8480870,Bo Groulx,C,ANA,24,0,0,0,0
16,8479368,Max Jones,L,ANA,26,0,0,0,0
16,8478099,Kevin Labanc,R,SJS,29,0,0,0,0
16,8478067,Oskar Lindblom,L,SJS,28,0,0,0,0
16,8476393,Nick Cousins,C,FLA,31,0,0,0,0
16,8483395,Arshdeep Bains,L,VAN,23,0,0,0,0
16,8480762,Eric Robinson,L,BUF,29,0,0,0,0
16,8479439,Jacob MacDonald,D,SJS,31,0,0,0,0
16,8476474,Stefan Noesen,R,CAR,31,0,0,0,0
16,8482787,Nikita Chibrikov,R,WPG,31,0,0,0,0
16,8478432,Christian Fischer,R,DET,27,0,0,0,0
16,8477979,Nicolas Aube-Kubel,R,WSH,28,0,0,0,0
16,8481789,Tye Kartye,L,SEA,23,0,0,0,0
16,8479330,Brandon Gignac,C,MTL,27,0,0,0,0
16,8480075,Cameron Crotty,D,ARI,25,0,0,0,0
16,8473473,Milan Lucic,L,BOS,36,0,0,0,0
16,8482094,Daemon Hunt,D,MIN,22,0,0,0,0
16,8481206,John Ludvig,D,PIT,24,0,0,0,0
16,8483630,Pavol Regenda,L,ANA,25,0,0,0,0
16,8481617,Vasily Podkolzin,R,VAN,23,0,0,0,0
16,8480306,Grant Hutton,D,NYI,29,0,0,0,0
16,8480995,Pontus Holmberg,R,TOR,25,0,0,0,0
16,8482148,Hendrix Lapierre,C,WSH,22,0,0,0,0
16,8477478,William Carrier,L,VGK,30,0,0,0,0
16,8480003,Jesper Boqvist,C,BOS,26,0,0,0,0
16,8482172,Landon Slaggert,L,CHI,22,0,0,0,0
16,8480789,Oliver Wahlstrom,R,NYI,24,0,0,0,0
16,8474062,Riley Nash,C,NYR,35,0,0,0,0
16,8480021,Jack Studnicka,C,SJS,25,0,0,0,0
16,8480025,MacKenzie Entwistle,R,CHI,25,0,0,0,0
16,8481582,Nicholas Robertson,L,TOR,23,0,0,0,0
16,8476867,Brendan Gaunce,C,CBJ,30,0,0,0,0
16,8479619,Michael Carcone,L,ARI,28,0,0,0,0
16,8479370,Tyson Jost,C,BUF,26,0,0,0,0
16,8479671,Mathieu Olivier,R,CBJ,27,0,0,0,0
16,8476994,Vinnie Hinostroza,C,PIT,30,0,0,0,0
16,8482070,Mitchell Chaffee,R,TBL,26,0,0,0,0
16,8477473,Justin Bailey,R,SJS,29,0,0,0,0
16,8479344,Jesse Puljujarvi,R,PIT,26,0,0,0,0
16,8480205,Emil Bemstrom,C,PIT,25,0,0,0,0
16,8479718,Alex Barré-Boulet,C,TBL,27,0,0,0,0
16,8482061,Brandon Biro,L,BUF,26,0,0,0,0
16,8479638,Justin Brazeau,R,BOS,26,0,0,0,0
16,8474040,Sam Gagner,C,EDM,35,0,0,0,0
16,8477846,Ryan Carpenter,C,SJS,33,0,0,0,0
16,8482077,Dylan Holloway,L,EDM,23,0,0,0,0
16,8482157,Will Cuylle,L,NYR,22,0,0,0,0
16,8480007,Jonas Rondbjerg,R,VGK,25,0,0,0,0
16,8478874,Adam Gaudette,C,STL,28,0,0,0,0
16,8478434,Keegan Kolesar,R,VGK,27,0,0,0,0
16,8480441,Trey Fix-Wolansky,R,CBJ,25,0,0,0,0
16,8479994,Jaret Anderson-Dolan,C,NSH,25,0,0,0,0
16,8483567,Georgii Merkulov,C,BOS,24,0,0,0,0
16,8477380,Jonny Brodzinski,C,NYR,31,0,0,0,0
16,8482201,Gage Goncalves,C,TBL,23,0,0,0,0
16,8478211,Dryden Hunt,L,CGY,29,0,0,0,0
16,8471699,Andrew Cogliano,C,COL,37,0,0,0,0
16,8479421,Jacob Moverare,D,LAK,26,0,0,0,0
16,8478881,Brett Seney,L,CHI,28,0,0,0,0
16,8477464,Nic Petan,C,MIN,29,0,0,0,0
16,8475958,Michael Sgarbossa,C,WSH,32,0,0,0,0
16,8481147,Reese Johnson,C,CHI,26,0,0,0,0
16,8479336,Carl Grundstrom,R,LAK,27,0,0,0,0
16,8480853,Liam Foudy,C,NSH,24,0,0,0,0
16,8479522,Hardy Haman Aktell,D,WSH,26,0,0,0,0
16,8481462,Mason Morelli,L,VGK,28,0,0,0,0
16,8482102,Vasily Ponomarev,C,CAR,22,0,0,0,0
16,8480844,Grigori Denisenko,L,VGK,24,0,0,0,0
16,8479944,Zach Aston-Reese,C,DET,30,0,0,0,0
16,8482784,Zach Dean,C,STL,21,0,0,0,0
16,8479419,Brett Murray,L,BUF,26,0,0,0,0
16,8479520,Brandon Duhaime,R,COL,27,0,0,0,0
16,8477573,Nathan Walker,L,STL,30,0,0,0,0
16,8478078,Rourke Chartier,C,OTT,28,0,0,0,0
16,8475795,Dylan McIlrath,D,WSH,32,0,0,0,0
16,8482496,Nils Aman,C,VAN,24,0,0,0,0
16,8480289,Morgan Barron,C,WPG,26,0,0,0,0
16,8481751,Lukas Rousek,R,BUF,25,0,0,0,0
16,8480011,Klim Kostin,C,SJS,25,0,0,0,0
16,8481556,John Beecher,C,BOS,23,0,0,0,0
16,8475278,Byron Froese,C,VGK,33,0,0,0,0
16,8475225,Craig Smith,C,DAL,35,0,0,0,0
16,8484326,Patrik Koch,D,ARI,28,0,0,0,0
16,8477930,Pierre-Edouard Bellemare,L,SEA,39,0,0,0,0
16,8478409,Anthony Richard,C,BOS,28,0,0,0,0
16,8481024,Linus Karlsson,C,VAN,25,0,0,0,0
16,8479986,Kole Lind,R,SEA,26,0,0,0,0
16,8479414,Nathan Bastian,R,NJD,27,0,0,0,0
16,8479362,Riley Tufte,L,COL,26,0,0,0,0
16,8481058,Jesse Ylönen,R,MTL,25,0,0,0,0
16,8482476,Emil Heineman,L,MTL,23,0,0,0,0
16,8482861,Vincent Iorio,D,WSH,22,0,0,0,0
16,8483432,Luca Del Bel Belluz,C,CBJ,31,0,0,0,0
16,8482744,James Malatesta,L,CBJ,21,0,0,0,0
16,8477887,Patrick Brown,C,BOS,32,0,0,0,0
16,8478585,Derek Ryan,C,EDM,38,0,0,0,0
16,8481441,Joe Snively,C,WSH,28,0,0,0,0
16,8481592,Jakob Pelletier,L,CGY,23,0,0,0,0
16,8482634,Alex Steeves,C,TOR,25,0,0,0,0
16,8477126,Jayson Megna,C,BOS,34,0,0,0,0
16,8475752,Tyler Pitlick,C,NYR,33,0,0,0,0
16,8480008,Adam Ruzicka,C,ARI,25,0,0,0,0
16,8481065,Angus Crookshank,L,OTT,25,0,0,0,0
16,8479547,Matthew Phillips,R,WSH,26,0,0,0,0
16,8480226,Marián Studenic,R,SEA,26,0,0,0,0
16,8481237,Kyle MacLean,C,NYI,25,0,0,0,0
16,8475413,Justin Dowling,C,NJD,34,0,0,0,0
16,8481641,Joel Kiviranta,L,COL,28,0,0,0,0
16,8478104,Sammy Blais,L,STL,28,0,0,0,0
16,8477454,Adam Erne,L,EDM,29,0,0,0,0
16,8481518,Nolan Foote,L,NJD,24,0,0,0,0
16,8480245,Olle Lycksell,R,PHI,25,0,0,0,0
16,8483570,Ben Meyers,C,ANA,26,0,0,0,0
16,8480776,Sheldon Rempal,R,VGK,29,0,0,0,0
16,8483920,Pierrick Dube,R,WSH,23,0,0,0,0
16,8480267,Sammy Walker,C,MIN,25,0,0,0,0
16,8482747,Brennan Othmann,L,NYR,21,0,0,0,0
16,8479991,Jake Leschyshyn,C,NYR,25,0,0,0,0
16,8478400,Colin White,C,MTL,27,0,0,0,0
16,8479328,Julien Gauthier,R,NYI,27,0,0,0,0
16,8484325,Waltteri Merela,C,TBL,26,0,0,0,0
16,8479066,Ryan Lomberg,L,FLA,30,0,0,0,0
16,8477070,Liam O'Brien,C,ARI,30,0,0,0,0
16,8478146,Matthew Highmore,C,OTT,28,0,0,0,0
16,8478028,Fredrik Olofsson,L,COL,28,0,0,0,0
16,8480880,Jakub Lauko,C,BOS,24,0,0,0,0
16,8479968,Vinni Lettieri,C,MIN,29,0,0,0,0
16,8474709,Matt Martin,L,NYI,35,0,0,0,0
16,8480845,Rasmus Kupari,C,WPG,24,0,0,0,0
16,8481550,Adam Beckman,L,MIN,23,0,0,0,0
16,8481422,Jacob Lucchini,C,MIN,29,0,0,0,0
16,8477401,John Hayden,C,SEA,29,0,0,0,0
16,8478904,Steven Lorentz,C,FLA,28,0,0,0,0
16,8482088,Justin Sourdif,R,FLA,22,0,0,0,0
16,8482751,Ryan Winterton,C,SEA,21,0,0,0,0
16,8482241,Radim Zohorna,L,PIT,28,0,0,0,0
16,8481690,Tyler Angle,C,CBJ,24,0,0,0,0
16,8476952,Dominic Toninato,C,WPG,30,0,0,0,0
16,8476919,Chris Tierney,C,NJD,30,0,0,0,0
16,8480032,Shane Bowers,C,NJD,25,0,0,0,0
16,8484314,Jiri Smejkal,L,OTT,28,0,0,0,0
16,8481239,Samuel Fagemo,L,LAK,24,0,0,0,0
16,8481532,Alex Turcotte,C,LAK,23,0,0,0,0
16,8481019,David Gustafsson,C,WPG,24,0,0,0,0
16,8478477,Mitchell Stephens,C,MTL,27,0,0,0,0
16,8479546,Oskar Steen,C,BOS,26,0,0,0,0
16,8480292,Carson Meyer,R,CBJ,27,0,0,0,0
16,8478446,Glenn Gawdin,C,ANA,27,0,0,0,0
16,8483531,Brian Halonen,L,NJD,25,0,0,0,0
16,8477149,Scott Sabourin,R,SJS,32,0,0,0,0
16,8479972,Mason Shaw,C,MIN,26,0,0,0,0
16,8480890,Jan Jenik,R,ARI,24,0,0,0,0
16,8478051,Max Willman,C,NJD,29,0,0,0,0
16,8480851,Akil Thomas,C,LAK,24,0,0,0,0
16,8482765,Isak Rosen,R,BUF,21,0,0,0,0
16,8478421,A.J. Greer,L,CGY,28,0,0,0,0
16,8478512,Austin Czarnik,C,DET,32,0,0,0,0
16,8479536,Axel Jonsson-Fjallby,L,WPG,26,0,0,0,0
16,8477320,Anton Blidh,L,NYR,29,0,0,0,0
16,8481543,Nikita Alexandrov,C,STL,24,0,0,0,0
16,8475235,Nicolas Deslauriers,L,PHI,33,0,0,0,0
16,8481070,Hugh McGing,L,STL,26,0,0,0,0
16,8480836,Jonathan Gruden,C,PIT,24,0,0,0,0
16,8481591,Sam Poulin,R,PIT,23,0,0,0,0
16,8477962,Brendan Lemieux,L,CAR,28,0,0,0,0
16,8483401,Marc Johnstone,R,PIT,28,0,0,0,0
16,8482250,Callahan Burke,C,CAR,27,0,0,0,0
16,8481726,Adam Edstrom,C,NYR,24,0,0,0,0
16,8471817,Ryan Reaves,R,TOR,37,0,0,0,0
16,8479587,Rhett Gardner,C,PHI,28,0,0,0,0
16,8475766,Austin Watson,L,TBL,32,0,0,0,0
16,8479367,William Lockwood,R,FLA,26,0,0,0,0
16,8478424,Jansen Harkins,C,PIT,27,0,0,0,0
16,8476913,Devin Shore,C,SEA,30,0,0,0,0
16,8482652,Walker Duehr,R,CGY,27,0,0,0,0
16,8477527,Ross Johnston,L,ANA,30,0,0,0,0
16,8481077,John Leonard,L,ARI,26,0,0,0,0
16,8483549,Lucas Condotta,L,MTL,27,0,0,0,0
16,8480468,James Hamblin,L,EDM,25,0,0,0,0
16,8476907,Mackenzie MacEachern,L,STL,30,0,0,0,0
16,8479543,Michael Pezzetta,L,MTL,26,0,0,0,0
16,8480355,Mark Kastelic,C,OTT,25,0,0,0,0
16,8482162,Roby Jarventie,L,OTT,22,0,0,0,0
16,8479772,Zack MacEwen,R,OTT,28,0,0,0,0
16,8483597,Milos Kelemen,L,ARI,25,0,0,0,0
16,8479379,Givani Smith,R,SJS,26,0,0,0,0
16,8481655,Cole Schwindt,R,CGY,23,0,0,0,0
16,8479981,Jonah Gadjovich,L,FLA,26,0,0,0,0
16,8482147,Jean-Luc Foudy,C,COL,22,0,0,0,0
16,8484255,Jason Polin,R,COL,25,0,0,0,0
16,8477993,Justin Kirkland,C,ARI,28,0,0,0,0
16,8479249,Andrew Poturalski,C,SEA,30,0,0,0,0
16,8482197,Adam Raska,R,MIN,23,0,0,0,0
16,8475780,Chris Wagner,R,COL,33,0,0,0,0
16,8479533,Joona Koppanen,L,PIT,26,0,0,0,0
16,8481534,Raphael Lavoie,C,EDM,24,0,0,0,0
16,8484321,Nikolas Matinpalo,D,OTT,26,0,0,0,0
16,8481043,Cole Koepke,L,TBL,26,0,0,0,0
16,8476323,Max McCormick,L,SEA,32,0,0,0,0
16,8483609,Adam Klapka,R,CGY,24,0,0,0,0
16,8483512,Matt Savoie,C,BUF,20,0,0,0,0
16,8484259,Ondrej Pavel,C,COL,31,0,0,0,0
16,8478147,Bokondji Imama,L,OTT,28,0,0,0,0
16,8482460,Matt Rempe,C,NYR,22,0,0,0,0
16,8477073,Kurtis MacDermid,L,NJD,30,0,0,0,0
16,8480274,Philip Kemp,D,EDM,25,0,0,0,0
16,8478956,Samuel Laberge,L,NJD,27,0,0,0,0
16,8483045,Cameron Butler,R,CBJ,31,0,0,0,0
17,8479318,Auston Matthews,C,TOR,27,82,77,56,133
17,8478402,Connor McDavid,C,EDM,27,82,45,78,123
17,8481559,Jack Hughes,C,NJD,23,82,56,56,112
17,8477956,David Pastrnak,R,BOS,28,82,52,59,111
17,8477492,Nathan MacKinnon,C,COL,29,82,38,70,108
17,8479314,Matthew Tkachuk,L,FLA,27,82,40,64,104
17,8471675,Sidney Crosby,C,PIT,37,82,40,59,99
17,8476453,Nikita Kucherov,R,TBL,31,82,27,71,98
17,8477942,Kevin Fiala,L,LAK,28,82,37,56,93
17,8480023,Robert Thomas,C,STL,25,82,33,54,87
17,8478864,Kirill Kaprizov,L,MIN,27,82,42,44,86
17,8478420,Mikko Rantanen,R,COL,28,82,40,46,86
17,8475786,Zach Hyman,L,EDM,32,82,52,32,84
17,8480012,Elias Pettersson,C,VAN,26,82,34,49,83
17,8475166,John Tavares,C,TOR,34,82,32,51,83
17,8476887,Filip Forsberg,L,NSH,30,82,38,44,82
17,8480027,Jason Robertson,L,DAL,25,82,38,44,82
17,8477934,Leon Draisaitl,C,EDM,29,82,34,48,82
17,8476468,J.T. Miller,C,VAN,31,82,31,50,81
17,8477402,Pavel Buchnevich,L,STL,29,82,25,56,81
17,8478445,Mathew Barzal,C,NYI,27,82,22,58,80
17,8478427,Sebastian Aho,C,CAR,27,82,40,38,78
17,8478010,Brayden Point,C,TBL,28,82,35,43,78
17,8479407,Jesper Bratt,L,NJD,26,82,24,54,78
17,8477493,Aleksander Barkov,C,FLA,29,82,20,58,78
17,8477404,Jake Guentzel,C,CAR,30,82,32,45,77
17,8478414,Timo Meier,R,NJD,28,82,37,38,75
17,8479343,Clayton Keller,R,ARI,26,82,34,41,75
17,8477939,William Nylander,R,TOR,28,82,25,50,75
17,8476459,Mika Zibanejad,C,NYR,31,82,28,46,74
17,8477496,Elias Lindholm,C,VAN,30,82,28,46,74
17,8482116,Tim Stützle,C,OTT,22,82,21,53,74
17,8479420,Tage Thompson,C,BUF,27,82,38,35,73
17,8478550,Artemi Panarin,L,NYR,33,82,34,39,73
17,8476346,Johnny Gaudreau,L,CBJ,31,82,22,51,73
17,8474564,Steven Stamkos,C,TBL,34,82,37,35,72
17,8479385,Jordan Kyrou,C,STL,26,82,36,36,72
17,8480069,Cale Makar,D,COL,26,82,16,56,72
17,8478047,Michael Bunting,L,PIT,29,82,31,40,71
17,8478439,Travis Konecny,R,PHI,27,82,25,46,71
17,8480830,Andrei Svechnikov,R,CAR,24,82,28,42,70
17,8481523,Kirby Dach,C,MTL,23,82,8,62,70
17,8477933,Sam Reinhart,C,FLA,29,82,35,34,69
17,8479542,Brandon Hagel,L,TBL,26,82,31,37,68
17,8478440,Dylan Strome,C,WSH,27,82,28,40,68
17,8475172,Nazem Kadri,C,CGY,34,82,23,45,68
17,8479325,Charlie McAvoy,D,BOS,27,82,11,57,68
17,8475798,Mikael Granlund,C,SJS,32,82,11,57,68
17,8477940,Nikolaj Ehlers,L,WPG,28,82,32,35,67
17,8478444,Brock Boeser,R,VAN,27,82,26,41,67
17,8474141,Patrick Kane,R,DET,36,82,23,44,67
17,8475692,Mats Zuccarello,R,MIN,37,82,18,49,67
17,8480839,Rasmus Dahlin,D,BUF,24,82,18,49,67
17,8476853,Morgan Rielly,D,TOR,30,82,11,56,67
17,8477946,Dylan Larkin,C,DET,28,82,30,36,66
17,8481557,Matt Boldy,L,MIN,23,82,30,36,66
17,8477500,Bo Horvat,C,NYI,29,82,30,36,66
17,8470794,Joe Pavelski,C,DAL,40,82,19,47,66
17,8478398,Kyle Connor,L,WPG,28,82,27,38,65
17,8475784,Jeff Skinner,C,BUF,32,82,27,38,65
17,8480002,Nico Hischier,C,NJD,25,82,20,45,65
17,8477346,MacKenzie Weegar,D,CGY,30,82,14,51,65
17,8475151,Kyle Palmieri,C,NYI,33,82,33,31,64
17,8475765,Vladimir Tarasenko,R,FLA,33,82,31,33,64
17,8478403,Jack Eichel,C,VGK,28,82,29,35,64
17,8480208,Drake Batherson,R,OTT,26,82,27,37,64
17,8476460,Mark Scheifele,C,WPG,31,82,26,38,64
17,8473512,Claude Giroux,R,OTT,36,82,16,48,64
17,8474590,John Carlson,D,WSH,34,82,13,51,64
17,8475726,Tyler Toffoli,C,WPG,32,82,36,27,63
17,8471214,Alex Ovechkin,L,WSH,39,82,30,32,62
17,8482078,Lucas Raymond,L,DET,22,82,29,33,62
17,8482097,Jack Quinn,R,BUF,23,82,26,36,62
17,8475170,Brayden Schenn,C,STL,33,82,24,38,62
17,8474600,Roman Josi,D,NSH,34,82,13,49,62
17,8477960,Adrian Kempe,R,LAK,28,82,29,32,61
17,8478042,Viktor Arvidsson,R,LAK,31,82,23,38,61
17,8476454,Ryan Nugent-Hopkins,C,EDM,31,82,19,42,61
17,8480803,Evan Bouchard,D,EDM,25,82,8,53,61
17,8478493,Joel Eriksson Ek,C,MIN,27,82,24,36,60
17,8476389,Vincent Trocheck,C,NYR,31,82,21,39,60
17,8480800,Quinn Hughes,D,VAN,25,82,13,47,60
17,8479425,Filip Hronek,D,VAN,27,82,11,49,60
17,8480801,Brady Tkachuk,L,OTT,25,82,35,24,59
17,8475810,Bryan Rust,R,PIT,32,82,28,31,59
17,8477501,Valeri Nichushkin,R,COL,29,82,26,33,59
17,8478401,Pavel Zacha,C,BOS,27,82,26,33,59
17,8478449,Roope Hintz,C,DAL,28,82,25,34,59
17,8477416,Oliver Bjorkstrand,R,SEA,29,82,24,35,59
17,8477949,Alex Tuch,R,BUF,28,82,22,37,59
17,8471215,Evgeni Malkin,C,PIT,38,82,18,41,59
17,8479323,Adam Fox,D,NYR,26,82,8,51,59
17,8479675,Trevor Moore,L,LAK,29,82,32,26,58
17,8481540,Cole Caufield,R,MTL,23,82,28,30,58
17,8477409,Carter Verhaeghe,C,FLA,29,82,23,35,58
17,8476462,Dougie Hamilton,D,NJD,31,82,23,35,58
17,8475191,Reilly Smith,R,PIT,33,82,21,37,58
17,8471685,Anze Kopitar,C,LAK,37,82,16,42,58
17,8474578,Erik Karlsson,D,PIT,34,82,15,43,58
17,8479337,Alex DeBrincat,R,DET,27,82,25,32,57
17,8476905,Chandler Stephenson,C,VGK,30,82,23,34,57
17,8478975,Mason Marchment,L,DAL,29,82,22,35,57
17,8477447,Shea Theodore,D,VGK,29,82,8,49,57
17,8476880,Tom Wilson,R,WSH,30,82,27,29,56
17,8481528,Dylan Cozens,C,BUF,23,82,25,31,56
17,8480031,Maxime Comtois,L,CAR,25,82,13,43,56
17,8480015,Owen Tippett,R,PHI,25,82,32,23,55
17,8480018,Nick Suzuki,C,MTL,25,82,24,31,55
17,8477494,Jonathan Drouin,L,COL,29,82,17,38,55
17,8480865,Noah Dobson,D,NYI,24,82,14,41,55
17,8477504,Josh Morrissey,D,WPG,29,82,11,44,55
17,8475167,Victor Hedman,D,TBL,34,82,3,52,55
17,8477476,Artturi Lehkonen,L,COL,29,82,26,28,54
17,8473419,Brad Marchand,L,BOS,36,82,22,32,54
17,8482745,Mason McTavish,C,ANA,21,82,19,35,54
17,8477503,Max Domi,C,TOR,29,82,17,37,54
17,8475184,Chris Kreider,L,NYR,33,82,29,24,53
17,8476881,Tomas Hertl,C,VGK,31,82,27,26,53
17,8477479,Tyler Bertuzzi,L,TOR,29,82,26,27,53
17,8482740,Wyatt Johnston,C,DAL,21,82,23,30,53
17,8481068,Yegor Sharangovich,C,CGY,26,82,22,30,52
17,8482684,Luke Hughes,D,NJD,21,82,20,32,52
17,8478498,Jake DeBrusk,L,BOS,28,82,32,19,51
17,8476399,Blake Coleman,C,CGY,33,82,28,23,51
17,8484144,Connor Bedard,C,CHI,19,82,21,30,51
17,8476456,Jonathan Huberdeau,C,CGY,31,82,17,34,51
17,8480036,Miro Heiskanen,D,DAL,25,82,11,40,51
17,8471724,Kris Letang,D,PIT,37,82,9,42,51
17,8482101,Danil Gushchin,L,SJS,22,82,23,27,50
17,8475763,Kevin Hayes,R,STL,32,82,21,29,50
17,8481542,Moritz Seider,D,DET,23,82,5,45,50
17,8478366,Frank Vatrano,R,ANA,30,82,28,21,49
17,8475314,Anders Lee,L,NYI,34,82,27,22,49
17,8480188,Fabian Zetterlund,L,SJS,25,82,24,25,49
17,8476438,Brandon Saad,L,STL,32,82,22,27,49
17,8475791,Taylor Hall,L,CHI,33,82,19,30,49
17,8474102,David Perron,L,DET,36,82,16,33,49
17,8478873,Troy Terry,R,ANA,27,82,14,35,49
17,8478046,Danton Heinen,L,BOS,29,82,24,24,48
17,8482093,Seth Jarvis,C,CAR,22,82,23,25,48
17,8478057,Dakota Joshua,C,VAN,28,82,23,25,48
17,8479999,Casey Mittelstadt,C,COL,26,82,20,28,48
17,8475168,Matt Duchene,C,DAL,33,82,17,31,48
17,8473994,Jamie Benn,L,DAL,35,82,17,31,48
17,8478038,Devon Toews,D,COL,30,82,16,32,48
17,8483445,Cutter Gauthier,L,ANA,20,82,11,37,48
17,8480014,Gabriel Vilardi,C,WPG,25,82,25,22,47
17,8475722,Jason Zucker,L,NSH,32,82,25,22,47
17,8477407,Anthony Duclair,L,TBL,29,82,22,25,47
17,8473986,Alex Killorn,L,ANA,35,82,21,26,47
17,8475745,Charlie Coyle,C,BOS,32,82,13,34,47
17,8477986,Brandon Montour,D,FLA,30,82,12,35,47
17,8476792,Torey Krug,D,STL,33,82,11,36,47
17,8475754,Brock Nelson,C,NYI,33,82,25,21,46
17,8482079,Marco Rossi,C,MIN,23,82,20,26,46
17,8474150,Mikael Backlund,C,CGY,35,82,19,27,46
17,8482665,Matty Beniers,C,SEA,22,82,17,29,46
17,8475753,Justin Faulk,D,STL,32,82,13,33,46
17,8479987,Morgan Geekie,C,BOS,26,82,11,35,46
17,8482122,Brock Faber,D,MIN,22,82,7,39,46
17,8478407,Vince Dunn,D,SEA,28,82,6,40,46
17,8483808,Andrei Kuzmenko,L,CGY,28,82,23,22,45
17,8478519,Anthony Cirelli,C,TBL,27,82,23,22,45
17,8474641,Adam Henrique,C,EDM,34,82,22,23,45
17,8480220,Noah Cates,L,PHI,25,82,21,24,45
17,8476479,Phillip Danault,C,LAK,31,82,19,26,45
17,8479400,Pierre-Luc Dubois,L,LAK,26,82,18,27,45
17,8474679,Gustav Nyquist,C,NSH,35,82,16,29,45
17,8474586,Jordan Eberle,R,SEA,34,82,16,29,45
17,8477932,Aaron Ekblad,D,FLA,28,82,16,29,45
17,8478438,Tommy Novak,C,NSH,27,82,15,30,45
17,8478542,Evan Rodrigues,C,FLA,31,82,14,31,45
17,8481016,Ruslan Iskhakov,C,NYI,24,82,6,39,45
17,8482089,Jake Neighbours,L,STL,22,82,30,14,44
17,8477955,Jared McCann,L,SEA,28,82,25,19,44
17,8477497,Sean Monahan,C,WPG,30,82,22,22,44
17,8474157,Max Pacioretty,L,WSH,36,82,21,23,44
17,8478462,Nicolas Roy,C,VGK,27,82,18,26,44
17,8478413,Jordan Greenway,L,BUF,27,82,15,29,44
17,8479410,Mikhail Sergachev,D,TBL,26,82,10,34,44
17,8476854,Hampus Lindholm,D,BOS,30,82,1,43,44
17,8480039,Martin Necas,C,CAR,25,82,18,25,43
17,8482667,William Eklund,L,SJS,22,82,18,25,43
17,8482113,Anton Lundell,C,FLA,23,82,18,25,43
17,8480185,Eetu Luostarinen,C,FLA,26,82,18,25,43
17,8478109,Victor Olofsson,L,BUF,29,82,18,25,43
17,8475158,Ryan O'Reilly,C,NSH,33,82,17,26,43
17,8478460,Zach Werenski,D,CBJ,27,82,13,30,43
17,8476869,Brady Skjei,D,CAR,30,82,11,32,43
17,8477935,Sam Bennett,C,FLA,28,82,22,20,42
17,8479339,Patrik Laine,L,CBJ,26,82,20,22,42
17,8477951,Nick Schmaltz,C,ARI,28,82,19,23,42
17,8482159,Tyson Foerster,R,PHI,22,82,19,23,42
17,8478856,Conor Garland,R,VAN,28,82,17,25,42
17,8480028,Morgan Frost,C,PHI,25,82,10,32,42
17,8482110,Dawson Mercer,C,NJD,23,82,25,16,41
17,8476882,Teuvo Teravainen,L,CAR,30,82,18,23,41
17,8482146,Luke Evangelista,R,NSH,22,82,15,26,41
17,8476480,Vladislav Namestnikov,C,WPG,32,82,15,26,41
17,8478474,Lawson Crouse,L,ARI,27,82,14,27,41
17,8478396,Noah Hanifin,D,VGK,27,82,10,31,41
17,8476875,Mike Matheson,D,MTL,30,82,9,32,41
17,8477495,Seth Jones,D,CHI,30,82,9,32,41
17,8482733,Logan Mailloux,D,MTL,31,82,6,35,41
17,8483397,Marc McLaughlin,C,BOS,25,82,35,5,40
17,8479525,Ross Colton,C,COL,28,82,24,16,40
17,8476539,Jonathan Marchessault,R,VGK,34,82,23,17,40
17,8482109,Alexis Lafrenière,L,NYR,23,82,23,17,40
17,8481596,Shane Pinto,C,OTT,24,82,21,19,40
17,8480064,Josh Norris,C,OTT,25,82,21,19,40
17,8477451,Ryan Hartman,R,MIN,30,82,20,20,40
17,8478466,Daniel Sprong,R,DET,27,82,20,20,40
17,8476872,Scott Laughton,C,PHI,30,82,18,22,40
17,8476392,Adam Lowry,C,WPG,31,82,16,24,40
17,8476483,Rickard Rakell,R,PIT,31,82,25,14,39
17,8477952,Robby Fabbri,C,DET,28,82,22,17,39
17,8476432,Boone Jenner,C,CBJ,31,82,21,18,39
17,8475169,Evander Kane,L,EDM,33,82,20,19,39
17,8477964,Ivan Barbashev,C,VGK,29,82,20,19,39
17,8471218,Blake Wheeler,R,NYR,38,82,19,20,39
17,8480849,Barrett Hayton,C,ARI,24,82,19,20,39
17,8476448,William Karlsson,C,VGK,31,82,16,23,39
17,8482222,Alexander Barabanov,L,SJS,30,82,15,24,39
17,8476292,Ondrej Palat,L,NJD,33,82,13,26,39
17,8474037,James van Riemsdyk,L,BOS,35,82,13,26,39
17,8482105,Jake Sanderson,D,OTT,22,82,9,30,39
17,8483524,Shane Wright,C,SEA,20,82,22,16,38
17,8471698,T.J. Oshie,R,WSH,38,82,18,20,38
17,8482055,Drew O'Connor,L,PIT,26,82,18,20,38
17,8483515,Juraj Slafkovsky,L,MTL,20,82,17,21,38
17,8475913,Mark Stone,R,VGK,32,82,15,23,38
17,8475794,Tyler Seguin,C,DAL,32,82,14,24,38
17,8474149,Evgenii Dadonov,R,DAL,35,82,14,24,38
17,8475744,Evgeny Kuznetsov,C,CAR,32,82,11,27,38
17,8480434,Sean Durzi,D,ARI,26,82,10,28,38
17,8474563,Drew Doughty,D,LAK,35,82,6,32,38
17,8481618,Alex Newhook,C,MTL,23,82,17,20,37
17,8474870,Tyler Johnson,C,CHI,34,82,17,20,37
17,8478463,Anthony Beauvillier,L,NSH,27,82,17,20,37
17,8479992,Michael Rasmussen,C,DET,25,82,14,23,37
17,8480043,Timothy Liljegren,D,TOR,25,82,11,26,37
17,8478469,Thomas Chabot,D,OTT,27,82,9,28,37
17,8475764,Cam Fowler,D,ANA,33,82,7,30,37
17,8476329,Travis Boyd,C,ARI,31,82,7,30,37
17,8477989,Christian Dvorak,C,MTL,28,82,19,17,36
17,8476458,Ryan Strome,C,ANA,31,82,15,21,36
17,8484153,Leo Carlsson,C,ANA,20,82,15,21,36
17,8480068,Ryan Poehling,C,PHI,25,82,14,22,36
17,8477953,Kasperi Kapanen,R,STL,28,82,13,23,36
17,8476419,Jean-Gabriel Pageau,C,NYI,32,82,13,23,36
17,8475149,Marcus Johansson,L,MIN,34,82,12,24,36
17,8482124,Quinton Byfield,R,LAK,22,82,11,25,36
17,8474053,Logan Couture,C,SJS,35,82,9,27,36
17,8478397,Rasmus Andersson,D,CGY,28,82,3,33,36
17,8477426,Nicholas Paul,L,TBL,29,82,22,13,35
17,8482133,Thomas Bordeleau,C,SJS,22,82,16,19,35
17,8480078,Filip Chytil,C,NYR,25,82,15,20,35
17,8480802,Ryan McLeod,C,EDM,25,82,15,20,35
17,8480798,Philipp Kurashev,C,CHI,25,82,11,24,35
17,8482475,Yegor Chinakhov,R,CBJ,23,82,10,25,35
17,8476927,Teddy Blueger,C,VAN,30,82,10,25,35
17,8476826,Yanni Gourde,C,SEA,33,82,8,27,35
17,8470613,Brent Burns,D,CAR,39,82,8,27,35
17,8477498,Darnell Nurse,D,EDM,29,82,8,27,35
17,8475197,Tyson Barrie,D,NSH,33,82,5,30,35
17,8481624,Ilya Mikheyev,R,VAN,30,82,20,14,34
17,8475760,Nick Bjugstad,C,ARI,32,82,19,15,34
17,8483431,Logan Cooley,C,ARI,20,82,17,17,34
17,8481711,Matias Maccelli,L,ARI,24,82,14,20,34
17,8477998,Warren Foegele,L,EDM,28,82,14,20,34
17,8476897,Oskar Sundqvist,C,STL,30,82,13,21,34
17,8481533,Trevor Zegras,C,ANA,23,82,12,22,34
17,8474565,Alex Pietrangelo,D,VGK,34,82,11,23,34
17,8482142,Jamie Drysdale,D,PHI,22,82,9,25,34
17,8476923,Damon Severson,D,CBJ,30,82,9,25,34
17,8476469,Joel Armia,R,MTL,31,82,22,11,33
17,8475714,Calle Jarnkrok,C,TOR,33,82,18,15,33
17,8478233,Andrew Mangiapane,L,CGY,28,82,17,16,33
17,8477444,Andre Burakovsky,L,SEA,29,82,16,17,33
17,8476925,Colton Sissons,C,NSH,31,82,16,17,33
17,8477450,Jason Dickinson,C,CHI,29,82,15,18,33
17,8480893,Kirill Marchenko,R,CBJ,24,82,15,18,33
17,8475799,Nino Niederreiter,R,WPG,32,82,14,19,33
17,8475343,Nic Dowd,C,WSH,34,82,13,20,33
17,8475793,Ryan Johansen,C,PHI,32,82,12,21,33
17,8475287,Erik Haula,L,NJD,33,82,11,22,33
17,8477429,Andrew Copp,C,DET,30,82,10,23,33
17,8475848,Brendan Gallagher,R,MTL,32,82,18,14,32
17,8481601,Simon Holmstrom,R,NYI,23,82,17,15,32
17,8482699,Dylan Guenther,R,ARI,21,82,16,16,32
17,8480459,Pius Suter,C,VAN,28,82,16,16,32
17,8478458,Jack Roslovic,C,NYR,27,82,14,18,32
17,8482175,JJ Peterka,R,BUF,22,82,14,18,32
17,8481013,Jonatan Berggren,R,DET,24,82,12,20,32
17,8479415,Michael McLeod,C,NJD,26,82,11,21,32
17,8480871,Adam Boqvist,D,CBJ,24,82,11,21,32
17,8482655,J.J. Moser,D,ARI,24,82,9,23,32
17,8483495,Simon Nemec,D,NJD,20,82,8,24,32
17,8478055,Gustav Forsling,D,FLA,28,82,6,26,32
17,8476906,Shayne Gostisbehere,D,DET,31,82,6,26,32
17,8478911,Matt Roy,D,LAK,29,82,5,27,32
17,8482259,Bobby McMann,C,TOR,28,82,20,11,31
17,8476981,Josh Anderson,R,MTL,30,82,19,12,31
17,8479423,Alex Nylander,L,CBJ,26,82,17,14,31
17,8481554,Kaapo Kakko,R,NYR,23,82,15,16,31
17,8477511,Anthony Mantha,R,VGK,30,82,14,17,31
17,8474189,Lars Eller,C,PIT,35,82,13,18,31
17,8470604,Jeff Carter,C,PIT,39,82,13,18,31
17,8481581,Thomas Harley,D,DAL,23,82,10,21,31
17,8477506,Ryan Pulock,D,NYI,30,82,9,22,31
17,8482073,Braden Schneider,D,NYR,23,82,8,23,31
17,8480817,K'Andre Miller,D,NYR,24,82,7,24,31
17,8475218,Mattias Ekholm,D,EDM,34,82,6,25,31
17,8483493,Frank Nazar,C,CHI,20,82,21,9,30
17,8477944,Jakub Vrana,L,STL,28,82,17,13,30
17,8478508,Yakov Trenin,C,COL,27,82,17,13,30
17,8478115,Pierre Engvall,L,NYI,28,82,16,14,30
17,8479316,Luke Kunin,C,SJS,27,82,16,14,30
17,8473449,Kyle Okposo,R,FLA,36,82,15,15,30
17,8477456,J.T. Compher,L,DET,29,82,13,17,30
17,8480855,Jack McBain,C,ARI,24,82,13,17,30
17,8477021,Alex Kerfoot,C,ARI,30,82,12,18,30
17,8479977,Kailer Yamamoto,R,SEA,26,82,12,18,30
17,8482671,Owen Power,D,BUF,22,82,6,24,30
17,8483457,Lane Hutson,D,MTL,20,82,5,25,30
17,8481699,Aku Raty,R,ARI,23,82,4,26,30
17,8478507,John Marino,D,NJD,27,82,2,28,30
17,8476873,Mark Jankowski,C,NSH,30,82,15,14,29
17,8476960,Andreas Athanasiou,C,CHI,30,82,14,15,29
17,8480821,Filip Zadina,R,SJS,25,82,13,16,29
17,8478472,Mathieu Joseph,R,OTT,27,82,12,17,29
17,8479365,Trent Frederic,C,BOS,26,82,11,18,29
17,8479345,Jakob Chychrun,D,OTT,26,82,9,20,29
17,8477948,Travis Sanheim,D,PHI,28,82,8,21,29
17,8481656,Aliaksei Protas,C,WSH,23,82,7,22,29
17,8479976,Juuso Valimaki,D,ARI,26,82,4,25,29
17,8481568,Alex Vlasic,D,CHI,23,82,2,27,29
17,8475906,John Klingberg,D,TOR,32,82,1,28,29
17,8474884,Mike Hoffman,C,SJS,35,82,15,13,28
17,8483491,Ivan Miroshnichenko,L,WSH,20,82,14,14,28
17,8480797,Joel Farabee,L,PHI,24,82,10,18,28
17,8476461,Sean Couturier,C,PHI,32,82,10,18,28
17,8480806,Isac Lundestrom,C,ANA,25,82,8,20,28
17,8476979,Erik Gustafsson,D,NYR,32,82,7,21,28
17,8480873,Rasmus Sandin,D,WSH,24,82,7,21,28
17,8475181,Nick Leddy,D,STL,33,82,7,21,28
17,8474151,Ryan McDonagh,D,NSH,35,82,7,21,28
17,8481703,Valtteri Puustinen,R,PIT,25,82,6,22,28
17,8477220,Nate Schmidt,D,WPG,33,82,5,23,28
17,8480860,Kevin Bahl,D,NJD,24,82,1,27,28
17,8481535,Nils Hoglander,L,VAN,24,82,16,11,27
17,8478043,Sam Lafferty,C,VAN,29,82,15,12,27
17,8477947,Sonny Milano,L,WSH,28,82,13,14,27
17,8470610,Zach Parise,L,COL,40,82,13,14,27
17,8478569,Noel Acciari,C,PIT,33,82,12,15,27
17,8480113,Alex Iafallo,L,WPG,31,82,11,16,27
17,8482117,Lukas Reichel,L,CHI,22,82,11,16,27
17,8479393,Noah Gregor,C,TOR,26,82,11,16,27
17,8482111,Justin Barron,D,MTL,23,82,11,16,27
17,8482705,Cole Sillinger,C,CBJ,21,82,10,17,27
17,8478451,Ethan Bear,D,WSH,27,82,6,21,27
17,8481524,Bowen Byram,D,BUF,23,82,6,21,27
17,8476892,Colton Parayko,D,STL,31,82,4,23,27
17,8484166,Adam Fantilli,C,CBJ,20,82,13,13,26
17,8477330,Dominik Kubalik,L,OTT,29,82,13,13,26
17,8475164,Jakob Silfverberg,R,ANA,34,82,13,13,26
17,8481560,Arthur Kaliyev,R,LAK,23,82,12,14,26
17,8478020,Michael Amadio,C,VGK,28,82,12,14,26
17,8479996,Cody Glass,C,NSH,25,82,9,17,26
17,8482092,Ridly Greig,C,OTT,22,82,9,17,26
17,8478891,Mason Appleton,C,WPG,28,82,8,18,26
17,8478133,Jake Evans,C,MTL,28,82,6,20,26
17,8481014,Alexander Romanov,D,NYI,24,82,5,21,26
17,8475188,Brayden McNabb,D,VGK,33,82,5,21,26
17,8476331,Dylan DeMelo,D,WPG,31,82,3,23,26
17,8483471,Brad Lambert,C,WPG,31,82,2,24,26
17,8480009,Eeli Tolvanen,R,SEA,25,82,15,10,25
17,8475220,Marcus Foligno,L,MIN,33,82,12,13,25
17,8481481,Blake Lizotte,C,LAK,27,82,10,15,25
17,8481186,Logan O'Connor,R,COL,28,82,10,15,25
17,8473563,Nicklas Backstrom,C,WSH,37,82,10,15,25
17,8480073,Erik Brannstrom,D,OTT,25,82,9,16,25
17,8482624,Daniil Miromanov,D,CGY,27,82,8,17,25
17,8473422,Nick Foligno,L,CHI,37,82,8,17,25
17,8480145,Neal Pionk,D,WPG,29,82,7,18,25
17,8481522,Peyton Krebs,C,BUF,23,82,7,18,25
17,8476917,Adam Pelech,D,NYI,30,82,6,19,25
17,8480336,Sean Walker,D,COL,30,82,6,19,25
17,8475200,Dmitry Orlov,D,CAR,33,82,5,20,25
17,8482087,Kaiden Guhle,D,MTL,22,82,5,20,25
17,8476891,Matt Grzelcyk,D,BOS,30,82,5,20,25
17,8476885,Jacob Trouba,D,NYR,30,82,4,21,25
17,8479998,Mikey Anderson,D,LAK,25,82,4,21,25
17,8476931,Jake McCabe,D,TOR,31,82,1,24,25
17,8479390,Taylor Raddysh,R,CHI,26,82,14,10,24
17,8479293,Brandon Tanev,L,SEA,33,82,13,11,24
17,8478013,Jake Walman,D,DET,28,82,12,12,24
17,8479359,Beck Malenstyn,L,WSH,26,82,11,13,24
17,8482730,Brandt Clarke,D,LAK,21,82,8,16,24
17,8474034,Pat Maroon,L,BOS,36,82,7,17,24
17,8473533,Jordan Staal,C,CAR,36,82,7,17,24
17,8478882,Vladislav Gavrikov,D,LAK,29,82,7,17,24
17,8475171,Oliver Ekman-Larsson,D,FLA,33,82,5,19,24
17,8483490,Pavel Mintyukov,D,ANA,21,82,5,19,24
17,8482803,Olen Zellweger,D,ANA,21,82,5,19,24
17,8474574,Tyler Myers,D,VAN,34,82,4,20,24
17,8477969,Marcus Pettersson,D,PIT,28,82,3,21,24
17,8477845,Trevor van Riemsdyk,D,WSH,33,82,3,21,24
17,8476958,Jaccob Slavin,D,CAR,30,82,2,22,24
17,8482145,Mavrik Bourque,C,DAL,22,82,19,4,23
17,8484203,Bradly Nadeau,L,CAR,19,82,15,8,23
17,8482702,Logan Stankoven,C,DAL,21,82,14,9,23
17,8481604,Pavel Dorofeyev,L,VGK,24,82,12,11,23
17,8481580,Connor McMichael,C,WSH,23,82,12,11,23
17,8474715,Cam Atkinson,R,PHI,35,82,12,11,23
17,8479514,Rem Pitlick,C,CHI,27,82,11,12,23
17,8484145,Zach Benson,L,BUF,19,82,11,12,23
17,8475768,Jaden Schwartz,C,SEA,32,82,10,13,23
17,8477508,Curtis Lazar,C,NJD,29,82,10,13,23
17,8475842,Sam Carrick,C,EDM,32,82,9,14,23
17,8478851,Alexandre Carrier,D,NSH,28,82,8,15,23
17,8481546,Cam York,D,PHI,23,82,7,16,23
17,8476278,Colin Blackwell,C,CHI,31,82,7,16,23
17,8479371,Dante Fabbro,D,NSH,26,82,6,17,23
17,8482720,Matthew Knies,L,TOR,22,82,5,18,23
17,8479353,Brett Howden,C,VGK,26,82,5,18,23
17,8481567,Henry Thrun,D,SJS,23,82,4,19,23
17,8479369,Andrew Peeke,D,BOS,26,82,3,20,23
17,8476429,Scott Mayfield,D,NYI,32,82,3,20,23
17,8474673,TJ Brodie,D,TOR,34,82,1,22,23
17,8476442,Matt Nieto,L,PIT,32,82,14,8,22
17,8479941,Justin Danforth,R,CBJ,31,82,13,9,22
17,8483499,Liam Ohgren,L,MIN,20,82,12,10,22
17,8481553,Bobby Brink,R,PHI,23,82,11,11,22
17,8481093,Rafael Harvey-Pinard,L,MTL,25,82,11,11,22
17,8476878,Zemgus Girgensons,L,BUF,30,82,11,11,22
17,8481704,Juuso Parssinen,C,NSH,23,82,10,12,22
17,8477392,Hudson Fasching,R,NYI,29,82,10,12,22
17,8479346,Dillon Dube,C,CGY,26,82,9,13,22
17,8476463,Jonas Brodin,D,MIN,31,82,8,14,22
17,8476525,Colin Miller,D,WPG,32,82,6,16,22
17,8479398,Samuel Girard,D,COL,26,82,4,18,22
17,8476902,Esa Lindell,D,DAL,30,82,4,18,22
17,8476312,Josh Manson,D,COL,33,82,3,19,22
17,8478500,Ivan Provorov,D,CBJ,27,82,3,19,22
17,8482809,Jackson Blake,R,CAR,21,82,14,7,21
17,8476871,Tanner Pearson,L,MTL,32,82,13,8,21
17,8479591,Michael Eyssimont,C,TBL,28,82,12,9,21
17,8480144,David Kampf,C,TOR,29,82,11,10,21
17,8480980,Connor Dewar,C,TOR,25,82,10,11,21
17,8479661,Tanner Jeannot,L,TBL,27,82,9,12,21
17,8480281,Alexey Toropchenko,R,STL,25,82,9,12,21
17,8482125,Alexander Holtz,R,NJD,22,82,8,13,21
17,8482074,Connor Zary,C,CGY,23,82,8,13,21
17,8482062,Cole Smith,L,NSH,29,82,8,13,21
17,8481028,Martin Pospisil,C,CGY,25,82,7,14,21
17,8476457,Adam Larsson,D,SEA,32,82,6,15,21
17,8480035,Henri Jokiharju,D,BUF,25,82,5,16,21
17,8478840,Will Borgen,D,SEA,28,82,4,17,21
17,8476422,Mike Reilly,D,NYI,31,82,4,17,21
17,8480246,Nick Perbix,D,TBL,26,82,2,19,21
17,8480796,Martin Fehervary,D,WSH,25,82,2,19,21
17,8480074,Alexandre Texier,C,CBJ,25,82,7,13,20
17,8479351,Sam Steel,C,DAL,26,82,5,15,20
17,8477839,Conor Sheary,L,TBL,32,82,5,15,20
17,8474716,Jared Spurgeon,D,MIN,35,82,3,17,20
17,8475455,Brenden Dillon,D,WPG,34,82,2,18,20
17,8482118,Sam Colangelo,R,ANA,23,82,14,5,19
17,8477919,Frederick Gaudreau,C,MIN,31,82,10,9,19
17,8470621,Corey Perry,R,EDM,39,82,10,9,19
17,8476624,Barclay Goodrow,C,NYR,31,82,9,10,19
17,8475231,Casey Cizikas,C,NYI,33,82,8,11,19
17,8474009,Nick Bonino,C,NYR,36,82,6,13,19
17,8475690,Chris Tanev,D,DAL,35,82,4,15,19
17,8475324,Nick Jensen,D,WSH,34,82,4,15,19
17,8480172,Jan Rutta,D,SJS,34,82,4,15,19
17,8483466,Kevin Korchinski,D,CHI,20,82,3,16,19
17,8481059,Scott Perunovich,D,STL,26,82,1,18,19
17,8478178,Darren Raddysh,D,TBL,28,82,0,19,19
17,8482155,Alex Laferriere,R,LAK,23,82,10,8,18
17,8479383,Boris Katchouk,L,OTT,26,82,9,9,18
17,8473453,Trevor Lewis,C,LAK,37,82,8,10,18
17,8481477,Nico Sturm,C,SJS,29,82,7,11,18
17,8477507,Nikita Zadorov,D,VAN,29,82,7,11,18
17,8480990,Declan Chisholm,D,MIN,24,82,7,11,18
17,8476858,Phillip Di Giuseppe,L,VAN,31,82,6,12,18
17,8480834,Ty Emberson,D,SJS,24,82,5,13,18
17,8477369,Carson Soucy,D,VAN,30,82,5,13,18
17,8481606,Jordan Spence,D,LAK,23,82,4,14,18
17,8476967,Brett Kulak,D,EDM,30,82,4,14,18
17,8479980,Nicolas Hague,D,VGK,26,82,4,14,18
17,8477365,Connor Clifton,D,BUF,29,82,2,16,18
17,8483505,Matthew Poitras,C,BOS,20,82,8,9,17
17,8482679,Matt Coronato,R,CGY,22,82,8,9,17
17,8473504,Cal Clutterbuck,R,NYI,37,82,7,10,17
17,8475462,Radko Gudas,D,ANA,34,82,6,11,17
17,8476374,Sean Kuraly,C,CBJ,31,82,6,11,17
17,8481537,Nikita Okhotiuk,D,CGY,24,82,6,11,17
17,8477425,Miles Wood,L,COL,29,82,5,12,17
17,8476467,Jamie Oleksiak,D,SEA,32,82,5,12,17
17,8479983,Mario Ferraro,D,SJS,26,82,4,13,17
17,8477499,Rasmus Ristolainen,D,PHI,30,82,4,13,17
17,8475179,Dmitry Kulikov,D,FLA,34,82,3,14,17
17,8474166,Alec Martinez,D,VGK,37,82,3,14,17
17,8477435,Ryan Graves,D,PIT,29,82,3,14,17
17,8470966,Mark Giordano,D,TOR,41,82,3,14,17
17,8473507,Jeff Petry,D,DET,37,82,2,15,17
17,8478443,Brandon Carlo,D,BOS,28,82,2,15,17
17,8480879,Jacob Bernard-Docker,D,OTT,24,82,2,15,17
17,8482516,Matthew Kessel,D,STL,24,82,2,15,17
17,8477015,Connor Brown,R,EDM,30,82,2,15,17
17,8482858,Ryker Evans,D,SEA,23,82,2,15,17
17,8478136,Jake Middleton,D,MIN,28,82,1,16,17
17,8480448,Parker Kelly,L,OTT,25,82,9,7,16
17,8479291,Kevin Rooney,C,CGY,31,82,8,8,16
17,8478430,Oliver Kylington,D,CGY,27,82,6,10,16
17,8482737,Zack Bolduc,C,STL,21,82,6,10,16
17,8478468,Jeremy Lauzon,D,NSH,27,82,6,10,16
17,8478859,Niko Mikkola,D,FLA,28,82,4,12,16
17,8483565,Nick Blankenburg,D,CBJ,26,82,4,12,16
17,8475790,Erik Gudbranson,D,CBJ,32,82,3,13,16
17,8474567,Zach Bogosian,D,MIN,34,82,2,14,16
17,8477353,Tyler Motte,C,TBL,29,82,8,7,15
17,8482166,Shakir Mukhamadullin,D,SJS,22,82,7,8,15
17,8477931,Tomas Nosek,L,NJD,32,82,7,8,15
17,8480813,Joe Veleno,C,DET,24,82,3,12,15
17,8477505,Alexander Wennberg,C,NYR,30,82,3,12,15
17,8475208,Brian Dumoulin,D,SEA,33,82,3,12,15
17,8475233,David Savard,D,MTL,34,82,1,14,15
17,8476473,Connor Murphy,D,CHI,31,82,1,14,15
17,8478831,Kevin Stenlund,C,FLA,28,82,6,8,14
17,8477406,Mattias Janmark,C,EDM,32,82,5,9,14
17,8470600,Ryan Suter,D,DAL,39,82,4,10,14
17,8476921,Jordan Martinook,L,CAR,32,82,3,11,14
17,8480058,Pierre-Olivier Joseph,D,PIT,25,82,3,11,14
17,8479324,Ryan Lindgren,D,NYR,26,82,3,11,14
17,8482245,Artem Zub,D,OTT,29,82,2,12,14
17,8482470,Ilya Solovyov,D,CGY,24,82,2,12,14
17,8474013,Ian Cole,D,VAN,35,82,2,12,14
17,8476822,Luke Glendening,C,TBL,35,82,8,5,13
17,8483482,Tristan Luneau,D,ANA,20,82,4,9,13
17,8475825,Jani Hakanpää,D,DAL,32,82,4,9,13
17,8484911,Collin Graf,R,SJS,22,82,3,10,13
17,8482859,Zack Ostapchuk,C,OTT,21,82,3,10,13
17,8482712,Oskar Olausson,R,COL,22,82,1,12,13
17,8481030,Jack St. Ivany,D,PIT,25,82,1,12,13
17,8481578,Graeme Clarke,R,NJD,23,82,7,5,12
17,8482807,Ethan Del Mastro,D,CHI,21,82,5,7,12
17,8483012,Logan Morrison,C,SEA,22,82,4,8,12
17,8471677,Jack Johnson,D,COL,37,82,3,9,12
17,8481605,Jackson LaCombe,D,ANA,23,82,2,10,12
17,8482666,Scott Morrow,D,CAR,22,82,2,10,12
17,8478399,Jonas Siegenthaler,D,NJD,27,82,1,11,12
17,8481517,Brett Leason,R,ANA,25,82,8,3,11
17,8482762,Simon Edvinsson,D,DET,21,82,6,5,11
17,8478416,Erik Cernak,D,TBL,27,82,5,6,11
17,8476879,Cody Ceci,D,EDM,31,82,4,7,11
17,8477335,Kyle Burroughs,D,SJS,29,82,4,7,11
17,8476915,Jujhar Khaira,L,MIN,30,82,4,7,11
17,8483468,Jiri Kulich,C,BUF,20,82,3,8,11
17,8481178,Egor Zamula,D,PHI,24,82,2,9,11
17,8480807,Mattias Samuelsson,D,BUF,24,82,2,9,11
17,8476372,Nick Seeler,D,PHI,31,82,2,9,11
17,8477488,Brett Pesce,D,CAR,30,82,1,10,11
17,8475762,Derek Forbort,D,BOS,32,82,1,10,11
17,8475177,Calvin de Haan,D,TBL,33,82,3,7,10
17,8483489,Fraser Minten,C,TOR,31,82,3,7,10
17,8484149,Gavin Brindley,C,CBJ,20,82,3,7,10
17,8477034,Jaycob Megna,D,CHI,32,82,0,10,10
17,8475279,Ben Chiarot,D,DET,33,82,2,7,9
17,8482177,Marat Khusnutdinov,C,MIN,22,82,2,7,9
17,8479442,Troy Stecher,D,EDM,30,82,1,8,9
17,8481599,Victor Soderstrom,D,ARI,23,82,0,9,9
17,8483763,Maksymilian Szuber,D,ARI,22,82,5,3,8
17,8478408,Travis Dermott,D,ARI,28,82,3,4,7
17,8482713,Mackie Samoskevich,R,FLA,22,82,0,6,6
17,8482141,Lukas Cormier,D,VGK,22,0,0,0,0
17,8476988,Matt Benning,D,SJS,30,0,0,0,0
17,8480727,Zach Whitecloud,D,VGK,28,0,0,0,0
17,8480887,Jordan Harris,D,MTL,24,0,0,0,0
17,8478450,Parker Wotherspoon,D,BOS,27,0,0,0,0
17,8481812,Nikolai Knyzhov,D,SJS,27,0,0,0,0
17,8480001,Urho Vaakanainen,D,ANA,25,0,0,0,0
17,8482176,Wyatt Kaiser,D,CHI,22,0,0,0,0
17,8481122,Simon Benoit,D,TOR,26,0,0,0,0
17,8476441,Joel Edmundson,D,TOR,31,0,0,0,0
17,8480884,Calen Addison,D,SJS,24,0,0,0,0
17,8482511,Mason Lohrei,D,BOS,23,0,0,0,0
17,8482192,Isaak Phillips,D,CHI,23,0,0,0,0
17,8480950,Ilya Lyubushkin,D,TOR,30,0,0,0,0
17,8474031,Kevin Shattenkirk,D,BOS,35,0,0,0,0
17,8475718,Justin Holl,D,DET,32,0,0,0,0
17,8479402,Jake Bean,D,CBJ,26,0,0,0,0
17,8474602,Justin Schultz,D,SEA,34,0,0,0,0
17,8477950,Tony DeAngelo,D,CAR,29,0,0,0,0
17,8481743,Marc Del Gaizo,D,NSH,25,0,0,0,0
17,8481527,Kaedan Korczak,D,VGK,23,0,0,0,0
17,8480192,Johnathan Kovacevic,D,MTL,27,0,0,0,0
17,8476874,Olli Maatta,D,DET,30,0,0,0,0
17,8482144,Jack Thompson,D,SJS,22,0,0,0,0
17,8480222,Sebastian Aho,D,NYI,28,0,0,0,0
17,8479458,Nikita Zaitsev,D,CHI,33,0,0,0,0
17,8471709,Marc-Edouard Vlasic,D,SJS,37,0,0,0,0
17,8482929,Emil Lilleberg,D,TBL,23,0,0,0,0
17,8477018,Ben Hutton,D,VGK,31,0,0,0,0
17,8481056,Spencer Stastney,D,NSH,24,0,0,0,0
17,8481593,Jayden Struble,D,MTL,23,0,0,0,0
17,8479982,Conor Timmins,D,TOR,26,0,0,0,0
17,8474090,Brendan Smith,D,NJD,35,0,0,0,0
17,8482964,Arber Xhekaj,D,MTL,23,0,0,0,0
17,8480891,Michael Kesselring,D,ARI,24,0,0,0,0
17,8477938,Haydn Fleury,D,TBL,28,0,0,0,0
17,8481806,Louis Crevier,D,CHI,23,0,0,0,0
17,8471274,Alex Goligoski,D,MIN,39,0,0,0,0
17,8481600,Tobias Bjornfot,D,FLA,23,0,0,0,0
17,8475797,Jarred Tinordi,D,CHI,32,0,0,0,0
17,8481521,Ronnie Attard,D,PHI,25,0,0,0,0
17,8474612,Travis Hamonic,D,OTT,34,0,0,0,0
17,8479576,Vincent Desharnais,D,EDM,28,0,0,0,0
17,8480049,Dylan Samberg,D,WPG,25,0,0,0,0
17,8483619,Filip Roos,D,CHI,25,0,0,0,0
17,8474568,Luke Schenn,D,NSH,35,0,0,0,0
17,8480184,Gustav Lindstrom,D,ANA,26,0,0,0,0
17,8480070,Ian Mitchell,D,BOS,25,0,0,0,0
17,8480196,Jacob Bryson,D,BUF,27,0,0,0,0
17,8471686,Marc Staal,D,PHI,37,0,0,0,0
17,8477467,Gustav Olofsson,D,SEA,30,0,0,0,0
17,8478970,Jalen Chatfield,D,CAR,28,0,0,0,0
17,8479348,Kale Clague,D,BUF,26,0,0,0,0
17,8473446,Erik Johnson,D,PHI,36,0,0,0,0
17,8477462,Robert Hagg,D,ANA,29,0,0,0,0
17,8478454,Noah Juulsen,D,VAN,27,0,0,0,0
17,8477384,Josh Brown,D,ARI,30,0,0,0,0
17,8481708,Zac Jones,D,NYR,24,0,0,0,0
17,8481167,Brayden Pachal,D,CGY,25,0,0,0,0
17,8482067,Connor Mackey,D,NYR,28,0,0,0,0
17,8483460,David Jiricek,D,CBJ,21,0,0,0,0
17,8481701,Santeri Hatakka,D,NJD,23,0,0,0,0
17,8478021,William Lagesson,D,ANA,28,0,0,0,0
17,8477851,Jordan Oesterle,D,CGY,32,0,0,0,0
17,8478452,Caleb Jones,D,COL,27,0,0,0,0
17,8479984,Cal Foote,D,NJD,26,0,0,0,0
17,8479639,Dylan Coghlan,D,CAR,26,0,0,0,0
17,8480874,Adam Ginning,D,PHI,24,0,0,0,0
17,8479321,Lucas Johansen,D,WSH,27,0,0,0,0
17,8480878,Nils Lundkvist,D,DAL,24,0,0,0,0
17,8482165,Yan Kuznetsov,D,CGY,22,0,0,0,0
17,8484258,Sam Malinski,D,COL,26,0,0,0,0
17,8480157,Calle Rosen,D,STL,30,0,0,0,0
17,8484304,Uvis Balinskis,D,FLA,28,0,0,0,0
17,8479985,Cale Fleury,D,SEA,26,0,0,0,0
17,8479378,Logan Stanley,D,WPG,26,0,0,0,0
17,8477541,Dakota Mermis,D,MIN,30,0,0,0,0
17,8481609,Vladislav Kolyachonok,D,ARI,23,0,0,0,0
17,8480823,Alexander Alexeyev,D,WSH,25,0,0,0,0
17,8481679,Maxence Guenette,D,OTT,23,0,0,0,0
17,8481564,Ryan Johnson,D,BUF,23,0,0,0,0
17,8479376,Victor Mete,D,PHI,26,0,0,0,0
17,8484254,Akito Hirose,D,VAN,25,0,0,0,0
17,8482660,Kent Johnson,C,CBJ,22,0,0,0,0
17,8482149,Cole Perfetti,C,WPG,22,0,0,0,0
17,8477987,Ryan Donato,C,CHI,28,0,0,0,0
17,8475755,Alexander Petrovic,D,DAL,32,0,0,0,0
17,8477810,Joel Hanley,D,CGY,33,0,0,0,0
17,8474145,Robert Bortuzzo,D,NYI,35,0,0,0,0
17,8481161,Jake Christiansen,D,CBJ,25,0,0,0,0
17,8476884,Derrick Pouliot,D,DAL,30,0,0,0,0
17,8481716,Dmitri Voronkov,L,CBJ,24,0,0,0,0
17,8480084,Nick DeSimone,D,NJD,30,0,0,0,0
17,8475750,Jon Merrill,D,MIN,32,0,0,0,0
17,8479315,Joey Anderson,R,CHI,26,0,0,0,0
17,8478011,Louie Belpedio,D,PHI,28,0,0,0,0
17,8482451,Mikael Pyyhtia,L,CBJ,23,0,0,0,0
17,8481541,Samuel Bolduc,D,NYI,24,0,0,0,0
17,8482126,Emil Andrae,D,PHI,31,0,0,0,0
17,8474618,Marco Scandella,D,STL,34,0,0,0,0
17,8477244,Chad Ruhwedel,D,NYR,34,0,0,0,0
17,8477971,Andreas Englund,D,LAK,28,0,0,0,0
17,8480829,Jesperi Kotkaniemi,C,CAR,24,0,0,0,0
17,8479372,Josh Mahura,D,FLA,26,0,0,0,0
17,8482095,Tyler Kleven,D,OTT,22,0,0,0,0
17,8481719,Maxwell Crozier,D,TBL,24,0,0,0,0
17,8475855,Jesper Fast,R,CAR,33,0,0,0,0
17,8480848,Ty Dellandrea,C,DAL,24,0,0,0,0
17,8475193,Tomas Tatar,L,SEA,34,0,0,0,0
17,8476889,Radek Faksa,C,DAL,30,0,0,0,0
17,8478495,Denis Gurianov,R,PHI,27,0,0,0,0
17,8480216,Jacob Peterson,C,SJS,25,0,0,0,0
17,8480252,Cole Guttman,C,CHI,25,0,0,0,0
17,8479026,Philippe Myers,D,TBL,27,0,0,0,0
17,8481006,Tyler Tucker,D,STL,24,0,0,0,0
17,8481032,Paul Cotter,C,VGK,25,0,0,0,0
17,8481577,Philip Tomasino,C,NSH,23,0,0,0,0
17,8476918,Jimmy Vesey,L,NYR,31,0,0,0,0
17,8479320,Max Lajoie,D,TOR,27,0,0,0,0
17,8478017,Mark Friedman,D,VAN,29,0,0,0,0
17,8481754,Nikita Nesterenko,C,ANA,23,0,0,0,0
17,8483407,Brandon Scanlin,D,NYR,25,0,0,0,0
17,8482659,Josh Doan,R,ARI,22,0,0,0,0
17,8477446,Michael McCarron,R,NSH,29,0,0,0,0
17,8477903,Garnet Hathaway,R,PHI,33,0,0,0,0
17,8482153,Brendan Brisson,C,VGK,23,0,0,0,0
17,8483546,Marshall Rifai,D,TOR,26,0,0,0,0
17,8484287,Cole McWard,D,VAN,23,0,0,0,0
17,8478854,Ryan Shea,D,PIT,27,0,0,0,0
17,8481585,Egor Afanasyev,L,NSH,23,0,0,0,0
17,8483398,Declan Carlile,D,TBL,31,0,0,0,0
17,8478502,Dennis Gilbert,D,CGY,28,0,0,0,0
17,8482749,Joshua Roy,R,MTL,21,0,0,0,0
17,8481598,Philip Broberg,D,EDM,23,0,0,0,0
17,8480835,Jack Drury,C,CAR,24,0,0,0,0
17,8480748,Kiefer Sherwood,L,NSH,29,0,0,0,0
17,8476934,Brock McGinn,L,ANA,30,0,0,0,0
17,8480870,Bo Groulx,C,ANA,24,0,0,0,0
17,8479368,Max Jones,L,ANA,26,0,0,0,0
17,8478099,Kevin Labanc,R,SJS,29,0,0,0,0
17,8478067,Oskar Lindblom,L,SJS,28,0,0,0,0
17,8476393,Nick Cousins,C,FLA,31,0,0,0,0
17,8483395,Arshdeep Bains,L,VAN,23,0,0,0,0
17,8480762,Eric Robinson,L,BUF,29,0,0,0,0
17,8479439,Jacob MacDonald,D,SJS,31,0,0,0,0
17,8476474,Stefan Noesen,R,CAR,31,0,0,0,0
17,8482787,Nikita Chibrikov,R,WPG,31,0,0,0,0
17,8478432,Christian Fischer,R,DET,27,0,0,0,0
17,8477979,Nicolas Aube-Kubel,R,WSH,28,0,0,0,0
17,8481789,Tye Kartye,L,SEA,23,0,0,0,0
17,8479330,Brandon Gignac,C,MTL,27,0,0,0,0
17,8480075,Cameron Crotty,D,ARI,25,0,0,0,0
17,8473473,Milan Lucic,L,BOS,36,0,0,0,0
17,8482094,Daemon Hunt,D,MIN,22,0,0,0,0
17,8481206,John Ludvig,D,PIT,24,0,0,0,0
17,8483630,Pavol Regenda,L,ANA,25,0,0,0,0
17,8481617,Vasily Podkolzin,R,VAN,23,0,0,0,0
17,8480306,Grant Hutton,D,NYI,29,0,0,0,0
17,8480995,Pontus Holmberg,R,TOR,25,0,0,0,0
17,8482148,Hendrix Lapierre,C,WSH,22,0,0,0,0
17,8477478,William Carrier,L,VGK,30,0,0,0,0
17,8480003,Jesper Boqvist,C,BOS,26,0,0,0,0
17,8482172,Landon Slaggert,L,CHI,22,0,0,0,0
17,8480789,Oliver Wahlstrom,R,NYI,24,0,0,0,0
17,8474062,Riley Nash,C,NYR,35,0,0,0,0
17,8480021,Jack Studnicka,C,SJS,25,0,0,0,0
17,8480025,MacKenzie Entwistle,R,CHI,25,0,0,0,0
17,8481582,Nicholas Robertson,L,TOR,23,0,0,0,0
17,8476867,Brendan Gaunce,C,CBJ,30,0,0,0,0
17,8479619,Michael Carcone,L,ARI,28,0,0,0,0
17,8479370,Tyson Jost,C,BUF,26,0,0,0,0
17,8479671,Mathieu Olivier,R,CBJ,27,0,0,0,0
17,8476994,Vinnie Hinostroza,C,PIT,30,0,0,0,0
17,8482070,Mitchell Chaffee,R,TBL,26,0,0,0,0
17,8477473,Justin Bailey,R,SJS,29,0,0,0,0
17,8479344,Jesse Puljujarvi,R,PIT,26,0,0,0,0
17,8480205,Emil Bemstrom,C,PIT,25,0,0,0,0
17,8479718,Alex Barré-Boulet,C,TBL,27,0,0,0,0
17,8482061,Brandon Biro,L,BUF,26,0,0,0,0
17,8479638,Justin Brazeau,R,BOS,26,0,0,0,0
17,8474040,Sam Gagner,C,EDM,35,0,0,0,0
17,8477846,Ryan Carpenter,C,SJS,33,0,0,0,0
17,8482077,Dylan Holloway,L,EDM,23,0,0,0,0
17,8482157,Will Cuylle,L,NYR,22,0,0,0,0
17,8480007,Jonas Rondbjerg,R,VGK,25,0,0,0,0
17,8478874,Adam Gaudette,C,STL,28,0,0,0,0
17,8478434,Keegan Kolesar,R,VGK,27,0,0,0,0
17,8480441,Trey Fix-Wolansky,R,CBJ,25,0,0,0,0
17,8479994,Jaret Anderson-Dolan,C,NSH,25,0,0,0,0
17,8483567,Georgii Merkulov,C,BOS,24,0,0,0,0
17,8477380,Jonny Brodzinski,C,NYR,31,0,0,0,0
17,8482201,Gage Goncalves,C,TBL,23,0,0,0,0
17,8478211,Dryden Hunt,L,CGY,29,0,0,0,0
17,8471699,Andrew Cogliano,C,COL,37,0,0,0,0
17,8479421,Jacob Moverare,D,LAK,26,0,0,0,0
17,8478881,Brett Seney,L,CHI,28,0,0,0,0
17,8477464,Nic Petan,C,MIN,29,0,0,0,0
17,8475958,Michael Sgarbossa,C,WSH,32,0,0,0,0
17,8481147,Reese Johnson,C,CHI,26,0,0,0,0
17,8479336,Carl Grundstrom,R,LAK,27,0,0,0,0
17,8480853,Liam Foudy,C,NSH,24,0,0,0,0
17,8479522,Hardy Haman Aktell,D,WSH,26,0,0,0,0
17,8481462,Mason Morelli,L,VGK,28,0,0,0,0
17,8482102,Vasily Ponomarev,C,CAR,22,0,0,0,0
17,8480844,Grigori Denisenko,L,VGK,24,0,0,0,0
17,8479944,Zach Aston-Reese,C,DET,30,0,0,0,0
17,8482784,Zach Dean,C,STL,21,0,0,0,0
17,8479419,Brett Murray,L,BUF,26,0,0,0,0
17,8479520,Brandon Duhaime,R,COL,27,0,0,0,0
17,8477573,Nathan Walker,L,STL,30,0,0,0,0
17,8478078,Rourke Chartier,C,OTT,28,0,0,0,0
17,8475795,Dylan McIlrath,D,WSH,32,0,0,0,0
17,8482496,Nils Aman,C,VAN,24,0,0,0,0
17,8480289,Morgan Barron,C,WPG,26,0,0,0,0
17,8481751,Lukas Rousek,R,BUF,25,0,0,0,0
17,8480011,Klim Kostin,C,SJS,25,0,0,0,0
17,8481556,John Beecher,C,BOS,23,0,0,0,0
17,8475278,Byron Froese,C,VGK,33,0,0,0,0
17,8475225,Craig Smith,C,DAL,35,0,0,0,0
17,8484326,Patrik Koch,D,ARI,28,0,0,0,0
17,8477930,Pierre-Edouard Bellemare,L,SEA,39,0,0,0,0
17,8478409,Anthony Richard,C,BOS,28,0,0,0,0
17,8481024,Linus Karlsson,C,VAN,25,0,0,0,0
17,8479986,Kole Lind,R,SEA,26,0,0,0,0
17,8479414,Nathan Bastian,R,NJD,27,0,0,0,0
17,8479362,Riley Tufte,L,COL,26,0,0,0,0
17,8481058,Jesse Ylönen,R,MTL,25,0,0,0,0
17,8482476,Emil Heineman,L,MTL,23,0,0,0,0
17,8482861,Vincent Iorio,D,WSH,22,0,0,0,0
17,8483432,Luca Del Bel Belluz,C,CBJ,31,0,0,0,0
17,8482744,James Malatesta,L,CBJ,21,0,0,0,0
17,8477887,Patrick Brown,C,BOS,32,0,0,0,0
17,8478585,Derek Ryan,C,EDM,38,0,0,0,0
17,8481441,Joe Snively,C,WSH,28,0,0,0,0
17,8481592,Jakob Pelletier,L,CGY,23,0,0,0,0
17,8482634,Alex Steeves,C,TOR,25,0,0,0,0
17,8477126,Jayson Megna,C,BOS,34,0,0,0,0
17,8475752,Tyler Pitlick,C,NYR,33,0,0,0,0
17,8480008,Adam Ruzicka,C,ARI,25,0,0,0,0
17,8481065,Angus Crookshank,L,OTT,25,0,0,0,0
17,8479547,Matthew Phillips,R,WSH,26,0,0,0,0
17,8480226,Marián Studenic,R,SEA,26,0,0,0,0
17,8481237,Kyle MacLean,C,NYI,25,0,0,0,0
17,8475413,Justin Dowling,C,NJD,34,0,0,0,0
17,8481641,Joel Kiviranta,L,COL,28,0,0,0,0
17,8478104,Sammy Blais,L,STL,28,0,0,0,0
17,8477454,Adam Erne,L,EDM,29,0,0,0,0
17,8481518,Nolan Foote,L,NJD,24,0,0,0,0
17,8480245,Olle Lycksell,R,PHI,25,0,0,0,0
17,8483570,Ben Meyers,C,ANA,26,0,0,0,0
17,8480776,Sheldon Rempal,R,VGK,29,0,0,0,0
17,8483920,Pierrick Dube,R,WSH,23,0,0,0,0
17,8480267,Sammy Walker,C,MIN,25,0,0,0,0
17,8482747,Brennan Othmann,L,NYR,21,0,0,0,0
17,8479991,Jake Leschyshyn,C,NYR,25,0,0,0,0
17,8478400,Colin White,C,MTL,27,0,0,0,0
17,8479328,Julien Gauthier,R,NYI,27,0,0,0,0
17,8484325,Waltteri Merela,C,TBL,26,0,0,0,0
17,8479066,Ryan Lomberg,L,FLA,30,0,0,0,0
17,8477070,Liam O'Brien,C,ARI,30,0,0,0,0
17,8478146,Matthew Highmore,C,OTT,28,0,0,0,0
17,8478028,Fredrik Olofsson,L,COL,28,0,0,0,0
17,8480880,Jakub Lauko,C,BOS,24,0,0,0,0
17,8479968,Vinni Lettieri,C,MIN,29,0,0,0,0
17,8474709,Matt Martin,L,NYI,35,0,0,0,0
17,8480845,Rasmus Kupari,C,WPG,24,0,0,0,0
17,8481550,Adam Beckman,L,MIN,23,0,0,0,0
17,8481422,Jacob Lucchini,C,MIN,29,0,0,0,0
17,8477401,John Hayden,C,SEA,29,0,0,0,0
17,8478904,Steven Lorentz,C,FLA,28,0,0,0,0
17,8482088,Justin Sourdif,R,FLA,22,0,0,0,0
17,8482751,Ryan Winterton,C,SEA,21,0,0,0,0
17,8482241,Radim Zohorna,L,PIT,28,0,0,0,0
17,8481690,Tyler Angle,C,CBJ,24,0,0,0,0
17,8476952,Dominic Toninato,C,WPG,30,0,0,0,0
17,8476919,Chris Tierney,C,NJD,30,0,0,0,0
17,8480032,Shane Bowers,C,NJD,25,0,0,0,0
17,8484314,Jiri Smejkal,L,OTT,28,0,0,0,0
17,8481239,Samuel Fagemo,L,LAK,24,0,0,0,0
17,8481532,Alex Turcotte,C,LAK,23,0,0,0,0
17,8481019,David Gustafsson,C,WPG,24,0,0,0,0
17,8478477,Mitchell Stephens,C,MTL,27,0,0,0,0
17,8479546,Oskar Steen,C,BOS,26,0,0,0,0
17,8480292,Carson Meyer,R,CBJ,27,0,0,0,0
17,8478446,Glenn Gawdin,C,ANA,27,0,0,0,0
17,8483531,Brian Halonen,L,NJD,25,0,0,0,0
17,8477149,Scott Sabourin,R,SJS,32,0,0,0,0
17,8479972,Mason Shaw,C,MIN,26,0,0,0,0
17,8480890,Jan Jenik,R,ARI,24,0,0,0,0
17,8478051,Max Willman,C,NJD,29,0,0,0,0
17,8480851,Akil Thomas,C,LAK,24,0,0,0,0
17,8482765,Isak Rosen,R,BUF,21,0,0,0,0
17,8478421,A.J. Greer,L,CGY,28,0,0,0,0
17,8478512,Austin Czarnik,C,DET,32,0,0,0,0
17,8479536,Axel Jonsson-Fjallby,L,WPG,26,0,0,0,0
17,8477320,Anton Blidh,L,NYR,29,0,0,0,0
17,8481543,Nikita Alexandrov,C,STL,24,0,0,0,0
17,8475235,Nicolas Deslauriers,L,PHI,33,0,0,0,0
17,8481070,Hugh McGing,L,STL,26,0,0,0,0
17,8480836,Jonathan Gruden,C,PIT,24,0,0,0,0
17,8481591,Sam Poulin,R,PIT,23,0,0,0,0
17,8477962,Brendan Lemieux,L,CAR,28,0,0,0,0
17,8483401,Marc Johnstone,R,PIT,28,0,0,0,0
17,8482250,Callahan Burke,C,CAR,27,0,0,0,0
17,8481726,Adam Edstrom,C,NYR,24,0,0,0,0
17,8471817,Ryan Reaves,R,TOR,37,0,0,0,0
17,8479587,Rhett Gardner,C,PHI,28,0,0,0,0
17,8475766,Austin Watson,L,TBL,32,0,0,0,0
17,8479367,William Lockwood,R,FLA,26,0,0,0,0
17,8478424,Jansen Harkins,C,PIT,27,0,0,0,0
17,8476913,Devin Shore,C,SEA,30,0,0,0,0
17,8482652,Walker Duehr,R,CGY,27,0,0,0,0
17,8477527,Ross Johnston,L,ANA,30,0,0,0,0
17,8481077,John Leonard,L,ARI,26,0,0,0,0
17,8483549,Lucas Condotta,L,MTL,27,0,0,0,0
17,8480468,James Hamblin,L,EDM,25,0,0,0,0
17,8476907,Mackenzie MacEachern,L,STL,30,0,0,0,0
17,8479543,Michael Pezzetta,L,MTL,26,0,0,0,0
17,8480355,Mark Kastelic,C,OTT,25,0,0,0,0
17,8482162,Roby Jarventie,L,OTT,22,0,0,0,0
17,8479772,Zack MacEwen,R,OTT,28,0,0,0,0
17,8483597,Milos Kelemen,L,ARI,25,0,0,0,0
17,8479379,Givani Smith,R,SJS,26,0,0,0,0
17,8481655,Cole Schwindt,R,CGY,23,0,0,0,0
17,8479981,Jonah Gadjovich,L,FLA,26,0,0,0,0
17,8482147,Jean-Luc Foudy,C,COL,22,0,0,0,0
17,8484255,Jason Polin,R,COL,25,0,0,0,0
17,8477993,Justin Kirkland,C,ARI,28,0,0,0,0
17,8479249,Andrew Poturalski,C,SEA,30,0,0,0,0
17,8482197,Adam Raska,R,MIN,23,0,0,0,0
17,8475780,Chris Wagner,R,COL,33,0,0,0,0
17,8479533,Joona Koppanen,L,PIT,26,0,0,0,0
17,8481534,Raphael Lavoie,C,EDM,24,0,0,0,0
17,8484321,Nikolas Matinpalo,D,OTT,26,0,0,0,0
17,8481043,Cole Koepke,L,TBL,26,0,0,0,0
17,8476323,Max McCormick,L,SEA,32,0,0,0,0
17,8483609,Adam Klapka,R,CGY,24,0,0,0,0
17,8483512,Matt Savoie,C,BUF,20,0,0,0,0
17,8484259,Ondrej Pavel,C,COL,31,0,0,0,0
17,8478147,Bokondji Imama,L,OTT,28,0,0,0,0
17,8482460,Matt Rempe,C,NYR,22,0,0,0,0
17,8477073,Kurtis MacDermid,L,NJD,30,0,0,0,0
17,8480274,Philip Kemp,D,EDM,25,0,0,0,0
17,8478956,Samuel Laberge,L,NJD,27,0,0,0,0
17,8483045,Cameron Butler,R,CBJ,31,0,0,0,0
18,8481559,Jack Hughes,C,NJD,23,82,45,72,117
18,8478402,Connor McDavid,C,EDM,27,82,39,77,116
18,8479314,Matthew Tkachuk,L,FLA,27,82,47,62,109
18,8477492,Nathan MacKinnon,C,COL,29,82,41,65,106
18,8477946,Dylan Larkin,C,DET,28,82,45,56,101
18,8477960,Adrian Kempe,R,LAK,28,82,48,52,100
18,8476453,Nikita Kucherov,R,TBL,31,82,27,73,100
18,8477956,David Pastrnak,R,BOS,28,82,55,44,99
18,8479318,Auston Matthews,C,TOR,27,82,54,45,99
18,8478864,Kirill Kaprizov,L,MIN,27,82,54,45,99
18,8480023,Robert Thomas,C,STL,25,82,32,65,97
18,8476887,Filip Forsberg,L,NSH,30,82,42,51,93
18,8474564,Steven Stamkos,C,TBL,34,82,47,45,92
18,8478420,Mikko Rantanen,R,COL,28,82,37,52,89
18,8477493,Aleksander Barkov,C,FLA,29,82,29,59,88
18,8479407,Jesper Bratt,L,NJD,26,82,27,61,88
18,8477933,Sam Reinhart,C,FLA,29,82,38,49,87
18,8471675,Sidney Crosby,C,PIT,37,82,36,51,87
18,8474141,Patrick Kane,R,DET,36,82,32,55,87
18,8480027,Jason Robertson,L,DAL,25,82,22,64,86
18,8477942,Kevin Fiala,L,LAK,28,82,29,56,85
18,8478439,Travis Konecny,R,PHI,27,82,30,54,84
18,8477402,Pavel Buchnevich,L,STL,29,82,36,46,82
18,8477939,William Nylander,R,TOR,28,82,38,43,81
18,8478010,Brayden Point,C,TBL,28,82,39,41,80
18,8478550,Artemi Panarin,L,NYR,33,82,34,46,80
18,8477934,Leon Draisaitl,C,EDM,29,82,24,56,80
18,8475786,Zach Hyman,L,EDM,32,82,46,33,79
18,8480069,Cale Makar,D,COL,26,82,27,52,79
18,8474600,Roman Josi,D,NSH,34,82,16,63,79
18,8478398,Kyle Connor,L,WPG,28,82,33,44,77
18,8480002,Nico Hischier,C,NJD,25,82,32,44,76
18,8479337,Alex DeBrincat,R,DET,27,82,30,46,76
18,8478042,Viktor Arvidsson,R,LAK,31,82,27,49,76
18,8478047,Michael Bunting,L,PIT,29,82,29,46,75
18,8481557,Matt Boldy,L,MIN,23,82,25,50,75
18,8482078,Lucas Raymond,L,DET,22,82,24,51,75
18,8480801,Brady Tkachuk,L,OTT,25,82,42,31,73
18,8476468,J.T. Miller,C,VAN,31,82,35,37,72
18,8478427,Sebastian Aho,C,CAR,27,82,32,40,72
18,8479385,Jordan Kyrou,C,STL,26,82,33,38,71
18,8479343,Clayton Keller,R,ARI,26,82,32,39,71
18,8471215,Evgeni Malkin,C,PIT,38,82,30,41,71
18,8478873,Troy Terry,R,ANA,27,82,25,46,71
18,8470794,Joe Pavelski,C,DAL,40,82,23,47,70
18,8477940,Nikolaj Ehlers,L,WPG,28,82,21,49,70
18,8478414,Timo Meier,R,NJD,28,82,37,32,69
18,8479542,Brandon Hagel,L,TBL,26,82,22,47,69
18,8478403,Jack Eichel,C,VGK,28,82,33,35,68
18,8475166,John Tavares,C,TOR,34,82,28,40,68
18,8480830,Andrei Svechnikov,R,CAR,24,82,26,42,68
18,8475158,Ryan O'Reilly,C,NSH,33,82,26,42,68
18,8478440,Dylan Strome,C,WSH,27,82,24,44,68
18,8475172,Nazem Kadri,C,CGY,34,82,24,44,68
18,8476454,Ryan Nugent-Hopkins,C,EDM,31,82,19,48,67
18,8474578,Erik Karlsson,D,PIT,34,82,19,48,67
18,8475810,Bryan Rust,R,PIT,32,82,32,34,66
18,8477955,Jared McCann,L,SEA,28,82,28,38,66
18,8482116,Tim Stützle,C,OTT,22,82,23,43,66
18,8475798,Mikael Granlund,C,SJS,32,82,14,52,66
18,8477409,Carter Verhaeghe,C,FLA,29,82,23,42,65
18,8477949,Alex Tuch,R,BUF,28,82,21,44,65
18,8476460,Mark Scheifele,C,WPG,31,82,26,38,64
18,8475168,Matt Duchene,C,DAL,33,82,23,41,64
18,8480803,Evan Bouchard,D,EDM,25,82,19,45,64
18,8477501,Valeri Nichushkin,R,COL,29,82,29,34,63
18,8475184,Chris Kreider,L,NYR,33,82,42,20,62
18,8479420,Tage Thompson,C,BUF,27,82,33,29,62
18,8475913,Mark Stone,R,VGK,32,82,24,38,62
18,8477404,Jake Guentzel,C,CAR,30,82,23,39,62
18,8480036,Miro Heiskanen,D,DAL,25,82,17,45,62
18,8479325,Charlie McAvoy,D,BOS,27,82,12,50,62
18,8480208,Drake Batherson,R,OTT,26,82,20,41,61
18,8471685,Anze Kopitar,C,LAK,37,82,17,44,61
18,8476346,Johnny Gaudreau,L,CBJ,31,82,16,45,61
18,8476462,Dougie Hamilton,D,NJD,31,82,16,45,61
18,8476456,Jonathan Huberdeau,C,CGY,31,82,12,49,61
18,8479323,Adam Fox,D,NYR,26,82,10,51,61
18,8471214,Alex Ovechkin,L,WSH,39,82,30,30,60
18,8480012,Elias Pettersson,C,VAN,26,82,26,34,60
18,8482097,Jack Quinn,R,BUF,23,82,25,35,60
18,8476479,Phillip Danault,C,LAK,31,82,25,35,60
18,8473512,Claude Giroux,R,OTT,36,82,20,40,60
18,8478445,Mathew Barzal,C,NYI,27,82,14,46,60
18,8478407,Vince Dunn,D,SEA,28,82,12,48,60
18,8474590,John Carlson,D,WSH,34,82,11,49,60
18,8477500,Bo Horvat,C,NYI,29,82,31,28,59
18,8478493,Joel Eriksson Ek,C,MIN,27,82,28,31,59
18,8477456,J.T. Compher,L,DET,29,82,27,32,59
18,8482124,Quinton Byfield,R,LAK,22,82,23,36,59
18,8476459,Mika Zibanejad,C,NYR,31,82,19,40,59
18,8481523,Kirby Dach,C,MTL,23,82,9,50,59
18,8481068,Yegor Sharangovich,C,CGY,26,82,23,35,58
18,8477951,Nick Schmaltz,C,ARI,28,82,23,35,58
18,8475167,Victor Hedman,D,TBL,34,82,15,43,58
18,8476539,Jonathan Marchessault,R,VGK,34,82,37,20,57
18,8481540,Cole Caufield,R,MTL,23,82,33,24,57
18,8479400,Pierre-Luc Dubois,L,LAK,26,82,29,28,57
18,8479339,Patrik Laine,L,CBJ,26,82,26,31,57
18,8478444,Brock Boeser,R,VAN,27,82,19,38,57
18,8477447,Shea Theodore,D,VGK,29,82,14,43,57
18,8474563,Drew Doughty,D,LAK,35,82,14,43,57
18,8475784,Jeff Skinner,C,BUF,32,82,25,31,56
18,8480015,Owen Tippett,R,PHI,25,82,23,33,56
18,8482745,Mason McTavish,C,ANA,21,82,23,33,56
18,8476853,Morgan Rielly,D,TOR,30,82,16,40,56
18,8477494,Jonathan Drouin,L,COL,29,82,16,40,56
18,8480018,Nick Suzuki,C,MTL,25,82,19,36,55
18,8479675,Trevor Moore,L,LAK,29,82,22,32,54
18,8473419,Brad Marchand,L,BOS,36,82,21,33,54
18,8482740,Wyatt Johnston,C,DAL,21,82,21,33,54
18,8477932,Aaron Ekblad,D,FLA,28,82,17,37,54
18,8475692,Mats Zuccarello,R,MIN,37,82,14,40,54
18,8477504,Josh Morrissey,D,WPG,29,82,11,43,54
18,8477935,Sam Bennett,C,FLA,28,82,29,24,53
18,8477497,Sean Monahan,C,WPG,30,82,27,26,53
18,8475170,Brayden Schenn,C,STL,33,82,23,30,53
18,8477416,Oliver Bjorkstrand,R,SEA,29,82,21,32,53
18,8474150,Mikael Backlund,C,CGY,35,82,21,31,52
18,8480797,Joel Farabee,L,PHI,24,82,15,37,52
18,8481618,Alex Newhook,C,MTL,23,82,25,26,51
18,8481560,Arthur Kaliyev,R,LAK,23,82,25,26,51
18,8477496,Elias Lindholm,C,VAN,30,82,23,28,51
18,8476448,William Karlsson,C,VGK,31,82,18,33,51
18,8478856,Conor Garland,R,VAN,28,82,17,34,51
18,8476905,Chandler Stephenson,C,VGK,30,82,15,36,51
18,8480839,Rasmus Dahlin,D,BUF,24,82,12,39,51
18,8478396,Noah Hanifin,D,VGK,27,82,9,42,51
18,8480800,Quinn Hughes,D,VAN,25,82,3,48,51
18,8482159,Tyson Foerster,R,PHI,22,82,28,22,50
18,8476882,Teuvo Teravainen,L,CAR,30,82,22,28,50
18,8475791,Taylor Hall,L,CHI,33,82,19,31,50
18,8478438,Tommy Novak,C,NSH,27,82,19,31,50
18,8476292,Ondrej Palat,L,NJD,33,82,19,31,50
18,8476881,Tomas Hertl,C,VGK,31,82,18,32,50
18,8480078,Filip Chytil,C,NYR,25,82,11,39,50
18,8476875,Mike Matheson,D,MTL,30,82,6,44,50
18,8475754,Brock Nelson,C,NYI,33,82,26,23,49
18,8479999,Casey Mittelstadt,C,COL,26,82,22,27,49
18,8481528,Dylan Cozens,C,BUF,23,82,21,28,49
18,8478449,Roope Hintz,C,DAL,28,82,18,31,49
18,8475765,Vladimir Tarasenko,R,FLA,33,82,16,33,49
18,8476458,Ryan Strome,C,ANA,31,82,15,34,49
18,8471724,Kris Letang,D,PIT,37,82,11,38,49
18,8480865,Noah Dobson,D,NYI,24,82,7,42,49
18,8478466,Daniel Sprong,R,DET,27,82,27,21,48
18,8478366,Frank Vatrano,R,ANA,30,82,26,22,48
18,8475793,Ryan Johansen,C,PHI,32,82,21,27,48
18,8482093,Seth Jarvis,C,CAR,22,82,20,28,48
18,8476389,Vincent Trocheck,C,NYR,31,82,19,29,48
18,8484144,Connor Bedard,C,CHI,19,82,18,30,48
18,8482665,Matty Beniers,C,SEA,22,82,18,30,48
18,8475287,Erik Haula,L,NJD,33,82,18,30,48
18,8481711,Matias Maccelli,L,ARI,24,82,15,33,48
18,8483808,Andrei Kuzmenko,L,CGY,28,82,28,19,47
18,8480064,Josh Norris,C,OTT,25,82,28,19,47
18,8475760,Nick Bjugstad,C,ARI,32,82,27,20,47
18,8475314,Anders Lee,L,NYI,34,82,26,21,47
18,8477476,Artturi Lehkonen,L,COL,29,82,24,23,47
18,8473986,Alex Killorn,L,ANA,35,82,19,28,47
18,8480009,Eeli Tolvanen,R,SEA,25,82,19,28,47
18,8477444,Andre Burakovsky,L,SEA,29,82,18,29,47
18,8470613,Brent Burns,D,CAR,39,82,11,36,47
18,8479410,Mikhail Sergachev,D,TBL,26,82,9,38,47
18,8480014,Gabriel Vilardi,C,WPG,25,82,28,18,46
18,8477998,Warren Foegele,L,EDM,28,82,26,20,46
18,8476399,Blake Coleman,C,CGY,33,82,24,22,46
18,8477964,Ivan Barbashev,C,VGK,29,82,23,23,46
18,8475726,Tyler Toffoli,C,WPG,32,82,22,24,46
18,8482699,Dylan Guenther,R,ARI,21,82,22,24,46
18,8478542,Evan Rodrigues,C,FLA,31,82,21,25,46
18,8476483,Rickard Rakell,R,PIT,31,82,21,25,46
18,8480039,Martin Necas,C,CAR,25,82,18,28,46
18,8480031,Maxime Comtois,L,CAR,25,82,12,34,46
18,8476438,Brandon Saad,L,STL,32,82,30,15,45
18,8478460,Zach Werenski,D,CBJ,27,82,17,28,45
18,8475191,Reilly Smith,R,PIT,33,82,16,29,45
18,8477346,MacKenzie Weegar,D,CGY,30,82,13,32,45
18,8478975,Mason Marchment,L,DAL,29,82,11,34,45
18,8476329,Travis Boyd,C,ARI,31,82,8,37,45
18,8473994,Jamie Benn,L,DAL,35,82,20,24,44
18,8482684,Luke Hughes,D,NJD,21,82,19,25,44
18,8477479,Tyler Bertuzzi,L,TOR,29,82,18,26,44
18,8477986,Brandon Montour,D,FLA,30,82,10,34,44
18,8478038,Devon Toews,D,COL,30,82,8,36,44
18,8478397,Rasmus Andersson,D,CGY,28,82,2,42,44
18,8475151,Kyle Palmieri,C,NYI,33,82,22,21,43
18,8474679,Gustav Nyquist,C,NSH,35,82,20,23,43
18,8481596,Shane Pinto,C,OTT,24,82,20,23,43
18,8478519,Anthony Cirelli,C,TBL,27,82,19,24,43
18,8478401,Pavel Zacha,C,BOS,27,82,10,33,43
18,8476925,Colton Sissons,C,NSH,31,82,15,27,42
18,8477429,Andrew Copp,C,DET,30,82,15,27,42
18,8478458,Jack Roslovic,C,NYR,27,82,15,27,42
18,8482146,Luke Evangelista,R,NSH,22,82,14,28,42
18,8475753,Justin Faulk,D,STL,32,82,9,33,42
18,8480145,Neal Pionk,D,WPG,29,82,9,33,42
18,8482667,William Eklund,L,SJS,22,82,14,27,41
18,8480028,Morgan Frost,C,PHI,25,82,14,27,41
18,8478469,Thomas Chabot,D,OTT,27,82,14,27,41
18,8475197,Tyson Barrie,D,NSH,33,82,14,27,41
18,8479345,Jakob Chychrun,D,OTT,26,82,13,28,41
18,8481533,Trevor Zegras,C,ANA,23,82,11,30,41
18,8478233,Andrew Mangiapane,L,CGY,28,82,10,31,41
18,8474586,Jordan Eberle,R,SEA,34,82,8,33,41
18,8476906,Shayne Gostisbehere,D,DET,31,82,8,33,41
18,8476958,Jaccob Slavin,D,CAR,30,82,7,34,41
18,8481542,Moritz Seider,D,DET,23,82,3,38,41
18,8476432,Boone Jenner,C,CBJ,31,82,26,14,40
18,8478498,Jake DeBrusk,L,BOS,28,82,25,15,40
18,8482055,Drew O'Connor,L,PIT,26,82,22,18,40
18,8482101,Danil Gushchin,L,SJS,22,82,20,20,40
18,8476872,Scott Laughton,C,PHI,30,82,19,21,40
18,8477511,Anthony Mantha,R,VGK,30,82,15,25,40
18,8474641,Adam Henrique,C,EDM,34,82,13,27,40
18,8477503,Max Domi,C,TOR,29,82,8,32,40
18,8476923,Damon Severson,D,CBJ,30,82,4,36,40
18,8477944,Jakub Vrana,L,STL,28,82,23,16,39
18,8480893,Kirill Marchenko,R,CBJ,24,82,22,17,39
18,8474157,Max Pacioretty,L,WSH,36,82,20,19,39
18,8483515,Juraj Slafkovsky,L,MTL,20,82,19,20,39
18,8474102,David Perron,L,DET,36,82,17,22,39
18,8471698,T.J. Oshie,R,WSH,38,82,17,22,39
18,8478046,Danton Heinen,L,BOS,29,82,16,23,39
18,8482133,Thomas Bordeleau,C,SJS,22,82,16,23,39
18,8474149,Evgenii Dadonov,R,DAL,35,82,15,24,39
18,8482475,Yegor Chinakhov,R,CBJ,23,82,15,24,39
18,8482110,Dawson Mercer,C,NJD,23,82,14,25,39
18,8482222,Alexander Barabanov,L,SJS,30,82,13,26,39
18,8480798,Philipp Kurashev,C,CHI,25,82,12,27,39
18,8476792,Torey Krug,D,STL,33,82,10,29,39
18,8481546,Cam York,D,PHI,23,82,8,31,39
18,8483524,Shane Wright,C,SEA,20,82,30,8,38
18,8475169,Evander Kane,L,EDM,33,82,22,16,38
18,8475722,Jason Zucker,L,NSH,32,82,21,17,38
18,8482109,Alexis Lafrenière,L,NYR,23,82,21,17,38
18,8480434,Sean Durzi,D,ARI,26,82,14,24,38
18,8475744,Evgeny Kuznetsov,C,CAR,32,82,13,25,38
18,8481581,Thomas Harley,D,DAL,23,82,12,26,38
18,8476854,Hampus Lindholm,D,BOS,30,82,6,32,38
18,8475794,Tyler Seguin,C,DAL,32,82,25,12,37
18,8475848,Brendan Gallagher,R,MTL,32,82,23,14,37
18,8480188,Fabian Zetterlund,L,SJS,25,82,20,17,37
18,8474037,James van Riemsdyk,L,BOS,35,82,16,21,37
18,8477451,Ryan Hartman,R,MIN,30,82,15,22,37
18,8477953,Kasperi Kapanen,R,STL,28,82,15,22,37
18,8477948,Travis Sanheim,D,PHI,28,82,15,22,37
18,8476880,Tom Wilson,R,WSH,30,82,13,24,37
18,8475763,Kevin Hayes,R,STL,32,82,12,25,37
18,8478055,Gustav Forsling,D,FLA,28,82,10,27,37
18,8482175,JJ Peterka,R,BUF,22,82,19,17,36
18,8477947,Sonny Milano,L,WSH,28,82,19,17,36
18,8481580,Connor McMichael,C,WSH,23,82,19,17,36
18,8476826,Yanni Gourde,C,SEA,33,82,17,19,36
18,8479365,Trent Frederic,C,BOS,26,82,16,20,36
18,8478462,Nicolas Roy,C,VGK,27,82,15,21,36
18,8479415,Michael McLeod,C,NJD,26,82,15,21,36
18,8479423,Alex Nylander,L,CBJ,26,82,15,21,36
18,8478115,Pierre Engvall,L,NYI,28,82,15,21,36
18,8478472,Mathieu Joseph,R,OTT,27,82,14,22,36
18,8480185,Eetu Luostarinen,C,FLA,26,82,13,23,36
18,8480246,Nick Perbix,D,TBL,26,82,7,29,36
18,8482105,Jake Sanderson,D,OTT,22,82,6,30,36
18,8481013,Jonatan Berggren,R,DET,24,82,6,30,36
18,8481699,Aku Raty,R,ARI,23,82,1,35,36
18,8479525,Ross Colton,C,COL,28,82,22,13,35
18,8475799,Nino Niederreiter,R,WPG,32,82,20,15,35
18,8475745,Charlie Coyle,C,BOS,32,82,16,19,35
18,8475343,Nic Dowd,C,WSH,34,82,16,19,35
18,8476921,Jordan Martinook,L,CAR,32,82,16,19,35
18,8478463,Anthony Beauvillier,L,NSH,27,82,14,21,35
18,8480802,Ryan McLeod,C,EDM,25,82,13,22,35
18,8480873,Rasmus Sandin,D,WSH,24,82,12,23,35
18,8479992,Michael Rasmussen,C,DET,25,82,11,24,35
18,8482624,Daniil Miromanov,D,CGY,27,82,11,24,35
18,8480043,Timothy Liljegren,D,TOR,25,82,9,26,35
18,8478911,Matt Roy,D,LAK,29,82,9,26,35
18,8479425,Filip Hronek,D,VAN,27,82,7,28,35
18,8483445,Cutter Gauthier,L,ANA,20,82,6,29,35
18,8482671,Owen Power,D,BUF,22,82,2,33,35
18,8481016,Ruslan Iskhakov,C,NYI,24,82,1,34,35
18,8478057,Dakota Joshua,C,VAN,28,82,18,16,34
18,8481624,Ilya Mikheyev,R,VAN,30,82,18,16,34
18,8480459,Pius Suter,C,VAN,28,82,18,16,34
18,8476419,Jean-Gabriel Pageau,C,NYI,32,82,17,17,34
18,8473422,Nick Foligno,L,CHI,37,82,17,17,34
18,8474053,Logan Couture,C,SJS,35,82,16,18,34
18,8476869,Brady Skjei,D,CAR,30,82,8,26,34
18,8482118,Sam Colangelo,R,ANA,23,82,25,8,33
18,8476981,Josh Anderson,R,MTL,30,82,22,11,33
18,8480849,Barrett Hayton,C,ARI,24,82,15,18,33
18,8480855,Jack McBain,C,ARI,24,82,14,19,33
18,8476461,Sean Couturier,C,PHI,32,82,10,23,33
18,8473563,Nicklas Backstrom,C,WSH,37,82,10,23,33
18,8480220,Noah Cates,L,PHI,25,82,9,24,33
18,8475906,John Klingberg,D,TOR,32,82,7,26,33
18,8479998,Mikey Anderson,D,LAK,25,82,7,26,33
18,8483457,Lane Hutson,D,MTL,20,82,6,27,33
18,8477969,Marcus Pettersson,D,PIT,28,82,6,27,33
18,8479983,Mario Ferraro,D,SJS,26,82,5,28,33
18,8482089,Jake Neighbours,L,STL,22,82,17,15,32
18,8475714,Calle Jarnkrok,C,TOR,33,82,14,18,32
18,8476927,Teddy Blueger,C,VAN,30,82,13,19,32
18,8477021,Alex Kerfoot,C,ARI,30,82,12,20,32
18,8482113,Anton Lundell,C,FLA,23,82,11,21,32
18,8479353,Brett Howden,C,VGK,26,82,10,22,32
18,8475171,Oliver Ekman-Larsson,D,FLA,33,82,9,23,32
18,8477425,Miles Wood,L,COL,29,82,9,23,32
18,8477495,Seth Jones,D,CHI,30,82,8,24,32
18,8482705,Cole Sillinger,C,CBJ,21,82,8,24,32
18,8482712,Oskar Olausson,R,COL,22,82,8,24,32
18,8474151,Ryan McDonagh,D,NSH,35,82,7,25,32
18,8482122,Brock Faber,D,MIN,22,82,6,26,32
18,8476897,Oskar Sundqvist,C,STL,30,82,6,26,32
18,8483471,Brad Lambert,C,WPG,31,82,5,27,32
18,8475790,Erik Gudbranson,D,CBJ,32,82,3,29,32
18,8482145,Mavrik Bourque,C,DAL,22,82,25,6,31
18,8481535,Nils Hoglander,L,VAN,24,82,18,13,31
18,8477426,Nicholas Paul,L,TBL,29,82,17,14,31
18,8474884,Mike Hoffman,C,SJS,35,82,16,15,31
18,8484145,Zach Benson,L,BUF,19,82,15,16,31
18,8477952,Robby Fabbri,C,DET,28,82,13,18,31
18,8482079,Marco Rossi,C,MIN,23,82,12,19,31
18,8475768,Jaden Schwartz,C,SEA,32,82,12,19,31
18,8481703,Valtteri Puustinen,R,PIT,25,82,4,27,31
18,8483493,Frank Nazar,C,CHI,20,82,24,6,30
18,8476392,Adam Lowry,C,WPG,31,82,19,11,30
18,8471218,Blake Wheeler,R,NYR,38,82,10,20,30
18,8482092,Ridly Greig,C,OTT,22,82,10,20,30
18,8475218,Mattias Ekholm,D,EDM,34,82,9,21,30
18,8481656,Aliaksei Protas,C,WSH,23,82,9,21,30
18,8476892,Colton Parayko,D,STL,31,82,9,21,30
18,8483495,Simon Nemec,D,NJD,20,82,7,23,30
18,8480336,Sean Walker,D,COL,30,82,6,24,30
18,8478178,Darren Raddysh,D,TBL,28,82,6,24,30
18,8474189,Lars Eller,C,PIT,35,82,18,11,29
18,8482762,Simon Edvinsson,D,DET,21,82,16,13,29
18,8481704,Juuso Parssinen,C,NSH,23,82,14,15,29
18,8480813,Joe Veleno,C,DET,24,82,14,15,29
18,8482702,Logan Stankoven,C,DAL,21,82,13,16,29
18,8478413,Jordan Greenway,L,BUF,27,82,12,17,29
18,8483431,Logan Cooley,C,ARI,20,82,12,17,29
18,8473533,Jordan Staal,C,CAR,36,82,12,17,29
18,8482117,Lukas Reichel,L,CHI,22,82,10,19,29
18,8482720,Matthew Knies,L,TOR,22,82,10,19,29
18,8475200,Dmitry Orlov,D,CAR,33,82,9,20,29
18,8476457,Adam Larsson,D,SEA,32,82,4,25,29
18,8476278,Colin Blackwell,C,CHI,31,82,15,13,28
18,8477407,Anthony Duclair,L,TBL,29,82,14,14,28
18,8478474,Lawson Crouse,L,ARI,27,82,14,14,28
18,8474870,Tyler Johnson,C,CHI,34,82,13,15,28
18,8484166,Adam Fantilli,C,CBJ,20,82,13,15,28
18,8481477,Nico Sturm,C,SJS,29,82,11,17,28
18,8482655,J.J. Moser,D,ARI,24,82,8,20,28
18,8478500,Ivan Provorov,D,CBJ,27,82,7,21,28
18,8474034,Pat Maroon,L,BOS,36,82,6,22,28
18,8476960,Andreas Athanasiou,C,CHI,30,82,5,23,28
18,8474716,Jared Spurgeon,D,MIN,35,82,5,23,28
18,8483397,Marc McLaughlin,C,BOS,25,82,24,3,27
18,8483491,Ivan Miroshnichenko,L,WSH,20,82,15,12,27
18,8479316,Luke Kunin,C,SJS,27,82,13,14,27
18,8479351,Sam Steel,C,DAL,26,82,13,14,27
18,8477839,Conor Sheary,L,TBL,32,82,11,16,27
18,8470621,Corey Perry,R,EDM,39,82,11,16,27
18,8481186,Logan O'Connor,R,COL,28,82,10,17,27
18,8480817,K'Andre Miller,D,NYR,24,82,8,19,27
18,8482142,Jamie Drysdale,D,PHI,22,82,7,20,27
18,8476885,Jacob Trouba,D,NYR,30,82,5,22,27
18,8482733,Logan Mailloux,D,MTL,31,82,3,24,27
18,8475181,Nick Leddy,D,STL,33,82,1,26,27
18,8479941,Justin Danforth,R,CBJ,31,82,17,9,26
18,8481093,Rafael Harvey-Pinard,L,MTL,25,82,14,12,26
18,8483012,Logan Morrison,C,SEA,22,82,14,12,26
18,8480821,Filip Zadina,R,SJS,25,82,13,13,26
18,8476469,Joel Armia,R,MTL,31,82,12,14,26
18,8478508,Yakov Trenin,C,COL,27,82,12,14,26
18,8480068,Ryan Poehling,C,PHI,25,82,11,15,26
18,8479514,Rem Pitlick,C,CHI,27,82,11,15,26
18,8481028,Martin Pospisil,C,CGY,25,82,11,15,26
18,8477506,Ryan Pulock,D,NYI,30,82,8,18,26
18,8478882,Vladislav Gavrikov,D,LAK,29,82,8,18,26
18,8480113,Alex Iafallo,L,WPG,31,82,7,19,26
18,8478451,Ethan Bear,D,WSH,27,82,7,19,26
18,8483505,Matthew Poitras,C,BOS,20,82,7,19,26
18,8480879,Jacob Bernard-Docker,D,OTT,24,82,5,21,26
18,8475764,Cam Fowler,D,ANA,33,82,4,22,26
18,8481606,Jordan Spence,D,LAK,23,82,4,22,26
18,8483490,Pavel Mintyukov,D,ANA,21,82,1,25,26
18,8476878,Zemgus Girgensons,L,BUF,30,82,15,10,25
18,8483499,Liam Ohgren,L,MIN,20,82,14,11,25
18,8481481,Blake Lizotte,C,LAK,27,82,11,14,25
18,8479996,Cody Glass,C,NSH,25,82,10,15,25
18,8477499,Rasmus Ristolainen,D,PHI,30,82,8,17,25
18,8480073,Erik Brannstrom,D,OTT,25,82,7,18,25
18,8474574,Tyler Myers,D,VAN,34,82,7,18,25
18,8477435,Ryan Graves,D,PIT,29,82,7,18,25
18,8475690,Chris Tanev,D,DAL,35,82,6,19,25
18,8476331,Dylan DeMelo,D,WPG,31,82,5,20,25
18,8478507,John Marino,D,NJD,27,82,3,22,25
18,8476931,Jake McCabe,D,TOR,31,82,3,22,25
18,8476312,Josh Manson,D,COL,33,82,3,22,25
18,8479661,Tanner Jeannot,L,TBL,27,82,12,12,24
18,8477919,Frederick Gaudreau,C,MIN,31,82,10,14,24
18,8475462,Radko Gudas,D,ANA,34,82,9,15,24
18,8482062,Cole Smith,L,NSH,29,82,8,16,24
18,8476979,Erik Gustafsson,D,NYR,32,82,7,17,24
18,8476917,Adam Pelech,D,NYI,30,82,7,17,24
18,8479976,Juuso Valimaki,D,ARI,26,82,6,18,24
18,8474673,TJ Brodie,D,TOR,34,82,3,21,24
18,8481059,Scott Perunovich,D,STL,26,82,2,22,24
18,8470604,Jeff Carter,C,PIT,39,82,12,11,23
18,8484203,Bradly Nadeau,L,CAR,19,82,12,11,23
18,8482125,Alexander Holtz,R,NJD,22,82,12,11,23
18,8478013,Jake Walman,D,DET,28,82,11,12,23
18,8479390,Taylor Raddysh,R,CHI,26,82,10,13,23
18,8482166,Shakir Mukhamadullin,D,SJS,22,82,10,13,23
18,8474565,Alex Pietrangelo,D,VGK,34,82,8,15,23
18,8477330,Dominik Kubalik,L,OTT,29,82,8,15,23
18,8479398,Samuel Girard,D,COL,26,82,8,15,23
18,8478416,Erik Cernak,D,TBL,27,82,7,16,23
18,8478133,Jake Evans,C,MTL,28,82,6,17,23
18,8477498,Darnell Nurse,D,EDM,29,82,5,18,23
18,8477365,Connor Clifton,D,BUF,29,82,5,18,23
18,8481524,Bowen Byram,D,BUF,23,82,4,19,23
18,8476463,Jonas Brodin,D,MIN,31,82,4,19,23
18,8476902,Esa Lindell,D,DAL,30,82,3,20,23
18,8479977,Kailer Yamamoto,R,SEA,26,82,15,7,22
18,8482809,Jackson Blake,R,CAR,21,82,15,7,22
18,8481517,Brett Leason,R,ANA,25,82,13,9,22
18,8480806,Isac Lundestrom,C,ANA,25,82,10,12,22
18,8479293,Brandon Tanev,L,SEA,33,82,10,12,22
18,8482679,Matt Coronato,R,CGY,22,82,10,12,22
18,8478468,Jeremy Lauzon,D,NSH,27,82,10,12,22
18,8478109,Victor Olofsson,L,BUF,29,82,9,13,22
18,8476480,Vladislav Namestnikov,C,WPG,32,82,7,15,22
18,8480448,Parker Kelly,L,OTT,25,82,7,15,22
18,8475233,David Savard,D,MTL,34,82,6,16,22
18,8480871,Adam Boqvist,D,CBJ,24,82,5,17,22
18,8479369,Andrew Peeke,D,BOS,26,82,5,17,22
18,8478840,Will Borgen,D,SEA,28,82,5,17,22
18,8480796,Martin Fehervary,D,WSH,25,82,5,17,22
18,8477488,Brett Pesce,D,CAR,30,82,5,17,22
18,8475179,Dmitry Kulikov,D,FLA,34,82,4,18,22
18,8481554,Kaapo Kakko,R,NYR,23,82,16,5,21
18,8477406,Mattias Janmark,C,EDM,32,82,13,8,21
18,8482737,Zack Bolduc,C,STL,21,82,12,9,21
18,8481553,Bobby Brink,R,PHI,23,82,10,11,21
18,8476871,Tanner Pearson,L,MTL,32,82,10,11,21
18,8475231,Casey Cizikas,C,NYI,33,82,10,11,21
18,8475149,Marcus Johansson,L,MIN,34,82,9,12,21
18,8478020,Michael Amadio,C,VGK,28,82,9,12,21
18,8476858,Phillip Di Giuseppe,L,VAN,31,82,9,12,21
18,8476374,Sean Kuraly,C,CBJ,31,82,9,12,21
18,8477989,Christian Dvorak,C,MTL,28,82,8,13,21
18,8475164,Jakob Silfverberg,R,ANA,34,82,8,13,21
18,8478891,Mason Appleton,C,WPG,28,82,8,13,21
18,8479324,Ryan Lindgren,D,NYR,26,82,7,14,21
18,8483565,Nick Blankenburg,D,CBJ,26,82,5,16,21
18,8481178,Egor Zamula,D,PHI,24,82,5,16,21
18,8476467,Jamie Oleksiak,D,SEA,32,82,4,17,21
18,8473507,Jeff Petry,D,DET,37,82,4,17,21
18,8482858,Ryker Evans,D,SEA,23,82,2,19,21
18,8482074,Connor Zary,C,CGY,23,82,13,7,20
18,8477508,Curtis Lazar,C,NJD,29,82,11,9,20
18,8480281,Alexey Toropchenko,R,STL,25,82,10,10,20
18,8484153,Leo Carlsson,C,ANA,20,82,8,12,20
18,8477450,Jason Dickinson,C,CHI,29,82,8,12,20
18,8479591,Michael Eyssimont,C,TBL,28,82,8,12,20
18,8481537,Nikita Okhotiuk,D,CGY,24,82,8,12,20
18,8475220,Marcus Foligno,L,MIN,33,82,7,13,20
18,8477015,Connor Brown,R,EDM,30,82,5,15,20
18,8477505,Alexander Wennberg,C,NYR,30,82,5,15,20
18,8482245,Artem Zub,D,OTT,29,82,4,16,20
18,8475324,Nick Jensen,D,WSH,34,82,3,17,20
18,8483466,Kevin Korchinski,D,CHI,20,82,3,17,20
18,8476873,Mark Jankowski,C,NSH,30,82,12,7,19
18,8481601,Simon Holmstrom,R,NYI,23,82,9,10,19
18,8473449,Kyle Okposo,R,FLA,36,82,8,11,19
18,8481605,Jackson LaCombe,D,ANA,23,82,8,11,19
18,8470610,Zach Parise,L,COL,40,82,6,13,19
18,8482111,Justin Barron,D,MTL,23,82,6,13,19
18,8476624,Barclay Goodrow,C,NYR,31,82,5,14,19
18,8478443,Brandon Carlo,D,BOS,28,82,5,14,19
18,8482730,Brandt Clarke,D,LAK,21,82,4,15,19
18,8482803,Olen Zellweger,D,ANA,21,82,4,15,19
18,8476525,Colin Miller,D,WPG,32,82,4,15,19
18,8480035,Henri Jokiharju,D,BUF,25,82,4,15,19
18,8479987,Morgan Geekie,C,BOS,26,82,2,17,19
18,8481568,Alex Vlasic,D,CHI,23,82,1,18,19
18,8477845,Trevor van Riemsdyk,D,WSH,33,82,1,18,19
18,8477507,Nikita Zadorov,D,VAN,29,82,1,18,19
18,8481604,Pavel Dorofeyev,L,VGK,24,82,12,6,18
18,8478043,Sam Lafferty,C,VAN,29,82,11,7,18
18,8479346,Dillon Dube,C,CGY,26,82,9,9,18
18,8479359,Beck Malenstyn,L,WSH,26,82,8,10,18
18,8474715,Cam Atkinson,R,PHI,35,82,7,11,18
18,8482087,Kaiden Guhle,D,MTL,22,82,6,12,18
18,8480144,David Kampf,C,TOR,29,82,6,12,18
18,8474166,Alec Martinez,D,VGK,37,82,6,12,18
18,8477353,Tyler Motte,C,TBL,29,82,6,12,18
18,8481522,Peyton Krebs,C,BUF,23,82,5,13,18
18,8476967,Brett Kulak,D,EDM,30,82,4,14,18
18,8478136,Jake Middleton,D,MIN,28,82,4,14,18
18,8475279,Ben Chiarot,D,DET,33,82,4,14,18
18,8476442,Matt Nieto,L,PIT,32,82,3,15,18
18,8482516,Matthew Kessel,D,STL,24,82,3,15,18
18,8475208,Brian Dumoulin,D,SEA,33,82,3,15,18
18,8470600,Ryan Suter,D,DAL,39,82,3,15,18
18,8476879,Cody Ceci,D,EDM,31,82,2,16,18
18,8479393,Noah Gregor,C,TOR,26,82,10,7,17
18,8473504,Cal Clutterbuck,R,NYI,37,82,9,8,17
18,8481567,Henry Thrun,D,SJS,23,82,5,12,17
18,8477392,Hudson Fasching,R,NYI,29,82,5,12,17
18,8480860,Kevin Bahl,D,NJD,24,82,4,13,17
18,8477335,Kyle Burroughs,D,SJS,29,82,4,13,17
18,8479371,Dante Fabbro,D,NSH,26,82,3,14,17
18,8478399,Jonas Siegenthaler,D,NJD,27,82,3,14,17
18,8475188,Brayden McNabb,D,VGK,33,82,1,16,17
18,8480074,Alexandre Texier,C,CBJ,25,82,9,7,16
18,8473453,Trevor Lewis,C,LAK,37,82,8,8,16
18,8478430,Oliver Kylington,D,CGY,27,82,8,8,16
18,8477931,Tomas Nosek,L,NJD,32,82,8,8,16
18,8478569,Noel Acciari,C,PIT,33,82,7,9,16
18,8479291,Kevin Rooney,C,CGY,31,82,7,9,16
18,8476422,Mike Reilly,D,NYI,31,82,6,10,16
18,8479980,Nicolas Hague,D,VGK,26,82,5,11,16
18,8482470,Ilya Solovyov,D,CGY,24,82,5,11,16
18,8475762,Derek Forbort,D,BOS,32,82,4,12,16
18,8481014,Alexander Romanov,D,NYI,24,82,3,13,16
18,8478851,Alexandre Carrier,D,NSH,28,82,3,13,16
18,8480834,Ty Emberson,D,SJS,24,82,3,13,16
18,8474013,Ian Cole,D,VAN,35,82,3,13,16
18,8482666,Scott Morrow,D,CAR,22,82,9,6,15
18,8483482,Tristan Luneau,D,ANA,20,82,5,10,15
18,8480990,Declan Chisholm,D,MIN,24,82,4,11,15
18,8475455,Brenden Dillon,D,WPG,34,82,3,12,15
18,8470966,Mark Giordano,D,TOR,41,82,2,13,15
18,8477034,Jaycob Megna,D,CHI,32,82,2,13,15
18,8476429,Scott Mayfield,D,NYI,32,82,1,14,15
18,8482259,Bobby McMann,C,TOR,28,82,8,6,14
18,8477220,Nate Schmidt,D,WPG,33,82,5,9,14
18,8474009,Nick Bonino,C,NYR,36,82,5,9,14
18,8481578,Graeme Clarke,R,NJD,23,82,5,9,14
18,8476372,Nick Seeler,D,PHI,31,82,3,11,14
18,8478859,Niko Mikkola,D,FLA,28,82,1,13,14
18,8480807,Mattias Samuelsson,D,BUF,24,82,1,13,14
18,8479383,Boris Katchouk,L,OTT,26,82,6,7,13
18,8477369,Carson Soucy,D,VAN,30,82,6,7,13
18,8475177,Calvin de Haan,D,TBL,33,82,6,7,13
18,8475842,Sam Carrick,C,EDM,32,82,5,8,13
18,8482807,Ethan Del Mastro,D,CHI,21,82,5,8,13
18,8479442,Troy Stecher,D,EDM,30,82,5,8,13
18,8475825,Jani Hakanpää,D,DAL,32,82,4,9,13
18,8476891,Matt Grzelcyk,D,BOS,30,82,2,11,13
18,8480058,Pierre-Olivier Joseph,D,PIT,25,82,1,12,13
18,8482155,Alex Laferriere,R,LAK,23,82,4,8,12
18,8483468,Jiri Kulich,C,BUF,20,82,4,8,12
18,8482177,Marat Khusnutdinov,C,MIN,22,82,0,12,12
18,8480980,Connor Dewar,C,TOR,25,82,7,4,11
18,8482713,Mackie Samoskevich,R,FLA,22,82,7,4,11
18,8478831,Kevin Stenlund,C,FLA,28,82,6,5,11
18,8480172,Jan Rutta,D,SJS,34,82,2,9,11
18,8482073,Braden Schneider,D,NYR,23,82,5,5,10
18,8476822,Luke Glendening,C,TBL,35,82,5,5,10
18,8484911,Collin Graf,R,SJS,22,82,4,6,10
18,8481030,Jack St. Ivany,D,PIT,25,82,3,7,10
18,8474567,Zach Bogosian,D,MIN,34,82,2,8,10
18,8476915,Jujhar Khaira,L,MIN,30,82,6,3,9
18,8482859,Zack Ostapchuk,C,OTT,21,82,3,5,8
18,8471677,Jack Johnson,D,COL,37,82,1,7,8
18,8478408,Travis Dermott,D,ARI,28,82,1,7,8
18,8476473,Connor Murphy,D,CHI,31,82,3,4,7
18,8483763,Maksymilian Szuber,D,ARI,22,82,3,4,7
18,8481599,Victor Soderstrom,D,ARI,23,82,2,5,7
18,8484149,Gavin Brindley,C,CBJ,20,82,1,6,7
18,8483489,Fraser Minten,C,TOR,31,82,3,3,6
18,8482141,Lukas Cormier,D,VGK,22,0,0,0,0
18,8476988,Matt Benning,D,SJS,30,0,0,0,0
18,8480727,Zach Whitecloud,D,VGK,28,0,0,0,0
18,8480887,Jordan Harris,D,MTL,24,0,0,0,0
18,8478450,Parker Wotherspoon,D,BOS,27,0,0,0,0
18,8481812,Nikolai Knyzhov,D,SJS,27,0,0,0,0
18,8480001,Urho Vaakanainen,D,ANA,25,0,0,0,0
18,8482176,Wyatt Kaiser,D,CHI,22,0,0,0,0
18,8481122,Simon Benoit,D,TOR,26,0,0,0,0
18,8476441,Joel Edmundson,D,TOR,31,0,0,0,0
18,8480884,Calen Addison,D,SJS,24,0,0,0,0
18,8482511,Mason Lohrei,D,BOS,23,0,0,0,0
18,8482192,Isaak Phillips,D,CHI,23,0,0,0,0
18,8480950,Ilya Lyubushkin,D,TOR,30,0,0,0,0
18,8474031,Kevin Shattenkirk,D,BOS,35,0,0,0,0
18,8475718,Justin Holl,D,DET,32,0,0,0,0
18,8479402,Jake Bean,D,CBJ,26,0,0,0,0
18,8474602,Justin Schultz,D,SEA,34,0,0,0,0
18,8477950,Tony DeAngelo,D,CAR,29,0,0,0,0
18,8481743,Marc Del Gaizo,D,NSH,25,0,0,0,0
18,8481527,Kaedan Korczak,D,VGK,23,0,0,0,0
18,8480192,Johnathan Kovacevic,D,MTL,27,0,0,0,0
18,8476874,Olli Maatta,D,DET,30,0,0,0,0
18,8482144,Jack Thompson,D,SJS,22,0,0,0,0
18,8480222,Sebastian Aho,D,NYI,28,0,0,0,0
18,8479458,Nikita Zaitsev,D,CHI,33,0,0,0,0
18,8471709,Marc-Edouard Vlasic,D,SJS,37,0,0,0,0
18,8482929,Emil Lilleberg,D,TBL,23,0,0,0,0
18,8477018,Ben Hutton,D,VGK,31,0,0,0,0
18,8481056,Spencer Stastney,D,NSH,24,0,0,0,0
18,8481593,Jayden Struble,D,MTL,23,0,0,0,0
18,8479982,Conor Timmins,D,TOR,26,0,0,0,0
18,8474090,Brendan Smith,D,NJD,35,0,0,0,0
18,8482964,Arber Xhekaj,D,MTL,23,0,0,0,0
18,8480891,Michael Kesselring,D,ARI,24,0,0,0,0
18,8477938,Haydn Fleury,D,TBL,28,0,0,0,0
18,8481806,Louis Crevier,D,CHI,23,0,0,0,0
18,8471274,Alex Goligoski,D,MIN,39,0,0,0,0
18,8481600,Tobias Bjornfot,D,FLA,23,0,0,0,0
18,8475797,Jarred Tinordi,D,CHI,32,0,0,0,0
18,8481521,Ronnie Attard,D,PHI,25,0,0,0,0
18,8474612,Travis Hamonic,D,OTT,34,0,0,0,0
18,8479576,Vincent Desharnais,D,EDM,28,0,0,0,0
18,8480049,Dylan Samberg,D,WPG,25,0,0,0,0
18,8483619,Filip Roos,D,CHI,25,0,0,0,0
18,8474568,Luke Schenn,D,NSH,35,0,0,0,0
18,8480184,Gustav Lindstrom,D,ANA,26,0,0,0,0
18,8480070,Ian Mitchell,D,BOS,25,0,0,0,0
18,8480196,Jacob Bryson,D,BUF,27,0,0,0,0
18,8471686,Marc Staal,D,PHI,37,0,0,0,0
18,8477467,Gustav Olofsson,D,SEA,30,0,0,0,0
18,8478970,Jalen Chatfield,D,CAR,28,0,0,0,0
18,8479348,Kale Clague,D,BUF,26,0,0,0,0
18,8473446,Erik Johnson,D,PHI,36,0,0,0,0
18,8477462,Robert Hagg,D,ANA,29,0,0,0,0
18,8478454,Noah Juulsen,D,VAN,27,0,0,0,0
18,8477384,Josh Brown,D,ARI,30,0,0,0,0
18,8481708,Zac Jones,D,NYR,24,0,0,0,0
18,8481167,Brayden Pachal,D,CGY,25,0,0,0,0
18,8482067,Connor Mackey,D,NYR,28,0,0,0,0
18,8483460,David Jiricek,D,CBJ,21,0,0,0,0
18,8481701,Santeri Hatakka,D,NJD,23,0,0,0,0
18,8478021,William Lagesson,D,ANA,28,0,0,0,0
18,8477851,Jordan Oesterle,D,CGY,32,0,0,0,0
18,8478452,Caleb Jones,D,COL,27,0,0,0,0
18,8479984,Cal Foote,D,NJD,26,0,0,0,0
18,8479639,Dylan Coghlan,D,CAR,26,0,0,0,0
18,8480874,Adam Ginning,D,PHI,24,0,0,0,0
18,8479321,Lucas Johansen,D,WSH,27,0,0,0,0
18,8480878,Nils Lundkvist,D,DAL,24,0,0,0,0
18,8482165,Yan Kuznetsov,D,CGY,22,0,0,0,0
18,8484258,Sam Malinski,D,COL,26,0,0,0,0
18,8480157,Calle Rosen,D,STL,30,0,0,0,0
18,8484304,Uvis Balinskis,D,FLA,28,0,0,0,0
18,8479985,Cale Fleury,D,SEA,26,0,0,0,0
18,8479378,Logan Stanley,D,WPG,26,0,0,0,0
18,8477541,Dakota Mermis,D,MIN,30,0,0,0,0
18,8481609,Vladislav Kolyachonok,D,ARI,23,0,0,0,0
18,8480823,Alexander Alexeyev,D,WSH,25,0,0,0,0
18,8481679,Maxence Guenette,D,OTT,23,0,0,0,0
18,8481564,Ryan Johnson,D,BUF,23,0,0,0,0
18,8479376,Victor Mete,D,PHI,26,0,0,0,0
18,8484254,Akito Hirose,D,VAN,25,0,0,0,0
18,8482660,Kent Johnson,C,CBJ,22,0,0,0,0
18,8482149,Cole Perfetti,C,WPG,22,0,0,0,0
18,8477987,Ryan Donato,C,CHI,28,0,0,0,0
18,8475755,Alexander Petrovic,D,DAL,32,0,0,0,0
18,8477810,Joel Hanley,D,CGY,33,0,0,0,0
18,8474145,Robert Bortuzzo,D,NYI,35,0,0,0,0
18,8481161,Jake Christiansen,D,CBJ,25,0,0,0,0
18,8476884,Derrick Pouliot,D,DAL,30,0,0,0,0
18,8481716,Dmitri Voronkov,L,CBJ,24,0,0,0,0
18,8480084,Nick DeSimone,D,NJD,30,0,0,0,0
18,8475750,Jon Merrill,D,MIN,32,0,0,0,0
18,8479315,Joey Anderson,R,CHI,26,0,0,0,0
18,8478011,Louie Belpedio,D,PHI,28,0,0,0,0
18,8482451,Mikael Pyyhtia,L,CBJ,23,0,0,0,0
18,8481541,Samuel Bolduc,D,NYI,24,0,0,0,0
18,8482126,Emil Andrae,D,PHI,31,0,0,0,0
18,8474618,Marco Scandella,D,STL,34,0,0,0,0
18,8477244,Chad Ruhwedel,D,NYR,34,0,0,0,0
18,8477971,Andreas Englund,D,LAK,28,0,0,0,0
18,8480829,Jesperi Kotkaniemi,C,CAR,24,0,0,0,0
18,8479372,Josh Mahura,D,FLA,26,0,0,0,0
18,8482095,Tyler Kleven,D,OTT,22,0,0,0,0
18,8481719,Maxwell Crozier,D,TBL,24,0,0,0,0
18,8475855,Jesper Fast,R,CAR,33,0,0,0,0
18,8480848,Ty Dellandrea,C,DAL,24,0,0,0,0
18,8475193,Tomas Tatar,L,SEA,34,0,0,0,0
18,8476889,Radek Faksa,C,DAL,30,0,0,0,0
18,8478495,Denis Gurianov,R,PHI,27,0,0,0,0
18,8480216,Jacob Peterson,C,SJS,25,0,0,0,0
18,8480252,Cole Guttman,C,CHI,25,0,0,0,0
18,8479026,Philippe Myers,D,TBL,27,0,0,0,0
18,8481006,Tyler Tucker,D,STL,24,0,0,0,0
18,8481032,Paul Cotter,C,VGK,25,0,0,0,0
18,8481577,Philip Tomasino,C,NSH,23,0,0,0,0
18,8476918,Jimmy Vesey,L,NYR,31,0,0,0,0
18,8479320,Max Lajoie,D,TOR,27,0,0,0,0
18,8478017,Mark Friedman,D,VAN,29,0,0,0,0
18,8481754,Nikita Nesterenko,C,ANA,23,0,0,0,0
18,8483407,Brandon Scanlin,D,NYR,25,0,0,0,0
18,8482659,Josh Doan,R,ARI,22,0,0,0,0
18,8477446,Michael McCarron,R,NSH,29,0,0,0,0
18,8477903,Garnet Hathaway,R,PHI,33,0,0,0,0
18,8482153,Brendan Brisson,C,VGK,23,0,0,0,0
18,8483546,Marshall Rifai,D,TOR,26,0,0,0,0
18,8484287,Cole McWard,D,VAN,23,0,0,0,0
18,8478854,Ryan Shea,D,PIT,27,0,0,0,0
18,8481585,Egor Afanasyev,L,NSH,23,0,0,0,0
18,8483398,Declan Carlile,D,TBL,31,0,0,0,0
18,8478502,Dennis Gilbert,D,CGY,28,0,0,0,0
18,8482749,Joshua Roy,R,MTL,21,0,0,0,0
18,8481598,Philip Broberg,D,EDM,23,0,0,0,0
18,8480835,Jack Drury,C,CAR,24,0,0,0,0
18,8480748,Kiefer Sherwood,L,NSH,29,0,0,0,0
18,8476934,Brock McGinn,L,ANA,30,0,0,0,0
18,8480870,Bo Groulx,C,ANA,24,0,0,0,0
18,8479368,Max Jones,L,ANA,26,0,0,0,0
18,8478099,Kevin Labanc,R,SJS,29,0,0,0,0
18,8478067,Oskar Lindblom,L,SJS,28,0,0,0,0
18,8476393,Nick Cousins,C,FLA,31,0,0,0,0
18,8483395,Arshdeep Bains,L,VAN,23,0,0,0,0
18,8480762,Eric Robinson,L,BUF,29,0,0,0,0
18,8479439,Jacob MacDonald,D,SJS,31,0,0,0,0
18,8476474,Stefan Noesen,R,CAR,31,0,0,0,0
18,8482787,Nikita Chibrikov,R,WPG,31,0,0,0,0
18,8478432,Christian Fischer,R,DET,27,0,0,0,0
18,8477979,Nicolas Aube-Kubel,R,WSH,28,0,0,0,0
18,8481789,Tye Kartye,L,SEA,23,0,0,0,0
18,8479330,Brandon Gignac,C,MTL,27,0,0,0,0
18,8480075,Cameron Crotty,D,ARI,25,0,0,0,0
18,8473473,Milan Lucic,L,BOS,36,0,0,0,0
18,8482094,Daemon Hunt,D,MIN,22,0,0,0,0
18,8481206,John Ludvig,D,PIT,24,0,0,0,0
18,8483630,Pavol Regenda,L,ANA,25,0,0,0,0
18,8481617,Vasily Podkolzin,R,VAN,23,0,0,0,0
18,8480306,Grant Hutton,D,NYI,29,0,0,0,0
18,8480995,Pontus Holmberg,R,TOR,25,0,0,0,0
18,8482148,Hendrix Lapierre,C,WSH,22,0,0,0,0
18,8477478,William Carrier,L,VGK,30,0,0,0,0
18,8480003,Jesper Boqvist,C,BOS,26,0,0,0,0
18,8482172,Landon Slaggert,L,CHI,22,0,0,0,0
18,8480789,Oliver Wahlstrom,R,NYI,24,0,0,0,0
18,8474062,Riley Nash,C,NYR,35,0,0,0,0
18,8480021,Jack Studnicka,C,SJS,25,0,0,0,0
18,8480025,MacKenzie Entwistle,R,CHI,25,0,0,0,0
18,8481582,Nicholas Robertson,L,TOR,23,0,0,0,0
18,8476867,Brendan Gaunce,C,CBJ,30,0,0,0,0
18,8479619,Michael Carcone,L,ARI,28,0,0,0,0
18,8479370,Tyson Jost,C,BUF,26,0,0,0,0
18,8479671,Mathieu Olivier,R,CBJ,27,0,0,0,0
18,8476994,Vinnie Hinostroza,C,PIT,30,0,0,0,0
18,8482070,Mitchell Chaffee,R,TBL,26,0,0,0,0
18,8477473,Justin Bailey,R,SJS,29,0,0,0,0
18,8479344,Jesse Puljujarvi,R,PIT,26,0,0,0,0
18,8480205,Emil Bemstrom,C,PIT,25,0,0,0,0
18,8479718,Alex Barré-Boulet,C,TBL,27,0,0,0,0
18,8482061,Brandon Biro,L,BUF,26,0,0,0,0
18,8479638,Justin Brazeau,R,BOS,26,0,0,0,0
18,8474040,Sam Gagner,C,EDM,35,0,0,0,0
18,8477846,Ryan Carpenter,C,SJS,33,0,0,0,0
18,8482077,Dylan Holloway,L,EDM,23,0,0,0,0
18,8482157,Will Cuylle,L,NYR,22,0,0,0,0
18,8480007,Jonas Rondbjerg,R,VGK,25,0,0,0,0
18,8478874,Adam Gaudette,C,STL,28,0,0,0,0
18,8478434,Keegan Kolesar,R,VGK,27,0,0,0,0
18,8480441,Trey Fix-Wolansky,R,CBJ,25,0,0,0,0
18,8479994,Jaret Anderson-Dolan,C,NSH,25,0,0,0,0
18,8483567,Georgii Merkulov,C,BOS,24,0,0,0,0
18,8477380,Jonny Brodzinski,C,NYR,31,0,0,0,0
18,8482201,Gage Goncalves,C,TBL,23,0,0,0,0
18,8478211,Dryden Hunt,L,CGY,29,0,0,0,0
18,8471699,Andrew Cogliano,C,COL,37,0,0,0,0
18,8479421,Jacob Moverare,D,LAK,26,0,0,0,0
18,8478881,Brett Seney,L,CHI,28,0,0,0,0
18,8477464,Nic Petan,C,MIN,29,0,0,0,0
18,8475958,Michael Sgarbossa,C,WSH,32,0,0,0,0
18,8481147,Reese Johnson,C,CHI,26,0,0,0,0
18,8479336,Carl Grundstrom,R,LAK,27,0,0,0,0
18,8480853,Liam Foudy,C,NSH,24,0,0,0,0
18,8479522,Hardy Haman Aktell,D,WSH,26,0,0,0,0
18,8481462,Mason Morelli,L,VGK,28,0,0,0,0
18,8482102,Vasily Ponomarev,C,CAR,22,0,0,0,0
18,8480844,Grigori Denisenko,L,VGK,24,0,0,0,0
18,8479944,Zach Aston-Reese,C,DET,30,0,0,0,0
18,8482784,Zach Dean,C,STL,21,0,0,0,0
18,8479419,Brett Murray,L,BUF,26,0,0,0,0
18,8479520,Brandon Duhaime,R,COL,27,0,0,0,0
18,8477573,Nathan Walker,L,STL,30,0,0,0,0
18,8478078,Rourke Chartier,C,OTT,28,0,0,0,0
18,8475795,Dylan McIlrath,D,WSH,32,0,0,0,0
18,8482496,Nils Aman,C,VAN,24,0,0,0,0
18,8480289,Morgan Barron,C,WPG,26,0,0,0,0
18,8481751,Lukas Rousek,R,BUF,25,0,0,0,0
18,8480011,Klim Kostin,C,SJS,25,0,0,0,0
18,8481556,John Beecher,C,BOS,23,0,0,0,0
18,8475278,Byron Froese,C,VGK,33,0,0,0,0
18,8475225,Craig Smith,C,DAL,35,0,0,0,0
18,8484326,Patrik Koch,D,ARI,28,0,0,0,0
18,8477930,Pierre-Edouard Bellemare,L,SEA,39,0,0,0,0
18,8478409,Anthony Richard,C,BOS,28,0,0,0,0
18,8481024,Linus Karlsson,C,VAN,25,0,0,0,0
18,8479986,Kole Lind,R,SEA,26,0,0,0,0
18,8479414,Nathan Bastian,R,NJD,27,0,0,0,0
18,8479362,Riley Tufte,L,COL,26,0,0,0,0
18,8481058,Jesse Ylönen,R,MTL,25,0,0,0,0
18,8482476,Emil Heineman,L,MTL,23,0,0,0,0
18,8482861,Vincent Iorio,D,WSH,22,0,0,0,0
18,8483432,Luca Del Bel Belluz,C,CBJ,31,0,0,0,0
18,8482744,James Malatesta,L,CBJ,21,0,0,0,0
18,8477887,Patrick Brown,C,BOS,32,0,0,0,0
18,8478585,Derek Ryan,C,EDM,38,0,0,0,0
18,8481441,Joe Snively,C,WSH,28,0,0,0,0
18,8481592,Jakob Pelletier,L,CGY,23,0,0,0,0
18,8482634,Alex Steeves,C,TOR,25,0,0,0,0
18,8477126,Jayson Megna,C,BOS,34,0,0,0,0
18,8475752,Tyler Pitlick,C,NYR,33,0,0,0,0
18,8480008,Adam Ruzicka,C,ARI,25,0,0,0,0
18,8481065,Angus Crookshank,L,OTT,25,0,0,0,0
18,8479547,Matthew Phillips,R,WSH,26,0,0,0,0
18,8480226,Marián Studenic,R,SEA,26,0,0,0,0
18,8481237,Kyle MacLean,C,NYI,25,0,0,0,0
18,8475413,Justin Dowling,C,NJD,34,0,0,0,0
18,8481641,Joel Kiviranta,L,COL,28,0,0,0,0
18,8478104,Sammy Blais,L,STL,28,0,0,0,0
18,8477454,Adam Erne,L,EDM,29,0,0,0,0
18,8481518,Nolan Foote,L,NJD,24,0,0,0,0
18,8480245,Olle Lycksell,R,PHI,25,0,0,0,0
18,8483570,Ben Meyers,C,ANA,26,0,0,0,0
18,8480776,Sheldon Rempal,R,VGK,29,0,0,0,0
18,8483920,Pierrick Dube,R,WSH,23,0,0,0,0
18,8480267,Sammy Walker,C,MIN,25,0,0,0,0
18,8482747,Brennan Othmann,L,NYR,21,0,0,0,0
18,8479991,Jake Leschyshyn,C,NYR,25,0,0,0,0
18,8478400,Colin White,C,MTL,27,0,0,0,0
18,8479328,Julien Gauthier,R,NYI,27,0,0,0,0
18,8484325,Waltteri Merela,C,TBL,26,0,0,0,0
18,8479066,Ryan Lomberg,L,FLA,30,0,0,0,0
18,8477070,Liam O'Brien,C,ARI,30,0,0,0,0
18,8478146,Matthew Highmore,C,OTT,28,0,0,0,0
18,8478028,Fredrik Olofsson,L,COL,28,0,0,0,0
18,8480880,Jakub Lauko,C,BOS,24,0,0,0,0
18,8479968,Vinni Lettieri,C,MIN,29,0,0,0,0
18,8474709,Matt Martin,L,NYI,35,0,0,0,0
18,8480845,Rasmus Kupari,C,WPG,24,0,0,0,0
18,8481550,Adam Beckman,L,MIN,23,0,0,0,0
18,8481422,Jacob Lucchini,C,MIN,29,0,0,0,0
18,8477401,John Hayden,C,SEA,29,0,0,0,0
18,8478904,Steven Lorentz,C,FLA,28,0,0,0,0
18,8482088,Justin Sourdif,R,FLA,22,0,0,0,0
18,8482751,Ryan Winterton,C,SEA,21,0,0,0,0
18,8482241,Radim Zohorna,L,PIT,28,0,0,0,0
18,8481690,Tyler Angle,C,CBJ,24,0,0,0,0
18,8476952,Dominic Toninato,C,WPG,30,0,0,0,0
18,8476919,Chris Tierney,C,NJD,30,0,0,0,0
18,8480032,Shane Bowers,C,NJD,25,0,0,0,0
18,8484314,Jiri Smejkal,L,OTT,28,0,0,0,0
18,8481239,Samuel Fagemo,L,LAK,24,0,0,0,0
18,8481532,Alex Turcotte,C,LAK,23,0,0,0,0
18,8481019,David Gustafsson,C,WPG,24,0,0,0,0
18,8478477,Mitchell Stephens,C,MTL,27,0,0,0,0
18,8479546,Oskar Steen,C,BOS,26,0,0,0,0
18,8480292,Carson Meyer,R,CBJ,27,0,0,0,0
18,8478446,Glenn Gawdin,C,ANA,27,0,0,0,0
18,8483531,Brian Halonen,L,NJD,25,0,0,0,0
18,8477149,Scott Sabourin,R,SJS,32,0,0,0,0
18,8479972,Mason Shaw,C,MIN,26,0,0,0,0
18,8480890,Jan Jenik,R,ARI,24,0,0,0,0
18,8478051,Max Willman,C,NJD,29,0,0,0,0
18,8480851,Akil Thomas,C,LAK,24,0,0,0,0
18,8482765,Isak Rosen,R,BUF,21,0,0,0,0
18,8478421,A.J. Greer,L,CGY,28,0,0,0,0
18,8478512,Austin Czarnik,C,DET,32,0,0,0,0
18,8479536,Axel Jonsson-Fjallby,L,WPG,26,0,0,0,0
18,8477320,Anton Blidh,L,NYR,29,0,0,0,0
18,8481543,Nikita Alexandrov,C,STL,24,0,0,0,0
18,8475235,Nicolas Deslauriers,L,PHI,33,0,0,0,0
18,8481070,Hugh McGing,L,STL,26,0,0,0,0
18,8480836,Jonathan Gruden,C,PIT,24,0,0,0,0
18,8481591,Sam Poulin,R,PIT,23,0,0,0,0
18,8477962,Brendan Lemieux,L,CAR,28,0,0,0,0
18,8483401,Marc Johnstone,R,PIT,28,0,0,0,0
18,8482250,Callahan Burke,C,CAR,27,0,0,0,0
18,8481726,Adam Edstrom,C,NYR,24,0,0,0,0
18,8471817,Ryan Reaves,R,TOR,37,0,0,0,0
18,8479587,Rhett Gardner,C,PHI,28,0,0,0,0
18,8475766,Austin Watson,L,TBL,32,0,0,0,0
18,8479367,William Lockwood,R,FLA,26,0,0,0,0
18,8478424,Jansen Harkins,C,PIT,27,0,0,0,0
18,8476913,Devin Shore,C,SEA,30,0,0,0,0
18,8482652,Walker Duehr,R,CGY,27,0,0,0,0
18,8477527,Ross Johnston,L,ANA,30,0,0,0,0
18,8481077,John Leonard,L,ARI,26,0,0,0,0
18,8483549,Lucas Condotta,L,MTL,27,0,0,0,0
18,8480468,James Hamblin,L,EDM,25,0,0,0,0
18,8476907,Mackenzie MacEachern,L,STL,30,0,0,0,0
18,8479543,Michael Pezzetta,L,MTL,26,0,0,0,0
18,8480355,Mark Kastelic,C,OTT,25,0,0,0,0
18,8482162,Roby Jarventie,L,OTT,22,0,0,0,0
18,8479772,Zack MacEwen,R,OTT,28,0,0,0,0
18,8483597,Milos Kelemen,L,ARI,25,0,0,0,0
18,8479379,Givani Smith,R,SJS,26,0,0,0,0
18,8481655,Cole Schwindt,R,CGY,23,0,0,0,0
18,8479981,Jonah Gadjovich,L,FLA,26,0,0,0,0
18,8482147,Jean-Luc Foudy,C,COL,22,0,0,0,0
18,8484255,Jason Polin,R,COL,25,0,0,0,0
18,8477993,Justin Kirkland,C,ARI,28,0,0,0,0
18,8479249,Andrew Poturalski,C,SEA,30,0,0,0,0
18,8482197,Adam Raska,R,MIN,23,0,0,0,0
18,8475780,Chris Wagner,R,COL,33,0,0,0,0
18,8479533,Joona Koppanen,L,PIT,26,0,0,0,0
18,8481534,Raphael Lavoie,C,EDM,24,0,0,0,0
18,8484321,Nikolas Matinpalo,D,OTT,26,0,0,0,0
18,8481043,Cole Koepke,L,TBL,26,0,0,0,0
18,8476323,Max McCormick,L,SEA,32,0,0,0,0
18,8483609,Adam Klapka,R,CGY,24,0,0,0,0
18,8483512,Matt Savoie,C,BUF,20,0,0,0,0
18,8484259,Ondrej Pavel,C,COL,31,0,0,0,0
18,8478147,Bokondji Imama,L,OTT,28,0,0,0,0
18,8482460,Matt Rempe,C,NYR,22,0,0,0,0
18,8477073,Kurtis MacDermid,L,NJD,30,0,0,0,0
18,8480274,Philip Kemp,D,EDM,25,0,0,0,0
18,8478956,Samuel Laberge,L,NJD,27,0,0,0,0
18,8483045,Cameron Butler,R,CBJ,31,0,0,0,0
19,8476453,Nikita Kucherov,R,TBL,31,82,44,77,121
19,8478402,Connor McDavid,C,EDM,27,82,37,83,120
19,8481559,Jack Hughes,C,NJD,23,82,41,71,112
19,8479318,Auston Matthews,C,TOR,27,82,64,45,109
19,8477934,Leon Draisaitl,C,EDM,29,82,36,66,102
19,8479314,Matthew Tkachuk,L,FLA,27,82,36,63,99
19,8480012,Elias Pettersson,C,VAN,26,82,37,59,96
19,8479323,Adam Fox,D,NYR,26,82,20,76,96
19,8477933,Sam Reinhart,C,FLA,29,82,43,52,95
19,8478864,Kirill Kaprizov,L,MIN,27,82,46,47,93
19,8476459,Mika Zibanejad,C,NYR,31,82,43,46,89
19,8471675,Sidney Crosby,C,PIT,37,82,32,57,89
19,8478550,Artemi Panarin,L,NYR,33,82,31,58,89
19,8477956,David Pastrnak,R,BOS,28,82,38,49,87
19,8477493,Aleksander Barkov,C,FLA,29,82,37,49,86
19,8477492,Nathan MacKinnon,C,COL,29,82,35,49,84
19,8481557,Matt Boldy,L,MIN,23,82,35,49,84
19,8479407,Jesper Bratt,L,NJD,26,82,34,48,82
19,8477939,William Nylander,R,TOR,28,82,29,52,81
19,8477500,Bo Horvat,C,NYI,29,82,36,43,79
19,8476468,J.T. Miller,C,VAN,31,82,29,50,79
19,8478445,Mathew Barzal,C,NYI,27,82,13,66,79
19,8476887,Filip Forsberg,L,NSH,30,82,47,31,78
19,8474600,Roman Josi,D,NSH,34,82,18,60,78
19,8478010,Brayden Point,C,TBL,28,82,40,37,77
19,8477946,Dylan Larkin,C,DET,28,82,39,38,77
19,8478420,Mikko Rantanen,R,COL,28,82,31,46,77
19,8475166,John Tavares,C,TOR,34,82,28,49,77
19,8480002,Nico Hischier,C,NJD,25,82,24,53,77
19,8481523,Kirby Dach,C,MTL,23,82,11,66,77
19,8475184,Chris Kreider,L,NYR,33,82,45,31,76
19,8482116,Tim Stützle,C,OTT,22,82,24,51,75
19,8475172,Nazem Kadri,C,CGY,34,82,20,55,75
19,8475786,Zach Hyman,L,EDM,32,82,43,31,74
19,8479343,Clayton Keller,R,ARI,26,82,36,38,74
19,8480069,Cale Makar,D,COL,26,82,19,55,74
19,8480801,Brady Tkachuk,L,OTT,25,82,37,36,73
19,8478493,Joel Eriksson Ek,C,MIN,27,82,29,44,73
19,8475692,Mats Zuccarello,R,MIN,37,82,27,46,73
19,8479385,Jordan Kyrou,C,STL,26,82,30,42,72
19,8471215,Evgeni Malkin,C,PIT,38,82,29,43,72
19,8474564,Steven Stamkos,C,TBL,34,82,36,35,71
19,8478444,Brock Boeser,R,VAN,27,82,36,35,71
19,8475754,Brock Nelson,C,NYI,33,82,31,40,71
19,8478439,Travis Konecny,R,PHI,27,82,28,43,71
19,8477942,Kevin Fiala,L,LAK,28,82,27,44,71
19,8476456,Jonathan Huberdeau,C,CGY,31,82,19,51,70
19,8480023,Robert Thomas,C,STL,25,82,18,52,70
19,8477501,Valeri Nichushkin,R,COL,29,82,28,41,69
19,8477949,Alex Tuch,R,BUF,28,82,24,45,69
19,8476853,Morgan Rielly,D,TOR,30,82,13,56,69
19,8481540,Cole Caufield,R,MTL,23,82,42,26,68
19,8477402,Pavel Buchnevich,L,STL,29,82,31,37,68
19,8477951,Nick Schmaltz,C,ARI,28,82,28,40,68
19,8477409,Carter Verhaeghe,C,FLA,29,82,38,29,67
19,8479420,Tage Thompson,C,BUF,27,82,37,30,67
19,8473419,Brad Marchand,L,BOS,36,82,31,36,67
19,8471685,Anze Kopitar,C,LAK,37,82,25,42,67
19,8475158,Ryan O'Reilly,C,NSH,33,82,24,42,66
19,8480800,Quinn Hughes,D,VAN,25,82,8,58,66
19,8476460,Mark Scheifele,C,WPG,31,82,25,40,65
19,8479542,Brandon Hagel,L,TBL,26,82,20,45,65
19,8476389,Vincent Trocheck,C,NYR,31,82,19,46,65
19,8477955,Jared McCann,L,SEA,28,82,33,31,64
19,8478449,Roope Hintz,C,DAL,28,82,30,34,64
19,8480830,Andrei Svechnikov,R,CAR,24,82,23,41,64
19,8475167,Victor Hedman,D,TBL,34,82,21,43,64
19,8480027,Jason Robertson,L,DAL,25,82,16,48,64
19,8477451,Ryan Hartman,R,MIN,30,82,29,34,63
19,8473512,Claude Giroux,R,OTT,36,82,26,37,63
19,8474141,Patrick Kane,R,DET,36,82,26,36,62
19,8477404,Jake Guentzel,C,CAR,30,82,24,38,62
19,8478873,Troy Terry,R,ANA,27,82,23,39,62
19,8482684,Luke Hughes,D,NJD,21,82,20,42,62
19,8475810,Bryan Rust,R,PIT,32,82,30,31,61
19,8480208,Drake Batherson,R,OTT,26,82,26,35,61
19,8478427,Sebastian Aho,C,CAR,27,82,25,36,61
19,8477447,Shea Theodore,D,VGK,29,82,12,49,61
19,8478414,Timo Meier,R,NJD,28,82,30,30,60
19,8478401,Pavel Zacha,C,BOS,27,82,20,40,60
19,8480036,Miro Heiskanen,D,DAL,25,82,10,50,60
19,8480015,Owen Tippett,R,PHI,25,82,33,26,59
19,8480839,Rasmus Dahlin,D,BUF,24,82,16,43,59
19,8476454,Ryan Nugent-Hopkins,C,EDM,31,82,11,48,59
19,8478403,Jack Eichel,C,VGK,28,82,29,29,58
19,8471214,Alex Ovechkin,L,WSH,39,82,22,36,58
19,8475168,Matt Duchene,C,DAL,33,82,20,38,58
19,8479325,Charlie McAvoy,D,BOS,27,82,11,47,58
19,8482097,Jack Quinn,R,BUF,23,82,21,36,57
19,8480803,Evan Bouchard,D,EDM,25,82,14,43,57
19,8479425,Filip Hronek,D,VAN,27,82,8,49,57
19,8477960,Adrian Kempe,R,LAK,28,82,28,28,56
19,8480018,Nick Suzuki,C,MTL,25,82,27,29,56
19,8470794,Joe Pavelski,C,DAL,40,82,21,35,56
19,8477479,Tyler Bertuzzi,L,TOR,29,82,19,37,56
19,8477932,Aaron Ekblad,D,FLA,28,82,13,43,56
19,8482113,Anton Lundell,C,FLA,23,82,13,43,56
19,8474590,John Carlson,D,WSH,34,82,9,47,56
19,8475191,Reilly Smith,R,PIT,33,82,20,35,55
19,8478440,Dylan Strome,C,WSH,27,82,17,38,55
19,8477416,Oliver Bjorkstrand,R,SEA,29,82,16,39,55
19,8478407,Vince Dunn,D,SEA,28,82,13,42,55
19,8475726,Tyler Toffoli,C,WPG,32,82,32,22,54
19,8478042,Viktor Arvidsson,R,LAK,31,82,22,32,54
19,8478498,Jake DeBrusk,L,BOS,28,82,21,33,54
19,8477940,Nikolaj Ehlers,L,WPG,28,82,13,41,54
19,8480865,Noah Dobson,D,NYI,24,82,12,42,54
19,8476346,Johnny Gaudreau,L,CBJ,31,82,10,44,54
19,8475314,Anders Lee,L,NYI,34,82,30,23,53
19,8475794,Tyler Seguin,C,DAL,32,82,28,25,53
19,8481596,Shane Pinto,C,OTT,24,82,21,32,53
19,8481528,Dylan Cozens,C,BUF,23,82,19,34,53
19,8482699,Dylan Guenther,R,ARI,21,82,27,25,52
19,8482093,Seth Jarvis,C,CAR,22,82,24,28,52
19,8475151,Kyle Palmieri,C,NYI,33,82,24,28,52
19,8478047,Michael Bunting,L,PIT,29,82,23,29,52
19,8481618,Alex Newhook,C,MTL,23,82,21,31,52
19,8475798,Mikael Granlund,C,SJS,32,82,18,34,52
19,8473994,Jamie Benn,L,DAL,35,82,18,34,52
19,8474578,Erik Karlsson,D,PIT,34,82,14,38,52
19,8480064,Josh Norris,C,OTT,25,82,26,25,51
19,8479337,Alex DeBrincat,R,DET,27,82,25,26,51
19,8475745,Charlie Coyle,C,BOS,32,82,23,28,51
19,8475784,Jeff Skinner,C,BUF,32,82,22,29,51
19,8475170,Brayden Schenn,C,STL,33,82,17,34,51
19,8474563,Drew Doughty,D,LAK,35,82,7,44,51
19,8477935,Sam Bennett,C,FLA,28,82,28,22,50
19,8476539,Jonathan Marchessault,R,VGK,34,82,27,23,50
19,8478438,Tommy Novak,C,NSH,27,82,22,28,50
19,8479675,Trevor Moore,L,LAK,29,82,16,34,50
19,8478472,Mathieu Joseph,R,OTT,27,82,15,35,50
19,8477986,Brandon Montour,D,FLA,30,82,14,36,50
19,8482101,Danil Gushchin,L,SJS,22,82,25,24,49
19,8478398,Kyle Connor,L,WPG,28,82,24,25,49
19,8482740,Wyatt Johnston,C,DAL,21,82,21,28,49
19,8478474,Lawson Crouse,L,ARI,27,82,20,29,49
19,8482665,Matty Beniers,C,SEA,22,82,16,33,49
19,8474641,Adam Henrique,C,EDM,34,82,16,33,49
19,8479345,Jakob Chychrun,D,OTT,26,82,15,34,49
19,8481711,Matias Maccelli,L,ARI,24,82,9,40,49
19,8478462,Nicolas Roy,C,VGK,27,82,23,25,48
19,8480078,Filip Chytil,C,NYR,25,82,22,26,48
19,8482109,Alexis Lafrenière,L,NYR,23,82,22,26,48
19,8475287,Erik Haula,L,NJD,33,82,19,29,48
19,8474679,Gustav Nyquist,C,NSH,35,82,12,36,48
19,8474102,David Perron,L,DET,36,82,25,22,47
19,8482159,Tyson Foerster,R,PHI,22,82,22,25,47
19,8477407,Anthony Duclair,L,TBL,29,82,22,25,47
19,8475765,Vladimir Tarasenko,R,FLA,33,82,20,27,47
19,8480028,Morgan Frost,C,PHI,25,82,19,28,47
19,8478038,Devon Toews,D,COL,30,82,14,33,47
19,8476448,William Karlsson,C,VGK,31,82,12,35,47
19,8478397,Rasmus Andersson,D,CGY,28,82,10,37,47
19,8478975,Mason Marchment,L,DAL,29,82,26,20,46
19,8480039,Martin Necas,C,CAR,25,82,24,22,46
19,8477497,Sean Monahan,C,WPG,30,82,22,24,46
19,8475793,Ryan Johansen,C,PHI,32,82,20,26,46
19,8482124,Quinton Byfield,R,LAK,22,82,19,27,46
19,8482667,William Eklund,L,SJS,22,82,17,29,46
19,8475744,Evgeny Kuznetsov,C,CAR,32,82,17,29,46
19,8477503,Max Domi,C,TOR,29,82,13,33,46
19,8478460,Zach Werenski,D,CBJ,27,82,12,34,46
19,8480798,Philipp Kurashev,C,CHI,25,82,10,36,46
19,8484144,Connor Bedard,C,CHI,19,82,24,21,45
19,8475169,Evander Kane,L,EDM,33,82,24,21,45
19,8483808,Andrei Kuzmenko,L,CGY,28,82,22,23,45
19,8482078,Lucas Raymond,L,DET,22,82,20,25,45
19,8473422,Nick Foligno,L,CHI,37,82,19,26,45
19,8476882,Teuvo Teravainen,L,CAR,30,82,15,30,45
19,8479999,Casey Mittelstadt,C,COL,26,82,13,32,45
19,8476906,Shayne Gostisbehere,D,DET,31,82,7,38,45
19,8480893,Kirill Marchenko,R,CBJ,24,82,25,19,44
19,8480031,Maxime Comtois,L,CAR,25,82,14,30,44
19,8477444,Andre Burakovsky,L,SEA,29,82,12,32,44
19,8470613,Brent Burns,D,CAR,39,82,9,35,44
19,8478856,Conor Garland,R,VAN,28,82,18,25,43
19,8474586,Jordan Eberle,R,SEA,34,82,16,27,43
19,8476462,Dougie Hamilton,D,NJD,31,82,15,28,43
19,8476881,Tomas Hertl,C,VGK,31,82,15,28,43
19,8476792,Torey Krug,D,STL,33,82,11,32,43
19,8479410,Mikhail Sergachev,D,TBL,26,82,7,36,43
19,8477495,Seth Jones,D,CHI,30,82,7,36,43
19,8483515,Juraj Slafkovsky,L,MTL,20,82,20,22,42
19,8478519,Anthony Cirelli,C,TBL,27,82,18,24,42
19,8477964,Ivan Barbashev,C,VGK,29,82,15,27,42
19,8481068,Yegor Sharangovich,C,CGY,26,82,14,28,42
19,8475763,Kevin Hayes,R,STL,32,82,13,29,42
19,8471724,Kris Letang,D,PIT,37,82,9,33,42
19,8481699,Aku Raty,R,ARI,23,82,1,41,42
19,8483397,Marc McLaughlin,C,BOS,25,82,36,5,41
19,8479525,Ross Colton,C,COL,28,82,24,17,41
19,8475799,Nino Niederreiter,R,WPG,32,82,23,18,41
19,8476880,Tom Wilson,R,WSH,30,82,22,19,41
19,8478233,Andrew Mangiapane,L,CGY,28,82,20,21,41
19,8475913,Mark Stone,R,VGK,32,82,19,22,41
19,8480009,Eeli Tolvanen,R,SEA,25,82,19,22,41
19,8478542,Evan Rodrigues,C,FLA,31,82,18,23,41
19,8476872,Scott Laughton,C,PHI,30,82,18,23,41
19,8474870,Tyler Johnson,C,CHI,34,82,18,23,41
19,8473986,Alex Killorn,L,ANA,35,82,16,25,41
19,8477953,Kasperi Kapanen,R,STL,28,82,12,29,41
19,8482117,Lukas Reichel,L,CHI,22,82,11,30,41
19,8479987,Morgan Geekie,C,BOS,26,82,11,30,41
19,8483524,Shane Wright,C,SEA,20,82,28,12,40
19,8479400,Pierre-Luc Dubois,L,LAK,26,82,23,17,40
19,8482110,Dawson Mercer,C,NJD,23,82,20,20,40
19,8476292,Ondrej Palat,L,NJD,33,82,19,21,40
19,8479339,Patrik Laine,L,CBJ,26,82,14,26,40
19,8476875,Mike Matheson,D,MTL,30,82,8,32,40
19,8475197,Tyson Barrie,D,NSH,33,82,6,34,40
19,8477998,Warren Foegele,L,EDM,28,82,23,16,39
19,8476483,Rickard Rakell,R,PIT,31,82,21,18,39
19,8477511,Anthony Mantha,R,VGK,30,82,15,24,39
19,8476479,Phillip Danault,C,LAK,31,82,13,26,39
19,8478469,Thomas Chabot,D,OTT,27,82,9,30,39
19,8476432,Boone Jenner,C,CBJ,31,82,25,13,38
19,8476399,Blake Coleman,C,CGY,33,82,23,15,38
19,8475760,Nick Bjugstad,C,ARI,32,82,21,17,38
19,8477496,Elias Lindholm,C,VAN,30,82,19,19,38
19,8478458,Jack Roslovic,C,NYR,27,82,19,19,38
19,8482745,Mason McTavish,C,ANA,21,82,17,21,38
19,8477429,Andrew Copp,C,DET,30,82,16,22,38
19,8474157,Max Pacioretty,L,WSH,36,82,16,22,38
19,8481554,Kaapo Kakko,R,NYR,23,82,15,23,38
19,8474189,Lars Eller,C,PIT,35,82,14,24,38
19,8476826,Yanni Gourde,C,SEA,33,82,13,25,38
19,8476905,Chandler Stephenson,C,VGK,30,82,12,26,38
19,8478055,Gustav Forsling,D,FLA,28,82,11,27,38
19,8474565,Alex Pietrangelo,D,VGK,34,82,9,29,38
19,8481016,Ruslan Iskhakov,C,NYI,24,82,5,33,38
19,8475722,Jason Zucker,L,NSH,32,82,21,16,37
19,8480188,Fabian Zetterlund,L,SJS,25,82,20,17,37
19,8483431,Logan Cooley,C,ARI,20,82,20,17,37
19,8478463,Anthony Beauvillier,L,NSH,27,82,19,18,37
19,8478466,Daniel Sprong,R,DET,27,82,16,21,37
19,8474037,James van Riemsdyk,L,BOS,35,82,16,21,37
19,8475768,Jaden Schwartz,C,SEA,32,82,16,21,37
19,8480113,Alex Iafallo,L,WPG,31,82,16,21,37
19,8476458,Ryan Strome,C,ANA,31,82,15,22,37
19,8477021,Alex Kerfoot,C,ARI,30,82,13,24,37
19,8481656,Aliaksei Protas,C,WSH,23,82,11,26,37
19,8477504,Josh Morrissey,D,WPG,29,82,8,29,37
19,8475753,Justin Faulk,D,STL,32,82,6,31,37
19,8476958,Jaccob Slavin,D,CAR,30,82,5,32,37
19,8480434,Sean Durzi,D,ARI,26,82,5,32,37
19,8478911,Matt Roy,D,LAK,29,82,5,32,37
19,8482089,Jake Neighbours,L,STL,22,82,23,13,36
19,8476438,Brandon Saad,L,STL,32,82,16,20,36
19,8478115,Pierre Engvall,L,NYI,28,82,16,20,36
19,8475791,Taylor Hall,L,CHI,33,82,14,22,36
19,8479996,Cody Glass,C,NSH,25,82,14,22,36
19,8477346,MacKenzie Weegar,D,CGY,30,82,11,25,36
19,8480043,Timothy Liljegren,D,TOR,25,82,10,26,36
19,8471218,Blake Wheeler,R,NYR,38,82,10,26,36
19,8476869,Brady Skjei,D,CAR,30,82,8,28,36
19,8481542,Moritz Seider,D,DET,23,82,4,32,36
19,8477944,Jakub Vrana,L,STL,28,82,23,12,35
19,8477947,Sonny Milano,L,WSH,28,82,19,16,35
19,8482146,Luke Evangelista,R,NSH,22,82,17,18,35
19,8480821,Filip Zadina,R,SJS,25,82,17,18,35
19,8471698,T.J. Oshie,R,WSH,38,82,16,19,35
19,8480849,Barrett Hayton,C,ARI,24,82,15,20,35
19,8482720,Matthew Knies,L,TOR,22,82,14,21,35
19,8484166,Adam Fantilli,C,CBJ,20,82,14,21,35
19,8480817,K'Andre Miller,D,NYR,24,82,10,25,35
19,8481546,Cam York,D,PHI,23,82,6,29,35
19,8474716,Jared Spurgeon,D,MIN,35,82,5,30,35
19,8480873,Rasmus Sandin,D,WSH,24,82,4,31,35
19,8476931,Jake McCabe,D,TOR,31,82,4,31,35
19,8480797,Joel Farabee,L,PHI,24,82,17,17,34
19,8481624,Ilya Mikheyev,R,VAN,30,82,15,19,34
19,8475149,Marcus Johansson,L,MIN,34,82,14,20,34
19,8473449,Kyle Okposo,R,FLA,36,82,14,20,34
19,8477494,Jonathan Drouin,L,COL,29,82,9,25,34
19,8476923,Damon Severson,D,CBJ,30,82,3,31,34
19,8476871,Tanner Pearson,L,MTL,32,82,12,21,33
19,8474150,Mikael Backlund,C,CGY,35,82,11,22,33
19,8476461,Sean Couturier,C,PHI,32,82,11,22,33
19,8478891,Mason Appleton,C,WPG,28,82,10,23,33
19,8476960,Andreas Athanasiou,C,CHI,30,82,9,24,33
19,8482133,Thomas Bordeleau,C,SJS,22,82,8,25,33
19,8476463,Jonas Brodin,D,MIN,31,82,8,25,33
19,8483457,Lane Hutson,D,MTL,20,82,3,30,33
19,8482175,JJ Peterka,R,BUF,22,82,16,16,32
19,8477426,Nicholas Paul,L,TBL,29,82,16,16,32
19,8478057,Dakota Joshua,C,VAN,28,82,15,17,32
19,8475714,Calle Jarnkrok,C,TOR,33,82,15,17,32
19,8479316,Luke Kunin,C,SJS,27,82,15,17,32
19,8477919,Frederick Gaudreau,C,MIN,31,82,15,17,32
19,8478020,Michael Amadio,C,VGK,28,82,15,17,32
19,8480802,Ryan McLeod,C,EDM,25,82,13,19,32
19,8477330,Dominik Kubalik,L,OTT,29,82,13,19,32
19,8479415,Michael McLeod,C,NJD,26,82,9,23,32
19,8478046,Danton Heinen,L,BOS,29,82,8,24,32
19,8474053,Logan Couture,C,SJS,35,82,8,24,32
19,8481533,Trevor Zegras,C,ANA,23,82,7,25,32
19,8482475,Yegor Chinakhov,R,CBJ,23,82,7,25,32
19,8478178,Darren Raddysh,D,TBL,28,82,7,25,32
19,8474151,Ryan McDonagh,D,NSH,35,82,5,27,32
19,8481606,Jordan Spence,D,LAK,23,82,5,27,32
19,8478136,Jake Middleton,D,MIN,28,82,5,27,32
19,8482733,Logan Mailloux,D,MTL,31,82,2,30,32
19,8476981,Josh Anderson,R,MTL,30,82,18,13,31
19,8477989,Christian Dvorak,C,MTL,28,82,17,14,31
19,8482074,Connor Zary,C,CGY,23,82,17,14,31
19,8480185,Eetu Luostarinen,C,FLA,26,82,14,17,31
19,8477450,Jason Dickinson,C,CHI,29,82,14,17,31
19,8483445,Cutter Gauthier,L,ANA,20,82,10,21,31
19,8478396,Noah Hanifin,D,VGK,27,82,9,22,31
19,8476885,Jacob Trouba,D,NYR,30,82,9,22,31
19,8478133,Jake Evans,C,MTL,28,82,9,22,31
19,8475906,John Klingberg,D,TOR,32,82,4,27,31
19,8476979,Erik Gustafsson,D,NYR,32,82,3,28,31
19,8478569,Noel Acciari,C,PIT,33,82,18,12,30
19,8481535,Nils Hoglander,L,VAN,24,82,15,15,30
19,8475848,Brendan Gallagher,R,MTL,32,82,14,16,30
19,8470621,Corey Perry,R,EDM,39,82,14,16,30
19,8480068,Ryan Poehling,C,PHI,25,82,14,16,30
19,8482222,Alexander Barabanov,L,SJS,30,82,10,20,30
19,8476329,Travis Boyd,C,ARI,31,82,9,21,30
19,8479992,Michael Rasmussen,C,DET,25,82,9,21,30
19,8477498,Darnell Nurse,D,EDM,29,82,9,21,30
19,8476854,Hampus Lindholm,D,BOS,30,82,6,24,30
19,8480246,Nick Perbix,D,TBL,26,82,1,29,30
19,8477476,Artturi Lehkonen,L,COL,29,82,22,7,29
19,8478366,Frank Vatrano,R,ANA,30,82,18,11,29
19,8481560,Arthur Kaliyev,R,LAK,23,82,16,13,29
19,8482259,Bobby McMann,C,TOR,28,82,16,13,29
19,8474884,Mike Hoffman,C,SJS,35,82,15,14,29
19,8482125,Alexander Holtz,R,NJD,22,82,13,16,29
19,8481028,Martin Pospisil,C,CGY,25,82,12,17,29
19,8475220,Marcus Foligno,L,MIN,33,82,12,17,29
19,8481477,Nico Sturm,C,SJS,29,82,11,18,29
19,8479351,Sam Steel,C,DAL,26,82,11,18,29
19,8477506,Ryan Pulock,D,NYI,30,82,10,19,29
19,8479661,Tanner Jeannot,L,TBL,27,82,10,19,29
19,8479346,Dillon Dube,C,CGY,26,82,10,19,29
19,8480145,Neal Pionk,D,WPG,29,82,6,23,29
19,8476892,Colton Parayko,D,STL,31,82,6,23,29
19,8480220,Noah Cates,L,PHI,25,82,4,25,29
19,8481703,Valtteri Puustinen,R,PIT,25,82,2,27,29
19,8479423,Alex Nylander,L,CBJ,26,82,16,12,28
19,8479365,Trent Frederic,C,BOS,26,82,15,13,28
19,8475231,Casey Cizikas,C,NYI,33,82,14,14,28
19,8482705,Cole Sillinger,C,CBJ,21,82,12,16,28
19,8477456,J.T. Compher,L,DET,29,82,11,17,28
19,8481014,Alexander Romanov,D,NYI,24,82,10,18,28
19,8482671,Owen Power,D,BUF,22,82,7,21,28
19,8477948,Travis Sanheim,D,PHI,28,82,6,22,28
19,8478882,Vladislav Gavrikov,D,LAK,29,82,6,22,28
19,8481581,Thomas Harley,D,DAL,23,82,3,25,28
19,8481604,Pavel Dorofeyev,L,VGK,24,82,20,7,27
19,8480014,Gabriel Vilardi,C,WPG,25,82,19,8,27
19,8479359,Beck Malenstyn,L,WSH,26,82,18,9,27
19,8479941,Justin Danforth,R,CBJ,31,82,16,11,27
19,8481093,Rafael Harvey-Pinard,L,MTL,25,82,16,11,27
19,8479591,Michael Eyssimont,C,TBL,28,82,15,12,27
19,8480459,Pius Suter,C,VAN,28,82,14,13,27
19,8478413,Jordan Greenway,L,BUF,27,82,13,14,27
19,8476469,Joel Armia,R,MTL,31,82,13,14,27
19,8479393,Noah Gregor,C,TOR,26,82,13,14,27
19,8473533,Jordan Staal,C,CAR,36,82,12,15,27
19,8481601,Simon Holmstrom,R,NYI,23,82,12,15,27
19,8482079,Marco Rossi,C,MIN,23,82,11,16,27
19,8476897,Oskar Sundqvist,C,STL,30,82,10,17,27
19,8484153,Leo Carlsson,C,ANA,20,82,9,18,27
19,8482655,J.J. Moser,D,ARI,24,82,8,19,27
19,8482087,Kaiden Guhle,D,MTL,22,82,7,20,27
19,8476902,Esa Lindell,D,DAL,30,82,6,21,27
19,8477969,Marcus Pettersson,D,PIT,28,82,5,22,27
19,8480871,Adam Boqvist,D,CBJ,24,82,5,22,27
19,8482122,Brock Faber,D,MIN,22,82,4,23,27
19,8479976,Juuso Valimaki,D,ARI,26,82,2,25,27
19,8476278,Colin Blackwell,C,CHI,31,82,15,11,26
19,8483499,Liam Ohgren,L,MIN,20,82,12,14,26
19,8476624,Barclay Goodrow,C,NYR,31,82,12,14,26
19,8481481,Blake Lizotte,C,LAK,27,82,11,15,26
19,8482055,Drew O'Connor,L,PIT,26,82,10,16,26
19,8473563,Nicklas Backstrom,C,WSH,37,82,10,16,26
19,8479977,Kailer Yamamoto,R,SEA,26,82,9,17,26
19,8483505,Matthew Poitras,C,BOS,20,82,8,18,26
19,8475171,Oliver Ekman-Larsson,D,FLA,33,82,6,20,26
19,8482105,Jake Sanderson,D,OTT,22,82,5,21,26
19,8475218,Mattias Ekholm,D,EDM,34,82,5,21,26
19,8475764,Cam Fowler,D,ANA,33,82,4,22,26
19,8474673,TJ Brodie,D,TOR,34,82,2,24,26
19,8478013,Jake Walman,D,DET,28,82,2,24,26
19,8482092,Ridly Greig,C,OTT,22,82,14,11,25
19,8476921,Jordan Martinook,L,CAR,32,82,13,12,25
19,8478109,Victor Olofsson,L,BUF,29,82,12,13,25
19,8483491,Ivan Miroshnichenko,L,WSH,20,82,10,15,25
19,8482062,Cole Smith,L,NSH,29,82,9,16,25
19,8479983,Mario Ferraro,D,SJS,26,82,5,20,25
19,8479369,Andrew Peeke,D,BOS,26,82,5,20,25
19,8482073,Braden Schneider,D,NYR,23,82,5,20,25
19,8475181,Nick Leddy,D,STL,33,82,4,21,25
19,8473453,Trevor Lewis,C,LAK,37,82,14,10,24
19,8476873,Mark Jankowski,C,NSH,30,82,12,12,24
19,8481517,Brett Leason,R,ANA,25,82,11,13,24
19,8475200,Dmitry Orlov,D,CAR,33,82,9,15,24
19,8477952,Robby Fabbri,C,DET,28,82,7,17,24
19,8478468,Jeremy Lauzon,D,NSH,27,82,7,17,24
19,8483482,Tristan Luneau,D,ANA,20,82,7,17,24
19,8478399,Jonas Siegenthaler,D,NJD,27,82,5,19,24
19,8482145,Mavrik Bourque,C,DAL,22,82,17,6,23
19,8480855,Jack McBain,C,ARI,24,82,15,8,23
19,8480281,Alexey Toropchenko,R,STL,25,82,15,8,23
19,8480980,Connor Dewar,C,TOR,25,82,13,10,23
19,8480144,David Kampf,C,TOR,29,82,12,11,23
19,8474149,Evgenii Dadonov,R,DAL,35,82,11,12,23
19,8470604,Jeff Carter,C,PIT,39,82,11,12,23
19,8479293,Brandon Tanev,L,SEA,33,82,10,13,23
19,8477435,Ryan Graves,D,PIT,29,82,9,14,23
19,8481537,Nikita Okhotiuk,D,CGY,24,82,9,14,23
19,8475455,Brenden Dillon,D,WPG,34,82,8,15,23
19,8476917,Adam Pelech,D,NYI,30,82,6,17,23
19,8478851,Alexandre Carrier,D,NSH,28,82,6,17,23
19,8477488,Brett Pesce,D,CAR,30,82,5,18,23
19,8480172,Jan Rutta,D,SJS,34,82,5,18,23
19,8478507,John Marino,D,NJD,27,82,4,19,23
19,8481704,Juuso Parssinen,C,NSH,23,82,13,9,22
19,8474715,Cam Atkinson,R,PHI,35,82,12,10,22
19,8482624,Daniil Miromanov,D,CGY,27,82,10,12,22
19,8482679,Matt Coronato,R,CGY,22,82,9,13,22
19,8476925,Colton Sissons,C,NSH,31,82,8,14,22
19,8475462,Radko Gudas,D,ANA,34,82,7,15,22
19,8480073,Erik Brannstrom,D,OTT,25,82,6,16,22
19,8483493,Frank Nazar,C,CHI,20,82,16,5,21
19,8479514,Rem Pitlick,C,CHI,27,82,10,11,21
19,8479383,Boris Katchouk,L,OTT,26,82,9,12,21
19,8477425,Miles Wood,L,COL,29,82,8,13,21
19,8475208,Brian Dumoulin,D,SEA,33,82,5,16,21
19,8479371,Dante Fabbro,D,NSH,26,82,5,16,21
19,8482245,Artem Zub,D,OTT,29,82,4,17,21
19,8476480,Vladislav Namestnikov,C,WPG,32,82,3,18,21
19,8482118,Sam Colangelo,R,ANA,23,82,16,4,20
19,8482702,Logan Stankoven,C,DAL,21,82,13,7,20
19,8475343,Nic Dowd,C,WSH,34,82,12,8,20
19,8478508,Yakov Trenin,C,COL,27,82,12,8,20
19,8482155,Alex Laferriere,R,LAK,23,82,11,9,20
19,8480813,Joe Veleno,C,DET,24,82,10,10,20
19,8476419,Jean-Gabriel Pageau,C,NYI,32,82,9,11,20
19,8479390,Taylor Raddysh,R,CHI,26,82,9,11,20
19,8476927,Teddy Blueger,C,VAN,30,82,7,13,20
19,8481553,Bobby Brink,R,PHI,23,82,7,13,20
19,8475233,David Savard,D,MTL,34,82,6,14,20
19,8483565,Nick Blankenburg,D,CBJ,26,82,6,14,20
19,8480336,Sean Walker,D,COL,30,82,5,15,20
19,8478840,Will Borgen,D,SEA,28,82,4,16,20
19,8475279,Ben Chiarot,D,DET,33,82,3,17,20
19,8483471,Brad Lambert,C,WPG,31,82,2,18,20
19,8482142,Jamie Drysdale,D,PHI,22,82,2,18,20
19,8479398,Samuel Girard,D,COL,26,82,1,19,20
19,8476891,Matt Grzelcyk,D,BOS,30,82,1,19,20
19,8476331,Dylan DeMelo,D,WPG,31,82,0,20,20
19,8482737,Zack Bolduc,C,STL,21,82,12,7,19
19,8484203,Bradly Nadeau,L,CAR,19,82,10,9,19
19,8473504,Cal Clutterbuck,R,NYI,37,82,9,10,19
19,8476858,Phillip Di Giuseppe,L,VAN,31,82,8,11,19
19,8475164,Jakob Silfverberg,R,ANA,34,82,8,11,19
19,8476525,Colin Miller,D,WPG,32,82,8,11,19
19,8481013,Jonatan Berggren,R,DET,24,82,7,12,19
19,8478430,Oliver Kylington,D,CGY,27,82,7,12,19
19,8482762,Simon Edvinsson,D,DET,21,82,6,13,19
19,8478443,Brandon Carlo,D,BOS,28,82,5,14,19
19,8479291,Kevin Rooney,C,CGY,31,82,5,14,19
19,8475324,Nick Jensen,D,WSH,34,82,4,15,19
19,8480448,Parker Kelly,L,OTT,25,82,3,16,19
19,8481522,Peyton Krebs,C,BUF,23,82,3,16,19
19,8480074,Alexandre Texier,C,CBJ,25,82,10,8,18
19,8484145,Zach Benson,L,BUF,19,82,9,9,18
19,8470610,Zach Parise,L,COL,40,82,9,9,18
19,8477507,Nikita Zadorov,D,VAN,29,82,7,11,18
19,8479998,Mikey Anderson,D,LAK,25,82,6,12,18
19,8482111,Justin Barron,D,MTL,23,82,6,12,18
19,8478500,Ivan Provorov,D,CBJ,27,82,4,14,18
19,8480879,Jacob Bernard-Docker,D,OTT,24,82,4,14,18
19,8483490,Pavel Mintyukov,D,ANA,21,82,4,14,18
19,8473507,Jeff Petry,D,DET,37,82,4,14,18
19,8479353,Brett Howden,C,VGK,26,82,3,15,18
19,8483495,Simon Nemec,D,NJD,20,82,3,15,18
19,8481178,Egor Zamula,D,PHI,24,82,3,15,18
19,8480035,Henri Jokiharju,D,BUF,25,82,3,15,18
19,8476312,Josh Manson,D,COL,33,82,2,16,18
19,8475179,Dmitry Kulikov,D,FLA,34,82,1,17,18
19,8477508,Curtis Lazar,C,NJD,29,82,8,9,17
19,8475842,Sam Carrick,C,EDM,32,82,7,10,17
19,8476457,Adam Larsson,D,SEA,32,82,6,11,17
19,8481186,Logan O'Connor,R,COL,28,82,6,11,17
19,8476422,Mike Reilly,D,NYI,31,82,6,11,17
19,8482166,Shakir Mukhamadullin,D,SJS,22,82,5,12,17
19,8474009,Nick Bonino,C,NYR,36,82,5,12,17
19,8476467,Jamie Oleksiak,D,SEA,32,82,4,13,17
19,8476879,Cody Ceci,D,EDM,31,82,4,13,17
19,8479324,Ryan Lindgren,D,NYR,26,82,3,14,17
19,8481568,Alex Vlasic,D,CHI,23,82,3,14,17
19,8470600,Ryan Suter,D,DAL,39,82,3,14,17
19,8475690,Chris Tanev,D,DAL,35,82,2,15,17
19,8477353,Tyler Motte,C,TBL,29,82,8,8,16
19,8483012,Logan Morrison,C,SEA,22,82,7,9,16
19,8480806,Isac Lundestrom,C,ANA,25,82,7,9,16
19,8476374,Sean Kuraly,C,CBJ,31,82,7,9,16
19,8477839,Conor Sheary,L,TBL,32,82,6,10,16
19,8477392,Hudson Fasching,R,NYI,29,82,6,10,16
19,8482730,Brandt Clarke,D,LAK,21,82,4,12,16
19,8477406,Mattias Janmark,C,EDM,32,82,3,13,16
19,8481567,Henry Thrun,D,SJS,23,82,1,15,16
19,8481580,Connor McMichael,C,WSH,23,82,8,7,15
19,8475762,Derek Forbort,D,BOS,32,82,7,8,15
19,8476822,Luke Glendening,C,TBL,35,82,7,8,15
19,8474034,Pat Maroon,L,BOS,36,82,5,10,15
19,8478451,Ethan Bear,D,WSH,27,82,5,10,15
19,8477365,Connor Clifton,D,BUF,29,82,5,10,15
19,8479442,Troy Stecher,D,EDM,30,82,5,10,15
19,8477499,Rasmus Ristolainen,D,PHI,30,82,4,11,15
19,8479980,Nicolas Hague,D,VGK,26,82,4,11,15
19,8477369,Carson Soucy,D,VAN,30,82,4,11,15
19,8476967,Brett Kulak,D,EDM,30,82,3,12,15
19,8476372,Nick Seeler,D,PHI,31,82,3,12,15
19,8475790,Erik Gudbranson,D,CBJ,32,82,2,13,15
19,8476429,Scott Mayfield,D,NYI,32,82,2,13,15
19,8476392,Adam Lowry,C,WPG,31,82,7,7,14
19,8471677,Jack Johnson,D,COL,37,82,7,7,14
19,8481524,Bowen Byram,D,BUF,23,82,6,8,14
19,8483466,Kevin Korchinski,D,CHI,20,82,6,8,14
19,8478831,Kevin Stenlund,C,FLA,28,82,6,8,14
19,8483763,Maksymilian Szuber,D,ARI,22,82,6,8,14
19,8482712,Oskar Olausson,R,COL,22,82,5,9,14
19,8474574,Tyler Myers,D,VAN,34,82,5,9,14
19,8474013,Ian Cole,D,VAN,35,82,5,9,14
19,8482666,Scott Morrow,D,CAR,22,82,5,9,14
19,8480796,Martin Fehervary,D,WSH,25,82,4,10,14
19,8477220,Nate Schmidt,D,WPG,33,82,4,10,14
19,8480058,Pierre-Olivier Joseph,D,PIT,25,82,4,10,14
19,8481605,Jackson LaCombe,D,ANA,23,82,3,11,14
19,8480860,Kevin Bahl,D,NJD,24,82,3,11,14
19,8477845,Trevor van Riemsdyk,D,WSH,33,82,2,12,14
19,8474567,Zach Bogosian,D,MIN,34,82,0,14,14
19,8478043,Sam Lafferty,C,VAN,29,82,5,8,13
19,8477505,Alexander Wennberg,C,NYR,30,82,4,9,13
19,8476442,Matt Nieto,L,PIT,32,82,4,9,13
19,8482470,Ilya Solovyov,D,CGY,24,82,3,10,13
19,8480807,Mattias Samuelsson,D,BUF,24,82,3,10,13
19,8482177,Marat Khusnutdinov,C,MIN,22,82,3,10,13
19,8478416,Erik Cernak,D,TBL,27,82,2,11,13
19,8484911,Collin Graf,R,SJS,22,82,6,6,12
19,8478859,Niko Mikkola,D,FLA,28,82,3,9,12
19,8475177,Calvin de Haan,D,TBL,33,82,3,9,12
19,8482807,Ethan Del Mastro,D,CHI,21,82,3,9,12
19,8481059,Scott Perunovich,D,STL,26,82,1,11,12
19,8475188,Brayden McNabb,D,VGK,33,82,1,11,12
19,8481030,Jack St. Ivany,D,PIT,25,82,0,12,12
19,8477015,Connor Brown,R,EDM,30,82,8,3,11
19,8482809,Jackson Blake,R,CAR,21,82,6,5,11
19,8482516,Matthew Kessel,D,STL,24,82,4,7,11
19,8476878,Zemgus Girgensons,L,BUF,30,82,3,8,11
19,8474166,Alec Martinez,D,VGK,37,82,2,9,11
19,8477931,Tomas Nosek,L,NJD,32,82,2,9,11
19,8470966,Mark Giordano,D,TOR,41,82,2,9,11
19,8480834,Ty Emberson,D,SJS,24,82,1,10,11
19,8476473,Connor Murphy,D,CHI,31,82,0,11,11
19,8482858,Ryker Evans,D,SEA,23,82,2,8,10
19,8477034,Jaycob Megna,D,CHI,32,82,2,8,10
19,8482713,Mackie Samoskevich,R,FLA,22,82,2,8,10
19,8475825,Jani Hakanpää,D,DAL,32,82,1,9,10
19,8483489,Fraser Minten,C,TOR,31,82,8,1,9
19,8480990,Declan Chisholm,D,MIN,24,82,3,6,9
19,8482803,Olen Zellweger,D,ANA,21,82,2,7,9
19,8476915,Jujhar Khaira,L,MIN,30,82,5,3,8
19,8478408,Travis Dermott,D,ARI,28,82,4,4,8
19,8481578,Graeme Clarke,R,NJD,23,82,3,5,8
19,8477335,Kyle Burroughs,D,SJS,29,82,1,7,8
19,8482859,Zack Ostapchuk,C,OTT,21,82,1,6,7
19,8481599,Victor Soderstrom,D,ARI,23,82,2,4,6
19,8484149,Gavin Brindley,C,CBJ,20,82,2,4,6
19,8483468,Jiri Kulich,C,BUF,20,82,0,6,6
19,8482141,Lukas Cormier,D,VGK,22,0,0,0,0
19,8476988,Matt Benning,D,SJS,30,0,0,0,0
19,8480727,Zach Whitecloud,D,VGK,28,0,0,0,0
19,8480887,Jordan Harris,D,MTL,24,0,0,0,0
19,8478450,Parker Wotherspoon,D,BOS,27,0,0,0,0
19,8481812,Nikolai Knyzhov,D,SJS,27,0,0,0,0
19,8480001,Urho Vaakanainen,D,ANA,25,0,0,0,0
19,8482176,Wyatt Kaiser,D,CHI,22,0,0,0,0
19,8481122,Simon Benoit,D,TOR,26,0,0,0,0
19,8476441,Joel Edmundson,D,TOR,31,0,0,0,0
19,8480884,Calen Addison,D,SJS,24,0,0,0,0
19,8482511,Mason Lohrei,D,BOS,23,0,0,0,0
19,8482192,Isaak Phillips,D,CHI,23,0,0,0,0
19,8480950,Ilya Lyubushkin,D,TOR,30,0,0,0,0
19,8474031,Kevin Shattenkirk,D,BOS,35,0,0,0,0
19,8475718,Justin Holl,D,DET,32,0,0,0,0
19,8479402,Jake Bean,D,CBJ,26,0,0,0,0
19,8474602,Justin Schultz,D,SEA,34,0,0,0,0
19,8477950,Tony DeAngelo,D,CAR,29,0,0,0,0
19,8481743,Marc Del Gaizo,D,NSH,25,0,0,0,0
19,8481527,Kaedan Korczak,D,VGK,23,0,0,0,0
19,8480192,Johnathan Kovacevic,D,MTL,27,0,0,0,0
19,8476874,Olli Maatta,D,DET,30,0,0,0,0
19,8482144,Jack Thompson,D,SJS,22,0,0,0,0
19,8480222,Sebastian Aho,D,NYI,28,0,0,0,0
19,8479458,Nikita Zaitsev,D,CHI,33,0,0,0,0
19,8471709,Marc-Edouard Vlasic,D,SJS,37,0,0,0,0
19,8482929,Emil Lilleberg,D,TBL,23,0,0,0,0
19,8477018,Ben Hutton,D,VGK,31,0,0,0,0
19,8481056,Spencer Stastney,D,NSH,24,0,0,0,0
19,8481593,Jayden Struble,D,MTL,23,0,0,0,0
19,8479982,Conor Timmins,D,TOR,26,0,0,0,0
19,8474090,Brendan Smith,D,NJD,35,0,0,0,0
19,8482964,Arber Xhekaj,D,MTL,23,0,0,0,0
19,8480891,Michael Kesselring,D,ARI,24,0,0,0,0
19,8477938,Haydn Fleury,D,TBL,28,0,0,0,0
19,8481806,Louis Crevier,D,CHI,23,0,0,0,0
19,8471274,Alex Goligoski,D,MIN,39,0,0,0,0
19,8481600,Tobias Bjornfot,D,FLA,23,0,0,0,0
19,8475797,Jarred Tinordi,D,CHI,32,0,0,0,0
19,8481521,Ronnie Attard,D,PHI,25,0,0,0,0
19,8474612,Travis Hamonic,D,OTT,34,0,0,0,0
19,8479576,Vincent Desharnais,D,EDM,28,0,0,0,0
19,8480049,Dylan Samberg,D,WPG,25,0,0,0,0
19,8483619,Filip Roos,D,CHI,25,0,0,0,0
19,8474568,Luke Schenn,D,NSH,35,0,0,0,0
19,8480184,Gustav Lindstrom,D,ANA,26,0,0,0,0
19,8480070,Ian Mitchell,D,BOS,25,0,0,0,0
19,8480196,Jacob Bryson,D,BUF,27,0,0,0,0
19,8471686,Marc Staal,D,PHI,37,0,0,0,0
19,8477467,Gustav Olofsson,D,SEA,30,0,0,0,0
19,8478970,Jalen Chatfield,D,CAR,28,0,0,0,0
19,8479348,Kale Clague,D,BUF,26,0,0,0,0
19,8473446,Erik Johnson,D,PHI,36,0,0,0,0
19,8477462,Robert Hagg,D,ANA,29,0,0,0,0
19,8478454,Noah Juulsen,D,VAN,27,0,0,0,0
19,8477384,Josh Brown,D,ARI,30,0,0,0,0
19,8481708,Zac Jones,D,NYR,24,0,0,0,0
19,8481167,Brayden Pachal,D,CGY,25,0,0,0,0
19,8482067,Connor Mackey,D,NYR,28,0,0,0,0
19,8483460,David Jiricek,D,CBJ,21,0,0,0,0
19,8481701,Santeri Hatakka,D,NJD,23,0,0,0,0
19,8478021,William Lagesson,D,ANA,28,0,0,0,0
19,8477851,Jordan Oesterle,D,CGY,32,0,0,0,0
19,8478452,Caleb Jones,D,COL,27,0,0,0,0
19,8479984,Cal Foote,D,NJD,26,0,0,0,0
19,8479639,Dylan Coghlan,D,CAR,26,0,0,0,0
19,8480874,Adam Ginning,D,PHI,24,0,0,0,0
19,8479321,Lucas Johansen,D,WSH,27,0,0,0,0
19,8480878,Nils Lundkvist,D,DAL,24,0,0,0,0
19,8482165,Yan Kuznetsov,D,CGY,22,0,0,0,0
19,8484258,Sam Malinski,D,COL,26,0,0,0,0
19,8480157,Calle Rosen,D,STL,30,0,0,0,0
19,8484304,Uvis Balinskis,D,FLA,28,0,0,0,0
19,8479985,Cale Fleury,D,SEA,26,0,0,0,0
19,8479378,Logan Stanley,D,WPG,26,0,0,0,0
19,8477541,Dakota Mermis,D,MIN,30,0,0,0,0
19,8481609,Vladislav Kolyachonok,D,ARI,23,0,0,0,0
19,8480823,Alexander Alexeyev,D,WSH,25,0,0,0,0
19,8481679,Maxence Guenette,D,OTT,23,0,0,0,0
19,8481564,Ryan Johnson,D,BUF,23,0,0,0,0
19,8479376,Victor Mete,D,PHI,26,0,0,0,0
19,8484254,Akito Hirose,D,VAN,25,0,0,0,0
19,8482660,Kent Johnson,C,CBJ,22,0,0,0,0
19,8482149,Cole Perfetti,C,WPG,22,0,0,0,0
19,8477987,Ryan Donato,C,CHI,28,0,0,0,0
19,8475755,Alexander Petrovic,D,DAL,32,0,0,0,0
19,8477810,Joel Hanley,D,CGY,33,0,0,0,0
19,8474145,Robert Bortuzzo,D,NYI,35,0,0,0,0
19,8481161,Jake Christiansen,D,CBJ,25,0,0,0,0
19,8476884,Derrick Pouliot,D,DAL,30,0,0,0,0
19,8481716,Dmitri Voronkov,L,CBJ,24,0,0,0,0
19,8480084,Nick DeSimone,D,NJD,30,0,0,0,0
19,8475750,Jon Merrill,D,MIN,32,0,0,0,0
19,8479315,Joey Anderson,R,CHI,26,0,0,0,0
19,8478011,Louie Belpedio,D,PHI,28,0,0,0,0
19,8482451,Mikael Pyyhtia,L,CBJ,23,0,0,0,0
19,8481541,Samuel Bolduc,D,NYI,24,0,0,0,0
19,8482126,Emil Andrae,D,PHI,31,0,0,0,0
19,8474618,Marco Scandella,D,STL,34,0,0,0,0
19,8477244,Chad Ruhwedel,D,NYR,34,0,0,0,0
19,8477971,Andreas Englund,D,LAK,28,0,0,0,0
19,8480829,Jesperi Kotkaniemi,C,CAR,24,0,0,0,0
19,8479372,Josh Mahura,D,FLA,26,0,0,0,0
19,8482095,Tyler Kleven,D,OTT,22,0,0,0,0
19,8481719,Maxwell Crozier,D,TBL,24,0,0,0,0
19,8475855,Jesper Fast,R,CAR,33,0,0,0,0
19,8480848,Ty Dellandrea,C,DAL,24,0,0,0,0
19,8475193,Tomas Tatar,L,SEA,34,0,0,0,0
19,8476889,Radek Faksa,C,DAL,30,0,0,0,0
19,8478495,Denis Gurianov,R,PHI,27,0,0,0,0
19,8480216,Jacob Peterson,C,SJS,25,0,0,0,0
19,8480252,Cole Guttman,C,CHI,25,0,0,0,0
19,8479026,Philippe Myers,D,TBL,27,0,0,0,0
19,8481006,Tyler Tucker,D,STL,24,0,0,0,0
19,8481032,Paul Cotter,C,VGK,25,0,0,0,0
19,8481577,Philip Tomasino,C,NSH,23,0,0,0,0
19,8476918,Jimmy Vesey,L,NYR,31,0,0,0,0
19,8479320,Max Lajoie,D,TOR,27,0,0,0,0
19,8478017,Mark Friedman,D,VAN,29,0,0,0,0
19,8481754,Nikita Nesterenko,C,ANA,23,0,0,0,0
19,8483407,Brandon Scanlin,D,NYR,25,0,0,0,0
19,8482659,Josh Doan,R,ARI,22,0,0,0,0
19,8477446,Michael McCarron,R,NSH,29,0,0,0,0
19,8477903,Garnet Hathaway,R,PHI,33,0,0,0,0
19,8482153,Brendan Brisson,C,VGK,23,0,0,0,0
19,8483546,Marshall Rifai,D,TOR,26,0,0,0,0
19,8484287,Cole McWard,D,VAN,23,0,0,0,0
19,8478854,Ryan Shea,D,PIT,27,0,0,0,0
19,8481585,Egor Afanasyev,L,NSH,23,0,0,0,0
19,8483398,Declan Carlile,D,TBL,31,0,0,0,0
19,8478502,Dennis Gilbert,D,CGY,28,0,0,0,0
19,8482749,Joshua Roy,R,MTL,21,0,0,0,0
19,8481598,Philip Broberg,D,EDM,23,0,0,0,0
19,8480835,Jack Drury,C,CAR,24,0,0,0,0
19,8480748,Kiefer Sherwood,L,NSH,29,0,0,0,0
19,8476934,Brock McGinn,L,ANA,30,0,0,0,0
19,8480870,Bo Groulx,C,ANA,24,0,0,0,0
19,8479368,Max Jones,L,ANA,26,0,0,0,0
19,8478099,Kevin Labanc,R,SJS,29,0,0,0,0
19,8478067,Oskar Lindblom,L,SJS,28,0,0,0,0
19,8476393,Nick Cousins,C,FLA,31,0,0,0,0
19,8483395,Arshdeep Bains,L,VAN,23,0,0,0,0
19,8480762,Eric Robinson,L,BUF,29,0,0,0,0
19,8479439,Jacob MacDonald,D,SJS,31,0,0,0,0
19,8476474,Stefan Noesen,R,CAR,31,0,0,0,0
19,8482787,Nikita Chibrikov,R,WPG,31,0,0,0,0
19,8478432,Christian Fischer,R,DET,27,0,0,0,0
19,8477979,Nicolas Aube-Kubel,R,WSH,28,0,0,0,0
19,8481789,Tye Kartye,L,SEA,23,0,0,0,0
19,8479330,Brandon Gignac,C,MTL,27,0,0,0,0
19,8480075,Cameron Crotty,D,ARI,25,0,0,0,0
19,8473473,Milan Lucic,L,BOS,36,0,0,0,0
19,8482094,Daemon Hunt,D,MIN,22,0,0,0,0
19,8481206,John Ludvig,D,PIT,24,0,0,0,0
19,8483630,Pavol Regenda,L,ANA,25,0,0,0,0
19,8481617,Vasily Podkolzin,R,VAN,23,0,0,0,0
19,8480306,Grant Hutton,D,NYI,29,0,0,0,0
19,8480995,Pontus Holmberg,R,TOR,25,0,0,0,0
19,8482148,Hendrix Lapierre,C,WSH,22,0,0,0,0
19,8477478,William Carrier,L,VGK,30,0,0,0,0
19,8480003,Jesper Boqvist,C,BOS,26,0,0,0,0
19,8482172,Landon Slaggert,L,CHI,22,0,0,0,0
19,8480789,Oliver Wahlstrom,R,NYI,24,0,0,0,0
19,8474062,Riley Nash,C,NYR,35,0,0,0,0
19,8480021,Jack Studnicka,C,SJS,25,0,0,0,0
19,8480025,MacKenzie Entwistle,R,CHI,25,0,0,0,0
19,8481582,Nicholas Robertson,L,TOR,23,0,0,0,0
19,8476867,Brendan Gaunce,C,CBJ,30,0,0,0,0
19,8479619,Michael Carcone,L,ARI,28,0,0,0,0
19,8479370,Tyson Jost,C,BUF,26,0,0,0,0
19,8479671,Mathieu Olivier,R,CBJ,27,0,0,0,0
19,8476994,Vinnie Hinostroza,C,PIT,30,0,0,0,0
19,8482070,Mitchell Chaffee,R,TBL,26,0,0,0,0
19,8477473,Justin Bailey,R,SJS,29,0,0,0,0
19,8479344,Jesse Puljujarvi,R,PIT,26,0,0,0,0
19,8480205,Emil Bemstrom,C,PIT,25,0,0,0,0
19,8479718,Alex Barré-Boulet,C,TBL,27,0,0,0,0
19,8482061,Brandon Biro,L,BUF,26,0,0,0,0
19,8479638,Justin Brazeau,R,BOS,26,0,0,0,0
19,8474040,Sam Gagner,C,EDM,35,0,0,0,0
19,8477846,Ryan Carpenter,C,SJS,33,0,0,0,0
19,8482077,Dylan Holloway,L,EDM,23,0,0,0,0
19,8482157,Will Cuylle,L,NYR,22,0,0,0,0
19,8480007,Jonas Rondbjerg,R,VGK,25,0,0,0,0
19,8478874,Adam Gaudette,C,STL,28,0,0,0,0
19,8478434,Keegan Kolesar,R,VGK,27,0,0,0,0
19,8480441,Trey Fix-Wolansky,R,CBJ,25,0,0,0,0
19,8479994,Jaret Anderson-Dolan,C,NSH,25,0,0,0,0
19,8483567,Georgii Merkulov,C,BOS,24,0,0,0,0
19,8477380,Jonny Brodzinski,C,NYR,31,0,0,0,0
19,8482201,Gage Goncalves,C,TBL,23,0,0,0,0
19,8478211,Dryden Hunt,L,CGY,29,0,0,0,0
19,8471699,Andrew Cogliano,C,COL,37,0,0,0,0
19,8479421,Jacob Moverare,D,LAK,26,0,0,0,0
19,8478881,Brett Seney,L,CHI,28,0,0,0,0
19,8477464,Nic Petan,C,MIN,29,0,0,0,0
19,8475958,Michael Sgarbossa,C,WSH,32,0,0,0,0
19,8481147,Reese Johnson,C,CHI,26,0,0,0,0
19,8479336,Carl Grundstrom,R,LAK,27,0,0,0,0
19,8480853,Liam Foudy,C,NSH,24,0,0,0,0
19,8479522,Hardy Haman Aktell,D,WSH,26,0,0,0,0
19,8481462,Mason Morelli,L,VGK,28,0,0,0,0
19,8482102,Vasily Ponomarev,C,CAR,22,0,0,0,0
19,8480844,Grigori Denisenko,L,VGK,24,0,0,0,0
19,8479944,Zach Aston-Reese,C,DET,30,0,0,0,0
19,8482784,Zach Dean,C,STL,21,0,0,0,0
19,8479419,Brett Murray,L,BUF,26,0,0,0,0
19,8479520,Brandon Duhaime,R,COL,27,0,0,0,0
19,8477573,Nathan Walker,L,STL,30,0,0,0,0
19,8478078,Rourke Chartier,C,OTT,28,0,0,0,0
19,8475795,Dylan McIlrath,D,WSH,32,0,0,0,0
19,8482496,Nils Aman,C,VAN,24,0,0,0,0
19,8480289,Morgan Barron,C,WPG,26,0,0,0,0
19,8481751,Lukas Rousek,R,BUF,25,0,0,0,0
19,8480011,Klim Kostin,C,SJS,25,0,0,0,0
19,8481556,John Beecher,C,BOS,23,0,0,0,0
19,8475278,Byron Froese,C,VGK,33,0,0,0,0
19,8475225,Craig Smith,C,DAL,35,0,0,0,0
19,8484326,Patrik Koch,D,ARI,28,0,0,0,0
19,8477930,Pierre-Edouard Bellemare,L,SEA,39,0,0,0,0
19,8478409,Anthony Richard,C,BOS,28,0,0,0,0
19,8481024,Linus Karlsson,C,VAN,25,0,0,0,0
19,8479986,Kole Lind,R,SEA,26,0,0,0,0
19,8479414,Nathan Bastian,R,NJD,27,0,0,0,0
19,8479362,Riley Tufte,L,COL,26,0,0,0,0
19,8481058,Jesse Ylönen,R,MTL,25,0,0,0,0
19,8482476,Emil Heineman,L,MTL,23,0,0,0,0
19,8482861,Vincent Iorio,D,WSH,22,0,0,0,0
19,8483432,Luca Del Bel Belluz,C,CBJ,31,0,0,0,0
19,8482744,James Malatesta,L,CBJ,21,0,0,0,0
19,8477887,Patrick Brown,C,BOS,32,0,0,0,0
19,8478585,Derek Ryan,C,EDM,38,0,0,0,0
19,8481441,Joe Snively,C,WSH,28,0,0,0,0
19,8481592,Jakob Pelletier,L,CGY,23,0,0,0,0
19,8482634,Alex Steeves,C,TOR,25,0,0,0,0
19,8477126,Jayson Megna,C,BOS,34,0,0,0,0
19,8475752,Tyler Pitlick,C,NYR,33,0,0,0,0
19,8480008,Adam Ruzicka,C,ARI,25,0,0,0,0
19,8481065,Angus Crookshank,L,OTT,25,0,0,0,0
19,8479547,Matthew Phillips,R,WSH,26,0,0,0,0
19,8480226,Marián Studenic,R,SEA,26,0,0,0,0
19,8481237,Kyle MacLean,C,NYI,25,0,0,0,0
19,8475413,Justin Dowling,C,NJD,34,0,0,0,0
19,8481641,Joel Kiviranta,L,COL,28,0,0,0,0
19,8478104,Sammy Blais,L,STL,28,0,0,0,0
19,8477454,Adam Erne,L,EDM,29,0,0,0,0
19,8481518,Nolan Foote,L,NJD,24,0,0,0,0
19,8480245,Olle Lycksell,R,PHI,25,0,0,0,0
19,8483570,Ben Meyers,C,ANA,26,0,0,0,0
19,8480776,Sheldon Rempal,R,VGK,29,0,0,0,0
19,8483920,Pierrick Dube,R,WSH,23,0,0,0,0
19,8480267,Sammy Walker,C,MIN,25,0,0,0,0
19,8482747,Brennan Othmann,L,NYR,21,0,0,0,0
19,8479991,Jake Leschyshyn,C,NYR,25,0,0,0,0
19,8478400,Colin White,C,MTL,27,0,0,0,0
19,8479328,Julien Gauthier,R,NYI,27,0,0,0,0
19,8484325,Waltteri Merela,C,TBL,26,0,0,0,0
19,8479066,Ryan Lomberg,L,FLA,30,0,0,0,0
19,8477070,Liam O'Brien,C,ARI,30,0,0,0,0
19,8478146,Matthew Highmore,C,OTT,28,0,0,0,0
19,8478028,Fredrik Olofsson,L,COL,28,0,0,0,0
19,8480880,Jakub Lauko,C,BOS,24,0,0,0,0
19,8479968,Vinni Lettieri,C,MIN,29,0,0,0,0
19,8474709,Matt Martin,L,NYI,35,0,0,0,0
19,8480845,Rasmus Kupari,C,WPG,24,0,0,0,0
19,8481550,Adam Beckman,L,MIN,23,0,0,0,0
19,8481422,Jacob Lucchini,C,MIN,29,0,0,0,0
19,8477401,John Hayden,C,SEA,29,0,0,0,0
19,8478904,Steven Lorentz,C,FLA,28,0,0,0,0
19,8482088,Justin Sourdif,R,FLA,22,0,0,0,0
19,8482751,Ryan Winterton,C,SEA,21,0,0,0,0
19,8482241,Radim Zohorna,L,PIT,28,0,0,0,0
19,8481690,Tyler Angle,C,CBJ,24,0,0,0,0
19,8476952,Dominic Toninato,C,WPG,30,0,0,0,0
19,8476919,Chris Tierney,C,NJD,30,0,0,0,0
19,8480032,Shane Bowers,C,NJD,25,0,0,0,0
19,8484314,Jiri Smejkal,L,OTT,28,0,0,0,0
19,8481239,Samuel Fagemo,L,LAK,24,0,0,0,0
19,8481532,Alex Turcotte,C,LAK,23,0,0,0,0
19,8481019,David Gustafsson,C,WPG,24,0,0,0,0
19,8478477,Mitchell Stephens,C,MTL,27,0,0,0,0
19,8479546,Oskar Steen,C,BOS,26,0,0,0,0
19,8480292,Carson Meyer,R,CBJ,27,0,0,0,0
19,8478446,Glenn Gawdin,C,ANA,27,0,0,0,0
19,8483531,Brian Halonen,L,NJD,25,0,0,0,0
19,8477149,Scott Sabourin,R,SJS,32,0,0,0,0
19,8479972,Mason Shaw,C,MIN,26,0,0,0,0
19,8480890,Jan Jenik,R,ARI,24,0,0,0,0
19,8478051,Max Willman,C,NJD,29,0,0,0,0
19,8480851,Akil Thomas,C,LAK,24,0,0,0,0
19,8482765,Isak Rosen,R,BUF,21,0,0,0,0
19,8478421,A.J. Greer,L,CGY,28,0,0,0,0
19,8478512,Austin Czarnik,C,DET,32,0,0,0,0
19,8479536,Axel Jonsson-Fjallby,L,WPG,26,0,0,0,0
19,8477320,Anton Blidh,L,NYR,29,0,0,0,0
19,8481543,Nikita Alexandrov,C,STL,24,0,0,0,0
19,8475235,Nicolas Deslauriers,L,PHI,33,0,0,0,0
19,8481070,Hugh McGing,L,STL,26,0,0,0,0
19,8480836,Jonathan Gruden,C,PIT,24,0,0,0,0
19,8481591,Sam Poulin,R,PIT,23,0,0,0,0
19,8477962,Brendan Lemieux,L,CAR,28,0,0,0,0
19,8483401,Marc Johnstone,R,PIT,28,0,0,0,0
19,8482250,Callahan Burke,C,CAR,27,0,0,0,0
19,8481726,Adam Edstrom,C,NYR,24,0,0,0,0
19,8471817,Ryan Reaves,R,TOR,37,0,0,0,0
19,8479587,Rhett Gardner,C,PHI,28,0,0,0,0
19,8475766,Austin Watson,L,TBL,32,0,0,0,0
19,8479367,William Lockwood,R,FLA,26,0,0,0,0
19,8478424,Jansen Harkins,C,PIT,27,0,0,0,0
19,8476913,Devin Shore,C,SEA,30,0,0,0,0
19,8482652,Walker Duehr,R,CGY,27,0,0,0,0
19,8477527,Ross Johnston,L,ANA,30,0,0,0,0
19,8481077,John Leonard,L,ARI,26,0,0,0,0
19,8483549,Lucas Condotta,L,MTL,27,0,0,0,0
19,8480468,James Hamblin,L,EDM,25,0,0,0,0
19,8476907,Mackenzie MacEachern,L,STL,30,0,0,0,0
19,8479543,Michael Pezzetta,L,MTL,26,0,0,0,0
19,8480355,Mark Kastelic,C,OTT,25,0,0,0,0
19,8482162,Roby Jarventie,L,OTT,22,0,0,0,0
19,8479772,Zack MacEwen,R,OTT,28,0,0,0,0
19,8483597,Milos Kelemen,L,ARI,25,0,0,0,0
19,8479379,Givani Smith,R,SJS,26,0,0,0,0
19,8481655,Cole Schwindt,R,CGY,23,0,0,0,0
19,8479981,Jonah Gadjovich,L,FLA,26,0,0,0,0
19,8482147,Jean-Luc Foudy,C,COL,22,0,0,0,0
19,8484255,Jason Polin,R,COL,25,0,0,0,0
19,8477993,Justin Kirkland,C,ARI,28,0,0,0,0
19,8479249,Andrew Poturalski,C,SEA,30,0,0,0,0
19,8482197,Adam Raska,R,MIN,23,0,0,0,0
19,8475780,Chris Wagner,R,COL,33,0,0,0,0
19,8479533,Joona Koppanen,L,PIT,26,0,0,0,0
19,8481534,Raphael Lavoie,C,EDM,24,0,0,0,0
19,8484321,Nikolas Matinpalo,D,OTT,26,0,0,0,0
19,8481043,Cole Koepke,L,TBL,26,0,0,0,0
19,8476323,Max McCormick,L,SEA,32,0,0,0,0
19,8483609,Adam Klapka,R,CGY,24,0,0,0,0
19,8483512,Matt Savoie,C,BUF,20,0,0,0,0
19,8484259,Ondrej Pavel,C,COL,31,0,0,0,0
19,8478147,Bokondji Imama,L,OTT,28,0,0,0,0
19,8482460,Matt Rempe,C,NYR,22,0,0,0,0
19,8477073,Kurtis MacDermid,L,NJD,30,0,0,0,0
19,8480274,Philip Kemp,D,EDM,25,0,0,0,0
19,8478956,Samuel Laberge,L,NJD,27,0,0,0,0
19,8483045,Cameron Butler,R,CBJ,31,0,0,0,0
20,8476453,Nikita Kucherov,R,TBL,31,82,40,83,123
20,8478402,Connor McDavid,C,EDM,27,82,26,91,117
20,8477934,Leon Draisaitl,C,EDM,29,82,40,63,103
20,8476887,Filip Forsberg,L,NSH,30,82,56,46,102
20,8471675,Sidney Crosby,C,PIT,37,82,38,64,102
20,8479318,Auston Matthews,C,TOR,27,82,60,39,99
20,8478550,Artemi Panarin,L,NYR,33,82,43,55,98
20,8478864,Kirill Kaprizov,L,MIN,27,82,45,50,95
20,8474564,Steven Stamkos,C,TBL,34,82,42,53,95
20,8478010,Brayden Point,C,TBL,28,82,45,46,91
20,8481559,Jack Hughes,C,NJD,23,82,39,51,90
20,8476346,Johnny Gaudreau,L,CBJ,31,82,17,73,90
20,8477956,David Pastrnak,R,BOS,28,82,35,52,87
20,8480069,Cale Makar,D,COL,26,82,20,67,87
20,8480027,Jason Robertson,L,DAL,25,82,34,52,86
20,8478493,Joel Eriksson Ek,C,MIN,27,82,39,46,85
20,8478427,Sebastian Aho,C,CAR,27,82,36,49,85
20,8478445,Mathew Barzal,C,NYI,27,82,26,59,85
20,8474600,Roman Josi,D,NSH,34,82,20,64,84
20,8481557,Matt Boldy,L,MIN,23,82,32,51,83
20,8479314,Matthew Tkachuk,L,FLA,27,82,31,52,83
20,8479343,Clayton Keller,R,ARI,26,82,27,53,80
20,8477939,William Nylander,R,TOR,28,82,22,58,80
20,8477933,Sam Reinhart,C,FLA,29,82,55,24,79
20,8478439,Travis Konecny,R,PHI,27,82,36,42,78
20,8477492,Nathan MacKinnon,C,COL,29,82,29,49,78
20,8477940,Nikolaj Ehlers,L,WPG,28,82,26,51,77
20,8480800,Quinn Hughes,D,VAN,25,82,12,64,76
20,8480801,Brady Tkachuk,L,OTT,25,82,33,42,75
20,8478047,Michael Bunting,L,PIT,29,82,33,42,75
20,8478420,Mikko Rantanen,R,COL,28,82,37,37,74
20,8477404,Jake Guentzel,C,CAR,30,82,31,43,74
20,8478414,Timo Meier,R,NJD,28,82,36,37,73
20,8480012,Elias Pettersson,C,VAN,26,82,27,46,73
20,8479407,Jesper Bratt,L,NJD,26,82,23,50,73
20,8480002,Nico Hischier,C,NJD,25,82,23,50,73
20,8473419,Brad Marchand,L,BOS,36,82,25,47,72
20,8476468,J.T. Miller,C,VAN,31,82,22,50,72
20,8477402,Pavel Buchnevich,L,STL,29,82,34,37,71
20,8480023,Robert Thomas,C,STL,25,82,22,49,71
20,8477951,Nick Schmaltz,C,ARI,28,82,29,41,70
20,8475786,Zach Hyman,L,EDM,32,82,40,29,69
20,8471215,Evgeni Malkin,C,PIT,38,82,32,37,69
20,8476460,Mark Scheifele,C,WPG,31,82,28,41,69
20,8478398,Kyle Connor,L,WPG,28,82,37,31,68
20,8475810,Bryan Rust,R,PIT,32,82,31,37,68
20,8478440,Dylan Strome,C,WSH,27,82,27,41,68
20,8481533,Trevor Zegras,C,ANA,23,82,25,43,68
20,8477493,Aleksander Barkov,C,FLA,29,82,24,44,68
20,8476456,Jonathan Huberdeau,C,CGY,31,82,23,45,68
20,8475184,Chris Kreider,L,NYR,33,82,45,22,67
20,8477946,Dylan Larkin,C,DET,28,82,33,34,67
20,8479420,Tage Thompson,C,BUF,27,82,28,39,67
20,8476459,Mika Zibanejad,C,NYR,31,82,24,43,67
20,8480830,Andrei Svechnikov,R,CAR,24,82,23,44,67
20,8480865,Noah Dobson,D,NYI,24,82,20,47,67
20,8477504,Josh Morrissey,D,WPG,29,82,11,56,67
20,8481523,Kirby Dach,C,MTL,23,82,10,57,67
20,8477500,Bo Horvat,C,NYI,29,82,39,27,66
20,8475726,Tyler Toffoli,C,WPG,32,82,32,34,66
20,8482116,Tim Stützle,C,OTT,22,82,25,41,66
20,8479323,Adam Fox,D,NYR,26,82,15,51,66
20,8480018,Nick Suzuki,C,MTL,25,82,25,40,65
20,8477496,Elias Lindholm,C,VAN,30,82,35,29,64
20,8477949,Alex Tuch,R,BUF,28,82,30,34,64
20,8475172,Nazem Kadri,C,CGY,34,82,29,35,64
20,8475166,John Tavares,C,TOR,34,82,31,32,63
20,8479385,Jordan Kyrou,C,STL,26,82,28,35,63
20,8478444,Brock Boeser,R,VAN,27,82,26,37,63
20,8478438,Tommy Novak,C,NSH,27,82,23,40,63
20,8477942,Kevin Fiala,L,LAK,28,82,19,44,63
20,8480839,Rasmus Dahlin,D,BUF,24,82,16,47,63
20,8471214,Alex Ovechkin,L,WSH,39,82,29,33,62
20,8473512,Claude Giroux,R,OTT,36,82,26,36,62
20,8475754,Brock Nelson,C,NYI,33,82,25,37,62
20,8475167,Victor Hedman,D,TBL,34,82,23,39,62
20,8474141,Patrick Kane,R,DET,36,82,23,39,62
20,8478407,Vince Dunn,D,SEA,28,82,13,49,62
20,8478873,Troy Terry,R,ANA,27,82,25,36,61
20,8471685,Anze Kopitar,C,LAK,37,82,23,38,61
20,8479337,Alex DeBrincat,R,DET,27,82,23,38,61
20,8482078,Lucas Raymond,L,DET,22,82,23,38,61
20,8476389,Vincent Trocheck,C,NYR,31,82,27,33,60
20,8478403,Jack Eichel,C,VGK,28,82,27,33,60
20,8480015,Owen Tippett,R,PHI,25,82,25,35,60
20,8477960,Adrian Kempe,R,LAK,28,82,25,35,60
20,8478449,Roope Hintz,C,DAL,28,82,28,31,59
20,8480208,Drake Batherson,R,OTT,26,82,25,34,59
20,8476880,Tom Wilson,R,WSH,30,82,24,35,59
20,8475158,Ryan O'Reilly,C,NSH,33,82,21,38,59
20,8480014,Gabriel Vilardi,C,WPG,25,82,37,21,58
20,8481540,Cole Caufield,R,MTL,23,82,29,29,58
20,8475784,Jeff Skinner,C,BUF,32,82,27,31,58
20,8480803,Evan Bouchard,D,EDM,25,82,14,44,58
20,8477955,Jared McCann,L,SEA,28,82,31,26,57
20,8478233,Andrew Mangiapane,L,CGY,28,82,27,30,57
20,8476881,Tomas Hertl,C,VGK,31,82,24,33,57
20,8479542,Brandon Hagel,L,TBL,26,82,22,35,57
20,8476462,Dougie Hamilton,D,NJD,31,82,20,37,57
20,8470794,Joe Pavelski,C,DAL,40,82,18,39,57
20,8475798,Mikael Granlund,C,SJS,32,82,12,45,57
20,8477501,Valeri Nichushkin,R,COL,29,82,28,28,56
20,8477409,Carter Verhaeghe,C,FLA,29,82,22,34,56
20,8480078,Filip Chytil,C,NYR,25,82,20,36,56
20,8475692,Mats Zuccarello,R,MIN,37,82,10,46,56
20,8482699,Dylan Guenther,R,ARI,21,82,29,26,55
20,8482093,Seth Jarvis,C,CAR,22,82,25,30,55
20,8478462,Nicolas Roy,C,VGK,27,82,25,30,55
20,8473994,Jamie Benn,L,DAL,35,82,23,32,55
20,8475913,Mark Stone,R,VGK,32,82,23,32,55
20,8474586,Jordan Eberle,R,SEA,34,82,17,38,55
20,8482684,Luke Hughes,D,NJD,21,82,11,44,55
20,8480036,Miro Heiskanen,D,DAL,25,82,9,46,55
20,8476539,Jonathan Marchessault,R,VGK,34,82,31,23,54
20,8484144,Connor Bedard,C,CHI,19,82,31,23,54
20,8475168,Matt Duchene,C,DAL,33,82,24,30,54
20,8482745,Mason McTavish,C,ANA,21,82,19,35,54
20,8478975,Mason Marchment,L,DAL,29,82,17,37,54
20,8477416,Oliver Bjorkstrand,R,SEA,29,82,15,39,54
20,8474590,John Carlson,D,WSH,34,82,12,42,54
20,8478460,Zach Werenski,D,CBJ,27,82,11,43,54
20,8476448,William Karlsson,C,VGK,31,82,24,29,53
20,8475287,Erik Haula,L,NJD,33,82,21,31,52
20,8474641,Adam Henrique,C,EDM,34,82,20,32,52
20,8477497,Sean Monahan,C,WPG,30,82,19,33,52
20,8480039,Martin Necas,C,CAR,25,82,18,34,52
20,8476454,Ryan Nugent-Hopkins,C,EDM,31,82,17,35,52
20,8478042,Viktor Arvidsson,R,LAK,31,82,16,36,52
20,8471724,Kris Letang,D,PIT,37,82,7,45,52
20,8479339,Patrik Laine,L,CBJ,26,82,23,28,51
20,8475765,Vladimir Tarasenko,R,FLA,33,82,20,31,51
20,8475744,Evgeny Kuznetsov,C,CAR,32,82,20,31,51
20,8476905,Chandler Stephenson,C,VGK,30,82,15,36,51
20,8475169,Evander Kane,L,EDM,33,82,27,23,50
20,8474679,Gustav Nyquist,C,NSH,35,82,15,35,50
20,8479325,Charlie McAvoy,D,BOS,27,82,9,41,50
20,8478055,Gustav Forsling,D,FLA,28,82,9,41,50
20,8482665,Matty Beniers,C,SEA,22,82,21,28,49
20,8481068,Yegor Sharangovich,C,CGY,26,82,21,28,49
20,8477476,Artturi Lehkonen,L,COL,29,82,20,29,49
20,8477479,Tyler Bertuzzi,L,TOR,29,82,18,31,49
20,8475170,Brayden Schenn,C,STL,33,82,16,33,49
20,8477447,Shea Theodore,D,VGK,29,82,12,37,49
20,8476479,Phillip Danault,C,LAK,31,82,24,24,48
20,8478519,Anthony Cirelli,C,TBL,27,82,20,28,48
20,8478397,Rasmus Andersson,D,CGY,28,82,10,38,48
20,8471698,T.J. Oshie,R,WSH,38,82,24,23,47
20,8480028,Morgan Frost,C,PHI,25,82,20,27,47
20,8475191,Reilly Smith,R,PIT,33,82,18,29,47
20,8482097,Jack Quinn,R,BUF,23,82,17,30,47
20,8478458,Jack Roslovic,C,NYR,27,82,17,30,47
20,8480434,Sean Durzi,D,ARI,26,82,12,35,47
20,8480893,Kirill Marchenko,R,CBJ,24,82,30,16,46
20,8478401,Pavel Zacha,C,BOS,27,82,24,22,46
20,8478474,Lawson Crouse,L,ARI,27,82,23,23,46
20,8476882,Teuvo Teravainen,L,CAR,30,82,19,27,46
20,8480031,Maxime Comtois,L,CAR,25,82,16,30,46
20,8470613,Brent Burns,D,CAR,39,82,11,35,46
20,8474565,Alex Pietrangelo,D,VGK,34,82,8,38,46
20,8476853,Morgan Rielly,D,TOR,30,82,5,41,46
20,8477952,Robby Fabbri,C,DET,28,82,30,15,45
20,8475151,Kyle Palmieri,C,NYI,33,82,26,19,45
20,8476432,Boone Jenner,C,CBJ,31,82,23,22,45
20,8476483,Rickard Rakell,R,PIT,31,82,20,25,45
20,8477407,Anthony Duclair,L,TBL,29,82,19,26,45
20,8476925,Colton Sissons,C,NSH,31,82,18,27,45
20,8477495,Seth Jones,D,CHI,30,82,8,37,45
20,8478498,Jake DeBrusk,L,BOS,28,82,24,20,44
20,8477426,Nicholas Paul,L,TBL,29,82,24,20,44
20,8479400,Pierre-Luc Dubois,L,LAK,26,82,22,22,44
20,8474157,Max Pacioretty,L,WSH,36,82,20,24,44
20,8477451,Ryan Hartman,R,MIN,30,82,19,25,44
20,8477935,Sam Bennett,C,FLA,28,82,18,26,44
20,8473986,Alex Killorn,L,ANA,35,82,18,26,44
20,8477021,Alex Kerfoot,C,ARI,30,82,16,28,44
20,8477444,Andre Burakovsky,L,SEA,29,82,15,29,44
20,8479999,Casey Mittelstadt,C,COL,26,82,13,31,44
20,8478542,Evan Rodrigues,C,FLA,31,82,13,31,44
20,8474102,David Perron,L,DET,36,82,11,33,44
20,8481542,Moritz Seider,D,DET,23,82,6,38,44
20,8481618,Alex Newhook,C,MTL,23,82,22,21,43
20,8475722,Jason Zucker,L,NSH,32,82,20,23,43
20,8482475,Yegor Chinakhov,R,CBJ,23,82,20,23,43
20,8483515,Juraj Slafkovsky,L,MTL,20,82,18,25,43
20,8479293,Brandon Tanev,L,SEA,33,82,18,25,43
20,8482124,Quinton Byfield,R,LAK,22,82,17,26,43
20,8477346,MacKenzie Weegar,D,CGY,30,82,15,28,43
20,8475197,Tyson Barrie,D,NSH,33,82,6,37,43
20,8482055,Drew O'Connor,L,PIT,26,82,24,18,42
20,8475760,Nick Bjugstad,C,ARI,32,82,20,22,42
20,8481624,Ilya Mikheyev,R,VAN,30,82,20,22,42
20,8478856,Conor Garland,R,VAN,28,82,18,24,42
20,8477456,J.T. Compher,L,DET,29,82,18,24,42
20,8478469,Thomas Chabot,D,OTT,27,82,8,34,42
20,8474563,Drew Doughty,D,LAK,35,82,5,37,42
20,8483457,Lane Hutson,D,MTL,20,82,2,40,42
20,8482101,Danil Gushchin,L,SJS,22,82,22,19,41
20,8476399,Blake Coleman,C,CGY,33,82,22,19,41
20,8482110,Dawson Mercer,C,NJD,23,82,21,20,41
20,8482159,Tyson Foerster,R,PHI,22,82,20,21,41
20,8482146,Luke Evangelista,R,NSH,22,82,20,21,41
20,8482113,Anton Lundell,C,FLA,23,82,18,23,41
20,8481711,Matias Maccelli,L,ARI,24,82,17,24,41
20,8476875,Mike Matheson,D,MTL,30,82,17,24,41
20,8481528,Dylan Cozens,C,BUF,23,82,14,27,41
20,8478466,Daniel Sprong,R,DET,27,82,14,27,41
20,8479425,Filip Hronek,D,VAN,27,82,9,32,41
20,8483471,Brad Lambert,C,WPG,31,82,5,36,41
20,8483397,Marc McLaughlin,C,BOS,25,82,35,5,40
20,8475791,Taylor Hall,L,CHI,33,82,13,27,40
20,8474150,Mikael Backlund,C,CGY,35,82,11,29,40
20,8482092,Ridly Greig,C,OTT,22,82,11,29,40
20,8474578,Erik Karlsson,D,PIT,34,82,5,35,40
20,8483499,Liam Ohgren,L,MIN,20,82,20,19,39
20,8470604,Jeff Carter,C,PIT,39,82,20,19,39
20,8480188,Fabian Zetterlund,L,SJS,25,82,19,20,39
20,8482740,Wyatt Johnston,C,DAL,21,82,17,22,39
20,8475794,Tyler Seguin,C,DAL,32,82,16,23,39
20,8481704,Juuso Parssinen,C,NSH,23,82,14,25,39
20,8479345,Jakob Chychrun,D,OTT,26,82,13,26,39
20,8483445,Cutter Gauthier,L,ANA,20,82,13,26,39
20,8475220,Marcus Foligno,L,MIN,33,82,13,26,39
20,8477932,Aaron Ekblad,D,FLA,28,82,7,32,39
20,8474716,Jared Spurgeon,D,MIN,35,82,7,32,39
20,8476906,Shayne Gostisbehere,D,DET,31,82,4,35,39
20,8480064,Josh Norris,C,OTT,25,82,25,13,38
20,8484203,Bradly Nadeau,L,CAR,19,82,25,13,38
20,8477964,Ivan Barbashev,C,VGK,29,82,21,17,38
20,8482109,Alexis Lafrenière,L,NYR,23,82,20,18,38
20,8476871,Tanner Pearson,L,MTL,32,82,18,20,38
20,8478891,Mason Appleton,C,WPG,28,82,13,25,38
20,8480797,Joel Farabee,L,PHI,24,82,12,26,38
20,8474053,Logan Couture,C,SJS,35,82,11,27,38
20,8475753,Justin Faulk,D,STL,32,82,10,28,38
20,8478396,Noah Hanifin,D,VGK,27,82,10,28,38
20,8476923,Damon Severson,D,CBJ,30,82,8,30,38
20,8479410,Mikhail Sergachev,D,TBL,26,82,5,33,38
20,8483524,Shane Wright,C,SEA,20,82,27,10,37
20,8479941,Justin Danforth,R,CBJ,31,82,22,15,37
20,8480009,Eeli Tolvanen,R,SEA,25,82,21,16,37
20,8476981,Josh Anderson,R,MTL,30,82,21,16,37
20,8479423,Alex Nylander,L,CBJ,26,82,15,22,37
20,8475768,Jaden Schwartz,C,SEA,32,82,12,25,37
20,8480798,Philipp Kurashev,C,CHI,25,82,10,27,37
20,8476869,Brady Skjei,D,CAR,30,82,9,28,37
20,8475314,Anders Lee,L,NYI,34,82,27,9,36
20,8477998,Warren Foegele,L,EDM,28,82,20,16,36
20,8481596,Shane Pinto,C,OTT,24,82,16,20,36
20,8482133,Thomas Bordeleau,C,SJS,22,82,14,22,36
20,8475149,Marcus Johansson,L,MIN,34,82,11,25,36
20,8480871,Adam Boqvist,D,CBJ,24,82,11,25,36
20,8475745,Charlie Coyle,C,BOS,32,82,9,27,36
20,8478038,Devon Toews,D,COL,30,82,8,28,36
20,8480817,K'Andre Miller,D,NYR,24,82,4,32,36
20,8482733,Logan Mailloux,D,MTL,31,82,3,33,36
20,8476892,Colton Parayko,D,STL,31,82,3,33,36
20,8480113,Alex Iafallo,L,WPG,31,82,22,13,35
20,8478366,Frank Vatrano,R,ANA,30,82,21,14,35
20,8474037,James van Riemsdyk,L,BOS,35,82,16,19,35
20,8473449,Kyle Okposo,R,FLA,36,82,16,19,35
20,8476374,Sean Kuraly,C,CBJ,31,82,16,19,35
20,8474189,Lars Eller,C,PIT,35,82,15,20,35
20,8476458,Ryan Strome,C,ANA,31,82,12,23,35
20,8484153,Leo Carlsson,C,ANA,20,82,12,23,35
20,8476329,Travis Boyd,C,ARI,31,82,10,25,35
20,8481546,Cam York,D,PHI,23,82,6,29,35
20,8477498,Darnell Nurse,D,EDM,29,82,6,29,35
20,8482624,Daniil Miromanov,D,CGY,27,82,6,29,35
20,8476792,Torey Krug,D,STL,33,82,5,30,35
20,8477948,Travis Sanheim,D,PHI,28,82,4,31,35
20,8477944,Jakub Vrana,L,STL,28,82,23,11,34
20,8475793,Ryan Johansen,C,PHI,32,82,15,19,34
20,8479675,Trevor Moore,L,LAK,29,82,13,21,34
20,8482074,Connor Zary,C,CGY,23,82,12,22,34
20,8476419,Jean-Gabriel Pageau,C,NYI,32,82,11,23,34
20,8476461,Sean Couturier,C,PHI,32,82,9,25,34
20,8477494,Jonathan Drouin,L,COL,29,82,8,26,34
20,8482667,William Eklund,L,SJS,22,82,17,16,33
20,8474149,Evgenii Dadonov,R,DAL,35,82,15,18,33
20,8476480,Vladislav Namestnikov,C,WPG,32,82,12,21,33
20,8476872,Scott Laughton,C,PHI,30,82,11,22,33
20,8478472,Mathieu Joseph,R,OTT,27,82,10,23,33
20,8480185,Eetu Luostarinen,C,FLA,26,82,10,23,33
20,8477986,Brandon Montour,D,FLA,30,82,9,24,33
20,8473422,Nick Foligno,L,CHI,37,82,9,24,33
20,8476826,Yanni Gourde,C,SEA,33,82,8,25,33
20,8481016,Ruslan Iskhakov,C,NYI,24,82,2,31,33
20,8483493,Frank Nazar,C,CHI,20,82,22,10,32
20,8482702,Logan Stankoven,C,DAL,21,82,22,10,32
20,8476278,Colin Blackwell,C,CHI,31,82,18,14,32
20,8484166,Adam Fantilli,C,CBJ,20,82,16,16,32
20,8477919,Frederick Gaudreau,C,MIN,31,82,15,17,32
20,8479987,Morgan Geekie,C,BOS,26,82,12,20,32
20,8477947,Sonny Milano,L,WSH,28,82,12,20,32
20,8477450,Jason Dickinson,C,CHI,29,82,12,20,32
20,8479415,Michael McLeod,C,NJD,26,82,10,22,32
20,8475218,Mattias Ekholm,D,EDM,34,82,9,23,32
20,8478178,Darren Raddysh,D,TBL,28,82,6,26,32
20,8476854,Hampus Lindholm,D,BOS,30,82,4,28,32
20,8476979,Erik Gustafsson,D,NYR,32,82,2,30,32
20,8476392,Adam Lowry,C,WPG,31,82,18,13,31
20,8478057,Dakota Joshua,C,VAN,28,82,17,14,31
20,8479525,Ross Colton,C,COL,28,82,16,15,31
20,8476873,Mark Jankowski,C,NSH,30,82,16,15,31
20,8478115,Pierre Engvall,L,NYI,28,82,15,16,31
20,8483808,Andrei Kuzmenko,L,CGY,28,82,13,18,31
20,8477953,Kasperi Kapanen,R,STL,28,82,13,18,31
20,8482222,Alexander Barabanov,L,SJS,30,82,12,19,31
20,8478133,Jake Evans,C,MTL,28,82,10,21,31
20,8473563,Nicklas Backstrom,C,WSH,37,82,9,22,31
20,8482105,Jake Sanderson,D,OTT,22,82,7,24,31
20,8481656,Aliaksei Protas,C,WSH,23,82,6,25,31
20,8476958,Jaccob Slavin,D,CAR,30,82,6,25,31
20,8480145,Neal Pionk,D,WPG,29,82,6,25,31
20,8481699,Aku Raty,R,ARI,23,82,2,29,31
20,8478109,Victor Olofsson,L,BUF,29,82,18,12,30
20,8480849,Barrett Hayton,C,ARI,24,82,15,15,30
20,8481186,Logan O'Connor,R,COL,28,82,14,16,30
20,8477503,Max Domi,C,TOR,29,82,11,19,30
20,8478413,Jordan Greenway,L,BUF,27,82,11,19,30
20,8480855,Jack McBain,C,ARI,24,82,11,19,30
20,8477511,Anthony Mantha,R,VGK,30,82,8,22,30
20,8482122,Brock Faber,D,MIN,22,82,8,22,30
20,8480873,Rasmus Sandin,D,WSH,24,82,7,23,30
20,8482142,Jamie Drysdale,D,PHI,22,82,7,23,30
20,8481581,Thomas Harley,D,DAL,23,82,6,24,30
20,8476438,Brandon Saad,L,STL,32,82,19,10,29
20,8475799,Nino Niederreiter,R,WPG,32,82,18,11,29
20,8482089,Jake Neighbours,L,STL,22,82,15,14,29
20,8480068,Ryan Poehling,C,PHI,25,82,15,14,29
20,8476469,Joel Armia,R,MTL,31,82,15,14,29
20,8480821,Filip Zadina,R,SJS,25,82,12,17,29
20,8480220,Noah Cates,L,PHI,25,82,12,17,29
20,8479996,Cody Glass,C,NSH,25,82,11,18,29
20,8475343,Nic Dowd,C,WSH,34,82,9,20,29
20,8481178,Egor Zamula,D,PHI,24,82,7,22,29
20,8474151,Ryan McDonagh,D,NSH,35,82,5,24,29
20,8475200,Dmitry Orlov,D,CAR,33,82,5,24,29
20,8482671,Owen Power,D,BUF,22,82,4,25,29
20,8475188,Brayden McNabb,D,VGK,33,82,2,27,29
20,8475763,Kevin Hayes,R,STL,32,82,12,16,28
20,8482175,JJ Peterka,R,BUF,22,82,12,16,28
20,8475848,Brendan Gallagher,R,MTL,32,82,12,16,28
20,8481604,Pavel Dorofeyev,L,VGK,24,82,12,16,28
20,8481703,Valtteri Puustinen,R,PIT,25,82,10,18,28
20,8482705,Cole Sillinger,C,CBJ,21,82,10,18,28
20,8476960,Andreas Athanasiou,C,CHI,30,82,9,19,28
20,8479514,Rem Pitlick,C,CHI,27,82,7,21,28
20,8478507,John Marino,D,NJD,27,82,6,22,28
20,8476902,Esa Lindell,D,DAL,30,82,5,23,28
20,8478500,Ivan Provorov,D,CBJ,27,82,4,24,28
20,8483490,Pavel Mintyukov,D,ANA,21,82,4,24,28
20,8479977,Kailer Yamamoto,R,SEA,26,82,16,11,27
20,8482145,Mavrik Bourque,C,DAL,22,82,16,11,27
20,8470621,Corey Perry,R,EDM,39,82,14,13,27
20,8482155,Alex Laferriere,R,LAK,23,82,14,13,27
20,8473533,Jordan Staal,C,CAR,36,82,13,14,27
20,8481560,Arthur Kaliyev,R,LAK,23,82,12,15,27
20,8481606,Jordan Spence,D,LAK,23,82,8,19,27
20,8478851,Alexandre Carrier,D,NSH,28,82,6,21,27
20,8475181,Nick Leddy,D,STL,33,82,5,22,27
20,8476467,Jamie Oleksiak,D,SEA,32,82,5,22,27
20,8478046,Danton Heinen,L,BOS,29,82,3,24,27
20,8482118,Sam Colangelo,R,ANA,23,82,21,5,26
20,8481554,Kaapo Kakko,R,NYR,23,82,17,9,26
20,8481535,Nils Hoglander,L,VAN,24,82,15,11,26
20,8478463,Anthony Beauvillier,L,NSH,27,82,14,12,26
20,8479661,Tanner Jeannot,L,TBL,27,82,14,12,26
20,8478020,Michael Amadio,C,VGK,28,82,12,14,26
20,8479591,Michael Eyssimont,C,TBL,28,82,10,16,26
20,8481013,Jonatan Berggren,R,DET,24,82,10,16,26
20,8479353,Brett Howden,C,VGK,26,82,9,17,26
20,8482079,Marco Rossi,C,MIN,23,82,8,18,26
20,8475906,John Klingberg,D,TOR,32,82,7,19,26
20,8477506,Ryan Pulock,D,NYI,30,82,5,21,26
20,8479371,Dante Fabbro,D,NSH,26,82,5,21,26
20,8475790,Erik Gudbranson,D,CBJ,32,82,5,21,26
20,8482245,Artem Zub,D,OTT,29,82,4,22,26
20,8475764,Cam Fowler,D,ANA,33,82,3,23,26
20,8477220,Nate Schmidt,D,WPG,33,82,3,23,26
20,8476921,Jordan Martinook,L,CAR,32,82,13,12,25
20,8481553,Bobby Brink,R,PHI,23,82,13,12,25
20,8483431,Logan Cooley,C,ARI,20,82,12,13,25
20,8479316,Luke Kunin,C,SJS,27,82,11,14,25
20,8477429,Andrew Copp,C,DET,30,82,8,17,25
20,8482720,Matthew Knies,L,TOR,22,82,8,17,25
20,8482073,Braden Schneider,D,NYR,23,82,8,17,25
20,8474567,Zach Bogosian,D,MIN,34,82,8,17,25
20,8478136,Jake Middleton,D,MIN,28,82,7,18,25
20,8478430,Oliver Kylington,D,CGY,27,82,7,18,25
20,8480336,Sean Walker,D,COL,30,82,6,19,25
20,8480246,Nick Perbix,D,TBL,26,82,5,20,25
20,8476331,Dylan DeMelo,D,WPG,31,82,4,21,25
20,8476422,Mike Reilly,D,NYI,31,82,4,21,25
20,8477969,Marcus Pettersson,D,PIT,28,82,1,24,25
20,8480281,Alexey Toropchenko,R,STL,25,82,15,9,24
20,8475714,Calle Jarnkrok,C,TOR,33,82,13,11,24
20,8479992,Michael Rasmussen,C,DET,25,82,13,11,24
20,8479346,Dillon Dube,C,CGY,26,82,13,11,24
20,8482737,Zack Bolduc,C,STL,21,82,12,12,24
20,8477353,Tyler Motte,C,TBL,29,82,12,12,24
20,8477425,Miles Wood,L,COL,29,82,11,13,24
20,8478468,Jeremy Lauzon,D,NSH,27,82,10,14,24
20,8479351,Sam Steel,C,DAL,26,82,8,16,24
20,8483565,Nick Blankenburg,D,CBJ,26,82,6,18,24
20,8478399,Jonas Siegenthaler,D,NJD,27,82,5,19,24
20,8477839,Conor Sheary,L,TBL,32,82,5,19,24
20,8477989,Christian Dvorak,C,MTL,28,82,14,9,23
20,8479393,Noah Gregor,C,TOR,26,82,12,11,23
20,8483491,Ivan Miroshnichenko,L,WSH,20,82,12,11,23
20,8474034,Pat Maroon,L,BOS,36,82,10,13,23
20,8478013,Jake Walman,D,DET,28,82,9,14,23
20,8482655,J.J. Moser,D,ARI,24,82,8,15,23
20,8481580,Connor McMichael,C,WSH,23,82,8,15,23
20,8476312,Josh Manson,D,COL,33,82,7,16,23
20,8476292,Ondrej Palat,L,NJD,33,82,6,17,23
20,8480144,David Kampf,C,TOR,29,82,6,17,23
20,8480172,Jan Rutta,D,SJS,34,82,4,19,23
20,8476457,Adam Larsson,D,SEA,32,82,4,19,23
20,8476463,Jonas Brodin,D,MIN,31,82,3,20,23
20,8480073,Erik Brannstrom,D,OTT,25,82,3,20,23
20,8480459,Pius Suter,C,VAN,28,82,11,11,22
20,8477406,Mattias Janmark,C,EDM,32,82,9,13,22
20,8471218,Blake Wheeler,R,NYR,38,82,8,14,22
20,8479390,Taylor Raddysh,R,CHI,26,82,7,15,22
20,8476891,Matt Grzelcyk,D,BOS,30,82,6,16,22
20,8482087,Kaiden Guhle,D,MTL,22,82,5,17,22
20,8475171,Oliver Ekman-Larsson,D,FLA,33,82,4,18,22
20,8478508,Yakov Trenin,C,COL,27,82,14,7,21
20,8482125,Alexander Holtz,R,NJD,22,82,13,8,21
20,8476878,Zemgus Girgensons,L,BUF,30,82,13,8,21
20,8482117,Lukas Reichel,L,CHI,22,82,11,10,21
20,8482062,Cole Smith,L,NSH,29,82,8,13,21
20,8477508,Curtis Lazar,C,NJD,29,82,8,13,21
20,8476927,Teddy Blueger,C,VAN,30,82,7,14,21
20,8477435,Ryan Graves,D,PIT,29,82,6,15,21
20,8483505,Matthew Poitras,C,BOS,20,82,5,16,21
20,8475233,David Savard,D,MTL,34,82,5,16,21
20,8480043,Timothy Liljegren,D,TOR,25,82,4,17,21
20,8476931,Jake McCabe,D,TOR,31,82,4,17,21
20,8481568,Alex Vlasic,D,CHI,23,82,4,17,21
20,8478840,Will Borgen,D,SEA,28,82,2,19,21
20,8475179,Dmitry Kulikov,D,FLA,34,82,1,20,21
20,8476915,Jujhar Khaira,L,MIN,30,82,13,7,20
20,8477330,Dominik Kubalik,L,OTT,29,82,12,8,20
20,8481537,Nikita Okhotiuk,D,CGY,24,82,10,10,20
20,8470610,Zach Parise,L,COL,40,82,9,11,20
20,8480980,Connor Dewar,C,TOR,25,82,8,12,20
20,8482111,Justin Barron,D,MTL,23,82,8,12,20
20,8480035,Henri Jokiharju,D,BUF,25,82,8,12,20
20,8484911,Collin Graf,R,SJS,22,82,7,13,20
20,8481601,Simon Holmstrom,R,NYI,23,82,6,14,20
20,8479369,Andrew Peeke,D,BOS,26,82,5,15,20
20,8477507,Nikita Zadorov,D,VAN,29,82,5,15,20
20,8477034,Jaycob Megna,D,CHI,32,82,5,15,20
20,8476525,Colin Miller,D,WPG,32,82,4,16,20
20,8479998,Mikey Anderson,D,LAK,25,82,4,16,20
20,8477845,Trevor van Riemsdyk,D,WSH,33,82,4,16,20
20,8475455,Brenden Dillon,D,WPG,34,82,3,17,20
20,8476917,Adam Pelech,D,NYI,30,82,3,17,20
20,8475462,Radko Gudas,D,ANA,34,82,3,17,20
20,8476879,Cody Ceci,D,EDM,31,82,3,17,20
20,8477505,Alexander Wennberg,C,NYR,30,82,3,17,20
20,8482470,Ilya Solovyov,D,CGY,24,82,2,18,20
20,8479976,Juuso Valimaki,D,ARI,26,82,1,19,20
20,8482259,Bobby McMann,C,TOR,28,82,11,8,19
20,8474884,Mike Hoffman,C,SJS,35,82,11,8,19
20,8481517,Brett Leason,R,ANA,25,82,11,8,19
20,8475231,Casey Cizikas,C,NYI,33,82,10,9,19
20,8479359,Beck Malenstyn,L,WSH,26,82,10,9,19
20,8480802,Ryan McLeod,C,EDM,25,82,9,10,19
20,8478569,Noel Acciari,C,PIT,33,82,9,10,19
20,8483482,Tristan Luneau,D,ANA,20,82,9,10,19
20,8480448,Parker Kelly,L,OTT,25,82,9,10,19
20,8480074,Alexandre Texier,C,CBJ,25,82,9,10,19
20,8481014,Alexander Romanov,D,NYI,24,82,8,11,19
20,8480796,Martin Fehervary,D,WSH,25,82,7,12,19
20,8482730,Brandt Clarke,D,LAK,21,82,6,13,19
20,8483466,Kevin Korchinski,D,CHI,20,82,6,13,19
20,8480807,Mattias Samuelsson,D,BUF,24,82,5,14,19
20,8474166,Alec Martinez,D,VGK,37,82,5,14,19
20,8476885,Jacob Trouba,D,NYR,30,82,4,15,19
20,8478882,Vladislav Gavrikov,D,LAK,29,82,4,15,19
20,8481524,Bowen Byram,D,BUF,23,82,3,16,19
20,8480834,Ty Emberson,D,SJS,24,82,3,16,19
20,8475324,Nick Jensen,D,WSH,34,82,2,17,19
20,8482516,Matthew Kessel,D,STL,24,82,2,17,19
20,8481481,Blake Lizotte,C,LAK,27,82,10,8,18
20,8481093,Rafael Harvey-Pinard,L,MTL,25,82,8,10,18
20,8479365,Trent Frederic,C,BOS,26,82,7,11,18
20,8482166,Shakir Mukhamadullin,D,SJS,22,82,6,12,18
20,8476858,Phillip Di Giuseppe,L,VAN,31,82,5,13,18
20,8476473,Connor Murphy,D,CHI,31,82,5,13,18
20,8481522,Peyton Krebs,C,BUF,23,82,4,14,18
20,8470600,Ryan Suter,D,DAL,39,82,4,14,18
20,8477488,Brett Pesce,D,CAR,30,82,3,15,18
20,8473507,Jeff Petry,D,DET,37,82,3,15,18
20,8474574,Tyler Myers,D,VAN,34,82,3,15,18
20,8474673,TJ Brodie,D,TOR,34,82,2,16,18
20,8474013,Ian Cole,D,VAN,35,82,1,17,18
20,8478043,Sam Lafferty,C,VAN,29,82,12,5,17
20,8481477,Nico Sturm,C,SJS,29,82,8,9,17
20,8480813,Joe Veleno,C,DET,24,82,8,9,17
20,8479291,Kevin Rooney,C,CGY,31,82,8,9,17
20,8474870,Tyler Johnson,C,CHI,34,82,7,10,17
20,8478831,Kevin Stenlund,C,FLA,28,82,7,10,17
20,8475164,Jakob Silfverberg,R,ANA,34,82,6,11,17
20,8476442,Matt Nieto,L,PIT,32,82,6,11,17
20,8474009,Nick Bonino,C,NYR,36,82,5,12,17
20,8479980,Nicolas Hague,D,VGK,26,82,5,12,17
20,8475177,Calvin de Haan,D,TBL,33,82,5,12,17
20,8482807,Ethan Del Mastro,D,CHI,21,82,5,12,17
20,8479398,Samuel Girard,D,COL,26,82,4,13,17
20,8477369,Carson Soucy,D,VAN,30,82,10,6,16
20,8475279,Ben Chiarot,D,DET,33,82,8,8,16
20,8475842,Sam Carrick,C,EDM,32,82,8,8,16
20,8481028,Martin Pospisil,C,CGY,25,82,4,12,16
20,8476897,Oskar Sundqvist,C,STL,30,82,4,12,16
20,8484145,Zach Benson,L,BUF,19,82,3,13,16
20,8476429,Scott Mayfield,D,NYI,32,82,3,13,16
20,8482666,Scott Morrow,D,CAR,22,82,3,13,16
20,8480058,Pierre-Olivier Joseph,D,PIT,25,82,3,13,16
20,8483012,Logan Morrison,C,SEA,22,82,11,4,15
20,8476822,Luke Glendening,C,TBL,35,82,8,7,15
20,8478911,Matt Roy,D,LAK,29,82,7,8,15
20,8482679,Matt Coronato,R,CGY,22,82,6,9,15
20,8477931,Tomas Nosek,L,NJD,32,82,6,9,15
20,8477392,Hudson Fasching,R,NYI,29,82,3,12,15
20,8475762,Derek Forbort,D,BOS,32,82,3,12,15
20,8481567,Henry Thrun,D,SJS,23,82,1,14,15
20,8478416,Erik Cernak,D,TBL,27,82,1,14,15
20,8482809,Jackson Blake,R,CAR,21,82,8,6,14
20,8479983,Mario Ferraro,D,SJS,26,82,4,10,14
20,8477015,Connor Brown,R,EDM,30,82,4,10,14
20,8482858,Ryker Evans,D,SEA,23,82,4,10,14
20,8480879,Jacob Bernard-Docker,D,OTT,24,82,3,11,14
20,8475690,Chris Tanev,D,DAL,35,82,3,11,14
20,8476372,Nick Seeler,D,PHI,31,82,2,12,14
20,8470966,Mark Giordano,D,TOR,41,82,2,12,14
20,8481059,Scott Perunovich,D,STL,26,82,1,13,14
20,8476624,Barclay Goodrow,C,NYR,31,82,7,6,13
20,8479383,Boris Katchouk,L,OTT,26,82,7,6,13
20,8480860,Kevin Bahl,D,NJD,24,82,6,7,13
20,8478451,Ethan Bear,D,WSH,27,82,5,8,13
20,8480806,Isac Lundestrom,C,ANA,25,82,4,9,13
20,8477499,Rasmus Ristolainen,D,PHI,30,82,4,9,13
20,8479324,Ryan Lindgren,D,NYR,26,82,3,10,13
20,8471677,Jack Johnson,D,COL,37,82,3,10,13
20,8473504,Cal Clutterbuck,R,NYI,37,82,2,11,13
20,8482712,Oskar Olausson,R,COL,22,82,2,11,13
20,8478408,Travis Dermott,D,ARI,28,82,2,11,13
20,8482803,Olen Zellweger,D,ANA,21,82,0,13,13
20,8476967,Brett Kulak,D,EDM,30,82,3,9,12
20,8483495,Simon Nemec,D,NJD,20,82,2,10,12
20,8477365,Connor Clifton,D,BUF,29,82,2,10,12
20,8475825,Jani Hakanpää,D,DAL,32,82,0,12,12
20,8474715,Cam Atkinson,R,PHI,35,82,8,3,11
20,8473453,Trevor Lewis,C,LAK,37,82,4,7,11
20,8479442,Troy Stecher,D,EDM,30,82,3,8,11
20,8478859,Niko Mikkola,D,FLA,28,82,1,10,11
20,8483763,Maksymilian Szuber,D,ARI,22,82,4,6,10
20,8481030,Jack St. Ivany,D,PIT,25,82,4,6,10
20,8482177,Marat Khusnutdinov,C,MIN,22,82,3,7,10
20,8483468,Jiri Kulich,C,BUF,20,82,3,7,10
20,8482762,Simon Edvinsson,D,DET,21,82,2,8,10
20,8478443,Brandon Carlo,D,BOS,28,82,1,9,10
20,8477335,Kyle Burroughs,D,SJS,29,82,5,4,9
20,8480990,Declan Chisholm,D,MIN,24,82,3,6,9
20,8481605,Jackson LaCombe,D,ANA,23,82,2,7,9
20,8475208,Brian Dumoulin,D,SEA,33,82,1,8,9
20,8484149,Gavin Brindley,C,CBJ,20,82,0,7,7
20,8483489,Fraser Minten,C,TOR,31,82,4,2,6
20,8482859,Zack Ostapchuk,C,OTT,21,82,3,3,6
20,8481578,Graeme Clarke,R,NJD,23,82,3,2,5
20,8482713,Mackie Samoskevich,R,FLA,22,82,2,3,5
20,8481599,Victor Soderstrom,D,ARI,23,82,0,3,3
20,8482141,Lukas Cormier,D,VGK,22,0,0,0,0
20,8476988,Matt Benning,D,SJS,30,0,0,0,0
20,8480727,Zach Whitecloud,D,VGK,28,0,0,0,0
20,8480887,Jordan Harris,D,MTL,24,0,0,0,0
20,8478450,Parker Wotherspoon,D,BOS,27,0,0,0,0
20,8481812,Nikolai Knyzhov,D,SJS,27,0,0,0,0
20,8480001,Urho Vaakanainen,D,ANA,25,0,0,0,0
20,8482176,Wyatt Kaiser,D,CHI,22,0,0,0,0
20,8481122,Simon Benoit,D,TOR,26,0,0,0,0
20,8476441,Joel Edmundson,D,TOR,31,0,0,0,0
20,8480884,Calen Addison,D,SJS,24,0,0,0,0
20,8482511,Mason Lohrei,D,BOS,23,0,0,0,0
20,8482192,Isaak Phillips,D,CHI,23,0,0,0,0
20,8480950,Ilya Lyubushkin,D,TOR,30,0,0,0,0
20,8474031,Kevin Shattenkirk,D,BOS,35,0,0,0,0
20,8475718,Justin Holl,D,DET,32,0,0,0,0
20,8479402,Jake Bean,D,CBJ,26,0,0,0,0
20,8474602,Justin Schultz,D,SEA,34,0,0,0,0
20,8477950,Tony DeAngelo,D,CAR,29,0,0,0,0
20,8481743,Marc Del Gaizo,D,NSH,25,0,0,0,0
20,8481527,Kaedan Korczak,D,VGK,23,0,0,0,0
20,8480192,Johnathan Kovacevic,D,MTL,27,0,0,0,0
20,8476874,Olli Maatta,D,DET,30,0,0,0,0
20,8482144,Jack Thompson,D,SJS,22,0,0,0,0
20,8480222,Sebastian Aho,D,NYI,28,0,0,0,0
20,8479458,Nikita Zaitsev,D,CHI,33,0,0,0,0
20,8471709,Marc-Edouard Vlasic,D,SJS,37,0,0,0,0
20,8482929,Emil Lilleberg,D,TBL,23,0,0,0,0
20,8477018,Ben Hutton,D,VGK,31,0,0,0,0
20,8481056,Spencer Stastney,D,NSH,24,0,0,0,0
20,8481593,Jayden Struble,D,MTL,23,0,0,0,0
20,8479982,Conor Timmins,D,TOR,26,0,0,0,0
20,8474090,Brendan Smith,D,NJD,35,0,0,0,0
20,8482964,Arber Xhekaj,D,MTL,23,0,0,0,0
20,8480891,Michael Kesselring,D,ARI,24,0,0,0,0
20,8477938,Haydn Fleury,D,TBL,28,0,0,0,0
20,8481806,Louis Crevier,D,CHI,23,0,0,0,0
20,8471274,Alex Goligoski,D,MIN,39,0,0,0,0
20,8481600,Tobias Bjornfot,D,FLA,23,0,0,0,0
20,8475797,Jarred Tinordi,D,CHI,32,0,0,0,0
20,8481521,Ronnie Attard,D,PHI,25,0,0,0,0
20,8474612,Travis Hamonic,D,OTT,34,0,0,0,0
20,8479576,Vincent Desharnais,D,EDM,28,0,0,0,0
20,8480049,Dylan Samberg,D,WPG,25,0,0,0,0
20,8483619,Filip Roos,D,CHI,25,0,0,0,0
20,8474568,Luke Schenn,D,NSH,35,0,0,0,0
20,8480184,Gustav Lindstrom,D,ANA,26,0,0,0,0
20,8480070,Ian Mitchell,D,BOS,25,0,0,0,0
20,8480196,Jacob Bryson,D,BUF,27,0,0,0,0
20,8471686,Marc Staal,D,PHI,37,0,0,0,0
20,8477467,Gustav Olofsson,D,SEA,30,0,0,0,0
20,8478970,Jalen Chatfield,D,CAR,28,0,0,0,0
20,8479348,Kale Clague,D,BUF,26,0,0,0,0
20,8473446,Erik Johnson,D,PHI,36,0,0,0,0
20,8477462,Robert Hagg,D,ANA,29,0,0,0,0
20,8478454,Noah Juulsen,D,VAN,27,0,0,0,0
20,8477384,Josh Brown,D,ARI,30,0,0,0,0
20,8481708,Zac Jones,D,NYR,24,0,0,0,0
20,8481167,Brayden Pachal,D,CGY,25,0,0,0,0
20,8482067,Connor Mackey,D,NYR,28,0,0,0,0
20,8483460,David Jiricek,D,CBJ,21,0,0,0,0
20,8481701,Santeri Hatakka,D,NJD,23,0,0,0,0
20,8478021,William Lagesson,D,ANA,28,0,0,0,0
20,8477851,Jordan Oesterle,D,CGY,32,0,0,0,0
20,8478452,Caleb Jones,D,COL,27,0,0,0,0
20,8479984,Cal Foote,D,NJD,26,0,0,0,0
20,8479639,Dylan Coghlan,D,CAR,26,0,0,0,0
20,8480874,Adam Ginning,D,PHI,24,0,0,0,0
20,8479321,Lucas Johansen,D,WSH,27,0,0,0,0
20,8480878,Nils Lundkvist,D,DAL,24,0,0,0,0
20,8482165,Yan Kuznetsov,D,CGY,22,0,0,0,0
20,8484258,Sam Malinski,D,COL,26,0,0,0,0
20,8480157,Calle Rosen,D,STL,30,0,0,0,0
20,8484304,Uvis Balinskis,D,FLA,28,0,0,0,0
20,8479985,Cale Fleury,D,SEA,26,0,0,0,0
20,8479378,Logan Stanley,D,WPG,26,0,0,0,0
20,8477541,Dakota Mermis,D,MIN,30,0,0,0,0
20,8481609,Vladislav Kolyachonok,D,ARI,23,0,0,0,0
20,8480823,Alexander Alexeyev,D,WSH,25,0,0,0,0
20,8481679,Maxence Guenette,D,OTT,23,0,0,0,0
20,8481564,Ryan Johnson,D,BUF,23,0,0,0,0
20,8479376,Victor Mete,D,PHI,26,0,0,0,0
20,8484254,Akito Hirose,D,VAN,25,0,0,0,0
20,8482660,Kent Johnson,C,CBJ,22,0,0,0,0
20,8482149,Cole Perfetti,C,WPG,22,0,0,0,0
20,8477987,Ryan Donato,C,CHI,28,0,0,0,0
20,8475755,Alexander Petrovic,D,DAL,32,0,0,0,0
20,8477810,Joel Hanley,D,CGY,33,0,0,0,0
20,8474145,Robert Bortuzzo,D,NYI,35,0,0,0,0
20,8481161,Jake Christiansen,D,CBJ,25,0,0,0,0
20,8476884,Derrick Pouliot,D,DAL,30,0,0,0,0
20,8481716,Dmitri Voronkov,L,CBJ,24,0,0,0,0
20,8480084,Nick DeSimone,D,NJD,30,0,0,0,0
20,8475750,Jon Merrill,D,MIN,32,0,0,0,0
20,8479315,Joey Anderson,R,CHI,26,0,0,0,0
20,8478011,Louie Belpedio,D,PHI,28,0,0,0,0
20,8482451,Mikael Pyyhtia,L,CBJ,23,0,0,0,0
20,8481541,Samuel Bolduc,D,NYI,24,0,0,0,0
20,8482126,Emil Andrae,D,PHI,31,0,0,0,0
20,8474618,Marco Scandella,D,STL,34,0,0,0,0
20,8477244,Chad Ruhwedel,D,NYR,34,0,0,0,0
20,8477971,Andreas Englund,D,LAK,28,0,0,0,0
20,8480829,Jesperi Kotkaniemi,C,CAR,24,0,0,0,0
20,8479372,Josh Mahura,D,FLA,26,0,0,0,0
20,8482095,Tyler Kleven,D,OTT,22,0,0,0,0
20,8481719,Maxwell Crozier,D,TBL,24,0,0,0,0
20,8475855,Jesper Fast,R,CAR,33,0,0,0,0
20,8480848,Ty Dellandrea,C,DAL,24,0,0,0,0
20,8475193,Tomas Tatar,L,SEA,34,0,0,0,0
20,8476889,Radek Faksa,C,DAL,30,0,0,0,0
20,8478495,Denis Gurianov,R,PHI,27,0,0,0,0
20,8480216,Jacob Peterson,C,SJS,25,0,0,0,0
20,8480252,Cole Guttman,C,CHI,25,0,0,0,0
20,8479026,Philippe Myers,D,TBL,27,0,0,0,0
20,8481006,Tyler Tucker,D,STL,24,0,0,0,0
20,8481032,Paul Cotter,C,VGK,25,0,0,0,0
20,8481577,Philip Tomasino,C,NSH,23,0,0,0,0
20,8476918,Jimmy Vesey,L,NYR,31,0,0,0,0
20,8479320,Max Lajoie,D,TOR,27,0,0,0,0
20,8478017,Mark Friedman,D,VAN,29,0,0,0,0
20,8481754,Nikita Nesterenko,C,ANA,23,0,0,0,0
20,8483407,Brandon Scanlin,D,NYR,25,0,0,0,0
20,8482659,Josh Doan,R,ARI,22,0,0,0,0
20,8477446,Michael McCarron,R,NSH,29,0,0,0,0
20,8477903,Garnet Hathaway,R,PHI,33,0,0,0,0
20,8482153,Brendan Brisson,C,VGK,23,0,0,0,0
20,8483546,Marshall Rifai,D,TOR,26,0,0,0,0
20,8484287,Cole McWard,D,VAN,23,0,0,0,0
20,8478854,Ryan Shea,D,PIT,27,0,0,0,0
20,8481585,Egor Afanasyev,L,NSH,23,0,0,0,0
20,8483398,Declan Carlile,D,TBL,31,0,0,0,0
20,8478502,Dennis Gilbert,D,CGY,28,0,0,0,0
20,8482749,Joshua Roy,R,MTL,21,0,0,0,0
20,8481598,Philip Broberg,D,EDM,23,0,0,0,0
20,8480835,Jack Drury,C,CAR,24,0,0,0,0
20,8480748,Kiefer Sherwood,L,NSH,29,0,0,0,0
20,8476934,Brock McGinn,L,ANA,30,0,0,0,0
20,8480870,Bo Groulx,C,ANA,24,0,0,0,0
20,8479368,Max Jones,L,ANA,26,0,0,0,0
20,8478099,Kevin Labanc,R,SJS,29,0,0,0,0
20,8478067,Oskar Lindblom,L,SJS,28,0,0,0,0
20,8476393,Nick Cousins,C,FLA,31,0,0,0,0
20,8483395,Arshdeep Bains,L,VAN,23,0,0,0,0
20,8480762,Eric Robinson,L,BUF,29,0,0,0,0
20,8479439,Jacob MacDonald,D,SJS,31,0,0,0,0
20,8476474,Stefan Noesen,R,CAR,31,0,0,0,0
20,8482787,Nikita Chibrikov,R,WPG,31,0,0,0,0
20,8478432,Christian Fischer,R,DET,27,0,0,0,0
20,8477979,Nicolas Aube-Kubel,R,WSH,28,0,0,0,0
20,8481789,Tye Kartye,L,SEA,23,0,0,0,0
20,8479330,Brandon Gignac,C,MTL,27,0,0,0,0
20,8480075,Cameron Crotty,D,ARI,25,0,0,0,0
20,8473473,Milan Lucic,L,BOS,36,0,0,0,0
20,8482094,Daemon Hunt,D,MIN,22,0,0,0,0
20,8481206,John Ludvig,D,PIT,24,0,0,0,0
20,8483630,Pavol Regenda,L,ANA,25,0,0,0,0
20,8481617,Vasily Podkolzin,R,VAN,23,0,0,0,0
20,8480306,Grant Hutton,D,NYI,29,0,0,0,0
20,8480995,Pontus Holmberg,R,TOR,25,0,0,0,0
20,8482148,Hendrix Lapierre,C,WSH,22,0,0,0,0
20,8477478,William Carrier,L,VGK,30,0,0,0,0
20,8480003,Jesper Boqvist,C,BOS,26,0,0,0,0
20,8482172,Landon Slaggert,L,CHI,22,0,0,0,0
20,8480789,Oliver Wahlstrom,R,NYI,24,0,0,0,0
20,8474062,Riley Nash,C,NYR,35,0,0,0,0
20,8480021,Jack Studnicka,C,SJS,25,0,0,0,0
20,8480025,MacKenzie Entwistle,R,CHI,25,0,0,0,0
20,8481582,Nicholas Robertson,L,TOR,23,0,0,0,0
20,8476867,Brendan Gaunce,C,CBJ,30,0,0,0,0
20,8479619,Michael Carcone,L,ARI,28,0,0,0,0
20,8479370,Tyson Jost,C,BUF,26,0,0,0,0
20,8479671,Mathieu Olivier,R,CBJ,27,0,0,0,0
20,8476994,Vinnie Hinostroza,C,PIT,30,0,0,0,0
20,8482070,Mitchell Chaffee,R,TBL,26,0,0,0,0
20,8477473,Justin Bailey,R,SJS,29,0,0,0,0
20,8479344,Jesse Puljujarvi,R,PIT,26,0,0,0,0
20,8480205,Emil Bemstrom,C,PIT,25,0,0,0,0
20,8479718,Alex Barré-Boulet,C,TBL,27,0,0,0,0
20,8482061,Brandon Biro,L,BUF,26,0,0,0,0
20,8479638,Justin Brazeau,R,BOS,26,0,0,0,0
20,8474040,Sam Gagner,C,EDM,35,0,0,0,0
20,8477846,Ryan Carpenter,C,SJS,33,0,0,0,0
20,8482077,Dylan Holloway,L,EDM,23,0,0,0,0
20,8482157,Will Cuylle,L,NYR,22,0,0,0,0
20,8480007,Jonas Rondbjerg,R,VGK,25,0,0,0,0
20,8478874,Adam Gaudette,C,STL,28,0,0,0,0
20,8478434,Keegan Kolesar,R,VGK,27,0,0,0,0
20,8480441,Trey Fix-Wolansky,R,CBJ,25,0,0,0,0
20,8479994,Jaret Anderson-Dolan,C,NSH,25,0,0,0,0
20,8483567,Georgii Merkulov,C,BOS,24,0,0,0,0
20,8477380,Jonny Brodzinski,C,NYR,31,0,0,0,0
20,8482201,Gage Goncalves,C,TBL,23,0,0,0,0
20,8478211,Dryden Hunt,L,CGY,29,0,0,0,0
20,8471699,Andrew Cogliano,C,COL,37,0,0,0,0
20,8479421,Jacob Moverare,D,LAK,26,0,0,0,0
20,8478881,Brett Seney,L,CHI,28,0,0,0,0
20,8477464,Nic Petan,C,MIN,29,0,0,0,0
20,8475958,Michael Sgarbossa,C,WSH,32,0,0,0,0
20,8481147,Reese Johnson,C,CHI,26,0,0,0,0
20,8479336,Carl Grundstrom,R,LAK,27,0,0,0,0
20,8480853,Liam Foudy,C,NSH,24,0,0,0,0
20,8479522,Hardy Haman Aktell,D,WSH,26,0,0,0,0
20,8481462,Mason Morelli,L,VGK,28,0,0,0,0
20,8482102,Vasily Ponomarev,C,CAR,22,0,0,0,0
20,8480844,Grigori Denisenko,L,VGK,24,0,0,0,0
20,8479944,Zach Aston-Reese,C,DET,30,0,0,0,0
20,8482784,Zach Dean,C,STL,21,0,0,0,0
20,8479419,Brett Murray,L,BUF,26,0,0,0,0
20,8479520,Brandon Duhaime,R,COL,27,0,0,0,0
20,8477573,Nathan Walker,L,STL,30,0,0,0,0
20,8478078,Rourke Chartier,C,OTT,28,0,0,0,0
20,8475795,Dylan McIlrath,D,WSH,32,0,0,0,0
20,8482496,Nils Aman,C,VAN,24,0,0,0,0
20,8480289,Morgan Barron,C,WPG,26,0,0,0,0
20,8481751,Lukas Rousek,R,BUF,25,0,0,0,0
20,8480011,Klim Kostin,C,SJS,25,0,0,0,0
20,8481556,John Beecher,C,BOS,23,0,0,0,0
20,8475278,Byron Froese,C,VGK,33,0,0,0,0
20,8475225,Craig Smith,C,DAL,35,0,0,0,0
20,8484326,Patrik Koch,D,ARI,28,0,0,0,0
20,8477930,Pierre-Edouard Bellemare,L,SEA,39,0,0,0,0
20,8478409,Anthony Richard,C,BOS,28,0,0,0,0
20,8481024,Linus Karlsson,C,VAN,25,0,0,0,0
20,8479986,Kole Lind,R,SEA,26,0,0,0,0
20,8479414,Nathan Bastian,R,NJD,27,0,0,0,0
20,8479362,Riley Tufte,L,COL,26,0,0,0,0
20,8481058,Jesse Ylönen,R,MTL,25,0,0,0,0
20,8482476,Emil Heineman,L,MTL,23,0,0,0,0
20,8482861,Vincent Iorio,D,WSH,22,0,0,0,0
20,8483432,Luca Del Bel Belluz,C,CBJ,31,0,0,0,0
20,8482744,James Malatesta,L,CBJ,21,0,0,0,0
20,8477887,Patrick Brown,C,BOS,32,0,0,0,0
20,8478585,Derek Ryan,C,EDM,38,0,0,0,0
20,8481441,Joe Snively,C,WSH,28,0,0,0,0
20,8481592,Jakob Pelletier,L,CGY,23,0,0,0,0
20,8482634,Alex Steeves,C,TOR,25,0,0,0,0
20,8477126,Jayson Megna,C,BOS,34,0,0,0,0
20,8475752,Tyler Pitlick,C,NYR,33,0,0,0,0
20,8480008,Adam Ruzicka,C,ARI,25,0,0,0,0
20,8481065,Angus Crookshank,L,OTT,25,0,0,0,0
20,8479547,Matthew Phillips,R,WSH,26,0,0,0,0
20,8480226,Marián Studenic,R,SEA,26,0,0,0,0
20,8481237,Kyle MacLean,C,NYI,25,0,0,0,0
20,8475413,Justin Dowling,C,NJD,34,0,0,0,0
20,8481641,Joel Kiviranta,L,COL,28,0,0,0,0
20,8478104,Sammy Blais,L,STL,28,0,0,0,0
20,8477454,Adam Erne,L,EDM,29,0,0,0,0
20,8481518,Nolan Foote,L,NJD,24,0,0,0,0
20,8480245,Olle Lycksell,R,PHI,25,0,0,0,0
20,8483570,Ben Meyers,C,ANA,26,0,0,0,0
20,8480776,Sheldon Rempal,R,VGK,29,0,0,0,0
20,8483920,Pierrick Dube,R,WSH,23,0,0,0,0
20,8480267,Sammy Walker,C,MIN,25,0,0,0,0
20,8482747,Brennan Othmann,L,NYR,21,0,0,0,0
20,8479991,Jake Leschyshyn,C,NYR,25,0,0,0,0
20,8478400,Colin White,C,MTL,27,0,0,0,0
20,8479328,Julien Gauthier,R,NYI,27,0,0,0,0
20,8484325,Waltteri Merela,C,TBL,26,0,0,0,0
20,8479066,Ryan Lomberg,L,FLA,30,0,0,0,0
20,8477070,Liam O'Brien,C,ARI,30,0,0,0,0
20,8478146,Matthew Highmore,C,OTT,28,0,0,0,0
20,8478028,Fredrik Olofsson,L,COL,28,0,0,0,0
20,8480880,Jakub Lauko,C,BOS,24,0,0,0,0
20,8479968,Vinni Lettieri,C,MIN,29,0,0,0,0
20,8474709,Matt Martin,L,NYI,35,0,0,0,0
20,8480845,Rasmus Kupari,C,WPG,24,0,0,0,0
20,8481550,Adam Beckman,L,MIN,23,0,0,0,0
20,8481422,Jacob Lucchini,C,MIN,29,0,0,0,0
20,8477401,John Hayden,C,SEA,29,0,0,0,0
20,8478904,Steven Lorentz,C,FLA,28,0,0,0,0
20,8482088,Justin Sourdif,R,FLA,22,0,0,0,0
20,8482751,Ryan Winterton,C,SEA,21,0,0,0,0
20,8482241,Radim Zohorna,L,PIT,28,0,0,0,0
20,8481690,Tyler Angle,C,CBJ,24,0,0,0,0
20,8476952,Dominic Toninato,C,WPG,30,0,0,0,0
20,8476919,Chris Tierney,C,NJD,30,0,0,0,0
20,8480032,Shane Bowers,C,NJD,25,0,0,0,0
20,8484314,Jiri Smejkal,L,OTT,28,0,0,0,0
20,8481239,Samuel Fagemo,L,LAK,24,0,0,0,0
20,8481532,Alex Turcotte,C,LAK,23,0,0,0,0
20,8481019,David Gustafsson,C,WPG,24,0,0,0,0
20,8478477,Mitchell Stephens,C,MTL,27,0,0,0,0
20,8479546,Oskar Steen,C,BOS,26,0,0,0,0
20,8480292,Carson Meyer,R,CBJ,27,0,0,0,0
20,8478446,Glenn Gawdin,C,ANA,27,0,0,0,0
20,8483531,Brian Halonen,L,NJD,25,0,0,0,0
20,8477149,Scott Sabourin,R,SJS,32,0,0,0,0
20,8479972,Mason Shaw,C,MIN,26,0,0,0,0
20,8480890,Jan Jenik,R,ARI,24,0,0,0,0
20,8478051,Max Willman,C,NJD,29,0,0,0,0
20,8480851,Akil Thomas,C,LAK,24,0,0,0,0
20,8482765,Isak Rosen,R,BUF,21,0,0,0,0
20,8478421,A.J. Greer,L,CGY,28,0,0,0,0
20,8478512,Austin Czarnik,C,DET,32,0,0,0,0
20,8479536,Axel Jonsson-Fjallby,L,WPG,26,0,0,0,0
20,8477320,Anton Blidh,L,NYR,29,0,0,0,0
20,8481543,Nikita Alexandrov,C,STL,24,0,0,0,0
20,8475235,Nicolas Deslauriers,L,PHI,33,0,0,0,0
20,8481070,Hugh McGing,L,STL,26,0,0,0,0
20,8480836,Jonathan Gruden,C,PIT,24,0,0,0,0
20,8481591,Sam Poulin,R,PIT,23,0,0,0,0
20,8477962,Brendan Lemieux,L,CAR,28,0,0,0,0
20,8483401,Marc Johnstone,R,PIT,28,0,0,0,0
20,8482250,Callahan Burke,C,CAR,27,0,0,0,0
20,8481726,Adam Edstrom,C,NYR,24,0,0,0,0
20,8471817,Ryan Reaves,R,TOR,37,0,0,0,0
20,8479587,Rhett Gardner,C,PHI,28,0,0,0,0
20,8475766,Austin Watson,L,TBL,32,0,0,0,0
20,8479367,William Lockwood,R,FLA,26,0,0,0,0
20,8478424,Jansen Harkins,C,PIT,27,0,0,0,0
20,8476913,Devin Shore,C,SEA,30,0,0,0,0
20,8482652,Walker Duehr,R,CGY,27,0,0,0,0
20,8477527,Ross Johnston,L,ANA,30,0,0,0,0
20,8481077,John Leonard,L,ARI,26,0,0,0,0
20,8483549,Lucas Condotta,L,MTL,27,0,0,0,0
20,8480468,James Hamblin,L,EDM,25,0,0,0,0
20,8476907,Mackenzie MacEachern,L,STL,30,0,0,0,0
20,8479543,Michael Pezzetta,L,MTL,26,0,0,0,0
20,8480355,Mark Kastelic,C,OTT,25,0,0,0,0
20,8482162,Roby Jarventie,L,OTT,22,0,0,0,0
20,8479772,Zack MacEwen,R,OTT,28,0,0,0,0
20,8483597,Milos Kelemen,L,ARI,25,0,0,0,0
20,8479379,Givani Smith,R,SJS,26,0,0,0,0
20,8481655,Cole Schwindt,R,CGY,23,0,0,0,0
20,8479981,Jonah Gadjovich,L,FLA,26,0,0,0,0
20,8482147,Jean-Luc Foudy,C,COL,22,0,0,0,0
20,8484255,Jason Polin,R,COL,25,0,0,0,0
20,8477993,Justin Kirkland,C,ARI,28,0,0,0,0
20,8479249,Andrew Poturalski,C,SEA,30,0,0,0,0
20,8482197,Adam Raska,R,MIN,23,0,0,0,0
20,8475780,Chris Wagner,R,COL,33,0,0,0,0
20,8479533,Joona Koppanen,L,PIT,26,0,0,0,0
20,8481534,Raphael Lavoie,C,EDM,24,0,0,0,0
20,8484321,Nikolas Matinpalo,D,OTT,26,0,0,0,0
20,8481043,Cole Koepke,L,TBL,26,0,0,0,0
20,8476323,Max McCormick,L,SEA,32,0,0,0,0
20,8483609,Adam Klapka,R,CGY,24,0,0,0,0
20,8483512,Matt Savoie,C,BUF,20,0,0,0,0
20,8484259,Ondrej Pavel,C,COL,31,0,0,0,0
20,8478147,Bokondji Imama,L,OTT,28,0,0,0,0
20,8482460,Matt Rempe,C,NYR,22,0,0,0,0
20,8477073,Kurtis MacDermid,L,NJD,30,0,0,0,0
20,8480274,Philip Kemp,D,EDM,25,0,0,0,0
20,8478956,Samuel Laberge,L,NJD,27,0,0,0,0
20,8483045,Cameron Butler,R,CBJ,31,0,0,0,0
21,8478402,Connor McDavid,C,EDM,27,82,35,76,111
21,8476453,Nikita Kucherov,R,TBL,31,82,36,71,107
21,8478864,Kirill Kaprizov,L,MIN,27,82,42,62,104
21,8477956,David Pastrnak,R,BOS,28,82,38,61,99
21,8480012,Elias Pettersson,C,VAN,26,82,41,56,97
21,8477493,Aleksander Barkov,C,FLA,29,82,31,66,97
21,8477934,Leon Draisaitl,C,EDM,29,82,35,61,96
21,8477492,Nathan MacKinnon,C,COL,29,82,42,52,94
21,8478550,Artemi Panarin,L,NYR,33,82,35,58,93
21,8480027,Jason Robertson,L,DAL,25,82,37,53,90
21,8479343,Clayton Keller,R,ARI,26,82,42,47,89
21,8478420,Mikko Rantanen,R,COL,28,82,42,47,89
21,8476468,J.T. Miller,C,VAN,31,82,37,50,87
21,8477933,Sam Reinhart,C,FLA,29,82,43,43,86
21,8478398,Kyle Connor,L,WPG,28,82,41,45,86
21,8474564,Steven Stamkos,C,TBL,34,82,36,49,85
21,8481559,Jack Hughes,C,NJD,23,82,33,51,84
21,8479314,Matthew Tkachuk,L,FLA,27,82,35,47,82
21,8477939,William Nylander,R,TOR,28,82,38,43,81
21,8479318,Auston Matthews,C,TOR,27,82,46,33,79
21,8473419,Brad Marchand,L,BOS,36,82,36,43,79
21,8477409,Carter Verhaeghe,C,FLA,29,82,36,43,79
21,8475786,Zach Hyman,L,EDM,32,82,42,36,78
21,8479407,Jesper Bratt,L,NJD,26,82,23,54,77
21,8480069,Cale Makar,D,COL,26,82,18,59,77
21,8480800,Quinn Hughes,D,VAN,25,82,12,65,77
21,8478427,Sebastian Aho,C,CAR,27,82,30,46,76
21,8481557,Matt Boldy,L,MIN,23,82,25,51,76
21,8479420,Tage Thompson,C,BUF,27,82,43,32,75
21,8478010,Brayden Point,C,TBL,28,82,45,29,74
21,8475184,Chris Kreider,L,NYR,33,82,40,34,74
21,8471675,Sidney Crosby,C,PIT,37,82,32,42,74
21,8478449,Roope Hintz,C,DAL,28,82,32,42,74
21,8476459,Mika Zibanejad,C,NYR,31,82,30,44,74
21,8482078,Lucas Raymond,L,DET,22,82,29,45,74
21,8476346,Johnny Gaudreau,L,CBJ,31,82,21,53,74
21,8480002,Nico Hischier,C,NJD,25,82,30,43,73
21,8477402,Pavel Buchnevich,L,STL,29,82,30,43,73
21,8480801,Brady Tkachuk,L,OTT,25,82,27,46,73
21,8475167,Victor Hedman,D,TBL,34,82,11,62,73
21,8476389,Vincent Trocheck,C,NYR,31,82,21,51,72
21,8478414,Timo Meier,R,NJD,28,82,39,32,71
21,8476887,Filip Forsberg,L,NSH,30,82,35,36,71
21,8477949,Alex Tuch,R,BUF,28,82,33,38,71
21,8479385,Jordan Kyrou,C,STL,26,82,29,42,71
21,8478407,Vince Dunn,D,SEA,28,82,16,55,71
21,8477404,Jake Guentzel,C,CAR,30,82,30,40,70
21,8478439,Travis Konecny,R,PHI,27,82,23,47,70
21,8471215,Evgeni Malkin,C,PIT,38,82,21,49,70
21,8475692,Mats Zuccarello,R,MIN,37,82,14,56,70
21,8478498,Jake DeBrusk,L,BOS,28,82,30,39,69
21,8476460,Mark Scheifele,C,WPG,31,82,29,40,69
21,8482684,Luke Hughes,D,NJD,21,82,28,41,69
21,8474141,Patrick Kane,R,DET,36,82,25,43,68
21,8479323,Adam Fox,D,NYR,26,82,20,48,68
21,8480018,Nick Suzuki,C,MTL,25,82,34,33,67
21,8475810,Bryan Rust,R,PIT,32,82,32,35,67
21,8481523,Kirby Dach,C,MTL,23,82,9,58,67
21,8480208,Drake Batherson,R,OTT,26,82,33,33,66
21,8477946,Dylan Larkin,C,DET,28,82,29,37,66
21,8477500,Bo Horvat,C,NYI,29,82,35,30,65
21,8474590,John Carlson,D,WSH,34,82,14,51,65
21,8479325,Charlie McAvoy,D,BOS,27,82,10,55,65
21,8471214,Alex Ovechkin,L,WSH,39,82,28,36,64
21,8476454,Ryan Nugent-Hopkins,C,EDM,31,82,27,37,64
21,8475166,John Tavares,C,TOR,34,82,25,39,64
21,8477942,Kevin Fiala,L,LAK,28,82,25,39,64
21,8481540,Cole Caufield,R,MTL,23,82,34,29,63
21,8478047,Michael Bunting,L,PIT,29,82,25,38,63
21,8475798,Mikael Granlund,C,SJS,32,82,20,43,63
21,8482116,Tim Stützle,C,OTT,22,82,14,49,63
21,8477501,Valeri Nichushkin,R,COL,29,82,27,35,62
21,8478403,Jack Eichel,C,VGK,28,82,31,30,61
21,8475754,Brock Nelson,C,NYI,33,82,24,37,61
21,8477447,Shea Theodore,D,VGK,29,82,14,47,61
21,8475765,Vladimir Tarasenko,R,FLA,33,82,26,34,60
21,8474586,Jordan Eberle,R,SEA,34,82,24,36,60
21,8470794,Joe Pavelski,C,DAL,40,82,19,41,60
21,8480039,Martin Necas,C,CAR,25,82,25,34,59
21,8480830,Andrei Svechnikov,R,CAR,24,82,17,42,59
21,8480023,Robert Thomas,C,STL,25,82,16,43,59
21,8476456,Jonathan Huberdeau,C,CGY,31,82,16,43,59
21,8474578,Erik Karlsson,D,PIT,34,82,16,43,59
21,8480036,Miro Heiskanen,D,DAL,25,82,12,47,59
21,8477416,Oliver Bjorkstrand,R,SEA,29,82,25,33,58
21,8477955,Jared McCann,L,SEA,28,82,20,38,58
21,8478042,Viktor Arvidsson,R,LAK,31,82,18,40,58
21,8471698,T.J. Oshie,R,WSH,38,82,30,27,57
21,8479542,Brandon Hagel,L,TBL,26,82,24,33,57
21,8482665,Matty Beniers,C,SEA,22,82,21,36,57
21,8474150,Mikael Backlund,C,CGY,35,82,21,36,57
21,8475784,Jeff Skinner,C,BUF,32,82,19,38,57
21,8477496,Elias Lindholm,C,VAN,30,82,18,39,57
21,8479337,Alex DeBrincat,R,DET,27,82,26,30,56
21,8480015,Owen Tippett,R,PHI,25,82,26,30,56
21,8477951,Nick Schmaltz,C,ARI,28,82,21,35,56
21,8474102,David Perron,L,DET,36,82,20,36,56
21,8476462,Dougie Hamilton,D,NJD,31,82,17,39,56
21,8479425,Filip Hronek,D,VAN,27,82,16,40,56
21,8476432,Boone Jenner,C,CBJ,31,82,27,28,55
21,8482093,Seth Jarvis,C,CAR,22,82,25,30,55
21,8478856,Conor Garland,R,VAN,28,82,25,30,55
21,8477407,Anthony Duclair,L,TBL,29,82,24,31,55
21,8475172,Nazem Kadri,C,CGY,34,82,23,32,55
21,8478493,Joel Eriksson Ek,C,MIN,27,82,22,33,55
21,8478445,Mathew Barzal,C,NYI,27,82,16,39,55
21,8477504,Josh Morrissey,D,WPG,29,82,10,45,55
21,8476483,Rickard Rakell,R,PIT,31,82,28,26,54
21,8478401,Pavel Zacha,C,BOS,27,82,21,33,54
21,8481533,Trevor Zegras,C,ANA,23,82,20,34,54
21,8482740,Wyatt Johnston,C,DAL,21,82,20,34,54
21,8474679,Gustav Nyquist,C,NSH,35,82,19,35,54
21,8478444,Brock Boeser,R,VAN,27,82,18,36,54
21,8476826,Yanni Gourde,C,SEA,33,82,14,40,54
21,8482109,Alexis Lafrenière,L,NYR,23,82,31,22,53
21,8474641,Adam Henrique,C,EDM,34,82,28,25,53
21,8475168,Matt Duchene,C,DAL,33,82,24,29,53
21,8482097,Jack Quinn,R,BUF,23,82,21,32,53
21,8475158,Ryan O'Reilly,C,NSH,33,82,19,34,53
21,8480078,Filip Chytil,C,NYR,25,82,17,36,53
21,8475745,Charlie Coyle,C,BOS,32,82,14,39,53
21,8479410,Mikhail Sergachev,D,TBL,26,82,7,46,53
21,8476853,Morgan Rielly,D,TOR,30,82,6,47,53
21,8477476,Artturi Lehkonen,L,COL,29,82,23,29,52
21,8475794,Tyler Seguin,C,DAL,32,82,20,32,52
21,8474600,Roman Josi,D,NSH,34,82,17,35,52
21,8473994,Jamie Benn,L,DAL,35,82,16,36,52
21,8471685,Anze Kopitar,C,LAK,37,82,14,38,52
21,8479365,Trent Frederic,C,BOS,26,82,29,22,51
21,8479675,Trevor Moore,L,LAK,29,82,27,24,51
21,8480064,Josh Norris,C,OTT,25,82,26,25,51
21,8478466,Daniel Sprong,R,DET,27,82,23,28,51
21,8477960,Adrian Kempe,R,LAK,28,82,21,30,51
21,8482667,William Eklund,L,SJS,22,82,20,31,51
21,8482745,Mason McTavish,C,ANA,21,82,19,32,51
21,8475913,Mark Stone,R,VGK,32,82,15,36,51
21,8480865,Noah Dobson,D,NYI,24,82,11,40,51
21,8475151,Kyle Palmieri,C,NYI,33,82,30,20,50
21,8477935,Sam Bennett,C,FLA,28,82,28,22,50
21,8480797,Joel Farabee,L,PHI,24,82,26,24,50
21,8476882,Teuvo Teravainen,L,CAR,30,82,20,30,50
21,8479400,Pierre-Luc Dubois,L,LAK,26,82,17,33,50
21,8479987,Morgan Geekie,C,BOS,26,82,17,33,50
21,8481068,Yegor Sharangovich,C,CGY,26,82,24,25,49
21,8473512,Claude Giroux,R,OTT,36,82,23,26,49
21,8477479,Tyler Bertuzzi,L,TOR,29,82,15,34,49
21,8475726,Tyler Toffoli,C,WPG,32,82,24,24,48
21,8480188,Fabian Zetterlund,L,SJS,25,82,20,28,48
21,8477497,Sean Monahan,C,WPG,30,82,17,31,48
21,8480839,Rasmus Dahlin,D,BUF,24,82,14,34,48
21,8478397,Rasmus Andersson,D,CGY,28,82,10,38,48
21,8477451,Ryan Hartman,R,MIN,30,82,26,21,47
21,8482159,Tyson Foerster,R,PHI,22,82,23,24,47
21,8479339,Patrik Laine,L,CBJ,26,82,21,26,47
21,8481528,Dylan Cozens,C,BUF,23,82,21,26,47
21,8480220,Noah Cates,L,PHI,25,82,20,27,47
21,8480031,Maxime Comtois,L,CAR,25,82,15,32,47
21,8475753,Justin Faulk,D,STL,32,82,12,35,47
21,8480803,Evan Bouchard,D,EDM,25,82,7,40,47
21,8483524,Shane Wright,C,SEA,20,82,35,11,46
21,8478233,Andrew Mangiapane,L,CGY,28,82,24,22,46
21,8478519,Anthony Cirelli,C,TBL,27,82,22,24,46
21,8474037,James van Riemsdyk,L,BOS,35,82,22,24,46
21,8481618,Alex Newhook,C,MTL,23,82,21,25,46
21,8475191,Reilly Smith,R,PIT,33,82,20,26,46
21,8474157,Max Pacioretty,L,WSH,36,82,20,26,46
21,8476438,Brandon Saad,L,STL,32,82,25,20,45
21,8476539,Jonathan Marchessault,R,VGK,34,82,24,21,45
21,8482222,Alexander Barabanov,L,SJS,30,82,21,24,45
21,8477940,Nikolaj Ehlers,L,WPG,28,82,19,26,45
21,8476880,Tom Wilson,R,WSH,30,82,19,26,45
21,8475768,Jaden Schwartz,C,SEA,32,82,17,28,45
21,8477932,Aaron Ekblad,D,FLA,28,82,13,32,45
21,8481699,Aku Raty,R,ARI,23,82,2,43,45
21,8478474,Lawson Crouse,L,ARI,27,82,28,16,44
21,8476479,Phillip Danault,C,LAK,31,82,16,28,44
21,8482133,Thomas Bordeleau,C,SJS,22,82,16,28,44
21,8476905,Chandler Stephenson,C,VGK,30,82,15,29,44
21,8478460,Zach Werenski,D,CBJ,27,82,14,30,44
21,8479999,Casey Mittelstadt,C,COL,26,82,14,30,44
21,8471724,Kris Letang,D,PIT,37,82,13,31,44
21,8477494,Jonathan Drouin,L,COL,29,82,13,31,44
21,8477986,Brandon Montour,D,FLA,30,82,9,35,44
21,8470613,Brent Burns,D,CAR,39,82,7,37,44
21,8478366,Frank Vatrano,R,ANA,30,82,26,17,43
21,8477444,Andre Burakovsky,L,SEA,29,82,16,27,43
21,8475170,Brayden Schenn,C,STL,33,82,13,30,43
21,8478542,Evan Rodrigues,C,FLA,31,82,12,31,43
21,8480113,Alex Iafallo,L,WPG,31,82,19,23,42
21,8478440,Dylan Strome,C,WSH,27,82,18,24,42
21,8482699,Dylan Guenther,R,ARI,21,82,18,24,42
21,8476875,Mike Matheson,D,MTL,30,82,17,25,42
21,8482124,Quinton Byfield,R,LAK,22,82,15,27,42
21,8476329,Travis Boyd,C,ARI,31,82,13,29,42
21,8476906,Shayne Gostisbehere,D,DET,31,82,10,32,42
21,8480434,Sean Durzi,D,ARI,26,82,6,36,42
21,8481542,Moritz Seider,D,DET,23,82,5,37,42
21,8484203,Bradly Nadeau,L,CAR,19,82,30,11,41
21,8475760,Nick Bjugstad,C,ARI,32,82,21,20,41
21,8478458,Jack Roslovic,C,NYR,27,82,18,23,41
21,8480009,Eeli Tolvanen,R,SEA,25,82,18,23,41
21,8478873,Troy Terry,R,ANA,27,82,17,24,41
21,8476925,Colton Sissons,C,NSH,31,82,15,26,41
21,8476869,Brady Skjei,D,CAR,30,82,10,31,41
21,8477944,Jakub Vrana,L,STL,28,82,21,19,40
21,8482101,Danil Gushchin,L,SJS,22,82,16,24,40
21,8482113,Anton Lundell,C,FLA,23,82,16,24,40
21,8482705,Cole Sillinger,C,CBJ,21,82,15,25,40
21,8482175,JJ Peterka,R,BUF,22,82,14,26,40
21,8478469,Thomas Chabot,D,OTT,27,82,11,29,40
21,8475791,Taylor Hall,L,CHI,33,82,11,29,40
21,8480798,Philipp Kurashev,C,CHI,25,82,11,29,40
21,8476792,Torey Krug,D,STL,33,82,6,34,40
21,8476448,William Karlsson,C,VGK,31,82,17,22,39
21,8475763,Kevin Hayes,R,STL,32,82,17,22,39
21,8477456,J.T. Compher,L,DET,29,82,10,29,39
21,8481546,Cam York,D,PHI,23,82,10,29,39
21,8478038,Devon Toews,D,COL,30,82,9,30,39
21,8476854,Hampus Lindholm,D,BOS,30,82,9,30,39
21,8483445,Cutter Gauthier,L,ANA,20,82,6,33,39
21,8475764,Cam Fowler,D,ANA,33,82,5,34,39
21,8476958,Jaccob Slavin,D,CAR,30,82,3,36,39
21,8477426,Nicholas Paul,L,TBL,29,82,20,18,38
21,8480014,Gabriel Vilardi,C,WPG,25,82,19,19,38
21,8478975,Mason Marchment,L,DAL,29,82,17,21,38
21,8481596,Shane Pinto,C,OTT,24,82,16,22,38
21,8476292,Ondrej Palat,L,NJD,33,82,16,22,38
21,8476881,Tomas Hertl,C,VGK,31,82,15,23,38
21,8473986,Alex Killorn,L,ANA,35,82,15,23,38
21,8477021,Alex Kerfoot,C,ARI,30,82,13,25,38
21,8481703,Valtteri Puustinen,R,PIT,25,82,11,27,38
21,8480043,Timothy Liljegren,D,TOR,25,82,11,27,38
21,8474565,Alex Pietrangelo,D,VGK,34,82,8,30,38
21,8480893,Kirill Marchenko,R,CBJ,24,82,22,15,37
21,8471218,Blake Wheeler,R,NYR,38,82,18,19,37
21,8477511,Anthony Mantha,R,VGK,30,82,17,20,37
21,8475722,Jason Zucker,L,NSH,32,82,15,22,37
21,8475200,Dmitry Orlov,D,CAR,33,82,12,25,37
21,8476872,Scott Laughton,C,PHI,30,82,11,26,37
21,8476480,Vladislav Namestnikov,C,WPG,32,82,10,27,37
21,8477498,Darnell Nurse,D,EDM,29,82,9,28,37
21,8483457,Lane Hutson,D,MTL,20,82,0,37,37
21,8478115,Pierre Engvall,L,NYI,28,82,18,18,36
21,8480028,Morgan Frost,C,PHI,25,82,16,20,36
21,8480185,Eetu Luostarinen,C,FLA,26,82,13,23,36
21,8476927,Teddy Blueger,C,VAN,30,82,13,23,36
21,8477495,Seth Jones,D,CHI,30,82,11,25,36
21,8478046,Danton Heinen,L,BOS,29,82,10,26,36
21,8478396,Noah Hanifin,D,VGK,27,82,8,28,36
21,8482105,Jake Sanderson,D,OTT,22,82,6,30,36
21,8481016,Ruslan Iskhakov,C,NYI,24,82,3,33,36
21,8481554,Kaapo Kakko,R,NYR,23,82,19,16,35
21,8480459,Pius Suter,C,VAN,28,82,19,16,35
21,8477998,Warren Foegele,L,EDM,28,82,18,17,35
21,8478057,Dakota Joshua,C,VAN,28,82,18,17,35
21,8484166,Adam Fantilli,C,CBJ,20,82,17,18,35
21,8477964,Ivan Barbashev,C,VGK,29,82,16,19,35
21,8478463,Anthony Beauvillier,L,NSH,27,82,15,20,35
21,8482092,Ridly Greig,C,OTT,22,82,13,22,35
21,8478413,Jordan Greenway,L,BUF,27,82,9,26,35
21,8481624,Ilya Mikheyev,R,VAN,30,82,22,12,34
21,8483808,Andrei Kuzmenko,L,CGY,28,82,18,16,34
21,8480068,Ryan Poehling,C,PHI,25,82,16,18,34
21,8477947,Sonny Milano,L,WSH,28,82,15,19,34
21,8482702,Logan Stankoven,C,DAL,21,82,14,20,34
21,8476960,Andreas Athanasiou,C,CHI,30,82,14,20,34
21,8478438,Tommy Novak,C,NSH,27,82,12,22,34
21,8482110,Dawson Mercer,C,NJD,23,82,12,22,34
21,8475218,Mattias Ekholm,D,EDM,34,82,11,23,34
21,8475197,Tyson Barrie,D,NSH,33,82,8,26,34
21,8476902,Esa Lindell,D,DAL,30,82,7,27,34
21,8483397,Marc McLaughlin,C,BOS,25,82,27,6,33
21,8482089,Jake Neighbours,L,STL,22,82,25,8,33
21,8477952,Robby Fabbri,C,DET,28,82,22,11,33
21,8475220,Marcus Foligno,L,MIN,33,82,20,13,33
21,8474189,Lars Eller,C,PIT,35,82,15,18,33
21,8483515,Juraj Slafkovsky,L,MTL,20,82,14,19,33
21,8479293,Brandon Tanev,L,SEA,33,82,14,19,33
21,8483505,Matthew Poitras,C,BOS,20,82,14,19,33
21,8475287,Erik Haula,L,NJD,33,82,11,22,33
21,8474563,Drew Doughty,D,LAK,35,82,10,23,33
21,8478472,Mathieu Joseph,R,OTT,27,82,10,23,33
21,8477346,MacKenzie Weegar,D,CGY,30,82,8,25,33
21,8481656,Aliaksei Protas,C,WSH,23,82,7,26,33
21,8483471,Brad Lambert,C,WPG,31,82,6,27,33
21,8476891,Matt Grzelcyk,D,BOS,30,82,6,27,33
21,8475799,Nino Niederreiter,R,WPG,32,82,19,13,32
21,8480802,Ryan McLeod,C,EDM,25,82,14,18,32
21,8478462,Nicolas Roy,C,VGK,27,82,13,19,32
21,8482146,Luke Evangelista,R,NSH,22,82,12,20,32
21,8481711,Matias Maccelli,L,ARI,24,82,12,20,32
21,8475793,Ryan Johansen,C,PHI,32,82,12,20,32
21,8474149,Evgenii Dadonov,R,DAL,35,82,11,21,32
21,8477429,Andrew Copp,C,DET,30,82,11,21,32
21,8480873,Rasmus Sandin,D,WSH,24,82,10,22,32
21,8477503,Max Domi,C,TOR,29,82,9,23,32
21,8478500,Ivan Provorov,D,CBJ,27,82,5,27,32
21,8479525,Ross Colton,C,COL,28,82,21,10,31
21,8484144,Connor Bedard,C,CHI,19,82,17,14,31
21,8476399,Blake Coleman,C,CGY,33,82,17,14,31
21,8476419,Jean-Gabriel Pageau,C,NYI,32,82,12,19,31
21,8477989,Christian Dvorak,C,MTL,28,82,11,20,31
21,8478055,Gustav Forsling,D,FLA,28,82,10,21,31
21,8474716,Jared Spurgeon,D,MIN,35,82,10,21,31
21,8477948,Travis Sanheim,D,PHI,28,82,9,22,31
21,8480817,K'Andre Miller,D,NYR,24,82,8,23,31
21,8481581,Thomas Harley,D,DAL,23,82,8,23,31
21,8475149,Marcus Johansson,L,MIN,34,82,7,24,31
21,8482655,J.J. Moser,D,ARI,24,82,6,25,31
21,8477969,Marcus Pettersson,D,PIT,28,82,2,29,31
21,8475314,Anders Lee,L,NYI,34,82,18,12,30
21,8480821,Filip Zadina,R,SJS,25,82,17,13,30
21,8479996,Cody Glass,C,NSH,25,82,16,14,30
21,8477425,Miles Wood,L,COL,29,82,16,14,30
21,8474870,Tyler Johnson,C,CHI,34,82,15,15,30
21,8479977,Kailer Yamamoto,R,SEA,26,82,14,16,30
21,8481535,Nils Hoglander,L,VAN,24,82,14,16,30
21,8478891,Mason Appleton,C,WPG,28,82,11,19,30
21,8474053,Logan Couture,C,SJS,35,82,11,19,30
21,8476458,Ryan Strome,C,ANA,31,82,11,19,30
21,8475744,Evgeny Kuznetsov,C,CAR,32,82,9,21,30
21,8480871,Adam Boqvist,D,CBJ,24,82,8,22,30
21,8476885,Jacob Trouba,D,NYR,30,82,6,24,30
21,8482733,Logan Mailloux,D,MTL,31,82,5,25,30
21,8481560,Arthur Kaliyev,R,LAK,23,82,16,13,29
21,8482259,Bobby McMann,C,TOR,28,82,15,14,29
21,8475169,Evander Kane,L,EDM,33,82,14,15,29
21,8480849,Barrett Hayton,C,ARI,24,82,13,16,29
21,8483491,Ivan Miroshnichenko,L,WSH,20,82,13,16,29
21,8473422,Nick Foligno,L,CHI,37,82,12,17,29
21,8479390,Taylor Raddysh,R,CHI,26,82,12,17,29
21,8482475,Yegor Chinakhov,R,CBJ,23,82,11,18,29
21,8476392,Adam Lowry,C,WPG,31,82,11,18,29
21,8476897,Oskar Sundqvist,C,STL,30,82,9,20,29
21,8482079,Marco Rossi,C,MIN,23,82,18,10,28
21,8476469,Joel Armia,R,MTL,31,82,17,11,28
21,8477919,Frederick Gaudreau,C,MIN,31,82,14,14,28
21,8473563,Nicklas Backstrom,C,WSH,37,82,14,14,28
21,8479345,Jakob Chychrun,D,OTT,26,82,12,16,28
21,8479346,Dillon Dube,C,CGY,26,82,9,19,28
21,8480172,Jan Rutta,D,SJS,34,82,7,21,28
21,8476892,Colton Parayko,D,STL,31,82,6,22,28
21,8478840,Will Borgen,D,SEA,28,82,6,22,28
21,8479976,Juuso Valimaki,D,ARI,26,82,5,23,28
21,8482073,Braden Schneider,D,NYR,23,82,4,24,28
21,8476923,Damon Severson,D,CBJ,30,82,2,26,28
21,8474151,Ryan McDonagh,D,NSH,35,82,2,26,28
21,8482145,Mavrik Bourque,C,DAL,22,82,23,4,27
21,8481704,Juuso Parssinen,C,NSH,23,82,18,9,27
21,8483431,Logan Cooley,C,ARI,20,82,13,14,27
21,8470604,Jeff Carter,C,PIT,39,82,12,15,27
21,8481186,Logan O'Connor,R,COL,28,82,12,15,27
21,8480855,Jack McBain,C,ARI,24,82,12,15,27
21,8475848,Brendan Gallagher,R,MTL,32,82,12,15,27
21,8482730,Brandt Clarke,D,LAK,21,82,12,15,27
21,8481013,Jonatan Berggren,R,DET,24,82,11,16,27
21,8474034,Pat Maroon,L,BOS,36,82,9,18,27
21,8478507,John Marino,D,NJD,27,82,6,21,27
21,8479983,Mario Ferraro,D,SJS,26,82,6,21,27
21,8476624,Barclay Goodrow,C,NYR,31,82,6,21,27
21,8481568,Alex Vlasic,D,CHI,23,82,1,26,27
21,8475714,Calle Jarnkrok,C,TOR,33,82,16,10,26
21,8470610,Zach Parise,L,COL,40,82,16,10,26
21,8481601,Simon Holmstrom,R,NYI,23,82,11,15,26
21,8477450,Jason Dickinson,C,CHI,29,82,9,17,26
21,8478133,Jake Evans,C,MTL,28,82,7,19,26
21,8482671,Owen Power,D,BUF,22,82,7,19,26
21,8478178,Darren Raddysh,D,TBL,28,82,5,21,26
21,8482624,Daniil Miromanov,D,CGY,27,82,4,22,26
21,8477506,Ryan Pulock,D,NYI,30,82,4,22,26
21,8482122,Brock Faber,D,MIN,22,82,3,23,26
21,8483493,Frank Nazar,C,CHI,20,82,20,5,25
21,8481477,Nico Sturm,C,SJS,29,82,16,9,25
21,8476921,Jordan Martinook,L,CAR,32,82,15,10,25
21,8479393,Noah Gregor,C,TOR,26,82,14,11,25
21,8476981,Josh Anderson,R,MTL,30,82,13,12,25
21,8482155,Alex Laferriere,R,LAK,23,82,11,14,25
21,8477953,Kasperi Kapanen,R,STL,28,82,10,15,25
21,8478020,Michael Amadio,C,VGK,28,82,10,15,25
21,8481553,Bobby Brink,R,PHI,23,82,10,15,25
21,8481580,Connor McMichael,C,WSH,23,82,10,15,25
21,8479514,Rem Pitlick,C,CHI,27,82,9,16,25
21,8483499,Liam Ohgren,L,MIN,20,82,8,17,25
21,8477335,Kyle Burroughs,D,SJS,29,82,7,18,25
21,8478851,Alexandre Carrier,D,NSH,28,82,6,19,25
21,8480336,Sean Walker,D,COL,30,82,6,19,25
21,8475171,Oliver Ekman-Larsson,D,FLA,33,82,6,19,25
21,8480807,Mattias Samuelsson,D,BUF,24,82,5,20,25
21,8479324,Ryan Lindgren,D,NYR,26,82,5,20,25
21,8473507,Jeff Petry,D,DET,37,82,4,21,25
21,8481567,Henry Thrun,D,SJS,23,82,4,21,25
21,8481604,Pavel Dorofeyev,L,VGK,24,82,15,9,24
21,8479992,Michael Rasmussen,C,DET,25,82,12,12,24
21,8474884,Mike Hoffman,C,SJS,35,82,12,12,24
21,8482666,Scott Morrow,D,CAR,22,82,11,13,24
21,8482055,Drew O'Connor,L,PIT,26,82,9,15,24
21,8477839,Conor Sheary,L,TBL,32,82,9,15,24
21,8482125,Alexander Holtz,R,NJD,22,82,9,15,24
21,8477508,Curtis Lazar,C,NJD,29,82,8,16,24
21,8484145,Zach Benson,L,BUF,19,82,7,17,24
21,8482087,Kaiden Guhle,D,MTL,22,82,6,18,24
21,8476422,Mike Reilly,D,NYI,31,82,5,19,24
21,8479398,Samuel Girard,D,COL,26,82,5,19,24
21,8480145,Neal Pionk,D,WPG,29,82,3,21,24
21,8477369,Carson Soucy,D,VAN,30,82,3,21,24
21,8478443,Brandon Carlo,D,BOS,28,82,3,21,24
21,8473449,Kyle Okposo,R,FLA,36,82,14,9,23
21,8478043,Sam Lafferty,C,VAN,29,82,14,9,23
21,8480281,Alexey Toropchenko,R,STL,25,82,13,10,23
21,8475164,Jakob Silfverberg,R,ANA,34,82,13,10,23
21,8481481,Blake Lizotte,C,LAK,27,82,11,12,23
21,8473533,Jordan Staal,C,CAR,36,82,8,15,23
21,8480813,Joe Veleno,C,DET,24,82,8,15,23
21,8477931,Tomas Nosek,L,NJD,32,82,8,15,23
21,8479415,Michael McLeod,C,NJD,26,82,7,16,23
21,8479351,Sam Steel,C,DAL,26,82,7,16,23
21,8476525,Colin Miller,D,WPG,32,82,6,17,23
21,8482803,Olen Zellweger,D,ANA,21,82,5,18,23
21,8474574,Tyler Myers,D,VAN,34,82,2,21,23
21,8477353,Tyler Motte,C,TBL,29,82,11,11,22
21,8484153,Leo Carlsson,C,ANA,20,82,10,12,22
21,8475343,Nic Dowd,C,WSH,34,82,10,12,22
21,8480074,Alexandre Texier,C,CBJ,25,82,10,12,22
21,8479316,Luke Kunin,C,SJS,27,82,9,13,22
21,8483012,Logan Morrison,C,SEA,22,82,9,13,22
21,8478136,Jake Middleton,D,MIN,28,82,8,14,22
21,8478013,Jake Walman,D,DET,28,82,8,14,22
21,8482117,Lukas Reichel,L,CHI,22,82,8,14,22
21,8475233,David Savard,D,MTL,34,82,8,14,22
21,8477507,Nikita Zadorov,D,VAN,29,82,6,16,22
21,8478911,Matt Roy,D,LAK,29,82,6,16,22
21,8482062,Cole Smith,L,NSH,29,82,5,17,22
21,8482712,Oskar Olausson,R,COL,22,82,5,17,22
21,8476312,Josh Manson,D,COL,33,82,3,19,22
21,8477488,Brett Pesce,D,CAR,30,82,3,19,22
21,8483482,Tristan Luneau,D,ANA,20,82,2,20,22
21,8480246,Nick Perbix,D,TBL,26,82,1,21,22
21,8476873,Mark Jankowski,C,NSH,30,82,13,8,21
21,8480806,Isac Lundestrom,C,ANA,25,82,12,9,21
21,8482074,Connor Zary,C,CGY,23,82,11,10,21
21,8476878,Zemgus Girgensons,L,BUF,30,82,9,12,21
21,8476931,Jake McCabe,D,TOR,31,82,7,14,21
21,8479353,Brett Howden,C,VGK,26,82,5,16,21
21,8478399,Jonas Siegenthaler,D,NJD,27,82,5,16,21
21,8478416,Erik Cernak,D,TBL,27,82,4,17,21
21,8480860,Kevin Bahl,D,NJD,24,82,4,17,21
21,8475188,Brayden McNabb,D,VGK,33,82,3,18,21
21,8475455,Brenden Dillon,D,WPG,34,82,3,18,21
21,8481178,Egor Zamula,D,PHI,24,82,2,19,21
21,8475181,Nick Leddy,D,STL,33,82,2,19,21
21,8476463,Jonas Brodin,D,MIN,31,82,2,19,21
21,8474673,TJ Brodie,D,TOR,34,82,2,19,21
21,8476967,Brett Kulak,D,EDM,30,82,2,19,21
21,8475208,Brian Dumoulin,D,SEA,33,82,2,19,21
21,8476979,Erik Gustafsson,D,NYR,32,82,1,20,21
21,8474715,Cam Atkinson,R,PHI,35,82,12,8,20
21,8479941,Justin Danforth,R,CBJ,31,82,11,9,20
21,8479423,Alex Nylander,L,CBJ,26,82,11,9,20
21,8478569,Noel Acciari,C,PIT,33,82,11,9,20
21,8477015,Connor Brown,R,EDM,30,82,11,9,20
21,8475231,Casey Cizikas,C,NYI,33,82,10,10,20
21,8478508,Yakov Trenin,C,COL,27,82,9,11,20
21,8480980,Connor Dewar,C,TOR,25,82,9,11,20
21,8474009,Nick Bonino,C,NYR,36,82,9,11,20
21,8476374,Sean Kuraly,C,CBJ,31,82,8,12,20
21,8477330,Dominik Kubalik,L,OTT,29,82,8,12,20
21,8476461,Sean Couturier,C,PHI,32,82,7,13,20
21,8477406,Mattias Janmark,C,EDM,32,82,7,13,20
21,8482142,Jamie Drysdale,D,PHI,22,82,5,15,20
21,8482245,Artem Zub,D,OTT,29,82,5,15,20
21,8480058,Pierre-Olivier Joseph,D,PIT,25,82,4,16,20
21,8481606,Jordan Spence,D,LAK,23,82,3,17,20
21,8475906,John Klingberg,D,TOR,32,82,2,18,20
21,8482118,Sam Colangelo,R,ANA,23,82,14,5,19
21,8479383,Boris Katchouk,L,OTT,26,82,8,11,19
21,8470621,Corey Perry,R,EDM,39,82,7,12,19
21,8481522,Peyton Krebs,C,BUF,23,82,7,12,19
21,8482720,Matthew Knies,L,TOR,22,82,5,14,19
21,8476331,Dylan DeMelo,D,WPG,31,82,5,14,19
21,8481028,Martin Pospisil,C,CGY,25,82,5,14,19
21,8483490,Pavel Mintyukov,D,ANA,21,82,4,15,19
21,8479371,Dante Fabbro,D,NSH,26,82,4,15,19
21,8481605,Jackson LaCombe,D,ANA,23,82,4,15,19
21,8470600,Ryan Suter,D,DAL,39,82,3,16,19
21,8470966,Mark Giordano,D,TOR,41,82,3,16,19
21,8481059,Scott Perunovich,D,STL,26,82,3,16,19
21,8477365,Connor Clifton,D,BUF,29,82,3,16,19
21,8476429,Scott Mayfield,D,NYI,32,82,2,17,19
21,8481517,Brett Leason,R,ANA,25,82,12,6,18
21,8480448,Parker Kelly,L,OTT,25,82,10,8,18
21,8478109,Victor Olofsson,L,BUF,29,82,8,10,18
21,8479661,Tanner Jeannot,L,TBL,27,82,8,10,18
21,8479359,Beck Malenstyn,L,WSH,26,82,8,10,18
21,8473504,Cal Clutterbuck,R,NYI,37,82,7,11,18
21,8482111,Justin Barron,D,MTL,23,82,6,12,18
21,8477505,Alexander Wennberg,C,NYR,30,82,6,12,18
21,8476473,Connor Murphy,D,CHI,31,82,5,13,18
21,8476917,Adam Pelech,D,NYI,30,82,4,14,18
21,8477845,Trevor van Riemsdyk,D,WSH,33,82,3,15,18
21,8480796,Martin Fehervary,D,WSH,25,82,3,15,18
21,8477435,Ryan Graves,D,PIT,29,82,2,16,18
21,8477499,Rasmus Ristolainen,D,PHI,30,82,2,16,18
21,8476879,Cody Ceci,D,EDM,31,82,1,17,18
21,8476871,Tanner Pearson,L,MTL,32,82,7,10,17
21,8477392,Hudson Fasching,R,NYI,29,82,7,10,17
21,8476278,Colin Blackwell,C,CHI,31,82,6,11,17
21,8476467,Jamie Oleksiak,D,SEA,32,82,6,11,17
21,8483495,Simon Nemec,D,NJD,20,82,5,12,17
21,8480834,Ty Emberson,D,SJS,24,82,3,14,17
21,8482516,Matthew Kessel,D,STL,24,82,3,14,17
21,8482858,Ryker Evans,D,SEA,23,82,3,14,17
21,8475324,Nick Jensen,D,WSH,34,82,1,16,17
21,8476915,Jujhar Khaira,L,MIN,30,82,9,7,16
21,8482737,Zack Bolduc,C,STL,21,82,7,9,16
21,8481524,Bowen Byram,D,BUF,23,82,7,9,16
21,8481093,Rafael Harvey-Pinard,L,MTL,25,82,7,9,16
21,8476858,Phillip Di Giuseppe,L,VAN,31,82,7,9,16
21,8480879,Jacob Bernard-Docker,D,OTT,24,82,5,11,16
21,8478430,Oliver Kylington,D,CGY,27,82,4,12,16
21,8478859,Niko Mikkola,D,FLA,28,82,4,12,16
21,8480035,Henri Jokiharju,D,BUF,25,82,1,15,16
21,8475690,Chris Tanev,D,DAL,35,82,6,9,15
21,8481014,Alexander Romanov,D,NYI,24,82,5,10,15
21,8479591,Michael Eyssimont,C,TBL,28,82,4,11,15
21,8480144,David Kampf,C,TOR,29,82,4,11,15
21,8479442,Troy Stecher,D,EDM,30,82,4,11,15
21,8474013,Ian Cole,D,VAN,35,82,3,12,15
21,8475279,Ben Chiarot,D,DET,33,82,3,12,15
21,8480073,Erik Brannstrom,D,OTT,25,82,2,13,15
21,8479980,Nicolas Hague,D,VGK,26,82,2,13,15
21,8476372,Nick Seeler,D,PHI,31,82,2,13,15
21,8475790,Erik Gudbranson,D,CBJ,32,82,1,14,15
21,8476457,Adam Larsson,D,SEA,32,82,1,14,15
21,8475179,Dmitry Kulikov,D,FLA,34,82,1,14,15
21,8482809,Jackson Blake,R,CAR,21,82,9,5,14
21,8479291,Kevin Rooney,C,CGY,31,82,7,7,14
21,8476442,Matt Nieto,L,PIT,32,82,7,7,14
21,8478831,Kevin Stenlund,C,FLA,28,82,5,9,14
21,8482762,Simon Edvinsson,D,DET,21,82,5,9,14
21,8475825,Jani Hakanpää,D,DAL,32,82,4,10,14
21,8483763,Maksymilian Szuber,D,ARI,22,82,4,10,14
21,8482166,Shakir Mukhamadullin,D,SJS,22,82,3,11,14
21,8479369,Andrew Peeke,D,BOS,26,82,2,12,14
21,8475462,Radko Gudas,D,ANA,34,82,2,12,14
21,8478451,Ethan Bear,D,WSH,27,82,2,12,14
21,8473453,Trevor Lewis,C,LAK,37,82,6,7,13
21,8477034,Jaycob Megna,D,CHI,32,82,4,9,13
21,8482470,Ilya Solovyov,D,CGY,24,82,4,9,13
21,8484911,Collin Graf,R,SJS,22,82,2,11,13
21,8479998,Mikey Anderson,D,LAK,25,82,2,11,13
21,8477220,Nate Schmidt,D,WPG,33,82,1,12,13
21,8478882,Vladislav Gavrikov,D,LAK,29,82,6,6,12
21,8475177,Calvin de Haan,D,TBL,33,82,5,7,12
21,8475842,Sam Carrick,C,EDM,32,82,4,8,12
21,8471677,Jack Johnson,D,COL,37,82,4,8,12
21,8480990,Declan Chisholm,D,MIN,24,82,4,8,12
21,8482713,Mackie Samoskevich,R,FLA,22,82,4,8,12
21,8481537,Nikita Okhotiuk,D,CGY,24,82,2,10,12
21,8475762,Derek Forbort,D,BOS,32,82,2,10,12
21,8482679,Matt Coronato,R,CGY,22,82,4,7,11
21,8483565,Nick Blankenburg,D,CBJ,26,82,2,9,11
21,8476822,Luke Glendening,C,TBL,35,82,8,2,10
21,8483466,Kevin Korchinski,D,CHI,20,82,3,7,10
21,8483468,Jiri Kulich,C,BUF,20,82,4,5,9
21,8478468,Jeremy Lauzon,D,NSH,27,82,3,6,9
21,8482807,Ethan Del Mastro,D,CHI,21,82,2,7,9
21,8481030,Jack St. Ivany,D,PIT,25,82,0,9,9
21,8482177,Marat Khusnutdinov,C,MIN,22,82,2,6,8
21,8478408,Travis Dermott,D,ARI,28,82,3,4,7
21,8481578,Graeme Clarke,R,NJD,23,82,3,4,7
21,8474567,Zach Bogosian,D,MIN,34,82,0,7,7
21,8483489,Fraser Minten,C,TOR,31,82,3,3,6
21,8474166,Alec Martinez,D,VGK,37,82,1,5,6
21,8481599,Victor Soderstrom,D,ARI,23,82,1,5,6
21,8484149,Gavin Brindley,C,CBJ,20,82,0,6,6
21,8482859,Zack Ostapchuk,C,OTT,21,82,1,3,4
21,8482141,Lukas Cormier,D,VGK,22,0,0,0,0
21,8476988,Matt Benning,D,SJS,30,0,0,0,0
21,8480727,Zach Whitecloud,D,VGK,28,0,0,0,0
21,8480887,Jordan Harris,D,MTL,24,0,0,0,0
21,8478450,Parker Wotherspoon,D,BOS,27,0,0,0,0
21,8481812,Nikolai Knyzhov,D,SJS,27,0,0,0,0
21,8480001,Urho Vaakanainen,D,ANA,25,0,0,0,0
21,8482176,Wyatt Kaiser,D,CHI,22,0,0,0,0
21,8481122,Simon Benoit,D,TOR,26,0,0,0,0
21,8476441,Joel Edmundson,D,TOR,31,0,0,0,0
21,8480884,Calen Addison,D,SJS,24,0,0,0,0
21,8482511,Mason Lohrei,D,BOS,23,0,0,0,0
21,8482192,Isaak Phillips,D,CHI,23,0,0,0,0
21,8480950,Ilya Lyubushkin,D,TOR,30,0,0,0,0
21,8474031,Kevin Shattenkirk,D,BOS,35,0,0,0,0
21,8475718,Justin Holl,D,DET,32,0,0,0,0
21,8479402,Jake Bean,D,CBJ,26,0,0,0,0
21,8474602,Justin Schultz,D,SEA,34,0,0,0,0
21,8477950,Tony DeAngelo,D,CAR,29,0,0,0,0
21,8481743,Marc Del Gaizo,D,NSH,25,0,0,0,0
21,8481527,Kaedan Korczak,D,VGK,23,0,0,0,0
21,8480192,Johnathan Kovacevic,D,MTL,27,0,0,0,0
21,8476874,Olli Maatta,D,DET,30,0,0,0,0
21,8482144,Jack Thompson,D,SJS,22,0,0,0,0
21,8480222,Sebastian Aho,D,NYI,28,0,0,0,0
21,8479458,Nikita Zaitsev,D,CHI,33,0,0,0,0
21,8471709,Marc-Edouard Vlasic,D,SJS,37,0,0,0,0
21,8482929,Emil Lilleberg,D,TBL,23,0,0,0,0
21,8477018,Ben Hutton,D,VGK,31,0,0,0,0
21,8481056,Spencer Stastney,D,NSH,24,0,0,0,0
21,8481593,Jayden Struble,D,MTL,23,0,0,0,0
21,8479982,Conor Timmins,D,TOR,26,0,0,0,0
21,8474090,Brendan Smith,D,NJD,35,0,0,0,0
21,8482964,Arber Xhekaj,D,MTL,23,0,0,0,0
21,8480891,Michael Kesselring,D,ARI,24,0,0,0,0
21,8477938,Haydn Fleury,D,TBL,28,0,0,0,0
21,8481806,Louis Crevier,D,CHI,23,0,0,0,0
21,8471274,Alex Goligoski,D,MIN,39,0,0,0,0
21,8481600,Tobias Bjornfot,D,FLA,23,0,0,0,0
21,8475797,Jarred Tinordi,D,CHI,32,0,0,0,0
21,8481521,Ronnie Attard,D,PHI,25,0,0,0,0
21,8474612,Travis Hamonic,D,OTT,34,0,0,0,0
21,8479576,Vincent Desharnais,D,EDM,28,0,0,0,0
21,8480049,Dylan Samberg,D,WPG,25,0,0,0,0
21,8483619,Filip Roos,D,CHI,25,0,0,0,0
21,8474568,Luke Schenn,D,NSH,35,0,0,0,0
21,8480184,Gustav Lindstrom,D,ANA,26,0,0,0,0
21,8480070,Ian Mitchell,D,BOS,25,0,0,0,0
21,8480196,Jacob Bryson,D,BUF,27,0,0,0,0
21,8471686,Marc Staal,D,PHI,37,0,0,0,0
21,8477467,Gustav Olofsson,D,SEA,30,0,0,0,0
21,8478970,Jalen Chatfield,D,CAR,28,0,0,0,0
21,8479348,Kale Clague,D,BUF,26,0,0,0,0
21,8473446,Erik Johnson,D,PHI,36,0,0,0,0
21,8477462,Robert Hagg,D,ANA,29,0,0,0,0
21,8478454,Noah Juulsen,D,VAN,27,0,0,0,0
21,8477384,Josh Brown,D,ARI,30,0,0,0,0
21,8481708,Zac Jones,D,NYR,24,0,0,0,0
21,8481167,Brayden Pachal,D,CGY,25,0,0,0,0
21,8482067,Connor Mackey,D,NYR,28,0,0,0,0
21,8483460,David Jiricek,D,CBJ,21,0,0,0,0
21,8481701,Santeri Hatakka,D,NJD,23,0,0,0,0
21,8478021,William Lagesson,D,ANA,28,0,0,0,0
21,8477851,Jordan Oesterle,D,CGY,32,0,0,0,0
21,8478452,Caleb Jones,D,COL,27,0,0,0,0
21,8479984,Cal Foote,D,NJD,26,0,0,0,0
21,8479639,Dylan Coghlan,D,CAR,26,0,0,0,0
21,8480874,Adam Ginning,D,PHI,24,0,0,0,0
21,8479321,Lucas Johansen,D,WSH,27,0,0,0,0
21,8480878,Nils Lundkvist,D,DAL,24,0,0,0,0
21,8482165,Yan Kuznetsov,D,CGY,22,0,0,0,0
21,8484258,Sam Malinski,D,COL,26,0,0,0,0
21,8480157,Calle Rosen,D,STL,30,0,0,0,0
21,8484304,Uvis Balinskis,D,FLA,28,0,0,0,0
21,8479985,Cale Fleury,D,SEA,26,0,0,0,0
21,8479378,Logan Stanley,D,WPG,26,0,0,0,0
21,8477541,Dakota Mermis,D,MIN,30,0,0,0,0
21,8481609,Vladislav Kolyachonok,D,ARI,23,0,0,0,0
21,8480823,Alexander Alexeyev,D,WSH,25,0,0,0,0
21,8481679,Maxence Guenette,D,OTT,23,0,0,0,0
21,8481564,Ryan Johnson,D,BUF,23,0,0,0,0
21,8479376,Victor Mete,D,PHI,26,0,0,0,0
21,8484254,Akito Hirose,D,VAN,25,0,0,0,0
21,8482660,Kent Johnson,C,CBJ,22,0,0,0,0
21,8482149,Cole Perfetti,C,WPG,22,0,0,0,0
21,8477987,Ryan Donato,C,CHI,28,0,0,0,0
21,8475755,Alexander Petrovic,D,DAL,32,0,0,0,0
21,8477810,Joel Hanley,D,CGY,33,0,0,0,0
21,8474145,Robert Bortuzzo,D,NYI,35,0,0,0,0
21,8481161,Jake Christiansen,D,CBJ,25,0,0,0,0
21,8476884,Derrick Pouliot,D,DAL,30,0,0,0,0
21,8481716,Dmitri Voronkov,L,CBJ,24,0,0,0,0
21,8480084,Nick DeSimone,D,NJD,30,0,0,0,0
21,8475750,Jon Merrill,D,MIN,32,0,0,0,0
21,8479315,Joey Anderson,R,CHI,26,0,0,0,0
21,8478011,Louie Belpedio,D,PHI,28,0,0,0,0
21,8482451,Mikael Pyyhtia,L,CBJ,23,0,0,0,0
21,8481541,Samuel Bolduc,D,NYI,24,0,0,0,0
21,8482126,Emil Andrae,D,PHI,31,0,0,0,0
21,8474618,Marco Scandella,D,STL,34,0,0,0,0
21,8477244,Chad Ruhwedel,D,NYR,34,0,0,0,0
21,8477971,Andreas Englund,D,LAK,28,0,0,0,0
21,8480829,Jesperi Kotkaniemi,C,CAR,24,0,0,0,0
21,8479372,Josh Mahura,D,FLA,26,0,0,0,0
21,8482095,Tyler Kleven,D,OTT,22,0,0,0,0
21,8481719,Maxwell Crozier,D,TBL,24,0,0,0,0
21,8475855,Jesper Fast,R,CAR,33,0,0,0,0
21,8480848,Ty Dellandrea,C,DAL,24,0,0,0,0
21,8475193,Tomas Tatar,L,SEA,34,0,0,0,0
21,8476889,Radek Faksa,C,DAL,30,0,0,0,0
21,8478495,Denis Gurianov,R,PHI,27,0,0,0,0
21,8480216,Jacob Peterson,C,SJS,25,0,0,0,0
21,8480252,Cole Guttman,C,CHI,25,0,0,0,0
21,8479026,Philippe Myers,D,TBL,27,0,0,0,0
21,8481006,Tyler Tucker,D,STL,24,0,0,0,0
21,8481032,Paul Cotter,C,VGK,25,0,0,0,0
21,8481577,Philip Tomasino,C,NSH,23,0,0,0,0
21,8476918,Jimmy Vesey,L,NYR,31,0,0,0,0
21,8479320,Max Lajoie,D,TOR,27,0,0,0,0
21,8478017,Mark Friedman,D,VAN,29,0,0,0,0
21,8481754,Nikita Nesterenko,C,ANA,23,0,0,0,0
21,8483407,Brandon Scanlin,D,NYR,25,0,0,0,0
21,8482659,Josh Doan,R,ARI,22,0,0,0,0
21,8477446,Michael McCarron,R,NSH,29,0,0,0,0
21,8477903,Garnet Hathaway,R,PHI,33,0,0,0,0
21,8482153,Brendan Brisson,C,VGK,23,0,0,0,0
21,8483546,Marshall Rifai,D,TOR,26,0,0,0,0
21,8484287,Cole McWard,D,VAN,23,0,0,0,0
21,8478854,Ryan Shea,D,PIT,27,0,0,0,0
21,8481585,Egor Afanasyev,L,NSH,23,0,0,0,0
21,8483398,Declan Carlile,D,TBL,31,0,0,0,0
21,8478502,Dennis Gilbert,D,CGY,28,0,0,0,0
21,8482749,Joshua Roy,R,MTL,21,0,0,0,0
21,8481598,Philip Broberg,D,EDM,23,0,0,0,0
21,8480835,Jack Drury,C,CAR,24,0,0,0,0
21,8480748,Kiefer Sherwood,L,NSH,29,0,0,0,0
21,8476934,Brock McGinn,L,ANA,30,0,0,0,0
21,8480870,Bo Groulx,C,ANA,24,0,0,0,0
21,8479368,Max Jones,L,ANA,26,0,0,0,0
21,8478099,Kevin Labanc,R,SJS,29,0,0,0,0
21,8478067,Oskar Lindblom,L,SJS,28,0,0,0,0
21,8476393,Nick Cousins,C,FLA,31,0,0,0,0
21,8483395,Arshdeep Bains,L,VAN,23,0,0,0,0
21,8480762,Eric Robinson,L,BUF,29,0,0,0,0
21,8479439,Jacob MacDonald,D,SJS,31,0,0,0,0
21,8476474,Stefan Noesen,R,CAR,31,0,0,0,0
21,8482787,Nikita Chibrikov,R,WPG,31,0,0,0,0
21,8478432,Christian Fischer,R,DET,27,0,0,0,0
21,8477979,Nicolas Aube-Kubel,R,WSH,28,0,0,0,0
21,8481789,Tye Kartye,L,SEA,23,0,0,0,0
21,8479330,Brandon Gignac,C,MTL,27,0,0,0,0
21,8480075,Cameron Crotty,D,ARI,25,0,0,0,0
21,8473473,Milan Lucic,L,BOS,36,0,0,0,0
21,8482094,Daemon Hunt,D,MIN,22,0,0,0,0
21,8481206,John Ludvig,D,PIT,24,0,0,0,0
21,8483630,Pavol Regenda,L,ANA,25,0,0,0,0
21,8481617,Vasily Podkolzin,R,VAN,23,0,0,0,0
21,8480306,Grant Hutton,D,NYI,29,0,0,0,0
21,8480995,Pontus Holmberg,R,TOR,25,0,0,0,0
21,8482148,Hendrix Lapierre,C,WSH,22,0,0,0,0
21,8477478,William Carrier,L,VGK,30,0,0,0,0
21,8480003,Jesper Boqvist,C,BOS,26,0,0,0,0
21,8482172,Landon Slaggert,L,CHI,22,0,0,0,0
21,8480789,Oliver Wahlstrom,R,NYI,24,0,0,0,0
21,8474062,Riley Nash,C,NYR,35,0,0,0,0
21,8480021,Jack Studnicka,C,SJS,25,0,0,0,0
21,8480025,MacKenzie Entwistle,R,CHI,25,0,0,0,0
21,8481582,Nicholas Robertson,L,TOR,23,0,0,0,0
21,8476867,Brendan Gaunce,C,CBJ,30,0,0,0,0
21,8479619,Michael Carcone,L,ARI,28,0,0,0,0
21,8479370,Tyson Jost,C,BUF,26,0,0,0,0
21,8479671,Mathieu Olivier,R,CBJ,27,0,0,0,0
21,8476994,Vinnie Hinostroza,C,PIT,30,0,0,0,0
21,8482070,Mitchell Chaffee,R,TBL,26,0,0,0,0
21,8477473,Justin Bailey,R,SJS,29,0,0,0,0
21,8479344,Jesse Puljujarvi,R,PIT,26,0,0,0,0
21,8480205,Emil Bemstrom,C,PIT,25,0,0,0,0
21,8479718,Alex Barré-Boulet,C,TBL,27,0,0,0,0
21,8482061,Brandon Biro,L,BUF,26,0,0,0,0
21,8479638,Justin Brazeau,R,BOS,26,0,0,0,0
21,8474040,Sam Gagner,C,EDM,35,0,0,0,0
21,8477846,Ryan Carpenter,C,SJS,33,0,0,0,0
21,8482077,Dylan Holloway,L,EDM,23,0,0,0,0
21,8482157,Will Cuylle,L,NYR,22,0,0,0,0
21,8480007,Jonas Rondbjerg,R,VGK,25,0,0,0,0
21,8478874,Adam Gaudette,C,STL,28,0,0,0,0
21,8478434,Keegan Kolesar,R,VGK,27,0,0,0,0
21,8480441,Trey Fix-Wolansky,R,CBJ,25,0,0,0,0
21,8479994,Jaret Anderson-Dolan,C,NSH,25,0,0,0,0
21,8483567,Georgii Merkulov,C,BOS,24,0,0,0,0
21,8477380,Jonny Brodzinski,C,NYR,31,0,0,0,0
21,8482201,Gage Goncalves,C,TBL,23,0,0,0,0
21,8478211,Dryden Hunt,L,CGY,29,0,0,0,0
21,8471699,Andrew Cogliano,C,COL,37,0,0,0,0
21,8479421,Jacob Moverare,D,LAK,26,0,0,0,0
21,8478881,Brett Seney,L,CHI,28,0,0,0,0
21,8477464,Nic Petan,C,MIN,29,0,0,0,0
21,8475958,Michael Sgarbossa,C,WSH,32,0,0,0,0
21,8481147,Reese Johnson,C,CHI,26,0,0,0,0
21,8479336,Carl Grundstrom,R,LAK,27,0,0,0,0
21,8480853,Liam Foudy,C,NSH,24,0,0,0,0
21,8479522,Hardy Haman Aktell,D,WSH,26,0,0,0,0
21,8481462,Mason Morelli,L,VGK,28,0,0,0,0
21,8482102,Vasily Ponomarev,C,CAR,22,0,0,0,0
21,8480844,Grigori Denisenko,L,VGK,24,0,0,0,0
21,8479944,Zach Aston-Reese,C,DET,30,0,0,0,0
21,8482784,Zach Dean,C,STL,21,0,0,0,0
21,8479419,Brett Murray,L,BUF,26,0,0,0,0
21,8479520,Brandon Duhaime,R,COL,27,0,0,0,0
21,8477573,Nathan Walker,L,STL,30,0,0,0,0
21,8478078,Rourke Chartier,C,OTT,28,0,0,0,0
21,8475795,Dylan McIlrath,D,WSH,32,0,0,0,0
21,8482496,Nils Aman,C,VAN,24,0,0,0,0
21,8480289,Morgan Barron,C,WPG,26,0,0,0,0
21,8481751,Lukas Rousek,R,BUF,25,0,0,0,0
21,8480011,Klim Kostin,C,SJS,25,0,0,0,0
21,8481556,John Beecher,C,BOS,23,0,0,0,0
21,8475278,Byron Froese,C,VGK,33,0,0,0,0
21,8475225,Craig Smith,C,DAL,35,0,0,0,0
21,8484326,Patrik Koch,D,ARI,28,0,0,0,0
21,8477930,Pierre-Edouard Bellemare,L,SEA,39,0,0,0,0
21,8478409,Anthony Richard,C,BOS,28,0,0,0,0
21,8481024,Linus Karlsson,C,VAN,25,0,0,0,0
21,8479986,Kole Lind,R,SEA,26,0,0,0,0
21,8479414,Nathan Bastian,R,NJD,27,0,0,0,0
21,8479362,Riley Tufte,L,COL,26,0,0,0,0
21,8481058,Jesse Ylönen,R,MTL,25,0,0,0,0
21,8482476,Emil Heineman,L,MTL,23,0,0,0,0
21,8482861,Vincent Iorio,D,WSH,22,0,0,0,0
21,8483432,Luca Del Bel Belluz,C,CBJ,31,0,0,0,0
21,8482744,James Malatesta,L,CBJ,21,0,0,0,0
21,8477887,Patrick Brown,C,BOS,32,0,0,0,0
21,8478585,Derek Ryan,C,EDM,38,0,0,0,0
21,8481441,Joe Snively,C,WSH,28,0,0,0,0
21,8481592,Jakob Pelletier,L,CGY,23,0,0,0,0
21,8482634,Alex Steeves,C,TOR,25,0,0,0,0
21,8477126,Jayson Megna,C,BOS,34,0,0,0,0
21,8475752,Tyler Pitlick,C,NYR,33,0,0,0,0
21,8480008,Adam Ruzicka,C,ARI,25,0,0,0,0
21,8481065,Angus Crookshank,L,OTT,25,0,0,0,0
21,8479547,Matthew Phillips,R,WSH,26,0,0,0,0
21,8480226,Marián Studenic,R,SEA,26,0,0,0,0
21,8481237,Kyle MacLean,C,NYI,25,0,0,0,0
21,8475413,Justin Dowling,C,NJD,34,0,0,0,0
21,8481641,Joel Kiviranta,L,COL,28,0,0,0,0
21,8478104,Sammy Blais,L,STL,28,0,0,0,0
21,8477454,Adam Erne,L,EDM,29,0,0,0,0
21,8481518,Nolan Foote,L,NJD,24,0,0,0,0
21,8480245,Olle Lycksell,R,PHI,25,0,0,0,0
21,8483570,Ben Meyers,C,ANA,26,0,0,0,0
21,8480776,Sheldon Rempal,R,VGK,29,0,0,0,0
21,8483920,Pierrick Dube,R,WSH,23,0,0,0,0
21,8480267,Sammy Walker,C,MIN,25,0,0,0,0
21,8482747,Brennan Othmann,L,NYR,21,0,0,0,0
21,8479991,Jake Leschyshyn,C,NYR,25,0,0,0,0
21,8478400,Colin White,C,MTL,27,0,0,0,0
21,8479328,Julien Gauthier,R,NYI,27,0,0,0,0
21,8484325,Waltteri Merela,C,TBL,26,0,0,0,0
21,8479066,Ryan Lomberg,L,FLA,30,0,0,0,0
21,8477070,Liam O'Brien,C,ARI,30,0,0,0,0
21,8478146,Matthew Highmore,C,OTT,28,0,0,0,0
21,8478028,Fredrik Olofsson,L,COL,28,0,0,0,0
21,8480880,Jakub Lauko,C,BOS,24,0,0,0,0
21,8479968,Vinni Lettieri,C,MIN,29,0,0,0,0
21,8474709,Matt Martin,L,NYI,35,0,0,0,0
21,8480845,Rasmus Kupari,C,WPG,24,0,0,0,0
21,8481550,Adam Beckman,L,MIN,23,0,0,0,0
21,8481422,Jacob Lucchini,C,MIN,29,0,0,0,0
21,8477401,John Hayden,C,SEA,29,0,0,0,0
21,8478904,Steven Lorentz,C,FLA,28,0,0,0,0
21,8482088,Justin Sourdif,R,FLA,22,0,0,0,0
21,8482751,Ryan Winterton,C,SEA,21,0,0,0,0
21,8482241,Radim Zohorna,L,PIT,28,0,0,0,0
21,8481690,Tyler Angle,C,CBJ,24,0,0,0,0
21,8476952,Dominic Toninato,C,WPG,30,0,0,0,0
21,8476919,Chris Tierney,C,NJD,30,0,0,0,0
21,8480032,Shane Bowers,C,NJD,25,0,0,0,0
21,8484314,Jiri Smejkal,L,OTT,28,0,0,0,0
21,8481239,Samuel Fagemo,L,LAK,24,0,0,0,0
21,8481532,Alex Turcotte,C,LAK,23,0,0,0,0
21,8481019,David Gustafsson,C,WPG,24,0,0,0,0
21,8478477,Mitchell Stephens,C,MTL,27,0,0,0,0
21,8479546,Oskar Steen,C,BOS,26,0,0,0,0
21,8480292,Carson Meyer,R,CBJ,27,0,0,0,0
21,8478446,Glenn Gawdin,C,ANA,27,0,0,0,0
21,8483531,Brian Halonen,L,NJD,25,0,0,0,0
21,8477149,Scott Sabourin,R,SJS,32,0,0,0,0
21,8479972,Mason Shaw,C,MIN,26,0,0,0,0
21,8480890,Jan Jenik,R,ARI,24,0,0,0,0
21,8478051,Max Willman,C,NJD,29,0,0,0,0
21,8480851,Akil Thomas,C,LAK,24,0,0,0,0
21,8482765,Isak Rosen,R,BUF,21,0,0,0,0
21,8478421,A.J. Greer,L,CGY,28,0,0,0,0
21,8478512,Austin Czarnik,C,DET,32,0,0,0,0
21,8479536,Axel Jonsson-Fjallby,L,WPG,26,0,0,0,0
21,8477320,Anton Blidh,L,NYR,29,0,0,0,0
21,8481543,Nikita Alexandrov,C,STL,24,0,0,0,0
21,8475235,Nicolas Deslauriers,L,PHI,33,0,0,0,0
21,8481070,Hugh McGing,L,STL,26,0,0,0,0
21,8480836,Jonathan Gruden,C,PIT,24,0,0,0,0
21,8481591,Sam Poulin,R,PIT,23,0,0,0,0
21,8477962,Brendan Lemieux,L,CAR,28,0,0,0,0
21,8483401,Marc Johnstone,R,PIT,28,0,0,0,0
21,8482250,Callahan Burke,C,CAR,27,0,0,0,0
21,8481726,Adam Edstrom,C,NYR,24,0,0,0,0
21,8471817,Ryan Reaves,R,TOR,37,0,0,0,0
21,8479587,Rhett Gardner,C,PHI,28,0,0,0,0
21,8475766,Austin Watson,L,TBL,32,0,0,0,0
21,8479367,William Lockwood,R,FLA,26,0,0,0,0
21,8478424,Jansen Harkins,C,PIT,27,0,0,0,0
21,8476913,Devin Shore,C,SEA,30,0,0,0,0
21,8482652,Walker Duehr,R,CGY,27,0,0,0,0
21,8477527,Ross Johnston,L,ANA,30,0,0,0,0
21,8481077,John Leonard,L,ARI,26,0,0,0,0
21,8483549,Lucas Condotta,L,MTL,27,0,0,0,0
21,8480468,James Hamblin,L,EDM,25,0,0,0,0
21,8476907,Mackenzie MacEachern,L,STL,30,0,0,0,0
21,8479543,Michael Pezzetta,L,MTL,26,0,0,0,0
21,8480355,Mark Kastelic,C,OTT,25,0,0,0,0
21,8482162,Roby Jarventie,L,OTT,22,0,0,0,0
21,8479772,Zack MacEwen,R,OTT,28,0,0,0,0
21,8483597,Milos Kelemen,L,ARI,25,0,0,0,0
21,8479379,Givani Smith,R,SJS,26,0,0,0,0
21,8481655,Cole Schwindt,R,CGY,23,0,0,0,0
21,8479981,Jonah Gadjovich,L,FLA,26,0,0,0,0
21,8482147,Jean-Luc Foudy,C,COL,22,0,0,0,0
21,8484255,Jason Polin,R,COL,25,0,0,0,0
21,8477993,Justin Kirkland,C,ARI,28,0,0,0,0
21,8479249,Andrew Poturalski,C,SEA,30,0,0,0,0
21,8482197,Adam Raska,R,MIN,23,0,0,0,0
21,8475780,Chris Wagner,R,COL,33,0,0,0,0
21,8479533,Joona Koppanen,L,PIT,26,0,0,0,0
21,8481534,Raphael Lavoie,C,EDM,24,0,0,0,0
21,8484321,Nikolas Matinpalo,D,OTT,26,0,0,0,0
21,8481043,Cole Koepke,L,TBL,26,0,0,0,0
21,8476323,Max McCormick,L,SEA,32,0,0,0,0
21,8483609,Adam Klapka,R,CGY,24,0,0,0,0
21,8483512,Matt Savoie,C,BUF,20,0,0,0,0
21,8484259,Ondrej Pavel,C,COL,31,0,0,0,0
21,8478147,Bokondji Imama,L,OTT,28,0,0,0,0
21,8482460,Matt Rempe,C,NYR,22,0,0,0,0
21,8477073,Kurtis MacDermid,L,NJD,30,0,0,0,0
21,8480274,Philip Kemp,D,EDM,25,0,0,0,0
21,8478956,Samuel Laberge,L,NJD,27,0,0,0,0
21,8483045,Cameron Butler,R,CBJ,31,0,0,0,0
22,8478402,Connor McDavid,C,EDM,27,82,38,83,121
22,8477934,Leon Draisaitl,C,EDM,29,82,47,62,109
22,8478010,Brayden Point,C,TBL,28,82,57,49,106
22,8479318,Auston Matthews,C,TOR,27,82,47,54,101
22,8476453,Nikita Kucherov,R,TBL,31,82,36,65,101
22,8471675,Sidney Crosby,C,PIT,37,82,44,56,100
22,8481559,Jack Hughes,C,NJD,23,82,48,49,97
22,8477956,David Pastrnak,R,BOS,28,82,39,58,97
22,8479314,Matthew Tkachuk,L,FLA,27,82,25,72,97
22,8480800,Quinn Hughes,D,VAN,25,82,15,82,97
22,8480069,Cale Makar,D,COL,26,82,20,75,95
22,8477404,Jake Guentzel,C,CAR,30,82,35,53,88
22,8477933,Sam Reinhart,C,FLA,29,82,49,38,87
22,8477493,Aleksander Barkov,C,FLA,29,82,30,56,86
22,8477492,Nathan MacKinnon,C,COL,29,82,39,45,84
22,8480012,Elias Pettersson,C,VAN,26,82,32,52,84
22,8478550,Artemi Panarin,L,NYR,33,82,29,55,84
22,8478864,Kirill Kaprizov,L,MIN,27,82,51,32,83
22,8478439,Travis Konecny,R,PHI,27,82,39,44,83
22,8480027,Jason Robertson,L,DAL,25,82,36,46,82
22,8479407,Jesper Bratt,L,NJD,26,82,24,58,82
22,8478420,Mikko Rantanen,R,COL,28,82,35,46,81
22,8476460,Mark Scheifele,C,WPG,31,82,32,48,80
22,8477939,William Nylander,R,TOR,28,82,29,51,80
22,8475692,Mats Zuccarello,R,MIN,37,82,16,63,79
22,8478398,Kyle Connor,L,WPG,28,82,34,44,78
22,8480002,Nico Hischier,C,NJD,25,82,34,44,78
22,8476459,Mika Zibanejad,C,NYR,31,82,27,50,77
22,8477942,Kevin Fiala,L,LAK,28,82,24,53,77
22,8479323,Adam Fox,D,NYR,26,82,14,62,76
22,8471214,Alex Ovechkin,L,WSH,39,82,41,34,75
22,8476887,Filip Forsberg,L,NSH,30,82,38,37,75
22,8476468,J.T. Miller,C,VAN,31,82,25,50,75
22,8476456,Jonathan Huberdeau,C,CGY,31,82,25,48,73
22,8480865,Noah Dobson,D,NYI,24,82,20,53,73
22,8481557,Matt Boldy,L,MIN,23,82,33,39,72
22,8474564,Steven Stamkos,C,TBL,34,82,23,49,72
22,8478427,Sebastian Aho,C,CAR,27,82,33,38,71
22,8478444,Brock Boeser,R,VAN,27,82,43,27,70
22,8477960,Adrian Kempe,R,LAK,28,82,32,38,70
22,8477949,Alex Tuch,R,BUF,28,82,28,42,70
22,8476454,Ryan Nugent-Hopkins,C,EDM,31,82,14,56,70
22,8480036,Miro Heiskanen,D,DAL,25,82,13,57,70
22,8477500,Bo Horvat,C,NYI,29,82,31,38,69
22,8478445,Mathew Barzal,C,NYI,27,82,20,49,69
22,8481523,Kirby Dach,C,MTL,23,82,15,54,69
22,8475810,Bryan Rust,R,PIT,32,82,36,32,68
22,8478403,Jack Eichel,C,VGK,28,82,28,40,68
22,8471215,Evgeni Malkin,C,PIT,38,82,15,53,68
22,8475184,Chris Kreider,L,NYR,33,82,43,24,67
22,8475754,Brock Nelson,C,NYI,33,82,35,32,67
22,8477955,Jared McCann,L,SEA,28,82,34,33,67
22,8470794,Joe Pavelski,C,DAL,40,82,24,43,67
22,8477496,Elias Lindholm,C,VAN,30,82,21,46,67
22,8479343,Clayton Keller,R,ARI,26,82,34,32,66
22,8480023,Robert Thomas,C,STL,25,82,21,45,66
22,8480031,Maxime Comtois,L,CAR,25,82,19,47,66
22,8480839,Rasmus Dahlin,D,BUF,24,82,13,53,66
22,8477409,Carter Verhaeghe,C,FLA,29,82,35,30,65
22,8475784,Jeff Skinner,C,BUF,32,82,34,31,65
22,8475726,Tyler Toffoli,C,WPG,32,82,31,34,65
22,8479420,Tage Thompson,C,BUF,27,82,30,35,65
22,8475168,Matt Duchene,C,DAL,33,82,23,41,64
22,8474578,Erik Karlsson,D,PIT,34,82,19,45,64
22,8478414,Timo Meier,R,NJD,28,82,32,31,63
22,8479542,Brandon Hagel,L,TBL,26,82,29,34,63
22,8475745,Charlie Coyle,C,BOS,32,82,27,36,63
22,8478401,Pavel Zacha,C,BOS,27,82,21,42,63
22,8475798,Mikael Granlund,C,SJS,32,82,16,47,63
22,8478460,Zach Werenski,D,CBJ,27,82,15,48,63
22,8480830,Andrei Svechnikov,R,CAR,24,82,25,37,62
22,8477501,Valeri Nichushkin,R,COL,29,82,24,38,62
22,8480803,Evan Bouchard,D,EDM,25,82,16,46,62
22,8478873,Troy Terry,R,ANA,27,82,28,33,61
22,8480208,Drake Batherson,R,OTT,26,82,27,34,61
22,8473419,Brad Marchand,L,BOS,36,82,18,42,60
22,8476346,Johnny Gaudreau,L,CBJ,31,82,18,42,60
22,8478407,Vince Dunn,D,SEA,28,82,14,45,59
22,8480801,Brady Tkachuk,L,OTT,25,82,30,28,58
22,8479337,Alex DeBrincat,R,DET,27,82,30,28,58
22,8477946,Dylan Larkin,C,DET,28,82,29,29,58
22,8478449,Roope Hintz,C,DAL,28,82,27,31,58
22,8476389,Vincent Trocheck,C,NYR,31,82,19,39,58
22,8474600,Roman Josi,D,NSH,34,82,19,39,58
22,8475167,Victor Hedman,D,TBL,34,82,10,48,58
22,8478493,Joel Eriksson Ek,C,MIN,27,82,24,33,57
22,8476881,Tomas Hertl,C,VGK,31,82,20,37,57
22,8475786,Zach Hyman,L,EDM,32,82,37,19,56
22,8479385,Jordan Kyrou,C,STL,26,82,29,27,56
22,8480039,Martin Necas,C,CAR,25,82,24,32,56
22,8475765,Vladimir Tarasenko,R,FLA,33,82,23,33,56
22,8475158,Ryan O'Reilly,C,NSH,33,82,20,36,56
22,8481533,Trevor Zegras,C,ANA,23,82,18,38,56
22,8475172,Nazem Kadri,C,CGY,34,82,16,40,56
22,8482116,Tim Stützle,C,OTT,22,82,13,43,56
22,8476448,William Karlsson,C,VGK,31,82,25,30,55
22,8475794,Tyler Seguin,C,DAL,32,82,23,32,55
22,8476432,Boone Jenner,C,CBJ,31,82,33,21,54
22,8476539,Jonathan Marchessault,R,VGK,34,82,30,24,54
22,8478047,Michael Bunting,L,PIT,29,82,19,35,54
22,8478440,Dylan Strome,C,WSH,27,82,18,36,54
22,8482684,Luke Hughes,D,NJD,21,82,17,37,54
22,8479325,Charlie McAvoy,D,BOS,27,82,11,43,54
22,8475166,John Tavares,C,TOR,34,82,27,26,53
22,8473994,Jamie Benn,L,DAL,35,82,19,34,53
22,8478466,Daniel Sprong,R,DET,27,82,18,35,53
22,8476399,Blake Coleman,C,CGY,33,82,28,24,52
22,8477951,Nick Schmaltz,C,ARI,28,82,25,27,52
22,8482078,Lucas Raymond,L,DET,22,82,19,33,52
22,8477402,Pavel Buchnevich,L,STL,29,82,19,33,52
22,8478438,Tommy Novak,C,NSH,27,82,18,34,52
22,8474679,Gustav Nyquist,C,NSH,35,82,17,35,52
22,8475151,Kyle Palmieri,C,NYI,33,82,32,19,51
22,8482109,Alexis Lafrenière,L,NYR,23,82,28,23,51
22,8474150,Mikael Backlund,C,CGY,35,82,22,29,51
22,8476483,Rickard Rakell,R,PIT,31,82,22,29,51
22,8473512,Claude Giroux,R,OTT,36,82,20,31,51
22,8477940,Nikolaj Ehlers,L,WPG,28,82,20,31,51
22,8478975,Mason Marchment,L,DAL,29,82,18,33,51
22,8477504,Josh Morrissey,D,WPG,29,82,15,36,51
22,8476853,Morgan Rielly,D,TOR,30,82,7,44,51
22,8480064,Josh Norris,C,OTT,25,82,24,26,50
22,8474586,Jordan Eberle,R,SEA,34,82,20,30,50
22,8480188,Fabian Zetterlund,L,SJS,25,82,20,30,50
22,8477447,Shea Theodore,D,VGK,29,82,16,34,50
22,8476462,Dougie Hamilton,D,NJD,31,82,12,38,50
22,8474590,John Carlson,D,WSH,34,82,11,39,50
22,8471724,Kris Letang,D,PIT,37,82,11,39,50
22,8480015,Owen Tippett,R,PHI,25,82,31,18,49
22,8478233,Andrew Mangiapane,L,CGY,28,82,24,25,49
22,8475191,Reilly Smith,R,PIT,33,82,23,26,49
22,8480797,Joel Farabee,L,PHI,24,82,20,29,49
22,8482740,Wyatt Johnston,C,DAL,21,82,18,31,49
22,8477497,Sean Monahan,C,WPG,30,82,17,32,49
22,8478542,Evan Rodrigues,C,FLA,31,82,16,33,49
22,8475744,Evgeny Kuznetsov,C,CAR,32,82,11,38,49
22,8476292,Ondrej Palat,L,NJD,33,82,23,25,48
22,8474141,Patrick Kane,R,DET,36,82,21,27,48
22,8475913,Mark Stone,R,VGK,32,82,19,29,48
22,8478519,Anthony Cirelli,C,TBL,27,82,19,29,48
22,8473986,Alex Killorn,L,ANA,35,82,19,29,48
22,8481528,Dylan Cozens,C,BUF,23,82,17,31,48
22,8481711,Matias Maccelli,L,ARI,24,82,11,37,48
22,8476905,Chandler Stephenson,C,VGK,30,82,10,38,48
22,8480014,Gabriel Vilardi,C,WPG,25,82,30,17,47
22,8478366,Frank Vatrano,R,ANA,30,82,26,21,47
22,8475287,Erik Haula,L,NJD,33,82,18,29,47
22,8476479,Phillip Danault,C,LAK,31,82,17,30,47
22,8480009,Eeli Tolvanen,R,SEA,25,82,16,31,47
22,8477998,Warren Foegele,L,EDM,28,82,16,31,47
22,8482097,Jack Quinn,R,BUF,23,82,15,32,47
22,8477986,Brandon Montour,D,FLA,30,82,14,33,47
22,8476958,Jaccob Slavin,D,CAR,30,82,12,35,47
22,8477444,Andre Burakovsky,L,SEA,29,82,20,26,46
22,8478462,Nicolas Roy,C,VGK,27,82,19,27,46
22,8477494,Jonathan Drouin,L,COL,29,82,13,33,46
22,8476882,Teuvo Teravainen,L,CAR,30,82,10,36,46
22,8479425,Filip Hronek,D,VAN,27,82,8,38,46
22,8478498,Jake DeBrusk,L,BOS,28,82,24,21,45
22,8475799,Nino Niederreiter,R,WPG,32,82,24,21,45
22,8481540,Cole Caufield,R,MTL,23,82,23,22,45
22,8477451,Ryan Hartman,R,MIN,30,82,23,22,45
22,8478042,Viktor Arvidsson,R,LAK,31,82,22,23,45
22,8482745,Mason McTavish,C,ANA,21,82,21,24,45
22,8481068,Yegor Sharangovich,C,CGY,26,82,20,25,45
22,8476880,Tom Wilson,R,WSH,30,82,20,25,45
22,8479992,Michael Rasmussen,C,DET,25,82,19,26,45
22,8482699,Dylan Guenther,R,ARI,21,82,18,27,45
22,8479400,Pierre-Luc Dubois,L,LAK,26,82,16,29,45
22,8483471,Brad Lambert,C,WPG,31,82,7,38,45
22,8475169,Evander Kane,L,EDM,33,82,21,23,44
22,8482665,Matty Beniers,C,SEA,22,82,20,24,44
22,8477479,Tyler Bertuzzi,L,TOR,29,82,20,24,44
22,8482159,Tyson Foerster,R,PHI,22,82,20,24,44
22,8476392,Adam Lowry,C,WPG,31,82,19,25,44
22,8481596,Shane Pinto,C,OTT,24,82,17,27,44
22,8482093,Seth Jarvis,C,CAR,22,82,16,28,44
22,8482110,Dawson Mercer,C,NJD,23,82,16,28,44
22,8479345,Jakob Chychrun,D,OTT,26,82,15,29,44
22,8480220,Noah Cates,L,PHI,25,82,14,30,44
22,8478396,Noah Hanifin,D,VGK,27,82,11,33,44
22,8480028,Morgan Frost,C,PHI,25,82,10,34,44
22,8474641,Adam Henrique,C,EDM,34,82,21,22,43
22,8477935,Sam Bennett,C,FLA,28,82,21,22,43
22,8471698,T.J. Oshie,R,WSH,38,82,18,25,43
22,8477416,Oliver Bjorkstrand,R,SEA,29,82,17,26,43
22,8476329,Travis Boyd,C,ARI,31,82,14,29,43
22,8478115,Pierre Engvall,L,NYI,28,82,13,30,43
22,8478038,Devon Toews,D,COL,30,82,11,32,43
22,8482101,Danil Gushchin,L,SJS,22,82,27,15,42
22,8477947,Sonny Milano,L,WSH,28,82,25,17,42
22,8475314,Anders Lee,L,NYI,34,82,25,17,42
22,8478046,Danton Heinen,L,BOS,29,82,24,18,42
22,8482222,Alexander Barabanov,L,SJS,30,82,21,21,42
22,8479339,Patrik Laine,L,CBJ,26,82,18,24,42
22,8479675,Trevor Moore,L,LAK,29,82,17,25,42
22,8482475,Yegor Chinakhov,R,CBJ,23,82,17,25,42
22,8480078,Filip Chytil,C,NYR,25,82,13,29,42
22,8478891,Mason Appleton,C,WPG,28,82,11,30,41
22,8479410,Mikhail Sergachev,D,TBL,26,82,7,34,41
22,8476875,Mike Matheson,D,MTL,30,82,7,34,41
22,8476923,Damon Severson,D,CBJ,30,82,7,34,41
22,8480018,Nick Suzuki,C,MTL,25,82,22,18,40
22,8475791,Taylor Hall,L,CHI,33,82,21,19,40
22,8479415,Michael McLeod,C,NJD,26,82,17,23,40
22,8470613,Brent Burns,D,CAR,39,82,11,29,40
22,8479987,Morgan Geekie,C,BOS,26,82,8,32,40
22,8476792,Torey Krug,D,STL,33,82,3,37,40
22,8483524,Shane Wright,C,SEA,20,82,30,9,39
22,8477511,Anthony Mantha,R,VGK,30,82,18,21,39
22,8478057,Dakota Joshua,C,VAN,28,82,18,21,39
22,8477989,Christian Dvorak,C,MTL,28,82,17,22,39
22,8481546,Cam York,D,PHI,23,82,13,26,39
22,8480434,Sean Durzi,D,ARI,26,82,11,28,39
22,8477346,MacKenzie Weegar,D,CGY,30,82,9,30,39
22,8480871,Adam Boqvist,D,CBJ,24,82,7,32,39
22,8475760,Nick Bjugstad,C,ARI,32,82,22,16,38
22,8483808,Andrei Kuzmenko,L,CGY,28,82,21,17,38
22,8479525,Ross Colton,C,COL,28,82,21,17,38
22,8477476,Artturi Lehkonen,L,COL,29,82,20,18,38
22,8476419,Jean-Gabriel Pageau,C,NYI,32,82,17,21,38
22,8470604,Jeff Carter,C,PIT,39,82,17,21,38
22,8477456,J.T. Compher,L,DET,29,82,15,23,38
22,8481560,Arthur Kaliyev,R,LAK,23,82,15,23,38
22,8471685,Anze Kopitar,C,LAK,37,82,14,24,38
22,8477021,Alex Kerfoot,C,ARI,30,82,12,26,38
22,8474053,Logan Couture,C,SJS,35,82,10,28,38
22,8476906,Shayne Gostisbehere,D,DET,31,82,9,29,38
22,8483445,Cutter Gauthier,L,ANA,20,82,9,29,38
22,8475200,Dmitry Orlov,D,CAR,33,82,9,29,38
22,8477503,Max Domi,C,TOR,29,82,9,29,38
22,8481542,Moritz Seider,D,DET,23,82,8,30,38
22,8477932,Aaron Ekblad,D,FLA,28,82,7,31,38
22,8474565,Alex Pietrangelo,D,VGK,34,82,4,34,38
22,8478397,Rasmus Andersson,D,CGY,28,82,3,35,38
22,8481618,Alex Newhook,C,MTL,23,82,18,19,37
22,8477426,Nicholas Paul,L,TBL,29,82,17,20,37
22,8474102,David Perron,L,DET,36,82,16,21,37
22,8471218,Blake Wheeler,R,NYR,38,82,16,21,37
22,8478856,Conor Garland,R,VAN,28,82,13,24,37
22,8476826,Yanni Gourde,C,SEA,33,82,13,24,37
22,8476872,Scott Laughton,C,PHI,30,82,12,25,37
22,8477948,Travis Sanheim,D,PHI,28,82,8,29,37
22,8480893,Kirill Marchenko,R,CBJ,24,82,19,17,36
22,8478474,Lawson Crouse,L,ARI,27,82,18,18,36
22,8477964,Ivan Barbashev,C,VGK,29,82,15,21,36
22,8482124,Quinton Byfield,R,LAK,22,82,14,22,36
22,8484144,Connor Bedard,C,CHI,19,82,13,23,36
22,8476960,Andreas Athanasiou,C,CHI,30,82,12,24,36
22,8479999,Casey Mittelstadt,C,COL,26,82,11,25,36
22,8479369,Andrew Peeke,D,BOS,26,82,8,28,36
22,8481699,Aku Raty,R,ARI,23,82,1,35,36
22,8484166,Adam Fantilli,C,CBJ,20,82,21,14,35
22,8482667,William Eklund,L,SJS,22,82,20,15,35
22,8482113,Anton Lundell,C,FLA,23,82,17,18,35
22,8478458,Jack Roslovic,C,NYR,27,82,14,21,35
22,8478469,Thomas Chabot,D,OTT,27,82,12,23,35
22,8482146,Luke Evangelista,R,NSH,22,82,12,23,35
22,8476458,Ryan Strome,C,ANA,31,82,12,23,35
22,8481581,Thomas Harley,D,DAL,23,82,10,25,35
22,8480798,Philipp Kurashev,C,CHI,25,82,9,26,35
22,8474563,Drew Doughty,D,LAK,35,82,8,27,35
22,8482122,Brock Faber,D,MIN,22,82,5,30,35
22,8474157,Max Pacioretty,L,WSH,36,82,21,13,34
22,8480459,Pius Suter,C,VAN,28,82,19,15,34
22,8477407,Anthony Duclair,L,TBL,29,82,16,18,34
22,8475722,Jason Zucker,L,NSH,32,82,14,20,34
22,8484145,Zach Benson,L,BUF,19,82,13,21,34
22,8476927,Teddy Blueger,C,VAN,30,82,12,22,34
22,8474189,Lars Eller,C,PIT,35,82,12,22,34
22,8475218,Mattias Ekholm,D,EDM,34,82,10,24,34
22,8480802,Ryan McLeod,C,EDM,25,82,9,25,34
22,8475753,Justin Faulk,D,STL,32,82,5,29,34
22,8477944,Jakub Vrana,L,STL,28,82,20,13,33
22,8474870,Tyler Johnson,C,CHI,34,82,19,14,33
22,8482175,JJ Peterka,R,BUF,22,82,18,15,33
22,8477952,Robby Fabbri,C,DET,28,82,17,16,33
22,8474037,James van Riemsdyk,L,BOS,35,82,14,19,33
22,8479941,Justin Danforth,R,CBJ,31,82,13,20,33
22,8478055,Gustav Forsling,D,FLA,28,82,11,22,33
22,8476854,Hampus Lindholm,D,BOS,30,82,10,23,33
22,8477495,Seth Jones,D,CHI,30,82,10,23,33
22,8474034,Pat Maroon,L,BOS,36,82,9,24,33
22,8482089,Jake Neighbours,L,STL,22,82,22,10,32
22,8475714,Calle Jarnkrok,C,TOR,33,82,22,10,32
22,8476869,Brady Skjei,D,CAR,30,82,16,16,32
22,8480849,Barrett Hayton,C,ARI,24,82,16,16,32
22,8481186,Logan O'Connor,R,COL,28,82,14,18,32
22,8475768,Jaden Schwartz,C,SEA,32,82,13,19,32
22,8477498,Darnell Nurse,D,EDM,29,82,13,19,32
22,8484153,Leo Carlsson,C,ANA,20,82,13,19,32
22,8475170,Brayden Schenn,C,STL,33,82,11,21,32
22,8479365,Trent Frederic,C,BOS,26,82,10,22,32
22,8482671,Owen Power,D,BUF,22,82,10,22,32
22,8481013,Jonatan Berggren,R,DET,24,82,7,25,32
22,8474716,Jared Spurgeon,D,MIN,35,82,6,26,32
22,8483457,Lane Hutson,D,MTL,20,82,5,27,32
22,8478472,Mathieu Joseph,R,OTT,27,82,18,13,31
22,8482624,Daniil Miromanov,D,CGY,27,82,13,18,31
22,8477839,Conor Sheary,L,TBL,32,82,13,18,31
22,8478109,Victor Olofsson,L,BUF,29,82,13,18,31
22,8481535,Nils Hoglander,L,VAN,24,82,12,19,31
22,8480113,Alex Iafallo,L,WPG,31,82,11,20,31
22,8477429,Andrew Copp,C,DET,30,82,8,23,31
22,8480145,Neal Pionk,D,WPG,29,82,7,24,31
22,8478840,Will Borgen,D,SEA,28,82,5,26,31
22,8477845,Trevor van Riemsdyk,D,WSH,33,82,5,26,31
22,8479423,Alex Nylander,L,CBJ,26,82,17,13,30
22,8482055,Drew O'Connor,L,PIT,26,82,16,14,30
22,8476921,Jordan Martinook,L,CAR,32,82,15,15,30
22,8477450,Jason Dickinson,C,CHI,29,82,14,16,30
22,8474884,Mike Hoffman,C,SJS,35,82,14,16,30
22,8476885,Jacob Trouba,D,NYR,30,82,13,17,30
22,8479346,Dillon Dube,C,CGY,26,82,13,17,30
22,8478463,Anthony Beauvillier,L,NSH,27,82,12,18,30
22,8477507,Nikita Zadorov,D,VAN,29,82,12,18,30
22,8479977,Kailer Yamamoto,R,SEA,26,82,11,19,30
22,8481522,Peyton Krebs,C,BUF,23,82,10,20,30
22,8482720,Matthew Knies,L,TOR,22,82,10,20,30
22,8474574,Tyler Myers,D,VAN,34,82,6,24,30
22,8476463,Jonas Brodin,D,MIN,31,82,6,24,30
22,8481016,Ruslan Iskhakov,C,NYI,24,82,3,27,30
22,8483397,Marc McLaughlin,C,BOS,25,82,24,5,29
22,8482092,Ridly Greig,C,OTT,22,82,14,15,29
22,8480068,Ryan Poehling,C,PHI,25,82,14,15,29
22,8483515,Juraj Slafkovsky,L,MTL,20,82,14,15,29
22,8483505,Matthew Poitras,C,BOS,20,82,14,15,29
22,8478043,Sam Lafferty,C,VAN,29,82,14,15,29
22,8479390,Taylor Raddysh,R,CHI,26,82,12,17,29
22,8476438,Brandon Saad,L,STL,32,82,11,18,29
22,8480074,Alexandre Texier,C,CBJ,25,82,10,19,29
22,8476979,Erik Gustafsson,D,NYR,32,82,9,20,29
22,8482730,Brandt Clarke,D,LAK,21,82,8,21,29
22,8478911,Matt Roy,D,LAK,29,82,8,21,29
22,8475181,Nick Leddy,D,STL,33,82,5,24,29
22,8482105,Jake Sanderson,D,OTT,22,82,3,26,29
22,8475763,Kevin Hayes,R,STL,32,82,15,13,28
22,8480185,Eetu Luostarinen,C,FLA,26,82,12,16,28
22,8476480,Vladislav Namestnikov,C,WPG,32,82,11,17,28
22,8481580,Connor McMichael,C,WSH,23,82,10,18,28
22,8482655,J.J. Moser,D,ARI,24,82,7,21,28
22,8475171,Oliver Ekman-Larsson,D,FLA,33,82,7,21,28
22,8481703,Valtteri Puustinen,R,PIT,25,82,6,22,28
22,8480817,K'Andre Miller,D,NYR,24,82,6,22,28
22,8476331,Dylan DeMelo,D,WPG,31,82,6,22,28
22,8476917,Adam Pelech,D,NYI,30,82,5,23,28
22,8477969,Marcus Pettersson,D,PIT,28,82,4,24,28
22,8476278,Colin Blackwell,C,CHI,31,82,15,12,27
22,8482079,Marco Rossi,C,MIN,23,82,14,13,27
22,8476925,Colton Sissons,C,NSH,31,82,13,14,27
22,8482074,Connor Zary,C,CGY,23,82,13,14,27
22,8479661,Tanner Jeannot,L,TBL,27,82,13,14,27
22,8478851,Alexandre Carrier,D,NSH,28,82,11,16,27
22,8473533,Jordan Staal,C,CAR,36,82,11,16,27
22,8482133,Thomas Bordeleau,C,SJS,22,82,9,18,27
22,8477508,Curtis Lazar,C,NJD,29,82,9,18,27
22,8476461,Sean Couturier,C,PHI,32,82,9,18,27
22,8481553,Bobby Brink,R,PHI,23,82,8,19,27
22,8482705,Cole Sillinger,C,CBJ,21,82,7,20,27
22,8480246,Nick Perbix,D,TBL,26,82,5,22,27
22,8476967,Brett Kulak,D,EDM,30,82,5,22,27
22,8475455,Brenden Dillon,D,WPG,34,82,4,23,27
22,8474673,TJ Brodie,D,TOR,34,82,4,23,27
22,8480873,Rasmus Sandin,D,WSH,24,82,2,25,27
22,8475793,Ryan Johansen,C,PHI,32,82,18,8,26
22,8481554,Kaapo Kakko,R,NYR,23,82,17,9,26
22,8481624,Ilya Mikheyev,R,VAN,30,82,16,10,26
22,8470610,Zach Parise,L,COL,40,82,16,10,26
22,8480813,Joe Veleno,C,DET,24,82,12,14,26
22,8481601,Simon Holmstrom,R,NYI,23,82,10,16,26
22,8473449,Kyle Okposo,R,FLA,36,82,10,16,26
22,8476892,Colton Parayko,D,STL,31,82,8,18,26
22,8475197,Tyson Barrie,D,NSH,33,82,6,20,26
22,8478507,John Marino,D,NJD,27,82,3,23,26
22,8476467,Jamie Oleksiak,D,SEA,32,82,2,24,26
22,8475764,Cam Fowler,D,ANA,33,82,1,25,26
22,8481604,Pavel Dorofeyev,L,VGK,24,82,19,6,25
22,8478413,Jordan Greenway,L,BUF,27,82,13,12,25
22,8479351,Sam Steel,C,DAL,26,82,13,12,25
22,8482702,Logan Stankoven,C,DAL,21,82,12,13,25
22,8473422,Nick Foligno,L,CHI,37,82,11,14,25
22,8479591,Michael Eyssimont,C,TBL,28,82,11,14,25
22,8475149,Marcus Johansson,L,MIN,34,82,10,15,25
22,8478013,Jake Walman,D,DET,28,82,10,15,25
22,8476422,Mike Reilly,D,NYI,31,82,8,17,25
22,8481656,Aliaksei Protas,C,WSH,23,82,6,19,25
22,8479983,Mario Ferraro,D,SJS,26,82,6,19,25
22,8482142,Jamie Drysdale,D,PHI,22,82,5,20,25
22,8478500,Ivan Provorov,D,CBJ,27,82,4,21,25
22,8478178,Darren Raddysh,D,TBL,28,82,4,21,25
22,8476429,Scott Mayfield,D,NYI,32,82,2,23,25
22,8482125,Alexander Holtz,R,NJD,22,82,12,12,24
22,8476469,Joel Armia,R,MTL,31,82,11,13,24
22,8481704,Juuso Parssinen,C,NSH,23,82,11,13,24
22,8476374,Sean Kuraly,C,CBJ,31,82,9,15,24
22,8470621,Corey Perry,R,EDM,39,82,9,15,24
22,8482117,Lukas Reichel,L,CHI,22,82,8,16,24
22,8480860,Kevin Bahl,D,NJD,24,82,7,17,24
22,8475906,John Klingberg,D,TOR,32,82,6,18,24
22,8481524,Bowen Byram,D,BUF,23,82,6,18,24
22,8477919,Frederick Gaudreau,C,MIN,31,82,5,19,24
22,8483495,Simon Nemec,D,NJD,20,82,5,19,24
22,8476931,Jake McCabe,D,TOR,31,82,3,21,24
22,8480073,Erik Brannstrom,D,OTT,25,82,3,21,24
22,8474149,Evgenii Dadonov,R,DAL,35,82,13,10,23
22,8480806,Isac Lundestrom,C,ANA,25,82,13,10,23
22,8479393,Noah Gregor,C,TOR,26,82,12,11,23
22,8476873,Mark Jankowski,C,NSH,30,82,12,11,23
22,8475343,Nic Dowd,C,WSH,34,82,11,12,23
22,8478508,Yakov Trenin,C,COL,27,82,11,12,23
22,8481477,Nico Sturm,C,SJS,29,82,9,14,23
22,8479514,Rem Pitlick,C,CHI,27,82,9,14,23
22,8477353,Tyler Motte,C,TBL,29,82,8,15,23
22,8478416,Erik Cernak,D,TBL,27,82,6,17,23
22,8477369,Carson Soucy,D,VAN,30,82,5,18,23
22,8479398,Samuel Girard,D,COL,26,82,4,19,23
22,8482803,Olen Zellweger,D,ANA,21,82,4,19,23
22,8475208,Brian Dumoulin,D,SEA,33,82,4,19,23
22,8477506,Ryan Pulock,D,NYI,30,82,2,21,23
22,8483490,Pavel Mintyukov,D,ANA,21,82,2,21,23
22,8482118,Sam Colangelo,R,ANA,23,82,16,6,22
22,8477330,Dominik Kubalik,L,OTT,29,82,14,8,22
22,8481517,Brett Leason,R,ANA,25,82,13,9,22
22,8476878,Zemgus Girgensons,L,BUF,30,82,12,10,22
22,8478569,Noel Acciari,C,PIT,33,82,12,10,22
22,8479293,Brandon Tanev,L,SEA,33,82,11,11,22
22,8481606,Jordan Spence,D,LAK,23,82,8,14,22
22,8480043,Timothy Liljegren,D,TOR,25,82,7,15,22
22,8476897,Oskar Sundqvist,C,STL,30,82,6,16,22
22,8477488,Brett Pesce,D,CAR,30,82,6,16,22
22,8475842,Sam Carrick,C,EDM,32,82,15,6,21
22,8477953,Kasperi Kapanen,R,STL,28,82,10,11,21
22,8475220,Marcus Foligno,L,MIN,33,82,9,12,21
22,8475848,Brendan Gallagher,R,MTL,32,82,9,12,21
22,8474715,Cam Atkinson,R,PHI,35,82,8,13,21
22,8479976,Juuso Valimaki,D,ARI,26,82,7,14,21
22,8479371,Dante Fabbro,D,NSH,26,82,6,15,21
22,8473507,Jeff Petry,D,DET,37,82,5,16,21
22,8481014,Alexander Romanov,D,NYI,24,82,5,16,21
22,8476525,Colin Miller,D,WPG,32,82,4,17,21
22,8479998,Mikey Anderson,D,LAK,25,82,3,18,21
22,8475690,Chris Tanev,D,DAL,35,82,2,19,21
22,8483431,Logan Cooley,C,ARI,20,82,11,9,20
22,8480281,Alexey Toropchenko,R,STL,25,82,10,10,20
22,8481028,Martin Pospisil,C,CGY,25,82,8,12,20
22,8481481,Blake Lizotte,C,LAK,27,82,7,13,20
22,8480448,Parker Kelly,L,OTT,25,82,7,13,20
22,8477435,Ryan Graves,D,PIT,29,82,7,13,20
22,8475164,Jakob Silfverberg,R,ANA,34,82,6,14,20
22,8476902,Esa Lindell,D,DAL,30,82,5,15,20
22,8480821,Filip Zadina,R,SJS,25,82,5,15,20
22,8482062,Cole Smith,L,NSH,29,82,5,15,20
22,8481605,Jackson LaCombe,D,ANA,23,82,2,18,20
22,8477499,Rasmus Ristolainen,D,PHI,30,82,1,19,20
22,8482145,Mavrik Bourque,C,DAL,22,82,16,3,19
22,8482155,Alex Laferriere,R,LAK,23,82,12,7,19
22,8483493,Frank Nazar,C,CHI,20,82,11,8,19
22,8476981,Josh Anderson,R,MTL,30,82,11,8,19
22,8482737,Zack Bolduc,C,STL,21,82,11,8,19
22,8475231,Casey Cizikas,C,NYI,33,82,10,9,19
22,8478831,Kevin Stenlund,C,FLA,28,82,9,10,19
22,8483499,Liam Ohgren,L,MIN,20,82,8,11,19
22,8480807,Mattias Samuelsson,D,BUF,24,82,8,11,19
22,8479353,Brett Howden,C,VGK,26,82,8,11,19
22,8473563,Nicklas Backstrom,C,WSH,37,82,7,12,19
22,8478133,Jake Evans,C,MTL,28,82,7,12,19
22,8482073,Braden Schneider,D,NYR,23,82,6,13,19
22,8476624,Barclay Goodrow,C,NYR,31,82,6,13,19
22,8480990,Declan Chisholm,D,MIN,24,82,6,13,19
22,8476891,Matt Grzelcyk,D,BOS,30,82,5,14,19
22,8478430,Oliver Kylington,D,CGY,27,82,5,14,19
22,8480035,Henri Jokiharju,D,BUF,25,82,5,14,19
22,8479996,Cody Glass,C,NSH,25,82,4,15,19
22,8474151,Ryan McDonagh,D,NSH,35,82,4,15,19
22,8474009,Nick Bonino,C,NYR,36,82,3,16,19
22,8482733,Logan Mailloux,D,MTL,31,82,2,17,19
22,8478020,Michael Amadio,C,VGK,28,82,11,7,18
22,8476858,Phillip Di Giuseppe,L,VAN,31,82,11,7,18
22,8482259,Bobby McMann,C,TOR,28,82,8,10,18
22,8478136,Jake Middleton,D,MIN,28,82,5,13,18
22,8479359,Beck Malenstyn,L,WSH,26,82,5,13,18
22,8476879,Cody Ceci,D,EDM,31,82,5,13,18
22,8481537,Nikita Okhotiuk,D,CGY,24,82,5,13,18
22,8481178,Egor Zamula,D,PHI,24,82,4,14,18
22,8482111,Justin Barron,D,MTL,23,82,4,14,18
22,8476473,Connor Murphy,D,CHI,31,82,4,14,18
22,8480144,David Kampf,C,TOR,29,82,4,14,18
22,8479442,Troy Stecher,D,EDM,30,82,4,14,18
22,8478859,Niko Mikkola,D,FLA,28,82,3,15,18
22,8478443,Brandon Carlo,D,BOS,28,82,2,16,18
22,8478399,Jonas Siegenthaler,D,NJD,27,82,2,16,18
22,8475762,Derek Forbort,D,BOS,32,82,2,16,18
22,8483466,Kevin Korchinski,D,CHI,20,82,2,16,18
22,8479980,Nicolas Hague,D,VGK,26,82,1,17,18
22,8477425,Miles Wood,L,COL,29,82,10,7,17
22,8481093,Rafael Harvey-Pinard,L,MTL,25,82,9,8,17
22,8482679,Matt Coronato,R,CGY,22,82,7,10,17
22,8482245,Artem Zub,D,OTT,29,82,6,11,17
22,8480336,Sean Walker,D,COL,30,82,5,12,17
22,8482166,Shakir Mukhamadullin,D,SJS,22,82,4,13,17
22,8482177,Marat Khusnutdinov,C,MIN,22,82,4,13,17
22,8477365,Connor Clifton,D,BUF,29,82,3,14,17
22,8480834,Ty Emberson,D,SJS,24,82,3,14,17
22,8477220,Nate Schmidt,D,WPG,33,82,3,14,17
22,8482712,Oskar Olausson,R,COL,22,82,2,15,17
22,8479324,Ryan Lindgren,D,NYR,26,82,1,16,17
22,8476457,Adam Larsson,D,SEA,32,82,1,16,17
22,8475188,Brayden McNabb,D,VGK,33,82,0,17,17
22,8483012,Logan Morrison,C,SEA,22,82,8,8,16
22,8483491,Ivan Miroshnichenko,L,WSH,20,82,7,9,16
22,8477931,Tomas Nosek,L,NJD,32,82,7,9,16
22,8479383,Boris Katchouk,L,OTT,26,82,7,9,16
22,8476442,Matt Nieto,L,PIT,32,82,7,9,16
22,8477505,Alexander Wennberg,C,NYR,30,82,6,10,16
22,8481059,Scott Perunovich,D,STL,26,82,4,12,16
22,8480796,Martin Fehervary,D,WSH,25,82,4,12,16
22,8478408,Travis Dermott,D,ARI,28,82,4,12,16
22,8475462,Radko Gudas,D,ANA,34,82,3,13,16
22,8480879,Jacob Bernard-Docker,D,OTT,24,82,2,14,16
22,8481567,Henry Thrun,D,SJS,23,82,1,15,16
22,8475825,Jani Hakanpää,D,DAL,32,82,1,15,16
22,8484203,Bradly Nadeau,L,CAR,19,82,10,5,15
22,8480855,Jack McBain,C,ARI,24,82,10,5,15
22,8479316,Luke Kunin,C,SJS,27,82,10,5,15
22,8475233,David Savard,D,MTL,34,82,5,10,15
22,8476312,Josh Manson,D,COL,33,82,5,10,15
22,8477392,Hudson Fasching,R,NYI,29,82,5,10,15
22,8475177,Calvin de Haan,D,TBL,33,82,4,11,15
22,8483565,Nick Blankenburg,D,CBJ,26,82,4,11,15
22,8480172,Jan Rutta,D,SJS,34,82,3,12,15
22,8484911,Collin Graf,R,SJS,22,82,3,12,15
22,8480058,Pierre-Olivier Joseph,D,PIT,25,82,2,13,15
22,8481568,Alex Vlasic,D,CHI,23,82,0,15,15
22,8477406,Mattias Janmark,C,EDM,32,82,7,7,14
22,8476871,Tanner Pearson,L,MTL,32,82,7,7,14
22,8478882,Vladislav Gavrikov,D,LAK,29,82,6,8,14
22,8470600,Ryan Suter,D,DAL,39,82,4,10,14
22,8475790,Erik Gudbranson,D,CBJ,32,82,3,11,14
22,8474166,Alec Martinez,D,VGK,37,82,2,12,14
22,8480980,Connor Dewar,C,TOR,25,82,11,2,13
22,8473504,Cal Clutterbuck,R,NYI,37,82,5,8,13
22,8482516,Matthew Kessel,D,STL,24,82,5,8,13
22,8477015,Connor Brown,R,EDM,30,82,4,9,13
22,8479291,Kevin Rooney,C,CGY,31,82,4,9,13
22,8475279,Ben Chiarot,D,DET,33,82,2,11,13
22,8475179,Dmitry Kulikov,D,FLA,34,82,0,13,13
22,8476915,Jujhar Khaira,L,MIN,30,82,7,5,12
22,8481578,Graeme Clarke,R,NJD,23,82,5,7,12
22,8476372,Nick Seeler,D,PHI,31,82,4,8,12
22,8477335,Kyle Burroughs,D,SJS,29,82,3,9,12
22,8482858,Ryker Evans,D,SEA,23,82,2,10,12
22,8482470,Ilya Solovyov,D,CGY,24,82,2,10,12
22,8471677,Jack Johnson,D,COL,37,82,2,10,12
22,8477034,Jaycob Megna,D,CHI,32,82,6,5,11
22,8483482,Tristan Luneau,D,ANA,20,82,5,6,11
22,8474013,Ian Cole,D,VAN,35,82,4,7,11
22,8478451,Ethan Bear,D,WSH,27,82,4,7,11
22,8482087,Kaiden Guhle,D,MTL,22,82,3,8,11
22,8483763,Maksymilian Szuber,D,ARI,22,82,3,8,11
22,8481030,Jack St. Ivany,D,PIT,25,82,3,8,11
22,8470966,Mark Giordano,D,TOR,41,82,2,9,11
22,8474567,Zach Bogosian,D,MIN,34,82,1,10,11
22,8482809,Jackson Blake,R,CAR,21,82,8,2,10
22,8482666,Scott Morrow,D,CAR,22,82,5,5,10
22,8482762,Simon Edvinsson,D,DET,21,82,3,7,10
22,8475324,Nick Jensen,D,WSH,34,82,1,9,10
22,8482713,Mackie Samoskevich,R,FLA,22,82,5,4,9
22,8482807,Ethan Del Mastro,D,CHI,21,82,3,6,9
22,8478468,Jeremy Lauzon,D,NSH,27,82,1,8,9
22,8476822,Luke Glendening,C,TBL,35,82,4,4,8
22,8481599,Victor Soderstrom,D,ARI,23,82,3,5,8
22,8483468,Jiri Kulich,C,BUF,20,82,2,6,8
22,8482859,Zack Ostapchuk,C,OTT,21,82,2,6,8
22,8473453,Trevor Lewis,C,LAK,37,82,3,3,6
22,8483489,Fraser Minten,C,TOR,31,82,3,2,5
22,8484149,Gavin Brindley,C,CBJ,20,82,1,3,4
22,8482141,Lukas Cormier,D,VGK,22,0,0,0,0
22,8476988,Matt Benning,D,SJS,30,0,0,0,0
22,8480727,Zach Whitecloud,D,VGK,28,0,0,0,0
22,8480887,Jordan Harris,D,MTL,24,0,0,0,0
22,8478450,Parker Wotherspoon,D,BOS,27,0,0,0,0
22,8481812,Nikolai Knyzhov,D,SJS,27,0,0,0,0
22,8480001,Urho Vaakanainen,D,ANA,25,0,0,0,0
22,8482176,Wyatt Kaiser,D,CHI,22,0,0,0,0
22,8481122,Simon Benoit,D,TOR,26,0,0,0,0
22,8476441,Joel Edmundson,D,TOR,31,0,0,0,0
22,8480884,Calen Addison,D,SJS,24,0,0,0,0
22,8482511,Mason Lohrei,D,BOS,23,0,0,0,0
22,8482192,Isaak Phillips,D,CHI,23,0,0,0,0
22,8480950,Ilya Lyubushkin,D,TOR,30,0,0,0,0
22,8474031,Kevin Shattenkirk,D,BOS,35,0,0,0,0
22,8475718,Justin Holl,D,DET,32,0,0,0,0
22,8479402,Jake Bean,D,CBJ,26,0,0,0,0
22,8474602,Justin Schultz,D,SEA,34,0,0,0,0
22,8477950,Tony DeAngelo,D,CAR,29,0,0,0,0
22,8481743,Marc Del Gaizo,D,NSH,25,0,0,0,0
22,8481527,Kaedan Korczak,D,VGK,23,0,0,0,0
22,8480192,Johnathan Kovacevic,D,MTL,27,0,0,0,0
22,8476874,Olli Maatta,D,DET,30,0,0,0,0
22,8482144,Jack Thompson,D,SJS,22,0,0,0,0
22,8480222,Sebastian Aho,D,NYI,28,0,0,0,0
22,8479458,Nikita Zaitsev,D,CHI,33,0,0,0,0
22,8471709,Marc-Edouard Vlasic,D,SJS,37,0,0,0,0
22,8482929,Emil Lilleberg,D,TBL,23,0,0,0,0
22,8477018,Ben Hutton,D,VGK,31,0,0,0,0
22,8481056,Spencer Stastney,D,NSH,24,0,0,0,0
22,8481593,Jayden Struble,D,MTL,23,0,0,0,0
22,8479982,Conor Timmins,D,TOR,26,0,0,0,0
22,8474090,Brendan Smith,D,NJD,35,0,0,0,0
22,8482964,Arber Xhekaj,D,MTL,23,0,0,0,0
22,8480891,Michael Kesselring,D,ARI,24,0,0,0,0
22,8477938,Haydn Fleury,D,TBL,28,0,0,0,0
22,8481806,Louis Crevier,D,CHI,23,0,0,0,0
22,8471274,Alex Goligoski,D,MIN,39,0,0,0,0
22,8481600,Tobias Bjornfot,D,FLA,23,0,0,0,0
22,8475797,Jarred Tinordi,D,CHI,32,0,0,0,0
22,8481521,Ronnie Attard,D,PHI,25,0,0,0,0
22,8474612,Travis Hamonic,D,OTT,34,0,0,0,0
22,8479576,Vincent Desharnais,D,EDM,28,0,0,0,0
22,8480049,Dylan Samberg,D,WPG,25,0,0,0,0
22,8483619,Filip Roos,D,CHI,25,0,0,0,0
22,8474568,Luke Schenn,D,NSH,35,0,0,0,0
22,8480184,Gustav Lindstrom,D,ANA,26,0,0,0,0
22,8480070,Ian Mitchell,D,BOS,25,0,0,0,0
22,8480196,Jacob Bryson,D,BUF,27,0,0,0,0
22,8471686,Marc Staal,D,PHI,37,0,0,0,0
22,8477467,Gustav Olofsson,D,SEA,30,0,0,0,0
22,8478970,Jalen Chatfield,D,CAR,28,0,0,0,0
22,8479348,Kale Clague,D,BUF,26,0,0,0,0
22,8473446,Erik Johnson,D,PHI,36,0,0,0,0
22,8477462,Robert Hagg,D,ANA,29,0,0,0,0
22,8478454,Noah Juulsen,D,VAN,27,0,0,0,0
22,8477384,Josh Brown,D,ARI,30,0,0,0,0
22,8481708,Zac Jones,D,NYR,24,0,0,0,0
22,8481167,Brayden Pachal,D,CGY,25,0,0,0,0
22,8482067,Connor Mackey,D,NYR,28,0,0,0,0
22,8483460,David Jiricek,D,CBJ,21,0,0,0,0
22,8481701,Santeri Hatakka,D,NJD,23,0,0,0,0
22,8478021,William Lagesson,D,ANA,28,0,0,0,0
22,8477851,Jordan Oesterle,D,CGY,32,0,0,0,0
22,8478452,Caleb Jones,D,COL,27,0,0,0,0
22,8479984,Cal Foote,D,NJD,26,0,0,0,0
22,8479639,Dylan Coghlan,D,CAR,26,0,0,0,0
22,8480874,Adam Ginning,D,PHI,24,0,0,0,0
22,8479321,Lucas Johansen,D,WSH,27,0,0,0,0
22,8480878,Nils Lundkvist,D,DAL,24,0,0,0,0
22,8482165,Yan Kuznetsov,D,CGY,22,0,0,0,0
22,8484258,Sam Malinski,D,COL,26,0,0,0,0
22,8480157,Calle Rosen,D,STL,30,0,0,0,0
22,8484304,Uvis Balinskis,D,FLA,28,0,0,0,0
22,8479985,Cale Fleury,D,SEA,26,0,0,0,0
22,8479378,Logan Stanley,D,WPG,26,0,0,0,0
22,8477541,Dakota Mermis,D,MIN,30,0,0,0,0
22,8481609,Vladislav Kolyachonok,D,ARI,23,0,0,0,0
22,8480823,Alexander Alexeyev,D,WSH,25,0,0,0,0
22,8481679,Maxence Guenette,D,OTT,23,0,0,0,0
22,8481564,Ryan Johnson,D,BUF,23,0,0,0,0
22,8479376,Victor Mete,D,PHI,26,0,0,0,0
22,8484254,Akito Hirose,D,VAN,25,0,0,0,0
22,8482660,Kent Johnson,C,CBJ,22,0,0,0,0
22,8482149,Cole Perfetti,C,WPG,22,0,0,0,0
22,8477987,Ryan Donato,C,CHI,28,0,0,0,0
22,8475755,Alexander Petrovic,D,DAL,32,0,0,0,0
22,8477810,Joel Hanley,D,CGY,33,0,0,0,0
22,8474145,Robert Bortuzzo,D,NYI,35,0,0,0,0
22,8481161,Jake Christiansen,D,CBJ,25,0,0,0,0
22,8476884,Derrick Pouliot,D,DAL,30,0,0,0,0
22,8481716,Dmitri Voronkov,L,CBJ,24,0,0,0,0
22,8480084,Nick DeSimone,D,NJD,30,0,0,0,0
22,8475750,Jon Merrill,D,MIN,32,0,0,0,0
22,8479315,Joey Anderson,R,CHI,26,0,0,0,0
22,8478011,Louie Belpedio,D,PHI,28,0,0,0,0
22,8482451,Mikael Pyyhtia,L,CBJ,23,0,0,0,0
22,8481541,Samuel Bolduc,D,NYI,24,0,0,0,0
22,8482126,Emil Andrae,D,PHI,31,0,0,0,0
22,8474618,Marco Scandella,D,STL,34,0,0,0,0
22,8477244,Chad Ruhwedel,D,NYR,34,0,0,0,0
22,8477971,Andreas Englund,D,LAK,28,0,0,0,0
22,8480829,Jesperi Kotkaniemi,C,CAR,24,0,0,0,0
22,8479372,Josh Mahura,D,FLA,26,0,0,0,0
22,8482095,Tyler Kleven,D,OTT,22,0,0,0,0
22,8481719,Maxwell Crozier,D,TBL,24,0,0,0,0
22,8475855,Jesper Fast,R,CAR,33,0,0,0,0
22,8480848,Ty Dellandrea,C,DAL,24,0,0,0,0
22,8475193,Tomas Tatar,L,SEA,34,0,0,0,0
22,8476889,Radek Faksa,C,DAL,30,0,0,0,0
22,8478495,Denis Gurianov,R,PHI,27,0,0,0,0
22,8480216,Jacob Peterson,C,SJS,25,0,0,0,0
22,8480252,Cole Guttman,C,CHI,25,0,0,0,0
22,8479026,Philippe Myers,D,TBL,27,0,0,0,0
22,8481006,Tyler Tucker,D,STL,24,0,0,0,0
22,8481032,Paul Cotter,C,VGK,25,0,0,0,0
22,8481577,Philip Tomasino,C,NSH,23,0,0,0,0
22,8476918,Jimmy Vesey,L,NYR,31,0,0,0,0
22,8479320,Max Lajoie,D,TOR,27,0,0,0,0
22,8478017,Mark Friedman,D,VAN,29,0,0,0,0
22,8481754,Nikita Nesterenko,C,ANA,23,0,0,0,0
22,8483407,Brandon Scanlin,D,NYR,25,0,0,0,0
22,8482659,Josh Doan,R,ARI,22,0,0,0,0
22,8477446,Michael McCarron,R,NSH,29,0,0,0,0
22,8477903,Garnet Hathaway,R,PHI,33,0,0,0,0
22,8482153,Brendan Brisson,C,VGK,23,0,0,0,0
22,8483546,Marshall Rifai,D,TOR,26,0,0,0,0
22,8484287,Cole McWard,D,VAN,23,0,0,0,0
22,8478854,Ryan Shea,D,PIT,27,0,0,0,0
22,8481585,Egor Afanasyev,L,NSH,23,0,0,0,0
22,8483398,Declan Carlile,D,TBL,31,0,0,0,0
22,8478502,Dennis Gilbert,D,CGY,28,0,0,0,0
22,8482749,Joshua Roy,R,MTL,21,0,0,0,0
22,8481598,Philip Broberg,D,EDM,23,0,0,0,0
22,8480835,Jack Drury,C,CAR,24,0,0,0,0
22,8480748,Kiefer Sherwood,L,NSH,29,0,0,0,0
22,8476934,Brock McGinn,L,ANA,30,0,0,0,0
22,8480870,Bo Groulx,C,ANA,24,0,0,0,0
22,8479368,Max Jones,L,ANA,26,0,0,0,0
22,8478099,Kevin Labanc,R,SJS,29,0,0,0,0
22,8478067,Oskar Lindblom,L,SJS,28,0,0,0,0
22,8476393,Nick Cousins,C,FLA,31,0,0,0,0
22,8483395,Arshdeep Bains,L,VAN,23,0,0,0,0
22,8480762,Eric Robinson,L,BUF,29,0,0,0,0
22,8479439,Jacob MacDonald,D,SJS,31,0,0,0,0
22,8476474,Stefan Noesen,R,CAR,31,0,0,0,0
22,8482787,Nikita Chibrikov,R,WPG,31,0,0,0,0
22,8478432,Christian Fischer,R,DET,27,0,0,0,0
22,8477979,Nicolas Aube-Kubel,R,WSH,28,0,0,0,0
22,8481789,Tye Kartye,L,SEA,23,0,0,0,0
22,8479330,Brandon Gignac,C,MTL,27,0,0,0,0
22,8480075,Cameron Crotty,D,ARI,25,0,0,0,0
22,8473473,Milan Lucic,L,BOS,36,0,0,0,0
22,8482094,Daemon Hunt,D,MIN,22,0,0,0,0
22,8481206,John Ludvig,D,PIT,24,0,0,0,0
22,8483630,Pavol Regenda,L,ANA,25,0,0,0,0
22,8481617,Vasily Podkolzin,R,VAN,23,0,0,0,0
22,8480306,Grant Hutton,D,NYI,29,0,0,0,0
22,8480995,Pontus Holmberg,R,TOR,25,0,0,0,0
22,8482148,Hendrix Lapierre,C,WSH,22,0,0,0,0
22,8477478,William Carrier,L,VGK,30,0,0,0,0
22,8480003,Jesper Boqvist,C,BOS,26,0,0,0,0
22,8482172,Landon Slaggert,L,CHI,22,0,0,0,0
22,8480789,Oliver Wahlstrom,R,NYI,24,0,0,0,0
22,8474062,Riley Nash,C,NYR,35,0,0,0,0
22,8480021,Jack Studnicka,C,SJS,25,0,0,0,0
22,8480025,MacKenzie Entwistle,R,CHI,25,0,0,0,0
22,8481582,Nicholas Robertson,L,TOR,23,0,0,0,0
22,8476867,Brendan Gaunce,C,CBJ,30,0,0,0,0
22,8479619,Michael Carcone,L,ARI,28,0,0,0,0
22,8479370,Tyson Jost,C,BUF,26,0,0,0,0
22,8479671,Mathieu Olivier,R,CBJ,27,0,0,0,0
22,8476994,Vinnie Hinostroza,C,PIT,30,0,0,0,0
22,8482070,Mitchell Chaffee,R,TBL,26,0,0,0,0
22,8477473,Justin Bailey,R,SJS,29,0,0,0,0
22,8479344,Jesse Puljujarvi,R,PIT,26,0,0,0,0
22,8480205,Emil Bemstrom,C,PIT,25,0,0,0,0
22,8479718,Alex Barré-Boulet,C,TBL,27,0,0,0,0
22,8482061,Brandon Biro,L,BUF,26,0,0,0,0
22,8479638,Justin Brazeau,R,BOS,26,0,0,0,0
22,8474040,Sam Gagner,C,EDM,35,0,0,0,0
22,8477846,Ryan Carpenter,C,SJS,33,0,0,0,0
22,8482077,Dylan Holloway,L,EDM,23,0,0,0,0
22,8482157,Will Cuylle,L,NYR,22,0,0,0,0
22,8480007,Jonas Rondbjerg,R,VGK,25,0,0,0,0
22,8478874,Adam Gaudette,C,STL,28,0,0,0,0
22,8478434,Keegan Kolesar,R,VGK,27,0,0,0,0
22,8480441,Trey Fix-Wolansky,R,CBJ,25,0,0,0,0
22,8479994,Jaret Anderson-Dolan,C,NSH,25,0,0,0,0
22,8483567,Georgii Merkulov,C,BOS,24,0,0,0,0
22,8477380,Jonny Brodzinski,C,NYR,31,0,0,0,0
22,8482201,Gage Goncalves,C,TBL,23,0,0,0,0
22,8478211,Dryden Hunt,L,CGY,29,0,0,0,0
22,8471699,Andrew Cogliano,C,COL,37,0,0,0,0
22,8479421,Jacob Moverare,D,LAK,26,0,0,0,0
22,8478881,Brett Seney,L,CHI,28,0,0,0,0
22,8477464,Nic Petan,C,MIN,29,0,0,0,0
22,8475958,Michael Sgarbossa,C,WSH,32,0,0,0,0
22,8481147,Reese Johnson,C,CHI,26,0,0,0,0
22,8479336,Carl Grundstrom,R,LAK,27,0,0,0,0
22,8480853,Liam Foudy,C,NSH,24,0,0,0,0
22,8479522,Hardy Haman Aktell,D,WSH,26,0,0,0,0
22,8481462,Mason Morelli,L,VGK,28,0,0,0,0
22,8482102,Vasily Ponomarev,C,CAR,22,0,0,0,0
22,8480844,Grigori Denisenko,L,VGK,24,0,0,0,0
22,8479944,Zach Aston-Reese,C,DET,30,0,0,0,0
22,8482784,Zach Dean,C,STL,21,0,0,0,0
22,8479419,Brett Murray,L,BUF,26,0,0,0,0
22,8479520,Brandon Duhaime,R,COL,27,0,0,0,0
22,8477573,Nathan Walker,L,STL,30,0,0,0,0
22,8478078,Rourke Chartier,C,OTT,28,0,0,0,0
22,8475795,Dylan McIlrath,D,WSH,32,0,0,0,0
22,8482496,Nils Aman,C,VAN,24,0,0,0,0
22,8480289,Morgan Barron,C,WPG,26,0,0,0,0
22,8481751,Lukas Rousek,R,BUF,25,0,0,0,0
22,8480011,Klim Kostin,C,SJS,25,0,0,0,0
22,8481556,John Beecher,C,BOS,23,0,0,0,0
22,8475278,Byron Froese,C,VGK,33,0,0,0,0
22,8475225,Craig Smith,C,DAL,35,0,0,0,0
22,8484326,Patrik Koch,D,ARI,28,0,0,0,0
22,8477930,Pierre-Edouard Bellemare,L,SEA,39,0,0,0,0
22,8478409,Anthony Richard,C,BOS,28,0,0,0,0
22,8481024,Linus Karlsson,C,VAN,25,0,0,0,0
22,8479986,Kole Lind,R,SEA,26,0,0,0,0
22,8479414,Nathan Bastian,R,NJD,27,0,0,0,0
22,8479362,Riley Tufte,L,COL,26,0,0,0,0
22,8481058,Jesse Ylönen,R,MTL,25,0,0,0,0
22,8482476,Emil Heineman,L,MTL,23,0,0,0,0
22,8482861,Vincent Iorio,D,WSH,22,0,0,0,0
22,8483432,Luca Del Bel Belluz,C,CBJ,31,0,0,0,0
22,8482744,James Malatesta,L,CBJ,21,0,0,0,0
22,8477887,Patrick Brown,C,BOS,32,0,0,0,0
22,8478585,Derek Ryan,C,EDM,38,0,0,0,0
22,8481441,Joe Snively,C,WSH,28,0,0,0,0
22,8481592,Jakob Pelletier,L,CGY,23,0,0,0,0
22,8482634,Alex Steeves,C,TOR,25,0,0,0,0
22,8477126,Jayson Megna,C,BOS,34,0,0,0,0
22,8475752,Tyler Pitlick,C,NYR,33,0,0,0,0
22,8480008,Adam Ruzicka,C,ARI,25,0,0,0,0
22,8481065,Angus Crookshank,L,OTT,25,0,0,0,0
22,8479547,Matthew Phillips,R,WSH,26,0,0,0,0
22,8480226,Marián Studenic,R,SEA,26,0,0,0,0
22,8481237,Kyle MacLean,C,NYI,25,0,0,0,0
22,8475413,Justin Dowling,C,NJD,34,0,0,0,0
22,8481641,Joel Kiviranta,L,COL,28,0,0,0,0
22,8478104,Sammy Blais,L,STL,28,0,0,0,0
22,8477454,Adam Erne,L,EDM,29,0,0,0,0
22,8481518,Nolan Foote,L,NJD,24,0,0,0,0
22,8480245,Olle Lycksell,R,PHI,25,0,0,0,0
22,8483570,Ben Meyers,C,ANA,26,0,0,0,0
22,8480776,Sheldon Rempal,R,VGK,29,0,0,0,0
22,8483920,Pierrick Dube,R,WSH,23,0,0,0,0
22,8480267,Sammy Walker,C,MIN,25,0,0,0,0
22,8482747,Brennan Othmann,L,NYR,21,0,0,0,0
22,8479991,Jake Leschyshyn,C,NYR,25,0,0,0,0
22,8478400,Colin White,C,MTL,27,0,0,0,0
22,8479328,Julien Gauthier,R,NYI,27,0,0,0,0
22,8484325,Waltteri Merela,C,TBL,26,0,0,0,0
22,8479066,Ryan Lomberg,L,FLA,30,0,0,0,0
22,8477070,Liam O'Brien,C,ARI,30,0,0,0,0
22,8478146,Matthew Highmore,C,OTT,28,0,0,0,0
22,8478028,Fredrik Olofsson,L,COL,28,0,0,0,0
22,8480880,Jakub Lauko,C,BOS,24,0,0,0,0
22,8479968,Vinni Lettieri,C,MIN,29,0,0,0,0
22,8474709,Matt Martin,L,NYI,35,0,0,0,0
22,8480845,Rasmus Kupari,C,WPG,24,0,0,0,0
22,8481550,Adam Beckman,L,MIN,23,0,0,0,0
22,8481422,Jacob Lucchini,C,MIN,29,0,0,0,0
22,8477401,John Hayden,C,SEA,29,0,0,0,0
22,8478904,Steven Lorentz,C,FLA,28,0,0,0,0
22,8482088,Justin Sourdif,R,FLA,22,0,0,0,0
22,8482751,Ryan Winterton,C,SEA,21,0,0,0,0
22,8482241,Radim Zohorna,L,PIT,28,0,0,0,0
22,8481690,Tyler Angle,C,CBJ,24,0,0,0,0
22,8476952,Dominic Toninato,C,WPG,30,0,0,0,0
22,8476919,Chris Tierney,C,NJD,30,0,0,0,0
22,8480032,Shane Bowers,C,NJD,25,0,0,0,0
22,8484314,Jiri Smejkal,L,OTT,28,0,0,0,0
22,8481239,Samuel Fagemo,L,LAK,24,0,0,0,0
22,8481532,Alex Turcotte,C,LAK,23,0,0,0,0
22,8481019,David Gustafsson,C,WPG,24,0,0,0,0
22,8478477,Mitchell Stephens,C,MTL,27,0,0,0,0
22,8479546,Oskar Steen,C,BOS,26,0,0,0,0
22,8480292,Carson Meyer,R,CBJ,27,0,0,0,0
22,8478446,Glenn Gawdin,C,ANA,27,0,0,0,0
22,8483531,Brian Halonen,L,NJD,25,0,0,0,0
22,8477149,Scott Sabourin,R,SJS,32,0,0,0,0
22,8479972,Mason Shaw,C,MIN,26,0,0,0,0
22,8480890,Jan Jenik,R,ARI,24,0,0,0,0
22,8478051,Max Willman,C,NJD,29,0,0,0,0
22,8480851,Akil Thomas,C,LAK,24,0,0,0,0
22,8482765,Isak Rosen,R,BUF,21,0,0,0,0
22,8478421,A.J. Greer,L,CGY,28,0,0,0,0
22,8478512,Austin Czarnik,C,DET,32,0,0,0,0
22,8479536,Axel Jonsson-Fjallby,L,WPG,26,0,0,0,0
22,8477320,Anton Blidh,L,NYR,29,0,0,0,0
22,8481543,Nikita Alexandrov,C,STL,24,0,0,0,0
22,8475235,Nicolas Deslauriers,L,PHI,33,0,0,0,0
22,8481070,Hugh McGing,L,STL,26,0,0,0,0
22,8480836,Jonathan Gruden,C,PIT,24,0,0,0,0
22,8481591,Sam Poulin,R,PIT,23,0,0,0,0
22,8477962,Brendan Lemieux,L,CAR,28,0,0,0,0
22,8483401,Marc Johnstone,R,PIT,28,0,0,0,0
22,8482250,Callahan Burke,C,CAR,27,0,0,0,0
22,8481726,Adam Edstrom,C,NYR,24,0,0,0,0
22,8471817,Ryan Reaves,R,TOR,37,0,0,0,0
22,8479587,Rhett Gardner,C,PHI,28,0,0,0,0
22,8475766,Austin Watson,L,TBL,32,0,0,0,0
22,8479367,William Lockwood,R,FLA,26,0,0,0,0
22,8478424,Jansen Harkins,C,PIT,27,0,0,0,0
22,8476913,Devin Shore,C,SEA,30,0,0,0,0
22,8482652,Walker Duehr,R,CGY,27,0,0,0,0
22,8477527,Ross Johnston,L,ANA,30,0,0,0,0
22,8481077,John Leonard,L,ARI,26,0,0,0,0
22,8483549,Lucas Condotta,L,MTL,27,0,0,0,0
22,8480468,James Hamblin,L,EDM,25,0,0,0,0
22,8476907,Mackenzie MacEachern,L,STL,30,0,0,0,0
22,8479543,Michael Pezzetta,L,MTL,26,0,0,0,0
22,8480355,Mark Kastelic,C,OTT,25,0,0,0,0
22,8482162,Roby Jarventie,L,OTT,22,0,0,0,0
22,8479772,Zack MacEwen,R,OTT,28,0,0,0,0
22,8483597,Milos Kelemen,L,ARI,25,0,0,0,0
22,8479379,Givani Smith,R,SJS,26,0,0,0,0
22,8481655,Cole Schwindt,R,CGY,23,0,0,0,0
22,8479981,Jonah Gadjovich,L,FLA,26,0,0,0,0
22,8482147,Jean-Luc Foudy,C,COL,22,0,0,0,0
22,8484255,Jason Polin,R,COL,25,0,0,0,0
22,8477993,Justin Kirkland,C,ARI,28,0,0,0,0
22,8479249,Andrew Poturalski,C,SEA,30,0,0,0,0
22,8482197,Adam Raska,R,MIN,23,0,0,0,0
22,8475780,Chris Wagner,R,COL,33,0,0,0,0
22,8479533,Joona Koppanen,L,PIT,26,0,0,0,0
22,8481534,Raphael Lavoie,C,EDM,24,0,0,0,0
22,8484321,Nikolas Matinpalo,D,OTT,26,0,0,0,0
22,8481043,Cole Koepke,L,TBL,26,0,0,0,0
22,8476323,Max McCormick,L,SEA,32,0,0,0,0
22,8483609,Adam Klapka,R,CGY,24,0,0,0,0
22,8483512,Matt Savoie,C,BUF,20,0,0,0,0
22,8484259,Ondrej Pavel,C,COL,31,0,0,0,0
22,8478147,Bokondji Imama,L,OTT,28,0,0,0,0
22,8482460,Matt Rempe,C,NYR,22,0,0,0,0
22,8477073,Kurtis MacDermid,L,NJD,30,0,0,0,0
22,8480274,Philip Kemp,D,EDM,25,0,0,0,0
22,8478956,Samuel Laberge,L,NJD,27,0,0,0,0
22,8483045,Cameron Butler,R,CBJ,31,0,0,0,0
23,8478402,Connor McDavid,C,EDM,27,82,36,86,122
23,8477492,Nathan MacKinnon,C,COL,29,82,52,67,119
23,8479318,Auston Matthews,C,TOR,27,82,67,45,112
23,8477934,Leon Draisaitl,C,EDM,29,82,52,60,112
23,8479314,Matthew Tkachuk,L,FLA,27,82,38,73,111
23,8478864,Kirill Kaprizov,L,MIN,27,82,48,60,108
23,8477956,David Pastrnak,R,BOS,28,82,50,57,107
23,8480012,Elias Pettersson,C,VAN,26,82,37,57,94
23,8480069,Cale Makar,D,COL,26,82,21,73,94
23,8477946,Dylan Larkin,C,DET,28,82,44,49,93
23,8476468,J.T. Miller,C,VAN,31,82,33,60,93
23,8478420,Mikko Rantanen,R,COL,28,82,42,50,92
23,8481559,Jack Hughes,C,NJD,23,82,44,46,90
23,8471675,Sidney Crosby,C,PIT,37,82,41,49,90
23,8478550,Artemi Panarin,L,NYR,33,82,39,50,89
23,8478493,Joel Eriksson Ek,C,MIN,27,82,43,45,88
23,8476887,Filip Forsberg,L,NSH,30,82,39,48,87
23,8477404,Jake Guentzel,C,CAR,30,82,33,54,87
23,8476453,Nikita Kucherov,R,TBL,31,82,25,61,86
23,8475172,Nazem Kadri,C,CGY,34,82,30,52,82
23,8480801,Brady Tkachuk,L,OTT,25,82,45,36,81
23,8479420,Tage Thompson,C,BUF,27,82,40,41,81
23,8477939,William Nylander,R,TOR,28,82,35,46,81
23,8471215,Evgeni Malkin,C,PIT,38,82,32,48,80
23,8477409,Carter Verhaeghe,C,FLA,29,82,28,51,79
23,8477493,Aleksander Barkov,C,FLA,29,82,32,46,78
23,8480830,Andrei Svechnikov,R,CAR,24,82,31,47,78
23,8474600,Roman Josi,D,NSH,34,82,25,53,78
23,8474141,Patrick Kane,R,DET,36,82,30,47,77
23,8475810,Bryan Rust,R,PIT,32,82,36,39,75
23,8475913,Mark Stone,R,VGK,32,82,25,50,75
23,8477951,Nick Schmaltz,C,ARI,28,82,32,42,74
23,8474564,Steven Stamkos,C,TBL,34,82,28,46,74
23,8478873,Troy Terry,R,ANA,27,82,26,48,74
23,8482116,Tim Stützle,C,OTT,22,82,25,49,74
23,8477402,Pavel Buchnevich,L,STL,29,82,22,52,74
23,8479407,Jesper Bratt,L,NJD,26,82,27,46,73
23,8476456,Jonathan Huberdeau,C,CGY,31,82,18,55,73
23,8478427,Sebastian Aho,C,CAR,27,82,31,40,71
23,8477942,Kevin Fiala,L,LAK,28,82,26,45,71
23,8479343,Clayton Keller,R,ARI,26,82,26,45,71
23,8478407,Vince Dunn,D,SEA,28,82,18,53,71
23,8476389,Vincent Trocheck,C,NYR,31,82,27,43,70
23,8477949,Alex Tuch,R,BUF,28,82,20,50,70
23,8476460,Mark Scheifele,C,WPG,31,82,30,39,69
23,8478042,Viktor Arvidsson,R,LAK,31,82,28,41,69
23,8480027,Jason Robertson,L,DAL,25,82,23,46,69
23,8476454,Ryan Nugent-Hopkins,C,EDM,31,82,17,52,69
23,8478403,Jack Eichel,C,VGK,28,82,38,30,68
23,8478010,Brayden Point,C,TBL,28,82,32,36,68
23,8476346,Johnny Gaudreau,L,CBJ,31,82,23,45,68
23,8471685,Anze Kopitar,C,LAK,37,82,20,48,68
23,8480800,Quinn Hughes,D,VAN,25,82,13,55,68
23,8477960,Adrian Kempe,R,LAK,28,82,36,31,67
23,8480002,Nico Hischier,C,NJD,25,82,26,41,67
23,8479385,Jordan Kyrou,C,STL,26,82,26,41,67
23,8476459,Mika Zibanejad,C,NYR,31,82,25,42,67
23,8480023,Robert Thomas,C,STL,25,82,22,45,67
23,8475692,Mats Zuccarello,R,MIN,37,82,18,49,67
23,8481523,Kirby Dach,C,MTL,23,82,11,56,67
23,8481557,Matt Boldy,L,MIN,23,82,34,32,66
23,8477940,Nikolaj Ehlers,L,WPG,28,82,31,35,66
23,8479337,Alex DeBrincat,R,DET,27,82,27,39,66
23,8478445,Mathew Barzal,C,NYI,27,82,22,44,66
23,8477447,Shea Theodore,D,VGK,29,82,13,53,66
23,8479323,Adam Fox,D,NYR,26,82,7,59,66
23,8471214,Alex Ovechkin,L,WSH,39,82,39,26,65
23,8477933,Sam Reinhart,C,FLA,29,82,34,31,65
23,8478398,Kyle Connor,L,WPG,28,82,31,34,65
23,8475786,Zach Hyman,L,EDM,32,82,31,33,64
23,8475754,Brock Nelson,C,NYI,33,82,25,39,64
23,8482745,Mason McTavish,C,ANA,21,82,24,40,64
23,8475765,Vladimir Tarasenko,R,FLA,33,82,20,44,64
23,8478439,Travis Konecny,R,PHI,27,82,34,29,63
23,8480839,Rasmus Dahlin,D,BUF,24,82,13,50,63
23,8480208,Drake Batherson,R,OTT,26,82,21,41,62
23,8478444,Brock Boeser,R,VAN,27,82,34,27,61
23,8482740,Wyatt Johnston,C,DAL,21,82,33,28,61
23,8478414,Timo Meier,R,NJD,28,82,27,34,61
23,8478449,Roope Hintz,C,DAL,28,82,25,36,61
23,8481540,Cole Caufield,R,MTL,23,82,30,30,60
23,8476881,Tomas Hertl,C,VGK,31,82,29,31,60
23,8475726,Tyler Toffoli,C,WPG,32,82,28,32,60
23,8477955,Jared McCann,L,SEA,28,82,25,35,60
23,8482078,Lucas Raymond,L,DET,22,82,24,36,60
23,8480434,Sean Durzi,D,ARI,26,82,24,36,60
23,8475166,John Tavares,C,TOR,34,82,25,34,59
23,8474641,Adam Henrique,C,EDM,34,82,25,34,59
23,8481533,Trevor Zegras,C,ANA,23,82,21,38,59
23,8482684,Luke Hughes,D,NJD,21,82,18,41,59
23,8478460,Zach Werenski,D,CBJ,27,82,15,44,59
23,8474578,Erik Karlsson,D,PIT,34,82,8,51,59
23,8475184,Chris Kreider,L,NYR,33,82,33,25,58
23,8477501,Valeri Nichushkin,R,COL,29,82,29,29,58
23,8480803,Evan Bouchard,D,EDM,25,82,13,45,58
23,8476853,Morgan Rielly,D,TOR,30,82,5,53,58
23,8477935,Sam Bennett,C,FLA,28,82,30,27,57
23,8478401,Pavel Zacha,C,BOS,27,82,17,40,57
23,8476906,Shayne Gostisbehere,D,DET,31,82,11,46,57
23,8480031,Maxime Comtois,L,CAR,25,82,10,47,57
23,8477500,Bo Horvat,C,NYI,29,82,28,28,56
23,8481528,Dylan Cozens,C,BUF,23,82,26,30,56
23,8476448,William Karlsson,C,VGK,31,82,16,40,56
23,8476905,Chandler Stephenson,C,VGK,30,82,15,41,56
23,8483808,Andrei Kuzmenko,L,CGY,28,82,22,33,55
23,8482665,Matty Beniers,C,SEA,22,82,17,38,55
23,8476462,Dougie Hamilton,D,NJD,31,82,16,39,55
23,8478397,Rasmus Andersson,D,CGY,28,82,15,40,55
23,8479999,Casey Mittelstadt,C,COL,26,82,13,42,55
23,8470794,Joe Pavelski,C,DAL,40,82,23,31,54
23,8475784,Jeff Skinner,C,BUF,32,82,22,32,54
23,8475794,Tyler Seguin,C,DAL,32,82,22,32,54
23,8473986,Alex Killorn,L,ANA,35,82,22,32,54
23,8482097,Jack Quinn,R,BUF,23,82,20,34,54
23,8478047,Michael Bunting,L,PIT,29,82,19,35,54
23,8477986,Brandon Montour,D,FLA,30,82,15,39,54
23,8479325,Charlie McAvoy,D,BOS,27,82,8,46,54
23,8482133,Thomas Bordeleau,C,SJS,22,82,21,32,53
23,8478440,Dylan Strome,C,WSH,27,82,16,37,53
23,8475158,Ryan O'Reilly,C,NSH,33,82,15,38,53
23,8479425,Filip Hronek,D,VAN,27,82,15,38,53
23,8477504,Josh Morrissey,D,WPG,29,82,9,44,53
23,8479400,Pierre-Luc Dubois,L,LAK,26,82,27,25,52
23,8482699,Dylan Guenther,R,ARI,21,82,26,26,52
23,8476826,Yanni Gourde,C,SEA,33,82,21,31,52
23,8475798,Mikael Granlund,C,SJS,32,82,16,36,52
23,8480798,Philipp Kurashev,C,CHI,25,82,15,37,52
23,8475167,Victor Hedman,D,TBL,34,82,7,45,52
23,8481699,Aku Raty,R,ARI,23,82,5,47,52
23,8475151,Kyle Palmieri,C,NYI,33,82,30,21,51
23,8477496,Elias Lindholm,C,VAN,30,82,23,28,51
23,8477497,Sean Monahan,C,WPG,30,82,23,28,51
23,8474586,Jordan Eberle,R,SEA,34,82,22,29,51
23,8475744,Evgeny Kuznetsov,C,CAR,32,82,22,29,51
23,8480039,Martin Necas,C,CAR,25,82,19,32,51
23,8477416,Oliver Bjorkstrand,R,SEA,29,82,17,34,51
23,8473512,Claude Giroux,R,OTT,36,82,16,35,51
23,8476875,Mike Matheson,D,MTL,30,82,9,42,51
23,8481618,Alex Newhook,C,MTL,23,82,28,22,50
23,8481068,Yegor Sharangovich,C,CGY,26,82,27,23,50
23,8482110,Dawson Mercer,C,NJD,23,82,25,25,50
23,8479339,Patrik Laine,L,CBJ,26,82,24,26,50
23,8481596,Shane Pinto,C,OTT,24,82,21,29,50
23,8478438,Tommy Novak,C,NSH,27,82,17,33,50
23,8476479,Phillip Danault,C,LAK,31,82,16,34,50
23,8476539,Jonathan Marchessault,R,VGK,34,82,25,24,49
23,8482093,Seth Jarvis,C,CAR,22,82,23,26,49
23,8478856,Conor Garland,R,VAN,28,82,16,33,49
23,8480028,Morgan Frost,C,PHI,25,82,14,35,49
23,8480036,Miro Heiskanen,D,DAL,25,82,12,37,49
23,8477952,Robby Fabbri,C,DET,28,82,30,18,48
23,8478233,Andrew Mangiapane,L,CGY,28,82,23,25,48
23,8480015,Owen Tippett,R,PHI,25,82,21,27,48
23,8480018,Nick Suzuki,C,MTL,25,82,20,28,48
23,8475745,Charlie Coyle,C,BOS,32,82,16,32,48
23,8473419,Brad Marchand,L,BOS,36,82,15,33,48
23,8477494,Jonathan Drouin,L,COL,29,82,15,33,48
23,8481711,Matias Maccelli,L,ARI,24,82,14,34,48
23,8474102,David Perron,L,DET,36,82,14,34,48
23,8478500,Ivan Provorov,D,CBJ,27,82,5,43,48
23,8476483,Rickard Rakell,R,PIT,31,82,26,21,47
23,8475287,Erik Haula,L,NJD,33,82,24,23,47
23,8480064,Josh Norris,C,OTT,25,82,22,25,47
23,8479542,Brandon Hagel,L,TBL,26,82,20,27,47
23,8474590,John Carlson,D,WSH,34,82,7,40,47
23,8483524,Shane Wright,C,SEA,20,82,33,13,46
23,8477451,Ryan Hartman,R,MIN,30,82,24,22,46
23,8480009,Eeli Tolvanen,R,SEA,25,82,21,25,46
23,8476432,Boone Jenner,C,CBJ,31,82,20,26,46
23,8482101,Danil Gushchin,L,SJS,22,82,20,26,46
23,8476882,Teuvo Teravainen,L,CAR,30,82,18,28,46
23,8475170,Brayden Schenn,C,STL,33,82,17,29,46
23,8483445,Cutter Gauthier,L,ANA,20,82,15,31,46
23,8477953,Kasperi Kapanen,R,STL,28,82,13,33,46
23,8479410,Mikhail Sergachev,D,TBL,26,82,11,35,46
23,8478038,Devon Toews,D,COL,30,82,9,37,46
23,8480797,Joel Farabee,L,PHI,24,82,25,20,45
23,8478542,Evan Rodrigues,C,FLA,31,82,23,22,45
23,8476399,Blake Coleman,C,CGY,33,82,21,24,45
23,8477476,Artturi Lehkonen,L,COL,29,82,15,30,45
23,8480185,Eetu Luostarinen,C,FLA,26,82,15,30,45
23,8476292,Ondrej Palat,L,NJD,33,82,14,31,45
23,8484144,Connor Bedard,C,CHI,19,82,23,21,44
23,8476880,Tom Wilson,R,WSH,30,82,22,22,44
23,8480113,Alex Iafallo,L,WPG,31,82,21,23,44
23,8474679,Gustav Nyquist,C,NSH,35,82,19,25,44
23,8478975,Mason Marchment,L,DAL,29,82,18,26,44
23,8480078,Filip Chytil,C,NYR,25,82,16,28,44
23,8477495,Seth Jones,D,CHI,30,82,11,33,44
23,8480865,Noah Dobson,D,NYI,24,82,9,35,44
23,8476923,Damon Severson,D,CBJ,30,82,8,36,44
23,8475169,Evander Kane,L,EDM,33,82,28,15,43
23,8475314,Anders Lee,L,NYI,34,82,23,20,43
23,8480849,Barrett Hayton,C,ARI,24,82,22,21,43
23,8482109,Alexis Lafrenière,L,NYR,23,82,20,23,43
23,8482705,Cole Sillinger,C,CBJ,21,82,20,23,43
23,8477444,Andre Burakovsky,L,SEA,29,82,19,24,43
23,8477964,Ivan Barbashev,C,VGK,29,82,18,25,43
23,8476458,Ryan Strome,C,ANA,31,82,14,29,43
23,8483471,Brad Lambert,C,WPG,31,82,4,39,43
23,8477456,J.T. Compher,L,DET,29,82,23,19,42
23,8477021,Alex Kerfoot,C,ARI,30,82,22,20,42
23,8482175,JJ Peterka,R,BUF,22,82,21,21,42
23,8479525,Ross Colton,C,COL,28,82,20,22,42
23,8474150,Mikael Backlund,C,CGY,35,82,16,26,42
23,8482475,Yegor Chinakhov,R,CBJ,23,82,16,26,42
23,8475191,Reilly Smith,R,PIT,33,82,15,27,42
23,8483397,Marc McLaughlin,C,BOS,25,82,35,6,41
23,8478498,Jake DeBrusk,L,BOS,28,82,22,19,41
23,8474157,Max Pacioretty,L,WSH,36,82,19,22,41
23,8481624,Ilya Mikheyev,R,VAN,30,82,18,23,41
23,8474563,Drew Doughty,D,LAK,35,82,16,25,41
23,8477429,Andrew Copp,C,DET,30,82,15,26,41
23,8480188,Fabian Zetterlund,L,SJS,25,82,24,16,40
23,8473994,Jamie Benn,L,DAL,35,82,16,24,40
23,8475768,Jaden Schwartz,C,SEA,32,82,16,24,40
23,8477511,Anthony Mantha,R,VGK,30,82,15,25,40
23,8482667,William Eklund,L,SJS,22,82,13,27,40
23,8475753,Justin Faulk,D,STL,32,82,13,27,40
23,8482159,Tyson Foerster,R,PHI,22,82,12,28,40
23,8482222,Alexander Barabanov,L,SJS,30,82,12,28,40
23,8477932,Aaron Ekblad,D,FLA,28,82,9,31,40
23,8479675,Trevor Moore,L,LAK,29,82,21,18,39
23,8470613,Brent Burns,D,CAR,39,82,14,25,39
23,8478462,Nicolas Roy,C,VGK,27,82,11,28,39
23,8479987,Morgan Geekie,C,BOS,26,82,11,28,39
23,8478472,Mathieu Joseph,R,OTT,27,82,11,28,39
23,8473422,Nick Foligno,L,CHI,37,82,11,28,39
23,8478396,Noah Hanifin,D,VGK,27,82,9,30,39
23,8478046,Danton Heinen,L,BOS,29,82,8,31,39
23,8482122,Brock Faber,D,MIN,22,82,4,35,39
23,8476981,Josh Anderson,R,MTL,30,82,25,13,38
23,8478519,Anthony Cirelli,C,TBL,27,82,18,20,38
23,8478366,Frank Vatrano,R,ANA,30,82,18,20,38
23,8475714,Calle Jarnkrok,C,TOR,33,82,18,20,38
23,8478115,Pierre Engvall,L,NYI,28,82,17,21,38
23,8483515,Juraj Slafkovsky,L,MTL,20,82,16,22,38
23,8482055,Drew O'Connor,L,PIT,26,82,15,23,38
23,8481013,Jonatan Berggren,R,DET,24,82,12,26,38
23,8482105,Jake Sanderson,D,OTT,22,82,8,30,38
23,8471724,Kris Letang,D,PIT,37,82,4,34,38
23,8475906,John Klingberg,D,TOR,32,82,4,34,38
23,8480014,Gabriel Vilardi,C,WPG,25,82,25,12,37
23,8477426,Nicholas Paul,L,TBL,29,82,24,13,37
23,8476392,Adam Lowry,C,WPG,31,82,16,21,37
23,8482113,Anton Lundell,C,FLA,23,82,16,21,37
23,8479351,Sam Steel,C,DAL,26,82,13,24,37
23,8474053,Logan Couture,C,SJS,35,82,12,25,37
23,8481703,Valtteri Puustinen,R,PIT,25,82,11,26,37
23,8477948,Travis Sanheim,D,PHI,28,82,9,28,37
23,8482142,Jamie Drysdale,D,PHI,22,82,9,28,37
23,8477503,Max Domi,C,TOR,29,82,8,29,37
23,8481604,Pavel Dorofeyev,L,VGK,24,82,28,8,36
23,8471698,T.J. Oshie,R,WSH,38,82,21,15,36
23,8478413,Jordan Greenway,L,BUF,27,82,17,19,36
23,8475168,Matt Duchene,C,DAL,33,82,15,21,36
23,8475791,Taylor Hall,L,CHI,33,82,14,22,36
23,8477989,Christian Dvorak,C,MTL,28,82,13,23,36
23,8477346,MacKenzie Weegar,D,CGY,30,82,13,23,36
23,8482124,Quinton Byfield,R,LAK,22,82,13,23,36
23,8482146,Luke Evangelista,R,NSH,22,82,12,24,36
23,8478469,Thomas Chabot,D,OTT,27,82,11,25,36
23,8478055,Gustav Forsling,D,FLA,28,82,11,25,36
23,8480893,Kirill Marchenko,R,CBJ,24,82,27,8,35
23,8475722,Jason Zucker,L,NSH,32,82,18,17,35
23,8477407,Anthony Duclair,L,TBL,29,82,17,18,35
23,8482089,Jake Neighbours,L,STL,22,82,17,18,35
23,8478466,Daniel Sprong,R,DET,27,82,16,19,35
23,8479941,Justin Danforth,R,CBJ,31,82,16,19,35
23,8476872,Scott Laughton,C,PHI,30,82,13,22,35
23,8475343,Nic Dowd,C,WSH,34,82,13,22,35
23,8479992,Michael Rasmussen,C,DET,25,82,12,23,35
23,8475197,Tyson Barrie,D,NSH,33,82,10,25,35
23,8474151,Ryan McDonagh,D,NSH,35,82,5,30,35
23,8483457,Lane Hutson,D,MTL,20,82,3,32,35
23,8476438,Brandon Saad,L,STL,32,82,23,11,34
23,8477944,Jakub Vrana,L,STL,28,82,18,16,34
23,8482092,Ridly Greig,C,OTT,22,82,17,17,34
23,8480802,Ryan McLeod,C,EDM,25,82,15,19,34
23,8479345,Jakob Chychrun,D,OTT,26,82,13,21,34
23,8482111,Justin Barron,D,MTL,23,82,13,21,34
23,8481546,Cam York,D,PHI,23,82,9,25,34
23,8474565,Alex Pietrangelo,D,VGK,34,82,8,26,34
23,8480043,Timothy Liljegren,D,TOR,25,82,4,30,34
23,8478133,Jake Evans,C,MTL,28,82,4,30,34
23,8477479,Tyler Bertuzzi,L,TOR,29,82,16,17,33
23,8478474,Lawson Crouse,L,ARI,27,82,16,17,33
23,8475760,Nick Bjugstad,C,ARI,32,82,15,18,33
23,8482155,Alex Laferriere,R,LAK,23,82,15,18,33
23,8482079,Marco Rossi,C,MIN,23,82,14,19,33
23,8481554,Kaapo Kakko,R,NYR,23,82,11,22,33
23,8480871,Adam Boqvist,D,CBJ,24,82,3,30,33
23,8476873,Mark Jankowski,C,NSH,30,82,21,11,32
23,8481186,Logan O'Connor,R,COL,28,82,19,13,32
23,8481580,Connor McMichael,C,WSH,23,82,13,19,32
23,8478508,Yakov Trenin,C,COL,27,82,12,20,32
23,8475799,Nino Niederreiter,R,WPG,32,82,11,21,32
23,8477498,Darnell Nurse,D,EDM,29,82,10,22,32
23,8476869,Brady Skjei,D,CAR,30,82,8,24,32
23,8478840,Will Borgen,D,SEA,28,82,8,24,32
23,8481581,Thomas Harley,D,DAL,23,82,7,25,32
23,8476958,Jaccob Slavin,D,CAR,30,82,4,28,32
23,8475764,Cam Fowler,D,ANA,33,82,4,28,32
23,8471218,Blake Wheeler,R,NYR,38,82,17,14,31
23,8481481,Blake Lizotte,C,LAK,27,82,11,20,31
23,8482117,Lukas Reichel,L,CHI,22,82,10,21,31
23,8475149,Marcus Johansson,L,MIN,34,82,9,22,31
23,8479293,Brandon Tanev,L,SEA,33,82,9,22,31
23,8482655,J.J. Moser,D,ARI,24,82,6,25,31
23,8476792,Torey Krug,D,STL,33,82,3,28,31
23,8474149,Evgenii Dadonov,R,DAL,35,82,20,10,30
23,8480821,Filip Zadina,R,SJS,25,82,17,13,30
23,8476871,Tanner Pearson,L,MTL,32,82,17,13,30
23,8477450,Jason Dickinson,C,CHI,29,82,15,15,30
23,8474884,Mike Hoffman,C,SJS,35,82,15,15,30
23,8475848,Brendan Gallagher,R,MTL,32,82,13,17,30
23,8474715,Cam Atkinson,R,PHI,35,82,13,17,30
23,8480220,Noah Cates,L,PHI,25,82,11,19,30
23,8476921,Jordan Martinook,L,CAR,32,82,8,22,30
23,8479398,Samuel Girard,D,COL,26,82,8,22,30
23,8481537,Nikita Okhotiuk,D,CGY,24,82,8,22,30
23,8481542,Moritz Seider,D,DET,23,82,3,27,30
23,8476902,Esa Lindell,D,DAL,30,82,3,27,30
23,8480459,Pius Suter,C,VAN,28,82,16,13,29
23,8479365,Trent Frederic,C,BOS,26,82,15,14,29
23,8478020,Michael Amadio,C,VGK,28,82,15,14,29
23,8473449,Kyle Okposo,R,FLA,36,82,14,15,29
23,8482125,Alexander Holtz,R,NJD,22,82,14,15,29
23,8477998,Warren Foegele,L,EDM,28,82,13,16,29
23,8484153,Leo Carlsson,C,ANA,20,82,13,16,29
23,8476419,Jean-Gabriel Pageau,C,NYI,32,82,12,17,29
23,8476960,Andreas Athanasiou,C,CHI,30,82,12,17,29
23,8476329,Travis Boyd,C,ARI,31,82,11,18,29
23,8478891,Mason Appleton,C,WPG,28,82,11,18,29
23,8478458,Jack Roslovic,C,NYR,27,82,10,19,29
23,8475763,Kevin Hayes,R,STL,32,82,10,19,29
23,8479514,Rem Pitlick,C,CHI,27,82,6,23,29
23,8475218,Mattias Ekholm,D,EDM,34,82,5,24,29
23,8481016,Ruslan Iskhakov,C,NYI,24,82,2,27,29
23,8482118,Sam Colangelo,R,ANA,23,82,18,10,28
23,8481535,Nils Hoglander,L,VAN,24,82,15,13,28
23,8480813,Joe Veleno,C,DET,24,82,14,14,28
23,8476925,Colton Sissons,C,NSH,31,82,11,17,28
23,8481477,Nico Sturm,C,SJS,29,82,11,17,28
23,8476897,Oskar Sundqvist,C,STL,30,82,11,17,28
23,8481606,Jordan Spence,D,LAK,23,82,9,19,28
23,8476979,Erik Gustafsson,D,NYR,32,82,8,20,28
23,8480817,K'Andre Miller,D,NYR,24,82,8,20,28
23,8482624,Daniil Miromanov,D,CGY,27,82,7,21,28
23,8476917,Adam Pelech,D,NYI,30,82,7,21,28
23,8475462,Radko Gudas,D,ANA,34,82,7,21,28
23,8477969,Marcus Pettersson,D,PIT,28,82,5,23,28
23,8482733,Logan Mailloux,D,MTL,31,82,5,23,28
23,8477845,Trevor van Riemsdyk,D,WSH,33,82,3,25,28
23,8478882,Vladislav Gavrikov,D,LAK,29,82,3,25,28
23,8484203,Bradly Nadeau,L,CAR,19,82,20,7,27
23,8480074,Alexandre Texier,C,CBJ,25,82,14,13,27
23,8480855,Jack McBain,C,ARI,24,82,14,13,27
23,8475200,Dmitry Orlov,D,CAR,33,82,13,14,27
23,8477839,Conor Sheary,L,TBL,32,82,13,14,27
23,8477425,Miles Wood,L,COL,29,82,12,15,27
23,8478463,Anthony Beauvillier,L,NSH,27,82,11,16,27
23,8474189,Lars Eller,C,PIT,35,82,10,17,27
23,8475164,Jakob Silfverberg,R,ANA,34,82,10,17,27
23,8474037,James van Riemsdyk,L,BOS,35,82,9,18,27
23,8473533,Jordan Staal,C,CAR,36,82,9,18,27
23,8476480,Vladislav Namestnikov,C,WPG,32,82,7,20,27
23,8476885,Jacob Trouba,D,NYR,30,82,5,22,27
23,8480807,Mattias Samuelsson,D,BUF,24,82,5,22,27
23,8476879,Cody Ceci,D,EDM,31,82,4,23,27
23,8481517,Brett Leason,R,ANA,25,82,15,11,26
23,8470621,Corey Perry,R,EDM,39,82,14,12,26
23,8481560,Arthur Kaliyev,R,LAK,23,82,12,14,26
23,8482062,Cole Smith,L,NSH,29,82,12,14,26
23,8481522,Peyton Krebs,C,BUF,23,82,11,15,26
23,8481656,Aliaksei Protas,C,WSH,23,82,9,17,26
23,8476854,Hampus Lindholm,D,BOS,30,82,7,19,26
23,8478013,Jake Walman,D,DET,28,82,7,19,26
23,8475220,Marcus Foligno,L,MIN,33,82,6,20,26
23,8476457,Adam Larsson,D,SEA,32,82,6,20,26
23,8483495,Simon Nemec,D,NJD,20,82,5,21,26
23,8476525,Colin Miller,D,WPG,32,82,5,21,26
23,8470604,Jeff Carter,C,PIT,39,82,13,12,25
23,8479423,Alex Nylander,L,CBJ,26,82,13,12,25
23,8481553,Bobby Brink,R,PHI,23,82,13,12,25
23,8482702,Logan Stankoven,C,DAL,21,82,12,13,25
23,8483505,Matthew Poitras,C,BOS,20,82,11,14,25
23,8474870,Tyler Johnson,C,CHI,34,82,10,15,25
23,8477330,Dominik Kubalik,L,OTT,29,82,10,15,25
23,8476858,Phillip Di Giuseppe,L,VAN,31,82,10,15,25
23,8476422,Mike Reilly,D,NYI,31,82,8,17,25
23,8482720,Matthew Knies,L,TOR,22,82,7,18,25
23,8476892,Colton Parayko,D,STL,31,82,7,18,25
23,8480336,Sean Walker,D,COL,30,82,7,18,25
23,8480145,Neal Pionk,D,WPG,29,82,5,20,25
23,8475324,Nick Jensen,D,WSH,34,82,5,20,25
23,8480873,Rasmus Sandin,D,WSH,24,82,4,21,25
23,8479983,Mario Ferraro,D,SJS,26,82,4,21,25
23,8477506,Ryan Pulock,D,NYI,30,82,4,21,25
23,8476467,Jamie Oleksiak,D,SEA,32,82,3,22,25
23,8480281,Alexey Toropchenko,R,STL,25,82,16,8,24
23,8483431,Logan Cooley,C,ARI,20,82,12,12,24
23,8478109,Victor Olofsson,L,BUF,29,82,11,13,24
23,8480068,Ryan Poehling,C,PHI,25,82,11,13,24
23,8477353,Tyler Motte,C,TBL,29,82,10,14,24
23,8475793,Ryan Johansen,C,PHI,32,82,9,15,24
23,8478136,Jake Middleton,D,MIN,28,82,6,18,24
23,8479976,Juuso Valimaki,D,ARI,26,82,4,20,24
23,8478507,John Marino,D,NJD,27,82,3,21,24
23,8481704,Juuso Parssinen,C,NSH,23,82,16,7,23
23,8482145,Mavrik Bourque,C,DAL,22,82,16,7,23
23,8483493,Frank Nazar,C,CHI,20,82,15,8,23
23,8479346,Dillon Dube,C,CGY,26,82,13,10,23
23,8470610,Zach Parise,L,COL,40,82,13,10,23
23,8476469,Joel Armia,R,MTL,31,82,12,11,23
23,8484166,Adam Fantilli,C,CBJ,20,82,11,12,23
23,8478057,Dakota Joshua,C,VAN,28,82,10,13,23
23,8475842,Sam Carrick,C,EDM,32,82,10,13,23
23,8479977,Kailer Yamamoto,R,SEA,26,82,7,16,23
23,8475171,Oliver Ekman-Larsson,D,FLA,33,82,6,17,23
23,8482671,Owen Power,D,BUF,22,82,5,18,23
23,8475279,Ben Chiarot,D,DET,33,82,4,19,23
23,8474716,Jared Spurgeon,D,MIN,35,82,3,20,23
23,8478851,Alexandre Carrier,D,NSH,28,82,3,20,23
23,8483490,Pavel Mintyukov,D,ANA,21,82,2,21,23
23,8481567,Henry Thrun,D,SJS,23,82,2,21,23
23,8476374,Sean Kuraly,C,CBJ,31,82,13,9,22
23,8482809,Jackson Blake,R,CAR,21,82,13,9,22
23,8482259,Bobby McMann,C,TOR,28,82,12,10,22
23,8482737,Zack Bolduc,C,STL,21,82,11,11,22
23,8482074,Connor Zary,C,CGY,23,82,10,12,22
23,8479996,Cody Glass,C,NSH,25,82,10,12,22
23,8476331,Dylan DeMelo,D,WPG,31,82,8,14,22
23,8482245,Artem Zub,D,OTT,29,82,7,15,22
23,8483565,Nick Blankenburg,D,CBJ,26,82,7,15,22
23,8477505,Alexander Wennberg,C,NYR,30,82,6,16,22
23,8482730,Brandt Clarke,D,LAK,21,82,5,17,22
23,8478178,Darren Raddysh,D,TBL,28,82,5,17,22
23,8480058,Pierre-Olivier Joseph,D,PIT,25,82,4,18,22
23,8477220,Nate Schmidt,D,WPG,33,82,3,19,22
23,8481524,Bowen Byram,D,BUF,23,82,2,20,22
23,8478569,Noel Acciari,C,PIT,33,82,16,5,21
23,8479393,Noah Gregor,C,TOR,26,82,14,7,21
23,8481093,Rafael Harvey-Pinard,L,MTL,25,82,14,7,21
23,8478831,Kevin Stenlund,C,FLA,28,82,12,9,21
23,8479316,Luke Kunin,C,SJS,27,82,12,9,21
23,8477947,Sonny Milano,L,WSH,28,82,10,11,21
23,8476931,Jake McCabe,D,TOR,31,82,9,12,21
23,8477406,Mattias Janmark,C,EDM,32,82,9,12,21
23,8476927,Teddy Blueger,C,VAN,30,82,6,15,21
23,8481601,Simon Holmstrom,R,NYI,23,82,6,15,21
23,8477931,Tomas Nosek,L,NJD,32,82,6,15,21
23,8471677,Jack Johnson,D,COL,37,82,6,15,21
23,8479415,Michael McLeod,C,NJD,26,82,5,16,21
23,8480172,Jan Rutta,D,SJS,34,82,5,16,21
23,8482177,Marat Khusnutdinov,C,MIN,22,82,4,17,21
23,8475690,Chris Tanev,D,DAL,35,82,3,18,21
23,8473507,Jeff Petry,D,DET,37,82,2,19,21
23,8483012,Logan Morrison,C,SEA,22,82,12,8,20
23,8479661,Tanner Jeannot,L,TBL,27,82,9,11,20
23,8477392,Hudson Fasching,R,NYI,29,82,9,11,20
23,8480806,Isac Lundestrom,C,ANA,25,82,8,12,20
23,8481028,Martin Pospisil,C,CGY,25,82,6,14,20
23,8474009,Nick Bonino,C,NYR,36,82,6,14,20
23,8477015,Connor Brown,R,EDM,30,82,6,14,20
23,8478430,Oliver Kylington,D,CGY,27,82,5,15,20
23,8480246,Nick Perbix,D,TBL,26,82,4,16,20
23,8474673,TJ Brodie,D,TOR,34,82,4,16,20
23,8482087,Kaiden Guhle,D,MTL,22,82,4,16,20
23,8477507,Nikita Zadorov,D,VAN,29,82,2,18,20
23,8476278,Colin Blackwell,C,CHI,31,82,12,7,19
23,8480980,Connor Dewar,C,TOR,25,82,12,7,19
23,8477508,Curtis Lazar,C,NJD,29,82,11,8,19
23,8482073,Braden Schneider,D,NYR,23,82,9,10,19
23,8479353,Brett Howden,C,VGK,26,82,8,11,19
23,8476461,Sean Couturier,C,PHI,32,82,7,12,19
23,8477919,Frederick Gaudreau,C,MIN,31,82,7,12,19
23,8479998,Mikey Anderson,D,LAK,25,82,7,12,19
23,8474034,Pat Maroon,L,BOS,36,82,6,13,19
23,8474574,Tyler Myers,D,VAN,34,82,6,13,19
23,8479390,Taylor Raddysh,R,CHI,26,82,6,13,19
23,8479369,Andrew Peeke,D,BOS,26,82,5,14,19
23,8484145,Zach Benson,L,BUF,19,82,5,14,19
23,8478859,Niko Mikkola,D,FLA,28,82,4,15,19
23,8478468,Jeremy Lauzon,D,NSH,27,82,3,16,19
23,8476463,Jonas Brodin,D,MIN,31,82,2,17,19
23,8477369,Carson Soucy,D,VAN,30,82,7,11,18
23,8479383,Boris Katchouk,L,OTT,26,82,7,11,18
23,8483466,Kevin Korchinski,D,CHI,20,82,5,13,18
23,8473453,Trevor Lewis,C,LAK,37,82,5,13,18
23,8477488,Brett Pesce,D,CAR,30,82,4,14,18
23,8481178,Egor Zamula,D,PHI,24,82,4,14,18
23,8479980,Nicolas Hague,D,VGK,26,82,4,14,18
23,8477365,Connor Clifton,D,BUF,29,82,4,14,18
23,8482166,Shakir Mukhamadullin,D,SJS,22,82,3,15,18
23,8479371,Dante Fabbro,D,NSH,26,82,2,16,18
23,8478911,Matt Roy,D,LAK,29,82,0,18,18
23,8475455,Brenden Dillon,D,WPG,34,82,0,18,18
23,8475179,Dmitry Kulikov,D,FLA,34,82,0,18,18
23,8473504,Cal Clutterbuck,R,NYI,37,82,12,5,17
23,8478043,Sam Lafferty,C,VAN,29,82,10,7,17
23,8482679,Matt Coronato,R,CGY,22,82,10,7,17
23,8483499,Liam Ohgren,L,MIN,20,82,8,9,17
23,8480035,Henri Jokiharju,D,BUF,25,82,7,10,17
23,8476429,Scott Mayfield,D,NYI,32,82,5,12,17
23,8476624,Barclay Goodrow,C,NYR,31,82,5,12,17
23,8476967,Brett Kulak,D,EDM,30,82,4,13,17
23,8475188,Brayden McNabb,D,VGK,33,82,4,13,17
23,8482516,Matthew Kessel,D,STL,24,82,4,13,17
23,8481605,Jackson LaCombe,D,ANA,23,82,3,14,17
23,8480834,Ty Emberson,D,SJS,24,82,3,14,17
23,8475208,Brian Dumoulin,D,SEA,33,82,2,15,17
23,8479591,Michael Eyssimont,C,TBL,28,82,8,8,16
23,8475231,Casey Cizikas,C,NYI,33,82,6,10,16
23,8482807,Ethan Del Mastro,D,CHI,21,82,5,11,16
23,8477499,Rasmus Ristolainen,D,PHI,30,82,4,12,16
23,8475177,Calvin de Haan,D,TBL,33,82,4,12,16
23,8481578,Graeme Clarke,R,NJD,23,82,4,12,16
23,8476312,Josh Manson,D,COL,33,82,3,13,16
23,8474166,Alec Martinez,D,VGK,37,82,3,13,16
23,8482858,Ryker Evans,D,SEA,23,82,3,13,16
23,8475790,Erik Gudbranson,D,CBJ,32,82,1,15,16
23,8470966,Mark Giordano,D,TOR,41,82,1,15,16
23,8477435,Ryan Graves,D,PIT,29,82,0,16,16
23,8483491,Ivan Miroshnichenko,L,WSH,20,82,10,5,15
23,8479359,Beck Malenstyn,L,WSH,26,82,5,10,15
23,8482803,Olen Zellweger,D,ANA,21,82,4,11,15
23,8480448,Parker Kelly,L,OTT,25,82,4,11,15
23,8473563,Nicklas Backstrom,C,WSH,37,82,4,11,15
23,8480879,Jacob Bernard-Docker,D,OTT,24,82,4,11,15
23,8481014,Alexander Romanov,D,NYI,24,82,3,12,15
23,8478399,Jonas Siegenthaler,D,NJD,27,82,3,12,15
23,8481568,Alex Vlasic,D,CHI,23,82,3,12,15
23,8477034,Jaycob Megna,D,CHI,32,82,1,14,15
23,8476473,Connor Murphy,D,CHI,31,82,7,7,14
23,8478416,Erik Cernak,D,TBL,27,82,6,8,14
23,8478443,Brandon Carlo,D,BOS,28,82,6,8,14
23,8479324,Ryan Lindgren,D,NYR,26,82,5,9,14
23,8476891,Matt Grzelcyk,D,BOS,30,82,4,10,14
23,8470600,Ryan Suter,D,DAL,39,82,2,12,14
23,8482712,Oskar Olausson,R,COL,22,82,1,13,14
23,8483482,Tristan Luneau,D,ANA,20,82,7,6,13
23,8476822,Luke Glendening,C,TBL,35,82,7,6,13
23,8474567,Zach Bogosian,D,MIN,34,82,6,7,13
23,8482666,Scott Morrow,D,CAR,22,82,6,7,13
23,8484911,Collin Graf,R,SJS,22,82,5,8,13
23,8482470,Ilya Solovyov,D,CGY,24,82,5,8,13
23,8475181,Nick Leddy,D,STL,33,82,4,9,13
23,8480073,Erik Brannstrom,D,OTT,25,82,4,9,13
23,8475233,David Savard,D,MTL,34,82,4,9,13
23,8480860,Kevin Bahl,D,NJD,24,82,3,10,13
23,8476372,Nick Seeler,D,PHI,31,82,3,10,13
23,8475825,Jani Hakanpää,D,DAL,32,82,1,12,13
23,8478451,Ethan Bear,D,WSH,27,82,2,10,12
23,8481059,Scott Perunovich,D,STL,26,82,1,11,12
23,8476878,Zemgus Girgensons,L,BUF,30,82,7,4,11
23,8481599,Victor Soderstrom,D,ARI,23,82,4,7,11
23,8476915,Jujhar Khaira,L,MIN,30,82,3,8,11
23,8479291,Kevin Rooney,C,CGY,31,82,2,9,11
23,8474013,Ian Cole,D,VAN,35,82,2,9,11
23,8483763,Maksymilian Szuber,D,ARI,22,82,1,10,11
23,8482762,Simon Edvinsson,D,DET,21,82,5,5,10
23,8480144,David Kampf,C,TOR,29,82,4,6,10
23,8475762,Derek Forbort,D,BOS,32,82,1,9,10
23,8480796,Martin Fehervary,D,WSH,25,82,1,9,10
23,8476442,Matt Nieto,L,PIT,32,82,5,4,9
23,8477335,Kyle Burroughs,D,SJS,29,82,4,5,9
23,8483468,Jiri Kulich,C,BUF,20,82,3,6,9
23,8481030,Jack St. Ivany,D,PIT,25,82,2,7,9
23,8483489,Fraser Minten,C,TOR,31,82,2,7,9
23,8482859,Zack Ostapchuk,C,OTT,21,82,1,8,9
23,8478408,Travis Dermott,D,ARI,28,82,0,9,9
23,8480990,Declan Chisholm,D,MIN,24,82,4,4,8
23,8484149,Gavin Brindley,C,CBJ,20,82,2,5,7
23,8479442,Troy Stecher,D,EDM,30,82,1,6,7
23,8482713,Mackie Samoskevich,R,FLA,22,82,1,3,4
23,8482141,Lukas Cormier,D,VGK,22,0,0,0,0
23,8476988,Matt Benning,D,SJS,30,0,0,0,0
23,8480727,Zach Whitecloud,D,VGK,28,0,0,0,0
23,8480887,Jordan Harris,D,MTL,24,0,0,0,0
23,8478450,Parker Wotherspoon,D,BOS,27,0,0,0,0
23,8481812,Nikolai Knyzhov,D,SJS,27,0,0,0,0
23,8480001,Urho Vaakanainen,D,ANA,25,0,0,0,0
23,8482176,Wyatt Kaiser,D,CHI,22,0,0,0,0
23,8481122,Simon Benoit,D,TOR,26,0,0,0,0
23,8476441,Joel Edmundson,D,TOR,31,0,0,0,0
23,8480884,Calen Addison,D,SJS,24,0,0,0,0
23,8482511,Mason Lohrei,D,BOS,23,0,0,0,0
23,8482192,Isaak Phillips,D,CHI,23,0,0,0,0
23,8480950,Ilya Lyubushkin,D,TOR,30,0,0,0,0
23,8474031,Kevin Shattenkirk,D,BOS,35,0,0,0,0
23,8475718,Justin Holl,D,DET,32,0,0,0,0
23,8479402,Jake Bean,D,CBJ,26,0,0,0,0
23,8474602,Justin Schultz,D,SEA,34,0,0,0,0
23,8477950,Tony DeAngelo,D,CAR,29,0,0,0,0
23,8481743,Marc Del Gaizo,D,NSH,25,0,0,0,0
23,8481527,Kaedan Korczak,D,VGK,23,0,0,0,0
23,8480192,Johnathan Kovacevic,D,MTL,27,0,0,0,0
23,8476874,Olli Maatta,D,DET,30,0,0,0,0
23,8482144,Jack Thompson,D,SJS,22,0,0,0,0
23,8480222,Sebastian Aho,D,NYI,28,0,0,0,0
23,8479458,Nikita Zaitsev,D,CHI,33,0,0,0,0
23,8471709,Marc-Edouard Vlasic,D,SJS,37,0,0,0,0
23,8482929,Emil Lilleberg,D,TBL,23,0,0,0,0
23,8477018,Ben Hutton,D,VGK,31,0,0,0,0
23,8481056,Spencer Stastney,D,NSH,24,0,0,0,0
23,8481593,Jayden Struble,D,MTL,23,0,0,0,0
23,8479982,Conor Timmins,D,TOR,26,0,0,0,0
23,8474090,Brendan Smith,D,NJD,35,0,0,0,0
23,8482964,Arber Xhekaj,D,MTL,23,0,0,0,0
23,8480891,Michael Kesselring,D,ARI,24,0,0,0,0
23,8477938,Haydn Fleury,D,TBL,28,0,0,0,0
23,8481806,Louis Crevier,D,CHI,23,0,0,0,0
23,8471274,Alex Goligoski,D,MIN,39,0,0,0,0
23,8481600,Tobias Bjornfot,D,FLA,23,0,0,0,0
23,8475797,Jarred Tinordi,D,CHI,32,0,0,0,0
23,8481521,Ronnie Attard,D,PHI,25,0,0,0,0
23,8474612,Travis Hamonic,D,OTT,34,0,0,0,0
23,8479576,Vincent Desharnais,D,EDM,28,0,0,0,0
23,8480049,Dylan Samberg,D,WPG,25,0,0,0,0
23,8483619,Filip Roos,D,CHI,25,0,0,0,0
23,8474568,Luke Schenn,D,NSH,35,0,0,0,0
23,8480184,Gustav Lindstrom,D,ANA,26,0,0,0,0
23,8480070,Ian Mitchell,D,BOS,25,0,0,0,0
23,8480196,Jacob Bryson,D,BUF,27,0,0,0,0
23,8471686,Marc Staal,D,PHI,37,0,0,0,0
23,8477467,Gustav Olofsson,D,SEA,30,0,0,0,0
23,8478970,Jalen Chatfield,D,CAR,28,0,0,0,0
23,8479348,Kale Clague,D,BUF,26,0,0,0,0
23,8473446,Erik Johnson,D,PHI,36,0,0,0,0
23,8477462,Robert Hagg,D,ANA,29,0,0,0,0
23,8478454,Noah Juulsen,D,VAN,27,0,0,0,0
23,8477384,Josh Brown,D,ARI,30,0,0,0,0
23,8481708,Zac Jones,D,NYR,24,0,0,0,0
23,8481167,Brayden Pachal,D,CGY,25,0,0,0,0
23,8482067,Connor Mackey,D,NYR,28,0,0,0,0
23,8483460,David Jiricek,D,CBJ,21,0,0,0,0
23,8481701,Santeri Hatakka,D,NJD,23,0,0,0,0
23,8478021,William Lagesson,D,ANA,28,0,0,0,0
23,8477851,Jordan Oesterle,D,CGY,32,0,0,0,0
23,8478452,Caleb Jones,D,COL,27,0,0,0,0
23,8479984,Cal Foote,D,NJD,26,0,0,0,0
23,8479639,Dylan Coghlan,D,CAR,26,0,0,0,0
23,8480874,Adam Ginning,D,PHI,24,0,0,0,0
23,8479321,Lucas Johansen,D,WSH,27,0,0,0,0
23,8480878,Nils Lundkvist,D,DAL,24,0,0,0,0
23,8482165,Yan Kuznetsov,D,CGY,22,0,0,0,0
23,8484258,Sam Malinski,D,COL,26,0,0,0,0
23,8480157,Calle Rosen,D,STL,30,0,0,0,0
23,8484304,Uvis Balinskis,D,FLA,28,0,0,0,0
23,8479985,Cale Fleury,D,SEA,26,0,0,0,0
23,8479378,Logan Stanley,D,WPG,26,0,0,0,0
23,8477541,Dakota Mermis,D,MIN,30,0,0,0,0
23,8481609,Vladislav Kolyachonok,D,ARI,23,0,0,0,0
23,8480823,Alexander Alexeyev,D,WSH,25,0,0,0,0
23,8481679,Maxence Guenette,D,OTT,23,0,0,0,0
23,8481564,Ryan Johnson,D,BUF,23,0,0,0,0
23,8479376,Victor Mete,D,PHI,26,0,0,0,0
23,8484254,Akito Hirose,D,VAN,25,0,0,0,0
23,8482660,Kent Johnson,C,CBJ,22,0,0,0,0
23,8482149,Cole Perfetti,C,WPG,22,0,0,0,0
23,8477987,Ryan Donato,C,CHI,28,0,0,0,0
23,8475755,Alexander Petrovic,D,DAL,32,0,0,0,0
23,8477810,Joel Hanley,D,CGY,33,0,0,0,0
23,8474145,Robert Bortuzzo,D,NYI,35,0,0,0,0
23,8481161,Jake Christiansen,D,CBJ,25,0,0,0,0
23,8476884,Derrick Pouliot,D,DAL,30,0,0,0,0
23,8481716,Dmitri Voronkov,L,CBJ,24,0,0,0,0
23,8480084,Nick DeSimone,D,NJD,30,0,0,0,0
23,8475750,Jon Merrill,D,MIN,32,0,0,0,0
23,8479315,Joey Anderson,R,CHI,26,0,0,0,0
23,8478011,Louie Belpedio,D,PHI,28,0,0,0,0
23,8482451,Mikael Pyyhtia,L,CBJ,23,0,0,0,0
23,8481541,Samuel Bolduc,D,NYI,24,0,0,0,0
23,8482126,Emil Andrae,D,PHI,31,0,0,0,0
23,8474618,Marco Scandella,D,STL,34,0,0,0,0
23,8477244,Chad Ruhwedel,D,NYR,34,0,0,0,0
23,8477971,Andreas Englund,D,LAK,28,0,0,0,0
23,8480829,Jesperi Kotkaniemi,C,CAR,24,0,0,0,0
23,8479372,Josh Mahura,D,FLA,26,0,0,0,0
23,8482095,Tyler Kleven,D,OTT,22,0,0,0,0
23,8481719,Maxwell Crozier,D,TBL,24,0,0,0,0
23,8475855,Jesper Fast,R,CAR,33,0,0,0,0
23,8480848,Ty Dellandrea,C,DAL,24,0,0,0,0
23,8475193,Tomas Tatar,L,SEA,34,0,0,0,0
23,8476889,Radek Faksa,C,DAL,30,0,0,0,0
23,8478495,Denis Gurianov,R,PHI,27,0,0,0,0
23,8480216,Jacob Peterson,C,SJS,25,0,0,0,0
23,8480252,Cole Guttman,C,CHI,25,0,0,0,0
23,8479026,Philippe Myers,D,TBL,27,0,0,0,0
23,8481006,Tyler Tucker,D,STL,24,0,0,0,0
23,8481032,Paul Cotter,C,VGK,25,0,0,0,0
23,8481577,Philip Tomasino,C,NSH,23,0,0,0,0
23,8476918,Jimmy Vesey,L,NYR,31,0,0,0,0
23,8479320,Max Lajoie,D,TOR,27,0,0,0,0
23,8478017,Mark Friedman,D,VAN,29,0,0,0,0
23,8481754,Nikita Nesterenko,C,ANA,23,0,0,0,0
23,8483407,Brandon Scanlin,D,NYR,25,0,0,0,0
23,8482659,Josh Doan,R,ARI,22,0,0,0,0
23,8477446,Michael McCarron,R,NSH,29,0,0,0,0
23,8477903,Garnet Hathaway,R,PHI,33,0,0,0,0
23,8482153,Brendan Brisson,C,VGK,23,0,0,0,0
23,8483546,Marshall Rifai,D,TOR,26,0,0,0,0
23,8484287,Cole McWard,D,VAN,23,0,0,0,0
23,8478854,Ryan Shea,D,PIT,27,0,0,0,0
23,8481585,Egor Afanasyev,L,NSH,23,0,0,0,0
23,8483398,Declan Carlile,D,TBL,31,0,0,0,0
23,8478502,Dennis Gilbert,D,CGY,28,0,0,0,0
23,8482749,Joshua Roy,R,MTL,21,0,0,0,0
23,8481598,Philip Broberg,D,EDM,23,0,0,0,0
23,8480835,Jack Drury,C,CAR,24,0,0,0,0
23,8480748,Kiefer Sherwood,L,NSH,29,0,0,0,0
23,8476934,Brock McGinn,L,ANA,30,0,0,0,0
23,8480870,Bo Groulx,C,ANA,24,0,0,0,0
23,8479368,Max Jones,L,ANA,26,0,0,0,0
23,8478099,Kevin Labanc,R,SJS,29,0,0,0,0
23,8478067,Oskar Lindblom,L,SJS,28,0,0,0,0
23,8476393,Nick Cousins,C,FLA,31,0,0,0,0
23,8483395,Arshdeep Bains,L,VAN,23,0,0,0,0
23,8480762,Eric Robinson,L,BUF,29,0,0,0,0
23,8479439,Jacob MacDonald,D,SJS,31,0,0,0,0
23,8476474,Stefan Noesen,R,CAR,31,0,0,0,0
23,8482787,Nikita Chibrikov,R,WPG,31,0,0,0,0
23,8478432,Christian Fischer,R,DET,27,0,0,0,0
23,8477979,Nicolas Aube-Kubel,R,WSH,28,0,0,0,0
23,8481789,Tye Kartye,L,SEA,23,0,0,0,0
23,8479330,Brandon Gignac,C,MTL,27,0,0,0,0
23,8480075,Cameron Crotty,D,ARI,25,0,0,0,0
23,8473473,Milan Lucic,L,BOS,36,0,0,0,0
23,8482094,Daemon Hunt,D,MIN,22,0,0,0,0
23,8481206,John Ludvig,D,PIT,24,0,0,0,0
23,8483630,Pavol Regenda,L,ANA,25,0,0,0,0
23,8481617,Vasily Podkolzin,R,VAN,23,0,0,0,0
23,8480306,Grant Hutton,D,NYI,29,0,0,0,0
23,8480995,Pontus Holmberg,R,TOR,25,0,0,0,0
23,8482148,Hendrix Lapierre,C,WSH,22,0,0,0,0
23,8477478,William Carrier,L,VGK,30,0,0,0,0
23,8480003,Jesper Boqvist,C,BOS,26,0,0,0,0
23,8482172,Landon Slaggert,L,CHI,22,0,0,0,0
23,8480789,Oliver Wahlstrom,R,NYI,24,0,0,0,0
23,8474062,Riley Nash,C,NYR,35,0,0,0,0
23,8480021,Jack Studnicka,C,SJS,25,0,0,0,0
23,8480025,MacKenzie Entwistle,R,CHI,25,0,0,0,0
23,8481582,Nicholas Robertson,L,TOR,23,0,0,0,0
23,8476867,Brendan Gaunce,C,CBJ,30,0,0,0,0
23,8479619,Michael Carcone,L,ARI,28,0,0,0,0
23,8479370,Tyson Jost,C,BUF,26,0,0,0,0
23,8479671,Mathieu Olivier,R,CBJ,27,0,0,0,0
23,8476994,Vinnie Hinostroza,C,PIT,30,0,0,0,0
23,8482070,Mitchell Chaffee,R,TBL,26,0,0,0,0
23,8477473,Justin Bailey,R,SJS,29,0,0,0,0
23,8479344,Jesse Puljujarvi,R,PIT,26,0,0,0,0
23,8480205,Emil Bemstrom,C,PIT,25,0,0,0,0
23,8479718,Alex Barré-Boulet,C,TBL,27,0,0,0,0
23,8482061,Brandon Biro,L,BUF,26,0,0,0,0
23,8479638,Justin Brazeau,R,BOS,26,0,0,0,0
23,8474040,Sam Gagner,C,EDM,35,0,0,0,0
23,8477846,Ryan Carpenter,C,SJS,33,0,0,0,0
23,8482077,Dylan Holloway,L,EDM,23,0,0,0,0
23,8482157,Will Cuylle,L,NYR,22,0,0,0,0
23,8480007,Jonas Rondbjerg,R,VGK,25,0,0,0,0
23,8478874,Adam Gaudette,C,STL,28,0,0,0,0
23,8478434,Keegan Kolesar,R,VGK,27,0,0,0,0
23,8480441,Trey Fix-Wolansky,R,CBJ,25,0,0,0,0
23,8479994,Jaret Anderson-Dolan,C,NSH,25,0,0,0,0
23,8483567,Georgii Merkulov,C,BOS,24,0,0,0,0
23,8477380,Jonny Brodzinski,C,NYR,31,0,0,0,0
23,8482201,Gage Goncalves,C,TBL,23,0,0,0,0
23,8478211,Dryden Hunt,L,CGY,29,0,0,0,0
23,8471699,Andrew Cogliano,C,COL,37,0,0,0,0
23,8479421,Jacob Moverare,D,LAK,26,0,0,0,0
23,8478881,Brett Seney,L,CHI,28,0,0,0,0
23,8477464,Nic Petan,C,MIN,29,0,0,0,0
23,8475958,Michael Sgarbossa,C,WSH,32,0,0,0,0
23,8481147,Reese Johnson,C,CHI,26,0,0,0,0
23,8479336,Carl Grundstrom,R,LAK,27,0,0,0,0
23,8480853,Liam Foudy,C,NSH,24,0,0,0,0
23,8479522,Hardy Haman Aktell,D,WSH,26,0,0,0,0
23,8481462,Mason Morelli,L,VGK,28,0,0,0,0
23,8482102,Vasily Ponomarev,C,CAR,22,0,0,0,0
23,8480844,Grigori Denisenko,L,VGK,24,0,0,0,0
23,8479944,Zach Aston-Reese,C,DET,30,0,0,0,0
23,8482784,Zach Dean,C,STL,21,0,0,0,0
23,8479419,Brett Murray,L,BUF,26,0,0,0,0
23,8479520,Brandon Duhaime,R,COL,27,0,0,0,0
23,8477573,Nathan Walker,L,STL,30,0,0,0,0
23,8478078,Rourke Chartier,C,OTT,28,0,0,0,0
23,8475795,Dylan McIlrath,D,WSH,32,0,0,0,0
23,8482496,Nils Aman,C,VAN,24,0,0,0,0
23,8480289,Morgan Barron,C,WPG,26,0,0,0,0
23,8481751,Lukas Rousek,R,BUF,25,0,0,0,0
23,8480011,Klim Kostin,C,SJS,25,0,0,0,0
23,8481556,John Beecher,C,BOS,23,0,0,0,0
23,8475278,Byron Froese,C,VGK,33,0,0,0,0
23,8475225,Craig Smith,C,DAL,35,0,0,0,0
23,8484326,Patrik Koch,D,ARI,28,0,0,0,0
23,8477930,Pierre-Edouard Bellemare,L,SEA,39,0,0,0,0
23,8478409,Anthony Richard,C,BOS,28,0,0,0,0
23,8481024,Linus Karlsson,C,VAN,25,0,0,0,0
23,8479986,Kole Lind,R,SEA,26,0,0,0,0
23,8479414,Nathan Bastian,R,NJD,27,0,0,0,0
23,8479362,Riley Tufte,L,COL,26,0,0,0,0
23,8481058,Jesse Ylönen,R,MTL,25,0,0,0,0
23,8482476,Emil Heineman,L,MTL,23,0,0,0,0
23,8482861,Vincent Iorio,D,WSH,22,0,0,0,0
23,8483432,Luca Del Bel Belluz,C,CBJ,31,0,0,0,0
23,8482744,James Malatesta,L,CBJ,21,0,0,0,0
23,8477887,Patrick Brown,C,BOS,32,0,0,0,0
23,8478585,Derek Ryan,C,EDM,38,0,0,0,0
23,8481441,Joe Snively,C,WSH,28,0,0,0,0
23,8481592,Jakob Pelletier,L,CGY,23,0,0,0,0
23,8482634,Alex Steeves,C,TOR,25,0,0,0,0
23,8477126,Jayson Megna,C,BOS,34,0,0,0,0
23,8475752,Tyler Pitlick,C,NYR,33,0,0,0,0
23,8480008,Adam Ruzicka,C,ARI,25,0,0,0,0
23,8481065,Angus Crookshank,L,OTT,25,0,0,0,0
23,8479547,Matthew Phillips,R,WSH,26,0,0,0,0
23,8480226,Marián Studenic,R,SEA,26,0,0,0,0
23,8481237,Kyle MacLean,C,NYI,25,0,0,0,0
23,8475413,Justin Dowling,C,NJD,34,0,0,0,0
23,8481641,Joel Kiviranta,L,COL,28,0,0,0,0
23,8478104,Sammy Blais,L,STL,28,0,0,0,0
23,8477454,Adam Erne,L,EDM,29,0,0,0,0
23,8481518,Nolan Foote,L,NJD,24,0,0,0,0
23,8480245,Olle Lycksell,R,PHI,25,0,0,0,0
23,8483570,Ben Meyers,C,ANA,26,0,0,0,0
23,8480776,Sheldon Rempal,R,VGK,29,0,0,0,0
23,8483920,Pierrick Dube,R,WSH,23,0,0,0,0
23,8480267,Sammy Walker,C,MIN,25,0,0,0,0
23,8482747,Brennan Othmann,L,NYR,21,0,0,0,0
23,8479991,Jake Leschyshyn,C,NYR,25,0,0,0,0
23,8478400,Colin White,C,MTL,27,0,0,0,0
23,8479328,Julien Gauthier,R,NYI,27,0,0,0,0
23,8484325,Waltteri Merela,C,TBL,26,0,0,0,0
23,8479066,Ryan Lomberg,L,FLA,30,0,0,0,0
23,8477070,Liam O'Brien,C,ARI,30,0,0,0,0
23,8478146,Matthew Highmore,C,OTT,28,0,0,0,0
23,8478028,Fredrik Olofsson,L,COL,28,0,0,0,0
23,8480880,Jakub Lauko,C,BOS,24,0,0,0,0
23,8479968,Vinni Lettieri,C,MIN,29,0,0,0,0
23,8474709,Matt Martin,L,NYI,35,0,0,0,0
23,8480845,Rasmus Kupari,C,WPG,24,0,0,0,0
23,8481550,Adam Beckman,L,MIN,23,0,0,0,0
23,8481422,Jacob Lucchini,C,MIN,29,0,0,0,0
23,8477401,John Hayden,C,SEA,29,0,0,0,0
23,8478904,Steven Lorentz,C,FLA,28,0,0,0,0
23,8482088,Justin Sourdif,R,FLA,22,0,0,0,0
23,8482751,Ryan Winterton,C,SEA,21,0,0,0,0
23,8482241,Radim Zohorna,L,PIT,28,0,0,0,0
23,8481690,Tyler Angle,C,CBJ,24,0,0,0,0
23,8476952,Dominic Toninato,C,WPG,30,0,0,0,0
23,8476919,Chris Tierney,C,NJD,30,0,0,0,0
23,8480032,Shane Bowers,C,NJD,25,0,0,0,0
23,8484314,Jiri Smejkal,L,OTT,28,0,0,0,0
23,8481239,Samuel Fagemo,L,LAK,24,0,0,0,0
23,8481532,Alex Turcotte,C,LAK,23,0,0,0,0
23,8481019,David Gustafsson,C,WPG,24,0,0,0,0
23,8478477,Mitchell Stephens,C,MTL,27,0,0,0,0
23,8479546,Oskar Steen,C,BOS,26,0,0,0,0
23,8480292,Carson Meyer,R,CBJ,27,0,0,0,0
23,8478446,Glenn Gawdin,C,ANA,27,0,0,0,0
23,8483531,Brian Halonen,L,NJD,25,0,0,0,0
23,8477149,Scott Sabourin,R,SJS,32,0,0,0,0
23,8479972,Mason Shaw,C,MIN,26,0,0,0,0
23,8480890,Jan Jenik,R,ARI,24,0,0,0,0
23,8478051,Max Willman,C,NJD,29,0,0,0,0
23,8480851,Akil Thomas,C,LAK,24,0,0,0,0
23,8482765,Isak Rosen,R,BUF,21,0,0,0,0
23,8478421,A.J. Greer,L,CGY,28,0,0,0,0
23,8478512,Austin Czarnik,C,DET,32,0,0,0,0
23,8479536,Axel Jonsson-Fjallby,L,WPG,26,0,0,0,0
23,8477320,Anton Blidh,L,NYR,29,0,0,0,0
23,8481543,Nikita Alexandrov,C,STL,24,0,0,0,0
23,8475235,Nicolas Deslauriers,L,PHI,33,0,0,0,0
23,8481070,Hugh McGing,L,STL,26,0,0,0,0
23,8480836,Jonathan Gruden,C,PIT,24,0,0,0,0
23,8481591,Sam Poulin,R,PIT,23,0,0,0,0
23,8477962,Brendan Lemieux,L,CAR,28,0,0,0,0
23,8483401,Marc Johnstone,R,PIT,28,0,0,0,0
23,8482250,Callahan Burke,C,CAR,27,0,0,0,0
23,8481726,Adam Edstrom,C,NYR,24,0,0,0,0
23,8471817,Ryan Reaves,R,TOR,37,0,0,0,0
23,8479587,Rhett Gardner,C,PHI,28,0,0,0,0
23,8475766,Austin Watson,L,TBL,32,0,0,0,0
23,8479367,William Lockwood,R,FLA,26,0,0,0,0
23,8478424,Jansen Harkins,C,PIT,27,0,0,0,0
23,8476913,Devin Shore,C,SEA,30,0,0,0,0
23,8482652,Walker Duehr,R,CGY,27,0,0,0,0
23,8477527,Ross Johnston,L,ANA,30,0,0,0,0
23,8481077,John Leonard,L,ARI,26,0,0,0,0
23,8483549,Lucas Condotta,L,MTL,27,0,0,0,0
23,8480468,James Hamblin,L,EDM,25,0,0,0,0
23,8476907,Mackenzie MacEachern,L,STL,30,0,0,0,0
23,8479543,Michael Pezzetta,L,MTL,26,0,0,0,0
23,8480355,Mark Kastelic,C,OTT,25,0,0,0,0
23,8482162,Roby Jarventie,L,OTT,22,0,0,0,0
23,8479772,Zack MacEwen,R,OTT,28,0,0,0,0
23,8483597,Milos Kelemen,L,ARI,25,0,0,0,0
23,8479379,Givani Smith,R,SJS,26,0,0,0,0
23,8481655,Cole Schwindt,R,CGY,23,0,0,0,0
23,8479981,Jonah Gadjovich,L,FLA,26,0,0,0,0
23,8482147,Jean-Luc Foudy,C,COL,22,0,0,0,0
23,8484255,Jason Polin,R,COL,25,0,0,0,0
23,8477993,Justin Kirkland,C,ARI,28,0,0,0,0
23,8479249,Andrew Poturalski,C,SEA,30,0,0,0,0
23,8482197,Adam Raska,R,MIN,23,0,0,0,0
23,8475780,Chris Wagner,R,COL,33,0,0,0,0
23,8479533,Joona Koppanen,L,PIT,26,0,0,0,0
23,8481534,Raphael Lavoie,C,EDM,24,0,0,0,0
23,8484321,Nikolas Matinpalo,D,OTT,26,0,0,0,0
23,8481043,Cole Koepke,L,TBL,26,0,0,0,0
23,8476323,Max McCormick,L,SEA,32,0,0,0,0
23,8483609,Adam Klapka,R,CGY,24,0,0,0,0
23,8483512,Matt Savoie,C,BUF,20,0,0,0,0
23,8484259,Ondrej Pavel,C,COL,31,0,0,0,0
23,8478147,Bokondji Imama,L,OTT,28,0,0,0,0
23,8482460,Matt Rempe,C,NYR,22,0,0,0,0
23,8477073,Kurtis MacDermid,L,NJD,30,0,0,0,0
23,8480274,Philip Kemp,D,EDM,25,0,0,0,0
23,8478956,Samuel Laberge,L,NJD,27,0,0,0,0
23,8483045,Cameron Butler,R,CBJ,31,0,0,0,0
24,8477492,Nathan MacKinnon,C,COL,29,82,58,71,129
24,8476453,Nikita Kucherov,R,TBL,31,82,40,83,123
24,8478420,Mikko Rantanen,R,COL,28,82,43,68,111
24,8479318,Auston Matthews,C,TOR,27,82,60,48,108
24,8481559,Jack Hughes,C,NJD,23,82,44,59,103
24,8478864,Kirill Kaprizov,L,MIN,27,82,47,55,102
24,8477404,Jake Guentzel,C,CAR,30,82,47,55,102
24,8478402,Connor McDavid,C,EDM,27,82,31,70,101
24,8477933,Sam Reinhart,C,FLA,29,82,51,48,99
24,8477493,Aleksander Barkov,C,FLA,29,82,30,66,96
24,8476468,J.T. Miller,C,VAN,31,82,32,63,95
24,8478550,Artemi Panarin,L,NYR,33,82,31,62,93
24,8477946,Dylan Larkin,C,DET,28,82,41,51,92
24,8478427,Sebastian Aho,C,CAR,27,82,34,58,92
24,8471675,Sidney Crosby,C,PIT,37,82,37,54,91
24,8480069,Cale Makar,D,COL,26,82,20,71,91
24,8478010,Brayden Point,C,TBL,28,82,49,41,90
24,8479407,Jesper Bratt,L,NJD,26,82,29,58,87
24,8477934,Leon Draisaitl,C,EDM,29,82,36,50,86
24,8480023,Robert Thomas,C,STL,25,82,30,56,86
24,8478440,Dylan Strome,C,WSH,27,82,27,57,84
24,8480012,Elias Pettersson,C,VAN,26,82,39,44,83
24,8476887,Filip Forsberg,L,NSH,30,82,39,44,83
24,8474600,Roman Josi,D,NSH,34,82,21,62,83
24,8480002,Nico Hischier,C,NJD,25,82,29,52,81
24,8480027,Jason Robertson,L,DAL,25,82,34,46,80
24,8477956,David Pastrnak,R,BOS,28,82,38,41,79
24,8474590,John Carlson,D,WSH,34,82,15,64,79
24,8480800,Quinn Hughes,D,VAN,25,82,13,66,79
24,8479314,Matthew Tkachuk,L,FLA,27,82,31,47,78
24,8475786,Zach Hyman,L,EDM,32,82,41,36,77
24,8478042,Viktor Arvidsson,R,LAK,31,82,36,41,77
24,8478445,Mathew Barzal,C,NYI,27,82,19,58,77
24,8475172,Nazem Kadri,C,CGY,34,82,30,46,76
24,8481557,Matt Boldy,L,MIN,23,82,38,37,75
24,8475168,Matt Duchene,C,DAL,33,82,29,46,75
24,8471214,Alex Ovechkin,L,WSH,39,82,40,34,74
24,8482116,Tim Stützle,C,OTT,22,82,32,42,74
24,8482684,Luke Hughes,D,NJD,21,82,23,51,74
24,8480036,Miro Heiskanen,D,DAL,25,82,13,61,74
24,8479420,Tage Thompson,C,BUF,27,82,33,39,72
24,8476454,Ryan Nugent-Hopkins,C,EDM,31,82,27,45,72
24,8475765,Vladimir Tarasenko,R,FLA,33,82,25,47,72
24,8480801,Brady Tkachuk,L,OTT,25,82,39,32,71
24,8477416,Oliver Bjorkstrand,R,SEA,29,82,31,40,71
24,8474564,Steven Stamkos,C,TBL,34,82,28,43,71
24,8477949,Alex Tuch,R,BUF,28,82,21,50,71
24,8478414,Timo Meier,R,NJD,28,82,32,37,69
24,8476459,Mika Zibanejad,C,NYR,31,82,29,40,69
24,8477942,Kevin Fiala,L,LAK,28,82,28,41,69
24,8479542,Brandon Hagel,L,TBL,26,82,28,41,69
24,8478047,Michael Bunting,L,PIT,29,82,28,40,68
24,8479323,Adam Fox,D,NYR,26,82,17,51,68
24,8478407,Vince Dunn,D,SEA,28,82,12,56,68
24,8475184,Chris Kreider,L,NYR,33,82,41,26,67
24,8477939,William Nylander,R,TOR,28,82,29,37,66
24,8478403,Jack Eichel,C,VGK,28,82,27,39,66
24,8480830,Andrei Svechnikov,R,CAR,24,82,26,40,66
24,8477402,Pavel Buchnevich,L,STL,29,82,24,42,66
24,8482078,Lucas Raymond,L,DET,22,82,23,43,66
24,8477409,Carter Verhaeghe,C,FLA,29,82,20,46,66
24,8476456,Jonathan Huberdeau,C,CGY,31,82,18,48,66
24,8481523,Kirby Dach,C,MTL,23,82,8,58,66
24,8478444,Brock Boeser,R,VAN,27,82,31,34,65
24,8478398,Kyle Connor,L,WPG,28,82,29,36,65
24,8471215,Evgeni Malkin,C,PIT,38,82,24,41,65
24,8476346,Johnny Gaudreau,L,CBJ,31,82,20,45,65
24,8474578,Erik Karlsson,D,PIT,34,82,16,49,65
24,8476880,Tom Wilson,R,WSH,30,82,32,32,64
24,8475166,John Tavares,C,TOR,34,82,31,33,64
24,8480031,Maxime Comtois,L,CAR,25,82,12,52,64
24,8476853,Morgan Rielly,D,TOR,30,82,7,57,64
24,8471685,Anze Kopitar,C,LAK,37,82,18,45,63
24,8479337,Alex DeBrincat,R,DET,27,82,32,30,62
24,8476462,Dougie Hamilton,D,NJD,31,82,24,38,62
24,8477955,Jared McCann,L,SEA,28,82,23,39,62
24,8474141,Patrick Kane,R,DET,36,82,17,45,62
24,8475692,Mats Zuccarello,R,MIN,37,82,17,45,62
24,8476539,Jonathan Marchessault,R,VGK,34,82,30,31,61
24,8479385,Jordan Kyrou,C,STL,26,82,27,34,61
24,8475170,Brayden Schenn,C,STL,33,82,24,37,61
24,8481528,Dylan Cozens,C,BUF,23,82,23,38,61
24,8473512,Claude Giroux,R,OTT,36,82,17,44,61
24,8478873,Troy Terry,R,ANA,27,82,31,29,60
24,8479343,Clayton Keller,R,ARI,26,82,27,33,60
24,8478439,Travis Konecny,R,PHI,27,82,23,37,60
24,8470794,Joe Pavelski,C,DAL,40,82,20,40,60
24,8480208,Drake Batherson,R,OTT,26,82,19,41,60
24,8475794,Tyler Seguin,C,DAL,32,82,30,29,59
24,8482665,Matty Beniers,C,SEA,22,82,26,33,59
24,8482093,Seth Jarvis,C,CAR,22,82,23,36,59
24,8480839,Rasmus Dahlin,D,BUF,24,82,14,45,59
24,8475784,Jeff Skinner,C,BUF,32,82,27,31,58
24,8475810,Bryan Rust,R,PIT,32,82,24,34,58
24,8475913,Mark Stone,R,VGK,32,82,24,34,58
24,8477940,Nikolaj Ehlers,L,WPG,28,82,23,35,58
24,8478401,Pavel Zacha,C,BOS,27,82,17,41,58
24,8476460,Mark Scheifele,C,WPG,31,82,32,25,57
24,8478449,Roope Hintz,C,DAL,28,82,27,30,57
24,8473419,Brad Marchand,L,BOS,36,82,23,34,57
24,8480018,Nick Suzuki,C,MTL,25,82,22,35,57
24,8482124,Quinton Byfield,R,LAK,22,82,15,42,57
24,8477504,Josh Morrissey,D,WPG,29,82,12,45,57
24,8479400,Pierre-Luc Dubois,L,LAK,26,82,26,30,56
24,8474157,Max Pacioretty,L,WSH,36,82,25,31,56
24,8477501,Valeri Nichushkin,R,COL,29,82,24,32,56
24,8478493,Joel Eriksson Ek,C,MIN,27,82,22,34,56
24,8475167,Victor Hedman,D,TBL,34,82,9,47,56
24,8477447,Shea Theodore,D,VGK,29,82,8,48,56
24,8481540,Cole Caufield,R,MTL,23,82,27,28,55
24,8477960,Adrian Kempe,R,LAK,28,82,25,30,55
24,8482097,Jack Quinn,R,BUF,23,82,20,35,55
24,8480014,Gabriel Vilardi,C,WPG,25,82,30,24,54
24,8479675,Trevor Moore,L,LAK,29,82,28,26,54
24,8480078,Filip Chytil,C,NYR,25,82,14,40,54
24,8475754,Brock Nelson,C,NYI,33,82,30,23,53
24,8479339,Patrik Laine,L,CBJ,26,82,27,26,53
24,8477476,Artturi Lehkonen,L,COL,29,82,23,30,53
24,8474586,Jordan Eberle,R,SEA,34,82,22,31,53
24,8475158,Ryan O'Reilly,C,NSH,33,82,20,33,53
24,8478469,Thomas Chabot,D,OTT,27,82,17,36,53
24,8477951,Nick Schmaltz,C,ARI,28,82,15,38,53
24,8480039,Martin Necas,C,CAR,25,82,27,25,52
24,8475169,Evander Kane,L,EDM,33,82,25,27,52
24,8474150,Mikael Backlund,C,CGY,35,82,21,31,52
24,8475798,Mikael Granlund,C,SJS,32,82,11,41,52
24,8477952,Robby Fabbri,C,DET,28,82,25,26,51
24,8473994,Jamie Benn,L,DAL,35,82,21,30,51
24,8479999,Casey Mittelstadt,C,COL,26,82,16,35,51
24,8474679,Gustav Nyquist,C,NSH,35,82,16,35,51
24,8477986,Brandon Montour,D,FLA,30,82,15,36,51
24,8476826,Yanni Gourde,C,SEA,33,82,14,37,51
24,8477500,Bo Horvat,C,NYI,29,82,27,23,50
24,8480015,Owen Tippett,R,PHI,25,82,26,24,50
24,8475287,Erik Haula,L,NJD,33,82,25,25,50
24,8476448,William Karlsson,C,VGK,31,82,21,29,50
24,8476881,Tomas Hertl,C,VGK,31,82,19,31,50
24,8476479,Phillip Danault,C,LAK,31,82,18,32,50
24,8482175,JJ Peterka,R,BUF,22,82,18,32,50
24,8480028,Morgan Frost,C,PHI,25,82,17,33,50
24,8476869,Brady Skjei,D,CAR,30,82,16,34,50
24,8477496,Elias Lindholm,C,VAN,30,82,15,35,50
24,8478460,Zach Werenski,D,CBJ,27,82,10,40,50
24,8479325,Charlie McAvoy,D,BOS,27,82,8,42,50
24,8480865,Noah Dobson,D,NYI,24,82,8,42,50
24,8476483,Rickard Rakell,R,PIT,31,82,31,18,49
24,8475314,Anders Lee,L,NYI,34,82,26,23,49
24,8476399,Blake Coleman,C,CGY,33,82,24,25,49
24,8478975,Mason Marchment,L,DAL,29,82,24,25,49
24,8482109,Alexis Lafrenière,L,NYR,23,82,24,25,49
24,8478498,Jake DeBrusk,L,BOS,28,82,24,25,49
24,8483808,Andrei Kuzmenko,L,CGY,28,82,22,27,49
24,8476389,Vincent Trocheck,C,NYR,31,82,20,29,49
24,8477429,Andrew Copp,C,DET,30,82,19,30,49
24,8477444,Andre Burakovsky,L,SEA,29,82,18,31,49
24,8476292,Ondrej Palat,L,NJD,33,82,16,33,49
24,8477503,Max Domi,C,TOR,29,82,16,33,49
24,8481711,Matias Maccelli,L,ARI,24,82,14,35,49
24,8479345,Jakob Chychrun,D,OTT,26,82,14,35,49
24,8480064,Josh Norris,C,OTT,25,82,29,19,48
24,8477935,Sam Bennett,C,FLA,28,82,22,26,48
24,8480798,Philipp Kurashev,C,CHI,25,82,19,29,48
24,8477456,J.T. Compher,L,DET,29,82,18,30,48
24,8479525,Ross Colton,C,COL,28,82,18,30,48
24,8475744,Evgeny Kuznetsov,C,CAR,32,82,10,38,48
24,8482110,Dawson Mercer,C,NJD,23,82,24,23,47
24,8480188,Fabian Zetterlund,L,SJS,25,82,21,26,47
24,8482745,Mason McTavish,C,ANA,21,82,16,31,47
24,8478519,Anthony Cirelli,C,TBL,27,82,15,32,47
24,8477495,Seth Jones,D,CHI,30,82,10,37,47
24,8476958,Jaccob Slavin,D,CAR,30,82,10,37,47
24,8475726,Tyler Toffoli,C,WPG,32,82,22,24,46
24,8477451,Ryan Hartman,R,MIN,30,82,21,25,46
24,8478046,Danton Heinen,L,BOS,29,82,21,25,46
24,8483515,Juraj Slafkovsky,L,MTL,20,82,19,27,46
24,8471724,Kris Letang,D,PIT,37,82,15,31,46
24,8477346,MacKenzie Weegar,D,CGY,30,82,13,33,46
24,8480803,Evan Bouchard,D,EDM,25,82,11,35,46
24,8480009,Eeli Tolvanen,R,SEA,25,82,27,18,45
24,8484144,Connor Bedard,C,CHI,19,82,23,22,45
24,8471698,T.J. Oshie,R,WSH,38,82,23,22,45
24,8474102,David Perron,L,DET,36,82,21,24,45
24,8478856,Conor Garland,R,VAN,28,82,19,26,45
24,8482740,Wyatt Johnston,C,DAL,21,82,18,27,45
24,8480797,Joel Farabee,L,PHI,24,82,18,27,45
24,8476905,Chandler Stephenson,C,VGK,30,82,15,30,45
24,8475745,Charlie Coyle,C,BOS,32,82,15,30,45
24,8478055,Gustav Forsling,D,FLA,28,82,15,30,45
24,8478438,Tommy Novak,C,NSH,27,82,23,21,44
24,8475848,Brendan Gallagher,R,MTL,32,82,22,22,44
24,8482159,Tyson Foerster,R,PHI,22,82,19,25,44
24,8475768,Jaden Schwartz,C,SEA,32,82,18,26,44
24,8477932,Aaron Ekblad,D,FLA,28,82,10,34,44
24,8475760,Nick Bjugstad,C,ARI,32,82,22,21,43
24,8482699,Dylan Guenther,R,ARI,21,82,19,24,43
24,8478472,Mathieu Joseph,R,OTT,27,82,12,31,43
24,8479410,Mikhail Sergachev,D,TBL,26,82,10,33,43
24,8477479,Tyler Bertuzzi,L,TOR,29,82,22,20,42
24,8475151,Kyle Palmieri,C,NYI,33,82,18,24,42
24,8475722,Jason Zucker,L,NSH,32,82,18,24,42
24,8479987,Morgan Geekie,C,BOS,26,82,16,26,42
24,8481186,Logan O'Connor,R,COL,28,82,16,26,42
24,8481068,Yegor Sharangovich,C,CGY,26,82,15,27,42
24,8477021,Alex Kerfoot,C,ARI,30,82,15,27,42
24,8470613,Brent Burns,D,CAR,39,82,15,27,42
24,8477497,Sean Monahan,C,WPG,30,82,14,28,42
24,8475191,Reilly Smith,R,PIT,33,82,14,28,42
24,8480434,Sean Durzi,D,ARI,26,82,13,29,42
24,8474037,James van Riemsdyk,L,BOS,35,82,13,29,42
24,8481656,Aliaksei Protas,C,WSH,23,82,10,32,42
24,8475906,John Klingberg,D,TOR,32,82,9,33,42
24,8481542,Moritz Seider,D,DET,23,82,9,33,42
24,8473986,Alex Killorn,L,ANA,35,82,20,21,41
24,8482705,Cole Sillinger,C,CBJ,21,82,20,21,41
24,8478542,Evan Rodrigues,C,FLA,31,82,15,26,41
24,8476923,Damon Severson,D,CBJ,30,82,13,28,41
24,8476278,Colin Blackwell,C,CHI,31,82,13,28,41
24,8481533,Trevor Zegras,C,ANA,23,82,11,30,41
24,8476875,Mike Matheson,D,MTL,30,82,9,32,41
24,8475218,Mattias Ekholm,D,EDM,34,82,5,36,41
24,8482101,Danil Gushchin,L,SJS,22,82,22,18,40
24,8482146,Luke Evangelista,R,NSH,22,82,20,20,40
24,8481580,Connor McMichael,C,WSH,23,82,19,21,40
24,8478462,Nicolas Roy,C,VGK,27,82,18,22,40
24,8478474,Lawson Crouse,L,ARI,27,82,27,12,39
24,8474641,Adam Henrique,C,EDM,34,82,25,14,39
24,8476432,Boone Jenner,C,CBJ,31,82,23,16,39
24,8474053,Logan Couture,C,SJS,35,82,20,19,39
24,8481596,Shane Pinto,C,OTT,24,82,14,25,39
24,8481581,Thomas Harley,D,DAL,23,82,10,29,39
24,8476882,Teuvo Teravainen,L,CAR,30,82,9,30,39
24,8474563,Drew Doughty,D,LAK,35,82,9,30,39
24,8481703,Valtteri Puustinen,R,PIT,25,82,8,31,39
24,8478396,Noah Hanifin,D,VGK,27,82,5,34,39
24,8475197,Tyson Barrie,D,NSH,33,82,5,34,39
24,8482089,Jake Neighbours,L,STL,22,82,20,18,38
24,8477947,Sonny Milano,L,WSH,28,82,20,18,38
24,8475763,Kevin Hayes,R,STL,32,82,15,23,38
24,8481013,Jonatan Berggren,R,DET,24,82,14,24,38
24,8480220,Noah Cates,L,PHI,25,82,13,25,38
24,8482667,William Eklund,L,SJS,22,82,11,27,38
24,8475753,Justin Faulk,D,STL,32,82,10,28,38
24,8479425,Filip Hronek,D,VAN,27,82,6,32,38
24,8476906,Shayne Gostisbehere,D,DET,31,82,4,34,38
24,8481699,Aku Raty,R,ARI,23,82,4,34,38
24,8481016,Ruslan Iskhakov,C,NYI,24,82,1,37,38
24,8483397,Marc McLaughlin,C,BOS,25,82,33,4,37
24,8481618,Alex Newhook,C,MTL,23,82,20,17,37
24,8477426,Nicholas Paul,L,TBL,29,82,19,18,37
24,8477998,Warren Foegele,L,EDM,28,82,17,20,37
24,8477407,Anthony Duclair,L,TBL,29,82,16,21,37
24,8475799,Nino Niederreiter,R,WPG,32,82,15,22,37
24,8481535,Nils Hoglander,L,VAN,24,82,15,22,37
24,8480043,Timothy Liljegren,D,TOR,25,82,10,27,37
24,8482720,Matthew Knies,L,TOR,22,82,9,28,37
24,8481604,Pavel Dorofeyev,L,VGK,24,82,24,12,36
24,8481624,Ilya Mikheyev,R,VAN,30,82,21,15,36
24,8478458,Jack Roslovic,C,NYR,27,82,17,19,36
24,8477494,Jonathan Drouin,L,COL,29,82,16,20,36
24,8480893,Kirill Marchenko,R,CBJ,24,82,16,20,36
24,8478466,Daniel Sprong,R,DET,27,82,16,20,36
24,8477511,Anthony Mantha,R,VGK,30,82,15,21,36
24,8480802,Ryan McLeod,C,EDM,25,82,13,23,36
24,8476927,Teddy Blueger,C,VAN,30,82,9,27,36
24,8480873,Rasmus Sandin,D,WSH,24,82,7,29,36
24,8476792,Torey Krug,D,STL,33,82,6,30,36
24,8483524,Shane Wright,C,SEA,20,82,25,10,35
24,8478115,Pierre Engvall,L,NYI,28,82,21,14,35
24,8484166,Adam Fantilli,C,CBJ,20,82,21,14,35
24,8480068,Ryan Poehling,C,PHI,25,82,20,15,35
24,8476458,Ryan Strome,C,ANA,31,82,16,19,35
24,8477989,Christian Dvorak,C,MTL,28,82,16,19,35
24,8479992,Michael Rasmussen,C,DET,25,82,15,20,35
24,8483431,Logan Cooley,C,ARI,20,82,15,20,35
24,8476438,Brandon Saad,L,STL,32,82,13,22,35
24,8474149,Evgenii Dadonov,R,DAL,35,82,13,22,35
24,8482113,Anton Lundell,C,FLA,23,82,12,23,35
24,8476329,Travis Boyd,C,ARI,31,82,10,25,35
24,8474565,Alex Pietrangelo,D,VGK,34,82,8,27,35
24,8476467,Jamie Oleksiak,D,SEA,32,82,6,29,35
24,8476892,Colton Parayko,D,STL,31,82,4,31,35
24,8473533,Jordan Staal,C,CAR,36,82,16,18,34
24,8479941,Justin Danforth,R,CBJ,31,82,15,19,34
24,8478463,Anthony Beauvillier,L,NSH,27,82,14,20,34
24,8476312,Josh Manson,D,COL,33,82,14,20,34
24,8477964,Ivan Barbashev,C,VGK,29,82,12,22,34
24,8479365,Trent Frederic,C,BOS,26,82,12,22,34
24,8477953,Kasperi Kapanen,R,STL,28,82,11,23,34
24,8480817,K'Andre Miller,D,NYR,24,82,9,25,34
24,8478038,Devon Toews,D,COL,30,82,7,27,34
24,8482105,Jake Sanderson,D,OTT,22,82,5,29,34
24,8471218,Blake Wheeler,R,NYR,38,82,14,19,33
24,8482624,Daniil Miromanov,D,CGY,27,82,8,25,33
24,8475200,Dmitry Orlov,D,CAR,33,82,6,27,33
24,8482145,Mavrik Bourque,C,DAL,22,82,25,7,32
24,8476873,Mark Jankowski,C,NSH,30,82,18,14,32
24,8479293,Brandon Tanev,L,SEA,33,82,16,16,32
24,8477353,Tyler Motte,C,TBL,29,82,15,17,32
24,8482055,Drew O'Connor,L,PIT,26,82,14,18,32
24,8480459,Pius Suter,C,VAN,28,82,13,19,32
24,8480185,Eetu Luostarinen,C,FLA,26,82,12,20,32
24,8479415,Michael McLeod,C,NJD,26,82,12,20,32
24,8475791,Taylor Hall,L,CHI,33,82,11,21,32
24,8473422,Nick Foligno,L,CHI,37,82,9,23,32
24,8482122,Brock Faber,D,MIN,22,82,5,27,32
24,8483471,Brad Lambert,C,WPG,31,82,2,30,32
24,8473449,Kyle Okposo,R,FLA,36,82,20,11,31
24,8475343,Nic Dowd,C,WSH,34,82,13,18,31
24,8479346,Dillon Dube,C,CGY,26,82,12,19,31
24,8475714,Calle Jarnkrok,C,TOR,33,82,10,21,31
24,8483445,Cutter Gauthier,L,ANA,20,82,9,22,31
24,8482222,Alexander Barabanov,L,SJS,30,82,9,22,31
24,8476392,Adam Lowry,C,WPG,31,82,9,22,31
24,8482475,Yegor Chinakhov,R,CBJ,23,82,7,24,31
24,8478133,Jake Evans,C,MTL,28,82,7,24,31
24,8483457,Lane Hutson,D,MTL,20,82,6,25,31
24,8477508,Curtis Lazar,C,NJD,29,82,6,25,31
24,8480871,Adam Boqvist,D,CBJ,24,82,5,26,31
24,8478233,Andrew Mangiapane,L,CGY,28,82,16,14,30
24,8478057,Dakota Joshua,C,VAN,28,82,16,14,30
24,8481554,Kaapo Kakko,R,NYR,23,82,15,15,30
24,8477330,Dominik Kubalik,L,OTT,29,82,15,15,30
24,8475149,Marcus Johansson,L,MIN,34,82,12,18,30
24,8481704,Juuso Parssinen,C,NSH,23,82,12,18,30
24,8476480,Vladislav Namestnikov,C,WPG,32,82,11,19,30
24,8476925,Colton Sissons,C,NSH,31,82,9,21,30
24,8479351,Sam Steel,C,DAL,26,82,6,24,30
24,8482733,Logan Mailloux,D,MTL,31,82,6,24,30
24,8478397,Rasmus Andersson,D,CGY,28,82,5,25,30
24,8478911,Matt Roy,D,LAK,29,82,4,26,30
24,8476981,Josh Anderson,R,MTL,30,82,17,12,29
24,8482079,Marco Rossi,C,MIN,23,82,15,14,29
24,8481481,Blake Lizotte,C,LAK,27,82,15,14,29
24,8476872,Scott Laughton,C,PHI,30,82,14,15,29
24,8479591,Michael Eyssimont,C,TBL,28,82,14,15,29
24,8482092,Ridly Greig,C,OTT,22,82,12,17,29
24,8478109,Victor Olofsson,L,BUF,29,82,12,17,29
24,8475793,Ryan Johansen,C,PHI,32,82,11,18,29
24,8480073,Erik Brannstrom,D,OTT,25,82,9,20,29
24,8478882,Vladislav Gavrikov,D,LAK,29,82,8,21,29
24,8474716,Jared Spurgeon,D,MIN,35,82,3,26,29
24,8474151,Ryan McDonagh,D,NSH,35,82,2,27,29
24,8482118,Sam Colangelo,R,ANA,23,82,18,10,28
24,8478366,Frank Vatrano,R,ANA,30,82,17,11,28
24,8477944,Jakub Vrana,L,STL,28,82,17,11,28
24,8482125,Alexander Holtz,R,NJD,22,82,17,11,28
24,8481560,Arthur Kaliyev,R,LAK,23,82,15,13,28
24,8482062,Cole Smith,L,NSH,29,82,15,13,28
24,8479423,Alex Nylander,L,CBJ,26,82,13,15,28
24,8481517,Brett Leason,R,ANA,25,82,12,16,28
24,8480806,Isac Lundestrom,C,ANA,25,82,12,16,28
24,8478013,Jake Walman,D,DET,28,82,11,17,28
24,8479353,Brett Howden,C,VGK,26,82,10,18,28
24,8479977,Kailer Yamamoto,R,SEA,26,82,9,19,28
24,8476979,Erik Gustafsson,D,NYR,32,82,8,20,28
24,8482730,Brandt Clarke,D,LAK,21,82,7,21,28
24,8473563,Nicklas Backstrom,C,WSH,37,82,7,21,28
24,8482671,Owen Power,D,BUF,22,82,5,23,28
24,8482245,Artem Zub,D,OTT,29,82,4,24,28
24,8476419,Jean-Gabriel Pageau,C,NYI,32,82,15,12,27
24,8476469,Joel Armia,R,MTL,31,82,15,12,27
24,8477450,Jason Dickinson,C,CHI,29,82,14,13,27
24,8470621,Corey Perry,R,EDM,39,82,14,13,27
24,8482259,Bobby McMann,C,TOR,28,82,14,13,27
24,8480336,Sean Walker,D,COL,30,82,13,14,27
24,8478891,Mason Appleton,C,WPG,28,82,11,16,27
24,8470610,Zach Parise,L,COL,40,82,11,16,27
24,8480813,Joe Veleno,C,DET,24,82,10,17,27
24,8476931,Jake McCabe,D,TOR,31,82,9,18,27
24,8478413,Jordan Greenway,L,BUF,27,82,8,19,27
24,8482142,Jamie Drysdale,D,PHI,22,82,5,22,27
24,8478500,Ivan Provorov,D,CBJ,27,82,4,23,27
24,8480145,Neal Pionk,D,WPG,29,82,4,23,27
24,8477969,Marcus Pettersson,D,PIT,28,82,3,24,27
24,8477948,Travis Sanheim,D,PHI,28,82,2,25,27
24,8481178,Egor Zamula,D,PHI,24,82,1,26,27
24,8476921,Jordan Martinook,L,CAR,32,82,16,10,26
24,8481553,Bobby Brink,R,PHI,23,82,16,10,26
24,8478020,Michael Amadio,C,VGK,28,82,15,11,26
24,8482133,Thomas Bordeleau,C,SJS,22,82,14,12,26
24,8477919,Frederick Gaudreau,C,MIN,31,82,11,15,26
24,8479398,Samuel Girard,D,COL,26,82,9,17,26
24,8477425,Miles Wood,L,COL,29,82,9,17,26
24,8480796,Martin Fehervary,D,WSH,25,82,8,18,26
24,8478840,Will Borgen,D,SEA,28,82,7,19,26
24,8476463,Jonas Brodin,D,MIN,31,82,7,19,26
24,8481568,Alex Vlasic,D,CHI,23,82,3,23,26
24,8483493,Frank Nazar,C,CHI,20,82,17,8,25
24,8479996,Cody Glass,C,NSH,25,82,15,10,25
24,8474870,Tyler Johnson,C,CHI,34,82,14,11,25
24,8480849,Barrett Hayton,C,ARI,24,82,13,12,25
24,8478508,Yakov Trenin,C,COL,27,82,11,14,25
24,8474884,Mike Hoffman,C,SJS,35,82,10,15,25
24,8476374,Sean Kuraly,C,CBJ,31,82,10,15,25
24,8481028,Martin Pospisil,C,CGY,25,82,10,15,25
24,8481546,Cam York,D,PHI,23,82,8,17,25
24,8477365,Connor Clifton,D,BUF,29,82,7,18,25
24,8477506,Ryan Pulock,D,NYI,30,82,6,19,25
24,8477488,Brett Pesce,D,CAR,30,82,6,19,25
24,8476457,Adam Larsson,D,SEA,32,82,5,20,25
24,8474034,Pat Maroon,L,BOS,36,82,4,21,25
24,8478507,John Marino,D,NJD,27,82,3,22,25
24,8476461,Sean Couturier,C,PHI,32,82,14,10,24
24,8480821,Filip Zadina,R,SJS,25,82,13,11,24
24,8474715,Cam Atkinson,R,PHI,35,82,12,12,24
24,8474189,Lars Eller,C,PIT,35,82,12,12,24
24,8481601,Simon Holmstrom,R,NYI,23,82,12,12,24
24,8476960,Andreas Athanasiou,C,CHI,30,82,11,13,24
24,8479393,Noah Gregor,C,TOR,26,82,11,13,24
24,8476871,Tanner Pearson,L,MTL,32,82,10,14,24
24,8482117,Lukas Reichel,L,CHI,22,82,9,15,24
24,8475764,Cam Fowler,D,ANA,33,82,5,19,24
24,8480113,Alex Iafallo,L,WPG,31,82,12,11,23
24,8483491,Ivan Miroshnichenko,L,WSH,20,82,12,11,23
24,8470604,Jeff Carter,C,PIT,39,82,11,12,23
24,8480074,Alexandre Texier,C,CBJ,25,82,9,14,23
24,8483565,Nick Blankenburg,D,CBJ,26,82,8,15,23
24,8480035,Henri Jokiharju,D,BUF,25,82,8,15,23
24,8479983,Mario Ferraro,D,SJS,26,82,7,16,23
24,8475181,Nick Leddy,D,STL,33,82,6,17,23
24,8476854,Hampus Lindholm,D,BOS,30,82,5,18,23
24,8474673,TJ Brodie,D,TOR,34,82,5,18,23
24,8479998,Mikey Anderson,D,LAK,25,82,5,18,23
24,8478416,Erik Cernak,D,TBL,27,82,5,18,23
24,8482655,J.J. Moser,D,ARI,24,82,4,19,23
24,8475462,Radko Gudas,D,ANA,34,82,4,19,23
24,8475171,Oliver Ekman-Larsson,D,FLA,33,82,4,19,23
24,8475690,Chris Tanev,D,DAL,35,82,3,20,23
24,8482702,Logan Stankoven,C,DAL,21,82,11,11,22
24,8479390,Taylor Raddysh,R,CHI,26,82,11,11,22
24,8483499,Liam Ohgren,L,MIN,20,82,10,12,22
24,8481537,Nikita Okhotiuk,D,CGY,24,82,9,13,22
24,8484145,Zach Benson,L,BUF,19,82,9,13,22
24,8479514,Rem Pitlick,C,CHI,27,82,8,14,22
24,8481477,Nico Sturm,C,SJS,29,82,8,14,22
24,8479661,Tanner Jeannot,L,TBL,27,82,8,14,22
24,8473453,Trevor Lewis,C,LAK,37,82,8,14,22
24,8476902,Esa Lindell,D,DAL,30,82,6,16,22
24,8477220,Nate Schmidt,D,WPG,33,82,6,16,22
24,8478851,Alexandre Carrier,D,NSH,28,82,4,18,22
24,8476885,Jacob Trouba,D,NYR,30,82,3,19,22
24,8482809,Jackson Blake,R,CAR,21,82,14,7,21
24,8477839,Conor Sheary,L,TBL,32,82,12,9,21
24,8482111,Justin Barron,D,MTL,23,82,10,11,21
24,8481522,Peyton Krebs,C,BUF,23,82,10,11,21
24,8476422,Mike Reilly,D,NYI,31,82,9,12,21
24,8484153,Leo Carlsson,C,ANA,20,82,8,13,21
24,8473504,Cal Clutterbuck,R,NYI,37,82,8,13,21
24,8475231,Casey Cizikas,C,NYI,33,82,8,13,21
24,8481606,Jordan Spence,D,LAK,23,82,5,16,21
24,8479371,Dante Fabbro,D,NSH,26,82,5,16,21
24,8473507,Jeff Petry,D,DET,37,82,3,18,21
24,8476917,Adam Pelech,D,NYI,30,82,2,19,21
24,8477845,Trevor van Riemsdyk,D,WSH,33,82,2,19,21
24,8476967,Brett Kulak,D,EDM,30,82,2,19,21
24,8475790,Erik Gudbranson,D,CBJ,32,82,2,19,21
24,8479316,Luke Kunin,C,SJS,27,82,13,7,20
24,8478043,Sam Lafferty,C,VAN,29,82,12,8,20
24,8482155,Alex Laferriere,R,LAK,23,82,10,10,20
24,8482666,Scott Morrow,D,CAR,22,82,10,10,20
24,8475220,Marcus Foligno,L,MIN,33,82,9,11,20
24,8483505,Matthew Poitras,C,BOS,20,82,6,14,20
24,8480834,Ty Emberson,D,SJS,24,82,6,14,20
24,8477498,Darnell Nurse,D,EDM,29,82,5,15,20
24,8477015,Connor Brown,R,EDM,30,82,5,15,20
24,8476624,Barclay Goodrow,C,NYR,31,82,5,15,20
24,8477435,Ryan Graves,D,PIT,29,82,5,15,20
24,8475762,Derek Forbort,D,BOS,32,82,5,15,20
24,8476879,Cody Ceci,D,EDM,31,82,4,16,20
24,8475279,Ben Chiarot,D,DET,33,82,3,17,20
24,8479980,Nicolas Hague,D,VGK,26,82,2,18,20
24,8475233,David Savard,D,MTL,34,82,2,18,20
24,8482737,Zack Bolduc,C,STL,21,82,14,5,19
24,8479291,Kevin Rooney,C,CGY,31,82,11,8,19
24,8480855,Jack McBain,C,ARI,24,82,9,10,19
24,8476897,Oskar Sundqvist,C,STL,30,82,7,12,19
24,8478831,Kevin Stenlund,C,FLA,28,82,7,12,19
24,8477392,Hudson Fasching,R,NYI,29,82,7,12,19
24,8482087,Kaiden Guhle,D,MTL,22,82,7,12,19
24,8478430,Oliver Kylington,D,CGY,27,82,4,15,19
24,8481605,Jackson LaCombe,D,ANA,23,82,4,15,19
24,8474567,Zach Bogosian,D,MIN,34,82,4,15,19
24,8482470,Ilya Solovyov,D,CGY,24,82,4,15,19
24,8478399,Jonas Siegenthaler,D,NJD,27,82,3,16,19
24,8470966,Mark Giordano,D,TOR,41,82,2,17,19
24,8476858,Phillip Di Giuseppe,L,VAN,31,82,9,9,18
24,8475842,Sam Carrick,C,EDM,32,82,7,11,18
24,8480807,Mattias Samuelsson,D,BUF,24,82,6,12,18
24,8474574,Tyler Myers,D,VAN,34,82,6,12,18
24,8474166,Alec Martinez,D,VGK,37,82,6,12,18
24,8481014,Alexander Romanov,D,NYI,24,82,6,12,18
24,8475164,Jakob Silfverberg,R,ANA,34,82,5,13,18
24,8477369,Carson Soucy,D,VAN,30,82,5,13,18
24,8475188,Brayden McNabb,D,VGK,33,82,5,13,18
24,8477507,Nikita Zadorov,D,VAN,29,82,4,14,18
24,8482803,Olen Zellweger,D,ANA,21,82,4,14,18
24,8478443,Brandon Carlo,D,BOS,28,82,4,14,18
24,8484911,Collin Graf,R,SJS,22,82,4,14,18
24,8475208,Brian Dumoulin,D,SEA,33,82,3,15,18
24,8480246,Nick Perbix,D,TBL,26,82,2,16,18
24,8470600,Ryan Suter,D,DAL,39,82,2,16,18
24,8483490,Pavel Mintyukov,D,ANA,21,82,1,17,18
24,8480448,Parker Kelly,L,OTT,25,82,9,8,17
24,8479359,Beck Malenstyn,L,WSH,26,82,7,10,17
24,8478136,Jake Middleton,D,MIN,28,82,4,13,17
24,8478178,Darren Raddysh,D,TBL,28,82,4,13,17
24,8482177,Marat Khusnutdinov,C,MIN,22,82,4,13,17
24,8479369,Andrew Peeke,D,BOS,26,82,4,13,17
24,8481567,Henry Thrun,D,SJS,23,82,3,14,17
24,8476331,Dylan DeMelo,D,WPG,31,82,3,14,17
24,8476372,Nick Seeler,D,PHI,31,82,2,15,17
24,8482074,Connor Zary,C,CGY,23,82,11,5,16
24,8482762,Simon Edvinsson,D,DET,21,82,9,7,16
24,8480990,Declan Chisholm,D,MIN,24,82,7,9,16
24,8477505,Alexander Wennberg,C,NYR,30,82,5,11,16
24,8478468,Jeremy Lauzon,D,NSH,27,82,5,11,16
24,8479383,Boris Katchouk,L,OTT,26,82,5,11,16
24,8476525,Colin Miller,D,WPG,32,82,4,12,16
24,8483466,Kevin Korchinski,D,CHI,20,82,3,13,16
24,8482516,Matthew Kessel,D,STL,24,82,3,13,16
24,8479324,Ryan Lindgren,D,NYR,26,82,3,13,16
24,8480281,Alexey Toropchenko,R,STL,25,82,10,5,15
24,8482679,Matt Coronato,R,CGY,22,82,6,9,15
24,8476429,Scott Mayfield,D,NYI,32,82,5,10,15
24,8476891,Matt Grzelcyk,D,BOS,30,82,5,10,15
24,8479976,Juuso Valimaki,D,ARI,26,82,4,11,15
24,8480172,Jan Rutta,D,SJS,34,82,4,11,15
24,8481059,Scott Perunovich,D,STL,26,82,4,11,15
24,8483495,Simon Nemec,D,NJD,20,82,3,12,15
24,8480879,Jacob Bernard-Docker,D,OTT,24,82,2,13,15
24,8480860,Kevin Bahl,D,NJD,24,82,2,13,15
24,8475324,Nick Jensen,D,WSH,34,82,1,14,15
24,8484203,Bradly Nadeau,L,CAR,19,82,12,2,14
24,8480980,Connor Dewar,C,TOR,25,82,6,8,14
24,8482712,Oskar Olausson,R,COL,22,82,4,10,14
24,8478451,Ethan Bear,D,WSH,27,82,4,10,14
24,8480058,Pierre-Olivier Joseph,D,PIT,25,82,3,11,14
24,8471677,Jack Johnson,D,COL,37,82,3,11,14
24,8475179,Dmitry Kulikov,D,FLA,34,82,3,11,14
24,8482073,Braden Schneider,D,NYR,23,82,6,7,13
24,8478859,Niko Mikkola,D,FLA,28,82,5,8,13
24,8476442,Matt Nieto,L,PIT,32,82,5,8,13
24,8477406,Mattias Janmark,C,EDM,32,82,4,9,13
24,8477034,Jaycob Megna,D,CHI,32,82,4,9,13
24,8480144,David Kampf,C,TOR,29,82,4,9,13
24,8479442,Troy Stecher,D,EDM,30,82,4,9,13
24,8474009,Nick Bonino,C,NYR,36,82,3,10,13
24,8475825,Jani Hakanpää,D,DAL,32,82,2,11,13
24,8477499,Rasmus Ristolainen,D,PHI,30,82,1,12,13
24,8474013,Ian Cole,D,VAN,35,82,1,12,13
24,8476878,Zemgus Girgensons,L,BUF,30,82,9,3,12
24,8476822,Luke Glendening,C,TBL,35,82,8,4,12
24,8478569,Noel Acciari,C,PIT,33,82,5,7,12
24,8477335,Kyle Burroughs,D,SJS,29,82,4,8,12
24,8476473,Connor Murphy,D,CHI,31,82,2,10,12
24,8481093,Rafael Harvey-Pinard,L,MTL,25,82,8,3,11
24,8483482,Tristan Luneau,D,ANA,20,82,3,8,11
24,8483763,Maksymilian Szuber,D,ARI,22,82,3,8,11
24,8481524,Bowen Byram,D,BUF,23,82,2,9,11
24,8482858,Ryker Evans,D,SEA,23,82,2,9,11
24,8484149,Gavin Brindley,C,CBJ,20,82,2,9,11
24,8482166,Shakir Mukhamadullin,D,SJS,22,82,0,11,11
24,8476915,Jujhar Khaira,L,MIN,30,82,5,5,10
24,8481030,Jack St. Ivany,D,PIT,25,82,3,7,10
24,8477931,Tomas Nosek,L,NJD,32,82,2,8,10
24,8475177,Calvin de Haan,D,TBL,33,82,3,6,9
24,8483468,Jiri Kulich,C,BUF,20,82,3,6,9
24,8475455,Brenden Dillon,D,WPG,34,82,0,9,9
24,8482713,Mackie Samoskevich,R,FLA,22,82,3,4,7
24,8483012,Logan Morrison,C,SEA,22,82,1,6,7
24,8478408,Travis Dermott,D,ARI,28,82,1,6,7
24,8483489,Fraser Minten,C,TOR,31,82,3,2,5
24,8482807,Ethan Del Mastro,D,CHI,21,82,2,3,5
24,8481578,Graeme Clarke,R,NJD,23,82,3,1,4
24,8482859,Zack Ostapchuk,C,OTT,21,82,1,3,4
24,8481599,Victor Soderstrom,D,ARI,23,82,2,1,3
24,8482141,Lukas Cormier,D,VGK,22,0,0,0,0
24,8476988,Matt Benning,D,SJS,30,0,0,0,0
24,8480727,Zach Whitecloud,D,VGK,28,0,0,0,0
24,8480887,Jordan Harris,D,MTL,24,0,0,0,0
24,8478450,Parker Wotherspoon,D,BOS,27,0,0,0,0
24,8481812,Nikolai Knyzhov,D,SJS,27,0,0,0,0
24,8480001,Urho Vaakanainen,D,ANA,25,0,0,0,0
24,8482176,Wyatt Kaiser,D,CHI,22,0,0,0,0
24,8481122,Simon Benoit,D,TOR,26,0,0,0,0
24,8476441,Joel Edmundson,D,TOR,31,0,0,0,0
24,8480884,Calen Addison,D,SJS,24,0,0,0,0
24,8482511,Mason Lohrei,D,BOS,23,0,0,0,0
24,8482192,Isaak Phillips,D,CHI,23,0,0,0,0
24,8480950,Ilya Lyubushkin,D,TOR,30,0,0,0,0
24,8474031,Kevin Shattenkirk,D,BOS,35,0,0,0,0
24,8475718,Justin Holl,D,DET,32,0,0,0,0
24,8479402,Jake Bean,D,CBJ,26,0,0,0,0
24,8474602,Justin Schultz,D,SEA,34,0,0,0,0
24,8477950,Tony DeAngelo,D,CAR,29,0,0,0,0
24,8481743,Marc Del Gaizo,D,NSH,25,0,0,0,0
24,8481527,Kaedan Korczak,D,VGK,23,0,0,0,0
24,8480192,Johnathan Kovacevic,D,MTL,27,0,0,0,0
24,8476874,Olli Maatta,D,DET,30,0,0,0,0
24,8482144,Jack Thompson,D,SJS,22,0,0,0,0
24,8480222,Sebastian Aho,D,NYI,28,0,0,0,0
24,8479458,Nikita Zaitsev,D,CHI,33,0,0,0,0
24,8471709,Marc-Edouard Vlasic,D,SJS,37,0,0,0,0
24,8482929,Emil Lilleberg,D,TBL,23,0,0,0,0
24,8477018,Ben Hutton,D,VGK,31,0,0,0,0
24,8481056,Spencer Stastney,D,NSH,24,0,0,0,0
24,8481593,Jayden Struble,D,MTL,23,0,0,0,0
24,8479982,Conor Timmins,D,TOR,26,0,0,0,0
24,8474090,Brendan Smith,D,NJD,35,0,0,0,0
24,8482964,Arber Xhekaj,D,MTL,23,0,0,0,0
24,8480891,Michael Kesselring,D,ARI,24,0,0,0,0
24,8477938,Haydn Fleury,D,TBL,28,0,0,0,0
24,8481806,Louis Crevier,D,CHI,23,0,0,0,0
24,8471274,Alex Goligoski,D,MIN,39,0,0,0,0
24,8481600,Tobias Bjornfot,D,FLA,23,0,0,0,0
24,8475797,Jarred Tinordi,D,CHI,32,0,0,0,0
24,8481521,Ronnie Attard,D,PHI,25,0,0,0,0
24,8474612,Travis Hamonic,D,OTT,34,0,0,0,0
24,8479576,Vincent Desharnais,D,EDM,28,0,0,0,0
24,8480049,Dylan Samberg,D,WPG,25,0,0,0,0
24,8483619,Filip Roos,D,CHI,25,0,0,0,0
24,8474568,Luke Schenn,D,NSH,35,0,0,0,0
24,8480184,Gustav Lindstrom,D,ANA,26,0,0,0,0
24,8480070,Ian Mitchell,D,BOS,25,0,0,0,0
24,8480196,Jacob Bryson,D,BUF,27,0,0,0,0
24,8471686,Marc Staal,D,PHI,37,0,0,0,0
24,8477467,Gustav Olofsson,D,SEA,30,0,0,0,0
24,8478970,Jalen Chatfield,D,CAR,28,0,0,0,0
24,8479348,Kale Clague,D,BUF,26,0,0,0,0
24,8473446,Erik Johnson,D,PHI,36,0,0,0,0
24,8477462,Robert Hagg,D,ANA,29,0,0,0,0
24,8478454,Noah Juulsen,D,VAN,27,0,0,0,0
24,8477384,Josh Brown,D,ARI,30,0,0,0,0
24,8481708,Zac Jones,D,NYR,24,0,0,0,0
24,8481167,Brayden Pachal,D,CGY,25,0,0,0,0
24,8482067,Connor Mackey,D,NYR,28,0,0,0,0
24,8483460,David Jiricek,D,CBJ,21,0,0,0,0
24,8481701,Santeri Hatakka,D,NJD,23,0,0,0,0
24,8478021,William Lagesson,D,ANA,28,0,0,0,0
24,8477851,Jordan Oesterle,D,CGY,32,0,0,0,0
24,8478452,Caleb Jones,D,COL,27,0,0,0,0
24,8479984,Cal Foote,D,NJD,26,0,0,0,0
24,8479639,Dylan Coghlan,D,CAR,26,0,0,0,0
24,8480874,Adam Ginning,D,PHI,24,0,0,0,0
24,8479321,Lucas Johansen,D,WSH,27,0,0,0,0
24,8480878,Nils Lundkvist,D,DAL,24,0,0,0,0
24,8482165,Yan Kuznetsov,D,CGY,22,0,0,0,0
24,8484258,Sam Malinski,D,COL,26,0,0,0,0
24,8480157,Calle Rosen,D,STL,30,0,0,0,0
24,8484304,Uvis Balinskis,D,FLA,28,0,0,0,0
24,8479985,Cale Fleury,D,SEA,26,0,0,0,0
24,8479378,Logan Stanley,D,WPG,26,0,0,0,0
24,8477541,Dakota Mermis,D,MIN,30,0,0,0,0
24,8481609,Vladislav Kolyachonok,D,ARI,23,0,0,0,0
24,8480823,Alexander Alexeyev,D,WSH,25,0,0,0,0
24,8481679,Maxence Guenette,D,OTT,23,0,0,0,0
24,8481564,Ryan Johnson,D,BUF,23,0,0,0,0
24,8479376,Victor Mete,D,PHI,26,0,0,0,0
24,8484254,Akito Hirose,D,VAN,25,0,0,0,0
24,8482660,Kent Johnson,C,CBJ,22,0,0,0,0
24,8482149,Cole Perfetti,C,WPG,22,0,0,0,0
24,8477987,Ryan Donato,C,CHI,28,0,0,0,0
24,8475755,Alexander Petrovic,D,DAL,32,0,0,0,0
24,8477810,Joel Hanley,D,CGY,33,0,0,0,0
24,8474145,Robert Bortuzzo,D,NYI,35,0,0,0,0
24,8481161,Jake Christiansen,D,CBJ,25,0,0,0,0
24,8476884,Derrick Pouliot,D,DAL,30,0,0,0,0
24,8481716,Dmitri Voronkov,L,CBJ,24,0,0,0,0
24,8480084,Nick DeSimone,D,NJD,30,0,0,0,0
24,8475750,Jon Merrill,D,MIN,32,0,0,0,0
24,8479315,Joey Anderson,R,CHI,26,0,0,0,0
24,8478011,Louie Belpedio,D,PHI,28,0,0,0,0
24,8482451,Mikael Pyyhtia,L,CBJ,23,0,0,0,0
24,8481541,Samuel Bolduc,D,NYI,24,0,0,0,0
24,8482126,Emil Andrae,D,PHI,31,0,0,0,0
24,8474618,Marco Scandella,D,STL,34,0,0,0,0
24,8477244,Chad Ruhwedel,D,NYR,34,0,0,0,0
24,8477971,Andreas Englund,D,LAK,28,0,0,0,0
24,8480829,Jesperi Kotkaniemi,C,CAR,24,0,0,0,0
24,8479372,Josh Mahura,D,FLA,26,0,0,0,0
24,8482095,Tyler Kleven,D,OTT,22,0,0,0,0
24,8481719,Maxwell Crozier,D,TBL,24,0,0,0,0
24,8475855,Jesper Fast,R,CAR,33,0,0,0,0
24,8480848,Ty Dellandrea,C,DAL,24,0,0,0,0
24,8475193,Tomas Tatar,L,SEA,34,0,0,0,0
24,8476889,Radek Faksa,C,DAL,30,0,0,0,0
24,8478495,Denis Gurianov,R,PHI,27,0,0,0,0
24,8480216,Jacob Peterson,C,SJS,25,0,0,0,0
24,8480252,Cole Guttman,C,CHI,25,0,0,0,0
24,8479026,Philippe Myers,D,TBL,27,0,0,0,0
24,8481006,Tyler Tucker,D,STL,24,0,0,0,0
24,8481032,Paul Cotter,C,VGK,25,0,0,0,0
24,8481577,Philip Tomasino,C,NSH,23,0,0,0,0
24,8476918,Jimmy Vesey,L,NYR,31,0,0,0,0
24,8479320,Max Lajoie,D,TOR,27,0,0,0,0
24,8478017,Mark Friedman,D,VAN,29,0,0,0,0
24,8481754,Nikita Nesterenko,C,ANA,23,0,0,0,0
24,8483407,Brandon Scanlin,D,NYR,25,0,0,0,0
24,8482659,Josh Doan,R,ARI,22,0,0,0,0
24,8477446,Michael McCarron,R,NSH,29,0,0,0,0
24,8477903,Garnet Hathaway,R,PHI,33,0,0,0,0
24,8482153,Brendan Brisson,C,VGK,23,0,0,0,0
24,8483546,Marshall Rifai,D,TOR,26,0,0,0,0
24,8484287,Cole McWard,D,VAN,23,0,0,0,0
24,8478854,Ryan Shea,D,PIT,27,0,0,0,0
24,8481585,Egor Afanasyev,L,NSH,23,0,0,0,0
24,8483398,Declan Carlile,D,TBL,31,0,0,0,0
24,8478502,Dennis Gilbert,D,CGY,28,0,0,0,0
24,8482749,Joshua Roy,R,MTL,21,0,0,0,0
24,8481598,Philip Broberg,D,EDM,23,0,0,0,0
24,8480835,Jack Drury,C,CAR,24,0,0,0,0
24,8480748,Kiefer Sherwood,L,NSH,29,0,0,0,0
24,8476934,Brock McGinn,L,ANA,30,0,0,0,0
24,8480870,Bo Groulx,C,ANA,24,0,0,0,0
24,8479368,Max Jones,L,ANA,26,0,0,0,0
24,8478099,Kevin Labanc,R,SJS,29,0,0,0,0
24,8478067,Oskar Lindblom,L,SJS,28,0,0,0,0
24,8476393,Nick Cousins,C,FLA,31,0,0,0,0
24,8483395,Arshdeep Bains,L,VAN,23,0,0,0,0
24,8480762,Eric Robinson,L,BUF,29,0,0,0,0
24,8479439,Jacob MacDonald,D,SJS,31,0,0,0,0
24,8476474,Stefan Noesen,R,CAR,31,0,0,0,0
24,8482787,Nikita Chibrikov,R,WPG,31,0,0,0,0
24,8478432,Christian Fischer,R,DET,27,0,0,0,0
24,8477979,Nicolas Aube-Kubel,R,WSH,28,0,0,0,0
24,8481789,Tye Kartye,L,SEA,23,0,0,0,0
24,8479330,Brandon Gignac,C,MTL,27,0,0,0,0
24,8480075,Cameron Crotty,D,ARI,25,0,0,0,0
24,8473473,Milan Lucic,L,BOS,36,0,0,0,0
24,8482094,Daemon Hunt,D,MIN,22,0,0,0,0
24,8481206,John Ludvig,D,PIT,24,0,0,0,0
24,8483630,Pavol Regenda,L,ANA,25,0,0,0,0
24,8481617,Vasily Podkolzin,R,VAN,23,0,0,0,0
24,8480306,Grant Hutton,D,NYI,29,0,0,0,0
24,8480995,Pontus Holmberg,R,TOR,25,0,0,0,0
24,8482148,Hendrix Lapierre,C,WSH,22,0,0,0,0
24,8477478,William Carrier,L,VGK,30,0,0,0,0
24,8480003,Jesper Boqvist,C,BOS,26,0,0,0,0
24,8482172,Landon Slaggert,L,CHI,22,0,0,0,0
24,8480789,Oliver Wahlstrom,R,NYI,24,0,0,0,0
24,8474062,Riley Nash,C,NYR,35,0,0,0,0
24,8480021,Jack Studnicka,C,SJS,25,0,0,0,0
24,8480025,MacKenzie Entwistle,R,CHI,25,0,0,0,0
24,8481582,Nicholas Robertson,L,TOR,23,0,0,0,0
24,8476867,Brendan Gaunce,C,CBJ,30,0,0,0,0
24,8479619,Michael Carcone,L,ARI,28,0,0,0,0
24,8479370,Tyson Jost,C,BUF,26,0,0,0,0
24,8479671,Mathieu Olivier,R,CBJ,27,0,0,0,0
24,8476994,Vinnie Hinostroza,C,PIT,30,0,0,0,0
24,8482070,Mitchell Chaffee,R,TBL,26,0,0,0,0
24,8477473,Justin Bailey,R,SJS,29,0,0,0,0
24,8479344,Jesse Puljujarvi,R,PIT,26,0,0,0,0
24,8480205,Emil Bemstrom,C,PIT,25,0,0,0,0
24,8479718,Alex Barré-Boulet,C,TBL,27,0,0,0,0
24,8482061,Brandon Biro,L,BUF,26,0,0,0,0
24,8479638,Justin Brazeau,R,BOS,26,0,0,0,0
24,8474040,Sam Gagner,C,EDM,35,0,0,0,0
24,8477846,Ryan Carpenter,C,SJS,33,0,0,0,0
24,8482077,Dylan Holloway,L,EDM,23,0,0,0,0
24,8482157,Will Cuylle,L,NYR,22,0,0,0,0
24,8480007,Jonas Rondbjerg,R,VGK,25,0,0,0,0
24,8478874,Adam Gaudette,C,STL,28,0,0,0,0
24,8478434,Keegan Kolesar,R,VGK,27,0,0,0,0
24,8480441,Trey Fix-Wolansky,R,CBJ,25,0,0,0,0
24,8479994,Jaret Anderson-Dolan,C,NSH,25,0,0,0,0
24,8483567,Georgii Merkulov,C,BOS,24,0,0,0,0
24,8477380,Jonny Brodzinski,C,NYR,31,0,0,0,0
24,8482201,Gage Goncalves,C,TBL,23,0,0,0,0
24,8478211,Dryden Hunt,L,CGY,29,0,0,0,0
24,8471699,Andrew Cogliano,C,COL,37,0,0,0,0
24,8479421,Jacob Moverare,D,LAK,26,0,0,0,0
24,8478881,Brett Seney,L,CHI,28,0,0,0,0
24,8477464,Nic Petan,C,MIN,29,0,0,0,0
24,8475958,Michael Sgarbossa,C,WSH,32,0,0,0,0
24,8481147,Reese Johnson,C,CHI,26,0,0,0,0
24,8479336,Carl Grundstrom,R,LAK,27,0,0,0,0
24,8480853,Liam Foudy,C,NSH,24,0,0,0,0
24,8479522,Hardy Haman Aktell,D,WSH,26,0,0,0,0
24,8481462,Mason Morelli,L,VGK,28,0,0,0,0
24,8482102,Vasily Ponomarev,C,CAR,22,0,0,0,0
24,8480844,Grigori Denisenko,L,VGK,24,0,0,0,0
24,8479944,Zach Aston-Reese,C,DET,30,0,0,0,0
24,8482784,Zach Dean,C,STL,21,0,0,0,0
24,8479419,Brett Murray,L,BUF,26,0,0,0,0
24,8479520,Brandon Duhaime,R,COL,27,0,0,0,0
24,8477573,Nathan Walker,L,STL,30,0,0,0,0
24,8478078,Rourke Chartier,C,OTT,28,0,0,0,0
24,8475795,Dylan McIlrath,D,WSH,32,0,0,0,0
24,8482496,Nils Aman,C,VAN,24,0,0,0,0
24,8480289,Morgan Barron,C,WPG,26,0,0,0,0
24,8481751,Lukas Rousek,R,BUF,25,0,0,0,0
24,8480011,Klim Kostin,C,SJS,25,0,0,0,0
24,8481556,John Beecher,C,BOS,23,0,0,0,0
24,8475278,Byron Froese,C,VGK,33,0,0,0,0
24,8475225,Craig Smith,C,DAL,35,0,0,0,0
24,8484326,Patrik Koch,D,ARI,28,0,0,0,0
24,8477930,Pierre-Edouard Bellemare,L,SEA,39,0,0,0,0
24,8478409,Anthony Richard,C,BOS,28,0,0,0,0
24,8481024,Linus Karlsson,C,VAN,25,0,0,0,0
24,8479986,Kole Lind,R,SEA,26,0,0,0,0
24,8479414,Nathan Bastian,R,NJD,27,0,0,0,0
24,8479362,Riley Tufte,L,COL,26,0,0,0,0
24,8481058,Jesse Ylönen,R,MTL,25,0,0,0,0
24,8482476,Emil Heineman,L,MTL,23,0,0,0,0
24,8482861,Vincent Iorio,D,WSH,22,0,0,0,0
24,8483432,Luca Del Bel Belluz,C,CBJ,31,0,0,0,0
24,8482744,James Malatesta,L,CBJ,21,0,0,0,0
24,8477887,Patrick Brown,C,BOS,32,0,0,0,0
24,8478585,Derek Ryan,C,EDM,38,0,0,0,0
24,8481441,Joe Snively,C,WSH,28,0,0,0,0
24,8481592,Jakob Pelletier,L,CGY,23,0,0,0,0
24,8482634,Alex Steeves,C,TOR,25,0,0,0,0
24,8477126,Jayson Megna,C,BOS,34,0,0,0,0
24,8475752,Tyler Pitlick,C,NYR,33,0,0,0,0
24,8480008,Adam Ruzicka,C,ARI,25,0,0,0,0
24,8481065,Angus Crookshank,L,OTT,25,0,0,0,0
24,8479547,Matthew Phillips,R,WSH,26,0,0,0,0
24,8480226,Marián Studenic,R,SEA,26,0,0,0,0
24,8481237,Kyle MacLean,C,NYI,25,0,0,0,0
24,8475413,Justin Dowling,C,NJD,34,0,0,0,0
24,8481641,Joel Kiviranta,L,COL,28,0,0,0,0
24,8478104,Sammy Blais,L,STL,28,0,0,0,0
24,8477454,Adam Erne,L,EDM,29,0,0,0,0
24,8481518,Nolan Foote,L,NJD,24,0,0,0,0
24,8480245,Olle Lycksell,R,PHI,25,0,0,0,0
24,8483570,Ben Meyers,C,ANA,26,0,0,0,0
24,8480776,Sheldon Rempal,R,VGK,29,0,0,0,0
24,8483920,Pierrick Dube,R,WSH,23,0,0,0,0
24,8480267,Sammy Walker,C,MIN,25,0,0,0,0
24,8482747,Brennan Othmann,L,NYR,21,0,0,0,0
24,8479991,Jake Leschyshyn,C,NYR,25,0,0,0,0
24,8478400,Colin White,C,MTL,27,0,0,0,0
24,8479328,Julien Gauthier,R,NYI,27,0,0,0,0
24,8484325,Waltteri Merela,C,TBL,26,0,0,0,0
24,8479066,Ryan Lomberg,L,FLA,30,0,0,0,0
24,8477070,Liam O'Brien,C,ARI,30,0,0,0,0
24,8478146,Matthew Highmore,C,OTT,28,0,0,0,0
24,8478028,Fredrik Olofsson,L,COL,28,0,0,0,0
24,8480880,Jakub Lauko,C,BOS,24,0,0,0,0
24,8479968,Vinni Lettieri,C,MIN,29,0,0,0,0
24,8474709,Matt Martin,L,NYI,35,0,0,0,0
24,8480845,Rasmus Kupari,C,WPG,24,0,0,0,0
24,8481550,Adam Beckman,L,MIN,23,0,0,0,0
24,8481422,Jacob Lucchini,C,MIN,29,0,0,0,0
24,8477401,John Hayden,C,SEA,29,0,0,0,0
24,8478904,Steven Lorentz,C,FLA,28,0,0,0,0
24,8482088,Justin Sourdif,R,FLA,22,0,0,0,0
24,8482751,Ryan Winterton,C,SEA,21,0,0,0,0
24,8482241,Radim Zohorna,L,PIT,28,0,0,0,0
24,8481690,Tyler Angle,C,CBJ,24,0,0,0,0
24,8476952,Dominic Toninato,C,WPG,30,0,0,0,0
24,8476919,Chris Tierney,C,NJD,30,0,0,0,0
24,8480032,Shane Bowers,C,NJD,25,0,0,0,0
24,8484314,Jiri Smejkal,L,OTT,28,0,0,0,0
24,8481239,Samuel Fagemo,L,LAK,24,0,0,0,0
24,8481532,Alex Turcotte,C,LAK,23,0,0,0,0
24,8481019,David Gustafsson,C,WPG,24,0,0,0,0
24,8478477,Mitchell Stephens,C,MTL,27,0,0,0,0
24,8479546,Oskar Steen,C,BOS,26,0,0,0,0
24,8480292,Carson Meyer,R,CBJ,27,0,0,0,0
24,8478446,Glenn Gawdin,C,ANA,27,0,0,0,0
24,8483531,Brian Halonen,L,NJD,25,0,0,0,0
24,8477149,Scott Sabourin,R,SJS,32,0,0,0,0
24,8479972,Mason Shaw,C,MIN,26,0,0,0,0
24,8480890,Jan Jenik,R,ARI,24,0,0,0,0
24,8478051,Max Willman,C,NJD,29,0,0,0,0
24,8480851,Akil Thomas,C,LAK,24,0,0,0,0
24,8482765,Isak Rosen,R,BUF,21,0,0,0,0
24,8478421,A.J. Greer,L,CGY,28,0,0,0,0
24,8478512,Austin Czarnik,C,DET,32,0,0,0,0
24,8479536,Axel Jonsson-Fjallby,L,WPG,26,0,0,0,0
24,8477320,Anton Blidh,L,NYR,29,0,0,0,0
24,8481543,Nikita Alexandrov,C,STL,24,0,0,0,0
24,8475235,Nicolas Deslauriers,L,PHI,33,0,0,0,0
24,8481070,Hugh McGing,L,STL,26,0,0,0,0
24,8480836,Jonathan Gruden,C,PIT,24,0,0,0,0
24,8481591,Sam Poulin,R,PIT,23,0,0,0,0
24,8477962,Brendan Lemieux,L,CAR,28,0,0,0,0
24,8483401,Marc Johnstone,R,PIT,28,0,0,0,0
24,8482250,Callahan Burke,C,CAR,27,0,0,0,0
24,8481726,Adam Edstrom,C,NYR,24,0,0,0,0
24,8471817,Ryan Reaves,R,TOR,37,0,0,0,0
24,8479587,Rhett Gardner,C,PHI,28,0,0,0,0
24,8475766,Austin Watson,L,TBL,32,0,0,0,0
24,8479367,William Lockwood,R,FLA,26,0,0,0,0
24,8478424,Jansen Harkins,C,PIT,27,0,0,0,0
24,8476913,Devin Shore,C,SEA,30,0,0,0,0
24,8482652,Walker Duehr,R,CGY,27,0,0,0,0
24,8477527,Ross Johnston,L,ANA,30,0,0,0,0
24,8481077,John Leonard,L,ARI,26,0,0,0,0
24,8483549,Lucas Condotta,L,MTL,27,0,0,0,0
24,8480468,James Hamblin,L,EDM,25,0,0,0,0
24,8476907,Mackenzie MacEachern,L,STL,30,0,0,0,0
24,8479543,Michael Pezzetta,L,MTL,26,0,0,0,0
24,8480355,Mark Kastelic,C,OTT,25,0,0,0,0
24,8482162,Roby Jarventie,L,OTT,22,0,0,0,0
24,8479772,Zack MacEwen,R,OTT,28,0,0,0,0
24,8483597,Milos Kelemen,L,ARI,25,0,0,0,0
24,8479379,Givani Smith,R,SJS,26,0,0,0,0
24,8481655,Cole Schwindt,R,CGY,23,0,0,0,0
24,8479981,Jonah Gadjovich,L,FLA,26,0,0,0,0
24,8482147,Jean-Luc Foudy,C,COL,22,0,0,0,0
24,8484255,Jason Polin,R,COL,25,0,0,0,0
24,8477993,Justin Kirkland,C,ARI,28,0,0,0,0
24,8479249,Andrew Poturalski,C,SEA,30,0,0,0,0
24,8482197,Adam Raska,R,MIN,23,0,0,0,0
24,8475780,Chris Wagner,R,COL,33,0,0,0,0
24,8479533,Joona Koppanen,L,PIT,26,0,0,0,0
24,8481534,Raphael Lavoie,C,EDM,24,0,0,0,0
24,8484321,Nikolas Matinpalo,D,OTT,26,0,0,0,0
24,8481043,Cole Koepke,L,TBL,26,0,0,0,0
24,8476323,Max McCormick,L,SEA,32,0,0,0,0
24,8483609,Adam Klapka,R,CGY,24,0,0,0,0
24,8483512,Matt Savoie,C,BUF,20,0,0,0,0
24,8484259,Ondrej Pavel,C,COL,31,0,0,0,0
24,8478147,Bokondji Imama,L,OTT,28,0,0,0,0
24,8482460,Matt Rempe,C,NYR,22,0,0,0,0
24,8477073,Kurtis MacDermid,L,NJD,30,0,0,0,0
24,8480274,Philip Kemp,D,EDM,25,0,0,0,0
24,8478956,Samuel Laberge,L,NJD,27,0,0,0,0
24,8483045,Cameron Butler,R,CBJ,31,0,0,0,0
25,8478402,Connor McDavid,C,EDM,27,82,36,94,130
25,8479343,Clayton Keller,R,ARI,26,82,54,52,106
25,8476453,Nikita Kucherov,R,TBL,31,82,33,73,106
25,8477956,David Pastrnak,R,BOS,28,82,40,63,103
25,8478420,Mikko Rantanen,R,COL,28,82,48,53,101
25,8477404,Jake Guentzel,C,CAR,30,82,47,53,100
25,8477934,Leon Draisaitl,C,EDM,29,82,34,66,100
25,8479318,Auston Matthews,C,TOR,27,82,51,48,99
25,8481559,Jack Hughes,C,NJD,23,82,39,58,97
25,8479314,Matthew Tkachuk,L,FLA,27,82,40,56,96
25,8471675,Sidney Crosby,C,PIT,37,82,40,51,91
25,8477492,Nathan MacKinnon,C,COL,29,82,34,57,91
25,8482116,Tim Stützle,C,OTT,22,82,37,52,89
25,8476468,J.T. Miller,C,VAN,31,82,25,64,89
25,8475786,Zach Hyman,L,EDM,32,82,55,33,88
25,8480801,Brady Tkachuk,L,OTT,25,82,45,41,86
25,8482078,Lucas Raymond,L,DET,22,82,32,54,86
25,8480027,Jason Robertson,L,DAL,25,82,29,55,84
25,8478864,Kirill Kaprizov,L,MIN,27,82,37,45,82
25,8478010,Brayden Point,C,TBL,28,82,36,45,81
25,8476887,Filip Forsberg,L,NSH,30,82,34,47,81
25,8477939,William Nylander,R,TOR,28,82,28,53,81
25,8480865,Noah Dobson,D,NYI,24,82,17,64,81
25,8477493,Aleksander Barkov,C,FLA,29,82,27,53,80
25,8480012,Elias Pettersson,C,VAN,26,82,31,47,78
25,8477942,Kevin Fiala,L,LAK,28,82,24,54,78
25,8477501,Valeri Nichushkin,R,COL,29,82,40,37,77
25,8479385,Jordan Kyrou,C,STL,26,82,34,43,77
25,8479407,Jesper Bratt,L,NJD,26,82,23,53,76
25,8478439,Travis Konecny,R,PHI,27,82,36,39,75
25,8474600,Roman Josi,D,NSH,34,82,22,53,75
25,8478550,Artemi Panarin,L,NYR,33,82,32,42,74
25,8474564,Steven Stamkos,C,TBL,34,82,29,45,74
25,8480023,Robert Thomas,C,STL,25,82,21,53,74
25,8478445,Mathew Barzal,C,NYI,27,82,20,53,73
25,8479420,Tage Thompson,C,BUF,27,82,35,36,71
25,8475810,Bryan Rust,R,PIT,32,82,35,36,71
25,8477496,Elias Lindholm,C,VAN,30,82,30,41,71
25,8471215,Evgeni Malkin,C,PIT,38,82,27,44,71
25,8478427,Sebastian Aho,C,CAR,27,82,24,47,71
25,8480069,Cale Makar,D,COL,26,82,18,53,71
25,8477955,Jared McCann,L,SEA,28,82,29,41,70
25,8477940,Nikolaj Ehlers,L,WPG,28,82,25,43,68
25,8480800,Quinn Hughes,D,VAN,25,82,10,58,68
25,8476853,Morgan Rielly,D,TOR,30,82,14,53,67
25,8475166,John Tavares,C,TOR,34,82,33,33,66
25,8476459,Mika Zibanejad,C,NYR,31,82,28,38,66
25,8479323,Adam Fox,D,NYR,26,82,11,55,66
25,8477960,Adrian Kempe,R,LAK,28,82,36,29,65
25,8481557,Matt Boldy,L,MIN,23,82,31,34,65
25,8479337,Alex DeBrincat,R,DET,27,82,29,36,65
25,8475167,Victor Hedman,D,TBL,34,82,14,51,65
25,8480015,Owen Tippett,R,PHI,25,82,37,27,64
25,8478403,Jack Eichel,C,VGK,28,82,30,34,64
25,8471214,Alex Ovechkin,L,WSH,39,82,26,38,64
25,8478440,Dylan Strome,C,WSH,27,82,19,45,64
25,8480036,Miro Heiskanen,D,DAL,25,82,11,53,64
25,8476483,Rickard Rakell,R,PIT,31,82,28,35,63
25,8477949,Alex Tuch,R,BUF,28,82,20,43,63
25,8477933,Sam Reinhart,C,FLA,29,82,33,29,62
25,8478493,Joel Eriksson Ek,C,MIN,27,82,28,34,62
25,8479542,Brandon Hagel,L,TBL,26,82,24,38,62
25,8481528,Dylan Cozens,C,BUF,23,82,22,40,62
25,8474578,Erik Karlsson,D,PIT,34,82,13,49,62
25,8480031,Maxime Comtois,L,CAR,25,82,13,49,62
25,8480839,Rasmus Dahlin,D,BUF,24,82,10,52,62
25,8479425,Filip Hronek,D,VAN,27,82,9,53,62
25,8475726,Tyler Toffoli,C,WPG,32,82,36,25,61
25,8475172,Nazem Kadri,C,CGY,34,82,28,33,61
25,8478444,Brock Boeser,R,VAN,27,82,28,33,61
25,8480208,Drake Batherson,R,OTT,26,82,27,34,61
25,8480188,Fabian Zetterlund,L,SJS,25,82,27,34,61
25,8480018,Nick Suzuki,C,MTL,25,82,24,37,61
25,8471685,Anze Kopitar,C,LAK,37,82,21,40,61
25,8473512,Claude Giroux,R,OTT,36,82,21,40,61
25,8477946,Dylan Larkin,C,DET,28,82,20,41,61
25,8474141,Patrick Kane,R,DET,36,82,20,41,61
25,8477504,Josh Morrissey,D,WPG,29,82,13,48,61
25,8475184,Chris Kreider,L,NYR,33,82,38,22,60
25,8481540,Cole Caufield,R,MTL,23,82,38,22,60
25,8477500,Bo Horvat,C,NYI,29,82,31,29,60
25,8476462,Dougie Hamilton,D,NJD,31,82,23,37,60
25,8477951,Nick Schmaltz,C,ARI,28,82,28,31,59
25,8480830,Andrei Svechnikov,R,CAR,24,82,27,32,59
25,8478042,Viktor Arvidsson,R,LAK,31,82,22,37,59
25,8482124,Quinton Byfield,R,LAK,22,82,20,39,59
25,8481523,Kirby Dach,C,MTL,23,82,15,44,59
25,8476539,Jonathan Marchessault,R,VGK,34,82,29,29,58
25,8475784,Jeff Skinner,C,BUF,32,82,22,36,58
25,8477402,Pavel Buchnevich,L,STL,29,82,20,38,58
25,8478047,Michael Bunting,L,PIT,29,82,18,40,58
25,8475798,Mikael Granlund,C,SJS,32,82,14,44,58
25,8480434,Sean Durzi,D,ARI,26,82,6,52,58
25,8482699,Dylan Guenther,R,ARI,21,82,34,23,57
25,8477409,Carter Verhaeghe,C,FLA,29,82,27,30,57
25,8478398,Kyle Connor,L,WPG,28,82,25,32,57
25,8476460,Mark Scheifele,C,WPG,31,82,23,34,57
25,8475158,Ryan O'Reilly,C,NSH,33,82,23,34,57
25,8482740,Wyatt Johnston,C,DAL,21,82,23,34,57
25,8474679,Gustav Nyquist,C,NSH,35,82,21,36,57
25,8473419,Brad Marchand,L,BOS,36,82,19,38,57
25,8475692,Mats Zuccarello,R,MIN,37,82,13,44,57
25,8476346,Johnny Gaudreau,L,CBJ,31,82,11,46,57
25,8475913,Mark Stone,R,VGK,32,82,27,29,56
25,8475170,Brayden Schenn,C,STL,33,82,19,37,56
25,8482667,William Eklund,L,SJS,22,82,19,37,56
25,8482684,Luke Hughes,D,NJD,21,82,17,39,56
25,8475765,Vladimir Tarasenko,R,FLA,33,82,13,43,56
25,8482097,Jack Quinn,R,BUF,23,82,27,28,55
25,8478449,Roope Hintz,C,DAL,28,82,24,31,55
25,8479339,Patrik Laine,L,CBJ,26,82,20,35,55
25,8481596,Shane Pinto,C,OTT,24,82,20,35,55
25,8476454,Ryan Nugent-Hopkins,C,EDM,31,82,19,36,55
25,8478460,Zach Werenski,D,CBJ,27,82,10,45,55
25,8478397,Rasmus Andersson,D,CGY,28,82,10,45,55
25,8475168,Matt Duchene,C,DAL,33,82,26,28,54
25,8478414,Timo Meier,R,NJD,28,82,25,29,54
25,8470794,Joe Pavelski,C,DAL,40,82,23,31,54
25,8480039,Martin Necas,C,CAR,25,82,22,32,54
25,8473994,Jamie Benn,L,DAL,35,82,22,32,54
25,8478873,Troy Terry,R,ANA,27,82,17,37,54
25,8476329,Travis Boyd,C,ARI,31,82,9,45,54
25,8477416,Oliver Bjorkstrand,R,SEA,29,82,21,32,53
25,8478975,Mason Marchment,L,DAL,29,82,21,32,53
25,8476881,Tomas Hertl,C,VGK,31,82,20,33,53
25,8481699,Aku Raty,R,ARI,23,82,1,52,53
25,8482093,Seth Jarvis,C,CAR,22,82,30,22,52
25,8483524,Shane Wright,C,SEA,20,82,30,22,52
25,8478519,Anthony Cirelli,C,TBL,27,82,23,29,52
25,8476448,William Karlsson,C,VGK,31,82,22,30,52
25,8480002,Nico Hischier,C,NJD,25,82,21,31,52
25,8479325,Charlie McAvoy,D,BOS,27,82,12,40,52
25,8477476,Artturi Lehkonen,L,COL,29,82,26,25,51
25,8480803,Evan Bouchard,D,EDM,25,82,11,40,51
25,8475314,Anders Lee,L,NYI,34,82,28,22,50
25,8477935,Sam Bennett,C,FLA,28,82,24,26,50
25,8476389,Vincent Trocheck,C,NYR,31,82,22,28,50
25,8478233,Andrew Mangiapane,L,CGY,28,82,20,30,50
25,8474586,Jordan Eberle,R,SEA,34,82,19,31,50
25,8478401,Pavel Zacha,C,BOS,27,82,18,32,50
25,8476456,Jonathan Huberdeau,C,CGY,31,82,11,39,50
25,8475753,Justin Faulk,D,STL,32,82,7,43,50
25,8476880,Tom Wilson,R,WSH,30,82,26,23,49
25,8475754,Brock Nelson,C,NYI,33,82,23,26,49
25,8482665,Matty Beniers,C,SEA,22,82,19,30,49
25,8476906,Shayne Gostisbehere,D,DET,31,82,19,30,49
25,8477495,Seth Jones,D,CHI,30,82,14,35,49
25,8479410,Mikhail Sergachev,D,TBL,26,82,14,35,49
25,8477447,Shea Theodore,D,VGK,29,82,12,37,49
25,8471724,Kris Letang,D,PIT,37,82,12,37,49
25,8481711,Matias Maccelli,L,ARI,24,82,7,42,49
25,8481068,Yegor Sharangovich,C,CGY,26,82,26,22,48
25,8474102,David Perron,L,DET,36,82,22,26,48
25,8475744,Evgeny Kuznetsov,C,CAR,32,82,16,32,48
25,8479999,Casey Mittelstadt,C,COL,26,82,11,37,48
25,8476399,Blake Coleman,C,CGY,33,82,28,19,47
25,8477451,Ryan Hartman,R,MIN,30,82,22,25,47
25,8482745,Mason McTavish,C,ANA,21,82,20,27,47
25,8477479,Tyler Bertuzzi,L,TOR,29,82,18,29,47
25,8476882,Teuvo Teravainen,L,CAR,30,82,12,35,47
25,8477986,Brandon Montour,D,FLA,30,82,11,36,47
25,8478396,Noah Hanifin,D,VGK,27,82,9,38,47
25,8478038,Devon Toews,D,COL,30,82,7,40,47
25,8482101,Danil Gushchin,L,SJS,22,82,23,23,46
25,8478438,Tommy Novak,C,NSH,27,82,19,27,46
25,8482159,Tyson Foerster,R,PHI,22,82,17,29,46
25,8482113,Anton Lundell,C,FLA,23,82,17,29,46
25,8475791,Taylor Hall,L,CHI,33,82,17,29,46
25,8477494,Jonathan Drouin,L,COL,29,82,16,30,46
25,8476905,Chandler Stephenson,C,VGK,30,82,15,31,46
25,8480064,Josh Norris,C,OTT,25,82,27,18,45
25,8477429,Andrew Copp,C,DET,30,82,16,29,45
25,8477503,Max Domi,C,TOR,29,82,13,32,45
25,8476869,Brady Skjei,D,CAR,30,82,12,33,45
25,8482105,Jake Sanderson,D,OTT,22,82,12,33,45
25,8476875,Mike Matheson,D,MTL,30,82,8,37,45
25,8475151,Kyle Palmieri,C,NYI,33,82,26,18,44
25,8479675,Trevor Moore,L,LAK,29,82,25,19,44
25,8483808,Andrei Kuzmenko,L,CGY,28,82,23,21,44
25,8474641,Adam Henrique,C,EDM,34,82,22,22,44
25,8480849,Barrett Hayton,C,ARI,24,82,20,24,44
25,8479345,Jakob Chychrun,D,OTT,26,82,17,27,44
25,8482222,Alexander Barabanov,L,SJS,30,82,17,27,44
25,8476438,Brandon Saad,L,STL,32,82,24,19,43
25,8482110,Dawson Mercer,C,NJD,23,82,23,20,43
25,8478474,Lawson Crouse,L,ARI,27,82,22,21,43
25,8480893,Kirill Marchenko,R,CBJ,24,82,22,21,43
25,8476479,Phillip Danault,C,LAK,31,82,14,29,43
25,8480797,Joel Farabee,L,PHI,24,82,14,29,43
25,8483397,Marc McLaughlin,C,BOS,25,82,38,4,42
25,8475722,Jason Zucker,L,NSH,32,82,26,16,42
25,8475799,Nino Niederreiter,R,WPG,32,82,23,19,42
25,8482146,Luke Evangelista,R,NSH,22,82,18,24,42
25,8478466,Daniel Sprong,R,DET,27,82,17,25,42
25,8482133,Thomas Bordeleau,C,SJS,22,82,11,31,42
25,8477948,Travis Sanheim,D,PHI,28,82,8,34,42
25,8481618,Alex Newhook,C,MTL,23,82,18,23,41
25,8477511,Anthony Mantha,R,VGK,30,82,16,25,41
25,8474053,Logan Couture,C,SJS,35,82,14,27,41
25,8480871,Adam Boqvist,D,CBJ,24,82,12,29,41
25,8477456,J.T. Compher,L,DET,29,82,10,31,41
25,8471698,T.J. Oshie,R,WSH,38,82,22,18,40
25,8479591,Michael Eyssimont,C,TBL,28,82,22,18,40
25,8484166,Adam Fantilli,C,CBJ,20,82,20,20,40
25,8479365,Trent Frederic,C,BOS,26,82,19,21,40
25,8481535,Nils Hoglander,L,VAN,24,82,18,22,40
25,8478057,Dakota Joshua,C,VAN,28,82,17,23,40
25,8478542,Evan Rodrigues,C,FLA,31,82,16,24,40
25,8477426,Nicholas Paul,L,TBL,29,82,15,25,40
25,8478469,Thomas Chabot,D,OTT,27,82,12,28,40
25,8477497,Sean Monahan,C,WPG,30,82,12,28,40
25,8481542,Moritz Seider,D,DET,23,82,10,30,40
25,8481546,Cam York,D,PHI,23,82,10,30,40
25,8480078,Filip Chytil,C,NYR,25,82,9,31,40
25,8476958,Jaccob Slavin,D,CAR,30,82,7,33,40
25,8481016,Ruslan Iskhakov,C,NYI,24,82,5,35,40
25,8475764,Cam Fowler,D,ANA,33,82,5,35,40
25,8483457,Lane Hutson,D,MTL,20,82,4,36,40
25,8482109,Alexis Lafrenière,L,NYR,23,82,21,18,39
25,8475714,Calle Jarnkrok,C,TOR,33,82,19,20,39
25,8482475,Yegor Chinakhov,R,CBJ,23,82,18,21,39
25,8482055,Drew O'Connor,L,PIT,26,82,17,22,39
25,8475794,Tyler Seguin,C,DAL,32,82,16,23,39
25,8474157,Max Pacioretty,L,WSH,36,82,16,23,39
25,8476419,Jean-Gabriel Pageau,C,NYI,32,82,16,23,39
25,8476897,Oskar Sundqvist,C,STL,30,82,13,26,39
25,8481581,Thomas Harley,D,DAL,23,82,11,28,39
25,8477407,Anthony Duclair,L,TBL,29,82,24,14,38
25,8481624,Ilya Mikheyev,R,VAN,30,82,24,14,38
25,8480459,Pius Suter,C,VAN,28,82,22,16,38
25,8482089,Jake Neighbours,L,STL,22,82,17,21,38
25,8481533,Trevor Zegras,C,ANA,23,82,12,26,38
25,8476292,Ondrej Palat,L,NJD,33,82,11,27,38
25,8470613,Brent Burns,D,CAR,39,82,11,27,38
25,8477444,Andre Burakovsky,L,SEA,29,82,9,29,38
25,8478407,Vince Dunn,D,SEA,28,82,8,30,38
25,8476923,Damon Severson,D,CBJ,30,82,4,34,38
25,8475760,Nick Bjugstad,C,ARI,32,82,24,13,37
25,8476432,Boone Jenner,C,CBJ,31,82,22,15,37
25,8478046,Danton Heinen,L,BOS,29,82,14,23,37
25,8478133,Jake Evans,C,MTL,28,82,14,23,37
25,8476925,Colton Sissons,C,NSH,31,82,14,23,37
25,8480220,Noah Cates,L,PHI,25,82,13,24,37
25,8474590,John Carlson,D,WSH,34,82,12,25,37
25,8477021,Alex Kerfoot,C,ARI,30,82,12,25,37
25,8475793,Ryan Johansen,C,PHI,32,82,12,25,37
25,8475745,Charlie Coyle,C,BOS,32,82,10,27,37
25,8474037,James van Riemsdyk,L,BOS,35,82,10,27,37
25,8475197,Tyson Barrie,D,NSH,33,82,8,29,37
25,8475848,Brendan Gallagher,R,MTL,32,82,23,13,36
25,8475169,Evander Kane,L,EDM,33,82,20,16,36
25,8478366,Frank Vatrano,R,ANA,30,82,20,16,36
25,8482737,Zack Bolduc,C,STL,21,82,20,16,36
25,8478462,Nicolas Roy,C,VGK,27,82,18,18,36
25,8480068,Ryan Poehling,C,PHI,25,82,17,19,36
25,8477346,MacKenzie Weegar,D,CGY,30,82,9,27,36
25,8482175,JJ Peterka,R,BUF,22,82,20,15,35
25,8484144,Connor Bedard,C,CHI,19,82,18,17,35
25,8480821,Filip Zadina,R,SJS,25,82,18,17,35
25,8476921,Jordan Martinook,L,CAR,32,82,15,20,35
25,8474149,Evgenii Dadonov,R,DAL,35,82,14,21,35
25,8476872,Scott Laughton,C,PHI,30,82,14,21,35
25,8478891,Mason Appleton,C,WPG,28,82,14,21,35
25,8478458,Jack Roslovic,C,NYR,27,82,9,26,35
25,8473507,Jeff Petry,D,DET,37,82,6,29,35
25,8482245,Artem Zub,D,OTT,29,82,5,30,35
25,8477998,Warren Foegele,L,EDM,28,82,20,14,34
25,8475191,Reilly Smith,R,PIT,33,82,19,15,34
25,8478498,Jake DeBrusk,L,BOS,28,82,18,16,34
25,8481704,Juuso Parssinen,C,NSH,23,82,17,17,34
25,8480028,Morgan Frost,C,PHI,25,82,16,18,34
25,8474150,Mikael Backlund,C,CGY,35,82,15,19,34
25,8479987,Morgan Geekie,C,BOS,26,82,15,19,34
25,8478463,Anthony Beauvillier,L,NSH,27,82,15,19,34
25,8480014,Gabriel Vilardi,C,WPG,25,82,14,20,34
25,8475768,Jaden Schwartz,C,SEA,32,82,13,21,34
25,8481186,Logan O'Connor,R,COL,28,82,13,21,34
25,8478856,Conor Garland,R,VAN,28,82,12,22,34
25,8481522,Peyton Krebs,C,BUF,23,82,11,23,34
25,8475287,Erik Haula,L,NJD,33,82,10,24,34
25,8477964,Ivan Barbashev,C,VGK,29,82,8,26,34
25,8483471,Brad Lambert,C,WPG,31,82,8,26,34
25,8478840,Will Borgen,D,SEA,28,82,6,28,34
25,8476392,Adam Lowry,C,WPG,31,82,19,14,33
25,8481560,Arthur Kaliyev,R,LAK,23,82,19,14,33
25,8479525,Ross Colton,C,COL,28,82,14,19,33
25,8479351,Sam Steel,C,DAL,26,82,14,19,33
25,8476458,Ryan Strome,C,ANA,31,82,11,22,33
25,8474563,Drew Doughty,D,LAK,35,82,9,24,33
25,8481703,Valtteri Puustinen,R,PIT,25,82,9,24,33
25,8475906,John Klingberg,D,TOR,32,82,4,29,33
25,8474716,Jared Spurgeon,D,MIN,35,82,4,29,33
25,8480873,Rasmus Sandin,D,WSH,24,82,3,30,33
25,8479941,Justin Danforth,R,CBJ,31,82,23,9,32
25,8479996,Cody Glass,C,NSH,25,82,16,16,32
25,8480185,Eetu Luostarinen,C,FLA,26,82,12,20,32
25,8478472,Mathieu Joseph,R,OTT,27,82,11,21,32
25,8478055,Gustav Forsling,D,FLA,28,82,10,22,32
25,8475763,Kevin Hayes,R,STL,32,82,9,23,32
25,8480798,Philipp Kurashev,C,CHI,25,82,8,24,32
25,8477932,Aaron Ekblad,D,FLA,28,82,8,24,32
25,8474565,Alex Pietrangelo,D,VGK,34,82,7,25,32
25,8481604,Pavel Dorofeyev,L,VGK,24,82,19,12,31
25,8479359,Beck Malenstyn,L,WSH,26,82,19,12,31
25,8479293,Brandon Tanev,L,SEA,33,82,18,13,31
25,8477353,Tyler Motte,C,TBL,29,82,17,14,31
25,8474884,Mike Hoffman,C,SJS,35,82,17,14,31
25,8483491,Ivan Miroshnichenko,L,WSH,20,82,17,14,31
25,8480074,Alexandre Texier,C,CBJ,25,82,14,17,31
25,8479400,Pierre-Luc Dubois,L,LAK,26,82,13,18,31
25,8474870,Tyler Johnson,C,CHI,34,82,13,18,31
25,8477953,Kasperi Kapanen,R,STL,28,82,12,19,31
25,8480009,Eeli Tolvanen,R,SEA,25,82,11,20,31
25,8476461,Sean Couturier,C,PHI,32,82,11,20,31
25,8475218,Mattias Ekholm,D,EDM,34,82,10,21,31
25,8481013,Jonatan Berggren,R,DET,24,82,9,22,31
25,8476792,Torey Krug,D,STL,33,82,5,26,31
25,8482733,Logan Mailloux,D,MTL,31,82,3,28,31
25,8474151,Ryan McDonagh,D,NSH,35,82,3,28,31
25,8479423,Alex Nylander,L,CBJ,26,82,17,13,30
25,8477330,Dominik Kubalik,L,OTT,29,82,16,14,30
25,8476873,Mark Jankowski,C,NSH,30,82,15,15,30
25,8473533,Jordan Staal,C,CAR,36,82,14,16,30
25,8482259,Bobby McMann,C,TOR,28,82,13,17,30
25,8477425,Miles Wood,L,COL,29,82,12,18,30
25,8471218,Blake Wheeler,R,NYR,38,82,11,19,30
25,8482092,Ridly Greig,C,OTT,22,82,9,21,30
25,8478136,Jake Middleton,D,MIN,28,82,9,21,30
25,8478500,Ivan Provorov,D,CBJ,27,82,8,22,30
25,8479398,Samuel Girard,D,COL,26,82,6,24,30
25,8475200,Dmitry Orlov,D,CAR,33,82,5,25,30
25,8480043,Timothy Liljegren,D,TOR,25,82,2,28,30
25,8478013,Jake Walman,D,DET,28,82,18,11,29
25,8482125,Alexander Holtz,R,NJD,22,82,17,12,29
25,8481554,Kaapo Kakko,R,NYR,23,82,16,13,29
25,8480813,Joe Veleno,C,DET,24,82,14,15,29
25,8476826,Yanni Gourde,C,SEA,33,82,12,17,29
25,8478430,Oliver Kylington,D,CGY,27,82,12,17,29
25,8482720,Matthew Knies,L,TOR,22,82,10,19,29
25,8478413,Jordan Greenway,L,BUF,27,82,10,19,29
25,8482655,J.J. Moser,D,ARI,24,82,9,20,29
25,8478178,Darren Raddysh,D,TBL,28,82,9,20,29
25,8481656,Aliaksei Protas,C,WSH,23,82,8,21,29
25,8476917,Adam Pelech,D,NYI,30,82,8,21,29
25,8476854,Hampus Lindholm,D,BOS,30,82,4,25,29
25,8482122,Brock Faber,D,MIN,22,82,2,27,29
25,8477944,Jakub Vrana,L,STL,28,82,21,7,28
25,8483431,Logan Cooley,C,ARI,20,82,19,9,28
25,8478043,Sam Lafferty,C,VAN,29,82,16,12,28
25,8482702,Logan Stankoven,C,DAL,21,82,13,15,28
25,8477919,Frederick Gaudreau,C,MIN,31,82,12,16,28
25,8476892,Colton Parayko,D,STL,31,82,11,17,28
25,8475149,Marcus Johansson,L,MIN,34,82,11,17,28
25,8481481,Blake Lizotte,C,LAK,27,82,10,18,28
25,8482671,Owen Power,D,BUF,22,82,8,20,28
25,8481553,Bobby Brink,R,PHI,23,82,8,20,28
25,8477498,Darnell Nurse,D,EDM,29,82,8,20,28
25,8477488,Brett Pesce,D,CAR,30,82,6,22,28
25,8480145,Neal Pionk,D,WPG,29,82,5,23,28
25,8478109,Victor Olofsson,L,BUF,29,82,16,11,27
25,8481580,Connor McMichael,C,WSH,23,82,14,13,27
25,8476960,Andreas Athanasiou,C,CHI,30,82,14,13,27
25,8473504,Cal Clutterbuck,R,NYI,37,82,14,13,27
25,8470610,Zach Parise,L,COL,40,82,13,14,27
25,8480113,Alex Iafallo,L,WPG,31,82,10,17,27
25,8484153,Leo Carlsson,C,ANA,20,82,10,17,27
25,8475164,Jakob Silfverberg,R,ANA,34,82,10,17,27
25,8482079,Marco Rossi,C,MIN,23,82,9,18,27
25,8475231,Casey Cizikas,C,NYI,33,82,9,18,27
25,8482705,Cole Sillinger,C,CBJ,21,82,8,19,27
25,8477947,Sonny Milano,L,WSH,28,82,8,19,27
25,8483445,Cutter Gauthier,L,ANA,20,82,8,19,27
25,8476885,Jacob Trouba,D,NYR,30,82,8,19,27
25,8478851,Alexandre Carrier,D,NSH,28,82,5,22,27
25,8480073,Erik Brannstrom,D,OTT,25,82,4,23,27
25,8477969,Marcus Pettersson,D,PIT,28,82,4,23,27
25,8477952,Robby Fabbri,C,DET,28,82,15,11,26
25,8480802,Ryan McLeod,C,EDM,25,82,11,15,26
25,8473422,Nick Foligno,L,CHI,37,82,11,15,26
25,8475171,Oliver Ekman-Larsson,D,FLA,33,82,9,17,26
25,8473563,Nicklas Backstrom,C,WSH,37,82,8,18,26
25,8478882,Vladislav Gavrikov,D,LAK,29,82,6,20,26
25,8475181,Nick Leddy,D,STL,33,82,4,22,26
25,8483493,Frank Nazar,C,CHI,20,82,18,7,25
25,8479316,Luke Kunin,C,SJS,27,82,16,9,25
25,8473986,Alex Killorn,L,ANA,35,82,15,10,25
25,8476927,Teddy Blueger,C,VAN,30,82,14,11,25
25,8481517,Brett Leason,R,ANA,25,82,14,11,25
25,8478508,Yakov Trenin,C,COL,27,82,14,11,25
25,8479415,Michael McLeod,C,NJD,26,82,12,13,25
25,8475842,Sam Carrick,C,EDM,32,82,12,13,25
25,8480817,K'Andre Miller,D,NYR,24,82,11,14,25
25,8482117,Lukas Reichel,L,CHI,22,82,11,14,25
25,8476902,Esa Lindell,D,DAL,30,82,8,17,25
25,8476312,Josh Manson,D,COL,33,82,4,21,25
25,8482087,Kaiden Guhle,D,MTL,22,82,4,21,25
25,8477506,Ryan Pulock,D,NYI,30,82,2,23,25
25,8476879,Cody Ceci,D,EDM,31,82,0,25,25
25,8479390,Taylor Raddysh,R,CHI,26,82,14,10,24
25,8476981,Josh Anderson,R,MTL,30,82,12,12,24
25,8479977,Kailer Yamamoto,R,SEA,26,82,12,12,24
25,8480855,Jack McBain,C,ARI,24,82,12,12,24
25,8476525,Colin Miller,D,WPG,32,82,9,15,24
25,8481524,Bowen Byram,D,BUF,23,82,9,15,24
25,8474189,Lars Eller,C,PIT,35,82,7,17,24
25,8479976,Juuso Valimaki,D,ARI,26,82,7,17,24
25,8475455,Brenden Dillon,D,WPG,34,82,7,17,24
25,8481178,Egor Zamula,D,PHI,24,82,6,18,24
25,8476422,Mike Reilly,D,NYI,31,82,5,19,24
25,8474673,TJ Brodie,D,TOR,34,82,4,20,24
25,8475188,Brayden McNabb,D,VGK,33,82,3,21,24
25,8476979,Erik Gustafsson,D,NYR,32,82,2,22,24
25,8478020,Michael Amadio,C,VGK,28,82,14,9,23
25,8482111,Justin Barron,D,MTL,23,82,13,10,23
25,8478569,Noel Acciari,C,PIT,33,82,13,10,23
25,8479346,Dillon Dube,C,CGY,26,82,12,11,23
25,8482624,Daniil Miromanov,D,CGY,27,82,10,13,23
25,8473449,Kyle Okposo,R,FLA,36,82,10,13,23
25,8483499,Liam Ohgren,L,MIN,20,82,10,13,23
25,8476480,Vladislav Namestnikov,C,WPG,32,82,9,14,23
25,8476469,Joel Armia,R,MTL,31,82,9,14,23
25,8470621,Corey Perry,R,EDM,39,82,9,14,23
25,8480172,Jan Rutta,D,SJS,34,82,9,14,23
25,8476278,Colin Blackwell,C,CHI,31,82,8,15,23
25,8477369,Carson Soucy,D,VAN,30,82,8,15,23
25,8483482,Tristan Luneau,D,ANA,20,82,8,15,23
25,8479353,Brett Howden,C,VGK,26,82,7,16,23
25,8481537,Nikita Okhotiuk,D,CGY,24,82,7,16,23
25,8473453,Trevor Lewis,C,LAK,37,82,7,16,23
25,8481606,Jordan Spence,D,LAK,23,82,7,16,23
25,8476457,Adam Larsson,D,SEA,32,82,6,17,23
25,8478911,Matt Roy,D,LAK,29,82,3,20,23
25,8479369,Andrew Peeke,D,BOS,26,82,2,21,23
25,8480281,Alexey Toropchenko,R,STL,25,82,13,9,22
25,8477450,Jason Dickinson,C,CHI,29,82,12,10,22
25,8482155,Alex Laferriere,R,LAK,23,82,12,10,22
25,8483515,Juraj Slafkovsky,L,MTL,20,82,11,11,22
25,8482166,Shakir Mukhamadullin,D,SJS,22,82,11,11,22
25,8478831,Kevin Stenlund,C,FLA,28,82,10,12,22
25,8480980,Connor Dewar,C,TOR,25,82,10,12,22
25,8479992,Michael Rasmussen,C,DET,25,82,9,13,22
25,8479383,Boris Katchouk,L,OTT,26,82,9,13,22
25,8481477,Nico Sturm,C,SJS,29,82,8,14,22
25,8477499,Rasmus Ristolainen,D,PHI,30,82,6,16,22
25,8476467,Jamie Oleksiak,D,SEA,32,82,3,19,22
25,8476331,Dylan DeMelo,D,WPG,31,82,3,19,22
25,8482118,Sam Colangelo,R,ANA,23,82,17,4,21
25,8478115,Pierre Engvall,L,NYI,28,82,12,9,21
25,8476374,Sean Kuraly,C,CBJ,31,82,10,11,21
25,8477507,Nikita Zadorov,D,VAN,29,82,10,11,21
25,8483565,Nick Blankenburg,D,CBJ,26,82,9,12,21
25,8480035,Henri Jokiharju,D,BUF,25,82,6,15,21
25,8477435,Ryan Graves,D,PIT,29,82,5,16,21
25,8475324,Nick Jensen,D,WSH,34,82,4,17,21
25,8480834,Ty Emberson,D,SJS,24,82,3,18,21
25,8476891,Matt Grzelcyk,D,BOS,30,82,3,18,21
25,8478451,Ethan Bear,D,WSH,27,82,3,18,21
25,8482516,Matthew Kessel,D,STL,24,82,2,19,21
25,8483490,Pavel Mintyukov,D,ANA,21,82,1,20,21
25,8482809,Jackson Blake,R,CAR,21,82,13,7,20
25,8476871,Tanner Pearson,L,MTL,32,82,11,9,20
25,8480144,David Kampf,C,TOR,29,82,11,9,20
25,8476878,Zemgus Girgensons,L,BUF,30,82,10,10,20
25,8477508,Curtis Lazar,C,NJD,29,82,9,11,20
25,8470600,Ryan Suter,D,DAL,39,82,5,15,20
25,8482730,Brandt Clarke,D,LAK,21,82,4,16,20
25,8476463,Jonas Brodin,D,MIN,31,82,4,16,20
25,8481014,Alexander Romanov,D,NYI,24,82,4,16,20
25,8478507,John Marino,D,NJD,27,82,1,19,20
25,8482712,Oskar Olausson,R,COL,22,82,1,19,20
25,8477989,Christian Dvorak,C,MTL,28,82,11,8,19
25,8479393,Noah Gregor,C,TOR,26,82,11,8,19
25,8474009,Nick Bonino,C,NYR,36,82,11,8,19
25,8477392,Hudson Fasching,R,NYI,29,82,9,10,19
25,8483012,Logan Morrison,C,SEA,22,82,9,10,19
25,8475343,Nic Dowd,C,WSH,34,82,8,11,19
25,8480448,Parker Kelly,L,OTT,25,82,6,13,19
25,8482762,Simon Edvinsson,D,DET,21,82,6,13,19
25,8479983,Mario Ferraro,D,SJS,26,82,5,14,19
25,8482803,Olen Zellweger,D,ANA,21,82,5,14,19
25,8481568,Alex Vlasic,D,CHI,23,82,4,15,19
25,8484911,Collin Graf,R,SJS,22,82,4,15,19
25,8477406,Mattias Janmark,C,EDM,32,82,4,15,19
25,8479371,Dante Fabbro,D,NSH,26,82,3,16,19
25,8481567,Henry Thrun,D,SJS,23,82,3,16,19
25,8484145,Zach Benson,L,BUF,19,82,12,6,18
25,8475220,Marcus Foligno,L,MIN,33,82,11,7,18
25,8481601,Simon Holmstrom,R,NYI,23,82,9,9,18
25,8476931,Jake McCabe,D,TOR,31,82,8,10,18
25,8474715,Cam Atkinson,R,PHI,35,82,8,10,18
25,8479661,Tanner Jeannot,L,TBL,27,82,7,11,18
25,8477839,Conor Sheary,L,TBL,32,82,5,13,18
25,8478399,Jonas Siegenthaler,D,NJD,27,82,5,13,18
25,8478859,Niko Mikkola,D,FLA,28,82,5,13,18
25,8476442,Matt Nieto,L,PIT,32,82,5,13,18
25,8475279,Ben Chiarot,D,DET,33,82,4,14,18
25,8479291,Kevin Rooney,C,CGY,31,82,4,14,18
25,8475690,Chris Tanev,D,DAL,35,82,3,15,18
25,8470966,Mark Giordano,D,TOR,41,82,3,15,18
25,8481028,Martin Pospisil,C,CGY,25,82,2,16,18
25,8480807,Mattias Samuelsson,D,BUF,24,82,1,17,18
25,8470604,Jeff Carter,C,PIT,39,82,10,7,17
25,8476858,Phillip Di Giuseppe,L,VAN,31,82,8,9,17
25,8477365,Connor Clifton,D,BUF,29,82,5,12,17
25,8483505,Matthew Poitras,C,BOS,20,82,5,12,17
25,8477015,Connor Brown,R,EDM,30,82,5,12,17
25,8480990,Declan Chisholm,D,MIN,24,82,5,12,17
25,8483495,Simon Nemec,D,NJD,20,82,5,12,17
25,8479980,Nicolas Hague,D,VGK,26,82,4,13,17
25,8480879,Jacob Bernard-Docker,D,OTT,24,82,4,13,17
25,8482142,Jamie Drysdale,D,PHI,22,82,3,14,17
25,8482470,Ilya Solovyov,D,CGY,24,82,3,14,17
25,8474574,Tyler Myers,D,VAN,34,82,3,14,17
25,8480058,Pierre-Olivier Joseph,D,PIT,25,82,3,14,17
25,8475790,Erik Gudbranson,D,CBJ,32,82,2,15,17
25,8480246,Nick Perbix,D,TBL,26,82,2,15,17
25,8482145,Mavrik Bourque,C,DAL,22,82,11,5,16
25,8484203,Bradly Nadeau,L,CAR,19,82,11,5,16
25,8481093,Rafael Harvey-Pinard,L,MTL,25,82,6,10,16
25,8480860,Kevin Bahl,D,NJD,24,82,5,11,16
25,8482062,Cole Smith,L,NSH,29,82,4,12,16
25,8477220,Nate Schmidt,D,WPG,33,82,3,13,16
25,8475233,David Savard,D,MTL,34,82,1,15,16
25,8480806,Isac Lundestrom,C,ANA,25,82,8,7,15
25,8478443,Brandon Carlo,D,BOS,28,82,5,10,15
25,8480336,Sean Walker,D,COL,30,82,4,11,15
25,8480796,Martin Fehervary,D,WSH,25,82,4,11,15
25,8476429,Scott Mayfield,D,NYI,32,82,4,11,15
25,8477034,Jaycob Megna,D,CHI,32,82,2,13,15
25,8475762,Derek Forbort,D,BOS,32,82,6,8,14
25,8482074,Connor Zary,C,CGY,23,82,5,9,14
25,8478416,Erik Cernak,D,TBL,27,82,3,11,14
25,8474166,Alec Martinez,D,VGK,37,82,2,12,14
25,8482073,Braden Schneider,D,NYR,23,82,2,12,14
25,8483466,Kevin Korchinski,D,CHI,20,82,1,13,14
25,8474013,Ian Cole,D,VAN,35,82,1,13,14
25,8482679,Matt Coronato,R,CGY,22,82,5,8,13
25,8482666,Scott Morrow,D,CAR,22,82,4,9,13
25,8479442,Troy Stecher,D,EDM,30,82,4,9,13
25,8477931,Tomas Nosek,L,NJD,32,82,4,9,13
25,8478468,Jeremy Lauzon,D,NSH,27,82,3,10,13
25,8477845,Trevor van Riemsdyk,D,WSH,33,82,2,11,13
25,8475208,Brian Dumoulin,D,SEA,33,82,2,11,13
25,8478408,Travis Dermott,D,ARI,28,82,2,11,13
25,8476372,Nick Seeler,D,PHI,31,82,1,12,13
25,8475177,Calvin de Haan,D,TBL,33,82,1,12,13
25,8474034,Pat Maroon,L,BOS,36,82,7,5,12
25,8471677,Jack Johnson,D,COL,37,82,5,7,12
25,8479998,Mikey Anderson,D,LAK,25,82,4,8,12
25,8476624,Barclay Goodrow,C,NYR,31,82,2,10,12
25,8482858,Ryker Evans,D,SEA,23,82,2,10,12
25,8474567,Zach Bogosian,D,MIN,34,82,1,11,12
25,8477505,Alexander Wennberg,C,NYR,30,82,1,11,12
25,8475179,Dmitry Kulikov,D,FLA,34,82,1,11,12
25,8481059,Scott Perunovich,D,STL,26,82,5,6,11
25,8479324,Ryan Lindgren,D,NYR,26,82,4,7,11
25,8482807,Ethan Del Mastro,D,CHI,21,82,2,9,11
25,8482859,Zack Ostapchuk,C,OTT,21,82,2,9,11
25,8475462,Radko Gudas,D,ANA,34,82,1,10,11
25,8476967,Brett Kulak,D,EDM,30,82,1,10,11
25,8476473,Connor Murphy,D,CHI,31,82,1,10,11
25,8481578,Graeme Clarke,R,NJD,23,82,3,7,10
25,8479514,Rem Pitlick,C,CHI,27,82,0,10,10
25,8476915,Jujhar Khaira,L,MIN,30,82,5,4,9
25,8481599,Victor Soderstrom,D,ARI,23,82,5,4,9
25,8481605,Jackson LaCombe,D,ANA,23,82,4,5,9
25,8475825,Jani Hakanpää,D,DAL,32,82,2,7,9
25,8484149,Gavin Brindley,C,CBJ,20,82,4,4,8
25,8477335,Kyle Burroughs,D,SJS,29,82,3,5,8
25,8483763,Maksymilian Szuber,D,ARI,22,82,3,5,8
25,8482713,Mackie Samoskevich,R,FLA,22,82,1,7,8
25,8476822,Luke Glendening,C,TBL,35,82,4,3,7
25,8481030,Jack St. Ivany,D,PIT,25,82,4,3,7
25,8482177,Marat Khusnutdinov,C,MIN,22,82,3,3,6
25,8483489,Fraser Minten,C,TOR,31,82,2,4,6
25,8483468,Jiri Kulich,C,BUF,20,82,0,4,4
25,8482141,Lukas Cormier,D,VGK,22,0,0,0,0
25,8476988,Matt Benning,D,SJS,30,0,0,0,0
25,8480727,Zach Whitecloud,D,VGK,28,0,0,0,0
25,8480887,Jordan Harris,D,MTL,24,0,0,0,0
25,8478450,Parker Wotherspoon,D,BOS,27,0,0,0,0
25,8481812,Nikolai Knyzhov,D,SJS,27,0,0,0,0
25,8480001,Urho Vaakanainen,D,ANA,25,0,0,0,0
25,8482176,Wyatt Kaiser,D,CHI,22,0,0,0,0
25,8481122,Simon Benoit,D,TOR,26,0,0,0,0
25,8476441,Joel Edmundson,D,TOR,31,0,0,0,0
25,8480884,Calen Addison,D,SJS,24,0,0,0,0
25,8482511,Mason Lohrei,D,BOS,23,0,0,0,0
25,8482192,Isaak Phillips,D,CHI,23,0,0,0,0
25,8480950,Ilya Lyubushkin,D,TOR,30,0,0,0,0
25,8474031,Kevin Shattenkirk,D,BOS,35,0,0,0,0
25,8475718,Justin Holl,D,DET,32,0,0,0,0
25,8479402,Jake Bean,D,CBJ,26,0,0,0,0
25,8474602,Justin Schultz,D,SEA,34,0,0,0,0
25,8477950,Tony DeAngelo,D,CAR,29,0,0,0,0
25,8481743,Marc Del Gaizo,D,NSH,25,0,0,0,0
25,8481527,Kaedan Korczak,D,VGK,23,0,0,0,0
25,8480192,Johnathan Kovacevic,D,MTL,27,0,0,0,0
25,8476874,Olli Maatta,D,DET,30,0,0,0,0
25,8482144,Jack Thompson,D,SJS,22,0,0,0,0
25,8480222,Sebastian Aho,D,NYI,28,0,0,0,0
25,8479458,Nikita Zaitsev,D,CHI,33,0,0,0,0
25,8471709,Marc-Edouard Vlasic,D,SJS,37,0,0,0,0
25,8482929,Emil Lilleberg,D,TBL,23,0,0,0,0
25,8477018,Ben Hutton,D,VGK,31,0,0,0,0
25,8481056,Spencer Stastney,D,NSH,24,0,0,0,0
25,8481593,Jayden Struble,D,MTL,23,0,0,0,0
25,8479982,Conor Timmins,D,TOR,26,0,0,0,0
25,8474090,Brendan Smith,D,NJD,35,0,0,0,0
25,8482964,Arber Xhekaj,D,MTL,23,0,0,0,0
25,8480891,Michael Kesselring,D,ARI,24,0,0,0,0
25,8477938,Haydn Fleury,D,TBL,28,0,0,0,0
25,8481806,Louis Crevier,D,CHI,23,0,0,0,0
25,8471274,Alex Goligoski,D,MIN,39,0,0,0,0
25,8481600,Tobias Bjornfot,D,FLA,23,0,0,0,0
25,8475797,Jarred Tinordi,D,CHI,32,0,0,0,0
25,8481521,Ronnie Attard,D,PHI,25,0,0,0,0
25,8474612,Travis Hamonic,D,OTT,34,0,0,0,0
25,8479576,Vincent Desharnais,D,EDM,28,0,0,0,0
25,8480049,Dylan Samberg,D,WPG,25,0,0,0,0
25,8483619,Filip Roos,D,CHI,25,0,0,0,0
25,8474568,Luke Schenn,D,NSH,35,0,0,0,0
25,8480184,Gustav Lindstrom,D,ANA,26,0,0,0,0
25,8480070,Ian Mitchell,D,BOS,25,0,0,0,0
25,8480196,Jacob Bryson,D,BUF,27,0,0,0,0
25,8471686,Marc Staal,D,PHI,37,0,0,0,0
25,8477467,Gustav Olofsson,D,SEA,30,0,0,0,0
25,8478970,Jalen Chatfield,D,CAR,28,0,0,0,0
25,8479348,Kale Clague,D,BUF,26,0,0,0,0
25,8473446,Erik Johnson,D,PHI,36,0,0,0,0
25,8477462,Robert Hagg,D,ANA,29,0,0,0,0
25,8478454,Noah Juulsen,D,VAN,27,0,0,0,0
25,8477384,Josh Brown,D,ARI,30,0,0,0,0
25,8481708,Zac Jones,D,NYR,24,0,0,0,0
25,8481167,Brayden Pachal,D,CGY,25,0,0,0,0
25,8482067,Connor Mackey,D,NYR,28,0,0,0,0
25,8483460,David Jiricek,D,CBJ,21,0,0,0,0
25,8481701,Santeri Hatakka,D,NJD,23,0,0,0,0
25,8478021,William Lagesson,D,ANA,28,0,0,0,0
25,8477851,Jordan Oesterle,D,CGY,32,0,0,0,0
25,8478452,Caleb Jones,D,COL,27,0,0,0,0
25,8479984,Cal Foote,D,NJD,26,0,0,0,0
25,8479639,Dylan Coghlan,D,CAR,26,0,0,0,0
25,8480874,Adam Ginning,D,PHI,24,0,0,0,0
25,8479321,Lucas Johansen,D,WSH,27,0,0,0,0
25,8480878,Nils Lundkvist,D,DAL,24,0,0,0,0
25,8482165,Yan Kuznetsov,D,CGY,22,0,0,0,0
25,8484258,Sam Malinski,D,COL,26,0,0,0,0
25,8480157,Calle Rosen,D,STL,30,0,0,0,0
25,8484304,Uvis Balinskis,D,FLA,28,0,0,0,0
25,8479985,Cale Fleury,D,SEA,26,0,0,0,0
25,8479378,Logan Stanley,D,WPG,26,0,0,0,0
25,8477541,Dakota Mermis,D,MIN,30,0,0,0,0
25,8481609,Vladislav Kolyachonok,D,ARI,23,0,0,0,0
25,8480823,Alexander Alexeyev,D,WSH,25,0,0,0,0
25,8481679,Maxence Guenette,D,OTT,23,0,0,0,0
25,8481564,Ryan Johnson,D,BUF,23,0,0,0,0
25,8479376,Victor Mete,D,PHI,26,0,0,0,0
25,8484254,Akito Hirose,D,VAN,25,0,0,0,0
25,8482660,Kent Johnson,C,CBJ,22,0,0,0,0
25,8482149,Cole Perfetti,C,WPG,22,0,0,0,0
25,8477987,Ryan Donato,C,CHI,28,0,0,0,0
25,8475755,Alexander Petrovic,D,DAL,32,0,0,0,0
25,8477810,Joel Hanley,D,CGY,33,0,0,0,0
25,8474145,Robert Bortuzzo,D,NYI,35,0,0,0,0
25,8481161,Jake Christiansen,D,CBJ,25,0,0,0,0
25,8476884,Derrick Pouliot,D,DAL,30,0,0,0,0
25,8481716,Dmitri Voronkov,L,CBJ,24,0,0,0,0
25,8480084,Nick DeSimone,D,NJD,30,0,0,0,0
25,8475750,Jon Merrill,D,MIN,32,0,0,0,0
25,8479315,Joey Anderson,R,CHI,26,0,0,0,0
25,8478011,Louie Belpedio,D,PHI,28,0,0,0,0
25,8482451,Mikael Pyyhtia,L,CBJ,23,0,0,0,0
25,8481541,Samuel Bolduc,D,NYI,24,0,0,0,0
25,8482126,Emil Andrae,D,PHI,31,0,0,0,0
25,8474618,Marco Scandella,D,STL,34,0,0,0,0
25,8477244,Chad Ruhwedel,D,NYR,34,0,0,0,0
25,8477971,Andreas Englund,D,LAK,28,0,0,0,0
25,8480829,Jesperi Kotkaniemi,C,CAR,24,0,0,0,0
25,8479372,Josh Mahura,D,FLA,26,0,0,0,0
25,8482095,Tyler Kleven,D,OTT,22,0,0,0,0
25,8481719,Maxwell Crozier,D,TBL,24,0,0,0,0
25,8475855,Jesper Fast,R,CAR,33,0,0,0,0
25,8480848,Ty Dellandrea,C,DAL,24,0,0,0,0
25,8475193,Tomas Tatar,L,SEA,34,0,0,0,0
25,8476889,Radek Faksa,C,DAL,30,0,0,0,0
25,8478495,Denis Gurianov,R,PHI,27,0,0,0,0
25,8480216,Jacob Peterson,C,SJS,25,0,0,0,0
25,8480252,Cole Guttman,C,CHI,25,0,0,0,0
25,8479026,Philippe Myers,D,TBL,27,0,0,0,0
25,8481006,Tyler Tucker,D,STL,24,0,0,0,0
25,8481032,Paul Cotter,C,VGK,25,0,0,0,0
25,8481577,Philip Tomasino,C,NSH,23,0,0,0,0
25,8476918,Jimmy Vesey,L,NYR,31,0,0,0,0
25,8479320,Max Lajoie,D,TOR,27,0,0,0,0
25,8478017,Mark Friedman,D,VAN,29,0,0,0,0
25,8481754,Nikita Nesterenko,C,ANA,23,0,0,0,0
25,8483407,Brandon Scanlin,D,NYR,25,0,0,0,0
25,8482659,Josh Doan,R,ARI,22,0,0,0,0
25,8477446,Michael McCarron,R,NSH,29,0,0,0,0
25,8477903,Garnet Hathaway,R,PHI,33,0,0,0,0
25,8482153,Brendan Brisson,C,VGK,23,0,0,0,0
25,8483546,Marshall Rifai,D,TOR,26,0,0,0,0
25,8484287,Cole McWard,D,VAN,23,0,0,0,0
25,8478854,Ryan Shea,D,PIT,27,0,0,0,0
25,8481585,Egor Afanasyev,L,NSH,23,0,0,0,0
25,8483398,Declan Carlile,D,TBL,31,0,0,0,0
25,8478502,Dennis Gilbert,D,CGY,28,0,0,0,0
25,8482749,Joshua Roy,R,MTL,21,0,0,0,0
25,8481598,Philip Broberg,D,EDM,23,0,0,0,0
25,8480835,Jack Drury,C,CAR,24,0,0,0,0
25,8480748,Kiefer Sherwood,L,NSH,29,0,0,0,0
25,8476934,Brock McGinn,L,ANA,30,0,0,0,0
25,8480870,Bo Groulx,C,ANA,24,0,0,0,0
25,8479368,Max Jones,L,ANA,26,0,0,0,0
25,8478099,Kevin Labanc,R,SJS,29,0,0,0,0
25,8478067,Oskar Lindblom,L,SJS,28,0,0,0,0
25,8476393,Nick Cousins,C,FLA,31,0,0,0,0
25,8483395,Arshdeep Bains,L,VAN,23,0,0,0,0
25,8480762,Eric Robinson,L,BUF,29,0,0,0,0
25,8479439,Jacob MacDonald,D,SJS,31,0,0,0,0
25,8476474,Stefan Noesen,R,CAR,31,0,0,0,0
25,8482787,Nikita Chibrikov,R,WPG,31,0,0,0,0
25,8478432,Christian Fischer,R,DET,27,0,0,0,0
25,8477979,Nicolas Aube-Kubel,R,WSH,28,0,0,0,0
25,8481789,Tye Kartye,L,SEA,23,0,0,0,0
25,8479330,Brandon Gignac,C,MTL,27,0,0,0,0
25,8480075,Cameron Crotty,D,ARI,25,0,0,0,0
25,8473473,Milan Lucic,L,BOS,36,0,0,0,0
25,8482094,Daemon Hunt,D,MIN,22,0,0,0,0
25,8481206,John Ludvig,D,PIT,24,0,0,0,0
25,8483630,Pavol Regenda,L,ANA,25,0,0,0,0
25,8481617,Vasily Podkolzin,R,VAN,23,0,0,0,0
25,8480306,Grant Hutton,D,NYI,29,0,0,0,0
25,8480995,Pontus Holmberg,R,TOR,25,0,0,0,0
25,8482148,Hendrix Lapierre,C,WSH,22,0,0,0,0
25,8477478,William Carrier,L,VGK,30,0,0,0,0
25,8480003,Jesper Boqvist,C,BOS,26,0,0,0,0
25,8482172,Landon Slaggert,L,CHI,22,0,0,0,0
25,8480789,Oliver Wahlstrom,R,NYI,24,0,0,0,0
25,8474062,Riley Nash,C,NYR,35,0,0,0,0
25,8480021,Jack Studnicka,C,SJS,25,0,0,0,0
25,8480025,MacKenzie Entwistle,R,CHI,25,0,0,0,0
25,8481582,Nicholas Robertson,L,TOR,23,0,0,0,0
25,8476867,Brendan Gaunce,C,CBJ,30,0,0,0,0
25,8479619,Michael Carcone,L,ARI,28,0,0,0,0
25,8479370,Tyson Jost,C,BUF,26,0,0,0,0
25,8479671,Mathieu Olivier,R,CBJ,27,0,0,0,0
25,8476994,Vinnie Hinostroza,C,PIT,30,0,0,0,0
25,8482070,Mitchell Chaffee,R,TBL,26,0,0,0,0
25,8477473,Justin Bailey,R,SJS,29,0,0,0,0
25,8479344,Jesse Puljujarvi,R,PIT,26,0,0,0,0
25,8480205,Emil Bemstrom,C,PIT,25,0,0,0,0
25,8479718,Alex Barré-Boulet,C,TBL,27,0,0,0,0
25,8482061,Brandon Biro,L,BUF,26,0,0,0,0
25,8479638,Justin Brazeau,R,BOS,26,0,0,0,0
25,8474040,Sam Gagner,C,EDM,35,0,0,0,0
25,8477846,Ryan Carpenter,C,SJS,33,0,0,0,0
25,8482077,Dylan Holloway,L,EDM,23,0,0,0,0
25,8482157,Will Cuylle,L,NYR,22,0,0,0,0
25,8480007,Jonas Rondbjerg,R,VGK,25,0,0,0,0
25,8478874,Adam Gaudette,C,STL,28,0,0,0,0
25,8478434,Keegan Kolesar,R,VGK,27,0,0,0,0
25,8480441,Trey Fix-Wolansky,R,CBJ,25,0,0,0,0
25,8479994,Jaret Anderson-Dolan,C,NSH,25,0,0,0,0
25,8483567,Georgii Merkulov,C,BOS,24,0,0,0,0
25,8477380,Jonny Brodzinski,C,NYR,31,0,0,0,0
25,8482201,Gage Goncalves,C,TBL,23,0,0,0,0
25,8478211,Dryden Hunt,L,CGY,29,0,0,0,0
25,8471699,Andrew Cogliano,C,COL,37,0,0,0,0
25,8479421,Jacob Moverare,D,LAK,26,0,0,0,0
25,8478881,Brett Seney,L,CHI,28,0,0,0,0
25,8477464,Nic Petan,C,MIN,29,0,0,0,0
25,8475958,Michael Sgarbossa,C,WSH,32,0,0,0,0
25,8481147,Reese Johnson,C,CHI,26,0,0,0,0
25,8479336,Carl Grundstrom,R,LAK,27,0,0,0,0
25,8480853,Liam Foudy,C,NSH,24,0,0,0,0
25,8479522,Hardy Haman Aktell,D,WSH,26,0,0,0,0
25,8481462,Mason Morelli,L,VGK,28,0,0,0,0
25,8482102,Vasily Ponomarev,C,CAR,22,0,0,0,0
25,8480844,Grigori Denisenko,L,VGK,24,0,0,0,0
25,8479944,Zach Aston-Reese,C,DET,30,0,0,0,0
25,8482784,Zach Dean,C,STL,21,0,0,0,0
25,8479419,Brett Murray,L,BUF,26,0,0,0,0
25,8479520,Brandon Duhaime,R,COL,27,0,0,0,0
25,8477573,Nathan Walker,L,STL,30,0,0,0,0
25,8478078,Rourke Chartier,C,OTT,28,0,0,0,0
25,8475795,Dylan McIlrath,D,WSH,32,0,0,0,0
25,8482496,Nils Aman,C,VAN,24,0,0,0,0
25,8480289,Morgan Barron,C,WPG,26,0,0,0,0
25,8481751,Lukas Rousek,R,BUF,25,0,0,0,0
25,8480011,Klim Kostin,C,SJS,25,0,0,0,0
25,8481556,John Beecher,C,BOS,23,0,0,0,0
25,8475278,Byron Froese,C,VGK,33,0,0,0,0
25,8475225,Craig Smith,C,DAL,35,0,0,0,0
25,8484326,Patrik Koch,D,ARI,28,0,0,0,0
25,8477930,Pierre-Edouard Bellemare,L,SEA,39,0,0,0,0
25,8478409,Anthony Richard,C,BOS,28,0,0,0,0
25,8481024,Linus Karlsson,C,VAN,25,0,0,0,0
25,8479986,Kole Lind,R,SEA,26,0,0,0,0
25,8479414,Nathan Bastian,R,NJD,27,0,0,0,0
25,8479362,Riley Tufte,L,COL,26,0,0,0,0
25,8481058,Jesse Ylönen,R,MTL,25,0,0,0,0
25,8482476,Emil Heineman,L,MTL,23,0,0,0,0
25,8482861,Vincent Iorio,D,WSH,22,0,0,0,0
25,8483432,Luca Del Bel Belluz,C,CBJ,31,0,0,0,0
25,8482744,James Malatesta,L,CBJ,21,0,0,0,0
25,8477887,Patrick Brown,C,BOS,32,0,0,0,0
25,8478585,Derek Ryan,C,EDM,38,0,0,0,0
25,8481441,Joe Snively,C,WSH,28,0,0,0,0
25,8481592,Jakob Pelletier,L,CGY,23,0,0,0,0
25,8482634,Alex Steeves,C,TOR,25,0,0,0,0
25,8477126,Jayson Megna,C,BOS,34,0,0,0,0
25,8475752,Tyler Pitlick,C,NYR,33,0,0,0,0
25,8480008,Adam Ruzicka,C,ARI,25,0,0,0,0
25,8481065,Angus Crookshank,L,OTT,25,0,0,0,0
25,8479547,Matthew Phillips,R,WSH,26,0,0,0,0
25,8480226,Marián Studenic,R,SEA,26,0,0,0,0
25,8481237,Kyle MacLean,C,NYI,25,0,0,0,0
25,8475413,Justin Dowling,C,NJD,34,0,0,0,0
25,8481641,Joel Kiviranta,L,COL,28,0,0,0,0
25,8478104,Sammy Blais,L,STL,28,0,0,0,0
25,8477454,Adam Erne,L,EDM,29,0,0,0,0
25,8481518,Nolan Foote,L,NJD,24,0,0,0,0
25,8480245,Olle Lycksell,R,PHI,25,0,0,0,0
25,8483570,Ben Meyers,C,ANA,26,0,0,0,0
25,8480776,Sheldon Rempal,R,VGK,29,0,0,0,0
25,8483920,Pierrick Dube,R,WSH,23,0,0,0,0
25,8480267,Sammy Walker,C,MIN,25,0,0,0,0
25,8482747,Brennan Othmann,L,NYR,21,0,0,0,0
25,8479991,Jake Leschyshyn,C,NYR,25,0,0,0,0
25,8478400,Colin White,C,MTL,27,0,0,0,0
25,8479328,Julien Gauthier,R,NYI,27,0,0,0,0
25,8484325,Waltteri Merela,C,TBL,26,0,0,0,0
25,8479066,Ryan Lomberg,L,FLA,30,0,0,0,0
25,8477070,Liam O'Brien,C,ARI,30,0,0,0,0
25,8478146,Matthew Highmore,C,OTT,28,0,0,0,0
25,8478028,Fredrik Olofsson,L,COL,28,0,0,0,0
25,8480880,Jakub Lauko,C,BOS,24,0,0,0,0
25,8479968,Vinni Lettieri,C,MIN,29,0,0,0,0
25,8474709,Matt Martin,L,NYI,35,0,0,0,0
25,8480845,Rasmus Kupari,C,WPG,24,0,0,0,0
25,8481550,Adam Beckman,L,MIN,23,0,0,0,0
25,8481422,Jacob Lucchini,C,MIN,29,0,0,0,0
25,8477401,John Hayden,C,SEA,29,0,0,0,0
25,8478904,Steven Lorentz,C,FLA,28,0,0,0,0
25,8482088,Justin Sourdif,R,FLA,22,0,0,0,0
25,8482751,Ryan Winterton,C,SEA,21,0,0,0,0
25,8482241,Radim Zohorna,L,PIT,28,0,0,0,0
25,8481690,Tyler Angle,C,CBJ,24,0,0,0,0
25,8476952,Dominic Toninato,C,WPG,30,0,0,0,0
25,8476919,Chris Tierney,C,NJD,30,0,0,0,0
25,8480032,Shane Bowers,C,NJD,25,0,0,0,0
25,8484314,Jiri Smejkal,L,OTT,28,0,0,0,0
25,8481239,Samuel Fagemo,L,LAK,24,0,0,0,0
25,8481532,Alex Turcotte,C,LAK,23,0,0,0,0
25,8481019,David Gustafsson,C,WPG,24,0,0,0,0
25,8478477,Mitchell Stephens,C,MTL,27,0,0,0,0
25,8479546,Oskar Steen,C,BOS,26,0,0,0,0
25,8480292,Carson Meyer,R,CBJ,27,0,0,0,0
25,8478446,Glenn Gawdin,C,ANA,27,0,0,0,0
25,8483531,Brian Halonen,L,NJD,25,0,0,0,0
25,8477149,Scott Sabourin,R,SJS,32,0,0,0,0
25,8479972,Mason Shaw,C,MIN,26,0,0,0,0
25,8480890,Jan Jenik,R,ARI,24,0,0,0,0
25,8478051,Max Willman,C,NJD,29,0,0,0,0
25,8480851,Akil Thomas,C,LAK,24,0,0,0,0
25,8482765,Isak Rosen,R,BUF,21,0,0,0,0
25,8478421,A.J. Greer,L,CGY,28,0,0,0,0
25,8478512,Austin Czarnik,C,DET,32,0,0,0,0
25,8479536,Axel Jonsson-Fjallby,L,WPG,26,0,0,0,0
25,8477320,Anton Blidh,L,NYR,29,0,0,0,0
25,8481543,Nikita Alexandrov,C,STL,24,0,0,0,0
25,8475235,Nicolas Deslauriers,L,PHI,33,0,0,0,0
25,8481070,Hugh McGing,L,STL,26,0,0,0,0
25,8480836,Jonathan Gruden,C,PIT,24,0,0,0,0
25,8481591,Sam Poulin,R,PIT,23,0,0,0,0
25,8477962,Brendan Lemieux,L,CAR,28,0,0,0,0
25,8483401,Marc Johnstone,R,PIT,28,0,0,0,0
25,8482250,Callahan Burke,C,CAR,27,0,0,0,0
25,8481726,Adam Edstrom,C,NYR,24,0,0,0,0
25,8471817,Ryan Reaves,R,TOR,37,0,0,0,0
25,8479587,Rhett Gardner,C,PHI,28,0,0,0,0
25,8475766,Austin Watson,L,TBL,32,0,0,0,0
25,8479367,William Lockwood,R,FLA,26,0,0,0,0
25,8478424,Jansen Harkins,C,PIT,27,0,0,0,0
25,8476913,Devin Shore,C,SEA,30,0,0,0,0
25,8482652,Walker Duehr,R,CGY,27,0,0,0,0
25,8477527,Ross Johnston,L,ANA,30,0,0,0,0
25,8481077,John Leonard,L,ARI,26,0,0,0,0
25,8483549,Lucas Condotta,L,MTL,27,0,0,0,0
25,8480468,James Hamblin,L,EDM,25,0,0,0,0
25,8476907,Mackenzie MacEachern,L,STL,30,0,0,0,0
25,8479543,Michael Pezzetta,L,MTL,26,0,0,0,0
25,8480355,Mark Kastelic,C,OTT,25,0,0,0,0
25,8482162,Roby Jarventie,L,OTT,22,0,0,0,0
25,8479772,Zack MacEwen,R,OTT,28,0,0,0,0
25,8483597,Milos Kelemen,L,ARI,25,0,0,0,0
25,8479379,Givani Smith,R,SJS,26,0,0,0,0
25,8481655,Cole Schwindt,R,CGY,23,0,0,0,0
25,8479981,Jonah Gadjovich,L,FLA,26,0,0,0,0
25,8482147,Jean-Luc Foudy,C,COL,22,0,0,0,0
25,8484255,Jason Polin,R,COL,25,0,0,0,0
25,8477993,Justin Kirkland,C,ARI,28,0,0,0,0
25,8479249,Andrew Poturalski,C,SEA,30,0,0,0,0
25,8482197,Adam Raska,R,MIN,23,0,0,0,0
25,8475780,Chris Wagner,R,COL,33,0,0,0,0
25,8479533,Joona Koppanen,L,PIT,26,0,0,0,0
25,8481534,Raphael Lavoie,C,EDM,24,0,0,0,0
25,8484321,Nikolas Matinpalo,D,OTT,26,0,0,0,0
25,8481043,Cole Koepke,L,TBL,26,0,0,0,0
25,8476323,Max McCormick,L,SEA,32,0,0,0,0
25,8483609,Adam Klapka,R,CGY,24,0,0,0,0
25,8483512,Matt Savoie,C,BUF,20,0,0,0,0
25,8484259,Ondrej Pavel,C,COL,31,0,0,0,0
25,8478147,Bokondji Imama,L,OTT,28,0,0,0,0
25,8482460,Matt Rempe,C,NYR,22,0,0,0,0
25,8477073,Kurtis MacDermid,L,NJD,30,0,0,0,0
25,8480274,Philip Kemp,D,EDM,25,0,0,0,0
25,8478956,Samuel Laberge,L,NJD,27,0,0,0,0
25,8483045,Cameron Butler,R,CBJ,31,0,0,0,0
26,8476453,Nikita Kucherov,R,TBL,31,82,43,78,121
26,8478402,Connor McDavid,C,EDM,27,82,36,80,116
26,8481559,Jack Hughes,C,NJD,23,82,41,71,112
26,8477492,Nathan MacKinnon,C,COL,29,82,43,57,100
26,8480069,Cale Makar,D,COL,26,82,25,71,96
26,8477939,William Nylander,R,TOR,28,82,42,53,95
26,8478550,Artemi Panarin,L,NYR,33,82,35,58,93
26,8477493,Aleksander Barkov,C,FLA,29,82,32,61,93
26,8476887,Filip Forsberg,L,NSH,30,82,50,41,91
26,8479314,Matthew Tkachuk,L,FLA,27,82,36,55,91
26,8477956,David Pastrnak,R,BOS,28,82,44,45,89
26,8479318,Auston Matthews,C,TOR,27,82,42,46,88
26,8480027,Jason Robertson,L,DAL,25,82,27,61,88
26,8478493,Joel Eriksson Ek,C,MIN,27,82,40,47,87
26,8480801,Brady Tkachuk,L,OTT,25,82,42,42,84
26,8478010,Brayden Point,C,TBL,28,82,42,42,84
26,8478427,Sebastian Aho,C,CAR,27,82,37,47,84
26,8477942,Kevin Fiala,L,LAK,28,82,35,49,84
26,8477934,Leon Draisaitl,C,EDM,29,82,35,48,83
26,8474564,Steven Stamkos,C,TBL,34,82,37,45,82
26,8471215,Evgeni Malkin,C,PIT,38,82,37,45,82
26,8478864,Kirill Kaprizov,L,MIN,27,82,35,47,82
26,8482116,Tim Stützle,C,OTT,22,82,28,54,82
26,8480012,Elias Pettersson,C,VAN,26,82,26,56,82
26,8474141,Patrick Kane,R,DET,36,82,32,49,81
26,8480023,Robert Thomas,C,STL,25,82,31,50,81
26,8478439,Travis Konecny,R,PHI,27,82,33,47,80
26,8471675,Sidney Crosby,C,PIT,37,82,31,49,80
26,8475172,Nazem Kadri,C,CGY,34,82,23,57,80
26,8476468,J.T. Miller,C,VAN,31,82,37,42,79
26,8475786,Zach Hyman,L,EDM,32,82,44,34,78
26,8477404,Jake Guentzel,C,CAR,30,82,37,40,77
26,8478398,Kyle Connor,L,WPG,28,82,36,41,77
26,8480800,Quinn Hughes,D,VAN,25,82,14,63,77
26,8470794,Joe Pavelski,C,DAL,40,82,29,47,76
26,8473419,Brad Marchand,L,BOS,36,82,25,51,76
26,8477933,Sam Reinhart,C,FLA,29,82,33,42,75
26,8479323,Adam Fox,D,NYR,26,82,18,57,75
26,8478420,Mikko Rantanen,R,COL,28,82,35,39,74
26,8475692,Mats Zuccarello,R,MIN,37,82,11,63,74
26,8475754,Brock Nelson,C,NYI,33,82,38,35,73
26,8478403,Jack Eichel,C,VGK,28,82,33,40,73
26,8475167,Victor Hedman,D,TBL,34,82,17,56,73
26,8475166,John Tavares,C,TOR,34,82,35,36,71
26,8477402,Pavel Buchnevich,L,STL,29,82,34,37,71
26,8471685,Anze Kopitar,C,LAK,37,82,28,43,71
26,8479542,Brandon Hagel,L,TBL,26,82,26,45,71
26,8476454,Ryan Nugent-Hopkins,C,EDM,31,82,20,51,71
26,8476459,Mika Zibanejad,C,NYR,31,82,17,54,71
26,8478449,Roope Hintz,C,DAL,28,82,37,33,70
26,8482078,Lucas Raymond,L,DET,22,82,30,40,70
26,8480002,Nico Hischier,C,NJD,25,82,26,44,70
26,8478414,Timo Meier,R,NJD,28,82,37,32,69
26,8474600,Roman Josi,D,NSH,34,82,12,57,69
26,8476881,Tomas Hertl,C,VGK,31,82,30,38,68
26,8475158,Ryan O'Reilly,C,NSH,33,82,29,39,68
26,8477496,Elias Lindholm,C,VAN,30,82,25,43,68
26,8477951,Nick Schmaltz,C,ARI,28,82,22,46,68
26,8477501,Valeri Nichushkin,R,COL,29,82,37,30,67
26,8476389,Vincent Trocheck,C,NYR,31,82,30,37,67
26,8476346,Johnny Gaudreau,L,CBJ,31,82,17,50,67
26,8481523,Kirby Dach,C,MTL,23,82,14,53,67
26,8475810,Bryan Rust,R,PIT,32,82,34,32,66
26,8477409,Carter Verhaeghe,C,FLA,29,82,32,34,66
26,8479343,Clayton Keller,R,ARI,26,82,36,29,65
26,8475765,Vladimir Tarasenko,R,FLA,33,82,29,36,65
26,8476460,Mark Scheifele,C,WPG,31,82,27,38,65
26,8480839,Rasmus Dahlin,D,BUF,24,82,15,50,65
26,8479675,Trevor Moore,L,LAK,29,82,32,32,64
26,8477504,Josh Morrissey,D,WPG,29,82,11,53,64
26,8475184,Chris Kreider,L,NYR,33,82,42,21,63
26,8479420,Tage Thompson,C,BUF,27,82,31,32,63
26,8478873,Troy Terry,R,ANA,27,82,30,33,63
26,8477960,Adrian Kempe,R,LAK,28,82,28,35,63
26,8477946,Dylan Larkin,C,DET,28,82,26,37,63
26,8478445,Mathew Barzal,C,NYI,27,82,16,47,63
26,8475168,Matt Duchene,C,DAL,33,82,28,34,62
26,8481557,Matt Boldy,L,MIN,23,82,27,35,62
26,8476462,Dougie Hamilton,D,NJD,31,82,20,41,61
26,8478366,Frank Vatrano,R,ANA,30,82,19,42,61
26,8480036,Miro Heiskanen,D,DAL,25,82,11,50,61
26,8476539,Jonathan Marchessault,R,VGK,34,82,31,29,60
26,8479337,Alex DeBrincat,R,DET,27,82,28,32,60
26,8471214,Alex Ovechkin,L,WSH,39,82,27,33,60
26,8477407,Anthony Duclair,L,TBL,29,82,36,23,59
26,8477500,Bo Horvat,C,NYI,29,82,31,28,59
26,8478444,Brock Boeser,R,VAN,27,82,29,30,59
26,8478856,Conor Garland,R,VAN,28,82,29,30,59
26,8477949,Alex Tuch,R,BUF,28,82,22,37,59
26,8482745,Mason McTavish,C,ANA,21,82,20,39,59
26,8479407,Jesper Bratt,L,NJD,26,82,19,40,59
26,8479325,Charlie McAvoy,D,BOS,27,82,15,44,59
26,8474157,Max Pacioretty,L,WSH,36,82,27,31,58
26,8479385,Jordan Kyrou,C,STL,26,82,23,35,58
26,8480208,Drake Batherson,R,OTT,26,82,22,36,58
26,8481533,Trevor Zegras,C,ANA,23,82,22,36,58
26,8480014,Gabriel Vilardi,C,WPG,25,82,29,28,57
26,8474679,Gustav Nyquist,C,NSH,35,82,18,39,57
26,8477955,Jared McCann,L,SEA,28,82,25,31,56
26,8477497,Sean Monahan,C,WPG,30,82,23,33,56
26,8480018,Nick Suzuki,C,MTL,25,82,20,36,56
26,8482097,Jack Quinn,R,BUF,23,82,20,36,56
26,8482109,Alexis Lafrenière,L,NYR,23,82,28,27,55
26,8483808,Andrei Kuzmenko,L,CGY,28,82,23,32,55
26,8473512,Claude Giroux,R,OTT,36,82,21,34,55
26,8476456,Jonathan Huberdeau,C,CGY,31,82,13,42,55
26,8480865,Noah Dobson,D,NYI,24,82,12,43,55
26,8478047,Michael Bunting,L,PIT,29,82,24,30,54
26,8475913,Mark Stone,R,VGK,32,82,21,33,54
26,8481528,Dylan Cozens,C,BUF,23,82,20,34,54
26,8476479,Phillip Danault,C,LAK,31,82,20,34,54
26,8478407,Vince Dunn,D,SEA,28,82,14,40,54
26,8482159,Tyson Foerster,R,PHI,22,82,24,29,53
26,8477416,Oliver Bjorkstrand,R,SEA,29,82,20,33,53
26,8477444,Andre Burakovsky,L,SEA,29,82,18,35,53
26,8482684,Luke Hughes,D,NJD,21,82,11,42,53
26,8474590,John Carlson,D,WSH,34,82,9,44,53
26,8475799,Nino Niederreiter,R,WPG,32,82,28,24,52
26,8478498,Jake DeBrusk,L,BOS,28,82,20,32,52
26,8480185,Eetu Luostarinen,C,FLA,26,82,13,39,52
26,8475726,Tyler Toffoli,C,WPG,32,82,25,26,51
26,8480893,Kirill Marchenko,R,CBJ,24,82,25,26,51
26,8480830,Andrei Svechnikov,R,CAR,24,82,18,33,51
26,8474578,Erik Karlsson,D,PIT,34,82,13,38,51
26,8476853,Morgan Rielly,D,TOR,30,82,9,42,51
26,8479425,Filip Hronek,D,VAN,27,82,6,45,51
26,8480064,Josh Norris,C,OTT,25,82,26,24,50
26,8476483,Rickard Rakell,R,PIT,31,82,24,26,50
26,8474586,Jordan Eberle,R,SEA,34,82,24,26,50
26,8478440,Dylan Strome,C,WSH,27,82,20,30,50
26,8480039,Martin Necas,C,CAR,25,82,20,30,50
26,8479400,Pierre-Luc Dubois,L,LAK,26,82,19,31,50
26,8476882,Teuvo Teravainen,L,CAR,30,82,17,33,50
26,8475745,Charlie Coyle,C,BOS,32,82,17,33,50
26,8476905,Chandler Stephenson,C,VGK,30,82,16,34,50
26,8478460,Zach Werenski,D,CBJ,27,82,11,39,50
26,8477346,MacKenzie Weegar,D,CGY,30,82,11,39,50
26,8476432,Boone Jenner,C,CBJ,31,82,30,19,49
26,8477935,Sam Bennett,C,FLA,28,82,28,21,49
26,8476448,William Karlsson,C,VGK,31,82,17,32,49
26,8480078,Filip Chytil,C,NYR,25,82,15,34,49
26,8481542,Moritz Seider,D,DET,23,82,10,39,49
26,8481540,Cole Caufield,R,MTL,23,82,32,16,48
26,8477511,Anthony Mantha,R,VGK,30,82,21,27,48
26,8473986,Alex Killorn,L,ANA,35,82,20,28,48
26,8480434,Sean Durzi,D,ARI,26,82,12,36,48
26,8478397,Rasmus Andersson,D,CGY,28,82,12,36,48
26,8476826,Yanni Gourde,C,SEA,33,82,12,36,48
26,8478038,Devon Toews,D,COL,30,82,9,39,48
26,8480803,Evan Bouchard,D,EDM,25,82,7,41,48
26,8481068,Yegor Sharangovich,C,CGY,26,82,25,22,47
26,8480009,Eeli Tolvanen,R,SEA,25,82,24,23,47
26,8473994,Jamie Benn,L,DAL,35,82,23,24,47
26,8479339,Patrik Laine,L,CBJ,26,82,20,27,47
26,8475760,Nick Bjugstad,C,ARI,32,82,20,27,47
26,8478438,Tommy Novak,C,NSH,27,82,18,29,47
26,8475170,Brayden Schenn,C,STL,33,82,15,32,47
26,8482665,Matty Beniers,C,SEA,22,82,15,32,47
26,8481711,Matias Maccelli,L,ARI,24,82,15,32,47
26,8481699,Aku Raty,R,ARI,23,82,1,46,47
26,8483397,Marc McLaughlin,C,BOS,25,82,38,8,46
26,8482699,Dylan Guenther,R,ARI,21,82,24,22,46
26,8481596,Shane Pinto,C,OTT,24,82,22,24,46
26,8477479,Tyler Bertuzzi,L,TOR,29,82,20,26,46
26,8478542,Evan Rodrigues,C,FLA,31,82,16,30,46
26,8475149,Marcus Johansson,L,MIN,34,82,16,30,46
26,8477447,Shea Theodore,D,VGK,29,82,9,37,46
26,8480031,Maxime Comtois,L,CAR,25,82,8,38,46
26,8474641,Adam Henrique,C,EDM,34,82,26,19,45
26,8480797,Joel Farabee,L,PHI,24,82,22,23,45
26,8476880,Tom Wilson,R,WSH,30,82,21,24,45
26,8475794,Tyler Seguin,C,DAL,32,82,20,25,45
26,8474150,Mikael Backlund,C,CGY,35,82,19,26,45
26,8480015,Owen Tippett,R,PHI,25,82,18,27,45
26,8477021,Alex Kerfoot,C,ARI,30,82,17,28,45
26,8482124,Quinton Byfield,R,LAK,22,82,15,30,45
26,8478975,Mason Marchment,L,DAL,29,82,15,30,45
26,8477940,Nikolaj Ehlers,L,WPG,28,82,14,31,45
26,8480802,Ryan McLeod,C,EDM,25,82,13,32,45
26,8482089,Jake Neighbours,L,STL,22,82,30,14,44
26,8476906,Shayne Gostisbehere,D,DET,31,82,14,30,44
26,8482105,Jake Sanderson,D,OTT,22,82,13,31,44
26,8479365,Trent Frederic,C,BOS,26,82,12,32,44
26,8478472,Mathieu Joseph,R,OTT,27,82,12,32,44
26,8477503,Max Domi,C,TOR,29,82,10,34,44
26,8475169,Evander Kane,L,EDM,33,82,28,15,43
26,8477476,Artturi Lehkonen,L,COL,29,82,24,19,43
26,8482110,Dawson Mercer,C,NJD,23,82,22,21,43
26,8478233,Andrew Mangiapane,L,CGY,28,82,21,22,43
26,8480188,Fabian Zetterlund,L,SJS,25,82,20,23,43
26,8477451,Ryan Hartman,R,MIN,30,82,19,24,43
26,8478466,Daniel Sprong,R,DET,27,82,18,25,43
26,8475768,Jaden Schwartz,C,SEA,32,82,17,26,43
26,8476292,Ondrej Palat,L,NJD,33,82,15,28,43
26,8477495,Seth Jones,D,CHI,30,82,10,33,43
26,8475197,Tyson Barrie,D,NSH,33,82,9,34,43
26,8481186,Logan O'Connor,R,COL,28,82,23,19,42
26,8475784,Jeff Skinner,C,BUF,32,82,18,24,42
26,8474037,James van Riemsdyk,L,BOS,35,82,18,24,42
26,8478519,Anthony Cirelli,C,TBL,27,82,17,25,42
26,8474102,David Perron,L,DET,36,82,15,27,42
26,8475798,Mikael Granlund,C,SJS,32,82,14,28,42
26,8477932,Aaron Ekblad,D,FLA,28,82,13,29,42
26,8482720,Matthew Knies,L,TOR,22,82,13,29,42
26,8481581,Thomas Harley,D,DAL,23,82,10,32,42
26,8483445,Cutter Gauthier,L,ANA,20,82,10,32,42
26,8479410,Mikhail Sergachev,D,TBL,26,82,6,36,42
26,8481624,Ilya Mikheyev,R,VAN,30,82,25,16,41
26,8484144,Connor Bedard,C,CHI,19,82,23,18,41
26,8475722,Jason Zucker,L,NSH,32,82,22,19,41
26,8482740,Wyatt Johnston,C,DAL,21,82,21,20,41
26,8475744,Evgeny Kuznetsov,C,CAR,32,82,17,24,41
26,8477986,Brandon Montour,D,FLA,30,82,17,24,41
26,8482667,William Eklund,L,SJS,22,82,16,25,41
26,8476461,Sean Couturier,C,PHI,32,82,16,25,41
26,8475287,Erik Haula,L,NJD,33,82,15,26,41
26,8477456,J.T. Compher,L,DET,29,82,14,27,41
26,8479345,Jakob Chychrun,D,OTT,26,82,13,28,41
26,8470613,Brent Burns,D,CAR,39,82,13,28,41
26,8478042,Viktor Arvidsson,R,LAK,31,82,9,32,41
26,8476792,Torey Krug,D,STL,33,82,8,33,41
26,8471698,T.J. Oshie,R,WSH,38,82,24,16,40
26,8475151,Kyle Palmieri,C,NYI,33,82,23,17,40
26,8482055,Drew O'Connor,L,PIT,26,82,19,21,40
26,8478046,Danton Heinen,L,BOS,29,82,19,21,40
26,8478474,Lawson Crouse,L,ARI,27,82,18,22,40
26,8482475,Yegor Chinakhov,R,CBJ,23,82,18,22,40
26,8475191,Reilly Smith,R,PIT,33,82,17,23,40
26,8478401,Pavel Zacha,C,BOS,27,82,15,25,40
26,8483515,Juraj Slafkovsky,L,MTL,20,82,15,25,40
26,8480220,Noah Cates,L,PHI,25,82,13,27,40
26,8475753,Justin Faulk,D,STL,32,82,9,31,40
26,8471724,Kris Letang,D,PIT,37,82,8,32,40
26,8479423,Alex Nylander,L,CBJ,26,82,20,19,39
26,8476925,Colton Sissons,C,NSH,31,82,16,23,39
26,8475791,Taylor Hall,L,CHI,33,82,14,25,39
26,8482222,Alexander Barabanov,L,SJS,30,82,11,28,39
26,8476979,Erik Gustafsson,D,NYR,32,82,6,33,39
26,8479941,Justin Danforth,R,CBJ,31,82,22,16,38
26,8477964,Ivan Barbashev,C,VGK,29,82,19,19,38
26,8475763,Kevin Hayes,R,STL,32,82,13,25,38
26,8478396,Noah Hanifin,D,VGK,27,82,9,29,38
26,8474565,Alex Pietrangelo,D,VGK,34,82,8,30,38
26,8479987,Morgan Geekie,C,BOS,26,82,7,31,38
26,8481703,Valtteri Puustinen,R,PIT,25,82,7,31,38
26,8476399,Blake Coleman,C,CGY,33,82,23,14,37
26,8477429,Andrew Copp,C,DET,30,82,16,21,37
26,8482175,JJ Peterka,R,BUF,22,82,16,21,37
26,8482146,Luke Evangelista,R,NSH,22,82,15,22,37
26,8477450,Jason Dickinson,C,CHI,29,82,15,22,37
26,8480028,Morgan Frost,C,PHI,25,82,14,23,37
26,8482133,Thomas Bordeleau,C,SJS,22,82,11,26,37
26,8478469,Thomas Chabot,D,OTT,27,82,11,26,37
26,8475793,Ryan Johansen,C,PHI,32,82,11,26,37
26,8482093,Seth Jarvis,C,CAR,22,82,20,16,36
26,8481535,Nils Hoglander,L,VAN,24,82,19,17,36
26,8478115,Pierre Engvall,L,NYI,28,82,19,17,36
26,8471218,Blake Wheeler,R,NYR,38,82,14,22,36
26,8479996,Cody Glass,C,NSH,25,82,12,24,36
26,8480113,Alex Iafallo,L,WPG,31,82,12,24,36
26,8481013,Jonatan Berggren,R,DET,24,82,11,25,36
26,8482087,Kaiden Guhle,D,MTL,22,82,9,27,36
26,8477948,Travis Sanheim,D,PHI,28,82,5,31,36
26,8475314,Anders Lee,L,NYI,34,82,22,13,35
26,8482101,Danil Gushchin,L,SJS,22,82,18,17,35
26,8476960,Andreas Athanasiou,C,CHI,30,82,17,18,35
26,8482113,Anton Lundell,C,FLA,23,82,11,24,35
26,8478462,Nicolas Roy,C,VGK,27,82,11,24,35
26,8483471,Brad Lambert,C,WPG,31,82,5,30,35
26,8475906,John Klingberg,D,TOR,32,82,5,30,35
26,8482142,Jamie Drysdale,D,PHI,22,82,5,30,35
26,8479999,Casey Mittelstadt,C,COL,26,82,3,32,35
26,8476438,Brandon Saad,L,STL,32,82,20,14,34
26,8480459,Pius Suter,C,VAN,28,82,15,19,34
26,8476872,Scott Laughton,C,PHI,30,82,15,19,34
26,8477426,Nicholas Paul,L,TBL,29,82,14,20,34
26,8479351,Sam Steel,C,DAL,26,82,12,22,34
26,8476869,Brady Skjei,D,CAR,30,82,8,26,34
26,8481016,Ruslan Iskhakov,C,NYI,24,82,1,33,34
26,8480849,Barrett Hayton,C,ARI,24,82,21,12,33
26,8476921,Jordan Martinook,L,CAR,32,82,13,20,33
26,8476392,Adam Lowry,C,WPG,31,82,13,20,33
26,8480798,Philipp Kurashev,C,CHI,25,82,12,21,33
26,8476463,Jonas Brodin,D,MIN,31,82,11,22,33
26,8477498,Darnell Nurse,D,EDM,29,82,9,24,33
26,8477494,Jonathan Drouin,L,COL,29,82,8,25,33
26,8474563,Drew Doughty,D,LAK,35,82,8,25,33
26,8476875,Mike Matheson,D,MTL,30,82,7,26,33
26,8474716,Jared Spurgeon,D,MIN,35,82,7,26,33
26,8483524,Shane Wright,C,SEA,20,82,23,9,32
26,8481554,Kaapo Kakko,R,NYR,23,82,23,9,32
26,8474053,Logan Couture,C,SJS,35,82,16,16,32
26,8478057,Dakota Joshua,C,VAN,28,82,15,17,32
26,8474870,Tyler Johnson,C,CHI,34,82,13,19,32
26,8476458,Ryan Strome,C,ANA,31,82,12,20,32
26,8476958,Jaccob Slavin,D,CAR,30,82,6,26,32
26,8479398,Samuel Girard,D,COL,26,82,6,26,32
26,8481560,Arthur Kaliyev,R,LAK,23,82,17,14,31
26,8477952,Robby Fabbri,C,DET,28,82,13,18,31
26,8478891,Mason Appleton,C,WPG,28,82,12,19,31
26,8479992,Michael Rasmussen,C,DET,25,82,12,19,31
26,8475714,Calle Jarnkrok,C,TOR,33,82,11,20,31
26,8482624,Daniil Miromanov,D,CGY,27,82,9,22,31
26,8476329,Travis Boyd,C,ARI,31,82,8,23,31
26,8474151,Ryan McDonagh,D,NSH,35,82,8,23,31
26,8473422,Nick Foligno,L,CHI,37,82,6,25,31
26,8480073,Erik Brannstrom,D,OTT,25,82,5,26,31
26,8475171,Oliver Ekman-Larsson,D,FLA,33,82,5,26,31
26,8480246,Nick Perbix,D,TBL,26,82,5,26,31
26,8480145,Neal Pionk,D,WPG,29,82,4,27,31
26,8478507,John Marino,D,NJD,27,82,4,27,31
26,8481604,Pavel Dorofeyev,L,VGK,24,82,17,13,30
26,8478020,Michael Amadio,C,VGK,28,82,15,15,30
26,8483431,Logan Cooley,C,ARI,20,82,14,16,30
26,8475343,Nic Dowd,C,WSH,34,82,12,18,30
26,8476927,Teddy Blueger,C,VAN,30,82,11,19,30
26,8479661,Tanner Jeannot,L,TBL,27,82,11,19,30
26,8483565,Nick Blankenburg,D,CBJ,26,82,8,22,30
26,8478055,Gustav Forsling,D,FLA,28,82,7,23,30
26,8482733,Logan Mailloux,D,MTL,31,82,1,29,30
26,8474884,Mike Hoffman,C,SJS,35,82,18,11,29
26,8483493,Frank Nazar,C,CHI,20,82,18,11,29
26,8481704,Juuso Parssinen,C,NSH,23,82,16,13,29
26,8484166,Adam Fantilli,C,CBJ,20,82,14,15,29
26,8477998,Warren Foegele,L,EDM,28,82,14,15,29
26,8479415,Michael McLeod,C,NJD,26,82,14,15,29
26,8477330,Dominik Kubalik,L,OTT,29,82,13,16,29
26,8473449,Kyle Okposo,R,FLA,36,82,13,16,29
26,8478458,Jack Roslovic,C,NYR,27,82,12,17,29
26,8474149,Evgenii Dadonov,R,DAL,35,82,7,22,29
26,8476892,Colton Parayko,D,STL,31,82,6,23,29
26,8476885,Jacob Trouba,D,NYR,30,82,5,24,29
26,8477969,Marcus Pettersson,D,PIT,28,82,4,25,29
26,8479525,Ross Colton,C,COL,28,82,14,14,28
26,8481517,Brett Leason,R,ANA,25,82,14,14,28
26,8479293,Brandon Tanev,L,SEA,33,82,13,15,28
26,8478109,Victor Olofsson,L,BUF,29,82,13,15,28
26,8476419,Jean-Gabriel Pageau,C,NYI,32,82,12,16,28
26,8475218,Mattias Ekholm,D,EDM,34,82,12,16,28
26,8481618,Alex Newhook,C,MTL,23,82,11,17,28
26,8482079,Marco Rossi,C,MIN,23,82,10,18,28
26,8481605,Jackson LaCombe,D,ANA,23,82,8,20,28
26,8478840,Will Borgen,D,SEA,28,82,6,22,28
26,8475764,Cam Fowler,D,ANA,33,82,5,23,28
26,8483457,Lane Hutson,D,MTL,20,82,1,27,28
26,8476469,Joel Armia,R,MTL,31,82,21,6,27
26,8479346,Dillon Dube,C,CGY,26,82,14,13,27
26,8476374,Sean Kuraly,C,CBJ,31,82,13,14,27
26,8477989,Christian Dvorak,C,MTL,28,82,11,16,27
26,8481656,Aliaksei Protas,C,WSH,23,82,9,18,27
26,8482092,Ridly Greig,C,OTT,22,82,7,20,27
26,8482730,Brandt Clarke,D,LAK,21,82,7,20,27
26,8482671,Owen Power,D,BUF,22,82,6,21,27
26,8482122,Brock Faber,D,MIN,22,82,4,23,27
26,8478500,Ivan Provorov,D,CBJ,27,82,3,24,27
26,8473533,Jordan Staal,C,CAR,36,82,13,13,26
26,8484153,Leo Carlsson,C,ANA,20,82,13,13,26
26,8479591,Michael Eyssimont,C,TBL,28,82,11,15,26
26,8480068,Ryan Poehling,C,PHI,25,82,10,16,26
26,8470621,Corey Perry,R,EDM,39,82,10,16,26
26,8476931,Jake McCabe,D,TOR,31,82,9,17,26
26,8478831,Kevin Stenlund,C,FLA,28,82,8,18,26
26,8482803,Olen Zellweger,D,ANA,21,82,8,18,26
26,8473563,Nicklas Backstrom,C,WSH,37,82,6,20,26
26,8479514,Rem Pitlick,C,CHI,27,82,6,20,26
26,8474673,TJ Brodie,D,TOR,34,82,5,21,26
26,8476457,Adam Larsson,D,SEA,32,82,5,21,26
26,8480796,Martin Fehervary,D,WSH,25,82,5,21,26
26,8480871,Adam Boqvist,D,CBJ,24,82,4,22,26
26,8482245,Artem Zub,D,OTT,29,82,4,22,26
26,8475200,Dmitry Orlov,D,CAR,33,82,3,23,26
26,8478178,Darren Raddysh,D,TBL,28,82,3,23,26
26,8483491,Ivan Miroshnichenko,L,WSH,20,82,15,10,25
26,8481553,Bobby Brink,R,PHI,23,82,15,10,25
26,8478508,Yakov Trenin,C,COL,27,82,13,12,25
26,8477353,Tyler Motte,C,TBL,29,82,12,13,25
26,8476873,Mark Jankowski,C,NSH,30,82,12,13,25
26,8476897,Oskar Sundqvist,C,STL,30,82,10,15,25
26,8475164,Jakob Silfverberg,R,ANA,34,82,10,15,25
26,8478463,Anthony Beauvillier,L,NSH,27,82,9,16,25
26,8477919,Frederick Gaudreau,C,MIN,31,82,9,16,25
26,8479316,Luke Kunin,C,SJS,27,82,9,16,25
26,8476854,Hampus Lindholm,D,BOS,30,82,7,18,25
26,8476467,Jamie Oleksiak,D,SEA,32,82,6,19,25
26,8480873,Rasmus Sandin,D,WSH,24,82,5,20,25
26,8476917,Adam Pelech,D,NYI,30,82,5,20,25
26,8477488,Brett Pesce,D,CAR,30,82,5,20,25
26,8476967,Brett Kulak,D,EDM,30,82,5,20,25
26,8476923,Damon Severson,D,CBJ,30,82,4,21,25
26,8475181,Nick Leddy,D,STL,33,82,4,21,25
26,8478443,Brandon Carlo,D,BOS,28,82,4,21,25
26,8479393,Noah Gregor,C,TOR,26,82,16,8,24
26,8483499,Liam Ohgren,L,MIN,20,82,13,11,24
26,8477425,Miles Wood,L,COL,29,82,12,12,24
26,8477839,Conor Sheary,L,TBL,32,82,8,16,24
26,8479359,Beck Malenstyn,L,WSH,26,82,6,18,24
26,8482705,Cole Sillinger,C,CBJ,21,82,5,19,24
26,8481014,Alexander Romanov,D,NYI,24,82,5,19,24
26,8480043,Timothy Liljegren,D,TOR,25,82,2,22,24
26,8481580,Connor McMichael,C,WSH,23,82,15,8,23
26,8484203,Bradly Nadeau,L,CAR,19,82,15,8,23
26,8470610,Zach Parise,L,COL,40,82,13,10,23
26,8480855,Jack McBain,C,ARI,24,82,13,10,23
26,8474189,Lars Eller,C,PIT,35,82,11,12,23
26,8480980,Connor Dewar,C,TOR,25,82,11,12,23
26,8476871,Tanner Pearson,L,MTL,32,82,11,12,23
26,8480144,David Kampf,C,TOR,29,82,11,12,23
26,8481546,Cam York,D,PHI,23,82,10,13,23
26,8476878,Zemgus Girgensons,L,BUF,30,82,10,13,23
26,8477508,Curtis Lazar,C,NJD,29,82,10,13,23
26,8478569,Noel Acciari,C,PIT,33,82,9,14,23
26,8483482,Tristan Luneau,D,ANA,20,82,9,14,23
26,8479353,Brett Howden,C,VGK,26,82,9,14,23
26,8482155,Alex Laferriere,R,LAK,23,82,9,14,23
26,8477953,Kasperi Kapanen,R,STL,28,82,8,15,23
26,8478882,Vladislav Gavrikov,D,LAK,29,82,7,16,23
26,8480336,Sean Walker,D,COL,30,82,7,16,23
26,8477506,Ryan Pulock,D,NYI,30,82,6,17,23
26,8479998,Mikey Anderson,D,LAK,25,82,6,17,23
26,8475179,Dmitry Kulikov,D,FLA,34,82,6,17,23
26,8482655,J.J. Moser,D,ARI,24,82,4,19,23
26,8479980,Nicolas Hague,D,VGK,26,82,4,19,23
26,8478451,Ethan Bear,D,WSH,27,82,3,20,23
26,8481568,Alex Vlasic,D,CHI,23,82,1,22,23
26,8482145,Mavrik Bourque,C,DAL,22,82,19,3,22
26,8475220,Marcus Foligno,L,MIN,33,82,13,9,22
26,8477944,Jakub Vrana,L,STL,28,82,12,10,22
26,8480074,Alexandre Texier,C,CBJ,25,82,10,12,22
26,8477947,Sonny Milano,L,WSH,28,82,10,12,22
26,8481537,Nikita Okhotiuk,D,CGY,24,82,8,14,22
26,8482074,Connor Zary,C,CGY,23,82,7,15,22
26,8478133,Jake Evans,C,MTL,28,82,6,16,22
26,8476525,Colin Miller,D,WPG,32,82,6,16,22
26,8480058,Pierre-Olivier Joseph,D,PIT,25,82,4,18,22
26,8481178,Egor Zamula,D,PHI,24,82,2,20,22
26,8475690,Chris Tanev,D,DAL,35,82,2,20,22
26,8482702,Logan Stankoven,C,DAL,21,82,11,10,21
26,8479390,Taylor Raddysh,R,CHI,26,82,11,10,21
26,8478413,Jordan Greenway,L,BUF,27,82,10,11,21
26,8479977,Kailer Yamamoto,R,SEA,26,82,8,13,21
26,8476480,Vladislav Namestnikov,C,WPG,32,82,7,14,21
26,8476902,Esa Lindell,D,DAL,30,82,4,17,21
26,8479369,Andrew Peeke,D,BOS,26,82,4,17,21
26,8478851,Alexandre Carrier,D,NSH,28,82,3,18,21
26,8480035,Henri Jokiharju,D,BUF,25,82,2,19,21
26,8475208,Brian Dumoulin,D,SEA,33,82,2,19,21
26,8476981,Josh Anderson,R,MTL,30,82,15,5,20
26,8476278,Colin Blackwell,C,CHI,31,82,15,5,20
26,8482809,Jackson Blake,R,CAR,21,82,14,6,20
26,8481093,Rafael Harvey-Pinard,L,MTL,25,82,12,8,20
26,8484145,Zach Benson,L,BUF,19,82,11,9,20
26,8478430,Oliver Kylington,D,CGY,27,82,9,11,20
26,8478136,Jake Middleton,D,MIN,28,82,8,12,20
26,8480813,Joe Veleno,C,DET,24,82,8,12,20
26,8479976,Juuso Valimaki,D,ARI,26,82,8,12,20
26,8480806,Isac Lundestrom,C,ANA,25,82,7,13,20
26,8483490,Pavel Mintyukov,D,ANA,21,82,5,15,20
26,8474013,Ian Cole,D,VAN,35,82,4,16,20
26,8475324,Nick Jensen,D,WSH,34,82,3,17,20
26,8482712,Oskar Olausson,R,COL,22,82,3,17,20
26,8474574,Tyler Myers,D,VAN,34,82,3,17,20
26,8475790,Erik Gudbranson,D,CBJ,32,82,3,17,20
26,8475279,Ben Chiarot,D,DET,33,82,2,18,20
26,8479324,Ryan Lindgren,D,NYR,26,82,2,18,20
26,8470600,Ryan Suter,D,DAL,39,82,1,19,20
26,8479383,Boris Katchouk,L,OTT,26,82,11,8,19
26,8476442,Matt Nieto,L,PIT,32,82,9,10,19
26,8482259,Bobby McMann,C,TOR,28,82,8,11,19
26,8476422,Mike Reilly,D,NYI,31,82,7,12,19
26,8483495,Simon Nemec,D,NJD,20,82,7,12,19
26,8482062,Cole Smith,L,NSH,29,82,7,12,19
26,8478043,Sam Lafferty,C,VAN,29,82,6,13,19
26,8476372,Nick Seeler,D,PHI,31,82,6,13,19
26,8480817,K'Andre Miller,D,NYR,24,82,5,14,19
26,8477220,Nate Schmidt,D,WPG,33,82,5,14,19
26,8481524,Bowen Byram,D,BUF,23,82,4,15,19
26,8478911,Matt Roy,D,LAK,29,82,4,15,19
26,8477845,Trevor van Riemsdyk,D,WSH,33,82,4,15,19
26,8480807,Mattias Samuelsson,D,BUF,24,82,3,16,19
26,8480821,Filip Zadina,R,SJS,25,82,11,7,18
26,8480281,Alexey Toropchenko,R,STL,25,82,11,7,18
26,8483012,Logan Morrison,C,SEA,22,82,11,7,18
26,8475848,Brendan Gallagher,R,MTL,32,82,8,10,18
26,8478013,Jake Walman,D,DET,28,82,8,10,18
26,8481477,Nico Sturm,C,SJS,29,82,8,10,18
26,8477507,Nikita Zadorov,D,VAN,29,82,7,11,18
26,8477505,Alexander Wennberg,C,NYR,30,82,7,11,18
26,8483505,Matthew Poitras,C,BOS,20,82,5,13,18
26,8478468,Jeremy Lauzon,D,NSH,27,82,5,13,18
26,8482117,Lukas Reichel,L,CHI,22,82,4,14,18
26,8480834,Ty Emberson,D,SJS,24,82,4,14,18
26,8479371,Dante Fabbro,D,NSH,26,82,4,14,18
26,8475462,Radko Gudas,D,ANA,34,82,4,14,18
26,8482858,Ryker Evans,D,SEA,23,82,2,16,18
26,8477435,Ryan Graves,D,PIT,29,82,1,17,18
26,8482125,Alexander Holtz,R,NJD,22,82,12,5,17
26,8481522,Peyton Krebs,C,BUF,23,82,11,6,17
26,8474034,Pat Maroon,L,BOS,36,82,8,9,17
26,8474715,Cam Atkinson,R,PHI,35,82,7,10,17
26,8477931,Tomas Nosek,L,NJD,32,82,7,10,17
26,8477369,Carson Soucy,D,VAN,30,82,5,12,17
26,8477392,Hudson Fasching,R,NYI,29,82,5,12,17
26,8476429,Scott Mayfield,D,NYI,32,82,5,12,17
26,8476891,Matt Grzelcyk,D,BOS,30,82,4,13,17
26,8475825,Jani Hakanpää,D,DAL,32,82,4,13,17
26,8474166,Alec Martinez,D,VGK,37,82,3,14,17
26,8471677,Jack Johnson,D,COL,37,82,3,14,17
26,8482118,Sam Colangelo,R,ANA,23,82,12,4,16
26,8480448,Parker Kelly,L,OTT,25,82,10,6,16
26,8482679,Matt Coronato,R,CGY,22,82,8,8,16
26,8475231,Casey Cizikas,C,NYI,33,82,7,9,16
26,8479291,Kevin Rooney,C,CGY,31,82,7,9,16
26,8476624,Barclay Goodrow,C,NYR,31,82,7,9,16
26,8481601,Simon Holmstrom,R,NYI,23,82,6,10,16
26,8482073,Braden Schneider,D,NYR,23,82,5,11,16
26,8470966,Mark Giordano,D,TOR,41,82,4,12,16
26,8475233,David Savard,D,MTL,34,82,4,12,16
26,8482807,Ethan Del Mastro,D,CHI,21,82,4,12,16
26,8476879,Cody Ceci,D,EDM,31,82,3,13,16
26,8483466,Kevin Korchinski,D,CHI,20,82,3,13,16
26,8477365,Connor Clifton,D,BUF,29,82,2,14,16
26,8475188,Brayden McNabb,D,VGK,33,82,1,15,16
26,8475762,Derek Forbort,D,BOS,32,82,1,15,16
26,8470604,Jeff Carter,C,PIT,39,82,11,4,15
26,8475842,Sam Carrick,C,EDM,32,82,8,7,15
26,8481481,Blake Lizotte,C,LAK,27,82,7,8,15
26,8482111,Justin Barron,D,MTL,23,82,7,8,15
26,8482762,Simon Edvinsson,D,DET,21,82,5,10,15
26,8477015,Connor Brown,R,EDM,30,82,5,10,15
26,8476473,Connor Murphy,D,CHI,31,82,5,10,15
26,8481567,Henry Thrun,D,SJS,23,82,4,11,15
26,8479442,Troy Stecher,D,EDM,30,82,4,11,15
26,8484911,Collin Graf,R,SJS,22,82,3,12,15
26,8478859,Niko Mikkola,D,FLA,28,82,3,12,15
26,8482470,Ilya Solovyov,D,CGY,24,82,1,14,15
26,8473507,Jeff Petry,D,DET,37,82,3,11,14
26,8473504,Cal Clutterbuck,R,NYI,37,82,3,11,14
26,8475455,Brenden Dillon,D,WPG,34,82,3,11,14
26,8474567,Zach Bogosian,D,MIN,34,82,3,11,14
26,8480172,Jan Rutta,D,SJS,34,82,2,12,14
26,8481606,Jordan Spence,D,LAK,23,82,1,13,14
26,8476331,Dylan DeMelo,D,WPG,31,82,0,14,14
26,8474009,Nick Bonino,C,NYR,36,82,7,6,13
26,8482737,Zack Bolduc,C,STL,21,82,5,8,13
26,8477406,Mattias Janmark,C,EDM,32,82,5,8,13
26,8476312,Josh Manson,D,COL,33,82,4,9,13
26,8480879,Jacob Bernard-Docker,D,OTT,24,82,3,10,13
26,8478399,Jonas Siegenthaler,D,NJD,27,82,2,11,13
26,8481059,Scott Perunovich,D,STL,26,82,1,12,13
26,8482177,Marat Khusnutdinov,C,MIN,22,82,1,12,13
26,8473453,Trevor Lewis,C,LAK,37,82,8,4,12
26,8483763,Maksymilian Szuber,D,ARI,22,82,4,8,12
26,8477499,Rasmus Ristolainen,D,PHI,30,82,3,9,12
26,8479983,Mario Ferraro,D,SJS,26,82,2,10,12
26,8480990,Declan Chisholm,D,MIN,24,82,5,6,11
26,8482666,Scott Morrow,D,CAR,22,82,4,7,11
26,8482516,Matthew Kessel,D,STL,24,82,1,10,11
26,8480860,Kevin Bahl,D,NJD,24,82,1,10,11
26,8478408,Travis Dermott,D,ARI,28,82,4,6,10
26,8475177,Calvin de Haan,D,TBL,33,82,4,6,10
26,8482166,Shakir Mukhamadullin,D,SJS,22,82,2,8,10
26,8477034,Jaycob Megna,D,CHI,32,82,2,8,10
26,8478416,Erik Cernak,D,TBL,27,82,1,9,10
26,8476822,Luke Glendening,C,TBL,35,82,8,1,9
26,8476858,Phillip Di Giuseppe,L,VAN,31,82,7,2,9
26,8476915,Jujhar Khaira,L,MIN,30,82,7,2,9
26,8483489,Fraser Minten,C,TOR,31,82,5,4,9
26,8481028,Martin Pospisil,C,CGY,25,82,3,5,8
26,8481578,Graeme Clarke,R,NJD,23,82,2,6,8
26,8483468,Jiri Kulich,C,BUF,20,82,2,6,8
26,8477335,Kyle Burroughs,D,SJS,29,82,1,7,8
26,8482859,Zack Ostapchuk,C,OTT,21,82,1,6,7
26,8484149,Gavin Brindley,C,CBJ,20,82,1,6,7
26,8481030,Jack St. Ivany,D,PIT,25,82,1,6,7
26,8482713,Mackie Samoskevich,R,FLA,22,82,3,3,6
26,8481599,Victor Soderstrom,D,ARI,23,82,1,4,5
26,8482141,Lukas Cormier,D,VGK,22,0,0,0,0
26,8476988,Matt Benning,D,SJS,30,0,0,0,0
26,8480727,Zach Whitecloud,D,VGK,28,0,0,0,0
26,8480887,Jordan Harris,D,MTL,24,0,0,0,0
26,8478450,Parker Wotherspoon,D,BOS,27,0,0,0,0
26,8481812,Nikolai Knyzhov,D,SJS,27,0,0,0,0
26,8480001,Urho Vaakanainen,D,ANA,25,0,0,0,0
26,8482176,Wyatt Kaiser,D,CHI,22,0,0,0,0
26,8481122,Simon Benoit,D,TOR,26,0,0,0,0
26,8476441,Joel Edmundson,D,TOR,31,0,0,0,0
26,8480884,Calen Addison,D,SJS,24,0,0,0,0
26,8482511,Mason Lohrei,D,BOS,23,0,0,0,0
26,8482192,Isaak Phillips,D,CHI,23,0,0,0,0
26,8480950,Ilya Lyubushkin,D,TOR,30,0,0,0,0
26,8474031,Kevin Shattenkirk,D,BOS,35,0,0,0,0
26,8475718,Justin Holl,D,DET,32,0,0,0,0
26,8479402,Jake Bean,D,CBJ,26,0,0,0,0
26,8474602,Justin Schultz,D,SEA,34,0,0,0,0
26,8477950,Tony DeAngelo,D,CAR,29,0,0,0,0
26,8481743,Marc Del Gaizo,D,NSH,25,0,0,0,0
26,8481527,Kaedan Korczak,D,VGK,23,0,0,0,0
26,8480192,Johnathan Kovacevic,D,MTL,27,0,0,0,0
26,8476874,Olli Maatta,D,DET,30,0,0,0,0
26,8482144,Jack Thompson,D,SJS,22,0,0,0,0
26,8480222,Sebastian Aho,D,NYI,28,0,0,0,0
26,8479458,Nikita Zaitsev,D,CHI,33,0,0,0,0
26,8471709,Marc-Edouard Vlasic,D,SJS,37,0,0,0,0
26,8482929,Emil Lilleberg,D,TBL,23,0,0,0,0
26,8477018,Ben Hutton,D,VGK,31,0,0,0,0
26,8481056,Spencer Stastney,D,NSH,24,0,0,0,0
26,8481593,Jayden Struble,D,MTL,23,0,0,0,0
26,8479982,Conor Timmins,D,TOR,26,0,0,0,0
26,8474090,Brendan Smith,D,NJD,35,0,0,0,0
26,8482964,Arber Xhekaj,D,MTL,23,0,0,0,0
26,8480891,Michael Kesselring,D,ARI,24,0,0,0,0
26,8477938,Haydn Fleury,D,TBL,28,0,0,0,0
26,8481806,Louis Crevier,D,CHI,23,0,0,0,0
26,8471274,Alex Goligoski,D,MIN,39,0,0,0,0
26,8481600,Tobias Bjornfot,D,FLA,23,0,0,0,0
26,8475797,Jarred Tinordi,D,CHI,32,0,0,0,0
26,8481521,Ronnie Attard,D,PHI,25,0,0,0,0
26,8474612,Travis Hamonic,D,OTT,34,0,0,0,0
26,8479576,Vincent Desharnais,D,EDM,28,0,0,0,0
26,8480049,Dylan Samberg,D,WPG,25,0,0,0,0
26,8483619,Filip Roos,D,CHI,25,0,0,0,0
26,8474568,Luke Schenn,D,NSH,35,0,0,0,0
26,8480184,Gustav Lindstrom,D,ANA,26,0,0,0,0
26,8480070,Ian Mitchell,D,BOS,25,0,0,0,0
26,8480196,Jacob Bryson,D,BUF,27,0,0,0,0
26,8471686,Marc Staal,D,PHI,37,0,0,0,0
26,8477467,Gustav Olofsson,D,SEA,30,0,0,0,0
26,8478970,Jalen Chatfield,D,CAR,28,0,0,0,0
26,8479348,Kale Clague,D,BUF,26,0,0,0,0
26,8473446,Erik Johnson,D,PHI,36,0,0,0,0
26,8477462,Robert Hagg,D,ANA,29,0,0,0,0
26,8478454,Noah Juulsen,D,VAN,27,0,0,0,0
26,8477384,Josh Brown,D,ARI,30,0,0,0,0
26,8481708,Zac Jones,D,NYR,24,0,0,0,0
26,8481167,Brayden Pachal,D,CGY,25,0,0,0,0
26,8482067,Connor Mackey,D,NYR,28,0,0,0,0
26,8483460,David Jiricek,D,CBJ,21,0,0,0,0
26,8481701,Santeri Hatakka,D,NJD,23,0,0,0,0
26,8478021,William Lagesson,D,ANA,28,0,0,0,0
26,8477851,Jordan Oesterle,D,CGY,32,0,0,0,0
26,8478452,Caleb Jones,D,COL,27,0,0,0,0
26,8479984,Cal Foote,D,NJD,26,0,0,0,0
26,8479639,Dylan Coghlan,D,CAR,26,0,0,0,0
26,8480874,Adam Ginning,D,PHI,24,0,0,0,0
26,8479321,Lucas Johansen,D,WSH,27,0,0,0,0
26,8480878,Nils Lundkvist,D,DAL,24,0,0,0,0
26,8482165,Yan Kuznetsov,D,CGY,22,0,0,0,0
26,8484258,Sam Malinski,D,COL,26,0,0,0,0
26,8480157,Calle Rosen,D,STL,30,0,0,0,0
26,8484304,Uvis Balinskis,D,FLA,28,0,0,0,0
26,8479985,Cale Fleury,D,SEA,26,0,0,0,0
26,8479378,Logan Stanley,D,WPG,26,0,0,0,0
26,8477541,Dakota Mermis,D,MIN,30,0,0,0,0
26,8481609,Vladislav Kolyachonok,D,ARI,23,0,0,0,0
26,8480823,Alexander Alexeyev,D,WSH,25,0,0,0,0
26,8481679,Maxence Guenette,D,OTT,23,0,0,0,0
26,8481564,Ryan Johnson,D,BUF,23,0,0,0,0
26,8479376,Victor Mete,D,PHI,26,0,0,0,0
26,8484254,Akito Hirose,D,VAN,25,0,0,0,0
26,8482660,Kent Johnson,C,CBJ,22,0,0,0,0
26,8482149,Cole Perfetti,C,WPG,22,0,0,0,0
26,8477987,Ryan Donato,C,CHI,28,0,0,0,0
26,8475755,Alexander Petrovic,D,DAL,32,0,0,0,0
26,8477810,Joel Hanley,D,CGY,33,0,0,0,0
26,8474145,Robert Bortuzzo,D,NYI,35,0,0,0,0
26,8481161,Jake Christiansen,D,CBJ,25,0,0,0,0
26,8476884,Derrick Pouliot,D,DAL,30,0,0,0,0
26,8481716,Dmitri Voronkov,L,CBJ,24,0,0,0,0
26,8480084,Nick DeSimone,D,NJD,30,0,0,0,0
26,8475750,Jon Merrill,D,MIN,32,0,0,0,0
26,8479315,Joey Anderson,R,CHI,26,0,0,0,0
26,8478011,Louie Belpedio,D,PHI,28,0,0,0,0
26,8482451,Mikael Pyyhtia,L,CBJ,23,0,0,0,0
26,8481541,Samuel Bolduc,D,NYI,24,0,0,0,0
26,8482126,Emil Andrae,D,PHI,31,0,0,0,0
26,8474618,Marco Scandella,D,STL,34,0,0,0,0
26,8477244,Chad Ruhwedel,D,NYR,34,0,0,0,0
26,8477971,Andreas Englund,D,LAK,28,0,0,0,0
26,8480829,Jesperi Kotkaniemi,C,CAR,24,0,0,0,0
26,8479372,Josh Mahura,D,FLA,26,0,0,0,0
26,8482095,Tyler Kleven,D,OTT,22,0,0,0,0
26,8481719,Maxwell Crozier,D,TBL,24,0,0,0,0
26,8475855,Jesper Fast,R,CAR,33,0,0,0,0
26,8480848,Ty Dellandrea,C,DAL,24,0,0,0,0
26,8475193,Tomas Tatar,L,SEA,34,0,0,0,0
26,8476889,Radek Faksa,C,DAL,30,0,0,0,0
26,8478495,Denis Gurianov,R,PHI,27,0,0,0,0
26,8480216,Jacob Peterson,C,SJS,25,0,0,0,0
26,8480252,Cole Guttman,C,CHI,25,0,0,0,0
26,8479026,Philippe Myers,D,TBL,27,0,0,0,0
26,8481006,Tyler Tucker,D,STL,24,0,0,0,0
26,8481032,Paul Cotter,C,VGK,25,0,0,0,0
26,8481577,Philip Tomasino,C,NSH,23,0,0,0,0
26,8476918,Jimmy Vesey,L,NYR,31,0,0,0,0
26,8479320,Max Lajoie,D,TOR,27,0,0,0,0
26,8478017,Mark Friedman,D,VAN,29,0,0,0,0
26,8481754,Nikita Nesterenko,C,ANA,23,0,0,0,0
26,8483407,Brandon Scanlin,D,NYR,25,0,0,0,0
26,8482659,Josh Doan,R,ARI,22,0,0,0,0
26,8477446,Michael McCarron,R,NSH,29,0,0,0,0
26,8477903,Garnet Hathaway,R,PHI,33,0,0,0,0
26,8482153,Brendan Brisson,C,VGK,23,0,0,0,0
26,8483546,Marshall Rifai,D,TOR,26,0,0,0,0
26,8484287,Cole McWard,D,VAN,23,0,0,0,0
26,8478854,Ryan Shea,D,PIT,27,0,0,0,0
26,8481585,Egor Afanasyev,L,NSH,23,0,0,0,0
26,8483398,Declan Carlile,D,TBL,31,0,0,0,0
26,8478502,Dennis Gilbert,D,CGY,28,0,0,0,0
26,8482749,Joshua Roy,R,MTL,21,0,0,0,0
26,8481598,Philip Broberg,D,EDM,23,0,0,0,0
26,8480835,Jack Drury,C,CAR,24,0,0,0,0
26,8480748,Kiefer Sherwood,L,NSH,29,0,0,0,0
26,8476934,Brock McGinn,L,ANA,30,0,0,0,0
26,8480870,Bo Groulx,C,ANA,24,0,0,0,0
26,8479368,Max Jones,L,ANA,26,0,0,0,0
26,8478099,Kevin Labanc,R,SJS,29,0,0,0,0
26,8478067,Oskar Lindblom,L,SJS,28,0,0,0,0
26,8476393,Nick Cousins,C,FLA,31,0,0,0,0
26,8483395,Arshdeep Bains,L,VAN,23,0,0,0,0
26,8480762,Eric Robinson,L,BUF,29,0,0,0,0
26,8479439,Jacob MacDonald,D,SJS,31,0,0,0,0
26,8476474,Stefan Noesen,R,CAR,31,0,0,0,0
26,8482787,Nikita Chibrikov,R,WPG,31,0,0,0,0
26,8478432,Christian Fischer,R,DET,27,0,0,0,0
26,8477979,Nicolas Aube-Kubel,R,WSH,28,0,0,0,0
26,8481789,Tye Kartye,L,SEA,23,0,0,0,0
26,8479330,Brandon Gignac,C,MTL,27,0,0,0,0
26,8480075,Cameron Crotty,D,ARI,25,0,0,0,0
26,8473473,Milan Lucic,L,BOS,36,0,0,0,0
26,8482094,Daemon Hunt,D,MIN,22,0,0,0,0
26,8481206,John Ludvig,D,PIT,24,0,0,0,0
26,8483630,Pavol Regenda,L,ANA,25,0,0,0,0
26,8481617,Vasily Podkolzin,R,VAN,23,0,0,0,0
26,8480306,Grant Hutton,D,NYI,29,0,0,0,0
26,8480995,Pontus Holmberg,R,TOR,25,0,0,0,0
26,8482148,Hendrix Lapierre,C,WSH,22,0,0,0,0
26,8477478,William Carrier,L,VGK,30,0,0,0,0
26,8480003,Jesper Boqvist,C,BOS,26,0,0,0,0
26,8482172,Landon Slaggert,L,CHI,22,0,0,0,0
26,8480789,Oliver Wahlstrom,R,NYI,24,0,0,0,0
26,8474062,Riley Nash,C,NYR,35,0,0,0,0
26,8480021,Jack Studnicka,C,SJS,25,0,0,0,0
26,8480025,MacKenzie Entwistle,R,CHI,25,0,0,0,0
26,8481582,Nicholas Robertson,L,TOR,23,0,0,0,0
26,8476867,Brendan Gaunce,C,CBJ,30,0,0,0,0
26,8479619,Michael Carcone,L,ARI,28,0,0,0,0
26,8479370,Tyson Jost,C,BUF,26,0,0,0,0
26,8479671,Mathieu Olivier,R,CBJ,27,0,0,0,0
26,8476994,Vinnie Hinostroza,C,PIT,30,0,0,0,0
26,8482070,Mitchell Chaffee,R,TBL,26,0,0,0,0
26,8477473,Justin Bailey,R,SJS,29,0,0,0,0
26,8479344,Jesse Puljujarvi,R,PIT,26,0,0,0,0
26,8480205,Emil Bemstrom,C,PIT,25,0,0,0,0
26,8479718,Alex Barré-Boulet,C,TBL,27,0,0,0,0
26,8482061,Brandon Biro,L,BUF,26,0,0,0,0
26,8479638,Justin Brazeau,R,BOS,26,0,0,0,0
26,8474040,Sam Gagner,C,EDM,35,0,0,0,0
26,8477846,Ryan Carpenter,C,SJS,33,0,0,0,0
26,8482077,Dylan Holloway,L,EDM,23,0,0,0,0
26,8482157,Will Cuylle,L,NYR,22,0,0,0,0
26,8480007,Jonas Rondbjerg,R,VGK,25,0,0,0,0
26,8478874,Adam Gaudette,C,STL,28,0,0,0,0
26,8478434,Keegan Kolesar,R,VGK,27,0,0,0,0
26,8480441,Trey Fix-Wolansky,R,CBJ,25,0,0,0,0
26,8479994,Jaret Anderson-Dolan,C,NSH,25,0,0,0,0
26,8483567,Georgii Merkulov,C,BOS,24,0,0,0,0
26,8477380,Jonny Brodzinski,C,NYR,31,0,0,0,0
26,8482201,Gage Goncalves,C,TBL,23,0,0,0,0
26,8478211,Dryden Hunt,L,CGY,29,0,0,0,0
26,8471699,Andrew Cogliano,C,COL,37,0,0,0,0
26,8479421,Jacob Moverare,D,LAK,26,0,0,0,0
26,8478881,Brett Seney,L,CHI,28,0,0,0,0
26,8477464,Nic Petan,C,MIN,29,0,0,0,0
26,8475958,Michael Sgarbossa,C,WSH,32,0,0,0,0
26,8481147,Reese Johnson,C,CHI,26,0,0,0,0
26,8479336,Carl Grundstrom,R,LAK,27,0,0,0,0
26,8480853,Liam Foudy,C,NSH,24,0,0,0,0
26,8479522,Hardy Haman Aktell,D,WSH,26,0,0,0,0
26,8481462,Mason Morelli,L,VGK,28,0,0,0,0
26,8482102,Vasily Ponomarev,C,CAR,22,0,0,0,0
26,8480844,Grigori Denisenko,L,VGK,24,0,0,0,0
26,8479944,Zach Aston-Reese,C,DET,30,0,0,0,0
26,8482784,Zach Dean,C,STL,21,0,0,0,0
26,8479419,Brett Murray,L,BUF,26,0,0,0,0
26,8479520,Brandon Duhaime,R,COL,27,0,0,0,0
26,8477573,Nathan Walker,L,STL,30,0,0,0,0
26,8478078,Rourke Chartier,C,OTT,28,0,0,0,0
26,8475795,Dylan McIlrath,D,WSH,32,0,0,0,0
26,8482496,Nils Aman,C,VAN,24,0,0,0,0
26,8480289,Morgan Barron,C,WPG,26,0,0,0,0
26,8481751,Lukas Rousek,R,BUF,25,0,0,0,0
26,8480011,Klim Kostin,C,SJS,25,0,0,0,0
26,8481556,John Beecher,C,BOS,23,0,0,0,0
26,8475278,Byron Froese,C,VGK,33,0,0,0,0
26,8475225,Craig Smith,C,DAL,35,0,0,0,0
26,8484326,Patrik Koch,D,ARI,28,0,0,0,0
26,8477930,Pierre-Edouard Bellemare,L,SEA,39,0,0,0,0
26,8478409,Anthony Richard,C,BOS,28,0,0,0,0
26,8481024,Linus Karlsson,C,VAN,25,0,0,0,0
26,8479986,Kole Lind,R,SEA,26,0,0,0,0
26,8479414,Nathan Bastian,R,NJD,27,0,0,0,0
26,8479362,Riley Tufte,L,COL,26,0,0,0,0
26,8481058,Jesse Ylönen,R,MTL,25,0,0,0,0
26,8482476,Emil Heineman,L,MTL,23,0,0,0,0
26,8482861,Vincent Iorio,D,WSH,22,0,0,0,0
26,8483432,Luca Del Bel Belluz,C,CBJ,31,0,0,0,0
26,8482744,James Malatesta,L,CBJ,21,0,0,0,0
26,8477887,Patrick Brown,C,BOS,32,0,0,0,0
26,8478585,Derek Ryan,C,EDM,38,0,0,0,0
26,8481441,Joe Snively,C,WSH,28,0,0,0,0
26,8481592,Jakob Pelletier,L,CGY,23,0,0,0,0
26,8482634,Alex Steeves,C,TOR,25,0,0,0,0
26,8477126,Jayson Megna,C,BOS,34,0,0,0,0
26,8475752,Tyler Pitlick,C,NYR,33,0,0,0,0
26,8480008,Adam Ruzicka,C,ARI,25,0,0,0,0
26,8481065,Angus Crookshank,L,OTT,25,0,0,0,0
26,8479547,Matthew Phillips,R,WSH,26,0,0,0,0
26,8480226,Marián Studenic,R,SEA,26,0,0,0,0
26,8481237,Kyle MacLean,C,NYI,25,0,0,0,0
26,8475413,Justin Dowling,C,NJD,34,0,0,0,0
26,8481641,Joel Kiviranta,L,COL,28,0,0,0,0
26,8478104,Sammy Blais,L,STL,28,0,0,0,0
26,8477454,Adam Erne,L,EDM,29,0,0,0,0
26,8481518,Nolan Foote,L,NJD,24,0,0,0,0
26,8480245,Olle Lycksell,R,PHI,25,0,0,0,0
26,8483570,Ben Meyers,C,ANA,26,0,0,0,0
26,8480776,Sheldon Rempal,R,VGK,29,0,0,0,0
26,8483920,Pierrick Dube,R,WSH,23,0,0,0,0
26,8480267,Sammy Walker,C,MIN,25,0,0,0,0
26,8482747,Brennan Othmann,L,NYR,21,0,0,0,0
26,8479991,Jake Leschyshyn,C,NYR,25,0,0,0,0
26,8478400,Colin White,C,MTL,27,0,0,0,0
26,8479328,Julien Gauthier,R,NYI,27,0,0,0,0
26,8484325,Waltteri Merela,C,TBL,26,0,0,0,0
26,8479066,Ryan Lomberg,L,FLA,30,0,0,0,0
26,8477070,Liam O'Brien,C,ARI,30,0,0,0,0
26,8478146,Matthew Highmore,C,OTT,28,0,0,0,0
26,8478028,Fredrik Olofsson,L,COL,28,0,0,0,0
26,8480880,Jakub Lauko,C,BOS,24,0,0,0,0
26,8479968,Vinni Lettieri,C,MIN,29,0,0,0,0
26,8474709,Matt Martin,L,NYI,35,0,0,0,0
26,8480845,Rasmus Kupari,C,WPG,24,0,0,0,0
26,8481550,Adam Beckman,L,MIN,23,0,0,0,0
26,8481422,Jacob Lucchini,C,MIN,29,0,0,0,0
26,8477401,John Hayden,C,SEA,29,0,0,0,0
26,8478904,Steven Lorentz,C,FLA,28,0,0,0,0
26,8482088,Justin Sourdif,R,FLA,22,0,0,0,0
26,8482751,Ryan Winterton,C,SEA,21,0,0,0,0
26,8482241,Radim Zohorna,L,PIT,28,0,0,0,0
26,8481690,Tyler Angle,C,CBJ,24,0,0,0,0
26,8476952,Dominic Toninato,C,WPG,30,0,0,0,0
26,8476919,Chris Tierney,C,NJD,30,0,0,0,0
26,8480032,Shane Bowers,C,NJD,25,0,0,0,0
26,8484314,Jiri Smejkal,L,OTT,28,0,0,0,0
26,8481239,Samuel Fagemo,L,LAK,24,0,0,0,0
26,8481532,Alex Turcotte,C,LAK,23,0,0,0,0
26,8481019,David Gustafsson,C,WPG,24,0,0,0,0
26,8478477,Mitchell Stephens,C,MTL,27,0,0,0,0
26,8479546,Oskar Steen,C,BOS,26,0,0,0,0
26,8480292,Carson Meyer,R,CBJ,27,0,0,0,0
26,8478446,Glenn Gawdin,C,ANA,27,0,0,0,0
26,8483531,Brian Halonen,L,NJD,25,0,0,0,0
26,8477149,Scott Sabourin,R,SJS,32,0,0,0,0
26,8479972,Mason Shaw,C,MIN,26,0,0,0,0
26,8480890,Jan Jenik,R,ARI,24,0,0,0,0
26,8478051,Max Willman,C,NJD,29,0,0,0,0
26,8480851,Akil Thomas,C,LAK,24,0,0,0,0
26,8482765,Isak Rosen,R,BUF,21,0,0,0,0
26,8478421,A.J. Greer,L,CGY,28,0,0,0,0
26,8478512,Austin Czarnik,C,DET,32,0,0,0,0
26,8479536,Axel Jonsson-Fjallby,L,WPG,26,0,0,0,0
26,8477320,Anton Blidh,L,NYR,29,0,0,0,0
26,8481543,Nikita Alexandrov,C,STL,24,0,0,0,0
26,8475235,Nicolas Deslauriers,L,PHI,33,0,0,0,0
26,8481070,Hugh McGing,L,STL,26,0,0,0,0
26,8480836,Jonathan Gruden,C,PIT,24,0,0,0,0
26,8481591,Sam Poulin,R,PIT,23,0,0,0,0
26,8477962,Brendan Lemieux,L,CAR,28,0,0,0,0
26,8483401,Marc Johnstone,R,PIT,28,0,0,0,0
26,8482250,Callahan Burke,C,CAR,27,0,0,0,0
26,8481726,Adam Edstrom,C,NYR,24,0,0,0,0
26,8471817,Ryan Reaves,R,TOR,37,0,0,0,0
26,8479587,Rhett Gardner,C,PHI,28,0,0,0,0
26,8475766,Austin Watson,L,TBL,32,0,0,0,0
26,8479367,William Lockwood,R,FLA,26,0,0,0,0
26,8478424,Jansen Harkins,C,PIT,27,0,0,0,0
26,8476913,Devin Shore,C,SEA,30,0,0,0,0
26,8482652,Walker Duehr,R,CGY,27,0,0,0,0
26,8477527,Ross Johnston,L,ANA,30,0,0,0,0
26,8481077,John Leonard,L,ARI,26,0,0,0,0
26,8483549,Lucas Condotta,L,MTL,27,0,0,0,0
26,8480468,James Hamblin,L,EDM,25,0,0,0,0
26,8476907,Mackenzie MacEachern,L,STL,30,0,0,0,0
26,8479543,Michael Pezzetta,L,MTL,26,0,0,0,0
26,8480355,Mark Kastelic,C,OTT,25,0,0,0,0
26,8482162,Roby Jarventie,L,OTT,22,0,0,0,0
26,8479772,Zack MacEwen,R,OTT,28,0,0,0,0
26,8483597,Milos Kelemen,L,ARI,25,0,0,0,0
26,8479379,Givani Smith,R,SJS,26,0,0,0,0
26,8481655,Cole Schwindt,R,CGY,23,0,0,0,0
26,8479981,Jonah Gadjovich,L,FLA,26,0,0,0,0
26,8482147,Jean-Luc Foudy,C,COL,22,0,0,0,0
26,8484255,Jason Polin,R,COL,25,0,0,0,0
26,8477993,Justin Kirkland,C,ARI,28,0,0,0,0
26,8479249,Andrew Poturalski,C,SEA,30,0,0,0,0
26,8482197,Adam Raska,R,MIN,23,0,0,0,0
26,8475780,Chris Wagner,R,COL,33,0,0,0,0
26,8479533,Joona Koppanen,L,PIT,26,0,0,0,0
26,8481534,Raphael Lavoie,C,EDM,24,0,0,0,0
26,8484321,Nikolas Matinpalo,D,OTT,26,0,0,0,0
26,8481043,Cole Koepke,L,TBL,26,0,0,0,0
26,8476323,Max McCormick,L,SEA,32,0,0,0,0
26,8483609,Adam Klapka,R,CGY,24,0,0,0,0
26,8483512,Matt Savoie,C,BUF,20,0,0,0,0
26,8484259,Ondrej Pavel,C,COL,31,0,0,0,0
26,8478147,Bokondji Imama,L,OTT,28,0,0,0,0
26,8482460,Matt Rempe,C,NYR,22,0,0,0,0
26,8477073,Kurtis MacDermid,L,NJD,30,0,0,0,0
26,8480274,Philip Kemp,D,EDM,25,0,0,0,0
26,8478956,Samuel Laberge,L,NJD,27,0,0,0,0
26,8483045,Cameron Butler,R,CBJ,31,0,0,0,0
27,8478402,Connor McDavid,C,EDM,27,82,41,80,121
27,8477934,Leon Draisaitl,C,EDM,29,82,44,72,116
27,8478550,Artemi Panarin,L,NYR,33,82,40,70,110
27,8481559,Jack Hughes,C,NJD,23,82,36,71,107
27,8476453,Nikita Kucherov,R,TBL,31,82,35,66,101
27,8480800,Quinn Hughes,D,VAN,25,82,16,82,98
27,8480027,Jason Robertson,L,DAL,25,82,44,52,96
27,8477956,David Pastrnak,R,BOS,28,82,42,54,96
27,8476887,Filip Forsberg,L,NSH,30,82,52,43,95
27,8477493,Aleksander Barkov,C,FLA,29,82,35,57,92
27,8471675,Sidney Crosby,C,PIT,37,82,35,57,92
27,8477942,Kevin Fiala,L,LAK,28,82,32,60,92
27,8479318,Auston Matthews,C,TOR,27,82,55,36,91
27,8476468,J.T. Miller,C,VAN,31,82,33,56,89
27,8476389,Vincent Trocheck,C,NYR,31,82,31,58,89
27,8477939,William Nylander,R,TOR,28,82,29,60,89
27,8477404,Jake Guentzel,C,CAR,30,82,33,55,88
27,8479314,Matthew Tkachuk,L,FLA,27,82,26,62,88
27,8477492,Nathan MacKinnon,C,COL,29,82,36,51,87
27,8476454,Ryan Nugent-Hopkins,C,EDM,31,82,25,61,86
27,8479343,Clayton Keller,R,ARI,26,82,34,49,83
27,8478864,Kirill Kaprizov,L,MIN,27,82,35,47,82
27,8482116,Tim Stützle,C,OTT,22,82,29,53,82
27,8476459,Mika Zibanejad,C,NYR,31,82,30,51,81
27,8478010,Brayden Point,C,TBL,28,82,43,37,80
27,8475166,John Tavares,C,TOR,34,82,40,38,78
27,8477946,Dylan Larkin,C,DET,28,82,35,43,78
27,8478420,Mikko Rantanen,R,COL,28,82,30,48,78
27,8475786,Zach Hyman,L,EDM,32,82,41,35,76
27,8481557,Matt Boldy,L,MIN,23,82,32,44,76
27,8475172,Nazem Kadri,C,CGY,34,82,35,40,75
27,8475913,Mark Stone,R,VGK,32,82,34,40,74
27,8477933,Sam Reinhart,C,FLA,29,82,36,37,73
27,8479407,Jesper Bratt,L,NJD,26,82,32,40,72
27,8480801,Brady Tkachuk,L,OTT,25,82,27,45,72
27,8474600,Roman Josi,D,NSH,34,82,16,56,72
27,8480803,Evan Bouchard,D,EDM,25,82,13,59,72
27,8481540,Cole Caufield,R,MTL,23,82,42,29,71
27,8476456,Jonathan Huberdeau,C,CGY,31,82,21,50,71
27,8478398,Kyle Connor,L,WPG,28,82,35,35,70
27,8477960,Adrian Kempe,R,LAK,28,82,30,40,70
27,8482665,Matty Beniers,C,SEA,22,82,25,45,70
27,8474141,Patrick Kane,R,DET,36,82,23,47,70
27,8480036,Miro Heiskanen,D,DAL,25,82,13,57,70
27,8477409,Carter Verhaeghe,C,FLA,29,82,41,28,69
27,8478440,Dylan Strome,C,WSH,27,82,28,41,69
27,8473994,Jamie Benn,L,DAL,35,82,25,44,69
27,8481523,Kirby Dach,C,MTL,23,82,14,55,69
27,8478403,Jack Eichel,C,VGK,28,82,33,35,68
27,8475810,Bryan Rust,R,PIT,32,82,29,39,68
27,8474578,Erik Karlsson,D,PIT,34,82,26,42,68
27,8480023,Robert Thomas,C,STL,25,82,23,45,68
27,8478449,Roope Hintz,C,DAL,28,82,26,41,67
27,8480839,Rasmus Dahlin,D,BUF,24,82,18,49,67
27,8480012,Elias Pettersson,C,VAN,26,82,27,39,66
27,8477951,Nick Schmaltz,C,ARI,28,82,21,45,66
27,8477949,Alex Tuch,R,BUF,28,82,20,46,66
27,8480069,Cale Makar,D,COL,26,82,16,50,66
27,8478414,Timo Meier,R,NJD,28,82,31,34,65
27,8476462,Dougie Hamilton,D,NJD,31,82,25,40,65
27,8478873,Troy Terry,R,ANA,27,82,20,45,65
27,8480865,Noah Dobson,D,NYI,24,82,16,49,65
27,8480002,Nico Hischier,C,NJD,25,82,26,38,64
27,8480830,Andrei Svechnikov,R,CAR,24,82,19,45,64
27,8473419,Brad Marchand,L,BOS,36,82,17,47,64
27,8479420,Tage Thompson,C,BUF,27,82,34,29,63
27,8478427,Sebastian Aho,C,CAR,27,82,29,34,63
27,8470794,Joe Pavelski,C,DAL,40,82,23,40,63
27,8475798,Mikael Granlund,C,SJS,32,82,19,44,63
27,8474564,Steven Stamkos,C,TBL,34,82,29,33,62
27,8475692,Mats Zuccarello,R,MIN,37,82,20,42,62
27,8474590,John Carlson,D,WSH,34,82,11,51,62
27,8479323,Adam Fox,D,NYR,26,82,9,53,62
27,8480064,Josh Norris,C,OTT,25,82,40,21,61
27,8475754,Brock Nelson,C,NYI,33,82,34,27,61
27,8481711,Matias Maccelli,L,ARI,24,82,27,34,61
27,8475158,Ryan O'Reilly,C,NSH,33,82,22,39,61
27,8476346,Johnny Gaudreau,L,CBJ,31,82,19,42,61
27,8477447,Shea Theodore,D,VGK,29,82,17,44,61
27,8480208,Drake Batherson,R,OTT,26,82,25,35,60
27,8476460,Mark Scheifele,C,WPG,31,82,20,40,60
27,8478396,Noah Hanifin,D,VGK,27,82,12,48,60
27,8475184,Chris Kreider,L,NYR,33,82,31,28,59
27,8478042,Viktor Arvidsson,R,LAK,31,82,24,35,59
27,8471214,Alex Ovechkin,L,WSH,39,82,30,28,58
27,8476539,Jonathan Marchessault,R,VGK,34,82,25,33,58
27,8479325,Charlie McAvoy,D,BOS,27,82,12,46,58
27,8476853,Morgan Rielly,D,TOR,30,82,7,51,58
27,8482093,Seth Jarvis,C,CAR,22,82,24,33,57
27,8475168,Matt Duchene,C,DAL,33,82,22,35,57
27,8479385,Jordan Kyrou,C,STL,26,82,24,32,56
27,8477402,Pavel Buchnevich,L,STL,29,82,28,27,55
27,8482740,Wyatt Johnston,C,DAL,21,82,28,27,55
27,8478439,Travis Konecny,R,PHI,27,82,23,32,55
27,8471685,Anze Kopitar,C,LAK,37,82,17,38,55
27,8477935,Sam Bennett,C,FLA,28,82,28,26,54
27,8477955,Jared McCann,L,SEA,28,82,26,28,54
27,8478438,Tommy Novak,C,NSH,27,82,24,30,54
27,8476448,William Karlsson,C,VGK,31,82,23,31,54
27,8478493,Joel Eriksson Ek,C,MIN,27,82,21,33,54
27,8478445,Mathew Barzal,C,NYI,27,82,12,42,54
27,8477476,Artturi Lehkonen,L,COL,29,82,27,26,53
27,8478975,Mason Marchment,L,DAL,29,82,21,32,53
27,8473512,Claude Giroux,R,OTT,36,82,18,35,53
27,8476905,Chandler Stephenson,C,VGK,30,82,18,35,53
27,8471215,Evgeni Malkin,C,PIT,38,82,17,36,53
27,8474102,David Perron,L,DET,36,82,17,36,53
27,8478366,Frank Vatrano,R,ANA,30,82,26,26,52
27,8475151,Kyle Palmieri,C,NYI,33,82,26,26,52
27,8473986,Alex Killorn,L,ANA,35,82,25,27,52
27,8476880,Tom Wilson,R,WSH,30,82,23,29,52
27,8479675,Trevor Moore,L,LAK,29,82,21,31,52
27,8476881,Tomas Hertl,C,VGK,31,82,18,34,52
27,8481596,Shane Pinto,C,OTT,24,82,18,34,52
27,8480031,Maxime Comtois,L,CAR,25,82,17,35,52
27,8483445,Cutter Gauthier,L,ANA,20,82,13,39,52
27,8482101,Danil Gushchin,L,SJS,22,82,30,21,51
27,8479542,Brandon Hagel,L,TBL,26,82,27,24,51
27,8475726,Tyler Toffoli,C,WPG,32,82,26,25,51
27,8480018,Nick Suzuki,C,MTL,25,82,21,30,51
27,8478401,Pavel Zacha,C,BOS,27,82,21,30,51
27,8479337,Alex DeBrincat,R,DET,27,82,20,31,51
27,8478460,Zach Werenski,D,CBJ,27,82,16,35,51
27,8478407,Vince Dunn,D,SEA,28,82,8,43,51
27,8482699,Dylan Guenther,R,ARI,21,82,27,23,50
27,8482159,Tyson Foerster,R,PHI,22,82,24,26,50
27,8477500,Bo Horvat,C,NYI,29,82,22,28,50
27,8474157,Max Pacioretty,L,WSH,36,82,20,30,50
27,8477940,Nikolaj Ehlers,L,WPG,28,82,19,31,50
27,8481528,Dylan Cozens,C,BUF,23,82,17,33,50
27,8477416,Oliver Bjorkstrand,R,SEA,29,82,16,34,50
27,8477346,MacKenzie Weegar,D,CGY,30,82,11,39,50
27,8478474,Lawson Crouse,L,ARI,27,82,27,22,49
27,8477501,Valeri Nichushkin,R,COL,29,82,26,23,49
27,8479400,Pierre-Luc Dubois,L,LAK,26,82,20,29,49
27,8482110,Dawson Mercer,C,NJD,23,82,15,34,49
27,8475745,Charlie Coyle,C,BOS,32,82,13,36,49
27,8480078,Filip Chytil,C,NYR,25,82,13,36,49
27,8480434,Sean Durzi,D,ARI,26,82,10,39,49
27,8477504,Josh Morrissey,D,WPG,29,82,9,40,49
27,8476432,Boone Jenner,C,CBJ,31,82,24,24,48
27,8481068,Yegor Sharangovich,C,CGY,26,82,24,24,48
27,8478498,Jake DeBrusk,L,BOS,28,82,23,25,48
27,8476399,Blake Coleman,C,CGY,33,82,23,25,48
27,8475765,Vladimir Tarasenko,R,FLA,33,82,22,26,48
27,8482124,Quinton Byfield,R,LAK,22,82,18,30,48
27,8478519,Anthony Cirelli,C,TBL,27,82,16,32,48
27,8475169,Evander Kane,L,EDM,33,82,29,18,47
27,8481624,Ilya Mikheyev,R,VAN,30,82,25,22,47
27,8475794,Tyler Seguin,C,DAL,32,82,24,23,47
27,8482078,Lucas Raymond,L,DET,22,82,22,25,47
27,8482745,Mason McTavish,C,ANA,21,82,22,25,47
27,8477497,Sean Monahan,C,WPG,30,82,20,27,47
27,8478472,Mathieu Joseph,R,OTT,27,82,16,31,47
27,8475744,Evgeny Kuznetsov,C,CAR,32,82,13,34,47
27,8475167,Victor Hedman,D,TBL,34,82,11,36,47
27,8474565,Alex Pietrangelo,D,VGK,34,82,11,36,47
27,8479999,Casey Mittelstadt,C,COL,26,82,11,36,47
27,8480014,Gabriel Vilardi,C,WPG,25,82,26,20,46
27,8474641,Adam Henrique,C,EDM,34,82,24,22,46
27,8478856,Conor Garland,R,VAN,28,82,23,23,46
27,8480893,Kirill Marchenko,R,CBJ,24,82,23,23,46
27,8477511,Anthony Mantha,R,VGK,30,82,16,30,46
27,8482109,Alexis Lafrenière,L,NYR,23,82,28,17,45
27,8477479,Tyler Bertuzzi,L,TOR,29,82,25,20,45
27,8471698,T.J. Oshie,R,WSH,38,82,25,20,45
27,8482175,JJ Peterka,R,BUF,22,82,23,22,45
27,8475768,Jaden Schwartz,C,SEA,32,82,22,23,45
27,8475784,Jeff Skinner,C,BUF,32,82,22,23,45
27,8478444,Brock Boeser,R,VAN,27,82,19,26,45
27,8478047,Michael Bunting,L,PIT,29,82,19,26,45
27,8482667,William Eklund,L,SJS,22,82,19,26,45
27,8478891,Mason Appleton,C,WPG,28,82,19,26,45
27,8474679,Gustav Nyquist,C,NSH,35,82,17,28,45
27,8479339,Patrik Laine,L,CBJ,26,82,16,29,45
27,8477986,Brandon Montour,D,FLA,30,82,13,32,45
27,8477503,Max Domi,C,TOR,29,82,10,35,45
27,8475753,Justin Faulk,D,STL,32,82,9,36,45
27,8483808,Andrei Kuzmenko,L,CGY,28,82,22,22,44
27,8477451,Ryan Hartman,R,MIN,30,82,20,24,44
27,8479992,Michael Rasmussen,C,DET,25,82,20,24,44
27,8482684,Luke Hughes,D,NJD,21,82,15,29,44
27,8476925,Colton Sissons,C,NSH,31,82,13,31,44
27,8481656,Aliaksei Protas,C,WSH,23,82,13,31,44
27,8474586,Jordan Eberle,R,SEA,34,82,12,32,44
27,8481016,Ruslan Iskhakov,C,NYI,24,82,5,39,44
27,8476483,Rickard Rakell,R,PIT,31,82,23,20,43
27,8477496,Elias Lindholm,C,VAN,30,82,17,26,43
27,8481533,Trevor Zegras,C,ANA,23,82,17,26,43
27,8477456,J.T. Compher,L,DET,29,82,16,27,43
27,8475191,Reilly Smith,R,PIT,33,82,16,27,43
27,8478462,Nicolas Roy,C,VGK,27,82,15,28,43
27,8478038,Devon Toews,D,COL,30,82,14,29,43
27,8480797,Joel Farabee,L,PHI,24,82,14,29,43
27,8478469,Thomas Chabot,D,OTT,27,82,10,33,43
27,8482097,Jack Quinn,R,BUF,23,82,18,24,42
27,8482113,Anton Lundell,C,FLA,23,82,16,26,42
27,8477932,Aaron Ekblad,D,FLA,28,82,10,32,42
27,8483457,Lane Hutson,D,MTL,20,82,9,33,42
27,8482222,Alexander Barabanov,L,SJS,30,82,19,22,41
27,8477426,Nicholas Paul,L,TBL,29,82,19,22,41
27,8477964,Ivan Barbashev,C,VGK,29,82,17,24,41
27,8474150,Mikael Backlund,C,CGY,35,82,15,26,41
27,8477444,Andre Burakovsky,L,SEA,29,82,14,27,41
27,8482624,Daniil Miromanov,D,CGY,27,82,12,29,41
27,8476875,Mike Matheson,D,MTL,30,82,10,31,41
27,8478397,Rasmus Andersson,D,CGY,28,82,9,32,41
27,8476458,Ryan Strome,C,ANA,31,82,18,22,40
27,8475170,Brayden Schenn,C,STL,33,82,17,23,40
27,8480028,Morgan Frost,C,PHI,25,82,17,23,40
27,8482146,Luke Evangelista,R,NSH,22,82,16,24,40
27,8480459,Pius Suter,C,VAN,28,82,15,25,40
27,8480039,Martin Necas,C,CAR,25,82,13,27,40
27,8482733,Logan Mailloux,D,MTL,31,82,6,34,40
27,8479525,Ross Colton,C,COL,28,82,25,14,39
27,8479423,Alex Nylander,L,CBJ,26,82,19,20,39
27,8480802,Ryan McLeod,C,EDM,25,82,15,24,39
27,8478233,Andrew Mangiapane,L,CGY,28,82,15,24,39
27,8479987,Morgan Geekie,C,BOS,26,82,15,24,39
27,8474053,Logan Couture,C,SJS,35,82,15,24,39
27,8470613,Brent Burns,D,CAR,39,82,13,26,39
27,8483471,Brad Lambert,C,WPG,31,82,9,30,39
27,8475906,John Klingberg,D,TOR,32,82,8,31,39
27,8481581,Thomas Harley,D,DAL,23,82,5,34,39
27,8477998,Warren Foegele,L,EDM,28,82,18,20,38
27,8479365,Trent Frederic,C,BOS,26,82,15,23,38
27,8483515,Juraj Slafkovsky,L,MTL,20,82,15,23,38
27,8479996,Cody Glass,C,NSH,25,82,15,23,38
27,8477498,Darnell Nurse,D,EDM,29,82,14,24,38
27,8476479,Phillip Danault,C,LAK,31,82,13,25,38
27,8478542,Evan Rodrigues,C,FLA,31,82,11,27,38
27,8477021,Alex Kerfoot,C,ARI,30,82,10,28,38
27,8476923,Damon Severson,D,CBJ,30,82,8,30,38
27,8475714,Calle Jarnkrok,C,TOR,33,82,27,10,37
27,8482055,Drew O'Connor,L,PIT,26,82,21,16,37
27,8475760,Nick Bjugstad,C,ARI,32,82,20,17,37
27,8478466,Daniel Sprong,R,DET,27,82,18,19,37
27,8475287,Erik Haula,L,NJD,33,82,17,20,37
27,8480015,Owen Tippett,R,PHI,25,82,16,21,37
27,8474149,Evgenii Dadonov,R,DAL,35,82,15,22,37
27,8476882,Teuvo Teravainen,L,CAR,30,82,13,24,37
27,8480188,Fabian Zetterlund,L,SJS,25,82,13,24,37
27,8480220,Noah Cates,L,PHI,25,82,11,26,37
27,8478055,Gustav Forsling,D,FLA,28,82,10,27,37
27,8476792,Torey Krug,D,STL,33,82,8,29,37
27,8477495,Seth Jones,D,CHI,30,82,7,30,37
27,8471724,Kris Letang,D,PIT,37,82,7,30,37
27,8474563,Drew Doughty,D,LAK,35,82,7,30,37
27,8476312,Josh Manson,D,COL,33,82,7,30,37
27,8481542,Moritz Seider,D,DET,23,82,6,31,37
27,8479425,Filip Hronek,D,VAN,27,82,5,32,37
27,8481699,Aku Raty,R,ARI,23,82,4,33,37
27,8482475,Yegor Chinakhov,R,CBJ,23,82,18,18,36
27,8478458,Jack Roslovic,C,NYR,27,82,18,18,36
27,8482702,Logan Stankoven,C,DAL,21,82,18,18,36
27,8478046,Danton Heinen,L,BOS,29,82,17,19,36
27,8471218,Blake Wheeler,R,NYR,38,82,16,20,36
27,8480113,Alex Iafallo,L,WPG,31,82,15,21,36
27,8482125,Alexander Holtz,R,NJD,22,82,15,21,36
27,8480849,Barrett Hayton,C,ARI,24,82,14,22,36
27,8481186,Logan O'Connor,R,COL,28,82,13,23,36
27,8475218,Mattias Ekholm,D,EDM,34,82,13,23,36
27,8478413,Jordan Greenway,L,BUF,27,82,12,24,36
27,8476906,Shayne Gostisbehere,D,DET,31,82,10,26,36
27,8475197,Tyson Barrie,D,NSH,33,82,8,28,36
27,8479410,Mikhail Sergachev,D,TBL,26,82,3,33,36
27,8484144,Connor Bedard,C,CHI,19,82,15,20,35
27,8477429,Andrew Copp,C,DET,30,82,15,20,35
27,8482117,Lukas Reichel,L,CHI,22,82,9,26,35
27,8482105,Jake Sanderson,D,OTT,22,82,8,27,35
27,8480798,Philipp Kurashev,C,CHI,25,82,8,27,35
27,8483397,Marc McLaughlin,C,BOS,25,82,29,5,34
27,8475314,Anders Lee,L,NYI,34,82,22,12,34
27,8475791,Taylor Hall,L,CHI,33,82,16,18,34
27,8477494,Jonathan Drouin,L,COL,29,82,16,18,34
27,8470621,Corey Perry,R,EDM,39,82,11,23,34
27,8481481,Blake Lizotte,C,LAK,27,82,11,23,34
27,8482720,Matthew Knies,L,TOR,22,82,10,24,34
27,8476480,Vladislav Namestnikov,C,WPG,32,82,10,24,34
27,8476958,Jaccob Slavin,D,CAR,30,82,8,26,34
27,8476885,Jacob Trouba,D,NYR,30,82,8,26,34
27,8484166,Adam Fantilli,C,CBJ,20,82,18,15,33
27,8476438,Brandon Saad,L,STL,32,82,17,16,33
27,8482092,Ridly Greig,C,OTT,22,82,15,18,33
27,8476461,Sean Couturier,C,PHI,32,82,12,21,33
27,8479415,Michael McLeod,C,NJD,26,82,12,21,33
27,8481703,Valtteri Puustinen,R,PIT,25,82,11,22,33
27,8482133,Thomas Bordeleau,C,SJS,22,82,11,22,33
27,8475220,Marcus Foligno,L,MIN,33,82,10,23,33
27,8476292,Ondrej Palat,L,NJD,33,82,9,24,33
27,8476917,Adam Pelech,D,NYI,30,82,4,29,33
27,8483493,Frank Nazar,C,CHI,20,82,20,12,32
27,8478463,Anthony Beauvillier,L,NSH,27,82,16,16,32
27,8476872,Scott Laughton,C,PHI,30,82,15,17,32
27,8476960,Andreas Athanasiou,C,CHI,30,82,10,22,32
27,8480871,Adam Boqvist,D,CBJ,24,82,10,22,32
27,8481618,Alex Newhook,C,MTL,23,82,9,23,32
27,8479976,Juuso Valimaki,D,ARI,26,82,5,27,32
27,8476979,Erik Gustafsson,D,NYR,32,82,4,28,32
27,8474884,Mike Hoffman,C,SJS,35,82,16,15,31
27,8475799,Nino Niederreiter,R,WPG,32,82,14,17,31
27,8478115,Pierre Engvall,L,NYI,28,82,14,17,31
27,8477953,Kasperi Kapanen,R,STL,28,82,12,19,31
27,8480009,Eeli Tolvanen,R,SEA,25,82,11,20,31
27,8479345,Jakob Chychrun,D,OTT,26,82,11,20,31
27,8476329,Travis Boyd,C,ARI,31,82,10,21,31
27,8478013,Jake Walman,D,DET,28,82,10,21,31
27,8483524,Shane Wright,C,SEA,20,82,24,6,30
27,8475793,Ryan Johansen,C,PHI,32,82,16,14,30
27,8481560,Arthur Kaliyev,R,LAK,23,82,16,14,30
27,8475343,Nic Dowd,C,WSH,34,82,16,14,30
27,8473533,Jordan Staal,C,CAR,36,82,16,14,30
27,8474037,James van Riemsdyk,L,BOS,35,82,14,16,30
27,8477952,Robby Fabbri,C,DET,28,82,13,17,30
27,8478133,Jake Evans,C,MTL,28,82,11,19,30
27,8480817,K'Andre Miller,D,NYR,24,82,11,19,30
27,8477947,Sonny Milano,L,WSH,28,82,10,20,30
27,8474716,Jared Spurgeon,D,MIN,35,82,9,21,30
27,8482655,J.J. Moser,D,ARI,24,82,8,22,30
27,8480873,Rasmus Sandin,D,WSH,24,82,7,23,30
27,8476869,Brady Skjei,D,CAR,30,82,6,24,30
27,8482671,Owen Power,D,BUF,22,82,6,24,30
27,8478500,Ivan Provorov,D,CBJ,27,82,5,25,30
27,8475279,Ben Chiarot,D,DET,33,82,5,25,30
27,8481554,Kaapo Kakko,R,NYR,23,82,21,8,29
27,8481535,Nils Hoglander,L,VAN,24,82,19,10,29
27,8477407,Anthony Duclair,L,TBL,29,82,12,17,29
27,8476981,Josh Anderson,R,MTL,30,82,11,18,29
27,8473449,Kyle Okposo,R,FLA,36,82,10,19,29
27,8475848,Brendan Gallagher,R,MTL,32,82,10,19,29
27,8475200,Dmitry Orlov,D,CAR,33,82,6,23,29
27,8475764,Cam Fowler,D,ANA,33,82,4,25,29
27,8483491,Ivan Miroshnichenko,L,WSH,20,82,14,14,28
27,8477450,Jason Dickinson,C,CHI,29,82,11,17,28
27,8475763,Kevin Hayes,R,STL,32,82,10,18,28
27,8481522,Peyton Krebs,C,BUF,23,82,10,18,28
27,8477948,Travis Sanheim,D,PHI,28,82,7,21,28
27,8484145,Zach Benson,L,BUF,19,82,7,21,28
27,8480246,Nick Perbix,D,TBL,26,82,3,25,28
27,8476931,Jake McCabe,D,TOR,31,82,3,25,28
27,8483431,Logan Cooley,C,ARI,20,82,16,11,27
27,8475722,Jason Zucker,L,NSH,32,82,15,12,27
27,8482089,Jake Neighbours,L,STL,22,82,14,13,27
27,8479661,Tanner Jeannot,L,TBL,27,82,12,15,27
27,8477425,Miles Wood,L,COL,29,82,10,17,27
27,8482155,Alex Laferriere,R,LAK,23,82,10,17,27
27,8481014,Alexander Romanov,D,NYI,24,82,9,18,27
27,8475149,Marcus Johansson,L,MIN,34,82,8,19,27
27,8483505,Matthew Poitras,C,BOS,20,82,8,19,27
27,8475171,Oliver Ekman-Larsson,D,FLA,33,82,6,21,27
27,8477969,Marcus Pettersson,D,PIT,28,82,4,23,27
27,8473563,Nicklas Backstrom,C,WSH,37,82,4,23,27
27,8479346,Dillon Dube,C,CGY,26,82,13,13,26
27,8481553,Bobby Brink,R,PHI,23,82,11,15,26
27,8479390,Taylor Raddysh,R,CHI,26,82,11,15,26
27,8482087,Kaiden Guhle,D,MTL,22,82,10,16,26
27,8477989,Christian Dvorak,C,MTL,28,82,10,16,26
27,8482062,Cole Smith,L,NSH,29,82,9,17,26
27,8479351,Sam Steel,C,DAL,26,82,7,19,26
27,8474151,Ryan McDonagh,D,NSH,35,82,6,20,26
27,8477435,Ryan Graves,D,PIT,29,82,6,20,26
27,8481606,Jordan Spence,D,LAK,23,82,6,20,26
27,8482705,Cole Sillinger,C,CBJ,21,82,5,21,26
27,8474870,Tyler Johnson,C,CHI,34,82,16,9,25
27,8470604,Jeff Carter,C,PIT,39,82,16,9,25
27,8482118,Sam Colangelo,R,ANA,23,82,15,10,25
27,8479393,Noah Gregor,C,TOR,26,82,14,11,25
27,8476278,Colin Blackwell,C,CHI,31,82,13,12,25
27,8475231,Casey Cizikas,C,NYI,33,82,13,12,25
27,8480813,Joe Veleno,C,DET,24,82,12,13,25
27,8478057,Dakota Joshua,C,VAN,28,82,11,14,25
27,8477839,Conor Sheary,L,TBL,32,82,11,14,25
27,8481580,Connor McMichael,C,WSH,23,82,11,14,25
27,8476392,Adam Lowry,C,WPG,31,82,10,15,25
27,8476419,Jean-Gabriel Pageau,C,NYI,32,82,10,15,25
27,8478840,Will Borgen,D,SEA,28,82,10,15,25
27,8481013,Jonatan Berggren,R,DET,24,82,9,16,25
27,8482079,Marco Rossi,C,MIN,23,82,9,16,25
27,8479353,Brett Howden,C,VGK,26,82,9,16,25
27,8478882,Vladislav Gavrikov,D,LAK,29,82,9,16,25
27,8482142,Jamie Drysdale,D,PHI,22,82,6,19,25
27,8474673,TJ Brodie,D,TOR,34,82,6,19,25
27,8481178,Egor Zamula,D,PHI,24,82,5,20,25
27,8476331,Dylan DeMelo,D,WPG,31,82,4,21,25
27,8482122,Brock Faber,D,MIN,22,82,1,24,25
27,8476854,Hampus Lindholm,D,BOS,30,82,1,24,25
27,8478020,Michael Amadio,C,VGK,28,82,16,8,24
27,8476469,Joel Armia,R,MTL,31,82,13,11,24
27,8480068,Ryan Poehling,C,PHI,25,82,13,11,24
27,8480821,Filip Zadina,R,SJS,25,82,13,11,24
27,8482737,Zack Bolduc,C,STL,21,82,13,11,24
27,8484153,Leo Carlsson,C,ANA,20,82,12,12,24
27,8480806,Isac Lundestrom,C,ANA,25,82,12,12,24
27,8474715,Cam Atkinson,R,PHI,35,82,12,12,24
27,8480448,Parker Kelly,L,OTT,25,82,12,12,24
27,8479941,Justin Danforth,R,CBJ,31,82,11,13,24
27,8478508,Yakov Trenin,C,COL,27,82,11,13,24
27,8470610,Zach Parise,L,COL,40,82,11,13,24
27,8477944,Jakub Vrana,L,STL,28,82,11,13,24
27,8473453,Trevor Lewis,C,LAK,37,82,10,14,24
27,8473422,Nick Foligno,L,CHI,37,82,9,15,24
27,8478109,Victor Olofsson,L,BUF,29,82,8,16,24
27,8480855,Jack McBain,C,ARI,24,82,8,16,24
27,8480144,David Kampf,C,TOR,29,82,8,16,24
27,8476826,Yanni Gourde,C,SEA,33,82,7,17,24
27,8480980,Connor Dewar,C,TOR,25,82,7,17,24
27,8477488,Brett Pesce,D,CAR,30,82,6,18,24
27,8476525,Colin Miller,D,WPG,32,82,6,18,24
27,8478178,Darren Raddysh,D,TBL,28,82,4,20,24
27,8480043,Timothy Liljegren,D,TOR,25,82,4,20,24
27,8481704,Juuso Parssinen,C,NSH,23,82,12,11,23
27,8480281,Alexey Toropchenko,R,STL,25,82,12,11,23
27,8482111,Justin Barron,D,MTL,23,82,12,11,23
27,8475164,Jakob Silfverberg,R,ANA,34,82,11,12,23
27,8482074,Connor Zary,C,CGY,23,82,11,12,23
27,8476624,Barclay Goodrow,C,NYR,31,82,10,13,23
27,8480185,Eetu Luostarinen,C,FLA,26,82,8,15,23
27,8482259,Bobby McMann,C,TOR,28,82,8,15,23
27,8479369,Andrew Peeke,D,BOS,26,82,6,17,23
27,8482712,Oskar Olausson,R,COL,22,82,5,18,23
27,8480796,Martin Fehervary,D,WSH,25,82,4,19,23
27,8475179,Dmitry Kulikov,D,FLA,34,82,4,19,23
27,8475455,Brenden Dillon,D,WPG,34,82,4,19,23
27,8478451,Ethan Bear,D,WSH,27,82,3,20,23
27,8482166,Shakir Mukhamadullin,D,SJS,22,82,3,20,23
27,8478851,Alexandre Carrier,D,NSH,28,82,2,21,23
27,8481604,Pavel Dorofeyev,L,VGK,24,82,18,4,22
27,8476921,Jordan Martinook,L,CAR,32,82,11,11,22
27,8482679,Matt Coronato,R,CGY,22,82,10,12,22
27,8480035,Henri Jokiharju,D,BUF,25,82,9,13,22
27,8475233,David Savard,D,MTL,34,82,8,14,22
27,8475790,Erik Gudbranson,D,CBJ,32,82,7,15,22
27,8478408,Travis Dermott,D,ARI,28,82,7,15,22
27,8481537,Nikita Okhotiuk,D,CGY,24,82,6,16,22
27,8482803,Olen Zellweger,D,ANA,21,82,5,17,22
27,8473507,Jeff Petry,D,DET,37,82,4,18,22
27,8483490,Pavel Mintyukov,D,ANA,21,82,3,19,22
27,8480172,Jan Rutta,D,SJS,34,82,3,19,22
27,8481546,Cam York,D,PHI,23,82,2,20,22
27,8484203,Bradly Nadeau,L,CAR,19,82,15,6,21
27,8476873,Mark Jankowski,C,NSH,30,82,10,11,21
27,8476927,Teddy Blueger,C,VAN,30,82,9,12,21
27,8475842,Sam Carrick,C,EDM,32,82,9,12,21
27,8481601,Simon Holmstrom,R,NYI,23,82,8,13,21
27,8477508,Curtis Lazar,C,NJD,29,82,7,14,21
27,8477845,Trevor van Riemsdyk,D,WSH,33,82,7,14,21
27,8479293,Brandon Tanev,L,SEA,33,82,6,15,21
27,8474189,Lars Eller,C,PIT,35,82,6,15,21
27,8474034,Pat Maroon,L,BOS,36,82,6,15,21
27,8481567,Henry Thrun,D,SJS,23,82,6,15,21
27,8478468,Jeremy Lauzon,D,NSH,27,82,5,16,21
27,8477506,Ryan Pulock,D,NYI,30,82,4,17,21
27,8480145,Neal Pionk,D,WPG,29,82,3,18,21
27,8482245,Artem Zub,D,OTT,29,82,3,18,21
27,8480834,Ty Emberson,D,SJS,24,82,2,19,21
27,8482470,Ilya Solovyov,D,CGY,24,82,2,19,21
27,8479398,Samuel Girard,D,COL,26,82,1,20,21
27,8483012,Logan Morrison,C,SEA,22,82,17,3,20
27,8477392,Hudson Fasching,R,NYI,29,82,12,8,20
27,8481477,Nico Sturm,C,SJS,29,82,9,11,20
27,8477330,Dominik Kubalik,L,OTT,29,82,7,13,20
27,8476871,Tanner Pearson,L,MTL,32,82,7,13,20
27,8476457,Adam Larsson,D,SEA,32,82,3,17,20
27,8478507,John Marino,D,NJD,27,82,2,18,20
27,8475324,Nick Jensen,D,WSH,34,82,2,18,20
27,8479359,Beck Malenstyn,L,WSH,26,82,10,9,19
27,8479514,Rem Pitlick,C,CHI,27,82,9,10,19
27,8476897,Oskar Sundqvist,C,STL,30,82,9,10,19
27,8480336,Sean Walker,D,COL,30,82,8,11,19
27,8476858,Phillip Di Giuseppe,L,VAN,31,82,8,11,19
27,8483495,Simon Nemec,D,NJD,20,82,6,13,19
27,8478911,Matt Roy,D,LAK,29,82,6,13,19
27,8477507,Nikita Zadorov,D,VAN,29,82,6,13,19
27,8476892,Colton Parayko,D,STL,31,82,5,14,19
27,8479983,Mario Ferraro,D,SJS,26,82,3,16,19
27,8481605,Jackson LaCombe,D,ANA,23,82,1,18,19
27,8481093,Rafael Harvey-Pinard,L,MTL,25,82,16,2,18
27,8483499,Liam Ohgren,L,MIN,20,82,11,7,18
27,8474009,Nick Bonino,C,NYR,36,82,8,10,18
27,8477919,Frederick Gaudreau,C,MIN,31,82,7,11,18
27,8476463,Jonas Brodin,D,MIN,31,82,6,12,18
27,8483482,Tristan Luneau,D,ANA,20,82,6,12,18
27,8478399,Jonas Siegenthaler,D,NJD,27,82,6,12,18
27,8478831,Kevin Stenlund,C,FLA,28,82,5,13,18
27,8477365,Connor Clifton,D,BUF,29,82,5,13,18
27,8481568,Alex Vlasic,D,CHI,23,82,4,14,18
27,8470966,Mark Giordano,D,TOR,41,82,4,14,18
27,8479324,Ryan Lindgren,D,NYR,26,82,3,15,18
27,8480807,Mattias Samuelsson,D,BUF,24,82,3,15,18
27,8480073,Erik Brannstrom,D,OTT,25,82,2,16,18
27,8475181,Nick Leddy,D,STL,33,82,2,16,18
27,8476902,Esa Lindell,D,DAL,30,82,2,16,18
27,8476879,Cody Ceci,D,EDM,31,82,1,17,18
27,8477499,Rasmus Ristolainen,D,PHI,30,82,1,17,18
27,8482666,Scott Morrow,D,CAR,22,82,10,7,17
27,8482730,Brandt Clarke,D,LAK,21,82,9,8,17
27,8479998,Mikey Anderson,D,LAK,25,82,6,11,17
27,8474574,Tyler Myers,D,VAN,34,82,6,11,17
27,8477220,Nate Schmidt,D,WPG,33,82,5,12,17
27,8477505,Alexander Wennberg,C,NYR,30,82,4,13,17
27,8484911,Collin Graf,R,SJS,22,82,4,13,17
27,8476891,Matt Grzelcyk,D,BOS,30,82,2,15,17
27,8483466,Kevin Korchinski,D,CHI,20,82,1,16,17
27,8479591,Michael Eyssimont,C,TBL,28,82,9,7,16
27,8476372,Nick Seeler,D,PHI,31,82,7,9,16
27,8480074,Alexandre Texier,C,CBJ,25,82,6,10,16
27,8477406,Mattias Janmark,C,EDM,32,82,6,10,16
27,8481028,Martin Pospisil,C,CGY,25,82,6,10,16
27,8481524,Bowen Byram,D,BUF,23,82,5,11,16
27,8476374,Sean Kuraly,C,CBJ,31,82,4,12,16
27,8480058,Pierre-Olivier Joseph,D,PIT,25,82,4,12,16
27,8479977,Kailer Yamamoto,R,SEA,26,82,4,12,16
27,8477369,Carson Soucy,D,VAN,30,82,4,12,16
27,8478859,Niko Mikkola,D,FLA,28,82,4,12,16
27,8480860,Kevin Bahl,D,NJD,24,82,4,12,16
27,8475762,Derek Forbort,D,BOS,32,82,3,13,16
27,8482073,Braden Schneider,D,NYR,23,82,2,14,16
27,8481030,Jack St. Ivany,D,PIT,25,82,2,14,16
27,8479371,Dante Fabbro,D,NSH,26,82,1,15,16
27,8475188,Brayden McNabb,D,VGK,33,82,1,15,16
27,8482145,Mavrik Bourque,C,DAL,22,82,13,2,15
27,8479316,Luke Kunin,C,SJS,27,82,11,4,15
27,8481517,Brett Leason,R,ANA,25,82,10,5,15
27,8476878,Zemgus Girgensons,L,BUF,30,82,10,5,15
27,8483565,Nick Blankenburg,D,CBJ,26,82,5,10,15
27,8475690,Chris Tanev,D,DAL,35,82,5,10,15
27,8479383,Boris Katchouk,L,OTT,26,82,5,10,15
27,8482807,Ethan Del Mastro,D,CHI,21,82,5,10,15
27,8483763,Maksymilian Szuber,D,ARI,22,82,5,10,15
27,8476467,Jamie Oleksiak,D,SEA,32,82,4,11,15
27,8478430,Oliver Kylington,D,CGY,27,82,4,11,15
27,8482177,Marat Khusnutdinov,C,MIN,22,82,3,12,15
27,8482516,Matthew Kessel,D,STL,24,82,3,12,15
27,8478043,Sam Lafferty,C,VAN,29,82,9,5,14
27,8477015,Connor Brown,R,EDM,30,82,6,8,14
27,8477353,Tyler Motte,C,TBL,29,82,5,9,14
27,8478136,Jake Middleton,D,MIN,28,82,5,9,14
27,8476422,Mike Reilly,D,NYI,31,82,5,9,14
27,8479442,Troy Stecher,D,EDM,30,82,4,10,14
27,8478569,Noel Acciari,C,PIT,33,82,3,11,14
27,8482858,Ryker Evans,D,SEA,23,82,3,11,14
27,8477931,Tomas Nosek,L,NJD,32,82,3,11,14
27,8475177,Calvin de Haan,D,TBL,33,82,2,12,14
27,8470600,Ryan Suter,D,DAL,39,82,1,13,14
27,8475462,Radko Gudas,D,ANA,34,82,1,13,14
27,8480990,Declan Chisholm,D,MIN,24,82,5,8,13
27,8479980,Nicolas Hague,D,VGK,26,82,3,10,13
27,8476429,Scott Mayfield,D,NYI,32,82,3,10,13
27,8474166,Alec Martinez,D,VGK,37,82,3,10,13
27,8476442,Matt Nieto,L,PIT,32,82,6,6,12
27,8479291,Kevin Rooney,C,CGY,31,82,4,8,12
27,8478443,Brandon Carlo,D,BOS,28,82,3,9,12
27,8475825,Jani Hakanpää,D,DAL,32,82,1,11,12
27,8482809,Jackson Blake,R,CAR,21,82,7,4,11
27,8483468,Jiri Kulich,C,BUF,20,82,7,4,11
27,8482762,Simon Edvinsson,D,DET,21,82,5,6,11
27,8480879,Jacob Bernard-Docker,D,OTT,24,82,5,6,11
27,8476473,Connor Murphy,D,CHI,31,82,5,5,10
27,8476822,Luke Glendening,C,TBL,35,82,4,6,10
27,8482859,Zack Ostapchuk,C,OTT,21,82,4,6,10
27,8471677,Jack Johnson,D,COL,37,82,2,8,10
27,8478416,Erik Cernak,D,TBL,27,82,2,8,10
27,8476967,Brett Kulak,D,EDM,30,82,1,9,10
27,8481059,Scott Perunovich,D,STL,26,82,0,10,10
27,8477034,Jaycob Megna,D,CHI,32,82,0,10,10
27,8483489,Fraser Minten,C,TOR,31,82,6,3,9
27,8473504,Cal Clutterbuck,R,NYI,37,82,4,5,9
27,8474567,Zach Bogosian,D,MIN,34,82,4,5,9
27,8476915,Jujhar Khaira,L,MIN,30,82,4,4,8
27,8474013,Ian Cole,D,VAN,35,82,2,6,8
27,8481599,Victor Soderstrom,D,ARI,23,82,1,7,8
27,8482713,Mackie Samoskevich,R,FLA,22,82,3,4,7
27,8481578,Graeme Clarke,R,NJD,23,82,2,5,7
27,8477335,Kyle Burroughs,D,SJS,29,82,1,6,7
27,8475208,Brian Dumoulin,D,SEA,33,82,0,6,6
27,8484149,Gavin Brindley,C,CBJ,20,82,0,3,3
27,8482141,Lukas Cormier,D,VGK,22,0,0,0,0
27,8476988,Matt Benning,D,SJS,30,0,0,0,0
27,8480727,Zach Whitecloud,D,VGK,28,0,0,0,0
27,8480887,Jordan Harris,D,MTL,24,0,0,0,0
27,8478450,Parker Wotherspoon,D,BOS,27,0,0,0,0
27,8481812,Nikolai Knyzhov,D,SJS,27,0,0,0,0
27,8480001,Urho Vaakanainen,D,ANA,25,0,0,0,0
27,8482176,Wyatt Kaiser,D,CHI,22,0,0,0,0
27,8481122,Simon Benoit,D,TOR,26,0,0,0,0
27,8476441,Joel Edmundson,D,TOR,31,0,0,0,0
27,8480884,Calen Addison,D,SJS,24,0,0,0,0
27,8482511,Mason Lohrei,D,BOS,23,0,0,0,0
27,8482192,Isaak Phillips,D,CHI,23,0,0,0,0
27,8480950,Ilya Lyubushkin,D,TOR,30,0,0,0,0
27,8474031,Kevin Shattenkirk,D,BOS,35,0,0,0,0
27,8475718,Justin Holl,D,DET,32,0,0,0,0
27,8479402,Jake Bean,D,CBJ,26,0,0,0,0
27,8474602,Justin Schultz,D,SEA,34,0,0,0,0
27,8477950,Tony DeAngelo,D,CAR,29,0,0,0,0
27,8481743,Marc Del Gaizo,D,NSH,25,0,0,0,0
27,8481527,Kaedan Korczak,D,VGK,23,0,0,0,0
27,8480192,Johnathan Kovacevic,D,MTL,27,0,0,0,0
27,8476874,Olli Maatta,D,DET,30,0,0,0,0
27,8482144,Jack Thompson,D,SJS,22,0,0,0,0
27,8480222,Sebastian Aho,D,NYI,28,0,0,0,0
27,8479458,Nikita Zaitsev,D,CHI,33,0,0,0,0
27,8471709,Marc-Edouard Vlasic,D,SJS,37,0,0,0,0
27,8482929,Emil Lilleberg,D,TBL,23,0,0,0,0
27,8477018,Ben Hutton,D,VGK,31,0,0,0,0
27,8481056,Spencer Stastney,D,NSH,24,0,0,0,0
27,8481593,Jayden Struble,D,MTL,23,0,0,0,0
27,8479982,Conor Timmins,D,TOR,26,0,0,0,0
27,8474090,Brendan Smith,D,NJD,35,0,0,0,0
27,8482964,Arber Xhekaj,D,MTL,23,0,0,0,0
27,8480891,Michael Kesselring,D,ARI,24,0,0,0,0
27,8477938,Haydn Fleury,D,TBL,28,0,0,0,0
27,8481806,Louis Crevier,D,CHI,23,0,0,0,0
27,8471274,Alex Goligoski,D,MIN,39,0,0,0,0
27,8481600,Tobias Bjornfot,D,FLA,23,0,0,0,0
27,8475797,Jarred Tinordi,D,CHI,32,0,0,0,0
27,8481521,Ronnie Attard,D,PHI,25,0,0,0,0
27,8474612,Travis Hamonic,D,OTT,34,0,0,0,0
27,8479576,Vincent Desharnais,D,EDM,28,0,0,0,0
27,8480049,Dylan Samberg,D,WPG,25,0,0,0,0
27,8483619,Filip Roos,D,CHI,25,0,0,0,0
27,8474568,Luke Schenn,D,NSH,35,0,0,0,0
27,8480184,Gustav Lindstrom,D,ANA,26,0,0,0,0
27,8480070,Ian Mitchell,D,BOS,25,0,0,0,0
27,8480196,Jacob Bryson,D,BUF,27,0,0,0,0
27,8471686,Marc Staal,D,PHI,37,0,0,0,0
27,8477467,Gustav Olofsson,D,SEA,30,0,0,0,0
27,8478970,Jalen Chatfield,D,CAR,28,0,0,0,0
27,8479348,Kale Clague,D,BUF,26,0,0,0,0
27,8473446,Erik Johnson,D,PHI,36,0,0,0,0
27,8477462,Robert Hagg,D,ANA,29,0,0,0,0
27,8478454,Noah Juulsen,D,VAN,27,0,0,0,0
27,8477384,Josh Brown,D,ARI,30,0,0,0,0
27,8481708,Zac Jones,D,NYR,24,0,0,0,0
27,8481167,Brayden Pachal,D,CGY,25,0,0,0,0
27,8482067,Connor Mackey,D,NYR,28,0,0,0,0
27,8483460,David Jiricek,D,CBJ,21,0,0,0,0
27,8481701,Santeri Hatakka,D,NJD,23,0,0,0,0
27,8478021,William Lagesson,D,ANA,28,0,0,0,0
27,8477851,Jordan Oesterle,D,CGY,32,0,0,0,0
27,8478452,Caleb Jones,D,COL,27,0,0,0,0
27,8479984,Cal Foote,D,NJD,26,0,0,0,0
27,8479639,Dylan Coghlan,D,CAR,26,0,0,0,0
27,8480874,Adam Ginning,D,PHI,24,0,0,0,0
27,8479321,Lucas Johansen,D,WSH,27,0,0,0,0
27,8480878,Nils Lundkvist,D,DAL,24,0,0,0,0
27,8482165,Yan Kuznetsov,D,CGY,22,0,0,0,0
27,8484258,Sam Malinski,D,COL,26,0,0,0,0
27,8480157,Calle Rosen,D,STL,30,0,0,0,0
27,8484304,Uvis Balinskis,D,FLA,28,0,0,0,0
27,8479985,Cale Fleury,D,SEA,26,0,0,0,0
27,8479378,Logan Stanley,D,WPG,26,0,0,0,0
27,8477541,Dakota Mermis,D,MIN,30,0,0,0,0
27,8481609,Vladislav Kolyachonok,D,ARI,23,0,0,0,0
27,8480823,Alexander Alexeyev,D,WSH,25,0,0,0,0
27,8481679,Maxence Guenette,D,OTT,23,0,0,0,0
27,8481564,Ryan Johnson,D,BUF,23,0,0,0,0
27,8479376,Victor Mete,D,PHI,26,0,0,0,0
27,8484254,Akito Hirose,D,VAN,25,0,0,0,0
27,8482660,Kent Johnson,C,CBJ,22,0,0,0,0
27,8482149,Cole Perfetti,C,WPG,22,0,0,0,0
27,8477987,Ryan Donato,C,CHI,28,0,0,0,0
27,8475755,Alexander Petrovic,D,DAL,32,0,0,0,0
27,8477810,Joel Hanley,D,CGY,33,0,0,0,0
27,8474145,Robert Bortuzzo,D,NYI,35,0,0,0,0
27,8481161,Jake Christiansen,D,CBJ,25,0,0,0,0
27,8476884,Derrick Pouliot,D,DAL,30,0,0,0,0
27,8481716,Dmitri Voronkov,L,CBJ,24,0,0,0,0
27,8480084,Nick DeSimone,D,NJD,30,0,0,0,0
27,8475750,Jon Merrill,D,MIN,32,0,0,0,0
27,8479315,Joey Anderson,R,CHI,26,0,0,0,0
27,8478011,Louie Belpedio,D,PHI,28,0,0,0,0
27,8482451,Mikael Pyyhtia,L,CBJ,23,0,0,0,0
27,8481541,Samuel Bolduc,D,NYI,24,0,0,0,0
27,8482126,Emil Andrae,D,PHI,31,0,0,0,0
27,8474618,Marco Scandella,D,STL,34,0,0,0,0
27,8477244,Chad Ruhwedel,D,NYR,34,0,0,0,0
27,8477971,Andreas Englund,D,LAK,28,0,0,0,0
27,8480829,Jesperi Kotkaniemi,C,CAR,24,0,0,0,0
27,8479372,Josh Mahura,D,FLA,26,0,0,0,0
27,8482095,Tyler Kleven,D,OTT,22,0,0,0,0
27,8481719,Maxwell Crozier,D,TBL,24,0,0,0,0
27,8475855,Jesper Fast,R,CAR,33,0,0,0,0
27,8480848,Ty Dellandrea,C,DAL,24,0,0,0,0
27,8475193,Tomas Tatar,L,SEA,34,0,0,0,0
27,8476889,Radek Faksa,C,DAL,30,0,0,0,0
27,8478495,Denis Gurianov,R,PHI,27,0,0,0,0
27,8480216,Jacob Peterson,C,SJS,25,0,0,0,0
27,8480252,Cole Guttman,C,CHI,25,0,0,0,0
27,8479026,Philippe Myers,D,TBL,27,0,0,0,0
27,8481006,Tyler Tucker,D,STL,24,0,0,0,0
27,8481032,Paul Cotter,C,VGK,25,0,0,0,0
27,8481577,Philip Tomasino,C,NSH,23,0,0,0,0
27,8476918,Jimmy Vesey,L,NYR,31,0,0,0,0
27,8479320,Max Lajoie,D,TOR,27,0,0,0,0
27,8478017,Mark Friedman,D,VAN,29,0,0,0,0
27,8481754,Nikita Nesterenko,C,ANA,23,0,0,0,0
27,8483407,Brandon Scanlin,D,NYR,25,0,0,0,0
27,8482659,Josh Doan,R,ARI,22,0,0,0,0
27,8477446,Michael McCarron,R,NSH,29,0,0,0,0
27,8477903,Garnet Hathaway,R,PHI,33,0,0,0,0
27,8482153,Brendan Brisson,C,VGK,23,0,0,0,0
27,8483546,Marshall Rifai,D,TOR,26,0,0,0,0
27,8484287,Cole McWard,D,VAN,23,0,0,0,0
27,8478854,Ryan Shea,D,PIT,27,0,0,0,0
27,8481585,Egor Afanasyev,L,NSH,23,0,0,0,0
27,8483398,Declan Carlile,D,TBL,31,0,0,0,0
27,8478502,Dennis Gilbert,D,CGY,28,0,0,0,0
27,8482749,Joshua Roy,R,MTL,21,0,0,0,0
27,8481598,Philip Broberg,D,EDM,23,0,0,0,0
27,8480835,Jack Drury,C,CAR,24,0,0,0,0
27,8480748,Kiefer Sherwood,L,NSH,29,0,0,0,0
27,8476934,Brock McGinn,L,ANA,30,0,0,0,0
27,8480870,Bo Groulx,C,ANA,24,0,0,0,0
27,8479368,Max Jones,L,ANA,26,0,0,0,0
27,8478099,Kevin Labanc,R,SJS,29,0,0,0,0
27,8478067,Oskar Lindblom,L,SJS,28,0,0,0,0
27,8476393,Nick Cousins,C,FLA,31,0,0,0,0
27,8483395,Arshdeep Bains,L,VAN,23,0,0,0,0
27,8480762,Eric Robinson,L,BUF,29,0,0,0,0
27,8479439,Jacob MacDonald,D,SJS,31,0,0,0,0
27,8476474,Stefan Noesen,R,CAR,31,0,0,0,0
27,8482787,Nikita Chibrikov,R,WPG,31,0,0,0,0
27,8478432,Christian Fischer,R,DET,27,0,0,0,0
27,8477979,Nicolas Aube-Kubel,R,WSH,28,0,0,0,0
27,8481789,Tye Kartye,L,SEA,23,0,0,0,0
27,8479330,Brandon Gignac,C,MTL,27,0,0,0,0
27,8480075,Cameron Crotty,D,ARI,25,0,0,0,0
27,8473473,Milan Lucic,L,BOS,36,0,0,0,0
27,8482094,Daemon Hunt,D,MIN,22,0,0,0,0
27,8481206,John Ludvig,D,PIT,24,0,0,0,0
27,8483630,Pavol Regenda,L,ANA,25,0,0,0,0
27,8481617,Vasily Podkolzin,R,VAN,23,0,0,0,0
27,8480306,Grant Hutton,D,NYI,29,0,0,0,0
27,8480995,Pontus Holmberg,R,TOR,25,0,0,0,0
27,8482148,Hendrix Lapierre,C,WSH,22,0,0,0,0
27,8477478,William Carrier,L,VGK,30,0,0,0,0
27,8480003,Jesper Boqvist,C,BOS,26,0,0,0,0
27,8482172,Landon Slaggert,L,CHI,22,0,0,0,0
27,8480789,Oliver Wahlstrom,R,NYI,24,0,0,0,0
27,8474062,Riley Nash,C,NYR,35,0,0,0,0
27,8480021,Jack Studnicka,C,SJS,25,0,0,0,0
27,8480025,MacKenzie Entwistle,R,CHI,25,0,0,0,0
27,8481582,Nicholas Robertson,L,TOR,23,0,0,0,0
27,8476867,Brendan Gaunce,C,CBJ,30,0,0,0,0
27,8479619,Michael Carcone,L,ARI,28,0,0,0,0
27,8479370,Tyson Jost,C,BUF,26,0,0,0,0
27,8479671,Mathieu Olivier,R,CBJ,27,0,0,0,0
27,8476994,Vinnie Hinostroza,C,PIT,30,0,0,0,0
27,8482070,Mitchell Chaffee,R,TBL,26,0,0,0,0
27,8477473,Justin Bailey,R,SJS,29,0,0,0,0
27,8479344,Jesse Puljujarvi,R,PIT,26,0,0,0,0
27,8480205,Emil Bemstrom,C,PIT,25,0,0,0,0
27,8479718,Alex Barré-Boulet,C,TBL,27,0,0,0,0
27,8482061,Brandon Biro,L,BUF,26,0,0,0,0
27,8479638,Justin Brazeau,R,BOS,26,0,0,0,0
27,8474040,Sam Gagner,C,EDM,35,0,0,0,0
27,8477846,Ryan Carpenter,C,SJS,33,0,0,0,0
27,8482077,Dylan Holloway,L,EDM,23,0,0,0,0
27,8482157,Will Cuylle,L,NYR,22,0,0,0,0
27,8480007,Jonas Rondbjerg,R,VGK,25,0,0,0,0
27,8478874,Adam Gaudette,C,STL,28,0,0,0,0
27,8478434,Keegan Kolesar,R,VGK,27,0,0,0,0
27,8480441,Trey Fix-Wolansky,R,CBJ,25,0,0,0,0
27,8479994,Jaret Anderson-Dolan,C,NSH,25,0,0,0,0
27,8483567,Georgii Merkulov,C,BOS,24,0,0,0,0
27,8477380,Jonny Brodzinski,C,NYR,31,0,0,0,0
27,8482201,Gage Goncalves,C,TBL,23,0,0,0,0
27,8478211,Dryden Hunt,L,CGY,29,0,0,0,0
27,8471699,Andrew Cogliano,C,COL,37,0,0,0,0
27,8479421,Jacob Moverare,D,LAK,26,0,0,0,0
27,8478881,Brett Seney,L,CHI,28,0,0,0,0
27,8477464,Nic Petan,C,MIN,29,0,0,0,0
27,8475958,Michael Sgarbossa,C,WSH,32,0,0,0,0
27,8481147,Reese Johnson,C,CHI,26,0,0,0,0
27,8479336,Carl Grundstrom,R,LAK,27,0,0,0,0
27,8480853,Liam Foudy,C,NSH,24,0,0,0,0
27,8479522,Hardy Haman Aktell,D,WSH,26,0,0,0,0
27,8481462,Mason Morelli,L,VGK,28,0,0,0,0
27,8482102,Vasily Ponomarev,C,CAR,22,0,0,0,0
27,8480844,Grigori Denisenko,L,VGK,24,0,0,0,0
27,8479944,Zach Aston-Reese,C,DET,30,0,0,0,0
27,8482784,Zach Dean,C,STL,21,0,0,0,0
27,8479419,Brett Murray,L,BUF,26,0,0,0,0
27,8479520,Brandon Duhaime,R,COL,27,0,0,0,0
27,8477573,Nathan Walker,L,STL,30,0,0,0,0
27,8478078,Rourke Chartier,C,OTT,28,0,0,0,0
27,8475795,Dylan McIlrath,D,WSH,32,0,0,0,0
27,8482496,Nils Aman,C,VAN,24,0,0,0,0
27,8480289,Morgan Barron,C,WPG,26,0,0,0,0
27,8481751,Lukas Rousek,R,BUF,25,0,0,0,0
27,8480011,Klim Kostin,C,SJS,25,0,0,0,0
27,8481556,John Beecher,C,BOS,23,0,0,0,0
27,8475278,Byron Froese,C,VGK,33,0,0,0,0
27,8475225,Craig Smith,C,DAL,35,0,0,0,0
27,8484326,Patrik Koch,D,ARI,28,0,0,0,0
27,8477930,Pierre-Edouard Bellemare,L,SEA,39,0,0,0,0
27,8478409,Anthony Richard,C,BOS,28,0,0,0,0
27,8481024,Linus Karlsson,C,VAN,25,0,0,0,0
27,8479986,Kole Lind,R,SEA,26,0,0,0,0
27,8479414,Nathan Bastian,R,NJD,27,0,0,0,0
27,8479362,Riley Tufte,L,COL,26,0,0,0,0
27,8481058,Jesse Ylönen,R,MTL,25,0,0,0,0
27,8482476,Emil Heineman,L,MTL,23,0,0,0,0
27,8482861,Vincent Iorio,D,WSH,22,0,0,0,0
27,8483432,Luca Del Bel Belluz,C,CBJ,31,0,0,0,0
27,8482744,James Malatesta,L,CBJ,21,0,0,0,0
27,8477887,Patrick Brown,C,BOS,32,0,0,0,0
27,8478585,Derek Ryan,C,EDM,38,0,0,0,0
27,8481441,Joe Snively,C,WSH,28,0,0,0,0
27,8481592,Jakob Pelletier,L,CGY,23,0,0,0,0
27,8482634,Alex Steeves,C,TOR,25,0,0,0,0
27,8477126,Jayson Megna,C,BOS,34,0,0,0,0
27,8475752,Tyler Pitlick,C,NYR,33,0,0,0,0
27,8480008,Adam Ruzicka,C,ARI,25,0,0,0,0
27,8481065,Angus Crookshank,L,OTT,25,0,0,0,0
27,8479547,Matthew Phillips,R,WSH,26,0,0,0,0
27,8480226,Marián Studenic,R,SEA,26,0,0,0,0
27,8481237,Kyle MacLean,C,NYI,25,0,0,0,0
27,8475413,Justin Dowling,C,NJD,34,0,0,0,0
27,8481641,Joel Kiviranta,L,COL,28,0,0,0,0
27,8478104,Sammy Blais,L,STL,28,0,0,0,0
27,8477454,Adam Erne,L,EDM,29,0,0,0,0
27,8481518,Nolan Foote,L,NJD,24,0,0,0,0
27,8480245,Olle Lycksell,R,PHI,25,0,0,0,0
27,8483570,Ben Meyers,C,ANA,26,0,0,0,0
27,8480776,Sheldon Rempal,R,VGK,29,0,0,0,0
27,8483920,Pierrick Dube,R,WSH,23,0,0,0,0
27,8480267,Sammy Walker,C,MIN,25,0,0,0,0
27,8482747,Brennan Othmann,L,NYR,21,0,0,0,0
27,8479991,Jake Leschyshyn,C,NYR,25,0,0,0,0
27,8478400,Colin White,C,MTL,27,0,0,0,0
27,8479328,Julien Gauthier,R,NYI,27,0,0,0,0
27,8484325,Waltteri Merela,C,TBL,26,0,0,0,0
27,8479066,Ryan Lomberg,L,FLA,30,0,0,0,0
27,8477070,Liam O'Brien,C,ARI,30,0,0,0,0
27,8478146,Matthew Highmore,C,OTT,28,0,0,0,0
27,8478028,Fredrik Olofsson,L,COL,28,0,0,0,0
27,8480880,Jakub Lauko,C,BOS,24,0,0,0,0
27,8479968,Vinni Lettieri,C,MIN,29,0,0,0,0
27,8474709,Matt Martin,L,NYI,35,0,0,0,0
27,8480845,Rasmus Kupari,C,WPG,24,0,0,0,0
27,8481550,Adam Beckman,L,MIN,23,0,0,0,0
27,8481422,Jacob Lucchini,C,MIN,29,0,0,0,0
27,8477401,John Hayden,C,SEA,29,0,0,0,0
27,8478904,Steven Lorentz,C,FLA,28,0,0,0,0
27,8482088,Justin Sourdif,R,FLA,22,0,0,0,0
27,8482751,Ryan Winterton,C,SEA,21,0,0,0,0
27,8482241,Radim Zohorna,L,PIT,28,0,0,0,0
27,8481690,Tyler Angle,C,CBJ,24,0,0,0,0
27,8476952,Dominic Toninato,C,WPG,30,0,0,0,0
27,8476919,Chris Tierney,C,NJD,30,0,0,0,0
27,8480032,Shane Bowers,C,NJD,25,0,0,0,0
27,8484314,Jiri Smejkal,L,OTT,28,0,0,0,0
27,8481239,Samuel Fagemo,L,LAK,24,0,0,0,0
27,8481532,Alex Turcotte,C,LAK,23,0,0,0,0
27,8481019,David Gustafsson,C,WPG,24,0,0,0,0
27,8478477,Mitchell Stephens,C,MTL,27,0,0,0,0
27,8479546,Oskar Steen,C,BOS,26,0,0,0,0
27,8480292,Carson Meyer,R,CBJ,27,0,0,0,0
27,8478446,Glenn Gawdin,C,ANA,27,0,0,0,0
27,8483531,Brian Halonen,L,NJD,25,0,0,0,0
27,8477149,Scott Sabourin,R,SJS,32,0,0,0,0
27,8479972,Mason Shaw,C,MIN,26,0,0,0,0
27,8480890,Jan Jenik,R,ARI,24,0,0,0,0
27,8478051,Max Willman,C,NJD,29,0,0,0,0
27,8480851,Akil Thomas,C,LAK,24,0,0,0,0
27,8482765,Isak Rosen,R,BUF,21,0,0,0,0
27,8478421,A.J. Greer,L,CGY,28,0,0,0,0
27,8478512,Austin Czarnik,C,DET,32,0,0,0,0
27,8479536,Axel Jonsson-Fjallby,L,WPG,26,0,0,0,0
27,8477320,Anton Blidh,L,NYR,29,0,0,0,0
27,8481543,Nikita Alexandrov,C,STL,24,0,0,0,0
27,8475235,Nicolas Deslauriers,L,PHI,33,0,0,0,0
27,8481070,Hugh McGing,L,STL,26,0,0,0,0
27,8480836,Jonathan Gruden,C,PIT,24,0,0,0,0
27,8481591,Sam Poulin,R,PIT,23,0,0,0,0
27,8477962,Brendan Lemieux,L,CAR,28,0,0,0,0
27,8483401,Marc Johnstone,R,PIT,28,0,0,0,0
27,8482250,Callahan Burke,C,CAR,27,0,0,0,0
27,8481726,Adam Edstrom,C,NYR,24,0,0,0,0
27,8471817,Ryan Reaves,R,TOR,37,0,0,0,0
27,8479587,Rhett Gardner,C,PHI,28,0,0,0,0
27,8475766,Austin Watson,L,TBL,32,0,0,0,0
27,8479367,William Lockwood,R,FLA,26,0,0,0,0
27,8478424,Jansen Harkins,C,PIT,27,0,0,0,0
27,8476913,Devin Shore,C,SEA,30,0,0,0,0
27,8482652,Walker Duehr,R,CGY,27,0,0,0,0
27,8477527,Ross Johnston,L,ANA,30,0,0,0,0
27,8481077,John Leonard,L,ARI,26,0,0,0,0
27,8483549,Lucas Condotta,L,MTL,27,0,0,0,0
27,8480468,James Hamblin,L,EDM,25,0,0,0,0
27,8476907,Mackenzie MacEachern,L,STL,30,0,0,0,0
27,8479543,Michael Pezzetta,L,MTL,26,0,0,0,0
27,8480355,Mark Kastelic,C,OTT,25,0,0,0,0
27,8482162,Roby Jarventie,L,OTT,22,0,0,0,0
27,8479772,Zack MacEwen,R,OTT,28,0,0,0,0
27,8483597,Milos Kelemen,L,ARI,25,0,0,0,0
27,8479379,Givani Smith,R,SJS,26,0,0,0,0
27,8481655,Cole Schwindt,R,CGY,23,0,0,0,0
27,8479981,Jonah Gadjovich,L,FLA,26,0,0,0,0
27,8482147,Jean-Luc Foudy,C,COL,22,0,0,0,0
27,8484255,Jason Polin,R,COL,25,0,0,0,0
27,8477993,Justin Kirkland,C,ARI,28,0,0,0,0
27,8479249,Andrew Poturalski,C,SEA,30,0,0,0,0
27,8482197,Adam Raska,R,MIN,23,0,0,0,0
27,8475780,Chris Wagner,R,COL,33,0,0,0,0
27,8479533,Joona Koppanen,L,PIT,26,0,0,0,0
27,8481534,Raphael Lavoie,C,EDM,24,0,0,0,0
27,8484321,Nikolas Matinpalo,D,OTT,26,0,0,0,0
27,8481043,Cole Koepke,L,TBL,26,0,0,0,0
27,8476323,Max McCormick,L,SEA,32,0,0,0,0
27,8483609,Adam Klapka,R,CGY,24,0,0,0,0
27,8483512,Matt Savoie,C,BUF,20,0,0,0,0
27,8484259,Ondrej Pavel,C,COL,31,0,0,0,0
27,8478147,Bokondji Imama,L,OTT,28,0,0,0,0
27,8482460,Matt Rempe,C,NYR,22,0,0,0,0
27,8477073,Kurtis MacDermid,L,NJD,30,0,0,0,0
27,8480274,Philip Kemp,D,EDM,25,0,0,0,0
27,8478956,Samuel Laberge,L,NJD,27,0,0,0,0
27,8483045,Cameron Butler,R,CBJ,31,0,0,0,0
28,8477934,Leon Draisaitl,C,EDM,29,82,53,80,133
28,8478402,Connor McDavid,C,EDM,27,82,31,92,123
28,8476453,Nikita Kucherov,R,TBL,31,82,33,82,115
28,8479318,Auston Matthews,C,TOR,27,82,50,54,104
28,8477956,David Pastrnak,R,BOS,28,82,51,48,99
28,8477939,William Nylander,R,TOR,28,82,38,58,96
28,8481559,Jack Hughes,C,NJD,23,82,32,64,96
28,8477492,Nathan MacKinnon,C,COL,29,82,43,52,95
28,8480027,Jason Robertson,L,DAL,25,82,37,58,95
28,8480012,Elias Pettersson,C,VAN,26,82,34,59,93
28,8478864,Kirill Kaprizov,L,MIN,27,82,39,53,92
28,8478550,Artemi Panarin,L,NYR,33,82,39,52,91
28,8479314,Matthew Tkachuk,L,FLA,27,82,33,57,90
28,8480801,Brady Tkachuk,L,OTT,25,82,41,47,88
28,8471675,Sidney Crosby,C,PIT,37,82,40,47,87
28,8476459,Mika Zibanejad,C,NYR,31,82,33,54,87
28,8480002,Nico Hischier,C,NJD,25,82,39,46,85
28,8477493,Aleksander Barkov,C,FLA,29,82,29,56,85
28,8476887,Filip Forsberg,L,NSH,30,82,38,46,84
28,8478010,Brayden Point,C,TBL,28,82,44,39,83
28,8476346,Johnny Gaudreau,L,CBJ,31,82,19,64,83
28,8475166,John Tavares,C,TOR,34,82,40,41,81
28,8474141,Patrick Kane,R,DET,36,82,34,46,80
28,8476454,Ryan Nugent-Hopkins,C,EDM,31,82,25,55,80
28,8478420,Mikko Rantanen,R,COL,28,82,27,52,79
28,8479337,Alex DeBrincat,R,DET,27,82,36,41,77
28,8478444,Brock Boeser,R,VAN,27,82,49,27,76
28,8480800,Quinn Hughes,D,VAN,25,82,13,63,76
28,8474600,Roman Josi,D,NSH,34,82,22,53,75
28,8478449,Roope Hintz,C,DAL,28,82,38,36,74
28,8476468,J.T. Miller,C,VAN,31,82,23,51,74
28,8477933,Sam Reinhart,C,FLA,29,82,29,44,73
28,8477402,Pavel Buchnevich,L,STL,29,82,29,44,73
28,8480023,Robert Thomas,C,STL,25,82,20,53,73
28,8477946,Dylan Larkin,C,DET,28,82,27,45,72
28,8480069,Cale Makar,D,COL,26,82,22,50,72
28,8476389,Vincent Trocheck,C,NYR,31,82,29,42,71
28,8477404,Jake Guentzel,C,CAR,30,82,26,45,71
28,8475786,Zach Hyman,L,EDM,32,82,40,30,70
28,8477409,Carter Verhaeghe,C,FLA,29,82,34,36,70
28,8481540,Cole Caufield,R,MTL,23,82,37,32,69
28,8476539,Jonathan Marchessault,R,VGK,34,82,33,36,69
28,8477496,Elias Lindholm,C,VAN,30,82,27,42,69
28,8474564,Steven Stamkos,C,TBL,34,82,25,44,69
28,8477504,Josh Morrissey,D,WPG,29,82,20,49,69
28,8475692,Mats Zuccarello,R,MIN,37,82,17,52,69
28,8478403,Jack Eichel,C,VGK,28,82,29,39,68
28,8477942,Kevin Fiala,L,LAK,28,82,24,44,68
28,8481523,Kirby Dach,C,MTL,23,82,9,58,67
28,8477949,Alex Tuch,R,BUF,28,82,28,38,66
28,8479385,Jordan Kyrou,C,STL,26,82,27,39,66
28,8479542,Brandon Hagel,L,TBL,26,82,22,44,66
28,8480803,Evan Bouchard,D,EDM,25,82,15,51,66
28,8478439,Travis Konecny,R,PHI,27,82,31,34,65
28,8475172,Nazem Kadri,C,CGY,34,82,25,40,65
28,8470794,Joe Pavelski,C,DAL,40,82,24,41,65
28,8479410,Mikhail Sergachev,D,TBL,26,82,10,55,65
28,8477960,Adrian Kempe,R,LAK,28,82,34,30,64
28,8471214,Alex Ovechkin,L,WSH,39,82,28,36,64
28,8480018,Nick Suzuki,C,MTL,25,82,28,36,64
28,8480208,Drake Batherson,R,OTT,26,82,23,41,64
28,8478414,Timo Meier,R,NJD,28,82,38,25,63
28,8475169,Evander Kane,L,EDM,33,82,33,30,63
28,8477501,Valeri Nichushkin,R,COL,29,82,30,33,63
28,8479343,Clayton Keller,R,ARI,26,82,28,35,63
28,8478398,Kyle Connor,L,WPG,28,82,26,37,63
28,8478873,Troy Terry,R,ANA,27,82,19,44,63
28,8478460,Zach Werenski,D,CBJ,27,82,18,45,63
28,8476456,Jonathan Huberdeau,C,CGY,31,82,14,49,63
28,8480036,Miro Heiskanen,D,DAL,25,82,11,52,63
28,8475184,Chris Kreider,L,NYR,33,82,36,26,62
28,8481557,Matt Boldy,L,MIN,23,82,31,31,62
28,8482097,Jack Quinn,R,BUF,23,82,27,35,62
28,8474590,John Carlson,D,WSH,34,82,21,41,62
28,8478445,Mathew Barzal,C,NYI,27,82,21,41,62
28,8474586,Jordan Eberle,R,SEA,34,82,20,42,62
28,8478407,Vince Dunn,D,SEA,28,82,15,47,62
28,8475726,Tyler Toffoli,C,WPG,32,82,35,26,61
28,8475765,Vladimir Tarasenko,R,FLA,33,82,28,33,61
28,8478427,Sebastian Aho,C,CAR,27,82,26,35,61
28,8482078,Lucas Raymond,L,DET,22,82,23,38,61
28,8474578,Erik Karlsson,D,PIT,34,82,22,39,61
28,8483808,Andrei Kuzmenko,L,CGY,28,82,19,42,61
28,8473512,Claude Giroux,R,OTT,36,82,14,47,61
28,8478493,Joel Eriksson Ek,C,MIN,27,82,32,28,60
28,8482116,Tim Stützle,C,OTT,22,82,26,34,60
28,8477416,Oliver Bjorkstrand,R,SEA,29,82,26,34,60
28,8478856,Conor Garland,R,VAN,28,82,24,36,60
28,8478047,Michael Bunting,L,PIT,29,82,21,39,60
28,8482745,Mason McTavish,C,ANA,21,82,20,40,60
28,8482740,Wyatt Johnston,C,DAL,21,82,26,33,59
28,8476460,Mark Scheifele,C,WPG,31,82,23,36,59
28,8477479,Tyler Bertuzzi,L,TOR,29,82,20,39,59
28,8475158,Ryan O'Reilly,C,NSH,33,82,17,42,59
28,8480830,Andrei Svechnikov,R,CAR,24,82,23,35,58
28,8479675,Trevor Moore,L,LAK,29,82,23,35,58
28,8480839,Rasmus Dahlin,D,BUF,24,82,16,42,58
28,8471724,Kris Letang,D,PIT,37,82,16,42,58
28,8479323,Adam Fox,D,NYR,26,82,10,48,58
28,8474150,Mikael Backlund,C,CGY,35,82,24,33,57
28,8473994,Jamie Benn,L,DAL,35,82,21,36,57
28,8477476,Artturi Lehkonen,L,COL,29,82,30,26,56
28,8477955,Jared McCann,L,SEA,28,82,24,32,56
28,8478042,Viktor Arvidsson,R,LAK,31,82,21,35,56
28,8471215,Evgeni Malkin,C,PIT,38,82,20,36,56
28,8477346,MacKenzie Weegar,D,CGY,30,82,19,37,56
28,8473419,Brad Marchand,L,BOS,36,82,18,38,56
28,8474641,Adam Henrique,C,EDM,34,82,27,28,55
28,8479400,Pierre-Luc Dubois,L,LAK,26,82,23,32,55
28,8480039,Martin Necas,C,CAR,25,82,22,33,55
28,8479407,Jesper Bratt,L,NJD,26,82,21,34,55
28,8475913,Mark Stone,R,VGK,32,82,19,36,55
28,8478440,Dylan Strome,C,WSH,27,82,18,37,55
28,8477494,Jonathan Drouin,L,COL,29,82,16,39,55
28,8475167,Victor Hedman,D,TBL,34,82,9,46,55
28,8475151,Kyle Palmieri,C,NYI,33,82,32,22,54
28,8482159,Tyson Foerster,R,PHI,22,82,21,33,54
28,8480865,Noah Dobson,D,NYI,24,82,14,40,54
28,8477500,Bo Horvat,C,NYI,29,82,28,25,53
28,8475784,Jeff Skinner,C,BUF,32,82,25,28,53
28,8474102,David Perron,L,DET,36,82,16,37,53
28,8477986,Brandon Montour,D,FLA,30,82,13,40,53
28,8480014,Gabriel Vilardi,C,WPG,25,82,29,23,52
28,8478466,Daniel Sprong,R,DET,27,82,25,27,52
28,8476880,Tom Wilson,R,WSH,30,82,24,28,52
28,8478498,Jake DeBrusk,L,BOS,28,82,23,29,52
28,8481528,Dylan Cozens,C,BUF,23,82,19,33,52
28,8478438,Tommy Novak,C,NSH,27,82,17,35,52
28,8475754,Brock Nelson,C,NYI,33,82,15,37,52
28,8476906,Shayne Gostisbehere,D,DET,31,82,9,43,52
28,8475314,Anders Lee,L,NYI,34,82,28,23,51
28,8481596,Shane Pinto,C,OTT,24,82,25,26,51
28,8471685,Anze Kopitar,C,LAK,37,82,14,37,51
28,8476853,Morgan Rielly,D,TOR,30,82,8,43,51
28,8481542,Moritz Seider,D,DET,23,82,6,45,51
28,8478038,Devon Toews,D,COL,30,82,4,47,51
28,8477456,J.T. Compher,L,DET,29,82,23,27,50
28,8482665,Matty Beniers,C,SEA,22,82,17,33,50
28,8476826,Yanni Gourde,C,SEA,33,82,17,33,50
28,8479325,Charlie McAvoy,D,BOS,27,82,13,37,50
28,8479425,Filip Hronek,D,VAN,27,82,13,37,50
28,8476462,Dougie Hamilton,D,NJD,31,82,11,39,50
28,8475798,Mikael Granlund,C,SJS,32,82,10,40,50
28,8477407,Anthony Duclair,L,TBL,29,82,29,20,49
28,8479420,Tage Thompson,C,BUF,27,82,26,23,49
28,8477935,Sam Bennett,C,FLA,28,82,23,26,49
28,8475810,Bryan Rust,R,PIT,32,82,22,27,49
28,8477951,Nick Schmaltz,C,ARI,28,82,18,31,49
28,8477444,Andre Burakovsky,L,SEA,29,82,17,32,49
28,8476483,Rickard Rakell,R,PIT,31,82,26,22,48
28,8480015,Owen Tippett,R,PHI,25,82,22,26,48
28,8476881,Tomas Hertl,C,VGK,31,82,21,27,48
28,8479999,Casey Mittelstadt,C,COL,26,82,16,32,48
28,8477451,Ryan Hartman,R,MIN,30,82,16,32,48
28,8478469,Thomas Chabot,D,OTT,27,82,14,34,48
28,8477948,Travis Sanheim,D,PHI,28,82,13,35,48
28,8477447,Shea Theodore,D,VGK,29,82,6,42,48
28,8480893,Kirill Marchenko,R,CBJ,24,82,28,19,47
28,8482124,Quinton Byfield,R,LAK,22,82,21,26,47
28,8481533,Trevor Zegras,C,ANA,23,82,17,30,47
28,8476329,Travis Boyd,C,ARI,31,82,15,32,47
28,8476905,Chandler Stephenson,C,VGK,30,82,14,33,47
28,8480434,Sean Durzi,D,ARI,26,82,14,33,47
28,8482684,Luke Hughes,D,NJD,21,82,10,37,47
28,8476432,Boone Jenner,C,CBJ,31,82,28,18,46
28,8482109,Alexis Lafrenière,L,NYR,23,82,27,19,46
28,8475794,Tyler Seguin,C,DAL,32,82,23,23,46
28,8480188,Fabian Zetterlund,L,SJS,25,82,21,25,46
28,8476882,Teuvo Teravainen,L,CAR,30,82,20,26,46
28,8475168,Matt Duchene,C,DAL,33,82,17,29,46
28,8478975,Mason Marchment,L,DAL,29,82,17,29,46
28,8480031,Maxime Comtois,L,CAR,25,82,14,32,46
28,8480064,Josh Norris,C,OTT,25,82,28,17,45
28,8475191,Reilly Smith,R,PIT,33,82,24,21,45
28,8477952,Robby Fabbri,C,DET,28,82,22,23,45
28,8475768,Jaden Schwartz,C,SEA,32,82,20,25,45
28,8476479,Phillip Danault,C,LAK,31,82,17,28,45
28,8477503,Max Domi,C,TOR,29,82,12,33,45
28,8478396,Noah Hanifin,D,VGK,27,82,10,35,45
28,8476480,Vladislav Namestnikov,C,WPG,32,82,15,29,44
28,8481711,Matias Maccelli,L,ARI,24,82,12,32,44
28,8470613,Brent Burns,D,CAR,39,82,10,34,44
28,8478474,Lawson Crouse,L,ARI,27,82,30,13,43
28,8483524,Shane Wright,C,SEA,20,82,29,14,43
28,8478233,Andrew Mangiapane,L,CGY,28,82,20,23,43
28,8480078,Filip Chytil,C,NYR,25,82,17,26,43
28,8482146,Luke Evangelista,R,NSH,22,82,17,26,43
28,8474679,Gustav Nyquist,C,NSH,35,82,14,29,43
28,8475745,Charlie Coyle,C,BOS,32,82,11,32,43
28,8474563,Drew Doughty,D,LAK,35,82,7,36,43
28,8481016,Ruslan Iskhakov,C,NYI,24,82,5,38,43
28,8482089,Jake Neighbours,L,STL,22,82,27,15,42
28,8476448,William Karlsson,C,VGK,31,82,20,22,42
28,8482110,Dawson Mercer,C,NJD,23,82,20,22,42
28,8478519,Anthony Cirelli,C,TBL,27,82,20,22,42
28,8473986,Alex Killorn,L,ANA,35,82,19,23,42
28,8477940,Nikolaj Ehlers,L,WPG,28,82,18,24,42
28,8482705,Cole Sillinger,C,CBJ,21,82,17,25,42
28,8483445,Cutter Gauthier,L,ANA,20,82,16,26,42
28,8478401,Pavel Zacha,C,BOS,27,82,16,26,42
28,8477497,Sean Monahan,C,WPG,30,82,16,26,42
28,8480798,Philipp Kurashev,C,CHI,25,82,15,27,42
28,8476792,Torey Krug,D,STL,33,82,7,35,42
28,8478397,Rasmus Andersson,D,CGY,28,82,4,38,42
28,8476399,Blake Coleman,C,CGY,33,82,24,17,41
28,8475793,Ryan Johansen,C,PHI,32,82,19,22,41
28,8478413,Jordan Greenway,L,BUF,27,82,15,26,41
28,8478542,Evan Rodrigues,C,FLA,31,82,14,27,41
28,8480043,Timothy Liljegren,D,TOR,25,82,12,29,41
28,8480802,Ryan McLeod,C,EDM,25,82,11,30,41
28,8475197,Tyson Barrie,D,NSH,33,82,11,30,41
28,8482113,Anton Lundell,C,FLA,23,82,20,20,40
28,8479423,Alex Nylander,L,CBJ,26,82,20,20,40
28,8482175,JJ Peterka,R,BUF,22,82,17,23,40
28,8478472,Mathieu Joseph,R,OTT,27,82,15,25,40
28,8475170,Brayden Schenn,C,STL,33,82,14,26,40
28,8482092,Ridly Greig,C,OTT,22,82,14,26,40
28,8476875,Mike Matheson,D,MTL,30,82,13,27,40
28,8481581,Thomas Harley,D,DAL,23,82,12,28,40
28,8481699,Aku Raty,R,ARI,23,82,0,40,40
28,8471698,T.J. Oshie,R,WSH,38,82,17,22,39
28,8476292,Ondrej Palat,L,NJD,33,82,15,24,39
28,8482667,William Eklund,L,SJS,22,82,12,27,39
28,8480220,Noah Cates,L,PHI,25,82,12,27,39
28,8482105,Jake Sanderson,D,OTT,22,82,10,29,39
28,8475763,Kevin Hayes,R,STL,32,82,10,29,39
28,8476854,Hampus Lindholm,D,BOS,30,82,4,35,39
28,8481068,Yegor Sharangovich,C,CGY,26,82,18,20,38
28,8477998,Warren Foegele,L,EDM,28,82,16,22,38
28,8480009,Eeli Tolvanen,R,SEA,25,82,16,22,38
28,8478055,Gustav Forsling,D,FLA,28,82,8,30,38
28,8483397,Marc McLaughlin,C,BOS,25,82,30,7,37
28,8479525,Ross Colton,C,COL,28,82,22,15,37
28,8475714,Calle Jarnkrok,C,TOR,33,82,20,17,37
28,8475799,Nino Niederreiter,R,WPG,32,82,20,17,37
28,8478463,Anthony Beauvillier,L,NSH,27,82,19,18,37
28,8480028,Morgan Frost,C,PHI,25,82,15,22,37
28,8482720,Matthew Knies,L,TOR,22,82,14,23,37
28,8482133,Thomas Bordeleau,C,SJS,22,82,11,26,37
28,8476923,Damon Severson,D,CBJ,30,82,10,27,37
28,8475753,Justin Faulk,D,STL,32,82,9,28,37
28,8475760,Nick Bjugstad,C,ARI,32,82,23,13,36
28,8483515,Juraj Slafkovsky,L,MTL,20,82,19,17,36
28,8474157,Max Pacioretty,L,WSH,36,82,18,18,36
28,8481618,Alex Newhook,C,MTL,23,82,15,21,36
28,8477495,Seth Jones,D,CHI,30,82,13,23,36
28,8474037,James van Riemsdyk,L,BOS,35,82,13,23,36
28,8476392,Adam Lowry,C,WPG,31,82,10,26,36
28,8477498,Darnell Nurse,D,EDM,29,82,8,28,36
28,8470621,Corey Perry,R,EDM,39,82,20,15,35
28,8479339,Patrik Laine,L,CBJ,26,82,14,21,35
28,8477964,Ivan Barbashev,C,VGK,29,82,13,22,35
28,8474189,Lars Eller,C,PIT,35,82,11,24,35
28,8479351,Sam Steel,C,DAL,26,82,10,25,35
28,8476958,Jaccob Slavin,D,CAR,30,82,7,28,35
28,8475764,Cam Fowler,D,ANA,33,82,7,28,35
28,8475906,John Klingberg,D,TOR,32,82,6,29,35
28,8484203,Bradly Nadeau,L,CAR,19,82,22,12,34
28,8475722,Jason Zucker,L,NSH,32,82,21,13,34
28,8478366,Frank Vatrano,R,ANA,30,82,15,19,34
28,8473449,Kyle Okposo,R,FLA,36,82,14,20,34
28,8480797,Joel Farabee,L,PHI,24,82,11,23,34
28,8473563,Nicklas Backstrom,C,WSH,37,82,10,24,34
28,8474053,Logan Couture,C,SJS,35,82,8,26,34
28,8479345,Jakob Chychrun,D,OTT,26,82,8,26,34
28,8475744,Evgeny Kuznetsov,C,CAR,32,82,7,27,34
28,8480246,Nick Perbix,D,TBL,26,82,5,29,34
28,8476457,Adam Larsson,D,SEA,32,82,3,31,34
28,8482074,Connor Zary,C,CGY,23,82,17,16,33
28,8479996,Cody Glass,C,NSH,25,82,16,17,33
28,8481535,Nils Hoglander,L,VAN,24,82,15,18,33
28,8480855,Jack McBain,C,ARI,24,82,14,19,33
28,8480817,K'Andre Miller,D,NYR,24,82,7,26,33
28,8477511,Anthony Mantha,R,VGK,30,82,21,11,32
28,8474715,Cam Atkinson,R,PHI,35,82,18,14,32
28,8480113,Alex Iafallo,L,WPG,31,82,15,17,32
28,8477429,Andrew Copp,C,DET,30,82,15,17,32
28,8478046,Danton Heinen,L,BOS,29,82,13,19,32
28,8478458,Jack Roslovic,C,NYR,27,82,12,20,32
28,8476872,Scott Laughton,C,PHI,30,82,12,20,32
28,8476979,Erik Gustafsson,D,NYR,32,82,8,24,32
28,8478178,Darren Raddysh,D,TBL,28,82,6,26,32
28,8481178,Egor Zamula,D,PHI,24,82,4,28,32
28,8483471,Brad Lambert,C,WPG,31,82,3,29,32
28,8483457,Lane Hutson,D,MTL,20,82,1,31,32
28,8477426,Nicholas Paul,L,TBL,29,82,20,11,31
28,8476981,Josh Anderson,R,MTL,30,82,20,11,31
28,8482101,Danil Gushchin,L,SJS,22,82,19,12,31
28,8479393,Noah Gregor,C,TOR,26,82,18,13,31
28,8478057,Dakota Joshua,C,VAN,28,82,18,13,31
28,8477944,Jakub Vrana,L,STL,28,82,18,13,31
28,8480806,Isac Lundestrom,C,ANA,25,82,16,15,31
28,8474149,Evgenii Dadonov,R,DAL,35,82,15,16,31
28,8484144,Connor Bedard,C,CHI,19,82,14,17,31
28,8478115,Pierre Engvall,L,NYI,28,82,14,17,31
28,8480459,Pius Suter,C,VAN,28,82,12,19,31
28,8482093,Seth Jarvis,C,CAR,22,82,11,20,31
28,8481013,Jonatan Berggren,R,DET,24,82,11,20,31
28,8480185,Eetu Luostarinen,C,FLA,26,82,11,20,31
28,8480873,Rasmus Sandin,D,WSH,24,82,7,24,31
28,8475218,Mattias Ekholm,D,EDM,34,82,5,26,31
28,8480145,Neal Pionk,D,WPG,29,82,4,27,31
28,8479398,Samuel Girard,D,COL,26,82,3,28,31
28,8483499,Liam Ohgren,L,MIN,20,82,17,13,30
28,8479941,Justin Danforth,R,CBJ,31,82,16,14,30
28,8480068,Ryan Poehling,C,PHI,25,82,15,15,30
28,8479365,Trent Frederic,C,BOS,26,82,14,16,30
28,8482079,Marco Rossi,C,MIN,23,82,12,18,30
28,8482055,Drew O'Connor,L,PIT,26,82,10,20,30
28,8476419,Jean-Gabriel Pageau,C,NYI,32,82,10,20,30
28,8481703,Valtteri Puustinen,R,PIT,25,82,9,21,30
28,8482475,Yegor Chinakhov,R,CBJ,23,82,8,22,30
28,8480871,Adam Boqvist,D,CBJ,24,82,6,24,30
28,8474716,Jared Spurgeon,D,MIN,35,82,6,24,30
28,8475171,Oliver Ekman-Larsson,D,FLA,33,82,6,24,30
28,8476927,Teddy Blueger,C,VAN,30,82,6,24,30
28,8470610,Zach Parise,L,COL,40,82,19,10,29
28,8476438,Brandon Saad,L,STL,32,82,17,12,29
28,8476925,Colton Sissons,C,NSH,31,82,14,15,29
28,8479293,Brandon Tanev,L,SEA,33,82,13,16,29
28,8478500,Ivan Provorov,D,CBJ,27,82,11,18,29
28,8476869,Brady Skjei,D,CAR,30,82,10,19,29
28,8479316,Luke Kunin,C,SJS,27,82,10,19,29
28,8477932,Aaron Ekblad,D,FLA,28,82,9,20,29
28,8479987,Morgan Geekie,C,BOS,26,82,9,20,29
28,8482111,Justin Barron,D,MTL,23,82,8,21,29
28,8474565,Alex Pietrangelo,D,VGK,34,82,7,22,29
28,8474673,TJ Brodie,D,TOR,34,82,3,26,29
28,8482155,Alex Laferriere,R,LAK,23,82,21,7,28
28,8481601,Simon Holmstrom,R,NYI,23,82,17,11,28
28,8479390,Taylor Raddysh,R,CHI,26,82,14,14,28
28,8470604,Jeff Carter,C,PIT,39,82,13,15,28
28,8480849,Barrett Hayton,C,ARI,24,82,11,17,28
28,8477425,Miles Wood,L,COL,29,82,11,17,28
28,8482087,Kaiden Guhle,D,MTL,22,82,10,18,28
28,8477392,Hudson Fasching,R,NYI,29,82,10,18,28
28,8477021,Alex Kerfoot,C,ARI,30,82,9,19,28
28,8481481,Blake Lizotte,C,LAK,27,82,9,19,28
28,8480144,David Kampf,C,TOR,29,82,9,19,28
28,8476897,Oskar Sundqvist,C,STL,30,82,8,20,28
28,8481656,Aliaksei Protas,C,WSH,23,82,7,21,28
28,8479353,Brett Howden,C,VGK,26,82,7,21,28
28,8476885,Jacob Trouba,D,NYR,30,82,3,25,28
28,8480821,Filip Zadina,R,SJS,25,82,19,8,27
28,8484145,Zach Benson,L,BUF,19,82,16,11,27
28,8481477,Nico Sturm,C,SJS,29,82,16,11,27
28,8479977,Kailer Yamamoto,R,SEA,26,82,16,11,27
28,8474870,Tyler Johnson,C,CHI,34,82,15,12,27
28,8481560,Arthur Kaliyev,R,LAK,23,82,14,13,27
28,8480813,Joe Veleno,C,DET,24,82,14,13,27
28,8478020,Michael Amadio,C,VGK,28,82,14,13,27
28,8476461,Sean Couturier,C,PHI,32,82,12,15,27
28,8481186,Logan O'Connor,R,COL,28,82,10,17,27
28,8478133,Jake Evans,C,MTL,28,82,10,17,27
28,8482699,Dylan Guenther,R,ARI,21,82,9,18,27
28,8483490,Pavel Mintyukov,D,ANA,21,82,9,18,27
28,8477505,Alexander Wennberg,C,NYR,30,82,8,19,27
28,8482671,Owen Power,D,BUF,22,82,7,20,27
28,8482142,Jamie Drysdale,D,PHI,22,82,5,22,27
28,8481546,Cam York,D,PHI,23,82,5,22,27
28,8475462,Radko Gudas,D,ANA,34,82,5,22,27
28,8482118,Sam Colangelo,R,ANA,23,82,22,4,26
28,8478569,Noel Acciari,C,PIT,33,82,16,10,26
28,8483431,Logan Cooley,C,ARI,20,82,15,11,26
28,8480281,Alexey Toropchenko,R,STL,25,82,15,11,26
28,8481554,Kaapo Kakko,R,NYR,23,82,13,13,26
28,8475848,Brendan Gallagher,R,MTL,32,82,13,13,26
28,8475149,Marcus Johansson,L,MIN,34,82,11,15,26
28,8481537,Nikita Okhotiuk,D,CGY,24,82,11,15,26
28,8480336,Sean Walker,D,COL,30,82,11,15,26
28,8477989,Christian Dvorak,C,MTL,28,82,10,16,26
28,8478109,Victor Olofsson,L,BUF,29,82,10,16,26
28,8481704,Juuso Parssinen,C,NSH,23,82,9,17,26
28,8476879,Cody Ceci,D,EDM,31,82,8,18,26
28,8479992,Michael Rasmussen,C,DET,25,82,7,19,26
28,8479998,Mikey Anderson,D,LAK,25,82,7,19,26
28,8476917,Adam Pelech,D,NYI,30,82,5,21,26
28,8477969,Marcus Pettersson,D,PIT,28,82,4,22,26
28,8475790,Erik Gudbranson,D,CBJ,32,82,4,22,26
28,8481604,Pavel Dorofeyev,L,VGK,24,82,17,8,25
28,8484166,Adam Fantilli,C,CBJ,20,82,13,12,25
28,8480980,Connor Dewar,C,TOR,25,82,13,12,25
28,8482222,Alexander Barabanov,L,SJS,30,82,12,13,25
28,8471218,Blake Wheeler,R,NYR,38,82,12,13,25
28,8474884,Mike Hoffman,C,SJS,35,82,12,13,25
28,8482062,Cole Smith,L,NSH,29,82,12,13,25
28,8476960,Andreas Athanasiou,C,CHI,30,82,10,15,25
28,8477953,Kasperi Kapanen,R,STL,28,82,9,16,25
28,8475279,Ben Chiarot,D,DET,33,82,9,16,25
28,8477839,Conor Sheary,L,TBL,32,82,9,16,25
28,8476921,Jordan Martinook,L,CAR,32,82,8,17,25
28,8482624,Daniil Miromanov,D,CGY,27,82,7,18,25
28,8477506,Ryan Pulock,D,NYI,30,82,7,18,25
28,8482733,Logan Mailloux,D,MTL,31,82,5,20,25
28,8476331,Dylan DeMelo,D,WPG,31,82,4,21,25
28,8477353,Tyler Motte,C,TBL,29,82,16,8,24
28,8482125,Alexander Holtz,R,NJD,22,82,14,10,24
28,8475231,Casey Cizikas,C,NYI,33,82,12,12,24
28,8481580,Connor McMichael,C,WSH,23,82,11,13,24
28,8477508,Curtis Lazar,C,NJD,29,82,11,13,24
28,8482702,Logan Stankoven,C,DAL,21,82,10,14,24
28,8481522,Peyton Krebs,C,BUF,23,82,8,16,24
28,8476312,Josh Manson,D,COL,33,82,7,17,24
28,8478882,Vladislav Gavrikov,D,LAK,29,82,7,17,24
28,8473504,Cal Clutterbuck,R,NYI,37,82,7,17,24
28,8475791,Taylor Hall,L,CHI,33,82,6,18,24
28,8476871,Tanner Pearson,L,MTL,32,82,6,18,24
28,8475179,Dmitry Kulikov,D,FLA,34,82,5,19,24
28,8473507,Jeff Petry,D,DET,37,82,4,20,24
28,8477435,Ryan Graves,D,PIT,29,82,2,22,24
28,8478851,Alexandre Carrier,D,NSH,28,82,1,23,24
28,8475188,Brayden McNabb,D,VGK,33,82,1,23,24
28,8482737,Zack Bolduc,C,STL,21,82,17,6,23
28,8483012,Logan Morrison,C,SEA,22,82,17,6,23
28,8481624,Ilya Mikheyev,R,VAN,30,82,12,11,23
28,8479346,Dillon Dube,C,CGY,26,82,12,11,23
28,8476469,Joel Armia,R,MTL,31,82,12,11,23
28,8477450,Jason Dickinson,C,CHI,29,82,11,12,23
28,8478508,Yakov Trenin,C,COL,27,82,11,12,23
28,8481553,Bobby Brink,R,PHI,23,82,9,14,23
28,8477507,Nikita Zadorov,D,VAN,29,82,9,14,23
28,8478911,Matt Roy,D,LAK,29,82,8,15,23
28,8476442,Matt Nieto,L,PIT,32,82,7,16,23
28,8478013,Jake Walman,D,DET,28,82,6,17,23
28,8476463,Jonas Brodin,D,MIN,31,82,6,17,23
28,8476374,Sean Kuraly,C,CBJ,31,82,6,17,23
28,8476467,Jamie Oleksiak,D,SEA,32,82,6,17,23
28,8479976,Juuso Valimaki,D,ARI,26,82,3,20,23
28,8477488,Brett Pesce,D,CAR,30,82,2,21,23
28,8482122,Brock Faber,D,MIN,22,82,1,22,23
28,8478507,John Marino,D,NJD,27,82,0,23,23
28,8479661,Tanner Jeannot,L,TBL,27,82,14,8,22
28,8477330,Dominik Kubalik,L,OTT,29,82,12,10,22
28,8482145,Mavrik Bourque,C,DAL,22,82,12,10,22
28,8478891,Mason Appleton,C,WPG,28,82,11,11,22
28,8474009,Nick Bonino,C,NYR,36,82,8,14,22
28,8479371,Dante Fabbro,D,NSH,26,82,6,16,22
28,8476458,Ryan Strome,C,ANA,31,82,5,17,22
28,8478451,Ethan Bear,D,WSH,27,82,5,17,22
28,8482245,Artem Zub,D,OTT,29,82,4,18,22
28,8477845,Trevor van Riemsdyk,D,WSH,33,82,3,19,22
28,8474151,Ryan McDonagh,D,NSH,35,82,1,21,22
28,8481517,Brett Leason,R,ANA,25,82,13,8,21
28,8475220,Marcus Foligno,L,MIN,33,82,11,10,21
28,8482259,Bobby McMann,C,TOR,28,82,11,10,21
28,8476624,Barclay Goodrow,C,NYR,31,82,9,12,21
28,8478043,Sam Lafferty,C,VAN,29,82,9,12,21
28,8475287,Erik Haula,L,NJD,33,82,8,13,21
28,8475200,Dmitry Orlov,D,CAR,33,82,8,13,21
28,8484153,Leo Carlsson,C,ANA,20,82,8,13,21
28,8479359,Beck Malenstyn,L,WSH,26,82,8,13,21
28,8478430,Oliver Kylington,D,CGY,27,82,7,14,21
28,8477365,Connor Clifton,D,BUF,29,82,6,15,21
28,8477220,Nate Schmidt,D,WPG,33,82,4,17,21
28,8475690,Chris Tanev,D,DAL,35,82,4,17,21
28,8476892,Colton Parayko,D,STL,31,82,3,18,21
28,8470966,Mark Giordano,D,TOR,41,82,3,18,21
28,8475181,Nick Leddy,D,STL,33,82,2,19,21
28,8477499,Rasmus Ristolainen,D,PHI,30,82,2,19,21
28,8483491,Ivan Miroshnichenko,L,WSH,20,82,15,5,20
28,8476873,Mark Jankowski,C,NSH,30,82,13,7,20
28,8478462,Nicolas Roy,C,VGK,27,82,11,9,20
28,8477947,Sonny Milano,L,WSH,28,82,10,10,20
28,8475164,Jakob Silfverberg,R,ANA,34,82,7,13,20
28,8481014,Alexander Romanov,D,NYI,24,82,6,14,20
28,8483565,Nick Blankenburg,D,CBJ,26,82,6,14,20
28,8481606,Jordan Spence,D,LAK,23,82,2,18,20
28,8482809,Jackson Blake,R,CAR,21,82,14,5,19
28,8473533,Jordan Staal,C,CAR,36,82,11,8,19
28,8479514,Rem Pitlick,C,CHI,27,82,10,9,19
28,8481093,Rafael Harvey-Pinard,L,MTL,25,82,10,9,19
28,8476915,Jujhar Khaira,L,MIN,30,82,9,10,19
28,8476278,Colin Blackwell,C,CHI,31,82,8,11,19
28,8473453,Trevor Lewis,C,LAK,37,82,8,11,19
28,8482117,Lukas Reichel,L,CHI,22,82,7,12,19
28,8478468,Jeremy Lauzon,D,NSH,27,82,7,12,19
28,8475455,Brenden Dillon,D,WPG,34,82,5,14,19
28,8476422,Mike Reilly,D,NYI,31,82,5,14,19
28,8474013,Ian Cole,D,VAN,35,82,5,14,19
28,8482712,Oskar Olausson,R,COL,22,82,4,15,19
28,8480035,Henri Jokiharju,D,BUF,25,82,3,16,19
28,8476931,Jake McCabe,D,TOR,31,82,2,17,19
28,8476473,Connor Murphy,D,CHI,31,82,2,17,19
28,8479591,Michael Eyssimont,C,TBL,28,82,13,5,18
28,8480448,Parker Kelly,L,OTT,25,82,9,9,18
28,8480073,Erik Brannstrom,D,OTT,25,82,6,12,18
28,8482730,Brandt Clarke,D,LAK,21,82,6,12,18
28,8477369,Carson Soucy,D,VAN,30,82,6,12,18
28,8478416,Erik Cernak,D,TBL,27,82,6,12,18
28,8482655,J.J. Moser,D,ARI,24,82,5,13,18
28,8482679,Matt Coronato,R,CGY,22,82,5,13,18
28,8479980,Nicolas Hague,D,VGK,26,82,5,13,18
28,8476525,Colin Miller,D,WPG,32,82,3,15,18
28,8482858,Ryker Evans,D,SEA,23,82,1,17,18
28,8475208,Brian Dumoulin,D,SEA,33,82,1,17,18
28,8480879,Jacob Bernard-Docker,D,OTT,24,82,0,18,18
28,8483493,Frank Nazar,C,CHI,20,82,13,4,17
28,8475842,Sam Carrick,C,EDM,32,82,7,10,17
28,8479983,Mario Ferraro,D,SJS,26,82,7,10,17
28,8483505,Matthew Poitras,C,BOS,20,82,6,11,17
28,8470600,Ryan Suter,D,DAL,39,82,6,11,17
28,8476967,Brett Kulak,D,EDM,30,82,5,12,17
28,8477335,Kyle Burroughs,D,SJS,29,82,5,12,17
28,8476429,Scott Mayfield,D,NYI,32,82,4,13,17
28,8480834,Ty Emberson,D,SJS,24,82,2,15,17
28,8478136,Jake Middleton,D,MIN,28,82,2,15,17
28,8481567,Henry Thrun,D,SJS,23,82,1,16,17
28,8474574,Tyler Myers,D,VAN,34,82,1,16,17
28,8476891,Matt Grzelcyk,D,BOS,30,82,1,16,17
28,8475343,Nic Dowd,C,WSH,34,82,8,8,16
28,8474034,Pat Maroon,L,BOS,36,82,8,8,16
28,8476858,Phillip Di Giuseppe,L,VAN,31,82,8,8,16
28,8476878,Zemgus Girgensons,L,BUF,30,82,8,8,16
28,8480074,Alexandre Texier,C,CBJ,25,82,7,9,16
28,8477931,Tomas Nosek,L,NJD,32,82,7,9,16
28,8478408,Travis Dermott,D,ARI,28,82,6,10,16
28,8477015,Connor Brown,R,EDM,30,82,6,10,16
28,8476822,Luke Glendening,C,TBL,35,82,6,10,16
28,8473422,Nick Foligno,L,CHI,37,82,5,11,16
28,8480796,Martin Fehervary,D,WSH,25,82,5,11,16
28,8477919,Frederick Gaudreau,C,MIN,31,82,4,12,16
28,8479415,Michael McLeod,C,NJD,26,82,3,13,16
28,8478840,Will Borgen,D,SEA,28,82,3,13,16
28,8483495,Simon Nemec,D,NJD,20,82,3,13,16
28,8481524,Bowen Byram,D,BUF,23,82,3,13,16
28,8478443,Brandon Carlo,D,BOS,28,82,3,13,16
28,8482073,Braden Schneider,D,NYR,23,82,2,14,16
28,8480807,Mattias Samuelsson,D,BUF,24,82,1,15,16
28,8478831,Kevin Stenlund,C,FLA,28,82,9,6,15
28,8483489,Fraser Minten,C,TOR,31,82,9,6,15
28,8482177,Marat Khusnutdinov,C,MIN,22,82,7,8,15
28,8477406,Mattias Janmark,C,EDM,32,82,6,9,15
28,8481028,Martin Pospisil,C,CGY,25,82,5,10,15
28,8474166,Alec Martinez,D,VGK,37,82,5,10,15
28,8481599,Victor Soderstrom,D,ARI,23,82,5,10,15
28,8476902,Esa Lindell,D,DAL,30,82,4,11,15
28,8474567,Zach Bogosian,D,MIN,34,82,1,14,15
28,8479291,Kevin Rooney,C,CGY,31,82,6,8,14
28,8478399,Jonas Siegenthaler,D,NJD,27,82,4,10,14
28,8479369,Andrew Peeke,D,BOS,26,82,3,11,14
28,8482803,Olen Zellweger,D,ANA,21,82,3,11,14
28,8483482,Tristan Luneau,D,ANA,20,82,3,11,14
28,8479324,Ryan Lindgren,D,NYR,26,82,3,11,14
28,8475762,Derek Forbort,D,BOS,32,82,3,11,14
28,8471677,Jack Johnson,D,COL,37,82,3,11,14
28,8475825,Jani Hakanpää,D,DAL,32,82,1,13,14
28,8482166,Shakir Mukhamadullin,D,SJS,22,82,7,6,13
28,8482666,Scott Morrow,D,CAR,22,82,7,6,13
28,8479442,Troy Stecher,D,EDM,30,82,5,8,13
28,8481059,Scott Perunovich,D,STL,26,82,5,8,13
28,8475324,Nick Jensen,D,WSH,34,82,2,11,13
28,8479383,Boris Katchouk,L,OTT,26,82,6,6,12
28,8480172,Jan Rutta,D,SJS,34,82,4,8,12
28,8482516,Matthew Kessel,D,STL,24,82,3,9,12
28,8477034,Jaycob Megna,D,CHI,32,82,2,10,12
28,8482470,Ilya Solovyov,D,CGY,24,82,1,11,12
28,8480860,Kevin Bahl,D,NJD,24,82,1,11,12
28,8481605,Jackson LaCombe,D,ANA,23,82,4,7,11
28,8480058,Pierre-Olivier Joseph,D,PIT,25,82,2,9,11
28,8478859,Niko Mikkola,D,FLA,28,82,2,9,11
28,8475177,Calvin de Haan,D,TBL,33,82,2,9,11
28,8484911,Collin Graf,R,SJS,22,82,1,10,11
28,8481568,Alex Vlasic,D,CHI,23,82,0,11,11
28,8480990,Declan Chisholm,D,MIN,24,82,6,4,10
28,8475233,David Savard,D,MTL,34,82,2,8,10
28,8484149,Gavin Brindley,C,CBJ,20,82,2,8,10
28,8483466,Kevin Korchinski,D,CHI,20,82,1,9,10
28,8482762,Simon Edvinsson,D,DET,21,82,6,3,9
28,8481578,Graeme Clarke,R,NJD,23,82,5,3,8
28,8476372,Nick Seeler,D,PHI,31,82,3,5,8
28,8483763,Maksymilian Szuber,D,ARI,22,82,2,6,8
28,8481030,Jack St. Ivany,D,PIT,25,82,1,7,8
28,8482859,Zack Ostapchuk,C,OTT,21,82,0,8,8
28,8482713,Mackie Samoskevich,R,FLA,22,82,2,5,7
28,8483468,Jiri Kulich,C,BUF,20,82,1,5,6
28,8482807,Ethan Del Mastro,D,CHI,21,82,1,2,3
28,8482141,Lukas Cormier,D,VGK,22,0,0,0,0
28,8476988,Matt Benning,D,SJS,30,0,0,0,0
28,8480727,Zach Whitecloud,D,VGK,28,0,0,0,0
28,8480887,Jordan Harris,D,MTL,24,0,0,0,0
28,8478450,Parker Wotherspoon,D,BOS,27,0,0,0,0
28,8481812,Nikolai Knyzhov,D,SJS,27,0,0,0,0
28,8480001,Urho Vaakanainen,D,ANA,25,0,0,0,0
28,8482176,Wyatt Kaiser,D,CHI,22,0,0,0,0
28,8481122,Simon Benoit,D,TOR,26,0,0,0,0
28,8476441,Joel Edmundson,D,TOR,31,0,0,0,0
28,8480884,Calen Addison,D,SJS,24,0,0,0,0
28,8482511,Mason Lohrei,D,BOS,23,0,0,0,0
28,8482192,Isaak Phillips,D,CHI,23,0,0,0,0
28,8480950,Ilya Lyubushkin,D,TOR,30,0,0,0,0
28,8474031,Kevin Shattenkirk,D,BOS,35,0,0,0,0
28,8475718,Justin Holl,D,DET,32,0,0,0,0
28,8479402,Jake Bean,D,CBJ,26,0,0,0,0
28,8474602,Justin Schultz,D,SEA,34,0,0,0,0
28,8477950,Tony DeAngelo,D,CAR,29,0,0,0,0
28,8481743,Marc Del Gaizo,D,NSH,25,0,0,0,0
28,8481527,Kaedan Korczak,D,VGK,23,0,0,0,0
28,8480192,Johnathan Kovacevic,D,MTL,27,0,0,0,0
28,8476874,Olli Maatta,D,DET,30,0,0,0,0
28,8482144,Jack Thompson,D,SJS,22,0,0,0,0
28,8480222,Sebastian Aho,D,NYI,28,0,0,0,0
28,8479458,Nikita Zaitsev,D,CHI,33,0,0,0,0
28,8471709,Marc-Edouard Vlasic,D,SJS,37,0,0,0,0
28,8482929,Emil Lilleberg,D,TBL,23,0,0,0,0
28,8477018,Ben Hutton,D,VGK,31,0,0,0,0
28,8481056,Spencer Stastney,D,NSH,24,0,0,0,0
28,8481593,Jayden Struble,D,MTL,23,0,0,0,0
28,8479982,Conor Timmins,D,TOR,26,0,0,0,0
28,8474090,Brendan Smith,D,NJD,35,0,0,0,0
28,8482964,Arber Xhekaj,D,MTL,23,0,0,0,0
28,8480891,Michael Kesselring,D,ARI,24,0,0,0,0
28,8477938,Haydn Fleury,D,TBL,28,0,0,0,0
28,8481806,Louis Crevier,D,CHI,23,0,0,0,0
28,8471274,Alex Goligoski,D,MIN,39,0,0,0,0
28,8481600,Tobias Bjornfot,D,FLA,23,0,0,0,0
28,8475797,Jarred Tinordi,D,CHI,32,0,0,0,0
28,8481521,Ronnie Attard,D,PHI,25,0,0,0,0
28,8474612,Travis Hamonic,D,OTT,34,0,0,0,0
28,8479576,Vincent Desharnais,D,EDM,28,0,0,0,0
28,8480049,Dylan Samberg,D,WPG,25,0,0,0,0
28,8483619,Filip Roos,D,CHI,25,0,0,0,0
28,8474568,Luke Schenn,D,NSH,35,0,0,0,0
28,8480184,Gustav Lindstrom,D,ANA,26,0,0,0,0
28,8480070,Ian Mitchell,D,BOS,25,0,0,0,0
28,8480196,Jacob Bryson,D,BUF,27,0,0,0,0
28,8471686,Marc Staal,D,PHI,37,0,0,0,0
28,8477467,Gustav Olofsson,D,SEA,30,0,0,0,0
28,8478970,Jalen Chatfield,D,CAR,28,0,0,0,0
28,8479348,Kale Clague,D,BUF,26,0,0,0,0
28,8473446,Erik Johnson,D,PHI,36,0,0,0,0
28,8477462,Robert Hagg,D,ANA,29,0,0,0,0
28,8478454,Noah Juulsen,D,VAN,27,0,0,0,0
28,8477384,Josh Brown,D,ARI,30,0,0,0,0
28,8481708,Zac Jones,D,NYR,24,0,0,0,0
28,8481167,Brayden Pachal,D,CGY,25,0,0,0,0
28,8482067,Connor Mackey,D,NYR,28,0,0,0,0
28,8483460,David Jiricek,D,CBJ,21,0,0,0,0
28,8481701,Santeri Hatakka,D,NJD,23,0,0,0,0
28,8478021,William Lagesson,D,ANA,28,0,0,0,0
28,8477851,Jordan Oesterle,D,CGY,32,0,0,0,0
28,8478452,Caleb Jones,D,COL,27,0,0,0,0
28,8479984,Cal Foote,D,NJD,26,0,0,0,0
28,8479639,Dylan Coghlan,D,CAR,26,0,0,0,0
28,8480874,Adam Ginning,D,PHI,24,0,0,0,0
28,8479321,Lucas Johansen,D,WSH,27,0,0,0,0
28,8480878,Nils Lundkvist,D,DAL,24,0,0,0,0
28,8482165,Yan Kuznetsov,D,CGY,22,0,0,0,0
28,8484258,Sam Malinski,D,COL,26,0,0,0,0
28,8480157,Calle Rosen,D,STL,30,0,0,0,0
28,8484304,Uvis Balinskis,D,FLA,28,0,0,0,0
28,8479985,Cale Fleury,D,SEA,26,0,0,0,0
28,8479378,Logan Stanley,D,WPG,26,0,0,0,0
28,8477541,Dakota Mermis,D,MIN,30,0,0,0,0
28,8481609,Vladislav Kolyachonok,D,ARI,23,0,0,0,0
28,8480823,Alexander Alexeyev,D,WSH,25,0,0,0,0
28,8481679,Maxence Guenette,D,OTT,23,0,0,0,0
28,8481564,Ryan Johnson,D,BUF,23,0,0,0,0
28,8479376,Victor Mete,D,PHI,26,0,0,0,0
28,8484254,Akito Hirose,D,VAN,25,0,0,0,0
28,8482660,Kent Johnson,C,CBJ,22,0,0,0,0
28,8482149,Cole Perfetti,C,WPG,22,0,0,0,0
28,8477987,Ryan Donato,C,CHI,28,0,0,0,0
28,8475755,Alexander Petrovic,D,DAL,32,0,0,0,0
28,8477810,Joel Hanley,D,CGY,33,0,0,0,0
28,8474145,Robert Bortuzzo,D,NYI,35,0,0,0,0
28,8481161,Jake Christiansen,D,CBJ,25,0,0,0,0
28,8476884,Derrick Pouliot,D,DAL,30,0,0,0,0
28,8481716,Dmitri Voronkov,L,CBJ,24,0,0,0,0
28,8480084,Nick DeSimone,D,NJD,30,0,0,0,0
28,8475750,Jon Merrill,D,MIN,32,0,0,0,0
28,8479315,Joey Anderson,R,CHI,26,0,0,0,0
28,8478011,Louie Belpedio,D,PHI,28,0,0,0,0
28,8482451,Mikael Pyyhtia,L,CBJ,23,0,0,0,0
28,8481541,Samuel Bolduc,D,NYI,24,0,0,0,0
28,8482126,Emil Andrae,D,PHI,31,0,0,0,0
28,8474618,Marco Scandella,D,STL,34,0,0,0,0
28,8477244,Chad Ruhwedel,D,NYR,34,0,0,0,0
28,8477971,Andreas Englund,D,LAK,28,0,0,0,0
28,8480829,Jesperi Kotkaniemi,C,CAR,24,0,0,0,0
28,8479372,Josh Mahura,D,FLA,26,0,0,0,0
28,8482095,Tyler Kleven,D,OTT,22,0,0,0,0
28,8481719,Maxwell Crozier,D,TBL,24,0,0,0,0
28,8475855,Jesper Fast,R,CAR,33,0,0,0,0
28,8480848,Ty Dellandrea,C,DAL,24,0,0,0,0
28,8475193,Tomas Tatar,L,SEA,34,0,0,0,0
28,8476889,Radek Faksa,C,DAL,30,0,0,0,0
28,8478495,Denis Gurianov,R,PHI,27,0,0,0,0
28,8480216,Jacob Peterson,C,SJS,25,0,0,0,0
28,8480252,Cole Guttman,C,CHI,25,0,0,0,0
28,8479026,Philippe Myers,D,TBL,27,0,0,0,0
28,8481006,Tyler Tucker,D,STL,24,0,0,0,0
28,8481032,Paul Cotter,C,VGK,25,0,0,0,0
28,8481577,Philip Tomasino,C,NSH,23,0,0,0,0
28,8476918,Jimmy Vesey,L,NYR,31,0,0,0,0
28,8479320,Max Lajoie,D,TOR,27,0,0,0,0
28,8478017,Mark Friedman,D,VAN,29,0,0,0,0
28,8481754,Nikita Nesterenko,C,ANA,23,0,0,0,0
28,8483407,Brandon Scanlin,D,NYR,25,0,0,0,0
28,8482659,Josh Doan,R,ARI,22,0,0,0,0
28,8477446,Michael McCarron,R,NSH,29,0,0,0,0
28,8477903,Garnet Hathaway,R,PHI,33,0,0,0,0
28,8482153,Brendan Brisson,C,VGK,23,0,0,0,0
28,8483546,Marshall Rifai,D,TOR,26,0,0,0,0
28,8484287,Cole McWard,D,VAN,23,0,0,0,0
28,8478854,Ryan Shea,D,PIT,27,0,0,0,0
28,8481585,Egor Afanasyev,L,NSH,23,0,0,0,0
28,8483398,Declan Carlile,D,TBL,31,0,0,0,0
28,8478502,Dennis Gilbert,D,CGY,28,0,0,0,0
28,8482749,Joshua Roy,R,MTL,21,0,0,0,0
28,8481598,Philip Broberg,D,EDM,23,0,0,0,0
28,8480835,Jack Drury,C,CAR,24,0,0,0,0
28,8480748,Kiefer Sherwood,L,NSH,29,0,0,0,0
28,8476934,Brock McGinn,L,ANA,30,0,0,0,0
28,8480870,Bo Groulx,C,ANA,24,0,0,0,0
28,8479368,Max Jones,L,ANA,26,0,0,0,0
28,8478099,Kevin Labanc,R,SJS,29,0,0,0,0
28,8478067,Oskar Lindblom,L,SJS,28,0,0,0,0
28,8476393,Nick Cousins,C,FLA,31,0,0,0,0
28,8483395,Arshdeep Bains,L,VAN,23,0,0,0,0
28,8480762,Eric Robinson,L,BUF,29,0,0,0,0
28,8479439,Jacob MacDonald,D,SJS,31,0,0,0,0
28,8476474,Stefan Noesen,R,CAR,31,0,0,0,0
28,8482787,Nikita Chibrikov,R,WPG,31,0,0,0,0
28,8478432,Christian Fischer,R,DET,27,0,0,0,0
28,8477979,Nicolas Aube-Kubel,R,WSH,28,0,0,0,0
28,8481789,Tye Kartye,L,SEA,23,0,0,0,0
28,8479330,Brandon Gignac,C,MTL,27,0,0,0,0
28,8480075,Cameron Crotty,D,ARI,25,0,0,0,0
28,8473473,Milan Lucic,L,BOS,36,0,0,0,0
28,8482094,Daemon Hunt,D,MIN,22,0,0,0,0
28,8481206,John Ludvig,D,PIT,24,0,0,0,0
28,8483630,Pavol Regenda,L,ANA,25,0,0,0,0
28,8481617,Vasily Podkolzin,R,VAN,23,0,0,0,0
28,8480306,Grant Hutton,D,NYI,29,0,0,0,0
28,8480995,Pontus Holmberg,R,TOR,25,0,0,0,0
28,8482148,Hendrix Lapierre,C,WSH,22,0,0,0,0
28,8477478,William Carrier,L,VGK,30,0,0,0,0
28,8480003,Jesper Boqvist,C,BOS,26,0,0,0,0
28,8482172,Landon Slaggert,L,CHI,22,0,0,0,0
28,8480789,Oliver Wahlstrom,R,NYI,24,0,0,0,0
28,8474062,Riley Nash,C,NYR,35,0,0,0,0
28,8480021,Jack Studnicka,C,SJS,25,0,0,0,0
28,8480025,MacKenzie Entwistle,R,CHI,25,0,0,0,0
28,8481582,Nicholas Robertson,L,TOR,23,0,0,0,0
28,8476867,Brendan Gaunce,C,CBJ,30,0,0,0,0
28,8479619,Michael Carcone,L,ARI,28,0,0,0,0
28,8479370,Tyson Jost,C,BUF,26,0,0,0,0
28,8479671,Mathieu Olivier,R,CBJ,27,0,0,0,0
28,8476994,Vinnie Hinostroza,C,PIT,30,0,0,0,0
28,8482070,Mitchell Chaffee,R,TBL,26,0,0,0,0
28,8477473,Justin Bailey,R,SJS,29,0,0,0,0
28,8479344,Jesse Puljujarvi,R,PIT,26,0,0,0,0
28,8480205,Emil Bemstrom,C,PIT,25,0,0,0,0
28,8479718,Alex Barré-Boulet,C,TBL,27,0,0,0,0
28,8482061,Brandon Biro,L,BUF,26,0,0,0,0
28,8479638,Justin Brazeau,R,BOS,26,0,0,0,0
28,8474040,Sam Gagner,C,EDM,35,0,0,0,0
28,8477846,Ryan Carpenter,C,SJS,33,0,0,0,0
28,8482077,Dylan Holloway,L,EDM,23,0,0,0,0
28,8482157,Will Cuylle,L,NYR,22,0,0,0,0
28,8480007,Jonas Rondbjerg,R,VGK,25,0,0,0,0
28,8478874,Adam Gaudette,C,STL,28,0,0,0,0
28,8478434,Keegan Kolesar,R,VGK,27,0,0,0,0
28,8480441,Trey Fix-Wolansky,R,CBJ,25,0,0,0,0
28,8479994,Jaret Anderson-Dolan,C,NSH,25,0,0,0,0
28,8483567,Georgii Merkulov,C,BOS,24,0,0,0,0
28,8477380,Jonny Brodzinski,C,NYR,31,0,0,0,0
28,8482201,Gage Goncalves,C,TBL,23,0,0,0,0
28,8478211,Dryden Hunt,L,CGY,29,0,0,0,0
28,8471699,Andrew Cogliano,C,COL,37,0,0,0,0
28,8479421,Jacob Moverare,D,LAK,26,0,0,0,0
28,8478881,Brett Seney,L,CHI,28,0,0,0,0
28,8477464,Nic Petan,C,MIN,29,0,0,0,0
28,8475958,Michael Sgarbossa,C,WSH,32,0,0,0,0
28,8481147,Reese Johnson,C,CHI,26,0,0,0,0
28,8479336,Carl Grundstrom,R,LAK,27,0,0,0,0
28,8480853,Liam Foudy,C,NSH,24,0,0,0,0
28,8479522,Hardy Haman Aktell,D,WSH,26,0,0,0,0
28,8481462,Mason Morelli,L,VGK,28,0,0,0,0
28,8482102,Vasily Ponomarev,C,CAR,22,0,0,0,0
28,8480844,Grigori Denisenko,L,VGK,24,0,0,0,0
28,8479944,Zach Aston-Reese,C,DET,30,0,0,0,0
28,8482784,Zach Dean,C,STL,21,0,0,0,0
28,8479419,Brett Murray,L,BUF,26,0,0,0,0
28,8479520,Brandon Duhaime,R,COL,27,0,0,0,0
28,8477573,Nathan Walker,L,STL,30,0,0,0,0
28,8478078,Rourke Chartier,C,OTT,28,0,0,0,0
28,8475795,Dylan McIlrath,D,WSH,32,0,0,0,0
28,8482496,Nils Aman,C,VAN,24,0,0,0,0
28,8480289,Morgan Barron,C,WPG,26,0,0,0,0
28,8481751,Lukas Rousek,R,BUF,25,0,0,0,0
28,8480011,Klim Kostin,C,SJS,25,0,0,0,0
28,8481556,John Beecher,C,BOS,23,0,0,0,0
28,8475278,Byron Froese,C,VGK,33,0,0,0,0
28,8475225,Craig Smith,C,DAL,35,0,0,0,0
28,8484326,Patrik Koch,D,ARI,28,0,0,0,0
28,8477930,Pierre-Edouard Bellemare,L,SEA,39,0,0,0,0
28,8478409,Anthony Richard,C,BOS,28,0,0,0,0
28,8481024,Linus Karlsson,C,VAN,25,0,0,0,0
28,8479986,Kole Lind,R,SEA,26,0,0,0,0
28,8479414,Nathan Bastian,R,NJD,27,0,0,0,0
28,8479362,Riley Tufte,L,COL,26,0,0,0,0
28,8481058,Jesse Ylönen,R,MTL,25,0,0,0,0
28,8482476,Emil Heineman,L,MTL,23,0,0,0,0
28,8482861,Vincent Iorio,D,WSH,22,0,0,0,0
28,8483432,Luca Del Bel Belluz,C,CBJ,31,0,0,0,0
28,8482744,James Malatesta,L,CBJ,21,0,0,0,0
28,8477887,Patrick Brown,C,BOS,32,0,0,0,0
28,8478585,Derek Ryan,C,EDM,38,0,0,0,0
28,8481441,Joe Snively,C,WSH,28,0,0,0,0
28,8481592,Jakob Pelletier,L,CGY,23,0,0,0,0
28,8482634,Alex Steeves,C,TOR,25,0,0,0,0
28,8477126,Jayson Megna,C,BOS,34,0,0,0,0
28,8475752,Tyler Pitlick,C,NYR,33,0,0,0,0
28,8480008,Adam Ruzicka,C,ARI,25,0,0,0,0
28,8481065,Angus Crookshank,L,OTT,25,0,0,0,0
28,8479547,Matthew Phillips,R,WSH,26,0,0,0,0
28,8480226,Marián Studenic,R,SEA,26,0,0,0,0
28,8481237,Kyle MacLean,C,NYI,25,0,0,0,0
28,8475413,Justin Dowling,C,NJD,34,0,0,0,0
28,8481641,Joel Kiviranta,L,COL,28,0,0,0,0
28,8478104,Sammy Blais,L,STL,28,0,0,0,0
28,8477454,Adam Erne,L,EDM,29,0,0,0,0
28,8481518,Nolan Foote,L,NJD,24,0,0,0,0
28,8480245,Olle Lycksell,R,PHI,25,0,0,0,0
28,8483570,Ben Meyers,C,ANA,26,0,0,0,0
28,8480776,Sheldon Rempal,R,VGK,29,0,0,0,0
28,8483920,Pierrick Dube,R,WSH,23,0,0,0,0
28,8480267,Sammy Walker,C,MIN,25,0,0,0,0
28,8482747,Brennan Othmann,L,NYR,21,0,0,0,0
28,8479991,Jake Leschyshyn,C,NYR,25,0,0,0,0
28,8478400,Colin White,C,MTL,27,0,0,0,0
28,8479328,Julien Gauthier,R,NYI,27,0,0,0,0
28,8484325,Waltteri Merela,C,TBL,26,0,0,0,0
28,8479066,Ryan Lomberg,L,FLA,30,0,0,0,0
28,8477070,Liam O'Brien,C,ARI,30,0,0,0,0
28,8478146,Matthew Highmore,C,OTT,28,0,0,0,0
28,8478028,Fredrik Olofsson,L,COL,28,0,0,0,0
28,8480880,Jakub Lauko,C,BOS,24,0,0,0,0
28,8479968,Vinni Lettieri,C,MIN,29,0,0,0,0
28,8474709,Matt Martin,L,NYI,35,0,0,0,0
28,8480845,Rasmus Kupari,C,WPG,24,0,0,0,0
28,8481550,Adam Beckman,L,MIN,23,0,0,0,0
28,8481422,Jacob Lucchini,C,MIN,29,0,0,0,0
28,8477401,John Hayden,C,SEA,29,0,0,0,0
28,8478904,Steven Lorentz,C,FLA,28,0,0,0,0
28,8482088,Justin Sourdif,R,FLA,22,0,0,0,0
28,8482751,Ryan Winterton,C,SEA,21,0,0,0,0
28,8482241,Radim Zohorna,L,PIT,28,0,0,0,0
28,8481690,Tyler Angle,C,CBJ,24,0,0,0,0
28,8476952,Dominic Toninato,C,WPG,30,0,0,0,0
28,8476919,Chris Tierney,C,NJD,30,0,0,0,0
28,8480032,Shane Bowers,C,NJD,25,0,0,0,0
28,8484314,Jiri Smejkal,L,OTT,28,0,0,0,0
28,8481239,Samuel Fagemo,L,LAK,24,0,0,0,0
28,8481532,Alex Turcotte,C,LAK,23,0,0,0,0
28,8481019,David Gustafsson,C,WPG,24,0,0,0,0
28,8478477,Mitchell Stephens,C,MTL,27,0,0,0,0
28,8479546,Oskar Steen,C,BOS,26,0,0,0,0
28,8480292,Carson Meyer,R,CBJ,27,0,0,0,0
28,8478446,Glenn Gawdin,C,ANA,27,0,0,0,0
28,8483531,Brian Halonen,L,NJD,25,0,0,0,0
28,8477149,Scott Sabourin,R,SJS,32,0,0,0,0
28,8479972,Mason Shaw,C,MIN,26,0,0,0,0
28,8480890,Jan Jenik,R,ARI,24,0,0,0,0
28,8478051,Max Willman,C,NJD,29,0,0,0,0
28,8480851,Akil Thomas,C,LAK,24,0,0,0,0
28,8482765,Isak Rosen,R,BUF,21,0,0,0,0
28,8478421,A.J. Greer,L,CGY,28,0,0,0,0
28,8478512,Austin Czarnik,C,DET,32,0,0,0,0
28,8479536,Axel Jonsson-Fjallby,L,WPG,26,0,0,0,0
28,8477320,Anton Blidh,L,NYR,29,0,0,0,0
28,8481543,Nikita Alexandrov,C,STL,24,0,0,0,0
28,8475235,Nicolas Deslauriers,L,PHI,33,0,0,0,0
28,8481070,Hugh McGing,L,STL,26,0,0,0,0
28,8480836,Jonathan Gruden,C,PIT,24,0,0,0,0
28,8481591,Sam Poulin,R,PIT,23,0,0,0,0
28,8477962,Brendan Lemieux,L,CAR,28,0,0,0,0
28,8483401,Marc Johnstone,R,PIT,28,0,0,0,0
28,8482250,Callahan Burke,C,CAR,27,0,0,0,0
28,8481726,Adam Edstrom,C,NYR,24,0,0,0,0
28,8471817,Ryan Reaves,R,TOR,37,0,0,0,0
28,8479587,Rhett Gardner,C,PHI,28,0,0,0,0
28,8475766,Austin Watson,L,TBL,32,0,0,0,0
28,8479367,William Lockwood,R,FLA,26,0,0,0,0
28,8478424,Jansen Harkins,C,PIT,27,0,0,0,0
28,8476913,Devin Shore,C,SEA,30,0,0,0,0
28,8482652,Walker Duehr,R,CGY,27,0,0,0,0
28,8477527,Ross Johnston,L,ANA,30,0,0,0,0
28,8481077,John Leonard,L,ARI,26,0,0,0,0
28,8483549,Lucas Condotta,L,MTL,27,0,0,0,0
28,8480468,James Hamblin,L,EDM,25,0,0,0,0
28,8476907,Mackenzie MacEachern,L,STL,30,0,0,0,0
28,8479543,Michael Pezzetta,L,MTL,26,0,0,0,0
28,8480355,Mark Kastelic,C,OTT,25,0,0,0,0
28,8482162,Roby Jarventie,L,OTT,22,0,0,0,0
28,8479772,Zack MacEwen,R,OTT,28,0,0,0,0
28,8483597,Milos Kelemen,L,ARI,25,0,0,0,0
28,8479379,Givani Smith,R,SJS,26,0,0,0,0
28,8481655,Cole Schwindt,R,CGY,23,0,0,0,0
28,8479981,Jonah Gadjovich,L,FLA,26,0,0,0,0
28,8482147,Jean-Luc Foudy,C,COL,22,0,0,0,0
28,8484255,Jason Polin,R,COL,25,0,0,0,0
28,8477993,Justin Kirkland,C,ARI,28,0,0,0,0
28,8479249,Andrew Poturalski,C,SEA,30,0,0,0,0
28,8482197,Adam Raska,R,MIN,23,0,0,0,0
28,8475780,Chris Wagner,R,COL,33,0,0,0,0
28,8479533,Joona Koppanen,L,PIT,26,0,0,0,0
28,8481534,Raphael Lavoie,C,EDM,24,0,0,0,0
28,8484321,Nikolas Matinpalo,D,OTT,26,0,0,0,0
28,8481043,Cole Koepke,L,TBL,26,0,0,0,0
28,8476323,Max McCormick,L,SEA,32,0,0,0,0
28,8483609,Adam Klapka,R,CGY,24,0,0,0,0
28,8483512,Matt Savoie,C,BUF,20,0,0,0,0
28,8484259,Ondrej Pavel,C,COL,31,0,0,0,0
28,8478147,Bokondji Imama,L,OTT,28,0,0,0,0
28,8482460,Matt Rempe,C,NYR,22,0,0,0,0
28,8477073,Kurtis MacDermid,L,NJD,30,0,0,0,0
28,8480274,Philip Kemp,D,EDM,25,0,0,0,0
28,8478956,Samuel Laberge,L,NJD,27,0,0,0,0
28,8483045,Cameron Butler,R,CBJ,31,0,0,0,0
29,8478402,Connor McDavid,C,EDM,27,82,47,91,138
29,8479318,Auston Matthews,C,TOR,27,82,65,43,108
29,8477956,David Pastrnak,R,BOS,28,82,43,60,103
29,8479314,Matthew Tkachuk,L,FLA,27,82,36,65,101
29,8481559,Jack Hughes,C,NJD,23,82,35,65,100
29,8478864,Kirill Kaprizov,L,MIN,27,82,46,51,97
29,8476453,Nikita Kucherov,R,TBL,31,82,25,72,97
29,8480027,Jason Robertson,L,DAL,25,82,33,63,96
29,8478420,Mikko Rantanen,R,COL,28,82,48,45,93
29,8477934,Leon Draisaitl,C,EDM,29,82,41,51,92
29,8477492,Nathan MacKinnon,C,COL,29,82,35,56,91
29,8480800,Quinn Hughes,D,VAN,25,82,18,71,89
29,8471675,Sidney Crosby,C,PIT,37,82,34,54,88
29,8477933,Sam Reinhart,C,FLA,29,82,38,45,83
29,8477404,Jake Guentzel,C,CAR,30,82,27,54,81
29,8478550,Artemi Panarin,L,NYR,33,82,35,45,80
29,8480801,Brady Tkachuk,L,OTT,25,82,38,41,79
29,8476887,Filip Forsberg,L,NSH,30,82,32,47,79
29,8471214,Alex Ovechkin,L,WSH,39,82,39,39,78
29,8475166,John Tavares,C,TOR,34,82,34,43,77
29,8477409,Carter Verhaeghe,C,FLA,29,82,34,43,77
29,8476468,J.T. Miller,C,VAN,31,82,32,45,77
29,8480069,Cale Makar,D,COL,26,82,19,58,77
29,8478010,Brayden Point,C,TBL,28,82,40,36,76
29,8477493,Aleksander Barkov,C,FLA,29,82,30,46,76
29,8476456,Jonathan Huberdeau,C,CGY,31,82,11,63,74
29,8476460,Mark Scheifele,C,WPG,31,82,24,49,73
29,8481523,Kirby Dach,C,MTL,23,82,9,64,73
29,8475184,Chris Kreider,L,NYR,33,82,43,29,72
29,8478403,Jack Eichel,C,VGK,28,82,39,33,72
29,8480002,Nico Hischier,C,NJD,25,82,30,42,72
29,8477942,Kevin Fiala,L,LAK,28,82,31,40,71
29,8476454,Ryan Nugent-Hopkins,C,EDM,31,82,23,48,71
29,8474600,Roman Josi,D,NSH,34,82,20,51,71
29,8475172,Nazem Kadri,C,CGY,34,82,37,33,70
29,8475692,Mats Zuccarello,R,MIN,37,82,10,60,70
29,8479420,Tage Thompson,C,BUF,27,82,32,37,69
29,8477946,Dylan Larkin,C,DET,28,82,26,43,69
29,8479407,Jesper Bratt,L,NJD,26,82,24,45,69
29,8482116,Tim Stützle,C,OTT,22,82,22,47,69
29,8480803,Evan Bouchard,D,EDM,25,82,11,58,69
29,8481540,Cole Caufield,R,MTL,23,82,42,26,68
29,8477940,Nikolaj Ehlers,L,WPG,28,82,33,35,68
29,8479337,Alex DeBrincat,R,DET,27,82,31,37,68
29,8473512,Claude Giroux,R,OTT,36,82,26,42,68
29,8478398,Kyle Connor,L,WPG,28,82,33,34,67
29,8481557,Matt Boldy,L,MIN,23,82,31,36,67
29,8480012,Elias Pettersson,C,VAN,26,82,29,38,67
29,8478440,Dylan Strome,C,WSH,27,82,26,41,67
29,8476389,Vincent Trocheck,C,NYR,31,82,20,47,67
29,8474590,John Carlson,D,WSH,34,82,19,48,67
29,8475158,Ryan O'Reilly,C,NSH,33,82,30,36,66
29,8480023,Robert Thomas,C,STL,25,82,20,46,66
29,8476346,Johnny Gaudreau,L,CBJ,31,82,17,49,66
29,8475786,Zach Hyman,L,EDM,32,82,34,31,65
29,8474564,Steven Stamkos,C,TBL,34,82,30,35,65
29,8480830,Andrei Svechnikov,R,CAR,24,82,30,35,65
29,8478449,Roope Hintz,C,DAL,28,82,28,37,65
29,8471215,Evgeni Malkin,C,PIT,38,82,25,40,65
29,8478427,Sebastian Aho,C,CAR,27,82,19,46,65
29,8475726,Tyler Toffoli,C,WPG,32,82,34,30,64
29,8477939,William Nylander,R,TOR,28,82,31,33,64
29,8478047,Michael Bunting,L,PIT,29,82,25,39,64
29,8474141,Patrick Kane,R,DET,36,82,19,45,64
29,8477951,Nick Schmaltz,C,ARI,28,82,24,39,63
29,8474578,Erik Karlsson,D,PIT,34,82,21,42,63
29,8480865,Noah Dobson,D,NYI,24,82,17,46,63
29,8479385,Jordan Kyrou,C,STL,26,82,29,33,62
29,8477402,Pavel Buchnevich,L,STL,29,82,27,35,62
29,8480839,Rasmus Dahlin,D,BUF,24,82,12,50,62
29,8477955,Jared McCann,L,SEA,28,82,31,30,61
29,8480208,Drake Batherson,R,OTT,26,82,29,32,61
29,8476459,Mika Zibanejad,C,NYR,31,82,28,32,60
29,8478873,Troy Terry,R,ANA,27,82,28,32,60
29,8481533,Trevor Zegras,C,ANA,23,82,19,41,60
29,8478445,Mathew Barzal,C,NYI,27,82,18,42,60
29,8479325,Charlie McAvoy,D,BOS,27,82,11,49,60
29,8476853,Morgan Rielly,D,TOR,30,82,10,50,60
29,8482097,Jack Quinn,R,BUF,23,82,30,29,59
29,8475810,Bryan Rust,R,PIT,32,82,27,32,59
29,8476539,Jonathan Marchessault,R,VGK,34,82,26,33,59
29,8479343,Clayton Keller,R,ARI,26,82,24,35,59
29,8478414,Timo Meier,R,NJD,28,82,35,23,58
29,8475754,Brock Nelson,C,NYI,33,82,28,30,58
29,8473986,Alex Killorn,L,ANA,35,82,25,33,58
29,8471685,Anze Kopitar,C,LAK,37,82,21,37,58
29,8475798,Mikael Granlund,C,SJS,32,82,17,41,58
29,8478460,Zach Werenski,D,CBJ,27,82,15,43,58
29,8479323,Adam Fox,D,NYR,26,82,11,47,58
29,8478493,Joel Eriksson Ek,C,MIN,27,82,28,29,57
29,8477476,Artturi Lehkonen,L,COL,29,82,28,29,57
29,8478439,Travis Konecny,R,PHI,27,82,20,37,57
29,8476881,Tomas Hertl,C,VGK,31,82,20,37,57
29,8477504,Josh Morrissey,D,WPG,29,82,13,44,57
29,8478407,Vince Dunn,D,SEA,28,82,13,44,57
29,8482665,Matty Beniers,C,SEA,22,82,21,35,56
29,8481711,Matias Maccelli,L,ARI,24,82,15,41,56
29,8471698,T.J. Oshie,R,WSH,38,82,29,26,55
29,8477501,Valeri Nichushkin,R,COL,29,82,28,27,55
29,8476399,Blake Coleman,C,CGY,33,82,28,27,55
29,8478444,Brock Boeser,R,VAN,27,82,27,28,55
29,8477935,Sam Bennett,C,FLA,28,82,27,28,55
29,8480039,Martin Necas,C,CAR,25,82,24,31,55
29,8477949,Alex Tuch,R,BUF,28,82,17,38,55
29,8482684,Luke Hughes,D,NJD,21,82,13,42,55
29,8476432,Boone Jenner,C,CBJ,31,82,33,21,54
29,8475169,Evander Kane,L,EDM,33,82,32,22,54
29,8476826,Yanni Gourde,C,SEA,33,82,21,33,54
29,8475913,Mark Stone,R,VGK,32,82,20,34,54
29,8475167,Victor Hedman,D,TBL,34,82,9,45,54
29,8480015,Owen Tippett,R,PHI,25,82,32,21,53
29,8474157,Max Pacioretty,L,WSH,36,82,27,26,53
29,8475765,Vladimir Tarasenko,R,FLA,33,82,20,33,53
29,8477416,Oliver Bjorkstrand,R,SEA,29,82,17,36,53
29,8476875,Mike Matheson,D,MTL,30,82,12,41,53
29,8478233,Andrew Mangiapane,L,CGY,28,82,21,31,52
29,8474679,Gustav Nyquist,C,NSH,35,82,19,33,52
29,8482699,Dylan Guenther,R,ARI,21,82,24,27,51
29,8476448,William Karlsson,C,VGK,31,82,23,28,51
29,8482078,Lucas Raymond,L,DET,22,82,20,31,51
29,8476462,Dougie Hamilton,D,NJD,31,82,18,33,51
29,8476906,Shayne Gostisbehere,D,DET,31,82,12,39,51
29,8478438,Tommy Novak,C,NSH,27,82,24,26,50
29,8480064,Josh Norris,C,OTT,25,82,24,26,50
29,8475784,Jeff Skinner,C,BUF,32,82,22,28,50
29,8477497,Sean Monahan,C,WPG,30,82,22,28,50
29,8474586,Jordan Eberle,R,SEA,34,82,19,31,50
29,8473419,Brad Marchand,L,BOS,36,82,18,32,50
29,8477346,MacKenzie Weegar,D,CGY,30,82,17,33,50
29,8475170,Brayden Schenn,C,STL,33,82,17,33,50
29,8478397,Rasmus Andersson,D,CGY,28,82,11,39,50
29,8480014,Gabriel Vilardi,C,WPG,25,82,29,20,49
29,8479542,Brandon Hagel,L,TBL,26,82,26,23,49
29,8481596,Shane Pinto,C,OTT,24,82,26,23,49
29,8477496,Elias Lindholm,C,VAN,30,82,25,24,49
29,8478498,Jake DeBrusk,L,BOS,28,82,25,24,49
29,8474150,Mikael Backlund,C,CGY,35,82,24,25,49
29,8477479,Tyler Bertuzzi,L,TOR,29,82,18,31,49
29,8477947,Sonny Milano,L,WSH,28,82,18,31,49
29,8478038,Devon Toews,D,COL,30,82,11,38,49
29,8475794,Tyler Seguin,C,DAL,32,82,31,17,48
29,8481618,Alex Newhook,C,MTL,23,82,30,18,48
29,8482110,Dawson Mercer,C,NJD,23,82,28,20,48
29,8478042,Viktor Arvidsson,R,LAK,31,82,27,21,48
29,8477960,Adrian Kempe,R,LAK,28,82,23,25,48
29,8480893,Kirill Marchenko,R,CBJ,24,82,21,27,48
29,8480031,Maxime Comtois,L,CAR,25,82,20,28,48
29,8481068,Yegor Sharangovich,C,CGY,26,82,20,28,48
29,8477986,Brandon Montour,D,FLA,30,82,12,36,48
29,8477503,Max Domi,C,TOR,29,82,10,38,48
29,8477447,Shea Theodore,D,VGK,29,82,7,41,48
29,8478474,Lawson Crouse,L,ARI,27,82,30,17,47
29,8479400,Pierre-Luc Dubois,L,LAK,26,82,23,24,47
29,8474641,Adam Henrique,C,EDM,34,82,22,25,47
29,8475191,Reilly Smith,R,PIT,33,82,22,25,47
29,8483808,Andrei Kuzmenko,L,CGY,28,82,21,26,47
29,8482475,Yegor Chinakhov,R,CBJ,23,82,20,27,47
29,8482159,Tyson Foerster,R,PHI,22,82,19,28,47
29,8470794,Joe Pavelski,C,DAL,40,82,15,32,47
29,8480018,Nick Suzuki,C,MTL,25,82,15,32,47
29,8479345,Jakob Chychrun,D,OTT,26,82,14,33,47
29,8480036,Miro Heiskanen,D,DAL,25,82,6,41,47
29,8483471,Brad Lambert,C,WPG,31,82,5,42,47
29,8483397,Marc McLaughlin,C,BOS,25,82,36,10,46
29,8477500,Bo Horvat,C,NYI,29,82,24,22,46
29,8479675,Trevor Moore,L,LAK,29,82,19,27,46
29,8475168,Matt Duchene,C,DAL,33,82,17,29,46
29,8480078,Filip Chytil,C,NYR,25,82,17,29,46
29,8478401,Pavel Zacha,C,BOS,27,82,17,29,46
29,8478469,Thomas Chabot,D,OTT,27,82,14,32,46
29,8475753,Justin Faulk,D,STL,32,82,7,39,46
29,8482740,Wyatt Johnston,C,DAL,21,82,23,22,45
29,8482101,Danil Gushchin,L,SJS,22,82,23,22,45
29,8481528,Dylan Cozens,C,BUF,23,82,21,24,45
29,8479339,Patrik Laine,L,CBJ,26,82,17,28,45
29,8477444,Andre Burakovsky,L,SEA,29,82,11,34,45
29,8476880,Tom Wilson,R,WSH,30,82,19,25,44
29,8477964,Ivan Barbashev,C,VGK,29,82,15,29,44
29,8479999,Casey Mittelstadt,C,COL,26,82,12,32,44
29,8480188,Fabian Zetterlund,L,SJS,25,82,21,22,43
29,8477451,Ryan Hartman,R,MIN,30,82,18,25,43
29,8482124,Quinton Byfield,R,LAK,22,82,17,26,43
29,8478975,Mason Marchment,L,DAL,29,82,13,30,43
29,8477021,Alex Kerfoot,C,ARI,30,82,12,31,43
29,8476458,Ryan Strome,C,ANA,31,82,12,31,43
29,8481542,Moritz Seider,D,DET,23,82,5,38,43
29,8483457,Lane Hutson,D,MTL,20,82,2,41,43
29,8475314,Anders Lee,L,NYI,34,82,26,16,42
29,8477426,Nicholas Paul,L,TBL,29,82,26,16,42
29,8480009,Eeli Tolvanen,R,SEA,25,82,24,18,42
29,8482109,Alexis Lafrenière,L,NYR,23,82,22,20,42
29,8474102,David Perron,L,DET,36,82,18,24,42
29,8482745,Mason McTavish,C,ANA,21,82,16,26,42
29,8477494,Jonathan Drouin,L,COL,29,82,15,27,42
29,8481624,Ilya Mikheyev,R,VAN,30,82,15,27,42
29,8476882,Teuvo Teravainen,L,CAR,30,82,14,28,42
29,8482667,William Eklund,L,SJS,22,82,13,29,42
29,8476869,Brady Skjei,D,CAR,30,82,13,29,42
29,8475744,Evgeny Kuznetsov,C,CAR,32,82,11,31,42
29,8476792,Torey Krug,D,STL,33,82,9,33,42
29,8474565,Alex Pietrangelo,D,VGK,34,82,9,33,42
29,8480873,Rasmus Sandin,D,WSH,24,82,3,39,42
29,8479987,Morgan Geekie,C,BOS,26,82,17,24,41
29,8482093,Seth Jarvis,C,CAR,22,82,16,25,41
29,8477456,J.T. Compher,L,DET,29,82,15,26,41
29,8477511,Anthony Mantha,R,VGK,30,82,15,26,41
29,8478396,Noah Hanifin,D,VGK,27,82,13,28,41
29,8482133,Thomas Bordeleau,C,SJS,22,82,13,28,41
29,8475197,Tyson Barrie,D,NSH,33,82,10,31,41
29,8476329,Travis Boyd,C,ARI,31,82,8,33,41
29,8475714,Calle Jarnkrok,C,TOR,33,82,20,20,40
29,8478463,Anthony Beauvillier,L,NSH,27,82,15,25,40
29,8475745,Charlie Coyle,C,BOS,32,82,14,26,40
29,8480798,Philipp Kurashev,C,CHI,25,82,14,26,40
29,8475791,Taylor Hall,L,CHI,33,82,14,26,40
29,8473994,Jamie Benn,L,DAL,35,82,13,27,40
29,8471218,Blake Wheeler,R,NYR,38,82,12,28,40
29,8478542,Evan Rodrigues,C,FLA,31,82,11,29,40
29,8482720,Matthew Knies,L,TOR,22,82,11,29,40
29,8480145,Neal Pionk,D,WPG,29,82,8,32,40
29,8476483,Rickard Rakell,R,PIT,31,82,21,18,39
29,8476479,Phillip Danault,C,LAK,31,82,20,19,39
29,8478856,Conor Garland,R,VAN,28,82,17,22,39
29,8478458,Jack Roslovic,C,NYR,27,82,15,24,39
29,8476854,Hampus Lindholm,D,BOS,30,82,1,38,39
29,8474715,Cam Atkinson,R,PHI,35,82,20,18,38
29,8475151,Kyle Palmieri,C,NYI,33,82,19,19,38
29,8477425,Miles Wood,L,COL,29,82,19,19,38
29,8480028,Morgan Frost,C,PHI,25,82,18,20,38
29,8478366,Frank Vatrano,R,ANA,30,82,18,20,38
29,8479423,Alex Nylander,L,CBJ,26,82,17,21,38
29,8478519,Anthony Cirelli,C,TBL,27,82,14,24,38
29,8483445,Cutter Gauthier,L,ANA,20,82,14,24,38
29,8477498,Darnell Nurse,D,EDM,29,82,10,28,38
29,8478472,Mathieu Joseph,R,OTT,27,82,9,29,38
29,8477932,Aaron Ekblad,D,FLA,28,82,5,33,38
29,8479425,Filip Hronek,D,VAN,27,82,4,34,38
29,8477969,Marcus Pettersson,D,PIT,28,82,4,34,38
29,8484166,Adam Fantilli,C,CBJ,20,82,21,16,37
29,8475722,Jason Zucker,L,NSH,32,82,20,17,37
29,8478462,Nicolas Roy,C,VGK,27,82,17,20,37
29,8476480,Vladislav Namestnikov,C,WPG,32,82,13,24,37
29,8480802,Ryan McLeod,C,EDM,25,82,12,25,37
29,8480185,Eetu Luostarinen,C,FLA,26,82,12,25,37
29,8479410,Mikhail Sergachev,D,TBL,26,82,5,32,37
29,8471724,Kris Letang,D,PIT,37,82,5,32,37
29,8482089,Jake Neighbours,L,STL,22,82,27,9,36
29,8484153,Leo Carlsson,C,ANA,20,82,17,19,36
29,8479525,Ross Colton,C,COL,28,82,14,22,36
29,8477998,Warren Foegele,L,EDM,28,82,13,23,36
29,8476905,Chandler Stephenson,C,VGK,30,82,12,24,36
29,8473563,Nicklas Backstrom,C,WSH,37,82,12,24,36
29,8480220,Noah Cates,L,PHI,25,82,10,26,36
29,8474563,Drew Doughty,D,LAK,35,82,5,31,36
29,8483524,Shane Wright,C,SEA,20,82,23,12,35
29,8480797,Joel Farabee,L,PHI,24,82,18,17,35
29,8475768,Jaden Schwartz,C,SEA,32,82,16,19,35
29,8479996,Cody Glass,C,NSH,25,82,15,20,35
29,8481186,Logan O'Connor,R,COL,28,82,14,21,35
29,8482624,Daniil Miromanov,D,CGY,27,82,14,21,35
29,8470613,Brent Burns,D,CAR,39,82,5,30,35
29,8474870,Tyler Johnson,C,CHI,34,82,19,15,34
29,8474037,James van Riemsdyk,L,BOS,35,82,18,16,34
29,8481580,Connor McMichael,C,WSH,23,82,16,18,34
29,8482702,Logan Stankoven,C,DAL,21,82,16,18,34
29,8477407,Anthony Duclair,L,TBL,29,82,14,20,34
29,8482146,Luke Evangelista,R,NSH,22,82,14,20,34
29,8476292,Ondrej Palat,L,NJD,33,82,12,22,34
29,8479992,Michael Rasmussen,C,DET,25,82,12,22,34
29,8474149,Evgenii Dadonov,R,DAL,35,82,11,23,34
29,8478055,Gustav Forsling,D,FLA,28,82,9,25,34
29,8480113,Alex Iafallo,L,WPG,31,82,9,25,34
29,8477948,Travis Sanheim,D,PHI,28,82,8,26,34
29,8475793,Ryan Johansen,C,PHI,32,82,8,26,34
29,8476923,Damon Severson,D,CBJ,30,82,8,26,34
29,8479415,Michael McLeod,C,NJD,26,82,8,26,34
29,8480043,Timothy Liljegren,D,TOR,25,82,6,28,34
29,8477495,Seth Jones,D,CHI,30,82,6,28,34
29,8476885,Jacob Trouba,D,NYR,30,82,6,28,34
29,8484203,Bradly Nadeau,L,CAR,19,82,23,10,33
29,8482113,Anton Lundell,C,FLA,23,82,17,16,33
29,8478466,Daniel Sprong,R,DET,27,82,16,17,33
29,8476392,Adam Lowry,C,WPG,31,82,15,18,33
29,8476461,Sean Couturier,C,PHI,32,82,14,19,33
29,8482092,Ridly Greig,C,OTT,22,82,13,20,33
29,8480871,Adam Boqvist,D,CBJ,24,82,8,25,33
29,8475181,Nick Leddy,D,STL,33,82,8,25,33
29,8475906,John Klingberg,D,TOR,32,82,7,26,33
29,8478046,Danton Heinen,L,BOS,29,82,18,14,32
29,8475848,Brendan Gallagher,R,MTL,32,82,18,14,32
29,8474053,Logan Couture,C,SJS,35,82,15,17,32
29,8481013,Jonatan Berggren,R,DET,24,82,15,17,32
29,8481553,Bobby Brink,R,PHI,23,82,15,17,32
29,8473449,Kyle Okposo,R,FLA,36,82,14,18,32
29,8476925,Colton Sissons,C,NSH,31,82,13,19,32
29,8475149,Marcus Johansson,L,MIN,34,82,12,20,32
29,8477429,Andrew Copp,C,DET,30,82,10,22,32
29,8475218,Mattias Ekholm,D,EDM,34,82,7,25,32
29,8475171,Oliver Ekman-Larsson,D,FLA,33,82,7,25,32
29,8482733,Logan Mailloux,D,MTL,31,82,5,27,32
29,8481016,Ruslan Iskhakov,C,NYI,24,82,2,30,32
29,8478413,Jordan Greenway,L,BUF,27,82,18,13,31
29,8480068,Ryan Poehling,C,PHI,25,82,14,17,31
29,8484145,Zach Benson,L,BUF,19,82,13,18,31
29,8475287,Erik Haula,L,NJD,33,82,13,18,31
29,8477015,Connor Brown,R,EDM,30,82,13,18,31
29,8476872,Scott Laughton,C,PHI,30,82,12,19,31
29,8478115,Pierre Engvall,L,NYI,28,82,12,19,31
29,8480074,Alexandre Texier,C,CBJ,25,82,12,19,31
29,8476897,Oskar Sundqvist,C,STL,30,82,11,20,31
29,8482671,Owen Power,D,BUF,22,82,10,21,31
29,8476927,Teddy Blueger,C,VAN,30,82,8,23,31
29,8479365,Trent Frederic,C,BOS,26,82,7,24,31
29,8481703,Valtteri Puustinen,R,PIT,25,82,5,26,31
29,8482809,Jackson Blake,R,CAR,21,82,21,9,30
29,8476981,Josh Anderson,R,MTL,30,82,20,10,30
29,8475799,Nino Niederreiter,R,WPG,32,82,17,13,30
29,8476438,Brandon Saad,L,STL,32,82,16,14,30
29,8480813,Joe Veleno,C,DET,24,82,15,15,30
29,8477952,Robby Fabbri,C,DET,28,82,14,16,30
29,8480434,Sean Durzi,D,ARI,26,82,7,23,30
29,8475764,Cam Fowler,D,ANA,33,82,7,23,30
29,8478500,Ivan Provorov,D,CBJ,27,82,7,23,30
29,8482087,Kaiden Guhle,D,MTL,22,82,7,23,30
29,8482222,Alexander Barabanov,L,SJS,30,82,12,17,29
29,8478013,Jake Walman,D,DET,28,82,12,17,29
29,8479977,Kailer Yamamoto,R,SEA,26,82,10,19,29
29,8482142,Jamie Drysdale,D,PHI,22,82,8,21,29
29,8476979,Erik Gustafsson,D,NYR,32,82,5,24,29
29,8481178,Egor Zamula,D,PHI,24,82,5,24,29
29,8483490,Pavel Mintyukov,D,ANA,21,82,5,24,29
29,8481699,Aku Raty,R,ARI,23,82,1,28,29
29,8480849,Barrett Hayton,C,ARI,24,82,16,12,28
29,8481604,Pavel Dorofeyev,L,VGK,24,82,16,12,28
29,8474189,Lars Eller,C,PIT,35,82,15,13,28
29,8478057,Dakota Joshua,C,VAN,28,82,14,14,28
29,8480821,Filip Zadina,R,SJS,25,82,13,15,28
29,8479390,Taylor Raddysh,R,CHI,26,82,12,16,28
29,8475220,Marcus Foligno,L,MIN,33,82,12,16,28
29,8482259,Bobby McMann,C,TOR,28,82,12,16,28
29,8476419,Jean-Gabriel Pageau,C,NYI,32,82,11,17,28
29,8476960,Andreas Athanasiou,C,CHI,30,82,11,17,28
29,8476374,Sean Kuraly,C,CBJ,31,82,11,17,28
29,8480855,Jack McBain,C,ARI,24,82,10,18,28
29,8476624,Barclay Goodrow,C,NYR,31,82,10,18,28
29,8482105,Jake Sanderson,D,OTT,22,82,6,22,28
29,8476958,Jaccob Slavin,D,CAR,30,82,5,23,28
29,8478178,Darren Raddysh,D,TBL,28,82,5,23,28
29,8474151,Ryan McDonagh,D,NSH,35,82,5,23,28
29,8481535,Nils Hoglander,L,VAN,24,82,17,10,27
29,8475760,Nick Bjugstad,C,ARI,32,82,16,11,27
29,8477989,Christian Dvorak,C,MTL,28,82,15,12,27
29,8476278,Colin Blackwell,C,CHI,31,82,14,13,27
29,8475763,Kevin Hayes,R,STL,32,82,13,14,27
29,8483515,Juraj Slafkovsky,L,MTL,20,82,10,17,27
29,8482111,Justin Barron,D,MTL,23,82,10,17,27
29,8482705,Cole Sillinger,C,CBJ,21,82,8,19,27
29,8482655,J.J. Moser,D,ARI,24,82,8,19,27
29,8478133,Jake Evans,C,MTL,28,82,7,20,27
29,8478882,Vladislav Gavrikov,D,LAK,29,82,6,21,27
29,8481656,Aliaksei Protas,C,WSH,23,82,4,23,27
29,8473507,Jeff Petry,D,DET,37,82,3,24,27
29,8479941,Justin Danforth,R,CBJ,31,82,18,8,26
29,8476469,Joel Armia,R,MTL,31,82,16,10,26
29,8476873,Mark Jankowski,C,NSH,30,82,15,11,26
29,8483431,Logan Cooley,C,ARI,20,82,13,13,26
29,8484144,Connor Bedard,C,CHI,19,82,12,14,26
29,8477953,Kasperi Kapanen,R,STL,28,82,11,15,26
29,8477353,Tyler Motte,C,TBL,29,82,9,17,26
29,8482117,Lukas Reichel,L,CHI,22,82,9,17,26
29,8476917,Adam Pelech,D,NYI,30,82,7,19,26
29,8478911,Matt Roy,D,LAK,29,82,7,19,26
29,8476331,Dylan DeMelo,D,WPG,31,82,5,21,26
29,8476892,Colton Parayko,D,STL,31,82,5,21,26
29,8475164,Jakob Silfverberg,R,ANA,34,82,14,11,25
29,8470621,Corey Perry,R,EDM,39,82,13,12,25
29,8482079,Marco Rossi,C,MIN,23,82,13,12,25
29,8478020,Michael Amadio,C,VGK,28,82,13,12,25
29,8477507,Nikita Zadorov,D,VAN,29,82,11,14,25
29,8481560,Arthur Kaliyev,R,LAK,23,82,9,16,25
29,8477839,Conor Sheary,L,TBL,32,82,9,16,25
29,8481524,Bowen Byram,D,BUF,23,82,7,18,25
29,8478507,John Marino,D,NJD,27,82,5,20,25
29,8478891,Mason Appleton,C,WPG,28,82,5,20,25
29,8480058,Pierre-Olivier Joseph,D,PIT,25,82,5,20,25
29,8476879,Cody Ceci,D,EDM,31,82,3,22,25
29,8478840,Will Borgen,D,SEA,28,82,2,23,25
29,8479293,Brandon Tanev,L,SEA,33,82,14,10,24
29,8482055,Drew O'Connor,L,PIT,26,82,13,11,24
29,8481554,Kaapo Kakko,R,NYR,23,82,12,12,24
29,8478508,Yakov Trenin,C,COL,27,82,12,12,24
29,8481704,Juuso Parssinen,C,NSH,23,82,11,13,24
29,8482679,Matt Coronato,R,CGY,22,82,9,15,24
29,8480817,K'Andre Miller,D,NYR,24,82,8,16,24
29,8475690,Chris Tanev,D,DAL,35,82,8,16,24
29,8473533,Jordan Staal,C,CAR,36,82,8,16,24
29,8478851,Alexandre Carrier,D,NSH,28,82,6,18,24
29,8481546,Cam York,D,PHI,23,82,5,19,24
29,8476463,Jonas Brodin,D,MIN,31,82,5,19,24
29,8475188,Brayden McNabb,D,VGK,33,82,4,20,24
29,8474716,Jared Spurgeon,D,MIN,35,82,2,22,24
29,8483493,Frank Nazar,C,CHI,20,82,18,5,23
29,8475343,Nic Dowd,C,WSH,34,82,13,10,23
29,8482737,Zack Bolduc,C,STL,21,82,9,14,23
29,8473422,Nick Foligno,L,CHI,37,82,8,15,23
29,8476312,Josh Manson,D,COL,33,82,7,16,23
29,8475179,Dmitry Kulikov,D,FLA,34,82,7,16,23
29,8477220,Nate Schmidt,D,WPG,33,82,7,16,23
29,8482803,Olen Zellweger,D,ANA,21,82,6,17,23
29,8480246,Nick Perbix,D,TBL,26,82,5,18,23
29,8482122,Brock Faber,D,MIN,22,82,4,19,23
29,8482245,Artem Zub,D,OTT,29,82,3,20,23
29,8481567,Henry Thrun,D,SJS,23,82,1,22,23
29,8482118,Sam Colangelo,R,ANA,23,82,17,5,22
29,8478043,Sam Lafferty,C,VAN,29,82,15,7,22
29,8470604,Jeff Carter,C,PIT,39,82,14,8,22
29,8477450,Jason Dickinson,C,CHI,29,82,14,8,22
29,8483012,Logan Morrison,C,SEA,22,82,11,11,22
29,8476871,Tanner Pearson,L,MTL,32,82,10,12,22
29,8482074,Connor Zary,C,CGY,23,82,9,13,22
29,8481601,Simon Holmstrom,R,NYI,23,82,9,13,22
29,8481481,Blake Lizotte,C,LAK,27,82,8,14,22
29,8477508,Curtis Lazar,C,NJD,29,82,8,14,22
29,8479976,Juuso Valimaki,D,ARI,26,82,8,14,22
29,8481517,Brett Leason,R,ANA,25,82,8,14,22
29,8477499,Rasmus Ristolainen,D,PHI,30,82,6,16,22
29,8478136,Jake Middleton,D,MIN,28,82,6,16,22
29,8481581,Thomas Harley,D,DAL,23,82,4,18,22
29,8475200,Dmitry Orlov,D,CAR,33,82,4,18,22
29,8476525,Colin Miller,D,WPG,32,82,4,18,22
29,8476858,Phillip Di Giuseppe,L,VAN,31,82,4,18,22
29,8478443,Brandon Carlo,D,BOS,28,82,4,18,22
29,8475231,Casey Cizikas,C,NYI,33,82,10,11,21
29,8482062,Cole Smith,L,NSH,29,82,9,12,21
29,8481014,Alexander Romanov,D,NYI,24,82,9,12,21
29,8479514,Rem Pitlick,C,CHI,27,82,7,14,21
29,8477392,Hudson Fasching,R,NYI,29,82,6,15,21
29,8480073,Erik Brannstrom,D,OTT,25,82,6,15,21
29,8483565,Nick Blankenburg,D,CBJ,26,82,5,16,21
29,8482073,Braden Schneider,D,NYR,23,82,5,16,21
29,8483482,Tristan Luneau,D,ANA,20,82,3,18,21
29,8481093,Rafael Harvey-Pinard,L,MTL,25,82,15,5,20
29,8474884,Mike Hoffman,C,SJS,35,82,13,7,20
29,8481477,Nico Sturm,C,SJS,29,82,12,8,20
29,8478109,Victor Olofsson,L,BUF,29,82,11,9,20
29,8480459,Pius Suter,C,VAN,28,82,10,10,20
29,8479316,Luke Kunin,C,SJS,27,82,10,10,20
29,8477505,Alexander Wennberg,C,NYR,30,82,8,12,20
29,8475279,Ben Chiarot,D,DET,33,82,8,12,20
29,8479998,Mikey Anderson,D,LAK,25,82,6,14,20
29,8479346,Dillon Dube,C,CGY,26,82,6,14,20
29,8475455,Brenden Dillon,D,WPG,34,82,6,14,20
29,8482730,Brandt Clarke,D,LAK,21,82,6,14,20
29,8479383,Boris Katchouk,L,OTT,26,82,6,14,20
29,8470610,Zach Parise,L,COL,40,82,5,15,20
29,8477488,Brett Pesce,D,CAR,30,82,5,15,20
29,8478451,Ethan Bear,D,WSH,27,82,5,15,20
29,8476931,Jake McCabe,D,TOR,31,82,5,15,20
29,8482175,JJ Peterka,R,BUF,22,82,4,16,20
29,8483491,Ivan Miroshnichenko,L,WSH,20,82,4,16,20
29,8475208,Brian Dumoulin,D,SEA,33,82,3,17,20
29,8479983,Mario Ferraro,D,SJS,26,82,3,17,20
29,8475324,Nick Jensen,D,WSH,34,82,3,17,20
29,8483466,Kevin Korchinski,D,CHI,20,82,2,18,20
29,8475790,Erik Gudbranson,D,CBJ,32,82,1,19,20
29,8479591,Michael Eyssimont,C,TBL,28,82,13,6,19
29,8483499,Liam Ohgren,L,MIN,20,82,12,7,19
29,8479359,Beck Malenstyn,L,WSH,26,82,11,8,19
29,8479351,Sam Steel,C,DAL,26,82,9,10,19
29,8477944,Jakub Vrana,L,STL,28,82,9,10,19
29,8474034,Pat Maroon,L,BOS,36,82,8,11,19
29,8482666,Scott Morrow,D,CAR,22,82,8,11,19
29,8476921,Jordan Martinook,L,CAR,32,82,7,12,19
29,8480144,David Kampf,C,TOR,29,82,5,14,19
29,8480806,Isac Lundestrom,C,ANA,25,82,4,15,19
29,8475177,Calvin de Haan,D,TBL,33,82,2,17,19
29,8474673,TJ Brodie,D,TOR,34,82,0,19,19
29,8477845,Trevor van Riemsdyk,D,WSH,33,82,0,19,19
29,8482125,Alexander Holtz,R,NJD,22,82,10,8,18
29,8477919,Frederick Gaudreau,C,MIN,31,82,8,10,18
29,8480336,Sean Walker,D,COL,30,82,6,12,18
29,8479980,Nicolas Hague,D,VGK,26,82,6,12,18
29,8476422,Mike Reilly,D,NYI,31,82,4,14,18
29,8470600,Ryan Suter,D,DAL,39,82,4,14,18
29,8477406,Mattias Janmark,C,EDM,32,82,4,14,18
29,8476467,Jamie Oleksiak,D,SEA,32,82,3,15,18
29,8481059,Scott Perunovich,D,STL,26,82,2,16,18
29,8476902,Esa Lindell,D,DAL,30,82,1,17,18
29,8481606,Jordan Spence,D,LAK,23,82,0,18,18
29,8482762,Simon Edvinsson,D,DET,21,82,11,6,17
29,8479661,Tanner Jeannot,L,TBL,27,82,9,8,17
29,8477330,Dominik Kubalik,L,OTT,29,82,9,8,17
29,8475842,Sam Carrick,C,EDM,32,82,9,8,17
29,8480448,Parker Kelly,L,OTT,25,82,8,9,17
29,8478831,Kevin Stenlund,C,FLA,28,82,8,9,17
29,8481522,Peyton Krebs,C,BUF,23,82,5,12,17
29,8474009,Nick Bonino,C,NYR,36,82,5,12,17
29,8480796,Martin Fehervary,D,WSH,25,82,5,12,17
29,8475233,David Savard,D,MTL,34,82,5,12,17
29,8482712,Oskar Olausson,R,COL,22,82,3,14,17
29,8480860,Kevin Bahl,D,NJD,24,82,3,14,17
29,8478468,Jeremy Lauzon,D,NSH,27,82,0,17,17
29,8480807,Mattias Samuelsson,D,BUF,24,82,0,17,17
29,8482145,Mavrik Bourque,C,DAL,22,82,13,3,16
29,8480980,Connor Dewar,C,TOR,25,82,9,7,16
29,8477435,Ryan Graves,D,PIT,29,82,7,9,16
29,8478569,Noel Acciari,C,PIT,33,82,6,10,16
29,8480281,Alexey Toropchenko,R,STL,25,82,6,10,16
29,8476967,Brett Kulak,D,EDM,30,82,6,10,16
29,8477365,Connor Clifton,D,BUF,29,82,4,12,16
29,8479371,Dante Fabbro,D,NSH,26,82,3,13,16
29,8476473,Connor Murphy,D,CHI,31,82,3,13,16
29,8481568,Alex Vlasic,D,CHI,23,82,3,13,16
29,8476457,Adam Larsson,D,SEA,32,82,1,15,16
29,8479398,Samuel Girard,D,COL,26,82,1,15,16
29,8477034,Jaycob Megna,D,CHI,32,82,1,15,16
29,8479353,Brett Howden,C,VGK,26,82,7,8,15
29,8479291,Kevin Rooney,C,CGY,31,82,7,8,15
29,8482155,Alex Laferriere,R,LAK,23,82,5,10,15
29,8470966,Mark Giordano,D,TOR,41,82,4,11,15
29,8471677,Jack Johnson,D,COL,37,82,4,11,15
29,8481605,Jackson LaCombe,D,ANA,23,82,3,12,15
29,8482470,Ilya Solovyov,D,CGY,24,82,1,14,15
29,8476878,Zemgus Girgensons,L,BUF,30,82,7,7,14
29,8476429,Scott Mayfield,D,NYI,32,82,5,9,14
29,8476891,Matt Grzelcyk,D,BOS,30,82,5,9,14
29,8481028,Martin Pospisil,C,CGY,25,82,5,9,14
29,8482166,Shakir Mukhamadullin,D,SJS,22,82,5,9,14
29,8475462,Radko Gudas,D,ANA,34,82,3,11,14
29,8480172,Jan Rutta,D,SJS,34,82,3,11,14
29,8476372,Nick Seeler,D,PHI,31,82,3,11,14
29,8474166,Alec Martinez,D,VGK,37,82,2,12,14
29,8479369,Andrew Peeke,D,BOS,26,82,1,13,14
29,8475762,Derek Forbort,D,BOS,32,82,1,13,14
29,8473453,Trevor Lewis,C,LAK,37,82,8,5,13
29,8476822,Luke Glendening,C,TBL,35,82,8,5,13
29,8476442,Matt Nieto,L,PIT,32,82,7,6,13
29,8479393,Noah Gregor,C,TOR,26,82,5,8,13
29,8476915,Jujhar Khaira,L,MIN,30,82,5,8,13
29,8481537,Nikita Okhotiuk,D,CGY,24,82,4,9,13
29,8477506,Ryan Pulock,D,NYI,30,82,4,9,13
29,8483505,Matthew Poitras,C,BOS,20,82,4,9,13
29,8477931,Tomas Nosek,L,NJD,32,82,4,9,13
29,8477369,Carson Soucy,D,VAN,30,82,3,10,13
29,8478408,Travis Dermott,D,ARI,28,82,3,10,13
29,8474013,Ian Cole,D,VAN,35,82,2,11,13
29,8474574,Tyler Myers,D,VAN,34,82,1,12,13
29,8478399,Jonas Siegenthaler,D,NJD,27,82,4,8,12
29,8479324,Ryan Lindgren,D,NYR,26,82,4,8,12
29,8484911,Collin Graf,R,SJS,22,82,3,9,12
29,8480035,Henri Jokiharju,D,BUF,25,82,2,10,12
29,8482858,Ryker Evans,D,SEA,23,82,2,10,12
29,8480879,Jacob Bernard-Docker,D,OTT,24,82,2,10,12
29,8474567,Zach Bogosian,D,MIN,34,82,1,11,12
29,8478859,Niko Mikkola,D,FLA,28,82,1,11,12
29,8482807,Ethan Del Mastro,D,CHI,21,82,0,12,12
29,8481578,Graeme Clarke,R,NJD,23,82,5,6,11
29,8483763,Maksymilian Szuber,D,ARI,22,82,4,7,11
29,8482859,Zack Ostapchuk,C,OTT,21,82,2,9,11
29,8480990,Declan Chisholm,D,MIN,24,82,3,7,10
29,8478430,Oliver Kylington,D,CGY,27,82,2,8,10
29,8477335,Kyle Burroughs,D,SJS,29,82,2,8,10
29,8475825,Jani Hakanpää,D,DAL,32,82,2,8,10
29,8480834,Ty Emberson,D,SJS,24,82,0,10,10
29,8482713,Mackie Samoskevich,R,FLA,22,82,5,4,9
29,8479442,Troy Stecher,D,EDM,30,82,3,6,9
29,8483468,Jiri Kulich,C,BUF,20,82,3,6,9
29,8473504,Cal Clutterbuck,R,NYI,37,82,2,7,9
29,8478416,Erik Cernak,D,TBL,27,82,2,7,9
29,8481599,Victor Soderstrom,D,ARI,23,82,2,6,8
29,8483495,Simon Nemec,D,NJD,20,82,1,7,8
29,8483489,Fraser Minten,C,TOR,31,82,2,5,7
29,8482177,Marat Khusnutdinov,C,MIN,22,82,2,5,7
29,8482516,Matthew Kessel,D,STL,24,82,0,7,7
29,8481030,Jack St. Ivany,D,PIT,25,82,0,6,6
29,8484149,Gavin Brindley,C,CBJ,20,82,1,3,4
29,8482141,Lukas Cormier,D,VGK,22,0,0,0,0
29,8476988,Matt Benning,D,SJS,30,0,0,0,0
29,8480727,Zach Whitecloud,D,VGK,28,0,0,0,0
29,8480887,Jordan Harris,D,MTL,24,0,0,0,0
29,8478450,Parker Wotherspoon,D,BOS,27,0,0,0,0
29,8481812,Nikolai Knyzhov,D,SJS,27,0,0,0,0
29,8480001,Urho Vaakanainen,D,ANA,25,0,0,0,0
29,8482176,Wyatt Kaiser,D,CHI,22,0,0,0,0
29,8481122,Simon Benoit,D,TOR,26,0,0,0,0
29,8476441,Joel Edmundson,D,TOR,31,0,0,0,0
29,8480884,Calen Addison,D,SJS,24,0,0,0,0
29,8482511,Mason Lohrei,D,BOS,23,0,0,0,0
29,8482192,Isaak Phillips,D,CHI,23,0,0,0,0
29,8480950,Ilya Lyubushkin,D,TOR,30,0,0,0,0
29,8474031,Kevin Shattenkirk,D,BOS,35,0,0,0,0
29,8475718,Justin Holl,D,DET,32,0,0,0,0
29,8479402,Jake Bean,D,CBJ,26,0,0,0,0
29,8474602,Justin Schultz,D,SEA,34,0,0,0,0
29,8477950,Tony DeAngelo,D,CAR,29,0,0,0,0
29,8481743,Marc Del Gaizo,D,NSH,25,0,0,0,0
29,8481527,Kaedan Korczak,D,VGK,23,0,0,0,0
29,8480192,Johnathan Kovacevic,D,MTL,27,0,0,0,0
29,8476874,Olli Maatta,D,DET,30,0,0,0,0
29,8482144,Jack Thompson,D,SJS,22,0,0,0,0
29,8480222,Sebastian Aho,D,NYI,28,0,0,0,0
29,8479458,Nikita Zaitsev,D,CHI,33,0,0,0,0
29,8471709,Marc-Edouard Vlasic,D,SJS,37,0,0,0,0
29,8482929,Emil Lilleberg,D,TBL,23,0,0,0,0
29,8477018,Ben Hutton,D,VGK,31,0,0,0,0
29,8481056,Spencer Stastney,D,NSH,24,0,0,0,0
29,8481593,Jayden Struble,D,MTL,23,0,0,0,0
29,8479982,Conor Timmins,D,TOR,26,0,0,0,0
29,8474090,Brendan Smith,D,NJD,35,0,0,0,0
29,8482964,Arber Xhekaj,D,MTL,23,0,0,0,0
29,8480891,Michael Kesselring,D,ARI,24,0,0,0,0
29,8477938,Haydn Fleury,D,TBL,28,0,0,0,0
29,8481806,Louis Crevier,D,CHI,23,0,0,0,0
29,8471274,Alex Goligoski,D,MIN,39,0,0,0,0
29,8481600,Tobias Bjornfot,D,FLA,23,0,0,0,0
29,8475797,Jarred Tinordi,D,CHI,32,0,0,0,0
29,8481521,Ronnie Attard,D,PHI,25,0,0,0,0
29,8474612,Travis Hamonic,D,OTT,34,0,0,0,0
29,8479576,Vincent Desharnais,D,EDM,28,0,0,0,0
29,8480049,Dylan Samberg,D,WPG,25,0,0,0,0
29,8483619,Filip Roos,D,CHI,25,0,0,0,0
29,8474568,Luke Schenn,D,NSH,35,0,0,0,0
29,8480184,Gustav Lindstrom,D,ANA,26,0,0,0,0
29,8480070,Ian Mitchell,D,BOS,25,0,0,0,0
29,8480196,Jacob Bryson,D,BUF,27,0,0,0,0
29,8471686,Marc Staal,D,PHI,37,0,0,0,0
29,8477467,Gustav Olofsson,D,SEA,30,0,0,0,0
29,8478970,Jalen Chatfield,D,CAR,28,0,0,0,0
29,8479348,Kale Clague,D,BUF,26,0,0,0,0
29,8473446,Erik Johnson,D,PHI,36,0,0,0,0
29,8477462,Robert Hagg,D,ANA,29,0,0,0,0
29,8478454,Noah Juulsen,D,VAN,27,0,0,0,0
29,8477384,Josh Brown,D,ARI,30,0,0,0,0
29,8481708,Zac Jones,D,NYR,24,0,0,0,0
29,8481167,Brayden Pachal,D,CGY,25,0,0,0,0
29,8482067,Connor Mackey,D,NYR,28,0,0,0,0
29,8483460,David Jiricek,D,CBJ,21,0,0,0,0
29,8481701,Santeri Hatakka,D,NJD,23,0,0,0,0
29,8478021,William Lagesson,D,ANA,28,0,0,0,0
29,8477851,Jordan Oesterle,D,CGY,32,0,0,0,0
29,8478452,Caleb Jones,D,COL,27,0,0,0,0
29,8479984,Cal Foote,D,NJD,26,0,0,0,0
29,8479639,Dylan Coghlan,D,CAR,26,0,0,0,0
29,8480874,Adam Ginning,D,PHI,24,0,0,0,0
29,8479321,Lucas Johansen,D,WSH,27,0,0,0,0
29,8480878,Nils Lundkvist,D,DAL,24,0,0,0,0
29,8482165,Yan Kuznetsov,D,CGY,22,0,0,0,0
29,8484258,Sam Malinski,D,COL,26,0,0,0,0
29,8480157,Calle Rosen,D,STL,30,0,0,0,0
29,8484304,Uvis Balinskis,D,FLA,28,0,0,0,0
29,8479985,Cale Fleury,D,SEA,26,0,0,0,0
29,8479378,Logan Stanley,D,WPG,26,0,0,0,0
29,8477541,Dakota Mermis,D,MIN,30,0,0,0,0
29,8481609,Vladislav Kolyachonok,D,ARI,23,0,0,0,0
29,8480823,Alexander Alexeyev,D,WSH,25,0,0,0,0
29,8481679,Maxence Guenette,D,OTT,23,0,0,0,0
29,8481564,Ryan Johnson,D,BUF,23,0,0,0,0
29,8479376,Victor Mete,D,PHI,26,0,0,0,0
29,8484254,Akito Hirose,D,VAN,25,0,0,0,0
29,8482660,Kent Johnson,C,CBJ,22,0,0,0,0
29,8482149,Cole Perfetti,C,WPG,22,0,0,0,0
29,8477987,Ryan Donato,C,CHI,28,0,0,0,0
29,8475755,Alexander Petrovic,D,DAL,32,0,0,0,0
29,8477810,Joel Hanley,D,CGY,33,0,0,0,0
29,8474145,Robert Bortuzzo,D,NYI,35,0,0,0,0
29,8481161,Jake Christiansen,D,CBJ,25,0,0,0,0
29,8476884,Derrick Pouliot,D,DAL,30,0,0,0,0
29,8481716,Dmitri Voronkov,L,CBJ,24,0,0,0,0
29,8480084,Nick DeSimone,D,NJD,30,0,0,0,0
29,8475750,Jon Merrill,D,MIN,32,0,0,0,0
29,8479315,Joey Anderson,R,CHI,26,0,0,0,0
29,8478011,Louie Belpedio,D,PHI,28,0,0,0,0
29,8482451,Mikael Pyyhtia,L,CBJ,23,0,0,0,0
29,8481541,Samuel Bolduc,D,NYI,24,0,0,0,0
29,8482126,Emil Andrae,D,PHI,31,0,0,0,0
29,8474618,Marco Scandella,D,STL,34,0,0,0,0
29,8477244,Chad Ruhwedel,D,NYR,34,0,0,0,0
29,8477971,Andreas Englund,D,LAK,28,0,0,0,0
29,8480829,Jesperi Kotkaniemi,C,CAR,24,0,0,0,0
29,8479372,Josh Mahura,D,FLA,26,0,0,0,0
29,8482095,Tyler Kleven,D,OTT,22,0,0,0,0
29,8481719,Maxwell Crozier,D,TBL,24,0,0,0,0
29,8475855,Jesper Fast,R,CAR,33,0,0,0,0
29,8480848,Ty Dellandrea,C,DAL,24,0,0,0,0
29,8475193,Tomas Tatar,L,SEA,34,0,0,0,0
29,8476889,Radek Faksa,C,DAL,30,0,0,0,0
29,8478495,Denis Gurianov,R,PHI,27,0,0,0,0
29,8480216,Jacob Peterson,C,SJS,25,0,0,0,0
29,8480252,Cole Guttman,C,CHI,25,0,0,0,0
29,8479026,Philippe Myers,D,TBL,27,0,0,0,0
29,8481006,Tyler Tucker,D,STL,24,0,0,0,0
29,8481032,Paul Cotter,C,VGK,25,0,0,0,0
29,8481577,Philip Tomasino,C,NSH,23,0,0,0,0
29,8476918,Jimmy Vesey,L,NYR,31,0,0,0,0
29,8479320,Max Lajoie,D,TOR,27,0,0,0,0
29,8478017,Mark Friedman,D,VAN,29,0,0,0,0
29,8481754,Nikita Nesterenko,C,ANA,23,0,0,0,0
29,8483407,Brandon Scanlin,D,NYR,25,0,0,0,0
29,8482659,Josh Doan,R,ARI,22,0,0,0,0
29,8477446,Michael McCarron,R,NSH,29,0,0,0,0
29,8477903,Garnet Hathaway,R,PHI,33,0,0,0,0
29,8482153,Brendan Brisson,C,VGK,23,0,0,0,0
29,8483546,Marshall Rifai,D,TOR,26,0,0,0,0
29,8484287,Cole McWard,D,VAN,23,0,0,0,0
29,8478854,Ryan Shea,D,PIT,27,0,0,0,0
29,8481585,Egor Afanasyev,L,NSH,23,0,0,0,0
29,8483398,Declan Carlile,D,TBL,31,0,0,0,0
29,8478502,Dennis Gilbert,D,CGY,28,0,0,0,0
29,8482749,Joshua Roy,R,MTL,21,0,0,0,0
29,8481598,Philip Broberg,D,EDM,23,0,0,0,0
29,8480835,Jack Drury,C,CAR,24,0,0,0,0
29,8480748,Kiefer Sherwood,L,NSH,29,0,0,0,0
29,8476934,Brock McGinn,L,ANA,30,0,0,0,0
29,8480870,Bo Groulx,C,ANA,24,0,0,0,0
29,8479368,Max Jones,L,ANA,26,0,0,0,0
29,8478099,Kevin Labanc,R,SJS,29,0,0,0,0
29,8478067,Oskar Lindblom,L,SJS,28,0,0,0,0
29,8476393,Nick Cousins,C,FLA,31,0,0,0,0
29,8483395,Arshdeep Bains,L,VAN,23,0,0,0,0
29,8480762,Eric Robinson,L,BUF,29,0,0,0,0
29,8479439,Jacob MacDonald,D,SJS,31,0,0,0,0
29,8476474,Stefan Noesen,R,CAR,31,0,0,0,0
29,8482787,Nikita Chibrikov,R,WPG,31,0,0,0,0
29,8478432,Christian Fischer,R,DET,27,0,0,0,0
29,8477979,Nicolas Aube-Kubel,R,WSH,28,0,0,0,0
29,8481789,Tye Kartye,L,SEA,23,0,0,0,0
29,8479330,Brandon Gignac,C,MTL,27,0,0,0,0
29,8480075,Cameron Crotty,D,ARI,25,0,0,0,0
29,8473473,Milan Lucic,L,BOS,36,0,0,0,0
29,8482094,Daemon Hunt,D,MIN,22,0,0,0,0
29,8481206,John Ludvig,D,PIT,24,0,0,0,0
29,8483630,Pavol Regenda,L,ANA,25,0,0,0,0
29,8481617,Vasily Podkolzin,R,VAN,23,0,0,0,0
29,8480306,Grant Hutton,D,NYI,29,0,0,0,0
29,8480995,Pontus Holmberg,R,TOR,25,0,0,0,0
29,8482148,Hendrix Lapierre,C,WSH,22,0,0,0,0
29,8477478,William Carrier,L,VGK,30,0,0,0,0
29,8480003,Jesper Boqvist,C,BOS,26,0,0,0,0
29,8482172,Landon Slaggert,L,CHI,22,0,0,0,0
29,8480789,Oliver Wahlstrom,R,NYI,24,0,0,0,0
29,8474062,Riley Nash,C,NYR,35,0,0,0,0
29,8480021,Jack Studnicka,C,SJS,25,0,0,0,0
29,8480025,MacKenzie Entwistle,R,CHI,25,0,0,0,0
29,8481582,Nicholas Robertson,L,TOR,23,0,0,0,0
29,8476867,Brendan Gaunce,C,CBJ,30,0,0,0,0
29,8479619,Michael Carcone,L,ARI,28,0,0,0,0
29,8479370,Tyson Jost,C,BUF,26,0,0,0,0
29,8479671,Mathieu Olivier,R,CBJ,27,0,0,0,0
29,8476994,Vinnie Hinostroza,C,PIT,30,0,0,0,0
29,8482070,Mitchell Chaffee,R,TBL,26,0,0,0,0
29,8477473,Justin Bailey,R,SJS,29,0,0,0,0
29,8479344,Jesse Puljujarvi,R,PIT,26,0,0,0,0
29,8480205,Emil Bemstrom,C,PIT,25,0,0,0,0
29,8479718,Alex Barré-Boulet,C,TBL,27,0,0,0,0
29,8482061,Brandon Biro,L,BUF,26,0,0,0,0
29,8479638,Justin Brazeau,R,BOS,26,0,0,0,0
29,8474040,Sam Gagner,C,EDM,35,0,0,0,0
29,8477846,Ryan Carpenter,C,SJS,33,0,0,0,0
29,8482077,Dylan Holloway,L,EDM,23,0,0,0,0
29,8482157,Will Cuylle,L,NYR,22,0,0,0,0
29,8480007,Jonas Rondbjerg,R,VGK,25,0,0,0,0
29,8478874,Adam Gaudette,C,STL,28,0,0,0,0
29,8478434,Keegan Kolesar,R,VGK,27,0,0,0,0
29,8480441,Trey Fix-Wolansky,R,CBJ,25,0,0,0,0
29,8479994,Jaret Anderson-Dolan,C,NSH,25,0,0,0,0
29,8483567,Georgii Merkulov,C,BOS,24,0,0,0,0
29,8477380,Jonny Brodzinski,C,NYR,31,0,0,0,0
29,8482201,Gage Goncalves,C,TBL,23,0,0,0,0
29,8478211,Dryden Hunt,L,CGY,29,0,0,0,0
29,8471699,Andrew Cogliano,C,COL,37,0,0,0,0
29,8479421,Jacob Moverare,D,LAK,26,0,0,0,0
29,8478881,Brett Seney,L,CHI,28,0,0,0,0
29,8477464,Nic Petan,C,MIN,29,0,0,0,0
29,8475958,Michael Sgarbossa,C,WSH,32,0,0,0,0
29,8481147,Reese Johnson,C,CHI,26,0,0,0,0
29,8479336,Carl Grundstrom,R,LAK,27,0,0,0,0
29,8480853,Liam Foudy,C,NSH,24,0,0,0,0
29,8479522,Hardy Haman Aktell,D,WSH,26,0,0,0,0
29,8481462,Mason Morelli,L,VGK,28,0,0,0,0
29,8482102,Vasily Ponomarev,C,CAR,22,0,0,0,0
29,8480844,Grigori Denisenko,L,VGK,24,0,0,0,0
29,8479944,Zach Aston-Reese,C,DET,30,0,0,0,0
29,8482784,Zach Dean,C,STL,21,0,0,0,0
29,8479419,Brett Murray,L,BUF,26,0,0,0,0
29,8479520,Brandon Duhaime,R,COL,27,0,0,0,0
29,8477573,Nathan Walker,L,STL,30,0,0,0,0
29,8478078,Rourke Chartier,C,OTT,28,0,0,0,0
29,8475795,Dylan McIlrath,D,WSH,32,0,0,0,0
29,8482496,Nils Aman,C,VAN,24,0,0,0,0
29,8480289,Morgan Barron,C,WPG,26,0,0,0,0
29,8481751,Lukas Rousek,R,BUF,25,0,0,0,0
29,8480011,Klim Kostin,C,SJS,25,0,0,0,0
29,8481556,John Beecher,C,BOS,23,0,0,0,0
29,8475278,Byron Froese,C,VGK,33,0,0,0,0
29,8475225,Craig Smith,C,DAL,35,0,0,0,0
29,8484326,Patrik Koch,D,ARI,28,0,0,0,0
29,8477930,Pierre-Edouard Bellemare,L,SEA,39,0,0,0,0
29,8478409,Anthony Richard,C,BOS,28,0,0,0,0
29,8481024,Linus Karlsson,C,VAN,25,0,0,0,0
29,8479986,Kole Lind,R,SEA,26,0,0,0,0
29,8479414,Nathan Bastian,R,NJD,27,0,0,0,0
29,8479362,Riley Tufte,L,COL,26,0,0,0,0
29,8481058,Jesse Ylönen,R,MTL,25,0,0,0,0
29,8482476,Emil Heineman,L,MTL,23,0,0,0,0
29,8482861,Vincent Iorio,D,WSH,22,0,0,0,0
29,8483432,Luca Del Bel Belluz,C,CBJ,31,0,0,0,0
29,8482744,James Malatesta,L,CBJ,21,0,0,0,0
29,8477887,Patrick Brown,C,BOS,32,0,0,0,0
29,8478585,Derek Ryan,C,EDM,38,0,0,0,0
29,8481441,Joe Snively,C,WSH,28,0,0,0,0
29,8481592,Jakob Pelletier,L,CGY,23,0,0,0,0
29,8482634,Alex Steeves,C,TOR,25,0,0,0,0
29,8477126,Jayson Megna,C,BOS,34,0,0,0,0
29,8475752,Tyler Pitlick,C,NYR,33,0,0,0,0
29,8480008,Adam Ruzicka,C,ARI,25,0,0,0,0
29,8481065,Angus Crookshank,L,OTT,25,0,0,0,0
29,8479547,Matthew Phillips,R,WSH,26,0,0,0,0
29,8480226,Marián Studenic,R,SEA,26,0,0,0,0
29,8481237,Kyle MacLean,C,NYI,25,0,0,0,0
29,8475413,Justin Dowling,C,NJD,34,0,0,0,0
29,8481641,Joel Kiviranta,L,COL,28,0,0,0,0
29,8478104,Sammy Blais,L,STL,28,0,0,0,0
29,8477454,Adam Erne,L,EDM,29,0,0,0,0
29,8481518,Nolan Foote,L,NJD,24,0,0,0,0
29,8480245,Olle Lycksell,R,PHI,25,0,0,0,0
29,8483570,Ben Meyers,C,ANA,26,0,0,0,0
29,8480776,Sheldon Rempal,R,VGK,29,0,0,0,0
29,8483920,Pierrick Dube,R,WSH,23,0,0,0,0
29,8480267,Sammy Walker,C,MIN,25,0,0,0,0
29,8482747,Brennan Othmann,L,NYR,21,0,0,0,0
29,8479991,Jake Leschyshyn,C,NYR,25,0,0,0,0
29,8478400,Colin White,C,MTL,27,0,0,0,0
29,8479328,Julien Gauthier,R,NYI,27,0,0,0,0
29,8484325,Waltteri Merela,C,TBL,26,0,0,0,0
29,8479066,Ryan Lomberg,L,FLA,30,0,0,0,0
29,8477070,Liam O'Brien,C,ARI,30,0,0,0,0
29,8478146,Matthew Highmore,C,OTT,28,0,0,0,0
29,8478028,Fredrik Olofsson,L,COL,28,0,0,0,0
29,8480880,Jakub Lauko,C,BOS,24,0,0,0,0
29,8479968,Vinni Lettieri,C,MIN,29,0,0,0,0
29,8474709,Matt Martin,L,NYI,35,0,0,0,0
29,8480845,Rasmus Kupari,C,WPG,24,0,0,0,0
29,8481550,Adam Beckman,L,MIN,23,0,0,0,0
29,8481422,Jacob Lucchini,C,MIN,29,0,0,0,0
29,8477401,John Hayden,C,SEA,29,0,0,0,0
29,8478904,Steven Lorentz,C,FLA,28,0,0,0,0
29,8482088,Justin Sourdif,R,FLA,22,0,0,0,0
29,8482751,Ryan Winterton,C,SEA,21,0,0,0,0
29,8482241,Radim Zohorna,L,PIT,28,0,0,0,0
29,8481690,Tyler Angle,C,CBJ,24,0,0,0,0
29,8476952,Dominic Toninato,C,WPG,30,0,0,0,0
29,8476919,Chris Tierney,C,NJD,30,0,0,0,0
29,8480032,Shane Bowers,C,NJD,25,0,0,0,0
29,8484314,Jiri Smejkal,L,OTT,28,0,0,0,0
29,8481239,Samuel Fagemo,L,LAK,24,0,0,0,0
29,8481532,Alex Turcotte,C,LAK,23,0,0,0,0
29,8481019,David Gustafsson,C,WPG,24,0,0,0,0
29,8478477,Mitchell Stephens,C,MTL,27,0,0,0,0
29,8479546,Oskar Steen,C,BOS,26,0,0,0,0
29,8480292,Carson Meyer,R,CBJ,27,0,0,0,0
29,8478446,Glenn Gawdin,C,ANA,27,0,0,0,0
29,8483531,Brian Halonen,L,NJD,25,0,0,0,0
29,8477149,Scott Sabourin,R,SJS,32,0,0,0,0
29,8479972,Mason Shaw,C,MIN,26,0,0,0,0
29,8480890,Jan Jenik,R,ARI,24,0,0,0,0
29,8478051,Max Willman,C,NJD,29,0,0,0,0
29,8480851,Akil Thomas,C,LAK,24,0,0,0,0
29,8482765,Isak Rosen,R,BUF,21,0,0,0,0
29,8478421,A.J. Greer,L,CGY,28,0,0,0,0
29,8478512,Austin Czarnik,C,DET,32,0,0,0,0
29,8479536,Axel Jonsson-Fjallby,L,WPG,26,0,0,0,0
29,8477320,Anton Blidh,L,NYR,29,0,0,0,0
29,8481543,Nikita Alexandrov,C,STL,24,0,0,0,0
29,8475235,Nicolas Deslauriers,L,PHI,33,0,0,0,0
29,8481070,Hugh McGing,L,STL,26,0,0,0,0
29,8480836,Jonathan Gruden,C,PIT,24,0,0,0,0
29,8481591,Sam Poulin,R,PIT,23,0,0,0,0
29,8477962,Brendan Lemieux,L,CAR,28,0,0,0,0
29,8483401,Marc Johnstone,R,PIT,28,0,0,0,0
29,8482250,Callahan Burke,C,CAR,27,0,0,0,0
29,8481726,Adam Edstrom,C,NYR,24,0,0,0,0
29,8471817,Ryan Reaves,R,TOR,37,0,0,0,0
29,8479587,Rhett Gardner,C,PHI,28,0,0,0,0
29,8475766,Austin Watson,L,TBL,32,0,0,0,0
29,8479367,William Lockwood,R,FLA,26,0,0,0,0
29,8478424,Jansen Harkins,C,PIT,27,0,0,0,0
29,8476913,Devin Shore,C,SEA,30,0,0,0,0
29,8482652,Walker Duehr,R,CGY,27,0,0,0,0
29,8477527,Ross Johnston,L,ANA,30,0,0,0,0
29,8481077,John Leonard,L,ARI,26,0,0,0,0
29,8483549,Lucas Condotta,L,MTL,27,0,0,0,0
29,8480468,James Hamblin,L,EDM,25,0,0,0,0
29,8476907,Mackenzie MacEachern,L,STL,30,0,0,0,0
29,8479543,Michael Pezzetta,L,MTL,26,0,0,0,0
29,8480355,Mark Kastelic,C,OTT,25,0,0,0,0
29,8482162,Roby Jarventie,L,OTT,22,0,0,0,0
29,8479772,Zack MacEwen,R,OTT,28,0,0,0,0
29,8483597,Milos Kelemen,L,ARI,25,0,0,0,0
29,8479379,Givani Smith,R,SJS,26,0,0,0,0
29,8481655,Cole Schwindt,R,CGY,23,0,0,0,0
29,8479981,Jonah Gadjovich,L,FLA,26,0,0,0,0
29,8482147,Jean-Luc Foudy,C,COL,22,0,0,0,0
29,8484255,Jason Polin,R,COL,25,0,0,0,0
29,8477993,Justin Kirkland,C,ARI,28,0,0,0,0
29,8479249,Andrew Poturalski,C,SEA,30,0,0,0,0
29,8482197,Adam Raska,R,MIN,23,0,0,0,0
29,8475780,Chris Wagner,R,COL,33,0,0,0,0
29,8479533,Joona Koppanen,L,PIT,26,0,0,0,0
29,8481534,Raphael Lavoie,C,EDM,24,0,0,0,0
29,8484321,Nikolas Matinpalo,D,OTT,26,0,0,0,0
29,8481043,Cole Koepke,L,TBL,26,0,0,0,0
29,8476323,Max McCormick,L,SEA,32,0,0,0,0
29,8483609,Adam Klapka,R,CGY,24,0,0,0,0
29,8483512,Matt Savoie,C,BUF,20,0,0,0,0
29,8484259,Ondrej Pavel,C,COL,31,0,0,0,0
29,8478147,Bokondji Imama,L,OTT,28,0,0,0,0
29,8482460,Matt Rempe,C,NYR,22,0,0,0,0
29,8477073,Kurtis MacDermid,L,NJD,30,0,0,0,0
29,8480274,Philip Kemp,D,EDM,25,0,0,0,0
29,8478956,Samuel Laberge,L,NJD,27,0,0,0,0
29,8483045,Cameron Butler,R,CBJ,31,0,0,0,0
30,8478402,Connor McDavid,C,EDM,27,82,36,79,115
30,8478550,Artemi Panarin,L,NYR,33,82,45,67,112
30,8477956,David Pastrnak,R,BOS,28,82,45,57,102
30,8476453,Nikita Kucherov,R,TBL,31,82,26,75,101
30,8479314,Matthew Tkachuk,L,FLA,27,82,34,66,100
30,8481559,Jack Hughes,C,NJD,23,82,39,60,99
30,8478864,Kirill Kaprizov,L,MIN,27,82,48,50,98
30,8477934,Leon Draisaitl,C,EDM,29,82,42,53,95
30,8478420,Mikko Rantanen,R,COL,28,82,45,49,94
30,8476887,Filip Forsberg,L,NSH,30,82,48,44,92
30,8477939,William Nylander,R,TOR,28,82,33,58,91
30,8479318,Auston Matthews,C,TOR,27,82,48,41,89
30,8477933,Sam Reinhart,C,FLA,29,82,47,41,88
30,8477492,Nathan MacKinnon,C,COL,29,82,39,49,88
30,8478414,Timo Meier,R,NJD,28,82,42,45,87
30,8475172,Nazem Kadri,C,CGY,34,82,27,60,87
30,8478010,Brayden Point,C,TBL,28,82,36,49,85
30,8480023,Robert Thomas,C,STL,25,82,20,64,84
30,8477946,Dylan Larkin,C,DET,28,82,38,43,81
30,8479343,Clayton Keller,R,ARI,26,82,35,46,81
30,8480069,Cale Makar,D,COL,26,82,20,61,81
30,8479385,Jordan Kyrou,C,STL,26,82,34,46,80
30,8478445,Mathew Barzal,C,NYI,27,82,24,56,80
30,8477504,Josh Morrissey,D,WPG,29,82,11,69,80
30,8482684,Luke Hughes,D,NJD,21,82,17,62,79
30,8471215,Evgeni Malkin,C,PIT,38,82,33,45,78
30,8477404,Jake Guentzel,C,CAR,30,82,30,48,78
30,8475184,Chris Kreider,L,NYR,33,82,49,28,77
30,8478427,Sebastian Aho,C,CAR,27,82,34,43,77
30,8475913,Mark Stone,R,VGK,32,82,30,47,77
30,8471214,Alex Ovechkin,L,WSH,39,82,35,41,76
30,8477942,Kevin Fiala,L,LAK,28,82,32,44,76
30,8480801,Brady Tkachuk,L,OTT,25,82,40,35,75
30,8477949,Alex Tuch,R,BUF,28,82,30,45,75
30,8480002,Nico Hischier,C,NJD,25,82,28,47,75
30,8482116,Tim Stützle,C,OTT,22,82,28,47,75
30,8475168,Matt Duchene,C,DAL,33,82,31,43,74
30,8481523,Kirby Dach,C,MTL,23,82,15,59,74
30,8482093,Seth Jarvis,C,CAR,22,82,37,36,73
30,8478398,Kyle Connor,L,WPG,28,82,33,40,73
30,8474564,Steven Stamkos,C,TBL,34,82,31,42,73
30,8478047,Michael Bunting,L,PIT,29,82,28,45,73
30,8480027,Jason Robertson,L,DAL,25,82,29,43,72
30,8475158,Ryan O'Reilly,C,NSH,33,82,26,46,72
30,8479407,Jesper Bratt,L,NJD,26,82,21,51,72
30,8475786,Zach Hyman,L,EDM,32,82,45,26,71
30,8480012,Elias Pettersson,C,VAN,26,82,35,36,71
30,8477951,Nick Schmaltz,C,ARI,28,82,23,48,71
30,8476454,Ryan Nugent-Hopkins,C,EDM,31,82,18,53,71
30,8480800,Quinn Hughes,D,VAN,25,82,13,58,71
30,8479420,Tage Thompson,C,BUF,27,82,31,39,70
30,8476459,Mika Zibanejad,C,NYR,31,82,29,41,70
30,8476468,J.T. Miller,C,VAN,31,82,27,43,70
30,8477493,Aleksander Barkov,C,FLA,29,82,21,48,69
30,8474600,Roman Josi,D,NSH,34,82,18,51,69
30,8473419,Brad Marchand,L,BOS,36,82,25,43,68
30,8477960,Adrian Kempe,R,LAK,28,82,27,40,67
30,8471675,Sidney Crosby,C,PIT,37,82,25,42,67
30,8478439,Travis Konecny,R,PHI,27,82,23,44,67
30,8476456,Jonathan Huberdeau,C,CGY,31,82,16,51,67
30,8479323,Adam Fox,D,NYR,26,82,5,62,67
30,8475765,Vladimir Tarasenko,R,FLA,33,82,22,44,66
30,8476483,Rickard Rakell,R,PIT,31,82,27,38,65
30,8477500,Bo Horvat,C,NYI,29,82,38,26,64
30,8475794,Tyler Seguin,C,DAL,32,82,29,35,64
30,8477409,Carter Verhaeghe,C,FLA,29,82,27,37,64
30,8478449,Roope Hintz,C,DAL,28,82,30,33,63
30,8476881,Tomas Hertl,C,VGK,31,82,28,35,63
30,8480865,Noah Dobson,D,NYI,24,82,14,49,63
30,8475810,Bryan Rust,R,PIT,32,82,26,36,62
30,8477496,Elias Lindholm,C,VAN,30,82,22,40,62
30,8474578,Erik Karlsson,D,PIT,34,82,21,41,62
30,8475784,Jeff Skinner,C,BUF,32,82,28,33,61
30,8480208,Drake Batherson,R,OTT,26,82,18,43,61
30,8470794,Joe Pavelski,C,DAL,40,82,18,43,61
30,8478407,Vince Dunn,D,SEA,28,82,21,39,60
30,8475167,Victor Hedman,D,TBL,34,82,14,46,60
30,8480188,Fabian Zetterlund,L,SJS,25,82,30,29,59
30,8476448,William Karlsson,C,VGK,31,82,28,31,59
30,8480803,Evan Bouchard,D,EDM,25,82,17,42,59
30,8478444,Brock Boeser,R,VAN,27,82,28,30,58
30,8479400,Pierre-Luc Dubois,L,LAK,26,82,27,31,58
30,8478042,Viktor Arvidsson,R,LAK,31,82,21,37,58
30,8478438,Tommy Novak,C,NSH,27,82,14,44,58
30,8480036,Miro Heiskanen,D,DAL,25,82,11,47,58
30,8478403,Jack Eichel,C,VGK,28,82,28,29,57
30,8480018,Nick Suzuki,C,MTL,25,82,27,30,57
30,8475726,Tyler Toffoli,C,WPG,32,82,26,31,57
30,8480078,Filip Chytil,C,NYR,25,82,22,35,57
30,8477402,Pavel Buchnevich,L,STL,29,82,18,39,57
30,8471724,Kris Letang,D,PIT,37,82,12,45,57
30,8475754,Brock Nelson,C,NYI,33,82,31,25,56
30,8476880,Tom Wilson,R,WSH,30,82,24,32,56
30,8476460,Mark Scheifele,C,WPG,31,82,23,33,56
30,8482745,Mason McTavish,C,ANA,21,82,22,34,56
30,8478493,Joel Eriksson Ek,C,MIN,27,82,21,35,56
30,8478401,Pavel Zacha,C,BOS,27,82,20,36,56
30,8476346,Johnny Gaudreau,L,CBJ,31,82,16,40,56
30,8482159,Tyson Foerster,R,PHI,22,82,28,27,55
30,8477501,Valeri Nichushkin,R,COL,29,82,26,29,55
30,8474679,Gustav Nyquist,C,NSH,35,82,25,30,55
30,8473512,Claude Giroux,R,OTT,36,82,23,32,55
30,8476389,Vincent Trocheck,C,NYR,31,82,23,32,55
30,8475798,Mikael Granlund,C,SJS,32,82,22,33,55
30,8478440,Dylan Strome,C,WSH,27,82,20,35,55
30,8478873,Troy Terry,R,ANA,27,82,20,35,55
30,8482097,Jack Quinn,R,BUF,23,82,20,35,55
30,8475692,Mats Zuccarello,R,MIN,37,82,14,41,55
30,8474590,John Carlson,D,WSH,34,82,11,44,55
30,8479425,Filip Hronek,D,VAN,27,82,10,45,55
30,8476853,Morgan Rielly,D,TOR,30,82,6,49,55
30,8476539,Jonathan Marchessault,R,VGK,34,82,27,27,54
30,8474141,Patrick Kane,R,DET,36,82,25,29,54
30,8481540,Cole Caufield,R,MTL,23,82,32,21,53
30,8482110,Dawson Mercer,C,NJD,23,82,32,21,53
30,8479542,Brandon Hagel,L,TBL,26,82,24,29,53
30,8478498,Jake DeBrusk,L,BOS,28,82,24,29,53
30,8480830,Andrei Svechnikov,R,CAR,24,82,23,30,53
30,8482665,Matty Beniers,C,SEA,22,82,17,36,53
30,8477447,Shea Theodore,D,VGK,29,82,8,45,53
30,8474157,Max Pacioretty,L,WSH,36,82,25,27,52
30,8479337,Alex DeBrincat,R,DET,27,82,24,28,52
30,8478233,Andrew Mangiapane,L,CGY,28,82,23,29,52
30,8483808,Andrei Kuzmenko,L,CGY,28,82,23,29,52
30,8477955,Jared McCann,L,SEA,28,82,22,30,52
30,8475287,Erik Haula,L,NJD,33,82,20,32,52
30,8476462,Dougie Hamilton,D,NJD,31,82,17,35,52
30,8477503,Max Domi,C,TOR,29,82,13,39,52
30,8479325,Charlie McAvoy,D,BOS,27,82,12,40,52
30,8482740,Wyatt Johnston,C,DAL,21,82,28,23,51
30,8481557,Matt Boldy,L,MIN,23,82,22,29,51
30,8481528,Dylan Cozens,C,BUF,23,82,19,32,51
30,8479410,Mikhail Sergachev,D,TBL,26,82,9,42,51
30,8480014,Gabriel Vilardi,C,WPG,25,82,32,18,50
30,8475166,John Tavares,C,TOR,34,82,25,25,50
30,8481618,Alex Newhook,C,MTL,23,82,25,25,50
30,8475169,Evander Kane,L,EDM,33,82,22,28,50
30,8481542,Moritz Seider,D,DET,23,82,11,39,50
30,8484144,Connor Bedard,C,CHI,19,82,29,20,49
30,8481533,Trevor Zegras,C,ANA,23,82,24,25,49
30,8474150,Mikael Backlund,C,CGY,35,82,22,27,49
30,8480039,Martin Necas,C,CAR,25,82,15,34,49
30,8476905,Chandler Stephenson,C,VGK,30,82,15,34,49
30,8480031,Maxime Comtois,L,CAR,25,82,9,40,49
30,8477940,Nikolaj Ehlers,L,WPG,28,82,19,29,48
30,8475151,Kyle Palmieri,C,NYI,33,82,17,31,48
30,8477935,Sam Bennett,C,FLA,28,82,21,26,47
30,8481068,Yegor Sharangovich,C,CGY,26,82,21,26,47
30,8480839,Rasmus Dahlin,D,BUF,24,82,17,30,47
30,8473994,Jamie Benn,L,DAL,35,82,17,30,47
30,8482124,Quinton Byfield,R,LAK,22,82,15,32,47
30,8479675,Trevor Moore,L,LAK,29,82,19,27,46
30,8479339,Patrik Laine,L,CBJ,26,82,18,28,46
30,8477021,Alex Kerfoot,C,ARI,30,82,18,28,46
30,8474641,Adam Henrique,C,EDM,34,82,15,31,46
30,8477416,Oliver Bjorkstrand,R,SEA,29,82,14,32,46
30,8476872,Scott Laughton,C,PHI,30,82,13,33,46
30,8475745,Charlie Coyle,C,BOS,32,82,12,34,46
30,8478038,Devon Toews,D,COL,30,82,11,35,46
30,8477346,MacKenzie Weegar,D,CGY,30,82,4,42,46
30,8477497,Sean Monahan,C,WPG,30,82,21,24,45
30,8475170,Brayden Schenn,C,STL,33,82,20,25,45
30,8482175,JJ Peterka,R,BUF,22,82,20,25,45
30,8474102,David Perron,L,DET,36,82,19,26,45
30,8476869,Brady Skjei,D,CAR,30,82,13,32,45
30,8477494,Jonathan Drouin,L,COL,29,82,11,34,45
30,8482133,Thomas Bordeleau,C,SJS,22,82,11,34,45
30,8480015,Owen Tippett,R,PHI,25,82,28,16,44
30,8475314,Anders Lee,L,NYI,34,82,24,20,44
30,8477444,Andre Burakovsky,L,SEA,29,82,20,24,44
30,8477407,Anthony Duclair,L,TBL,29,82,20,24,44
30,8482078,Lucas Raymond,L,DET,22,82,17,27,44
30,8479999,Casey Mittelstadt,C,COL,26,82,11,33,44
30,8476882,Teuvo Teravainen,L,CAR,30,82,11,33,44
30,8478460,Zach Werenski,D,CBJ,27,82,7,37,44
30,8483397,Marc McLaughlin,C,BOS,25,82,35,8,43
30,8476399,Blake Coleman,C,CGY,33,82,29,14,43
30,8482699,Dylan Guenther,R,ARI,21,82,27,16,43
30,8478856,Conor Garland,R,VAN,28,82,18,25,43
30,8482113,Anton Lundell,C,FLA,23,82,18,25,43
30,8471685,Anze Kopitar,C,LAK,37,82,14,29,43
30,8480798,Philipp Kurashev,C,CHI,25,82,9,34,43
30,8480434,Sean Durzi,D,ARI,26,82,9,34,43
30,8477476,Artturi Lehkonen,L,COL,29,82,24,18,42
30,8482101,Danil Gushchin,L,SJS,22,82,22,20,42
30,8478462,Nicolas Roy,C,VGK,27,82,19,23,42
30,8482222,Alexander Barabanov,L,SJS,30,82,18,24,42
30,8477456,J.T. Compher,L,DET,29,82,17,25,42
30,8480009,Eeli Tolvanen,R,SEA,25,82,14,28,42
30,8475763,Kevin Hayes,R,STL,32,82,21,20,41
30,8477952,Robby Fabbri,C,DET,28,82,17,24,41
30,8480797,Joel Farabee,L,PHI,24,82,13,28,41
30,8474053,Logan Couture,C,SJS,35,82,13,28,41
30,8476826,Yanni Gourde,C,SEA,33,82,11,30,41
30,8476875,Mike Matheson,D,MTL,30,82,10,31,41
30,8476906,Shayne Gostisbehere,D,DET,31,82,8,33,41
30,8477969,Marcus Pettersson,D,PIT,28,82,8,33,41
30,8475714,Calle Jarnkrok,C,TOR,33,82,21,19,40
30,8478046,Danton Heinen,L,BOS,29,82,20,20,40
30,8476432,Boone Jenner,C,CBJ,31,82,19,21,40
30,8482702,Logan Stankoven,C,DAL,21,82,18,22,40
30,8478891,Mason Appleton,C,WPG,28,82,18,22,40
30,8482720,Matthew Knies,L,TOR,22,82,17,23,40
30,8481699,Aku Raty,R,ARI,23,82,2,38,40
30,8482089,Jake Neighbours,L,STL,22,82,25,14,39
30,8477426,Nicholas Paul,L,TBL,29,82,19,20,39
30,8478057,Dakota Joshua,C,VAN,28,82,19,20,39
30,8482055,Drew O'Connor,L,PIT,26,82,19,20,39
30,8482667,William Eklund,L,SJS,22,82,17,22,39
30,8482475,Yegor Chinakhov,R,CBJ,23,82,16,23,39
30,8471698,T.J. Oshie,R,WSH,38,82,15,24,39
30,8475744,Evgeny Kuznetsov,C,CAR,32,82,13,26,39
30,8481711,Matias Maccelli,L,ARI,24,82,11,28,39
30,8478469,Thomas Chabot,D,OTT,27,82,11,28,39
30,8475906,John Klingberg,D,TOR,32,82,6,33,39
30,8478366,Frank Vatrano,R,ANA,30,82,26,12,38
30,8476329,Travis Boyd,C,ARI,31,82,12,26,38
30,8480068,Ryan Poehling,C,PHI,25,82,12,26,38
30,8478413,Jordan Greenway,L,BUF,27,82,11,27,38
30,8483471,Brad Lambert,C,WPG,31,82,10,28,38
30,8478397,Rasmus Andersson,D,CGY,28,82,9,29,38
30,8476792,Torey Krug,D,STL,33,82,9,29,38
30,8481581,Thomas Harley,D,DAL,23,82,8,30,38
30,8474563,Drew Doughty,D,LAK,35,82,6,32,38
30,8474565,Alex Pietrangelo,D,VGK,34,82,5,33,38
30,8480064,Josh Norris,C,OTT,25,82,21,16,37
30,8477451,Ryan Hartman,R,MIN,30,82,21,16,37
30,8478519,Anthony Cirelli,C,TBL,27,82,20,17,37
30,8476479,Phillip Danault,C,LAK,31,82,15,22,37
30,8478542,Evan Rodrigues,C,FLA,31,82,14,23,37
30,8475791,Taylor Hall,L,CHI,33,82,12,25,37
30,8478472,Mathieu Joseph,R,OTT,27,82,12,25,37
30,8481596,Shane Pinto,C,OTT,24,82,11,26,37
30,8483524,Shane Wright,C,SEA,20,82,25,11,36
30,8475799,Nino Niederreiter,R,WPG,32,82,24,12,36
30,8477947,Sonny Milano,L,WSH,28,82,23,13,36
30,8482109,Alexis Lafrenière,L,NYR,23,82,19,17,36
30,8473986,Alex Killorn,L,ANA,35,82,15,21,36
30,8476960,Andreas Athanasiou,C,CHI,30,82,14,22,36
30,8482146,Luke Evangelista,R,NSH,22,82,12,24,36
30,8477964,Ivan Barbashev,C,VGK,29,82,11,25,36
30,8476458,Ryan Strome,C,ANA,31,82,10,26,36
30,8477932,Aaron Ekblad,D,FLA,28,82,10,26,36
30,8480817,K'Andre Miller,D,NYR,24,82,9,27,36
30,8478474,Lawson Crouse,L,ARI,27,82,19,16,35
30,8477450,Jason Dickinson,C,CHI,29,82,18,17,35
30,8471218,Blake Wheeler,R,NYR,38,82,15,20,35
30,8477998,Warren Foegele,L,EDM,28,82,14,21,35
30,8475753,Justin Faulk,D,STL,32,82,9,26,35
30,8478975,Mason Marchment,L,DAL,29,82,9,26,35
30,8483445,Cutter Gauthier,L,ANA,20,82,9,26,35
30,8481703,Valtteri Puustinen,R,PIT,25,82,7,28,35
30,8476958,Jaccob Slavin,D,CAR,30,82,6,29,35
30,8481624,Ilya Mikheyev,R,VAN,30,82,21,13,34
30,8475793,Ryan Johansen,C,PHI,32,82,20,14,34
30,8477479,Tyler Bertuzzi,L,TOR,29,82,19,15,34
30,8480028,Morgan Frost,C,PHI,25,82,16,18,34
30,8484166,Adam Fantilli,C,CBJ,20,82,14,20,34
30,8474149,Evgenii Dadonov,R,DAL,35,82,14,20,34
30,8476438,Brandon Saad,L,STL,32,82,14,20,34
30,8477498,Darnell Nurse,D,EDM,29,82,13,21,34
30,8477986,Brandon Montour,D,FLA,30,82,9,25,34
30,8478396,Noah Hanifin,D,VGK,27,82,4,30,34
30,8477944,Jakub Vrana,L,STL,28,82,20,13,33
30,8480459,Pius Suter,C,VAN,28,82,19,14,33
30,8475722,Jason Zucker,L,NSH,32,82,16,17,33
30,8480185,Eetu Luostarinen,C,FLA,26,82,16,17,33
30,8478458,Jack Roslovic,C,NYR,27,82,15,18,33
30,8480849,Barrett Hayton,C,ARI,24,82,13,20,33
30,8477948,Travis Sanheim,D,PHI,28,82,12,21,33
30,8479345,Jakob Chychrun,D,OTT,26,82,11,22,33
30,8475768,Jaden Schwartz,C,SEA,32,82,11,22,33
30,8474037,James van Riemsdyk,L,BOS,35,82,11,22,33
30,8480220,Noah Cates,L,PHI,25,82,10,23,33
30,8480145,Neal Pionk,D,WPG,29,82,7,26,33
30,8480035,Henri Jokiharju,D,BUF,25,82,7,26,33
30,8478178,Darren Raddysh,D,TBL,28,82,6,27,33
30,8476927,Teddy Blueger,C,VAN,30,82,5,28,33
30,8478055,Gustav Forsling,D,FLA,28,82,4,29,33
30,8482705,Cole Sillinger,C,CBJ,21,82,19,13,32
30,8484153,Leo Carlsson,C,ANA,20,82,17,15,32
30,8480113,Alex Iafallo,L,WPG,31,82,17,15,32
30,8481093,Rafael Harvey-Pinard,L,MTL,25,82,17,15,32
30,8476981,Josh Anderson,R,MTL,30,82,15,17,32
30,8476469,Joel Armia,R,MTL,31,82,13,19,32
30,8473422,Nick Foligno,L,CHI,37,82,11,21,32
30,8480873,Rasmus Sandin,D,WSH,24,82,9,23,32
30,8482624,Daniil Miromanov,D,CGY,27,82,8,24,32
30,8477495,Seth Jones,D,CHI,30,82,8,24,32
30,8473563,Nicklas Backstrom,C,WSH,37,82,7,25,32
30,8475181,Nick Leddy,D,STL,33,82,3,29,32
30,8481604,Pavel Dorofeyev,L,VGK,24,82,18,13,31
30,8481704,Juuso Parssinen,C,NSH,23,82,15,16,31
30,8482259,Bobby McMann,C,TOR,28,82,14,17,31
30,8480802,Ryan McLeod,C,EDM,25,82,13,18,31
30,8476419,Jean-Gabriel Pageau,C,NYI,32,82,12,19,31
30,8475191,Reilly Smith,R,PIT,33,82,10,21,31
30,8478463,Anthony Beauvillier,L,NSH,27,82,10,21,31
30,8476885,Jacob Trouba,D,NYR,30,82,9,22,31
30,8476902,Esa Lindell,D,DAL,30,82,5,26,31
30,8476979,Erik Gustafsson,D,NYR,32,82,2,29,31
30,8475764,Cam Fowler,D,ANA,33,82,1,30,31
30,8475848,Brendan Gallagher,R,MTL,32,82,15,15,30
30,8474884,Mike Hoffman,C,SJS,35,82,13,17,30
30,8470613,Brent Burns,D,CAR,39,82,11,19,30
30,8476292,Ondrej Palat,L,NJD,33,82,10,20,30
30,8479987,Morgan Geekie,C,BOS,26,82,8,22,30
30,8481481,Blake Lizotte,C,LAK,27,82,7,23,30
30,8481656,Aliaksei Protas,C,WSH,23,82,6,24,30
30,8476854,Hampus Lindholm,D,BOS,30,82,5,25,30
30,8480855,Jack McBain,C,ARI,24,82,19,10,29
30,8474586,Jordan Eberle,R,SEA,34,82,15,14,29
30,8473449,Kyle Okposo,R,FLA,36,82,15,14,29
30,8481580,Connor McMichael,C,WSH,23,82,13,16,29
30,8480821,Filip Zadina,R,SJS,25,82,13,16,29
30,8480074,Alexandre Texier,C,CBJ,25,82,12,17,29
30,8476921,Jordan Martinook,L,CAR,32,82,10,19,29
30,8476480,Vladislav Namestnikov,C,WPG,32,82,8,21,29
30,8482105,Jake Sanderson,D,OTT,22,82,6,23,29
30,8476457,Adam Larsson,D,SEA,32,82,5,24,29
30,8474151,Ryan McDonagh,D,NSH,35,82,4,25,29
30,8475760,Nick Bjugstad,C,ARI,32,82,19,9,28
30,8477989,Christian Dvorak,C,MTL,28,82,18,10,28
30,8470610,Zach Parise,L,COL,40,82,17,11,28
30,8476278,Colin Blackwell,C,CHI,31,82,15,13,28
30,8479525,Ross Colton,C,COL,28,82,14,14,28
30,8475149,Marcus Johansson,L,MIN,34,82,9,19,28
30,8479351,Sam Steel,C,DAL,26,82,9,19,28
30,8476891,Matt Grzelcyk,D,BOS,30,82,9,19,28
30,8476925,Colton Sissons,C,NSH,31,82,8,20,28
30,8476871,Tanner Pearson,L,MTL,32,82,8,20,28
30,8476917,Adam Pelech,D,NYI,30,82,6,22,28
30,8483493,Frank Nazar,C,CHI,20,82,20,7,27
30,8482079,Marco Rossi,C,MIN,23,82,19,8,27
30,8479423,Alex Nylander,L,CBJ,26,82,17,10,27
30,8479941,Justin Danforth,R,CBJ,31,82,16,11,27
30,8479996,Cody Glass,C,NSH,25,82,15,12,27
30,8482125,Alexander Holtz,R,NJD,22,82,15,12,27
30,8481560,Arthur Kaliyev,R,LAK,23,82,14,13,27
30,8481013,Jonatan Berggren,R,DET,24,82,13,14,27
30,8479393,Noah Gregor,C,TOR,26,82,13,14,27
30,8475164,Jakob Silfverberg,R,ANA,34,82,12,15,27
30,8479415,Michael McLeod,C,NJD,26,82,11,16,27
30,8480336,Sean Walker,D,COL,30,82,11,16,27
30,8476392,Adam Lowry,C,WPG,31,82,10,17,27
30,8482092,Ridly Greig,C,OTT,22,82,10,17,27
30,8478115,Pierre Engvall,L,NYI,28,82,10,17,27
30,8482111,Justin Barron,D,MTL,23,82,10,17,27
30,8476873,Mark Jankowski,C,NSH,30,82,10,17,27
30,8477511,Anthony Mantha,R,VGK,30,82,9,18,27
30,8484145,Zach Benson,L,BUF,19,82,9,18,27
30,8483515,Juraj Slafkovsky,L,MTL,20,82,8,19,27
30,8474034,Pat Maroon,L,BOS,36,82,8,19,27
30,8479992,Michael Rasmussen,C,DET,25,82,7,20,27
30,8477015,Connor Brown,R,EDM,30,82,6,21,27
30,8481524,Bowen Byram,D,BUF,23,82,6,21,27
30,8480043,Timothy Liljegren,D,TOR,25,82,4,23,27
30,8476923,Damon Severson,D,CBJ,30,82,3,24,27
30,8479398,Samuel Girard,D,COL,26,82,3,24,27
30,8482733,Logan Mailloux,D,MTL,31,82,2,25,27
30,8481554,Kaapo Kakko,R,NYR,23,82,17,9,26
30,8470604,Jeff Carter,C,PIT,39,82,16,10,26
30,8477353,Tyler Motte,C,TBL,29,82,15,11,26
30,8479316,Luke Kunin,C,SJS,27,82,15,11,26
30,8479353,Brett Howden,C,VGK,26,82,14,12,26
30,8474870,Tyler Johnson,C,CHI,34,82,13,13,26
30,8478466,Daniel Sprong,R,DET,27,82,13,13,26
30,8477953,Kasperi Kapanen,R,STL,28,82,12,14,26
30,8479359,Beck Malenstyn,L,WSH,26,82,12,14,26
30,8479514,Rem Pitlick,C,CHI,27,82,11,15,26
30,8478416,Erik Cernak,D,TBL,27,82,11,15,26
30,8479365,Trent Frederic,C,BOS,26,82,9,17,26
30,8483431,Logan Cooley,C,ARI,20,82,9,17,26
30,8482671,Owen Power,D,BUF,22,82,8,18,26
30,8475218,Mattias Ekholm,D,EDM,34,82,7,19,26
30,8482117,Lukas Reichel,L,CHI,22,82,7,19,26
30,8481606,Jordan Spence,D,LAK,23,82,6,20,26
30,8482122,Brock Faber,D,MIN,22,82,5,21,26
30,8474574,Tyler Myers,D,VAN,34,82,4,22,26
30,8476331,Dylan DeMelo,D,WPG,31,82,3,23,26
30,8483490,Pavel Mintyukov,D,ANA,21,82,2,24,26
30,8478882,Vladislav Gavrikov,D,LAK,29,82,1,25,26
30,8483457,Lane Hutson,D,MTL,20,82,0,26,26
30,8477429,Andrew Copp,C,DET,30,82,11,14,25
30,8475343,Nic Dowd,C,WSH,34,82,11,14,25
30,8476422,Mike Reilly,D,NYI,31,82,9,16,25
30,8476442,Matt Nieto,L,PIT,32,82,9,16,25
30,8477506,Ryan Pulock,D,NYI,30,82,9,16,25
30,8477425,Miles Wood,L,COL,29,82,8,17,25
30,8470600,Ryan Suter,D,DAL,39,82,8,17,25
30,8477507,Nikita Zadorov,D,VAN,29,82,6,19,25
30,8476463,Jonas Brodin,D,MIN,31,82,4,21,25
30,8474716,Jared Spurgeon,D,MIN,35,82,4,21,25
30,8481016,Ruslan Iskhakov,C,NYI,24,82,3,22,25
30,8481568,Alex Vlasic,D,CHI,23,82,2,23,25
30,8481535,Nils Hoglander,L,VAN,24,82,17,7,24
30,8481186,Logan O'Connor,R,COL,28,82,14,10,24
30,8480144,David Kampf,C,TOR,29,82,13,11,24
30,8477919,Frederick Gaudreau,C,MIN,31,82,12,12,24
30,8478133,Jake Evans,C,MTL,28,82,11,13,24
30,8475200,Dmitry Orlov,D,CAR,33,82,10,14,24
30,8473533,Jordan Staal,C,CAR,36,82,9,15,24
30,8479591,Michael Eyssimont,C,TBL,28,82,9,15,24
30,8475197,Tyson Barrie,D,NSH,33,82,8,16,24
30,8477488,Brett Pesce,D,CAR,30,82,8,16,24
30,8482142,Jamie Drysdale,D,PHI,22,82,5,19,24
30,8476892,Colton Parayko,D,STL,31,82,3,21,24
30,8481546,Cam York,D,PHI,23,82,3,21,24
30,8477220,Nate Schmidt,D,WPG,33,82,2,22,24
30,8479976,Juuso Valimaki,D,ARI,26,82,2,22,24
30,8480893,Kirill Marchenko,R,CBJ,24,82,14,9,23
30,8478508,Yakov Trenin,C,COL,27,82,13,10,23
30,8478109,Victor Olofsson,L,BUF,29,82,12,11,23
30,8480448,Parker Kelly,L,OTT,25,82,12,11,23
30,8474189,Lars Eller,C,PIT,35,82,11,12,23
30,8476374,Sean Kuraly,C,CBJ,31,82,11,12,23
30,8483491,Ivan Miroshnichenko,L,WSH,20,82,11,12,23
30,8476461,Sean Couturier,C,PHI,32,82,9,14,23
30,8480813,Joe Veleno,C,DET,24,82,9,14,23
30,8476624,Barclay Goodrow,C,NYR,31,82,5,18,23
30,8480073,Erik Brannstrom,D,OTT,25,82,3,20,23
30,8478507,John Marino,D,NJD,27,82,2,21,23
30,8479293,Brandon Tanev,L,SEA,33,82,12,10,22
30,8477839,Conor Sheary,L,TBL,32,82,11,11,22
30,8479390,Taylor Raddysh,R,CHI,26,82,10,12,22
30,8479383,Boris Katchouk,L,OTT,26,82,10,12,22
30,8477508,Curtis Lazar,C,NJD,29,82,9,13,22
30,8480860,Kevin Bahl,D,NJD,24,82,7,15,22
30,8475171,Oliver Ekman-Larsson,D,FLA,33,82,6,16,22
30,8478911,Matt Roy,D,LAK,29,82,6,16,22
30,8476525,Colin Miller,D,WPG,32,82,5,17,22
30,8483499,Liam Ohgren,L,MIN,20,82,12,9,21
30,8482730,Brandt Clarke,D,LAK,21,82,11,10,21
30,8478136,Jake Middleton,D,MIN,28,82,5,16,21
30,8477392,Hudson Fasching,R,NYI,29,82,5,16,21
30,8481477,Nico Sturm,C,SJS,29,82,5,16,21
30,8478851,Alexandre Carrier,D,NSH,28,82,4,17,21
30,8478443,Brandon Carlo,D,BOS,28,82,4,17,21
30,8475233,David Savard,D,MTL,34,82,3,18,21
30,8483495,Simon Nemec,D,NJD,20,82,3,18,21
30,8478020,Michael Amadio,C,VGK,28,82,13,7,20
30,8477330,Dominik Kubalik,L,OTT,29,82,13,7,20
30,8480281,Alexey Toropchenko,R,STL,25,82,13,7,20
30,8484203,Bradly Nadeau,L,CAR,19,82,12,8,20
30,8482074,Connor Zary,C,CGY,23,82,12,8,20
30,8482155,Alex Laferriere,R,LAK,23,82,12,8,20
30,8475842,Sam Carrick,C,EDM,32,82,11,9,20
30,8482245,Artem Zub,D,OTT,29,82,7,13,20
30,8478043,Sam Lafferty,C,VAN,29,82,7,13,20
30,8481517,Brett Leason,R,ANA,25,82,7,13,20
30,8478840,Will Borgen,D,SEA,28,82,6,14,20
30,8470966,Mark Giordano,D,TOR,41,82,5,15,20
30,8482470,Ilya Solovyov,D,CGY,24,82,5,15,20
30,8479661,Tanner Jeannot,L,TBL,27,82,4,16,20
30,8478500,Ivan Provorov,D,CBJ,27,82,3,17,20
30,8481178,Egor Zamula,D,PHI,24,82,3,17,20
30,8474673,TJ Brodie,D,TOR,34,82,3,17,20
30,8482712,Oskar Olausson,R,COL,22,82,3,17,20
30,8479371,Dante Fabbro,D,NSH,26,82,3,17,20
30,8473507,Jeff Petry,D,DET,37,82,0,20,20
30,8482145,Mavrik Bourque,C,DAL,22,82,16,3,19
30,8474715,Cam Atkinson,R,PHI,35,82,13,6,19
30,8482809,Jackson Blake,R,CAR,21,82,12,7,19
30,8473453,Trevor Lewis,C,LAK,37,82,12,7,19
30,8479346,Dillon Dube,C,CGY,26,82,11,8,19
30,8481522,Peyton Krebs,C,BUF,23,82,11,8,19
30,8474009,Nick Bonino,C,NYR,36,82,10,9,19
30,8479977,Kailer Yamamoto,R,SEA,26,82,9,10,19
30,8477406,Mattias Janmark,C,EDM,32,82,9,10,19
30,8482737,Zack Bolduc,C,STL,21,82,8,11,19
30,8478013,Jake Walman,D,DET,28,82,7,12,19
30,8482062,Cole Smith,L,NSH,29,82,7,12,19
30,8480796,Martin Fehervary,D,WSH,25,82,6,13,19
30,8475220,Marcus Foligno,L,MIN,33,82,5,14,19
30,8482655,J.J. Moser,D,ARI,24,82,5,14,19
30,8475279,Ben Chiarot,D,DET,33,82,4,15,19
30,8481537,Nikita Okhotiuk,D,CGY,24,82,4,15,19
30,8480807,Mattias Samuelsson,D,BUF,24,82,3,16,19
30,8475462,Radko Gudas,D,ANA,34,82,3,16,19
30,8480871,Adam Boqvist,D,CBJ,24,82,2,17,19
30,8481567,Henry Thrun,D,SJS,23,82,2,17,19
30,8481014,Alexander Romanov,D,NYI,24,82,1,18,19
30,8479324,Ryan Lindgren,D,NYR,26,82,1,18,19
30,8470621,Corey Perry,R,EDM,39,82,11,7,18
30,8478569,Noel Acciari,C,PIT,33,82,9,9,18
30,8476858,Phillip Di Giuseppe,L,VAN,31,82,8,10,18
30,8480806,Isac Lundestrom,C,ANA,25,82,7,11,18
30,8475324,Nick Jensen,D,WSH,34,82,6,12,18
30,8473504,Cal Clutterbuck,R,NYI,37,82,6,12,18
30,8482516,Matthew Kessel,D,STL,24,82,6,12,18
30,8478451,Ethan Bear,D,WSH,27,82,5,13,18
30,8475455,Brenden Dillon,D,WPG,34,82,4,14,18
30,8474567,Zach Bogosian,D,MIN,34,82,4,14,18
30,8475690,Chris Tanev,D,DAL,35,82,3,15,18
30,8479983,Mario Ferraro,D,SJS,26,82,3,15,18
30,8483505,Matthew Poitras,C,BOS,20,82,3,15,18
30,8476312,Josh Manson,D,COL,33,82,2,16,18
30,8480246,Nick Perbix,D,TBL,26,82,2,16,18
30,8475188,Brayden McNabb,D,VGK,33,82,0,18,18
30,8478831,Kevin Stenlund,C,FLA,28,82,11,6,17
30,8476878,Zemgus Girgensons,L,BUF,30,82,8,9,17
30,8481028,Martin Pospisil,C,CGY,25,82,6,11,17
30,8478430,Oliver Kylington,D,CGY,27,82,6,11,17
30,8476897,Oskar Sundqvist,C,STL,30,82,5,12,17
30,8476931,Jake McCabe,D,TOR,31,82,5,12,17
30,8475790,Erik Gudbranson,D,CBJ,32,82,5,12,17
30,8476879,Cody Ceci,D,EDM,31,82,4,13,17
30,8477369,Carson Soucy,D,VAN,30,82,4,13,17
30,8476467,Jamie Oleksiak,D,SEA,32,82,2,15,17
30,8477845,Trevor van Riemsdyk,D,WSH,33,82,1,16,17
30,8482118,Sam Colangelo,R,ANA,23,82,13,3,16
30,8479291,Kevin Rooney,C,CGY,31,82,9,7,16
30,8482679,Matt Coronato,R,CGY,22,82,7,9,16
30,8475231,Casey Cizikas,C,NYI,33,82,7,9,16
30,8482858,Ryker Evans,D,SEA,23,82,6,10,16
30,8481605,Jackson LaCombe,D,ANA,23,82,5,11,16
30,8474013,Ian Cole,D,VAN,35,82,5,11,16
30,8483565,Nick Blankenburg,D,CBJ,26,82,4,12,16
30,8482803,Olen Zellweger,D,ANA,21,82,3,13,16
30,8483466,Kevin Korchinski,D,CHI,20,82,3,13,16
30,8478859,Niko Mikkola,D,FLA,28,82,3,13,16
30,8479442,Troy Stecher,D,EDM,30,82,1,15,16
30,8481601,Simon Holmstrom,R,NYI,23,82,12,3,15
30,8476822,Luke Glendening,C,TBL,35,82,7,8,15
30,8481553,Bobby Brink,R,PHI,23,82,4,11,15
30,8479980,Nicolas Hague,D,VGK,26,82,4,11,15
30,8478399,Jonas Siegenthaler,D,NJD,27,82,4,11,15
30,8484149,Gavin Brindley,C,CBJ,20,82,4,11,15
30,8477435,Ryan Graves,D,PIT,29,82,3,12,15
30,8482166,Shakir Mukhamadullin,D,SJS,22,82,3,12,15
30,8481059,Scott Perunovich,D,STL,26,82,2,13,15
30,8475179,Dmitry Kulikov,D,FLA,34,82,1,14,15
30,8480834,Ty Emberson,D,SJS,24,82,1,14,15
30,8477499,Rasmus Ristolainen,D,PHI,30,82,5,9,14
30,8476429,Scott Mayfield,D,NYI,32,82,5,9,14
30,8483482,Tristan Luneau,D,ANA,20,82,4,10,14
30,8475208,Brian Dumoulin,D,SEA,33,82,4,10,14
30,8480980,Connor Dewar,C,TOR,25,82,4,10,14
30,8484911,Collin Graf,R,SJS,22,82,4,10,14
30,8482087,Kaiden Guhle,D,MTL,22,82,0,14,14
30,8477034,Jaycob Megna,D,CHI,32,82,0,14,14
30,8480058,Pierre-Olivier Joseph,D,PIT,25,82,7,6,13
30,8477335,Kyle Burroughs,D,SJS,29,82,7,6,13
30,8477931,Tomas Nosek,L,NJD,32,82,6,7,13
30,8478408,Travis Dermott,D,ARI,28,82,4,9,13
30,8480990,Declan Chisholm,D,MIN,24,82,3,10,13
30,8477505,Alexander Wennberg,C,NYR,30,82,2,11,13
30,8480879,Jacob Bernard-Docker,D,OTT,24,82,2,11,13
30,8481030,Jack St. Ivany,D,PIT,25,82,2,11,13
30,8476967,Brett Kulak,D,EDM,30,82,1,12,13
30,8482666,Scott Morrow,D,CAR,22,82,6,6,12
30,8478468,Jeremy Lauzon,D,NSH,27,82,4,8,12
30,8476473,Connor Murphy,D,CHI,31,82,3,9,12
30,8471677,Jack Johnson,D,COL,37,82,3,9,12
30,8475825,Jani Hakanpää,D,DAL,32,82,3,9,12
30,8479998,Mikey Anderson,D,LAK,25,82,2,10,12
30,8482762,Simon Edvinsson,D,DET,21,82,5,6,11
30,8483489,Fraser Minten,C,TOR,31,82,5,6,11
30,8477365,Connor Clifton,D,BUF,29,82,0,11,11
30,8481599,Victor Soderstrom,D,ARI,23,82,6,4,10
30,8479369,Andrew Peeke,D,BOS,26,82,5,5,10
30,8476915,Jujhar Khaira,L,MIN,30,82,5,5,10
30,8482713,Mackie Samoskevich,R,FLA,22,82,4,6,10
30,8474166,Alec Martinez,D,VGK,37,82,3,7,10
30,8475762,Derek Forbort,D,BOS,32,82,2,8,10
30,8482073,Braden Schneider,D,NYR,23,82,1,9,10
30,8483468,Jiri Kulich,C,BUF,20,82,3,6,9
30,8475177,Calvin de Haan,D,TBL,33,82,1,8,9
30,8476372,Nick Seeler,D,PHI,31,82,1,8,9
30,8482807,Ethan Del Mastro,D,CHI,21,82,1,8,9
30,8483012,Logan Morrison,C,SEA,22,82,3,5,8
30,8481578,Graeme Clarke,R,NJD,23,82,3,5,8
30,8482859,Zack Ostapchuk,C,OTT,21,82,2,6,8
30,8482177,Marat Khusnutdinov,C,MIN,22,82,1,6,7
30,8483763,Maksymilian Szuber,D,ARI,22,82,1,5,6
30,8480172,Jan Rutta,D,SJS,34,82,0,5,5
30,8482141,Lukas Cormier,D,VGK,22,0,0,0,0
30,8476988,Matt Benning,D,SJS,30,0,0,0,0
30,8480727,Zach Whitecloud,D,VGK,28,0,0,0,0
30,8480887,Jordan Harris,D,MTL,24,0,0,0,0
30,8478450,Parker Wotherspoon,D,BOS,27,0,0,0,0
30,8481812,Nikolai Knyzhov,D,SJS,27,0,0,0,0
30,8480001,Urho Vaakanainen,D,ANA,25,0,0,0,0
30,8482176,Wyatt Kaiser,D,CHI,22,0,0,0,0
30,8481122,Simon Benoit,D,TOR,26,0,0,0,0
30,8476441,Joel Edmundson,D,TOR,31,0,0,0,0
30,8480884,Calen Addison,D,SJS,24,0,0,0,0
30,8482511,Mason Lohrei,D,BOS,23,0,0,0,0
30,8482192,Isaak Phillips,D,CHI,23,0,0,0,0
30,8480950,Ilya Lyubushkin,D,TOR,30,0,0,0,0
30,8474031,Kevin Shattenkirk,D,BOS,35,0,0,0,0
30,8475718,Justin Holl,D,DET,32,0,0,0,0
30,8479402,Jake Bean,D,CBJ,26,0,0,0,0
30,8474602,Justin Schultz,D,SEA,34,0,0,0,0
30,8477950,Tony DeAngelo,D,CAR,29,0,0,0,0
30,8481743,Marc Del Gaizo,D,NSH,25,0,0,0,0
30,8481527,Kaedan Korczak,D,VGK,23,0,0,0,0
30,8480192,Johnathan Kovacevic,D,MTL,27,0,0,0,0
30,8476874,Olli Maatta,D,DET,30,0,0,0,0
30,8482144,Jack Thompson,D,SJS,22,0,0,0,0
30,8480222,Sebastian Aho,D,NYI,28,0,0,0,0
30,8479458,Nikita Zaitsev,D,CHI,33,0,0,0,0
30,8471709,Marc-Edouard Vlasic,D,SJS,37,0,0,0,0
30,8482929,Emil Lilleberg,D,TBL,23,0,0,0,0
30,8477018,Ben Hutton,D,VGK,31,0,0,0,0
30,8481056,Spencer Stastney,D,NSH,24,0,0,0,0
30,8481593,Jayden Struble,D,MTL,23,0,0,0,0
30,8479982,Conor Timmins,D,TOR,26,0,0,0,0
30,8474090,Brendan Smith,D,NJD,35,0,0,0,0
30,8482964,Arber Xhekaj,D,MTL,23,0,0,0,0
30,8480891,Michael Kesselring,D,ARI,24,0,0,0,0
30,8477938,Haydn Fleury,D,TBL,28,0,0,0,0
30,8481806,Louis Crevier,D,CHI,23,0,0,0,0
30,8471274,Alex Goligoski,D,MIN,39,0,0,0,0
30,8481600,Tobias Bjornfot,D,FLA,23,0,0,0,0
30,8475797,Jarred Tinordi,D,CHI,32,0,0,0,0
30,8481521,Ronnie Attard,D,PHI,25,0,0,0,0
30,8474612,Travis Hamonic,D,OTT,34,0,0,0,0
30,8479576,Vincent Desharnais,D,EDM,28,0,0,0,0
30,8480049,Dylan Samberg,D,WPG,25,0,0,0,0
30,8483619,Filip Roos,D,CHI,25,0,0,0,0
30,8474568,Luke Schenn,D,NSH,35,0,0,0,0
30,8480184,Gustav Lindstrom,D,ANA,26,0,0,0,0
30,8480070,Ian Mitchell,D,BOS,25,0,0,0,0
30,8480196,Jacob Bryson,D,BUF,27,0,0,0,0
30,8471686,Marc Staal,D,PHI,37,0,0,0,0
30,8477467,Gustav Olofsson,D,SEA,30,0,0,0,0
30,8478970,Jalen Chatfield,D,CAR,28,0,0,0,0
30,8479348,Kale Clague,D,BUF,26,0,0,0,0
30,8473446,Erik Johnson,D,PHI,36,0,0,0,0
30,8477462,Robert Hagg,D,ANA,29,0,0,0,0
30,8478454,Noah Juulsen,D,VAN,27,0,0,0,0
30,8477384,Josh Brown,D,ARI,30,0,0,0,0
30,8481708,Zac Jones,D,NYR,24,0,0,0,0
30,8481167,Brayden Pachal,D,CGY,25,0,0,0,0
30,8482067,Connor Mackey,D,NYR,28,0,0,0,0
30,8483460,David Jiricek,D,CBJ,21,0,0,0,0
30,8481701,Santeri Hatakka,D,NJD,23,0,0,0,0
30,8478021,William Lagesson,D,ANA,28,0,0,0,0
30,8477851,Jordan Oesterle,D,CGY,32,0,0,0,0
30,8478452,Caleb Jones,D,COL,27,0,0,0,0
30,8479984,Cal Foote,D,NJD,26,0,0,0,0
30,8479639,Dylan Coghlan,D,CAR,26,0,0,0,0
30,8480874,Adam Ginning,D,PHI,24,0,0,0,0
30,8479321,Lucas Johansen,D,WSH,27,0,0,0,0
30,8480878,Nils Lundkvist,D,DAL,24,0,0,0,0
30,8482165,Yan Kuznetsov,D,CGY,22,0,0,0,0
30,8484258,Sam Malinski,D,COL,26,0,0,0,0
30,8480157,Calle Rosen,D,STL,30,0,0,0,0
30,8484304,Uvis Balinskis,D,FLA,28,0,0,0,0
30,8479985,Cale Fleury,D,SEA,26,0,0,0,0
30,8479378,Logan Stanley,D,WPG,26,0,0,0,0
30,8477541,Dakota Mermis,D,MIN,30,0,0,0,0
30,8481609,Vladislav Kolyachonok,D,ARI,23,0,0,0,0
30,8480823,Alexander Alexeyev,D,WSH,25,0,0,0,0
30,8481679,Maxence Guenette,D,OTT,23,0,0,0,0
30,8481564,Ryan Johnson,D,BUF,23,0,0,0,0
30,8479376,Victor Mete,D,PHI,26,0,0,0,0
30,8484254,Akito Hirose,D,VAN,25,0,0,0,0
30,8482660,Kent Johnson,C,CBJ,22,0,0,0,0
30,8482149,Cole Perfetti,C,WPG,22,0,0,0,0
30,8477987,Ryan Donato,C,CHI,28,0,0,0,0
30,8475755,Alexander Petrovic,D,DAL,32,0,0,0,0
30,8477810,Joel Hanley,D,CGY,33,0,0,0,0
30,8474145,Robert Bortuzzo,D,NYI,35,0,0,0,0
30,8481161,Jake Christiansen,D,CBJ,25,0,0,0,0
30,8476884,Derrick Pouliot,D,DAL,30,0,0,0,0
30,8481716,Dmitri Voronkov,L,CBJ,24,0,0,0,0
30,8480084,Nick DeSimone,D,NJD,30,0,0,0,0
30,8475750,Jon Merrill,D,MIN,32,0,0,0,0
30,8479315,Joey Anderson,R,CHI,26,0,0,0,0
30,8478011,Louie Belpedio,D,PHI,28,0,0,0,0
30,8482451,Mikael Pyyhtia,L,CBJ,23,0,0,0,0
30,8481541,Samuel Bolduc,D,NYI,24,0,0,0,0
30,8482126,Emil Andrae,D,PHI,31,0,0,0,0
30,8474618,Marco Scandella,D,STL,34,0,0,0,0
30,8477244,Chad Ruhwedel,D,NYR,34,0,0,0,0
30,8477971,Andreas Englund,D,LAK,28,0,0,0,0
30,8480829,Jesperi Kotkaniemi,C,CAR,24,0,0,0,0
30,8479372,Josh Mahura,D,FLA,26,0,0,0,0
30,8482095,Tyler Kleven,D,OTT,22,0,0,0,0
30,8481719,Maxwell Crozier,D,TBL,24,0,0,0,0
30,8475855,Jesper Fast,R,CAR,33,0,0,0,0
30,8480848,Ty Dellandrea,C,DAL,24,0,0,0,0
30,8475193,Tomas Tatar,L,SEA,34,0,0,0,0
30,8476889,Radek Faksa,C,DAL,30,0,0,0,0
30,8478495,Denis Gurianov,R,PHI,27,0,0,0,0
30,8480216,Jacob Peterson,C,SJS,25,0,0,0,0
30,8480252,Cole Guttman,C,CHI,25,0,0,0,0
30,8479026,Philippe Myers,D,TBL,27,0,0,0,0
30,8481006,Tyler Tucker,D,STL,24,0,0,0,0
30,8481032,Paul Cotter,C,VGK,25,0,0,0,0
30,8481577,Philip Tomasino,C,NSH,23,0,0,0,0
30,8476918,Jimmy Vesey,L,NYR,31,0,0,0,0
30,8479320,Max Lajoie,D,TOR,27,0,0,0,0
30,8478017,Mark Friedman,D,VAN,29,0,0,0,0
30,8481754,Nikita Nesterenko,C,ANA,23,0,0,0,0
30,8483407,Brandon Scanlin,D,NYR,25,0,0,0,0
30,8482659,Josh Doan,R,ARI,22,0,0,0,0
30,8477446,Michael McCarron,R,NSH,29,0,0,0,0
30,8477903,Garnet Hathaway,R,PHI,33,0,0,0,0
30,8482153,Brendan Brisson,C,VGK,23,0,0,0,0
30,8483546,Marshall Rifai,D,TOR,26,0,0,0,0
30,8484287,Cole McWard,D,VAN,23,0,0,0,0
30,8478854,Ryan Shea,D,PIT,27,0,0,0,0
30,8481585,Egor Afanasyev,L,NSH,23,0,0,0,0
30,8483398,Declan Carlile,D,TBL,31,0,0,0,0
30,8478502,Dennis Gilbert,D,CGY,28,0,0,0,0
30,8482749,Joshua Roy,R,MTL,21,0,0,0,0
30,8481598,Philip Broberg,D,EDM,23,0,0,0,0
30,8480835,Jack Drury,C,CAR,24,0,0,0,0
30,8480748,Kiefer Sherwood,L,NSH,29,0,0,0,0
30,8476934,Brock McGinn,L,ANA,30,0,0,0,0
30,8480870,Bo Groulx,C,ANA,24,0,0,0,0
30,8479368,Max Jones,L,ANA,26,0,0,0,0
30,8478099,Kevin Labanc,R,SJS,29,0,0,0,0
30,8478067,Oskar Lindblom,L,SJS,28,0,0,0,0
30,8476393,Nick Cousins,C,FLA,31,0,0,0,0
30,8483395,Arshdeep Bains,L,VAN,23,0,0,0,0
30,8480762,Eric Robinson,L,BUF,29,0,0,0,0
30,8479439,Jacob MacDonald,D,SJS,31,0,0,0,0
30,8476474,Stefan Noesen,R,CAR,31,0,0,0,0
30,8482787,Nikita Chibrikov,R,WPG,31,0,0,0,0
30,8478432,Christian Fischer,R,DET,27,0,0,0,0
30,8477979,Nicolas Aube-Kubel,R,WSH,28,0,0,0,0
30,8481789,Tye Kartye,L,SEA,23,0,0,0,0
30,8479330,Brandon Gignac,C,MTL,27,0,0,0,0
30,8480075,Cameron Crotty,D,ARI,25,0,0,0,0
30,8473473,Milan Lucic,L,BOS,36,0,0,0,0
30,8482094,Daemon Hunt,D,MIN,22,0,0,0,0
30,8481206,John Ludvig,D,PIT,24,0,0,0,0
30,8483630,Pavol Regenda,L,ANA,25,0,0,0,0
30,8481617,Vasily Podkolzin,R,VAN,23,0,0,0,0
30,8480306,Grant Hutton,D,NYI,29,0,0,0,0
30,8480995,Pontus Holmberg,R,TOR,25,0,0,0,0
30,8482148,Hendrix Lapierre,C,WSH,22,0,0,0,0
30,8477478,William Carrier,L,VGK,30,0,0,0,0
30,8480003,Jesper Boqvist,C,BOS,26,0,0,0,0
30,8482172,Landon Slaggert,L,CHI,22,0,0,0,0
30,8480789,Oliver Wahlstrom,R,NYI,24,0,0,0,0
30,8474062,Riley Nash,C,NYR,35,0,0,0,0
30,8480021,Jack Studnicka,C,SJS,25,0,0,0,0
30,8480025,MacKenzie Entwistle,R,CHI,25,0,0,0,0
30,8481582,Nicholas Robertson,L,TOR,23,0,0,0,0
30,8476867,Brendan Gaunce,C,CBJ,30,0,0,0,0
30,8479619,Michael Carcone,L,ARI,28,0,0,0,0
30,8479370,Tyson Jost,C,BUF,26,0,0,0,0
30,8479671,Mathieu Olivier,R,CBJ,27,0,0,0,0
30,8476994,Vinnie Hinostroza,C,PIT,30,0,0,0,0
30,8482070,Mitchell Chaffee,R,TBL,26,0,0,0,0
30,8477473,Justin Bailey,R,SJS,29,0,0,0,0
30,8479344,Jesse Puljujarvi,R,PIT,26,0,0,0,0
30,8480205,Emil Bemstrom,C,PIT,25,0,0,0,0
30,8479718,Alex Barré-Boulet,C,TBL,27,0,0,0,0
30,8482061,Brandon Biro,L,BUF,26,0,0,0,0
30,8479638,Justin Brazeau,R,BOS,26,0,0,0,0
30,8474040,Sam Gagner,C,EDM,35,0,0,0,0
30,8477846,Ryan Carpenter,C,SJS,33,0,0,0,0
30,8482077,Dylan Holloway,L,EDM,23,0,0,0,0
30,8482157,Will Cuylle,L,NYR,22,0,0,0,0
30,8480007,Jonas Rondbjerg,R,VGK,25,0,0,0,0
30,8478874,Adam Gaudette,C,STL,28,0,0,0,0
30,8478434,Keegan Kolesar,R,VGK,27,0,0,0,0
30,8480441,Trey Fix-Wolansky,R,CBJ,25,0,0,0,0
30,8479994,Jaret Anderson-Dolan,C,NSH,25,0,0,0,0
30,8483567,Georgii Merkulov,C,BOS,24,0,0,0,0
30,8477380,Jonny Brodzinski,C,NYR,31,0,0,0,0
30,8482201,Gage Goncalves,C,TBL,23,0,0,0,0
30,8478211,Dryden Hunt,L,CGY,29,0,0,0,0
30,8471699,Andrew Cogliano,C,COL,37,0,0,0,0
30,8479421,Jacob Moverare,D,LAK,26,0,0,0,0
30,8478881,Brett Seney,L,CHI,28,0,0,0,0
30,8477464,Nic Petan,C,MIN,29,0,0,0,0
30,8475958,Michael Sgarbossa,C,WSH,32,0,0,0,0
30,8481147,Reese Johnson,C,CHI,26,0,0,0,0
30,8479336,Carl Grundstrom,R,LAK,27,0,0,0,0
30,8480853,Liam Foudy,C,NSH,24,0,0,0,0
30,8479522,Hardy Haman Aktell,D,WSH,26,0,0,0,0
30,8481462,Mason Morelli,L,VGK,28,0,0,0,0
30,8482102,Vasily Ponomarev,C,CAR,22,0,0,0,0
30,8480844,Grigori Denisenko,L,VGK,24,0,0,0,0
30,8479944,Zach Aston-Reese,C,DET,30,0,0,0,0
30,8482784,Zach Dean,C,STL,21,0,0,0,0
30,8479419,Brett Murray,L,BUF,26,0,0,0,0
30,8479520,Brandon Duhaime,R,COL,27,0,0,0,0
30,8477573,Nathan Walker,L,STL,30,0,0,0,0
30,8478078,Rourke Chartier,C,OTT,28,0,0,0,0
30,8475795,Dylan McIlrath,D,WSH,32,0,0,0,0
30,8482496,Nils Aman,C,VAN,24,0,0,0,0
30,8480289,Morgan Barron,C,WPG,26,0,0,0,0
30,8481751,Lukas Rousek,R,BUF,25,0,0,0,0
30,8480011,Klim Kostin,C,SJS,25,0,0,0,0
30,8481556,John Beecher,C,BOS,23,0,0,0,0
30,8475278,Byron Froese,C,VGK,33,0,0,0,0
30,8475225,Craig Smith,C,DAL,35,0,0,0,0
30,8484326,Patrik Koch,D,ARI,28,0,0,0,0
30,8477930,Pierre-Edouard Bellemare,L,SEA,39,0,0,0,0
30,8478409,Anthony Richard,C,BOS,28,0,0,0,0
30,8481024,Linus Karlsson,C,VAN,25,0,0,0,0
30,8479986,Kole Lind,R,SEA,26,0,0,0,0
30,8479414,Nathan Bastian,R,NJD,27,0,0,0,0
30,8479362,Riley Tufte,L,COL,26,0,0,0,0
30,8481058,Jesse Ylönen,R,MTL,25,0,0,0,0
30,8482476,Emil Heineman,L,MTL,23,0,0,0,0
30,8482861,Vincent Iorio,D,WSH,22,0,0,0,0
30,8483432,Luca Del Bel Belluz,C,CBJ,31,0,0,0,0
30,8482744,James Malatesta,L,CBJ,21,0,0,0,0
30,8477887,Patrick Brown,C,BOS,32,0,0,0,0
30,8478585,Derek Ryan,C,EDM,38,0,0,0,0
30,8481441,Joe Snively,C,WSH,28,0,0,0,0
30,8481592,Jakob Pelletier,L,CGY,23,0,0,0,0
30,8482634,Alex Steeves,C,TOR,25,0,0,0,0
30,8477126,Jayson Megna,C,BOS,34,0,0,0,0
30,8475752,Tyler Pitlick,C,NYR,33,0,0,0,0
30,8480008,Adam Ruzicka,C,ARI,25,0,0,0,0
30,8481065,Angus Crookshank,L,OTT,25,0,0,0,0
30,8479547,Matthew Phillips,R,WSH,26,0,0,0,0
30,8480226,Marián Studenic,R,SEA,26,0,0,0,0
30,8481237,Kyle MacLean,C,NYI,25,0,0,0,0
30,8475413,Justin Dowling,C,NJD,34,0,0,0,0
30,8481641,Joel Kiviranta,L,COL,28,0,0,0,0
30,8478104,Sammy Blais,L,STL,28,0,0,0,0
30,8477454,Adam Erne,L,EDM,29,0,0,0,0
30,8481518,Nolan Foote,L,NJD,24,0,0,0,0
30,8480245,Olle Lycksell,R,PHI,25,0,0,0,0
30,8483570,Ben Meyers,C,ANA,26,0,0,0,0
30,8480776,Sheldon Rempal,R,VGK,29,0,0,0,0
30,8483920,Pierrick Dube,R,WSH,23,0,0,0,0
30,8480267,Sammy Walker,C,MIN,25,0,0,0,0
30,8482747,Brennan Othmann,L,NYR,21,0,0,0,0
30,8479991,Jake Leschyshyn,C,NYR,25,0,0,0,0
30,8478400,Colin White,C,MTL,27,0,0,0,0
30,8479328,Julien Gauthier,R,NYI,27,0,0,0,0
30,8484325,Waltteri Merela,C,TBL,26,0,0,0,0
30,8479066,Ryan Lomberg,L,FLA,30,0,0,0,0
30,8477070,Liam O'Brien,C,ARI,30,0,0,0,0
30,8478146,Matthew Highmore,C,OTT,28,0,0,0,0
30,8478028,Fredrik Olofsson,L,COL,28,0,0,0,0
30,8480880,Jakub Lauko,C,BOS,24,0,0,0,0
30,8479968,Vinni Lettieri,C,MIN,29,0,0,0,0
30,8474709,Matt Martin,L,NYI,35,0,0,0,0
30,8480845,Rasmus Kupari,C,WPG,24,0,0,0,0
30,8481550,Adam Beckman,L,MIN,23,0,0,0,0
30,8481422,Jacob Lucchini,C,MIN,29,0,0,0,0
30,8477401,John Hayden,C,SEA,29,0,0,0,0
30,8478904,Steven Lorentz,C,FLA,28,0,0,0,0
30,8482088,Justin Sourdif,R,FLA,22,0,0,0,0
30,8482751,Ryan Winterton,C,SEA,21,0,0,0,0
30,8482241,Radim Zohorna,L,PIT,28,0,0,0,0
30,8481690,Tyler Angle,C,CBJ,24,0,0,0,0
30,8476952,Dominic Toninato,C,WPG,30,0,0,0,0
30,8476919,Chris Tierney,C,NJD,30,0,0,0,0
30,8480032,Shane Bowers,C,NJD,25,0,0,0,0
30,8484314,Jiri Smejkal,L,OTT,28,0,0,0,0
30,8481239,Samuel Fagemo,L,LAK,24,0,0,0,0
30,8481532,Alex Turcotte,C,LAK,23,0,0,0,0
30,8481019,David Gustafsson,C,WPG,24,0,0,0,0
30,8478477,Mitchell Stephens,C,MTL,27,0,0,0,0
30,8479546,Oskar Steen,C,BOS,26,0,0,0,0
30,8480292,Carson Meyer,R,CBJ,27,0,0,0,0
30,8478446,Glenn Gawdin,C,ANA,27,0,0,0,0
30,8483531,Brian Halonen,L,NJD,25,0,0,0,0
30,8477149,Scott Sabourin,R,SJS,32,0,0,0,0
30,8479972,Mason Shaw,C,MIN,26,0,0,0,0
30,8480890,Jan Jenik,R,ARI,24,0,0,0,0
30,8478051,Max Willman,C,NJD,29,0,0,0,0
30,8480851,Akil Thomas,C,LAK,24,0,0,0,0
30,8482765,Isak Rosen,R,BUF,21,0,0,0,0
30,8478421,A.J. Greer,L,CGY,28,0,0,0,0
30,8478512,Austin Czarnik,C,DET,32,0,0,0,0
30,8479536,Axel Jonsson-Fjallby,L,WPG,26,0,0,0,0
30,8477320,Anton Blidh,L,NYR,29,0,0,0,0
30,8481543,Nikita Alexandrov,C,STL,24,0,0,0,0
30,8475235,Nicolas Deslauriers,L,PHI,33,0,0,0,0
30,8481070,Hugh McGing,L,STL,26,0,0,0,0
30,8480836,Jonathan Gruden,C,PIT,24,0,0,0,0
30,8481591,Sam Poulin,R,PIT,23,0,0,0,0
30,8477962,Brendan Lemieux,L,CAR,28,0,0,0,0
30,8483401,Marc Johnstone,R,PIT,28,0,0,0,0
30,8482250,Callahan Burke,C,CAR,27,0,0,0,0
30,8481726,Adam Edstrom,C,NYR,24,0,0,0,0
30,8471817,Ryan Reaves,R,TOR,37,0,0,0,0
30,8479587,Rhett Gardner,C,PHI,28,0,0,0,0
30,8475766,Austin Watson,L,TBL,32,0,0,0,0
30,8479367,William Lockwood,R,FLA,26,0,0,0,0
30,8478424,Jansen Harkins,C,PIT,27,0,0,0,0
30,8476913,Devin Shore,C,SEA,30,0,0,0,0
30,8482652,Walker Duehr,R,CGY,27,0,0,0,0
30,8477527,Ross Johnston,L,ANA,30,0,0,0,0
30,8481077,John Leonard,L,ARI,26,0,0,0,0
30,8483549,Lucas Condotta,L,MTL,27,0,0,0,0
30,8480468,James Hamblin,L,EDM,25,0,0,0,0
30,8476907,Mackenzie MacEachern,L,STL,30,0,0,0,0
30,8479543,Michael Pezzetta,L,MTL,26,0,0,0,0
30,8480355,Mark Kastelic,C,OTT,25,0,0,0,0
30,8482162,Roby Jarventie,L,OTT,22,0,0,0,0
30,8479772,Zack MacEwen,R,OTT,28,0,0,0,0
30,8483597,Milos Kelemen,L,ARI,25,0,0,0,0
30,8479379,Givani Smith,R,SJS,26,0,0,0,0
30,8481655,Cole Schwindt,R,CGY,23,0,0,0,0
30,8479981,Jonah Gadjovich,L,FLA,26,0,0,0,0
30,8482147,Jean-Luc Foudy,C,COL,22,0,0,0,0
30,8484255,Jason Polin,R,COL,25,0,0,0,0
30,8477993,Justin Kirkland,C,ARI,28,0,0,0,0
30,8479249,Andrew Poturalski,C,SEA,30,0,0,0,0
30,8482197,Adam Raska,R,MIN,23,0,0,0,0
30,8475780,Chris Wagner,R,COL,33,0,0,0,0
30,8479533,Joona Koppanen,L,PIT,26,0,0,0,0
30,8481534,Raphael Lavoie,C,EDM,24,0,0,0,0
30,8484321,Nikolas Matinpalo,D,OTT,26,0,0,0,0
30,8481043,Cole Koepke,L,TBL,26,0,0,0,0
30,8476323,Max McCormick,L,SEA,32,0,0,0,0
30,8483609,Adam Klapka,R,CGY,24,0,0,0,0
30,8483512,Matt Savoie,C,BUF,20,0,0,0,0
30,8484259,Ondrej Pavel,C,COL,31,0,0,0,0
30,8478147,Bokondji Imama,L,OTT,28,0,0,0,0
30,8482460,Matt Rempe,C,NYR,22,0,0,0,0
30,8477073,Kurtis MacDermid,L,NJD,30,0,0,0,0
30,8480274,Philip Kemp,D,EDM,25,0,0,0,0
30,8478956,Samuel Laberge,L,NJD,27,0,0,0,0
30,8483045,Cameron Butler,R,CBJ,31,0,0,0,0
31,8478402,Connor McDavid,C,EDM,27,82,42,93,135
31,8479318,Auston Matthews,C,TOR,27,82,72,57,129
31,8481559,Jack Hughes,C,NJD,23,82,41,76,117
31,8476453,Nikita Kucherov,R,TBL,31,82,46,70,116
31,8477939,William Nylander,R,TOR,28,82,40,62,102
31,8480012,Elias Pettersson,C,VAN,26,82,37,63,100
31,8478427,Sebastian Aho,C,CAR,27,82,43,52,95
31,8477934,Leon Draisaitl,C,EDM,29,82,39,56,95
31,8477956,David Pastrnak,R,BOS,28,82,40,52,92
31,8478550,Artemi Panarin,L,NYR,33,82,39,53,92
31,8478010,Brayden Point,C,TBL,28,82,47,43,90
31,8477942,Kevin Fiala,L,LAK,28,82,34,56,90
31,8476887,Filip Forsberg,L,NSH,30,82,42,47,89
31,8477933,Sam Reinhart,C,FLA,29,82,42,43,85
31,8474564,Steven Stamkos,C,TBL,34,82,39,46,85
31,8478864,Kirill Kaprizov,L,MIN,27,82,32,53,85
31,8477493,Aleksander Barkov,C,FLA,29,82,31,53,84
31,8479314,Matthew Tkachuk,L,FLA,27,82,26,58,84
31,8471675,Sidney Crosby,C,PIT,37,82,38,45,83
31,8482116,Tim Stützle,C,OTT,22,82,32,51,83
31,8480027,Jason Robertson,L,DAL,25,82,35,47,82
31,8478420,Mikko Rantanen,R,COL,28,82,35,46,81
31,8477492,Nathan MacKinnon,C,COL,29,82,29,52,81
31,8479407,Jesper Bratt,L,NJD,26,82,28,53,81
31,8475184,Chris Kreider,L,NYR,33,82,47,31,78
31,8480801,Brady Tkachuk,L,OTT,25,82,33,44,77
31,8478445,Mathew Barzal,C,NYI,27,82,23,54,77
31,8481523,Kirby Dach,C,MTL,23,82,14,63,77
31,8479343,Clayton Keller,R,ARI,26,82,38,37,75
31,8471215,Evgeni Malkin,C,PIT,38,82,37,38,75
31,8480002,Nico Hischier,C,NJD,25,82,26,49,75
31,8477949,Alex Tuch,R,BUF,28,82,25,50,75
31,8477946,Dylan Larkin,C,DET,28,82,24,49,73
31,8477960,Adrian Kempe,R,LAK,28,82,38,34,72
31,8475786,Zach Hyman,L,EDM,32,82,34,38,72
31,8478403,Jack Eichel,C,VGK,28,82,32,40,72
31,8480208,Drake Batherson,R,OTT,26,82,28,44,72
31,8475166,John Tavares,C,TOR,34,82,27,45,72
31,8476346,Johnny Gaudreau,L,CBJ,31,82,19,53,72
31,8477409,Carter Verhaeghe,C,FLA,29,82,33,38,71
31,8476459,Mika Zibanejad,C,NYR,31,82,21,50,71
31,8480865,Noah Dobson,D,NYI,24,82,15,56,71
31,8475172,Nazem Kadri,C,CGY,34,82,30,40,70
31,8476389,Vincent Trocheck,C,NYR,31,82,30,40,70
31,8480023,Robert Thomas,C,STL,25,82,17,53,70
31,8479323,Adam Fox,D,NYR,26,82,14,56,70
31,8480830,Andrei Svechnikov,R,CAR,24,82,36,33,69
31,8479385,Jordan Kyrou,C,STL,26,82,33,36,69
31,8474141,Patrick Kane,R,DET,36,82,27,42,69
31,8474600,Roman Josi,D,NSH,34,82,17,52,69
31,8471214,Alex Ovechkin,L,WSH,39,82,41,27,68
31,8481557,Matt Boldy,L,MIN,23,82,33,35,68
31,8476454,Ryan Nugent-Hopkins,C,EDM,31,82,28,40,68
31,8480069,Cale Makar,D,COL,26,82,27,41,68
31,8476460,Mark Scheifele,C,WPG,31,82,27,41,68
31,8475726,Tyler Toffoli,C,WPG,32,82,35,32,67
31,8479420,Tage Thompson,C,BUF,27,82,31,36,67
31,8478440,Dylan Strome,C,WSH,27,82,23,44,67
31,8478397,Rasmus Andersson,D,CGY,28,82,17,50,67
31,8478398,Kyle Connor,L,WPG,28,82,25,41,66
31,8477402,Pavel Buchnevich,L,STL,29,82,21,45,66
31,8478460,Zach Werenski,D,CBJ,27,82,17,49,66
31,8475158,Ryan O'Reilly,C,NSH,33,82,25,40,65
31,8478449,Roope Hintz,C,DAL,28,82,31,33,64
31,8477404,Jake Guentzel,C,CAR,30,82,29,35,64
31,8482093,Seth Jarvis,C,CAR,22,82,21,43,64
31,8475692,Mats Zuccarello,R,MIN,37,82,18,46,64
31,8474578,Erik Karlsson,D,PIT,34,82,16,48,64
31,8477447,Shea Theodore,D,VGK,29,82,11,53,64
31,8475167,Victor Hedman,D,TBL,34,82,13,50,63
31,8476539,Jonathan Marchessault,R,VGK,34,82,32,30,62
31,8478047,Michael Bunting,L,PIT,29,82,19,43,62
31,8475754,Brock Nelson,C,NYI,33,82,35,26,61
31,8477955,Jared McCann,L,SEA,28,82,24,37,61
31,8482097,Jack Quinn,R,BUF,23,82,20,41,61
31,8482684,Luke Hughes,D,NJD,21,82,19,42,61
31,8478414,Timo Meier,R,NJD,28,82,32,28,60
31,8477501,Valeri Nichushkin,R,COL,29,82,30,30,60
31,8474102,David Perron,L,DET,36,82,23,37,60
31,8481596,Shane Pinto,C,OTT,24,82,22,38,60
31,8477940,Nikolaj Ehlers,L,WPG,28,82,20,40,60
31,8481540,Cole Caufield,R,MTL,23,82,34,25,59
31,8478444,Brock Boeser,R,VAN,27,82,29,30,59
31,8482745,Mason McTavish,C,ANA,21,82,25,34,59
31,8480036,Miro Heiskanen,D,DAL,25,82,11,48,59
31,8482740,Wyatt Johnston,C,DAL,21,82,32,26,58
31,8480018,Nick Suzuki,C,MTL,25,82,27,31,58
31,8476468,J.T. Miller,C,VAN,31,82,14,44,58
31,8480803,Evan Bouchard,D,EDM,25,82,13,45,58
31,8477935,Sam Bennett,C,FLA,28,82,28,29,57
31,8478439,Travis Konecny,R,PHI,27,82,27,30,57
31,8476479,Phillip Danault,C,LAK,31,82,20,37,57
31,8481711,Matias Maccelli,L,ARI,24,82,15,42,57
31,8476905,Chandler Stephenson,C,VGK,30,82,13,44,57
31,8479325,Charlie McAvoy,D,BOS,27,82,8,49,57
31,8479339,Patrik Laine,L,CBJ,26,82,27,29,56
31,8479542,Brandon Hagel,L,TBL,26,82,24,32,56
31,8479337,Alex DeBrincat,R,DET,27,82,24,32,56
31,8478042,Viktor Arvidsson,R,LAK,31,82,23,33,56
31,8483808,Andrei Kuzmenko,L,CGY,28,82,26,29,55
31,8477479,Tyler Bertuzzi,L,TOR,29,82,21,34,55
31,8470794,Joe Pavelski,C,DAL,40,82,20,35,55
31,8471685,Anze Kopitar,C,LAK,37,82,18,37,55
31,8471724,Kris Letang,D,PIT,37,82,17,38,55
31,8478233,Andrew Mangiapane,L,CGY,28,82,17,38,55
31,8477504,Josh Morrissey,D,WPG,29,82,15,40,55
31,8480015,Owen Tippett,R,PHI,25,82,28,26,54
31,8476448,William Karlsson,C,VGK,31,82,22,32,54
31,8476462,Dougie Hamilton,D,NJD,31,82,18,36,54
31,8473994,Jamie Benn,L,DAL,35,82,15,39,54
31,8477503,Max Domi,C,TOR,29,82,12,42,54
31,8481533,Trevor Zegras,C,ANA,23,82,26,27,53
31,8477497,Sean Monahan,C,WPG,30,82,25,28,53
31,8473419,Brad Marchand,L,BOS,36,82,24,29,53
31,8473512,Claude Giroux,R,OTT,36,82,22,31,53
31,8475913,Mark Stone,R,VGK,32,82,21,32,53
31,8482665,Matty Beniers,C,SEA,22,82,18,35,53
31,8476456,Jonathan Huberdeau,C,CGY,31,82,17,36,53
31,8480800,Quinn Hughes,D,VAN,25,82,6,47,53
31,8475784,Jeff Skinner,C,BUF,32,82,32,20,52
31,8475169,Evander Kane,L,EDM,33,82,24,28,52
31,8477416,Oliver Bjorkstrand,R,SEA,29,82,19,33,52
31,8476792,Torey Krug,D,STL,33,82,13,39,52
31,8474590,John Carlson,D,WSH,34,82,11,41,52
31,8478407,Vince Dunn,D,SEA,28,82,10,42,52
31,8476875,Mike Matheson,D,MTL,30,82,10,42,52
31,8480031,Maxime Comtois,L,CAR,25,82,9,43,52
31,8476853,Morgan Rielly,D,TOR,30,82,7,45,52
31,8475168,Matt Duchene,C,DAL,33,82,22,29,51
31,8481528,Dylan Cozens,C,BUF,23,82,21,30,51
31,8475191,Reilly Smith,R,PIT,33,82,21,30,51
31,8477951,Nick Schmaltz,C,ARI,28,82,20,31,51
31,8479410,Mikhail Sergachev,D,TBL,26,82,9,42,51
31,8481068,Yegor Sharangovich,C,CGY,26,82,24,26,50
31,8482159,Tyson Foerster,R,PHI,22,82,22,28,50
31,8476881,Tomas Hertl,C,VGK,31,82,21,29,50
31,8480078,Filip Chytil,C,NYR,25,82,19,31,50
31,8483515,Juraj Slafkovsky,L,MTL,20,82,19,31,50
31,8474150,Mikael Backlund,C,CGY,35,82,17,33,50
31,8475798,Mikael Granlund,C,SJS,32,82,12,38,50
31,8478366,Frank Vatrano,R,ANA,30,82,26,23,49
31,8478856,Conor Garland,R,VAN,28,82,25,24,49
31,8476432,Boone Jenner,C,CBJ,31,82,22,27,49
31,8474679,Gustav Nyquist,C,NSH,35,82,20,29,49
31,8475170,Brayden Schenn,C,STL,33,82,19,30,49
31,8478542,Evan Rodrigues,C,FLA,31,82,19,30,49
31,8479400,Pierre-Luc Dubois,L,LAK,26,82,16,33,49
31,8482124,Quinton Byfield,R,LAK,22,82,15,34,49
31,8475794,Tyler Seguin,C,DAL,32,82,14,35,49
31,8477494,Jonathan Drouin,L,COL,29,82,13,36,49
31,8480014,Gabriel Vilardi,C,WPG,25,82,26,22,48
31,8475765,Vladimir Tarasenko,R,FLA,33,82,22,26,48
31,8477964,Ivan Barbashev,C,VGK,29,82,17,31,48
31,8484144,Connor Bedard,C,CHI,19,82,26,21,47
31,8478873,Troy Terry,R,ANA,27,82,20,27,47
31,8477476,Artturi Lehkonen,L,COL,29,82,20,27,47
31,8475810,Bryan Rust,R,PIT,32,82,19,28,47
31,8476292,Ondrej Palat,L,NJD,33,82,19,28,47
31,8482113,Anton Lundell,C,FLA,23,82,17,30,47
31,8478458,Jack Roslovic,C,NYR,27,82,17,30,47
31,8471698,T.J. Oshie,R,WSH,38,82,16,31,47
31,8478975,Mason Marchment,L,DAL,29,82,16,31,47
31,8479345,Jakob Chychrun,D,OTT,26,82,22,24,46
31,8476880,Tom Wilson,R,WSH,30,82,20,26,46
31,8475151,Kyle Palmieri,C,NYI,33,82,20,26,46
31,8474565,Alex Pietrangelo,D,VGK,34,82,5,41,46
31,8483397,Marc McLaughlin,C,BOS,25,82,39,6,45
31,8481554,Kaapo Kakko,R,NYR,23,82,26,19,45
31,8482101,Danil Gushchin,L,SJS,22,82,24,21,45
31,8478462,Nicolas Roy,C,VGK,27,82,22,23,45
31,8480064,Josh Norris,C,OTT,25,82,22,23,45
31,8480798,Philipp Kurashev,C,CHI,25,82,19,26,45
31,8480220,Noah Cates,L,PHI,25,82,19,26,45
31,8474586,Jordan Eberle,R,SEA,34,82,18,27,45
31,8480873,Rasmus Sandin,D,WSH,24,82,14,31,45
31,8474563,Drew Doughty,D,LAK,35,82,10,35,45
31,8482720,Matthew Knies,L,TOR,22,82,8,37,45
31,8479675,Trevor Moore,L,LAK,29,82,20,24,44
31,8475799,Nino Niederreiter,R,WPG,32,82,20,24,44
31,8478438,Tommy Novak,C,NSH,27,82,16,28,44
31,8482078,Lucas Raymond,L,DET,22,82,16,28,44
31,8476826,Yanni Gourde,C,SEA,33,82,16,28,44
31,8476458,Ryan Strome,C,ANA,31,82,15,29,44
31,8482133,Thomas Bordeleau,C,SJS,22,82,9,35,44
31,8475906,John Klingberg,D,TOR,32,82,9,35,44
31,8477500,Bo Horvat,C,NYI,29,82,23,20,43
31,8474157,Max Pacioretty,L,WSH,36,82,23,20,43
31,8480039,Martin Necas,C,CAR,25,82,19,24,43
31,8480188,Fabian Zetterlund,L,SJS,25,82,18,25,43
31,8477998,Warren Foegele,L,EDM,28,82,17,26,43
31,8482109,Alexis Lafrenière,L,NYR,23,82,16,27,43
31,8477496,Elias Lindholm,C,VAN,30,82,12,31,43
31,8478038,Devon Toews,D,COL,30,82,8,35,43
31,8483471,Brad Lambert,C,WPG,31,82,8,35,43
31,8481699,Aku Raty,R,ARI,23,82,0,43,43
31,8475314,Anders Lee,L,NYI,34,82,27,15,42
31,8475763,Kevin Hayes,R,STL,32,82,22,20,42
31,8478493,Joel Eriksson Ek,C,MIN,27,82,21,21,42
31,8478498,Jake DeBrusk,L,BOS,28,82,20,22,42
31,8476399,Blake Coleman,C,CGY,33,82,20,22,42
31,8477451,Ryan Hartman,R,MIN,30,82,18,24,42
31,8477429,Andrew Copp,C,DET,30,82,17,25,42
31,8475745,Charlie Coyle,C,BOS,32,82,14,28,42
31,8479999,Casey Mittelstadt,C,COL,26,82,11,31,42
31,8483445,Cutter Gauthier,L,ANA,20,82,11,31,42
31,8480434,Sean Durzi,D,ARI,26,82,9,33,42
31,8479425,Filip Hronek,D,VAN,27,82,8,34,42
31,8481542,Moritz Seider,D,DET,23,82,5,37,42
31,8476958,Jaccob Slavin,D,CAR,30,82,3,39,42
31,8478466,Daniel Sprong,R,DET,27,82,28,13,41
31,8477407,Anthony Duclair,L,TBL,29,82,23,18,41
31,8478057,Dakota Joshua,C,VAN,28,82,23,18,41
31,8482699,Dylan Guenther,R,ARI,21,82,22,19,41
31,8479423,Alex Nylander,L,CBJ,26,82,22,19,41
31,8478474,Lawson Crouse,L,ARI,27,82,20,21,41
31,8479996,Cody Glass,C,NSH,25,82,20,21,41
31,8478401,Pavel Zacha,C,BOS,27,82,16,25,41
31,8477456,J.T. Compher,L,DET,29,82,15,26,41
31,8480797,Joel Farabee,L,PHI,24,82,13,28,41
31,8476869,Brady Skjei,D,CAR,30,82,12,29,41
31,8476854,Hampus Lindholm,D,BOS,30,82,6,35,41
31,8482055,Drew O'Connor,L,PIT,26,82,20,20,40
31,8480009,Eeli Tolvanen,R,SEA,25,82,19,21,40
31,8476438,Brandon Saad,L,STL,32,82,19,21,40
31,8482146,Luke Evangelista,R,NSH,22,82,16,24,40
31,8479525,Ross Colton,C,COL,28,82,16,24,40
31,8476882,Teuvo Teravainen,L,CAR,30,82,15,25,40
31,8475791,Taylor Hall,L,CHI,33,82,13,27,40
31,8476329,Travis Boyd,C,ARI,31,82,12,28,40
31,8477986,Brandon Montour,D,FLA,30,82,11,29,40
31,8478396,Noah Hanifin,D,VGK,27,82,11,29,40
31,8480028,Morgan Frost,C,PHI,25,82,10,30,40
31,8477495,Seth Jones,D,CHI,30,82,9,31,40
31,8475764,Cam Fowler,D,ANA,33,82,4,36,40
31,8475714,Calle Jarnkrok,C,TOR,33,82,23,16,39
31,8475768,Jaden Schwartz,C,SEA,32,82,23,16,39
31,8478046,Danton Heinen,L,BOS,29,82,19,20,39
31,8473986,Alex Killorn,L,ANA,35,82,18,21,39
31,8470613,Brent Burns,D,CAR,39,82,17,22,39
31,8481016,Ruslan Iskhakov,C,NYI,24,82,7,32,39
31,8482733,Logan Mailloux,D,MTL,31,82,3,36,39
31,8483524,Shane Wright,C,SEA,20,82,23,15,38
31,8479987,Morgan Geekie,C,BOS,26,82,20,18,38
31,8475760,Nick Bjugstad,C,ARI,32,82,20,18,38
31,8478115,Pierre Engvall,L,NYI,28,82,20,18,38
31,8474641,Adam Henrique,C,EDM,34,82,19,19,38
31,8481618,Alex Newhook,C,MTL,23,82,18,20,38
31,8482667,William Eklund,L,SJS,22,82,17,21,38
31,8474037,James van Riemsdyk,L,BOS,35,82,14,24,38
31,8477444,Andre Burakovsky,L,SEA,29,82,11,27,38
31,8481703,Valtteri Puustinen,R,PIT,25,82,11,27,38
31,8480839,Rasmus Dahlin,D,BUF,24,82,10,28,38
31,8477932,Aaron Ekblad,D,FLA,28,82,9,29,38
31,8480145,Neal Pionk,D,WPG,29,82,8,30,38
31,8475793,Ryan Johansen,C,PHI,32,82,21,16,37
31,8476483,Rickard Rakell,R,PIT,31,82,14,23,37
31,8478519,Anthony Cirelli,C,TBL,27,82,14,23,37
31,8477947,Sonny Milano,L,WSH,28,82,12,25,37
31,8478472,Mathieu Joseph,R,OTT,27,82,11,26,37
31,8482122,Brock Faber,D,MIN,22,82,10,27,37
31,8476979,Erik Gustafsson,D,NYR,32,82,9,28,37
31,8475744,Evgeny Kuznetsov,C,CAR,32,82,8,29,37
31,8477506,Ryan Pulock,D,NYI,30,82,8,29,37
31,8483457,Lane Hutson,D,MTL,20,82,5,32,37
31,8475197,Tyson Barrie,D,NSH,33,82,5,32,37
31,8481604,Pavel Dorofeyev,L,VGK,24,82,24,12,36
31,8481624,Ilya Mikheyev,R,VAN,30,82,21,15,36
31,8479393,Noah Gregor,C,TOR,26,82,21,15,36
31,8480459,Pius Suter,C,VAN,28,82,15,21,36
31,8475287,Erik Haula,L,NJD,33,82,14,22,36
31,8471218,Blake Wheeler,R,NYR,38,82,12,24,36
31,8476927,Teddy Blueger,C,VAN,30,82,12,24,36
31,8481581,Thomas Harley,D,DAL,23,82,9,27,36
31,8478055,Gustav Forsling,D,FLA,28,82,9,27,36
31,8476906,Shayne Gostisbehere,D,DET,31,82,7,29,36
31,8482105,Jake Sanderson,D,OTT,22,82,6,30,36
31,8482702,Logan Stankoven,C,DAL,21,82,19,16,35
31,8478463,Anthony Beauvillier,L,NSH,27,82,17,18,35
31,8477511,Anthony Mantha,R,VGK,30,82,17,18,35
31,8476419,Jean-Gabriel Pageau,C,NYI,32,82,16,19,35
31,8479353,Brett Howden,C,VGK,26,82,16,19,35
31,8482222,Alexander Barabanov,L,SJS,30,82,14,21,35
31,8479365,Trent Frederic,C,BOS,26,82,14,21,35
31,8480849,Barrett Hayton,C,ARI,24,82,13,22,35
31,8476921,Jordan Martinook,L,CAR,32,82,12,23,35
31,8475753,Justin Faulk,D,STL,32,82,8,27,35
31,8480043,Timothy Liljegren,D,TOR,25,82,8,27,35
31,8476925,Colton Sissons,C,NSH,31,82,18,16,34
31,8478109,Victor Olofsson,L,BUF,29,82,16,18,34
31,8478891,Mason Appleton,C,WPG,28,82,12,22,34
31,8475200,Dmitry Orlov,D,CAR,33,82,8,26,34
31,8478469,Thomas Chabot,D,OTT,27,82,5,29,34
31,8484166,Adam Fantilli,C,CBJ,20,82,16,17,33
31,8482110,Dawson Mercer,C,NJD,23,82,15,18,33
31,8475343,Nic Dowd,C,WSH,34,82,15,18,33
31,8482087,Kaiden Guhle,D,MTL,22,82,13,20,33
31,8480796,Martin Fehervary,D,WSH,25,82,12,21,33
31,8482671,Owen Power,D,BUF,22,82,9,24,33
31,8477944,Jakub Vrana,L,STL,28,82,20,12,32
31,8482074,Connor Zary,C,CGY,23,82,16,16,32
31,8482092,Ridly Greig,C,OTT,22,82,14,18,32
31,8479992,Michael Rasmussen,C,DET,25,82,14,18,32
31,8482475,Yegor Chinakhov,R,CBJ,23,82,13,19,32
31,8474149,Evgenii Dadonov,R,DAL,35,82,12,20,32
31,8476960,Andreas Athanasiou,C,CHI,30,82,10,22,32
31,8477021,Alex Kerfoot,C,ARI,30,82,9,23,32
31,8474053,Logan Couture,C,SJS,35,82,7,25,32
31,8476923,Damon Severson,D,CBJ,30,82,4,28,32
31,8481535,Nils Hoglander,L,VAN,24,82,18,13,31
31,8483431,Logan Cooley,C,ARI,20,82,16,15,31
31,8476872,Scott Laughton,C,PHI,30,82,13,18,31
31,8477426,Nicholas Paul,L,TBL,29,82,13,18,31
31,8479415,Michael McLeod,C,NJD,26,82,11,20,31
31,8480802,Ryan McLeod,C,EDM,25,82,7,24,31
31,8480817,K'Andre Miller,D,NYR,24,82,6,25,31
31,8475181,Nick Leddy,D,STL,33,82,6,25,31
31,8477435,Ryan Graves,D,PIT,29,82,5,26,31
31,8484203,Bradly Nadeau,L,CAR,19,82,22,8,30
31,8482089,Jake Neighbours,L,STL,22,82,19,11,30
31,8475722,Jason Zucker,L,NSH,32,82,15,15,30
31,8479390,Taylor Raddysh,R,CHI,26,82,13,17,30
31,8480980,Connor Dewar,C,TOR,25,82,13,17,30
31,8473422,Nick Foligno,L,CHI,37,82,12,18,30
31,8475218,Mattias Ekholm,D,EDM,34,82,12,18,30
31,8480185,Eetu Luostarinen,C,FLA,26,82,11,19,30
31,8476480,Vladislav Namestnikov,C,WPG,32,82,10,20,30
31,8477346,MacKenzie Weegar,D,CGY,30,82,9,21,30
31,8477948,Travis Sanheim,D,PHI,28,82,8,22,30
31,8479398,Samuel Girard,D,COL,26,82,7,23,30
31,8478851,Alexandre Carrier,D,NSH,28,82,6,24,30
31,8476981,Josh Anderson,R,MTL,30,82,15,14,29
31,8474884,Mike Hoffman,C,SJS,35,82,14,15,29
31,8476871,Tanner Pearson,L,MTL,32,82,13,16,29
31,8476873,Mark Jankowski,C,NSH,30,82,11,18,29
31,8481013,Jonatan Berggren,R,DET,24,82,10,19,29
31,8477839,Conor Sheary,L,TBL,32,82,10,19,29
31,8481656,Aliaksei Protas,C,WSH,23,82,9,20,29
31,8481537,Nikita Okhotiuk,D,CGY,24,82,7,22,29
31,8483565,Nick Blankenburg,D,CBJ,26,82,7,22,29
31,8481546,Cam York,D,PHI,23,82,5,24,29
31,8480246,Nick Perbix,D,TBL,26,82,3,26,29
31,8482175,JJ Peterka,R,BUF,22,82,16,12,28
31,8477425,Miles Wood,L,COL,29,82,16,12,28
31,8482259,Bobby McMann,C,TOR,28,82,15,13,28
31,8476392,Adam Lowry,C,WPG,31,82,15,13,28
31,8479316,Luke Kunin,C,SJS,27,82,15,13,28
31,8473449,Kyle Okposo,R,FLA,36,82,13,15,28
31,8481560,Arthur Kaliyev,R,LAK,23,82,11,17,28
31,8478500,Ivan Provorov,D,CBJ,27,82,7,21,28
31,8480871,Adam Boqvist,D,CBJ,24,82,7,21,28
31,8480336,Sean Walker,D,COL,30,82,5,23,28
31,8476885,Jacob Trouba,D,NYR,30,82,3,25,28
31,8481178,Egor Zamula,D,PHI,24,82,1,27,28
31,8480893,Kirill Marchenko,R,CBJ,24,82,16,11,27
31,8481186,Logan O'Connor,R,COL,28,82,14,13,27
31,8470621,Corey Perry,R,EDM,39,82,14,13,27
31,8481028,Martin Pospisil,C,CGY,25,82,13,14,27
31,8475848,Brendan Gallagher,R,MTL,32,82,12,15,27
31,8478020,Michael Amadio,C,VGK,28,82,11,16,27
31,8475790,Erik Gudbranson,D,CBJ,32,82,8,19,27
31,8473563,Nicklas Backstrom,C,WSH,37,82,7,20,27
31,8477969,Marcus Pettersson,D,PIT,28,82,6,21,27
31,8477488,Brett Pesce,D,CAR,30,82,5,22,27
31,8480821,Filip Zadina,R,SJS,25,82,20,6,26
31,8480813,Joe Veleno,C,DET,24,82,17,9,26
31,8482809,Jackson Blake,R,CAR,21,82,16,10,26
31,8474870,Tyler Johnson,C,CHI,34,82,14,12,26
31,8480068,Ryan Poehling,C,PHI,25,82,10,16,26
31,8476457,Adam Larsson,D,SEA,32,82,10,16,26
31,8470604,Jeff Carter,C,PIT,39,82,10,16,26
31,8478413,Jordan Greenway,L,BUF,27,82,9,17,26
31,8476461,Sean Couturier,C,PHI,32,82,9,17,26
31,8476897,Oskar Sundqvist,C,STL,30,82,9,17,26
31,8477498,Darnell Nurse,D,EDM,29,82,8,18,26
31,8484153,Leo Carlsson,C,ANA,20,82,8,18,26
31,8476892,Colton Parayko,D,STL,31,82,6,20,26
31,8482245,Artem Zub,D,OTT,29,82,6,20,26
31,8474151,Ryan McDonagh,D,NSH,35,82,4,22,26
31,8476931,Jake McCabe,D,TOR,31,82,3,23,26
31,8482145,Mavrik Bourque,C,DAL,22,82,20,5,25
31,8483493,Frank Nazar,C,CHI,20,82,19,6,25
31,8482118,Sam Colangelo,R,ANA,23,82,18,7,25
31,8478043,Sam Lafferty,C,VAN,29,82,13,12,25
31,8480806,Isac Lundestrom,C,ANA,25,82,12,13,25
31,8479976,Juuso Valimaki,D,ARI,26,82,10,15,25
31,8477919,Frederick Gaudreau,C,MIN,31,82,9,16,25
31,8477353,Tyler Motte,C,TBL,29,82,8,17,25
31,8478911,Matt Roy,D,LAK,29,82,8,17,25
31,8478133,Jake Evans,C,MTL,28,82,6,19,25
31,8474034,Pat Maroon,L,BOS,36,82,5,20,25
31,8477220,Nate Schmidt,D,WPG,33,82,5,20,25
31,8474673,TJ Brodie,D,TOR,34,82,5,20,25
31,8481014,Alexander Romanov,D,NYI,24,82,5,20,25
31,8478882,Vladislav Gavrikov,D,LAK,29,82,4,21,25
31,8476879,Cody Ceci,D,EDM,31,82,4,21,25
31,8482125,Alexander Holtz,R,NJD,22,82,17,7,24
31,8477330,Dominik Kubalik,L,OTT,29,82,17,7,24
31,8480074,Alexandre Texier,C,CBJ,25,82,13,11,24
31,8474009,Nick Bonino,C,NYR,36,82,13,11,24
31,8477450,Jason Dickinson,C,CHI,29,82,11,13,24
31,8474715,Cam Atkinson,R,PHI,35,82,11,13,24
31,8481481,Blake Lizotte,C,LAK,27,82,10,14,24
31,8480855,Jack McBain,C,ARI,24,82,10,14,24
31,8473533,Jordan Staal,C,CAR,36,82,10,14,24
31,8481580,Connor McMichael,C,WSH,23,82,9,15,24
31,8479941,Justin Danforth,R,CBJ,31,82,9,15,24
31,8482117,Lukas Reichel,L,CHI,22,82,9,15,24
31,8482679,Matt Coronato,R,CGY,22,82,8,16,24
31,8476278,Colin Blackwell,C,CHI,31,82,7,17,24
31,8475164,Jakob Silfverberg,R,ANA,34,82,7,17,24
31,8476525,Colin Miller,D,WPG,32,82,5,19,24
31,8482624,Daniil Miromanov,D,CGY,27,82,4,20,24
31,8484145,Zach Benson,L,BUF,19,82,4,20,24
31,8483482,Tristan Luneau,D,ANA,20,82,4,20,24
31,8481568,Alex Vlasic,D,CHI,23,82,3,21,24
31,8482705,Cole Sillinger,C,CBJ,21,82,12,11,23
31,8476469,Joel Armia,R,MTL,31,82,12,11,23
31,8476374,Sean Kuraly,C,CBJ,31,82,12,11,23
31,8482730,Brandt Clarke,D,LAK,21,82,12,11,23
31,8479977,Kailer Yamamoto,R,SEA,26,82,12,11,23
31,8481704,Juuso Parssinen,C,NSH,23,82,10,13,23
31,8475149,Marcus Johansson,L,MIN,34,82,10,13,23
31,8479351,Sam Steel,C,DAL,26,82,8,15,23
31,8477015,Connor Brown,R,EDM,30,82,8,15,23
31,8481522,Peyton Krebs,C,BUF,23,82,8,15,23
31,8481553,Bobby Brink,R,PHI,23,82,8,15,23
31,8477953,Kasperi Kapanen,R,STL,28,82,7,16,23
31,8479359,Beck Malenstyn,L,WSH,26,82,7,16,23
31,8480035,Henri Jokiharju,D,BUF,25,82,6,17,23
31,8481606,Jordan Spence,D,LAK,23,82,6,17,23
31,8478507,John Marino,D,NJD,27,82,5,18,23
31,8475171,Oliver Ekman-Larsson,D,FLA,33,82,1,22,23
31,8481093,Rafael Harvey-Pinard,L,MTL,25,82,16,6,22
31,8470610,Zach Parise,L,COL,40,82,13,9,22
31,8480113,Alex Iafallo,L,WPG,31,82,11,11,22
31,8479293,Brandon Tanev,L,SEA,33,82,11,11,22
31,8477989,Christian Dvorak,C,MTL,28,82,10,12,22
31,8482111,Justin Barron,D,MTL,23,82,10,12,22
31,8481477,Nico Sturm,C,SJS,29,82,10,12,22
31,8481601,Simon Holmstrom,R,NYI,23,82,10,12,22
31,8480281,Alexey Toropchenko,R,STL,25,82,9,13,22
31,8479346,Dillon Dube,C,CGY,26,82,9,13,22
31,8480144,David Kampf,C,TOR,29,82,7,15,22
31,8477392,Hudson Fasching,R,NYI,29,82,7,15,22
31,8474166,Alec Martinez,D,VGK,37,82,7,15,22
31,8476917,Adam Pelech,D,NYI,30,82,4,18,22
31,8479661,Tanner Jeannot,L,TBL,27,82,4,18,22
31,8474574,Tyler Myers,D,VAN,34,82,3,19,22
31,8477845,Trevor van Riemsdyk,D,WSH,33,82,3,19,22
31,8475179,Dmitry Kulikov,D,FLA,34,82,3,19,22
31,8477365,Connor Clifton,D,BUF,29,82,2,20,22
31,8483491,Ivan Miroshnichenko,L,WSH,20,82,12,9,21
31,8482737,Zack Bolduc,C,STL,21,82,10,11,21
31,8481524,Bowen Byram,D,BUF,23,82,9,12,21
31,8483495,Simon Nemec,D,NJD,20,82,9,12,21
31,8482142,Jamie Drysdale,D,PHI,22,82,6,15,21
31,8482712,Oskar Olausson,R,COL,22,82,6,15,21
31,8476312,Josh Manson,D,COL,33,82,6,15,21
31,8482079,Marco Rossi,C,MIN,23,82,5,16,21
31,8475455,Brenden Dillon,D,WPG,34,82,5,16,21
31,8470600,Ryan Suter,D,DAL,39,82,4,17,21
31,8476467,Jamie Oleksiak,D,SEA,32,82,4,17,21
31,8476967,Brett Kulak,D,EDM,30,82,4,17,21
31,8474716,Jared Spurgeon,D,MIN,35,82,3,18,21
31,8475324,Nick Jensen,D,WSH,34,82,3,18,21
31,8481605,Jackson LaCombe,D,ANA,23,82,3,18,21
31,8476902,Esa Lindell,D,DAL,30,82,2,19,21
31,8478840,Will Borgen,D,SEA,28,82,2,19,21
31,8475208,Brian Dumoulin,D,SEA,33,82,1,20,21
31,8479591,Michael Eyssimont,C,TBL,28,82,12,8,20
31,8474189,Lars Eller,C,PIT,35,82,12,8,20
31,8482655,J.J. Moser,D,ARI,24,82,9,11,20
31,8482062,Cole Smith,L,NSH,29,82,7,13,20
31,8476442,Matt Nieto,L,PIT,32,82,6,14,20
31,8475220,Marcus Foligno,L,MIN,33,82,6,14,20
31,8475188,Brayden McNabb,D,VGK,33,82,5,15,20
31,8482155,Alex Laferriere,R,LAK,23,82,12,7,19
31,8476878,Zemgus Girgensons,L,BUF,30,82,10,9,19
31,8478569,Noel Acciari,C,PIT,33,82,9,10,19
31,8477952,Robby Fabbri,C,DET,28,82,8,11,19
31,8479371,Dante Fabbro,D,NSH,26,82,5,14,19
31,8479324,Ryan Lindgren,D,NYR,26,82,5,14,19
31,8480073,Erik Brannstrom,D,OTT,25,82,3,16,19
31,8475233,David Savard,D,MTL,34,82,3,16,19
31,8481567,Henry Thrun,D,SJS,23,82,2,17,19
31,8480990,Declan Chisholm,D,MIN,24,82,11,7,18
31,8483499,Liam Ohgren,L,MIN,20,82,9,9,18
31,8478508,Yakov Trenin,C,COL,27,82,8,10,18
31,8475231,Casey Cizikas,C,NYI,33,82,8,10,18
31,8480448,Parker Kelly,L,OTT,25,82,6,12,18
31,8475690,Chris Tanev,D,DAL,35,82,5,13,18
31,8479980,Nicolas Hague,D,VGK,26,82,5,13,18
31,8476422,Mike Reilly,D,NYI,31,82,4,14,18
31,8476463,Jonas Brodin,D,MIN,31,82,4,14,18
31,8470966,Mark Giordano,D,TOR,41,82,4,14,18
31,8478451,Ethan Bear,D,WSH,27,82,4,14,18
31,8478178,Darren Raddysh,D,TBL,28,82,2,16,18
31,8476891,Matt Grzelcyk,D,BOS,30,82,2,16,18
31,8479514,Rem Pitlick,C,CHI,27,82,7,10,17
31,8478430,Oliver Kylington,D,CGY,27,82,6,11,17
31,8473504,Cal Clutterbuck,R,NYI,37,82,5,12,17
31,8480058,Pierre-Olivier Joseph,D,PIT,25,82,4,13,17
31,8480879,Jacob Bernard-Docker,D,OTT,24,82,3,14,17
31,8480860,Kevin Bahl,D,NJD,24,82,2,15,17
31,8475842,Sam Carrick,C,EDM,32,82,9,7,16
31,8481517,Brett Leason,R,ANA,25,82,8,8,16
31,8474567,Zach Bogosian,D,MIN,34,82,6,10,16
31,8479442,Troy Stecher,D,EDM,30,82,6,10,16
31,8476858,Phillip Di Giuseppe,L,VAN,31,82,5,11,16
31,8482803,Olen Zellweger,D,ANA,21,82,4,12,16
31,8481059,Scott Perunovich,D,STL,26,82,3,13,16
31,8477505,Alexander Wennberg,C,NYR,30,82,3,13,16
31,8479369,Andrew Peeke,D,BOS,26,82,2,14,16
31,8476331,Dylan DeMelo,D,WPG,31,82,1,15,16
31,8477034,Jaycob Megna,D,CHI,32,82,0,16,16
31,8483012,Logan Morrison,C,SEA,22,82,9,6,15
31,8477406,Mattias Janmark,C,EDM,32,82,7,8,15
31,8482666,Scott Morrow,D,CAR,22,82,7,8,15
31,8479383,Boris Katchouk,L,OTT,26,82,6,9,15
31,8477369,Carson Soucy,D,VAN,30,82,5,10,15
31,8477499,Rasmus Ristolainen,D,PHI,30,82,5,10,15
31,8475279,Ben Chiarot,D,DET,33,82,4,11,15
31,8483505,Matthew Poitras,C,BOS,20,82,3,12,15
31,8482858,Ryker Evans,D,SEA,23,82,3,12,15
31,8476372,Nick Seeler,D,PHI,31,82,3,12,15
31,8478399,Jonas Siegenthaler,D,NJD,27,82,2,13,15
31,8476429,Scott Mayfield,D,NYI,32,82,2,13,15
31,8477931,Tomas Nosek,L,NJD,32,82,6,8,14
31,8478416,Erik Cernak,D,TBL,27,82,5,9,14
31,8476624,Barclay Goodrow,C,NYR,31,82,5,9,14
31,8482470,Ilya Solovyov,D,CGY,24,82,4,10,14
31,8475462,Radko Gudas,D,ANA,34,82,4,10,14
31,8482859,Zack Ostapchuk,C,OTT,21,82,4,10,14
31,8482807,Ethan Del Mastro,D,CHI,21,82,3,11,14
31,8481578,Graeme Clarke,R,NJD,23,82,3,11,14
31,8471677,Jack Johnson,D,COL,37,82,2,12,14
31,8479998,Mikey Anderson,D,LAK,25,82,2,12,14
31,8478443,Brandon Carlo,D,BOS,28,82,1,13,14
31,8473453,Trevor Lewis,C,LAK,37,82,9,4,13
31,8482762,Simon Edvinsson,D,DET,21,82,8,5,13
31,8476822,Luke Glendening,C,TBL,35,82,7,6,13
31,8478468,Jeremy Lauzon,D,NSH,27,82,6,7,13
31,8482073,Braden Schneider,D,NYR,23,82,5,8,13
31,8482516,Matthew Kessel,D,STL,24,82,4,9,13
31,8482166,Shakir Mukhamadullin,D,SJS,22,82,4,9,13
31,8478013,Jake Walman,D,DET,28,82,3,10,13
31,8480172,Jan Rutta,D,SJS,34,82,3,10,13
31,8483490,Pavel Mintyukov,D,ANA,21,82,2,11,13
31,8473507,Jeff Petry,D,DET,37,82,2,11,13
31,8483468,Jiri Kulich,C,BUF,20,82,2,11,13
31,8476915,Jujhar Khaira,L,MIN,30,82,8,4,12
31,8477507,Nikita Zadorov,D,VAN,29,82,7,5,12
31,8482177,Marat Khusnutdinov,C,MIN,22,82,4,8,12
31,8483466,Kevin Korchinski,D,CHI,20,82,3,9,12
31,8475825,Jani Hakanpää,D,DAL,32,82,3,9,12
31,8483763,Maksymilian Szuber,D,ARI,22,82,2,10,12
31,8477508,Curtis Lazar,C,NJD,29,82,3,8,11
31,8479983,Mario Ferraro,D,SJS,26,82,3,8,11
31,8484911,Collin Graf,R,SJS,22,82,3,8,11
31,8478859,Niko Mikkola,D,FLA,28,82,2,9,11
31,8476473,Connor Murphy,D,CHI,31,82,2,9,11
31,8474013,Ian Cole,D,VAN,35,82,1,10,11
31,8479291,Kevin Rooney,C,CGY,31,82,6,4,10
31,8478831,Kevin Stenlund,C,FLA,28,82,5,5,10
31,8478136,Jake Middleton,D,MIN,28,82,2,8,10
31,8480807,Mattias Samuelsson,D,BUF,24,82,2,8,10
31,8480834,Ty Emberson,D,SJS,24,82,1,9,10
31,8483489,Fraser Minten,C,TOR,31,82,5,4,9
31,8482713,Mackie Samoskevich,R,FLA,22,82,5,4,9
31,8477335,Kyle Burroughs,D,SJS,29,82,1,8,9
31,8475762,Derek Forbort,D,BOS,32,82,1,8,9
31,8481030,Jack St. Ivany,D,PIT,25,82,2,5,7
31,8484149,Gavin Brindley,C,CBJ,20,82,2,4,6
31,8478408,Travis Dermott,D,ARI,28,82,2,4,6
31,8475177,Calvin de Haan,D,TBL,33,82,0,5,5
31,8481599,Victor Soderstrom,D,ARI,23,82,2,2,4
31,8482141,Lukas Cormier,D,VGK,22,0,0,0,0
31,8476988,Matt Benning,D,SJS,30,0,0,0,0
31,8480727,Zach Whitecloud,D,VGK,28,0,0,0,0
31,8480887,Jordan Harris,D,MTL,24,0,0,0,0
31,8478450,Parker Wotherspoon,D,BOS,27,0,0,0,0
31,8481812,Nikolai Knyzhov,D,SJS,27,0,0,0,0
31,8480001,Urho Vaakanainen,D,ANA,25,0,0,0,0
31,8482176,Wyatt Kaiser,D,CHI,22,0,0,0,0
31,8481122,Simon Benoit,D,TOR,26,0,0,0,0
31,8476441,Joel Edmundson,D,TOR,31,0,0,0,0
31,8480884,Calen Addison,D,SJS,24,0,0,0,0
31,8482511,Mason Lohrei,D,BOS,23,0,0,0,0
31,8482192,Isaak Phillips,D,CHI,23,0,0,0,0
31,8480950,Ilya Lyubushkin,D,TOR,30,0,0,0,0
31,8474031,Kevin Shattenkirk,D,BOS,35,0,0,0,0
31,8475718,Justin Holl,D,DET,32,0,0,0,0
31,8479402,Jake Bean,D,CBJ,26,0,0,0,0
31,8474602,Justin Schultz,D,SEA,34,0,0,0,0
31,8477950,Tony DeAngelo,D,CAR,29,0,0,0,0
31,8481743,Marc Del Gaizo,D,NSH,25,0,0,0,0
31,8481527,Kaedan Korczak,D,VGK,23,0,0,0,0
31,8480192,Johnathan Kovacevic,D,MTL,27,0,0,0,0
31,8476874,Olli Maatta,D,DET,30,0,0,0,0
31,8482144,Jack Thompson,D,SJS,22,0,0,0,0
31,8480222,Sebastian Aho,D,NYI,28,0,0,0,0
31,8479458,Nikita Zaitsev,D,CHI,33,0,0,0,0
31,8471709,Marc-Edouard Vlasic,D,SJS,37,0,0,0,0
31,8482929,Emil Lilleberg,D,TBL,23,0,0,0,0
31,8477018,Ben Hutton,D,VGK,31,0,0,0,0
31,8481056,Spencer Stastney,D,NSH,24,0,0,0,0
31,8481593,Jayden Struble,D,MTL,23,0,0,0,0
31,8479982,Conor Timmins,D,TOR,26,0,0,0,0
31,8474090,Brendan Smith,D,NJD,35,0,0,0,0
31,8482964,Arber Xhekaj,D,MTL,23,0,0,0,0
31,8480891,Michael Kesselring,D,ARI,24,0,0,0,0
31,8477938,Haydn Fleury,D,TBL,28,0,0,0,0
31,8481806,Louis Crevier,D,CHI,23,0,0,0,0
31,8471274,Alex Goligoski,D,MIN,39,0,0,0,0
31,8481600,Tobias Bjornfot,D,FLA,23,0,0,0,0
31,8475797,Jarred Tinordi,D,CHI,32,0,0,0,0
31,8481521,Ronnie Attard,D,PHI,25,0,0,0,0
31,8474612,Travis Hamonic,D,OTT,34,0,0,0,0
31,8479576,Vincent Desharnais,D,EDM,28,0,0,0,0
31,8480049,Dylan Samberg,D,WPG,25,0,0,0,0
31,8483619,Filip Roos,D,CHI,25,0,0,0,0
31,8474568,Luke Schenn,D,NSH,35,0,0,0,0
31,8480184,Gustav Lindstrom,D,ANA,26,0,0,0,0
31,8480070,Ian Mitchell,D,BOS,25,0,0,0,0
31,8480196,Jacob Bryson,D,BUF,27,0,0,0,0
31,8471686,Marc Staal,D,PHI,37,0,0,0,0
31,8477467,Gustav Olofsson,D,SEA,30,0,0,0,0
31,8478970,Jalen Chatfield,D,CAR,28,0,0,0,0
31,8479348,Kale Clague,D,BUF,26,0,0,0,0
31,8473446,Erik Johnson,D,PHI,36,0,0,0,0
31,8477462,Robert Hagg,D,ANA,29,0,0,0,0
31,8478454,Noah Juulsen,D,VAN,27,0,0,0,0
31,8477384,Josh Brown,D,ARI,30,0,0,0,0
31,8481708,Zac Jones,D,NYR,24,0,0,0,0
31,8481167,Brayden Pachal,D,CGY,25,0,0,0,0
31,8482067,Connor Mackey,D,NYR,28,0,0,0,0
31,8483460,David Jiricek,D,CBJ,21,0,0,0,0
31,8481701,Santeri Hatakka,D,NJD,23,0,0,0,0
31,8478021,William Lagesson,D,ANA,28,0,0,0,0
31,8477851,Jordan Oesterle,D,CGY,32,0,0,0,0
31,8478452,Caleb Jones,D,COL,27,0,0,0,0
31,8479984,Cal Foote,D,NJD,26,0,0,0,0
31,8479639,Dylan Coghlan,D,CAR,26,0,0,0,0
31,8480874,Adam Ginning,D,PHI,24,0,0,0,0
31,8479321,Lucas Johansen,D,WSH,27,0,0,0,0
31,8480878,Nils Lundkvist,D,DAL,24,0,0,0,0
31,8482165,Yan Kuznetsov,D,CGY,22,0,0,0,0
31,8484258,Sam Malinski,D,COL,26,0,0,0,0
31,8480157,Calle Rosen,D,STL,30,0,0,0,0
31,8484304,Uvis Balinskis,D,FLA,28,0,0,0,0
31,8479985,Cale Fleury,D,SEA,26,0,0,0,0
31,8479378,Logan Stanley,D,WPG,26,0,0,0,0
31,8477541,Dakota Mermis,D,MIN,30,0,0,0,0
31,8481609,Vladislav Kolyachonok,D,ARI,23,0,0,0,0
31,8480823,Alexander Alexeyev,D,WSH,25,0,0,0,0
31,8481679,Maxence Guenette,D,OTT,23,0,0,0,0
31,8481564,Ryan Johnson,D,BUF,23,0,0,0,0
31,8479376,Victor Mete,D,PHI,26,0,0,0,0
31,8484254,Akito Hirose,D,VAN,25,0,0,0,0
31,8482660,Kent Johnson,C,CBJ,22,0,0,0,0
31,8482149,Cole Perfetti,C,WPG,22,0,0,0,0
31,8477987,Ryan Donato,C,CHI,28,0,0,0,0
31,8475755,Alexander Petrovic,D,DAL,32,0,0,0,0
31,8477810,Joel Hanley,D,CGY,33,0,0,0,0
31,8474145,Robert Bortuzzo,D,NYI,35,0,0,0,0
31,8481161,Jake Christiansen,D,CBJ,25,0,0,0,0
31,8476884,Derrick Pouliot,D,DAL,30,0,0,0,0
31,8481716,Dmitri Voronkov,L,CBJ,24,0,0,0,0
31,8480084,Nick DeSimone,D,NJD,30,0,0,0,0
31,8475750,Jon Merrill,D,MIN,32,0,0,0,0
31,8479315,Joey Anderson,R,CHI,26,0,0,0,0
31,8478011,Louie Belpedio,D,PHI,28,0,0,0,0
31,8482451,Mikael Pyyhtia,L,CBJ,23,0,0,0,0
31,8481541,Samuel Bolduc,D,NYI,24,0,0,0,0
31,8482126,Emil Andrae,D,PHI,31,0,0,0,0
31,8474618,Marco Scandella,D,STL,34,0,0,0,0
31,8477244,Chad Ruhwedel,D,NYR,34,0,0,0,0
31,8477971,Andreas Englund,D,LAK,28,0,0,0,0
31,8480829,Jesperi Kotkaniemi,C,CAR,24,0,0,0,0
31,8479372,Josh Mahura,D,FLA,26,0,0,0,0
31,8482095,Tyler Kleven,D,OTT,22,0,0,0,0
31,8481719,Maxwell Crozier,D,TBL,24,0,0,0,0
31,8475855,Jesper Fast,R,CAR,33,0,0,0,0
31,8480848,Ty Dellandrea,C,DAL,24,0,0,0,0
31,8475193,Tomas Tatar,L,SEA,34,0,0,0,0
31,8476889,Radek Faksa,C,DAL,30,0,0,0,0
31,8478495,Denis Gurianov,R,PHI,27,0,0,0,0
31,8480216,Jacob Peterson,C,SJS,25,0,0,0,0
31,8480252,Cole Guttman,C,CHI,25,0,0,0,0
31,8479026,Philippe Myers,D,TBL,27,0,0,0,0
31,8481006,Tyler Tucker,D,STL,24,0,0,0,0
31,8481032,Paul Cotter,C,VGK,25,0,0,0,0
31,8481577,Philip Tomasino,C,NSH,23,0,0,0,0
31,8476918,Jimmy Vesey,L,NYR,31,0,0,0,0
31,8479320,Max Lajoie,D,TOR,27,0,0,0,0
31,8478017,Mark Friedman,D,VAN,29,0,0,0,0
31,8481754,Nikita Nesterenko,C,ANA,23,0,0,0,0
31,8483407,Brandon Scanlin,D,NYR,25,0,0,0,0
31,8482659,Josh Doan,R,ARI,22,0,0,0,0
31,8477446,Michael McCarron,R,NSH,29,0,0,0,0
31,8477903,Garnet Hathaway,R,PHI,33,0,0,0,0
31,8482153,Brendan Brisson,C,VGK,23,0,0,0,0
31,8483546,Marshall Rifai,D,TOR,26,0,0,0,0
31,8484287,Cole McWard,D,VAN,23,0,0,0,0
31,8478854,Ryan Shea,D,PIT,27,0,0,0,0
31,8481585,Egor Afanasyev,L,NSH,23,0,0,0,0
31,8483398,Declan Carlile,D,TBL,31,0,0,0,0
31,8478502,Dennis Gilbert,D,CGY,28,0,0,0,0
31,8482749,Joshua Roy,R,MTL,21,0,0,0,0
31,8481598,Philip Broberg,D,EDM,23,0,0,0,0
31,8480835,Jack Drury,C,CAR,24,0,0,0,0
31,8480748,Kiefer Sherwood,L,NSH,29,0,0,0,0
31,8476934,Brock McGinn,L,ANA,30,0,0,0,0
31,8480870,Bo Groulx,C,ANA,24,0,0,0,0
31,8479368,Max Jones,L,ANA,26,0,0,0,0
31,8478099,Kevin Labanc,R,SJS,29,0,0,0,0
31,8478067,Oskar Lindblom,L,SJS,28,0,0,0,0
31,8476393,Nick Cousins,C,FLA,31,0,0,0,0
31,8483395,Arshdeep Bains,L,VAN,23,0,0,0,0
31,8480762,Eric Robinson,L,BUF,29,0,0,0,0
31,8479439,Jacob MacDonald,D,SJS,31,0,0,0,0
31,8476474,Stefan Noesen,R,CAR,31,0,0,0,0
31,8482787,Nikita Chibrikov,R,WPG,31,0,0,0,0
31,8478432,Christian Fischer,R,DET,27,0,0,0,0
31,8477979,Nicolas Aube-Kubel,R,WSH,28,0,0,0,0
31,8481789,Tye Kartye,L,SEA,23,0,0,0,0
31,8479330,Brandon Gignac,C,MTL,27,0,0,0,0
31,8480075,Cameron Crotty,D,ARI,25,0,0,0,0
31,8473473,Milan Lucic,L,BOS,36,0,0,0,0
31,8482094,Daemon Hunt,D,MIN,22,0,0,0,0
31,8481206,John Ludvig,D,PIT,24,0,0,0,0
31,8483630,Pavol Regenda,L,ANA,25,0,0,0,0
31,8481617,Vasily Podkolzin,R,VAN,23,0,0,0,0
31,8480306,Grant Hutton,D,NYI,29,0,0,0,0
31,8480995,Pontus Holmberg,R,TOR,25,0,0,0,0
31,8482148,Hendrix Lapierre,C,WSH,22,0,0,0,0
31,8477478,William Carrier,L,VGK,30,0,0,0,0
31,8480003,Jesper Boqvist,C,BOS,26,0,0,0,0
31,8482172,Landon Slaggert,L,CHI,22,0,0,0,0
31,8480789,Oliver Wahlstrom,R,NYI,24,0,0,0,0
31,8474062,Riley Nash,C,NYR,35,0,0,0,0
31,8480021,Jack Studnicka,C,SJS,25,0,0,0,0
31,8480025,MacKenzie Entwistle,R,CHI,25,0,0,0,0
31,8481582,Nicholas Robertson,L,TOR,23,0,0,0,0
31,8476867,Brendan Gaunce,C,CBJ,30,0,0,0,0
31,8479619,Michael Carcone,L,ARI,28,0,0,0,0
31,8479370,Tyson Jost,C,BUF,26,0,0,0,0
31,8479671,Mathieu Olivier,R,CBJ,27,0,0,0,0
31,8476994,Vinnie Hinostroza,C,PIT,30,0,0,0,0
31,8482070,Mitchell Chaffee,R,TBL,26,0,0,0,0
31,8477473,Justin Bailey,R,SJS,29,0,0,0,0
31,8479344,Jesse Puljujarvi,R,PIT,26,0,0,0,0
31,8480205,Emil Bemstrom,C,PIT,25,0,0,0,0
31,8479718,Alex Barré-Boulet,C,TBL,27,0,0,0,0
31,8482061,Brandon Biro,L,BUF,26,0,0,0,0
31,8479638,Justin Brazeau,R,BOS,26,0,0,0,0
31,8474040,Sam Gagner,C,EDM,35,0,0,0,0
31,8477846,Ryan Carpenter,C,SJS,33,0,0,0,0
31,8482077,Dylan Holloway,L,EDM,23,0,0,0,0
31,8482157,Will Cuylle,L,NYR,22,0,0,0,0
31,8480007,Jonas Rondbjerg,R,VGK,25,0,0,0,0
31,8478874,Adam Gaudette,C,STL,28,0,0,0,0
31,8478434,Keegan Kolesar,R,VGK,27,0,0,0,0
31,8480441,Trey Fix-Wolansky,R,CBJ,25,0,0,0,0
31,8479994,Jaret Anderson-Dolan,C,NSH,25,0,0,0,0
31,8483567,Georgii Merkulov,C,BOS,24,0,0,0,0
31,8477380,Jonny Brodzinski,C,NYR,31,0,0,0,0
31,8482201,Gage Goncalves,C,TBL,23,0,0,0,0
31,8478211,Dryden Hunt,L,CGY,29,0,0,0,0
31,8471699,Andrew Cogliano,C,COL,37,0,0,0,0
31,8479421,Jacob Moverare,D,LAK,26,0,0,0,0
31,8478881,Brett Seney,L,CHI,28,0,0,0,0
31,8477464,Nic Petan,C,MIN,29,0,0,0,0
31,8475958,Michael Sgarbossa,C,WSH,32,0,0,0,0
31,8481147,Reese Johnson,C,CHI,26,0,0,0,0
31,8479336,Carl Grundstrom,R,LAK,27,0,0,0,0
31,8480853,Liam Foudy,C,NSH,24,0,0,0,0
31,8479522,Hardy Haman Aktell,D,WSH,26,0,0,0,0
31,8481462,Mason Morelli,L,VGK,28,0,0,0,0
31,8482102,Vasily Ponomarev,C,CAR,22,0,0,0,0
31,8480844,Grigori Denisenko,L,VGK,24,0,0,0,0
31,8479944,Zach Aston-Reese,C,DET,30,0,0,0,0
31,8482784,Zach Dean,C,STL,21,0,0,0,0
31,8479419,Brett Murray,L,BUF,26,0,0,0,0
31,8479520,Brandon Duhaime,R,COL,27,0,0,0,0
31,8477573,Nathan Walker,L,STL,30,0,0,0,0
31,8478078,Rourke Chartier,C,OTT,28,0,0,0,0
31,8475795,Dylan McIlrath,D,WSH,32,0,0,0,0
31,8482496,Nils Aman,C,VAN,24,0,0,0,0
31,8480289,Morgan Barron,C,WPG,26,0,0,0,0
31,8481751,Lukas Rousek,R,BUF,25,0,0,0,0
31,8480011,Klim Kostin,C,SJS,25,0,0,0,0
31,8481556,John Beecher,C,BOS,23,0,0,0,0
31,8475278,Byron Froese,C,VGK,33,0,0,0,0
31,8475225,Craig Smith,C,DAL,35,0,0,0,0
31,8484326,Patrik Koch,D,ARI,28,0,0,0,0
31,8477930,Pierre-Edouard Bellemare,L,SEA,39,0,0,0,0
31,8478409,Anthony Richard,C,BOS,28,0,0,0,0
31,8481024,Linus Karlsson,C,VAN,25,0,0,0,0
31,8479986,Kole Lind,R,SEA,26,0,0,0,0
31,8479414,Nathan Bastian,R,NJD,27,0,0,0,0
31,8479362,Riley Tufte,L,COL,26,0,0,0,0
31,8481058,Jesse Ylönen,R,MTL,25,0,0,0,0
31,8482476,Emil Heineman,L,MTL,23,0,0,0,0
31,8482861,Vincent Iorio,D,WSH,22,0,0,0,0
31,8483432,Luca Del Bel Belluz,C,CBJ,31,0,0,0,0
31,8482744,James Malatesta,L,CBJ,21,0,0,0,0
31,8477887,Patrick Brown,C,BOS,32,0,0,0,0
31,8478585,Derek Ryan,C,EDM,38,0,0,0,0
31,8481441,Joe Snively,C,WSH,28,0,0,0,0
31,8481592,Jakob Pelletier,L,CGY,23,0,0,0,0
31,8482634,Alex Steeves,C,TOR,25,0,0,0,0
31,8477126,Jayson Megna,C,BOS,34,0,0,0,0
31,8475752,Tyler Pitlick,C,NYR,33,0,0,0,0
31,8480008,Adam Ruzicka,C,ARI,25,0,0,0,0
31,8481065,Angus Crookshank,L,OTT,25,0,0,0,0
31,8479547,Matthew Phillips,R,WSH,26,0,0,0,0
31,8480226,Marián Studenic,R,SEA,26,0,0,0,0
31,8481237,Kyle MacLean,C,NYI,25,0,0,0,0
31,8475413,Justin Dowling,C,NJD,34,0,0,0,0
31,8481641,Joel Kiviranta,L,COL,28,0,0,0,0
31,8478104,Sammy Blais,L,STL,28,0,0,0,0
31,8477454,Adam Erne,L,EDM,29,0,0,0,0
31,8481518,Nolan Foote,L,NJD,24,0,0,0,0
31,8480245,Olle Lycksell,R,PHI,25,0,0,0,0
31,8483570,Ben Meyers,C,ANA,26,0,0,0,0
31,8480776,Sheldon Rempal,R,VGK,29,0,0,0,0
31,8483920,Pierrick Dube,R,WSH,23,0,0,0,0
31,8480267,Sammy Walker,C,MIN,25,0,0,0,0
31,8482747,Brennan Othmann,L,NYR,21,0,0,0,0
31,8479991,Jake Leschyshyn,C,NYR,25,0,0,0,0
31,8478400,Colin White,C,MTL,27,0,0,0,0
31,8479328,Julien Gauthier,R,NYI,27,0,0,0,0
31,8484325,Waltteri Merela,C,TBL,26,0,0,0,0
31,8479066,Ryan Lomberg,L,FLA,30,0,0,0,0
31,8477070,Liam O'Brien,C,ARI,30,0,0,0,0
31,8478146,Matthew Highmore,C,OTT,28,0,0,0,0
31,8478028,Fredrik Olofsson,L,COL,28,0,0,0,0
31,8480880,Jakub Lauko,C,BOS,24,0,0,0,0
31,8479968,Vinni Lettieri,C,MIN,29,0,0,0,0
31,8474709,Matt Martin,L,NYI,35,0,0,0,0
31,8480845,Rasmus Kupari,C,WPG,24,0,0,0,0
31,8481550,Adam Beckman,L,MIN,23,0,0,0,0
31,8481422,Jacob Lucchini,C,MIN,29,0,0,0,0
31,8477401,John Hayden,C,SEA,29,0,0,0,0
31,8478904,Steven Lorentz,C,FLA,28,0,0,0,0
31,8482088,Justin Sourdif,R,FLA,22,0,0,0,0
31,8482751,Ryan Winterton,C,SEA,21,0,0,0,0
31,8482241,Radim Zohorna,L,PIT,28,0,0,0,0
31,8481690,Tyler Angle,C,CBJ,24,0,0,0,0
31,8476952,Dominic Toninato,C,WPG,30,0,0,0,0
31,8476919,Chris Tierney,C,NJD,30,0,0,0,0
31,8480032,Shane Bowers,C,NJD,25,0,0,0,0
31,8484314,Jiri Smejkal,L,OTT,28,0,0,0,0
31,8481239,Samuel Fagemo,L,LAK,24,0,0,0,0
31,8481532,Alex Turcotte,C,LAK,23,0,0,0,0
31,8481019,David Gustafsson,C,WPG,24,0,0,0,0
31,8478477,Mitchell Stephens,C,MTL,27,0,0,0,0
31,8479546,Oskar Steen,C,BOS,26,0,0,0,0
31,8480292,Carson Meyer,R,CBJ,27,0,0,0,0
31,8478446,Glenn Gawdin,C,ANA,27,0,0,0,0
31,8483531,Brian Halonen,L,NJD,25,0,0,0,0
31,8477149,Scott Sabourin,R,SJS,32,0,0,0,0
31,8479972,Mason Shaw,C,MIN,26,0,0,0,0
31,8480890,Jan Jenik,R,ARI,24,0,0,0,0
31,8478051,Max Willman,C,NJD,29,0,0,0,0
31,8480851,Akil Thomas,C,LAK,24,0,0,0,0
31,8482765,Isak Rosen,R,BUF,21,0,0,0,0
31,8478421,A.J. Greer,L,CGY,28,0,0,0,0
31,8478512,Austin Czarnik,C,DET,32,0,0,0,0
31,8479536,Axel Jonsson-Fjallby,L,WPG,26,0,0,0,0
31,8477320,Anton Blidh,L,NYR,29,0,0,0,0
31,8481543,Nikita Alexandrov,C,STL,24,0,0,0,0
31,8475235,Nicolas Deslauriers,L,PHI,33,0,0,0,0
31,8481070,Hugh McGing,L,STL,26,0,0,0,0
31,8480836,Jonathan Gruden,C,PIT,24,0,0,0,0
31,8481591,Sam Poulin,R,PIT,23,0,0,0,0
31,8477962,Brendan Lemieux,L,CAR,28,0,0,0,0
31,8483401,Marc Johnstone,R,PIT,28,0,0,0,0
31,8482250,Callahan Burke,C,CAR,27,0,0,0,0
31,8481726,Adam Edstrom,C,NYR,24,0,0,0,0
31,8471817,Ryan Reaves,R,TOR,37,0,0,0,0
31,8479587,Rhett Gardner,C,PHI,28,0,0,0,0
31,8475766,Austin Watson,L,TBL,32,0,0,0,0
31,8479367,William Lockwood,R,FLA,26,0,0,0,0
31,8478424,Jansen Harkins,C,PIT,27,0,0,0,0
31,8476913,Devin Shore,C,SEA,30,0,0,0,0
31,8482652,Walker Duehr,R,CGY,27,0,0,0,0
31,8477527,Ross Johnston,L,ANA,30,0,0,0,0
31,8481077,John Leonard,L,ARI,26,0,0,0,0
31,8483549,Lucas Condotta,L,MTL,27,0,0,0,0
31,8480468,James Hamblin,L,EDM,25,0,0,0,0
31,8476907,Mackenzie MacEachern,L,STL,30,0,0,0,0
31,8479543,Michael Pezzetta,L,MTL,26,0,0,0,0
31,8480355,Mark Kastelic,C,OTT,25,0,0,0,0
31,8482162,Roby Jarventie,L,OTT,22,0,0,0,0
31,8479772,Zack MacEwen,R,OTT,28,0,0,0,0
31,8483597,Milos Kelemen,L,ARI,25,0,0,0,0
31,8479379,Givani Smith,R,SJS,26,0,0,0,0
31,8481655,Cole Schwindt,R,CGY,23,0,0,0,0
31,8479981,Jonah Gadjovich,L,FLA,26,0,0,0,0
31,8482147,Jean-Luc Foudy,C,COL,22,0,0,0,0
31,8484255,Jason Polin,R,COL,25,0,0,0,0
31,8477993,Justin Kirkland,C,ARI,28,0,0,0,0
31,8479249,Andrew Poturalski,C,SEA,30,0,0,0,0
31,8482197,Adam Raska,R,MIN,23,0,0,0,0
31,8475780,Chris Wagner,R,COL,33,0,0,0,0
31,8479533,Joona Koppanen,L,PIT,26,0,0,0,0
31,8481534,Raphael Lavoie,C,EDM,24,0,0,0,0
31,8484321,Nikolas Matinpalo,D,OTT,26,0,0,0,0
31,8481043,Cole Koepke,L,TBL,26,0,0,0,0
31,8476323,Max McCormick,L,SEA,32,0,0,0,0
31,8483609,Adam Klapka,R,CGY,24,0,0,0,0
31,8483512,Matt Savoie,C,BUF,20,0,0,0,0
31,8484259,Ondrej Pavel,C,COL,31,0,0,0,0
31,8478147,Bokondji Imama,L,OTT,28,0,0,0,0
31,8482460,Matt Rempe,C,NYR,22,0,0,0,0
31,8477073,Kurtis MacDermid,L,NJD,30,0,0,0,0
31,8480274,Philip Kemp,D,EDM,25,0,0,0,0
31,8478956,Samuel Laberge,L,NJD,27,0,0,0,0
31,8483045,Cameron Butler,R,CBJ,31,0,0,0,0
32,8478402,Connor McDavid,C,EDM,27,82,49,92,141
32,8477492,Nathan MacKinnon,C,COL,29,82,39,71,110
32,8478420,Mikko Rantanen,R,COL,28,82,52,55,107
32,8479318,Auston Matthews,C,TOR,27,82,50,54,104
32,8477956,David Pastrnak,R,BOS,28,82,44,54,98
32,8477939,William Nylander,R,TOR,28,82,40,56,96
32,8477934,Leon Draisaitl,C,EDM,29,82,34,61,95
32,8480069,Cale Makar,D,COL,26,82,30,64,94
32,8475172,Nazem Kadri,C,CGY,34,82,40,50,90
32,8477493,Aleksander Barkov,C,FLA,29,82,30,60,90
32,8481559,Jack Hughes,C,NJD,23,82,40,49,89
32,8471675,Sidney Crosby,C,PIT,37,82,28,61,89
32,8478550,Artemi Panarin,L,NYR,33,82,36,52,88
32,8478864,Kirill Kaprizov,L,MIN,27,82,35,53,88
32,8476468,J.T. Miller,C,VAN,31,82,31,57,88
32,8480801,Brady Tkachuk,L,OTT,25,82,41,46,87
32,8476453,Nikita Kucherov,R,TBL,31,82,31,56,87
32,8480012,Elias Pettersson,C,VAN,26,82,35,50,85
32,8480023,Robert Thomas,C,STL,25,82,23,62,85
32,8480027,Jason Robertson,L,DAL,25,82,31,53,84
32,8480002,Nico Hischier,C,NJD,25,82,38,45,83
32,8475786,Zach Hyman,L,EDM,32,82,52,28,80
32,8479407,Jesper Bratt,L,NJD,26,82,31,49,80
32,8476456,Jonathan Huberdeau,C,CGY,31,82,26,54,80
32,8475166,John Tavares,C,TOR,34,82,36,43,79
32,8474564,Steven Stamkos,C,TBL,34,82,31,47,78
32,8480800,Quinn Hughes,D,VAN,25,82,16,62,78
32,8478403,Jack Eichel,C,VGK,28,82,35,42,77
32,8477404,Jake Guentzel,C,CAR,30,82,34,43,77
32,8478010,Brayden Point,C,TBL,28,82,43,33,76
32,8478493,Joel Eriksson Ek,C,MIN,27,82,43,32,75
32,8477933,Sam Reinhart,C,FLA,29,82,34,40,74
32,8478439,Travis Konecny,R,PHI,27,82,30,44,74
32,8482116,Tim Stützle,C,OTT,22,82,27,47,74
32,8476459,Mika Zibanejad,C,NYR,31,82,34,39,73
32,8477942,Kevin Fiala,L,LAK,28,82,33,40,73
32,8475913,Mark Stone,R,VGK,32,82,33,40,73
32,8478398,Kyle Connor,L,WPG,28,82,31,41,72
32,8477949,Alex Tuch,R,BUF,28,82,18,54,72
32,8477501,Valeri Nichushkin,R,COL,29,82,33,38,71
32,8482684,Luke Hughes,D,NJD,21,82,22,49,71
32,8475798,Mikael Granlund,C,SJS,32,82,22,49,71
32,8480208,Drake Batherson,R,OTT,26,82,29,41,70
32,8476905,Chandler Stephenson,C,VGK,30,82,16,54,70
32,8479323,Adam Fox,D,NYR,26,82,14,56,70
32,8474600,Roman Josi,D,NSH,34,82,17,52,69
32,8476887,Filip Forsberg,L,NSH,30,82,31,37,68
32,8477416,Oliver Bjorkstrand,R,SEA,29,82,30,38,68
32,8479314,Matthew Tkachuk,L,FLA,27,82,20,48,68
32,8481523,Kirby Dach,C,MTL,23,82,11,57,68
32,8475784,Jeff Skinner,C,BUF,32,82,33,34,67
32,8477960,Adrian Kempe,R,LAK,28,82,32,35,67
32,8477946,Dylan Larkin,C,DET,28,82,29,38,67
32,8478444,Brock Boeser,R,VAN,27,82,34,32,66
32,8475810,Bryan Rust,R,PIT,32,82,34,32,66
32,8477500,Bo Horvat,C,NYI,29,82,33,33,66
32,8477476,Artturi Lehkonen,L,COL,29,82,31,35,66
32,8481557,Matt Boldy,L,MIN,23,82,27,39,66
32,8480865,Noah Dobson,D,NYI,24,82,19,47,66
32,8478414,Timo Meier,R,NJD,28,82,33,32,65
32,8479343,Clayton Keller,R,ARI,26,82,27,38,65
32,8482097,Jack Quinn,R,BUF,23,82,27,38,65
32,8479542,Brandon Hagel,L,TBL,26,82,26,39,65
32,8476346,Johnny Gaudreau,L,CBJ,31,82,23,42,65
32,8480803,Evan Bouchard,D,EDM,25,82,16,49,65
32,8475692,Mats Zuccarello,R,MIN,37,82,15,50,65
32,8475167,Victor Hedman,D,TBL,34,82,14,51,65
32,8476853,Morgan Rielly,D,TOR,30,82,12,53,65
32,8481540,Cole Caufield,R,MTL,23,82,44,20,64
32,8479420,Tage Thompson,C,BUF,27,82,34,30,64
32,8477447,Shea Theodore,D,VGK,29,82,12,52,64
32,8470794,Joe Pavelski,C,DAL,40,82,24,39,63
32,8478042,Viktor Arvidsson,R,LAK,31,82,26,36,62
32,8478427,Sebastian Aho,C,CAR,27,82,25,37,62
32,8478440,Dylan Strome,C,WSH,27,82,17,45,62
32,8474578,Erik Karlsson,D,PIT,34,82,13,49,62
32,8475184,Chris Kreider,L,NYR,33,82,39,22,61
32,8478873,Troy Terry,R,ANA,27,82,29,32,61
32,8478047,Michael Bunting,L,PIT,29,82,27,34,61
32,8478449,Roope Hintz,C,DAL,28,82,26,35,61
32,8480830,Andrei Svechnikov,R,CAR,24,82,24,37,61
32,8478445,Mathew Barzal,C,NYI,27,82,23,38,61
32,8477951,Nick Schmaltz,C,ARI,28,82,20,41,61
32,8471685,Anze Kopitar,C,LAK,37,82,14,47,61
32,8479339,Patrik Laine,L,CBJ,26,82,26,34,60
32,8476462,Dougie Hamilton,D,NJD,31,82,14,46,60
32,8478401,Pavel Zacha,C,BOS,27,82,27,32,59
32,8481596,Shane Pinto,C,OTT,24,82,24,35,59
32,8477479,Tyler Bertuzzi,L,TOR,29,82,20,39,59
32,8473512,Claude Giroux,R,OTT,36,82,20,39,59
32,8480839,Rasmus Dahlin,D,BUF,24,82,18,41,59
32,8480036,Miro Heiskanen,D,DAL,25,82,13,46,59
32,8482109,Alexis Lafrenière,L,NYR,23,82,26,32,58
32,8479337,Alex DeBrincat,R,DET,27,82,24,34,58
32,8475168,Matt Duchene,C,DAL,33,82,21,37,58
32,8477451,Ryan Hartman,R,MIN,30,82,29,28,57
32,8471215,Evgeni Malkin,C,PIT,38,82,20,37,57
32,8474141,Patrick Kane,R,DET,36,82,20,37,57
32,8474590,John Carlson,D,WSH,34,82,16,41,57
32,8479385,Jordan Kyrou,C,STL,26,82,33,23,56
32,8482665,Matty Beniers,C,SEA,22,82,21,35,56
32,8477496,Elias Lindholm,C,VAN,30,82,21,35,56
32,8476460,Mark Scheifele,C,WPG,31,82,20,36,56
32,8477504,Josh Morrissey,D,WPG,29,82,15,41,56
32,8477402,Pavel Buchnevich,L,STL,29,82,25,30,55
32,8475170,Brayden Schenn,C,STL,33,82,25,30,55
32,8471214,Alex Ovechkin,L,WSH,39,82,24,31,55
32,8481533,Trevor Zegras,C,ANA,23,82,23,32,55
32,8476454,Ryan Nugent-Hopkins,C,EDM,31,82,20,35,55
32,8478407,Vince Dunn,D,SEA,28,82,13,42,55
32,8482159,Tyson Foerster,R,PHI,22,82,34,20,54
32,8477409,Carter Verhaeghe,C,FLA,29,82,25,29,54
32,8474586,Jordan Eberle,R,SEA,34,82,21,33,54
32,8482078,Lucas Raymond,L,DET,22,82,20,34,54
32,8480028,Morgan Frost,C,PHI,25,82,20,34,54
32,8480064,Josh Norris,C,OTT,25,82,30,23,53
32,8478366,Frank Vatrano,R,ANA,30,82,25,28,53
32,8480039,Martin Necas,C,CAR,25,82,19,34,53
32,8478975,Mason Marchment,L,DAL,29,82,18,35,53
32,8477494,Jonathan Drouin,L,COL,29,82,15,38,53
32,8478038,Devon Toews,D,COL,30,82,9,44,53
32,8475765,Vladimir Tarasenko,R,FLA,33,82,27,25,52
32,8475745,Charlie Coyle,C,BOS,32,82,19,33,52
32,8477955,Jared McCann,L,SEA,28,82,18,34,52
32,8482124,Quinton Byfield,R,LAK,22,82,16,36,52
32,8475726,Tyler Toffoli,C,WPG,32,82,24,27,51
32,8480018,Nick Suzuki,C,MTL,25,82,23,28,51
32,8482093,Seth Jarvis,C,CAR,22,82,20,31,51
32,8479999,Casey Mittelstadt,C,COL,26,82,16,35,51
32,8473419,Brad Marchand,L,BOS,36,82,14,37,51
32,8480078,Filip Chytil,C,NYR,25,82,15,35,50
32,8474150,Mikael Backlund,C,CGY,35,82,14,36,50
32,8478472,Mathieu Joseph,R,OTT,27,82,14,36,50
32,8478469,Thomas Chabot,D,OTT,27,82,11,39,50
32,8474565,Alex Pietrangelo,D,VGK,34,82,8,42,50
32,8484144,Connor Bedard,C,CHI,19,82,27,22,49
32,8482740,Wyatt Johnston,C,DAL,21,82,26,23,49
32,8480015,Owen Tippett,R,PHI,25,82,24,25,49
32,8474679,Gustav Nyquist,C,NSH,35,82,24,25,49
32,8481068,Yegor Sharangovich,C,CGY,26,82,21,28,49
32,8475754,Brock Nelson,C,NYI,33,82,20,29,49
32,8480797,Joel Farabee,L,PHI,24,82,20,29,49
32,8483445,Cutter Gauthier,L,ANA,20,82,16,33,49
32,8478397,Rasmus Andersson,D,CGY,28,82,6,43,49
32,8474157,Max Pacioretty,L,WSH,36,82,29,19,48
32,8482146,Luke Evangelista,R,NSH,22,82,28,20,48
32,8476880,Tom Wilson,R,WSH,30,82,27,21,48
32,8476448,William Karlsson,C,VGK,31,82,24,24,48
32,8477407,Anthony Duclair,L,TBL,29,82,24,24,48
32,8475169,Evander Kane,L,EDM,33,82,23,25,48
32,8479400,Pierre-Luc Dubois,L,LAK,26,82,21,27,48
32,8482667,William Eklund,L,SJS,22,82,21,27,48
32,8481618,Alex Newhook,C,MTL,23,82,20,28,48
32,8475158,Ryan O'Reilly,C,NSH,33,82,18,30,48
32,8477503,Max Domi,C,TOR,29,82,15,33,48
32,8482101,Danil Gushchin,L,SJS,22,82,23,24,47
32,8478498,Jake DeBrusk,L,BOS,28,82,23,24,47
32,8476399,Blake Coleman,C,CGY,33,82,23,24,47
32,8476483,Rickard Rakell,R,PIT,31,82,23,24,47
32,8477940,Nikolaj Ehlers,L,WPG,28,82,22,25,47
32,8478233,Andrew Mangiapane,L,CGY,28,82,18,29,47
32,8476875,Mike Matheson,D,MTL,30,82,12,35,47
32,8476432,Boone Jenner,C,CBJ,31,82,25,21,46
32,8476539,Jonathan Marchessault,R,VGK,34,82,23,23,46
32,8482745,Mason McTavish,C,ANA,21,82,21,25,46
32,8476461,Sean Couturier,C,PHI,32,82,14,32,46
32,8478438,Tommy Novak,C,NSH,27,82,13,33,46
32,8478396,Noah Hanifin,D,VGK,27,82,13,33,46
32,8481699,Aku Raty,R,ARI,23,82,3,43,46
32,8482475,Yegor Chinakhov,R,CBJ,23,82,28,17,45
32,8480188,Fabian Zetterlund,L,SJS,25,82,22,23,45
32,8471698,T.J. Oshie,R,WSH,38,82,21,24,45
32,8474102,David Perron,L,DET,36,82,16,29,45
32,8473986,Alex Killorn,L,ANA,35,82,14,31,45
32,8479410,Mikhail Sergachev,D,TBL,26,82,13,32,45
32,8479345,Jakob Chychrun,D,OTT,26,82,10,35,45
32,8479425,Filip Hronek,D,VAN,27,82,5,40,45
32,8482113,Anton Lundell,C,FLA,23,82,24,20,44
32,8476389,Vincent Trocheck,C,NYR,31,82,23,21,44
32,8478519,Anthony Cirelli,C,TBL,27,82,21,23,44
32,8482175,JJ Peterka,R,BUF,22,82,20,24,44
32,8473994,Jamie Benn,L,DAL,35,82,16,28,44
32,8475791,Taylor Hall,L,CHI,33,82,15,29,44
32,8476826,Yanni Gourde,C,SEA,33,82,14,30,44
32,8476329,Travis Boyd,C,ARI,31,82,12,32,44
32,8477346,MacKenzie Weegar,D,CGY,30,82,11,33,44
32,8480849,Barrett Hayton,C,ARI,24,82,21,22,43
32,8476479,Phillip Danault,C,LAK,31,82,20,23,43
32,8476881,Tomas Hertl,C,VGK,31,82,19,24,43
32,8476882,Teuvo Teravainen,L,CAR,30,82,19,24,43
32,8477444,Andre Burakovsky,L,SEA,29,82,19,24,43
32,8482699,Dylan Guenther,R,ARI,21,82,18,25,43
32,8482092,Ridly Greig,C,OTT,22,82,17,26,43
32,8475191,Reilly Smith,R,PIT,33,82,16,27,43
32,8476792,Torey Krug,D,STL,33,82,7,36,43
32,8475799,Nino Niederreiter,R,WPG,32,82,24,18,42
32,8475151,Kyle Palmieri,C,NYI,33,82,23,19,42
32,8483808,Andrei Kuzmenko,L,CGY,28,82,22,20,42
32,8481528,Dylan Cozens,C,BUF,23,82,19,23,42
32,8476872,Scott Laughton,C,PHI,30,82,18,24,42
32,8471218,Blake Wheeler,R,NYR,38,82,14,28,42
32,8482671,Owen Power,D,BUF,22,82,10,32,42
32,8475760,Nick Bjugstad,C,ARI,32,82,21,20,41
32,8478856,Conor Garland,R,VAN,28,82,19,22,41
32,8477456,J.T. Compher,L,DET,29,82,16,25,41
32,8474037,James van Riemsdyk,L,BOS,35,82,14,27,41
32,8481542,Moritz Seider,D,DET,23,82,9,32,41
32,8471724,Kris Letang,D,PIT,37,82,8,33,41
32,8483524,Shane Wright,C,SEA,20,82,32,8,40
32,8482055,Drew O'Connor,L,PIT,26,82,20,20,40
32,8479525,Ross Colton,C,COL,28,82,20,20,40
32,8478462,Nicolas Roy,C,VGK,27,82,19,21,40
32,8481624,Ilya Mikheyev,R,VAN,30,82,19,21,40
32,8482110,Dawson Mercer,C,NJD,23,82,18,22,40
32,8474641,Adam Henrique,C,EDM,34,82,17,23,40
32,8473422,Nick Foligno,L,CHI,37,82,17,23,40
32,8480798,Philipp Kurashev,C,CHI,25,82,15,25,40
32,8480009,Eeli Tolvanen,R,SEA,25,82,15,25,40
32,8470613,Brent Burns,D,CAR,39,82,14,26,40
32,8477986,Brandon Montour,D,FLA,30,82,13,27,40
32,8475794,Tyler Seguin,C,DAL,32,82,12,28,40
32,8476906,Shayne Gostisbehere,D,DET,31,82,6,34,40
32,8480014,Gabriel Vilardi,C,WPG,25,82,26,13,39
32,8478474,Lawson Crouse,L,ARI,27,82,21,18,39
32,8475287,Erik Haula,L,NJD,33,82,20,19,39
32,8483431,Logan Cooley,C,ARI,20,82,19,20,39
32,8483515,Juraj Slafkovsky,L,MTL,20,82,18,21,39
32,8478466,Daniel Sprong,R,DET,27,82,18,21,39
32,8481580,Connor McMichael,C,WSH,23,82,16,23,39
32,8475744,Evgeny Kuznetsov,C,CAR,32,82,12,27,39
32,8482720,Matthew Knies,L,TOR,22,82,11,28,39
32,8481581,Thomas Harley,D,DAL,23,82,11,28,39
32,8481711,Matias Maccelli,L,ARI,24,82,9,30,39
32,8474563,Drew Doughty,D,LAK,35,82,6,33,39
32,8476869,Brady Skjei,D,CAR,30,82,5,34,39
32,8482122,Brock Faber,D,MIN,22,82,3,36,39
32,8479423,Alex Nylander,L,CBJ,26,82,20,18,38
32,8475722,Jason Zucker,L,NSH,32,82,17,21,38
32,8482624,Daniil Miromanov,D,CGY,27,82,16,22,38
32,8477497,Sean Monahan,C,WPG,30,82,14,24,38
32,8480434,Sean Durzi,D,ARI,26,82,13,25,38
32,8479987,Morgan Geekie,C,BOS,26,82,12,26,38
32,8477964,Ivan Barbashev,C,VGK,29,82,10,28,38
32,8481703,Valtteri Puustinen,R,PIT,25,82,9,29,38
32,8479996,Cody Glass,C,NSH,25,82,17,20,37
32,8477021,Alex Kerfoot,C,ARI,30,82,16,21,37
32,8479992,Michael Rasmussen,C,DET,25,82,15,22,37
32,8478458,Jack Roslovic,C,NYR,27,82,12,25,37
32,8480802,Ryan McLeod,C,EDM,25,82,12,25,37
32,8482705,Cole Sillinger,C,CBJ,21,82,11,26,37
32,8478460,Zach Werenski,D,CBJ,27,82,9,28,37
32,8480031,Maxime Comtois,L,CAR,25,82,9,28,37
32,8475764,Cam Fowler,D,ANA,33,82,3,34,37
32,8474189,Lars Eller,C,PIT,35,82,13,23,36
32,8478542,Evan Rodrigues,C,FLA,31,82,12,24,36
32,8475793,Ryan Johansen,C,PHI,32,82,10,26,36
32,8479325,Charlie McAvoy,D,BOS,27,82,9,27,36
32,8478507,John Marino,D,NJD,27,82,9,27,36
32,8476885,Jacob Trouba,D,NYR,30,82,8,28,36
32,8477488,Brett Pesce,D,CAR,30,82,7,29,36
32,8483397,Marc McLaughlin,C,BOS,25,82,32,3,35
32,8475314,Anders Lee,L,NYI,34,82,22,13,35
32,8481535,Nils Hoglander,L,VAN,24,82,19,16,35
32,8478508,Yakov Trenin,C,COL,27,82,19,16,35
32,8477426,Nicholas Paul,L,TBL,29,82,17,18,35
32,8473533,Jordan Staal,C,CAR,36,82,16,19,35
32,8482125,Alexander Holtz,R,NJD,22,82,13,22,35
32,8482133,Thomas Bordeleau,C,SJS,22,82,9,26,35
32,8477932,Aaron Ekblad,D,FLA,28,82,6,29,35
32,8475218,Mattias Ekholm,D,EDM,34,82,5,30,35
32,8475343,Nic Dowd,C,WSH,34,82,17,17,34
32,8479514,Rem Pitlick,C,CHI,27,82,15,19,34
32,8477511,Anthony Mantha,R,VGK,30,82,14,20,34
32,8479675,Trevor Moore,L,LAK,29,82,13,21,34
32,8476392,Adam Lowry,C,WPG,31,82,13,21,34
32,8475753,Justin Faulk,D,STL,32,82,10,24,34
32,8476480,Vladislav Namestnikov,C,WPG,32,82,10,24,34
32,8475906,John Klingberg,D,TOR,32,82,3,31,34
32,8476438,Brandon Saad,L,STL,32,82,19,14,33
32,8480893,Kirill Marchenko,R,CBJ,24,82,19,14,33
32,8479346,Dillon Dube,C,CGY,26,82,19,14,33
32,8477953,Kasperi Kapanen,R,STL,28,82,17,16,33
32,8479316,Luke Kunin,C,SJS,27,82,16,17,33
32,8481554,Kaapo Kakko,R,NYR,23,82,14,19,33
32,8480855,Jack McBain,C,ARI,24,82,13,20,33
32,8475200,Dmitry Orlov,D,CAR,33,82,11,22,33
32,8482105,Jake Sanderson,D,OTT,22,82,9,24,33
32,8474884,Mike Hoffman,C,SJS,35,82,18,14,32
32,8470610,Zach Parise,L,COL,40,82,18,14,32
32,8476925,Colton Sissons,C,NSH,31,82,14,18,32
32,8484166,Adam Fantilli,C,CBJ,20,82,13,19,32
32,8476292,Ondrej Palat,L,NJD,33,82,11,21,32
32,8476921,Jordan Martinook,L,CAR,32,82,10,22,32
32,8477498,Darnell Nurse,D,EDM,29,82,10,22,32
32,8476458,Ryan Strome,C,ANA,31,82,7,25,32
32,8478055,Gustav Forsling,D,FLA,28,82,7,25,32
32,8481178,Egor Zamula,D,PHI,24,82,6,26,32
32,8482259,Bobby McMann,C,TOR,28,82,19,12,31
32,8479365,Trent Frederic,C,BOS,26,82,16,15,31
32,8482089,Jake Neighbours,L,STL,22,82,16,15,31
32,8481517,Brett Leason,R,ANA,25,82,16,15,31
32,8483499,Liam Ohgren,L,MIN,20,82,15,16,31
32,8474870,Tyler Johnson,C,CHI,34,82,13,18,31
32,8482142,Jamie Drysdale,D,PHI,22,82,13,18,31
32,8480068,Ryan Poehling,C,PHI,25,82,11,20,31
32,8475768,Jaden Schwartz,C,SEA,32,82,9,22,31
32,8475220,Marcus Foligno,L,MIN,33,82,9,22,31
32,8473563,Nicklas Backstrom,C,WSH,37,82,8,23,31
32,8482222,Alexander Barabanov,L,SJS,30,82,7,24,31
32,8481013,Jonatan Berggren,R,DET,24,82,7,24,31
32,8481656,Aliaksei Protas,C,WSH,23,82,7,24,31
32,8475171,Oliver Ekman-Larsson,D,FLA,33,82,7,24,31
32,8483471,Brad Lambert,C,WPG,31,82,6,25,31
32,8481546,Cam York,D,PHI,23,82,5,26,31
32,8481606,Jordan Spence,D,LAK,23,82,5,26,31
32,8478178,Darren Raddysh,D,TBL,28,82,5,26,31
32,8480873,Rasmus Sandin,D,WSH,24,82,4,27,31
32,8482733,Logan Mailloux,D,MTL,31,82,4,27,31
32,8479390,Taylor Raddysh,R,CHI,26,82,15,15,30
32,8478891,Mason Appleton,C,WPG,28,82,11,19,30
32,8480796,Martin Fehervary,D,WSH,25,82,10,20,30
32,8476457,Adam Larsson,D,SEA,32,82,9,21,30
32,8484145,Zach Benson,L,BUF,19,82,9,21,30
32,8477507,Nikita Zadorov,D,VAN,29,82,8,22,30
32,8477935,Sam Bennett,C,FLA,28,82,17,12,29
32,8470604,Jeff Carter,C,PIT,39,82,16,13,29
32,8482111,Justin Barron,D,MTL,23,82,15,14,29
32,8478115,Pierre Engvall,L,NYI,28,82,14,15,29
32,8482079,Marco Rossi,C,MIN,23,82,14,15,29
32,8475763,Kevin Hayes,R,STL,32,82,13,16,29
32,8481481,Blake Lizotte,C,LAK,27,82,12,17,29
32,8474053,Logan Couture,C,SJS,35,82,11,18,29
32,8480817,K'Andre Miller,D,NYR,24,82,10,19,29
32,8478046,Danton Heinen,L,BOS,29,82,9,20,29
32,8477948,Travis Sanheim,D,PHI,28,82,9,20,29
32,8481537,Nikita Okhotiuk,D,CGY,24,82,9,20,29
32,8480336,Sean Walker,D,COL,30,82,9,20,29
32,8479941,Justin Danforth,R,CBJ,31,82,9,20,29
32,8481524,Bowen Byram,D,BUF,23,82,8,21,29
32,8479415,Michael McLeod,C,NJD,26,82,7,22,29
32,8480185,Eetu Luostarinen,C,FLA,26,82,7,22,29
32,8477495,Seth Jones,D,CHI,30,82,4,25,29
32,8480281,Alexey Toropchenko,R,STL,25,82,17,11,28
32,8482702,Logan Stankoven,C,DAL,21,82,16,12,28
32,8477330,Dominik Kubalik,L,OTT,29,82,15,13,28
32,8480459,Pius Suter,C,VAN,28,82,14,14,28
32,8480113,Alex Iafallo,L,WPG,31,82,13,15,28
32,8480144,David Kampf,C,TOR,29,82,13,15,28
32,8476878,Zemgus Girgensons,L,BUF,30,82,12,16,28
32,8477947,Sonny Milano,L,WSH,28,82,11,17,28
32,8481601,Simon Holmstrom,R,NYI,23,82,11,17,28
32,8481522,Peyton Krebs,C,BUF,23,82,9,19,28
32,8477969,Marcus Pettersson,D,PIT,28,82,5,23,28
32,8476927,Teddy Blueger,C,VAN,30,82,4,24,28
32,8476958,Jaccob Slavin,D,CAR,30,82,3,25,28
32,8477952,Robby Fabbri,C,DET,28,82,18,9,27
32,8484203,Bradly Nadeau,L,CAR,19,82,16,11,27
32,8481604,Pavel Dorofeyev,L,VGK,24,82,15,12,27
32,8481560,Arthur Kaliyev,R,LAK,23,82,14,13,27
32,8480220,Noah Cates,L,PHI,25,82,11,16,27
32,8476960,Andreas Athanasiou,C,CHI,30,82,10,17,27
32,8470621,Corey Perry,R,EDM,39,82,10,17,27
32,8482655,J.J. Moser,D,ARI,24,82,7,20,27
32,8475790,Erik Gudbranson,D,CBJ,32,82,5,22,27
32,8475197,Tyson Barrie,D,NSH,33,82,4,23,27
32,8483457,Lane Hutson,D,MTL,20,82,3,24,27
32,8480246,Nick Perbix,D,TBL,26,82,3,24,27
32,8475181,Nick Leddy,D,STL,33,82,2,25,27
32,8476469,Joel Armia,R,MTL,31,82,14,12,26
32,8478463,Anthony Beauvillier,L,NSH,27,82,12,14,26
32,8478109,Victor Olofsson,L,BUF,29,82,12,14,26
32,8480821,Filip Zadina,R,SJS,25,82,11,15,26
32,8477450,Jason Dickinson,C,CHI,29,82,9,17,26
32,8475149,Marcus Johansson,L,MIN,34,82,9,17,26
32,8482117,Lukas Reichel,L,CHI,22,82,7,19,26
32,8476979,Erik Gustafsson,D,NYR,32,82,5,21,26
32,8482087,Kaiden Guhle,D,MTL,22,82,5,21,26
32,8480074,Alexandre Texier,C,CBJ,25,82,5,21,26
32,8476312,Josh Manson,D,COL,33,82,5,21,26
32,8478413,Jordan Greenway,L,BUF,27,82,3,23,26
32,8476624,Barclay Goodrow,C,NYR,31,82,14,11,25
32,8477919,Frederick Gaudreau,C,MIN,31,82,11,14,25
32,8481477,Nico Sturm,C,SJS,29,82,11,14,25
32,8476897,Oskar Sundqvist,C,STL,30,82,10,15,25
32,8482679,Matt Coronato,R,CGY,22,82,10,15,25
32,8479591,Michael Eyssimont,C,TBL,28,82,10,15,25
32,8477429,Andrew Copp,C,DET,30,82,9,16,25
32,8477392,Hudson Fasching,R,NYI,29,82,9,16,25
32,8476463,Jonas Brodin,D,MIN,31,82,8,17,25
32,8474715,Cam Atkinson,R,PHI,35,82,5,20,25
32,8476917,Adam Pelech,D,NYI,30,82,4,21,25
32,8476892,Colton Parayko,D,STL,31,82,3,22,25
32,8478399,Jonas Siegenthaler,D,NJD,27,82,3,22,25
32,8481016,Ruslan Iskhakov,C,NYI,24,82,2,23,25
32,8476981,Josh Anderson,R,MTL,30,82,16,8,24
32,8478057,Dakota Joshua,C,VAN,28,82,14,10,24
32,8478020,Michael Amadio,C,VGK,28,82,13,11,24
32,8475842,Sam Carrick,C,EDM,32,82,12,12,24
32,8477998,Warren Foegele,L,EDM,28,82,11,13,24
32,8480806,Isac Lundestrom,C,ANA,25,82,10,14,24
32,8482737,Zack Bolduc,C,STL,21,82,8,16,24
32,8479398,Samuel Girard,D,COL,26,82,6,18,24
32,8478911,Matt Roy,D,LAK,29,82,6,18,24
32,8478451,Ethan Bear,D,WSH,27,82,6,18,24
32,8476931,Jake McCabe,D,TOR,31,82,5,19,24
32,8473507,Jeff Petry,D,DET,37,82,5,19,24
32,8484911,Collin Graf,R,SJS,22,82,5,19,24
32,8480043,Timothy Liljegren,D,TOR,25,82,4,20,24
32,8476422,Mike Reilly,D,NYI,31,82,4,20,24
32,8477220,Nate Schmidt,D,WPG,33,82,3,21,24
32,8482809,Jackson Blake,R,CAR,21,82,15,8,23
32,8474149,Evgenii Dadonov,R,DAL,35,82,14,9,23
32,8483493,Frank Nazar,C,CHI,20,82,14,9,23
32,8475714,Calle Jarnkrok,C,TOR,33,82,12,11,23
32,8476374,Sean Kuraly,C,CBJ,31,82,10,13,23
32,8480448,Parker Kelly,L,OTT,25,82,10,13,23
32,8480813,Joe Veleno,C,DET,24,82,9,14,23
32,8483482,Tristan Luneau,D,ANA,20,82,9,14,23
32,8477931,Tomas Nosek,L,NJD,32,82,9,14,23
32,8477425,Miles Wood,L,COL,29,82,8,15,23
32,8480035,Henri Jokiharju,D,BUF,25,82,7,16,23
32,8479369,Andrew Peeke,D,BOS,26,82,4,19,23
32,8483490,Pavel Mintyukov,D,ANA,21,82,4,19,23
32,8478136,Jake Middleton,D,MIN,28,82,2,21,23
32,8474151,Ryan McDonagh,D,NSH,35,82,1,22,23
32,8478043,Sam Lafferty,C,VAN,29,82,12,10,22
32,8482155,Alex Laferriere,R,LAK,23,82,11,11,22
32,8483491,Ivan Miroshnichenko,L,WSH,20,82,10,12,22
32,8475848,Brendan Gallagher,R,MTL,32,82,8,14,22
32,8477435,Ryan Graves,D,PIT,29,82,6,16,22
32,8477353,Tyler Motte,C,TBL,29,82,6,16,22
32,8478133,Jake Evans,C,MTL,28,82,6,16,22
32,8480871,Adam Boqvist,D,CBJ,24,82,5,17,22
32,8483505,Matthew Poitras,C,BOS,20,82,5,17,22
32,8477506,Ryan Pulock,D,NYI,30,82,4,18,22
32,8479976,Juuso Valimaki,D,ARI,26,82,4,18,22
32,8482073,Braden Schneider,D,NYR,23,82,4,18,22
32,8478500,Ivan Provorov,D,CBJ,27,82,3,19,22
32,8481568,Alex Vlasic,D,CHI,23,82,3,19,22
32,8474716,Jared Spurgeon,D,MIN,35,82,3,19,22
32,8481605,Jackson LaCombe,D,ANA,23,82,1,21,22
32,8476854,Hampus Lindholm,D,BOS,30,82,0,22,22
32,8482118,Sam Colangelo,R,ANA,23,82,16,5,21
32,8482145,Mavrik Bourque,C,DAL,22,82,15,6,21
32,8478569,Noel Acciari,C,PIT,33,82,15,6,21
32,8479661,Tanner Jeannot,L,TBL,27,82,8,13,21
32,8482062,Cole Smith,L,NSH,29,82,8,13,21
32,8479291,Kevin Rooney,C,CGY,31,82,8,13,21
32,8476419,Jean-Gabriel Pageau,C,NYI,32,82,7,14,21
32,8479353,Brett Howden,C,VGK,26,82,7,14,21
32,8484153,Leo Carlsson,C,ANA,20,82,7,14,21
32,8481704,Juuso Parssinen,C,NSH,23,82,6,15,21
32,8481553,Bobby Brink,R,PHI,23,82,6,15,21
32,8476429,Scott Mayfield,D,NYI,32,82,6,15,21
32,8479393,Noah Gregor,C,TOR,26,82,13,7,20
32,8473449,Kyle Okposo,R,FLA,36,82,10,10,20
32,8479293,Brandon Tanev,L,SEA,33,82,10,10,20
32,8482803,Olen Zellweger,D,ANA,21,82,8,12,20
32,8477505,Alexander Wennberg,C,NYR,30,82,7,13,20
32,8474034,Pat Maroon,L,BOS,36,82,6,14,20
32,8476923,Damon Severson,D,CBJ,30,82,5,15,20
32,8479977,Kailer Yamamoto,R,SEA,26,82,5,15,20
32,8477845,Trevor van Riemsdyk,D,WSH,33,82,5,15,20
32,8478443,Brandon Carlo,D,BOS,28,82,4,16,20
32,8481014,Alexander Romanov,D,NYI,24,82,3,17,20
32,8481567,Henry Thrun,D,SJS,23,82,3,17,20
32,8474673,TJ Brodie,D,TOR,34,82,2,18,20
32,8478831,Kevin Stenlund,C,FLA,28,82,12,7,19
32,8476873,Mark Jankowski,C,NSH,30,82,11,8,19
32,8477365,Connor Clifton,D,BUF,29,82,9,10,19
32,8479383,Boris Katchouk,L,OTT,26,82,9,10,19
32,8477369,Carson Soucy,D,VAN,30,82,9,10,19
32,8475279,Ben Chiarot,D,DET,33,82,9,10,19
32,8479351,Sam Steel,C,DAL,26,82,8,11,19
32,8476871,Tanner Pearson,L,MTL,32,82,6,13,19
32,8483565,Nick Blankenburg,D,CBJ,26,82,6,13,19
32,8475164,Jakob Silfverberg,R,ANA,34,82,6,13,19
32,8478840,Will Borgen,D,SEA,28,82,3,16,19
32,8475455,Brenden Dillon,D,WPG,34,82,2,17,19
32,8475324,Nick Jensen,D,WSH,34,82,2,17,19
32,8482074,Connor Zary,C,CGY,23,82,10,8,18
32,8475231,Casey Cizikas,C,NYI,33,82,10,8,18
32,8481186,Logan O'Connor,R,COL,28,82,6,12,18
32,8478416,Erik Cernak,D,TBL,27,82,5,13,18
32,8482177,Marat Khusnutdinov,C,MIN,22,82,5,13,18
32,8478851,Alexandre Carrier,D,NSH,28,82,4,14,18
32,8480073,Erik Brannstrom,D,OTT,25,82,4,14,18
32,8476891,Matt Grzelcyk,D,BOS,30,82,4,14,18
32,8480145,Neal Pionk,D,WPG,29,82,3,15,18
32,8476967,Brett Kulak,D,EDM,30,82,3,15,18
32,8478430,Oliver Kylington,D,CGY,27,82,3,15,18
32,8477499,Rasmus Ristolainen,D,PHI,30,82,3,15,18
32,8478882,Vladislav Gavrikov,D,LAK,29,82,1,17,18
32,8470600,Ryan Suter,D,DAL,39,82,1,17,18
32,8482730,Brandt Clarke,D,LAK,21,82,7,10,17
32,8477839,Conor Sheary,L,TBL,32,82,6,11,17
32,8480172,Jan Rutta,D,SJS,34,82,6,11,17
32,8479983,Mario Ferraro,D,SJS,26,82,6,11,17
32,8480834,Ty Emberson,D,SJS,24,82,4,13,17
32,8474574,Tyler Myers,D,VAN,34,82,3,14,17
32,8479371,Dante Fabbro,D,NSH,26,82,2,15,17
32,8475233,David Savard,D,MTL,34,82,2,15,17
32,8477989,Christian Dvorak,C,MTL,28,82,9,7,16
32,8476442,Matt Nieto,L,PIT,32,82,8,8,16
32,8482666,Scott Morrow,D,CAR,22,82,8,8,16
32,8478408,Travis Dermott,D,ARI,28,82,8,8,16
32,8480980,Connor Dewar,C,TOR,25,82,7,9,16
32,8479998,Mikey Anderson,D,LAK,25,82,6,10,16
32,8481028,Martin Pospisil,C,CGY,25,82,5,11,16
32,8470966,Mark Giordano,D,TOR,41,82,5,11,16
32,8476879,Cody Ceci,D,EDM,31,82,4,12,16
32,8479980,Nicolas Hague,D,VGK,26,82,4,12,16
32,8482516,Matthew Kessel,D,STL,24,82,3,13,16
32,8475208,Brian Dumoulin,D,SEA,33,82,2,14,16
32,8475690,Chris Tanev,D,DAL,35,82,2,14,16
32,8476372,Nick Seeler,D,PHI,31,82,2,14,16
32,8482245,Artem Zub,D,OTT,29,82,1,15,16
32,8479359,Beck Malenstyn,L,WSH,26,82,5,10,15
32,8474166,Alec Martinez,D,VGK,37,82,3,12,15
32,8483495,Simon Nemec,D,NJD,20,82,2,13,15
32,8482712,Oskar Olausson,R,COL,22,82,2,13,15
32,8481059,Scott Perunovich,D,STL,26,82,2,13,15
32,8483466,Kevin Korchinski,D,CHI,20,82,1,14,15
32,8480058,Pierre-Olivier Joseph,D,PIT,25,82,0,15,15
32,8481093,Rafael Harvey-Pinard,L,MTL,25,82,8,6,14
32,8482713,Mackie Samoskevich,R,FLA,22,82,8,6,14
32,8476822,Luke Glendening,C,TBL,35,82,6,8,14
32,8482166,Shakir Mukhamadullin,D,SJS,22,82,3,11,14
32,8480860,Kevin Bahl,D,NJD,24,82,2,12,14
32,8475179,Dmitry Kulikov,D,FLA,34,82,1,13,14
32,8475762,Derek Forbort,D,BOS,32,82,1,13,14
32,8476915,Jujhar Khaira,L,MIN,30,82,9,4,13
32,8477944,Jakub Vrana,L,STL,28,82,8,5,13
32,8473504,Cal Clutterbuck,R,NYI,37,82,6,7,13
32,8482762,Simon Edvinsson,D,DET,21,82,6,7,13
32,8480807,Mattias Samuelsson,D,BUF,24,82,5,8,13
32,8477015,Connor Brown,R,EDM,30,82,4,9,13
32,8483468,Jiri Kulich,C,BUF,20,82,4,9,13
32,8480879,Jacob Bernard-Docker,D,OTT,24,82,3,10,13
32,8478859,Niko Mikkola,D,FLA,28,82,3,10,13
32,8476467,Jamie Oleksiak,D,SEA,32,82,2,11,13
32,8479442,Troy Stecher,D,EDM,30,82,2,11,13
32,8484149,Gavin Brindley,C,CBJ,20,82,2,11,13
32,8482470,Ilya Solovyov,D,CGY,24,82,1,12,13
32,8483012,Logan Morrison,C,SEA,22,82,8,4,12
32,8473453,Trevor Lewis,C,LAK,37,82,6,6,12
32,8478013,Jake Walman,D,DET,28,82,5,7,12
32,8476902,Esa Lindell,D,DAL,30,82,4,8,12
32,8479324,Ryan Lindgren,D,NYR,26,82,1,11,12
32,8476525,Colin Miller,D,WPG,32,82,4,7,11
32,8477034,Jaycob Megna,D,CHI,32,82,4,7,11
32,8476858,Phillip Di Giuseppe,L,VAN,31,82,3,8,11
32,8478468,Jeremy Lauzon,D,NSH,27,82,3,8,11
32,8477508,Curtis Lazar,C,NJD,29,82,3,8,11
32,8476473,Connor Murphy,D,CHI,31,82,3,8,11
32,8474567,Zach Bogosian,D,MIN,34,82,2,9,11
32,8477335,Kyle Burroughs,D,SJS,29,82,2,9,11
32,8474009,Nick Bonino,C,NYR,36,82,1,10,11
32,8476331,Dylan DeMelo,D,WPG,31,82,1,10,11
32,8474013,Ian Cole,D,VAN,35,82,1,10,11
32,8483763,Maksymilian Szuber,D,ARI,22,82,5,5,10
32,8476278,Colin Blackwell,C,CHI,31,82,4,6,10
32,8477406,Mattias Janmark,C,EDM,32,82,4,6,10
32,8475177,Calvin de Haan,D,TBL,33,82,4,6,10
32,8482858,Ryker Evans,D,SEA,23,82,3,7,10
32,8482859,Zack Ostapchuk,C,OTT,21,82,2,8,10
32,8475825,Jani Hakanpää,D,DAL,32,82,2,8,10
32,8475188,Brayden McNabb,D,VGK,33,82,1,9,10
32,8482807,Ethan Del Mastro,D,CHI,21,82,1,9,10
32,8481578,Graeme Clarke,R,NJD,23,82,5,4,9
32,8480990,Declan Chisholm,D,MIN,24,82,4,5,9
32,8475462,Radko Gudas,D,ANA,34,82,3,6,9
32,8471677,Jack Johnson,D,COL,37,82,4,4,8
32,8481599,Victor Soderstrom,D,ARI,23,82,4,4,8
32,8481030,Jack St. Ivany,D,PIT,25,82,2,6,8
32,8483489,Fraser Minten,C,TOR,31,82,2,4,6
32,8482141,Lukas Cormier,D,VGK,22,0,0,0,0
32,8476988,Matt Benning,D,SJS,30,0,0,0,0
32,8480727,Zach Whitecloud,D,VGK,28,0,0,0,0
32,8480887,Jordan Harris,D,MTL,24,0,0,0,0
32,8478450,Parker Wotherspoon,D,BOS,27,0,0,0,0
32,8481812,Nikolai Knyzhov,D,SJS,27,0,0,0,0
32,8480001,Urho Vaakanainen,D,ANA,25,0,0,0,0
32,8482176,Wyatt Kaiser,D,CHI,22,0,0,0,0
32,8481122,Simon Benoit,D,TOR,26,0,0,0,0
32,8476441,Joel Edmundson,D,TOR,31,0,0,0,0
32,8480884,Calen Addison,D,SJS,24,0,0,0,0
32,8482511,Mason Lohrei,D,BOS,23,0,0,0,0
32,8482192,Isaak Phillips,D,CHI,23,0,0,0,0
32,8480950,Ilya Lyubushkin,D,TOR,30,0,0,0,0
32,8474031,Kevin Shattenkirk,D,BOS,35,0,0,0,0
32,8475718,Justin Holl,D,DET,32,0,0,0,0
32,8479402,Jake Bean,D,CBJ,26,0,0,0,0
32,8474602,Justin Schultz,D,SEA,34,0,0,0,0
32,8477950,Tony DeAngelo,D,CAR,29,0,0,0,0
32,8481743,Marc Del Gaizo,D,NSH,25,0,0,0,0
32,8481527,Kaedan Korczak,D,VGK,23,0,0,0,0
32,8480192,Johnathan Kovacevic,D,MTL,27,0,0,0,0
32,8476874,Olli Maatta,D,DET,30,0,0,0,0
32,8482144,Jack Thompson,D,SJS,22,0,0,0,0
32,8480222,Sebastian Aho,D,NYI,28,0,0,0,0
32,8479458,Nikita Zaitsev,D,CHI,33,0,0,0,0
32,8471709,Marc-Edouard Vlasic,D,SJS,37,0,0,0,0
32,8482929,Emil Lilleberg,D,TBL,23,0,0,0,0
32,8477018,Ben Hutton,D,VGK,31,0,0,0,0
32,8481056,Spencer Stastney,D,NSH,24,0,0,0,0
32,8481593,Jayden Struble,D,MTL,23,0,0,0,0
32,8479982,Conor Timmins,D,TOR,26,0,0,0,0
32,8474090,Brendan Smith,D,NJD,35,0,0,0,0
32,8482964,Arber Xhekaj,D,MTL,23,0,0,0,0
32,8480891,Michael Kesselring,D,ARI,24,0,0,0,0
32,8477938,Haydn Fleury,D,TBL,28,0,0,0,0
32,8481806,Louis Crevier,D,CHI,23,0,0,0,0
32,8471274,Alex Goligoski,D,MIN,39,0,0,0,0
32,8481600,Tobias Bjornfot,D,FLA,23,0,0,0,0
32,8475797,Jarred Tinordi,D,CHI,32,0,0,0,0
32,8481521,Ronnie Attard,D,PHI,25,0,0,0,0
32,8474612,Travis Hamonic,D,OTT,34,0,0,0,0
32,8479576,Vincent Desharnais,D,EDM,28,0,0,0,0
32,8480049,Dylan Samberg,D,WPG,25,0,0,0,0
32,8483619,Filip Roos,D,CHI,25,0,0,0,0
32,8474568,Luke Schenn,D,NSH,35,0,0,0,0
32,8480184,Gustav Lindstrom,D,ANA,26,0,0,0,0
32,8480070,Ian Mitchell,D,BOS,25,0,0,0,0
32,8480196,Jacob Bryson,D,BUF,27,0,0,0,0
32,8471686,Marc Staal,D,PHI,37,0,0,0,0
32,8477467,Gustav Olofsson,D,SEA,30,0,0,0,0
32,8478970,Jalen Chatfield,D,CAR,28,0,0,0,0
32,8479348,Kale Clague,D,BUF,26,0,0,0,0
32,8473446,Erik Johnson,D,PHI,36,0,0,0,0
32,8477462,Robert Hagg,D,ANA,29,0,0,0,0
32,8478454,Noah Juulsen,D,VAN,27,0,0,0,0
32,8477384,Josh Brown,D,ARI,30,0,0,0,0
32,8481708,Zac Jones,D,NYR,24,0,0,0,0
32,8481167,Brayden Pachal,D,CGY,25,0,0,0,0
32,8482067,Connor Mackey,D,NYR,28,0,0,0,0
32,8483460,David Jiricek,D,CBJ,21,0,0,0,0
32,8481701,Santeri Hatakka,D,NJD,23,0,0,0,0
32,8478021,William Lagesson,D,ANA,28,0,0,0,0
32,8477851,Jordan Oesterle,D,CGY,32,0,0,0,0
32,8478452,Caleb Jones,D,COL,27,0,0,0,0
32,8479984,Cal Foote,D,NJD,26,0,0,0,0
32,8479639,Dylan Coghlan,D,CAR,26,0,0,0,0
32,8480874,Adam Ginning,D,PHI,24,0,0,0,0
32,8479321,Lucas Johansen,D,WSH,27,0,0,0,0
32,8480878,Nils Lundkvist,D,DAL,24,0,0,0,0
32,8482165,Yan Kuznetsov,D,CGY,22,0,0,0,0
32,8484258,Sam Malinski,D,COL,26,0,0,0,0
32,8480157,Calle Rosen,D,STL,30,0,0,0,0
32,8484304,Uvis Balinskis,D,FLA,28,0,0,0,0
32,8479985,Cale Fleury,D,SEA,26,0,0,0,0
32,8479378,Logan Stanley,D,WPG,26,0,0,0,0
32,8477541,Dakota Mermis,D,MIN,30,0,0,0,0
32,8481609,Vladislav Kolyachonok,D,ARI,23,0,0,0,0
32,8480823,Alexander Alexeyev,D,WSH,25,0,0,0,0
32,8481679,Maxence Guenette,D,OTT,23,0,0,0,0
32,8481564,Ryan Johnson,D,BUF,23,0,0,0,0
32,8479376,Victor Mete,D,PHI,26,0,0,0,0
32,8484254,Akito Hirose,D,VAN,25,0,0,0,0
32,8482660,Kent Johnson,C,CBJ,22,0,0,0,0
32,8482149,Cole Perfetti,C,WPG,22,0,0,0,0
32,8477987,Ryan Donato,C,CHI,28,0,0,0,0
32,8475755,Alexander Petrovic,D,DAL,32,0,0,0,0
32,8477810,Joel Hanley,D,CGY,33,0,0,0,0
32,8474145,Robert Bortuzzo,D,NYI,35,0,0,0,0
32,8481161,Jake Christiansen,D,CBJ,25,0,0,0,0
32,8476884,Derrick Pouliot,D,DAL,30,0,0,0,0
32,8481716,Dmitri Voronkov,L,CBJ,24,0,0,0,0
32,8480084,Nick DeSimone,D,NJD,30,0,0,0,0
32,8475750,Jon Merrill,D,MIN,32,0,0,0,0
32,8479315,Joey Anderson,R,CHI,26,0,0,0,0
32,8478011,Louie Belpedio,D,PHI,28,0,0,0,0
32,8482451,Mikael Pyyhtia,L,CBJ,23,0,0,0,0
32,8481541,Samuel Bolduc,D,NYI,24,0,0,0,0
32,8482126,Emil Andrae,D,PHI,31,0,0,0,0
32,8474618,Marco Scandella,D,STL,34,0,0,0,0
32,8477244,Chad Ruhwedel,D,NYR,34,0,0,0,0
32,8477971,Andreas Englund,D,LAK,28,0,0,0,0
32,8480829,Jesperi Kotkaniemi,C,CAR,24,0,0,0,0
32,8479372,Josh Mahura,D,FLA,26,0,0,0,0
32,8482095,Tyler Kleven,D,OTT,22,0,0,0,0
32,8481719,Maxwell Crozier,D,TBL,24,0,0,0,0
32,8475855,Jesper Fast,R,CAR,33,0,0,0,0
32,8480848,Ty Dellandrea,C,DAL,24,0,0,0,0
32,8475193,Tomas Tatar,L,SEA,34,0,0,0,0
32,8476889,Radek Faksa,C,DAL,30,0,0,0,0
32,8478495,Denis Gurianov,R,PHI,27,0,0,0,0
32,8480216,Jacob Peterson,C,SJS,25,0,0,0,0
32,8480252,Cole Guttman,C,CHI,25,0,0,0,0
32,8479026,Philippe Myers,D,TBL,27,0,0,0,0
32,8481006,Tyler Tucker,D,STL,24,0,0,0,0
32,8481032,Paul Cotter,C,VGK,25,0,0,0,0
32,8481577,Philip Tomasino,C,NSH,23,0,0,0,0
32,8476918,Jimmy Vesey,L,NYR,31,0,0,0,0
32,8479320,Max Lajoie,D,TOR,27,0,0,0,0
32,8478017,Mark Friedman,D,VAN,29,0,0,0,0
32,8481754,Nikita Nesterenko,C,ANA,23,0,0,0,0
32,8483407,Brandon Scanlin,D,NYR,25,0,0,0,0
32,8482659,Josh Doan,R,ARI,22,0,0,0,0
32,8477446,Michael McCarron,R,NSH,29,0,0,0,0
32,8477903,Garnet Hathaway,R,PHI,33,0,0,0,0
32,8482153,Brendan Brisson,C,VGK,23,0,0,0,0
32,8483546,Marshall Rifai,D,TOR,26,0,0,0,0
32,8484287,Cole McWard,D,VAN,23,0,0,0,0
32,8478854,Ryan Shea,D,PIT,27,0,0,0,0
32,8481585,Egor Afanasyev,L,NSH,23,0,0,0,0
32,8483398,Declan Carlile,D,TBL,31,0,0,0,0
32,8478502,Dennis Gilbert,D,CGY,28,0,0,0,0
32,8482749,Joshua Roy,R,MTL,21,0,0,0,0
32,8481598,Philip Broberg,D,EDM,23,0,0,0,0
32,8480835,Jack Drury,C,CAR,24,0,0,0,0
32,8480748,Kiefer Sherwood,L,NSH,29,0,0,0,0
32,8476934,Brock McGinn,L,ANA,30,0,0,0,0
32,8480870,Bo Groulx,C,ANA,24,0,0,0,0
32,8479368,Max Jones,L,ANA,26,0,0,0,0
32,8478099,Kevin Labanc,R,SJS,29,0,0,0,0
32,8478067,Oskar Lindblom,L,SJS,28,0,0,0,0
32,8476393,Nick Cousins,C,FLA,31,0,0,0,0
32,8483395,Arshdeep Bains,L,VAN,23,0,0,0,0
32,8480762,Eric Robinson,L,BUF,29,0,0,0,0
32,8479439,Jacob MacDonald,D,SJS,31,0,0,0,0
32,8476474,Stefan Noesen,R,CAR,31,0,0,0,0
32,8482787,Nikita Chibrikov,R,WPG,31,0,0,0,0
32,8478432,Christian Fischer,R,DET,27,0,0,0,0
32,8477979,Nicolas Aube-Kubel,R,WSH,28,0,0,0,0
32,8481789,Tye Kartye,L,SEA,23,0,0,0,0
32,8479330,Brandon Gignac,C,MTL,27,0,0,0,0
32,8480075,Cameron Crotty,D,ARI,25,0,0,0,0
32,8473473,Milan Lucic,L,BOS,36,0,0,0,0
32,8482094,Daemon Hunt,D,MIN,22,0,0,0,0
32,8481206,John Ludvig,D,PIT,24,0,0,0,0
32,8483630,Pavol Regenda,L,ANA,25,0,0,0,0
32,8481617,Vasily Podkolzin,R,VAN,23,0,0,0,0
32,8480306,Grant Hutton,D,NYI,29,0,0,0,0
32,8480995,Pontus Holmberg,R,TOR,25,0,0,0,0
32,8482148,Hendrix Lapierre,C,WSH,22,0,0,0,0
32,8477478,William Carrier,L,VGK,30,0,0,0,0
32,8480003,Jesper Boqvist,C,BOS,26,0,0,0,0
32,8482172,Landon Slaggert,L,CHI,22,0,0,0,0
32,8480789,Oliver Wahlstrom,R,NYI,24,0,0,0,0
32,8474062,Riley Nash,C,NYR,35,0,0,0,0
32,8480021,Jack Studnicka,C,SJS,25,0,0,0,0
32,8480025,MacKenzie Entwistle,R,CHI,25,0,0,0,0
32,8481582,Nicholas Robertson,L,TOR,23,0,0,0,0
32,8476867,Brendan Gaunce,C,CBJ,30,0,0,0,0
32,8479619,Michael Carcone,L,ARI,28,0,0,0,0
32,8479370,Tyson Jost,C,BUF,26,0,0,0,0
32,8479671,Mathieu Olivier,R,CBJ,27,0,0,0,0
32,8476994,Vinnie Hinostroza,C,PIT,30,0,0,0,0
32,8482070,Mitchell Chaffee,R,TBL,26,0,0,0,0
32,8477473,Justin Bailey,R,SJS,29,0,0,0,0
32,8479344,Jesse Puljujarvi,R,PIT,26,0,0,0,0
32,8480205,Emil Bemstrom,C,PIT,25,0,0,0,0
32,8479718,Alex Barré-Boulet,C,TBL,27,0,0,0,0
32,8482061,Brandon Biro,L,BUF,26,0,0,0,0
32,8479638,Justin Brazeau,R,BOS,26,0,0,0,0
32,8474040,Sam Gagner,C,EDM,35,0,0,0,0
32,8477846,Ryan Carpenter,C,SJS,33,0,0,0,0
32,8482077,Dylan Holloway,L,EDM,23,0,0,0,0
32,8482157,Will Cuylle,L,NYR,22,0,0,0,0
32,8480007,Jonas Rondbjerg,R,VGK,25,0,0,0,0
32,8478874,Adam Gaudette,C,STL,28,0,0,0,0
32,8478434,Keegan Kolesar,R,VGK,27,0,0,0,0
32,8480441,Trey Fix-Wolansky,R,CBJ,25,0,0,0,0
32,8479994,Jaret Anderson-Dolan,C,NSH,25,0,0,0,0
32,8483567,Georgii Merkulov,C,BOS,24,0,0,0,0
32,8477380,Jonny Brodzinski,C,NYR,31,0,0,0,0
32,8482201,Gage Goncalves,C,TBL,23,0,0,0,0
32,8478211,Dryden Hunt,L,CGY,29,0,0,0,0
32,8471699,Andrew Cogliano,C,COL,37,0,0,0,0
32,8479421,Jacob Moverare,D,LAK,26,0,0,0,0
32,8478881,Brett Seney,L,CHI,28,0,0,0,0
32,8477464,Nic Petan,C,MIN,29,0,0,0,0
32,8475958,Michael Sgarbossa,C,WSH,32,0,0,0,0
32,8481147,Reese Johnson,C,CHI,26,0,0,0,0
32,8479336,Carl Grundstrom,R,LAK,27,0,0,0,0
32,8480853,Liam Foudy,C,NSH,24,0,0,0,0
32,8479522,Hardy Haman Aktell,D,WSH,26,0,0,0,0
32,8481462,Mason Morelli,L,VGK,28,0,0,0,0
32,8482102,Vasily Ponomarev,C,CAR,22,0,0,0,0
32,8480844,Grigori Denisenko,L,VGK,24,0,0,0,0
32,8479944,Zach Aston-Reese,C,DET,30,0,0,0,0
32,8482784,Zach Dean,C,STL,21,0,0,0,0
32,8479419,Brett Murray,L,BUF,26,0,0,0,0
32,8479520,Brandon Duhaime,R,COL,27,0,0,0,0
32,8477573,Nathan Walker,L,STL,30,0,0,0,0
32,8478078,Rourke Chartier,C,OTT,28,0,0,0,0
32,8475795,Dylan McIlrath,D,WSH,32,0,0,0,0
32,8482496,Nils Aman,C,VAN,24,0,0,0,0
32,8480289,Morgan Barron,C,WPG,26,0,0,0,0
32,8481751,Lukas Rousek,R,BUF,25,0,0,0,0
32,8480011,Klim Kostin,C,SJS,25,0,0,0,0
32,8481556,John Beecher,C,BOS,23,0,0,0,0
32,8475278,Byron Froese,C,VGK,33,0,0,0,0
32,8475225,Craig Smith,C,DAL,35,0,0,0,0
32,8484326,Patrik Koch,D,ARI,28,0,0,0,0
32,8477930,Pierre-Edouard Bellemare,L,SEA,39,0,0,0,0
32,8478409,Anthony Richard,C,BOS,28,0,0,0,0
32,8481024,Linus Karlsson,C,VAN,25,0,0,0,0
32,8479986,Kole Lind,R,SEA,26,0,0,0,0
32,8479414,Nathan Bastian,R,NJD,27,0,0,0,0
32,8479362,Riley Tufte,L,COL,26,0,0,0,0
32,8481058,Jesse Ylönen,R,MTL,25,0,0,0,0
32,8482476,Emil Heineman,L,MTL,23,0,0,0,0
32,8482861,Vincent Iorio,D,WSH,22,0,0,0,0
32,8483432,Luca Del Bel Belluz,C,CBJ,31,0,0,0,0
32,8482744,James Malatesta,L,CBJ,21,0,0,0,0
32,8477887,Patrick Brown,C,BOS,32,0,0,0,0
32,8478585,Derek Ryan,C,EDM,38,0,0,0,0
32,8481441,Joe Snively,C,WSH,28,0,0,0,0
32,8481592,Jakob Pelletier,L,CGY,23,0,0,0,0
32,8482634,Alex Steeves,C,TOR,25,0,0,0,0
32,8477126,Jayson Megna,C,BOS,34,0,0,0,0
32,8475752,Tyler Pitlick,C,NYR,33,0,0,0,0
32,8480008,Adam Ruzicka,C,ARI,25,0,0,0,0
32,8481065,Angus Crookshank,L,OTT,25,0,0,0,0
32,8479547,Matthew Phillips,R,WSH,26,0,0,0,0
32,8480226,Marián Studenic,R,SEA,26,0,0,0,0
32,8481237,Kyle MacLean,C,NYI,25,0,0,0,0
32,8475413,Justin Dowling,C,NJD,34,0,0,0,0
32,8481641,Joel Kiviranta,L,COL,28,0,0,0,0
32,8478104,Sammy Blais,L,STL,28,0,0,0,0
32,8477454,Adam Erne,L,EDM,29,0,0,0,0
32,8481518,Nolan Foote,L,NJD,24,0,0,0,0
32,8480245,Olle Lycksell,R,PHI,25,0,0,0,0
32,8483570,Ben Meyers,C,ANA,26,0,0,0,0
32,8480776,Sheldon Rempal,R,VGK,29,0,0,0,0
32,8483920,Pierrick Dube,R,WSH,23,0,0,0,0
32,8480267,Sammy Walker,C,MIN,25,0,0,0,0
32,8482747,Brennan Othmann,L,NYR,21,0,0,0,0
32,8479991,Jake Leschyshyn,C,NYR,25,0,0,0,0
32,8478400,Colin White,C,MTL,27,0,0,0,0
32,8479328,Julien Gauthier,R,NYI,27,0,0,0,0
32,8484325,Waltteri Merela,C,TBL,26,0,0,0,0
32,8479066,Ryan Lomberg,L,FLA,30,0,0,0,0
32,8477070,Liam O'Brien,C,ARI,30,0,0,0,0
32,8478146,Matthew Highmore,C,OTT,28,0,0,0,0
32,8478028,Fredrik Olofsson,L,COL,28,0,0,0,0
32,8480880,Jakub Lauko,C,BOS,24,0,0,0,0
32,8479968,Vinni Lettieri,C,MIN,29,0,0,0,0
32,8474709,Matt Martin,L,NYI,35,0,0,0,0
32,8480845,Rasmus Kupari,C,WPG,24,0,0,0,0
32,8481550,Adam Beckman,L,MIN,23,0,0,0,0
32,8481422,Jacob Lucchini,C,MIN,29,0,0,0,0
32,8477401,John Hayden,C,SEA,29,0,0,0,0
32,8478904,Steven Lorentz,C,FLA,28,0,0,0,0
32,8482088,Justin Sourdif,R,FLA,22,0,0,0,0
32,8482751,Ryan Winterton,C,SEA,21,0,0,0,0
32,8482241,Radim Zohorna,L,PIT,28,0,0,0,0
32,8481690,Tyler Angle,C,CBJ,24,0,0,0,0
32,8476952,Dominic Toninato,C,WPG,30,0,0,0,0
32,8476919,Chris Tierney,C,NJD,30,0,0,0,0
32,8480032,Shane Bowers,C,NJD,25,0,0,0,0
32,8484314,Jiri Smejkal,L,OTT,28,0,0,0,0
32,8481239,Samuel Fagemo,L,LAK,24,0,0,0,0
32,8481532,Alex Turcotte,C,LAK,23,0,0,0,0
32,8481019,David Gustafsson,C,WPG,24,0,0,0,0
32,8478477,Mitchell Stephens,C,MTL,27,0,0,0,0
32,8479546,Oskar Steen,C,BOS,26,0,0,0,0
32,8480292,Carson Meyer,R,CBJ,27,0,0,0,0
32,8478446,Glenn Gawdin,C,ANA,27,0,0,0,0
32,8483531,Brian Halonen,L,NJD,25,0,0,0,0
32,8477149,Scott Sabourin,R,SJS,32,0,0,0,0
32,8479972,Mason Shaw,C,MIN,26,0,0,0,0
32,8480890,Jan Jenik,R,ARI,24,0,0,0,0
32,8478051,Max Willman,C,NJD,29,0,0,0,0
32,8480851,Akil Thomas,C,LAK,24,0,0,0,0
32,8482765,Isak Rosen,R,BUF,21,0,0,0,0
32,8478421,A.J. Greer,L,CGY,28,0,0,0,0
32,8478512,Austin Czarnik,C,DET,32,0,0,0,0
32,8479536,Axel Jonsson-Fjallby,L,WPG,26,0,0,0,0
32,8477320,Anton Blidh,L,NYR,29,0,0,0,0
32,8481543,Nikita Alexandrov,C,STL,24,0,0,0,0
32,8475235,Nicolas Deslauriers,L,PHI,33,0,0,0,0
32,8481070,Hugh McGing,L,STL,26,0,0,0,0
32,8480836,Jonathan Gruden,C,PIT,24,0,0,0,0
32,8481591,Sam Poulin,R,PIT,23,0,0,0,0
32,8477962,Brendan Lemieux,L,CAR,28,0,0,0,0
32,8483401,Marc Johnstone,R,PIT,28,0,0,0,0
32,8482250,Callahan Burke,C,CAR,27,0,0,0,0
32,8481726,Adam Edstrom,C,NYR,24,0,0,0,0
32,8471817,Ryan Reaves,R,TOR,37,0,0,0,0
32,8479587,Rhett Gardner,C,PHI,28,0,0,0,0
32,8475766,Austin Watson,L,TBL,32,0,0,0,0
32,8479367,William Lockwood,R,FLA,26,0,0,0,0
32,8478424,Jansen Harkins,C,PIT,27,0,0,0,0
32,8476913,Devin Shore,C,SEA,30,0,0,0,0
32,8482652,Walker Duehr,R,CGY,27,0,0,0,0
32,8477527,Ross Johnston,L,ANA,30,0,0,0,0
32,8481077,John Leonard,L,ARI,26,0,0,0,0
32,8483549,Lucas Condotta,L,MTL,27,0,0,0,0
32,8480468,James Hamblin,L,EDM,25,0,0,0,0
32,8476907,Mackenzie MacEachern,L,STL,30,0,0,0,0
32,8479543,Michael Pezzetta,L,MTL,26,0,0,0,0
32,8480355,Mark Kastelic,C,OTT,25,0,0,0,0
32,8482162,Roby Jarventie,L,OTT,22,0,0,0,0
32,8479772,Zack MacEwen,R,OTT,28,0,0,0,0
32,8483597,Milos Kelemen,L,ARI,25,0,0,0,0
32,8479379,Givani Smith,R,SJS,26,0,0,0,0
32,8481655,Cole Schwindt,R,CGY,23,0,0,0,0
32,8479981,Jonah Gadjovich,L,FLA,26,0,0,0,0
32,8482147,Jean-Luc Foudy,C,COL,22,0,0,0,0
32,8484255,Jason Polin,R,COL,25,0,0,0,0
32,8477993,Justin Kirkland,C,ARI,28,0,0,0,0
32,8479249,Andrew Poturalski,C,SEA,30,0,0,0,0
32,8482197,Adam Raska,R,MIN,23,0,0,0,0
32,8475780,Chris Wagner,R,COL,33,0,0,0,0
32,8479533,Joona Koppanen,L,PIT,26,0,0,0,0
32,8481534,Raphael Lavoie,C,EDM,24,0,0,0,0
32,8484321,Nikolas Matinpalo,D,OTT,26,0,0,0,0
32,8481043,Cole Koepke,L,TBL,26,0,0,0,0
32,8476323,Max McCormick,L,SEA,32,0,0,0,0
32,8483609,Adam Klapka,R,CGY,24,0,0,0,0
32,8483512,Matt Savoie,C,BUF,20,0,0,0,0
32,8484259,Ondrej Pavel,C,COL,31,0,0,0,0
32,8478147,Bokondji Imama,L,OTT,28,0,0,0,0
32,8482460,Matt Rempe,C,NYR,22,0,0,0,0
32,8477073,Kurtis MacDermid,L,NJD,30,0,0,0,0
32,8480274,Philip Kemp,D,EDM,25,0,0,0,0
32,8478956,Samuel Laberge,L,NJD,27,0,0,0,0
32,8483045,Cameron Butler,R,CBJ,31,0,0,0,0
33,8476453,Nikita Kucherov,R,TBL,31,82,38,85,123
33,8478402,Connor McDavid,C,EDM,27,82,43,76,119
33,8477956,David Pastrnak,R,BOS,28,82,40,70,110
33,8479318,Auston Matthews,C,TOR,27,82,67,41,108
33,8476887,Filip Forsberg,L,NSH,30,82,49,51,100
33,8481559,Jack Hughes,C,NJD,23,82,37,54,91
33,8477939,William Nylander,R,TOR,28,82,36,55,91
33,8475166,John Tavares,C,TOR,34,82,34,57,91
33,8479314,Matthew Tkachuk,L,FLA,27,82,30,61,91
33,8480801,Brady Tkachuk,L,OTT,25,82,42,48,90
33,8480027,Jason Robertson,L,DAL,25,82,37,53,90
33,8480023,Robert Thomas,C,STL,25,82,24,66,90
33,8476346,Johnny Gaudreau,L,CBJ,31,82,24,66,90
33,8476468,J.T. Miller,C,VAN,31,82,43,46,89
33,8477946,Dylan Larkin,C,DET,28,82,41,47,88
33,8478550,Artemi Panarin,L,NYR,33,82,33,55,88
33,8478864,Kirill Kaprizov,L,MIN,27,82,38,49,87
33,8482116,Tim Stützle,C,OTT,22,82,33,54,87
33,8478420,Mikko Rantanen,R,COL,28,82,33,51,84
33,8480800,Quinn Hughes,D,VAN,25,82,12,72,84
33,8477492,Nathan MacKinnon,C,COL,29,82,35,48,83
33,8477934,Leon Draisaitl,C,EDM,29,82,31,52,83
33,8478010,Brayden Point,C,TBL,28,82,39,42,81
33,8480012,Elias Pettersson,C,VAN,26,82,36,44,80
33,8479343,Clayton Keller,R,ARI,26,82,35,45,80
33,8474564,Steven Stamkos,C,TBL,34,82,36,43,79
33,8481557,Matt Boldy,L,MIN,23,82,36,43,79
33,8478427,Sebastian Aho,C,CAR,27,82,37,40,77
33,8478873,Troy Terry,R,ANA,27,82,33,44,77
33,8479407,Jesper Bratt,L,NJD,26,82,32,44,76
33,8480069,Cale Makar,D,COL,26,82,25,51,76
33,8477404,Jake Guentzel,C,CAR,30,82,36,39,75
33,8478403,Jack Eichel,C,VGK,28,82,31,44,75
33,8481523,Kirby Dach,C,MTL,23,82,12,63,75
33,8480018,Nick Suzuki,C,MTL,25,82,34,40,74
33,8479337,Alex DeBrincat,R,DET,27,82,24,50,74
33,8476459,Mika Zibanejad,C,NYR,31,82,23,51,74
33,8478398,Kyle Connor,L,WPG,28,82,38,35,73
33,8473419,Brad Marchand,L,BOS,36,82,23,50,73
33,8476454,Ryan Nugent-Hopkins,C,EDM,31,82,20,53,73
33,8474600,Roman Josi,D,NSH,34,82,20,52,72
33,8475786,Zach Hyman,L,EDM,32,82,44,27,71
33,8476389,Vincent Trocheck,C,NYR,31,82,23,48,71
33,8477402,Pavel Buchnevich,L,STL,29,82,31,39,70
33,8471215,Evgeni Malkin,C,PIT,38,82,29,41,70
33,8480865,Noah Dobson,D,NYI,24,82,21,49,70
33,8482078,Lucas Raymond,L,DET,22,82,36,33,69
33,8479542,Brandon Hagel,L,TBL,26,82,31,38,69
33,8477933,Sam Reinhart,C,FLA,29,82,29,40,69
33,8477493,Aleksander Barkov,C,FLA,29,82,25,44,69
33,8477951,Nick Schmaltz,C,ARI,28,82,25,44,69
33,8480002,Nico Hischier,C,NJD,25,82,24,45,69
33,8477942,Kevin Fiala,L,LAK,28,82,23,46,69
33,8478445,Mathew Barzal,C,NYI,27,82,20,49,69
33,8475184,Chris Kreider,L,NYR,33,82,39,28,67
33,8475167,Victor Hedman,D,TBL,34,82,10,57,67
33,8475692,Mats Zuccarello,R,MIN,37,82,14,52,66
33,8477949,Alex Tuch,R,BUF,28,82,23,42,65
33,8482097,Jack Quinn,R,BUF,23,82,22,43,65
33,8479385,Jordan Kyrou,C,STL,26,82,21,44,65
33,8474578,Erik Karlsson,D,PIT,34,82,11,54,65
33,8480208,Drake Batherson,R,OTT,26,82,30,34,64
33,8471675,Sidney Crosby,C,PIT,37,82,24,40,64
33,8476460,Mark Scheifele,C,WPG,31,82,31,32,63
33,8478439,Travis Konecny,R,PHI,27,82,30,33,63
33,8477409,Carter Verhaeghe,C,FLA,29,82,28,35,63
33,8476881,Tomas Hertl,C,VGK,31,82,28,35,63
33,8476539,Jonathan Marchessault,R,VGK,34,82,27,36,63
33,8476853,Morgan Rielly,D,TOR,30,82,11,52,63
33,8479420,Tage Thompson,C,BUF,27,82,29,33,62
33,8478493,Joel Eriksson Ek,C,MIN,27,82,27,35,62
33,8471685,Anze Kopitar,C,LAK,37,82,21,41,62
33,8480036,Miro Heiskanen,D,DAL,25,82,11,51,62
33,8478042,Viktor Arvidsson,R,LAK,31,82,25,36,61
33,8475172,Nazem Kadri,C,CGY,34,82,19,42,61
33,8478366,Frank Vatrano,R,ANA,30,82,32,28,60
33,8478414,Timo Meier,R,NJD,28,82,31,29,60
33,8477497,Sean Monahan,C,WPG,30,82,23,37,60
33,8477476,Artturi Lehkonen,L,COL,29,82,30,29,59
33,8475784,Jeff Skinner,C,BUF,32,82,28,31,59
33,8475754,Brock Nelson,C,NYI,33,82,28,31,59
33,8476905,Chandler Stephenson,C,VGK,30,82,20,39,59
33,8475798,Mikael Granlund,C,SJS,32,82,19,40,59
33,8475170,Brayden Schenn,C,STL,33,82,19,40,59
33,8476456,Jonathan Huberdeau,C,CGY,31,82,16,43,59
33,8474590,John Carlson,D,WSH,34,82,13,46,59
33,8478407,Vince Dunn,D,SEA,28,82,11,48,59
33,8477447,Shea Theodore,D,VGK,29,82,8,51,59
33,8474102,David Perron,L,DET,36,82,27,31,58
33,8479425,Filip Hronek,D,VAN,27,82,8,50,58
33,8479410,Mikhail Sergachev,D,TBL,26,82,6,52,58
33,8478444,Brock Boeser,R,VAN,27,82,29,28,57
33,8475810,Bryan Rust,R,PIT,32,82,26,31,57
33,8479339,Patrik Laine,L,CBJ,26,82,25,32,57
33,8480830,Andrei Svechnikov,R,CAR,24,82,20,37,57
33,8479325,Charlie McAvoy,D,BOS,27,82,10,47,57
33,8477504,Josh Morrissey,D,WPG,29,82,6,51,57
33,8477500,Bo Horvat,C,NYI,29,82,25,31,56
33,8476448,William Karlsson,C,VGK,31,82,25,31,56
33,8474150,Mikael Backlund,C,CGY,35,82,21,35,56
33,8477501,Valeri Nichushkin,R,COL,29,82,23,32,55
33,8478440,Dylan Strome,C,WSH,27,82,23,32,55
33,8470794,Joe Pavelski,C,DAL,40,82,21,34,55
33,8474141,Patrick Kane,R,DET,36,82,21,34,55
33,8473986,Alex Killorn,L,ANA,35,82,20,35,55
33,8473512,Claude Giroux,R,OTT,36,82,15,40,55
33,8478047,Michael Bunting,L,PIT,29,82,24,30,54
33,8477496,Elias Lindholm,C,VAN,30,82,20,34,54
33,8480798,Philipp Kurashev,C,CHI,25,82,15,39,54
33,8477503,Max Domi,C,TOR,29,82,13,41,54
33,8478449,Roope Hintz,C,DAL,28,82,33,20,53
33,8477407,Anthony Duclair,L,TBL,29,82,30,23,53
33,8477960,Adrian Kempe,R,LAK,28,82,25,28,53
33,8482159,Tyson Foerster,R,PHI,22,82,24,29,53
33,8477479,Tyler Bertuzzi,L,TOR,29,82,19,34,53
33,8476875,Mike Matheson,D,MTL,30,82,12,41,53
33,8479323,Adam Fox,D,NYR,26,82,11,42,53
33,8482745,Mason McTavish,C,ANA,21,82,18,34,52
33,8482684,Luke Hughes,D,NJD,21,82,14,38,52
33,8478472,Mathieu Joseph,R,OTT,27,82,14,38,52
33,8475168,Matt Duchene,C,DAL,33,82,24,27,51
33,8479423,Alex Nylander,L,CBJ,26,82,23,28,51
33,8480039,Martin Necas,C,CAR,25,82,19,32,51
33,8478519,Anthony Cirelli,C,TBL,27,82,19,32,51
33,8481528,Dylan Cozens,C,BUF,23,82,19,32,51
33,8481711,Matias Maccelli,L,ARI,24,82,14,37,51
33,8478396,Noah Hanifin,D,VGK,27,82,10,41,51
33,8471724,Kris Letang,D,PIT,37,82,5,46,51
33,8481540,Cole Caufield,R,MTL,23,82,28,22,50
33,8481068,Yegor Sharangovich,C,CGY,26,82,27,23,50
33,8475151,Kyle Palmieri,C,NYI,33,82,25,25,50
33,8475765,Vladimir Tarasenko,R,FLA,33,82,24,26,50
33,8475745,Charlie Coyle,C,BOS,32,82,18,32,50
33,8478460,Zach Werenski,D,CBJ,27,82,15,35,50
33,8480064,Josh Norris,C,OTT,25,82,28,21,49
33,8477935,Sam Bennett,C,FLA,28,82,26,23,49
33,8479400,Pierre-Luc Dubois,L,LAK,26,82,23,26,49
33,8482110,Dawson Mercer,C,NJD,23,82,23,26,49
33,8482093,Seth Jarvis,C,CAR,22,82,21,28,49
33,8476882,Teuvo Teravainen,L,CAR,30,82,21,28,49
33,8482055,Drew O'Connor,L,PIT,26,82,21,28,49
33,8484144,Connor Bedard,C,CHI,19,82,20,29,49
33,8477451,Ryan Hartman,R,MIN,30,82,18,31,49
33,8480031,Maxime Comtois,L,CAR,25,82,16,33,49
33,8476792,Torey Krug,D,STL,33,82,9,40,49
33,8478397,Rasmus Andersson,D,CGY,28,82,2,47,49
33,8475726,Tyler Toffoli,C,WPG,32,82,24,24,48
33,8477021,Alex Kerfoot,C,ARI,30,82,22,26,48
33,8478462,Nicolas Roy,C,VGK,27,82,16,32,48
33,8482124,Quinton Byfield,R,LAK,22,82,15,33,48
33,8476462,Dougie Hamilton,D,NJD,31,82,13,35,48
33,8478975,Mason Marchment,L,DAL,29,82,11,37,48
33,8475913,Mark Stone,R,VGK,32,82,27,20,47
33,8480078,Filip Chytil,C,NYR,25,82,22,25,47
33,8474679,Gustav Nyquist,C,NSH,35,82,21,26,47
33,8475158,Ryan O'Reilly,C,NSH,33,82,21,26,47
33,8477955,Jared McCann,L,SEA,28,82,17,30,47
33,8475149,Marcus Johansson,L,MIN,34,82,17,30,47
33,8476869,Brady Skjei,D,CAR,30,82,12,35,47
33,8480803,Evan Bouchard,D,EDM,25,82,7,40,47
33,8481542,Moritz Seider,D,DET,23,82,6,41,47
33,8479675,Trevor Moore,L,LAK,29,82,20,26,46
33,8475197,Tyson Barrie,D,NSH,33,82,8,38,46
33,8476880,Tom Wilson,R,WSH,30,82,24,21,45
33,8475768,Jaden Schwartz,C,SEA,32,82,23,22,45
33,8471698,T.J. Oshie,R,WSH,38,82,19,26,45
33,8474641,Adam Henrique,C,EDM,34,82,19,26,45
33,8475794,Tyler Seguin,C,DAL,32,82,18,27,45
33,8475744,Evgeny Kuznetsov,C,CAR,32,82,15,30,45
33,8477495,Seth Jones,D,CHI,30,82,14,31,45
33,8478038,Devon Toews,D,COL,30,82,11,34,45
33,8483457,Lane Hutson,D,MTL,20,82,7,38,45
33,8479999,Casey Mittelstadt,C,COL,26,82,6,39,45
33,8480014,Gabriel Vilardi,C,WPG,25,82,28,16,44
33,8482089,Jake Neighbours,L,STL,22,82,27,17,44
33,8477944,Jakub Vrana,L,STL,28,82,27,17,44
33,8475169,Evander Kane,L,EDM,33,82,24,20,44
33,8471214,Alex Ovechkin,L,WSH,39,82,19,25,44
33,8479992,Michael Rasmussen,C,DET,25,82,19,25,44
33,8476925,Colton Sissons,C,NSH,31,82,17,27,44
33,8477948,Travis Sanheim,D,PHI,28,82,14,30,44
33,8482705,Cole Sillinger,C,CBJ,21,82,13,31,44
33,8481533,Trevor Zegras,C,ANA,23,82,12,32,44
33,8475906,John Klingberg,D,TOR,32,82,6,38,44
33,8476483,Rickard Rakell,R,PIT,31,82,26,17,43
33,8481596,Shane Pinto,C,OTT,24,82,20,23,43
33,8477511,Anthony Mantha,R,VGK,30,82,20,23,43
33,8474870,Tyler Johnson,C,CHI,34,82,20,23,43
33,8482740,Wyatt Johnston,C,DAL,21,82,17,26,43
33,8479365,Trent Frederic,C,BOS,26,82,17,26,43
33,8478413,Jordan Greenway,L,BUF,27,82,17,26,43
33,8476906,Shayne Gostisbehere,D,DET,31,82,4,39,43
33,8480015,Owen Tippett,R,PHI,25,82,22,20,42
33,8477952,Robby Fabbri,C,DET,28,82,21,21,42
33,8474586,Jordan Eberle,R,SEA,34,82,19,23,42
33,8476826,Yanni Gourde,C,SEA,33,82,15,27,42
33,8478498,Jake DeBrusk,L,BOS,28,82,25,16,41
33,8476432,Boone Jenner,C,CBJ,31,82,25,16,41
33,8481604,Pavel Dorofeyev,L,VGK,24,82,22,19,41
33,8475714,Calle Jarnkrok,C,TOR,33,82,22,19,41
33,8475848,Brendan Gallagher,R,MTL,32,82,20,21,41
33,8477456,J.T. Compher,L,DET,29,82,18,23,41
33,8476479,Phillip Danault,C,LAK,31,82,16,25,41
33,8478401,Pavel Zacha,C,BOS,27,82,14,27,41
33,8478438,Tommy Novak,C,NSH,27,82,13,28,41
33,8480839,Rasmus Dahlin,D,BUF,24,82,10,31,41
33,8483445,Cutter Gauthier,L,ANA,20,82,9,32,41
33,8477346,MacKenzie Weegar,D,CGY,30,82,8,33,41
33,8482109,Alexis Lafrenière,L,NYR,23,82,25,15,40
33,8478458,Jack Roslovic,C,NYR,27,82,16,24,40
33,8482113,Anton Lundell,C,FLA,23,82,15,25,40
33,8480028,Morgan Frost,C,PHI,25,82,13,27,40
33,8482122,Brock Faber,D,MIN,22,82,10,30,40
33,8481013,Jonatan Berggren,R,DET,24,82,10,30,40
33,8475753,Justin Faulk,D,STL,32,82,5,35,40
33,8474157,Max Pacioretty,L,WSH,36,82,22,17,39
33,8478466,Daniel Sprong,R,DET,27,82,20,19,39
33,8477940,Nikolaj Ehlers,L,WPG,28,82,18,21,39
33,8482665,Matty Beniers,C,SEA,22,82,15,24,39
33,8482624,Daniil Miromanov,D,CGY,27,82,13,26,39
33,8480434,Sean Durzi,D,ARI,26,82,12,27,39
33,8470613,Brent Burns,D,CAR,39,82,10,29,39
33,8475764,Cam Fowler,D,ANA,33,82,6,33,39
33,8481016,Ruslan Iskhakov,C,NYI,24,82,6,33,39
33,8481699,Aku Raty,R,ARI,23,82,2,37,39
33,8479941,Justin Danforth,R,CBJ,31,82,20,18,38
33,8480797,Joel Farabee,L,PHI,24,82,18,20,38
33,8477426,Nicholas Paul,L,TBL,29,82,16,22,38
33,8479525,Ross Colton,C,COL,28,82,15,23,38
33,8479345,Jakob Chychrun,D,OTT,26,82,13,25,38
33,8477986,Brandon Montour,D,FLA,30,82,13,25,38
33,8475314,Anders Lee,L,NYI,34,82,26,11,37
33,8480188,Fabian Zetterlund,L,SJS,25,82,25,12,37
33,8481560,Arthur Kaliyev,R,LAK,23,82,23,14,37
33,8478474,Lawson Crouse,L,ARI,27,82,20,17,37
33,8483808,Andrei Kuzmenko,L,CGY,28,82,18,19,37
33,8482475,Yegor Chinakhov,R,CBJ,23,82,17,20,37
33,8480849,Barrett Hayton,C,ARI,24,82,17,20,37
33,8471218,Blake Wheeler,R,NYR,38,82,16,21,37
33,8476885,Jacob Trouba,D,NYR,30,82,13,24,37
33,8482133,Thomas Bordeleau,C,SJS,22,82,12,25,37
33,8482667,William Eklund,L,SJS,22,82,10,27,37
33,8482105,Jake Sanderson,D,OTT,22,82,8,29,37
33,8478115,Pierre Engvall,L,NYI,28,82,18,18,36
33,8475799,Nino Niederreiter,R,WPG,32,82,16,20,36
33,8476399,Blake Coleman,C,CGY,33,82,15,21,36
33,8478057,Dakota Joshua,C,VAN,28,82,15,21,36
33,8477429,Andrew Copp,C,DET,30,82,11,25,36
33,8478055,Gustav Forsling,D,FLA,28,82,10,26,36
33,8478500,Ivan Provorov,D,CBJ,27,82,8,28,36
33,8478469,Thomas Chabot,D,OTT,27,82,7,29,36
33,8476923,Damon Severson,D,CBJ,30,82,7,29,36
33,8482671,Owen Power,D,BUF,22,82,6,30,36
33,8481703,Valtteri Puustinen,R,PIT,25,82,5,31,36
33,8477932,Aaron Ekblad,D,FLA,28,82,4,32,36
33,8483397,Marc McLaughlin,C,BOS,25,82,31,4,35
33,8476438,Brandon Saad,L,STL,32,82,23,12,35
33,8482175,JJ Peterka,R,BUF,22,82,20,15,35
33,8478046,Danton Heinen,L,BOS,29,82,19,16,35
33,8478020,Michael Amadio,C,VGK,28,82,19,16,35
33,8478233,Andrew Mangiapane,L,CGY,28,82,18,17,35
33,8480893,Kirill Marchenko,R,CBJ,24,82,17,18,35
33,8475793,Ryan Johansen,C,PHI,32,82,16,19,35
33,8480459,Pius Suter,C,VAN,28,82,16,19,35
33,8478856,Conor Garland,R,VAN,28,82,15,20,35
33,8483515,Juraj Slafkovsky,L,MTL,20,82,15,20,35
33,8482720,Matthew Knies,L,TOR,22,82,13,22,35
33,8476872,Scott Laughton,C,PHI,30,82,12,23,35
33,8474037,James van Riemsdyk,L,BOS,35,82,12,23,35
33,8476458,Ryan Strome,C,ANA,31,82,12,23,35
33,8484166,Adam Fantilli,C,CBJ,20,82,11,24,35
33,8475791,Taylor Hall,L,CHI,33,82,10,25,35
33,8478133,Jake Evans,C,MTL,28,82,9,26,35
33,8477444,Andre Burakovsky,L,SEA,29,82,8,27,35
33,8480873,Rasmus Sandin,D,WSH,24,82,7,28,35
33,8481581,Thomas Harley,D,DAL,23,82,4,31,35
33,8477947,Sonny Milano,L,WSH,28,82,18,16,34
33,8482146,Luke Evangelista,R,NSH,22,82,16,18,34
33,8477964,Ivan Barbashev,C,VGK,29,82,16,18,34
33,8476419,Jean-Gabriel Pageau,C,NYI,32,82,16,18,34
33,8477416,Oliver Bjorkstrand,R,SEA,29,82,13,21,34
33,8476329,Travis Boyd,C,ARI,31,82,12,22,34
33,8477425,Miles Wood,L,COL,29,82,10,24,34
33,8480336,Sean Walker,D,COL,30,82,9,25,34
33,8483471,Brad Lambert,C,WPG,31,82,5,29,34
33,8479591,Michael Eyssimont,C,TBL,28,82,20,13,33
33,8475287,Erik Haula,L,NJD,33,82,13,20,33
33,8476892,Colton Parayko,D,STL,31,82,11,22,33
33,8482699,Dylan Guenther,R,ARI,21,82,10,23,33
33,8473449,Kyle Okposo,R,FLA,36,82,10,23,33
33,8474563,Drew Doughty,D,LAK,35,82,7,26,33
33,8480145,Neal Pionk,D,WPG,29,82,7,26,33
33,8475218,Mattias Ekholm,D,EDM,34,82,6,27,33
33,8483524,Shane Wright,C,SEA,20,82,26,6,32
33,8473422,Nick Foligno,L,CHI,37,82,15,17,32
33,8475191,Reilly Smith,R,PIT,33,82,14,18,32
33,8477494,Jonathan Drouin,L,COL,29,82,12,20,32
33,8479987,Morgan Geekie,C,BOS,26,82,11,21,32
33,8482111,Justin Barron,D,MTL,23,82,11,21,32
33,8482092,Ridly Greig,C,OTT,22,82,9,23,32
33,8476480,Vladislav Namestnikov,C,WPG,32,82,9,23,32
33,8476292,Ondrej Palat,L,NJD,33,82,9,23,32
33,8477498,Darnell Nurse,D,EDM,29,82,9,23,32
33,8474565,Alex Pietrangelo,D,VGK,34,82,5,27,32
33,8478507,John Marino,D,NJD,27,82,5,27,32
33,8481618,Alex Newhook,C,MTL,23,82,17,14,31
33,8475760,Nick Bjugstad,C,ARI,32,82,16,15,31
33,8475343,Nic Dowd,C,WSH,34,82,16,15,31
33,8482222,Alexander Barabanov,L,SJS,30,82,16,15,31
33,8477998,Warren Foegele,L,EDM,28,82,16,15,31
33,8479996,Cody Glass,C,NSH,25,82,13,18,31
33,8478109,Victor Olofsson,L,BUF,29,82,13,18,31
33,8476278,Colin Blackwell,C,CHI,31,82,13,18,31
33,8481535,Nils Hoglander,L,VAN,24,82,12,19,31
33,8475200,Dmitry Orlov,D,CAR,33,82,11,20,31
33,8478463,Anthony Beauvillier,L,NSH,27,82,11,20,31
33,8479353,Brett Howden,C,VGK,26,82,10,21,31
33,8475763,Kevin Hayes,R,STL,32,82,9,22,31
33,8479390,Taylor Raddysh,R,CHI,26,82,14,16,30
33,8474149,Evgenii Dadonov,R,DAL,35,82,12,18,30
33,8477953,Kasperi Kapanen,R,STL,28,82,11,19,30
33,8481656,Aliaksei Protas,C,WSH,23,82,11,19,30
33,8481546,Cam York,D,PHI,23,82,11,19,30
33,8474053,Logan Couture,C,SJS,35,82,7,23,30
33,8478542,Evan Rodrigues,C,FLA,31,82,14,15,29
33,8480821,Filip Zadina,R,SJS,25,82,14,15,29
33,8480113,Alex Iafallo,L,WPG,31,82,13,16,29
33,8476873,Mark Jankowski,C,NSH,30,82,13,16,29
33,8480185,Eetu Luostarinen,C,FLA,26,82,12,17,29
33,8476960,Andreas Athanasiou,C,CHI,30,82,12,17,29
33,8477450,Jason Dickinson,C,CHI,29,82,11,18,29
33,8481580,Connor McMichael,C,WSH,23,82,10,19,29
33,8480220,Noah Cates,L,PHI,25,82,8,21,29
33,8480802,Ryan McLeod,C,EDM,25,82,7,22,29
33,8482087,Kaiden Guhle,D,MTL,22,82,7,22,29
33,8476463,Jonas Brodin,D,MIN,31,82,7,22,29
33,8476931,Jake McCabe,D,TOR,31,82,5,24,29
33,8477969,Marcus Pettersson,D,PIT,28,82,4,25,29
33,8476958,Jaccob Slavin,D,CAR,30,82,4,25,29
33,8477506,Ryan Pulock,D,NYI,30,82,4,25,29
33,8481601,Simon Holmstrom,R,NYI,23,82,15,13,28
33,8474189,Lars Eller,C,PIT,35,82,14,14,28
33,8473533,Jordan Staal,C,CAR,36,82,14,14,28
33,8480281,Alexey Toropchenko,R,STL,25,82,14,14,28
33,8478043,Sam Lafferty,C,VAN,29,82,14,14,28
33,8474884,Mike Hoffman,C,SJS,35,82,13,15,28
33,8481554,Kaapo Kakko,R,NYR,23,82,12,16,28
33,8477839,Conor Sheary,L,TBL,32,82,10,18,28
33,8482655,J.J. Moser,D,ARI,24,82,9,19,28
33,8483499,Liam Ohgren,L,MIN,20,82,7,21,28
33,8473994,Jamie Benn,L,DAL,35,82,6,22,28
33,8475790,Erik Gudbranson,D,CBJ,32,82,6,22,28
33,8482803,Olen Zellweger,D,ANA,21,82,6,22,28
33,8481178,Egor Zamula,D,PHI,24,82,2,26,28
33,8470610,Zach Parise,L,COL,40,82,16,11,27
33,8483431,Logan Cooley,C,ARI,20,82,15,12,27
33,8476374,Sean Kuraly,C,CBJ,31,82,14,13,27
33,8477406,Mattias Janmark,C,EDM,32,82,13,14,27
33,8480068,Ryan Poehling,C,PHI,25,82,11,16,27
33,8479977,Kailer Yamamoto,R,SEA,26,82,11,16,27
33,8479514,Rem Pitlick,C,CHI,27,82,9,18,27
33,8473507,Jeff Petry,D,DET,37,82,6,21,27
33,8476854,Hampus Lindholm,D,BOS,30,82,6,21,27
33,8474151,Ryan McDonagh,D,NSH,35,82,5,22,27
33,8480246,Nick Perbix,D,TBL,26,82,3,24,27
33,8476979,Erik Gustafsson,D,NYR,32,82,3,24,27
33,8479316,Luke Kunin,C,SJS,27,82,16,10,26
33,8481093,Rafael Harvey-Pinard,L,MTL,25,82,16,10,26
33,8482679,Matt Coronato,R,CGY,22,82,15,11,26
33,8479293,Brandon Tanev,L,SEA,33,82,15,11,26
33,8479415,Michael McLeod,C,NJD,26,82,13,13,26
33,8475722,Jason Zucker,L,NSH,32,82,12,14,26
33,8480009,Eeli Tolvanen,R,SEA,25,82,11,15,26
33,8476927,Teddy Blueger,C,VAN,30,82,11,15,26
33,8476897,Oskar Sundqvist,C,STL,30,82,10,16,26
33,8476921,Jordan Martinook,L,CAR,32,82,8,18,26
33,8482142,Jamie Drysdale,D,PHI,22,82,7,19,26
33,8476624,Barclay Goodrow,C,NYR,31,82,7,19,26
33,8478013,Jake Walman,D,DET,28,82,7,19,26
33,8475279,Ben Chiarot,D,DET,33,82,5,21,26
33,8482702,Logan Stankoven,C,DAL,21,82,16,9,25
33,8476981,Josh Anderson,R,MTL,30,82,14,11,25
33,8482737,Zack Bolduc,C,STL,21,82,14,11,25
33,8480855,Jack McBain,C,ARI,24,82,9,16,25
33,8478891,Mason Appleton,C,WPG,28,82,9,16,25
33,8477392,Hudson Fasching,R,NYI,29,82,9,16,25
33,8479359,Beck Malenstyn,L,WSH,26,82,9,16,25
33,8473563,Nicklas Backstrom,C,WSH,37,82,8,17,25
33,8483505,Matthew Poitras,C,BOS,20,82,8,17,25
33,8476902,Esa Lindell,D,DAL,30,82,7,18,25
33,8482245,Artem Zub,D,OTT,29,82,6,19,25
33,8475188,Brayden McNabb,D,VGK,33,82,6,19,25
33,8475181,Nick Leddy,D,STL,33,82,4,21,25
33,8482733,Logan Mailloux,D,MTL,31,82,3,22,25
33,8482118,Sam Colangelo,R,ANA,23,82,21,3,24
33,8484203,Bradly Nadeau,L,CAR,19,82,15,9,24
33,8483493,Frank Nazar,C,CHI,20,82,15,9,24
33,8474715,Cam Atkinson,R,PHI,35,82,14,10,24
33,8476392,Adam Lowry,C,WPG,31,82,12,12,24
33,8481624,Ilya Mikheyev,R,VAN,30,82,11,13,24
33,8482117,Lukas Reichel,L,CHI,22,82,9,15,24
33,8480448,Parker Kelly,L,OTT,25,82,9,15,24
33,8483490,Pavel Mintyukov,D,ANA,21,82,9,15,24
33,8484153,Leo Carlsson,C,ANA,20,82,9,15,24
33,8479351,Sam Steel,C,DAL,26,82,9,15,24
33,8475164,Jakob Silfverberg,R,ANA,34,82,8,16,24
33,8482101,Danil Gushchin,L,SJS,22,82,7,17,24
33,8476457,Adam Larsson,D,SEA,32,82,7,17,24
33,8477507,Nikita Zadorov,D,VAN,29,82,5,19,24
33,8476461,Sean Couturier,C,PHI,32,82,3,21,24
33,8478416,Erik Cernak,D,TBL,27,82,2,22,24
33,8479393,Noah Gregor,C,TOR,26,82,15,8,23
33,8477919,Frederick Gaudreau,C,MIN,31,82,13,10,23
33,8482079,Marco Rossi,C,MIN,23,82,10,13,23
33,8483491,Ivan Miroshnichenko,L,WSH,20,82,10,13,23
33,8476312,Josh Manson,D,COL,33,82,8,15,23
33,8480813,Joe Veleno,C,DET,24,82,8,15,23
33,8477499,Rasmus Ristolainen,D,PHI,30,82,8,15,23
33,8480043,Timothy Liljegren,D,TOR,25,82,5,18,23
33,8478882,Vladislav Gavrikov,D,LAK,29,82,5,18,23
33,8480172,Jan Rutta,D,SJS,34,82,5,18,23
33,8478451,Ethan Bear,D,WSH,27,82,4,19,23
33,8478851,Alexandre Carrier,D,NSH,28,82,4,19,23
33,8474673,TJ Brodie,D,TOR,34,82,3,20,23
33,8482074,Connor Zary,C,CGY,23,82,15,7,22
33,8482259,Bobby McMann,C,TOR,28,82,11,11,22
33,8477989,Christian Dvorak,C,MTL,28,82,11,11,22
33,8481477,Nico Sturm,C,SJS,29,82,10,12,22
33,8481704,Juuso Parssinen,C,NSH,23,82,10,12,22
33,8477330,Dominik Kubalik,L,OTT,29,82,9,13,22
33,8470621,Corey Perry,R,EDM,39,82,9,13,22
33,8475231,Casey Cizikas,C,NYI,33,82,8,14,22
33,8480817,K'Andre Miller,D,NYR,24,82,7,15,22
33,8480871,Adam Boqvist,D,CBJ,24,82,7,15,22
33,8481606,Jordan Spence,D,LAK,23,82,6,16,22
33,8475233,David Savard,D,MTL,34,82,5,17,22
33,8479398,Samuel Girard,D,COL,26,82,4,18,22
33,8477845,Trevor van Riemsdyk,D,WSH,33,82,3,19,22
33,8476879,Cody Ceci,D,EDM,31,82,3,19,22
33,8478840,Will Borgen,D,SEA,28,82,2,20,22
33,8479346,Dillon Dube,C,CGY,26,82,9,12,21
33,8478430,Oliver Kylington,D,CGY,27,82,9,12,21
33,8482730,Brandt Clarke,D,LAK,21,82,8,13,21
33,8478468,Jeremy Lauzon,D,NSH,27,82,8,13,21
33,8477508,Curtis Lazar,C,NJD,29,82,8,13,21
33,8480144,David Kampf,C,TOR,29,82,7,14,21
33,8478178,Darren Raddysh,D,TBL,28,82,6,15,21
33,8481537,Nikita Okhotiuk,D,CGY,24,82,6,15,21
33,8481522,Peyton Krebs,C,BUF,23,82,6,15,21
33,8474013,Ian Cole,D,VAN,35,82,6,15,21
33,8478911,Matt Roy,D,LAK,29,82,5,16,21
33,8481567,Henry Thrun,D,SJS,23,82,5,16,21
33,8482073,Braden Schneider,D,NYR,23,82,4,17,21
33,8479371,Dante Fabbro,D,NSH,26,82,4,17,21
33,8481524,Bowen Byram,D,BUF,23,82,3,18,21
33,8477505,Alexander Wennberg,C,NYR,30,82,3,18,21
33,8470604,Jeff Carter,C,PIT,39,82,16,4,20
33,8478508,Yakov Trenin,C,COL,27,82,14,6,20
33,8477353,Tyler Motte,C,TBL,29,82,14,6,20
33,8479383,Boris Katchouk,L,OTT,26,82,12,8,20
33,8481517,Brett Leason,R,ANA,25,82,10,10,20
33,8475220,Marcus Foligno,L,MIN,33,82,10,10,20
33,8476469,Joel Armia,R,MTL,31,82,10,10,20
33,8479661,Tanner Jeannot,L,TBL,27,82,10,10,20
33,8481186,Logan O'Connor,R,COL,28,82,10,10,20
33,8477015,Connor Brown,R,EDM,30,82,7,13,20
33,8481014,Alexander Romanov,D,NYI,24,82,6,14,20
33,8476525,Colin Miller,D,WPG,32,82,6,14,20
33,8480796,Martin Fehervary,D,WSH,25,82,5,15,20
33,8483495,Simon Nemec,D,NJD,20,82,3,17,20
33,8484145,Zach Benson,L,BUF,19,82,12,7,19
33,8476858,Phillip Di Giuseppe,L,VAN,31,82,11,8,19
33,8480806,Isac Lundestrom,C,ANA,25,82,10,9,19
33,8476871,Tanner Pearson,L,MTL,32,82,9,10,19
33,8481481,Blake Lizotte,C,LAK,27,82,7,12,19
33,8478443,Brandon Carlo,D,BOS,28,82,6,13,19
33,8476422,Mike Reilly,D,NYI,31,82,5,14,19
33,8480807,Mattias Samuelsson,D,BUF,24,82,5,14,19
33,8475324,Nick Jensen,D,WSH,34,82,3,16,19
33,8479980,Nicolas Hague,D,VGK,26,82,3,16,19
33,8477488,Brett Pesce,D,CAR,30,82,1,18,19
33,8482145,Mavrik Bourque,C,DAL,22,82,15,3,18
33,8480074,Alexandre Texier,C,CBJ,25,82,10,8,18
33,8477369,Carson Soucy,D,VAN,30,82,9,9,18
33,8476442,Matt Nieto,L,PIT,32,82,9,9,18
33,8482125,Alexander Holtz,R,NJD,22,82,8,10,18
33,8477435,Ryan Graves,D,PIT,29,82,4,14,18
33,8475171,Oliver Ekman-Larsson,D,FLA,33,82,3,15,18
33,8475179,Dmitry Kulikov,D,FLA,34,82,3,15,18
33,8476331,Dylan DeMelo,D,WPG,31,82,3,15,18
33,8475825,Jani Hakanpää,D,DAL,32,82,3,15,18
33,8479976,Juuso Valimaki,D,ARI,26,82,2,16,18
33,8470966,Mark Giordano,D,TOR,41,82,2,16,18
33,8481568,Alex Vlasic,D,CHI,23,82,1,17,18
33,8476429,Scott Mayfield,D,NYI,32,82,0,18,18
33,8478569,Noel Acciari,C,PIT,33,82,12,5,17
33,8478831,Kevin Stenlund,C,FLA,28,82,7,10,17
33,8481028,Martin Pospisil,C,CGY,25,82,7,10,17
33,8475762,Derek Forbort,D,BOS,32,82,5,12,17
33,8482858,Ryker Evans,D,SEA,23,82,5,12,17
33,8480035,Henri Jokiharju,D,BUF,25,82,4,13,17
33,8480879,Jacob Bernard-Docker,D,OTT,24,82,4,13,17
33,8476917,Adam Pelech,D,NYI,30,82,3,14,17
33,8484911,Collin Graf,R,SJS,22,82,3,14,17
33,8479369,Andrew Peeke,D,BOS,26,82,3,14,17
33,8477365,Connor Clifton,D,BUF,29,82,3,14,17
33,8474574,Tyler Myers,D,VAN,34,82,3,14,17
33,8474166,Alec Martinez,D,VGK,37,82,3,14,17
33,8475455,Brenden Dillon,D,WPG,34,82,0,17,17
33,8475842,Sam Carrick,C,EDM,32,82,10,6,16
33,8482155,Alex Laferriere,R,LAK,23,82,10,6,16
33,8476822,Luke Glendening,C,TBL,35,82,8,8,16
33,8481553,Bobby Brink,R,PHI,23,82,6,10,16
33,8476891,Matt Grzelcyk,D,BOS,30,82,5,11,16
33,8482166,Shakir Mukhamadullin,D,SJS,22,82,5,11,16
33,8470600,Ryan Suter,D,DAL,39,82,4,12,16
33,8483466,Kevin Korchinski,D,CHI,20,82,3,13,16
33,8475690,Chris Tanev,D,DAL,35,82,2,14,16
33,8476467,Jamie Oleksiak,D,SEA,32,82,1,15,16
33,8480980,Connor Dewar,C,TOR,25,82,9,6,15
33,8479983,Mario Ferraro,D,SJS,26,82,7,8,15
33,8478136,Jake Middleton,D,MIN,28,82,6,9,15
33,8483482,Tristan Luneau,D,ANA,20,82,5,10,15
33,8474034,Pat Maroon,L,BOS,36,82,5,10,15
33,8480073,Erik Brannstrom,D,OTT,25,82,5,10,15
33,8479442,Troy Stecher,D,EDM,30,82,5,10,15
33,8480860,Kevin Bahl,D,NJD,24,82,4,11,15
33,8473504,Cal Clutterbuck,R,NYI,37,82,4,11,15
33,8475462,Radko Gudas,D,ANA,34,82,4,11,15
33,8475208,Brian Dumoulin,D,SEA,33,82,3,12,15
33,8474009,Nick Bonino,C,NYR,36,82,7,7,14
33,8474716,Jared Spurgeon,D,MIN,35,82,5,9,14
33,8481605,Jackson LaCombe,D,ANA,23,82,5,9,14
33,8478859,Niko Mikkola,D,FLA,28,82,5,9,14
33,8480990,Declan Chisholm,D,MIN,24,82,5,9,14
33,8482666,Scott Morrow,D,CAR,22,82,4,10,14
33,8475177,Calvin de Haan,D,TBL,33,82,3,11,14
33,8480834,Ty Emberson,D,SJS,24,82,0,14,14
33,8479291,Kevin Rooney,C,CGY,31,82,10,3,13
33,8476878,Zemgus Girgensons,L,BUF,30,82,9,4,13
33,8477931,Tomas Nosek,L,NJD,32,82,4,9,13
33,8476967,Brett Kulak,D,EDM,30,82,4,9,13
33,8482516,Matthew Kessel,D,STL,24,82,4,9,13
33,8473453,Trevor Lewis,C,LAK,37,82,4,9,13
33,8476473,Connor Murphy,D,CHI,31,82,4,9,13
33,8482470,Ilya Solovyov,D,CGY,24,82,3,10,13
33,8482712,Oskar Olausson,R,COL,22,82,2,11,13
33,8479998,Mikey Anderson,D,LAK,25,82,1,12,13
33,8483012,Logan Morrison,C,SEA,22,82,7,5,12
33,8482807,Ethan Del Mastro,D,CHI,21,82,6,6,12
33,8478399,Jonas Siegenthaler,D,NJD,27,82,5,7,12
33,8482809,Jackson Blake,R,CAR,21,82,5,7,12
33,8482062,Cole Smith,L,NSH,29,82,5,7,12
33,8479324,Ryan Lindgren,D,NYR,26,82,3,9,12
33,8476372,Nick Seeler,D,PHI,31,82,2,10,12
33,8477220,Nate Schmidt,D,WPG,33,82,1,11,12
33,8474567,Zach Bogosian,D,MIN,34,82,5,6,11
33,8483565,Nick Blankenburg,D,CBJ,26,82,4,7,11
33,8482762,Simon Edvinsson,D,DET,21,82,4,7,11
33,8477034,Jaycob Megna,D,CHI,32,82,0,11,11
33,8482713,Mackie Samoskevich,R,FLA,22,82,6,4,10
33,8481578,Graeme Clarke,R,NJD,23,82,5,5,10
33,8478408,Travis Dermott,D,ARI,28,82,4,6,10
33,8483468,Jiri Kulich,C,BUF,20,82,4,6,10
33,8481599,Victor Soderstrom,D,ARI,23,82,4,6,10
33,8476915,Jujhar Khaira,L,MIN,30,82,3,7,10
33,8481059,Scott Perunovich,D,STL,26,82,1,9,10
33,8477335,Kyle Burroughs,D,SJS,29,82,5,4,9
33,8480058,Pierre-Olivier Joseph,D,PIT,25,82,1,8,9
33,8483763,Maksymilian Szuber,D,ARI,22,82,6,2,8
33,8471677,Jack Johnson,D,COL,37,82,3,5,8
33,8481030,Jack St. Ivany,D,PIT,25,82,2,6,8
33,8484149,Gavin Brindley,C,CBJ,20,82,1,7,8
33,8482177,Marat Khusnutdinov,C,MIN,22,82,2,5,7
33,8482859,Zack Ostapchuk,C,OTT,21,82,0,6,6
33,8483489,Fraser Minten,C,TOR,31,82,3,2,5
33,8482141,Lukas Cormier,D,VGK,22,0,0,0,0
33,8476988,Matt Benning,D,SJS,30,0,0,0,0
33,8480727,Zach Whitecloud,D,VGK,28,0,0,0,0
33,8480887,Jordan Harris,D,MTL,24,0,0,0,0
33,8478450,Parker Wotherspoon,D,BOS,27,0,0,0,0
33,8481812,Nikolai Knyzhov,D,SJS,27,0,0,0,0
33,8480001,Urho Vaakanainen,D,ANA,25,0,0,0,0
33,8482176,Wyatt Kaiser,D,CHI,22,0,0,0,0
33,8481122,Simon Benoit,D,TOR,26,0,0,0,0
33,8476441,Joel Edmundson,D,TOR,31,0,0,0,0
33,8480884,Calen Addison,D,SJS,24,0,0,0,0
33,8482511,Mason Lohrei,D,BOS,23,0,0,0,0
33,8482192,Isaak Phillips,D,CHI,23,0,0,0,0
33,8480950,Ilya Lyubushkin,D,TOR,30,0,0,0,0
33,8474031,Kevin Shattenkirk,D,BOS,35,0,0,0,0
33,8475718,Justin Holl,D,DET,32,0,0,0,0
33,8479402,Jake Bean,D,CBJ,26,0,0,0,0
33,8474602,Justin Schultz,D,SEA,34,0,0,0,0
33,8477950,Tony DeAngelo,D,CAR,29,0,0,0,0
33,8481743,Marc Del Gaizo,D,NSH,25,0,0,0,0
33,8481527,Kaedan Korczak,D,VGK,23,0,0,0,0
33,8480192,Johnathan Kovacevic,D,MTL,27,0,0,0,0
33,8476874,Olli Maatta,D,DET,30,0,0,0,0
33,8482144,Jack Thompson,D,SJS,22,0,0,0,0
33,8480222,Sebastian Aho,D,NYI,28,0,0,0,0
33,8479458,Nikita Zaitsev,D,CHI,33,0,0,0,0
33,8471709,Marc-Edouard Vlasic,D,SJS,37,0,0,0,0
33,8482929,Emil Lilleberg,D,TBL,23,0,0,0,0
33,8477018,Ben Hutton,D,VGK,31,0,0,0,0
33,8481056,Spencer Stastney,D,NSH,24,0,0,0,0
33,8481593,Jayden Struble,D,MTL,23,0,0,0,0
33,8479982,Conor Timmins,D,TOR,26,0,0,0,0
33,8474090,Brendan Smith,D,NJD,35,0,0,0,0
33,8482964,Arber Xhekaj,D,MTL,23,0,0,0,0
33,8480891,Michael Kesselring,D,ARI,24,0,0,0,0
33,8477938,Haydn Fleury,D,TBL,28,0,0,0,0
33,8481806,Louis Crevier,D,CHI,23,0,0,0,0
33,8471274,Alex Goligoski,D,MIN,39,0,0,0,0
33,8481600,Tobias Bjornfot,D,FLA,23,0,0,0,0
33,8475797,Jarred Tinordi,D,CHI,32,0,0,0,0
33,8481521,Ronnie Attard,D,PHI,25,0,0,0,0
33,8474612,Travis Hamonic,D,OTT,34,0,0,0,0
33,8479576,Vincent Desharnais,D,EDM,28,0,0,0,0
33,8480049,Dylan Samberg,D,WPG,25,0,0,0,0
33,8483619,Filip Roos,D,CHI,25,0,0,0,0
33,8474568,Luke Schenn,D,NSH,35,0,0,0,0
33,8480184,Gustav Lindstrom,D,ANA,26,0,0,0,0
33,8480070,Ian Mitchell,D,BOS,25,0,0,0,0
33,8480196,Jacob Bryson,D,BUF,27,0,0,0,0
33,8471686,Marc Staal,D,PHI,37,0,0,0,0
33,8477467,Gustav Olofsson,D,SEA,30,0,0,0,0
33,8478970,Jalen Chatfield,D,CAR,28,0,0,0,0
33,8479348,Kale Clague,D,BUF,26,0,0,0,0
33,8473446,Erik Johnson,D,PHI,36,0,0,0,0
33,8477462,Robert Hagg,D,ANA,29,0,0,0,0
33,8478454,Noah Juulsen,D,VAN,27,0,0,0,0
33,8477384,Josh Brown,D,ARI,30,0,0,0,0
33,8481708,Zac Jones,D,NYR,24,0,0,0,0
33,8481167,Brayden Pachal,D,CGY,25,0,0,0,0
33,8482067,Connor Mackey,D,NYR,28,0,0,0,0
33,8483460,David Jiricek,D,CBJ,21,0,0,0,0
33,8481701,Santeri Hatakka,D,NJD,23,0,0,0,0
33,8478021,William Lagesson,D,ANA,28,0,0,0,0
33,8477851,Jordan Oesterle,D,CGY,32,0,0,0,0
33,8478452,Caleb Jones,D,COL,27,0,0,0,0
33,8479984,Cal Foote,D,NJD,26,0,0,0,0
33,8479639,Dylan Coghlan,D,CAR,26,0,0,0,0
33,8480874,Adam Ginning,D,PHI,24,0,0,0,0
33,8479321,Lucas Johansen,D,WSH,27,0,0,0,0
33,8480878,Nils Lundkvist,D,DAL,24,0,0,0,0
33,8482165,Yan Kuznetsov,D,CGY,22,0,0,0,0
33,8484258,Sam Malinski,D,COL,26,0,0,0,0
33,8480157,Calle Rosen,D,STL,30,0,0,0,0
33,8484304,Uvis Balinskis,D,FLA,28,0,0,0,0
33,8479985,Cale Fleury,D,SEA,26,0,0,0,0
33,8479378,Logan Stanley,D,WPG,26,0,0,0,0
33,8477541,Dakota Mermis,D,MIN,30,0,0,0,0
33,8481609,Vladislav Kolyachonok,D,ARI,23,0,0,0,0
33,8480823,Alexander Alexeyev,D,WSH,25,0,0,0,0
33,8481679,Maxence Guenette,D,OTT,23,0,0,0,0
33,8481564,Ryan Johnson,D,BUF,23,0,0,0,0
33,8479376,Victor Mete,D,PHI,26,0,0,0,0
33,8484254,Akito Hirose,D,VAN,25,0,0,0,0
33,8482660,Kent Johnson,C,CBJ,22,0,0,0,0
33,8482149,Cole Perfetti,C,WPG,22,0,0,0,0
33,8477987,Ryan Donato,C,CHI,28,0,0,0,0
33,8475755,Alexander Petrovic,D,DAL,32,0,0,0,0
33,8477810,Joel Hanley,D,CGY,33,0,0,0,0
33,8474145,Robert Bortuzzo,D,NYI,35,0,0,0,0
33,8481161,Jake Christiansen,D,CBJ,25,0,0,0,0
33,8476884,Derrick Pouliot,D,DAL,30,0,0,0,0
33,8481716,Dmitri Voronkov,L,CBJ,24,0,0,0,0
33,8480084,Nick DeSimone,D,NJD,30,0,0,0,0
33,8475750,Jon Merrill,D,MIN,32,0,0,0,0
33,8479315,Joey Anderson,R,CHI,26,0,0,0,0
33,8478011,Louie Belpedio,D,PHI,28,0,0,0,0
33,8482451,Mikael Pyyhtia,L,CBJ,23,0,0,0,0
33,8481541,Samuel Bolduc,D,NYI,24,0,0,0,0
33,8482126,Emil Andrae,D,PHI,31,0,0,0,0
33,8474618,Marco Scandella,D,STL,34,0,0,0,0
33,8477244,Chad Ruhwedel,D,NYR,34,0,0,0,0
33,8477971,Andreas Englund,D,LAK,28,0,0,0,0
33,8480829,Jesperi Kotkaniemi,C,CAR,24,0,0,0,0
33,8479372,Josh Mahura,D,FLA,26,0,0,0,0
33,8482095,Tyler Kleven,D,OTT,22,0,0,0,0
33,8481719,Maxwell Crozier,D,TBL,24,0,0,0,0
33,8475855,Jesper Fast,R,CAR,33,0,0,0,0
33,8480848,Ty Dellandrea,C,DAL,24,0,0,0,0
33,8475193,Tomas Tatar,L,SEA,34,0,0,0,0
33,8476889,Radek Faksa,C,DAL,30,0,0,0,0
33,8478495,Denis Gurianov,R,PHI,27,0,0,0,0
33,8480216,Jacob Peterson,C,SJS,25,0,0,0,0
33,8480252,Cole Guttman,C,CHI,25,0,0,0,0
33,8479026,Philippe Myers,D,TBL,27,0,0,0,0
33,8481006,Tyler Tucker,D,STL,24,0,0,0,0
33,8481032,Paul Cotter,C,VGK,25,0,0,0,0
33,8481577,Philip Tomasino,C,NSH,23,0,0,0,0
33,8476918,Jimmy Vesey,L,NYR,31,0,0,0,0
33,8479320,Max Lajoie,D,TOR,27,0,0,0,0
33,8478017,Mark Friedman,D,VAN,29,0,0,0,0
33,8481754,Nikita Nesterenko,C,ANA,23,0,0,0,0
33,8483407,Brandon Scanlin,D,NYR,25,0,0,0,0
33,8482659,Josh Doan,R,ARI,22,0,0,0,0
33,8477446,Michael McCarron,R,NSH,29,0,0,0,0
33,8477903,Garnet Hathaway,R,PHI,33,0,0,0,0
33,8482153,Brendan Brisson,C,VGK,23,0,0,0,0
33,8483546,Marshall Rifai,D,TOR,26,0,0,0,0
33,8484287,Cole McWard,D,VAN,23,0,0,0,0
33,8478854,Ryan Shea,D,PIT,27,0,0,0,0
33,8481585,Egor Afanasyev,L,NSH,23,0,0,0,0
33,8483398,Declan Carlile,D,TBL,31,0,0,0,0
33,8478502,Dennis Gilbert,D,CGY,28,0,0,0,0
33,8482749,Joshua Roy,R,MTL,21,0,0,0,0
33,8481598,Philip Broberg,D,EDM,23,0,0,0,0
33,8480835,Jack Drury,C,CAR,24,0,0,0,0
33,8480748,Kiefer Sherwood,L,NSH,29,0,0,0,0
33,8476934,Brock McGinn,L,ANA,30,0,0,0,0
33,8480870,Bo Groulx,C,ANA,24,0,0,0,0
33,8479368,Max Jones,L,ANA,26,0,0,0,0
33,8478099,Kevin Labanc,R,SJS,29,0,0,0,0
33,8478067,Oskar Lindblom,L,SJS,28,0,0,0,0
33,8476393,Nick Cousins,C,FLA,31,0,0,0,0
33,8483395,Arshdeep Bains,L,VAN,23,0,0,0,0
33,8480762,Eric Robinson,L,BUF,29,0,0,0,0
33,8479439,Jacob MacDonald,D,SJS,31,0,0,0,0
33,8476474,Stefan Noesen,R,CAR,31,0,0,0,0
33,8482787,Nikita Chibrikov,R,WPG,31,0,0,0,0
33,8478432,Christian Fischer,R,DET,27,0,0,0,0
33,8477979,Nicolas Aube-Kubel,R,WSH,28,0,0,0,0
33,8481789,Tye Kartye,L,SEA,23,0,0,0,0
33,8479330,Brandon Gignac,C,MTL,27,0,0,0,0
33,8480075,Cameron Crotty,D,ARI,25,0,0,0,0
33,8473473,Milan Lucic,L,BOS,36,0,0,0,0
33,8482094,Daemon Hunt,D,MIN,22,0,0,0,0
33,8481206,John Ludvig,D,PIT,24,0,0,0,0
33,8483630,Pavol Regenda,L,ANA,25,0,0,0,0
33,8481617,Vasily Podkolzin,R,VAN,23,0,0,0,0
33,8480306,Grant Hutton,D,NYI,29,0,0,0,0
33,8480995,Pontus Holmberg,R,TOR,25,0,0,0,0
33,8482148,Hendrix Lapierre,C,WSH,22,0,0,0,0
33,8477478,William Carrier,L,VGK,30,0,0,0,0
33,8480003,Jesper Boqvist,C,BOS,26,0,0,0,0
33,8482172,Landon Slaggert,L,CHI,22,0,0,0,0
33,8480789,Oliver Wahlstrom,R,NYI,24,0,0,0,0
33,8474062,Riley Nash,C,NYR,35,0,0,0,0
33,8480021,Jack Studnicka,C,SJS,25,0,0,0,0
33,8480025,MacKenzie Entwistle,R,CHI,25,0,0,0,0
33,8481582,Nicholas Robertson,L,TOR,23,0,0,0,0
33,8476867,Brendan Gaunce,C,CBJ,30,0,0,0,0
33,8479619,Michael Carcone,L,ARI,28,0,0,0,0
33,8479370,Tyson Jost,C,BUF,26,0,0,0,0
33,8479671,Mathieu Olivier,R,CBJ,27,0,0,0,0
33,8476994,Vinnie Hinostroza,C,PIT,30,0,0,0,0
33,8482070,Mitchell Chaffee,R,TBL,26,0,0,0,0
33,8477473,Justin Bailey,R,SJS,29,0,0,0,0
33,8479344,Jesse Puljujarvi,R,PIT,26,0,0,0,0
33,8480205,Emil Bemstrom,C,PIT,25,0,0,0,0
33,8479718,Alex Barré-Boulet,C,TBL,27,0,0,0,0
33,8482061,Brandon Biro,L,BUF,26,0,0,0,0
33,8479638,Justin Brazeau,R,BOS,26,0,0,0,0
33,8474040,Sam Gagner,C,EDM,35,0,0,0,0
33,8477846,Ryan Carpenter,C,SJS,33,0,0,0,0
33,8482077,Dylan Holloway,L,EDM,23,0,0,0,0
33,8482157,Will Cuylle,L,NYR,22,0,0,0,0
33,8480007,Jonas Rondbjerg,R,VGK,25,0,0,0,0
33,8478874,Adam Gaudette,C,STL,28,0,0,0,0
33,8478434,Keegan Kolesar,R,VGK,27,0,0,0,0
33,8480441,Trey Fix-Wolansky,R,CBJ,25,0,0,0,0
33,8479994,Jaret Anderson-Dolan,C,NSH,25,0,0,0,0
33,8483567,Georgii Merkulov,C,BOS,24,0,0,0,0
33,8477380,Jonny Brodzinski,C,NYR,31,0,0,0,0
33,8482201,Gage Goncalves,C,TBL,23,0,0,0,0
33,8478211,Dryden Hunt,L,CGY,29,0,0,0,0
33,8471699,Andrew Cogliano,C,COL,37,0,0,0,0
33,8479421,Jacob Moverare,D,LAK,26,0,0,0,0
33,8478881,Brett Seney,L,CHI,28,0,0,0,0
33,8477464,Nic Petan,C,MIN,29,0,0,0,0
33,8475958,Michael Sgarbossa,C,WSH,32,0,0,0,0
33,8481147,Reese Johnson,C,CHI,26,0,0,0,0
33,8479336,Carl Grundstrom,R,LAK,27,0,0,0,0
33,8480853,Liam Foudy,C,NSH,24,0,0,0,0
33,8479522,Hardy Haman Aktell,D,WSH,26,0,0,0,0
33,8481462,Mason Morelli,L,VGK,28,0,0,0,0
33,8482102,Vasily Ponomarev,C,CAR,22,0,0,0,0
33,8480844,Grigori Denisenko,L,VGK,24,0,0,0,0
33,8479944,Zach Aston-Reese,C,DET,30,0,0,0,0
33,8482784,Zach Dean,C,STL,21,0,0,0,0
33,8479419,Brett Murray,L,BUF,26,0,0,0,0
33,8479520,Brandon Duhaime,R,COL,27,0,0,0,0
33,8477573,Nathan Walker,L,STL,30,0,0,0,0
33,8478078,Rourke Chartier,C,OTT,28,0,0,0,0
33,8475795,Dylan McIlrath,D,WSH,32,0,0,0,0
33,8482496,Nils Aman,C,VAN,24,0,0,0,0
33,8480289,Morgan Barron,C,WPG,26,0,0,0,0
33,8481751,Lukas Rousek,R,BUF,25,0,0,0,0
33,8480011,Klim Kostin,C,SJS,25,0,0,0,0
33,8481556,John Beecher,C,BOS,23,0,0,0,0
33,8475278,Byron Froese,C,VGK,33,0,0,0,0
33,8475225,Craig Smith,C,DAL,35,0,0,0,0
33,8484326,Patrik Koch,D,ARI,28,0,0,0,0
33,8477930,Pierre-Edouard Bellemare,L,SEA,39,0,0,0,0
33,8478409,Anthony Richard,C,BOS,28,0,0,0,0
33,8481024,Linus Karlsson,C,VAN,25,0,0,0,0
33,8479986,Kole Lind,R,SEA,26,0,0,0,0
33,8479414,Nathan Bastian,R,NJD,27,0,0,0,0
33,8479362,Riley Tufte,L,COL,26,0,0,0,0
33,8481058,Jesse Ylönen,R,MTL,25,0,0,0,0
33,8482476,Emil Heineman,L,MTL,23,0,0,0,0
33,8482861,Vincent Iorio,D,WSH,22,0,0,0,0
33,8483432,Luca Del Bel Belluz,C,CBJ,31,0,0,0,0
33,8482744,James Malatesta,L,CBJ,21,0,0,0,0
33,8477887,Patrick Brown,C,BOS,32,0,0,0,0
33,8478585,Derek Ryan,C,EDM,38,0,0,0,0
33,8481441,Joe Snively,C,WSH,28,0,0,0,0
33,8481592,Jakob Pelletier,L,CGY,23,0,0,0,0
33,8482634,Alex Steeves,C,TOR,25,0,0,0,0
33,8477126,Jayson Megna,C,BOS,34,0,0,0,0
33,8475752,Tyler Pitlick,C,NYR,33,0,0,0,0
33,8480008,Adam Ruzicka,C,ARI,25,0,0,0,0
33,8481065,Angus Crookshank,L,OTT,25,0,0,0,0
33,8479547,Matthew Phillips,R,WSH,26,0,0,0,0
33,8480226,Marián Studenic,R,SEA,26,0,0,0,0
33,8481237,Kyle MacLean,C,NYI,25,0,0,0,0
33,8475413,Justin Dowling,C,NJD,34,0,0,0,0
33,8481641,Joel Kiviranta,L,COL,28,0,0,0,0
33,8478104,Sammy Blais,L,STL,28,0,0,0,0
33,8477454,Adam Erne,L,EDM,29,0,0,0,0
33,8481518,Nolan Foote,L,NJD,24,0,0,0,0
33,8480245,Olle Lycksell,R,PHI,25,0,0,0,0
33,8483570,Ben Meyers,C,ANA,26,0,0,0,0
33,8480776,Sheldon Rempal,R,VGK,29,0,0,0,0
33,8483920,Pierrick Dube,R,WSH,23,0,0,0,0
33,8480267,Sammy Walker,C,MIN,25,0,0,0,0
33,8482747,Brennan Othmann,L,NYR,21,0,0,0,0
33,8479991,Jake Leschyshyn,C,NYR,25,0,0,0,0
33,8478400,Colin White,C,MTL,27,0,0,0,0
33,8479328,Julien Gauthier,R,NYI,27,0,0,0,0
33,8484325,Waltteri Merela,C,TBL,26,0,0,0,0
33,8479066,Ryan Lomberg,L,FLA,30,0,0,0,0
33,8477070,Liam O'Brien,C,ARI,30,0,0,0,0
33,8478146,Matthew Highmore,C,OTT,28,0,0,0,0
33,8478028,Fredrik Olofsson,L,COL,28,0,0,0,0
33,8480880,Jakub Lauko,C,BOS,24,0,0,0,0
33,8479968,Vinni Lettieri,C,MIN,29,0,0,0,0
33,8474709,Matt Martin,L,NYI,35,0,0,0,0
33,8480845,Rasmus Kupari,C,WPG,24,0,0,0,0
33,8481550,Adam Beckman,L,MIN,23,0,0,0,0
33,8481422,Jacob Lucchini,C,MIN,29,0,0,0,0
33,8477401,John Hayden,C,SEA,29,0,0,0,0
33,8478904,Steven Lorentz,C,FLA,28,0,0,0,0
33,8482088,Justin Sourdif,R,FLA,22,0,0,0,0
33,8482751,Ryan Winterton,C,SEA,21,0,0,0,0
33,8482241,Radim Zohorna,L,PIT,28,0,0,0,0
33,8481690,Tyler Angle,C,CBJ,24,0,0,0,0
33,8476952,Dominic Toninato,C,WPG,30,0,0,0,0
33,8476919,Chris Tierney,C,NJD,30,0,0,0,0
33,8480032,Shane Bowers,C,NJD,25,0,0,0,0
33,8484314,Jiri Smejkal,L,OTT,28,0,0,0,0
33,8481239,Samuel Fagemo,L,LAK,24,0,0,0,0
33,8481532,Alex Turcotte,C,LAK,23,0,0,0,0
33,8481019,David Gustafsson,C,WPG,24,0,0,0,0
33,8478477,Mitchell Stephens,C,MTL,27,0,0,0,0
33,8479546,Oskar Steen,C,BOS,26,0,0,0,0
33,8480292,Carson Meyer,R,CBJ,27,0,0,0,0
33,8478446,Glenn Gawdin,C,ANA,27,0,0,0,0
33,8483531,Brian Halonen,L,NJD,25,0,0,0,0
33,8477149,Scott Sabourin,R,SJS,32,0,0,0,0
33,8479972,Mason Shaw,C,MIN,26,0,0,0,0
33,8480890,Jan Jenik,R,ARI,24,0,0,0,0
33,8478051,Max Willman,C,NJD,29,0,0,0,0
33,8480851,Akil Thomas,C,LAK,24,0,0,0,0
33,8482765,Isak Rosen,R,BUF,21,0,0,0,0
33,8478421,A.J. Greer,L,CGY,28,0,0,0,0
33,8478512,Austin Czarnik,C,DET,32,0,0,0,0
33,8479536,Axel Jonsson-Fjallby,L,WPG,26,0,0,0,0
33,8477320,Anton Blidh,L,NYR,29,0,0,0,0
33,8481543,Nikita Alexandrov,C,STL,24,0,0,0,0
33,8475235,Nicolas Deslauriers,L,PHI,33,0,0,0,0
33,8481070,Hugh McGing,L,STL,26,0,0,0,0
33,8480836,Jonathan Gruden,C,PIT,24,0,0,0,0
33,8481591,Sam Poulin,R,PIT,23,0,0,0,0
33,8477962,Brendan Lemieux,L,CAR,28,0,0,0,0
33,8483401,Marc Johnstone,R,PIT,28,0,0,0,0
33,8482250,Callahan Burke,C,CAR,27,0,0,0,0
33,8481726,Adam Edstrom,C,NYR,24,0,0,0,0
33,8471817,Ryan Reaves,R,TOR,37,0,0,0,0
33,8479587,Rhett Gardner,C,PHI,28,0,0,0,0
33,8475766,Austin Watson,L,TBL,32,0,0,0,0
33,8479367,William Lockwood,R,FLA,26,0,0,0,0
33,8478424,Jansen Harkins,C,PIT,27,0,0,0,0
33,8476913,Devin Shore,C,SEA,30,0,0,0,0
33,8482652,Walker Duehr,R,CGY,27,0,0,0,0
33,8477527,Ross Johnston,L,ANA,30,0,0,0,0
33,8481077,John Leonard,L,ARI,26,0,0,0,0
33,8483549,Lucas Condotta,L,MTL,27,0,0,0,0
33,8480468,James Hamblin,L,EDM,25,0,0,0,0
33,8476907,Mackenzie MacEachern,L,STL,30,0,0,0,0
33,8479543,Michael Pezzetta,L,MTL,26,0,0,0,0
33,8480355,Mark Kastelic,C,OTT,25,0,0,0,0
33,8482162,Roby Jarventie,L,OTT,22,0,0,0,0
33,8479772,Zack MacEwen,R,OTT,28,0,0,0,0
33,8483597,Milos Kelemen,L,ARI,25,0,0,0,0
33,8479379,Givani Smith,R,SJS,26,0,0,0,0
33,8481655,Cole Schwindt,R,CGY,23,0,0,0,0
33,8479981,Jonah Gadjovich,L,FLA,26,0,0,0,0
33,8482147,Jean-Luc Foudy,C,COL,22,0,0,0,0
33,8484255,Jason Polin,R,COL,25,0,0,0,0
33,8477993,Justin Kirkland,C,ARI,28,0,0,0,0
33,8479249,Andrew Poturalski,C,SEA,30,0,0,0,0
33,8482197,Adam Raska,R,MIN,23,0,0,0,0
33,8475780,Chris Wagner,R,COL,33,0,0,0,0
33,8479533,Joona Koppanen,L,PIT,26,0,0,0,0
33,8481534,Raphael Lavoie,C,EDM,24,0,0,0,0
33,8484321,Nikolas Matinpalo,D,OTT,26,0,0,0,0
33,8481043,Cole Koepke,L,TBL,26,0,0,0,0
33,8476323,Max McCormick,L,SEA,32,0,0,0,0
33,8483609,Adam Klapka,R,CGY,24,0,0,0,0
33,8483512,Matt Savoie,C,BUF,20,0,0,0,0
33,8484259,Ondrej Pavel,C,COL,31,0,0,0,0
33,8478147,Bokondji Imama,L,OTT,28,0,0,0,0
33,8482460,Matt Rempe,C,NYR,22,0,0,0,0
33,8477073,Kurtis MacDermid,L,NJD,30,0,0,0,0
33,8480274,Philip Kemp,D,EDM,25,0,0,0,0
33,8478956,Samuel Laberge,L,NJD,27,0,0,0,0
33,8483045,Cameron Butler,R,CBJ,31,0,0,0,0
34,8478402,Connor McDavid,C,EDM,27,82,42,83,125
34,8481559,Jack Hughes,C,NJD,23,82,40,71,111
34,8477956,David Pastrnak,R,BOS,28,82,41,57,98
34,8479314,Matthew Tkachuk,L,FLA,27,82,37,61,98
34,8479318,Auston Matthews,C,TOR,27,82,48,49,97
34,8477493,Aleksander Barkov,C,FLA,29,82,35,60,95
34,8476453,Nikita Kucherov,R,TBL,31,82,31,64,95
34,8478420,Mikko Rantanen,R,COL,28,82,45,49,94
34,8479407,Jesper Bratt,L,NJD,26,82,30,62,92
34,8477934,Leon Draisaitl,C,EDM,29,82,34,57,91
34,8477492,Nathan MacKinnon,C,COL,29,82,43,47,90
34,8476887,Filip Forsberg,L,NSH,30,82,44,45,89
34,8478439,Travis Konecny,R,PHI,27,82,32,54,86
34,8481540,Cole Caufield,R,MTL,23,82,50,35,85
34,8482116,Tim Stützle,C,OTT,22,82,31,54,85
34,8476468,J.T. Miller,C,VAN,31,82,28,57,85
34,8480027,Jason Robertson,L,DAL,25,82,27,57,84
34,8477933,Sam Reinhart,C,FLA,29,82,38,44,82
34,8480023,Robert Thomas,C,STL,25,82,23,59,82
34,8478550,Artemi Panarin,L,NYR,33,82,26,55,81
34,8479343,Clayton Keller,R,ARI,26,82,35,45,80
34,8478042,Viktor Arvidsson,R,LAK,31,82,34,46,80
34,8481523,Kirby Dach,C,MTL,23,82,12,68,80
34,8481557,Matt Boldy,L,MIN,23,82,36,43,79
34,8476454,Ryan Nugent-Hopkins,C,EDM,31,82,24,54,78
34,8478864,Kirill Kaprizov,L,MIN,27,82,46,31,77
34,8480069,Cale Makar,D,COL,26,82,21,56,77
34,8477946,Dylan Larkin,C,DET,28,82,33,43,76
34,8477404,Jake Guentzel,C,CAR,30,82,32,44,76
34,8478414,Timo Meier,R,NJD,28,82,39,36,75
34,8480012,Elias Pettersson,C,VAN,26,82,33,41,74
34,8474564,Steven Stamkos,C,TBL,34,82,26,47,73
34,8480801,Brady Tkachuk,L,OTT,25,82,40,32,72
34,8478403,Jack Eichel,C,VGK,28,82,34,38,72
34,8477501,Valeri Nichushkin,R,COL,29,82,37,34,71
34,8477939,William Nylander,R,TOR,28,82,29,42,71
34,8479325,Charlie McAvoy,D,BOS,27,82,11,60,71
34,8471214,Alex Ovechkin,L,WSH,39,82,36,34,70
34,8475166,John Tavares,C,TOR,34,82,33,37,70
34,8476460,Mark Scheifele,C,WPG,31,82,28,41,69
34,8476389,Vincent Trocheck,C,NYR,31,82,25,44,69
34,8471675,Sidney Crosby,C,PIT,37,82,24,45,69
34,8478010,Brayden Point,C,TBL,28,82,38,30,68
34,8478493,Joel Eriksson Ek,C,MIN,27,82,36,32,68
34,8477409,Carter Verhaeghe,C,FLA,29,82,33,35,68
34,8480830,Andrei Svechnikov,R,CAR,24,82,26,42,68
34,8475692,Mats Zuccarello,R,MIN,37,82,17,51,68
34,8475754,Brock Nelson,C,NYI,33,82,38,29,67
34,8477955,Jared McCann,L,SEA,28,82,35,32,67
34,8476459,Mika Zibanejad,C,NYR,31,82,25,42,67
34,8471685,Anze Kopitar,C,LAK,37,82,19,48,67
34,8476346,Johnny Gaudreau,L,CBJ,31,82,15,52,67
34,8477949,Alex Tuch,R,BUF,28,82,26,40,66
34,8479420,Tage Thompson,C,BUF,27,82,25,41,66
34,8474600,Roman Josi,D,NSH,34,82,20,46,66
34,8479337,Alex DeBrincat,R,DET,27,82,33,32,65
34,8482097,Jack Quinn,R,BUF,23,82,26,39,65
34,8477402,Pavel Buchnevich,L,STL,29,82,23,41,64
34,8480036,Miro Heiskanen,D,DAL,25,82,13,51,64
34,8477940,Nikolaj Ehlers,L,WPG,28,82,28,35,63
34,8477416,Oliver Bjorkstrand,R,SEA,29,82,26,37,63
34,8474141,Patrick Kane,R,DET,36,82,22,41,63
34,8475172,Nazem Kadri,C,CGY,34,82,19,44,63
34,8479999,Casey Mittelstadt,C,COL,26,82,18,45,63
34,8474590,John Carlson,D,WSH,34,82,15,48,63
34,8480208,Drake Batherson,R,OTT,26,82,26,36,62
34,8474586,Jordan Eberle,R,SEA,34,82,21,41,62
34,8475913,Mark Stone,R,VGK,32,82,16,46,62
34,8476853,Morgan Rielly,D,TOR,30,82,12,50,62
34,8480188,Fabian Zetterlund,L,SJS,25,82,35,26,61
34,8482740,Wyatt Johnston,C,DAL,21,82,28,33,61
34,8480002,Nico Hischier,C,NJD,25,82,25,36,61
34,8479323,Adam Fox,D,NYR,26,82,15,46,61
34,8480865,Noah Dobson,D,NYI,24,82,12,49,61
34,8477504,Josh Morrissey,D,WPG,29,82,10,51,61
34,8475786,Zach Hyman,L,EDM,32,82,34,26,60
34,8478498,Jake DeBrusk,L,BOS,28,82,30,30,60
34,8478444,Brock Boeser,R,VAN,27,82,27,33,60
34,8479339,Patrik Laine,L,CBJ,26,82,23,37,60
34,8475765,Vladimir Tarasenko,R,FLA,33,82,20,40,60
34,8482684,Luke Hughes,D,NJD,21,82,16,44,60
34,8470794,Joe Pavelski,C,DAL,40,82,26,33,59
34,8479385,Jordan Kyrou,C,STL,26,82,24,35,59
34,8478445,Mathew Barzal,C,NYI,27,82,22,37,59
34,8482665,Matty Beniers,C,SEA,22,82,20,39,59
34,8475168,Matt Duchene,C,DAL,33,82,18,41,59
34,8480800,Quinn Hughes,D,VAN,25,82,10,49,59
34,8478449,Roope Hintz,C,DAL,28,82,27,31,58
34,8473994,Jamie Benn,L,DAL,35,82,22,36,58
34,8473419,Brad Marchand,L,BOS,36,82,19,39,58
34,8474578,Erik Karlsson,D,PIT,34,82,15,43,58
34,8479675,Trevor Moore,L,LAK,29,82,27,30,57
34,8482175,JJ Peterka,R,BUF,22,82,27,30,57
34,8476881,Tomas Hertl,C,VGK,31,82,22,35,57
34,8477500,Bo Horvat,C,NYI,29,82,28,28,56
34,8478047,Michael Bunting,L,PIT,29,82,26,30,56
34,8480798,Philipp Kurashev,C,CHI,25,82,20,36,56
34,8475798,Mikael Granlund,C,SJS,32,82,7,49,56
34,8483808,Andrei Kuzmenko,L,CGY,28,82,33,22,55
34,8475184,Chris Kreider,L,NYR,33,82,31,24,55
34,8475810,Bryan Rust,R,PIT,32,82,26,29,55
34,8471215,Evgeni Malkin,C,PIT,38,82,25,30,55
34,8476479,Phillip Danault,C,LAK,31,82,25,30,55
34,8482093,Seth Jarvis,C,CAR,22,82,24,31,55
34,8477960,Adrian Kempe,R,LAK,28,82,23,32,55
34,8480839,Rasmus Dahlin,D,BUF,24,82,17,38,55
34,8480803,Evan Bouchard,D,EDM,25,82,15,40,55
34,8477942,Kevin Fiala,L,LAK,28,82,14,41,55
34,8475167,Victor Hedman,D,TBL,34,82,9,46,55
34,8476539,Jonathan Marchessault,R,VGK,34,82,36,18,54
34,8475726,Tyler Toffoli,C,WPG,32,82,29,25,54
34,8477451,Ryan Hartman,R,MIN,30,82,27,27,54
34,8481068,Yegor Sharangovich,C,CGY,26,82,23,31,54
34,8478427,Sebastian Aho,C,CAR,27,82,22,32,54
34,8478873,Troy Terry,R,ANA,27,82,19,35,54
34,8477951,Nick Schmaltz,C,ARI,28,82,18,36,54
34,8482078,Lucas Raymond,L,DET,22,82,17,37,54
34,8475745,Charlie Coyle,C,BOS,32,82,16,38,54
34,8476462,Dougie Hamilton,D,NJD,31,82,16,38,54
34,8477447,Shea Theodore,D,VGK,29,82,12,42,54
34,8480064,Josh Norris,C,OTT,25,82,37,16,53
34,8478401,Pavel Zacha,C,BOS,27,82,23,30,53
34,8480018,Nick Suzuki,C,MTL,25,82,22,31,53
34,8475170,Brayden Schenn,C,STL,33,82,20,33,53
34,8480078,Filip Chytil,C,NYR,25,82,20,33,53
34,8477444,Andre Burakovsky,L,SEA,29,82,17,36,53
34,8473512,Claude Giroux,R,OTT,36,82,14,39,53
34,8478469,Thomas Chabot,D,OTT,27,82,11,42,53
34,8480015,Owen Tippett,R,PHI,25,82,27,25,52
34,8481528,Dylan Cozens,C,BUF,23,82,21,31,52
34,8474102,David Perron,L,DET,36,82,20,32,52
34,8478440,Dylan Strome,C,WSH,27,82,20,32,52
34,8478407,Vince Dunn,D,SEA,28,82,10,42,52
34,8479425,Filip Hronek,D,VAN,27,82,8,44,52
34,8480014,Gabriel Vilardi,C,WPG,25,82,27,24,51
34,8474150,Mikael Backlund,C,CGY,35,82,22,29,51
34,8475158,Ryan O'Reilly,C,NSH,33,82,22,29,51
34,8482109,Alexis Lafrenière,L,NYR,23,82,22,29,51
34,8480009,Eeli Tolvanen,R,SEA,25,82,22,29,51
34,8478462,Nicolas Roy,C,VGK,27,82,18,33,51
34,8476905,Chandler Stephenson,C,VGK,30,82,14,37,51
34,8479542,Brandon Hagel,L,TBL,26,82,22,28,50
34,8475784,Jeff Skinner,C,BUF,32,82,21,29,50
34,8477964,Ivan Barbashev,C,VGK,29,82,19,31,50
34,8471724,Kris Letang,D,PIT,37,82,13,37,50
34,8476875,Mike Matheson,D,MTL,30,82,10,40,50
34,8478398,Kyle Connor,L,WPG,28,82,24,25,49
34,8482745,Mason McTavish,C,ANA,21,82,24,25,49
34,8476399,Blake Coleman,C,CGY,33,82,22,27,49
34,8478856,Conor Garland,R,VAN,28,82,19,30,49
34,8477496,Elias Lindholm,C,VAN,30,82,16,33,49
34,8480039,Martin Necas,C,CAR,25,82,16,33,49
34,8476456,Jonathan Huberdeau,C,CGY,31,82,11,38,49
34,8482110,Dawson Mercer,C,NJD,23,82,24,24,48
34,8471698,T.J. Oshie,R,WSH,38,82,24,24,48
34,8480031,Maxime Comtois,L,CAR,25,82,19,29,48
34,8478542,Evan Rodrigues,C,FLA,31,82,15,33,48
34,8480797,Joel Farabee,L,PHI,24,82,13,35,48
34,8481581,Thomas Harley,D,DAL,23,82,13,35,48
34,8474563,Drew Doughty,D,LAK,35,82,10,38,48
34,8473986,Alex Killorn,L,ANA,35,82,24,23,47
34,8477407,Anthony Duclair,L,TBL,29,82,20,27,47
34,8481596,Shane Pinto,C,OTT,24,82,19,28,47
34,8478038,Devon Toews,D,COL,30,82,9,38,47
34,8483524,Shane Wright,C,SEA,20,82,31,15,46
34,8475768,Jaden Schwartz,C,SEA,32,82,21,25,46
34,8478438,Tommy Novak,C,NSH,27,82,19,27,46
34,8482124,Quinton Byfield,R,LAK,22,82,16,30,46
34,8477495,Seth Jones,D,CHI,30,82,16,30,46
34,8477456,J.T. Compher,L,DET,29,82,15,31,46
34,8474565,Alex Pietrangelo,D,VGK,34,82,12,34,46
34,8478460,Zach Werenski,D,CBJ,27,82,6,40,46
34,8474157,Max Pacioretty,L,WSH,36,82,21,24,45
34,8478458,Jack Roslovic,C,NYR,27,82,16,29,45
34,8478472,Mathieu Joseph,R,OTT,27,82,13,32,45
34,8477948,Travis Sanheim,D,PHI,28,82,12,33,45
34,8483397,Marc McLaughlin,C,BOS,25,82,38,6,44
34,8477476,Artturi Lehkonen,L,COL,29,82,24,20,44
34,8476448,William Karlsson,C,VGK,31,82,23,21,44
34,8476880,Tom Wilson,R,WSH,30,82,18,26,44
34,8475744,Evgeny Kuznetsov,C,CAR,32,82,18,26,44
34,8476826,Yanni Gourde,C,SEA,33,82,18,26,44
34,8479400,Pierre-Luc Dubois,L,LAK,26,82,16,28,44
34,8479525,Ross Colton,C,COL,28,82,15,29,44
34,8475197,Tyson Barrie,D,NSH,33,82,12,32,44
34,8477932,Aaron Ekblad,D,FLA,28,82,9,35,44
34,8476483,Rickard Rakell,R,PIT,31,82,23,20,43
34,8482699,Dylan Guenther,R,ARI,21,82,23,20,43
34,8481618,Alex Newhook,C,MTL,23,82,20,23,43
34,8482667,William Eklund,L,SJS,22,82,19,24,43
34,8475791,Taylor Hall,L,CHI,33,82,19,24,43
34,8481711,Matias Maccelli,L,ARI,24,82,16,27,43
34,8478975,Mason Marchment,L,DAL,29,82,14,29,43
34,8477346,MacKenzie Weegar,D,CGY,30,82,11,32,43
34,8479410,Mikhail Sergachev,D,TBL,26,82,8,35,43
34,8481699,Aku Raty,R,ARI,23,82,1,42,43
34,8478366,Frank Vatrano,R,ANA,30,82,21,21,42
34,8477935,Sam Bennett,C,FLA,28,82,21,21,42
34,8478474,Lawson Crouse,L,ARI,27,82,21,21,42
34,8478046,Danton Heinen,L,BOS,29,82,20,22,42
34,8479415,Michael McLeod,C,NJD,26,82,20,22,42
34,8475794,Tyler Seguin,C,DAL,32,82,18,24,42
34,8480028,Morgan Frost,C,PHI,25,82,18,24,42
34,8482159,Tyson Foerster,R,PHI,22,82,17,25,42
34,8478466,Daniel Sprong,R,DET,27,82,17,25,42
34,8475763,Kevin Hayes,R,STL,32,82,16,26,42
34,8479345,Jakob Chychrun,D,OTT,26,82,15,27,42
34,8479987,Morgan Geekie,C,BOS,26,82,15,27,42
34,8476292,Ondrej Palat,L,NJD,33,82,15,27,42
34,8477494,Jonathan Drouin,L,COL,29,82,10,32,42
34,8476923,Damon Severson,D,CBJ,30,82,6,36,42
34,8480849,Barrett Hayton,C,ARI,24,82,21,20,41
34,8477511,Anthony Mantha,R,VGK,30,82,19,22,41
34,8483515,Juraj Slafkovsky,L,MTL,20,82,15,26,41
34,8482720,Matthew Knies,L,TOR,22,82,9,32,41
34,8478397,Rasmus Andersson,D,CGY,28,82,4,37,41
34,8474716,Jared Spurgeon,D,MIN,35,82,4,37,41
34,8483457,Lane Hutson,D,MTL,20,82,2,39,41
34,8480893,Kirill Marchenko,R,CBJ,24,82,23,17,40
34,8482702,Logan Stankoven,C,DAL,21,82,22,18,40
34,8475169,Evander Kane,L,EDM,33,82,21,19,40
34,8478233,Andrew Mangiapane,L,CGY,28,82,15,25,40
34,8482222,Alexander Barabanov,L,SJS,30,82,15,25,40
34,8481533,Trevor Zegras,C,ANA,23,82,13,27,40
34,8478396,Noah Hanifin,D,VGK,27,82,8,32,40
34,8470613,Brent Burns,D,CAR,39,82,6,34,40
34,8476432,Boone Jenner,C,CBJ,31,82,29,10,39
34,8477479,Tyler Bertuzzi,L,TOR,29,82,16,23,39
34,8476872,Scott Laughton,C,PHI,30,82,15,24,39
34,8482133,Thomas Bordeleau,C,SJS,22,82,14,25,39
34,8477986,Brandon Montour,D,FLA,30,82,12,27,39
34,8477021,Alex Kerfoot,C,ARI,30,82,11,28,39
34,8475753,Justin Faulk,D,STL,32,82,10,29,39
34,8476958,Jaccob Slavin,D,CAR,30,82,9,30,39
34,8481542,Moritz Seider,D,DET,23,82,8,31,39
34,8475218,Mattias Ekholm,D,EDM,34,82,5,34,39
34,8482733,Logan Mailloux,D,MTL,31,82,5,34,39
34,8475151,Kyle Palmieri,C,NYI,33,82,25,13,38
34,8482089,Jake Neighbours,L,STL,22,82,17,21,38
34,8478020,Michael Amadio,C,VGK,28,82,16,22,38
34,8476329,Travis Boyd,C,ARI,31,82,15,23,38
34,8484144,Connor Bedard,C,CHI,19,82,14,24,38
34,8476419,Jean-Gabriel Pageau,C,NYI,32,82,14,24,38
34,8474679,Gustav Nyquist,C,NSH,35,82,13,25,38
34,8476854,Hampus Lindholm,D,BOS,30,82,6,32,38
34,8475714,Calle Jarnkrok,C,TOR,33,82,20,17,37
34,8475287,Erik Haula,L,NJD,33,82,19,18,37
34,8478055,Gustav Forsling,D,FLA,28,82,17,20,37
34,8480068,Ryan Poehling,C,PHI,25,82,17,20,37
34,8480220,Noah Cates,L,PHI,25,82,16,21,37
34,8478519,Anthony Cirelli,C,TBL,27,82,15,22,37
34,8478413,Jordan Greenway,L,BUF,27,82,15,22,37
34,8473533,Jordan Staal,C,CAR,36,82,15,22,37
34,8480434,Sean Durzi,D,ARI,26,82,11,26,37
34,8481703,Valtteri Puustinen,R,PIT,25,82,9,28,37
34,8482671,Owen Power,D,BUF,22,82,5,32,37
34,8476438,Brandon Saad,L,STL,32,82,24,12,36
34,8474149,Evgenii Dadonov,R,DAL,35,82,21,15,36
34,8481604,Pavel Dorofeyev,L,VGK,24,82,19,17,36
34,8479365,Trent Frederic,C,BOS,26,82,18,18,36
34,8481704,Juuso Parssinen,C,NSH,23,82,18,18,36
34,8480113,Alex Iafallo,L,WPG,31,82,17,19,36
34,8481535,Nils Hoglander,L,VAN,24,82,16,20,36
34,8481624,Ilya Mikheyev,R,VAN,30,82,16,20,36
34,8477503,Max Domi,C,TOR,29,82,13,23,36
34,8476882,Teuvo Teravainen,L,CAR,30,82,13,23,36
34,8481606,Jordan Spence,D,LAK,23,82,13,23,36
34,8476925,Colton Sissons,C,NSH,31,82,11,25,36
34,8473449,Kyle Okposo,R,FLA,36,82,20,15,35
34,8481554,Kaapo Kakko,R,NYR,23,82,18,17,35
34,8475191,Reilly Smith,R,PIT,33,82,11,24,35
34,8476869,Brady Skjei,D,CAR,30,82,10,25,35
34,8476906,Shayne Gostisbehere,D,DET,31,82,8,27,35
34,8475764,Cam Fowler,D,ANA,33,82,7,28,35
34,8482105,Jake Sanderson,D,OTT,22,82,6,29,35
34,8475314,Anders Lee,L,NYI,34,82,24,10,34
34,8475848,Brendan Gallagher,R,MTL,32,82,18,16,34
34,8477947,Sonny Milano,L,WSH,28,82,17,17,34
34,8479390,Taylor Raddysh,R,CHI,26,82,17,17,34
34,8477426,Nicholas Paul,L,TBL,29,82,16,18,34
34,8477998,Warren Foegele,L,EDM,28,82,14,20,34
34,8474053,Logan Couture,C,SJS,35,82,14,20,34
34,8477429,Andrew Copp,C,DET,30,82,13,21,34
34,8483445,Cutter Gauthier,L,ANA,20,82,11,23,34
34,8482087,Kaiden Guhle,D,MTL,22,82,7,27,34
34,8478057,Dakota Joshua,C,VAN,28,82,17,16,33
34,8474870,Tyler Johnson,C,CHI,34,82,16,17,33
34,8474037,James van Riemsdyk,L,BOS,35,82,16,17,33
34,8479293,Brandon Tanev,L,SEA,33,82,16,17,33
34,8477989,Christian Dvorak,C,MTL,28,82,16,17,33
34,8476458,Ryan Strome,C,ANA,31,82,11,22,33
34,8481656,Aliaksei Protas,C,WSH,23,82,11,22,33
34,8478840,Will Borgen,D,SEA,28,82,5,28,33
34,8478115,Pierre Engvall,L,NYI,28,82,17,15,32
34,8483431,Logan Cooley,C,ARI,20,82,17,15,32
34,8482624,Daniil Miromanov,D,CGY,27,82,16,16,32
34,8474641,Adam Henrique,C,EDM,34,82,13,19,32
34,8480185,Eetu Luostarinen,C,FLA,26,82,12,20,32
34,8476897,Oskar Sundqvist,C,STL,30,82,11,21,32
34,8482475,Yegor Chinakhov,R,CBJ,23,82,9,23,32
34,8476792,Torey Krug,D,STL,33,82,6,26,32
34,8480873,Rasmus Sandin,D,WSH,24,82,5,27,32
34,8481016,Ruslan Iskhakov,C,NYI,24,82,0,32,32
34,8475793,Ryan Johansen,C,PHI,32,82,18,13,31
34,8481093,Rafael Harvey-Pinard,L,MTL,25,82,16,15,31
34,8484166,Adam Fantilli,C,CBJ,20,82,15,16,31
34,8478133,Jake Evans,C,MTL,28,82,13,18,31
34,8481580,Connor McMichael,C,WSH,23,82,13,18,31
34,8482705,Cole Sillinger,C,CBJ,21,82,12,19,31
34,8476480,Vladislav Namestnikov,C,WPG,32,82,12,19,31
34,8476374,Sean Kuraly,C,CBJ,31,82,12,19,31
34,8470604,Jeff Carter,C,PIT,39,82,12,19,31
34,8476461,Sean Couturier,C,PHI,32,82,10,21,31
34,8475149,Marcus Johansson,L,MIN,34,82,8,23,31
34,8478500,Ivan Provorov,D,CBJ,27,82,6,25,31
34,8481178,Egor Zamula,D,PHI,24,82,5,26,31
34,8478507,John Marino,D,NJD,27,82,3,28,31
34,8477944,Jakub Vrana,L,STL,28,82,19,11,30
34,8476927,Teddy Blueger,C,VAN,30,82,17,13,30
34,8480459,Pius Suter,C,VAN,28,82,16,14,30
34,8475799,Nino Niederreiter,R,WPG,32,82,14,16,30
34,8477497,Sean Monahan,C,WPG,30,82,13,17,30
34,8478891,Mason Appleton,C,WPG,28,82,12,18,30
34,8476871,Tanner Pearson,L,MTL,32,82,11,19,30
34,8483490,Pavel Mintyukov,D,ANA,21,82,10,20,30
34,8473563,Nicklas Backstrom,C,WSH,37,82,9,21,30
34,8476885,Jacob Trouba,D,NYR,30,82,7,23,30
34,8475760,Nick Bjugstad,C,ARI,32,82,16,13,29
34,8479992,Michael Rasmussen,C,DET,25,82,15,14,29
34,8470621,Corey Perry,R,EDM,39,82,15,14,29
34,8479996,Cody Glass,C,NSH,25,82,14,15,29
34,8482055,Drew O'Connor,L,PIT,26,82,13,16,29
34,8482146,Luke Evangelista,R,NSH,22,82,13,16,29
34,8482101,Danil Gushchin,L,SJS,22,82,13,16,29
34,8483491,Ivan Miroshnichenko,L,WSH,20,82,13,16,29
34,8481560,Arthur Kaliyev,R,LAK,23,82,12,17,29
34,8471218,Blake Wheeler,R,NYR,38,82,12,17,29
34,8480855,Jack McBain,C,ARI,24,82,12,17,29
34,8478109,Victor Olofsson,L,BUF,29,82,11,18,29
34,8473422,Nick Foligno,L,CHI,37,82,10,19,29
34,8477498,Darnell Nurse,D,EDM,29,82,9,20,29
34,8476902,Esa Lindell,D,DAL,30,82,7,22,29
34,8482142,Jamie Drysdale,D,PHI,22,82,6,23,29
34,8480871,Adam Boqvist,D,CBJ,24,82,6,23,29
34,8477488,Brett Pesce,D,CAR,30,82,6,23,29
34,8477969,Marcus Pettersson,D,PIT,28,82,5,24,29
34,8479398,Samuel Girard,D,COL,26,82,5,24,29
34,8478178,Darren Raddysh,D,TBL,28,82,3,26,29
34,8484203,Bradly Nadeau,L,CAR,19,82,23,5,28
34,8476469,Joel Armia,R,MTL,31,82,15,13,28
34,8480802,Ryan McLeod,C,EDM,25,82,12,16,28
34,8478911,Matt Roy,D,LAK,29,82,11,17,28
34,8477450,Jason Dickinson,C,CHI,29,82,10,18,28
34,8479393,Noah Gregor,C,TOR,26,82,9,19,28
34,8481013,Jonatan Berggren,R,DET,24,82,7,21,28
34,8476960,Andreas Athanasiou,C,CHI,30,82,7,21,28
34,8482122,Brock Faber,D,MIN,22,82,4,24,28
34,8483471,Brad Lambert,C,WPG,31,82,3,25,28
34,8477330,Dominik Kubalik,L,OTT,29,82,16,11,27
34,8476981,Josh Anderson,R,MTL,30,82,15,12,27
34,8482155,Alex Laferriere,R,LAK,23,82,15,12,27
34,8476892,Colton Parayko,D,STL,31,82,14,13,27
34,8482111,Justin Barron,D,MTL,23,82,14,13,27
34,8470610,Zach Parise,L,COL,40,82,14,13,27
34,8480074,Alexandre Texier,C,CBJ,25,82,14,13,27
34,8481186,Logan O'Connor,R,COL,28,82,13,14,27
34,8481553,Bobby Brink,R,PHI,23,82,12,15,27
34,8475722,Jason Zucker,L,NSH,32,82,11,16,27
34,8476624,Barclay Goodrow,C,NYR,31,82,11,16,27
34,8482092,Ridly Greig,C,OTT,22,82,7,20,27
34,8479514,Rem Pitlick,C,CHI,27,82,7,20,27
34,8479371,Dante Fabbro,D,NSH,26,82,7,20,27
34,8475906,John Klingberg,D,TOR,32,82,6,21,27
34,8480336,Sean Walker,D,COL,30,82,6,21,27
34,8474151,Ryan McDonagh,D,NSH,35,82,6,21,27
34,8477435,Ryan Graves,D,PIT,29,82,6,21,27
34,8481546,Cam York,D,PHI,23,82,5,22,27
34,8477506,Ryan Pulock,D,NYI,30,82,5,22,27
34,8482655,J.J. Moser,D,ARI,24,82,5,22,27
34,8480043,Timothy Liljegren,D,TOR,25,82,5,22,27
34,8480821,Filip Zadina,R,SJS,25,82,18,8,26
34,8477952,Robby Fabbri,C,DET,28,82,15,11,26
34,8481477,Nico Sturm,C,SJS,29,82,15,11,26
34,8479346,Dillon Dube,C,CGY,26,82,15,11,26
34,8479941,Justin Danforth,R,CBJ,31,82,14,12,26
34,8475343,Nic Dowd,C,WSH,34,82,13,13,26
34,8482074,Connor Zary,C,CGY,23,82,9,17,26
34,8479316,Luke Kunin,C,SJS,27,82,8,18,26
34,8476312,Josh Manson,D,COL,33,82,8,18,26
34,8482245,Artem Zub,D,OTT,29,82,4,22,26
34,8481014,Alexander Romanov,D,NYI,24,82,3,23,26
34,8482117,Lukas Reichel,L,CHI,22,82,11,14,25
34,8483499,Liam Ohgren,L,MIN,20,82,8,17,25
34,8482730,Brandt Clarke,D,LAK,21,82,8,17,25
34,8483495,Simon Nemec,D,NJD,20,82,5,20,25
34,8479423,Alex Nylander,L,CBJ,26,82,18,6,24
34,8482737,Zack Bolduc,C,STL,21,82,18,6,24
34,8484153,Leo Carlsson,C,ANA,20,82,13,11,24
34,8477953,Kasperi Kapanen,R,STL,28,82,9,15,24
34,8474884,Mike Hoffman,C,SJS,35,82,9,15,24
34,8476979,Erik Gustafsson,D,NYR,32,82,9,15,24
34,8475231,Casey Cizikas,C,NYI,33,82,9,15,24
34,8476392,Adam Lowry,C,WPG,31,82,8,16,24
34,8477369,Carson Soucy,D,VAN,30,82,7,17,24
34,8474009,Nick Bonino,C,NYR,36,82,7,17,24
34,8480246,Nick Perbix,D,TBL,26,82,2,22,24
34,8477845,Trevor van Riemsdyk,D,WSH,33,82,2,22,24
34,8476879,Cody Ceci,D,EDM,31,82,2,22,24
34,8482125,Alexander Holtz,R,NJD,22,82,14,9,23
34,8482259,Bobby McMann,C,TOR,28,82,12,11,23
34,8475220,Marcus Foligno,L,MIN,33,82,11,12,23
34,8482113,Anton Lundell,C,FLA,23,82,10,13,23
34,8477015,Connor Brown,R,EDM,30,82,10,13,23
34,8477931,Tomas Nosek,L,NJD,32,82,9,14,23
34,8474189,Lars Eller,C,PIT,35,82,8,15,23
34,8480796,Martin Fehervary,D,WSH,25,82,7,16,23
34,8479983,Mario Ferraro,D,SJS,26,82,7,16,23
34,8478831,Kevin Stenlund,C,FLA,28,82,6,17,23
34,8475324,Nick Jensen,D,WSH,34,82,5,18,23
34,8479976,Juuso Valimaki,D,ARI,26,82,5,18,23
34,8476463,Jonas Brodin,D,MIN,31,82,4,19,23
34,8478882,Vladislav Gavrikov,D,LAK,29,82,3,20,23
34,8475181,Nick Leddy,D,STL,33,82,1,22,23
34,8483493,Frank Nazar,C,CHI,20,82,19,3,22
34,8482118,Sam Colangelo,R,ANA,23,82,16,6,22
34,8477353,Tyler Motte,C,TBL,29,82,13,9,22
34,8482809,Jackson Blake,R,CAR,21,82,13,9,22
34,8478569,Noel Acciari,C,PIT,33,82,12,10,22
34,8478463,Anthony Beauvillier,L,NSH,27,82,9,13,22
34,8476921,Jordan Martinook,L,CAR,32,82,9,13,22
34,8480813,Joe Veleno,C,DET,24,82,9,13,22
34,8479351,Sam Steel,C,DAL,26,82,8,14,22
34,8477425,Miles Wood,L,COL,29,82,7,15,22
34,8476278,Colin Blackwell,C,CHI,31,82,7,15,22
34,8481522,Peyton Krebs,C,BUF,23,82,7,15,22
34,8480144,David Kampf,C,TOR,29,82,6,16,22
34,8481537,Nikita Okhotiuk,D,CGY,24,82,6,16,22
34,8470966,Mark Giordano,D,TOR,41,82,6,16,22
34,8473507,Jeff Petry,D,DET,37,82,5,17,22
34,8478851,Alexandre Carrier,D,NSH,28,82,5,17,22
34,8482073,Braden Schneider,D,NYR,23,82,5,17,22
34,8475171,Oliver Ekman-Larsson,D,FLA,33,82,3,19,22
34,8481605,Jackson LaCombe,D,ANA,23,82,0,22,22
34,8479591,Michael Eyssimont,C,TBL,28,82,13,8,21
34,8476873,Mark Jankowski,C,NSH,30,82,11,10,21
34,8477505,Alexander Wennberg,C,NYR,30,82,11,10,21
34,8479661,Tanner Jeannot,L,TBL,27,82,11,10,21
34,8475842,Sam Carrick,C,EDM,32,82,10,11,21
34,8481028,Martin Pospisil,C,CGY,25,82,9,12,21
34,8475200,Dmitry Orlov,D,CAR,33,82,8,13,21
34,8483505,Matthew Poitras,C,BOS,20,82,8,13,21
34,8477919,Frederick Gaudreau,C,MIN,31,82,8,13,21
34,8474034,Pat Maroon,L,BOS,36,82,8,13,21
34,8476525,Colin Miller,D,WPG,32,82,7,14,21
34,8477499,Rasmus Ristolainen,D,PHI,30,82,6,15,21
34,8475690,Chris Tanev,D,DAL,35,82,6,15,21
34,8476422,Mike Reilly,D,NYI,31,82,5,16,21
34,8480860,Kevin Bahl,D,NJD,24,82,3,18,21
34,8481517,Brett Leason,R,ANA,25,82,13,7,20
34,8479359,Beck Malenstyn,L,WSH,26,82,12,8,20
34,8474715,Cam Atkinson,R,PHI,35,82,7,13,20
34,8482079,Marco Rossi,C,MIN,23,82,7,13,20
34,8477508,Curtis Lazar,C,NJD,29,82,7,13,20
34,8480990,Declan Chisholm,D,MIN,24,82,7,13,20
34,8481481,Blake Lizotte,C,LAK,27,82,6,14,20
34,8480281,Alexey Toropchenko,R,STL,25,82,5,15,20
34,8480817,K'Andre Miller,D,NYR,24,82,5,15,20
34,8480806,Isac Lundestrom,C,ANA,25,82,5,15,20
34,8476467,Jamie Oleksiak,D,SEA,32,82,5,15,20
34,8480145,Neal Pionk,D,WPG,29,82,4,16,20
34,8479980,Nicolas Hague,D,VGK,26,82,3,17,20
34,8475790,Erik Gudbranson,D,CBJ,32,82,2,18,20
34,8475279,Ben Chiarot,D,DET,33,82,2,18,20
34,8480879,Jacob Bernard-Docker,D,OTT,24,82,2,18,20
34,8475188,Brayden McNabb,D,VGK,33,82,1,19,20
34,8473453,Trevor Lewis,C,LAK,37,82,11,8,19
34,8481601,Simon Holmstrom,R,NYI,23,82,10,9,19
34,8476442,Matt Nieto,L,PIT,32,82,9,10,19
34,8480980,Connor Dewar,C,TOR,25,82,9,10,19
34,8484911,Collin Graf,R,SJS,22,82,5,14,19
34,8479977,Kailer Yamamoto,R,SEA,26,82,4,15,19
34,8482679,Matt Coronato,R,CGY,22,82,4,15,19
34,8480834,Ty Emberson,D,SJS,24,82,4,15,19
34,8476891,Matt Grzelcyk,D,BOS,30,82,3,16,19
34,8476429,Scott Mayfield,D,NYI,32,82,2,17,19
34,8475762,Derek Forbort,D,BOS,32,82,2,17,19
34,8480073,Erik Brannstrom,D,OTT,25,82,2,17,19
34,8477220,Nate Schmidt,D,WPG,33,82,2,17,19
34,8476878,Zemgus Girgensons,L,BUF,30,82,10,8,18
34,8479383,Boris Katchouk,L,OTT,26,82,8,10,18
34,8477392,Hudson Fasching,R,NYI,29,82,6,12,18
34,8477507,Nikita Zadorov,D,VAN,29,82,6,12,18
34,8482062,Cole Smith,L,NSH,29,82,6,12,18
34,8482803,Olen Zellweger,D,ANA,21,82,5,13,18
34,8477406,Mattias Janmark,C,EDM,32,82,5,13,18
34,8480807,Mattias Samuelsson,D,BUF,24,82,4,14,18
34,8476457,Adam Larsson,D,SEA,32,82,2,16,18
34,8476858,Phillip Di Giuseppe,L,VAN,31,82,9,8,17
34,8478468,Jeremy Lauzon,D,NSH,27,82,7,10,17
34,8478430,Oliver Kylington,D,CGY,27,82,5,12,17
34,8483482,Tristan Luneau,D,ANA,20,82,5,12,17
34,8475208,Brian Dumoulin,D,SEA,33,82,5,12,17
34,8483565,Nick Blankenburg,D,CBJ,26,82,5,12,17
34,8478451,Ethan Bear,D,WSH,27,82,4,13,17
34,8481524,Bowen Byram,D,BUF,23,82,4,13,17
34,8482712,Oskar Olausson,R,COL,22,82,4,13,17
34,8475179,Dmitry Kulikov,D,FLA,34,82,2,15,17
34,8481568,Alex Vlasic,D,CHI,23,82,2,15,17
34,8478508,Yakov Trenin,C,COL,27,82,9,7,16
34,8480448,Parker Kelly,L,OTT,25,82,8,8,16
34,8476473,Connor Murphy,D,CHI,31,82,7,9,16
34,8475177,Calvin de Haan,D,TBL,33,82,6,10,16
34,8478416,Erik Cernak,D,TBL,27,82,5,11,16
34,8479998,Mikey Anderson,D,LAK,25,82,5,11,16
34,8477335,Kyle Burroughs,D,SJS,29,82,5,11,16
34,8483763,Maksymilian Szuber,D,ARI,22,82,5,11,16
34,8476931,Jake McCabe,D,TOR,31,82,4,12,16
34,8476331,Dylan DeMelo,D,WPG,31,82,3,13,16
34,8470600,Ryan Suter,D,DAL,39,82,3,13,16
34,8479324,Ryan Lindgren,D,NYR,26,82,3,13,16
34,8476372,Nick Seeler,D,PHI,31,82,3,13,16
34,8481567,Henry Thrun,D,SJS,23,82,2,14,16
34,8475455,Brenden Dillon,D,WPG,34,82,2,14,16
34,8475462,Radko Gudas,D,ANA,34,82,2,14,16
34,8481059,Scott Perunovich,D,STL,26,82,2,14,16
34,8483466,Kevin Korchinski,D,CHI,20,82,1,15,16
34,8478859,Niko Mikkola,D,FLA,28,82,1,15,16
34,8483012,Logan Morrison,C,SEA,22,82,9,6,15
34,8477839,Conor Sheary,L,TBL,32,82,8,7,15
34,8475164,Jakob Silfverberg,R,ANA,34,82,5,10,15
34,8482666,Scott Morrow,D,CAR,22,82,4,11,15
34,8480172,Jan Rutta,D,SJS,34,82,3,12,15
34,8476917,Adam Pelech,D,NYI,30,82,3,12,15
34,8474574,Tyler Myers,D,VAN,34,82,3,12,15
34,8480035,Henri Jokiharju,D,BUF,25,82,2,13,15
34,8479369,Andrew Peeke,D,BOS,26,82,1,14,15
34,8484145,Zach Benson,L,BUF,19,82,7,7,14
34,8478013,Jake Walman,D,DET,28,82,5,9,14
34,8473504,Cal Clutterbuck,R,NYI,37,82,4,10,14
34,8480058,Pierre-Olivier Joseph,D,PIT,25,82,4,10,14
34,8482858,Ryker Evans,D,SEA,23,82,3,11,14
34,8477365,Connor Clifton,D,BUF,29,82,3,11,14
34,8482177,Marat Khusnutdinov,C,MIN,22,82,1,13,14
34,8478043,Sam Lafferty,C,VAN,29,82,10,3,13
34,8475233,David Savard,D,MTL,34,82,5,8,13
34,8482166,Shakir Mukhamadullin,D,SJS,22,82,4,9,13
34,8478136,Jake Middleton,D,MIN,28,82,3,10,13
34,8474673,TJ Brodie,D,TOR,34,82,2,11,13
34,8476915,Jujhar Khaira,L,MIN,30,82,2,11,13
34,8476967,Brett Kulak,D,EDM,30,82,6,6,12
34,8479353,Brett Howden,C,VGK,26,82,5,7,12
34,8484149,Gavin Brindley,C,CBJ,20,82,5,7,12
34,8477034,Jaycob Megna,D,CHI,32,82,3,9,12
34,8481599,Victor Soderstrom,D,ARI,23,82,3,9,12
34,8478443,Brandon Carlo,D,BOS,28,82,2,10,12
34,8474166,Alec Martinez,D,VGK,37,82,3,8,11
34,8474567,Zach Bogosian,D,MIN,34,82,3,8,11
34,8471677,Jack Johnson,D,COL,37,82,3,8,11
34,8475825,Jani Hakanpää,D,DAL,32,82,2,9,11
34,8478399,Jonas Siegenthaler,D,NJD,27,82,2,9,11
34,8482762,Simon Edvinsson,D,DET,21,82,7,3,10
34,8476822,Luke Glendening,C,TBL,35,82,4,6,10
34,8482516,Matthew Kessel,D,STL,24,82,1,9,10
34,8474013,Ian Cole,D,VAN,35,82,0,10,10
34,8482470,Ilya Solovyov,D,CGY,24,82,0,10,10
34,8482145,Mavrik Bourque,C,DAL,22,82,7,2,9
34,8479291,Kevin Rooney,C,CGY,31,82,6,3,9
34,8481578,Graeme Clarke,R,NJD,23,82,6,3,9
34,8479442,Troy Stecher,D,EDM,30,82,5,4,9
34,8478408,Travis Dermott,D,ARI,28,82,4,5,9
34,8483489,Fraser Minten,C,TOR,31,82,3,6,9
34,8482713,Mackie Samoskevich,R,FLA,22,82,4,4,8
34,8481030,Jack St. Ivany,D,PIT,25,82,1,7,8
34,8483468,Jiri Kulich,C,BUF,20,82,2,5,7
34,8482859,Zack Ostapchuk,C,OTT,21,82,2,5,7
34,8482807,Ethan Del Mastro,D,CHI,21,82,1,6,7
34,8482141,Lukas Cormier,D,VGK,22,0,0,0,0
34,8476988,Matt Benning,D,SJS,30,0,0,0,0
34,8480727,Zach Whitecloud,D,VGK,28,0,0,0,0
34,8480887,Jordan Harris,D,MTL,24,0,0,0,0
34,8478450,Parker Wotherspoon,D,BOS,27,0,0,0,0
34,8481812,Nikolai Knyzhov,D,SJS,27,0,0,0,0
34,8480001,Urho Vaakanainen,D,ANA,25,0,0,0,0
34,8482176,Wyatt Kaiser,D,CHI,22,0,0,0,0
34,8481122,Simon Benoit,D,TOR,26,0,0,0,0
34,8476441,Joel Edmundson,D,TOR,31,0,0,0,0
34,8480884,Calen Addison,D,SJS,24,0,0,0,0
34,8482511,Mason Lohrei,D,BOS,23,0,0,0,0
34,8482192,Isaak Phillips,D,CHI,23,0,0,0,0
34,8480950,Ilya Lyubushkin,D,TOR,30,0,0,0,0
34,8474031,Kevin Shattenkirk,D,BOS,35,0,0,0,0
34,8475718,Justin Holl,D,DET,32,0,0,0,0
34,8479402,Jake Bean,D,CBJ,26,0,0,0,0
34,8474602,Justin Schultz,D,SEA,34,0,0,0,0
34,8477950,Tony DeAngelo,D,CAR,29,0,0,0,0
34,8481743,Marc Del Gaizo,D,NSH,25,0,0,0,0
34,8481527,Kaedan Korczak,D,VGK,23,0,0,0,0
34,8480192,Johnathan Kovacevic,D,MTL,27,0,0,0,0
34,8476874,Olli Maatta,D,DET,30,0,0,0,0
34,8482144,Jack Thompson,D,SJS,22,0,0,0,0
34,8480222,Sebastian Aho,D,NYI,28,0,0,0,0
34,8479458,Nikita Zaitsev,D,CHI,33,0,0,0,0
34,8471709,Marc-Edouard Vlasic,D,SJS,37,0,0,0,0
34,8482929,Emil Lilleberg,D,TBL,23,0,0,0,0
34,8477018,Ben Hutton,D,VGK,31,0,0,0,0
34,8481056,Spencer Stastney,D,NSH,24,0,0,0,0
34,8481593,Jayden Struble,D,MTL,23,0,0,0,0
34,8479982,Conor Timmins,D,TOR,26,0,0,0,0
34,8474090,Brendan Smith,D,NJD,35,0,0,0,0
34,8482964,Arber Xhekaj,D,MTL,23,0,0,0,0
34,8480891,Michael Kesselring,D,ARI,24,0,0,0,0
34,8477938,Haydn Fleury,D,TBL,28,0,0,0,0
34,8481806,Louis Crevier,D,CHI,23,0,0,0,0
34,8471274,Alex Goligoski,D,MIN,39,0,0,0,0
34,8481600,Tobias Bjornfot,D,FLA,23,0,0,0,0
34,8475797,Jarred Tinordi,D,CHI,32,0,0,0,0
34,8481521,Ronnie Attard,D,PHI,25,0,0,0,0
34,8474612,Travis Hamonic,D,OTT,34,0,0,0,0
34,8479576,Vincent Desharnais,D,EDM,28,0,0,0,0
34,8480049,Dylan Samberg,D,WPG,25,0,0,0,0
34,8483619,Filip Roos,D,CHI,25,0,0,0,0
34,8474568,Luke Schenn,D,NSH,35,0,0,0,0
34,8480184,Gustav Lindstrom,D,ANA,26,0,0,0,0
34,8480070,Ian Mitchell,D,BOS,25,0,0,0,0
34,8480196,Jacob Bryson,D,BUF,27,0,0,0,0
34,8471686,Marc Staal,D,PHI,37,0,0,0,0
34,8477467,Gustav Olofsson,D,SEA,30,0,0,0,0
34,8478970,Jalen Chatfield,D,CAR,28,0,0,0,0
34,8479348,Kale Clague,D,BUF,26,0,0,0,0
34,8473446,Erik Johnson,D,PHI,36,0,0,0,0
34,8477462,Robert Hagg,D,ANA,29,0,0,0,0
34,8478454,Noah Juulsen,D,VAN,27,0,0,0,0
34,8477384,Josh Brown,D,ARI,30,0,0,0,0
34,8481708,Zac Jones,D,NYR,24,0,0,0,0
34,8481167,Brayden Pachal,D,CGY,25,0,0,0,0
34,8482067,Connor Mackey,D,NYR,28,0,0,0,0
34,8483460,David Jiricek,D,CBJ,21,0,0,0,0
34,8481701,Santeri Hatakka,D,NJD,23,0,0,0,0
34,8478021,William Lagesson,D,ANA,28,0,0,0,0
34,8477851,Jordan Oesterle,D,CGY,32,0,0,0,0
34,8478452,Caleb Jones,D,COL,27,0,0,0,0
34,8479984,Cal Foote,D,NJD,26,0,0,0,0
34,8479639,Dylan Coghlan,D,CAR,26,0,0,0,0
34,8480874,Adam Ginning,D,PHI,24,0,0,0,0
34,8479321,Lucas Johansen,D,WSH,27,0,0,0,0
34,8480878,Nils Lundkvist,D,DAL,24,0,0,0,0
34,8482165,Yan Kuznetsov,D,CGY,22,0,0,0,0
34,8484258,Sam Malinski,D,COL,26,0,0,0,0
34,8480157,Calle Rosen,D,STL,30,0,0,0,0
34,8484304,Uvis Balinskis,D,FLA,28,0,0,0,0
34,8479985,Cale Fleury,D,SEA,26,0,0,0,0
34,8479378,Logan Stanley,D,WPG,26,0,0,0,0
34,8477541,Dakota Mermis,D,MIN,30,0,0,0,0
34,8481609,Vladislav Kolyachonok,D,ARI,23,0,0,0,0
34,8480823,Alexander Alexeyev,D,WSH,25,0,0,0,0
34,8481679,Maxence Guenette,D,OTT,23,0,0,0,0
34,8481564,Ryan Johnson,D,BUF,23,0,0,0,0
34,8479376,Victor Mete,D,PHI,26,0,0,0,0
34,8484254,Akito Hirose,D,VAN,25,0,0,0,0
34,8482660,Kent Johnson,C,CBJ,22,0,0,0,0
34,8482149,Cole Perfetti,C,WPG,22,0,0,0,0
34,8477987,Ryan Donato,C,CHI,28,0,0,0,0
34,8475755,Alexander Petrovic,D,DAL,32,0,0,0,0
34,8477810,Joel Hanley,D,CGY,33,0,0,0,0
34,8474145,Robert Bortuzzo,D,NYI,35,0,0,0,0
34,8481161,Jake Christiansen,D,CBJ,25,0,0,0,0
34,8476884,Derrick Pouliot,D,DAL,30,0,0,0,0
34,8481716,Dmitri Voronkov,L,CBJ,24,0,0,0,0
34,8480084,Nick DeSimone,D,NJD,30,0,0,0,0
34,8475750,Jon Merrill,D,MIN,32,0,0,0,0
34,8479315,Joey Anderson,R,CHI,26,0,0,0,0
34,8478011,Louie Belpedio,D,PHI,28,0,0,0,0
34,8482451,Mikael Pyyhtia,L,CBJ,23,0,0,0,0
34,8481541,Samuel Bolduc,D,NYI,24,0,0,0,0
34,8482126,Emil Andrae,D,PHI,31,0,0,0,0
34,8474618,Marco Scandella,D,STL,34,0,0,0,0
34,8477244,Chad Ruhwedel,D,NYR,34,0,0,0,0
34,8477971,Andreas Englund,D,LAK,28,0,0,0,0
34,8480829,Jesperi Kotkaniemi,C,CAR,24,0,0,0,0
34,8479372,Josh Mahura,D,FLA,26,0,0,0,0
34,8482095,Tyler Kleven,D,OTT,22,0,0,0,0
34,8481719,Maxwell Crozier,D,TBL,24,0,0,0,0
34,8475855,Jesper Fast,R,CAR,33,0,0,0,0
34,8480848,Ty Dellandrea,C,DAL,24,0,0,0,0
34,8475193,Tomas Tatar,L,SEA,34,0,0,0,0
34,8476889,Radek Faksa,C,DAL,30,0,0,0,0
34,8478495,Denis Gurianov,R,PHI,27,0,0,0,0
34,8480216,Jacob Peterson,C,SJS,25,0,0,0,0
34,8480252,Cole Guttman,C,CHI,25,0,0,0,0
34,8479026,Philippe Myers,D,TBL,27,0,0,0,0
34,8481006,Tyler Tucker,D,STL,24,0,0,0,0
34,8481032,Paul Cotter,C,VGK,25,0,0,0,0
34,8481577,Philip Tomasino,C,NSH,23,0,0,0,0
34,8476918,Jimmy Vesey,L,NYR,31,0,0,0,0
34,8479320,Max Lajoie,D,TOR,27,0,0,0,0
34,8478017,Mark Friedman,D,VAN,29,0,0,0,0
34,8481754,Nikita Nesterenko,C,ANA,23,0,0,0,0
34,8483407,Brandon Scanlin,D,NYR,25,0,0,0,0
34,8482659,Josh Doan,R,ARI,22,0,0,0,0
34,8477446,Michael McCarron,R,NSH,29,0,0,0,0
34,8477903,Garnet Hathaway,R,PHI,33,0,0,0,0
34,8482153,Brendan Brisson,C,VGK,23,0,0,0,0
34,8483546,Marshall Rifai,D,TOR,26,0,0,0,0
34,8484287,Cole McWard,D,VAN,23,0,0,0,0
34,8478854,Ryan Shea,D,PIT,27,0,0,0,0
34,8481585,Egor Afanasyev,L,NSH,23,0,0,0,0
34,8483398,Declan Carlile,D,TBL,31,0,0,0,0
34,8478502,Dennis Gilbert,D,CGY,28,0,0,0,0
34,8482749,Joshua Roy,R,MTL,21,0,0,0,0
34,8481598,Philip Broberg,D,EDM,23,0,0,0,0
34,8480835,Jack Drury,C,CAR,24,0,0,0,0
34,8480748,Kiefer Sherwood,L,NSH,29,0,0,0,0
34,8476934,Brock McGinn,L,ANA,30,0,0,0,0
34,8480870,Bo Groulx,C,ANA,24,0,0,0,0
34,8479368,Max Jones,L,ANA,26,0,0,0,0
34,8478099,Kevin Labanc,R,SJS,29,0,0,0,0
34,8478067,Oskar Lindblom,L,SJS,28,0,0,0,0
34,8476393,Nick Cousins,C,FLA,31,0,0,0,0
34,8483395,Arshdeep Bains,L,VAN,23,0,0,0,0
34,8480762,Eric Robinson,L,BUF,29,0,0,0,0
34,8479439,Jacob MacDonald,D,SJS,31,0,0,0,0
34,8476474,Stefan Noesen,R,CAR,31,0,0,0,0
34,8482787,Nikita Chibrikov,R,WPG,31,0,0,0,0
34,8478432,Christian Fischer,R,DET,27,0,0,0,0
34,8477979,Nicolas Aube-Kubel,R,WSH,28,0,0,0,0
34,8481789,Tye Kartye,L,SEA,23,0,0,0,0
34,8479330,Brandon Gignac,C,MTL,27,0,0,0,0
34,8480075,Cameron Crotty,D,ARI,25,0,0,0,0
34,8473473,Milan Lucic,L,BOS,36,0,0,0,0
34,8482094,Daemon Hunt,D,MIN,22,0,0,0,0
34,8481206,John Ludvig,D,PIT,24,0,0,0,0
34,8483630,Pavol Regenda,L,ANA,25,0,0,0,0
34,8481617,Vasily Podkolzin,R,VAN,23,0,0,0,0
34,8480306,Grant Hutton,D,NYI,29,0,0,0,0
34,8480995,Pontus Holmberg,R,TOR,25,0,0,0,0
34,8482148,Hendrix Lapierre,C,WSH,22,0,0,0,0
34,8477478,William Carrier,L,VGK,30,0,0,0,0
34,8480003,Jesper Boqvist,C,BOS,26,0,0,0,0
34,8482172,Landon Slaggert,L,CHI,22,0,0,0,0
34,8480789,Oliver Wahlstrom,R,NYI,24,0,0,0,0
34,8474062,Riley Nash,C,NYR,35,0,0,0,0
34,8480021,Jack Studnicka,C,SJS,25,0,0,0,0
34,8480025,MacKenzie Entwistle,R,CHI,25,0,0,0,0
34,8481582,Nicholas Robertson,L,TOR,23,0,0,0,0
34,8476867,Brendan Gaunce,C,CBJ,30,0,0,0,0
34,8479619,Michael Carcone,L,ARI,28,0,0,0,0
34,8479370,Tyson Jost,C,BUF,26,0,0,0,0
34,8479671,Mathieu Olivier,R,CBJ,27,0,0,0,0
34,8476994,Vinnie Hinostroza,C,PIT,30,0,0,0,0
34,8482070,Mitchell Chaffee,R,TBL,26,0,0,0,0
34,8477473,Justin Bailey,R,SJS,29,0,0,0,0
34,8479344,Jesse Puljujarvi,R,PIT,26,0,0,0,0
34,8480205,Emil Bemstrom,C,PIT,25,0,0,0,0
34,8479718,Alex Barré-Boulet,C,TBL,27,0,0,0,0
34,8482061,Brandon Biro,L,BUF,26,0,0,0,0
34,8479638,Justin Brazeau,R,BOS,26,0,0,0,0
34,8474040,Sam Gagner,C,EDM,35,0,0,0,0
34,8477846,Ryan Carpenter,C,SJS,33,0,0,0,0
34,8482077,Dylan Holloway,L,EDM,23,0,0,0,0
34,8482157,Will Cuylle,L,NYR,22,0,0,0,0
34,8480007,Jonas Rondbjerg,R,VGK,25,0,0,0,0
34,8478874,Adam Gaudette,C,STL,28,0,0,0,0
34,8478434,Keegan Kolesar,R,VGK,27,0,0,0,0
34,8480441,Trey Fix-Wolansky,R,CBJ,25,0,0,0,0
34,8479994,Jaret Anderson-Dolan,C,NSH,25,0,0,0,0
34,8483567,Georgii Merkulov,C,BOS,24,0,0,0,0
34,8477380,Jonny Brodzinski,C,NYR,31,0,0,0,0
34,8482201,Gage Goncalves,C,TBL,23,0,0,0,0
34,8478211,Dryden Hunt,L,CGY,29,0,0,0,0
34,8471699,Andrew Cogliano,C,COL,37,0,0,0,0
34,8479421,Jacob Moverare,D,LAK,26,0,0,0,0
34,8478881,Brett Seney,L,CHI,28,0,0,0,0
34,8477464,Nic Petan,C,MIN,29,0,0,0,0
34,8475958,Michael Sgarbossa,C,WSH,32,0,0,0,0
34,8481147,Reese Johnson,C,CHI,26,0,0,0,0
34,8479336,Carl Grundstrom,R,LAK,27,0,0,0,0
34,8480853,Liam Foudy,C,NSH,24,0,0,0,0
34,8479522,Hardy Haman Aktell,D,WSH,26,0,0,0,0
34,8481462,Mason Morelli,L,VGK,28,0,0,0,0
34,8482102,Vasily Ponomarev,C,CAR,22,0,0,0,0
34,8480844,Grigori Denisenko,L,VGK,24,0,0,0,0
34,8479944,Zach Aston-Reese,C,DET,30,0,0,0,0
34,8482784,Zach Dean,C,STL,21,0,0,0,0
34,8479419,Brett Murray,L,BUF,26,0,0,0,0
34,8479520,Brandon Duhaime,R,COL,27,0,0,0,0
34,8477573,Nathan Walker,L,STL,30,0,0,0,0
34,8478078,Rourke Chartier,C,OTT,28,0,0,0,0
34,8475795,Dylan McIlrath,D,WSH,32,0,0,0,0
34,8482496,Nils Aman,C,VAN,24,0,0,0,0
34,8480289,Morgan Barron,C,WPG,26,0,0,0,0
34,8481751,Lukas Rousek,R,BUF,25,0,0,0,0
34,8480011,Klim Kostin,C,SJS,25,0,0,0,0
34,8481556,John Beecher,C,BOS,23,0,0,0,0
34,8475278,Byron Froese,C,VGK,33,0,0,0,0
34,8475225,Craig Smith,C,DAL,35,0,0,0,0
34,8484326,Patrik Koch,D,ARI,28,0,0,0,0
34,8477930,Pierre-Edouard Bellemare,L,SEA,39,0,0,0,0
34,8478409,Anthony Richard,C,BOS,28,0,0,0,0
34,8481024,Linus Karlsson,C,VAN,25,0,0,0,0
34,8479986,Kole Lind,R,SEA,26,0,0,0,0
34,8479414,Nathan Bastian,R,NJD,27,0,0,0,0
34,8479362,Riley Tufte,L,COL,26,0,0,0,0
34,8481058,Jesse Ylönen,R,MTL,25,0,0,0,0
34,8482476,Emil Heineman,L,MTL,23,0,0,0,0
34,8482861,Vincent Iorio,D,WSH,22,0,0,0,0
34,8483432,Luca Del Bel Belluz,C,CBJ,31,0,0,0,0
34,8482744,James Malatesta,L,CBJ,21,0,0,0,0
34,8477887,Patrick Brown,C,BOS,32,0,0,0,0
34,8478585,Derek Ryan,C,EDM,38,0,0,0,0
34,8481441,Joe Snively,C,WSH,28,0,0,0,0
34,8481592,Jakob Pelletier,L,CGY,23,0,0,0,0
34,8482634,Alex Steeves,C,TOR,25,0,0,0,0
34,8477126,Jayson Megna,C,BOS,34,0,0,0,0
34,8475752,Tyler Pitlick,C,NYR,33,0,0,0,0
34,8480008,Adam Ruzicka,C,ARI,25,0,0,0,0
34,8481065,Angus Crookshank,L,OTT,25,0,0,0,0
34,8479547,Matthew Phillips,R,WSH,26,0,0,0,0
34,8480226,Marián Studenic,R,SEA,26,0,0,0,0
34,8481237,Kyle MacLean,C,NYI,25,0,0,0,0
34,8475413,Justin Dowling,C,NJD,34,0,0,0,0
34,8481641,Joel Kiviranta,L,COL,28,0,0,0,0
34,8478104,Sammy Blais,L,STL,28,0,0,0,0
34,8477454,Adam Erne,L,EDM,29,0,0,0,0
34,8481518,Nolan Foote,L,NJD,24,0,0,0,0
34,8480245,Olle Lycksell,R,PHI,25,0,0,0,0
34,8483570,Ben Meyers,C,ANA,26,0,0,0,0
34,8480776,Sheldon Rempal,R,VGK,29,0,0,0,0
34,8483920,Pierrick Dube,R,WSH,23,0,0,0,0
34,8480267,Sammy Walker,C,MIN,25,0,0,0,0
34,8482747,Brennan Othmann,L,NYR,21,0,0,0,0
34,8479991,Jake Leschyshyn,C,NYR,25,0,0,0,0
34,8478400,Colin White,C,MTL,27,0,0,0,0
34,8479328,Julien Gauthier,R,NYI,27,0,0,0,0
34,8484325,Waltteri Merela,C,TBL,26,0,0,0,0
34,8479066,Ryan Lomberg,L,FLA,30,0,0,0,0
34,8477070,Liam O'Brien,C,ARI,30,0,0,0,0
34,8478146,Matthew Highmore,C,OTT,28,0,0,0,0
34,8478028,Fredrik Olofsson,L,COL,28,0,0,0,0
34,8480880,Jakub Lauko,C,BOS,24,0,0,0,0
34,8479968,Vinni Lettieri,C,MIN,29,0,0,0,0
34,8474709,Matt Martin,L,NYI,35,0,0,0,0
34,8480845,Rasmus Kupari,C,WPG,24,0,0,0,0
34,8481550,Adam Beckman,L,MIN,23,0,0,0,0
34,8481422,Jacob Lucchini,C,MIN,29,0,0,0,0
34,8477401,John Hayden,C,SEA,29,0,0,0,0
34,8478904,Steven Lorentz,C,FLA,28,0,0,0,0
34,8482088,Justin Sourdif,R,FLA,22,0,0,0,0
34,8482751,Ryan Winterton,C,SEA,21,0,0,0,0
34,8482241,Radim Zohorna,L,PIT,28,0,0,0,0
34,8481690,Tyler Angle,C,CBJ,24,0,0,0,0
34,8476952,Dominic Toninato,C,WPG,30,0,0,0,0
34,8476919,Chris Tierney,C,NJD,30,0,0,0,0
34,8480032,Shane Bowers,C,NJD,25,0,0,0,0
34,8484314,Jiri Smejkal,L,OTT,28,0,0,0,0
34,8481239,Samuel Fagemo,L,LAK,24,0,0,0,0
34,8481532,Alex Turcotte,C,LAK,23,0,0,0,0
34,8481019,David Gustafsson,C,WPG,24,0,0,0,0
34,8478477,Mitchell Stephens,C,MTL,27,0,0,0,0
34,8479546,Oskar Steen,C,BOS,26,0,0,0,0
34,8480292,Carson Meyer,R,CBJ,27,0,0,0,0
34,8478446,Glenn Gawdin,C,ANA,27,0,0,0,0
34,8483531,Brian Halonen,L,NJD,25,0,0,0,0
34,8477149,Scott Sabourin,R,SJS,32,0,0,0,0
34,8479972,Mason Shaw,C,MIN,26,0,0,0,0
34,8480890,Jan Jenik,R,ARI,24,0,0,0,0
34,8478051,Max Willman,C,NJD,29,0,0,0,0
34,8480851,Akil Thomas,C,LAK,24,0,0,0,0
34,8482765,Isak Rosen,R,BUF,21,0,0,0,0
34,8478421,A.J. Greer,L,CGY,28,0,0,0,0
34,8478512,Austin Czarnik,C,DET,32,0,0,0,0
34,8479536,Axel Jonsson-Fjallby,L,WPG,26,0,0,0,0
34,8477320,Anton Blidh,L,NYR,29,0,0,0,0
34,8481543,Nikita Alexandrov,C,STL,24,0,0,0,0
34,8475235,Nicolas Deslauriers,L,PHI,33,0,0,0,0
34,8481070,Hugh McGing,L,STL,26,0,0,0,0
34,8480836,Jonathan Gruden,C,PIT,24,0,0,0,0
34,8481591,Sam Poulin,R,PIT,23,0,0,0,0
34,8477962,Brendan Lemieux,L,CAR,28,0,0,0,0
34,8483401,Marc Johnstone,R,PIT,28,0,0,0,0
34,8482250,Callahan Burke,C,CAR,27,0,0,0,0
34,8481726,Adam Edstrom,C,NYR,24,0,0,0,0
34,8471817,Ryan Reaves,R,TOR,37,0,0,0,0
34,8479587,Rhett Gardner,C,PHI,28,0,0,0,0
34,8475766,Austin Watson,L,TBL,32,0,0,0,0
34,8479367,William Lockwood,R,FLA,26,0,0,0,0
34,8478424,Jansen Harkins,C,PIT,27,0,0,0,0
34,8476913,Devin Shore,C,SEA,30,0,0,0,0
34,8482652,Walker Duehr,R,CGY,27,0,0,0,0
34,8477527,Ross Johnston,L,ANA,30,0,0,0,0
34,8481077,John Leonard,L,ARI,26,0,0,0,0
34,8483549,Lucas Condotta,L,MTL,27,0,0,0,0
34,8480468,James Hamblin,L,EDM,25,0,0,0,0
34,8476907,Mackenzie MacEachern,L,STL,30,0,0,0,0
34,8479543,Michael Pezzetta,L,MTL,26,0,0,0,0
34,8480355,Mark Kastelic,C,OTT,25,0,0,0,0
34,8482162,Roby Jarventie,L,OTT,22,0,0,0,0
34,8479772,Zack MacEwen,R,OTT,28,0,0,0,0
34,8483597,Milos Kelemen,L,ARI,25,0,0,0,0
34,8479379,Givani Smith,R,SJS,26,0,0,0,0
34,8481655,Cole Schwindt,R,CGY,23,0,0,0,0
34,8479981,Jonah Gadjovich,L,FLA,26,0,0,0,0
34,8482147,Jean-Luc Foudy,C,COL,22,0,0,0,0
34,8484255,Jason Polin,R,COL,25,0,0,0,0
34,8477993,Justin Kirkland,C,ARI,28,0,0,0,0
34,8479249,Andrew Poturalski,C,SEA,30,0,0,0,0
34,8482197,Adam Raska,R,MIN,23,0,0,0,0
34,8475780,Chris Wagner,R,COL,33,0,0,0,0
34,8479533,Joona Koppanen,L,PIT,26,0,0,0,0
34,8481534,Raphael Lavoie,C,EDM,24,0,0,0,0
34,8484321,Nikolas Matinpalo,D,OTT,26,0,0,0,0
34,8481043,Cole Koepke,L,TBL,26,0,0,0,0
34,8476323,Max McCormick,L,SEA,32,0,0,0,0
34,8483609,Adam Klapka,R,CGY,24,0,0,0,0
34,8483512,Matt Savoie,C,BUF,20,0,0,0,0
34,8484259,Ondrej Pavel,C,COL,31,0,0,0,0
34,8478147,Bokondji Imama,L,OTT,28,0,0,0,0
34,8482460,Matt Rempe,C,NYR,22,0,0,0,0
34,8477073,Kurtis MacDermid,L,NJD,30,0,0,0,0
34,8480274,Philip Kemp,D,EDM,25,0,0,0,0
34,8478956,Samuel Laberge,L,NJD,27,0,0,0,0
34,8483045,Cameron Butler,R,CBJ,31,0,0,0,0
35,8476453,Nikita Kucherov,R,TBL,31,82,34,82,116
35,8481559,Jack Hughes,C,NJD,23,82,36,79,115
35,8477956,David Pastrnak,R,BOS,28,82,44,63,107
35,8477939,William Nylander,R,TOR,28,82,44,61,105
35,8478402,Connor McDavid,C,EDM,27,82,32,70,102
35,8477492,Nathan MacKinnon,C,COL,29,82,42,58,100
35,8478420,Mikko Rantanen,R,COL,28,82,34,66,100
35,8477934,Leon Draisaitl,C,EDM,29,82,34,62,96
35,8478864,Kirill Kaprizov,L,MIN,27,82,41,52,93
35,8479318,Auston Matthews,C,TOR,27,82,47,45,92
35,8477942,Kevin Fiala,L,LAK,28,82,34,56,90
35,8471675,Sidney Crosby,C,PIT,37,82,43,45,88
35,8480027,Jason Robertson,L,DAL,25,82,38,50,88
35,8480069,Cale Makar,D,COL,26,82,27,61,88
35,8479407,Jesper Bratt,L,NJD,26,82,32,55,87
35,8471215,Evgeni Malkin,C,PIT,38,82,37,49,86
35,8480012,Elias Pettersson,C,VAN,26,82,38,47,85
35,8479314,Matthew Tkachuk,L,FLA,27,82,30,55,85
35,8474564,Steven Stamkos,C,TBL,34,82,39,43,82
35,8479343,Clayton Keller,R,ARI,26,82,39,41,80
35,8481557,Matt Boldy,L,MIN,23,82,32,48,80
35,8478445,Mathew Barzal,C,NYI,27,82,29,51,80
35,8478550,Artemi Panarin,L,NYR,33,82,26,54,80
35,8477960,Adrian Kempe,R,LAK,28,82,38,40,78
35,8476887,Filip Forsberg,L,NSH,30,82,34,44,78
35,8478440,Dylan Strome,C,WSH,27,82,29,49,78
35,8479337,Alex DeBrincat,R,DET,27,82,28,50,78
35,8476853,Morgan Rielly,D,TOR,30,82,16,62,78
35,8477946,Dylan Larkin,C,DET,28,82,36,41,77
35,8479385,Jordan Kyrou,C,STL,26,82,36,41,77
35,8477933,Sam Reinhart,C,FLA,29,82,35,42,77
35,8480023,Robert Thomas,C,STL,25,82,20,57,77
35,8478010,Brayden Point,C,TBL,28,82,41,35,76
35,8476346,Johnny Gaudreau,L,CBJ,31,82,23,53,76
35,8477493,Aleksander Barkov,C,FLA,29,82,20,56,76
35,8477501,Valeri Nichushkin,R,COL,29,82,41,34,75
35,8478414,Timo Meier,R,NJD,28,82,40,35,75
35,8480002,Nico Hischier,C,NJD,25,82,27,48,75
35,8480208,Drake Batherson,R,OTT,26,82,33,41,74
35,8471214,Alex Ovechkin,L,WSH,39,82,36,36,72
35,8475166,John Tavares,C,TOR,34,82,33,39,72
35,8478439,Travis Konecny,R,PHI,27,82,31,39,70
35,8477949,Alex Tuch,R,BUF,28,82,28,42,70
35,8480800,Quinn Hughes,D,VAN,25,82,13,56,69
35,8479542,Brandon Hagel,L,TBL,26,82,31,37,68
35,8473419,Brad Marchand,L,BOS,36,82,26,42,68
35,8482116,Tim Stützle,C,OTT,22,82,23,45,68
35,8481540,Cole Caufield,R,MTL,23,82,35,32,67
35,8480064,Josh Norris,C,OTT,25,82,35,32,67
35,8473512,Claude Giroux,R,OTT,36,82,27,40,67
35,8478042,Viktor Arvidsson,R,LAK,31,82,26,41,67
35,8478403,Jack Eichel,C,VGK,28,82,22,45,67
35,8476539,Jonathan Marchessault,R,VGK,34,82,33,33,66
35,8480018,Nick Suzuki,C,MTL,25,82,30,36,66
35,8479675,Trevor Moore,L,LAK,29,82,29,37,66
35,8478427,Sebastian Aho,C,CAR,27,82,29,37,66
35,8479325,Charlie McAvoy,D,BOS,27,82,11,55,66
35,8478493,Joel Eriksson Ek,C,MIN,27,82,31,34,65
35,8475913,Mark Stone,R,VGK,32,82,30,35,65
35,8481523,Kirby Dach,C,MTL,23,82,13,52,65
35,8475786,Zach Hyman,L,EDM,32,82,38,26,64
35,8477404,Jake Guentzel,C,CAR,30,82,33,31,64
35,8478449,Roope Hintz,C,DAL,28,82,31,33,64
35,8478873,Troy Terry,R,ANA,27,82,30,34,64
35,8482097,Jack Quinn,R,BUF,23,82,20,44,64
35,8480865,Noah Dobson,D,NYI,24,82,15,49,64
35,8482745,Mason McTavish,C,ANA,21,82,30,33,63
35,8477402,Pavel Buchnevich,L,STL,29,82,23,40,63
35,8475692,Mats Zuccarello,R,MIN,37,82,20,43,63
35,8477447,Shea Theodore,D,VGK,29,82,11,52,63
35,8478460,Zach Werenski,D,CBJ,27,82,10,53,63
35,8478398,Kyle Connor,L,WPG,28,82,31,31,62
35,8476881,Tomas Hertl,C,VGK,31,82,25,37,62
35,8482078,Lucas Raymond,L,DET,22,82,24,38,62
35,8476389,Vincent Trocheck,C,NYR,31,82,29,32,61
35,8478047,Michael Bunting,L,PIT,29,82,26,35,61
35,8480801,Brady Tkachuk,L,OTT,25,82,25,35,60
35,8476460,Mark Scheifele,C,WPG,31,82,20,40,60
35,8477416,Oliver Bjorkstrand,R,SEA,29,82,20,40,60
35,8475168,Matt Duchene,C,DAL,33,82,20,40,60
35,8481533,Trevor Zegras,C,ANA,23,82,20,40,60
35,8470794,Joe Pavelski,C,DAL,40,82,19,41,60
35,8477951,Nick Schmaltz,C,ARI,28,82,18,42,60
35,8477940,Nikolaj Ehlers,L,WPG,28,82,29,30,59
35,8476448,William Karlsson,C,VGK,31,82,29,30,59
35,8477409,Carter Verhaeghe,C,FLA,29,82,25,34,59
35,8482093,Seth Jarvis,C,CAR,22,82,24,35,59
35,8479323,Adam Fox,D,NYR,26,82,14,45,59
35,8479420,Tage Thompson,C,BUF,27,82,35,23,58
35,8476432,Boone Jenner,C,CBJ,31,82,35,23,58
35,8478366,Frank Vatrano,R,ANA,30,82,31,27,58
35,8476483,Rickard Rakell,R,PIT,31,82,29,29,58
35,8482740,Wyatt Johnston,C,DAL,21,82,27,31,58
35,8471724,Kris Letang,D,PIT,37,82,13,45,58
35,8475794,Tyler Seguin,C,DAL,32,82,26,31,57
35,8477494,Jonathan Drouin,L,COL,29,82,19,38,57
35,8476456,Jonathan Huberdeau,C,CGY,31,82,17,40,57
35,8474600,Roman Josi,D,NSH,34,82,20,36,56
35,8476468,J.T. Miller,C,VAN,31,82,18,38,56
35,8480031,Maxime Comtois,L,CAR,25,82,18,38,56
35,8476459,Mika Zibanejad,C,NYR,31,82,17,39,56
35,8474578,Erik Karlsson,D,PIT,34,82,17,39,56
35,8477504,Josh Morrissey,D,WPG,29,82,11,45,56
35,8477500,Bo Horvat,C,NYI,29,82,23,32,55
35,8480830,Andrei Svechnikov,R,CAR,24,82,17,38,55
35,8478038,Devon Toews,D,COL,30,82,17,38,55
35,8482684,Luke Hughes,D,NJD,21,82,16,39,55
35,8480839,Rasmus Dahlin,D,BUF,24,82,13,42,55
35,8478444,Brock Boeser,R,VAN,27,82,31,23,54
35,8481528,Dylan Cozens,C,BUF,23,82,29,25,54
35,8480015,Owen Tippett,R,PHI,25,82,28,26,54
35,8476458,Ryan Strome,C,ANA,31,82,21,33,54
35,8475158,Ryan O'Reilly,C,NSH,33,82,20,34,54
35,8475753,Justin Faulk,D,STL,32,82,17,37,54
35,8475167,Victor Hedman,D,TBL,34,82,16,38,54
35,8474590,John Carlson,D,WSH,34,82,11,43,54
35,8475754,Brock Nelson,C,NYI,33,82,32,21,53
35,8471698,T.J. Oshie,R,WSH,38,82,28,25,53
35,8477476,Artturi Lehkonen,L,COL,29,82,23,30,53
35,8482665,Matty Beniers,C,SEA,22,82,18,35,53
35,8477986,Brandon Montour,D,FLA,30,82,17,36,53
35,8480036,Miro Heiskanen,D,DAL,25,82,12,41,53
35,8478498,Jake DeBrusk,L,BOS,28,82,25,27,52
35,8474141,Patrick Kane,R,DET,36,82,21,31,52
35,8479400,Pierre-Luc Dubois,L,LAK,26,82,21,31,52
35,8473986,Alex Killorn,L,ANA,35,82,18,34,52
35,8476905,Chandler Stephenson,C,VGK,30,82,17,35,52
35,8478469,Thomas Chabot,D,OTT,27,82,14,38,52
35,8479410,Mikhail Sergachev,D,TBL,26,82,8,44,52
35,8477426,Nicholas Paul,L,TBL,29,82,24,27,51
35,8478474,Lawson Crouse,L,ARI,27,82,20,31,51
35,8475798,Mikael Granlund,C,SJS,32,82,17,34,51
35,8475172,Nazem Kadri,C,CGY,34,82,14,37,51
35,8475784,Jeff Skinner,C,BUF,32,82,29,21,50
35,8475793,Ryan Johansen,C,PHI,32,82,28,22,50
35,8475810,Bryan Rust,R,PIT,32,82,23,27,50
35,8477496,Elias Lindholm,C,VAN,30,82,20,30,50
35,8480039,Martin Necas,C,CAR,25,82,18,32,50
35,8477998,Warren Foegele,L,EDM,28,82,30,19,49
35,8477479,Tyler Bertuzzi,L,TOR,29,82,24,25,49
35,8482159,Tyson Foerster,R,PHI,22,82,23,26,49
35,8480068,Ryan Poehling,C,PHI,25,82,19,30,49
35,8478401,Pavel Zacha,C,BOS,27,82,17,32,49
35,8477429,Andrew Copp,C,DET,30,82,17,32,49
35,8475765,Vladimir Tarasenko,R,FLA,33,82,14,35,49
35,8476454,Ryan Nugent-Hopkins,C,EDM,31,82,9,40,49
35,8474641,Adam Henrique,C,EDM,34,82,24,24,48
35,8481596,Shane Pinto,C,OTT,24,82,22,26,48
35,8478466,Daniel Sprong,R,DET,27,82,21,27,48
35,8476826,Yanni Gourde,C,SEA,33,82,19,29,48
35,8477955,Jared McCann,L,SEA,28,82,18,30,48
35,8471685,Anze Kopitar,C,LAK,37,82,17,31,48
35,8480434,Sean Durzi,D,ARI,26,82,7,41,48
35,8474157,Max Pacioretty,L,WSH,36,82,24,23,47
35,8475151,Kyle Palmieri,C,NYI,33,82,24,23,47
35,8473994,Jamie Benn,L,DAL,35,82,17,30,47
35,8475744,Evgeny Kuznetsov,C,CAR,32,82,17,30,47
35,8474102,David Perron,L,DET,36,82,16,31,47
35,8476462,Dougie Hamilton,D,NJD,31,82,11,36,47
35,8482105,Jake Sanderson,D,OTT,22,82,10,37,47
35,8475906,John Klingberg,D,TOR,32,82,10,37,47
35,8478407,Vince Dunn,D,SEA,28,82,9,38,47
35,8482175,JJ Peterka,R,BUF,22,82,22,24,46
35,8479345,Jakob Chychrun,D,OTT,26,82,18,28,46
35,8476882,Teuvo Teravainen,L,CAR,30,82,15,31,46
35,8482124,Quinton Byfield,R,LAK,22,82,14,32,46
35,8475218,Mattias Ekholm,D,EDM,34,82,9,37,46
35,8479425,Filip Hronek,D,VAN,27,82,5,41,46
35,8482109,Alexis Lafrenière,L,NYR,23,82,26,19,45
35,8477451,Ryan Hartman,R,MIN,30,82,23,22,45
35,8476399,Blake Coleman,C,CGY,33,82,23,22,45
35,8481618,Alex Newhook,C,MTL,23,82,22,23,45
35,8477407,Anthony Duclair,L,TBL,29,82,20,25,45
35,8478458,Jack Roslovic,C,NYR,27,82,20,25,45
35,8482699,Dylan Guenther,R,ARI,21,82,20,25,45
35,8480188,Fabian Zetterlund,L,SJS,25,82,18,27,45
35,8478438,Tommy Novak,C,NSH,27,82,15,30,45
35,8478055,Gustav Forsling,D,FLA,28,82,12,33,45
35,8480803,Evan Bouchard,D,EDM,25,82,6,39,45
35,8481699,Aku Raty,R,ARI,23,82,3,42,45
35,8475184,Chris Kreider,L,NYR,33,82,31,13,44
35,8481068,Yegor Sharangovich,C,CGY,26,82,25,19,44
35,8478856,Conor Garland,R,VAN,28,82,17,27,44
35,8478542,Evan Rodrigues,C,FLA,31,82,17,27,44
35,8477444,Andre Burakovsky,L,SEA,29,82,16,28,44
35,8474679,Gustav Nyquist,C,NSH,35,82,15,29,44
35,8476875,Mike Matheson,D,MTL,30,82,10,34,44
35,8478519,Anthony Cirelli,C,TBL,27,82,10,34,44
35,8477503,Max Domi,C,TOR,29,82,10,34,44
35,8477495,Seth Jones,D,CHI,30,82,8,36,44
35,8483397,Marc McLaughlin,C,BOS,25,82,37,6,43
35,8482089,Jake Neighbours,L,STL,22,82,23,20,43
35,8480797,Joel Farabee,L,PHI,24,82,21,22,43
35,8475170,Brayden Schenn,C,STL,33,82,20,23,43
35,8479365,Trent Frederic,C,BOS,26,82,20,23,43
35,8476329,Travis Boyd,C,ARI,31,82,18,25,43
35,8476479,Phillip Danault,C,LAK,31,82,16,27,43
35,8479339,Patrik Laine,L,CBJ,26,82,15,28,43
35,8478975,Mason Marchment,L,DAL,29,82,14,29,43
35,8474565,Alex Pietrangelo,D,VGK,34,82,13,30,43
35,8478472,Mathieu Joseph,R,OTT,27,82,13,30,43
35,8475768,Jaden Schwartz,C,SEA,32,82,22,20,42
35,8475848,Brendan Gallagher,R,MTL,32,82,21,21,42
35,8482113,Anton Lundell,C,FLA,23,82,21,21,42
35,8479992,Michael Rasmussen,C,DET,25,82,19,23,42
35,8479525,Ross Colton,C,COL,28,82,18,24,42
35,8482475,Yegor Chinakhov,R,CBJ,23,82,17,25,42
35,8474586,Jordan Eberle,R,SEA,34,82,13,29,42
35,8474150,Mikael Backlund,C,CGY,35,82,12,30,42
35,8479987,Morgan Geekie,C,BOS,26,82,12,30,42
35,8476292,Ondrej Palat,L,NJD,33,82,11,31,42
35,8481711,Matias Maccelli,L,ARI,24,82,9,33,42
35,8475197,Tyson Barrie,D,NSH,33,82,7,35,42
35,8481624,Ilya Mikheyev,R,VAN,30,82,24,17,41
35,8482110,Dawson Mercer,C,NJD,23,82,23,18,41
35,8481186,Logan O'Connor,R,COL,28,82,23,18,41
35,8478020,Michael Amadio,C,VGK,28,82,20,21,41
35,8475726,Tyler Toffoli,C,WPG,32,82,19,22,41
35,8482720,Matthew Knies,L,TOR,22,82,11,30,41
35,8480798,Philipp Kurashev,C,CHI,25,82,10,31,41
35,8478397,Rasmus Andersson,D,CGY,28,82,9,32,41
35,8478396,Noah Hanifin,D,VGK,27,82,6,35,41
35,8475169,Evander Kane,L,EDM,33,82,22,18,40
35,8475799,Nino Niederreiter,R,WPG,32,82,21,19,40
35,8482705,Cole Sillinger,C,CBJ,21,82,19,21,40
35,8475791,Taylor Hall,L,CHI,33,82,18,22,40
35,8482055,Drew O'Connor,L,PIT,26,82,16,24,40
35,8477021,Alex Kerfoot,C,ARI,30,82,14,26,40
35,8483445,Cutter Gauthier,L,ANA,20,82,13,27,40
35,8480028,Morgan Frost,C,PHI,25,82,12,28,40
35,8475314,Anders Lee,L,NYI,34,82,26,13,39
35,8477947,Sonny Milano,L,WSH,28,82,18,21,39
35,8478462,Nicolas Roy,C,VGK,27,82,17,22,39
35,8480893,Kirill Marchenko,R,CBJ,24,82,17,22,39
35,8478046,Danton Heinen,L,BOS,29,82,12,27,39
35,8481542,Moritz Seider,D,DET,23,82,3,36,39
35,8481554,Kaapo Kakko,R,NYR,23,82,21,17,38
35,8484144,Connor Bedard,C,CHI,19,82,18,20,38
35,8480220,Noah Cates,L,PHI,25,82,18,20,38
35,8475287,Erik Haula,L,NJD,33,82,17,21,38
35,8474870,Tyler Johnson,C,CHI,34,82,17,21,38
35,8478233,Andrew Mangiapane,L,CGY,28,82,15,23,38
35,8476921,Jordan Martinook,L,CAR,32,82,13,25,38
35,8480078,Filip Chytil,C,NYR,25,82,12,26,38
35,8476872,Scott Laughton,C,PHI,30,82,12,26,38
35,8477953,Kasperi Kapanen,R,STL,28,82,12,26,38
35,8475191,Reilly Smith,R,PIT,33,82,10,28,38
35,8483524,Shane Wright,C,SEA,20,82,27,10,37
35,8476880,Tom Wilson,R,WSH,30,82,17,20,37
35,8482667,William Eklund,L,SJS,22,82,13,24,37
35,8480873,Rasmus Sandin,D,WSH,24,82,9,28,37
35,8480014,Gabriel Vilardi,C,WPG,25,82,26,10,36
35,8477944,Jakub Vrana,L,STL,28,82,23,13,36
35,8477935,Sam Bennett,C,FLA,28,82,17,19,36
35,8476960,Andreas Athanasiou,C,CHI,30,82,16,20,36
35,8477346,MacKenzie Weegar,D,CGY,30,82,15,21,36
35,8475343,Nic Dowd,C,WSH,34,82,12,24,36
35,8477919,Frederick Gaudreau,C,MIN,31,82,9,27,36
35,8480849,Barrett Hayton,C,ARI,24,82,24,11,35
35,8479423,Alex Nylander,L,CBJ,26,82,20,15,35
35,8483515,Juraj Slafkovsky,L,MTL,20,82,16,19,35
35,8480459,Pius Suter,C,VAN,28,82,16,19,35
35,8474034,Pat Maroon,L,BOS,36,82,13,22,35
35,8475745,Charlie Coyle,C,BOS,32,82,10,25,35
35,8475764,Cam Fowler,D,ANA,33,82,5,30,35
35,8483471,Brad Lambert,C,WPG,31,82,5,30,35
35,8482101,Danil Gushchin,L,SJS,22,82,24,10,34
35,8480009,Eeli Tolvanen,R,SEA,25,82,19,15,34
35,8481580,Connor McMichael,C,WSH,23,82,15,19,34
35,8478508,Yakov Trenin,C,COL,27,82,14,20,34
35,8482133,Thomas Bordeleau,C,SJS,22,82,12,22,34
35,8482117,Lukas Reichel,L,CHI,22,82,12,22,34
35,8477497,Sean Monahan,C,WPG,30,82,11,23,34
35,8482671,Owen Power,D,BUF,22,82,9,25,34
35,8478911,Matt Roy,D,LAK,29,82,7,27,34
35,8481703,Valtteri Puustinen,R,PIT,25,82,6,28,34
35,8476792,Torey Krug,D,STL,33,82,5,29,34
35,8478109,Victor Olofsson,L,BUF,29,82,20,13,33
35,8479941,Justin Danforth,R,CBJ,31,82,20,13,33
35,8483808,Andrei Kuzmenko,L,CGY,28,82,15,18,33
35,8479977,Kailer Yamamoto,R,SEA,26,82,13,20,33
35,8481560,Arthur Kaliyev,R,LAK,23,82,12,21,33
35,8474715,Cam Atkinson,R,PHI,35,82,12,21,33
35,8481581,Thomas Harley,D,DAL,23,82,7,26,33
35,8476923,Damon Severson,D,CBJ,30,82,6,27,33
35,8476958,Jaccob Slavin,D,CAR,30,82,5,28,33
35,8481546,Cam York,D,PHI,23,82,5,28,33
35,8477948,Travis Sanheim,D,PHI,28,82,4,29,33
35,8483457,Lane Hutson,D,MTL,20,82,2,31,33
35,8477511,Anthony Mantha,R,VGK,30,82,17,15,32
35,8474149,Evgenii Dadonov,R,DAL,35,82,17,15,32
35,8475722,Jason Zucker,L,NSH,32,82,17,15,32
35,8470610,Zach Parise,L,COL,40,82,16,16,32
35,8480813,Joe Veleno,C,DET,24,82,14,18,32
35,8477450,Jason Dickinson,C,CHI,29,82,12,20,32
35,8478115,Pierre Engvall,L,NYI,28,82,11,21,32
35,8477425,Miles Wood,L,COL,29,82,11,21,32
35,8477932,Aaron Ekblad,D,FLA,28,82,9,23,32
35,8473563,Nicklas Backstrom,C,WSH,37,82,9,23,32
35,8479398,Samuel Girard,D,COL,26,82,6,26,32
35,8476906,Shayne Gostisbehere,D,DET,31,82,5,27,32
35,8480871,Adam Boqvist,D,CBJ,24,82,5,27,32
35,8482122,Brock Faber,D,MIN,22,82,5,27,32
35,8481016,Ruslan Iskhakov,C,NYI,24,82,4,28,32
35,8475760,Nick Bjugstad,C,ARI,32,82,21,10,31
35,8475714,Calle Jarnkrok,C,TOR,33,82,15,16,31
35,8477353,Tyler Motte,C,TBL,29,82,13,18,31
35,8482222,Alexander Barabanov,L,SJS,30,82,12,19,31
35,8479999,Casey Mittelstadt,C,COL,26,82,11,20,31
35,8480043,Timothy Liljegren,D,TOR,25,82,10,21,31
35,8476461,Sean Couturier,C,PHI,32,82,9,22,31
35,8481656,Aliaksei Protas,C,WSH,23,82,8,23,31
35,8476854,Hampus Lindholm,D,BOS,30,82,7,24,31
35,8478413,Jordan Greenway,L,BUF,27,82,6,25,31
35,8483493,Frank Nazar,C,CHI,20,82,19,11,30
35,8481093,Rafael Harvey-Pinard,L,MTL,25,82,18,12,30
35,8481604,Pavel Dorofeyev,L,VGK,24,82,17,13,30
35,8475149,Marcus Johansson,L,MIN,34,82,16,14,30
35,8477952,Robby Fabbri,C,DET,28,82,16,14,30
35,8479591,Michael Eyssimont,C,TBL,28,82,15,15,30
35,8477507,Nikita Zadorov,D,VAN,29,82,15,15,30
35,8480113,Alex Iafallo,L,WPG,31,82,13,17,30
35,8480185,Eetu Luostarinen,C,FLA,26,82,13,17,30
35,8482146,Luke Evangelista,R,NSH,22,82,13,17,30
35,8477964,Ivan Barbashev,C,VGK,29,82,12,18,30
35,8482074,Connor Zary,C,CGY,23,82,12,18,30
35,8474563,Drew Doughty,D,LAK,35,82,9,21,30
35,8470613,Brent Burns,D,CAR,39,82,8,22,30
35,8482245,Artem Zub,D,OTT,29,82,7,23,30
35,8476892,Colton Parayko,D,STL,31,82,6,24,30
35,8477506,Ryan Pulock,D,NYI,30,82,6,24,30
35,8479371,Dante Fabbro,D,NSH,26,82,5,25,30
35,8476873,Mark Jankowski,C,NSH,30,82,18,11,29
35,8476438,Brandon Saad,L,STL,32,82,17,12,29
35,8484203,Bradly Nadeau,L,CAR,19,82,17,12,29
35,8477392,Hudson Fasching,R,NYI,29,82,16,13,29
35,8476925,Colton Sissons,C,NSH,31,82,15,14,29
35,8476624,Barclay Goodrow,C,NYR,31,82,14,15,29
35,8483431,Logan Cooley,C,ARI,20,82,13,16,29
35,8481013,Jonatan Berggren,R,DET,24,82,12,17,29
35,8476869,Brady Skjei,D,CAR,30,82,11,18,29
35,8475171,Oliver Ekman-Larsson,D,FLA,33,82,10,19,29
35,8477456,J.T. Compher,L,DET,29,82,9,20,29
35,8482142,Jamie Drysdale,D,PHI,22,82,7,22,29
35,8476374,Sean Kuraly,C,CBJ,31,82,16,12,28
35,8482125,Alexander Holtz,R,NJD,22,82,14,14,28
35,8479661,Tanner Jeannot,L,TBL,27,82,13,15,28
35,8480802,Ryan McLeod,C,EDM,25,82,11,17,28
35,8476927,Teddy Blueger,C,VAN,30,82,10,18,28
35,8476979,Erik Gustafsson,D,NYR,32,82,9,19,28
35,8476392,Adam Lowry,C,WPG,31,82,9,19,28
35,8474189,Lars Eller,C,PIT,35,82,9,19,28
35,8479353,Brett Howden,C,VGK,26,82,9,19,28
35,8476463,Jonas Brodin,D,MIN,31,82,5,23,28
35,8479415,Michael McLeod,C,NJD,26,82,15,12,27
35,8481704,Juuso Parssinen,C,NSH,23,82,13,14,27
35,8470621,Corey Perry,R,EDM,39,82,13,14,27
35,8475220,Marcus Foligno,L,MIN,33,82,13,14,27
35,8471218,Blake Wheeler,R,NYR,38,82,12,15,27
35,8477330,Dominik Kubalik,L,OTT,29,82,12,15,27
35,8473422,Nick Foligno,L,CHI,37,82,10,17,27
35,8478178,Darren Raddysh,D,TBL,28,82,8,19,27
35,8478507,John Marino,D,NJD,27,82,6,21,27
35,8477969,Marcus Pettersson,D,PIT,28,82,5,22,27
35,8479998,Mikey Anderson,D,LAK,25,82,5,22,27
35,8476931,Jake McCabe,D,TOR,31,82,5,22,27
35,8482470,Ilya Solovyov,D,CGY,24,82,4,23,27
35,8473507,Jeff Petry,D,DET,37,82,1,26,27
35,8482145,Mavrik Bourque,C,DAL,22,82,18,8,26
35,8479359,Beck Malenstyn,L,WSH,26,82,15,11,26
35,8477508,Curtis Lazar,C,NJD,29,82,15,11,26
35,8478463,Anthony Beauvillier,L,NSH,27,82,14,12,26
35,8473449,Kyle Okposo,R,FLA,36,82,11,15,26
35,8473533,Jordan Staal,C,CAR,36,82,9,17,26
35,8479996,Cody Glass,C,NSH,25,82,9,17,26
35,8477989,Christian Dvorak,C,MTL,28,82,8,18,26
35,8475763,Kevin Hayes,R,STL,32,82,7,19,26
35,8476885,Jacob Trouba,D,NYR,30,82,5,21,26
35,8480246,Nick Perbix,D,TBL,26,82,4,22,26
35,8478882,Vladislav Gavrikov,D,LAK,29,82,4,22,26
35,8474053,Logan Couture,C,SJS,35,82,11,14,25
35,8476897,Oskar Sundqvist,C,STL,30,82,9,16,25
35,8483505,Matthew Poitras,C,BOS,20,82,9,16,25
35,8480806,Isac Lundestrom,C,ANA,25,82,9,16,25
35,8470604,Jeff Carter,C,PIT,39,82,7,18,25
35,8474716,Jared Spurgeon,D,MIN,35,82,6,19,25
35,8482087,Kaiden Guhle,D,MTL,22,82,6,19,25
35,8477498,Darnell Nurse,D,EDM,29,82,6,19,25
35,8476457,Adam Larsson,D,SEA,32,82,6,19,25
35,8483490,Pavel Mintyukov,D,ANA,21,82,4,21,25
35,8480796,Martin Fehervary,D,WSH,25,82,4,21,25
35,8481524,Bowen Byram,D,BUF,23,82,2,23,25
35,8477499,Rasmus Ristolainen,D,PHI,30,82,1,24,25
35,8476469,Joel Armia,R,MTL,31,82,14,10,24
35,8479514,Rem Pitlick,C,CHI,27,82,13,11,24
35,8479393,Noah Gregor,C,TOR,26,82,12,12,24
35,8476278,Colin Blackwell,C,CHI,31,82,12,12,24
35,8478891,Mason Appleton,C,WPG,28,82,11,13,24
35,8482092,Ridly Greig,C,OTT,22,82,11,13,24
35,8483499,Liam Ohgren,L,MIN,20,82,11,13,24
35,8484166,Adam Fantilli,C,CBJ,20,82,10,14,24
35,8482111,Justin Barron,D,MTL,23,82,10,14,24
35,8475164,Jakob Silfverberg,R,ANA,34,82,10,14,24
35,8479351,Sam Steel,C,DAL,26,82,9,15,24
35,8478136,Jake Middleton,D,MIN,28,82,8,16,24
35,8480144,David Kampf,C,TOR,29,82,7,17,24
35,8483482,Tristan Luneau,D,ANA,20,82,7,17,24
35,8476917,Adam Pelech,D,NYI,30,82,6,18,24
35,8481522,Peyton Krebs,C,BUF,23,82,5,19,24
35,8482803,Olen Zellweger,D,ANA,21,82,5,19,24
35,8483495,Simon Nemec,D,NJD,20,82,4,20,24
35,8480879,Jacob Bernard-Docker,D,OTT,24,82,3,21,24
35,8481481,Blake Lizotte,C,LAK,27,82,14,9,23
35,8478057,Dakota Joshua,C,VAN,28,82,13,10,23
35,8482259,Bobby McMann,C,TOR,28,82,11,12,23
35,8474037,James van Riemsdyk,L,BOS,35,82,9,14,23
35,8479346,Dillon Dube,C,CGY,26,82,9,14,23
35,8478569,Noel Acciari,C,PIT,33,82,9,14,23
35,8480855,Jack McBain,C,ARI,24,82,8,15,23
35,8477839,Conor Sheary,L,TBL,32,82,8,15,23
35,8479390,Taylor Raddysh,R,CHI,26,82,7,16,23
35,8474151,Ryan McDonagh,D,NSH,35,82,4,19,23
35,8480807,Mattias Samuelsson,D,BUF,24,82,2,21,23
35,8479369,Andrew Peeke,D,BOS,26,82,2,21,23
35,8482737,Zack Bolduc,C,STL,21,82,13,9,22
35,8480821,Filip Zadina,R,SJS,25,82,12,10,22
35,8481601,Simon Holmstrom,R,NYI,23,82,11,11,22
35,8483491,Ivan Miroshnichenko,L,WSH,20,82,10,12,22
35,8481553,Bobby Brink,R,PHI,23,82,8,14,22
35,8482655,J.J. Moser,D,ARI,24,82,8,14,22
35,8478043,Sam Lafferty,C,VAN,29,82,8,14,22
35,8483565,Nick Blankenburg,D,CBJ,26,82,7,15,22
35,8476879,Cody Ceci,D,EDM,31,82,6,16,22
35,8478133,Jake Evans,C,MTL,28,82,5,17,22
35,8478500,Ivan Provorov,D,CBJ,27,82,4,18,22
35,8475462,Radko Gudas,D,ANA,34,82,4,18,22
35,8480035,Henri Jokiharju,D,BUF,25,82,4,18,22
35,8477845,Trevor van Riemsdyk,D,WSH,33,82,3,19,22
35,8475233,David Savard,D,MTL,34,82,2,20,22
35,8476981,Josh Anderson,R,MTL,30,82,12,9,21
35,8481477,Nico Sturm,C,SJS,29,82,11,10,21
35,8477488,Brett Pesce,D,CAR,30,82,10,11,21
35,8476525,Colin Miller,D,WPG,32,82,7,14,21
35,8481517,Brett Leason,R,ANA,25,82,7,14,21
35,8482062,Cole Smith,L,NSH,29,82,7,14,21
35,8482073,Braden Schneider,D,NYR,23,82,5,16,21
35,8480145,Neal Pionk,D,WPG,29,82,5,16,21
35,8478840,Will Borgen,D,SEA,28,82,4,17,21
35,8481014,Alexander Romanov,D,NYI,24,82,3,18,21
35,8475790,Erik Gudbranson,D,CBJ,32,82,3,18,21
35,8480336,Sean Walker,D,COL,30,82,2,19,21
35,8482733,Logan Mailloux,D,MTL,31,82,1,20,21
35,8480073,Erik Brannstrom,D,OTT,25,82,0,21,21
35,8480281,Alexey Toropchenko,R,STL,25,82,11,9,20
35,8484153,Leo Carlsson,C,ANA,20,82,10,10,20
35,8482702,Logan Stankoven,C,DAL,21,82,9,11,20
35,8481535,Nils Hoglander,L,VAN,24,82,9,11,20
35,8476419,Jean-Gabriel Pageau,C,NYI,32,82,7,13,20
35,8476422,Mike Reilly,D,NYI,31,82,7,13,20
35,8482079,Marco Rossi,C,MIN,23,82,7,13,20
35,8478451,Ethan Bear,D,WSH,27,82,5,15,20
35,8481605,Jackson LaCombe,D,ANA,23,82,4,16,20
35,8476429,Scott Mayfield,D,NYI,32,82,4,16,20
35,8480817,K'Andre Miller,D,NYR,24,82,3,17,20
35,8474574,Tyler Myers,D,VAN,34,82,2,18,20
35,8481568,Alex Vlasic,D,CHI,23,82,1,19,20
35,8482118,Sam Colangelo,R,ANA,23,82,11,8,19
35,8480074,Alexandre Texier,C,CBJ,25,82,10,9,19
35,8482624,Daniil Miromanov,D,CGY,27,82,9,10,19
35,8477406,Mattias Janmark,C,EDM,32,82,9,10,19
35,8477365,Connor Clifton,D,BUF,29,82,7,12,19
35,8478430,Oliver Kylington,D,CGY,27,82,6,13,19
35,8475200,Dmitry Orlov,D,CAR,33,82,5,14,19
35,8475324,Nick Jensen,D,WSH,34,82,3,16,19
35,8477505,Alexander Wennberg,C,NYR,30,82,3,16,19
35,8482712,Oskar Olausson,R,COL,22,82,3,16,19
35,8475690,Chris Tanev,D,DAL,35,82,1,18,19
35,8479293,Brandon Tanev,L,SEA,33,82,10,8,18
35,8478831,Kevin Stenlund,C,FLA,28,82,10,8,18
35,8480448,Parker Kelly,L,OTT,25,82,9,9,18
35,8474884,Mike Hoffman,C,SJS,35,82,7,11,18
35,8478013,Jake Walman,D,DET,28,82,7,11,18
35,8481606,Jordan Spence,D,LAK,23,82,6,12,18
35,8476902,Esa Lindell,D,DAL,30,82,5,13,18
35,8476480,Vladislav Namestnikov,C,WPG,32,82,4,14,18
35,8476312,Josh Manson,D,COL,33,82,4,14,18
35,8475762,Derek Forbort,D,BOS,32,82,3,15,18
35,8475208,Brian Dumoulin,D,SEA,33,82,1,17,18
35,8475181,Nick Leddy,D,STL,33,82,0,18,18
35,8481537,Nikita Okhotiuk,D,CGY,24,82,8,9,17
35,8476442,Matt Nieto,L,PIT,32,82,8,9,17
35,8479316,Luke Kunin,C,SJS,27,82,7,10,17
35,8482730,Brandt Clarke,D,LAK,21,82,7,10,17
35,8481028,Martin Pospisil,C,CGY,25,82,7,10,17
35,8482679,Matt Coronato,R,CGY,22,82,6,11,17
35,8474013,Ian Cole,D,VAN,35,82,6,11,17
35,8475179,Dmitry Kulikov,D,FLA,34,82,5,12,17
35,8473504,Cal Clutterbuck,R,NYI,37,82,5,12,17
35,8480058,Pierre-Olivier Joseph,D,PIT,25,82,5,12,17
35,8476891,Matt Grzelcyk,D,BOS,30,82,4,13,17
35,8477335,Kyle Burroughs,D,SJS,29,82,4,13,17
35,8474673,TJ Brodie,D,TOR,34,82,4,13,17
35,8477369,Carson Soucy,D,VAN,30,82,3,14,17
35,8479983,Mario Ferraro,D,SJS,26,82,3,14,17
35,8476331,Dylan DeMelo,D,WPG,31,82,2,15,17
35,8479324,Ryan Lindgren,D,NYR,26,82,1,16,17
35,8474567,Zach Bogosian,D,MIN,34,82,0,17,17
35,8482762,Simon Edvinsson,D,DET,21,82,11,5,16
35,8479383,Boris Katchouk,L,OTT,26,82,9,7,16
35,8476467,Jamie Oleksiak,D,SEA,32,82,6,10,16
35,8473453,Trevor Lewis,C,LAK,37,82,5,11,16
35,8475231,Casey Cizikas,C,NYI,33,82,4,12,16
35,8476967,Brett Kulak,D,EDM,30,82,4,12,16
35,8478851,Alexandre Carrier,D,NSH,28,82,2,14,16
35,8481178,Egor Zamula,D,PHI,24,82,1,15,16
35,8481567,Henry Thrun,D,SJS,23,82,1,15,16
35,8474166,Alec Martinez,D,VGK,37,82,1,15,16
35,8482155,Alex Laferriere,R,LAK,23,82,8,7,15
35,8476858,Phillip Di Giuseppe,L,VAN,31,82,8,7,15
35,8480980,Connor Dewar,C,TOR,25,82,6,9,15
35,8477931,Tomas Nosek,L,NJD,32,82,5,10,15
35,8475279,Ben Chiarot,D,DET,33,82,4,11,15
35,8482166,Shakir Mukhamadullin,D,SJS,22,82,4,11,15
35,8471677,Jack Johnson,D,COL,37,82,3,12,15
35,8476473,Connor Murphy,D,CHI,31,82,0,15,15
35,8482666,Scott Morrow,D,CAR,22,82,7,7,14
35,8482809,Jackson Blake,R,CAR,21,82,5,9,14
35,8476871,Tanner Pearson,L,MTL,32,82,4,10,14
35,8477435,Ryan Graves,D,PIT,29,82,4,10,14
35,8470966,Mark Giordano,D,TOR,41,82,4,10,14
35,8480990,Declan Chisholm,D,MIN,24,82,4,10,14
35,8484145,Zach Benson,L,BUF,19,82,4,10,14
35,8479976,Juuso Valimaki,D,ARI,26,82,3,11,14
35,8478416,Erik Cernak,D,TBL,27,82,3,11,14
35,8470600,Ryan Suter,D,DAL,39,82,3,11,14
35,8479980,Nicolas Hague,D,VGK,26,82,2,12,14
35,8483763,Maksymilian Szuber,D,ARI,22,82,5,8,13
35,8476372,Nick Seeler,D,PHI,31,82,5,8,13
35,8483466,Kevin Korchinski,D,CHI,20,82,5,8,13
35,8481059,Scott Perunovich,D,STL,26,82,4,9,13
35,8484911,Collin Graf,R,SJS,22,82,3,10,13
35,8482177,Marat Khusnutdinov,C,MIN,22,82,3,10,13
35,8475455,Brenden Dillon,D,WPG,34,82,2,11,13
35,8482516,Matthew Kessel,D,STL,24,82,2,11,13
35,8475188,Brayden McNabb,D,VGK,33,82,0,13,13
35,8474009,Nick Bonino,C,NYR,36,82,5,7,12
35,8475842,Sam Carrick,C,EDM,32,82,5,7,12
35,8478859,Niko Mikkola,D,FLA,28,82,5,7,12
35,8476822,Luke Glendening,C,TBL,35,82,5,7,12
35,8480834,Ty Emberson,D,SJS,24,82,4,8,12
35,8478468,Jeremy Lauzon,D,NSH,27,82,4,8,12
35,8479442,Troy Stecher,D,EDM,30,82,4,8,12
35,8477220,Nate Schmidt,D,WPG,33,82,3,9,12
35,8481599,Victor Soderstrom,D,ARI,23,82,3,9,12
35,8480172,Jan Rutta,D,SJS,34,82,2,10,12
35,8475177,Calvin de Haan,D,TBL,33,82,1,11,12
35,8476878,Zemgus Girgensons,L,BUF,30,82,4,7,11
35,8478399,Jonas Siegenthaler,D,NJD,27,82,2,9,11
35,8483468,Jiri Kulich,C,BUF,20,82,2,9,11
35,8480860,Kevin Bahl,D,NJD,24,82,3,7,10
35,8477034,Jaycob Megna,D,CHI,32,82,3,7,10
35,8482858,Ryker Evans,D,SEA,23,82,2,8,10
35,8477015,Connor Brown,R,EDM,30,82,1,9,10
35,8482807,Ethan Del Mastro,D,CHI,21,82,1,9,10
35,8478443,Brandon Carlo,D,BOS,28,82,6,3,9
35,8483012,Logan Morrison,C,SEA,22,82,5,4,9
35,8482713,Mackie Samoskevich,R,FLA,22,82,5,4,9
35,8476915,Jujhar Khaira,L,MIN,30,82,4,5,9
35,8481030,Jack St. Ivany,D,PIT,25,82,2,7,9
35,8479291,Kevin Rooney,C,CGY,31,82,6,2,8
35,8481578,Graeme Clarke,R,NJD,23,82,3,5,8
35,8478408,Travis Dermott,D,ARI,28,82,2,6,8
35,8475825,Jani Hakanpää,D,DAL,32,82,2,5,7
35,8483489,Fraser Minten,C,TOR,31,82,2,2,4
35,8484149,Gavin Brindley,C,CBJ,20,82,1,3,4
35,8482859,Zack Ostapchuk,C,OTT,21,82,1,3,4
35,8482141,Lukas Cormier,D,VGK,22,0,0,0,0
35,8476988,Matt Benning,D,SJS,30,0,0,0,0
35,8480727,Zach Whitecloud,D,VGK,28,0,0,0,0
35,8480887,Jordan Harris,D,MTL,24,0,0,0,0
35,8478450,Parker Wotherspoon,D,BOS,27,0,0,0,0
35,8481812,Nikolai Knyzhov,D,SJS,27,0,0,0,0
35,8480001,Urho Vaakanainen,D,ANA,25,0,0,0,0
35,8482176,Wyatt Kaiser,D,CHI,22,0,0,0,0
35,8481122,Simon Benoit,D,TOR,26,0,0,0,0
35,8476441,Joel Edmundson,D,TOR,31,0,0,0,0
35,8480884,Calen Addison,D,SJS,24,0,0,0,0
35,8482511,Mason Lohrei,D,BOS,23,0,0,0,0
35,8482192,Isaak Phillips,D,CHI,23,0,0,0,0
35,8480950,Ilya Lyubushkin,D,TOR,30,0,0,0,0
35,8474031,Kevin Shattenkirk,D,BOS,35,0,0,0,0
35,8475718,Justin Holl,D,DET,32,0,0,0,0
35,8479402,Jake Bean,D,CBJ,26,0,0,0,0
35,8474602,Justin Schultz,D,SEA,34,0,0,0,0
35,8477950,Tony DeAngelo,D,CAR,29,0,0,0,0
35,8481743,Marc Del Gaizo,D,NSH,25,0,0,0,0
35,8481527,Kaedan Korczak,D,VGK,23,0,0,0,0
35,8480192,Johnathan Kovacevic,D,MTL,27,0,0,0,0
35,8476874,Olli Maatta,D,DET,30,0,0,0,0
35,8482144,Jack Thompson,D,SJS,22,0,0,0,0
35,8480222,Sebastian Aho,D,NYI,28,0,0,0,0
35,8479458,Nikita Zaitsev,D,CHI,33,0,0,0,0
35,8471709,Marc-Edouard Vlasic,D,SJS,37,0,0,0,0
35,8482929,Emil Lilleberg,D,TBL,23,0,0,0,0
35,8477018,Ben Hutton,D,VGK,31,0,0,0,0
35,8481056,Spencer Stastney,D,NSH,24,0,0,0,0
35,8481593,Jayden Struble,D,MTL,23,0,0,0,0
35,8479982,Conor Timmins,D,TOR,26,0,0,0,0
35,8474090,Brendan Smith,D,NJD,35,0,0,0,0
35,8482964,Arber Xhekaj,D,MTL,23,0,0,0,0
35,8480891,Michael Kesselring,D,ARI,24,0,0,0,0
35,8477938,Haydn Fleury,D,TBL,28,0,0,0,0
35,8481806,Louis Crevier,D,CHI,23,0,0,0,0
35,8471274,Alex Goligoski,D,MIN,39,0,0,0,0
35,8481600,Tobias Bjornfot,D,FLA,23,0,0,0,0
35,8475797,Jarred Tinordi,D,CHI,32,0,0,0,0
35,8481521,Ronnie Attard,D,PHI,25,0,0,0,0
35,8474612,Travis Hamonic,D,OTT,34,0,0,0,0
35,8479576,Vincent Desharnais,D,EDM,28,0,0,0,0
35,8480049,Dylan Samberg,D,WPG,25,0,0,0,0
35,8483619,Filip Roos,D,CHI,25,0,0,0,0
35,8474568,Luke Schenn,D,NSH,35,0,0,0,0
35,8480184,Gustav Lindstrom,D,ANA,26,0,0,0,0
35,8480070,Ian Mitchell,D,BOS,25,0,0,0,0
35,8480196,Jacob Bryson,D,BUF,27,0,0,0,0
35,8471686,Marc Staal,D,PHI,37,0,0,0,0
35,8477467,Gustav Olofsson,D,SEA,30,0,0,0,0
35,8478970,Jalen Chatfield,D,CAR,28,0,0,0,0
35,8479348,Kale Clague,D,BUF,26,0,0,0,0
35,8473446,Erik Johnson,D,PHI,36,0,0,0,0
35,8477462,Robert Hagg,D,ANA,29,0,0,0,0
35,8478454,Noah Juulsen,D,VAN,27,0,0,0,0
35,8477384,Josh Brown,D,ARI,30,0,0,0,0
35,8481708,Zac Jones,D,NYR,24,0,0,0,0
35,8481167,Brayden Pachal,D,CGY,25,0,0,0,0
35,8482067,Connor Mackey,D,NYR,28,0,0,0,0
35,8483460,David Jiricek,D,CBJ,21,0,0,0,0
35,8481701,Santeri Hatakka,D,NJD,23,0,0,0,0
35,8478021,William Lagesson,D,ANA,28,0,0,0,0
35,8477851,Jordan Oesterle,D,CGY,32,0,0,0,0
35,8478452,Caleb Jones,D,COL,27,0,0,0,0
35,8479984,Cal Foote,D,NJD,26,0,0,0,0
35,8479639,Dylan Coghlan,D,CAR,26,0,0,0,0
35,8480874,Adam Ginning,D,PHI,24,0,0,0,0
35,8479321,Lucas Johansen,D,WSH,27,0,0,0,0
35,8480878,Nils Lundkvist,D,DAL,24,0,0,0,0
35,8482165,Yan Kuznetsov,D,CGY,22,0,0,0,0
35,8484258,Sam Malinski,D,COL,26,0,0,0,0
35,8480157,Calle Rosen,D,STL,30,0,0,0,0
35,8484304,Uvis Balinskis,D,FLA,28,0,0,0,0
35,8479985,Cale Fleury,D,SEA,26,0,0,0,0
35,8479378,Logan Stanley,D,WPG,26,0,0,0,0
35,8477541,Dakota Mermis,D,MIN,30,0,0,0,0
35,8481609,Vladislav Kolyachonok,D,ARI,23,0,0,0,0
35,8480823,Alexander Alexeyev,D,WSH,25,0,0,0,0
35,8481679,Maxence Guenette,D,OTT,23,0,0,0,0
35,8481564,Ryan Johnson,D,BUF,23,0,0,0,0
35,8479376,Victor Mete,D,PHI,26,0,0,0,0
35,8484254,Akito Hirose,D,VAN,25,0,0,0,0
35,8482660,Kent Johnson,C,CBJ,22,0,0,0,0
35,8482149,Cole Perfetti,C,WPG,22,0,0,0,0
35,8477987,Ryan Donato,C,CHI,28,0,0,0,0
35,8475755,Alexander Petrovic,D,DAL,32,0,0,0,0
35,8477810,Joel Hanley,D,CGY,33,0,0,0,0
35,8474145,Robert Bortuzzo,D,NYI,35,0,0,0,0
35,8481161,Jake Christiansen,D,CBJ,25,0,0,0,0
35,8476884,Derrick Pouliot,D,DAL,30,0,0,0,0
35,8481716,Dmitri Voronkov,L,CBJ,24,0,0,0,0
35,8480084,Nick DeSimone,D,NJD,30,0,0,0,0
35,8475750,Jon Merrill,D,MIN,32,0,0,0,0
35,8479315,Joey Anderson,R,CHI,26,0,0,0,0
35,8478011,Louie Belpedio,D,PHI,28,0,0,0,0
35,8482451,Mikael Pyyhtia,L,CBJ,23,0,0,0,0
35,8481541,Samuel Bolduc,D,NYI,24,0,0,0,0
35,8482126,Emil Andrae,D,PHI,31,0,0,0,0
35,8474618,Marco Scandella,D,STL,34,0,0,0,0
35,8477244,Chad Ruhwedel,D,NYR,34,0,0,0,0
35,8477971,Andreas Englund,D,LAK,28,0,0,0,0
35,8480829,Jesperi Kotkaniemi,C,CAR,24,0,0,0,0
35,8479372,Josh Mahura,D,FLA,26,0,0,0,0
35,8482095,Tyler Kleven,D,OTT,22,0,0,0,0
35,8481719,Maxwell Crozier,D,TBL,24,0,0,0,0
35,8475855,Jesper Fast,R,CAR,33,0,0,0,0
35,8480848,Ty Dellandrea,C,DAL,24,0,0,0,0
35,8475193,Tomas Tatar,L,SEA,34,0,0,0,0
35,8476889,Radek Faksa,C,DAL,30,0,0,0,0
35,8478495,Denis Gurianov,R,PHI,27,0,0,0,0
35,8480216,Jacob Peterson,C,SJS,25,0,0,0,0
35,8480252,Cole Guttman,C,CHI,25,0,0,0,0
35,8479026,Philippe Myers,D,TBL,27,0,0,0,0
35,8481006,Tyler Tucker,D,STL,24,0,0,0,0
35,8481032,Paul Cotter,C,VGK,25,0,0,0,0
35,8481577,Philip Tomasino,C,NSH,23,0,0,0,0
35,8476918,Jimmy Vesey,L,NYR,31,0,0,0,0
35,8479320,Max Lajoie,D,TOR,27,0,0,0,0
35,8478017,Mark Friedman,D,VAN,29,0,0,0,0
35,8481754,Nikita Nesterenko,C,ANA,23,0,0,0,0
35,8483407,Brandon Scanlin,D,NYR,25,0,0,0,0
35,8482659,Josh Doan,R,ARI,22,0,0,0,0
35,8477446,Michael McCarron,R,NSH,29,0,0,0,0
35,8477903,Garnet Hathaway,R,PHI,33,0,0,0,0
35,8482153,Brendan Brisson,C,VGK,23,0,0,0,0
35,8483546,Marshall Rifai,D,TOR,26,0,0,0,0
35,8484287,Cole McWard,D,VAN,23,0,0,0,0
35,8478854,Ryan Shea,D,PIT,27,0,0,0,0
35,8481585,Egor Afanasyev,L,NSH,23,0,0,0,0
35,8483398,Declan Carlile,D,TBL,31,0,0,0,0
35,8478502,Dennis Gilbert,D,CGY,28,0,0,0,0
35,8482749,Joshua Roy,R,MTL,21,0,0,0,0
35,8481598,Philip Broberg,D,EDM,23,0,0,0,0
35,8480835,Jack Drury,C,CAR,24,0,0,0,0
35,8480748,Kiefer Sherwood,L,NSH,29,0,0,0,0
35,8476934,Brock McGinn,L,ANA,30,0,0,0,0
35,8480870,Bo Groulx,C,ANA,24,0,0,0,0
35,8479368,Max Jones,L,ANA,26,0,0,0,0
35,8478099,Kevin Labanc,R,SJS,29,0,0,0,0
35,8478067,Oskar Lindblom,L,SJS,28,0,0,0,0
35,8476393,Nick Cousins,C,FLA,31,0,0,0,0
35,8483395,Arshdeep Bains,L,VAN,23,0,0,0,0
35,8480762,Eric Robinson,L,BUF,29,0,0,0,0
35,8479439,Jacob MacDonald,D,SJS,31,0,0,0,0
35,8476474,Stefan Noesen,R,CAR,31,0,0,0,0
35,8482787,Nikita Chibrikov,R,WPG,31,0,0,0,0
35,8478432,Christian Fischer,R,DET,27,0,0,0,0
35,8477979,Nicolas Aube-Kubel,R,WSH,28,0,0,0,0
35,8481789,Tye Kartye,L,SEA,23,0,0,0,0
35,8479330,Brandon Gignac,C,MTL,27,0,0,0,0
35,8480075,Cameron Crotty,D,ARI,25,0,0,0,0
35,8473473,Milan Lucic,L,BOS,36,0,0,0,0
35,8482094,Daemon Hunt,D,MIN,22,0,0,0,0
35,8481206,John Ludvig,D,PIT,24,0,0,0,0
35,8483630,Pavol Regenda,L,ANA,25,0,0,0,0
35,8481617,Vasily Podkolzin,R,VAN,23,0,0,0,0
35,8480306,Grant Hutton,D,NYI,29,0,0,0,0
35,8480995,Pontus Holmberg,R,TOR,25,0,0,0,0
35,8482148,Hendrix Lapierre,C,WSH,22,0,0,0,0
35,8477478,William Carrier,L,VGK,30,0,0,0,0
35,8480003,Jesper Boqvist,C,BOS,26,0,0,0,0
35,8482172,Landon Slaggert,L,CHI,22,0,0,0,0
35,8480789,Oliver Wahlstrom,R,NYI,24,0,0,0,0
35,8474062,Riley Nash,C,NYR,35,0,0,0,0
35,8480021,Jack Studnicka,C,SJS,25,0,0,0,0
35,8480025,MacKenzie Entwistle,R,CHI,25,0,0,0,0
35,8481582,Nicholas Robertson,L,TOR,23,0,0,0,0
35,8476867,Brendan Gaunce,C,CBJ,30,0,0,0,0
35,8479619,Michael Carcone,L,ARI,28,0,0,0,0
35,8479370,Tyson Jost,C,BUF,26,0,0,0,0
35,8479671,Mathieu Olivier,R,CBJ,27,0,0,0,0
35,8476994,Vinnie Hinostroza,C,PIT,30,0,0,0,0
35,8482070,Mitchell Chaffee,R,TBL,26,0,0,0,0
35,8477473,Justin Bailey,R,SJS,29,0,0,0,0
35,8479344,Jesse Puljujarvi,R,PIT,26,0,0,0,0
35,8480205,Emil Bemstrom,C,PIT,25,0,0,0,0
35,8479718,Alex Barré-Boulet,C,TBL,27,0,0,0,0
35,8482061,Brandon Biro,L,BUF,26,0,0,0,0
35,8479638,Justin Brazeau,R,BOS,26,0,0,0,0
35,8474040,Sam Gagner,C,EDM,35,0,0,0,0
35,8477846,Ryan Carpenter,C,SJS,33,0,0,0,0
35,8482077,Dylan Holloway,L,EDM,23,0,0,0,0
35,8482157,Will Cuylle,L,NYR,22,0,0,0,0
35,8480007,Jonas Rondbjerg,R,VGK,25,0,0,0,0
35,8478874,Adam Gaudette,C,STL,28,0,0,0,0
35,8478434,Keegan Kolesar,R,VGK,27,0,0,0,0
35,8480441,Trey Fix-Wolansky,R,CBJ,25,0,0,0,0
35,8479994,Jaret Anderson-Dolan,C,NSH,25,0,0,0,0
35,8483567,Georgii Merkulov,C,BOS,24,0,0,0,0
35,8477380,Jonny Brodzinski,C,NYR,31,0,0,0,0
35,8482201,Gage Goncalves,C,TBL,23,0,0,0,0
35,8478211,Dryden Hunt,L,CGY,29,0,0,0,0
35,8471699,Andrew Cogliano,C,COL,37,0,0,0,0
35,8479421,Jacob Moverare,D,LAK,26,0,0,0,0
35,8478881,Brett Seney,L,CHI,28,0,0,0,0
35,8477464,Nic Petan,C,MIN,29,0,0,0,0
35,8475958,Michael Sgarbossa,C,WSH,32,0,0,0,0
35,8481147,Reese Johnson,C,CHI,26,0,0,0,0
35,8479336,Carl Grundstrom,R,LAK,27,0,0,0,0
35,8480853,Liam Foudy,C,NSH,24,0,0,0,0
35,8479522,Hardy Haman Aktell,D,WSH,26,0,0,0,0
35,8481462,Mason Morelli,L,VGK,28,0,0,0,0
35,8482102,Vasily Ponomarev,C,CAR,22,0,0,0,0
35,8480844,Grigori Denisenko,L,VGK,24,0,0,0,0
35,8479944,Zach Aston-Reese,C,DET,30,0,0,0,0
35,8482784,Zach Dean,C,STL,21,0,0,0,0
35,8479419,Brett Murray,L,BUF,26,0,0,0,0
35,8479520,Brandon Duhaime,R,COL,27,0,0,0,0
35,8477573,Nathan Walker,L,STL,30,0,0,0,0
35,8478078,Rourke Chartier,C,OTT,28,0,0,0,0
35,8475795,Dylan McIlrath,D,WSH,32,0,0,0,0
35,8482496,Nils Aman,C,VAN,24,0,0,0,0
35,8480289,Morgan Barron,C,WPG,26,0,0,0,0
35,8481751,Lukas Rousek,R,BUF,25,0,0,0,0
35,8480011,Klim Kostin,C,SJS,25,0,0,0,0
35,8481556,John Beecher,C,BOS,23,0,0,0,0
35,8475278,Byron Froese,C,VGK,33,0,0,0,0
35,8475225,Craig Smith,C,DAL,35,0,0,0,0
35,8484326,Patrik Koch,D,ARI,28,0,0,0,0
35,8477930,Pierre-Edouard Bellemare,L,SEA,39,0,0,0,0
35,8478409,Anthony Richard,C,BOS,28,0,0,0,0
35,8481024,Linus Karlsson,C,VAN,25,0,0,0,0
35,8479986,Kole Lind,R,SEA,26,0,0,0,0
35,8479414,Nathan Bastian,R,NJD,27,0,0,0,0
35,8479362,Riley Tufte,L,COL,26,0,0,0,0
35,8481058,Jesse Ylönen,R,MTL,25,0,0,0,0
35,8482476,Emil Heineman,L,MTL,23,0,0,0,0
35,8482861,Vincent Iorio,D,WSH,22,0,0,0,0
35,8483432,Luca Del Bel Belluz,C,CBJ,31,0,0,0,0
35,8482744,James Malatesta,L,CBJ,21,0,0,0,0
35,8477887,Patrick Brown,C,BOS,32,0,0,0,0
35,8478585,Derek Ryan,C,EDM,38,0,0,0,0
35,8481441,Joe Snively,C,WSH,28,0,0,0,0
35,8481592,Jakob Pelletier,L,CGY,23,0,0,0,0
35,8482634,Alex Steeves,C,TOR,25,0,0,0,0
35,8477126,Jayson Megna,C,BOS,34,0,0,0,0
35,8475752,Tyler Pitlick,C,NYR,33,0,0,0,0
35,8480008,Adam Ruzicka,C,ARI,25,0,0,0,0
35,8481065,Angus Crookshank,L,OTT,25,0,0,0,0
35,8479547,Matthew Phillips,R,WSH,26,0,0,0,0
35,8480226,Marián Studenic,R,SEA,26,0,0,0,0
35,8481237,Kyle MacLean,C,NYI,25,0,0,0,0
35,8475413,Justin Dowling,C,NJD,34,0,0,0,0
35,8481641,Joel Kiviranta,L,COL,28,0,0,0,0
35,8478104,Sammy Blais,L,STL,28,0,0,0,0
35,8477454,Adam Erne,L,EDM,29,0,0,0,0
35,8481518,Nolan Foote,L,NJD,24,0,0,0,0
35,8480245,Olle Lycksell,R,PHI,25,0,0,0,0
35,8483570,Ben Meyers,C,ANA,26,0,0,0,0
35,8480776,Sheldon Rempal,R,VGK,29,0,0,0,0
35,8483920,Pierrick Dube,R,WSH,23,0,0,0,0
35,8480267,Sammy Walker,C,MIN,25,0,0,0,0
35,8482747,Brennan Othmann,L,NYR,21,0,0,0,0
35,8479991,Jake Leschyshyn,C,NYR,25,0,0,0,0
35,8478400,Colin White,C,MTL,27,0,0,0,0
35,8479328,Julien Gauthier,R,NYI,27,0,0,0,0
35,8484325,Waltteri Merela,C,TBL,26,0,0,0,0
35,8479066,Ryan Lomberg,L,FLA,30,0,0,0,0
35,8477070,Liam O'Brien,C,ARI,30,0,0,0,0
35,8478146,Matthew Highmore,C,OTT,28,0,0,0,0
35,8478028,Fredrik Olofsson,L,COL,28,0,0,0,0
35,8480880,Jakub Lauko,C,BOS,24,0,0,0,0
35,8479968,Vinni Lettieri,C,MIN,29,0,0,0,0
35,8474709,Matt Martin,L,NYI,35,0,0,0,0
35,8480845,Rasmus Kupari,C,WPG,24,0,0,0,0
35,8481550,Adam Beckman,L,MIN,23,0,0,0,0
35,8481422,Jacob Lucchini,C,MIN,29,0,0,0,0
35,8477401,John Hayden,C,SEA,29,0,0,0,0
35,8478904,Steven Lorentz,C,FLA,28,0,0,0,0
35,8482088,Justin Sourdif,R,FLA,22,0,0,0,0
35,8482751,Ryan Winterton,C,SEA,21,0,0,0,0
35,8482241,Radim Zohorna,L,PIT,28,0,0,0,0
35,8481690,Tyler Angle,C,CBJ,24,0,0,0,0
35,8476952,Dominic Toninato,C,WPG,30,0,0,0,0
35,8476919,Chris Tierney,C,NJD,30,0,0,0,0
35,8480032,Shane Bowers,C,NJD,25,0,0,0,0
35,8484314,Jiri Smejkal,L,OTT,28,0,0,0,0
35,8481239,Samuel Fagemo,L,LAK,24,0,0,0,0
35,8481532,Alex Turcotte,C,LAK,23,0,0,0,0
35,8481019,David Gustafsson,C,WPG,24,0,0,0,0
35,8478477,Mitchell Stephens,C,MTL,27,0,0,0,0
35,8479546,Oskar Steen,C,BOS,26,0,0,0,0
35,8480292,Carson Meyer,R,CBJ,27,0,0,0,0
35,8478446,Glenn Gawdin,C,ANA,27,0,0,0,0
35,8483531,Brian Halonen,L,NJD,25,0,0,0,0
35,8477149,Scott Sabourin,R,SJS,32,0,0,0,0
35,8479972,Mason Shaw,C,MIN,26,0,0,0,0
35,8480890,Jan Jenik,R,ARI,24,0,0,0,0
35,8478051,Max Willman,C,NJD,29,0,0,0,0
35,8480851,Akil Thomas,C,LAK,24,0,0,0,0
35,8482765,Isak Rosen,R,BUF,21,0,0,0,0
35,8478421,A.J. Greer,L,CGY,28,0,0,0,0
35,8478512,Austin Czarnik,C,DET,32,0,0,0,0
35,8479536,Axel Jonsson-Fjallby,L,WPG,26,0,0,0,0
35,8477320,Anton Blidh,L,NYR,29,0,0,0,0
35,8481543,Nikita Alexandrov,C,STL,24,0,0,0,0
35,8475235,Nicolas Deslauriers,L,PHI,33,0,0,0,0
35,8481070,Hugh McGing,L,STL,26,0,0,0,0
35,8480836,Jonathan Gruden,C,PIT,24,0,0,0,0
35,8481591,Sam Poulin,R,PIT,23,0,0,0,0
35,8477962,Brendan Lemieux,L,CAR,28,0,0,0,0
35,8483401,Marc Johnstone,R,PIT,28,0,0,0,0
35,8482250,Callahan Burke,C,CAR,27,0,0,0,0
35,8481726,Adam Edstrom,C,NYR,24,0,0,0,0
35,8471817,Ryan Reaves,R,TOR,37,0,0,0,0
35,8479587,Rhett Gardner,C,PHI,28,0,0,0,0
35,8475766,Austin Watson,L,TBL,32,0,0,0,0
35,8479367,William Lockwood,R,FLA,26,0,0,0,0
35,8478424,Jansen Harkins,C,PIT,27,0,0,0,0
35,8476913,Devin Shore,C,SEA,30,0,0,0,0
35,8482652,Walker Duehr,R,CGY,27,0,0,0,0
35,8477527,Ross Johnston,L,ANA,30,0,0,0,0
35,8481077,John Leonard,L,ARI,26,0,0,0,0
35,8483549,Lucas Condotta,L,MTL,27,0,0,0,0
35,8480468,James Hamblin,L,EDM,25,0,0,0,0
35,8476907,Mackenzie MacEachern,L,STL,30,0,0,0,0
35,8479543,Michael Pezzetta,L,MTL,26,0,0,0,0
35,8480355,Mark Kastelic,C,OTT,25,0,0,0,0
35,8482162,Roby Jarventie,L,OTT,22,0,0,0,0
35,8479772,Zack MacEwen,R,OTT,28,0,0,0,0
35,8483597,Milos Kelemen,L,ARI,25,0,0,0,0
35,8479379,Givani Smith,R,SJS,26,0,0,0,0
35,8481655,Cole Schwindt,R,CGY,23,0,0,0,0
35,8479981,Jonah Gadjovich,L,FLA,26,0,0,0,0
35,8482147,Jean-Luc Foudy,C,COL,22,0,0,0,0
35,8484255,Jason Polin,R,COL,25,0,0,0,0
35,8477993,Justin Kirkland,C,ARI,28,0,0,0,0
35,8479249,Andrew Poturalski,C,SEA,30,0,0,0,0
35,8482197,Adam Raska,R,MIN,23,0,0,0,0
35,8475780,Chris Wagner,R,COL,33,0,0,0,0
35,8479533,Joona Koppanen,L,PIT,26,0,0,0,0
35,8481534,Raphael Lavoie,C,EDM,24,0,0,0,0
35,8484321,Nikolas Matinpalo,D,OTT,26,0,0,0,0
35,8481043,Cole Koepke,L,TBL,26,0,0,0,0
35,8476323,Max McCormick,L,SEA,32,0,0,0,0
35,8483609,Adam Klapka,R,CGY,24,0,0,0,0
35,8483512,Matt Savoie,C,BUF,20,0,0,0,0
35,8484259,Ondrej Pavel,C,COL,31,0,0,0,0
35,8478147,Bokondji Imama,L,OTT,28,0,0,0,0
35,8482460,Matt Rempe,C,NYR,22,0,0,0,0
35,8477073,Kurtis MacDermid,L,NJD,30,0,0,0,0
35,8480274,Philip Kemp,D,EDM,25,0,0,0,0
35,8478956,Samuel Laberge,L,NJD,27,0,0,0,0
35,8483045,Cameron Butler,R,CBJ,31,0,0,0,0
36,8478402,Connor McDavid,C,EDM,27,82,45,76,121
36,8476453,Nikita Kucherov,R,TBL,31,82,39,82,121
36,8479318,Auston Matthews,C,TOR,27,82,70,50,120
36,8471675,Sidney Crosby,C,PIT,37,82,44,56,100
36,8477956,David Pastrnak,R,BOS,28,82,41,57,98
36,8476468,J.T. Miller,C,VAN,31,82,39,57,96
36,8478550,Artemi Panarin,L,NYR,33,82,31,60,91
36,8476460,Mark Scheifele,C,WPG,31,82,36,53,89
36,8478420,Mikko Rantanen,R,COL,28,82,34,55,89
36,8480069,Cale Makar,D,COL,26,82,25,64,89
36,8477934,Leon Draisaitl,C,EDM,29,82,35,53,88
36,8477492,Nathan MacKinnon,C,COL,29,82,27,60,87
36,8481523,Kirby Dach,C,MTL,23,82,13,74,87
36,8480801,Brady Tkachuk,L,OTT,25,82,46,40,86
36,8480027,Jason Robertson,L,DAL,25,82,34,52,86
36,8477942,Kevin Fiala,L,LAK,28,82,36,49,85
36,8478403,Jack Eichel,C,VGK,28,82,34,51,85
36,8480800,Quinn Hughes,D,VAN,25,82,14,71,85
36,8478864,Kirill Kaprizov,L,MIN,27,82,37,46,83
36,8481559,Jack Hughes,C,NJD,23,82,32,51,83
36,8474564,Steven Stamkos,C,TBL,34,82,36,45,81
36,8480002,Nico Hischier,C,NJD,25,82,34,46,80
36,8479343,Clayton Keller,R,ARI,26,82,40,39,79
36,8479385,Jordan Kyrou,C,STL,26,82,31,48,79
36,8477493,Aleksander Barkov,C,FLA,29,82,27,52,79
36,8480023,Robert Thomas,C,STL,25,82,19,60,79
36,8476346,Johnny Gaudreau,L,CBJ,31,82,17,62,79
36,8477939,William Nylander,R,TOR,28,82,31,47,78
36,8479337,Alex DeBrincat,R,DET,27,82,40,37,77
36,8477940,Nikolaj Ehlers,L,WPG,28,82,19,57,76
36,8480865,Noah Dobson,D,NYI,24,82,14,62,76
36,8471215,Evgeni Malkin,C,PIT,38,82,29,46,75
36,8475786,Zach Hyman,L,EDM,32,82,48,26,74
36,8477404,Jake Guentzel,C,CAR,30,82,40,34,74
36,8478439,Travis Konecny,R,PHI,27,82,37,37,74
36,8477933,Sam Reinhart,C,FLA,29,82,36,38,74
36,8476456,Jonathan Huberdeau,C,CGY,31,82,14,60,74
36,8474600,Roman Josi,D,NSH,34,82,12,62,74
36,8477955,Jared McCann,L,SEA,28,82,35,37,72
36,8474141,Patrick Kane,R,DET,36,82,29,43,72
36,8481557,Matt Boldy,L,MIN,23,82,27,45,72
36,8478445,Mathew Barzal,C,NYI,27,82,22,50,72
36,8478407,Vince Dunn,D,SEA,28,82,19,53,72
36,8477447,Shea Theodore,D,VGK,29,82,18,54,72
36,8477960,Adrian Kempe,R,LAK,28,82,31,40,71
36,8478398,Kyle Connor,L,WPG,28,82,29,42,71
36,8473419,Brad Marchand,L,BOS,36,82,22,49,71
36,8480036,Miro Heiskanen,D,DAL,25,82,9,62,71
36,8476887,Filip Forsberg,L,NSH,30,82,31,39,70
36,8475166,John Tavares,C,TOR,34,82,30,40,70
36,8475810,Bryan Rust,R,PIT,32,82,30,40,70
36,8479407,Jesper Bratt,L,NJD,26,82,29,41,70
36,8477409,Carter Verhaeghe,C,FLA,29,82,44,25,69
36,8477946,Dylan Larkin,C,DET,28,82,31,38,69
36,8478427,Sebastian Aho,C,CAR,27,82,22,46,68
36,8475172,Nazem Kadri,C,CGY,34,82,21,47,68
36,8476454,Ryan Nugent-Hopkins,C,EDM,31,82,17,51,68
36,8480803,Evan Bouchard,D,EDM,25,82,16,52,68
36,8480018,Nick Suzuki,C,MTL,25,82,23,44,67
36,8471214,Alex Ovechkin,L,WSH,39,82,34,32,66
36,8478414,Timo Meier,R,NJD,28,82,32,34,66
36,8480012,Elias Pettersson,C,VAN,26,82,25,41,66
36,8470794,Joe Pavelski,C,DAL,40,82,25,41,66
36,8478042,Viktor Arvidsson,R,LAK,31,82,36,28,64
36,8478010,Brayden Point,C,TBL,28,82,35,29,64
36,8479420,Tage Thompson,C,BUF,27,82,31,33,64
36,8482116,Tim Stützle,C,OTT,22,82,26,38,64
36,8482078,Lucas Raymond,L,DET,22,82,24,40,64
36,8479314,Matthew Tkachuk,L,FLA,27,82,23,41,64
36,8481533,Trevor Zegras,C,ANA,23,82,16,48,64
36,8475754,Brock Nelson,C,NYI,33,82,36,27,63
36,8475913,Mark Stone,R,VGK,32,82,27,36,63
36,8480208,Drake Batherson,R,OTT,26,82,25,38,63
36,8475168,Matt Duchene,C,DAL,33,82,23,40,63
36,8483808,Andrei Kuzmenko,L,CGY,28,82,31,31,62
36,8476399,Blake Coleman,C,CGY,33,82,27,35,62
36,8471685,Anze Kopitar,C,LAK,37,82,16,46,62
36,8477500,Bo Horvat,C,NYI,29,82,30,31,61
36,8479339,Patrik Laine,L,CBJ,26,82,30,31,61
36,8473512,Claude Giroux,R,OTT,36,82,21,40,61
36,8478440,Dylan Strome,C,WSH,27,82,20,41,61
36,8476459,Mika Zibanejad,C,NYR,31,82,19,42,61
36,8477416,Oliver Bjorkstrand,R,SEA,29,82,18,43,61
36,8480839,Rasmus Dahlin,D,BUF,24,82,23,37,60
36,8474590,John Carlson,D,WSH,34,82,13,47,60
36,8476906,Shayne Gostisbehere,D,DET,31,82,13,47,60
36,8482745,Mason McTavish,C,ANA,21,82,28,31,59
36,8475784,Jeff Skinner,C,BUF,32,82,24,35,59
36,8474102,David Perron,L,DET,36,82,22,37,59
36,8475726,Tyler Toffoli,C,WPG,32,82,34,24,58
36,8476389,Vincent Trocheck,C,NYR,31,82,28,30,58
36,8478449,Roope Hintz,C,DAL,28,82,26,32,58
36,8482740,Wyatt Johnston,C,DAL,21,82,25,33,58
36,8477402,Pavel Buchnevich,L,STL,29,82,23,35,58
36,8478047,Michael Bunting,L,PIT,29,82,20,38,58
36,8474586,Jordan Eberle,R,SEA,34,82,20,38,58
36,8477951,Nick Schmaltz,C,ARI,28,82,13,45,58
36,8479325,Charlie McAvoy,D,BOS,27,82,8,50,58
36,8478366,Frank Vatrano,R,ANA,30,82,29,28,57
36,8475169,Evander Kane,L,EDM,33,82,25,32,57
36,8479542,Brandon Hagel,L,TBL,26,82,24,33,57
36,8476881,Tomas Hertl,C,VGK,31,82,21,36,57
36,8475158,Ryan O'Reilly,C,NSH,33,82,24,32,56
36,8478873,Troy Terry,R,ANA,27,82,19,37,56
36,8479999,Casey Mittelstadt,C,COL,26,82,16,40,56
36,8480014,Gabriel Vilardi,C,WPG,25,82,34,21,55
36,8476539,Jonathan Marchessault,R,VGK,34,82,28,27,55
36,8480830,Andrei Svechnikov,R,CAR,24,82,22,33,55
36,8475184,Chris Kreider,L,NYR,33,82,36,18,54
36,8476462,Dougie Hamilton,D,NJD,31,82,21,33,54
36,8482684,Luke Hughes,D,NJD,21,82,13,41,54
36,8478396,Noah Hanifin,D,VGK,27,82,8,46,54
36,8478493,Joel Eriksson Ek,C,MIN,27,82,28,25,53
36,8477949,Alex Tuch,R,BUF,28,82,22,31,53
36,8475798,Mikael Granlund,C,SJS,32,82,17,36,53
36,8482124,Quinton Byfield,R,LAK,22,82,15,38,53
36,8479323,Adam Fox,D,NYR,26,82,12,41,53
36,8477964,Ivan Barbashev,C,VGK,29,82,27,25,52
36,8473994,Jamie Benn,L,DAL,35,82,26,26,52
36,8481540,Cole Caufield,R,MTL,23,82,25,27,52
36,8474679,Gustav Nyquist,C,NSH,35,82,22,30,52
36,8477497,Sean Monahan,C,WPG,30,82,22,30,52
36,8480039,Martin Necas,C,CAR,25,82,19,33,52
36,8475692,Mats Zuccarello,R,MIN,37,82,16,36,52
36,8476853,Morgan Rielly,D,TOR,30,82,9,43,52
36,8475799,Nino Niederreiter,R,WPG,32,82,27,24,51
36,8480009,Eeli Tolvanen,R,SEA,25,82,25,26,51
36,8478444,Brock Boeser,R,VAN,27,82,22,29,51
36,8481596,Shane Pinto,C,OTT,24,82,19,32,51
36,8477456,J.T. Compher,L,DET,29,82,19,32,51
36,8477496,Elias Lindholm,C,VAN,30,82,15,36,51
36,8477504,Josh Morrissey,D,WPG,29,82,10,41,51
36,8475167,Victor Hedman,D,TBL,34,82,10,41,51
36,8474641,Adam Henrique,C,EDM,34,82,24,26,50
36,8476479,Phillip Danault,C,LAK,31,82,24,26,50
36,8477501,Valeri Nichushkin,R,COL,29,82,23,27,50
36,8477495,Seth Jones,D,CHI,30,82,10,40,50
36,8475314,Anders Lee,L,NYI,34,82,31,18,49
36,8478474,Lawson Crouse,L,ARI,27,82,25,24,49
36,8476483,Rickard Rakell,R,PIT,31,82,22,27,49
36,8476448,William Karlsson,C,VGK,31,82,21,28,49
36,8475170,Brayden Schenn,C,STL,33,82,21,28,49
36,8477444,Andre Burakovsky,L,SEA,29,82,10,39,49
36,8474157,Max Pacioretty,L,WSH,36,82,27,21,48
36,8476432,Boone Jenner,C,CBJ,31,82,26,22,48
36,8475794,Tyler Seguin,C,DAL,32,82,23,25,48
36,8474150,Mikael Backlund,C,CGY,35,82,21,27,48
36,8477494,Jonathan Drouin,L,COL,29,82,15,33,48
36,8478401,Pavel Zacha,C,BOS,27,82,13,35,48
36,8474578,Erik Karlsson,D,PIT,34,82,8,40,48
36,8477998,Warren Foegele,L,EDM,28,82,22,25,47
36,8476882,Teuvo Teravainen,L,CAR,30,82,20,27,47
36,8476905,Chandler Stephenson,C,VGK,30,82,14,33,47
36,8475191,Reilly Smith,R,PIT,33,82,25,21,46
36,8480188,Fabian Zetterlund,L,SJS,25,82,23,23,46
36,8480015,Owen Tippett,R,PHI,25,82,20,26,46
36,8482109,Alexis Lafrenière,L,NYR,23,82,19,27,46
36,8481528,Dylan Cozens,C,BUF,23,82,18,28,46
36,8480078,Filip Chytil,C,NYR,25,82,18,28,46
36,8482097,Jack Quinn,R,BUF,23,82,17,29,46
36,8479345,Jakob Chychrun,D,OTT,26,82,16,30,46
36,8477503,Max Domi,C,TOR,29,82,14,32,46
36,8482133,Thomas Bordeleau,C,SJS,22,82,22,23,45
36,8482055,Drew O'Connor,L,PIT,26,82,21,24,45
36,8476880,Tom Wilson,R,WSH,30,82,20,25,45
36,8478975,Mason Marchment,L,DAL,29,82,15,30,45
36,8479992,Michael Rasmussen,C,DET,25,82,14,31,45
36,8476875,Mike Matheson,D,MTL,30,82,12,33,45
36,8481542,Moritz Seider,D,DET,23,82,7,38,45
36,8478397,Rasmus Andersson,D,CGY,28,82,4,41,45
36,8477476,Artturi Lehkonen,L,COL,29,82,28,16,44
36,8475151,Kyle Palmieri,C,NYI,33,82,27,17,44
36,8479400,Pierre-Luc Dubois,L,LAK,26,82,21,23,44
36,8482110,Dawson Mercer,C,NJD,23,82,21,23,44
36,8475768,Jaden Schwartz,C,SEA,32,82,19,25,44
36,8475745,Charlie Coyle,C,BOS,32,82,19,25,44
36,8479675,Trevor Moore,L,LAK,29,82,17,27,44
36,8482175,JJ Peterka,R,BUF,22,82,17,27,44
36,8478472,Mathieu Joseph,R,OTT,27,82,12,32,44
36,8478460,Zach Werenski,D,CBJ,27,82,8,36,44
36,8482699,Dylan Guenther,R,ARI,21,82,26,17,43
36,8482159,Tyson Foerster,R,PHI,22,82,22,21,43
36,8481618,Alex Newhook,C,MTL,23,82,21,22,43
36,8475765,Vladimir Tarasenko,R,FLA,33,82,20,23,43
36,8482475,Yegor Chinakhov,R,CBJ,23,82,20,23,43
36,8483445,Cutter Gauthier,L,ANA,20,82,17,26,43
36,8474053,Logan Couture,C,SJS,35,82,16,27,43
36,8477986,Brandon Montour,D,FLA,30,82,15,28,43
36,8482665,Matty Beniers,C,SEA,22,82,13,30,43
36,8477479,Tyler Bertuzzi,L,TOR,29,82,13,30,43
36,8475744,Evgeny Kuznetsov,C,CAR,32,82,11,32,43
36,8481711,Matias Maccelli,L,ARI,24,82,8,35,43
36,8479525,Ross Colton,C,COL,28,82,25,17,42
36,8478466,Daniel Sprong,R,DET,27,82,20,22,42
36,8475763,Kevin Hayes,R,STL,32,82,19,23,42
36,8477451,Ryan Hartman,R,MIN,30,82,18,24,42
36,8478856,Conor Garland,R,VAN,28,82,16,26,42
36,8473986,Alex Killorn,L,ANA,35,82,15,27,42
36,8471724,Kris Letang,D,PIT,37,82,13,29,42
36,8477021,Alex Kerfoot,C,ARI,30,82,11,31,42
36,8480434,Sean Durzi,D,ARI,26,82,10,32,42
36,8481624,Ilya Mikheyev,R,VAN,30,82,23,18,41
36,8474037,James van Riemsdyk,L,BOS,35,82,18,23,41
36,8482667,William Eklund,L,SJS,22,82,17,24,41
36,8477935,Sam Bennett,C,FLA,28,82,16,25,41
36,8478133,Jake Evans,C,MTL,28,82,16,25,41
36,8477407,Anthony Duclair,L,TBL,29,82,14,27,41
36,8475218,Mattias Ekholm,D,EDM,34,82,11,30,41
36,8478469,Thomas Chabot,D,OTT,27,82,10,31,41
36,8482113,Anton Lundell,C,FLA,23,82,10,31,41
36,8478038,Devon Toews,D,COL,30,82,8,33,41
36,8483397,Marc McLaughlin,C,BOS,25,82,35,5,40
36,8478498,Jake DeBrusk,L,BOS,28,82,22,18,40
36,8475760,Nick Bjugstad,C,ARI,32,82,20,20,40
36,8471698,T.J. Oshie,R,WSH,38,82,16,24,40
36,8477429,Andrew Copp,C,DET,30,82,15,25,40
36,8480028,Morgan Frost,C,PHI,25,82,15,25,40
36,8479987,Morgan Geekie,C,BOS,26,82,13,27,40
36,8478891,Mason Appleton,C,WPG,28,82,13,27,40
36,8482122,Brock Faber,D,MIN,22,82,7,33,40
36,8481016,Ruslan Iskhakov,C,NYI,24,82,6,34,40
36,8476872,Scott Laughton,C,PHI,30,82,18,21,39
36,8478233,Andrew Mangiapane,L,CGY,28,82,16,23,39
36,8482146,Luke Evangelista,R,NSH,22,82,14,25,39
36,8482093,Seth Jarvis,C,CAR,22,82,12,27,39
36,8477932,Aaron Ekblad,D,FLA,28,82,10,29,39
36,8475722,Jason Zucker,L,NSH,32,82,24,14,38
36,8483524,Shane Wright,C,SEA,20,82,22,16,38
36,8478046,Danton Heinen,L,BOS,29,82,16,22,38
36,8477450,Jason Dickinson,C,CHI,29,82,15,23,38
36,8482720,Matthew Knies,L,TOR,22,82,13,25,38
36,8476869,Brady Skjei,D,CAR,30,82,13,25,38
36,8476826,Yanni Gourde,C,SEA,33,82,10,28,38
36,8476292,Ondrej Palat,L,NJD,33,82,10,28,38
36,8479425,Filip Hronek,D,VAN,27,82,9,29,38
36,8480031,Maxime Comtois,L,CAR,25,82,7,31,38
36,8477989,Christian Dvorak,C,MTL,28,82,22,15,37
36,8477426,Nicholas Paul,L,TBL,29,82,20,17,37
36,8480849,Barrett Hayton,C,ARI,24,82,19,18,37
36,8476438,Brandon Saad,L,STL,32,82,19,18,37
36,8481546,Cam York,D,PHI,23,82,13,24,37
36,8482222,Alexander Barabanov,L,SJS,30,82,12,25,37
36,8475791,Taylor Hall,L,CHI,33,82,11,26,37
36,8477346,MacKenzie Weegar,D,CGY,30,82,9,28,37
36,8483471,Brad Lambert,C,WPG,31,82,6,31,37
36,8482671,Owen Power,D,BUF,22,82,6,31,37
36,8477498,Darnell Nurse,D,EDM,29,82,6,31,37
36,8474563,Drew Doughty,D,LAK,35,82,4,33,37
36,8479423,Alex Nylander,L,CBJ,26,82,24,12,36
36,8484144,Connor Bedard,C,CHI,19,82,21,15,36
36,8482079,Marco Rossi,C,MIN,23,82,19,17,36
36,8474149,Evgenii Dadonov,R,DAL,35,82,17,19,36
36,8480802,Ryan McLeod,C,EDM,25,82,16,20,36
36,8482705,Cole Sillinger,C,CBJ,21,82,14,22,36
36,8478542,Evan Rodrigues,C,FLA,31,82,11,25,36
36,8476458,Ryan Strome,C,ANA,31,82,10,26,36
36,8475764,Cam Fowler,D,ANA,33,82,5,31,36
36,8481068,Yegor Sharangovich,C,CGY,26,82,22,13,35
36,8478115,Pierre Engvall,L,NYI,28,82,18,17,35
36,8480113,Alex Iafallo,L,WPG,31,82,18,17,35
36,8478438,Tommy Novak,C,NSH,27,82,17,18,35
36,8476925,Colton Sissons,C,NSH,31,82,17,18,35
36,8483515,Juraj Slafkovsky,L,MTL,20,82,16,19,35
36,8478055,Gustav Forsling,D,FLA,28,82,12,23,35
36,8482624,Daniil Miromanov,D,CGY,27,82,11,24,35
36,8480145,Neal Pionk,D,WPG,29,82,7,28,35
36,8474565,Alex Pietrangelo,D,VGK,34,82,6,29,35
36,8481581,Thomas Harley,D,DAL,23,82,6,29,35
36,8477944,Jakub Vrana,L,STL,28,82,21,13,34
36,8481013,Jonatan Berggren,R,DET,24,82,14,20,34
36,8474189,Lars Eller,C,PIT,35,82,12,22,34
36,8478463,Anthony Beauvillier,L,NSH,27,82,12,22,34
36,8480220,Noah Cates,L,PHI,25,82,10,24,34
36,8481656,Aliaksei Protas,C,WSH,23,82,9,25,34
36,8480797,Joel Farabee,L,PHI,24,82,8,26,34
36,8475753,Justin Faulk,D,STL,32,82,6,28,34
36,8479996,Cody Glass,C,NSH,25,82,18,15,33
36,8475848,Brendan Gallagher,R,MTL,32,82,16,17,33
36,8478462,Nicolas Roy,C,VGK,27,82,12,21,33
36,8477953,Kasperi Kapanen,R,STL,28,82,10,23,33
36,8471218,Blake Wheeler,R,NYR,38,82,10,23,33
36,8477948,Travis Sanheim,D,PHI,28,82,7,26,33
36,8481703,Valtteri Puustinen,R,PIT,25,82,5,28,33
36,8484153,Leo Carlsson,C,ANA,20,82,13,19,32
36,8476792,Torey Krug,D,STL,33,82,8,24,32
36,8477220,Nate Schmidt,D,WPG,33,82,8,24,32
36,8479398,Samuel Girard,D,COL,26,82,6,26,32
36,8479410,Mikhail Sergachev,D,TBL,26,82,5,27,32
36,8482702,Logan Stankoven,C,DAL,21,82,21,10,31
36,8475714,Calle Jarnkrok,C,TOR,33,82,19,12,31
36,8480893,Kirill Marchenko,R,CBJ,24,82,15,16,31
36,8475287,Erik Haula,L,NJD,33,82,14,17,31
36,8479415,Michael McLeod,C,NJD,26,82,13,18,31
36,8482074,Connor Zary,C,CGY,23,82,11,20,31
36,8470613,Brent Burns,D,CAR,39,82,10,21,31
36,8475197,Tyson Barrie,D,NSH,33,82,9,22,31
36,8480185,Eetu Luostarinen,C,FLA,26,82,7,24,31
36,8483457,Lane Hutson,D,MTL,20,82,6,25,31
36,8475906,John Klingberg,D,TOR,32,82,5,26,31
36,8481699,Aku Raty,R,ARI,23,82,3,28,31
36,8482089,Jake Neighbours,L,STL,22,82,19,11,30
36,8473449,Kyle Okposo,R,FLA,36,82,17,13,30
36,8480064,Josh Norris,C,OTT,25,82,15,15,30
36,8476329,Travis Boyd,C,ARI,31,82,12,18,30
36,8476392,Adam Lowry,C,WPG,31,82,9,21,30
36,8476897,Oskar Sundqvist,C,STL,30,82,9,21,30
36,8476958,Jaccob Slavin,D,CAR,30,82,8,22,30
36,8481535,Nils Hoglander,L,VAN,24,82,8,22,30
36,8478519,Anthony Cirelli,C,TBL,27,82,7,23,30
36,8482803,Olen Zellweger,D,ANA,21,82,6,24,30
36,8478043,Sam Lafferty,C,VAN,29,82,17,12,29
36,8476480,Vladislav Namestnikov,C,WPG,32,82,17,12,29
36,8480855,Jack McBain,C,ARI,24,82,16,13,29
36,8481604,Pavel Dorofeyev,L,VGK,24,82,15,14,29
36,8477952,Robby Fabbri,C,DET,28,82,15,14,29
36,8484166,Adam Fantilli,C,CBJ,20,82,15,14,29
36,8476873,Mark Jankowski,C,NSH,30,82,13,16,29
36,8478109,Victor Olofsson,L,BUF,29,82,12,17,29
36,8478413,Jordan Greenway,L,BUF,27,82,11,18,29
36,8477511,Anthony Mantha,R,VGK,30,82,10,19,29
36,8475793,Ryan Johansen,C,PHI,32,82,9,20,29
36,8479976,Juuso Valimaki,D,ARI,26,82,6,23,29
36,8477969,Marcus Pettersson,D,PIT,28,82,5,24,29
36,8478882,Vladislav Gavrikov,D,LAK,29,82,4,25,29
36,8482655,J.J. Moser,D,ARI,24,82,4,25,29
36,8478840,Will Borgen,D,SEA,28,82,1,28,29
36,8476981,Josh Anderson,R,MTL,30,82,20,8,28
36,8480459,Pius Suter,C,VAN,28,82,17,11,28
36,8483499,Liam Ohgren,L,MIN,20,82,15,13,28
36,8481553,Bobby Brink,R,PHI,23,82,15,13,28
36,8479365,Trent Frederic,C,BOS,26,82,13,15,28
36,8474715,Cam Atkinson,R,PHI,35,82,13,15,28
36,8474870,Tyler Johnson,C,CHI,34,82,12,16,28
36,8482105,Jake Sanderson,D,OTT,22,82,9,19,28
36,8480817,K'Andre Miller,D,NYR,24,82,7,21,28
36,8477506,Ryan Pulock,D,NYI,30,82,6,22,28
36,8475171,Oliver Ekman-Larsson,D,FLA,33,82,4,24,28
36,8480035,Henri Jokiharju,D,BUF,25,82,4,24,28
36,8481554,Kaapo Kakko,R,NYR,23,82,17,10,27
36,8470610,Zach Parise,L,COL,40,82,17,10,27
36,8479941,Justin Danforth,R,CBJ,31,82,16,11,27
36,8477947,Sonny Milano,L,WSH,28,82,15,12,27
36,8481093,Rafael Harvey-Pinard,L,MTL,25,82,15,12,27
36,8483431,Logan Cooley,C,ARI,20,82,15,12,27
36,8479291,Kevin Rooney,C,CGY,31,82,12,15,27
36,8476921,Jordan Martinook,L,CAR,32,82,11,16,27
36,8473422,Nick Foligno,L,CHI,37,82,11,16,27
36,8477919,Frederick Gaudreau,C,MIN,31,82,9,18,27
36,8479353,Brett Howden,C,VGK,26,82,9,18,27
36,8478500,Ivan Provorov,D,CBJ,27,82,7,20,27
36,8476419,Jean-Gabriel Pageau,C,NYI,32,82,7,20,27
36,8476979,Erik Gustafsson,D,NYR,32,82,5,22,27
36,8481567,Henry Thrun,D,SJS,23,82,3,24,27
36,8476923,Damon Severson,D,CBJ,30,82,1,26,27
36,8484203,Bradly Nadeau,L,CAR,19,82,21,5,26
36,8481186,Logan O'Connor,R,COL,28,82,17,9,26
36,8478458,Jack Roslovic,C,NYR,27,82,15,11,26
36,8479346,Dillon Dube,C,CGY,26,82,13,13,26
36,8475220,Marcus Foligno,L,MIN,33,82,11,15,26
36,8483505,Matthew Poitras,C,BOS,20,82,9,17,26
36,8480798,Philipp Kurashev,C,CHI,25,82,8,18,26
36,8473563,Nicklas Backstrom,C,WSH,37,82,6,20,26
36,8476885,Jacob Trouba,D,NYR,30,82,6,20,26
36,8482087,Kaiden Guhle,D,MTL,22,82,6,20,26
36,8483490,Pavel Mintyukov,D,ANA,21,82,6,20,26
36,8477488,Brett Pesce,D,CAR,30,82,6,20,26
36,8481605,Jackson LaCombe,D,ANA,23,82,6,20,26
36,8476331,Dylan DeMelo,D,WPG,31,82,6,20,26
36,8476854,Hampus Lindholm,D,BOS,30,82,4,22,26
36,8481606,Jordan Spence,D,LAK,23,82,4,22,26
36,8478851,Alexandre Carrier,D,NSH,28,82,2,24,26
36,8478508,Yakov Trenin,C,COL,27,82,16,9,25
36,8479977,Kailer Yamamoto,R,SEA,26,82,16,9,25
36,8476469,Joel Armia,R,MTL,31,82,13,12,25
36,8481560,Arthur Kaliyev,R,LAK,23,82,12,13,25
36,8479316,Luke Kunin,C,SJS,27,82,12,13,25
36,8482111,Justin Barron,D,MTL,23,82,11,14,25
36,8476374,Sean Kuraly,C,CBJ,31,82,10,15,25
36,8482062,Cole Smith,L,NSH,29,82,9,16,25
36,8473533,Jordan Staal,C,CAR,36,82,8,17,25
36,8476422,Mike Reilly,D,NYI,31,82,7,18,25
36,8480073,Erik Brannstrom,D,OTT,25,82,5,20,25
36,8481178,Egor Zamula,D,PHI,24,82,5,20,25
36,8482142,Jamie Drysdale,D,PHI,22,82,4,21,25
36,8476931,Jake McCabe,D,TOR,31,82,2,23,25
36,8474151,Ryan McDonagh,D,NSH,35,82,0,25,25
36,8476278,Colin Blackwell,C,CHI,31,82,13,11,24
36,8478013,Jake Walman,D,DET,28,82,13,11,24
36,8476960,Andreas Athanasiou,C,CHI,30,82,12,12,24
36,8481477,Nico Sturm,C,SJS,29,82,11,13,24
36,8481704,Juuso Parssinen,C,NSH,23,82,10,14,24
36,8476457,Adam Larsson,D,SEA,32,82,10,14,24
36,8481601,Simon Holmstrom,R,NYI,23,82,9,15,24
36,8476892,Colton Parayko,D,STL,31,82,8,16,24
36,8476927,Teddy Blueger,C,VAN,30,82,8,16,24
36,8476891,Matt Grzelcyk,D,BOS,30,82,7,17,24
36,8476463,Jonas Brodin,D,MIN,31,82,6,18,24
36,8475233,David Savard,D,MTL,34,82,6,18,24
36,8475188,Brayden McNabb,D,VGK,33,82,6,18,24
36,8478911,Matt Roy,D,LAK,29,82,5,19,24
36,8478178,Darren Raddysh,D,TBL,28,82,5,19,24
36,8480871,Adam Boqvist,D,CBJ,24,82,4,20,24
36,8475181,Nick Leddy,D,STL,33,82,3,21,24
36,8482145,Mavrik Bourque,C,DAL,22,82,17,6,23
36,8478020,Michael Amadio,C,VGK,28,82,14,9,23
36,8478057,Dakota Joshua,C,VAN,28,82,13,10,23
36,8480281,Alexey Toropchenko,R,STL,25,82,13,10,23
36,8480074,Alexandre Texier,C,CBJ,25,82,13,10,23
36,8479293,Brandon Tanev,L,SEA,33,82,13,10,23
36,8480068,Ryan Poehling,C,PHI,25,82,11,12,23
36,8482092,Ridly Greig,C,OTT,22,82,10,13,23
36,8473453,Trevor Lewis,C,LAK,37,82,10,13,23
36,8476871,Tanner Pearson,L,MTL,32,82,10,13,23
36,8475231,Casey Cizikas,C,NYI,33,82,9,14,23
36,8477015,Connor Brown,R,EDM,30,82,9,14,23
36,8480813,Joe Veleno,C,DET,24,82,8,15,23
36,8479359,Beck Malenstyn,L,WSH,26,82,8,15,23
36,8481481,Blake Lizotte,C,LAK,27,82,7,16,23
36,8476525,Colin Miller,D,WPG,32,82,7,16,23
36,8476312,Josh Manson,D,COL,33,82,7,16,23
36,8480336,Sean Walker,D,COL,30,82,6,17,23
36,8478430,Oliver Kylington,D,CGY,27,82,6,17,23
36,8478136,Jake Middleton,D,MIN,28,82,5,18,23
36,8475149,Marcus Johansson,L,MIN,34,82,3,20,23
36,8476917,Adam Pelech,D,NYI,30,82,2,21,23
36,8478569,Noel Acciari,C,PIT,33,82,14,8,22
36,8474884,Mike Hoffman,C,SJS,35,82,11,11,22
36,8481580,Connor McMichael,C,WSH,23,82,9,13,22
36,8470604,Jeff Carter,C,PIT,39,82,9,13,22
36,8479514,Rem Pitlick,C,CHI,27,82,9,13,22
36,8482737,Zack Bolduc,C,STL,21,82,9,13,22
36,8482730,Brandt Clarke,D,LAK,21,82,9,13,22
36,8480980,Connor Dewar,C,TOR,25,82,9,13,22
36,8480873,Rasmus Sandin,D,WSH,24,82,7,15,22
36,8477392,Hudson Fasching,R,NYI,29,82,7,15,22
36,8480821,Filip Zadina,R,SJS,25,82,6,16,22
36,8481014,Alexander Romanov,D,NYI,24,82,4,18,22
36,8478507,John Marino,D,NJD,27,82,3,19,22
36,8473507,Jeff Petry,D,DET,37,82,3,19,22
36,8477845,Trevor van Riemsdyk,D,WSH,33,82,3,19,22
36,8475208,Brian Dumoulin,D,SEA,33,82,2,20,22
36,8482118,Sam Colangelo,R,ANA,23,82,19,2,21
36,8483493,Frank Nazar,C,CHI,20,82,16,5,21
36,8482259,Bobby McMann,C,TOR,28,82,12,9,21
36,8479591,Michael Eyssimont,C,TBL,28,82,11,10,21
36,8475343,Nic Dowd,C,WSH,34,82,6,15,21
36,8474716,Jared Spurgeon,D,MIN,35,82,6,15,21
36,8479351,Sam Steel,C,DAL,26,82,5,16,21
36,8478451,Ethan Bear,D,WSH,27,82,5,16,21
36,8477839,Conor Sheary,L,TBL,32,82,4,17,21
36,8482733,Logan Mailloux,D,MTL,31,82,4,17,21
36,8475200,Dmitry Orlov,D,CAR,33,82,4,17,21
36,8480043,Timothy Liljegren,D,TOR,25,82,3,18,21
36,8475790,Erik Gudbranson,D,CBJ,32,82,2,19,21
36,8470621,Corey Perry,R,EDM,39,82,13,7,20
36,8482155,Alex Laferriere,R,LAK,23,82,13,7,20
36,8483482,Tristan Luneau,D,ANA,20,82,9,11,20
36,8476461,Sean Couturier,C,PHI,32,82,6,14,20
36,8481568,Alex Vlasic,D,CHI,23,82,3,17,20
36,8474673,TJ Brodie,D,TOR,34,82,1,19,20
36,8477406,Mattias Janmark,C,EDM,32,82,11,8,19
36,8476878,Zemgus Girgensons,L,BUF,30,82,11,8,19
36,8482101,Danil Gushchin,L,SJS,22,82,10,9,19
36,8477330,Dominik Kubalik,L,OTT,29,82,9,10,19
36,8477507,Nikita Zadorov,D,VAN,29,82,8,11,19
36,8478831,Kevin Stenlund,C,FLA,28,82,8,11,19
36,8481028,Martin Pospisil,C,CGY,25,82,8,11,19
36,8480796,Martin Fehervary,D,WSH,25,82,7,12,19
36,8481524,Bowen Byram,D,BUF,23,82,6,13,19
36,8480879,Jacob Bernard-Docker,D,OTT,24,82,6,13,19
36,8481537,Nikita Okhotiuk,D,CGY,24,82,6,13,19
36,8479371,Dante Fabbro,D,NSH,26,82,5,14,19
36,8480806,Isac Lundestrom,C,ANA,25,82,5,14,19
36,8477435,Ryan Graves,D,PIT,29,82,5,14,19
36,8476467,Jamie Oleksiak,D,SEA,32,82,4,15,19
36,8470600,Ryan Suter,D,DAL,39,82,3,16,19
36,8480058,Pierre-Olivier Joseph,D,PIT,25,82,2,17,19
36,8476879,Cody Ceci,D,EDM,31,82,0,19,19
36,8482679,Matt Coronato,R,CGY,22,82,11,7,18
36,8481522,Peyton Krebs,C,BUF,23,82,8,10,18
36,8476442,Matt Nieto,L,PIT,32,82,8,10,18
36,8483565,Nick Blankenburg,D,CBJ,26,82,6,12,18
36,8475842,Sam Carrick,C,EDM,32,82,6,12,18
36,8475179,Dmitry Kulikov,D,FLA,34,82,5,13,18
36,8482516,Matthew Kessel,D,STL,24,82,5,13,18
36,8475462,Radko Gudas,D,ANA,34,82,4,14,18
36,8475690,Chris Tanev,D,DAL,35,82,4,14,18
36,8480448,Parker Kelly,L,OTT,25,82,4,14,18
36,8477425,Miles Wood,L,COL,29,82,6,11,17
36,8482117,Lukas Reichel,L,CHI,22,82,5,12,17
36,8479390,Taylor Raddysh,R,CHI,26,82,5,12,17
36,8479983,Mario Ferraro,D,SJS,26,82,5,12,17
36,8480172,Jan Rutta,D,SJS,34,82,4,13,17
36,8475825,Jani Hakanpää,D,DAL,32,82,4,13,17
36,8482245,Artem Zub,D,OTT,29,82,3,14,17
36,8482470,Ilya Solovyov,D,CGY,24,82,3,14,17
36,8477335,Kyle Burroughs,D,SJS,29,82,3,14,17
36,8475324,Nick Jensen,D,WSH,34,82,2,15,17
36,8476967,Brett Kulak,D,EDM,30,82,1,16,17
36,8477353,Tyler Motte,C,TBL,29,82,10,6,16
36,8479661,Tanner Jeannot,L,TBL,27,82,9,7,16
36,8482125,Alexander Holtz,R,NJD,22,82,8,8,16
36,8475762,Derek Forbort,D,BOS,32,82,7,9,16
36,8480144,David Kampf,C,TOR,29,82,5,11,16
36,8474574,Tyler Myers,D,VAN,34,82,5,11,16
36,8470966,Mark Giordano,D,TOR,41,82,5,11,16
36,8474009,Nick Bonino,C,NYR,36,82,5,11,16
36,8477365,Connor Clifton,D,BUF,29,82,4,12,16
36,8474013,Ian Cole,D,VAN,35,82,4,12,16
36,8479980,Nicolas Hague,D,VGK,26,82,4,12,16
36,8483495,Simon Nemec,D,NJD,20,82,3,13,16
36,8479369,Andrew Peeke,D,BOS,26,82,2,14,16
36,8477369,Carson Soucy,D,VAN,30,82,1,15,16
36,8476624,Barclay Goodrow,C,NYR,31,82,8,7,15
36,8479998,Mikey Anderson,D,LAK,25,82,6,9,15
36,8477508,Curtis Lazar,C,NJD,29,82,6,9,15
36,8482166,Shakir Mukhamadullin,D,SJS,22,82,5,10,15
36,8475164,Jakob Silfverberg,R,ANA,34,82,4,11,15
36,8480990,Declan Chisholm,D,MIN,24,82,4,11,15
36,8482712,Oskar Olausson,R,COL,22,82,1,14,15
36,8476902,Esa Lindell,D,DAL,30,82,1,14,15
36,8475455,Brenden Dillon,D,WPG,34,82,1,14,15
36,8481517,Brett Leason,R,ANA,25,82,10,4,14
36,8484145,Zach Benson,L,BUF,19,82,9,5,14
36,8476822,Luke Glendening,C,TBL,35,82,8,6,14
36,8482177,Marat Khusnutdinov,C,MIN,22,82,6,8,14
36,8479393,Noah Gregor,C,TOR,26,82,5,9,14
36,8476429,Scott Mayfield,D,NYI,32,82,5,9,14
36,8474034,Pat Maroon,L,BOS,36,82,4,10,14
36,8476473,Connor Murphy,D,CHI,31,82,4,10,14
36,8474567,Zach Bogosian,D,MIN,34,82,3,11,14
36,8482858,Ryker Evans,D,SEA,23,82,3,11,14
36,8475279,Ben Chiarot,D,DET,33,82,2,12,14
36,8482073,Braden Schneider,D,NYR,23,82,1,13,14
36,8483491,Ivan Miroshnichenko,L,WSH,20,82,8,5,13
36,8476858,Phillip Di Giuseppe,L,VAN,31,82,8,5,13
36,8482762,Simon Edvinsson,D,DET,21,82,7,6,13
36,8484911,Collin Graf,R,SJS,22,82,4,9,13
36,8479324,Ryan Lindgren,D,NYR,26,82,3,10,13
36,8480246,Nick Perbix,D,TBL,26,82,2,11,13
36,8483763,Maksymilian Szuber,D,ARI,22,82,2,11,13
36,8480860,Kevin Bahl,D,NJD,24,82,2,11,13
36,8482809,Jackson Blake,R,CAR,21,82,9,3,12
36,8482666,Scott Morrow,D,CAR,22,82,7,5,12
36,8477505,Alexander Wennberg,C,NYR,30,82,3,9,12
36,8480834,Ty Emberson,D,SJS,24,82,3,9,12
36,8478416,Erik Cernak,D,TBL,27,82,2,10,12
36,8481059,Scott Perunovich,D,STL,26,82,2,10,12
36,8478443,Brandon Carlo,D,BOS,28,82,1,11,12
36,8473504,Cal Clutterbuck,R,NYI,37,82,5,6,11
36,8476372,Nick Seeler,D,PHI,31,82,5,6,11
36,8477931,Tomas Nosek,L,NJD,32,82,4,7,11
36,8471677,Jack Johnson,D,COL,37,82,2,9,11
36,8483468,Jiri Kulich,C,BUF,20,82,2,9,11
36,8479442,Troy Stecher,D,EDM,30,82,0,11,11
36,8478399,Jonas Siegenthaler,D,NJD,27,82,0,11,11
36,8483012,Logan Morrison,C,SEA,22,82,8,2,10
36,8474166,Alec Martinez,D,VGK,37,82,5,5,10
36,8478468,Jeremy Lauzon,D,NSH,27,82,5,5,10
36,8483489,Fraser Minten,C,TOR,31,82,5,5,10
36,8482807,Ethan Del Mastro,D,CHI,21,82,4,6,10
36,8476915,Jujhar Khaira,L,MIN,30,82,4,6,10
36,8481578,Graeme Clarke,R,NJD,23,82,4,6,10
36,8477034,Jaycob Megna,D,CHI,32,82,1,9,10
36,8484149,Gavin Brindley,C,CBJ,20,82,1,9,10
36,8478859,Niko Mikkola,D,FLA,28,82,3,6,9
36,8480807,Mattias Samuelsson,D,BUF,24,82,1,8,9
36,8483466,Kevin Korchinski,D,CHI,20,82,1,8,9
36,8477499,Rasmus Ristolainen,D,PHI,30,82,0,9,9
36,8475177,Calvin de Haan,D,TBL,33,82,2,6,8
36,8479383,Boris Katchouk,L,OTT,26,82,3,4,7
36,8481599,Victor Soderstrom,D,ARI,23,82,3,4,7
36,8478408,Travis Dermott,D,ARI,28,82,3,4,7
36,8482713,Mackie Samoskevich,R,FLA,22,82,2,5,7
36,8482859,Zack Ostapchuk,C,OTT,21,82,1,6,7
36,8481030,Jack St. Ivany,D,PIT,25,82,1,4,5
36,8482141,Lukas Cormier,D,VGK,22,0,0,0,0
36,8476988,Matt Benning,D,SJS,30,0,0,0,0
36,8480727,Zach Whitecloud,D,VGK,28,0,0,0,0
36,8480887,Jordan Harris,D,MTL,24,0,0,0,0
36,8478450,Parker Wotherspoon,D,BOS,27,0,0,0,0
36,8481812,Nikolai Knyzhov,D,SJS,27,0,0,0,0
36,8480001,Urho Vaakanainen,D,ANA,25,0,0,0,0
36,8482176,Wyatt Kaiser,D,CHI,22,0,0,0,0
36,8481122,Simon Benoit,D,TOR,26,0,0,0,0
36,8476441,Joel Edmundson,D,TOR,31,0,0,0,0
36,8480884,Calen Addison,D,SJS,24,0,0,0,0
36,8482511,Mason Lohrei,D,BOS,23,0,0,0,0
36,8482192,Isaak Phillips,D,CHI,23,0,0,0,0
36,8480950,Ilya Lyubushkin,D,TOR,30,0,0,0,0
36,8474031,Kevin Shattenkirk,D,BOS,35,0,0,0,0
36,8475718,Justin Holl,D,DET,32,0,0,0,0
36,8479402,Jake Bean,D,CBJ,26,0,0,0,0
36,8474602,Justin Schultz,D,SEA,34,0,0,0,0
36,8477950,Tony DeAngelo,D,CAR,29,0,0,0,0
36,8481743,Marc Del Gaizo,D,NSH,25,0,0,0,0
36,8481527,Kaedan Korczak,D,VGK,23,0,0,0,0
36,8480192,Johnathan Kovacevic,D,MTL,27,0,0,0,0
36,8476874,Olli Maatta,D,DET,30,0,0,0,0
36,8482144,Jack Thompson,D,SJS,22,0,0,0,0
36,8480222,Sebastian Aho,D,NYI,28,0,0,0,0
36,8479458,Nikita Zaitsev,D,CHI,33,0,0,0,0
36,8471709,Marc-Edouard Vlasic,D,SJS,37,0,0,0,0
36,8482929,Emil Lilleberg,D,TBL,23,0,0,0,0
36,8477018,Ben Hutton,D,VGK,31,0,0,0,0
36,8481056,Spencer Stastney,D,NSH,24,0,0,0,0
36,8481593,Jayden Struble,D,MTL,23,0,0,0,0
36,8479982,Conor Timmins,D,TOR,26,0,0,0,0
36,8474090,Brendan Smith,D,NJD,35,0,0,0,0
36,8482964,Arber Xhekaj,D,MTL,23,0,0,0,0
36,8480891,Michael Kesselring,D,ARI,24,0,0,0,0
36,8477938,Haydn Fleury,D,TBL,28,0,0,0,0
36,8481806,Louis Crevier,D,CHI,23,0,0,0,0
36,8471274,Alex Goligoski,D,MIN,39,0,0,0,0
36,8481600,Tobias Bjornfot,D,FLA,23,0,0,0,0
36,8475797,Jarred Tinordi,D,CHI,32,0,0,0,0
36,8481521,Ronnie Attard,D,PHI,25,0,0,0,0
36,8474612,Travis Hamonic,D,OTT,34,0,0,0,0
36,8479576,Vincent Desharnais,D,EDM,28,0,0,0,0
36,8480049,Dylan Samberg,D,WPG,25,0,0,0,0
36,8483619,Filip Roos,D,CHI,25,0,0,0,0
36,8474568,Luke Schenn,D,NSH,35,0,0,0,0
36,8480184,Gustav Lindstrom,D,ANA,26,0,0,0,0
36,8480070,Ian Mitchell,D,BOS,25,0,0,0,0
36,8480196,Jacob Bryson,D,BUF,27,0,0,0,0
36,8471686,Marc Staal,D,PHI,37,0,0,0,0
36,8477467,Gustav Olofsson,D,SEA,30,0,0,0,0
36,8478970,Jalen Chatfield,D,CAR,28,0,0,0,0
36,8479348,Kale Clague,D,BUF,26,0,0,0,0
36,8473446,Erik Johnson,D,PHI,36,0,0,0,0
36,8477462,Robert Hagg,D,ANA,29,0,0,0,0
36,8478454,Noah Juulsen,D,VAN,27,0,0,0,0
36,8477384,Josh Brown,D,ARI,30,0,0,0,0
36,8481708,Zac Jones,D,NYR,24,0,0,0,0
36,8481167,Brayden Pachal,D,CGY,25,0,0,0,0
36,8482067,Connor Mackey,D,NYR,28,0,0,0,0
36,8483460,David Jiricek,D,CBJ,21,0,0,0,0
36,8481701,Santeri Hatakka,D,NJD,23,0,0,0,0
36,8478021,William Lagesson,D,ANA,28,0,0,0,0
36,8477851,Jordan Oesterle,D,CGY,32,0,0,0,0
36,8478452,Caleb Jones,D,COL,27,0,0,0,0
36,8479984,Cal Foote,D,NJD,26,0,0,0,0
36,8479639,Dylan Coghlan,D,CAR,26,0,0,0,0
36,8480874,Adam Ginning,D,PHI,24,0,0,0,0
36,8479321,Lucas Johansen,D,WSH,27,0,0,0,0
36,8480878,Nils Lundkvist,D,DAL,24,0,0,0,0
36,8482165,Yan Kuznetsov,D,CGY,22,0,0,0,0
36,8484258,Sam Malinski,D,COL,26,0,0,0,0
36,8480157,Calle Rosen,D,STL,30,0,0,0,0
36,8484304,Uvis Balinskis,D,FLA,28,0,0,0,0
36,8479985,Cale Fleury,D,SEA,26,0,0,0,0
36,8479378,Logan Stanley,D,WPG,26,0,0,0,0
36,8477541,Dakota Mermis,D,MIN,30,0,0,0,0
36,8481609,Vladislav Kolyachonok,D,ARI,23,0,0,0,0
36,8480823,Alexander Alexeyev,D,WSH,25,0,0,0,0
36,8481679,Maxence Guenette,D,OTT,23,0,0,0,0
36,8481564,Ryan Johnson,D,BUF,23,0,0,0,0
36,8479376,Victor Mete,D,PHI,26,0,0,0,0
36,8484254,Akito Hirose,D,VAN,25,0,0,0,0
36,8482660,Kent Johnson,C,CBJ,22,0,0,0,0
36,8482149,Cole Perfetti,C,WPG,22,0,0,0,0
36,8477987,Ryan Donato,C,CHI,28,0,0,0,0
36,8475755,Alexander Petrovic,D,DAL,32,0,0,0,0
36,8477810,Joel Hanley,D,CGY,33,0,0,0,0
36,8474145,Robert Bortuzzo,D,NYI,35,0,0,0,0
36,8481161,Jake Christiansen,D,CBJ,25,0,0,0,0
36,8476884,Derrick Pouliot,D,DAL,30,0,0,0,0
36,8481716,Dmitri Voronkov,L,CBJ,24,0,0,0,0
36,8480084,Nick DeSimone,D,NJD,30,0,0,0,0
36,8475750,Jon Merrill,D,MIN,32,0,0,0,0
36,8479315,Joey Anderson,R,CHI,26,0,0,0,0
36,8478011,Louie Belpedio,D,PHI,28,0,0,0,0
36,8482451,Mikael Pyyhtia,L,CBJ,23,0,0,0,0
36,8481541,Samuel Bolduc,D,NYI,24,0,0,0,0
36,8482126,Emil Andrae,D,PHI,31,0,0,0,0
36,8474618,Marco Scandella,D,STL,34,0,0,0,0
36,8477244,Chad Ruhwedel,D,NYR,34,0,0,0,0
36,8477971,Andreas Englund,D,LAK,28,0,0,0,0
36,8480829,Jesperi Kotkaniemi,C,CAR,24,0,0,0,0
36,8479372,Josh Mahura,D,FLA,26,0,0,0,0
36,8482095,Tyler Kleven,D,OTT,22,0,0,0,0
36,8481719,Maxwell Crozier,D,TBL,24,0,0,0,0
36,8475855,Jesper Fast,R,CAR,33,0,0,0,0
36,8480848,Ty Dellandrea,C,DAL,24,0,0,0,0
36,8475193,Tomas Tatar,L,SEA,34,0,0,0,0
36,8476889,Radek Faksa,C,DAL,30,0,0,0,0
36,8478495,Denis Gurianov,R,PHI,27,0,0,0,0
36,8480216,Jacob Peterson,C,SJS,25,0,0,0,0
36,8480252,Cole Guttman,C,CHI,25,0,0,0,0
36,8479026,Philippe Myers,D,TBL,27,0,0,0,0
36,8481006,Tyler Tucker,D,STL,24,0,0,0,0
36,8481032,Paul Cotter,C,VGK,25,0,0,0,0
36,8481577,Philip Tomasino,C,NSH,23,0,0,0,0
36,8476918,Jimmy Vesey,L,NYR,31,0,0,0,0
36,8479320,Max Lajoie,D,TOR,27,0,0,0,0
36,8478017,Mark Friedman,D,VAN,29,0,0,0,0
36,8481754,Nikita Nesterenko,C,ANA,23,0,0,0,0
36,8483407,Brandon Scanlin,D,NYR,25,0,0,0,0
36,8482659,Josh Doan,R,ARI,22,0,0,0,0
36,8477446,Michael McCarron,R,NSH,29,0,0,0,0
36,8477903,Garnet Hathaway,R,PHI,33,0,0,0,0
36,8482153,Brendan Brisson,C,VGK,23,0,0,0,0
36,8483546,Marshall Rifai,D,TOR,26,0,0,0,0
36,8484287,Cole McWard,D,VAN,23,0,0,0,0
36,8478854,Ryan Shea,D,PIT,27,0,0,0,0
36,8481585,Egor Afanasyev,L,NSH,23,0,0,0,0
36,8483398,Declan Carlile,D,TBL,31,0,0,0,0
36,8478502,Dennis Gilbert,D,CGY,28,0,0,0,0
36,8482749,Joshua Roy,R,MTL,21,0,0,0,0
36,8481598,Philip Broberg,D,EDM,23,0,0,0,0
36,8480835,Jack Drury,C,CAR,24,0,0,0,0
36,8480748,Kiefer Sherwood,L,NSH,29,0,0,0,0
36,8476934,Brock McGinn,L,ANA,30,0,0,0,0
36,8480870,Bo Groulx,C,ANA,24,0,0,0,0
36,8479368,Max Jones,L,ANA,26,0,0,0,0
36,8478099,Kevin Labanc,R,SJS,29,0,0,0,0
36,8478067,Oskar Lindblom,L,SJS,28,0,0,0,0
36,8476393,Nick Cousins,C,FLA,31,0,0,0,0
36,8483395,Arshdeep Bains,L,VAN,23,0,0,0,0
36,8480762,Eric Robinson,L,BUF,29,0,0,0,0
36,8479439,Jacob MacDonald,D,SJS,31,0,0,0,0
36,8476474,Stefan Noesen,R,CAR,31,0,0,0,0
36,8482787,Nikita Chibrikov,R,WPG,31,0,0,0,0
36,8478432,Christian Fischer,R,DET,27,0,0,0,0
36,8477979,Nicolas Aube-Kubel,R,WSH,28,0,0,0,0
36,8481789,Tye Kartye,L,SEA,23,0,0,0,0
36,8479330,Brandon Gignac,C,MTL,27,0,0,0,0
36,8480075,Cameron Crotty,D,ARI,25,0,0,0,0
36,8473473,Milan Lucic,L,BOS,36,0,0,0,0
36,8482094,Daemon Hunt,D,MIN,22,0,0,0,0
36,8481206,John Ludvig,D,PIT,24,0,0,0,0
36,8483630,Pavol Regenda,L,ANA,25,0,0,0,0
36,8481617,Vasily Podkolzin,R,VAN,23,0,0,0,0
36,8480306,Grant Hutton,D,NYI,29,0,0,0,0
36,8480995,Pontus Holmberg,R,TOR,25,0,0,0,0
36,8482148,Hendrix Lapierre,C,WSH,22,0,0,0,0
36,8477478,William Carrier,L,VGK,30,0,0,0,0
36,8480003,Jesper Boqvist,C,BOS,26,0,0,0,0
36,8482172,Landon Slaggert,L,CHI,22,0,0,0,0
36,8480789,Oliver Wahlstrom,R,NYI,24,0,0,0,0
36,8474062,Riley Nash,C,NYR,35,0,0,0,0
36,8480021,Jack Studnicka,C,SJS,25,0,0,0,0
36,8480025,MacKenzie Entwistle,R,CHI,25,0,0,0,0
36,8481582,Nicholas Robertson,L,TOR,23,0,0,0,0
36,8476867,Brendan Gaunce,C,CBJ,30,0,0,0,0
36,8479619,Michael Carcone,L,ARI,28,0,0,0,0
36,8479370,Tyson Jost,C,BUF,26,0,0,0,0
36,8479671,Mathieu Olivier,R,CBJ,27,0,0,0,0
36,8476994,Vinnie Hinostroza,C,PIT,30,0,0,0,0
36,8482070,Mitchell Chaffee,R,TBL,26,0,0,0,0
36,8477473,Justin Bailey,R,SJS,29,0,0,0,0
36,8479344,Jesse Puljujarvi,R,PIT,26,0,0,0,0
36,8480205,Emil Bemstrom,C,PIT,25,0,0,0,0
36,8479718,Alex Barré-Boulet,C,TBL,27,0,0,0,0
36,8482061,Brandon Biro,L,BUF,26,0,0,0,0
36,8479638,Justin Brazeau,R,BOS,26,0,0,0,0
36,8474040,Sam Gagner,C,EDM,35,0,0,0,0
36,8477846,Ryan Carpenter,C,SJS,33,0,0,0,0
36,8482077,Dylan Holloway,L,EDM,23,0,0,0,0
36,8482157,Will Cuylle,L,NYR,22,0,0,0,0
36,8480007,Jonas Rondbjerg,R,VGK,25,0,0,0,0
36,8478874,Adam Gaudette,C,STL,28,0,0,0,0
36,8478434,Keegan Kolesar,R,VGK,27,0,0,0,0
36,8480441,Trey Fix-Wolansky,R,CBJ,25,0,0,0,0
36,8479994,Jaret Anderson-Dolan,C,NSH,25,0,0,0,0
36,8483567,Georgii Merkulov,C,BOS,24,0,0,0,0
36,8477380,Jonny Brodzinski,C,NYR,31,0,0,0,0
36,8482201,Gage Goncalves,C,TBL,23,0,0,0,0
36,8478211,Dryden Hunt,L,CGY,29,0,0,0,0
36,8471699,Andrew Cogliano,C,COL,37,0,0,0,0
36,8479421,Jacob Moverare,D,LAK,26,0,0,0,0
36,8478881,Brett Seney,L,CHI,28,0,0,0,0
36,8477464,Nic Petan,C,MIN,29,0,0,0,0
36,8475958,Michael Sgarbossa,C,WSH,32,0,0,0,0
36,8481147,Reese Johnson,C,CHI,26,0,0,0,0
36,8479336,Carl Grundstrom,R,LAK,27,0,0,0,0
36,8480853,Liam Foudy,C,NSH,24,0,0,0,0
36,8479522,Hardy Haman Aktell,D,WSH,26,0,0,0,0
36,8481462,Mason Morelli,L,VGK,28,0,0,0,0
36,8482102,Vasily Ponomarev,C,CAR,22,0,0,0,0
36,8480844,Grigori Denisenko,L,VGK,24,0,0,0,0
36,8479944,Zach Aston-Reese,C,DET,30,0,0,0,0
36,8482784,Zach Dean,C,STL,21,0,0,0,0
36,8479419,Brett Murray,L,BUF,26,0,0,0,0
36,8479520,Brandon Duhaime,R,COL,27,0,0,0,0
36,8477573,Nathan Walker,L,STL,30,0,0,0,0
36,8478078,Rourke Chartier,C,OTT,28,0,0,0,0
36,8475795,Dylan McIlrath,D,WSH,32,0,0,0,0
36,8482496,Nils Aman,C,VAN,24,0,0,0,0
36,8480289,Morgan Barron,C,WPG,26,0,0,0,0
36,8481751,Lukas Rousek,R,BUF,25,0,0,0,0
36,8480011,Klim Kostin,C,SJS,25,0,0,0,0
36,8481556,John Beecher,C,BOS,23,0,0,0,0
36,8475278,Byron Froese,C,VGK,33,0,0,0,0
36,8475225,Craig Smith,C,DAL,35,0,0,0,0
36,8484326,Patrik Koch,D,ARI,28,0,0,0,0
36,8477930,Pierre-Edouard Bellemare,L,SEA,39,0,0,0,0
36,8478409,Anthony Richard,C,BOS,28,0,0,0,0
36,8481024,Linus Karlsson,C,VAN,25,0,0,0,0
36,8479986,Kole Lind,R,SEA,26,0,0,0,0
36,8479414,Nathan Bastian,R,NJD,27,0,0,0,0
36,8479362,Riley Tufte,L,COL,26,0,0,0,0
36,8481058,Jesse Ylönen,R,MTL,25,0,0,0,0
36,8482476,Emil Heineman,L,MTL,23,0,0,0,0
36,8482861,Vincent Iorio,D,WSH,22,0,0,0,0
36,8483432,Luca Del Bel Belluz,C,CBJ,31,0,0,0,0
36,8482744,James Malatesta,L,CBJ,21,0,0,0,0
36,8477887,Patrick Brown,C,BOS,32,0,0,0,0
36,8478585,Derek Ryan,C,EDM,38,0,0,0,0
36,8481441,Joe Snively,C,WSH,28,0,0,0,0
36,8481592,Jakob Pelletier,L,CGY,23,0,0,0,0
36,8482634,Alex Steeves,C,TOR,25,0,0,0,0
36,8477126,Jayson Megna,C,BOS,34,0,0,0,0
36,8475752,Tyler Pitlick,C,NYR,33,0,0,0,0
36,8480008,Adam Ruzicka,C,ARI,25,0,0,0,0
36,8481065,Angus Crookshank,L,OTT,25,0,0,0,0
36,8479547,Matthew Phillips,R,WSH,26,0,0,0,0
36,8480226,Marián Studenic,R,SEA,26,0,0,0,0
36,8481237,Kyle MacLean,C,NYI,25,0,0,0,0
36,8475413,Justin Dowling,C,NJD,34,0,0,0,0
36,8481641,Joel Kiviranta,L,COL,28,0,0,0,0
36,8478104,Sammy Blais,L,STL,28,0,0,0,0
36,8477454,Adam Erne,L,EDM,29,0,0,0,0
36,8481518,Nolan Foote,L,NJD,24,0,0,0,0
36,8480245,Olle Lycksell,R,PHI,25,0,0,0,0
36,8483570,Ben Meyers,C,ANA,26,0,0,0,0
36,8480776,Sheldon Rempal,R,VGK,29,0,0,0,0
36,8483920,Pierrick Dube,R,WSH,23,0,0,0,0
36,8480267,Sammy Walker,C,MIN,25,0,0,0,0
36,8482747,Brennan Othmann,L,NYR,21,0,0,0,0
36,8479991,Jake Leschyshyn,C,NYR,25,0,0,0,0
36,8478400,Colin White,C,MTL,27,0,0,0,0
36,8479328,Julien Gauthier,R,NYI,27,0,0,0,0
36,8484325,Waltteri Merela,C,TBL,26,0,0,0,0
36,8479066,Ryan Lomberg,L,FLA,30,0,0,0,0
36,8477070,Liam O'Brien,C,ARI,30,0,0,0,0
36,8478146,Matthew Highmore,C,OTT,28,0,0,0,0
36,8478028,Fredrik Olofsson,L,COL,28,0,0,0,0
36,8480880,Jakub Lauko,C,BOS,24,0,0,0,0
36,8479968,Vinni Lettieri,C,MIN,29,0,0,0,0
36,8474709,Matt Martin,L,NYI,35,0,0,0,0
36,8480845,Rasmus Kupari,C,WPG,24,0,0,0,0
36,8481550,Adam Beckman,L,MIN,23,0,0,0,0
36,8481422,Jacob Lucchini,C,MIN,29,0,0,0,0
36,8477401,John Hayden,C,SEA,29,0,0,0,0
36,8478904,Steven Lorentz,C,FLA,28,0,0,0,0
36,8482088,Justin Sourdif,R,FLA,22,0,0,0,0
36,8482751,Ryan Winterton,C,SEA,21,0,0,0,0
36,8482241,Radim Zohorna,L,PIT,28,0,0,0,0
36,8481690,Tyler Angle,C,CBJ,24,0,0,0,0
36,8476952,Dominic Toninato,C,WPG,30,0,0,0,0
36,8476919,Chris Tierney,C,NJD,30,0,0,0,0
36,8480032,Shane Bowers,C,NJD,25,0,0,0,0
36,8484314,Jiri Smejkal,L,OTT,28,0,0,0,0
36,8481239,Samuel Fagemo,L,LAK,24,0,0,0,0
36,8481532,Alex Turcotte,C,LAK,23,0,0,0,0
36,8481019,David Gustafsson,C,WPG,24,0,0,0,0
36,8478477,Mitchell Stephens,C,MTL,27,0,0,0,0
36,8479546,Oskar Steen,C,BOS,26,0,0,0,0
36,8480292,Carson Meyer,R,CBJ,27,0,0,0,0
36,8478446,Glenn Gawdin,C,ANA,27,0,0,0,0
36,8483531,Brian Halonen,L,NJD,25,0,0,0,0
36,8477149,Scott Sabourin,R,SJS,32,0,0,0,0
36,8479972,Mason Shaw,C,MIN,26,0,0,0,0
36,8480890,Jan Jenik,R,ARI,24,0,0,0,0
36,8478051,Max Willman,C,NJD,29,0,0,0,0
36,8480851,Akil Thomas,C,LAK,24,0,0,0,0
36,8482765,Isak Rosen,R,BUF,21,0,0,0,0
36,8478421,A.J. Greer,L,CGY,28,0,0,0,0
36,8478512,Austin Czarnik,C,DET,32,0,0,0,0
36,8479536,Axel Jonsson-Fjallby,L,WPG,26,0,0,0,0
36,8477320,Anton Blidh,L,NYR,29,0,0,0,0
36,8481543,Nikita Alexandrov,C,STL,24,0,0,0,0
36,8475235,Nicolas Deslauriers,L,PHI,33,0,0,0,0
36,8481070,Hugh McGing,L,STL,26,0,0,0,0
36,8480836,Jonathan Gruden,C,PIT,24,0,0,0,0
36,8481591,Sam Poulin,R,PIT,23,0,0,0,0
36,8477962,Brendan Lemieux,L,CAR,28,0,0,0,0
36,8483401,Marc Johnstone,R,PIT,28,0,0,0,0
36,8482250,Callahan Burke,C,CAR,27,0,0,0,0
36,8481726,Adam Edstrom,C,NYR,24,0,0,0,0
36,8471817,Ryan Reaves,R,TOR,37,0,0,0,0
36,8479587,Rhett Gardner,C,PHI,28,0,0,0,0
36,8475766,Austin Watson,L,TBL,32,0,0,0,0
36,8479367,William Lockwood,R,FLA,26,0,0,0,0
36,8478424,Jansen Harkins,C,PIT,27,0,0,0,0
36,8476913,Devin Shore,C,SEA,30,0,0,0,0
36,8482652,Walker Duehr,R,CGY,27,0,0,0,0
36,8477527,Ross Johnston,L,ANA,30,0,0,0,0
36,8481077,John Leonard,L,ARI,26,0,0,0,0
36,8483549,Lucas Condotta,L,MTL,27,0,0,0,0
36,8480468,James Hamblin,L,EDM,25,0,0,0,0
36,8476907,Mackenzie MacEachern,L,STL,30,0,0,0,0
36,8479543,Michael Pezzetta,L,MTL,26,0,0,0,0
36,8480355,Mark Kastelic,C,OTT,25,0,0,0,0
36,8482162,Roby Jarventie,L,OTT,22,0,0,0,0
36,8479772,Zack MacEwen,R,OTT,28,0,0,0,0
36,8483597,Milos Kelemen,L,ARI,25,0,0,0,0
36,8479379,Givani Smith,R,SJS,26,0,0,0,0
36,8481655,Cole Schwindt,R,CGY,23,0,0,0,0
36,8479981,Jonah Gadjovich,L,FLA,26,0,0,0,0
36,8482147,Jean-Luc Foudy,C,COL,22,0,0,0,0
36,8484255,Jason Polin,R,COL,25,0,0,0,0
36,8477993,Justin Kirkland,C,ARI,28,0,0,0,0
36,8479249,Andrew Poturalski,C,SEA,30,0,0,0,0
36,8482197,Adam Raska,R,MIN,23,0,0,0,0
36,8475780,Chris Wagner,R,COL,33,0,0,0,0
36,8479533,Joona Koppanen,L,PIT,26,0,0,0,0
36,8481534,Raphael Lavoie,C,EDM,24,0,0,0,0
36,8484321,Nikolas Matinpalo,D,OTT,26,0,0,0,0
36,8481043,Cole Koepke,L,TBL,26,0,0,0,0
36,8476323,Max McCormick,L,SEA,32,0,0,0,0
36,8483609,Adam Klapka,R,CGY,24,0,0,0,0
36,8483512,Matt Savoie,C,BUF,20,0,0,0,0
36,8484259,Ondrej Pavel,C,COL,31,0,0,0,0
36,8478147,Bokondji Imama,L,OTT,28,0,0,0,0
36,8482460,Matt Rempe,C,NYR,22,0,0,0,0
36,8477073,Kurtis MacDermid,L,NJD,30,0,0,0,0
36,8480274,Philip Kemp,D,EDM,25,0,0,0,0
36,8478956,Samuel Laberge,L,NJD,27,0,0,0,0
36,8483045,Cameron Butler,R,CBJ,31,0,0,0,0
37,8477492,Nathan MacKinnon,C,COL,29,82,55,70,125
37,8478864,Kirill Kaprizov,L,MIN,27,82,58,59,117
37,8481559,Jack Hughes,C,NJD,23,82,48,66,114
37,8476453,Nikita Kucherov,R,TBL,31,82,40,73,113
37,8477933,Sam Reinhart,C,FLA,29,82,56,53,109
37,8478402,Connor McDavid,C,EDM,27,82,38,65,103
37,8479314,Matthew Tkachuk,L,FLA,27,82,31,63,94
37,8477956,David Pastrnak,R,BOS,28,82,44,49,93
37,8480800,Quinn Hughes,D,VAN,25,82,21,72,93
37,8478550,Artemi Panarin,L,NYR,33,82,33,59,92
37,8479318,Auston Matthews,C,TOR,27,82,48,42,90
37,8480027,Jason Robertson,L,DAL,25,82,36,54,90
37,8478439,Travis Konecny,R,PHI,27,82,35,55,90
37,8480012,Elias Pettersson,C,VAN,26,82,35,54,89
37,8477939,William Nylander,R,TOR,28,82,31,57,88
37,8478010,Brayden Point,C,TBL,28,82,40,47,87
37,8481523,Kirby Dach,C,MTL,23,82,11,74,85
37,8478420,Mikko Rantanen,R,COL,28,82,36,48,84
37,8477934,Leon Draisaitl,C,EDM,29,82,33,51,84
37,8478445,Mathew Barzal,C,NYI,27,82,29,55,84
37,8480002,Nico Hischier,C,NJD,25,82,37,44,81
37,8476468,J.T. Miller,C,VAN,31,82,25,56,81
37,8480018,Nick Suzuki,C,MTL,25,82,24,56,80
37,8478449,Roope Hintz,C,DAL,28,82,30,49,79
37,8479407,Jesper Bratt,L,NJD,26,82,23,56,79
37,8479385,Jordan Kyrou,C,STL,26,82,41,37,78
37,8471675,Sidney Crosby,C,PIT,37,82,35,43,78
37,8475166,John Tavares,C,TOR,34,82,34,44,78
37,8480069,Cale Makar,D,COL,26,82,17,61,78
37,8476887,Filip Forsberg,L,NSH,30,82,30,47,77
37,8475168,Matt Duchene,C,DAL,33,82,23,54,77
37,8478403,Jack Eichel,C,VGK,28,82,36,40,76
37,8474564,Steven Stamkos,C,TBL,34,82,29,47,76
37,8476454,Ryan Nugent-Hopkins,C,EDM,31,82,23,53,76
37,8478975,Mason Marchment,L,DAL,29,82,32,42,74
37,8479542,Brandon Hagel,L,TBL,26,82,33,40,73
37,8473419,Brad Marchand,L,BOS,36,82,25,48,73
37,8473994,Jamie Benn,L,DAL,35,82,20,53,73
37,8479323,Adam Fox,D,NYR,26,82,13,60,73
37,8481540,Cole Caufield,R,MTL,23,82,45,27,72
37,8477409,Carter Verhaeghe,C,FLA,29,82,34,38,72
37,8480036,Miro Heiskanen,D,DAL,25,82,17,55,72
37,8474600,Roman Josi,D,NSH,34,82,18,53,71
37,8475184,Chris Kreider,L,NYR,33,82,43,27,70
37,8478042,Viktor Arvidsson,R,LAK,31,82,31,39,70
37,8471214,Alex Ovechkin,L,WSH,39,82,29,41,70
37,8470794,Joe Pavelski,C,DAL,40,82,28,42,70
37,8476346,Johnny Gaudreau,L,CBJ,31,82,17,53,70
37,8479420,Tage Thompson,C,BUF,27,82,33,36,69
37,8477949,Alex Tuch,R,BUF,28,82,26,43,69
37,8475158,Ryan O'Reilly,C,NSH,33,82,34,33,67
37,8477946,Dylan Larkin,C,DET,28,82,30,37,67
37,8476459,Mika Zibanejad,C,NYR,31,82,24,43,67
37,8481557,Matt Boldy,L,MIN,23,82,27,39,66
37,8477951,Nick Schmaltz,C,ARI,28,82,25,41,66
37,8477402,Pavel Buchnevich,L,STL,29,82,23,43,66
37,8477493,Aleksander Barkov,C,FLA,29,82,22,44,66
37,8478427,Sebastian Aho,C,CAR,27,82,35,30,65
37,8477404,Jake Guentzel,C,CAR,30,82,30,35,65
37,8474590,John Carlson,D,WSH,34,82,16,49,65
37,8475798,Mikael Granlund,C,SJS,32,82,14,51,65
37,8475167,Victor Hedman,D,TBL,34,82,13,52,65
37,8482116,Tim Stützle,C,OTT,22,82,26,38,64
37,8480801,Brady Tkachuk,L,OTT,25,82,34,29,63
37,8478493,Joel Eriksson Ek,C,MIN,27,82,30,33,63
37,8479337,Alex DeBrincat,R,DET,27,82,27,36,63
37,8478440,Dylan Strome,C,WSH,27,82,25,38,63
37,8476432,Boone Jenner,C,CBJ,31,82,39,23,62
37,8477960,Adrian Kempe,R,LAK,28,82,34,28,62
37,8476389,Vincent Trocheck,C,NYR,31,82,26,36,62
37,8482740,Wyatt Johnston,C,DAL,21,82,25,37,62
37,8475170,Brayden Schenn,C,STL,33,82,22,40,62
37,8475786,Zach Hyman,L,EDM,32,82,33,28,61
37,8479343,Clayton Keller,R,ARI,26,82,30,31,61
37,8475151,Kyle Palmieri,C,NYI,33,82,29,32,61
37,8477955,Jared McCann,L,SEA,28,82,26,35,61
37,8477494,Jonathan Drouin,L,COL,29,82,13,48,61
37,8479325,Charlie McAvoy,D,BOS,27,82,8,53,61
37,8475810,Bryan Rust,R,PIT,32,82,31,29,60
37,8478444,Brock Boeser,R,VAN,27,82,31,29,60
37,8477501,Valeri Nichushkin,R,COL,29,82,29,31,60
37,8482097,Jack Quinn,R,BUF,23,82,27,33,60
37,8476460,Mark Scheifele,C,WPG,31,82,25,35,60
37,8476905,Chandler Stephenson,C,VGK,30,82,21,39,60
37,8476853,Morgan Rielly,D,TOR,30,82,9,51,60
37,8471685,Anze Kopitar,C,LAK,37,82,21,38,59
37,8475784,Jeff Skinner,C,BUF,32,82,21,38,59
37,8478414,Timo Meier,R,NJD,28,82,26,32,58
37,8475172,Nazem Kadri,C,CGY,34,82,22,36,58
37,8482665,Matty Beniers,C,SEA,22,82,21,37,58
37,8482124,Quinton Byfield,R,LAK,22,82,15,43,58
37,8476880,Tom Wilson,R,WSH,30,82,27,30,57
37,8482093,Seth Jarvis,C,CAR,22,82,24,33,57
37,8477496,Elias Lindholm,C,VAN,30,82,17,40,57
37,8477935,Sam Bennett,C,FLA,28,82,31,25,56
37,8479400,Pierre-Luc Dubois,L,LAK,26,82,30,26,56
37,8476539,Jonathan Marchessault,R,VGK,34,82,24,32,56
37,8478873,Troy Terry,R,ANA,27,82,23,33,56
37,8478398,Kyle Connor,L,WPG,28,82,21,35,56
37,8480208,Drake Batherson,R,OTT,26,82,20,36,56
37,8475765,Vladimir Tarasenko,R,FLA,33,82,20,36,56
37,8476479,Phillip Danault,C,LAK,31,82,19,37,56
37,8482109,Alexis Lafrenière,L,NYR,23,82,27,28,55
37,8471698,T.J. Oshie,R,WSH,38,82,26,29,55
37,8484144,Connor Bedard,C,CHI,19,82,26,29,55
37,8480023,Robert Thomas,C,STL,25,82,14,41,55
37,8479410,Mikhail Sergachev,D,TBL,26,82,5,50,55
37,8475169,Evander Kane,L,EDM,33,82,29,25,54
37,8480830,Andrei Svechnikov,R,CAR,24,82,25,29,54
37,8480893,Kirill Marchenko,R,CBJ,24,82,23,31,54
37,8475692,Mats Zuccarello,R,MIN,37,82,13,41,54
37,8480865,Noah Dobson,D,NYI,24,82,9,45,54
37,8482745,Mason McTavish,C,ANA,21,82,19,34,53
37,8477444,Andre Burakovsky,L,SEA,29,82,18,35,53
37,8481542,Moritz Seider,D,DET,23,82,5,48,53
37,8476448,William Karlsson,C,VGK,31,82,23,29,52
37,8474141,Patrick Kane,R,DET,36,82,15,37,52
37,8482684,Luke Hughes,D,NJD,21,82,15,37,52
37,8475753,Justin Faulk,D,STL,32,82,15,37,52
37,8474578,Erik Karlsson,D,PIT,34,82,12,40,52
37,8477940,Nikolaj Ehlers,L,WPG,28,82,26,25,51
37,8477407,Anthony Duclair,L,TBL,29,82,23,28,51
37,8483808,Andrei Kuzmenko,L,CGY,28,82,20,31,51
37,8476462,Dougie Hamilton,D,NJD,31,82,17,34,51
37,8481581,Thomas Harley,D,DAL,23,82,14,37,51
37,8477942,Kevin Fiala,L,LAK,28,82,13,38,51
37,8478460,Zach Werenski,D,CBJ,27,82,8,43,51
37,8476483,Rickard Rakell,R,PIT,31,82,28,22,50
37,8477476,Artturi Lehkonen,L,COL,29,82,28,22,50
37,8480015,Owen Tippett,R,PHI,25,82,22,28,50
37,8481533,Trevor Zegras,C,ANA,23,82,21,29,50
37,8482078,Lucas Raymond,L,DET,22,82,19,31,50
37,8476826,Yanni Gourde,C,SEA,33,82,19,31,50
37,8476872,Scott Laughton,C,PHI,30,82,17,33,50
37,8476906,Shayne Gostisbehere,D,DET,31,82,14,36,50
37,8477447,Shea Theodore,D,VGK,29,82,12,38,50
37,8480039,Martin Necas,C,CAR,25,82,11,39,50
37,8475794,Tyler Seguin,C,DAL,32,82,23,26,49
37,8471215,Evgeni Malkin,C,PIT,38,82,21,28,49
37,8478519,Anthony Cirelli,C,TBL,27,82,20,29,49
37,8471724,Kris Letang,D,PIT,37,82,8,41,49
37,8475754,Brock Nelson,C,NYI,33,82,29,19,48
37,8474157,Max Pacioretty,L,WSH,36,82,25,23,48
37,8477479,Tyler Bertuzzi,L,TOR,29,82,23,25,48
37,8481528,Dylan Cozens,C,BUF,23,82,19,29,48
37,8474149,Evgenii Dadonov,R,DAL,35,82,18,30,48
37,8477504,Josh Morrissey,D,WPG,29,82,5,43,48
37,8477500,Bo Horvat,C,NYI,29,82,25,22,47
37,8478498,Jake DeBrusk,L,BOS,28,82,24,23,47
37,8477416,Oliver Bjorkstrand,R,SEA,29,82,20,27,47
37,8478401,Pavel Zacha,C,BOS,27,82,20,27,47
37,8475191,Reilly Smith,R,PIT,33,82,13,34,47
37,8478038,Devon Toews,D,COL,30,82,12,35,47
37,8479425,Filip Hronek,D,VAN,27,82,12,35,47
37,8480839,Rasmus Dahlin,D,BUF,24,82,9,38,47
37,8477948,Travis Sanheim,D,PHI,28,82,8,39,47
37,8475760,Nick Bjugstad,C,ARI,32,82,26,20,46
37,8480188,Fabian Zetterlund,L,SJS,25,82,24,22,46
37,8479675,Trevor Moore,L,LAK,29,82,23,23,46
37,8476897,Oskar Sundqvist,C,STL,30,82,23,23,46
37,8480797,Joel Farabee,L,PHI,24,82,21,25,46
37,8480220,Noah Cates,L,PHI,25,82,17,29,46
37,8477964,Ivan Barbashev,C,VGK,29,82,14,32,46
37,8477503,Max Domi,C,TOR,29,82,14,32,46
37,8476875,Mike Matheson,D,MTL,30,82,13,33,46
37,8475745,Charlie Coyle,C,BOS,32,82,13,33,46
37,8477986,Brandon Montour,D,FLA,30,82,9,37,46
37,8478366,Frank Vatrano,R,ANA,30,82,29,16,45
37,8476399,Blake Coleman,C,CGY,33,82,23,22,45
37,8478542,Evan Rodrigues,C,FLA,31,82,21,24,45
37,8478856,Conor Garland,R,VAN,28,82,19,26,45
37,8474641,Adam Henrique,C,EDM,34,82,18,27,45
37,8474150,Mikael Backlund,C,CGY,35,82,18,27,45
37,8475913,Mark Stone,R,VGK,32,82,17,28,45
37,8474679,Gustav Nyquist,C,NSH,35,82,17,28,45
37,8478472,Mathieu Joseph,R,OTT,27,82,14,31,45
37,8478397,Rasmus Andersson,D,CGY,28,82,13,32,45
37,8474563,Drew Doughty,D,LAK,35,82,7,38,45
37,8475726,Tyler Toffoli,C,WPG,32,82,24,20,44
37,8482159,Tyson Foerster,R,PHI,22,82,24,20,44
37,8476881,Tomas Hertl,C,VGK,31,82,19,25,44
37,8482667,William Eklund,L,SJS,22,82,18,26,44
37,8482475,Yegor Chinakhov,R,CBJ,23,82,16,28,44
37,8480028,Morgan Frost,C,PHI,25,82,16,28,44
37,8482133,Thomas Bordeleau,C,SJS,22,82,14,30,44
37,8473563,Nicklas Backstrom,C,WSH,37,82,14,30,44
37,8478469,Thomas Chabot,D,OTT,27,82,9,35,44
37,8476792,Torey Krug,D,STL,33,82,5,39,44
37,8480064,Josh Norris,C,OTT,25,82,24,19,43
37,8481618,Alex Newhook,C,MTL,23,82,22,21,43
37,8474102,David Perron,L,DET,36,82,19,24,43
37,8477451,Ryan Hartman,R,MIN,30,82,19,24,43
37,8482113,Anton Lundell,C,FLA,23,82,19,24,43
37,8476329,Travis Boyd,C,ARI,31,82,17,26,43
37,8476438,Brandon Saad,L,STL,32,82,16,27,43
37,8477456,J.T. Compher,L,DET,29,82,15,28,43
37,8481711,Matias Maccelli,L,ARI,24,82,15,28,43
37,8481596,Shane Pinto,C,OTT,24,82,13,30,43
37,8478047,Michael Bunting,L,PIT,29,82,11,32,43
37,8480871,Adam Boqvist,D,CBJ,24,82,8,35,43
37,8482175,JJ Peterka,R,BUF,22,82,18,24,42
37,8478396,Noah Hanifin,D,VGK,27,82,17,25,42
37,8476458,Ryan Strome,C,ANA,31,82,16,26,42
37,8483515,Juraj Slafkovsky,L,MTL,20,82,16,26,42
37,8478407,Vince Dunn,D,SEA,28,82,15,27,42
37,8478438,Tommy Novak,C,NSH,27,82,15,27,42
37,8477346,MacKenzie Weegar,D,CGY,30,82,12,30,42
37,8483457,Lane Hutson,D,MTL,20,82,6,36,42
37,8476958,Jaccob Slavin,D,CAR,30,82,5,37,42
37,8479339,Patrik Laine,L,CBJ,26,82,24,17,41
37,8476981,Josh Anderson,R,MTL,30,82,24,17,41
37,8477497,Sean Monahan,C,WPG,30,82,19,22,41
37,8474586,Jordan Eberle,R,SEA,34,82,17,24,41
37,8481624,Ilya Mikheyev,R,VAN,30,82,16,25,41
37,8474037,James van Riemsdyk,L,BOS,35,82,16,25,41
37,8479987,Morgan Geekie,C,BOS,26,82,14,27,41
37,8473422,Nick Foligno,L,CHI,37,82,14,27,41
37,8475714,Calle Jarnkrok,C,TOR,33,82,24,16,40
37,8477952,Robby Fabbri,C,DET,28,82,24,16,40
37,8477426,Nicholas Paul,L,TBL,29,82,23,17,40
37,8475848,Brendan Gallagher,R,MTL,32,82,23,17,40
37,8476292,Ondrej Palat,L,NJD,33,82,19,21,40
37,8474053,Logan Couture,C,SJS,35,82,12,28,40
37,8476456,Jonathan Huberdeau,C,CGY,31,82,11,29,40
37,8481546,Cam York,D,PHI,23,82,9,31,40
37,8483471,Brad Lambert,C,WPG,31,82,8,32,40
37,8480031,Maxime Comtois,L,CAR,25,82,7,33,40
37,8474565,Alex Pietrangelo,D,VGK,34,82,5,35,40
37,8482702,Logan Stankoven,C,DAL,21,82,26,13,39
37,8473512,Claude Giroux,R,OTT,36,82,24,15,39
37,8481535,Nils Hoglander,L,VAN,24,82,19,20,39
37,8475763,Kevin Hayes,R,STL,32,82,18,21,39
37,8479415,Michael McLeod,C,NJD,26,82,16,23,39
37,8476419,Jean-Gabriel Pageau,C,NYI,32,82,15,24,39
37,8481656,Aliaksei Protas,C,WSH,23,82,12,27,39
37,8476923,Damon Severson,D,CBJ,30,82,11,28,39
37,8479999,Casey Mittelstadt,C,COL,26,82,10,29,39
37,8481016,Ruslan Iskhakov,C,NYI,24,82,2,37,39
37,8480014,Gabriel Vilardi,C,WPG,25,82,24,14,38
37,8481554,Kaapo Kakko,R,NYR,23,82,21,17,38
37,8473986,Alex Killorn,L,ANA,35,82,16,22,38
37,8476902,Esa Lindell,D,DAL,30,82,13,25,38
37,8477932,Aaron Ekblad,D,FLA,28,82,12,26,38
37,8477488,Brett Pesce,D,CAR,30,82,12,26,38
37,8477021,Alex Kerfoot,C,ARI,30,82,10,28,38
37,8480873,Rasmus Sandin,D,WSH,24,82,10,28,38
37,8482733,Logan Mailloux,D,MTL,31,82,1,37,38
37,8481699,Aku Raty,R,ARI,23,82,0,38,38
37,8481068,Yegor Sharangovich,C,CGY,26,82,21,16,37
37,8473449,Kyle Okposo,R,FLA,36,82,17,20,37
37,8478466,Daniel Sprong,R,DET,27,82,16,21,37
37,8476882,Teuvo Teravainen,L,CAR,30,82,14,23,37
37,8475744,Evgeny Kuznetsov,C,CAR,32,82,14,23,37
37,8478462,Nicolas Roy,C,VGK,27,82,14,23,37
37,8475287,Erik Haula,L,NJD,33,82,14,23,37
37,8475768,Jaden Schwartz,C,SEA,32,82,13,24,37
37,8482079,Marco Rossi,C,MIN,23,82,13,24,37
37,8471218,Blake Wheeler,R,NYR,38,82,13,24,37
37,8476979,Erik Gustafsson,D,NYR,32,82,7,30,37
37,8475764,Cam Fowler,D,ANA,33,82,3,34,37
37,8475722,Jason Zucker,L,NSH,32,82,19,17,36
37,8478458,Jack Roslovic,C,NYR,27,82,16,20,36
37,8477425,Miles Wood,L,COL,29,82,14,22,36
37,8477498,Darnell Nurse,D,EDM,29,82,11,25,36
37,8481013,Jonatan Berggren,R,DET,24,82,11,25,36
37,8479977,Kailer Yamamoto,R,SEA,26,82,10,26,36
37,8480078,Filip Chytil,C,NYR,25,82,18,17,35
37,8479941,Justin Danforth,R,CBJ,31,82,18,17,35
37,8479525,Ross Colton,C,COL,28,82,17,18,35
37,8482222,Alexander Barabanov,L,SJS,30,82,17,18,35
37,8480459,Pius Suter,C,VAN,28,82,17,18,35
37,8481186,Logan O'Connor,R,COL,28,82,16,19,35
37,8476461,Sean Couturier,C,PHI,32,82,16,19,35
37,8478891,Mason Appleton,C,WPG,28,82,13,22,35
37,8470613,Brent Burns,D,CAR,39,82,13,22,35
37,8477947,Sonny Milano,L,WSH,28,82,13,22,35
37,8478233,Andrew Mangiapane,L,CGY,28,82,12,23,35
37,8476871,Tanner Pearson,L,MTL,32,82,11,24,35
37,8481703,Valtteri Puustinen,R,PIT,25,82,10,25,35
37,8480803,Evan Bouchard,D,EDM,25,82,8,27,35
37,8480434,Sean Durzi,D,ARI,26,82,8,27,35
37,8479345,Jakob Chychrun,D,OTT,26,82,6,29,35
37,8475799,Nino Niederreiter,R,WPG,32,82,21,13,34
37,8478057,Dakota Joshua,C,VAN,28,82,20,14,34
37,8474189,Lars Eller,C,PIT,35,82,18,16,34
37,8476278,Colin Blackwell,C,CHI,31,82,18,16,34
37,8477944,Jakub Vrana,L,STL,28,82,16,18,34
37,8475791,Taylor Hall,L,CHI,33,82,13,21,34
37,8480855,Jack McBain,C,ARI,24,82,12,22,34
37,8483445,Cutter Gauthier,L,ANA,20,82,11,23,34
37,8483397,Marc McLaughlin,C,BOS,25,82,29,4,33
37,8482089,Jake Neighbours,L,STL,22,82,23,10,33
37,8478474,Lawson Crouse,L,ARI,27,82,20,13,33
37,8482101,Danil Gushchin,L,SJS,22,82,19,14,33
37,8478115,Pierre Engvall,L,NYI,28,82,18,15,33
37,8482110,Dawson Mercer,C,NJD,23,82,15,18,33
37,8478046,Danton Heinen,L,BOS,29,82,14,19,33
37,8484153,Leo Carlsson,C,ANA,20,82,13,20,33
37,8480798,Philipp Kurashev,C,CHI,25,82,12,21,33
37,8480009,Eeli Tolvanen,R,SEA,25,82,10,23,33
37,8482146,Luke Evangelista,R,NSH,22,82,10,23,33
37,8480336,Sean Walker,D,COL,30,82,10,23,33
37,8477495,Seth Jones,D,CHI,30,82,8,25,33
37,8474716,Jared Spurgeon,D,MIN,35,82,6,27,33
37,8480817,K'Andre Miller,D,NYR,24,82,5,28,33
37,8482105,Jake Sanderson,D,OTT,22,82,4,29,33
37,8483524,Shane Wright,C,SEA,20,82,25,7,32
37,8477330,Dominik Kubalik,L,OTT,29,82,18,14,32
37,8479423,Alex Nylander,L,CBJ,26,82,16,16,32
37,8478109,Victor Olofsson,L,BUF,29,82,16,16,32
37,8480821,Filip Zadina,R,SJS,25,82,16,16,32
37,8476925,Colton Sissons,C,NSH,31,82,15,17,32
37,8478413,Jordan Greenway,L,BUF,27,82,14,18,32
37,8476869,Brady Skjei,D,CAR,30,82,11,21,32
37,8474870,Tyler Johnson,C,CHI,34,82,8,24,32
37,8479983,Mario Ferraro,D,SJS,26,82,7,25,32
37,8479316,Luke Kunin,C,SJS,27,82,22,9,31
37,8481093,Rafael Harvey-Pinard,L,MTL,25,82,18,13,31
37,8477989,Christian Dvorak,C,MTL,28,82,15,16,31
37,8481517,Brett Leason,R,ANA,25,82,13,18,31
37,8475218,Mattias Ekholm,D,EDM,34,82,9,22,31
37,8482671,Owen Power,D,BUF,22,82,9,22,31
37,8480185,Eetu Luostarinen,C,FLA,26,82,9,22,31
37,8475906,John Klingberg,D,TOR,32,82,7,24,31
37,8478500,Ivan Provorov,D,CBJ,27,82,6,25,31
37,8474673,TJ Brodie,D,TOR,34,82,6,25,31
37,8484166,Adam Fantilli,C,CBJ,20,82,15,15,30
37,8475793,Ryan Johansen,C,PHI,32,82,12,18,30
37,8482087,Kaiden Guhle,D,MTL,22,82,9,21,30
37,8476312,Josh Manson,D,COL,33,82,9,21,30
37,8482705,Cole Sillinger,C,CBJ,21,82,8,22,30
37,8477499,Rasmus Ristolainen,D,PHI,30,82,8,22,30
37,8483493,Frank Nazar,C,CHI,20,82,22,7,29
37,8481604,Pavel Dorofeyev,L,VGK,24,82,20,9,29
37,8475314,Anders Lee,L,NYI,34,82,19,10,29
37,8477998,Warren Foegele,L,EDM,28,82,16,13,29
37,8482055,Drew O'Connor,L,PIT,26,82,14,15,29
37,8481560,Arthur Kaliyev,R,LAK,23,82,13,16,29
37,8476927,Teddy Blueger,C,VAN,30,82,13,16,29
37,8480849,Barrett Hayton,C,ARI,24,82,11,18,29
37,8477919,Frederick Gaudreau,C,MIN,31,82,11,18,29
37,8483505,Matthew Poitras,C,BOS,20,82,11,18,29
37,8482720,Matthew Knies,L,TOR,22,82,9,20,29
37,8477969,Marcus Pettersson,D,PIT,28,82,7,22,29
37,8476854,Hampus Lindholm,D,BOS,30,82,6,23,29
37,8477506,Ryan Pulock,D,NYI,30,82,4,25,29
37,8480813,Joe Veleno,C,DET,24,82,18,10,28
37,8480281,Alexey Toropchenko,R,STL,25,82,17,11,28
37,8482699,Dylan Guenther,R,ARI,21,82,15,13,28
37,8479514,Rem Pitlick,C,CHI,27,82,10,18,28
37,8479351,Sam Steel,C,DAL,26,82,9,19,28
37,8478463,Anthony Beauvillier,L,NSH,27,82,8,20,28
37,8475220,Marcus Foligno,L,MIN,33,82,8,20,28
37,8482122,Brock Faber,D,MIN,22,82,7,21,28
37,8476463,Jonas Brodin,D,MIN,31,82,7,21,28
37,8480043,Timothy Liljegren,D,TOR,25,82,7,21,28
37,8478055,Gustav Forsling,D,FLA,28,82,5,23,28
37,8483431,Logan Cooley,C,ARI,20,82,15,12,27
37,8476469,Joel Armia,R,MTL,31,82,14,13,27
37,8470621,Corey Perry,R,EDM,39,82,14,13,27
37,8470610,Zach Parise,L,COL,40,82,13,14,27
37,8476960,Andreas Athanasiou,C,CHI,30,82,13,14,27
37,8475149,Marcus Johansson,L,MIN,34,82,13,14,27
37,8484145,Zach Benson,L,BUF,19,82,10,17,27
37,8480113,Alex Iafallo,L,WPG,31,82,9,18,27
37,8481568,Alex Vlasic,D,CHI,23,82,3,24,27
37,8482111,Justin Barron,D,MTL,23,82,14,12,26
37,8477353,Tyler Motte,C,TBL,29,82,10,16,26
37,8477511,Anthony Mantha,R,VGK,30,82,9,17,26
37,8477429,Andrew Copp,C,DET,30,82,7,19,26
37,8482624,Daniil Miromanov,D,CGY,27,82,7,19,26
37,8477953,Kasperi Kapanen,R,STL,28,82,7,19,26
37,8480145,Neal Pionk,D,WPG,29,82,4,22,26
37,8476892,Colton Parayko,D,STL,31,82,3,23,26
37,8475171,Oliver Ekman-Larsson,D,FLA,33,82,1,25,26
37,8479365,Trent Frederic,C,BOS,26,82,14,11,25
37,8482117,Lukas Reichel,L,CHI,22,82,13,12,25
37,8476921,Jordan Martinook,L,CAR,32,82,11,14,25
37,8479992,Michael Rasmussen,C,DET,25,82,10,15,25
37,8482730,Brandt Clarke,D,LAK,21,82,7,18,25
37,8478882,Vladislav Gavrikov,D,LAK,29,82,5,20,25
37,8480035,Henri Jokiharju,D,BUF,25,82,3,22,25
37,8481178,Egor Zamula,D,PHI,24,82,3,22,25
37,8480068,Ryan Poehling,C,PHI,25,82,13,11,24
37,8481580,Connor McMichael,C,WSH,23,82,13,11,24
37,8482125,Alexander Holtz,R,NJD,22,82,10,14,24
37,8479353,Brett Howden,C,VGK,26,82,9,15,24
37,8481601,Simon Holmstrom,R,NYI,23,82,9,15,24
37,8482259,Bobby McMann,C,TOR,28,82,9,15,24
37,8477508,Curtis Lazar,C,NJD,29,82,9,15,24
37,8477839,Conor Sheary,L,TBL,32,82,8,16,24
37,8480806,Isac Lundestrom,C,ANA,25,82,7,17,24
37,8476931,Jake McCabe,D,TOR,31,82,5,19,24
37,8481014,Alexander Romanov,D,NYI,24,82,4,20,24
37,8482245,Artem Zub,D,OTT,29,82,4,20,24
37,8476967,Brett Kulak,D,EDM,30,82,2,22,24
37,8476878,Zemgus Girgensons,L,BUF,30,82,14,9,23
37,8476480,Vladislav Namestnikov,C,WPG,32,82,12,11,23
37,8482679,Matt Coronato,R,CGY,22,82,12,11,23
37,8479393,Noah Gregor,C,TOR,26,82,12,11,23
37,8481477,Nico Sturm,C,SJS,29,82,11,12,23
37,8477507,Nikita Zadorov,D,VAN,29,82,11,12,23
37,8477450,Jason Dickinson,C,CHI,29,82,10,13,23
37,8475343,Nic Dowd,C,WSH,34,82,10,13,23
37,8479390,Taylor Raddysh,R,CHI,26,82,9,14,23
37,8473533,Jordan Staal,C,CAR,36,82,8,15,23
37,8479371,Dante Fabbro,D,NSH,26,82,8,15,23
37,8475197,Tyson Barrie,D,NSH,33,82,7,16,23
37,8477369,Carson Soucy,D,VAN,30,82,7,16,23
37,8479398,Samuel Girard,D,COL,26,82,5,18,23
37,8476885,Jacob Trouba,D,NYR,30,82,5,18,23
37,8483495,Simon Nemec,D,NJD,20,82,4,19,23
37,8473507,Jeff Petry,D,DET,37,82,3,20,23
37,8477505,Alexander Wennberg,C,NYR,30,82,2,21,23
37,8476873,Mark Jankowski,C,NSH,30,82,11,11,22
37,8479346,Dillon Dube,C,CGY,26,82,11,11,22
37,8478013,Jake Walman,D,DET,28,82,11,11,22
37,8481704,Juuso Parssinen,C,NSH,23,82,11,11,22
37,8483491,Ivan Miroshnichenko,L,WSH,20,82,11,11,22
37,8479293,Brandon Tanev,L,SEA,33,82,10,12,22
37,8480802,Ryan McLeod,C,EDM,25,82,9,13,22
37,8476392,Adam Lowry,C,WPG,31,82,8,14,22
37,8481522,Peyton Krebs,C,BUF,23,82,7,15,22
37,8475790,Erik Gudbranson,D,CBJ,32,82,6,16,22
37,8476917,Adam Pelech,D,NYI,30,82,5,17,22
37,8480246,Nick Perbix,D,TBL,26,82,5,17,22
37,8478851,Alexandre Carrier,D,NSH,28,82,4,18,22
37,8478569,Noel Acciari,C,PIT,33,82,16,5,21
37,8482118,Sam Colangelo,R,ANA,23,82,15,6,21
37,8474715,Cam Atkinson,R,PHI,35,82,14,7,21
37,8480980,Connor Dewar,C,TOR,25,82,11,10,21
37,8481553,Bobby Brink,R,PHI,23,82,10,11,21
37,8481481,Blake Lizotte,C,LAK,27,82,10,11,21
37,8482155,Alex Laferriere,R,LAK,23,82,10,11,21
37,8476422,Mike Reilly,D,NYI,31,82,9,12,21
37,8479591,Michael Eyssimont,C,TBL,28,82,8,13,21
37,8482074,Connor Zary,C,CGY,23,82,7,14,21
37,8478043,Sam Lafferty,C,VAN,29,82,7,14,21
37,8470604,Jeff Carter,C,PIT,39,82,6,15,21
37,8481524,Bowen Byram,D,BUF,23,82,6,15,21
37,8482803,Olen Zellweger,D,ANA,21,82,5,16,21
37,8478911,Matt Roy,D,LAK,29,82,5,16,21
37,8484911,Collin Graf,R,SJS,22,82,5,16,21
37,8482712,Oskar Olausson,R,COL,22,82,4,17,21
37,8475179,Dmitry Kulikov,D,FLA,34,82,3,18,21
37,8474574,Tyler Myers,D,VAN,34,82,3,18,21
37,8479369,Andrew Peeke,D,BOS,26,82,3,18,21
37,8482073,Braden Schneider,D,NYR,23,82,3,18,21
37,8481567,Henry Thrun,D,SJS,23,82,1,20,21
37,8476891,Matt Grzelcyk,D,BOS,30,82,0,21,21
37,8482145,Mavrik Bourque,C,DAL,22,82,17,3,20
37,8479996,Cody Glass,C,NSH,25,82,11,9,20
37,8480074,Alexandre Texier,C,CBJ,25,82,10,10,20
37,8484203,Bradly Nadeau,L,CAR,19,82,9,11,20
37,8482666,Scott Morrow,D,CAR,22,82,9,11,20
37,8476858,Phillip Di Giuseppe,L,VAN,31,82,8,12,20
37,8478133,Jake Evans,C,MTL,28,82,6,14,20
37,8478451,Ethan Bear,D,WSH,27,82,6,14,20
37,8475825,Jani Hakanpää,D,DAL,32,82,6,14,20
37,8482092,Ridly Greig,C,OTT,22,82,5,15,20
37,8474567,Zach Bogosian,D,MIN,34,82,5,15,20
37,8475200,Dmitry Orlov,D,CAR,33,82,4,16,20
37,8477435,Ryan Graves,D,PIT,29,82,4,16,20
37,8482470,Ilya Solovyov,D,CGY,24,82,4,16,20
37,8483466,Kevin Korchinski,D,CHI,20,82,4,16,20
37,8478507,John Marino,D,NJD,27,82,3,17,20
37,8475181,Nick Leddy,D,STL,33,82,2,18,20
37,8483499,Liam Ohgren,L,MIN,20,82,13,6,19
37,8474009,Nick Bonino,C,NYR,36,82,10,9,19
37,8478430,Oliver Kylington,D,CGY,27,82,9,10,19
37,8478020,Michael Amadio,C,VGK,28,82,8,11,19
37,8482737,Zack Bolduc,C,STL,21,82,8,11,19
37,8475842,Sam Carrick,C,EDM,32,82,8,11,19
37,8482062,Cole Smith,L,NSH,29,82,7,12,19
37,8474884,Mike Hoffman,C,SJS,35,82,6,13,19
37,8477931,Tomas Nosek,L,NJD,32,82,5,14,19
37,8482142,Jamie Drysdale,D,PHI,22,82,4,15,19
37,8478178,Darren Raddysh,D,TBL,28,82,3,16,19
37,8470600,Ryan Suter,D,DAL,39,82,3,16,19
37,8475324,Nick Jensen,D,WSH,34,82,3,16,19
37,8470966,Mark Giordano,D,TOR,41,82,3,16,19
37,8477845,Trevor van Riemsdyk,D,WSH,33,82,2,17,19
37,8477034,Jaycob Megna,D,CHI,32,82,2,17,19
37,8482809,Jackson Blake,R,CAR,21,82,15,3,18
37,8475231,Casey Cizikas,C,NYI,33,82,12,6,18
37,8478831,Kevin Stenlund,C,FLA,28,82,11,7,18
37,8480448,Parker Kelly,L,OTT,25,82,9,9,18
37,8476374,Sean Kuraly,C,CBJ,31,82,7,11,18
37,8479998,Mikey Anderson,D,LAK,25,82,6,12,18
37,8478468,Jeremy Lauzon,D,NSH,27,82,6,12,18
37,8475279,Ben Chiarot,D,DET,33,82,4,14,18
37,8483565,Nick Blankenburg,D,CBJ,26,82,3,15,18
37,8475177,Calvin de Haan,D,TBL,33,82,3,15,18
37,8477220,Nate Schmidt,D,WPG,33,82,2,16,18
37,8482655,J.J. Moser,D,ARI,24,82,2,16,18
37,8476467,Jamie Oleksiak,D,SEA,32,82,2,16,18
37,8478443,Brandon Carlo,D,BOS,28,82,2,16,18
37,8474151,Ryan McDonagh,D,NSH,35,82,1,17,18
37,8478136,Jake Middleton,D,MIN,28,82,1,17,18
37,8478859,Niko Mikkola,D,FLA,28,82,1,17,18
37,8473453,Trevor Lewis,C,LAK,37,82,11,6,17
37,8473504,Cal Clutterbuck,R,NYI,37,82,6,11,17
37,8476457,Adam Larsson,D,SEA,32,82,5,12,17
37,8483482,Tristan Luneau,D,ANA,20,82,4,13,17
37,8480058,Pierre-Olivier Joseph,D,PIT,25,82,4,13,17
37,8480073,Erik Brannstrom,D,OTT,25,82,1,16,17
37,8481030,Jack St. Ivany,D,PIT,25,82,1,16,17
37,8479976,Juuso Valimaki,D,ARI,26,82,0,17,17
37,8479661,Tanner Jeannot,L,TBL,27,82,10,6,16
37,8477392,Hudson Fasching,R,NYI,29,82,8,8,16
37,8480990,Declan Chisholm,D,MIN,24,82,7,9,16
37,8479324,Ryan Lindgren,D,NYR,26,82,7,9,16
37,8479359,Beck Malenstyn,L,WSH,26,82,6,10,16
37,8480807,Mattias Samuelsson,D,BUF,24,82,6,10,16
37,8480796,Martin Fehervary,D,WSH,25,82,5,11,16
37,8480144,David Kampf,C,TOR,29,82,5,11,16
37,8476429,Scott Mayfield,D,NYI,32,82,5,11,16
37,8477015,Connor Brown,R,EDM,30,82,4,12,16
37,8480860,Kevin Bahl,D,NJD,24,82,4,12,16
37,8478416,Erik Cernak,D,TBL,27,82,4,12,16
37,8483490,Pavel Mintyukov,D,ANA,21,82,3,13,16
37,8475455,Brenden Dillon,D,WPG,34,82,3,13,16
37,8476525,Colin Miller,D,WPG,32,82,2,14,16
37,8481537,Nikita Okhotiuk,D,CGY,24,82,2,14,16
37,8476879,Cody Ceci,D,EDM,31,82,2,14,16
37,8482858,Ryker Evans,D,SEA,23,82,2,14,16
37,8475208,Brian Dumoulin,D,SEA,33,82,1,15,16
37,8478840,Will Borgen,D,SEA,28,82,4,11,15
37,8476331,Dylan DeMelo,D,WPG,31,82,3,12,15
37,8481606,Jordan Spence,D,LAK,23,82,2,13,15
37,8481605,Jackson LaCombe,D,ANA,23,82,1,14,15
37,8480834,Ty Emberson,D,SJS,24,82,1,14,15
37,8475462,Radko Gudas,D,ANA,34,82,0,15,15
37,8478508,Yakov Trenin,C,COL,27,82,11,3,14
37,8482762,Simon Edvinsson,D,DET,21,82,9,5,14
37,8475164,Jakob Silfverberg,R,ANA,34,82,8,6,14
37,8474166,Alec Martinez,D,VGK,37,82,2,12,14
37,8474034,Pat Maroon,L,BOS,36,82,9,4,13
37,8481028,Martin Pospisil,C,CGY,25,82,7,6,13
37,8480172,Jan Rutta,D,SJS,34,82,6,7,13
37,8476624,Barclay Goodrow,C,NYR,31,82,4,9,13
37,8479980,Nicolas Hague,D,VGK,26,82,3,10,13
37,8477335,Kyle Burroughs,D,SJS,29,82,2,11,13
37,8475233,David Savard,D,MTL,34,82,1,12,13
37,8475762,Derek Forbort,D,BOS,32,82,1,12,13
37,8476473,Connor Murphy,D,CHI,31,82,1,12,13
37,8477365,Connor Clifton,D,BUF,29,82,0,13,13
37,8479383,Boris Katchouk,L,OTT,26,82,8,4,12
37,8483012,Logan Morrison,C,SEA,22,82,7,5,12
37,8476442,Matt Nieto,L,PIT,32,82,4,8,12
37,8477406,Mattias Janmark,C,EDM,32,82,3,9,12
37,8482166,Shakir Mukhamadullin,D,SJS,22,82,3,9,12
37,8482516,Matthew Kessel,D,STL,24,82,1,11,12
37,8481059,Scott Perunovich,D,STL,26,82,1,11,12
37,8476822,Luke Glendening,C,TBL,35,82,5,6,11
37,8479291,Kevin Rooney,C,CGY,31,82,3,8,11
37,8476915,Jujhar Khaira,L,MIN,30,82,3,8,11
37,8475188,Brayden McNabb,D,VGK,33,82,2,9,11
37,8482177,Marat Khusnutdinov,C,MIN,22,82,2,9,11
37,8479442,Troy Stecher,D,EDM,30,82,2,9,11
37,8476372,Nick Seeler,D,PHI,31,82,1,10,11
37,8480879,Jacob Bernard-Docker,D,OTT,24,82,5,5,10
37,8483489,Fraser Minten,C,TOR,31,82,5,5,10
37,8482713,Mackie Samoskevich,R,FLA,22,82,2,8,10
37,8475690,Chris Tanev,D,DAL,35,82,0,10,10
37,8481578,Graeme Clarke,R,NJD,23,82,4,5,9
37,8481599,Victor Soderstrom,D,ARI,23,82,4,5,9
37,8478408,Travis Dermott,D,ARI,28,82,4,5,9
37,8482859,Zack Ostapchuk,C,OTT,21,82,4,5,9
37,8482807,Ethan Del Mastro,D,CHI,21,82,1,8,9
37,8478399,Jonas Siegenthaler,D,NJD,27,82,0,9,9
37,8471677,Jack Johnson,D,COL,37,82,1,7,8
37,8474013,Ian Cole,D,VAN,35,82,0,8,8
37,8483468,Jiri Kulich,C,BUF,20,82,1,6,7
37,8484149,Gavin Brindley,C,CBJ,20,82,2,2,4
37,8483763,Maksymilian Szuber,D,ARI,22,82,0,4,4
37,8482141,Lukas Cormier,D,VGK,22,0,0,0,0
37,8476988,Matt Benning,D,SJS,30,0,0,0,0
37,8480727,Zach Whitecloud,D,VGK,28,0,0,0,0
37,8480887,Jordan Harris,D,MTL,24,0,0,0,0
37,8478450,Parker Wotherspoon,D,BOS,27,0,0,0,0
37,8481812,Nikolai Knyzhov,D,SJS,27,0,0,0,0
37,8480001,Urho Vaakanainen,D,ANA,25,0,0,0,0
37,8482176,Wyatt Kaiser,D,CHI,22,0,0,0,0
37,8481122,Simon Benoit,D,TOR,26,0,0,0,0
37,8476441,Joel Edmundson,D,TOR,31,0,0,0,0
37,8480884,Calen Addison,D,SJS,24,0,0,0,0
37,8482511,Mason Lohrei,D,BOS,23,0,0,0,0
37,8482192,Isaak Phillips,D,CHI,23,0,0,0,0
37,8480950,Ilya Lyubushkin,D,TOR,30,0,0,0,0
37,8474031,Kevin Shattenkirk,D,BOS,35,0,0,0,0
37,8475718,Justin Holl,D,DET,32,0,0,0,0
37,8479402,Jake Bean,D,CBJ,26,0,0,0,0
37,8474602,Justin Schultz,D,SEA,34,0,0,0,0
37,8477950,Tony DeAngelo,D,CAR,29,0,0,0,0
37,8481743,Marc Del Gaizo,D,NSH,25,0,0,0,0
37,8481527,Kaedan Korczak,D,VGK,23,0,0,0,0
37,8480192,Johnathan Kovacevic,D,MTL,27,0,0,0,0
37,8476874,Olli Maatta,D,DET,30,0,0,0,0
37,8482144,Jack Thompson,D,SJS,22,0,0,0,0
37,8480222,Sebastian Aho,D,NYI,28,0,0,0,0
37,8479458,Nikita Zaitsev,D,CHI,33,0,0,0,0
37,8471709,Marc-Edouard Vlasic,D,SJS,37,0,0,0,0
37,8482929,Emil Lilleberg,D,TBL,23,0,0,0,0
37,8477018,Ben Hutton,D,VGK,31,0,0,0,0
37,8481056,Spencer Stastney,D,NSH,24,0,0,0,0
37,8481593,Jayden Struble,D,MTL,23,0,0,0,0
37,8479982,Conor Timmins,D,TOR,26,0,0,0,0
37,8474090,Brendan Smith,D,NJD,35,0,0,0,0
37,8482964,Arber Xhekaj,D,MTL,23,0,0,0,0
37,8480891,Michael Kesselring,D,ARI,24,0,0,0,0
37,8477938,Haydn Fleury,D,TBL,28,0,0,0,0
37,8481806,Louis Crevier,D,CHI,23,0,0,0,0
37,8471274,Alex Goligoski,D,MIN,39,0,0,0,0
37,8481600,Tobias Bjornfot,D,FLA,23,0,0,0,0
37,8475797,Jarred Tinordi,D,CHI,32,0,0,0,0
37,8481521,Ronnie Attard,D,PHI,25,0,0,0,0
37,8474612,Travis Hamonic,D,OTT,34,0,0,0,0
37,8479576,Vincent Desharnais,D,EDM,28,0,0,0,0
37,8480049,Dylan Samberg,D,WPG,25,0,0,0,0
37,8483619,Filip Roos,D,CHI,25,0,0,0,0
37,8474568,Luke Schenn,D,NSH,35,0,0,0,0
37,8480184,Gustav Lindstrom,D,ANA,26,0,0,0,0
37,8480070,Ian Mitchell,D,BOS,25,0,0,0,0
37,8480196,Jacob Bryson,D,BUF,27,0,0,0,0
37,8471686,Marc Staal,D,PHI,37,0,0,0,0
37,8477467,Gustav Olofsson,D,SEA,30,0,0,0,0
37,8478970,Jalen Chatfield,D,CAR,28,0,0,0,0
37,8479348,Kale Clague,D,BUF,26,0,0,0,0
37,8473446,Erik Johnson,D,PHI,36,0,0,0,0
37,8477462,Robert Hagg,D,ANA,29,0,0,0,0
37,8478454,Noah Juulsen,D,VAN,27,0,0,0,0
37,8477384,Josh Brown,D,ARI,30,0,0,0,0
37,8481708,Zac Jones,D,NYR,24,0,0,0,0
37,8481167,Brayden Pachal,D,CGY,25,0,0,0,0
37,8482067,Connor Mackey,D,NYR,28,0,0,0,0
37,8483460,David Jiricek,D,CBJ,21,0,0,0,0
37,8481701,Santeri Hatakka,D,NJD,23,0,0,0,0
37,8478021,William Lagesson,D,ANA,28,0,0,0,0
37,8477851,Jordan Oesterle,D,CGY,32,0,0,0,0
37,8478452,Caleb Jones,D,COL,27,0,0,0,0
37,8479984,Cal Foote,D,NJD,26,0,0,0,0
37,8479639,Dylan Coghlan,D,CAR,26,0,0,0,0
37,8480874,Adam Ginning,D,PHI,24,0,0,0,0
37,8479321,Lucas Johansen,D,WSH,27,0,0,0,0
37,8480878,Nils Lundkvist,D,DAL,24,0,0,0,0
37,8482165,Yan Kuznetsov,D,CGY,22,0,0,0,0
37,8484258,Sam Malinski,D,COL,26,0,0,0,0
37,8480157,Calle Rosen,D,STL,30,0,0,0,0
37,8484304,Uvis Balinskis,D,FLA,28,0,0,0,0
37,8479985,Cale Fleury,D,SEA,26,0,0,0,0
37,8479378,Logan Stanley,D,WPG,26,0,0,0,0
37,8477541,Dakota Mermis,D,MIN,30,0,0,0,0
37,8481609,Vladislav Kolyachonok,D,ARI,23,0,0,0,0
37,8480823,Alexander Alexeyev,D,WSH,25,0,0,0,0
37,8481679,Maxence Guenette,D,OTT,23,0,0,0,0
37,8481564,Ryan Johnson,D,BUF,23,0,0,0,0
37,8479376,Victor Mete,D,PHI,26,0,0,0,0
37,8484254,Akito Hirose,D,VAN,25,0,0,0,0
37,8482660,Kent Johnson,C,CBJ,22,0,0,0,0
37,8482149,Cole Perfetti,C,WPG,22,0,0,0,0
37,8477987,Ryan Donato,C,CHI,28,0,0,0,0
37,8475755,Alexander Petrovic,D,DAL,32,0,0,0,0
37,8477810,Joel Hanley,D,CGY,33,0,0,0,0
37,8474145,Robert Bortuzzo,D,NYI,35,0,0,0,0
37,8481161,Jake Christiansen,D,CBJ,25,0,0,0,0
37,8476884,Derrick Pouliot,D,DAL,30,0,0,0,0
37,8481716,Dmitri Voronkov,L,CBJ,24,0,0,0,0
37,8480084,Nick DeSimone,D,NJD,30,0,0,0,0
37,8475750,Jon Merrill,D,MIN,32,0,0,0,0
37,8479315,Joey Anderson,R,CHI,26,0,0,0,0
37,8478011,Louie Belpedio,D,PHI,28,0,0,0,0
37,8482451,Mikael Pyyhtia,L,CBJ,23,0,0,0,0
37,8481541,Samuel Bolduc,D,NYI,24,0,0,0,0
37,8482126,Emil Andrae,D,PHI,31,0,0,0,0
37,8474618,Marco Scandella,D,STL,34,0,0,0,0
37,8477244,Chad Ruhwedel,D,NYR,34,0,0,0,0
37,8477971,Andreas Englund,D,LAK,28,0,0,0,0
37,8480829,Jesperi Kotkaniemi,C,CAR,24,0,0,0,0
37,8479372,Josh Mahura,D,FLA,26,0,0,0,0
37,8482095,Tyler Kleven,D,OTT,22,0,0,0,0
37,8481719,Maxwell Crozier,D,TBL,24,0,0,0,0
37,8475855,Jesper Fast,R,CAR,33,0,0,0,0
37,8480848,Ty Dellandrea,C,DAL,24,0,0,0,0
37,8475193,Tomas Tatar,L,SEA,34,0,0,0,0
37,8476889,Radek Faksa,C,DAL,30,0,0,0,0
37,8478495,Denis Gurianov,R,PHI,27,0,0,0,0
37,8480216,Jacob Peterson,C,SJS,25,0,0,0,0
37,8480252,Cole Guttman,C,CHI,25,0,0,0,0
37,8479026,Philippe Myers,D,TBL,27,0,0,0,0
37,8481006,Tyler Tucker,D,STL,24,0,0,0,0
37,8481032,Paul Cotter,C,VGK,25,0,0,0,0
37,8481577,Philip Tomasino,C,NSH,23,0,0,0,0
37,8476918,Jimmy Vesey,L,NYR,31,0,0,0,0
37,8479320,Max Lajoie,D,TOR,27,0,0,0,0
37,8478017,Mark Friedman,D,VAN,29,0,0,0,0
37,8481754,Nikita Nesterenko,C,ANA,23,0,0,0,0
37,8483407,Brandon Scanlin,D,NYR,25,0,0,0,0
37,8482659,Josh Doan,R,ARI,22,0,0,0,0
37,8477446,Michael McCarron,R,NSH,29,0,0,0,0
37,8477903,Garnet Hathaway,R,PHI,33,0,0,0,0
37,8482153,Brendan Brisson,C,VGK,23,0,0,0,0
37,8483546,Marshall Rifai,D,TOR,26,0,0,0,0
37,8484287,Cole McWard,D,VAN,23,0,0,0,0
37,8478854,Ryan Shea,D,PIT,27,0,0,0,0
37,8481585,Egor Afanasyev,L,NSH,23,0,0,0,0
37,8483398,Declan Carlile,D,TBL,31,0,0,0,0
37,8478502,Dennis Gilbert,D,CGY,28,0,0,0,0
37,8482749,Joshua Roy,R,MTL,21,0,0,0,0
37,8481598,Philip Broberg,D,EDM,23,0,0,0,0
37,8480835,Jack Drury,C,CAR,24,0,0,0,0
37,8480748,Kiefer Sherwood,L,NSH,29,0,0,0,0
37,8476934,Brock McGinn,L,ANA,30,0,0,0,0
37,8480870,Bo Groulx,C,ANA,24,0,0,0,0
37,8479368,Max Jones,L,ANA,26,0,0,0,0
37,8478099,Kevin Labanc,R,SJS,29,0,0,0,0
37,8478067,Oskar Lindblom,L,SJS,28,0,0,0,0
37,8476393,Nick Cousins,C,FLA,31,0,0,0,0
37,8483395,Arshdeep Bains,L,VAN,23,0,0,0,0
37,8480762,Eric Robinson,L,BUF,29,0,0,0,0
37,8479439,Jacob MacDonald,D,SJS,31,0,0,0,0
37,8476474,Stefan Noesen,R,CAR,31,0,0,0,0
37,8482787,Nikita Chibrikov,R,WPG,31,0,0,0,0
37,8478432,Christian Fischer,R,DET,27,0,0,0,0
37,8477979,Nicolas Aube-Kubel,R,WSH,28,0,0,0,0
37,8481789,Tye Kartye,L,SEA,23,0,0,0,0
37,8479330,Brandon Gignac,C,MTL,27,0,0,0,0
37,8480075,Cameron Crotty,D,ARI,25,0,0,0,0
37,8473473,Milan Lucic,L,BOS,36,0,0,0,0
37,8482094,Daemon Hunt,D,MIN,22,0,0,0,0
37,8481206,John Ludvig,D,PIT,24,0,0,0,0
37,8483630,Pavol Regenda,L,ANA,25,0,0,0,0
37,8481617,Vasily Podkolzin,R,VAN,23,0,0,0,0
37,8480306,Grant Hutton,D,NYI,29,0,0,0,0
37,8480995,Pontus Holmberg,R,TOR,25,0,0,0,0
37,8482148,Hendrix Lapierre,C,WSH,22,0,0,0,0
37,8477478,William Carrier,L,VGK,30,0,0,0,0
37,8480003,Jesper Boqvist,C,BOS,26,0,0,0,0
37,8482172,Landon Slaggert,L,CHI,22,0,0,0,0
37,8480789,Oliver Wahlstrom,R,NYI,24,0,0,0,0
37,8474062,Riley Nash,C,NYR,35,0,0,0,0
37,8480021,Jack Studnicka,C,SJS,25,0,0,0,0
37,8480025,MacKenzie Entwistle,R,CHI,25,0,0,0,0
37,8481582,Nicholas Robertson,L,TOR,23,0,0,0,0
37,8476867,Brendan Gaunce,C,CBJ,30,0,0,0,0
37,8479619,Michael Carcone,L,ARI,28,0,0,0,0
37,8479370,Tyson Jost,C,BUF,26,0,0,0,0
37,8479671,Mathieu Olivier,R,CBJ,27,0,0,0,0
37,8476994,Vinnie Hinostroza,C,PIT,30,0,0,0,0
37,8482070,Mitchell Chaffee,R,TBL,26,0,0,0,0
37,8477473,Justin Bailey,R,SJS,29,0,0,0,0
37,8479344,Jesse Puljujarvi,R,PIT,26,0,0,0,0
37,8480205,Emil Bemstrom,C,PIT,25,0,0,0,0
37,8479718,Alex Barré-Boulet,C,TBL,27,0,0,0,0
37,8482061,Brandon Biro,L,BUF,26,0,0,0,0
37,8479638,Justin Brazeau,R,BOS,26,0,0,0,0
37,8474040,Sam Gagner,C,EDM,35,0,0,0,0
37,8477846,Ryan Carpenter,C,SJS,33,0,0,0,0
37,8482077,Dylan Holloway,L,EDM,23,0,0,0,0
37,8482157,Will Cuylle,L,NYR,22,0,0,0,0
37,8480007,Jonas Rondbjerg,R,VGK,25,0,0,0,0
37,8478874,Adam Gaudette,C,STL,28,0,0,0,0
37,8478434,Keegan Kolesar,R,VGK,27,0,0,0,0
37,8480441,Trey Fix-Wolansky,R,CBJ,25,0,0,0,0
37,8479994,Jaret Anderson-Dolan,C,NSH,25,0,0,0,0
37,8483567,Georgii Merkulov,C,BOS,24,0,0,0,0
37,8477380,Jonny Brodzinski,C,NYR,31,0,0,0,0
37,8482201,Gage Goncalves,C,TBL,23,0,0,0,0
37,8478211,Dryden Hunt,L,CGY,29,0,0,0,0
37,8471699,Andrew Cogliano,C,COL,37,0,0,0,0
37,8479421,Jacob Moverare,D,LAK,26,0,0,0,0
37,8478881,Brett Seney,L,CHI,28,0,0,0,0
37,8477464,Nic Petan,C,MIN,29,0,0,0,0
37,8475958,Michael Sgarbossa,C,WSH,32,0,0,0,0
37,8481147,Reese Johnson,C,CHI,26,0,0,0,0
37,8479336,Carl Grundstrom,R,LAK,27,0,0,0,0
37,8480853,Liam Foudy,C,NSH,24,0,0,0,0
37,8479522,Hardy Haman Aktell,D,WSH,26,0,0,0,0
37,8481462,Mason Morelli,L,VGK,28,0,0,0,0
37,8482102,Vasily Ponomarev,C,CAR,22,0,0,0,0
37,8480844,Grigori Denisenko,L,VGK,24,0,0,0,0
37,8479944,Zach Aston-Reese,C,DET,30,0,0,0,0
37,8482784,Zach Dean,C,STL,21,0,0,0,0
37,8479419,Brett Murray,L,BUF,26,0,0,0,0
37,8479520,Brandon Duhaime,R,COL,27,0,0,0,0
37,8477573,Nathan Walker,L,STL,30,0,0,0,0
37,8478078,Rourke Chartier,C,OTT,28,0,0,0,0
37,8475795,Dylan McIlrath,D,WSH,32,0,0,0,0
37,8482496,Nils Aman,C,VAN,24,0,0,0,0
37,8480289,Morgan Barron,C,WPG,26,0,0,0,0
37,8481751,Lukas Rousek,R,BUF,25,0,0,0,0
37,8480011,Klim Kostin,C,SJS,25,0,0,0,0
37,8481556,John Beecher,C,BOS,23,0,0,0,0
37,8475278,Byron Froese,C,VGK,33,0,0,0,0
37,8475225,Craig Smith,C,DAL,35,0,0,0,0
37,8484326,Patrik Koch,D,ARI,28,0,0,0,0
37,8477930,Pierre-Edouard Bellemare,L,SEA,39,0,0,0,0
37,8478409,Anthony Richard,C,BOS,28,0,0,0,0
37,8481024,Linus Karlsson,C,VAN,25,0,0,0,0
37,8479986,Kole Lind,R,SEA,26,0,0,0,0
37,8479414,Nathan Bastian,R,NJD,27,0,0,0,0
37,8479362,Riley Tufte,L,COL,26,0,0,0,0
37,8481058,Jesse Ylönen,R,MTL,25,0,0,0,0
37,8482476,Emil Heineman,L,MTL,23,0,0,0,0
37,8482861,Vincent Iorio,D,WSH,22,0,0,0,0
37,8483432,Luca Del Bel Belluz,C,CBJ,31,0,0,0,0
37,8482744,James Malatesta,L,CBJ,21,0,0,0,0
37,8477887,Patrick Brown,C,BOS,32,0,0,0,0
37,8478585,Derek Ryan,C,EDM,38,0,0,0,0
37,8481441,Joe Snively,C,WSH,28,0,0,0,0
37,8481592,Jakob Pelletier,L,CGY,23,0,0,0,0
37,8482634,Alex Steeves,C,TOR,25,0,0,0,0
37,8477126,Jayson Megna,C,BOS,34,0,0,0,0
37,8475752,Tyler Pitlick,C,NYR,33,0,0,0,0
37,8480008,Adam Ruzicka,C,ARI,25,0,0,0,0
37,8481065,Angus Crookshank,L,OTT,25,0,0,0,0
37,8479547,Matthew Phillips,R,WSH,26,0,0,0,0
37,8480226,Marián Studenic,R,SEA,26,0,0,0,0
37,8481237,Kyle MacLean,C,NYI,25,0,0,0,0
37,8475413,Justin Dowling,C,NJD,34,0,0,0,0
37,8481641,Joel Kiviranta,L,COL,28,0,0,0,0
37,8478104,Sammy Blais,L,STL,28,0,0,0,0
37,8477454,Adam Erne,L,EDM,29,0,0,0,0
37,8481518,Nolan Foote,L,NJD,24,0,0,0,0
37,8480245,Olle Lycksell,R,PHI,25,0,0,0,0
37,8483570,Ben Meyers,C,ANA,26,0,0,0,0
37,8480776,Sheldon Rempal,R,VGK,29,0,0,0,0
37,8483920,Pierrick Dube,R,WSH,23,0,0,0,0
37,8480267,Sammy Walker,C,MIN,25,0,0,0,0
37,8482747,Brennan Othmann,L,NYR,21,0,0,0,0
37,8479991,Jake Leschyshyn,C,NYR,25,0,0,0,0
37,8478400,Colin White,C,MTL,27,0,0,0,0
37,8479328,Julien Gauthier,R,NYI,27,0,0,0,0
37,8484325,Waltteri Merela,C,TBL,26,0,0,0,0
37,8479066,Ryan Lomberg,L,FLA,30,0,0,0,0
37,8477070,Liam O'Brien,C,ARI,30,0,0,0,0
37,8478146,Matthew Highmore,C,OTT,28,0,0,0,0
37,8478028,Fredrik Olofsson,L,COL,28,0,0,0,0
37,8480880,Jakub Lauko,C,BOS,24,0,0,0,0
37,8479968,Vinni Lettieri,C,MIN,29,0,0,0,0
37,8474709,Matt Martin,L,NYI,35,0,0,0,0
37,8480845,Rasmus Kupari,C,WPG,24,0,0,0,0
37,8481550,Adam Beckman,L,MIN,23,0,0,0,0
37,8481422,Jacob Lucchini,C,MIN,29,0,0,0,0
37,8477401,John Hayden,C,SEA,29,0,0,0,0
37,8478904,Steven Lorentz,C,FLA,28,0,0,0,0
37,8482088,Justin Sourdif,R,FLA,22,0,0,0,0
37,8482751,Ryan Winterton,C,SEA,21,0,0,0,0
37,8482241,Radim Zohorna,L,PIT,28,0,0,0,0
37,8481690,Tyler Angle,C,CBJ,24,0,0,0,0
37,8476952,Dominic Toninato,C,WPG,30,0,0,0,0
37,8476919,Chris Tierney,C,NJD,30,0,0,0,0
37,8480032,Shane Bowers,C,NJD,25,0,0,0,0
37,8484314,Jiri Smejkal,L,OTT,28,0,0,0,0
37,8481239,Samuel Fagemo,L,LAK,24,0,0,0,0
37,8481532,Alex Turcotte,C,LAK,23,0,0,0,0
37,8481019,David Gustafsson,C,WPG,24,0,0,0,0
37,8478477,Mitchell Stephens,C,MTL,27,0,0,0,0
37,8479546,Oskar Steen,C,BOS,26,0,0,0,0
37,8480292,Carson Meyer,R,CBJ,27,0,0,0,0
37,8478446,Glenn Gawdin,C,ANA,27,0,0,0,0
37,8483531,Brian Halonen,L,NJD,25,0,0,0,0
37,8477149,Scott Sabourin,R,SJS,32,0,0,0,0
37,8479972,Mason Shaw,C,MIN,26,0,0,0,0
37,8480890,Jan Jenik,R,ARI,24,0,0,0,0
37,8478051,Max Willman,C,NJD,29,0,0,0,0
37,8480851,Akil Thomas,C,LAK,24,0,0,0,0
37,8482765,Isak Rosen,R,BUF,21,0,0,0,0
37,8478421,A.J. Greer,L,CGY,28,0,0,0,0
37,8478512,Austin Czarnik,C,DET,32,0,0,0,0
37,8479536,Axel Jonsson-Fjallby,L,WPG,26,0,0,0,0
37,8477320,Anton Blidh,L,NYR,29,0,0,0,0
37,8481543,Nikita Alexandrov,C,STL,24,0,0,0,0
37,8475235,Nicolas Deslauriers,L,PHI,33,0,0,0,0
37,8481070,Hugh McGing,L,STL,26,0,0,0,0
37,8480836,Jonathan Gruden,C,PIT,24,0,0,0,0
37,8481591,Sam Poulin,R,PIT,23,0,0,0,0
37,8477962,Brendan Lemieux,L,CAR,28,0,0,0,0
37,8483401,Marc Johnstone,R,PIT,28,0,0,0,0
37,8482250,Callahan Burke,C,CAR,27,0,0,0,0
37,8481726,Adam Edstrom,C,NYR,24,0,0,0,0
37,8471817,Ryan Reaves,R,TOR,37,0,0,0,0
37,8479587,Rhett Gardner,C,PHI,28,0,0,0,0
37,8475766,Austin Watson,L,TBL,32,0,0,0,0
37,8479367,William Lockwood,R,FLA,26,0,0,0,0
37,8478424,Jansen Harkins,C,PIT,27,0,0,0,0
37,8476913,Devin Shore,C,SEA,30,0,0,0,0
37,8482652,Walker Duehr,R,CGY,27,0,0,0,0
37,8477527,Ross Johnston,L,ANA,30,0,0,0,0
37,8481077,John Leonard,L,ARI,26,0,0,0,0
37,8483549,Lucas Condotta,L,MTL,27,0,0,0,0
37,8480468,James Hamblin,L,EDM,25,0,0,0,0
37,8476907,Mackenzie MacEachern,L,STL,30,0,0,0,0
37,8479543,Michael Pezzetta,L,MTL,26,0,0,0,0
37,8480355,Mark Kastelic,C,OTT,25,0,0,0,0
37,8482162,Roby Jarventie,L,OTT,22,0,0,0,0
37,8479772,Zack MacEwen,R,OTT,28,0,0,0,0
37,8483597,Milos Kelemen,L,ARI,25,0,0,0,0
37,8479379,Givani Smith,R,SJS,26,0,0,0,0
37,8481655,Cole Schwindt,R,CGY,23,0,0,0,0
37,8479981,Jonah Gadjovich,L,FLA,26,0,0,0,0
37,8482147,Jean-Luc Foudy,C,COL,22,0,0,0,0
37,8484255,Jason Polin,R,COL,25,0,0,0,0
37,8477993,Justin Kirkland,C,ARI,28,0,0,0,0
37,8479249,Andrew Poturalski,C,SEA,30,0,0,0,0
37,8482197,Adam Raska,R,MIN,23,0,0,0,0
37,8475780,Chris Wagner,R,COL,33,0,0,0,0
37,8479533,Joona Koppanen,L,PIT,26,0,0,0,0
37,8481534,Raphael Lavoie,C,EDM,24,0,0,0,0
37,8484321,Nikolas Matinpalo,D,OTT,26,0,0,0,0
37,8481043,Cole Koepke,L,TBL,26,0,0,0,0
37,8476323,Max McCormick,L,SEA,32,0,0,0,0
37,8483609,Adam Klapka,R,CGY,24,0,0,0,0
37,8483512,Matt Savoie,C,BUF,20,0,0,0,0
37,8484259,Ondrej Pavel,C,COL,31,0,0,0,0
37,8478147,Bokondji Imama,L,OTT,28,0,0,0,0
37,8482460,Matt Rempe,C,NYR,22,0,0,0,0
37,8477073,Kurtis MacDermid,L,NJD,30,0,0,0,0
37,8480274,Philip Kemp,D,EDM,25,0,0,0,0
37,8478956,Samuel Laberge,L,NJD,27,0,0,0,0
37,8483045,Cameron Butler,R,CBJ,31,0,0,0,0
38,8478402,Connor McDavid,C,EDM,27,82,42,82,124
38,8476453,Nikita Kucherov,R,TBL,31,82,40,69,109
38,8471675,Sidney Crosby,C,PIT,37,82,46,58,104
38,8477934,Leon Draisaitl,C,EDM,29,82,37,65,102
38,8479318,Auston Matthews,C,TOR,27,82,51,47,98
38,8478420,Mikko Rantanen,R,COL,28,82,36,61,97
38,8477492,Nathan MacKinnon,C,COL,29,82,37,58,95
38,8481559,Jack Hughes,C,NJD,23,82,40,54,94
38,8479314,Matthew Tkachuk,L,FLA,27,82,38,54,92
38,8476468,J.T. Miller,C,VAN,31,82,32,58,90
38,8478010,Brayden Point,C,TBL,28,82,40,46,86
38,8477946,Dylan Larkin,C,DET,28,82,39,46,85
38,8480012,Elias Pettersson,C,VAN,26,82,38,46,84
38,8480027,Jason Robertson,L,DAL,25,82,34,50,84
38,8478550,Artemi Panarin,L,NYR,33,82,31,52,83
38,8476887,Filip Forsberg,L,NSH,30,82,35,47,82
38,8478864,Kirill Kaprizov,L,MIN,27,82,42,39,81
38,8480800,Quinn Hughes,D,VAN,25,82,8,73,81
38,8477956,David Pastrnak,R,BOS,28,82,32,48,80
38,8478398,Kyle Connor,L,WPG,28,82,30,50,80
38,8477493,Aleksander Barkov,C,FLA,29,82,28,51,79
38,8477404,Jake Guentzel,C,CAR,30,82,35,43,78
38,8480801,Brady Tkachuk,L,OTT,25,82,34,44,78
38,8475786,Zach Hyman,L,EDM,32,82,34,43,77
38,8477939,William Nylander,R,TOR,28,82,33,44,77
38,8477501,Valeri Nichushkin,R,COL,29,82,37,39,76
38,8475166,John Tavares,C,TOR,34,82,35,40,75
38,8476459,Mika Zibanejad,C,NYR,31,82,24,51,75
38,8477496,Elias Lindholm,C,VAN,30,82,33,41,74
38,8479385,Jordan Kyrou,C,STL,26,82,31,43,74
38,8478414,Timo Meier,R,NJD,28,82,30,44,74
38,8476389,Vincent Trocheck,C,NYR,31,82,26,48,74
38,8474600,Roman Josi,D,NSH,34,82,18,56,74
38,8479407,Jesper Bratt,L,NJD,26,82,30,43,73
38,8478427,Sebastian Aho,C,CAR,27,82,27,46,73
38,8480002,Nico Hischier,C,NJD,25,82,25,48,73
38,8479343,Clayton Keller,R,ARI,26,82,29,43,72
38,8475692,Mats Zuccarello,R,MIN,37,82,19,53,72
38,8474564,Steven Stamkos,C,TBL,34,82,39,32,71
38,8478403,Jack Eichel,C,VGK,28,82,29,41,70
38,8471214,Alex Ovechkin,L,WSH,39,82,32,37,69
38,8482093,Seth Jarvis,C,CAR,22,82,28,41,69
38,8480830,Andrei Svechnikov,R,CAR,24,82,27,42,69
38,8477960,Adrian Kempe,R,LAK,28,82,26,43,69
38,8475798,Mikael Granlund,C,SJS,32,82,10,59,69
38,8477933,Sam Reinhart,C,FLA,29,82,35,33,68
38,8475172,Nazem Kadri,C,CGY,34,82,27,41,68
38,8475168,Matt Duchene,C,DAL,33,82,26,42,68
38,8482116,Tim Stützle,C,OTT,22,82,26,42,68
38,8476454,Ryan Nugent-Hopkins,C,EDM,31,82,22,46,68
38,8477942,Kevin Fiala,L,LAK,28,82,21,47,68
38,8477409,Carter Verhaeghe,C,FLA,29,82,40,27,67
38,8478439,Travis Konecny,R,PHI,27,82,29,38,67
38,8482078,Lucas Raymond,L,DET,22,82,31,35,66
38,8477940,Nikolaj Ehlers,L,WPG,28,82,27,39,66
38,8471215,Evgeni Malkin,C,PIT,38,82,21,45,66
38,8478038,Devon Toews,D,COL,30,82,16,50,66
38,8481557,Matt Boldy,L,MIN,23,82,30,35,65
38,8480018,Nick Suzuki,C,MTL,25,82,27,38,65
38,8480069,Cale Makar,D,COL,26,82,18,47,65
38,8482684,Luke Hughes,D,NJD,21,82,25,39,64
38,8479323,Adam Fox,D,NYR,26,82,16,48,64
38,8480036,Miro Heiskanen,D,DAL,25,82,9,55,64
38,8481523,Kirby Dach,C,MTL,23,82,8,56,64
38,8476539,Jonathan Marchessault,R,VGK,34,82,41,22,63
38,8478042,Viktor Arvidsson,R,LAK,31,82,27,36,63
38,8474141,Patrick Kane,R,DET,36,82,27,36,63
38,8476456,Jonathan Huberdeau,C,CGY,31,82,15,48,63
38,8477955,Jared McCann,L,SEA,28,82,32,30,62
38,8477402,Pavel Buchnevich,L,STL,29,82,25,37,62
38,8477951,Nick Schmaltz,C,ARI,28,82,24,38,62
38,8473419,Brad Marchand,L,BOS,36,82,20,42,62
38,8475158,Ryan O'Reilly,C,NSH,33,82,18,44,62
38,8478856,Conor Garland,R,VAN,28,82,26,35,61
38,8478440,Dylan Strome,C,WSH,27,82,23,38,61
38,8479542,Brandon Hagel,L,TBL,26,82,20,41,61
38,8480023,Robert Thomas,C,STL,25,82,15,46,61
38,8480803,Evan Bouchard,D,EDM,25,82,14,47,61
38,8478407,Vince Dunn,D,SEA,28,82,12,49,61
38,8481540,Cole Caufield,R,MTL,23,82,37,23,60
38,8480208,Drake Batherson,R,OTT,26,82,29,31,60
38,8476462,Dougie Hamilton,D,NJD,31,82,20,40,60
38,8477476,Artturi Lehkonen,L,COL,29,82,31,28,59
38,8481068,Yegor Sharangovich,C,CGY,26,82,30,29,59
38,8475810,Bryan Rust,R,PIT,32,82,24,35,59
38,8479675,Trevor Moore,L,LAK,29,82,23,36,59
38,8478445,Mathew Barzal,C,NYI,27,82,19,40,59
38,8474578,Erik Karlsson,D,PIT,34,82,17,42,59
38,8480865,Noah Dobson,D,NYI,24,82,12,47,59
38,8475167,Victor Hedman,D,TBL,34,82,8,51,59
38,8475913,Mark Stone,R,VGK,32,82,19,39,58
38,8479420,Tage Thompson,C,BUF,27,82,33,24,57
38,8482109,Alexis Lafrenière,L,NYR,23,82,26,31,57
38,8477416,Oliver Bjorkstrand,R,SEA,29,82,21,36,57
38,8479410,Mikhail Sergachev,D,TBL,26,82,9,48,57
38,8476460,Mark Scheifele,C,WPG,31,82,28,28,56
38,8478449,Roope Hintz,C,DAL,28,82,25,31,56
38,8482097,Jack Quinn,R,BUF,23,82,21,35,56
38,8478397,Rasmus Andersson,D,CGY,28,82,12,44,56
38,8476346,Johnny Gaudreau,L,CBJ,31,82,10,46,56
38,8477447,Shea Theodore,D,VGK,29,82,10,46,56
38,8475794,Tyler Seguin,C,DAL,32,82,31,24,55
38,8478444,Brock Boeser,R,VAN,27,82,26,29,55
38,8477949,Alex Tuch,R,BUF,28,82,22,33,55
38,8476869,Brady Skjei,D,CAR,30,82,17,38,55
38,8479400,Pierre-Luc Dubois,L,LAK,26,82,27,27,54
38,8478493,Joel Eriksson Ek,C,MIN,27,82,26,28,54
38,8479337,Alex DeBrincat,R,DET,27,82,23,31,54
38,8476880,Tom Wilson,R,WSH,30,82,23,31,54
38,8482124,Quinton Byfield,R,LAK,22,82,19,35,54
38,8477504,Josh Morrissey,D,WPG,29,82,12,42,54
38,8480031,Maxime Comtois,L,CAR,25,82,12,42,54
38,8475151,Kyle Palmieri,C,NYI,33,82,25,28,53
38,8473994,Jamie Benn,L,DAL,35,82,19,34,53
38,8480839,Rasmus Dahlin,D,BUF,24,82,8,45,53
38,8480188,Fabian Zetterlund,L,SJS,25,82,29,23,52
38,8477500,Bo Horvat,C,NYI,29,82,28,24,52
38,8483808,Andrei Kuzmenko,L,CGY,28,82,23,29,52
38,8477456,J.T. Compher,L,DET,29,82,23,29,52
38,8481711,Matias Maccelli,L,ARI,24,82,23,29,52
38,8476881,Tomas Hertl,C,VGK,31,82,22,30,52
38,8477444,Andre Burakovsky,L,SEA,29,82,16,36,52
38,8478460,Zach Werenski,D,CBJ,27,82,15,37,52
38,8476875,Mike Matheson,D,MTL,30,82,13,39,52
38,8474590,John Carlson,D,WSH,34,82,8,44,52
38,8471685,Anze Kopitar,C,LAK,37,82,28,23,51
38,8475754,Brock Nelson,C,NYI,33,82,25,26,51
38,8478233,Andrew Mangiapane,L,CGY,28,82,20,31,51
38,8475765,Vladimir Tarasenko,R,FLA,33,82,18,33,51
38,8478975,Mason Marchment,L,DAL,29,82,17,34,51
38,8470794,Joe Pavelski,C,DAL,40,82,17,34,51
38,8476853,Morgan Rielly,D,TOR,30,82,7,44,51
38,8480015,Owen Tippett,R,PHI,25,82,24,26,50
38,8475726,Tyler Toffoli,C,WPG,32,82,22,28,50
38,8476483,Rickard Rakell,R,PIT,31,82,21,29,50
38,8474586,Jordan Eberle,R,SEA,34,82,19,31,50
38,8477346,MacKenzie Weegar,D,CGY,30,82,16,34,50
38,8484144,Connor Bedard,C,CHI,19,82,27,22,49
38,8474157,Max Pacioretty,L,WSH,36,82,26,23,49
38,8478469,Thomas Chabot,D,OTT,27,82,21,28,49
38,8482745,Mason McTavish,C,ANA,21,82,19,30,49
38,8477479,Tyler Bertuzzi,L,TOR,29,82,19,30,49
38,8478047,Michael Bunting,L,PIT,29,82,19,30,49
38,8481533,Trevor Zegras,C,ANA,23,82,17,32,49
38,8478466,Daniel Sprong,R,DET,27,82,12,37,49
38,8479425,Filip Hronek,D,VAN,27,82,9,40,49
38,8479325,Charlie McAvoy,D,BOS,27,82,8,41,49
38,8478873,Troy Terry,R,ANA,27,82,28,20,48
38,8482159,Tyson Foerster,R,PHI,22,82,27,21,48
38,8482699,Dylan Guenther,R,ARI,21,82,25,23,48
38,8476399,Blake Coleman,C,CGY,33,82,22,26,48
38,8481528,Dylan Cozens,C,BUF,23,82,19,29,48
38,8475184,Chris Kreider,L,NYR,33,82,34,13,47
38,8476448,William Karlsson,C,VGK,31,82,25,22,47
38,8477407,Anthony Duclair,L,TBL,29,82,22,25,47
38,8471698,T.J. Oshie,R,WSH,38,82,21,26,47
38,8480797,Joel Farabee,L,PHI,24,82,19,28,47
38,8475191,Reilly Smith,R,PIT,33,82,18,29,47
38,8473512,Claude Giroux,R,OTT,36,82,18,29,47
38,8474102,David Perron,L,DET,36,82,17,30,47
38,8479345,Jakob Chychrun,D,OTT,26,82,16,31,47
38,8481596,Shane Pinto,C,OTT,24,82,14,33,47
38,8477986,Brandon Montour,D,FLA,30,82,9,38,47
38,8480893,Kirill Marchenko,R,CBJ,24,82,26,20,46
38,8482740,Wyatt Johnston,C,DAL,21,82,24,22,46
38,8480039,Martin Necas,C,CAR,25,82,18,28,46
38,8479339,Patrik Laine,L,CBJ,26,82,18,28,46
38,8477935,Sam Bennett,C,FLA,28,82,23,22,45
38,8482110,Dawson Mercer,C,NJD,23,82,23,22,45
38,8478366,Frank Vatrano,R,ANA,30,82,22,23,45
38,8478458,Jack Roslovic,C,NYR,27,82,21,24,45
38,8474641,Adam Henrique,C,EDM,34,82,18,27,45
38,8474679,Gustav Nyquist,C,NSH,35,82,18,27,45
38,8474150,Mikael Backlund,C,CGY,35,82,15,30,45
38,8473986,Alex Killorn,L,ANA,35,82,15,30,45
38,8477021,Alex Kerfoot,C,ARI,30,82,12,33,45
38,8483471,Brad Lambert,C,WPG,31,82,10,35,45
38,8483457,Lane Hutson,D,MTL,20,82,6,39,45
38,8475169,Evander Kane,L,EDM,33,82,29,15,44
38,8475768,Jaden Schwartz,C,SEA,32,82,20,24,44
38,8480078,Filip Chytil,C,NYR,25,82,12,32,44
38,8470613,Brent Burns,D,CAR,39,82,10,34,44
38,8476432,Boone Jenner,C,CBJ,31,82,27,16,43
38,8482146,Luke Evangelista,R,NSH,22,82,19,24,43
38,8478498,Jake DeBrusk,L,BOS,28,82,18,25,43
38,8475791,Taylor Hall,L,CHI,33,82,16,27,43
38,8478472,Mathieu Joseph,R,OTT,27,82,13,30,43
38,8482105,Jake Sanderson,D,OTT,22,82,13,30,43
38,8482133,Thomas Bordeleau,C,SJS,22,82,12,31,43
38,8479999,Casey Mittelstadt,C,COL,26,82,11,32,43
38,8476292,Ondrej Palat,L,NJD,33,82,8,35,43
38,8482101,Danil Gushchin,L,SJS,22,82,23,19,42
38,8474149,Evgenii Dadonov,R,DAL,35,82,20,22,42
38,8477497,Sean Monahan,C,WPG,30,82,17,25,42
38,8475170,Brayden Schenn,C,STL,33,82,15,27,42
38,8476826,Yanni Gourde,C,SEA,33,82,14,28,42
38,8475287,Erik Haula,L,NJD,33,82,14,28,42
38,8476329,Travis Boyd,C,ARI,31,82,13,29,42
38,8478396,Noah Hanifin,D,VGK,27,82,10,32,42
38,8483445,Cutter Gauthier,L,ANA,20,82,9,33,42
38,8475197,Tyson Barrie,D,NSH,33,82,9,33,42
38,8477948,Travis Sanheim,D,PHI,28,82,6,36,42
38,8481016,Ruslan Iskhakov,C,NYI,24,82,5,37,42
38,8475314,Anders Lee,L,NYI,34,82,25,16,41
38,8477989,Christian Dvorak,C,MTL,28,82,18,23,41
38,8475784,Jeff Skinner,C,BUF,32,82,16,25,41
38,8476479,Phillip Danault,C,LAK,31,82,16,25,41
38,8480009,Eeli Tolvanen,R,SEA,25,82,16,25,41
38,8483515,Juraj Slafkovsky,L,MTL,20,82,14,27,41
38,8478462,Nicolas Roy,C,VGK,27,82,14,27,41
38,8476905,Chandler Stephenson,C,VGK,30,82,10,31,41
38,8474565,Alex Pietrangelo,D,VGK,34,82,7,34,41
38,8475722,Jason Zucker,L,NSH,32,82,23,17,40
38,8482222,Alexander Barabanov,L,SJS,30,82,22,18,40
38,8475799,Nino Niederreiter,R,WPG,32,82,21,19,40
38,8481560,Arthur Kaliyev,R,LAK,23,82,16,24,40
38,8477429,Andrew Copp,C,DET,30,82,14,26,40
38,8477932,Aaron Ekblad,D,FLA,28,82,12,28,40
38,8480014,Gabriel Vilardi,C,WPG,25,82,27,12,39
38,8483524,Shane Wright,C,SEA,20,82,25,14,39
38,8474037,James van Riemsdyk,L,BOS,35,82,20,19,39
38,8475745,Charlie Coyle,C,BOS,32,82,18,21,39
38,8477511,Anthony Mantha,R,VGK,30,82,17,22,39
38,8479365,Trent Frederic,C,BOS,26,82,17,22,39
38,8478401,Pavel Zacha,C,BOS,27,82,16,23,39
38,8477451,Ryan Hartman,R,MIN,30,82,16,23,39
38,8480798,Philipp Kurashev,C,CHI,25,82,12,27,39
38,8476906,Shayne Gostisbehere,D,DET,31,82,9,30,39
38,8478519,Anthony Cirelli,C,TBL,27,82,18,20,38
38,8471218,Blake Wheeler,R,NYR,38,82,18,20,38
38,8475793,Ryan Johansen,C,PHI,32,82,18,20,38
38,8477426,Nicholas Paul,L,TBL,29,82,16,22,38
38,8476882,Teuvo Teravainen,L,CAR,30,82,16,22,38
38,8474884,Mike Hoffman,C,SJS,35,82,16,22,38
38,8475744,Evgeny Kuznetsov,C,CAR,32,82,15,23,38
38,8479992,Michael Rasmussen,C,DET,25,82,15,23,38
38,8477494,Jonathan Drouin,L,COL,29,82,10,28,38
38,8481542,Moritz Seider,D,DET,23,82,6,32,38
38,8477503,Max Domi,C,TOR,29,82,6,32,38
38,8476792,Torey Krug,D,STL,33,82,6,32,38
38,8477495,Seth Jones,D,CHI,30,82,5,33,38
38,8477998,Warren Foegele,L,EDM,28,82,17,20,37
38,8478438,Tommy Novak,C,NSH,27,82,16,21,37
38,8476921,Jordan Martinook,L,CAR,32,82,14,23,37
38,8482665,Matty Beniers,C,SEA,22,82,10,27,37
38,8482720,Matthew Knies,L,TOR,22,82,10,27,37
38,8480028,Morgan Frost,C,PHI,25,82,9,28,37
38,8475218,Mattias Ekholm,D,EDM,34,82,8,29,37
38,8480336,Sean Walker,D,COL,30,82,7,30,37
38,8483397,Marc McLaughlin,C,BOS,25,82,34,2,36
38,8475848,Brendan Gallagher,R,MTL,32,82,22,14,36
38,8478891,Mason Appleton,C,WPG,28,82,19,17,36
38,8482667,William Eklund,L,SJS,22,82,17,19,36
38,8479525,Ross Colton,C,COL,28,82,17,19,36
38,8482175,JJ Peterka,R,BUF,22,82,16,20,36
38,8478413,Jordan Greenway,L,BUF,27,82,14,22,36
38,8480849,Barrett Hayton,C,ARI,24,82,13,23,36
38,8481581,Thomas Harley,D,DAL,23,82,9,27,36
38,8474563,Drew Doughty,D,LAK,35,82,9,27,36
38,8480434,Sean Durzi,D,ARI,26,82,8,28,36
38,8482671,Owen Power,D,BUF,22,82,8,28,36
38,8471724,Kris Letang,D,PIT,37,82,6,30,36
38,8475764,Cam Fowler,D,ANA,33,82,5,31,36
38,8477944,Jakub Vrana,L,STL,28,82,18,17,35
38,8470610,Zach Parise,L,COL,40,82,17,18,35
38,8478057,Dakota Joshua,C,VAN,28,82,16,19,35
38,8476458,Ryan Strome,C,ANA,31,82,15,20,35
38,8477952,Robby Fabbri,C,DET,28,82,14,21,35
38,8479987,Morgan Geekie,C,BOS,26,82,13,22,35
38,8476461,Sean Couturier,C,PHI,32,82,11,24,35
38,8476854,Hampus Lindholm,D,BOS,30,82,10,25,35
38,8482122,Brock Faber,D,MIN,22,82,5,30,35
38,8479316,Luke Kunin,C,SJS,27,82,19,15,34
38,8477947,Sonny Milano,L,WSH,28,82,17,17,34
38,8476419,Jean-Gabriel Pageau,C,NYI,32,82,16,18,34
38,8480873,Rasmus Sandin,D,WSH,24,82,7,27,34
38,8475906,John Klingberg,D,TOR,32,82,6,28,34
38,8481699,Aku Raty,R,ARI,23,82,2,32,34
38,8478474,Lawson Crouse,L,ARI,27,82,17,16,33
38,8478046,Danton Heinen,L,BOS,29,82,16,17,33
38,8479996,Cody Glass,C,NSH,25,82,14,19,33
38,8478542,Evan Rodrigues,C,FLA,31,82,13,20,33
38,8474715,Cam Atkinson,R,PHI,35,82,13,20,33
38,8482113,Anton Lundell,C,FLA,23,82,12,21,33
38,8481618,Alex Newhook,C,MTL,23,82,11,22,33
38,8480145,Neal Pionk,D,WPG,29,82,7,26,33
38,8481703,Valtteri Puustinen,R,PIT,25,82,5,28,33
38,8480220,Noah Cates,L,PHI,25,82,17,15,32
38,8475763,Kevin Hayes,R,STL,32,82,16,16,32
38,8481535,Nils Hoglander,L,VAN,24,82,11,21,32
38,8475343,Nic Dowd,C,WSH,34,82,11,21,32
38,8476958,Jaccob Slavin,D,CAR,30,82,8,24,32
38,8481656,Aliaksei Protas,C,WSH,23,82,8,24,32
38,8474716,Jared Spurgeon,D,MIN,35,82,4,28,32
38,8479423,Alex Nylander,L,CBJ,26,82,20,11,31
38,8482055,Drew O'Connor,L,PIT,26,82,18,13,31
38,8480064,Josh Norris,C,OTT,25,82,17,14,31
38,8477839,Conor Sheary,L,TBL,32,82,17,14,31
38,8477964,Ivan Barbashev,C,VGK,29,82,14,17,31
38,8476872,Scott Laughton,C,PHI,30,82,13,18,31
38,8475231,Casey Cizikas,C,NYI,33,82,12,19,31
38,8482705,Cole Sillinger,C,CBJ,21,82,9,22,31
38,8475200,Dmitry Orlov,D,CAR,33,82,9,22,31
38,8474053,Logan Couture,C,SJS,35,82,6,25,31
38,8482118,Sam Colangelo,R,ANA,23,82,24,6,30
38,8481624,Ilya Mikheyev,R,VAN,30,82,20,10,30
38,8476981,Josh Anderson,R,MTL,30,82,17,13,30
38,8479415,Michael McLeod,C,NJD,26,82,17,13,30
38,8479346,Dillon Dube,C,CGY,26,82,17,13,30
38,8483499,Liam Ohgren,L,MIN,20,82,17,13,30
38,8483431,Logan Cooley,C,ARI,20,82,15,15,30
38,8476960,Andreas Athanasiou,C,CHI,30,82,14,16,30
38,8482475,Yegor Chinakhov,R,CBJ,23,82,12,18,30
38,8478463,Anthony Beauvillier,L,NSH,27,82,12,18,30
38,8480817,K'Andre Miller,D,NYR,24,82,11,19,30
38,8482111,Justin Barron,D,MTL,23,82,11,19,30
38,8476392,Adam Lowry,C,WPG,31,82,11,19,30
38,8475753,Justin Faulk,D,STL,32,82,10,20,30
38,8482117,Lukas Reichel,L,CHI,22,82,10,20,30
38,8481013,Jonatan Berggren,R,DET,24,82,9,21,30
38,8477506,Ryan Pulock,D,NYI,30,82,9,21,30
38,8478911,Matt Roy,D,LAK,29,82,8,22,30
38,8481546,Cam York,D,PHI,23,82,6,24,30
38,8478500,Ivan Provorov,D,CBJ,27,82,5,25,30
38,8478507,John Marino,D,NJD,27,82,5,25,30
38,8481554,Kaapo Kakko,R,NYR,23,82,17,12,29
38,8476438,Brandon Saad,L,STL,32,82,15,14,29
38,8477425,Miles Wood,L,COL,29,82,14,15,29
38,8473422,Nick Foligno,L,CHI,37,82,13,16,29
38,8476925,Colton Sissons,C,NSH,31,82,13,16,29
38,8481580,Connor McMichael,C,WSH,23,82,12,17,29
38,8476278,Colin Blackwell,C,CHI,31,82,11,18,29
38,8476927,Teddy Blueger,C,VAN,30,82,11,18,29
38,8475220,Marcus Foligno,L,MIN,33,82,11,18,29
38,8476480,Vladislav Namestnikov,C,WPG,32,82,11,18,29
38,8478020,Michael Amadio,C,VGK,28,82,11,18,29
38,8477507,Nikita Zadorov,D,VAN,29,82,7,22,29
38,8475181,Nick Leddy,D,STL,33,82,6,23,29
38,8476885,Jacob Trouba,D,NYR,30,82,4,25,29
38,8481568,Alex Vlasic,D,CHI,23,82,2,27,29
38,8481604,Pavel Dorofeyev,L,VGK,24,82,20,8,28
38,8483493,Frank Nazar,C,CHI,20,82,19,9,28
38,8476871,Tanner Pearson,L,MTL,32,82,18,10,28
38,8482089,Jake Neighbours,L,STL,22,82,16,12,28
38,8481093,Rafael Harvey-Pinard,L,MTL,25,82,16,12,28
38,8480459,Pius Suter,C,VAN,28,82,11,17,28
38,8481537,Nikita Okhotiuk,D,CGY,24,82,11,17,28
38,8476469,Joel Armia,R,MTL,31,82,10,18,28
38,8480806,Isac Lundestrom,C,ANA,25,82,9,19,28
38,8478136,Jake Middleton,D,MIN,28,82,8,20,28
38,8481567,Henry Thrun,D,SJS,23,82,6,22,28
38,8476979,Erik Gustafsson,D,NYR,32,82,4,24,28
38,8478055,Gustav Forsling,D,FLA,28,82,4,24,28
38,8476331,Dylan DeMelo,D,WPG,31,82,4,24,28
38,8470621,Corey Perry,R,EDM,39,82,18,9,27
38,8484203,Bradly Nadeau,L,CAR,19,82,18,9,27
38,8476897,Oskar Sundqvist,C,STL,30,82,14,13,27
38,8478043,Sam Lafferty,C,VAN,29,82,13,14,27
38,8480855,Jack McBain,C,ARI,24,82,12,15,27
38,8474870,Tyler Johnson,C,CHI,34,82,12,15,27
38,8477953,Kasperi Kapanen,R,STL,28,82,12,15,27
38,8482624,Daniil Miromanov,D,CGY,27,82,8,19,27
38,8476892,Colton Parayko,D,STL,31,82,7,20,27
38,8475760,Nick Bjugstad,C,ARI,32,82,18,8,26
38,8475714,Calle Jarnkrok,C,TOR,33,82,17,9,26
38,8478115,Pierre Engvall,L,NYI,28,82,15,11,26
38,8480821,Filip Zadina,R,SJS,25,82,15,11,26
38,8484166,Adam Fantilli,C,CBJ,20,82,13,13,26
38,8484145,Zach Benson,L,BUF,19,82,12,14,26
38,8479383,Boris Katchouk,L,OTT,26,82,10,16,26
38,8480185,Eetu Luostarinen,C,FLA,26,82,9,17,26
38,8477508,Curtis Lazar,C,NJD,29,82,9,17,26
38,8479398,Samuel Girard,D,COL,26,82,8,18,26
38,8478430,Oliver Kylington,D,CGY,27,82,8,18,26
38,8483505,Matthew Poitras,C,BOS,20,82,7,19,26
38,8473563,Nicklas Backstrom,C,WSH,37,82,6,20,26
38,8480871,Adam Boqvist,D,CBJ,24,82,5,21,26
38,8481606,Jordan Spence,D,LAK,23,82,3,23,26
38,8482702,Logan Stankoven,C,DAL,21,82,14,11,25
38,8478109,Victor Olofsson,L,BUF,29,82,12,13,25
38,8480281,Alexey Toropchenko,R,STL,25,82,12,13,25
38,8481186,Logan O'Connor,R,COL,28,82,10,15,25
38,8480802,Ryan McLeod,C,EDM,25,82,10,15,25
38,8475149,Marcus Johansson,L,MIN,34,82,9,16,25
38,8478133,Jake Evans,C,MTL,28,82,9,16,25
38,8482142,Jamie Drysdale,D,PHI,22,82,8,17,25
38,8479351,Sam Steel,C,DAL,26,82,6,19,25
38,8476463,Jonas Brodin,D,MIN,31,82,6,19,25
38,8476923,Damon Severson,D,CBJ,30,82,4,21,25
38,8482087,Kaiden Guhle,D,MTL,22,82,3,22,25
38,8483490,Pavel Mintyukov,D,ANA,21,82,2,23,25
38,8478178,Darren Raddysh,D,TBL,28,82,1,24,25
38,8470604,Jeff Carter,C,PIT,39,82,14,10,24
38,8479514,Rem Pitlick,C,CHI,27,82,12,12,24
38,8482259,Bobby McMann,C,TOR,28,82,12,12,24
38,8479977,Kailer Yamamoto,R,SEA,26,82,10,14,24
38,8481517,Brett Leason,R,ANA,25,82,10,14,24
38,8480068,Ryan Poehling,C,PHI,25,82,10,14,24
38,8473449,Kyle Okposo,R,FLA,36,82,8,16,24
38,8483466,Kevin Korchinski,D,CHI,20,82,7,17,24
38,8476442,Matt Nieto,L,PIT,32,82,7,17,24
38,8475171,Oliver Ekman-Larsson,D,FLA,33,82,5,19,24
38,8480043,Timothy Liljegren,D,TOR,25,82,2,22,24
38,8478508,Yakov Trenin,C,COL,27,82,15,8,23
38,8482125,Alexander Holtz,R,NJD,22,82,13,10,23
38,8476873,Mark Jankowski,C,NSH,30,82,13,10,23
38,8479661,Tanner Jeannot,L,TBL,27,82,13,10,23
38,8474009,Nick Bonino,C,NYR,36,82,12,11,23
38,8476878,Zemgus Girgensons,L,BUF,30,82,11,12,23
38,8477450,Jason Dickinson,C,CHI,29,82,11,12,23
38,8479371,Dante Fabbro,D,NSH,26,82,9,14,23
38,8484153,Leo Carlsson,C,ANA,20,82,7,16,23
38,8480113,Alex Iafallo,L,WPG,31,82,7,16,23
38,8477488,Brett Pesce,D,CAR,30,82,6,17,23
38,8478013,Jake Walman,D,DET,28,82,6,17,23
38,8481028,Martin Pospisil,C,CGY,25,82,5,18,23
38,8482733,Logan Mailloux,D,MTL,31,82,4,19,23
38,8481014,Alexander Romanov,D,NYI,24,82,4,19,23
38,8470600,Ryan Suter,D,DAL,39,82,4,19,23
38,8477392,Hudson Fasching,R,NYI,29,82,4,19,23
38,8475179,Dmitry Kulikov,D,FLA,34,82,3,20,23
38,8477969,Marcus Pettersson,D,PIT,28,82,1,22,23
38,8478569,Noel Acciari,C,PIT,33,82,16,6,22
38,8480144,David Kampf,C,TOR,29,82,13,9,22
38,8475164,Jakob Silfverberg,R,ANA,34,82,13,9,22
38,8482079,Marco Rossi,C,MIN,23,82,10,12,22
38,8481601,Simon Holmstrom,R,NYI,23,82,10,12,22
38,8482074,Connor Zary,C,CGY,23,82,9,13,22
38,8480074,Alexandre Texier,C,CBJ,25,82,9,13,22
38,8482655,J.J. Moser,D,ARI,24,82,9,13,22
38,8479353,Brett Howden,C,VGK,26,82,8,14,22
38,8479390,Taylor Raddysh,R,CHI,26,82,8,14,22
38,8476902,Esa Lindell,D,DAL,30,82,7,15,22
38,8477498,Darnell Nurse,D,EDM,29,82,6,16,22
38,8482092,Ridly Greig,C,OTT,22,82,6,16,22
38,8476879,Cody Ceci,D,EDM,31,82,6,16,22
38,8474673,TJ Brodie,D,TOR,34,82,4,18,22
38,8475177,Calvin de Haan,D,TBL,33,82,4,18,22
38,8480246,Nick Perbix,D,TBL,26,82,2,20,22
38,8475690,Chris Tanev,D,DAL,35,82,1,21,22
38,8482809,Jackson Blake,R,CAR,21,82,15,6,21
38,8481578,Graeme Clarke,R,NJD,23,82,14,7,21
38,8482155,Alex Laferriere,R,LAK,23,82,12,9,21
38,8479591,Michael Eyssimont,C,TBL,28,82,12,9,21
38,8483491,Ivan Miroshnichenko,L,WSH,20,82,10,11,21
38,8477330,Dominik Kubalik,L,OTT,29,82,9,12,21
38,8480058,Pierre-Olivier Joseph,D,PIT,25,82,6,15,21
38,8481481,Blake Lizotte,C,LAK,27,82,5,16,21
38,8476467,Jamie Oleksiak,D,SEA,32,82,5,16,21
38,8481477,Nico Sturm,C,SJS,29,82,4,17,21
38,8478859,Niko Mikkola,D,FLA,28,82,4,17,21
38,8481178,Egor Zamula,D,PHI,24,82,3,18,21
38,8482073,Braden Schneider,D,NYR,23,82,3,18,21
38,8476457,Adam Larsson,D,SEA,32,82,3,18,21
38,8479324,Ryan Lindgren,D,NYR,26,82,3,18,21
38,8479293,Brandon Tanev,L,SEA,33,82,15,5,20
38,8482803,Olen Zellweger,D,ANA,21,82,6,14,20
38,8483482,Tristan Luneau,D,ANA,20,82,6,14,20
38,8481522,Peyton Krebs,C,BUF,23,82,5,15,20
38,8481605,Jackson LaCombe,D,ANA,23,82,5,15,20
38,8474034,Pat Maroon,L,BOS,36,82,5,15,20
38,8474574,Tyler Myers,D,VAN,34,82,3,17,20
38,8480073,Erik Brannstrom,D,OTT,25,82,2,18,20
38,8478443,Brandon Carlo,D,BOS,28,82,1,19,20
38,8474151,Ryan McDonagh,D,NSH,35,82,1,19,20
38,8473507,Jeff Petry,D,DET,37,82,0,20,20
38,8479393,Noah Gregor,C,TOR,26,82,10,9,19
38,8482062,Cole Smith,L,NSH,29,82,10,9,19
38,8474189,Lars Eller,C,PIT,35,82,7,12,19
38,8477435,Ryan Graves,D,PIT,29,82,6,13,19
38,8476931,Jake McCabe,D,TOR,31,82,4,15,19
38,8483495,Simon Nemec,D,NJD,20,82,3,16,19
38,8475790,Erik Gudbranson,D,CBJ,32,82,3,16,19
38,8478416,Erik Cernak,D,TBL,27,82,3,16,19
38,8475455,Brenden Dillon,D,WPG,34,82,2,17,19
38,8480813,Joe Veleno,C,DET,24,82,11,7,18
38,8479941,Justin Danforth,R,CBJ,31,82,10,8,18
38,8482679,Matt Coronato,R,CGY,22,82,10,8,18
38,8473533,Jordan Staal,C,CAR,36,82,10,8,18
38,8481704,Juuso Parssinen,C,NSH,23,82,8,10,18
38,8481553,Bobby Brink,R,PHI,23,82,7,11,18
38,8480448,Parker Kelly,L,OTT,25,82,7,11,18
38,8478851,Alexandre Carrier,D,NSH,28,82,6,12,18
38,8480172,Jan Rutta,D,SJS,34,82,6,12,18
38,8477406,Mattias Janmark,C,EDM,32,82,6,12,18
38,8482730,Brandt Clarke,D,LAK,21,82,5,13,18
38,8479359,Beck Malenstyn,L,WSH,26,82,5,13,18
38,8477365,Connor Clifton,D,BUF,29,82,5,13,18
38,8480807,Mattias Samuelsson,D,BUF,24,82,4,14,18
38,8479980,Nicolas Hague,D,VGK,26,82,4,14,18
38,8476312,Josh Manson,D,COL,33,82,3,15,18
38,8477499,Rasmus Ristolainen,D,PHI,30,82,3,15,18
38,8476967,Brett Kulak,D,EDM,30,82,3,15,18
38,8479976,Juuso Valimaki,D,ARI,26,82,3,15,18
38,8480860,Kevin Bahl,D,NJD,24,82,3,15,18
38,8476525,Colin Miller,D,WPG,32,82,3,15,18
38,8476891,Matt Grzelcyk,D,BOS,30,82,2,16,18
38,8476429,Scott Mayfield,D,NYI,32,82,2,16,18
38,8475188,Brayden McNabb,D,VGK,33,82,2,16,18
38,8483012,Logan Morrison,C,SEA,22,82,8,9,17
38,8476374,Sean Kuraly,C,CBJ,31,82,7,10,17
38,8477919,Frederick Gaudreau,C,MIN,31,82,6,11,17
38,8477931,Tomas Nosek,L,NJD,32,82,4,13,17
38,8475324,Nick Jensen,D,WSH,34,82,4,13,17
38,8470966,Mark Giordano,D,TOR,41,82,4,13,17
38,8479998,Mikey Anderson,D,LAK,25,82,4,13,17
38,8478468,Jeremy Lauzon,D,NSH,27,82,4,13,17
38,8482516,Matthew Kessel,D,STL,24,82,4,13,17
38,8480879,Jacob Bernard-Docker,D,OTT,24,82,3,14,17
38,8482145,Mavrik Bourque,C,DAL,22,82,13,3,16
38,8482762,Simon Edvinsson,D,DET,21,82,9,7,16
38,8480796,Martin Fehervary,D,WSH,25,82,6,10,16
38,8477505,Alexander Wennberg,C,NYR,30,82,5,11,16
38,8476917,Adam Pelech,D,NYI,30,82,5,11,16
38,8475279,Ben Chiarot,D,DET,33,82,5,11,16
38,8480834,Ty Emberson,D,SJS,24,82,5,11,16
38,8482245,Artem Zub,D,OTT,29,82,4,12,16
38,8478399,Jonas Siegenthaler,D,NJD,27,82,4,12,16
38,8478840,Will Borgen,D,SEA,28,82,2,14,16
38,8482470,Ilya Solovyov,D,CGY,24,82,1,15,16
38,8471677,Jack Johnson,D,COL,37,82,1,15,16
38,8481524,Bowen Byram,D,BUF,23,82,9,6,15
38,8473504,Cal Clutterbuck,R,NYI,37,82,7,8,15
38,8477220,Nate Schmidt,D,WPG,33,82,3,12,15
38,8479369,Andrew Peeke,D,BOS,26,82,2,13,15
38,8479983,Mario Ferraro,D,SJS,26,82,1,14,15
38,8482737,Zack Bolduc,C,STL,21,82,8,6,14
38,8475842,Sam Carrick,C,EDM,32,82,7,7,14
38,8482166,Shakir Mukhamadullin,D,SJS,22,82,6,8,14
38,8478831,Kevin Stenlund,C,FLA,28,82,5,9,14
38,8476422,Mike Reilly,D,NYI,31,82,4,10,14
38,8475233,David Savard,D,MTL,34,82,4,10,14
38,8474013,Ian Cole,D,VAN,35,82,4,10,14
38,8482712,Oskar Olausson,R,COL,22,82,3,11,14
38,8484911,Collin Graf,R,SJS,22,82,2,12,14
38,8478408,Travis Dermott,D,ARI,28,82,2,12,14
38,8480035,Henri Jokiharju,D,BUF,25,82,0,14,14
38,8476822,Luke Glendening,C,TBL,35,82,7,6,13
38,8473453,Trevor Lewis,C,LAK,37,82,6,7,13
38,8480980,Connor Dewar,C,TOR,25,82,4,9,13
38,8476473,Connor Murphy,D,CHI,31,82,4,9,13
38,8478882,Vladislav Gavrikov,D,LAK,29,82,3,10,13
38,8474567,Zach Bogosian,D,MIN,34,82,2,11,13
38,8476372,Nick Seeler,D,PHI,31,82,2,11,13
38,8477353,Tyler Motte,C,TBL,29,82,8,4,12
38,8480990,Declan Chisholm,D,MIN,24,82,6,6,12
38,8479291,Kevin Rooney,C,CGY,31,82,6,6,12
38,8482858,Ryker Evans,D,SEA,23,82,3,9,12
38,8479442,Troy Stecher,D,EDM,30,82,0,12,12
38,8482666,Scott Morrow,D,CAR,22,82,5,6,11
38,8477845,Trevor van Riemsdyk,D,WSH,33,82,5,6,11
38,8477015,Connor Brown,R,EDM,30,82,4,7,11
38,8483763,Maksymilian Szuber,D,ARI,22,82,4,7,11
38,8475462,Radko Gudas,D,ANA,34,82,3,8,11
38,8474166,Alec Martinez,D,VGK,37,82,3,8,11
38,8475762,Derek Forbort,D,BOS,32,82,3,8,11
38,8477034,Jaycob Megna,D,CHI,32,82,2,9,11
38,8475208,Brian Dumoulin,D,SEA,33,82,2,9,11
38,8477335,Kyle Burroughs,D,SJS,29,82,2,9,11
38,8476915,Jujhar Khaira,L,MIN,30,82,6,4,10
38,8482713,Mackie Samoskevich,R,FLA,22,82,5,5,10
38,8476858,Phillip Di Giuseppe,L,VAN,31,82,4,6,10
38,8483489,Fraser Minten,C,TOR,31,82,3,7,10
38,8477369,Carson Soucy,D,VAN,30,82,2,8,10
38,8482807,Ethan Del Mastro,D,CHI,21,82,2,8,10
38,8482859,Zack Ostapchuk,C,OTT,21,82,1,9,10
38,8483565,Nick Blankenburg,D,CBJ,26,82,4,5,9
38,8482177,Marat Khusnutdinov,C,MIN,22,82,4,5,9
38,8475825,Jani Hakanpää,D,DAL,32,82,1,8,9
38,8481059,Scott Perunovich,D,STL,26,82,1,8,9
38,8476624,Barclay Goodrow,C,NYR,31,82,4,4,8
38,8484149,Gavin Brindley,C,CBJ,20,82,1,7,8
38,8481599,Victor Soderstrom,D,ARI,23,82,0,8,8
38,8481030,Jack St. Ivany,D,PIT,25,82,3,4,7
38,8483468,Jiri Kulich,C,BUF,20,82,2,4,6
38,8478451,Ethan Bear,D,WSH,27,82,1,5,6
38,8482141,Lukas Cormier,D,VGK,22,0,0,0,0
38,8476988,Matt Benning,D,SJS,30,0,0,0,0
38,8480727,Zach Whitecloud,D,VGK,28,0,0,0,0
38,8480887,Jordan Harris,D,MTL,24,0,0,0,0
38,8478450,Parker Wotherspoon,D,BOS,27,0,0,0,0
38,8481812,Nikolai Knyzhov,D,SJS,27,0,0,0,0
38,8480001,Urho Vaakanainen,D,ANA,25,0,0,0,0
38,8482176,Wyatt Kaiser,D,CHI,22,0,0,0,0
38,8481122,Simon Benoit,D,TOR,26,0,0,0,0
38,8476441,Joel Edmundson,D,TOR,31,0,0,0,0
38,8480884,Calen Addison,D,SJS,24,0,0,0,0
38,8482511,Mason Lohrei,D,BOS,23,0,0,0,0
38,8482192,Isaak Phillips,D,CHI,23,0,0,0,0
38,8480950,Ilya Lyubushkin,D,TOR,30,0,0,0,0
38,8474031,Kevin Shattenkirk,D,BOS,35,0,0,0,0
38,8475718,Justin Holl,D,DET,32,0,0,0,0
38,8479402,Jake Bean,D,CBJ,26,0,0,0,0
38,8474602,Justin Schultz,D,SEA,34,0,0,0,0
38,8477950,Tony DeAngelo,D,CAR,29,0,0,0,0
38,8481743,Marc Del Gaizo,D,NSH,25,0,0,0,0
38,8481527,Kaedan Korczak,D,VGK,23,0,0,0,0
38,8480192,Johnathan Kovacevic,D,MTL,27,0,0,0,0
38,8476874,Olli Maatta,D,DET,30,0,0,0,0
38,8482144,Jack Thompson,D,SJS,22,0,0,0,0
38,8480222,Sebastian Aho,D,NYI,28,0,0,0,0
38,8479458,Nikita Zaitsev,D,CHI,33,0,0,0,0
38,8471709,Marc-Edouard Vlasic,D,SJS,37,0,0,0,0
38,8482929,Emil Lilleberg,D,TBL,23,0,0,0,0
38,8477018,Ben Hutton,D,VGK,31,0,0,0,0
38,8481056,Spencer Stastney,D,NSH,24,0,0,0,0
38,8481593,Jayden Struble,D,MTL,23,0,0,0,0
38,8479982,Conor Timmins,D,TOR,26,0,0,0,0
38,8474090,Brendan Smith,D,NJD,35,0,0,0,0
38,8482964,Arber Xhekaj,D,MTL,23,0,0,0,0
38,8480891,Michael Kesselring,D,ARI,24,0,0,0,0
38,8477938,Haydn Fleury,D,TBL,28,0,0,0,0
38,8481806,Louis Crevier,D,CHI,23,0,0,0,0
38,8471274,Alex Goligoski,D,MIN,39,0,0,0,0
38,8481600,Tobias Bjornfot,D,FLA,23,0,0,0,0
38,8475797,Jarred Tinordi,D,CHI,32,0,0,0,0
38,8481521,Ronnie Attard,D,PHI,25,0,0,0,0
38,8474612,Travis Hamonic,D,OTT,34,0,0,0,0
38,8479576,Vincent Desharnais,D,EDM,28,0,0,0,0
38,8480049,Dylan Samberg,D,WPG,25,0,0,0,0
38,8483619,Filip Roos,D,CHI,25,0,0,0,0
38,8474568,Luke Schenn,D,NSH,35,0,0,0,0
38,8480184,Gustav Lindstrom,D,ANA,26,0,0,0,0
38,8480070,Ian Mitchell,D,BOS,25,0,0,0,0
38,8480196,Jacob Bryson,D,BUF,27,0,0,0,0
38,8471686,Marc Staal,D,PHI,37,0,0,0,0
38,8477467,Gustav Olofsson,D,SEA,30,0,0,0,0
38,8478970,Jalen Chatfield,D,CAR,28,0,0,0,0
38,8479348,Kale Clague,D,BUF,26,0,0,0,0
38,8473446,Erik Johnson,D,PHI,36,0,0,0,0
38,8477462,Robert Hagg,D,ANA,29,0,0,0,0
38,8478454,Noah Juulsen,D,VAN,27,0,0,0,0
38,8477384,Josh Brown,D,ARI,30,0,0,0,0
38,8481708,Zac Jones,D,NYR,24,0,0,0,0
38,8481167,Brayden Pachal,D,CGY,25,0,0,0,0
38,8482067,Connor Mackey,D,NYR,28,0,0,0,0
38,8483460,David Jiricek,D,CBJ,21,0,0,0,0
38,8481701,Santeri Hatakka,D,NJD,23,0,0,0,0
38,8478021,William Lagesson,D,ANA,28,0,0,0,0
38,8477851,Jordan Oesterle,D,CGY,32,0,0,0,0
38,8478452,Caleb Jones,D,COL,27,0,0,0,0
38,8479984,Cal Foote,D,NJD,26,0,0,0,0
38,8479639,Dylan Coghlan,D,CAR,26,0,0,0,0
38,8480874,Adam Ginning,D,PHI,24,0,0,0,0
38,8479321,Lucas Johansen,D,WSH,27,0,0,0,0
38,8480878,Nils Lundkvist,D,DAL,24,0,0,0,0
38,8482165,Yan Kuznetsov,D,CGY,22,0,0,0,0
38,8484258,Sam Malinski,D,COL,26,0,0,0,0
38,8480157,Calle Rosen,D,STL,30,0,0,0,0
38,8484304,Uvis Balinskis,D,FLA,28,0,0,0,0
38,8479985,Cale Fleury,D,SEA,26,0,0,0,0
38,8479378,Logan Stanley,D,WPG,26,0,0,0,0
38,8477541,Dakota Mermis,D,MIN,30,0,0,0,0
38,8481609,Vladislav Kolyachonok,D,ARI,23,0,0,0,0
38,8480823,Alexander Alexeyev,D,WSH,25,0,0,0,0
38,8481679,Maxence Guenette,D,OTT,23,0,0,0,0
38,8481564,Ryan Johnson,D,BUF,23,0,0,0,0
38,8479376,Victor Mete,D,PHI,26,0,0,0,0
38,8484254,Akito Hirose,D,VAN,25,0,0,0,0
38,8482660,Kent Johnson,C,CBJ,22,0,0,0,0
38,8482149,Cole Perfetti,C,WPG,22,0,0,0,0
38,8477987,Ryan Donato,C,CHI,28,0,0,0,0
38,8475755,Alexander Petrovic,D,DAL,32,0,0,0,0
38,8477810,Joel Hanley,D,CGY,33,0,0,0,0
38,8474145,Robert Bortuzzo,D,NYI,35,0,0,0,0
38,8481161,Jake Christiansen,D,CBJ,25,0,0,0,0
38,8476884,Derrick Pouliot,D,DAL,30,0,0,0,0
38,8481716,Dmitri Voronkov,L,CBJ,24,0,0,0,0
38,8480084,Nick DeSimone,D,NJD,30,0,0,0,0
38,8475750,Jon Merrill,D,MIN,32,0,0,0,0
38,8479315,Joey Anderson,R,CHI,26,0,0,0,0
38,8478011,Louie Belpedio,D,PHI,28,0,0,0,0
38,8482451,Mikael Pyyhtia,L,CBJ,23,0,0,0,0
38,8481541,Samuel Bolduc,D,NYI,24,0,0,0,0
38,8482126,Emil Andrae,D,PHI,31,0,0,0,0
38,8474618,Marco Scandella,D,STL,34,0,0,0,0
38,8477244,Chad Ruhwedel,D,NYR,34,0,0,0,0
38,8477971,Andreas Englund,D,LAK,28,0,0,0,0
38,8480829,Jesperi Kotkaniemi,C,CAR,24,0,0,0,0
38,8479372,Josh Mahura,D,FLA,26,0,0,0,0
38,8482095,Tyler Kleven,D,OTT,22,0,0,0,0
38,8481719,Maxwell Crozier,D,TBL,24,0,0,0,0
38,8475855,Jesper Fast,R,CAR,33,0,0,0,0
38,8480848,Ty Dellandrea,C,DAL,24,0,0,0,0
38,8475193,Tomas Tatar,L,SEA,34,0,0,0,0
38,8476889,Radek Faksa,C,DAL,30,0,0,0,0
38,8478495,Denis Gurianov,R,PHI,27,0,0,0,0
38,8480216,Jacob Peterson,C,SJS,25,0,0,0,0
38,8480252,Cole Guttman,C,CHI,25,0,0,0,0
38,8479026,Philippe Myers,D,TBL,27,0,0,0,0
38,8481006,Tyler Tucker,D,STL,24,0,0,0,0
38,8481032,Paul Cotter,C,VGK,25,0,0,0,0
38,8481577,Philip Tomasino,C,NSH,23,0,0,0,0
38,8476918,Jimmy Vesey,L,NYR,31,0,0,0,0
38,8479320,Max Lajoie,D,TOR,27,0,0,0,0
38,8478017,Mark Friedman,D,VAN,29,0,0,0,0
38,8481754,Nikita Nesterenko,C,ANA,23,0,0,0,0
38,8483407,Brandon Scanlin,D,NYR,25,0,0,0,0
38,8482659,Josh Doan,R,ARI,22,0,0,0,0
38,8477446,Michael McCarron,R,NSH,29,0,0,0,0
38,8477903,Garnet Hathaway,R,PHI,33,0,0,0,0
38,8482153,Brendan Brisson,C,VGK,23,0,0,0,0
38,8483546,Marshall Rifai,D,TOR,26,0,0,0,0
38,8484287,Cole McWard,D,VAN,23,0,0,0,0
38,8478854,Ryan Shea,D,PIT,27,0,0,0,0
38,8481585,Egor Afanasyev,L,NSH,23,0,0,0,0
38,8483398,Declan Carlile,D,TBL,31,0,0,0,0
38,8478502,Dennis Gilbert,D,CGY,28,0,0,0,0
38,8482749,Joshua Roy,R,MTL,21,0,0,0,0
38,8481598,Philip Broberg,D,EDM,23,0,0,0,0
38,8480835,Jack Drury,C,CAR,24,0,0,0,0
38,8480748,Kiefer Sherwood,L,NSH,29,0,0,0,0
38,8476934,Brock McGinn,L,ANA,30,0,0,0,0
38,8480870,Bo Groulx,C,ANA,24,0,0,0,0
38,8479368,Max Jones,L,ANA,26,0,0,0,0
38,8478099,Kevin Labanc,R,SJS,29,0,0,0,0
38,8478067,Oskar Lindblom,L,SJS,28,0,0,0,0
38,8476393,Nick Cousins,C,FLA,31,0,0,0,0
38,8483395,Arshdeep Bains,L,VAN,23,0,0,0,0
38,8480762,Eric Robinson,L,BUF,29,0,0,0,0
38,8479439,Jacob MacDonald,D,SJS,31,0,0,0,0
38,8476474,Stefan Noesen,R,CAR,31,0,0,0,0
38,8482787,Nikita Chibrikov,R,WPG,31,0,0,0,0
38,8478432,Christian Fischer,R,DET,27,0,0,0,0
38,8477979,Nicolas Aube-Kubel,R,WSH,28,0,0,0,0
38,8481789,Tye Kartye,L,SEA,23,0,0,0,0
38,8479330,Brandon Gignac,C,MTL,27,0,0,0,0
38,8480075,Cameron Crotty,D,ARI,25,0,0,0,0
38,8473473,Milan Lucic,L,BOS,36,0,0,0,0
38,8482094,Daemon Hunt,D,MIN,22,0,0,0,0
38,8481206,John Ludvig,D,PIT,24,0,0,0,0
38,8483630,Pavol Regenda,L,ANA,25,0,0,0,0
38,8481617,Vasily Podkolzin,R,VAN,23,0,0,0,0
38,8480306,Grant Hutton,D,NYI,29,0,0,0,0
38,8480995,Pontus Holmberg,R,TOR,25,0,0,0,0
38,8482148,Hendrix Lapierre,C,WSH,22,0,0,0,0
38,8477478,William Carrier,L,VGK,30,0,0,0,0
38,8480003,Jesper Boqvist,C,BOS,26,0,0,0,0
38,8482172,Landon Slaggert,L,CHI,22,0,0,0,0
38,8480789,Oliver Wahlstrom,R,NYI,24,0,0,0,0
38,8474062,Riley Nash,C,NYR,35,0,0,0,0
38,8480021,Jack Studnicka,C,SJS,25,0,0,0,0
38,8480025,MacKenzie Entwistle,R,CHI,25,0,0,0,0
38,8481582,Nicholas Robertson,L,TOR,23,0,0,0,0
38,8476867,Brendan Gaunce,C,CBJ,30,0,0,0,0
38,8479619,Michael Carcone,L,ARI,28,0,0,0,0
38,8479370,Tyson Jost,C,BUF,26,0,0,0,0
38,8479671,Mathieu Olivier,R,CBJ,27,0,0,0,0
38,8476994,Vinnie Hinostroza,C,PIT,30,0,0,0,0
38,8482070,Mitchell Chaffee,R,TBL,26,0,0,0,0
38,8477473,Justin Bailey,R,SJS,29,0,0,0,0
38,8479344,Jesse Puljujarvi,R,PIT,26,0,0,0,0
38,8480205,Emil Bemstrom,C,PIT,25,0,0,0,0
38,8479718,Alex Barré-Boulet,C,TBL,27,0,0,0,0
38,8482061,Brandon Biro,L,BUF,26,0,0,0,0
38,8479638,Justin Brazeau,R,BOS,26,0,0,0,0
38,8474040,Sam Gagner,C,EDM,35,0,0,0,0
38,8477846,Ryan Carpenter,C,SJS,33,0,0,0,0
38,8482077,Dylan Holloway,L,EDM,23,0,0,0,0
38,8482157,Will Cuylle,L,NYR,22,0,0,0,0
38,8480007,Jonas Rondbjerg,R,VGK,25,0,0,0,0
38,8478874,Adam Gaudette,C,STL,28,0,0,0,0
38,8478434,Keegan Kolesar,R,VGK,27,0,0,0,0
38,8480441,Trey Fix-Wolansky,R,CBJ,25,0,0,0,0
38,8479994,Jaret Anderson-Dolan,C,NSH,25,0,0,0,0
38,8483567,Georgii Merkulov,C,BOS,24,0,0,0,0
38,8477380,Jonny Brodzinski,C,NYR,31,0,0,0,0
38,8482201,Gage Goncalves,C,TBL,23,0,0,0,0
38,8478211,Dryden Hunt,L,CGY,29,0,0,0,0
38,8471699,Andrew Cogliano,C,COL,37,0,0,0,0
38,8479421,Jacob Moverare,D,LAK,26,0,0,0,0
38,8478881,Brett Seney,L,CHI,28,0,0,0,0
38,8477464,Nic Petan,C,MIN,29,0,0,0,0
38,8475958,Michael Sgarbossa,C,WSH,32,0,0,0,0
38,8481147,Reese Johnson,C,CHI,26,0,0,0,0
38,8479336,Carl Grundstrom,R,LAK,27,0,0,0,0
38,8480853,Liam Foudy,C,NSH,24,0,0,0,0
38,8479522,Hardy Haman Aktell,D,WSH,26,0,0,0,0
38,8481462,Mason Morelli,L,VGK,28,0,0,0,0
38,8482102,Vasily Ponomarev,C,CAR,22,0,0,0,0
38,8480844,Grigori Denisenko,L,VGK,24,0,0,0,0
38,8479944,Zach Aston-Reese,C,DET,30,0,0,0,0
38,8482784,Zach Dean,C,STL,21,0,0,0,0
38,8479419,Brett Murray,L,BUF,26,0,0,0,0
38,8479520,Brandon Duhaime,R,COL,27,0,0,0,0
38,8477573,Nathan Walker,L,STL,30,0,0,0,0
38,8478078,Rourke Chartier,C,OTT,28,0,0,0,0
38,8475795,Dylan McIlrath,D,WSH,32,0,0,0,0
38,8482496,Nils Aman,C,VAN,24,0,0,0,0
38,8480289,Morgan Barron,C,WPG,26,0,0,0,0
38,8481751,Lukas Rousek,R,BUF,25,0,0,0,0
38,8480011,Klim Kostin,C,SJS,25,0,0,0,0
38,8481556,John Beecher,C,BOS,23,0,0,0,0
38,8475278,Byron Froese,C,VGK,33,0,0,0,0
38,8475225,Craig Smith,C,DAL,35,0,0,0,0
38,8484326,Patrik Koch,D,ARI,28,0,0,0,0
38,8477930,Pierre-Edouard Bellemare,L,SEA,39,0,0,0,0
38,8478409,Anthony Richard,C,BOS,28,0,0,0,0
38,8481024,Linus Karlsson,C,VAN,25,0,0,0,0
38,8479986,Kole Lind,R,SEA,26,0,0,0,0
38,8479414,Nathan Bastian,R,NJD,27,0,0,0,0
38,8479362,Riley Tufte,L,COL,26,0,0,0,0
38,8481058,Jesse Ylönen,R,MTL,25,0,0,0,0
38,8482476,Emil Heineman,L,MTL,23,0,0,0,0
38,8482861,Vincent Iorio,D,WSH,22,0,0,0,0
38,8483432,Luca Del Bel Belluz,C,CBJ,31,0,0,0,0
38,8482744,James Malatesta,L,CBJ,21,0,0,0,0
38,8477887,Patrick Brown,C,BOS,32,0,0,0,0
38,8478585,Derek Ryan,C,EDM,38,0,0,0,0
38,8481441,Joe Snively,C,WSH,28,0,0,0,0
38,8481592,Jakob Pelletier,L,CGY,23,0,0,0,0
38,8482634,Alex Steeves,C,TOR,25,0,0,0,0
38,8477126,Jayson Megna,C,BOS,34,0,0,0,0
38,8475752,Tyler Pitlick,C,NYR,33,0,0,0,0
38,8480008,Adam Ruzicka,C,ARI,25,0,0,0,0
38,8481065,Angus Crookshank,L,OTT,25,0,0,0,0
38,8479547,Matthew Phillips,R,WSH,26,0,0,0,0
38,8480226,Marián Studenic,R,SEA,26,0,0,0,0
38,8481237,Kyle MacLean,C,NYI,25,0,0,0,0
38,8475413,Justin Dowling,C,NJD,34,0,0,0,0
38,8481641,Joel Kiviranta,L,COL,28,0,0,0,0
38,8478104,Sammy Blais,L,STL,28,0,0,0,0
38,8477454,Adam Erne,L,EDM,29,0,0,0,0
38,8481518,Nolan Foote,L,NJD,24,0,0,0,0
38,8480245,Olle Lycksell,R,PHI,25,0,0,0,0
38,8483570,Ben Meyers,C,ANA,26,0,0,0,0
38,8480776,Sheldon Rempal,R,VGK,29,0,0,0,0
38,8483920,Pierrick Dube,R,WSH,23,0,0,0,0
38,8480267,Sammy Walker,C,MIN,25,0,0,0,0
38,8482747,Brennan Othmann,L,NYR,21,0,0,0,0
38,8479991,Jake Leschyshyn,C,NYR,25,0,0,0,0
38,8478400,Colin White,C,MTL,27,0,0,0,0
38,8479328,Julien Gauthier,R,NYI,27,0,0,0,0
38,8484325,Waltteri Merela,C,TBL,26,0,0,0,0
38,8479066,Ryan Lomberg,L,FLA,30,0,0,0,0
38,8477070,Liam O'Brien,C,ARI,30,0,0,0,0
38,8478146,Matthew Highmore,C,OTT,28,0,0,0,0
38,8478028,Fredrik Olofsson,L,COL,28,0,0,0,0
38,8480880,Jakub Lauko,C,BOS,24,0,0,0,0
38,8479968,Vinni Lettieri,C,MIN,29,0,0,0,0
38,8474709,Matt Martin,L,NYI,35,0,0,0,0
38,8480845,Rasmus Kupari,C,WPG,24,0,0,0,0
38,8481550,Adam Beckman,L,MIN,23,0,0,0,0
38,8481422,Jacob Lucchini,C,MIN,29,0,0,0,0
38,8477401,John Hayden,C,SEA,29,0,0,0,0
38,8478904,Steven Lorentz,C,FLA,28,0,0,0,0
38,8482088,Justin Sourdif,R,FLA,22,0,0,0,0
38,8482751,Ryan Winterton,C,SEA,21,0,0,0,0
38,8482241,Radim Zohorna,L,PIT,28,0,0,0,0
38,8481690,Tyler Angle,C,CBJ,24,0,0,0,0
38,8476952,Dominic Toninato,C,WPG,30,0,0,0,0
38,8476919,Chris Tierney,C,NJD,30,0,0,0,0
38,8480032,Shane Bowers,C,NJD,25,0,0,0,0
38,8484314,Jiri Smejkal,L,OTT,28,0,0,0,0
38,8481239,Samuel Fagemo,L,LAK,24,0,0,0,0
38,8481532,Alex Turcotte,C,LAK,23,0,0,0,0
38,8481019,David Gustafsson,C,WPG,24,0,0,0,0
38,8478477,Mitchell Stephens,C,MTL,27,0,0,0,0
38,8479546,Oskar Steen,C,BOS,26,0,0,0,0
38,8480292,Carson Meyer,R,CBJ,27,0,0,0,0
38,8478446,Glenn Gawdin,C,ANA,27,0,0,0,0
38,8483531,Brian Halonen,L,NJD,25,0,0,0,0
38,8477149,Scott Sabourin,R,SJS,32,0,0,0,0
38,8479972,Mason Shaw,C,MIN,26,0,0,0,0
38,8480890,Jan Jenik,R,ARI,24,0,0,0,0
38,8478051,Max Willman,C,NJD,29,0,0,0,0
38,8480851,Akil Thomas,C,LAK,24,0,0,0,0
38,8482765,Isak Rosen,R,BUF,21,0,0,0,0
38,8478421,A.J. Greer,L,CGY,28,0,0,0,0
38,8478512,Austin Czarnik,C,DET,32,0,0,0,0
38,8479536,Axel Jonsson-Fjallby,L,WPG,26,0,0,0,0
38,8477320,Anton Blidh,L,NYR,29,0,0,0,0
38,8481543,Nikita Alexandrov,C,STL,24,0,0,0,0
38,8475235,Nicolas Deslauriers,L,PHI,33,0,0,0,0
38,8481070,Hugh McGing,L,STL,26,0,0,0,0
38,8480836,Jonathan Gruden,C,PIT,24,0,0,0,0
38,8481591,Sam Poulin,R,PIT,23,0,0,0,0
38,8477962,Brendan Lemieux,L,CAR,28,0,0,0,0
38,8483401,Marc Johnstone,R,PIT,28,0,0,0,0
38,8482250,Callahan Burke,C,CAR,27,0,0,0,0
38,8481726,Adam Edstrom,C,NYR,24,0,0,0,0
38,8471817,Ryan Reaves,R,TOR,37,0,0,0,0
38,8479587,Rhett Gardner,C,PHI,28,0,0,0,0
38,8475766,Austin Watson,L,TBL,32,0,0,0,0
38,8479367,William Lockwood,R,FLA,26,0,0,0,0
38,8478424,Jansen Harkins,C,PIT,27,0,0,0,0
38,8476913,Devin Shore,C,SEA,30,0,0,0,0
38,8482652,Walker Duehr,R,CGY,27,0,0,0,0
38,8477527,Ross Johnston,L,ANA,30,0,0,0,0
38,8481077,John Leonard,L,ARI,26,0,0,0,0
38,8483549,Lucas Condotta,L,MTL,27,0,0,0,0
38,8480468,James Hamblin,L,EDM,25,0,0,0,0
38,8476907,Mackenzie MacEachern,L,STL,30,0,0,0,0
38,8479543,Michael Pezzetta,L,MTL,26,0,0,0,0
38,8480355,Mark Kastelic,C,OTT,25,0,0,0,0
38,8482162,Roby Jarventie,L,OTT,22,0,0,0,0
38,8479772,Zack MacEwen,R,OTT,28,0,0,0,0
38,8483597,Milos Kelemen,L,ARI,25,0,0,0,0
38,8479379,Givani Smith,R,SJS,26,0,0,0,0
38,8481655,Cole Schwindt,R,CGY,23,0,0,0,0
38,8479981,Jonah Gadjovich,L,FLA,26,0,0,0,0
38,8482147,Jean-Luc Foudy,C,COL,22,0,0,0,0
38,8484255,Jason Polin,R,COL,25,0,0,0,0
38,8477993,Justin Kirkland,C,ARI,28,0,0,0,0
38,8479249,Andrew Poturalski,C,SEA,30,0,0,0,0
38,8482197,Adam Raska,R,MIN,23,0,0,0,0
38,8475780,Chris Wagner,R,COL,33,0,0,0,0
38,8479533,Joona Koppanen,L,PIT,26,0,0,0,0
38,8481534,Raphael Lavoie,C,EDM,24,0,0,0,0
38,8484321,Nikolas Matinpalo,D,OTT,26,0,0,0,0
38,8481043,Cole Koepke,L,TBL,26,0,0,0,0
38,8476323,Max McCormick,L,SEA,32,0,0,0,0
38,8483609,Adam Klapka,R,CGY,24,0,0,0,0
38,8483512,Matt Savoie,C,BUF,20,0,0,0,0
38,8484259,Ondrej Pavel,C,COL,31,0,0,0,0
38,8478147,Bokondji Imama,L,OTT,28,0,0,0,0
38,8482460,Matt Rempe,C,NYR,22,0,0,0,0
38,8477073,Kurtis MacDermid,L,NJD,30,0,0,0,0
38,8480274,Philip Kemp,D,EDM,25,0,0,0,0
38,8478956,Samuel Laberge,L,NJD,27,0,0,0,0
38,8483045,Cameron Butler,R,CBJ,31,0,0,0,0
39,8476453,Nikita Kucherov,R,TBL,31,82,43,95,138
39,8478402,Connor McDavid,C,EDM,27,82,33,79,112
39,8477492,Nathan MacKinnon,C,COL,29,82,45,65,110
39,8477934,Leon Draisaitl,C,EDM,29,82,35,75,110
39,8479314,Matthew Tkachuk,L,FLA,27,82,29,77,106
39,8480027,Jason Robertson,L,DAL,25,82,43,61,104
39,8478010,Brayden Point,C,TBL,28,82,55,48,103
39,8477404,Jake Guentzel,C,CAR,30,82,43,57,100
39,8481559,Jack Hughes,C,NJD,23,82,35,63,98
39,8479318,Auston Matthews,C,TOR,27,82,59,37,96
39,8477956,David Pastrnak,R,BOS,28,82,41,54,95
39,8476468,J.T. Miller,C,VAN,31,82,30,65,95
39,8478420,Mikko Rantanen,R,COL,28,82,45,46,91
39,8477939,William Nylander,R,TOR,28,82,44,47,91
39,8482116,Tim Stützle,C,OTT,22,82,28,60,88
39,8471675,Sidney Crosby,C,PIT,37,82,30,56,86
39,8480801,Brady Tkachuk,L,OTT,25,82,41,42,83
39,8481557,Matt Boldy,L,MIN,23,82,32,50,82
39,8476887,Filip Forsberg,L,NSH,30,82,39,41,80
39,8480800,Quinn Hughes,D,VAN,25,82,18,61,79
39,8479343,Clayton Keller,R,ARI,26,82,33,45,78
39,8480012,Elias Pettersson,C,VAN,26,82,28,50,78
39,8479323,Adam Fox,D,NYR,26,82,20,58,78
39,8473512,Claude Giroux,R,OTT,36,82,31,46,77
39,8478864,Kirill Kaprizov,L,MIN,27,82,29,48,77
39,8478550,Artemi Panarin,L,NYR,33,82,24,53,77
39,8477942,Kevin Fiala,L,LAK,28,82,27,49,76
39,8478427,Sebastian Aho,C,CAR,27,82,26,50,76
39,8475166,John Tavares,C,TOR,34,82,33,42,75
39,8480002,Nico Hischier,C,NJD,25,82,33,42,75
39,8478439,Travis Konecny,R,PHI,27,82,25,50,75
39,8476346,Johnny Gaudreau,L,CBJ,31,82,23,52,75
39,8478414,Timo Meier,R,NJD,28,82,42,32,74
39,8481523,Kirby Dach,C,MTL,23,82,15,59,74
39,8478493,Joel Eriksson Ek,C,MIN,27,82,34,39,73
39,8478440,Dylan Strome,C,WSH,27,82,31,42,73
39,8477933,Sam Reinhart,C,FLA,29,82,30,43,73
39,8474564,Steven Stamkos,C,TBL,34,82,28,45,73
39,8477493,Aleksander Barkov,C,FLA,29,82,32,40,72
39,8477946,Dylan Larkin,C,DET,28,82,30,42,72
39,8471215,Evgeni Malkin,C,PIT,38,82,27,45,72
39,8474600,Roman Josi,D,NSH,34,82,19,53,72
39,8480069,Cale Makar,D,COL,26,82,18,54,72
39,8477504,Josh Morrissey,D,WPG,29,82,16,56,72
39,8476459,Mika Zibanejad,C,NYR,31,82,22,49,71
39,8471685,Anze Kopitar,C,LAK,37,82,19,52,71
39,8478398,Kyle Connor,L,WPG,28,82,31,39,70
39,8478445,Mathew Barzal,C,NYI,27,82,22,48,70
39,8480803,Evan Bouchard,D,EDM,25,82,16,54,70
39,8475786,Zach Hyman,L,EDM,32,82,41,28,69
39,8479420,Tage Thompson,C,BUF,27,82,41,28,69
39,8477409,Carter Verhaeghe,C,FLA,29,82,36,33,69
39,8477501,Valeri Nichushkin,R,COL,29,82,32,37,69
39,8477949,Alex Tuch,R,BUF,28,82,32,37,69
39,8475810,Bryan Rust,R,PIT,32,82,33,35,68
39,8475158,Ryan O'Reilly,C,NSH,33,82,18,50,68
39,8478444,Brock Boeser,R,VAN,27,82,32,35,67
39,8475765,Vladimir Tarasenko,R,FLA,33,82,28,39,67
39,8477960,Adrian Kempe,R,LAK,28,82,35,31,66
39,8480830,Andrei Svechnikov,R,CAR,24,82,31,35,66
39,8474590,John Carlson,D,WSH,34,82,18,48,66
39,8475167,Victor Hedman,D,TBL,34,82,10,56,66
39,8475168,Matt Duchene,C,DAL,33,82,31,34,65
39,8477951,Nick Schmaltz,C,ARI,28,82,26,39,65
39,8481533,Trevor Zegras,C,ANA,23,82,20,45,65
39,8478407,Vince Dunn,D,SEA,28,82,10,55,65
39,8476389,Vincent Trocheck,C,NYR,31,82,31,33,64
39,8479407,Jesper Bratt,L,NJD,26,82,27,37,64
39,8480208,Drake Batherson,R,OTT,26,82,26,38,64
39,8476454,Ryan Nugent-Hopkins,C,EDM,31,82,25,39,64
39,8478449,Roope Hintz,C,DAL,28,82,19,45,64
39,8476460,Mark Scheifele,C,WPG,31,82,31,32,63
39,8477955,Jared McCann,L,SEA,28,82,22,41,63
39,8477402,Pavel Buchnevich,L,STL,29,82,32,30,62
39,8479385,Jordan Kyrou,C,STL,26,82,27,35,62
39,8474141,Patrick Kane,R,DET,36,82,23,39,62
39,8474679,Gustav Nyquist,C,NSH,35,82,22,40,62
39,8473419,Brad Marchand,L,BOS,36,82,21,41,62
39,8476882,Teuvo Teravainen,L,CAR,30,82,26,35,61
39,8478873,Troy Terry,R,ANA,27,82,18,43,61
39,8475754,Brock Nelson,C,NYI,33,82,31,29,60
39,8479542,Brandon Hagel,L,TBL,26,82,26,34,60
39,8474586,Jordan Eberle,R,SEA,34,82,22,38,60
39,8480039,Martin Necas,C,CAR,25,82,19,41,60
39,8471214,Alex Ovechkin,L,WSH,39,82,27,32,59
39,8473994,Jamie Benn,L,DAL,35,82,25,34,59
39,8482665,Matty Beniers,C,SEA,22,82,20,39,59
39,8480839,Rasmus Dahlin,D,BUF,24,82,19,40,59
39,8482684,Luke Hughes,D,NJD,21,82,17,42,59
39,8478047,Michael Bunting,L,PIT,29,82,17,42,59
39,8480865,Noah Dobson,D,NYI,24,82,9,50,59
39,8479337,Alex DeBrincat,R,DET,27,82,29,29,58
39,8480018,Nick Suzuki,C,MTL,25,82,20,38,58
39,8476462,Dougie Hamilton,D,NJD,31,82,14,44,58
39,8475726,Tyler Toffoli,C,WPG,32,82,29,28,57
39,8478403,Jack Eichel,C,VGK,28,82,27,30,57
39,8477500,Bo Horvat,C,NYI,29,82,24,33,57
39,8479339,Patrik Laine,L,CBJ,26,82,22,35,57
39,8475170,Brayden Schenn,C,STL,33,82,20,37,57
39,8475798,Mikael Granlund,C,SJS,32,82,15,42,57
39,8475692,Mats Zuccarello,R,MIN,37,82,20,36,56
39,8481711,Matias Maccelli,L,ARI,24,82,19,37,56
39,8476905,Chandler Stephenson,C,VGK,30,82,19,37,56
39,8478519,Anthony Cirelli,C,TBL,27,82,19,37,56
39,8482078,Lucas Raymond,L,DET,22,82,17,39,56
39,8480031,Maxime Comtois,L,CAR,25,82,15,41,56
39,8475172,Nazem Kadri,C,CGY,34,82,21,34,55
39,8480064,Josh Norris,C,OTT,25,82,31,23,54
39,8475151,Kyle Palmieri,C,NYI,33,82,30,24,54
39,8477476,Artturi Lehkonen,L,COL,29,82,29,25,54
39,8480023,Robert Thomas,C,STL,25,82,16,38,54
39,8478975,Mason Marchment,L,DAL,29,82,16,38,54
39,8476906,Shayne Gostisbehere,D,DET,31,82,7,47,54
39,8480036,Miro Heiskanen,D,DAL,25,82,5,49,54
39,8480434,Sean Durzi,D,ARI,26,82,22,31,53
39,8477479,Tyler Bertuzzi,L,TOR,29,82,20,33,53
39,8476456,Jonathan Huberdeau,C,CGY,31,82,15,38,53
39,8477447,Shea Theodore,D,VGK,29,82,13,40,53
39,8477496,Elias Lindholm,C,VAN,30,82,25,27,52
39,8477940,Nikolaj Ehlers,L,WPG,28,82,24,28,52
39,8479999,Casey Mittelstadt,C,COL,26,82,17,35,52
39,8478038,Devon Toews,D,COL,30,82,12,40,52
39,8480015,Owen Tippett,R,PHI,25,82,26,25,51
39,8474157,Max Pacioretty,L,WSH,36,82,26,25,51
39,8475722,Jason Zucker,L,NSH,32,82,26,25,51
39,8474150,Mikael Backlund,C,CGY,35,82,19,32,51
39,8475184,Chris Kreider,L,NYR,33,82,32,18,50
39,8480188,Fabian Zetterlund,L,SJS,25,82,28,22,50
39,8477407,Anthony Duclair,L,TBL,29,82,27,23,50
39,8484144,Connor Bedard,C,CHI,19,82,24,26,50
39,8482159,Tyson Foerster,R,PHI,22,82,24,26,50
39,8475169,Evander Kane,L,EDM,33,82,22,28,50
39,8475745,Charlie Coyle,C,BOS,32,82,21,29,50
39,8482055,Drew O'Connor,L,PIT,26,82,22,27,49
39,8479675,Trevor Moore,L,LAK,29,82,21,28,49
39,8475913,Mark Stone,R,VGK,32,82,21,28,49
39,8478401,Pavel Zacha,C,BOS,27,82,20,29,49
39,8474563,Drew Doughty,D,LAK,35,82,13,36,49
39,8470613,Brent Burns,D,CAR,39,82,11,38,49
39,8476875,Mike Matheson,D,MTL,30,82,9,40,49
39,8478042,Viktor Arvidsson,R,LAK,31,82,26,22,48
39,8475768,Jaden Schwartz,C,SEA,32,82,22,26,48
39,8482740,Wyatt Johnston,C,DAL,21,82,21,27,48
39,8481596,Shane Pinto,C,OTT,24,82,16,32,48
39,8474578,Erik Karlsson,D,PIT,34,82,13,35,48
39,8482097,Jack Quinn,R,BUF,23,82,13,35,48
39,8478460,Zach Werenski,D,CBJ,27,82,11,37,48
39,8481540,Cole Caufield,R,MTL,23,82,30,17,47
39,8482699,Dylan Guenther,R,ARI,21,82,23,24,47
39,8481068,Yegor Sharangovich,C,CGY,26,82,19,28,47
39,8477416,Oliver Bjorkstrand,R,SEA,29,82,19,28,47
39,8477456,J.T. Compher,L,DET,29,82,16,31,47
39,8480798,Philipp Kurashev,C,CHI,25,82,15,32,47
39,8479410,Mikhail Sergachev,D,TBL,26,82,4,43,47
39,8476880,Tom Wilson,R,WSH,30,82,24,22,46
39,8475287,Erik Haula,L,NJD,33,82,23,23,46
39,8476869,Brady Skjei,D,CAR,30,82,19,27,46
39,8476479,Phillip Danault,C,LAK,31,82,19,27,46
39,8477497,Sean Monahan,C,WPG,30,82,14,32,46
39,8479325,Charlie McAvoy,D,BOS,27,82,5,41,46
39,8478366,Frank Vatrano,R,ANA,30,82,31,14,45
39,8475314,Anders Lee,L,NYI,34,82,24,21,45
39,8475784,Jeff Skinner,C,BUF,32,82,23,22,45
39,8476448,William Karlsson,C,VGK,31,82,21,24,45
39,8483808,Andrei Kuzmenko,L,CGY,28,82,20,25,45
39,8475794,Tyler Seguin,C,DAL,32,82,19,26,45
39,8479345,Jakob Chychrun,D,OTT,26,82,19,26,45
39,8470794,Joe Pavelski,C,DAL,40,82,17,28,45
39,8478469,Thomas Chabot,D,OTT,27,82,12,33,45
39,8482105,Jake Sanderson,D,OTT,22,82,12,33,45
39,8483445,Cutter Gauthier,L,ANA,20,82,11,34,45
39,8475744,Evgeny Kuznetsov,C,CAR,32,82,11,34,45
39,8474102,David Perron,L,DET,36,82,24,20,44
39,8480028,Morgan Frost,C,PHI,25,82,24,19,43
39,8482745,Mason McTavish,C,ANA,21,82,20,23,43
39,8482146,Luke Evangelista,R,NSH,22,82,15,28,43
39,8477935,Sam Bennett,C,FLA,28,82,13,30,43
39,8479425,Filip Hronek,D,VAN,27,82,10,33,43
39,8476958,Jaccob Slavin,D,CAR,30,82,4,39,43
39,8481699,Aku Raty,R,ARI,23,82,2,41,43
39,8483397,Marc McLaughlin,C,BOS,25,82,38,4,42
39,8476438,Brandon Saad,L,STL,32,82,24,18,42
39,8482089,Jake Neighbours,L,STL,22,82,24,18,42
39,8478233,Andrew Mangiapane,L,CGY,28,82,22,20,42
39,8480797,Joel Farabee,L,PHI,24,82,22,20,42
39,8476432,Boone Jenner,C,CBJ,31,82,22,20,42
39,8471698,T.J. Oshie,R,WSH,38,82,21,21,42
39,8476399,Blake Coleman,C,CGY,33,82,20,22,42
39,8482113,Anton Lundell,C,FLA,23,82,20,22,42
39,8477451,Ryan Hartman,R,MIN,30,82,18,24,42
39,8476329,Travis Boyd,C,ARI,31,82,15,27,42
39,8477494,Jonathan Drouin,L,COL,29,82,15,27,42
39,8482667,William Eklund,L,SJS,22,82,13,29,42
39,8476921,Jordan Martinook,L,CAR,32,82,12,30,42
39,8480220,Noah Cates,L,PHI,25,82,10,32,42
39,8477021,Alex Kerfoot,C,ARI,30,82,9,33,42
39,8478397,Rasmus Andersson,D,CGY,28,82,7,35,42
39,8475343,Nic Dowd,C,WSH,34,82,21,20,41
39,8476539,Jonathan Marchessault,R,VGK,34,82,20,21,41
39,8478057,Dakota Joshua,C,VAN,28,82,19,22,41
39,8480893,Kirill Marchenko,R,CBJ,24,82,18,23,41
39,8482093,Seth Jarvis,C,CAR,22,82,17,24,41
39,8476419,Jean-Gabriel Pageau,C,NYI,32,82,16,25,41
39,8478458,Jack Roslovic,C,NYR,27,82,14,27,41
39,8477346,MacKenzie Weegar,D,CGY,30,82,10,31,41
39,8477948,Travis Sanheim,D,PHI,28,82,10,31,41
39,8476792,Torey Krug,D,STL,33,82,10,31,41
39,8476853,Morgan Rielly,D,TOR,30,82,8,33,41
39,8481016,Ruslan Iskhakov,C,NYI,24,82,4,37,41
39,8480014,Gabriel Vilardi,C,WPG,25,82,25,15,40
39,8478474,Lawson Crouse,L,ARI,27,82,24,16,40
39,8482109,Alexis Lafrenière,L,NYR,23,82,22,18,40
39,8482110,Dawson Mercer,C,NJD,23,82,22,18,40
39,8483431,Logan Cooley,C,ARI,20,82,22,18,40
39,8476483,Rickard Rakell,R,PIT,31,82,21,19,40
39,8477426,Nicholas Paul,L,TBL,29,82,21,19,40
39,8480113,Alex Iafallo,L,WPG,31,82,20,20,40
39,8477429,Andrew Copp,C,DET,30,82,16,24,40
39,8478462,Nicolas Roy,C,VGK,27,82,15,25,40
39,8480078,Filip Chytil,C,NYR,25,82,10,30,40
39,8481581,Thomas Harley,D,DAL,23,82,9,31,40
39,8474053,Logan Couture,C,SJS,35,82,17,22,39
39,8475791,Taylor Hall,L,CHI,33,82,12,27,39
39,8477503,Max Domi,C,TOR,29,82,10,29,39
39,8481546,Cam York,D,PHI,23,82,10,29,39
39,8479400,Pierre-Luc Dubois,L,LAK,26,82,19,19,38
39,8477444,Andre Burakovsky,L,SEA,29,82,19,19,38
39,8474037,James van Riemsdyk,L,BOS,35,82,18,20,38
39,8482124,Quinton Byfield,R,LAK,22,82,17,21,38
39,8475191,Reilly Smith,R,PIT,33,82,17,21,38
39,8482222,Alexander Barabanov,L,SJS,30,82,17,21,38
39,8478438,Tommy Novak,C,NSH,27,82,17,21,38
39,8477932,Aaron Ekblad,D,FLA,28,82,14,24,38
39,8476458,Ryan Strome,C,ANA,31,82,14,24,38
39,8479987,Morgan Geekie,C,BOS,26,82,14,24,38
39,8476881,Tomas Hertl,C,VGK,31,82,12,26,38
39,8481703,Valtteri Puustinen,R,PIT,25,82,9,29,38
39,8480873,Rasmus Sandin,D,WSH,24,82,7,31,38
39,8477986,Brandon Montour,D,FLA,30,82,6,32,38
39,8475753,Justin Faulk,D,STL,32,82,6,32,38
39,8480043,Timothy Liljegren,D,TOR,25,82,5,33,38
39,8481542,Moritz Seider,D,DET,23,82,4,34,38
39,8483457,Lane Hutson,D,MTL,20,82,3,35,38
39,8483524,Shane Wright,C,SEA,20,82,30,7,37
39,8478856,Conor Garland,R,VAN,28,82,20,17,37
39,8478498,Jake DeBrusk,L,BOS,28,82,19,18,37
39,8477511,Anthony Mantha,R,VGK,30,82,18,19,37
39,8482175,JJ Peterka,R,BUF,22,82,18,19,37
39,8471218,Blake Wheeler,R,NYR,38,82,17,20,37
39,8478542,Evan Rodrigues,C,FLA,31,82,16,21,37
39,8476392,Adam Lowry,C,WPG,31,82,16,21,37
39,8481013,Jonatan Berggren,R,DET,24,82,15,22,37
39,8477947,Sonny Milano,L,WSH,28,82,14,23,37
39,8471724,Kris Letang,D,PIT,37,82,10,27,37
39,8475197,Tyson Barrie,D,NSH,33,82,9,28,37
39,8478466,Daniel Sprong,R,DET,27,82,20,16,36
39,8481618,Alex Newhook,C,MTL,23,82,19,17,36
39,8483515,Juraj Slafkovsky,L,MTL,20,82,17,19,36
39,8477998,Warren Foegele,L,EDM,28,82,17,19,36
39,8481656,Aliaksei Protas,C,WSH,23,82,12,24,36
39,8473986,Alex Killorn,L,ANA,35,82,11,25,36
39,8484153,Leo Carlsson,C,ANA,20,82,11,25,36
39,8478396,Noah Hanifin,D,VGK,27,82,10,26,36
39,8475149,Marcus Johansson,L,MIN,34,82,9,27,36
39,8474565,Alex Pietrangelo,D,VGK,34,82,8,28,36
39,8483471,Brad Lambert,C,WPG,31,82,7,29,36
39,8478911,Matt Roy,D,LAK,29,82,7,29,36
39,8475906,John Klingberg,D,TOR,32,82,4,32,36
39,8475760,Nick Bjugstad,C,ARI,32,82,16,19,35
39,8481528,Dylan Cozens,C,BUF,23,82,14,21,35
39,8476927,Teddy Blueger,C,VAN,30,82,14,21,35
39,8480185,Eetu Luostarinen,C,FLA,26,82,13,22,35
39,8482133,Thomas Bordeleau,C,SJS,22,82,12,23,35
39,8480817,K'Andre Miller,D,NYR,24,82,8,27,35
39,8476854,Hampus Lindholm,D,BOS,30,82,7,28,35
39,8474641,Adam Henrique,C,EDM,34,82,21,13,34
39,8479423,Alex Nylander,L,CBJ,26,82,18,16,34
39,8484166,Adam Fantilli,C,CBJ,20,82,18,16,34
39,8480849,Barrett Hayton,C,ARI,24,82,16,18,34
39,8479365,Trent Frederic,C,BOS,26,82,15,19,34
39,8478891,Mason Appleton,C,WPG,28,82,14,20,34
39,8474149,Evgenii Dadonov,R,DAL,35,82,13,21,34
39,8476885,Jacob Trouba,D,NYR,30,82,9,25,34
39,8476292,Ondrej Palat,L,NJD,33,82,7,27,34
39,8476979,Erik Gustafsson,D,NYR,32,82,7,27,34
39,8477964,Ivan Barbashev,C,VGK,29,82,17,16,33
39,8480459,Pius Suter,C,VAN,28,82,14,19,33
39,8476826,Yanni Gourde,C,SEA,33,82,11,22,33
39,8479525,Ross Colton,C,COL,28,82,11,22,33
39,8478472,Mathieu Joseph,R,OTT,27,82,9,24,33
39,8477495,Seth Jones,D,CHI,30,82,8,25,33
39,8477450,Jason Dickinson,C,CHI,29,82,20,12,32
39,8470604,Jeff Carter,C,PIT,39,82,17,15,32
39,8477425,Miles Wood,L,COL,29,82,8,24,32
39,8478115,Pierre Engvall,L,NYI,28,82,17,14,31
39,8476925,Colton Sissons,C,NSH,31,82,15,16,31
39,8480009,Eeli Tolvanen,R,SEA,25,82,14,17,31
39,8479977,Kailer Yamamoto,R,SEA,26,82,14,17,31
39,8480871,Adam Boqvist,D,CBJ,24,82,13,18,31
39,8480802,Ryan McLeod,C,EDM,25,82,13,18,31
39,8482101,Danil Gushchin,L,SJS,22,82,11,20,31
39,8476871,Tanner Pearson,L,MTL,32,82,11,20,31
39,8478133,Jake Evans,C,MTL,28,82,10,21,31
39,8475200,Dmitry Orlov,D,CAR,33,82,9,22,31
39,8476902,Esa Lindell,D,DAL,30,82,7,24,31
39,8484203,Bradly Nadeau,L,CAR,19,82,23,7,30
39,8476981,Josh Anderson,R,MTL,30,82,19,11,30
39,8477989,Christian Dvorak,C,MTL,28,82,18,12,30
39,8477330,Dominik Kubalik,L,OTT,29,82,18,12,30
39,8470621,Corey Perry,R,EDM,39,82,16,14,30
39,8483499,Liam Ohgren,L,MIN,20,82,14,16,30
39,8482092,Ridly Greig,C,OTT,22,82,14,16,30
39,8482475,Yegor Chinakhov,R,CBJ,23,82,12,18,30
39,8479353,Brett Howden,C,VGK,26,82,12,18,30
39,8476461,Sean Couturier,C,PHI,32,82,11,19,30
39,8474715,Cam Atkinson,R,PHI,35,82,11,19,30
39,8477498,Darnell Nurse,D,EDM,29,82,11,19,30
39,8476374,Sean Kuraly,C,CBJ,31,82,10,20,30
39,8476457,Adam Larsson,D,SEA,32,82,7,23,30
39,8477969,Marcus Pettersson,D,PIT,28,82,5,25,30
39,8480035,Henri Jokiharju,D,BUF,25,82,2,28,30
39,8479996,Cody Glass,C,NSH,25,82,18,11,29
39,8482118,Sam Colangelo,R,ANA,23,82,18,11,29
39,8481554,Kaapo Kakko,R,NYR,23,82,17,12,29
39,8481535,Nils Hoglander,L,VAN,24,82,16,13,29
39,8475848,Brendan Gallagher,R,MTL,32,82,13,16,29
39,8476872,Scott Laughton,C,PHI,30,82,13,16,29
39,8481624,Ilya Mikheyev,R,VAN,30,82,12,17,29
39,8477953,Kasperi Kapanen,R,STL,28,82,12,17,29
39,8481560,Arthur Kaliyev,R,LAK,23,82,9,20,29
39,8478413,Jordan Greenway,L,BUF,27,82,8,21,29
39,8477506,Ryan Pulock,D,NYI,30,82,8,21,29
39,8473422,Nick Foligno,L,CHI,37,82,7,22,29
39,8479976,Juuso Valimaki,D,ARI,26,82,6,23,29
39,8480336,Sean Walker,D,COL,30,82,5,24,29
39,8482671,Owen Power,D,BUF,22,82,5,24,29
39,8475764,Cam Fowler,D,ANA,33,82,5,24,29
39,8482733,Logan Mailloux,D,MTL,31,82,5,24,29
39,8482702,Logan Stankoven,C,DAL,21,82,20,8,28
39,8480281,Alexey Toropchenko,R,STL,25,82,18,10,28
39,8481186,Logan O'Connor,R,COL,28,82,16,12,28
39,8478463,Anthony Beauvillier,L,NSH,27,82,14,14,28
39,8476960,Andreas Athanasiou,C,CHI,30,82,13,15,28
39,8475763,Kevin Hayes,R,STL,32,82,12,16,28
39,8479514,Rem Pitlick,C,CHI,27,82,12,16,28
39,8478055,Gustav Forsling,D,FLA,28,82,6,22,28
39,8482122,Brock Faber,D,MIN,22,82,5,23,28
39,8474716,Jared Spurgeon,D,MIN,35,82,5,23,28
39,8477488,Brett Pesce,D,CAR,30,82,5,23,28
39,8479398,Samuel Girard,D,COL,26,82,3,25,28
39,8481604,Pavel Dorofeyev,L,VGK,24,82,15,12,27
39,8478043,Sam Lafferty,C,VAN,29,82,13,14,27
39,8480821,Filip Zadina,R,SJS,25,82,13,14,27
39,8479415,Michael McLeod,C,NJD,26,82,9,18,27
39,8482705,Cole Sillinger,C,CBJ,21,82,8,19,27
39,8482142,Jamie Drysdale,D,PHI,22,82,8,19,27
39,8475171,Oliver Ekman-Larsson,D,FLA,33,82,7,20,27
39,8482730,Brandt Clarke,D,LAK,21,82,5,22,27
39,8482145,Mavrik Bourque,C,DAL,22,82,20,6,26
39,8470610,Zach Parise,L,COL,40,82,17,9,26
39,8479661,Tanner Jeannot,L,TBL,27,82,17,9,26
39,8480813,Joe Veleno,C,DET,24,82,14,12,26
39,8478569,Noel Acciari,C,PIT,33,82,12,14,26
39,8479992,Michael Rasmussen,C,DET,25,82,11,15,26
39,8482117,Lukas Reichel,L,CHI,22,82,11,15,26
39,8476897,Oskar Sundqvist,C,STL,30,82,11,15,26
39,8482079,Marco Rossi,C,MIN,23,82,11,15,26
39,8482062,Cole Smith,L,NSH,29,82,11,15,26
39,8473563,Nicklas Backstrom,C,WSH,37,82,8,18,26
39,8480068,Ryan Poehling,C,PHI,25,82,8,18,26
39,8477435,Ryan Graves,D,PIT,29,82,6,20,26
39,8476331,Dylan DeMelo,D,WPG,31,82,3,23,26
39,8482245,Artem Zub,D,OTT,29,82,2,24,26
39,8473533,Jordan Staal,C,CAR,36,82,15,10,25
39,8476469,Joel Armia,R,MTL,31,82,14,11,25
39,8475793,Ryan Johansen,C,PHI,32,82,13,12,25
39,8477952,Robby Fabbri,C,DET,28,82,13,12,25
39,8474884,Mike Hoffman,C,SJS,35,82,12,13,25
39,8480806,Isac Lundestrom,C,ANA,25,82,12,13,25
39,8481704,Juuso Parssinen,C,NSH,23,82,12,13,25
39,8480855,Jack McBain,C,ARI,24,82,11,14,25
39,8479293,Brandon Tanev,L,SEA,33,82,11,14,25
39,8474189,Lars Eller,C,PIT,35,82,11,14,25
39,8476923,Damon Severson,D,CBJ,30,82,10,15,25
39,8482655,J.J. Moser,D,ARI,24,82,7,18,25
39,8477505,Alexander Wennberg,C,NYR,30,82,7,18,25
39,8480145,Neal Pionk,D,WPG,29,82,5,20,25
39,8478507,John Marino,D,NJD,27,82,4,21,25
39,8482087,Kaiden Guhle,D,MTL,22,82,4,21,25
39,8476892,Colton Parayko,D,STL,31,82,1,24,25
39,8476891,Matt Grzelcyk,D,BOS,30,82,1,24,25
39,8481093,Rafael Harvey-Pinard,L,MTL,25,82,18,6,24
39,8477353,Tyler Motte,C,TBL,29,82,16,8,24
39,8484145,Zach Benson,L,BUF,19,82,13,11,24
39,8474870,Tyler Johnson,C,CHI,34,82,11,13,24
39,8482125,Alexander Holtz,R,NJD,22,82,11,13,24
39,8481580,Connor McMichael,C,WSH,23,82,10,14,24
39,8478046,Danton Heinen,L,BOS,29,82,9,15,24
39,8479390,Taylor Raddysh,R,CHI,26,82,8,16,24
39,8483490,Pavel Mintyukov,D,ANA,21,82,7,17,24
39,8474574,Tyler Myers,D,VAN,34,82,4,20,24
39,8476525,Colin Miller,D,WPG,32,82,4,20,24
39,8482720,Matthew Knies,L,TOR,22,82,3,21,24
39,8476917,Adam Pelech,D,NYI,30,82,2,22,24
39,8479346,Dillon Dube,C,CGY,26,82,11,12,23
39,8482111,Justin Barron,D,MTL,23,82,9,14,23
39,8478451,Ethan Bear,D,WSH,27,82,7,16,23
39,8475218,Mattias Ekholm,D,EDM,34,82,5,18,23
39,8470966,Mark Giordano,D,TOR,41,82,5,18,23
39,8478882,Vladislav Gavrikov,D,LAK,29,82,5,18,23
39,8475181,Nick Leddy,D,STL,33,82,3,20,23
39,8475324,Nick Jensen,D,WSH,34,82,3,20,23
39,8478178,Darren Raddysh,D,TBL,28,82,2,21,23
39,8473507,Jeff Petry,D,DET,37,82,1,22,23
39,8477944,Jakub Vrana,L,STL,28,82,12,10,22
39,8475799,Nino Niederreiter,R,WPG,32,82,11,11,22
39,8483505,Matthew Poitras,C,BOS,20,82,11,11,22
39,8479941,Justin Danforth,R,CBJ,31,82,11,11,22
39,8478109,Victor Olofsson,L,BUF,29,82,10,12,22
39,8477839,Conor Sheary,L,TBL,32,82,6,16,22
39,8473449,Kyle Okposo,R,FLA,36,82,6,16,22
39,8482737,Zack Bolduc,C,STL,21,82,6,16,22
39,8474034,Pat Maroon,L,BOS,36,82,5,17,22
39,8477507,Nikita Zadorov,D,VAN,29,82,4,18,22
39,8475762,Derek Forbort,D,BOS,32,82,2,20,22
39,8479591,Michael Eyssimont,C,TBL,28,82,13,8,21
39,8481601,Simon Holmstrom,R,NYI,23,82,11,10,21
39,8482624,Daniil Miromanov,D,CGY,27,82,10,11,21
39,8481477,Nico Sturm,C,SJS,29,82,10,11,21
39,8482259,Bobby McMann,C,TOR,28,82,8,13,21
39,8478468,Jeremy Lauzon,D,NSH,27,82,8,13,21
39,8481524,Bowen Byram,D,BUF,23,82,8,13,21
39,8476480,Vladislav Namestnikov,C,WPG,32,82,7,14,21
39,8481567,Henry Thrun,D,SJS,23,82,6,15,21
39,8478430,Oliver Kylington,D,CGY,27,82,5,16,21
39,8476967,Brett Kulak,D,EDM,30,82,5,16,21
39,8478500,Ivan Provorov,D,CBJ,27,82,4,17,21
39,8477919,Frederick Gaudreau,C,MIN,31,82,3,18,21
39,8478840,Will Borgen,D,SEA,28,82,3,18,21
39,8478399,Jonas Siegenthaler,D,NJD,27,82,2,19,21
39,8477845,Trevor van Riemsdyk,D,WSH,33,82,2,19,21
39,8479393,Noah Gregor,C,TOR,26,82,14,6,20
39,8477508,Curtis Lazar,C,NJD,29,82,8,12,20
39,8483491,Ivan Miroshnichenko,L,WSH,20,82,8,12,20
39,8482803,Olen Zellweger,D,ANA,21,82,6,14,20
39,8477220,Nate Schmidt,D,WPG,33,82,6,14,20
39,8481014,Alexander Romanov,D,NYI,24,82,5,15,20
39,8475188,Brayden McNabb,D,VGK,33,82,4,16,20
39,8481178,Egor Zamula,D,PHI,24,82,3,17,20
39,8480073,Erik Brannstrom,D,OTT,25,82,3,17,20
39,8475790,Erik Gudbranson,D,CBJ,32,82,3,17,20
39,8478851,Alexandre Carrier,D,NSH,28,82,3,17,20
39,8480860,Kevin Bahl,D,NJD,24,82,3,17,20
39,8480246,Nick Perbix,D,TBL,26,82,1,19,20
39,8483493,Frank Nazar,C,CHI,20,82,14,5,19
39,8479316,Luke Kunin,C,SJS,27,82,11,8,19
39,8482074,Connor Zary,C,CGY,23,82,10,9,19
39,8482679,Matt Coronato,R,CGY,22,82,10,9,19
39,8473504,Cal Clutterbuck,R,NYI,37,82,10,9,19
39,8480448,Parker Kelly,L,OTT,25,82,9,10,19
39,8475231,Casey Cizikas,C,NYI,33,82,8,11,19
39,8478136,Jake Middleton,D,MIN,28,82,8,11,19
39,8478020,Michael Amadio,C,VGK,28,82,7,12,19
39,8480990,Declan Chisholm,D,MIN,24,82,7,12,19
39,8476873,Mark Jankowski,C,NSH,30,82,5,14,19
39,8481553,Bobby Brink,R,PHI,23,82,5,14,19
39,8479980,Nicolas Hague,D,VGK,26,82,5,14,19
39,8481028,Martin Pospisil,C,CGY,25,82,4,15,19
39,8476429,Scott Mayfield,D,NYI,32,82,3,16,19
39,8477369,Carson Soucy,D,VAN,30,82,3,16,19
39,8481059,Scott Perunovich,D,STL,26,82,3,16,19
39,8479371,Dante Fabbro,D,NSH,26,82,2,17,19
39,8474673,TJ Brodie,D,TOR,34,82,1,18,19
39,8476372,Nick Seeler,D,PHI,31,82,1,18,19
39,8475233,David Savard,D,MTL,34,82,0,19,19
39,8478013,Jake Walman,D,DET,28,82,12,6,18
39,8482155,Alex Laferriere,R,LAK,23,82,12,6,18
39,8482809,Jackson Blake,R,CAR,21,82,11,7,18
39,8475714,Calle Jarnkrok,C,TOR,33,82,8,10,18
39,8479351,Sam Steel,C,DAL,26,82,8,10,18
39,8476463,Jonas Brodin,D,MIN,31,82,8,10,18
39,8475220,Marcus Foligno,L,MIN,33,82,7,11,18
39,8479998,Mikey Anderson,D,LAK,25,82,7,11,18
39,8481522,Peyton Krebs,C,BUF,23,82,6,12,18
39,8483495,Simon Nemec,D,NJD,20,82,6,12,18
39,8479359,Beck Malenstyn,L,WSH,26,82,6,12,18
39,8481606,Jordan Spence,D,LAK,23,82,5,13,18
39,8475455,Brenden Dillon,D,WPG,34,82,5,13,18
39,8480834,Ty Emberson,D,SJS,24,82,5,13,18
39,8476422,Mike Reilly,D,NYI,31,82,5,13,18
39,8470600,Ryan Suter,D,DAL,39,82,4,14,18
39,8478831,Kevin Stenlund,C,FLA,28,82,12,5,17
39,8481517,Brett Leason,R,ANA,25,82,10,7,17
39,8477392,Hudson Fasching,R,NYI,29,82,10,7,17
39,8480074,Alexandre Texier,C,CBJ,25,82,7,10,17
39,8479983,Mario Ferraro,D,SJS,26,82,7,10,17
39,8482666,Scott Morrow,D,CAR,22,82,7,10,17
39,8483466,Kevin Korchinski,D,CHI,20,82,2,15,17
39,8476879,Cody Ceci,D,EDM,31,82,2,15,17
39,8475690,Chris Tanev,D,DAL,35,82,2,15,17
39,8476467,Jamie Oleksiak,D,SEA,32,82,2,15,17
39,8474151,Ryan McDonagh,D,NSH,35,82,2,15,17
39,8477034,Jaycob Megna,D,CHI,32,82,2,15,17
39,8479369,Andrew Peeke,D,BOS,26,82,1,16,17
39,8475164,Jakob Silfverberg,R,ANA,34,82,10,6,16
39,8479383,Boris Katchouk,L,OTT,26,82,9,7,16
39,8478508,Yakov Trenin,C,COL,27,82,9,7,16
39,8483012,Logan Morrison,C,SEA,22,82,9,7,16
39,8476858,Phillip Di Giuseppe,L,VAN,31,82,9,7,16
39,8482073,Braden Schneider,D,NYR,23,82,8,8,16
39,8477015,Connor Brown,R,EDM,30,82,8,8,16
39,8476278,Colin Blackwell,C,CHI,31,82,7,9,16
39,8480144,David Kampf,C,TOR,29,82,6,10,16
39,8481481,Blake Lizotte,C,LAK,27,82,6,10,16
39,8475842,Sam Carrick,C,EDM,32,82,5,11,16
39,8477931,Tomas Nosek,L,NJD,32,82,4,12,16
39,8479324,Ryan Lindgren,D,NYR,26,82,3,13,16
39,8476312,Josh Manson,D,COL,33,82,3,13,16
39,8483565,Nick Blankenburg,D,CBJ,26,82,3,13,16
39,8480058,Pierre-Olivier Joseph,D,PIT,25,82,2,14,16
39,8478443,Brandon Carlo,D,BOS,28,82,2,14,16
39,8476931,Jake McCabe,D,TOR,31,82,2,14,16
39,8480879,Jacob Bernard-Docker,D,OTT,24,82,2,14,16
39,8475825,Jani Hakanpää,D,DAL,32,82,2,14,16
39,8477365,Connor Clifton,D,BUF,29,82,0,16,16
39,8477406,Mattias Janmark,C,EDM,32,82,7,8,15
39,8473453,Trevor Lewis,C,LAK,37,82,7,8,15
39,8477499,Rasmus Ristolainen,D,PHI,30,82,5,10,15
39,8482166,Shakir Mukhamadullin,D,SJS,22,82,5,10,15
39,8481537,Nikita Okhotiuk,D,CGY,24,82,4,11,15
39,8483482,Tristan Luneau,D,ANA,20,82,4,11,15
39,8482858,Ryker Evans,D,SEA,23,82,4,11,15
39,8475177,Calvin de Haan,D,TBL,33,82,3,12,15
39,8480796,Martin Fehervary,D,WSH,25,82,3,12,15
39,8480980,Connor Dewar,C,TOR,25,82,3,12,15
39,8476624,Barclay Goodrow,C,NYR,31,82,8,6,14
39,8482470,Ilya Solovyov,D,CGY,24,82,5,9,14
39,8474166,Alec Martinez,D,VGK,37,82,5,9,14
39,8478859,Niko Mikkola,D,FLA,28,82,4,10,14
39,8482762,Simon Edvinsson,D,DET,21,82,4,10,14
39,8481605,Jackson LaCombe,D,ANA,23,82,3,11,14
39,8484911,Collin Graf,R,SJS,22,82,3,11,14
39,8481568,Alex Vlasic,D,CHI,23,82,2,12,14
39,8475279,Ben Chiarot,D,DET,33,82,2,12,14
39,8478408,Travis Dermott,D,ARI,28,82,2,12,14
39,8474009,Nick Bonino,C,NYR,36,82,6,7,13
39,8476822,Luke Glendening,C,TBL,35,82,6,7,13
39,8474013,Ian Cole,D,VAN,35,82,4,9,13
39,8479291,Kevin Rooney,C,CGY,31,82,3,10,13
39,8480807,Mattias Samuelsson,D,BUF,24,82,2,11,13
39,8480172,Jan Rutta,D,SJS,34,82,1,12,13
39,8482516,Matthew Kessel,D,STL,24,82,1,12,13
39,8482712,Oskar Olausson,R,COL,22,82,1,12,13
39,8476878,Zemgus Girgensons,L,BUF,30,82,8,4,12
39,8477335,Kyle Burroughs,D,SJS,29,82,4,8,12
39,8484149,Gavin Brindley,C,CBJ,20,82,2,10,12
39,8476442,Matt Nieto,L,PIT,32,82,5,6,11
39,8483489,Fraser Minten,C,TOR,31,82,4,7,11
39,8478416,Erik Cernak,D,TBL,27,82,2,9,11
39,8483763,Maksymilian Szuber,D,ARI,22,82,2,9,11
39,8481599,Victor Soderstrom,D,ARI,23,82,5,5,10
39,8479442,Troy Stecher,D,EDM,30,82,3,7,10
39,8475179,Dmitry Kulikov,D,FLA,34,82,1,9,10
39,8476473,Connor Murphy,D,CHI,31,82,1,9,10
39,8475208,Brian Dumoulin,D,SEA,33,82,1,9,10
39,8482807,Ethan Del Mastro,D,CHI,21,82,5,4,9
39,8482177,Marat Khusnutdinov,C,MIN,22,82,3,6,9
39,8475462,Radko Gudas,D,ANA,34,82,2,7,9
39,8474567,Zach Bogosian,D,MIN,34,82,1,8,9
39,8482713,Mackie Samoskevich,R,FLA,22,82,5,3,8
39,8471677,Jack Johnson,D,COL,37,82,1,7,8
39,8482859,Zack Ostapchuk,C,OTT,21,82,1,7,8
39,8481030,Jack St. Ivany,D,PIT,25,82,1,7,8
39,8476915,Jujhar Khaira,L,MIN,30,82,4,3,7
39,8483468,Jiri Kulich,C,BUF,20,82,0,6,6
39,8481578,Graeme Clarke,R,NJD,23,82,3,2,5
39,8482141,Lukas Cormier,D,VGK,22,0,0,0,0
39,8476988,Matt Benning,D,SJS,30,0,0,0,0
39,8480727,Zach Whitecloud,D,VGK,28,0,0,0,0
39,8480887,Jordan Harris,D,MTL,24,0,0,0,0
39,8478450,Parker Wotherspoon,D,BOS,27,0,0,0,0
39,8481812,Nikolai Knyzhov,D,SJS,27,0,0,0,0
39,8480001,Urho Vaakanainen,D,ANA,25,0,0,0,0
39,8482176,Wyatt Kaiser,D,CHI,22,0,0,0,0
39,8481122,Simon Benoit,D,TOR,26,0,0,0,0
39,8476441,Joel Edmundson,D,TOR,31,0,0,0,0
39,8480884,Calen Addison,D,SJS,24,0,0,0,0
39,8482511,Mason Lohrei,D,BOS,23,0,0,0,0
39,8482192,Isaak Phillips,D,CHI,23,0,0,0,0
39,8480950,Ilya Lyubushkin,D,TOR,30,0,0,0,0
39,8474031,Kevin Shattenkirk,D,BOS,35,0,0,0,0
39,8475718,Justin Holl,D,DET,32,0,0,0,0
39,8479402,Jake Bean,D,CBJ,26,0,0,0,0
39,8474602,Justin Schultz,D,SEA,34,0,0,0,0
39,8477950,Tony DeAngelo,D,CAR,29,0,0,0,0
39,8481743,Marc Del Gaizo,D,NSH,25,0,0,0,0
39,8481527,Kaedan Korczak,D,VGK,23,0,0,0,0
39,8480192,Johnathan Kovacevic,D,MTL,27,0,0,0,0
39,8476874,Olli Maatta,D,DET,30,0,0,0,0
39,8482144,Jack Thompson,D,SJS,22,0,0,0,0
39,8480222,Sebastian Aho,D,NYI,28,0,0,0,0
39,8479458,Nikita Zaitsev,D,CHI,33,0,0,0,0
39,8471709,Marc-Edouard Vlasic,D,SJS,37,0,0,0,0
39,8482929,Emil Lilleberg,D,TBL,23,0,0,0,0
39,8477018,Ben Hutton,D,VGK,31,0,0,0,0
39,8481056,Spencer Stastney,D,NSH,24,0,0,0,0
39,8481593,Jayden Struble,D,MTL,23,0,0,0,0
39,8479982,Conor Timmins,D,TOR,26,0,0,0,0
39,8474090,Brendan Smith,D,NJD,35,0,0,0,0
39,8482964,Arber Xhekaj,D,MTL,23,0,0,0,0
39,8480891,Michael Kesselring,D,ARI,24,0,0,0,0
39,8477938,Haydn Fleury,D,TBL,28,0,0,0,0
39,8481806,Louis Crevier,D,CHI,23,0,0,0,0
39,8471274,Alex Goligoski,D,MIN,39,0,0,0,0
39,8481600,Tobias Bjornfot,D,FLA,23,0,0,0,0
39,8475797,Jarred Tinordi,D,CHI,32,0,0,0,0
39,8481521,Ronnie Attard,D,PHI,25,0,0,0,0
39,8474612,Travis Hamonic,D,OTT,34,0,0,0,0
39,8479576,Vincent Desharnais,D,EDM,28,0,0,0,0
39,8480049,Dylan Samberg,D,WPG,25,0,0,0,0
39,8483619,Filip Roos,D,CHI,25,0,0,0,0
39,8474568,Luke Schenn,D,NSH,35,0,0,0,0
39,8480184,Gustav Lindstrom,D,ANA,26,0,0,0,0
39,8480070,Ian Mitchell,D,BOS,25,0,0,0,0
39,8480196,Jacob Bryson,D,BUF,27,0,0,0,0
39,8471686,Marc Staal,D,PHI,37,0,0,0,0
39,8477467,Gustav Olofsson,D,SEA,30,0,0,0,0
39,8478970,Jalen Chatfield,D,CAR,28,0,0,0,0
39,8479348,Kale Clague,D,BUF,26,0,0,0,0
39,8473446,Erik Johnson,D,PHI,36,0,0,0,0
39,8477462,Robert Hagg,D,ANA,29,0,0,0,0
39,8478454,Noah Juulsen,D,VAN,27,0,0,0,0
39,8477384,Josh Brown,D,ARI,30,0,0,0,0
39,8481708,Zac Jones,D,NYR,24,0,0,0,0
39,8481167,Brayden Pachal,D,CGY,25,0,0,0,0
39,8482067,Connor Mackey,D,NYR,28,0,0,0,0
39,8483460,David Jiricek,D,CBJ,21,0,0,0,0
39,8481701,Santeri Hatakka,D,NJD,23,0,0,0,0
39,8478021,William Lagesson,D,ANA,28,0,0,0,0
39,8477851,Jordan Oesterle,D,CGY,32,0,0,0,0
39,8478452,Caleb Jones,D,COL,27,0,0,0,0
39,8479984,Cal Foote,D,NJD,26,0,0,0,0
39,8479639,Dylan Coghlan,D,CAR,26,0,0,0,0
39,8480874,Adam Ginning,D,PHI,24,0,0,0,0
39,8479321,Lucas Johansen,D,WSH,27,0,0,0,0
39,8480878,Nils Lundkvist,D,DAL,24,0,0,0,0
39,8482165,Yan Kuznetsov,D,CGY,22,0,0,0,0
39,8484258,Sam Malinski,D,COL,26,0,0,0,0
39,8480157,Calle Rosen,D,STL,30,0,0,0,0
39,8484304,Uvis Balinskis,D,FLA,28,0,0,0,0
39,8479985,Cale Fleury,D,SEA,26,0,0,0,0
39,8479378,Logan Stanley,D,WPG,26,0,0,0,0
39,8477541,Dakota Mermis,D,MIN,30,0,0,0,0
39,8481609,Vladislav Kolyachonok,D,ARI,23,0,0,0,0
39,8480823,Alexander Alexeyev,D,WSH,25,0,0,0,0
39,8481679,Maxence Guenette,D,OTT,23,0,0,0,0
39,8481564,Ryan Johnson,D,BUF,23,0,0,0,0
39,8479376,Victor Mete,D,PHI,26,0,0,0,0
39,8484254,Akito Hirose,D,VAN,25,0,0,0,0
39,8482660,Kent Johnson,C,CBJ,22,0,0,0,0
39,8482149,Cole Perfetti,C,WPG,22,0,0,0,0
39,8477987,Ryan Donato,C,CHI,28,0,0,0,0
39,8475755,Alexander Petrovic,D,DAL,32,0,0,0,0
39,8477810,Joel Hanley,D,CGY,33,0,0,0,0
39,8474145,Robert Bortuzzo,D,NYI,35,0,0,0,0
39,8481161,Jake Christiansen,D,CBJ,25,0,0,0,0
39,8476884,Derrick Pouliot,D,DAL,30,0,0,0,0
39,8481716,Dmitri Voronkov,L,CBJ,24,0,0,0,0
39,8480084,Nick DeSimone,D,NJD,30,0,0,0,0
39,8475750,Jon Merrill,D,MIN,32,0,0,0,0
39,8479315,Joey Anderson,R,CHI,26,0,0,0,0
39,8478011,Louie Belpedio,D,PHI,28,0,0,0,0
39,8482451,Mikael Pyyhtia,L,CBJ,23,0,0,0,0
39,8481541,Samuel Bolduc,D,NYI,24,0,0,0,0
39,8482126,Emil Andrae,D,PHI,31,0,0,0,0
39,8474618,Marco Scandella,D,STL,34,0,0,0,0
39,8477244,Chad Ruhwedel,D,NYR,34,0,0,0,0
39,8477971,Andreas Englund,D,LAK,28,0,0,0,0
39,8480829,Jesperi Kotkaniemi,C,CAR,24,0,0,0,0
39,8479372,Josh Mahura,D,FLA,26,0,0,0,0
39,8482095,Tyler Kleven,D,OTT,22,0,0,0,0
39,8481719,Maxwell Crozier,D,TBL,24,0,0,0,0
39,8475855,Jesper Fast,R,CAR,33,0,0,0,0
39,8480848,Ty Dellandrea,C,DAL,24,0,0,0,0
39,8475193,Tomas Tatar,L,SEA,34,0,0,0,0
39,8476889,Radek Faksa,C,DAL,30,0,0,0,0
39,8478495,Denis Gurianov,R,PHI,27,0,0,0,0
39,8480216,Jacob Peterson,C,SJS,25,0,0,0,0
39,8480252,Cole Guttman,C,CHI,25,0,0,0,0
39,8479026,Philippe Myers,D,TBL,27,0,0,0,0
39,8481006,Tyler Tucker,D,STL,24,0,0,0,0
39,8481032,Paul Cotter,C,VGK,25,0,0,0,0
39,8481577,Philip Tomasino,C,NSH,23,0,0,0,0
39,8476918,Jimmy Vesey,L,NYR,31,0,0,0,0
39,8479320,Max Lajoie,D,TOR,27,0,0,0,0
39,8478017,Mark Friedman,D,VAN,29,0,0,0,0
39,8481754,Nikita Nesterenko,C,ANA,23,0,0,0,0
39,8483407,Brandon Scanlin,D,NYR,25,0,0,0,0
39,8482659,Josh Doan,R,ARI,22,0,0,0,0
39,8477446,Michael McCarron,R,NSH,29,0,0,0,0
39,8477903,Garnet Hathaway,R,PHI,33,0,0,0,0
39,8482153,Brendan Brisson,C,VGK,23,0,0,0,0
39,8483546,Marshall Rifai,D,TOR,26,0,0,0,0
39,8484287,Cole McWard,D,VAN,23,0,0,0,0
39,8478854,Ryan Shea,D,PIT,27,0,0,0,0
39,8481585,Egor Afanasyev,L,NSH,23,0,0,0,0
39,8483398,Declan Carlile,D,TBL,31,0,0,0,0
39,8478502,Dennis Gilbert,D,CGY,28,0,0,0,0
39,8482749,Joshua Roy,R,MTL,21,0,0,0,0
39,8481598,Philip Broberg,D,EDM,23,0,0,0,0
39,8480835,Jack Drury,C,CAR,24,0,0,0,0
39,8480748,Kiefer Sherwood,L,NSH,29,0,0,0,0
39,8476934,Brock McGinn,L,ANA,30,0,0,0,0
39,8480870,Bo Groulx,C,ANA,24,0,0,0,0
39,8479368,Max Jones,L,ANA,26,0,0,0,0
39,8478099,Kevin Labanc,R,SJS,29,0,0,0,0
39,8478067,Oskar Lindblom,L,SJS,28,0,0,0,0
39,8476393,Nick Cousins,C,FLA,31,0,0,0,0
39,8483395,Arshdeep Bains,L,VAN,23,0,0,0,0
39,8480762,Eric Robinson,L,BUF,29,0,0,0,0
39,8479439,Jacob MacDonald,D,SJS,31,0,0,0,0
39,8476474,Stefan Noesen,R,CAR,31,0,0,0,0
39,8482787,Nikita Chibrikov,R,WPG,31,0,0,0,0
39,8478432,Christian Fischer,R,DET,27,0,0,0,0
39,8477979,Nicolas Aube-Kubel,R,WSH,28,0,0,0,0
39,8481789,Tye Kartye,L,SEA,23,0,0,0,0
39,8479330,Brandon Gignac,C,MTL,27,0,0,0,0
39,8480075,Cameron Crotty,D,ARI,25,0,0,0,0
39,8473473,Milan Lucic,L,BOS,36,0,0,0,0
39,8482094,Daemon Hunt,D,MIN,22,0,0,0,0
39,8481206,John Ludvig,D,PIT,24,0,0,0,0
39,8483630,Pavol Regenda,L,ANA,25,0,0,0,0
39,8481617,Vasily Podkolzin,R,VAN,23,0,0,0,0
39,8480306,Grant Hutton,D,NYI,29,0,0,0,0
39,8480995,Pontus Holmberg,R,TOR,25,0,0,0,0
39,8482148,Hendrix Lapierre,C,WSH,22,0,0,0,0
39,8477478,William Carrier,L,VGK,30,0,0,0,0
39,8480003,Jesper Boqvist,C,BOS,26,0,0,0,0
39,8482172,Landon Slaggert,L,CHI,22,0,0,0,0
39,8480789,Oliver Wahlstrom,R,NYI,24,0,0,0,0
39,8474062,Riley Nash,C,NYR,35,0,0,0,0
39,8480021,Jack Studnicka,C,SJS,25,0,0,0,0
39,8480025,MacKenzie Entwistle,R,CHI,25,0,0,0,0
39,8481582,Nicholas Robertson,L,TOR,23,0,0,0,0
39,8476867,Brendan Gaunce,C,CBJ,30,0,0,0,0
39,8479619,Michael Carcone,L,ARI,28,0,0,0,0
39,8479370,Tyson Jost,C,BUF,26,0,0,0,0
39,8479671,Mathieu Olivier,R,CBJ,27,0,0,0,0
39,8476994,Vinnie Hinostroza,C,PIT,30,0,0,0,0
39,8482070,Mitchell Chaffee,R,TBL,26,0,0,0,0
39,8477473,Justin Bailey,R,SJS,29,0,0,0,0
39,8479344,Jesse Puljujarvi,R,PIT,26,0,0,0,0
39,8480205,Emil Bemstrom,C,PIT,25,0,0,0,0
39,8479718,Alex Barré-Boulet,C,TBL,27,0,0,0,0
39,8482061,Brandon Biro,L,BUF,26,0,0,0,0
39,8479638,Justin Brazeau,R,BOS,26,0,0,0,0
39,8474040,Sam Gagner,C,EDM,35,0,0,0,0
39,8477846,Ryan Carpenter,C,SJS,33,0,0,0,0
39,8482077,Dylan Holloway,L,EDM,23,0,0,0,0
39,8482157,Will Cuylle,L,NYR,22,0,0,0,0
39,8480007,Jonas Rondbjerg,R,VGK,25,0,0,0,0
39,8478874,Adam Gaudette,C,STL,28,0,0,0,0
39,8478434,Keegan Kolesar,R,VGK,27,0,0,0,0
39,8480441,Trey Fix-Wolansky,R,CBJ,25,0,0,0,0
39,8479994,Jaret Anderson-Dolan,C,NSH,25,0,0,0,0
39,8483567,Georgii Merkulov,C,BOS,24,0,0,0,0
39,8477380,Jonny Brodzinski,C,NYR,31,0,0,0,0
39,8482201,Gage Goncalves,C,TBL,23,0,0,0,0
39,8478211,Dryden Hunt,L,CGY,29,0,0,0,0
39,8471699,Andrew Cogliano,C,COL,37,0,0,0,0
39,8479421,Jacob Moverare,D,LAK,26,0,0,0,0
39,8478881,Brett Seney,L,CHI,28,0,0,0,0
39,8477464,Nic Petan,C,MIN,29,0,0,0,0
39,8475958,Michael Sgarbossa,C,WSH,32,0,0,0,0
39,8481147,Reese Johnson,C,CHI,26,0,0,0,0
39,8479336,Carl Grundstrom,R,LAK,27,0,0,0,0
39,8480853,Liam Foudy,C,NSH,24,0,0,0,0
39,8479522,Hardy Haman Aktell,D,WSH,26,0,0,0,0
39,8481462,Mason Morelli,L,VGK,28,0,0,0,0
39,8482102,Vasily Ponomarev,C,CAR,22,0,0,0,0
39,8480844,Grigori Denisenko,L,VGK,24,0,0,0,0
39,8479944,Zach Aston-Reese,C,DET,30,0,0,0,0
39,8482784,Zach Dean,C,STL,21,0,0,0,0
39,8479419,Brett Murray,L,BUF,26,0,0,0,0
39,8479520,Brandon Duhaime,R,COL,27,0,0,0,0
39,8477573,Nathan Walker,L,STL,30,0,0,0,0
39,8478078,Rourke Chartier,C,OTT,28,0,0,0,0
39,8475795,Dylan McIlrath,D,WSH,32,0,0,0,0
39,8482496,Nils Aman,C,VAN,24,0,0,0,0
39,8480289,Morgan Barron,C,WPG,26,0,0,0,0
39,8481751,Lukas Rousek,R,BUF,25,0,0,0,0
39,8480011,Klim Kostin,C,SJS,25,0,0,0,0
39,8481556,John Beecher,C,BOS,23,0,0,0,0
39,8475278,Byron Froese,C,VGK,33,0,0,0,0
39,8475225,Craig Smith,C,DAL,35,0,0,0,0
39,8484326,Patrik Koch,D,ARI,28,0,0,0,0
39,8477930,Pierre-Edouard Bellemare,L,SEA,39,0,0,0,0
39,8478409,Anthony Richard,C,BOS,28,0,0,0,0
39,8481024,Linus Karlsson,C,VAN,25,0,0,0,0
39,8479986,Kole Lind,R,SEA,26,0,0,0,0
39,8479414,Nathan Bastian,R,NJD,27,0,0,0,0
39,8479362,Riley Tufte,L,COL,26,0,0,0,0
39,8481058,Jesse Ylönen,R,MTL,25,0,0,0,0
39,8482476,Emil Heineman,L,MTL,23,0,0,0,0
39,8482861,Vincent Iorio,D,WSH,22,0,0,0,0
39,8483432,Luca Del Bel Belluz,C,CBJ,31,0,0,0,0
39,8482744,James Malatesta,L,CBJ,21,0,0,0,0
39,8477887,Patrick Brown,C,BOS,32,0,0,0,0
39,8478585,Derek Ryan,C,EDM,38,0,0,0,0
39,8481441,Joe Snively,C,WSH,28,0,0,0,0
39,8481592,Jakob Pelletier,L,CGY,23,0,0,0,0
39,8482634,Alex Steeves,C,TOR,25,0,0,0,0
39,8477126,Jayson Megna,C,BOS,34,0,0,0,0
39,8475752,Tyler Pitlick,C,NYR,33,0,0,0,0
39,8480008,Adam Ruzicka,C,ARI,25,0,0,0,0
39,8481065,Angus Crookshank,L,OTT,25,0,0,0,0
39,8479547,Matthew Phillips,R,WSH,26,0,0,0,0
39,8480226,Marián Studenic,R,SEA,26,0,0,0,0
39,8481237,Kyle MacLean,C,NYI,25,0,0,0,0
39,8475413,Justin Dowling,C,NJD,34,0,0,0,0
39,8481641,Joel Kiviranta,L,COL,28,0,0,0,0
39,8478104,Sammy Blais,L,STL,28,0,0,0,0
39,8477454,Adam Erne,L,EDM,29,0,0,0,0
39,8481518,Nolan Foote,L,NJD,24,0,0,0,0
39,8480245,Olle Lycksell,R,PHI,25,0,0,0,0
39,8483570,Ben Meyers,C,ANA,26,0,0,0,0
39,8480776,Sheldon Rempal,R,VGK,29,0,0,0,0
39,8483920,Pierrick Dube,R,WSH,23,0,0,0,0
39,8480267,Sammy Walker,C,MIN,25,0,0,0,0
39,8482747,Brennan Othmann,L,NYR,21,0,0,0,0
39,8479991,Jake Leschyshyn,C,NYR,25,0,0,0,0
39,8478400,Colin White,C,MTL,27,0,0,0,0
39,8479328,Julien Gauthier,R,NYI,27,0,0,0,0
39,8484325,Waltteri Merela,C,TBL,26,0,0,0,0
39,8479066,Ryan Lomberg,L,FLA,30,0,0,0,0
39,8477070,Liam O'Brien,C,ARI,30,0,0,0,0
39,8478146,Matthew Highmore,C,OTT,28,0,0,0,0
39,8478028,Fredrik Olofsson,L,COL,28,0,0,0,0
39,8480880,Jakub Lauko,C,BOS,24,0,0,0,0
39,8479968,Vinni Lettieri,C,MIN,29,0,0,0,0
39,8474709,Matt Martin,L,NYI,35,0,0,0,0
39,8480845,Rasmus Kupari,C,WPG,24,0,0,0,0
39,8481550,Adam Beckman,L,MIN,23,0,0,0,0
39,8481422,Jacob Lucchini,C,MIN,29,0,0,0,0
39,8477401,John Hayden,C,SEA,29,0,0,0,0
39,8478904,Steven Lorentz,C,FLA,28,0,0,0,0
39,8482088,Justin Sourdif,R,FLA,22,0,0,0,0
39,8482751,Ryan Winterton,C,SEA,21,0,0,0,0
39,8482241,Radim Zohorna,L,PIT,28,0,0,0,0
39,8481690,Tyler Angle,C,CBJ,24,0,0,0,0
39,8476952,Dominic Toninato,C,WPG,30,0,0,0,0
39,8476919,Chris Tierney,C,NJD,30,0,0,0,0
39,8480032,Shane Bowers,C,NJD,25,0,0,0,0
39,8484314,Jiri Smejkal,L,OTT,28,0,0,0,0
39,8481239,Samuel Fagemo,L,LAK,24,0,0,0,0
39,8481532,Alex Turcotte,C,LAK,23,0,0,0,0
39,8481019,David Gustafsson,C,WPG,24,0,0,0,0
39,8478477,Mitchell Stephens,C,MTL,27,0,0,0,0
39,8479546,Oskar Steen,C,BOS,26,0,0,0,0
39,8480292,Carson Meyer,R,CBJ,27,0,0,0,0
39,8478446,Glenn Gawdin,C,ANA,27,0,0,0,0
39,8483531,Brian Halonen,L,NJD,25,0,0,0,0
39,8477149,Scott Sabourin,R,SJS,32,0,0,0,0
39,8479972,Mason Shaw,C,MIN,26,0,0,0,0
39,8480890,Jan Jenik,R,ARI,24,0,0,0,0
39,8478051,Max Willman,C,NJD,29,0,0,0,0
39,8480851,Akil Thomas,C,LAK,24,0,0,0,0
39,8482765,Isak Rosen,R,BUF,21,0,0,0,0
39,8478421,A.J. Greer,L,CGY,28,0,0,0,0
39,8478512,Austin Czarnik,C,DET,32,0,0,0,0
39,8479536,Axel Jonsson-Fjallby,L,WPG,26,0,0,0,0
39,8477320,Anton Blidh,L,NYR,29,0,0,0,0
39,8481543,Nikita Alexandrov,C,STL,24,0,0,0,0
39,8475235,Nicolas Deslauriers,L,PHI,33,0,0,0,0
39,8481070,Hugh McGing,L,STL,26,0,0,0,0
39,8480836,Jonathan Gruden,C,PIT,24,0,0,0,0
39,8481591,Sam Poulin,R,PIT,23,0,0,0,0
39,8477962,Brendan Lemieux,L,CAR,28,0,0,0,0
39,8483401,Marc Johnstone,R,PIT,28,0,0,0,0
39,8482250,Callahan Burke,C,CAR,27,0,0,0,0
39,8481726,Adam Edstrom,C,NYR,24,0,0,0,0
39,8471817,Ryan Reaves,R,TOR,37,0,0,0,0
39,8479587,Rhett Gardner,C,PHI,28,0,0,0,0
39,8475766,Austin Watson,L,TBL,32,0,0,0,0
39,8479367,William Lockwood,R,FLA,26,0,0,0,0
39,8478424,Jansen Harkins,C,PIT,27,0,0,0,0
39,8476913,Devin Shore,C,SEA,30,0,0,0,0
39,8482652,Walker Duehr,R,CGY,27,0,0,0,0
39,8477527,Ross Johnston,L,ANA,30,0,0,0,0
39,8481077,John Leonard,L,ARI,26,0,0,0,0
39,8483549,Lucas Condotta,L,MTL,27,0,0,0,0
39,8480468,James Hamblin,L,EDM,25,0,0,0,0
39,8476907,Mackenzie MacEachern,L,STL,30,0,0,0,0
39,8479543,Michael Pezzetta,L,MTL,26,0,0,0,0
39,8480355,Mark Kastelic,C,OTT,25,0,0,0,0
39,8482162,Roby Jarventie,L,OTT,22,0,0,0,0
39,8479772,Zack MacEwen,R,OTT,28,0,0,0,0
39,8483597,Milos Kelemen,L,ARI,25,0,0,0,0
39,8479379,Givani Smith,R,SJS,26,0,0,0,0
39,8481655,Cole Schwindt,R,CGY,23,0,0,0,0
39,8479981,Jonah Gadjovich,L,FLA,26,0,0,0,0
39,8482147,Jean-Luc Foudy,C,COL,22,0,0,0,0
39,8484255,Jason Polin,R,COL,25,0,0,0,0
39,8477993,Justin Kirkland,C,ARI,28,0,0,0,0
39,8479249,Andrew Poturalski,C,SEA,30,0,0,0,0
39,8482197,Adam Raska,R,MIN,23,0,0,0,0
39,8475780,Chris Wagner,R,COL,33,0,0,0,0
39,8479533,Joona Koppanen,L,PIT,26,0,0,0,0
39,8481534,Raphael Lavoie,C,EDM,24,0,0,0,0
39,8484321,Nikolas Matinpalo,D,OTT,26,0,0,0,0
39,8481043,Cole Koepke,L,TBL,26,0,0,0,0
39,8476323,Max McCormick,L,SEA,32,0,0,0,0
39,8483609,Adam Klapka,R,CGY,24,0,0,0,0
39,8483512,Matt Savoie,C,BUF,20,0,0,0,0
39,8484259,Ondrej Pavel,C,COL,31,0,0,0,0
39,8478147,Bokondji Imama,L,OTT,28,0,0,0,0
39,8482460,Matt Rempe,C,NYR,22,0,0,0,0
39,8477073,Kurtis MacDermid,L,NJD,30,0,0,0,0
39,8480274,Philip Kemp,D,EDM,25,0,0,0,0
39,8478956,Samuel Laberge,L,NJD,27,0,0,0,0
39,8483045,Cameron Butler,R,CBJ,31,0,0,0,0
40,8476453,Nikita Kucherov,R,TBL,31,82,47,89,136
40,8478402,Connor McDavid,C,EDM,27,82,41,74,115
40,8479318,Auston Matthews,C,TOR,27,82,53,58,111
40,8478420,Mikko Rantanen,R,COL,28,82,44,63,107
40,8477492,Nathan MacKinnon,C,COL,29,82,35,72,107
40,8481559,Jack Hughes,C,NJD,23,82,34,68,102
40,8480027,Jason Robertson,L,DAL,25,82,39,60,99
40,8479314,Matthew Tkachuk,L,FLA,27,82,34,63,97
40,8477934,Leon Draisaitl,C,EDM,29,82,35,61,96
40,8477493,Aleksander Barkov,C,FLA,29,82,31,63,94
40,8476887,Filip Forsberg,L,NSH,30,82,48,44,92
40,8474564,Steven Stamkos,C,TBL,34,82,38,53,91
40,8471675,Sidney Crosby,C,PIT,37,82,36,54,90
40,8477956,David Pastrnak,R,BOS,28,82,43,45,88
40,8477404,Jake Guentzel,C,CAR,30,82,37,51,88
40,8480002,Nico Hischier,C,NJD,25,82,30,58,88
40,8477933,Sam Reinhart,C,FLA,29,82,37,50,87
40,8480069,Cale Makar,D,COL,26,82,24,63,87
40,8481523,Kirby Dach,C,MTL,23,82,11,76,87
40,8477939,William Nylander,R,TOR,28,82,39,44,83
40,8478864,Kirill Kaprizov,L,MIN,27,82,30,52,82
40,8478550,Artemi Panarin,L,NYR,33,82,32,49,81
40,8478439,Travis Konecny,R,PHI,27,82,38,42,80
40,8477402,Pavel Buchnevich,L,STL,29,82,29,51,80
40,8476468,J.T. Miller,C,VAN,31,82,34,45,79
40,8477946,Dylan Larkin,C,DET,28,82,34,45,79
40,8477949,Alex Tuch,R,BUF,28,82,26,53,79
40,8479420,Tage Thompson,C,BUF,27,82,41,37,78
40,8479407,Jesper Bratt,L,NJD,26,82,27,50,77
40,8475172,Nazem Kadri,C,CGY,34,82,19,58,77
40,8480800,Quinn Hughes,D,VAN,25,82,11,66,77
40,8477960,Adrian Kempe,R,LAK,28,82,34,42,76
40,8480023,Robert Thomas,C,STL,25,82,23,53,76
40,8474590,John Carlson,D,WSH,34,82,17,59,76
40,8475167,Victor Hedman,D,TBL,34,82,15,61,76
40,8478403,Jack Eichel,C,VGK,28,82,37,38,75
40,8480036,Miro Heiskanen,D,DAL,25,82,12,63,75
40,8480801,Brady Tkachuk,L,OTT,25,82,28,46,74
40,8482116,Tim Stützle,C,OTT,22,82,27,47,74
40,8480830,Andrei Svechnikov,R,CAR,24,82,24,50,74
40,8478427,Sebastian Aho,C,CAR,27,82,35,38,73
40,8475184,Chris Kreider,L,NYR,33,82,39,33,72
40,8475692,Mats Zuccarello,R,MIN,37,82,24,48,72
40,8480208,Drake Batherson,R,OTT,26,82,34,37,71
40,8480012,Elias Pettersson,C,VAN,26,82,32,39,71
40,8475166,John Tavares,C,TOR,34,82,30,41,71
40,8479385,Jordan Kyrou,C,STL,26,82,30,41,71
40,8478398,Kyle Connor,L,WPG,28,82,29,42,71
40,8478010,Brayden Point,C,TBL,28,82,33,37,70
40,8476389,Vincent Trocheck,C,NYR,31,82,27,43,70
40,8478042,Viktor Arvidsson,R,LAK,31,82,25,45,70
40,8474600,Roman Josi,D,NSH,34,82,20,50,70
40,8479323,Adam Fox,D,NYR,26,82,16,54,70
40,8473994,Jamie Benn,L,DAL,35,82,29,40,69
40,8471685,Anze Kopitar,C,LAK,37,82,28,41,69
40,8477942,Kevin Fiala,L,LAK,28,82,24,45,69
40,8471214,Alex Ovechkin,L,WSH,39,82,35,33,68
40,8470794,Joe Pavelski,C,DAL,40,82,24,44,68
40,8477501,Valeri Nichushkin,R,COL,29,82,34,33,67
40,8477986,Brandon Montour,D,FLA,30,82,27,40,67
40,8477955,Jared McCann,L,SEA,28,82,25,42,67
40,8482684,Luke Hughes,D,NJD,21,82,22,45,67
40,8478460,Zach Werenski,D,CBJ,27,82,15,52,67
40,8475786,Zach Hyman,L,EDM,32,82,38,28,66
40,8478414,Timo Meier,R,NJD,28,82,32,34,66
40,8476881,Tomas Hertl,C,VGK,31,82,27,39,66
40,8477409,Carter Verhaeghe,C,FLA,29,82,26,40,66
40,8476454,Ryan Nugent-Hopkins,C,EDM,31,82,13,53,66
40,8473419,Brad Marchand,L,BOS,36,82,28,37,65
40,8475170,Brayden Schenn,C,STL,33,82,18,47,65
40,8476853,Morgan Rielly,D,TOR,30,82,16,49,65
40,8475754,Brock Nelson,C,NYI,33,82,35,29,64
40,8475913,Mark Stone,R,VGK,32,82,21,43,64
40,8479343,Clayton Keller,R,ARI,26,82,23,40,63
40,8476462,Dougie Hamilton,D,NJD,31,82,23,40,63
40,8481557,Matt Boldy,L,MIN,23,82,18,45,63
40,8471215,Evgeni Malkin,C,PIT,38,82,33,29,62
40,8479542,Brandon Hagel,L,TBL,26,82,28,33,61
40,8474141,Patrick Kane,R,DET,36,82,19,42,61
40,8478444,Brock Boeser,R,VAN,27,82,31,29,60
40,8476448,William Karlsson,C,VGK,31,82,27,33,60
40,8480014,Gabriel Vilardi,C,WPG,25,82,27,33,60
40,8475765,Vladimir Tarasenko,R,FLA,33,82,22,38,60
40,8476346,Johnny Gaudreau,L,CBJ,31,82,17,43,60
40,8474578,Erik Karlsson,D,PIT,34,82,14,46,60
40,8478445,Mathew Barzal,C,NYI,27,82,12,48,60
40,8481540,Cole Caufield,R,MTL,23,82,33,26,59
40,8482159,Tyson Foerster,R,PHI,22,82,28,31,59
40,8477951,Nick Schmaltz,C,ARI,28,82,23,36,59
40,8478493,Joel Eriksson Ek,C,MIN,27,82,33,25,58
40,8481068,Yegor Sharangovich,C,CGY,26,82,31,27,58
40,8478440,Dylan Strome,C,WSH,27,82,27,31,58
40,8480018,Nick Suzuki,C,MTL,25,82,25,33,58
40,8476459,Mika Zibanejad,C,NYR,31,82,24,34,58
40,8477496,Elias Lindholm,C,VAN,30,82,19,38,57
40,8473512,Claude Giroux,R,OTT,36,82,19,37,56
40,8476456,Jonathan Huberdeau,C,CGY,31,82,14,42,56
40,8480803,Evan Bouchard,D,EDM,25,82,11,45,56
40,8475158,Ryan O'Reilly,C,NSH,33,82,23,32,55
40,8482078,Lucas Raymond,L,DET,22,82,23,32,55
40,8480188,Fabian Zetterlund,L,SJS,25,82,22,33,55
40,8475745,Charlie Coyle,C,BOS,32,82,21,34,55
40,8475798,Mikael Granlund,C,SJS,32,82,20,35,55
40,8475726,Tyler Toffoli,C,WPG,32,82,34,20,54
40,8475810,Bryan Rust,R,PIT,32,82,27,27,54
40,8479675,Trevor Moore,L,LAK,29,82,26,28,54
40,8480015,Owen Tippett,R,PHI,25,82,25,29,54
40,8475794,Tyler Seguin,C,DAL,32,82,25,29,54
40,8476438,Brandon Saad,L,STL,32,82,24,30,54
40,8476875,Mike Matheson,D,MTL,30,82,20,34,54
40,8476460,Mark Scheifele,C,WPG,31,82,19,35,54
40,8477479,Tyler Bertuzzi,L,TOR,29,82,18,36,54
40,8479325,Charlie McAvoy,D,BOS,27,82,9,45,54
40,8477407,Anthony Duclair,L,TBL,29,82,27,26,53
40,8480797,Joel Farabee,L,PHI,24,82,18,35,53
40,8476906,Shayne Gostisbehere,D,DET,31,82,11,42,53
40,8477447,Shea Theodore,D,VGK,29,82,11,42,53
40,8471724,Kris Letang,D,PIT,37,82,5,48,53
40,8478449,Roope Hintz,C,DAL,28,82,31,21,52
40,8478366,Frank Vatrano,R,ANA,30,82,27,25,52
40,8475168,Matt Duchene,C,DAL,33,82,22,30,52
40,8477416,Oliver Bjorkstrand,R,SEA,29,82,21,31,52
40,8482097,Jack Quinn,R,BUF,23,82,20,32,52
40,8473986,Alex Killorn,L,ANA,35,82,17,35,52
40,8476432,Boone Jenner,C,CBJ,31,82,31,20,51
40,8471698,T.J. Oshie,R,WSH,38,82,30,21,51
40,8477476,Artturi Lehkonen,L,COL,29,82,24,27,51
40,8478873,Troy Terry,R,ANA,27,82,18,33,51
40,8478975,Mason Marchment,L,DAL,29,82,15,36,51
40,8475197,Tyson Barrie,D,NSH,33,82,12,39,51
40,8480434,Sean Durzi,D,ARI,26,82,8,43,51
40,8481699,Aku Raty,R,ARI,23,82,6,45,51
40,8474157,Max Pacioretty,L,WSH,36,82,22,28,50
40,8477497,Sean Monahan,C,WPG,30,82,20,30,50
40,8475763,Kevin Hayes,R,STL,32,82,18,32,50
40,8479410,Mikhail Sergachev,D,TBL,26,82,12,38,50
40,8478407,Vince Dunn,D,SEA,28,82,10,40,50
40,8480865,Noah Dobson,D,NYI,24,82,5,45,50
40,8479337,Alex DeBrincat,R,DET,27,82,26,23,49
40,8474102,David Perron,L,DET,36,82,25,24,49
40,8483808,Andrei Kuzmenko,L,CGY,28,82,21,28,49
40,8476882,Teuvo Teravainen,L,CAR,30,82,20,29,49
40,8478519,Anthony Cirelli,C,TBL,27,82,19,30,49
40,8477346,MacKenzie Weegar,D,CGY,30,82,16,33,49
40,8479999,Casey Mittelstadt,C,COL,26,82,14,35,49
40,8477494,Jonathan Drouin,L,COL,29,82,14,35,49
40,8478038,Devon Toews,D,COL,30,82,13,36,49
40,8477504,Josh Morrissey,D,WPG,29,82,9,40,49
40,8480064,Josh Norris,C,OTT,25,82,24,24,48
40,8475169,Evander Kane,L,EDM,33,82,23,25,48
40,8476399,Blake Coleman,C,CGY,33,82,23,25,48
40,8477935,Sam Bennett,C,FLA,28,82,17,31,48
40,8476905,Chandler Stephenson,C,VGK,30,82,15,33,48
40,8476792,Torey Krug,D,STL,33,82,13,35,48
40,8477500,Bo Horvat,C,NYI,29,82,30,17,47
40,8482699,Dylan Guenther,R,ARI,21,82,27,20,47
40,8477426,Nicholas Paul,L,TBL,29,82,23,24,47
40,8482740,Wyatt Johnston,C,DAL,21,82,21,26,47
40,8477940,Nikolaj Ehlers,L,WPG,28,82,19,28,47
40,8483515,Juraj Slafkovsky,L,MTL,20,82,17,30,47
40,8478469,Thomas Chabot,D,OTT,27,82,16,31,47
40,8483397,Marc McLaughlin,C,BOS,25,82,43,3,46
40,8476539,Jonathan Marchessault,R,VGK,34,82,28,18,46
40,8474150,Mikael Backlund,C,CGY,35,82,21,25,46
40,8478498,Jake DeBrusk,L,BOS,28,82,19,27,46
40,8481528,Dylan Cozens,C,BUF,23,82,19,27,46
40,8478401,Pavel Zacha,C,BOS,27,82,17,29,46
40,8474679,Gustav Nyquist,C,NSH,35,82,14,32,46
40,8480031,Maxime Comtois,L,CAR,25,82,14,32,46
40,8479400,Pierre-Luc Dubois,L,LAK,26,82,23,22,45
40,8482113,Anton Lundell,C,FLA,23,82,18,27,45
40,8477021,Alex Kerfoot,C,ARI,30,82,14,31,45
40,8477444,Andre Burakovsky,L,SEA,29,82,14,31,45
40,8475744,Evgeny Kuznetsov,C,CAR,32,82,10,35,45
40,8476880,Tom Wilson,R,WSH,30,82,19,25,44
40,8479992,Michael Rasmussen,C,DET,25,82,19,25,44
40,8480039,Martin Necas,C,CAR,25,82,18,26,44
40,8479339,Patrik Laine,L,CBJ,26,82,16,28,44
40,8482146,Luke Evangelista,R,NSH,22,82,15,29,44
40,8482124,Quinton Byfield,R,LAK,22,82,15,29,44
40,8480078,Filip Chytil,C,NYR,25,82,12,32,44
40,8473563,Nicklas Backstrom,C,WSH,37,82,9,35,44
40,8481596,Shane Pinto,C,OTT,24,82,22,21,43
40,8477964,Ivan Barbashev,C,VGK,29,82,14,29,43
40,8475753,Justin Faulk,D,STL,32,82,13,30,43
40,8479425,Filip Hronek,D,VAN,27,82,9,34,43
40,8483471,Brad Lambert,C,WPG,31,82,8,35,43
40,8482089,Jake Neighbours,L,STL,22,82,25,17,42
40,8475784,Jeff Skinner,C,BUF,32,82,24,18,42
40,8474641,Adam Henrique,C,EDM,34,82,22,20,42
40,8476873,Mark Jankowski,C,NSH,30,82,22,20,42
40,8482475,Yegor Chinakhov,R,CBJ,23,82,17,25,42
40,8480839,Rasmus Dahlin,D,BUF,24,82,13,29,42
40,8476826,Yanni Gourde,C,SEA,33,82,13,29,42
40,8482110,Dawson Mercer,C,NJD,23,82,21,20,41
40,8475722,Jason Zucker,L,NSH,32,82,20,21,41
40,8482093,Seth Jarvis,C,CAR,22,82,19,22,41
40,8480798,Philipp Kurashev,C,CHI,25,82,16,25,41
40,8478462,Nicolas Roy,C,VGK,27,82,15,26,41
40,8476458,Ryan Strome,C,ANA,31,82,15,26,41
40,8477953,Kasperi Kapanen,R,STL,28,82,15,26,41
40,8481533,Trevor Zegras,C,ANA,23,82,13,28,41
40,8477503,Max Domi,C,TOR,29,82,13,28,41
40,8476923,Damon Severson,D,CBJ,30,82,13,28,41
40,8477948,Travis Sanheim,D,PHI,28,82,9,32,41
40,8481542,Moritz Seider,D,DET,23,82,8,33,41
40,8477451,Ryan Hartman,R,MIN,30,82,25,15,40
40,8479525,Ross Colton,C,COL,28,82,22,18,40
40,8475191,Reilly Smith,R,PIT,33,82,18,22,40
40,8478474,Lawson Crouse,L,ARI,27,82,17,23,40
40,8482175,JJ Peterka,R,BUF,22,82,17,23,40
40,8482101,Danil Gushchin,L,SJS,22,82,17,23,40
40,8482092,Ridly Greig,C,OTT,22,82,17,23,40
40,8482109,Alexis Lafrenière,L,NYR,23,82,15,25,40
40,8483445,Cutter Gauthier,L,ANA,20,82,13,27,40
40,8479345,Jakob Chychrun,D,OTT,26,82,12,28,40
40,8476958,Jaccob Slavin,D,CAR,30,82,11,29,40
40,8474565,Alex Pietrangelo,D,VGK,34,82,4,36,40
40,8480849,Barrett Hayton,C,ARI,24,82,25,14,39
40,8475151,Kyle Palmieri,C,NYI,33,82,20,19,39
40,8482665,Matty Beniers,C,SEA,22,82,19,20,39
40,8480028,Morgan Frost,C,PHI,25,82,16,23,39
40,8480893,Kirill Marchenko,R,CBJ,24,82,15,24,39
40,8477989,Christian Dvorak,C,MTL,28,82,15,24,39
40,8482705,Cole Sillinger,C,CBJ,21,82,14,25,39
40,8478047,Michael Bunting,L,PIT,29,82,13,26,39
40,8475791,Taylor Hall,L,CHI,33,82,13,26,39
40,8482667,William Eklund,L,SJS,22,82,12,27,39
40,8482671,Owen Power,D,BUF,22,82,10,29,39
40,8474563,Drew Doughty,D,LAK,35,82,8,31,39
40,8478397,Rasmus Andersson,D,CGY,28,82,6,33,39
40,8478466,Daniel Sprong,R,DET,27,82,23,15,38
40,8480459,Pius Suter,C,VAN,28,82,22,16,38
40,8481711,Matias Maccelli,L,ARI,24,82,20,18,38
40,8477952,Robby Fabbri,C,DET,28,82,17,21,38
40,8478542,Evan Rodrigues,C,FLA,31,82,16,22,38
40,8481618,Alex Newhook,C,MTL,23,82,16,22,38
40,8482702,Logan Stankoven,C,DAL,21,82,16,22,38
40,8480220,Noah Cates,L,PHI,25,82,15,23,38
40,8476872,Scott Laughton,C,PHI,30,82,15,23,38
40,8482745,Mason McTavish,C,ANA,21,82,14,24,38
40,8478458,Jack Roslovic,C,NYR,27,82,13,25,38
40,8477932,Aaron Ekblad,D,FLA,28,82,12,26,38
40,8478856,Conor Garland,R,VAN,28,82,12,26,38
40,8476461,Sean Couturier,C,PHI,32,82,12,26,38
40,8478472,Mathieu Joseph,R,OTT,27,82,11,27,38
40,8477495,Seth Jones,D,CHI,30,82,6,32,38
40,8475314,Anders Lee,L,NYI,34,82,25,12,37
40,8476483,Rickard Rakell,R,PIT,31,82,21,16,37
40,8475799,Nino Niederreiter,R,WPG,32,82,19,18,37
40,8477429,Andrew Copp,C,DET,30,82,17,20,37
40,8475287,Erik Haula,L,NJD,33,82,16,21,37
40,8479996,Cody Glass,C,NSH,25,82,16,21,37
40,8484144,Connor Bedard,C,CHI,19,82,15,22,37
40,8474586,Jordan Eberle,R,SEA,34,82,14,23,37
40,8479351,Sam Steel,C,DAL,26,82,14,23,37
40,8476329,Travis Boyd,C,ARI,31,82,12,25,37
40,8480873,Rasmus Sandin,D,WSH,24,82,8,29,37
40,8470613,Brent Burns,D,CAR,39,82,6,31,37
40,8478178,Darren Raddysh,D,TBL,28,82,6,31,37
40,8480009,Eeli Tolvanen,R,SEA,25,82,21,15,36
40,8478233,Andrew Mangiapane,L,CGY,28,82,20,16,36
40,8476469,Joel Armia,R,MTL,31,82,20,16,36
40,8483524,Shane Wright,C,SEA,20,82,19,17,36
40,8479941,Justin Danforth,R,CBJ,31,82,19,17,36
40,8475768,Jaden Schwartz,C,SEA,32,82,17,19,36
40,8477998,Warren Foegele,L,EDM,28,82,16,20,36
40,8476292,Ondrej Palat,L,NJD,33,82,16,20,36
40,8482133,Thomas Bordeleau,C,SJS,22,82,15,21,36
40,8474149,Evgenii Dadonov,R,DAL,35,82,15,21,36
40,8478057,Dakota Joshua,C,VAN,28,82,14,22,36
40,8479591,Michael Eyssimont,C,TBL,28,82,13,23,36
40,8478438,Tommy Novak,C,NSH,27,82,12,24,36
40,8482222,Alexander Barabanov,L,SJS,30,82,11,25,36
40,8481581,Thomas Harley,D,DAL,23,82,8,28,36
40,8476892,Colton Parayko,D,STL,31,82,8,28,36
40,8481535,Nils Hoglander,L,VAN,24,82,24,11,35
40,8474189,Lars Eller,C,PIT,35,82,18,17,35
40,8475760,Nick Bjugstad,C,ARI,32,82,17,18,35
40,8476392,Adam Lowry,C,WPG,31,82,15,20,35
40,8477947,Sonny Milano,L,WSH,28,82,14,21,35
40,8473422,Nick Foligno,L,CHI,37,82,13,22,35
40,8474037,James van Riemsdyk,L,BOS,35,82,10,25,35
40,8476463,Jonas Brodin,D,MIN,31,82,5,30,35
40,8477944,Jakub Vrana,L,STL,28,82,25,9,34
40,8484166,Adam Fantilli,C,CBJ,20,82,19,15,34
40,8477015,Connor Brown,R,EDM,30,82,18,16,34
40,8478133,Jake Evans,C,MTL,28,82,16,18,34
40,8478463,Anthony Beauvillier,L,NSH,27,82,12,22,34
40,8481580,Connor McMichael,C,WSH,23,82,12,22,34
40,8478046,Danton Heinen,L,BOS,29,82,12,22,34
40,8481606,Jordan Spence,D,LAK,23,82,10,24,34
40,8475906,John Klingberg,D,TOR,32,82,8,26,34
40,8475764,Cam Fowler,D,ANA,33,82,4,30,34
40,8476981,Josh Anderson,R,MTL,30,82,19,14,33
40,8473449,Kyle Okposo,R,FLA,36,82,16,17,33
40,8474053,Logan Couture,C,SJS,35,82,15,18,33
40,8482624,Daniil Miromanov,D,CGY,27,82,12,21,33
40,8475164,Jakob Silfverberg,R,ANA,34,82,12,21,33
40,8476869,Brady Skjei,D,CAR,30,82,11,22,33
40,8478413,Jordan Greenway,L,BUF,27,82,10,23,33
40,8479987,Morgan Geekie,C,BOS,26,82,9,24,33
40,8476479,Phillip Danault,C,LAK,31,82,8,25,33
40,8478891,Mason Appleton,C,WPG,28,82,6,27,33
40,8478882,Vladislav Gavrikov,D,LAK,29,82,6,27,33
40,8482142,Jamie Drysdale,D,PHI,22,82,5,28,33
40,8480185,Eetu Luostarinen,C,FLA,26,82,15,17,32
40,8479977,Kailer Yamamoto,R,SEA,26,82,15,17,32
40,8471218,Blake Wheeler,R,NYR,38,82,11,21,32
40,8473533,Jordan Staal,C,CAR,36,82,11,21,32
40,8477456,J.T. Compher,L,DET,29,82,10,22,32
40,8478396,Noah Hanifin,D,VGK,27,82,7,25,32
40,8475793,Ryan Johansen,C,PHI,32,82,20,11,31
40,8482079,Marco Rossi,C,MIN,23,82,17,14,31
40,8477353,Tyler Motte,C,TBL,29,82,16,15,31
40,8476480,Vladislav Namestnikov,C,WPG,32,82,14,17,31
40,8479293,Brandon Tanev,L,SEA,33,82,13,18,31
40,8478115,Pierre Engvall,L,NYI,28,82,12,19,31
40,8477511,Anthony Mantha,R,VGK,30,82,11,20,31
40,8481013,Jonatan Berggren,R,DET,24,82,7,24,31
40,8482105,Jake Sanderson,D,OTT,22,82,6,25,31
40,8476854,Hampus Lindholm,D,BOS,30,82,6,25,31
40,8481016,Ruslan Iskhakov,C,NYI,24,82,1,30,31
40,8481554,Kaapo Kakko,R,NYR,23,82,21,9,30
40,8480113,Alex Iafallo,L,WPG,31,82,20,10,30
40,8474715,Cam Atkinson,R,PHI,35,82,15,15,30
40,8474870,Tyler Johnson,C,CHI,34,82,13,17,30
40,8480796,Martin Fehervary,D,WSH,25,82,10,20,30
40,8481624,Ilya Mikheyev,R,VAN,30,82,9,21,30
40,8482720,Matthew Knies,L,TOR,22,82,9,21,30
40,8481703,Valtteri Puustinen,R,PIT,25,82,8,22,30
40,8481546,Cam York,D,PHI,23,82,7,23,30
40,8483457,Lane Hutson,D,MTL,20,82,4,26,30
40,8481604,Pavel Dorofeyev,L,VGK,24,82,20,9,29
40,8484153,Leo Carlsson,C,ANA,20,82,17,12,29
40,8479390,Taylor Raddysh,R,CHI,26,82,15,14,29
40,8479415,Michael McLeod,C,NJD,26,82,10,19,29
40,8480043,Timothy Liljegren,D,TOR,25,82,9,20,29
40,8480871,Adam Boqvist,D,CBJ,24,82,9,20,29
40,8482111,Justin Barron,D,MTL,23,82,9,20,29
40,8480074,Alexandre Texier,C,CBJ,25,82,9,20,29
40,8481656,Aliaksei Protas,C,WSH,23,82,8,21,29
40,8482655,J.J. Moser,D,ARI,24,82,8,21,29
40,8475218,Mattias Ekholm,D,EDM,34,82,6,23,29
40,8474673,TJ Brodie,D,TOR,34,82,5,24,29
40,8480821,Filip Zadina,R,SJS,25,82,20,8,28
40,8479359,Beck Malenstyn,L,WSH,26,82,18,10,28
40,8483431,Logan Cooley,C,ARI,20,82,15,13,28
40,8476871,Tanner Pearson,L,MTL,32,82,13,15,28
40,8482055,Drew O'Connor,L,PIT,26,82,12,16,28
40,8476921,Jordan Martinook,L,CAR,32,82,12,16,28
40,8478109,Victor Olofsson,L,BUF,29,82,12,16,28
40,8483491,Ivan Miroshnichenko,L,WSH,20,82,11,17,28
40,8474884,Mike Hoffman,C,SJS,35,82,10,18,28
40,8476278,Colin Blackwell,C,CHI,31,82,10,18,28
40,8479365,Trent Frederic,C,BOS,26,82,9,19,28
40,8478055,Gustav Forsling,D,FLA,28,82,9,19,28
40,8475714,Calle Jarnkrok,C,TOR,33,82,8,20,28
40,8479998,Mikey Anderson,D,LAK,25,82,6,22,28
40,8482245,Artem Zub,D,OTT,29,82,5,23,28
40,8476902,Esa Lindell,D,DAL,30,82,4,24,28
40,8483493,Frank Nazar,C,CHI,20,82,24,3,27
40,8479423,Alex Nylander,L,CBJ,26,82,19,8,27
40,8470610,Zach Parise,L,COL,40,82,16,11,27
40,8480802,Ryan McLeod,C,EDM,25,82,14,13,27
40,8482259,Bobby McMann,C,TOR,28,82,14,13,27
40,8481704,Juuso Parssinen,C,NSH,23,82,13,14,27
40,8479316,Luke Kunin,C,SJS,27,82,13,14,27
40,8477330,Dominik Kubalik,L,OTT,29,82,12,15,27
40,8477450,Jason Dickinson,C,CHI,29,82,11,16,27
40,8476960,Andreas Athanasiou,C,CHI,30,82,8,19,27
40,8477839,Conor Sheary,L,TBL,32,82,7,20,27
40,8480145,Neal Pionk,D,WPG,29,82,6,21,27
40,8476979,Erik Gustafsson,D,NYR,32,82,5,22,27
40,8482122,Brock Faber,D,MIN,22,82,5,22,27
40,8477488,Brett Pesce,D,CAR,30,82,5,22,27
40,8474034,Pat Maroon,L,BOS,36,82,5,22,27
40,8474716,Jared Spurgeon,D,MIN,35,82,3,24,27
40,8482118,Sam Colangelo,R,ANA,23,82,19,7,26
40,8481560,Arthur Kaliyev,R,LAK,23,82,17,9,26
40,8481477,Nico Sturm,C,SJS,29,82,16,10,26
40,8481186,Logan O'Connor,R,COL,28,82,14,12,26
40,8476419,Jean-Gabriel Pageau,C,NYI,32,82,11,15,26
40,8481524,Bowen Byram,D,BUF,23,82,10,16,26
40,8477506,Ryan Pulock,D,NYI,30,82,8,18,26
40,8482087,Kaiden Guhle,D,MTL,22,82,7,19,26
40,8480336,Sean Walker,D,COL,30,82,6,20,26
40,8478500,Ivan Provorov,D,CBJ,27,82,6,20,26
40,8481014,Alexander Romanov,D,NYI,24,82,6,20,26
40,8478851,Alexandre Carrier,D,NSH,28,82,6,20,26
40,8477498,Darnell Nurse,D,EDM,29,82,5,21,26
40,8478020,Michael Amadio,C,VGK,28,82,13,12,25
40,8475231,Casey Cizikas,C,NYI,33,82,12,13,25
40,8476897,Oskar Sundqvist,C,STL,30,82,11,14,25
40,8480448,Parker Kelly,L,OTT,25,82,10,15,25
40,8481522,Peyton Krebs,C,BUF,23,82,9,16,25
40,8476422,Mike Reilly,D,NYI,31,82,9,16,25
40,8474009,Nick Bonino,C,NYR,36,82,9,16,25
40,8476917,Adam Pelech,D,NYI,30,82,8,17,25
40,8479369,Andrew Peeke,D,BOS,26,82,5,20,25
40,8470600,Ryan Suter,D,DAL,39,82,4,21,25
40,8478507,John Marino,D,NJD,27,82,3,22,25
40,8475179,Dmitry Kulikov,D,FLA,34,82,0,25,25
40,8479393,Noah Gregor,C,TOR,26,82,16,8,24
40,8480980,Connor Dewar,C,TOR,25,82,8,16,24
40,8476331,Dylan DeMelo,D,WPG,31,82,6,18,24
40,8476891,Matt Grzelcyk,D,BOS,30,82,6,18,24
40,8480817,K'Andre Miller,D,NYR,24,82,5,19,24
40,8475200,Dmitry Orlov,D,CAR,33,82,4,20,24
40,8476931,Jake McCabe,D,TOR,31,82,4,20,24
40,8481537,Nikita Okhotiuk,D,CGY,24,82,4,20,24
40,8482733,Logan Mailloux,D,MTL,31,82,3,21,24
40,8481178,Egor Zamula,D,PHI,24,82,2,22,24
40,8480246,Nick Perbix,D,TBL,26,82,1,23,24
40,8481568,Alex Vlasic,D,CHI,23,82,1,23,24
40,8479661,Tanner Jeannot,L,TBL,27,82,11,12,23
40,8479346,Dillon Dube,C,CGY,26,82,11,12,23
40,8482679,Matt Coronato,R,CGY,22,82,10,13,23
40,8476885,Jacob Trouba,D,NYR,30,82,8,15,23
40,8483490,Pavel Mintyukov,D,ANA,21,82,7,16,23
40,8480806,Isac Lundestrom,C,ANA,25,82,6,17,23
40,8475188,Brayden McNabb,D,VGK,33,82,4,19,23
40,8474151,Ryan McDonagh,D,NSH,35,82,4,19,23
40,8475171,Oliver Ekman-Larsson,D,FLA,33,82,3,20,23
40,8473507,Jeff Petry,D,DET,37,82,3,20,23
40,8480073,Erik Brannstrom,D,OTT,25,82,3,20,23
40,8479371,Dante Fabbro,D,NSH,26,82,0,23,23
40,8484203,Bradly Nadeau,L,CAR,19,82,17,5,22
40,8475848,Brendan Gallagher,R,MTL,32,82,13,9,22
40,8476878,Zemgus Girgensons,L,BUF,30,82,13,9,22
40,8481517,Brett Leason,R,ANA,25,82,12,10,22
40,8479353,Brett Howden,C,VGK,26,82,11,11,22
40,8477919,Frederick Gaudreau,C,MIN,31,82,10,12,22
40,8480281,Alexey Toropchenko,R,STL,25,82,9,13,22
40,8482074,Connor Zary,C,CGY,23,82,8,14,22
40,8475220,Marcus Foligno,L,MIN,33,82,8,14,22
40,8476457,Adam Larsson,D,SEA,32,82,7,15,22
40,8477505,Alexander Wennberg,C,NYR,30,82,6,16,22
40,8483495,Simon Nemec,D,NJD,20,82,5,17,22
40,8470604,Jeff Carter,C,PIT,39,82,12,9,21
40,8482155,Alex Laferriere,R,LAK,23,82,11,10,21
40,8482125,Alexander Holtz,R,NJD,22,82,10,11,21
40,8477392,Hudson Fasching,R,NYI,29,82,10,11,21
40,8480068,Ryan Poehling,C,PHI,25,82,8,13,21
40,8478451,Ethan Bear,D,WSH,27,82,8,13,21
40,8477508,Curtis Lazar,C,NJD,29,82,8,13,21
40,8482117,Lukas Reichel,L,CHI,22,82,7,14,21
40,8481093,Rafael Harvey-Pinard,L,MTL,25,82,7,14,21
40,8478399,Jonas Siegenthaler,D,NJD,27,82,7,14,21
40,8481553,Bobby Brink,R,PHI,23,82,6,15,21
40,8476374,Sean Kuraly,C,CBJ,31,82,5,16,21
40,8478859,Niko Mikkola,D,FLA,28,82,3,18,21
40,8478911,Matt Roy,D,LAK,29,82,2,19,21
40,8473453,Trevor Lewis,C,LAK,37,82,11,9,20
40,8478831,Kevin Stenlund,C,FLA,28,82,10,10,20
40,8476312,Josh Manson,D,COL,33,82,10,10,20
40,8483499,Liam Ohgren,L,MIN,20,82,9,11,20
40,8479383,Boris Katchouk,L,OTT,26,82,9,11,20
40,8480879,Jacob Bernard-Docker,D,OTT,24,82,6,14,20
40,8479398,Samuel Girard,D,COL,26,82,5,15,20
40,8476525,Colin Miller,D,WPG,32,82,5,15,20
40,8475177,Calvin de Haan,D,TBL,33,82,5,15,20
40,8475324,Nick Jensen,D,WSH,34,82,4,16,20
40,8480860,Kevin Bahl,D,NJD,24,82,4,16,20
40,8481059,Scott Perunovich,D,STL,26,82,4,16,20
40,8477499,Rasmus Ristolainen,D,PHI,30,82,3,17,20
40,8482516,Matthew Kessel,D,STL,24,82,3,17,20
40,8476879,Cody Ceci,D,EDM,31,82,2,18,20
40,8482145,Mavrik Bourque,C,DAL,22,82,13,6,19
40,8470621,Corey Perry,R,EDM,39,82,11,8,19
40,8482713,Mackie Samoskevich,R,FLA,22,82,11,8,19
40,8476925,Colton Sissons,C,NSH,31,82,9,10,19
40,8478043,Sam Lafferty,C,VAN,29,82,9,10,19
40,8476624,Barclay Goodrow,C,NYR,31,82,9,10,19
40,8482730,Brandt Clarke,D,LAK,21,82,8,11,19
40,8476927,Teddy Blueger,C,VAN,30,82,7,12,19
40,8482062,Cole Smith,L,NSH,29,82,7,12,19
40,8478430,Oliver Kylington,D,CGY,27,82,7,12,19
40,8477425,Miles Wood,L,COL,29,82,6,13,19
40,8475149,Marcus Johansson,L,MIN,34,82,5,14,19
40,8479514,Rem Pitlick,C,CHI,27,82,5,14,19
40,8484145,Zach Benson,L,BUF,19,82,5,14,19
40,8476429,Scott Mayfield,D,NYI,32,82,4,15,19
40,8478013,Jake Walman,D,DET,28,82,4,15,19
40,8480172,Jan Rutta,D,SJS,34,82,4,15,19
40,8475181,Nick Leddy,D,STL,33,82,0,19,19
40,8480813,Joe Veleno,C,DET,24,82,9,9,18
40,8478569,Noel Acciari,C,PIT,33,82,9,9,18
40,8483505,Matthew Poitras,C,BOS,20,82,9,9,18
40,8478508,Yakov Trenin,C,COL,27,82,9,9,18
40,8477931,Tomas Nosek,L,NJD,32,82,9,9,18
40,8481028,Martin Pospisil,C,CGY,25,82,8,10,18
40,8476473,Connor Murphy,D,CHI,31,82,7,11,18
40,8480144,David Kampf,C,TOR,29,82,6,12,18
40,8481481,Blake Lizotte,C,LAK,27,82,6,12,18
40,8477220,Nate Schmidt,D,WPG,33,82,5,13,18
40,8479324,Ryan Lindgren,D,NYR,26,82,5,13,18
40,8483565,Nick Blankenburg,D,CBJ,26,82,5,13,18
40,8475462,Radko Gudas,D,ANA,34,82,4,14,18
40,8476967,Brett Kulak,D,EDM,30,82,3,15,18
40,8479983,Mario Ferraro,D,SJS,26,82,3,15,18
40,8479976,Juuso Valimaki,D,ARI,26,82,2,16,18
40,8478840,Will Borgen,D,SEA,28,82,2,16,18
40,8482712,Oskar Olausson,R,COL,22,82,2,16,18
40,8477845,Trevor van Riemsdyk,D,WSH,33,82,1,17,18
40,8480855,Jack McBain,C,ARI,24,82,8,9,17
40,8482737,Zack Bolduc,C,STL,21,82,8,9,17
40,8483466,Kevin Korchinski,D,CHI,20,82,7,10,17
40,8475842,Sam Carrick,C,EDM,32,82,7,10,17
40,8480058,Pierre-Olivier Joseph,D,PIT,25,82,4,13,17
40,8477435,Ryan Graves,D,PIT,29,82,3,14,17
40,8474166,Alec Martinez,D,VGK,37,82,3,14,17
40,8477335,Kyle Burroughs,D,SJS,29,82,3,14,17
40,8484911,Collin Graf,R,SJS,22,82,2,15,17
40,8474574,Tyler Myers,D,VAN,34,82,1,16,17
40,8478416,Erik Cernak,D,TBL,27,82,7,9,16
40,8475343,Nic Dowd,C,WSH,34,82,6,10,16
40,8482073,Braden Schneider,D,NYR,23,82,6,10,16
40,8477507,Nikita Zadorov,D,VAN,29,82,5,11,16
40,8478408,Travis Dermott,D,ARI,28,82,4,12,16
40,8475279,Ben Chiarot,D,DET,33,82,3,13,16
40,8477969,Marcus Pettersson,D,PIT,28,82,2,14,16
40,8483468,Jiri Kulich,C,BUF,20,82,1,15,16
40,8480807,Mattias Samuelsson,D,BUF,24,82,0,16,16
40,8482809,Jackson Blake,R,CAR,21,82,8,7,15
40,8481601,Simon Holmstrom,R,NYI,23,82,7,8,15
40,8482803,Olen Zellweger,D,ANA,21,82,4,11,15
40,8482166,Shakir Mukhamadullin,D,SJS,22,82,4,11,15
40,8475455,Brenden Dillon,D,WPG,34,82,3,12,15
40,8476372,Nick Seeler,D,PHI,31,82,2,13,15
40,8475790,Erik Gudbranson,D,CBJ,32,82,1,14,15
40,8483763,Maksymilian Szuber,D,ARI,22,82,6,8,14
40,8475233,David Savard,D,MTL,34,82,5,9,14
40,8470966,Mark Giordano,D,TOR,41,82,4,10,14
40,8477369,Carson Soucy,D,VAN,30,82,4,10,14
40,8478443,Brandon Carlo,D,BOS,28,82,4,10,14
40,8482762,Simon Edvinsson,D,DET,21,82,4,10,14
40,8481567,Henry Thrun,D,SJS,23,82,3,11,14
40,8478136,Jake Middleton,D,MIN,28,82,3,11,14
40,8482858,Ryker Evans,D,SEA,23,82,2,12,14
40,8475762,Derek Forbort,D,BOS,32,82,1,13,14
40,8482470,Ilya Solovyov,D,CGY,24,82,1,13,14
40,8476915,Jujhar Khaira,L,MIN,30,82,7,6,13
40,8476442,Matt Nieto,L,PIT,32,82,6,7,13
40,8479980,Nicolas Hague,D,VGK,26,82,5,8,13
40,8480834,Ty Emberson,D,SJS,24,82,4,9,13
40,8481605,Jackson LaCombe,D,ANA,23,82,4,9,13
40,8474567,Zach Bogosian,D,MIN,34,82,4,9,13
40,8475690,Chris Tanev,D,DAL,35,82,3,10,13
40,8473504,Cal Clutterbuck,R,NYI,37,82,2,11,13
40,8475825,Jani Hakanpää,D,DAL,32,82,2,11,13
40,8482177,Marat Khusnutdinov,C,MIN,22,82,1,12,13
40,8480035,Henri Jokiharju,D,BUF,25,82,0,13,13
40,8476858,Phillip Di Giuseppe,L,VAN,31,82,8,4,12
40,8483482,Tristan Luneau,D,ANA,20,82,5,7,12
40,8477406,Mattias Janmark,C,EDM,32,82,4,8,12
40,8481599,Victor Soderstrom,D,ARI,23,82,4,8,12
40,8482666,Scott Morrow,D,CAR,22,82,3,9,12
40,8475208,Brian Dumoulin,D,SEA,33,82,2,9,11
40,8477365,Connor Clifton,D,BUF,29,82,1,10,11
40,8474013,Ian Cole,D,VAN,35,82,0,11,11
40,8483012,Logan Morrison,C,SEA,22,82,6,4,10
40,8476822,Luke Glendening,C,TBL,35,82,6,4,10
40,8484149,Gavin Brindley,C,CBJ,20,82,5,5,10
40,8478468,Jeremy Lauzon,D,NSH,27,82,4,6,10
40,8476467,Jamie Oleksiak,D,SEA,32,82,3,7,10
40,8481030,Jack St. Ivany,D,PIT,25,82,1,9,10
40,8480990,Declan Chisholm,D,MIN,24,82,6,3,9
40,8479291,Kevin Rooney,C,CGY,31,82,2,7,9
40,8477034,Jaycob Megna,D,CHI,32,82,1,8,9
40,8481578,Graeme Clarke,R,NJD,23,82,5,3,8
40,8479442,Troy Stecher,D,EDM,30,82,3,5,8
40,8482807,Ethan Del Mastro,D,CHI,21,82,2,6,8
40,8471677,Jack Johnson,D,COL,37,82,1,7,8
40,8483489,Fraser Minten,C,TOR,31,82,2,4,6
40,8482859,Zack Ostapchuk,C,OTT,21,82,1,3,4
40,8482141,Lukas Cormier,D,VGK,22,0,0,0,0
40,8476988,Matt Benning,D,SJS,30,0,0,0,0
40,8480727,Zach Whitecloud,D,VGK,28,0,0,0,0
40,8480887,Jordan Harris,D,MTL,24,0,0,0,0
40,8478450,Parker Wotherspoon,D,BOS,27,0,0,0,0
40,8481812,Nikolai Knyzhov,D,SJS,27,0,0,0,0
40,8480001,Urho Vaakanainen,D,ANA,25,0,0,0,0
40,8482176,Wyatt Kaiser,D,CHI,22,0,0,0,0
40,8481122,Simon Benoit,D,TOR,26,0,0,0,0
40,8476441,Joel Edmundson,D,TOR,31,0,0,0,0
40,8480884,Calen Addison,D,SJS,24,0,0,0,0
40,8482511,Mason Lohrei,D,BOS,23,0,0,0,0
40,8482192,Isaak Phillips,D,CHI,23,0,0,0,0
40,8480950,Ilya Lyubushkin,D,TOR,30,0,0,0,0
40,8474031,Kevin Shattenkirk,D,BOS,35,0,0,0,0
40,8475718,Justin Holl,D,DET,32,0,0,0,0
40,8479402,Jake Bean,D,CBJ,26,0,0,0,0
40,8474602,Justin Schultz,D,SEA,34,0,0,0,0
40,8477950,Tony DeAngelo,D,CAR,29,0,0,0,0
40,8481743,Marc Del Gaizo,D,NSH,25,0,0,0,0
40,8481527,Kaedan Korczak,D,VGK,23,0,0,0,0
40,8480192,Johnathan Kovacevic,D,MTL,27,0,0,0,0
40,8476874,Olli Maatta,D,DET,30,0,0,0,0
40,8482144,Jack Thompson,D,SJS,22,0,0,0,0
40,8480222,Sebastian Aho,D,NYI,28,0,0,0,0
40,8479458,Nikita Zaitsev,D,CHI,33,0,0,0,0
40,8471709,Marc-Edouard Vlasic,D,SJS,37,0,0,0,0
40,8482929,Emil Lilleberg,D,TBL,23,0,0,0,0
40,8477018,Ben Hutton,D,VGK,31,0,0,0,0
40,8481056,Spencer Stastney,D,NSH,24,0,0,0,0
40,8481593,Jayden Struble,D,MTL,23,0,0,0,0
40,8479982,Conor Timmins,D,TOR,26,0,0,0,0
40,8474090,Brendan Smith,D,NJD,35,0,0,0,0
40,8482964,Arber Xhekaj,D,MTL,23,0,0,0,0
40,8480891,Michael Kesselring,D,ARI,24,0,0,0,0
40,8477938,Haydn Fleury,D,TBL,28,0,0,0,0
40,8481806,Louis Crevier,D,CHI,23,0,0,0,0
40,8471274,Alex Goligoski,D,MIN,39,0,0,0,0
40,8481600,Tobias Bjornfot,D,FLA,23,0,0,0,0
40,8475797,Jarred Tinordi,D,CHI,32,0,0,0,0
40,8481521,Ronnie Attard,D,PHI,25,0,0,0,0
40,8474612,Travis Hamonic,D,OTT,34,0,0,0,0
40,8479576,Vincent Desharnais,D,EDM,28,0,0,0,0
40,8480049,Dylan Samberg,D,WPG,25,0,0,0,0
40,8483619,Filip Roos,D,CHI,25,0,0,0,0
40,8474568,Luke Schenn,D,NSH,35,0,0,0,0
40,8480184,Gustav Lindstrom,D,ANA,26,0,0,0,0
40,8480070,Ian Mitchell,D,BOS,25,0,0,0,0
40,8480196,Jacob Bryson,D,BUF,27,0,0,0,0
40,8471686,Marc Staal,D,PHI,37,0,0,0,0
40,8477467,Gustav Olofsson,D,SEA,30,0,0,0,0
40,8478970,Jalen Chatfield,D,CAR,28,0,0,0,0
40,8479348,Kale Clague,D,BUF,26,0,0,0,0
40,8473446,Erik Johnson,D,PHI,36,0,0,0,0
40,8477462,Robert Hagg,D,ANA,29,0,0,0,0
40,8478454,Noah Juulsen,D,VAN,27,0,0,0,0
40,8477384,Josh Brown,D,ARI,30,0,0,0,0
40,8481708,Zac Jones,D,NYR,24,0,0,0,0
40,8481167,Brayden Pachal,D,CGY,25,0,0,0,0
40,8482067,Connor Mackey,D,NYR,28,0,0,0,0
40,8483460,David Jiricek,D,CBJ,21,0,0,0,0
40,8481701,Santeri Hatakka,D,NJD,23,0,0,0,0
40,8478021,William Lagesson,D,ANA,28,0,0,0,0
40,8477851,Jordan Oesterle,D,CGY,32,0,0,0,0
40,8478452,Caleb Jones,D,COL,27,0,0,0,0
40,8479984,Cal Foote,D,NJD,26,0,0,0,0
40,8479639,Dylan Coghlan,D,CAR,26,0,0,0,0
40,8480874,Adam Ginning,D,PHI,24,0,0,0,0
40,8479321,Lucas Johansen,D,WSH,27,0,0,0,0
40,8480878,Nils Lundkvist,D,DAL,24,0,0,0,0
40,8482165,Yan Kuznetsov,D,CGY,22,0,0,0,0
40,8484258,Sam Malinski,D,COL,26,0,0,0,0
40,8480157,Calle Rosen,D,STL,30,0,0,0,0
40,8484304,Uvis Balinskis,D,FLA,28,0,0,0,0
40,8479985,Cale Fleury,D,SEA,26,0,0,0,0
40,8479378,Logan Stanley,D,WPG,26,0,0,0,0
40,8477541,Dakota Mermis,D,MIN,30,0,0,0,0
40,8481609,Vladislav Kolyachonok,D,ARI,23,0,0,0,0
40,8480823,Alexander Alexeyev,D,WSH,25,0,0,0,0
40,8481679,Maxence Guenette,D,OTT,23,0,0,0,0
40,8481564,Ryan Johnson,D,BUF,23,0,0,0,0
40,8479376,Victor Mete,D,PHI,26,0,0,0,0
40,8484254,Akito Hirose,D,VAN,25,0,0,0,0
40,8482660,Kent Johnson,C,CBJ,22,0,0,0,0
40,8482149,Cole Perfetti,C,WPG,22,0,0,0,0
40,8477987,Ryan Donato,C,CHI,28,0,0,0,0
40,8475755,Alexander Petrovic,D,DAL,32,0,0,0,0
40,8477810,Joel Hanley,D,CGY,33,0,0,0,0
40,8474145,Robert Bortuzzo,D,NYI,35,0,0,0,0
40,8481161,Jake Christiansen,D,CBJ,25,0,0,0,0
40,8476884,Derrick Pouliot,D,DAL,30,0,0,0,0
40,8481716,Dmitri Voronkov,L,CBJ,24,0,0,0,0
40,8480084,Nick DeSimone,D,NJD,30,0,0,0,0
40,8475750,Jon Merrill,D,MIN,32,0,0,0,0
40,8479315,Joey Anderson,R,CHI,26,0,0,0,0
40,8478011,Louie Belpedio,D,PHI,28,0,0,0,0
40,8482451,Mikael Pyyhtia,L,CBJ,23,0,0,0,0
40,8481541,Samuel Bolduc,D,NYI,24,0,0,0,0
40,8482126,Emil Andrae,D,PHI,31,0,0,0,0
40,8474618,Marco Scandella,D,STL,34,0,0,0,0
40,8477244,Chad Ruhwedel,D,NYR,34,0,0,0,0
40,8477971,Andreas Englund,D,LAK,28,0,0,0,0
40,8480829,Jesperi Kotkaniemi,C,CAR,24,0,0,0,0
40,8479372,Josh Mahura,D,FLA,26,0,0,0,0
40,8482095,Tyler Kleven,D,OTT,22,0,0,0,0
40,8481719,Maxwell Crozier,D,TBL,24,0,0,0,0
40,8475855,Jesper Fast,R,CAR,33,0,0,0,0
40,8480848,Ty Dellandrea,C,DAL,24,0,0,0,0
40,8475193,Tomas Tatar,L,SEA,34,0,0,0,0
40,8476889,Radek Faksa,C,DAL,30,0,0,0,0
40,8478495,Denis Gurianov,R,PHI,27,0,0,0,0
40,8480216,Jacob Peterson,C,SJS,25,0,0,0,0
40,8480252,Cole Guttman,C,CHI,25,0,0,0,0
40,8479026,Philippe Myers,D,TBL,27,0,0,0,0
40,8481006,Tyler Tucker,D,STL,24,0,0,0,0
40,8481032,Paul Cotter,C,VGK,25,0,0,0,0
40,8481577,Philip Tomasino,C,NSH,23,0,0,0,0
40,8476918,Jimmy Vesey,L,NYR,31,0,0,0,0
40,8479320,Max Lajoie,D,TOR,27,0,0,0,0
40,8478017,Mark Friedman,D,VAN,29,0,0,0,0
40,8481754,Nikita Nesterenko,C,ANA,23,0,0,0,0
40,8483407,Brandon Scanlin,D,NYR,25,0,0,0,0
40,8482659,Josh Doan,R,ARI,22,0,0,0,0
40,8477446,Michael McCarron,R,NSH,29,0,0,0,0
40,8477903,Garnet Hathaway,R,PHI,33,0,0,0,0
40,8482153,Brendan Brisson,C,VGK,23,0,0,0,0
40,8483546,Marshall Rifai,D,TOR,26,0,0,0,0
40,8484287,Cole McWard,D,VAN,23,0,0,0,0
40,8478854,Ryan Shea,D,PIT,27,0,0,0,0
40,8481585,Egor Afanasyev,L,NSH,23,0,0,0,0
40,8483398,Declan Carlile,D,TBL,31,0,0,0,0
40,8478502,Dennis Gilbert,D,CGY,28,0,0,0,0
40,8482749,Joshua Roy,R,MTL,21,0,0,0,0
40,8481598,Philip Broberg,D,EDM,23,0,0,0,0
40,8480835,Jack Drury,C,CAR,24,0,0,0,0
40,8480748,Kiefer Sherwood,L,NSH,29,0,0,0,0
40,8476934,Brock McGinn,L,ANA,30,0,0,0,0
40,8480870,Bo Groulx,C,ANA,24,0,0,0,0
40,8479368,Max Jones,L,ANA,26,0,0,0,0
40,8478099,Kevin Labanc,R,SJS,29,0,0,0,0
40,8478067,Oskar Lindblom,L,SJS,28,0,0,0,0
40,8476393,Nick Cousins,C,FLA,31,0,0,0,0
40,8483395,Arshdeep Bains,L,VAN,23,0,0,0,0
40,8480762,Eric Robinson,L,BUF,29,0,0,0,0
40,8479439,Jacob MacDonald,D,SJS,31,0,0,0,0
40,8476474,Stefan Noesen,R,CAR,31,0,0,0,0
40,8482787,Nikita Chibrikov,R,WPG,31,0,0,0,0
40,8478432,Christian Fischer,R,DET,27,0,0,0,0
40,8477979,Nicolas Aube-Kubel,R,WSH,28,0,0,0,0
40,8481789,Tye Kartye,L,SEA,23,0,0,0,0
40,8479330,Brandon Gignac,C,MTL,27,0,0,0,0
40,8480075,Cameron Crotty,D,ARI,25,0,0,0,0
40,8473473,Milan Lucic,L,BOS,36,0,0,0,0
40,8482094,Daemon Hunt,D,MIN,22,0,0,0,0
40,8481206,John Ludvig,D,PIT,24,0,0,0,0
40,8483630,Pavol Regenda,L,ANA,25,0,0,0,0
40,8481617,Vasily Podkolzin,R,VAN,23,0,0,0,0
40,8480306,Grant Hutton,D,NYI,29,0,0,0,0
40,8480995,Pontus Holmberg,R,TOR,25,0,0,0,0
40,8482148,Hendrix Lapierre,C,WSH,22,0,0,0,0
40,8477478,William Carrier,L,VGK,30,0,0,0,0
40,8480003,Jesper Boqvist,C,BOS,26,0,0,0,0
40,8482172,Landon Slaggert,L,CHI,22,0,0,0,0
40,8480789,Oliver Wahlstrom,R,NYI,24,0,0,0,0
40,8474062,Riley Nash,C,NYR,35,0,0,0,0
40,8480021,Jack Studnicka,C,SJS,25,0,0,0,0
40,8480025,MacKenzie Entwistle,R,CHI,25,0,0,0,0
40,8481582,Nicholas Robertson,L,TOR,23,0,0,0,0
40,8476867,Brendan Gaunce,C,CBJ,30,0,0,0,0
40,8479619,Michael Carcone,L,ARI,28,0,0,0,0
40,8479370,Tyson Jost,C,BUF,26,0,0,0,0
40,8479671,Mathieu Olivier,R,CBJ,27,0,0,0,0
40,8476994,Vinnie Hinostroza,C,PIT,30,0,0,0,0
40,8482070,Mitchell Chaffee,R,TBL,26,0,0,0,0
40,8477473,Justin Bailey,R,SJS,29,0,0,0,0
40,8479344,Jesse Puljujarvi,R,PIT,26,0,0,0,0
40,8480205,Emil Bemstrom,C,PIT,25,0,0,0,0
40,8479718,Alex Barré-Boulet,C,TBL,27,0,0,0,0
40,8482061,Brandon Biro,L,BUF,26,0,0,0,0
40,8479638,Justin Brazeau,R,BOS,26,0,0,0,0
40,8474040,Sam Gagner,C,EDM,35,0,0,0,0
40,8477846,Ryan Carpenter,C,SJS,33,0,0,0,0
40,8482077,Dylan Holloway,L,EDM,23,0,0,0,0
40,8482157,Will Cuylle,L,NYR,22,0,0,0,0
40,8480007,Jonas Rondbjerg,R,VGK,25,0,0,0,0
40,8478874,Adam Gaudette,C,STL,28,0,0,0,0
40,8478434,Keegan Kolesar,R,VGK,27,0,0,0,0
40,8480441,Trey Fix-Wolansky,R,CBJ,25,0,0,0,0
40,8479994,Jaret Anderson-Dolan,C,NSH,25,0,0,0,0
40,8483567,Georgii Merkulov,C,BOS,24,0,0,0,0
40,8477380,Jonny Brodzinski,C,NYR,31,0,0,0,0
40,8482201,Gage Goncalves,C,TBL,23,0,0,0,0
40,8478211,Dryden Hunt,L,CGY,29,0,0,0,0
40,8471699,Andrew Cogliano,C,COL,37,0,0,0,0
40,8479421,Jacob Moverare,D,LAK,26,0,0,0,0
40,8478881,Brett Seney,L,CHI,28,0,0,0,0
40,8477464,Nic Petan,C,MIN,29,0,0,0,0
40,8475958,Michael Sgarbossa,C,WSH,32,0,0,0,0
40,8481147,Reese Johnson,C,CHI,26,0,0,0,0
40,8479336,Carl Grundstrom,R,LAK,27,0,0,0,0
40,8480853,Liam Foudy,C,NSH,24,0,0,0,0
40,8479522,Hardy Haman Aktell,D,WSH,26,0,0,0,0
40,8481462,Mason Morelli,L,VGK,28,0,0,0,0
40,8482102,Vasily Ponomarev,C,CAR,22,0,0,0,0
40,8480844,Grigori Denisenko,L,VGK,24,0,0,0,0
40,8479944,Zach Aston-Reese,C,DET,30,0,0,0,0
40,8482784,Zach Dean,C,STL,21,0,0,0,0
40,8479419,Brett Murray,L,BUF,26,0,0,0,0
40,8479520,Brandon Duhaime,R,COL,27,0,0,0,0
40,8477573,Nathan Walker,L,STL,30,0,0,0,0
40,8478078,Rourke Chartier,C,OTT,28,0,0,0,0
40,8475795,Dylan McIlrath,D,WSH,32,0,0,0,0
40,8482496,Nils Aman,C,VAN,24,0,0,0,0
40,8480289,Morgan Barron,C,WPG,26,0,0,0,0
40,8481751,Lukas Rousek,R,BUF,25,0,0,0,0
40,8480011,Klim Kostin,C,SJS,25,0,0,0,0
40,8481556,John Beecher,C,BOS,23,0,0,0,0
40,8475278,Byron Froese,C,VGK,33,0,0,0,0
40,8475225,Craig Smith,C,DAL,35,0,0,0,0
40,8484326,Patrik Koch,D,ARI,28,0,0,0,0
40,8477930,Pierre-Edouard Bellemare,L,SEA,39,0,0,0,0
40,8478409,Anthony Richard,C,BOS,28,0,0,0,0
40,8481024,Linus Karlsson,C,VAN,25,0,0,0,0
40,8479986,Kole Lind,R,SEA,26,0,0,0,0
40,8479414,Nathan Bastian,R,NJD,27,0,0,0,0
40,8479362,Riley Tufte,L,COL,26,0,0,0,0
40,8481058,Jesse Ylönen,R,MTL,25,0,0,0,0
40,8482476,Emil Heineman,L,MTL,23,0,0,0,0
40,8482861,Vincent Iorio,D,WSH,22,0,0,0,0
40,8483432,Luca Del Bel Belluz,C,CBJ,31,0,0,0,0
40,8482744,James Malatesta,L,CBJ,21,0,0,0,0
40,8477887,Patrick Brown,C,BOS,32,0,0,0,0
40,8478585,Derek Ryan,C,EDM,38,0,0,0,0
40,8481441,Joe Snively,C,WSH,28,0,0,0,0
40,8481592,Jakob Pelletier,L,CGY,23,0,0,0,0
40,8482634,Alex Steeves,C,TOR,25,0,0,0,0
40,8477126,Jayson Megna,C,BOS,34,0,0,0,0
40,8475752,Tyler Pitlick,C,NYR,33,0,0,0,0
40,8480008,Adam Ruzicka,C,ARI,25,0,0,0,0
40,8481065,Angus Crookshank,L,OTT,25,0,0,0,0
40,8479547,Matthew Phillips,R,WSH,26,0,0,0,0
40,8480226,Marián Studenic,R,SEA,26,0,0,0,0
40,8481237,Kyle MacLean,C,NYI,25,0,0,0,0
40,8475413,Justin Dowling,C,NJD,34,0,0,0,0
40,8481641,Joel Kiviranta,L,COL,28,0,0,0,0
40,8478104,Sammy Blais,L,STL,28,0,0,0,0
40,8477454,Adam Erne,L,EDM,29,0,0,0,0
40,8481518,Nolan Foote,L,NJD,24,0,0,0,0
40,8480245,Olle Lycksell,R,PHI,25,0,0,0,0
40,8483570,Ben Meyers,C,ANA,26,0,0,0,0
40,8480776,Sheldon Rempal,R,VGK,29,0,0,0,0
40,8483920,Pierrick Dube,R,WSH,23,0,0,0,0
40,8480267,Sammy Walker,C,MIN,25,0,0,0,0
40,8482747,Brennan Othmann,L,NYR,21,0,0,0,0
40,8479991,Jake Leschyshyn,C,NYR,25,0,0,0,0
40,8478400,Colin White,C,MTL,27,0,0,0,0
40,8479328,Julien Gauthier,R,NYI,27,0,0,0,0
40,8484325,Waltteri Merela,C,TBL,26,0,0,0,0
40,8479066,Ryan Lomberg,L,FLA,30,0,0,0,0
40,8477070,Liam O'Brien,C,ARI,30,0,0,0,0
40,8478146,Matthew Highmore,C,OTT,28,0,0,0,0
40,8478028,Fredrik Olofsson,L,COL,28,0,0,0,0
40,8480880,Jakub Lauko,C,BOS,24,0,0,0,0
40,8479968,Vinni Lettieri,C,MIN,29,0,0,0,0
40,8474709,Matt Martin,L,NYI,35,0,0,0,0
40,8480845,Rasmus Kupari,C,WPG,24,0,0,0,0
40,8481550,Adam Beckman,L,MIN,23,0,0,0,0
40,8481422,Jacob Lucchini,C,MIN,29,0,0,0,0
40,8477401,John Hayden,C,SEA,29,0,0,0,0
40,8478904,Steven Lorentz,C,FLA,28,0,0,0,0
40,8482088,Justin Sourdif,R,FLA,22,0,0,0,0
40,8482751,Ryan Winterton,C,SEA,21,0,0,0,0
40,8482241,Radim Zohorna,L,PIT,28,0,0,0,0
40,8481690,Tyler Angle,C,CBJ,24,0,0,0,0
40,8476952,Dominic Toninato,C,WPG,30,0,0,0,0
40,8476919,Chris Tierney,C,NJD,30,0,0,0,0
40,8480032,Shane Bowers,C,NJD,25,0,0,0,0
40,8484314,Jiri Smejkal,L,OTT,28,0,0,0,0
40,8481239,Samuel Fagemo,L,LAK,24,0,0,0,0
40,8481532,Alex Turcotte,C,LAK,23,0,0,0,0
40,8481019,David Gustafsson,C,WPG,24,0,0,0,0
40,8478477,Mitchell Stephens,C,MTL,27,0,0,0,0
40,8479546,Oskar Steen,C,BOS,26,0,0,0,0
40,8480292,Carson Meyer,R,CBJ,27,0,0,0,0
40,8478446,Glenn Gawdin,C,ANA,27,0,0,0,0
40,8483531,Brian Halonen,L,NJD,25,0,0,0,0
40,8477149,Scott Sabourin,R,SJS,32,0,0,0,0
40,8479972,Mason Shaw,C,MIN,26,0,0,0,0
40,8480890,Jan Jenik,R,ARI,24,0,0,0,0
40,8478051,Max Willman,C,NJD,29,0,0,0,0
40,8480851,Akil Thomas,C,LAK,24,0,0,0,0
40,8482765,Isak Rosen,R,BUF,21,0,0,0,0
40,8478421,A.J. Greer,L,CGY,28,0,0,0,0
40,8478512,Austin Czarnik,C,DET,32,0,0,0,0
40,8479536,Axel Jonsson-Fjallby,L,WPG,26,0,0,0,0
40,8477320,Anton Blidh,L,NYR,29,0,0,0,0
40,8481543,Nikita Alexandrov,C,STL,24,0,0,0,0
40,8475235,Nicolas Deslauriers,L,PHI,33,0,0,0,0
40,8481070,Hugh McGing,L,STL,26,0,0,0,0
40,8480836,Jonathan Gruden,C,PIT,24,0,0,0,0
40,8481591,Sam Poulin,R,PIT,23,0,0,0,0
40,8477962,Brendan Lemieux,L,CAR,28,0,0,0,0
40,8483401,Marc Johnstone,R,PIT,28,0,0,0,0
40,8482250,Callahan Burke,C,CAR,27,0,0,0,0
40,8481726,Adam Edstrom,C,NYR,24,0,0,0,0
40,8471817,Ryan Reaves,R,TOR,37,0,0,0,0
40,8479587,Rhett Gardner,C,PHI,28,0,0,0,0
40,8475766,Austin Watson,L,TBL,32,0,0,0,0
40,8479367,William Lockwood,R,FLA,26,0,0,0,0
40,8478424,Jansen Harkins,C,PIT,27,0,0,0,0
40,8476913,Devin Shore,C,SEA,30,0,0,0,0
40,8482652,Walker Duehr,R,CGY,27,0,0,0,0
40,8477527,Ross Johnston,L,ANA,30,0,0,0,0
40,8481077,John Leonard,L,ARI,26,0,0,0,0
40,8483549,Lucas Condotta,L,MTL,27,0,0,0,0
40,8480468,James Hamblin,L,EDM,25,0,0,0,0
40,8476907,Mackenzie MacEachern,L,STL,30,0,0,0,0
40,8479543,Michael Pezzetta,L,MTL,26,0,0,0,0
40,8480355,Mark Kastelic,C,OTT,25,0,0,0,0
40,8482162,Roby Jarventie,L,OTT,22,0,0,0,0
40,8479772,Zack MacEwen,R,OTT,28,0,0,0,0
40,8483597,Milos Kelemen,L,ARI,25,0,0,0,0
40,8479379,Givani Smith,R,SJS,26,0,0,0,0
40,8481655,Cole Schwindt,R,CGY,23,0,0,0,0
40,8479981,Jonah Gadjovich,L,FLA,26,0,0,0,0
40,8482147,Jean-Luc Foudy,C,COL,22,0,0,0,0
40,8484255,Jason Polin,R,COL,25,0,0,0,0
40,8477993,Justin Kirkland,C,ARI,28,0,0,0,0
40,8479249,Andrew Poturalski,C,SEA,30,0,0,0,0
40,8482197,Adam Raska,R,MIN,23,0,0,0,0
40,8475780,Chris Wagner,R,COL,33,0,0,0,0
40,8479533,Joona Koppanen,L,PIT,26,0,0,0,0
40,8481534,Raphael Lavoie,C,EDM,24,0,0,0,0
40,8484321,Nikolas Matinpalo,D,OTT,26,0,0,0,0
40,8481043,Cole Koepke,L,TBL,26,0,0,0,0
40,8476323,Max McCormick,L,SEA,32,0,0,0,0
40,8483609,Adam Klapka,R,CGY,24,0,0,0,0
40,8483512,Matt Savoie,C,BUF,20,0,0,0,0
40,8484259,Ondrej Pavel,C,COL,31,0,0,0,0
40,8478147,Bokondji Imama,L,OTT,28,0,0,0,0
40,8482460,Matt Rempe,C,NYR,22,0,0,0,0
40,8477073,Kurtis MacDermid,L,NJD,30,0,0,0,0
40,8480274,Philip Kemp,D,EDM,25,0,0,0,0
40,8478956,Samuel Laberge,L,NJD,27,0,0,0,0
40,8483045,Cameron Butler,R,CBJ,31,0,0,0,0
41,8478402,Connor McDavid,C,EDM,27,82,51,73,124
41,8479318,Auston Matthews,C,TOR,27,82,61,57,118
41,8477956,David Pastrnak,R,BOS,28,82,53,63,116
41,8476453,Nikita Kucherov,R,TBL,31,82,34,73,107
41,8481559,Jack Hughes,C,NJD,23,82,45,57,102
41,8477934,Leon Draisaitl,C,EDM,29,82,40,59,99
41,8477492,Nathan MacKinnon,C,COL,29,82,35,64,99
41,8480027,Jason Robertson,L,DAL,25,82,37,60,97
41,8480002,Nico Hischier,C,NJD,25,82,39,56,95
41,8478550,Artemi Panarin,L,NYR,33,82,35,59,94
41,8478420,Mikko Rantanen,R,COL,28,82,44,49,93
41,8477942,Kevin Fiala,L,LAK,28,82,35,56,91
41,8478864,Kirill Kaprizov,L,MIN,27,82,39,50,89
41,8474564,Steven Stamkos,C,TBL,34,82,39,48,87
41,8477404,Jake Guentzel,C,CAR,30,82,38,49,87
41,8479407,Jesper Bratt,L,NJD,26,82,25,62,87
41,8476887,Filip Forsberg,L,NSH,30,82,38,48,86
41,8477939,William Nylander,R,TOR,28,82,36,50,86
41,8478042,Viktor Arvidsson,R,LAK,31,82,36,49,85
41,8470794,Joe Pavelski,C,DAL,40,82,28,57,85
41,8471675,Sidney Crosby,C,PIT,37,82,33,48,81
41,8476454,Ryan Nugent-Hopkins,C,EDM,31,82,26,55,81
41,8475786,Zach Hyman,L,EDM,32,82,47,33,80
41,8475172,Nazem Kadri,C,CGY,34,82,28,52,80
41,8474600,Roman Josi,D,NSH,34,82,18,62,80
41,8478010,Brayden Point,C,TBL,28,82,45,34,79
41,8481557,Matt Boldy,L,MIN,23,82,38,40,78
41,8473419,Brad Marchand,L,BOS,36,82,30,48,78
41,8480801,Brady Tkachuk,L,OTT,25,82,42,35,77
41,8478439,Travis Konecny,R,PHI,27,82,34,42,76
41,8471215,Evgeni Malkin,C,PIT,38,82,32,44,76
41,8476853,Morgan Rielly,D,TOR,30,82,14,62,76
41,8477493,Aleksander Barkov,C,FLA,29,82,25,50,75
41,8480069,Cale Makar,D,COL,26,82,17,58,75
41,8480012,Elias Pettersson,C,VAN,26,82,32,42,74
41,8478398,Kyle Connor,L,WPG,28,82,30,44,74
41,8476468,J.T. Miller,C,VAN,31,82,29,45,74
41,8479314,Matthew Tkachuk,L,FLA,27,82,22,52,74
41,8480023,Robert Thomas,C,STL,25,82,21,53,74
41,8476346,Johnny Gaudreau,L,CBJ,31,82,21,53,74
41,8475167,Victor Hedman,D,TBL,34,82,17,56,73
41,8477933,Sam Reinhart,C,FLA,29,82,35,37,72
41,8475166,John Tavares,C,TOR,34,82,33,39,72
41,8478975,Mason Marchment,L,DAL,29,82,24,47,71
41,8479343,Clayton Keller,R,ARI,26,82,28,42,70
41,8477409,Carter Verhaeghe,C,FLA,29,82,30,38,68
41,8478449,Roope Hintz,C,DAL,28,82,26,42,68
41,8478460,Zach Werenski,D,CBJ,27,82,17,51,68
41,8477501,Valeri Nichushkin,R,COL,29,82,35,32,67
41,8475184,Chris Kreider,L,NYR,33,82,34,33,67
41,8478403,Jack Eichel,C,VGK,28,82,33,34,67
41,8476389,Vincent Trocheck,C,NYR,31,82,27,40,67
41,8475794,Tyler Seguin,C,DAL,32,82,32,34,66
41,8476460,Mark Scheifele,C,WPG,31,82,27,39,66
41,8478445,Mathew Barzal,C,NYI,27,82,15,51,66
41,8478493,Joel Eriksson Ek,C,MIN,27,82,30,35,65
41,8478873,Troy Terry,R,ANA,27,82,29,36,65
41,8478427,Sebastian Aho,C,CAR,27,82,22,43,65
41,8480800,Quinn Hughes,D,VAN,25,82,17,47,64
41,8475692,Mats Zuccarello,R,MIN,37,82,15,49,64
41,8480803,Evan Bouchard,D,EDM,25,82,12,52,64
41,8471214,Alex Ovechkin,L,WSH,39,82,32,31,63
41,8475726,Tyler Toffoli,C,WPG,32,82,32,31,63
41,8483808,Andrei Kuzmenko,L,CGY,28,82,29,34,63
41,8482093,Seth Jarvis,C,CAR,22,82,27,36,63
41,8479420,Tage Thompson,C,BUF,27,82,26,37,63
41,8480039,Martin Necas,C,CAR,25,82,22,41,63
41,8482684,Luke Hughes,D,NJD,21,82,21,42,63
41,8476905,Chandler Stephenson,C,VGK,30,82,25,37,62
41,8475913,Mark Stone,R,VGK,32,82,24,38,62
41,8478440,Dylan Strome,C,WSH,27,82,24,38,62
41,8475168,Matt Duchene,C,DAL,33,82,24,38,62
41,8475754,Brock Nelson,C,NYI,33,82,19,43,62
41,8477497,Sean Monahan,C,WPG,30,82,31,30,61
41,8477500,Bo Horvat,C,NYI,29,82,31,30,61
41,8477496,Elias Lindholm,C,VAN,30,82,28,33,61
41,8482665,Matty Beniers,C,SEA,22,82,24,37,61
41,8478458,Jack Roslovic,C,NYR,27,82,24,37,61
41,8478519,Anthony Cirelli,C,TBL,27,82,21,40,61
41,8474578,Erik Karlsson,D,PIT,34,82,16,45,61
41,8479337,Alex DeBrincat,R,DET,27,82,31,29,60
41,8477402,Pavel Buchnevich,L,STL,29,82,23,37,60
41,8480018,Nick Suzuki,C,MTL,25,82,23,37,60
41,8480830,Andrei Svechnikov,R,CAR,24,82,22,38,60
41,8473994,Jamie Benn,L,DAL,35,82,21,39,60
41,8479323,Adam Fox,D,NYR,26,82,12,48,60
41,8480865,Noah Dobson,D,NYI,24,82,6,54,60
41,8476459,Mika Zibanejad,C,NYR,31,82,28,31,59
41,8477940,Nikolaj Ehlers,L,WPG,28,82,25,34,59
41,8476881,Tomas Hertl,C,VGK,31,82,24,35,59
41,8482116,Tim Stützle,C,OTT,22,82,22,37,59
41,8471685,Anze Kopitar,C,LAK,37,82,20,39,59
41,8476456,Jonathan Huberdeau,C,CGY,31,82,16,43,59
41,8480036,Miro Heiskanen,D,DAL,25,82,12,47,59
41,8479325,Charlie McAvoy,D,BOS,27,82,6,53,59
41,8476432,Boone Jenner,C,CBJ,31,82,33,25,58
41,8478498,Jake DeBrusk,L,BOS,28,82,30,28,58
41,8477951,Nick Schmaltz,C,ARI,28,82,19,39,58
41,8475151,Kyle Palmieri,C,NYI,33,82,36,21,57
41,8475810,Bryan Rust,R,PIT,32,82,27,30,57
41,8482740,Wyatt Johnston,C,DAL,21,82,27,30,57
41,8480208,Drake Batherson,R,OTT,26,82,26,31,57
41,8474141,Patrick Kane,R,DET,36,82,19,38,57
41,8477447,Shea Theodore,D,VGK,29,82,10,47,57
41,8483397,Marc McLaughlin,C,BOS,25,82,50,6,56
41,8476479,Phillip Danault,C,LAK,31,82,24,32,56
41,8479339,Patrik Laine,L,CBJ,26,82,22,34,56
41,8478414,Timo Meier,R,NJD,28,82,28,27,55
41,8477960,Adrian Kempe,R,LAK,28,82,26,29,55
41,8479675,Trevor Moore,L,LAK,29,82,23,32,55
41,8479400,Pierre-Luc Dubois,L,LAK,26,82,23,32,55
41,8474641,Adam Henrique,C,EDM,34,82,21,34,55
41,8481533,Trevor Zegras,C,ANA,23,82,16,39,55
41,8481523,Kirby Dach,C,MTL,23,82,10,45,55
41,8475314,Anders Lee,L,NYI,34,82,33,21,54
41,8474157,Max Pacioretty,L,WSH,36,82,32,22,54
41,8478444,Brock Boeser,R,VAN,27,82,24,30,54
41,8482667,William Eklund,L,SJS,22,82,22,32,54
41,8478397,Rasmus Andersson,D,CGY,28,82,15,39,54
41,8474586,Jordan Eberle,R,SEA,34,82,15,39,54
41,8477504,Josh Morrissey,D,WPG,29,82,11,43,54
41,8475798,Mikael Granlund,C,SJS,32,82,10,44,54
41,8476399,Blake Coleman,C,CGY,33,82,26,27,53
41,8475158,Ryan O'Reilly,C,NSH,33,82,22,31,53
41,8482097,Jack Quinn,R,BUF,23,82,21,32,53
41,8479385,Jordan Kyrou,C,STL,26,82,20,33,53
41,8480839,Rasmus Dahlin,D,BUF,24,82,17,36,53
41,8477946,Dylan Larkin,C,DET,28,82,28,24,52
41,8476539,Jonathan Marchessault,R,VGK,34,82,26,26,52
41,8477451,Ryan Hartman,R,MIN,30,82,21,31,52
41,8482745,Mason McTavish,C,ANA,21,82,20,32,52
41,8482078,Lucas Raymond,L,DET,22,82,19,33,52
41,8481581,Thomas Harley,D,DAL,23,82,15,37,52
41,8478396,Noah Hanifin,D,VGK,27,82,10,42,52
41,8474590,John Carlson,D,WSH,34,82,8,44,52
41,8476906,Shayne Gostisbehere,D,DET,31,82,5,47,52
41,8479410,Mikhail Sergachev,D,TBL,26,82,4,48,52
41,8475169,Evander Kane,L,EDM,33,82,31,20,51
41,8482159,Tyson Foerster,R,PHI,22,82,20,31,51
41,8477949,Alex Tuch,R,BUF,28,82,19,32,51
41,8475745,Charlie Coyle,C,BOS,32,82,18,33,51
41,8483524,Shane Wright,C,SEA,20,82,32,18,50
41,8477407,Anthony Duclair,L,TBL,29,82,26,24,50
41,8480015,Owen Tippett,R,PHI,25,82,29,20,49
41,8475765,Vladimir Tarasenko,R,FLA,33,82,19,30,49
41,8478407,Vince Dunn,D,SEA,28,82,8,41,49
41,8480014,Gabriel Vilardi,C,WPG,25,82,33,15,48
41,8477955,Jared McCann,L,SEA,28,82,23,25,48
41,8479542,Brandon Hagel,L,TBL,26,82,22,26,48
41,8481068,Yegor Sharangovich,C,CGY,26,82,18,30,48
41,8478366,Frank Vatrano,R,ANA,30,82,29,18,47
41,8475791,Taylor Hall,L,CHI,33,82,27,20,47
41,8477479,Tyler Bertuzzi,L,TOR,29,82,21,26,47
41,8474102,David Perron,L,DET,36,82,21,26,47
41,8482109,Alexis Lafrenière,L,NYR,23,82,20,27,47
41,8477416,Oliver Bjorkstrand,R,SEA,29,82,18,29,47
41,8476882,Teuvo Teravainen,L,CAR,30,82,16,31,47
41,8480028,Morgan Frost,C,PHI,25,82,16,31,47
41,8481711,Matias Maccelli,L,ARI,24,82,11,36,47
41,8477932,Aaron Ekblad,D,FLA,28,82,11,36,47
41,8476875,Mike Matheson,D,MTL,30,82,6,41,47
41,8478474,Lawson Crouse,L,ARI,27,82,26,20,46
41,8478047,Michael Bunting,L,PIT,29,82,23,23,46
41,8478233,Andrew Mangiapane,L,CGY,28,82,23,23,46
41,8482110,Dawson Mercer,C,NJD,23,82,20,26,46
41,8478401,Pavel Zacha,C,BOS,27,82,17,29,46
41,8473512,Claude Giroux,R,OTT,36,82,13,33,46
41,8474563,Drew Doughty,D,LAK,35,82,13,33,46
41,8478438,Tommy Novak,C,NSH,27,82,21,24,45
41,8475799,Nino Niederreiter,R,WPG,32,82,20,25,45
41,8477346,MacKenzie Weegar,D,CGY,30,82,18,27,45
41,8477456,J.T. Compher,L,DET,29,82,16,29,45
41,8480078,Filip Chytil,C,NYR,25,82,15,30,45
41,8480817,K'Andre Miller,D,NYR,24,82,14,31,45
41,8477948,Travis Sanheim,D,PHI,28,82,11,34,45
41,8482124,Quinton Byfield,R,LAK,22,82,9,36,45
41,8481540,Cole Caufield,R,MTL,23,82,30,14,44
41,8476921,Jordan Martinook,L,CAR,32,82,25,19,44
41,8476483,Rickard Rakell,R,PIT,31,82,24,20,44
41,8481618,Alex Newhook,C,MTL,23,82,23,21,44
41,8476448,William Karlsson,C,VGK,31,82,22,22,44
41,8480188,Fabian Zetterlund,L,SJS,25,82,22,22,44
41,8477476,Artturi Lehkonen,L,COL,29,82,22,22,44
41,8481535,Nils Hoglander,L,VAN,24,82,19,25,44
41,8482133,Thomas Bordeleau,C,SJS,22,82,18,26,44
41,8476462,Dougie Hamilton,D,NJD,31,82,13,31,44
41,8474679,Gustav Nyquist,C,NSH,35,82,13,31,44
41,8478038,Devon Toews,D,COL,30,82,9,35,44
41,8476869,Brady Skjei,D,CAR,30,82,8,36,44
41,8481528,Dylan Cozens,C,BUF,23,82,19,24,43
41,8476329,Travis Boyd,C,ARI,31,82,19,24,43
41,8477986,Brandon Montour,D,FLA,30,82,17,26,43
41,8473986,Alex Killorn,L,ANA,35,82,17,26,43
41,8476880,Tom Wilson,R,WSH,30,82,16,27,43
41,8477021,Alex Kerfoot,C,ARI,30,82,15,28,43
41,8475763,Kevin Hayes,R,STL,32,82,13,30,43
41,8477503,Max Domi,C,TOR,29,82,13,30,43
41,8474151,Ryan McDonagh,D,NSH,35,82,5,38,43
41,8482175,JJ Peterka,R,BUF,22,82,21,21,42
41,8471698,T.J. Oshie,R,WSH,38,82,18,24,42
41,8475191,Reilly Smith,R,PIT,33,82,18,24,42
41,8474150,Mikael Backlund,C,CGY,35,82,14,28,42
41,8476826,Yanni Gourde,C,SEA,33,82,14,28,42
41,8483445,Cutter Gauthier,L,ANA,20,82,13,29,42
41,8480031,Maxime Comtois,L,CAR,25,82,10,32,42
41,8482101,Danil Gushchin,L,SJS,22,82,21,20,41
41,8475793,Ryan Johansen,C,PHI,32,82,20,21,41
41,8475784,Jeff Skinner,C,BUF,32,82,19,22,41
41,8476872,Scott Laughton,C,PHI,30,82,17,24,41
41,8475744,Evgeny Kuznetsov,C,CAR,32,82,15,26,41
41,8479987,Morgan Geekie,C,BOS,26,82,12,29,41
41,8477495,Seth Jones,D,CHI,30,82,11,30,41
41,8475906,John Klingberg,D,TOR,32,82,5,36,41
41,8480064,Josh Norris,C,OTT,25,82,22,18,40
41,8477511,Anthony Mantha,R,VGK,30,82,20,20,40
41,8475714,Calle Jarnkrok,C,TOR,33,82,20,20,40
41,8478046,Danton Heinen,L,BOS,29,82,18,22,40
41,8474053,Logan Couture,C,SJS,35,82,18,22,40
41,8475287,Erik Haula,L,NJD,33,82,13,27,40
41,8479999,Casey Mittelstadt,C,COL,26,82,12,28,40
41,8474565,Alex Pietrangelo,D,VGK,34,82,4,36,40
41,8478413,Jordan Greenway,L,BUF,27,82,22,17,39
41,8480113,Alex Iafallo,L,WPG,31,82,21,18,39
41,8482146,Luke Evangelista,R,NSH,22,82,20,19,39
41,8482699,Dylan Guenther,R,ARI,21,82,19,20,39
41,8473449,Kyle Okposo,R,FLA,36,82,18,21,39
41,8478542,Evan Rodrigues,C,FLA,31,82,16,23,39
41,8476469,Joel Armia,R,MTL,31,82,16,23,39
41,8477964,Ivan Barbashev,C,VGK,29,82,15,24,39
41,8475170,Brayden Schenn,C,STL,33,82,13,26,39
41,8478856,Conor Garland,R,VAN,28,82,12,27,39
41,8476461,Sean Couturier,C,PHI,32,82,12,27,39
41,8475197,Tyson Barrie,D,NSH,33,82,9,30,39
41,8482671,Owen Power,D,BUF,22,82,7,32,39
41,8483471,Brad Lambert,C,WPG,31,82,2,37,39
41,8482055,Drew O'Connor,L,PIT,26,82,21,17,38
41,8475722,Jason Zucker,L,NSH,32,82,19,19,38
41,8474870,Tyler Johnson,C,CHI,34,82,18,20,38
41,8475768,Jaden Schwartz,C,SEA,32,82,16,22,38
41,8477998,Warren Foegele,L,EDM,28,82,16,22,38
41,8476458,Ryan Strome,C,ANA,31,82,13,25,38
41,8481542,Moritz Seider,D,DET,23,82,10,28,38
41,8476480,Vladislav Namestnikov,C,WPG,32,82,10,28,38
41,8479423,Alex Nylander,L,CBJ,26,82,21,16,37
41,8482702,Logan Stankoven,C,DAL,21,82,20,17,37
41,8477935,Sam Bennett,C,FLA,28,82,19,18,37
41,8481560,Arthur Kaliyev,R,LAK,23,82,17,20,37
41,8479525,Ross Colton,C,COL,28,82,16,21,37
41,8482113,Anton Lundell,C,FLA,23,82,15,22,37
41,8481596,Shane Pinto,C,OTT,24,82,15,22,37
41,8480220,Noah Cates,L,PHI,25,82,13,24,37
41,8476854,Hampus Lindholm,D,BOS,30,82,7,30,37
41,8475753,Justin Faulk,D,STL,32,82,5,32,37
41,8479425,Filip Hronek,D,VAN,27,82,5,32,37
41,8480849,Barrett Hayton,C,ARI,24,82,22,14,36
41,8477444,Andre Burakovsky,L,SEA,29,82,18,18,36
41,8479941,Justin Danforth,R,CBJ,31,82,15,21,36
41,8477947,Sonny Milano,L,WSH,28,82,15,21,36
41,8484144,Connor Bedard,C,CHI,19,82,12,24,36
41,8480185,Eetu Luostarinen,C,FLA,26,82,12,24,36
41,8481554,Kaapo Kakko,R,NYR,23,82,22,13,35
41,8476438,Brandon Saad,L,STL,32,82,19,16,35
41,8477426,Nicholas Paul,L,TBL,29,82,19,16,35
41,8476292,Ondrej Palat,L,NJD,33,82,12,23,35
41,8480798,Philipp Kurashev,C,CHI,25,82,11,24,35
41,8482624,Daniil Miromanov,D,CGY,27,82,9,26,35
41,8478115,Pierre Engvall,L,NYI,28,82,21,13,34
41,8482089,Jake Neighbours,L,STL,22,82,20,14,34
41,8481517,Brett Leason,R,ANA,25,82,17,17,34
41,8478463,Anthony Beauvillier,L,NSH,27,82,16,18,34
41,8478466,Daniel Sprong,R,DET,27,82,14,20,34
41,8480797,Joel Farabee,L,PHI,24,82,13,21,34
41,8473563,Nicklas Backstrom,C,WSH,37,82,13,21,34
41,8482720,Matthew Knies,L,TOR,22,82,11,23,34
41,8475218,Mattias Ekholm,D,EDM,34,82,11,23,34
41,8483515,Juraj Slafkovsky,L,MTL,20,82,9,25,34
41,8482105,Jake Sanderson,D,OTT,22,82,9,25,34
41,8481016,Ruslan Iskhakov,C,NYI,24,82,2,32,34
41,8479996,Cody Glass,C,NSH,25,82,15,18,33
41,8480009,Eeli Tolvanen,R,SEA,25,82,15,18,33
41,8479365,Trent Frederic,C,BOS,26,82,14,19,33
41,8482155,Alex Laferriere,R,LAK,23,82,14,19,33
41,8476792,Torey Krug,D,STL,33,82,11,22,33
41,8479345,Jakob Chychrun,D,OTT,26,82,9,24,33
41,8471724,Kris Letang,D,PIT,37,82,6,27,33
41,8481699,Aku Raty,R,ARI,23,82,2,31,33
41,8479393,Noah Gregor,C,TOR,26,82,20,12,32
41,8474715,Cam Atkinson,R,PHI,35,82,18,14,32
41,8481580,Connor McMichael,C,WSH,23,82,14,18,32
41,8478462,Nicolas Roy,C,VGK,27,82,12,20,32
41,8482705,Cole Sillinger,C,CBJ,21,82,12,20,32
41,8478109,Victor Olofsson,L,BUF,29,82,12,20,32
41,8482079,Marco Rossi,C,MIN,23,82,11,21,32
41,8470613,Brent Burns,D,CAR,39,82,10,22,32
41,8478891,Mason Appleton,C,WPG,28,82,10,22,32
41,8474037,James van Riemsdyk,L,BOS,35,82,9,23,32
41,8482655,J.J. Moser,D,ARI,24,82,7,25,32
41,8480145,Neal Pionk,D,WPG,29,82,7,25,32
41,8481013,Jonatan Berggren,R,DET,24,82,5,27,32
41,8475764,Cam Fowler,D,ANA,33,82,4,28,32
41,8476979,Erik Gustafsson,D,NYR,32,82,3,29,32
41,8480459,Pius Suter,C,VAN,28,82,23,8,31
41,8477952,Robby Fabbri,C,DET,28,82,16,15,31
41,8482092,Ridly Greig,C,OTT,22,82,13,18,31
41,8473422,Nick Foligno,L,CHI,37,82,13,18,31
41,8477450,Jason Dickinson,C,CHI,29,82,13,18,31
41,8476958,Jaccob Slavin,D,CAR,30,82,7,24,31
41,8481656,Aliaksei Protas,C,WSH,23,82,7,24,31
41,8480873,Rasmus Sandin,D,WSH,24,82,6,25,31
41,8477969,Marcus Pettersson,D,PIT,28,82,4,27,31
41,8476981,Josh Anderson,R,MTL,30,82,19,11,30
41,8470610,Zach Parise,L,COL,40,82,15,15,30
41,8476419,Jean-Gabriel Pageau,C,NYI,32,82,13,17,30
41,8479415,Michael McLeod,C,NJD,26,82,11,19,30
41,8470621,Corey Perry,R,EDM,39,82,11,19,30
41,8476885,Jacob Trouba,D,NYR,30,82,10,20,30
41,8480434,Sean Durzi,D,ARI,26,82,8,22,30
41,8482733,Logan Mailloux,D,MTL,31,82,5,25,30
41,8481703,Valtteri Puustinen,R,PIT,25,82,4,26,30
41,8475848,Brendan Gallagher,R,MTL,32,82,19,10,29
41,8479293,Brandon Tanev,L,SEA,33,82,16,13,29
41,8481704,Juuso Parssinen,C,NSH,23,82,15,14,29
41,8482074,Connor Zary,C,CGY,23,82,14,15,29
41,8482222,Alexander Barabanov,L,SJS,30,82,12,17,29
41,8479351,Sam Steel,C,DAL,26,82,11,18,29
41,8481624,Ilya Mikheyev,R,VAN,30,82,11,18,29
41,8478911,Matt Roy,D,LAK,29,82,11,18,29
41,8478055,Gustav Forsling,D,FLA,28,82,9,20,29
41,8478057,Dakota Joshua,C,VAN,28,82,8,21,29
41,8480871,Adam Boqvist,D,CBJ,24,82,6,23,29
41,8479976,Juuso Valimaki,D,ARI,26,82,2,27,29
41,8478508,Yakov Trenin,C,COL,27,82,17,11,28
41,8480068,Ryan Poehling,C,PHI,25,82,14,14,28
41,8477953,Kasperi Kapanen,R,STL,28,82,13,15,28
41,8483491,Ivan Miroshnichenko,L,WSH,20,82,12,16,28
41,8474189,Lars Eller,C,PIT,35,82,11,17,28
41,8474884,Mike Hoffman,C,SJS,35,82,11,17,28
41,8476960,Andreas Athanasiou,C,CHI,30,82,8,20,28
41,8476923,Damon Severson,D,CBJ,30,82,7,21,28
41,8478469,Thomas Chabot,D,OTT,27,82,6,22,28
41,8483505,Matthew Poitras,C,BOS,20,82,6,22,28
41,8477506,Ryan Pulock,D,NYI,30,82,5,23,28
41,8476931,Jake McCabe,D,TOR,31,82,5,23,28
41,8478020,Michael Amadio,C,VGK,28,82,14,13,27
41,8470604,Jeff Carter,C,PIT,39,82,14,13,27
41,8477494,Jonathan Drouin,L,COL,29,82,10,17,27
41,8482087,Kaiden Guhle,D,MTL,22,82,10,17,27
41,8483499,Liam Ohgren,L,MIN,20,82,10,17,27
41,8476392,Adam Lowry,C,WPG,31,82,9,18,27
41,8482111,Justin Barron,D,MTL,23,82,9,18,27
41,8481537,Nikita Okhotiuk,D,CGY,24,82,9,18,27
41,8475220,Marcus Foligno,L,MIN,33,82,9,18,27
41,8483482,Tristan Luneau,D,ANA,20,82,9,18,27
41,8476927,Teddy Blueger,C,VAN,30,82,8,19,27
41,8482475,Yegor Chinakhov,R,CBJ,23,82,7,20,27
41,8478500,Ivan Provorov,D,CBJ,27,82,7,20,27
41,8480043,Timothy Liljegren,D,TOR,25,82,6,21,27
41,8475790,Erik Gudbranson,D,CBJ,32,82,6,21,27
41,8475762,Derek Forbort,D,BOS,32,82,4,23,27
41,8482122,Brock Faber,D,MIN,22,82,2,25,27
41,8476891,Matt Grzelcyk,D,BOS,30,82,2,25,27
41,8480246,Nick Perbix,D,TBL,26,82,2,25,27
41,8482737,Zack Bolduc,C,STL,21,82,14,12,26
41,8479591,Michael Eyssimont,C,TBL,28,82,13,13,26
41,8477429,Andrew Copp,C,DET,30,82,12,14,26
41,8471218,Blake Wheeler,R,NYR,38,82,11,15,26
41,8484153,Leo Carlsson,C,ANA,20,82,10,16,26
41,8476278,Colin Blackwell,C,CHI,31,82,10,16,26
41,8476374,Sean Kuraly,C,CBJ,31,82,10,16,26
41,8476463,Jonas Brodin,D,MIN,31,82,8,18,26
41,8481553,Bobby Brink,R,PHI,23,82,8,18,26
41,8476892,Colton Parayko,D,STL,31,82,7,19,26
41,8477220,Nate Schmidt,D,WPG,33,82,6,20,26
41,8477435,Ryan Graves,D,PIT,29,82,6,20,26
41,8482803,Olen Zellweger,D,ANA,21,82,6,20,26
41,8481606,Jordan Spence,D,LAK,23,82,5,21,26
41,8478178,Darren Raddysh,D,TBL,28,82,4,22,26
41,8484166,Adam Fantilli,C,CBJ,20,82,14,11,25
41,8481604,Pavel Dorofeyev,L,VGK,24,82,14,11,25
41,8477839,Conor Sheary,L,TBL,32,82,11,14,25
41,8478507,John Marino,D,NJD,27,82,10,15,25
41,8479661,Tanner Jeannot,L,TBL,27,82,10,15,25
41,8481028,Martin Pospisil,C,CGY,25,82,10,15,25
41,8475164,Jakob Silfverberg,R,ANA,34,82,9,16,25
41,8480144,David Kampf,C,TOR,29,82,8,17,25
41,8480860,Kevin Bahl,D,NJD,24,82,2,23,25
41,8483457,Lane Hutson,D,MTL,20,82,1,24,25
41,8482118,Sam Colangelo,R,ANA,23,82,22,2,24
41,8482145,Mavrik Bourque,C,DAL,22,82,18,6,24
41,8480821,Filip Zadina,R,SJS,25,82,17,7,24
41,8475760,Nick Bjugstad,C,ARI,32,82,16,8,24
41,8477330,Dominik Kubalik,L,OTT,29,82,14,10,24
41,8482259,Bobby McMann,C,TOR,28,82,12,12,24
41,8480855,Jack McBain,C,ARI,24,82,12,12,24
41,8479992,Michael Rasmussen,C,DET,25,82,8,16,24
41,8479998,Mikey Anderson,D,LAK,25,82,7,17,24
41,8478851,Alexandre Carrier,D,NSH,28,82,5,19,24
41,8474673,TJ Brodie,D,TOR,34,82,4,20,24
41,8477498,Darnell Nurse,D,EDM,29,82,4,20,24
41,8483490,Pavel Mintyukov,D,ANA,21,82,1,23,24
41,8477425,Miles Wood,L,COL,29,82,14,9,23
41,8482125,Alexander Holtz,R,NJD,22,82,12,11,23
41,8478043,Sam Lafferty,C,VAN,29,82,12,11,23
41,8476873,Mark Jankowski,C,NSH,30,82,11,12,23
41,8483431,Logan Cooley,C,ARI,20,82,11,12,23
41,8482679,Matt Coronato,R,CGY,22,82,11,12,23
41,8475149,Marcus Johansson,L,MIN,34,82,11,12,23
41,8477931,Tomas Nosek,L,NJD,32,82,11,12,23
41,8475343,Nic Dowd,C,WSH,34,82,11,12,23
41,8479359,Beck Malenstyn,L,WSH,26,82,9,14,23
41,8479371,Dante Fabbro,D,NSH,26,82,9,14,23
41,8477507,Nikita Zadorov,D,VAN,29,82,9,14,23
41,8481522,Peyton Krebs,C,BUF,23,82,8,15,23
41,8474149,Evgenii Dadonov,R,DAL,35,82,7,16,23
41,8477015,Connor Brown,R,EDM,30,82,7,16,23
41,8479514,Rem Pitlick,C,CHI,27,82,7,16,23
41,8479977,Kailer Yamamoto,R,SEA,26,82,6,17,23
41,8482142,Jamie Drysdale,D,PHI,22,82,4,19,23
41,8476457,Adam Larsson,D,SEA,32,82,4,19,23
41,8475188,Brayden McNabb,D,VGK,33,82,3,20,23
41,8475462,Radko Gudas,D,ANA,34,82,3,20,23
41,8483493,Frank Nazar,C,CHI,20,82,14,8,22
41,8477989,Christian Dvorak,C,MTL,28,82,12,10,22
41,8479390,Taylor Raddysh,R,CHI,26,82,11,11,22
41,8477919,Frederick Gaudreau,C,MIN,31,82,10,12,22
41,8482117,Lukas Reichel,L,CHI,22,82,10,12,22
41,8480893,Kirill Marchenko,R,CBJ,24,82,9,13,22
41,8476422,Mike Reilly,D,NYI,31,82,9,13,22
41,8475200,Dmitry Orlov,D,CAR,33,82,9,13,22
41,8476925,Colton Sissons,C,NSH,31,82,8,14,22
41,8475171,Oliver Ekman-Larsson,D,FLA,33,82,6,16,22
41,8480802,Ryan McLeod,C,EDM,25,82,5,17,22
41,8478443,Brandon Carlo,D,BOS,28,82,5,17,22
41,8478882,Vladislav Gavrikov,D,LAK,29,82,3,19,22
41,8482245,Artem Zub,D,OTT,29,82,3,19,22
41,8476331,Dylan DeMelo,D,WPG,31,82,3,19,22
41,8477845,Trevor van Riemsdyk,D,WSH,33,82,3,19,22
41,8479983,Mario Ferraro,D,SJS,26,82,2,20,22
41,8477944,Jakub Vrana,L,STL,28,82,13,8,21
41,8480074,Alexandre Texier,C,CBJ,25,82,12,9,21
41,8484203,Bradly Nadeau,L,CAR,19,82,12,9,21
41,8477353,Tyler Motte,C,TBL,29,82,11,10,21
41,8479353,Brett Howden,C,VGK,26,82,10,11,21
41,8480281,Alexey Toropchenko,R,STL,25,82,9,12,21
41,8477406,Mattias Janmark,C,EDM,32,82,9,12,21
41,8481546,Cam York,D,PHI,23,82,7,14,21
41,8476871,Tanner Pearson,L,MTL,32,82,7,14,21
41,8482062,Cole Smith,L,NSH,29,82,7,14,21
41,8481481,Blake Lizotte,C,LAK,27,82,7,14,21
41,8473504,Cal Clutterbuck,R,NYI,37,82,7,14,21
41,8476902,Esa Lindell,D,DAL,30,82,6,15,21
41,8483495,Simon Nemec,D,NJD,20,82,6,15,21
41,8477488,Brett Pesce,D,CAR,30,82,4,17,21
41,8481178,Egor Zamula,D,PHI,24,82,4,17,21
41,8470966,Mark Giordano,D,TOR,41,82,4,17,21
41,8481605,Jackson LaCombe,D,ANA,23,82,4,17,21
41,8475208,Brian Dumoulin,D,SEA,33,82,4,17,21
41,8474716,Jared Spurgeon,D,MIN,35,82,3,18,21
41,8476312,Josh Manson,D,COL,33,82,3,18,21
41,8480073,Erik Brannstrom,D,OTT,25,82,2,19,21
41,8473453,Trevor Lewis,C,LAK,37,82,10,10,20
41,8480813,Joe Veleno,C,DET,24,82,9,11,20
41,8475842,Sam Carrick,C,EDM,32,82,8,12,20
41,8478133,Jake Evans,C,MTL,28,82,6,14,20
41,8479346,Dillon Dube,C,CGY,26,82,6,14,20
41,8478430,Oliver Kylington,D,CGY,27,82,6,14,20
41,8480796,Martin Fehervary,D,WSH,25,82,5,15,20
41,8483565,Nick Blankenburg,D,CBJ,26,82,5,15,20
41,8474166,Alec Martinez,D,VGK,37,82,4,16,20
41,8477335,Kyle Burroughs,D,SJS,29,82,4,16,20
41,8470600,Ryan Suter,D,DAL,39,82,3,17,20
41,8482470,Ilya Solovyov,D,CGY,24,82,3,17,20
41,8481477,Nico Sturm,C,SJS,29,82,9,10,19
41,8479316,Luke Kunin,C,SJS,27,82,8,11,19
41,8481014,Alexander Romanov,D,NYI,24,82,8,11,19
41,8476897,Oskar Sundqvist,C,STL,30,82,8,11,19
41,8482730,Brandt Clarke,D,LAK,21,82,8,11,19
41,8478468,Jeremy Lauzon,D,NSH,27,82,8,11,19
41,8478472,Mathieu Joseph,R,OTT,27,82,6,13,19
41,8480336,Sean Walker,D,COL,30,82,6,13,19
41,8480807,Mattias Samuelsson,D,BUF,24,82,6,13,19
41,8476442,Matt Nieto,L,PIT,32,82,6,13,19
41,8475690,Chris Tanev,D,DAL,35,82,6,13,19
41,8484145,Zach Benson,L,BUF,19,82,5,14,19
41,8478840,Will Borgen,D,SEA,28,82,5,14,19
41,8475825,Jani Hakanpää,D,DAL,32,82,5,14,19
41,8476879,Cody Ceci,D,EDM,31,82,4,15,19
41,8476525,Colin Miller,D,WPG,32,82,3,16,19
41,8474574,Tyler Myers,D,VAN,34,82,3,16,19
41,8482809,Jackson Blake,R,CAR,21,82,14,4,18
41,8473533,Jordan Staal,C,CAR,36,82,11,7,18
41,8475231,Casey Cizikas,C,NYI,33,82,10,8,18
41,8478831,Kevin Stenlund,C,FLA,28,82,10,8,18
41,8474034,Pat Maroon,L,BOS,36,82,9,9,18
41,8480448,Parker Kelly,L,OTT,25,82,8,10,18
41,8480980,Connor Dewar,C,TOR,25,82,8,10,18
41,8478013,Jake Walman,D,DET,28,82,6,12,18
41,8479369,Andrew Peeke,D,BOS,26,82,5,13,18
41,8477392,Hudson Fasching,R,NYI,29,82,5,13,18
41,8477505,Alexander Wennberg,C,NYR,30,82,4,14,18
41,8481567,Henry Thrun,D,SJS,23,82,4,14,18
41,8480035,Henri Jokiharju,D,BUF,25,82,2,16,18
41,8478859,Niko Mikkola,D,FLA,28,82,1,17,18
41,8479383,Boris Katchouk,L,OTT,26,82,7,10,17
41,8478451,Ethan Bear,D,WSH,27,82,5,12,17
41,8475177,Calvin de Haan,D,TBL,33,82,5,12,17
41,8475455,Brenden Dillon,D,WPG,34,82,4,13,17
41,8475233,David Savard,D,MTL,34,82,4,13,17
41,8477365,Connor Clifton,D,BUF,29,82,4,13,17
41,8479324,Ryan Lindgren,D,NYR,26,82,3,14,17
41,8480834,Ty Emberson,D,SJS,24,82,3,14,17
41,8474567,Zach Bogosian,D,MIN,34,82,3,14,17
41,8479442,Troy Stecher,D,EDM,30,82,3,14,17
41,8476917,Adam Pelech,D,NYI,30,82,2,15,17
41,8473507,Jeff Petry,D,DET,37,82,2,15,17
41,8480879,Jacob Bernard-Docker,D,OTT,24,82,2,15,17
41,8475179,Dmitry Kulikov,D,FLA,34,82,1,16,17
41,8480806,Isac Lundestrom,C,ANA,25,82,9,7,16
41,8481093,Rafael Harvey-Pinard,L,MTL,25,82,9,7,16
41,8477369,Carson Soucy,D,VAN,30,82,6,10,16
41,8478136,Jake Middleton,D,MIN,28,82,6,10,16
41,8476967,Brett Kulak,D,EDM,30,82,5,11,16
41,8481524,Bowen Byram,D,BUF,23,82,4,12,16
41,8475324,Nick Jensen,D,WSH,34,82,4,12,16
41,8482073,Braden Schneider,D,NYR,23,82,4,12,16
41,8483466,Kevin Korchinski,D,CHI,20,82,3,13,16
41,8478416,Erik Cernak,D,TBL,27,82,3,13,16
41,8482807,Ethan Del Mastro,D,CHI,21,82,3,13,16
41,8481568,Alex Vlasic,D,CHI,23,82,2,14,16
41,8479398,Samuel Girard,D,COL,26,82,2,14,16
41,8479291,Kevin Rooney,C,CGY,31,82,9,6,15
41,8478569,Noel Acciari,C,PIT,33,82,8,7,15
41,8481601,Simon Holmstrom,R,NYI,23,82,7,8,15
41,8474009,Nick Bonino,C,NYR,36,82,6,9,15
41,8475279,Ben Chiarot,D,DET,33,82,6,9,15
41,8476878,Zemgus Girgensons,L,BUF,30,82,5,10,15
41,8476624,Barclay Goodrow,C,NYR,31,82,5,10,15
41,8481186,Logan O'Connor,R,COL,28,82,3,12,15
41,8476473,Connor Murphy,D,CHI,31,82,3,12,15
41,8484911,Collin Graf,R,SJS,22,82,2,13,15
41,8482166,Shakir Mukhamadullin,D,SJS,22,82,2,13,15
41,8476372,Nick Seeler,D,PHI,31,82,1,14,15
41,8482762,Simon Edvinsson,D,DET,21,82,10,4,14
41,8476822,Luke Glendening,C,TBL,35,82,9,5,14
41,8477508,Curtis Lazar,C,NJD,29,82,7,7,14
41,8483468,Jiri Kulich,C,BUF,20,82,6,8,14
41,8482666,Scott Morrow,D,CAR,22,82,5,9,14
41,8478408,Travis Dermott,D,ARI,28,82,4,10,14
41,8478399,Jonas Siegenthaler,D,NJD,27,82,1,13,14
41,8476467,Jamie Oleksiak,D,SEA,32,82,1,13,14
41,8476915,Jujhar Khaira,L,MIN,30,82,8,5,13
41,8475181,Nick Leddy,D,STL,33,82,6,7,13
41,8476429,Scott Mayfield,D,NYI,32,82,4,9,13
41,8482858,Ryker Evans,D,SEA,23,82,3,10,13
41,8474013,Ian Cole,D,VAN,35,82,3,10,13
41,8480058,Pierre-Olivier Joseph,D,PIT,25,82,2,11,13
41,8479980,Nicolas Hague,D,VGK,26,82,2,11,13
41,8482859,Zack Ostapchuk,C,OTT,21,82,2,11,13
41,8482712,Oskar Olausson,R,COL,22,82,1,12,13
41,8483012,Logan Morrison,C,SEA,22,82,5,7,12
41,8481059,Scott Perunovich,D,STL,26,82,3,9,12
41,8482177,Marat Khusnutdinov,C,MIN,22,82,3,9,12
41,8477034,Jaycob Megna,D,CHI,32,82,1,11,12
41,8477499,Rasmus Ristolainen,D,PHI,30,82,0,12,12
41,8483763,Maksymilian Szuber,D,ARI,22,82,3,8,11
41,8483489,Fraser Minten,C,TOR,31,82,3,8,11
41,8480990,Declan Chisholm,D,MIN,24,82,4,6,10
41,8480172,Jan Rutta,D,SJS,34,82,2,8,10
41,8476858,Phillip Di Giuseppe,L,VAN,31,82,2,8,10
41,8481599,Victor Soderstrom,D,ARI,23,82,2,8,10
41,8482516,Matthew Kessel,D,STL,24,82,1,9,10
41,8482713,Mackie Samoskevich,R,FLA,22,82,3,6,9
41,8471677,Jack Johnson,D,COL,37,82,3,6,9
41,8481578,Graeme Clarke,R,NJD,23,82,3,5,8
41,8481030,Jack St. Ivany,D,PIT,25,82,0,8,8
41,8484149,Gavin Brindley,C,CBJ,20,82,4,3,7
41,8482141,Lukas Cormier,D,VGK,22,0,0,0,0
41,8476988,Matt Benning,D,SJS,30,0,0,0,0
41,8480727,Zach Whitecloud,D,VGK,28,0,0,0,0
41,8480887,Jordan Harris,D,MTL,24,0,0,0,0
41,8478450,Parker Wotherspoon,D,BOS,27,0,0,0,0
41,8481812,Nikolai Knyzhov,D,SJS,27,0,0,0,0
41,8480001,Urho Vaakanainen,D,ANA,25,0,0,0,0
41,8482176,Wyatt Kaiser,D,CHI,22,0,0,0,0
41,8481122,Simon Benoit,D,TOR,26,0,0,0,0
41,8476441,Joel Edmundson,D,TOR,31,0,0,0,0
41,8480884,Calen Addison,D,SJS,24,0,0,0,0
41,8482511,Mason Lohrei,D,BOS,23,0,0,0,0
41,8482192,Isaak Phillips,D,CHI,23,0,0,0,0
41,8480950,Ilya Lyubushkin,D,TOR,30,0,0,0,0
41,8474031,Kevin Shattenkirk,D,BOS,35,0,0,0,0
41,8475718,Justin Holl,D,DET,32,0,0,0,0
41,8479402,Jake Bean,D,CBJ,26,0,0,0,0
41,8474602,Justin Schultz,D,SEA,34,0,0,0,0
41,8477950,Tony DeAngelo,D,CAR,29,0,0,0,0
41,8481743,Marc Del Gaizo,D,NSH,25,0,0,0,0
41,8481527,Kaedan Korczak,D,VGK,23,0,0,0,0
41,8480192,Johnathan Kovacevic,D,MTL,27,0,0,0,0
41,8476874,Olli Maatta,D,DET,30,0,0,0,0
41,8482144,Jack Thompson,D,SJS,22,0,0,0,0
41,8480222,Sebastian Aho,D,NYI,28,0,0,0,0
41,8479458,Nikita Zaitsev,D,CHI,33,0,0,0,0
41,8471709,Marc-Edouard Vlasic,D,SJS,37,0,0,0,0
41,8482929,Emil Lilleberg,D,TBL,23,0,0,0,0
41,8477018,Ben Hutton,D,VGK,31,0,0,0,0
41,8481056,Spencer Stastney,D,NSH,24,0,0,0,0
41,8481593,Jayden Struble,D,MTL,23,0,0,0,0
41,8479982,Conor Timmins,D,TOR,26,0,0,0,0
41,8474090,Brendan Smith,D,NJD,35,0,0,0,0
41,8482964,Arber Xhekaj,D,MTL,23,0,0,0,0
41,8480891,Michael Kesselring,D,ARI,24,0,0,0,0
41,8477938,Haydn Fleury,D,TBL,28,0,0,0,0
41,8481806,Louis Crevier,D,CHI,23,0,0,0,0
41,8471274,Alex Goligoski,D,MIN,39,0,0,0,0
41,8481600,Tobias Bjornfot,D,FLA,23,0,0,0,0
41,8475797,Jarred Tinordi,D,CHI,32,0,0,0,0
41,8481521,Ronnie Attard,D,PHI,25,0,0,0,0
41,8474612,Travis Hamonic,D,OTT,34,0,0,0,0
41,8479576,Vincent Desharnais,D,EDM,28,0,0,0,0
41,8480049,Dylan Samberg,D,WPG,25,0,0,0,0
41,8483619,Filip Roos,D,CHI,25,0,0,0,0
41,8474568,Luke Schenn,D,NSH,35,0,0,0,0
41,8480184,Gustav Lindstrom,D,ANA,26,0,0,0,0
41,8480070,Ian Mitchell,D,BOS,25,0,0,0,0
41,8480196,Jacob Bryson,D,BUF,27,0,0,0,0
41,8471686,Marc Staal,D,PHI,37,0,0,0,0
41,8477467,Gustav Olofsson,D,SEA,30,0,0,0,0
41,8478970,Jalen Chatfield,D,CAR,28,0,0,0,0
41,8479348,Kale Clague,D,BUF,26,0,0,0,0
41,8473446,Erik Johnson,D,PHI,36,0,0,0,0
41,8477462,Robert Hagg,D,ANA,29,0,0,0,0
41,8478454,Noah Juulsen,D,VAN,27,0,0,0,0
41,8477384,Josh Brown,D,ARI,30,0,0,0,0
41,8481708,Zac Jones,D,NYR,24,0,0,0,0
41,8481167,Brayden Pachal,D,CGY,25,0,0,0,0
41,8482067,Connor Mackey,D,NYR,28,0,0,0,0
41,8483460,David Jiricek,D,CBJ,21,0,0,0,0
41,8481701,Santeri Hatakka,D,NJD,23,0,0,0,0
41,8478021,William Lagesson,D,ANA,28,0,0,0,0
41,8477851,Jordan Oesterle,D,CGY,32,0,0,0,0
41,8478452,Caleb Jones,D,COL,27,0,0,0,0
41,8479984,Cal Foote,D,NJD,26,0,0,0,0
41,8479639,Dylan Coghlan,D,CAR,26,0,0,0,0
41,8480874,Adam Ginning,D,PHI,24,0,0,0,0
41,8479321,Lucas Johansen,D,WSH,27,0,0,0,0
41,8480878,Nils Lundkvist,D,DAL,24,0,0,0,0
41,8482165,Yan Kuznetsov,D,CGY,22,0,0,0,0
41,8484258,Sam Malinski,D,COL,26,0,0,0,0
41,8480157,Calle Rosen,D,STL,30,0,0,0,0
41,8484304,Uvis Balinskis,D,FLA,28,0,0,0,0
41,8479985,Cale Fleury,D,SEA,26,0,0,0,0
41,8479378,Logan Stanley,D,WPG,26,0,0,0,0
41,8477541,Dakota Mermis,D,MIN,30,0,0,0,0
41,8481609,Vladislav Kolyachonok,D,ARI,23,0,0,0,0
41,8480823,Alexander Alexeyev,D,WSH,25,0,0,0,0
41,8481679,Maxence Guenette,D,OTT,23,0,0,0,0
41,8481564,Ryan Johnson,D,BUF,23,0,0,0,0
41,8479376,Victor Mete,D,PHI,26,0,0,0,0
41,8484254,Akito Hirose,D,VAN,25,0,0,0,0
41,8482660,Kent Johnson,C,CBJ,22,0,0,0,0
41,8482149,Cole Perfetti,C,WPG,22,0,0,0,0
41,8477987,Ryan Donato,C,CHI,28,0,0,0,0
41,8475755,Alexander Petrovic,D,DAL,32,0,0,0,0
41,8477810,Joel Hanley,D,CGY,33,0,0,0,0
41,8474145,Robert Bortuzzo,D,NYI,35,0,0,0,0
41,8481161,Jake Christiansen,D,CBJ,25,0,0,0,0
41,8476884,Derrick Pouliot,D,DAL,30,0,0,0,0
41,8481716,Dmitri Voronkov,L,CBJ,24,0,0,0,0
41,8480084,Nick DeSimone,D,NJD,30,0,0,0,0
41,8475750,Jon Merrill,D,MIN,32,0,0,0,0
41,8479315,Joey Anderson,R,CHI,26,0,0,0,0
41,8478011,Louie Belpedio,D,PHI,28,0,0,0,0
41,8482451,Mikael Pyyhtia,L,CBJ,23,0,0,0,0
41,8481541,Samuel Bolduc,D,NYI,24,0,0,0,0
41,8482126,Emil Andrae,D,PHI,31,0,0,0,0
41,8474618,Marco Scandella,D,STL,34,0,0,0,0
41,8477244,Chad Ruhwedel,D,NYR,34,0,0,0,0
41,8477971,Andreas Englund,D,LAK,28,0,0,0,0
41,8480829,Jesperi Kotkaniemi,C,CAR,24,0,0,0,0
41,8479372,Josh Mahura,D,FLA,26,0,0,0,0
41,8482095,Tyler Kleven,D,OTT,22,0,0,0,0
41,8481719,Maxwell Crozier,D,TBL,24,0,0,0,0
41,8475855,Jesper Fast,R,CAR,33,0,0,0,0
41,8480848,Ty Dellandrea,C,DAL,24,0,0,0,0
41,8475193,Tomas Tatar,L,SEA,34,0,0,0,0
41,8476889,Radek Faksa,C,DAL,30,0,0,0,0
41,8478495,Denis Gurianov,R,PHI,27,0,0,0,0
41,8480216,Jacob Peterson,C,SJS,25,0,0,0,0
41,8480252,Cole Guttman,C,CHI,25,0,0,0,0
41,8479026,Philippe Myers,D,TBL,27,0,0,0,0
41,8481006,Tyler Tucker,D,STL,24,0,0,0,0
41,8481032,Paul Cotter,C,VGK,25,0,0,0,0
41,8481577,Philip Tomasino,C,NSH,23,0,0,0,0
41,8476918,Jimmy Vesey,L,NYR,31,0,0,0,0
41,8479320,Max Lajoie,D,TOR,27,0,0,0,0
41,8478017,Mark Friedman,D,VAN,29,0,0,0,0
41,8481754,Nikita Nesterenko,C,ANA,23,0,0,0,0
41,8483407,Brandon Scanlin,D,NYR,25,0,0,0,0
41,8482659,Josh Doan,R,ARI,22,0,0,0,0
41,8477446,Michael McCarron,R,NSH,29,0,0,0,0
41,8477903,Garnet Hathaway,R,PHI,33,0,0,0,0
41,8482153,Brendan Brisson,C,VGK,23,0,0,0,0
41,8483546,Marshall Rifai,D,TOR,26,0,0,0,0
41,8484287,Cole McWard,D,VAN,23,0,0,0,0
41,8478854,Ryan Shea,D,PIT,27,0,0,0,0
41,8481585,Egor Afanasyev,L,NSH,23,0,0,0,0
41,8483398,Declan Carlile,D,TBL,31,0,0,0,0
41,8478502,Dennis Gilbert,D,CGY,28,0,0,0,0
41,8482749,Joshua Roy,R,MTL,21,0,0,0,0
41,8481598,Philip Broberg,D,EDM,23,0,0,0,0
41,8480835,Jack Drury,C,CAR,24,0,0,0,0
41,8480748,Kiefer Sherwood,L,NSH,29,0,0,0,0
41,8476934,Brock McGinn,L,ANA,30,0,0,0,0
41,8480870,Bo Groulx,C,ANA,24,0,0,0,0
41,8479368,Max Jones,L,ANA,26,0,0,0,0
41,8478099,Kevin Labanc,R,SJS,29,0,0,0,0
41,8478067,Oskar Lindblom,L,SJS,28,0,0,0,0
41,8476393,Nick Cousins,C,FLA,31,0,0,0,0
41,8483395,Arshdeep Bains,L,VAN,23,0,0,0,0
41,8480762,Eric Robinson,L,BUF,29,0,0,0,0
41,8479439,Jacob MacDonald,D,SJS,31,0,0,0,0
41,8476474,Stefan Noesen,R,CAR,31,0,0,0,0
41,8482787,Nikita Chibrikov,R,WPG,31,0,0,0,0
41,8478432,Christian Fischer,R,DET,27,0,0,0,0
41,8477979,Nicolas Aube-Kubel,R,WSH,28,0,0,0,0
41,8481789,Tye Kartye,L,SEA,23,0,0,0,0
41,8479330,Brandon Gignac,C,MTL,27,0,0,0,0
41,8480075,Cameron Crotty,D,ARI,25,0,0,0,0
41,8473473,Milan Lucic,L,BOS,36,0,0,0,0
41,8482094,Daemon Hunt,D,MIN,22,0,0,0,0
41,8481206,John Ludvig,D,PIT,24,0,0,0,0
41,8483630,Pavol Regenda,L,ANA,25,0,0,0,0
41,8481617,Vasily Podkolzin,R,VAN,23,0,0,0,0
41,8480306,Grant Hutton,D,NYI,29,0,0,0,0
41,8480995,Pontus Holmberg,R,TOR,25,0,0,0,0
41,8482148,Hendrix Lapierre,C,WSH,22,0,0,0,0
41,8477478,William Carrier,L,VGK,30,0,0,0,0
41,8480003,Jesper Boqvist,C,BOS,26,0,0,0,0
41,8482172,Landon Slaggert,L,CHI,22,0,0,0,0
41,8480789,Oliver Wahlstrom,R,NYI,24,0,0,0,0
41,8474062,Riley Nash,C,NYR,35,0,0,0,0
41,8480021,Jack Studnicka,C,SJS,25,0,0,0,0
41,8480025,MacKenzie Entwistle,R,CHI,25,0,0,0,0
41,8481582,Nicholas Robertson,L,TOR,23,0,0,0,0
41,8476867,Brendan Gaunce,C,CBJ,30,0,0,0,0
41,8479619,Michael Carcone,L,ARI,28,0,0,0,0
41,8479370,Tyson Jost,C,BUF,26,0,0,0,0
41,8479671,Mathieu Olivier,R,CBJ,27,0,0,0,0
41,8476994,Vinnie Hinostroza,C,PIT,30,0,0,0,0
41,8482070,Mitchell Chaffee,R,TBL,26,0,0,0,0
41,8477473,Justin Bailey,R,SJS,29,0,0,0,0
41,8479344,Jesse Puljujarvi,R,PIT,26,0,0,0,0
41,8480205,Emil Bemstrom,C,PIT,25,0,0,0,0
41,8479718,Alex Barré-Boulet,C,TBL,27,0,0,0,0
41,8482061,Brandon Biro,L,BUF,26,0,0,0,0
41,8479638,Justin Brazeau,R,BOS,26,0,0,0,0
41,8474040,Sam Gagner,C,EDM,35,0,0,0,0
41,8477846,Ryan Carpenter,C,SJS,33,0,0,0,0
41,8482077,Dylan Holloway,L,EDM,23,0,0,0,0
41,8482157,Will Cuylle,L,NYR,22,0,0,0,0
41,8480007,Jonas Rondbjerg,R,VGK,25,0,0,0,0
41,8478874,Adam Gaudette,C,STL,28,0,0,0,0
41,8478434,Keegan Kolesar,R,VGK,27,0,0,0,0
41,8480441,Trey Fix-Wolansky,R,CBJ,25,0,0,0,0
41,8479994,Jaret Anderson-Dolan,C,NSH,25,0,0,0,0
41,8483567,Georgii Merkulov,C,BOS,24,0,0,0,0
41,8477380,Jonny Brodzinski,C,NYR,31,0,0,0,0
41,8482201,Gage Goncalves,C,TBL,23,0,0,0,0
41,8478211,Dryden Hunt,L,CGY,29,0,0,0,0
41,8471699,Andrew Cogliano,C,COL,37,0,0,0,0
41,8479421,Jacob Moverare,D,LAK,26,0,0,0,0
41,8478881,Brett Seney,L,CHI,28,0,0,0,0
41,8477464,Nic Petan,C,MIN,29,0,0,0,0
41,8475958,Michael Sgarbossa,C,WSH,32,0,0,0,0
41,8481147,Reese Johnson,C,CHI,26,0,0,0,0
41,8479336,Carl Grundstrom,R,LAK,27,0,0,0,0
41,8480853,Liam Foudy,C,NSH,24,0,0,0,0
41,8479522,Hardy Haman Aktell,D,WSH,26,0,0,0,0
41,8481462,Mason Morelli,L,VGK,28,0,0,0,0
41,8482102,Vasily Ponomarev,C,CAR,22,0,0,0,0
41,8480844,Grigori Denisenko,L,VGK,24,0,0,0,0
41,8479944,Zach Aston-Reese,C,DET,30,0,0,0,0
41,8482784,Zach Dean,C,STL,21,0,0,0,0
41,8479419,Brett Murray,L,BUF,26,0,0,0,0
41,8479520,Brandon Duhaime,R,COL,27,0,0,0,0
41,8477573,Nathan Walker,L,STL,30,0,0,0,0
41,8478078,Rourke Chartier,C,OTT,28,0,0,0,0
41,8475795,Dylan McIlrath,D,WSH,32,0,0,0,0
41,8482496,Nils Aman,C,VAN,24,0,0,0,0
41,8480289,Morgan Barron,C,WPG,26,0,0,0,0
41,8481751,Lukas Rousek,R,BUF,25,0,0,0,0
41,8480011,Klim Kostin,C,SJS,25,0,0,0,0
41,8481556,John Beecher,C,BOS,23,0,0,0,0
41,8475278,Byron Froese,C,VGK,33,0,0,0,0
41,8475225,Craig Smith,C,DAL,35,0,0,0,0
41,8484326,Patrik Koch,D,ARI,28,0,0,0,0
41,8477930,Pierre-Edouard Bellemare,L,SEA,39,0,0,0,0
41,8478409,Anthony Richard,C,BOS,28,0,0,0,0
41,8481024,Linus Karlsson,C,VAN,25,0,0,0,0
41,8479986,Kole Lind,R,SEA,26,0,0,0,0
41,8479414,Nathan Bastian,R,NJD,27,0,0,0,0
41,8479362,Riley Tufte,L,COL,26,0,0,0,0
41,8481058,Jesse Ylönen,R,MTL,25,0,0,0,0
41,8482476,Emil Heineman,L,MTL,23,0,0,0,0
41,8482861,Vincent Iorio,D,WSH,22,0,0,0,0
41,8483432,Luca Del Bel Belluz,C,CBJ,31,0,0,0,0
41,8482744,James Malatesta,L,CBJ,21,0,0,0,0
41,8477887,Patrick Brown,C,BOS,32,0,0,0,0
41,8478585,Derek Ryan,C,EDM,38,0,0,0,0
41,8481441,Joe Snively,C,WSH,28,0,0,0,0
41,8481592,Jakob Pelletier,L,CGY,23,0,0,0,0
41,8482634,Alex Steeves,C,TOR,25,0,0,0,0
41,8477126,Jayson Megna,C,BOS,34,0,0,0,0
41,8475752,Tyler Pitlick,C,NYR,33,0,0,0,0
41,8480008,Adam Ruzicka,C,ARI,25,0,0,0,0
41,8481065,Angus Crookshank,L,OTT,25,0,0,0,0
41,8479547,Matthew Phillips,R,WSH,26,0,0,0,0
41,8480226,Marián Studenic,R,SEA,26,0,0,0,0
41,8481237,Kyle MacLean,C,NYI,25,0,0,0,0
41,8475413,Justin Dowling,C,NJD,34,0,0,0,0
41,8481641,Joel Kiviranta,L,COL,28,0,0,0,0
41,8478104,Sammy Blais,L,STL,28,0,0,0,0
41,8477454,Adam Erne,L,EDM,29,0,0,0,0
41,8481518,Nolan Foote,L,NJD,24,0,0,0,0
41,8480245,Olle Lycksell,R,PHI,25,0,0,0,0
41,8483570,Ben Meyers,C,ANA,26,0,0,0,0
41,8480776,Sheldon Rempal,R,VGK,29,0,0,0,0
41,8483920,Pierrick Dube,R,WSH,23,0,0,0,0
41,8480267,Sammy Walker,C,MIN,25,0,0,0,0
41,8482747,Brennan Othmann,L,NYR,21,0,0,0,0
41,8479991,Jake Leschyshyn,C,NYR,25,0,0,0,0
41,8478400,Colin White,C,MTL,27,0,0,0,0
41,8479328,Julien Gauthier,R,NYI,27,0,0,0,0
41,8484325,Waltteri Merela,C,TBL,26,0,0,0,0
41,8479066,Ryan Lomberg,L,FLA,30,0,0,0,0
41,8477070,Liam O'Brien,C,ARI,30,0,0,0,0
41,8478146,Matthew Highmore,C,OTT,28,0,0,0,0
41,8478028,Fredrik Olofsson,L,COL,28,0,0,0,0
41,8480880,Jakub Lauko,C,BOS,24,0,0,0,0
41,8479968,Vinni Lettieri,C,MIN,29,0,0,0,0
41,8474709,Matt Martin,L,NYI,35,0,0,0,0
41,8480845,Rasmus Kupari,C,WPG,24,0,0,0,0
41,8481550,Adam Beckman,L,MIN,23,0,0,0,0
41,8481422,Jacob Lucchini,C,MIN,29,0,0,0,0
41,8477401,John Hayden,C,SEA,29,0,0,0,0
41,8478904,Steven Lorentz,C,FLA,28,0,0,0,0
41,8482088,Justin Sourdif,R,FLA,22,0,0,0,0
41,8482751,Ryan Winterton,C,SEA,21,0,0,0,0
41,8482241,Radim Zohorna,L,PIT,28,0,0,0,0
41,8481690,Tyler Angle,C,CBJ,24,0,0,0,0
41,8476952,Dominic Toninato,C,WPG,30,0,0,0,0
41,8476919,Chris Tierney,C,NJD,30,0,0,0,0
41,8480032,Shane Bowers,C,NJD,25,0,0,0,0
41,8484314,Jiri Smejkal,L,OTT,28,0,0,0,0
41,8481239,Samuel Fagemo,L,LAK,24,0,0,0,0
41,8481532,Alex Turcotte,C,LAK,23,0,0,0,0
41,8481019,David Gustafsson,C,WPG,24,0,0,0,0
41,8478477,Mitchell Stephens,C,MTL,27,0,0,0,0
41,8479546,Oskar Steen,C,BOS,26,0,0,0,0
41,8480292,Carson Meyer,R,CBJ,27,0,0,0,0
41,8478446,Glenn Gawdin,C,ANA,27,0,0,0,0
41,8483531,Brian Halonen,L,NJD,25,0,0,0,0
41,8477149,Scott Sabourin,R,SJS,32,0,0,0,0
41,8479972,Mason Shaw,C,MIN,26,0,0,0,0
41,8480890,Jan Jenik,R,ARI,24,0,0,0,0
41,8478051,Max Willman,C,NJD,29,0,0,0,0
41,8480851,Akil Thomas,C,LAK,24,0,0,0,0
41,8482765,Isak Rosen,R,BUF,21,0,0,0,0
41,8478421,A.J. Greer,L,CGY,28,0,0,0,0
41,8478512,Austin Czarnik,C,DET,32,0,0,0,0
41,8479536,Axel Jonsson-Fjallby,L,WPG,26,0,0,0,0
41,8477320,Anton Blidh,L,NYR,29,0,0,0,0
41,8481543,Nikita Alexandrov,C,STL,24,0,0,0,0
41,8475235,Nicolas Deslauriers,L,PHI,33,0,0,0,0
41,8481070,Hugh McGing,L,STL,26,0,0,0,0
41,8480836,Jonathan Gruden,C,PIT,24,0,0,0,0
41,8481591,Sam Poulin,R,PIT,23,0,0,0,0
41,8477962,Brendan Lemieux,L,CAR,28,0,0,0,0
41,8483401,Marc Johnstone,R,PIT,28,0,0,0,0
41,8482250,Callahan Burke,C,CAR,27,0,0,0,0
41,8481726,Adam Edstrom,C,NYR,24,0,0,0,0
41,8471817,Ryan Reaves,R,TOR,37,0,0,0,0
41,8479587,Rhett Gardner,C,PHI,28,0,0,0,0
41,8475766,Austin Watson,L,TBL,32,0,0,0,0
41,8479367,William Lockwood,R,FLA,26,0,0,0,0
41,8478424,Jansen Harkins,C,PIT,27,0,0,0,0
41,8476913,Devin Shore,C,SEA,30,0,0,0,0
41,8482652,Walker Duehr,R,CGY,27,0,0,0,0
41,8477527,Ross Johnston,L,ANA,30,0,0,0,0
41,8481077,John Leonard,L,ARI,26,0,0,0,0
41,8483549,Lucas Condotta,L,MTL,27,0,0,0,0
41,8480468,James Hamblin,L,EDM,25,0,0,0,0
41,8476907,Mackenzie MacEachern,L,STL,30,0,0,0,0
41,8479543,Michael Pezzetta,L,MTL,26,0,0,0,0
41,8480355,Mark Kastelic,C,OTT,25,0,0,0,0
41,8482162,Roby Jarventie,L,OTT,22,0,0,0,0
41,8479772,Zack MacEwen,R,OTT,28,0,0,0,0
41,8483597,Milos Kelemen,L,ARI,25,0,0,0,0
41,8479379,Givani Smith,R,SJS,26,0,0,0,0
41,8481655,Cole Schwindt,R,CGY,23,0,0,0,0
41,8479981,Jonah Gadjovich,L,FLA,26,0,0,0,0
41,8482147,Jean-Luc Foudy,C,COL,22,0,0,0,0
41,8484255,Jason Polin,R,COL,25,0,0,0,0
41,8477993,Justin Kirkland,C,ARI,28,0,0,0,0
41,8479249,Andrew Poturalski,C,SEA,30,0,0,0,0
41,8482197,Adam Raska,R,MIN,23,0,0,0,0
41,8475780,Chris Wagner,R,COL,33,0,0,0,0
41,8479533,Joona Koppanen,L,PIT,26,0,0,0,0
41,8481534,Raphael Lavoie,C,EDM,24,0,0,0,0
41,8484321,Nikolas Matinpalo,D,OTT,26,0,0,0,0
41,8481043,Cole Koepke,L,TBL,26,0,0,0,0
41,8476323,Max McCormick,L,SEA,32,0,0,0,0
41,8483609,Adam Klapka,R,CGY,24,0,0,0,0
41,8483512,Matt Savoie,C,BUF,20,0,0,0,0
41,8484259,Ondrej Pavel,C,COL,31,0,0,0,0
41,8478147,Bokondji Imama,L,OTT,28,0,0,0,0
41,8482460,Matt Rempe,C,NYR,22,0,0,0,0
41,8477073,Kurtis MacDermid,L,NJD,30,0,0,0,0
41,8480274,Philip Kemp,D,EDM,25,0,0,0,0
41,8478956,Samuel Laberge,L,NJD,27,0,0,0,0
41,8483045,Cameron Butler,R,CBJ,31,0,0,0,0
42,8478402,Connor McDavid,C,EDM,27,82,38,93,131
42,8481559,Jack Hughes,C,NJD,23,82,42,74,116
42,8477934,Leon Draisaitl,C,EDM,29,82,43,70,113
42,8476453,Nikita Kucherov,R,TBL,31,82,30,80,110
42,8477492,Nathan MacKinnon,C,COL,29,82,45,62,107
42,8477956,David Pastrnak,R,BOS,28,82,40,64,104
42,8478010,Brayden Point,C,TBL,28,82,52,48,100
42,8480027,Jason Robertson,L,DAL,25,82,46,52,98
42,8471675,Sidney Crosby,C,PIT,37,82,35,62,97
42,8478550,Artemi Panarin,L,NYR,33,82,37,53,90
42,8480002,Nico Hischier,C,NJD,25,82,35,55,90
42,8479318,Auston Matthews,C,TOR,27,82,50,39,89
42,8482116,Tim Stützle,C,OTT,22,82,30,57,87
42,8474600,Roman Josi,D,NSH,34,82,17,70,87
42,8478420,Mikko Rantanen,R,COL,28,82,31,53,84
42,8477493,Aleksander Barkov,C,FLA,29,82,30,53,83
42,8480012,Elias Pettersson,C,VAN,26,82,28,54,82
42,8476887,Filip Forsberg,L,NSH,30,82,50,31,81
42,8475786,Zach Hyman,L,EDM,32,82,46,35,81
42,8478439,Travis Konecny,R,PHI,27,82,34,47,81
42,8480801,Brady Tkachuk,L,OTT,25,82,38,42,80
42,8471215,Evgeni Malkin,C,PIT,38,82,35,44,79
42,8477949,Alex Tuch,R,BUF,28,82,30,49,79
42,8477404,Jake Guentzel,C,CAR,30,82,28,51,79
42,8476468,J.T. Miller,C,VAN,31,82,27,52,79
42,8477939,William Nylander,R,TOR,28,82,33,45,78
42,8473512,Claude Giroux,R,OTT,36,82,28,50,78
42,8477933,Sam Reinhart,C,FLA,29,82,40,37,77
42,8480069,Cale Makar,D,COL,26,82,20,57,77
42,8480839,Rasmus Dahlin,D,BUF,24,82,16,59,75
42,8478047,Michael Bunting,L,PIT,29,82,27,46,73
42,8479314,Matthew Tkachuk,L,FLA,27,82,25,48,73
42,8477501,Valeri Nichushkin,R,COL,29,82,32,40,72
42,8478864,Kirill Kaprizov,L,MIN,27,82,29,43,72
42,8478407,Vince Dunn,D,SEA,28,82,16,56,72
42,8475172,Nazem Kadri,C,CGY,34,82,34,37,71
42,8476459,Mika Zibanejad,C,NYR,31,82,29,42,71
42,8478427,Sebastian Aho,C,CAR,27,82,28,43,71
42,8479339,Patrik Laine,L,CBJ,26,82,27,44,71
42,8479385,Jordan Kyrou,C,STL,26,82,27,44,71
42,8478445,Mathew Barzal,C,NYI,27,82,20,51,71
42,8480800,Quinn Hughes,D,VAN,25,82,17,54,71
42,8476853,Morgan Rielly,D,TOR,30,82,10,61,71
42,8478414,Timo Meier,R,NJD,28,82,33,36,69
42,8475166,John Tavares,C,TOR,34,82,31,38,69
42,8480023,Robert Thomas,C,STL,25,82,17,52,69
42,8475913,Mark Stone,R,VGK,32,82,24,44,68
42,8476539,Jonathan Marchessault,R,VGK,34,82,37,30,67
42,8477402,Pavel Buchnevich,L,STL,29,82,32,35,67
42,8479420,Tage Thompson,C,BUF,27,82,28,39,67
42,8479337,Alex DeBrincat,R,DET,27,82,24,43,67
42,8481523,Kirby Dach,C,MTL,23,82,7,60,67
42,8478444,Brock Boeser,R,VAN,27,82,35,31,66
42,8480208,Drake Batherson,R,OTT,26,82,28,38,66
42,8476448,William Karlsson,C,VGK,31,82,25,41,66
42,8474564,Steven Stamkos,C,TBL,34,82,22,44,66
42,8477500,Bo Horvat,C,NYI,29,82,32,33,65
42,8480039,Martin Necas,C,CAR,25,82,24,41,65
42,8477447,Shea Theodore,D,VGK,29,82,16,49,65
42,8474578,Erik Karlsson,D,PIT,34,82,14,51,65
42,8476346,Johnny Gaudreau,L,CBJ,31,82,13,52,65
42,8479675,Trevor Moore,L,LAK,29,82,33,31,64
42,8477409,Carter Verhaeghe,C,FLA,29,82,32,32,64
42,8478403,Jack Eichel,C,VGK,28,82,30,34,64
42,8477942,Kevin Fiala,L,LAK,28,82,24,40,64
42,8479343,Clayton Keller,R,ARI,26,82,23,41,64
42,8480803,Evan Bouchard,D,EDM,25,82,14,50,64
42,8475167,Victor Hedman,D,TBL,34,82,10,54,64
42,8480036,Miro Heiskanen,D,DAL,25,82,10,54,64
42,8475784,Jeff Skinner,C,BUF,32,82,32,31,63
42,8478398,Kyle Connor,L,WPG,28,82,27,36,63
42,8477955,Jared McCann,L,SEA,28,82,26,37,63
42,8473994,Jamie Benn,L,DAL,35,82,24,39,63
42,8476456,Jonathan Huberdeau,C,CGY,31,82,18,45,63
42,8475810,Bryan Rust,R,PIT,32,82,37,25,62
42,8480830,Andrei Svechnikov,R,CAR,24,82,29,33,62
42,8482097,Jack Quinn,R,BUF,23,82,25,37,62
42,8479542,Brandon Hagel,L,TBL,26,82,25,37,62
42,8478042,Viktor Arvidsson,R,LAK,31,82,20,42,62
42,8478440,Dylan Strome,C,WSH,27,82,18,44,62
42,8476454,Ryan Nugent-Hopkins,C,EDM,31,82,15,47,62
42,8476389,Vincent Trocheck,C,NYR,31,82,28,33,61
42,8481068,Yegor Sharangovich,C,CGY,26,82,26,35,61
42,8471685,Anze Kopitar,C,LAK,37,82,20,41,61
42,8478449,Roope Hintz,C,DAL,28,82,27,33,60
42,8476460,Mark Scheifele,C,WPG,31,82,24,36,60
42,8477960,Adrian Kempe,R,LAK,28,82,28,31,59
42,8478401,Pavel Zacha,C,BOS,27,82,24,35,59
42,8476905,Chandler Stephenson,C,VGK,30,82,19,40,59
42,8474141,Patrick Kane,R,DET,36,82,19,40,59
42,8482665,Matty Beniers,C,SEA,22,82,16,43,59
42,8475169,Evander Kane,L,EDM,33,82,31,27,58
42,8475184,Chris Kreider,L,NYR,33,82,30,28,58
42,8471214,Alex Ovechkin,L,WSH,39,82,29,29,58
42,8478396,Noah Hanifin,D,VGK,27,82,18,40,58
42,8474679,Gustav Nyquist,C,NSH,35,82,18,40,58
42,8470613,Brent Burns,D,CAR,39,82,11,47,58
42,8475168,Matt Duchene,C,DAL,33,82,21,36,57
42,8479407,Jesper Bratt,L,NJD,26,82,19,38,57
42,8478460,Zach Werenski,D,CBJ,27,82,19,38,57
42,8477946,Dylan Larkin,C,DET,28,82,29,27,56
42,8476462,Dougie Hamilton,D,NJD,31,82,22,34,56
42,8481557,Matt Boldy,L,MIN,23,82,21,35,56
42,8480018,Nick Suzuki,C,MTL,25,82,18,38,56
42,8474590,John Carlson,D,WSH,34,82,13,43,56
42,8475754,Brock Nelson,C,NYI,33,82,26,29,55
42,8477951,Nick Schmaltz,C,ARI,28,82,26,29,55
42,8475765,Vladimir Tarasenko,R,FLA,33,82,22,33,55
42,8479323,Adam Fox,D,NYR,26,82,12,43,55
42,8478493,Joel Eriksson Ek,C,MIN,27,82,29,25,54
42,8476880,Tom Wilson,R,WSH,30,82,25,29,54
42,8478856,Conor Garland,R,VAN,28,82,25,29,54
42,8478519,Anthony Cirelli,C,TBL,27,82,24,30,54
42,8479525,Ross Colton,C,COL,28,82,24,30,54
42,8482078,Lucas Raymond,L,DET,22,82,22,32,54
42,8473419,Brad Marchand,L,BOS,36,82,18,36,54
42,8474102,David Perron,L,DET,36,82,18,36,54
42,8476882,Teuvo Teravainen,L,CAR,30,82,9,45,54
42,8474157,Max Pacioretty,L,WSH,36,82,34,19,53
42,8475791,Taylor Hall,L,CHI,33,82,25,28,53
42,8476881,Tomas Hertl,C,VGK,31,82,23,30,53
42,8477496,Elias Lindholm,C,VAN,30,82,21,32,53
42,8480015,Owen Tippett,R,PHI,25,82,21,32,53
42,8479345,Jakob Chychrun,D,OTT,26,82,21,32,53
42,8482124,Quinton Byfield,R,LAK,22,82,19,34,53
42,8477504,Josh Morrissey,D,WPG,29,82,12,41,53
42,8481540,Cole Caufield,R,MTL,23,82,33,19,52
42,8474641,Adam Henrique,C,EDM,34,82,24,28,52
42,8479400,Pierre-Luc Dubois,L,LAK,26,82,20,32,52
42,8482109,Alexis Lafrenière,L,NYR,23,82,19,33,52
42,8479999,Casey Mittelstadt,C,COL,26,82,17,35,52
42,8482105,Jake Sanderson,D,OTT,22,82,11,41,52
42,8480865,Noah Dobson,D,NYI,24,82,10,42,52
42,8480014,Gabriel Vilardi,C,WPG,25,82,30,21,51
42,8475726,Tyler Toffoli,C,WPG,32,82,28,23,51
42,8477479,Tyler Bertuzzi,L,TOR,29,82,24,27,51
42,8482159,Tyson Foerster,R,PHI,22,82,23,28,51
42,8470794,Joe Pavelski,C,DAL,40,82,20,31,51
42,8480009,Eeli Tolvanen,R,SEA,25,82,20,31,51
42,8480797,Joel Farabee,L,PHI,24,82,18,33,51
42,8482684,Luke Hughes,D,NJD,21,82,13,38,51
42,8475798,Mikael Granlund,C,SJS,32,82,10,41,51
42,8471724,Kris Letang,D,PIT,37,82,6,45,51
42,8478474,Lawson Crouse,L,ARI,27,82,29,21,50
42,8482093,Seth Jarvis,C,CAR,22,82,25,25,50
42,8480064,Josh Norris,C,OTT,25,82,24,26,50
42,8480028,Morgan Frost,C,PHI,25,82,23,27,50
42,8478462,Nicolas Roy,C,VGK,27,82,22,28,50
42,8476479,Phillip Danault,C,LAK,31,82,27,22,49
42,8477476,Artturi Lehkonen,L,COL,29,82,24,25,49
42,8475794,Tyler Seguin,C,DAL,32,82,22,27,49
42,8484144,Connor Bedard,C,CHI,19,82,22,27,49
42,8481596,Shane Pinto,C,OTT,24,82,20,29,49
42,8481533,Trevor Zegras,C,ANA,23,82,16,33,49
42,8479425,Filip Hronek,D,VAN,27,82,10,39,49
42,8480434,Sean Durzi,D,ARI,26,82,9,40,49
42,8481528,Dylan Cozens,C,BUF,23,82,22,26,48
42,8482745,Mason McTavish,C,ANA,21,82,21,27,48
42,8477940,Nikolaj Ehlers,L,WPG,28,82,19,29,48
42,8478397,Rasmus Andersson,D,CGY,28,82,12,36,48
42,8478498,Jake DeBrusk,L,BOS,28,82,24,23,47
42,8476438,Brandon Saad,L,STL,32,82,23,24,47
42,8477494,Jonathan Drouin,L,COL,29,82,17,30,47
42,8478873,Troy Terry,R,ANA,27,82,16,31,47
42,8477935,Sam Bennett,C,FLA,28,82,14,33,47
42,8479325,Charlie McAvoy,D,BOS,27,82,8,39,47
42,8481699,Aku Raty,R,ARI,23,82,2,45,47
42,8476399,Blake Coleman,C,CGY,33,82,28,18,46
42,8477416,Oliver Bjorkstrand,R,SEA,29,82,24,22,46
42,8482699,Dylan Guenther,R,ARI,21,82,21,25,46
42,8477407,Anthony Duclair,L,TBL,29,82,20,26,46
42,8481711,Matias Maccelli,L,ARI,24,82,14,32,46
42,8477986,Brandon Montour,D,FLA,30,82,12,34,46
42,8478038,Devon Toews,D,COL,30,82,8,38,46
42,8479410,Mikhail Sergachev,D,TBL,26,82,7,39,46
42,8475191,Reilly Smith,R,PIT,33,82,19,26,45
42,8478975,Mason Marchment,L,DAL,29,82,15,30,45
42,8478458,Jack Roslovic,C,NYR,27,82,15,30,45
42,8482101,Danil Gushchin,L,SJS,22,82,26,18,44
42,8482740,Wyatt Johnston,C,DAL,21,82,24,20,44
42,8477998,Warren Foegele,L,EDM,28,82,21,23,44
42,8473986,Alex Killorn,L,ANA,35,82,17,27,44
42,8475170,Brayden Schenn,C,STL,33,82,16,28,44
42,8477444,Andre Burakovsky,L,SEA,29,82,15,29,44
42,8478469,Thomas Chabot,D,OTT,27,82,15,29,44
42,8480798,Philipp Kurashev,C,CHI,25,82,13,31,44
42,8475158,Ryan O'Reilly,C,NSH,33,82,16,27,43
42,8477964,Ivan Barbashev,C,VGK,29,82,16,27,43
42,8482092,Ridly Greig,C,OTT,22,82,16,27,43
42,8480188,Fabian Zetterlund,L,SJS,25,82,14,29,43
42,8475692,Mats Zuccarello,R,MIN,37,82,13,30,43
42,8474150,Mikael Backlund,C,CGY,35,82,13,30,43
42,8479987,Morgan Geekie,C,BOS,26,82,12,31,43
42,8480849,Barrett Hayton,C,ARI,24,82,20,22,42
42,8476885,Jacob Trouba,D,NYR,30,82,19,23,42
42,8482055,Drew O'Connor,L,PIT,26,82,18,24,42
42,8477451,Ryan Hartman,R,MIN,30,82,17,25,42
42,8476483,Rickard Rakell,R,PIT,31,82,17,25,42
42,8482110,Dawson Mercer,C,NJD,23,82,16,26,42
42,8478466,Daniel Sprong,R,DET,27,82,16,26,42
42,8477503,Max Domi,C,TOR,29,82,14,28,42
42,8482113,Anton Lundell,C,FLA,23,82,14,28,42
42,8480078,Filip Chytil,C,NYR,25,82,12,30,42
42,8475763,Kevin Hayes,R,STL,32,82,22,19,41
42,8476292,Ondrej Palat,L,NJD,33,82,21,20,41
42,8481618,Alex Newhook,C,MTL,23,82,17,24,41
42,8477497,Sean Monahan,C,WPG,30,82,15,26,41
42,8476826,Yanni Gourde,C,SEA,33,82,14,27,41
42,8480031,Maxime Comtois,L,CAR,25,82,14,27,41
42,8477932,Aaron Ekblad,D,FLA,28,82,13,28,41
42,8478542,Evan Rodrigues,C,FLA,31,82,13,28,41
42,8477429,Andrew Copp,C,DET,30,82,13,28,41
42,8474586,Jordan Eberle,R,SEA,34,82,12,29,41
42,8480220,Noah Cates,L,PHI,25,82,12,29,41
42,8474563,Drew Doughty,D,LAK,35,82,9,32,41
42,8481581,Thomas Harley,D,DAL,23,82,8,33,41
42,8475906,John Klingberg,D,TOR,32,82,4,37,41
42,8478366,Frank Vatrano,R,ANA,30,82,19,21,40
42,8483808,Andrei Kuzmenko,L,CGY,28,82,16,24,40
42,8477948,Travis Sanheim,D,PHI,28,82,13,27,40
42,8476792,Torey Krug,D,STL,33,82,8,32,40
42,8482702,Logan Stankoven,C,DAL,21,82,21,18,39
42,8479992,Michael Rasmussen,C,DET,25,82,21,18,39
42,8476875,Mike Matheson,D,MTL,30,82,12,27,39
42,8478233,Andrew Mangiapane,L,CGY,28,82,12,27,39
42,8476872,Scott Laughton,C,PHI,30,82,12,27,39
42,8483397,Marc McLaughlin,C,BOS,25,82,32,6,38
42,8477426,Nicholas Paul,L,TBL,29,82,20,18,38
42,8475744,Evgeny Kuznetsov,C,CAR,32,82,17,21,38
42,8471218,Blake Wheeler,R,NYR,38,82,17,21,38
42,8475218,Mattias Ekholm,D,EDM,34,82,15,23,38
42,8477947,Sonny Milano,L,WSH,28,82,12,26,38
42,8475149,Marcus Johansson,L,MIN,34,82,12,26,38
42,8476869,Brady Skjei,D,CAR,30,82,11,27,38
42,8473563,Nicklas Backstrom,C,WSH,37,82,10,28,38
42,8474565,Alex Pietrangelo,D,VGK,34,82,7,31,38
42,8477495,Seth Jones,D,CHI,30,82,5,33,38
42,8475760,Nick Bjugstad,C,ARI,32,82,21,16,37
42,8477456,J.T. Compher,L,DET,29,82,17,20,37
42,8471698,T.J. Oshie,R,WSH,38,82,16,21,37
42,8476960,Andreas Athanasiou,C,CHI,30,82,15,22,37
42,8478472,Mathieu Joseph,R,OTT,27,82,15,22,37
42,8475287,Erik Haula,L,NJD,33,82,13,24,37
42,8478046,Danton Heinen,L,BOS,29,82,12,25,37
42,8481656,Aliaksei Protas,C,WSH,23,82,12,25,37
42,8481546,Cam York,D,PHI,23,82,7,30,37
42,8470621,Corey Perry,R,EDM,39,82,21,15,36
42,8481624,Ilya Mikheyev,R,VAN,30,82,18,18,36
42,8475793,Ryan Johansen,C,PHI,32,82,17,19,36
42,8474037,James van Riemsdyk,L,BOS,35,82,17,19,36
42,8480459,Pius Suter,C,VAN,28,82,17,19,36
42,8480068,Ryan Poehling,C,PHI,25,82,16,20,36
42,8475768,Jaden Schwartz,C,SEA,32,82,14,22,36
42,8482624,Daniil Miromanov,D,CGY,27,82,13,23,36
42,8482175,JJ Peterka,R,BUF,22,82,12,24,36
42,8476854,Hampus Lindholm,D,BOS,30,82,9,27,36
42,8477346,MacKenzie Weegar,D,CGY,30,82,8,28,36
42,8476906,Shayne Gostisbehere,D,DET,31,82,5,31,36
42,8475151,Kyle Palmieri,C,NYI,33,82,22,13,35
42,8478057,Dakota Joshua,C,VAN,28,82,21,14,35
42,8481186,Logan O'Connor,R,COL,28,82,19,16,35
42,8481560,Arthur Kaliyev,R,LAK,23,82,17,18,35
42,8480893,Kirill Marchenko,R,CBJ,24,82,14,21,35
42,8474053,Logan Couture,C,SJS,35,82,13,22,35
42,8477498,Darnell Nurse,D,EDM,29,82,10,25,35
42,8475764,Cam Fowler,D,ANA,33,82,9,26,35
42,8476979,Erik Gustafsson,D,NYR,32,82,6,29,35
42,8478020,Michael Amadio,C,VGK,28,82,22,12,34
42,8482705,Cole Sillinger,C,CBJ,21,82,19,15,34
42,8482667,William Eklund,L,SJS,22,82,17,17,34
42,8481535,Nils Hoglander,L,VAN,24,82,16,18,34
42,8476432,Boone Jenner,C,CBJ,31,82,14,20,34
42,8476458,Ryan Strome,C,ANA,31,82,14,20,34
42,8482079,Marco Rossi,C,MIN,23,82,13,21,34
42,8475745,Charlie Coyle,C,BOS,32,82,9,25,34
42,8478438,Tommy Novak,C,NSH,27,82,9,25,34
42,8483445,Cutter Gauthier,L,ANA,20,82,7,27,34
42,8482733,Logan Mailloux,D,MTL,31,82,7,27,34
42,8481542,Moritz Seider,D,DET,23,82,5,29,34
42,8483457,Lane Hutson,D,MTL,20,82,5,29,34
42,8475848,Brendan Gallagher,R,MTL,32,82,20,13,33
42,8479423,Alex Nylander,L,CBJ,26,82,18,15,33
42,8477330,Dominik Kubalik,L,OTT,29,82,17,16,33
42,8477944,Jakub Vrana,L,STL,28,82,15,18,33
42,8476927,Teddy Blueger,C,VAN,30,82,14,19,33
42,8482133,Thomas Bordeleau,C,SJS,22,82,13,20,33
42,8475220,Marcus Foligno,L,MIN,33,82,12,21,33
42,8477511,Anthony Mantha,R,VGK,30,82,11,22,33
42,8478463,Anthony Beauvillier,L,NSH,27,82,17,15,32
42,8479977,Kailer Yamamoto,R,SEA,26,82,16,16,32
42,8473533,Jordan Staal,C,CAR,36,82,14,18,32
42,8477839,Conor Sheary,L,TBL,32,82,12,20,32
42,8475343,Nic Dowd,C,WSH,34,82,12,20,32
42,8480817,K'Andre Miller,D,NYR,24,82,11,21,32
42,8482222,Alexander Barabanov,L,SJS,30,82,9,23,32
42,8475197,Tyson Barrie,D,NSH,33,82,7,25,32
42,8481703,Valtteri Puustinen,R,PIT,25,82,5,27,32
42,8476923,Damon Severson,D,CBJ,30,82,5,27,32
42,8480873,Rasmus Sandin,D,WSH,24,82,3,29,32
42,8482122,Brock Faber,D,MIN,22,82,3,29,32
42,8480821,Filip Zadina,R,SJS,25,82,17,14,31
42,8480802,Ryan McLeod,C,EDM,25,82,10,21,31
42,8475753,Justin Faulk,D,STL,32,82,8,23,31
42,8479353,Brett Howden,C,VGK,26,82,8,23,31
42,8476917,Adam Pelech,D,NYI,30,82,8,23,31
42,8476958,Jaccob Slavin,D,CAR,30,82,7,24,31
42,8480043,Timothy Liljegren,D,TOR,25,82,7,24,31
42,8482245,Artem Zub,D,OTT,29,82,4,27,31
42,8483524,Shane Wright,C,SEA,20,82,25,5,30
42,8482089,Jake Neighbours,L,STL,22,82,19,11,30
42,8483431,Logan Cooley,C,ARI,20,82,19,11,30
42,8482146,Luke Evangelista,R,NSH,22,82,16,14,30
42,8475799,Nino Niederreiter,R,WPG,32,82,15,15,30
42,8476480,Vladislav Namestnikov,C,WPG,32,82,14,16,30
42,8478133,Jake Evans,C,MTL,28,82,14,16,30
42,8476981,Josh Anderson,R,MTL,30,82,13,17,30
42,8482475,Yegor Chinakhov,R,CBJ,23,82,13,17,30
42,8478115,Pierre Engvall,L,NYI,28,82,12,18,30
42,8474189,Lars Eller,C,PIT,35,82,12,18,30
42,8484145,Zach Benson,L,BUF,19,82,12,18,30
42,8480185,Eetu Luostarinen,C,FLA,26,82,11,19,30
42,8483515,Juraj Slafkovsky,L,MTL,20,82,11,19,30
42,8474715,Cam Atkinson,R,PHI,35,82,10,20,30
42,8477507,Nikita Zadorov,D,VAN,29,82,8,22,30
42,8480145,Neal Pionk,D,WPG,29,82,5,25,30
42,8482087,Kaiden Guhle,D,MTL,22,82,5,25,30
42,8478851,Alexandre Carrier,D,NSH,28,82,5,25,30
42,8483471,Brad Lambert,C,WPG,31,82,3,27,30
42,8482145,Mavrik Bourque,C,DAL,22,82,22,7,29
42,8480855,Jack McBain,C,ARI,24,82,15,14,29
42,8476461,Sean Couturier,C,PHI,32,82,14,15,29
42,8478508,Yakov Trenin,C,COL,27,82,14,15,29
42,8481580,Connor McMichael,C,WSH,23,82,12,17,29
42,8476278,Colin Blackwell,C,CHI,31,82,12,17,29
42,8477353,Tyler Motte,C,TBL,29,82,12,17,29
42,8480113,Alex Iafallo,L,WPG,31,82,10,19,29
42,8477953,Kasperi Kapanen,R,STL,28,82,10,19,29
42,8477021,Alex Kerfoot,C,ARI,30,82,7,22,29
42,8477969,Marcus Pettersson,D,PIT,28,82,6,23,29
42,8480246,Nick Perbix,D,TBL,26,82,6,23,29
42,8482118,Sam Colangelo,R,ANA,23,82,23,5,28
42,8475722,Jason Zucker,L,NSH,32,82,15,13,28
42,8481604,Pavel Dorofeyev,L,VGK,24,82,14,14,28
42,8474884,Mike Hoffman,C,SJS,35,82,13,15,28
42,8479661,Tanner Jeannot,L,TBL,27,82,13,15,28
42,8476925,Colton Sissons,C,NSH,31,82,10,18,28
42,8474870,Tyler Johnson,C,CHI,34,82,8,20,28
42,8482720,Matthew Knies,L,TOR,22,82,8,20,28
42,8476463,Jonas Brodin,D,MIN,31,82,7,21,28
42,8476892,Colton Parayko,D,STL,31,82,7,21,28
42,8478178,Darren Raddysh,D,TBL,28,82,6,22,28
42,8481016,Ruslan Iskhakov,C,NYI,24,82,4,24,28
42,8484203,Bradly Nadeau,L,CAR,19,82,18,9,27
42,8475314,Anders Lee,L,NYI,34,82,15,12,27
42,8476469,Joel Armia,R,MTL,31,82,15,12,27
42,8482125,Alexander Holtz,R,NJD,22,82,15,12,27
42,8483012,Logan Morrison,C,SEA,22,82,15,12,27
42,8479591,Michael Eyssimont,C,TBL,28,82,14,13,27
42,8479316,Luke Kunin,C,SJS,27,82,14,13,27
42,8478013,Jake Walman,D,DET,28,82,14,13,27
42,8473422,Nick Foligno,L,CHI,37,82,13,14,27
42,8479415,Michael McLeod,C,NJD,26,82,12,15,27
42,8482671,Owen Power,D,BUF,22,82,10,17,27
42,8476871,Tanner Pearson,L,MTL,32,82,10,17,27
42,8479980,Nicolas Hague,D,VGK,26,82,7,20,27
42,8476329,Travis Boyd,C,ARI,31,82,6,21,27
42,8481013,Jonatan Berggren,R,DET,24,82,6,21,27
42,8478891,Mason Appleton,C,WPG,28,82,16,10,26
42,8477952,Robby Fabbri,C,DET,28,82,15,11,26
42,8481553,Bobby Brink,R,PHI,23,82,15,11,26
42,8482074,Connor Zary,C,CGY,23,82,14,12,26
42,8477919,Frederick Gaudreau,C,MIN,31,82,14,12,26
42,8479293,Brandon Tanev,L,SEA,33,82,11,15,26
42,8482655,J.J. Moser,D,ARI,24,82,9,17,26
42,8474149,Evgenii Dadonov,R,DAL,35,82,9,17,26
42,8476897,Oskar Sundqvist,C,STL,30,82,9,17,26
42,8479351,Sam Steel,C,DAL,26,82,7,19,26
42,8477506,Ryan Pulock,D,NYI,30,82,6,20,26
42,8475188,Brayden McNabb,D,VGK,33,82,3,23,26
42,8479398,Samuel Girard,D,COL,26,82,2,24,26
42,8475181,Nick Leddy,D,STL,33,82,2,24,26
42,8476873,Mark Jankowski,C,NSH,30,82,20,5,25
42,8479365,Trent Frederic,C,BOS,26,82,13,12,25
42,8473449,Kyle Okposo,R,FLA,36,82,11,14,25
42,8477450,Jason Dickinson,C,CHI,29,82,11,14,25
42,8482259,Bobby McMann,C,TOR,28,82,11,14,25
42,8480871,Adam Boqvist,D,CBJ,24,82,10,15,25
42,8477392,Hudson Fasching,R,NYI,29,82,8,17,25
42,8476419,Jean-Gabriel Pageau,C,NYI,32,82,7,18,25
42,8481524,Bowen Byram,D,BUF,23,82,7,18,25
42,8476392,Adam Lowry,C,WPG,31,82,6,19,25
42,8482142,Jamie Drysdale,D,PHI,22,82,6,19,25
42,8478055,Gustav Forsling,D,FLA,28,82,5,20,25
42,8476902,Esa Lindell,D,DAL,30,82,5,20,25
42,8476331,Dylan DeMelo,D,WPG,31,82,3,22,25
42,8476879,Cody Ceci,D,EDM,31,82,0,25,25
42,8475714,Calle Jarnkrok,C,TOR,33,82,14,10,24
42,8477989,Christian Dvorak,C,MTL,28,82,14,10,24
42,8477015,Connor Brown,R,EDM,30,82,13,11,24
42,8478413,Jordan Greenway,L,BUF,27,82,12,12,24
42,8480074,Alexandre Texier,C,CBJ,25,82,12,12,24
42,8484153,Leo Carlsson,C,ANA,20,82,10,14,24
42,8479996,Cody Glass,C,NSH,25,82,9,15,24
42,8481522,Peyton Krebs,C,BUF,23,82,9,15,24
42,8480813,Joe Veleno,C,DET,24,82,9,15,24
42,8478840,Will Borgen,D,SEA,28,82,8,16,24
42,8479369,Andrew Peeke,D,BOS,26,82,5,19,24
42,8481178,Egor Zamula,D,PHI,24,82,4,20,24
42,8478507,John Marino,D,NJD,27,82,1,23,24
42,8483493,Frank Nazar,C,CHI,20,82,16,7,23
42,8470604,Jeff Carter,C,PIT,39,82,13,10,23
42,8481554,Kaapo Kakko,R,NYR,23,82,11,12,23
42,8484166,Adam Fantilli,C,CBJ,20,82,11,12,23
42,8479514,Rem Pitlick,C,CHI,27,82,9,14,23
42,8479346,Dillon Dube,C,CGY,26,82,9,14,23
42,8474151,Ryan McDonagh,D,NSH,35,82,6,17,23
42,8478911,Matt Roy,D,LAK,29,82,5,18,23
42,8477435,Ryan Graves,D,PIT,29,82,5,18,23
42,8477488,Brett Pesce,D,CAR,30,82,5,18,23
42,8475200,Dmitry Orlov,D,CAR,33,82,4,19,23
42,8483495,Simon Nemec,D,NJD,20,82,3,20,23
42,8477369,Carson Soucy,D,VAN,30,82,3,20,23
42,8480073,Erik Brannstrom,D,OTT,25,82,2,21,23
42,8480281,Alexey Toropchenko,R,STL,25,82,14,8,22
42,8483491,Ivan Miroshnichenko,L,WSH,20,82,11,11,22
42,8481028,Martin Pospisil,C,CGY,25,82,10,12,22
42,8477425,Miles Wood,L,COL,29,82,9,13,22
42,8482111,Justin Barron,D,MTL,23,82,8,14,22
42,8482117,Lukas Reichel,L,CHI,22,82,8,14,22
42,8480448,Parker Kelly,L,OTT,25,82,8,14,22
42,8480144,David Kampf,C,TOR,29,82,7,15,22
42,8480035,Henri Jokiharju,D,BUF,25,82,7,15,22
42,8481601,Simon Holmstrom,R,NYI,23,82,7,15,22
42,8482155,Alex Laferriere,R,LAK,23,82,5,17,22
42,8478500,Ivan Provorov,D,CBJ,27,82,4,18,22
42,8481568,Alex Vlasic,D,CHI,23,82,3,19,22
42,8473507,Jeff Petry,D,DET,37,82,2,20,22
42,8481093,Rafael Harvey-Pinard,L,MTL,25,82,18,3,21
42,8483505,Matthew Poitras,C,BOS,20,82,10,11,21
42,8482712,Oskar Olausson,R,COL,22,82,10,11,21
42,8479983,Mario Ferraro,D,SJS,26,82,7,14,21
42,8481567,Henry Thrun,D,SJS,23,82,7,14,21
42,8477406,Mattias Janmark,C,EDM,32,82,6,15,21
42,8478416,Erik Cernak,D,TBL,27,82,6,15,21
42,8483482,Tristan Luneau,D,ANA,20,82,4,17,21
42,8478882,Vladislav Gavrikov,D,LAK,29,82,4,17,21
42,8477505,Alexander Wennberg,C,NYR,30,82,4,17,21
42,8479998,Mikey Anderson,D,LAK,25,82,3,18,21
42,8479324,Ryan Lindgren,D,NYR,26,82,3,18,21
42,8476921,Jordan Martinook,L,CAR,32,82,13,7,20
42,8479390,Taylor Raddysh,R,CHI,26,82,12,8,20
42,8478043,Sam Lafferty,C,VAN,29,82,10,10,20
42,8478109,Victor Olofsson,L,BUF,29,82,9,11,20
42,8481477,Nico Sturm,C,SJS,29,82,8,12,20
42,8480806,Isac Lundestrom,C,ANA,25,82,8,12,20
42,8470610,Zach Parise,L,COL,40,82,6,14,20
42,8474034,Pat Maroon,L,BOS,36,82,6,14,20
42,8476891,Matt Grzelcyk,D,BOS,30,82,5,15,20
42,8475279,Ben Chiarot,D,DET,33,82,5,15,20
42,8475762,Derek Forbort,D,BOS,32,82,4,16,20
42,8480860,Kevin Bahl,D,NJD,24,82,4,16,20
42,8474716,Jared Spurgeon,D,MIN,35,82,3,17,20
42,8483565,Nick Blankenburg,D,CBJ,26,82,3,17,20
42,8476467,Jamie Oleksiak,D,SEA,32,82,3,17,20
42,8478569,Noel Acciari,C,PIT,33,82,13,6,19
42,8475231,Casey Cizikas,C,NYI,33,82,12,7,19
42,8481537,Nikita Okhotiuk,D,CGY,24,82,8,11,19
42,8476312,Josh Manson,D,COL,33,82,8,11,19
42,8482679,Matt Coronato,R,CGY,22,82,7,12,19
42,8475171,Oliver Ekman-Larsson,D,FLA,33,82,7,12,19
42,8480058,Pierre-Olivier Joseph,D,PIT,25,82,6,13,19
42,8482730,Brandt Clarke,D,LAK,21,82,5,14,19
42,8477335,Kyle Burroughs,D,SJS,29,82,4,15,19
42,8477365,Connor Clifton,D,BUF,29,82,4,15,19
42,8479371,Dante Fabbro,D,NSH,26,82,3,16,19
42,8483466,Kevin Korchinski,D,CHI,20,82,2,17,19
42,8475690,Chris Tanev,D,DAL,35,82,0,19,19
42,8480980,Connor Dewar,C,TOR,25,82,12,6,18
42,8476442,Matt Nieto,L,PIT,32,82,11,7,18
42,8481481,Blake Lizotte,C,LAK,27,82,10,8,18
42,8481704,Juuso Parssinen,C,NSH,23,82,8,10,18
42,8476525,Colin Miller,D,WPG,32,82,6,12,18
42,8480834,Ty Emberson,D,SJS,24,82,5,13,18
42,8475324,Nick Jensen,D,WSH,34,82,5,13,18
42,8479976,Juuso Valimaki,D,ARI,26,82,4,14,18
42,8477845,Trevor van Riemsdyk,D,WSH,33,82,4,14,18
42,8481014,Alexander Romanov,D,NYI,24,82,4,14,18
42,8480336,Sean Walker,D,COL,30,82,4,14,18
42,8482073,Braden Schneider,D,NYR,23,82,4,14,18
42,8477220,Nate Schmidt,D,WPG,33,82,3,15,18
42,8470966,Mark Giordano,D,TOR,41,82,3,15,18
42,8481059,Scott Perunovich,D,STL,26,82,3,15,18
42,8479941,Justin Danforth,R,CBJ,31,82,12,5,17
42,8482809,Jackson Blake,R,CAR,21,82,12,5,17
42,8479359,Beck Malenstyn,L,WSH,26,82,8,9,17
42,8476422,Mike Reilly,D,NYI,31,82,8,9,17
42,8476624,Barclay Goodrow,C,NYR,31,82,6,11,17
42,8482470,Ilya Solovyov,D,CGY,24,82,3,14,17
42,8480807,Mattias Samuelsson,D,BUF,24,82,2,15,17
42,8475233,David Savard,D,MTL,34,82,2,15,17
42,8482737,Zack Bolduc,C,STL,21,82,10,6,16
42,8478831,Kevin Stenlund,C,FLA,28,82,10,6,16
42,8475842,Sam Carrick,C,EDM,32,82,9,7,16
42,8478430,Oliver Kylington,D,CGY,27,82,6,10,16
42,8479383,Boris Katchouk,L,OTT,26,82,6,10,16
42,8477931,Tomas Nosek,L,NJD,32,82,5,11,16
42,8477499,Rasmus Ristolainen,D,PHI,30,82,5,11,16
42,8478451,Ethan Bear,D,WSH,27,82,4,12,16
42,8476931,Jake McCabe,D,TOR,31,82,3,13,16
42,8481606,Jordan Spence,D,LAK,23,82,3,13,16
42,8476457,Adam Larsson,D,SEA,32,82,3,13,16
42,8475455,Brenden Dillon,D,WPG,34,82,2,14,16
42,8474574,Tyler Myers,D,VAN,34,82,1,15,16
42,8475177,Calvin de Haan,D,TBL,33,82,9,6,15
42,8479393,Noah Gregor,C,TOR,26,82,8,7,15
42,8480796,Martin Fehervary,D,WSH,25,82,6,9,15
42,8481517,Brett Leason,R,ANA,25,82,5,10,15
42,8476429,Scott Mayfield,D,NYI,32,82,5,10,15
42,8475462,Radko Gudas,D,ANA,34,82,4,11,15
42,8475790,Erik Gudbranson,D,CBJ,32,82,3,12,15
42,8478399,Jonas Siegenthaler,D,NJD,27,82,3,12,15
42,8482859,Zack Ostapchuk,C,OTT,21,82,3,12,15
42,8478859,Niko Mikkola,D,FLA,28,82,2,13,15
42,8480879,Jacob Bernard-Docker,D,OTT,24,82,2,13,15
42,8476372,Nick Seeler,D,PHI,31,82,2,13,15
42,8483499,Liam Ohgren,L,MIN,20,82,9,5,14
42,8476822,Luke Glendening,C,TBL,35,82,8,6,14
42,8474567,Zach Bogosian,D,MIN,34,82,7,7,14
42,8476878,Zemgus Girgensons,L,BUF,30,82,5,9,14
42,8476858,Phillip Di Giuseppe,L,VAN,31,82,5,9,14
42,8475208,Brian Dumoulin,D,SEA,33,82,3,11,14
42,8482807,Ethan Del Mastro,D,CHI,21,82,3,11,14
42,8478443,Brandon Carlo,D,BOS,28,82,2,12,14
42,8482166,Shakir Mukhamadullin,D,SJS,22,82,2,12,14
42,8470600,Ryan Suter,D,DAL,39,82,1,13,14
42,8479291,Kevin Rooney,C,CGY,31,82,9,4,13
42,8474009,Nick Bonino,C,NYR,36,82,6,7,13
42,8477508,Curtis Lazar,C,NJD,29,82,5,8,13
42,8482666,Scott Morrow,D,CAR,22,82,5,8,13
42,8482062,Cole Smith,L,NSH,29,82,4,9,13
42,8476473,Connor Murphy,D,CHI,31,82,4,9,13
42,8476374,Sean Kuraly,C,CBJ,31,82,3,10,13
42,8478468,Jeremy Lauzon,D,NSH,27,82,3,10,13
42,8475825,Jani Hakanpää,D,DAL,32,82,3,10,13
42,8479442,Troy Stecher,D,EDM,30,82,2,11,13
42,8476967,Brett Kulak,D,EDM,30,82,2,11,13
42,8481605,Jackson LaCombe,D,ANA,23,82,1,12,13
42,8482762,Simon Edvinsson,D,DET,21,82,7,5,12
42,8481578,Graeme Clarke,R,NJD,23,82,5,7,12
42,8483490,Pavel Mintyukov,D,ANA,21,82,3,9,12
42,8474673,TJ Brodie,D,TOR,34,82,2,10,12
42,8475179,Dmitry Kulikov,D,FLA,34,82,2,10,12
42,8480172,Jan Rutta,D,SJS,34,82,2,10,12
42,8480990,Declan Chisholm,D,MIN,24,82,7,4,11
42,8482803,Olen Zellweger,D,ANA,21,82,6,5,11
42,8473504,Cal Clutterbuck,R,NYI,37,82,6,5,11
42,8473453,Trevor Lewis,C,LAK,37,82,6,5,11
42,8475164,Jakob Silfverberg,R,ANA,34,82,4,7,11
42,8474166,Alec Martinez,D,VGK,37,82,2,9,11
42,8478136,Jake Middleton,D,MIN,28,82,2,9,11
42,8482516,Matthew Kessel,D,STL,24,82,2,9,11
42,8484911,Collin Graf,R,SJS,22,82,6,4,10
42,8481599,Victor Soderstrom,D,ARI,23,82,3,7,10
42,8483763,Maksymilian Szuber,D,ARI,22,82,4,5,9
42,8484149,Gavin Brindley,C,CBJ,20,82,1,8,9
42,8477034,Jaycob Megna,D,CHI,32,82,4,4,8
42,8483468,Jiri Kulich,C,BUF,20,82,3,5,8
42,8482177,Marat Khusnutdinov,C,MIN,22,82,3,5,8
42,8482858,Ryker Evans,D,SEA,23,82,2,6,8
42,8471677,Jack Johnson,D,COL,37,82,1,7,8
42,8478408,Travis Dermott,D,ARI,28,82,3,4,7
42,8474013,Ian Cole,D,VAN,35,82,1,6,7
42,8482713,Mackie Samoskevich,R,FLA,22,82,4,2,6
42,8476915,Jujhar Khaira,L,MIN,30,82,2,4,6
42,8481030,Jack St. Ivany,D,PIT,25,82,2,3,5
42,8483489,Fraser Minten,C,TOR,31,82,2,1,3
42,8482141,Lukas Cormier,D,VGK,22,0,0,0,0
42,8476988,Matt Benning,D,SJS,30,0,0,0,0
42,8480727,Zach Whitecloud,D,VGK,28,0,0,0,0
42,8480887,Jordan Harris,D,MTL,24,0,0,0,0
42,8478450,Parker Wotherspoon,D,BOS,27,0,0,0,0
42,8481812,Nikolai Knyzhov,D,SJS,27,0,0,0,0
42,8480001,Urho Vaakanainen,D,ANA,25,0,0,0,0
42,8482176,Wyatt Kaiser,D,CHI,22,0,0,0,0
42,8481122,Simon Benoit,D,TOR,26,0,0,0,0
42,8476441,Joel Edmundson,D,TOR,31,0,0,0,0
42,8480884,Calen Addison,D,SJS,24,0,0,0,0
42,8482511,Mason Lohrei,D,BOS,23,0,0,0,0
42,8482192,Isaak Phillips,D,CHI,23,0,0,0,0
42,8480950,Ilya Lyubushkin,D,TOR,30,0,0,0,0
42,8474031,Kevin Shattenkirk,D,BOS,35,0,0,0,0
42,8475718,Justin Holl,D,DET,32,0,0,0,0
42,8479402,Jake Bean,D,CBJ,26,0,0,0,0
42,8474602,Justin Schultz,D,SEA,34,0,0,0,0
42,8477950,Tony DeAngelo,D,CAR,29,0,0,0,0
42,8481743,Marc Del Gaizo,D,NSH,25,0,0,0,0
42,8481527,Kaedan Korczak,D,VGK,23,0,0,0,0
42,8480192,Johnathan Kovacevic,D,MTL,27,0,0,0,0
42,8476874,Olli Maatta,D,DET,30,0,0,0,0
42,8482144,Jack Thompson,D,SJS,22,0,0,0,0
42,8480222,Sebastian Aho,D,NYI,28,0,0,0,0
42,8479458,Nikita Zaitsev,D,CHI,33,0,0,0,0
42,8471709,Marc-Edouard Vlasic,D,SJS,37,0,0,0,0
42,8482929,Emil Lilleberg,D,TBL,23,0,0,0,0
42,8477018,Ben Hutton,D,VGK,31,0,0,0,0
42,8481056,Spencer Stastney,D,NSH,24,0,0,0,0
42,8481593,Jayden Struble,D,MTL,23,0,0,0,0
42,8479982,Conor Timmins,D,TOR,26,0,0,0,0
42,8474090,Brendan Smith,D,NJD,35,0,0,0,0
42,8482964,Arber Xhekaj,D,MTL,23,0,0,0,0
42,8480891,Michael Kesselring,D,ARI,24,0,0,0,0
42,8477938,Haydn Fleury,D,TBL,28,0,0,0,0
42,8481806,Louis Crevier,D,CHI,23,0,0,0,0
42,8471274,Alex Goligoski,D,MIN,39,0,0,0,0
42,8481600,Tobias Bjornfot,D,FLA,23,0,0,0,0
42,8475797,Jarred Tinordi,D,CHI,32,0,0,0,0
42,8481521,Ronnie Attard,D,PHI,25,0,0,0,0
42,8474612,Travis Hamonic,D,OTT,34,0,0,0,0
42,8479576,Vincent Desharnais,D,EDM,28,0,0,0,0
42,8480049,Dylan Samberg,D,WPG,25,0,0,0,0
42,8483619,Filip Roos,D,CHI,25,0,0,0,0
42,8474568,Luke Schenn,D,NSH,35,0,0,0,0
42,8480184,Gustav Lindstrom,D,ANA,26,0,0,0,0
42,8480070,Ian Mitchell,D,BOS,25,0,0,0,0
42,8480196,Jacob Bryson,D,BUF,27,0,0,0,0
42,8471686,Marc Staal,D,PHI,37,0,0,0,0
42,8477467,Gustav Olofsson,D,SEA,30,0,0,0,0
42,8478970,Jalen Chatfield,D,CAR,28,0,0,0,0
42,8479348,Kale Clague,D,BUF,26,0,0,0,0
42,8473446,Erik Johnson,D,PHI,36,0,0,0,0
42,8477462,Robert Hagg,D,ANA,29,0,0,0,0
42,8478454,Noah Juulsen,D,VAN,27,0,0,0,0
42,8477384,Josh Brown,D,ARI,30,0,0,0,0
42,8481708,Zac Jones,D,NYR,24,0,0,0,0
42,8481167,Brayden Pachal,D,CGY,25,0,0,0,0
42,8482067,Connor Mackey,D,NYR,28,0,0,0,0
42,8483460,David Jiricek,D,CBJ,21,0,0,0,0
42,8481701,Santeri Hatakka,D,NJD,23,0,0,0,0
42,8478021,William Lagesson,D,ANA,28,0,0,0,0
42,8477851,Jordan Oesterle,D,CGY,32,0,0,0,0
42,8478452,Caleb Jones,D,COL,27,0,0,0,0
42,8479984,Cal Foote,D,NJD,26,0,0,0,0
42,8479639,Dylan Coghlan,D,CAR,26,0,0,0,0
42,8480874,Adam Ginning,D,PHI,24,0,0,0,0
42,8479321,Lucas Johansen,D,WSH,27,0,0,0,0
42,8480878,Nils Lundkvist,D,DAL,24,0,0,0,0
42,8482165,Yan Kuznetsov,D,CGY,22,0,0,0,0
42,8484258,Sam Malinski,D,COL,26,0,0,0,0
42,8480157,Calle Rosen,D,STL,30,0,0,0,0
42,8484304,Uvis Balinskis,D,FLA,28,0,0,0,0
42,8479985,Cale Fleury,D,SEA,26,0,0,0,0
42,8479378,Logan Stanley,D,WPG,26,0,0,0,0
42,8477541,Dakota Mermis,D,MIN,30,0,0,0,0
42,8481609,Vladislav Kolyachonok,D,ARI,23,0,0,0,0
42,8480823,Alexander Alexeyev,D,WSH,25,0,0,0,0
42,8481679,Maxence Guenette,D,OTT,23,0,0,0,0
42,8481564,Ryan Johnson,D,BUF,23,0,0,0,0
42,8479376,Victor Mete,D,PHI,26,0,0,0,0
42,8484254,Akito Hirose,D,VAN,25,0,0,0,0
42,8482660,Kent Johnson,C,CBJ,22,0,0,0,0
42,8482149,Cole Perfetti,C,WPG,22,0,0,0,0
42,8477987,Ryan Donato,C,CHI,28,0,0,0,0
42,8475755,Alexander Petrovic,D,DAL,32,0,0,0,0
42,8477810,Joel Hanley,D,CGY,33,0,0,0,0
42,8474145,Robert Bortuzzo,D,NYI,35,0,0,0,0
42,8481161,Jake Christiansen,D,CBJ,25,0,0,0,0
42,8476884,Derrick Pouliot,D,DAL,30,0,0,0,0
42,8481716,Dmitri Voronkov,L,CBJ,24,0,0,0,0
42,8480084,Nick DeSimone,D,NJD,30,0,0,0,0
42,8475750,Jon Merrill,D,MIN,32,0,0,0,0
42,8479315,Joey Anderson,R,CHI,26,0,0,0,0
42,8478011,Louie Belpedio,D,PHI,28,0,0,0,0
42,8482451,Mikael Pyyhtia,L,CBJ,23,0,0,0,0
42,8481541,Samuel Bolduc,D,NYI,24,0,0,0,0
42,8482126,Emil Andrae,D,PHI,31,0,0,0,0
42,8474618,Marco Scandella,D,STL,34,0,0,0,0
42,8477244,Chad Ruhwedel,D,NYR,34,0,0,0,0
42,8477971,Andreas Englund,D,LAK,28,0,0,0,0
42,8480829,Jesperi Kotkaniemi,C,CAR,24,0,0,0,0
42,8479372,Josh Mahura,D,FLA,26,0,0,0,0
42,8482095,Tyler Kleven,D,OTT,22,0,0,0,0
42,8481719,Maxwell Crozier,D,TBL,24,0,0,0,0
42,8475855,Jesper Fast,R,CAR,33,0,0,0,0
42,8480848,Ty Dellandrea,C,DAL,24,0,0,0,0
42,8475193,Tomas Tatar,L,SEA,34,0,0,0,0
42,8476889,Radek Faksa,C,DAL,30,0,0,0,0
42,8478495,Denis Gurianov,R,PHI,27,0,0,0,0
42,8480216,Jacob Peterson,C,SJS,25,0,0,0,0
42,8480252,Cole Guttman,C,CHI,25,0,0,0,0
42,8479026,Philippe Myers,D,TBL,27,0,0,0,0
42,8481006,Tyler Tucker,D,STL,24,0,0,0,0
42,8481032,Paul Cotter,C,VGK,25,0,0,0,0
42,8481577,Philip Tomasino,C,NSH,23,0,0,0,0
42,8476918,Jimmy Vesey,L,NYR,31,0,0,0,0
42,8479320,Max Lajoie,D,TOR,27,0,0,0,0
42,8478017,Mark Friedman,D,VAN,29,0,0,0,0
42,8481754,Nikita Nesterenko,C,ANA,23,0,0,0,0
42,8483407,Brandon Scanlin,D,NYR,25,0,0,0,0
42,8482659,Josh Doan,R,ARI,22,0,0,0,0
42,8477446,Michael McCarron,R,NSH,29,0,0,0,0
42,8477903,Garnet Hathaway,R,PHI,33,0,0,0,0
42,8482153,Brendan Brisson,C,VGK,23,0,0,0,0
42,8483546,Marshall Rifai,D,TOR,26,0,0,0,0
42,8484287,Cole McWard,D,VAN,23,0,0,0,0
42,8478854,Ryan Shea,D,PIT,27,0,0,0,0
42,8481585,Egor Afanasyev,L,NSH,23,0,0,0,0
42,8483398,Declan Carlile,D,TBL,31,0,0,0,0
42,8478502,Dennis Gilbert,D,CGY,28,0,0,0,0
42,8482749,Joshua Roy,R,MTL,21,0,0,0,0
42,8481598,Philip Broberg,D,EDM,23,0,0,0,0
42,8480835,Jack Drury,C,CAR,24,0,0,0,0
42,8480748,Kiefer Sherwood,L,NSH,29,0,0,0,0
42,8476934,Brock McGinn,L,ANA,30,0,0,0,0
42,8480870,Bo Groulx,C,ANA,24,0,0,0,0
42,8479368,Max Jones,L,ANA,26,0,0,0,0
42,8478099,Kevin Labanc,R,SJS,29,0,0,0,0
42,8478067,Oskar Lindblom,L,SJS,28,0,0,0,0
42,8476393,Nick Cousins,C,FLA,31,0,0,0,0
42,8483395,Arshdeep Bains,L,VAN,23,0,0,0,0
42,8480762,Eric Robinson,L,BUF,29,0,0,0,0
42,8479439,Jacob MacDonald,D,SJS,31,0,0,0,0
42,8476474,Stefan Noesen,R,CAR,31,0,0,0,0
42,8482787,Nikita Chibrikov,R,WPG,31,0,0,0,0
42,8478432,Christian Fischer,R,DET,27,0,0,0,0
42,8477979,Nicolas Aube-Kubel,R,WSH,28,0,0,0,0
42,8481789,Tye Kartye,L,SEA,23,0,0,0,0
42,8479330,Brandon Gignac,C,MTL,27,0,0,0,0
42,8480075,Cameron Crotty,D,ARI,25,0,0,0,0
42,8473473,Milan Lucic,L,BOS,36,0,0,0,0
42,8482094,Daemon Hunt,D,MIN,22,0,0,0,0
42,8481206,John Ludvig,D,PIT,24,0,0,0,0
42,8483630,Pavol Regenda,L,ANA,25,0,0,0,0
42,8481617,Vasily Podkolzin,R,VAN,23,0,0,0,0
42,8480306,Grant Hutton,D,NYI,29,0,0,0,0
42,8480995,Pontus Holmberg,R,TOR,25,0,0,0,0
42,8482148,Hendrix Lapierre,C,WSH,22,0,0,0,0
42,8477478,William Carrier,L,VGK,30,0,0,0,0
42,8480003,Jesper Boqvist,C,BOS,26,0,0,0,0
42,8482172,Landon Slaggert,L,CHI,22,0,0,0,0
42,8480789,Oliver Wahlstrom,R,NYI,24,0,0,0,0
42,8474062,Riley Nash,C,NYR,35,0,0,0,0
42,8480021,Jack Studnicka,C,SJS,25,0,0,0,0
42,8480025,MacKenzie Entwistle,R,CHI,25,0,0,0,0
42,8481582,Nicholas Robertson,L,TOR,23,0,0,0,0
42,8476867,Brendan Gaunce,C,CBJ,30,0,0,0,0
42,8479619,Michael Carcone,L,ARI,28,0,0,0,0
42,8479370,Tyson Jost,C,BUF,26,0,0,0,0
42,8479671,Mathieu Olivier,R,CBJ,27,0,0,0,0
42,8476994,Vinnie Hinostroza,C,PIT,30,0,0,0,0
42,8482070,Mitchell Chaffee,R,TBL,26,0,0,0,0
42,8477473,Justin Bailey,R,SJS,29,0,0,0,0
42,8479344,Jesse Puljujarvi,R,PIT,26,0,0,0,0
42,8480205,Emil Bemstrom,C,PIT,25,0,0,0,0
42,8479718,Alex Barré-Boulet,C,TBL,27,0,0,0,0
42,8482061,Brandon Biro,L,BUF,26,0,0,0,0
42,8479638,Justin Brazeau,R,BOS,26,0,0,0,0
42,8474040,Sam Gagner,C,EDM,35,0,0,0,0
42,8477846,Ryan Carpenter,C,SJS,33,0,0,0,0
42,8482077,Dylan Holloway,L,EDM,23,0,0,0,0
42,8482157,Will Cuylle,L,NYR,22,0,0,0,0
42,8480007,Jonas Rondbjerg,R,VGK,25,0,0,0,0
42,8478874,Adam Gaudette,C,STL,28,0,0,0,0
42,8478434,Keegan Kolesar,R,VGK,27,0,0,0,0
42,8480441,Trey Fix-Wolansky,R,CBJ,25,0,0,0,0
42,8479994,Jaret Anderson-Dolan,C,NSH,25,0,0,0,0
42,8483567,Georgii Merkulov,C,BOS,24,0,0,0,0
42,8477380,Jonny Brodzinski,C,NYR,31,0,0,0,0
42,8482201,Gage Goncalves,C,TBL,23,0,0,0,0
42,8478211,Dryden Hunt,L,CGY,29,0,0,0,0
42,8471699,Andrew Cogliano,C,COL,37,0,0,0,0
42,8479421,Jacob Moverare,D,LAK,26,0,0,0,0
42,8478881,Brett Seney,L,CHI,28,0,0,0,0
42,8477464,Nic Petan,C,MIN,29,0,0,0,0
42,8475958,Michael Sgarbossa,C,WSH,32,0,0,0,0
42,8481147,Reese Johnson,C,CHI,26,0,0,0,0
42,8479336,Carl Grundstrom,R,LAK,27,0,0,0,0
42,8480853,Liam Foudy,C,NSH,24,0,0,0,0
42,8479522,Hardy Haman Aktell,D,WSH,26,0,0,0,0
42,8481462,Mason Morelli,L,VGK,28,0,0,0,0
42,8482102,Vasily Ponomarev,C,CAR,22,0,0,0,0
42,8480844,Grigori Denisenko,L,VGK,24,0,0,0,0
42,8479944,Zach Aston-Reese,C,DET,30,0,0,0,0
42,8482784,Zach Dean,C,STL,21,0,0,0,0
42,8479419,Brett Murray,L,BUF,26,0,0,0,0
42,8479520,Brandon Duhaime,R,COL,27,0,0,0,0
42,8477573,Nathan Walker,L,STL,30,0,0,0,0
42,8478078,Rourke Chartier,C,OTT,28,0,0,0,0
42,8475795,Dylan McIlrath,D,WSH,32,0,0,0,0
42,8482496,Nils Aman,C,VAN,24,0,0,0,0
42,8480289,Morgan Barron,C,WPG,26,0,0,0,0
42,8481751,Lukas Rousek,R,BUF,25,0,0,0,0
42,8480011,Klim Kostin,C,SJS,25,0,0,0,0
42,8481556,John Beecher,C,BOS,23,0,0,0,0
42,8475278,Byron Froese,C,VGK,33,0,0,0,0
42,8475225,Craig Smith,C,DAL,35,0,0,0,0
42,8484326,Patrik Koch,D,ARI,28,0,0,0,0
42,8477930,Pierre-Edouard Bellemare,L,SEA,39,0,0,0,0
42,8478409,Anthony Richard,C,BOS,28,0,0,0,0
42,8481024,Linus Karlsson,C,VAN,25,0,0,0,0
42,8479986,Kole Lind,R,SEA,26,0,0,0,0
42,8479414,Nathan Bastian,R,NJD,27,0,0,0,0
42,8479362,Riley Tufte,L,COL,26,0,0,0,0
42,8481058,Jesse Ylönen,R,MTL,25,0,0,0,0
42,8482476,Emil Heineman,L,MTL,23,0,0,0,0
42,8482861,Vincent Iorio,D,WSH,22,0,0,0,0
42,8483432,Luca Del Bel Belluz,C,CBJ,31,0,0,0,0
42,8482744,James Malatesta,L,CBJ,21,0,0,0,0
42,8477887,Patrick Brown,C,BOS,32,0,0,0,0
42,8478585,Derek Ryan,C,EDM,38,0,0,0,0
42,8481441,Joe Snively,C,WSH,28,0,0,0,0
42,8481592,Jakob Pelletier,L,CGY,23,0,0,0,0
42,8482634,Alex Steeves,C,TOR,25,0,0,0,0
42,8477126,Jayson Megna,C,BOS,34,0,0,0,0
42,8475752,Tyler Pitlick,C,NYR,33,0,0,0,0
42,8480008,Adam Ruzicka,C,ARI,25,0,0,0,0
42,8481065,Angus Crookshank,L,OTT,25,0,0,0,0
42,8479547,Matthew Phillips,R,WSH,26,0,0,0,0
42,8480226,Marián Studenic,R,SEA,26,0,0,0,0
42,8481237,Kyle MacLean,C,NYI,25,0,0,0,0
42,8475413,Justin Dowling,C,NJD,34,0,0,0,0
42,8481641,Joel Kiviranta,L,COL,28,0,0,0,0
42,8478104,Sammy Blais,L,STL,28,0,0,0,0
42,8477454,Adam Erne,L,EDM,29,0,0,0,0
42,8481518,Nolan Foote,L,NJD,24,0,0,0,0
42,8480245,Olle Lycksell,R,PHI,25,0,0,0,0
42,8483570,Ben Meyers,C,ANA,26,0,0,0,0
42,8480776,Sheldon Rempal,R,VGK,29,0,0,0,0
42,8483920,Pierrick Dube,R,WSH,23,0,0,0,0
42,8480267,Sammy Walker,C,MIN,25,0,0,0,0
42,8482747,Brennan Othmann,L,NYR,21,0,0,0,0
42,8479991,Jake Leschyshyn,C,NYR,25,0,0,0,0
42,8478400,Colin White,C,MTL,27,0,0,0,0
42,8479328,Julien Gauthier,R,NYI,27,0,0,0,0
42,8484325,Waltteri Merela,C,TBL,26,0,0,0,0
42,8479066,Ryan Lomberg,L,FLA,30,0,0,0,0
42,8477070,Liam O'Brien,C,ARI,30,0,0,0,0
42,8478146,Matthew Highmore,C,OTT,28,0,0,0,0
42,8478028,Fredrik Olofsson,L,COL,28,0,0,0,0
42,8480880,Jakub Lauko,C,BOS,24,0,0,0,0
42,8479968,Vinni Lettieri,C,MIN,29,0,0,0,0
42,8474709,Matt Martin,L,NYI,35,0,0,0,0
42,8480845,Rasmus Kupari,C,WPG,24,0,0,0,0
42,8481550,Adam Beckman,L,MIN,23,0,0,0,0
42,8481422,Jacob Lucchini,C,MIN,29,0,0,0,0
42,8477401,John Hayden,C,SEA,29,0,0,0,0
42,8478904,Steven Lorentz,C,FLA,28,0,0,0,0
42,8482088,Justin Sourdif,R,FLA,22,0,0,0,0
42,8482751,Ryan Winterton,C,SEA,21,0,0,0,0
42,8482241,Radim Zohorna,L,PIT,28,0,0,0,0
42,8481690,Tyler Angle,C,CBJ,24,0,0,0,0
42,8476952,Dominic Toninato,C,WPG,30,0,0,0,0
42,8476919,Chris Tierney,C,NJD,30,0,0,0,0
42,8480032,Shane Bowers,C,NJD,25,0,0,0,0
42,8484314,Jiri Smejkal,L,OTT,28,0,0,0,0
42,8481239,Samuel Fagemo,L,LAK,24,0,0,0,0
42,8481532,Alex Turcotte,C,LAK,23,0,0,0,0
42,8481019,David Gustafsson,C,WPG,24,0,0,0,0
42,8478477,Mitchell Stephens,C,MTL,27,0,0,0,0
42,8479546,Oskar Steen,C,BOS,26,0,0,0,0
42,8480292,Carson Meyer,R,CBJ,27,0,0,0,0
42,8478446,Glenn Gawdin,C,ANA,27,0,0,0,0
42,8483531,Brian Halonen,L,NJD,25,0,0,0,0
42,8477149,Scott Sabourin,R,SJS,32,0,0,0,0
42,8479972,Mason Shaw,C,MIN,26,0,0,0,0
42,8480890,Jan Jenik,R,ARI,24,0,0,0,0
42,8478051,Max Willman,C,NJD,29,0,0,0,0
42,8480851,Akil Thomas,C,LAK,24,0,0,0,0
42,8482765,Isak Rosen,R,BUF,21,0,0,0,0
42,8478421,A.J. Greer,L,CGY,28,0,0,0,0
42,8478512,Austin Czarnik,C,DET,32,0,0,0,0
42,8479536,Axel Jonsson-Fjallby,L,WPG,26,0,0,0,0
42,8477320,Anton Blidh,L,NYR,29,0,0,0,0
42,8481543,Nikita Alexandrov,C,STL,24,0,0,0,0
42,8475235,Nicolas Deslauriers,L,PHI,33,0,0,0,0
42,8481070,Hugh McGing,L,STL,26,0,0,0,0
42,8480836,Jonathan Gruden,C,PIT,24,0,0,0,0
42,8481591,Sam Poulin,R,PIT,23,0,0,0,0
42,8477962,Brendan Lemieux,L,CAR,28,0,0,0,0
42,8483401,Marc Johnstone,R,PIT,28,0,0,0,0
42,8482250,Callahan Burke,C,CAR,27,0,0,0,0
42,8481726,Adam Edstrom,C,NYR,24,0,0,0,0
42,8471817,Ryan Reaves,R,TOR,37,0,0,0,0
42,8479587,Rhett Gardner,C,PHI,28,0,0,0,0
42,8475766,Austin Watson,L,TBL,32,0,0,0,0
42,8479367,William Lockwood,R,FLA,26,0,0,0,0
42,8478424,Jansen Harkins,C,PIT,27,0,0,0,0
42,8476913,Devin Shore,C,SEA,30,0,0,0,0
42,8482652,Walker Duehr,R,CGY,27,0,0,0,0
42,8477527,Ross Johnston,L,ANA,30,0,0,0,0
42,8481077,John Leonard,L,ARI,26,0,0,0,0
42,8483549,Lucas Condotta,L,MTL,27,0,0,0,0
42,8480468,James Hamblin,L,EDM,25,0,0,0,0
42,8476907,Mackenzie MacEachern,L,STL,30,0,0,0,0
42,8479543,Michael Pezzetta,L,MTL,26,0,0,0,0
42,8480355,Mark Kastelic,C,OTT,25,0,0,0,0
42,8482162,Roby Jarventie,L,OTT,22,0,0,0,0
42,8479772,Zack MacEwen,R,OTT,28,0,0,0,0
42,8483597,Milos Kelemen,L,ARI,25,0,0,0,0
42,8479379,Givani Smith,R,SJS,26,0,0,0,0
42,8481655,Cole Schwindt,R,CGY,23,0,0,0,0
42,8479981,Jonah Gadjovich,L,FLA,26,0,0,0,0
42,8482147,Jean-Luc Foudy,C,COL,22,0,0,0,0
42,8484255,Jason Polin,R,COL,25,0,0,0,0
42,8477993,Justin Kirkland,C,ARI,28,0,0,0,0
42,8479249,Andrew Poturalski,C,SEA,30,0,0,0,0
42,8482197,Adam Raska,R,MIN,23,0,0,0,0
42,8475780,Chris Wagner,R,COL,33,0,0,0,0
42,8479533,Joona Koppanen,L,PIT,26,0,0,0,0
42,8481534,Raphael Lavoie,C,EDM,24,0,0,0,0
42,8484321,Nikolas Matinpalo,D,OTT,26,0,0,0,0
42,8481043,Cole Koepke,L,TBL,26,0,0,0,0
42,8476323,Max McCormick,L,SEA,32,0,0,0,0
42,8483609,Adam Klapka,R,CGY,24,0,0,0,0
42,8483512,Matt Savoie,C,BUF,20,0,0,0,0
42,8484259,Ondrej Pavel,C,COL,31,0,0,0,0
42,8478147,Bokondji Imama,L,OTT,28,0,0,0,0
42,8482460,Matt Rempe,C,NYR,22,0,0,0,0
42,8477073,Kurtis MacDermid,L,NJD,30,0,0,0,0
42,8480274,Philip Kemp,D,EDM,25,0,0,0,0
42,8478956,Samuel Laberge,L,NJD,27,0,0,0,0
42,8483045,Cameron Butler,R,CBJ,31,0,0,0,0
43,8478402,Connor McDavid,C,EDM,27,82,41,84,125
43,8479318,Auston Matthews,C,TOR,27,82,59,49,108
43,8481559,Jack Hughes,C,NJD,23,82,43,65,108
43,8477934,Leon Draisaitl,C,EDM,29,82,42,65,107
43,8476468,J.T. Miller,C,VAN,31,82,30,75,105
43,8478550,Artemi Panarin,L,NYR,33,82,48,50,98
43,8477939,William Nylander,R,TOR,28,82,39,56,95
43,8477492,Nathan MacKinnon,C,COL,29,82,37,57,94
43,8476453,Nikita Kucherov,R,TBL,31,82,19,74,93
43,8478420,Mikko Rantanen,R,COL,28,82,48,43,91
43,8480027,Jason Robertson,L,DAL,25,82,34,57,91
43,8475786,Zach Hyman,L,EDM,32,82,54,35,89
43,8479314,Matthew Tkachuk,L,FLA,27,82,30,58,88
43,8480069,Cale Makar,D,COL,26,82,26,61,87
43,8477404,Jake Guentzel,C,CAR,30,82,43,43,86
43,8480830,Andrei Svechnikov,R,CAR,24,82,36,49,85
43,8474564,Steven Stamkos,C,TBL,34,82,39,45,84
43,8477956,David Pastrnak,R,BOS,28,82,33,51,84
43,8482116,Tim Stützle,C,OTT,22,82,35,48,83
43,8480023,Robert Thomas,C,STL,25,82,26,57,83
43,8480803,Evan Bouchard,D,EDM,25,82,16,66,82
43,8480012,Elias Pettersson,C,VAN,26,82,32,49,81
43,8478427,Sebastian Aho,C,CAR,27,82,27,54,81
43,8480002,Nico Hischier,C,NJD,25,82,26,55,81
43,8480208,Drake Batherson,R,OTT,26,82,33,47,80
43,8479385,Jordan Kyrou,C,STL,26,82,36,41,77
43,8477933,Sam Reinhart,C,FLA,29,82,32,45,77
43,8477946,Dylan Larkin,C,DET,28,82,34,42,76
43,8475166,John Tavares,C,TOR,34,82,37,38,75
43,8474141,Patrick Kane,R,DET,36,82,27,48,75
43,8479420,Tage Thompson,C,BUF,27,82,39,35,74
43,8477493,Aleksander Barkov,C,FLA,29,82,31,43,74
43,8470794,Joe Pavelski,C,DAL,40,82,30,44,74
43,8475172,Nazem Kadri,C,CGY,34,82,36,37,73
43,8478864,Kirill Kaprizov,L,MIN,27,82,34,39,73
43,8479343,Clayton Keller,R,ARI,26,82,33,40,73
43,8478414,Timo Meier,R,NJD,28,82,38,34,72
43,8476459,Mika Zibanejad,C,NYR,31,82,33,39,72
43,8477402,Pavel Buchnevich,L,STL,29,82,29,43,72
43,8479323,Adam Fox,D,NYR,26,82,14,58,72
43,8475798,Mikael Granlund,C,SJS,32,82,15,56,71
43,8480800,Quinn Hughes,D,VAN,25,82,13,58,71
43,8478010,Brayden Point,C,TBL,28,82,37,33,70
43,8478398,Kyle Connor,L,WPG,28,82,35,35,70
43,8482078,Lucas Raymond,L,DET,22,82,27,43,70
43,8471675,Sidney Crosby,C,PIT,37,82,25,45,70
43,8475913,Mark Stone,R,VGK,32,82,26,43,69
43,8474600,Roman Josi,D,NSH,34,82,23,46,69
43,8471215,Evgeni Malkin,C,PIT,38,82,29,39,68
43,8476887,Filip Forsberg,L,NSH,30,82,39,28,67
43,8479407,Jesper Bratt,L,NJD,26,82,32,35,67
43,8480018,Nick Suzuki,C,MTL,25,82,29,38,67
43,8477501,Valeri Nichushkin,R,COL,29,82,28,39,67
43,8476389,Vincent Trocheck,C,NYR,31,82,25,42,67
43,8475158,Ryan O'Reilly,C,NSH,33,82,23,44,67
43,8478439,Travis Konecny,R,PHI,27,82,22,45,67
43,8480801,Brady Tkachuk,L,OTT,25,82,30,36,66
43,8477496,Elias Lindholm,C,VAN,30,82,27,38,65
43,8477949,Alex Tuch,R,BUF,28,82,21,44,65
43,8474578,Erik Karlsson,D,PIT,34,82,18,47,65
43,8475810,Bryan Rust,R,PIT,32,82,38,26,64
43,8478403,Jack Eichel,C,VGK,28,82,25,39,64
43,8478042,Viktor Arvidsson,R,LAK,31,82,24,40,64
43,8473512,Claude Giroux,R,OTT,36,82,17,47,64
43,8477409,Carter Verhaeghe,C,FLA,29,82,30,33,63
43,8477942,Kevin Fiala,L,LAK,28,82,28,35,63
43,8478445,Mathew Barzal,C,NYI,27,82,24,39,63
43,8476460,Mark Scheifele,C,WPG,31,82,24,39,63
43,8475692,Mats Zuccarello,R,MIN,37,82,16,47,63
43,8481523,Kirby Dach,C,MTL,23,82,14,49,63
43,8476539,Jonathan Marchessault,R,VGK,34,82,37,25,62
43,8479542,Brandon Hagel,L,TBL,26,82,29,33,62
43,8478873,Troy Terry,R,ANA,27,82,27,35,62
43,8478449,Roope Hintz,C,DAL,28,82,24,38,62
43,8478444,Brock Boeser,R,VAN,27,82,35,26,61
43,8477500,Bo Horvat,C,NYI,29,82,34,27,61
43,8476346,Johnny Gaudreau,L,CBJ,31,82,17,44,61
43,8481540,Cole Caufield,R,MTL,23,82,35,25,60
43,8482097,Jack Quinn,R,BUF,23,82,27,33,60
43,8477960,Adrian Kempe,R,LAK,28,82,27,33,60
43,8479425,Filip Hronek,D,VAN,27,82,12,48,60
43,8479410,Mikhail Sergachev,D,TBL,26,82,10,50,60
43,8479337,Alex DeBrincat,R,DET,27,82,26,33,59
43,8477940,Nikolaj Ehlers,L,WPG,28,82,22,37,59
43,8480188,Fabian Zetterlund,L,SJS,25,82,22,37,59
43,8481557,Matt Boldy,L,MIN,23,82,19,40,59
43,8478975,Mason Marchment,L,DAL,29,82,19,40,59
43,8480036,Miro Heiskanen,D,DAL,25,82,9,50,59
43,8476483,Rickard Rakell,R,PIT,31,82,27,31,58
43,8482124,Quinton Byfield,R,LAK,22,82,24,34,58
43,8475168,Matt Duchene,C,DAL,33,82,23,35,58
43,8477951,Nick Schmaltz,C,ARI,28,82,23,35,58
43,8476456,Jonathan Huberdeau,C,CGY,31,82,16,42,58
43,8480839,Rasmus Dahlin,D,BUF,24,82,16,41,57
43,8476454,Ryan Nugent-Hopkins,C,EDM,31,82,16,41,57
43,8482684,Luke Hughes,D,NJD,21,82,14,43,57
43,8475184,Chris Kreider,L,NYR,33,82,35,21,56
43,8477451,Ryan Hartman,R,MIN,30,82,25,31,56
43,8473419,Brad Marchand,L,BOS,36,82,21,35,56
43,8480798,Philipp Kurashev,C,CHI,25,82,15,41,56
43,8478407,Vince Dunn,D,SEA,28,82,12,44,56
43,8479339,Patrik Laine,L,CBJ,26,82,25,30,55
43,8473994,Jamie Benn,L,DAL,35,82,23,32,55
43,8477479,Tyler Bertuzzi,L,TOR,29,82,22,33,55
43,8480078,Filip Chytil,C,NYR,25,82,22,33,55
43,8478440,Dylan Strome,C,WSH,27,82,18,37,55
43,8477986,Brandon Montour,D,FLA,30,82,11,44,55
43,8476853,Morgan Rielly,D,TOR,30,82,6,49,55
43,8475726,Tyler Toffoli,C,WPG,32,82,33,21,54
43,8475768,Jaden Schwartz,C,SEA,32,82,32,22,54
43,8477447,Shea Theodore,D,VGK,29,82,15,39,54
43,8477504,Josh Morrissey,D,WPG,29,82,15,39,54
43,8478397,Rasmus Andersson,D,CGY,28,82,8,46,54
43,8478498,Jake DeBrusk,L,BOS,28,82,28,25,53
43,8474641,Adam Henrique,C,EDM,34,82,27,26,53
43,8479400,Pierre-Luc Dubois,L,LAK,26,82,24,29,53
43,8482093,Seth Jarvis,C,CAR,22,82,23,30,53
43,8476869,Brady Skjei,D,CAR,30,82,23,30,53
43,8477476,Artturi Lehkonen,L,COL,29,82,21,32,53
43,8477416,Oliver Bjorkstrand,R,SEA,29,82,16,37,53
43,8475167,Victor Hedman,D,TBL,34,82,14,39,53
43,8479325,Charlie McAvoy,D,BOS,27,82,6,47,53
43,8481068,Yegor Sharangovich,C,CGY,26,82,25,27,52
43,8483808,Andrei Kuzmenko,L,CGY,28,82,25,27,52
43,8475765,Vladimir Tarasenko,R,FLA,33,82,19,33,52
43,8478493,Joel Eriksson Ek,C,MIN,27,82,18,34,52
43,8482745,Mason McTavish,C,ANA,21,82,16,36,52
43,8480865,Noah Dobson,D,NYI,24,82,13,39,52
43,8471214,Alex Ovechkin,L,WSH,39,82,25,26,51
43,8478474,Lawson Crouse,L,ARI,27,82,25,26,51
43,8482740,Wyatt Johnston,C,DAL,21,82,25,26,51
43,8482110,Dawson Mercer,C,NJD,23,82,25,26,51
43,8477407,Anthony Duclair,L,TBL,29,82,20,31,51
43,8478047,Michael Bunting,L,PIT,29,82,17,34,51
43,8476882,Teuvo Teravainen,L,CAR,30,82,14,37,51
43,8476906,Shayne Gostisbehere,D,DET,31,82,11,40,51
43,8475784,Jeff Skinner,C,BUF,32,82,25,25,50
43,8482109,Alexis Lafrenière,L,NYR,23,82,22,28,50
43,8478401,Pavel Zacha,C,BOS,27,82,17,33,50
43,8476905,Chandler Stephenson,C,VGK,30,82,16,34,50
43,8478038,Devon Toews,D,COL,30,82,13,37,50
43,8484144,Connor Bedard,C,CHI,19,82,35,14,49
43,8483524,Shane Wright,C,SEA,20,82,31,18,49
43,8478366,Frank Vatrano,R,ANA,30,82,25,24,49
43,8481533,Trevor Zegras,C,ANA,23,82,23,26,49
43,8475191,Reilly Smith,R,PIT,33,82,19,30,49
43,8478856,Conor Garland,R,VAN,28,82,15,34,49
43,8474150,Mikael Backlund,C,CGY,35,82,15,34,49
43,8474679,Gustav Nyquist,C,NSH,35,82,14,35,49
43,8476792,Torey Krug,D,STL,33,82,10,39,49
43,8477955,Jared McCann,L,SEA,28,82,24,24,48
43,8476432,Boone Jenner,C,CBJ,31,82,21,27,48
43,8474157,Max Pacioretty,L,WSH,36,82,19,29,48
43,8480039,Martin Necas,C,CAR,25,82,18,30,48
43,8474102,David Perron,L,DET,36,82,18,30,48
43,8480031,Maxime Comtois,L,CAR,25,82,13,35,48
43,8478460,Zach Werenski,D,CBJ,27,82,10,38,48
43,8480014,Gabriel Vilardi,C,WPG,25,82,28,19,47
43,8480015,Owen Tippett,R,PHI,25,82,25,22,47
43,8475791,Taylor Hall,L,CHI,33,82,22,25,47
43,8477511,Anthony Mantha,R,VGK,30,82,22,25,47
43,8473986,Alex Killorn,L,ANA,35,82,20,27,47
43,8477444,Andre Burakovsky,L,SEA,29,82,20,27,47
43,8471685,Anze Kopitar,C,LAK,37,82,18,29,47
43,8482667,William Eklund,L,SJS,22,82,18,29,47
43,8477497,Sean Monahan,C,WPG,30,82,16,31,47
43,8480220,Noah Cates,L,PHI,25,82,16,31,47
43,8475170,Brayden Schenn,C,STL,33,82,15,32,47
43,8476448,William Karlsson,C,VGK,31,82,13,34,47
43,8482101,Danil Gushchin,L,SJS,22,82,22,24,46
43,8482665,Matty Beniers,C,SEA,22,82,17,29,46
43,8480113,Alex Iafallo,L,WPG,31,82,16,30,46
43,8481711,Matias Maccelli,L,ARI,24,82,15,31,46
43,8481542,Moritz Seider,D,DET,23,82,12,34,46
43,8476880,Tom Wilson,R,WSH,30,82,20,25,45
43,8482159,Tyson Foerster,R,PHI,22,82,19,26,45
43,8475169,Evander Kane,L,EDM,33,82,17,28,45
43,8479999,Casey Mittelstadt,C,COL,26,82,16,29,45
43,8476826,Yanni Gourde,C,SEA,33,82,16,29,45
43,8482133,Thomas Bordeleau,C,SJS,22,82,16,29,45
43,8474586,Jordan Eberle,R,SEA,34,82,15,30,45
43,8478115,Pierre Engvall,L,NYI,28,82,24,20,44
43,8478109,Victor Olofsson,L,BUF,29,82,21,23,44
43,8479675,Trevor Moore,L,LAK,29,82,20,24,44
43,8474189,Lars Eller,C,PIT,35,82,20,24,44
43,8482720,Matthew Knies,L,TOR,22,82,15,29,44
43,8480028,Morgan Frost,C,PHI,25,82,13,31,44
43,8476458,Ryan Strome,C,ANA,31,82,13,31,44
43,8483445,Cutter Gauthier,L,ANA,20,82,12,32,44
43,8476462,Dougie Hamilton,D,NJD,31,82,8,36,44
43,8471724,Kris Letang,D,PIT,37,82,8,36,44
43,8475754,Brock Nelson,C,NYI,33,82,22,21,43
43,8478466,Daniel Sprong,R,DET,27,82,20,23,43
43,8475151,Kyle Palmieri,C,NYI,33,82,19,24,43
43,8481528,Dylan Cozens,C,BUF,23,82,17,26,43
43,8477456,J.T. Compher,L,DET,29,82,15,28,43
43,8475197,Tyson Barrie,D,NSH,33,82,14,29,43
43,8478542,Evan Rodrigues,C,FLA,31,82,11,32,43
43,8480434,Sean Durzi,D,ARI,26,82,10,33,43
43,8475744,Evgeny Kuznetsov,C,CAR,32,82,9,34,43
43,8480009,Eeli Tolvanen,R,SEA,25,82,18,24,42
43,8480797,Joel Farabee,L,PHI,24,82,18,24,42
43,8481618,Alex Newhook,C,MTL,23,82,15,27,42
43,8477021,Alex Kerfoot,C,ARI,30,82,15,27,42
43,8482671,Owen Power,D,BUF,22,82,15,27,42
43,8478519,Anthony Cirelli,C,TBL,27,82,14,28,42
43,8476881,Tomas Hertl,C,VGK,31,82,14,28,42
43,8477503,Max Domi,C,TOR,29,82,9,33,42
43,8475764,Cam Fowler,D,ANA,33,82,5,37,42
43,8480064,Josh Norris,C,OTT,25,82,21,20,41
43,8482699,Dylan Guenther,R,ARI,21,82,19,22,41
43,8482222,Alexander Barabanov,L,SJS,30,82,19,22,41
43,8479525,Ross Colton,C,COL,28,82,18,23,41
43,8481596,Shane Pinto,C,OTT,24,82,16,25,41
43,8475745,Charlie Coyle,C,BOS,32,82,14,27,41
43,8483515,Juraj Slafkovsky,L,MTL,20,82,13,28,41
43,8477494,Jonathan Drouin,L,COL,29,82,12,29,41
43,8477944,Jakub Vrana,L,STL,28,82,33,7,40
43,8471698,T.J. Oshie,R,WSH,38,82,22,18,40
43,8480821,Filip Zadina,R,SJS,25,82,21,19,40
43,8475722,Jason Zucker,L,NSH,32,82,21,19,40
43,8475218,Mattias Ekholm,D,EDM,34,82,14,26,40
43,8478438,Tommy Novak,C,NSH,27,82,14,26,40
43,8474590,John Carlson,D,WSH,34,82,13,27,40
43,8478458,Jack Roslovic,C,NYR,27,82,13,27,40
43,8476480,Vladislav Namestnikov,C,WPG,32,82,13,27,40
43,8477488,Brett Pesce,D,CAR,30,82,11,29,40
43,8476875,Mike Matheson,D,MTL,30,82,6,34,40
43,8477346,MacKenzie Weegar,D,CGY,30,82,0,40,40
43,8475287,Erik Haula,L,NJD,33,82,21,18,39
43,8474053,Logan Couture,C,SJS,35,82,16,23,39
43,8476479,Phillip Danault,C,LAK,31,82,15,24,39
43,8475714,Calle Jarnkrok,C,TOR,33,82,15,24,39
43,8477495,Seth Jones,D,CHI,30,82,13,26,39
43,8477964,Ivan Barbashev,C,VGK,29,82,11,28,39
43,8478396,Noah Hanifin,D,VGK,27,82,7,32,39
43,8475760,Nick Bjugstad,C,ARI,32,82,25,13,38
43,8477426,Nicholas Paul,L,TBL,29,82,22,16,38
43,8478043,Sam Lafferty,C,VAN,29,82,22,16,38
43,8477989,Christian Dvorak,C,MTL,28,82,20,18,38
43,8479345,Jakob Chychrun,D,OTT,26,82,19,19,38
43,8474870,Tyler Johnson,C,CHI,34,82,19,19,38
43,8478462,Nicolas Roy,C,VGK,27,82,17,21,38
43,8475794,Tyler Seguin,C,DAL,32,82,16,22,38
43,8476438,Brandon Saad,L,STL,32,82,13,25,38
43,8481581,Thomas Harley,D,DAL,23,82,11,27,38
43,8483457,Lane Hutson,D,MTL,20,82,9,29,38
43,8470613,Brent Burns,D,CAR,39,82,8,30,38
43,8473563,Nicklas Backstrom,C,WSH,37,82,8,30,38
43,8477948,Travis Sanheim,D,PHI,28,82,7,31,38
43,8474563,Drew Doughty,D,LAK,35,82,5,33,38
43,8476399,Blake Coleman,C,CGY,33,82,18,19,37
43,8482113,Anton Lundell,C,FLA,23,82,15,22,37
43,8481186,Logan O'Connor,R,COL,28,82,15,22,37
43,8478233,Andrew Mangiapane,L,CGY,28,82,14,23,37
43,8471218,Blake Wheeler,R,NYR,38,82,14,23,37
43,8482475,Yegor Chinakhov,R,CBJ,23,82,13,24,37
43,8478055,Gustav Forsling,D,FLA,28,82,13,24,37
43,8482055,Drew O'Connor,L,PIT,26,82,12,25,37
43,8482105,Jake Sanderson,D,OTT,22,82,7,30,37
43,8483471,Brad Lambert,C,WPG,31,82,5,32,37
43,8473422,Nick Foligno,L,CHI,37,82,11,25,36
43,8482092,Ridly Greig,C,OTT,22,82,10,26,36
43,8474565,Alex Pietrangelo,D,VGK,34,82,10,26,36
43,8480817,K'Andre Miller,D,NYR,24,82,9,27,36
43,8480873,Rasmus Sandin,D,WSH,24,82,7,29,36
43,8481567,Henry Thrun,D,SJS,23,82,7,29,36
43,8481554,Kaapo Kakko,R,NYR,23,82,20,15,35
43,8477429,Andrew Copp,C,DET,30,82,16,19,35
43,8477952,Robby Fabbri,C,DET,28,82,15,20,35
43,8481656,Aliaksei Protas,C,WSH,23,82,13,22,35
43,8477498,Darnell Nurse,D,EDM,29,82,10,25,35
43,8480336,Sean Walker,D,COL,30,82,10,25,35
43,8478133,Jake Evans,C,MTL,28,82,9,26,35
43,8478500,Ivan Provorov,D,CBJ,27,82,3,32,35
43,8483397,Marc McLaughlin,C,BOS,25,82,30,4,34
43,8482702,Logan Stankoven,C,DAL,21,82,23,11,34
43,8475848,Brendan Gallagher,R,MTL,32,82,18,16,34
43,8479941,Justin Danforth,R,CBJ,31,82,17,17,34
43,8481624,Ilya Mikheyev,R,VAN,30,82,16,18,34
43,8473533,Jordan Staal,C,CAR,36,82,16,18,34
43,8481553,Bobby Brink,R,PHI,23,82,16,18,34
43,8478469,Thomas Chabot,D,OTT,27,82,15,19,34
43,8474037,James van Riemsdyk,L,BOS,35,82,15,19,34
43,8477932,Aaron Ekblad,D,FLA,28,82,14,20,34
43,8475799,Nino Niederreiter,R,WPG,32,82,13,21,34
43,8481013,Jonatan Berggren,R,DET,24,82,12,22,34
43,8479987,Morgan Geekie,C,BOS,26,82,11,23,34
43,8475906,John Klingberg,D,TOR,32,82,5,29,34
43,8475753,Justin Faulk,D,STL,32,82,5,29,34
43,8477935,Sam Bennett,C,FLA,28,82,18,15,33
43,8481535,Nils Hoglander,L,VAN,24,82,18,15,33
43,8480185,Eetu Luostarinen,C,FLA,26,82,18,15,33
43,8481560,Arthur Kaliyev,R,LAK,23,82,16,17,33
43,8476419,Jean-Gabriel Pageau,C,NYI,32,82,16,17,33
43,8482175,JJ Peterka,R,BUF,22,82,15,18,33
43,8478057,Dakota Joshua,C,VAN,28,82,15,18,33
43,8478413,Jordan Greenway,L,BUF,27,82,14,19,33
43,8476925,Colton Sissons,C,NSH,31,82,12,21,33
43,8475763,Kevin Hayes,R,STL,32,82,11,22,33
43,8482146,Luke Evangelista,R,NSH,22,82,11,22,33
43,8479992,Michael Rasmussen,C,DET,25,82,10,23,33
43,8477450,Jason Dickinson,C,CHI,29,82,10,23,33
43,8479365,Trent Frederic,C,BOS,26,82,9,24,33
43,8478472,Mathieu Joseph,R,OTT,27,82,8,25,33
43,8481014,Alexander Romanov,D,NYI,24,82,6,27,33
43,8481568,Alex Vlasic,D,CHI,23,82,5,28,33
43,8483431,Logan Cooley,C,ARI,20,82,20,12,32
43,8479316,Luke Kunin,C,SJS,27,82,19,13,32
43,8482259,Bobby McMann,C,TOR,28,82,18,14,32
43,8476461,Sean Couturier,C,PHI,32,82,13,19,32
43,8479996,Cody Glass,C,NSH,25,82,13,19,32
43,8482062,Cole Smith,L,NSH,29,82,13,19,32
43,8475220,Marcus Foligno,L,MIN,33,82,11,21,32
43,8476854,Hampus Lindholm,D,BOS,30,82,7,25,32
43,8476463,Jonas Brodin,D,MIN,31,82,6,26,32
43,8481699,Aku Raty,R,ARI,23,82,1,31,32
43,8482089,Jake Neighbours,L,STL,22,82,21,10,31
43,8477330,Dominik Kubalik,L,OTT,29,82,18,13,31
43,8476871,Tanner Pearson,L,MTL,32,82,16,15,31
43,8476329,Travis Boyd,C,ARI,31,82,9,22,31
43,8482117,Lukas Reichel,L,CHI,22,82,8,23,31
43,8476958,Jaccob Slavin,D,CAR,30,82,6,25,31
43,8480043,Timothy Liljegren,D,TOR,25,82,4,27,31
43,8483499,Liam Ohgren,L,MIN,20,82,18,12,30
43,8479390,Taylor Raddysh,R,CHI,26,82,16,14,30
43,8476469,Joel Armia,R,MTL,31,82,15,15,30
43,8477947,Sonny Milano,L,WSH,28,82,12,18,30
43,8480281,Alexey Toropchenko,R,STL,25,82,12,18,30
43,8476921,Jordan Martinook,L,CAR,32,82,12,18,30
43,8476873,Mark Jankowski,C,NSH,30,82,11,19,30
43,8482122,Brock Faber,D,MIN,22,82,7,23,30
43,8482087,Kaiden Guhle,D,MTL,22,82,5,25,30
43,8481604,Pavel Dorofeyev,L,VGK,24,82,18,11,29
43,8481704,Juuso Parssinen,C,NSH,23,82,17,12,29
43,8478891,Mason Appleton,C,WPG,28,82,13,16,29
43,8474034,Pat Maroon,L,BOS,36,82,13,16,29
43,8479977,Kailer Yamamoto,R,SEA,26,82,12,17,29
43,8479514,Rem Pitlick,C,CHI,27,82,11,18,29
43,8480459,Pius Suter,C,VAN,28,82,10,19,29
43,8475200,Dmitry Orlov,D,CAR,33,82,10,19,29
43,8481546,Cam York,D,PHI,23,82,9,20,29
43,8480145,Neal Pionk,D,WPG,29,82,8,21,29
43,8479398,Samuel Girard,D,COL,26,82,6,23,29
43,8482142,Jamie Drysdale,D,PHI,22,82,6,23,29
43,8478882,Vladislav Gavrikov,D,LAK,29,82,4,25,29
43,8482655,J.J. Moser,D,ARI,24,82,3,26,29
43,8480893,Kirill Marchenko,R,CBJ,24,82,18,10,28
43,8478508,Yakov Trenin,C,COL,27,82,15,13,28
43,8479351,Sam Steel,C,DAL,26,82,14,14,28
43,8482705,Cole Sillinger,C,CBJ,21,82,13,15,28
43,8474149,Evgenii Dadonov,R,DAL,35,82,13,15,28
43,8483493,Frank Nazar,C,CHI,20,82,13,15,28
43,8476981,Josh Anderson,R,MTL,30,82,12,16,28
43,8482624,Daniil Miromanov,D,CGY,27,82,11,17,28
43,8478911,Matt Roy,D,LAK,29,82,10,18,28
43,8470621,Corey Perry,R,EDM,39,82,9,19,28
43,8476292,Ondrej Palat,L,NJD,33,82,8,20,28
43,8477506,Ryan Pulock,D,NYI,30,82,7,21,28
43,8479983,Mario Ferraro,D,SJS,26,82,7,21,28
43,8481481,Blake Lizotte,C,LAK,27,82,7,21,28
43,8477969,Marcus Pettersson,D,PIT,28,82,6,22,28
43,8475171,Oliver Ekman-Larsson,D,FLA,33,82,6,22,28
43,8482118,Sam Colangelo,R,ANA,23,82,22,5,27
43,8480849,Barrett Hayton,C,ARI,24,82,15,12,27
43,8479591,Michael Eyssimont,C,TBL,28,82,14,13,27
43,8477919,Frederick Gaudreau,C,MIN,31,82,14,13,27
43,8475793,Ryan Johansen,C,PHI,32,82,13,14,27
43,8480068,Ryan Poehling,C,PHI,25,82,13,14,27
43,8479661,Tanner Jeannot,L,TBL,27,82,13,14,27
43,8478046,Danton Heinen,L,BOS,29,82,11,16,27
43,8480802,Ryan McLeod,C,EDM,25,82,11,16,27
43,8482125,Alexander Holtz,R,NJD,22,82,11,16,27
43,8478430,Oliver Kylington,D,CGY,27,82,11,16,27
43,8477998,Warren Foegele,L,EDM,28,82,10,17,27
43,8480058,Pierre-Olivier Joseph,D,PIT,25,82,8,19,27
43,8476902,Esa Lindell,D,DAL,30,82,7,20,27
43,8478178,Darren Raddysh,D,TBL,28,82,6,21,27
43,8478507,John Marino,D,NJD,27,82,6,21,27
43,8481178,Egor Zamula,D,PHI,24,82,4,23,27
43,8481016,Ruslan Iskhakov,C,NYI,24,82,0,27,27
43,8484203,Bradly Nadeau,L,CAR,19,82,15,11,26
43,8475164,Jakob Silfverberg,R,ANA,34,82,14,12,26
43,8482155,Alex Laferriere,R,LAK,23,82,13,13,26
43,8479423,Alex Nylander,L,CBJ,26,82,12,14,26
43,8474715,Cam Atkinson,R,PHI,35,82,10,16,26
43,8477015,Connor Brown,R,EDM,30,82,10,16,26
43,8479415,Michael McLeod,C,NJD,26,82,9,17,26
43,8483495,Simon Nemec,D,NJD,20,82,6,20,26
43,8477505,Alexander Wennberg,C,NYR,30,82,6,20,26
43,8474716,Jared Spurgeon,D,MIN,35,82,6,20,26
43,8475231,Casey Cizikas,C,NYI,33,82,12,13,25
43,8484166,Adam Fantilli,C,CBJ,20,82,11,14,25
43,8482245,Artem Zub,D,OTT,29,82,5,20,25
43,8479369,Andrew Peeke,D,BOS,26,82,5,20,25
43,8477365,Connor Clifton,D,BUF,29,82,4,21,25
43,8476979,Erik Gustafsson,D,NYR,32,82,2,23,25
43,8479346,Dillon Dube,C,CGY,26,82,15,9,24
43,8473449,Kyle Okposo,R,FLA,36,82,14,10,24
43,8480074,Alexandre Texier,C,CBJ,25,82,14,10,24
43,8478020,Michael Amadio,C,VGK,28,82,13,11,24
43,8480855,Jack McBain,C,ARI,24,82,13,11,24
43,8482679,Matt Coronato,R,CGY,22,82,13,11,24
43,8476278,Colin Blackwell,C,CHI,31,82,11,13,24
43,8477953,Kasperi Kapanen,R,STL,28,82,11,13,24
43,8479359,Beck Malenstyn,L,WSH,26,82,11,13,24
43,8480871,Adam Boqvist,D,CBJ,24,82,8,16,24
43,8476927,Teddy Blueger,C,VAN,30,82,6,18,24
43,8476879,Cody Ceci,D,EDM,31,82,5,19,24
43,8476892,Colton Parayko,D,STL,31,82,3,21,24
43,8476457,Adam Larsson,D,SEA,32,82,3,21,24
43,8475314,Anders Lee,L,NYI,34,82,13,10,23
43,8480813,Joe Veleno,C,DET,24,82,11,12,23
43,8478463,Anthony Beauvillier,L,NSH,27,82,10,13,23
43,8479393,Noah Gregor,C,TOR,26,82,10,13,23
43,8482079,Marco Rossi,C,MIN,23,82,9,14,23
43,8481601,Simon Holmstrom,R,NYI,23,82,9,14,23
43,8476872,Scott Laughton,C,PHI,30,82,7,16,23
43,8477369,Carson Soucy,D,VAN,30,82,7,16,23
43,8480035,Henri Jokiharju,D,BUF,25,82,5,18,23
43,8480834,Ty Emberson,D,SJS,24,82,5,18,23
43,8470966,Mark Giordano,D,TOR,41,82,4,19,23
43,8480807,Mattias Samuelsson,D,BUF,24,82,4,19,23
43,8475233,David Savard,D,MTL,34,82,4,19,23
43,8475181,Nick Leddy,D,STL,33,82,3,20,23
43,8477435,Ryan Graves,D,PIT,29,82,3,20,23
43,8474574,Tyler Myers,D,VAN,34,82,3,20,23
43,8482733,Logan Mailloux,D,MTL,31,82,2,21,23
43,8478013,Jake Walman,D,DET,28,82,14,8,22
43,8483505,Matthew Poitras,C,BOS,20,82,12,10,22
43,8475149,Marcus Johansson,L,MIN,34,82,11,11,22
43,8474884,Mike Hoffman,C,SJS,35,82,11,11,22
43,8481580,Connor McMichael,C,WSH,23,82,10,12,22
43,8481477,Nico Sturm,C,SJS,29,82,10,12,22
43,8476960,Andreas Athanasiou,C,CHI,30,82,9,13,22
43,8477392,Hudson Fasching,R,NYI,29,82,8,14,22
43,8481522,Peyton Krebs,C,BUF,23,82,8,14,22
43,8483482,Tristan Luneau,D,ANA,20,82,7,15,22
43,8479324,Ryan Lindgren,D,NYR,26,82,7,15,22
43,8476891,Matt Grzelcyk,D,BOS,30,82,7,15,22
43,8475279,Ben Chiarot,D,DET,33,82,5,17,22
43,8480073,Erik Brannstrom,D,OTT,25,82,4,18,22
43,8482073,Braden Schneider,D,NYR,23,82,4,18,22
43,8478399,Jonas Siegenthaler,D,NJD,27,82,4,18,22
43,8475690,Chris Tanev,D,DAL,35,82,1,21,22
43,8479976,Juuso Valimaki,D,ARI,26,82,1,21,22
43,8478569,Noel Acciari,C,PIT,33,82,13,8,21
43,8483491,Ivan Miroshnichenko,L,WSH,20,82,11,10,21
43,8482737,Zack Bolduc,C,STL,21,82,10,11,21
43,8482074,Connor Zary,C,CGY,23,82,9,12,21
43,8477839,Conor Sheary,L,TBL,32,82,8,13,21
43,8474009,Nick Bonino,C,NYR,36,82,8,13,21
43,8482730,Brandt Clarke,D,LAK,21,82,7,14,21
43,8476392,Adam Lowry,C,WPG,31,82,6,15,21
43,8477845,Trevor van Riemsdyk,D,WSH,33,82,6,15,21
43,8478416,Erik Cernak,D,TBL,27,82,5,16,21
43,8481606,Jordan Spence,D,LAK,23,82,4,17,21
43,8476885,Jacob Trouba,D,NYR,30,82,2,19,21
43,8482803,Olen Zellweger,D,ANA,21,82,2,19,21
43,8474166,Alec Martinez,D,VGK,37,82,2,19,21
43,8479353,Brett Howden,C,VGK,26,82,13,7,20
43,8476878,Zemgus Girgensons,L,BUF,30,82,9,11,20
43,8484153,Leo Carlsson,C,ANA,20,82,8,12,20
43,8470604,Jeff Carter,C,PIT,39,82,7,13,20
43,8470610,Zach Parise,L,COL,40,82,6,14,20
43,8476624,Barclay Goodrow,C,NYR,31,82,6,14,20
43,8480879,Jacob Bernard-Docker,D,OTT,24,82,6,14,20
43,8482858,Ryker Evans,D,SEA,23,82,5,15,20
43,8478840,Will Borgen,D,SEA,28,82,4,16,20
43,8481537,Nikita Okhotiuk,D,CGY,24,82,4,16,20
43,8476331,Dylan DeMelo,D,WPG,31,82,3,17,20
43,8478468,Jeremy Lauzon,D,NSH,27,82,3,17,20
43,8482516,Matthew Kessel,D,STL,24,82,3,17,20
43,8477034,Jaycob Megna,D,CHI,32,82,3,17,20
43,8474151,Ryan McDonagh,D,NSH,35,82,2,18,20
43,8473507,Jeff Petry,D,DET,37,82,1,19,20
43,8476473,Connor Murphy,D,CHI,31,82,1,19,20
43,8470600,Ryan Suter,D,DAL,39,82,0,20,20
43,8481093,Rafael Harvey-Pinard,L,MTL,25,82,11,8,19
43,8477508,Curtis Lazar,C,NJD,29,82,11,8,19
43,8477507,Nikita Zadorov,D,VAN,29,82,10,9,19
43,8480980,Connor Dewar,C,TOR,25,82,10,9,19
43,8476858,Phillip Di Giuseppe,L,VAN,31,82,10,9,19
43,8476967,Brett Kulak,D,EDM,30,82,6,13,19
43,8475343,Nic Dowd,C,WSH,34,82,5,14,19
43,8481703,Valtteri Puustinen,R,PIT,25,82,5,14,19
43,8476422,Mike Reilly,D,NYI,31,82,5,14,19
43,8475790,Erik Gudbranson,D,CBJ,32,82,5,14,19
43,8474567,Zach Bogosian,D,MIN,34,82,4,15,19
43,8480246,Nick Perbix,D,TBL,26,82,3,16,19
43,8477220,Nate Schmidt,D,WPG,33,82,0,19,19
43,8482145,Mavrik Bourque,C,DAL,22,82,14,4,18
43,8477425,Miles Wood,L,COL,29,82,9,9,18
43,8481059,Scott Perunovich,D,STL,26,82,7,11,18
43,8480144,David Kampf,C,TOR,29,82,6,12,18
43,8476931,Jake McCabe,D,TOR,31,82,6,12,18
43,8476923,Damon Severson,D,CBJ,30,82,5,13,18
43,8477406,Mattias Janmark,C,EDM,32,82,5,13,18
43,8484145,Zach Benson,L,BUF,19,82,4,14,18
43,8482166,Shakir Mukhamadullin,D,SJS,22,82,4,14,18
43,8481605,Jackson LaCombe,D,ANA,23,82,4,14,18
43,8476917,Adam Pelech,D,NYI,30,82,3,15,18
43,8479980,Nicolas Hague,D,VGK,26,82,3,15,18
43,8476429,Scott Mayfield,D,NYI,32,82,3,15,18
43,8476467,Jamie Oleksiak,D,SEA,32,82,2,16,18
43,8483012,Logan Morrison,C,SEA,22,82,8,9,17
43,8480806,Isac Lundestrom,C,ANA,25,82,8,9,17
43,8477499,Rasmus Ristolainen,D,PHI,30,82,7,10,17
43,8479442,Troy Stecher,D,EDM,30,82,6,11,17
43,8483763,Maksymilian Szuber,D,ARI,22,82,6,11,17
43,8480448,Parker Kelly,L,OTT,25,82,5,12,17
43,8482470,Ilya Solovyov,D,CGY,24,82,5,12,17
43,8475188,Brayden McNabb,D,VGK,33,82,4,13,17
43,8481524,Bowen Byram,D,BUF,23,82,4,13,17
43,8482712,Oskar Olausson,R,COL,22,82,4,13,17
43,8476525,Colin Miller,D,WPG,32,82,4,13,17
43,8478136,Jake Middleton,D,MIN,28,82,4,13,17
43,8479998,Mikey Anderson,D,LAK,25,82,2,15,17
43,8474673,TJ Brodie,D,TOR,34,82,2,15,17
43,8478443,Brandon Carlo,D,BOS,28,82,1,16,17
43,8482809,Jackson Blake,R,CAR,21,82,13,3,16
43,8476374,Sean Kuraly,C,CBJ,31,82,7,9,16
43,8484911,Collin Graf,R,SJS,22,82,7,9,16
43,8481517,Brett Leason,R,ANA,25,82,6,10,16
43,8481028,Martin Pospisil,C,CGY,25,82,5,11,16
43,8478451,Ethan Bear,D,WSH,27,82,5,11,16
43,8483490,Pavel Mintyukov,D,ANA,21,82,5,11,16
43,8475208,Brian Dumoulin,D,SEA,33,82,4,12,16
43,8475825,Jani Hakanpää,D,DAL,32,82,4,12,16
43,8475179,Dmitry Kulikov,D,FLA,34,82,3,13,16
43,8479371,Dante Fabbro,D,NSH,26,82,1,15,16
43,8480796,Martin Fehervary,D,WSH,25,82,1,15,16
43,8476822,Luke Glendening,C,TBL,35,82,8,7,15
43,8482666,Scott Morrow,D,CAR,22,82,8,7,15
43,8482111,Justin Barron,D,MTL,23,82,7,8,15
43,8476897,Oskar Sundqvist,C,STL,30,82,4,11,15
43,8473453,Trevor Lewis,C,LAK,37,82,4,11,15
43,8476312,Josh Manson,D,COL,33,82,2,13,15
43,8475462,Radko Gudas,D,ANA,34,82,2,13,15
43,8482807,Ethan Del Mastro,D,CHI,21,82,1,14,15
43,8482762,Simon Edvinsson,D,DET,21,82,9,5,14
43,8480990,Declan Chisholm,D,MIN,24,82,6,8,14
43,8473504,Cal Clutterbuck,R,NYI,37,82,4,10,14
43,8476372,Nick Seeler,D,PHI,31,82,6,7,13
43,8481599,Victor Soderstrom,D,ARI,23,82,5,8,13
43,8475762,Derek Forbort,D,BOS,32,82,4,9,13
43,8480860,Kevin Bahl,D,NJD,24,82,4,9,13
43,8476442,Matt Nieto,L,PIT,32,82,4,9,13
43,8479293,Brandon Tanev,L,SEA,33,82,2,11,13
43,8477335,Kyle Burroughs,D,SJS,29,82,2,11,13
43,8475324,Nick Jensen,D,WSH,34,82,2,11,13
43,8471677,Jack Johnson,D,COL,37,82,2,11,13
43,8478851,Alexandre Carrier,D,NSH,28,82,1,12,13
43,8478859,Niko Mikkola,D,FLA,28,82,1,12,13
43,8475842,Sam Carrick,C,EDM,32,82,7,5,12
43,8479291,Kevin Rooney,C,CGY,31,82,6,6,12
43,8483489,Fraser Minten,C,TOR,31,82,5,7,12
43,8477931,Tomas Nosek,L,NJD,32,82,4,8,12
43,8475177,Calvin de Haan,D,TBL,33,82,4,8,12
43,8477353,Tyler Motte,C,TBL,29,82,3,9,12
43,8483466,Kevin Korchinski,D,CHI,20,82,2,10,12
43,8478831,Kevin Stenlund,C,FLA,28,82,5,6,11
43,8479383,Boris Katchouk,L,OTT,26,82,4,7,11
43,8475455,Brenden Dillon,D,WPG,34,82,3,8,11
43,8478408,Travis Dermott,D,ARI,28,82,3,8,11
43,8483468,Jiri Kulich,C,BUF,20,82,2,9,11
43,8476915,Jujhar Khaira,L,MIN,30,82,6,4,10
43,8482713,Mackie Samoskevich,R,FLA,22,82,3,7,10
43,8480172,Jan Rutta,D,SJS,34,82,2,8,10
43,8483565,Nick Blankenburg,D,CBJ,26,82,1,9,10
43,8484149,Gavin Brindley,C,CBJ,20,82,4,5,9
43,8481578,Graeme Clarke,R,NJD,23,82,5,3,8
43,8482177,Marat Khusnutdinov,C,MIN,22,82,2,5,7
43,8474013,Ian Cole,D,VAN,35,82,1,6,7
43,8481030,Jack St. Ivany,D,PIT,25,82,0,7,7
43,8482859,Zack Ostapchuk,C,OTT,21,82,1,5,6
43,8482141,Lukas Cormier,D,VGK,22,0,0,0,0
43,8476988,Matt Benning,D,SJS,30,0,0,0,0
43,8480727,Zach Whitecloud,D,VGK,28,0,0,0,0
43,8480887,Jordan Harris,D,MTL,24,0,0,0,0
43,8478450,Parker Wotherspoon,D,BOS,27,0,0,0,0
43,8481812,Nikolai Knyzhov,D,SJS,27,0,0,0,0
43,8480001,Urho Vaakanainen,D,ANA,25,0,0,0,0
43,8482176,Wyatt Kaiser,D,CHI,22,0,0,0,0
43,8481122,Simon Benoit,D,TOR,26,0,0,0,0
43,8476441,Joel Edmundson,D,TOR,31,0,0,0,0
43,8480884,Calen Addison,D,SJS,24,0,0,0,0
43,8482511,Mason Lohrei,D,BOS,23,0,0,0,0
43,8482192,Isaak Phillips,D,CHI,23,0,0,0,0
43,8480950,Ilya Lyubushkin,D,TOR,30,0,0,0,0
43,8474031,Kevin Shattenkirk,D,BOS,35,0,0,0,0
43,8475718,Justin Holl,D,DET,32,0,0,0,0
43,8479402,Jake Bean,D,CBJ,26,0,0,0,0
43,8474602,Justin Schultz,D,SEA,34,0,0,0,0
43,8477950,Tony DeAngelo,D,CAR,29,0,0,0,0
43,8481743,Marc Del Gaizo,D,NSH,25,0,0,0,0
43,8481527,Kaedan Korczak,D,VGK,23,0,0,0,0
43,8480192,Johnathan Kovacevic,D,MTL,27,0,0,0,0
43,8476874,Olli Maatta,D,DET,30,0,0,0,0
43,8482144,Jack Thompson,D,SJS,22,0,0,0,0
43,8480222,Sebastian Aho,D,NYI,28,0,0,0,0
43,8479458,Nikita Zaitsev,D,CHI,33,0,0,0,0
43,8471709,Marc-Edouard Vlasic,D,SJS,37,0,0,0,0
43,8482929,Emil Lilleberg,D,TBL,23,0,0,0,0
43,8477018,Ben Hutton,D,VGK,31,0,0,0,0
43,8481056,Spencer Stastney,D,NSH,24,0,0,0,0
43,8481593,Jayden Struble,D,MTL,23,0,0,0,0
43,8479982,Conor Timmins,D,TOR,26,0,0,0,0
43,8474090,Brendan Smith,D,NJD,35,0,0,0,0
43,8482964,Arber Xhekaj,D,MTL,23,0,0,0,0
43,8480891,Michael Kesselring,D,ARI,24,0,0,0,0
43,8477938,Haydn Fleury,D,TBL,28,0,0,0,0
43,8481806,Louis Crevier,D,CHI,23,0,0,0,0
43,8471274,Alex Goligoski,D,MIN,39,0,0,0,0
43,8481600,Tobias Bjornfot,D,FLA,23,0,0,0,0
43,8475797,Jarred Tinordi,D,CHI,32,0,0,0,0
43,8481521,Ronnie Attard,D,PHI,25,0,0,0,0
43,8474612,Travis Hamonic,D,OTT,34,0,0,0,0
43,8479576,Vincent Desharnais,D,EDM,28,0,0,0,0
43,8480049,Dylan Samberg,D,WPG,25,0,0,0,0
43,8483619,Filip Roos,D,CHI,25,0,0,0,0
43,8474568,Luke Schenn,D,NSH,35,0,0,0,0
43,8480184,Gustav Lindstrom,D,ANA,26,0,0,0,0
43,8480070,Ian Mitchell,D,BOS,25,0,0,0,0
43,8480196,Jacob Bryson,D,BUF,27,0,0,0,0
43,8471686,Marc Staal,D,PHI,37,0,0,0,0
43,8477467,Gustav Olofsson,D,SEA,30,0,0,0,0
43,8478970,Jalen Chatfield,D,CAR,28,0,0,0,0
43,8479348,Kale Clague,D,BUF,26,0,0,0,0
43,8473446,Erik Johnson,D,PHI,36,0,0,0,0
43,8477462,Robert Hagg,D,ANA,29,0,0,0,0
43,8478454,Noah Juulsen,D,VAN,27,0,0,0,0
43,8477384,Josh Brown,D,ARI,30,0,0,0,0
43,8481708,Zac Jones,D,NYR,24,0,0,0,0
43,8481167,Brayden Pachal,D,CGY,25,0,0,0,0
43,8482067,Connor Mackey,D,NYR,28,0,0,0,0
43,8483460,David Jiricek,D,CBJ,21,0,0,0,0
43,8481701,Santeri Hatakka,D,NJD,23,0,0,0,0
43,8478021,William Lagesson,D,ANA,28,0,0,0,0
43,8477851,Jordan Oesterle,D,CGY,32,0,0,0,0
43,8478452,Caleb Jones,D,COL,27,0,0,0,0
43,8479984,Cal Foote,D,NJD,26,0,0,0,0
43,8479639,Dylan Coghlan,D,CAR,26,0,0,0,0
43,8480874,Adam Ginning,D,PHI,24,0,0,0,0
43,8479321,Lucas Johansen,D,WSH,27,0,0,0,0
43,8480878,Nils Lundkvist,D,DAL,24,0,0,0,0
43,8482165,Yan Kuznetsov,D,CGY,22,0,0,0,0
43,8484258,Sam Malinski,D,COL,26,0,0,0,0
43,8480157,Calle Rosen,D,STL,30,0,0,0,0
43,8484304,Uvis Balinskis,D,FLA,28,0,0,0,0
43,8479985,Cale Fleury,D,SEA,26,0,0,0,0
43,8479378,Logan Stanley,D,WPG,26,0,0,0,0
43,8477541,Dakota Mermis,D,MIN,30,0,0,0,0
43,8481609,Vladislav Kolyachonok,D,ARI,23,0,0,0,0
43,8480823,Alexander Alexeyev,D,WSH,25,0,0,0,0
43,8481679,Maxence Guenette,D,OTT,23,0,0,0,0
43,8481564,Ryan Johnson,D,BUF,23,0,0,0,0
43,8479376,Victor Mete,D,PHI,26,0,0,0,0
43,8484254,Akito Hirose,D,VAN,25,0,0,0,0
43,8482660,Kent Johnson,C,CBJ,22,0,0,0,0
43,8482149,Cole Perfetti,C,WPG,22,0,0,0,0
43,8477987,Ryan Donato,C,CHI,28,0,0,0,0
43,8475755,Alexander Petrovic,D,DAL,32,0,0,0,0
43,8477810,Joel Hanley,D,CGY,33,0,0,0,0
43,8474145,Robert Bortuzzo,D,NYI,35,0,0,0,0
43,8481161,Jake Christiansen,D,CBJ,25,0,0,0,0
43,8476884,Derrick Pouliot,D,DAL,30,0,0,0,0
43,8481716,Dmitri Voronkov,L,CBJ,24,0,0,0,0
43,8480084,Nick DeSimone,D,NJD,30,0,0,0,0
43,8475750,Jon Merrill,D,MIN,32,0,0,0,0
43,8479315,Joey Anderson,R,CHI,26,0,0,0,0
43,8478011,Louie Belpedio,D,PHI,28,0,0,0,0
43,8482451,Mikael Pyyhtia,L,CBJ,23,0,0,0,0
43,8481541,Samuel Bolduc,D,NYI,24,0,0,0,0
43,8482126,Emil Andrae,D,PHI,31,0,0,0,0
43,8474618,Marco Scandella,D,STL,34,0,0,0,0
43,8477244,Chad Ruhwedel,D,NYR,34,0,0,0,0
43,8477971,Andreas Englund,D,LAK,28,0,0,0,0
43,8480829,Jesperi Kotkaniemi,C,CAR,24,0,0,0,0
43,8479372,Josh Mahura,D,FLA,26,0,0,0,0
43,8482095,Tyler Kleven,D,OTT,22,0,0,0,0
43,8481719,Maxwell Crozier,D,TBL,24,0,0,0,0
43,8475855,Jesper Fast,R,CAR,33,0,0,0,0
43,8480848,Ty Dellandrea,C,DAL,24,0,0,0,0
43,8475193,Tomas Tatar,L,SEA,34,0,0,0,0
43,8476889,Radek Faksa,C,DAL,30,0,0,0,0
43,8478495,Denis Gurianov,R,PHI,27,0,0,0,0
43,8480216,Jacob Peterson,C,SJS,25,0,0,0,0
43,8480252,Cole Guttman,C,CHI,25,0,0,0,0
43,8479026,Philippe Myers,D,TBL,27,0,0,0,0
43,8481006,Tyler Tucker,D,STL,24,0,0,0,0
43,8481032,Paul Cotter,C,VGK,25,0,0,0,0
43,8481577,Philip Tomasino,C,NSH,23,0,0,0,0
43,8476918,Jimmy Vesey,L,NYR,31,0,0,0,0
43,8479320,Max Lajoie,D,TOR,27,0,0,0,0
43,8478017,Mark Friedman,D,VAN,29,0,0,0,0
43,8481754,Nikita Nesterenko,C,ANA,23,0,0,0,0
43,8483407,Brandon Scanlin,D,NYR,25,0,0,0,0
43,8482659,Josh Doan,R,ARI,22,0,0,0,0
43,8477446,Michael McCarron,R,NSH,29,0,0,0,0
43,8477903,Garnet Hathaway,R,PHI,33,0,0,0,0
43,8482153,Brendan Brisson,C,VGK,23,0,0,0,0
43,8483546,Marshall Rifai,D,TOR,26,0,0,0,0
43,8484287,Cole McWard,D,VAN,23,0,0,0,0
43,8478854,Ryan Shea,D,PIT,27,0,0,0,0
43,8481585,Egor Afanasyev,L,NSH,23,0,0,0,0
43,8483398,Declan Carlile,D,TBL,31,0,0,0,0
43,8478502,Dennis Gilbert,D,CGY,28,0,0,0,0
43,8482749,Joshua Roy,R,MTL,21,0,0,0,0
43,8481598,Philip Broberg,D,EDM,23,0,0,0,0
43,8480835,Jack Drury,C,CAR,24,0,0,0,0
43,8480748,Kiefer Sherwood,L,NSH,29,0,0,0,0
43,8476934,Brock McGinn,L,ANA,30,0,0,0,0
43,8480870,Bo Groulx,C,ANA,24,0,0,0,0
43,8479368,Max Jones,L,ANA,26,0,0,0,0
43,8478099,Kevin Labanc,R,SJS,29,0,0,0,0
43,8478067,Oskar Lindblom,L,SJS,28,0,0,0,0
43,8476393,Nick Cousins,C,FLA,31,0,0,0,0
43,8483395,Arshdeep Bains,L,VAN,23,0,0,0,0
43,8480762,Eric Robinson,L,BUF,29,0,0,0,0
43,8479439,Jacob MacDonald,D,SJS,31,0,0,0,0
43,8476474,Stefan Noesen,R,CAR,31,0,0,0,0
43,8482787,Nikita Chibrikov,R,WPG,31,0,0,0,0
43,8478432,Christian Fischer,R,DET,27,0,0,0,0
43,8477979,Nicolas Aube-Kubel,R,WSH,28,0,0,0,0
43,8481789,Tye Kartye,L,SEA,23,0,0,0,0
43,8479330,Brandon Gignac,C,MTL,27,0,0,0,0
43,8480075,Cameron Crotty,D,ARI,25,0,0,0,0
43,8473473,Milan Lucic,L,BOS,36,0,0,0,0
43,8482094,Daemon Hunt,D,MIN,22,0,0,0,0
43,8481206,John Ludvig,D,PIT,24,0,0,0,0
43,8483630,Pavol Regenda,L,ANA,25,0,0,0,0
43,8481617,Vasily Podkolzin,R,VAN,23,0,0,0,0
43,8480306,Grant Hutton,D,NYI,29,0,0,0,0
43,8480995,Pontus Holmberg,R,TOR,25,0,0,0,0
43,8482148,Hendrix Lapierre,C,WSH,22,0,0,0,0
43,8477478,William Carrier,L,VGK,30,0,0,0,0
43,8480003,Jesper Boqvist,C,BOS,26,0,0,0,0
43,8482172,Landon Slaggert,L,CHI,22,0,0,0,0
43,8480789,Oliver Wahlstrom,R,NYI,24,0,0,0,0
43,8474062,Riley Nash,C,NYR,35,0,0,0,0
43,8480021,Jack Studnicka,C,SJS,25,0,0,0,0
43,8480025,MacKenzie Entwistle,R,CHI,25,0,0,0,0
43,8481582,Nicholas Robertson,L,TOR,23,0,0,0,0
43,8476867,Brendan Gaunce,C,CBJ,30,0,0,0,0
43,8479619,Michael Carcone,L,ARI,28,0,0,0,0
43,8479370,Tyson Jost,C,BUF,26,0,0,0,0
43,8479671,Mathieu Olivier,R,CBJ,27,0,0,0,0
43,8476994,Vinnie Hinostroza,C,PIT,30,0,0,0,0
43,8482070,Mitchell Chaffee,R,TBL,26,0,0,0,0
43,8477473,Justin Bailey,R,SJS,29,0,0,0,0
43,8479344,Jesse Puljujarvi,R,PIT,26,0,0,0,0
43,8480205,Emil Bemstrom,C,PIT,25,0,0,0,0
43,8479718,Alex Barré-Boulet,C,TBL,27,0,0,0,0
43,8482061,Brandon Biro,L,BUF,26,0,0,0,0
43,8479638,Justin Brazeau,R,BOS,26,0,0,0,0
43,8474040,Sam Gagner,C,EDM,35,0,0,0,0
43,8477846,Ryan Carpenter,C,SJS,33,0,0,0,0
43,8482077,Dylan Holloway,L,EDM,23,0,0,0,0
43,8482157,Will Cuylle,L,NYR,22,0,0,0,0
43,8480007,Jonas Rondbjerg,R,VGK,25,0,0,0,0
43,8478874,Adam Gaudette,C,STL,28,0,0,0,0
43,8478434,Keegan Kolesar,R,VGK,27,0,0,0,0
43,8480441,Trey Fix-Wolansky,R,CBJ,25,0,0,0,0
43,8479994,Jaret Anderson-Dolan,C,NSH,25,0,0,0,0
43,8483567,Georgii Merkulov,C,BOS,24,0,0,0,0
43,8477380,Jonny Brodzinski,C,NYR,31,0,0,0,0
43,8482201,Gage Goncalves,C,TBL,23,0,0,0,0
43,8478211,Dryden Hunt,L,CGY,29,0,0,0,0
43,8471699,Andrew Cogliano,C,COL,37,0,0,0,0
43,8479421,Jacob Moverare,D,LAK,26,0,0,0,0
43,8478881,Brett Seney,L,CHI,28,0,0,0,0
43,8477464,Nic Petan,C,MIN,29,0,0,0,0
43,8475958,Michael Sgarbossa,C,WSH,32,0,0,0,0
43,8481147,Reese Johnson,C,CHI,26,0,0,0,0
43,8479336,Carl Grundstrom,R,LAK,27,0,0,0,0
43,8480853,Liam Foudy,C,NSH,24,0,0,0,0
43,8479522,Hardy Haman Aktell,D,WSH,26,0,0,0,0
43,8481462,Mason Morelli,L,VGK,28,0,0,0,0
43,8482102,Vasily Ponomarev,C,CAR,22,0,0,0,0
43,8480844,Grigori Denisenko,L,VGK,24,0,0,0,0
43,8479944,Zach Aston-Reese,C,DET,30,0,0,0,0
43,8482784,Zach Dean,C,STL,21,0,0,0,0
43,8479419,Brett Murray,L,BUF,26,0,0,0,0
43,8479520,Brandon Duhaime,R,COL,27,0,0,0,0
43,8477573,Nathan Walker,L,STL,30,0,0,0,0
43,8478078,Rourke Chartier,C,OTT,28,0,0,0,0
43,8475795,Dylan McIlrath,D,WSH,32,0,0,0,0
43,8482496,Nils Aman,C,VAN,24,0,0,0,0
43,8480289,Morgan Barron,C,WPG,26,0,0,0,0
43,8481751,Lukas Rousek,R,BUF,25,0,0,0,0
43,8480011,Klim Kostin,C,SJS,25,0,0,0,0
43,8481556,John Beecher,C,BOS,23,0,0,0,0
43,8475278,Byron Froese,C,VGK,33,0,0,0,0
43,8475225,Craig Smith,C,DAL,35,0,0,0,0
43,8484326,Patrik Koch,D,ARI,28,0,0,0,0
43,8477930,Pierre-Edouard Bellemare,L,SEA,39,0,0,0,0
43,8478409,Anthony Richard,C,BOS,28,0,0,0,0
43,8481024,Linus Karlsson,C,VAN,25,0,0,0,0
43,8479986,Kole Lind,R,SEA,26,0,0,0,0
43,8479414,Nathan Bastian,R,NJD,27,0,0,0,0
43,8479362,Riley Tufte,L,COL,26,0,0,0,0
43,8481058,Jesse Ylönen,R,MTL,25,0,0,0,0
43,8482476,Emil Heineman,L,MTL,23,0,0,0,0
43,8482861,Vincent Iorio,D,WSH,22,0,0,0,0
43,8483432,Luca Del Bel Belluz,C,CBJ,31,0,0,0,0
43,8482744,James Malatesta,L,CBJ,21,0,0,0,0
43,8477887,Patrick Brown,C,BOS,32,0,0,0,0
43,8478585,Derek Ryan,C,EDM,38,0,0,0,0
43,8481441,Joe Snively,C,WSH,28,0,0,0,0
43,8481592,Jakob Pelletier,L,CGY,23,0,0,0,0
43,8482634,Alex Steeves,C,TOR,25,0,0,0,0
43,8477126,Jayson Megna,C,BOS,34,0,0,0,0
43,8475752,Tyler Pitlick,C,NYR,33,0,0,0,0
43,8480008,Adam Ruzicka,C,ARI,25,0,0,0,0
43,8481065,Angus Crookshank,L,OTT,25,0,0,0,0
43,8479547,Matthew Phillips,R,WSH,26,0,0,0,0
43,8480226,Marián Studenic,R,SEA,26,0,0,0,0
43,8481237,Kyle MacLean,C,NYI,25,0,0,0,0
43,8475413,Justin Dowling,C,NJD,34,0,0,0,0
43,8481641,Joel Kiviranta,L,COL,28,0,0,0,0
43,8478104,Sammy Blais,L,STL,28,0,0,0,0
43,8477454,Adam Erne,L,EDM,29,0,0,0,0
43,8481518,Nolan Foote,L,NJD,24,0,0,0,0
43,8480245,Olle Lycksell,R,PHI,25,0,0,0,0
43,8483570,Ben Meyers,C,ANA,26,0,0,0,0
43,8480776,Sheldon Rempal,R,VGK,29,0,0,0,0
43,8483920,Pierrick Dube,R,WSH,23,0,0,0,0
43,8480267,Sammy Walker,C,MIN,25,0,0,0,0
43,8482747,Brennan Othmann,L,NYR,21,0,0,0,0
43,8479991,Jake Leschyshyn,C,NYR,25,0,0,0,0
43,8478400,Colin White,C,MTL,27,0,0,0,0
43,8479328,Julien Gauthier,R,NYI,27,0,0,0,0
43,8484325,Waltteri Merela,C,TBL,26,0,0,0,0
43,8479066,Ryan Lomberg,L,FLA,30,0,0,0,0
43,8477070,Liam O'Brien,C,ARI,30,0,0,0,0
43,8478146,Matthew Highmore,C,OTT,28,0,0,0,0
43,8478028,Fredrik Olofsson,L,COL,28,0,0,0,0
43,8480880,Jakub Lauko,C,BOS,24,0,0,0,0
43,8479968,Vinni Lettieri,C,MIN,29,0,0,0,0
43,8474709,Matt Martin,L,NYI,35,0,0,0,0
43,8480845,Rasmus Kupari,C,WPG,24,0,0,0,0
43,8481550,Adam Beckman,L,MIN,23,0,0,0,0
43,8481422,Jacob Lucchini,C,MIN,29,0,0,0,0
43,8477401,John Hayden,C,SEA,29,0,0,0,0
43,8478904,Steven Lorentz,C,FLA,28,0,0,0,0
43,8482088,Justin Sourdif,R,FLA,22,0,0,0,0
43,8482751,Ryan Winterton,C,SEA,21,0,0,0,0
43,8482241,Radim Zohorna,L,PIT,28,0,0,0,0
43,8481690,Tyler Angle,C,CBJ,24,0,0,0,0
43,8476952,Dominic Toninato,C,WPG,30,0,0,0,0
43,8476919,Chris Tierney,C,NJD,30,0,0,0,0
43,8480032,Shane Bowers,C,NJD,25,0,0,0,0
43,8484314,Jiri Smejkal,L,OTT,28,0,0,0,0
43,8481239,Samuel Fagemo,L,LAK,24,0,0,0,0
43,8481532,Alex Turcotte,C,LAK,23,0,0,0,0
43,8481019,David Gustafsson,C,WPG,24,0,0,0,0
43,8478477,Mitchell Stephens,C,MTL,27,0,0,0,0
43,8479546,Oskar Steen,C,BOS,26,0,0,0,0
43,8480292,Carson Meyer,R,CBJ,27,0,0,0,0
43,8478446,Glenn Gawdin,C,ANA,27,0,0,0,0
43,8483531,Brian Halonen,L,NJD,25,0,0,0,0
43,8477149,Scott Sabourin,R,SJS,32,0,0,0,0
43,8479972,Mason Shaw,C,MIN,26,0,0,0,0
43,8480890,Jan Jenik,R,ARI,24,0,0,0,0
43,8478051,Max Willman,C,NJD,29,0,0,0,0
43,8480851,Akil Thomas,C,LAK,24,0,0,0,0
43,8482765,Isak Rosen,R,BUF,21,0,0,0,0
43,8478421,A.J. Greer,L,CGY,28,0,0,0,0
43,8478512,Austin Czarnik,C,DET,32,0,0,0,0
43,8479536,Axel Jonsson-Fjallby,L,WPG,26,0,0,0,0
43,8477320,Anton Blidh,L,NYR,29,0,0,0,0
43,8481543,Nikita Alexandrov,C,STL,24,0,0,0,0
43,8475235,Nicolas Deslauriers,L,PHI,33,0,0,0,0
43,8481070,Hugh McGing,L,STL,26,0,0,0,0
43,8480836,Jonathan Gruden,C,PIT,24,0,0,0,0
43,8481591,Sam Poulin,R,PIT,23,0,0,0,0
43,8477962,Brendan Lemieux,L,CAR,28,0,0,0,0
43,8483401,Marc Johnstone,R,PIT,28,0,0,0,0
43,8482250,Callahan Burke,C,CAR,27,0,0,0,0
43,8481726,Adam Edstrom,C,NYR,24,0,0,0,0
43,8471817,Ryan Reaves,R,TOR,37,0,0,0,0
43,8479587,Rhett Gardner,C,PHI,28,0,0,0,0
43,8475766,Austin Watson,L,TBL,32,0,0,0,0
43,8479367,William Lockwood,R,FLA,26,0,0,0,0
43,8478424,Jansen Harkins,C,PIT,27,0,0,0,0
43,8476913,Devin Shore,C,SEA,30,0,0,0,0
43,8482652,Walker Duehr,R,CGY,27,0,0,0,0
43,8477527,Ross Johnston,L,ANA,30,0,0,0,0
43,8481077,John Leonard,L,ARI,26,0,0,0,0
43,8483549,Lucas Condotta,L,MTL,27,0,0,0,0
43,8480468,James Hamblin,L,EDM,25,0,0,0,0
43,8476907,Mackenzie MacEachern,L,STL,30,0,0,0,0
43,8479543,Michael Pezzetta,L,MTL,26,0,0,0,0
43,8480355,Mark Kastelic,C,OTT,25,0,0,0,0
43,8482162,Roby Jarventie,L,OTT,22,0,0,0,0
43,8479772,Zack MacEwen,R,OTT,28,0,0,0,0
43,8483597,Milos Kelemen,L,ARI,25,0,0,0,0
43,8479379,Givani Smith,R,SJS,26,0,0,0,0
43,8481655,Cole Schwindt,R,CGY,23,0,0,0,0
43,8479981,Jonah Gadjovich,L,FLA,26,0,0,0,0
43,8482147,Jean-Luc Foudy,C,COL,22,0,0,0,0
43,8484255,Jason Polin,R,COL,25,0,0,0,0
43,8477993,Justin Kirkland,C,ARI,28,0,0,0,0
43,8479249,Andrew Poturalski,C,SEA,30,0,0,0,0
43,8482197,Adam Raska,R,MIN,23,0,0,0,0
43,8475780,Chris Wagner,R,COL,33,0,0,0,0
43,8479533,Joona Koppanen,L,PIT,26,0,0,0,0
43,8481534,Raphael Lavoie,C,EDM,24,0,0,0,0
43,8484321,Nikolas Matinpalo,D,OTT,26,0,0,0,0
43,8481043,Cole Koepke,L,TBL,26,0,0,0,0
43,8476323,Max McCormick,L,SEA,32,0,0,0,0
43,8483609,Adam Klapka,R,CGY,24,0,0,0,0
43,8483512,Matt Savoie,C,BUF,20,0,0,0,0
43,8484259,Ondrej Pavel,C,COL,31,0,0,0,0
43,8478147,Bokondji Imama,L,OTT,28,0,0,0,0
43,8482460,Matt Rempe,C,NYR,22,0,0,0,0
43,8477073,Kurtis MacDermid,L,NJD,30,0,0,0,0
43,8480274,Philip Kemp,D,EDM,25,0,0,0,0
43,8478956,Samuel Laberge,L,NJD,27,0,0,0,0
43,8483045,Cameron Butler,R,CBJ,31,0,0,0,0
44,8478402,Connor McDavid,C,EDM,27,82,42,86,128
44,8478550,Artemi Panarin,L,NYR,33,82,48,68,116
44,8477956,David Pastrnak,R,BOS,28,82,53,61,114
44,8476453,Nikita Kucherov,R,TBL,31,82,38,75,113
44,8481559,Jack Hughes,C,NJD,23,82,36,76,112
44,8479318,Auston Matthews,C,TOR,27,82,66,37,103
44,8477934,Leon Draisaitl,C,EDM,29,82,42,60,102
44,8477492,Nathan MacKinnon,C,COL,29,82,44,55,99
44,8477960,Adrian Kempe,R,LAK,28,82,35,57,92
44,8478864,Kirill Kaprizov,L,MIN,27,82,38,52,90
44,8479343,Clayton Keller,R,ARI,26,82,33,56,89
44,8479314,Matthew Tkachuk,L,FLA,27,82,34,54,88
44,8476468,J.T. Miller,C,VAN,31,82,33,55,88
44,8480012,Elias Pettersson,C,VAN,26,82,39,48,87
44,8475166,John Tavares,C,TOR,34,82,33,52,85
44,8481523,Kirby Dach,C,MTL,23,82,17,68,85
44,8479337,Alex DeBrincat,R,DET,27,82,34,50,84
44,8478010,Brayden Point,C,TBL,28,82,45,38,83
44,8476887,Filip Forsberg,L,NSH,30,82,44,39,83
44,8480800,Quinn Hughes,D,VAN,25,82,16,66,82
44,8475786,Zach Hyman,L,EDM,32,82,46,35,81
44,8478420,Mikko Rantanen,R,COL,28,82,36,45,81
44,8474600,Roman Josi,D,NSH,34,82,22,58,80
44,8477493,Aleksander Barkov,C,FLA,29,82,30,49,79
44,8471675,Sidney Crosby,C,PIT,37,82,31,46,77
44,8480002,Nico Hischier,C,NJD,25,82,26,51,77
44,8478427,Sebastian Aho,C,CAR,27,82,27,47,74
44,8479323,Adam Fox,D,NYR,26,82,17,57,74
44,8474564,Steven Stamkos,C,TBL,34,82,30,43,73
44,8479407,Jesper Bratt,L,NJD,26,82,29,44,73
44,8480023,Robert Thomas,C,STL,25,82,22,51,73
44,8478398,Kyle Connor,L,WPG,28,82,32,40,72
44,8480027,Jason Robertson,L,DAL,25,82,30,42,72
44,8478439,Travis Konecny,R,PHI,27,82,27,45,72
44,8480801,Brady Tkachuk,L,OTT,25,82,38,33,71
44,8479385,Jordan Kyrou,C,STL,26,82,28,43,71
44,8480830,Andrei Svechnikov,R,CAR,24,82,26,45,71
44,8477949,Alex Tuch,R,BUF,28,82,26,45,71
44,8477404,Jake Guentzel,C,CAR,30,82,32,38,70
44,8482116,Tim Stützle,C,OTT,22,82,22,48,70
44,8476454,Ryan Nugent-Hopkins,C,EDM,31,82,22,48,70
44,8480069,Cale Makar,D,COL,26,82,17,53,70
44,8475172,Nazem Kadri,C,CGY,34,82,33,36,69
44,8481557,Matt Boldy,L,MIN,23,82,32,37,69
44,8477939,William Nylander,R,TOR,28,82,24,44,68
44,8476460,Mark Scheifele,C,WPG,31,82,24,44,68
44,8471215,Evgeni Malkin,C,PIT,38,82,28,39,67
44,8477933,Sam Reinhart,C,FLA,29,82,27,40,67
44,8474141,Patrick Kane,R,DET,36,82,25,42,67
44,8475810,Bryan Rust,R,PIT,32,82,31,35,66
44,8479542,Brandon Hagel,L,TBL,26,82,25,41,66
44,8476456,Jonathan Huberdeau,C,CGY,31,82,18,48,66
44,8477946,Dylan Larkin,C,DET,28,82,25,40,65
44,8477402,Pavel Buchnevich,L,STL,29,82,22,43,65
44,8475692,Mats Zuccarello,R,MIN,37,82,16,49,65
44,8471214,Alex Ovechkin,L,WSH,39,82,38,26,64
44,8477501,Valeri Nichushkin,R,COL,29,82,35,29,64
44,8481540,Cole Caufield,R,MTL,23,82,32,32,64
44,8477500,Bo Horvat,C,NYI,29,82,31,33,64
44,8478403,Jack Eichel,C,VGK,28,82,29,35,64
44,8477940,Nikolaj Ehlers,L,WPG,28,82,25,39,64
44,8477496,Elias Lindholm,C,VAN,30,82,21,43,64
44,8480803,Evan Bouchard,D,EDM,25,82,12,52,64
44,8477935,Sam Bennett,C,FLA,28,82,30,33,63
44,8476459,Mika Zibanejad,C,NYR,31,82,17,46,63
44,8475167,Victor Hedman,D,TBL,34,82,9,53,62
44,8479325,Charlie McAvoy,D,BOS,27,82,8,54,62
44,8476539,Jonathan Marchessault,R,VGK,34,82,29,32,61
44,8478493,Joel Eriksson Ek,C,MIN,27,82,28,33,61
44,8476881,Tomas Hertl,C,VGK,31,82,26,35,61
44,8477456,J.T. Compher,L,DET,29,82,24,36,60
44,8478445,Mathew Barzal,C,NYI,27,82,16,44,60
44,8481528,Dylan Cozens,C,BUF,23,82,26,33,59
44,8478449,Roope Hintz,C,DAL,28,82,24,35,59
44,8478873,Troy Terry,R,ANA,27,82,23,36,59
44,8477942,Kevin Fiala,L,LAK,28,82,22,37,59
44,8476448,William Karlsson,C,VGK,31,82,22,37,59
44,8475798,Mikael Granlund,C,SJS,32,82,15,44,59
44,8480865,Noah Dobson,D,NYI,24,82,11,48,59
44,8476389,Vincent Trocheck,C,NYR,31,82,28,30,58
44,8477951,Nick Schmaltz,C,ARI,28,82,25,33,58
44,8480018,Nick Suzuki,C,MTL,25,82,23,35,58
44,8482097,Jack Quinn,R,BUF,23,82,20,38,58
44,8475191,Reilly Smith,R,PIT,33,82,20,38,58
44,8470794,Joe Pavelski,C,DAL,40,82,19,39,58
44,8478407,Vince Dunn,D,SEA,28,82,12,46,58
44,8480839,Rasmus Dahlin,D,BUF,24,82,10,48,58
44,8475184,Chris Kreider,L,NYR,33,82,38,19,57
44,8477407,Anthony Duclair,L,TBL,29,82,27,30,57
44,8477409,Carter Verhaeghe,C,FLA,29,82,23,34,57
44,8474590,John Carlson,D,WSH,34,82,12,45,57
44,8480015,Owen Tippett,R,PHI,25,82,28,28,56
44,8477451,Ryan Hartman,R,MIN,30,82,27,29,56
44,8476346,Johnny Gaudreau,L,CBJ,31,82,21,35,56
44,8478440,Dylan Strome,C,WSH,27,82,20,36,56
44,8475158,Ryan O'Reilly,C,NSH,33,82,18,38,56
44,8482745,Mason McTavish,C,ANA,21,82,15,41,56
44,8479410,Mikhail Sergachev,D,TBL,26,82,10,46,56
44,8476853,Morgan Rielly,D,TOR,30,82,10,46,56
44,8477447,Shea Theodore,D,VGK,29,82,8,48,56
44,8478444,Brock Boeser,R,VAN,27,82,35,20,55
44,8478414,Timo Meier,R,NJD,28,82,34,21,55
44,8477497,Sean Monahan,C,WPG,30,82,25,30,55
44,8483808,Andrei Kuzmenko,L,CGY,28,82,24,31,55
44,8480039,Martin Necas,C,CAR,25,82,22,33,55
44,8482684,Luke Hughes,D,NJD,21,82,19,36,55
44,8477986,Brandon Montour,D,FLA,30,82,18,37,55
44,8475726,Tyler Toffoli,C,WPG,32,82,27,27,54
44,8478498,Jake DeBrusk,L,BOS,28,82,26,28,54
44,8477955,Jared McCann,L,SEA,28,82,26,28,54
44,8482093,Seth Jarvis,C,CAR,22,82,20,34,54
44,8471698,T.J. Oshie,R,WSH,38,82,20,34,54
44,8479675,Trevor Moore,L,LAK,29,82,19,35,54
44,8482124,Quinton Byfield,R,LAK,22,82,14,40,54
44,8480036,Miro Heiskanen,D,DAL,25,82,5,49,54
44,8479420,Tage Thompson,C,BUF,27,82,33,20,53
44,8478042,Viktor Arvidsson,R,LAK,31,82,24,29,53
44,8474578,Erik Karlsson,D,PIT,34,82,12,41,53
44,8475753,Justin Faulk,D,STL,32,82,10,43,53
44,8475722,Jason Zucker,L,NSH,32,82,32,20,52
44,8476438,Brandon Saad,L,STL,32,82,28,24,52
44,8478233,Andrew Mangiapane,L,CGY,28,82,22,30,52
44,8475765,Vladimir Tarasenko,R,FLA,33,82,21,31,52
44,8481533,Trevor Zegras,C,ANA,23,82,20,32,52
44,8480028,Morgan Frost,C,PHI,25,82,19,33,52
44,8477504,Josh Morrissey,D,WPG,29,82,13,39,52
44,8476462,Dougie Hamilton,D,NJD,31,82,10,42,52
44,8478474,Lawson Crouse,L,ARI,27,82,28,23,51
44,8475754,Brock Nelson,C,NYI,33,82,28,23,51
44,8480064,Josh Norris,C,OTT,25,82,28,23,51
44,8473419,Brad Marchand,L,BOS,36,82,19,32,51
44,8480208,Drake Batherson,R,OTT,26,82,16,35,51
44,8478401,Pavel Zacha,C,BOS,27,82,8,43,51
44,8483397,Marc McLaughlin,C,BOS,25,82,40,10,50
44,8476880,Tom Wilson,R,WSH,30,82,24,26,50
44,8474150,Mikael Backlund,C,CGY,35,82,22,28,50
44,8482159,Tyson Foerster,R,PHI,22,82,22,28,50
44,8473512,Claude Giroux,R,OTT,36,82,20,30,50
44,8481624,Ilya Mikheyev,R,VAN,30,82,18,32,50
44,8477416,Oliver Bjorkstrand,R,SEA,29,82,16,34,50
44,8478460,Zach Werenski,D,CBJ,27,82,12,38,50
44,8479425,Filip Hronek,D,VAN,27,82,6,44,50
44,8478366,Frank Vatrano,R,ANA,30,82,26,23,49
44,8482699,Dylan Guenther,R,ARI,21,82,26,23,49
44,8478047,Michael Bunting,L,PIT,29,82,21,28,49
44,8480893,Kirill Marchenko,R,CBJ,24,82,20,29,49
44,8473986,Alex Killorn,L,ANA,35,82,19,30,49
44,8482665,Matty Beniers,C,SEA,22,82,17,32,49
44,8483445,Cutter Gauthier,L,ANA,20,82,15,34,49
44,8477503,Max Domi,C,TOR,29,82,7,42,49
44,8478055,Gustav Forsling,D,FLA,28,82,7,42,49
44,8477952,Robby Fabbri,C,DET,28,82,26,22,48
44,8475168,Matt Duchene,C,DAL,33,82,25,23,48
44,8476432,Boone Jenner,C,CBJ,31,82,24,24,48
44,8473994,Jamie Benn,L,DAL,35,82,23,25,48
44,8479339,Patrik Laine,L,CBJ,26,82,22,26,48
44,8480031,Maxime Comtois,L,CAR,25,82,17,31,48
44,8476826,Yanni Gourde,C,SEA,33,82,16,32,48
44,8475169,Evander Kane,L,EDM,33,82,26,21,47
44,8481068,Yegor Sharangovich,C,CGY,26,82,25,22,47
44,8482740,Wyatt Johnston,C,DAL,21,82,24,23,47
44,8475784,Jeff Skinner,C,BUF,32,82,24,23,47
44,8480188,Fabian Zetterlund,L,SJS,25,82,22,25,47
44,8476458,Ryan Strome,C,ANA,31,82,21,26,47
44,8478856,Conor Garland,R,VAN,28,82,15,32,47
44,8478038,Devon Toews,D,COL,30,82,12,35,47
44,8480797,Joel Farabee,L,PHI,24,82,20,26,46
44,8475794,Tyler Seguin,C,DAL,32,82,20,26,46
44,8478519,Anthony Cirelli,C,TBL,27,82,18,28,46
44,8471685,Anze Kopitar,C,LAK,37,82,16,30,46
44,8474679,Gustav Nyquist,C,NSH,35,82,11,35,46
44,8482078,Lucas Raymond,L,DET,22,82,21,24,45
44,8476479,Phillip Danault,C,LAK,31,82,17,28,45
44,8478975,Mason Marchment,L,DAL,29,82,16,29,45
44,8481542,Moritz Seider,D,DET,23,82,7,38,45
44,8482113,Anton Lundell,C,FLA,23,82,21,23,44
44,8475745,Charlie Coyle,C,BOS,32,82,19,25,44
44,8477947,Sonny Milano,L,WSH,28,82,19,25,44
44,8477998,Warren Foegele,L,EDM,28,82,17,27,44
44,8475151,Kyle Palmieri,C,NYI,33,82,16,28,44
44,8478469,Thomas Chabot,D,OTT,27,82,14,30,44
44,8471724,Kris Letang,D,PIT,37,82,12,32,44
44,8478057,Dakota Joshua,C,VAN,28,82,24,19,43
44,8477476,Artturi Lehkonen,L,COL,29,82,23,20,43
44,8475913,Mark Stone,R,VGK,32,82,16,27,43
44,8476905,Chandler Stephenson,C,VGK,30,82,14,29,43
44,8474586,Jordan Eberle,R,SEA,34,82,12,31,43
44,8478438,Tommy Novak,C,NSH,27,82,12,31,43
44,8482109,Alexis Lafrenière,L,NYR,23,82,24,18,42
44,8479400,Pierre-Luc Dubois,L,LAK,26,82,20,22,42
44,8480009,Eeli Tolvanen,R,SEA,25,82,20,22,42
44,8473449,Kyle Okposo,R,FLA,36,82,20,22,42
44,8478466,Daniel Sprong,R,DET,27,82,19,23,42
44,8477948,Travis Sanheim,D,PHI,28,82,14,28,42
44,8481596,Shane Pinto,C,OTT,24,82,13,29,42
44,8476792,Torey Krug,D,STL,33,82,11,31,42
44,8477444,Andre Burakovsky,L,SEA,29,82,11,31,42
44,8473563,Nicklas Backstrom,C,WSH,37,82,11,31,42
44,8475197,Tyson Barrie,D,NSH,33,82,10,32,42
44,8480871,Adam Boqvist,D,CBJ,24,82,7,35,42
44,8474157,Max Pacioretty,L,WSH,36,82,22,19,41
44,8474053,Logan Couture,C,SJS,35,82,18,23,41
44,8480220,Noah Cates,L,PHI,25,82,16,25,41
44,8476399,Blake Coleman,C,CGY,33,82,16,25,41
44,8471218,Blake Wheeler,R,NYR,38,82,16,25,41
44,8481013,Jonatan Berggren,R,DET,24,82,16,25,41
44,8476872,Scott Laughton,C,PHI,30,82,16,25,41
44,8477479,Tyler Bertuzzi,L,TOR,29,82,15,26,41
44,8478462,Nicolas Roy,C,VGK,27,82,15,26,41
44,8480873,Rasmus Sandin,D,WSH,24,82,15,26,41
44,8478542,Evan Rodrigues,C,FLA,31,82,14,27,41
44,8480078,Filip Chytil,C,NYR,25,82,13,28,41
44,8477494,Jonathan Drouin,L,COL,29,82,13,28,41
44,8481711,Matias Maccelli,L,ARI,24,82,12,29,41
44,8470613,Brent Burns,D,CAR,39,82,12,29,41
44,8479525,Ross Colton,C,COL,28,82,11,30,41
44,8477346,MacKenzie Weegar,D,CGY,30,82,11,30,41
44,8481703,Valtteri Puustinen,R,PIT,25,82,7,34,41
44,8482122,Brock Faber,D,MIN,22,82,6,35,41
44,8483471,Brad Lambert,C,WPG,31,82,5,36,41
44,8480849,Barrett Hayton,C,ARI,24,82,19,21,40
44,8477964,Ivan Barbashev,C,VGK,29,82,17,23,40
44,8475287,Erik Haula,L,NJD,33,82,16,24,40
44,8476461,Sean Couturier,C,PHI,32,82,13,27,40
44,8484144,Connor Bedard,C,CHI,19,82,22,17,39
44,8476483,Rickard Rakell,R,PIT,31,82,21,18,39
44,8475768,Jaden Schwartz,C,SEA,32,82,21,18,39
44,8477511,Anthony Mantha,R,VGK,30,82,18,21,39
44,8482110,Dawson Mercer,C,NJD,23,82,17,22,39
44,8482667,William Eklund,L,SJS,22,82,16,23,39
44,8483515,Juraj Slafkovsky,L,MTL,20,82,16,23,39
44,8476882,Teuvo Teravainen,L,CAR,30,82,15,24,39
44,8480068,Ryan Poehling,C,PHI,25,82,14,25,39
44,8474563,Drew Doughty,D,LAK,35,82,12,27,39
44,8477495,Seth Jones,D,CHI,30,82,10,29,39
44,8483524,Shane Wright,C,SEA,20,82,27,11,38
44,8482101,Danil Gushchin,L,SJS,22,82,23,15,38
44,8475714,Calle Jarnkrok,C,TOR,33,82,20,18,38
44,8479996,Cody Glass,C,NSH,25,82,20,18,38
44,8481560,Arthur Kaliyev,R,LAK,23,82,18,20,38
44,8480113,Alex Iafallo,L,WPG,31,82,16,22,38
44,8474641,Adam Henrique,C,EDM,34,82,15,23,38
44,8482222,Alexander Barabanov,L,SJS,30,82,14,24,38
44,8478046,Danton Heinen,L,BOS,29,82,13,25,38
44,8477498,Darnell Nurse,D,EDM,29,82,9,29,38
44,8476875,Mike Matheson,D,MTL,30,82,8,30,38
44,8482733,Logan Mailloux,D,MTL,31,82,4,34,38
44,8480821,Filip Zadina,R,SJS,25,82,20,17,37
44,8480185,Eetu Luostarinen,C,FLA,26,82,18,19,37
44,8482089,Jake Neighbours,L,STL,22,82,16,21,37
44,8482705,Cole Sillinger,C,CBJ,21,82,15,22,37
44,8477953,Kasperi Kapanen,R,STL,28,82,13,24,37
44,8475170,Brayden Schenn,C,STL,33,82,12,25,37
44,8478458,Jack Roslovic,C,NYR,27,82,11,26,37
44,8476906,Shayne Gostisbehere,D,DET,31,82,9,28,37
44,8483457,Lane Hutson,D,MTL,20,82,5,32,37
44,8479977,Kailer Yamamoto,R,SEA,26,82,19,17,36
44,8481618,Alex Newhook,C,MTL,23,82,14,22,36
44,8477021,Alex Kerfoot,C,ARI,30,82,12,24,36
44,8474565,Alex Pietrangelo,D,VGK,34,82,12,24,36
44,8478500,Ivan Provorov,D,CBJ,27,82,8,28,36
44,8478397,Rasmus Andersson,D,CGY,28,82,7,29,36
44,8480014,Gabriel Vilardi,C,WPG,25,82,21,14,35
44,8479423,Alex Nylander,L,CBJ,26,82,20,15,35
44,8476392,Adam Lowry,C,WPG,31,82,16,19,35
44,8475848,Brendan Gallagher,R,MTL,32,82,15,20,35
44,8479999,Casey Mittelstadt,C,COL,26,82,13,22,35
44,8474149,Evgenii Dadonov,R,DAL,35,82,13,22,35
44,8475149,Marcus Johansson,L,MIN,34,82,13,22,35
44,8477932,Aaron Ekblad,D,FLA,28,82,10,25,35
44,8482133,Thomas Bordeleau,C,SJS,22,82,7,28,35
44,8476292,Ondrej Palat,L,NJD,33,82,18,16,34
44,8478463,Anthony Beauvillier,L,NSH,27,82,17,17,34
44,8482146,Luke Evangelista,R,NSH,22,82,16,18,34
44,8476419,Jean-Gabriel Pageau,C,NYI,32,82,15,19,34
44,8482175,JJ Peterka,R,BUF,22,82,13,21,34
44,8479365,Trent Frederic,C,BOS,26,82,13,21,34
44,8476885,Jacob Trouba,D,NYR,30,82,12,22,34
44,8473422,Nick Foligno,L,CHI,37,82,11,23,34
44,8477429,Andrew Copp,C,DET,30,82,10,24,34
44,8476329,Travis Boyd,C,ARI,31,82,9,25,34
44,8481581,Thomas Harley,D,DAL,23,82,8,26,34
44,8480459,Pius Suter,C,VAN,28,82,16,17,33
44,8480855,Jack McBain,C,ARI,24,82,14,19,33
44,8474102,David Perron,L,DET,36,82,13,20,33
44,8476960,Andreas Athanasiou,C,CHI,30,82,13,20,33
44,8480806,Isac Lundestrom,C,ANA,25,82,13,20,33
44,8478472,Mathieu Joseph,R,OTT,27,82,9,24,33
44,8478396,Noah Hanifin,D,VGK,27,82,8,25,33
44,8482073,Braden Schneider,D,NYR,23,82,8,25,33
44,8476958,Jaccob Slavin,D,CAR,30,82,6,27,33
44,8481016,Ruslan Iskhakov,C,NYI,24,82,4,29,33
44,8481604,Pavel Dorofeyev,L,VGK,24,82,21,11,32
44,8477989,Christian Dvorak,C,MTL,28,82,18,14,32
44,8475799,Nino Niederreiter,R,WPG,32,82,16,16,32
44,8475343,Nic Dowd,C,WSH,34,82,15,17,32
44,8475791,Taylor Hall,L,CHI,33,82,14,18,32
44,8481554,Kaapo Kakko,R,NYR,23,82,14,18,32
44,8481535,Nils Hoglander,L,VAN,24,82,12,20,32
44,8482105,Jake Sanderson,D,OTT,22,82,10,22,32
44,8476892,Colton Parayko,D,STL,31,82,10,22,32
44,8480817,K'Andre Miller,D,NYR,24,82,9,23,32
44,8481546,Cam York,D,PHI,23,82,8,24,32
44,8475181,Nick Leddy,D,STL,33,82,8,24,32
44,8478851,Alexandre Carrier,D,NSH,28,82,6,26,32
44,8475314,Anders Lee,L,NYI,34,82,18,13,31
44,8474037,James van Riemsdyk,L,BOS,35,82,10,21,31
44,8481656,Aliaksei Protas,C,WSH,23,82,9,22,31
44,8482671,Owen Power,D,BUF,22,82,8,23,31
44,8477944,Jakub Vrana,L,STL,28,82,21,9,30
44,8481093,Rafael Harvey-Pinard,L,MTL,25,82,20,10,30
44,8482125,Alexander Holtz,R,NJD,22,82,16,14,30
44,8475760,Nick Bjugstad,C,ARI,32,82,15,15,30
44,8474870,Tyler Johnson,C,CHI,34,82,12,18,30
44,8479987,Morgan Geekie,C,BOS,26,82,12,18,30
44,8482475,Yegor Chinakhov,R,CBJ,23,82,11,19,30
44,8475220,Marcus Foligno,L,MIN,33,82,11,19,30
44,8476927,Teddy Blueger,C,VAN,30,82,11,19,30
44,8476869,Brady Skjei,D,CAR,30,82,10,20,30
44,8482079,Marco Rossi,C,MIN,23,82,10,20,30
44,8482142,Jamie Drysdale,D,PHI,22,82,8,22,30
44,8480434,Sean Durzi,D,ARI,26,82,5,25,30
44,8475906,John Klingberg,D,TOR,32,82,5,25,30
44,8475764,Cam Fowler,D,ANA,33,82,4,26,30
44,8476981,Josh Anderson,R,MTL,30,82,17,12,29
44,8479992,Michael Rasmussen,C,DET,25,82,11,18,29
44,8482087,Kaiden Guhle,D,MTL,22,82,11,18,29
44,8474884,Mike Hoffman,C,SJS,35,82,11,18,29
44,8479351,Sam Steel,C,DAL,26,82,10,19,29
44,8474716,Jared Spurgeon,D,MIN,35,82,5,24,29
44,8481699,Aku Raty,R,ARI,23,82,2,27,29
44,8478115,Pierre Engvall,L,NYI,28,82,17,11,28
44,8482259,Bobby McMann,C,TOR,28,82,16,12,28
44,8482062,Cole Smith,L,NSH,29,82,16,12,28
44,8482737,Zack Bolduc,C,STL,21,82,15,13,28
44,8477426,Nicholas Paul,L,TBL,29,82,14,14,28
44,8483499,Liam Ohgren,L,MIN,20,82,14,14,28
44,8480144,David Kampf,C,TOR,29,82,14,14,28
44,8474189,Lars Eller,C,PIT,35,82,10,18,28
44,8480798,Philipp Kurashev,C,CHI,25,82,8,20,28
44,8479345,Jakob Chychrun,D,OTT,26,82,8,20,28
44,8482679,Matt Coronato,R,CGY,22,82,8,20,28
44,8477969,Marcus Pettersson,D,PIT,28,82,6,22,28
44,8483490,Pavel Mintyukov,D,ANA,21,82,5,23,28
44,8480043,Timothy Liljegren,D,TOR,25,82,4,24,28
44,8479398,Samuel Girard,D,COL,26,82,4,24,28
44,8483493,Frank Nazar,C,CHI,20,82,23,4,27
44,8483431,Logan Cooley,C,ARI,20,82,17,10,27
44,8470621,Corey Perry,R,EDM,39,82,13,14,27
44,8475793,Ryan Johansen,C,PHI,32,82,13,14,27
44,8480813,Joe Veleno,C,DET,24,82,11,16,27
44,8481580,Connor McMichael,C,WSH,23,82,11,16,27
44,8482730,Brandt Clarke,D,LAK,21,82,11,16,27
44,8483565,Nick Blankenburg,D,CBJ,26,82,10,17,27
44,8476480,Vladislav Namestnikov,C,WPG,32,82,9,18,27
44,8476873,Mark Jankowski,C,NSH,30,82,9,18,27
44,8478891,Mason Appleton,C,WPG,28,82,8,19,27
44,8482720,Matthew Knies,L,TOR,22,82,7,20,27
44,8475744,Evgeny Kuznetsov,C,CAR,32,82,7,20,27
44,8479353,Brett Howden,C,VGK,26,82,7,20,27
44,8476923,Damon Severson,D,CBJ,30,82,7,20,27
44,8474034,Pat Maroon,L,BOS,36,82,6,21,27
44,8481014,Alexander Romanov,D,NYI,24,82,5,22,27
44,8482055,Drew O'Connor,L,PIT,26,82,16,10,26
44,8480074,Alexandre Texier,C,CBJ,25,82,13,13,26
44,8479346,Dillon Dube,C,CGY,26,82,10,16,26
44,8478840,Will Borgen,D,SEA,28,82,10,16,26
44,8482624,Daniil Miromanov,D,CGY,27,82,9,17,26
44,8478911,Matt Roy,D,LAK,29,82,7,19,26
44,8477506,Ryan Pulock,D,NYI,30,82,7,19,26
44,8480145,Neal Pionk,D,WPG,29,82,5,21,26
44,8480336,Sean Walker,D,COL,30,82,4,22,26
44,8475690,Chris Tanev,D,DAL,35,82,3,23,26
44,8484203,Bradly Nadeau,L,CAR,19,82,15,10,25
44,8476921,Jordan Martinook,L,CAR,32,82,13,12,25
44,8470610,Zach Parise,L,COL,40,82,13,12,25
44,8479293,Brandon Tanev,L,SEA,33,82,12,13,25
44,8479941,Justin Danforth,R,CBJ,31,82,11,14,25
44,8484153,Leo Carlsson,C,ANA,20,82,11,14,25
44,8476967,Brett Kulak,D,EDM,30,82,8,17,25
44,8476374,Sean Kuraly,C,CBJ,31,82,8,17,25
44,8481704,Juuso Parssinen,C,NSH,23,82,7,18,25
44,8475218,Mattias Ekholm,D,EDM,34,82,4,21,25
44,8482118,Sam Colangelo,R,ANA,23,82,19,5,24
44,8481517,Brett Leason,R,ANA,25,82,15,9,24
44,8477919,Frederick Gaudreau,C,MIN,31,82,12,12,24
44,8478020,Michael Amadio,C,VGK,28,82,12,12,24
44,8482155,Alex Laferriere,R,LAK,23,82,11,13,24
44,8477508,Curtis Lazar,C,NJD,29,82,11,13,24
44,8477365,Connor Clifton,D,BUF,29,82,10,14,24
44,8478109,Victor Olofsson,L,BUF,29,82,9,15,24
44,8477839,Conor Sheary,L,TBL,32,82,8,16,24
44,8475171,Oliver Ekman-Larsson,D,FLA,33,82,7,17,24
44,8482803,Olen Zellweger,D,ANA,21,82,6,18,24
44,8478133,Jake Evans,C,MTL,28,82,5,19,24
44,8474013,Ian Cole,D,VAN,35,82,5,19,24
44,8474574,Tyler Myers,D,VAN,34,82,3,21,24
44,8473507,Jeff Petry,D,DET,37,82,2,22,24
44,8482145,Mavrik Bourque,C,DAL,22,82,21,2,23
44,8480980,Connor Dewar,C,TOR,25,82,15,8,23
44,8484166,Adam Fantilli,C,CBJ,20,82,14,9,23
44,8479661,Tanner Jeannot,L,TBL,27,82,13,10,23
44,8478413,Jordan Greenway,L,BUF,27,82,11,12,23
44,8475842,Sam Carrick,C,EDM,32,82,11,12,23
44,8477931,Tomas Nosek,L,NJD,32,82,11,12,23
44,8476871,Tanner Pearson,L,MTL,32,82,9,14,23
44,8476457,Adam Larsson,D,SEA,32,82,8,15,23
44,8477435,Ryan Graves,D,PIT,29,82,7,16,23
44,8475763,Kevin Hayes,R,STL,32,82,6,17,23
44,8481537,Nikita Okhotiuk,D,CGY,24,82,6,17,23
44,8482470,Ilya Solovyov,D,CGY,24,82,6,17,23
44,8482655,J.J. Moser,D,ARI,24,82,2,21,23
44,8476469,Joel Armia,R,MTL,31,82,14,8,22
44,8478569,Noel Acciari,C,PIT,33,82,14,8,22
44,8473533,Jordan Staal,C,CAR,36,82,10,12,22
44,8480802,Ryan McLeod,C,EDM,25,82,10,12,22
44,8470604,Jeff Carter,C,PIT,39,82,10,12,22
44,8479415,Michael McLeod,C,NJD,26,82,8,14,22
44,8478013,Jake Walman,D,DET,28,82,8,14,22
44,8481028,Martin Pospisil,C,CGY,25,82,8,14,22
44,8476897,Oskar Sundqvist,C,STL,30,82,8,14,22
44,8476372,Nick Seeler,D,PHI,31,82,8,14,22
44,8482092,Ridly Greig,C,OTT,22,82,7,15,22
44,8475208,Brian Dumoulin,D,SEA,33,82,7,15,22
44,8481567,Henry Thrun,D,SJS,23,82,6,16,22
44,8476979,Erik Gustafsson,D,NYR,32,82,6,16,22
44,8480860,Kevin Bahl,D,NJD,24,82,5,17,22
44,8481186,Logan O'Connor,R,COL,28,82,4,18,22
44,8475462,Radko Gudas,D,ANA,34,82,4,18,22
44,8475200,Dmitry Orlov,D,CAR,33,82,2,20,22
44,8481178,Egor Zamula,D,PHI,24,82,0,22,22
44,8479393,Noah Gregor,C,TOR,26,82,14,7,21
44,8482702,Logan Stankoven,C,DAL,21,82,11,10,21
44,8476624,Barclay Goodrow,C,NYR,31,82,9,12,21
44,8475177,Calvin de Haan,D,TBL,33,82,8,13,21
44,8479371,Dante Fabbro,D,NSH,26,82,7,14,21
44,8476854,Hampus Lindholm,D,BOS,30,82,6,15,21
44,8480035,Henri Jokiharju,D,BUF,25,82,6,15,21
44,8477220,Nate Schmidt,D,WPG,33,82,5,16,21
44,8479998,Mikey Anderson,D,LAK,25,82,5,16,21
44,8476902,Esa Lindell,D,DAL,30,82,4,17,21
44,8478507,John Marino,D,NJD,27,82,3,18,21
44,8476931,Jake McCabe,D,TOR,31,82,3,18,21
44,8480796,Martin Fehervary,D,WSH,25,82,3,18,21
44,8480246,Nick Perbix,D,TBL,26,82,1,20,21
44,8478508,Yakov Trenin,C,COL,27,82,13,7,20
44,8476925,Colton Sissons,C,NSH,31,82,9,11,20
44,8481477,Nico Sturm,C,SJS,29,82,9,11,20
44,8477450,Jason Dickinson,C,CHI,29,82,8,12,20
44,8483491,Ivan Miroshnichenko,L,WSH,20,82,8,12,20
44,8475324,Nick Jensen,D,WSH,34,82,6,14,20
44,8483495,Simon Nemec,D,NJD,20,82,5,15,20
44,8480281,Alexey Toropchenko,R,STL,25,82,16,3,19
44,8475231,Casey Cizikas,C,NYI,33,82,13,6,19
44,8477392,Hudson Fasching,R,NYI,29,82,11,8,19
44,8482809,Jackson Blake,R,CAR,21,82,11,8,19
44,8479591,Michael Eyssimont,C,TBL,28,82,10,9,19
44,8482117,Lukas Reichel,L,CHI,22,82,9,10,19
44,8476822,Luke Glendening,C,TBL,35,82,9,10,19
44,8477369,Carson Soucy,D,VAN,30,82,8,11,19
44,8473504,Cal Clutterbuck,R,NYI,37,82,8,11,19
44,8475233,David Savard,D,MTL,34,82,7,12,19
44,8481522,Peyton Krebs,C,BUF,23,82,7,12,19
44,8478831,Kevin Stenlund,C,FLA,28,82,7,12,19
44,8476858,Phillip Di Giuseppe,L,VAN,31,82,6,13,19
44,8479514,Rem Pitlick,C,CHI,27,82,5,14,19
44,8481606,Jordan Spence,D,LAK,23,82,4,15,19
44,8476331,Dylan DeMelo,D,WPG,31,82,4,15,19
44,8476525,Colin Miller,D,WPG,32,82,4,15,19
44,8478443,Brandon Carlo,D,BOS,28,82,4,15,19
44,8475164,Jakob Silfverberg,R,ANA,34,82,3,16,19
44,8476467,Jamie Oleksiak,D,SEA,32,82,3,16,19
44,8482245,Artem Zub,D,OTT,29,82,2,17,19
44,8475279,Ben Chiarot,D,DET,33,82,2,17,19
44,8478399,Jonas Siegenthaler,D,NJD,27,82,2,17,19
44,8475188,Brayden McNabb,D,VGK,33,82,2,17,19
44,8470966,Mark Giordano,D,TOR,41,82,1,18,19
44,8475179,Dmitry Kulikov,D,FLA,34,82,1,18,19
44,8482111,Justin Barron,D,MTL,23,82,10,8,18
44,8479390,Taylor Raddysh,R,CHI,26,82,9,9,18
44,8474715,Cam Atkinson,R,PHI,35,82,8,10,18
44,8482074,Connor Zary,C,CGY,23,82,8,10,18
44,8477015,Connor Brown,R,EDM,30,82,7,11,18
44,8483505,Matthew Poitras,C,BOS,20,82,7,11,18
44,8474166,Alec Martinez,D,VGK,37,82,7,11,18
44,8476422,Mike Reilly,D,NYI,31,82,7,11,18
44,8478430,Oliver Kylington,D,CGY,27,82,6,12,18
44,8478178,Darren Raddysh,D,TBL,28,82,6,12,18
44,8479442,Troy Stecher,D,EDM,30,82,6,12,18
44,8482762,Simon Edvinsson,D,DET,21,82,6,12,18
44,8477505,Alexander Wennberg,C,NYR,30,82,5,13,18
44,8478136,Jake Middleton,D,MIN,28,82,5,13,18
44,8478882,Vladislav Gavrikov,D,LAK,29,82,4,14,18
44,8481605,Jackson LaCombe,D,ANA,23,82,4,14,18
44,8474673,TJ Brodie,D,TOR,34,82,3,15,18
44,8476463,Jonas Brodin,D,MIN,31,82,2,16,18
44,8477507,Nikita Zadorov,D,VAN,29,82,9,8,17
44,8479316,Luke Kunin,C,SJS,27,82,7,10,17
44,8479980,Nicolas Hague,D,VGK,26,82,7,10,17
44,8476312,Josh Manson,D,COL,33,82,7,10,17
44,8483482,Tristan Luneau,D,ANA,20,82,6,11,17
44,8476878,Zemgus Girgensons,L,BUF,30,82,5,12,17
44,8484911,Collin Graf,R,SJS,22,82,4,13,17
44,8478859,Niko Mikkola,D,FLA,28,82,4,13,17
44,8480834,Ty Emberson,D,SJS,24,82,3,14,17
44,8478408,Travis Dermott,D,ARI,28,82,3,14,17
44,8478416,Erik Cernak,D,TBL,27,82,2,15,17
44,8477034,Jaycob Megna,D,CHI,32,82,2,15,17
44,8476879,Cody Ceci,D,EDM,31,82,1,16,17
44,8476917,Adam Pelech,D,NYI,30,82,1,16,17
44,8484145,Zach Benson,L,BUF,19,82,10,6,16
44,8479383,Boris Katchouk,L,OTT,26,82,6,10,16
44,8479359,Beck Malenstyn,L,WSH,26,82,5,11,16
44,8480879,Jacob Bernard-Docker,D,OTT,24,82,5,11,16
44,8477425,Miles Wood,L,COL,29,82,5,11,16
44,8480990,Declan Chisholm,D,MIN,24,82,5,11,16
44,8476915,Jujhar Khaira,L,MIN,30,82,5,11,16
44,8479976,Juuso Valimaki,D,ARI,26,82,4,12,16
44,8478451,Ethan Bear,D,WSH,27,82,4,12,16
44,8479324,Ryan Lindgren,D,NYR,26,82,3,13,16
44,8475790,Erik Gudbranson,D,CBJ,32,82,3,13,16
44,8477499,Rasmus Ristolainen,D,PHI,30,82,3,13,16
44,8470600,Ryan Suter,D,DAL,39,82,2,14,16
44,8480807,Mattias Samuelsson,D,BUF,24,82,0,16,16
44,8473453,Trevor Lewis,C,LAK,37,82,10,5,15
44,8477330,Dominik Kubalik,L,OTT,29,82,7,8,15
44,8479983,Mario Ferraro,D,SJS,26,82,6,9,15
44,8474009,Nick Bonino,C,NYR,36,82,6,9,15
44,8481524,Bowen Byram,D,BUF,23,82,6,9,15
44,8477488,Brett Pesce,D,CAR,30,82,5,10,15
44,8482712,Oskar Olausson,R,COL,22,82,5,10,15
44,8476278,Colin Blackwell,C,CHI,31,82,3,12,15
44,8475455,Brenden Dillon,D,WPG,34,82,3,12,15
44,8481568,Alex Vlasic,D,CHI,23,82,1,14,15
44,8482858,Ryker Evans,D,SEA,23,82,1,14,15
44,8479291,Kevin Rooney,C,CGY,31,82,7,7,14
44,8477353,Tyler Motte,C,TBL,29,82,7,7,14
44,8481481,Blake Lizotte,C,LAK,27,82,6,8,14
44,8481553,Bobby Brink,R,PHI,23,82,5,9,14
44,8474567,Zach Bogosian,D,MIN,34,82,5,9,14
44,8477406,Mattias Janmark,C,EDM,32,82,5,9,14
44,8480073,Erik Brannstrom,D,OTT,25,82,4,10,14
44,8477845,Trevor van Riemsdyk,D,WSH,33,82,1,13,14
44,8476429,Scott Mayfield,D,NYI,32,82,1,13,14
44,8482516,Matthew Kessel,D,STL,24,82,0,14,14
44,8482666,Scott Morrow,D,CAR,22,82,6,7,13
44,8478468,Jeremy Lauzon,D,NSH,27,82,4,9,13
44,8476891,Matt Grzelcyk,D,BOS,30,82,3,10,13
44,8481059,Scott Perunovich,D,STL,26,82,3,10,13
44,8481030,Jack St. Ivany,D,PIT,25,82,3,10,13
44,8480058,Pierre-Olivier Joseph,D,PIT,25,82,2,11,13
44,8474151,Ryan McDonagh,D,NSH,35,82,1,12,13
44,8478043,Sam Lafferty,C,VAN,29,82,7,5,12
44,8483012,Logan Morrison,C,SEA,22,82,4,8,12
44,8477335,Kyle Burroughs,D,SJS,29,82,3,9,12
44,8479369,Andrew Peeke,D,BOS,26,82,2,10,12
44,8483466,Kevin Korchinski,D,CHI,20,82,2,10,12
44,8476473,Connor Murphy,D,CHI,31,82,1,11,12
44,8475825,Jani Hakanpää,D,DAL,32,82,0,12,12
44,8481601,Simon Holmstrom,R,NYI,23,82,5,6,11
44,8476442,Matt Nieto,L,PIT,32,82,3,8,11
44,8480448,Parker Kelly,L,OTT,25,82,7,3,10
44,8482166,Shakir Mukhamadullin,D,SJS,22,82,3,7,10
44,8481599,Victor Soderstrom,D,ARI,23,82,3,7,10
44,8482177,Marat Khusnutdinov,C,MIN,22,82,3,7,10
44,8480172,Jan Rutta,D,SJS,34,82,2,8,10
44,8475762,Derek Forbort,D,BOS,32,82,1,9,10
44,8484149,Gavin Brindley,C,CBJ,20,82,1,9,10
44,8482807,Ethan Del Mastro,D,CHI,21,82,4,5,9
44,8471677,Jack Johnson,D,COL,37,82,2,7,9
44,8481578,Graeme Clarke,R,NJD,23,82,4,4,8
44,8483468,Jiri Kulich,C,BUF,20,82,3,4,7
44,8483489,Fraser Minten,C,TOR,31,82,4,2,6
44,8482713,Mackie Samoskevich,R,FLA,22,82,4,2,6
44,8483763,Maksymilian Szuber,D,ARI,22,82,0,4,4
44,8482859,Zack Ostapchuk,C,OTT,21,82,1,1,2
44,8482141,Lukas Cormier,D,VGK,22,0,0,0,0
44,8476988,Matt Benning,D,SJS,30,0,0,0,0
44,8480727,Zach Whitecloud,D,VGK,28,0,0,0,0
44,8480887,Jordan Harris,D,MTL,24,0,0,0,0
44,8478450,Parker Wotherspoon,D,BOS,27,0,0,0,0
44,8481812,Nikolai Knyzhov,D,SJS,27,0,0,0,0
44,8480001,Urho Vaakanainen,D,ANA,25,0,0,0,0
44,8482176,Wyatt Kaiser,D,CHI,22,0,0,0,0
44,8481122,Simon Benoit,D,TOR,26,0,0,0,0
44,8476441,Joel Edmundson,D,TOR,31,0,0,0,0
44,8480884,Calen Addison,D,SJS,24,0,0,0,0
44,8482511,Mason Lohrei,D,BOS,23,0,0,0,0
44,8482192,Isaak Phillips,D,CHI,23,0,0,0,0
44,8480950,Ilya Lyubushkin,D,TOR,30,0,0,0,0
44,8474031,Kevin Shattenkirk,D,BOS,35,0,0,0,0
44,8475718,Justin Holl,D,DET,32,0,0,0,0
44,8479402,Jake Bean,D,CBJ,26,0,0,0,0
44,8474602,Justin Schultz,D,SEA,34,0,0,0,0
44,8477950,Tony DeAngelo,D,CAR,29,0,0,0,0
44,8481743,Marc Del Gaizo,D,NSH,25,0,0,0,0
44,8481527,Kaedan Korczak,D,VGK,23,0,0,0,0
44,8480192,Johnathan Kovacevic,D,MTL,27,0,0,0,0
44,8476874,Olli Maatta,D,DET,30,0,0,0,0
44,8482144,Jack Thompson,D,SJS,22,0,0,0,0
44,8480222,Sebastian Aho,D,NYI,28,0,0,0,0
44,8479458,Nikita Zaitsev,D,CHI,33,0,0,0,0
44,8471709,Marc-Edouard Vlasic,D,SJS,37,0,0,0,0
44,8482929,Emil Lilleberg,D,TBL,23,0,0,0,0
44,8477018,Ben Hutton,D,VGK,31,0,0,0,0
44,8481056,Spencer Stastney,D,NSH,24,0,0,0,0
44,8481593,Jayden Struble,D,MTL,23,0,0,0,0
44,8479982,Conor Timmins,D,TOR,26,0,0,0,0
44,8474090,Brendan Smith,D,NJD,35,0,0,0,0
44,8482964,Arber Xhekaj,D,MTL,23,0,0,0,0
44,8480891,Michael Kesselring,D,ARI,24,0,0,0,0
44,8477938,Haydn Fleury,D,TBL,28,0,0,0,0
44,8481806,Louis Crevier,D,CHI,23,0,0,0,0
44,8471274,Alex Goligoski,D,MIN,39,0,0,0,0
44,8481600,Tobias Bjornfot,D,FLA,23,0,0,0,0
44,8475797,Jarred Tinordi,D,CHI,32,0,0,0,0
44,8481521,Ronnie Attard,D,PHI,25,0,0,0,0
44,8474612,Travis Hamonic,D,OTT,34,0,0,0,0
44,8479576,Vincent Desharnais,D,EDM,28,0,0,0,0
44,8480049,Dylan Samberg,D,WPG,25,0,0,0,0
44,8483619,Filip Roos,D,CHI,25,0,0,0,0
44,8474568,Luke Schenn,D,NSH,35,0,0,0,0
44,8480184,Gustav Lindstrom,D,ANA,26,0,0,0,0
44,8480070,Ian Mitchell,D,BOS,25,0,0,0,0
44,8480196,Jacob Bryson,D,BUF,27,0,0,0,0
44,8471686,Marc Staal,D,PHI,37,0,0,0,0
44,8477467,Gustav Olofsson,D,SEA,30,0,0,0,0
44,8478970,Jalen Chatfield,D,CAR,28,0,0,0,0
44,8479348,Kale Clague,D,BUF,26,0,0,0,0
44,8473446,Erik Johnson,D,PHI,36,0,0,0,0
44,8477462,Robert Hagg,D,ANA,29,0,0,0,0
44,8478454,Noah Juulsen,D,VAN,27,0,0,0,0
44,8477384,Josh Brown,D,ARI,30,0,0,0,0
44,8481708,Zac Jones,D,NYR,24,0,0,0,0
44,8481167,Brayden Pachal,D,CGY,25,0,0,0,0
44,8482067,Connor Mackey,D,NYR,28,0,0,0,0
44,8483460,David Jiricek,D,CBJ,21,0,0,0,0
44,8481701,Santeri Hatakka,D,NJD,23,0,0,0,0
44,8478021,William Lagesson,D,ANA,28,0,0,0,0
44,8477851,Jordan Oesterle,D,CGY,32,0,0,0,0
44,8478452,Caleb Jones,D,COL,27,0,0,0,0
44,8479984,Cal Foote,D,NJD,26,0,0,0,0
44,8479639,Dylan Coghlan,D,CAR,26,0,0,0,0
44,8480874,Adam Ginning,D,PHI,24,0,0,0,0
44,8479321,Lucas Johansen,D,WSH,27,0,0,0,0
44,8480878,Nils Lundkvist,D,DAL,24,0,0,0,0
44,8482165,Yan Kuznetsov,D,CGY,22,0,0,0,0
44,8484258,Sam Malinski,D,COL,26,0,0,0,0
44,8480157,Calle Rosen,D,STL,30,0,0,0,0
44,8484304,Uvis Balinskis,D,FLA,28,0,0,0,0
44,8479985,Cale Fleury,D,SEA,26,0,0,0,0
44,8479378,Logan Stanley,D,WPG,26,0,0,0,0
44,8477541,Dakota Mermis,D,MIN,30,0,0,0,0
44,8481609,Vladislav Kolyachonok,D,ARI,23,0,0,0,0
44,8480823,Alexander Alexeyev,D,WSH,25,0,0,0,0
44,8481679,Maxence Guenette,D,OTT,23,0,0,0,0
44,8481564,Ryan Johnson,D,BUF,23,0,0,0,0
44,8479376,Victor Mete,D,PHI,26,0,0,0,0
44,8484254,Akito Hirose,D,VAN,25,0,0,0,0
44,8482660,Kent Johnson,C,CBJ,22,0,0,0,0
44,8482149,Cole Perfetti,C,WPG,22,0,0,0,0
44,8477987,Ryan Donato,C,CHI,28,0,0,0,0
44,8475755,Alexander Petrovic,D,DAL,32,0,0,0,0
44,8477810,Joel Hanley,D,CGY,33,0,0,0,0
44,8474145,Robert Bortuzzo,D,NYI,35,0,0,0,0
44,8481161,Jake Christiansen,D,CBJ,25,0,0,0,0
44,8476884,Derrick Pouliot,D,DAL,30,0,0,0,0
44,8481716,Dmitri Voronkov,L,CBJ,24,0,0,0,0
44,8480084,Nick DeSimone,D,NJD,30,0,0,0,0
44,8475750,Jon Merrill,D,MIN,32,0,0,0,0
44,8479315,Joey Anderson,R,CHI,26,0,0,0,0
44,8478011,Louie Belpedio,D,PHI,28,0,0,0,0
44,8482451,Mikael Pyyhtia,L,CBJ,23,0,0,0,0
44,8481541,Samuel Bolduc,D,NYI,24,0,0,0,0
44,8482126,Emil Andrae,D,PHI,31,0,0,0,0
44,8474618,Marco Scandella,D,STL,34,0,0,0,0
44,8477244,Chad Ruhwedel,D,NYR,34,0,0,0,0
44,8477971,Andreas Englund,D,LAK,28,0,0,0,0
44,8480829,Jesperi Kotkaniemi,C,CAR,24,0,0,0,0
44,8479372,Josh Mahura,D,FLA,26,0,0,0,0
44,8482095,Tyler Kleven,D,OTT,22,0,0,0,0
44,8481719,Maxwell Crozier,D,TBL,24,0,0,0,0
44,8475855,Jesper Fast,R,CAR,33,0,0,0,0
44,8480848,Ty Dellandrea,C,DAL,24,0,0,0,0
44,8475193,Tomas Tatar,L,SEA,34,0,0,0,0
44,8476889,Radek Faksa,C,DAL,30,0,0,0,0
44,8478495,Denis Gurianov,R,PHI,27,0,0,0,0
44,8480216,Jacob Peterson,C,SJS,25,0,0,0,0
44,8480252,Cole Guttman,C,CHI,25,0,0,0,0
44,8479026,Philippe Myers,D,TBL,27,0,0,0,0
44,8481006,Tyler Tucker,D,STL,24,0,0,0,0
44,8481032,Paul Cotter,C,VGK,25,0,0,0,0
44,8481577,Philip Tomasino,C,NSH,23,0,0,0,0
44,8476918,Jimmy Vesey,L,NYR,31,0,0,0,0
44,8479320,Max Lajoie,D,TOR,27,0,0,0,0
44,8478017,Mark Friedman,D,VAN,29,0,0,0,0
44,8481754,Nikita Nesterenko,C,ANA,23,0,0,0,0
44,8483407,Brandon Scanlin,D,NYR,25,0,0,0,0
44,8482659,Josh Doan,R,ARI,22,0,0,0,0
44,8477446,Michael McCarron,R,NSH,29,0,0,0,0
44,8477903,Garnet Hathaway,R,PHI,33,0,0,0,0
44,8482153,Brendan Brisson,C,VGK,23,0,0,0,0
44,8483546,Marshall Rifai,D,TOR,26,0,0,0,0
44,8484287,Cole McWard,D,VAN,23,0,0,0,0
44,8478854,Ryan Shea,D,PIT,27,0,0,0,0
44,8481585,Egor Afanasyev,L,NSH,23,0,0,0,0
44,8483398,Declan Carlile,D,TBL,31,0,0,0,0
44,8478502,Dennis Gilbert,D,CGY,28,0,0,0,0
44,8482749,Joshua Roy,R,MTL,21,0,0,0,0
44,8481598,Philip Broberg,D,EDM,23,0,0,0,0
44,8480835,Jack Drury,C,CAR,24,0,0,0,0
44,8480748,Kiefer Sherwood,L,NSH,29,0,0,0,0
44,8476934,Brock McGinn,L,ANA,30,0,0,0,0
44,8480870,Bo Groulx,C,ANA,24,0,0,0,0
44,8479368,Max Jones,L,ANA,26,0,0,0,0
44,8478099,Kevin Labanc,R,SJS,29,0,0,0,0
44,8478067,Oskar Lindblom,L,SJS,28,0,0,0,0
44,8476393,Nick Cousins,C,FLA,31,0,0,0,0
44,8483395,Arshdeep Bains,L,VAN,23,0,0,0,0
44,8480762,Eric Robinson,L,BUF,29,0,0,0,0
44,8479439,Jacob MacDonald,D,SJS,31,0,0,0,0
44,8476474,Stefan Noesen,R,CAR,31,0,0,0,0
44,8482787,Nikita Chibrikov,R,WPG,31,0,0,0,0
44,8478432,Christian Fischer,R,DET,27,0,0,0,0
44,8477979,Nicolas Aube-Kubel,R,WSH,28,0,0,0,0
44,8481789,Tye Kartye,L,SEA,23,0,0,0,0
44,8479330,Brandon Gignac,C,MTL,27,0,0,0,0
44,8480075,Cameron Crotty,D,ARI,25,0,0,0,0
44,8473473,Milan Lucic,L,BOS,36,0,0,0,0
44,8482094,Daemon Hunt,D,MIN,22,0,0,0,0
44,8481206,John Ludvig,D,PIT,24,0,0,0,0
44,8483630,Pavol Regenda,L,ANA,25,0,0,0,0
44,8481617,Vasily Podkolzin,R,VAN,23,0,0,0,0
44,8480306,Grant Hutton,D,NYI,29,0,0,0,0
44,8480995,Pontus Holmberg,R,TOR,25,0,0,0,0
44,8482148,Hendrix Lapierre,C,WSH,22,0,0,0,0
44,8477478,William Carrier,L,VGK,30,0,0,0,0
44,8480003,Jesper Boqvist,C,BOS,26,0,0,0,0
44,8482172,Landon Slaggert,L,CHI,22,0,0,0,0
44,8480789,Oliver Wahlstrom,R,NYI,24,0,0,0,0
44,8474062,Riley Nash,C,NYR,35,0,0,0,0
44,8480021,Jack Studnicka,C,SJS,25,0,0,0,0
44,8480025,MacKenzie Entwistle,R,CHI,25,0,0,0,0
44,8481582,Nicholas Robertson,L,TOR,23,0,0,0,0
44,8476867,Brendan Gaunce,C,CBJ,30,0,0,0,0
44,8479619,Michael Carcone,L,ARI,28,0,0,0,0
44,8479370,Tyson Jost,C,BUF,26,0,0,0,0
44,8479671,Mathieu Olivier,R,CBJ,27,0,0,0,0
44,8476994,Vinnie Hinostroza,C,PIT,30,0,0,0,0
44,8482070,Mitchell Chaffee,R,TBL,26,0,0,0,0
44,8477473,Justin Bailey,R,SJS,29,0,0,0,0
44,8479344,Jesse Puljujarvi,R,PIT,26,0,0,0,0
44,8480205,Emil Bemstrom,C,PIT,25,0,0,0,0
44,8479718,Alex Barré-Boulet,C,TBL,27,0,0,0,0
44,8482061,Brandon Biro,L,BUF,26,0,0,0,0
44,8479638,Justin Brazeau,R,BOS,26,0,0,0,0
44,8474040,Sam Gagner,C,EDM,35,0,0,0,0
44,8477846,Ryan Carpenter,C,SJS,33,0,0,0,0
44,8482077,Dylan Holloway,L,EDM,23,0,0,0,0
44,8482157,Will Cuylle,L,NYR,22,0,0,0,0
44,8480007,Jonas Rondbjerg,R,VGK,25,0,0,0,0
44,8478874,Adam Gaudette,C,STL,28,0,0,0,0
44,8478434,Keegan Kolesar,R,VGK,27,0,0,0,0
44,8480441,Trey Fix-Wolansky,R,CBJ,25,0,0,0,0
44,8479994,Jaret Anderson-Dolan,C,NSH,25,0,0,0,0
44,8483567,Georgii Merkulov,C,BOS,24,0,0,0,0
44,8477380,Jonny Brodzinski,C,NYR,31,0,0,0,0
44,8482201,Gage Goncalves,C,TBL,23,0,0,0,0
44,8478211,Dryden Hunt,L,CGY,29,0,0,0,0
44,8471699,Andrew Cogliano,C,COL,37,0,0,0,0
44,8479421,Jacob Moverare,D,LAK,26,0,0,0,0
44,8478881,Brett Seney,L,CHI,28,0,0,0,0
44,8477464,Nic Petan,C,MIN,29,0,0,0,0
44,8475958,Michael Sgarbossa,C,WSH,32,0,0,0,0
44,8481147,Reese Johnson,C,CHI,26,0,0,0,0
44,8479336,Carl Grundstrom,R,LAK,27,0,0,0,0
44,8480853,Liam Foudy,C,NSH,24,0,0,0,0
44,8479522,Hardy Haman Aktell,D,WSH,26,0,0,0,0
44,8481462,Mason Morelli,L,VGK,28,0,0,0,0
44,8482102,Vasily Ponomarev,C,CAR,22,0,0,0,0
44,8480844,Grigori Denisenko,L,VGK,24,0,0,0,0
44,8479944,Zach Aston-Reese,C,DET,30,0,0,0,0
44,8482784,Zach Dean,C,STL,21,0,0,0,0
44,8479419,Brett Murray,L,BUF,26,0,0,0,0
44,8479520,Brandon Duhaime,R,COL,27,0,0,0,0
44,8477573,Nathan Walker,L,STL,30,0,0,0,0
44,8478078,Rourke Chartier,C,OTT,28,0,0,0,0
44,8475795,Dylan McIlrath,D,WSH,32,0,0,0,0
44,8482496,Nils Aman,C,VAN,24,0,0,0,0
44,8480289,Morgan Barron,C,WPG,26,0,0,0,0
44,8481751,Lukas Rousek,R,BUF,25,0,0,0,0
44,8480011,Klim Kostin,C,SJS,25,0,0,0,0
44,8481556,John Beecher,C,BOS,23,0,0,0,0
44,8475278,Byron Froese,C,VGK,33,0,0,0,0
44,8475225,Craig Smith,C,DAL,35,0,0,0,0
44,8484326,Patrik Koch,D,ARI,28,0,0,0,0
44,8477930,Pierre-Edouard Bellemare,L,SEA,39,0,0,0,0
44,8478409,Anthony Richard,C,BOS,28,0,0,0,0
44,8481024,Linus Karlsson,C,VAN,25,0,0,0,0
44,8479986,Kole Lind,R,SEA,26,0,0,0,0
44,8479414,Nathan Bastian,R,NJD,27,0,0,0,0
44,8479362,Riley Tufte,L,COL,26,0,0,0,0
44,8481058,Jesse Ylönen,R,MTL,25,0,0,0,0
44,8482476,Emil Heineman,L,MTL,23,0,0,0,0
44,8482861,Vincent Iorio,D,WSH,22,0,0,0,0
44,8483432,Luca Del Bel Belluz,C,CBJ,31,0,0,0,0
44,8482744,James Malatesta,L,CBJ,21,0,0,0,0
44,8477887,Patrick Brown,C,BOS,32,0,0,0,0
44,8478585,Derek Ryan,C,EDM,38,0,0,0,0
44,8481441,Joe Snively,C,WSH,28,0,0,0,0
44,8481592,Jakob Pelletier,L,CGY,23,0,0,0,0
44,8482634,Alex Steeves,C,TOR,25,0,0,0,0
44,8477126,Jayson Megna,C,BOS,34,0,0,0,0
44,8475752,Tyler Pitlick,C,NYR,33,0,0,0,0
44,8480008,Adam Ruzicka,C,ARI,25,0,0,0,0
44,8481065,Angus Crookshank,L,OTT,25,0,0,0,0
44,8479547,Matthew Phillips,R,WSH,26,0,0,0,0
44,8480226,Marián Studenic,R,SEA,26,0,0,0,0
44,8481237,Kyle MacLean,C,NYI,25,0,0,0,0
44,8475413,Justin Dowling,C,NJD,34,0,0,0,0
44,8481641,Joel Kiviranta,L,COL,28,0,0,0,0
44,8478104,Sammy Blais,L,STL,28,0,0,0,0
44,8477454,Adam Erne,L,EDM,29,0,0,0,0
44,8481518,Nolan Foote,L,NJD,24,0,0,0,0
44,8480245,Olle Lycksell,R,PHI,25,0,0,0,0
44,8483570,Ben Meyers,C,ANA,26,0,0,0,0
44,8480776,Sheldon Rempal,R,VGK,29,0,0,0,0
44,8483920,Pierrick Dube,R,WSH,23,0,0,0,0
44,8480267,Sammy Walker,C,MIN,25,0,0,0,0
44,8482747,Brennan Othmann,L,NYR,21,0,0,0,0
44,8479991,Jake Leschyshyn,C,NYR,25,0,0,0,0
44,8478400,Colin White,C,MTL,27,0,0,0,0
44,8479328,Julien Gauthier,R,NYI,27,0,0,0,0
44,8484325,Waltteri Merela,C,TBL,26,0,0,0,0
44,8479066,Ryan Lomberg,L,FLA,30,0,0,0,0
44,8477070,Liam O'Brien,C,ARI,30,0,0,0,0
44,8478146,Matthew Highmore,C,OTT,28,0,0,0,0
44,8478028,Fredrik Olofsson,L,COL,28,0,0,0,0
44,8480880,Jakub Lauko,C,BOS,24,0,0,0,0
44,8479968,Vinni Lettieri,C,MIN,29,0,0,0,0
44,8474709,Matt Martin,L,NYI,35,0,0,0,0
44,8480845,Rasmus Kupari,C,WPG,24,0,0,0,0
44,8481550,Adam Beckman,L,MIN,23,0,0,0,0
44,8481422,Jacob Lucchini,C,MIN,29,0,0,0,0
44,8477401,John Hayden,C,SEA,29,0,0,0,0
44,8478904,Steven Lorentz,C,FLA,28,0,0,0,0
44,8482088,Justin Sourdif,R,FLA,22,0,0,0,0
44,8482751,Ryan Winterton,C,SEA,21,0,0,0,0
44,8482241,Radim Zohorna,L,PIT,28,0,0,0,0
44,8481690,Tyler Angle,C,CBJ,24,0,0,0,0
44,8476952,Dominic Toninato,C,WPG,30,0,0,0,0
44,8476919,Chris Tierney,C,NJD,30,0,0,0,0
44,8480032,Shane Bowers,C,NJD,25,0,0,0,0
44,8484314,Jiri Smejkal,L,OTT,28,0,0,0,0
44,8481239,Samuel Fagemo,L,LAK,24,0,0,0,0
44,8481532,Alex Turcotte,C,LAK,23,0,0,0,0
44,8481019,David Gustafsson,C,WPG,24,0,0,0,0
44,8478477,Mitchell Stephens,C,MTL,27,0,0,0,0
44,8479546,Oskar Steen,C,BOS,26,0,0,0,0
44,8480292,Carson Meyer,R,CBJ,27,0,0,0,0
44,8478446,Glenn Gawdin,C,ANA,27,0,0,0,0
44,8483531,Brian Halonen,L,NJD,25,0,0,0,0
44,8477149,Scott Sabourin,R,SJS,32,0,0,0,0
44,8479972,Mason Shaw,C,MIN,26,0,0,0,0
44,8480890,Jan Jenik,R,ARI,24,0,0,0,0
44,8478051,Max Willman,C,NJD,29,0,0,0,0
44,8480851,Akil Thomas,C,LAK,24,0,0,0,0
44,8482765,Isak Rosen,R,BUF,21,0,0,0,0
44,8478421,A.J. Greer,L,CGY,28,0,0,0,0
44,8478512,Austin Czarnik,C,DET,32,0,0,0,0
44,8479536,Axel Jonsson-Fjallby,L,WPG,26,0,0,0,0
44,8477320,Anton Blidh,L,NYR,29,0,0,0,0
44,8481543,Nikita Alexandrov,C,STL,24,0,0,0,0
44,8475235,Nicolas Deslauriers,L,PHI,33,0,0,0,0
44,8481070,Hugh McGing,L,STL,26,0,0,0,0
44,8480836,Jonathan Gruden,C,PIT,24,0,0,0,0
44,8481591,Sam Poulin,R,PIT,23,0,0,0,0
44,8477962,Brendan Lemieux,L,CAR,28,0,0,0,0
44,8483401,Marc Johnstone,R,PIT,28,0,0,0,0
44,8482250,Callahan Burke,C,CAR,27,0,0,0,0
44,8481726,Adam Edstrom,C,NYR,24,0,0,0,0
44,8471817,Ryan Reaves,R,TOR,37,0,0,0,0
44,8479587,Rhett Gardner,C,PHI,28,0,0,0,0
44,8475766,Austin Watson,L,TBL,32,0,0,0,0
44,8479367,William Lockwood,R,FLA,26,0,0,0,0
44,8478424,Jansen Harkins,C,PIT,27,0,0,0,0
44,8476913,Devin Shore,C,SEA,30,0,0,0,0
44,8482652,Walker Duehr,R,CGY,27,0,0,0,0
44,8477527,Ross Johnston,L,ANA,30,0,0,0,0
44,8481077,John Leonard,L,ARI,26,0,0,0,0
44,8483549,Lucas Condotta,L,MTL,27,0,0,0,0
44,8480468,James Hamblin,L,EDM,25,0,0,0,0
44,8476907,Mackenzie MacEachern,L,STL,30,0,0,0,0
44,8479543,Michael Pezzetta,L,MTL,26,0,0,0,0
44,8480355,Mark Kastelic,C,OTT,25,0,0,0,0
44,8482162,Roby Jarventie,L,OTT,22,0,0,0,0
44,8479772,Zack MacEwen,R,OTT,28,0,0,0,0
44,8483597,Milos Kelemen,L,ARI,25,0,0,0,0
44,8479379,Givani Smith,R,SJS,26,0,0,0,0
44,8481655,Cole Schwindt,R,CGY,23,0,0,0,0
44,8479981,Jonah Gadjovich,L,FLA,26,0,0,0,0
44,8482147,Jean-Luc Foudy,C,COL,22,0,0,0,0
44,8484255,Jason Polin,R,COL,25,0,0,0,0
44,8477993,Justin Kirkland,C,ARI,28,0,0,0,0
44,8479249,Andrew Poturalski,C,SEA,30,0,0,0,0
44,8482197,Adam Raska,R,MIN,23,0,0,0,0
44,8475780,Chris Wagner,R,COL,33,0,0,0,0
44,8479533,Joona Koppanen,L,PIT,26,0,0,0,0
44,8481534,Raphael Lavoie,C,EDM,24,0,0,0,0
44,8484321,Nikolas Matinpalo,D,OTT,26,0,0,0,0
44,8481043,Cole Koepke,L,TBL,26,0,0,0,0
44,8476323,Max McCormick,L,SEA,32,0,0,0,0
44,8483609,Adam Klapka,R,CGY,24,0,0,0,0
44,8483512,Matt Savoie,C,BUF,20,0,0,0,0
44,8484259,Ondrej Pavel,C,COL,31,0,0,0,0
44,8478147,Bokondji Imama,L,OTT,28,0,0,0,0
44,8482460,Matt Rempe,C,NYR,22,0,0,0,0
44,8477073,Kurtis MacDermid,L,NJD,30,0,0,0,0
44,8480274,Philip Kemp,D,EDM,25,0,0,0,0
44,8478956,Samuel Laberge,L,NJD,27,0,0,0,0
44,8483045,Cameron Butler,R,CBJ,31,0,0,0,0
45,8476453,Nikita Kucherov,R,TBL,31,82,37,86,123
45,8478402,Connor McDavid,C,EDM,27,82,28,86,114
45,8481559,Jack Hughes,C,NJD,23,82,38,73,111
45,8476468,J.T. Miller,C,VAN,31,82,35,75,110
45,8477492,Nathan MacKinnon,C,COL,29,82,39,61,100
45,8474564,Steven Stamkos,C,TBL,34,82,49,50,99
45,8480069,Cale Makar,D,COL,26,82,26,72,98
45,8478864,Kirill Kaprizov,L,MIN,27,82,39,58,97
45,8478010,Brayden Point,C,TBL,28,82,53,43,96
45,8479318,Auston Matthews,C,TOR,27,82,51,45,96
45,8478439,Travis Konecny,R,PHI,27,82,29,65,94
45,8479314,Matthew Tkachuk,L,FLA,27,82,34,59,93
45,8476887,Filip Forsberg,L,NSH,30,82,43,48,91
45,8477934,Leon Draisaitl,C,EDM,29,82,38,53,91
45,8478550,Artemi Panarin,L,NYR,33,82,36,54,90
45,8480800,Quinn Hughes,D,VAN,25,82,17,73,90
45,8477939,William Nylander,R,TOR,28,82,39,50,89
45,8477956,David Pastrnak,R,BOS,28,82,37,52,89
45,8480002,Nico Hischier,C,NJD,25,82,31,54,85
45,8474600,Roman Josi,D,NSH,34,82,23,62,85
45,8480012,Elias Pettersson,C,VAN,26,82,33,51,84
45,8471675,Sidney Crosby,C,PIT,37,82,40,43,83
45,8471214,Alex Ovechkin,L,WSH,39,82,35,48,83
45,8478420,Mikko Rantanen,R,COL,28,82,40,42,82
45,8479542,Brandon Hagel,L,TBL,26,82,31,49,80
45,8475166,John Tavares,C,TOR,34,82,29,48,77
45,8477493,Aleksander Barkov,C,FLA,29,82,24,53,77
45,8478414,Timo Meier,R,NJD,28,82,39,37,76
45,8482745,Mason McTavish,C,ANA,21,82,35,41,76
45,8481540,Cole Caufield,R,MTL,23,82,39,36,75
45,8479343,Clayton Keller,R,ARI,26,82,28,47,75
45,8477949,Alex Tuch,R,BUF,28,82,28,47,75
45,8478042,Viktor Arvidsson,R,LAK,31,82,27,48,75
45,8479407,Jesper Bratt,L,NJD,26,82,34,40,74
45,8471215,Evgeni Malkin,C,PIT,38,82,26,48,74
45,8482116,Tim Stützle,C,OTT,22,82,21,53,74
45,8476454,Ryan Nugent-Hopkins,C,EDM,31,82,20,54,74
45,8479323,Adam Fox,D,NYR,26,82,10,64,74
45,8479420,Tage Thompson,C,BUF,27,82,33,40,73
45,8479337,Alex DeBrincat,R,DET,27,82,28,45,73
45,8478440,Dylan Strome,C,WSH,27,82,28,45,73
45,8478445,Mathew Barzal,C,NYI,27,82,21,52,73
45,8477933,Sam Reinhart,C,FLA,29,82,31,41,72
45,8475172,Nazem Kadri,C,CGY,34,82,28,44,72
45,8478427,Sebastian Aho,C,CAR,27,82,24,48,72
45,8477479,Tyler Bertuzzi,L,TOR,29,82,35,36,71
45,8478403,Jack Eichel,C,VGK,28,82,27,44,71
45,8480801,Brady Tkachuk,L,OTT,25,82,42,28,70
45,8477404,Jake Guentzel,C,CAR,30,82,36,34,70
45,8477946,Dylan Larkin,C,DET,28,82,32,38,70
45,8480023,Robert Thomas,C,STL,25,82,20,50,70
45,8478493,Joel Eriksson Ek,C,MIN,27,82,44,25,69
45,8475184,Chris Kreider,L,NYR,33,82,39,30,69
45,8480027,Jason Robertson,L,DAL,25,82,28,41,69
45,8480839,Rasmus Dahlin,D,BUF,24,82,14,55,69
45,8481523,Kirby Dach,C,MTL,23,82,13,56,69
45,8477942,Kevin Fiala,L,LAK,28,82,27,41,68
45,8475167,Victor Hedman,D,TBL,34,82,13,55,68
45,8471685,Anze Kopitar,C,LAK,37,82,18,49,67
45,8473512,Claude Giroux,R,OTT,36,82,23,43,66
45,8470794,Joe Pavelski,C,DAL,40,82,20,46,66
45,8476853,Morgan Rielly,D,TOR,30,82,6,60,66
45,8475786,Zach Hyman,L,EDM,32,82,43,22,65
45,8478047,Michael Bunting,L,PIT,29,82,25,40,65
45,8482684,Luke Hughes,D,NJD,21,82,18,47,65
45,8482097,Jack Quinn,R,BUF,23,82,31,33,64
45,8476881,Tomas Hertl,C,VGK,31,82,30,34,64
45,8475810,Bryan Rust,R,PIT,32,82,29,35,64
45,8480036,Miro Heiskanen,D,DAL,25,82,12,52,64
45,8476459,Mika Zibanejad,C,NYR,31,82,29,34,63
45,8481557,Matt Boldy,L,MIN,23,82,27,36,63
45,8480830,Andrei Svechnikov,R,CAR,24,82,26,37,63
45,8474141,Patrick Kane,R,DET,36,82,24,39,63
45,8473419,Brad Marchand,L,BOS,36,82,21,42,63
45,8473986,Alex Killorn,L,ANA,35,82,30,32,62
45,8478398,Kyle Connor,L,WPG,28,82,29,32,61
45,8477501,Valeri Nichushkin,R,COL,29,82,29,32,61
45,8476460,Mark Scheifele,C,WPG,31,82,27,34,61
45,8477402,Pavel Buchnevich,L,STL,29,82,26,35,61
45,8479325,Charlie McAvoy,D,BOS,27,82,12,49,61
45,8478444,Brock Boeser,R,VAN,27,82,25,35,60
45,8478873,Troy Terry,R,ANA,27,82,23,37,60
45,8475158,Ryan O'Reilly,C,NSH,33,82,23,37,60
45,8477955,Jared McCann,L,SEA,28,82,22,38,60
45,8479400,Pierre-Luc Dubois,L,LAK,26,82,30,29,59
45,8476539,Jonathan Marchessault,R,VGK,34,82,28,31,59
45,8475692,Mats Zuccarello,R,MIN,37,82,11,48,59
45,8478449,Roope Hintz,C,DAL,28,82,27,31,58
45,8477476,Artturi Lehkonen,L,COL,29,82,27,31,58
45,8476389,Vincent Trocheck,C,NYR,31,82,26,32,58
45,8475168,Matt Duchene,C,DAL,33,82,24,34,58
45,8482078,Lucas Raymond,L,DET,22,82,19,39,58
45,8478366,Frank Vatrano,R,ANA,30,82,28,29,57
45,8477500,Bo Horvat,C,NYI,29,82,25,32,57
45,8479339,Patrik Laine,L,CBJ,26,82,22,35,57
45,8479410,Mikhail Sergachev,D,TBL,26,82,17,40,57
45,8474578,Erik Karlsson,D,PIT,34,82,17,40,57
45,8480015,Owen Tippett,R,PHI,25,82,28,28,56
45,8477951,Nick Schmaltz,C,ARI,28,82,24,32,56
45,8480208,Drake Batherson,R,OTT,26,82,22,34,56
45,8480803,Evan Bouchard,D,EDM,25,82,20,36,56
45,8473994,Jamie Benn,L,DAL,35,82,20,36,56
45,8476456,Jonathan Huberdeau,C,CGY,31,82,16,40,56
45,8475314,Anders Lee,L,NYI,34,82,36,19,55
45,8478466,Daniel Sprong,R,DET,27,82,33,22,55
45,8480018,Nick Suzuki,C,MTL,25,82,29,26,55
45,8482093,Seth Jarvis,C,CAR,22,82,27,28,55
45,8477960,Adrian Kempe,R,LAK,28,82,25,30,55
45,8477407,Anthony Duclair,L,TBL,29,82,21,34,55
45,8476875,Mike Matheson,D,MTL,30,82,14,41,55
45,8476346,Johnny Gaudreau,L,CBJ,31,82,8,47,55
45,8481542,Moritz Seider,D,DET,23,82,8,47,55
45,8476483,Rickard Rakell,R,PIT,31,82,32,22,54
45,8476448,William Karlsson,C,VGK,31,82,28,26,54
45,8482159,Tyson Foerster,R,PHI,22,82,25,29,54
45,8478438,Tommy Novak,C,NSH,27,82,22,32,54
45,8475170,Brayden Schenn,C,STL,33,82,21,33,54
45,8477496,Elias Lindholm,C,VAN,30,82,18,36,54
45,8477964,Ivan Barbashev,C,VGK,29,82,16,38,54
45,8480798,Philipp Kurashev,C,CHI,25,82,13,41,54
45,8478856,Conor Garland,R,VAN,28,82,27,26,53
45,8480028,Morgan Frost,C,PHI,25,82,20,33,53
45,8481528,Dylan Cozens,C,BUF,23,82,18,35,53
45,8474679,Gustav Nyquist,C,NSH,35,82,18,35,53
45,8477444,Andre Burakovsky,L,SEA,29,82,17,36,53
45,8475794,Tyler Seguin,C,DAL,32,82,24,28,52
45,8476399,Blake Coleman,C,CGY,33,82,23,29,52
45,8480865,Noah Dobson,D,NYI,24,82,14,38,52
45,8480031,Maxime Comtois,L,CAR,25,82,11,41,52
45,8478397,Rasmus Andersson,D,CGY,28,82,9,43,52
45,8481068,Yegor Sharangovich,C,CGY,26,82,31,20,51
45,8477409,Carter Verhaeghe,C,FLA,29,82,25,26,51
45,8475913,Mark Stone,R,VGK,32,82,23,28,51
45,8482740,Wyatt Johnston,C,DAL,21,82,18,33,51
45,8479385,Jordan Kyrou,C,STL,26,82,16,35,51
45,8476462,Dougie Hamilton,D,NJD,31,82,13,38,51
45,8477986,Brandon Montour,D,FLA,30,82,12,39,51
45,8475754,Brock Nelson,C,NYI,33,82,29,21,50
45,8480797,Joel Farabee,L,PHI,24,82,26,24,50
45,8477416,Oliver Bjorkstrand,R,SEA,29,82,24,26,50
45,8477947,Sonny Milano,L,WSH,28,82,23,27,50
45,8474641,Adam Henrique,C,EDM,34,82,21,29,50
45,8478519,Anthony Cirelli,C,TBL,27,82,19,31,50
45,8482146,Luke Evangelista,R,NSH,22,82,19,30,49
45,8474150,Mikael Backlund,C,CGY,35,82,18,31,49
45,8480188,Fabian Zetterlund,L,SJS,25,82,17,32,49
45,8482124,Quinton Byfield,R,LAK,22,82,16,33,49
45,8477447,Shea Theodore,D,VGK,29,82,11,38,49
45,8483457,Lane Hutson,D,MTL,20,82,3,46,49
45,8475784,Jeff Skinner,C,BUF,32,82,26,22,48
45,8477456,J.T. Compher,L,DET,29,82,22,26,48
45,8477451,Ryan Hartman,R,MIN,30,82,22,26,48
45,8483515,Juraj Slafkovsky,L,MTL,20,82,16,32,48
45,8478463,Anthony Beauvillier,L,NSH,27,82,15,33,48
45,8478055,Gustav Forsling,D,FLA,28,82,13,35,48
45,8476826,Yanni Gourde,C,SEA,33,82,11,37,48
45,8478038,Devon Toews,D,COL,30,82,11,37,48
45,8474590,John Carlson,D,WSH,34,82,10,38,48
45,8482665,Matty Beniers,C,SEA,22,82,8,40,48
45,8475169,Evander Kane,L,EDM,33,82,30,17,47
45,8480064,Josh Norris,C,OTT,25,82,28,19,47
45,8479525,Ross Colton,C,COL,28,82,27,20,47
45,8475191,Reilly Smith,R,PIT,33,82,20,27,47
45,8477940,Nikolaj Ehlers,L,WPG,28,82,19,28,47
45,8475793,Ryan Johansen,C,PHI,32,82,19,28,47
45,8478401,Pavel Zacha,C,BOS,27,82,15,32,47
45,8478460,Zach Werenski,D,CBJ,27,82,11,36,47
45,8476882,Teuvo Teravainen,L,CAR,30,82,20,26,46
45,8479999,Casey Mittelstadt,C,COL,26,82,16,30,46
45,8477935,Sam Bennett,C,FLA,28,82,15,31,46
45,8478474,Lawson Crouse,L,ARI,27,82,25,20,45
45,8475765,Vladimir Tarasenko,R,FLA,33,82,22,23,45
45,8475722,Jason Zucker,L,NSH,32,82,21,24,45
45,8478458,Jack Roslovic,C,NYR,27,82,21,24,45
45,8479675,Trevor Moore,L,LAK,29,82,17,28,45
45,8476292,Ondrej Palat,L,NJD,33,82,14,31,45
45,8471724,Kris Letang,D,PIT,37,82,9,36,45
45,8480078,Filip Chytil,C,NYR,25,82,9,36,45
45,8476906,Shayne Gostisbehere,D,DET,31,82,7,38,45
45,8471698,T.J. Oshie,R,WSH,38,82,20,24,44
45,8476479,Phillip Danault,C,LAK,31,82,20,24,44
45,8477998,Warren Foegele,L,EDM,28,82,19,25,44
45,8478413,Jordan Greenway,L,BUF,27,82,19,25,44
45,8481533,Trevor Zegras,C,ANA,23,82,18,26,44
45,8477494,Jonathan Drouin,L,COL,29,82,13,31,44
45,8475744,Evgeny Kuznetsov,C,CAR,32,82,12,32,44
45,8475798,Mikael Granlund,C,SJS,32,82,10,34,44
45,8474563,Drew Doughty,D,LAK,35,82,10,34,44
45,8476432,Boone Jenner,C,CBJ,31,82,26,17,43
45,8481624,Ilya Mikheyev,R,VAN,30,82,25,18,43
45,8478498,Jake DeBrusk,L,BOS,28,82,20,23,43
45,8482109,Alexis Lafrenière,L,NYR,23,82,18,25,43
45,8480185,Eetu Luostarinen,C,FLA,26,82,18,25,43
45,8482667,William Eklund,L,SJS,22,82,15,28,43
45,8475745,Charlie Coyle,C,BOS,32,82,12,31,43
45,8480434,Sean Durzi,D,ARI,26,82,11,32,43
45,8481178,Egor Zamula,D,PHI,24,82,11,32,43
45,8479425,Filip Hronek,D,VAN,27,82,10,33,43
45,8483524,Shane Wright,C,SEA,20,82,31,11,42
45,8482699,Dylan Guenther,R,ARI,21,82,26,16,42
45,8481596,Shane Pinto,C,OTT,24,82,21,21,42
45,8482055,Drew O'Connor,L,PIT,26,82,18,24,42
45,8477429,Andrew Copp,C,DET,30,82,17,25,42
45,8473422,Nick Foligno,L,CHI,37,82,14,28,42
45,8474102,David Perron,L,DET,36,82,13,29,42
45,8475753,Justin Faulk,D,STL,32,82,12,30,42
45,8481711,Matias Maccelli,L,ARI,24,82,11,31,42
45,8479345,Jakob Chychrun,D,OTT,26,82,9,33,42
45,8474157,Max Pacioretty,L,WSH,36,82,22,19,41
45,8474586,Jordan Eberle,R,SEA,34,82,21,20,41
45,8478233,Andrew Mangiapane,L,CGY,28,82,20,21,41
45,8475726,Tyler Toffoli,C,WPG,32,82,19,22,41
45,8473449,Kyle Okposo,R,FLA,36,82,17,24,41
45,8482475,Yegor Chinakhov,R,CBJ,23,82,17,24,41
45,8480039,Martin Necas,C,CAR,25,82,15,26,41
45,8483445,Cutter Gauthier,L,ANA,20,82,9,32,41
45,8482110,Dawson Mercer,C,NJD,23,82,23,17,40
45,8481618,Alex Newhook,C,MTL,23,82,23,17,40
45,8474870,Tyler Johnson,C,CHI,34,82,23,17,40
45,8480014,Gabriel Vilardi,C,WPG,25,82,21,19,40
45,8475791,Taylor Hall,L,CHI,33,82,18,22,40
45,8478472,Mathieu Joseph,R,OTT,27,82,17,23,40
45,8475287,Erik Haula,L,NJD,33,82,13,27,40
45,8480873,Rasmus Sandin,D,WSH,24,82,12,28,40
45,8478407,Vince Dunn,D,SEA,28,82,8,32,40
45,8477503,Max Domi,C,TOR,29,82,5,35,40
45,8481535,Nils Hoglander,L,VAN,24,82,27,12,39
45,8478115,Pierre Engvall,L,NYI,28,82,21,18,39
45,8483808,Andrei Kuzmenko,L,CGY,28,82,17,22,39
45,8477021,Alex Kerfoot,C,ARI,30,82,15,24,39
45,8476458,Ryan Strome,C,ANA,31,82,12,27,39
45,8477495,Seth Jones,D,CHI,30,82,10,29,39
45,8476905,Chandler Stephenson,C,VGK,30,82,9,30,39
45,8481699,Aku Raty,R,ARI,23,82,2,37,39
45,8482089,Jake Neighbours,L,STL,22,82,25,13,38
45,8482113,Anton Lundell,C,FLA,23,82,24,14,38
45,8477497,Sean Monahan,C,WPG,30,82,19,19,38
45,8481554,Kaapo Kakko,R,NYR,23,82,19,19,38
45,8480893,Kirill Marchenko,R,CBJ,24,82,18,20,38
45,8475799,Nino Niederreiter,R,WPG,32,82,18,20,38
45,8479992,Michael Rasmussen,C,DET,25,82,17,21,38
45,8477504,Josh Morrissey,D,WPG,29,82,16,22,38
45,8474149,Evgenii Dadonov,R,DAL,35,82,14,24,38
45,8482624,Daniil Miromanov,D,CGY,27,82,14,24,38
45,8482133,Thomas Bordeleau,C,SJS,22,82,9,29,38
45,8477346,MacKenzie Weegar,D,CGY,30,82,6,32,38
45,8476438,Brandon Saad,L,STL,32,82,24,13,37
45,8484144,Connor Bedard,C,CHI,19,82,20,17,37
45,8479996,Cody Glass,C,NSH,25,82,20,17,37
45,8478542,Evan Rodrigues,C,FLA,31,82,16,21,37
45,8477511,Anthony Mantha,R,VGK,30,82,16,21,37
45,8476329,Travis Boyd,C,ARI,31,82,10,27,37
45,8476854,Hampus Lindholm,D,BOS,30,82,10,27,37
45,8477953,Kasperi Kapanen,R,STL,28,82,9,28,37
45,8478882,Vladislav Gavrikov,D,LAK,29,82,9,28,37
45,8482671,Owen Power,D,BUF,22,82,8,29,37
45,8479398,Samuel Girard,D,COL,26,82,7,30,37
45,8470613,Brent Burns,D,CAR,39,82,6,31,37
45,8482105,Jake Sanderson,D,OTT,22,82,4,33,37
45,8478975,Mason Marchment,L,DAL,29,82,16,20,36
45,8480220,Noah Cates,L,PHI,25,82,12,24,36
45,8481013,Jonatan Berggren,R,DET,24,82,12,24,36
45,8476960,Andreas Athanasiou,C,CHI,30,82,12,24,36
45,8480817,K'Andre Miller,D,NYR,24,82,12,24,36
45,8477498,Darnell Nurse,D,EDM,29,82,10,26,36
45,8476958,Jaccob Slavin,D,CAR,30,82,7,29,36
45,8483431,Logan Cooley,C,ARI,20,82,19,16,35
45,8481580,Connor McMichael,C,WSH,23,82,17,18,35
45,8479591,Michael Eyssimont,C,TBL,28,82,17,18,35
45,8476392,Adam Lowry,C,WPG,31,82,13,22,35
45,8475763,Kevin Hayes,R,STL,32,82,13,22,35
45,8482222,Alexander Barabanov,L,SJS,30,82,12,23,35
45,8480459,Pius Suter,C,VAN,28,82,12,23,35
45,8476892,Colton Parayko,D,STL,31,82,7,28,35
45,8476480,Vladislav Namestnikov,C,WPG,32,82,7,28,35
45,8475181,Nick Leddy,D,STL,33,82,3,32,35
45,8483397,Marc McLaughlin,C,BOS,25,82,28,6,34
45,8479423,Alex Nylander,L,CBJ,26,82,18,16,34
45,8477989,Christian Dvorak,C,MTL,28,82,18,16,34
45,8474053,Logan Couture,C,SJS,35,82,15,19,34
45,8480849,Barrett Hayton,C,ARI,24,82,14,20,34
45,8476872,Scott Laughton,C,PHI,30,82,13,21,34
45,8477425,Miles Wood,L,COL,29,82,10,24,34
45,8477932,Aaron Ekblad,D,FLA,28,82,9,25,34
45,8482092,Ridly Greig,C,OTT,22,82,9,25,34
45,8474037,James van Riemsdyk,L,BOS,35,82,8,26,34
45,8476792,Torey Krug,D,STL,33,82,6,28,34
45,8475171,Oliver Ekman-Larsson,D,FLA,33,82,6,28,34
45,8482733,Logan Mailloux,D,MTL,31,82,3,31,34
45,8477944,Jakub Vrana,L,STL,28,82,18,15,33
45,8476925,Colton Sissons,C,NSH,31,82,17,16,33
45,8481560,Arthur Kaliyev,R,LAK,23,82,16,17,33
45,8478046,Danton Heinen,L,BOS,29,82,15,18,33
45,8482175,JJ Peterka,R,BUF,22,82,15,18,33
45,8479987,Morgan Geekie,C,BOS,26,82,15,18,33
45,8476469,Joel Armia,R,MTL,31,82,12,21,33
45,8476927,Teddy Blueger,C,VAN,30,82,11,22,33
45,8476457,Adam Larsson,D,SEA,32,82,10,23,33
45,8478462,Nicolas Roy,C,VGK,27,82,9,24,33
45,8476419,Jean-Gabriel Pageau,C,NYI,32,82,9,24,33
45,8475906,John Klingberg,D,TOR,32,82,7,26,33
45,8477969,Marcus Pettersson,D,PIT,28,82,2,31,33
45,8478057,Dakota Joshua,C,VAN,28,82,16,16,32
45,8482079,Marco Rossi,C,MIN,23,82,14,18,32
45,8477919,Frederick Gaudreau,C,MIN,31,82,14,18,32
45,8481656,Aliaksei Protas,C,WSH,23,82,13,19,32
45,8478013,Jake Walman,D,DET,28,82,12,20,32
45,8478396,Noah Hanifin,D,VGK,27,82,10,22,32
45,8474189,Lars Eller,C,PIT,35,82,10,22,32
45,8476885,Jacob Trouba,D,NYR,30,82,8,24,32
45,8481546,Cam York,D,PHI,23,82,8,24,32
45,8476869,Brady Skjei,D,CAR,30,82,8,24,32
45,8482655,J.J. Moser,D,ARI,24,82,8,24,32
45,8473563,Nicklas Backstrom,C,WSH,37,82,7,25,32
45,8475197,Tyson Barrie,D,NSH,33,82,7,25,32
45,8474565,Alex Pietrangelo,D,VGK,34,82,5,27,32
45,8481016,Ruslan Iskhakov,C,NYI,24,82,1,31,32
45,8474884,Mike Hoffman,C,SJS,35,82,18,13,31
45,8475760,Nick Bjugstad,C,ARI,32,82,16,15,31
45,8476374,Sean Kuraly,C,CBJ,31,82,16,15,31
45,8478469,Thomas Chabot,D,OTT,27,82,13,18,31
45,8480068,Ryan Poehling,C,PHI,25,82,13,18,31
45,8471218,Blake Wheeler,R,NYR,38,82,11,20,31
45,8475149,Marcus Johansson,L,MIN,34,82,7,24,31
45,8480145,Neal Pionk,D,WPG,29,82,7,24,31
45,8477948,Travis Sanheim,D,PHI,28,82,2,29,31
45,8483493,Frank Nazar,C,CHI,20,82,21,9,30
45,8475848,Brendan Gallagher,R,MTL,32,82,18,12,30
45,8477952,Robby Fabbri,C,DET,28,82,17,13,30
45,8475151,Kyle Palmieri,C,NYI,33,82,15,15,30
45,8480813,Joe Veleno,C,DET,24,82,15,15,30
45,8477426,Nicholas Paul,L,TBL,29,82,14,16,30
45,8475768,Jaden Schwartz,C,SEA,32,82,11,19,30
45,8476461,Sean Couturier,C,PHI,32,82,10,20,30
45,8482142,Jamie Drysdale,D,PHI,22,82,10,20,30
45,8482125,Alexander Holtz,R,NJD,22,82,9,21,30
45,8480043,Timothy Liljegren,D,TOR,25,82,8,22,30
45,8476979,Erik Gustafsson,D,NYR,32,82,5,25,30
45,8482122,Brock Faber,D,MIN,22,82,3,27,30
45,8474716,Jared Spurgeon,D,MIN,35,82,3,27,30
45,8482705,Cole Sillinger,C,CBJ,21,82,20,9,29
45,8476981,Josh Anderson,R,MTL,30,82,18,11,29
45,8480821,Filip Zadina,R,SJS,25,82,17,12,29
45,8484145,Zach Benson,L,BUF,19,82,15,14,29
45,8474715,Cam Atkinson,R,PHI,35,82,14,15,29
45,8479415,Michael McLeod,C,NJD,26,82,12,17,29
45,8480860,Kevin Bahl,D,NJD,24,82,11,18,29
45,8480802,Ryan McLeod,C,EDM,25,82,10,19,29
45,8475164,Jakob Silfverberg,R,ANA,34,82,10,19,29
45,8476880,Tom Wilson,R,WSH,30,82,9,20,29
45,8483471,Brad Lambert,C,WPG,31,82,5,24,29
45,8475233,David Savard,D,MTL,34,82,5,24,29
45,8476923,Damon Severson,D,CBJ,30,82,4,25,29
45,8480009,Eeli Tolvanen,R,SEA,25,82,15,13,28
45,8473533,Jordan Staal,C,CAR,36,82,15,13,28
45,8479316,Luke Kunin,C,SJS,27,82,15,13,28
45,8479365,Trent Frederic,C,BOS,26,82,11,17,28
45,8475200,Dmitry Orlov,D,CAR,33,82,11,17,28
45,8475220,Marcus Foligno,L,MIN,33,82,10,18,28
45,8479293,Brandon Tanev,L,SEA,33,82,10,18,28
45,8479351,Sam Steel,C,DAL,26,82,8,20,28
45,8479514,Rem Pitlick,C,CHI,27,82,8,20,28
45,8481553,Bobby Brink,R,PHI,23,82,7,21,28
45,8478178,Darren Raddysh,D,TBL,28,82,4,24,28
45,8478508,Yakov Trenin,C,COL,27,82,17,10,27
45,8477450,Jason Dickinson,C,CHI,29,82,14,13,27
45,8479977,Kailer Yamamoto,R,SEA,26,82,13,14,27
45,8480144,David Kampf,C,TOR,29,82,12,15,27
45,8479346,Dillon Dube,C,CGY,26,82,12,15,27
45,8483499,Liam Ohgren,L,MIN,20,82,11,16,27
45,8477839,Conor Sheary,L,TBL,32,82,11,16,27
45,8475231,Casey Cizikas,C,NYI,33,82,11,16,27
45,8482720,Matthew Knies,L,TOR,22,82,9,18,27
45,8481014,Alexander Romanov,D,NYI,24,82,9,18,27
45,8478911,Matt Roy,D,LAK,29,82,9,18,27
45,8482803,Olen Zellweger,D,ANA,21,82,9,18,27
45,8481028,Martin Pospisil,C,CGY,25,82,8,19,27
45,8481581,Thomas Harley,D,DAL,23,82,7,20,27
45,8475764,Cam Fowler,D,ANA,33,82,5,22,27
45,8481703,Valtteri Puustinen,R,PIT,25,82,2,25,27
45,8482155,Alex Laferriere,R,LAK,23,82,18,8,26
45,8481477,Nico Sturm,C,SJS,29,82,14,12,26
45,8483491,Ivan Miroshnichenko,L,WSH,20,82,12,14,26
45,8481601,Simon Holmstrom,R,NYI,23,82,11,15,26
45,8476442,Matt Nieto,L,PIT,32,82,11,15,26
45,8484153,Leo Carlsson,C,ANA,20,82,10,16,26
45,8474574,Tyler Myers,D,VAN,34,82,7,19,26
45,8481186,Logan O'Connor,R,COL,28,82,7,19,26
45,8479976,Juuso Valimaki,D,ARI,26,82,5,21,26
45,8478507,John Marino,D,NJD,27,82,3,23,26
45,8482145,Mavrik Bourque,C,DAL,22,82,20,5,25
45,8482101,Danil Gushchin,L,SJS,22,82,19,6,25
45,8478109,Victor Olofsson,L,BUF,29,82,14,11,25
45,8484166,Adam Fantilli,C,CBJ,20,82,14,11,25
45,8478043,Sam Lafferty,C,VAN,29,82,14,11,25
45,8479353,Brett Howden,C,VGK,26,82,12,13,25
45,8474034,Pat Maroon,L,BOS,36,82,12,13,25
45,8480113,Alex Iafallo,L,WPG,31,82,10,15,25
45,8480806,Isac Lundestrom,C,ANA,25,82,10,15,25
45,8478891,Mason Appleton,C,WPG,28,82,9,16,25
45,8478136,Jake Middleton,D,MIN,28,82,7,18,25
45,8482087,Kaiden Guhle,D,MTL,22,82,6,19,25
45,8476917,Adam Pelech,D,NYI,30,82,5,20,25
45,8476891,Matt Grzelcyk,D,BOS,30,82,5,20,25
45,8477488,Brett Pesce,D,CAR,30,82,4,21,25
45,8473507,Jeff Petry,D,DET,37,82,3,22,25
45,8483490,Pavel Mintyukov,D,ANA,21,82,2,23,25
45,8482702,Logan Stankoven,C,DAL,21,82,17,7,24
45,8475714,Calle Jarnkrok,C,TOR,33,82,14,10,24
45,8482259,Bobby McMann,C,TOR,28,82,7,17,24
45,8476873,Mark Jankowski,C,NSH,30,82,7,17,24
45,8475455,Brenden Dillon,D,WPG,34,82,7,17,24
45,8481481,Blake Lizotte,C,LAK,27,82,7,17,24
45,8479998,Mikey Anderson,D,LAK,25,82,6,18,24
45,8477507,Nikita Zadorov,D,VAN,29,82,6,18,24
45,8482062,Cole Smith,L,NSH,29,82,5,19,24
45,8480246,Nick Perbix,D,TBL,26,82,1,23,24
45,8475790,Erik Gudbranson,D,CBJ,32,82,1,23,24
45,8481093,Rafael Harvey-Pinard,L,MTL,25,82,16,7,23
45,8477330,Dominik Kubalik,L,OTT,29,82,14,9,23
45,8478831,Kevin Stenlund,C,FLA,28,82,13,10,23
45,8478020,Michael Amadio,C,VGK,28,82,10,13,23
45,8479661,Tanner Jeannot,L,TBL,27,82,9,14,23
45,8476871,Tanner Pearson,L,MTL,32,82,9,14,23
45,8476312,Josh Manson,D,COL,33,82,9,14,23
45,8479980,Nicolas Hague,D,VGK,26,82,7,16,23
45,8478133,Jake Evans,C,MTL,28,82,6,17,23
45,8479371,Dante Fabbro,D,NSH,26,82,6,17,23
45,8480834,Ty Emberson,D,SJS,24,82,5,18,23
45,8475218,Mattias Ekholm,D,EDM,34,82,4,19,23
45,8476902,Esa Lindell,D,DAL,30,82,4,19,23
45,8481568,Alex Vlasic,D,CHI,23,82,1,22,23
45,8481704,Juuso Parssinen,C,NSH,23,82,13,9,22
45,8475343,Nic Dowd,C,WSH,34,82,9,13,22
45,8481522,Peyton Krebs,C,BUF,23,82,9,13,22
45,8477365,Connor Clifton,D,BUF,29,82,8,14,22
45,8479390,Taylor Raddysh,R,CHI,26,82,8,14,22
45,8482074,Connor Zary,C,CGY,23,82,8,14,22
45,8477505,Alexander Wennberg,C,NYR,30,82,8,14,22
45,8480336,Sean Walker,D,COL,30,82,7,15,22
45,8480074,Alexandre Texier,C,CBJ,25,82,6,16,22
45,8476463,Jonas Brodin,D,MIN,31,82,6,16,22
45,8478451,Ethan Bear,D,WSH,27,82,6,16,22
45,8478851,Alexandre Carrier,D,NSH,28,82,4,18,22
45,8478840,Will Borgen,D,SEA,28,82,4,18,22
45,8476331,Dylan DeMelo,D,WPG,31,82,3,19,22
45,8477369,Carson Soucy,D,VAN,30,82,2,20,22
45,8481605,Jackson LaCombe,D,ANA,23,82,2,20,22
45,8480807,Mattias Samuelsson,D,BUF,24,82,2,20,22
45,8482712,Oskar Olausson,R,COL,22,82,1,21,22
45,8482118,Sam Colangelo,R,ANA,23,82,18,3,21
45,8481604,Pavel Dorofeyev,L,VGK,24,82,12,9,21
45,8476897,Oskar Sundqvist,C,STL,30,82,11,10,21
45,8479359,Beck Malenstyn,L,WSH,26,82,10,11,21
45,8470621,Corey Perry,R,EDM,39,82,9,12,21
45,8482679,Matt Coronato,R,CGY,22,82,8,13,21
45,8476921,Jordan Martinook,L,CAR,32,82,8,13,21
45,8477931,Tomas Nosek,L,NJD,32,82,8,13,21
45,8478443,Brandon Carlo,D,BOS,28,82,6,15,21
45,8483482,Tristan Luneau,D,ANA,20,82,5,16,21
45,8480035,Henri Jokiharju,D,BUF,25,82,3,18,21
45,8477220,Nate Schmidt,D,WPG,33,82,3,18,21
45,8481524,Bowen Byram,D,BUF,23,82,3,18,21
45,8480172,Jan Rutta,D,SJS,34,82,1,20,21
45,8480281,Alexey Toropchenko,R,STL,25,82,13,7,20
45,8483505,Matthew Poitras,C,BOS,20,82,10,10,20
45,8470610,Zach Parise,L,COL,40,82,9,11,20
45,8473504,Cal Clutterbuck,R,NYI,37,82,9,11,20
45,8482117,Lukas Reichel,L,CHI,22,82,8,12,20
45,8476878,Zemgus Girgensons,L,BUF,30,82,8,12,20
45,8474166,Alec Martinez,D,VGK,37,82,7,13,20
45,8480871,Adam Boqvist,D,CBJ,24,82,6,14,20
45,8477499,Rasmus Ristolainen,D,PHI,30,82,6,14,20
45,8480058,Pierre-Olivier Joseph,D,PIT,25,82,5,15,20
45,8474673,TJ Brodie,D,TOR,34,82,4,16,20
45,8476879,Cody Ceci,D,EDM,31,82,4,16,20
45,8479941,Justin Danforth,R,CBJ,31,82,11,8,19
45,8479393,Noah Gregor,C,TOR,26,82,10,9,19
45,8477353,Tyler Motte,C,TBL,29,82,10,9,19
45,8482730,Brandt Clarke,D,LAK,21,82,9,10,19
45,8478569,Noel Acciari,C,PIT,33,82,9,10,19
45,8476858,Phillip Di Giuseppe,L,VAN,31,82,9,10,19
45,8480855,Jack McBain,C,ARI,24,82,8,11,19
45,8483565,Nick Blankenburg,D,CBJ,26,82,7,12,19
45,8476372,Nick Seeler,D,PHI,31,82,7,12,19
45,8483495,Simon Nemec,D,NJD,20,82,6,13,19
45,8477435,Ryan Graves,D,PIT,29,82,5,14,19
45,8476422,Mike Reilly,D,NYI,31,82,5,14,19
45,8483466,Kevin Korchinski,D,CHI,20,82,5,14,19
45,8478500,Ivan Provorov,D,CBJ,27,82,4,15,19
45,8478416,Erik Cernak,D,TBL,27,82,4,15,19
45,8479324,Ryan Lindgren,D,NYR,26,82,4,15,19
45,8474567,Zach Bogosian,D,MIN,34,82,4,15,19
45,8475690,Chris Tanev,D,DAL,35,82,3,16,19
45,8477845,Trevor van Riemsdyk,D,WSH,33,82,3,16,19
45,8481606,Jordan Spence,D,LAK,23,82,2,17,19
45,8476467,Jamie Oleksiak,D,SEA,32,82,1,18,19
45,8480980,Connor Dewar,C,TOR,25,82,11,7,18
45,8484203,Bradly Nadeau,L,CAR,19,82,10,8,18
45,8478430,Oliver Kylington,D,CGY,27,82,8,10,18
45,8477015,Connor Brown,R,EDM,30,82,7,11,18
45,8477406,Mattias Janmark,C,EDM,32,82,7,11,18
45,8476624,Barclay Goodrow,C,NYR,31,82,6,12,18
45,8482111,Justin Barron,D,MTL,23,82,6,12,18
45,8482245,Artem Zub,D,OTT,29,82,5,13,18
45,8475462,Radko Gudas,D,ANA,34,82,4,14,18
45,8476967,Brett Kulak,D,EDM,30,82,1,17,18
45,8475842,Sam Carrick,C,EDM,32,82,8,9,17
45,8481517,Brett Leason,R,ANA,25,82,7,10,17
45,8476915,Jujhar Khaira,L,MIN,30,82,7,10,17
45,8475208,Brian Dumoulin,D,SEA,33,82,6,11,17
45,8478859,Niko Mikkola,D,FLA,28,82,6,11,17
45,8480448,Parker Kelly,L,OTT,25,82,6,11,17
45,8477506,Ryan Pulock,D,NYI,30,82,5,12,17
45,8470600,Ryan Suter,D,DAL,39,82,5,12,17
45,8479983,Mario Ferraro,D,SJS,26,82,5,12,17
45,8481059,Scott Perunovich,D,STL,26,82,5,12,17
45,8479369,Andrew Peeke,D,BOS,26,82,2,15,17
45,8475324,Nick Jensen,D,WSH,34,82,1,16,17
45,8480990,Declan Chisholm,D,MIN,24,82,8,8,16
45,8474151,Ryan McDonagh,D,NSH,35,82,5,11,16
45,8476525,Colin Miller,D,WPG,32,82,4,12,16
45,8474013,Ian Cole,D,VAN,35,82,3,13,16
45,8476931,Jake McCabe,D,TOR,31,82,3,13,16
45,8477034,Jaycob Megna,D,CHI,32,82,2,14,16
45,8470604,Jeff Carter,C,PIT,39,82,8,7,15
45,8482737,Zack Bolduc,C,STL,21,82,7,8,15
45,8474009,Nick Bonino,C,NYR,36,82,6,9,15
45,8476278,Colin Blackwell,C,CHI,31,82,6,9,15
45,8482073,Braden Schneider,D,NYR,23,82,5,10,15
45,8477508,Curtis Lazar,C,NJD,29,82,5,10,15
45,8473453,Trevor Lewis,C,LAK,37,82,5,10,15
45,8477392,Hudson Fasching,R,NYI,29,82,3,12,15
45,8475179,Dmitry Kulikov,D,FLA,34,82,3,12,15
45,8480879,Jacob Bernard-Docker,D,OTT,24,82,2,13,15
45,8475762,Derek Forbort,D,BOS,32,82,2,13,15
45,8482809,Jackson Blake,R,CAR,21,82,12,2,14
45,8477335,Kyle Burroughs,D,SJS,29,82,8,6,14
45,8470966,Mark Giordano,D,TOR,41,82,5,9,14
45,8482166,Shakir Mukhamadullin,D,SJS,22,82,5,9,14
45,8476429,Scott Mayfield,D,NYI,32,82,3,11,14
45,8482470,Ilya Solovyov,D,CGY,24,82,2,12,14
45,8476822,Luke Glendening,C,TBL,35,82,7,6,13
45,8483012,Logan Morrison,C,SEA,22,82,7,6,13
45,8482177,Marat Khusnutdinov,C,MIN,22,82,7,6,13
45,8481537,Nikita Okhotiuk,D,CGY,24,82,6,7,13
45,8475177,Calvin de Haan,D,TBL,33,82,3,10,13
45,8480073,Erik Brannstrom,D,OTT,25,82,3,10,13
45,8482807,Ethan Del Mastro,D,CHI,21,82,3,10,13
45,8471677,Jack Johnson,D,COL,37,82,3,10,13
45,8478468,Jeremy Lauzon,D,NSH,27,82,1,12,13
45,8481567,Henry Thrun,D,SJS,23,82,0,13,13
45,8476473,Connor Murphy,D,CHI,31,82,5,7,12
45,8483763,Maksymilian Szuber,D,ARI,22,82,4,8,12
45,8478399,Jonas Siegenthaler,D,NJD,27,82,3,9,12
45,8475188,Brayden McNabb,D,VGK,33,82,3,9,12
45,8482666,Scott Morrow,D,CAR,22,82,3,9,12
45,8478408,Travis Dermott,D,ARI,28,82,5,6,11
45,8475279,Ben Chiarot,D,DET,33,82,4,7,11
45,8480796,Martin Fehervary,D,WSH,25,82,3,8,11
45,8479383,Boris Katchouk,L,OTT,26,82,3,8,11
45,8482858,Ryker Evans,D,SEA,23,82,3,8,11
45,8475825,Jani Hakanpää,D,DAL,32,82,2,9,11
45,8484911,Collin Graf,R,SJS,22,82,2,8,10
45,8481030,Jack St. Ivany,D,PIT,25,82,2,8,10
45,8483468,Jiri Kulich,C,BUF,20,82,2,8,10
45,8482859,Zack Ostapchuk,C,OTT,21,82,0,10,10
45,8481599,Victor Soderstrom,D,ARI,23,82,3,6,9
45,8482762,Simon Edvinsson,D,DET,21,82,1,8,9
45,8484149,Gavin Brindley,C,CBJ,20,82,1,8,9
45,8482516,Matthew Kessel,D,STL,24,82,4,4,8
45,8479291,Kevin Rooney,C,CGY,31,82,3,5,8
45,8483489,Fraser Minten,C,TOR,31,82,2,6,8
45,8482713,Mackie Samoskevich,R,FLA,22,82,1,6,7
45,8479442,Troy Stecher,D,EDM,30,82,0,7,7
45,8481578,Graeme Clarke,R,NJD,23,82,3,2,5
45,8482141,Lukas Cormier,D,VGK,22,0,0,0,0
45,8476988,Matt Benning,D,SJS,30,0,0,0,0
45,8480727,Zach Whitecloud,D,VGK,28,0,0,0,0
45,8480887,Jordan Harris,D,MTL,24,0,0,0,0
45,8478450,Parker Wotherspoon,D,BOS,27,0,0,0,0
45,8481812,Nikolai Knyzhov,D,SJS,27,0,0,0,0
45,8480001,Urho Vaakanainen,D,ANA,25,0,0,0,0
45,8482176,Wyatt Kaiser,D,CHI,22,0,0,0,0
45,8481122,Simon Benoit,D,TOR,26,0,0,0,0
45,8476441,Joel Edmundson,D,TOR,31,0,0,0,0
45,8480884,Calen Addison,D,SJS,24,0,0,0,0
45,8482511,Mason Lohrei,D,BOS,23,0,0,0,0
45,8482192,Isaak Phillips,D,CHI,23,0,0,0,0
45,8480950,Ilya Lyubushkin,D,TOR,30,0,0,0,0
45,8474031,Kevin Shattenkirk,D,BOS,35,0,0,0,0
45,8475718,Justin Holl,D,DET,32,0,0,0,0
45,8479402,Jake Bean,D,CBJ,26,0,0,0,0
45,8474602,Justin Schultz,D,SEA,34,0,0,0,0
45,8477950,Tony DeAngelo,D,CAR,29,0,0,0,0
45,8481743,Marc Del Gaizo,D,NSH,25,0,0,0,0
45,8481527,Kaedan Korczak,D,VGK,23,0,0,0,0
45,8480192,Johnathan Kovacevic,D,MTL,27,0,0,0,0
45,8476874,Olli Maatta,D,DET,30,0,0,0,0
45,8482144,Jack Thompson,D,SJS,22,0,0,0,0
45,8480222,Sebastian Aho,D,NYI,28,0,0,0,0
45,8479458,Nikita Zaitsev,D,CHI,33,0,0,0,0
45,8471709,Marc-Edouard Vlasic,D,SJS,37,0,0,0,0
45,8482929,Emil Lilleberg,D,TBL,23,0,0,0,0
45,8477018,Ben Hutton,D,VGK,31,0,0,0,0
45,8481056,Spencer Stastney,D,NSH,24,0,0,0,0
45,8481593,Jayden Struble,D,MTL,23,0,0,0,0
45,8479982,Conor Timmins,D,TOR,26,0,0,0,0
45,8474090,Brendan Smith,D,NJD,35,0,0,0,0
45,8482964,Arber Xhekaj,D,MTL,23,0,0,0,0
45,8480891,Michael Kesselring,D,ARI,24,0,0,0,0
45,8477938,Haydn Fleury,D,TBL,28,0,0,0,0
45,8481806,Louis Crevier,D,CHI,23,0,0,0,0
45,8471274,Alex Goligoski,D,MIN,39,0,0,0,0
45,8481600,Tobias Bjornfot,D,FLA,23,0,0,0,0
45,8475797,Jarred Tinordi,D,CHI,32,0,0,0,0
45,8481521,Ronnie Attard,D,PHI,25,0,0,0,0
45,8474612,Travis Hamonic,D,OTT,34,0,0,0,0
45,8479576,Vincent Desharnais,D,EDM,28,0,0,0,0
45,8480049,Dylan Samberg,D,WPG,25,0,0,0,0
45,8483619,Filip Roos,D,CHI,25,0,0,0,0
45,8474568,Luke Schenn,D,NSH,35,0,0,0,0
45,8480184,Gustav Lindstrom,D,ANA,26,0,0,0,0
45,8480070,Ian Mitchell,D,BOS,25,0,0,0,0
45,8480196,Jacob Bryson,D,BUF,27,0,0,0,0
45,8471686,Marc Staal,D,PHI,37,0,0,0,0
45,8477467,Gustav Olofsson,D,SEA,30,0,0,0,0
45,8478970,Jalen Chatfield,D,CAR,28,0,0,0,0
45,8479348,Kale Clague,D,BUF,26,0,0,0,0
45,8473446,Erik Johnson,D,PHI,36,0,0,0,0
45,8477462,Robert Hagg,D,ANA,29,0,0,0,0
45,8478454,Noah Juulsen,D,VAN,27,0,0,0,0
45,8477384,Josh Brown,D,ARI,30,0,0,0,0
45,8481708,Zac Jones,D,NYR,24,0,0,0,0
45,8481167,Brayden Pachal,D,CGY,25,0,0,0,0
45,8482067,Connor Mackey,D,NYR,28,0,0,0,0
45,8483460,David Jiricek,D,CBJ,21,0,0,0,0
45,8481701,Santeri Hatakka,D,NJD,23,0,0,0,0
45,8478021,William Lagesson,D,ANA,28,0,0,0,0
45,8477851,Jordan Oesterle,D,CGY,32,0,0,0,0
45,8478452,Caleb Jones,D,COL,27,0,0,0,0
45,8479984,Cal Foote,D,NJD,26,0,0,0,0
45,8479639,Dylan Coghlan,D,CAR,26,0,0,0,0
45,8480874,Adam Ginning,D,PHI,24,0,0,0,0
45,8479321,Lucas Johansen,D,WSH,27,0,0,0,0
45,8480878,Nils Lundkvist,D,DAL,24,0,0,0,0
45,8482165,Yan Kuznetsov,D,CGY,22,0,0,0,0
45,8484258,Sam Malinski,D,COL,26,0,0,0,0
45,8480157,Calle Rosen,D,STL,30,0,0,0,0
45,8484304,Uvis Balinskis,D,FLA,28,0,0,0,0
45,8479985,Cale Fleury,D,SEA,26,0,0,0,0
45,8479378,Logan Stanley,D,WPG,26,0,0,0,0
45,8477541,Dakota Mermis,D,MIN,30,0,0,0,0
45,8481609,Vladislav Kolyachonok,D,ARI,23,0,0,0,0
45,8480823,Alexander Alexeyev,D,WSH,25,0,0,0,0
45,8481679,Maxence Guenette,D,OTT,23,0,0,0,0
45,8481564,Ryan Johnson,D,BUF,23,0,0,0,0
45,8479376,Victor Mete,D,PHI,26,0,0,0,0
45,8484254,Akito Hirose,D,VAN,25,0,0,0,0
45,8482660,Kent Johnson,C,CBJ,22,0,0,0,0
45,8482149,Cole Perfetti,C,WPG,22,0,0,0,0
45,8477987,Ryan Donato,C,CHI,28,0,0,0,0
45,8475755,Alexander Petrovic,D,DAL,32,0,0,0,0
45,8477810,Joel Hanley,D,CGY,33,0,0,0,0
45,8474145,Robert Bortuzzo,D,NYI,35,0,0,0,0
45,8481161,Jake Christiansen,D,CBJ,25,0,0,0,0
45,8476884,Derrick Pouliot,D,DAL,30,0,0,0,0
45,8481716,Dmitri Voronkov,L,CBJ,24,0,0,0,0
45,8480084,Nick DeSimone,D,NJD,30,0,0,0,0
45,8475750,Jon Merrill,D,MIN,32,0,0,0,0
45,8479315,Joey Anderson,R,CHI,26,0,0,0,0
45,8478011,Louie Belpedio,D,PHI,28,0,0,0,0
45,8482451,Mikael Pyyhtia,L,CBJ,23,0,0,0,0
45,8481541,Samuel Bolduc,D,NYI,24,0,0,0,0
45,8482126,Emil Andrae,D,PHI,31,0,0,0,0
45,8474618,Marco Scandella,D,STL,34,0,0,0,0
45,8477244,Chad Ruhwedel,D,NYR,34,0,0,0,0
45,8477971,Andreas Englund,D,LAK,28,0,0,0,0
45,8480829,Jesperi Kotkaniemi,C,CAR,24,0,0,0,0
45,8479372,Josh Mahura,D,FLA,26,0,0,0,0
45,8482095,Tyler Kleven,D,OTT,22,0,0,0,0
45,8481719,Maxwell Crozier,D,TBL,24,0,0,0,0
45,8475855,Jesper Fast,R,CAR,33,0,0,0,0
45,8480848,Ty Dellandrea,C,DAL,24,0,0,0,0
45,8475193,Tomas Tatar,L,SEA,34,0,0,0,0
45,8476889,Radek Faksa,C,DAL,30,0,0,0,0
45,8478495,Denis Gurianov,R,PHI,27,0,0,0,0
45,8480216,Jacob Peterson,C,SJS,25,0,0,0,0
45,8480252,Cole Guttman,C,CHI,25,0,0,0,0
45,8479026,Philippe Myers,D,TBL,27,0,0,0,0
45,8481006,Tyler Tucker,D,STL,24,0,0,0,0
45,8481032,Paul Cotter,C,VGK,25,0,0,0,0
45,8481577,Philip Tomasino,C,NSH,23,0,0,0,0
45,8476918,Jimmy Vesey,L,NYR,31,0,0,0,0
45,8479320,Max Lajoie,D,TOR,27,0,0,0,0
45,8478017,Mark Friedman,D,VAN,29,0,0,0,0
45,8481754,Nikita Nesterenko,C,ANA,23,0,0,0,0
45,8483407,Brandon Scanlin,D,NYR,25,0,0,0,0
45,8482659,Josh Doan,R,ARI,22,0,0,0,0
45,8477446,Michael McCarron,R,NSH,29,0,0,0,0
45,8477903,Garnet Hathaway,R,PHI,33,0,0,0,0
45,8482153,Brendan Brisson,C,VGK,23,0,0,0,0
45,8483546,Marshall Rifai,D,TOR,26,0,0,0,0
45,8484287,Cole McWard,D,VAN,23,0,0,0,0
45,8478854,Ryan Shea,D,PIT,27,0,0,0,0
45,8481585,Egor Afanasyev,L,NSH,23,0,0,0,0
45,8483398,Declan Carlile,D,TBL,31,0,0,0,0
45,8478502,Dennis Gilbert,D,CGY,28,0,0,0,0
45,8482749,Joshua Roy,R,MTL,21,0,0,0,0
45,8481598,Philip Broberg,D,EDM,23,0,0,0,0
45,8480835,Jack Drury,C,CAR,24,0,0,0,0
45,8480748,Kiefer Sherwood,L,NSH,29,0,0,0,0
45,8476934,Brock McGinn,L,ANA,30,0,0,0,0
45,8480870,Bo Groulx,C,ANA,24,0,0,0,0
45,8479368,Max Jones,L,ANA,26,0,0,0,0
45,8478099,Kevin Labanc,R,SJS,29,0,0,0,0
45,8478067,Oskar Lindblom,L,SJS,28,0,0,0,0
45,8476393,Nick Cousins,C,FLA,31,0,0,0,0
45,8483395,Arshdeep Bains,L,VAN,23,0,0,0,0
45,8480762,Eric Robinson,L,BUF,29,0,0,0,0
45,8479439,Jacob MacDonald,D,SJS,31,0,0,0,0
45,8476474,Stefan Noesen,R,CAR,31,0,0,0,0
45,8482787,Nikita Chibrikov,R,WPG,31,0,0,0,0
45,8478432,Christian Fischer,R,DET,27,0,0,0,0
45,8477979,Nicolas Aube-Kubel,R,WSH,28,0,0,0,0
45,8481789,Tye Kartye,L,SEA,23,0,0,0,0
45,8479330,Brandon Gignac,C,MTL,27,0,0,0,0
45,8480075,Cameron Crotty,D,ARI,25,0,0,0,0
45,8473473,Milan Lucic,L,BOS,36,0,0,0,0
45,8482094,Daemon Hunt,D,MIN,22,0,0,0,0
45,8481206,John Ludvig,D,PIT,24,0,0,0,0
45,8483630,Pavol Regenda,L,ANA,25,0,0,0,0
45,8481617,Vasily Podkolzin,R,VAN,23,0,0,0,0
45,8480306,Grant Hutton,D,NYI,29,0,0,0,0
45,8480995,Pontus Holmberg,R,TOR,25,0,0,0,0
45,8482148,Hendrix Lapierre,C,WSH,22,0,0,0,0
45,8477478,William Carrier,L,VGK,30,0,0,0,0
45,8480003,Jesper Boqvist,C,BOS,26,0,0,0,0
45,8482172,Landon Slaggert,L,CHI,22,0,0,0,0
45,8480789,Oliver Wahlstrom,R,NYI,24,0,0,0,0
45,8474062,Riley Nash,C,NYR,35,0,0,0,0
45,8480021,Jack Studnicka,C,SJS,25,0,0,0,0
45,8480025,MacKenzie Entwistle,R,CHI,25,0,0,0,0
45,8481582,Nicholas Robertson,L,TOR,23,0,0,0,0
45,8476867,Brendan Gaunce,C,CBJ,30,0,0,0,0
45,8479619,Michael Carcone,L,ARI,28,0,0,0,0
45,8479370,Tyson Jost,C,BUF,26,0,0,0,0
45,8479671,Mathieu Olivier,R,CBJ,27,0,0,0,0
45,8476994,Vinnie Hinostroza,C,PIT,30,0,0,0,0
45,8482070,Mitchell Chaffee,R,TBL,26,0,0,0,0
45,8477473,Justin Bailey,R,SJS,29,0,0,0,0
45,8479344,Jesse Puljujarvi,R,PIT,26,0,0,0,0
45,8480205,Emil Bemstrom,C,PIT,25,0,0,0,0
45,8479718,Alex Barré-Boulet,C,TBL,27,0,0,0,0
45,8482061,Brandon Biro,L,BUF,26,0,0,0,0
45,8479638,Justin Brazeau,R,BOS,26,0,0,0,0
45,8474040,Sam Gagner,C,EDM,35,0,0,0,0
45,8477846,Ryan Carpenter,C,SJS,33,0,0,0,0
45,8482077,Dylan Holloway,L,EDM,23,0,0,0,0
45,8482157,Will Cuylle,L,NYR,22,0,0,0,0
45,8480007,Jonas Rondbjerg,R,VGK,25,0,0,0,0
45,8478874,Adam Gaudette,C,STL,28,0,0,0,0
45,8478434,Keegan Kolesar,R,VGK,27,0,0,0,0
45,8480441,Trey Fix-Wolansky,R,CBJ,25,0,0,0,0
45,8479994,Jaret Anderson-Dolan,C,NSH,25,0,0,0,0
45,8483567,Georgii Merkulov,C,BOS,24,0,0,0,0
45,8477380,Jonny Brodzinski,C,NYR,31,0,0,0,0
45,8482201,Gage Goncalves,C,TBL,23,0,0,0,0
45,8478211,Dryden Hunt,L,CGY,29,0,0,0,0
45,8471699,Andrew Cogliano,C,COL,37,0,0,0,0
45,8479421,Jacob Moverare,D,LAK,26,0,0,0,0
45,8478881,Brett Seney,L,CHI,28,0,0,0,0
45,8477464,Nic Petan,C,MIN,29,0,0,0,0
45,8475958,Michael Sgarbossa,C,WSH,32,0,0,0,0
45,8481147,Reese Johnson,C,CHI,26,0,0,0,0
45,8479336,Carl Grundstrom,R,LAK,27,0,0,0,0
45,8480853,Liam Foudy,C,NSH,24,0,0,0,0
45,8479522,Hardy Haman Aktell,D,WSH,26,0,0,0,0
45,8481462,Mason Morelli,L,VGK,28,0,0,0,0
45,8482102,Vasily Ponomarev,C,CAR,22,0,0,0,0
45,8480844,Grigori Denisenko,L,VGK,24,0,0,0,0
45,8479944,Zach Aston-Reese,C,DET,30,0,0,0,0
45,8482784,Zach Dean,C,STL,21,0,0,0,0
45,8479419,Brett Murray,L,BUF,26,0,0,0,0
45,8479520,Brandon Duhaime,R,COL,27,0,0,0,0
45,8477573,Nathan Walker,L,STL,30,0,0,0,0
45,8478078,Rourke Chartier,C,OTT,28,0,0,0,0
45,8475795,Dylan McIlrath,D,WSH,32,0,0,0,0
45,8482496,Nils Aman,C,VAN,24,0,0,0,0
45,8480289,Morgan Barron,C,WPG,26,0,0,0,0
45,8481751,Lukas Rousek,R,BUF,25,0,0,0,0
45,8480011,Klim Kostin,C,SJS,25,0,0,0,0
45,8481556,John Beecher,C,BOS,23,0,0,0,0
45,8475278,Byron Froese,C,VGK,33,0,0,0,0
45,8475225,Craig Smith,C,DAL,35,0,0,0,0
45,8484326,Patrik Koch,D,ARI,28,0,0,0,0
45,8477930,Pierre-Edouard Bellemare,L,SEA,39,0,0,0,0
45,8478409,Anthony Richard,C,BOS,28,0,0,0,0
45,8481024,Linus Karlsson,C,VAN,25,0,0,0,0
45,8479986,Kole Lind,R,SEA,26,0,0,0,0
45,8479414,Nathan Bastian,R,NJD,27,0,0,0,0
45,8479362,Riley Tufte,L,COL,26,0,0,0,0
45,8481058,Jesse Ylönen,R,MTL,25,0,0,0,0
45,8482476,Emil Heineman,L,MTL,23,0,0,0,0
45,8482861,Vincent Iorio,D,WSH,22,0,0,0,0
45,8483432,Luca Del Bel Belluz,C,CBJ,31,0,0,0,0
45,8482744,James Malatesta,L,CBJ,21,0,0,0,0
45,8477887,Patrick Brown,C,BOS,32,0,0,0,0
45,8478585,Derek Ryan,C,EDM,38,0,0,0,0
45,8481441,Joe Snively,C,WSH,28,0,0,0,0
45,8481592,Jakob Pelletier,L,CGY,23,0,0,0,0
45,8482634,Alex Steeves,C,TOR,25,0,0,0,0
45,8477126,Jayson Megna,C,BOS,34,0,0,0,0
45,8475752,Tyler Pitlick,C,NYR,33,0,0,0,0
45,8480008,Adam Ruzicka,C,ARI,25,0,0,0,0
45,8481065,Angus Crookshank,L,OTT,25,0,0,0,0
45,8479547,Matthew Phillips,R,WSH,26,0,0,0,0
45,8480226,Marián Studenic,R,SEA,26,0,0,0,0
45,8481237,Kyle MacLean,C,NYI,25,0,0,0,0
45,8475413,Justin Dowling,C,NJD,34,0,0,0,0
45,8481641,Joel Kiviranta,L,COL,28,0,0,0,0
45,8478104,Sammy Blais,L,STL,28,0,0,0,0
45,8477454,Adam Erne,L,EDM,29,0,0,0,0
45,8481518,Nolan Foote,L,NJD,24,0,0,0,0
45,8480245,Olle Lycksell,R,PHI,25,0,0,0,0
45,8483570,Ben Meyers,C,ANA,26,0,0,0,0
45,8480776,Sheldon Rempal,R,VGK,29,0,0,0,0
45,8483920,Pierrick Dube,R,WSH,23,0,0,0,0
45,8480267,Sammy Walker,C,MIN,25,0,0,0,0
45,8482747,Brennan Othmann,L,NYR,21,0,0,0,0
45,8479991,Jake Leschyshyn,C,NYR,25,0,0,0,0
45,8478400,Colin White,C,MTL,27,0,0,0,0
45,8479328,Julien Gauthier,R,NYI,27,0,0,0,0
45,8484325,Waltteri Merela,C,TBL,26,0,0,0,0
45,8479066,Ryan Lomberg,L,FLA,30,0,0,0,0
45,8477070,Liam O'Brien,C,ARI,30,0,0,0,0
45,8478146,Matthew Highmore,C,OTT,28,0,0,0,0
45,8478028,Fredrik Olofsson,L,COL,28,0,0,0,0
45,8480880,Jakub Lauko,C,BOS,24,0,0,0,0
45,8479968,Vinni Lettieri,C,MIN,29,0,0,0,0
45,8474709,Matt Martin,L,NYI,35,0,0,0,0
45,8480845,Rasmus Kupari,C,WPG,24,0,0,0,0
45,8481550,Adam Beckman,L,MIN,23,0,0,0,0
45,8481422,Jacob Lucchini,C,MIN,29,0,0,0,0
45,8477401,John Hayden,C,SEA,29,0,0,0,0
45,8478904,Steven Lorentz,C,FLA,28,0,0,0,0
45,8482088,Justin Sourdif,R,FLA,22,0,0,0,0
45,8482751,Ryan Winterton,C,SEA,21,0,0,0,0
45,8482241,Radim Zohorna,L,PIT,28,0,0,0,0
45,8481690,Tyler Angle,C,CBJ,24,0,0,0,0
45,8476952,Dominic Toninato,C,WPG,30,0,0,0,0
45,8476919,Chris Tierney,C,NJD,30,0,0,0,0
45,8480032,Shane Bowers,C,NJD,25,0,0,0,0
45,8484314,Jiri Smejkal,L,OTT,28,0,0,0,0
45,8481239,Samuel Fagemo,L,LAK,24,0,0,0,0
45,8481532,Alex Turcotte,C,LAK,23,0,0,0,0
45,8481019,David Gustafsson,C,WPG,24,0,0,0,0
45,8478477,Mitchell Stephens,C,MTL,27,0,0,0,0
45,8479546,Oskar Steen,C,BOS,26,0,0,0,0
45,8480292,Carson Meyer,R,CBJ,27,0,0,0,0
45,8478446,Glenn Gawdin,C,ANA,27,0,0,0,0
45,8483531,Brian Halonen,L,NJD,25,0,0,0,0
45,8477149,Scott Sabourin,R,SJS,32,0,0,0,0
45,8479972,Mason Shaw,C,MIN,26,0,0,0,0
45,8480890,Jan Jenik,R,ARI,24,0,0,0,0
45,8478051,Max Willman,C,NJD,29,0,0,0,0
45,8480851,Akil Thomas,C,LAK,24,0,0,0,0
45,8482765,Isak Rosen,R,BUF,21,0,0,0,0
45,8478421,A.J. Greer,L,CGY,28,0,0,0,0
45,8478512,Austin Czarnik,C,DET,32,0,0,0,0
45,8479536,Axel Jonsson-Fjallby,L,WPG,26,0,0,0,0
45,8477320,Anton Blidh,L,NYR,29,0,0,0,0
45,8481543,Nikita Alexandrov,C,STL,24,0,0,0,0
45,8475235,Nicolas Deslauriers,L,PHI,33,0,0,0,0
45,8481070,Hugh McGing,L,STL,26,0,0,0,0
45,8480836,Jonathan Gruden,C,PIT,24,0,0,0,0
45,8481591,Sam Poulin,R,PIT,23,0,0,0,0
45,8477962,Brendan Lemieux,L,CAR,28,0,0,0,0
45,8483401,Marc Johnstone,R,PIT,28,0,0,0,0
45,8482250,Callahan Burke,C,CAR,27,0,0,0,0
45,8481726,Adam Edstrom,C,NYR,24,0,0,0,0
45,8471817,Ryan Reaves,R,TOR,37,0,0,0,0
45,8479587,Rhett Gardner,C,PHI,28,0,0,0,0
45,8475766,Austin Watson,L,TBL,32,0,0,0,0
45,8479367,William Lockwood,R,FLA,26,0,0,0,0
45,8478424,Jansen Harkins,C,PIT,27,0,0,0,0
45,8476913,Devin Shore,C,SEA,30,0,0,0,0
45,8482652,Walker Duehr,R,CGY,27,0,0,0,0
45,8477527,Ross Johnston,L,ANA,30,0,0,0,0
45,8481077,John Leonard,L,ARI,26,0,0,0,0
45,8483549,Lucas Condotta,L,MTL,27,0,0,0,0
45,8480468,James Hamblin,L,EDM,25,0,0,0,0
45,8476907,Mackenzie MacEachern,L,STL,30,0,0,0,0
45,8479543,Michael Pezzetta,L,MTL,26,0,0,0,0
45,8480355,Mark Kastelic,C,OTT,25,0,0,0,0
45,8482162,Roby Jarventie,L,OTT,22,0,0,0,0
45,8479772,Zack MacEwen,R,OTT,28,0,0,0,0
45,8483597,Milos Kelemen,L,ARI,25,0,0,0,0
45,8479379,Givani Smith,R,SJS,26,0,0,0,0
45,8481655,Cole Schwindt,R,CGY,23,0,0,0,0
45,8479981,Jonah Gadjovich,L,FLA,26,0,0,0,0
45,8482147,Jean-Luc Foudy,C,COL,22,0,0,0,0
45,8484255,Jason Polin,R,COL,25,0,0,0,0
45,8477993,Justin Kirkland,C,ARI,28,0,0,0,0
45,8479249,Andrew Poturalski,C,SEA,30,0,0,0,0
45,8482197,Adam Raska,R,MIN,23,0,0,0,0
45,8475780,Chris Wagner,R,COL,33,0,0,0,0
45,8479533,Joona Koppanen,L,PIT,26,0,0,0,0
45,8481534,Raphael Lavoie,C,EDM,24,0,0,0,0
45,8484321,Nikolas Matinpalo,D,OTT,26,0,0,0,0
45,8481043,Cole Koepke,L,TBL,26,0,0,0,0
45,8476323,Max McCormick,L,SEA,32,0,0,0,0
45,8483609,Adam Klapka,R,CGY,24,0,0,0,0
45,8483512,Matt Savoie,C,BUF,20,0,0,0,0
45,8484259,Ondrej Pavel,C,COL,31,0,0,0,0
45,8478147,Bokondji Imama,L,OTT,28,0,0,0,0
45,8482460,Matt Rempe,C,NYR,22,0,0,0,0
45,8477073,Kurtis MacDermid,L,NJD,30,0,0,0,0
45,8480274,Philip Kemp,D,EDM,25,0,0,0,0
45,8478956,Samuel Laberge,L,NJD,27,0,0,0,0
45,8483045,Cameron Butler,R,CBJ,31,0,0,0,0
46,8478402,Connor McDavid,C,EDM,27,82,33,92,125
46,8477956,David Pastrnak,R,BOS,28,82,48,56,104
46,8471675,Sidney Crosby,C,PIT,37,82,43,61,104
46,8478550,Artemi Panarin,L,NYR,33,82,46,57,103
46,8477404,Jake Guentzel,C,CAR,30,82,45,55,100
46,8479318,Auston Matthews,C,TOR,27,82,54,45,99
46,8481559,Jack Hughes,C,NJD,23,82,35,63,98
46,8477934,Leon Draisaitl,C,EDM,29,82,34,64,98
46,8474600,Roman Josi,D,NSH,34,82,23,74,97
46,8476887,Filip Forsberg,L,NSH,30,82,46,50,96
46,8478864,Kirill Kaprizov,L,MIN,27,82,43,53,96
46,8480069,Cale Makar,D,COL,26,82,27,69,96
46,8482116,Tim Stützle,C,OTT,22,82,30,65,95
46,8476453,Nikita Kucherov,R,TBL,31,82,33,61,94
46,8476468,J.T. Miller,C,VAN,31,82,35,58,93
46,8477492,Nathan MacKinnon,C,COL,29,82,31,60,91
46,8480002,Nico Hischier,C,NJD,25,82,39,50,89
46,8478420,Mikko Rantanen,R,COL,28,82,53,31,84
46,8478439,Travis Konecny,R,PHI,27,82,40,44,84
46,8480800,Quinn Hughes,D,VAN,25,82,12,71,83
46,8476459,Mika Zibanejad,C,NYR,31,82,32,50,82
46,8474564,Steven Stamkos,C,TBL,34,82,28,53,81
46,8475172,Nazem Kadri,C,CGY,34,82,26,55,81
46,8478440,Dylan Strome,C,WSH,27,82,42,38,80
46,8479385,Jordan Kyrou,C,STL,26,82,37,43,80
46,8479343,Clayton Keller,R,ARI,26,82,36,44,80
46,8477493,Aleksander Barkov,C,FLA,29,82,35,45,80
46,8478010,Brayden Point,C,TBL,28,82,34,46,80
46,8479314,Matthew Tkachuk,L,FLA,27,82,34,46,80
46,8480012,Elias Pettersson,C,VAN,26,82,27,53,80
46,8479323,Adam Fox,D,NYR,26,82,15,65,80
46,8471215,Evgeni Malkin,C,PIT,38,82,31,46,77
46,8475784,Jeff Skinner,C,BUF,32,82,38,38,76
46,8478444,Brock Boeser,R,VAN,27,82,40,35,75
46,8473419,Brad Marchand,L,BOS,36,82,26,49,75
46,8477942,Kevin Fiala,L,LAK,28,82,29,45,74
46,8480208,Drake Batherson,R,OTT,26,82,26,48,74
46,8471214,Alex Ovechkin,L,WSH,39,82,37,36,73
46,8477933,Sam Reinhart,C,FLA,29,82,29,44,73
46,8478493,Joel Eriksson Ek,C,MIN,27,82,37,35,72
46,8480830,Andrei Svechnikov,R,CAR,24,82,21,51,72
46,8480027,Jason Robertson,L,DAL,25,82,28,43,71
46,8478427,Sebastian Aho,C,CAR,27,82,28,42,70
46,8475166,John Tavares,C,TOR,34,82,36,33,69
46,8477939,William Nylander,R,TOR,28,82,27,42,69
46,8476460,Mark Scheifele,C,WPG,31,82,24,45,69
46,8478975,Mason Marchment,L,DAL,29,82,22,47,69
46,8479337,Alex DeBrincat,R,DET,27,82,30,38,68
46,8478401,Pavel Zacha,C,BOS,27,82,24,44,68
46,8477949,Alex Tuch,R,BUF,28,82,16,52,68
46,8477946,Dylan Larkin,C,DET,28,82,27,40,67
46,8478047,Michael Bunting,L,PIT,29,82,23,43,66
46,8481523,Kirby Dach,C,MTL,23,82,7,59,66
46,8475184,Chris Kreider,L,NYR,33,82,38,27,65
46,8475786,Zach Hyman,L,EDM,32,82,36,29,65
46,8480018,Nick Suzuki,C,MTL,25,82,36,29,65
46,8478873,Troy Terry,R,ANA,27,82,31,34,65
46,8475754,Brock Nelson,C,NYI,33,82,30,35,65
46,8477501,Valeri Nichushkin,R,COL,29,82,39,25,64
46,8475726,Tyler Toffoli,C,WPG,32,82,28,36,64
46,8477496,Elias Lindholm,C,VAN,30,82,24,40,64
46,8474141,Patrick Kane,R,DET,36,82,22,42,64
46,8480078,Filip Chytil,C,NYR,25,82,22,42,64
46,8478445,Mathew Barzal,C,NYI,27,82,21,43,64
46,8475158,Ryan O'Reilly,C,NSH,33,82,32,31,63
46,8479420,Tage Thompson,C,BUF,27,82,29,34,63
46,8477951,Nick Schmaltz,C,ARI,28,82,24,39,63
46,8480839,Rasmus Dahlin,D,BUF,24,82,14,49,63
46,8482740,Wyatt Johnston,C,DAL,21,82,39,23,62
46,8477960,Adrian Kempe,R,LAK,28,82,32,30,62
46,8476389,Vincent Trocheck,C,NYR,31,82,23,39,62
46,8475798,Mikael Granlund,C,SJS,32,82,18,44,62
46,8477447,Shea Theodore,D,VGK,29,82,8,54,62
46,8475810,Bryan Rust,R,PIT,32,82,33,28,61
46,8480801,Brady Tkachuk,L,OTT,25,82,29,32,61
46,8470794,Joe Pavelski,C,DAL,40,82,29,32,61
46,8477402,Pavel Buchnevich,L,STL,29,82,24,37,61
46,8475913,Mark Stone,R,VGK,32,82,24,37,61
46,8478449,Roope Hintz,C,DAL,28,82,22,39,61
46,8477495,Seth Jones,D,CHI,30,82,10,51,61
46,8479407,Jesper Bratt,L,NJD,26,82,26,34,60
46,8476454,Ryan Nugent-Hopkins,C,EDM,31,82,20,40,60
46,8474150,Mikael Backlund,C,CGY,35,82,17,43,60
46,8476462,Dougie Hamilton,D,NJD,31,82,15,45,60
46,8476456,Jonathan Huberdeau,C,CGY,31,82,13,47,60
46,8478414,Timo Meier,R,NJD,28,82,29,30,59
46,8479542,Brandon Hagel,L,TBL,26,82,25,34,59
46,8482078,Lucas Raymond,L,DET,22,82,23,36,59
46,8482684,Luke Hughes,D,NJD,21,82,21,38,59
46,8480023,Robert Thomas,C,STL,25,82,18,41,59
46,8473512,Claude Giroux,R,OTT,36,82,18,41,59
46,8478042,Viktor Arvidsson,R,LAK,31,82,28,30,58
46,8481557,Matt Boldy,L,MIN,23,82,26,32,58
46,8474679,Gustav Nyquist,C,NSH,35,82,21,37,58
46,8477932,Aaron Ekblad,D,FLA,28,82,16,42,58
46,8478407,Vince Dunn,D,SEA,28,82,11,47,58
46,8474578,Erik Karlsson,D,PIT,34,82,7,51,58
46,8477500,Bo Horvat,C,NYI,29,82,36,21,57
46,8480064,Josh Norris,C,OTT,25,82,32,25,57
46,8478438,Tommy Novak,C,NSH,27,82,21,36,57
46,8480803,Evan Bouchard,D,EDM,25,82,11,46,57
46,8477409,Carter Verhaeghe,C,FLA,29,82,26,30,56
46,8476880,Tom Wilson,R,WSH,30,82,19,37,56
46,8480036,Miro Heiskanen,D,DAL,25,82,12,44,56
46,8476346,Johnny Gaudreau,L,CBJ,31,82,12,44,56
46,8480865,Noah Dobson,D,NYI,24,82,6,50,56
46,8478398,Kyle Connor,L,WPG,28,82,31,24,55
46,8476399,Blake Coleman,C,CGY,33,82,30,25,55
46,8477935,Sam Bennett,C,FLA,28,82,27,28,55
46,8477416,Oliver Bjorkstrand,R,SEA,29,82,23,32,55
46,8477940,Nikolaj Ehlers,L,WPG,28,82,21,34,55
46,8475765,Vladimir Tarasenko,R,FLA,33,82,16,39,55
46,8476905,Chandler Stephenson,C,VGK,30,82,14,41,55
46,8475167,Victor Hedman,D,TBL,34,82,13,42,55
46,8478474,Lawson Crouse,L,ARI,27,82,29,25,54
46,8476479,Phillip Danault,C,LAK,31,82,24,30,54
46,8473994,Jamie Benn,L,DAL,35,82,22,32,54
46,8475191,Reilly Smith,R,PIT,33,82,20,34,54
46,8474590,John Carlson,D,WSH,34,82,12,42,54
46,8478498,Jake DeBrusk,L,BOS,28,82,26,27,53
46,8482093,Seth Jarvis,C,CAR,22,82,18,35,53
46,8479345,Jakob Chychrun,D,OTT,26,82,16,37,53
46,8471685,Anze Kopitar,C,LAK,37,82,13,40,53
46,8476483,Rickard Rakell,R,PIT,31,82,26,26,52
46,8481596,Shane Pinto,C,OTT,24,82,21,31,52
46,8480798,Philipp Kurashev,C,CHI,25,82,20,32,52
46,8477504,Josh Morrissey,D,WPG,29,82,15,37,52
46,8479325,Charlie McAvoy,D,BOS,27,82,9,43,52
46,8479410,Mikhail Sergachev,D,TBL,26,82,9,43,52
46,8476539,Jonathan Marchessault,R,VGK,34,82,27,24,51
46,8475169,Evander Kane,L,EDM,33,82,27,24,51
46,8478403,Jack Eichel,C,VGK,28,82,26,25,51
46,8479400,Pierre-Luc Dubois,L,LAK,26,82,22,29,51
46,8477451,Ryan Hartman,R,MIN,30,82,22,29,51
46,8479675,Trevor Moore,L,LAK,29,82,22,29,51
46,8482745,Mason McTavish,C,ANA,21,82,18,33,51
46,8475692,Mats Zuccarello,R,MIN,37,82,14,37,51
46,8474586,Jordan Eberle,R,SEA,34,82,14,37,51
46,8481699,Aku Raty,R,ARI,23,82,1,50,51
46,8477476,Artturi Lehkonen,L,COL,29,82,21,29,50
46,8481533,Trevor Zegras,C,ANA,23,82,17,33,50
46,8476875,Mike Matheson,D,MTL,30,82,15,35,50
46,8483524,Shane Wright,C,SEA,20,82,38,11,49
46,8477952,Robby Fabbri,C,DET,28,82,28,21,49
46,8483808,Andrei Kuzmenko,L,CGY,28,82,27,22,49
46,8481540,Cole Caufield,R,MTL,23,82,25,24,49
46,8474157,Max Pacioretty,L,WSH,36,82,24,25,49
46,8482665,Matty Beniers,C,SEA,22,82,23,26,49
46,8477479,Tyler Bertuzzi,L,TOR,29,82,21,28,49
46,8477497,Sean Monahan,C,WPG,30,82,21,28,49
46,8476906,Shayne Gostisbehere,D,DET,31,82,11,38,49
46,8478038,Devon Toews,D,COL,30,82,6,43,49
46,8481068,Yegor Sharangovich,C,CGY,26,82,27,21,48
46,8478856,Conor Garland,R,VAN,28,82,25,23,48
46,8476882,Teuvo Teravainen,L,CAR,30,82,22,26,48
46,8481528,Dylan Cozens,C,BUF,23,82,21,27,48
46,8478519,Anthony Cirelli,C,TBL,27,82,21,27,48
46,8475168,Matt Duchene,C,DAL,33,82,17,31,48
46,8476792,Torey Krug,D,STL,33,82,13,35,48
46,8477444,Andre Burakovsky,L,SEA,29,82,12,36,48
46,8477503,Max Domi,C,TOR,29,82,10,38,48
46,8477947,Sonny Milano,L,WSH,28,82,21,26,47
46,8476448,William Karlsson,C,VGK,31,82,20,27,47
46,8477964,Ivan Barbashev,C,VGK,29,82,20,27,47
46,8480028,Morgan Frost,C,PHI,25,82,19,28,47
46,8480015,Owen Tippett,R,PHI,25,82,17,30,47
46,8477986,Brandon Montour,D,FLA,30,82,16,31,47
46,8479999,Casey Mittelstadt,C,COL,26,82,15,32,47
46,8480031,Maxime Comtois,L,CAR,25,82,13,34,47
46,8471724,Kris Letang,D,PIT,37,82,12,35,47
46,8476853,Morgan Rielly,D,TOR,30,82,7,40,47
46,8482109,Alexis Lafrenière,L,NYR,23,82,25,21,46
46,8482699,Dylan Guenther,R,ARI,21,82,24,22,46
46,8474102,David Perron,L,DET,36,82,23,23,46
46,8484144,Connor Bedard,C,CHI,19,82,22,24,46
46,8470610,Zach Parise,L,COL,40,82,21,25,46
46,8480188,Fabian Zetterlund,L,SJS,25,82,19,27,46
46,8478458,Jack Roslovic,C,NYR,27,82,19,27,46
46,8477021,Alex Kerfoot,C,ARI,30,82,19,27,46
46,8474053,Logan Couture,C,SJS,35,82,18,28,46
46,8476881,Tomas Hertl,C,VGK,31,82,14,32,46
46,8474641,Adam Henrique,C,EDM,34,82,25,20,45
46,8482055,Drew O'Connor,L,PIT,26,82,25,20,45
46,8477426,Nicholas Paul,L,TBL,29,82,25,20,45
46,8482097,Jack Quinn,R,BUF,23,82,20,25,45
46,8479339,Patrik Laine,L,CBJ,26,82,23,21,44
46,8480797,Joel Farabee,L,PHI,24,82,21,23,44
46,8477494,Jonathan Drouin,L,COL,29,82,18,26,44
46,8475170,Brayden Schenn,C,STL,33,82,17,27,44
46,8471218,Blake Wheeler,R,NYR,38,82,14,30,44
46,8475745,Charlie Coyle,C,BOS,32,82,13,31,44
46,8481711,Matias Maccelli,L,ARI,24,82,10,34,44
46,8481016,Ruslan Iskhakov,C,NYI,24,82,8,36,44
46,8477407,Anthony Duclair,L,TBL,29,82,21,22,43
46,8482175,JJ Peterka,R,BUF,22,82,21,22,43
46,8478469,Thomas Chabot,D,OTT,27,82,17,26,43
46,8476458,Ryan Strome,C,ANA,31,82,16,27,43
46,8482624,Daniil Miromanov,D,CGY,27,82,12,31,43
46,8476869,Brady Skjei,D,CAR,30,82,12,31,43
46,8475151,Kyle Palmieri,C,NYI,33,82,26,16,42
46,8476432,Boone Jenner,C,CBJ,31,82,23,19,42
46,8475794,Tyler Seguin,C,DAL,32,82,21,21,42
46,8482159,Tyson Foerster,R,PHI,22,82,20,22,42
46,8477456,J.T. Compher,L,DET,29,82,18,24,42
46,8478396,Noah Hanifin,D,VGK,27,82,14,28,42
46,8480849,Barrett Hayton,C,ARI,24,82,12,30,42
46,8483431,Logan Cooley,C,ARI,20,82,23,18,41
46,8476438,Brandon Saad,L,STL,32,82,22,19,41
46,8477955,Jared McCann,L,SEA,28,82,19,22,41
46,8480039,Martin Necas,C,CAR,25,82,19,22,41
46,8476826,Yanni Gourde,C,SEA,33,82,15,26,41
46,8480220,Noah Cates,L,PHI,25,82,15,26,41
46,8482667,William Eklund,L,SJS,22,82,14,27,41
46,8479987,Morgan Geekie,C,BOS,26,82,14,27,41
46,8482133,Thomas Bordeleau,C,SJS,22,82,13,28,41
46,8475791,Taylor Hall,L,CHI,33,82,12,29,41
46,8478460,Zach Werenski,D,CBJ,27,82,11,30,41
46,8476854,Hampus Lindholm,D,BOS,30,82,7,34,41
46,8481542,Moritz Seider,D,DET,23,82,6,35,41
46,8481624,Ilya Mikheyev,R,VAN,30,82,19,21,40
46,8475149,Marcus Johansson,L,MIN,34,82,17,23,40
46,8483515,Juraj Slafkovsky,L,MTL,20,82,15,25,40
46,8482222,Alexander Barabanov,L,SJS,30,82,14,26,40
46,8482105,Jake Sanderson,D,OTT,22,82,11,29,40
46,8480014,Gabriel Vilardi,C,WPG,25,82,22,17,39
46,8482125,Alexander Holtz,R,NJD,22,82,20,19,39
46,8479525,Ross Colton,C,COL,28,82,19,20,39
46,8474189,Lars Eller,C,PIT,35,82,17,22,39
46,8482117,Lukas Reichel,L,CHI,22,82,14,25,39
46,8481013,Jonatan Berggren,R,DET,24,82,10,29,39
46,8474563,Drew Doughty,D,LAK,35,82,9,30,39
46,8476979,Erik Gustafsson,D,NYR,32,82,8,31,39
46,8475764,Cam Fowler,D,ANA,33,82,3,36,39
46,8478366,Frank Vatrano,R,ANA,30,82,22,16,38
46,8475314,Anders Lee,L,NYI,34,82,19,19,38
46,8477511,Anthony Mantha,R,VGK,30,82,19,19,38
46,8482101,Danil Gushchin,L,SJS,22,82,18,20,38
46,8482110,Dawson Mercer,C,NJD,23,82,16,22,38
46,8481560,Arthur Kaliyev,R,LAK,23,82,16,22,38
46,8474037,James van Riemsdyk,L,BOS,35,82,15,23,38
46,8478055,Gustav Forsling,D,FLA,28,82,12,26,38
46,8477944,Jakub Vrana,L,STL,28,82,21,16,37
46,8473533,Jordan Staal,C,CAR,36,82,21,16,37
46,8475287,Erik Haula,L,NJD,33,82,16,21,37
46,8482113,Anton Lundell,C,FLA,23,82,13,24,37
46,8480185,Eetu Luostarinen,C,FLA,26,82,12,25,37
46,8475753,Justin Faulk,D,STL,32,82,10,27,37
46,8474884,Mike Hoffman,C,SJS,35,82,17,19,36
46,8478115,Pierre Engvall,L,NYI,28,82,14,22,36
46,8478472,Mathieu Joseph,R,OTT,27,82,13,23,36
46,8479425,Filip Hronek,D,VAN,27,82,12,24,36
46,8473986,Alex Killorn,L,ANA,35,82,11,25,36
46,8476329,Travis Boyd,C,ARI,31,82,10,26,36
46,8475763,Kevin Hayes,R,STL,32,82,10,26,36
46,8470613,Brent Burns,D,CAR,39,82,6,30,36
46,8474565,Alex Pietrangelo,D,VGK,34,82,5,31,36
46,8481581,Thomas Harley,D,DAL,23,82,5,31,36
46,8477488,Brett Pesce,D,CAR,30,82,5,31,36
46,8475197,Tyson Barrie,D,NSH,33,82,4,32,36
46,8480246,Nick Perbix,D,TBL,26,82,4,32,36
46,8475760,Nick Bjugstad,C,ARI,32,82,21,14,35
46,8476981,Josh Anderson,R,MTL,30,82,19,16,35
46,8478057,Dakota Joshua,C,VAN,28,82,17,18,35
46,8476871,Tanner Pearson,L,MTL,32,82,15,20,35
46,8478542,Evan Rodrigues,C,FLA,31,82,12,23,35
46,8482671,Owen Power,D,BUF,22,82,12,23,35
46,8482475,Yegor Chinakhov,R,CBJ,23,82,11,24,35
46,8476872,Scott Laughton,C,PHI,30,82,11,24,35
46,8478013,Jake Walman,D,DET,28,82,11,24,35
46,8480434,Sean Durzi,D,ARI,26,82,6,29,35
46,8482142,Jamie Drysdale,D,PHI,22,82,4,31,35
46,8479316,Luke Kunin,C,SJS,27,82,21,13,34
46,8478466,Daniel Sprong,R,DET,27,82,19,15,34
46,8477998,Warren Foegele,L,EDM,28,82,18,16,34
46,8475722,Jason Zucker,L,NSH,32,82,17,17,34
46,8474870,Tyler Johnson,C,CHI,34,82,14,20,34
46,8475768,Jaden Schwartz,C,SEA,32,82,14,20,34
46,8482124,Quinton Byfield,R,LAK,22,82,12,22,34
46,8477953,Kasperi Kapanen,R,STL,28,82,11,23,34
46,8481186,Logan O'Connor,R,COL,28,82,11,23,34
46,8478882,Vladislav Gavrikov,D,LAK,29,82,10,24,34
46,8477989,Christian Dvorak,C,MTL,28,82,10,24,34
46,8483397,Marc McLaughlin,C,BOS,25,82,29,4,33
46,8481535,Nils Hoglander,L,VAN,24,82,17,16,33
46,8480802,Ryan McLeod,C,EDM,25,82,17,16,33
46,8479415,Michael McLeod,C,NJD,26,82,16,17,33
46,8479293,Brandon Tanev,L,SEA,33,82,16,17,33
46,8475220,Marcus Foligno,L,MIN,33,82,14,19,33
46,8480893,Kirill Marchenko,R,CBJ,24,82,13,20,33
46,8479514,Rem Pitlick,C,CHI,27,82,12,21,33
46,8484166,Adam Fantilli,C,CBJ,20,82,12,21,33
46,8478462,Nicolas Roy,C,VGK,27,82,11,22,33
46,8480068,Ryan Poehling,C,PHI,25,82,11,22,33
46,8478397,Rasmus Andersson,D,CGY,28,82,8,25,33
46,8475744,Evgeny Kuznetsov,C,CAR,32,82,8,25,33
46,8474149,Evgenii Dadonov,R,DAL,35,82,8,25,33
46,8480873,Rasmus Sandin,D,WSH,24,82,7,26,33
46,8475906,John Klingberg,D,TOR,32,82,7,26,33
46,8476885,Jacob Trouba,D,NYR,30,82,6,27,33
46,8483471,Brad Lambert,C,WPG,31,82,4,29,33
46,8478043,Sam Lafferty,C,VAN,29,82,20,12,32
46,8482705,Cole Sillinger,C,CBJ,21,82,17,15,32
46,8481554,Kaapo Kakko,R,NYR,23,82,16,16,32
46,8476480,Vladislav Namestnikov,C,WPG,32,82,16,16,32
46,8479992,Michael Rasmussen,C,DET,25,82,15,17,32
46,8481580,Connor McMichael,C,WSH,23,82,13,19,32
46,8484153,Leo Carlsson,C,ANA,20,82,13,19,32
46,8480459,Pius Suter,C,VAN,28,82,12,20,32
46,8478046,Danton Heinen,L,BOS,29,82,12,20,32
46,8478133,Jake Evans,C,MTL,28,82,9,23,32
46,8479398,Samuel Girard,D,COL,26,82,8,24,32
46,8481656,Aliaksei Protas,C,WSH,23,82,8,24,32
46,8483445,Cutter Gauthier,L,ANA,20,82,7,25,32
46,8475218,Mattias Ekholm,D,EDM,34,82,7,25,32
46,8473507,Jeff Petry,D,DET,37,82,4,28,32
46,8482712,Oskar Olausson,R,COL,22,82,2,30,32
46,8475799,Nino Niederreiter,R,WPG,32,82,17,14,31
46,8483493,Frank Nazar,C,CHI,20,82,17,14,31
46,8479661,Tanner Jeannot,L,TBL,27,82,17,14,31
46,8482146,Luke Evangelista,R,NSH,22,82,13,18,31
46,8476292,Ondrej Palat,L,NJD,33,82,13,18,31
46,8477948,Travis Sanheim,D,PHI,28,82,13,18,31
46,8478413,Jordan Greenway,L,BUF,27,82,12,19,31
46,8471698,T.J. Oshie,R,WSH,38,82,11,20,31
46,8476923,Damon Severson,D,CBJ,30,82,10,21,31
46,8473563,Nicklas Backstrom,C,WSH,37,82,9,22,31
46,8479351,Sam Steel,C,DAL,26,82,9,22,31
46,8480035,Henri Jokiharju,D,BUF,25,82,5,26,31
46,8480145,Neal Pionk,D,WPG,29,82,4,27,31
46,8478500,Ivan Provorov,D,CBJ,27,82,3,28,31
46,8482118,Sam Colangelo,R,ANA,23,82,24,6,30
46,8479423,Alex Nylander,L,CBJ,26,82,21,9,30
46,8481604,Pavel Dorofeyev,L,VGK,24,82,20,10,30
46,8482089,Jake Neighbours,L,STL,22,82,17,13,30
46,8475343,Nic Dowd,C,WSH,34,82,14,16,30
46,8473449,Kyle Okposo,R,FLA,36,82,13,17,30
46,8478233,Andrew Mangiapane,L,CGY,28,82,12,18,30
46,8482092,Ridly Greig,C,OTT,22,82,8,22,30
46,8482245,Artem Zub,D,OTT,29,82,8,22,30
46,8477429,Andrew Copp,C,DET,30,82,6,24,30
46,8476927,Teddy Blueger,C,VAN,30,82,6,24,30
46,8481568,Alex Vlasic,D,CHI,23,82,5,25,30
46,8477969,Marcus Pettersson,D,PIT,28,82,3,27,30
46,8478507,John Marino,D,NJD,27,82,2,28,30
46,8479365,Trent Frederic,C,BOS,26,82,18,11,29
46,8481093,Rafael Harvey-Pinard,L,MTL,25,82,18,11,29
46,8476461,Sean Couturier,C,PHI,32,82,16,13,29
46,8477330,Dominik Kubalik,L,OTT,29,82,16,13,29
46,8470604,Jeff Carter,C,PIT,39,82,16,13,29
46,8481618,Alex Newhook,C,MTL,23,82,14,15,29
46,8475848,Brendan Gallagher,R,MTL,32,82,13,16,29
46,8476392,Adam Lowry,C,WPG,31,82,11,18,29
46,8482079,Marco Rossi,C,MIN,23,82,9,20,29
46,8480817,K'Andre Miller,D,NYR,24,82,7,22,29
46,8476892,Colton Parayko,D,STL,31,82,7,22,29
46,8483457,Lane Hutson,D,MTL,20,82,2,27,29
46,8482733,Logan Mailloux,D,MTL,31,82,1,28,29
46,8478020,Michael Amadio,C,VGK,28,82,20,8,28
46,8480113,Alex Iafallo,L,WPG,31,82,15,13,28
46,8478463,Anthony Beauvillier,L,NSH,27,82,14,14,28
46,8476873,Mark Jankowski,C,NSH,30,82,14,14,28
46,8479390,Taylor Raddysh,R,CHI,26,82,14,14,28
46,8479346,Dillon Dube,C,CGY,26,82,13,15,28
46,8478109,Victor Olofsson,L,BUF,29,82,13,15,28
46,8473422,Nick Foligno,L,CHI,37,82,12,16,28
46,8476960,Andreas Athanasiou,C,CHI,30,82,12,16,28
46,8477839,Conor Sheary,L,TBL,32,82,12,16,28
46,8476921,Jordan Martinook,L,CAR,32,82,12,16,28
46,8475793,Ryan Johansen,C,PHI,32,82,11,17,28
46,8479996,Cody Glass,C,NSH,25,82,10,18,28
46,8477346,MacKenzie Weegar,D,CGY,30,82,9,19,28
46,8480009,Eeli Tolvanen,R,SEA,25,82,9,19,28
46,8478178,Darren Raddysh,D,TBL,28,82,8,20,28
46,8476457,Adam Larsson,D,SEA,32,82,6,22,28
46,8475324,Nick Jensen,D,WSH,34,82,6,22,28
46,8478891,Mason Appleton,C,WPG,28,82,5,23,28
46,8474716,Jared Spurgeon,D,MIN,35,82,4,24,28
46,8483490,Pavel Mintyukov,D,ANA,21,82,4,24,28
46,8476469,Joel Armia,R,MTL,31,82,18,9,27
46,8476878,Zemgus Girgensons,L,BUF,30,82,13,14,27
46,8475714,Calle Jarnkrok,C,TOR,33,82,12,15,27
46,8478508,Yakov Trenin,C,COL,27,82,11,16,27
46,8478911,Matt Roy,D,LAK,29,82,8,19,27
46,8482087,Kaiden Guhle,D,MTL,22,82,5,22,27
46,8475690,Chris Tanev,D,DAL,35,82,4,23,27
46,8482655,J.J. Moser,D,ARI,24,82,3,24,27
46,8483499,Liam Ohgren,L,MIN,20,82,13,13,26
46,8481477,Nico Sturm,C,SJS,29,82,11,15,26
46,8480855,Jack McBain,C,ARI,24,82,10,16,26
46,8480821,Filip Zadina,R,SJS,25,82,8,18,26
46,8475200,Dmitry Orlov,D,CAR,33,82,8,18,26
46,8481522,Peyton Krebs,C,BUF,23,82,8,18,26
46,8477498,Darnell Nurse,D,EDM,29,82,7,19,26
46,8479980,Nicolas Hague,D,VGK,26,82,7,19,26
46,8476312,Josh Manson,D,COL,33,82,6,20,26
46,8476958,Jaccob Slavin,D,CAR,30,82,2,24,26
46,8481546,Cam York,D,PHI,23,82,2,24,26
46,8477353,Tyler Motte,C,TBL,29,82,15,10,25
46,8479393,Noah Gregor,C,TOR,26,82,13,12,25
46,8480806,Isac Lundestrom,C,ANA,25,82,11,14,25
46,8481704,Juuso Parssinen,C,NSH,23,82,11,14,25
46,8481178,Egor Zamula,D,PHI,24,82,9,16,25
46,8474034,Pat Maroon,L,BOS,36,82,8,17,25
46,8481703,Valtteri Puustinen,R,PIT,25,82,4,21,25
46,8484203,Bradly Nadeau,L,CAR,19,82,16,8,24
46,8477450,Jason Dickinson,C,CHI,29,82,11,13,24
46,8480871,Adam Boqvist,D,CBJ,24,82,10,14,24
46,8476419,Jean-Gabriel Pageau,C,NYI,32,82,9,15,24
46,8482679,Matt Coronato,R,CGY,22,82,9,15,24
46,8477425,Miles Wood,L,COL,29,82,8,16,24
46,8481524,Bowen Byram,D,BUF,23,82,8,16,24
46,8482730,Brandt Clarke,D,LAK,21,82,8,16,24
46,8477015,Connor Brown,R,EDM,30,82,8,16,24
46,8482720,Matthew Knies,L,TOR,22,82,7,17,24
46,8476902,Esa Lindell,D,DAL,30,82,7,17,24
46,8476897,Oskar Sundqvist,C,STL,30,82,7,17,24
46,8477220,Nate Schmidt,D,WPG,33,82,5,19,24
46,8476931,Jake McCabe,D,TOR,31,82,5,19,24
46,8475171,Oliver Ekman-Larsson,D,FLA,33,82,4,20,24
46,8481606,Jordan Spence,D,LAK,23,82,4,20,24
46,8476331,Dylan DeMelo,D,WPG,31,82,1,23,24
46,8476925,Colton Sissons,C,NSH,31,82,13,10,23
46,8482702,Logan Stankoven,C,DAL,21,82,13,10,23
46,8482155,Alex Laferriere,R,LAK,23,82,11,12,23
46,8479941,Justin Danforth,R,CBJ,31,82,11,12,23
46,8482737,Zack Bolduc,C,STL,21,82,10,13,23
46,8480074,Alexandre Texier,C,CBJ,25,82,9,14,23
46,8481605,Jackson LaCombe,D,ANA,23,82,7,16,23
46,8477506,Ryan Pulock,D,NYI,30,82,7,16,23
46,8475181,Nick Leddy,D,STL,33,82,4,19,23
46,8478451,Ethan Bear,D,WSH,27,82,4,19,23
46,8474673,TJ Brodie,D,TOR,34,82,4,19,23
46,8479369,Andrew Peeke,D,BOS,26,82,3,20,23
46,8482145,Mavrik Bourque,C,DAL,22,82,15,7,22
46,8476278,Colin Blackwell,C,CHI,31,82,12,10,22
46,8477919,Frederick Gaudreau,C,MIN,31,82,8,14,22
46,8477435,Ryan Graves,D,PIT,29,82,7,15,22
46,8477369,Carson Soucy,D,VAN,30,82,6,16,22
46,8480058,Pierre-Olivier Joseph,D,PIT,25,82,5,17,22
46,8482122,Brock Faber,D,MIN,22,82,2,20,22
46,8476467,Jamie Oleksiak,D,SEA,32,82,2,20,22
46,8474151,Ryan McDonagh,D,NSH,35,82,2,20,22
46,8478569,Noel Acciari,C,PIT,33,82,14,7,21
46,8478430,Oliver Kylington,D,CGY,27,82,10,11,21
46,8474009,Nick Bonino,C,NYR,36,82,10,11,21
46,8479353,Brett Howden,C,VGK,26,82,9,12,21
46,8482259,Bobby McMann,C,TOR,28,82,8,13,21
46,8482074,Connor Zary,C,CGY,23,82,8,13,21
46,8479359,Beck Malenstyn,L,WSH,26,82,8,13,21
46,8483482,Tristan Luneau,D,ANA,20,82,8,13,21
46,8473453,Trevor Lewis,C,LAK,37,82,8,13,21
46,8481481,Blake Lizotte,C,LAK,27,82,7,14,21
46,8480336,Sean Walker,D,COL,30,82,7,14,21
46,8483466,Kevin Korchinski,D,CHI,20,82,7,14,21
46,8476429,Scott Mayfield,D,NYI,32,82,7,14,21
46,8475279,Ben Chiarot,D,DET,33,82,7,14,21
46,8481014,Alexander Romanov,D,NYI,24,82,6,15,21
46,8476374,Sean Kuraly,C,CBJ,31,82,5,16,21
46,8482858,Ryker Evans,D,SEA,23,82,5,16,21
46,8478840,Will Borgen,D,SEA,28,82,4,17,21
46,8480172,Jan Rutta,D,SJS,34,82,4,17,21
46,8476917,Adam Pelech,D,NYI,30,82,3,18,21
46,8475208,Brian Dumoulin,D,SEA,33,82,3,18,21
46,8470621,Corey Perry,R,EDM,39,82,13,7,20
46,8480813,Joe Veleno,C,DET,24,82,11,9,20
46,8481601,Simon Holmstrom,R,NYI,23,82,11,9,20
46,8482111,Justin Barron,D,MTL,23,82,11,9,20
46,8479591,Michael Eyssimont,C,TBL,28,82,9,11,20
46,8479983,Mario Ferraro,D,SJS,26,82,8,12,20
46,8474715,Cam Atkinson,R,PHI,35,82,7,13,20
46,8483565,Nick Blankenburg,D,CBJ,26,82,7,13,20
46,8480043,Timothy Liljegren,D,TOR,25,82,5,15,20
46,8480448,Parker Kelly,L,OTT,25,82,5,15,20
46,8477034,Jaycob Megna,D,CHI,32,82,5,15,20
46,8480860,Kevin Bahl,D,NJD,24,82,3,17,20
46,8476463,Jonas Brodin,D,MIN,31,82,3,17,20
46,8479324,Ryan Lindgren,D,NYR,26,82,3,17,20
46,8475233,David Savard,D,MTL,34,82,2,18,20
46,8476879,Cody Ceci,D,EDM,31,82,2,18,20
46,8483012,Logan Morrison,C,SEA,22,82,14,5,19
46,8480073,Erik Brannstrom,D,OTT,25,82,8,11,19
46,8484145,Zach Benson,L,BUF,19,82,7,12,19
46,8476442,Matt Nieto,L,PIT,32,82,6,13,19
46,8482762,Simon Edvinsson,D,DET,21,82,6,13,19
46,8476891,Matt Grzelcyk,D,BOS,30,82,3,16,19
46,8475790,Erik Gudbranson,D,CBJ,32,82,3,16,19
46,8475188,Brayden McNabb,D,VGK,33,82,1,18,19
46,8476858,Phillip Di Giuseppe,L,VAN,31,82,9,9,18
46,8477508,Curtis Lazar,C,NJD,29,82,9,9,18
46,8477406,Mattias Janmark,C,EDM,32,82,8,10,18
46,8478136,Jake Middleton,D,MIN,28,82,7,11,18
46,8483763,Maksymilian Szuber,D,ARI,22,82,7,11,18
46,8481028,Martin Pospisil,C,CGY,25,82,6,12,18
46,8478851,Alexandre Carrier,D,NSH,28,82,6,12,18
46,8483505,Matthew Poitras,C,BOS,20,82,6,12,18
46,8479977,Kailer Yamamoto,R,SEA,26,82,5,13,18
46,8482073,Braden Schneider,D,NYR,23,82,5,13,18
46,8481537,Nikita Okhotiuk,D,CGY,24,82,5,13,18
46,8480796,Martin Fehervary,D,WSH,25,82,2,16,18
46,8474574,Tyler Myers,D,VAN,34,82,1,17,18
46,8478859,Niko Mikkola,D,FLA,28,82,1,17,18
46,8480144,David Kampf,C,TOR,29,82,10,7,17
46,8483491,Ivan Miroshnichenko,L,WSH,20,82,10,7,17
46,8476624,Barclay Goodrow,C,NYR,31,82,9,8,17
46,8482166,Shakir Mukhamadullin,D,SJS,22,82,8,9,17
46,8475164,Jakob Silfverberg,R,ANA,34,82,7,10,17
46,8477507,Nikita Zadorov,D,VAN,29,82,7,10,17
46,8474166,Alec Martinez,D,VGK,37,82,7,10,17
46,8481517,Brett Leason,R,ANA,25,82,7,10,17
46,8479976,Juuso Valimaki,D,ARI,26,82,5,12,17
46,8475455,Brenden Dillon,D,WPG,34,82,5,12,17
46,8478443,Brandon Carlo,D,BOS,28,82,5,12,17
46,8473504,Cal Clutterbuck,R,NYI,37,82,5,12,17
46,8477505,Alexander Wennberg,C,NYR,30,82,4,13,17
46,8477365,Connor Clifton,D,BUF,29,82,3,14,17
46,8480807,Mattias Samuelsson,D,BUF,24,82,3,14,17
46,8481578,Graeme Clarke,R,NJD,23,82,3,14,17
46,8479998,Mikey Anderson,D,LAK,25,82,2,15,17
46,8476967,Brett Kulak,D,EDM,30,82,2,15,17
46,8482809,Jackson Blake,R,CAR,21,82,12,4,16
46,8475231,Casey Cizikas,C,NYI,33,82,9,7,16
46,8476372,Nick Seeler,D,PHI,31,82,6,10,16
46,8475462,Radko Gudas,D,ANA,34,82,5,11,16
46,8477392,Hudson Fasching,R,NYI,29,82,5,11,16
46,8482177,Marat Khusnutdinov,C,MIN,22,82,5,11,16
46,8477499,Rasmus Ristolainen,D,PHI,30,82,3,13,16
46,8475177,Calvin de Haan,D,TBL,33,82,3,13,16
46,8477845,Trevor van Riemsdyk,D,WSH,33,82,2,14,16
46,8482062,Cole Smith,L,NSH,29,82,7,8,15
46,8482666,Scott Morrow,D,CAR,22,82,4,11,15
46,8481030,Jack St. Ivany,D,PIT,25,82,4,11,15
46,8481553,Bobby Brink,R,PHI,23,82,3,12,15
46,8482803,Olen Zellweger,D,ANA,21,82,3,12,15
46,8475179,Dmitry Kulikov,D,FLA,34,82,2,13,15
46,8475842,Sam Carrick,C,EDM,32,82,6,8,14
46,8481599,Victor Soderstrom,D,ARI,23,82,6,8,14
46,8470600,Ryan Suter,D,DAL,39,82,4,10,14
46,8475762,Derek Forbort,D,BOS,32,82,4,10,14
46,8478468,Jeremy Lauzon,D,NSH,27,82,4,10,14
46,8480834,Ty Emberson,D,SJS,24,82,3,11,14
46,8477335,Kyle Burroughs,D,SJS,29,82,3,11,14
46,8478399,Jonas Siegenthaler,D,NJD,27,82,2,12,14
46,8475825,Jani Hakanpää,D,DAL,32,82,2,12,14
46,8470966,Mark Giordano,D,TOR,41,82,7,6,13
46,8479383,Boris Katchouk,L,OTT,26,82,7,6,13
46,8476915,Jujhar Khaira,L,MIN,30,82,5,8,13
46,8479291,Kevin Rooney,C,CGY,31,82,4,9,13
46,8480879,Jacob Bernard-Docker,D,OTT,24,82,3,10,13
46,8481567,Henry Thrun,D,SJS,23,82,3,10,13
46,8476473,Connor Murphy,D,CHI,31,82,3,10,13
46,8484911,Collin Graf,R,SJS,22,82,3,10,13
46,8479371,Dante Fabbro,D,NSH,26,82,2,11,13
46,8476525,Colin Miller,D,WPG,32,82,0,13,13
46,8480281,Alexey Toropchenko,R,STL,25,82,6,6,12
46,8483495,Simon Nemec,D,NJD,20,82,5,7,12
46,8476422,Mike Reilly,D,NYI,31,82,5,7,12
46,8482807,Ethan Del Mastro,D,CHI,21,82,5,7,12
46,8481059,Scott Perunovich,D,STL,26,82,4,8,12
46,8474013,Ian Cole,D,VAN,35,82,3,9,12
46,8478416,Erik Cernak,D,TBL,27,82,2,10,12
46,8478831,Kevin Stenlund,C,FLA,28,82,5,6,11
46,8474567,Zach Bogosian,D,MIN,34,82,3,8,11
46,8484149,Gavin Brindley,C,CBJ,20,82,3,8,11
46,8480980,Connor Dewar,C,TOR,25,82,1,10,11
46,8482516,Matthew Kessel,D,STL,24,82,0,11,11
46,8480990,Declan Chisholm,D,MIN,24,82,4,6,10
46,8477931,Tomas Nosek,L,NJD,32,82,2,8,10
46,8482470,Ilya Solovyov,D,CGY,24,82,2,8,10
46,8471677,Jack Johnson,D,COL,37,82,1,9,10
46,8478408,Travis Dermott,D,ARI,28,82,4,5,9
46,8483468,Jiri Kulich,C,BUF,20,82,4,5,9
46,8482713,Mackie Samoskevich,R,FLA,22,82,4,5,9
46,8483489,Fraser Minten,C,TOR,31,82,5,3,8
46,8476822,Luke Glendening,C,TBL,35,82,4,4,8
46,8479442,Troy Stecher,D,EDM,30,82,3,5,8
46,8482859,Zack Ostapchuk,C,OTT,21,82,0,4,4
46,8482141,Lukas Cormier,D,VGK,22,0,0,0,0
46,8476988,Matt Benning,D,SJS,30,0,0,0,0
46,8480727,Zach Whitecloud,D,VGK,28,0,0,0,0
46,8480887,Jordan Harris,D,MTL,24,0,0,0,0
46,8478450,Parker Wotherspoon,D,BOS,27,0,0,0,0
46,8481812,Nikolai Knyzhov,D,SJS,27,0,0,0,0
46,8480001,Urho Vaakanainen,D,ANA,25,0,0,0,0
46,8482176,Wyatt Kaiser,D,CHI,22,0,0,0,0
46,8481122,Simon Benoit,D,TOR,26,0,0,0,0
46,8476441,Joel Edmundson,D,TOR,31,0,0,0,0
46,8480884,Calen Addison,D,SJS,24,0,0,0,0
46,8482511,Mason Lohrei,D,BOS,23,0,0,0,0
46,8482192,Isaak Phillips,D,CHI,23,0,0,0,0
46,8480950,Ilya Lyubushkin,D,TOR,30,0,0,0,0
46,8474031,Kevin Shattenkirk,D,BOS,35,0,0,0,0
46,8475718,Justin Holl,D,DET,32,0,0,0,0
46,8479402,Jake Bean,D,CBJ,26,0,0,0,0
46,8474602,Justin Schultz,D,SEA,34,0,0,0,0
46,8477950,Tony DeAngelo,D,CAR,29,0,0,0,0
46,8481743,Marc Del Gaizo,D,NSH,25,0,0,0,0
46,8481527,Kaedan Korczak,D,VGK,23,0,0,0,0
46,8480192,Johnathan Kovacevic,D,MTL,27,0,0,0,0
46,8476874,Olli Maatta,D,DET,30,0,0,0,0
46,8482144,Jack Thompson,D,SJS,22,0,0,0,0
46,8480222,Sebastian Aho,D,NYI,28,0,0,0,0
46,8479458,Nikita Zaitsev,D,CHI,33,0,0,0,0
46,8471709,Marc-Edouard Vlasic,D,SJS,37,0,0,0,0
46,8482929,Emil Lilleberg,D,TBL,23,0,0,0,0
46,8477018,Ben Hutton,D,VGK,31,0,0,0,0
46,8481056,Spencer Stastney,D,NSH,24,0,0,0,0
46,8481593,Jayden Struble,D,MTL,23,0,0,0,0
46,8479982,Conor Timmins,D,TOR,26,0,0,0,0
46,8474090,Brendan Smith,D,NJD,35,0,0,0,0
46,8482964,Arber Xhekaj,D,MTL,23,0,0,0,0
46,8480891,Michael Kesselring,D,ARI,24,0,0,0,0
46,8477938,Haydn Fleury,D,TBL,28,0,0,0,0
46,8481806,Louis Crevier,D,CHI,23,0,0,0,0
46,8471274,Alex Goligoski,D,MIN,39,0,0,0,0
46,8481600,Tobias Bjornfot,D,FLA,23,0,0,0,0
46,8475797,Jarred Tinordi,D,CHI,32,0,0,0,0
46,8481521,Ronnie Attard,D,PHI,25,0,0,0,0
46,8474612,Travis Hamonic,D,OTT,34,0,0,0,0
46,8479576,Vincent Desharnais,D,EDM,28,0,0,0,0
46,8480049,Dylan Samberg,D,WPG,25,0,0,0,0
46,8483619,Filip Roos,D,CHI,25,0,0,0,0
46,8474568,Luke Schenn,D,NSH,35,0,0,0,0
46,8480184,Gustav Lindstrom,D,ANA,26,0,0,0,0
46,8480070,Ian Mitchell,D,BOS,25,0,0,0,0
46,8480196,Jacob Bryson,D,BUF,27,0,0,0,0
46,8471686,Marc Staal,D,PHI,37,0,0,0,0
46,8477467,Gustav Olofsson,D,SEA,30,0,0,0,0
46,8478970,Jalen Chatfield,D,CAR,28,0,0,0,0
46,8479348,Kale Clague,D,BUF,26,0,0,0,0
46,8473446,Erik Johnson,D,PHI,36,0,0,0,0
46,8477462,Robert Hagg,D,ANA,29,0,0,0,0
46,8478454,Noah Juulsen,D,VAN,27,0,0,0,0
46,8477384,Josh Brown,D,ARI,30,0,0,0,0
46,8481708,Zac Jones,D,NYR,24,0,0,0,0
46,8481167,Brayden Pachal,D,CGY,25,0,0,0,0
46,8482067,Connor Mackey,D,NYR,28,0,0,0,0
46,8483460,David Jiricek,D,CBJ,21,0,0,0,0
46,8481701,Santeri Hatakka,D,NJD,23,0,0,0,0
46,8478021,William Lagesson,D,ANA,28,0,0,0,0
46,8477851,Jordan Oesterle,D,CGY,32,0,0,0,0
46,8478452,Caleb Jones,D,COL,27,0,0,0,0
46,8479984,Cal Foote,D,NJD,26,0,0,0,0
46,8479639,Dylan Coghlan,D,CAR,26,0,0,0,0
46,8480874,Adam Ginning,D,PHI,24,0,0,0,0
46,8479321,Lucas Johansen,D,WSH,27,0,0,0,0
46,8480878,Nils Lundkvist,D,DAL,24,0,0,0,0
46,8482165,Yan Kuznetsov,D,CGY,22,0,0,0,0
46,8484258,Sam Malinski,D,COL,26,0,0,0,0
46,8480157,Calle Rosen,D,STL,30,0,0,0,0
46,8484304,Uvis Balinskis,D,FLA,28,0,0,0,0
46,8479985,Cale Fleury,D,SEA,26,0,0,0,0
46,8479378,Logan Stanley,D,WPG,26,0,0,0,0
46,8477541,Dakota Mermis,D,MIN,30,0,0,0,0
46,8481609,Vladislav Kolyachonok,D,ARI,23,0,0,0,0
46,8480823,Alexander Alexeyev,D,WSH,25,0,0,0,0
46,8481679,Maxence Guenette,D,OTT,23,0,0,0,0
46,8481564,Ryan Johnson,D,BUF,23,0,0,0,0
46,8479376,Victor Mete,D,PHI,26,0,0,0,0
46,8484254,Akito Hirose,D,VAN,25,0,0,0,0
46,8482660,Kent Johnson,C,CBJ,22,0,0,0,0
46,8482149,Cole Perfetti,C,WPG,22,0,0,0,0
46,8477987,Ryan Donato,C,CHI,28,0,0,0,0
46,8475755,Alexander Petrovic,D,DAL,32,0,0,0,0
46,8477810,Joel Hanley,D,CGY,33,0,0,0,0
46,8474145,Robert Bortuzzo,D,NYI,35,0,0,0,0
46,8481161,Jake Christiansen,D,CBJ,25,0,0,0,0
46,8476884,Derrick Pouliot,D,DAL,30,0,0,0,0
46,8481716,Dmitri Voronkov,L,CBJ,24,0,0,0,0
46,8480084,Nick DeSimone,D,NJD,30,0,0,0,0
46,8475750,Jon Merrill,D,MIN,32,0,0,0,0
46,8479315,Joey Anderson,R,CHI,26,0,0,0,0
46,8478011,Louie Belpedio,D,PHI,28,0,0,0,0
46,8482451,Mikael Pyyhtia,L,CBJ,23,0,0,0,0
46,8481541,Samuel Bolduc,D,NYI,24,0,0,0,0
46,8482126,Emil Andrae,D,PHI,31,0,0,0,0
46,8474618,Marco Scandella,D,STL,34,0,0,0,0
46,8477244,Chad Ruhwedel,D,NYR,34,0,0,0,0
46,8477971,Andreas Englund,D,LAK,28,0,0,0,0
46,8480829,Jesperi Kotkaniemi,C,CAR,24,0,0,0,0
46,8479372,Josh Mahura,D,FLA,26,0,0,0,0
46,8482095,Tyler Kleven,D,OTT,22,0,0,0,0
46,8481719,Maxwell Crozier,D,TBL,24,0,0,0,0
46,8475855,Jesper Fast,R,CAR,33,0,0,0,0
46,8480848,Ty Dellandrea,C,DAL,24,0,0,0,0
46,8475193,Tomas Tatar,L,SEA,34,0,0,0,0
46,8476889,Radek Faksa,C,DAL,30,0,0,0,0
46,8478495,Denis Gurianov,R,PHI,27,0,0,0,0
46,8480216,Jacob Peterson,C,SJS,25,0,0,0,0
46,8480252,Cole Guttman,C,CHI,25,0,0,0,0
46,8479026,Philippe Myers,D,TBL,27,0,0,0,0
46,8481006,Tyler Tucker,D,STL,24,0,0,0,0
46,8481032,Paul Cotter,C,VGK,25,0,0,0,0
46,8481577,Philip Tomasino,C,NSH,23,0,0,0,0
46,8476918,Jimmy Vesey,L,NYR,31,0,0,0,0
46,8479320,Max Lajoie,D,TOR,27,0,0,0,0
46,8478017,Mark Friedman,D,VAN,29,0,0,0,0
46,8481754,Nikita Nesterenko,C,ANA,23,0,0,0,0
46,8483407,Brandon Scanlin,D,NYR,25,0,0,0,0
46,8482659,Josh Doan,R,ARI,22,0,0,0,0
46,8477446,Michael McCarron,R,NSH,29,0,0,0,0
46,8477903,Garnet Hathaway,R,PHI,33,0,0,0,0
46,8482153,Brendan Brisson,C,VGK,23,0,0,0,0
46,8483546,Marshall Rifai,D,TOR,26,0,0,0,0
46,8484287,Cole McWard,D,VAN,23,0,0,0,0
46,8478854,Ryan Shea,D,PIT,27,0,0,0,0
46,8481585,Egor Afanasyev,L,NSH,23,0,0,0,0
46,8483398,Declan Carlile,D,TBL,31,0,0,0,0
46,8478502,Dennis Gilbert,D,CGY,28,0,0,0,0
46,8482749,Joshua Roy,R,MTL,21,0,0,0,0
46,8481598,Philip Broberg,D,EDM,23,0,0,0,0
46,8480835,Jack Drury,C,CAR,24,0,0,0,0
46,8480748,Kiefer Sherwood,L,NSH,29,0,0,0,0
46,8476934,Brock McGinn,L,ANA,30,0,0,0,0
46,8480870,Bo Groulx,C,ANA,24,0,0,0,0
46,8479368,Max Jones,L,ANA,26,0,0,0,0
46,8478099,Kevin Labanc,R,SJS,29,0,0,0,0
46,8478067,Oskar Lindblom,L,SJS,28,0,0,0,0
46,8476393,Nick Cousins,C,FLA,31,0,0,0,0
46,8483395,Arshdeep Bains,L,VAN,23,0,0,0,0
46,8480762,Eric Robinson,L,BUF,29,0,0,0,0
46,8479439,Jacob MacDonald,D,SJS,31,0,0,0,0
46,8476474,Stefan Noesen,R,CAR,31,0,0,0,0
46,8482787,Nikita Chibrikov,R,WPG,31,0,0,0,0
46,8478432,Christian Fischer,R,DET,27,0,0,0,0
46,8477979,Nicolas Aube-Kubel,R,WSH,28,0,0,0,0
46,8481789,Tye Kartye,L,SEA,23,0,0,0,0
46,8479330,Brandon Gignac,C,MTL,27,0,0,0,0
46,8480075,Cameron Crotty,D,ARI,25,0,0,0,0
46,8473473,Milan Lucic,L,BOS,36,0,0,0,0
46,8482094,Daemon Hunt,D,MIN,22,0,0,0,0
46,8481206,John Ludvig,D,PIT,24,0,0,0,0
46,8483630,Pavol Regenda,L,ANA,25,0,0,0,0
46,8481617,Vasily Podkolzin,R,VAN,23,0,0,0,0
46,8480306,Grant Hutton,D,NYI,29,0,0,0,0
46,8480995,Pontus Holmberg,R,TOR,25,0,0,0,0
46,8482148,Hendrix Lapierre,C,WSH,22,0,0,0,0
46,8477478,William Carrier,L,VGK,30,0,0,0,0
46,8480003,Jesper Boqvist,C,BOS,26,0,0,0,0
46,8482172,Landon Slaggert,L,CHI,22,0,0,0,0
46,8480789,Oliver Wahlstrom,R,NYI,24,0,0,0,0
46,8474062,Riley Nash,C,NYR,35,0,0,0,0
46,8480021,Jack Studnicka,C,SJS,25,0,0,0,0
46,8480025,MacKenzie Entwistle,R,CHI,25,0,0,0,0
46,8481582,Nicholas Robertson,L,TOR,23,0,0,0,0
46,8476867,Brendan Gaunce,C,CBJ,30,0,0,0,0
46,8479619,Michael Carcone,L,ARI,28,0,0,0,0
46,8479370,Tyson Jost,C,BUF,26,0,0,0,0
46,8479671,Mathieu Olivier,R,CBJ,27,0,0,0,0
46,8476994,Vinnie Hinostroza,C,PIT,30,0,0,0,0
46,8482070,Mitchell Chaffee,R,TBL,26,0,0,0,0
46,8477473,Justin Bailey,R,SJS,29,0,0,0,0
46,8479344,Jesse Puljujarvi,R,PIT,26,0,0,0,0
46,8480205,Emil Bemstrom,C,PIT,25,0,0,0,0
46,8479718,Alex Barré-Boulet,C,TBL,27,0,0,0,0
46,8482061,Brandon Biro,L,BUF,26,0,0,0,0
46,8479638,Justin Brazeau,R,BOS,26,0,0,0,0
46,8474040,Sam Gagner,C,EDM,35,0,0,0,0
46,8477846,Ryan Carpenter,C,SJS,33,0,0,0,0
46,8482077,Dylan Holloway,L,EDM,23,0,0,0,0
46,8482157,Will Cuylle,L,NYR,22,0,0,0,0
46,8480007,Jonas Rondbjerg,R,VGK,25,0,0,0,0
46,8478874,Adam Gaudette,C,STL,28,0,0,0,0
46,8478434,Keegan Kolesar,R,VGK,27,0,0,0,0
46,8480441,Trey Fix-Wolansky,R,CBJ,25,0,0,0,0
46,8479994,Jaret Anderson-Dolan,C,NSH,25,0,0,0,0
46,8483567,Georgii Merkulov,C,BOS,24,0,0,0,0
46,8477380,Jonny Brodzinski,C,NYR,31,0,0,0,0
46,8482201,Gage Goncalves,C,TBL,23,0,0,0,0
46,8478211,Dryden Hunt,L,CGY,29,0,0,0,0
46,8471699,Andrew Cogliano,C,COL,37,0,0,0,0
46,8479421,Jacob Moverare,D,LAK,26,0,0,0,0
46,8478881,Brett Seney,L,CHI,28,0,0,0,0
46,8477464,Nic Petan,C,MIN,29,0,0,0,0
46,8475958,Michael Sgarbossa,C,WSH,32,0,0,0,0
46,8481147,Reese Johnson,C,CHI,26,0,0,0,0
46,8479336,Carl Grundstrom,R,LAK,27,0,0,0,0
46,8480853,Liam Foudy,C,NSH,24,0,0,0,0
46,8479522,Hardy Haman Aktell,D,WSH,26,0,0,0,0
46,8481462,Mason Morelli,L,VGK,28,0,0,0,0
46,8482102,Vasily Ponomarev,C,CAR,22,0,0,0,0
46,8480844,Grigori Denisenko,L,VGK,24,0,0,0,0
46,8479944,Zach Aston-Reese,C,DET,30,0,0,0,0
46,8482784,Zach Dean,C,STL,21,0,0,0,0
46,8479419,Brett Murray,L,BUF,26,0,0,0,0
46,8479520,Brandon Duhaime,R,COL,27,0,0,0,0
46,8477573,Nathan Walker,L,STL,30,0,0,0,0
46,8478078,Rourke Chartier,C,OTT,28,0,0,0,0
46,8475795,Dylan McIlrath,D,WSH,32,0,0,0,0
46,8482496,Nils Aman,C,VAN,24,0,0,0,0
46,8480289,Morgan Barron,C,WPG,26,0,0,0,0
46,8481751,Lukas Rousek,R,BUF,25,0,0,0,0
46,8480011,Klim Kostin,C,SJS,25,0,0,0,0
46,8481556,John Beecher,C,BOS,23,0,0,0,0
46,8475278,Byron Froese,C,VGK,33,0,0,0,0
46,8475225,Craig Smith,C,DAL,35,0,0,0,0
46,8484326,Patrik Koch,D,ARI,28,0,0,0,0
46,8477930,Pierre-Edouard Bellemare,L,SEA,39,0,0,0,0
46,8478409,Anthony Richard,C,BOS,28,0,0,0,0
46,8481024,Linus Karlsson,C,VAN,25,0,0,0,0
46,8479986,Kole Lind,R,SEA,26,0,0,0,0
46,8479414,Nathan Bastian,R,NJD,27,0,0,0,0
46,8479362,Riley Tufte,L,COL,26,0,0,0,0
46,8481058,Jesse Ylönen,R,MTL,25,0,0,0,0
46,8482476,Emil Heineman,L,MTL,23,0,0,0,0
46,8482861,Vincent Iorio,D,WSH,22,0,0,0,0
46,8483432,Luca Del Bel Belluz,C,CBJ,31,0,0,0,0
46,8482744,James Malatesta,L,CBJ,21,0,0,0,0
46,8477887,Patrick Brown,C,BOS,32,0,0,0,0
46,8478585,Derek Ryan,C,EDM,38,0,0,0,0
46,8481441,Joe Snively,C,WSH,28,0,0,0,0
46,8481592,Jakob Pelletier,L,CGY,23,0,0,0,0
46,8482634,Alex Steeves,C,TOR,25,0,0,0,0
46,8477126,Jayson Megna,C,BOS,34,0,0,0,0
46,8475752,Tyler Pitlick,C,NYR,33,0,0,0,0
46,8480008,Adam Ruzicka,C,ARI,25,0,0,0,0
46,8481065,Angus Crookshank,L,OTT,25,0,0,0,0
46,8479547,Matthew Phillips,R,WSH,26,0,0,0,0
46,8480226,Marián Studenic,R,SEA,26,0,0,0,0
46,8481237,Kyle MacLean,C,NYI,25,0,0,0,0
46,8475413,Justin Dowling,C,NJD,34,0,0,0,0
46,8481641,Joel Kiviranta,L,COL,28,0,0,0,0
46,8478104,Sammy Blais,L,STL,28,0,0,0,0
46,8477454,Adam Erne,L,EDM,29,0,0,0,0
46,8481518,Nolan Foote,L,NJD,24,0,0,0,0
46,8480245,Olle Lycksell,R,PHI,25,0,0,0,0
46,8483570,Ben Meyers,C,ANA,26,0,0,0,0
46,8480776,Sheldon Rempal,R,VGK,29,0,0,0,0
46,8483920,Pierrick Dube,R,WSH,23,0,0,0,0
46,8480267,Sammy Walker,C,MIN,25,0,0,0,0
46,8482747,Brennan Othmann,L,NYR,21,0,0,0,0
46,8479991,Jake Leschyshyn,C,NYR,25,0,0,0,0
46,8478400,Colin White,C,MTL,27,0,0,0,0
46,8479328,Julien Gauthier,R,NYI,27,0,0,0,0
46,8484325,Waltteri Merela,C,TBL,26,0,0,0,0
46,8479066,Ryan Lomberg,L,FLA,30,0,0,0,0
46,8477070,Liam O'Brien,C,ARI,30,0,0,0,0
46,8478146,Matthew Highmore,C,OTT,28,0,0,0,0
46,8478028,Fredrik Olofsson,L,COL,28,0,0,0,0
46,8480880,Jakub Lauko,C,BOS,24,0,0,0,0
46,8479968,Vinni Lettieri,C,MIN,29,0,0,0,0
46,8474709,Matt Martin,L,NYI,35,0,0,0,0
46,8480845,Rasmus Kupari,C,WPG,24,0,0,0,0
46,8481550,Adam Beckman,L,MIN,23,0,0,0,0
46,8481422,Jacob Lucchini,C,MIN,29,0,0,0,0
46,8477401,John Hayden,C,SEA,29,0,0,0,0
46,8478904,Steven Lorentz,C,FLA,28,0,0,0,0
46,8482088,Justin Sourdif,R,FLA,22,0,0,0,0
46,8482751,Ryan Winterton,C,SEA,21,0,0,0,0
46,8482241,Radim Zohorna,L,PIT,28,0,0,0,0
46,8481690,Tyler Angle,C,CBJ,24,0,0,0,0
46,8476952,Dominic Toninato,C,WPG,30,0,0,0,0
46,8476919,Chris Tierney,C,NJD,30,0,0,0,0
46,8480032,Shane Bowers,C,NJD,25,0,0,0,0
46,8484314,Jiri Smejkal,L,OTT,28,0,0,0,0
46,8481239,Samuel Fagemo,L,LAK,24,0,0,0,0
46,8481532,Alex Turcotte,C,LAK,23,0,0,0,0
46,8481019,David Gustafsson,C,WPG,24,0,0,0,0
46,8478477,Mitchell Stephens,C,MTL,27,0,0,0,0
46,8479546,Oskar Steen,C,BOS,26,0,0,0,0
46,8480292,Carson Meyer,R,CBJ,27,0,0,0,0
46,8478446,Glenn Gawdin,C,ANA,27,0,0,0,0
46,8483531,Brian Halonen,L,NJD,25,0,0,0,0
46,8477149,Scott Sabourin,R,SJS,32,0,0,0,0
46,8479972,Mason Shaw,C,MIN,26,0,0,0,0
46,8480890,Jan Jenik,R,ARI,24,0,0,0,0
46,8478051,Max Willman,C,NJD,29,0,0,0,0
46,8480851,Akil Thomas,C,LAK,24,0,0,0,0
46,8482765,Isak Rosen,R,BUF,21,0,0,0,0
46,8478421,A.J. Greer,L,CGY,28,0,0,0,0
46,8478512,Austin Czarnik,C,DET,32,0,0,0,0
46,8479536,Axel Jonsson-Fjallby,L,WPG,26,0,0,0,0
46,8477320,Anton Blidh,L,NYR,29,0,0,0,0
46,8481543,Nikita Alexandrov,C,STL,24,0,0,0,0
46,8475235,Nicolas Deslauriers,L,PHI,33,0,0,0,0
46,8481070,Hugh McGing,L,STL,26,0,0,0,0
46,8480836,Jonathan Gruden,C,PIT,24,0,0,0,0
46,8481591,Sam Poulin,R,PIT,23,0,0,0,0
46,8477962,Brendan Lemieux,L,CAR,28,0,0,0,0
46,8483401,Marc Johnstone,R,PIT,28,0,0,0,0
46,8482250,Callahan Burke,C,CAR,27,0,0,0,0
46,8481726,Adam Edstrom,C,NYR,24,0,0,0,0
46,8471817,Ryan Reaves,R,TOR,37,0,0,0,0
46,8479587,Rhett Gardner,C,PHI,28,0,0,0,0
46,8475766,Austin Watson,L,TBL,32,0,0,0,0
46,8479367,William Lockwood,R,FLA,26,0,0,0,0
46,8478424,Jansen Harkins,C,PIT,27,0,0,0,0
46,8476913,Devin Shore,C,SEA,30,0,0,0,0
46,8482652,Walker Duehr,R,CGY,27,0,0,0,0
46,8477527,Ross Johnston,L,ANA,30,0,0,0,0
46,8481077,John Leonard,L,ARI,26,0,0,0,0
46,8483549,Lucas Condotta,L,MTL,27,0,0,0,0
46,8480468,James Hamblin,L,EDM,25,0,0,0,0
46,8476907,Mackenzie MacEachern,L,STL,30,0,0,0,0
46,8479543,Michael Pezzetta,L,MTL,26,0,0,0,0
46,8480355,Mark Kastelic,C,OTT,25,0,0,0,0
46,8482162,Roby Jarventie,L,OTT,22,0,0,0,0
46,8479772,Zack MacEwen,R,OTT,28,0,0,0,0
46,8483597,Milos Kelemen,L,ARI,25,0,0,0,0
46,8479379,Givani Smith,R,SJS,26,0,0,0,0
46,8481655,Cole Schwindt,R,CGY,23,0,0,0,0
46,8479981,Jonah Gadjovich,L,FLA,26,0,0,0,0
46,8482147,Jean-Luc Foudy,C,COL,22,0,0,0,0
46,8484255,Jason Polin,R,COL,25,0,0,0,0
46,8477993,Justin Kirkland,C,ARI,28,0,0,0,0
46,8479249,Andrew Poturalski,C,SEA,30,0,0,0,0
46,8482197,Adam Raska,R,MIN,23,0,0,0,0
46,8475780,Chris Wagner,R,COL,33,0,0,0,0
46,8479533,Joona Koppanen,L,PIT,26,0,0,0,0
46,8481534,Raphael Lavoie,C,EDM,24,0,0,0,0
46,8484321,Nikolas Matinpalo,D,OTT,26,0,0,0,0
46,8481043,Cole Koepke,L,TBL,26,0,0,0,0
46,8476323,Max McCormick,L,SEA,32,0,0,0,0
46,8483609,Adam Klapka,R,CGY,24,0,0,0,0
46,8483512,Matt Savoie,C,BUF,20,0,0,0,0
46,8484259,Ondrej Pavel,C,COL,31,0,0,0,0
46,8478147,Bokondji Imama,L,OTT,28,0,0,0,0
46,8482460,Matt Rempe,C,NYR,22,0,0,0,0
46,8477073,Kurtis MacDermid,L,NJD,30,0,0,0,0
46,8480274,Philip Kemp,D,EDM,25,0,0,0,0
46,8478956,Samuel Laberge,L,NJD,27,0,0,0,0
46,8483045,Cameron Butler,R,CBJ,31,0,0,0,0
47,8478402,Connor McDavid,C,EDM,27,82,40,76,116
47,8477492,Nathan MacKinnon,C,COL,29,82,45,66,111
47,8476453,Nikita Kucherov,R,TBL,31,82,39,71,110
47,8478864,Kirill Kaprizov,L,MIN,27,82,47,62,109
47,8481559,Jack Hughes,C,NJD,23,82,42,60,102
47,8477956,David Pastrnak,R,BOS,28,82,53,43,96
47,8477946,Dylan Larkin,C,DET,28,82,38,57,95
47,8480027,Jason Robertson,L,DAL,25,82,33,62,95
47,8478550,Artemi Panarin,L,NYR,33,82,32,63,95
47,8477934,Leon Draisaitl,C,EDM,29,82,33,60,93
47,8479318,Auston Matthews,C,TOR,27,82,53,38,91
47,8476887,Filip Forsberg,L,NSH,30,82,48,43,91
47,8479407,Jesper Bratt,L,NJD,26,82,28,62,90
47,8479314,Matthew Tkachuk,L,FLA,27,82,33,54,87
47,8477942,Kevin Fiala,L,LAK,28,82,27,60,87
47,8478414,Timo Meier,R,NJD,28,82,45,40,85
47,8476346,Johnny Gaudreau,L,CBJ,31,82,21,61,82
47,8478398,Kyle Connor,L,WPG,28,82,35,46,81
47,8477402,Pavel Buchnevich,L,STL,29,82,34,47,81
47,8474600,Roman Josi,D,NSH,34,82,23,58,81
47,8471215,Evgeni Malkin,C,PIT,38,82,37,43,80
47,8477493,Aleksander Barkov,C,FLA,29,82,33,47,80
47,8480012,Elias Pettersson,C,VAN,26,82,26,54,80
47,8476459,Mika Zibanejad,C,NYR,31,82,36,43,79
47,8478439,Travis Konecny,R,PHI,27,82,33,46,79
47,8477404,Jake Guentzel,C,CAR,30,82,31,48,79
47,8476468,J.T. Miller,C,VAN,31,82,23,56,79
47,8478449,Roope Hintz,C,DAL,28,82,39,39,78
47,8478010,Brayden Point,C,TBL,28,82,37,41,78
47,8480069,Cale Makar,D,COL,26,82,16,62,78
47,8479343,Clayton Keller,R,ARI,26,82,38,39,77
47,8478420,Mikko Rantanen,R,COL,28,82,31,46,77
47,8481523,Kirby Dach,C,MTL,23,82,13,64,77
47,8481540,Cole Caufield,R,MTL,23,82,49,27,76
47,8480023,Robert Thomas,C,STL,25,82,26,50,76
47,8480801,Brady Tkachuk,L,OTT,25,82,42,33,75
47,8480002,Nico Hischier,C,NJD,25,82,28,46,74
47,8480830,Andrei Svechnikov,R,CAR,24,82,25,49,74
47,8476456,Jonathan Huberdeau,C,CGY,31,82,19,55,74
47,8476389,Vincent Trocheck,C,NYR,31,82,32,41,73
47,8482116,Tim Stützle,C,OTT,22,82,21,52,73
47,8479325,Charlie McAvoy,D,BOS,27,82,16,56,72
47,8477939,William Nylander,R,TOR,28,82,35,36,71
47,8477496,Elias Lindholm,C,VAN,30,82,30,41,71
47,8474141,Patrick Kane,R,DET,36,82,24,47,71
47,8475786,Zach Hyman,L,EDM,32,82,41,29,70
47,8475754,Brock Nelson,C,NYI,33,82,41,29,70
47,8476460,Mark Scheifele,C,WPG,31,82,37,33,70
47,8479385,Jordan Kyrou,C,STL,26,82,30,40,70
47,8480036,Miro Heiskanen,D,DAL,25,82,12,58,70
47,8480800,Quinn Hughes,D,VAN,25,82,9,61,70
47,8471214,Alex Ovechkin,L,WSH,39,82,32,37,69
47,8481557,Matt Boldy,L,MIN,23,82,31,38,69
47,8478427,Sebastian Aho,C,CAR,27,82,28,41,69
47,8477501,Valeri Nichushkin,R,COL,29,82,36,32,68
47,8473419,Brad Marchand,L,BOS,36,82,22,46,68
47,8478444,Brock Boeser,R,VAN,27,82,33,34,67
47,8479420,Tage Thompson,C,BUF,27,82,33,34,67
47,8477409,Carter Verhaeghe,C,FLA,29,82,33,34,67
47,8479339,Patrik Laine,L,CBJ,26,82,28,39,67
47,8477940,Nikolaj Ehlers,L,WPG,28,82,27,40,67
47,8471675,Sidney Crosby,C,PIT,37,82,25,42,67
47,8477949,Alex Tuch,R,BUF,28,82,24,43,67
47,8475168,Matt Duchene,C,DAL,33,82,24,43,67
47,8477933,Sam Reinhart,C,FLA,29,82,30,36,66
47,8478047,Michael Bunting,L,PIT,29,82,29,36,65
47,8476462,Dougie Hamilton,D,NJD,31,82,19,46,65
47,8482684,Luke Hughes,D,NJD,21,82,15,50,65
47,8475810,Bryan Rust,R,PIT,32,82,36,28,64
47,8477500,Bo Horvat,C,NYI,29,82,32,32,64
47,8475172,Nazem Kadri,C,CGY,34,82,26,38,64
47,8476454,Ryan Nugent-Hopkins,C,EDM,31,82,17,47,64
47,8478460,Zach Werenski,D,CBJ,27,82,16,48,64
47,8478407,Vince Dunn,D,SEA,28,82,15,49,64
47,8474578,Erik Karlsson,D,PIT,34,82,12,51,63
47,8477955,Jared McCann,L,SEA,28,82,31,31,62
47,8474564,Steven Stamkos,C,TBL,34,82,30,32,62
47,8478493,Joel Eriksson Ek,C,MIN,27,82,29,33,62
47,8475794,Tyler Seguin,C,DAL,32,82,36,25,61
47,8476479,Phillip Danault,C,LAK,31,82,24,37,61
47,8475913,Mark Stone,R,VGK,32,82,23,38,61
47,8475167,Victor Hedman,D,TBL,34,82,18,43,61
47,8480839,Rasmus Dahlin,D,BUF,24,82,19,41,60
47,8479542,Brandon Hagel,L,TBL,26,82,24,35,59
47,8478042,Viktor Arvidsson,R,LAK,31,82,23,36,59
47,8473994,Jamie Benn,L,DAL,35,82,21,38,59
47,8481528,Dylan Cozens,C,BUF,23,82,21,38,59
47,8478445,Mathew Barzal,C,NYI,27,82,19,40,59
47,8475745,Charlie Coyle,C,BOS,32,82,15,44,59
47,8478403,Jack Eichel,C,VGK,28,82,30,28,58
47,8475765,Vladimir Tarasenko,R,FLA,33,82,26,32,58
47,8471724,Kris Letang,D,PIT,37,82,14,44,58
47,8475158,Ryan O'Reilly,C,NSH,33,82,26,31,57
47,8476882,Teuvo Teravainen,L,CAR,30,82,24,33,57
47,8476881,Tomas Hertl,C,VGK,31,82,20,37,57
47,8471685,Anze Kopitar,C,LAK,37,82,18,39,57
47,8475184,Chris Kreider,L,NYR,33,82,32,24,56
47,8480015,Owen Tippett,R,PHI,25,82,31,25,56
47,8476483,Rickard Rakell,R,PIT,31,82,25,31,56
47,8478873,Troy Terry,R,ANA,27,82,22,34,56
47,8473512,Claude Giroux,R,OTT,36,82,21,35,56
47,8482093,Seth Jarvis,C,CAR,22,82,21,35,56
47,8475692,Mats Zuccarello,R,MIN,37,82,17,39,56
47,8475170,Brayden Schenn,C,STL,33,82,17,39,56
47,8477960,Adrian Kempe,R,LAK,28,82,31,24,55
47,8477935,Sam Bennett,C,FLA,28,82,23,32,55
47,8474157,Max Pacioretty,L,WSH,36,82,21,34,55
47,8480803,Evan Bouchard,D,EDM,25,82,16,39,55
47,8479323,Adam Fox,D,NYR,26,82,15,40,55
47,8476853,Morgan Rielly,D,TOR,30,82,5,50,55
47,8482159,Tyson Foerster,R,PHI,22,82,31,23,54
47,8475166,John Tavares,C,TOR,34,82,26,28,54
47,8482740,Wyatt Johnston,C,DAL,21,82,23,31,54
47,8474679,Gustav Nyquist,C,NSH,35,82,22,32,54
47,8482097,Jack Quinn,R,BUF,23,82,22,32,54
47,8478401,Pavel Zacha,C,BOS,27,82,21,33,54
47,8476432,Boone Jenner,C,CBJ,31,82,21,33,54
47,8480018,Nick Suzuki,C,MTL,25,82,18,36,54
47,8480865,Noah Dobson,D,NYI,24,82,11,43,54
47,8476448,William Karlsson,C,VGK,31,82,25,28,53
47,8479337,Alex DeBrincat,R,DET,27,82,21,32,53
47,8474590,John Carlson,D,WSH,34,82,12,41,53
47,8480064,Josh Norris,C,OTT,25,82,36,16,52
47,8476399,Blake Coleman,C,CGY,33,82,34,18,52
47,8476539,Jonathan Marchessault,R,VGK,34,82,26,26,52
47,8482078,Lucas Raymond,L,DET,22,82,22,30,52
47,8482665,Matty Beniers,C,SEA,22,82,21,31,52
47,8480039,Martin Necas,C,CAR,25,82,21,31,52
47,8481596,Shane Pinto,C,OTT,24,82,17,35,52
47,8477497,Sean Monahan,C,WPG,30,82,23,28,51
47,8476880,Tom Wilson,R,WSH,30,82,21,30,51
47,8475784,Jeff Skinner,C,BUF,32,82,18,33,51
47,8478233,Andrew Mangiapane,L,CGY,28,82,17,34,51
47,8478440,Dylan Strome,C,WSH,27,82,24,26,50
47,8478542,Evan Rodrigues,C,FLA,31,82,20,30,50
47,8481711,Matias Maccelli,L,ARI,24,82,15,35,50
47,8478856,Conor Garland,R,VAN,28,82,23,26,49
47,8470794,Joe Pavelski,C,DAL,40,82,21,28,49
47,8480208,Drake Batherson,R,OTT,26,82,16,33,49
47,8479345,Jakob Chychrun,D,OTT,26,82,15,34,49
47,8477021,Alex Kerfoot,C,ARI,30,82,13,36,49
47,8477503,Max Domi,C,TOR,29,82,12,37,49
47,8478366,Frank Vatrano,R,ANA,30,82,33,15,48
47,8478466,Daniel Sprong,R,DET,27,82,30,18,48
47,8471698,T.J. Oshie,R,WSH,38,82,26,22,48
47,8475169,Evander Kane,L,EDM,33,82,23,25,48
47,8482745,Mason McTavish,C,ANA,21,82,21,27,48
47,8477989,Christian Dvorak,C,MTL,28,82,19,29,48
47,8477416,Oliver Bjorkstrand,R,SEA,29,82,18,30,48
47,8483515,Juraj Slafkovsky,L,MTL,20,82,18,30,48
47,8478519,Anthony Cirelli,C,TBL,27,82,17,31,48
47,8474150,Mikael Backlund,C,CGY,35,82,15,33,48
47,8478469,Thomas Chabot,D,OTT,27,82,13,35,48
47,8478055,Gustav Forsling,D,FLA,28,82,12,36,48
47,8481542,Moritz Seider,D,DET,23,82,7,41,48
47,8479400,Pierre-Luc Dubois,L,LAK,26,82,23,24,47
47,8478438,Tommy Novak,C,NSH,27,82,15,32,47
47,8477986,Brandon Montour,D,FLA,30,82,14,33,47
47,8477447,Shea Theodore,D,VGK,29,82,13,34,47
47,8477951,Nick Schmaltz,C,ARI,28,82,11,36,47
47,8478498,Jake DeBrusk,L,BOS,28,82,22,24,46
47,8475726,Tyler Toffoli,C,WPG,32,82,20,26,46
47,8477407,Anthony Duclair,L,TBL,29,82,18,28,46
47,8479525,Ross Colton,C,COL,28,82,18,28,46
47,8475798,Mikael Granlund,C,SJS,32,82,16,30,46
47,8480798,Philipp Kurashev,C,CHI,25,82,16,30,46
47,8482671,Owen Power,D,BUF,22,82,16,30,46
47,8479999,Casey Mittelstadt,C,COL,26,82,15,31,46
47,8476875,Mike Matheson,D,MTL,30,82,10,36,46
47,8481581,Thomas Harley,D,DAL,23,82,8,38,46
47,8482699,Dylan Guenther,R,ARI,21,82,27,18,45
47,8480797,Joel Farabee,L,PHI,24,82,22,23,45
47,8476869,Brady Skjei,D,CAR,30,82,18,27,45
47,8477444,Andre Burakovsky,L,SEA,29,82,17,28,45
47,8479987,Morgan Geekie,C,BOS,26,82,13,32,45
47,8482055,Drew O'Connor,L,PIT,26,82,17,27,44
47,8474037,James van Riemsdyk,L,BOS,35,82,17,27,44
47,8475287,Erik Haula,L,NJD,33,82,15,29,44
47,8481533,Trevor Zegras,C,ANA,23,82,14,30,44
47,8480028,Morgan Frost,C,PHI,25,82,14,30,44
47,8478396,Noah Hanifin,D,VGK,27,82,14,30,44
47,8477964,Ivan Barbashev,C,VGK,29,82,11,33,44
47,8475744,Evgeny Kuznetsov,C,CAR,32,82,11,33,44
47,8483524,Shane Wright,C,SEA,20,82,27,16,43
47,8481618,Alex Newhook,C,MTL,23,82,22,21,43
47,8474641,Adam Henrique,C,EDM,34,82,19,24,43
47,8475791,Taylor Hall,L,CHI,33,82,19,24,43
47,8476292,Ondrej Palat,L,NJD,33,82,19,24,43
47,8482109,Alexis Lafrenière,L,NYR,23,82,18,25,43
47,8483808,Andrei Kuzmenko,L,CGY,28,82,17,26,43
47,8477504,Josh Morrissey,D,WPG,29,82,9,34,43
47,8475151,Kyle Palmieri,C,NYI,33,82,23,19,42
47,8479365,Trent Frederic,C,BOS,26,82,22,20,42
47,8475848,Brendan Gallagher,R,MTL,32,82,22,20,42
47,8481068,Yegor Sharangovich,C,CGY,26,82,21,21,42
47,8477479,Tyler Bertuzzi,L,TOR,29,82,20,22,42
47,8478975,Mason Marchment,L,DAL,29,82,14,28,42
47,8474102,David Perron,L,DET,36,82,14,28,42
47,8477494,Jonathan Drouin,L,COL,29,82,11,31,42
47,8482667,William Eklund,L,SJS,22,82,19,22,41
47,8474586,Jordan Eberle,R,SEA,34,82,15,26,41
47,8476905,Chandler Stephenson,C,VGK,30,82,14,27,41
47,8470613,Brent Burns,D,CAR,39,82,14,27,41
47,8480078,Filip Chytil,C,NYR,25,82,12,29,41
47,8478413,Jordan Greenway,L,BUF,27,82,12,29,41
47,8477948,Travis Sanheim,D,PHI,28,82,11,30,41
47,8480031,Maxime Comtois,L,CAR,25,82,10,31,41
47,8480434,Sean Durzi,D,ARI,26,82,9,32,41
47,8481546,Cam York,D,PHI,23,82,6,35,41
47,8483397,Marc McLaughlin,C,BOS,25,82,36,4,40
47,8480849,Barrett Hayton,C,ARI,24,82,24,16,40
47,8480893,Kirill Marchenko,R,CBJ,24,82,22,18,40
47,8475799,Nino Niederreiter,R,WPG,32,82,22,18,40
47,8479390,Taylor Raddysh,R,CHI,26,82,16,24,40
47,8477451,Ryan Hartman,R,MIN,30,82,14,26,40
47,8474565,Alex Pietrangelo,D,VGK,34,82,11,29,40
47,8475191,Reilly Smith,R,PIT,33,82,10,30,40
47,8477495,Seth Jones,D,CHI,30,82,7,33,40
47,8478397,Rasmus Andersson,D,CGY,28,82,7,33,40
47,8480014,Gabriel Vilardi,C,WPG,25,82,23,16,39
47,8482475,Yegor Chinakhov,R,CBJ,23,82,21,18,39
47,8476392,Adam Lowry,C,WPG,31,82,16,23,39
47,8480855,Jack McBain,C,ARI,24,82,15,24,39
47,8476458,Ryan Strome,C,ANA,31,82,11,28,39
47,8481699,Aku Raty,R,ARI,23,82,4,35,39
47,8475197,Tyson Barrie,D,NSH,33,82,4,35,39
47,8481535,Nils Hoglander,L,VAN,24,82,21,17,38
47,8477947,Sonny Milano,L,WSH,28,82,20,18,38
47,8480802,Ryan McLeod,C,EDM,25,82,16,22,38
47,8482113,Anton Lundell,C,FLA,23,82,10,28,38
47,8476906,Shayne Gostisbehere,D,DET,31,82,8,30,38
47,8478500,Ivan Provorov,D,CBJ,27,82,5,33,38
47,8481016,Ruslan Iskhakov,C,NYI,24,82,4,34,38
47,8470604,Jeff Carter,C,PIT,39,82,21,16,37
47,8479675,Trevor Moore,L,LAK,29,82,16,21,37
47,8475722,Jason Zucker,L,NSH,32,82,15,22,37
47,8473986,Alex Killorn,L,ANA,35,82,13,24,37
47,8475768,Jaden Schwartz,C,SEA,32,82,13,24,37
47,8478038,Devon Toews,D,COL,30,82,11,26,37
47,8480220,Noah Cates,L,PHI,25,82,11,26,37
47,8480817,K'Andre Miller,D,NYR,24,82,11,26,37
47,8477346,MacKenzie Weegar,D,CGY,30,82,11,26,37
47,8477425,Miles Wood,L,COL,29,82,10,27,37
47,8477932,Aaron Ekblad,D,FLA,28,82,9,28,37
47,8479425,Filip Hronek,D,VAN,27,82,9,28,37
47,8479410,Mikhail Sergachev,D,TBL,26,82,8,29,37
47,8475314,Anders Lee,L,NYI,34,82,20,16,36
47,8480188,Fabian Zetterlund,L,SJS,25,82,17,19,36
47,8478462,Nicolas Roy,C,VGK,27,82,17,19,36
47,8477456,J.T. Compher,L,DET,29,82,16,20,36
47,8482705,Cole Sillinger,C,CBJ,21,82,15,21,36
47,8482222,Alexander Barabanov,L,SJS,30,82,13,23,36
47,8480185,Eetu Luostarinen,C,FLA,26,82,10,26,36
47,8475906,John Klingberg,D,TOR,32,82,7,29,36
47,8482110,Dawson Mercer,C,NJD,23,82,25,10,35
47,8479423,Alex Nylander,L,CBJ,26,82,21,14,35
47,8476826,Yanni Gourde,C,SEA,33,82,17,18,35
47,8477511,Anthony Mantha,R,VGK,30,82,16,19,35
47,8482124,Quinton Byfield,R,LAK,22,82,14,21,35
47,8482146,Luke Evangelista,R,NSH,22,82,14,21,35
47,8475763,Kevin Hayes,R,STL,32,82,11,24,35
47,8478133,Jake Evans,C,MTL,28,82,8,27,35
47,8476885,Jacob Trouba,D,NYR,30,82,6,29,35
47,8474563,Drew Doughty,D,LAK,35,82,2,33,35
47,8476981,Josh Anderson,R,MTL,30,82,22,12,34
47,8478508,Yakov Trenin,C,COL,27,82,21,13,34
47,8481624,Ilya Mikheyev,R,VAN,30,82,19,15,34
47,8478115,Pierre Engvall,L,NYI,28,82,15,19,34
47,8479293,Brandon Tanev,L,SEA,33,82,12,22,34
47,8480009,Eeli Tolvanen,R,SEA,25,82,12,22,34
47,8475218,Mattias Ekholm,D,EDM,34,82,10,24,34
47,8478472,Mathieu Joseph,R,OTT,27,82,9,25,34
47,8482117,Lukas Reichel,L,CHI,22,82,7,27,34
47,8478178,Darren Raddysh,D,TBL,28,82,6,28,34
47,8483471,Brad Lambert,C,WPG,31,82,3,31,34
47,8477944,Jakub Vrana,L,STL,28,82,23,10,33
47,8484144,Connor Bedard,C,CHI,19,82,19,14,33
47,8482702,Logan Stankoven,C,DAL,21,82,18,15,33
47,8478463,Anthony Beauvillier,L,NSH,27,82,16,17,33
47,8484166,Adam Fantilli,C,CBJ,20,82,14,19,33
47,8476461,Sean Couturier,C,PHI,32,82,12,21,33
47,8483445,Cutter Gauthier,L,ANA,20,82,11,22,33
47,8474149,Evgenii Dadonov,R,DAL,35,82,10,23,33
47,8478891,Mason Appleton,C,WPG,28,82,10,23,33
47,8481013,Jonatan Berggren,R,DET,24,82,9,24,33
47,8482105,Jake Sanderson,D,OTT,22,82,8,25,33
47,8476329,Travis Boyd,C,ARI,31,82,8,25,33
47,8476480,Vladislav Namestnikov,C,WPG,32,82,7,26,33
47,8481560,Arthur Kaliyev,R,LAK,23,82,21,11,32
47,8482175,JJ Peterka,R,BUF,22,82,20,12,32
47,8476438,Brandon Saad,L,STL,32,82,19,13,32
47,8482089,Jake Neighbours,L,STL,22,82,16,16,32
47,8481704,Juuso Parssinen,C,NSH,23,82,16,16,32
47,8477450,Jason Dickinson,C,CHI,29,82,16,16,32
47,8477953,Kasperi Kapanen,R,STL,28,82,12,20,32
47,8477429,Andrew Copp,C,DET,30,82,12,20,32
47,8480145,Neal Pionk,D,WPG,29,82,6,26,32
47,8483457,Lane Hutson,D,MTL,20,82,3,29,32
47,8473422,Nick Foligno,L,CHI,37,82,17,14,31
47,8475149,Marcus Johansson,L,MIN,34,82,15,16,31
47,8478458,Jack Roslovic,C,NYR,27,82,12,19,31
47,8482133,Thomas Bordeleau,C,SJS,22,82,12,19,31
47,8483505,Matthew Poitras,C,BOS,20,82,12,19,31
47,8480113,Alex Iafallo,L,WPG,31,82,11,20,31
47,8476792,Torey Krug,D,STL,33,82,7,24,31
47,8480043,Timothy Liljegren,D,TOR,25,82,4,27,31
47,8476923,Damon Severson,D,CBJ,30,82,0,31,31
47,8477476,Artturi Lehkonen,L,COL,29,82,18,12,30
47,8482101,Danil Gushchin,L,SJS,22,82,18,12,30
47,8477426,Nicholas Paul,L,TBL,29,82,15,15,30
47,8475793,Ryan Johansen,C,PHI,32,82,15,15,30
47,8477498,Darnell Nurse,D,EDM,29,82,15,15,30
47,8471218,Blake Wheeler,R,NYR,38,82,14,16,30
47,8476873,Mark Jankowski,C,NSH,30,82,14,16,30
47,8477952,Robby Fabbri,C,DET,28,82,13,17,30
47,8481481,Blake Lizotte,C,LAK,27,82,12,18,30
47,8476419,Jean-Gabriel Pageau,C,NYI,32,82,11,19,30
47,8479977,Kailer Yamamoto,R,SEA,26,82,11,19,30
47,8474053,Logan Couture,C,SJS,35,82,10,20,30
47,8482125,Alexander Holtz,R,NJD,22,82,10,20,30
47,8481553,Bobby Brink,R,PHI,23,82,9,21,30
47,8482624,Daniil Miromanov,D,CGY,27,82,7,23,30
47,8480873,Rasmus Sandin,D,WSH,24,82,5,25,30
47,8476958,Jaccob Slavin,D,CAR,30,82,4,26,30
47,8475714,Calle Jarnkrok,C,TOR,33,82,16,13,29
47,8481554,Kaapo Kakko,R,NYR,23,82,15,14,29
47,8473449,Kyle Okposo,R,FLA,36,82,14,15,29
47,8478057,Dakota Joshua,C,VAN,28,82,12,17,29
47,8479514,Rem Pitlick,C,CHI,27,82,12,17,29
47,8479992,Michael Rasmussen,C,DET,25,82,12,17,29
47,8476872,Scott Laughton,C,PHI,30,82,11,18,29
47,8479415,Michael McLeod,C,NJD,26,82,10,19,29
47,8474715,Cam Atkinson,R,PHI,35,82,10,19,29
47,8474189,Lars Eller,C,PIT,35,82,8,21,29
47,8483490,Pavel Mintyukov,D,ANA,21,82,7,22,29
47,8479351,Sam Steel,C,DAL,26,82,6,23,29
47,8476892,Colton Parayko,D,STL,31,82,5,24,29
47,8481703,Valtteri Puustinen,R,PIT,25,82,5,24,29
47,8480796,Martin Fehervary,D,WSH,25,82,5,24,29
47,8482122,Brock Faber,D,MIN,22,82,4,25,29
47,8476854,Hampus Lindholm,D,BOS,30,82,3,26,29
47,8482733,Logan Mailloux,D,MTL,31,82,2,27,29
47,8478474,Lawson Crouse,L,ARI,27,82,17,11,28
47,8481604,Pavel Dorofeyev,L,VGK,24,82,16,12,28
47,8477330,Dominik Kubalik,L,OTT,29,82,16,12,28
47,8474884,Mike Hoffman,C,SJS,35,82,14,14,28
47,8481186,Logan O'Connor,R,COL,28,82,14,14,28
47,8479996,Cody Glass,C,NSH,25,82,14,14,28
47,8476469,Joel Armia,R,MTL,31,82,14,14,28
47,8480459,Pius Suter,C,VAN,28,82,12,16,28
47,8478020,Michael Amadio,C,VGK,28,82,12,16,28
47,8476463,Jonas Brodin,D,MIN,31,82,10,18,28
47,8481517,Brett Leason,R,ANA,25,82,10,18,28
47,8477998,Warren Foegele,L,EDM,28,82,9,19,28
47,8480336,Sean Walker,D,COL,30,82,8,20,28
47,8476927,Teddy Blueger,C,VAN,30,82,6,22,28
47,8477969,Marcus Pettersson,D,PIT,28,82,6,22,28
47,8481524,Bowen Byram,D,BUF,23,82,6,22,28
47,8475171,Oliver Ekman-Larsson,D,FLA,33,82,6,22,28
47,8476917,Adam Pelech,D,NYI,30,82,5,23,28
47,8474716,Jared Spurgeon,D,MIN,35,82,3,25,28
47,8475753,Justin Faulk,D,STL,32,82,2,26,28
47,8482118,Sam Colangelo,R,ANA,23,82,19,8,27
47,8483431,Logan Cooley,C,ARI,20,82,16,11,27
47,8479316,Luke Kunin,C,SJS,27,82,16,11,27
47,8480821,Filip Zadina,R,SJS,25,82,14,13,27
47,8476925,Colton Sissons,C,NSH,31,82,13,14,27
47,8480813,Joe Veleno,C,DET,24,82,13,14,27
47,8473563,Nicklas Backstrom,C,WSH,37,82,12,15,27
47,8479591,Michael Eyssimont,C,TBL,28,82,12,15,27
47,8473533,Jordan Staal,C,CAR,36,82,11,16,27
47,8480871,Adam Boqvist,D,CBJ,24,82,8,19,27
47,8482720,Matthew Knies,L,TOR,22,82,8,19,27
47,8477506,Ryan Pulock,D,NYI,30,82,6,21,27
47,8478882,Vladislav Gavrikov,D,LAK,29,82,5,22,27
47,8475181,Nick Leddy,D,STL,33,82,5,22,27
47,8475188,Brayden McNabb,D,VGK,33,82,5,22,27
47,8482145,Mavrik Bourque,C,DAL,22,82,22,4,26
47,8482809,Jackson Blake,R,CAR,21,82,17,9,26
47,8478831,Kevin Stenlund,C,FLA,28,82,16,10,26
47,8478013,Jake Walman,D,DET,28,82,15,11,26
47,8470621,Corey Perry,R,EDM,39,82,13,13,26
47,8479661,Tanner Jeannot,L,TBL,27,82,11,15,26
47,8477839,Conor Sheary,L,TBL,32,82,11,15,26
47,8476979,Erik Gustafsson,D,NYR,32,82,10,16,26
47,8476921,Jordan Martinook,L,CAR,32,82,10,16,26
47,8482111,Justin Barron,D,MTL,23,82,10,16,26
47,8481656,Aliaksei Protas,C,WSH,23,82,9,17,26
47,8474009,Nick Bonino,C,NYR,36,82,8,18,26
47,8484145,Zach Benson,L,BUF,19,82,8,18,26
47,8479983,Mario Ferraro,D,SJS,26,82,6,20,26
47,8482142,Jamie Drysdale,D,PHI,22,82,5,21,26
47,8481568,Alex Vlasic,D,CHI,23,82,2,24,26
47,8476960,Andreas Athanasiou,C,CHI,30,82,11,14,25
47,8480074,Alexandre Texier,C,CBJ,25,82,11,14,25
47,8478043,Sam Lafferty,C,VAN,29,82,10,15,25
47,8477507,Nikita Zadorov,D,VAN,29,82,9,16,25
47,8478507,John Marino,D,NJD,27,82,5,20,25
47,8475200,Dmitry Orlov,D,CAR,33,82,5,20,25
47,8479371,Dante Fabbro,D,NSH,26,82,5,20,25
47,8478840,Will Borgen,D,SEA,28,82,4,21,25
47,8479369,Andrew Peeke,D,BOS,26,82,0,25,25
47,8475760,Nick Bjugstad,C,ARI,32,82,15,9,24
47,8477369,Carson Soucy,D,VAN,30,82,11,13,24
47,8484153,Leo Carlsson,C,ANA,20,82,10,14,24
47,8482679,Matt Coronato,R,CGY,22,82,10,14,24
47,8478430,Oliver Kylington,D,CGY,27,82,10,14,24
47,8480068,Ryan Poehling,C,PHI,25,82,8,16,24
47,8479398,Samuel Girard,D,COL,26,82,8,16,24
47,8480073,Erik Brannstrom,D,OTT,25,82,8,16,24
47,8478046,Danton Heinen,L,BOS,29,82,7,17,24
47,8482092,Ridly Greig,C,OTT,22,82,7,17,24
47,8476442,Matt Nieto,L,PIT,32,82,7,17,24
47,8481606,Jordan Spence,D,LAK,23,82,6,18,24
47,8476891,Matt Grzelcyk,D,BOS,30,82,6,18,24
47,8479324,Ryan Lindgren,D,NYR,26,82,5,19,24
47,8481537,Nikita Okhotiuk,D,CGY,24,82,5,19,24
47,8481477,Nico Sturm,C,SJS,29,82,3,21,24
47,8479393,Noah Gregor,C,TOR,26,82,13,10,23
47,8477508,Curtis Lazar,C,NJD,29,82,11,12,23
47,8473504,Cal Clutterbuck,R,NYI,37,82,10,13,23
47,8482074,Connor Zary,C,CGY,23,82,9,14,23
47,8476902,Esa Lindell,D,DAL,30,82,7,16,23
47,8483565,Nick Blankenburg,D,CBJ,26,82,7,16,23
47,8478911,Matt Roy,D,LAK,29,82,5,18,23
47,8480058,Pierre-Olivier Joseph,D,PIT,25,82,5,18,23
47,8483499,Liam Ohgren,L,MIN,20,82,15,7,22
47,8476878,Zemgus Girgensons,L,BUF,30,82,13,9,22
47,8484203,Bradly Nadeau,L,CAR,19,82,12,10,22
47,8476871,Tanner Pearson,L,MTL,32,82,11,11,22
47,8475220,Marcus Foligno,L,MIN,33,82,11,11,22
47,8482737,Zack Bolduc,C,STL,21,82,11,11,22
47,8476897,Oskar Sundqvist,C,STL,30,82,9,13,22
47,8481601,Simon Holmstrom,R,NYI,23,82,8,14,22
47,8483495,Simon Nemec,D,NJD,20,82,7,15,22
47,8479976,Juuso Valimaki,D,ARI,26,82,4,18,22
47,8480807,Mattias Samuelsson,D,BUF,24,82,4,18,22
47,8481605,Jackson LaCombe,D,ANA,23,82,1,21,22
47,8479941,Justin Danforth,R,CBJ,31,82,16,5,21
47,8470610,Zach Parise,L,COL,40,82,10,11,21
47,8474870,Tyler Johnson,C,CHI,34,82,10,11,21
47,8478569,Noel Acciari,C,PIT,33,82,10,11,21
47,8479353,Brett Howden,C,VGK,26,82,10,11,21
47,8483491,Ivan Miroshnichenko,L,WSH,20,82,9,12,21
47,8476312,Josh Manson,D,COL,33,82,8,13,21
47,8474574,Tyler Myers,D,VAN,34,82,7,14,21
47,8482803,Olen Zellweger,D,ANA,21,82,7,14,21
47,8479383,Boris Katchouk,L,OTT,26,82,7,14,21
47,8478468,Jeremy Lauzon,D,NSH,27,82,6,15,21
47,8481014,Alexander Romanov,D,NYI,24,82,5,16,21
47,8476422,Mike Reilly,D,NYI,31,82,4,17,21
47,8474673,TJ Brodie,D,TOR,34,82,1,20,21
47,8481093,Rafael Harvey-Pinard,L,MTL,25,82,11,9,20
47,8479346,Dillon Dube,C,CGY,26,82,9,11,20
47,8477488,Brett Pesce,D,CAR,30,82,8,12,20
47,8476525,Colin Miller,D,WPG,32,82,7,13,20
47,8474034,Pat Maroon,L,BOS,36,82,6,14,20
47,8482858,Ryker Evans,D,SEA,23,82,4,16,20
47,8478443,Brandon Carlo,D,BOS,28,82,4,16,20
47,8475231,Casey Cizikas,C,NYI,33,82,4,16,20
47,8476931,Jake McCabe,D,TOR,31,82,3,17,20
47,8482073,Braden Schneider,D,NYR,23,82,3,17,20
47,8474151,Ryan McDonagh,D,NSH,35,82,2,18,20
47,8478851,Alexandre Carrier,D,NSH,28,82,2,18,20
47,8480980,Connor Dewar,C,TOR,25,82,12,7,19
47,8482666,Scott Morrow,D,CAR,22,82,11,8,19
47,8482155,Alex Laferriere,R,LAK,23,82,9,10,19
47,8475279,Ben Chiarot,D,DET,33,82,9,10,19
47,8481028,Martin Pospisil,C,CGY,25,82,9,10,19
47,8475842,Sam Carrick,C,EDM,32,82,8,11,19
47,8477015,Connor Brown,R,EDM,30,82,7,12,19
47,8476374,Sean Kuraly,C,CBJ,31,82,6,13,19
47,8476331,Dylan DeMelo,D,WPG,31,82,5,14,19
47,8477435,Ryan Graves,D,PIT,29,82,5,14,19
47,8480144,David Kampf,C,TOR,29,82,5,14,19
47,8475462,Radko Gudas,D,ANA,34,82,5,14,19
47,8482655,J.J. Moser,D,ARI,24,82,4,15,19
47,8480860,Kevin Bahl,D,NJD,24,82,4,15,19
47,8476967,Brett Kulak,D,EDM,30,82,3,16,19
47,8476457,Adam Larsson,D,SEA,32,82,2,17,19
47,8482087,Kaiden Guhle,D,MTL,22,82,2,17,19
47,8470600,Ryan Suter,D,DAL,39,82,2,17,19
47,8483493,Frank Nazar,C,CHI,20,82,11,7,18
47,8477353,Tyler Motte,C,TBL,29,82,10,8,18
47,8475343,Nic Dowd,C,WSH,34,82,8,10,18
47,8478109,Victor Olofsson,L,BUF,29,82,8,10,18
47,8480281,Alexey Toropchenko,R,STL,25,82,8,10,18
47,8477931,Tomas Nosek,L,NJD,32,82,8,10,18
47,8482259,Bobby McMann,C,TOR,28,82,7,11,18
47,8479359,Beck Malenstyn,L,WSH,26,82,7,11,18
47,8481580,Connor McMichael,C,WSH,23,82,6,12,18
47,8482079,Marco Rossi,C,MIN,23,82,6,12,18
47,8477406,Mattias Janmark,C,EDM,32,82,5,13,18
47,8475762,Derek Forbort,D,BOS,32,82,5,13,18
47,8476879,Cody Ceci,D,EDM,31,82,4,14,18
47,8475455,Brenden Dillon,D,WPG,34,82,3,15,18
47,8479998,Mikey Anderson,D,LAK,25,82,3,15,18
47,8477499,Rasmus Ristolainen,D,PHI,30,82,8,9,17
47,8477392,Hudson Fasching,R,NYI,29,82,6,11,17
47,8477220,Nate Schmidt,D,WPG,33,82,5,12,17
47,8480246,Nick Perbix,D,TBL,26,82,4,13,17
47,8482245,Artem Zub,D,OTT,29,82,4,13,17
47,8477845,Trevor van Riemsdyk,D,WSH,33,82,3,14,17
47,8480879,Jacob Bernard-Docker,D,OTT,24,82,2,15,17
47,8475764,Cam Fowler,D,ANA,33,82,1,16,17
47,8473507,Jeff Petry,D,DET,37,82,1,16,17
47,8480448,Parker Kelly,L,OTT,25,82,10,6,16
47,8475790,Erik Gudbranson,D,CBJ,32,82,6,10,16
47,8476467,Jamie Oleksiak,D,SEA,32,82,5,11,16
47,8483466,Kevin Korchinski,D,CHI,20,82,5,11,16
47,8480806,Isac Lundestrom,C,ANA,25,82,4,12,16
47,8475825,Jani Hakanpää,D,DAL,32,82,4,12,16
47,8479980,Nicolas Hague,D,VGK,26,82,3,13,16
47,8475179,Dmitry Kulikov,D,FLA,34,82,2,14,16
47,8481567,Henry Thrun,D,SJS,23,82,2,14,16
47,8475690,Chris Tanev,D,DAL,35,82,1,15,16
47,8474166,Alec Martinez,D,VGK,37,82,1,15,16
47,8482062,Cole Smith,L,NSH,29,82,9,6,15
47,8475164,Jakob Silfverberg,R,ANA,34,82,6,9,15
47,8482730,Brandt Clarke,D,LAK,21,82,5,10,15
47,8483482,Tristan Luneau,D,ANA,20,82,5,10,15
47,8479442,Troy Stecher,D,EDM,30,82,5,10,15
47,8477919,Frederick Gaudreau,C,MIN,31,82,4,11,15
47,8476429,Scott Mayfield,D,NYI,32,82,3,12,15
47,8478136,Jake Middleton,D,MIN,28,82,3,12,15
47,8478416,Erik Cernak,D,TBL,27,82,3,12,15
47,8480172,Jan Rutta,D,SJS,34,82,2,13,15
47,8477365,Connor Clifton,D,BUF,29,82,2,13,15
47,8479291,Kevin Rooney,C,CGY,31,82,5,9,14
47,8481522,Peyton Krebs,C,BUF,23,82,4,10,14
47,8474013,Ian Cole,D,VAN,35,82,4,10,14
47,8475177,Calvin de Haan,D,TBL,33,82,2,12,14
47,8470966,Mark Giordano,D,TOR,41,82,2,12,14
47,8478399,Jonas Siegenthaler,D,NJD,27,82,1,13,14
47,8474567,Zach Bogosian,D,MIN,34,82,1,13,14
47,8478451,Ethan Bear,D,WSH,27,82,3,10,13
47,8477505,Alexander Wennberg,C,NYR,30,82,3,10,13
47,8476473,Connor Murphy,D,CHI,31,82,2,11,13
47,8475208,Brian Dumoulin,D,SEA,33,82,1,12,13
47,8482516,Matthew Kessel,D,STL,24,82,1,12,13
47,8481578,Graeme Clarke,R,NJD,23,82,6,6,12
47,8482713,Mackie Samoskevich,R,FLA,22,82,6,6,12
47,8475233,David Savard,D,MTL,34,82,2,10,12
47,8482712,Oskar Olausson,R,COL,22,82,1,11,12
47,8471677,Jack Johnson,D,COL,37,82,1,11,12
47,8483012,Logan Morrison,C,SEA,22,82,7,4,11
47,8476858,Phillip Di Giuseppe,L,VAN,31,82,6,5,11
47,8476278,Colin Blackwell,C,CHI,31,82,5,6,11
47,8476372,Nick Seeler,D,PHI,31,82,4,7,11
47,8476624,Barclay Goodrow,C,NYR,31,82,3,8,11
47,8482166,Shakir Mukhamadullin,D,SJS,22,82,3,8,11
47,8477335,Kyle Burroughs,D,SJS,29,82,3,8,11
47,8482470,Ilya Solovyov,D,CGY,24,82,3,8,11
47,8480035,Henri Jokiharju,D,BUF,25,82,2,9,11
47,8475324,Nick Jensen,D,WSH,34,82,1,10,11
47,8482177,Marat Khusnutdinov,C,MIN,22,82,1,10,11
47,8473453,Trevor Lewis,C,LAK,37,82,5,5,10
47,8481178,Egor Zamula,D,PHI,24,82,2,8,10
47,8481599,Victor Soderstrom,D,ARI,23,82,1,9,10
47,8478859,Niko Mikkola,D,FLA,28,82,0,10,10
47,8482762,Simon Edvinsson,D,DET,21,82,7,2,9
47,8476822,Luke Glendening,C,TBL,35,82,6,3,9
47,8483468,Jiri Kulich,C,BUF,20,82,3,6,9
47,8480834,Ty Emberson,D,SJS,24,82,1,8,9
47,8481059,Scott Perunovich,D,STL,26,82,1,8,9
47,8484149,Gavin Brindley,C,CBJ,20,82,3,5,8
47,8480990,Declan Chisholm,D,MIN,24,82,2,6,8
47,8482859,Zack Ostapchuk,C,OTT,21,82,2,6,8
47,8484911,Collin Graf,R,SJS,22,82,1,7,8
47,8482807,Ethan Del Mastro,D,CHI,21,82,1,7,8
47,8476915,Jujhar Khaira,L,MIN,30,82,5,2,7
47,8483763,Maksymilian Szuber,D,ARI,22,82,3,4,7
47,8481030,Jack St. Ivany,D,PIT,25,82,2,5,7
47,8477034,Jaycob Megna,D,CHI,32,82,0,7,7
47,8478408,Travis Dermott,D,ARI,28,82,0,7,7
47,8483489,Fraser Minten,C,TOR,31,82,2,1,3
47,8482141,Lukas Cormier,D,VGK,22,0,0,0,0
47,8476988,Matt Benning,D,SJS,30,0,0,0,0
47,8480727,Zach Whitecloud,D,VGK,28,0,0,0,0
47,8480887,Jordan Harris,D,MTL,24,0,0,0,0
47,8478450,Parker Wotherspoon,D,BOS,27,0,0,0,0
47,8481812,Nikolai Knyzhov,D,SJS,27,0,0,0,0
47,8480001,Urho Vaakanainen,D,ANA,25,0,0,0,0
47,8482176,Wyatt Kaiser,D,CHI,22,0,0,0,0
47,8481122,Simon Benoit,D,TOR,26,0,0,0,0
47,8476441,Joel Edmundson,D,TOR,31,0,0,0,0
47,8480884,Calen Addison,D,SJS,24,0,0,0,0
47,8482511,Mason Lohrei,D,BOS,23,0,0,0,0
47,8482192,Isaak Phillips,D,CHI,23,0,0,0,0
47,8480950,Ilya Lyubushkin,D,TOR,30,0,0,0,0
47,8474031,Kevin Shattenkirk,D,BOS,35,0,0,0,0
47,8475718,Justin Holl,D,DET,32,0,0,0,0
47,8479402,Jake Bean,D,CBJ,26,0,0,0,0
47,8474602,Justin Schultz,D,SEA,34,0,0,0,0
47,8477950,Tony DeAngelo,D,CAR,29,0,0,0,0
47,8481743,Marc Del Gaizo,D,NSH,25,0,0,0,0
47,8481527,Kaedan Korczak,D,VGK,23,0,0,0,0
47,8480192,Johnathan Kovacevic,D,MTL,27,0,0,0,0
47,8476874,Olli Maatta,D,DET,30,0,0,0,0
47,8482144,Jack Thompson,D,SJS,22,0,0,0,0
47,8480222,Sebastian Aho,D,NYI,28,0,0,0,0
47,8479458,Nikita Zaitsev,D,CHI,33,0,0,0,0
47,8471709,Marc-Edouard Vlasic,D,SJS,37,0,0,0,0
47,8482929,Emil Lilleberg,D,TBL,23,0,0,0,0
47,8477018,Ben Hutton,D,VGK,31,0,0,0,0
47,8481056,Spencer Stastney,D,NSH,24,0,0,0,0
47,8481593,Jayden Struble,D,MTL,23,0,0,0,0
47,8479982,Conor Timmins,D,TOR,26,0,0,0,0
47,8474090,Brendan Smith,D,NJD,35,0,0,0,0
47,8482964,Arber Xhekaj,D,MTL,23,0,0,0,0
47,8480891,Michael Kesselring,D,ARI,24,0,0,0,0
47,8477938,Haydn Fleury,D,TBL,28,0,0,0,0
47,8481806,Louis Crevier,D,CHI,23,0,0,0,0
47,8471274,Alex Goligoski,D,MIN,39,0,0,0,0
47,8481600,Tobias Bjornfot,D,FLA,23,0,0,0,0
47,8475797,Jarred Tinordi,D,CHI,32,0,0,0,0
47,8481521,Ronnie Attard,D,PHI,25,0,0,0,0
47,8474612,Travis Hamonic,D,OTT,34,0,0,0,0
47,8479576,Vincent Desharnais,D,EDM,28,0,0,0,0
47,8480049,Dylan Samberg,D,WPG,25,0,0,0,0
47,8483619,Filip Roos,D,CHI,25,0,0,0,0
47,8474568,Luke Schenn,D,NSH,35,0,0,0,0
47,8480184,Gustav Lindstrom,D,ANA,26,0,0,0,0
47,8480070,Ian Mitchell,D,BOS,25,0,0,0,0
47,8480196,Jacob Bryson,D,BUF,27,0,0,0,0
47,8471686,Marc Staal,D,PHI,37,0,0,0,0
47,8477467,Gustav Olofsson,D,SEA,30,0,0,0,0
47,8478970,Jalen Chatfield,D,CAR,28,0,0,0,0
47,8479348,Kale Clague,D,BUF,26,0,0,0,0
47,8473446,Erik Johnson,D,PHI,36,0,0,0,0
47,8477462,Robert Hagg,D,ANA,29,0,0,0,0
47,8478454,Noah Juulsen,D,VAN,27,0,0,0,0
47,8477384,Josh Brown,D,ARI,30,0,0,0,0
47,8481708,Zac Jones,D,NYR,24,0,0,0,0
47,8481167,Brayden Pachal,D,CGY,25,0,0,0,0
47,8482067,Connor Mackey,D,NYR,28,0,0,0,0
47,8483460,David Jiricek,D,CBJ,21,0,0,0,0
47,8481701,Santeri Hatakka,D,NJD,23,0,0,0,0
47,8478021,William Lagesson,D,ANA,28,0,0,0,0
47,8477851,Jordan Oesterle,D,CGY,32,0,0,0,0
47,8478452,Caleb Jones,D,COL,27,0,0,0,0
47,8479984,Cal Foote,D,NJD,26,0,0,0,0
47,8479639,Dylan Coghlan,D,CAR,26,0,0,0,0
47,8480874,Adam Ginning,D,PHI,24,0,0,0,0
47,8479321,Lucas Johansen,D,WSH,27,0,0,0,0
47,8480878,Nils Lundkvist,D,DAL,24,0,0,0,0
47,8482165,Yan Kuznetsov,D,CGY,22,0,0,0,0
47,8484258,Sam Malinski,D,COL,26,0,0,0,0
47,8480157,Calle Rosen,D,STL,30,0,0,0,0
47,8484304,Uvis Balinskis,D,FLA,28,0,0,0,0
47,8479985,Cale Fleury,D,SEA,26,0,0,0,0
47,8479378,Logan Stanley,D,WPG,26,0,0,0,0
47,8477541,Dakota Mermis,D,MIN,30,0,0,0,0
47,8481609,Vladislav Kolyachonok,D,ARI,23,0,0,0,0
47,8480823,Alexander Alexeyev,D,WSH,25,0,0,0,0
47,8481679,Maxence Guenette,D,OTT,23,0,0,0,0
47,8481564,Ryan Johnson,D,BUF,23,0,0,0,0
47,8479376,Victor Mete,D,PHI,26,0,0,0,0
47,8484254,Akito Hirose,D,VAN,25,0,0,0,0
47,8482660,Kent Johnson,C,CBJ,22,0,0,0,0
47,8482149,Cole Perfetti,C,WPG,22,0,0,0,0
47,8477987,Ryan Donato,C,CHI,28,0,0,0,0
47,8475755,Alexander Petrovic,D,DAL,32,0,0,0,0
47,8477810,Joel Hanley,D,CGY,33,0,0,0,0
47,8474145,Robert Bortuzzo,D,NYI,35,0,0,0,0
47,8481161,Jake Christiansen,D,CBJ,25,0,0,0,0
47,8476884,Derrick Pouliot,D,DAL,30,0,0,0,0
47,8481716,Dmitri Voronkov,L,CBJ,24,0,0,0,0
47,8480084,Nick DeSimone,D,NJD,30,0,0,0,0
47,8475750,Jon Merrill,D,MIN,32,0,0,0,0
47,8479315,Joey Anderson,R,CHI,26,0,0,0,0
47,8478011,Louie Belpedio,D,PHI,28,0,0,0,0
47,8482451,Mikael Pyyhtia,L,CBJ,23,0,0,0,0
47,8481541,Samuel Bolduc,D,NYI,24,0,0,0,0
47,8482126,Emil Andrae,D,PHI,31,0,0,0,0
47,8474618,Marco Scandella,D,STL,34,0,0,0,0
47,8477244,Chad Ruhwedel,D,NYR,34,0,0,0,0
47,8477971,Andreas Englund,D,LAK,28,0,0,0,0
47,8480829,Jesperi Kotkaniemi,C,CAR,24,0,0,0,0
47,8479372,Josh Mahura,D,FLA,26,0,0,0,0
47,8482095,Tyler Kleven,D,OTT,22,0,0,0,0
47,8481719,Maxwell Crozier,D,TBL,24,0,0,0,0
47,8475855,Jesper Fast,R,CAR,33,0,0,0,0
47,8480848,Ty Dellandrea,C,DAL,24,0,0,0,0
47,8475193,Tomas Tatar,L,SEA,34,0,0,0,0
47,8476889,Radek Faksa,C,DAL,30,0,0,0,0
47,8478495,Denis Gurianov,R,PHI,27,0,0,0,0
47,8480216,Jacob Peterson,C,SJS,25,0,0,0,0
47,8480252,Cole Guttman,C,CHI,25,0,0,0,0
47,8479026,Philippe Myers,D,TBL,27,0,0,0,0
47,8481006,Tyler Tucker,D,STL,24,0,0,0,0
47,8481032,Paul Cotter,C,VGK,25,0,0,0,0
47,8481577,Philip Tomasino,C,NSH,23,0,0,0,0
47,8476918,Jimmy Vesey,L,NYR,31,0,0,0,0
47,8479320,Max Lajoie,D,TOR,27,0,0,0,0
47,8478017,Mark Friedman,D,VAN,29,0,0,0,0
47,8481754,Nikita Nesterenko,C,ANA,23,0,0,0,0
47,8483407,Brandon Scanlin,D,NYR,25,0,0,0,0
47,8482659,Josh Doan,R,ARI,22,0,0,0,0
47,8477446,Michael McCarron,R,NSH,29,0,0,0,0
47,8477903,Garnet Hathaway,R,PHI,33,0,0,0,0
47,8482153,Brendan Brisson,C,VGK,23,0,0,0,0
47,8483546,Marshall Rifai,D,TOR,26,0,0,0,0
47,8484287,Cole McWard,D,VAN,23,0,0,0,0
47,8478854,Ryan Shea,D,PIT,27,0,0,0,0
47,8481585,Egor Afanasyev,L,NSH,23,0,0,0,0
47,8483398,Declan Carlile,D,TBL,31,0,0,0,0
47,8478502,Dennis Gilbert,D,CGY,28,0,0,0,0
47,8482749,Joshua Roy,R,MTL,21,0,0,0,0
47,8481598,Philip Broberg,D,EDM,23,0,0,0,0
47,8480835,Jack Drury,C,CAR,24,0,0,0,0
47,8480748,Kiefer Sherwood,L,NSH,29,0,0,0,0
47,8476934,Brock McGinn,L,ANA,30,0,0,0,0
47,8480870,Bo Groulx,C,ANA,24,0,0,0,0
47,8479368,Max Jones,L,ANA,26,0,0,0,0
47,8478099,Kevin Labanc,R,SJS,29,0,0,0,0
47,8478067,Oskar Lindblom,L,SJS,28,0,0,0,0
47,8476393,Nick Cousins,C,FLA,31,0,0,0,0
47,8483395,Arshdeep Bains,L,VAN,23,0,0,0,0
47,8480762,Eric Robinson,L,BUF,29,0,0,0,0
47,8479439,Jacob MacDonald,D,SJS,31,0,0,0,0
47,8476474,Stefan Noesen,R,CAR,31,0,0,0,0
47,8482787,Nikita Chibrikov,R,WPG,31,0,0,0,0
47,8478432,Christian Fischer,R,DET,27,0,0,0,0
47,8477979,Nicolas Aube-Kubel,R,WSH,28,0,0,0,0
47,8481789,Tye Kartye,L,SEA,23,0,0,0,0
47,8479330,Brandon Gignac,C,MTL,27,0,0,0,0
47,8480075,Cameron Crotty,D,ARI,25,0,0,0,0
47,8473473,Milan Lucic,L,BOS,36,0,0,0,0
47,8482094,Daemon Hunt,D,MIN,22,0,0,0,0
47,8481206,John Ludvig,D,PIT,24,0,0,0,0
47,8483630,Pavol Regenda,L,ANA,25,0,0,0,0
47,8481617,Vasily Podkolzin,R,VAN,23,0,0,0,0
47,8480306,Grant Hutton,D,NYI,29,0,0,0,0
47,8480995,Pontus Holmberg,R,TOR,25,0,0,0,0
47,8482148,Hendrix Lapierre,C,WSH,22,0,0,0,0
47,8477478,William Carrier,L,VGK,30,0,0,0,0
47,8480003,Jesper Boqvist,C,BOS,26,0,0,0,0
47,8482172,Landon Slaggert,L,CHI,22,0,0,0,0
47,8480789,Oliver Wahlstrom,R,NYI,24,0,0,0,0
47,8474062,Riley Nash,C,NYR,35,0,0,0,0
47,8480021,Jack Studnicka,C,SJS,25,0,0,0,0
47,8480025,MacKenzie Entwistle,R,CHI,25,0,0,0,0
47,8481582,Nicholas Robertson,L,TOR,23,0,0,0,0
47,8476867,Brendan Gaunce,C,CBJ,30,0,0,0,0
47,8479619,Michael Carcone,L,ARI,28,0,0,0,0
47,8479370,Tyson Jost,C,BUF,26,0,0,0,0
47,8479671,Mathieu Olivier,R,CBJ,27,0,0,0,0
47,8476994,Vinnie Hinostroza,C,PIT,30,0,0,0,0
47,8482070,Mitchell Chaffee,R,TBL,26,0,0,0,0
47,8477473,Justin Bailey,R,SJS,29,0,0,0,0
47,8479344,Jesse Puljujarvi,R,PIT,26,0,0,0,0
47,8480205,Emil Bemstrom,C,PIT,25,0,0,0,0
47,8479718,Alex Barré-Boulet,C,TBL,27,0,0,0,0
47,8482061,Brandon Biro,L,BUF,26,0,0,0,0
47,8479638,Justin Brazeau,R,BOS,26,0,0,0,0
47,8474040,Sam Gagner,C,EDM,35,0,0,0,0
47,8477846,Ryan Carpenter,C,SJS,33,0,0,0,0
47,8482077,Dylan Holloway,L,EDM,23,0,0,0,0
47,8482157,Will Cuylle,L,NYR,22,0,0,0,0
47,8480007,Jonas Rondbjerg,R,VGK,25,0,0,0,0
47,8478874,Adam Gaudette,C,STL,28,0,0,0,0
47,8478434,Keegan Kolesar,R,VGK,27,0,0,0,0
47,8480441,Trey Fix-Wolansky,R,CBJ,25,0,0,0,0
47,8479994,Jaret Anderson-Dolan,C,NSH,25,0,0,0,0
47,8483567,Georgii Merkulov,C,BOS,24,0,0,0,0
47,8477380,Jonny Brodzinski,C,NYR,31,0,0,0,0
47,8482201,Gage Goncalves,C,TBL,23,0,0,0,0
47,8478211,Dryden Hunt,L,CGY,29,0,0,0,0
47,8471699,Andrew Cogliano,C,COL,37,0,0,0,0
47,8479421,Jacob Moverare,D,LAK,26,0,0,0,0
47,8478881,Brett Seney,L,CHI,28,0,0,0,0
47,8477464,Nic Petan,C,MIN,29,0,0,0,0
47,8475958,Michael Sgarbossa,C,WSH,32,0,0,0,0
47,8481147,Reese Johnson,C,CHI,26,0,0,0,0
47,8479336,Carl Grundstrom,R,LAK,27,0,0,0,0
47,8480853,Liam Foudy,C,NSH,24,0,0,0,0
47,8479522,Hardy Haman Aktell,D,WSH,26,0,0,0,0
47,8481462,Mason Morelli,L,VGK,28,0,0,0,0
47,8482102,Vasily Ponomarev,C,CAR,22,0,0,0,0
47,8480844,Grigori Denisenko,L,VGK,24,0,0,0,0
47,8479944,Zach Aston-Reese,C,DET,30,0,0,0,0
47,8482784,Zach Dean,C,STL,21,0,0,0,0
47,8479419,Brett Murray,L,BUF,26,0,0,0,0
47,8479520,Brandon Duhaime,R,COL,27,0,0,0,0
47,8477573,Nathan Walker,L,STL,30,0,0,0,0
47,8478078,Rourke Chartier,C,OTT,28,0,0,0,0
47,8475795,Dylan McIlrath,D,WSH,32,0,0,0,0
47,8482496,Nils Aman,C,VAN,24,0,0,0,0
47,8480289,Morgan Barron,C,WPG,26,0,0,0,0
47,8481751,Lukas Rousek,R,BUF,25,0,0,0,0
47,8480011,Klim Kostin,C,SJS,25,0,0,0,0
47,8481556,John Beecher,C,BOS,23,0,0,0,0
47,8475278,Byron Froese,C,VGK,33,0,0,0,0
47,8475225,Craig Smith,C,DAL,35,0,0,0,0
47,8484326,Patrik Koch,D,ARI,28,0,0,0,0
47,8477930,Pierre-Edouard Bellemare,L,SEA,39,0,0,0,0
47,8478409,Anthony Richard,C,BOS,28,0,0,0,0
47,8481024,Linus Karlsson,C,VAN,25,0,0,0,0
47,8479986,Kole Lind,R,SEA,26,0,0,0,0
47,8479414,Nathan Bastian,R,NJD,27,0,0,0,0
47,8479362,Riley Tufte,L,COL,26,0,0,0,0
47,8481058,Jesse Ylönen,R,MTL,25,0,0,0,0
47,8482476,Emil Heineman,L,MTL,23,0,0,0,0
47,8482861,Vincent Iorio,D,WSH,22,0,0,0,0
47,8483432,Luca Del Bel Belluz,C,CBJ,31,0,0,0,0
47,8482744,James Malatesta,L,CBJ,21,0,0,0,0
47,8477887,Patrick Brown,C,BOS,32,0,0,0,0
47,8478585,Derek Ryan,C,EDM,38,0,0,0,0
47,8481441,Joe Snively,C,WSH,28,0,0,0,0
47,8481592,Jakob Pelletier,L,CGY,23,0,0,0,0
47,8482634,Alex Steeves,C,TOR,25,0,0,0,0
47,8477126,Jayson Megna,C,BOS,34,0,0,0,0
47,8475752,Tyler Pitlick,C,NYR,33,0,0,0,0
47,8480008,Adam Ruzicka,C,ARI,25,0,0,0,0
47,8481065,Angus Crookshank,L,OTT,25,0,0,0,0
47,8479547,Matthew Phillips,R,WSH,26,0,0,0,0
47,8480226,Marián Studenic,R,SEA,26,0,0,0,0
47,8481237,Kyle MacLean,C,NYI,25,0,0,0,0
47,8475413,Justin Dowling,C,NJD,34,0,0,0,0
47,8481641,Joel Kiviranta,L,COL,28,0,0,0,0
47,8478104,Sammy Blais,L,STL,28,0,0,0,0
47,8477454,Adam Erne,L,EDM,29,0,0,0,0
47,8481518,Nolan Foote,L,NJD,24,0,0,0,0
47,8480245,Olle Lycksell,R,PHI,25,0,0,0,0
47,8483570,Ben Meyers,C,ANA,26,0,0,0,0
47,8480776,Sheldon Rempal,R,VGK,29,0,0,0,0
47,8483920,Pierrick Dube,R,WSH,23,0,0,0,0
47,8480267,Sammy Walker,C,MIN,25,0,0,0,0
47,8482747,Brennan Othmann,L,NYR,21,0,0,0,0
47,8479991,Jake Leschyshyn,C,NYR,25,0,0,0,0
47,8478400,Colin White,C,MTL,27,0,0,0,0
47,8479328,Julien Gauthier,R,NYI,27,0,0,0,0
47,8484325,Waltteri Merela,C,TBL,26,0,0,0,0
47,8479066,Ryan Lomberg,L,FLA,30,0,0,0,0
47,8477070,Liam O'Brien,C,ARI,30,0,0,0,0
47,8478146,Matthew Highmore,C,OTT,28,0,0,0,0
47,8478028,Fredrik Olofsson,L,COL,28,0,0,0,0
47,8480880,Jakub Lauko,C,BOS,24,0,0,0,0
47,8479968,Vinni Lettieri,C,MIN,29,0,0,0,0
47,8474709,Matt Martin,L,NYI,35,0,0,0,0
47,8480845,Rasmus Kupari,C,WPG,24,0,0,0,0
47,8481550,Adam Beckman,L,MIN,23,0,0,0,0
47,8481422,Jacob Lucchini,C,MIN,29,0,0,0,0
47,8477401,John Hayden,C,SEA,29,0,0,0,0
47,8478904,Steven Lorentz,C,FLA,28,0,0,0,0
47,8482088,Justin Sourdif,R,FLA,22,0,0,0,0
47,8482751,Ryan Winterton,C,SEA,21,0,0,0,0
47,8482241,Radim Zohorna,L,PIT,28,0,0,0,0
47,8481690,Tyler Angle,C,CBJ,24,0,0,0,0
47,8476952,Dominic Toninato,C,WPG,30,0,0,0,0
47,8476919,Chris Tierney,C,NJD,30,0,0,0,0
47,8480032,Shane Bowers,C,NJD,25,0,0,0,0
47,8484314,Jiri Smejkal,L,OTT,28,0,0,0,0
47,8481239,Samuel Fagemo,L,LAK,24,0,0,0,0
47,8481532,Alex Turcotte,C,LAK,23,0,0,0,0
47,8481019,David Gustafsson,C,WPG,24,0,0,0,0
47,8478477,Mitchell Stephens,C,MTL,27,0,0,0,0
47,8479546,Oskar Steen,C,BOS,26,0,0,0,0
47,8480292,Carson Meyer,R,CBJ,27,0,0,0,0
47,8478446,Glenn Gawdin,C,ANA,27,0,0,0,0
47,8483531,Brian Halonen,L,NJD,25,0,0,0,0
47,8477149,Scott Sabourin,R,SJS,32,0,0,0,0
47,8479972,Mason Shaw,C,MIN,26,0,0,0,0
47,8480890,Jan Jenik,R,ARI,24,0,0,0,0
47,8478051,Max Willman,C,NJD,29,0,0,0,0
47,8480851,Akil Thomas,C,LAK,24,0,0,0,0
47,8482765,Isak Rosen,R,BUF,21,0,0,0,0
47,8478421,A.J. Greer,L,CGY,28,0,0,0,0
47,8478512,Austin Czarnik,C,DET,32,0,0,0,0
47,8479536,Axel Jonsson-Fjallby,L,WPG,26,0,0,0,0
47,8477320,Anton Blidh,L,NYR,29,0,0,0,0
47,8481543,Nikita Alexandrov,C,STL,24,0,0,0,0
47,8475235,Nicolas Deslauriers,L,PHI,33,0,0,0,0
47,8481070,Hugh McGing,L,STL,26,0,0,0,0
47,8480836,Jonathan Gruden,C,PIT,24,0,0,0,0
47,8481591,Sam Poulin,R,PIT,23,0,0,0,0
47,8477962,Brendan Lemieux,L,CAR,28,0,0,0,0
47,8483401,Marc Johnstone,R,PIT,28,0,0,0,0
47,8482250,Callahan Burke,C,CAR,27,0,0,0,0
47,8481726,Adam Edstrom,C,NYR,24,0,0,0,0
47,8471817,Ryan Reaves,R,TOR,37,0,0,0,0
47,8479587,Rhett Gardner,C,PHI,28,0,0,0,0
47,8475766,Austin Watson,L,TBL,32,0,0,0,0
47,8479367,William Lockwood,R,FLA,26,0,0,0,0
47,8478424,Jansen Harkins,C,PIT,27,0,0,0,0
47,8476913,Devin Shore,C,SEA,30,0,0,0,0
47,8482652,Walker Duehr,R,CGY,27,0,0,0,0
47,8477527,Ross Johnston,L,ANA,30,0,0,0,0
47,8481077,John Leonard,L,ARI,26,0,0,0,0
47,8483549,Lucas Condotta,L,MTL,27,0,0,0,0
47,8480468,James Hamblin,L,EDM,25,0,0,0,0
47,8476907,Mackenzie MacEachern,L,STL,30,0,0,0,0
47,8479543,Michael Pezzetta,L,MTL,26,0,0,0,0
47,8480355,Mark Kastelic,C,OTT,25,0,0,0,0
47,8482162,Roby Jarventie,L,OTT,22,0,0,0,0
47,8479772,Zack MacEwen,R,OTT,28,0,0,0,0
47,8483597,Milos Kelemen,L,ARI,25,0,0,0,0
47,8479379,Givani Smith,R,SJS,26,0,0,0,0
47,8481655,Cole Schwindt,R,CGY,23,0,0,0,0
47,8479981,Jonah Gadjovich,L,FLA,26,0,0,0,0
47,8482147,Jean-Luc Foudy,C,COL,22,0,0,0,0
47,8484255,Jason Polin,R,COL,25,0,0,0,0
47,8477993,Justin Kirkland,C,ARI,28,0,0,0,0
47,8479249,Andrew Poturalski,C,SEA,30,0,0,0,0
47,8482197,Adam Raska,R,MIN,23,0,0,0,0
47,8475780,Chris Wagner,R,COL,33,0,0,0,0
47,8479533,Joona Koppanen,L,PIT,26,0,0,0,0
47,8481534,Raphael Lavoie,C,EDM,24,0,0,0,0
47,8484321,Nikolas Matinpalo,D,OTT,26,0,0,0,0
47,8481043,Cole Koepke,L,TBL,26,0,0,0,0
47,8476323,Max McCormick,L,SEA,32,0,0,0,0
47,8483609,Adam Klapka,R,CGY,24,0,0,0,0
47,8483512,Matt Savoie,C,BUF,20,0,0,0,0
47,8484259,Ondrej Pavel,C,COL,31,0,0,0,0
47,8478147,Bokondji Imama,L,OTT,28,0,0,0,0
47,8482460,Matt Rempe,C,NYR,22,0,0,0,0
47,8477073,Kurtis MacDermid,L,NJD,30,0,0,0,0
47,8480274,Philip Kemp,D,EDM,25,0,0,0,0
47,8478956,Samuel Laberge,L,NJD,27,0,0,0,0
47,8483045,Cameron Butler,R,CBJ,31,0,0,0,0
48,8478402,Connor McDavid,C,EDM,27,82,44,87,131
48,8476453,Nikita Kucherov,R,TBL,31,82,48,79,127
48,8477492,Nathan MacKinnon,C,COL,29,82,42,62,104
48,8479318,Auston Matthews,C,TOR,27,82,55,48,103
48,8478550,Artemi Panarin,L,NYR,33,82,28,73,101
48,8477934,Leon Draisaitl,C,EDM,29,82,35,65,100
48,8477956,David Pastrnak,R,BOS,28,82,39,56,95
48,8476468,J.T. Miller,C,VAN,31,82,35,60,95
48,8479314,Matthew Tkachuk,L,FLA,27,82,33,60,93
48,8478420,Mikko Rantanen,R,COL,28,82,38,54,92
48,8480012,Elias Pettersson,C,VAN,26,82,29,63,92
48,8481559,Jack Hughes,C,NJD,23,82,43,47,90
48,8476459,Mika Zibanejad,C,NYR,31,82,37,52,89
48,8477933,Sam Reinhart,C,FLA,29,82,43,45,88
48,8479407,Jesper Bratt,L,NJD,26,82,32,54,86
48,8478427,Sebastian Aho,C,CAR,27,82,34,50,84
48,8480830,Andrei Svechnikov,R,CAR,24,82,30,54,84
48,8475172,Nazem Kadri,C,CGY,34,82,27,57,84
48,8478010,Brayden Point,C,TBL,28,82,47,36,83
48,8480002,Nico Hischier,C,NJD,25,82,37,46,83
48,8478864,Kirill Kaprizov,L,MIN,27,82,40,41,81
48,8480027,Jason Robertson,L,DAL,25,82,39,42,81
48,8477939,William Nylander,R,TOR,28,82,29,51,80
48,8476887,Filip Forsberg,L,NSH,30,82,32,47,79
48,8480800,Quinn Hughes,D,VAN,25,82,17,62,79
48,8471675,Sidney Crosby,C,PIT,37,82,30,48,78
48,8475786,Zach Hyman,L,EDM,32,82,45,32,77
48,8474600,Roman Josi,D,NSH,34,82,22,54,76
48,8481523,Kirby Dach,C,MTL,23,82,18,58,76
48,8480023,Robert Thomas,C,STL,25,82,17,59,76
48,8475184,Chris Kreider,L,NYR,33,82,47,28,75
48,8479343,Clayton Keller,R,ARI,26,82,35,40,75
48,8477404,Jake Guentzel,C,CAR,30,82,29,46,75
48,8476456,Jonathan Huberdeau,C,CGY,31,82,19,56,75
48,8476389,Vincent Trocheck,C,NYR,31,82,29,45,74
48,8474564,Steven Stamkos,C,TBL,34,82,28,46,74
48,8480036,Miro Heiskanen,D,DAL,25,82,11,62,73
48,8478403,Jack Eichel,C,VGK,28,82,33,39,72
48,8478439,Travis Konecny,R,PHI,27,82,32,40,72
48,8477951,Nick Schmaltz,C,ARI,28,82,27,45,72
48,8477493,Aleksander Barkov,C,FLA,29,82,21,51,72
48,8475754,Brock Nelson,C,NYI,33,82,36,35,71
48,8473419,Brad Marchand,L,BOS,36,82,30,41,71
48,8478398,Kyle Connor,L,WPG,28,82,28,43,71
48,8482740,Wyatt Johnston,C,DAL,21,82,28,43,71
48,8476454,Ryan Nugent-Hopkins,C,EDM,31,82,21,50,71
48,8478445,Mathew Barzal,C,NYI,27,82,17,54,71
48,8478444,Brock Boeser,R,VAN,27,82,29,41,70
48,8480803,Evan Bouchard,D,EDM,25,82,19,51,70
48,8481557,Matt Boldy,L,MIN,23,82,30,39,69
48,8477942,Kevin Fiala,L,LAK,28,82,29,40,69
48,8479323,Adam Fox,D,NYR,26,82,15,54,69
48,8480069,Cale Makar,D,COL,26,82,20,48,68
48,8479385,Jordan Kyrou,C,STL,26,82,34,33,67
48,8479542,Brandon Hagel,L,TBL,26,82,22,45,67
48,8476853,Morgan Rielly,D,TOR,30,82,12,55,67
48,8471214,Alex Ovechkin,L,WSH,39,82,32,34,66
48,8477409,Carter Verhaeghe,C,FLA,29,82,27,39,66
48,8477503,Max Domi,C,TOR,29,82,20,46,66
48,8478407,Vince Dunn,D,SEA,28,82,15,51,66
48,8478873,Troy Terry,R,ANA,27,82,26,39,65
48,8478975,Mason Marchment,L,DAL,29,82,26,39,65
48,8475692,Mats Zuccarello,R,MIN,37,82,19,46,65
48,8475167,Victor Hedman,D,TBL,34,82,16,49,65
48,8477946,Dylan Larkin,C,DET,28,82,30,34,64
48,8478449,Roope Hintz,C,DAL,28,82,26,38,64
48,8476881,Tomas Hertl,C,VGK,31,82,25,39,64
48,8475784,Jeff Skinner,C,BUF,32,82,36,26,62
48,8475166,John Tavares,C,TOR,34,82,35,27,62
48,8475168,Matt Duchene,C,DAL,33,82,29,33,62
48,8478493,Joel Eriksson Ek,C,MIN,27,82,28,33,61
48,8477955,Jared McCann,L,SEA,28,82,26,35,61
48,8475791,Taylor Hall,L,CHI,33,82,24,37,61
48,8475158,Ryan O'Reilly,C,NSH,33,82,22,39,61
48,8476905,Chandler Stephenson,C,VGK,30,82,21,40,61
48,8480801,Brady Tkachuk,L,OTT,25,82,29,31,60
48,8482078,Lucas Raymond,L,DET,22,82,28,32,60
48,8477402,Pavel Buchnevich,L,STL,29,82,27,33,60
48,8475810,Bryan Rust,R,PIT,32,82,26,34,60
48,8478440,Dylan Strome,C,WSH,27,82,23,37,60
48,8477949,Alex Tuch,R,BUF,28,82,21,39,60
48,8482116,Tim Stützle,C,OTT,22,82,14,46,60
48,8479675,Trevor Moore,L,LAK,29,82,30,29,59
48,8475765,Vladimir Tarasenko,R,FLA,33,82,20,39,59
48,8481533,Trevor Zegras,C,ANA,23,82,19,40,59
48,8473994,Jamie Benn,L,DAL,35,82,17,42,59
48,8470794,Joe Pavelski,C,DAL,40,82,17,42,59
48,8474578,Erik Karlsson,D,PIT,34,82,11,48,59
48,8479410,Mikhail Sergachev,D,TBL,26,82,9,50,59
48,8477500,Bo Horvat,C,NYI,29,82,29,29,58
48,8471685,Anze Kopitar,C,LAK,37,82,18,40,58
48,8482665,Matty Beniers,C,SEA,22,82,17,41,58
48,8474563,Drew Doughty,D,LAK,35,82,8,50,58
48,8478042,Viktor Arvidsson,R,LAK,31,82,28,29,57
48,8477960,Adrian Kempe,R,LAK,28,82,25,32,57
48,8474157,Max Pacioretty,L,WSH,36,82,25,32,57
48,8477940,Nikolaj Ehlers,L,WPG,28,82,22,35,57
48,8482684,Luke Hughes,D,NJD,21,82,18,39,57
48,8480031,Maxime Comtois,L,CAR,25,82,14,43,57
48,8476880,Tom Wilson,R,WSH,30,82,33,23,56
48,8478414,Timo Meier,R,NJD,28,82,29,27,56
48,8477935,Sam Bennett,C,FLA,28,82,29,27,56
48,8477407,Anthony Duclair,L,TBL,29,82,27,29,56
48,8475170,Brayden Schenn,C,STL,33,82,24,32,56
48,8471215,Evgeni Malkin,C,PIT,38,82,21,35,56
48,8477416,Oliver Bjorkstrand,R,SEA,29,82,18,38,56
48,8475913,Mark Stone,R,VGK,32,82,16,40,56
48,8477504,Josh Morrissey,D,WPG,29,82,6,50,56
48,8475151,Kyle Palmieri,C,NYI,33,82,34,21,55
48,8477501,Valeri Nichushkin,R,COL,29,82,33,22,55
48,8481540,Cole Caufield,R,MTL,23,82,27,28,55
48,8475726,Tyler Toffoli,C,WPG,32,82,27,28,55
48,8474102,David Perron,L,DET,36,82,21,34,55
48,8478397,Rasmus Andersson,D,CGY,28,82,12,43,55
48,8480865,Noah Dobson,D,NYI,24,82,10,45,55
48,8474590,John Carlson,D,WSH,34,82,10,45,55
48,8481699,Aku Raty,R,ARI,23,82,4,51,55
48,8479420,Tage Thompson,C,BUF,27,82,27,27,54
48,8482093,Seth Jarvis,C,CAR,22,82,24,30,54
48,8477496,Elias Lindholm,C,VAN,30,82,23,31,54
48,8482097,Jack Quinn,R,BUF,23,82,22,32,54
48,8474586,Jordan Eberle,R,SEA,34,82,19,35,54
48,8477494,Jonathan Drouin,L,COL,29,82,16,38,54
48,8479325,Charlie McAvoy,D,BOS,27,82,11,43,54
48,8480039,Martin Necas,C,CAR,25,82,23,30,53
48,8480208,Drake Batherson,R,OTT,26,82,23,30,53
48,8476869,Brady Skjei,D,CAR,30,82,15,38,53
48,8481528,Dylan Cozens,C,BUF,23,82,24,28,52
48,8479337,Alex DeBrincat,R,DET,27,82,24,28,52
48,8480015,Owen Tippett,R,PHI,25,82,23,29,52
48,8476539,Jonathan Marchessault,R,VGK,34,82,21,31,52
48,8481068,Yegor Sharangovich,C,CGY,26,82,21,31,52
48,8478233,Andrew Mangiapane,L,CGY,28,82,19,33,52
48,8479999,Casey Mittelstadt,C,COL,26,82,19,33,52
48,8475798,Mikael Granlund,C,SJS,32,82,17,35,52
48,8476346,Johnny Gaudreau,L,CBJ,31,82,13,39,52
48,8475169,Evander Kane,L,EDM,33,82,26,25,51
48,8482159,Tyson Foerster,R,PHI,22,82,21,30,51
48,8481711,Matias Maccelli,L,ARI,24,82,21,30,51
48,8478438,Tommy Novak,C,NSH,27,82,21,30,51
48,8479400,Pierre-Luc Dubois,L,LAK,26,82,18,33,51
48,8480839,Rasmus Dahlin,D,BUF,24,82,15,36,51
48,8477495,Seth Jones,D,CHI,30,82,10,41,51
48,8478366,Frank Vatrano,R,ANA,30,82,26,24,50
48,8482124,Quinton Byfield,R,LAK,22,82,22,28,50
48,8474141,Patrick Kane,R,DET,36,82,19,31,50
48,8471724,Kris Letang,D,PIT,37,82,12,38,50
48,8476958,Jaccob Slavin,D,CAR,30,82,12,38,50
48,8476432,Boone Jenner,C,CBJ,31,82,29,20,49
48,8477426,Nicholas Paul,L,TBL,29,82,25,24,49
48,8478519,Anthony Cirelli,C,TBL,27,82,21,28,49
48,8480018,Nick Suzuki,C,MTL,25,82,20,29,49
48,8474641,Adam Henrique,C,EDM,34,82,20,29,49
48,8476872,Scott Laughton,C,PHI,30,82,20,29,49
48,8482702,Logan Stankoven,C,DAL,21,82,24,24,48
48,8478047,Michael Bunting,L,PIT,29,82,20,28,48
48,8482745,Mason McTavish,C,ANA,21,82,17,31,48
48,8479365,Trent Frederic,C,BOS,26,82,15,33,48
48,8475744,Evgeny Kuznetsov,C,CAR,32,82,13,35,48
48,8476460,Mark Scheifele,C,WPG,31,82,20,27,47
48,8478038,Devon Toews,D,COL,30,82,5,42,47
48,8473512,Claude Giroux,R,OTT,36,82,20,26,46
48,8479339,Patrik Laine,L,CBJ,26,82,19,27,46
48,8482113,Anton Lundell,C,FLA,23,82,18,28,46
48,8482146,Luke Evangelista,R,NSH,22,82,16,30,46
48,8477479,Tyler Bertuzzi,L,TOR,29,82,11,35,46
48,8477447,Shea Theodore,D,VGK,29,82,9,37,46
48,8476792,Torey Krug,D,STL,33,82,5,41,46
48,8480014,Gabriel Vilardi,C,WPG,25,82,29,16,45
48,8480188,Fabian Zetterlund,L,SJS,25,82,23,22,45
48,8480893,Kirill Marchenko,R,CBJ,24,82,20,25,45
48,8478462,Nicolas Roy,C,VGK,27,82,20,25,45
48,8482109,Alexis Lafrenière,L,NYR,23,82,19,26,45
48,8481560,Arthur Kaliyev,R,LAK,23,82,19,26,45
48,8480078,Filip Chytil,C,NYR,25,82,17,28,45
48,8477021,Alex Kerfoot,C,ARI,30,82,15,30,45
48,8477932,Aaron Ekblad,D,FLA,28,82,14,31,45
48,8470613,Brent Burns,D,CAR,39,82,13,32,45
48,8481596,Shane Pinto,C,OTT,24,82,25,19,44
48,8483808,Andrei Kuzmenko,L,CGY,28,82,25,19,44
48,8476882,Teuvo Teravainen,L,CAR,30,82,19,25,44
48,8476292,Ondrej Palat,L,NJD,33,82,16,28,44
48,8475197,Tyson Barrie,D,NSH,33,82,4,40,44
48,8475794,Tyler Seguin,C,DAL,32,82,22,21,43
48,8478856,Conor Garland,R,VAN,28,82,22,21,43
48,8475799,Nino Niederreiter,R,WPG,32,82,22,21,43
48,8480459,Pius Suter,C,VAN,28,82,20,23,43
48,8477964,Ivan Barbashev,C,VGK,29,82,19,24,43
48,8471698,T.J. Oshie,R,WSH,38,82,18,25,43
48,8480797,Joel Farabee,L,PHI,24,82,18,25,43
48,8484144,Connor Bedard,C,CHI,19,82,17,26,43
48,8478401,Pavel Zacha,C,BOS,27,82,16,27,43
48,8476458,Ryan Strome,C,ANA,31,82,14,29,43
48,8480798,Philipp Kurashev,C,CHI,25,82,13,30,43
48,8481542,Moritz Seider,D,DET,23,82,10,33,43
48,8478460,Zach Werenski,D,CBJ,27,82,9,34,43
48,8478396,Noah Hanifin,D,VGK,27,82,9,34,43
48,8483524,Shane Wright,C,SEA,20,82,33,9,42
48,8482699,Dylan Guenther,R,ARI,21,82,25,17,42
48,8477456,J.T. Compher,L,DET,29,82,19,23,42
48,8477497,Sean Monahan,C,WPG,30,82,18,24,42
48,8480028,Morgan Frost,C,PHI,25,82,12,30,42
48,8476875,Mike Matheson,D,MTL,30,82,11,31,42
48,8476399,Blake Coleman,C,CGY,33,82,26,15,41
48,8476483,Rickard Rakell,R,PIT,31,82,23,18,41
48,8473986,Alex Killorn,L,ANA,35,82,22,19,41
48,8478498,Jake DeBrusk,L,BOS,28,82,21,20,41
48,8475848,Brendan Gallagher,R,MTL,32,82,20,21,41
48,8475191,Reilly Smith,R,PIT,33,82,19,22,41
48,8478115,Pierre Engvall,L,NYI,28,82,19,22,41
48,8476479,Phillip Danault,C,LAK,31,82,18,23,41
48,8476448,William Karlsson,C,VGK,31,82,17,24,41
48,8476329,Travis Boyd,C,ARI,31,82,17,24,41
48,8483515,Juraj Slafkovsky,L,MTL,20,82,13,28,41
48,8476462,Dougie Hamilton,D,NJD,31,82,12,29,41
48,8474679,Gustav Nyquist,C,NSH,35,82,12,29,41
48,8479425,Filip Hronek,D,VAN,27,82,11,30,41
48,8480434,Sean Durzi,D,ARI,26,82,6,35,41
48,8475314,Anders Lee,L,NYI,34,82,25,15,40
48,8475722,Jason Zucker,L,NSH,32,82,23,17,40
48,8475768,Jaden Schwartz,C,SEA,32,82,22,18,40
48,8477451,Ryan Hartman,R,MIN,30,82,18,22,40
48,8480113,Alex Iafallo,L,WPG,31,82,15,25,40
48,8480220,Noah Cates,L,PHI,25,82,13,27,40
48,8478055,Gustav Forsling,D,FLA,28,82,11,29,40
48,8478469,Thomas Chabot,D,OTT,27,82,6,34,40
48,8483397,Marc McLaughlin,C,BOS,25,82,32,7,39
48,8477998,Warren Foegele,L,EDM,28,82,23,16,39
48,8474150,Mikael Backlund,C,CGY,35,82,19,20,39
48,8476480,Vladislav Namestnikov,C,WPG,32,82,18,21,39
48,8478472,Mathieu Joseph,R,OTT,27,82,17,22,39
48,8477429,Andrew Copp,C,DET,30,82,16,23,39
48,8478057,Dakota Joshua,C,VAN,28,82,16,23,39
48,8477346,MacKenzie Weegar,D,CGY,30,82,14,25,39
48,8478542,Evan Rodrigues,C,FLA,31,82,13,26,39
48,8479987,Morgan Geekie,C,BOS,26,82,13,26,39
48,8480064,Josh Norris,C,OTT,25,82,21,17,38
48,8481624,Ilya Mikheyev,R,VAN,30,82,20,18,38
48,8480849,Barrett Hayton,C,ARI,24,82,16,22,38
48,8474870,Tyler Johnson,C,CHI,34,82,16,22,38
48,8476826,Yanni Gourde,C,SEA,33,82,15,23,38
48,8482475,Yegor Chinakhov,R,CBJ,23,82,13,25,38
48,8478458,Jack Roslovic,C,NYR,27,82,13,25,38
48,8478046,Danton Heinen,L,BOS,29,82,12,26,38
48,8477444,Andre Burakovsky,L,SEA,29,82,11,27,38
48,8481016,Ruslan Iskhakov,C,NYI,24,82,6,32,38
48,8475760,Nick Bjugstad,C,ARI,32,82,24,13,37
48,8478463,Anthony Beauvillier,L,NSH,27,82,19,18,37
48,8482175,JJ Peterka,R,BUF,22,82,19,18,37
48,8477986,Brandon Montour,D,FLA,30,82,15,22,37
48,8480009,Eeli Tolvanen,R,SEA,25,82,15,22,37
48,8474053,Logan Couture,C,SJS,35,82,15,22,37
48,8471218,Blake Wheeler,R,NYR,38,82,13,24,37
48,8475287,Erik Haula,L,NJD,33,82,12,25,37
48,8482705,Cole Sillinger,C,CBJ,21,82,12,25,37
48,8482133,Thomas Bordeleau,C,SJS,22,82,12,25,37
48,8475763,Kevin Hayes,R,STL,32,82,11,26,37
48,8479415,Michael McLeod,C,NJD,26,82,10,27,37
48,8475753,Justin Faulk,D,STL,32,82,8,29,37
48,8478474,Lawson Crouse,L,ARI,27,82,24,12,36
48,8477989,Christian Dvorak,C,MTL,28,82,21,15,36
48,8475793,Ryan Johansen,C,PHI,32,82,18,18,36
48,8482092,Ridly Greig,C,OTT,22,82,15,21,36
48,8482667,William Eklund,L,SJS,22,82,13,23,36
48,8480043,Timothy Liljegren,D,TOR,25,82,13,23,36
48,8476927,Teddy Blueger,C,VAN,30,82,11,25,36
48,8483445,Cutter Gauthier,L,ANA,20,82,8,28,36
48,8476438,Brandon Saad,L,STL,32,82,21,14,35
48,8482089,Jake Neighbours,L,STL,22,82,18,17,35
48,8482101,Danil Gushchin,L,SJS,22,82,18,17,35
48,8476469,Joel Armia,R,MTL,31,82,17,18,35
48,8482055,Drew O'Connor,L,PIT,26,82,15,20,35
48,8482110,Dawson Mercer,C,NJD,23,82,11,24,35
48,8477969,Marcus Pettersson,D,PIT,28,82,10,25,35
48,8476906,Shayne Gostisbehere,D,DET,31,82,5,30,35
48,8475906,John Klingberg,D,TOR,32,82,4,31,35
48,8476457,Adam Larsson,D,SEA,32,82,4,31,35
48,8483471,Brad Lambert,C,WPG,31,82,3,32,35
48,8479423,Alex Nylander,L,CBJ,26,82,21,13,34
48,8477944,Jakub Vrana,L,STL,28,82,19,15,34
48,8483431,Logan Cooley,C,ARI,20,82,14,20,34
48,8482720,Matthew Knies,L,TOR,22,82,14,20,34
48,8475745,Charlie Coyle,C,BOS,32,82,11,23,34
48,8479345,Jakob Chychrun,D,OTT,26,82,10,24,34
48,8474565,Alex Pietrangelo,D,VGK,34,82,9,25,34
48,8477948,Travis Sanheim,D,PHI,28,82,7,27,34
48,8482122,Brock Faber,D,MIN,22,82,6,28,34
48,8479398,Samuel Girard,D,COL,26,82,6,28,34
48,8477476,Artturi Lehkonen,L,COL,29,82,14,19,33
48,8477511,Anthony Mantha,R,VGK,30,82,12,21,33
48,8484153,Leo Carlsson,C,ANA,20,82,9,24,33
48,8482671,Owen Power,D,BUF,22,82,6,27,33
48,8482145,Mavrik Bourque,C,DAL,22,82,24,8,32
48,8476981,Josh Anderson,R,MTL,30,82,21,11,32
48,8475714,Calle Jarnkrok,C,TOR,33,82,19,13,32
48,8476461,Sean Couturier,C,PHI,32,82,17,15,32
48,8480802,Ryan McLeod,C,EDM,25,82,16,16,32
48,8474149,Evgenii Dadonov,R,DAL,35,82,14,18,32
48,8476925,Colton Sissons,C,NSH,31,82,13,19,32
48,8476278,Colin Blackwell,C,CHI,31,82,13,19,32
48,8480185,Eetu Luostarinen,C,FLA,26,82,9,23,32
48,8480336,Sean Walker,D,COL,30,82,5,27,32
48,8479976,Juuso Valimaki,D,ARI,26,82,5,27,32
48,8479941,Justin Danforth,R,CBJ,31,82,19,12,31
48,8476960,Andreas Athanasiou,C,CHI,30,82,18,13,31
48,8479591,Michael Eyssimont,C,TBL,28,82,17,14,31
48,8479293,Brandon Tanev,L,SEA,33,82,15,16,31
48,8477952,Robby Fabbri,C,DET,28,82,14,17,31
48,8480821,Filip Zadina,R,SJS,25,82,14,17,31
48,8482222,Alexander Barabanov,L,SJS,30,82,12,19,31
48,8477498,Darnell Nurse,D,EDM,29,82,12,19,31
48,8477506,Ryan Pulock,D,NYI,30,82,12,19,31
48,8481618,Alex Newhook,C,MTL,23,82,11,20,31
48,8480855,Jack McBain,C,ARI,24,82,11,20,31
48,8477953,Kasperi Kapanen,R,STL,28,82,7,24,31
48,8481656,Aliaksei Protas,C,WSH,23,82,7,24,31
48,8481581,Thomas Harley,D,DAL,23,82,6,25,31
48,8483493,Frank Nazar,C,CHI,20,82,23,7,30
48,8479525,Ross Colton,C,COL,28,82,16,14,30
48,8479346,Dillon Dube,C,CGY,26,82,10,20,30
48,8479369,Andrew Peeke,D,BOS,26,82,8,22,30
48,8482105,Jake Sanderson,D,OTT,22,82,6,24,30
48,8475218,Mattias Ekholm,D,EDM,34,82,5,25,30
48,8482733,Logan Mailloux,D,MTL,31,82,5,25,30
48,8476979,Erik Gustafsson,D,NYR,32,82,4,26,30
48,8479371,Dante Fabbro,D,NSH,26,82,4,26,30
48,8481604,Pavel Dorofeyev,L,VGK,24,82,17,12,29
48,8482062,Cole Smith,L,NSH,29,82,14,15,29
48,8474037,James van Riemsdyk,L,BOS,35,82,13,16,29
48,8470604,Jeff Carter,C,PIT,39,82,12,17,29
48,8481546,Cam York,D,PHI,23,82,11,18,29
48,8481535,Nils Hoglander,L,VAN,24,82,11,18,29
48,8477947,Sonny Milano,L,WSH,28,82,11,18,29
48,8477839,Conor Sheary,L,TBL,32,82,10,19,29
48,8482730,Brandt Clarke,D,LAK,21,82,10,19,29
48,8476463,Jonas Brodin,D,MIN,31,82,8,21,29
48,8478911,Matt Roy,D,LAK,29,82,6,23,29
48,8474673,TJ Brodie,D,TOR,34,82,4,25,29
48,8482259,Bobby McMann,C,TOR,28,82,18,10,28
48,8477425,Miles Wood,L,COL,29,82,16,12,28
48,8481554,Kaapo Kakko,R,NYR,23,82,16,12,28
48,8474189,Lars Eller,C,PIT,35,82,15,13,28
48,8481093,Rafael Harvey-Pinard,L,MTL,25,82,15,13,28
48,8478466,Daniel Sprong,R,DET,27,82,12,16,28
48,8476419,Jean-Gabriel Pageau,C,NYI,32,82,12,16,28
48,8479393,Noah Gregor,C,TOR,26,82,11,17,28
48,8470610,Zach Parise,L,COL,40,82,11,17,28
48,8480806,Isac Lundestrom,C,ANA,25,82,11,17,28
48,8483499,Liam Ohgren,L,MIN,20,82,9,19,28
48,8478109,Victor Olofsson,L,BUF,29,82,8,20,28
48,8477488,Brett Pesce,D,CAR,30,82,6,22,28
48,8482245,Artem Zub,D,OTT,29,82,5,23,28
48,8481522,Peyton Krebs,C,BUF,23,82,4,24,28
48,8478507,John Marino,D,NJD,27,82,2,26,28
48,8482118,Sam Colangelo,R,ANA,23,82,17,10,27
48,8484203,Bradly Nadeau,L,CAR,19,82,17,10,27
48,8482737,Zack Bolduc,C,STL,21,82,15,12,27
48,8482125,Alexander Holtz,R,NJD,22,82,14,13,27
48,8474884,Mike Hoffman,C,SJS,35,82,14,13,27
48,8474715,Cam Atkinson,R,PHI,35,82,13,14,27
48,8481186,Logan O'Connor,R,COL,28,82,13,14,27
48,8478413,Jordan Greenway,L,BUF,27,82,12,15,27
48,8477450,Jason Dickinson,C,CHI,29,82,11,16,27
48,8479977,Kailer Yamamoto,R,SEA,26,82,11,16,27
48,8480068,Ryan Poehling,C,PHI,25,82,11,16,27
48,8473422,Nick Foligno,L,CHI,37,82,10,17,27
48,8483505,Matthew Poitras,C,BOS,20,82,9,18,27
48,8475764,Cam Fowler,D,ANA,33,82,6,21,27
48,8482655,J.J. Moser,D,ARI,24,82,5,22,27
48,8483457,Lane Hutson,D,MTL,20,82,3,24,27
48,8476858,Phillip Di Giuseppe,L,VAN,31,82,15,11,26
48,8479996,Cody Glass,C,NSH,25,82,13,13,26
48,8481013,Jonatan Berggren,R,DET,24,82,11,15,26
48,8479514,Rem Pitlick,C,CHI,27,82,11,15,26
48,8479351,Sam Steel,C,DAL,26,82,11,15,26
48,8476392,Adam Lowry,C,WPG,31,82,9,17,26
48,8481703,Valtteri Puustinen,R,PIT,25,82,7,19,26
48,8477392,Hudson Fasching,R,NYI,29,82,7,19,26
48,8476923,Damon Severson,D,CBJ,30,82,6,20,26
48,8475181,Nick Leddy,D,STL,33,82,6,20,26
48,8478178,Darren Raddysh,D,TBL,28,82,5,21,26
48,8476892,Colton Parayko,D,STL,31,82,5,21,26
48,8476854,Hampus Lindholm,D,BOS,30,82,5,21,26
48,8475171,Oliver Ekman-Larsson,D,FLA,33,82,3,23,26
48,8480873,Rasmus Sandin,D,WSH,24,82,2,24,26
48,8478569,Noel Acciari,C,PIT,33,82,16,9,25
48,8482074,Connor Zary,C,CGY,23,82,13,12,25
48,8482117,Lukas Reichel,L,CHI,22,82,11,14,25
48,8478891,Mason Appleton,C,WPG,28,82,11,14,25
48,8477330,Dominik Kubalik,L,OTT,29,82,11,14,25
48,8475149,Marcus Johansson,L,MIN,34,82,9,16,25
48,8473449,Kyle Okposo,R,FLA,36,82,9,16,25
48,8479992,Michael Rasmussen,C,DET,25,82,9,16,25
48,8474151,Ryan McDonagh,D,NSH,35,82,7,18,25
48,8474716,Jared Spurgeon,D,MIN,35,82,5,20,25
48,8477034,Jaycob Megna,D,CHI,32,82,4,21,25
48,8476902,Esa Lindell,D,DAL,30,82,3,22,25
48,8476931,Jake McCabe,D,TOR,31,82,2,23,25
48,8480246,Nick Perbix,D,TBL,26,82,0,25,25
48,8478508,Yakov Trenin,C,COL,27,82,15,9,24
48,8483491,Ivan Miroshnichenko,L,WSH,20,82,14,10,24
48,8478020,Michael Amadio,C,VGK,28,82,13,11,24
48,8481517,Brett Leason,R,ANA,25,82,12,12,24
48,8478013,Jake Walman,D,DET,28,82,12,12,24
48,8480144,David Kampf,C,TOR,29,82,12,12,24
48,8480281,Alexey Toropchenko,R,STL,25,82,12,12,24
48,8481704,Juuso Parssinen,C,NSH,23,82,10,14,24
48,8482111,Justin Barron,D,MTL,23,82,10,14,24
48,8476312,Josh Manson,D,COL,33,82,8,16,24
48,8470600,Ryan Suter,D,DAL,39,82,7,17,24
48,8475188,Brayden McNabb,D,VGK,33,82,6,18,24
48,8478831,Kevin Stenlund,C,FLA,28,82,13,10,23
48,8476873,Mark Jankowski,C,NSH,30,82,12,11,23
48,8483012,Logan Morrison,C,SEA,22,82,11,12,23
48,8481537,Nikita Okhotiuk,D,CGY,24,82,10,13,23
48,8481477,Nico Sturm,C,SJS,29,82,10,13,23
48,8481553,Bobby Brink,R,PHI,23,82,8,15,23
48,8481606,Jordan Spence,D,LAK,23,82,8,15,23
48,8475233,David Savard,D,MTL,34,82,7,16,23
48,8482624,Daniil Miromanov,D,CGY,27,82,6,17,23
48,8477015,Connor Brown,R,EDM,30,82,6,17,23
48,8478500,Ivan Provorov,D,CBJ,27,82,5,18,23
48,8476885,Jacob Trouba,D,NYR,30,82,5,18,23
48,8480796,Martin Fehervary,D,WSH,25,82,5,18,23
48,8476921,Jordan Martinook,L,CAR,32,82,5,18,23
48,8476891,Matt Grzelcyk,D,BOS,30,82,5,18,23
48,8477499,Rasmus Ristolainen,D,PHI,30,82,2,21,23
48,8473507,Jeff Petry,D,DET,37,82,0,23,23
48,8478043,Sam Lafferty,C,VAN,29,82,12,10,22
48,8482679,Matt Coronato,R,CGY,22,82,10,12,22
48,8479353,Brett Howden,C,VGK,26,82,10,12,22
48,8477919,Frederick Gaudreau,C,MIN,31,82,10,12,22
48,8479316,Luke Kunin,C,SJS,27,82,9,13,22
48,8476422,Mike Reilly,D,NYI,31,82,9,13,22
48,8470621,Corey Perry,R,EDM,39,82,8,14,22
48,8473563,Nicklas Backstrom,C,WSH,37,82,7,15,22
48,8480813,Joe Veleno,C,DET,24,82,6,16,22
48,8482079,Marco Rossi,C,MIN,23,82,6,16,22
48,8475208,Brian Dumoulin,D,SEA,33,82,6,16,22
48,8478851,Alexandre Carrier,D,NSH,28,82,5,17,22
48,8474166,Alec Martinez,D,VGK,37,82,5,17,22
48,8476967,Brett Kulak,D,EDM,30,82,4,18,22
48,8478882,Vladislav Gavrikov,D,LAK,29,82,3,19,22
48,8481178,Egor Zamula,D,PHI,24,82,3,19,22
48,8480871,Adam Boqvist,D,CBJ,24,82,1,21,22
48,8473533,Jordan Staal,C,CAR,36,82,14,7,21
48,8476624,Barclay Goodrow,C,NYR,31,82,13,8,21
48,8481580,Connor McMichael,C,WSH,23,82,10,11,21
48,8479390,Taylor Raddysh,R,CHI,26,82,9,12,21
48,8477507,Nikita Zadorov,D,VAN,29,82,9,12,21
48,8478840,Will Borgen,D,SEA,28,82,8,13,21
48,8484145,Zach Benson,L,BUF,19,82,7,14,21
48,8478133,Jake Evans,C,MTL,28,82,6,15,21
48,8482155,Alex Laferriere,R,LAK,23,82,6,15,21
48,8476473,Connor Murphy,D,CHI,31,82,6,15,21
48,8480035,Henri Jokiharju,D,BUF,25,82,5,16,21
48,8476917,Adam Pelech,D,NYI,30,82,4,17,21
48,8483495,Simon Nemec,D,NJD,20,82,4,17,21
48,8474013,Ian Cole,D,VAN,35,82,3,18,21
48,8479983,Mario Ferraro,D,SJS,26,82,2,19,21
48,8479324,Ryan Lindgren,D,NYR,26,82,2,19,21
48,8482470,Ilya Solovyov,D,CGY,24,82,1,20,21
48,8480074,Alexandre Texier,C,CBJ,25,82,12,8,20
48,8477353,Tyler Motte,C,TBL,29,82,9,11,20
48,8475343,Nic Dowd,C,WSH,34,82,8,12,20
48,8476871,Tanner Pearson,L,MTL,32,82,7,13,20
48,8475220,Marcus Foligno,L,MIN,33,82,7,13,20
48,8481601,Simon Holmstrom,R,NYI,23,82,7,13,20
48,8475842,Sam Carrick,C,EDM,32,82,7,13,20
48,8482803,Olen Zellweger,D,ANA,21,82,6,14,20
48,8476374,Sean Kuraly,C,CBJ,31,82,6,14,20
48,8479661,Tanner Jeannot,L,TBL,27,82,5,15,20
48,8482142,Jamie Drysdale,D,PHI,22,82,5,15,20
48,8481014,Alexander Romanov,D,NYI,24,82,4,16,20
48,8476879,Cody Ceci,D,EDM,31,82,4,16,20
48,8483466,Kevin Korchinski,D,CHI,20,82,3,17,20
48,8478416,Erik Cernak,D,TBL,27,82,3,17,20
48,8476897,Oskar Sundqvist,C,STL,30,82,10,9,19
48,8475164,Jakob Silfverberg,R,ANA,34,82,10,9,19
48,8475200,Dmitry Orlov,D,CAR,33,82,9,10,19
48,8484166,Adam Fantilli,C,CBJ,20,82,8,11,19
48,8481481,Blake Lizotte,C,LAK,27,82,8,11,19
48,8479383,Boris Katchouk,L,OTT,26,82,8,11,19
48,8482073,Braden Schneider,D,NYR,23,82,8,11,19
48,8482166,Shakir Mukhamadullin,D,SJS,22,82,5,14,19
48,8476442,Matt Nieto,L,PIT,32,82,4,15,19
48,8479998,Mikey Anderson,D,LAK,25,82,4,15,19
48,8481568,Alex Vlasic,D,CHI,23,82,3,16,19
48,8483490,Pavel Mintyukov,D,ANA,21,82,2,17,19
48,8480073,Erik Brannstrom,D,OTT,25,82,2,17,19
48,8480807,Mattias Samuelsson,D,BUF,24,82,1,18,19
48,8479359,Beck Malenstyn,L,WSH,26,82,9,9,18
48,8474034,Pat Maroon,L,BOS,36,82,7,11,18
48,8478430,Oliver Kylington,D,CGY,27,82,5,13,18
48,8475231,Casey Cizikas,C,NYI,33,82,5,13,18
48,8477220,Nate Schmidt,D,WPG,33,82,5,13,18
48,8477435,Ryan Graves,D,PIT,29,82,4,14,18
48,8474567,Zach Bogosian,D,MIN,34,82,4,14,18
48,8475790,Erik Gudbranson,D,CBJ,32,82,3,15,18
48,8475690,Chris Tanev,D,DAL,35,82,3,15,18
48,8474574,Tyler Myers,D,VAN,34,82,2,16,18
48,8482809,Jackson Blake,R,CAR,21,82,12,5,17
48,8476525,Colin Miller,D,WPG,32,82,10,7,17
48,8477508,Curtis Lazar,C,NJD,29,82,7,10,17
48,8480990,Declan Chisholm,D,MIN,24,82,6,11,17
48,8482858,Ryker Evans,D,SEA,23,82,5,12,17
48,8476331,Dylan DeMelo,D,WPG,31,82,5,12,17
48,8484911,Collin Graf,R,SJS,22,82,5,12,17
48,8480817,K'Andre Miller,D,NYR,24,82,4,13,17
48,8481028,Martin Pospisil,C,CGY,25,82,4,13,17
48,8480860,Kevin Bahl,D,NJD,24,82,4,13,17
48,8475762,Derek Forbort,D,BOS,32,82,4,13,17
48,8476467,Jamie Oleksiak,D,SEA,32,82,4,13,17
48,8478859,Niko Mikkola,D,FLA,28,82,4,13,17
48,8483565,Nick Blankenburg,D,CBJ,26,82,3,14,17
48,8480145,Neal Pionk,D,WPG,29,82,2,15,17
48,8470966,Mark Giordano,D,TOR,41,82,1,16,17
48,8482516,Matthew Kessel,D,STL,24,82,1,16,17
48,8482666,Scott Morrow,D,CAR,22,82,7,9,16
48,8477406,Mattias Janmark,C,EDM,32,82,7,9,16
48,8476878,Zemgus Girgensons,L,BUF,30,82,6,10,16
48,8480980,Connor Dewar,C,TOR,25,82,5,11,16
48,8478136,Jake Middleton,D,MIN,28,82,5,11,16
48,8477845,Trevor van Riemsdyk,D,WSH,33,82,4,12,16
48,8480172,Jan Rutta,D,SJS,34,82,4,12,16
48,8475462,Radko Gudas,D,ANA,34,82,2,14,16
48,8475825,Jani Hakanpää,D,DAL,32,82,2,14,16
48,8475179,Dmitry Kulikov,D,FLA,34,82,2,14,16
48,8481567,Henry Thrun,D,SJS,23,82,1,15,16
48,8474009,Nick Bonino,C,NYR,36,82,6,9,15
48,8481059,Scott Perunovich,D,STL,26,82,5,10,15
48,8480058,Pierre-Olivier Joseph,D,PIT,25,82,4,11,15
48,8481605,Jackson LaCombe,D,ANA,23,82,4,11,15
48,8476372,Nick Seeler,D,PHI,31,82,4,11,15
48,8482087,Kaiden Guhle,D,MTL,22,82,3,12,15
48,8478451,Ethan Bear,D,WSH,27,82,3,12,15
48,8478443,Brandon Carlo,D,BOS,28,82,2,13,15
48,8475455,Brenden Dillon,D,WPG,34,82,2,13,15
48,8475324,Nick Jensen,D,WSH,34,82,1,14,15
48,8480448,Parker Kelly,L,OTT,25,82,9,5,14
48,8473453,Trevor Lewis,C,LAK,37,82,7,7,14
48,8478468,Jeremy Lauzon,D,NSH,27,82,6,8,14
48,8473504,Cal Clutterbuck,R,NYI,37,82,4,10,14
48,8477931,Tomas Nosek,L,NJD,32,82,4,10,14
48,8476429,Scott Mayfield,D,NYI,32,82,4,10,14
48,8480879,Jacob Bernard-Docker,D,OTT,24,82,2,12,14
48,8475177,Calvin de Haan,D,TBL,33,82,1,13,14
48,8478399,Jonas Siegenthaler,D,NJD,27,82,1,13,14
48,8477369,Carson Soucy,D,VAN,30,82,5,8,13
48,8471677,Jack Johnson,D,COL,37,82,5,8,13
48,8482807,Ethan Del Mastro,D,CHI,21,82,5,8,13
48,8481524,Bowen Byram,D,BUF,23,82,4,9,13
48,8479980,Nicolas Hague,D,VGK,26,82,4,9,13
48,8475279,Ben Chiarot,D,DET,33,82,3,10,13
48,8478408,Travis Dermott,D,ARI,28,82,0,13,13
48,8483482,Tristan Luneau,D,ANA,20,82,3,9,12
48,8479442,Troy Stecher,D,EDM,30,82,3,9,12
48,8483763,Maksymilian Szuber,D,ARI,22,82,3,9,12
48,8477335,Kyle Burroughs,D,SJS,29,82,2,10,12
48,8476822,Luke Glendening,C,TBL,35,82,9,2,11
48,8479291,Kevin Rooney,C,CGY,31,82,5,5,10
48,8477505,Alexander Wennberg,C,NYR,30,82,1,9,10
48,8482712,Oskar Olausson,R,COL,22,82,1,9,10
48,8481578,Graeme Clarke,R,NJD,23,82,7,2,9
48,8482762,Simon Edvinsson,D,DET,21,82,6,3,9
48,8476915,Jujhar Khaira,L,MIN,30,82,4,5,9
48,8480834,Ty Emberson,D,SJS,24,82,1,8,9
48,8477365,Connor Clifton,D,BUF,29,82,1,7,8
48,8483489,Fraser Minten,C,TOR,31,82,7,0,7
48,8481599,Victor Soderstrom,D,ARI,23,82,3,4,7
48,8481030,Jack St. Ivany,D,PIT,25,82,0,7,7
48,8482177,Marat Khusnutdinov,C,MIN,22,82,1,5,6
48,8483468,Jiri Kulich,C,BUF,20,82,1,5,6
48,8482859,Zack Ostapchuk,C,OTT,21,82,1,5,6
48,8482713,Mackie Samoskevich,R,FLA,22,82,2,1,3
48,8484149,Gavin Brindley,C,CBJ,20,82,1,2,3
48,8482141,Lukas Cormier,D,VGK,22,0,0,0,0
48,8476988,Matt Benning,D,SJS,30,0,0,0,0
48,8480727,Zach Whitecloud,D,VGK,28,0,0,0,0
48,8480887,Jordan Harris,D,MTL,24,0,0,0,0
48,8478450,Parker Wotherspoon,D,BOS,27,0,0,0,0
48,8481812,Nikolai Knyzhov,D,SJS,27,0,0,0,0
48,8480001,Urho Vaakanainen,D,ANA,25,0,0,0,0
48,8482176,Wyatt Kaiser,D,CHI,22,0,0,0,0
48,8481122,Simon Benoit,D,TOR,26,0,0,0,0
48,8476441,Joel Edmundson,D,TOR,31,0,0,0,0
48,8480884,Calen Addison,D,SJS,24,0,0,0,0
48,8482511,Mason Lohrei,D,BOS,23,0,0,0,0
48,8482192,Isaak Phillips,D,CHI,23,0,0,0,0
48,8480950,Ilya Lyubushkin,D,TOR,30,0,0,0,0
48,8474031,Kevin Shattenkirk,D,BOS,35,0,0,0,0
48,8475718,Justin Holl,D,DET,32,0,0,0,0
48,8479402,Jake Bean,D,CBJ,26,0,0,0,0
48,8474602,Justin Schultz,D,SEA,34,0,0,0,0
48,8477950,Tony DeAngelo,D,CAR,29,0,0,0,0
48,8481743,Marc Del Gaizo,D,NSH,25,0,0,0,0
48,8481527,Kaedan Korczak,D,VGK,23,0,0,0,0
48,8480192,Johnathan Kovacevic,D,MTL,27,0,0,0,0
48,8476874,Olli Maatta,D,DET,30,0,0,0,0
48,8482144,Jack Thompson,D,SJS,22,0,0,0,0
48,8480222,Sebastian Aho,D,NYI,28,0,0,0,0
48,8479458,Nikita Zaitsev,D,CHI,33,0,0,0,0
48,8471709,Marc-Edouard Vlasic,D,SJS,37,0,0,0,0
48,8482929,Emil Lilleberg,D,TBL,23,0,0,0,0
48,8477018,Ben Hutton,D,VGK,31,0,0,0,0
48,8481056,Spencer Stastney,D,NSH,24,0,0,0,0
48,8481593,Jayden Struble,D,MTL,23,0,0,0,0
48,8479982,Conor Timmins,D,TOR,26,0,0,0,0
48,8474090,Brendan Smith,D,NJD,35,0,0,0,0
48,8482964,Arber Xhekaj,D,MTL,23,0,0,0,0
48,8480891,Michael Kesselring,D,ARI,24,0,0,0,0
48,8477938,Haydn Fleury,D,TBL,28,0,0,0,0
48,8481806,Louis Crevier,D,CHI,23,0,0,0,0
48,8471274,Alex Goligoski,D,MIN,39,0,0,0,0
48,8481600,Tobias Bjornfot,D,FLA,23,0,0,0,0
48,8475797,Jarred Tinordi,D,CHI,32,0,0,0,0
48,8481521,Ronnie Attard,D,PHI,25,0,0,0,0
48,8474612,Travis Hamonic,D,OTT,34,0,0,0,0
48,8479576,Vincent Desharnais,D,EDM,28,0,0,0,0
48,8480049,Dylan Samberg,D,WPG,25,0,0,0,0
48,8483619,Filip Roos,D,CHI,25,0,0,0,0
48,8474568,Luke Schenn,D,NSH,35,0,0,0,0
48,8480184,Gustav Lindstrom,D,ANA,26,0,0,0,0
48,8480070,Ian Mitchell,D,BOS,25,0,0,0,0
48,8480196,Jacob Bryson,D,BUF,27,0,0,0,0
48,8471686,Marc Staal,D,PHI,37,0,0,0,0
48,8477467,Gustav Olofsson,D,SEA,30,0,0,0,0
48,8478970,Jalen Chatfield,D,CAR,28,0,0,0,0
48,8479348,Kale Clague,D,BUF,26,0,0,0,0
48,8473446,Erik Johnson,D,PHI,36,0,0,0,0
48,8477462,Robert Hagg,D,ANA,29,0,0,0,0
48,8478454,Noah Juulsen,D,VAN,27,0,0,0,0
48,8477384,Josh Brown,D,ARI,30,0,0,0,0
48,8481708,Zac Jones,D,NYR,24,0,0,0,0
48,8481167,Brayden Pachal,D,CGY,25,0,0,0,0
48,8482067,Connor Mackey,D,NYR,28,0,0,0,0
48,8483460,David Jiricek,D,CBJ,21,0,0,0,0
48,8481701,Santeri Hatakka,D,NJD,23,0,0,0,0
48,8478021,William Lagesson,D,ANA,28,0,0,0,0
48,8477851,Jordan Oesterle,D,CGY,32,0,0,0,0
48,8478452,Caleb Jones,D,COL,27,0,0,0,0
48,8479984,Cal Foote,D,NJD,26,0,0,0,0
48,8479639,Dylan Coghlan,D,CAR,26,0,0,0,0
48,8480874,Adam Ginning,D,PHI,24,0,0,0,0
48,8479321,Lucas Johansen,D,WSH,27,0,0,0,0
48,8480878,Nils Lundkvist,D,DAL,24,0,0,0,0
48,8482165,Yan Kuznetsov,D,CGY,22,0,0,0,0
48,8484258,Sam Malinski,D,COL,26,0,0,0,0
48,8480157,Calle Rosen,D,STL,30,0,0,0,0
48,8484304,Uvis Balinskis,D,FLA,28,0,0,0,0
48,8479985,Cale Fleury,D,SEA,26,0,0,0,0
48,8479378,Logan Stanley,D,WPG,26,0,0,0,0
48,8477541,Dakota Mermis,D,MIN,30,0,0,0,0
48,8481609,Vladislav Kolyachonok,D,ARI,23,0,0,0,0
48,8480823,Alexander Alexeyev,D,WSH,25,0,0,0,0
48,8481679,Maxence Guenette,D,OTT,23,0,0,0,0
48,8481564,Ryan Johnson,D,BUF,23,0,0,0,0
48,8479376,Victor Mete,D,PHI,26,0,0,0,0
48,8484254,Akito Hirose,D,VAN,25,0,0,0,0
48,8482660,Kent Johnson,C,CBJ,22,0,0,0,0
48,8482149,Cole Perfetti,C,WPG,22,0,0,0,0
48,8477987,Ryan Donato,C,CHI,28,0,0,0,0
48,8475755,Alexander Petrovic,D,DAL,32,0,0,0,0
48,8477810,Joel Hanley,D,CGY,33,0,0,0,0
48,8474145,Robert Bortuzzo,D,NYI,35,0,0,0,0
48,8481161,Jake Christiansen,D,CBJ,25,0,0,0,0
48,8476884,Derrick Pouliot,D,DAL,30,0,0,0,0
48,8481716,Dmitri Voronkov,L,CBJ,24,0,0,0,0
48,8480084,Nick DeSimone,D,NJD,30,0,0,0,0
48,8475750,Jon Merrill,D,MIN,32,0,0,0,0
48,8479315,Joey Anderson,R,CHI,26,0,0,0,0
48,8478011,Louie Belpedio,D,PHI,28,0,0,0,0
48,8482451,Mikael Pyyhtia,L,CBJ,23,0,0,0,0
48,8481541,Samuel Bolduc,D,NYI,24,0,0,0,0
48,8482126,Emil Andrae,D,PHI,31,0,0,0,0
48,8474618,Marco Scandella,D,STL,34,0,0,0,0
48,8477244,Chad Ruhwedel,D,NYR,34,0,0,0,0
48,8477971,Andreas Englund,D,LAK,28,0,0,0,0
48,8480829,Jesperi Kotkaniemi,C,CAR,24,0,0,0,0
48,8479372,Josh Mahura,D,FLA,26,0,0,0,0
48,8482095,Tyler Kleven,D,OTT,22,0,0,0,0
48,8481719,Maxwell Crozier,D,TBL,24,0,0,0,0
48,8475855,Jesper Fast,R,CAR,33,0,0,0,0
48,8480848,Ty Dellandrea,C,DAL,24,0,0,0,0
48,8475193,Tomas Tatar,L,SEA,34,0,0,0,0
48,8476889,Radek Faksa,C,DAL,30,0,0,0,0
48,8478495,Denis Gurianov,R,PHI,27,0,0,0,0
48,8480216,Jacob Peterson,C,SJS,25,0,0,0,0
48,8480252,Cole Guttman,C,CHI,25,0,0,0,0
48,8479026,Philippe Myers,D,TBL,27,0,0,0,0
48,8481006,Tyler Tucker,D,STL,24,0,0,0,0
48,8481032,Paul Cotter,C,VGK,25,0,0,0,0
48,8481577,Philip Tomasino,C,NSH,23,0,0,0,0
48,8476918,Jimmy Vesey,L,NYR,31,0,0,0,0
48,8479320,Max Lajoie,D,TOR,27,0,0,0,0
48,8478017,Mark Friedman,D,VAN,29,0,0,0,0
48,8481754,Nikita Nesterenko,C,ANA,23,0,0,0,0
48,8483407,Brandon Scanlin,D,NYR,25,0,0,0,0
48,8482659,Josh Doan,R,ARI,22,0,0,0,0
48,8477446,Michael McCarron,R,NSH,29,0,0,0,0
48,8477903,Garnet Hathaway,R,PHI,33,0,0,0,0
48,8482153,Brendan Brisson,C,VGK,23,0,0,0,0
48,8483546,Marshall Rifai,D,TOR,26,0,0,0,0
48,8484287,Cole McWard,D,VAN,23,0,0,0,0
48,8478854,Ryan Shea,D,PIT,27,0,0,0,0
48,8481585,Egor Afanasyev,L,NSH,23,0,0,0,0
48,8483398,Declan Carlile,D,TBL,31,0,0,0,0
48,8478502,Dennis Gilbert,D,CGY,28,0,0,0,0
48,8482749,Joshua Roy,R,MTL,21,0,0,0,0
48,8481598,Philip Broberg,D,EDM,23,0,0,0,0
48,8480835,Jack Drury,C,CAR,24,0,0,0,0
48,8480748,Kiefer Sherwood,L,NSH,29,0,0,0,0
48,8476934,Brock McGinn,L,ANA,30,0,0,0,0
48,8480870,Bo Groulx,C,ANA,24,0,0,0,0
48,8479368,Max Jones,L,ANA,26,0,0,0,0
48,8478099,Kevin Labanc,R,SJS,29,0,0,0,0
48,8478067,Oskar Lindblom,L,SJS,28,0,0,0,0
48,8476393,Nick Cousins,C,FLA,31,0,0,0,0
48,8483395,Arshdeep Bains,L,VAN,23,0,0,0,0
48,8480762,Eric Robinson,L,BUF,29,0,0,0,0
48,8479439,Jacob MacDonald,D,SJS,31,0,0,0,0
48,8476474,Stefan Noesen,R,CAR,31,0,0,0,0
48,8482787,Nikita Chibrikov,R,WPG,31,0,0,0,0
48,8478432,Christian Fischer,R,DET,27,0,0,0,0
48,8477979,Nicolas Aube-Kubel,R,WSH,28,0,0,0,0
48,8481789,Tye Kartye,L,SEA,23,0,0,0,0
48,8479330,Brandon Gignac,C,MTL,27,0,0,0,0
48,8480075,Cameron Crotty,D,ARI,25,0,0,0,0
48,8473473,Milan Lucic,L,BOS,36,0,0,0,0
48,8482094,Daemon Hunt,D,MIN,22,0,0,0,0
48,8481206,John Ludvig,D,PIT,24,0,0,0,0
48,8483630,Pavol Regenda,L,ANA,25,0,0,0,0
48,8481617,Vasily Podkolzin,R,VAN,23,0,0,0,0
48,8480306,Grant Hutton,D,NYI,29,0,0,0,0
48,8480995,Pontus Holmberg,R,TOR,25,0,0,0,0
48,8482148,Hendrix Lapierre,C,WSH,22,0,0,0,0
48,8477478,William Carrier,L,VGK,30,0,0,0,0
48,8480003,Jesper Boqvist,C,BOS,26,0,0,0,0
48,8482172,Landon Slaggert,L,CHI,22,0,0,0,0
48,8480789,Oliver Wahlstrom,R,NYI,24,0,0,0,0
48,8474062,Riley Nash,C,NYR,35,0,0,0,0
48,8480021,Jack Studnicka,C,SJS,25,0,0,0,0
48,8480025,MacKenzie Entwistle,R,CHI,25,0,0,0,0
48,8481582,Nicholas Robertson,L,TOR,23,0,0,0,0
48,8476867,Brendan Gaunce,C,CBJ,30,0,0,0,0
48,8479619,Michael Carcone,L,ARI,28,0,0,0,0
48,8479370,Tyson Jost,C,BUF,26,0,0,0,0
48,8479671,Mathieu Olivier,R,CBJ,27,0,0,0,0
48,8476994,Vinnie Hinostroza,C,PIT,30,0,0,0,0
48,8482070,Mitchell Chaffee,R,TBL,26,0,0,0,0
48,8477473,Justin Bailey,R,SJS,29,0,0,0,0
48,8479344,Jesse Puljujarvi,R,PIT,26,0,0,0,0
48,8480205,Emil Bemstrom,C,PIT,25,0,0,0,0
48,8479718,Alex Barré-Boulet,C,TBL,27,0,0,0,0
48,8482061,Brandon Biro,L,BUF,26,0,0,0,0
48,8479638,Justin Brazeau,R,BOS,26,0,0,0,0
48,8474040,Sam Gagner,C,EDM,35,0,0,0,0
48,8477846,Ryan Carpenter,C,SJS,33,0,0,0,0
48,8482077,Dylan Holloway,L,EDM,23,0,0,0,0
48,8482157,Will Cuylle,L,NYR,22,0,0,0,0
48,8480007,Jonas Rondbjerg,R,VGK,25,0,0,0,0
48,8478874,Adam Gaudette,C,STL,28,0,0,0,0
48,8478434,Keegan Kolesar,R,VGK,27,0,0,0,0
48,8480441,Trey Fix-Wolansky,R,CBJ,25,0,0,0,0
48,8479994,Jaret Anderson-Dolan,C,NSH,25,0,0,0,0
48,8483567,Georgii Merkulov,C,BOS,24,0,0,0,0
48,8477380,Jonny Brodzinski,C,NYR,31,0,0,0,0
48,8482201,Gage Goncalves,C,TBL,23,0,0,0,0
48,8478211,Dryden Hunt,L,CGY,29,0,0,0,0
48,8471699,Andrew Cogliano,C,COL,37,0,0,0,0
48,8479421,Jacob Moverare,D,LAK,26,0,0,0,0
48,8478881,Brett Seney,L,CHI,28,0,0,0,0
48,8477464,Nic Petan,C,MIN,29,0,0,0,0
48,8475958,Michael Sgarbossa,C,WSH,32,0,0,0,0
48,8481147,Reese Johnson,C,CHI,26,0,0,0,0
48,8479336,Carl Grundstrom,R,LAK,27,0,0,0,0
48,8480853,Liam Foudy,C,NSH,24,0,0,0,0
48,8479522,Hardy Haman Aktell,D,WSH,26,0,0,0,0
48,8481462,Mason Morelli,L,VGK,28,0,0,0,0
48,8482102,Vasily Ponomarev,C,CAR,22,0,0,0,0
48,8480844,Grigori Denisenko,L,VGK,24,0,0,0,0
48,8479944,Zach Aston-Reese,C,DET,30,0,0,0,0
48,8482784,Zach Dean,C,STL,21,0,0,0,0
48,8479419,Brett Murray,L,BUF,26,0,0,0,0
48,8479520,Brandon Duhaime,R,COL,27,0,0,0,0
48,8477573,Nathan Walker,L,STL,30,0,0,0,0
48,8478078,Rourke Chartier,C,OTT,28,0,0,0,0
48,8475795,Dylan McIlrath,D,WSH,32,0,0,0,0
48,8482496,Nils Aman,C,VAN,24,0,0,0,0
48,8480289,Morgan Barron,C,WPG,26,0,0,0,0
48,8481751,Lukas Rousek,R,BUF,25,0,0,0,0
48,8480011,Klim Kostin,C,SJS,25,0,0,0,0
48,8481556,John Beecher,C,BOS,23,0,0,0,0
48,8475278,Byron Froese,C,VGK,33,0,0,0,0
48,8475225,Craig Smith,C,DAL,35,0,0,0,0
48,8484326,Patrik Koch,D,ARI,28,0,0,0,0
48,8477930,Pierre-Edouard Bellemare,L,SEA,39,0,0,0,0
48,8478409,Anthony Richard,C,BOS,28,0,0,0,0
48,8481024,Linus Karlsson,C,VAN,25,0,0,0,0
48,8479986,Kole Lind,R,SEA,26,0,0,0,0
48,8479414,Nathan Bastian,R,NJD,27,0,0,0,0
48,8479362,Riley Tufte,L,COL,26,0,0,0,0
48,8481058,Jesse Ylönen,R,MTL,25,0,0,0,0
48,8482476,Emil Heineman,L,MTL,23,0,0,0,0
48,8482861,Vincent Iorio,D,WSH,22,0,0,0,0
48,8483432,Luca Del Bel Belluz,C,CBJ,31,0,0,0,0
48,8482744,James Malatesta,L,CBJ,21,0,0,0,0
48,8477887,Patrick Brown,C,BOS,32,0,0,0,0
48,8478585,Derek Ryan,C,EDM,38,0,0,0,0
48,8481441,Joe Snively,C,WSH,28,0,0,0,0
48,8481592,Jakob Pelletier,L,CGY,23,0,0,0,0
48,8482634,Alex Steeves,C,TOR,25,0,0,0,0
48,8477126,Jayson Megna,C,BOS,34,0,0,0,0
48,8475752,Tyler Pitlick,C,NYR,33,0,0,0,0
48,8480008,Adam Ruzicka,C,ARI,25,0,0,0,0
48,8481065,Angus Crookshank,L,OTT,25,0,0,0,0
48,8479547,Matthew Phillips,R,WSH,26,0,0,0,0
48,8480226,Marián Studenic,R,SEA,26,0,0,0,0
48,8481237,Kyle MacLean,C,NYI,25,0,0,0,0
48,8475413,Justin Dowling,C,NJD,34,0,0,0,0
48,8481641,Joel Kiviranta,L,COL,28,0,0,0,0
48,8478104,Sammy Blais,L,STL,28,0,0,0,0
48,8477454,Adam Erne,L,EDM,29,0,0,0,0
48,8481518,Nolan Foote,L,NJD,24,0,0,0,0
48,8480245,Olle Lycksell,R,PHI,25,0,0,0,0
48,8483570,Ben Meyers,C,ANA,26,0,0,0,0
48,8480776,Sheldon Rempal,R,VGK,29,0,0,0,0
48,8483920,Pierrick Dube,R,WSH,23,0,0,0,0
48,8480267,Sammy Walker,C,MIN,25,0,0,0,0
48,8482747,Brennan Othmann,L,NYR,21,0,0,0,0
48,8479991,Jake Leschyshyn,C,NYR,25,0,0,0,0
48,8478400,Colin White,C,MTL,27,0,0,0,0
48,8479328,Julien Gauthier,R,NYI,27,0,0,0,0
48,8484325,Waltteri Merela,C,TBL,26,0,0,0,0
48,8479066,Ryan Lomberg,L,FLA,30,0,0,0,0
48,8477070,Liam O'Brien,C,ARI,30,0,0,0,0
48,8478146,Matthew Highmore,C,OTT,28,0,0,0,0
48,8478028,Fredrik Olofsson,L,COL,28,0,0,0,0
48,8480880,Jakub Lauko,C,BOS,24,0,0,0,0
48,8479968,Vinni Lettieri,C,MIN,29,0,0,0,0
48,8474709,Matt Martin,L,NYI,35,0,0,0,0
48,8480845,Rasmus Kupari,C,WPG,24,0,0,0,0
48,8481550,Adam Beckman,L,MIN,23,0,0,0,0
48,8481422,Jacob Lucchini,C,MIN,29,0,0,0,0
48,8477401,John Hayden,C,SEA,29,0,0,0,0
48,8478904,Steven Lorentz,C,FLA,28,0,0,0,0
48,8482088,Justin Sourdif,R,FLA,22,0,0,0,0
48,8482751,Ryan Winterton,C,SEA,21,0,0,0,0
48,8482241,Radim Zohorna,L,PIT,28,0,0,0,0
48,8481690,Tyler Angle,C,CBJ,24,0,0,0,0
48,8476952,Dominic Toninato,C,WPG,30,0,0,0,0
48,8476919,Chris Tierney,C,NJD,30,0,0,0,0
48,8480032,Shane Bowers,C,NJD,25,0,0,0,0
48,8484314,Jiri Smejkal,L,OTT,28,0,0,0,0
48,8481239,Samuel Fagemo,L,LAK,24,0,0,0,0
48,8481532,Alex Turcotte,C,LAK,23,0,0,0,0
48,8481019,David Gustafsson,C,WPG,24,0,0,0,0
48,8478477,Mitchell Stephens,C,MTL,27,0,0,0,0
48,8479546,Oskar Steen,C,BOS,26,0,0,0,0
48,8480292,Carson Meyer,R,CBJ,27,0,0,0,0
48,8478446,Glenn Gawdin,C,ANA,27,0,0,0,0
48,8483531,Brian Halonen,L,NJD,25,0,0,0,0
48,8477149,Scott Sabourin,R,SJS,32,0,0,0,0
48,8479972,Mason Shaw,C,MIN,26,0,0,0,0
48,8480890,Jan Jenik,R,ARI,24,0,0,0,0
48,8478051,Max Willman,C,NJD,29,0,0,0,0
48,8480851,Akil Thomas,C,LAK,24,0,0,0,0
48,8482765,Isak Rosen,R,BUF,21,0,0,0,0
48,8478421,A.J. Greer,L,CGY,28,0,0,0,0
48,8478512,Austin Czarnik,C,DET,32,0,0,0,0
48,8479536,Axel Jonsson-Fjallby,L,WPG,26,0,0,0,0
48,8477320,Anton Blidh,L,NYR,29,0,0,0,0
48,8481543,Nikita Alexandrov,C,STL,24,0,0,0,0
48,8475235,Nicolas Deslauriers,L,PHI,33,0,0,0,0
48,8481070,Hugh McGing,L,STL,26,0,0,0,0
48,8480836,Jonathan Gruden,C,PIT,24,0,0,0,0
48,8481591,Sam Poulin,R,PIT,23,0,0,0,0
48,8477962,Brendan Lemieux,L,CAR,28,0,0,0,0
48,8483401,Marc Johnstone,R,PIT,28,0,0,0,0
48,8482250,Callahan Burke,C,CAR,27,0,0,0,0
48,8481726,Adam Edstrom,C,NYR,24,0,0,0,0
48,8471817,Ryan Reaves,R,TOR,37,0,0,0,0
48,8479587,Rhett Gardner,C,PHI,28,0,0,0,0
48,8475766,Austin Watson,L,TBL,32,0,0,0,0
48,8479367,William Lockwood,R,FLA,26,0,0,0,0
48,8478424,Jansen Harkins,C,PIT,27,0,0,0,0
48,8476913,Devin Shore,C,SEA,30,0,0,0,0
48,8482652,Walker Duehr,R,CGY,27,0,0,0,0
48,8477527,Ross Johnston,L,ANA,30,0,0,0,0
48,8481077,John Leonard,L,ARI,26,0,0,0,0
48,8483549,Lucas Condotta,L,MTL,27,0,0,0,0
48,8480468,James Hamblin,L,EDM,25,0,0,0,0
48,8476907,Mackenzie MacEachern,L,STL,30,0,0,0,0
48,8479543,Michael Pezzetta,L,MTL,26,0,0,0,0
48,8480355,Mark Kastelic,C,OTT,25,0,0,0,0
48,8482162,Roby Jarventie,L,OTT,22,0,0,0,0
48,8479772,Zack MacEwen,R,OTT,28,0,0,0,0
48,8483597,Milos Kelemen,L,ARI,25,0,0,0,0
48,8479379,Givani Smith,R,SJS,26,0,0,0,0
48,8481655,Cole Schwindt,R,CGY,23,0,0,0,0
48,8479981,Jonah Gadjovich,L,FLA,26,0,0,0,0
48,8482147,Jean-Luc Foudy,C,COL,22,0,0,0,0
48,8484255,Jason Polin,R,COL,25,0,0,0,0
48,8477993,Justin Kirkland,C,ARI,28,0,0,0,0
48,8479249,Andrew Poturalski,C,SEA,30,0,0,0,0
48,8482197,Adam Raska,R,MIN,23,0,0,0,0
48,8475780,Chris Wagner,R,COL,33,0,0,0,0
48,8479533,Joona Koppanen,L,PIT,26,0,0,0,0
48,8481534,Raphael Lavoie,C,EDM,24,0,0,0,0
48,8484321,Nikolas Matinpalo,D,OTT,26,0,0,0,0
48,8481043,Cole Koepke,L,TBL,26,0,0,0,0
48,8476323,Max McCormick,L,SEA,32,0,0,0,0
48,8483609,Adam Klapka,R,CGY,24,0,0,0,0
48,8483512,Matt Savoie,C,BUF,20,0,0,0,0
48,8484259,Ondrej Pavel,C,COL,31,0,0,0,0
48,8478147,Bokondji Imama,L,OTT,28,0,0,0,0
48,8482460,Matt Rempe,C,NYR,22,0,0,0,0
48,8477073,Kurtis MacDermid,L,NJD,30,0,0,0,0
48,8480274,Philip Kemp,D,EDM,25,0,0,0,0
48,8478956,Samuel Laberge,L,NJD,27,0,0,0,0
48,8483045,Cameron Butler,R,CBJ,31,0,0,0,0
49,8477492,Nathan MacKinnon,C,COL,29,82,54,77,131
49,8478402,Connor McDavid,C,EDM,27,82,40,89,129
49,8476453,Nikita Kucherov,R,TBL,31,82,43,74,117
49,8477956,David Pastrnak,R,BOS,28,82,44,64,108
49,8481559,Jack Hughes,C,NJD,23,82,39,59,98
49,8478420,Mikko Rantanen,R,COL,28,82,41,56,97
49,8479318,Auston Matthews,C,TOR,27,82,54,41,95
49,8477934,Leon Draisaitl,C,EDM,29,82,34,60,94
49,8471675,Sidney Crosby,C,PIT,37,82,34,59,93
49,8480027,Jason Robertson,L,DAL,25,82,29,64,93
49,8478550,Artemi Panarin,L,NYR,33,82,41,51,92
49,8475166,John Tavares,C,TOR,34,82,37,53,90
49,8476887,Filip Forsberg,L,NSH,30,82,39,49,88
49,8479314,Matthew Tkachuk,L,FLA,27,82,34,51,85
49,8477939,William Nylander,R,TOR,28,82,32,53,85
49,8477949,Alex Tuch,R,BUF,28,82,22,63,85
49,8478403,Jack Eichel,C,VGK,28,82,38,46,84
49,8477404,Jake Guentzel,C,CAR,30,82,36,47,83
49,8476468,J.T. Miller,C,VAN,31,82,30,53,83
49,8479343,Clayton Keller,R,ARI,26,82,35,46,81
49,8480800,Quinn Hughes,D,VAN,25,82,12,69,81
49,8475786,Zach Hyman,L,EDM,32,82,45,35,80
49,8477942,Kevin Fiala,L,LAK,28,82,29,51,80
49,8471214,Alex Ovechkin,L,WSH,39,82,41,38,79
49,8474564,Steven Stamkos,C,TBL,34,82,38,41,79
49,8478444,Brock Boeser,R,VAN,27,82,38,41,79
49,8479385,Jordan Kyrou,C,STL,26,82,30,49,79
49,8476460,Mark Scheifele,C,WPG,31,82,30,49,79
49,8479407,Jesper Bratt,L,NJD,26,82,27,52,79
49,8478864,Kirill Kaprizov,L,MIN,27,82,33,45,78
49,8480801,Brady Tkachuk,L,OTT,25,82,34,43,77
49,8476389,Vincent Trocheck,C,NYR,31,82,26,50,76
49,8479323,Adam Fox,D,NYR,26,82,17,59,76
49,8478449,Roope Hintz,C,DAL,28,82,29,46,75
49,8479420,Tage Thompson,C,BUF,27,82,36,38,74
49,8478445,Mathew Barzal,C,NYI,27,82,19,54,73
49,8480023,Robert Thomas,C,STL,25,82,17,55,72
49,8478427,Sebastian Aho,C,CAR,27,82,23,48,71
49,8475913,Mark Stone,R,VGK,32,82,36,34,70
49,8477402,Pavel Buchnevich,L,STL,29,82,34,36,70
49,8480012,Elias Pettersson,C,VAN,26,82,32,38,70
49,8477955,Jared McCann,L,SEA,28,82,31,39,70
49,8477951,Nick Schmaltz,C,ARI,28,82,23,47,70
49,8477447,Shea Theodore,D,VGK,29,82,15,55,70
49,8475172,Nazem Kadri,C,CGY,34,82,31,38,69
49,8476459,Mika Zibanejad,C,NYR,31,82,29,40,69
49,8482116,Tim Stützle,C,OTT,22,82,25,44,69
49,8476454,Ryan Nugent-Hopkins,C,EDM,31,82,20,49,69
49,8477493,Aleksander Barkov,C,FLA,29,82,18,51,69
49,8482740,Wyatt Johnston,C,DAL,21,82,38,30,68
49,8471215,Evgeni Malkin,C,PIT,38,82,35,33,68
49,8478398,Kyle Connor,L,WPG,28,82,32,36,68
49,8477501,Valeri Nichushkin,R,COL,29,82,31,37,68
49,8480069,Cale Makar,D,COL,26,82,19,49,68
49,8477500,Bo Horvat,C,NYI,29,82,37,30,67
49,8481557,Matt Boldy,L,MIN,23,82,33,34,67
49,8477409,Carter Verhaeghe,C,FLA,29,82,31,36,67
49,8480002,Nico Hischier,C,NJD,25,82,30,37,67
49,8478439,Travis Konecny,R,PHI,27,82,27,40,67
49,8474600,Roman Josi,D,NSH,34,82,16,51,67
49,8477504,Josh Morrissey,D,WPG,29,82,11,56,67
49,8478010,Brayden Point,C,TBL,28,82,37,29,66
49,8474141,Patrick Kane,R,DET,36,82,24,42,66
49,8474578,Erik Karlsson,D,PIT,34,82,12,53,65
49,8475184,Chris Kreider,L,NYR,33,82,36,28,64
49,8475158,Ryan O'Reilly,C,NSH,33,82,30,34,64
49,8482684,Luke Hughes,D,NJD,21,82,15,49,64
49,8477946,Dylan Larkin,C,DET,28,82,32,31,63
49,8479337,Alex DeBrincat,R,DET,27,82,30,33,63
49,8476881,Tomas Hertl,C,VGK,31,82,26,37,63
49,8471685,Anze Kopitar,C,LAK,37,82,24,39,63
49,8477496,Elias Lindholm,C,VAN,30,82,22,41,63
49,8475167,Victor Hedman,D,TBL,34,82,9,54,63
49,8480839,Rasmus Dahlin,D,BUF,24,82,22,40,62
49,8470794,Joe Pavelski,C,DAL,40,82,27,34,61
49,8480208,Drake Batherson,R,OTT,26,82,20,41,61
49,8476456,Jonathan Huberdeau,C,CGY,31,82,18,43,61
49,8476346,Johnny Gaudreau,L,CBJ,31,82,13,48,61
49,8482097,Jack Quinn,R,BUF,23,82,33,27,60
49,8477933,Sam Reinhart,C,FLA,29,82,29,31,60
49,8475168,Matt Duchene,C,DAL,33,82,24,36,60
49,8478042,Viktor Arvidsson,R,LAK,31,82,23,37,60
49,8478440,Dylan Strome,C,WSH,27,82,17,43,60
49,8481523,Kirby Dach,C,MTL,23,82,10,50,60
49,8480036,Miro Heiskanen,D,DAL,25,82,9,51,60
49,8478047,Michael Bunting,L,PIT,29,82,19,40,59
49,8476539,Jonathan Marchessault,R,VGK,34,82,31,27,58
49,8481528,Dylan Cozens,C,BUF,23,82,23,35,58
49,8477416,Oliver Bjorkstrand,R,SEA,29,82,22,36,58
49,8478401,Pavel Zacha,C,BOS,27,82,20,38,58
49,8478407,Vince Dunn,D,SEA,28,82,9,49,58
49,8482078,Lucas Raymond,L,DET,22,82,29,28,57
49,8473419,Brad Marchand,L,BOS,36,82,22,35,57
49,8482133,Thomas Bordeleau,C,SJS,22,82,18,39,57
49,8476905,Chandler Stephenson,C,VGK,30,82,14,43,57
49,8477960,Adrian Kempe,R,LAK,28,82,27,29,56
49,8479400,Pierre-Luc Dubois,L,LAK,26,82,25,31,56
49,8478856,Conor Garland,R,VAN,28,82,25,31,56
49,8475810,Bryan Rust,R,PIT,32,82,21,35,56
49,8474586,Jordan Eberle,R,SEA,34,82,21,35,56
49,8474679,Gustav Nyquist,C,NSH,35,82,18,38,56
49,8476875,Mike Matheson,D,MTL,30,82,15,41,56
49,8480865,Noah Dobson,D,NYI,24,82,14,42,56
49,8475692,Mats Zuccarello,R,MIN,37,82,13,43,56
49,8481542,Moritz Seider,D,DET,23,82,10,46,56
49,8481540,Cole Caufield,R,MTL,23,82,34,21,55
49,8482093,Seth Jarvis,C,CAR,22,82,20,35,55
49,8480830,Andrei Svechnikov,R,CAR,24,82,19,36,55
49,8475794,Tyler Seguin,C,DAL,32,82,19,36,55
49,8476448,William Karlsson,C,VGK,31,82,19,36,55
49,8475798,Mikael Granlund,C,SJS,32,82,16,39,55
49,8478469,Thomas Chabot,D,OTT,27,82,13,42,55
49,8480803,Evan Bouchard,D,EDM,25,82,6,49,55
49,8478414,Timo Meier,R,NJD,28,82,29,25,54
49,8481533,Trevor Zegras,C,ANA,23,82,18,36,54
49,8475151,Kyle Palmieri,C,NYI,33,82,27,26,53
49,8484144,Connor Bedard,C,CHI,19,82,26,27,53
49,8478493,Joel Eriksson Ek,C,MIN,27,82,23,30,53
49,8477021,Alex Kerfoot,C,ARI,30,82,23,30,53
49,8480031,Maxime Comtois,L,CAR,25,82,20,33,53
49,8480188,Fabian Zetterlund,L,SJS,25,82,20,33,53
49,8471724,Kris Letang,D,PIT,37,82,8,45,53
49,8477964,Ivan Barbashev,C,VGK,29,82,25,27,52
49,8477497,Sean Monahan,C,WPG,30,82,16,36,52
49,8475754,Brock Nelson,C,NYI,33,82,28,23,51
49,8477940,Nikolaj Ehlers,L,WPG,28,82,25,26,51
49,8475169,Evander Kane,L,EDM,33,82,25,26,51
49,8473512,Claude Giroux,R,OTT,36,82,20,31,51
49,8481596,Shane Pinto,C,OTT,24,82,19,32,51
49,8476462,Dougie Hamilton,D,NJD,31,82,17,34,51
49,8479325,Charlie McAvoy,D,BOS,27,82,9,42,51
49,8475784,Jeff Skinner,C,BUF,32,82,26,24,50
49,8479525,Ross Colton,C,COL,28,82,25,25,50
49,8479542,Brandon Hagel,L,TBL,26,82,24,26,50
49,8482092,Ridly Greig,C,OTT,22,82,21,29,50
49,8473994,Jamie Benn,L,DAL,35,82,19,31,50
49,8479339,Patrik Laine,L,CBJ,26,82,18,32,50
49,8478466,Daniel Sprong,R,DET,27,82,30,19,49
49,8475726,Tyler Toffoli,C,WPG,32,82,28,21,49
49,8474641,Adam Henrique,C,EDM,34,82,26,23,49
49,8481068,Yegor Sharangovich,C,CGY,26,82,21,28,49
49,8475170,Brayden Schenn,C,STL,33,82,19,30,49
49,8479999,Casey Mittelstadt,C,COL,26,82,14,35,49
49,8475753,Justin Faulk,D,STL,32,82,9,40,49
49,8480014,Gabriel Vilardi,C,WPG,25,82,25,23,48
49,8471698,T.J. Oshie,R,WSH,38,82,24,24,48
49,8482667,William Eklund,L,SJS,22,82,21,27,48
49,8482699,Dylan Guenther,R,ARI,21,82,18,30,48
49,8483397,Marc McLaughlin,C,BOS,25,82,39,8,47
49,8474102,David Perron,L,DET,36,82,25,22,47
49,8480009,Eeli Tolvanen,R,SEA,25,82,22,25,47
49,8478474,Lawson Crouse,L,ARI,27,82,22,25,47
49,8479675,Trevor Moore,L,LAK,29,82,21,26,47
49,8473449,Kyle Okposo,R,FLA,36,82,20,27,47
49,8476483,Rickard Rakell,R,PIT,31,82,19,28,47
49,8481711,Matias Maccelli,L,ARI,24,82,17,30,47
49,8475745,Charlie Coyle,C,BOS,32,82,17,30,47
49,8475763,Kevin Hayes,R,STL,32,82,22,24,46
49,8477407,Anthony Duclair,L,TBL,29,82,19,27,46
49,8480039,Martin Necas,C,CAR,25,82,18,28,46
49,8474037,James van Riemsdyk,L,BOS,35,82,17,29,46
49,8480078,Filip Chytil,C,NYR,25,82,15,31,46
49,8477479,Tyler Bertuzzi,L,TOR,29,82,13,33,46
49,8482105,Jake Sanderson,D,OTT,22,82,6,40,46
49,8476853,Morgan Rielly,D,TOR,30,82,4,42,46
49,8476399,Blake Coleman,C,CGY,33,82,25,20,45
49,8482113,Anton Lundell,C,FLA,23,82,21,24,45
49,8478873,Troy Terry,R,ANA,27,82,20,25,45
49,8480015,Owen Tippett,R,PHI,25,82,20,25,45
49,8478233,Andrew Mangiapane,L,CGY,28,82,19,26,45
49,8475765,Vladimir Tarasenko,R,FLA,33,82,18,27,45
49,8479987,Morgan Geekie,C,BOS,26,82,17,28,45
49,8482222,Alexander Barabanov,L,SJS,30,82,17,28,45
49,8478460,Zach Werenski,D,CBJ,27,82,13,32,45
49,8479425,Filip Hronek,D,VAN,27,82,12,33,45
49,8478046,Danton Heinen,L,BOS,29,82,12,33,45
49,8476432,Boone Jenner,C,CBJ,31,82,27,17,44
49,8478366,Frank Vatrano,R,ANA,30,82,23,21,44
49,8478975,Mason Marchment,L,DAL,29,82,22,22,44
49,8482109,Alexis Lafrenière,L,NYR,23,82,22,22,44
49,8478498,Jake DeBrusk,L,BOS,28,82,22,22,44
49,8477944,Jakub Vrana,L,STL,28,82,21,23,44
49,8474157,Max Pacioretty,L,WSH,36,82,20,24,44
49,8482159,Tyson Foerster,R,PHI,22,82,20,24,44
49,8482745,Mason McTavish,C,ANA,21,82,19,25,44
49,8480849,Barrett Hayton,C,ARI,24,82,19,25,44
49,8475287,Erik Haula,L,NJD,33,82,19,25,44
49,8480798,Philipp Kurashev,C,CHI,25,82,16,28,44
49,8478519,Anthony Cirelli,C,TBL,27,82,15,29,44
49,8478462,Nicolas Roy,C,VGK,27,82,15,29,44
49,8476906,Shayne Gostisbehere,D,DET,31,82,7,37,44
49,8477935,Sam Bennett,C,FLA,28,82,18,25,43
49,8480018,Nick Suzuki,C,MTL,25,82,18,25,43
49,8471218,Blake Wheeler,R,NYR,38,82,18,25,43
49,8483808,Andrei Kuzmenko,L,CGY,28,82,17,26,43
49,8480797,Joel Farabee,L,PHI,24,82,17,26,43
49,8482720,Matthew Knies,L,TOR,22,82,15,28,43
49,8482124,Quinton Byfield,R,LAK,22,82,10,33,43
49,8480434,Sean Durzi,D,ARI,26,82,10,33,43
49,8482089,Jake Neighbours,L,STL,22,82,22,20,42
49,8477503,Max Domi,C,TOR,29,82,16,26,42
49,8475191,Reilly Smith,R,PIT,33,82,14,28,42
49,8474565,Alex Pietrangelo,D,VGK,34,82,9,33,42
49,8478055,Gustav Forsling,D,FLA,28,82,6,36,42
49,8481699,Aku Raty,R,ARI,23,82,0,42,42
49,8483524,Shane Wright,C,SEA,20,82,27,14,41
49,8480064,Josh Norris,C,OTT,25,82,24,17,41
49,8478057,Dakota Joshua,C,VAN,28,82,22,19,41
49,8476880,Tom Wilson,R,WSH,30,82,21,20,41
49,8478438,Tommy Novak,C,NSH,27,82,21,20,41
49,8470621,Corey Perry,R,EDM,39,82,21,20,41
49,8477444,Andre Burakovsky,L,SEA,29,82,17,24,41
49,8477511,Anthony Mantha,R,VGK,30,82,16,25,41
49,8476479,Phillip Danault,C,LAK,31,82,14,27,41
49,8477456,J.T. Compher,L,DET,29,82,13,28,41
49,8476958,Jaccob Slavin,D,CAR,30,82,6,35,41
49,8482671,Owen Power,D,BUF,22,82,4,37,41
49,8475314,Anders Lee,L,NYI,34,82,23,17,40
49,8477451,Ryan Hartman,R,MIN,30,82,19,21,40
49,8482175,JJ Peterka,R,BUF,22,82,19,21,40
49,8478458,Jack Roslovic,C,NYR,27,82,18,22,40
49,8482146,Luke Evangelista,R,NSH,22,82,16,24,40
49,8474150,Mikael Backlund,C,CGY,35,82,12,28,40
49,8476979,Erik Gustafsson,D,NYR,32,82,8,32,40
49,8482101,Danil Gushchin,L,SJS,22,82,24,15,39
49,8476438,Brandon Saad,L,STL,32,82,21,18,39
49,8482110,Dawson Mercer,C,NJD,23,82,20,19,39
49,8479423,Alex Nylander,L,CBJ,26,82,20,19,39
49,8477476,Artturi Lehkonen,L,COL,29,82,20,19,39
49,8480893,Kirill Marchenko,R,CBJ,24,82,18,21,39
49,8473986,Alex Killorn,L,ANA,35,82,17,22,39
49,8482665,Matty Beniers,C,SEA,22,82,12,27,39
49,8475218,Mattias Ekholm,D,EDM,34,82,10,29,39
49,8476923,Damon Severson,D,CBJ,30,82,8,31,39
49,8482055,Drew O'Connor,L,PIT,26,82,25,13,38
49,8483493,Frank Nazar,C,CHI,20,82,25,13,38
49,8481560,Arthur Kaliyev,R,LAK,23,82,20,18,38
49,8475768,Jaden Schwartz,C,SEA,32,82,19,19,38
49,8477426,Nicholas Paul,L,TBL,29,82,18,20,38
49,8479345,Jakob Chychrun,D,OTT,26,82,18,20,38
49,8476960,Andreas Athanasiou,C,CHI,30,82,15,23,38
49,8482475,Yegor Chinakhov,R,CBJ,23,82,13,25,38
49,8477986,Brandon Montour,D,FLA,30,82,11,27,38
49,8476927,Teddy Blueger,C,VAN,30,82,11,27,38
49,8478396,Noah Hanifin,D,VGK,27,82,10,28,38
49,8474563,Drew Doughty,D,LAK,35,82,9,29,38
49,8478038,Devon Toews,D,COL,30,82,8,30,38
49,8476792,Torey Krug,D,STL,33,82,8,30,38
49,8483471,Brad Lambert,C,WPG,31,82,6,32,38
49,8474590,John Carlson,D,WSH,34,82,2,36,38
49,8476329,Travis Boyd,C,ARI,31,82,13,24,37
49,8478472,Mathieu Joseph,R,OTT,27,82,13,24,37
49,8475744,Evgeny Kuznetsov,C,CAR,32,82,12,25,37
49,8477495,Seth Jones,D,CHI,30,82,7,30,37
49,8481618,Alex Newhook,C,MTL,23,82,20,16,36
49,8482079,Marco Rossi,C,MIN,23,82,18,18,36
49,8480028,Morgan Frost,C,PHI,25,82,16,20,36
49,8475793,Ryan Johansen,C,PHI,32,82,14,22,36
49,8476869,Brady Skjei,D,CAR,30,82,13,23,36
49,8473422,Nick Foligno,L,CHI,37,82,13,23,36
49,8483445,Cutter Gauthier,L,ANA,20,82,9,27,36
49,8477494,Jonathan Drouin,L,COL,29,82,8,28,36
49,8475722,Jason Zucker,L,NSH,32,82,17,18,35
49,8476882,Teuvo Teravainen,L,CAR,30,82,16,19,35
49,8478542,Evan Rodrigues,C,FLA,31,82,14,21,35
49,8475791,Taylor Hall,L,CHI,33,82,12,23,35
49,8481013,Jonatan Berggren,R,DET,24,82,9,26,35
49,8481546,Cam York,D,PHI,23,82,8,27,35
49,8478500,Ivan Provorov,D,CBJ,27,82,7,28,35
49,8475714,Calle Jarnkrok,C,TOR,33,82,20,14,34
49,8478115,Pierre Engvall,L,NYI,28,82,17,17,34
49,8480459,Pius Suter,C,VAN,28,82,16,18,34
49,8476292,Ondrej Palat,L,NJD,33,82,15,19,34
49,8477425,Miles Wood,L,COL,29,82,15,19,34
49,8474884,Mike Hoffman,C,SJS,35,82,13,21,34
49,8476826,Yanni Gourde,C,SEA,33,82,12,22,34
49,8474149,Evgenii Dadonov,R,DAL,35,82,12,22,34
49,8479992,Michael Rasmussen,C,DET,25,82,11,23,34
49,8477947,Sonny Milano,L,WSH,28,82,10,24,34
49,8480873,Rasmus Sandin,D,WSH,24,82,5,29,34
49,8475197,Tyson Barrie,D,NSH,33,82,4,30,34
49,8483431,Logan Cooley,C,ARI,20,82,21,12,33
49,8476374,Sean Kuraly,C,CBJ,31,82,18,15,33
49,8484166,Adam Fantilli,C,CBJ,20,82,17,16,33
49,8476872,Scott Laughton,C,PHI,30,82,15,18,33
49,8481481,Blake Lizotte,C,LAK,27,82,15,18,33
49,8474715,Cam Atkinson,R,PHI,35,82,14,19,33
49,8481656,Aliaksei Protas,C,WSH,23,82,9,24,33
49,8478507,John Marino,D,NJD,27,82,7,26,33
49,8482142,Jamie Drysdale,D,PHI,22,82,6,27,33
49,8475906,John Klingberg,D,TOR,32,82,5,28,33
49,8479398,Samuel Girard,D,COL,26,82,5,28,33
49,8478397,Rasmus Andersson,D,CGY,28,82,4,29,33
49,8479976,Juuso Valimaki,D,ARI,26,82,4,29,33
49,8477998,Warren Foegele,L,EDM,28,82,22,10,32
49,8481535,Nils Hoglander,L,VAN,24,82,19,13,32
49,8482155,Alex Laferriere,R,LAK,23,82,19,13,32
49,8481604,Pavel Dorofeyev,L,VGK,24,82,18,14,32
49,8480113,Alex Iafallo,L,WPG,31,82,14,18,32
49,8481704,Juuso Parssinen,C,NSH,23,82,14,18,32
49,8481624,Ilya Mikheyev,R,VAN,30,82,13,19,32
49,8477989,Christian Dvorak,C,MTL,28,82,13,19,32
49,8477429,Andrew Copp,C,DET,30,82,12,20,32
49,8482624,Daniil Miromanov,D,CGY,27,82,9,23,32
49,8477498,Darnell Nurse,D,EDM,29,82,7,25,32
49,8481581,Thomas Harley,D,DAL,23,82,7,25,32
49,8476854,Hampus Lindholm,D,BOS,30,82,7,25,32
49,8470613,Brent Burns,D,CAR,39,82,6,26,32
49,8477346,MacKenzie Weegar,D,CGY,30,82,6,26,32
49,8475764,Cam Fowler,D,ANA,33,82,6,26,32
49,8479410,Mikhail Sergachev,D,TBL,26,82,4,28,32
49,8484203,Bradly Nadeau,L,CAR,19,82,21,10,31
49,8475760,Nick Bjugstad,C,ARI,32,82,19,12,31
49,8481186,Logan O'Connor,R,COL,28,82,17,14,31
49,8475149,Marcus Johansson,L,MIN,34,82,16,15,31
49,8479977,Kailer Yamamoto,R,SEA,26,82,14,17,31
49,8475343,Nic Dowd,C,WSH,34,82,14,17,31
49,8480802,Ryan McLeod,C,EDM,25,82,13,18,31
49,8476873,Mark Jankowski,C,NSH,30,82,13,18,31
49,8476458,Ryan Strome,C,ANA,31,82,12,19,31
49,8477953,Kasperi Kapanen,R,STL,28,82,9,22,31
49,8479983,Mario Ferraro,D,SJS,26,82,9,22,31
49,8480834,Ty Emberson,D,SJS,24,82,6,25,31
49,8481554,Kaapo Kakko,R,NYR,23,82,17,13,30
49,8482705,Cole Sillinger,C,CBJ,21,82,16,14,30
49,8474189,Lars Eller,C,PIT,35,82,16,14,30
49,8477932,Aaron Ekblad,D,FLA,28,82,11,19,30
49,8476480,Vladislav Namestnikov,C,WPG,32,82,11,19,30
49,8481703,Valtteri Puustinen,R,PIT,25,82,11,19,30
49,8476902,Esa Lindell,D,DAL,30,82,9,21,30
49,8476885,Jacob Trouba,D,NYR,30,82,9,21,30
49,8476892,Colton Parayko,D,STL,31,82,8,22,30
49,8480817,K'Andre Miller,D,NYR,24,82,6,24,30
49,8480145,Neal Pionk,D,WPG,29,82,6,24,30
49,8475181,Nick Leddy,D,STL,33,82,4,26,30
49,8477969,Marcus Pettersson,D,PIT,28,82,3,27,30
49,8479316,Luke Kunin,C,SJS,27,82,19,10,29
49,8474870,Tyler Johnson,C,CHI,34,82,16,13,29
49,8475848,Brendan Gallagher,R,MTL,32,82,15,14,29
49,8474053,Logan Couture,C,SJS,35,82,15,14,29
49,8477952,Robby Fabbri,C,DET,28,82,15,14,29
49,8473533,Jordan Staal,C,CAR,36,82,14,15,29
49,8479365,Trent Frederic,C,BOS,26,82,11,18,29
49,8480068,Ryan Poehling,C,PHI,25,82,9,20,29
49,8478413,Jordan Greenway,L,BUF,27,82,7,22,29
49,8475171,Oliver Ekman-Larsson,D,FLA,33,82,6,23,29
49,8482122,Brock Faber,D,MIN,22,82,4,25,29
49,8475179,Dmitry Kulikov,D,FLA,34,82,3,26,29
49,8475799,Nino Niederreiter,R,WPG,32,82,18,10,28
49,8479591,Michael Eyssimont,C,TBL,28,82,12,16,28
49,8479353,Brett Howden,C,VGK,26,82,11,17,28
49,8479293,Brandon Tanev,L,SEA,33,82,9,19,28
49,8476392,Adam Lowry,C,WPG,31,82,9,19,28
49,8476624,Barclay Goodrow,C,NYR,31,82,8,20,28
49,8479369,Andrew Peeke,D,BOS,26,82,5,23,28
49,8474151,Ryan McDonagh,D,NSH,35,82,5,23,28
49,8476981,Josh Anderson,R,MTL,30,82,15,12,27
49,8478508,Yakov Trenin,C,COL,27,82,14,13,27
49,8478020,Michael Amadio,C,VGK,28,82,12,15,27
49,8478013,Jake Walman,D,DET,28,82,10,17,27
49,8478463,Anthony Beauvillier,L,NSH,27,82,9,18,27
49,8479415,Michael McLeod,C,NJD,26,82,9,18,27
49,8482111,Justin Barron,D,MTL,23,82,9,18,27
49,8473563,Nicklas Backstrom,C,WSH,37,82,9,18,27
49,8480336,Sean Walker,D,COL,30,82,7,20,27
49,8477948,Travis Sanheim,D,PHI,28,82,5,22,27
49,8482145,Mavrik Bourque,C,DAL,22,82,18,8,26
49,8482259,Bobby McMann,C,TOR,28,82,17,9,26
49,8481580,Connor McMichael,C,WSH,23,82,16,10,26
49,8479661,Tanner Jeannot,L,TBL,27,82,16,10,26
49,8476469,Joel Armia,R,MTL,31,82,15,11,26
49,8482702,Logan Stankoven,C,DAL,21,82,14,12,26
49,8483491,Ivan Miroshnichenko,L,WSH,20,82,14,12,26
49,8479390,Taylor Raddysh,R,CHI,26,82,13,13,26
49,8475842,Sam Carrick,C,EDM,32,82,10,16,26
49,8482125,Alexander Holtz,R,NJD,22,82,9,17,26
49,8478109,Victor Olofsson,L,BUF,29,82,8,18,26
49,8481522,Peyton Krebs,C,BUF,23,82,8,18,26
49,8475188,Brayden McNabb,D,VGK,33,82,7,19,26
49,8478178,Darren Raddysh,D,TBL,28,82,5,21,26
49,8483457,Lane Hutson,D,MTL,20,82,1,25,26
49,8476921,Jordan Martinook,L,CAR,32,82,15,10,25
49,8480074,Alexandre Texier,C,CBJ,25,82,14,11,25
49,8479346,Dillon Dube,C,CGY,26,82,13,12,25
49,8483515,Juraj Slafkovsky,L,MTL,20,82,10,15,25
49,8476461,Sean Couturier,C,PHI,32,82,9,16,25
49,8476925,Colton Sissons,C,NSH,31,82,9,16,25
49,8476463,Jonas Brodin,D,MIN,31,82,8,17,25
49,8478911,Matt Roy,D,LAK,29,82,5,20,25
49,8476457,Adam Larsson,D,SEA,32,82,4,21,25
49,8474574,Tyler Myers,D,VAN,34,82,2,23,25
49,8482733,Logan Mailloux,D,MTL,31,82,1,24,25
49,8479359,Beck Malenstyn,L,WSH,26,82,14,10,24
49,8476871,Tanner Pearson,L,MTL,32,82,13,11,24
49,8484153,Leo Carlsson,C,ANA,20,82,11,13,24
49,8481517,Brett Leason,R,ANA,25,82,10,14,24
49,8476422,Mike Reilly,D,NYI,31,82,10,14,24
49,8475220,Marcus Foligno,L,MIN,33,82,10,14,24
49,8479996,Cody Glass,C,NSH,25,82,9,15,24
49,8482074,Connor Zary,C,CGY,23,82,9,15,24
49,8482117,Lukas Reichel,L,CHI,22,82,9,15,24
49,8484145,Zach Benson,L,BUF,19,82,9,15,24
49,8481601,Simon Holmstrom,R,NYI,23,82,9,15,24
49,8478133,Jake Evans,C,MTL,28,82,8,16,24
49,8476931,Jake McCabe,D,TOR,31,82,7,17,24
49,8474034,Pat Maroon,L,BOS,36,82,7,17,24
49,8480871,Adam Boqvist,D,CBJ,24,82,5,19,24
49,8477506,Ryan Pulock,D,NYI,30,82,4,20,24
49,8482245,Artem Zub,D,OTT,29,82,4,20,24
49,8479998,Mikey Anderson,D,LAK,25,82,1,23,24
49,8478569,Noel Acciari,C,PIT,33,82,15,8,23
49,8477330,Dominik Kubalik,L,OTT,29,82,13,10,23
49,8480281,Alexey Toropchenko,R,STL,25,82,13,10,23
49,8480220,Noah Cates,L,PHI,25,82,11,12,23
49,8482679,Matt Coronato,R,CGY,22,82,10,13,23
49,8480980,Connor Dewar,C,TOR,25,82,8,15,23
49,8478851,Alexandre Carrier,D,NSH,28,82,7,16,23
49,8476897,Oskar Sundqvist,C,STL,30,82,7,16,23
49,8479514,Rem Pitlick,C,CHI,27,82,6,17,23
49,8478840,Will Borgen,D,SEA,28,82,6,17,23
49,8481524,Bowen Byram,D,BUF,23,82,6,17,23
49,8477365,Connor Clifton,D,BUF,29,82,6,17,23
49,8481606,Jordan Spence,D,LAK,23,82,5,18,23
49,8480073,Erik Brannstrom,D,OTT,25,82,5,18,23
49,8477839,Conor Sheary,L,TBL,32,82,3,20,23
49,8474716,Jared Spurgeon,D,MIN,35,82,2,21,23
49,8476331,Dylan DeMelo,D,WPG,31,82,2,21,23
49,8480855,Jack McBain,C,ARI,24,82,13,9,22
49,8477450,Jason Dickinson,C,CHI,29,82,12,10,22
49,8481553,Bobby Brink,R,PHI,23,82,11,11,22
49,8477919,Frederick Gaudreau,C,MIN,31,82,9,13,22
49,8470604,Jeff Carter,C,PIT,39,82,8,14,22
49,8483499,Liam Ohgren,L,MIN,20,82,8,14,22
49,8478891,Mason Appleton,C,WPG,28,82,8,14,22
49,8480807,Mattias Samuelsson,D,BUF,24,82,7,15,22
49,8482803,Olen Zellweger,D,ANA,21,82,5,17,22
49,8481014,Alexander Romanov,D,NYI,24,82,5,17,22
49,8470966,Mark Giordano,D,TOR,41,82,5,17,22
49,8477488,Brett Pesce,D,CAR,30,82,4,18,22
49,8482166,Shakir Mukhamadullin,D,SJS,22,82,4,18,22
49,8481016,Ruslan Iskhakov,C,NYI,24,82,3,19,22
49,8477499,Rasmus Ristolainen,D,PHI,30,82,3,19,22
49,8478136,Jake Middleton,D,MIN,28,82,3,19,22
49,8481567,Henry Thrun,D,SJS,23,82,3,19,22
49,8475164,Jakob Silfverberg,R,ANA,34,82,2,20,22
49,8473507,Jeff Petry,D,DET,37,82,0,22,22
49,8482737,Zack Bolduc,C,STL,21,82,11,10,21
49,8477508,Curtis Lazar,C,NJD,29,82,11,10,21
49,8470610,Zach Parise,L,COL,40,82,9,12,21
49,8478831,Kevin Stenlund,C,FLA,28,82,8,13,21
49,8480448,Parker Kelly,L,OTT,25,82,8,13,21
49,8477392,Hudson Fasching,R,NYI,29,82,7,14,21
49,8481477,Nico Sturm,C,SJS,29,82,7,14,21
49,8476891,Matt Grzelcyk,D,BOS,30,82,7,14,21
49,8478430,Oliver Kylington,D,CGY,27,82,7,14,21
49,8478468,Jeremy Lauzon,D,NSH,27,82,6,15,21
49,8480246,Nick Perbix,D,TBL,26,82,5,16,21
49,8478882,Vladislav Gavrikov,D,LAK,29,82,4,17,21
49,8474013,Ian Cole,D,VAN,35,82,4,17,21
49,8470600,Ryan Suter,D,DAL,39,82,3,18,21
49,8476879,Cody Ceci,D,EDM,31,82,3,18,21
49,8475790,Erik Gudbranson,D,CBJ,32,82,3,18,21
49,8476467,Jamie Oleksiak,D,SEA,32,82,3,18,21
49,8481568,Alex Vlasic,D,CHI,23,82,2,19,21
49,8482062,Cole Smith,L,NSH,29,82,12,8,20
49,8480821,Filip Zadina,R,SJS,25,82,9,11,20
49,8481178,Egor Zamula,D,PHI,24,82,8,12,20
49,8476419,Jean-Gabriel Pageau,C,NYI,32,82,6,14,20
49,8483505,Matthew Poitras,C,BOS,20,82,6,14,20
49,8479324,Ryan Lindgren,D,NYR,26,82,6,14,20
49,8482087,Kaiden Guhle,D,MTL,22,82,5,15,20
49,8476312,Josh Manson,D,COL,33,82,3,17,20
49,8477220,Nate Schmidt,D,WPG,33,82,3,17,20
49,8475324,Nick Jensen,D,WSH,34,82,3,17,20
49,8476878,Zemgus Girgensons,L,BUF,30,82,12,7,19
49,8481537,Nikita Okhotiuk,D,CGY,24,82,9,10,19
49,8483565,Nick Blankenburg,D,CBJ,26,82,8,11,19
49,8476278,Colin Blackwell,C,CHI,31,82,7,12,19
49,8479941,Justin Danforth,R,CBJ,31,82,7,12,19
49,8480806,Isac Lundestrom,C,ANA,25,82,7,12,19
49,8478043,Sam Lafferty,C,VAN,29,82,7,12,19
49,8480043,Timothy Liljegren,D,TOR,25,82,6,13,19
49,8479351,Sam Steel,C,DAL,26,82,6,13,19
49,8475690,Chris Tanev,D,DAL,35,82,4,15,19
49,8480172,Jan Rutta,D,SJS,34,82,3,16,19
49,8477505,Alexander Wennberg,C,NYR,30,82,3,16,19
49,8475200,Dmitry Orlov,D,CAR,33,82,2,17,19
49,8478399,Jonas Siegenthaler,D,NJD,27,82,2,17,19
49,8482118,Sam Colangelo,R,ANA,23,82,17,1,18
49,8476858,Phillip Di Giuseppe,L,VAN,31,82,10,8,18
49,8475231,Casey Cizikas,C,NYI,33,82,9,9,18
49,8480813,Joe Veleno,C,DET,24,82,8,10,18
49,8477015,Connor Brown,R,EDM,30,82,7,11,18
49,8482470,Ilya Solovyov,D,CGY,24,82,6,12,18
49,8481028,Martin Pospisil,C,CGY,25,82,6,12,18
49,8478416,Erik Cernak,D,TBL,27,82,5,13,18
49,8479980,Nicolas Hague,D,VGK,26,82,4,14,18
49,8475279,Ben Chiarot,D,DET,33,82,4,14,18
49,8476442,Matt Nieto,L,PIT,32,82,9,8,17
49,8482730,Brandt Clarke,D,LAK,21,82,8,9,17
49,8477406,Mattias Janmark,C,EDM,32,82,8,9,17
49,8473504,Cal Clutterbuck,R,NYI,37,82,8,9,17
49,8480185,Eetu Luostarinen,C,FLA,26,82,6,11,17
49,8477931,Tomas Nosek,L,NJD,32,82,5,12,17
49,8474673,TJ Brodie,D,TOR,34,82,4,13,17
49,8474009,Nick Bonino,C,NYR,36,82,4,13,17
49,8482655,J.J. Moser,D,ARI,24,82,3,14,17
49,8477435,Ryan Graves,D,PIT,29,82,3,14,17
49,8484911,Collin Graf,R,SJS,22,82,3,14,17
49,8483490,Pavel Mintyukov,D,ANA,21,82,2,15,17
49,8476429,Scott Mayfield,D,NYI,32,82,2,15,17
49,8476917,Adam Pelech,D,NYI,30,82,0,17,17
49,8473453,Trevor Lewis,C,LAK,37,82,11,5,16
49,8481093,Rafael Harvey-Pinard,L,MTL,25,82,8,8,16
49,8483763,Maksymilian Szuber,D,ARI,22,82,8,8,16
49,8477335,Kyle Burroughs,D,SJS,29,82,7,9,16
49,8479442,Troy Stecher,D,EDM,30,82,6,10,16
49,8477369,Carson Soucy,D,VAN,30,82,5,11,16
49,8475762,Derek Forbort,D,BOS,32,82,4,12,16
49,8478859,Niko Mikkola,D,FLA,28,82,4,12,16
49,8474166,Alec Martinez,D,VGK,37,82,3,13,16
49,8483466,Kevin Korchinski,D,CHI,20,82,3,13,16
49,8481605,Jackson LaCombe,D,ANA,23,82,3,13,16
49,8482073,Braden Schneider,D,NYR,23,82,2,14,16
49,8480058,Pierre-Olivier Joseph,D,PIT,25,82,2,14,16
49,8476967,Brett Kulak,D,EDM,30,82,1,15,16
49,8482809,Jackson Blake,R,CAR,21,82,9,6,15
49,8482762,Simon Edvinsson,D,DET,21,82,7,8,15
49,8475455,Brenden Dillon,D,WPG,34,82,4,11,15
49,8480860,Kevin Bahl,D,NJD,24,82,3,12,15
49,8482712,Oskar Olausson,R,COL,22,82,3,12,15
49,8482858,Ryker Evans,D,SEA,23,82,2,13,15
49,8477845,Trevor van Riemsdyk,D,WSH,33,82,1,14,15
49,8483482,Tristan Luneau,D,ANA,20,82,8,6,14
49,8478408,Travis Dermott,D,ARI,28,82,6,8,14
49,8480144,David Kampf,C,TOR,29,82,5,9,14
49,8480796,Martin Fehervary,D,WSH,25,82,3,11,14
49,8482516,Matthew Kessel,D,STL,24,82,3,11,14
49,8479371,Dante Fabbro,D,NSH,26,82,2,12,14
49,8475462,Radko Gudas,D,ANA,34,82,2,12,14
49,8475233,David Savard,D,MTL,34,82,1,13,14
49,8482666,Scott Morrow,D,CAR,22,82,8,5,13
49,8476525,Colin Miller,D,WPG,32,82,3,10,13
49,8483495,Simon Nemec,D,NJD,20,82,2,11,13
49,8478451,Ethan Bear,D,WSH,27,82,5,7,12
49,8480035,Henri Jokiharju,D,BUF,25,82,4,8,12
49,8475825,Jani Hakanpää,D,DAL,32,82,3,9,12
49,8482177,Marat Khusnutdinov,C,MIN,22,82,3,9,12
49,8483468,Jiri Kulich,C,BUF,20,82,3,9,12
49,8477353,Tyler Motte,C,TBL,29,82,9,2,11
49,8479393,Noah Gregor,C,TOR,26,82,8,3,11
49,8483012,Logan Morrison,C,SEA,22,82,6,5,11
49,8479291,Kevin Rooney,C,CGY,31,82,6,5,11
49,8481059,Scott Perunovich,D,STL,26,82,4,7,11
49,8478443,Brandon Carlo,D,BOS,28,82,4,7,11
49,8477507,Nikita Zadorov,D,VAN,29,82,3,8,11
49,8480990,Declan Chisholm,D,MIN,24,82,3,8,11
49,8477034,Jaycob Megna,D,CHI,32,82,2,9,11
49,8479383,Boris Katchouk,L,OTT,26,82,6,4,10
49,8483489,Fraser Minten,C,TOR,31,82,6,4,10
49,8474567,Zach Bogosian,D,MIN,34,82,3,7,10
49,8476915,Jujhar Khaira,L,MIN,30,82,3,7,10
49,8476372,Nick Seeler,D,PHI,31,82,2,8,10
49,8480879,Jacob Bernard-Docker,D,OTT,24,82,2,8,10
49,8475208,Brian Dumoulin,D,SEA,33,82,1,9,10
49,8476473,Connor Murphy,D,CHI,31,82,1,9,10
49,8481578,Graeme Clarke,R,NJD,23,82,5,4,9
49,8482713,Mackie Samoskevich,R,FLA,22,82,4,5,9
49,8484149,Gavin Brindley,C,CBJ,20,82,3,6,9
49,8482807,Ethan Del Mastro,D,CHI,21,82,2,7,9
49,8475177,Calvin de Haan,D,TBL,33,82,1,8,9
49,8481599,Victor Soderstrom,D,ARI,23,82,1,7,8
49,8476822,Luke Glendening,C,TBL,35,82,2,5,7
49,8481030,Jack St. Ivany,D,PIT,25,82,2,5,7
49,8471677,Jack Johnson,D,COL,37,82,1,6,7
49,8482859,Zack Ostapchuk,C,OTT,21,82,1,3,4
49,8482141,Lukas Cormier,D,VGK,22,0,0,0,0
49,8476988,Matt Benning,D,SJS,30,0,0,0,0
49,8480727,Zach Whitecloud,D,VGK,28,0,0,0,0
49,8480887,Jordan Harris,D,MTL,24,0,0,0,0
49,8478450,Parker Wotherspoon,D,BOS,27,0,0,0,0
49,8481812,Nikolai Knyzhov,D,SJS,27,0,0,0,0
49,8480001,Urho Vaakanainen,D,ANA,25,0,0,0,0
49,8482176,Wyatt Kaiser,D,CHI,22,0,0,0,0
49,8481122,Simon Benoit,D,TOR,26,0,0,0,0
49,8476441,Joel Edmundson,D,TOR,31,0,0,0,0
49,8480884,Calen Addison,D,SJS,24,0,0,0,0
49,8482511,Mason Lohrei,D,BOS,23,0,0,0,0
49,8482192,Isaak Phillips,D,CHI,23,0,0,0,0
49,8480950,Ilya Lyubushkin,D,TOR,30,0,0,0,0
49,8474031,Kevin Shattenkirk,D,BOS,35,0,0,0,0
49,8475718,Justin Holl,D,DET,32,0,0,0,0
49,8479402,Jake Bean,D,CBJ,26,0,0,0,0
49,8474602,Justin Schultz,D,SEA,34,0,0,0,0
49,8477950,Tony DeAngelo,D,CAR,29,0,0,0,0
49,8481743,Marc Del Gaizo,D,NSH,25,0,0,0,0
49,8481527,Kaedan Korczak,D,VGK,23,0,0,0,0
49,8480192,Johnathan Kovacevic,D,MTL,27,0,0,0,0
49,8476874,Olli Maatta,D,DET,30,0,0,0,0
49,8482144,Jack Thompson,D,SJS,22,0,0,0,0
49,8480222,Sebastian Aho,D,NYI,28,0,0,0,0
49,8479458,Nikita Zaitsev,D,CHI,33,0,0,0,0
49,8471709,Marc-Edouard Vlasic,D,SJS,37,0,0,0,0
49,8482929,Emil Lilleberg,D,TBL,23,0,0,0,0
49,8477018,Ben Hutton,D,VGK,31,0,0,0,0
49,8481056,Spencer Stastney,D,NSH,24,0,0,0,0
49,8481593,Jayden Struble,D,MTL,23,0,0,0,0
49,8479982,Conor Timmins,D,TOR,26,0,0,0,0
49,8474090,Brendan Smith,D,NJD,35,0,0,0,0
49,8482964,Arber Xhekaj,D,MTL,23,0,0,0,0
49,8480891,Michael Kesselring,D,ARI,24,0,0,0,0
49,8477938,Haydn Fleury,D,TBL,28,0,0,0,0
49,8481806,Louis Crevier,D,CHI,23,0,0,0,0
49,8471274,Alex Goligoski,D,MIN,39,0,0,0,0
49,8481600,Tobias Bjornfot,D,FLA,23,0,0,0,0
49,8475797,Jarred Tinordi,D,CHI,32,0,0,0,0
49,8481521,Ronnie Attard,D,PHI,25,0,0,0,0
49,8474612,Travis Hamonic,D,OTT,34,0,0,0,0
49,8479576,Vincent Desharnais,D,EDM,28,0,0,0,0
49,8480049,Dylan Samberg,D,WPG,25,0,0,0,0
49,8483619,Filip Roos,D,CHI,25,0,0,0,0
49,8474568,Luke Schenn,D,NSH,35,0,0,0,0
49,8480184,Gustav Lindstrom,D,ANA,26,0,0,0,0
49,8480070,Ian Mitchell,D,BOS,25,0,0,0,0
49,8480196,Jacob Bryson,D,BUF,27,0,0,0,0
49,8471686,Marc Staal,D,PHI,37,0,0,0,0
49,8477467,Gustav Olofsson,D,SEA,30,0,0,0,0
49,8478970,Jalen Chatfield,D,CAR,28,0,0,0,0
49,8479348,Kale Clague,D,BUF,26,0,0,0,0
49,8473446,Erik Johnson,D,PHI,36,0,0,0,0
49,8477462,Robert Hagg,D,ANA,29,0,0,0,0
49,8478454,Noah Juulsen,D,VAN,27,0,0,0,0
49,8477384,Josh Brown,D,ARI,30,0,0,0,0
49,8481708,Zac Jones,D,NYR,24,0,0,0,0
49,8481167,Brayden Pachal,D,CGY,25,0,0,0,0
49,8482067,Connor Mackey,D,NYR,28,0,0,0,0
49,8483460,David Jiricek,D,CBJ,21,0,0,0,0
49,8481701,Santeri Hatakka,D,NJD,23,0,0,0,0
49,8478021,William Lagesson,D,ANA,28,0,0,0,0
49,8477851,Jordan Oesterle,D,CGY,32,0,0,0,0
49,8478452,Caleb Jones,D,COL,27,0,0,0,0
49,8479984,Cal Foote,D,NJD,26,0,0,0,0
49,8479639,Dylan Coghlan,D,CAR,26,0,0,0,0
49,8480874,Adam Ginning,D,PHI,24,0,0,0,0
49,8479321,Lucas Johansen,D,WSH,27,0,0,0,0
49,8480878,Nils Lundkvist,D,DAL,24,0,0,0,0
49,8482165,Yan Kuznetsov,D,CGY,22,0,0,0,0
49,8484258,Sam Malinski,D,COL,26,0,0,0,0
49,8480157,Calle Rosen,D,STL,30,0,0,0,0
49,8484304,Uvis Balinskis,D,FLA,28,0,0,0,0
49,8479985,Cale Fleury,D,SEA,26,0,0,0,0
49,8479378,Logan Stanley,D,WPG,26,0,0,0,0
49,8477541,Dakota Mermis,D,MIN,30,0,0,0,0
49,8481609,Vladislav Kolyachonok,D,ARI,23,0,0,0,0
49,8480823,Alexander Alexeyev,D,WSH,25,0,0,0,0
49,8481679,Maxence Guenette,D,OTT,23,0,0,0,0
49,8481564,Ryan Johnson,D,BUF,23,0,0,0,0
49,8479376,Victor Mete,D,PHI,26,0,0,0,0
49,8484254,Akito Hirose,D,VAN,25,0,0,0,0
49,8482660,Kent Johnson,C,CBJ,22,0,0,0,0
49,8482149,Cole Perfetti,C,WPG,22,0,0,0,0
49,8477987,Ryan Donato,C,CHI,28,0,0,0,0
49,8475755,Alexander Petrovic,D,DAL,32,0,0,0,0
49,8477810,Joel Hanley,D,CGY,33,0,0,0,0
49,8474145,Robert Bortuzzo,D,NYI,35,0,0,0,0
49,8481161,Jake Christiansen,D,CBJ,25,0,0,0,0
49,8476884,Derrick Pouliot,D,DAL,30,0,0,0,0
49,8481716,Dmitri Voronkov,L,CBJ,24,0,0,0,0
49,8480084,Nick DeSimone,D,NJD,30,0,0,0,0
49,8475750,Jon Merrill,D,MIN,32,0,0,0,0
49,8479315,Joey Anderson,R,CHI,26,0,0,0,0
49,8478011,Louie Belpedio,D,PHI,28,0,0,0,0
49,8482451,Mikael Pyyhtia,L,CBJ,23,0,0,0,0
49,8481541,Samuel Bolduc,D,NYI,24,0,0,0,0
49,8482126,Emil Andrae,D,PHI,31,0,0,0,0
49,8474618,Marco Scandella,D,STL,34,0,0,0,0
49,8477244,Chad Ruhwedel,D,NYR,34,0,0,0,0
49,8477971,Andreas Englund,D,LAK,28,0,0,0,0
49,8480829,Jesperi Kotkaniemi,C,CAR,24,0,0,0,0
49,8479372,Josh Mahura,D,FLA,26,0,0,0,0
49,8482095,Tyler Kleven,D,OTT,22,0,0,0,0
49,8481719,Maxwell Crozier,D,TBL,24,0,0,0,0
49,8475855,Jesper Fast,R,CAR,33,0,0,0,0
49,8480848,Ty Dellandrea,C,DAL,24,0,0,0,0
49,8475193,Tomas Tatar,L,SEA,34,0,0,0,0
49,8476889,Radek Faksa,C,DAL,30,0,0,0,0
49,8478495,Denis Gurianov,R,PHI,27,0,0,0,0
49,8480216,Jacob Peterson,C,SJS,25,0,0,0,0
49,8480252,Cole Guttman,C,CHI,25,0,0,0,0
49,8479026,Philippe Myers,D,TBL,27,0,0,0,0
49,8481006,Tyler Tucker,D,STL,24,0,0,0,0
49,8481032,Paul Cotter,C,VGK,25,0,0,0,0
49,8481577,Philip Tomasino,C,NSH,23,0,0,0,0
49,8476918,Jimmy Vesey,L,NYR,31,0,0,0,0
49,8479320,Max Lajoie,D,TOR,27,0,0,0,0
49,8478017,Mark Friedman,D,VAN,29,0,0,0,0
49,8481754,Nikita Nesterenko,C,ANA,23,0,0,0,0
49,8483407,Brandon Scanlin,D,NYR,25,0,0,0,0
49,8482659,Josh Doan,R,ARI,22,0,0,0,0
49,8477446,Michael McCarron,R,NSH,29,0,0,0,0
49,8477903,Garnet Hathaway,R,PHI,33,0,0,0,0
49,8482153,Brendan Brisson,C,VGK,23,0,0,0,0
49,8483546,Marshall Rifai,D,TOR,26,0,0,0,0
49,8484287,Cole McWard,D,VAN,23,0,0,0,0
49,8478854,Ryan Shea,D,PIT,27,0,0,0,0
49,8481585,Egor Afanasyev,L,NSH,23,0,0,0,0
49,8483398,Declan Carlile,D,TBL,31,0,0,0,0
49,8478502,Dennis Gilbert,D,CGY,28,0,0,0,0
49,8482749,Joshua Roy,R,MTL,21,0,0,0,0
49,8481598,Philip Broberg,D,EDM,23,0,0,0,0
49,8480835,Jack Drury,C,CAR,24,0,0,0,0
49,8480748,Kiefer Sherwood,L,NSH,29,0,0,0,0
49,8476934,Brock McGinn,L,ANA,30,0,0,0,0
49,8480870,Bo Groulx,C,ANA,24,0,0,0,0
49,8479368,Max Jones,L,ANA,26,0,0,0,0
49,8478099,Kevin Labanc,R,SJS,29,0,0,0,0
49,8478067,Oskar Lindblom,L,SJS,28,0,0,0,0
49,8476393,Nick Cousins,C,FLA,31,0,0,0,0
49,8483395,Arshdeep Bains,L,VAN,23,0,0,0,0
49,8480762,Eric Robinson,L,BUF,29,0,0,0,0
49,8479439,Jacob MacDonald,D,SJS,31,0,0,0,0
49,8476474,Stefan Noesen,R,CAR,31,0,0,0,0
49,8482787,Nikita Chibrikov,R,WPG,31,0,0,0,0
49,8478432,Christian Fischer,R,DET,27,0,0,0,0
49,8477979,Nicolas Aube-Kubel,R,WSH,28,0,0,0,0
49,8481789,Tye Kartye,L,SEA,23,0,0,0,0
49,8479330,Brandon Gignac,C,MTL,27,0,0,0,0
49,8480075,Cameron Crotty,D,ARI,25,0,0,0,0
49,8473473,Milan Lucic,L,BOS,36,0,0,0,0
49,8482094,Daemon Hunt,D,MIN,22,0,0,0,0
49,8481206,John Ludvig,D,PIT,24,0,0,0,0
49,8483630,Pavol Regenda,L,ANA,25,0,0,0,0
49,8481617,Vasily Podkolzin,R,VAN,23,0,0,0,0
49,8480306,Grant Hutton,D,NYI,29,0,0,0,0
49,8480995,Pontus Holmberg,R,TOR,25,0,0,0,0
49,8482148,Hendrix Lapierre,C,WSH,22,0,0,0,0
49,8477478,William Carrier,L,VGK,30,0,0,0,0
49,8480003,Jesper Boqvist,C,BOS,26,0,0,0,0
49,8482172,Landon Slaggert,L,CHI,22,0,0,0,0
49,8480789,Oliver Wahlstrom,R,NYI,24,0,0,0,0
49,8474062,Riley Nash,C,NYR,35,0,0,0,0
49,8480021,Jack Studnicka,C,SJS,25,0,0,0,0
49,8480025,MacKenzie Entwistle,R,CHI,25,0,0,0,0
49,8481582,Nicholas Robertson,L,TOR,23,0,0,0,0
49,8476867,Brendan Gaunce,C,CBJ,30,0,0,0,0
49,8479619,Michael Carcone,L,ARI,28,0,0,0,0
49,8479370,Tyson Jost,C,BUF,26,0,0,0,0
49,8479671,Mathieu Olivier,R,CBJ,27,0,0,0,0
49,8476994,Vinnie Hinostroza,C,PIT,30,0,0,0,0
49,8482070,Mitchell Chaffee,R,TBL,26,0,0,0,0
49,8477473,Justin Bailey,R,SJS,29,0,0,0,0
49,8479344,Jesse Puljujarvi,R,PIT,26,0,0,0,0
49,8480205,Emil Bemstrom,C,PIT,25,0,0,0,0
49,8479718,Alex Barré-Boulet,C,TBL,27,0,0,0,0
49,8482061,Brandon Biro,L,BUF,26,0,0,0,0
49,8479638,Justin Brazeau,R,BOS,26,0,0,0,0
49,8474040,Sam Gagner,C,EDM,35,0,0,0,0
49,8477846,Ryan Carpenter,C,SJS,33,0,0,0,0
49,8482077,Dylan Holloway,L,EDM,23,0,0,0,0
49,8482157,Will Cuylle,L,NYR,22,0,0,0,0
49,8480007,Jonas Rondbjerg,R,VGK,25,0,0,0,0
49,8478874,Adam Gaudette,C,STL,28,0,0,0,0
49,8478434,Keegan Kolesar,R,VGK,27,0,0,0,0
49,8480441,Trey Fix-Wolansky,R,CBJ,25,0,0,0,0
49,8479994,Jaret Anderson-Dolan,C,NSH,25,0,0,0,0
49,8483567,Georgii Merkulov,C,BOS,24,0,0,0,0
49,8477380,Jonny Brodzinski,C,NYR,31,0,0,0,0
49,8482201,Gage Goncalves,C,TBL,23,0,0,0,0
49,8478211,Dryden Hunt,L,CGY,29,0,0,0,0
49,8471699,Andrew Cogliano,C,COL,37,0,0,0,0
49,8479421,Jacob Moverare,D,LAK,26,0,0,0,0
49,8478881,Brett Seney,L,CHI,28,0,0,0,0
49,8477464,Nic Petan,C,MIN,29,0,0,0,0
49,8475958,Michael Sgarbossa,C,WSH,32,0,0,0,0
49,8481147,Reese Johnson,C,CHI,26,0,0,0,0
49,8479336,Carl Grundstrom,R,LAK,27,0,0,0,0
49,8480853,Liam Foudy,C,NSH,24,0,0,0,0
49,8479522,Hardy Haman Aktell,D,WSH,26,0,0,0,0
49,8481462,Mason Morelli,L,VGK,28,0,0,0,0
49,8482102,Vasily Ponomarev,C,CAR,22,0,0,0,0
49,8480844,Grigori Denisenko,L,VGK,24,0,0,0,0
49,8479944,Zach Aston-Reese,C,DET,30,0,0,0,0
49,8482784,Zach Dean,C,STL,21,0,0,0,0
49,8479419,Brett Murray,L,BUF,26,0,0,0,0
49,8479520,Brandon Duhaime,R,COL,27,0,0,0,0
49,8477573,Nathan Walker,L,STL,30,0,0,0,0
49,8478078,Rourke Chartier,C,OTT,28,0,0,0,0
49,8475795,Dylan McIlrath,D,WSH,32,0,0,0,0
49,8482496,Nils Aman,C,VAN,24,0,0,0,0
49,8480289,Morgan Barron,C,WPG,26,0,0,0,0
49,8481751,Lukas Rousek,R,BUF,25,0,0,0,0
49,8480011,Klim Kostin,C,SJS,25,0,0,0,0
49,8481556,John Beecher,C,BOS,23,0,0,0,0
49,8475278,Byron Froese,C,VGK,33,0,0,0,0
49,8475225,Craig Smith,C,DAL,35,0,0,0,0
49,8484326,Patrik Koch,D,ARI,28,0,0,0,0
49,8477930,Pierre-Edouard Bellemare,L,SEA,39,0,0,0,0
49,8478409,Anthony Richard,C,BOS,28,0,0,0,0
49,8481024,Linus Karlsson,C,VAN,25,0,0,0,0
49,8479986,Kole Lind,R,SEA,26,0,0,0,0
49,8479414,Nathan Bastian,R,NJD,27,0,0,0,0
49,8479362,Riley Tufte,L,COL,26,0,0,0,0
49,8481058,Jesse Ylönen,R,MTL,25,0,0,0,0
49,8482476,Emil Heineman,L,MTL,23,0,0,0,0
49,8482861,Vincent Iorio,D,WSH,22,0,0,0,0
49,8483432,Luca Del Bel Belluz,C,CBJ,31,0,0,0,0
49,8482744,James Malatesta,L,CBJ,21,0,0,0,0
49,8477887,Patrick Brown,C,BOS,32,0,0,0,0
49,8478585,Derek Ryan,C,EDM,38,0,0,0,0
49,8481441,Joe Snively,C,WSH,28,0,0,0,0
49,8481592,Jakob Pelletier,L,CGY,23,0,0,0,0
49,8482634,Alex Steeves,C,TOR,25,0,0,0,0
49,8477126,Jayson Megna,C,BOS,34,0,0,0,0
49,8475752,Tyler Pitlick,C,NYR,33,0,0,0,0
49,8480008,Adam Ruzicka,C,ARI,25,0,0,0,0
49,8481065,Angus Crookshank,L,OTT,25,0,0,0,0
49,8479547,Matthew Phillips,R,WSH,26,0,0,0,0
49,8480226,Marián Studenic,R,SEA,26,0,0,0,0
49,8481237,Kyle MacLean,C,NYI,25,0,0,0,0
49,8475413,Justin Dowling,C,NJD,34,0,0,0,0
49,8481641,Joel Kiviranta,L,COL,28,0,0,0,0
49,8478104,Sammy Blais,L,STL,28,0,0,0,0
49,8477454,Adam Erne,L,EDM,29,0,0,0,0
49,8481518,Nolan Foote,L,NJD,24,0,0,0,0
49,8480245,Olle Lycksell,R,PHI,25,0,0,0,0
49,8483570,Ben Meyers,C,ANA,26,0,0,0,0
49,8480776,Sheldon Rempal,R,VGK,29,0,0,0,0
49,8483920,Pierrick Dube,R,WSH,23,0,0,0,0
49,8480267,Sammy Walker,C,MIN,25,0,0,0,0
49,8482747,Brennan Othmann,L,NYR,21,0,0,0,0
49,8479991,Jake Leschyshyn,C,NYR,25,0,0,0,0
49,8478400,Colin White,C,MTL,27,0,0,0,0
49,8479328,Julien Gauthier,R,NYI,27,0,0,0,0
49,8484325,Waltteri Merela,C,TBL,26,0,0,0,0
49,8479066,Ryan Lomberg,L,FLA,30,0,0,0,0
49,8477070,Liam O'Brien,C,ARI,30,0,0,0,0
49,8478146,Matthew Highmore,C,OTT,28,0,0,0,0
49,8478028,Fredrik Olofsson,L,COL,28,0,0,0,0
49,8480880,Jakub Lauko,C,BOS,24,0,0,0,0
49,8479968,Vinni Lettieri,C,MIN,29,0,0,0,0
49,8474709,Matt Martin,L,NYI,35,0,0,0,0
49,8480845,Rasmus Kupari,C,WPG,24,0,0,0,0
49,8481550,Adam Beckman,L,MIN,23,0,0,0,0
49,8481422,Jacob Lucchini,C,MIN,29,0,0,0,0
49,8477401,John Hayden,C,SEA,29,0,0,0,0
49,8478904,Steven Lorentz,C,FLA,28,0,0,0,0
49,8482088,Justin Sourdif,R,FLA,22,0,0,0,0
49,8482751,Ryan Winterton,C,SEA,21,0,0,0,0
49,8482241,Radim Zohorna,L,PIT,28,0,0,0,0
49,8481690,Tyler Angle,C,CBJ,24,0,0,0,0
49,8476952,Dominic Toninato,C,WPG,30,0,0,0,0
49,8476919,Chris Tierney,C,NJD,30,0,0,0,0
49,8480032,Shane Bowers,C,NJD,25,0,0,0,0
49,8484314,Jiri Smejkal,L,OTT,28,0,0,0,0
49,8481239,Samuel Fagemo,L,LAK,24,0,0,0,0
49,8481532,Alex Turcotte,C,LAK,23,0,0,0,0
49,8481019,David Gustafsson,C,WPG,24,0,0,0,0
49,8478477,Mitchell Stephens,C,MTL,27,0,0,0,0
49,8479546,Oskar Steen,C,BOS,26,0,0,0,0
49,8480292,Carson Meyer,R,CBJ,27,0,0,0,0
49,8478446,Glenn Gawdin,C,ANA,27,0,0,0,0
49,8483531,Brian Halonen,L,NJD,25,0,0,0,0
49,8477149,Scott Sabourin,R,SJS,32,0,0,0,0
49,8479972,Mason Shaw,C,MIN,26,0,0,0,0
49,8480890,Jan Jenik,R,ARI,24,0,0,0,0
49,8478051,Max Willman,C,NJD,29,0,0,0,0
49,8480851,Akil Thomas,C,LAK,24,0,0,0,0
49,8482765,Isak Rosen,R,BUF,21,0,0,0,0
49,8478421,A.J. Greer,L,CGY,28,0,0,0,0
49,8478512,Austin Czarnik,C,DET,32,0,0,0,0
49,8479536,Axel Jonsson-Fjallby,L,WPG,26,0,0,0,0
49,8477320,Anton Blidh,L,NYR,29,0,0,0,0
49,8481543,Nikita Alexandrov,C,STL,24,0,0,0,0
49,8475235,Nicolas Deslauriers,L,PHI,33,0,0,0,0
49,8481070,Hugh McGing,L,STL,26,0,0,0,0
49,8480836,Jonathan Gruden,C,PIT,24,0,0,0,0
49,8481591,Sam Poulin,R,PIT,23,0,0,0,0
49,8477962,Brendan Lemieux,L,CAR,28,0,0,0,0
49,8483401,Marc Johnstone,R,PIT,28,0,0,0,0
49,8482250,Callahan Burke,C,CAR,27,0,0,0,0
49,8481726,Adam Edstrom,C,NYR,24,0,0,0,0
49,8471817,Ryan Reaves,R,TOR,37,0,0,0,0
49,8479587,Rhett Gardner,C,PHI,28,0,0,0,0
49,8475766,Austin Watson,L,TBL,32,0,0,0,0
49,8479367,William Lockwood,R,FLA,26,0,0,0,0
49,8478424,Jansen Harkins,C,PIT,27,0,0,0,0
49,8476913,Devin Shore,C,SEA,30,0,0,0,0
49,8482652,Walker Duehr,R,CGY,27,0,0,0,0
49,8477527,Ross Johnston,L,ANA,30,0,0,0,0
49,8481077,John Leonard,L,ARI,26,0,0,0,0
49,8483549,Lucas Condotta,L,MTL,27,0,0,0,0
49,8480468,James Hamblin,L,EDM,25,0,0,0,0
49,8476907,Mackenzie MacEachern,L,STL,30,0,0,0,0
49,8479543,Michael Pezzetta,L,MTL,26,0,0,0,0
49,8480355,Mark Kastelic,C,OTT,25,0,0,0,0
49,8482162,Roby Jarventie,L,OTT,22,0,0,0,0
49,8479772,Zack MacEwen,R,OTT,28,0,0,0,0
49,8483597,Milos Kelemen,L,ARI,25,0,0,0,0
49,8479379,Givani Smith,R,SJS,26,0,0,0,0
49,8481655,Cole Schwindt,R,CGY,23,0,0,0,0
49,8479981,Jonah Gadjovich,L,FLA,26,0,0,0,0
49,8482147,Jean-Luc Foudy,C,COL,22,0,0,0,0
49,8484255,Jason Polin,R,COL,25,0,0,0,0
49,8477993,Justin Kirkland,C,ARI,28,0,0,0,0
49,8479249,Andrew Poturalski,C,SEA,30,0,0,0,0
49,8482197,Adam Raska,R,MIN,23,0,0,0,0
49,8475780,Chris Wagner,R,COL,33,0,0,0,0
49,8479533,Joona Koppanen,L,PIT,26,0,0,0,0
49,8481534,Raphael Lavoie,C,EDM,24,0,0,0,0
49,8484321,Nikolas Matinpalo,D,OTT,26,0,0,0,0
49,8481043,Cole Koepke,L,TBL,26,0,0,0,0
49,8476323,Max McCormick,L,SEA,32,0,0,0,0
49,8483609,Adam Klapka,R,CGY,24,0,0,0,0
49,8483512,Matt Savoie,C,BUF,20,0,0,0,0
49,8484259,Ondrej Pavel,C,COL,31,0,0,0,0
49,8478147,Bokondji Imama,L,OTT,28,0,0,0,0
49,8482460,Matt Rempe,C,NYR,22,0,0,0,0
49,8477073,Kurtis MacDermid,L,NJD,30,0,0,0,0
49,8480274,Philip Kemp,D,EDM,25,0,0,0,0
49,8478956,Samuel Laberge,L,NJD,27,0,0,0,0
49,8483045,Cameron Butler,R,CBJ,31,0,0,0,0
50,8478402,Connor McDavid,C,EDM,27,82,43,83,126
50,8476453,Nikita Kucherov,R,TBL,31,82,48,72,120
50,8477492,Nathan MacKinnon,C,COL,29,82,51,66,117
50,8481559,Jack Hughes,C,NJD,23,82,43,68,111
50,8478420,Mikko Rantanen,R,COL,28,82,43,68,111
50,8475166,John Tavares,C,TOR,34,82,41,63,104
50,8479407,Jesper Bratt,L,NJD,26,82,36,57,93
50,8477956,David Pastrnak,R,BOS,28,82,35,57,92
50,8474564,Steven Stamkos,C,TBL,34,82,34,58,92
50,8480069,Cale Makar,D,COL,26,82,25,67,92
50,8477934,Leon Draisaitl,C,EDM,29,82,39,51,90
50,8479314,Matthew Tkachuk,L,FLA,27,82,41,47,88
50,8478864,Kirill Kaprizov,L,MIN,27,82,39,49,88
50,8477939,William Nylander,R,TOR,28,82,38,50,88
50,8475692,Mats Zuccarello,R,MIN,37,82,24,63,87
50,8478010,Brayden Point,C,TBL,28,82,40,46,86
50,8481557,Matt Boldy,L,MIN,23,82,30,56,86
50,8479318,Auston Matthews,C,TOR,27,82,47,36,83
50,8471675,Sidney Crosby,C,PIT,37,82,38,45,83
50,8474600,Roman Josi,D,NSH,34,82,25,58,83
50,8480800,Quinn Hughes,D,VAN,25,82,9,74,83
50,8475786,Zach Hyman,L,EDM,32,82,45,37,82
50,8482116,Tim Stützle,C,OTT,22,82,35,47,82
50,8471214,Alex Ovechkin,L,WSH,39,82,39,41,80
50,8477942,Kevin Fiala,L,LAK,28,82,24,55,79
50,8478398,Kyle Connor,L,WPG,28,82,37,41,78
50,8476887,Filip Forsberg,L,NSH,30,82,32,46,78
50,8478427,Sebastian Aho,C,CAR,27,82,32,46,78
50,8478550,Artemi Panarin,L,NYR,33,82,25,53,78
50,8476346,Johnny Gaudreau,L,CBJ,31,82,24,53,77
50,8476468,J.T. Miller,C,VAN,31,82,31,45,76
50,8476389,Vincent Trocheck,C,NYR,31,82,31,45,76
50,8480023,Robert Thomas,C,STL,25,82,19,57,76
50,8477946,Dylan Larkin,C,DET,28,82,40,35,75
50,8477496,Elias Lindholm,C,VAN,30,82,36,39,75
50,8479542,Brandon Hagel,L,TBL,26,82,30,45,75
50,8478445,Mathew Barzal,C,NYI,27,82,23,51,74
50,8478444,Brock Boeser,R,VAN,27,82,38,35,73
50,8480801,Brady Tkachuk,L,OTT,25,82,35,38,73
50,8477933,Sam Reinhart,C,FLA,29,82,30,43,73
50,8477951,Nick Schmaltz,C,ARI,28,82,26,47,73
50,8475172,Nazem Kadri,C,CGY,34,82,28,43,71
50,8480012,Elias Pettersson,C,VAN,26,82,27,44,71
50,8481523,Kirby Dach,C,MTL,23,82,13,58,71
50,8477500,Bo Horvat,C,NYI,29,82,37,33,70
50,8475913,Mark Stone,R,VGK,32,82,23,47,70
50,8477409,Carter Verhaeghe,C,FLA,29,82,32,37,69
50,8480830,Andrei Svechnikov,R,CAR,24,82,31,38,69
50,8478439,Travis Konecny,R,PHI,27,82,27,42,69
50,8479323,Adam Fox,D,NYR,26,82,18,51,69
50,8480014,Gabriel Vilardi,C,WPG,25,82,50,18,68
50,8478873,Troy Terry,R,ANA,27,82,30,38,68
50,8480027,Jason Robertson,L,DAL,25,82,29,38,67
50,8479420,Tage Thompson,C,BUF,27,82,31,35,66
50,8479343,Clayton Keller,R,ARI,26,82,24,42,66
50,8478403,Jack Eichel,C,VGK,28,82,32,33,65
50,8473512,Claude Giroux,R,OTT,36,82,30,35,65
50,8477404,Jake Guentzel,C,CAR,30,82,23,42,65
50,8476459,Mika Zibanejad,C,NYR,31,82,23,42,65
50,8477447,Shea Theodore,D,VGK,29,82,19,46,65
50,8480839,Rasmus Dahlin,D,BUF,24,82,19,46,65
50,8478414,Timo Meier,R,NJD,28,82,37,27,64
50,8477493,Aleksander Barkov,C,FLA,29,82,13,51,64
50,8475184,Chris Kreider,L,NYR,33,82,44,19,63
50,8482078,Lucas Raymond,L,DET,22,82,20,43,63
50,8471685,Anze Kopitar,C,LAK,37,82,26,36,62
50,8477402,Pavel Buchnevich,L,STL,29,82,24,38,62
50,8475167,Victor Hedman,D,TBL,34,82,8,54,62
50,8482109,Alexis Lafrenière,L,NYR,23,82,34,27,61
50,8477479,Tyler Bertuzzi,L,TOR,29,82,28,33,61
50,8480039,Martin Necas,C,CAR,25,82,26,35,61
50,8480803,Evan Bouchard,D,EDM,25,82,13,48,61
50,8479385,Jordan Kyrou,C,STL,26,82,34,26,60
50,8471215,Evgeni Malkin,C,PIT,38,82,29,31,60
50,8478493,Joel Eriksson Ek,C,MIN,27,82,29,31,60
50,8476881,Tomas Hertl,C,VGK,31,82,24,36,60
50,8479675,Trevor Moore,L,LAK,29,82,23,37,60
50,8473419,Brad Marchand,L,BOS,36,82,17,43,60
50,8477501,Valeri Nichushkin,R,COL,29,82,31,28,59
50,8480018,Nick Suzuki,C,MTL,25,82,28,31,59
50,8476460,Mark Scheifele,C,WPG,31,82,21,38,59
50,8480002,Nico Hischier,C,NJD,25,82,20,39,59
50,8476454,Ryan Nugent-Hopkins,C,EDM,31,82,19,40,59
50,8476456,Jonathan Huberdeau,C,CGY,31,82,19,40,59
50,8477504,Josh Morrissey,D,WPG,29,82,6,52,58
50,8477940,Nikolaj Ehlers,L,WPG,28,82,25,32,57
50,8482745,Mason McTavish,C,ANA,21,82,20,37,57
50,8482097,Jack Quinn,R,BUF,23,82,18,39,57
50,8474141,Patrick Kane,R,DET,36,82,15,42,57
50,8477986,Brandon Montour,D,FLA,30,82,9,48,57
50,8476539,Jonathan Marchessault,R,VGK,34,82,29,27,56
50,8477476,Artturi Lehkonen,L,COL,29,82,26,30,56
50,8482093,Seth Jarvis,C,CAR,22,82,25,31,56
50,8478856,Conor Garland,R,VAN,28,82,22,34,56
50,8476792,Torey Krug,D,STL,33,82,16,40,56
50,8480865,Noah Dobson,D,NYI,24,82,10,46,56
50,8479410,Mikhail Sergachev,D,TBL,26,82,8,48,56
50,8476853,Morgan Rielly,D,TOR,30,82,6,50,56
50,8477960,Adrian Kempe,R,LAK,28,82,34,21,55
50,8475754,Brock Nelson,C,NYI,33,82,30,25,55
50,8479337,Alex DeBrincat,R,DET,27,82,25,30,55
50,8473994,Jamie Benn,L,DAL,35,82,21,34,55
50,8475168,Matt Duchene,C,DAL,33,82,17,38,55
50,8477416,Oliver Bjorkstrand,R,SEA,29,82,14,41,55
50,8475798,Mikael Granlund,C,SJS,32,82,11,44,55
50,8482159,Tyson Foerster,R,PHI,22,82,28,26,54
50,8475810,Bryan Rust,R,PIT,32,82,26,28,54
50,8478047,Michael Bunting,L,PIT,29,82,18,36,54
50,8478460,Zach Werenski,D,CBJ,27,82,11,43,54
50,8477407,Anthony Duclair,L,TBL,29,82,31,22,53
50,8475169,Evander Kane,L,EDM,33,82,23,30,53
50,8480015,Owen Tippett,R,PHI,25,82,22,31,53
50,8475765,Vladimir Tarasenko,R,FLA,33,82,21,32,53
50,8474150,Mikael Backlund,C,CGY,35,82,21,32,53
50,8477451,Ryan Hartman,R,MIN,30,82,20,33,53
50,8481528,Dylan Cozens,C,BUF,23,82,18,35,53
50,8481711,Matias Maccelli,L,ARI,24,82,13,40,53
50,8477495,Seth Jones,D,CHI,30,82,8,45,53
50,8476432,Boone Jenner,C,CBJ,31,82,37,15,52
50,8475784,Jeff Skinner,C,BUF,32,82,28,24,52
50,8470794,Joe Pavelski,C,DAL,40,82,18,34,52
50,8480798,Philipp Kurashev,C,CHI,25,82,16,36,52
50,8470613,Brent Burns,D,CAR,39,82,15,37,52
50,8482124,Quinton Byfield,R,LAK,22,82,25,26,51
50,8478466,Daniel Sprong,R,DET,27,82,22,29,51
50,8478042,Viktor Arvidsson,R,LAK,31,82,20,31,51
50,8476462,Dougie Hamilton,D,NJD,31,82,20,31,51
50,8474578,Erik Karlsson,D,PIT,34,82,19,32,51
50,8478055,Gustav Forsling,D,FLA,28,82,17,34,51
50,8482665,Matty Beniers,C,SEA,22,82,15,36,51
50,8479525,Ross Colton,C,COL,28,82,30,20,50
50,8483808,Andrei Kuzmenko,L,CGY,28,82,20,30,50
50,8474679,Gustav Nyquist,C,NSH,35,82,17,33,50
50,8482684,Luke Hughes,D,NJD,21,82,15,35,50
50,8480036,Miro Heiskanen,D,DAL,25,82,12,38,50
50,8478440,Dylan Strome,C,WSH,27,82,11,39,50
50,8483445,Cutter Gauthier,L,ANA,20,82,10,40,50
50,8477932,Aaron Ekblad,D,FLA,28,82,10,40,50
50,8477935,Sam Bennett,C,FLA,28,82,29,20,49
50,8478474,Lawson Crouse,L,ARI,27,82,28,21,49
50,8478449,Roope Hintz,C,DAL,28,82,26,23,49
50,8475726,Tyler Toffoli,C,WPG,32,82,23,26,49
50,8476448,William Karlsson,C,VGK,31,82,22,27,49
50,8477949,Alex Tuch,R,BUF,28,82,18,31,49
50,8478401,Pavel Zacha,C,BOS,27,82,17,32,49
50,8474590,John Carlson,D,WSH,34,82,11,38,49
50,8476905,Chandler Stephenson,C,VGK,30,82,10,39,49
50,8471698,T.J. Oshie,R,WSH,38,82,23,25,48
50,8478438,Tommy Novak,C,NSH,27,82,20,28,48
50,8480208,Drake Batherson,R,OTT,26,82,15,33,48
50,8477021,Alex Kerfoot,C,ARI,30,82,15,33,48
50,8481533,Trevor Zegras,C,ANA,23,82,14,34,48
50,8479999,Casey Mittelstadt,C,COL,26,82,10,38,48
50,8483524,Shane Wright,C,SEA,20,82,38,9,47
50,8480064,Josh Norris,C,OTT,25,82,31,16,47
50,8475314,Anders Lee,L,NYI,34,82,29,18,47
50,8478366,Frank Vatrano,R,ANA,30,82,25,22,47
50,8474037,James van Riemsdyk,L,BOS,35,82,24,23,47
50,8482110,Dawson Mercer,C,NJD,23,82,24,23,47
50,8475794,Tyler Seguin,C,DAL,32,82,20,27,47
50,8482740,Wyatt Johnston,C,DAL,21,82,18,29,47
50,8474102,David Perron,L,DET,36,82,18,29,47
50,8478975,Mason Marchment,L,DAL,29,82,15,32,47
50,8477497,Sean Monahan,C,WPG,30,82,13,34,47
50,8478469,Thomas Chabot,D,OTT,27,82,12,35,47
50,8478397,Rasmus Andersson,D,CGY,28,82,7,40,47
50,8476958,Jaccob Slavin,D,CAR,30,82,6,41,47
50,8479339,Patrik Laine,L,CBJ,26,82,25,21,46
50,8475170,Brayden Schenn,C,STL,33,82,22,24,46
50,8481699,Aku Raty,R,ARI,23,82,3,43,46
50,8477952,Robby Fabbri,C,DET,28,82,24,21,45
50,8475793,Ryan Johansen,C,PHI,32,82,21,24,45
50,8478115,Pierre Engvall,L,NYI,28,82,21,24,45
50,8478542,Evan Rodrigues,C,FLA,31,82,20,25,45
50,8481596,Shane Pinto,C,OTT,24,82,18,27,45
50,8476329,Travis Boyd,C,ARI,31,82,17,28,45
50,8482113,Anton Lundell,C,FLA,23,82,16,29,45
50,8474563,Drew Doughty,D,LAK,35,82,8,37,45
50,8481540,Cole Caufield,R,MTL,23,82,24,20,44
50,8482699,Dylan Guenther,R,ARI,21,82,22,22,44
50,8483431,Logan Cooley,C,ARI,20,82,22,22,44
50,8475158,Ryan O'Reilly,C,NSH,33,82,19,25,44
50,8479987,Morgan Geekie,C,BOS,26,82,14,30,44
50,8477494,Jonathan Drouin,L,COL,29,82,14,30,44
50,8478407,Vince Dunn,D,SEA,28,82,13,31,44
50,8479325,Charlie McAvoy,D,BOS,27,82,7,37,44
50,8479425,Filip Hronek,D,VAN,27,82,5,39,44
50,8478519,Anthony Cirelli,C,TBL,27,82,23,20,43
50,8481068,Yegor Sharangovich,C,CGY,26,82,21,22,43
50,8475722,Jason Zucker,L,NSH,32,82,17,26,43
50,8483515,Juraj Slafkovsky,L,MTL,20,82,17,26,43
50,8480031,Maxime Comtois,L,CAR,25,82,16,27,43
50,8475191,Reilly Smith,R,PIT,33,82,15,28,43
50,8478458,Jack Roslovic,C,NYR,27,82,15,28,43
50,8476479,Phillip Danault,C,LAK,31,82,14,29,43
50,8475744,Evgeny Kuznetsov,C,CAR,32,82,13,30,43
50,8480871,Adam Boqvist,D,CBJ,24,82,9,34,43
50,8476923,Damon Severson,D,CBJ,30,82,8,35,43
50,8477964,Ivan Barbashev,C,VGK,29,82,20,22,42
50,8473563,Nicklas Backstrom,C,WSH,37,82,17,25,42
50,8480220,Noah Cates,L,PHI,25,82,12,30,42
50,8478038,Devon Toews,D,COL,30,82,11,31,42
50,8478396,Noah Hanifin,D,VGK,27,82,10,32,42
50,8481703,Valtteri Puustinen,R,PIT,25,82,8,34,42
50,8476438,Brandon Saad,L,STL,32,82,23,18,41
50,8477998,Warren Foegele,L,EDM,28,82,22,19,41
50,8475745,Charlie Coyle,C,BOS,32,82,19,22,41
50,8478462,Nicolas Roy,C,VGK,27,82,18,23,41
50,8484144,Connor Bedard,C,CHI,19,82,17,24,41
50,8480078,Filip Chytil,C,NYR,25,82,16,25,41
50,8478020,Michael Amadio,C,VGK,28,82,16,25,41
50,8479400,Pierre-Luc Dubois,L,LAK,26,82,12,29,41
50,8478472,Mathieu Joseph,R,OTT,27,82,10,31,41
50,8475287,Erik Haula,L,NJD,33,82,9,32,41
50,8471724,Kris Letang,D,PIT,37,82,6,35,41
50,8476399,Blake Coleman,C,CGY,33,82,24,16,40
50,8480188,Fabian Zetterlund,L,SJS,25,82,21,19,40
50,8482133,Thomas Bordeleau,C,SJS,22,82,19,21,40
50,8480068,Ryan Poehling,C,PHI,25,82,19,21,40
50,8480797,Joel Farabee,L,PHI,24,82,14,26,40
50,8480009,Eeli Tolvanen,R,SEA,25,82,12,28,40
50,8476906,Shayne Gostisbehere,D,DET,31,82,11,29,40
50,8477444,Andre Burakovsky,L,SEA,29,82,9,31,40
50,8474565,Alex Pietrangelo,D,VGK,34,82,7,33,40
50,8481542,Moritz Seider,D,DET,23,82,5,35,40
50,8479423,Alex Nylander,L,CBJ,26,82,27,12,39
50,8475799,Nino Niederreiter,R,WPG,32,82,25,14,39
50,8482101,Danil Gushchin,L,SJS,22,82,22,17,39
50,8475768,Jaden Schwartz,C,SEA,32,82,19,20,39
50,8477955,Jared McCann,L,SEA,28,82,17,22,39
50,8477503,Max Domi,C,TOR,29,82,16,23,39
50,8475200,Dmitry Orlov,D,CAR,33,82,13,26,39
50,8476882,Teuvo Teravainen,L,CAR,30,82,10,29,39
50,8475906,John Klingberg,D,TOR,32,82,4,35,39
50,8477426,Nicholas Paul,L,TBL,29,82,23,15,38
50,8474157,Max Pacioretty,L,WSH,36,82,22,16,38
50,8474641,Adam Henrique,C,EDM,34,82,19,19,38
50,8477425,Miles Wood,L,COL,29,82,17,21,38
50,8482175,JJ Peterka,R,BUF,22,82,16,22,38
50,8477456,J.T. Compher,L,DET,29,82,11,27,38
50,8477346,MacKenzie Weegar,D,CGY,30,82,11,27,38
50,8482105,Jake Sanderson,D,OTT,22,82,5,33,38
50,8475760,Nick Bjugstad,C,ARI,32,82,19,18,37
50,8474586,Jordan Eberle,R,SEA,34,82,15,22,37
50,8475151,Kyle Palmieri,C,NYI,33,82,12,25,37
50,8480434,Sean Durzi,D,ARI,26,82,11,26,37
50,8477953,Kasperi Kapanen,R,STL,28,82,11,26,37
50,8475197,Tyson Barrie,D,NSH,33,82,10,27,37
50,8482667,William Eklund,L,SJS,22,82,7,30,37
50,8478498,Jake DeBrusk,L,BOS,28,82,19,17,36
50,8476873,Mark Jankowski,C,NSH,30,82,19,17,36
50,8474053,Logan Couture,C,SJS,35,82,19,17,36
50,8476483,Rickard Rakell,R,PIT,31,82,18,18,36
50,8476480,Vladislav Namestnikov,C,WPG,32,82,12,24,36
50,8476885,Jacob Trouba,D,NYR,30,82,8,28,36
50,8473986,Alex Killorn,L,ANA,35,82,22,13,35
50,8478233,Andrew Mangiapane,L,CGY,28,82,20,15,35
50,8482079,Marco Rossi,C,MIN,23,82,19,16,35
50,8474149,Evgenii Dadonov,R,DAL,35,82,19,16,35
50,8477511,Anthony Mantha,R,VGK,30,82,17,18,35
50,8476880,Tom Wilson,R,WSH,30,82,14,21,35
50,8476826,Yanni Gourde,C,SEA,33,82,13,22,35
50,8481186,Logan O'Connor,R,COL,28,82,11,24,35
50,8481581,Thomas Harley,D,DAL,23,82,9,26,35
50,8476458,Ryan Strome,C,ANA,31,82,7,28,35
50,8481560,Arthur Kaliyev,R,LAK,23,82,17,17,34
50,8480028,Morgan Frost,C,PHI,25,82,17,17,34
50,8478046,Danton Heinen,L,BOS,29,82,15,19,34
50,8482092,Ridly Greig,C,OTT,22,82,12,22,34
50,8476875,Mike Matheson,D,MTL,30,82,9,25,34
50,8478891,Mason Appleton,C,WPG,28,82,8,26,34
50,8475171,Oliver Ekman-Larsson,D,FLA,33,82,7,27,34
50,8483457,Lane Hutson,D,MTL,20,82,3,31,34
50,8479345,Jakob Chychrun,D,OTT,26,82,18,15,33
50,8481624,Ilya Mikheyev,R,VAN,30,82,17,16,33
50,8482146,Luke Evangelista,R,NSH,22,82,16,17,33
50,8478413,Jordan Greenway,L,BUF,27,82,14,19,33
50,8475149,Marcus Johansson,L,MIN,34,82,13,20,33
50,8479977,Kailer Yamamoto,R,SEA,26,82,13,20,33
50,8476872,Scott Laughton,C,PHI,30,82,12,21,33
50,8480185,Eetu Luostarinen,C,FLA,26,82,12,21,33
50,8470610,Zach Parise,L,COL,40,82,11,22,33
50,8476292,Ondrej Palat,L,NJD,33,82,10,23,33
50,8475791,Taylor Hall,L,CHI,33,82,7,26,33
50,8480802,Ryan McLeod,C,EDM,25,82,7,26,33
50,8476892,Colton Parayko,D,STL,31,82,6,27,33
50,8480145,Neal Pionk,D,WPG,29,82,6,27,33
50,8479591,Michael Eyssimont,C,TBL,28,82,17,15,32
50,8480849,Barrett Hayton,C,ARI,24,82,14,18,32
50,8480459,Pius Suter,C,VAN,28,82,14,18,32
50,8481535,Nils Hoglander,L,VAN,24,82,12,20,32
50,8477488,Brett Pesce,D,CAR,30,82,11,21,32
50,8476897,Oskar Sundqvist,C,STL,30,82,10,22,32
50,8482245,Artem Zub,D,OTT,29,82,9,23,32
50,8481546,Cam York,D,PHI,23,82,7,25,32
50,8475753,Justin Faulk,D,STL,32,82,5,27,32
50,8476854,Hampus Lindholm,D,BOS,30,82,4,28,32
50,8483397,Marc McLaughlin,C,BOS,25,82,25,6,31
50,8476469,Joel Armia,R,MTL,31,82,19,12,31
50,8478057,Dakota Joshua,C,VAN,28,82,18,13,31
50,8480074,Alexandre Texier,C,CBJ,25,82,17,14,31
50,8475714,Calle Jarnkrok,C,TOR,33,82,14,17,31
50,8479661,Tanner Jeannot,L,TBL,27,82,14,17,31
50,8482702,Logan Stankoven,C,DAL,21,82,14,17,31
50,8473422,Nick Foligno,L,CHI,37,82,13,18,31
50,8482222,Alexander Barabanov,L,SJS,30,82,12,19,31
50,8481618,Alex Newhook,C,MTL,23,82,11,20,31
50,8476927,Teddy Blueger,C,VAN,30,82,10,21,31
50,8478133,Jake Evans,C,MTL,28,82,8,23,31
50,8479398,Samuel Girard,D,COL,26,82,4,27,31
50,8483471,Brad Lambert,C,WPG,31,82,2,29,31
50,8478043,Sam Lafferty,C,VAN,29,82,18,12,30
50,8476871,Tanner Pearson,L,MTL,32,82,15,15,30
50,8471218,Blake Wheeler,R,NYR,38,82,14,16,30
50,8474189,Lars Eller,C,PIT,35,82,14,16,30
50,8478109,Victor Olofsson,L,BUF,29,82,14,16,30
50,8480113,Alex Iafallo,L,WPG,31,82,13,17,30
50,8479992,Michael Rasmussen,C,DET,25,82,12,18,30
50,8479415,Michael McLeod,C,NJD,26,82,12,18,30
50,8482055,Drew O'Connor,L,PIT,26,82,11,19,30
50,8475763,Kevin Hayes,R,STL,32,82,9,21,30
50,8477429,Andrew Copp,C,DET,30,82,9,21,30
50,8482655,J.J. Moser,D,ARI,24,82,7,23,30
50,8481656,Aliaksei Protas,C,WSH,23,82,6,24,30
50,8482142,Jamie Drysdale,D,PHI,22,82,5,25,30
50,8480873,Rasmus Sandin,D,WSH,24,82,4,26,30
50,8476331,Dylan DeMelo,D,WPG,31,82,4,26,30
50,8477944,Jakub Vrana,L,STL,28,82,21,8,29
50,8476960,Andreas Athanasiou,C,CHI,30,82,17,12,29
50,8473533,Jordan Staal,C,CAR,36,82,16,13,29
50,8475848,Brendan Gallagher,R,MTL,32,82,11,18,29
50,8476921,Jordan Martinook,L,CAR,32,82,10,19,29
50,8482720,Matthew Knies,L,TOR,22,82,9,20,29
50,8481704,Juuso Parssinen,C,NSH,23,82,9,20,29
50,8476463,Jonas Brodin,D,MIN,31,82,8,21,29
50,8482671,Owen Power,D,BUF,22,82,7,22,29
50,8482705,Cole Sillinger,C,CBJ,21,82,7,22,29
50,8475218,Mattias Ekholm,D,EDM,34,82,6,23,29
50,8480043,Timothy Liljegren,D,TOR,25,82,6,23,29
50,8475188,Brayden McNabb,D,VGK,33,82,5,24,29
50,8474151,Ryan McDonagh,D,NSH,35,82,3,26,29
50,8480246,Nick Perbix,D,TBL,26,82,3,26,29
50,8478416,Erik Cernak,D,TBL,27,82,3,26,29
50,8481604,Pavel Dorofeyev,L,VGK,24,82,16,12,28
50,8480893,Kirill Marchenko,R,CBJ,24,82,14,14,28
50,8484166,Adam Fantilli,C,CBJ,20,82,14,14,28
50,8476925,Colton Sissons,C,NSH,31,82,14,14,28
50,8482089,Jake Neighbours,L,STL,22,82,13,15,28
50,8480144,David Kampf,C,TOR,29,82,10,18,28
50,8475220,Marcus Foligno,L,MIN,33,82,9,19,28
50,8476525,Colin Miller,D,WPG,32,82,8,20,28
50,8473507,Jeff Petry,D,DET,37,82,7,21,28
50,8474574,Tyler Myers,D,VAN,34,82,6,22,28
50,8476979,Erik Gustafsson,D,NYR,32,82,5,23,28
50,8475181,Nick Leddy,D,STL,33,82,4,24,28
50,8478840,Will Borgen,D,SEA,28,82,2,26,28
50,8482259,Bobby McMann,C,TOR,28,82,13,14,27
50,8483491,Ivan Miroshnichenko,L,WSH,20,82,13,14,27
50,8480813,Joe Veleno,C,DET,24,82,13,14,27
50,8474870,Tyler Johnson,C,CHI,34,82,12,15,27
50,8479346,Dillon Dube,C,CGY,26,82,12,15,27
50,8476392,Adam Lowry,C,WPG,31,82,11,16,27
50,8479365,Trent Frederic,C,BOS,26,82,10,17,27
50,8481013,Jonatan Berggren,R,DET,24,82,9,18,27
50,8480855,Jack McBain,C,ARI,24,82,9,18,27
50,8483495,Simon Nemec,D,NJD,20,82,9,18,27
50,8482111,Justin Barron,D,MTL,23,82,8,19,27
50,8481537,Nikita Okhotiuk,D,CGY,24,82,7,20,27
50,8477498,Darnell Nurse,D,EDM,29,82,6,21,27
50,8475764,Cam Fowler,D,ANA,33,82,3,24,27
50,8477435,Ryan Graves,D,PIT,29,82,3,24,27
50,8483499,Liam Ohgren,L,MIN,20,82,14,12,26
50,8482074,Connor Zary,C,CGY,23,82,13,13,26
50,8479383,Boris Katchouk,L,OTT,26,82,13,13,26
50,8477989,Christian Dvorak,C,MTL,28,82,12,14,26
50,8479996,Cody Glass,C,NSH,25,82,11,15,26
50,8480821,Filip Zadina,R,SJS,25,82,11,15,26
50,8473449,Kyle Okposo,R,FLA,36,82,10,16,26
50,8482475,Yegor Chinakhov,R,CBJ,23,82,10,16,26
50,8476419,Jean-Gabriel Pageau,C,NYI,32,82,9,17,26
50,8479941,Justin Danforth,R,CBJ,31,82,9,17,26
50,8477839,Conor Sheary,L,TBL,32,82,8,18,26
50,8474716,Jared Spurgeon,D,MIN,35,82,6,20,26
50,8476917,Adam Pelech,D,NYI,30,82,6,20,26
50,8470604,Jeff Carter,C,PIT,39,82,16,9,25
50,8479316,Luke Kunin,C,SJS,27,82,14,11,25
50,8477947,Sonny Milano,L,WSH,28,82,13,12,25
50,8470621,Corey Perry,R,EDM,39,82,12,13,25
50,8481553,Bobby Brink,R,PHI,23,82,12,13,25
50,8482117,Lukas Reichel,L,CHI,22,82,10,15,25
50,8476461,Sean Couturier,C,PHI,32,82,9,16,25
50,8480817,K'Andre Miller,D,NYR,24,82,7,18,25
50,8477948,Travis Sanheim,D,PHI,28,82,6,19,25
50,8481016,Ruslan Iskhakov,C,NYI,24,82,3,22,25
50,8480281,Alexey Toropchenko,R,STL,25,82,20,4,24
50,8484203,Bradly Nadeau,L,CAR,19,82,16,8,24
50,8479293,Brandon Tanev,L,SEA,33,82,11,13,24
50,8481601,Simon Holmstrom,R,NYI,23,82,11,13,24
50,8476869,Brady Skjei,D,CAR,30,82,10,14,24
50,8477508,Curtis Lazar,C,NJD,29,82,10,14,24
50,8479353,Brett Howden,C,VGK,26,82,9,15,24
50,8480336,Sean Walker,D,COL,30,82,6,18,24
50,8479351,Sam Steel,C,DAL,26,82,6,18,24
50,8482145,Mavrik Bourque,C,DAL,22,82,19,4,23
50,8483493,Frank Nazar,C,CHI,20,82,18,5,23
50,8476981,Josh Anderson,R,MTL,30,82,13,10,23
50,8475164,Jakob Silfverberg,R,ANA,34,82,10,13,23
50,8474715,Cam Atkinson,R,PHI,35,82,9,14,23
50,8481554,Kaapo Kakko,R,NYR,23,82,9,14,23
50,8477392,Hudson Fasching,R,NYI,29,82,9,14,23
50,8483490,Pavel Mintyukov,D,ANA,21,82,9,14,23
50,8477450,Jason Dickinson,C,CHI,29,82,8,15,23
50,8480834,Ty Emberson,D,SJS,24,82,7,16,23
50,8474673,TJ Brodie,D,TOR,34,82,7,16,23
50,8478851,Alexandre Carrier,D,NSH,28,82,6,17,23
50,8479980,Nicolas Hague,D,VGK,26,82,5,18,23
50,8480860,Kevin Bahl,D,NJD,24,82,5,18,23
50,8478500,Ivan Provorov,D,CBJ,27,82,4,19,23
50,8482470,Ilya Solovyov,D,CGY,24,82,3,20,23
50,8482125,Alexander Holtz,R,NJD,22,82,12,10,22
50,8476858,Phillip Di Giuseppe,L,VAN,31,82,11,11,22
50,8481028,Martin Pospisil,C,CGY,25,82,10,12,22
50,8484153,Leo Carlsson,C,ANA,20,82,9,13,22
50,8481481,Blake Lizotte,C,LAK,27,82,8,14,22
50,8478463,Anthony Beauvillier,L,NSH,27,82,8,14,22
50,8482737,Zack Bolduc,C,STL,21,82,8,14,22
50,8480806,Isac Lundestrom,C,ANA,25,82,8,14,22
50,8477507,Nikita Zadorov,D,VAN,29,82,8,14,22
50,8482624,Daniil Miromanov,D,CGY,27,82,7,15,22
50,8482712,Oskar Olausson,R,COL,22,82,7,15,22
50,8482062,Cole Smith,L,NSH,29,82,6,16,22
50,8477369,Carson Soucy,D,VAN,30,82,6,16,22
50,8482073,Braden Schneider,D,NYR,23,82,6,16,22
50,8482087,Kaiden Guhle,D,MTL,22,82,5,17,22
50,8476902,Esa Lindell,D,DAL,30,82,4,18,22
50,8481014,Alexander Romanov,D,NYI,24,82,4,18,22
50,8483565,Nick Blankenburg,D,CBJ,26,82,4,18,22
50,8480073,Erik Brannstrom,D,OTT,25,82,3,19,22
50,8481178,Egor Zamula,D,PHI,24,82,2,20,22
50,8482118,Sam Colangelo,R,ANA,23,82,15,6,21
50,8479514,Rem Pitlick,C,CHI,27,82,13,8,21
50,8475343,Nic Dowd,C,WSH,34,82,11,10,21
50,8478508,Yakov Trenin,C,COL,27,82,11,10,21
50,8481522,Peyton Krebs,C,BUF,23,82,10,11,21
50,8477330,Dominik Kubalik,L,OTT,29,82,10,11,21
50,8479976,Juuso Valimaki,D,ARI,26,82,9,12,21
50,8482155,Alex Laferriere,R,LAK,23,82,9,12,21
50,8479390,Taylor Raddysh,R,CHI,26,82,9,12,21
50,8475279,Ben Chiarot,D,DET,33,82,9,12,21
50,8482666,Scott Morrow,D,CAR,22,82,9,12,21
50,8473504,Cal Clutterbuck,R,NYI,37,82,8,13,21
50,8482122,Brock Faber,D,MIN,22,82,7,14,21
50,8478451,Ethan Bear,D,WSH,27,82,7,14,21
50,8475208,Brian Dumoulin,D,SEA,33,82,7,14,21
50,8478136,Jake Middleton,D,MIN,28,82,5,16,21
50,8478911,Matt Roy,D,LAK,29,82,4,17,21
50,8476931,Jake McCabe,D,TOR,31,82,4,17,21
50,8470600,Ryan Suter,D,DAL,39,82,4,17,21
50,8482733,Logan Mailloux,D,MTL,31,82,3,18,21
50,8481524,Bowen Byram,D,BUF,23,82,3,18,21
50,8477969,Marcus Pettersson,D,PIT,28,82,2,19,21
50,8478831,Kevin Stenlund,C,FLA,28,82,12,8,20
50,8478569,Noel Acciari,C,PIT,33,82,11,9,20
50,8476878,Zemgus Girgensons,L,BUF,30,82,11,9,20
50,8479393,Noah Gregor,C,TOR,26,82,11,9,20
50,8476422,Mike Reilly,D,NYI,31,82,8,12,20
50,8477406,Mattias Janmark,C,EDM,32,82,8,12,20
50,8475231,Casey Cizikas,C,NYI,33,82,7,13,20
50,8477015,Connor Brown,R,EDM,30,82,7,13,20
50,8475790,Erik Gudbranson,D,CBJ,32,82,2,18,20
50,8481093,Rafael Harvey-Pinard,L,MTL,25,82,16,3,19
50,8481580,Connor McMichael,C,WSH,23,82,12,7,19
50,8481517,Brett Leason,R,ANA,25,82,10,9,19
50,8474884,Mike Hoffman,C,SJS,35,82,8,11,19
50,8483505,Matthew Poitras,C,BOS,20,82,7,12,19
50,8482730,Brandt Clarke,D,LAK,21,82,7,12,19
50,8482809,Jackson Blake,R,CAR,21,82,7,12,19
50,8479371,Dante Fabbro,D,NSH,26,82,7,12,19
50,8476915,Jujhar Khaira,L,MIN,30,82,7,12,19
50,8476457,Adam Larsson,D,SEA,32,82,4,15,19
50,8477506,Ryan Pulock,D,NYI,30,82,4,15,19
50,8477365,Connor Clifton,D,BUF,29,82,4,15,19
50,8479983,Mario Ferraro,D,SJS,26,82,3,16,19
50,8480807,Mattias Samuelsson,D,BUF,24,82,3,16,19
50,8480058,Pierre-Olivier Joseph,D,PIT,25,82,3,16,19
50,8479324,Ryan Lindgren,D,NYR,26,82,2,17,19
50,8481059,Scott Perunovich,D,STL,26,82,2,17,19
50,8480879,Jacob Bernard-Docker,D,OTT,24,82,2,17,19
50,8473453,Trevor Lewis,C,LAK,37,82,11,7,18
50,8476822,Luke Glendening,C,TBL,35,82,10,8,18
50,8478468,Jeremy Lauzon,D,NSH,27,82,9,9,18
50,8479359,Beck Malenstyn,L,WSH,26,82,7,11,18
50,8482679,Matt Coronato,R,CGY,22,82,7,11,18
50,8480980,Connor Dewar,C,TOR,25,82,7,11,18
50,8478013,Jake Walman,D,DET,28,82,6,12,18
50,8476278,Colin Blackwell,C,CHI,31,82,6,12,18
50,8478507,John Marino,D,NJD,27,82,5,13,18
50,8478882,Vladislav Gavrikov,D,LAK,29,82,5,13,18
50,8476312,Josh Manson,D,COL,33,82,5,13,18
50,8478430,Oliver Kylington,D,CGY,27,82,4,14,18
50,8477220,Nate Schmidt,D,WPG,33,82,4,14,18
50,8480035,Henri Jokiharju,D,BUF,25,82,4,14,18
50,8482859,Zack Ostapchuk,C,OTT,21,82,3,15,18
50,8479369,Andrew Peeke,D,BOS,26,82,2,16,18
50,8470966,Mark Giordano,D,TOR,41,82,2,16,18
50,8477931,Tomas Nosek,L,NJD,32,82,2,16,18
50,8484145,Zach Benson,L,BUF,19,82,9,8,17
50,8474166,Alec Martinez,D,VGK,37,82,7,10,17
50,8476374,Sean Kuraly,C,CBJ,31,82,6,11,17
50,8477505,Alexander Wennberg,C,NYR,30,82,6,11,17
50,8477034,Jaycob Megna,D,CHI,32,82,6,11,17
50,8474034,Pat Maroon,L,BOS,36,82,5,12,17
50,8474009,Nick Bonino,C,NYR,36,82,5,12,17
50,8483482,Tristan Luneau,D,ANA,20,82,5,12,17
50,8482516,Matthew Kessel,D,STL,24,82,5,12,17
50,8477919,Frederick Gaudreau,C,MIN,31,82,4,13,17
50,8475455,Brenden Dillon,D,WPG,34,82,3,14,17
50,8477499,Rasmus Ristolainen,D,PHI,30,82,2,15,17
50,8481568,Alex Vlasic,D,CHI,23,82,2,15,17
50,8481567,Henry Thrun,D,SJS,23,82,1,16,17
50,8477845,Trevor van Riemsdyk,D,WSH,33,82,1,16,17
50,8480448,Parker Kelly,L,OTT,25,82,6,10,16
50,8474013,Ian Cole,D,VAN,35,82,6,10,16
50,8474567,Zach Bogosian,D,MIN,34,82,6,10,16
50,8482713,Mackie Samoskevich,R,FLA,22,82,6,10,16
50,8476467,Jamie Oleksiak,D,SEA,32,82,5,11,16
50,8478859,Niko Mikkola,D,FLA,28,82,5,11,16
50,8480796,Martin Fehervary,D,WSH,25,82,3,13,16
50,8481606,Jordan Spence,D,LAK,23,82,2,14,16
50,8475233,David Savard,D,MTL,34,82,2,14,16
50,8480990,Declan Chisholm,D,MIN,24,82,9,6,15
50,8477353,Tyler Motte,C,TBL,29,82,7,8,15
50,8476967,Brett Kulak,D,EDM,30,82,5,10,15
50,8482803,Olen Zellweger,D,ANA,21,82,4,11,15
50,8479442,Troy Stecher,D,EDM,30,82,3,12,15
50,8481477,Nico Sturm,C,SJS,29,82,2,13,15
50,8483466,Kevin Korchinski,D,CHI,20,82,2,13,15
50,8479998,Mikey Anderson,D,LAK,25,82,1,14,15
50,8476879,Cody Ceci,D,EDM,31,82,0,15,15
50,8483012,Logan Morrison,C,SEA,22,82,9,5,14
50,8478408,Travis Dermott,D,ARI,28,82,6,8,14
50,8476473,Connor Murphy,D,CHI,31,82,6,8,14
50,8475179,Dmitry Kulikov,D,FLA,34,82,4,10,14
50,8483468,Jiri Kulich,C,BUF,20,82,4,10,14
50,8475324,Nick Jensen,D,WSH,34,82,3,11,14
50,8475690,Chris Tanev,D,DAL,35,82,3,11,14
50,8480172,Jan Rutta,D,SJS,34,82,3,11,14
50,8476624,Barclay Goodrow,C,NYR,31,82,2,12,14
50,8478399,Jonas Siegenthaler,D,NJD,27,82,2,12,14
50,8482858,Ryker Evans,D,SEA,23,82,2,12,14
50,8471677,Jack Johnson,D,COL,37,82,2,12,14
50,8476429,Scott Mayfield,D,NYI,32,82,2,11,13
50,8475762,Derek Forbort,D,BOS,32,82,2,11,13
50,8478443,Brandon Carlo,D,BOS,28,82,6,6,12
50,8482166,Shakir Mukhamadullin,D,SJS,22,82,5,7,12
50,8482807,Ethan Del Mastro,D,CHI,21,82,4,8,12
50,8478178,Darren Raddysh,D,TBL,28,82,3,9,12
50,8477335,Kyle Burroughs,D,SJS,29,82,3,9,12
50,8476372,Nick Seeler,D,PHI,31,82,3,9,12
50,8475177,Calvin de Haan,D,TBL,33,82,3,9,12
50,8483763,Maksymilian Szuber,D,ARI,22,82,2,10,12
50,8481578,Graeme Clarke,R,NJD,23,82,3,8,11
50,8482177,Marat Khusnutdinov,C,MIN,22,82,3,7,10
50,8479291,Kevin Rooney,C,CGY,31,82,2,8,10
50,8476891,Matt Grzelcyk,D,BOS,30,82,0,10,10
50,8475842,Sam Carrick,C,EDM,32,82,4,5,9
50,8481599,Victor Soderstrom,D,ARI,23,82,3,6,9
50,8482762,Simon Edvinsson,D,DET,21,82,2,7,9
50,8476442,Matt Nieto,L,PIT,32,82,5,3,8
50,8484911,Collin Graf,R,SJS,22,82,2,6,8
50,8481605,Jackson LaCombe,D,ANA,23,82,1,7,8
50,8483489,Fraser Minten,C,TOR,31,82,3,4,7
50,8481030,Jack St. Ivany,D,PIT,25,82,2,5,7
50,8475462,Radko Gudas,D,ANA,34,82,1,6,7
50,8484149,Gavin Brindley,C,CBJ,20,82,0,7,7
50,8475825,Jani Hakanpää,D,DAL,32,82,2,3,5
50,8482141,Lukas Cormier,D,VGK,22,0,0,0,0
50,8476988,Matt Benning,D,SJS,30,0,0,0,0
50,8480727,Zach Whitecloud,D,VGK,28,0,0,0,0
50,8480887,Jordan Harris,D,MTL,24,0,0,0,0
50,8478450,Parker Wotherspoon,D,BOS,27,0,0,0,0
50,8481812,Nikolai Knyzhov,D,SJS,27,0,0,0,0
50,8480001,Urho Vaakanainen,D,ANA,25,0,0,0,0
50,8482176,Wyatt Kaiser,D,CHI,22,0,0,0,0
50,8481122,Simon Benoit,D,TOR,26,0,0,0,0
50,8476441,Joel Edmundson,D,TOR,31,0,0,0,0
50,8480884,Calen Addison,D,SJS,24,0,0,0,0
50,8482511,Mason Lohrei,D,BOS,23,0,0,0,0
50,8482192,Isaak Phillips,D,CHI,23,0,0,0,0
50,8480950,Ilya Lyubushkin,D,TOR,30,0,0,0,0
50,8474031,Kevin Shattenkirk,D,BOS,35,0,0,0,0
50,8475718,Justin Holl,D,DET,32,0,0,0,0
50,8479402,Jake Bean,D,CBJ,26,0,0,0,0
50,8474602,Justin Schultz,D,SEA,34,0,0,0,0
50,8477950,Tony DeAngelo,D,CAR,29,0,0,0,0
50,8481743,Marc Del Gaizo,D,NSH,25,0,0,0,0
50,8481527,Kaedan Korczak,D,VGK,23,0,0,0,0
50,8480192,Johnathan Kovacevic,D,MTL,27,0,0,0,0
50,8476874,Olli Maatta,D,DET,30,0,0,0,0
50,8482144,Jack Thompson,D,SJS,22,0,0,0,0
50,8480222,Sebastian Aho,D,NYI,28,0,0,0,0
50,8479458,Nikita Zaitsev,D,CHI,33,0,0,0,0
50,8471709,Marc-Edouard Vlasic,D,SJS,37,0,0,0,0
50,8482929,Emil Lilleberg,D,TBL,23,0,0,0,0
50,8477018,Ben Hutton,D,VGK,31,0,0,0,0
50,8481056,Spencer Stastney,D,NSH,24,0,0,0,0
50,8481593,Jayden Struble,D,MTL,23,0,0,0,0
50,8479982,Conor Timmins,D,TOR,26,0,0,0,0
50,8474090,Brendan Smith,D,NJD,35,0,0,0,0
50,8482964,Arber Xhekaj,D,MTL,23,0,0,0,0
50,8480891,Michael Kesselring,D,ARI,24,0,0,0,0
50,8477938,Haydn Fleury,D,TBL,28,0,0,0,0
50,8481806,Louis Crevier,D,CHI,23,0,0,0,0
50,8471274,Alex Goligoski,D,MIN,39,0,0,0,0
50,8481600,Tobias Bjornfot,D,FLA,23,0,0,0,0
50,8475797,Jarred Tinordi,D,CHI,32,0,0,0,0
50,8481521,Ronnie Attard,D,PHI,25,0,0,0,0
50,8474612,Travis Hamonic,D,OTT,34,0,0,0,0
50,8479576,Vincent Desharnais,D,EDM,28,0,0,0,0
50,8480049,Dylan Samberg,D,WPG,25,0,0,0,0
50,8483619,Filip Roos,D,CHI,25,0,0,0,0
50,8474568,Luke Schenn,D,NSH,35,0,0,0,0
50,8480184,Gustav Lindstrom,D,ANA,26,0,0,0,0
50,8480070,Ian Mitchell,D,BOS,25,0,0,0,0
50,8480196,Jacob Bryson,D,BUF,27,0,0,0,0
50,8471686,Marc Staal,D,PHI,37,0,0,0,0
50,8477467,Gustav Olofsson,D,SEA,30,0,0,0,0
50,8478970,Jalen Chatfield,D,CAR,28,0,0,0,0
50,8479348,Kale Clague,D,BUF,26,0,0,0,0
50,8473446,Erik Johnson,D,PHI,36,0,0,0,0
50,8477462,Robert Hagg,D,ANA,29,0,0,0,0
50,8478454,Noah Juulsen,D,VAN,27,0,0,0,0
50,8477384,Josh Brown,D,ARI,30,0,0,0,0
50,8481708,Zac Jones,D,NYR,24,0,0,0,0
50,8481167,Brayden Pachal,D,CGY,25,0,0,0,0
50,8482067,Connor Mackey,D,NYR,28,0,0,0,0
50,8483460,David Jiricek,D,CBJ,21,0,0,0,0
50,8481701,Santeri Hatakka,D,NJD,23,0,0,0,0
50,8478021,William Lagesson,D,ANA,28,0,0,0,0
50,8477851,Jordan Oesterle,D,CGY,32,0,0,0,0
50,8478452,Caleb Jones,D,COL,27,0,0,0,0
50,8479984,Cal Foote,D,NJD,26,0,0,0,0
50,8479639,Dylan Coghlan,D,CAR,26,0,0,0,0
50,8480874,Adam Ginning,D,PHI,24,0,0,0,0
50,8479321,Lucas Johansen,D,WSH,27,0,0,0,0
50,8480878,Nils Lundkvist,D,DAL,24,0,0,0,0
50,8482165,Yan Kuznetsov,D,CGY,22,0,0,0,0
50,8484258,Sam Malinski,D,COL,26,0,0,0,0
50,8480157,Calle Rosen,D,STL,30,0,0,0,0
50,8484304,Uvis Balinskis,D,FLA,28,0,0,0,0
50,8479985,Cale Fleury,D,SEA,26,0,0,0,0
50,8479378,Logan Stanley,D,WPG,26,0,0,0,0
50,8477541,Dakota Mermis,D,MIN,30,0,0,0,0
50,8481609,Vladislav Kolyachonok,D,ARI,23,0,0,0,0
50,8480823,Alexander Alexeyev,D,WSH,25,0,0,0,0
50,8481679,Maxence Guenette,D,OTT,23,0,0,0,0
50,8481564,Ryan Johnson,D,BUF,23,0,0,0,0
50,8479376,Victor Mete,D,PHI,26,0,0,0,0
50,8484254,Akito Hirose,D,VAN,25,0,0,0,0
50,8482660,Kent Johnson,C,CBJ,22,0,0,0,0
50,8482149,Cole Perfetti,C,WPG,22,0,0,0,0
50,8477987,Ryan Donato,C,CHI,28,0,0,0,0
50,8475755,Alexander Petrovic,D,DAL,32,0,0,0,0
50,8477810,Joel Hanley,D,CGY,33,0,0,0,0
50,8474145,Robert Bortuzzo,D,NYI,35,0,0,0,0
50,8481161,Jake Christiansen,D,CBJ,25,0,0,0,0
50,8476884,Derrick Pouliot,D,DAL,30,0,0,0,0
50,8481716,Dmitri Voronkov,L,CBJ,24,0,0,0,0
50,8480084,Nick DeSimone,D,NJD,30,0,0,0,0
50,8475750,Jon Merrill,D,MIN,32,0,0,0,0
50,8479315,Joey Anderson,R,CHI,26,0,0,0,0
50,8478011,Louie Belpedio,D,PHI,28,0,0,0,0
50,8482451,Mikael Pyyhtia,L,CBJ,23,0,0,0,0
50,8481541,Samuel Bolduc,D,NYI,24,0,0,0,0
50,8482126,Emil Andrae,D,PHI,31,0,0,0,0
50,8474618,Marco Scandella,D,STL,34,0,0,0,0
50,8477244,Chad Ruhwedel,D,NYR,34,0,0,0,0
50,8477971,Andreas Englund,D,LAK,28,0,0,0,0
50,8480829,Jesperi Kotkaniemi,C,CAR,24,0,0,0,0
50,8479372,Josh Mahura,D,FLA,26,0,0,0,0
50,8482095,Tyler Kleven,D,OTT,22,0,0,0,0
50,8481719,Maxwell Crozier,D,TBL,24,0,0,0,0
50,8475855,Jesper Fast,R,CAR,33,0,0,0,0
50,8480848,Ty Dellandrea,C,DAL,24,0,0,0,0
50,8475193,Tomas Tatar,L,SEA,34,0,0,0,0
50,8476889,Radek Faksa,C,DAL,30,0,0,0,0
50,8478495,Denis Gurianov,R,PHI,27,0,0,0,0
50,8480216,Jacob Peterson,C,SJS,25,0,0,0,0
50,8480252,Cole Guttman,C,CHI,25,0,0,0,0
50,8479026,Philippe Myers,D,TBL,27,0,0,0,0
50,8481006,Tyler Tucker,D,STL,24,0,0,0,0
50,8481032,Paul Cotter,C,VGK,25,0,0,0,0
50,8481577,Philip Tomasino,C,NSH,23,0,0,0,0
50,8476918,Jimmy Vesey,L,NYR,31,0,0,0,0
50,8479320,Max Lajoie,D,TOR,27,0,0,0,0
50,8478017,Mark Friedman,D,VAN,29,0,0,0,0
50,8481754,Nikita Nesterenko,C,ANA,23,0,0,0,0
50,8483407,Brandon Scanlin,D,NYR,25,0,0,0,0
50,8482659,Josh Doan,R,ARI,22,0,0,0,0
50,8477446,Michael McCarron,R,NSH,29,0,0,0,0
50,8477903,Garnet Hathaway,R,PHI,33,0,0,0,0
50,8482153,Brendan Brisson,C,VGK,23,0,0,0,0
50,8483546,Marshall Rifai,D,TOR,26,0,0,0,0
50,8484287,Cole McWard,D,VAN,23,0,0,0,0
50,8478854,Ryan Shea,D,PIT,27,0,0,0,0
50,8481585,Egor Afanasyev,L,NSH,23,0,0,0,0
50,8483398,Declan Carlile,D,TBL,31,0,0,0,0
50,8478502,Dennis Gilbert,D,CGY,28,0,0,0,0
50,8482749,Joshua Roy,R,MTL,21,0,0,0,0
50,8481598,Philip Broberg,D,EDM,23,0,0,0,0
50,8480835,Jack Drury,C,CAR,24,0,0,0,0
50,8480748,Kiefer Sherwood,L,NSH,29,0,0,0,0
50,8476934,Brock McGinn,L,ANA,30,0,0,0,0
50,8480870,Bo Groulx,C,ANA,24,0,0,0,0
50,8479368,Max Jones,L,ANA,26,0,0,0,0
50,8478099,Kevin Labanc,R,SJS,29,0,0,0,0
50,8478067,Oskar Lindblom,L,SJS,28,0,0,0,0
50,8476393,Nick Cousins,C,FLA,31,0,0,0,0
50,8483395,Arshdeep Bains,L,VAN,23,0,0,0,0
50,8480762,Eric Robinson,L,BUF,29,0,0,0,0
50,8479439,Jacob MacDonald,D,SJS,31,0,0,0,0
50,8476474,Stefan Noesen,R,CAR,31,0,0,0,0
50,8482787,Nikita Chibrikov,R,WPG,31,0,0,0,0
50,8478432,Christian Fischer,R,DET,27,0,0,0,0
50,8477979,Nicolas Aube-Kubel,R,WSH,28,0,0,0,0
50,8481789,Tye Kartye,L,SEA,23,0,0,0,0
50,8479330,Brandon Gignac,C,MTL,27,0,0,0,0
50,8480075,Cameron Crotty,D,ARI,25,0,0,0,0
50,8473473,Milan Lucic,L,BOS,36,0,0,0,0
50,8482094,Daemon Hunt,D,MIN,22,0,0,0,0
50,8481206,John Ludvig,D,PIT,24,0,0,0,0
50,8483630,Pavol Regenda,L,ANA,25,0,0,0,0
50,8481617,Vasily Podkolzin,R,VAN,23,0,0,0,0
50,8480306,Grant Hutton,D,NYI,29,0,0,0,0
50,8480995,Pontus Holmberg,R,TOR,25,0,0,0,0
50,8482148,Hendrix Lapierre,C,WSH,22,0,0,0,0
50,8477478,William Carrier,L,VGK,30,0,0,0,0
50,8480003,Jesper Boqvist,C,BOS,26,0,0,0,0
50,8482172,Landon Slaggert,L,CHI,22,0,0,0,0
50,8480789,Oliver Wahlstrom,R,NYI,24,0,0,0,0
50,8474062,Riley Nash,C,NYR,35,0,0,0,0
50,8480021,Jack Studnicka,C,SJS,25,0,0,0,0
50,8480025,MacKenzie Entwistle,R,CHI,25,0,0,0,0
50,8481582,Nicholas Robertson,L,TOR,23,0,0,0,0
50,8476867,Brendan Gaunce,C,CBJ,30,0,0,0,0
50,8479619,Michael Carcone,L,ARI,28,0,0,0,0
50,8479370,Tyson Jost,C,BUF,26,0,0,0,0
50,8479671,Mathieu Olivier,R,CBJ,27,0,0,0,0
50,8476994,Vinnie Hinostroza,C,PIT,30,0,0,0,0
50,8482070,Mitchell Chaffee,R,TBL,26,0,0,0,0
50,8477473,Justin Bailey,R,SJS,29,0,0,0,0
50,8479344,Jesse Puljujarvi,R,PIT,26,0,0,0,0
50,8480205,Emil Bemstrom,C,PIT,25,0,0,0,0
50,8479718,Alex Barré-Boulet,C,TBL,27,0,0,0,0
50,8482061,Brandon Biro,L,BUF,26,0,0,0,0
50,8479638,Justin Brazeau,R,BOS,26,0,0,0,0
50,8474040,Sam Gagner,C,EDM,35,0,0,0,0
50,8477846,Ryan Carpenter,C,SJS,33,0,0,0,0
50,8482077,Dylan Holloway,L,EDM,23,0,0,0,0
50,8482157,Will Cuylle,L,NYR,22,0,0,0,0
50,8480007,Jonas Rondbjerg,R,VGK,25,0,0,0,0
50,8478874,Adam Gaudette,C,STL,28,0,0,0,0
50,8478434,Keegan Kolesar,R,VGK,27,0,0,0,0
50,8480441,Trey Fix-Wolansky,R,CBJ,25,0,0,0,0
50,8479994,Jaret Anderson-Dolan,C,NSH,25,0,0,0,0
50,8483567,Georgii Merkulov,C,BOS,24,0,0,0,0
50,8477380,Jonny Brodzinski,C,NYR,31,0,0,0,0
50,8482201,Gage Goncalves,C,TBL,23,0,0,0,0
50,8478211,Dryden Hunt,L,CGY,29,0,0,0,0
50,8471699,Andrew Cogliano,C,COL,37,0,0,0,0
50,8479421,Jacob Moverare,D,LAK,26,0,0,0,0
50,8478881,Brett Seney,L,CHI,28,0,0,0,0
50,8477464,Nic Petan,C,MIN,29,0,0,0,0
50,8475958,Michael Sgarbossa,C,WSH,32,0,0,0,0
50,8481147,Reese Johnson,C,CHI,26,0,0,0,0
50,8479336,Carl Grundstrom,R,LAK,27,0,0,0,0
50,8480853,Liam Foudy,C,NSH,24,0,0,0,0
50,8479522,Hardy Haman Aktell,D,WSH,26,0,0,0,0
50,8481462,Mason Morelli,L,VGK,28,0,0,0,0
50,8482102,Vasily Ponomarev,C,CAR,22,0,0,0,0
50,8480844,Grigori Denisenko,L,VGK,24,0,0,0,0
50,8479944,Zach Aston-Reese,C,DET,30,0,0,0,0
50,8482784,Zach Dean,C,STL,21,0,0,0,0
50,8479419,Brett Murray,L,BUF,26,0,0,0,0
50,8479520,Brandon Duhaime,R,COL,27,0,0,0,0
50,8477573,Nathan Walker,L,STL,30,0,0,0,0
50,8478078,Rourke Chartier,C,OTT,28,0,0,0,0
50,8475795,Dylan McIlrath,D,WSH,32,0,0,0,0
50,8482496,Nils Aman,C,VAN,24,0,0,0,0
50,8480289,Morgan Barron,C,WPG,26,0,0,0,0
50,8481751,Lukas Rousek,R,BUF,25,0,0,0,0
50,8480011,Klim Kostin,C,SJS,25,0,0,0,0
50,8481556,John Beecher,C,BOS,23,0,0,0,0
50,8475278,Byron Froese,C,VGK,33,0,0,0,0
50,8475225,Craig Smith,C,DAL,35,0,0,0,0
50,8484326,Patrik Koch,D,ARI,28,0,0,0,0
50,8477930,Pierre-Edouard Bellemare,L,SEA,39,0,0,0,0
50,8478409,Anthony Richard,C,BOS,28,0,0,0,0
50,8481024,Linus Karlsson,C,VAN,25,0,0,0,0
50,8479986,Kole Lind,R,SEA,26,0,0,0,0
50,8479414,Nathan Bastian,R,NJD,27,0,0,0,0
50,8479362,Riley Tufte,L,COL,26,0,0,0,0
50,8481058,Jesse Ylönen,R,MTL,25,0,0,0,0
50,8482476,Emil Heineman,L,MTL,23,0,0,0,0
50,8482861,Vincent Iorio,D,WSH,22,0,0,0,0
50,8483432,Luca Del Bel Belluz,C,CBJ,31,0,0,0,0
50,8482744,James Malatesta,L,CBJ,21,0,0,0,0
50,8477887,Patrick Brown,C,BOS,32,0,0,0,0
50,8478585,Derek Ryan,C,EDM,38,0,0,0,0
50,8481441,Joe Snively,C,WSH,28,0,0,0,0
50,8481592,Jakob Pelletier,L,CGY,23,0,0,0,0
50,8482634,Alex Steeves,C,TOR,25,0,0,0,0
50,8477126,Jayson Megna,C,BOS,34,0,0,0,0
50,8475752,Tyler Pitlick,C,NYR,33,0,0,0,0
50,8480008,Adam Ruzicka,C,ARI,25,0,0,0,0
50,8481065,Angus Crookshank,L,OTT,25,0,0,0,0
50,8479547,Matthew Phillips,R,WSH,26,0,0,0,0
50,8480226,Marián Studenic,R,SEA,26,0,0,0,0
50,8481237,Kyle MacLean,C,NYI,25,0,0,0,0
50,8475413,Justin Dowling,C,NJD,34,0,0,0,0
50,8481641,Joel Kiviranta,L,COL,28,0,0,0,0
50,8478104,Sammy Blais,L,STL,28,0,0,0,0
50,8477454,Adam Erne,L,EDM,29,0,0,0,0
50,8481518,Nolan Foote,L,NJD,24,0,0,0,0
50,8480245,Olle Lycksell,R,PHI,25,0,0,0,0
50,8483570,Ben Meyers,C,ANA,26,0,0,0,0
50,8480776,Sheldon Rempal,R,VGK,29,0,0,0,0
50,8483920,Pierrick Dube,R,WSH,23,0,0,0,0
50,8480267,Sammy Walker,C,MIN,25,0,0,0,0
50,8482747,Brennan Othmann,L,NYR,21,0,0,0,0
50,8479991,Jake Leschyshyn,C,NYR,25,0,0,0,0
50,8478400,Colin White,C,MTL,27,0,0,0,0
50,8479328,Julien Gauthier,R,NYI,27,0,0,0,0
50,8484325,Waltteri Merela,C,TBL,26,0,0,0,0
50,8479066,Ryan Lomberg,L,FLA,30,0,0,0,0
50,8477070,Liam O'Brien,C,ARI,30,0,0,0,0
50,8478146,Matthew Highmore,C,OTT,28,0,0,0,0
50,8478028,Fredrik Olofsson,L,COL,28,0,0,0,0
50,8480880,Jakub Lauko,C,BOS,24,0,0,0,0
50,8479968,Vinni Lettieri,C,MIN,29,0,0,0,0
50,8474709,Matt Martin,L,NYI,35,0,0,0,0
50,8480845,Rasmus Kupari,C,WPG,24,0,0,0,0
50,8481550,Adam Beckman,L,MIN,23,0,0,0,0
50,8481422,Jacob Lucchini,C,MIN,29,0,0,0,0
50,8477401,John Hayden,C,SEA,29,0,0,0,0
50,8478904,Steven Lorentz,C,FLA,28,0,0,0,0
50,8482088,Justin Sourdif,R,FLA,22,0,0,0,0
50,8482751,Ryan Winterton,C,SEA,21,0,0,0,0
50,8482241,Radim Zohorna,L,PIT,28,0,0,0,0
50,8481690,Tyler Angle,C,CBJ,24,0,0,0,0
50,8476952,Dominic Toninato,C,WPG,30,0,0,0,0
50,8476919,Chris Tierney,C,NJD,30,0,0,0,0
50,8480032,Shane Bowers,C,NJD,25,0,0,0,0
50,8484314,Jiri Smejkal,L,OTT,28,0,0,0,0
50,8481239,Samuel Fagemo,L,LAK,24,0,0,0,0
50,8481532,Alex Turcotte,C,LAK,23,0,0,0,0
50,8481019,David Gustafsson,C,WPG,24,0,0,0,0
50,8478477,Mitchell Stephens,C,MTL,27,0,0,0,0
50,8479546,Oskar Steen,C,BOS,26,0,0,0,0
50,8480292,Carson Meyer,R,CBJ,27,0,0,0,0
50,8478446,Glenn Gawdin,C,ANA,27,0,0,0,0
50,8483531,Brian Halonen,L,NJD,25,0,0,0,0
50,8477149,Scott Sabourin,R,SJS,32,0,0,0,0
50,8479972,Mason Shaw,C,MIN,26,0,0,0,0
50,8480890,Jan Jenik,R,ARI,24,0,0,0,0
50,8478051,Max Willman,C,NJD,29,0,0,0,0
50,8480851,Akil Thomas,C,LAK,24,0,0,0,0
50,8482765,Isak Rosen,R,BUF,21,0,0,0,0
50,8478421,A.J. Greer,L,CGY,28,0,0,0,0
50,8478512,Austin Czarnik,C,DET,32,0,0,0,0
50,8479536,Axel Jonsson-Fjallby,L,WPG,26,0,0,0,0
50,8477320,Anton Blidh,L,NYR,29,0,0,0,0
50,8481543,Nikita Alexandrov,C,STL,24,0,0,0,0
50,8475235,Nicolas Deslauriers,L,PHI,33,0,0,0,0
50,8481070,Hugh McGing,L,STL,26,0,0,0,0
50,8480836,Jonathan Gruden,C,PIT,24,0,0,0,0
50,8481591,Sam Poulin,R,PIT,23,0,0,0,0
50,8477962,Brendan Lemieux,L,CAR,28,0,0,0,0
50,8483401,Marc Johnstone,R,PIT,28,0,0,0,0
50,8482250,Callahan Burke,C,CAR,27,0,0,0,0
50,8481726,Adam Edstrom,C,NYR,24,0,0,0,0
50,8471817,Ryan Reaves,R,TOR,37,0,0,0,0
50,8479587,Rhett Gardner,C,PHI,28,0,0,0,0
50,8475766,Austin Watson,L,TBL,32,0,0,0,0
50,8479367,William Lockwood,R,FLA,26,0,0,0,0
50,8478424,Jansen Harkins,C,PIT,27,0,0,0,0
50,8476913,Devin Shore,C,SEA,30,0,0,0,0
50,8482652,Walker Duehr,R,CGY,27,0,0,0,0
50,8477527,Ross Johnston,L,ANA,30,0,0,0,0
50,8481077,John Leonard,L,ARI,26,0,0,0,0
50,8483549,Lucas Condotta,L,MTL,27,0,0,0,0
50,8480468,James Hamblin,L,EDM,25,0,0,0,0
50,8476907,Mackenzie MacEachern,L,STL,30,0,0,0,0
50,8479543,Michael Pezzetta,L,MTL,26,0,0,0,0
50,8480355,Mark Kastelic,C,OTT,25,0,0,0,0
50,8482162,Roby Jarventie,L,OTT,22,0,0,0,0
50,8479772,Zack MacEwen,R,OTT,28,0,0,0,0
50,8483597,Milos Kelemen,L,ARI,25,0,0,0,0
50,8479379,Givani Smith,R,SJS,26,0,0,0,0
50,8481655,Cole Schwindt,R,CGY,23,0,0,0,0
50,8479981,Jonah Gadjovich,L,FLA,26,0,0,0,0
50,8482147,Jean-Luc Foudy,C,COL,22,0,0,0,0
50,8484255,Jason Polin,R,COL,25,0,0,0,0
50,8477993,Justin Kirkland,C,ARI,28,0,0,0,0
50,8479249,Andrew Poturalski,C,SEA,30,0,0,0,0
50,8482197,Adam Raska,R,MIN,23,0,0,0,0
50,8475780,Chris Wagner,R,COL,33,0,0,0,0
50,8479533,Joona Koppanen,L,PIT,26,0,0,0,0
50,8481534,Raphael Lavoie,C,EDM,24,0,0,0,0
50,8484321,Nikolas Matinpalo,D,OTT,26,0,0,0,0
50,8481043,Cole Koepke,L,TBL,26,0,0,0,0
50,8476323,Max McCormick,L,SEA,32,0,0,0,0
50,8483609,Adam Klapka,R,CGY,24,0,0,0,0
50,8483512,Matt Savoie,C,BUF,20,0,0,0,0
50,8484259,Ondrej Pavel,C,COL,31,0,0,0,0
50,8478147,Bokondji Imama,L,OTT,28,0,0,0,0
50,8482460,Matt Rempe,C,NYR,22,0,0,0,0
50,8477073,Kurtis MacDermid,L,NJD,30,0,0,0,0
50,8480274,Philip Kemp,D,EDM,25,0,0,0,0
50,8478956,Samuel Laberge,L,NJD,27,0,0,0,0
50,8483045,Cameron Butler,R,CBJ,31,0,0,0,0
51,8478402,Connor McDavid,C,EDM,27,82,40,85,125
51,8477492,Nathan MacKinnon,C,COL,29,82,47,70,117
51,8479318,Auston Matthews,C,TOR,27,82,58,50,108
51,8476453,Nikita Kucherov,R,TBL,31,82,40,67,107
51,8477934,Leon Draisaitl,C,EDM,29,82,32,72,104
51,8481559,Jack Hughes,C,NJD,23,82,38,63,101
51,8478864,Kirill Kaprizov,L,MIN,27,82,40,60,100
51,8479314,Matthew Tkachuk,L,FLA,27,82,36,61,97
51,8478420,Mikko Rantanen,R,COL,28,82,42,53,95
51,8478010,Brayden Point,C,TBL,28,82,45,49,94
51,8478550,Artemi Panarin,L,NYR,33,82,45,48,93
51,8477956,David Pastrnak,R,BOS,28,82,37,55,92
51,8478427,Sebastian Aho,C,CAR,27,82,39,50,89
51,8477939,William Nylander,R,TOR,28,82,42,46,88
51,8480027,Jason Robertson,L,DAL,25,82,28,59,87
51,8477942,Kevin Fiala,L,LAK,28,82,36,49,85
51,8477493,Aleksander Barkov,C,FLA,29,82,25,59,84
51,8476468,J.T. Miller,C,VAN,31,82,28,55,83
51,8476887,Filip Forsberg,L,NSH,30,82,45,36,81
51,8477404,Jake Guentzel,C,CAR,30,82,34,47,81
51,8479420,Tage Thompson,C,BUF,27,82,41,39,80
51,8474564,Steven Stamkos,C,TBL,34,82,36,43,79
51,8478439,Travis Konecny,R,PHI,27,82,31,48,79
51,8480012,Elias Pettersson,C,VAN,26,82,39,39,78
51,8480801,Brady Tkachuk,L,OTT,25,82,40,37,77
51,8475172,Nazem Kadri,C,CGY,34,82,30,46,76
51,8482684,Luke Hughes,D,NJD,21,82,23,52,75
51,8477960,Adrian Kempe,R,LAK,28,82,32,42,74
51,8477940,Nikolaj Ehlers,L,WPG,28,82,30,44,74
51,8474600,Roman Josi,D,NSH,34,82,21,53,74
51,8477409,Carter Verhaeghe,C,FLA,29,82,35,38,73
51,8476389,Vincent Trocheck,C,NYR,31,82,28,45,73
51,8476459,Mika Zibanejad,C,NYR,31,82,26,47,73
51,8480839,Rasmus Dahlin,D,BUF,24,82,11,62,73
51,8479343,Clayton Keller,R,ARI,26,82,30,42,72
51,8478398,Kyle Connor,L,WPG,28,82,29,43,72
51,8477504,Josh Morrissey,D,WPG,29,82,14,58,72
51,8475184,Chris Kreider,L,NYR,33,82,50,21,71
51,8480069,Cale Makar,D,COL,26,82,16,55,71
51,8475166,John Tavares,C,TOR,34,82,36,34,70
51,8480002,Nico Hischier,C,NJD,25,82,30,40,70
51,8475810,Bryan Rust,R,PIT,32,82,30,40,70
51,8473512,Claude Giroux,R,OTT,36,82,19,51,70
51,8476454,Ryan Nugent-Hopkins,C,EDM,31,82,18,52,70
51,8476853,Morgan Rielly,D,TOR,30,82,11,59,70
51,8481523,Kirby Dach,C,MTL,23,82,17,52,69
51,8475786,Zach Hyman,L,EDM,32,82,35,33,68
51,8471675,Sidney Crosby,C,PIT,37,82,30,38,68
51,8475692,Mats Zuccarello,R,MIN,37,82,29,39,68
51,8479407,Jesper Bratt,L,NJD,26,82,22,46,68
51,8477933,Sam Reinhart,C,FLA,29,82,36,31,67
51,8476460,Mark Scheifele,C,WPG,31,82,26,41,67
51,8478440,Dylan Strome,C,WSH,27,82,21,46,67
51,8478445,Mathew Barzal,C,NYI,27,82,18,49,67
51,8475167,Victor Hedman,D,TBL,34,82,16,51,67
51,8478449,Roope Hintz,C,DAL,28,82,26,40,66
51,8482116,Tim Stützle,C,OTT,22,82,25,41,66
51,8477946,Dylan Larkin,C,DET,28,82,25,41,66
51,8471215,Evgeni Malkin,C,PIT,38,82,25,41,66
51,8473419,Brad Marchand,L,BOS,36,82,23,43,66
51,8480800,Quinn Hughes,D,VAN,25,82,12,54,66
51,8478403,Jack Eichel,C,VGK,28,82,25,40,65
51,8479323,Adam Fox,D,NYR,26,82,11,54,65
51,8480188,Fabian Zetterlund,L,SJS,25,82,31,33,64
51,8477501,Valeri Nichushkin,R,COL,29,82,28,36,64
51,8479337,Alex DeBrincat,R,DET,27,82,28,36,64
51,8479542,Brandon Hagel,L,TBL,26,82,32,31,63
51,8478414,Timo Meier,R,NJD,28,82,30,33,63
51,8470794,Joe Pavelski,C,DAL,40,82,18,45,63
51,8481528,Dylan Cozens,C,BUF,23,82,25,37,62
51,8478042,Viktor Arvidsson,R,LAK,31,82,20,42,62
51,8480865,Noah Dobson,D,NYI,24,82,9,53,62
51,8477500,Bo Horvat,C,NYI,29,82,25,36,61
51,8479339,Patrik Laine,L,CBJ,26,82,25,36,61
51,8477416,Oliver Bjorkstrand,R,SEA,29,82,23,38,61
51,8477951,Nick Schmaltz,C,ARI,28,82,18,43,61
51,8480803,Evan Bouchard,D,EDM,25,82,14,47,61
51,8478444,Brock Boeser,R,VAN,27,82,28,32,60
51,8479385,Jordan Kyrou,C,STL,26,82,28,32,60
51,8480830,Andrei Svechnikov,R,CAR,24,82,25,35,60
51,8476905,Chandler Stephenson,C,VGK,30,82,25,35,60
51,8477955,Jared McCann,L,SEA,28,82,24,36,60
51,8476462,Dougie Hamilton,D,NJD,31,82,21,39,60
51,8475913,Mark Stone,R,VGK,32,82,19,41,60
51,8477447,Shea Theodore,D,VGK,29,82,15,45,60
51,8480018,Nick Suzuki,C,MTL,25,82,27,32,59
51,8482745,Mason McTavish,C,ANA,21,82,25,34,59
51,8477451,Ryan Hartman,R,MIN,30,82,25,34,59
51,8475168,Matt Duchene,C,DAL,33,82,23,36,59
51,8478498,Jake DeBrusk,L,BOS,28,82,28,30,58
51,8475754,Brock Nelson,C,NYI,33,82,27,31,58
51,8471685,Anze Kopitar,C,LAK,37,82,20,38,58
51,8478873,Troy Terry,R,ANA,27,82,17,41,58
51,8481540,Cole Caufield,R,MTL,23,82,32,25,57
51,8477402,Pavel Buchnevich,L,STL,29,82,25,32,57
51,8474150,Mikael Backlund,C,CGY,35,82,23,34,57
51,8480208,Drake Batherson,R,OTT,26,82,19,38,57
51,8480023,Robert Thomas,C,STL,25,82,18,39,57
51,8475744,Evgeny Kuznetsov,C,CAR,32,82,17,40,57
51,8480036,Miro Heiskanen,D,DAL,25,82,16,41,57
51,8475726,Tyler Toffoli,C,WPG,32,82,30,26,56
51,8475784,Jeff Skinner,C,BUF,32,82,27,29,56
51,8476882,Teuvo Teravainen,L,CAR,30,82,21,35,56
51,8477949,Alex Tuch,R,BUF,28,82,20,36,56
51,8479325,Charlie McAvoy,D,BOS,27,82,14,42,56
51,8474590,John Carlson,D,WSH,34,82,13,43,56
51,8476346,Johnny Gaudreau,L,CBJ,31,82,16,39,55
51,8478460,Zach Werenski,D,CBJ,27,82,14,41,55
51,8474141,Patrick Kane,R,DET,36,82,27,27,54
51,8475169,Evander Kane,L,EDM,33,82,27,27,54
51,8475794,Tyler Seguin,C,DAL,32,82,25,29,54
51,8474157,Max Pacioretty,L,WSH,36,82,28,25,53
51,8478047,Michael Bunting,L,PIT,29,82,26,27,53
51,8481557,Matt Boldy,L,MIN,23,82,22,31,53
51,8474102,David Perron,L,DET,36,82,22,31,53
51,8482097,Jack Quinn,R,BUF,23,82,21,32,53
51,8478542,Evan Rodrigues,C,FLA,31,82,20,33,53
51,8476881,Tomas Hertl,C,VGK,31,82,19,34,53
51,8478438,Tommy Novak,C,NSH,27,82,16,37,53
51,8474586,Jordan Eberle,R,SEA,34,82,12,41,53
51,8479425,Filip Hronek,D,VAN,27,82,10,43,53
51,8477496,Elias Lindholm,C,VAN,30,82,24,28,52
51,8479675,Trevor Moore,L,LAK,29,82,22,30,52
51,8481533,Trevor Zegras,C,ANA,23,82,20,32,52
51,8482740,Wyatt Johnston,C,DAL,21,82,19,33,52
51,8476456,Jonathan Huberdeau,C,CGY,31,82,16,36,52
51,8482699,Dylan Guenther,R,ARI,21,82,28,23,51
51,8476539,Jonathan Marchessault,R,VGK,34,82,26,25,51
51,8478233,Andrew Mangiapane,L,CGY,28,82,25,26,51
51,8477497,Sean Monahan,C,WPG,30,82,24,27,51
51,8475170,Brayden Schenn,C,STL,33,82,24,27,51
51,8473994,Jamie Benn,L,DAL,35,82,23,28,51
51,8479999,Casey Mittelstadt,C,COL,26,82,17,34,51
51,8480031,Maxime Comtois,L,CAR,25,82,17,34,51
51,8478396,Noah Hanifin,D,VGK,27,82,14,37,51
51,8479410,Mikhail Sergachev,D,TBL,26,82,9,42,51
51,8474578,Erik Karlsson,D,PIT,34,82,5,46,51
51,8477426,Nicholas Paul,L,TBL,29,82,25,25,50
51,8475765,Vladimir Tarasenko,R,FLA,33,82,21,29,50
51,8484144,Connor Bedard,C,CHI,19,82,17,33,50
51,8478856,Conor Garland,R,VAN,28,82,13,37,50
51,8482124,Quinton Byfield,R,LAK,22,82,13,37,50
51,8482665,Matty Beniers,C,SEA,22,82,13,37,50
51,8477935,Sam Bennett,C,FLA,28,82,24,25,49
51,8474679,Gustav Nyquist,C,NSH,35,82,20,29,49
51,8475158,Ryan O'Reilly,C,NSH,33,82,20,29,49
51,8481542,Moritz Seider,D,DET,23,82,14,35,49
51,8476329,Travis Boyd,C,ARI,31,82,9,40,49
51,8477479,Tyler Bertuzzi,L,TOR,29,82,20,28,48
51,8482078,Lucas Raymond,L,DET,22,82,18,30,48
51,8480015,Owen Tippett,R,PHI,25,82,18,30,48
51,8478975,Mason Marchment,L,DAL,29,82,17,31,48
51,8471214,Alex Ovechkin,L,WSH,39,82,20,27,47
51,8477986,Brandon Montour,D,FLA,30,82,9,38,47
51,8483808,Andrei Kuzmenko,L,CGY,28,82,24,22,46
51,8477444,Andre Burakovsky,L,SEA,29,82,18,28,46
51,8480798,Philipp Kurashev,C,CHI,25,82,11,35,46
51,8475906,John Klingberg,D,TOR,32,82,7,39,46
51,8480014,Gabriel Vilardi,C,WPG,25,82,27,18,45
51,8477476,Artturi Lehkonen,L,COL,29,82,22,23,45
51,8478493,Joel Eriksson Ek,C,MIN,27,82,20,25,45
51,8481711,Matias Maccelli,L,ARI,24,82,20,25,45
51,8476448,William Karlsson,C,VGK,31,82,19,26,45
51,8482113,Anton Lundell,C,FLA,23,82,17,28,45
51,8476292,Ondrej Palat,L,NJD,33,82,17,28,45
51,8477932,Aaron Ekblad,D,FLA,28,82,13,32,45
51,8482093,Seth Jarvis,C,CAR,22,82,23,21,44
51,8482175,JJ Peterka,R,BUF,22,82,20,24,44
51,8476458,Ryan Strome,C,ANA,31,82,13,31,44
51,8478407,Vince Dunn,D,SEA,28,82,8,36,44
51,8483524,Shane Wright,C,SEA,20,82,33,10,43
51,8475799,Nino Niederreiter,R,WPG,32,82,28,15,43
51,8475314,Anders Lee,L,NYI,34,82,27,16,43
51,8482110,Dawson Mercer,C,NJD,23,82,24,19,43
51,8478366,Frank Vatrano,R,ANA,30,82,21,22,43
51,8480039,Martin Necas,C,CAR,25,82,19,24,43
51,8479400,Pierre-Luc Dubois,L,LAK,26,82,19,24,43
51,8482101,Danil Gushchin,L,SJS,22,82,18,25,43
51,8475287,Erik Haula,L,NJD,33,82,17,26,43
51,8480220,Noah Cates,L,PHI,25,82,16,27,43
51,8475798,Mikael Granlund,C,SJS,32,82,8,35,43
51,8478038,Devon Toews,D,COL,30,82,8,35,43
51,8476875,Mike Matheson,D,MTL,30,82,6,37,43
51,8479525,Ross Colton,C,COL,28,82,26,16,42
51,8480064,Josh Norris,C,OTT,25,82,26,16,42
51,8475151,Kyle Palmieri,C,NYI,33,82,25,17,42
51,8477407,Anthony Duclair,L,TBL,29,82,23,19,42
51,8471698,T.J. Oshie,R,WSH,38,82,20,22,42
51,8481068,Yegor Sharangovich,C,CGY,26,82,20,22,42
51,8476479,Phillip Danault,C,LAK,31,82,20,22,42
51,8478519,Anthony Cirelli,C,TBL,27,82,15,27,42
51,8477346,MacKenzie Weegar,D,CGY,30,82,9,33,42
51,8475753,Justin Faulk,D,STL,32,82,8,34,42
51,8480043,Timothy Liljegren,D,TOR,25,82,7,35,42
51,8471724,Kris Letang,D,PIT,37,82,4,38,42
51,8481618,Alex Newhook,C,MTL,23,82,27,14,41
51,8475191,Reilly Smith,R,PIT,33,82,24,17,41
51,8478472,Mathieu Joseph,R,OTT,27,82,20,21,41
51,8478462,Nicolas Roy,C,VGK,27,82,19,22,41
51,8475768,Jaden Schwartz,C,SEA,32,82,18,23,41
51,8476872,Scott Laughton,C,PHI,30,82,16,25,41
51,8475763,Kevin Hayes,R,STL,32,82,16,25,41
51,8482475,Yegor Chinakhov,R,CBJ,23,82,13,28,41
51,8474563,Drew Doughty,D,LAK,35,82,11,30,41
51,8470613,Brent Burns,D,CAR,39,82,6,35,41
51,8480893,Kirill Marchenko,R,CBJ,24,82,22,18,40
51,8479365,Trent Frederic,C,BOS,26,82,19,21,40
51,8482109,Alexis Lafrenière,L,NYR,23,82,18,22,40
51,8476399,Blake Coleman,C,CGY,33,82,18,22,40
51,8475714,Calle Jarnkrok,C,TOR,33,82,18,22,40
51,8480185,Eetu Luostarinen,C,FLA,26,82,17,23,40
51,8483445,Cutter Gauthier,L,ANA,20,82,13,27,40
51,8478055,Gustav Forsling,D,FLA,28,82,8,32,40
51,8474565,Alex Pietrangelo,D,VGK,34,82,8,32,40
51,8483471,Brad Lambert,C,WPG,31,82,6,34,40
51,8478474,Lawson Crouse,L,ARI,27,82,27,12,39
51,8476432,Boone Jenner,C,CBJ,31,82,22,17,39
51,8476483,Rickard Rakell,R,PIT,31,82,20,19,39
51,8476880,Tom Wilson,R,WSH,30,82,20,19,39
51,8471218,Blake Wheeler,R,NYR,38,82,18,21,39
51,8475745,Charlie Coyle,C,BOS,32,82,16,23,39
51,8481596,Shane Pinto,C,OTT,24,82,11,28,39
51,8477964,Ivan Barbashev,C,VGK,29,82,10,29,39
51,8481699,Aku Raty,R,ARI,23,82,1,38,39
51,8483397,Marc McLaughlin,C,BOS,25,82,35,3,38
51,8475722,Jason Zucker,L,NSH,32,82,22,16,38
51,8478891,Mason Appleton,C,WPG,28,82,18,20,38
51,8473986,Alex Killorn,L,ANA,35,82,17,21,38
51,8480028,Morgan Frost,C,PHI,25,82,17,21,38
51,8478466,Daniel Sprong,R,DET,27,82,16,22,38
51,8478458,Jack Roslovic,C,NYR,27,82,16,22,38
51,8476906,Shayne Gostisbehere,D,DET,31,82,15,23,38
51,8477494,Jonathan Drouin,L,COL,29,82,9,29,38
51,8482222,Alexander Barabanov,L,SJS,30,82,9,29,38
51,8478115,Pierre Engvall,L,NYI,28,82,18,19,37
51,8479423,Alex Nylander,L,CBJ,26,82,18,19,37
51,8477998,Warren Foegele,L,EDM,28,82,14,23,37
51,8477495,Seth Jones,D,CHI,30,82,11,26,37
51,8477429,Andrew Copp,C,DET,30,82,11,26,37
51,8480817,K'Andre Miller,D,NYR,24,82,5,32,37
51,8476981,Josh Anderson,R,MTL,30,82,21,15,36
51,8473449,Kyle Okposo,R,FLA,36,82,20,16,36
51,8474641,Adam Henrique,C,EDM,34,82,19,17,36
51,8482667,William Eklund,L,SJS,22,82,17,19,36
51,8482159,Tyson Foerster,R,PHI,22,82,16,20,36
51,8480009,Eeli Tolvanen,R,SEA,25,82,15,21,36
51,8473422,Nick Foligno,L,CHI,37,82,15,21,36
51,8482133,Thomas Bordeleau,C,SJS,22,82,14,22,36
51,8479987,Morgan Geekie,C,BOS,26,82,10,26,36
51,8480873,Rasmus Sandin,D,WSH,24,82,8,28,36
51,8478469,Thomas Chabot,D,OTT,27,82,7,29,36
51,8478057,Dakota Joshua,C,VAN,28,82,21,14,35
51,8475760,Nick Bjugstad,C,ARI,32,82,18,17,35
51,8478109,Victor Olofsson,L,BUF,29,82,17,18,35
51,8479345,Jakob Chychrun,D,OTT,26,82,12,23,35
51,8477503,Max Domi,C,TOR,29,82,9,26,35
51,8482105,Jake Sanderson,D,OTT,22,82,9,26,35
51,8481581,Thomas Harley,D,DAL,23,82,8,27,35
51,8478401,Pavel Zacha,C,BOS,27,82,7,28,35
51,8482671,Owen Power,D,BUF,22,82,6,29,35
51,8476854,Hampus Lindholm,D,BOS,30,82,3,32,35
51,8476469,Joel Armia,R,MTL,31,82,21,13,34
51,8477944,Jakub Vrana,L,STL,28,82,21,13,34
51,8481580,Connor McMichael,C,WSH,23,82,19,15,34
51,8480068,Ryan Poehling,C,PHI,25,82,18,16,34
51,8483431,Logan Cooley,C,ARI,20,82,17,17,34
51,8475848,Brendan Gallagher,R,MTL,32,82,17,17,34
51,8480459,Pius Suter,C,VAN,28,82,16,18,34
51,8482089,Jake Neighbours,L,STL,22,82,16,18,34
51,8477989,Christian Dvorak,C,MTL,28,82,15,19,34
51,8477021,Alex Kerfoot,C,ARI,30,82,13,21,34
51,8480113,Alex Iafallo,L,WPG,31,82,13,21,34
51,8476826,Yanni Gourde,C,SEA,33,82,12,22,34
51,8478133,Jake Evans,C,MTL,28,82,10,24,34
51,8476392,Adam Lowry,C,WPG,31,82,10,24,34
51,8482122,Brock Faber,D,MIN,22,82,9,25,34
51,8476923,Damon Severson,D,CBJ,30,82,5,29,34
51,8483457,Lane Hutson,D,MTL,20,82,4,30,34
51,8476960,Andreas Athanasiou,C,CHI,30,82,19,14,33
51,8480802,Ryan McLeod,C,EDM,25,82,15,18,33
51,8477947,Sonny Milano,L,WSH,28,82,15,18,33
51,8476419,Jean-Gabriel Pageau,C,NYI,32,82,14,19,33
51,8475791,Taylor Hall,L,CHI,33,82,12,21,33
51,8477498,Darnell Nurse,D,EDM,29,82,12,21,33
51,8479992,Michael Rasmussen,C,DET,25,82,11,22,33
51,8476463,Jonas Brodin,D,MIN,31,82,11,22,33
51,8481481,Blake Lizotte,C,LAK,27,82,10,23,33
51,8478911,Matt Roy,D,LAK,29,82,9,24,33
51,8480871,Adam Boqvist,D,CBJ,24,82,7,26,33
51,8478397,Rasmus Andersson,D,CGY,28,82,4,29,33
51,8478569,Noel Acciari,C,PIT,33,82,21,11,32
51,8475793,Ryan Johansen,C,PHI,32,82,16,16,32
51,8477456,J.T. Compher,L,DET,29,82,16,16,32
51,8475149,Marcus Johansson,L,MIN,34,82,13,19,32
51,8481656,Aliaksei Protas,C,WSH,23,82,13,19,32
51,8474037,James van Riemsdyk,L,BOS,35,82,12,20,32
51,8482092,Ridly Greig,C,OTT,22,82,12,20,32
51,8478463,Anthony Beauvillier,L,NSH,27,82,11,21,32
51,8480434,Sean Durzi,D,ARI,26,82,9,23,32
51,8474716,Jared Spurgeon,D,MIN,35,82,7,25,32
51,8481703,Valtteri Puustinen,R,PIT,25,82,4,28,32
51,8476892,Colton Parayko,D,STL,31,82,4,28,32
51,8481604,Pavel Dorofeyev,L,VGK,24,82,20,11,31
51,8483491,Ivan Miroshnichenko,L,WSH,20,82,16,15,31
51,8484145,Zach Benson,L,BUF,19,82,16,15,31
51,8481554,Kaapo Kakko,R,NYR,23,82,14,17,31
51,8477511,Anthony Mantha,R,VGK,30,82,12,19,31
51,8476461,Sean Couturier,C,PHI,32,82,12,19,31
51,8477919,Frederick Gaudreau,C,MIN,31,82,12,19,31
51,8481186,Logan O'Connor,R,COL,28,82,10,21,31
51,8481013,Jonatan Berggren,R,DET,24,82,10,21,31
51,8476792,Torey Krug,D,STL,33,82,9,22,31
51,8480078,Filip Chytil,C,NYR,25,82,9,22,31
51,8477839,Conor Sheary,L,TBL,32,82,9,22,31
51,8475764,Cam Fowler,D,ANA,33,82,6,25,31
51,8477948,Travis Sanheim,D,PHI,28,82,4,27,31
51,8481016,Ruslan Iskhakov,C,NYI,24,82,4,27,31
51,8477450,Jason Dickinson,C,CHI,29,82,19,11,30
51,8479941,Justin Danforth,R,CBJ,31,82,15,15,30
51,8480281,Alexey Toropchenko,R,STL,25,82,14,16,30
51,8474149,Evgenii Dadonov,R,DAL,35,82,13,17,30
51,8479415,Michael McLeod,C,NJD,26,82,12,18,30
51,8480806,Isac Lundestrom,C,ANA,25,82,12,18,30
51,8473533,Jordan Staal,C,CAR,36,82,11,19,30
51,8475171,Oliver Ekman-Larsson,D,FLA,33,82,8,22,30
51,8481546,Cam York,D,PHI,23,82,6,24,30
51,8476979,Erik Gustafsson,D,NYR,32,82,4,26,30
51,8476958,Jaccob Slavin,D,CAR,30,82,3,27,30
51,8480797,Joel Farabee,L,PHI,24,82,16,13,29
51,8470610,Zach Parise,L,COL,40,82,16,13,29
51,8477952,Robby Fabbri,C,DET,28,82,15,14,29
51,8481560,Arthur Kaliyev,R,LAK,23,82,14,15,29
51,8480821,Filip Zadina,R,SJS,25,82,14,15,29
51,8478046,Danton Heinen,L,BOS,29,82,13,16,29
51,8474870,Tyler Johnson,C,CHI,34,82,12,17,29
51,8484153,Leo Carlsson,C,ANA,20,82,12,17,29
51,8477506,Ryan Pulock,D,NYI,30,82,9,20,29
51,8475343,Nic Dowd,C,WSH,34,82,8,21,29
51,8479398,Samuel Girard,D,COL,26,82,7,22,29
51,8482705,Cole Sillinger,C,CBJ,21,82,7,22,29
51,8476902,Esa Lindell,D,DAL,30,82,7,22,29
51,8476917,Adam Pelech,D,NYI,30,82,6,23,29
51,8476331,Dylan DeMelo,D,WPG,31,82,5,24,29
51,8482733,Logan Mailloux,D,MTL,31,82,3,26,29
51,8473507,Jeff Petry,D,DET,37,82,0,29,29
51,8481624,Ilya Mikheyev,R,VAN,30,82,16,12,28
51,8479661,Tanner Jeannot,L,TBL,27,82,16,12,28
51,8482055,Drew O'Connor,L,PIT,26,82,16,12,28
51,8477425,Miles Wood,L,COL,29,82,13,15,28
51,8482079,Marco Rossi,C,MIN,23,82,13,15,28
51,8476438,Brandon Saad,L,STL,32,82,12,16,28
51,8482074,Connor Zary,C,CGY,23,82,11,17,28
51,8476374,Sean Kuraly,C,CBJ,31,82,10,18,28
51,8475218,Mattias Ekholm,D,EDM,34,82,9,19,28
51,8470604,Jeff Carter,C,PIT,39,82,8,20,28
51,8476885,Jacob Trouba,D,NYR,30,82,5,23,28
51,8482720,Matthew Knies,L,TOR,22,82,4,24,28
51,8483515,Juraj Slafkovsky,L,MTL,20,82,11,16,27
51,8479346,Dillon Dube,C,CGY,26,82,10,17,27
51,8476869,Brady Skjei,D,CAR,30,82,6,21,27
51,8480246,Nick Perbix,D,TBL,26,82,5,22,27
51,8482125,Alexander Holtz,R,NJD,22,82,18,8,26
51,8484166,Adam Fantilli,C,CBJ,20,82,15,11,26
51,8476480,Vladislav Namestnikov,C,WPG,32,82,13,13,26
51,8482146,Luke Evangelista,R,NSH,22,82,11,15,26
51,8476897,Oskar Sundqvist,C,STL,30,82,11,15,26
51,8476925,Colton Sissons,C,NSH,31,82,10,16,26
51,8480849,Barrett Hayton,C,ARI,24,82,8,18,26
51,8481522,Peyton Krebs,C,BUF,23,82,8,18,26
51,8482655,J.J. Moser,D,ARI,24,82,7,19,26
51,8482624,Daniil Miromanov,D,CGY,27,82,7,19,26
51,8480145,Neal Pionk,D,WPG,29,82,6,20,26
51,8478507,John Marino,D,NJD,27,82,6,20,26
51,8482712,Oskar Olausson,R,COL,22,82,3,23,26
51,8483493,Frank Nazar,C,CHI,20,82,16,9,25
51,8474189,Lars Eller,C,PIT,35,82,15,10,25
51,8476624,Barclay Goodrow,C,NYR,31,82,11,14,25
51,8482259,Bobby McMann,C,TOR,28,82,9,16,25
51,8477034,Jaycob Megna,D,CHI,32,82,6,19,25
51,8482470,Ilya Solovyov,D,CGY,24,82,5,20,25
51,8482073,Braden Schneider,D,NYR,23,82,1,24,25
51,8474053,Logan Couture,C,SJS,35,82,12,12,24
51,8479977,Kailer Yamamoto,R,SEA,26,82,12,12,24
51,8479591,Michael Eyssimont,C,TBL,28,82,10,14,24
51,8474715,Cam Atkinson,R,PHI,35,82,9,15,24
51,8476457,Adam Larsson,D,SEA,32,82,9,15,24
51,8475188,Brayden McNabb,D,VGK,33,82,7,17,24
51,8477392,Hudson Fasching,R,NYI,29,82,7,17,24
51,8477953,Kasperi Kapanen,R,STL,28,82,6,18,24
51,8477365,Connor Clifton,D,BUF,29,82,6,18,24
51,8473563,Nicklas Backstrom,C,WSH,37,82,5,19,24
51,8482245,Artem Zub,D,OTT,29,82,5,19,24
51,8477435,Ryan Graves,D,PIT,29,82,5,19,24
51,8479998,Mikey Anderson,D,LAK,25,82,5,19,24
51,8474151,Ryan McDonagh,D,NSH,35,82,4,20,24
51,8474673,TJ Brodie,D,TOR,34,82,3,21,24
51,8478416,Erik Cernak,D,TBL,27,82,2,22,24
51,8481535,Nils Hoglander,L,VAN,24,82,13,10,23
51,8478413,Jordan Greenway,L,BUF,27,82,12,11,23
51,8470621,Corey Perry,R,EDM,39,82,12,11,23
51,8473504,Cal Clutterbuck,R,NYI,37,82,12,11,23
51,8480144,David Kampf,C,TOR,29,82,10,13,23
51,8479316,Luke Kunin,C,SJS,27,82,10,13,23
51,8480336,Sean Walker,D,COL,30,82,8,15,23
51,8475164,Jakob Silfverberg,R,ANA,34,82,8,15,23
51,8482117,Lukas Reichel,L,CHI,22,82,7,16,23
51,8476871,Tanner Pearson,L,MTL,32,82,6,17,23
51,8478851,Alexandre Carrier,D,NSH,28,82,4,19,23
51,8475762,Derek Forbort,D,BOS,32,82,3,20,23
51,8478020,Michael Amadio,C,VGK,28,82,15,7,22
51,8482118,Sam Colangelo,R,ANA,23,82,15,7,22
51,8482702,Logan Stankoven,C,DAL,21,82,13,9,22
51,8476873,Mark Jankowski,C,NSH,30,82,10,12,22
51,8482737,Zack Bolduc,C,STL,21,82,10,12,22
51,8481093,Rafael Harvey-Pinard,L,MTL,25,82,10,12,22
51,8474884,Mike Hoffman,C,SJS,35,82,9,13,22
51,8477845,Trevor van Riemsdyk,D,WSH,33,82,7,15,22
51,8483495,Simon Nemec,D,NJD,20,82,5,17,22
51,8481537,Nikita Okhotiuk,D,CGY,24,82,5,17,22
51,8475197,Tyson Barrie,D,NSH,33,82,4,18,22
51,8480860,Kevin Bahl,D,NJD,24,82,4,18,22
51,8477220,Nate Schmidt,D,WPG,33,82,0,22,22
51,8482145,Mavrik Bourque,C,DAL,22,82,19,2,21
51,8480074,Alexandre Texier,C,CBJ,25,82,13,8,21
51,8480813,Joe Veleno,C,DET,24,82,8,13,21
51,8479514,Rem Pitlick,C,CHI,27,82,7,14,21
51,8479359,Beck Malenstyn,L,WSH,26,82,7,14,21
51,8480035,Henri Jokiharju,D,BUF,25,82,6,15,21
51,8476312,Josh Manson,D,COL,33,82,4,17,21
51,8476879,Cody Ceci,D,EDM,31,82,4,17,21
51,8475455,Brenden Dillon,D,WPG,34,82,2,19,21
51,8481568,Alex Vlasic,D,CHI,23,82,2,19,21
51,8476921,Jordan Martinook,L,CAR,32,82,11,9,20
51,8479293,Brandon Tanev,L,SEA,33,82,10,10,20
51,8479390,Taylor Raddysh,R,CHI,26,82,10,10,20
51,8477406,Mattias Janmark,C,EDM,32,82,10,10,20
51,8476927,Teddy Blueger,C,VAN,30,82,7,13,20
51,8483499,Liam Ohgren,L,MIN,20,82,7,13,20
51,8480834,Ty Emberson,D,SJS,24,82,7,13,20
51,8477330,Dominik Kubalik,L,OTT,29,82,7,13,20
51,8477015,Connor Brown,R,EDM,30,82,7,13,20
51,8478882,Vladislav Gavrikov,D,LAK,29,82,7,13,20
51,8477507,Nikita Zadorov,D,VAN,29,82,6,14,20
51,8478013,Jake Walman,D,DET,28,82,6,14,20
51,8470966,Mark Giordano,D,TOR,41,82,6,14,20
51,8476525,Colin Miller,D,WPG,32,82,5,15,20
51,8478500,Ivan Provorov,D,CBJ,27,82,5,15,20
51,8478859,Niko Mikkola,D,FLA,28,82,5,15,20
51,8481524,Bowen Byram,D,BUF,23,82,4,16,20
51,8480058,Pierre-Olivier Joseph,D,PIT,25,82,4,16,20
51,8477505,Alexander Wennberg,C,NYR,30,82,4,16,20
51,8481606,Jordan Spence,D,LAK,23,82,3,17,20
51,8478178,Darren Raddysh,D,TBL,28,82,3,17,20
51,8482087,Kaiden Guhle,D,MTL,22,82,2,18,20
51,8470600,Ryan Suter,D,DAL,39,82,2,18,20
51,8483466,Kevin Korchinski,D,CHI,20,82,2,18,20
51,8484203,Bradly Nadeau,L,CAR,19,82,11,8,19
51,8479393,Noah Gregor,C,TOR,26,82,11,8,19
51,8473453,Trevor Lewis,C,LAK,37,82,11,8,19
51,8479983,Mario Ferraro,D,SJS,26,82,10,9,19
51,8481517,Brett Leason,R,ANA,25,82,9,10,19
51,8474009,Nick Bonino,C,NYR,36,82,9,10,19
51,8479351,Sam Steel,C,DAL,26,82,8,11,19
51,8482679,Matt Coronato,R,CGY,22,82,8,11,19
51,8479353,Brett Howden,C,VGK,26,82,7,12,19
51,8475231,Casey Cizikas,C,NYI,33,82,7,12,19
51,8482111,Justin Barron,D,MTL,23,82,6,13,19
51,8481178,Egor Zamula,D,PHI,24,82,5,14,19
51,8474567,Zach Bogosian,D,MIN,34,82,5,14,19
51,8476467,Jamie Oleksiak,D,SEA,32,82,5,14,19
51,8475462,Radko Gudas,D,ANA,34,82,5,14,19
51,8481014,Alexander Romanov,D,NYI,24,82,4,15,19
51,8476429,Scott Mayfield,D,NYI,32,82,4,15,19
51,8478443,Brandon Carlo,D,BOS,28,82,4,15,19
51,8475233,David Savard,D,MTL,34,82,3,16,19
51,8478508,Yakov Trenin,C,COL,27,82,14,4,18
51,8476278,Colin Blackwell,C,CHI,31,82,11,7,18
51,8476858,Phillip Di Giuseppe,L,VAN,31,82,10,8,18
51,8479996,Cody Glass,C,NSH,25,82,8,10,18
51,8476931,Jake McCabe,D,TOR,31,82,8,10,18
51,8480980,Connor Dewar,C,TOR,25,82,7,11,18
51,8476442,Matt Nieto,L,PIT,32,82,7,11,18
51,8478451,Ethan Bear,D,WSH,27,82,6,12,18
51,8476422,Mike Reilly,D,NYI,31,82,6,12,18
51,8475220,Marcus Foligno,L,MIN,33,82,5,13,18
51,8476878,Zemgus Girgensons,L,BUF,30,82,5,13,18
51,8479369,Andrew Peeke,D,BOS,26,82,4,14,18
51,8475200,Dmitry Orlov,D,CAR,33,82,3,15,18
51,8480073,Erik Brannstrom,D,OTT,25,82,3,15,18
51,8480807,Mattias Samuelsson,D,BUF,24,82,2,16,18
51,8477499,Rasmus Ristolainen,D,PHI,30,82,2,16,18
51,8475179,Dmitry Kulikov,D,FLA,34,82,1,17,18
51,8475324,Nick Jensen,D,WSH,34,82,0,18,18
51,8480448,Parker Kelly,L,OTT,25,82,11,6,17
51,8483505,Matthew Poitras,C,BOS,20,82,10,7,17
51,8475181,Nick Leddy,D,STL,33,82,7,10,17
51,8475279,Ben Chiarot,D,DET,33,82,7,10,17
51,8480796,Martin Fehervary,D,WSH,25,82,7,10,17
51,8481477,Nico Sturm,C,SJS,29,82,7,10,17
51,8476967,Brett Kulak,D,EDM,30,82,5,12,17
51,8481605,Jackson LaCombe,D,ANA,23,82,5,12,17
51,8477508,Curtis Lazar,C,NJD,29,82,4,13,17
51,8479976,Juuso Valimaki,D,ARI,26,82,3,14,17
51,8475208,Brian Dumoulin,D,SEA,33,82,2,15,17
51,8475690,Chris Tanev,D,DAL,35,82,2,15,17
51,8475790,Erik Gudbranson,D,CBJ,32,82,1,16,17
51,8475842,Sam Carrick,C,EDM,32,82,10,6,16
51,8481704,Juuso Parssinen,C,NSH,23,82,8,8,16
51,8481601,Simon Holmstrom,R,NYI,23,82,8,8,16
51,8482730,Brandt Clarke,D,LAK,21,82,8,8,16
51,8480855,Jack McBain,C,ARI,24,82,7,9,16
51,8479442,Troy Stecher,D,EDM,30,82,6,10,16
51,8482142,Jamie Drysdale,D,PHI,22,82,5,11,16
51,8479324,Ryan Lindgren,D,NYR,26,82,5,11,16
51,8483565,Nick Blankenburg,D,CBJ,26,82,4,12,16
51,8475177,Calvin de Haan,D,TBL,33,82,4,12,16
51,8482166,Shakir Mukhamadullin,D,SJS,22,82,3,13,16
51,8478136,Jake Middleton,D,MIN,28,82,2,14,16
51,8483012,Logan Morrison,C,SEA,22,82,11,4,15
51,8482062,Cole Smith,L,NSH,29,82,6,9,15
51,8478043,Sam Lafferty,C,VAN,29,82,5,10,15
51,8482155,Alex Laferriere,R,LAK,23,82,5,10,15
51,8478430,Oliver Kylington,D,CGY,27,82,5,10,15
51,8474166,Alec Martinez,D,VGK,37,82,5,10,15
51,8477353,Tyler Motte,C,TBL,29,82,5,10,15
51,8482177,Marat Khusnutdinov,C,MIN,22,82,5,10,15
51,8483763,Maksymilian Szuber,D,ARI,22,82,4,11,15
51,8484911,Collin Graf,R,SJS,22,82,4,11,15
51,8477488,Brett Pesce,D,CAR,30,82,3,12,15
51,8481059,Scott Perunovich,D,STL,26,82,1,14,15
51,8478399,Jonas Siegenthaler,D,NJD,27,82,1,14,15
51,8481028,Martin Pospisil,C,CGY,25,82,7,7,14
51,8481553,Bobby Brink,R,PHI,23,82,5,9,14
51,8477931,Tomas Nosek,L,NJD,32,82,5,9,14
51,8478408,Travis Dermott,D,ARI,28,82,4,10,14
51,8481567,Henry Thrun,D,SJS,23,82,3,11,14
51,8476372,Nick Seeler,D,PHI,31,82,3,11,14
51,8477969,Marcus Pettersson,D,PIT,28,82,2,12,14
51,8476891,Matt Grzelcyk,D,BOS,30,82,1,13,14
51,8471677,Jack Johnson,D,COL,37,82,0,14,14
51,8479383,Boris Katchouk,L,OTT,26,82,6,7,13
51,8481030,Jack St. Ivany,D,PIT,25,82,5,8,13
51,8482803,Olen Zellweger,D,ANA,21,82,3,10,13
51,8475825,Jani Hakanpää,D,DAL,32,82,3,10,13
51,8478831,Kevin Stenlund,C,FLA,28,82,2,11,13
51,8483490,Pavel Mintyukov,D,ANA,21,82,1,12,13
51,8479371,Dante Fabbro,D,NSH,26,82,1,12,13
51,8480172,Jan Rutta,D,SJS,34,82,0,13,13
51,8476915,Jujhar Khaira,L,MIN,30,82,7,5,12
51,8477369,Carson Soucy,D,VAN,30,82,4,8,12
51,8482516,Matthew Kessel,D,STL,24,82,4,8,12
51,8474013,Ian Cole,D,VAN,35,82,3,9,12
51,8480990,Declan Chisholm,D,MIN,24,82,3,9,12
51,8482762,Simon Edvinsson,D,DET,21,82,2,10,12
51,8478840,Will Borgen,D,SEA,28,82,1,11,12
51,8479980,Nicolas Hague,D,VGK,26,82,1,11,12
51,8483482,Tristan Luneau,D,ANA,20,82,4,7,11
51,8480879,Jacob Bernard-Docker,D,OTT,24,82,2,9,11
51,8474574,Tyler Myers,D,VAN,34,82,1,10,11
51,8483468,Jiri Kulich,C,BUF,20,82,5,5,10
51,8479291,Kevin Rooney,C,CGY,31,82,4,6,10
51,8484149,Gavin Brindley,C,CBJ,20,82,4,6,10
51,8474034,Pat Maroon,L,BOS,36,82,3,7,10
51,8476473,Connor Murphy,D,CHI,31,82,2,8,10
51,8482858,Ryker Evans,D,SEA,23,82,2,8,10
51,8477335,Kyle Burroughs,D,SJS,29,82,4,5,9
51,8482809,Jackson Blake,R,CAR,21,82,5,3,8
51,8482666,Scott Morrow,D,CAR,22,82,3,5,8
51,8476822,Luke Glendening,C,TBL,35,82,3,5,8
51,8478468,Jeremy Lauzon,D,NSH,27,82,1,6,7
51,8482807,Ethan Del Mastro,D,CHI,21,82,1,6,7
51,8481578,Graeme Clarke,R,NJD,23,82,1,5,6
51,8482859,Zack Ostapchuk,C,OTT,21,82,1,4,5
51,8483489,Fraser Minten,C,TOR,31,82,1,4,5
51,8482713,Mackie Samoskevich,R,FLA,22,82,2,2,4
51,8481599,Victor Soderstrom,D,ARI,23,82,1,3,4
51,8482141,Lukas Cormier,D,VGK,22,0,0,0,0
51,8476988,Matt Benning,D,SJS,30,0,0,0,0
51,8480727,Zach Whitecloud,D,VGK,28,0,0,0,0
51,8480887,Jordan Harris,D,MTL,24,0,0,0,0
51,8478450,Parker Wotherspoon,D,BOS,27,0,0,0,0
51,8481812,Nikolai Knyzhov,D,SJS,27,0,0,0,0
51,8480001,Urho Vaakanainen,D,ANA,25,0,0,0,0
51,8482176,Wyatt Kaiser,D,CHI,22,0,0,0,0
51,8481122,Simon Benoit,D,TOR,26,0,0,0,0
51,8476441,Joel Edmundson,D,TOR,31,0,0,0,0
51,8480884,Calen Addison,D,SJS,24,0,0,0,0
51,8482511,Mason Lohrei,D,BOS,23,0,0,0,0
51,8482192,Isaak Phillips,D,CHI,23,0,0,0,0
51,8480950,Ilya Lyubushkin,D,TOR,30,0,0,0,0
51,8474031,Kevin Shattenkirk,D,BOS,35,0,0,0,0
51,8475718,Justin Holl,D,DET,32,0,0,0,0
51,8479402,Jake Bean,D,CBJ,26,0,0,0,0
51,8474602,Justin Schultz,D,SEA,34,0,0,0,0
51,8477950,Tony DeAngelo,D,CAR,29,0,0,0,0
51,8481743,Marc Del Gaizo,D,NSH,25,0,0,0,0
51,8481527,Kaedan Korczak,D,VGK,23,0,0,0,0
51,8480192,Johnathan Kovacevic,D,MTL,27,0,0,0,0
51,8476874,Olli Maatta,D,DET,30,0,0,0,0
51,8482144,Jack Thompson,D,SJS,22,0,0,0,0
51,8480222,Sebastian Aho,D,NYI,28,0,0,0,0
51,8479458,Nikita Zaitsev,D,CHI,33,0,0,0,0
51,8471709,Marc-Edouard Vlasic,D,SJS,37,0,0,0,0
51,8482929,Emil Lilleberg,D,TBL,23,0,0,0,0
51,8477018,Ben Hutton,D,VGK,31,0,0,0,0
51,8481056,Spencer Stastney,D,NSH,24,0,0,0,0
51,8481593,Jayden Struble,D,MTL,23,0,0,0,0
51,8479982,Conor Timmins,D,TOR,26,0,0,0,0
51,8474090,Brendan Smith,D,NJD,35,0,0,0,0
51,8482964,Arber Xhekaj,D,MTL,23,0,0,0,0
51,8480891,Michael Kesselring,D,ARI,24,0,0,0,0
51,8477938,Haydn Fleury,D,TBL,28,0,0,0,0
51,8481806,Louis Crevier,D,CHI,23,0,0,0,0
51,8471274,Alex Goligoski,D,MIN,39,0,0,0,0
51,8481600,Tobias Bjornfot,D,FLA,23,0,0,0,0
51,8475797,Jarred Tinordi,D,CHI,32,0,0,0,0
51,8481521,Ronnie Attard,D,PHI,25,0,0,0,0
51,8474612,Travis Hamonic,D,OTT,34,0,0,0,0
51,8479576,Vincent Desharnais,D,EDM,28,0,0,0,0
51,8480049,Dylan Samberg,D,WPG,25,0,0,0,0
51,8483619,Filip Roos,D,CHI,25,0,0,0,0
51,8474568,Luke Schenn,D,NSH,35,0,0,0,0
51,8480184,Gustav Lindstrom,D,ANA,26,0,0,0,0
51,8480070,Ian Mitchell,D,BOS,25,0,0,0,0
51,8480196,Jacob Bryson,D,BUF,27,0,0,0,0
51,8471686,Marc Staal,D,PHI,37,0,0,0,0
51,8477467,Gustav Olofsson,D,SEA,30,0,0,0,0
51,8478970,Jalen Chatfield,D,CAR,28,0,0,0,0
51,8479348,Kale Clague,D,BUF,26,0,0,0,0
51,8473446,Erik Johnson,D,PHI,36,0,0,0,0
51,8477462,Robert Hagg,D,ANA,29,0,0,0,0
51,8478454,Noah Juulsen,D,VAN,27,0,0,0,0
51,8477384,Josh Brown,D,ARI,30,0,0,0,0
51,8481708,Zac Jones,D,NYR,24,0,0,0,0
51,8481167,Brayden Pachal,D,CGY,25,0,0,0,0
51,8482067,Connor Mackey,D,NYR,28,0,0,0,0
51,8483460,David Jiricek,D,CBJ,21,0,0,0,0
51,8481701,Santeri Hatakka,D,NJD,23,0,0,0,0
51,8478021,William Lagesson,D,ANA,28,0,0,0,0
51,8477851,Jordan Oesterle,D,CGY,32,0,0,0,0
51,8478452,Caleb Jones,D,COL,27,0,0,0,0
51,8479984,Cal Foote,D,NJD,26,0,0,0,0
51,8479639,Dylan Coghlan,D,CAR,26,0,0,0,0
51,8480874,Adam Ginning,D,PHI,24,0,0,0,0
51,8479321,Lucas Johansen,D,WSH,27,0,0,0,0
51,8480878,Nils Lundkvist,D,DAL,24,0,0,0,0
51,8482165,Yan Kuznetsov,D,CGY,22,0,0,0,0
51,8484258,Sam Malinski,D,COL,26,0,0,0,0
51,8480157,Calle Rosen,D,STL,30,0,0,0,0
51,8484304,Uvis Balinskis,D,FLA,28,0,0,0,0
51,8479985,Cale Fleury,D,SEA,26,0,0,0,0
51,8479378,Logan Stanley,D,WPG,26,0,0,0,0
51,8477541,Dakota Mermis,D,MIN,30,0,0,0,0
51,8481609,Vladislav Kolyachonok,D,ARI,23,0,0,0,0
51,8480823,Alexander Alexeyev,D,WSH,25,0,0,0,0
51,8481679,Maxence Guenette,D,OTT,23,0,0,0,0
51,8481564,Ryan Johnson,D,BUF,23,0,0,0,0
51,8479376,Victor Mete,D,PHI,26,0,0,0,0
51,8484254,Akito Hirose,D,VAN,25,0,0,0,0
51,8482660,Kent Johnson,C,CBJ,22,0,0,0,0
51,8482149,Cole Perfetti,C,WPG,22,0,0,0,0
51,8477987,Ryan Donato,C,CHI,28,0,0,0,0
51,8475755,Alexander Petrovic,D,DAL,32,0,0,0,0
51,8477810,Joel Hanley,D,CGY,33,0,0,0,0
51,8474145,Robert Bortuzzo,D,NYI,35,0,0,0,0
51,8481161,Jake Christiansen,D,CBJ,25,0,0,0,0
51,8476884,Derrick Pouliot,D,DAL,30,0,0,0,0
51,8481716,Dmitri Voronkov,L,CBJ,24,0,0,0,0
51,8480084,Nick DeSimone,D,NJD,30,0,0,0,0
51,8475750,Jon Merrill,D,MIN,32,0,0,0,0
51,8479315,Joey Anderson,R,CHI,26,0,0,0,0
51,8478011,Louie Belpedio,D,PHI,28,0,0,0,0
51,8482451,Mikael Pyyhtia,L,CBJ,23,0,0,0,0
51,8481541,Samuel Bolduc,D,NYI,24,0,0,0,0
51,8482126,Emil Andrae,D,PHI,31,0,0,0,0
51,8474618,Marco Scandella,D,STL,34,0,0,0,0
51,8477244,Chad Ruhwedel,D,NYR,34,0,0,0,0
51,8477971,Andreas Englund,D,LAK,28,0,0,0,0
51,8480829,Jesperi Kotkaniemi,C,CAR,24,0,0,0,0
51,8479372,Josh Mahura,D,FLA,26,0,0,0,0
51,8482095,Tyler Kleven,D,OTT,22,0,0,0,0
51,8481719,Maxwell Crozier,D,TBL,24,0,0,0,0
51,8475855,Jesper Fast,R,CAR,33,0,0,0,0
51,8480848,Ty Dellandrea,C,DAL,24,0,0,0,0
51,8475193,Tomas Tatar,L,SEA,34,0,0,0,0
51,8476889,Radek Faksa,C,DAL,30,0,0,0,0
51,8478495,Denis Gurianov,R,PHI,27,0,0,0,0
51,8480216,Jacob Peterson,C,SJS,25,0,0,0,0
51,8480252,Cole Guttman,C,CHI,25,0,0,0,0
51,8479026,Philippe Myers,D,TBL,27,0,0,0,0
51,8481006,Tyler Tucker,D,STL,24,0,0,0,0
51,8481032,Paul Cotter,C,VGK,25,0,0,0,0
51,8481577,Philip Tomasino,C,NSH,23,0,0,0,0
51,8476918,Jimmy Vesey,L,NYR,31,0,0,0,0
51,8479320,Max Lajoie,D,TOR,27,0,0,0,0
51,8478017,Mark Friedman,D,VAN,29,0,0,0,0
51,8481754,Nikita Nesterenko,C,ANA,23,0,0,0,0
51,8483407,Brandon Scanlin,D,NYR,25,0,0,0,0
51,8482659,Josh Doan,R,ARI,22,0,0,0,0
51,8477446,Michael McCarron,R,NSH,29,0,0,0,0
51,8477903,Garnet Hathaway,R,PHI,33,0,0,0,0
51,8482153,Brendan Brisson,C,VGK,23,0,0,0,0
51,8483546,Marshall Rifai,D,TOR,26,0,0,0,0
51,8484287,Cole McWard,D,VAN,23,0,0,0,0
51,8478854,Ryan Shea,D,PIT,27,0,0,0,0
51,8481585,Egor Afanasyev,L,NSH,23,0,0,0,0
51,8483398,Declan Carlile,D,TBL,31,0,0,0,0
51,8478502,Dennis Gilbert,D,CGY,28,0,0,0,0
51,8482749,Joshua Roy,R,MTL,21,0,0,0,0
51,8481598,Philip Broberg,D,EDM,23,0,0,0,0
51,8480835,Jack Drury,C,CAR,24,0,0,0,0
51,8480748,Kiefer Sherwood,L,NSH,29,0,0,0,0
51,8476934,Brock McGinn,L,ANA,30,0,0,0,0
51,8480870,Bo Groulx,C,ANA,24,0,0,0,0
51,8479368,Max Jones,L,ANA,26,0,0,0,0
51,8478099,Kevin Labanc,R,SJS,29,0,0,0,0
51,8478067,Oskar Lindblom,L,SJS,28,0,0,0,0
51,8476393,Nick Cousins,C,FLA,31,0,0,0,0
51,8483395,Arshdeep Bains,L,VAN,23,0,0,0,0
51,8480762,Eric Robinson,L,BUF,29,0,0,0,0
51,8479439,Jacob MacDonald,D,SJS,31,0,0,0,0
51,8476474,Stefan Noesen,R,CAR,31,0,0,0,0
51,8482787,Nikita Chibrikov,R,WPG,31,0,0,0,0
51,8478432,Christian Fischer,R,DET,27,0,0,0,0
51,8477979,Nicolas Aube-Kubel,R,WSH,28,0,0,0,0
51,8481789,Tye Kartye,L,SEA,23,0,0,0,0
51,8479330,Brandon Gignac,C,MTL,27,0,0,0,0
51,8480075,Cameron Crotty,D,ARI,25,0,0,0,0
51,8473473,Milan Lucic,L,BOS,36,0,0,0,0
51,8482094,Daemon Hunt,D,MIN,22,0,0,0,0
51,8481206,John Ludvig,D,PIT,24,0,0,0,0
51,8483630,Pavol Regenda,L,ANA,25,0,0,0,0
51,8481617,Vasily Podkolzin,R,VAN,23,0,0,0,0
51,8480306,Grant Hutton,D,NYI,29,0,0,0,0
51,8480995,Pontus Holmberg,R,TOR,25,0,0,0,0
51,8482148,Hendrix Lapierre,C,WSH,22,0,0,0,0
51,8477478,William Carrier,L,VGK,30,0,0,0,0
51,8480003,Jesper Boqvist,C,BOS,26,0,0,0,0
51,8482172,Landon Slaggert,L,CHI,22,0,0,0,0
51,8480789,Oliver Wahlstrom,R,NYI,24,0,0,0,0
51,8474062,Riley Nash,C,NYR,35,0,0,0,0
51,8480021,Jack Studnicka,C,SJS,25,0,0,0,0
51,8480025,MacKenzie Entwistle,R,CHI,25,0,0,0,0
51,8481582,Nicholas Robertson,L,TOR,23,0,0,0,0
51,8476867,Brendan Gaunce,C,CBJ,30,0,0,0,0
51,8479619,Michael Carcone,L,ARI,28,0,0,0,0
51,8479370,Tyson Jost,C,BUF,26,0,0,0,0
51,8479671,Mathieu Olivier,R,CBJ,27,0,0,0,0
51,8476994,Vinnie Hinostroza,C,PIT,30,0,0,0,0
51,8482070,Mitchell Chaffee,R,TBL,26,0,0,0,0
51,8477473,Justin Bailey,R,SJS,29,0,0,0,0
51,8479344,Jesse Puljujarvi,R,PIT,26,0,0,0,0
51,8480205,Emil Bemstrom,C,PIT,25,0,0,0,0
51,8479718,Alex Barré-Boulet,C,TBL,27,0,0,0,0
51,8482061,Brandon Biro,L,BUF,26,0,0,0,0
51,8479638,Justin Brazeau,R,BOS,26,0,0,0,0
51,8474040,Sam Gagner,C,EDM,35,0,0,0,0
51,8477846,Ryan Carpenter,C,SJS,33,0,0,0,0
51,8482077,Dylan Holloway,L,EDM,23,0,0,0,0
51,8482157,Will Cuylle,L,NYR,22,0,0,0,0
51,8480007,Jonas Rondbjerg,R,VGK,25,0,0,0,0
51,8478874,Adam Gaudette,C,STL,28,0,0,0,0
51,8478434,Keegan Kolesar,R,VGK,27,0,0,0,0
51,8480441,Trey Fix-Wolansky,R,CBJ,25,0,0,0,0
51,8479994,Jaret Anderson-Dolan,C,NSH,25,0,0,0,0
51,8483567,Georgii Merkulov,C,BOS,24,0,0,0,0
51,8477380,Jonny Brodzinski,C,NYR,31,0,0,0,0
51,8482201,Gage Goncalves,C,TBL,23,0,0,0,0
51,8478211,Dryden Hunt,L,CGY,29,0,0,0,0
51,8471699,Andrew Cogliano,C,COL,37,0,0,0,0
51,8479421,Jacob Moverare,D,LAK,26,0,0,0,0
51,8478881,Brett Seney,L,CHI,28,0,0,0,0
51,8477464,Nic Petan,C,MIN,29,0,0,0,0
51,8475958,Michael Sgarbossa,C,WSH,32,0,0,0,0
51,8481147,Reese Johnson,C,CHI,26,0,0,0,0
51,8479336,Carl Grundstrom,R,LAK,27,0,0,0,0
51,8480853,Liam Foudy,C,NSH,24,0,0,0,0
51,8479522,Hardy Haman Aktell,D,WSH,26,0,0,0,0
51,8481462,Mason Morelli,L,VGK,28,0,0,0,0
51,8482102,Vasily Ponomarev,C,CAR,22,0,0,0,0
51,8480844,Grigori Denisenko,L,VGK,24,0,0,0,0
51,8479944,Zach Aston-Reese,C,DET,30,0,0,0,0
51,8482784,Zach Dean,C,STL,21,0,0,0,0
51,8479419,Brett Murray,L,BUF,26,0,0,0,0
51,8479520,Brandon Duhaime,R,COL,27,0,0,0,0
51,8477573,Nathan Walker,L,STL,30,0,0,0,0
51,8478078,Rourke Chartier,C,OTT,28,0,0,0,0
51,8475795,Dylan McIlrath,D,WSH,32,0,0,0,0
51,8482496,Nils Aman,C,VAN,24,0,0,0,0
51,8480289,Morgan Barron,C,WPG,26,0,0,0,0
51,8481751,Lukas Rousek,R,BUF,25,0,0,0,0
51,8480011,Klim Kostin,C,SJS,25,0,0,0,0
51,8481556,John Beecher,C,BOS,23,0,0,0,0
51,8475278,Byron Froese,C,VGK,33,0,0,0,0
51,8475225,Craig Smith,C,DAL,35,0,0,0,0
51,8484326,Patrik Koch,D,ARI,28,0,0,0,0
51,8477930,Pierre-Edouard Bellemare,L,SEA,39,0,0,0,0
51,8478409,Anthony Richard,C,BOS,28,0,0,0,0
51,8481024,Linus Karlsson,C,VAN,25,0,0,0,0
51,8479986,Kole Lind,R,SEA,26,0,0,0,0
51,8479414,Nathan Bastian,R,NJD,27,0,0,0,0
51,8479362,Riley Tufte,L,COL,26,0,0,0,0
51,8481058,Jesse Ylönen,R,MTL,25,0,0,0,0
51,8482476,Emil Heineman,L,MTL,23,0,0,0,0
51,8482861,Vincent Iorio,D,WSH,22,0,0,0,0
51,8483432,Luca Del Bel Belluz,C,CBJ,31,0,0,0,0
51,8482744,James Malatesta,L,CBJ,21,0,0,0,0
51,8477887,Patrick Brown,C,BOS,32,0,0,0,0
51,8478585,Derek Ryan,C,EDM,38,0,0,0,0
51,8481441,Joe Snively,C,WSH,28,0,0,0,0
51,8481592,Jakob Pelletier,L,CGY,23,0,0,0,0
51,8482634,Alex Steeves,C,TOR,25,0,0,0,0
51,8477126,Jayson Megna,C,BOS,34,0,0,0,0
51,8475752,Tyler Pitlick,C,NYR,33,0,0,0,0
51,8480008,Adam Ruzicka,C,ARI,25,0,0,0,0
51,8481065,Angus Crookshank,L,OTT,25,0,0,0,0
51,8479547,Matthew Phillips,R,WSH,26,0,0,0,0
51,8480226,Marián Studenic,R,SEA,26,0,0,0,0
51,8481237,Kyle MacLean,C,NYI,25,0,0,0,0
51,8475413,Justin Dowling,C,NJD,34,0,0,0,0
51,8481641,Joel Kiviranta,L,COL,28,0,0,0,0
51,8478104,Sammy Blais,L,STL,28,0,0,0,0
51,8477454,Adam Erne,L,EDM,29,0,0,0,0
51,8481518,Nolan Foote,L,NJD,24,0,0,0,0
51,8480245,Olle Lycksell,R,PHI,25,0,0,0,0
51,8483570,Ben Meyers,C,ANA,26,0,0,0,0
51,8480776,Sheldon Rempal,R,VGK,29,0,0,0,0
51,8483920,Pierrick Dube,R,WSH,23,0,0,0,0
51,8480267,Sammy Walker,C,MIN,25,0,0,0,0
51,8482747,Brennan Othmann,L,NYR,21,0,0,0,0
51,8479991,Jake Leschyshyn,C,NYR,25,0,0,0,0
51,8478400,Colin White,C,MTL,27,0,0,0,0
51,8479328,Julien Gauthier,R,NYI,27,0,0,0,0
51,8484325,Waltteri Merela,C,TBL,26,0,0,0,0
51,8479066,Ryan Lomberg,L,FLA,30,0,0,0,0
51,8477070,Liam O'Brien,C,ARI,30,0,0,0,0
51,8478146,Matthew Highmore,C,OTT,28,0,0,0,0
51,8478028,Fredrik Olofsson,L,COL,28,0,0,0,0
51,8480880,Jakub Lauko,C,BOS,24,0,0,0,0
51,8479968,Vinni Lettieri,C,MIN,29,0,0,0,0
51,8474709,Matt Martin,L,NYI,35,0,0,0,0
51,8480845,Rasmus Kupari,C,WPG,24,0,0,0,0
51,8481550,Adam Beckman,L,MIN,23,0,0,0,0
51,8481422,Jacob Lucchini,C,MIN,29,0,0,0,0
51,8477401,John Hayden,C,SEA,29,0,0,0,0
51,8478904,Steven Lorentz,C,FLA,28,0,0,0,0
51,8482088,Justin Sourdif,R,FLA,22,0,0,0,0
51,8482751,Ryan Winterton,C,SEA,21,0,0,0,0
51,8482241,Radim Zohorna,L,PIT,28,0,0,0,0
51,8481690,Tyler Angle,C,CBJ,24,0,0,0,0
51,8476952,Dominic Toninato,C,WPG,30,0,0,0,0
51,8476919,Chris Tierney,C,NJD,30,0,0,0,0
51,8480032,Shane Bowers,C,NJD,25,0,0,0,0
51,8484314,Jiri Smejkal,L,OTT,28,0,0,0,0
51,8481239,Samuel Fagemo,L,LAK,24,0,0,0,0
51,8481532,Alex Turcotte,C,LAK,23,0,0,0,0
51,8481019,David Gustafsson,C,WPG,24,0,0,0,0
51,8478477,Mitchell Stephens,C,MTL,27,0,0,0,0
51,8479546,Oskar Steen,C,BOS,26,0,0,0,0
51,8480292,Carson Meyer,R,CBJ,27,0,0,0,0
51,8478446,Glenn Gawdin,C,ANA,27,0,0,0,0
51,8483531,Brian Halonen,L,NJD,25,0,0,0,0
51,8477149,Scott Sabourin,R,SJS,32,0,0,0,0
51,8479972,Mason Shaw,C,MIN,26,0,0,0,0
51,8480890,Jan Jenik,R,ARI,24,0,0,0,0
51,8478051,Max Willman,C,NJD,29,0,0,0,0
51,8480851,Akil Thomas,C,LAK,24,0,0,0,0
51,8482765,Isak Rosen,R,BUF,21,0,0,0,0
51,8478421,A.J. Greer,L,CGY,28,0,0,0,0
51,8478512,Austin Czarnik,C,DET,32,0,0,0,0
51,8479536,Axel Jonsson-Fjallby,L,WPG,26,0,0,0,0
51,8477320,Anton Blidh,L,NYR,29,0,0,0,0
51,8481543,Nikita Alexandrov,C,STL,24,0,0,0,0
51,8475235,Nicolas Deslauriers,L,PHI,33,0,0,0,0
51,8481070,Hugh McGing,L,STL,26,0,0,0,0
51,8480836,Jonathan Gruden,C,PIT,24,0,0,0,0
51,8481591,Sam Poulin,R,PIT,23,0,0,0,0
51,8477962,Brendan Lemieux,L,CAR,28,0,0,0,0
51,8483401,Marc Johnstone,R,PIT,28,0,0,0,0
51,8482250,Callahan Burke,C,CAR,27,0,0,0,0
51,8481726,Adam Edstrom,C,NYR,24,0,0,0,0
51,8471817,Ryan Reaves,R,TOR,37,0,0,0,0
51,8479587,Rhett Gardner,C,PHI,28,0,0,0,0
51,8475766,Austin Watson,L,TBL,32,0,0,0,0
51,8479367,William Lockwood,R,FLA,26,0,0,0,0
51,8478424,Jansen Harkins,C,PIT,27,0,0,0,0
51,8476913,Devin Shore,C,SEA,30,0,0,0,0
51,8482652,Walker Duehr,R,CGY,27,0,0,0,0
51,8477527,Ross Johnston,L,ANA,30,0,0,0,0
51,8481077,John Leonard,L,ARI,26,0,0,0,0
51,8483549,Lucas Condotta,L,MTL,27,0,0,0,0
51,8480468,James Hamblin,L,EDM,25,0,0,0,0
51,8476907,Mackenzie MacEachern,L,STL,30,0,0,0,0
51,8479543,Michael Pezzetta,L,MTL,26,0,0,0,0
51,8480355,Mark Kastelic,C,OTT,25,0,0,0,0
51,8482162,Roby Jarventie,L,OTT,22,0,0,0,0
51,8479772,Zack MacEwen,R,OTT,28,0,0,0,0
51,8483597,Milos Kelemen,L,ARI,25,0,0,0,0
51,8479379,Givani Smith,R,SJS,26,0,0,0,0
51,8481655,Cole Schwindt,R,CGY,23,0,0,0,0
51,8479981,Jonah Gadjovich,L,FLA,26,0,0,0,0
51,8482147,Jean-Luc Foudy,C,COL,22,0,0,0,0
51,8484255,Jason Polin,R,COL,25,0,0,0,0
51,8477993,Justin Kirkland,C,ARI,28,0,0,0,0
51,8479249,Andrew Poturalski,C,SEA,30,0,0,0,0
51,8482197,Adam Raska,R,MIN,23,0,0,0,0
51,8475780,Chris Wagner,R,COL,33,0,0,0,0
51,8479533,Joona Koppanen,L,PIT,26,0,0,0,0
51,8481534,Raphael Lavoie,C,EDM,24,0,0,0,0
51,8484321,Nikolas Matinpalo,D,OTT,26,0,0,0,0
51,8481043,Cole Koepke,L,TBL,26,0,0,0,0
51,8476323,Max McCormick,L,SEA,32,0,0,0,0
51,8483609,Adam Klapka,R,CGY,24,0,0,0,0
51,8483512,Matt Savoie,C,BUF,20,0,0,0,0
51,8484259,Ondrej Pavel,C,COL,31,0,0,0,0
51,8478147,Bokondji Imama,L,OTT,28,0,0,0,0
51,8482460,Matt Rempe,C,NYR,22,0,0,0,0
51,8477073,Kurtis MacDermid,L,NJD,30,0,0,0,0
51,8480274,Philip Kemp,D,EDM,25,0,0,0,0
51,8478956,Samuel Laberge,L,NJD,27,0,0,0,0
51,8483045,Cameron Butler,R,CBJ,31,0,0,0,0
52,8476453,Nikita Kucherov,R,TBL,31,82,35,91,126
52,8478402,Connor McDavid,C,EDM,27,82,32,82,114
52,8478864,Kirill Kaprizov,L,MIN,27,82,53,58,111
52,8476887,Filip Forsberg,L,NSH,30,82,56,51,107
52,8477956,David Pastrnak,R,BOS,28,82,36,71,107
52,8479318,Auston Matthews,C,TOR,27,82,58,47,105
52,8478420,Mikko Rantanen,R,COL,28,82,50,51,101
52,8477939,William Nylander,R,TOR,28,82,46,55,101
52,8479314,Matthew Tkachuk,L,FLA,27,82,39,60,99
52,8481559,Jack Hughes,C,NJD,23,82,25,69,94
52,8477934,Leon Draisaitl,C,EDM,29,82,28,64,92
52,8478550,Artemi Panarin,L,NYR,33,82,40,51,91
52,8480027,Jason Robertson,L,DAL,25,82,33,55,88
52,8481557,Matt Boldy,L,MIN,23,82,31,57,88
52,8480801,Brady Tkachuk,L,OTT,25,82,42,45,87
52,8477933,Sam Reinhart,C,FLA,29,82,41,45,86
52,8478403,Jack Eichel,C,VGK,28,82,40,46,86
52,8477492,Nathan MacKinnon,C,COL,29,82,26,59,85
52,8480023,Robert Thomas,C,STL,25,82,24,57,81
52,8473419,Brad Marchand,L,BOS,36,82,31,49,80
52,8482116,Tim Stützle,C,OTT,22,82,18,62,80
52,8478427,Sebastian Aho,C,CAR,27,82,33,46,79
52,8477402,Pavel Buchnevich,L,STL,29,82,34,44,78
52,8478439,Travis Konecny,R,PHI,27,82,34,43,77
52,8475166,John Tavares,C,TOR,34,82,33,44,77
52,8471675,Sidney Crosby,C,PIT,37,82,31,46,77
52,8477960,Adrian Kempe,R,LAK,28,82,41,35,76
52,8476468,J.T. Miller,C,VAN,31,82,25,51,76
52,8477493,Aleksander Barkov,C,FLA,29,82,24,51,75
52,8474600,Roman Josi,D,NSH,34,82,21,54,75
52,8480012,Elias Pettersson,C,VAN,26,82,33,41,74
52,8480069,Cale Makar,D,COL,26,82,11,63,74
52,8475786,Zach Hyman,L,EDM,32,82,42,30,72
52,8478440,Dylan Strome,C,WSH,27,82,24,48,72
52,8474578,Erik Karlsson,D,PIT,34,82,23,49,72
52,8478445,Mathew Barzal,C,NYI,27,82,21,51,72
52,8477500,Bo Horvat,C,NYI,29,82,38,33,71
52,8476389,Vincent Trocheck,C,NYR,31,82,28,43,71
52,8476346,Johnny Gaudreau,L,CBJ,31,82,15,56,71
52,8478444,Brock Boeser,R,VAN,27,82,38,32,70
52,8476459,Mika Zibanejad,C,NYR,31,82,28,42,70
52,8475184,Chris Kreider,L,NYR,33,82,37,32,69
52,8481540,Cole Caufield,R,MTL,23,82,31,38,69
52,8480018,Nick Suzuki,C,MTL,25,82,30,39,69
52,8479407,Jesper Bratt,L,NJD,26,82,19,50,69
52,8480800,Quinn Hughes,D,VAN,25,82,10,58,68
52,8482665,Matty Beniers,C,SEA,22,82,19,48,67
52,8476456,Jonathan Huberdeau,C,CGY,31,82,17,50,67
52,8481523,Kirby Dach,C,MTL,23,82,9,58,67
52,8477951,Nick Schmaltz,C,ARI,28,82,24,42,66
52,8477942,Kevin Fiala,L,LAK,28,82,23,43,66
52,8477949,Alex Tuch,R,BUF,28,82,21,45,66
52,8480839,Rasmus Dahlin,D,BUF,24,82,20,46,66
52,8475692,Mats Zuccarello,R,MIN,37,82,16,50,66
52,8477501,Valeri Nichushkin,R,COL,29,82,37,28,65
52,8479420,Tage Thompson,C,BUF,27,82,31,34,65
52,8475913,Mark Stone,R,VGK,32,82,29,36,65
52,8482745,Mason McTavish,C,ANA,21,82,29,36,65
52,8475754,Brock Nelson,C,NYI,33,82,27,38,65
52,8471215,Evgeni Malkin,C,PIT,38,82,26,39,65
52,8478493,Joel Eriksson Ek,C,MIN,27,82,37,27,64
52,8474564,Steven Stamkos,C,TBL,34,82,34,30,64
52,8478010,Brayden Point,C,TBL,28,82,29,35,64
52,8477946,Dylan Larkin,C,DET,28,82,27,37,64
52,8477495,Seth Jones,D,CHI,30,82,23,41,64
52,8480830,Andrei Svechnikov,R,CAR,24,82,18,46,64
52,8480036,Miro Heiskanen,D,DAL,25,82,10,54,64
52,8476853,Morgan Rielly,D,TOR,30,82,6,58,64
52,8471214,Alex Ovechkin,L,WSH,39,82,34,29,63
52,8480208,Drake Batherson,R,OTT,26,82,30,33,63
52,8478414,Timo Meier,R,NJD,28,82,28,34,62
52,8471685,Anze Kopitar,C,LAK,37,82,25,37,62
52,8479385,Jordan Kyrou,C,STL,26,82,30,31,61
52,8476454,Ryan Nugent-Hopkins,C,EDM,31,82,19,42,61
52,8475810,Bryan Rust,R,PIT,32,82,29,31,60
52,8475172,Nazem Kadri,C,CGY,34,82,27,33,60
52,8475168,Matt Duchene,C,DAL,33,82,27,33,60
52,8477404,Jake Guentzel,C,CAR,30,82,26,34,60
52,8481528,Dylan Cozens,C,BUF,23,82,20,40,60
52,8477955,Jared McCann,L,SEA,28,82,29,30,59
52,8477940,Nikolaj Ehlers,L,WPG,28,82,27,32,59
52,8478398,Kyle Connor,L,WPG,28,82,22,37,59
52,8474141,Patrick Kane,R,DET,36,82,17,42,59
52,8479337,Alex DeBrincat,R,DET,27,82,26,32,58
52,8479343,Clayton Keller,R,ARI,26,82,25,33,58
52,8478042,Viktor Arvidsson,R,LAK,31,82,25,33,58
52,8480002,Nico Hischier,C,NJD,25,82,22,36,58
52,8479345,Jakob Chychrun,D,OTT,26,82,20,38,58
52,8476460,Mark Scheifele,C,WPG,31,82,19,39,58
52,8483445,Cutter Gauthier,L,ANA,20,82,12,46,58
52,8475784,Jeff Skinner,C,BUF,32,82,27,30,57
52,8480015,Owen Tippett,R,PHI,25,82,24,33,57
52,8470794,Joe Pavelski,C,DAL,40,82,22,35,57
52,8473512,Claude Giroux,R,OTT,36,82,17,40,57
52,8479325,Charlie McAvoy,D,BOS,27,82,7,50,57
52,8474679,Gustav Nyquist,C,NSH,35,82,19,37,56
52,8478233,Andrew Mangiapane,L,CGY,28,82,18,38,56
52,8478407,Vince Dunn,D,SEA,28,82,17,39,56
52,8480803,Evan Bouchard,D,EDM,25,82,11,45,56
52,8473986,Alex Killorn,L,ANA,35,82,24,31,55
52,8478438,Tommy Novak,C,NSH,27,82,22,33,55
52,8473994,Jamie Benn,L,DAL,35,82,22,33,55
52,8479323,Adam Fox,D,NYR,26,82,10,45,55
52,8478498,Jake DeBrusk,L,BOS,28,82,23,31,54
52,8480865,Noah Dobson,D,NYI,24,82,14,40,54
52,8477986,Brandon Montour,D,FLA,30,82,12,42,54
52,8477447,Shea Theodore,D,VGK,29,82,9,45,54
52,8480014,Gabriel Vilardi,C,WPG,25,82,31,22,53
52,8476483,Rickard Rakell,R,PIT,31,82,27,26,53
52,8477479,Tyler Bertuzzi,L,TOR,29,82,22,31,53
52,8477409,Carter Verhaeghe,C,FLA,29,82,21,32,53
52,8478449,Roope Hintz,C,DAL,28,82,21,32,53
52,8476881,Tomas Hertl,C,VGK,31,82,21,32,53
52,8476462,Dougie Hamilton,D,NJD,31,82,19,34,53
52,8478401,Pavel Zacha,C,BOS,27,82,17,36,53
52,8477504,Josh Morrissey,D,WPG,29,82,13,40,53
52,8479410,Mikhail Sergachev,D,TBL,26,82,6,47,53
52,8484144,Connor Bedard,C,CHI,19,82,28,24,52
52,8481068,Yegor Sharangovich,C,CGY,26,82,27,25,52
52,8475798,Mikael Granlund,C,SJS,32,82,17,35,52
52,8479675,Trevor Moore,L,LAK,29,82,16,36,52
52,8478469,Thomas Chabot,D,OTT,27,82,10,42,52
52,8479542,Brandon Hagel,L,TBL,26,82,25,26,51
52,8475158,Ryan O'Reilly,C,NSH,33,82,24,27,51
52,8475768,Jaden Schwartz,C,SEA,32,82,23,28,51
52,8477416,Oliver Bjorkstrand,R,SEA,29,82,21,30,51
52,8480039,Martin Necas,C,CAR,25,82,19,32,51
52,8477935,Sam Bennett,C,FLA,28,82,17,34,51
52,8476905,Chandler Stephenson,C,VGK,30,82,13,38,51
52,8474157,Max Pacioretty,L,WSH,36,82,27,23,50
52,8478519,Anthony Cirelli,C,TBL,27,82,24,26,50
52,8478856,Conor Garland,R,VAN,28,82,20,30,50
52,8478873,Troy Terry,R,ANA,27,82,18,32,50
52,8479400,Pierre-Luc Dubois,L,LAK,26,82,16,34,50
52,8479999,Casey Mittelstadt,C,COL,26,82,13,37,50
52,8478396,Noah Hanifin,D,VGK,27,82,10,40,50
52,8481542,Moritz Seider,D,DET,23,82,10,40,50
52,8482740,Wyatt Johnston,C,DAL,21,82,29,20,49
52,8482159,Tyson Foerster,R,PHI,22,82,25,24,49
52,8480078,Filip Chytil,C,NYR,25,82,18,31,49
52,8476882,Teuvo Teravainen,L,CAR,30,82,17,32,49
52,8480028,Morgan Frost,C,PHI,25,82,17,32,49
52,8478458,Jack Roslovic,C,NYR,27,82,17,32,49
52,8475170,Brayden Schenn,C,STL,33,82,16,33,49
52,8482684,Luke Hughes,D,NJD,21,82,15,34,49
52,8474150,Mikael Backlund,C,CGY,35,82,14,35,49
52,8477444,Andre Burakovsky,L,SEA,29,82,14,35,49
52,8478460,Zach Werenski,D,CBJ,27,82,13,36,49
52,8475726,Tyler Toffoli,C,WPG,32,82,27,21,48
52,8475151,Kyle Palmieri,C,NYI,33,82,27,21,48
52,8476826,Yanni Gourde,C,SEA,33,82,19,29,48
52,8482097,Jack Quinn,R,BUF,23,82,16,32,48
52,8476539,Jonathan Marchessault,R,VGK,34,82,30,17,47
52,8480064,Josh Norris,C,OTT,25,82,29,18,47
52,8475169,Evander Kane,L,EDM,33,82,23,24,47
52,8479339,Patrik Laine,L,CBJ,26,82,21,26,47
52,8482078,Lucas Raymond,L,DET,22,82,18,29,47
52,8474586,Jordan Eberle,R,SEA,34,82,14,33,47
52,8474565,Alex Pietrangelo,D,VGK,34,82,12,35,47
52,8482109,Alexis Lafrenière,L,NYR,23,82,26,20,46
52,8478115,Pierre Engvall,L,NYI,28,82,25,21,46
52,8477496,Elias Lindholm,C,VAN,30,82,24,22,46
52,8478975,Mason Marchment,L,DAL,29,82,19,27,46
52,8478542,Evan Rodrigues,C,FLA,31,82,16,30,46
52,8475764,Cam Fowler,D,ANA,33,82,8,38,46
52,8483397,Marc McLaughlin,C,BOS,25,82,42,3,45
52,8476432,Boone Jenner,C,CBJ,31,82,25,20,45
52,8476438,Brandon Saad,L,STL,32,82,23,22,45
52,8475765,Vladimir Tarasenko,R,FLA,33,82,22,23,45
52,8477407,Anthony Duclair,L,TBL,29,82,20,25,45
52,8476479,Phillip Danault,C,LAK,31,82,20,25,45
52,8482699,Dylan Guenther,R,ARI,21,82,19,26,45
52,8475745,Charlie Coyle,C,BOS,32,82,18,27,45
52,8476448,William Karlsson,C,VGK,31,82,17,28,45
52,8480434,Sean Durzi,D,ARI,26,82,13,32,45
52,8480031,Maxime Comtois,L,CAR,25,82,11,34,45
52,8481581,Thomas Harley,D,DAL,23,82,11,34,45
52,8475314,Anders Lee,L,NYI,34,82,23,20,43
52,8482146,Luke Evangelista,R,NSH,22,82,23,20,43
52,8475794,Tyler Seguin,C,DAL,32,82,22,21,43
52,8479525,Ross Colton,C,COL,28,82,20,23,43
52,8482475,Yegor Chinakhov,R,CBJ,23,82,20,23,43
52,8476399,Blake Coleman,C,CGY,33,82,20,23,43
52,8482055,Drew O'Connor,L,PIT,26,82,20,23,43
52,8477503,Max Domi,C,TOR,29,82,16,27,43
52,8476869,Brady Skjei,D,CAR,30,82,16,27,43
52,8478462,Nicolas Roy,C,VGK,27,82,15,28,43
52,8476458,Ryan Strome,C,ANA,31,82,13,30,43
52,8478038,Devon Toews,D,COL,30,82,12,31,43
52,8479425,Filip Hronek,D,VAN,27,82,10,33,43
52,8475197,Tyson Barrie,D,NSH,33,82,8,35,43
52,8476906,Shayne Gostisbehere,D,DET,31,82,7,36,43
52,8481016,Ruslan Iskhakov,C,NYI,24,82,6,37,43
52,8475167,Victor Hedman,D,TBL,34,82,5,38,43
52,8483457,Lane Hutson,D,MTL,20,82,5,38,43
52,8481699,Aku Raty,R,ARI,23,82,3,40,43
52,8478366,Frank Vatrano,R,ANA,30,82,26,16,42
52,8477451,Ryan Hartman,R,MIN,30,82,22,20,42
52,8482093,Seth Jarvis,C,CAR,22,82,21,21,42
52,8476880,Tom Wilson,R,WSH,30,82,19,23,42
52,8474102,David Perron,L,DET,36,82,17,25,42
52,8475791,Taylor Hall,L,CHI,33,82,17,25,42
52,8481533,Trevor Zegras,C,ANA,23,82,16,26,42
52,8476872,Scott Laughton,C,PHI,30,82,15,27,42
52,8479996,Cody Glass,C,NSH,25,82,15,27,42
52,8482122,Brock Faber,D,MIN,22,82,6,36,42
52,8477426,Nicholas Paul,L,TBL,29,82,20,21,41
52,8482222,Alexander Barabanov,L,SJS,30,82,20,21,41
52,8481711,Matias Maccelli,L,ARI,24,82,15,26,41
52,8476875,Mike Matheson,D,MTL,30,82,12,29,41
52,8477346,MacKenzie Weegar,D,CGY,30,82,8,33,41
52,8478397,Rasmus Andersson,D,CGY,28,82,8,33,41
52,8474590,John Carlson,D,WSH,34,82,7,34,41
52,8480817,K'Andre Miller,D,NYR,24,82,6,35,41
52,8484166,Adam Fantilli,C,CBJ,20,82,19,21,40
52,8477947,Sonny Milano,L,WSH,28,82,18,22,40
52,8478047,Michael Bunting,L,PIT,29,82,13,27,40
52,8480798,Philipp Kurashev,C,CHI,25,82,12,28,40
52,8482124,Quinton Byfield,R,LAK,22,82,10,30,40
52,8481703,Valtteri Puustinen,R,PIT,25,82,9,31,40
52,8481618,Alex Newhook,C,MTL,23,82,24,15,39
52,8482110,Dawson Mercer,C,NJD,23,82,23,16,39
52,8476469,Joel Armia,R,MTL,31,82,21,18,39
52,8480802,Ryan McLeod,C,EDM,25,82,18,21,39
52,8478463,Anthony Beauvillier,L,NSH,27,82,16,23,39
52,8482667,William Eklund,L,SJS,22,82,15,24,39
52,8476927,Teddy Blueger,C,VAN,30,82,10,29,39
52,8476979,Erik Gustafsson,D,NYR,32,82,6,33,39
52,8477998,Warren Foegele,L,EDM,28,82,23,15,38
52,8477476,Artturi Lehkonen,L,COL,29,82,21,17,38
52,8475760,Nick Bjugstad,C,ARI,32,82,21,17,38
52,8477944,Jakub Vrana,L,STL,28,82,20,18,38
52,8482101,Danil Gushchin,L,SJS,22,82,19,19,38
52,8477952,Robby Fabbri,C,DET,28,82,19,19,38
52,8475191,Reilly Smith,R,PIT,33,82,18,20,38
52,8483515,Juraj Slafkovsky,L,MTL,20,82,15,23,38
52,8479987,Morgan Geekie,C,BOS,26,82,14,24,38
52,8476329,Travis Boyd,C,ARI,31,82,13,25,38
52,8482113,Anton Lundell,C,FLA,23,82,12,26,38
52,8475753,Justin Faulk,D,STL,32,82,11,27,38
52,8477330,Dominik Kubalik,L,OTT,29,82,29,8,37
52,8481604,Pavel Dorofeyev,L,VGK,24,82,25,12,37
52,8478474,Lawson Crouse,L,ARI,27,82,20,17,37
52,8481596,Shane Pinto,C,OTT,24,82,18,19,37
52,8477989,Christian Dvorak,C,MTL,28,82,17,20,37
52,8481624,Ilya Mikheyev,R,VAN,30,82,17,20,37
52,8471698,T.J. Oshie,R,WSH,38,82,15,22,37
52,8480849,Barrett Hayton,C,ARI,24,82,15,22,37
52,8481535,Nils Hoglander,L,VAN,24,82,15,22,37
52,8470613,Brent Burns,D,CAR,39,82,14,23,37
52,8477948,Travis Sanheim,D,PHI,28,82,10,27,37
52,8474563,Drew Doughty,D,LAK,35,82,9,28,37
52,8474151,Ryan McDonagh,D,NSH,35,82,9,28,37
52,8478057,Dakota Joshua,C,VAN,28,82,19,17,36
52,8476292,Ondrej Palat,L,NJD,33,82,18,18,36
52,8481186,Logan O'Connor,R,COL,28,82,15,21,36
52,8477964,Ivan Barbashev,C,VGK,29,82,12,24,36
52,8471724,Kris Letang,D,PIT,37,82,9,27,36
52,8476854,Hampus Lindholm,D,BOS,30,82,3,33,36
52,8483471,Brad Lambert,C,WPG,31,82,2,34,36
52,8479365,Trent Frederic,C,BOS,26,82,19,16,35
52,8481560,Arthur Kaliyev,R,LAK,23,82,19,16,35
52,8480459,Pius Suter,C,VAN,28,82,16,19,35
52,8474037,James van Riemsdyk,L,BOS,35,82,16,19,35
52,8477456,J.T. Compher,L,DET,29,82,14,21,35
52,8482705,Cole Sillinger,C,CBJ,21,82,12,23,35
52,8477932,Aaron Ekblad,D,FLA,28,82,11,24,35
52,8478046,Danton Heinen,L,BOS,29,82,11,24,35
52,8477425,Miles Wood,L,COL,29,82,11,24,35
52,8476897,Oskar Sundqvist,C,STL,30,82,10,25,35
52,8476925,Colton Sissons,C,NSH,31,82,10,25,35
52,8479398,Samuel Girard,D,COL,26,82,8,27,35
52,8482720,Matthew Knies,L,TOR,22,82,8,27,35
52,8479423,Alex Nylander,L,CBJ,26,82,23,11,34
52,8482145,Mavrik Bourque,C,DAL,22,82,23,11,34
52,8481580,Connor McMichael,C,WSH,23,82,19,15,34
52,8480068,Ryan Poehling,C,PHI,25,82,16,18,34
52,8475744,Evgeny Kuznetsov,C,CAR,32,82,13,21,34
52,8477494,Jonathan Drouin,L,COL,29,82,9,25,34
52,8475763,Kevin Hayes,R,STL,32,82,7,27,34
52,8482089,Jake Neighbours,L,STL,22,82,18,15,33
52,8483431,Logan Cooley,C,ARI,20,82,17,16,33
52,8478109,Victor Olofsson,L,BUF,29,82,13,20,33
52,8479992,Michael Rasmussen,C,DET,25,82,13,20,33
52,8475722,Jason Zucker,L,NSH,32,82,12,21,33
52,8477497,Sean Monahan,C,WPG,30,82,11,22,33
52,8477506,Ryan Pulock,D,NYI,30,82,11,22,33
52,8476419,Jean-Gabriel Pageau,C,NYI,32,82,9,24,33
52,8483565,Nick Blankenburg,D,CBJ,26,82,9,24,33
52,8482105,Jake Sanderson,D,OTT,22,82,8,25,33
52,8481178,Egor Zamula,D,PHI,24,82,5,28,33
52,8474641,Adam Henrique,C,EDM,34,82,17,15,32
52,8475848,Brendan Gallagher,R,MTL,32,82,16,16,32
52,8475714,Calle Jarnkrok,C,TOR,33,82,15,17,32
52,8478466,Daniel Sprong,R,DET,27,82,14,18,32
52,8478569,Noel Acciari,C,PIT,33,82,14,18,32
52,8474870,Tyler Johnson,C,CHI,34,82,14,18,32
52,8474189,Lars Eller,C,PIT,35,82,14,18,32
52,8483808,Andrei Kuzmenko,L,CGY,28,82,13,19,32
52,8473422,Nick Foligno,L,CHI,37,82,13,19,32
52,8480188,Fabian Zetterlund,L,SJS,25,82,12,20,32
52,8480220,Noah Cates,L,PHI,25,82,12,20,32
52,8474053,Logan Couture,C,SJS,35,82,12,20,32
52,8482245,Artem Zub,D,OTT,29,82,11,21,32
52,8475231,Casey Cizikas,C,NYI,33,82,11,21,32
52,8477429,Andrew Copp,C,DET,30,82,10,22,32
52,8474149,Evgenii Dadonov,R,DAL,35,82,10,22,32
52,8476792,Torey Krug,D,STL,33,82,6,26,32
52,8476463,Jonas Brodin,D,MIN,31,82,5,27,32
52,8475218,Mattias Ekholm,D,EDM,34,82,5,27,32
52,8482175,JJ Peterka,R,BUF,22,82,18,13,31
52,8482702,Logan Stankoven,C,DAL,21,82,17,14,31
52,8470610,Zach Parise,L,COL,40,82,14,17,31
52,8471218,Blake Wheeler,R,NYR,38,82,13,18,31
52,8480871,Adam Boqvist,D,CBJ,24,82,13,18,31
52,8482079,Marco Rossi,C,MIN,23,82,12,19,31
52,8480185,Eetu Luostarinen,C,FLA,26,82,11,20,31
52,8476960,Andreas Athanasiou,C,CHI,30,82,10,21,31
52,8481546,Cam York,D,PHI,23,82,8,23,31
52,8476457,Adam Larsson,D,SEA,32,82,8,23,31
52,8478020,Michael Amadio,C,VGK,28,82,16,14,30
52,8473449,Kyle Okposo,R,FLA,36,82,15,15,30
52,8475287,Erik Haula,L,NJD,33,82,14,16,30
52,8479415,Michael McLeod,C,NJD,26,82,10,20,30
52,8473563,Nicklas Backstrom,C,WSH,37,82,10,20,30
52,8482092,Ridly Greig,C,OTT,22,82,8,22,30
52,8480336,Sean Walker,D,COL,30,82,7,23,30
52,8476958,Jaccob Slavin,D,CAR,30,82,5,25,30
52,8476892,Colton Parayko,D,STL,31,82,4,26,30
52,8483524,Shane Wright,C,SEA,20,82,18,11,29
52,8475799,Nino Niederreiter,R,WPG,32,82,18,11,29
52,8479390,Taylor Raddysh,R,CHI,26,82,16,13,29
52,8477953,Kasperi Kapanen,R,STL,28,82,15,14,29
52,8480893,Kirill Marchenko,R,CBJ,24,82,13,16,29
52,8477392,Hudson Fasching,R,NYI,29,82,13,16,29
52,8475220,Marcus Foligno,L,MIN,33,82,13,16,29
52,8476392,Adam Lowry,C,WPG,31,82,12,17,29
52,8480806,Isac Lundestrom,C,ANA,25,82,12,17,29
52,8481656,Aliaksei Protas,C,WSH,23,82,10,19,29
52,8480009,Eeli Tolvanen,R,SEA,25,82,7,22,29
52,8479514,Rem Pitlick,C,CHI,27,82,7,22,29
52,8478178,Darren Raddysh,D,TBL,28,82,7,22,29
52,8475906,John Klingberg,D,TOR,32,82,6,23,29
52,8474574,Tyler Myers,D,VAN,34,82,5,24,29
52,8483490,Pavel Mintyukov,D,ANA,21,82,4,25,29
52,8482733,Logan Mailloux,D,MTL,31,82,2,27,29
52,8482118,Sam Colangelo,R,ANA,23,82,23,5,28
52,8483493,Frank Nazar,C,CHI,20,82,19,9,28
52,8476873,Mark Jankowski,C,NSH,30,82,15,13,28
52,8479393,Noah Gregor,C,TOR,26,82,15,13,28
52,8480797,Joel Farabee,L,PHI,24,82,11,17,28
52,8478472,Mathieu Joseph,R,OTT,27,82,10,18,28
52,8478055,Gustav Forsling,D,FLA,28,82,8,20,28
52,8481014,Alexander Romanov,D,NYI,24,82,6,22,28
52,8476429,Scott Mayfield,D,NYI,32,82,6,22,28
52,8479293,Brandon Tanev,L,SEA,33,82,18,9,27
52,8475149,Marcus Johansson,L,MIN,34,82,15,12,27
52,8473533,Jordan Staal,C,CAR,36,82,13,14,27
52,8473453,Trevor Lewis,C,LAK,37,82,11,16,27
52,8477505,Alexander Wennberg,C,NYR,30,82,10,17,27
52,8476374,Sean Kuraly,C,CBJ,31,82,8,19,27
52,8483482,Tristan Luneau,D,ANA,20,82,7,20,27
52,8482671,Owen Power,D,BUF,22,82,6,21,27
52,8476923,Damon Severson,D,CBJ,30,82,6,21,27
52,8476422,Mike Reilly,D,NYI,31,82,6,21,27
52,8477507,Nikita Zadorov,D,VAN,29,82,4,23,27
52,8478508,Yakov Trenin,C,COL,27,82,16,10,26
52,8476878,Zemgus Girgensons,L,BUF,30,82,16,10,26
52,8477919,Frederick Gaudreau,C,MIN,31,82,14,12,26
52,8479941,Justin Danforth,R,CBJ,31,82,12,14,26
52,8481517,Brett Leason,R,ANA,25,82,12,14,26
52,8477511,Anthony Mantha,R,VGK,30,82,11,15,26
52,8481704,Juuso Parssinen,C,NSH,23,82,11,15,26
52,8477021,Alex Kerfoot,C,ARI,30,82,9,17,26
52,8476902,Esa Lindell,D,DAL,30,82,8,18,26
52,8476525,Colin Miller,D,WPG,32,82,7,19,26
52,8480043,Timothy Liljegren,D,TOR,25,82,6,20,26
52,8475181,Nick Leddy,D,STL,33,82,6,20,26
52,8482655,J.J. Moser,D,ARI,24,82,5,21,26
52,8481606,Jordan Spence,D,LAK,23,82,1,25,26
52,8480855,Jack McBain,C,ARI,24,82,15,10,25
52,8470621,Corey Perry,R,EDM,39,82,12,13,25
52,8475200,Dmitry Orlov,D,CAR,33,82,12,13,25
52,8478013,Jake Walman,D,DET,28,82,10,15,25
52,8482087,Kaiden Guhle,D,MTL,22,82,10,15,25
52,8482133,Thomas Bordeleau,C,SJS,22,82,9,16,25
52,8475343,Nic Dowd,C,WSH,34,82,9,16,25
52,8482624,Daniil Miromanov,D,CGY,27,82,9,16,25
52,8476931,Jake McCabe,D,TOR,31,82,9,16,25
52,8481013,Jonatan Berggren,R,DET,24,82,8,17,25
52,8478891,Mason Appleton,C,WPG,28,82,7,18,25
52,8475171,Oliver Ekman-Larsson,D,FLA,33,82,5,20,25
52,8477845,Trevor van Riemsdyk,D,WSH,33,82,5,20,25
52,8476891,Matt Grzelcyk,D,BOS,30,82,5,20,25
52,8478136,Jake Middleton,D,MIN,28,82,4,21,25
52,8479983,Mario Ferraro,D,SJS,26,82,3,22,25
52,8479346,Dillon Dube,C,CGY,26,82,16,8,24
52,8481553,Bobby Brink,R,PHI,23,82,15,9,24
52,8477498,Darnell Nurse,D,EDM,29,82,12,12,24
52,8481554,Kaapo Kakko,R,NYR,23,82,12,12,24
52,8481093,Rafael Harvey-Pinard,L,MTL,25,82,12,12,24
52,8475793,Ryan Johansen,C,PHI,32,82,11,13,24
52,8480821,Filip Zadina,R,SJS,25,82,10,14,24
52,8474715,Cam Atkinson,R,PHI,35,82,9,15,24
52,8482111,Justin Barron,D,MTL,23,82,9,15,24
52,8478413,Jordan Greenway,L,BUF,27,82,8,16,24
52,8476967,Brett Kulak,D,EDM,30,82,8,16,24
52,8478911,Matt Roy,D,LAK,29,82,7,17,24
52,8482073,Braden Schneider,D,NYR,23,82,7,17,24
52,8480035,Henri Jokiharju,D,BUF,25,82,7,17,24
52,8484145,Zach Benson,L,BUF,19,82,6,18,24
52,8483495,Simon Nemec,D,NJD,20,82,6,18,24
52,8475462,Radko Gudas,D,ANA,34,82,6,18,24
52,8474716,Jared Spurgeon,D,MIN,35,82,5,19,24
52,8476331,Dylan DeMelo,D,WPG,31,82,5,19,24
52,8480145,Neal Pionk,D,WPG,29,82,5,19,24
52,8478507,John Marino,D,NJD,27,82,5,19,24
52,8477435,Ryan Graves,D,PIT,29,82,5,19,24
52,8476885,Jacob Trouba,D,NYR,30,82,4,20,24
52,8479371,Dante Fabbro,D,NSH,26,82,4,20,24
52,8478500,Ivan Provorov,D,CBJ,27,82,3,21,24
52,8475324,Nick Jensen,D,WSH,34,82,3,21,24
52,8476917,Adam Pelech,D,NYI,30,82,1,23,24
52,8475842,Sam Carrick,C,EDM,32,82,15,8,23
52,8480113,Alex Iafallo,L,WPG,31,82,14,9,23
52,8474884,Mike Hoffman,C,SJS,35,82,13,10,23
52,8482074,Connor Zary,C,CGY,23,82,12,11,23
52,8470604,Jeff Carter,C,PIT,39,82,12,11,23
52,8484153,Leo Carlsson,C,ANA,20,82,11,12,23
52,8479977,Kailer Yamamoto,R,SEA,26,82,11,12,23
52,8474034,Pat Maroon,L,BOS,36,82,11,12,23
52,8483499,Liam Ohgren,L,MIN,20,82,9,14,23
52,8481522,Peyton Krebs,C,BUF,23,82,8,15,23
52,8477969,Marcus Pettersson,D,PIT,28,82,6,17,23
52,8478399,Jonas Siegenthaler,D,NJD,27,82,5,18,23
52,8480873,Rasmus Sandin,D,WSH,24,82,3,20,23
52,8482470,Ilya Solovyov,D,CGY,24,82,3,20,23
52,8478851,Alexandre Carrier,D,NSH,28,82,3,20,23
52,8477220,Nate Schmidt,D,WPG,33,82,3,20,23
52,8478840,Will Borgen,D,SEA,28,82,2,21,23
52,8476879,Cody Ceci,D,EDM,31,82,1,22,23
52,8477839,Conor Sheary,L,TBL,32,82,11,11,22
52,8477450,Jason Dickinson,C,CHI,29,82,11,11,22
52,8482737,Zack Bolduc,C,STL,21,82,11,11,22
52,8479661,Tanner Jeannot,L,TBL,27,82,10,12,22
52,8483491,Ivan Miroshnichenko,L,WSH,20,82,9,13,22
52,8481601,Simon Holmstrom,R,NYI,23,82,8,14,22
52,8480807,Mattias Samuelsson,D,BUF,24,82,7,15,22
52,8477488,Brett Pesce,D,CAR,30,82,6,16,22
52,8479980,Nicolas Hague,D,VGK,26,82,4,18,22
52,8482142,Jamie Drysdale,D,PHI,22,82,3,19,22
52,8475790,Erik Gudbranson,D,CBJ,32,82,2,20,22
52,8480246,Nick Perbix,D,TBL,26,82,1,21,22
52,8478043,Sam Lafferty,C,VAN,29,82,14,7,21
52,8478831,Kevin Stenlund,C,FLA,28,82,13,8,21
52,8479591,Michael Eyssimont,C,TBL,28,82,12,9,21
52,8476981,Josh Anderson,R,MTL,30,82,11,10,21
52,8480074,Alexandre Texier,C,CBJ,25,82,11,10,21
52,8477353,Tyler Motte,C,TBL,29,82,11,10,21
52,8476624,Barclay Goodrow,C,NYR,31,82,9,12,21
52,8476278,Colin Blackwell,C,CHI,31,82,7,14,21
52,8482062,Cole Smith,L,NSH,29,82,7,14,21
52,8477406,Mattias Janmark,C,EDM,32,82,6,15,21
52,8479351,Sam Steel,C,DAL,26,82,6,15,21
52,8476461,Sean Couturier,C,PHI,32,82,3,18,21
52,8475188,Brayden McNabb,D,VGK,33,82,2,19,21
52,8478882,Vladislav Gavrikov,D,LAK,29,82,2,19,21
52,8482125,Alexander Holtz,R,NJD,22,82,16,4,20
52,8480281,Alexey Toropchenko,R,STL,25,82,12,8,20
52,8481477,Nico Sturm,C,SJS,29,82,12,8,20
52,8480813,Joe Veleno,C,DET,24,82,11,9,20
52,8476480,Vladislav Namestnikov,C,WPG,32,82,9,11,20
52,8476921,Jordan Martinook,L,CAR,32,82,8,12,20
52,8477015,Connor Brown,R,EDM,30,82,8,12,20
52,8475762,Derek Forbort,D,BOS,32,82,6,14,20
52,8479353,Brett Howden,C,VGK,26,82,6,14,20
52,8480172,Jan Rutta,D,SJS,34,82,6,14,20
52,8475233,David Savard,D,MTL,34,82,5,15,20
52,8481059,Scott Perunovich,D,STL,26,82,5,15,20
52,8475164,Jakob Silfverberg,R,ANA,34,82,4,16,20
52,8482117,Lukas Reichel,L,CHI,22,82,4,16,20
52,8481568,Alex Vlasic,D,CHI,23,82,4,16,20
52,8479324,Ryan Lindgren,D,NYR,26,82,4,16,20
52,8479976,Juuso Valimaki,D,ARI,26,82,1,19,20
52,8474013,Ian Cole,D,VAN,35,82,1,19,20
52,8483012,Logan Morrison,C,SEA,22,82,11,8,19
52,8482155,Alex Laferriere,R,LAK,23,82,11,8,19
52,8483505,Matthew Poitras,C,BOS,20,82,8,11,19
52,8481481,Blake Lizotte,C,LAK,27,82,7,12,19
52,8481537,Nikita Okhotiuk,D,CGY,24,82,7,12,19
52,8475455,Brenden Dillon,D,WPG,34,82,7,12,19
52,8482730,Brandt Clarke,D,LAK,21,82,7,12,19
52,8476442,Matt Nieto,L,PIT,32,82,6,13,19
52,8480058,Pierre-Olivier Joseph,D,PIT,25,82,4,15,19
52,8480073,Erik Brannstrom,D,OTT,25,82,3,16,19
52,8470966,Mark Giordano,D,TOR,41,82,1,18,19
52,8477508,Curtis Lazar,C,NJD,29,82,11,7,18
52,8475279,Ben Chiarot,D,DET,33,82,10,8,18
52,8482809,Jackson Blake,R,CAR,21,82,10,8,18
52,8482679,Matt Coronato,R,CGY,22,82,8,10,18
52,8480448,Parker Kelly,L,OTT,25,82,7,11,18
52,8478430,Oliver Kylington,D,CGY,27,82,5,13,18
52,8474567,Zach Bogosian,D,MIN,34,82,4,14,18
52,8477369,Carson Soucy,D,VAN,30,82,4,14,18
52,8478443,Brandon Carlo,D,BOS,28,82,3,15,18
52,8483466,Kevin Korchinski,D,CHI,20,82,1,17,18
52,8484911,Collin Graf,R,SJS,22,82,1,17,18
52,8481524,Bowen Byram,D,BUF,23,82,8,9,17
52,8480980,Connor Dewar,C,TOR,25,82,8,9,17
52,8476858,Phillip Di Giuseppe,L,VAN,31,82,7,10,17
52,8479998,Mikey Anderson,D,LAK,25,82,6,11,17
52,8480834,Ty Emberson,D,SJS,24,82,5,12,17
52,8475825,Jani Hakanpää,D,DAL,32,82,5,12,17
52,8476467,Jamie Oleksiak,D,SEA,32,82,4,13,17
52,8479369,Andrew Peeke,D,BOS,26,82,4,13,17
52,8473507,Jeff Petry,D,DET,37,82,3,14,17
52,8480144,David Kampf,C,TOR,29,82,3,14,17
52,8470600,Ryan Suter,D,DAL,39,82,0,17,17
52,8478133,Jake Evans,C,MTL,28,82,10,6,16
52,8479316,Luke Kunin,C,SJS,27,82,9,7,16
52,8478408,Travis Dermott,D,ARI,28,82,8,8,16
52,8479442,Troy Stecher,D,EDM,30,82,7,9,16
52,8477931,Tomas Nosek,L,NJD,32,82,7,9,16
52,8480990,Declan Chisholm,D,MIN,24,82,7,9,16
52,8482259,Bobby McMann,C,TOR,28,82,6,10,16
52,8476312,Josh Manson,D,COL,33,82,5,11,16
52,8482712,Oskar Olausson,R,COL,22,82,4,12,16
52,8476871,Tanner Pearson,L,MTL,32,82,4,12,16
52,8480796,Martin Fehervary,D,WSH,25,82,4,12,16
52,8482166,Shakir Mukhamadullin,D,SJS,22,82,4,12,16
52,8474166,Alec Martinez,D,VGK,37,82,4,12,16
52,8478468,Jeremy Lauzon,D,NSH,27,82,4,12,16
52,8481567,Henry Thrun,D,SJS,23,82,3,13,16
52,8480879,Jacob Bernard-Docker,D,OTT,24,82,2,14,16
52,8484203,Bradly Nadeau,L,CAR,19,82,10,5,15
52,8482803,Olen Zellweger,D,ANA,21,82,4,11,15
52,8477499,Rasmus Ristolainen,D,PHI,30,82,3,12,15
52,8475179,Dmitry Kulikov,D,FLA,34,82,2,13,15
52,8475208,Brian Dumoulin,D,SEA,33,82,1,14,15
52,8474009,Nick Bonino,C,NYR,36,82,9,5,14
52,8478451,Ethan Bear,D,WSH,27,82,5,9,14
52,8475177,Calvin de Haan,D,TBL,33,82,4,10,14
52,8479383,Boris Katchouk,L,OTT,26,82,4,10,14
52,8482858,Ryker Evans,D,SEA,23,82,2,12,14
52,8474673,TJ Brodie,D,TOR,34,82,1,13,14
52,8475690,Chris Tanev,D,DAL,35,82,0,14,14
52,8471677,Jack Johnson,D,COL,37,82,0,14,14
52,8479359,Beck Malenstyn,L,WSH,26,82,7,6,13
52,8477335,Kyle Burroughs,D,SJS,29,82,5,8,13
52,8473504,Cal Clutterbuck,R,NYI,37,82,4,9,13
52,8481605,Jackson LaCombe,D,ANA,23,82,4,9,13
52,8482666,Scott Morrow,D,CAR,22,82,3,10,13
52,8478416,Erik Cernak,D,TBL,27,82,2,11,13
52,8478859,Niko Mikkola,D,FLA,28,82,2,11,13
52,8483763,Maksymilian Szuber,D,ARI,22,82,2,11,13
52,8476473,Connor Murphy,D,CHI,31,82,2,11,13
52,8477365,Connor Clifton,D,BUF,29,82,1,12,13
52,8481028,Martin Pospisil,C,CGY,25,82,7,5,12
52,8482807,Ethan Del Mastro,D,CHI,21,82,4,8,12
52,8484149,Gavin Brindley,C,CBJ,20,82,3,9,12
52,8481030,Jack St. Ivany,D,PIT,25,82,1,11,12
52,8477034,Jaycob Megna,D,CHI,32,82,0,12,12
52,8481578,Graeme Clarke,R,NJD,23,82,8,3,11
52,8482713,Mackie Samoskevich,R,FLA,22,82,8,3,11
52,8479291,Kevin Rooney,C,CGY,31,82,2,9,11
52,8482516,Matthew Kessel,D,STL,24,82,0,10,10
52,8476822,Luke Glendening,C,TBL,35,82,3,6,9
52,8481599,Victor Soderstrom,D,ARI,23,82,2,7,9
52,8480860,Kevin Bahl,D,NJD,24,82,0,9,9
52,8476915,Jujhar Khaira,L,MIN,30,82,3,5,8
52,8483468,Jiri Kulich,C,BUF,20,82,2,6,8
52,8476372,Nick Seeler,D,PHI,31,82,1,7,8
52,8482859,Zack Ostapchuk,C,OTT,21,82,0,8,8
52,8482762,Simon Edvinsson,D,DET,21,82,3,4,7
52,8482177,Marat Khusnutdinov,C,MIN,22,82,0,7,7
52,8483489,Fraser Minten,C,TOR,31,82,5,1,6
52,8482141,Lukas Cormier,D,VGK,22,0,0,0,0
52,8476988,Matt Benning,D,SJS,30,0,0,0,0
52,8480727,Zach Whitecloud,D,VGK,28,0,0,0,0
52,8480887,Jordan Harris,D,MTL,24,0,0,0,0
52,8478450,Parker Wotherspoon,D,BOS,27,0,0,0,0
52,8481812,Nikolai Knyzhov,D,SJS,27,0,0,0,0
52,8480001,Urho Vaakanainen,D,ANA,25,0,0,0,0
52,8482176,Wyatt Kaiser,D,CHI,22,0,0,0,0
52,8481122,Simon Benoit,D,TOR,26,0,0,0,0
52,8476441,Joel Edmundson,D,TOR,31,0,0,0,0
52,8480884,Calen Addison,D,SJS,24,0,0,0,0
52,8482511,Mason Lohrei,D,BOS,23,0,0,0,0
52,8482192,Isaak Phillips,D,CHI,23,0,0,0,0
52,8480950,Ilya Lyubushkin,D,TOR,30,0,0,0,0
52,8474031,Kevin Shattenkirk,D,BOS,35,0,0,0,0
52,8475718,Justin Holl,D,DET,32,0,0,0,0
52,8479402,Jake Bean,D,CBJ,26,0,0,0,0
52,8474602,Justin Schultz,D,SEA,34,0,0,0,0
52,8477950,Tony DeAngelo,D,CAR,29,0,0,0,0
52,8481743,Marc Del Gaizo,D,NSH,25,0,0,0,0
52,8481527,Kaedan Korczak,D,VGK,23,0,0,0,0
52,8480192,Johnathan Kovacevic,D,MTL,27,0,0,0,0
52,8476874,Olli Maatta,D,DET,30,0,0,0,0
52,8482144,Jack Thompson,D,SJS,22,0,0,0,0
52,8480222,Sebastian Aho,D,NYI,28,0,0,0,0
52,8479458,Nikita Zaitsev,D,CHI,33,0,0,0,0
52,8471709,Marc-Edouard Vlasic,D,SJS,37,0,0,0,0
52,8482929,Emil Lilleberg,D,TBL,23,0,0,0,0
52,8477018,Ben Hutton,D,VGK,31,0,0,0,0
52,8481056,Spencer Stastney,D,NSH,24,0,0,0,0
52,8481593,Jayden Struble,D,MTL,23,0,0,0,0
52,8479982,Conor Timmins,D,TOR,26,0,0,0,0
52,8474090,Brendan Smith,D,NJD,35,0,0,0,0
52,8482964,Arber Xhekaj,D,MTL,23,0,0,0,0
52,8480891,Michael Kesselring,D,ARI,24,0,0,0,0
52,8477938,Haydn Fleury,D,TBL,28,0,0,0,0
52,8481806,Louis Crevier,D,CHI,23,0,0,0,0
52,8471274,Alex Goligoski,D,MIN,39,0,0,0,0
52,8481600,Tobias Bjornfot,D,FLA,23,0,0,0,0
52,8475797,Jarred Tinordi,D,CHI,32,0,0,0,0
52,8481521,Ronnie Attard,D,PHI,25,0,0,0,0
52,8474612,Travis Hamonic,D,OTT,34,0,0,0,0
52,8479576,Vincent Desharnais,D,EDM,28,0,0,0,0
52,8480049,Dylan Samberg,D,WPG,25,0,0,0,0
52,8483619,Filip Roos,D,CHI,25,0,0,0,0
52,8474568,Luke Schenn,D,NSH,35,0,0,0,0
52,8480184,Gustav Lindstrom,D,ANA,26,0,0,0,0
52,8480070,Ian Mitchell,D,BOS,25,0,0,0,0
52,8480196,Jacob Bryson,D,BUF,27,0,0,0,0
52,8471686,Marc Staal,D,PHI,37,0,0,0,0
52,8477467,Gustav Olofsson,D,SEA,30,0,0,0,0
52,8478970,Jalen Chatfield,D,CAR,28,0,0,0,0
52,8479348,Kale Clague,D,BUF,26,0,0,0,0
52,8473446,Erik Johnson,D,PHI,36,0,0,0,0
52,8477462,Robert Hagg,D,ANA,29,0,0,0,0
52,8478454,Noah Juulsen,D,VAN,27,0,0,0,0
52,8477384,Josh Brown,D,ARI,30,0,0,0,0
52,8481708,Zac Jones,D,NYR,24,0,0,0,0
52,8481167,Brayden Pachal,D,CGY,25,0,0,0,0
52,8482067,Connor Mackey,D,NYR,28,0,0,0,0
52,8483460,David Jiricek,D,CBJ,21,0,0,0,0
52,8481701,Santeri Hatakka,D,NJD,23,0,0,0,0
52,8478021,William Lagesson,D,ANA,28,0,0,0,0
52,8477851,Jordan Oesterle,D,CGY,32,0,0,0,0
52,8478452,Caleb Jones,D,COL,27,0,0,0,0
52,8479984,Cal Foote,D,NJD,26,0,0,0,0
52,8479639,Dylan Coghlan,D,CAR,26,0,0,0,0
52,8480874,Adam Ginning,D,PHI,24,0,0,0,0
52,8479321,Lucas Johansen,D,WSH,27,0,0,0,0
52,8480878,Nils Lundkvist,D,DAL,24,0,0,0,0
52,8482165,Yan Kuznetsov,D,CGY,22,0,0,0,0
52,8484258,Sam Malinski,D,COL,26,0,0,0,0
52,8480157,Calle Rosen,D,STL,30,0,0,0,0
52,8484304,Uvis Balinskis,D,FLA,28,0,0,0,0
52,8479985,Cale Fleury,D,SEA,26,0,0,0,0
52,8479378,Logan Stanley,D,WPG,26,0,0,0,0
52,8477541,Dakota Mermis,D,MIN,30,0,0,0,0
52,8481609,Vladislav Kolyachonok,D,ARI,23,0,0,0,0
52,8480823,Alexander Alexeyev,D,WSH,25,0,0,0,0
52,8481679,Maxence Guenette,D,OTT,23,0,0,0,0
52,8481564,Ryan Johnson,D,BUF,23,0,0,0,0
52,8479376,Victor Mete,D,PHI,26,0,0,0,0
52,8484254,Akito Hirose,D,VAN,25,0,0,0,0
52,8482660,Kent Johnson,C,CBJ,22,0,0,0,0
52,8482149,Cole Perfetti,C,WPG,22,0,0,0,0
52,8477987,Ryan Donato,C,CHI,28,0,0,0,0
52,8475755,Alexander Petrovic,D,DAL,32,0,0,0,0
52,8477810,Joel Hanley,D,CGY,33,0,0,0,0
52,8474145,Robert Bortuzzo,D,NYI,35,0,0,0,0
52,8481161,Jake Christiansen,D,CBJ,25,0,0,0,0
52,8476884,Derrick Pouliot,D,DAL,30,0,0,0,0
52,8481716,Dmitri Voronkov,L,CBJ,24,0,0,0,0
52,8480084,Nick DeSimone,D,NJD,30,0,0,0,0
52,8475750,Jon Merrill,D,MIN,32,0,0,0,0
52,8479315,Joey Anderson,R,CHI,26,0,0,0,0
52,8478011,Louie Belpedio,D,PHI,28,0,0,0,0
52,8482451,Mikael Pyyhtia,L,CBJ,23,0,0,0,0
52,8481541,Samuel Bolduc,D,NYI,24,0,0,0,0
52,8482126,Emil Andrae,D,PHI,31,0,0,0,0
52,8474618,Marco Scandella,D,STL,34,0,0,0,0
52,8477244,Chad Ruhwedel,D,NYR,34,0,0,0,0
52,8477971,Andreas Englund,D,LAK,28,0,0,0,0
52,8480829,Jesperi Kotkaniemi,C,CAR,24,0,0,0,0
52,8479372,Josh Mahura,D,FLA,26,0,0,0,0
52,8482095,Tyler Kleven,D,OTT,22,0,0,0,0
52,8481719,Maxwell Crozier,D,TBL,24,0,0,0,0
52,8475855,Jesper Fast,R,CAR,33,0,0,0,0
52,8480848,Ty Dellandrea,C,DAL,24,0,0,0,0
52,8475193,Tomas Tatar,L,SEA,34,0,0,0,0
52,8476889,Radek Faksa,C,DAL,30,0,0,0,0
52,8478495,Denis Gurianov,R,PHI,27,0,0,0,0
52,8480216,Jacob Peterson,C,SJS,25,0,0,0,0
52,8480252,Cole Guttman,C,CHI,25,0,0,0,0
52,8479026,Philippe Myers,D,TBL,27,0,0,0,0
52,8481006,Tyler Tucker,D,STL,24,0,0,0,0
52,8481032,Paul Cotter,C,VGK,25,0,0,0,0
52,8481577,Philip Tomasino,C,NSH,23,0,0,0,0
52,8476918,Jimmy Vesey,L,NYR,31,0,0,0,0
52,8479320,Max Lajoie,D,TOR,27,0,0,0,0
52,8478017,Mark Friedman,D,VAN,29,0,0,0,0
52,8481754,Nikita Nesterenko,C,ANA,23,0,0,0,0
52,8483407,Brandon Scanlin,D,NYR,25,0,0,0,0
52,8482659,Josh Doan,R,ARI,22,0,0,0,0
52,8477446,Michael McCarron,R,NSH,29,0,0,0,0
52,8477903,Garnet Hathaway,R,PHI,33,0,0,0,0
52,8482153,Brendan Brisson,C,VGK,23,0,0,0,0
52,8483546,Marshall Rifai,D,TOR,26,0,0,0,0
52,8484287,Cole McWard,D,VAN,23,0,0,0,0
52,8478854,Ryan Shea,D,PIT,27,0,0,0,0
52,8481585,Egor Afanasyev,L,NSH,23,0,0,0,0
52,8483398,Declan Carlile,D,TBL,31,0,0,0,0
52,8478502,Dennis Gilbert,D,CGY,28,0,0,0,0
52,8482749,Joshua Roy,R,MTL,21,0,0,0,0
52,8481598,Philip Broberg,D,EDM,23,0,0,0,0
52,8480835,Jack Drury,C,CAR,24,0,0,0,0
52,8480748,Kiefer Sherwood,L,NSH,29,0,0,0,0
52,8476934,Brock McGinn,L,ANA,30,0,0,0,0
52,8480870,Bo Groulx,C,ANA,24,0,0,0,0
52,8479368,Max Jones,L,ANA,26,0,0,0,0
52,8478099,Kevin Labanc,R,SJS,29,0,0,0,0
52,8478067,Oskar Lindblom,L,SJS,28,0,0,0,0
52,8476393,Nick Cousins,C,FLA,31,0,0,0,0
52,8483395,Arshdeep Bains,L,VAN,23,0,0,0,0
52,8480762,Eric Robinson,L,BUF,29,0,0,0,0
52,8479439,Jacob MacDonald,D,SJS,31,0,0,0,0
52,8476474,Stefan Noesen,R,CAR,31,0,0,0,0
52,8482787,Nikita Chibrikov,R,WPG,31,0,0,0,0
52,8478432,Christian Fischer,R,DET,27,0,0,0,0
52,8477979,Nicolas Aube-Kubel,R,WSH,28,0,0,0,0
52,8481789,Tye Kartye,L,SEA,23,0,0,0,0
52,8479330,Brandon Gignac,C,MTL,27,0,0,0,0
52,8480075,Cameron Crotty,D,ARI,25,0,0,0,0
52,8473473,Milan Lucic,L,BOS,36,0,0,0,0
52,8482094,Daemon Hunt,D,MIN,22,0,0,0,0
52,8481206,John Ludvig,D,PIT,24,0,0,0,0
52,8483630,Pavol Regenda,L,ANA,25,0,0,0,0
52,8481617,Vasily Podkolzin,R,VAN,23,0,0,0,0
52,8480306,Grant Hutton,D,NYI,29,0,0,0,0
52,8480995,Pontus Holmberg,R,TOR,25,0,0,0,0
52,8482148,Hendrix Lapierre,C,WSH,22,0,0,0,0
52,8477478,William Carrier,L,VGK,30,0,0,0,0
52,8480003,Jesper Boqvist,C,BOS,26,0,0,0,0
52,8482172,Landon Slaggert,L,CHI,22,0,0,0,0
52,8480789,Oliver Wahlstrom,R,NYI,24,0,0,0,0
52,8474062,Riley Nash,C,NYR,35,0,0,0,0
52,8480021,Jack Studnicka,C,SJS,25,0,0,0,0
52,8480025,MacKenzie Entwistle,R,CHI,25,0,0,0,0
52,8481582,Nicholas Robertson,L,TOR,23,0,0,0,0
52,8476867,Brendan Gaunce,C,CBJ,30,0,0,0,0
52,8479619,Michael Carcone,L,ARI,28,0,0,0,0
52,8479370,Tyson Jost,C,BUF,26,0,0,0,0
52,8479671,Mathieu Olivier,R,CBJ,27,0,0,0,0
52,8476994,Vinnie Hinostroza,C,PIT,30,0,0,0,0
52,8482070,Mitchell Chaffee,R,TBL,26,0,0,0,0
52,8477473,Justin Bailey,R,SJS,29,0,0,0,0
52,8479344,Jesse Puljujarvi,R,PIT,26,0,0,0,0
52,8480205,Emil Bemstrom,C,PIT,25,0,0,0,0
52,8479718,Alex Barré-Boulet,C,TBL,27,0,0,0,0
52,8482061,Brandon Biro,L,BUF,26,0,0,0,0
52,8479638,Justin Brazeau,R,BOS,26,0,0,0,0
52,8474040,Sam Gagner,C,EDM,35,0,0,0,0
52,8477846,Ryan Carpenter,C,SJS,33,0,0,0,0
52,8482077,Dylan Holloway,L,EDM,23,0,0,0,0
52,8482157,Will Cuylle,L,NYR,22,0,0,0,0
52,8480007,Jonas Rondbjerg,R,VGK,25,0,0,0,0
52,8478874,Adam Gaudette,C,STL,28,0,0,0,0
52,8478434,Keegan Kolesar,R,VGK,27,0,0,0,0
52,8480441,Trey Fix-Wolansky,R,CBJ,25,0,0,0,0
52,8479994,Jaret Anderson-Dolan,C,NSH,25,0,0,0,0
52,8483567,Georgii Merkulov,C,BOS,24,0,0,0,0
52,8477380,Jonny Brodzinski,C,NYR,31,0,0,0,0
52,8482201,Gage Goncalves,C,TBL,23,0,0,0,0
52,8478211,Dryden Hunt,L,CGY,29,0,0,0,0
52,8471699,Andrew Cogliano,C,COL,37,0,0,0,0
52,8479421,Jacob Moverare,D,LAK,26,0,0,0,0
52,8478881,Brett Seney,L,CHI,28,0,0,0,0
52,8477464,Nic Petan,C,MIN,29,0,0,0,0
52,8475958,Michael Sgarbossa,C,WSH,32,0,0,0,0
52,8481147,Reese Johnson,C,CHI,26,0,0,0,0
52,8479336,Carl Grundstrom,R,LAK,27,0,0,0,0
52,8480853,Liam Foudy,C,NSH,24,0,0,0,0
52,8479522,Hardy Haman Aktell,D,WSH,26,0,0,0,0
52,8481462,Mason Morelli,L,VGK,28,0,0,0,0
52,8482102,Vasily Ponomarev,C,CAR,22,0,0,0,0
52,8480844,Grigori Denisenko,L,VGK,24,0,0,0,0
52,8479944,Zach Aston-Reese,C,DET,30,0,0,0,0
52,8482784,Zach Dean,C,STL,21,0,0,0,0
52,8479419,Brett Murray,L,BUF,26,0,0,0,0
52,8479520,Brandon Duhaime,R,COL,27,0,0,0,0
52,8477573,Nathan Walker,L,STL,30,0,0,0,0
52,8478078,Rourke Chartier,C,OTT,28,0,0,0,0
52,8475795,Dylan McIlrath,D,WSH,32,0,0,0,0
52,8482496,Nils Aman,C,VAN,24,0,0,0,0
52,8480289,Morgan Barron,C,WPG,26,0,0,0,0
52,8481751,Lukas Rousek,R,BUF,25,0,0,0,0
52,8480011,Klim Kostin,C,SJS,25,0,0,0,0
52,8481556,John Beecher,C,BOS,23,0,0,0,0
52,8475278,Byron Froese,C,VGK,33,0,0,0,0
52,8475225,Craig Smith,C,DAL,35,0,0,0,0
52,8484326,Patrik Koch,D,ARI,28,0,0,0,0
52,8477930,Pierre-Edouard Bellemare,L,SEA,39,0,0,0,0
52,8478409,Anthony Richard,C,BOS,28,0,0,0,0
52,8481024,Linus Karlsson,C,VAN,25,0,0,0,0
52,8479986,Kole Lind,R,SEA,26,0,0,0,0
52,8479414,Nathan Bastian,R,NJD,27,0,0,0,0
52,8479362,Riley Tufte,L,COL,26,0,0,0,0
52,8481058,Jesse Ylönen,R,MTL,25,0,0,0,0
52,8482476,Emil Heineman,L,MTL,23,0,0,0,0
52,8482861,Vincent Iorio,D,WSH,22,0,0,0,0
52,8483432,Luca Del Bel Belluz,C,CBJ,31,0,0,0,0
52,8482744,James Malatesta,L,CBJ,21,0,0,0,0
52,8477887,Patrick Brown,C,BOS,32,0,0,0,0
52,8478585,Derek Ryan,C,EDM,38,0,0,0,0
52,8481441,Joe Snively,C,WSH,28,0,0,0,0
52,8481592,Jakob Pelletier,L,CGY,23,0,0,0,0
52,8482634,Alex Steeves,C,TOR,25,0,0,0,0
52,8477126,Jayson Megna,C,BOS,34,0,0,0,0
52,8475752,Tyler Pitlick,C,NYR,33,0,0,0,0
52,8480008,Adam Ruzicka,C,ARI,25,0,0,0,0
52,8481065,Angus Crookshank,L,OTT,25,0,0,0,0
52,8479547,Matthew Phillips,R,WSH,26,0,0,0,0
52,8480226,Marián Studenic,R,SEA,26,0,0,0,0
52,8481237,Kyle MacLean,C,NYI,25,0,0,0,0
52,8475413,Justin Dowling,C,NJD,34,0,0,0,0
52,8481641,Joel Kiviranta,L,COL,28,0,0,0,0
52,8478104,Sammy Blais,L,STL,28,0,0,0,0
52,8477454,Adam Erne,L,EDM,29,0,0,0,0
52,8481518,Nolan Foote,L,NJD,24,0,0,0,0
52,8480245,Olle Lycksell,R,PHI,25,0,0,0,0
52,8483570,Ben Meyers,C,ANA,26,0,0,0,0
52,8480776,Sheldon Rempal,R,VGK,29,0,0,0,0
52,8483920,Pierrick Dube,R,WSH,23,0,0,0,0
52,8480267,Sammy Walker,C,MIN,25,0,0,0,0
52,8482747,Brennan Othmann,L,NYR,21,0,0,0,0
52,8479991,Jake Leschyshyn,C,NYR,25,0,0,0,0
52,8478400,Colin White,C,MTL,27,0,0,0,0
52,8479328,Julien Gauthier,R,NYI,27,0,0,0,0
52,8484325,Waltteri Merela,C,TBL,26,0,0,0,0
52,8479066,Ryan Lomberg,L,FLA,30,0,0,0,0
52,8477070,Liam O'Brien,C,ARI,30,0,0,0,0
52,8478146,Matthew Highmore,C,OTT,28,0,0,0,0
52,8478028,Fredrik Olofsson,L,COL,28,0,0,0,0
52,8480880,Jakub Lauko,C,BOS,24,0,0,0,0
52,8479968,Vinni Lettieri,C,MIN,29,0,0,0,0
52,8474709,Matt Martin,L,NYI,35,0,0,0,0
52,8480845,Rasmus Kupari,C,WPG,24,0,0,0,0
52,8481550,Adam Beckman,L,MIN,23,0,0,0,0
52,8481422,Jacob Lucchini,C,MIN,29,0,0,0,0
52,8477401,John Hayden,C,SEA,29,0,0,0,0
52,8478904,Steven Lorentz,C,FLA,28,0,0,0,0
52,8482088,Justin Sourdif,R,FLA,22,0,0,0,0
52,8482751,Ryan Winterton,C,SEA,21,0,0,0,0
52,8482241,Radim Zohorna,L,PIT,28,0,0,0,0
52,8481690,Tyler Angle,C,CBJ,24,0,0,0,0
52,8476952,Dominic Toninato,C,WPG,30,0,0,0,0
52,8476919,Chris Tierney,C,NJD,30,0,0,0,0
52,8480032,Shane Bowers,C,NJD,25,0,0,0,0
52,8484314,Jiri Smejkal,L,OTT,28,0,0,0,0
52,8481239,Samuel Fagemo,L,LAK,24,0,0,0,0
52,8481532,Alex Turcotte,C,LAK,23,0,0,0,0
52,8481019,David Gustafsson,C,WPG,24,0,0,0,0
52,8478477,Mitchell Stephens,C,MTL,27,0,0,0,0
52,8479546,Oskar Steen,C,BOS,26,0,0,0,0
52,8480292,Carson Meyer,R,CBJ,27,0,0,0,0
52,8478446,Glenn Gawdin,C,ANA,27,0,0,0,0
52,8483531,Brian Halonen,L,NJD,25,0,0,0,0
52,8477149,Scott Sabourin,R,SJS,32,0,0,0,0
52,8479972,Mason Shaw,C,MIN,26,0,0,0,0
52,8480890,Jan Jenik,R,ARI,24,0,0,0,0
52,8478051,Max Willman,C,NJD,29,0,0,0,0
52,8480851,Akil Thomas,C,LAK,24,0,0,0,0
52,8482765,Isak Rosen,R,BUF,21,0,0,0,0
52,8478421,A.J. Greer,L,CGY,28,0,0,0,0
52,8478512,Austin Czarnik,C,DET,32,0,0,0,0
52,8479536,Axel Jonsson-Fjallby,L,WPG,26,0,0,0,0
52,8477320,Anton Blidh,L,NYR,29,0,0,0,0
52,8481543,Nikita Alexandrov,C,STL,24,0,0,0,0
52,8475235,Nicolas Deslauriers,L,PHI,33,0,0,0,0
52,8481070,Hugh McGing,L,STL,26,0,0,0,0
52,8480836,Jonathan Gruden,C,PIT,24,0,0,0,0
52,8481591,Sam Poulin,R,PIT,23,0,0,0,0
52,8477962,Brendan Lemieux,L,CAR,28,0,0,0,0
52,8483401,Marc Johnstone,R,PIT,28,0,0,0,0
52,8482250,Callahan Burke,C,CAR,27,0,0,0,0
52,8481726,Adam Edstrom,C,NYR,24,0,0,0,0
52,8471817,Ryan Reaves,R,TOR,37,0,0,0,0
52,8479587,Rhett Gardner,C,PHI,28,0,0,0,0
52,8475766,Austin Watson,L,TBL,32,0,0,0,0
52,8479367,William Lockwood,R,FLA,26,0,0,0,0
52,8478424,Jansen Harkins,C,PIT,27,0,0,0,0
52,8476913,Devin Shore,C,SEA,30,0,0,0,0
52,8482652,Walker Duehr,R,CGY,27,0,0,0,0
52,8477527,Ross Johnston,L,ANA,30,0,0,0,0
52,8481077,John Leonard,L,ARI,26,0,0,0,0
52,8483549,Lucas Condotta,L,MTL,27,0,0,0,0
52,8480468,James Hamblin,L,EDM,25,0,0,0,0
52,8476907,Mackenzie MacEachern,L,STL,30,0,0,0,0
52,8479543,Michael Pezzetta,L,MTL,26,0,0,0,0
52,8480355,Mark Kastelic,C,OTT,25,0,0,0,0
52,8482162,Roby Jarventie,L,OTT,22,0,0,0,0
52,8479772,Zack MacEwen,R,OTT,28,0,0,0,0
52,8483597,Milos Kelemen,L,ARI,25,0,0,0,0
52,8479379,Givani Smith,R,SJS,26,0,0,0,0
52,8481655,Cole Schwindt,R,CGY,23,0,0,0,0
52,8479981,Jonah Gadjovich,L,FLA,26,0,0,0,0
52,8482147,Jean-Luc Foudy,C,COL,22,0,0,0,0
52,8484255,Jason Polin,R,COL,25,0,0,0,0
52,8477993,Justin Kirkland,C,ARI,28,0,0,0,0
52,8479249,Andrew Poturalski,C,SEA,30,0,0,0,0
52,8482197,Adam Raska,R,MIN,23,0,0,0,0
52,8475780,Chris Wagner,R,COL,33,0,0,0,0
52,8479533,Joona Koppanen,L,PIT,26,0,0,0,0
52,8481534,Raphael Lavoie,C,EDM,24,0,0,0,0
52,8484321,Nikolas Matinpalo,D,OTT,26,0,0,0,0
52,8481043,Cole Koepke,L,TBL,26,0,0,0,0
52,8476323,Max McCormick,L,SEA,32,0,0,0,0
52,8483609,Adam Klapka,R,CGY,24,0,0,0,0
52,8483512,Matt Savoie,C,BUF,20,0,0,0,0
52,8484259,Ondrej Pavel,C,COL,31,0,0,0,0
52,8478147,Bokondji Imama,L,OTT,28,0,0,0,0
52,8482460,Matt Rempe,C,NYR,22,0,0,0,0
52,8477073,Kurtis MacDermid,L,NJD,30,0,0,0,0
52,8480274,Philip Kemp,D,EDM,25,0,0,0,0
52,8478956,Samuel Laberge,L,NJD,27,0,0,0,0
52,8483045,Cameron Butler,R,CBJ,31,0,0,0,0
