Simulation,PlayerID,Player,Position,Team,Age,Games Played,Goals,Assists,Points
1,8478402,Connor McDavid,C,EDM,27,80,47,121,168
1,8476453,Nikita Kucherov,R,TBL,31,82,51,81,132
1,8479318,Auston Matthews,C,TOR,27,79,66,61,127
1,8477492,Nathan MacKinnon,C,COL,29,80,44,77,121
1,8478483,Mitch Marner,R,TOR,27,80,35,82,117
1,8477956,David Pastrnak,R,BOS,28,82,60,49,109
1,8480027,Jason Robertson,L,DAL,25,81,44,64,108
1,8481559,Jack Hughes,C,NJD,23,76,39,65,104
1,8478420,Mikko Rantanen,R,COL,28,82,50,53,103
1,8478864,Kirill Kaprizov,L,MIN,27,70,41,60,101
1,8475172,Nazem Kadri,C,CGY,34,79,38,63,101
1,8478427,Sebastian Aho,C,CAR,27,74,47,48,95
1,8477960,Adrian Kempe,R,LAK,28,80,40,55,95
1,8478550,Artemi Panarin,L,NYR,33,75,38,57,95
1,8477934,Leon Draisaitl,C,EDM,29,81,42,52,94
1,8477939,William Nylander,R,TOR,28,79,39,55,94
1,8480801,Brady Tkachuk,L,OTT,25,81,39,55,94
1,8477493,Aleksander Barkov,C,FLA,29,82,26,68,94
1,8480023,Robert Thomas,C,STL,25,75,29,63,92
1,8481557,Matt Boldy,L,MIN,23,76,35,56,91
1,8471675,Sidney Crosby,C,PIT,37,73,38,52,90
1,8478445,Mathew Barzal,C,NYI,27,81,24,66,90
1,8480800,Quinn Hughes,D,VAN,25,77,16,74,90
1,8475166,John Tavares,C,TOR,34,81,41,47,88
1,8476468,J.T. Miller,C,VAN,31,77,38,49,87
1,8476887,Filip Forsberg,L,NSH,30,72,33,54,87
1,8477404,Jake Guentzel,C,TBL,30,82,33,54,87
1,8478449,Roope Hintz,C,DAL,28,82,35,51,86
1,8479323,Adam Fox,D,NYR,26,78,16,70,86
1,8479314,Matthew Tkachuk,L,FLA,27,77,26,59,85
1,8476456,Jonathan Huberdeau,C,CGY,31,80,16,69,85
1,8475913,Mark Stone,R,VGK,32,76,34,50,84
1,8482116,Tim Stützle,C,OTT,22,80,30,54,84
1,8484144,Connor Bedard,C,CHI,19,71,27,57,84
1,8477942,Kevin Fiala,L,LAK,28,81,30,52,82
1,8476459,Mika Zibanejad,C,NYR,31,74,25,56,81
1,8477409,Carter Verhaeghe,C,FLA,29,79,40,40,80
1,8479343,Clayton Keller,R,UTA,26,80,33,46,79
1,8473512,Claude Giroux,R,OTT,36,80,29,50,79
1,8471214,Alex Ovechkin,L,WSH,39,70,36,42,78
1,8479407,Jesper Bratt,L,NJD,26,76,27,51,78
1,8478873,Troy Terry,R,ANA,27,75,38,39,77
1,8476389,Vincent Trocheck,C,NYR,31,79,27,49,76
1,8476454,Ryan Nugent-Hopkins,C,EDM,31,81,14,62,76
1,8477501,Valeri Nichushkin,R,COL,29,81,38,37,75
1,8478010,Brayden Point,C,TBL,28,82,34,40,74
1,8474564,Steven Stamkos,C,NSH,34,74,28,46,74
1,8475692,Mats Zuccarello,R,MIN,37,74,17,57,74
1,8477933,Sam Reinhart,C,FLA,29,80,34,39,73
1,8471215,Evgeni Malkin,C,PIT,38,77,24,49,73
1,8476881,Tomas Hertl,C,VGK,31,78,33,39,72
1,8474600,Roman Josi,D,NSH,34,76,21,51,72
1,8478403,Jack Eichel,C,VGK,28,78,41,30,71
1,8479420,Tage Thompson,C,BUF,27,75,36,35,71
1,8477955,Jared McCann,L,SEA,28,74,34,37,71
1,8473419,Brad Marchand,L,BOS,36,78,33,38,71
1,8476460,Mark Scheifele,C,WPG,31,73,29,42,71
1,8482093,Seth Jarvis,C,CAR,22,74,29,42,71
1,8479337,Alex DeBrincat,R,DET,27,82,36,34,70
1,8475810,Bryan Rust,R,PIT,32,72,33,37,70
1,8477946,Dylan Larkin,C,DET,28,81,32,38,70
1,8475168,Matt Duchene,C,DAL,33,79,28,42,70
1,8474141,Patrick Kane,R,DET,36,82,24,46,70
1,8480069,Cale Makar,D,COL,26,66,21,49,70
1,8480036,Miro Heiskanen,D,DAL,25,78,17,53,70
1,8474578,Erik Karlsson,D,PIT,34,79,17,53,70
1,8481540,Cole Caufield,R,MTL,23,75,35,33,68
1,8478439,Travis Konecny,R,PHI,27,75,30,38,68
1,8480012,Elias Pettersson,C,VAN,26,75,29,39,68
1,8478460,Zach Werenski,D,CBJ,27,79,18,50,68
1,8476539,Jonathan Marchessault,R,NSH,34,72,41,26,67
1,8478414,Timo Meier,R,NJD,28,70,36,31,67
1,8478444,Brock Boeser,R,VAN,27,79,31,36,67
1,8480208,Drake Batherson,R,OTT,26,78,26,41,67
1,8478398,Kyle Connor,L,WPG,28,73,26,41,67
1,8480018,Nick Suzuki,C,MTL,25,69,22,45,67
1,8475726,Tyler Toffoli,C,SJS,32,70,36,30,66
1,8477500,Bo Horvat,C,NYI,29,81,36,30,66
1,8480002,Nico Hischier,C,NJD,25,72,31,35,66
1,8482740,Wyatt Johnston,C,DAL,21,82,30,36,66
1,8475158,Ryan O'Reilly,C,NSH,33,74,27,39,66
1,8475167,Victor Hedman,D,TBL,34,82,12,53,65
1,8480865,Noah Dobson,D,NYI,24,81,12,53,65
1,8479542,Brandon Hagel,L,TBL,26,82,22,42,64
1,8475798,Mikael Granlund,C,SJS,32,73,18,46,64
1,8476432,Boone Jenner,C,CBJ,31,72,44,19,63
1,8480839,Rasmus Dahlin,D,BUF,24,71,10,53,63
1,8475786,Zach Hyman,L,EDM,32,79,35,27,62
1,8477951,Nick Schmaltz,C,UTA,28,80,25,37,62
1,8476448,William Karlsson,C,VGK,31,76,22,40,62
1,8474590,John Carlson,D,WSH,34,72,13,49,62
1,8477504,Josh Morrissey,D,WPG,29,75,12,50,62
1,8479675,Trevor Moore,L,LAK,29,79,29,32,61
1,8481528,Dylan Cozens,C,BUF,23,78,28,33,61
1,8477949,Alex Tuch,R,BUF,28,76,23,38,61
1,8478975,Mason Marchment,L,DAL,29,80,22,38,60
1,8473994,Jamie Benn,L,DAL,35,81,21,39,60
1,8476905,Chandler Stephenson,C,SEA,30,74,17,43,60
1,8480803,Evan Bouchard,D,EDM,25,78,13,47,60
1,8480064,Josh Norris,C,OTT,25,77,31,28,59
1,8473986,Alex Killorn,L,ANA,35,70,25,34,59
1,8479385,Jordan Kyrou,C,STL,26,74,22,37,59
1,8471685,Anze Kopitar,C,LAK,37,79,22,37,59
1,8482665,Matty Beniers,C,SEA,22,75,21,38,59
1,8484153,Leo Carlsson,C,ANA,20,75,19,40,59
1,8475765,Vladimir Tarasenko,R,DET,33,80,18,41,59
1,8477494,Jonathan Drouin,L,COL,29,80,18,41,59
1,8476853,Morgan Rielly,D,TOR,30,71,9,50,59
1,8475754,Brock Nelson,C,NYI,33,79,34,24,58
1,8474150,Mikael Backlund,C,CGY,35,77,25,33,58
1,8479999,Casey Mittelstadt,C,COL,26,82,20,38,58
1,8477503,Max Domi,C,TOR,29,77,15,43,58
1,8475184,Chris Kreider,L,NYR,33,78,37,20,57
1,8482078,Lucas Raymond,L,DET,22,81,23,34,57
1,8478856,Conor Garland,R,VAN,28,72,23,34,57
1,8480830,Andrei Svechnikov,R,CAR,24,72,20,37,57
1,8476882,Teuvo Teravainen,C,CHI,30,70,20,37,57
1,8475169,Evander Kane,L,EDM,33,77,34,22,56
1,8477935,Sam Bennett,C,FLA,28,76,29,27,56
1,8478493,Joel Eriksson Ek,C,MIN,27,61,25,31,56
1,8481533,Trevor Zegras,C,ANA,23,69,24,32,56
1,8478440,Dylan Strome,C,WSH,27,73,20,36,56
1,8478396,Noah Hanifin,D,VGK,27,64,17,39,56
1,8476346,Johnny Gaudreau,L,CBJ,31,68,14,42,56
1,8478407,Vince Dunn,D,SEA,28,78,10,46,56
1,8480014,Gabriel Vilardi,C,WPG,25,70,38,17,55
1,8482699,Dylan Guenther,R,UTA,21,77,28,27,55
1,8477402,Pavel Buchnevich,L,STL,29,73,26,29,55
1,8477964,Ivan Barbashev,C,VGK,29,76,26,29,55
1,8476880,Tom Wilson,R,WSH,30,70,24,31,55
1,8482124,Quinton Byfield,R,LAK,22,79,22,33,55
1,8481711,Matias Maccelli,L,UTA,24,75,18,37,55
1,8477940,Nikolaj Ehlers,L,WPG,28,74,17,38,55
1,8478047,Michael Bunting,L,PIT,29,72,17,38,55
1,8479325,Charlie McAvoy,D,BOS,27,74,10,45,55
1,8482684,Luke Hughes,D,NJD,21,69,8,47,55
1,8481068,Yegor Sharangovich,C,CGY,26,77,29,25,54
1,8482113,Anton Lundell,C,FLA,23,80,26,28,54
1,8475151,Kyle Palmieri,C,NYI,33,77,25,29,54
1,8479400,Pierre-Luc Dubois,L,WSH,26,70,24,30,54
1,8475170,Brayden Schenn,C,STL,33,76,18,36,54
1,8480039,Martin Necas,C,CAR,25,72,27,25,52
1,8475760,Nick Bjugstad,C,UTA,32,74,26,26,52
1,8477998,Warren Foegele,L,LAK,28,78,21,31,52
1,8478469,Thomas Chabot,D,OTT,27,73,20,32,52
1,8477416,Oliver Bjorkstrand,R,SEA,29,77,18,34,52
1,8482720,Matthew Knies,L,TOR,22,79,14,38,52
1,8477447,Shea Theodore,D,VGK,29,57,7,45,52
1,8474586,Jordan Eberle,R,SEA,34,74,23,28,51
1,8478458,John (Jack) Roslovic,C,CAR,27,66,19,32,51
1,8482159,Tyson Foerster,R,PHI,22,76,19,32,51
1,8474679,Gustav Nyquist,C,NSH,35,71,17,34,51
1,8478366,Frank Vatrano,R,ANA,30,77,26,24,50
1,8482110,Dawson Mercer,C,NJD,23,72,24,26,50
1,8478498,Jake DeBrusk,L,VAN,28,71,23,27,50
1,8477451,Ryan Hartman,R,MIN,30,73,19,31,50
1,8484166,Adam Fantilli,C,CBJ,20,71,18,32,50
1,8482745,Mason McTavish,C,ANA,21,72,17,33,50
1,8471724,Kris Letang,D,PIT,37,80,12,38,50
1,8476438,Brandon Saad,L,STL,32,70,26,23,49
1,8482109,Alexis Lafrenière,L,NYR,23,75,25,23,48
1,8474102,David Perron,L,OTT,36,77,18,30,48
1,8477496,Elias Lindholm,C,BOS,30,80,16,32,48
1,8481703,Valtteri Puustinen,R,PIT,25,67,11,37,48
1,8476792,Torey Krug,D,STL,33,74,10,38,48
1,8480145,Neal Pionk,D,WPG,29,73,9,39,48
1,8476483,Rickard Rakell,R,PIT,31,76,26,21,47
1,8483808,Andrei Kuzmenko,L,CGY,28,74,25,22,47
1,8475287,Erik Haula,L,NJD,33,75,19,28,47
1,8480798,Philipp Kurashev,C,CHI,25,64,18,29,47
1,8478462,Nicolas Roy,C,VGK,27,75,17,30,47
1,8475745,Charlie Coyle,C,BOS,32,79,14,33,47
1,8477476,Artturi Lehkonen,L,COL,29,82,23,23,46
1,8479525,Ross Colton,C,COL,28,80,21,25,46
1,8482146,Luke Evangelista,R,NSH,22,72,18,28,46
1,8481560,Arthur Kaliyev,R,LAK,23,80,16,30,46
1,8476906,Shayne Gostisbehere,D,CAR,31,78,14,32,46
1,8480797,Joel Farabee,L,PHI,24,71,14,32,46
1,8480028,Morgan Frost,C,PHI,25,74,12,34,46
1,8481581,Thomas Harley,D,DAL,23,78,12,34,46
1,8478397,Rasmus Andersson,D,CGY,28,66,9,37,46
1,8481542,Moritz Seider,D,DET,23,79,2,44,46
1,8475784,Jeff Skinner,C,EDM,32,78,25,20,45
1,8475794,Tyler Seguin,C,DAL,32,80,21,24,45
1,8482149,Cole Perfetti,C,WPG,22,68,17,28,45
1,8477986,Brandon Montour,D,SEA,30,71,12,33,45
1,8478401,Pavel Zacha,C,BOS,27,77,12,33,45
1,8479425,Filip Hronek,D,VAN,27,77,9,36,45
1,8477456,J.T. Compher,L,DET,29,79,20,24,44
1,8476479,Phillip Danault,C,LAK,31,78,18,26,44
1,8481618,Alex Newhook,C,MTL,23,69,16,28,44
1,8478474,Lawson Crouse,L,UTA,27,71,21,22,43
1,8480015,Owen Tippett,R,PHI,25,78,19,24,43
1,8476872,Scott Laughton,C,PHI,30,74,18,25,43
1,8480009,Eeli Tolvanen,R,SEA,25,74,18,25,43
1,8473422,Nick Foligno,L,CHI,37,66,18,25,43
1,8476826,Yanni Gourde,C,SEA,33,67,17,26,43
1,8475848,Brendan Gallagher,R,MTL,32,70,17,26,43
1,8476292,Ondrej Palat,L,NJD,33,71,12,31,43
1,8482667,William Eklund,L,SJS,22,62,10,33,43
1,8476399,Blake Coleman,C,CGY,33,76,24,18,42
1,8477407,Anthony Duclair,L,NYI,29,77,17,25,42
1,8477497,Sean Monahan,C,CBJ,30,71,15,27,42
1,8475191,Reilly Smith,R,NYR,33,77,15,27,42
1,8480188,Fabian Zetterlund,L,SJS,25,61,14,28,42
1,8470613,Brent Burns,D,CAR,39,77,10,32,42
1,8479345,Jakob Chychrun,D,WSH,26,72,10,32,42
1,8482671,Owen Power,D,BUF,22,67,8,34,42
1,8478038,Devon Toews,D,COL,30,73,7,35,42
1,8478046,Danton Heinen,L,VAN,29,71,20,21,41
1,8477932,Aaron Ekblad,D,FLA,28,73,18,23,41
1,8484145,Zach Benson,L,BUF,19,62,17,24,41
1,8477429,Andrew Copp,C,DET,30,79,17,24,41
1,8478438,Tommy Novak,C,NSH,27,72,14,27,41
1,8481596,Shane Pinto,C,OTT,24,77,11,30,41
1,8481186,Logan O'Connor,R,COL,28,78,22,18,40
1,8475768,Jaden Schwartz,C,SEA,32,76,19,21,40
1,8482092,Ridly Greig,C,OTT,22,80,18,22,40
1,8474565,Alex Pietrangelo,D,VGK,34,56,9,31,40
1,8477426,Nicholas Paul,L,TBL,29,82,21,18,39
1,8477511,Anthony Mantha,R,CGY,30,75,20,19,39
1,8478519,Anthony Cirelli,C,TBL,27,82,17,22,39
1,8475753,Justin Faulk,D,STL,32,73,14,25,39
1,8476458,Ryan Strome,C,ANA,31,75,11,28,39
1,8473563,Nicklas Backstrom,C,WSH,37,59,11,28,39
1,8476923,Damon Severson,D,CBJ,30,80,8,31,39
1,8481604,Pavel Dorofeyev,L,VGK,24,69,21,17,38
1,8483515,Juraj Slafkovsky,L,MTL,20,74,18,20,38
1,8482097,Jack Quinn,R,BUF,23,70,16,22,38
1,8483431,Logan Cooley,C,UTA,20,72,16,22,38
1,8478042,Viktor Arvidsson,L,EDM,31,75,14,24,38
1,8477444,Andre Burakovsky,L,SEA,29,70,13,25,38
1,8477346,MacKenzie Weegar,D,CGY,30,72,8,30,38
1,8481606,Jordan Spence,D,LAK,23,63,7,31,38
1,8478055,Gustav Forsling,D,FLA,28,70,7,31,38
1,8475314,Anders Lee,L,NYI,34,77,19,18,37
1,8475793,Ryan Johansen,C,PHI,32,73,17,20,37
1,8480849,Barrett Hayton,C,UTA,24,70,17,20,37
1,8477989,Christian Dvorak,C,MTL,28,67,13,24,37
1,8479365,Trent Frederic,C,BOS,26,78,11,26,37
1,8480434,Sean Durzi,D,UTA,26,72,9,28,37
1,8476869,Brady Skjei,D,NSH,30,71,9,28,37
1,8477495,Seth Jones,D,CHI,30,70,9,28,37
1,8478542,Evan Rodrigues,C,FLA,31,77,7,30,37
1,8476474,Stefan Noesen,R,NJD,31,71,21,15,36
1,8478233,Andrew Mangiapane,L,WSH,28,65,19,17,36
1,8475763,Kevin Hayes,R,PIT,32,67,11,25,36
1,8476392,Adam Lowry,C,WPG,31,63,11,25,36
1,8482105,Jake Sanderson,D,OTT,22,76,5,31,36
1,8479410,Mikhail Sergachev,D,UTA,26,68,4,32,36
1,8476875,Mike Matheson,D,MTL,30,72,3,33,36
1,8471698,T.J. Oshie,R,WSH,38,66,22,13,35
1,8474641,Adam Henrique,C,EDM,34,74,21,14,35
1,8481535,Nils Hoglander,L,VAN,24,65,21,14,35
1,8482055,Drew O'Connor,L,PIT,26,66,18,17,35
1,8482125,Alexander Holtz,R,VGK,22,69,17,18,35
1,8479996,Cody Glass,C,NSH,25,63,16,19,35
1,8476419,Jean-Gabriel Pageau,C,NYI,32,78,13,22,35
1,8480078,Filip Chytil,C,NYR,25,74,13,22,35
1,8476462,Dougie Hamilton,D,NJD,31,73,12,23,35
1,8477505,Alexander Wennberg,C,SJS,30,66,12,23,35
1,8476463,Jonas Brodin,D,MIN,31,78,9,26,35
1,8478109,Victor Olofsson,L,VGK,29,69,20,14,34
1,8482175,JJ Peterka,R,BUF,22,63,20,14,34
1,8481524,Bowen Byram,D,BUF,23,68,14,20,34
1,8477021,Alex Kerfoot,C,UTA,30,72,9,25,34
1,8479591,Michael Eyssimont,C,TBL,28,80,17,16,33
1,8476921,Jordan Martinook,L,CAR,32,68,14,19,33
1,8475791,Taylor Hall,L,CHI,33,55,12,21,33
1,8480185,Eetu Luostarinen,C,FLA,26,76,11,22,33
1,8476885,Jacob Trouba,D,NYR,30,73,8,25,33
1,8474151,Ryan McDonagh,D,TBL,35,75,5,28,33
1,8476958,Jaccob Slavin,D,CAR,30,75,2,31,33
1,8480113,Alex Iafallo,L,WPG,31,64,18,14,32
1,8480813,Joe Veleno,C,DET,24,74,17,15,32
1,8482660,Kent Johnson,C,CBJ,22,71,13,19,32
1,8475149,Marcus Johansson,L,MIN,34,57,13,19,32
1,8481624,Ilya Mikheyev,R,CHI,30,59,13,19,32
1,8479661,Tanner Jeannot,L,LAK,27,78,11,21,32
1,8478466,Daniel Sprong,R,VAN,27,69,9,23,32
1,8475200,Dmitry Orlov,D,CAR,33,75,9,23,32
1,8482803,Olen Zellweger,D,ANA,21,69,8,24,32
1,8475764,Cam Fowler,D,ANA,33,74,6,26,32
1,8483490,Pavel Mintyukov,D,ANA,21,69,4,28,32
1,8483505,Matthew Poitras,C,BOS,20,74,16,15,31
1,8475722,Jason Zucker,L,BUF,32,67,16,15,31
1,8479393,Noah Gregor,L,OTT,26,70,16,15,31
1,8479992,Michael Rasmussen,C,DET,25,77,15,16,31
1,8478020,Michael Amadio,R,OTT,28,76,14,17,31
1,8480459,Pius Suter,C,VAN,28,68,14,17,31
1,8477948,Travis Sanheim,D,PHI,28,74,12,19,31
1,8474716,Jared Spurgeon,D,MIN,35,81,12,19,31
1,8481523,Kirby Dach,C,MTL,23,66,12,19,31
1,8474053,Logan Couture,C,SJS,35,59,11,20,31
1,8481577,Philip Tomasino,C,NSH,23,65,10,21,31
1,8482624,Daniil Miromanov,D,CGY,27,72,10,21,31
1,8481656,Aliaksei Protas,C,WSH,23,64,9,22,31
1,8478882,Vladislav Gavrikov,D,LAK,29,66,8,23,31
1,8480873,Rasmus Sandin,D,WSH,24,65,7,24,31
1,8479371,Dante Fabbro,D,NSH,26,71,6,25,31
1,8480891,Michael Kesselring,D,UTA,24,60,3,28,31
1,8474189,Lars Eller,C,PIT,35,55,17,13,30
1,8480220,Noah Cates,L,PHI,25,67,15,15,30
1,8475714,Calle Jarnkrok,C,TOR,33,72,15,15,30
1,8476925,Colton Sissons,C,NSH,31,65,14,16,30
1,8475343,Nic Dowd,C,WSH,34,64,14,16,30
1,8475220,Marcus Foligno,L,MIN,33,61,13,17,30
1,8482133,Thomas Bordeleau,C,SJS,22,63,12,18,30
1,8480762,Eric Robinson,L,CAR,29,59,11,19,30
1,8470621,Corey Perry,R,EDM,39,68,11,19,30
1,8478508,Yakov Trenin,C,MIN,27,60,11,19,30
1,8478472,Mathieu Joseph,R,STL,27,69,10,20,30
1,8480871,Adam Boqvist,D,FLA,24,71,5,25,30
1,8482089,Jake Neighbours,L,STL,22,66,23,6,29
1,8476981,Josh Anderson,R,MTL,30,67,16,13,29
1,8474149,Evgenii Dadonov,R,DAL,35,81,15,14,29
1,8481582,Nicholas Robertson,L,TOR,23,65,14,15,29
1,8479987,Morgan Geekie,C,BOS,26,80,13,16,29
1,8475218,Mattias Ekholm,D,EDM,34,73,8,21,29
1,8477952,Robby Fabbri,C,ANA,28,68,18,10,28
1,8477425,Miles Wood,L,COL,29,77,17,11,28
1,8477479,Tyler Bertuzzi,L,CHI,29,58,16,12,28
1,8475799,Nino Niederreiter,R,WPG,32,64,16,12,28
1,8480829,Jesperi Kotkaniemi,C,CAR,24,62,13,15,28
1,8478891,Mason Appleton,C,WPG,28,58,12,16,28
1,8479339,Patrik Laine,L,CBJ,26,62,9,19,28
1,8484203,Bradly Nadeau,L,CAR,19,59,9,19,28
1,8476461,Sean Couturier,C,PHI,32,66,9,19,28
1,8478851,Alexandre Carrier,D,NSH,28,62,7,21,28
1,8474563,Drew Doughty,D,LAK,35,67,5,23,28
1,8479398,Samuel Girard,D,COL,26,64,1,27,28
1,8478569,Noel Acciari,C,PIT,33,54,17,10,27
1,8478057,Dakota Joshua,C,VAN,28,61,16,11,27
1,8479390,Taylor Raddysh,R,WSH,26,69,15,12,27
1,8479368,Max Jones,L,BOS,26,58,14,13,27
1,8482259,Bobby McMann,C,TOR,28,57,13,14,27
1,8476278,Colin Blackwell,C,DAL,31,77,13,14,27
1,8478434,Keegan Kolesar,R,VGK,27,68,11,16,27
1,8482702,Logan Stankoven,C,DAL,21,82,10,17,27
1,8476927,Teddy Blueger,C,VAN,30,66,8,19,27
1,8478133,Jake Evans,C,MTL,28,65,8,19,27
1,8477018,Ben Hutton,D,VGK,31,50,8,19,27
1,8476856,Mathew Dumba,D,DAL,30,73,8,19,27
1,8479983,Mario Ferraro,D,SJS,26,71,7,20,27
1,8477435,Ryan Graves,D,PIT,29,77,6,21,27
1,8476891,Matthew Grzelcyk,D,PIT,30,74,4,23,27
1,8476917,Adam Pelech,D,NYI,30,79,3,24,27
1,8482122,Brock Faber,D,MIN,22,80,2,25,27
1,8482705,Cole Sillinger,C,CBJ,21,63,13,13,26
1,8478463,Anthony Beauvillier,L,PIT,27,66,12,14,26
1,8482117,Lukas Reichel,L,CHI,22,57,12,14,26
1,8480995,Pontus Holmberg,R,TOR,25,61,11,15,26
1,8482679,Matt Coronato,R,CGY,22,67,11,15,26
1,8480003,Jesper Boqvist,C,FLA,26,63,10,16,26
1,8479315,Joey Anderson,R,CHI,26,51,9,17,26
1,8477498,Darnell Nurse,D,EDM,29,65,8,18,26
1,8481527,Kaedan Korczak,D,VGK,23,49,7,19,26
1,8483468,Jiri Kulich,C,BUF,20,56,7,19,26
1,8482712,Oskar Olausson,R,COL,22,74,3,23,26
1,8479976,Juuso Valimaki,D,UTA,26,68,1,25,26
1,8480893,Kirill Marchenko,R,CBJ,24,57,19,6,25
1,8483524,Shane Wright,C,SEA,20,59,13,12,25
1,8480074,Alexandre Texier,C,STL,25,58,13,12,25
1,8477947,Sonny Milano,L,WSH,28,60,10,15,25
1,8478115,Pierre Engvall,L,NYI,28,76,10,15,25
1,8475855,Jesper Fast,R,CAR,33,64,9,16,25
1,8480336,Sean Walker,D,CAR,30,76,8,17,25
1,8478013,Jake Walman,D,SJS,28,73,8,17,25
1,8480835,Jack Drury,C,CAR,24,62,6,19,25
1,8482475,Yegor Chinakhov,R,CBJ,23,65,6,19,25
1,8475193,Tomas Tatar,L,NJD,34,74,6,19,25
1,8476457,Adam Larsson,D,SEA,32,67,6,19,25
1,8477969,Marcus Pettersson,D,PIT,28,76,3,22,25
1,8477488,Brett Pesce,D,NJD,30,70,3,22,25
1,8475455,Brenden Dillon,D,NJD,34,58,3,22,25
1,8476892,Colton Parayko,D,STL,31,69,2,23,25
1,8482079,Marco Rossi,C,MIN,23,64,17,7,24
1,8479293,Brandon Tanev,L,SEA,33,62,15,9,24
1,8481481,Blake Lizotte,C,PIT,27,59,14,10,24
1,8481554,Kaapo Kakko,R,NYR,23,67,14,10,24
1,8480281,Alexey Toropchenko,R,STL,25,63,11,13,24
1,8481580,Connor McMichael,C,WSH,23,66,10,14,24
1,8479353,Brett Howden,C,VGK,26,68,9,15,24
1,8475171,Oliver Ekman-Larsson,D,TOR,33,67,8,16,24
1,8480035,Henri Jokiharju,D,BUF,25,64,8,16,24
1,8476988,Matt Benning,D,SJS,30,65,8,16,24
1,8479639,Dylan Coghlan,D,WPG,26,58,7,17,24
1,8482087,Kaiden Guhle,D,MTL,22,69,6,18,24
1,8479351,Sam Steel,C,DAL,26,72,5,19,24
1,8480043,Timothy Liljegren,D,TOR,25,68,4,20,24
1,8482073,Braden Schneider,D,NYR,23,67,4,20,24
1,8480246,Nick Perbix,D,TBL,26,75,3,21,24
1,8482655,Janis Moser,D,TBL,24,74,1,23,24
1,8474574,Tyler Myers,D,VAN,34,68,1,23,24
1,8480855,Jack McBain,C,UTA,24,61,13,10,23
1,8474715,Cameron Atkinson,R,TBL,35,81,13,10,23
1,8478432,Christian Fischer,R,DET,27,78,12,11,23
1,8475231,Casey Cizikas,C,NYI,33,69,11,12,23
1,8482111,Justin Barron,D,MTL,23,67,10,13,23
1,8481032,Paul Cotter,C,NJD,25,58,9,14,23
1,8477508,Curtis Lazar,C,NJD,29,60,8,15,23
1,8483499,Liam Ohgren,L,MIN,20,58,7,16,23
1,8483565,Nick Blankenburg,D,NSH,26,66,7,16,23
1,8483445,Cutter Gauthier,L,ANA,20,68,7,16,23
1,8478507,John Marino,D,UTA,27,67,2,21,23
1,8480980,Connor Dewar,C,TOR,25,71,15,7,22
1,8478043,Sam Lafferty,C,BUF,29,52,13,9,22
1,8480802,Ryan McLeod,C,BUF,25,64,11,11,22
1,8481553,Bobby Brink,R,PHI,23,62,11,11,22
1,8473453,Trevor Lewis,C,LAK,37,72,11,11,22
1,8476918,Jimmy Vesey,L,NYR,31,63,10,12,22
1,8481641,Joel Kiviranta,L,COL,28,68,9,13,22
1,8477953,Kasperi Kapanen,R,STL,28,61,8,14,22
1,8476469,Joel Armia,R,MTL,31,66,8,14,22
1,8476994,Vinnie Hinostroza,C,NSH,30,52,7,15,22
1,8478970,Jalen Chatfield,D,CAR,28,67,6,16,22
1,8476931,Jake McCabe,D,TOR,31,59,5,17,22
1,8479402,Jake Bean,D,CGY,26,64,4,18,22
1,8481708,Zac Jones,D,NYR,24,46,4,18,22
1,8481546,Cam York,D,PHI,23,73,3,19,22
1,8476467,Jamie Oleksiak,D,SEA,32,65,3,19,22
1,8475324,Nick Jensen,D,OTT,34,69,2,20,22
1,8479619,Michael Carcone,L,UTA,28,61,17,4,21
1,8475842,Sam Carrick,C,NYR,32,57,11,10,21
1,8477839,Conor Sheary,L,TBL,32,80,8,13,21
1,8476480,Vladislav Namestnikov,C,WPG,32,66,5,16,21
1,8477220,Nate Schmidt,D,FLA,33,65,5,16,21
1,8478413,Jordan Greenway,L,BUF,27,60,5,16,21
1,8476331,Dylan DeMelo,D,WPG,31,71,4,17,21
1,8476854,Hampus Lindholm,D,BOS,30,70,2,19,21
1,8477478,William Carrier,L,CAR,30,56,9,11,20
1,8477987,Ryan Donato,C,CHI,28,66,9,11,20
1,8480205,Emil Bemstrom,C,PIT,25,57,9,11,20
1,8480789,Oliver Wahlstrom,R,NYI,24,63,8,12,20
1,8476979,Erik Gustafsson,D,DET,32,76,6,14,20
1,8481521,Ronnie Attard,D,PHI,25,55,6,14,20
1,8480817,K'Andre Miller,D,NYR,24,65,4,16,20
1,8482192,Isaak Phillips,D,CHI,23,63,4,16,20
1,8476422,Mike Reilly,D,NYI,31,74,4,16,20
1,8475188,Brayden McNabb,D,VGK,33,62,3,17,20
1,8478451,Ethan Bear,D,WSH,27,46,3,17,20
1,8477369,Carson Soucy,D,VAN,30,65,2,18,20
1,8480011,Klim Kostin,C,SJS,25,47,12,7,19
1,8479336,Carl Grundstrom,R,SJS,27,59,12,7,19
1,8476897,Oskar Sundqvist,C,STL,30,60,11,8,19
1,8479941,Justin Danforth,R,CBJ,31,57,11,8,19
1,8476873,Mark Jankowski,C,NSH,30,50,10,9,19
1,8480289,Morgan Barron,C,WPG,26,57,10,9,19
1,8477450,Jason Dickinson,C,CHI,29,60,9,10,19
1,8479344,Jesse Puljujarvi,R,PIT,26,57,9,10,19
1,8478831,Kevin Stenlund,C,UTA,28,55,9,10,19
1,8477919,Frederick Gaudreau,C,MIN,31,62,8,11,19
1,8481537,Nikita Okhotiuk,D,CGY,24,53,6,13,19
1,8474673,TJ Brodie,D,CHI,34,56,5,14,19
1,8475790,Erik Gudbranson,D,CBJ,32,79,5,14,19
1,8478178,Darren Raddysh,D,TBL,28,73,4,15,19
1,8482749,Joshua Roy,R,MTL,21,62,4,15,19
1,8479980,Nicolas Hague,D,VGK,26,57,2,17,19
1,8482074,Connor Zary,C,CGY,23,56,12,6,18
1,8480748,Kiefer Sherwood,L,VAN,29,65,9,9,18
1,8480144,David Kampf,C,TOR,29,72,9,9,18
1,8479370,Tyson Jost,C,CAR,26,52,9,9,18
1,8483457,Lane Hutson,D,MTL,20,70,9,9,18
1,8481517,Brett Leason,R,ANA,25,56,9,9,18
1,8477499,Rasmus Ristolainen,D,PHI,30,57,8,10,18
1,8475225,Craig Smith,C,CHI,35,48,7,11,18
1,8482142,Jamie Drysdale,D,PHI,22,56,7,11,18
1,8484149,Gavin Brindley,C,CBJ,20,47,6,12,18
1,8477015,Connor Brown,R,EDM,30,65,6,12,18
1,8476312,Josh Manson,D,COL,33,59,5,13,18
1,8475181,Nick Leddy,D,STL,33,63,5,13,18
1,8477979,Nicolas Aube-Kubel,R,BUF,28,57,5,13,18
1,8481704,Juuso Parssinen,C,NSH,23,61,5,13,18
1,8476889,Radek Faksa,C,STL,30,64,5,13,18
1,8481028,Martin Pospisil,C,CGY,25,58,5,13,18
1,8480058,Pierre-Olivier Joseph,D,STL,25,55,4,14,18
1,8478840,Will Borgen,D,SEA,28,60,3,15,18
1,8476429,Scott Mayfield,D,NYI,32,73,3,15,18
1,8480796,Martin Fehervary,D,WSH,25,55,3,15,18
1,8481059,Scott Perunovich,D,STL,26,58,1,17,18
1,8478500,Ivan Provorov,D,CBJ,27,80,1,17,18
1,8475279,Ben Chiarot,D,DET,33,63,1,17,18
1,8479316,Luke Kunin,C,SJS,27,54,13,4,17
1,8482155,Alex Laferriere,R,LAK,23,62,12,5,17
1,8477380,Jonny Brodzinski,C,NYR,31,48,9,8,17
1,8476878,Zemgus Girgensons,C,TBL,30,81,9,8,17
1,8480068,Ryan Poehling,C,PHI,25,61,8,9,17
1,8478211,Dryden Hunt,L,CGY,29,63,8,9,17
1,8480021,Jack Studnicka,C,LAK,25,62,7,10,17
1,8480073,Erik Brannstrom,D,COL,25,65,6,11,17
1,8483482,Tristan Luneau,D,ANA,20,62,5,12,17
1,8476874,Olli Maatta,D,DET,30,64,5,12,17
1,8480806,Isac Lundestrom,C,ANA,25,62,5,12,17
1,8483495,Simon Nemec,D,NJD,20,56,5,12,17
1,8478452,Caleb Jones,D,LAK,27,67,4,13,17
1,8476879,Cody Ceci,D,EDM,31,73,4,13,17
1,8481441,Joe Snively,C,DET,28,56,3,14,17
1,8473507,Jeff Petry,D,DET,37,70,3,14,17
1,8475233,David Savard,D,MTL,34,63,3,14,17
1,8477446,Michael McCarron,R,NSH,29,53,3,14,17
1,8480049,Dylan Samberg,D,WPG,25,65,2,15,17
1,8480222,Sebastian Aho,D,PIT,28,76,2,15,17
1,8478911,Matt Roy,D,WSH,29,65,2,15,17
1,8482245,Artem Zub,D,OTT,29,66,2,15,17
1,8476967,Brett Kulak,D,EDM,30,63,1,16,17
1,8475462,Radko Gudas,D,ANA,34,66,1,16,17
1,8473533,Jordan Staal,C,CAR,36,58,11,5,16
1,8474034,Patrick Maroon,L,CHI,36,54,9,7,16
1,8477573,Nathan Walker,L,STL,30,56,9,7,16
1,8480448,Parker Kelly,L,COL,25,74,8,8,16
1,8481093,Rafael Harvey-Pinard,L,MTL,25,64,7,9,16
1,8475179,Dmitry Kulikov,D,FLA,34,63,7,9,16
1,8477353,Tyler Motte,C,DET,29,70,7,9,16
1,8482737,Zack Bolduc,C,STL,21,55,6,10,16
1,8479324,Ryan Lindgren,D,NYR,26,64,6,10,16
1,8482652,Walker Duehr,R,CGY,27,42,6,10,16
1,8476952,Dominic Toninato,C,WPG,30,39,5,11,16
1,8482809,Jackson Blake,R,CAR,21,55,5,11,16
1,8476902,Esa Lindell,D,DAL,30,69,4,12,16
1,8483491,Ivan Miroshnichenko,L,WSH,20,56,3,13,16
1,8477506,Ryan Pulock,D,NYI,30,73,3,13,16
1,8477507,Nikita Zadorov,D,BOS,29,68,3,13,16
1,8482067,Connor Mackey,D,NYR,28,65,2,14,16
1,8481014,Alexander Romanov,D,NYI,24,78,2,14,16
1,8478136,Jake Middleton,D,MIN,28,75,1,15,16
1,8480807,Mattias Samuelsson,D,BUF,24,55,1,15,16
1,8481601,Simon Holmstrom,R,NYI,23,66,9,6,15
1,8482062,Cole Smith,L,NSH,29,53,8,7,15
1,8477482,Zachary Sanford,L,CHI,30,43,8,7,15
1,8479520,Brandon Duhaime,R,WSH,27,47,8,7,15
1,8479359,Beck Malenstyn,L,BUF,26,50,8,7,15
1,8476934,Brock McGinn,L,ANA,30,42,8,7,15
1,8481522,Peyton Krebs,C,BUF,23,56,7,8,15
1,8479718,Alex Barré-Boulet,C,MTL,27,54,7,8,15
1,8479026,Philippe Myers,D,TOR,27,59,6,9,15
1,8476960,Andreas Athanasiou,C,CHI,30,47,6,9,15
1,8482157,Will Cuylle,L,NYR,22,62,6,9,15
1,8477931,Tomas Nosek,L,FLA,32,60,5,10,15
1,8479944,Zach Aston-Reese,C,VGK,30,52,5,10,15
1,8480172,Jan Rutta,D,SJS,34,63,4,11,15
1,8476624,Barclay Goodrow,C,SJS,31,55,3,12,15
1,8477392,Hudson Fasching,R,NYI,29,65,3,12,15
1,8478443,Brandon Carlo,D,BOS,28,59,3,12,15
1,8480878,Nils Lundkvist,D,DAL,24,70,2,13,15
1,8482101,Danil Gushchin,L,SJS,22,52,2,13,15
1,8482148,Hendrix Lapierre,C,WSH,22,47,8,6,14
1,8483493,Frank Nazar,C,CHI,20,48,8,6,14
1,8480025,MacKenzie Entwistle,R,FLA,25,67,8,6,14
1,8482730,Brandt Clarke,D,LAK,21,46,8,6,14
1,8482166,Shakir Mukhamadullin,D,SJS,22,51,7,7,14
1,8477365,Connor Clifton,D,BUF,29,56,5,9,14
1,8479671,Mathieu Olivier,R,CBJ,27,49,5,9,14
1,8480355,Mark Kastelic,C,BOS,25,62,4,10,14
1,8479982,Conor Timmins,D,TOR,26,53,3,11,14
1,8476525,Colin Miller,D,WPG,32,62,3,11,14
1,8480001,Urho Vaakanainen,D,ANA,25,61,3,11,14
1,8478416,Erik Cernak,D,TBL,27,74,2,12,14
1,8480860,Kevin Bahl,D,CGY,24,62,1,13,14
1,8479291,Kevin Rooney,C,CGY,31,52,7,6,13
1,8479066,Ryan Lomberg,L,CGY,30,63,6,7,13
1,8478399,Jonas Siegenthaler,D,NJD,27,62,6,7,13
1,8476329,Travis Boyd,C,MIN,31,50,5,8,13
1,8480950,Ilya Lyubushkin,D,DAL,30,61,5,8,13
1,8482659,Josh Doan,R,UTA,22,56,5,8,13
1,8475690,Chris Tanev,D,TOR,35,63,3,10,13
1,8479986,Kole Lind,R,DAL,26,58,3,10,13
1,8479348,Kale Clague,D,BUF,26,42,2,11,13
1,8475718,Justin Holl,D,DET,32,58,2,11,13
1,8481019,David Gustafsson,C,WPG,24,50,1,12,13
1,8481568,Alex Vlasic,D,CHI,23,54,1,12,13
1,8476822,Luke Glendening,C,TBL,35,75,10,2,12
1,8481789,Tye Kartye,L,SEA,23,44,9,3,12
1,8481477,Nico Sturm,C,SJS,29,49,8,4,12
1,8479439,Jacob MacDonald,D,COL,31,46,7,5,12
1,8477406,Mattias Janmark,C,EDM,32,63,6,6,12
1,8482859,Zack Ostapchuk,C,OTT,21,50,6,6,12
1,8482095,Tyler Kleven,D,OTT,22,45,5,7,12
1,8477070,Liam O'Brien,C,UTA,30,49,5,7,12
1,8480848,Ty Dellandrea,C,SJS,24,46,5,7,12
1,8479372,Joshua Mahura,D,SEA,26,51,4,8,12
1,8482765,Isak Rosen,R,BUF,21,40,4,8,12
1,8480887,Jordan Harris,D,MTL,24,45,3,9,12
1,8482784,Zach Dean,C,STL,21,41,3,9,12
1,8474090,Brendan Smith,D,DAL,35,55,3,9,12
1,8482634,Alex Steeves,C,TOR,25,49,2,10,12
1,8480157,Calle Rosen,D,COL,30,54,2,10,12
1,8477845,Trevor van Riemsdyk,D,WSH,33,59,2,10,12
1,8480252,Cole Guttman,C,CHI,25,37,2,10,12
1,8483460,David Jiricek,D,CBJ,21,59,0,12,12
1,8482807,Ethan Del Mastro,D,CHI,21,49,7,4,11
1,8481013,Jonatan Berggren,R,DET,24,65,7,4,11
1,8476374,Sean Kuraly,C,CBJ,31,60,7,4,11
1,8479968,Vinni Lettieri,C,BOS,29,48,5,6,11
1,8481716,Dmitri Voronkov,L,CBJ,24,44,5,6,11
1,8482451,Mikael Pyyhtia,L,CBJ,23,50,4,7,11
1,8479543,Michael Pezzetta,L,MTL,26,59,4,7,11
1,8480192,Johnathan Kovacevic,D,NJD,27,50,4,7,11
1,8471709,Marc-Edouard Vlasic,D,SJS,37,66,3,8,11
1,8474567,Zach Bogosian,D,MIN,34,68,2,9,11
1,8481598,Philip Broberg,D,EDM,23,43,7,3,10
1,8478585,Derek Ryan,C,EDM,38,51,6,4,10
1,8479442,Troy Stecher,D,EDM,30,58,6,4,10
1,8482744,James Malatesta,L,CBJ,21,37,3,7,10
1,8481751,Lukas Rousek,R,BUF,25,37,3,7,10
1,8476867,Brendan Gaunce,C,MIN,30,43,3,7,10
1,8477034,Jaycob Megna,D,FLA,32,42,3,7,10
1,8477903,Garnet Hathaway,R,PHI,33,67,3,7,10
1,8478468,Jeremy Lauzon,D,NSH,27,48,3,7,10
1,8477335,Kyle Burroughs,D,LAK,29,47,3,7,10
1,8481167,Brayden Pachal,D,CGY,25,48,2,8,10
1,8480070,Ian Mitchell,D,BOS,25,54,2,8,10
1,8479369,Andrew Peeke,D,BOS,26,60,2,8,10
1,8474166,Alec Martinez,D,CHI,37,48,2,8,10
1,8475750,Jon Merrill,D,MIN,32,52,2,8,10
1,8483466,Kevin Korchinski,D,CHI,20,49,2,8,10
1,8478859,Niko Mikkola,D,FLA,28,61,2,8,10
1,8479972,Mason Shaw,C,WPG,26,41,1,9,10
1,8481178,Egor Zamula,D,PHI,24,53,1,9,10
1,8474568,Luke Schenn,D,NSH,35,52,1,9,10
1,8480727,Zach Whitecloud,D,VGK,28,53,0,10,10
1,8479998,Mikey Anderson,D,LAK,25,61,0,10,10
1,8476442,Matt Nieto,L,PIT,32,38,6,3,9
1,8480441,Trey Fix-Wolansky,R,CBJ,25,37,5,4,9
1,8481161,Jake Christiansen,D,CBJ,25,53,5,4,9
1,8479328,Julien Gauthier,R,NYI,27,69,5,4,9
1,8479772,Zack MacEwen,R,OTT,28,52,5,4,9
1,8479414,Nathan Bastian,R,NJD,27,55,4,5,9
1,8481617,Vasily Podkolzin,R,VAN,23,45,4,5,9
1,8483763,Maksymilian Szuber,D,UTA,22,30,3,6,9
1,8476858,Phillip Di Giuseppe,L,VAN,31,44,3,6,9
1,8479378,Logan Stanley,D,WPG,26,48,2,7,9
1,8477401,John Hayden,C,SEA,29,35,6,2,8
1,8482070,Mitchell Chaffee,R,TBL,26,52,6,2,8
1,8482747,Brennan Othmann,L,NYR,21,43,4,4,8
1,8481567,Henry Thrun,D,SJS,23,46,4,4,8
1,8477938,Haydn Fleury,D,WPG,28,40,4,4,8
1,8474612,Travis Hamonic,D,OTT,34,47,3,5,8
1,8480990,Declan Chisholm,D,MIN,24,36,3,5,8
1,8480870,Bo Groulx,C,NYR,24,31,3,5,8
1,8476913,Devin Shore,C,MIN,30,45,2,6,8
1,8482964,Arber Xhekaj,D,MTL,23,51,2,6,8
1,8483619,Filip Roos,D,OTT,25,39,2,6,8
1,8481532,Alex Turcotte,C,LAK,23,47,2,6,8
1,8478421,A.J. Greer,L,FLA,28,55,1,7,8
1,8481701,Santeri Hatakka,D,NJD,23,40,1,7,8
1,8475208,Brian Dumoulin,D,ANA,33,62,1,7,8
1,8471677,Jack Johnson,D,CBJ,37,62,1,7,8
1,8482145,Mavrik Bourque,C,DAL,22,49,6,1,7
1,8481609,Vladislav Kolyachonok,D,UTA,23,39,4,3,7
1,8481679,Maxence Guenette,D,OTT,23,37,4,3,7
1,8481550,Adam Beckman,L,NJD,23,37,3,4,7
1,8481600,Tobias Bjornfot,D,FLA,23,39,3,4,7
1,8480834,Ty Emberson,D,SJS,24,32,3,4,7
1,8480007,Jonas Rondbjerg,R,VGK,25,35,2,5,7
1,8480245,Olle Lycksell,R,PHI,25,32,2,5,7
1,8482666,Scott Morrow,D,CAR,22,44,2,5,7
1,8480196,Jacob Bryson,D,BUF,27,38,1,6,7
1,8479249,Andrew Poturalski,C,SJS,30,35,0,7,7
1,8470600,Ryan Suter,D,STL,39,67,0,7,7
1,8474013,Ian Cole,D,UTA,35,49,0,7,7
1,8482511,Mason Lohrei,D,BOS,23,33,4,2,6
1,8481518,Nolan Foote,L,NJD,24,38,4,2,6
1,8471817,Ryan Reaves,R,TOR,37,53,4,2,6
1,8481556,John Beecher,C,BOS,23,37,4,2,6
1,8483549,Lucas Condotta,L,MTL,27,34,3,3,6
1,8480845,Rasmus Kupari,C,WPG,24,42,3,3,6
1,8479379,Givani Smith,R,SJS,26,30,3,3,6
1,8479985,Cale Fleury,D,SEA,26,34,3,3,6
1,8478409,Anthony Richard,C,PHI,28,36,3,3,6
1,8482141,Lukas Cormier,D,VGK,22,24,3,3,6
1,8481719,Maxwell Crozier,D,TBL,24,17,3,3,6
1,8481585,Egor Afanasyev,L,SJS,23,21,3,3,6
1,8480292,Carson Meyer,R,ANA,27,28,2,4,6
1,8477527,Ross Johnston,L,ANA,30,29,2,4,6
1,8482077,Dylan Holloway,L,EDM,23,48,2,4,6
1,8473446,Erik Johnson,D,PHI,36,51,1,5,6
1,8484254,Akito Hirose,D,VAN,25,49,1,5,6
1,8478017,Mark Friedman,D,VAN,29,36,1,5,6
1,8481599,Victor Soderstrom,D,UTA,23,38,1,5,6
1,8480879,Jacob Bernard-Docker,D,OTT,24,39,1,5,6
1,8477462,Robert Hagg,D,VGK,29,20,1,5,6
1,8477887,Patrick Brown,C,BOS,32,46,1,5,6
1,8482153,Brendan Brisson,C,VGK,23,37,1,5,6
1,8484911,Collin Graf,R,SJS,22,39,1,5,6
1,8482176,Wyatt Kaiser,D,CHI,22,44,0,6,6
1,8479994,Jaret Anderson-Dolan,C,WPG,25,30,5,0,5
1,8480880,Jakub Lauko,C,MIN,24,31,5,0,5
1,8481543,Nikita Alexandrov,C,STL,24,23,3,2,5
1,8481147,Reese Johnson,C,MIN,26,34,3,2,5
1,8475177,Calvin de Haan,D,COL,33,47,2,3,5
1,8481592,Jakob Pelletier,L,CGY,23,33,2,3,5
1,8478477,Mitchell Stephens,C,SEA,27,16,2,3,5
1,8475958,Michael Sgarbossa,C,WSH,32,33,2,3,5
1,8482762,Simon Edvinsson,D,DET,21,54,2,3,5
1,8479536,Axel Jonsson-Fjallby,L,WPG,26,35,1,4,5
1,8478146,Matthew Highmore,C,OTT,28,37,1,4,5
1,8478424,Jansen Harkins,C,ANA,27,45,1,4,5
1,8477384,Joshua Brown,D,EDM,30,37,1,4,5
1,8478874,Adam Gaudette,R,OTT,28,29,1,4,5
1,8476473,Connor Murphy,D,CHI,31,39,1,4,5
1,8482470,Ilya Solovyov,D,CGY,24,16,1,4,5
1,8477467,Gustav Olofsson,D,SEA,30,22,1,4,5
1,8480468,James Hamblin,L,EDM,25,23,1,4,5
1,8482861,Vincent Iorio,D,WSH,22,33,0,5,5
1,8482751,Ryan Winterton,C,SEA,21,35,0,5,5
1,8476372,Nick Seeler,D,PHI,31,38,0,5,5
1,8481754,Nikita Nesterenko,C,ANA,23,29,4,0,4
1,8477073,Kurtis MacDermid,L,NJD,30,34,3,1,4
1,8484287,Cole McWard,D,VAN,23,25,3,1,4
1,8479981,Jonah Gadjovich,L,FLA,26,42,2,2,4
1,8475235,Nicolas Deslauriers,L,PHI,33,52,2,2,4
1,8478446,Glenn Gawdin,C,LAK,27,16,2,2,4
1,8483570,Ben Meyers,C,SEA,26,27,2,2,4
1,8479638,Justin Brazeau,R,BOS,26,38,2,2,4
1,8478454,Noah Juulsen,D,VAN,27,33,1,3,4
1,8479576,Vincent Desharnais,D,VAN,28,26,1,3,4
1,8481541,Samuel Bolduc,D,NYI,24,28,1,3,4
1,8479991,Jake Leschyshyn,C,NYR,25,28,1,3,4
1,8480874,Adam Ginning,D,PHI,24,12,1,3,4
1,8482177,Marat Khusnutdinov,C,MIN,22,35,1,3,4
1,8481065,Angus Crookshank,L,OTT,25,16,1,3,4
1,8482118,Sam Colangelo,R,ANA,23,20,1,3,4
1,8484258,Sam Malinski,D,COL,26,18,0,4,4
1,8482061,Brandon Biro,L,SEA,26,14,3,0,3
1,8477851,Jordan Oesterle,D,BOS,32,40,2,1,3
1,8480890,Jan Jenik,C,OTT,24,24,2,1,3
1,8481237,Kyle MacLean,C,NYI,25,26,2,1,3
1,8482201,Gage Goncalves,C,TBL,23,24,2,1,3
1,8479320,Maxime Lajoie,D,SEA,27,24,1,2,3
1,8475762,Derek Forbort,D,VAN,32,36,1,2,3
1,8482496,Nils Aman,C,VAN,24,35,1,2,3
1,8482858,Ryker Evans,D,SEA,23,20,1,2,3
1,8482733,Logan Mailloux,D,MTL,31,33,1,2,3
1,8481699,Aku Raty,R,UTA,23,14,1,2,3
1,8483395,Arshdeep Bains,L,VAN,23,9,1,2,3
1,8483512,Matthew Savoie,C,EDM,20,19,0,3,3
1,8478450,Parker Wotherspoon,D,BOS,27,34,0,3,3
1,8481006,Tyler Tucker,D,STL,24,14,0,3,3
1,8480084,Nick DeSimone,D,NJD,30,14,0,3,3
1,8476441,Joel Edmundson,D,LAK,31,39,0,3,3
1,8481564,Ryan Johnson,D,BUF,23,14,0,3,3
1,8479419,Brett Murray,L,BUF,26,21,0,3,3
1,8481743,Marc Del Gaizo,D,NSH,25,17,0,3,3
1,8482144,Jack Thompson,D,SJS,22,25,0,3,3
1,8481122,Simon Benoit,D,TOR,26,38,0,3,3
1,8480844,Grigori Denisenko,L,VGK,24,27,0,3,3
1,8483630,Pavol Regenda,L,ANA,25,24,2,0,2
1,8477810,Joel Hanley,D,CGY,33,20,1,1,2
1,8477320,Anton Blidh,L,NYR,29,14,1,1,2
1,8482516,Matthew Kessel,D,STL,24,19,1,1,2
1,8480823,Alexander Alexeyev,D,WSH,25,9,1,1,2
1,8481593,Jayden Struble,D,MTL,23,22,1,1,2
1,8480267,Sammy Walker,C,MIN,25,20,1,1,2
1,8482929,Emil Lilleberg,D,TBL,23,17,1,1,2
1,8484304,Uvis Balinskis,D,FLA,28,8,1,1,2
1,8481422,Jake Lucchini,C,NSH,29,15,1,1,2
1,8481726,Adam Edstrom,C,NYR,24,8,1,1,2
1,8483397,Marc McLaughlin,C,BOS,25,28,1,1,2
1,8478147,Bokondji Imama,L,PIT,28,6,1,1,2
1,8483531,Brian Halonen,L,NJD,25,6,1,1,2
1,8483012,Logan Morrison,C,SEA,22,28,1,1,2
1,8481056,Spencer Stastney,D,NSH,24,29,0,2,2
1,8477244,Chad Ruhwedel,D,NYR,34,29,0,2,2
1,8477149,Scott Sabourin,R,SJS,32,18,0,2,2
1,8478011,Louie Belpedio,D,PHI,28,17,0,2,2
1,8482126,Emil Andrae,D,PHI,31,6,0,2,2
1,8478881,Brett Seney,L,CHI,28,11,0,2,2
1,8482713,Mackie Samoskevich,R,FLA,22,33,0,2,2
1,8479587,Rhett Gardner,C,PHI,28,20,1,0,1
1,8475795,Dylan McIlrath,D,WSH,32,8,1,0,1
1,8478021,William Lagesson,D,DET,28,28,1,0,1
1,8477971,Andreas Englund,D,LAK,28,28,1,0,1
1,8482094,Daemon Hunt,D,MIN,22,11,1,0,1
1,8482250,Callahan Burke,C,VGK,27,16,1,0,1
1,8477473,Justin Bailey,R,SJS,29,25,1,0,1
1,8480075,Cameron Crotty,D,MIN,25,11,1,0,1
1,8475413,Justin Dowling,C,NJD,34,12,1,0,1
1,8482172,Landon Slaggert,L,CHI,22,19,1,0,1
1,8482162,Roby Jarventie,L,EDM,22,20,1,0,1
1,8482102,Vasily Ponomarev,C,PIT,22,20,1,0,1
1,8483597,Milos Kelemen,L,UTA,25,17,1,0,1
1,8480851,Akil Thomas,C,LAK,24,13,1,0,1
1,8482787,Nikita Chibrikov,R,WPG,31,6,1,0,1
1,8482088,Justin Sourdif,R,FLA,22,11,1,0,1
1,8477962,Brendan Lemieux,L,CAR,28,31,0,1,1
1,8481605,Jackson LaCombe,D,ANA,23,29,0,1,1
1,8481806,Louis Crevier,D,CHI,23,20,0,1,1
1,8481030,Jack St. Ivany,D,PIT,25,18,0,1,1
1,8483407,Brandon Scanlin,D,NYR,25,5,0,1,1
1,8481206,John Ludvig,D,PIT,24,9,0,1,1
1,8483398,Declan Carlile,D,TBL,31,5,0,1,1
1,8479367,William Lockwood,R,FLA,26,26,0,1,1
1,8475755,Alexander Petrovic,D,DAL,32,8,0,1,1
1,8479421,Jacob Moverare,D,LAK,26,8,0,1,1
1,8481043,Cole Koepke,L,BOS,26,20,0,1,1
1,8477993,Justin Kirkland,C,CGY,28,5,0,1,1
1,8479362,Riley Tufte,L,BOS,26,14,0,1,1
1,8482460,Matt Rempe,C,NYR,22,11,0,1,1
1,8478854,Ryan Shea,D,PIT,27,3,0,1,1
1,8482147,Jean-Luc Foudy,C,COL,22,29,0,1,1
1,8479330,Brandon Gignac,C,MTL,27,13,0,1,1
1,8480032,Shane Bowers,C,NJD,25,9,0,1,1
1,8483489,Fraser Minten,C,TOR,31,9,0,1,1
1,8483920,Pierrick Dube,R,WSH,23,5,0,1,1
1,8481462,Mason Morelli,L,VGK,28,15,0,1,1
1,8470794,Joe Pavelski,C,,40,0,0,0,0
1,8479321,Lucas Johansen,D,,27,0,0,0,0
1,8477950,Tony DeAngelo,D,,29,0,0,0,0
1,8471218,Blake Wheeler,R,,38,0,0,0,0
1,8475197,Tyson Barrie,D,,33,0,0,0,0
1,8474157,Max Pacioretty,L,,36,0,0,0,0
1,8475744,Evgeny Kuznetsov,C,,32,0,0,0,0
1,8474037,James van Riemsdyk,L,,35,0,0,0,0
1,8476907,Mackenzie MacEachern,L,,30,0,0,0,0
1,8480216,Jacob Peterson,C,,25,0,0,0,0
1,8474602,Justin Schultz,D,,34,0,0,0,0
1,8482222,Alexander Barabanov,L,,30,0,0,0,0
1,8474031,Kevin Shattenkirk,D,,35,0,0,0,0
1,8477330,Dominik Kubalik,L,,29,0,0,0,0
1,8480884,Calen Addison,D,,24,0,0,0,0
1,8475906,John Klingberg,D,,32,0,0,0,0
1,8480008,Adam Ruzicka,C,,25,0,0,0,0
1,8476884,Derrick Pouliot,D,,30,0,0,0,0
1,8476919,Chris Tierney,C,,30,0,0,0,0
1,8479415,Michael McLeod,C,,26,0,0,0,0
1,8474870,Tyler Johnson,C,,34,0,0,0,0
1,8470604,Jeff Carter,C,,39,0,0,0,0
1,8478104,Sammy Blais,L,,28,0,0,0,0
1,8474884,Mike Hoffman,C,,35,0,0,0,0
1,8481591,Sam Poulin,R,,23,0,0,0,0
1,8471274,Alex Goligoski,D,,39,0,0,0,0
1,8476871,Tanner Pearson,L,,32,0,0,0,0
1,8476393,Nick Cousins,C,,31,0,0,0,0
1,8479977,Kailer Yamamoto,R,,26,0,0,0,0
1,8479346,Dillon Dube,C,,26,0,0,0,0
1,8480184,Gustav Lindstrom,D,,26,0,0,0,0
1,8479376,Victor Mete,D,,26,0,0,0,0
1,8473449,Kyle Okposo,R,,36,0,0,0,0
1,8481058,Jesse Ylonen,R,,25,0,0,0,0
1,8475752,Tyler Pitlick,C,,33,0,0,0,0
1,8481239,Samuel Fagemo,L,,24,0,0,0,0
1,8480821,Filip Zadina,R,,25,0,0,0,0
1,8470966,Mark Giordano,D,,41,0,0,0,0
1,8478495,Denis Gurianov,R,,27,0,0,0,0
1,8477464,Nic Petan,C,,29,0,0,0,0
1,8478502,Dennis Gilbert,D,BUF,28,17,0,0,0
1,8478099,Kevin Labanc,R,,29,0,0,0,0
1,8482241,Radim Zohorna,L,,28,0,0,0,0
1,8474040,Sam Gagner,C,,35,0,0,0,0
1,8479514,Rem Pitlick,C,,27,0,0,0,0
1,8478430,Oliver Kylington,D,,27,0,0,0,0
1,8479533,Joona Koppanen,L,,26,0,0,0,0
1,8479984,Cal Foote,D,,26,0,0,0,0
1,8477126,Jayson Megna,C,,34,0,0,0,0
1,8475164,Jakob Silfverberg,R,,34,0,0,0,0
1,8474009,Nick Bonino,C,,36,0,0,0,0
1,8479458,Nikita Zaitsev,D,,33,0,0,0,0
1,8477944,Jakub Vrana,L,,28,0,0,0,0
1,8476323,Max McCormick,L,SEA,32,3,0,0,0
1,8471699,Andrew Cogliano,C,,37,0,0,0,0
1,8478067,Oskar Lindblom,L,,28,0,0,0,0
1,8471686,Marc Staal,D,,37,0,0,0,0
1,8470610,Zach Parise,L,,40,0,0,0,0
1,8478904,Steven Lorentz,C,,28,0,0,0,0
1,8473473,Milan Lucic,L,,36,0,0,0,0
1,8480031,Maxime Comtois,L,,25,0,0,0,0
1,8478512,Austin Czarnik,C,,32,0,0,0,0
1,8473504,Cal Clutterbuck,R,,37,0,0,0,0
1,8477454,Adam Erne,L,,29,0,0,0,0
1,8479383,Boris Katchouk,L,,26,0,0,0,0
1,8475825,Jani Hakanpää,D,,32,0,0,0,0
1,8477846,Ryan Carpenter,C,,33,0,0,0,0
1,8477930,Pierre-Edouard Bellemare,L,,39,0,0,0,0
1,8478400,Colin White,C,,27,0,0,0,0
1,8480226,Marián Studenic,R,,26,0,0,0,0
1,8480853,Liam Foudy,C,,24,0,0,0,0
1,8475797,Jarred Tinordi,D,,32,0,0,0,0
1,8479423,Alex Nylander,L,,26,0,0,0,0
1,8474618,Marco Scandella,D,,34,0,0,0,0
1,8478028,Fredrik Olofsson,L,,28,0,0,0,0
1,8474709,Matt Martin,L,,35,0,0,0,0
1,8482165,Yan Kuznetsov,D,CGY,22,19,0,0,0
1,8479522,Hardy Haman Aktell,D,WSH,26,8,0,0,0
1,8481070,Hugh McGing,L,,26,0,0,0,0
1,8474062,Riley Nash,C,NYR,35,20,0,0,0
1,8479546,Oskar Steen,C,,26,0,0,0,0
1,8474145,Robert Bortuzzo,D,,35,0,0,0,0
1,8476915,Jujhar Khaira,L,,30,0,0,0,0
1,8480274,Philip Kemp,D,EDM,25,2,0,0,0
1,8483546,Marshall Rifai,D,TOR,26,6,0,0,0
1,8477541,Dakota Mermis,D,TOR,30,8,0,0,0
1,8484326,Patrik Koch,D,UTA,28,1,0,0,0
1,8484321,Nikolas Matinpalo,D,OTT,26,1,0,0,0
1,8475278,Byron Froese,C,,33,0,0,0,0
1,8481812,Nikolai Knyzhov,D,,27,0,0,0,0
1,8478051,Max Willman,C,NJD,29,17,0,0,0
1,8478408,Travis Dermott,D,,28,0,0,0,0
1,8480306,Grant Hutton,D,NYI,29,6,0,0,0
1,8481077,John Leonard,L,,26,0,0,0,0
1,8479547,Matthew Phillips,R,,26,0,0,0,0
1,8482197,Adam Raska,R,MIN,23,2,0,0,0
1,8480836,Jonathan Gruden,C,,24,0,0,0,0
1,8481655,Cole Schwindt,R,CGY,23,4,0,0,0
1,8481690,Tyler Angle,C,,24,0,0,0,0
1,8475766,Austin Watson,L,,32,0,0,0,0
1,8481016,Ruslan Iskhakov,C,,24,0,0,0,0
1,8478078,Rourke Chartier,C,,28,0,0,0,0
1,8484259,Ondrej Pavel,C,COL,31,2,0,0,0
1,8483471,Brad Lambert,C,WPG,31,11,0,0,0
1,8475780,Chris Wagner,R,COL,33,11,0,0,0
1,8483401,Marc Johnstone,R,PIT,28,2,0,0,0
1,8484325,Waltteri Merela,C,TBL,26,19,0,0,0
1,8480776,Sheldon Rempal,R,,29,0,0,0,0
1,8478956,Samuel Laberge,L,NJD,27,1,0,0,0
1,8484255,Jason Polin,R,COL,25,4,0,0,0
1,8483609,Adam Klapka,R,CGY,24,3,0,0,0
1,8483432,Luca Del Bel Belluz,C,CBJ,31,2,0,0,0
1,8483045,Cameron Butler,R,CBJ,31,1,0,0,0
1,8481534,Raphael Lavoie,C,EDM,24,2,0,0,0
1,8482476,Emil Heineman,L,MTL,23,10,0,0,0
1,8483567,Georgii Merkulov,C,BOS,24,5,0,0,0
1,8481024,Linus Karlsson,C,VAN,25,12,0,0,0
1,8481578,Graeme Clarke,R,MIN,23,8,0,0,0
1,8484314,Jiri Smejkal,L,,28,0,0,0,0
2,8476453,Nikita Kucherov,R,TBL,31,82,58,115,173
2,8478402,Connor McDavid,C,EDM,27,76,54,91,145
2,8477492,Nathan MacKinnon,C,COL,29,81,52,84,136
2,8479318,Auston Matthews,C,TOR,27,78,81,53,134
2,8477956,David Pastrnak,R,BOS,28,77,65,55,120
2,8481559,Jack Hughes,C,NJD,23,77,49,70,119
2,8478483,Mitch Marner,R,TOR,27,80,41,76,117
2,8477939,William Nylander,R,TOR,28,82,52,63,115
2,8477934,Leon Draisaitl,C,EDM,29,78,44,69,113
2,8477404,Jake Guentzel,C,TBL,30,82,40,73,113
2,8478550,Artemi Panarin,L,NYR,33,80,29,82,111
2,8478010,Brayden Point,C,TBL,28,81,48,56,104
2,8478420,Mikko Rantanen,R,COL,28,78,52,51,103
2,8478403,Jack Eichel,C,VGK,28,78,43,59,102
2,8478445,Mathew Barzal,C,NYI,27,80,25,77,102
2,8480027,Jason Robertson,L,DAL,25,82,38,59,97
2,8480801,Brady Tkachuk,L,OTT,25,81,47,49,96
2,8478864,Kirill Kaprizov,L,MIN,27,76,46,50,96
2,8480002,Nico Hischier,C,NJD,25,76,31,63,94
2,8478398,Kyle Connor,L,WPG,28,77,46,45,91
2,8479343,Clayton Keller,R,UTA,26,78,39,51,90
2,8480800,Quinn Hughes,D,VAN,25,74,10,79,89
2,8477501,Valeri Nichushkin,R,COL,29,81,46,41,87
2,8482116,Tim Stützle,C,OTT,22,81,28,59,87
2,8476454,Ryan Nugent-Hopkins,C,EDM,31,78,19,68,87
2,8479314,Matthew Tkachuk,L,FLA,27,80,29,57,86
2,8479420,Tage Thompson,C,BUF,27,73,40,45,85
2,8480036,Miro Heiskanen,D,DAL,25,78,8,76,84
2,8479385,Jordan Kyrou,C,STL,26,78,40,43,83
2,8481557,Matt Boldy,L,MIN,23,74,33,50,83
2,8479542,Brandon Hagel,L,TBL,26,82,30,53,83
2,8471675,Sidney Crosby,C,PIT,37,79,42,40,82
2,8478414,Timo Meier,R,NJD,28,74,39,42,81
2,8476459,Mika Zibanejad,C,NYR,31,73,33,48,81
2,8479407,Jesper Bratt,L,NJD,26,78,26,54,80
2,8480830,Andrei Svechnikov,R,CAR,24,76,32,47,79
2,8476468,J.T. Miller,C,VAN,31,78,30,49,79
2,8476389,Vincent Trocheck,C,NYR,31,78,26,53,79
2,8477951,Nick Schmaltz,C,UTA,28,76,23,56,79
2,8476460,Mark Scheifele,C,WPG,31,74,31,47,78
2,8481540,Cole Caufield,R,MTL,23,76,42,35,77
2,8474564,Steven Stamkos,C,NSH,34,75,38,39,77
2,8476887,Filip Forsberg,L,NSH,30,74,33,44,77
2,8477933,Sam Reinhart,C,FLA,29,78,42,34,76
2,8478401,Pavel Zacha,C,BOS,27,81,29,47,76
2,8474141,Patrick Kane,R,DET,36,81,22,54,76
2,8480069,Cale Makar,D,COL,26,68,21,55,76
2,8477500,Bo Horvat,C,NYI,29,80,38,37,75
2,8475754,Brock Nelson,C,NYI,33,77,34,41,75
2,8475166,John Tavares,C,TOR,34,78,30,45,75
2,8482078,Lucas Raymond,L,DET,22,80,28,47,75
2,8480018,Nick Suzuki,C,MTL,25,76,27,48,75
2,8477493,Aleksander Barkov,C,FLA,29,78,26,49,75
2,8480012,Elias Pettersson,C,VAN,26,73,31,43,74
2,8475172,Nazem Kadri,C,CGY,34,78,24,50,74
2,8476456,Jonathan Huberdeau,C,CGY,31,75,16,58,74
2,8477409,Carter Verhaeghe,C,FLA,29,76,34,39,73
2,8482740,Wyatt Johnston,C,DAL,21,81,31,42,73
2,8477960,Adrian Kempe,R,LAK,28,79,29,44,73
2,8477942,Kevin Fiala,L,LAK,28,80,28,45,73
2,8480023,Robert Thomas,C,STL,25,76,23,50,73
2,8475167,Victor Hedman,D,TBL,34,79,20,53,73
2,8475168,Matt Duchene,C,DAL,33,81,34,38,72
2,8475913,Mark Stone,R,VGK,32,77,25,47,72
2,8478460,Zach Werenski,D,CBJ,27,78,17,55,72
2,8479337,Alex DeBrincat,R,DET,27,82,33,38,71
2,8477496,Elias Lindholm,C,BOS,30,77,26,45,71
2,8475184,Chris Kreider,L,NYR,33,77,43,27,70
2,8478427,Sebastian Aho,C,CAR,27,74,31,38,69
2,8474600,Roman Josi,D,NSH,34,76,18,51,69
2,8478440,Dylan Strome,C,WSH,27,78,31,36,67
2,8477955,Jared McCann,L,SEA,28,71,28,39,67
2,8479999,Casey Mittelstadt,C,COL,26,81,23,44,67
2,8476905,Chandler Stephenson,C,SEA,30,78,22,45,67
2,8479323,Adam Fox,D,NYR,26,74,19,48,67
2,8476346,Johnny Gaudreau,L,CBJ,31,72,19,48,67
2,8477946,Dylan Larkin,C,DET,28,80,35,31,66
2,8477476,Artturi Lehkonen,L,COL,29,80,33,33,66
2,8478444,Brock Boeser,R,VAN,27,74,30,36,66
2,8476881,Tomas Hertl,C,VGK,31,75,29,37,66
2,8474578,Erik Karlsson,D,PIT,34,80,18,48,66
2,8475692,Mats Zuccarello,R,MIN,37,74,15,51,66
2,8477940,Nikolaj Ehlers,L,WPG,28,70,24,41,65
2,8475810,Bryan Rust,R,PIT,32,72,28,36,64
2,8478438,Tommy Novak,C,NSH,27,71,19,45,64
2,8480865,Noah Dobson,D,NYI,24,78,17,47,64
2,8477494,Jonathan Drouin,L,COL,29,80,15,49,64
2,8481711,Matias Maccelli,L,UTA,24,72,19,44,63
2,8477504,Josh Morrissey,D,WPG,29,71,17,46,63
2,8471214,Alex Ovechkin,L,WSH,39,75,30,32,62
2,8482093,Seth Jarvis,C,CAR,22,74,30,32,62
2,8475794,Tyler Seguin,C,DAL,32,79,30,32,62
2,8477949,Alex Tuch,R,BUF,28,73,25,37,62
2,8480208,Drake Batherson,R,OTT,26,78,18,44,62
2,8479325,Charlie McAvoy,D,BOS,27,76,11,51,62
2,8478449,Roope Hintz,C,DAL,28,81,36,25,61
2,8480015,Owen Tippett,R,PHI,25,76,30,31,61
2,8484144,Connor Bedard,C,CHI,19,71,26,35,61
2,8478439,Travis Konecny,R,PHI,27,75,24,37,61
2,8474679,Gustav Nyquist,C,NSH,35,74,19,42,61
2,8480803,Evan Bouchard,D,EDM,25,76,11,50,61
2,8473986,Alex Killorn,L,ANA,35,74,29,31,60
2,8471215,Evgeni Malkin,C,PIT,38,73,27,33,60
2,8473419,Brad Marchand,L,BOS,36,79,23,37,60
2,8475784,Jeff Skinner,C,EDM,32,74,23,37,60
2,8473512,Claude Giroux,R,OTT,36,79,19,41,60
2,8475170,Brayden Schenn,C,STL,33,73,18,42,60
2,8480839,Rasmus Dahlin,D,BUF,24,70,15,45,60
2,8476882,Teuvo Teravainen,C,CHI,30,67,26,33,59
2,8471685,Anze Kopitar,C,LAK,37,78,22,37,59
2,8475158,Ryan O'Reilly,C,NSH,33,71,19,40,59
2,8479675,Trevor Moore,L,LAK,29,81,19,40,59
2,8473994,Jamie Benn,L,DAL,35,80,19,40,59
2,8476853,Morgan Rielly,D,TOR,30,64,13,46,59
2,8482159,Tyson Foerster,R,PHI,22,80,24,34,58
2,8478975,Mason Marchment,L,DAL,29,80,23,34,57
2,8482149,Cole Perfetti,C,WPG,22,75,23,34,57
2,8474590,John Carlson,D,WSH,34,71,16,41,57
2,8478873,Troy Terry,R,ANA,27,75,27,29,56
2,8475786,Zach Hyman,L,EDM,32,76,26,30,56
2,8481596,Shane Pinto,C,OTT,24,77,24,32,56
2,8482684,Luke Hughes,D,NJD,21,73,8,48,56
2,8478493,Joel Eriksson Ek,C,MIN,27,77,31,24,55
2,8478047,Michael Bunting,L,PIT,29,69,19,36,55
2,8475745,Charlie Coyle,C,BOS,32,76,15,39,54
2,8477964,Ivan Barbashev,C,VGK,29,76,14,40,54
2,8480797,Joel Farabee,L,PHI,24,76,31,22,53
2,8482109,Alexis Lafrenière,L,NYR,23,68,30,23,53
2,8477456,J.T. Compher,L,DET,29,76,20,33,53
2,8476479,Phillip Danault,C,LAK,31,82,19,34,53
2,8481577,Philip Tomasino,C,NSH,23,69,18,35,53
2,8477447,Shea Theodore,D,VGK,29,60,16,37,53
2,8477503,Max Domi,C,TOR,29,80,13,40,53
2,8479425,Filip Hronek,D,VAN,27,74,8,45,53
2,8479410,Mikhail Sergachev,D,UTA,26,71,5,48,53
2,8478519,Anthony Cirelli,C,TBL,27,80,26,26,52
2,8476539,Jonathan Marchessault,R,NSH,34,70,25,27,52
2,8474586,Jordan Eberle,R,SEA,34,74,25,27,52
2,8477479,Tyler Bertuzzi,L,CHI,29,64,22,29,51
2,8479400,Pierre-Luc Dubois,L,WSH,26,74,17,34,51
2,8475191,Reilly Smith,R,NYR,33,72,13,38,51
2,8481581,Thomas Harley,D,DAL,23,78,12,39,51
2,8477986,Brandon Montour,D,SEA,30,69,12,39,51
2,8476448,William Karlsson,C,VGK,31,76,26,24,50
2,8477511,Anthony Mantha,R,CGY,30,71,26,24,50
2,8480039,Martin Necas,C,CAR,25,63,20,30,50
2,8477497,Sean Monahan,C,CBJ,30,69,20,30,50
2,8477935,Sam Bennett,C,FLA,28,81,19,31,50
2,8481533,Trevor Zegras,C,ANA,23,76,17,33,50
2,8477495,Seth Jones,D,CHI,30,69,12,38,50
2,8470613,Brent Burns,D,CAR,39,80,10,40,50
2,8474563,Drew Doughty,D,LAK,35,67,10,40,50
2,8474565,Alex Pietrangelo,D,VGK,34,66,9,41,50
2,8479525,Ross Colton,C,COL,28,79,23,26,49
2,8481068,Yegor Sharangovich,C,CGY,26,72,19,30,49
2,8482113,Anton Lundell,C,FLA,23,74,19,30,49
2,8484153,Leo Carlsson,C,ANA,20,69,15,34,49
2,8475722,Jason Zucker,L,BUF,32,71,29,19,48
2,8476399,Blake Coleman,C,CGY,33,73,27,21,48
2,8479987,Morgan Geekie,C,BOS,26,76,22,26,48
2,8475714,Calle Jarnkrok,C,TOR,33,75,21,27,48
2,8478469,Thomas Chabot,D,OTT,27,77,18,30,48
2,8477021,Alex Kerfoot,C,UTA,30,78,18,30,48
2,8483515,Juraj Slafkovsky,L,MTL,20,75,14,34,48
2,8478397,Rasmus Andersson,D,CGY,28,71,13,35,48
2,8479591,Michael Eyssimont,C,TBL,28,81,13,35,48
2,8476906,Shayne Gostisbehere,D,CAR,31,73,9,39,48
2,8478856,Conor Garland,R,VAN,28,79,25,22,47
2,8475726,Tyler Toffoli,C,SJS,32,68,24,23,47
2,8471698,T.J. Oshie,R,WSH,38,64,23,24,47
2,8481528,Dylan Cozens,C,BUF,23,67,20,27,47
2,8475765,Vladimir Tarasenko,R,DET,33,81,16,31,47
2,8477402,Pavel Buchnevich,L,STL,29,67,16,31,47
2,8476875,Mike Matheson,D,MTL,30,73,11,36,47
2,8478038,Devon Toews,D,COL,30,71,10,37,47
2,8476923,Damon Severson,D,CBJ,30,78,10,37,47
2,8482699,Dylan Guenther,R,UTA,21,79,25,21,46
2,8476483,Rickard Rakell,R,PIT,31,74,25,21,46
2,8477416,Oliver Bjorkstrand,R,SEA,29,75,23,23,46
2,8477407,Anthony Duclair,L,NYI,29,79,23,23,46
2,8477426,Nicholas Paul,L,TBL,29,81,23,23,46
2,8482665,Matty Beniers,C,SEA,22,76,16,30,46
2,8482124,Quinton Byfield,R,LAK,22,78,16,30,46
2,8483505,Matthew Poitras,C,BOS,20,77,13,33,46
2,8481703,Valtteri Puustinen,R,PIT,25,67,8,38,46
2,8475753,Justin Faulk,D,STL,32,68,7,39,46
2,8483808,Andrei Kuzmenko,L,CGY,28,75,22,23,45
2,8484166,Adam Fantilli,C,CBJ,20,70,21,24,45
2,8478466,Daniel Sprong,R,VAN,27,72,15,30,45
2,8471724,Kris Letang,D,PIT,37,80,10,35,45
2,8475798,Mikael Granlund,C,SJS,32,68,5,40,45
2,8476880,Tom Wilson,R,WSH,30,73,26,18,44
2,8482745,Mason McTavish,C,ANA,21,73,21,23,44
2,8475799,Nino Niederreiter,R,WPG,32,66,20,24,44
2,8480188,Fabian Zetterlund,L,SJS,25,68,19,25,44
2,8480798,Philipp Kurashev,C,CHI,25,67,14,30,44
2,8482092,Ridly Greig,C,OTT,22,74,13,31,44
2,8475169,Evander Kane,L,EDM,33,75,28,15,43
2,8476432,Boone Jenner,C,CBJ,31,71,26,17,43
2,8479339,Patrik Laine,L,CBJ,26,66,17,26,43
2,8478055,Gustav Forsling,D,FLA,28,76,11,32,43
2,8482671,Owen Power,D,BUF,22,71,9,34,43
2,8478407,Vince Dunn,D,SEA,28,72,7,36,43
2,8474150,Mikael Backlund,C,CGY,35,77,22,20,42
2,8474102,David Perron,L,OTT,36,79,19,23,42
2,8473422,Nick Foligno,L,CHI,37,63,19,23,42
2,8478462,Nicolas Roy,C,VGK,27,78,16,26,42
2,8481560,Arthur Kaliyev,R,LAK,23,78,27,14,41
2,8475151,Kyle Palmieri,C,NYI,33,77,23,18,41
2,8479992,Michael Rasmussen,C,DET,25,79,22,19,41
2,8481186,Logan O'Connor,R,COL,28,80,21,20,41
2,8479365,Trent Frederic,C,BOS,26,77,21,20,41
2,8482705,Cole Sillinger,C,CBJ,21,70,21,20,41
2,8482110,Dawson Mercer,C,NJD,23,74,18,23,41
2,8476419,Jean-Gabriel Pageau,C,NYI,32,74,16,25,41
2,8482720,Matthew Knies,L,TOR,22,74,11,30,41
2,8477948,Travis Sanheim,D,PHI,28,73,11,30,41
2,8483431,Logan Cooley,C,UTA,20,74,19,21,40
2,8477932,Aaron Ekblad,D,FLA,28,72,15,25,40
2,8477429,Andrew Copp,C,DET,30,77,13,27,40
2,8476792,Torey Krug,D,STL,33,74,10,30,40
2,8476292,Ondrej Palat,L,NJD,33,70,23,16,39
2,8475287,Erik Haula,L,NJD,33,68,20,19,39
2,8484145,Zach Benson,L,BUF,19,63,16,23,39
2,8478891,Mason Appleton,C,WPG,28,61,15,24,39
2,8480185,Eetu Luostarinen,C,FLA,26,78,14,25,39
2,8476885,Jacob Trouba,D,NYR,30,76,11,28,39
2,8475200,Dmitry Orlov,D,CAR,33,73,11,28,39
2,8476438,Brandon Saad,L,STL,32,72,26,12,38
2,8481604,Pavel Dorofeyev,L,VGK,24,72,24,14,38
2,8474641,Adam Henrique,C,EDM,34,75,23,15,38
2,8478498,Jake DeBrusk,L,VAN,28,73,16,22,38
2,8478542,Evan Rodrigues,C,FLA,31,78,12,26,38
2,8475793,Ryan Johansen,C,PHI,32,77,9,29,38
2,8476462,Dougie Hamilton,D,NJD,31,69,9,29,38
2,8482122,Brock Faber,D,MIN,22,82,7,31,38
2,8482712,Oskar Olausson,R,COL,22,76,2,36,38
2,8478366,Frank Vatrano,R,ANA,30,72,25,12,37
2,8479996,Cody Glass,C,NSH,25,63,12,25,37
2,8476480,Vladislav Namestnikov,C,WPG,32,67,11,26,37
2,8481624,Ilya Mikheyev,R,CHI,30,56,19,17,36
2,8480009,Eeli Tolvanen,R,SEA,25,75,18,18,36
2,8474715,Cameron Atkinson,R,TBL,35,82,17,19,36
2,8477451,Ryan Hartman,R,MIN,30,73,16,20,36
2,8480078,Filip Chytil,C,NYR,25,68,16,20,36
2,8476461,Sean Couturier,C,PHI,32,64,13,23,36
2,8481546,Cam York,D,PHI,23,72,13,23,36
2,8478233,Andrew Mangiapane,L,WSH,28,72,11,25,36
2,8482105,Jake Sanderson,D,OTT,22,72,8,28,36
2,8476979,Erik Gustafsson,D,DET,32,77,6,30,36
2,8480064,Josh Norris,C,OTT,25,79,20,15,35
2,8482475,Yegor Chinakhov,R,CBJ,23,67,17,18,35
2,8482175,JJ Peterka,R,BUF,22,70,16,19,35
2,8478458,John (Jack) Roslovic,C,CAR,27,58,13,22,35
2,8482097,Jack Quinn,R,BUF,23,58,13,22,35
2,8478115,Pierre Engvall,L,NYI,28,77,12,23,35
2,8477346,MacKenzie Weegar,D,CGY,30,75,10,25,35
2,8476958,Jaccob Slavin,D,CAR,30,76,7,28,35
2,8480014,Gabriel Vilardi,C,WPG,25,68,24,10,34
2,8475760,Nick Bjugstad,C,UTA,32,67,18,16,34
2,8475768,Jaden Schwartz,C,SEA,32,71,15,19,34
2,8476869,Brady Skjei,D,NSH,30,69,12,22,34
2,8480220,Noah Cates,L,PHI,25,73,12,22,34
2,8482133,Thomas Bordeleau,C,SJS,22,65,9,25,34
2,8477488,Brett Pesce,D,NJD,30,73,8,26,34
2,8476392,Adam Lowry,C,WPG,31,62,7,27,34
2,8474151,Ryan McDonagh,D,TBL,35,76,7,27,34
2,8476854,Hampus Lindholm,D,BOS,30,77,6,28,34
2,8480817,K'Andre Miller,D,NYR,24,72,6,28,34
2,8478474,Lawson Crouse,L,UTA,27,77,18,15,33
2,8477998,Warren Foegele,L,LAK,28,79,16,17,33
2,8478109,Victor Olofsson,L,VGK,29,70,16,17,33
2,8475314,Anders Lee,L,NYI,34,81,15,18,33
2,8481618,Alex Newhook,C,MTL,23,75,14,19,33
2,8480068,Ryan Poehling,C,PHI,25,64,14,19,33
2,8474149,Evgenii Dadonov,R,DAL,35,81,13,20,33
2,8476872,Scott Laughton,C,PHI,30,71,11,22,33
2,8473533,Jordan Staal,C,CAR,36,65,11,22,33
2,8476474,Stefan Noesen,R,NJD,31,68,10,23,33
2,8476927,Teddy Blueger,C,VAN,30,62,9,24,33
2,8480336,Sean Walker,D,CAR,30,72,9,24,33
2,8480434,Sean Durzi,D,UTA,26,69,8,25,33
2,8477953,Kasperi Kapanen,R,STL,28,68,7,26,33
2,8476463,Jonas Brodin,D,MIN,31,79,3,30,33
2,8477952,Robby Fabbri,C,ANA,28,66,18,14,32
2,8482089,Jake Neighbours,L,STL,22,66,17,15,32
2,8478057,Dakota Joshua,C,VAN,28,68,15,17,32
2,8482702,Logan Stankoven,C,DAL,21,78,15,17,32
2,8475848,Brendan Gallagher,R,MTL,32,64,14,18,32
2,8476921,Jordan Martinook,L,CAR,32,62,14,18,32
2,8475193,Tomas Tatar,L,NJD,34,65,13,19,32
2,8475218,Mattias Ekholm,D,EDM,34,75,12,20,32
2,8481542,Moritz Seider,D,DET,23,77,9,23,32
2,8475149,Marcus Johansson,L,MIN,34,64,9,23,32
2,8474053,Logan Couture,C,SJS,35,67,9,23,32
2,8474189,Lars Eller,C,PIT,35,63,16,15,31
2,8482117,Lukas Reichel,L,CHI,22,61,15,16,31
2,8477839,Conor Sheary,L,TBL,32,80,13,18,31
2,8478042,Viktor Arvidsson,L,EDM,31,73,12,19,31
2,8481524,Bowen Byram,D,BUF,23,69,12,19,31
2,8476278,Colin Blackwell,C,DAL,31,81,12,19,31
2,8476897,Oskar Sundqvist,C,STL,30,65,12,19,31
2,8483445,Cutter Gauthier,L,ANA,20,63,11,20,31
2,8482660,Kent Johnson,C,CBJ,22,63,10,21,31
2,8478472,Mathieu Joseph,R,STL,27,68,10,21,31
2,8480113,Alex Iafallo,L,WPG,31,63,15,15,30
2,8479345,Jakob Chychrun,D,WSH,26,59,12,18,30
2,8482667,William Eklund,L,SJS,22,69,11,19,30
2,8477979,Nicolas Aube-Kubel,R,BUF,28,61,11,19,30
2,8480878,Nils Lundkvist,D,DAL,24,73,11,19,30
2,8476891,Matthew Grzelcyk,D,PIT,30,72,5,25,30
2,8475171,Oliver Ekman-Larsson,D,TOR,33,68,5,25,30
2,8475763,Kevin Hayes,R,PIT,32,70,13,16,29
2,8480459,Pius Suter,C,VAN,28,70,13,16,29
2,8478396,Noah Hanifin,D,VGK,27,53,11,18,29
2,8476458,Ryan Strome,C,ANA,31,71,8,21,29
2,8480145,Neal Pionk,D,WPG,29,75,4,25,29
2,8482125,Alexander Holtz,R,VGK,22,70,16,12,28
2,8479353,Brett Howden,C,VGK,26,71,16,12,28
2,8481535,Nils Hoglander,L,VAN,24,60,15,13,28
2,8476826,Yanni Gourde,C,SEA,33,70,10,18,28
2,8481704,Juuso Parssinen,C,NSH,23,55,8,20,28
2,8477444,Andre Burakovsky,L,SEA,29,64,7,21,28
2,8478500,Ivan Provorov,D,CBJ,27,80,6,22,28
2,8481523,Kirby Dach,C,MTL,23,69,5,23,28
2,8475690,Chris Tanev,D,TOR,35,66,4,24,28
2,8479982,Conor Timmins,D,TOR,26,60,3,25,28
2,8478020,Michael Amadio,R,OTT,28,72,20,7,27
2,8478013,Jake Walman,D,SJS,28,71,16,11,27
2,8482749,Joshua Roy,R,MTL,21,65,14,13,27
2,8476981,Josh Anderson,R,MTL,30,74,13,14,27
2,8481554,Kaapo Kakko,R,NYR,23,77,13,14,27
2,8477478,William Carrier,L,CAR,30,58,13,14,27
2,8479293,Brandon Tanev,L,SEA,33,66,12,15,27
2,8479390,Taylor Raddysh,R,WSH,26,62,9,18,27
2,8480871,Adam Boqvist,D,FLA,24,69,8,19,27
2,8475764,Cam Fowler,D,ANA,33,72,5,22,27
2,8482111,Justin Barron,D,MTL,23,58,5,22,27
2,8476917,Adam Pelech,D,NYI,30,77,4,23,27
2,8477506,Ryan Pulock,D,NYI,30,75,4,23,27
2,8482259,Bobby McMann,C,TOR,28,65,18,8,26
2,8478046,Danton Heinen,L,VAN,29,63,15,11,26
2,8480003,Jesper Boqvist,C,FLA,26,65,15,11,26
2,8476469,Joel Armia,R,MTL,31,70,15,11,26
2,8470621,Corey Perry,R,EDM,39,74,11,15,26
2,8483491,Ivan Miroshnichenko,L,WSH,20,51,10,16,26
2,8476925,Colton Sissons,C,NSH,31,66,9,17,26
2,8482146,Luke Evangelista,R,NSH,22,69,8,18,26
2,8480849,Barrett Hayton,C,UTA,24,63,8,18,26
2,8480028,Morgan Frost,C,PHI,25,68,7,19,26
2,8483468,Jiri Kulich,C,BUF,20,63,7,19,26
2,8484203,Bradly Nadeau,L,CAR,19,67,6,20,26
2,8479402,Jake Bean,D,CGY,26,66,5,21,26
2,8480873,Rasmus Sandin,D,WSH,24,68,4,22,26
2,8481606,Jordan Spence,D,LAK,23,67,3,23,26
2,8482067,Connor Mackey,D,NYR,28,62,3,23,26
2,8482655,Janis Moser,D,TBL,24,77,1,25,26
2,8480893,Kirill Marchenko,R,CBJ,24,61,15,10,25
2,8480802,Ryan McLeod,C,BUF,25,73,13,12,25
2,8481582,Nicholas Robertson,L,TOR,23,56,12,13,25
2,8476878,Zemgus Girgensons,C,TBL,30,79,12,13,25
2,8480813,Joe Veleno,C,DET,24,75,11,14,25
2,8480855,Jack McBain,C,UTA,24,73,10,15,25
2,8479351,Sam Steel,C,DAL,26,79,9,16,25
2,8483490,Pavel Mintyukov,D,ANA,21,72,6,19,25
2,8479639,Dylan Coghlan,D,WPG,26,66,6,19,25
2,8474716,Jared Spurgeon,D,MIN,35,75,5,20,25
2,8476457,Adam Larsson,D,SEA,32,74,5,20,25
2,8481441,Joe Snively,C,DET,28,67,5,20,25
2,8476429,Scott Mayfield,D,NYI,32,73,4,21,25
2,8480281,Alexey Toropchenko,R,STL,25,61,17,7,24
2,8482101,Danil Gushchin,L,SJS,22,55,14,10,24
2,8477425,Miles Wood,L,COL,29,75,13,11,24
2,8482074,Connor Zary,C,CGY,23,66,13,11,24
2,8480829,Jesperi Kotkaniemi,C,CAR,24,68,11,13,24
2,8473563,Nicklas Backstrom,C,WSH,37,43,9,15,24
2,8477406,Mattias Janmark,C,EDM,32,70,8,16,24
2,8483524,Shane Wright,C,SEA,20,62,12,11,23
2,8481656,Aliaksei Protas,C,WSH,23,63,10,13,23
2,8480789,Oliver Wahlstrom,R,NYI,24,68,9,14,23
2,8482809,Jackson Blake,R,CAR,21,55,9,14,23
2,8478432,Christian Fischer,R,DET,27,71,7,16,23
2,8477435,Ryan Graves,D,PIT,29,78,6,17,23
2,8477987,Ryan Donato,C,CHI,28,56,6,17,23
2,8478463,Anthony Beauvillier,L,PIT,27,70,5,18,23
2,8480806,Isac Lundestrom,C,ANA,25,65,5,18,23
2,8480980,Connor Dewar,C,TOR,25,72,12,10,22
2,8477498,Darnell Nurse,D,EDM,29,76,11,11,22
2,8477505,Alexander Wennberg,C,SJS,30,57,10,12,22
2,8475220,Marcus Foligno,L,MIN,33,60,10,12,22
2,8479315,Joey Anderson,R,CHI,26,43,10,12,22
2,8477947,Sonny Milano,L,WSH,28,75,10,12,22
2,8481093,Rafael Harvey-Pinard,L,MTL,25,60,10,12,22
2,8483457,Lane Hutson,D,MTL,20,63,9,13,22
2,8479393,Noah Gregor,L,OTT,26,74,7,15,22
2,8482624,Daniil Miromanov,D,CGY,27,66,5,17,22
2,8477220,Nate Schmidt,D,FLA,33,71,5,17,22
2,8480043,Timothy Liljegren,D,TOR,25,70,2,20,22
2,8482245,Artem Zub,D,OTT,29,67,2,20,22
2,8475855,Jesper Fast,R,CAR,33,64,12,9,21
2,8480074,Alexandre Texier,C,STL,25,52,11,10,21
2,8480289,Morgan Barron,C,WPG,26,53,11,10,21
2,8480835,Jack Drury,C,CAR,24,51,10,11,21
2,8481580,Connor McMichael,C,WSH,23,68,9,12,21
2,8479316,Luke Kunin,C,SJS,27,55,9,12,21
2,8480995,Pontus Holmberg,R,TOR,25,57,8,13,21
2,8480448,Parker Kelly,L,COL,25,79,8,13,21
2,8477989,Christian Dvorak,C,MTL,28,56,7,14,21
2,8479398,Samuel Girard,D,COL,26,68,5,16,21
2,8479983,Mario Ferraro,D,SJS,26,68,5,16,21
2,8479976,Juuso Valimaki,D,UTA,26,61,5,16,21
2,8478911,Matt Roy,D,WSH,29,66,5,16,21
2,8481527,Kaedan Korczak,D,VGK,23,50,4,17,21
2,8477969,Marcus Pettersson,D,PIT,28,78,4,17,21
2,8473507,Jeff Petry,D,DET,37,69,4,17,21
2,8475208,Brian Dumoulin,D,ANA,33,62,4,17,21
2,8482087,Kaiden Guhle,D,MTL,22,66,1,20,21
2,8477499,Rasmus Ristolainen,D,PHI,30,63,1,20,21
2,8480049,Dylan Samberg,D,WPG,25,63,0,21,21
2,8482737,Zack Bolduc,C,STL,21,55,13,7,20
2,8473453,Trevor Lewis,C,LAK,37,74,12,8,20
2,8479661,Tanner Jeannot,L,LAK,27,76,10,10,20
2,8476918,Jimmy Vesey,L,NYR,31,69,10,10,20
2,8481553,Bobby Brink,R,PHI,23,62,9,11,20
2,8481537,Nikita Okhotiuk,D,CGY,24,52,9,11,20
2,8481601,Simon Holmstrom,R,NYI,23,67,9,11,20
2,8475791,Taylor Hall,L,CHI,33,61,8,12,20
2,8477380,Jonny Brodzinski,C,NYR,31,54,8,12,20
2,8478882,Vladislav Gavrikov,D,LAK,29,65,6,14,20
2,8482142,Jamie Drysdale,D,PHI,22,68,6,14,20
2,8480950,Ilya Lyubushkin,D,DAL,30,64,6,14,20
2,8482073,Braden Schneider,D,NYR,23,65,5,15,20
2,8480891,Michael Kesselring,D,UTA,24,56,4,16,20
2,8480073,Erik Brannstrom,D,COL,25,57,4,16,20
2,8478178,Darren Raddysh,D,TBL,28,69,3,17,20
2,8476331,Dylan DeMelo,D,WPG,31,68,2,18,20
2,8476931,Jake McCabe,D,TOR,31,62,0,20,20
2,8479619,Michael Carcone,L,UTA,28,65,14,5,19
2,8475231,Casey Cizikas,C,NYI,33,73,10,9,19
2,8477369,Carson Soucy,D,VAN,30,68,10,9,19
2,8483565,Nick Blankenburg,D,NSH,26,64,9,10,19
2,8480748,Kiefer Sherwood,L,VAN,29,63,8,11,19
2,8483493,Frank Nazar,C,CHI,20,55,8,11,19
2,8482192,Isaak Phillips,D,CHI,23,49,7,12,19
2,8480021,Jack Studnicka,C,LAK,25,66,7,12,19
2,8476892,Colton Parayko,D,STL,31,66,6,13,19
2,8481521,Ronnie Attard,D,PHI,25,54,6,13,19
2,8478133,Jake Evans,C,MTL,28,68,5,14,19
2,8475279,Ben Chiarot,D,DET,33,70,5,14,19
2,8475233,David Savard,D,MTL,34,64,5,14,19
2,8477507,Nikita Zadorov,D,BOS,29,67,5,14,19
2,8481522,Peyton Krebs,C,BUF,23,63,5,14,19
2,8478840,Will Borgen,D,SEA,28,60,4,15,19
2,8474166,Alec Martinez,D,CHI,37,55,4,15,19
2,8475462,Radko Gudas,D,ANA,34,67,3,16,19
2,8476879,Cody Ceci,D,EDM,31,68,2,17,19
2,8481477,Nico Sturm,C,SJS,29,56,14,4,18
2,8476329,Travis Boyd,C,MIN,31,47,11,7,18
2,8478569,Noel Acciari,C,PIT,33,53,9,9,18
2,8477392,Hudson Fasching,R,NYI,29,63,9,9,18
2,8478434,Keegan Kolesar,R,VGK,27,63,6,12,18
2,8479336,Carl Grundstrom,R,SJS,27,53,6,12,18
2,8479980,Nicolas Hague,D,VGK,26,54,3,15,18
2,8477845,Trevor van Riemsdyk,D,WSH,33,64,3,15,18
2,8476312,Josh Manson,D,COL,33,64,2,16,18
2,8481059,Scott Perunovich,D,STL,26,60,2,16,18
2,8476822,Luke Glendening,C,TBL,35,80,13,4,17
2,8479718,Alex Barré-Boulet,C,MTL,27,57,11,6,17
2,8477573,Nathan Walker,L,STL,30,49,9,8,17
2,8479671,Mathieu Olivier,R,CBJ,27,51,9,8,17
2,8480762,Eric Robinson,L,CAR,29,62,8,9,17
2,8480144,David Kampf,C,TOR,29,68,8,9,17
2,8482679,Matt Coronato,R,CGY,22,66,7,10,17
2,8476422,Mike Reilly,D,NYI,31,78,6,11,17
2,8478043,Sam Lafferty,C,BUF,29,64,5,12,17
2,8476525,Colin Miller,D,WPG,32,64,5,12,17
2,8478468,Jeremy Lauzon,D,NSH,27,51,5,12,17
2,8479414,Nathan Bastian,R,NJD,27,57,5,12,17
2,8475343,Nic Dowd,C,WSH,34,57,4,13,17
2,8478970,Jalen Chatfield,D,CAR,28,65,4,13,17
2,8476467,Jamie Oleksiak,D,SEA,32,72,4,13,17
2,8474673,TJ Brodie,D,CHI,34,60,3,14,17
2,8478452,Caleb Jones,D,LAK,27,50,3,14,17
2,8481568,Alex Vlasic,D,CHI,23,52,3,14,17
2,8475188,Brayden McNabb,D,VGK,33,58,2,15,17
2,8475790,Erik Gudbranson,D,CBJ,32,76,2,15,17
2,8480807,Mattias Samuelsson,D,BUF,24,54,2,15,17
2,8478136,Jake Middleton,D,MIN,28,76,0,17,17
2,8481178,Egor Zamula,D,PHI,24,55,0,17,17
2,8481032,Paul Cotter,C,NJD,25,63,10,6,16
2,8478585,Derek Ryan,C,EDM,38,60,9,7,16
2,8482079,Marco Rossi,C,MIN,23,53,8,8,16
2,8477903,Garnet Hathaway,R,PHI,33,61,8,8,16
2,8483495,Simon Nemec,D,NJD,20,63,7,9,16
2,8477450,Jason Dickinson,C,CHI,29,64,6,10,16
2,8476934,Brock McGinn,L,ANA,30,53,6,10,16
2,8476902,Esa Lindell,D,DAL,30,76,4,12,16
2,8482666,Scott Morrow,D,CAR,22,53,4,12,16
2,8476952,Dominic Toninato,C,WPG,30,36,3,13,16
2,8483549,Lucas Condotta,L,MTL,27,32,3,13,16
2,8480222,Sebastian Aho,D,PIT,28,71,2,14,16
2,8475181,Nick Leddy,D,STL,33,72,1,15,16
2,8471709,Marc-Edouard Vlasic,D,SJS,37,62,1,15,16
2,8482157,Will Cuylle,L,NYR,22,62,11,4,15
2,8478508,Yakov Trenin,C,MIN,27,53,10,5,15
2,8482055,Drew O'Connor,L,PIT,26,63,9,6,15
2,8483499,Liam Ohgren,L,MIN,20,57,9,6,15
2,8476873,Mark Jankowski,C,NSH,30,49,9,6,15
2,8479344,Jesse Puljujarvi,R,PIT,26,50,9,6,15
2,8482155,Alex Laferriere,R,LAK,23,71,9,6,15
2,8480205,Emil Bemstrom,C,PIT,25,58,8,7,15
2,8477931,Tomas Nosek,L,FLA,32,59,7,8,15
2,8476374,Sean Kuraly,C,CBJ,31,61,6,9,15
2,8477015,Connor Brown,R,EDM,30,62,5,10,15
2,8483482,Tristan Luneau,D,ANA,20,61,5,10,15
2,8482077,Dylan Holloway,L,EDM,23,55,5,10,15
2,8480246,Nick Perbix,D,TBL,26,76,4,11,15
2,8477919,Frederick Gaudreau,C,MIN,31,65,4,11,15
2,8484149,Gavin Brindley,C,CBJ,20,50,4,11,15
2,8478399,Jonas Siegenthaler,D,NJD,27,63,4,11,15
2,8482744,James Malatesta,L,CBJ,21,42,4,11,15
2,8482176,Wyatt Kaiser,D,CHI,22,53,3,12,15
2,8475324,Nick Jensen,D,OTT,34,66,1,14,15
2,8479291,Kevin Rooney,C,CGY,31,50,10,4,14
2,8482166,Shakir Mukhamadullin,D,SJS,22,59,8,6,14
2,8481716,Dmitri Voronkov,L,CBJ,24,47,8,6,14
2,8479941,Justin Danforth,R,CBJ,31,45,7,7,14
2,8482062,Cole Smith,L,NSH,29,48,7,7,14
2,8481481,Blake Lizotte,C,PIT,27,53,5,9,14
2,8482148,Hendrix Lapierre,C,WSH,22,44,5,9,14
2,8479066,Ryan Lomberg,L,CGY,30,60,5,9,14
2,8475842,Sam Carrick,C,NYR,32,56,4,10,14
2,8474574,Tyler Myers,D,VAN,34,65,3,11,14
2,8480796,Martin Fehervary,D,WSH,25,52,3,11,14
2,8479026,Philippe Myers,D,TOR,27,54,3,11,14
2,8476624,Barclay Goodrow,C,SJS,31,51,3,11,14
2,8479371,Dante Fabbro,D,NSH,26,60,2,12,14
2,8481014,Alexander Romanov,D,NYI,24,76,2,12,14
2,8476960,Andreas Athanasiou,C,CHI,30,48,2,12,14
2,8478443,Brandon Carlo,D,BOS,28,60,2,12,14
2,8478416,Erik Cernak,D,TBL,27,69,2,12,14
2,8477335,Kyle Burroughs,D,LAK,29,47,2,12,14
2,8479998,Mikey Anderson,D,LAK,25,61,2,12,14
2,8481550,Adam Beckman,L,NJD,23,42,2,12,14
2,8476988,Matt Benning,D,SJS,30,62,1,13,14
2,8470600,Ryan Suter,D,STL,39,61,1,13,14
2,8476858,Phillip Di Giuseppe,L,VAN,31,37,10,3,13
2,8477446,Michael McCarron,R,NSH,29,62,9,4,13
2,8479328,Julien Gauthier,R,NYI,27,61,9,4,13
2,8482659,Josh Doan,R,UTA,22,51,8,5,13
2,8479439,Jacob MacDonald,D,COL,31,46,8,5,13
2,8480025,MacKenzie Entwistle,R,FLA,25,65,7,6,13
2,8479368,Max Jones,L,BOS,26,60,6,7,13
2,8481751,Lukas Rousek,R,BUF,25,39,6,7,13
2,8481617,Vasily Podkolzin,R,VAN,23,48,5,8,13
2,8477508,Curtis Lazar,C,NJD,29,56,4,9,13
2,8476994,Vinnie Hinostroza,C,NSH,30,49,4,9,13
2,8480172,Jan Rutta,D,SJS,34,63,4,9,13
2,8480848,Ty Dellandrea,C,SJS,24,38,4,9,13
2,8477887,Patrick Brown,C,BOS,32,50,4,9,13
2,8478454,Noah Juulsen,D,VAN,27,36,4,9,13
2,8478451,Ethan Bear,D,WSH,27,59,3,10,13
2,8475718,Justin Holl,D,DET,32,63,3,10,13
2,8478507,John Marino,D,UTA,27,64,2,11,13
2,8475455,Brenden Dillon,D,NJD,34,49,1,12,13
2,8476967,Brett Kulak,D,EDM,30,68,1,12,13
2,8476856,Mathew Dumba,D,DAL,30,73,0,13,13
2,8478859,Niko Mikkola,D,FLA,28,54,0,13,13
2,8484911,Collin Graf,R,SJS,22,44,8,4,12
2,8477353,Tyler Motte,C,DET,29,74,7,5,12
2,8471817,Ryan Reaves,R,TOR,37,64,7,5,12
2,8480845,Rasmus Kupari,C,WPG,24,43,7,5,12
2,8482762,Simon Edvinsson,D,DET,21,56,7,5,12
2,8478831,Kevin Stenlund,C,UTA,28,53,6,6,12
2,8482807,Ethan Del Mastro,D,CHI,21,46,6,6,12
2,8476889,Radek Faksa,C,STL,30,61,5,7,12
2,8483466,Kevin Korchinski,D,CHI,20,55,5,7,12
2,8480011,Klim Kostin,C,SJS,25,44,4,8,12
2,8478421,A.J. Greer,L,FLA,28,60,4,8,12
2,8479324,Ryan Lindgren,D,NYR,26,58,3,9,12
2,8480292,Carson Meyer,R,ANA,27,31,3,9,12
2,8476874,Olli Maatta,D,DET,30,55,2,10,12
2,8480001,Urho Vaakanainen,D,ANA,25,57,2,10,12
2,8475750,Jon Merrill,D,MIN,32,62,2,10,12
2,8481708,Zac Jones,D,NYR,24,53,1,11,12
2,8480035,Henri Jokiharju,D,BUF,25,61,0,12,12
2,8477070,Liam O'Brien,C,UTA,30,57,0,12,12
2,8481147,Reese Johnson,C,MIN,26,38,9,2,11
2,8481789,Tye Kartye,L,SEA,23,41,7,4,11
2,8479543,Michael Pezzetta,L,MTL,26,52,7,4,11
2,8479638,Justin Brazeau,R,BOS,26,38,7,4,11
2,8479370,Tyson Jost,C,CAR,26,53,6,5,11
2,8475225,Craig Smith,C,CHI,35,55,6,5,11
2,8482784,Zach Dean,C,STL,21,46,6,5,11
2,8481013,Jonatan Berggren,R,DET,24,61,6,5,11
2,8482803,Olen Zellweger,D,ANA,21,67,5,6,11
2,8481641,Joel Kiviranta,L,COL,28,73,5,6,11
2,8481161,Jake Christiansen,D,CBJ,25,52,5,6,11
2,8478413,Jordan Greenway,L,BUF,27,57,4,7,11
2,8482095,Tyler Kleven,D,OTT,22,36,4,7,11
2,8480192,Johnathan Kovacevic,D,NJD,27,44,4,7,11
2,8474034,Patrick Maroon,L,CHI,36,48,3,8,11
2,8480887,Jordan Harris,D,MTL,24,60,3,8,11
2,8476441,Joel Edmundson,D,LAK,31,51,3,8,11
2,8477018,Ben Hutton,D,VGK,31,42,2,9,11
2,8475179,Dmitry Kulikov,D,FLA,34,56,2,9,11
2,8477365,Connor Clifton,D,BUF,29,60,2,9,11
2,8483460,David Jiricek,D,CBJ,21,66,2,9,11
2,8476473,Connor Murphy,D,CHI,31,38,2,9,11
2,8479369,Andrew Peeke,D,BOS,26,62,1,10,11
2,8479249,Andrew Poturalski,C,SJS,30,40,1,10,11
2,8480860,Kevin Bahl,D,CGY,24,58,0,11,11
2,8481518,Nolan Foote,L,NJD,24,38,8,2,10
2,8479359,Beck Malenstyn,L,BUF,26,43,6,4,10
2,8479772,Zack MacEwen,R,OTT,28,58,6,4,10
2,8479994,Jaret Anderson-Dolan,C,WPG,25,37,6,4,10
2,8481609,Vladislav Kolyachonok,D,UTA,23,42,5,5,10
2,8482730,Brandt Clarke,D,LAK,21,43,4,6,10
2,8480157,Calle Rosen,D,COL,30,49,4,6,10
2,8474567,Zach Bogosian,D,MIN,34,60,4,6,10
2,8476442,Matt Nieto,L,PIT,32,50,4,6,10
2,8480007,Jonas Rondbjerg,R,VGK,25,40,4,6,10
2,8481592,Jakob Pelletier,L,CGY,23,47,4,6,10
2,8478851,Alexandre Carrier,D,NSH,28,60,3,7,10
2,8481028,Martin Pospisil,C,CGY,25,62,3,7,10
2,8477482,Zachary Sanford,L,CHI,30,29,3,7,10
2,8474568,Luke Schenn,D,NSH,35,57,3,7,10
2,8481167,Brayden Pachal,D,CGY,25,38,2,8,10
2,8481567,Henry Thrun,D,SJS,23,52,2,8,10
2,8474090,Brendan Smith,D,DAL,35,45,1,9,10
2,8479348,Kale Clague,D,BUF,26,35,0,10,10
2,8481598,Philip Broberg,D,EDM,23,41,0,10,10
2,8480990,Declan Chisholm,D,MIN,24,40,5,4,9
2,8482733,Logan Mailloux,D,MTL,31,39,5,4,9
2,8479520,Brandon Duhaime,R,WSH,27,49,4,5,9
2,8479986,Kole Lind,R,DAL,26,48,3,6,9
2,8480727,Zach Whitecloud,D,VGK,28,56,3,6,9
2,8471677,Jack Johnson,D,CBJ,37,62,3,6,9
2,8480834,Ty Emberson,D,SJS,24,34,3,6,9
2,8479972,Mason Shaw,C,WPG,26,37,2,7,9
2,8480058,Pierre-Olivier Joseph,D,STL,25,54,1,8,9
2,8480070,Ian Mitchell,D,BOS,25,42,1,8,9
2,8474612,Travis Hamonic,D,OTT,34,49,1,8,9
2,8481701,Santeri Hatakka,D,NJD,23,40,1,8,9
2,8478409,Anthony Richard,C,PHI,28,32,1,8,9
2,8481122,Simon Benoit,D,TOR,26,38,1,8,9
2,8475762,Derek Forbort,D,VAN,32,45,0,9,9
2,8479379,Givani Smith,R,SJS,26,31,6,2,8
2,8481599,Victor Soderstrom,D,UTA,23,43,5,3,8
2,8480355,Mark Kastelic,C,BOS,25,65,4,4,8
2,8478424,Jansen Harkins,C,ANA,27,42,4,4,8
2,8481517,Brett Leason,R,ANA,25,49,3,5,8
2,8482859,Zack Ostapchuk,C,OTT,21,49,3,5,8
2,8479968,Vinni Lettieri,C,BOS,29,52,3,5,8
2,8476913,Devin Shore,C,MIN,30,37,3,5,8
2,8479991,Jake Leschyshyn,C,NYR,25,34,3,5,8
2,8482964,Arber Xhekaj,D,MTL,23,56,2,6,8
2,8475177,Calvin de Haan,D,COL,33,44,2,6,8
2,8476372,Nick Seeler,D,PHI,31,42,2,6,8
2,8477462,Robert Hagg,D,VGK,29,23,1,7,8
2,8478146,Matthew Highmore,C,OTT,28,34,6,1,7
2,8480870,Bo Groulx,C,NYR,24,30,5,2,7
2,8482153,Brendan Brisson,C,VGK,23,30,5,2,7
2,8475235,Nicolas Deslauriers,L,PHI,33,54,5,2,7
2,8477401,John Hayden,C,SEA,29,30,4,3,7
2,8478211,Dryden Hunt,L,CGY,29,55,3,4,7
2,8480252,Cole Guttman,C,CHI,25,34,3,4,7
2,8479536,Axel Jonsson-Fjallby,L,WPG,26,30,3,4,7
2,8483397,Marc McLaughlin,C,BOS,25,33,3,4,7
2,8476867,Brendan Gaunce,C,MIN,30,32,2,5,7
2,8479378,Logan Stanley,D,WPG,26,40,2,5,7
2,8477073,Kurtis MacDermid,L,NJD,30,23,2,5,7
2,8481019,David Gustafsson,C,WPG,24,48,1,6,7
2,8482634,Alex Steeves,C,TOR,25,41,1,6,7
2,8482451,Mikael Pyyhtia,L,CBJ,23,35,1,6,7
2,8482861,Vincent Iorio,D,WSH,22,33,1,6,7
2,8480844,Grigori Denisenko,L,VGK,24,28,1,6,7
2,8483619,Filip Roos,D,OTT,25,32,0,7,7
2,8480245,Olle Lycksell,R,PHI,25,31,4,2,6
2,8480441,Trey Fix-Wolansky,R,CBJ,25,37,3,3,6
2,8482145,Mavrik Bourque,C,DAL,22,53,3,3,6
2,8481600,Tobias Bjornfot,D,FLA,23,43,3,3,6
2,8481541,Samuel Bolduc,D,NYI,24,26,3,3,6
2,8477473,Justin Bailey,R,SJS,29,22,3,3,6
2,8477962,Brendan Lemieux,L,CAR,28,34,3,3,6
2,8478051,Max Willman,C,NJD,29,19,3,3,6
2,8479944,Zach Aston-Reese,C,VGK,30,45,2,4,6
2,8477938,Haydn Fleury,D,WPG,28,45,2,4,6
2,8479372,Joshua Mahura,D,SEA,26,55,1,5,6
2,8480196,Jacob Bryson,D,BUF,27,44,1,5,6
2,8480880,Jakub Lauko,C,MIN,24,36,1,5,6
2,8475958,Michael Sgarbossa,C,WSH,32,29,1,5,6
2,8477034,Jaycob Megna,D,FLA,32,47,0,6,6
2,8474013,Ian Cole,D,UTA,35,51,0,6,6
2,8480879,Jacob Bernard-Docker,D,OTT,24,52,0,6,6
2,8478450,Parker Wotherspoon,D,BOS,27,34,0,6,6
2,8482496,Nils Aman,C,VAN,24,39,4,1,5
2,8481532,Alex Turcotte,C,LAK,23,37,3,2,5
2,8482747,Brennan Othmann,L,NYR,21,31,2,3,5
2,8478477,Mitchell Stephens,C,SEA,27,25,2,3,5
2,8478874,Adam Gaudette,R,OTT,28,28,2,3,5
2,8477971,Andreas Englund,D,LAK,28,32,2,3,5
2,8482250,Callahan Burke,C,VGK,27,23,2,3,5
2,8482751,Ryan Winterton,C,SEA,21,34,1,4,5
2,8484258,Sam Malinski,D,COL,26,25,1,4,5
2,8479442,Troy Stecher,D,EDM,30,52,0,5,5
2,8482141,Lukas Cormier,D,VGK,22,30,0,5,5
2,8477527,Ross Johnston,L,ANA,30,28,0,5,5
2,8473446,Erik Johnson,D,PHI,36,45,0,5,5
2,8479419,Brett Murray,L,BUF,26,15,0,5,5
2,8482070,Mitchell Chaffee,R,TBL,26,41,3,1,4
2,8481754,Nikita Nesterenko,C,ANA,23,35,3,1,4
2,8479981,Jonah Gadjovich,L,FLA,26,36,3,1,4
2,8483570,Ben Meyers,C,SEA,26,28,3,1,4
2,8481743,Marc Del Gaizo,D,NSH,25,21,3,1,4
2,8480267,Sammy Walker,C,MIN,25,20,3,1,4
2,8482652,Walker Duehr,R,CGY,27,39,2,2,4
2,8478017,Mark Friedman,D,VAN,29,38,1,3,4
2,8477384,Joshua Brown,D,EDM,30,36,1,3,4
2,8477810,Joel Hanley,D,CGY,33,27,1,3,4
2,8482713,Mackie Samoskevich,R,FLA,22,36,1,3,4
2,8475795,Dylan McIlrath,D,WSH,32,13,1,3,4
2,8479576,Vincent Desharnais,D,VAN,28,31,0,4,4
2,8477149,Scott Sabourin,R,SJS,32,20,0,4,4
2,8481605,Jackson LaCombe,D,ANA,23,34,0,4,4
2,8482765,Isak Rosen,R,BUF,21,31,3,0,3
2,8480468,James Hamblin,L,EDM,25,23,3,0,3
2,8483471,Brad Lambert,C,WPG,31,10,3,0,3
2,8482511,Mason Lohrei,D,BOS,23,31,2,1,3
2,8479985,Cale Fleury,D,SEA,26,23,2,1,3
2,8481585,Egor Afanasyev,L,SJS,23,13,2,1,3
2,8481543,Nikita Alexandrov,C,STL,24,27,2,1,3
2,8482177,Marat Khusnutdinov,C,MIN,22,32,2,1,3
2,8482118,Sam Colangelo,R,ANA,23,15,2,1,3
2,8481237,Kyle MacLean,C,NYI,25,27,2,1,3
2,8482126,Emil Andrae,D,PHI,31,3,2,1,3
2,8475413,Justin Dowling,C,NJD,34,17,2,1,3
2,8482088,Justin Sourdif,R,FLA,22,16,2,1,3
2,8481043,Cole Koepke,L,BOS,26,13,2,1,3
2,8480032,Shane Bowers,C,NJD,25,17,2,1,3
2,8483763,Maksymilian Szuber,D,UTA,22,32,1,2,3
2,8481556,John Beecher,C,BOS,23,29,1,2,3
2,8484254,Akito Hirose,D,VAN,25,43,1,2,3
2,8484287,Cole McWard,D,VAN,23,18,1,2,3
2,8482201,Gage Goncalves,C,TBL,23,23,1,2,3
2,8483630,Pavol Regenda,L,ANA,25,27,1,2,3
2,8483012,Logan Morrison,C,SEA,22,33,1,2,3
2,8481056,Spencer Stastney,D,NSH,24,34,1,2,3
2,8483512,Matthew Savoie,C,EDM,20,17,0,3,3
2,8481564,Ryan Johnson,D,BUF,23,12,0,3,3
2,8481719,Maxwell Crozier,D,TBL,24,19,2,0,2
2,8477467,Gustav Olofsson,D,SEA,30,23,2,0,2
2,8481422,Jake Lucchini,C,NSH,29,19,2,0,2
2,8483407,Brandon Scanlin,D,NYR,25,6,2,0,2
2,8481206,John Ludvig,D,PIT,24,9,2,0,2
2,8482460,Matt Rempe,C,NYR,22,17,2,0,2
2,8474062,Riley Nash,C,NYR,35,10,2,0,2
2,8481679,Maxence Guenette,D,OTT,23,36,1,1,2
2,8482470,Ilya Solovyov,D,CGY,24,23,1,1,2
2,8480874,Adam Ginning,D,PHI,24,9,1,1,2
2,8482516,Matthew Kessel,D,STL,24,17,1,1,2
2,8477244,Chad Ruhwedel,D,NYR,34,26,1,1,2
2,8478021,William Lagesson,D,DET,28,25,1,1,2
2,8482094,Daemon Hunt,D,MIN,22,9,1,1,2
2,8482172,Landon Slaggert,L,CHI,22,29,1,1,2
2,8483597,Milos Kelemen,L,UTA,25,12,1,1,2
2,8480851,Akil Thomas,C,LAK,24,16,1,1,2
2,8481030,Jack St. Ivany,D,PIT,25,17,1,1,2
2,8479367,William Lockwood,R,FLA,26,24,1,1,2
2,8479362,Riley Tufte,L,BOS,26,14,1,1,2
2,8480084,Nick DeSimone,D,NJD,30,18,0,2,2
2,8477320,Anton Blidh,L,NYR,29,18,0,2,2
2,8480823,Alexander Alexeyev,D,WSH,25,7,0,2,2
2,8481593,Jayden Struble,D,MTL,23,13,0,2,2
2,8481726,Adam Edstrom,C,NYR,24,10,0,2,2
2,8478881,Brett Seney,L,CHI,28,13,0,2,2
2,8479421,Jacob Moverare,D,LAK,26,9,0,2,2
2,8478502,Dennis Gilbert,D,BUF,28,16,0,2,2
2,8481065,Angus Crookshank,L,OTT,25,25,1,0,1
2,8479320,Maxime Lajoie,D,SEA,27,26,1,0,1
2,8483395,Arshdeep Bains,L,VAN,23,13,1,0,1
2,8482162,Roby Jarventie,L,EDM,22,17,1,0,1
2,8483398,Declan Carlile,D,TBL,31,6,1,0,1
2,8482147,Jean-Luc Foudy,C,COL,22,24,1,0,1
2,8483489,Fraser Minten,C,TOR,31,14,1,0,1
2,8483920,Pierrick Dube,R,WSH,23,7,1,0,1
2,8482165,Yan Kuznetsov,D,CGY,22,16,1,0,1
2,8483609,Adam Klapka,R,CGY,24,4,1,0,1
2,8477851,Jordan Oesterle,D,BOS,32,43,0,1,1
2,8482858,Ryker Evans,D,SEA,23,18,0,1,1
2,8481006,Tyler Tucker,D,STL,24,20,0,1,1
2,8482144,Jack Thompson,D,SJS,22,21,0,1,1
2,8478147,Bokondji Imama,L,PIT,28,5,0,1,1
2,8479587,Rhett Gardner,C,PHI,28,20,0,1,1
2,8482102,Vasily Ponomarev,C,PIT,22,14,0,1,1
2,8477993,Justin Kirkland,C,CGY,28,10,0,1,1
2,8483546,Marshall Rifai,D,TOR,26,5,0,1,1
2,8480306,Grant Hutton,D,NYI,29,9,0,1,1
2,8481655,Cole Schwindt,R,CGY,23,4,0,1,1
2,8484325,Waltteri Merela,C,TBL,26,30,0,1,1
2,8484255,Jason Polin,R,COL,25,5,0,1,1
2,8483567,Georgii Merkulov,C,BOS,24,10,0,1,1
2,8481024,Linus Karlsson,C,VAN,25,12,0,1,1
2,8481578,Graeme Clarke,R,MIN,23,12,0,1,1
2,8478446,Glenn Gawdin,C,LAK,27,9,0,0,0
2,8482061,Brandon Biro,L,SEA,26,9,0,0,0
2,8480890,Jan Jenik,C,OTT,24,16,0,0,0
2,8481699,Aku Raty,R,UTA,23,9,0,0,0
2,8482929,Emil Lilleberg,D,TBL,23,21,0,0,0
2,8484304,Uvis Balinskis,D,FLA,28,4,0,0,0
2,8483531,Brian Halonen,L,NJD,25,1,0,0,0
2,8478011,Louie Belpedio,D,PHI,28,8,0,0,0
2,8480075,Cameron Crotty,D,MIN,25,9,0,0,0
2,8482787,Nikita Chibrikov,R,WPG,31,7,0,0,0
2,8481806,Louis Crevier,D,CHI,23,15,0,0,0
2,8475755,Alexander Petrovic,D,DAL,32,5,0,0,0
2,8478854,Ryan Shea,D,PIT,27,7,0,0,0
2,8479330,Brandon Gignac,C,MTL,27,9,0,0,0
2,8481462,Mason Morelli,L,VGK,28,12,0,0,0
2,8470794,Joe Pavelski,C,,40,0,0,0,0
2,8479321,Lucas Johansen,D,,27,0,0,0,0
2,8477950,Tony DeAngelo,D,,29,0,0,0,0
2,8471218,Blake Wheeler,R,,38,0,0,0,0
2,8475197,Tyson Barrie,D,,33,0,0,0,0
2,8474157,Max Pacioretty,L,,36,0,0,0,0
2,8475744,Evgeny Kuznetsov,C,,32,0,0,0,0
2,8474037,James van Riemsdyk,L,,35,0,0,0,0
2,8476907,Mackenzie MacEachern,L,,30,0,0,0,0
2,8480216,Jacob Peterson,C,,25,0,0,0,0
2,8474602,Justin Schultz,D,,34,0,0,0,0
2,8482222,Alexander Barabanov,L,,30,0,0,0,0
2,8474031,Kevin Shattenkirk,D,,35,0,0,0,0
2,8477330,Dominik Kubalik,L,,29,0,0,0,0
2,8480884,Calen Addison,D,,24,0,0,0,0
2,8475906,John Klingberg,D,,32,0,0,0,0
2,8480008,Adam Ruzicka,C,,25,0,0,0,0
2,8476884,Derrick Pouliot,D,,30,0,0,0,0
2,8476919,Chris Tierney,C,,30,0,0,0,0
2,8479415,Michael McLeod,C,,26,0,0,0,0
2,8474870,Tyler Johnson,C,,34,0,0,0,0
2,8470604,Jeff Carter,C,,39,0,0,0,0
2,8478104,Sammy Blais,L,,28,0,0,0,0
2,8474884,Mike Hoffman,C,,35,0,0,0,0
2,8481591,Sam Poulin,R,,23,0,0,0,0
2,8471274,Alex Goligoski,D,,39,0,0,0,0
2,8476871,Tanner Pearson,L,,32,0,0,0,0
2,8476393,Nick Cousins,C,,31,0,0,0,0
2,8479977,Kailer Yamamoto,R,,26,0,0,0,0
2,8479346,Dillon Dube,C,,26,0,0,0,0
2,8480184,Gustav Lindstrom,D,,26,0,0,0,0
2,8479376,Victor Mete,D,,26,0,0,0,0
2,8473449,Kyle Okposo,R,,36,0,0,0,0
2,8481058,Jesse Ylonen,R,,25,0,0,0,0
2,8475752,Tyler Pitlick,C,,33,0,0,0,0
2,8481239,Samuel Fagemo,L,,24,0,0,0,0
2,8480821,Filip Zadina,R,,25,0,0,0,0
2,8470966,Mark Giordano,D,,41,0,0,0,0
2,8478495,Denis Gurianov,R,,27,0,0,0,0
2,8477464,Nic Petan,C,,29,0,0,0,0
2,8478099,Kevin Labanc,R,,29,0,0,0,0
2,8482241,Radim Zohorna,L,,28,0,0,0,0
2,8474040,Sam Gagner,C,,35,0,0,0,0
2,8479514,Rem Pitlick,C,,27,0,0,0,0
2,8478430,Oliver Kylington,D,,27,0,0,0,0
2,8479533,Joona Koppanen,L,,26,0,0,0,0
2,8479984,Cal Foote,D,,26,0,0,0,0
2,8477126,Jayson Megna,C,,34,0,0,0,0
2,8475164,Jakob Silfverberg,R,,34,0,0,0,0
2,8474009,Nick Bonino,C,,36,0,0,0,0
2,8479458,Nikita Zaitsev,D,,33,0,0,0,0
2,8477944,Jakub Vrana,L,,28,0,0,0,0
2,8476323,Max McCormick,L,SEA,32,2,0,0,0
2,8471699,Andrew Cogliano,C,,37,0,0,0,0
2,8478067,Oskar Lindblom,L,,28,0,0,0,0
2,8471686,Marc Staal,D,,37,0,0,0,0
2,8470610,Zach Parise,L,,40,0,0,0,0
2,8478904,Steven Lorentz,C,,28,0,0,0,0
2,8473473,Milan Lucic,L,,36,0,0,0,0
2,8480031,Maxime Comtois,L,,25,0,0,0,0
2,8478512,Austin Czarnik,C,,32,0,0,0,0
2,8473504,Cal Clutterbuck,R,,37,0,0,0,0
2,8477454,Adam Erne,L,,29,0,0,0,0
2,8479383,Boris Katchouk,L,,26,0,0,0,0
2,8475825,Jani Hakanpää,D,,32,0,0,0,0
2,8477846,Ryan Carpenter,C,,33,0,0,0,0
2,8477930,Pierre-Edouard Bellemare,L,,39,0,0,0,0
2,8478400,Colin White,C,,27,0,0,0,0
2,8480226,Marián Studenic,R,,26,0,0,0,0
2,8480853,Liam Foudy,C,,24,0,0,0,0
2,8475797,Jarred Tinordi,D,,32,0,0,0,0
2,8479423,Alex Nylander,L,,26,0,0,0,0
2,8474618,Marco Scandella,D,,34,0,0,0,0
2,8478028,Fredrik Olofsson,L,,28,0,0,0,0
2,8474709,Matt Martin,L,,35,0,0,0,0
2,8479522,Hardy Haman Aktell,D,WSH,26,0,0,0,0
2,8481070,Hugh McGing,L,,26,0,0,0,0
2,8479546,Oskar Steen,C,,26,0,0,0,0
2,8474145,Robert Bortuzzo,D,,35,0,0,0,0
2,8476915,Jujhar Khaira,L,,30,0,0,0,0
2,8480274,Philip Kemp,D,EDM,25,0,0,0,0
2,8477541,Dakota Mermis,D,TOR,30,5,0,0,0
2,8484326,Patrik Koch,D,UTA,28,3,0,0,0
2,8484321,Nikolas Matinpalo,D,OTT,26,5,0,0,0
2,8475278,Byron Froese,C,,33,0,0,0,0
2,8481812,Nikolai Knyzhov,D,,27,0,0,0,0
2,8478408,Travis Dermott,D,,28,0,0,0,0
2,8481077,John Leonard,L,,26,0,0,0,0
2,8479547,Matthew Phillips,R,,26,0,0,0,0
2,8482197,Adam Raska,R,MIN,23,4,0,0,0
2,8480836,Jonathan Gruden,C,,24,0,0,0,0
2,8481690,Tyler Angle,C,,24,0,0,0,0
2,8475766,Austin Watson,L,,32,0,0,0,0
2,8481016,Ruslan Iskhakov,C,,24,0,0,0,0
2,8478078,Rourke Chartier,C,,28,0,0,0,0
2,8484259,Ondrej Pavel,C,COL,31,2,0,0,0
2,8475780,Chris Wagner,R,COL,33,10,0,0,0
2,8483401,Marc Johnstone,R,PIT,28,1,0,0,0
2,8480776,Sheldon Rempal,R,,29,0,0,0,0
2,8478956,Samuel Laberge,L,NJD,27,1,0,0,0
2,8483432,Luca Del Bel Belluz,C,CBJ,31,7,0,0,0
2,8483045,Cameron Butler,R,CBJ,31,0,0,0,0
2,8481534,Raphael Lavoie,C,EDM,24,1,0,0,0
2,8482476,Emil Heineman,L,MTL,23,6,0,0,0
2,8484314,Jiri Smejkal,L,,28,0,0,0,0
3,8476453,Nikita Kucherov,R,TBL,31,82,58,81,139
3,8478402,Connor McDavid,C,EDM,27,77,45,88,133
3,8477492,Nathan MacKinnon,C,COL,29,82,50,81,131
3,8477956,David Pastrnak,R,BOS,28,79,65,65,130
3,8478420,Mikko Rantanen,R,COL,28,81,38,81,119
3,8481559,Jack Hughes,C,NJD,23,74,52,66,118
3,8477493,Aleksander Barkov,C,FLA,29,79,43,74,117
3,8479318,Auston Matthews,C,TOR,27,79,67,49,116
3,8478550,Artemi Panarin,L,NYR,33,76,39,74,113
3,8477934,Leon Draisaitl,C,EDM,29,78,39,71,110
3,8480801,Brady Tkachuk,L,OTT,25,77,55,53,108
3,8480002,Nico Hischier,C,NJD,25,78,35,73,108
3,8477404,Jake Guentzel,C,TBL,30,82,39,68,107
3,8478483,Mitch Marner,R,TOR,27,78,34,73,107
3,8477939,William Nylander,R,TOR,28,79,40,63,103
3,8479407,Jesper Bratt,L,NJD,26,73,40,63,103
3,8479314,Matthew Tkachuk,L,FLA,27,79,22,78,100
3,8480069,Cale Makar,D,COL,26,68,21,76,97
3,8478864,Kirill Kaprizov,L,MIN,27,70,42,53,95
3,8476468,J.T. Miller,C,VAN,31,75,41,53,94
3,8480023,Robert Thomas,C,STL,25,75,26,68,94
3,8479323,Adam Fox,D,NYR,26,77,18,76,94
3,8480012,Elias Pettersson,C,VAN,26,74,31,62,93
3,8471675,Sidney Crosby,C,PIT,37,71,42,50,92
3,8478403,Jack Eichel,C,VGK,28,72,38,54,92
3,8484144,Connor Bedard,C,CHI,19,76,25,67,92
3,8480027,Jason Robertson,L,DAL,25,81,37,54,91
3,8474600,Roman Josi,D,NSH,34,77,26,64,90
3,8476459,Mika Zibanejad,C,NYR,31,76,36,51,87
3,8478445,Mathew Barzal,C,NYI,27,80,21,65,86
3,8478010,Brayden Point,C,TBL,28,82,42,43,85
3,8478439,Travis Konecny,R,PHI,27,77,32,53,85
3,8477942,Kevin Fiala,L,LAK,28,81,26,58,84
3,8474564,Steven Stamkos,C,NSH,34,73,30,53,83
3,8475913,Mark Stone,R,VGK,32,77,29,54,83
3,8482116,Tim Stützle,C,OTT,22,80,20,62,82
3,8479343,Clayton Keller,R,UTA,26,79,34,47,81
3,8477960,Adrian Kempe,R,LAK,28,81,32,49,81
3,8476887,Filip Forsberg,L,NSH,30,72,43,37,80
3,8473419,Brad Marchand,L,BOS,36,79,19,61,80
3,8475167,Victor Hedman,D,TBL,34,81,11,69,80
3,8475184,Chris Kreider,L,NYR,33,80,44,35,79
3,8475692,Mats Zuccarello,R,MIN,37,71,22,57,79
3,8476389,Vincent Trocheck,C,NYR,31,79,39,39,78
3,8471214,Alex Ovechkin,L,WSH,39,75,31,47,78
3,8475172,Nazem Kadri,C,CGY,34,80,26,52,78
3,8479420,Tage Thompson,C,BUF,27,73,37,39,76
3,8478427,Sebastian Aho,C,CAR,27,73,36,40,76
3,8477933,Sam Reinhart,C,FLA,29,77,35,41,76
3,8475166,John Tavares,C,TOR,34,79,32,44,76
3,8476881,Tomas Hertl,C,VGK,31,78,35,40,75
3,8479542,Brandon Hagel,L,TBL,26,82,30,45,75
3,8480800,Quinn Hughes,D,VAN,25,71,9,66,75
3,8478444,Brock Boeser,R,VAN,27,73,35,39,74
3,8474141,Patrick Kane,R,DET,36,81,26,48,74
3,8477946,Dylan Larkin,C,DET,28,81,39,34,73
3,8482740,Wyatt Johnston,C,DAL,21,81,28,45,73
3,8480208,Drake Batherson,R,OTT,26,76,28,45,73
3,8480830,Andrei Svechnikov,R,CAR,24,72,25,47,72
3,8477501,Valeri Nichushkin,R,COL,29,81,32,39,71
3,8477402,Pavel Buchnevich,L,STL,29,75,27,44,71
3,8476460,Mark Scheifele,C,WPG,31,75,24,47,71
3,8479325,Charlie McAvoy,D,BOS,27,76,13,58,71
3,8482078,Lucas Raymond,L,DET,22,79,26,44,70
3,8480865,Noah Dobson,D,NYI,24,80,12,58,70
3,8477500,Bo Horvat,C,NYI,29,80,33,36,69
3,8478401,Pavel Zacha,C,BOS,27,78,29,40,69
3,8479337,Alex DeBrincat,R,DET,27,81,24,45,69
3,8477496,Elias Lindholm,C,BOS,30,79,24,45,69
3,8477951,Nick Schmaltz,C,UTA,28,79,23,46,69
3,8480018,Nick Suzuki,C,MTL,25,73,24,44,68
3,8480036,Miro Heiskanen,D,DAL,25,80,10,58,68
3,8478449,Roope Hintz,C,DAL,28,80,39,28,67
3,8476792,Torey Krug,D,STL,33,72,15,52,67
3,8478407,Vince Dunn,D,SEA,28,77,14,53,67
3,8479385,Jordan Kyrou,C,STL,26,73,30,36,66
3,8477935,Sam Bennett,C,FLA,28,79,28,38,66
3,8476454,Ryan Nugent-Hopkins,C,EDM,31,78,17,49,66
3,8482093,Seth Jarvis,C,CAR,22,72,33,32,65
3,8473512,Claude Giroux,R,OTT,36,77,29,36,65
3,8479675,Trevor Moore,L,LAK,29,80,28,37,65
3,8476539,Jonathan Marchessault,R,NSH,34,72,32,32,64
3,8482699,Dylan Guenther,R,UTA,21,72,31,33,64
3,8478414,Timo Meier,R,NJD,28,72,30,34,64
3,8471215,Evgeni Malkin,C,PIT,38,71,30,34,64
3,8482745,Mason McTavish,C,ANA,21,73,28,36,64
3,8481557,Matt Boldy,L,MIN,23,71,27,37,64
3,8481540,Cole Caufield,R,MTL,23,74,31,32,63
3,8474578,Erik Karlsson,D,PIT,34,78,12,51,63
3,8482684,Luke Hughes,D,NJD,21,70,7,56,63
3,8478398,Kyle Connor,L,WPG,28,73,31,31,62
3,8476448,William Karlsson,C,VGK,31,78,29,33,62
3,8478493,Joel Eriksson Ek,C,MIN,27,68,28,34,62
3,8475794,Tyler Seguin,C,DAL,32,81,27,35,62
3,8471685,Anze Kopitar,C,LAK,37,81,24,38,62
3,8475168,Matt Duchene,C,DAL,33,81,21,41,62
3,8476905,Chandler Stephenson,C,SEA,30,76,15,47,62
3,8480803,Evan Bouchard,D,EDM,25,73,10,52,62
3,8475786,Zach Hyman,L,EDM,32,69,33,28,61
3,8476438,Brandon Saad,L,STL,32,71,31,30,61
3,8477476,Artturi Lehkonen,L,COL,29,78,27,34,61
3,8476346,Johnny Gaudreau,L,CBJ,31,72,18,43,61
3,8475754,Brock Nelson,C,NYI,33,78,32,28,60
3,8475158,Ryan O'Reilly,C,NSH,33,74,28,32,60
3,8475765,Vladimir Tarasenko,R,DET,33,77,24,36,60
3,8478873,Troy Terry,R,ANA,27,70,20,40,60
3,8476456,Jonathan Huberdeau,C,CGY,31,75,19,41,60
3,8474590,John Carlson,D,WSH,34,71,13,47,60
3,8478498,Jake DeBrusk,L,VAN,28,74,34,25,59
3,8475810,Bryan Rust,R,PIT,32,69,31,28,59
3,8477497,Sean Monahan,C,CBJ,30,70,28,31,59
3,8482113,Anton Lundell,C,FLA,23,76,24,35,59
3,8476875,Mike Matheson,D,MTL,30,72,13,46,59
3,8478856,Conor Garland,R,VAN,28,76,24,34,58
3,8480839,Rasmus Dahlin,D,BUF,24,70,16,42,58
3,8477940,Nikolaj Ehlers,L,WPG,28,72,15,43,58
3,8477409,Carter Verhaeghe,C,FLA,29,80,31,26,57
3,8475169,Evander Kane,L,EDM,33,76,28,29,57
3,8482159,Tyson Foerster,R,PHI,22,79,27,30,57
3,8479525,Ross Colton,C,COL,28,81,27,30,57
3,8473986,Alex Killorn,L,ANA,35,75,31,25,56
3,8475784,Jeff Skinner,C,EDM,32,73,24,32,56
3,8473994,Jamie Benn,L,DAL,35,82,22,34,56
3,8479999,Casey Mittelstadt,C,COL,26,82,21,35,56
3,8477503,Max Domi,C,TOR,29,79,16,40,56
3,8478469,Thomas Chabot,D,OTT,27,76,16,40,56
3,8480015,Owen Tippett,R,PHI,25,73,27,28,55
3,8478975,Mason Marchment,L,DAL,29,81,19,36,55
3,8481068,Yegor Sharangovich,C,CGY,26,75,28,26,54
3,8475745,Charlie Coyle,C,BOS,32,76,24,30,54
3,8482665,Matty Beniers,C,SEA,22,70,23,31,54
3,8477932,Aaron Ekblad,D,FLA,28,75,20,34,54
3,8482097,Jack Quinn,R,BUF,23,68,20,34,54
3,8477494,Jonathan Drouin,L,COL,29,81,15,39,54
3,8478047,Michael Bunting,L,PIT,29,75,15,39,54
3,8471724,Kris Letang,D,PIT,37,79,14,40,54
3,8478519,Anthony Cirelli,C,TBL,27,82,26,27,53
3,8481528,Dylan Cozens,C,BUF,23,72,21,32,53
3,8484166,Adam Fantilli,C,CBJ,20,74,21,32,53
3,8477986,Brandon Montour,D,SEA,30,74,15,38,53
3,8476853,Morgan Rielly,D,TOR,30,64,8,45,53
3,8474586,Jordan Eberle,R,SEA,34,72,26,26,52
3,8480064,Josh Norris,C,OTT,25,71,25,27,52
3,8476906,Shayne Gostisbehere,D,CAR,31,78,9,43,52
3,8477949,Alex Tuch,R,BUF,28,69,25,26,51
3,8481604,Pavel Dorofeyev,L,VGK,24,73,25,26,51
3,8471698,T.J. Oshie,R,WSH,38,72,24,27,51
3,8475170,Brayden Schenn,C,STL,33,72,20,31,51
3,8475191,Reilly Smith,R,NYR,33,69,20,31,51
3,8474102,David Perron,L,OTT,36,76,18,33,51
3,8477504,Josh Morrissey,D,WPG,29,67,14,37,51
3,8474565,Alex Pietrangelo,D,VGK,34,58,6,45,51
3,8476882,Teuvo Teravainen,C,CHI,30,60,28,22,50
3,8482109,Alexis Lafrenière,L,NYR,23,76,28,22,50
3,8477998,Warren Foegele,L,LAK,28,77,27,23,50
3,8477416,Oliver Bjorkstrand,R,SEA,29,69,24,26,50
3,8481533,Trevor Zegras,C,ANA,23,72,22,28,50
3,8477407,Anthony Duclair,L,NYI,29,80,22,28,50
3,8482705,Cole Sillinger,C,CBJ,21,68,19,31,50
3,8478440,Dylan Strome,C,WSH,27,73,18,32,50
3,8479987,Morgan Geekie,C,BOS,26,77,17,33,50
3,8475798,Mikael Granlund,C,SJS,32,65,15,35,50
3,8474679,Gustav Nyquist,C,NSH,35,77,13,37,50
3,8478460,Zach Werenski,D,CBJ,27,80,12,38,50
3,8479425,Filip Hronek,D,VAN,27,79,7,43,50
3,8482110,Dawson Mercer,C,NJD,23,73,27,22,49
3,8482667,William Eklund,L,SJS,22,70,19,30,49
3,8476479,Phillip Danault,C,LAK,31,82,17,32,49
3,8477346,MacKenzie Weegar,D,CGY,30,74,9,40,49
3,8477447,Shea Theodore,D,VGK,29,66,6,43,49
3,8475151,Kyle Palmieri,C,NYI,33,80,23,25,48
3,8480028,Morgan Frost,C,PHI,25,74,20,28,48
3,8480185,Eetu Luostarinen,C,FLA,26,76,19,29,48
3,8478115,Pierre Engvall,L,NYI,28,78,18,30,48
3,8475726,Tyler Toffoli,C,SJS,32,68,26,21,47
3,8476880,Tom Wilson,R,WSH,30,69,25,22,47
3,8477955,Jared McCann,L,SEA,28,76,24,23,47
3,8483431,Logan Cooley,C,UTA,20,76,19,28,47
3,8482149,Cole Perfetti,C,WPG,22,64,18,29,47
3,8480798,Philipp Kurashev,C,CHI,25,60,18,29,47
3,8483515,Juraj Slafkovsky,L,MTL,20,76,17,30,47
3,8477964,Ivan Barbashev,C,VGK,29,77,15,32,47
3,8481711,Matias Maccelli,L,UTA,24,73,12,35,47
3,8478366,Frank Vatrano,R,ANA,30,69,25,21,46
3,8474641,Adam Henrique,C,EDM,34,72,24,22,46
3,8477479,Tyler Bertuzzi,L,CHI,29,64,23,23,46
3,8479365,Trent Frederic,C,BOS,26,73,22,24,46
3,8481596,Shane Pinto,C,OTT,24,76,18,28,46
3,8481524,Bowen Byram,D,BUF,23,67,18,28,46
3,8480039,Martin Necas,C,CAR,25,69,12,34,46
3,8478396,Noah Hanifin,D,VGK,27,65,12,34,46
3,8480797,Joel Farabee,L,PHI,24,75,17,28,45
3,8480009,Eeli Tolvanen,R,SEA,25,68,17,28,45
3,8484153,Leo Carlsson,C,ANA,20,68,16,29,45
3,8482720,Matthew Knies,L,TOR,22,78,16,29,45
3,8483808,Andrei Kuzmenko,L,CGY,28,77,15,30,45
3,8478458,John (Jack) Roslovic,C,CAR,27,66,9,36,45
3,8474151,Ryan McDonagh,D,TBL,35,78,9,36,45
3,8476432,Boone Jenner,C,CBJ,31,67,25,19,44
3,8477444,Andre Burakovsky,L,SEA,29,69,19,25,44
3,8482124,Quinton Byfield,R,LAK,22,75,17,27,44
3,8476826,Yanni Gourde,C,SEA,33,68,15,29,44
3,8477498,Darnell Nurse,D,EDM,29,75,15,29,44
3,8481542,Moritz Seider,D,DET,23,78,10,34,44
3,8480434,Sean Durzi,D,UTA,26,73,8,36,44
3,8474150,Mikael Backlund,C,CGY,35,79,21,22,43
3,8480014,Gabriel Vilardi,C,WPG,25,72,21,22,43
3,8479591,Michael Eyssimont,C,TBL,28,81,20,23,43
3,8480849,Barrett Hayton,C,UTA,24,72,20,23,43
3,8477511,Anthony Mantha,R,CGY,30,75,19,24,43
3,8479992,Michael Rasmussen,C,DET,25,79,18,25,43
3,8477451,Ryan Hartman,R,MIN,30,74,17,26,43
3,8470613,Brent Burns,D,CAR,39,76,16,27,43
3,8479345,Jakob Chychrun,D,WSH,26,69,16,27,43
3,8476885,Jacob Trouba,D,NYR,30,73,14,29,43
3,8478038,Devon Toews,D,COL,30,68,13,30,43
3,8477495,Seth Jones,D,CHI,30,68,12,31,43
3,8479410,Mikhail Sergachev,D,UTA,26,70,7,36,43
3,8479400,Pierre-Luc Dubois,L,WSH,26,70,21,21,42
3,8475722,Jason Zucker,L,BUF,32,67,21,21,42
3,8482702,Logan Stankoven,C,DAL,21,80,20,22,42
3,8475753,Justin Faulk,D,STL,32,75,16,26,42
3,8478474,Lawson Crouse,L,UTA,27,72,26,15,41
3,8483505,Matthew Poitras,C,BOS,20,76,20,21,41
3,8476399,Blake Coleman,C,CGY,33,78,16,25,41
3,8478233,Andrew Mangiapane,L,WSH,28,71,14,27,41
3,8475793,Ryan Johansen,C,PHI,32,75,16,24,40
3,8478466,Daniel Sprong,R,VAN,27,66,12,28,40
3,8478055,Gustav Forsling,D,FLA,28,74,11,29,40
3,8476958,Jaccob Slavin,D,CAR,30,73,4,36,40
3,8475799,Nino Niederreiter,R,WPG,32,61,23,16,39
3,8477426,Nicholas Paul,L,TBL,29,81,20,19,39
3,8475763,Kevin Hayes,R,PIT,32,75,18,21,39
3,8474149,Evgenii Dadonov,R,DAL,35,80,17,22,39
3,8480188,Fabian Zetterlund,L,SJS,25,69,16,23,39
3,8482092,Ridly Greig,C,OTT,22,76,15,24,39
3,8478020,Michael Amadio,R,OTT,28,78,15,24,39
3,8478472,Mathieu Joseph,R,STL,27,70,8,31,39
3,8481703,Valtteri Puustinen,R,PIT,25,61,4,35,39
3,8476462,Dougie Hamilton,D,NJD,31,65,16,22,38
3,8477947,Sonny Milano,L,WSH,28,70,16,22,38
3,8477021,Alex Kerfoot,C,UTA,30,71,13,25,38
3,8481577,Philip Tomasino,C,NSH,23,68,9,29,38
3,8477429,Andrew Copp,C,DET,30,81,8,30,38
3,8478397,Rasmus Andersson,D,CGY,28,72,6,32,38
3,8477456,J.T. Compher,L,DET,29,78,20,17,37
3,8478057,Dakota Joshua,C,VAN,28,64,18,19,37
3,8474716,Jared Spurgeon,D,MIN,35,74,17,20,37
3,8475287,Erik Haula,L,NJD,33,68,15,22,37
3,8481624,Ilya Mikheyev,R,CHI,30,62,14,23,37
3,8476458,Ryan Strome,C,ANA,31,72,11,26,37
3,8476923,Damon Severson,D,CBJ,30,78,9,28,37
3,8477435,Ryan Graves,D,PIT,29,76,7,30,37
3,8477952,Robby Fabbri,C,ANA,28,62,22,14,36
3,8475218,Mattias Ekholm,D,EDM,34,74,13,23,36
3,8476927,Teddy Blueger,C,VAN,30,65,11,25,36
3,8474563,Drew Doughty,D,LAK,35,71,8,28,36
3,8476483,Rickard Rakell,R,PIT,31,69,22,13,35
3,8475768,Jaden Schwartz,C,SEA,32,72,17,18,35
3,8479339,Patrik Laine,L,CBJ,26,71,15,20,35
3,8480003,Jesper Boqvist,C,FLA,26,68,15,20,35
3,8478042,Viktor Arvidsson,L,EDM,31,78,14,21,35
3,8482146,Luke Evangelista,R,NSH,22,67,14,21,35
3,8478438,Tommy Novak,C,NSH,27,68,13,22,35
3,8484203,Bradly Nadeau,L,CAR,19,65,13,22,35
3,8474053,Logan Couture,C,SJS,35,55,12,23,35
3,8478462,Nicolas Roy,C,VGK,27,71,11,24,35
3,8480078,Filip Chytil,C,NYR,25,64,11,24,35
3,8482660,Kent Johnson,C,CBJ,22,65,10,25,35
3,8482101,Danil Gushchin,L,SJS,22,59,9,26,35
3,8481580,Connor McMichael,C,WSH,23,68,19,15,34
3,8482475,Yegor Chinakhov,R,CBJ,23,58,17,17,34
3,8481535,Nils Hoglander,L,VAN,24,68,17,17,34
3,8482074,Connor Zary,C,CGY,23,66,17,17,34
3,8480113,Alex Iafallo,L,WPG,31,68,15,19,34
3,8481186,Logan O'Connor,R,COL,28,77,13,21,34
3,8476292,Ondrej Palat,L,NJD,33,70,12,22,34
3,8477953,Kasperi Kapanen,R,STL,28,66,12,22,34
3,8476474,Stefan Noesen,R,NJD,31,67,11,23,34
3,8477969,Marcus Pettersson,D,PIT,28,77,4,30,34
3,8478046,Danton Heinen,L,VAN,29,62,18,15,33
3,8480835,Jack Drury,C,CAR,24,59,16,17,33
3,8470621,Corey Perry,R,EDM,39,73,15,18,33
3,8473422,Nick Foligno,L,CHI,37,62,13,20,33
3,8476419,Jean-Gabriel Pageau,C,NYI,32,76,13,20,33
3,8481523,Kirby Dach,C,MTL,23,68,12,21,33
3,8483490,Pavel Mintyukov,D,ANA,21,73,11,22,33
3,8476869,Brady Skjei,D,NSH,30,67,9,24,33
3,8480817,K'Andre Miller,D,NYR,24,70,9,24,33
3,8477948,Travis Sanheim,D,PHI,28,68,6,27,33
3,8476854,Hampus Lindholm,D,BOS,30,70,4,29,33
3,8477425,Miles Wood,L,COL,29,80,19,13,32
3,8480802,Ryan McLeod,C,BUF,25,66,16,16,32
3,8482809,Jackson Blake,R,CAR,21,59,16,16,32
3,8476480,Vladislav Namestnikov,C,WPG,32,70,15,17,32
3,8473533,Jordan Staal,C,CAR,36,60,12,20,32
3,8481554,Kaapo Kakko,R,NYR,23,71,12,20,32
3,8476921,Jordan Martinook,L,CAR,32,66,11,21,32
3,8482105,Jake Sanderson,D,OTT,22,73,8,24,32
3,8476463,Jonas Brodin,D,MIN,31,79,2,30,32
3,8475314,Anders Lee,L,NYI,34,80,23,8,31
3,8480459,Pius Suter,C,VAN,28,69,17,14,31
3,8481560,Arthur Kaliyev,R,LAK,23,78,15,16,31
3,8480068,Ryan Poehling,C,PHI,25,62,15,16,31
3,8477987,Ryan Donato,C,CHI,28,66,14,17,31
3,8475193,Tomas Tatar,L,NJD,34,67,13,18,31
3,8484145,Zach Benson,L,BUF,19,70,11,20,31
3,8478413,Jordan Greenway,L,BUF,27,67,11,20,31
3,8482671,Owen Power,D,BUF,22,69,10,21,31
3,8476461,Sean Couturier,C,PHI,32,62,9,22,31
3,8480336,Sean Walker,D,CAR,30,71,9,22,31
3,8479639,Dylan Coghlan,D,WPG,26,62,9,22,31
3,8476979,Erik Gustafsson,D,DET,32,76,7,24,31
3,8480074,Alexandre Texier,C,STL,25,59,16,14,30
3,8481656,Aliaksei Protas,C,WSH,23,66,12,18,30
3,8479351,Sam Steel,C,DAL,26,80,11,19,30
3,8477505,Alexander Wennberg,C,SJS,30,63,11,19,30
3,8482712,Oskar Olausson,R,COL,22,78,9,21,30
3,8480220,Noah Cates,L,PHI,25,70,9,21,30
3,8479315,Joey Anderson,R,CHI,26,49,6,24,30
3,8476897,Oskar Sundqvist,C,STL,30,68,16,13,29
3,8480829,Jesperi Kotkaniemi,C,CAR,24,65,15,14,29
3,8482089,Jake Neighbours,L,STL,22,61,14,15,29
3,8480855,Jack McBain,C,UTA,24,64,13,16,29
3,8476872,Scott Laughton,C,PHI,30,75,12,17,29
3,8481581,Thomas Harley,D,DAL,23,72,9,20,29
3,8475791,Taylor Hall,L,CHI,33,52,9,20,29
3,8478542,Evan Rodrigues,C,FLA,31,68,8,21,29
3,8482067,Connor Mackey,D,NYR,28,57,7,22,29
3,8474189,Lars Eller,C,PIT,35,67,16,12,28
3,8474715,Cameron Atkinson,R,TBL,35,81,15,13,28
3,8482117,Lukas Reichel,L,CHI,22,57,15,13,28
3,8476392,Adam Lowry,C,WPG,31,63,13,15,28
3,8476278,Colin Blackwell,C,DAL,31,79,13,15,28
3,8482624,Daniil Miromanov,D,CGY,27,64,12,16,28
3,8475714,Calle Jarnkrok,C,TOR,33,71,11,17,28
3,8482055,Drew O'Connor,L,PIT,26,65,11,17,28
3,8475848,Brendan Gallagher,R,MTL,32,73,10,18,28
3,8483445,Cutter Gauthier,L,ANA,20,68,10,18,28
3,8479293,Brandon Tanev,L,SEA,33,66,10,18,28
3,8482122,Brock Faber,D,MIN,22,78,6,22,28
3,8476988,Matt Benning,D,SJS,30,68,3,25,28
3,8475760,Nick Bjugstad,C,UTA,32,73,15,12,27
3,8482125,Alexander Holtz,R,VGK,22,72,14,13,27
3,8477839,Conor Sheary,L,TBL,32,81,12,15,27
3,8477989,Christian Dvorak,C,MTL,28,68,11,16,27
3,8478970,Jalen Chatfield,D,CAR,28,77,10,17,27
3,8480748,Kiefer Sherwood,L,VAN,29,66,8,19,27
3,8477488,Brett Pesce,D,NJD,30,72,7,20,27
3,8480871,Adam Boqvist,D,FLA,24,63,6,21,27
3,8476457,Adam Larsson,D,SEA,32,62,5,22,27
3,8482073,Braden Schneider,D,NYR,23,67,4,23,27
3,8480145,Neal Pionk,D,WPG,29,73,2,25,27
3,8481582,Nicholas Robertson,L,TOR,23,64,14,12,26
3,8479941,Justin Danforth,R,CBJ,31,59,14,12,26
3,8478109,Victor Olofsson,L,VGK,29,71,13,13,26
3,8482175,JJ Peterka,R,BUF,22,67,12,14,26
3,8477507,Nikita Zadorov,D,BOS,29,70,12,14,26
3,8475220,Marcus Foligno,L,MIN,33,61,11,15,26
3,8480789,Oliver Wahlstrom,R,NYI,24,71,10,16,26
3,8475149,Marcus Johansson,L,MIN,34,60,7,19,26
3,8478882,Vladislav Gavrikov,D,LAK,29,73,5,21,26
3,8476467,Jamie Oleksiak,D,SEA,32,69,5,21,26
3,8482079,Marco Rossi,C,MIN,23,56,15,10,25
3,8480448,Parker Kelly,L,COL,25,73,14,11,25
3,8480813,Joe Veleno,C,DET,24,75,13,12,25
3,8479393,Noah Gregor,L,OTT,26,74,12,13,25
3,8482133,Thomas Bordeleau,C,SJS,22,66,11,14,25
3,8481553,Bobby Brink,R,PHI,23,65,10,15,25
3,8481522,Peyton Krebs,C,BUF,23,61,9,16,25
3,8476891,Matthew Grzelcyk,D,PIT,30,76,6,19,25
3,8473563,Nicklas Backstrom,C,WSH,37,53,6,19,25
3,8479976,Juuso Valimaki,D,UTA,26,65,6,19,25
3,8476917,Adam Pelech,D,NYI,30,79,5,20,25
3,8480043,Timothy Liljegren,D,TOR,25,62,5,20,25
3,8475462,Radko Gudas,D,ANA,34,69,5,20,25
3,8477506,Ryan Pulock,D,NYI,30,80,4,21,25
3,8480873,Rasmus Sandin,D,WSH,24,58,2,23,25
3,8475181,Nick Leddy,D,STL,33,72,2,23,25
3,8479316,Luke Kunin,C,SJS,27,62,15,9,24
3,8480893,Kirill Marchenko,R,CBJ,24,54,14,10,24
3,8483524,Shane Wright,C,SEA,20,66,13,11,24
3,8479414,Nathan Bastian,R,NJD,27,60,13,11,24
3,8481618,Alex Newhook,C,MTL,23,72,12,12,24
3,8480762,Eric Robinson,L,CAR,29,55,10,14,24
3,8477392,Hudson Fasching,R,NYI,29,60,9,15,24
3,8476525,Colin Miller,D,WPG,32,71,6,18,24
3,8475200,Dmitry Orlov,D,CAR,33,72,5,19,24
3,8476429,Scott Mayfield,D,NYI,32,72,5,19,24
3,8481568,Alex Vlasic,D,CHI,23,59,5,19,24
3,8478136,Jake Middleton,D,MIN,28,74,1,23,24
3,8476981,Josh Anderson,R,MTL,30,64,16,7,23
3,8481093,Rafael Harvey-Pinard,L,MTL,25,63,12,11,23
3,8480995,Pontus Holmberg,R,TOR,25,63,12,11,23
3,8480796,Martin Fehervary,D,WSH,25,60,9,14,23
3,8478133,Jake Evans,C,MTL,28,69,8,15,23
3,8482245,Artem Zub,D,OTT,29,73,6,17,23
3,8474034,Patrick Maroon,L,CHI,36,49,6,17,23
3,8478911,Matt Roy,D,WSH,29,60,5,18,23
3,8480172,Jan Rutta,D,SJS,34,64,5,18,23
3,8478500,Ivan Provorov,D,CBJ,27,79,4,19,23
3,8478840,Will Borgen,D,SEA,28,68,3,20,23
3,8479983,Mario Ferraro,D,SJS,26,68,1,22,23
3,8482259,Bobby McMann,C,TOR,28,65,14,8,22
3,8476918,Jimmy Vesey,L,NYR,31,67,13,9,22
3,8478508,Yakov Trenin,C,MIN,27,55,13,9,22
3,8482737,Zack Bolduc,C,STL,21,63,11,11,22
3,8478891,Mason Appleton,C,WPG,28,70,10,12,22
3,8479336,Carl Grundstrom,R,SJS,27,53,10,12,22
3,8481704,Juuso Parssinen,C,NSH,23,58,9,13,22
3,8479390,Taylor Raddysh,R,WSH,26,56,9,13,22
3,8480980,Connor Dewar,C,TOR,25,70,9,13,22
3,8477508,Curtis Lazar,C,NJD,29,61,9,13,22
3,8475231,Casey Cizikas,C,NYI,33,69,8,14,22
3,8481527,Kaedan Korczak,D,VGK,23,51,7,15,22
3,8476902,Esa Lindell,D,DAL,30,76,5,17,22
3,8479324,Ryan Lindgren,D,NYR,26,57,5,17,22
3,8481606,Jordan Spence,D,LAK,23,66,4,18,22
3,8473507,Jeff Petry,D,DET,37,69,3,19,22
3,8480878,Nils Lundkvist,D,DAL,24,70,2,20,22
3,8475764,Cam Fowler,D,ANA,33,70,1,21,22
3,8476469,Joel Armia,R,MTL,31,63,12,9,21
3,8479996,Cody Glass,C,NSH,25,51,10,11,21
3,8478432,Christian Fischer,R,DET,27,76,10,11,21
3,8480011,Klim Kostin,C,SJS,25,50,10,11,21
3,8475225,Craig Smith,C,CHI,35,49,10,11,21
3,8483482,Tristan Luneau,D,ANA,20,60,9,12,21
3,8478569,Noel Acciari,C,PIT,33,59,8,13,21
3,8475188,Brayden McNabb,D,VGK,33,46,8,13,21
3,8480192,Johnathan Kovacevic,D,NJD,27,47,8,13,21
3,8475790,Erik Gudbranson,D,CBJ,32,77,6,15,21
3,8481059,Scott Perunovich,D,STL,26,59,5,16,21
3,8477220,Nate Schmidt,D,FLA,33,65,4,17,21
3,8480049,Dylan Samberg,D,WPG,25,65,3,18,21
3,8479982,Conor Timmins,D,TOR,26,66,2,19,21
3,8476878,Zemgus Girgensons,C,TBL,30,81,15,5,20
3,8475855,Jesper Fast,R,CAR,33,62,11,9,20
3,8480025,MacKenzie Entwistle,R,FLA,25,60,11,9,20
3,8478463,Anthony Beauvillier,L,PIT,27,59,10,10,20
3,8482679,Matt Coronato,R,CGY,22,66,10,10,20
3,8480205,Emil Bemstrom,C,PIT,25,56,10,10,20
3,8481481,Blake Lizotte,C,PIT,27,58,10,10,20
3,8477369,Carson Soucy,D,VAN,30,58,9,11,20
3,8481546,Cam York,D,PHI,23,64,8,12,20
3,8478043,Sam Lafferty,C,BUF,29,59,8,12,20
3,8475842,Sam Carrick,C,NYR,32,55,7,13,20
3,8479661,Tanner Jeannot,L,LAK,27,77,5,15,20
3,8479371,Dante Fabbro,D,NSH,26,64,5,15,20
3,8479372,Joshua Mahura,D,SEA,26,51,5,15,20
3,8482192,Isaak Phillips,D,CHI,23,50,4,16,20
3,8480807,Mattias Samuelsson,D,BUF,24,52,3,17,20
3,8475324,Nick Jensen,D,OTT,34,71,3,17,20
3,8478416,Erik Cernak,D,TBL,27,77,3,17,20
3,8481601,Simon Holmstrom,R,NYI,23,68,12,7,19
3,8482062,Cole Smith,L,NSH,29,59,11,8,19
3,8479370,Tyson Jost,C,CAR,26,46,8,11,19
3,8476331,Dylan DeMelo,D,WPG,31,69,7,12,19
3,8482803,Olen Zellweger,D,ANA,21,63,7,12,19
3,8477979,Nicolas Aube-Kubel,R,BUF,28,63,6,13,19
3,8478013,Jake Walman,D,SJS,28,71,6,13,19
3,8476925,Colton Sissons,C,NSH,31,66,6,13,19
3,8481441,Joe Snively,C,DET,28,69,6,13,19
3,8480144,David Kampf,C,TOR,29,67,6,13,19
3,8480073,Erik Brannstrom,D,COL,25,62,4,15,19
3,8475343,Nic Dowd,C,WSH,34,58,4,15,19
3,8481014,Alexander Romanov,D,NYI,24,78,4,15,19
3,8482142,Jamie Drysdale,D,PHI,22,66,3,16,19
3,8480891,Michael Kesselring,D,UTA,24,61,3,16,19
3,8474574,Tyler Myers,D,VAN,34,64,3,16,19
3,8482087,Kaiden Guhle,D,MTL,22,69,2,17,19
3,8474673,TJ Brodie,D,CHI,34,61,2,17,19
3,8475179,Dmitry Kulikov,D,FLA,34,58,2,17,19
3,8482451,Mikael Pyyhtia,L,CBJ,23,47,2,17,19
3,8476879,Cody Ceci,D,EDM,31,65,1,18,19
3,8481032,Paul Cotter,C,NJD,25,49,13,5,18
3,8482155,Alex Laferriere,R,LAK,23,61,11,7,18
3,8477406,Mattias Janmark,C,EDM,32,67,10,8,18
3,8482157,Will Cuylle,L,NYR,22,61,9,9,18
3,8477015,Connor Brown,R,EDM,30,63,9,9,18
3,8480355,Mark Kastelic,C,BOS,25,61,9,9,18
3,8481521,Ronnie Attard,D,PHI,25,55,7,11,18
3,8479353,Brett Howden,C,VGK,26,72,4,14,18
3,8478178,Darren Raddysh,D,TBL,28,71,3,15,18
3,8481708,Zac Jones,D,NYR,24,51,2,16,18
3,8475690,Chris Tanev,D,TOR,35,60,1,17,18
3,8477446,Michael McCarron,R,NSH,29,59,13,4,17
3,8477573,Nathan Walker,L,STL,30,53,12,5,17
3,8476889,Radek Faksa,C,STL,30,60,10,7,17
3,8483493,Frank Nazar,C,CHI,20,57,9,8,17
3,8477450,Jason Dickinson,C,CHI,29,54,9,8,17
3,8479368,Max Jones,L,BOS,26,69,9,8,17
3,8480848,Ty Dellandrea,C,SJS,24,43,8,9,17
3,8481013,Jonatan Berggren,R,DET,24,59,8,9,17
3,8482730,Brandt Clarke,D,LAK,21,51,6,11,17
3,8481598,Philip Broberg,D,EDM,23,48,6,11,17
3,8482496,Nils Aman,C,VAN,24,43,6,11,17
3,8483457,Lane Hutson,D,MTL,20,64,5,12,17
3,8476892,Colton Parayko,D,STL,31,71,4,13,17
3,8470600,Ryan Suter,D,STL,39,65,3,14,17
3,8479398,Samuel Girard,D,COL,26,66,2,15,17
3,8480246,Nick Perbix,D,TBL,26,70,2,15,17
3,8479369,Andrew Peeke,D,BOS,26,55,2,15,17
3,8476873,Mark Jankowski,C,NSH,30,53,9,7,16
3,8482148,Hendrix Lapierre,C,WSH,22,52,9,7,16
3,8476994,Vinnie Hinostroza,C,NSH,30,49,8,8,16
3,8480845,Rasmus Kupari,C,WPG,24,46,8,8,16
3,8482807,Ethan Del Mastro,D,CHI,21,54,8,8,16
3,8473453,Trevor Lewis,C,LAK,37,77,7,9,16
3,8481517,Brett Leason,R,ANA,25,56,7,9,16
3,8477903,Garnet Hathaway,R,PHI,33,62,6,10,16
3,8477353,Tyler Motte,C,DET,29,68,6,10,16
3,8479543,Michael Pezzetta,L,MTL,26,51,6,10,16
3,8477482,Zachary Sanford,L,CHI,30,48,6,10,16
3,8476960,Andreas Athanasiou,C,CHI,30,44,5,11,16
3,8479520,Brandon Duhaime,R,WSH,27,56,5,11,16
3,8476856,Mathew Dumba,D,DAL,30,72,4,12,16
3,8478211,Dryden Hunt,L,CGY,29,57,4,12,16
3,8482749,Joshua Roy,R,MTL,21,63,3,13,16
3,8476312,Josh Manson,D,COL,33,57,3,13,16
3,8477887,Patrick Brown,C,BOS,32,50,1,15,16
3,8477365,Connor Clifton,D,BUF,29,56,0,16,16
3,8479439,Jacob MacDonald,D,COL,31,49,12,3,15
3,8477478,William Carrier,L,CAR,30,57,11,4,15
3,8477931,Tomas Nosek,L,FLA,32,62,8,7,15
3,8481716,Dmitri Voronkov,L,CBJ,24,46,8,7,15
3,8479944,Zach Aston-Reese,C,VGK,30,49,8,7,15
3,8479619,Michael Carcone,L,UTA,28,62,7,8,15
3,8476422,Mike Reilly,D,NYI,31,76,7,8,15
3,8477919,Frederick Gaudreau,C,MIN,31,65,7,8,15
3,8479291,Kevin Rooney,C,CGY,31,52,7,8,15
3,8482634,Alex Steeves,C,TOR,25,51,7,8,15
3,8475233,David Savard,D,MTL,34,60,6,9,15
3,8483468,Jiri Kulich,C,BUF,20,55,5,10,15
3,8481537,Nikita Okhotiuk,D,CGY,24,55,4,11,15
3,8483565,Nick Blankenburg,D,NSH,26,67,4,11,15
3,8480887,Jordan Harris,D,MTL,24,49,4,11,15
3,8479402,Jake Bean,D,CGY,26,66,3,12,15
3,8476329,Travis Boyd,C,MIN,31,50,3,12,15
3,8478443,Brandon Carlo,D,BOS,28,62,3,12,15
3,8478851,Alexandre Carrier,D,NSH,28,60,3,12,15
3,8482655,Janis Moser,D,TBL,24,76,2,13,15
3,8475279,Ben Chiarot,D,DET,33,65,2,13,15
3,8478507,John Marino,D,UTA,27,67,2,13,15
3,8479344,Jesse Puljujarvi,R,PIT,26,49,9,5,14
3,8478585,Derek Ryan,C,EDM,38,63,8,6,14
3,8481789,Tye Kartye,L,SEA,23,46,8,6,14
3,8482744,James Malatesta,L,CBJ,21,39,7,7,14
3,8480727,Zach Whitecloud,D,VGK,28,53,7,7,14
3,8479968,Vinni Lettieri,C,BOS,29,54,7,7,14
3,8477962,Brendan Lemieux,L,CAR,28,38,7,7,14
3,8478434,Keegan Kolesar,R,VGK,27,58,6,8,14
3,8483491,Ivan Miroshnichenko,L,WSH,20,48,5,9,14
3,8476822,Luke Glendening,C,TBL,35,79,5,9,14
3,8479998,Mikey Anderson,D,LAK,25,62,5,9,14
3,8481567,Henry Thrun,D,SJS,23,55,5,9,14
3,8477499,Rasmus Ristolainen,D,PHI,30,59,4,10,14
3,8478451,Ethan Bear,D,WSH,27,53,4,10,14
3,8476931,Jake McCabe,D,TOR,31,62,3,11,14
3,8483495,Simon Nemec,D,NJD,20,61,3,11,14
3,8479026,Philippe Myers,D,TOR,27,52,3,11,14
3,8481751,Lukas Rousek,R,BUF,25,37,3,11,14
3,8475171,Oliver Ekman-Larsson,D,TOR,33,68,2,12,14
3,8476934,Brock McGinn,L,ANA,30,53,2,12,14
3,8481019,David Gustafsson,C,WPG,24,47,2,12,14
3,8475208,Brian Dumoulin,D,ANA,33,59,1,13,14
3,8480035,Henri Jokiharju,D,BUF,25,64,1,13,14
3,8480252,Cole Guttman,C,CHI,25,39,8,5,13
3,8479328,Julien Gauthier,R,NYI,27,59,7,6,13
3,8479359,Beck Malenstyn,L,BUF,26,44,7,6,13
3,8480806,Isac Lundestrom,C,ANA,25,54,6,7,13
3,8480289,Morgan Barron,C,WPG,26,52,6,7,13
3,8481477,Nico Sturm,C,SJS,29,59,6,7,13
3,8482166,Shakir Mukhamadullin,D,SJS,22,53,6,7,13
3,8476442,Matt Nieto,L,PIT,32,50,6,7,13
3,8478399,Jonas Siegenthaler,D,NJD,27,57,4,9,13
3,8477070,Liam O'Brien,C,UTA,30,57,4,9,13
3,8477018,Ben Hutton,D,VGK,31,54,4,9,13
3,8476473,Connor Murphy,D,CHI,31,41,4,9,13
3,8474567,Zach Bogosian,D,MIN,34,65,4,9,13
3,8477845,Trevor van Riemsdyk,D,WSH,33,58,3,10,13
3,8482111,Justin Barron,D,MTL,23,66,2,11,13
3,8474166,Alec Martinez,D,CHI,37,47,2,11,13
3,8480281,Alexey Toropchenko,R,STL,25,56,8,4,12
3,8479671,Mathieu Olivier,R,CBJ,27,48,8,4,12
3,8481028,Martin Pospisil,C,CGY,25,52,7,5,12
3,8476374,Sean Kuraly,C,CBJ,31,57,6,6,12
3,8471817,Ryan Reaves,R,TOR,37,54,6,6,12
3,8480860,Kevin Bahl,D,CGY,24,55,6,6,12
3,8482747,Brennan Othmann,L,NYR,21,43,6,6,12
3,8478859,Niko Mikkola,D,FLA,28,57,5,7,12
3,8476858,Phillip Di Giuseppe,L,VAN,31,45,4,8,12
3,8480157,Calle Rosen,D,COL,30,53,4,8,12
3,8481754,Nikita Nesterenko,C,ANA,23,32,4,8,12
3,8479980,Nicolas Hague,D,VGK,26,51,3,9,12
3,8481178,Egor Zamula,D,PHI,24,50,3,9,12
3,8475718,Justin Holl,D,DET,32,66,3,9,12
3,8480070,Ian Mitchell,D,BOS,25,54,3,9,12
3,8484149,Gavin Brindley,C,CBJ,20,52,2,10,12
3,8482652,Walker Duehr,R,CGY,27,36,8,3,11
3,8478421,A.J. Greer,L,FLA,28,59,7,4,11
3,8482176,Wyatt Kaiser,D,CHI,22,51,6,5,11
3,8481641,Joel Kiviranta,L,COL,28,73,6,5,11
3,8481518,Nolan Foote,L,NJD,24,43,6,5,11
3,8482751,Ryan Winterton,C,SEA,21,41,6,5,11
3,8483466,Kevin Korchinski,D,CHI,20,54,4,7,11
3,8478409,Anthony Richard,C,PHI,28,40,4,7,11
3,8476624,Barclay Goodrow,C,SJS,31,51,3,8,11
3,8478468,Jeremy Lauzon,D,NSH,27,49,2,9,11
3,8481550,Adam Beckman,L,NJD,23,41,2,9,11
3,8479986,Kole Lind,R,DAL,26,48,2,9,11
3,8475762,Derek Forbort,D,VAN,32,46,2,9,11
3,8474013,Ian Cole,D,UTA,35,52,2,9,11
3,8478017,Mark Friedman,D,VAN,29,37,2,9,11
3,8483460,David Jiricek,D,CBJ,21,59,1,10,11
3,8483619,Filip Roos,D,OTT,25,34,1,10,11
3,8480222,Sebastian Aho,D,PIT,28,69,0,11,11
3,8476967,Brett Kulak,D,EDM,30,60,0,11,11
3,8480001,Urho Vaakanainen,D,ANA,25,61,0,11,11
3,8482077,Dylan Holloway,L,EDM,23,55,8,2,10
3,8482762,Simon Edvinsson,D,DET,21,56,8,2,10
3,8477380,Jonny Brodzinski,C,NYR,31,56,5,5,10
3,8479718,Alex Barré-Boulet,C,MTL,27,47,5,5,10
3,8480990,Declan Chisholm,D,MIN,24,39,5,5,10
3,8483012,Logan Morrison,C,SEA,22,38,4,6,10
3,8476372,Nick Seeler,D,PHI,31,45,3,7,10
3,8477034,Jaycob Megna,D,FLA,32,47,3,7,10
3,8480950,Ilya Lyubushkin,D,DAL,30,57,2,8,10
3,8474090,Brendan Smith,D,DAL,35,54,2,8,10
3,8474568,Luke Schenn,D,NSH,35,51,0,10,10
3,8474612,Travis Hamonic,D,OTT,34,49,0,10,10
3,8480021,Jack Studnicka,C,LAK,25,57,7,2,9
3,8481617,Vasily Podkolzin,R,VAN,23,42,4,5,9
3,8476867,Brendan Gaunce,C,MIN,30,38,4,5,9
3,8482859,Zack Ostapchuk,C,OTT,21,57,3,6,9
3,8479442,Troy Stecher,D,EDM,30,56,3,6,9
3,8481122,Simon Benoit,D,TOR,26,46,2,7,9
3,8483763,Maksymilian Szuber,D,UTA,22,31,2,7,9
3,8471709,Marc-Edouard Vlasic,D,SJS,37,52,1,8,9
3,8481679,Maxence Guenette,D,OTT,23,32,5,3,8
3,8479066,Ryan Lomberg,L,CGY,30,62,4,4,8
3,8478454,Noah Juulsen,D,VAN,27,45,4,4,8
3,8481147,Reese Johnson,C,MIN,26,38,4,4,8
3,8481161,Jake Christiansen,D,CBJ,25,57,4,4,8
3,8480058,Pierre-Olivier Joseph,D,STL,25,49,4,4,8
3,8482964,Arber Xhekaj,D,MTL,23,49,4,4,8
3,8482145,Mavrik Bourque,C,DAL,22,50,4,4,8
3,8483630,Pavol Regenda,L,ANA,25,30,4,4,8
3,8483499,Liam Ohgren,L,MIN,20,50,3,5,8
3,8479638,Justin Brazeau,R,BOS,26,38,3,5,8
3,8477938,Haydn Fleury,D,WPG,28,42,3,5,8
3,8482070,Mitchell Chaffee,R,TBL,26,55,3,5,8
3,8483549,Lucas Condotta,L,MTL,27,45,2,6,8
3,8475177,Calvin de Haan,D,COL,33,46,2,6,8
3,8480245,Olle Lycksell,R,PHI,25,27,2,6,8
3,8482765,Isak Rosen,R,BUF,21,26,2,6,8
3,8479249,Andrew Poturalski,C,SJS,30,27,1,7,8
3,8477335,Kyle Burroughs,D,LAK,29,46,0,8,8
3,8475455,Brenden Dillon,D,NJD,34,64,0,8,8
3,8480292,Carson Meyer,R,ANA,27,37,0,8,8
3,8484254,Akito Hirose,D,VAN,25,40,0,8,8
3,8478831,Kevin Stenlund,C,UTA,28,53,5,2,7
3,8477401,John Hayden,C,SEA,29,30,5,2,7
3,8476441,Joel Edmundson,D,LAK,31,42,4,3,7
3,8479994,Jaret Anderson-Dolan,C,WPG,25,41,4,3,7
3,8480007,Jonas Rondbjerg,R,VGK,25,39,4,3,7
3,8481167,Brayden Pachal,D,CGY,25,46,3,4,7
3,8478424,Jansen Harkins,C,ANA,27,49,3,4,7
3,8479991,Jake Leschyshyn,C,NYR,25,34,3,4,7
3,8475235,Nicolas Deslauriers,L,PHI,33,54,3,4,7
3,8480880,Jakub Lauko,C,MIN,24,34,3,4,7
3,8480834,Ty Emberson,D,SJS,24,38,2,5,7
3,8476874,Olli Maatta,D,DET,30,58,1,6,7
3,8478450,Parker Wotherspoon,D,BOS,27,38,1,6,7
3,8473446,Erik Johnson,D,PHI,36,56,1,6,7
3,8481593,Jayden Struble,D,MTL,23,31,1,6,7
3,8481701,Santeri Hatakka,D,NJD,23,43,0,7,7
3,8482659,Josh Doan,R,UTA,22,50,5,1,6
3,8484287,Cole McWard,D,VAN,23,26,5,1,6
3,8478874,Adam Gaudette,R,OTT,28,34,4,2,6
3,8476952,Dominic Toninato,C,WPG,30,29,3,3,6
3,8484911,Collin Graf,R,SJS,22,37,3,3,6
3,8482784,Zach Dean,C,STL,21,37,3,3,6
3,8478146,Matthew Highmore,C,OTT,28,38,3,3,6
3,8479536,Axel Jonsson-Fjallby,L,WPG,26,37,3,3,6
3,8480441,Trey Fix-Wolansky,R,CBJ,25,31,3,3,6
3,8479985,Cale Fleury,D,SEA,26,25,3,3,6
3,8479367,William Lockwood,R,FLA,26,23,3,3,6
3,8479379,Givani Smith,R,SJS,26,32,2,4,6
3,8476913,Devin Shore,C,MIN,30,46,2,4,6
3,8480870,Bo Groulx,C,NYR,24,32,2,4,6
3,8482511,Mason Lohrei,D,BOS,23,26,2,4,6
3,8482095,Tyler Kleven,D,OTT,22,35,1,5,6
3,8482861,Vincent Iorio,D,WSH,22,31,1,5,6
3,8479419,Brett Murray,L,BUF,26,20,1,5,6
3,8478452,Caleb Jones,D,LAK,27,49,0,6,6
3,8481056,Spencer Stastney,D,NSH,24,33,0,6,6
3,8482666,Scott Morrow,D,CAR,22,45,3,2,5
3,8483397,Marc McLaughlin,C,BOS,25,23,3,2,5
3,8475750,Jon Merrill,D,MIN,32,56,2,3,5
3,8479972,Mason Shaw,C,WPG,26,34,2,3,5
3,8481600,Tobias Bjornfot,D,FLA,23,40,2,3,5
3,8477851,Jordan Oesterle,D,BOS,32,41,2,3,5
3,8477384,Joshua Brown,D,EDM,30,41,1,4,5
3,8481422,Jake Lucchini,C,NSH,29,18,1,4,5
3,8480879,Jacob Bernard-Docker,D,OTT,24,48,0,5,5
3,8478502,Dennis Gilbert,D,BUF,28,23,0,5,5
3,8479772,Zack MacEwen,R,OTT,28,50,3,1,4
3,8480844,Grigori Denisenko,L,VGK,24,28,2,2,4
3,8478051,Max Willman,C,NJD,29,22,2,2,4
3,8480267,Sammy Walker,C,MIN,25,22,2,2,4
3,8482713,Mackie Samoskevich,R,FLA,22,37,2,2,4
3,8480468,James Hamblin,L,EDM,25,19,2,2,4
3,8481699,Aku Raty,R,UTA,23,17,2,2,4
3,8481609,Vladislav Kolyachonok,D,UTA,23,31,1,3,4
3,8481592,Jakob Pelletier,L,CGY,23,37,1,3,4
3,8482733,Logan Mailloux,D,MTL,31,32,1,3,4
3,8479378,Logan Stanley,D,WPG,26,43,1,3,4
3,8481532,Alex Turcotte,C,LAK,23,44,1,3,4
3,8481743,Marc Del Gaizo,D,NSH,25,24,1,3,4
3,8482172,Landon Slaggert,L,CHI,22,23,1,3,4
3,8482144,Jack Thompson,D,SJS,22,23,1,3,4
3,8481806,Louis Crevier,D,CHI,23,7,1,3,4
3,8481599,Victor Soderstrom,D,UTA,23,41,0,4,4
3,8478477,Mitchell Stephens,C,SEA,27,20,0,4,4
3,8482250,Callahan Burke,C,VGK,27,19,0,4,4
3,8480084,Nick DeSimone,D,NJD,30,13,0,4,4
3,8481585,Egor Afanasyev,L,SJS,23,13,3,0,3
3,8481556,John Beecher,C,BOS,23,29,3,0,3
3,8482141,Lukas Cormier,D,VGK,22,25,2,1,3
3,8479981,Jonah Gadjovich,L,FLA,26,45,2,1,3
3,8477467,Gustav Olofsson,D,SEA,30,27,2,1,3
3,8477244,Chad Ruhwedel,D,NYR,34,33,2,1,3
3,8479348,Kale Clague,D,BUF,26,40,1,2,3
3,8480196,Jacob Bryson,D,BUF,27,38,1,2,3
3,8475958,Michael Sgarbossa,C,WSH,32,24,1,2,3
3,8477810,Joel Hanley,D,CGY,33,22,1,2,3
3,8483512,Matthew Savoie,C,EDM,20,23,1,2,3
3,8480823,Alexander Alexeyev,D,WSH,25,15,1,2,3
3,8480890,Jan Jenik,C,OTT,24,27,1,2,3
3,8477073,Kurtis MacDermid,L,NJD,30,29,0,3,3
3,8477149,Scott Sabourin,R,SJS,32,13,0,3,3
3,8481605,Jackson LaCombe,D,ANA,23,37,0,3,3
3,8481543,Nikita Alexandrov,C,STL,24,25,0,3,3
3,8482094,Daemon Hunt,D,MIN,22,18,0,3,3
3,8481578,Graeme Clarke,R,MIN,23,12,0,3,3
3,8482201,Gage Goncalves,C,TBL,23,21,2,0,2
3,8483597,Milos Kelemen,L,UTA,25,14,2,0,2
3,8479362,Riley Tufte,L,BOS,26,16,2,0,2
3,8481541,Samuel Bolduc,D,NYI,24,21,1,1,2
3,8479576,Vincent Desharnais,D,VAN,28,26,1,1,2
3,8482177,Marat Khusnutdinov,C,MIN,22,41,1,1,2
3,8481719,Maxwell Crozier,D,TBL,24,10,1,1,2
3,8483407,Brandon Scanlin,D,NYR,25,7,1,1,2
3,8482470,Ilya Solovyov,D,CGY,24,18,1,1,2
3,8478021,William Lagesson,D,DET,28,24,1,1,2
3,8481065,Angus Crookshank,L,OTT,25,17,1,1,2
3,8479320,Maxime Lajoie,D,SEA,27,19,1,1,2
3,8482162,Roby Jarventie,L,EDM,22,17,1,1,2
3,8483567,Georgii Merkulov,C,BOS,24,12,1,1,2
3,8477541,Dakota Mermis,D,TOR,30,9,1,1,2
3,8477527,Ross Johnston,L,ANA,30,27,0,2,2
3,8475795,Dylan McIlrath,D,WSH,32,14,0,2,2
3,8475413,Justin Dowling,C,NJD,34,18,0,2,2
3,8474062,Riley Nash,C,NYR,35,17,0,2,2
3,8482516,Matthew Kessel,D,STL,24,17,0,2,2
3,8481030,Jack St. Ivany,D,PIT,25,15,0,2,2
3,8481726,Adam Edstrom,C,NYR,24,7,0,2,2
3,8482165,Yan Kuznetsov,D,CGY,22,20,0,2,2
3,8482858,Ryker Evans,D,SEA,23,20,0,2,2
3,8481006,Tyler Tucker,D,STL,24,12,0,2,2
3,8482929,Emil Lilleberg,D,TBL,23,21,0,2,2
3,8480075,Cameron Crotty,D,MIN,25,9,0,2,2
3,8479330,Brandon Gignac,C,MTL,27,8,0,2,2
3,8471677,Jack Johnson,D,CBJ,37,62,1,0,1
3,8482153,Brendan Brisson,C,VGK,23,36,1,0,1
3,8477473,Justin Bailey,R,SJS,29,29,1,0,1
3,8477971,Andreas Englund,D,LAK,28,21,1,0,1
3,8483570,Ben Meyers,C,SEA,26,20,1,0,1
3,8482118,Sam Colangelo,R,ANA,23,17,1,0,1
3,8481237,Kyle MacLean,C,NYI,25,25,1,0,1
3,8480032,Shane Bowers,C,NJD,25,15,1,0,1
3,8477320,Anton Blidh,L,NYR,29,15,1,0,1
3,8478881,Brett Seney,L,CHI,28,13,1,0,1
3,8478147,Bokondji Imama,L,PIT,28,8,1,0,1
3,8479587,Rhett Gardner,C,PHI,28,14,1,0,1
3,8484255,Jason Polin,R,COL,25,2,1,0,1
3,8478854,Ryan Shea,D,PIT,27,5,1,0,1
3,8481462,Mason Morelli,L,VGK,28,14,1,0,1
3,8475780,Chris Wagner,R,COL,33,7,1,0,1
3,8484258,Sam Malinski,D,COL,26,23,0,1,1
3,8483395,Arshdeep Bains,L,VAN,23,12,0,1,1
3,8483920,Pierrick Dube,R,WSH,23,3,0,1,1
3,8482102,Vasily Ponomarev,C,PIT,22,19,0,1,1
3,8483546,Marshall Rifai,D,TOR,26,3,0,1,1
3,8484325,Waltteri Merela,C,TBL,26,14,0,1,1
3,8482061,Brandon Biro,L,SEA,26,15,0,1,1
3,8475755,Alexander Petrovic,D,DAL,32,11,0,1,1
3,8476323,Max McCormick,L,SEA,32,2,0,1,1
3,8477462,Robert Hagg,D,VGK,29,23,0,0,0
3,8483471,Brad Lambert,C,WPG,31,6,0,0,0
3,8482126,Emil Andrae,D,PHI,31,5,0,0,0
3,8482088,Justin Sourdif,R,FLA,22,16,0,0,0
3,8481043,Cole Koepke,L,BOS,26,15,0,0,0
3,8481564,Ryan Johnson,D,BUF,23,13,0,0,0
3,8481206,John Ludvig,D,PIT,24,17,0,0,0
3,8482460,Matt Rempe,C,NYR,22,6,0,0,0
3,8480874,Adam Ginning,D,PHI,24,9,0,0,0
3,8480851,Akil Thomas,C,LAK,24,24,0,0,0
3,8479421,Jacob Moverare,D,LAK,26,11,0,0,0
3,8483398,Declan Carlile,D,TBL,31,8,0,0,0
3,8482147,Jean-Luc Foudy,C,COL,22,22,0,0,0
3,8483489,Fraser Minten,C,TOR,31,7,0,0,0
3,8483609,Adam Klapka,R,CGY,24,4,0,0,0
3,8477993,Justin Kirkland,C,CGY,28,7,0,0,0
3,8480306,Grant Hutton,D,NYI,29,6,0,0,0
3,8481655,Cole Schwindt,R,CGY,23,6,0,0,0
3,8481024,Linus Karlsson,C,VAN,25,10,0,0,0
3,8478446,Glenn Gawdin,C,LAK,27,9,0,0,0
3,8484304,Uvis Balinskis,D,FLA,28,13,0,0,0
3,8483531,Brian Halonen,L,NJD,25,1,0,0,0
3,8478011,Louie Belpedio,D,PHI,28,15,0,0,0
3,8482787,Nikita Chibrikov,R,WPG,31,4,0,0,0
3,8470794,Joe Pavelski,C,,40,0,0,0,0
3,8479321,Lucas Johansen,D,,27,0,0,0,0
3,8477950,Tony DeAngelo,D,,29,0,0,0,0
3,8471218,Blake Wheeler,R,,38,0,0,0,0
3,8475197,Tyson Barrie,D,,33,0,0,0,0
3,8474157,Max Pacioretty,L,,36,0,0,0,0
3,8475744,Evgeny Kuznetsov,C,,32,0,0,0,0
3,8474037,James van Riemsdyk,L,,35,0,0,0,0
3,8476907,Mackenzie MacEachern,L,,30,0,0,0,0
3,8480216,Jacob Peterson,C,,25,0,0,0,0
3,8474602,Justin Schultz,D,,34,0,0,0,0
3,8482222,Alexander Barabanov,L,,30,0,0,0,0
3,8474031,Kevin Shattenkirk,D,,35,0,0,0,0
3,8477330,Dominik Kubalik,L,,29,0,0,0,0
3,8480884,Calen Addison,D,,24,0,0,0,0
3,8475906,John Klingberg,D,,32,0,0,0,0
3,8480008,Adam Ruzicka,C,,25,0,0,0,0
3,8476884,Derrick Pouliot,D,,30,0,0,0,0
3,8476919,Chris Tierney,C,,30,0,0,0,0
3,8479415,Michael McLeod,C,,26,0,0,0,0
3,8474870,Tyler Johnson,C,,34,0,0,0,0
3,8470604,Jeff Carter,C,,39,0,0,0,0
3,8478104,Sammy Blais,L,,28,0,0,0,0
3,8474884,Mike Hoffman,C,,35,0,0,0,0
3,8481591,Sam Poulin,R,,23,0,0,0,0
3,8471274,Alex Goligoski,D,,39,0,0,0,0
3,8476871,Tanner Pearson,L,,32,0,0,0,0
3,8476393,Nick Cousins,C,,31,0,0,0,0
3,8479977,Kailer Yamamoto,R,,26,0,0,0,0
3,8479346,Dillon Dube,C,,26,0,0,0,0
3,8480184,Gustav Lindstrom,D,,26,0,0,0,0
3,8479376,Victor Mete,D,,26,0,0,0,0
3,8473449,Kyle Okposo,R,,36,0,0,0,0
3,8481058,Jesse Ylonen,R,,25,0,0,0,0
3,8475752,Tyler Pitlick,C,,33,0,0,0,0
3,8481239,Samuel Fagemo,L,,24,0,0,0,0
3,8480821,Filip Zadina,R,,25,0,0,0,0
3,8470966,Mark Giordano,D,,41,0,0,0,0
3,8478495,Denis Gurianov,R,,27,0,0,0,0
3,8477464,Nic Petan,C,,29,0,0,0,0
3,8478099,Kevin Labanc,R,,29,0,0,0,0
3,8482241,Radim Zohorna,L,,28,0,0,0,0
3,8474040,Sam Gagner,C,,35,0,0,0,0
3,8479514,Rem Pitlick,C,,27,0,0,0,0
3,8478430,Oliver Kylington,D,,27,0,0,0,0
3,8479533,Joona Koppanen,L,,26,0,0,0,0
3,8479984,Cal Foote,D,,26,0,0,0,0
3,8477126,Jayson Megna,C,,34,0,0,0,0
3,8475164,Jakob Silfverberg,R,,34,0,0,0,0
3,8474009,Nick Bonino,C,,36,0,0,0,0
3,8479458,Nikita Zaitsev,D,,33,0,0,0,0
3,8477944,Jakub Vrana,L,,28,0,0,0,0
3,8471699,Andrew Cogliano,C,,37,0,0,0,0
3,8478067,Oskar Lindblom,L,,28,0,0,0,0
3,8471686,Marc Staal,D,,37,0,0,0,0
3,8470610,Zach Parise,L,,40,0,0,0,0
3,8478904,Steven Lorentz,C,,28,0,0,0,0
3,8473473,Milan Lucic,L,,36,0,0,0,0
3,8480031,Maxime Comtois,L,,25,0,0,0,0
3,8478512,Austin Czarnik,C,,32,0,0,0,0
3,8473504,Cal Clutterbuck,R,,37,0,0,0,0
3,8477454,Adam Erne,L,,29,0,0,0,0
3,8479383,Boris Katchouk,L,,26,0,0,0,0
3,8475825,Jani Hakanpää,D,,32,0,0,0,0
3,8477846,Ryan Carpenter,C,,33,0,0,0,0
3,8477930,Pierre-Edouard Bellemare,L,,39,0,0,0,0
3,8478400,Colin White,C,,27,0,0,0,0
3,8480226,Marián Studenic,R,,26,0,0,0,0
3,8480853,Liam Foudy,C,,24,0,0,0,0
3,8475797,Jarred Tinordi,D,,32,0,0,0,0
3,8479423,Alex Nylander,L,,26,0,0,0,0
3,8474618,Marco Scandella,D,,34,0,0,0,0
3,8478028,Fredrik Olofsson,L,,28,0,0,0,0
3,8474709,Matt Martin,L,,35,0,0,0,0
3,8479522,Hardy Haman Aktell,D,WSH,26,3,0,0,0
3,8481070,Hugh McGing,L,,26,0,0,0,0
3,8479546,Oskar Steen,C,,26,0,0,0,0
3,8474145,Robert Bortuzzo,D,,35,0,0,0,0
3,8476915,Jujhar Khaira,L,,30,0,0,0,0
3,8480274,Philip Kemp,D,EDM,25,0,0,0,0
3,8484326,Patrik Koch,D,UTA,28,1,0,0,0
3,8484321,Nikolas Matinpalo,D,OTT,26,1,0,0,0
3,8475278,Byron Froese,C,,33,0,0,0,0
3,8481812,Nikolai Knyzhov,D,,27,0,0,0,0
3,8478408,Travis Dermott,D,,28,0,0,0,0
3,8481077,John Leonard,L,,26,0,0,0,0
3,8479547,Matthew Phillips,R,,26,0,0,0,0
3,8482197,Adam Raska,R,MIN,23,2,0,0,0
3,8480836,Jonathan Gruden,C,,24,0,0,0,0
3,8481690,Tyler Angle,C,,24,0,0,0,0
3,8475766,Austin Watson,L,,32,0,0,0,0
3,8481016,Ruslan Iskhakov,C,,24,0,0,0,0
3,8478078,Rourke Chartier,C,,28,0,0,0,0
3,8484259,Ondrej Pavel,C,COL,31,6,0,0,0
3,8483401,Marc Johnstone,R,PIT,28,3,0,0,0
3,8480776,Sheldon Rempal,R,,29,0,0,0,0
3,8478956,Samuel Laberge,L,NJD,27,3,0,0,0
3,8483432,Luca Del Bel Belluz,C,CBJ,31,5,0,0,0
3,8483045,Cameron Butler,R,CBJ,31,1,0,0,0
3,8481534,Raphael Lavoie,C,EDM,24,3,0,0,0
3,8482476,Emil Heineman,L,MTL,23,7,0,0,0
3,8484314,Jiri Smejkal,L,,28,0,0,0,0
4,8478402,Connor McDavid,C,EDM,27,74,40,102,142
4,8477934,Leon Draisaitl,C,EDM,29,77,52,87,139
4,8477492,Nathan MacKinnon,C,COL,29,81,54,81,135
4,8476453,Nikita Kucherov,R,TBL,31,82,38,96,134
4,8477939,William Nylander,R,TOR,28,80,52,68,120
4,8477956,David Pastrnak,R,BOS,28,80,50,69,119
4,8481559,Jack Hughes,C,NJD,23,78,46,73,119
4,8478420,Mikko Rantanen,R,COL,28,82,53,65,118
4,8479318,Auston Matthews,C,TOR,27,79,57,60,117
4,8478550,Artemi Panarin,L,NYR,33,75,32,84,116
4,8477493,Aleksander Barkov,C,FLA,29,75,35,79,114
4,8478483,Mitch Marner,R,TOR,27,79,33,81,114
4,8479343,Clayton Keller,R,UTA,26,80,42,68,110
4,8479314,Matthew Tkachuk,L,FLA,27,78,32,74,106
4,8479407,Jesper Bratt,L,NJD,26,77,30,71,101
4,8476468,J.T. Miller,C,VAN,31,72,29,68,97
4,8475172,Nazem Kadri,C,CGY,34,78,43,52,95
4,8477933,Sam Reinhart,C,FLA,29,76,43,52,95
4,8471675,Sidney Crosby,C,PIT,37,77,41,54,95
4,8477942,Kevin Fiala,L,LAK,28,78,38,56,94
4,8480801,Brady Tkachuk,L,OTT,25,79,44,49,93
4,8474141,Patrick Kane,R,DET,36,81,32,60,92
4,8480023,Robert Thomas,C,STL,25,77,30,61,91
4,8478403,Jack Eichel,C,VGK,28,76,43,47,90
4,8476887,Filip Forsberg,L,NSH,30,71,42,48,90
4,8479337,Alex DeBrincat,R,DET,27,81,35,55,90
4,8480012,Elias Pettersson,C,VAN,26,78,34,56,90
4,8482116,Tim Stützle,C,OTT,22,80,27,63,90
4,8480027,Jason Robertson,L,DAL,25,82,24,65,89
4,8477402,Pavel Buchnevich,L,STL,29,75,45,43,88
4,8478864,Kirill Kaprizov,L,MIN,27,71,32,56,88
4,8478445,Mathew Barzal,C,NYI,27,80,19,69,88
4,8478010,Brayden Point,C,TBL,28,81,43,44,87
4,8477404,Jake Guentzel,C,TBL,30,79,41,46,87
4,8476454,Ryan Nugent-Hopkins,C,EDM,31,78,34,53,87
4,8477409,Carter Verhaeghe,C,FLA,29,77,41,44,85
4,8477946,Dylan Larkin,C,DET,28,80,37,46,83
4,8484144,Connor Bedard,C,CHI,19,68,30,53,83
4,8477960,Adrian Kempe,R,LAK,28,81,33,49,82
4,8477501,Valeri Nichushkin,R,COL,29,81,44,37,81
4,8478444,Brock Boeser,R,VAN,27,69,36,44,80
4,8478439,Travis Konecny,R,PHI,27,76,28,52,80
4,8481557,Matt Boldy,L,MIN,23,72,37,42,79
4,8474564,Steven Stamkos,C,NSH,34,74,32,47,79
4,8477496,Elias Lindholm,C,BOS,30,80,38,40,78
4,8478427,Sebastian Aho,C,CAR,27,70,34,44,78
4,8480036,Miro Heiskanen,D,DAL,25,78,18,60,78
4,8479323,Adam Fox,D,NYR,26,76,10,68,78
4,8480069,Cale Makar,D,COL,26,71,20,57,77
4,8480830,Andrei Svechnikov,R,CAR,24,68,29,46,75
4,8474600,Roman Josi,D,NSH,34,73,25,50,75
4,8477951,Nick Schmaltz,C,UTA,28,77,19,55,74
4,8475810,Bryan Rust,R,PIT,32,74,37,36,73
4,8471215,Evgeni Malkin,C,PIT,38,75,31,42,73
4,8475786,Zach Hyman,L,EDM,32,80,33,39,72
4,8477940,Nikolaj Ehlers,L,WPG,28,78,27,45,72
4,8473419,Brad Marchand,L,BOS,36,79,25,47,72
4,8482093,Seth Jarvis,C,CAR,22,73,25,47,72
4,8475168,Matt Duchene,C,DAL,33,82,23,49,72
4,8476346,Johnny Gaudreau,L,CBJ,31,69,16,56,72
4,8475692,Mats Zuccarello,R,MIN,37,73,13,59,72
4,8476539,Jonathan Marchessault,R,NSH,34,76,41,30,71
4,8475913,Mark Stone,R,VGK,32,74,25,46,71
4,8479385,Jordan Kyrou,C,STL,26,75,24,47,71
4,8471685,Anze Kopitar,C,LAK,37,80,22,49,71
4,8476875,Mike Matheson,D,MTL,30,76,11,60,71
4,8478398,Kyle Connor,L,WPG,28,69,39,31,70
4,8479420,Tage Thompson,C,BUF,27,76,35,35,70
4,8480002,Nico Hischier,C,NJD,25,76,23,47,70
4,8480800,Quinn Hughes,D,VAN,25,74,6,64,70
4,8471214,Alex Ovechkin,L,WSH,39,74,37,32,69
4,8476389,Vincent Trocheck,C,NYR,31,79,30,39,69
4,8475765,Vladimir Tarasenko,R,DET,33,80,25,44,69
4,8478469,Thomas Chabot,D,OTT,27,71,18,51,69
4,8473512,Claude Giroux,R,OTT,36,81,32,36,68
4,8478493,Joel Eriksson Ek,C,MIN,27,76,31,37,68
4,8477416,Oliver Bjorkstrand,R,SEA,29,75,24,44,68
4,8474578,Erik Karlsson,D,PIT,34,80,15,53,68
4,8482159,Tyson Foerster,R,PHI,22,78,24,43,67
4,8480803,Evan Bouchard,D,EDM,25,76,18,49,67
4,8477476,Artturi Lehkonen,L,COL,29,81,28,38,66
4,8480208,Drake Batherson,R,OTT,26,80,21,45,66
4,8482124,Quinton Byfield,R,LAK,22,79,26,39,65
4,8476905,Chandler Stephenson,C,SEA,30,72,18,47,65
4,8480865,Noah Dobson,D,NYI,24,81,12,53,65
4,8475754,Brock Nelson,C,NYI,33,81,42,22,64
4,8478449,Roope Hintz,C,DAL,28,81,35,29,64
4,8482740,Wyatt Johnston,C,DAL,21,81,33,31,64
4,8482078,Lucas Raymond,L,DET,22,81,32,32,64
4,8477500,Bo Horvat,C,NYI,29,80,29,35,64
4,8476460,Mark Scheifele,C,WPG,31,74,28,36,64
4,8475166,John Tavares,C,TOR,34,76,23,41,64
4,8477949,Alex Tuch,R,BUF,28,77,22,42,64
4,8475784,Jeff Skinner,C,EDM,32,76,28,35,63
4,8476483,Rickard Rakell,R,PIT,31,72,26,37,63
4,8477504,Josh Morrissey,D,WPG,29,73,8,55,63
4,8475794,Tyler Seguin,C,DAL,32,81,26,36,62
4,8480018,Nick Suzuki,C,MTL,25,72,19,43,62
4,8476456,Jonathan Huberdeau,C,CGY,31,77,16,46,62
4,8478397,Rasmus Andersson,D,CGY,28,80,11,51,62
4,8480039,Martin Necas,C,CAR,25,73,30,31,61
4,8476448,William Karlsson,C,VGK,31,78,23,38,61
4,8475167,Victor Hedman,D,TBL,34,79,15,46,61
4,8475184,Chris Kreider,L,NYR,33,78,34,26,60
4,8478440,Dylan Strome,C,WSH,27,70,30,30,60
4,8478975,Mason Marchment,L,DAL,29,82,27,33,60
4,8482699,Dylan Guenther,R,UTA,21,74,25,35,60
4,8477955,Jared McCann,L,SEA,28,73,23,36,59
4,8477447,Shea Theodore,D,VGK,29,58,17,42,59
4,8478460,Zach Werenski,D,CBJ,27,79,22,36,58
4,8476479,Phillip Danault,C,LAK,31,80,22,36,58
4,8474679,Gustav Nyquist,C,NSH,35,70,14,44,58
4,8477494,Jonathan Drouin,L,COL,29,79,13,45,58
4,8479542,Brandon Hagel,L,TBL,26,82,25,32,57
4,8478873,Troy Terry,R,ANA,27,72,24,33,57
4,8474590,John Carlson,D,WSH,34,70,7,50,57
4,8480014,Gabriel Vilardi,C,WPG,25,72,31,25,56
4,8481068,Yegor Sharangovich,C,CGY,26,76,28,28,56
4,8482665,Matty Beniers,C,SEA,22,78,24,32,56
4,8476459,Mika Zibanejad,C,NYR,31,80,22,34,56
4,8475169,Evander Kane,L,EDM,33,75,21,35,56
4,8479325,Charlie McAvoy,D,BOS,27,72,14,42,56
4,8474102,David Perron,L,OTT,36,78,13,43,56
4,8478542,Evan Rodrigues,C,FLA,31,76,26,29,55
4,8481528,Dylan Cozens,C,BUF,23,73,23,32,55
4,8481711,Matias Maccelli,L,UTA,24,76,19,36,55
4,8470613,Brent Burns,D,CAR,39,78,16,39,55
4,8473994,Jamie Benn,L,DAL,35,82,24,30,54
4,8478414,Timo Meier,R,NJD,28,73,23,31,54
4,8479999,Casey Mittelstadt,C,COL,26,81,23,31,54
4,8475170,Brayden Schenn,C,STL,33,78,23,31,54
4,8475798,Mikael Granlund,C,SJS,32,68,13,41,54
4,8476853,Morgan Rielly,D,TOR,30,70,9,45,54
4,8482110,Dawson Mercer,C,NJD,23,76,34,19,53
4,8482109,Alexis Lafrenière,L,NYR,23,77,33,20,53
4,8480797,Joel Farabee,L,PHI,24,76,25,28,53
4,8476881,Tomas Hertl,C,VGK,31,77,23,30,53
4,8479675,Trevor Moore,L,LAK,29,80,23,30,53
4,8482745,Mason McTavish,C,ANA,21,70,21,32,53
4,8477503,Max Domi,C,TOR,29,81,21,32,53
4,8484153,Leo Carlsson,C,ANA,20,77,18,35,53
4,8480839,Rasmus Dahlin,D,BUF,24,72,15,38,53
4,8477497,Sean Monahan,C,CBJ,30,67,27,25,52
4,8475745,Charlie Coyle,C,BOS,32,80,23,29,52
4,8478856,Conor Garland,R,VAN,28,73,21,31,52
4,8477444,Andre Burakovsky,L,SEA,29,76,21,31,52
4,8478401,Pavel Zacha,C,BOS,27,78,14,38,52
4,8482175,JJ Peterka,R,BUF,22,65,24,27,51
4,8478407,Vince Dunn,D,SEA,28,78,14,37,51
4,8480434,Sean Durzi,D,UTA,26,71,11,40,51
4,8471724,Kris Letang,D,PIT,37,78,9,42,51
4,8475158,Ryan O'Reilly,C,NSH,33,69,25,25,50
4,8476399,Blake Coleman,C,CGY,33,75,24,26,50
4,8478438,Tommy Novak,C,NSH,27,75,24,26,50
4,8477479,Tyler Bertuzzi,L,CHI,29,66,22,28,50
4,8479345,Jakob Chychrun,D,WSH,26,67,15,35,50
4,8474563,Drew Doughty,D,LAK,35,79,14,36,50
4,8478055,Gustav Forsling,D,FLA,28,74,12,38,50
4,8476958,Jaccob Slavin,D,CAR,30,76,9,41,50
4,8481540,Cole Caufield,R,MTL,23,71,22,27,49
4,8483431,Logan Cooley,C,UTA,20,79,19,30,49
4,8481533,Trevor Zegras,C,ANA,23,71,18,31,49
4,8483808,Andrei Kuzmenko,L,CGY,28,72,23,25,48
4,8484145,Zach Benson,L,BUF,19,68,23,25,48
4,8475191,Reilly Smith,R,NYR,33,74,22,26,48
4,8482720,Matthew Knies,L,TOR,22,79,22,26,48
4,8477451,Ryan Hartman,R,MIN,30,70,20,28,48
4,8476872,Scott Laughton,C,PHI,30,74,20,28,48
4,8482475,Yegor Chinakhov,R,CBJ,23,70,17,31,48
4,8477495,Seth Jones,D,CHI,30,73,9,39,48
4,8475726,Tyler Toffoli,C,SJS,32,61,28,19,47
4,8480064,Josh Norris,C,OTT,25,73,23,24,47
4,8477932,Aaron Ekblad,D,FLA,28,70,19,28,47
4,8480113,Alex Iafallo,L,WPG,31,67,19,28,47
4,8482667,William Eklund,L,SJS,22,70,14,33,47
4,8481577,Philip Tomasino,C,NSH,23,69,13,34,47
4,8482684,Luke Hughes,D,NJD,21,68,10,37,47
4,8480028,Morgan Frost,C,PHI,25,78,23,23,46
4,8481560,Arthur Kaliyev,R,LAK,23,78,19,27,46
4,8476792,Torey Krug,D,STL,33,72,15,31,46
4,8477986,Brandon Montour,D,SEA,30,71,14,32,46
4,8477407,Anthony Duclair,L,NYI,29,79,20,25,45
4,8477935,Sam Bennett,C,FLA,28,74,18,27,45
4,8480798,Philipp Kurashev,C,CHI,25,71,18,27,45
4,8484166,Adam Fantilli,C,CBJ,20,69,16,29,45
4,8478466,Daniel Sprong,R,VAN,27,72,15,30,45
4,8474150,Mikael Backlund,C,CGY,35,76,13,32,45
4,8477456,J.T. Compher,L,DET,29,78,13,32,45
4,8481596,Shane Pinto,C,OTT,24,78,17,27,44
4,8476462,Dougie Hamilton,D,NJD,31,74,16,28,44
4,8483515,Juraj Slafkovsky,L,MTL,20,74,13,31,44
4,8477964,Ivan Barbashev,C,VGK,29,78,10,34,44
4,8475314,Anders Lee,L,NYI,34,78,28,15,43
4,8478498,Jake DeBrusk,L,VAN,28,72,25,18,43
4,8480015,Owen Tippett,R,PHI,25,73,22,21,43
4,8480188,Fabian Zetterlund,L,SJS,25,67,15,28,43
4,8478462,Nicolas Roy,C,VGK,27,73,15,28,43
4,8477346,MacKenzie Weegar,D,CGY,30,69,13,30,43
4,8475763,Kevin Hayes,R,PIT,32,60,12,31,43
4,8475753,Justin Faulk,D,STL,32,74,11,32,43
4,8482712,Oskar Olausson,R,COL,22,75,10,33,43
4,8476906,Shayne Gostisbehere,D,CAR,31,76,9,34,43
4,8474565,Alex Pietrangelo,D,VGK,34,61,5,38,43
4,8479525,Ross Colton,C,COL,28,82,20,22,42
4,8475768,Jaden Schwartz,C,SEA,32,68,17,25,42
4,8473986,Alex Killorn,L,ANA,35,72,16,26,42
4,8475218,Mattias Ekholm,D,EDM,34,69,14,28,42
4,8478038,Devon Toews,D,COL,30,63,12,30,42
4,8476923,Damon Severson,D,CBJ,30,77,12,30,42
4,8481581,Thomas Harley,D,DAL,23,77,11,31,42
4,8482097,Jack Quinn,R,BUF,23,64,10,32,42
4,8475793,Ryan Johansen,C,PHI,32,68,22,19,41
4,8478463,Anthony Beauvillier,L,PIT,27,64,19,22,41
4,8477429,Andrew Copp,C,DET,30,81,18,23,41
4,8481656,Aliaksei Protas,C,WSH,23,70,18,23,41
4,8477998,Warren Foegele,L,LAK,28,81,16,25,41
4,8481606,Jordan Spence,D,LAK,23,67,9,32,41
4,8476438,Brandon Saad,L,STL,32,71,25,15,40
4,8482113,Anton Lundell,C,FLA,23,79,21,19,40
4,8481703,Valtteri Puustinen,R,PIT,25,60,18,22,40
4,8478891,Mason Appleton,C,WPG,28,67,17,23,40
4,8478519,Anthony Cirelli,C,TBL,27,82,16,24,40
4,8477511,Anthony Mantha,R,CGY,30,75,16,24,40
4,8478047,Michael Bunting,L,PIT,29,71,15,25,40
4,8482149,Cole Perfetti,C,WPG,22,73,15,25,40
4,8478042,Viktor Arvidsson,L,EDM,31,70,15,25,40
4,8479987,Morgan Geekie,C,BOS,26,80,14,26,40
4,8477953,Kasperi Kapanen,R,STL,28,67,13,27,40
4,8482133,Thomas Bordeleau,C,SJS,22,64,12,28,40
4,8475151,Kyle Palmieri,C,NYI,33,77,20,19,39
4,8476419,Jean-Gabriel Pageau,C,NYI,32,77,18,21,39
4,8476432,Boone Jenner,C,CBJ,31,67,16,23,39
4,8476826,Yanni Gourde,C,SEA,33,70,15,24,39
4,8479351,Sam Steel,C,DAL,26,81,15,24,39
4,8480145,Neal Pionk,D,WPG,29,69,9,30,39
4,8477948,Travis Sanheim,D,PHI,28,69,8,31,39
4,8477426,Nicholas Paul,L,TBL,29,82,18,20,38
4,8477505,Alexander Wennberg,C,SJS,30,62,18,20,38
4,8474586,Jordan Eberle,R,SEA,34,75,17,21,38
4,8479400,Pierre-Luc Dubois,L,WSH,26,68,16,22,38
4,8476458,Ryan Strome,C,ANA,31,71,14,24,38
4,8479425,Filip Hronek,D,VAN,27,75,12,26,38
4,8479410,Mikhail Sergachev,D,UTA,26,68,12,26,38
4,8478458,John (Jack) Roslovic,C,CAR,27,68,11,27,38
4,8481542,Moritz Seider,D,DET,23,74,3,35,38
4,8481618,Alex Newhook,C,MTL,23,69,20,17,37
4,8480078,Filip Chytil,C,NYR,25,70,19,18,37
4,8473533,Jordan Staal,C,CAR,36,64,19,18,37
4,8483524,Shane Wright,C,SEA,20,62,17,20,37
4,8474641,Adam Henrique,C,EDM,34,70,15,22,37
4,8475287,Erik Haula,L,NJD,33,74,15,22,37
4,8481186,Logan O'Connor,R,COL,28,79,15,22,37
4,8479996,Cody Glass,C,NSH,25,56,13,24,37
4,8478472,Mathieu Joseph,R,STL,27,72,11,26,37
4,8476927,Teddy Blueger,C,VAN,30,72,11,26,37
4,8481524,Bowen Byram,D,BUF,23,68,8,29,37
4,8480336,Sean Walker,D,CAR,30,71,8,29,37
4,8476979,Erik Gustafsson,D,DET,32,76,5,32,37
4,8478057,Dakota Joshua,C,VAN,28,68,18,18,36
4,8478366,Frank Vatrano,R,ANA,30,75,17,19,36
4,8480829,Jesperi Kotkaniemi,C,CAR,24,60,15,21,36
4,8478233,Andrew Mangiapane,L,WSH,28,68,8,28,36
4,8477506,Ryan Pulock,D,NYI,30,80,2,34,36
4,8478474,Lawson Crouse,L,UTA,27,72,23,12,35
4,8475799,Nino Niederreiter,R,WPG,32,67,21,14,35
4,8481554,Kaapo Kakko,R,NYR,23,69,18,17,35
4,8480185,Eetu Luostarinen,C,FLA,26,76,15,20,35
4,8478046,Danton Heinen,L,VAN,29,72,14,21,35
4,8479339,Patrik Laine,L,CBJ,26,60,13,22,35
4,8480871,Adam Boqvist,D,FLA,24,70,10,25,35
4,8475764,Cam Fowler,D,ANA,33,69,3,32,35
4,8483490,Pavel Mintyukov,D,ANA,21,70,2,33,35
4,8482055,Drew O'Connor,L,PIT,26,68,18,16,34
4,8482702,Logan Stankoven,C,DAL,21,82,15,19,34
4,8475149,Marcus Johansson,L,MIN,34,68,15,19,34
4,8480068,Ryan Poehling,C,PHI,25,71,14,20,34
4,8474053,Logan Couture,C,SJS,35,53,11,23,34
4,8478396,Noah Hanifin,D,VGK,27,61,9,25,34
4,8476869,Brady Skjei,D,NSH,30,72,8,26,34
4,8481535,Nils Hoglander,L,VAN,24,67,23,10,33
4,8478413,Jordan Greenway,L,BUF,27,59,17,16,33
4,8475714,Calle Jarnkrok,C,TOR,33,71,17,16,33
4,8481604,Pavel Dorofeyev,L,VGK,24,74,14,19,33
4,8479992,Michael Rasmussen,C,DET,25,78,14,19,33
4,8477021,Alex Kerfoot,C,UTA,30,71,13,20,33
4,8476474,Stefan Noesen,R,NJD,31,60,12,21,33
4,8481523,Kirby Dach,C,MTL,23,71,11,22,33
4,8476854,Hampus Lindholm,D,BOS,30,75,9,24,33
4,8475181,Nick Leddy,D,STL,33,69,4,29,33
4,8481580,Connor McMichael,C,WSH,23,54,20,12,32
4,8481553,Bobby Brink,R,PHI,23,64,18,14,32
4,8479316,Luke Kunin,C,SJS,27,54,18,14,32
4,8477952,Robby Fabbri,C,ANA,28,70,17,15,32
4,8479365,Trent Frederic,C,BOS,26,73,16,16,32
4,8476880,Tom Wilson,R,WSH,30,73,15,17,32
4,8475791,Taylor Hall,L,CHI,33,55,15,17,32
4,8477498,Darnell Nurse,D,EDM,29,71,13,19,32
4,8475722,Jason Zucker,L,BUF,32,69,12,20,32
4,8475760,Nick Bjugstad,C,UTA,32,71,11,21,32
4,8483505,Matthew Poitras,C,BOS,20,75,9,23,32
4,8475848,Brendan Gallagher,R,MTL,32,68,18,13,31
4,8471698,T.J. Oshie,R,WSH,38,64,15,16,31
4,8480009,Eeli Tolvanen,R,SEA,25,72,15,16,31
4,8474715,Cameron Atkinson,R,TBL,35,79,15,16,31
4,8477989,Christian Dvorak,C,MTL,28,64,14,17,31
4,8480802,Ryan McLeod,C,BUF,25,72,13,18,31
4,8476925,Colton Sissons,C,NSH,31,62,12,19,31
4,8477488,Brett Pesce,D,NJD,30,75,11,20,31
4,8477987,Ryan Donato,C,CHI,28,58,10,21,31
4,8482671,Owen Power,D,BUF,22,70,9,22,31
4,8476461,Sean Couturier,C,PHI,32,67,9,22,31
4,8479591,Michael Eyssimont,C,TBL,28,81,19,11,30
4,8473422,Nick Foligno,L,CHI,37,61,17,13,30
4,8482092,Ridly Greig,C,OTT,22,79,12,18,30
4,8480835,Jack Drury,C,CAR,24,55,12,18,30
4,8482101,Danil Gushchin,L,SJS,22,62,8,22,30
4,8482122,Brock Faber,D,MIN,22,78,8,22,30
4,8481546,Cam York,D,PHI,23,64,6,24,30
4,8474673,TJ Brodie,D,CHI,34,67,4,26,30
4,8480873,Rasmus Sandin,D,WSH,24,66,3,27,30
4,8478109,Victor Olofsson,L,VGK,29,66,18,11,29
4,8478020,Michael Amadio,R,OTT,28,76,16,13,29
4,8474149,Evgenii Dadonov,R,DAL,35,82,14,15,29
4,8480220,Noah Cates,L,PHI,25,72,13,16,29
4,8481481,Blake Lizotte,C,PIT,27,62,13,16,29
4,8474189,Lars Eller,C,PIT,35,68,11,18,29
4,8481441,Joe Snively,C,DET,28,65,10,19,29
4,8483468,Jiri Kulich,C,BUF,20,59,9,20,29
4,8478500,Ivan Provorov,D,CBJ,27,81,2,27,29
4,8476917,Adam Pelech,D,NYI,30,79,1,28,29
4,8482089,Jake Neighbours,L,STL,22,71,21,7,28
4,8482705,Cole Sillinger,C,CBJ,21,61,16,12,28
4,8480205,Emil Bemstrom,C,PIT,25,58,13,15,28
4,8480003,Jesper Boqvist,C,FLA,26,61,12,16,28
4,8478432,Christian Fischer,R,DET,27,74,12,16,28
4,8482809,Jackson Blake,R,CAR,21,64,11,17,28
4,8475200,Dmitry Orlov,D,CAR,33,71,11,17,28
4,8478013,Jake Walman,D,SJS,28,66,9,19,28
4,8474151,Ryan McDonagh,D,TBL,35,75,2,26,28
4,8479941,Justin Danforth,R,CBJ,31,63,20,7,27
4,8480980,Connor Dewar,C,TOR,25,70,20,7,27
4,8470621,Corey Perry,R,EDM,39,70,17,10,27
4,8480849,Barrett Hayton,C,UTA,24,73,14,13,27
4,8479661,Tanner Jeannot,L,LAK,27,74,13,14,27
4,8480459,Pius Suter,C,VAN,28,65,12,15,27
4,8481093,Rafael Harvey-Pinard,L,MTL,25,57,12,15,27
4,8476480,Vladislav Namestnikov,C,WPG,32,62,11,16,27
4,8475193,Tomas Tatar,L,NJD,34,65,11,16,27
4,8483491,Ivan Miroshnichenko,L,WSH,20,58,11,16,27
4,8482146,Luke Evangelista,R,NSH,22,65,10,17,27
4,8480817,K'Andre Miller,D,NYR,24,70,6,21,27
4,8481521,Ronnie Attard,D,PHI,25,60,5,22,27
4,8474716,Jared Spurgeon,D,MIN,35,74,4,23,27
4,8476331,Dylan DeMelo,D,WPG,31,77,3,24,27
4,8482074,Connor Zary,C,CGY,23,66,16,10,26
4,8477478,William Carrier,L,CAR,30,56,14,12,26
4,8477919,Frederick Gaudreau,C,MIN,31,67,14,12,26
4,8477450,Jason Dickinson,C,CHI,29,61,11,15,26
4,8477507,Nikita Zadorov,D,BOS,29,70,7,19,26
4,8476897,Oskar Sundqvist,C,STL,30,63,5,21,26
4,8476885,Jacob Trouba,D,NYR,30,68,4,22,26
4,8482079,Marco Rossi,C,MIN,23,56,14,11,25
4,8479390,Taylor Raddysh,R,WSH,26,71,14,11,25
4,8480855,Jack McBain,C,UTA,24,67,13,12,25
4,8478043,Sam Lafferty,C,BUF,29,58,13,12,25
4,8476278,Colin Blackwell,C,DAL,31,74,11,14,25
4,8481582,Nicholas Robertson,L,TOR,23,68,11,14,25
4,8479393,Noah Gregor,L,OTT,26,72,11,14,25
4,8476981,Josh Anderson,R,MTL,30,71,11,14,25
4,8481704,Juuso Parssinen,C,NSH,23,60,11,14,25
4,8482105,Jake Sanderson,D,OTT,22,78,10,15,25
4,8476882,Teuvo Teravainen,C,CHI,30,59,9,16,25
4,8478115,Pierre Engvall,L,NYI,28,74,9,16,25
4,8482624,Daniil Miromanov,D,CGY,27,58,9,16,25
4,8475231,Casey Cizikas,C,NYI,33,73,9,16,25
4,8477015,Connor Brown,R,EDM,30,60,9,16,25
4,8476463,Jonas Brodin,D,MIN,31,75,6,19,25
4,8479315,Joey Anderson,R,CHI,26,52,6,19,25
4,8480144,David Kampf,C,TOR,29,69,5,20,25
4,8476292,Ondrej Palat,L,NJD,33,67,4,21,25
4,8476457,Adam Larsson,D,SEA,32,69,4,21,25
4,8480246,Nick Perbix,D,TBL,26,78,1,24,25
4,8480893,Kirill Marchenko,R,CBJ,24,60,16,8,24
4,8483445,Cutter Gauthier,L,ANA,20,60,15,9,24
4,8482749,Joshua Roy,R,MTL,21,65,14,10,24
4,8481624,Ilya Mikheyev,R,CHI,30,61,13,11,24
4,8480813,Joe Veleno,C,DET,24,75,12,12,24
4,8475188,Brayden McNabb,D,VGK,33,58,9,15,24
4,8477435,Ryan Graves,D,PIT,29,75,8,16,24
4,8482148,Hendrix Lapierre,C,WSH,22,45,8,16,24
4,8477839,Conor Sheary,L,TBL,32,79,6,18,24
4,8479026,Philippe Myers,D,TOR,27,58,6,18,24
4,8482660,Kent Johnson,C,CBJ,22,60,5,19,24
4,8479398,Samuel Girard,D,COL,26,68,5,19,24
4,8479983,Mario Ferraro,D,SJS,26,72,4,20,24
4,8475790,Erik Gudbranson,D,CBJ,32,78,4,20,24
4,8479293,Brandon Tanev,L,SEA,33,66,13,10,23
4,8476469,Joel Armia,R,MTL,31,64,13,10,23
4,8476921,Jordan Martinook,L,CAR,32,61,12,11,23
4,8481517,Brett Leason,R,ANA,25,56,12,11,23
4,8480021,Jack Studnicka,C,LAK,25,61,12,11,23
4,8482803,Olen Zellweger,D,ANA,21,68,11,12,23
4,8480252,Cole Guttman,C,CHI,25,35,8,15,23
4,8476525,Colin Miller,D,WPG,32,67,6,17,23
4,8477969,Marcus Pettersson,D,PIT,28,78,5,18,23
4,8476891,Matthew Grzelcyk,D,PIT,30,74,5,18,23
4,8473507,Jeff Petry,D,DET,37,72,5,18,23
4,8480878,Nils Lundkvist,D,DAL,24,70,5,18,23
4,8479639,Dylan Coghlan,D,WPG,26,63,4,19,23
4,8480073,Erik Brannstrom,D,COL,25,62,4,19,23
4,8476931,Jake McCabe,D,TOR,31,64,2,21,23
4,8483457,Lane Hutson,D,MTL,20,74,14,8,22
4,8482259,Bobby McMann,C,TOR,28,65,13,9,22
4,8482125,Alexander Holtz,R,VGK,22,69,11,11,22
4,8483499,Liam Ohgren,L,MIN,20,57,11,11,22
4,8477425,Miles Wood,L,COL,29,76,10,12,22
4,8482679,Matt Coronato,R,CGY,22,61,10,12,22
4,8481032,Paul Cotter,C,NJD,25,60,10,12,22
4,8482117,Lukas Reichel,L,CHI,22,55,8,14,22
4,8480748,Kiefer Sherwood,L,VAN,29,58,6,16,22
4,8476312,Josh Manson,D,COL,33,61,6,16,22
4,8479976,Juuso Valimaki,D,UTA,26,66,4,18,22
4,8480035,Henri Jokiharju,D,BUF,25,62,3,19,22
4,8478970,Jalen Chatfield,D,CAR,28,74,2,20,22
4,8475718,Justin Holl,D,DET,32,62,2,20,22
4,8483493,Frank Nazar,C,CHI,20,49,12,9,21
4,8480281,Alexey Toropchenko,R,STL,25,61,12,9,21
4,8482111,Justin Barron,D,MTL,23,60,11,10,21
4,8476934,Brock McGinn,L,ANA,30,60,10,11,21
4,8484203,Bradly Nadeau,L,CAR,19,65,9,12,21
4,8482157,Will Cuylle,L,NYR,22,57,9,12,21
4,8471709,Marc-Edouard Vlasic,D,SJS,37,61,9,12,21
4,8478911,Matt Roy,D,WSH,29,69,8,13,21
4,8481477,Nico Sturm,C,SJS,29,59,8,13,21
4,8481028,Martin Pospisil,C,CGY,25,55,8,13,21
4,8475855,Jesper Fast,R,CAR,33,54,7,14,21
4,8481014,Alexander Romanov,D,NYI,24,73,5,16,21
4,8480891,Michael Kesselring,D,UTA,24,61,5,16,21
4,8474574,Tyler Myers,D,VAN,34,69,5,16,21
4,8482655,Janis Moser,D,TBL,24,78,5,16,21
4,8481019,David Gustafsson,C,WPG,24,55,5,16,21
4,8476902,Esa Lindell,D,DAL,30,76,3,18,21
4,8475171,Oliver Ekman-Larsson,D,TOR,33,68,3,18,21
4,8479324,Ryan Lindgren,D,NYR,26,62,2,19,21
4,8481059,Scott Perunovich,D,STL,26,57,2,19,21
4,8477220,Nate Schmidt,D,FLA,33,70,2,19,21
4,8476879,Cody Ceci,D,EDM,31,70,2,19,21
4,8479982,Conor Timmins,D,TOR,26,54,1,20,21
4,8480448,Parker Kelly,L,COL,25,72,11,9,20
4,8480806,Isac Lundestrom,C,ANA,25,64,11,9,20
4,8477947,Sonny Milano,L,WSH,28,66,10,10,20
4,8477406,Mattias Janmark,C,EDM,32,66,10,10,20
4,8479353,Brett Howden,C,VGK,26,64,10,10,20
4,8476392,Adam Lowry,C,WPG,31,64,8,12,20
4,8479368,Max Jones,L,BOS,26,62,7,13,20
4,8475343,Nic Dowd,C,WSH,34,58,6,14,20
4,8480043,Timothy Liljegren,D,TOR,25,63,5,15,20
4,8480995,Pontus Holmberg,R,TOR,25,53,5,15,20
4,8477508,Curtis Lazar,C,NJD,29,59,5,15,20
4,8477499,Rasmus Ristolainen,D,PHI,30,61,5,15,20
4,8475233,David Savard,D,MTL,34,59,3,17,20
4,8480001,Urho Vaakanainen,D,ANA,25,59,2,18,20
4,8476892,Colton Parayko,D,STL,31,66,1,19,20
4,8475842,Sam Carrick,C,NYR,32,61,12,7,19
4,8481537,Nikita Okhotiuk,D,CGY,24,51,12,7,19
4,8482155,Alex Laferriere,R,LAK,23,62,11,8,19
4,8476889,Radek Faksa,C,STL,30,66,10,9,19
4,8476374,Sean Kuraly,C,CBJ,31,52,10,9,19
4,8480789,Oliver Wahlstrom,R,NYI,24,71,9,10,19
4,8477446,Michael McCarron,R,NSH,29,54,7,12,19
4,8476988,Matt Benning,D,SJS,30,64,6,13,19
4,8478133,Jake Evans,C,MTL,28,71,6,13,19
4,8483482,Tristan Luneau,D,ANA,20,64,6,13,19
4,8477369,Carson Soucy,D,VAN,30,62,6,13,19
4,8476329,Travis Boyd,C,MIN,31,62,6,13,19
4,8478443,Brandon Carlo,D,BOS,28,53,6,13,19
4,8479344,Jesse Puljujarvi,R,PIT,26,53,6,13,19
4,8476429,Scott Mayfield,D,NYI,32,77,4,15,19
4,8479371,Dante Fabbro,D,NSH,26,64,4,15,19
4,8478507,John Marino,D,UTA,27,57,4,15,19
4,8475179,Dmitry Kulikov,D,FLA,34,59,2,17,19
4,8476422,Mike Reilly,D,NYI,31,74,2,17,19
4,8480049,Dylan Samberg,D,WPG,25,63,1,18,19
4,8479336,Carl Grundstrom,R,SJS,27,60,13,5,18
4,8480848,Ty Dellandrea,C,SJS,24,48,11,7,18
4,8476873,Mark Jankowski,C,NSH,30,50,9,9,18
4,8480762,Eric Robinson,L,CAR,29,58,8,10,18
4,8476878,Zemgus Girgensons,C,TBL,30,81,8,10,18
4,8476856,Mathew Dumba,D,DAL,30,66,8,10,18
4,8476918,Jimmy Vesey,L,NYR,31,63,6,12,18
4,8482730,Brandt Clarke,D,LAK,21,58,5,13,18
4,8477931,Tomas Nosek,L,FLA,32,61,5,13,18
4,8478434,Keegan Kolesar,R,VGK,27,71,5,13,18
4,8482142,Jamie Drysdale,D,PHI,22,66,2,16,18
4,8478851,Alexandre Carrier,D,NSH,28,75,2,16,18
4,8478178,Darren Raddysh,D,TBL,28,69,1,17,18
4,8480222,Sebastian Aho,D,PIT,28,69,1,17,18
4,8481522,Peyton Krebs,C,BUF,23,56,10,7,17
4,8478421,A.J. Greer,L,FLA,28,60,10,7,17
4,8476960,Andreas Athanasiou,C,CHI,30,59,9,8,17
4,8480011,Klim Kostin,C,SJS,25,51,8,9,17
4,8477018,Ben Hutton,D,VGK,31,47,8,9,17
4,8482666,Scott Morrow,D,CAR,22,46,8,9,17
4,8480074,Alexandre Texier,C,STL,25,52,7,10,17
4,8479066,Ryan Lomberg,L,CGY,30,70,7,10,17
4,8478508,Yakov Trenin,C,MIN,27,58,6,11,17
4,8482067,Connor Mackey,D,NYR,28,58,5,12,17
4,8476994,Vinnie Hinostroza,C,NSH,30,52,5,12,17
4,8479291,Kevin Rooney,C,CGY,31,48,4,13,17
4,8478416,Erik Cernak,D,TBL,27,75,3,14,17
4,8479402,Jake Bean,D,CGY,26,67,3,14,17
4,8477845,Trevor van Riemsdyk,D,WSH,33,57,3,14,17
4,8475690,Chris Tanev,D,TOR,35,62,2,15,17
4,8482095,Tyler Kleven,D,OTT,22,44,1,16,17
4,8477903,Garnet Hathaway,R,PHI,33,60,11,5,16
4,8478831,Kevin Stenlund,C,UTA,28,52,11,5,16
4,8473563,Nicklas Backstrom,C,WSH,37,49,8,8,16
4,8479414,Nathan Bastian,R,NJD,27,62,8,8,16
4,8482634,Alex Steeves,C,TOR,25,53,7,9,16
4,8484149,Gavin Brindley,C,CBJ,20,49,7,9,16
4,8478399,Jonas Siegenthaler,D,NJD,27,66,6,10,16
4,8478211,Dryden Hunt,L,CGY,29,56,5,11,16
4,8470600,Ryan Suter,D,STL,39,63,4,12,16
4,8482451,Mikael Pyyhtia,L,CBJ,23,50,3,13,16
4,8481178,Egor Zamula,D,PHI,24,57,3,13,16
4,8481599,Victor Soderstrom,D,UTA,23,45,3,13,16
4,8479543,Michael Pezzetta,L,MTL,26,59,2,14,16
4,8474034,Patrick Maroon,L,CHI,36,46,9,6,15
4,8480025,MacKenzie Entwistle,R,FLA,25,63,9,6,15
4,8479619,Michael Carcone,L,UTA,28,57,9,6,15
4,8479981,Jonah Gadjovich,L,FLA,26,48,9,6,15
4,8477353,Tyler Motte,C,DET,29,75,8,7,15
4,8475225,Craig Smith,C,CHI,35,49,7,8,15
4,8481716,Dmitri Voronkov,L,CBJ,24,48,7,8,15
4,8475220,Marcus Foligno,L,MIN,33,57,5,10,15
4,8480058,Pierre-Olivier Joseph,D,STL,25,59,5,10,15
4,8481708,Zac Jones,D,NYR,24,49,4,11,15
4,8483565,Nick Blankenburg,D,NSH,26,57,4,11,15
4,8479442,Troy Stecher,D,EDM,30,62,4,11,15
4,8482087,Kaiden Guhle,D,MTL,22,64,3,12,15
4,8482176,Wyatt Kaiser,D,CHI,22,49,3,12,15
4,8478882,Vladislav Gavrikov,D,LAK,29,68,2,13,15
4,8481568,Alex Vlasic,D,CHI,23,64,2,13,15
4,8482192,Isaak Phillips,D,CHI,23,52,2,13,15
4,8480807,Mattias Samuelsson,D,BUF,24,58,2,13,15
4,8475324,Nick Jensen,D,OTT,34,67,2,13,15
4,8482073,Braden Schneider,D,NYR,23,65,1,14,15
4,8482659,Josh Doan,R,UTA,22,50,11,3,14
4,8479328,Julien Gauthier,R,NYI,27,61,7,7,14
4,8476858,Phillip Di Giuseppe,L,VAN,31,41,7,7,14
4,8478424,Jansen Harkins,C,ANA,27,42,7,7,14
4,8479671,Mathieu Olivier,R,CBJ,27,56,4,10,14
4,8482077,Dylan Holloway,L,EDM,23,52,4,10,14
4,8480172,Jan Rutta,D,SJS,34,61,3,11,14
4,8475208,Brian Dumoulin,D,ANA,33,65,3,11,14
4,8476967,Brett Kulak,D,EDM,30,66,3,11,14
4,8475462,Radko Gudas,D,ANA,34,66,2,12,14
4,8479998,Mikey Anderson,D,LAK,25,59,2,12,14
4,8477392,Hudson Fasching,R,NYI,29,64,7,6,13
4,8478585,Derek Ryan,C,EDM,38,71,7,6,13
4,8476467,Jamie Oleksiak,D,SEA,32,64,6,7,13
4,8481550,Adam Beckman,L,NJD,23,39,6,7,13
4,8480007,Jonas Rondbjerg,R,VGK,25,40,5,8,13
4,8482062,Cole Smith,L,NSH,29,60,4,9,13
4,8478468,Jeremy Lauzon,D,NSH,27,45,3,10,13
4,8480796,Martin Fehervary,D,WSH,25,52,2,11,13
4,8474013,Ian Cole,D,UTA,35,56,2,11,13
4,8478452,Caleb Jones,D,LAK,27,55,2,11,13
4,8480157,Calle Rosen,D,COL,30,37,1,12,13
4,8475455,Brenden Dillon,D,NJD,34,53,0,13,13
4,8482737,Zack Bolduc,C,STL,21,50,7,5,12
4,8479370,Tyson Jost,C,CAR,26,58,7,5,12
4,8481601,Simon Holmstrom,R,NYI,23,69,6,6,12
4,8477070,Liam O'Brien,C,UTA,30,55,6,6,12
4,8479348,Kale Clague,D,BUF,26,39,6,6,12
4,8481013,Jonatan Berggren,R,DET,24,55,5,7,12
4,8479359,Beck Malenstyn,L,BUF,26,43,4,8,12
4,8480289,Morgan Barron,C,WPG,26,50,4,8,12
4,8483460,David Jiricek,D,CBJ,21,59,4,8,12
4,8477938,Haydn Fleury,D,WPG,28,36,4,8,12
4,8479372,Joshua Mahura,D,SEA,26,54,3,9,12
4,8479980,Nicolas Hague,D,VGK,26,53,3,9,12
4,8477365,Connor Clifton,D,BUF,29,55,2,10,12
4,8480860,Kevin Bahl,D,CGY,24,61,2,10,12
4,8480950,Ilya Lyubushkin,D,DAL,30,59,1,11,12
4,8481556,John Beecher,C,BOS,23,35,9,2,11
4,8482762,Simon Edvinsson,D,DET,21,63,8,3,11
4,8478569,Noel Acciari,C,PIT,33,53,6,5,11
4,8483495,Simon Nemec,D,NJD,20,53,6,5,11
4,8476442,Matt Nieto,L,PIT,32,44,6,5,11
4,8477887,Patrick Brown,C,BOS,32,47,5,6,11
4,8471817,Ryan Reaves,R,TOR,37,54,5,6,11
4,8479972,Mason Shaw,C,WPG,26,33,5,6,11
4,8482245,Artem Zub,D,OTT,29,71,4,7,11
4,8480845,Rasmus Kupari,C,WPG,24,43,4,7,11
4,8481751,Lukas Rousek,R,BUF,25,41,4,7,11
4,8482166,Shakir Mukhamadullin,D,SJS,22,53,4,7,11
4,8481592,Jakob Pelletier,L,CGY,23,46,4,7,11
4,8479369,Andrew Peeke,D,BOS,26,61,2,9,11
4,8475279,Ben Chiarot,D,DET,33,68,2,9,11
4,8475750,Jon Merrill,D,MIN,32,70,2,9,11
4,8474166,Alec Martinez,D,CHI,37,44,1,10,11
4,8480070,Ian Mitchell,D,BOS,25,49,1,10,11
4,8473446,Erik Johnson,D,PHI,36,44,1,10,11
4,8474568,Luke Schenn,D,NSH,35,55,0,11,11
4,8481617,Vasily Podkolzin,R,VAN,23,44,8,2,10
4,8481518,Nolan Foote,L,NJD,24,39,7,3,10
4,8473453,Trevor Lewis,C,LAK,37,71,6,4,10
4,8479520,Brandon Duhaime,R,WSH,27,57,5,5,10
4,8476822,Luke Glendening,C,TBL,35,78,5,5,10
4,8475235,Nicolas Deslauriers,L,PHI,33,57,5,5,10
4,8480192,Johnathan Kovacevic,D,NJD,27,46,4,6,10
4,8481641,Joel Kiviranta,L,COL,28,65,4,6,10
4,8476624,Barclay Goodrow,C,SJS,31,50,4,6,10
4,8482511,Mason Lohrei,D,BOS,23,32,4,6,10
4,8481532,Alex Turcotte,C,LAK,23,45,4,6,10
4,8480355,Mark Kastelic,C,BOS,25,56,3,7,10
4,8475762,Derek Forbort,D,VAN,32,43,3,7,10
4,8480990,Declan Chisholm,D,MIN,24,40,3,7,10
4,8479249,Andrew Poturalski,C,SJS,30,29,3,7,10
4,8480441,Trey Fix-Wolansky,R,CBJ,25,42,3,7,10
4,8477034,Jaycob Megna,D,FLA,32,48,2,8,10
4,8479536,Axel Jonsson-Fjallby,L,WPG,26,35,2,8,10
4,8481600,Tobias Bjornfot,D,FLA,23,48,2,8,10
4,8477380,Jonny Brodzinski,C,NYR,31,53,6,3,9
4,8477482,Zachary Sanford,L,CHI,30,39,5,4,9
4,8481147,Reese Johnson,C,MIN,26,31,5,4,9
4,8482070,Mitchell Chaffee,R,TBL,26,52,5,4,9
4,8480880,Jakub Lauko,C,MIN,24,41,4,5,9
4,8477979,Nicolas Aube-Kubel,R,BUF,28,53,3,6,9
4,8481567,Henry Thrun,D,SJS,23,57,3,6,9
4,8482652,Walker Duehr,R,CGY,27,38,3,6,9
4,8481161,Jake Christiansen,D,CBJ,25,50,3,6,9
4,8478874,Adam Gaudette,R,OTT,28,35,3,6,9
4,8482807,Ethan Del Mastro,D,CHI,21,45,2,7,9
4,8478451,Ethan Bear,D,WSH,27,44,2,7,9
4,8481701,Santeri Hatakka,D,NJD,23,36,2,7,9
4,8480887,Jordan Harris,D,MTL,24,56,1,8,9
4,8474567,Zach Bogosian,D,MIN,34,60,1,8,9
4,8479718,Alex Barré-Boulet,C,MTL,27,53,1,8,9
4,8478840,Will Borgen,D,SEA,28,63,0,9,9
4,8478450,Parker Wotherspoon,D,BOS,27,42,0,9,9
4,8480844,Grigori Denisenko,L,VGK,24,40,5,3,8
4,8482744,James Malatesta,L,CBJ,21,36,4,4,8
4,8471677,Jack Johnson,D,CBJ,37,68,4,4,8
4,8482153,Brendan Brisson,C,VGK,23,29,4,4,8
4,8478136,Jake Middleton,D,MIN,28,72,3,5,8
4,8479638,Justin Brazeau,R,BOS,26,34,3,5,8
4,8475177,Calvin de Haan,D,COL,33,48,3,5,8
4,8474612,Travis Hamonic,D,OTT,34,40,2,6,8
4,8481122,Simon Benoit,D,TOR,26,42,2,6,8
4,8480245,Olle Lycksell,R,PHI,25,25,2,6,8
4,8479994,Jaret Anderson-Dolan,C,WPG,25,27,2,6,8
4,8477851,Jordan Oesterle,D,BOS,32,38,1,7,8
4,8482747,Brennan Othmann,L,NYR,21,39,0,8,8
4,8480196,Jacob Bryson,D,BUF,27,40,0,8,8
4,8479772,Zack MacEwen,R,OTT,28,51,5,2,7
4,8477573,Nathan Walker,L,STL,30,45,4,3,7
4,8479439,Jacob MacDonald,D,COL,31,54,4,3,7
4,8481754,Nikita Nesterenko,C,ANA,23,25,3,4,7
4,8479986,Kole Lind,R,DAL,26,49,3,4,7
4,8482141,Lukas Cormier,D,VGK,22,31,3,4,7
4,8483570,Ben Meyers,C,SEA,26,34,3,4,7
4,8481789,Tye Kartye,L,SEA,23,46,2,5,7
4,8480727,Zach Whitecloud,D,VGK,28,51,2,5,7
4,8482751,Ryan Winterton,C,SEA,21,33,2,5,7
4,8483466,Kevin Korchinski,D,CHI,20,52,2,5,7
4,8482145,Mavrik Bourque,C,DAL,22,45,2,5,7
4,8480292,Carson Meyer,R,ANA,27,25,2,5,7
4,8481598,Philip Broberg,D,EDM,23,37,1,6,7
4,8474090,Brendan Smith,D,DAL,35,59,1,6,7
4,8484254,Akito Hirose,D,VAN,25,38,1,6,7
4,8480834,Ty Emberson,D,SJS,24,37,1,6,7
4,8481056,Spencer Stastney,D,NSH,24,37,1,6,7
4,8480879,Jacob Bernard-Docker,D,OTT,24,52,1,6,7
4,8482964,Arber Xhekaj,D,MTL,23,50,0,7,7
4,8481167,Brayden Pachal,D,CGY,25,46,0,7,7
4,8482861,Vincent Iorio,D,WSH,22,38,0,7,7
4,8477962,Brendan Lemieux,L,CAR,28,37,4,2,6
4,8481679,Maxence Guenette,D,OTT,23,37,4,2,6
4,8480870,Bo Groulx,C,NYR,24,31,4,2,6
4,8482496,Nils Aman,C,VAN,24,38,3,3,6
4,8479944,Zach Aston-Reese,C,VGK,30,40,3,3,6
4,8479968,Vinni Lettieri,C,BOS,29,43,3,3,6
4,8476952,Dominic Toninato,C,WPG,30,38,3,3,6
4,8482201,Gage Goncalves,C,TBL,23,26,3,3,6
4,8482088,Justin Sourdif,R,FLA,22,17,3,3,6
4,8483763,Maksymilian Szuber,D,UTA,22,27,2,4,6
4,8476874,Olli Maatta,D,DET,30,57,2,4,6
4,8482784,Zach Dean,C,STL,21,39,2,4,6
4,8480468,James Hamblin,L,EDM,25,25,2,4,6
4,8479378,Logan Stanley,D,WPG,26,44,2,4,6
4,8479576,Vincent Desharnais,D,VAN,28,31,2,4,6
4,8481527,Kaedan Korczak,D,VGK,23,51,1,5,6
4,8478859,Niko Mikkola,D,FLA,28,48,1,5,6
4,8475958,Michael Sgarbossa,C,WSH,32,36,1,5,6
4,8484258,Sam Malinski,D,COL,26,28,1,5,6
4,8477527,Ross Johnston,L,ANA,30,33,0,6,6
4,8483549,Lucas Condotta,L,MTL,27,37,3,2,5
4,8477401,John Hayden,C,SEA,29,28,3,2,5
4,8479367,William Lockwood,R,FLA,26,25,3,2,5
4,8481543,Nikita Alexandrov,C,STL,24,22,3,2,5
4,8482118,Sam Colangelo,R,ANA,23,18,3,2,5
4,8476473,Connor Murphy,D,CHI,31,32,2,3,5
4,8476867,Brendan Gaunce,C,MIN,30,36,2,3,5
4,8479379,Givani Smith,R,SJS,26,35,2,3,5
4,8481609,Vladislav Kolyachonok,D,UTA,23,40,2,3,5
4,8477473,Justin Bailey,R,SJS,29,24,2,3,5
4,8477462,Robert Hagg,D,VGK,29,21,2,3,5
4,8481043,Cole Koepke,L,BOS,26,23,2,3,5
4,8482859,Zack Ostapchuk,C,OTT,21,45,1,4,5
4,8480084,Nick DeSimone,D,NJD,30,21,1,4,5
4,8477244,Chad Ruhwedel,D,NYR,34,35,1,4,5
4,8481605,Jackson LaCombe,D,ANA,23,31,1,4,5
4,8477810,Joel Hanley,D,CGY,33,22,0,5,5
4,8481237,Kyle MacLean,C,NYI,25,20,3,1,4
4,8478409,Anthony Richard,C,PHI,28,29,2,2,4
4,8483630,Pavol Regenda,L,ANA,25,23,2,2,4
4,8479985,Cale Fleury,D,SEA,26,36,2,2,4
4,8481422,Jake Lucchini,C,NSH,29,21,2,2,4
4,8477971,Andreas Englund,D,LAK,28,27,2,2,4
4,8482765,Isak Rosen,R,BUF,21,34,1,3,4
4,8477335,Kyle Burroughs,D,LAK,29,43,1,3,4
4,8476441,Joel Edmundson,D,LAK,31,28,1,3,4
4,8476913,Devin Shore,C,MIN,30,28,1,3,4
4,8482144,Jack Thompson,D,SJS,22,21,1,3,4
4,8477149,Scott Sabourin,R,SJS,32,16,1,3,4
4,8482470,Ilya Solovyov,D,CGY,24,17,1,3,4
4,8483619,Filip Roos,D,OTT,25,29,0,4,4
4,8478502,Dennis Gilbert,D,BUF,28,14,0,4,4
4,8480267,Sammy Walker,C,MIN,25,18,3,0,3
4,8483012,Logan Morrison,C,SEA,22,27,2,1,3
4,8481593,Jayden Struble,D,MTL,23,21,2,1,3
4,8478146,Matthew Highmore,C,OTT,28,33,2,1,3
4,8481699,Aku Raty,R,UTA,23,18,2,1,3
4,8481585,Egor Afanasyev,L,SJS,23,12,2,1,3
4,8480890,Jan Jenik,C,OTT,24,28,2,1,3
4,8481541,Samuel Bolduc,D,NYI,24,24,2,1,3
4,8482165,Yan Kuznetsov,D,CGY,22,21,2,1,3
4,8480075,Cameron Crotty,D,MIN,25,10,2,1,3
4,8480032,Shane Bowers,C,NJD,25,20,2,1,3
4,8484911,Collin Graf,R,SJS,22,39,1,2,3
4,8477384,Joshua Brown,D,EDM,30,41,1,2,3
4,8482713,Mackie Samoskevich,R,FLA,22,38,1,2,3
4,8481743,Marc Del Gaizo,D,NSH,25,14,1,2,3
4,8483512,Matthew Savoie,C,EDM,20,18,1,2,3
4,8479320,Maxime Lajoie,D,SEA,27,23,1,2,3
4,8482516,Matthew Kessel,D,STL,24,18,1,2,3
4,8482858,Ryker Evans,D,SEA,23,19,1,2,3
4,8481024,Linus Karlsson,C,VAN,25,9,1,2,3
4,8481030,Jack St. Ivany,D,PIT,25,16,0,3,3
4,8483395,Arshdeep Bains,L,VAN,23,14,0,3,3
4,8482172,Landon Slaggert,L,CHI,22,27,2,0,2
4,8482250,Callahan Burke,C,VGK,27,19,2,0,2
4,8481719,Maxwell Crozier,D,TBL,24,15,2,0,2
4,8483567,Georgii Merkulov,C,BOS,24,12,2,0,2
4,8478454,Noah Juulsen,D,VAN,27,35,1,1,2
4,8477073,Kurtis MacDermid,L,NJD,30,25,1,1,2
4,8477541,Dakota Mermis,D,TOR,30,6,1,1,2
4,8475780,Chris Wagner,R,COL,33,15,1,1,2
4,8482061,Brandon Biro,L,SEA,26,11,1,1,2
4,8480851,Akil Thomas,C,LAK,24,20,1,1,2
4,8482787,Nikita Chibrikov,R,WPG,31,6,1,1,2
4,8476372,Nick Seeler,D,PHI,31,38,0,2,2
4,8479419,Brett Murray,L,BUF,26,17,0,2,2
4,8482733,Logan Mailloux,D,MTL,31,32,0,2,2
4,8481806,Louis Crevier,D,CHI,23,14,0,2,2
4,8482094,Daemon Hunt,D,MIN,22,13,0,2,2
4,8474062,Riley Nash,C,NYR,35,17,0,2,2
4,8478881,Brett Seney,L,CHI,28,13,0,2,2
4,8483397,Marc McLaughlin,C,BOS,25,23,1,0,1
4,8478477,Mitchell Stephens,C,SEA,27,16,1,0,1
4,8479362,Riley Tufte,L,BOS,26,24,1,0,1
4,8482177,Marat Khusnutdinov,C,MIN,22,33,1,0,1
4,8475795,Dylan McIlrath,D,WSH,32,13,1,0,1
4,8477320,Anton Blidh,L,NYR,29,20,1,0,1
4,8481462,Mason Morelli,L,VGK,28,16,1,0,1
4,8482126,Emil Andrae,D,PHI,31,2,1,0,1
4,8480874,Adam Ginning,D,PHI,24,8,1,0,1
4,8482147,Jean-Luc Foudy,C,COL,22,21,1,0,1
4,8478017,Mark Friedman,D,VAN,29,40,0,1,1
4,8479991,Jake Leschyshyn,C,NYR,25,28,0,1,1
4,8484287,Cole McWard,D,VAN,23,25,0,1,1
4,8477467,Gustav Olofsson,D,SEA,30,15,0,1,1
4,8481578,Graeme Clarke,R,MIN,23,8,0,1,1
4,8481065,Angus Crookshank,L,OTT,25,16,0,1,1
4,8475413,Justin Dowling,C,NJD,34,18,0,1,1
4,8479330,Brandon Gignac,C,MTL,27,6,0,1,1
4,8479587,Rhett Gardner,C,PHI,28,16,0,1,1
4,8484255,Jason Polin,R,COL,25,7,0,1,1
4,8478854,Ryan Shea,D,PIT,27,8,0,1,1
4,8482102,Vasily Ponomarev,C,PIT,22,15,0,1,1
4,8483546,Marshall Rifai,D,TOR,26,5,0,1,1
4,8475755,Alexander Petrovic,D,DAL,32,7,0,1,1
4,8481206,John Ludvig,D,PIT,24,14,0,1,1
4,8482460,Matt Rempe,C,NYR,22,9,0,1,1
4,8481655,Cole Schwindt,R,CGY,23,5,0,1,1
4,8478011,Louie Belpedio,D,PHI,28,23,0,1,1
4,8479522,Hardy Haman Aktell,D,WSH,26,3,0,1,1
4,8482476,Emil Heineman,L,MTL,23,12,0,1,1
4,8478051,Max Willman,C,NJD,29,14,0,0,0
4,8480823,Alexander Alexeyev,D,WSH,25,13,0,0,0
4,8483597,Milos Kelemen,L,UTA,25,12,0,0,0
4,8483407,Brandon Scanlin,D,NYR,25,9,0,0,0
4,8478021,William Lagesson,D,DET,28,20,0,0,0
4,8482162,Roby Jarventie,L,EDM,22,20,0,0,0
4,8481726,Adam Edstrom,C,NYR,24,4,0,0,0
4,8481006,Tyler Tucker,D,STL,24,14,0,0,0
4,8482929,Emil Lilleberg,D,TBL,23,17,0,0,0
4,8478147,Bokondji Imama,L,PIT,28,7,0,0,0
4,8483920,Pierrick Dube,R,WSH,23,3,0,0,0
4,8484325,Waltteri Merela,C,TBL,26,20,0,0,0
4,8476323,Max McCormick,L,SEA,32,2,0,0,0
4,8483471,Brad Lambert,C,WPG,31,4,0,0,0
4,8481564,Ryan Johnson,D,BUF,23,14,0,0,0
4,8479421,Jacob Moverare,D,LAK,26,8,0,0,0
4,8483398,Declan Carlile,D,TBL,31,6,0,0,0
4,8483489,Fraser Minten,C,TOR,31,7,0,0,0
4,8483609,Adam Klapka,R,CGY,24,1,0,0,0
4,8477993,Justin Kirkland,C,CGY,28,9,0,0,0
4,8480306,Grant Hutton,D,NYI,29,4,0,0,0
4,8478446,Glenn Gawdin,C,LAK,27,14,0,0,0
4,8484304,Uvis Balinskis,D,FLA,28,5,0,0,0
4,8483531,Brian Halonen,L,NJD,25,2,0,0,0
4,8470794,Joe Pavelski,C,,40,0,0,0,0
4,8479321,Lucas Johansen,D,,27,0,0,0,0
4,8477950,Tony DeAngelo,D,,29,0,0,0,0
4,8471218,Blake Wheeler,R,,38,0,0,0,0
4,8475197,Tyson Barrie,D,,33,0,0,0,0
4,8474157,Max Pacioretty,L,,36,0,0,0,0
4,8475744,Evgeny Kuznetsov,C,,32,0,0,0,0
4,8474037,James van Riemsdyk,L,,35,0,0,0,0
4,8476907,Mackenzie MacEachern,L,,30,0,0,0,0
4,8480216,Jacob Peterson,C,,25,0,0,0,0
4,8474602,Justin Schultz,D,,34,0,0,0,0
4,8482222,Alexander Barabanov,L,,30,0,0,0,0
4,8474031,Kevin Shattenkirk,D,,35,0,0,0,0
4,8477330,Dominik Kubalik,L,,29,0,0,0,0
4,8480884,Calen Addison,D,,24,0,0,0,0
4,8475906,John Klingberg,D,,32,0,0,0,0
4,8480008,Adam Ruzicka,C,,25,0,0,0,0
4,8476884,Derrick Pouliot,D,,30,0,0,0,0
4,8476919,Chris Tierney,C,,30,0,0,0,0
4,8479415,Michael McLeod,C,,26,0,0,0,0
4,8474870,Tyler Johnson,C,,34,0,0,0,0
4,8470604,Jeff Carter,C,,39,0,0,0,0
4,8478104,Sammy Blais,L,,28,0,0,0,0
4,8474884,Mike Hoffman,C,,35,0,0,0,0
4,8481591,Sam Poulin,R,,23,0,0,0,0
4,8471274,Alex Goligoski,D,,39,0,0,0,0
4,8476871,Tanner Pearson,L,,32,0,0,0,0
4,8476393,Nick Cousins,C,,31,0,0,0,0
4,8479977,Kailer Yamamoto,R,,26,0,0,0,0
4,8479346,Dillon Dube,C,,26,0,0,0,0
4,8480184,Gustav Lindstrom,D,,26,0,0,0,0
4,8479376,Victor Mete,D,,26,0,0,0,0
4,8473449,Kyle Okposo,R,,36,0,0,0,0
4,8481058,Jesse Ylonen,R,,25,0,0,0,0
4,8475752,Tyler Pitlick,C,,33,0,0,0,0
4,8481239,Samuel Fagemo,L,,24,0,0,0,0
4,8480821,Filip Zadina,R,,25,0,0,0,0
4,8470966,Mark Giordano,D,,41,0,0,0,0
4,8478495,Denis Gurianov,R,,27,0,0,0,0
4,8477464,Nic Petan,C,,29,0,0,0,0
4,8478099,Kevin Labanc,R,,29,0,0,0,0
4,8482241,Radim Zohorna,L,,28,0,0,0,0
4,8474040,Sam Gagner,C,,35,0,0,0,0
4,8479514,Rem Pitlick,C,,27,0,0,0,0
4,8478430,Oliver Kylington,D,,27,0,0,0,0
4,8479533,Joona Koppanen,L,,26,0,0,0,0
4,8479984,Cal Foote,D,,26,0,0,0,0
4,8477126,Jayson Megna,C,,34,0,0,0,0
4,8475164,Jakob Silfverberg,R,,34,0,0,0,0
4,8474009,Nick Bonino,C,,36,0,0,0,0
4,8479458,Nikita Zaitsev,D,,33,0,0,0,0
4,8477944,Jakub Vrana,L,,28,0,0,0,0
4,8471699,Andrew Cogliano,C,,37,0,0,0,0
4,8478067,Oskar Lindblom,L,,28,0,0,0,0
4,8471686,Marc Staal,D,,37,0,0,0,0
4,8470610,Zach Parise,L,,40,0,0,0,0
4,8478904,Steven Lorentz,C,,28,0,0,0,0
4,8473473,Milan Lucic,L,,36,0,0,0,0
4,8480031,Maxime Comtois,L,,25,0,0,0,0
4,8478512,Austin Czarnik,C,,32,0,0,0,0
4,8473504,Cal Clutterbuck,R,,37,0,0,0,0
4,8477454,Adam Erne,L,,29,0,0,0,0
4,8479383,Boris Katchouk,L,,26,0,0,0,0
4,8475825,Jani Hakanpää,D,,32,0,0,0,0
4,8477846,Ryan Carpenter,C,,33,0,0,0,0
4,8477930,Pierre-Edouard Bellemare,L,,39,0,0,0,0
4,8478400,Colin White,C,,27,0,0,0,0
4,8480226,Marián Studenic,R,,26,0,0,0,0
4,8480853,Liam Foudy,C,,24,0,0,0,0
4,8475797,Jarred Tinordi,D,,32,0,0,0,0
4,8479423,Alex Nylander,L,,26,0,0,0,0
4,8474618,Marco Scandella,D,,34,0,0,0,0
4,8478028,Fredrik Olofsson,L,,28,0,0,0,0
4,8474709,Matt Martin,L,,35,0,0,0,0
4,8481070,Hugh McGing,L,,26,0,0,0,0
4,8479546,Oskar Steen,C,,26,0,0,0,0
4,8474145,Robert Bortuzzo,D,,35,0,0,0,0
4,8476915,Jujhar Khaira,L,,30,0,0,0,0
4,8480274,Philip Kemp,D,EDM,25,0,0,0,0
4,8484326,Patrik Koch,D,UTA,28,1,0,0,0
4,8484321,Nikolas Matinpalo,D,OTT,26,3,0,0,0
4,8475278,Byron Froese,C,,33,0,0,0,0
4,8481812,Nikolai Knyzhov,D,,27,0,0,0,0
4,8478408,Travis Dermott,D,,28,0,0,0,0
4,8481077,John Leonard,L,,26,0,0,0,0
4,8479547,Matthew Phillips,R,,26,0,0,0,0
4,8482197,Adam Raska,R,MIN,23,2,0,0,0
4,8480836,Jonathan Gruden,C,,24,0,0,0,0
4,8481690,Tyler Angle,C,,24,0,0,0,0
4,8475766,Austin Watson,L,,32,0,0,0,0
4,8481016,Ruslan Iskhakov,C,,24,0,0,0,0
4,8478078,Rourke Chartier,C,,28,0,0,0,0
4,8484259,Ondrej Pavel,C,COL,31,7,0,0,0
4,8483401,Marc Johnstone,R,PIT,28,3,0,0,0
4,8480776,Sheldon Rempal,R,,29,0,0,0,0
4,8478956,Samuel Laberge,L,NJD,27,0,0,0,0
4,8483432,Luca Del Bel Belluz,C,CBJ,31,4,0,0,0
4,8483045,Cameron Butler,R,CBJ,31,1,0,0,0
4,8481534,Raphael Lavoie,C,EDM,24,2,0,0,0
4,8484314,Jiri Smejkal,L,,28,0,0,0,0
5,8477492,Nathan MacKinnon,C,COL,29,81,55,93,148
5,8478402,Connor McDavid,C,EDM,27,78,43,96,139
5,8479318,Auston Matthews,C,TOR,27,81,76,57,133
5,8481559,Jack Hughes,C,NJD,23,76,48,68,116
5,8476453,Nikita Kucherov,R,TBL,31,82,37,79,116
5,8477956,David Pastrnak,R,BOS,28,77,48,65,113
5,8479314,Matthew Tkachuk,L,FLA,27,82,30,75,105
5,8480023,Robert Thomas,C,STL,25,78,35,69,104
5,8478427,Sebastian Aho,C,CAR,27,73,34,66,100
5,8478550,Artemi Panarin,L,NYR,33,79,30,68,98
5,8478420,Mikko Rantanen,R,COL,28,81,47,49,96
5,8477934,Leon Draisaitl,C,EDM,29,76,40,55,95
5,8477939,William Nylander,R,TOR,28,79,43,51,94
5,8476468,J.T. Miller,C,VAN,31,72,28,66,94
5,8478864,Kirill Kaprizov,L,MIN,27,73,38,55,93
5,8480801,Brady Tkachuk,L,OTT,25,81,39,53,92
5,8474564,Steven Stamkos,C,NSH,34,75,33,59,92
5,8477493,Aleksander Barkov,C,FLA,29,77,22,69,91
5,8476454,Ryan Nugent-Hopkins,C,EDM,31,82,33,57,90
5,8471675,Sidney Crosby,C,PIT,37,71,42,47,89
5,8478010,Brayden Point,C,TBL,28,81,38,51,89
5,8477949,Alex Tuch,R,BUF,28,73,36,52,88
5,8480012,Elias Pettersson,C,VAN,26,74,35,53,88
5,8477404,Jake Guentzel,C,TBL,30,82,32,56,88
5,8475172,Nazem Kadri,C,CGY,34,77,37,50,87
5,8477946,Dylan Larkin,C,DET,28,81,46,40,86
5,8478403,Jack Eichel,C,VGK,28,78,37,49,86
5,8478445,Mathew Barzal,C,NYI,27,80,26,60,86
5,8476887,Filip Forsberg,L,NSH,30,73,38,46,84
5,8478483,Mitch Marner,R,TOR,27,79,28,56,84
5,8480800,Quinn Hughes,D,VAN,25,76,8,75,83
5,8478398,Kyle Connor,L,WPG,28,74,34,48,82
5,8477942,Kevin Fiala,L,LAK,28,81,32,50,82
5,8474600,Roman Josi,D,NSH,34,73,22,60,82
5,8476459,Mika Zibanejad,C,NYR,31,77,26,55,81
5,8475913,Mark Stone,R,VGK,32,80,24,57,81
5,8480002,Nico Hischier,C,NJD,25,73,22,58,80
5,8480027,Jason Robertson,L,DAL,25,82,37,42,79
5,8477951,Nick Schmaltz,C,UTA,28,75,28,51,79
5,8476346,Johnny Gaudreau,L,CBJ,31,76,20,59,79
5,8482116,Tim Stützle,C,OTT,22,79,25,53,78
5,8477933,Sam Reinhart,C,FLA,29,78,34,43,77
5,8477496,Elias Lindholm,C,BOS,30,79,33,44,77
5,8473419,Brad Marchand,L,BOS,36,78,28,49,77
5,8471685,Anze Kopitar,C,LAK,37,82,21,56,77
5,8477409,Carter Verhaeghe,C,FLA,29,79,41,35,76
5,8484144,Connor Bedard,C,CHI,19,69,27,49,76
5,8475692,Mats Zuccarello,R,MIN,37,77,25,51,76
5,8480069,Cale Makar,D,COL,26,66,24,52,76
5,8476456,Jonathan Huberdeau,C,CGY,31,77,20,56,76
5,8482078,Lucas Raymond,L,DET,22,80,32,43,75
5,8475166,John Tavares,C,TOR,34,79,28,47,75
5,8479323,Adam Fox,D,NYR,26,78,15,60,75
5,8480015,Owen Tippett,R,PHI,25,75,34,40,74
5,8481557,Matt Boldy,L,MIN,23,71,32,42,74
5,8477402,Pavel Buchnevich,L,STL,29,73,30,44,74
5,8479407,Jesper Bratt,L,NJD,26,74,28,46,74
5,8479343,Clayton Keller,R,UTA,26,76,26,48,74
5,8473512,Claude Giroux,R,OTT,36,77,24,50,74
5,8477960,Adrian Kempe,R,LAK,28,80,39,34,73
5,8481528,Dylan Cozens,C,BUF,23,71,28,45,73
5,8480839,Rasmus Dahlin,D,BUF,24,68,21,52,73
5,8476389,Vincent Trocheck,C,NYR,31,81,18,55,73
5,8474578,Erik Karlsson,D,PIT,34,80,13,60,73
5,8481068,Yegor Sharangovich,C,CGY,26,79,35,37,72
5,8482740,Wyatt Johnston,C,DAL,21,81,33,39,72
5,8480036,Miro Heiskanen,D,DAL,25,80,11,61,72
5,8477501,Valeri Nichushkin,R,COL,29,80,31,40,71
5,8474141,Patrick Kane,R,DET,36,79,25,46,71
5,8475184,Chris Kreider,L,NYR,33,70,38,32,70
5,8475765,Vladimir Tarasenko,R,DET,33,80,30,40,70
5,8479337,Alex DeBrincat,R,DET,27,81,37,32,69
5,8479420,Tage Thompson,C,BUF,27,70,37,32,69
5,8476448,William Karlsson,C,VGK,31,78,34,35,69
5,8480018,Nick Suzuki,C,MTL,25,76,24,45,69
5,8478460,Zach Werenski,D,CBJ,27,77,15,54,69
5,8480803,Evan Bouchard,D,EDM,25,74,14,55,69
5,8479325,Charlie McAvoy,D,BOS,27,74,10,59,69
5,8477940,Nikolaj Ehlers,L,WPG,28,75,29,39,68
5,8479542,Brandon Hagel,L,TBL,26,82,26,42,68
5,8480208,Drake Batherson,R,OTT,26,79,31,36,67
5,8475191,Reilly Smith,R,NYR,33,72,29,38,67
5,8480830,Andrei Svechnikov,R,CAR,24,71,24,43,67
5,8477504,Josh Morrissey,D,WPG,29,76,15,52,67
5,8480865,Noah Dobson,D,NYI,24,81,9,58,67
5,8478414,Timo Meier,R,NJD,28,75,31,35,66
5,8478440,Dylan Strome,C,WSH,27,69,30,36,66
5,8482665,Matty Beniers,C,SEA,22,78,29,37,66
5,8475167,Victor Hedman,D,TBL,34,78,11,55,66
5,8481540,Cole Caufield,R,MTL,23,78,35,30,65
5,8475810,Bryan Rust,R,PIT,32,77,29,36,65
5,8475168,Matt Duchene,C,DAL,33,80,24,41,65
5,8476399,Blake Coleman,C,CGY,33,79,36,28,64
5,8471214,Alex Ovechkin,L,WSH,39,74,33,31,64
5,8476881,Tomas Hertl,C,VGK,31,76,31,33,64
5,8478439,Travis Konecny,R,PHI,27,76,30,34,64
5,8473986,Alex Killorn,L,ANA,35,73,29,35,64
5,8475745,Charlie Coyle,C,BOS,32,79,25,39,64
5,8476460,Mark Scheifele,C,WPG,31,69,30,33,63
5,8475158,Ryan O'Reilly,C,NSH,33,69,25,38,63
5,8478873,Troy Terry,R,ANA,27,76,21,42,63
5,8475786,Zach Hyman,L,EDM,32,71,33,29,62
5,8479525,Ross Colton,C,COL,28,80,32,30,62
5,8480039,Martin Necas,C,CAR,25,73,30,32,62
5,8482093,Seth Jarvis,C,CAR,22,69,23,39,62
5,8478366,Frank Vatrano,R,ANA,30,74,36,25,61
5,8478493,Joel Eriksson Ek,C,MIN,27,69,19,42,61
5,8478444,Brock Boeser,R,VAN,27,77,35,25,60
5,8475754,Brock Nelson,C,NYI,33,80,34,26,60
5,8477955,Jared McCann,L,SEA,28,73,28,32,60
5,8483808,Andrei Kuzmenko,L,CGY,28,76,26,34,60
5,8478407,Vince Dunn,D,SEA,28,76,20,40,60
5,8471724,Kris Letang,D,PIT,37,81,16,44,60
5,8478401,Pavel Zacha,C,BOS,27,80,28,31,59
5,8478462,Nicolas Roy,C,VGK,27,74,29,29,58
5,8479385,Jordan Kyrou,C,STL,26,75,27,31,58
5,8474150,Mikael Backlund,C,CGY,35,76,23,35,58
5,8481542,Moritz Seider,D,DET,23,74,9,49,58
5,8471215,Evgeni Malkin,C,PIT,38,76,26,31,57
5,8475784,Jeff Skinner,C,EDM,32,73,26,31,57
5,8479999,Casey Mittelstadt,C,COL,26,82,25,32,57
5,8476905,Chandler Stephenson,C,SEA,30,79,20,37,57
5,8477935,Sam Bennett,C,FLA,28,78,26,30,56
5,8483515,Juraj Slafkovsky,L,MTL,20,73,21,35,56
5,8480009,Eeli Tolvanen,R,SEA,25,75,19,37,56
5,8475798,Mikael Granlund,C,SJS,32,67,12,44,56
5,8475169,Evander Kane,L,EDM,33,76,25,30,55
5,8482699,Dylan Guenther,R,UTA,21,75,24,31,55
5,8478449,Roope Hintz,C,DAL,28,82,28,26,54
5,8481711,Matias Maccelli,L,UTA,24,74,21,33,54
5,8476906,Shayne Gostisbehere,D,CAR,31,73,20,34,54
5,8477497,Sean Monahan,C,CBJ,30,69,18,36,54
5,8475753,Justin Faulk,D,STL,32,71,10,44,54
5,8477447,Shea Theodore,D,VGK,29,65,6,48,54
5,8476483,Rickard Rakell,R,PIT,31,69,32,21,53
5,8480188,Fabian Zetterlund,L,SJS,25,74,26,27,53
5,8475794,Tyler Seguin,C,DAL,32,82,22,31,53
5,8478047,Michael Bunting,L,PIT,29,73,16,37,53
5,8480014,Gabriel Vilardi,C,WPG,25,67,29,23,52
5,8479675,Trevor Moore,L,LAK,29,81,27,25,52
5,8478519,Anthony Cirelli,C,TBL,27,82,26,26,52
5,8477476,Artturi Lehkonen,L,COL,29,79,24,28,52
5,8478975,Mason Marchment,L,DAL,29,80,21,31,52
5,8478397,Rasmus Andersson,D,CGY,28,71,8,44,52
5,8479410,Mikhail Sergachev,D,UTA,26,66,8,43,51
5,8477416,Oliver Bjorkstrand,R,SEA,29,74,24,26,50
5,8482109,Alexis Lafrenière,L,NYR,23,72,24,26,50
5,8482745,Mason McTavish,C,ANA,21,75,24,26,50
5,8481618,Alex Newhook,C,MTL,23,77,17,33,50
5,8477964,Ivan Barbashev,C,VGK,29,70,12,38,50
5,8480064,Josh Norris,C,OTT,25,74,32,17,49
5,8482110,Dawson Mercer,C,NJD,23,71,26,23,49
5,8477500,Bo Horvat,C,NYI,29,81,24,25,49
5,8478498,Jake DeBrusk,L,VAN,28,76,24,25,49
5,8481533,Trevor Zegras,C,ANA,23,73,23,26,49
5,8477479,Tyler Bertuzzi,L,CHI,29,67,22,27,49
5,8484166,Adam Fantilli,C,CBJ,20,69,21,28,49
5,8477021,Alex Kerfoot,C,UTA,30,76,12,37,49
5,8478474,Lawson Crouse,L,UTA,27,73,27,21,48
5,8477451,Ryan Hartman,R,MIN,30,76,22,26,48
5,8476826,Yanni Gourde,C,SEA,33,68,16,32,48
5,8474102,David Perron,L,OTT,36,76,15,33,48
5,8478856,Conor Garland,R,VAN,28,75,15,33,48
5,8477456,J.T. Compher,L,DET,29,80,15,33,48
5,8476875,Mike Matheson,D,MTL,30,73,14,34,48
5,8477986,Brandon Montour,D,SEA,30,76,12,36,48
5,8482124,Quinton Byfield,R,LAK,22,80,11,37,48
5,8474565,Alex Pietrangelo,D,VGK,34,68,11,37,48
5,8479400,Pierre-Luc Dubois,L,WSH,26,66,22,25,47
5,8479339,Patrik Laine,L,CBJ,26,66,22,25,47
5,8476882,Teuvo Teravainen,C,CHI,30,67,21,26,47
5,8477511,Anthony Mantha,R,CGY,30,77,18,29,47
5,8482097,Jack Quinn,R,BUF,23,64,16,31,47
5,8474590,John Carlson,D,WSH,34,71,10,37,47
5,8476432,Boone Jenner,C,CBJ,31,66,27,19,46
5,8481604,Pavel Dorofeyev,L,VGK,24,74,25,21,46
5,8482175,JJ Peterka,R,BUF,22,72,24,22,46
5,8475726,Tyler Toffoli,C,SJS,32,71,20,26,46
5,8474679,Gustav Nyquist,C,NSH,35,69,18,28,46
5,8476458,Ryan Strome,C,ANA,31,70,17,29,46
5,8476462,Dougie Hamilton,D,NJD,31,70,16,30,46
5,8476792,Torey Krug,D,STL,33,75,14,32,46
5,8478472,Mathieu Joseph,R,STL,27,71,12,34,46
5,8478396,Noah Hanifin,D,VGK,27,66,12,34,46
5,8482684,Luke Hughes,D,NJD,21,67,8,38,46
5,8476539,Jonathan Marchessault,R,NSH,34,68,24,21,45
5,8481596,Shane Pinto,C,OTT,24,74,20,25,45
5,8480829,Jesperi Kotkaniemi,C,CAR,24,68,16,29,45
5,8476880,Tom Wilson,R,WSH,30,70,23,21,44
5,8478115,Pierre Engvall,L,NYI,28,82,21,23,44
5,8480459,Pius Suter,C,VAN,28,72,20,24,44
5,8478542,Evan Rodrigues,C,FLA,31,78,18,26,44
5,8477498,Darnell Nurse,D,EDM,29,75,17,27,44
5,8473994,Jamie Benn,L,DAL,35,81,16,28,44
5,8484153,Leo Carlsson,C,ANA,20,71,16,28,44
5,8480813,Joe Veleno,C,DET,24,78,15,29,44
5,8482667,William Eklund,L,SJS,22,70,13,31,44
5,8478038,Devon Toews,D,COL,30,62,3,41,44
5,8482149,Cole Perfetti,C,WPG,22,70,21,22,43
5,8479987,Morgan Geekie,C,BOS,26,78,21,22,43
5,8475722,Jason Zucker,L,BUF,32,72,21,22,43
5,8482705,Cole Sillinger,C,CBJ,21,73,21,22,43
5,8483431,Logan Cooley,C,UTA,20,75,18,25,43
5,8484145,Zach Benson,L,BUF,19,69,18,25,43
5,8477407,Anthony Duclair,L,NYI,29,77,18,25,43
5,8477495,Seth Jones,D,CHI,30,76,12,31,43
5,8477494,Jonathan Drouin,L,COL,29,80,11,32,43
5,8477932,Aaron Ekblad,D,FLA,28,67,10,33,43
5,8480797,Joel Farabee,L,PHI,24,79,18,24,42
5,8482702,Logan Stankoven,C,DAL,21,79,17,25,42
5,8478042,Viktor Arvidsson,L,EDM,31,72,15,27,42
5,8481577,Philip Tomasino,C,NSH,23,68,13,29,42
5,8477444,Andre Burakovsky,L,SEA,29,73,21,20,41
5,8481560,Arthur Kaliyev,R,LAK,23,81,20,21,41
5,8477998,Warren Foegele,L,LAK,28,79,17,24,41
5,8475151,Kyle Palmieri,C,NYI,33,79,15,26,41
5,8474586,Jordan Eberle,R,SEA,34,74,14,27,41
5,8476869,Brady Skjei,D,NSH,30,67,10,31,41
5,8477503,Max Domi,C,TOR,29,78,9,32,41
5,8481581,Thomas Harley,D,DAL,23,79,9,32,41
5,8479992,Michael Rasmussen,C,DET,25,79,21,19,40
5,8482159,Tyson Foerster,R,PHI,22,74,20,20,40
5,8475170,Brayden Schenn,C,STL,33,75,18,22,40
5,8482113,Anton Lundell,C,FLA,23,81,17,23,40
5,8478891,Mason Appleton,C,WPG,28,68,17,23,40
5,8475799,Nino Niederreiter,R,WPG,32,69,17,23,40
5,8478438,Tommy Novak,C,NSH,27,75,11,29,40
5,8477346,MacKenzie Weegar,D,CGY,30,73,10,30,40
5,8481703,Valtteri Puustinen,R,PIT,25,60,10,30,40
5,8476438,Brandon Saad,L,STL,32,70,22,17,39
5,8476479,Phillip Danault,C,LAK,31,76,18,21,39
5,8471698,T.J. Oshie,R,WSH,38,72,18,21,39
5,8482720,Matthew Knies,L,TOR,22,75,15,24,39
5,8476872,Scott Laughton,C,PHI,30,77,15,24,39
5,8475793,Ryan Johansen,C,PHI,32,71,15,24,39
5,8470613,Brent Burns,D,CAR,39,81,11,28,39
5,8479345,Jakob Chychrun,D,WSH,26,61,10,29,39
5,8478469,Thomas Chabot,D,OTT,27,70,9,30,39
5,8482671,Owen Power,D,BUF,22,71,7,32,39
5,8476853,Morgan Rielly,D,TOR,30,74,5,34,39
5,8479365,Trent Frederic,C,BOS,26,75,21,17,38
5,8480835,Jack Drury,C,CAR,24,66,18,20,38
5,8474716,Jared Spurgeon,D,MIN,35,73,18,20,38
5,8474641,Adam Henrique,C,EDM,34,76,16,22,38
5,8481524,Bowen Byram,D,BUF,23,71,15,23,38
5,8480817,K'Andre Miller,D,NYR,24,71,12,26,38
5,8476854,Hampus Lindholm,D,BOS,30,76,11,27,38
5,8482089,Jake Neighbours,L,STL,22,67,23,14,37
5,8475314,Anders Lee,L,NYI,34,76,19,18,37
5,8478057,Dakota Joshua,C,VAN,28,67,19,18,37
5,8475149,Marcus Johansson,L,MIN,34,72,17,20,37
5,8480849,Barrett Hayton,C,UTA,24,71,17,20,37
5,8478466,Daniel Sprong,R,VAN,27,65,14,23,37
5,8475760,Nick Bjugstad,C,UTA,32,73,14,23,37
5,8475763,Kevin Hayes,R,PIT,32,70,13,24,37
5,8480185,Eetu Luostarinen,C,FLA,26,75,13,24,37
5,8477429,Andrew Copp,C,DET,30,80,11,26,37
5,8482712,Oskar Olausson,R,COL,22,75,7,30,37
5,8483490,Pavel Mintyukov,D,ANA,21,73,6,31,37
5,8481535,Nils Hoglander,L,VAN,24,65,26,10,36
5,8477426,Nicholas Paul,L,TBL,29,82,18,18,36
5,8476474,Stefan Noesen,R,NJD,31,67,18,18,36
5,8480798,Philipp Kurashev,C,CHI,25,68,10,26,36
5,8479425,Filip Hronek,D,VAN,27,77,8,28,36
5,8476923,Damon Severson,D,CBJ,30,80,3,33,36
5,8478020,Michael Amadio,R,OTT,28,68,25,10,35
5,8475714,Calle Jarnkrok,C,TOR,33,78,15,20,35
5,8476925,Colton Sissons,C,NSH,31,68,14,21,35
5,8478458,John (Jack) Roslovic,C,CAR,27,67,12,23,35
5,8482624,Daniil Miromanov,D,CGY,27,70,12,23,35
5,8476292,Ondrej Palat,L,NJD,33,69,11,24,35
5,8480145,Neal Pionk,D,WPG,29,73,8,27,35
5,8470621,Corey Perry,R,EDM,39,72,16,18,34
5,8475768,Jaden Schwartz,C,SEA,32,65,15,19,34
5,8481523,Kirby Dach,C,MTL,23,74,15,19,34
5,8476392,Adam Lowry,C,WPG,31,59,14,20,34
5,8475287,Erik Haula,L,NJD,33,70,11,23,34
5,8482133,Thomas Bordeleau,C,SJS,22,62,9,25,34
5,8477948,Travis Sanheim,D,PHI,28,73,9,25,34
5,8480871,Adam Boqvist,D,FLA,24,75,5,29,34
5,8482475,Yegor Chinakhov,R,CBJ,23,62,17,16,33
5,8477488,Brett Pesce,D,NJD,30,72,13,20,33
5,8480220,Noah Cates,L,PHI,25,74,13,20,33
5,8481656,Aliaksei Protas,C,WSH,23,65,12,21,33
5,8484203,Bradly Nadeau,L,CAR,19,65,12,21,33
5,8475200,Dmitry Orlov,D,CAR,33,75,11,22,33
5,8476461,Sean Couturier,C,PHI,32,62,9,24,33
5,8476958,Jaccob Slavin,D,CAR,30,70,7,26,33
5,8476979,Erik Gustafsson,D,DET,32,75,6,27,33
5,8477969,Marcus Pettersson,D,PIT,28,74,6,27,33
5,8475764,Cam Fowler,D,ANA,33,73,4,29,33
5,8475193,Tomas Tatar,L,NJD,34,67,19,13,32
5,8480078,Filip Chytil,C,NYR,25,70,18,14,32
5,8476419,Jean-Gabriel Pageau,C,NYI,32,77,15,17,32
5,8477947,Sonny Milano,L,WSH,28,63,14,18,32
5,8479996,Cody Glass,C,NSH,25,66,13,19,32
5,8478413,Jordan Greenway,L,BUF,27,68,13,19,32
5,8480028,Morgan Frost,C,PHI,25,69,9,23,32
5,8483505,Matthew Poitras,C,BOS,20,76,7,25,32
5,8480434,Sean Durzi,D,UTA,26,70,6,26,32
5,8476981,Josh Anderson,R,MTL,30,68,19,12,31
5,8482146,Luke Evangelista,R,NSH,22,67,16,15,31
5,8474149,Evgenii Dadonov,R,DAL,35,81,14,17,31
5,8477425,Miles Wood,L,COL,29,76,11,20,31
5,8476927,Teddy Blueger,C,VAN,30,67,10,21,31
5,8481624,Ilya Mikheyev,R,CHI,30,53,10,21,31
5,8479639,Dylan Coghlan,D,WPG,26,62,7,24,31
5,8474563,Drew Doughty,D,LAK,35,74,6,25,31
5,8481546,Cam York,D,PHI,23,70,6,25,31
5,8476917,Adam Pelech,D,NYI,30,80,5,26,31
5,8479619,Michael Carcone,L,UTA,28,65,21,9,30
5,8479353,Brett Howden,C,VGK,26,71,18,12,30
5,8481186,Logan O'Connor,R,COL,28,78,15,15,30
5,8474715,Cameron Atkinson,R,TBL,35,80,15,15,30
5,8475848,Brendan Gallagher,R,MTL,32,70,14,16,30
5,8474189,Lars Eller,C,PIT,35,64,14,16,30
5,8476897,Oskar Sundqvist,C,STL,30,65,13,17,30
5,8476889,Radek Faksa,C,STL,30,58,12,18,30
5,8479983,Mario Ferraro,D,SJS,26,70,10,20,30
5,8478233,Andrew Mangiapane,L,WSH,28,70,9,21,30
5,8479398,Samuel Girard,D,COL,26,63,6,24,30
5,8480336,Sean Walker,D,CAR,30,77,5,25,30
5,8480113,Alex Iafallo,L,WPG,31,61,15,14,29
5,8480893,Kirill Marchenko,R,CBJ,24,63,15,14,29
5,8478463,Anthony Beauvillier,L,PIT,27,64,14,15,29
5,8477953,Kasperi Kapanen,R,STL,28,64,14,15,29
5,8477505,Alexander Wennberg,C,SJS,30,61,12,17,29
5,8482092,Ridly Greig,C,OTT,22,74,12,17,29
5,8480144,David Kampf,C,TOR,29,71,11,18,29
5,8482749,Joshua Roy,R,MTL,21,63,10,19,29
5,8475218,Mattias Ekholm,D,EDM,34,73,8,21,29
5,8476892,Colton Parayko,D,STL,31,69,7,22,29
5,8478055,Gustav Forsling,D,FLA,28,61,6,23,29
5,8478500,Ivan Provorov,D,CBJ,27,81,3,26,29
5,8482087,Kaiden Guhle,D,MTL,22,72,3,26,29
5,8482055,Drew O'Connor,L,PIT,26,65,19,9,28
5,8479393,Noah Gregor,L,OTT,26,70,16,12,28
5,8482259,Bobby McMann,C,TOR,28,64,16,12,28
5,8473533,Jordan Staal,C,CAR,36,55,13,15,28
5,8483524,Shane Wright,C,SEA,20,65,11,17,28
5,8474053,Logan Couture,C,SJS,35,65,11,17,28
5,8476480,Vladislav Namestnikov,C,WPG,32,63,9,19,28
5,8482660,Kent Johnson,C,CBJ,22,65,9,19,28
5,8483565,Nick Blankenburg,D,NSH,26,67,9,19,28
5,8481441,Joe Snively,C,DET,28,67,7,21,28
5,8482105,Jake Sanderson,D,OTT,22,74,5,23,28
5,8475324,Nick Jensen,D,OTT,34,75,4,24,28
5,8476463,Jonas Brodin,D,MIN,31,76,3,25,28
5,8482122,Brock Faber,D,MIN,22,78,2,26,28
5,8482245,Artem Zub,D,OTT,29,76,1,27,28
5,8479368,Max Jones,L,BOS,26,61,15,12,27
5,8481554,Kaapo Kakko,R,NYR,23,67,14,13,27
5,8478013,Jake Walman,D,SJS,28,70,14,13,27
5,8482074,Connor Zary,C,CGY,23,61,14,13,27
5,8477478,William Carrier,L,CAR,30,60,14,13,27
5,8481032,Paul Cotter,C,NJD,25,58,14,13,27
5,8482737,Zack Bolduc,C,STL,21,55,13,14,27
5,8479293,Brandon Tanev,L,SEA,33,60,12,15,27
5,8482117,Lukas Reichel,L,CHI,22,63,12,15,27
5,8479591,Michael Eyssimont,C,TBL,28,81,11,16,27
5,8482125,Alexander Holtz,R,VGK,22,62,11,16,27
5,8473422,Nick Foligno,L,CHI,37,56,10,17,27
5,8481582,Nicholas Robertson,L,TOR,23,62,9,18,27
5,8481019,David Gustafsson,C,WPG,24,49,6,21,27
5,8479976,Juuso Valimaki,D,UTA,26,64,5,22,27
5,8476469,Joel Armia,R,MTL,31,59,14,12,26
5,8479390,Taylor Raddysh,R,WSH,26,61,13,13,26
5,8476374,Sean Kuraly,C,CBJ,31,58,13,13,26
5,8480855,Jack McBain,C,UTA,24,69,10,16,26
5,8480891,Michael Kesselring,D,UTA,24,65,5,21,26
5,8481014,Alexander Romanov,D,NYI,24,81,4,22,26
5,8478507,John Marino,D,UTA,27,62,3,23,26
5,8476918,Jimmy Vesey,L,NYR,31,69,14,11,25
5,8483493,Frank Nazar,C,CHI,20,51,12,13,25
5,8478508,Yakov Trenin,C,MIN,27,60,12,13,25
5,8477987,Ryan Donato,C,CHI,28,67,11,14,25
5,8477903,Garnet Hathaway,R,PHI,33,66,11,14,25
5,8476278,Colin Blackwell,C,DAL,31,77,10,15,25
5,8475343,Nic Dowd,C,WSH,34,64,10,15,25
5,8476994,Vinnie Hinostroza,C,NSH,30,55,9,16,25
5,8483445,Cutter Gauthier,L,ANA,20,64,8,17,25
5,8480878,Nils Lundkvist,D,DAL,24,71,6,19,25
5,8476525,Colin Miller,D,WPG,32,75,5,20,25
5,8478911,Matt Roy,D,WSH,29,62,4,21,25
5,8482655,Janis Moser,D,TBL,24,79,4,21,25
5,8480873,Rasmus Sandin,D,WSH,24,70,3,22,25
5,8478416,Erik Cernak,D,TBL,27,79,3,22,25
5,8478046,Danton Heinen,L,VAN,29,69,15,9,24
5,8477952,Robby Fabbri,C,ANA,28,58,13,11,24
5,8478109,Victor Olofsson,L,VGK,29,64,13,11,24
5,8483468,Jiri Kulich,C,BUF,20,61,12,12,24
5,8481704,Juuso Parssinen,C,NSH,23,54,12,12,24
5,8478569,Noel Acciari,C,PIT,33,48,11,13,24
5,8476885,Jacob Trouba,D,NYR,30,64,10,14,24
5,8479351,Sam Steel,C,DAL,26,81,9,15,24
5,8480806,Isac Lundestrom,C,ANA,25,59,8,16,24
5,8478434,Keegan Kolesar,R,VGK,27,71,8,16,24
5,8480802,Ryan McLeod,C,BUF,25,61,7,17,24
5,8477506,Ryan Pulock,D,NYI,30,78,5,19,24
5,8478970,Jalen Chatfield,D,CAR,28,73,5,19,24
5,8479982,Conor Timmins,D,TOR,26,59,3,21,24
5,8480796,Martin Fehervary,D,WSH,25,53,2,22,24
5,8480003,Jesper Boqvist,C,FLA,26,66,14,9,23
5,8479941,Justin Danforth,R,CBJ,31,56,13,10,23
5,8483499,Liam Ohgren,L,MIN,20,53,12,11,23
5,8480205,Emil Bemstrom,C,PIT,25,56,11,12,23
5,8482077,Dylan Holloway,L,EDM,23,50,11,12,23
5,8479439,Jacob MacDonald,D,COL,31,61,11,12,23
5,8476902,Esa Lindell,D,DAL,30,71,10,13,23
5,8482809,Jackson Blake,R,CAR,21,57,9,14,23
5,8476921,Jordan Martinook,L,CAR,32,59,9,14,23
5,8474034,Patrick Maroon,L,CHI,36,46,8,15,23
5,8476429,Scott Mayfield,D,NYI,32,74,3,20,23
5,8475279,Ben Chiarot,D,DET,33,64,3,20,23
5,8476873,Mark Jankowski,C,NSH,30,52,9,13,22
5,8480355,Mark Kastelic,C,BOS,25,64,9,13,22
5,8481481,Blake Lizotte,C,PIT,27,65,7,15,22
5,8481093,Rafael Harvey-Pinard,L,MTL,25,65,6,16,22
5,8476931,Jake McCabe,D,TOR,31,65,6,16,22
5,8477919,Frederick Gaudreau,C,MIN,31,58,5,17,22
5,8473507,Jeff Petry,D,DET,37,75,5,17,22
5,8480043,Timothy Liljegren,D,TOR,25,69,4,18,22
5,8478136,Jake Middleton,D,MIN,28,73,3,19,22
5,8482659,Josh Doan,R,UTA,22,50,16,5,21
5,8477392,Hudson Fasching,R,NYI,29,66,15,6,21
5,8480748,Kiefer Sherwood,L,VAN,29,59,13,8,21
5,8476960,Andreas Athanasiou,C,CHI,30,48,13,8,21
5,8479316,Luke Kunin,C,SJS,27,59,11,10,21
5,8482679,Matt Coronato,R,CGY,22,64,8,13,21
5,8480789,Oliver Wahlstrom,R,NYI,24,72,8,13,21
5,8473563,Nicklas Backstrom,C,WSH,37,63,8,13,21
5,8477015,Connor Brown,R,EDM,30,61,7,14,21
5,8478882,Vladislav Gavrikov,D,LAK,29,68,7,14,21
5,8481606,Jordan Spence,D,LAK,23,68,6,15,21
5,8477989,Christian Dvorak,C,MTL,28,63,6,15,21
5,8480727,Zach Whitecloud,D,VGK,28,46,5,16,21
5,8482730,Brandt Clarke,D,LAK,21,51,4,17,21
5,8477507,Nikita Zadorov,D,BOS,29,70,3,18,21
5,8475171,Oliver Ekman-Larsson,D,TOR,33,65,2,19,21
5,8476331,Dylan DeMelo,D,WPG,31,64,1,20,21
5,8477446,Michael McCarron,R,NSH,29,50,12,8,20
5,8478432,Christian Fischer,R,DET,27,76,11,9,20
5,8479414,Nathan Bastian,R,NJD,27,62,11,9,20
5,8481601,Simon Holmstrom,R,NYI,23,67,11,9,20
5,8477450,Jason Dickinson,C,CHI,29,65,10,10,20
5,8482803,Olen Zellweger,D,ANA,21,66,8,12,20
5,8477839,Conor Sheary,L,TBL,32,81,6,14,20
5,8480073,Erik Brannstrom,D,COL,25,62,3,17,20
5,8478133,Jake Evans,C,MTL,28,72,3,17,20
5,8480860,Kevin Bahl,D,CGY,24,45,3,17,20
5,8482451,Mikael Pyyhtia,L,CBJ,23,40,2,18,20
5,8475181,Nick Leddy,D,STL,33,64,1,19,20
5,8479324,Ryan Lindgren,D,NYR,26,66,1,19,20
5,8479369,Andrew Peeke,D,BOS,26,55,0,20,20
5,8475791,Taylor Hall,L,CHI,33,54,9,10,19
5,8480068,Ryan Poehling,C,PHI,25,70,8,11,19
5,8476624,Barclay Goodrow,C,SJS,31,54,8,11,19
5,8476312,Josh Manson,D,COL,33,60,7,12,19
5,8477353,Tyler Motte,C,DET,29,70,7,12,19
5,8479661,Tanner Jeannot,L,LAK,27,78,6,13,19
5,8478178,Darren Raddysh,D,TBL,28,73,6,13,19
5,8479066,Ryan Lomberg,L,CGY,30,59,6,13,19
5,8477979,Nicolas Aube-Kubel,R,BUF,28,59,6,13,19
5,8484149,Gavin Brindley,C,CBJ,20,47,5,14,19
5,8474151,Ryan McDonagh,D,TBL,35,71,4,15,19
5,8476457,Adam Larsson,D,SEA,32,69,4,15,19
5,8479402,Jake Bean,D,CGY,26,68,1,18,19
5,8477845,Trevor van Riemsdyk,D,WSH,33,59,1,18,19
5,8478399,Jonas Siegenthaler,D,NJD,27,64,0,19,19
5,8478585,Derek Ryan,C,EDM,38,68,13,5,18
5,8476856,Mathew Dumba,D,DAL,30,71,10,8,18
5,8475220,Marcus Foligno,L,MIN,33,55,9,9,18
5,8481580,Connor McMichael,C,WSH,23,56,7,11,18
5,8482157,Will Cuylle,L,NYR,22,55,7,11,18
5,8482067,Connor Mackey,D,NYR,28,55,7,11,18
5,8480289,Morgan Barron,C,WPG,26,55,7,11,18
5,8480980,Connor Dewar,C,TOR,25,65,6,12,18
5,8479359,Beck Malenstyn,L,BUF,26,49,6,12,18
5,8471709,Marc-Edouard Vlasic,D,SJS,37,61,4,14,18
5,8477220,Nate Schmidt,D,FLA,33,65,4,14,18
5,8479371,Dante Fabbro,D,NSH,26,64,3,15,18
5,8476879,Cody Ceci,D,EDM,31,76,1,17,18
5,8478840,Will Borgen,D,SEA,28,66,1,17,18
5,8478421,A.J. Greer,L,FLA,28,64,12,5,17
5,8481477,Nico Sturm,C,SJS,29,54,11,6,17
5,8478043,Sam Lafferty,C,BUF,29,59,9,8,17
5,8479671,Mathieu Olivier,R,CBJ,27,50,9,8,17
5,8479370,Tyson Jost,C,CAR,26,54,9,8,17
5,8482744,James Malatesta,L,CBJ,21,39,9,8,17
5,8482111,Justin Barron,D,MTL,23,66,6,11,17
5,8481028,Martin Pospisil,C,CGY,25,51,6,11,17
5,8479315,Joey Anderson,R,CHI,26,45,5,12,17
5,8470600,Ryan Suter,D,STL,39,61,5,12,17
5,8479442,Troy Stecher,D,EDM,30,47,5,12,17
5,8475790,Erik Gudbranson,D,CBJ,32,77,4,13,17
5,8482073,Braden Schneider,D,NYR,23,63,4,13,17
5,8481527,Kaedan Korczak,D,VGK,23,47,3,14,17
5,8475188,Brayden McNabb,D,VGK,33,56,2,15,17
5,8475208,Brian Dumoulin,D,ANA,33,66,1,16,17
5,8480049,Dylan Samberg,D,WPG,25,70,0,17,17
5,8482062,Cole Smith,L,NSH,29,62,11,5,16
5,8482155,Alex Laferriere,R,LAK,23,61,10,6,16
5,8477406,Mattias Janmark,C,EDM,32,63,8,8,16
5,8480025,MacKenzie Entwistle,R,FLA,25,56,8,8,16
5,8480995,Pontus Holmberg,R,TOR,25,58,7,9,16
5,8476878,Zemgus Girgensons,C,TBL,30,78,7,9,16
5,8480011,Klim Kostin,C,SJS,25,53,7,9,16
5,8475225,Craig Smith,C,CHI,35,58,7,9,16
5,8482747,Brennan Othmann,L,NYR,21,42,6,10,16
5,8480246,Nick Perbix,D,TBL,26,70,4,12,16
5,8482166,Shakir Mukhamadullin,D,SJS,22,53,4,12,16
5,8475455,Brenden Dillon,D,NJD,34,63,3,13,16
5,8477435,Ryan Graves,D,PIT,29,77,2,14,16
5,8482192,Isaak Phillips,D,CHI,23,47,2,14,16
5,8475462,Radko Gudas,D,ANA,34,61,2,14,16
5,8480035,Henri Jokiharju,D,BUF,25,58,1,15,16
5,8478851,Alexandre Carrier,D,NSH,28,68,1,15,16
5,8479998,Mikey Anderson,D,LAK,25,63,0,16,16
5,8482148,Hendrix Lapierre,C,WSH,22,54,9,6,15
5,8478211,Dryden Hunt,L,CGY,29,54,9,6,15
5,8481641,Joel Kiviranta,L,COL,28,71,8,7,15
5,8480441,Trey Fix-Wolansky,R,CBJ,25,39,7,8,15
5,8476422,Mike Reilly,D,NYI,31,74,6,9,15
5,8480762,Eric Robinson,L,CAR,29,58,6,9,15
5,8480074,Alexandre Texier,C,STL,25,52,6,9,15
5,8474574,Tyler Myers,D,VAN,34,68,5,10,15
5,8479344,Jesse Puljujarvi,R,PIT,26,52,5,10,15
5,8482964,Arber Xhekaj,D,MTL,23,48,5,10,15
5,8483491,Ivan Miroshnichenko,L,WSH,20,53,4,11,15
5,8477369,Carson Soucy,D,VAN,30,59,4,11,15
5,8477380,Jonny Brodzinski,C,NYR,31,56,4,11,15
5,8482496,Nils Aman,C,VAN,24,42,4,11,15
5,8482101,Danil Gushchin,L,SJS,22,58,3,12,15
5,8474673,TJ Brodie,D,CHI,34,54,3,12,15
5,8480222,Sebastian Aho,D,PIT,28,71,3,12,15
5,8481568,Alex Vlasic,D,CHI,23,53,3,12,15
5,8475762,Derek Forbort,D,VAN,32,54,3,12,15
5,8480172,Jan Rutta,D,SJS,34,58,2,13,15
5,8479336,Carl Grundstrom,R,SJS,27,43,12,2,14
5,8479520,Brandon Duhaime,R,WSH,27,59,10,4,14
5,8482762,Simon Edvinsson,D,DET,21,61,7,7,14
5,8471817,Ryan Reaves,R,TOR,37,59,7,7,14
5,8480848,Ty Dellandrea,C,SJS,24,49,6,8,14
5,8477931,Tomas Nosek,L,FLA,32,65,6,8,14
5,8481521,Ronnie Attard,D,PHI,25,57,5,9,14
5,8480448,Parker Kelly,L,COL,25,75,5,9,14
5,8483482,Tristan Luneau,D,ANA,20,61,5,9,14
5,8476329,Travis Boyd,C,MIN,31,50,5,9,14
5,8481518,Nolan Foote,L,NJD,24,37,5,9,14
5,8477573,Nathan Walker,L,STL,30,51,5,9,14
5,8476874,Olli Maatta,D,DET,30,62,5,9,14
5,8478859,Niko Mikkola,D,FLA,28,51,5,9,14
5,8477508,Curtis Lazar,C,NJD,29,56,4,10,14
5,8481537,Nikita Okhotiuk,D,CGY,24,55,4,10,14
5,8479980,Nicolas Hague,D,VGK,26,46,4,10,14
5,8477499,Rasmus Ristolainen,D,PHI,30,56,3,11,14
5,8478451,Ethan Bear,D,WSH,27,48,3,11,14
5,8479026,Philippe Myers,D,TOR,27,50,2,12,14
5,8475233,David Savard,D,MTL,34,62,2,12,14
5,8478443,Brandon Carlo,D,BOS,28,63,2,12,14
5,8475690,Chris Tanev,D,TOR,35,53,2,12,14
5,8480157,Calle Rosen,D,COL,30,47,2,12,14
5,8479249,Andrew Poturalski,C,SJS,30,36,2,12,14
5,8480807,Mattias Samuelsson,D,BUF,24,55,1,13,14
5,8475855,Jesper Fast,R,CAR,33,52,10,3,13
5,8475842,Sam Carrick,C,NYR,32,53,10,3,13
5,8476822,Luke Glendening,C,TBL,35,77,9,4,13
5,8479994,Jaret Anderson-Dolan,C,WPG,25,38,9,4,13
5,8483457,Lane Hutson,D,MTL,20,65,8,5,13
5,8480845,Rasmus Kupari,C,WPG,24,45,8,5,13
5,8482079,Marco Rossi,C,MIN,23,56,6,7,13
5,8475231,Casey Cizikas,C,NYI,33,63,5,8,13
5,8482666,Scott Morrow,D,CAR,22,43,5,8,13
5,8477018,Ben Hutton,D,VGK,31,51,4,9,13
5,8481013,Jonatan Berggren,R,DET,24,53,4,9,13
5,8480070,Ian Mitchell,D,BOS,25,47,4,9,13
5,8476952,Dominic Toninato,C,WPG,30,34,4,9,13
5,8480879,Jacob Bernard-Docker,D,OTT,24,47,3,10,13
5,8480887,Jordan Harris,D,MTL,24,50,2,11,13
5,8479972,Mason Shaw,C,WPG,26,30,1,12,13
5,8477335,Kyle Burroughs,D,LAK,29,41,1,12,13
5,8478831,Kevin Stenlund,C,UTA,28,58,9,3,12
5,8480880,Jakub Lauko,C,MIN,24,34,7,5,12
5,8482859,Zack Ostapchuk,C,OTT,21,57,7,5,12
5,8481161,Jake Christiansen,D,CBJ,25,59,6,6,12
5,8479543,Michael Pezzetta,L,MTL,26,51,5,7,12
5,8479772,Zack MacEwen,R,OTT,28,59,5,7,12
5,8481553,Bobby Brink,R,PHI,23,59,4,8,12
5,8481059,Scott Perunovich,D,STL,26,64,4,8,12
5,8483495,Simon Nemec,D,NJD,20,54,4,8,12
5,8481751,Lukas Rousek,R,BUF,25,38,4,8,12
5,8481708,Zac Jones,D,NYR,24,55,3,9,12
5,8480007,Jonas Rondbjerg,R,VGK,25,36,3,9,12
5,8483619,Filip Roos,D,OTT,25,36,3,9,12
5,8480001,Urho Vaakanainen,D,ANA,25,59,2,10,12
5,8476967,Brett Kulak,D,EDM,30,62,1,11,12
5,8477365,Connor Clifton,D,BUF,29,57,0,12,12
5,8477034,Jaycob Megna,D,FLA,32,49,0,12,12
5,8477401,John Hayden,C,SEA,29,34,10,1,11
5,8480021,Jack Studnicka,C,LAK,25,58,7,4,11
5,8478424,Jansen Harkins,C,ANA,27,43,6,5,11
5,8473453,Trevor Lewis,C,LAK,37,73,6,5,11
5,8481789,Tye Kartye,L,SEA,23,34,6,5,11
5,8483466,Kevin Korchinski,D,CHI,20,51,6,5,11
5,8477070,Liam O'Brien,C,UTA,30,48,5,6,11
5,8481617,Vasily Podkolzin,R,VAN,23,54,5,6,11
5,8482784,Zach Dean,C,STL,21,42,5,6,11
5,8480281,Alexey Toropchenko,R,STL,25,56,4,7,11
5,8480192,Johnathan Kovacevic,D,NJD,27,51,4,7,11
5,8479536,Axel Jonsson-Fjallby,L,WPG,26,37,4,7,11
5,8481598,Philip Broberg,D,EDM,23,47,4,7,11
5,8481522,Peyton Krebs,C,BUF,23,49,3,8,11
5,8476467,Jamie Oleksiak,D,SEA,32,70,3,8,11
5,8471677,Jack Johnson,D,CBJ,37,64,3,8,11
5,8482142,Jamie Drysdale,D,PHI,22,56,2,9,11
5,8479348,Kale Clague,D,BUF,26,37,2,9,11
5,8474166,Alec Martinez,D,CHI,37,55,2,9,11
5,8474568,Luke Schenn,D,NSH,35,46,2,9,11
5,8480196,Jacob Bryson,D,BUF,27,48,2,9,11
5,8476891,Matthew Grzelcyk,D,PIT,30,76,1,10,11
5,8482634,Alex Steeves,C,TOR,25,48,1,10,11
5,8483460,David Jiricek,D,CBJ,21,54,0,11,11
5,8479372,Joshua Mahura,D,SEA,26,52,0,11,11
5,8480950,Ilya Lyubushkin,D,DAL,30,68,0,11,11
5,8481556,John Beecher,C,BOS,23,27,6,4,10
5,8479638,Justin Brazeau,R,BOS,26,32,5,5,10
5,8481754,Nikita Nesterenko,C,ANA,23,33,5,5,10
5,8479291,Kevin Rooney,C,CGY,31,48,4,6,10
5,8479328,Julien Gauthier,R,NYI,27,62,4,6,10
5,8479378,Logan Stanley,D,WPG,26,38,4,6,10
5,8481178,Egor Zamula,D,PHI,24,60,3,7,10
5,8482176,Wyatt Kaiser,D,CHI,22,54,3,7,10
5,8476988,Matt Benning,D,SJS,30,70,2,8,10
5,8476372,Nick Seeler,D,PHI,31,49,2,8,10
5,8481599,Victor Soderstrom,D,UTA,23,43,1,9,10
5,8478468,Jeremy Lauzon,D,NSH,27,61,1,9,10
5,8474612,Travis Hamonic,D,OTT,34,42,1,9,10
5,8481167,Brayden Pachal,D,CGY,25,46,1,9,10
5,8479576,Vincent Desharnais,D,VAN,28,35,1,9,10
5,8481567,Henry Thrun,D,SJS,23,49,0,10,10
5,8476934,Brock McGinn,L,ANA,30,51,5,4,9
5,8476442,Matt Nieto,L,PIT,32,51,5,4,9
5,8482095,Tyler Kleven,D,OTT,22,37,4,5,9
5,8477527,Ross Johnston,L,ANA,30,34,4,5,9
5,8476913,Devin Shore,C,MIN,30,43,4,5,9
5,8480058,Pierre-Olivier Joseph,D,STL,25,58,2,7,9
5,8475718,Justin Holl,D,DET,32,54,1,8,9
5,8481701,Santeri Hatakka,D,NJD,23,35,1,8,9
5,8482861,Vincent Iorio,D,WSH,22,39,1,8,9
5,8475179,Dmitry Kulikov,D,FLA,34,64,0,9,9
5,8481550,Adam Beckman,L,NJD,23,29,0,9,9
5,8481532,Alex Turcotte,C,LAK,23,48,7,1,8
5,8479944,Zach Aston-Reese,C,VGK,30,56,7,1,8
5,8481716,Dmitri Voronkov,L,CBJ,24,42,5,3,8
5,8482511,Mason Lohrei,D,BOS,23,31,5,3,8
5,8479981,Jonah Gadjovich,L,FLA,26,42,4,4,8
5,8477887,Patrick Brown,C,BOS,32,46,4,4,8
5,8474567,Zach Bogosian,D,MIN,34,61,4,4,8
5,8480252,Cole Guttman,C,CHI,25,31,3,5,8
5,8479718,Alex Barré-Boulet,C,MTL,27,41,3,5,8
5,8478452,Caleb Jones,D,LAK,27,51,2,6,8
5,8482807,Ethan Del Mastro,D,CHI,21,47,2,6,8
5,8482751,Ryan Winterton,C,SEA,21,36,1,7,8
5,8481605,Jackson LaCombe,D,ANA,23,33,0,8,8
5,8482713,Mackie Samoskevich,R,FLA,22,32,6,1,7
5,8475235,Nicolas Deslauriers,L,PHI,33,51,5,2,7
5,8482652,Walker Duehr,R,CGY,27,51,5,2,7
5,8479968,Vinni Lettieri,C,BOS,29,47,5,2,7
5,8482061,Brandon Biro,L,SEA,26,15,5,2,7
5,8480990,Declan Chisholm,D,MIN,24,41,4,3,7
5,8477482,Zachary Sanford,L,CHI,30,36,4,3,7
5,8483630,Pavol Regenda,L,ANA,25,28,4,3,7
5,8481122,Simon Benoit,D,TOR,26,42,3,4,7
5,8478881,Brett Seney,L,CHI,28,18,3,4,7
5,8477962,Brendan Lemieux,L,CAR,28,37,2,5,7
5,8483549,Lucas Condotta,L,MTL,27,37,2,5,7
5,8476867,Brendan Gaunce,C,MIN,30,38,2,5,7
5,8477384,Joshua Brown,D,EDM,30,38,2,5,7
5,8480245,Olle Lycksell,R,PHI,25,33,1,6,7
5,8474013,Ian Cole,D,UTA,35,53,0,7,7
5,8483570,Ben Meyers,C,SEA,26,30,5,1,6
5,8481147,Reese Johnson,C,MIN,26,37,3,3,6
5,8484258,Sam Malinski,D,COL,26,22,3,3,6
5,8478409,Anthony Richard,C,PHI,28,27,3,3,6
5,8481517,Brett Leason,R,ANA,25,52,2,4,6
5,8482145,Mavrik Bourque,C,DAL,22,53,2,4,6
5,8475958,Michael Sgarbossa,C,WSH,32,24,2,4,6
5,8478017,Mark Friedman,D,VAN,29,37,2,4,6
5,8481592,Jakob Pelletier,L,CGY,23,38,1,5,6
5,8475177,Calvin de Haan,D,COL,33,49,1,5,6
5,8474090,Brendan Smith,D,DAL,35,43,1,5,6
5,8481056,Spencer Stastney,D,NSH,24,25,1,5,6
5,8477810,Joel Hanley,D,CGY,33,26,1,5,6
5,8477971,Andreas Englund,D,LAK,28,28,1,5,6
5,8477073,Kurtis MacDermid,L,NJD,30,41,1,5,6
5,8479419,Brett Murray,L,BUF,26,24,1,5,6
5,8484287,Cole McWard,D,VAN,23,22,1,5,6
5,8475750,Jon Merrill,D,MIN,32,66,0,6,6
5,8473446,Erik Johnson,D,PHI,36,45,0,6,6
5,8479320,Maxime Lajoie,D,SEA,27,20,0,6,6
5,8482070,Mitchell Chaffee,R,TBL,26,48,5,0,5
5,8482141,Lukas Cormier,D,VGK,22,27,5,0,5
5,8479367,William Lockwood,R,FLA,26,18,5,0,5
5,8482147,Jean-Luc Foudy,C,COL,22,27,4,1,5
5,8477851,Jordan Oesterle,D,BOS,32,46,3,2,5
5,8483763,Maksymilian Szuber,D,UTA,22,34,3,2,5
5,8477462,Robert Hagg,D,VGK,29,20,3,2,5
5,8479991,Jake Leschyshyn,C,NYR,25,28,3,2,5
5,8479986,Kole Lind,R,DAL,26,45,2,3,5
5,8482201,Gage Goncalves,C,TBL,23,26,2,3,5
5,8481600,Tobias Bjornfot,D,FLA,23,45,1,4,5
5,8481609,Vladislav Kolyachonok,D,UTA,23,33,1,4,5
5,8477244,Chad Ruhwedel,D,NYR,34,35,1,4,5
5,8482250,Callahan Burke,C,VGK,27,21,1,4,5
5,8478450,Parker Wotherspoon,D,BOS,27,30,0,5,5
5,8484254,Akito Hirose,D,VAN,25,36,0,5,5
5,8482470,Ilya Solovyov,D,CGY,24,22,4,0,4
5,8480844,Grigori Denisenko,L,VGK,24,29,3,1,4
5,8481422,Jake Lucchini,C,NSH,29,13,3,1,4
5,8477938,Haydn Fleury,D,WPG,28,34,2,2,4
5,8480890,Jan Jenik,C,OTT,24,26,2,2,4
5,8480851,Akil Thomas,C,LAK,24,18,2,2,4
5,8475795,Dylan McIlrath,D,WSH,32,11,2,2,4
5,8477320,Anton Blidh,L,NYR,29,27,2,2,4
5,8478874,Adam Gaudette,R,OTT,28,40,1,3,4
5,8479379,Givani Smith,R,SJS,26,29,1,3,4
5,8478146,Matthew Highmore,C,OTT,28,34,1,3,4
5,8481699,Aku Raty,R,UTA,23,13,1,3,4
5,8484911,Collin Graf,R,SJS,22,39,1,3,4
5,8482177,Marat Khusnutdinov,C,MIN,22,29,1,3,4
5,8480292,Carson Meyer,R,ANA,27,35,0,4,4
5,8483397,Marc McLaughlin,C,BOS,25,36,0,4,4
5,8480870,Bo Groulx,C,NYR,24,34,3,0,3
5,8483546,Marshall Rifai,D,TOR,26,7,3,0,3
5,8481679,Maxence Guenette,D,OTT,23,34,2,1,3
5,8481543,Nikita Alexandrov,C,STL,24,32,2,1,3
5,8482144,Jack Thompson,D,SJS,22,29,2,1,3
5,8478051,Max Willman,C,NJD,29,20,2,1,3
5,8476858,Phillip Di Giuseppe,L,VAN,31,32,1,2,3
5,8482153,Brendan Brisson,C,VGK,23,34,1,2,3
5,8480834,Ty Emberson,D,SJS,24,32,1,2,3
5,8482118,Sam Colangelo,R,ANA,23,15,1,2,3
5,8476473,Connor Murphy,D,CHI,31,35,1,2,3
5,8477473,Justin Bailey,R,SJS,29,15,1,2,3
5,8482765,Isak Rosen,R,BUF,21,25,1,2,3
5,8482165,Yan Kuznetsov,D,CGY,22,16,1,2,3
5,8482516,Matthew Kessel,D,STL,24,17,1,2,3
5,8482733,Logan Mailloux,D,MTL,31,39,1,2,3
5,8478477,Mitchell Stephens,C,SEA,27,13,1,2,3
5,8481726,Adam Edstrom,C,NYR,24,8,1,2,3
5,8483471,Brad Lambert,C,WPG,31,14,1,2,3
5,8484304,Uvis Balinskis,D,FLA,28,15,1,2,3
5,8481237,Kyle MacLean,C,NYI,25,22,0,3,3
5,8481541,Samuel Bolduc,D,NYI,24,20,0,3,3
5,8481030,Jack St. Ivany,D,PIT,25,13,0,3,3
5,8478454,Noah Juulsen,D,VAN,27,28,0,3,3
5,8480267,Sammy Walker,C,MIN,25,18,2,0,2
5,8475413,Justin Dowling,C,NJD,34,18,2,0,2
5,8475755,Alexander Petrovic,D,DAL,32,9,2,0,2
5,8478021,William Lagesson,D,DET,28,27,2,0,2
5,8484325,Waltteri Merela,C,TBL,26,22,2,0,2
5,8480468,James Hamblin,L,EDM,25,26,1,1,2
5,8480075,Cameron Crotty,D,MIN,25,13,1,1,2
5,8481719,Maxwell Crozier,D,TBL,24,16,1,1,2
5,8479362,Riley Tufte,L,BOS,26,22,1,1,2
5,8481065,Angus Crookshank,L,OTT,25,16,1,1,2
5,8483407,Brandon Scanlin,D,NYR,25,5,1,1,2
5,8479985,Cale Fleury,D,SEA,26,31,0,2,2
5,8476441,Joel Edmundson,D,LAK,31,41,0,2,2
5,8481006,Tyler Tucker,D,STL,24,13,0,2,2
5,8482088,Justin Sourdif,R,FLA,22,13,1,0,1
5,8481043,Cole Koepke,L,BOS,26,17,1,0,1
5,8481593,Jayden Struble,D,MTL,23,17,1,0,1
5,8480032,Shane Bowers,C,NJD,25,15,1,0,1
5,8481024,Linus Karlsson,C,VAN,25,6,1,0,1
5,8483567,Georgii Merkulov,C,BOS,24,10,1,0,1
5,8482787,Nikita Chibrikov,R,WPG,31,7,1,0,1
5,8477467,Gustav Olofsson,D,SEA,30,15,1,0,1
5,8481578,Graeme Clarke,R,MIN,23,7,1,0,1
5,8478854,Ryan Shea,D,PIT,27,9,1,0,1
5,8481206,John Ludvig,D,PIT,24,11,1,0,1
5,8483489,Fraser Minten,C,TOR,31,8,1,0,1
5,8478446,Glenn Gawdin,C,LAK,27,8,1,0,1
5,8480084,Nick DeSimone,D,NJD,30,16,0,1,1
5,8477149,Scott Sabourin,R,SJS,32,14,0,1,1
5,8483012,Logan Morrison,C,SEA,22,36,0,1,1
5,8481743,Marc Del Gaizo,D,NSH,25,21,0,1,1
5,8483512,Matthew Savoie,C,EDM,20,22,0,1,1
5,8482858,Ryker Evans,D,SEA,23,17,0,1,1
5,8483395,Arshdeep Bains,L,VAN,23,12,0,1,1
5,8482172,Landon Slaggert,L,CHI,22,22,0,1,1
5,8477541,Dakota Mermis,D,TOR,30,8,0,1,1
5,8474062,Riley Nash,C,NYR,35,15,0,1,1
5,8479330,Brandon Gignac,C,MTL,27,10,0,1,1
5,8479587,Rhett Gardner,C,PHI,28,21,0,1,1
5,8481655,Cole Schwindt,R,CGY,23,7,0,1,1
5,8482162,Roby Jarventie,L,EDM,22,16,0,1,1
5,8482929,Emil Lilleberg,D,TBL,23,22,0,1,1
5,8481564,Ryan Johnson,D,BUF,23,8,0,1,1
5,8478502,Dennis Gilbert,D,BUF,28,19,0,0,0
5,8481585,Egor Afanasyev,L,SJS,23,11,0,0,0
5,8475780,Chris Wagner,R,COL,33,5,0,0,0
5,8481806,Louis Crevier,D,CHI,23,20,0,0,0
5,8482094,Daemon Hunt,D,MIN,22,11,0,0,0
5,8481462,Mason Morelli,L,VGK,28,10,0,0,0
5,8482126,Emil Andrae,D,PHI,31,1,0,0,0
5,8480874,Adam Ginning,D,PHI,24,11,0,0,0
5,8484255,Jason Polin,R,COL,25,8,0,0,0
5,8482102,Vasily Ponomarev,C,PIT,22,16,0,0,0
5,8482460,Matt Rempe,C,NYR,22,9,0,0,0
5,8478011,Louie Belpedio,D,PHI,28,14,0,0,0
5,8479522,Hardy Haman Aktell,D,WSH,26,2,0,0,0
5,8482476,Emil Heineman,L,MTL,23,7,0,0,0
5,8480823,Alexander Alexeyev,D,WSH,25,16,0,0,0
5,8483597,Milos Kelemen,L,UTA,25,13,0,0,0
5,8478147,Bokondji Imama,L,PIT,28,6,0,0,0
5,8483920,Pierrick Dube,R,WSH,23,1,0,0,0
5,8476323,Max McCormick,L,SEA,32,2,0,0,0
5,8479421,Jacob Moverare,D,LAK,26,7,0,0,0
5,8483398,Declan Carlile,D,TBL,31,4,0,0,0
5,8483609,Adam Klapka,R,CGY,24,5,0,0,0
5,8477993,Justin Kirkland,C,CGY,28,5,0,0,0
5,8480306,Grant Hutton,D,NYI,29,4,0,0,0
5,8483531,Brian Halonen,L,NJD,25,4,0,0,0
5,8470794,Joe Pavelski,C,,40,0,0,0,0
5,8479321,Lucas Johansen,D,,27,0,0,0,0
5,8477950,Tony DeAngelo,D,,29,0,0,0,0
5,8471218,Blake Wheeler,R,,38,0,0,0,0
5,8475197,Tyson Barrie,D,,33,0,0,0,0
5,8474157,Max Pacioretty,L,,36,0,0,0,0
5,8475744,Evgeny Kuznetsov,C,,32,0,0,0,0
5,8474037,James van Riemsdyk,L,,35,0,0,0,0
5,8476907,Mackenzie MacEachern,L,,30,0,0,0,0
5,8480216,Jacob Peterson,C,,25,0,0,0,0
5,8474602,Justin Schultz,D,,34,0,0,0,0
5,8482222,Alexander Barabanov,L,,30,0,0,0,0
5,8474031,Kevin Shattenkirk,D,,35,0,0,0,0
5,8477330,Dominik Kubalik,L,,29,0,0,0,0
5,8480884,Calen Addison,D,,24,0,0,0,0
5,8475906,John Klingberg,D,,32,0,0,0,0
5,8480008,Adam Ruzicka,C,,25,0,0,0,0
5,8476884,Derrick Pouliot,D,,30,0,0,0,0
5,8476919,Chris Tierney,C,,30,0,0,0,0
5,8479415,Michael McLeod,C,,26,0,0,0,0
5,8474870,Tyler Johnson,C,,34,0,0,0,0
5,8470604,Jeff Carter,C,,39,0,0,0,0
5,8478104,Sammy Blais,L,,28,0,0,0,0
5,8474884,Mike Hoffman,C,,35,0,0,0,0
5,8481591,Sam Poulin,R,,23,0,0,0,0
5,8471274,Alex Goligoski,D,,39,0,0,0,0
5,8476871,Tanner Pearson,L,,32,0,0,0,0
5,8476393,Nick Cousins,C,,31,0,0,0,0
5,8479977,Kailer Yamamoto,R,,26,0,0,0,0
5,8479346,Dillon Dube,C,,26,0,0,0,0
5,8480184,Gustav Lindstrom,D,,26,0,0,0,0
5,8479376,Victor Mete,D,,26,0,0,0,0
5,8473449,Kyle Okposo,R,,36,0,0,0,0
5,8481058,Jesse Ylonen,R,,25,0,0,0,0
5,8475752,Tyler Pitlick,C,,33,0,0,0,0
5,8481239,Samuel Fagemo,L,,24,0,0,0,0
5,8480821,Filip Zadina,R,,25,0,0,0,0
5,8470966,Mark Giordano,D,,41,0,0,0,0
5,8478495,Denis Gurianov,R,,27,0,0,0,0
5,8477464,Nic Petan,C,,29,0,0,0,0
5,8478099,Kevin Labanc,R,,29,0,0,0,0
5,8482241,Radim Zohorna,L,,28,0,0,0,0
5,8474040,Sam Gagner,C,,35,0,0,0,0
5,8479514,Rem Pitlick,C,,27,0,0,0,0
5,8478430,Oliver Kylington,D,,27,0,0,0,0
5,8479533,Joona Koppanen,L,,26,0,0,0,0
5,8479984,Cal Foote,D,,26,0,0,0,0
5,8477126,Jayson Megna,C,,34,0,0,0,0
5,8475164,Jakob Silfverberg,R,,34,0,0,0,0
5,8474009,Nick Bonino,C,,36,0,0,0,0
5,8479458,Nikita Zaitsev,D,,33,0,0,0,0
5,8477944,Jakub Vrana,L,,28,0,0,0,0
5,8471699,Andrew Cogliano,C,,37,0,0,0,0
5,8478067,Oskar Lindblom,L,,28,0,0,0,0
5,8471686,Marc Staal,D,,37,0,0,0,0
5,8470610,Zach Parise,L,,40,0,0,0,0
5,8478904,Steven Lorentz,C,,28,0,0,0,0
5,8473473,Milan Lucic,L,,36,0,0,0,0
5,8480031,Maxime Comtois,L,,25,0,0,0,0
5,8478512,Austin Czarnik,C,,32,0,0,0,0
5,8473504,Cal Clutterbuck,R,,37,0,0,0,0
5,8477454,Adam Erne,L,,29,0,0,0,0
5,8479383,Boris Katchouk,L,,26,0,0,0,0
5,8475825,Jani Hakanpää,D,,32,0,0,0,0
5,8477846,Ryan Carpenter,C,,33,0,0,0,0
5,8477930,Pierre-Edouard Bellemare,L,,39,0,0,0,0
5,8478400,Colin White,C,,27,0,0,0,0
5,8480226,Marián Studenic,R,,26,0,0,0,0
5,8480853,Liam Foudy,C,,24,0,0,0,0
5,8475797,Jarred Tinordi,D,,32,0,0,0,0
5,8479423,Alex Nylander,L,,26,0,0,0,0
5,8474618,Marco Scandella,D,,34,0,0,0,0
5,8478028,Fredrik Olofsson,L,,28,0,0,0,0
5,8474709,Matt Martin,L,,35,0,0,0,0
5,8481070,Hugh McGing,L,,26,0,0,0,0
5,8479546,Oskar Steen,C,,26,0,0,0,0
5,8474145,Robert Bortuzzo,D,,35,0,0,0,0
5,8476915,Jujhar Khaira,L,,30,0,0,0,0
5,8480274,Philip Kemp,D,EDM,25,0,0,0,0
5,8484326,Patrik Koch,D,UTA,28,2,0,0,0
5,8484321,Nikolas Matinpalo,D,OTT,26,1,0,0,0
5,8475278,Byron Froese,C,,33,0,0,0,0
5,8481812,Nikolai Knyzhov,D,,27,0,0,0,0
5,8478408,Travis Dermott,D,,28,0,0,0,0
5,8481077,John Leonard,L,,26,0,0,0,0
5,8479547,Matthew Phillips,R,,26,0,0,0,0
5,8482197,Adam Raska,R,MIN,23,8,0,0,0
5,8480836,Jonathan Gruden,C,,24,0,0,0,0
5,8481690,Tyler Angle,C,,24,0,0,0,0
5,8475766,Austin Watson,L,,32,0,0,0,0
5,8481016,Ruslan Iskhakov,C,,24,0,0,0,0
5,8478078,Rourke Chartier,C,,28,0,0,0,0
5,8484259,Ondrej Pavel,C,COL,31,6,0,0,0
5,8483401,Marc Johnstone,R,PIT,28,1,0,0,0
5,8480776,Sheldon Rempal,R,,29,0,0,0,0
5,8478956,Samuel Laberge,L,NJD,27,2,0,0,0
5,8483432,Luca Del Bel Belluz,C,CBJ,31,3,0,0,0
5,8483045,Cameron Butler,R,CBJ,31,1,0,0,0
5,8481534,Raphael Lavoie,C,EDM,24,2,0,0,0
5,8484314,Jiri Smejkal,L,,28,0,0,0,0
6,8477492,Nathan MacKinnon,C,COL,29,82,63,97,160
6,8478483,Mitch Marner,R,TOR,27,79,48,87,135
6,8478402,Connor McDavid,C,EDM,27,79,42,86,128
6,8479318,Auston Matthews,C,TOR,27,80,70,56,126
6,8477956,David Pastrnak,R,BOS,28,80,62,59,121
6,8479314,Matthew Tkachuk,L,FLA,27,79,34,81,115
6,8476453,Nikita Kucherov,R,TBL,31,82,33,80,113
6,8480069,Cale Makar,D,COL,26,69,28,79,107
6,8478420,Mikko Rantanen,R,COL,28,82,43,63,106
6,8477934,Leon Draisaitl,C,EDM,29,75,43,63,106
6,8477939,William Nylander,R,TOR,28,80,49,56,105
6,8480027,Jason Robertson,L,DAL,25,82,40,63,103
6,8480023,Robert Thomas,C,STL,25,77,28,75,103
6,8475913,Mark Stone,R,VGK,32,77,44,58,102
6,8481559,Jack Hughes,C,NJD,23,80,33,62,95
6,8478550,Artemi Panarin,L,NYR,33,79,25,70,95
6,8478403,Jack Eichel,C,VGK,28,77,41,51,92
6,8477942,Kevin Fiala,L,LAK,28,81,29,63,92
6,8478864,Kirill Kaprizov,L,MIN,27,71,41,49,90
6,8476468,J.T. Miller,C,VAN,31,75,34,56,90
6,8476887,Filip Forsberg,L,NSH,30,68,47,42,89
6,8477933,Sam Reinhart,C,FLA,29,82,45,42,87
6,8480012,Elias Pettersson,C,VAN,26,78,43,44,87
6,8480801,Brady Tkachuk,L,OTT,25,82,40,46,86
6,8474564,Steven Stamkos,C,NSH,34,75,33,53,86
6,8476454,Ryan Nugent-Hopkins,C,EDM,31,80,35,50,85
6,8480208,Drake Batherson,R,OTT,26,80,28,57,85
6,8479385,Jordan Kyrou,C,STL,26,72,38,46,84
6,8482116,Tim Stützle,C,OTT,22,80,30,54,84
6,8471675,Sidney Crosby,C,PIT,37,74,35,48,83
6,8478445,Mathew Barzal,C,NYI,27,77,22,61,83
6,8479323,Adam Fox,D,NYR,26,80,18,65,83
6,8477409,Carter Verhaeghe,C,FLA,29,79,32,50,82
6,8480865,Noah Dobson,D,NYI,24,80,19,63,82
6,8477501,Valeri Nichushkin,R,COL,29,79,41,40,81
6,8477493,Aleksander Barkov,C,FLA,29,76,30,51,81
6,8482665,Matty Beniers,C,SEA,22,80,29,51,80
6,8478010,Brayden Point,C,TBL,28,82,47,32,79
6,8473419,Brad Marchand,L,BOS,36,78,32,47,79
6,8475692,Mats Zuccarello,R,MIN,37,72,27,52,79
6,8479420,Tage Thompson,C,BUF,27,73,39,39,78
6,8477955,Jared McCann,L,SEA,28,78,39,39,78
6,8475168,Matt Duchene,C,DAL,33,82,36,42,78
6,8477402,Pavel Buchnevich,L,STL,29,72,30,48,78
6,8476459,Mika Zibanejad,C,NYR,31,76,28,50,78
6,8476460,Mark Scheifele,C,WPG,31,76,37,40,77
6,8484144,Connor Bedard,C,CHI,19,61,35,42,77
6,8477946,Dylan Larkin,C,DET,28,82,28,49,77
6,8474578,Erik Karlsson,D,PIT,34,81,22,55,77
6,8474600,Roman Josi,D,NSH,34,74,17,60,77
6,8478398,Kyle Connor,L,WPG,28,74,37,39,76
6,8479542,Brandon Hagel,L,TBL,26,82,35,41,76
6,8478449,Roope Hintz,C,DAL,28,81,34,42,76
6,8479343,Clayton Keller,R,UTA,26,74,33,43,76
6,8478427,Sebastian Aho,C,CAR,27,75,30,46,76
6,8477404,Jake Guentzel,C,TBL,30,82,29,47,76
6,8479407,Jesper Bratt,L,NJD,26,76,23,53,76
6,8477960,Adrian Kempe,R,LAK,28,82,34,41,75
6,8481540,Cole Caufield,R,MTL,23,80,32,42,74
6,8475810,Bryan Rust,R,PIT,32,73,32,42,74
6,8476881,Tomas Hertl,C,VGK,31,75,31,43,74
6,8477940,Nikolaj Ehlers,L,WPG,28,74,28,46,74
6,8480800,Quinn Hughes,D,VAN,25,75,12,62,74
6,8475786,Zach Hyman,L,EDM,32,77,40,32,72
6,8475166,John Tavares,C,TOR,34,79,28,44,72
6,8471215,Evgeni Malkin,C,PIT,38,76,28,44,72
6,8471685,Anze Kopitar,C,LAK,37,82,20,52,72
6,8480036,Miro Heiskanen,D,DAL,25,77,14,58,72
6,8481557,Matt Boldy,L,MIN,23,76,33,38,71
6,8477416,Oliver Bjorkstrand,R,SEA,29,70,30,41,71
6,8480803,Evan Bouchard,D,EDM,25,77,14,57,71
6,8475754,Brock Nelson,C,NYI,33,82,42,28,70
6,8475794,Tyler Seguin,C,DAL,32,82,26,44,70
6,8480018,Nick Suzuki,C,MTL,25,73,19,51,70
6,8475172,Nazem Kadri,C,CGY,34,77,29,40,69
6,8477951,Nick Schmaltz,C,UTA,28,76,23,46,69
6,8474141,Patrick Kane,R,DET,36,76,22,47,69
6,8476905,Chandler Stephenson,C,SEA,30,75,19,50,69
6,8474590,John Carlson,D,WSH,34,72,11,58,69
6,8475151,Kyle Palmieri,C,NYI,33,81,34,34,68
6,8479337,Alex DeBrincat,R,DET,27,79,29,39,68
6,8476389,Vincent Trocheck,C,NYR,31,73,23,45,68
6,8476875,Mike Matheson,D,MTL,30,76,15,53,68
6,8479675,Trevor Moore,L,LAK,29,82,40,27,67
6,8473994,Jamie Benn,L,DAL,35,80,27,40,67
6,8475784,Jeff Skinner,C,EDM,32,77,38,28,66
6,8480002,Nico Hischier,C,NJD,25,75,34,32,66
6,8480830,Andrei Svechnikov,R,CAR,24,68,28,38,66
6,8479999,Casey Mittelstadt,C,COL,26,81,19,47,66
6,8478460,Zach Werenski,D,CBJ,27,79,15,51,66
6,8473512,Claude Giroux,R,OTT,36,78,28,37,65
6,8478975,Mason Marchment,L,DAL,29,79,20,44,64
6,8478439,Travis Konecny,R,PHI,27,74,33,30,63
6,8471214,Alex Ovechkin,L,WSH,39,73,29,34,63
6,8476539,Jonathan Marchessault,R,NSH,34,70,28,35,63
6,8482124,Quinton Byfield,R,LAK,22,79,21,42,63
6,8474150,Mikael Backlund,C,CGY,35,75,22,40,62
6,8477949,Alex Tuch,R,BUF,28,74,21,41,62
6,8478401,Pavel Zacha,C,BOS,27,76,21,41,62
6,8480839,Rasmus Dahlin,D,BUF,24,73,17,45,62
6,8477504,Josh Morrissey,D,WPG,29,73,17,45,62
6,8476853,Morgan Rielly,D,TOR,30,73,7,55,62
6,8482740,Wyatt Johnston,C,DAL,21,82,37,24,61
6,8476399,Blake Coleman,C,CGY,33,78,27,34,61
6,8478440,Dylan Strome,C,WSH,27,71,21,40,61
6,8475184,Chris Kreider,L,NYR,33,70,33,27,60
6,8477500,Bo Horvat,C,NYI,29,77,32,28,60
6,8477476,Artturi Lehkonen,L,COL,29,79,31,29,60
6,8482699,Dylan Guenther,R,UTA,21,78,24,36,60
6,8475167,Victor Hedman,D,TBL,34,78,19,41,60
6,8478047,Michael Bunting,L,PIT,29,73,29,30,59
6,8478038,Devon Toews,D,COL,30,73,13,46,59
6,8478498,Jake DeBrusk,L,VAN,28,72,27,31,58
6,8477451,Ryan Hartman,R,MIN,30,72,27,31,58
6,8482093,Seth Jarvis,C,CAR,22,74,23,35,58
6,8475158,Ryan O'Reilly,C,NSH,33,76,17,41,58
6,8479525,Ross Colton,C,COL,28,80,31,26,57
6,8477496,Elias Lindholm,C,BOS,30,79,22,35,57
6,8476448,William Karlsson,C,VGK,31,71,19,38,57
6,8475745,Charlie Coyle,C,BOS,32,76,19,38,57
6,8478873,Troy Terry,R,ANA,27,73,19,38,57
6,8478407,Vince Dunn,D,SEA,28,73,11,46,57
6,8476346,Johnny Gaudreau,L,CBJ,31,72,11,45,56
6,8482113,Anton Lundell,C,FLA,23,76,23,32,55
6,8475765,Vladimir Tarasenko,R,DET,33,81,19,36,55
6,8478414,Timo Meier,R,NJD,28,72,16,39,55
6,8483515,Juraj Slafkovsky,L,MTL,20,76,26,28,54
6,8480015,Owen Tippett,R,PHI,25,73,25,29,54
6,8474102,David Perron,L,OTT,36,76,23,31,54
6,8483808,Andrei Kuzmenko,L,CGY,28,78,22,32,54
6,8476479,Phillip Danault,C,LAK,31,78,21,33,54
6,8482109,Alexis Lafrenière,L,NYR,23,76,23,30,53
6,8478444,Brock Boeser,R,VAN,27,75,21,32,53
6,8477935,Sam Bennett,C,FLA,28,78,19,34,53
6,8475798,Mikael Granlund,C,SJS,32,68,19,34,53
6,8477494,Jonathan Drouin,L,COL,29,82,16,37,53
6,8477021,Alex Kerfoot,C,UTA,30,76,13,40,53
6,8483431,Logan Cooley,C,UTA,20,73,23,29,52
6,8475191,Reilly Smith,R,NYR,33,75,21,31,52
6,8479425,Filip Hronek,D,VAN,27,79,13,39,52
6,8476432,Boone Jenner,C,CBJ,31,66,36,15,51
6,8477964,Ivan Barbashev,C,VGK,29,76,25,26,51
6,8478493,Joel Eriksson Ek,C,MIN,27,62,23,28,51
6,8482110,Dawson Mercer,C,NJD,23,73,23,28,51
6,8475170,Brayden Schenn,C,STL,33,73,17,34,51
6,8477998,Warren Foegele,L,LAK,28,79,15,36,51
6,8478397,Rasmus Andersson,D,CGY,28,77,7,44,51
6,8484166,Adam Fantilli,C,CBJ,20,67,23,27,50
6,8481528,Dylan Cozens,C,BUF,23,70,22,28,50
6,8476882,Teuvo Teravainen,C,CHI,30,75,21,29,50
6,8478458,John (Jack) Roslovic,C,CAR,27,73,20,30,50
6,8477986,Brandon Montour,D,SEA,30,72,12,38,50
6,8481581,Thomas Harley,D,DAL,23,77,11,39,50
6,8477479,Tyler Bertuzzi,L,CHI,29,69,21,28,49
6,8481711,Matias Maccelli,L,UTA,24,73,18,31,49
6,8481596,Shane Pinto,C,OTT,24,76,17,32,49
6,8478469,Thomas Chabot,D,OTT,27,78,13,36,49
6,8476880,Tom Wilson,R,WSH,30,68,24,24,48
6,8478462,Nicolas Roy,C,VGK,27,75,23,25,48
6,8481533,Trevor Zegras,C,ANA,23,65,18,30,48
6,8484145,Zach Benson,L,BUF,19,64,18,30,48
6,8477932,Aaron Ekblad,D,FLA,28,75,18,30,48
6,8477511,Anthony Mantha,R,CGY,30,75,17,31,48
6,8476872,Scott Laughton,C,PHI,30,73,17,31,48
6,8476456,Jonathan Huberdeau,C,CGY,31,75,12,36,48
6,8471724,Kris Letang,D,PIT,37,77,9,39,48
6,8481542,Moritz Seider,D,DET,23,78,6,42,48
6,8482684,Luke Hughes,D,NJD,21,69,5,43,48
6,8478366,Frank Vatrano,R,ANA,30,72,22,25,47
6,8482078,Lucas Raymond,L,DET,22,80,20,27,47
6,8477503,Max Domi,C,TOR,29,79,18,29,47
6,8484153,Leo Carlsson,C,ANA,20,71,16,31,47
6,8474679,Gustav Nyquist,C,NSH,35,75,14,33,47
6,8477456,J.T. Compher,L,DET,29,80,25,21,46
6,8478856,Conor Garland,R,VAN,28,70,21,25,46
6,8475760,Nick Bjugstad,C,UTA,32,73,19,27,46
6,8480039,Martin Necas,C,CAR,25,68,15,31,46
6,8480064,Josh Norris,C,OTT,25,71,32,13,45
6,8481068,Yegor Sharangovich,C,CGY,26,79,24,21,45
6,8475763,Kevin Hayes,R,PIT,32,66,16,29,45
6,8477447,Shea Theodore,D,VGK,29,59,9,36,45
6,8480145,Neal Pionk,D,WPG,29,74,7,38,45
6,8482745,Mason McTavish,C,ANA,21,74,21,23,44
6,8476462,Dougie Hamilton,D,NJD,31,66,19,25,44
6,8475714,Calle Jarnkrok,C,TOR,33,73,19,25,44
6,8477444,Andre Burakovsky,L,SEA,29,68,14,30,44
6,8480434,Sean Durzi,D,UTA,26,67,9,35,44
6,8478396,Noah Hanifin,D,VGK,27,62,8,36,44
6,8476958,Jaccob Slavin,D,CAR,30,74,8,36,44
6,8480014,Gabriel Vilardi,C,WPG,25,62,26,17,43
6,8481186,Logan O'Connor,R,COL,28,75,22,21,43
6,8471698,T.J. Oshie,R,WSH,38,67,19,24,43
6,8477429,Andrew Copp,C,DET,30,75,17,26,43
6,8479345,Jakob Chychrun,D,WSH,26,63,16,27,43
6,8480798,Philipp Kurashev,C,CHI,25,65,13,30,43
6,8477495,Seth Jones,D,CHI,30,69,8,35,43
6,8481618,Alex Newhook,C,MTL,23,69,23,19,42
6,8475169,Evander Kane,L,EDM,33,73,21,21,42
6,8478519,Anthony Cirelli,C,TBL,27,82,17,25,42
6,8476826,Yanni Gourde,C,SEA,33,70,16,26,42
6,8478042,Viktor Arvidsson,L,EDM,31,76,13,29,42
6,8479410,Mikhail Sergachev,D,UTA,26,72,3,39,42
6,8480849,Barrett Hayton,C,UTA,24,71,20,21,41
6,8482146,Luke Evangelista,R,NSH,22,70,20,21,41
6,8474586,Jordan Eberle,R,SEA,34,75,19,22,41
6,8475726,Tyler Toffoli,C,SJS,32,68,17,24,41
6,8477407,Anthony Duclair,L,NYI,29,76,17,24,41
6,8482097,Jack Quinn,R,BUF,23,65,14,27,41
6,8481703,Valtteri Puustinen,R,PIT,25,63,6,35,41
6,8476438,Brandon Saad,L,STL,32,66,21,19,40
6,8482475,Yegor Chinakhov,R,CBJ,23,58,21,19,40
6,8476483,Rickard Rakell,R,PIT,31,70,19,21,40
6,8480188,Fabian Zetterlund,L,SJS,25,71,16,24,40
6,8478233,Andrew Mangiapane,L,WSH,28,68,16,24,40
6,8481560,Arthur Kaliyev,R,LAK,23,81,15,25,40
6,8478115,Pierre Engvall,L,NYI,28,76,14,26,40
6,8476792,Torey Krug,D,STL,33,67,13,27,40
6,8474565,Alex Pietrangelo,D,VGK,34,64,12,28,40
6,8470613,Brent Burns,D,CAR,39,76,8,32,40
6,8482712,Oskar Olausson,R,COL,22,77,7,33,40
6,8483524,Shane Wright,C,SEA,20,61,22,17,39
6,8473986,Alex Killorn,L,ANA,35,70,21,18,39
6,8481604,Pavel Dorofeyev,L,VGK,24,67,20,19,39
6,8474641,Adam Henrique,C,EDM,34,74,16,23,39
6,8481656,Aliaksei Protas,C,WSH,23,64,16,23,39
6,8476925,Colton Sissons,C,NSH,31,72,14,25,39
6,8483490,Pavel Mintyukov,D,ANA,21,72,10,29,39
6,8475793,Ryan Johansen,C,PHI,32,73,19,19,38
6,8479293,Brandon Tanev,L,SEA,33,63,19,19,38
6,8475722,Jason Zucker,L,BUF,32,72,17,21,38
6,8482702,Logan Stankoven,C,DAL,21,79,17,21,38
6,8482667,William Eklund,L,SJS,22,69,14,24,38
6,8480113,Alex Iafallo,L,WPG,31,57,14,24,38
6,8477497,Sean Monahan,C,CBJ,30,66,13,25,38
6,8480028,Morgan Frost,C,PHI,25,75,12,26,38
6,8476906,Shayne Gostisbehere,D,CAR,31,80,11,27,38
6,8477346,MacKenzie Weegar,D,CGY,30,74,8,30,38
6,8476981,Josh Anderson,R,MTL,30,71,21,16,37
6,8482175,JJ Peterka,R,BUF,22,65,20,17,37
6,8478474,Lawson Crouse,L,UTA,27,78,18,19,37
6,8479987,Morgan Geekie,C,BOS,26,78,17,20,37
6,8479400,Pierre-Luc Dubois,L,WSH,26,72,14,23,37
6,8480220,Noah Cates,L,PHI,25,76,13,24,37
6,8482149,Cole Perfetti,C,WPG,22,72,12,25,37
6,8478438,Tommy Novak,C,NSH,27,74,11,26,37
6,8482720,Matthew Knies,L,TOR,22,78,7,30,37
6,8475764,Cam Fowler,D,ANA,33,73,4,33,37
6,8480829,Jesperi Kotkaniemi,C,CAR,24,67,19,17,36
6,8480185,Eetu Luostarinen,C,FLA,26,75,18,18,36
6,8476419,Jean-Gabriel Pageau,C,NYI,32,76,14,22,36
6,8480817,K'Andre Miller,D,NYR,24,70,12,24,36
6,8478046,Danton Heinen,L,VAN,29,67,12,24,36
6,8476923,Damon Severson,D,CBJ,30,82,6,30,36
6,8482089,Jake Neighbours,L,STL,22,71,27,8,35
6,8478020,Michael Amadio,R,OTT,28,71,17,18,35
6,8481523,Kirby Dach,C,MTL,23,71,16,19,35
6,8478472,Mathieu Joseph,R,STL,27,71,15,20,35
6,8474149,Evgenii Dadonov,R,DAL,35,81,15,20,35
6,8480797,Joel Farabee,L,PHI,24,74,14,21,35
6,8482159,Tyson Foerster,R,PHI,22,66,12,23,35
6,8477505,Alexander Wennberg,C,SJS,30,65,12,23,35
6,8475287,Erik Haula,L,NJD,33,74,11,24,35
6,8482092,Ridly Greig,C,OTT,22,72,8,27,35
6,8478055,Gustav Forsling,D,FLA,28,74,7,28,35
6,8477498,Darnell Nurse,D,EDM,29,73,6,29,35
6,8479325,Charlie McAvoy,D,BOS,27,72,4,31,35
6,8475314,Anders Lee,L,NYI,34,80,19,15,34
6,8475799,Nino Niederreiter,R,WPG,32,69,17,17,34
6,8475848,Brendan Gallagher,R,MTL,32,68,17,17,34
6,8480009,Eeli Tolvanen,R,SEA,25,72,14,20,34
6,8478891,Mason Appleton,C,WPG,28,65,14,20,34
6,8482133,Thomas Bordeleau,C,SJS,22,66,11,23,34
6,8473422,Nick Foligno,L,CHI,37,64,9,25,34
6,8476457,Adam Larsson,D,SEA,32,69,9,25,34
6,8477426,Nicholas Paul,L,TBL,29,82,19,14,33
6,8481554,Kaapo Kakko,R,NYR,23,72,19,14,33
6,8476461,Sean Couturier,C,PHI,32,69,16,17,33
6,8479393,Noah Gregor,L,OTT,26,71,16,17,33
6,8477952,Robby Fabbri,C,ANA,28,72,16,17,33
6,8476458,Ryan Strome,C,ANA,31,71,13,20,33
6,8482660,Kent Johnson,C,CBJ,22,61,13,20,33
6,8478466,Daniel Sprong,R,VAN,27,67,12,21,33
6,8482105,Jake Sanderson,D,OTT,22,79,12,21,33
6,8475218,Mattias Ekholm,D,EDM,34,69,10,23,33
6,8476869,Brady Skjei,D,NSH,30,68,9,24,33
6,8480871,Adam Boqvist,D,FLA,24,68,9,24,33
6,8479365,Trent Frederic,C,BOS,26,76,17,15,32
6,8482079,Marco Rossi,C,MIN,23,65,17,15,32
6,8478109,Victor Olofsson,L,VGK,29,68,16,16,32
6,8478413,Jordan Greenway,L,BUF,27,72,15,17,32
6,8474715,Cameron Atkinson,R,TBL,35,80,15,17,32
6,8478542,Evan Rodrigues,C,FLA,31,79,13,19,32
6,8480336,Sean Walker,D,CAR,30,72,12,20,32
6,8476392,Adam Lowry,C,WPG,31,67,11,21,32
6,8480802,Ryan McLeod,C,BUF,25,66,11,21,32
6,8479353,Brett Howden,C,VGK,26,63,9,23,32
6,8479351,Sam Steel,C,DAL,26,80,11,20,31
6,8476331,Dylan DeMelo,D,WPG,31,72,9,22,31
6,8477948,Travis Sanheim,D,PHI,28,72,8,23,31
6,8478057,Dakota Joshua,C,VAN,28,63,18,12,30
6,8481535,Nils Hoglander,L,VAN,24,66,14,16,30
6,8481624,Ilya Mikheyev,R,CHI,30,62,14,16,30
6,8480078,Filip Chytil,C,NYR,25,72,13,17,30
6,8476480,Vladislav Namestnikov,C,WPG,32,67,13,17,30
6,8481093,Rafael Harvey-Pinard,L,MTL,25,61,13,17,30
6,8481577,Philip Tomasino,C,NSH,23,67,12,18,30
6,8476474,Stefan Noesen,R,NJD,31,69,12,18,30
6,8484203,Bradly Nadeau,L,CAR,19,70,12,18,30
6,8479315,Joey Anderson,R,CHI,26,47,12,18,30
6,8475768,Jaden Schwartz,C,SEA,32,71,11,19,30
6,8477220,Nate Schmidt,D,FLA,33,69,9,21,30
6,8474563,Drew Doughty,D,LAK,35,67,7,23,30
6,8482122,Brock Faber,D,MIN,22,81,5,25,30
6,8476463,Jonas Brodin,D,MIN,31,78,3,27,30
6,8480873,Rasmus Sandin,D,WSH,24,64,3,27,30
6,8478463,Anthony Beauvillier,L,PIT,27,62,16,13,29
6,8483457,Lane Hutson,D,MTL,20,68,13,16,29
6,8480835,Jack Drury,C,CAR,24,57,12,17,29
6,8481524,Bowen Byram,D,BUF,23,67,12,17,29
6,8482671,Owen Power,D,BUF,22,71,11,18,29
6,8475200,Dmitry Orlov,D,CAR,33,78,9,20,29
6,8483505,Matthew Poitras,C,BOS,20,76,9,20,29
6,8476897,Oskar Sundqvist,C,STL,30,64,8,21,29
6,8474053,Logan Couture,C,SJS,35,56,6,23,29
6,8480043,Timothy Liljegren,D,TOR,25,70,3,26,29
6,8474673,TJ Brodie,D,CHI,34,66,2,27,29
6,8476918,Jimmy Vesey,L,NYR,31,72,19,9,28
6,8476292,Ondrej Palat,L,NJD,33,61,15,13,28
6,8482101,Danil Gushchin,L,SJS,22,57,15,13,28
6,8479339,Patrik Laine,L,CBJ,26,61,14,14,28
6,8479591,Michael Eyssimont,C,TBL,28,82,14,14,28
6,8476329,Travis Boyd,C,MIN,31,62,13,15,28
6,8480003,Jesper Boqvist,C,FLA,26,70,11,17,28
6,8479661,Tanner Jeannot,L,LAK,27,76,10,18,28
6,8476374,Sean Kuraly,C,CBJ,31,59,9,19,28
6,8477969,Marcus Pettersson,D,PIT,28,79,8,20,28
6,8474189,Lars Eller,C,PIT,35,65,8,20,28
6,8477507,Nikita Zadorov,D,BOS,29,71,7,21,28
6,8477506,Ryan Pulock,D,NYI,30,77,5,23,28
6,8476917,Adam Pelech,D,NYI,30,76,3,25,28
6,8478500,Ivan Provorov,D,CBJ,27,79,2,26,28
6,8477987,Ryan Donato,C,CHI,28,56,14,13,27
6,8480205,Emil Bemstrom,C,PIT,25,61,13,14,27
6,8477839,Conor Sheary,L,TBL,32,80,11,16,27
6,8482111,Justin Barron,D,MTL,23,61,11,16,27
6,8475791,Taylor Hall,L,CHI,33,61,6,21,27
6,8474151,Ryan McDonagh,D,TBL,35,75,6,21,27
6,8482655,Janis Moser,D,TBL,24,80,4,23,27
6,8475181,Nick Leddy,D,STL,33,66,2,25,27
6,8479390,Taylor Raddysh,R,WSH,26,63,17,9,26
6,8482125,Alexander Holtz,R,VGK,22,71,15,11,26
6,8480459,Pius Suter,C,VAN,28,65,13,13,26
6,8479992,Michael Rasmussen,C,DET,25,77,13,13,26
6,8479996,Cody Glass,C,NSH,25,62,11,15,26
6,8480855,Jack McBain,C,UTA,24,65,10,16,26
6,8482803,Olen Zellweger,D,ANA,21,66,10,16,26
6,8480448,Parker Kelly,L,COL,25,79,10,16,26
6,8475149,Marcus Johansson,L,MIN,34,68,9,17,26
6,8475343,Nic Dowd,C,WSH,34,65,8,18,26
6,8482117,Lukas Reichel,L,CHI,22,52,7,19,26
6,8478133,Jake Evans,C,MTL,28,66,6,20,26
6,8479402,Jake Bean,D,CGY,26,68,3,23,26
6,8479619,Michael Carcone,L,UTA,28,61,18,7,25
6,8476278,Colin Blackwell,C,DAL,31,75,18,7,25
6,8482259,Bobby McMann,C,TOR,28,61,14,11,25
6,8473533,Jordan Staal,C,CAR,36,61,13,12,25
6,8478508,Yakov Trenin,C,MIN,27,60,12,13,25
6,8481481,Blake Lizotte,C,PIT,27,59,11,14,25
6,8477450,Jason Dickinson,C,CHI,29,56,11,14,25
6,8475231,Casey Cizikas,C,NYI,33,69,9,16,25
6,8475193,Tomas Tatar,L,NJD,34,67,8,17,25
6,8477478,William Carrier,L,CAR,30,55,8,17,25
6,8483499,Liam Ohgren,L,MIN,20,58,8,17,25
6,8476885,Jacob Trouba,D,NYR,30,69,7,18,25
6,8477919,Frederick Gaudreau,C,MIN,31,56,7,18,25
6,8482142,Jamie Drysdale,D,PHI,22,68,7,18,25
6,8482624,Daniil Miromanov,D,CGY,27,58,6,19,25
6,8477015,Connor Brown,R,EDM,30,66,6,19,25
6,8478882,Vladislav Gavrikov,D,LAK,29,64,6,19,25
6,8479398,Samuel Girard,D,COL,26,64,5,20,25
6,8479976,Juuso Valimaki,D,UTA,26,67,4,21,25
6,8478911,Matt Roy,D,WSH,29,61,4,21,25
6,8476467,Jamie Oleksiak,D,SEA,32,67,4,21,25
6,8480891,Michael Kesselring,D,UTA,24,55,3,22,25
6,8481546,Cam York,D,PHI,23,61,2,23,25
6,8476960,Andreas Athanasiou,C,CHI,30,44,16,8,24
6,8482055,Drew O'Connor,L,PIT,26,71,14,10,24
6,8477903,Garnet Hathaway,R,PHI,33,70,14,10,24
6,8481582,Nicholas Robertson,L,TOR,23,68,12,12,24
6,8477953,Kasperi Kapanen,R,STL,28,70,11,13,24
6,8480813,Joe Veleno,C,DET,24,76,10,14,24
6,8475220,Marcus Foligno,L,MIN,33,63,9,15,24
6,8475753,Justin Faulk,D,STL,32,72,7,17,24
6,8478136,Jake Middleton,D,MIN,28,74,5,19,24
6,8476931,Jake McCabe,D,TOR,31,62,4,20,24
6,8479998,Mikey Anderson,D,LAK,25,61,4,20,24
6,8477435,Ryan Graves,D,PIT,29,77,3,21,24
6,8478178,Darren Raddysh,D,TBL,28,67,1,23,24
6,8481580,Connor McMichael,C,WSH,23,62,13,10,23
6,8482705,Cole Sillinger,C,CBJ,21,74,12,11,23
6,8477392,Hudson Fasching,R,NYI,29,65,11,12,23
6,8476927,Teddy Blueger,C,VAN,30,64,9,14,23
6,8480806,Isac Lundestrom,C,ANA,25,67,6,17,23
6,8478970,Jalen Chatfield,D,CAR,28,67,6,17,23
6,8477989,Christian Dvorak,C,MTL,28,60,6,17,23
6,8476979,Erik Gustafsson,D,DET,32,77,5,18,23
6,8476902,Esa Lindell,D,DAL,30,72,4,19,23
6,8475855,Jesper Fast,R,CAR,33,63,4,19,23
6,8482245,Artem Zub,D,OTT,29,65,3,20,23
6,8481014,Alexander Romanov,D,NYI,24,76,3,20,23
6,8480878,Nils Lundkvist,D,DAL,24,70,2,21,23
6,8479941,Justin Danforth,R,CBJ,31,65,14,8,22
6,8481032,Paul Cotter,C,NJD,25,60,13,9,22
6,8480068,Ryan Poehling,C,PHI,25,66,11,11,22
6,8477425,Miles Wood,L,COL,29,81,9,13,22
6,8475171,Oliver Ekman-Larsson,D,TOR,33,70,9,13,22
6,8483565,Nick Blankenburg,D,NSH,26,68,8,14,22
6,8480157,Calle Rosen,D,COL,30,57,7,15,22
6,8475324,Nick Jensen,D,OTT,34,64,6,16,22
6,8479368,Max Jones,L,BOS,26,68,6,16,22
6,8481606,Jordan Spence,D,LAK,23,66,5,17,22
6,8480049,Dylan Samberg,D,WPG,25,69,4,18,22
6,8479982,Conor Timmins,D,TOR,26,61,3,19,22
6,8473507,Jeff Petry,D,DET,37,70,3,19,22
6,8482157,Will Cuylle,L,NYR,22,58,14,7,21
6,8478569,Noel Acciari,C,PIT,33,56,10,11,21
6,8477353,Tyler Motte,C,DET,29,77,10,11,21
6,8473563,Nicklas Backstrom,C,WSH,37,55,9,12,21
6,8480252,Cole Guttman,C,CHI,25,43,9,12,21
6,8481704,Juuso Parssinen,C,NSH,23,55,7,14,21
6,8479543,Michael Pezzetta,L,MTL,26,58,5,16,21
6,8480035,Henri Jokiharju,D,BUF,25,61,4,17,21
6,8480172,Jan Rutta,D,SJS,34,63,4,17,21
6,8478013,Jake Walman,D,SJS,28,67,3,18,21
6,8480748,Kiefer Sherwood,L,VAN,29,59,3,18,21
6,8480073,Erik Brannstrom,D,COL,25,58,3,18,21
6,8480893,Kirill Marchenko,R,CBJ,24,53,13,7,20
6,8479671,Mathieu Olivier,R,CBJ,27,51,11,9,20
6,8480995,Pontus Holmberg,R,TOR,25,65,10,10,20
6,8481553,Bobby Brink,R,PHI,23,59,9,11,20
6,8479359,Beck Malenstyn,L,BUF,26,51,8,12,20
6,8478434,Keegan Kolesar,R,VGK,27,68,7,13,20
6,8480789,Oliver Wahlstrom,R,NYI,24,66,6,14,20
6,8474716,Jared Spurgeon,D,MIN,35,74,4,16,20
6,8474574,Tyler Myers,D,VAN,34,67,4,16,20
6,8483468,Jiri Kulich,C,BUF,20,60,3,17,20
6,8476892,Colton Parayko,D,STL,31,69,2,18,20
6,8482087,Kaiden Guhle,D,MTL,22,67,2,18,20
6,8482073,Braden Schneider,D,NYR,23,64,2,18,20
6,8480246,Nick Perbix,D,TBL,26,67,2,18,20
6,8480807,Mattias Samuelsson,D,BUF,24,64,2,18,20
6,8481178,Egor Zamula,D,PHI,24,49,1,19,20
6,8479066,Ryan Lomberg,L,CGY,30,65,14,5,19
6,8482074,Connor Zary,C,CGY,23,60,10,9,19
6,8478432,Christian Fischer,R,DET,27,71,10,9,19
6,8478421,A.J. Greer,L,FLA,28,61,10,9,19
6,8483482,Tristan Luneau,D,ANA,20,65,10,9,19
6,8475225,Craig Smith,C,CHI,35,53,9,10,19
6,8483493,Frank Nazar,C,CHI,20,52,8,11,19
6,8482749,Joshua Roy,R,MTL,21,65,7,12,19
6,8479316,Luke Kunin,C,SJS,27,54,7,12,19
6,8477488,Brett Pesce,D,NJD,30,68,6,13,19
6,8477947,Sonny Milano,L,WSH,28,62,6,13,19
6,8481019,David Gustafsson,C,WPG,24,48,6,13,19
6,8480058,Pierre-Olivier Joseph,D,STL,25,58,5,14,19
6,8479639,Dylan Coghlan,D,WPG,26,57,4,15,19
6,8482451,Mikael Pyyhtia,L,CBJ,23,47,3,16,19
6,8481059,Scott Perunovich,D,STL,26,60,3,16,19
6,8481477,Nico Sturm,C,SJS,29,53,12,6,18
6,8477380,Jonny Brodzinski,C,NYR,31,51,10,8,18
6,8480762,Eric Robinson,L,CAR,29,51,9,9,18
6,8475842,Sam Carrick,C,NYR,32,54,9,9,18
6,8482062,Cole Smith,L,NSH,29,56,8,10,18
6,8477406,Mattias Janmark,C,EDM,32,64,7,11,18
6,8479344,Jesse Puljujarvi,R,PIT,26,52,7,11,18
6,8483491,Ivan Miroshnichenko,L,WSH,20,53,7,11,18
6,8482809,Jackson Blake,R,CAR,21,55,6,12,18
6,8484149,Gavin Brindley,C,CBJ,20,56,4,14,18
6,8481521,Ronnie Attard,D,PHI,25,58,3,15,18
6,8479980,Nicolas Hague,D,VGK,26,60,3,15,18
6,8475233,David Savard,D,MTL,34,65,3,15,18
6,8476525,Colin Miller,D,WPG,32,60,2,16,18
6,8482067,Connor Mackey,D,NYR,28,62,2,16,18
6,8479026,Philippe Myers,D,TOR,27,49,2,16,18
6,8476988,Matt Benning,D,SJS,30,65,2,16,18
6,8476854,Hampus Lindholm,D,BOS,30,68,1,17,18
6,8479336,Carl Grundstrom,R,SJS,27,60,13,4,17
6,8481601,Simon Holmstrom,R,NYI,23,66,12,5,17
6,8477070,Liam O'Brien,C,UTA,30,47,11,6,17
6,8480281,Alexey Toropchenko,R,STL,25,57,9,8,17
6,8479983,Mario Ferraro,D,SJS,26,68,8,9,17
6,8476921,Jordan Martinook,L,CAR,32,62,8,9,17
6,8477573,Nathan Walker,L,STL,30,50,8,9,17
6,8479718,Alex Barré-Boulet,C,MTL,27,50,8,9,17
6,8474034,Patrick Maroon,L,CHI,36,51,7,10,17
6,8477401,John Hayden,C,SEA,29,33,7,10,17
6,8483445,Cutter Gauthier,L,ANA,20,61,6,11,17
6,8482964,Arber Xhekaj,D,MTL,23,43,6,11,17
6,8481522,Peyton Krebs,C,BUF,23,59,6,11,17
6,8475179,Dmitry Kulikov,D,FLA,34,64,6,11,17
6,8477979,Nicolas Aube-Kubel,R,BUF,28,54,4,13,17
6,8477499,Rasmus Ristolainen,D,PHI,30,73,4,13,17
6,8481567,Henry Thrun,D,SJS,23,54,4,13,17
6,8479986,Kole Lind,R,DAL,26,56,4,13,17
6,8480144,David Kampf,C,TOR,29,67,3,14,17
6,8479414,Nathan Bastian,R,NJD,27,65,11,5,16
6,8480980,Connor Dewar,C,TOR,25,65,8,8,16
6,8480289,Morgan Barron,C,WPG,26,53,7,9,16
6,8476878,Zemgus Girgensons,C,TBL,30,81,7,9,16
6,8480074,Alexandre Texier,C,STL,25,56,7,9,16
6,8482192,Isaak Phillips,D,CHI,23,48,5,11,16
6,8480222,Sebastian Aho,D,PIT,28,72,5,11,16
6,8476856,Mathew Dumba,D,DAL,30,73,4,12,16
6,8477018,Ben Hutton,D,VGK,31,48,4,12,16
6,8479439,Jacob MacDonald,D,COL,31,46,3,13,16
6,8476312,Josh Manson,D,COL,33,59,3,13,16
6,8478507,John Marino,D,UTA,27,68,2,14,16
6,8476422,Mike Reilly,D,NYI,31,71,2,14,16
6,8474567,Zach Bogosian,D,MIN,34,63,2,14,16
6,8475208,Brian Dumoulin,D,ANA,33,62,0,16,16
6,8476889,Radek Faksa,C,STL,30,60,8,7,15
6,8481028,Martin Pospisil,C,CGY,25,54,8,7,15
6,8481013,Jonatan Berggren,R,DET,24,64,8,7,15
6,8476469,Joel Armia,R,MTL,31,66,7,8,15
6,8477446,Michael McCarron,R,NSH,29,55,7,8,15
6,8482176,Wyatt Kaiser,D,CHI,22,50,7,8,15
6,8481517,Brett Leason,R,ANA,25,58,7,8,15
6,8470621,Corey Perry,R,EDM,39,75,6,9,15
6,8478585,Derek Ryan,C,EDM,38,65,6,9,15
6,8477369,Carson Soucy,D,VAN,30,66,6,9,15
6,8477508,Curtis Lazar,C,NJD,29,59,6,9,15
6,8470600,Ryan Suter,D,STL,39,57,5,10,15
6,8480025,MacKenzie Entwistle,R,FLA,25,63,4,11,15
6,8478452,Caleb Jones,D,LAK,27,49,4,11,15
6,8475790,Erik Gudbranson,D,CBJ,32,76,3,12,15
6,8481568,Alex Vlasic,D,CHI,23,56,3,12,15
6,8480727,Zach Whitecloud,D,VGK,28,53,2,13,15
6,8476967,Brett Kulak,D,EDM,30,59,2,13,15
6,8477845,Trevor van Riemsdyk,D,WSH,33,62,1,14,15
6,8475188,Brayden McNabb,D,VGK,33,57,1,14,15
6,8478416,Erik Cernak,D,TBL,27,78,0,15,15
6,8476891,Matthew Grzelcyk,D,PIT,30,71,0,15,15
6,8482155,Alex Laferriere,R,LAK,23,63,10,4,14
6,8476873,Mark Jankowski,C,NSH,30,53,9,5,14
6,8480021,Jack Studnicka,C,LAK,25,61,7,7,14
6,8479944,Zach Aston-Reese,C,VGK,30,54,7,7,14
6,8482807,Ethan Del Mastro,D,CHI,21,50,5,9,14
6,8474090,Brendan Smith,D,DAL,35,55,4,10,14
6,8480796,Martin Fehervary,D,WSH,25,60,3,11,14
6,8476429,Scott Mayfield,D,NYI,32,74,3,11,14
6,8479371,Dante Fabbro,D,NSH,26,60,3,11,14
6,8476952,Dominic Toninato,C,WPG,30,36,2,12,14
6,8480887,Jordan Harris,D,MTL,24,49,2,12,14
6,8481641,Joel Kiviranta,L,COL,28,70,9,4,13
6,8476994,Vinnie Hinostroza,C,NSH,30,38,7,6,13
6,8482148,Hendrix Lapierre,C,WSH,22,55,7,6,13
6,8482666,Scott Morrow,D,CAR,22,45,7,6,13
6,8482679,Matt Coronato,R,CGY,22,68,6,7,13
6,8481527,Kaedan Korczak,D,VGK,23,40,5,8,13
6,8482166,Shakir Mukhamadullin,D,SJS,22,54,5,8,13
6,8478851,Alexandre Carrier,D,NSH,28,66,5,8,13
6,8479772,Zack MacEwen,R,OTT,28,51,5,8,13
6,8478468,Jeremy Lauzon,D,NSH,27,47,5,8,13
6,8482859,Zack Ostapchuk,C,OTT,21,51,4,9,13
6,8476822,Luke Glendening,C,TBL,35,76,3,10,13
6,8480070,Ian Mitchell,D,BOS,25,46,3,10,13
6,8478840,Will Borgen,D,SEA,28,69,2,11,13
6,8474013,Ian Cole,D,UTA,35,52,1,12,13
6,8478831,Kevin Stenlund,C,UTA,28,57,11,1,12
6,8471817,Ryan Reaves,R,TOR,37,54,10,2,12
6,8476934,Brock McGinn,L,ANA,30,51,8,4,12
6,8479328,Julien Gauthier,R,NYI,27,64,7,5,12
6,8479968,Vinni Lettieri,C,BOS,29,51,7,5,12
6,8482737,Zack Bolduc,C,STL,21,54,5,7,12
6,8482077,Dylan Holloway,L,EDM,23,46,5,7,12
6,8481537,Nikita Okhotiuk,D,CGY,24,55,5,7,12
6,8482652,Walker Duehr,R,CGY,27,44,5,7,12
6,8480355,Mark Kastelic,C,BOS,25,64,4,8,12
6,8479324,Ryan Lindgren,D,NYR,26,64,4,8,12
6,8482733,Logan Mailloux,D,MTL,31,38,4,8,12
6,8475462,Radko Gudas,D,ANA,34,65,3,9,12
6,8483466,Kevin Korchinski,D,CHI,20,52,3,9,12
6,8476879,Cody Ceci,D,EDM,31,68,2,10,12
6,8478443,Brandon Carlo,D,BOS,28,62,2,10,12
6,8480192,Johnathan Kovacevic,D,NJD,27,51,2,10,12
6,8478859,Niko Mikkola,D,FLA,28,57,1,11,12
6,8475718,Justin Holl,D,DET,32,59,0,12,12
6,8482730,Brandt Clarke,D,LAK,21,53,6,5,11
6,8480011,Klim Kostin,C,SJS,25,45,6,5,11
6,8478211,Dryden Hunt,L,CGY,29,58,6,5,11
6,8481609,Vladislav Kolyachonok,D,UTA,23,41,6,5,11
6,8481754,Nikita Nesterenko,C,ANA,23,37,5,6,11
6,8478399,Jonas Siegenthaler,D,NJD,27,58,4,7,11
6,8474166,Alec Martinez,D,CHI,37,51,4,7,11
6,8479369,Andrew Peeke,D,BOS,26,64,1,10,11
6,8474568,Luke Schenn,D,NSH,35,50,1,10,11
6,8483460,David Jiricek,D,CBJ,21,60,1,10,11
6,8478043,Sam Lafferty,C,BUF,29,60,7,3,10
6,8481518,Nolan Foote,L,NJD,24,36,6,4,10
6,8481716,Dmitri Voronkov,L,CBJ,24,39,6,4,10
6,8480848,Ty Dellandrea,C,SJS,24,41,5,5,10
6,8482784,Zach Dean,C,STL,21,43,5,5,10
6,8478409,Anthony Richard,C,PHI,28,37,5,5,10
6,8482747,Brennan Othmann,L,NYR,21,41,4,6,10
6,8480441,Trey Fix-Wolansky,R,CBJ,25,47,4,6,10
6,8481708,Zac Jones,D,NYR,24,52,4,6,10
6,8479985,Cale Fleury,D,SEA,26,29,4,6,10
6,8471709,Marc-Edouard Vlasic,D,SJS,37,65,3,7,10
6,8477887,Patrick Brown,C,BOS,32,42,3,7,10
6,8477851,Jordan Oesterle,D,BOS,32,46,3,7,10
6,8475279,Ben Chiarot,D,DET,33,67,2,8,10
6,8475455,Brenden Dillon,D,NJD,34,62,2,8,10
6,8481598,Philip Broberg,D,EDM,23,51,2,8,10
6,8471677,Jack Johnson,D,CBJ,37,67,2,8,10
6,8481167,Brayden Pachal,D,CGY,25,39,2,8,10
6,8476441,Joel Edmundson,D,LAK,31,49,1,9,10
6,8483495,Simon Nemec,D,NJD,20,55,8,1,9
6,8481532,Alex Turcotte,C,LAK,23,44,7,2,9
6,8479370,Tyson Jost,C,CAR,26,48,6,3,9
6,8477482,Zachary Sanford,L,CHI,30,35,6,3,9
6,8481441,Joe Snively,C,DET,28,66,5,4,9
6,8480845,Rasmus Kupari,C,WPG,24,43,5,4,9
6,8479442,Troy Stecher,D,EDM,30,52,3,6,9
6,8475762,Derek Forbort,D,VAN,32,50,3,6,9
6,8481751,Lukas Rousek,R,BUF,25,39,3,6,9
6,8478017,Mark Friedman,D,VAN,29,44,3,6,9
6,8477931,Tomas Nosek,L,FLA,32,54,2,7,9
6,8475690,Chris Tanev,D,TOR,35,59,2,7,9
6,8480001,Urho Vaakanainen,D,ANA,25,58,2,7,9
6,8477365,Connor Clifton,D,BUF,29,52,2,7,9
6,8479372,Joshua Mahura,D,SEA,26,48,2,7,9
6,8481600,Tobias Bjornfot,D,FLA,23,36,2,7,9
6,8479348,Kale Clague,D,BUF,26,36,0,9,9
6,8479520,Brandon Duhaime,R,WSH,27,53,6,2,8
6,8481161,Jake Christiansen,D,CBJ,25,49,5,3,8
6,8473453,Trevor Lewis,C,LAK,37,68,5,3,8
6,8479981,Jonah Gadjovich,L,FLA,26,39,5,3,8
6,8475235,Nicolas Deslauriers,L,PHI,33,50,5,3,8
6,8483012,Logan Morrison,C,SEA,22,37,5,3,8
6,8480245,Olle Lycksell,R,PHI,25,30,4,4,8
6,8480007,Jonas Rondbjerg,R,VGK,25,35,3,5,8
6,8482861,Vincent Iorio,D,WSH,22,31,3,5,8
6,8477962,Brendan Lemieux,L,CAR,28,37,3,5,8
6,8482172,Landon Slaggert,L,CHI,22,26,3,5,8
6,8476874,Olli Maatta,D,DET,30,65,2,6,8
6,8476867,Brendan Gaunce,C,MIN,30,42,2,6,8
6,8477938,Haydn Fleury,D,WPG,28,46,2,6,8
6,8481122,Simon Benoit,D,TOR,26,33,1,7,8
6,8481056,Spencer Stastney,D,NSH,24,34,1,7,8
6,8474612,Travis Hamonic,D,OTT,34,45,0,8,8
6,8475750,Jon Merrill,D,MIN,32,59,0,8,8
6,8482751,Ryan Winterton,C,SEA,21,35,5,2,7
6,8482762,Simon Edvinsson,D,DET,21,52,4,3,7
6,8479972,Mason Shaw,C,WPG,26,40,4,3,7
6,8481556,John Beecher,C,BOS,23,34,4,3,7
6,8479994,Jaret Anderson-Dolan,C,WPG,25,36,3,4,7
6,8481789,Tye Kartye,L,SEA,23,33,3,4,7
6,8476442,Matt Nieto,L,PIT,32,41,3,4,7
6,8482095,Tyler Kleven,D,OTT,22,44,3,4,7
6,8480990,Declan Chisholm,D,MIN,24,35,3,4,7
6,8475958,Michael Sgarbossa,C,WSH,32,29,3,4,7
6,8475177,Calvin de Haan,D,COL,33,41,3,4,7
6,8480844,Grigori Denisenko,L,VGK,24,37,3,4,7
6,8482144,Jack Thompson,D,SJS,22,26,3,4,7
6,8482744,James Malatesta,L,CBJ,21,35,2,5,7
6,8482141,Lukas Cormier,D,VGK,22,23,2,5,7
6,8482496,Nils Aman,C,VAN,24,45,1,6,7
6,8480879,Jacob Bernard-Docker,D,OTT,24,47,1,6,7
6,8477034,Jaycob Megna,D,FLA,32,44,1,6,7
6,8473446,Erik Johnson,D,PHI,36,53,1,6,7
6,8479249,Andrew Poturalski,C,SJS,30,41,0,7,7
6,8481701,Santeri Hatakka,D,NJD,23,44,0,7,7
6,8480834,Ty Emberson,D,SJS,24,30,0,7,7
6,8482659,Josh Doan,R,UTA,22,52,4,2,6
6,8483549,Lucas Condotta,L,MTL,27,29,4,2,6
6,8477473,Justin Bailey,R,SJS,29,28,4,2,6
6,8479362,Riley Tufte,L,BOS,26,20,4,2,6
6,8480860,Kevin Bahl,D,CGY,24,53,3,3,6
6,8481617,Vasily Podkolzin,R,VAN,23,49,3,3,6
6,8479536,Axel Jonsson-Fjallby,L,WPG,26,31,3,3,6
6,8478146,Matthew Highmore,C,OTT,28,40,3,3,6
6,8476624,Barclay Goodrow,C,SJS,31,45,2,4,6
6,8478451,Ethan Bear,D,WSH,27,58,2,4,6
6,8480880,Jakub Lauko,C,MIN,24,31,2,4,6
6,8481550,Adam Beckman,L,NJD,23,41,2,4,6
6,8477384,Joshua Brown,D,EDM,30,42,2,4,6
6,8481592,Jakob Pelletier,L,CGY,23,37,2,4,6
6,8484287,Cole McWard,D,VAN,23,23,2,4,6
6,8479379,Givani Smith,R,SJS,26,26,2,4,6
6,8478454,Noah Juulsen,D,VAN,27,39,2,4,6
6,8480292,Carson Meyer,R,ANA,27,25,1,5,6
6,8481679,Maxence Guenette,D,OTT,23,32,1,5,6
6,8482765,Isak Rosen,R,BUF,21,20,1,5,6
6,8480196,Jacob Bryson,D,BUF,27,38,0,6,6
6,8478450,Parker Wotherspoon,D,BOS,27,31,0,6,6
6,8477527,Ross Johnston,L,ANA,30,34,3,2,5
6,8483763,Maksymilian Szuber,D,UTA,22,32,3,2,5
6,8482713,Mackie Samoskevich,R,FLA,22,35,2,3,5
6,8483570,Ben Meyers,C,SEA,26,30,2,3,5
6,8481147,Reese Johnson,C,MIN,26,41,2,3,5
6,8481237,Kyle MacLean,C,NYI,25,29,2,3,5
6,8479378,Logan Stanley,D,WPG,26,41,1,4,5
6,8482511,Mason Lohrei,D,BOS,23,32,1,4,5
6,8479320,Maxime Lajoie,D,SEA,27,23,1,4,5
6,8476858,Phillip Di Giuseppe,L,VAN,31,44,1,4,5
6,8482516,Matthew Kessel,D,STL,24,24,1,4,5
6,8482634,Alex Steeves,C,TOR,25,46,0,5,5
6,8482250,Callahan Burke,C,VGK,27,23,0,5,5
6,8484254,Akito Hirose,D,VAN,25,22,0,5,5
6,8484911,Collin Graf,R,SJS,22,41,0,5,5
6,8482165,Yan Kuznetsov,D,CGY,22,18,0,5,5
6,8483397,Marc McLaughlin,C,BOS,25,27,4,0,4
6,8479291,Kevin Rooney,C,CGY,31,45,3,1,4
6,8479419,Brett Murray,L,BUF,26,20,3,1,4
6,8478424,Jansen Harkins,C,ANA,27,42,2,2,4
6,8479367,William Lockwood,R,FLA,26,26,2,2,4
6,8479991,Jake Leschyshyn,C,NYR,25,31,2,2,4
6,8477335,Kyle Burroughs,D,LAK,29,45,1,3,4
6,8480950,Ilya Lyubushkin,D,DAL,30,55,1,3,4
6,8477073,Kurtis MacDermid,L,NJD,30,31,1,3,4
6,8477320,Anton Blidh,L,NYR,29,24,1,3,4
6,8478874,Adam Gaudette,R,OTT,28,37,1,3,4
6,8481541,Samuel Bolduc,D,NYI,24,31,1,3,4
6,8481030,Jack St. Ivany,D,PIT,25,23,1,3,4
6,8478021,William Lagesson,D,DET,28,24,1,3,4
6,8480075,Cameron Crotty,D,MIN,25,10,1,3,4
6,8477244,Chad Ruhwedel,D,NYR,34,28,0,4,4
6,8482088,Justin Sourdif,R,FLA,22,12,3,0,3
6,8476913,Devin Shore,C,MIN,30,29,2,1,3
6,8484258,Sam Malinski,D,COL,26,25,2,1,3
6,8482470,Ilya Solovyov,D,CGY,24,20,2,1,3
6,8480851,Akil Thomas,C,LAK,24,20,2,1,3
6,8480870,Bo Groulx,C,NYR,24,33,2,1,3
6,8481719,Maxwell Crozier,D,TBL,24,15,2,1,3
6,8480032,Shane Bowers,C,NJD,25,17,2,1,3
6,8483619,Filip Roos,D,OTT,25,38,1,2,3
6,8477971,Andreas Englund,D,LAK,28,32,1,2,3
6,8480890,Jan Jenik,C,OTT,24,30,1,2,3
6,8481543,Nikita Alexandrov,C,STL,24,28,1,2,3
6,8482153,Brendan Brisson,C,VGK,23,32,1,2,3
6,8484325,Waltteri Merela,C,TBL,26,24,1,2,3
6,8480084,Nick DeSimone,D,NJD,30,19,1,2,3
6,8482858,Ryker Evans,D,SEA,23,28,1,2,3
6,8479330,Brandon Gignac,C,MTL,27,14,1,2,3
6,8483597,Milos Kelemen,L,UTA,25,15,1,2,3
6,8476372,Nick Seeler,D,PHI,31,37,0,3,3
6,8476473,Connor Murphy,D,CHI,31,39,0,3,3
6,8481593,Jayden Struble,D,MTL,23,25,0,3,3
6,8482929,Emil Lilleberg,D,TBL,23,24,0,3,3
6,8481564,Ryan Johnson,D,BUF,23,14,0,3,3
6,8478502,Dennis Gilbert,D,BUF,28,16,0,3,3
6,8480267,Sammy Walker,C,MIN,25,16,2,0,2
6,8483395,Arshdeep Bains,L,VAN,23,13,2,0,2
6,8481599,Victor Soderstrom,D,UTA,23,36,1,1,2
6,8483630,Pavol Regenda,L,ANA,25,29,1,1,2
6,8482145,Mavrik Bourque,C,DAL,22,45,1,1,2
6,8477810,Joel Hanley,D,CGY,33,30,1,1,2
6,8482070,Mitchell Chaffee,R,TBL,26,48,1,1,2
6,8477462,Robert Hagg,D,VGK,29,26,1,1,2
6,8482201,Gage Goncalves,C,TBL,23,21,1,1,2
6,8481699,Aku Raty,R,UTA,23,15,1,1,2
6,8482177,Marat Khusnutdinov,C,MIN,22,28,1,1,2
6,8480468,James Hamblin,L,EDM,25,22,1,1,2
6,8481043,Cole Koepke,L,BOS,26,20,1,1,2
6,8481743,Marc Del Gaizo,D,NSH,25,25,1,1,2
6,8477541,Dakota Mermis,D,TOR,30,11,1,1,2
6,8481585,Egor Afanasyev,L,SJS,23,19,1,1,2
6,8481806,Louis Crevier,D,CHI,23,11,1,1,2
6,8482094,Daemon Hunt,D,MIN,22,18,1,1,2
6,8480874,Adam Ginning,D,PHI,24,10,1,1,2
6,8483398,Declan Carlile,D,TBL,31,8,1,1,2
6,8479576,Vincent Desharnais,D,VAN,28,27,0,2,2
6,8478881,Brett Seney,L,CHI,28,12,0,2,2
6,8481422,Jake Lucchini,C,NSH,29,18,0,2,2
6,8474062,Riley Nash,C,NYR,35,17,0,2,2
6,8479587,Rhett Gardner,C,PHI,28,19,0,2,2
6,8479638,Justin Brazeau,R,BOS,26,30,1,0,1
6,8482061,Brandon Biro,L,SEA,26,17,1,0,1
6,8478051,Max Willman,C,NJD,29,15,1,0,1
6,8482118,Sam Colangelo,R,ANA,23,12,1,0,1
6,8477467,Gustav Olofsson,D,SEA,30,14,1,0,1
6,8481578,Graeme Clarke,R,MIN,23,9,1,0,1
6,8482102,Vasily Ponomarev,C,PIT,22,15,1,0,1
6,8482476,Emil Heineman,L,MTL,23,7,1,0,1
6,8477993,Justin Kirkland,C,CGY,28,6,1,0,1
6,8475795,Dylan McIlrath,D,WSH,32,5,0,1,1
6,8478477,Mitchell Stephens,C,SEA,27,13,0,1,1
6,8483471,Brad Lambert,C,WPG,31,10,0,1,1
6,8484304,Uvis Balinskis,D,FLA,28,5,0,1,1
6,8475413,Justin Dowling,C,NJD,34,10,0,1,1
6,8481065,Angus Crookshank,L,OTT,25,18,0,1,1
6,8481006,Tyler Tucker,D,STL,24,19,0,1,1
6,8483489,Fraser Minten,C,TOR,31,10,0,1,1
6,8478446,Glenn Gawdin,C,LAK,27,8,0,1,1
6,8483512,Matthew Savoie,C,EDM,20,24,0,1,1
6,8481462,Mason Morelli,L,VGK,28,15,0,1,1
6,8483920,Pierrick Dube,R,WSH,23,4,0,1,1
6,8476323,Max McCormick,L,SEA,32,3,0,1,1
6,8483432,Luca Del Bel Belluz,C,CBJ,31,6,0,1,1
6,8481605,Jackson LaCombe,D,ANA,23,31,0,0,0
6,8482147,Jean-Luc Foudy,C,COL,22,26,0,0,0
6,8483546,Marshall Rifai,D,TOR,26,4,0,0,0
6,8481726,Adam Edstrom,C,NYR,24,3,0,0,0
6,8475755,Alexander Petrovic,D,DAL,32,13,0,0,0
6,8483407,Brandon Scanlin,D,NYR,25,3,0,0,0
6,8481024,Linus Karlsson,C,VAN,25,12,0,0,0
6,8483567,Georgii Merkulov,C,BOS,24,9,0,0,0
6,8482787,Nikita Chibrikov,R,WPG,31,4,0,0,0
6,8478854,Ryan Shea,D,PIT,27,5,0,0,0
6,8481206,John Ludvig,D,PIT,24,7,0,0,0
6,8477149,Scott Sabourin,R,SJS,32,11,0,0,0
6,8481655,Cole Schwindt,R,CGY,23,4,0,0,0
6,8482162,Roby Jarventie,L,EDM,22,10,0,0,0
6,8475780,Chris Wagner,R,COL,33,6,0,0,0
6,8482126,Emil Andrae,D,PHI,31,0,0,0,0
6,8484255,Jason Polin,R,COL,25,1,0,0,0
6,8482460,Matt Rempe,C,NYR,22,7,0,0,0
6,8478011,Louie Belpedio,D,PHI,28,11,0,0,0
6,8479522,Hardy Haman Aktell,D,WSH,26,3,0,0,0
6,8480823,Alexander Alexeyev,D,WSH,25,13,0,0,0
6,8478147,Bokondji Imama,L,PIT,28,3,0,0,0
6,8479421,Jacob Moverare,D,LAK,26,6,0,0,0
6,8483609,Adam Klapka,R,CGY,24,6,0,0,0
6,8480306,Grant Hutton,D,NYI,29,7,0,0,0
6,8483531,Brian Halonen,L,NJD,25,1,0,0,0
6,8470794,Joe Pavelski,C,,40,0,0,0,0
6,8479321,Lucas Johansen,D,,27,0,0,0,0
6,8477950,Tony DeAngelo,D,,29,0,0,0,0
6,8471218,Blake Wheeler,R,,38,0,0,0,0
6,8475197,Tyson Barrie,D,,33,0,0,0,0
6,8474157,Max Pacioretty,L,,36,0,0,0,0
6,8475744,Evgeny Kuznetsov,C,,32,0,0,0,0
6,8474037,James van Riemsdyk,L,,35,0,0,0,0
6,8476907,Mackenzie MacEachern,L,,30,0,0,0,0
6,8480216,Jacob Peterson,C,,25,0,0,0,0
6,8474602,Justin Schultz,D,,34,0,0,0,0
6,8482222,Alexander Barabanov,L,,30,0,0,0,0
6,8474031,Kevin Shattenkirk,D,,35,0,0,0,0
6,8477330,Dominik Kubalik,L,,29,0,0,0,0
6,8480884,Calen Addison,D,,24,0,0,0,0
6,8475906,John Klingberg,D,,32,0,0,0,0
6,8480008,Adam Ruzicka,C,,25,0,0,0,0
6,8476884,Derrick Pouliot,D,,30,0,0,0,0
6,8476919,Chris Tierney,C,,30,0,0,0,0
6,8479415,Michael McLeod,C,,26,0,0,0,0
6,8474870,Tyler Johnson,C,,34,0,0,0,0
6,8470604,Jeff Carter,C,,39,0,0,0,0
6,8478104,Sammy Blais,L,,28,0,0,0,0
6,8474884,Mike Hoffman,C,,35,0,0,0,0
6,8481591,Sam Poulin,R,,23,0,0,0,0
6,8471274,Alex Goligoski,D,,39,0,0,0,0
6,8476871,Tanner Pearson,L,,32,0,0,0,0
6,8476393,Nick Cousins,C,,31,0,0,0,0
6,8479977,Kailer Yamamoto,R,,26,0,0,0,0
6,8479346,Dillon Dube,C,,26,0,0,0,0
6,8480184,Gustav Lindstrom,D,,26,0,0,0,0
6,8479376,Victor Mete,D,,26,0,0,0,0
6,8473449,Kyle Okposo,R,,36,0,0,0,0
6,8481058,Jesse Ylonen,R,,25,0,0,0,0
6,8475752,Tyler Pitlick,C,,33,0,0,0,0
6,8481239,Samuel Fagemo,L,,24,0,0,0,0
6,8480821,Filip Zadina,R,,25,0,0,0,0
6,8470966,Mark Giordano,D,,41,0,0,0,0
6,8478495,Denis Gurianov,R,,27,0,0,0,0
6,8477464,Nic Petan,C,,29,0,0,0,0
6,8478099,Kevin Labanc,R,,29,0,0,0,0
6,8482241,Radim Zohorna,L,,28,0,0,0,0
6,8474040,Sam Gagner,C,,35,0,0,0,0
6,8479514,Rem Pitlick,C,,27,0,0,0,0
6,8478430,Oliver Kylington,D,,27,0,0,0,0
6,8479533,Joona Koppanen,L,,26,0,0,0,0
6,8479984,Cal Foote,D,,26,0,0,0,0
6,8477126,Jayson Megna,C,,34,0,0,0,0
6,8475164,Jakob Silfverberg,R,,34,0,0,0,0
6,8474009,Nick Bonino,C,,36,0,0,0,0
6,8479458,Nikita Zaitsev,D,,33,0,0,0,0
6,8477944,Jakub Vrana,L,,28,0,0,0,0
6,8471699,Andrew Cogliano,C,,37,0,0,0,0
6,8478067,Oskar Lindblom,L,,28,0,0,0,0
6,8471686,Marc Staal,D,,37,0,0,0,0
6,8470610,Zach Parise,L,,40,0,0,0,0
6,8478904,Steven Lorentz,C,,28,0,0,0,0
6,8473473,Milan Lucic,L,,36,0,0,0,0
6,8480031,Maxime Comtois,L,,25,0,0,0,0
6,8478512,Austin Czarnik,C,,32,0,0,0,0
6,8473504,Cal Clutterbuck,R,,37,0,0,0,0
6,8477454,Adam Erne,L,,29,0,0,0,0
6,8479383,Boris Katchouk,L,,26,0,0,0,0
6,8475825,Jani Hakanpää,D,,32,0,0,0,0
6,8477846,Ryan Carpenter,C,,33,0,0,0,0
6,8477930,Pierre-Edouard Bellemare,L,,39,0,0,0,0
6,8478400,Colin White,C,,27,0,0,0,0
6,8480226,Marián Studenic,R,,26,0,0,0,0
6,8480853,Liam Foudy,C,,24,0,0,0,0
6,8475797,Jarred Tinordi,D,,32,0,0,0,0
6,8479423,Alex Nylander,L,,26,0,0,0,0
6,8474618,Marco Scandella,D,,34,0,0,0,0
6,8478028,Fredrik Olofsson,L,,28,0,0,0,0
6,8474709,Matt Martin,L,,35,0,0,0,0
6,8481070,Hugh McGing,L,,26,0,0,0,0
6,8479546,Oskar Steen,C,,26,0,0,0,0
6,8474145,Robert Bortuzzo,D,,35,0,0,0,0
6,8476915,Jujhar Khaira,L,,30,0,0,0,0
6,8480274,Philip Kemp,D,EDM,25,1,0,0,0
6,8484326,Patrik Koch,D,UTA,28,2,0,0,0
6,8484321,Nikolas Matinpalo,D,OTT,26,0,0,0,0
6,8475278,Byron Froese,C,,33,0,0,0,0
6,8481812,Nikolai Knyzhov,D,,27,0,0,0,0
6,8478408,Travis Dermott,D,,28,0,0,0,0
6,8481077,John Leonard,L,,26,0,0,0,0
6,8479547,Matthew Phillips,R,,26,0,0,0,0
6,8482197,Adam Raska,R,MIN,23,3,0,0,0
6,8480836,Jonathan Gruden,C,,24,0,0,0,0
6,8481690,Tyler Angle,C,,24,0,0,0,0
6,8475766,Austin Watson,L,,32,0,0,0,0
6,8481016,Ruslan Iskhakov,C,,24,0,0,0,0
6,8478078,Rourke Chartier,C,,28,0,0,0,0
6,8484259,Ondrej Pavel,C,COL,31,4,0,0,0
6,8483401,Marc Johnstone,R,PIT,28,4,0,0,0
6,8480776,Sheldon Rempal,R,,29,0,0,0,0
6,8478956,Samuel Laberge,L,NJD,27,2,0,0,0
6,8483045,Cameron Butler,R,CBJ,31,1,0,0,0
6,8481534,Raphael Lavoie,C,EDM,24,1,0,0,0
6,8484314,Jiri Smejkal,L,,28,0,0,0,0
7,8478402,Connor McDavid,C,EDM,27,80,39,102,141
7,8477492,Nathan MacKinnon,C,COL,29,82,49,84,133
7,8479318,Auston Matthews,C,TOR,27,80,64,58,122
7,8477934,Leon Draisaitl,C,EDM,29,76,41,80,121
7,8478420,Mikko Rantanen,R,COL,28,81,48,72,120
7,8477956,David Pastrnak,R,BOS,28,81,57,56,113
7,8476453,Nikita Kucherov,R,TBL,31,81,32,81,113
7,8477501,Valeri Nichushkin,R,COL,29,81,62,48,110
7,8478864,Kirill Kaprizov,L,MIN,27,72,58,51,109
7,8478483,Mitch Marner,R,TOR,27,80,38,67,105
7,8477939,William Nylander,R,TOR,28,77,52,52,104
7,8481559,Jack Hughes,C,NJD,23,75,39,64,103
7,8477946,Dylan Larkin,C,DET,28,77,41,59,100
7,8479314,Matthew Tkachuk,L,FLA,27,80,32,67,99
7,8471675,Sidney Crosby,C,PIT,37,74,39,57,96
7,8478010,Brayden Point,C,TBL,28,82,44,49,93
7,8477404,Jake Guentzel,C,TBL,30,82,39,54,93
7,8475913,Mark Stone,R,VGK,32,75,29,64,93
7,8477493,Aleksander Barkov,C,FLA,29,79,28,65,93
7,8480023,Robert Thomas,C,STL,25,76,23,70,93
7,8476468,J.T. Miller,C,VAN,31,74,34,58,92
7,8480018,Nick Suzuki,C,MTL,25,80,30,60,90
7,8478550,Artemi Panarin,L,NYR,33,77,26,63,89
7,8480801,Brady Tkachuk,L,OTT,25,81,40,48,88
7,8477942,Kevin Fiala,L,LAK,28,81,33,55,88
7,8480800,Quinn Hughes,D,VAN,25,75,11,77,88
7,8478445,Mathew Barzal,C,NYI,27,81,18,68,86
7,8479420,Tage Thompson,C,BUF,27,70,47,38,85
7,8480027,Jason Robertson,L,DAL,25,82,28,57,85
7,8474600,Roman Josi,D,NSH,34,77,21,64,85
7,8476853,Morgan Rielly,D,TOR,30,69,10,75,85
7,8478398,Kyle Connor,L,WPG,28,75,47,36,83
7,8478439,Travis Konecny,R,PHI,27,80,39,44,83
7,8479407,Jesper Bratt,L,NJD,26,76,28,55,83
7,8482116,Tim Stützle,C,OTT,22,79,27,54,81
7,8475172,Nazem Kadri,C,CGY,34,78,23,58,81
7,8478427,Sebastian Aho,C,CAR,27,74,41,39,80
7,8479343,Clayton Keller,R,UTA,26,79,29,51,80
7,8477933,Sam Reinhart,C,FLA,29,79,45,34,79
7,8474564,Steven Stamkos,C,NSH,34,74,33,46,79
7,8480830,Andrei Svechnikov,R,CAR,24,72,24,55,79
7,8478403,Jack Eichel,C,VGK,28,74,38,40,78
7,8476389,Vincent Trocheck,C,NYR,31,79,35,43,78
7,8478444,Brock Boeser,R,VAN,27,79,44,32,76
7,8477960,Adrian Kempe,R,LAK,28,79,37,39,76
7,8476887,Filip Forsberg,L,NSH,30,76,33,42,75
7,8471685,Anze Kopitar,C,LAK,37,80,24,51,75
7,8475692,Mats Zuccarello,R,MIN,37,69,19,56,75
7,8473419,Brad Marchand,L,BOS,36,79,26,48,74
7,8480012,Elias Pettersson,C,VAN,26,72,23,51,74
7,8479323,Adam Fox,D,NYR,26,73,22,52,74
7,8482078,Lucas Raymond,L,DET,22,81,32,41,73
7,8480002,Nico Hischier,C,NJD,25,81,31,42,73
7,8479337,Alex DeBrincat,R,DET,27,82,30,43,73
7,8477949,Alex Tuch,R,BUF,28,72,26,47,73
7,8476459,Mika Zibanejad,C,NYR,31,77,24,49,73
7,8481540,Cole Caufield,R,MTL,23,75,42,30,72
7,8474141,Patrick Kane,R,DET,36,80,29,43,72
7,8477940,Nikolaj Ehlers,L,WPG,28,71,21,51,72
7,8477409,Carter Verhaeghe,C,FLA,29,78,36,35,71
7,8481557,Matt Boldy,L,MIN,23,73,31,40,71
7,8477402,Pavel Buchnevich,L,STL,29,77,35,35,70
7,8478414,Timo Meier,R,NJD,28,78,31,39,70
7,8480208,Drake Batherson,R,OTT,26,79,28,42,70
7,8479385,Jordan Kyrou,C,STL,26,71,22,48,70
7,8478047,Michael Bunting,L,PIT,29,68,27,42,69
7,8478460,Zach Werenski,D,CBJ,27,79,17,52,69
7,8475158,Ryan O'Reilly,C,NSH,33,74,32,36,68
7,8484144,Connor Bedard,C,CHI,19,70,26,42,68
7,8478873,Troy Terry,R,ANA,27,78,26,42,68
7,8479999,Casey Mittelstadt,C,COL,26,79,24,43,67
7,8476448,William Karlsson,C,VGK,31,79,23,44,67
7,8475786,Zach Hyman,L,EDM,32,78,34,32,66
7,8478449,Roope Hintz,C,DAL,28,82,33,33,66
7,8475810,Bryan Rust,R,PIT,32,76,31,35,66
7,8483515,Juraj Slafkovsky,L,MTL,20,77,30,36,66
7,8480069,Cale Makar,D,COL,26,69,21,44,65
7,8476454,Ryan Nugent-Hopkins,C,EDM,31,75,21,44,65
7,8477500,Bo Horvat,C,NYI,29,79,39,25,64
7,8476539,Jonathan Marchessault,R,NSH,34,71,33,31,64
7,8477951,Nick Schmaltz,C,UTA,28,80,28,36,64
7,8479542,Brandon Hagel,L,TBL,26,82,20,44,64
7,8476456,Jonathan Huberdeau,C,CGY,31,79,14,50,64
7,8482740,Wyatt Johnston,C,DAL,21,79,31,32,63
7,8475184,Chris Kreider,L,NYR,33,76,31,32,63
7,8478462,Nicolas Roy,C,VGK,27,74,31,32,63
7,8477407,Anthony Duclair,L,NYI,29,78,28,35,63
7,8477416,Oliver Bjorkstrand,R,SEA,29,70,27,36,63
7,8480064,Josh Norris,C,OTT,25,74,26,37,63
7,8471215,Evgeni Malkin,C,PIT,38,72,24,39,63
7,8478440,Dylan Strome,C,WSH,27,74,24,39,63
7,8475168,Matt Duchene,C,DAL,33,82,18,45,63
7,8474578,Erik Karlsson,D,PIT,34,75,13,50,63
7,8480865,Noah Dobson,D,NYI,24,82,11,52,63
7,8482159,Tyson Foerster,R,PHI,22,79,28,34,62
7,8475794,Tyler Seguin,C,DAL,32,81,27,35,62
7,8478975,Mason Marchment,L,DAL,29,80,24,38,62
7,8476881,Tomas Hertl,C,VGK,31,79,23,39,62
7,8477494,Jonathan Drouin,L,COL,29,80,22,40,62
7,8480803,Evan Bouchard,D,EDM,25,73,16,46,62
7,8482699,Dylan Guenther,R,UTA,21,70,28,33,61
7,8473512,Claude Giroux,R,OTT,36,79,24,37,61
7,8473994,Jamie Benn,L,DAL,35,82,22,39,61
7,8480036,Miro Heiskanen,D,DAL,25,74,9,52,61
7,8477964,Ivan Barbashev,C,VGK,29,79,28,32,60
7,8475754,Brock Nelson,C,NYI,33,80,27,33,60
7,8475166,John Tavares,C,TOR,34,75,23,37,60
7,8475798,Mikael Granlund,C,SJS,32,72,19,41,60
7,8475167,Victor Hedman,D,TBL,34,79,16,44,60
7,8476346,Johnny Gaudreau,L,CBJ,31,73,15,45,60
7,8480014,Gabriel Vilardi,C,WPG,25,69,37,22,59
7,8477955,Jared McCann,L,SEA,28,74,28,31,59
7,8475191,Reilly Smith,R,NYR,33,72,23,36,59
7,8480028,Morgan Frost,C,PHI,25,77,23,36,59
7,8474102,David Perron,L,OTT,36,78,21,38,59
7,8477504,Josh Morrissey,D,WPG,29,77,10,49,59
7,8475784,Jeff Skinner,C,EDM,32,74,26,32,58
7,8476875,Mike Matheson,D,MTL,30,73,7,51,58
7,8471214,Alex Ovechkin,L,WSH,39,74,25,32,57
7,8475765,Vladimir Tarasenko,R,DET,33,77,21,36,57
7,8476905,Chandler Stephenson,C,SEA,30,75,16,41,57
7,8476460,Mark Scheifele,C,WPG,31,73,33,23,56
7,8475170,Brayden Schenn,C,STL,33,74,26,30,56
7,8481711,Matias Maccelli,L,UTA,24,79,18,38,56
7,8475287,Erik Haula,L,NJD,33,68,29,26,55
7,8475314,Anders Lee,L,NYI,34,80,29,26,55
7,8482665,Matty Beniers,C,SEA,22,75,22,33,55
7,8482124,Quinton Byfield,R,LAK,22,81,22,33,55
7,8478407,Vince Dunn,D,SEA,28,74,9,46,55
7,8483431,Logan Cooley,C,UTA,20,75,29,25,54
7,8474679,Gustav Nyquist,C,NSH,35,74,24,30,54
7,8482109,Alexis Lafrenière,L,NYR,23,75,21,33,54
7,8479425,Filip Hronek,D,VAN,27,72,11,43,54
7,8476458,Ryan Strome,C,ANA,31,72,8,46,54
7,8480039,Martin Necas,C,CAR,25,68,23,30,53
7,8477451,Ryan Hartman,R,MIN,30,65,22,31,53
7,8478493,Joel Eriksson Ek,C,MIN,27,66,21,32,53
7,8482093,Seth Jarvis,C,CAR,22,70,19,34,53
7,8478542,Evan Rodrigues,C,FLA,31,76,17,36,53
7,8478474,Lawson Crouse,L,UTA,27,75,16,37,53
7,8474563,Drew Doughty,D,LAK,35,77,9,44,53
7,8478519,Anthony Cirelli,C,TBL,27,82,22,30,52
7,8481604,Pavel Dorofeyev,L,VGK,24,73,21,31,52
7,8480459,Pius Suter,C,VAN,28,72,21,31,52
7,8479525,Ross Colton,C,COL,28,80,25,26,51
7,8480015,Owen Tippett,R,PHI,25,74,20,31,51
7,8481528,Dylan Cozens,C,BUF,23,74,20,31,51
7,8476826,Yanni Gourde,C,SEA,33,74,17,34,51
7,8477503,Max Domi,C,TOR,29,77,12,39,51
7,8477447,Shea Theodore,D,VGK,29,67,8,43,51
7,8481068,Yegor Sharangovich,C,CGY,26,81,34,16,50
7,8478498,Jake DeBrusk,L,VAN,28,74,27,23,50
7,8478466,Daniel Sprong,R,VAN,27,65,22,28,50
7,8480009,Eeli Tolvanen,R,SEA,25,72,19,31,50
7,8480839,Rasmus Dahlin,D,BUF,24,70,10,40,50
7,8481596,Shane Pinto,C,OTT,24,77,21,28,49
7,8480188,Fabian Zetterlund,L,SJS,25,62,21,28,49
7,8477935,Sam Bennett,C,FLA,28,79,20,29,49
7,8478046,Danton Heinen,L,VAN,29,67,20,29,49
7,8477476,Artturi Lehkonen,L,COL,29,81,18,31,49
7,8477456,J.T. Compher,L,DET,29,78,18,31,49
7,8474590,John Carlson,D,WSH,34,70,15,34,49
7,8483808,Andrei Kuzmenko,L,CGY,28,74,15,34,49
7,8476432,Boone Jenner,C,CBJ,31,70,33,15,48
7,8475799,Nino Niederreiter,R,WPG,32,64,24,24,48
7,8476479,Phillip Danault,C,LAK,31,81,21,27,48
7,8479675,Trevor Moore,L,LAK,29,79,20,28,48
7,8479992,Michael Rasmussen,C,DET,25,78,18,30,48
7,8475745,Charlie Coyle,C,BOS,32,81,14,34,48
7,8475169,Evander Kane,L,EDM,33,78,24,23,47
7,8480797,Joel Farabee,L,PHI,24,72,24,23,47
7,8479339,Patrik Laine,L,CBJ,26,65,24,23,47
7,8475714,Calle Jarnkrok,C,TOR,33,75,23,24,47
7,8475726,Tyler Toffoli,C,SJS,32,68,23,24,47
7,8474586,Jordan Eberle,R,SEA,34,74,20,27,47
7,8478438,Tommy Novak,C,NSH,27,59,20,27,47
7,8482175,JJ Peterka,R,BUF,22,72,24,22,46
7,8475151,Kyle Palmieri,C,NYI,33,78,23,23,46
7,8474641,Adam Henrique,C,EDM,34,76,23,23,46
7,8482113,Anton Lundell,C,FLA,23,76,22,24,46
7,8482110,Dawson Mercer,C,NJD,23,73,21,25,46
7,8470613,Brent Burns,D,CAR,39,79,14,32,46
7,8478038,Devon Toews,D,COL,30,58,8,38,46
7,8477479,Tyler Bertuzzi,L,CHI,29,66,24,21,45
7,8482702,Logan Stankoven,C,DAL,21,81,23,22,45
7,8478401,Pavel Zacha,C,BOS,27,80,23,21,44
7,8476880,Tom Wilson,R,WSH,30,66,22,22,44
7,8481186,Logan O'Connor,R,COL,28,80,21,23,44
7,8476483,Rickard Rakell,R,PIT,31,73,19,25,44
7,8477986,Brandon Montour,D,SEA,30,78,14,30,44
7,8476461,Sean Couturier,C,PHI,32,67,13,31,44
7,8482712,Oskar Olausson,R,COL,22,81,11,33,44
7,8482149,Cole Perfetti,C,WPG,22,68,20,23,43
7,8484145,Zach Benson,L,BUF,19,69,16,27,43
7,8484153,Leo Carlsson,C,ANA,20,68,16,27,43
7,8481618,Alex Newhook,C,MTL,23,72,16,27,43
7,8478042,Viktor Arvidsson,L,EDM,31,72,16,27,43
7,8479400,Pierre-Luc Dubois,L,WSH,26,71,16,27,43
7,8477021,Alex Kerfoot,C,UTA,30,72,15,28,43
7,8478469,Thomas Chabot,D,OTT,27,69,10,33,43
7,8479410,Mikhail Sergachev,D,UTA,26,70,9,34,43
7,8482684,Luke Hughes,D,NJD,21,71,7,36,43
7,8477426,Nicholas Paul,L,TBL,29,82,22,20,42
7,8477496,Elias Lindholm,C,BOS,30,77,19,23,42
7,8474150,Mikael Backlund,C,CGY,35,75,16,26,42
7,8477998,Warren Foegele,L,LAK,28,81,16,26,42
7,8476419,Jean-Gabriel Pageau,C,NYI,32,76,14,28,42
7,8476462,Dougie Hamilton,D,NJD,31,74,11,31,42
7,8474151,Ryan McDonagh,D,TBL,35,77,10,32,42
7,8481581,Thomas Harley,D,DAL,23,74,8,34,42
7,8478856,Conor Garland,R,VAN,28,69,17,24,41
7,8477497,Sean Monahan,C,CBJ,30,70,17,24,41
7,8477444,Andre Burakovsky,L,SEA,29,74,16,25,41
7,8481533,Trevor Zegras,C,ANA,23,70,15,26,41
7,8482097,Jack Quinn,R,BUF,23,63,13,28,41
7,8476399,Blake Coleman,C,CGY,33,74,23,17,40
7,8482055,Drew O'Connor,L,PIT,26,68,21,19,40
7,8478463,Anthony Beauvillier,L,PIT,27,68,19,21,40
7,8476882,Teuvo Teravainen,C,CHI,30,65,16,24,40
7,8482720,Matthew Knies,L,TOR,22,79,16,24,40
7,8477932,Aaron Ekblad,D,FLA,28,73,13,27,40
7,8475149,Marcus Johansson,L,MIN,34,67,13,27,40
7,8471724,Kris Letang,D,PIT,37,79,12,28,40
7,8481703,Valtteri Puustinen,R,PIT,25,65,8,32,40
7,8478397,Rasmus Andersson,D,CGY,28,72,6,34,40
7,8481542,Moritz Seider,D,DET,23,80,4,36,40
7,8476438,Brandon Saad,L,STL,32,73,23,16,39
7,8478115,Pierre Engvall,L,NYI,28,79,17,22,39
7,8480220,Noah Cates,L,PHI,25,75,16,23,39
7,8481524,Bowen Byram,D,BUF,23,58,16,23,39
7,8476292,Ondrej Palat,L,NJD,33,70,13,26,39
7,8480849,Barrett Hayton,C,UTA,24,68,11,28,39
7,8482122,Brock Faber,D,MIN,22,80,11,28,39
7,8476958,Jaccob Slavin,D,CAR,30,79,10,29,39
7,8474565,Alex Pietrangelo,D,VGK,34,61,10,29,39
7,8476869,Brady Skjei,D,NSH,30,78,9,30,39
7,8482745,Mason McTavish,C,ANA,21,65,23,15,38
7,8480078,Filip Chytil,C,NYR,25,70,20,18,38
7,8482092,Ridly Greig,C,OTT,22,78,19,19,38
7,8477953,Kasperi Kapanen,R,STL,28,64,15,23,38
7,8476872,Scott Laughton,C,PHI,30,68,14,24,38
7,8479345,Jakob Chychrun,D,WSH,26,71,14,24,38
7,8477346,MacKenzie Weegar,D,CGY,30,71,14,24,38
7,8481523,Kirby Dach,C,MTL,23,70,12,26,38
7,8482133,Thomas Bordeleau,C,SJS,22,63,11,27,38
7,8477495,Seth Jones,D,CHI,30,66,7,31,38
7,8479325,Charlie McAvoy,D,BOS,27,74,7,31,38
7,8473986,Alex Killorn,L,ANA,35,68,21,16,37
7,8475760,Nick Bjugstad,C,UTA,32,72,19,18,37
7,8481580,Connor McMichael,C,WSH,23,61,19,18,37
7,8478458,John (Jack) Roslovic,C,CAR,27,67,17,20,37
7,8475793,Ryan Johansen,C,PHI,32,69,17,20,37
7,8482705,Cole Sillinger,C,CBJ,21,66,16,21,37
7,8482749,Joshua Roy,R,MTL,21,64,14,23,37
7,8477498,Darnell Nurse,D,EDM,29,72,13,24,37
7,8480798,Philipp Kurashev,C,CHI,25,63,12,25,37
7,8478133,Jake Evans,C,MTL,28,72,10,27,37
7,8474716,Jared Spurgeon,D,MIN,35,78,5,32,37
7,8475722,Jason Zucker,L,BUF,32,59,17,19,36
7,8476792,Torey Krug,D,STL,33,76,16,20,36
7,8482117,Lukas Reichel,L,CHI,22,62,12,24,36
7,8476927,Teddy Blueger,C,VAN,30,62,11,25,36
7,8481546,Cam York,D,PHI,23,74,10,26,36
7,8483445,Cutter Gauthier,L,ANA,20,65,9,27,36
7,8478396,Noah Hanifin,D,VGK,27,62,8,28,36
7,8476902,Esa Lindell,D,DAL,30,74,5,31,36
7,8484166,Adam Fantilli,C,CBJ,20,69,18,17,35
7,8474149,Evgenii Dadonov,R,DAL,35,81,17,18,35
7,8479351,Sam Steel,C,DAL,26,81,17,18,35
7,8477511,Anthony Mantha,R,CGY,30,78,15,20,35
7,8478472,Mathieu Joseph,R,STL,27,68,12,23,35
7,8480185,Eetu Luostarinen,C,FLA,26,74,11,24,35
7,8480817,K'Andre Miller,D,NYR,24,74,8,27,35
7,8478500,Ivan Provorov,D,CBJ,27,79,5,30,35
7,8478366,Frank Vatrano,R,ANA,30,76,18,16,34
7,8479393,Noah Gregor,L,OTT,26,67,17,17,34
7,8481560,Arthur Kaliyev,R,LAK,23,77,15,19,34
7,8482089,Jake Neighbours,L,STL,22,68,15,19,34
7,8476469,Joel Armia,R,MTL,31,62,14,20,34
7,8479987,Morgan Geekie,C,BOS,26,73,13,21,34
7,8480003,Jesper Boqvist,C,FLA,26,70,13,21,34
7,8477989,Christian Dvorak,C,MTL,28,63,13,21,34
7,8480871,Adam Boqvist,D,FLA,24,66,11,23,34
7,8475753,Justin Faulk,D,STL,32,65,9,25,34
7,8481577,Philip Tomasino,C,NSH,23,65,8,26,34
7,8477969,Marcus Pettersson,D,PIT,28,81,5,29,34
7,8476931,Jake McCabe,D,TOR,31,76,5,29,34
7,8478233,Andrew Mangiapane,L,WSH,28,70,14,19,33
7,8482667,William Eklund,L,SJS,22,61,14,19,33
7,8476278,Colin Blackwell,C,DAL,31,75,12,21,33
7,8476925,Colton Sissons,C,NSH,31,70,11,22,33
7,8476906,Shayne Gostisbehere,D,CAR,31,76,10,23,33
7,8478055,Gustav Forsling,D,FLA,28,67,7,26,33
7,8482105,Jake Sanderson,D,OTT,22,74,6,27,33
7,8476917,Adam Pelech,D,NYI,30,82,6,27,33
7,8474715,Cameron Atkinson,R,TBL,35,82,17,15,32
7,8478057,Dakota Joshua,C,VAN,28,70,17,15,32
7,8482475,Yegor Chinakhov,R,CBJ,23,62,15,17,32
7,8476981,Josh Anderson,R,MTL,30,68,15,17,32
7,8483457,Lane Hutson,D,MTL,20,68,15,17,32
7,8482101,Danil Gushchin,L,SJS,22,76,14,18,32
7,8475763,Kevin Hayes,R,PIT,32,58,13,19,32
7,8477429,Andrew Copp,C,DET,30,79,13,19,32
7,8482660,Kent Johnson,C,CBJ,22,63,9,23,32
7,8482671,Owen Power,D,BUF,22,70,8,24,32
7,8477948,Travis Sanheim,D,PHI,28,76,5,27,32
7,8483524,Shane Wright,C,SEA,20,66,19,12,31
7,8481535,Nils Hoglander,L,VAN,24,70,17,14,31
7,8480813,Joe Veleno,C,DET,24,80,17,14,31
7,8473422,Nick Foligno,L,CHI,37,62,15,16,31
7,8475848,Brendan Gallagher,R,MTL,32,74,14,17,31
7,8479661,Tanner Jeannot,L,LAK,27,81,14,17,31
7,8481582,Nicholas Robertson,L,TOR,23,61,14,17,31
7,8480068,Ryan Poehling,C,PHI,25,69,13,18,31
7,8480113,Alex Iafallo,L,WPG,31,61,12,19,31
7,8480145,Neal Pionk,D,WPG,29,72,7,24,31
7,8483490,Pavel Mintyukov,D,ANA,21,72,6,25,31
7,8480049,Dylan Samberg,D,WPG,25,66,0,31,31
7,8479353,Brett Howden,C,VGK,26,67,16,14,30
7,8479619,Michael Carcone,L,UTA,28,58,16,14,30
7,8479368,Max Jones,L,BOS,26,74,14,16,30
7,8482146,Luke Evangelista,R,NSH,22,68,12,18,30
7,8475218,Mattias Ekholm,D,EDM,34,76,11,19,30
7,8483505,Matthew Poitras,C,BOS,20,73,8,22,30
7,8476892,Colton Parayko,D,STL,31,69,7,23,30
7,8479293,Brandon Tanev,L,SEA,33,67,15,14,29
7,8477425,Miles Wood,L,COL,29,79,15,14,29
7,8477987,Ryan Donato,C,CHI,28,61,14,15,29
7,8476474,Stefan Noesen,R,NJD,31,61,13,16,29
7,8479591,Michael Eyssimont,C,TBL,28,82,13,16,29
7,8480043,Timothy Liljegren,D,TOR,25,66,6,23,29
7,8477506,Ryan Pulock,D,NYI,30,80,5,24,29
7,8478136,Jake Middleton,D,MIN,28,75,3,26,29
7,8475181,Nick Leddy,D,STL,33,64,1,28,29
7,8475768,Jaden Schwartz,C,SEA,32,64,16,12,28
7,8479996,Cody Glass,C,NSH,25,65,14,14,28
7,8471698,T.J. Oshie,R,WSH,38,67,13,15,28
7,8478413,Jordan Greenway,L,BUF,27,64,13,15,28
7,8479365,Trent Frederic,C,BOS,26,79,11,17,28
7,8480789,Oliver Wahlstrom,R,NYI,24,69,9,19,28
7,8480336,Sean Walker,D,CAR,30,74,8,20,28
7,8475764,Cam Fowler,D,ANA,33,78,6,22,28
7,8476312,Josh Manson,D,COL,33,64,4,24,28
7,8480873,Rasmus Sandin,D,WSH,24,66,3,25,28
7,8477952,Robby Fabbri,C,ANA,28,67,16,11,27
7,8480893,Kirill Marchenko,R,CBJ,24,62,13,14,27
7,8480802,Ryan McLeod,C,BUF,25,58,12,15,27
7,8478020,Michael Amadio,R,OTT,28,73,11,16,27
7,8473533,Jordan Staal,C,CAR,36,62,11,16,27
7,8477435,Ryan Graves,D,PIT,29,72,10,17,27
7,8482079,Marco Rossi,C,MIN,23,63,9,18,27
7,8480073,Erik Brannstrom,D,COL,25,60,9,18,27
7,8484203,Bradly Nadeau,L,CAR,19,70,8,19,27
7,8477947,Sonny Milano,L,WSH,28,67,8,19,27
7,8480434,Sean Durzi,D,UTA,26,67,7,20,27
7,8476979,Erik Gustafsson,D,DET,32,75,7,20,27
7,8473563,Nicklas Backstrom,C,WSH,37,61,7,20,27
7,8479398,Samuel Girard,D,COL,26,64,4,23,27
7,8478508,Yakov Trenin,C,MIN,27,67,20,6,26
7,8477839,Conor Sheary,L,TBL,32,81,13,13,26
7,8475343,Nic Dowd,C,WSH,34,62,13,13,26
7,8470621,Corey Perry,R,EDM,39,70,13,13,26
7,8474189,Lars Eller,C,PIT,35,68,11,15,26
7,8475220,Marcus Foligno,L,MIN,33,53,11,15,26
7,8480144,David Kampf,C,TOR,29,69,9,17,26
7,8482142,Jamie Drysdale,D,PHI,22,60,7,19,26
7,8475200,Dmitry Orlov,D,CAR,33,78,5,21,26
7,8478911,Matt Roy,D,WSH,29,67,4,22,26
7,8475171,Oliver Ekman-Larsson,D,TOR,33,70,4,22,26
7,8482125,Alexander Holtz,R,VGK,22,62,14,11,25
7,8481093,Rafael Harvey-Pinard,L,MTL,25,60,13,12,25
7,8476856,Mathew Dumba,D,DAL,30,68,11,14,25
7,8482067,Connor Mackey,D,NYR,28,66,8,17,25
7,8479983,Mario Ferraro,D,SJS,26,70,8,17,25
7,8480448,Parker Kelly,L,COL,25,75,7,18,25
7,8479639,Dylan Coghlan,D,WPG,26,60,7,18,25
7,8474574,Tyler Myers,D,VAN,34,64,3,22,25
7,8479316,Luke Kunin,C,SJS,27,65,13,11,24
7,8481601,Simon Holmstrom,R,NYI,23,64,13,11,24
7,8477505,Alexander Wennberg,C,SJS,30,59,11,13,24
7,8480748,Kiefer Sherwood,L,VAN,29,57,11,13,24
7,8480855,Jack McBain,C,UTA,24,69,9,15,24
7,8482624,Daniil Miromanov,D,CGY,27,69,9,15,24
7,8481522,Peyton Krebs,C,BUF,23,59,8,16,24
7,8474053,Logan Couture,C,SJS,35,57,6,18,24
7,8477507,Nikita Zadorov,D,BOS,29,65,6,18,24
7,8475179,Dmitry Kulikov,D,FLA,34,62,5,19,24
7,8476891,Matthew Grzelcyk,D,PIT,30,77,4,20,24
7,8480222,Sebastian Aho,D,PIT,28,67,3,21,24
7,8477478,William Carrier,L,CAR,30,57,11,12,23
7,8482737,Zack Bolduc,C,STL,21,65,11,12,23
7,8480835,Jack Drury,C,CAR,24,60,10,13,23
7,8480289,Morgan Barron,C,WPG,26,55,10,13,23
7,8482803,Olen Zellweger,D,ANA,21,64,9,14,23
7,8476392,Adam Lowry,C,WPG,31,54,8,15,23
7,8475855,Jesper Fast,R,CAR,33,56,8,15,23
7,8478434,Keegan Kolesar,R,VGK,27,64,7,16,23
7,8482111,Justin Barron,D,MTL,23,64,6,17,23
7,8481059,Scott Perunovich,D,STL,26,62,6,17,23
7,8482192,Isaak Phillips,D,CHI,23,57,6,17,23
7,8476923,Damon Severson,D,CBJ,30,77,5,18,23
7,8479369,Andrew Peeke,D,BOS,26,61,5,18,23
7,8476879,Cody Ceci,D,EDM,31,72,3,20,23
7,8477353,Tyler Motte,C,DET,29,77,12,10,22
7,8475791,Taylor Hall,L,CHI,33,57,11,11,22
7,8482259,Bobby McMann,C,TOR,28,63,11,11,22
7,8480025,MacKenzie Entwistle,R,FLA,25,63,11,11,22
7,8481656,Aliaksei Protas,C,WSH,23,63,10,12,22
7,8481554,Kaapo Kakko,R,NYR,23,69,10,12,22
7,8480762,Eric Robinson,L,CAR,29,58,9,13,22
7,8477446,Michael McCarron,R,NSH,29,58,9,13,22
7,8480205,Emil Bemstrom,C,PIT,25,53,8,14,22
7,8482157,Will Cuylle,L,NYR,22,67,8,14,22
7,8481641,Joel Kiviranta,L,COL,28,65,8,14,22
7,8477220,Nate Schmidt,D,FLA,33,66,7,15,22
7,8476329,Travis Boyd,C,MIN,31,52,7,15,22
7,8475231,Casey Cizikas,C,NYI,33,71,7,15,22
7,8480878,Nils Lundkvist,D,DAL,24,73,7,15,22
7,8476921,Jordan Martinook,L,CAR,32,58,7,15,22
7,8480829,Jesperi Kotkaniemi,C,CAR,24,62,6,16,22
7,8478851,Alexandre Carrier,D,NSH,28,63,6,16,22
7,8476463,Jonas Brodin,D,MIN,31,76,3,19,22
7,8478507,John Marino,D,UTA,27,65,3,19,22
7,8479941,Justin Danforth,R,CBJ,31,55,14,7,21
7,8478109,Victor Olofsson,L,VGK,29,73,11,10,21
7,8476889,Radek Faksa,C,STL,30,66,10,11,21
7,8477903,Garnet Hathaway,R,PHI,33,57,8,13,21
7,8476480,Vladislav Namestnikov,C,WPG,32,60,7,14,21
7,8479671,Mathieu Olivier,R,CBJ,27,51,7,14,21
7,8480891,Michael Kesselring,D,UTA,24,64,6,15,21
7,8477488,Brett Pesce,D,NJD,30,67,5,16,21
7,8476854,Hampus Lindholm,D,BOS,30,72,5,16,21
7,8483565,Nick Blankenburg,D,NSH,26,63,3,18,21
7,8475233,David Savard,D,MTL,34,66,3,18,21
7,8482655,Janis Moser,D,TBL,24,79,2,19,21
7,8474673,TJ Brodie,D,CHI,34,61,1,20,21
7,8475188,Brayden McNabb,D,VGK,33,59,0,21,21
7,8477015,Connor Brown,R,EDM,30,63,9,11,20
7,8483466,Kevin Korchinski,D,CHI,20,51,9,11,20
7,8480011,Klim Kostin,C,SJS,25,57,9,11,20
7,8481606,Jordan Spence,D,LAK,23,67,8,12,20
7,8476897,Oskar Sundqvist,C,STL,30,64,7,13,20
7,8477508,Curtis Lazar,C,NJD,29,62,7,13,20
7,8476467,Jamie Oleksiak,D,SEA,32,64,5,15,20
7,8483468,Jiri Kulich,C,BUF,20,62,5,15,20
7,8479390,Taylor Raddysh,R,WSH,26,68,4,16,20
7,8479402,Jake Bean,D,CGY,26,74,3,17,20
7,8473507,Jeff Petry,D,DET,37,65,3,17,20
7,8477499,Rasmus Ristolainen,D,PHI,30,59,3,17,20
7,8477365,Connor Clifton,D,BUF,29,60,3,17,20
7,8479976,Juuso Valimaki,D,UTA,26,62,2,18,20
7,8475750,Jon Merrill,D,MIN,32,59,1,19,20
7,8479336,Carl Grundstrom,R,SJS,27,53,11,8,19
7,8476822,Luke Glendening,C,TBL,35,80,10,9,19
7,8479344,Jesse Puljujarvi,R,PIT,26,52,9,10,19
7,8481624,Ilya Mikheyev,R,CHI,30,60,8,11,19
7,8474034,Patrick Maroon,L,CHI,36,47,6,13,19
7,8480727,Zach Whitecloud,D,VGK,28,53,3,16,19
7,8481568,Alex Vlasic,D,CHI,23,54,1,18,19
7,8482074,Connor Zary,C,CGY,23,70,13,5,18
7,8471817,Ryan Reaves,R,TOR,37,57,12,6,18
7,8481481,Blake Lizotte,C,PIT,27,59,11,7,18
7,8482809,Jackson Blake,R,CAR,21,54,11,7,18
7,8482964,Arber Xhekaj,D,MTL,23,50,11,7,18
7,8477450,Jason Dickinson,C,CHI,29,61,10,8,18
7,8483499,Liam Ohgren,L,MIN,20,58,10,8,18
7,8481032,Paul Cotter,C,NJD,25,57,10,8,18
7,8478891,Mason Appleton,C,WPG,28,64,9,9,18
7,8475225,Craig Smith,C,CHI,35,49,9,9,18
7,8480074,Alexandre Texier,C,STL,25,56,8,10,18
7,8482747,Brennan Othmann,L,NYR,21,38,8,10,18
7,8476918,Jimmy Vesey,L,NYR,31,64,7,11,18
7,8480021,Jack Studnicka,C,LAK,25,59,7,11,18
7,8482148,Hendrix Lapierre,C,WSH,22,50,7,11,18
7,8483482,Tristan Luneau,D,ANA,20,59,6,12,18
7,8481013,Jonatan Berggren,R,DET,24,57,6,12,18
7,8478043,Sam Lafferty,C,BUF,29,64,6,12,18
7,8479315,Joey Anderson,R,CHI,26,54,5,13,18
7,8480995,Pontus Holmberg,R,TOR,25,63,5,13,18
7,8481014,Alexander Romanov,D,NYI,24,72,3,15,18
7,8478840,Will Borgen,D,SEA,28,68,3,15,18
7,8475790,Erik Gudbranson,D,CBJ,32,77,2,16,18
7,8480001,Urho Vaakanainen,D,ANA,25,59,1,17,18
7,8481553,Bobby Brink,R,PHI,23,61,12,5,17
7,8483491,Ivan Miroshnichenko,L,WSH,20,52,10,7,17
7,8480980,Connor Dewar,C,TOR,25,64,10,7,17
7,8477919,Frederick Gaudreau,C,MIN,31,56,9,8,17
7,8480806,Isac Lundestrom,C,ANA,25,59,9,8,17
7,8480252,Cole Guttman,C,CHI,25,39,9,8,17
7,8482679,Matt Coronato,R,CGY,22,65,8,9,17
7,8476374,Sean Kuraly,C,CBJ,31,53,7,10,17
7,8476885,Jacob Trouba,D,NYR,30,69,6,11,17
7,8478432,Christian Fischer,R,DET,27,72,6,11,17
7,8482062,Cole Smith,L,NSH,29,58,6,11,17
7,8479980,Nicolas Hague,D,VGK,26,48,5,12,17
7,8476525,Colin Miller,D,WPG,32,67,5,12,17
7,8479026,Philippe Myers,D,TOR,27,50,5,12,17
7,8478452,Caleb Jones,D,LAK,27,60,4,13,17
7,8475718,Justin Holl,D,DET,32,56,4,13,17
7,8478399,Jonas Siegenthaler,D,NJD,27,59,4,13,17
7,8481708,Zac Jones,D,NYR,24,54,4,13,17
7,8476429,Scott Mayfield,D,NYI,32,75,3,14,17
7,8475462,Radko Gudas,D,ANA,34,64,3,14,17
7,8481178,Egor Zamula,D,PHI,24,55,1,16,17
7,8481518,Nolan Foote,L,NJD,24,47,10,6,16
7,8481716,Dmitri Voronkov,L,CBJ,24,48,9,7,16
7,8477392,Hudson Fasching,R,NYI,29,61,8,8,16
7,8481704,Juuso Parssinen,C,NSH,23,51,7,9,16
7,8482807,Ethan Del Mastro,D,CHI,21,50,7,9,16
7,8483493,Frank Nazar,C,CHI,20,54,6,10,16
7,8477380,Jonny Brodzinski,C,NYR,31,48,6,10,16
7,8476422,Mike Reilly,D,NYI,31,77,5,11,16
7,8482634,Alex Steeves,C,TOR,25,51,5,11,16
7,8477979,Nicolas Aube-Kubel,R,BUF,28,54,4,12,16
7,8477369,Carson Soucy,D,VAN,30,56,4,12,16
7,8479442,Troy Stecher,D,EDM,30,51,4,12,16
7,8475324,Nick Jensen,D,OTT,34,66,3,13,16
7,8483460,David Jiricek,D,CBJ,21,63,3,13,16
7,8476331,Dylan DeMelo,D,WPG,31,67,2,14,16
7,8478882,Vladislav Gavrikov,D,LAK,29,66,2,14,16
7,8480246,Nick Perbix,D,TBL,26,73,2,14,16
7,8477845,Trevor van Riemsdyk,D,WSH,33,58,2,14,16
7,8479982,Conor Timmins,D,TOR,26,54,1,15,16
7,8479371,Dante Fabbro,D,NSH,26,58,1,15,16
7,8480281,Alexey Toropchenko,R,STL,25,55,10,5,15
7,8477962,Brendan Lemieux,L,CAR,28,51,9,6,15
7,8482762,Simon Edvinsson,D,DET,21,57,9,6,15
7,8479359,Beck Malenstyn,L,BUF,26,54,8,7,15
7,8476960,Andreas Athanasiou,C,CHI,30,46,7,8,15
7,8475842,Sam Carrick,C,NYR,32,50,7,8,15
7,8478970,Jalen Chatfield,D,CAR,28,66,6,9,15
7,8481527,Kaedan Korczak,D,VGK,23,46,6,9,15
7,8481521,Ronnie Attard,D,PHI,25,49,5,10,15
7,8479414,Nathan Bastian,R,NJD,27,56,5,10,15
7,8481028,Martin Pospisil,C,CGY,25,58,5,10,15
7,8476624,Barclay Goodrow,C,SJS,31,50,4,11,15
7,8482087,Kaiden Guhle,D,MTL,22,61,3,12,15
7,8478416,Erik Cernak,D,TBL,27,72,3,12,15
7,8475279,Ben Chiarot,D,DET,33,62,3,12,15
7,8482451,Mikael Pyyhtia,L,CBJ,23,43,2,13,15
7,8475208,Brian Dumoulin,D,ANA,33,62,2,13,15
7,8477573,Nathan Walker,L,STL,30,51,9,5,14
7,8478421,A.J. Greer,L,FLA,28,53,7,7,14
7,8475193,Tomas Tatar,L,NJD,34,60,6,8,14
7,8478569,Noel Acciari,C,PIT,33,54,6,8,14
7,8479370,Tyson Jost,C,CAR,26,45,6,8,14
7,8481751,Lukas Rousek,R,BUF,25,39,6,8,14
7,8476874,Olli Maatta,D,DET,30,67,6,8,14
7,8479520,Brandon Duhaime,R,WSH,27,50,5,9,14
7,8474612,Travis Hamonic,D,OTT,34,46,5,9,14
7,8479543,Michael Pezzetta,L,MTL,26,51,4,10,14
7,8480807,Mattias Samuelsson,D,BUF,24,59,4,10,14
7,8481441,Joe Snively,C,DET,28,66,3,11,14
7,8480157,Calle Rosen,D,COL,30,46,2,12,14
7,8478013,Jake Walman,D,SJS,28,70,2,12,14
7,8482245,Artem Zub,D,OTT,29,69,1,13,14
7,8480887,Jordan Harris,D,MTL,24,48,1,13,14
7,8479944,Zach Aston-Reese,C,VGK,30,50,9,4,13
7,8477070,Liam O'Brien,C,UTA,30,50,8,5,13
7,8481617,Vasily Podkolzin,R,VAN,23,47,8,5,13
7,8476858,Phillip Di Giuseppe,L,VAN,31,41,8,5,13
7,8478211,Dryden Hunt,L,CGY,29,53,7,6,13
7,8477406,Mattias Janmark,C,EDM,32,65,6,7,13
7,8476442,Matt Nieto,L,PIT,32,54,6,7,13
7,8476988,Matt Benning,D,SJS,30,62,4,9,13
7,8476994,Vinnie Hinostroza,C,NSH,30,49,4,9,13
7,8480860,Kevin Bahl,D,CGY,24,62,3,10,13
7,8479998,Mikey Anderson,D,LAK,25,67,2,11,13
7,8478468,Jeremy Lauzon,D,NSH,27,58,2,11,13
7,8478859,Niko Mikkola,D,FLA,28,54,2,11,13
7,8480035,Henri Jokiharju,D,BUF,25,62,1,12,13
7,8481019,David Gustafsson,C,WPG,24,43,1,12,13
7,8480796,Martin Fehervary,D,WSH,25,54,1,12,13
7,8471677,Jack Johnson,D,CBJ,37,67,1,12,13
7,8479372,Joshua Mahura,D,SEA,26,54,0,13,13
7,8478585,Derek Ryan,C,EDM,38,60,9,3,12
7,8473453,Trevor Lewis,C,LAK,37,70,6,6,12
7,8479994,Jaret Anderson-Dolan,C,WPG,25,41,6,6,12
7,8483549,Lucas Condotta,L,MTL,27,36,5,7,12
7,8476878,Zemgus Girgensons,C,TBL,30,79,4,8,12
7,8477931,Tomas Nosek,L,FLA,32,57,4,8,12
7,8476913,Devin Shore,C,MIN,30,37,4,8,12
7,8478178,Darren Raddysh,D,TBL,28,69,3,9,12
7,8482176,Wyatt Kaiser,D,CHI,22,49,3,9,12
7,8474013,Ian Cole,D,UTA,35,53,3,9,12
7,8479972,Mason Shaw,C,WPG,26,43,3,9,12
7,8482511,Mason Lohrei,D,BOS,23,40,3,9,12
7,8474166,Alec Martinez,D,CHI,37,53,2,10,12
7,8480950,Ilya Lyubushkin,D,DAL,30,70,2,10,12
7,8476457,Adam Larsson,D,SEA,32,73,1,11,12
7,8475455,Brenden Dillon,D,NJD,34,63,1,11,12
7,8470600,Ryan Suter,D,STL,39,64,0,12,12
7,8482155,Alex Laferriere,R,LAK,23,60,8,3,11
7,8480880,Jakub Lauko,C,MIN,24,41,6,5,11
7,8479066,Ryan Lomberg,L,CGY,30,62,5,6,11
7,8479439,Jacob MacDonald,D,COL,31,54,5,6,11
7,8478443,Brandon Carlo,D,BOS,28,60,5,6,11
7,8482730,Brandt Clarke,D,LAK,21,41,5,6,11
7,8479328,Julien Gauthier,R,NYI,27,63,4,7,11
7,8480441,Trey Fix-Wolansky,R,CBJ,25,37,4,7,11
7,8481599,Victor Soderstrom,D,UTA,23,51,4,7,11
7,8476967,Brett Kulak,D,EDM,30,63,3,8,11
7,8473446,Erik Johnson,D,PHI,36,41,3,8,11
7,8481701,Santeri Hatakka,D,NJD,23,37,3,8,11
7,8482073,Braden Schneider,D,NYR,23,62,2,9,11
7,8481567,Henry Thrun,D,SJS,23,50,2,9,11
7,8480192,Johnathan Kovacevic,D,NJD,27,51,2,9,11
7,8477034,Jaycob Megna,D,FLA,32,47,2,9,11
7,8480172,Jan Rutta,D,SJS,34,62,1,10,11
7,8481537,Nikita Okhotiuk,D,CGY,24,49,1,10,11
7,8479378,Logan Stanley,D,WPG,26,42,1,10,11
7,8476473,Connor Murphy,D,CHI,31,42,1,10,11
7,8476873,Mark Jankowski,C,NSH,30,49,7,3,10
7,8482751,Ryan Winterton,C,SEA,21,34,7,3,10
7,8482659,Josh Doan,R,UTA,22,54,7,3,10
7,8480292,Carson Meyer,R,ANA,27,40,7,3,10
7,8478831,Kevin Stenlund,C,UTA,28,47,6,4,10
7,8482166,Shakir Mukhamadullin,D,SJS,22,56,5,5,10
7,8480355,Mark Kastelic,C,BOS,25,62,4,6,10
7,8475177,Calvin de Haan,D,COL,33,56,4,6,10
7,8479536,Axel Jonsson-Fjallby,L,WPG,26,45,4,6,10
7,8482765,Isak Rosen,R,BUF,21,31,4,6,10
7,8480845,Rasmus Kupari,C,WPG,24,35,3,7,10
7,8480844,Grigori Denisenko,L,VGK,24,30,3,7,10
7,8482784,Zach Dean,C,STL,21,38,2,8,10
7,8481598,Philip Broberg,D,EDM,23,41,2,8,10
7,8480070,Ian Mitchell,D,BOS,25,48,1,9,10
7,8474568,Luke Schenn,D,NSH,35,46,0,10,10
7,8481517,Brett Leason,R,ANA,25,58,6,3,9
7,8482077,Dylan Holloway,L,EDM,23,52,6,3,9
7,8480007,Jonas Rondbjerg,R,VGK,25,40,5,4,9
7,8476934,Brock McGinn,L,ANA,30,45,4,5,9
7,8477938,Haydn Fleury,D,WPG,28,41,4,5,9
7,8482095,Tyler Kleven,D,OTT,22,43,4,5,9
7,8483619,Filip Roos,D,OTT,25,38,4,5,9
7,8481477,Nico Sturm,C,SJS,29,49,3,6,9
7,8479718,Alex Barré-Boulet,C,MTL,27,39,3,6,9
7,8474090,Brendan Smith,D,DAL,35,56,3,6,9
7,8479324,Ryan Lindgren,D,NYR,26,60,3,6,9
7,8475762,Derek Forbort,D,VAN,32,36,3,6,9
7,8477335,Kyle Burroughs,D,LAK,29,46,3,6,9
7,8477018,Ben Hutton,D,VGK,31,41,2,7,9
7,8481600,Tobias Bjornfot,D,FLA,23,48,2,7,9
7,8482744,James Malatesta,L,CBJ,21,48,1,8,9
7,8477482,Zachary Sanford,L,CHI,30,33,5,3,8
7,8478146,Matthew Highmore,C,OTT,28,32,4,4,8
7,8482713,Mackie Samoskevich,R,FLA,22,42,4,4,8
7,8477401,John Hayden,C,SEA,29,35,3,5,8
7,8479772,Zack MacEwen,R,OTT,28,62,3,5,8
7,8482859,Zack Ostapchuk,C,OTT,21,49,3,5,8
7,8477887,Patrick Brown,C,BOS,32,46,3,5,8
7,8483495,Simon Nemec,D,NJD,20,54,3,5,8
7,8484287,Cole McWard,D,VAN,23,30,3,5,8
7,8479991,Jake Leschyshyn,C,NYR,25,34,3,5,8
7,8475235,Nicolas Deslauriers,L,PHI,33,53,2,6,8
7,8483630,Pavol Regenda,L,ANA,25,23,2,6,8
7,8476952,Dominic Toninato,C,WPG,30,46,1,7,8
7,8481167,Brayden Pachal,D,CGY,25,33,1,7,8
7,8479576,Vincent Desharnais,D,VAN,28,32,0,8,8
7,8481754,Nikita Nesterenko,C,ANA,23,39,5,2,7
7,8482070,Mitchell Chaffee,R,TBL,26,43,5,2,7
7,8480468,James Hamblin,L,EDM,25,31,5,2,7
7,8484149,Gavin Brindley,C,CBJ,20,44,4,3,7
7,8481556,John Beecher,C,BOS,23,38,4,3,7
7,8481532,Alex Turcotte,C,LAK,23,47,3,4,7
7,8481161,Jake Christiansen,D,CBJ,25,50,3,4,7
7,8480990,Declan Chisholm,D,MIN,24,36,3,4,7
7,8481550,Adam Beckman,L,NJD,23,34,3,4,7
7,8480058,Pierre-Olivier Joseph,D,STL,25,52,2,5,7
7,8482733,Logan Mailloux,D,MTL,31,43,2,5,7
7,8478017,Mark Friedman,D,VAN,29,48,2,5,7
7,8475690,Chris Tanev,D,TOR,35,58,2,5,7
7,8483012,Logan Morrison,C,SEA,22,28,2,5,7
7,8476867,Brendan Gaunce,C,MIN,30,42,2,5,7
7,8480834,Ty Emberson,D,SJS,24,30,2,5,7
7,8480879,Jacob Bernard-Docker,D,OTT,24,52,1,6,7
7,8481789,Tye Kartye,L,SEA,23,35,4,2,6
7,8475958,Michael Sgarbossa,C,WSH,32,27,4,2,6
7,8477473,Justin Bailey,R,SJS,29,20,4,2,6
7,8483570,Ben Meyers,C,SEA,26,31,4,2,6
7,8478051,Max Willman,C,NJD,29,24,4,2,6
7,8482666,Scott Morrow,D,CAR,22,40,3,3,6
7,8479379,Givani Smith,R,SJS,26,41,3,3,6
7,8477851,Jordan Oesterle,D,BOS,32,39,2,4,6
7,8481592,Jakob Pelletier,L,CGY,23,33,2,4,6
7,8481147,Reese Johnson,C,MIN,26,47,2,4,6
7,8482145,Mavrik Bourque,C,DAL,22,50,2,4,6
7,8480848,Ty Dellandrea,C,SJS,24,37,1,5,6
7,8471709,Marc-Edouard Vlasic,D,SJS,37,63,1,5,6
7,8480196,Jacob Bryson,D,BUF,27,43,1,5,6
7,8477527,Ross Johnston,L,ANA,30,37,1,5,6
7,8480870,Bo Groulx,C,NYR,24,32,1,5,6
7,8479968,Vinni Lettieri,C,BOS,29,46,5,0,5
7,8482496,Nils Aman,C,VAN,24,41,3,2,5
7,8478451,Ethan Bear,D,WSH,27,49,3,2,5
7,8479367,William Lockwood,R,FLA,26,26,3,2,5
7,8477320,Anton Blidh,L,NYR,29,21,3,2,5
7,8481743,Marc Del Gaizo,D,NSH,25,17,3,2,5
7,8481122,Simon Benoit,D,TOR,26,35,2,3,5
7,8478454,Noah Juulsen,D,VAN,27,39,2,3,5
7,8481679,Maxence Guenette,D,OTT,23,32,2,3,5
7,8483397,Marc McLaughlin,C,BOS,25,23,2,3,5
7,8478874,Adam Gaudette,R,OTT,28,33,2,3,5
7,8477462,Robert Hagg,D,VGK,29,25,2,3,5
7,8482177,Marat Khusnutdinov,C,MIN,22,31,2,3,5
7,8481605,Jackson LaCombe,D,ANA,23,34,2,3,5
7,8479986,Kole Lind,R,DAL,26,48,1,4,5
7,8476441,Joel Edmundson,D,LAK,31,43,1,4,5
7,8479348,Kale Clague,D,BUF,26,38,1,4,5
7,8480245,Olle Lycksell,R,PHI,25,32,1,4,5
7,8482861,Vincent Iorio,D,WSH,22,34,1,4,5
7,8484254,Akito Hirose,D,VAN,25,40,1,4,5
7,8477073,Kurtis MacDermid,L,NJD,30,21,1,4,5
7,8478021,William Lagesson,D,DET,28,30,1,4,5
7,8482153,Brendan Brisson,C,VGK,23,28,1,4,5
7,8482061,Brandon Biro,L,SEA,26,9,1,4,5
7,8481006,Tyler Tucker,D,STL,24,22,1,4,5
7,8474567,Zach Bogosian,D,MIN,34,58,0,5,5
7,8479981,Jonah Gadjovich,L,FLA,26,36,0,5,5
7,8481056,Spencer Stastney,D,NSH,24,32,0,5,5
7,8479249,Andrew Poturalski,C,SJS,30,36,0,5,5
7,8482147,Jean-Luc Foudy,C,COL,22,29,4,0,4
7,8482652,Walker Duehr,R,CGY,27,44,3,1,4
7,8481609,Vladislav Kolyachonok,D,UTA,23,28,2,2,4
7,8483763,Maksymilian Szuber,D,UTA,22,30,2,2,4
7,8479419,Brett Murray,L,BUF,26,20,2,2,4
7,8478424,Jansen Harkins,C,ANA,27,39,2,2,4
7,8484258,Sam Malinski,D,COL,26,21,2,2,4
7,8484325,Waltteri Merela,C,TBL,26,17,2,2,4
7,8481043,Cole Koepke,L,BOS,26,16,2,2,4
7,8478409,Anthony Richard,C,PHI,28,30,1,3,4
7,8480890,Jan Jenik,C,OTT,24,29,1,3,4
7,8478502,Dennis Gilbert,D,BUF,28,17,1,3,4
7,8479320,Maxime Lajoie,D,SEA,27,22,0,4,4
7,8484911,Collin Graf,R,SJS,22,39,0,4,4
7,8476372,Nick Seeler,D,PHI,31,38,0,4,4
7,8481593,Jayden Struble,D,MTL,23,19,0,4,4
7,8477467,Gustav Olofsson,D,SEA,30,23,0,4,4
7,8483597,Milos Kelemen,L,UTA,25,24,3,0,3
7,8478881,Brett Seney,L,CHI,28,12,2,1,3
7,8479638,Justin Brazeau,R,BOS,26,33,2,1,3
7,8481462,Mason Morelli,L,VGK,28,14,2,1,3
7,8481030,Jack St. Ivany,D,PIT,25,19,1,2,3
7,8477244,Chad Ruhwedel,D,NYR,34,30,1,2,3
7,8480851,Akil Thomas,C,LAK,24,19,1,2,3
7,8481543,Nikita Alexandrov,C,STL,24,18,1,2,3
7,8474062,Riley Nash,C,NYR,35,17,1,2,3
7,8481206,John Ludvig,D,PIT,24,15,1,2,3
7,8477149,Scott Sabourin,R,SJS,32,13,1,2,3
7,8480306,Grant Hutton,D,NYI,29,4,1,2,3
7,8482144,Jack Thompson,D,SJS,22,29,0,3,3
7,8478450,Parker Wotherspoon,D,BOS,27,33,0,3,3
7,8482470,Ilya Solovyov,D,CGY,24,18,0,3,3
7,8482858,Ryker Evans,D,SEA,23,19,0,3,3
7,8483395,Arshdeep Bains,L,VAN,23,12,0,3,3
7,8479587,Rhett Gardner,C,PHI,28,21,0,3,3
7,8483489,Fraser Minten,C,TOR,31,13,0,3,3
7,8482516,Matthew Kessel,D,STL,24,18,2,0,2
7,8480267,Sammy Walker,C,MIN,25,16,2,0,2
7,8482118,Sam Colangelo,R,ANA,23,15,2,0,2
7,8481024,Linus Karlsson,C,VAN,25,12,2,0,2
7,8482162,Roby Jarventie,L,EDM,22,15,2,0,2
7,8479985,Cale Fleury,D,SEA,26,17,1,1,2
7,8482141,Lukas Cormier,D,VGK,22,30,1,1,2
7,8481237,Kyle MacLean,C,NYI,25,25,1,1,2
7,8479291,Kevin Rooney,C,CGY,31,44,1,1,2
7,8480075,Cameron Crotty,D,MIN,25,10,1,1,2
7,8480874,Adam Ginning,D,PHI,24,16,1,1,2
7,8482102,Vasily Ponomarev,C,PIT,22,12,1,1,2
7,8482460,Matt Rempe,C,NYR,22,9,1,1,2
7,8482250,Callahan Burke,C,VGK,27,23,0,2,2
7,8481719,Maxwell Crozier,D,TBL,24,12,0,2,2
7,8482201,Gage Goncalves,C,TBL,23,29,0,2,2
7,8482094,Daemon Hunt,D,MIN,22,20,0,2,2
7,8482172,Landon Slaggert,L,CHI,22,23,1,0,1
7,8479362,Riley Tufte,L,BOS,26,15,1,0,1
7,8481541,Samuel Bolduc,D,NYI,24,20,1,0,1
7,8480032,Shane Bowers,C,NJD,25,22,1,0,1
7,8477971,Andreas Englund,D,LAK,28,19,1,0,1
7,8481585,Egor Afanasyev,L,SJS,23,6,1,0,1
7,8481422,Jake Lucchini,C,NSH,29,23,1,0,1
7,8484304,Uvis Balinskis,D,FLA,28,9,1,0,1
7,8478446,Glenn Gawdin,C,LAK,27,9,1,0,1
7,8478147,Bokondji Imama,L,PIT,28,7,1,0,1
7,8484259,Ondrej Pavel,C,COL,31,3,1,0,1
7,8482165,Yan Kuznetsov,D,CGY,22,23,0,1,1
7,8480084,Nick DeSimone,D,NJD,30,16,0,1,1
7,8482929,Emil Lilleberg,D,TBL,23,23,0,1,1
7,8481564,Ryan Johnson,D,BUF,23,15,0,1,1
7,8477541,Dakota Mermis,D,TOR,30,11,0,1,1
7,8481806,Louis Crevier,D,CHI,23,9,0,1,1
7,8482476,Emil Heineman,L,MTL,23,13,0,1,1
7,8483512,Matthew Savoie,C,EDM,20,14,0,1,1
7,8483432,Luca Del Bel Belluz,C,CBJ,31,5,0,1,1
7,8481726,Adam Edstrom,C,NYR,24,9,0,1,1
7,8483407,Brandon Scanlin,D,NYR,25,4,0,1,1
7,8483567,Georgii Merkulov,C,BOS,24,8,0,1,1
7,8480823,Alexander Alexeyev,D,WSH,25,8,0,1,1
7,8477384,Joshua Brown,D,EDM,30,43,0,0,0
7,8482088,Justin Sourdif,R,FLA,22,16,0,0,0
7,8479330,Brandon Gignac,C,MTL,27,8,0,0,0
7,8477810,Joel Hanley,D,CGY,33,21,0,0,0
7,8481699,Aku Raty,R,UTA,23,12,0,0,0
7,8483398,Declan Carlile,D,TBL,31,8,0,0,0
7,8481578,Graeme Clarke,R,MIN,23,3,0,0,0
7,8477993,Justin Kirkland,C,CGY,28,7,0,0,0
7,8475795,Dylan McIlrath,D,WSH,32,14,0,0,0
7,8478477,Mitchell Stephens,C,SEA,27,20,0,0,0
7,8483471,Brad Lambert,C,WPG,31,10,0,0,0
7,8475413,Justin Dowling,C,NJD,34,14,0,0,0
7,8481065,Angus Crookshank,L,OTT,25,14,0,0,0
7,8483920,Pierrick Dube,R,WSH,23,1,0,0,0
7,8476323,Max McCormick,L,SEA,32,7,0,0,0
7,8483546,Marshall Rifai,D,TOR,26,3,0,0,0
7,8475755,Alexander Petrovic,D,DAL,32,3,0,0,0
7,8482787,Nikita Chibrikov,R,WPG,31,7,0,0,0
7,8478854,Ryan Shea,D,PIT,27,7,0,0,0
7,8481655,Cole Schwindt,R,CGY,23,7,0,0,0
7,8475780,Chris Wagner,R,COL,33,4,0,0,0
7,8482126,Emil Andrae,D,PHI,31,5,0,0,0
7,8484255,Jason Polin,R,COL,25,4,0,0,0
7,8478011,Louie Belpedio,D,PHI,28,19,0,0,0
7,8479522,Hardy Haman Aktell,D,WSH,26,1,0,0,0
7,8479421,Jacob Moverare,D,LAK,26,6,0,0,0
7,8483609,Adam Klapka,R,CGY,24,2,0,0,0
7,8483531,Brian Halonen,L,NJD,25,3,0,0,0
7,8470794,Joe Pavelski,C,,40,0,0,0,0
7,8479321,Lucas Johansen,D,,27,0,0,0,0
7,8477950,Tony DeAngelo,D,,29,0,0,0,0
7,8471218,Blake Wheeler,R,,38,0,0,0,0
7,8475197,Tyson Barrie,D,,33,0,0,0,0
7,8474157,Max Pacioretty,L,,36,0,0,0,0
7,8475744,Evgeny Kuznetsov,C,,32,0,0,0,0
7,8474037,James van Riemsdyk,L,,35,0,0,0,0
7,8476907,Mackenzie MacEachern,L,,30,0,0,0,0
7,8480216,Jacob Peterson,C,,25,0,0,0,0
7,8474602,Justin Schultz,D,,34,0,0,0,0
7,8482222,Alexander Barabanov,L,,30,0,0,0,0
7,8474031,Kevin Shattenkirk,D,,35,0,0,0,0
7,8477330,Dominik Kubalik,L,,29,0,0,0,0
7,8480884,Calen Addison,D,,24,0,0,0,0
7,8475906,John Klingberg,D,,32,0,0,0,0
7,8480008,Adam Ruzicka,C,,25,0,0,0,0
7,8476884,Derrick Pouliot,D,,30,0,0,0,0
7,8476919,Chris Tierney,C,,30,0,0,0,0
7,8479415,Michael McLeod,C,,26,0,0,0,0
7,8474870,Tyler Johnson,C,,34,0,0,0,0
7,8470604,Jeff Carter,C,,39,0,0,0,0
7,8478104,Sammy Blais,L,,28,0,0,0,0
7,8474884,Mike Hoffman,C,,35,0,0,0,0
7,8481591,Sam Poulin,R,,23,0,0,0,0
7,8471274,Alex Goligoski,D,,39,0,0,0,0
7,8476871,Tanner Pearson,L,,32,0,0,0,0
7,8476393,Nick Cousins,C,,31,0,0,0,0
7,8479977,Kailer Yamamoto,R,,26,0,0,0,0
7,8479346,Dillon Dube,C,,26,0,0,0,0
7,8480184,Gustav Lindstrom,D,,26,0,0,0,0
7,8479376,Victor Mete,D,,26,0,0,0,0
7,8473449,Kyle Okposo,R,,36,0,0,0,0
7,8481058,Jesse Ylonen,R,,25,0,0,0,0
7,8475752,Tyler Pitlick,C,,33,0,0,0,0
7,8481239,Samuel Fagemo,L,,24,0,0,0,0
7,8480821,Filip Zadina,R,,25,0,0,0,0
7,8470966,Mark Giordano,D,,41,0,0,0,0
7,8478495,Denis Gurianov,R,,27,0,0,0,0
7,8477464,Nic Petan,C,,29,0,0,0,0
7,8478099,Kevin Labanc,R,,29,0,0,0,0
7,8482241,Radim Zohorna,L,,28,0,0,0,0
7,8474040,Sam Gagner,C,,35,0,0,0,0
7,8479514,Rem Pitlick,C,,27,0,0,0,0
7,8478430,Oliver Kylington,D,,27,0,0,0,0
7,8479533,Joona Koppanen,L,,26,0,0,0,0
7,8479984,Cal Foote,D,,26,0,0,0,0
7,8477126,Jayson Megna,C,,34,0,0,0,0
7,8475164,Jakob Silfverberg,R,,34,0,0,0,0
7,8474009,Nick Bonino,C,,36,0,0,0,0
7,8479458,Nikita Zaitsev,D,,33,0,0,0,0
7,8477944,Jakub Vrana,L,,28,0,0,0,0
7,8471699,Andrew Cogliano,C,,37,0,0,0,0
7,8478067,Oskar Lindblom,L,,28,0,0,0,0
7,8471686,Marc Staal,D,,37,0,0,0,0
7,8470610,Zach Parise,L,,40,0,0,0,0
7,8478904,Steven Lorentz,C,,28,0,0,0,0
7,8473473,Milan Lucic,L,,36,0,0,0,0
7,8480031,Maxime Comtois,L,,25,0,0,0,0
7,8478512,Austin Czarnik,C,,32,0,0,0,0
7,8473504,Cal Clutterbuck,R,,37,0,0,0,0
7,8477454,Adam Erne,L,,29,0,0,0,0
7,8479383,Boris Katchouk,L,,26,0,0,0,0
7,8475825,Jani Hakanpää,D,,32,0,0,0,0
7,8477846,Ryan Carpenter,C,,33,0,0,0,0
7,8477930,Pierre-Edouard Bellemare,L,,39,0,0,0,0
7,8478400,Colin White,C,,27,0,0,0,0
7,8480226,Marián Studenic,R,,26,0,0,0,0
7,8480853,Liam Foudy,C,,24,0,0,0,0
7,8475797,Jarred Tinordi,D,,32,0,0,0,0
7,8479423,Alex Nylander,L,,26,0,0,0,0
7,8474618,Marco Scandella,D,,34,0,0,0,0
7,8478028,Fredrik Olofsson,L,,28,0,0,0,0
7,8474709,Matt Martin,L,,35,0,0,0,0
7,8481070,Hugh McGing,L,,26,0,0,0,0
7,8479546,Oskar Steen,C,,26,0,0,0,0
7,8474145,Robert Bortuzzo,D,,35,0,0,0,0
7,8476915,Jujhar Khaira,L,,30,0,0,0,0
7,8480274,Philip Kemp,D,EDM,25,1,0,0,0
7,8484326,Patrik Koch,D,UTA,28,2,0,0,0
7,8484321,Nikolas Matinpalo,D,OTT,26,3,0,0,0
7,8475278,Byron Froese,C,,33,0,0,0,0
7,8481812,Nikolai Knyzhov,D,,27,0,0,0,0
7,8478408,Travis Dermott,D,,28,0,0,0,0
7,8481077,John Leonard,L,,26,0,0,0,0
7,8479547,Matthew Phillips,R,,26,0,0,0,0
7,8482197,Adam Raska,R,MIN,23,6,0,0,0
7,8480836,Jonathan Gruden,C,,24,0,0,0,0
7,8481690,Tyler Angle,C,,24,0,0,0,0
7,8475766,Austin Watson,L,,32,0,0,0,0
7,8481016,Ruslan Iskhakov,C,,24,0,0,0,0
7,8478078,Rourke Chartier,C,,28,0,0,0,0
7,8483401,Marc Johnstone,R,PIT,28,3,0,0,0
7,8480776,Sheldon Rempal,R,,29,0,0,0,0
7,8478956,Samuel Laberge,L,NJD,27,2,0,0,0
7,8483045,Cameron Butler,R,CBJ,31,0,0,0,0
7,8481534,Raphael Lavoie,C,EDM,24,5,0,0,0
7,8484314,Jiri Smejkal,L,,28,0,0,0,0
8,8477492,Nathan MacKinnon,C,COL,29,81,59,88,147
8,8478402,Connor McDavid,C,EDM,27,80,43,101,144
8,8479318,Auston Matthews,C,TOR,27,81,69,71,140
8,8476453,Nikita Kucherov,R,TBL,31,82,39,92,131
8,8477956,David Pastrnak,R,BOS,28,78,60,64,124
8,8476468,J.T. Miller,C,VAN,31,75,43,77,120
8,8478864,Kirill Kaprizov,L,MIN,27,78,50,69,119
8,8478483,Mitch Marner,R,TOR,27,80,39,75,114
8,8477934,Leon Draisaitl,C,EDM,29,77,50,63,113
8,8477939,William Nylander,R,TOR,28,82,53,58,111
8,8477493,Aleksander Barkov,C,FLA,29,79,37,71,108
8,8478420,Mikko Rantanen,R,COL,28,80,43,64,107
8,8481559,Jack Hughes,C,NJD,23,73,37,68,105
8,8480027,Jason Robertson,L,DAL,25,82,42,60,102
8,8478550,Artemi Panarin,L,NYR,33,77,34,68,102
8,8479314,Matthew Tkachuk,L,FLA,27,81,25,75,100
8,8478403,Jack Eichel,C,VGK,28,78,45,52,97
8,8478445,Mathew Barzal,C,NYI,27,82,33,63,96
8,8477404,Jake Guentzel,C,TBL,30,81,36,57,93
8,8474600,Roman Josi,D,NSH,34,77,27,66,93
8,8475166,John Tavares,C,TOR,34,81,46,46,92
8,8476887,Filip Forsberg,L,NSH,30,75,44,48,92
8,8478010,Brayden Point,C,TBL,28,82,41,51,92
8,8480012,Elias Pettersson,C,VAN,26,76,37,55,92
8,8480002,Nico Hischier,C,NJD,25,76,41,49,90
8,8476346,Johnny Gaudreau,L,CBJ,31,72,18,72,90
8,8477942,Kevin Fiala,L,LAK,28,80,30,58,88
8,8475172,Nazem Kadri,C,CGY,34,77,34,52,86
8,8477402,Pavel Buchnevich,L,STL,29,74,31,55,86
8,8476454,Ryan Nugent-Hopkins,C,EDM,31,79,22,64,86
8,8480800,Quinn Hughes,D,VAN,25,73,10,76,86
8,8482740,Wyatt Johnston,C,DAL,21,82,41,44,85
8,8475692,Mats Zuccarello,R,MIN,37,74,15,70,85
8,8477946,Dylan Larkin,C,DET,28,81,39,44,83
8,8471675,Sidney Crosby,C,PIT,37,72,38,44,82
8,8480801,Brady Tkachuk,L,OTT,25,77,37,45,82
8,8477960,Adrian Kempe,R,LAK,28,82,27,55,82
8,8471215,Evgeni Malkin,C,PIT,38,75,31,50,81
8,8480023,Robert Thomas,C,STL,25,78,29,52,81
8,8480865,Noah Dobson,D,NYI,24,80,17,64,81
8,8479407,Jesper Bratt,L,NJD,26,74,30,50,80
8,8479337,Alex DeBrincat,R,DET,27,81,30,50,80
8,8478439,Travis Konecny,R,PHI,27,80,25,55,80
8,8481557,Matt Boldy,L,MIN,23,70,39,40,79
8,8479343,Clayton Keller,R,UTA,26,77,30,49,79
8,8471685,Anze Kopitar,C,LAK,37,79,30,49,79
8,8479323,Adam Fox,D,NYR,26,72,23,56,79
8,8475810,Bryan Rust,R,PIT,32,78,40,38,78
8,8478427,Sebastian Aho,C,CAR,27,72,31,47,78
8,8480208,Drake Batherson,R,OTT,26,78,31,47,78
8,8478398,Kyle Connor,L,WPG,28,72,29,49,78
8,8480069,Cale Makar,D,COL,26,66,16,62,78
8,8479542,Brandon Hagel,L,TBL,26,82,34,42,76
8,8482093,Seth Jarvis,C,CAR,22,67,34,42,76
8,8477496,Elias Lindholm,C,BOS,30,81,33,43,76
8,8474564,Steven Stamkos,C,NSH,34,72,28,48,76
8,8481540,Cole Caufield,R,MTL,23,73,36,39,75
8,8477933,Sam Reinhart,C,FLA,29,75,34,41,75
8,8476460,Mark Scheifele,C,WPG,31,78,30,45,75
8,8473419,Brad Marchand,L,BOS,36,80,24,51,75
8,8478449,Roope Hintz,C,DAL,28,82,36,38,74
8,8475784,Jeff Skinner,C,EDM,32,77,34,40,74
8,8480036,Miro Heiskanen,D,DAL,25,79,18,56,74
8,8478414,Timo Meier,R,NJD,28,74,36,37,73
8,8476459,Mika Zibanejad,C,NYR,31,79,28,45,73
8,8474141,Patrick Kane,R,DET,36,80,25,48,73
8,8477951,Nick Schmaltz,C,UTA,28,75,24,48,72
8,8476389,Vincent Trocheck,C,NYR,31,76,27,44,71
8,8479420,Tage Thompson,C,BUF,27,74,36,34,70
8,8475184,Chris Kreider,L,NYR,33,79,36,34,70
8,8477501,Valeri Nichushkin,R,COL,29,80,32,38,70
8,8475913,Mark Stone,R,VGK,32,76,27,43,70
8,8482116,Tim Stützle,C,OTT,22,78,22,48,70
8,8477409,Carter Verhaeghe,C,FLA,29,74,34,35,69
8,8471214,Alex Ovechkin,L,WSH,39,74,29,40,69
8,8484144,Connor Bedard,C,CHI,19,62,27,42,69
8,8473994,Jamie Benn,L,DAL,35,81,30,38,68
8,8477494,Jonathan Drouin,L,COL,29,80,20,48,68
8,8477500,Bo Horvat,C,NYI,29,80,34,33,67
8,8475754,Brock Nelson,C,NYI,33,81,31,36,67
8,8480830,Andrei Svechnikov,R,CAR,24,72,28,39,67
8,8479999,Casey Mittelstadt,C,COL,26,82,21,45,66
8,8480803,Evan Bouchard,D,EDM,25,76,12,54,66
8,8477935,Sam Bennett,C,FLA,28,78,32,33,65
8,8475158,Ryan O'Reilly,C,NSH,33,73,30,35,65
8,8478397,Rasmus Andersson,D,CGY,28,78,12,53,65
8,8481068,Yegor Sharangovich,C,CGY,26,78,34,30,64
8,8477476,Artturi Lehkonen,L,COL,29,81,32,32,64
8,8475168,Matt Duchene,C,DAL,33,79,30,34,64
8,8483431,Logan Cooley,C,UTA,20,77,29,35,64
8,8479675,Trevor Moore,L,LAK,29,81,29,35,64
8,8476448,William Karlsson,C,VGK,31,76,28,36,64
8,8477456,J.T. Compher,L,DET,29,82,23,41,64
8,8478460,Zach Werenski,D,CBJ,27,82,16,48,64
8,8482124,Quinton Byfield,R,LAK,22,80,16,48,64
8,8475167,Victor Hedman,D,TBL,34,82,14,50,64
8,8482699,Dylan Guenther,R,UTA,21,73,32,31,63
8,8478444,Brock Boeser,R,VAN,27,73,31,32,63
8,8482078,Lucas Raymond,L,DET,22,81,25,38,63
8,8481711,Matias Maccelli,L,UTA,24,79,21,42,63
8,8477504,Josh Morrissey,D,WPG,29,76,16,47,63
8,8474150,Mikael Backlund,C,CGY,35,79,16,46,62
8,8474578,Erik Karlsson,D,PIT,34,79,15,47,62
8,8484166,Adam Fantilli,C,CBJ,20,69,31,30,61
8,8482665,Matty Beniers,C,SEA,22,72,25,36,61
8,8477940,Nikolaj Ehlers,L,WPG,28,76,22,39,61
8,8476456,Jonathan Huberdeau,C,CGY,31,78,11,50,61
8,8475786,Zach Hyman,L,EDM,32,77,31,29,60
8,8476539,Jonathan Marchessault,R,NSH,34,77,30,30,60
8,8478047,Michael Bunting,L,PIT,29,68,23,37,60
8,8475745,Charlie Coyle,C,BOS,32,76,22,38,60
8,8471724,Kris Letang,D,PIT,37,77,9,51,60
8,8478493,Joel Eriksson Ek,C,MIN,27,70,30,29,59
8,8477407,Anthony Duclair,L,NYI,29,74,29,30,59
8,8478873,Troy Terry,R,ANA,27,75,23,36,59
8,8477949,Alex Tuch,R,BUF,28,73,18,41,59
8,8478498,Jake DeBrusk,L,VAN,28,71,25,33,58
8,8478975,Mason Marchment,L,DAL,29,82,23,35,58
8,8477503,Max Domi,C,TOR,29,74,19,39,58
8,8478407,Vince Dunn,D,SEA,28,73,12,46,58
8,8481528,Dylan Cozens,C,BUF,23,69,28,29,57
8,8480018,Nick Suzuki,C,MTL,25,76,23,34,57
8,8477447,Shea Theodore,D,VGK,29,61,12,45,57
8,8480839,Rasmus Dahlin,D,BUF,24,68,9,48,57
8,8476881,Tomas Hertl,C,VGK,31,73,26,30,56
8,8476479,Phillip Danault,C,LAK,31,82,23,33,56
8,8484153,Leo Carlsson,C,ANA,20,71,23,33,56
8,8480015,Owen Tippett,R,PHI,25,79,21,35,56
8,8474590,John Carlson,D,WSH,34,72,10,46,56
8,8480039,Martin Necas,C,CAR,25,70,25,30,55
8,8474679,Gustav Nyquist,C,NSH,35,73,24,31,55
8,8475151,Kyle Palmieri,C,NYI,33,75,24,31,55
8,8482113,Anton Lundell,C,FLA,23,77,24,31,55
8,8475765,Vladimir Tarasenko,R,DET,33,79,21,34,55
8,8479425,Filip Hronek,D,VAN,27,74,7,48,55
8,8479325,Charlie McAvoy,D,BOS,27,77,4,51,55
8,8477426,Nicholas Paul,L,TBL,29,82,33,21,54
8,8477964,Ivan Barbashev,C,VGK,29,78,23,31,54
8,8479385,Jordan Kyrou,C,STL,26,74,21,33,54
8,8477416,Oliver Bjorkstrand,R,SEA,29,70,19,35,54
8,8478440,Dylan Strome,C,WSH,27,74,16,38,54
8,8476906,Shayne Gostisbehere,D,CAR,31,76,14,40,54
8,8476905,Chandler Stephenson,C,SEA,30,75,10,44,54
8,8479400,Pierre-Luc Dubois,L,WSH,26,70,31,22,53
8,8478542,Evan Rodrigues,C,FLA,31,77,22,31,53
8,8480797,Joel Farabee,L,PHI,24,74,17,36,53
8,8481560,Arthur Kaliyev,R,LAK,23,80,28,24,52
8,8477497,Sean Monahan,C,CBJ,30,70,26,25,51
8,8476880,Tom Wilson,R,WSH,30,73,25,26,51
8,8477479,Tyler Bertuzzi,L,CHI,29,67,24,27,51
8,8480028,Morgan Frost,C,PHI,25,70,22,28,50
8,8481618,Alex Newhook,C,MTL,23,71,16,34,50
8,8482146,Luke Evangelista,R,NSH,22,68,24,25,49
8,8476882,Teuvo Teravainen,C,CHI,30,69,22,27,49
8,8478462,Nicolas Roy,C,VGK,27,78,17,32,49
8,8473512,Claude Giroux,R,OTT,36,79,14,35,49
8,8478038,Devon Toews,D,COL,30,69,12,37,49
8,8482684,Luke Hughes,D,NJD,21,69,10,39,49
8,8477955,Jared McCann,L,SEA,28,73,21,27,48
8,8477429,Andrew Copp,C,DET,30,81,20,28,48
8,8477986,Brandon Montour,D,SEA,30,74,17,31,48
8,8483515,Juraj Slafkovsky,L,MTL,20,75,15,33,48
8,8475726,Tyler Toffoli,C,SJS,32,69,28,19,47
8,8482110,Dawson Mercer,C,NJD,23,72,17,30,47
8,8477495,Seth Jones,D,CHI,30,68,16,31,47
8,8479410,Mikhail Sergachev,D,UTA,26,70,7,40,47
8,8476853,Morgan Rielly,D,TOR,30,67,5,42,47
8,8475799,Nino Niederreiter,R,WPG,32,72,33,13,46
8,8482109,Alexis Lafrenière,L,NYR,23,69,26,20,46
8,8475191,Reilly Smith,R,NYR,33,74,23,23,46
8,8476399,Blake Coleman,C,CGY,33,75,19,27,46
8,8475170,Brayden Schenn,C,STL,33,73,16,30,46
8,8470613,Brent Burns,D,CAR,39,75,10,36,46
8,8476483,Rickard Rakell,R,PIT,31,68,26,19,45
8,8475314,Anders Lee,L,NYI,34,79,22,23,45
8,8478856,Conor Garland,R,VAN,28,68,22,23,45
8,8477451,Ryan Hartman,R,MIN,30,72,20,25,45
8,8478466,Daniel Sprong,R,VAN,27,73,20,25,45
8,8476292,Ondrej Palat,L,NJD,33,73,18,27,45
8,8477511,Anthony Mantha,R,CGY,30,74,18,27,45
8,8476826,Yanni Gourde,C,SEA,33,73,17,28,45
8,8482720,Matthew Knies,L,TOR,22,73,14,31,45
8,8479351,Sam Steel,C,DAL,26,82,14,31,45
8,8483505,Matthew Poitras,C,BOS,20,76,13,32,45
8,8477932,Aaron Ekblad,D,FLA,28,76,11,34,45
8,8475764,Cam Fowler,D,ANA,33,75,8,37,45
8,8482667,William Eklund,L,SJS,22,66,23,21,44
8,8482159,Tyson Foerster,R,PHI,22,76,22,22,44
8,8475169,Evander Kane,L,EDM,33,76,22,22,44
8,8480009,Eeli Tolvanen,R,SEA,25,77,17,27,44
8,8483808,Andrei Kuzmenko,L,CGY,28,76,17,27,44
8,8478401,Pavel Zacha,C,BOS,27,79,16,28,44
8,8476875,Mike Matheson,D,MTL,30,69,14,30,44
8,8480798,Philipp Kurashev,C,CHI,25,61,14,30,44
8,8477346,MacKenzie Weegar,D,CGY,30,72,9,35,44
8,8477998,Warren Foegele,L,LAK,28,78,24,19,43
8,8478046,Danton Heinen,L,VAN,29,68,21,22,43
8,8482745,Mason McTavish,C,ANA,21,69,21,22,43
8,8484145,Zach Benson,L,BUF,19,71,19,24,43
8,8481596,Shane Pinto,C,OTT,24,77,18,25,43
8,8475287,Erik Haula,L,NJD,33,78,17,26,43
8,8476872,Scott Laughton,C,PHI,30,72,17,26,43
8,8476927,Teddy Blueger,C,VAN,30,72,17,26,43
8,8479365,Trent Frederic,C,BOS,26,74,15,28,43
8,8475798,Mikael Granlund,C,SJS,32,72,10,33,43
8,8478366,Frank Vatrano,R,ANA,30,75,29,13,42
8,8480064,Josh Norris,C,OTT,25,77,27,15,42
8,8478474,Lawson Crouse,L,UTA,27,75,22,19,41
8,8478519,Anthony Cirelli,C,TBL,27,81,21,20,41
8,8480220,Noah Cates,L,PHI,25,73,16,25,41
8,8480849,Barrett Hayton,C,UTA,24,71,16,25,41
8,8478458,John (Jack) Roslovic,C,CAR,27,67,16,25,41
8,8478469,Thomas Chabot,D,OTT,27,75,9,32,41
8,8474565,Alex Pietrangelo,D,VGK,34,64,9,32,41
8,8473986,Alex Killorn,L,ANA,35,75,21,19,40
8,8477444,Andre Burakovsky,L,SEA,29,72,18,22,40
8,8477021,Alex Kerfoot,C,UTA,30,72,15,25,40
8,8481524,Bowen Byram,D,BUF,23,74,11,29,40
8,8480145,Neal Pionk,D,WPG,29,77,10,30,40
8,8478396,Noah Hanifin,D,VGK,27,63,8,32,40
8,8477919,Frederick Gaudreau,C,MIN,31,63,19,20,39
8,8475794,Tyler Seguin,C,DAL,32,80,18,21,39
8,8481604,Pavel Dorofeyev,L,VGK,24,70,18,21,39
8,8480185,Eetu Luostarinen,C,FLA,26,74,17,22,39
8,8480078,Filip Chytil,C,NYR,25,65,15,24,39
8,8471698,T.J. Oshie,R,WSH,38,65,15,24,39
8,8481656,Aliaksei Protas,C,WSH,23,66,15,24,39
8,8480434,Sean Durzi,D,UTA,26,73,12,27,39
8,8474563,Drew Doughty,D,LAK,35,72,10,29,39
8,8475714,Calle Jarnkrok,C,TOR,33,79,21,17,38
8,8482097,Jack Quinn,R,BUF,23,64,19,19,38
8,8474586,Jordan Eberle,R,SEA,34,72,18,20,38
8,8480829,Jesperi Kotkaniemi,C,CAR,24,64,17,21,38
8,8482125,Alexander Holtz,R,VGK,22,69,15,23,38
8,8480871,Adam Boqvist,D,FLA,24,65,12,26,38
8,8481581,Thomas Harley,D,DAL,23,74,11,27,38
8,8474716,Jared Spurgeon,D,MIN,35,77,11,27,38
8,8475218,Mattias Ekholm,D,EDM,34,75,11,27,38
8,8478055,Gustav Forsling,D,FLA,28,73,10,28,38
8,8482671,Owen Power,D,BUF,22,72,6,32,38
8,8483490,Pavel Mintyukov,D,ANA,21,74,5,33,38
8,8480014,Gabriel Vilardi,C,WPG,25,64,21,16,37
8,8479661,Tanner Jeannot,L,LAK,27,76,19,18,37
8,8474641,Adam Henrique,C,EDM,34,74,17,20,37
8,8482149,Cole Perfetti,C,WPG,22,67,16,21,37
8,8478438,Tommy Novak,C,NSH,27,69,13,24,37
8,8479339,Patrik Laine,L,CBJ,26,72,12,25,37
8,8476792,Torey Krug,D,STL,33,67,12,25,37
8,8481533,Trevor Zegras,C,ANA,23,73,10,27,37
8,8481542,Moritz Seider,D,DET,23,76,9,28,37
8,8476854,Hampus Lindholm,D,BOS,30,73,9,28,37
8,8476869,Brady Skjei,D,NSH,30,74,8,29,37
8,8477948,Travis Sanheim,D,PHI,28,70,6,31,37
8,8481554,Kaapo Kakko,R,NYR,23,71,17,19,36
8,8475149,Marcus Johansson,L,MIN,34,69,16,20,36
8,8479987,Morgan Geekie,C,BOS,26,77,15,21,36
8,8476480,Vladislav Namestnikov,C,WPG,32,69,15,21,36
8,8475793,Ryan Johansen,C,PHI,32,70,14,22,36
8,8475768,Jaden Schwartz,C,SEA,32,68,14,22,36
8,8481577,Philip Tomasino,C,NSH,23,70,9,27,36
8,8476438,Brandon Saad,L,STL,32,74,18,17,35
8,8481186,Logan O'Connor,R,COL,28,80,16,19,35
8,8477839,Conor Sheary,L,TBL,32,80,15,20,35
8,8475848,Brendan Gallagher,R,MTL,32,71,14,21,35
8,8474102,David Perron,L,OTT,36,74,13,22,35
8,8480188,Fabian Zetterlund,L,SJS,25,66,12,23,35
8,8476462,Dougie Hamilton,D,NJD,31,76,12,23,35
8,8476925,Colton Sissons,C,NSH,31,69,12,23,35
8,8481703,Valtteri Puustinen,R,PIT,25,66,9,26,35
8,8475791,Taylor Hall,L,CHI,33,59,9,26,35
8,8476458,Ryan Strome,C,ANA,31,67,7,28,35
8,8477506,Ryan Pulock,D,NYI,30,76,6,29,35
8,8481606,Jordan Spence,D,LAK,23,59,3,32,35
8,8481535,Nils Hoglander,L,VAN,24,69,18,16,34
8,8476419,Jean-Gabriel Pageau,C,NYI,32,77,15,19,34
8,8478042,Viktor Arvidsson,L,EDM,31,70,14,20,34
8,8478233,Andrew Mangiapane,L,WSH,28,66,12,22,34
8,8474149,Evgenii Dadonov,R,DAL,35,78,9,25,34
8,8475200,Dmitry Orlov,D,CAR,33,74,9,25,34
8,8482122,Brock Faber,D,MIN,22,78,6,28,34
8,8475753,Justin Faulk,D,STL,32,68,4,30,34
8,8476923,Damon Severson,D,CBJ,30,80,3,31,34
8,8479525,Ross Colton,C,COL,28,80,21,12,33
8,8476432,Boone Jenner,C,CBJ,31,69,18,15,33
8,8482055,Drew O'Connor,L,PIT,26,63,18,15,33
8,8477478,William Carrier,L,CAR,30,61,16,17,33
8,8479992,Michael Rasmussen,C,DET,25,78,13,20,33
8,8482660,Kent Johnson,C,CBJ,22,71,13,20,33
8,8479996,Cody Glass,C,NSH,25,57,13,20,33
8,8475193,Tomas Tatar,L,NJD,34,69,13,20,33
8,8484203,Bradly Nadeau,L,CAR,19,73,12,21,33
8,8474053,Logan Couture,C,SJS,35,60,12,21,33
8,8482702,Logan Stankoven,C,DAL,21,80,11,22,33
8,8483445,Cutter Gauthier,L,ANA,20,60,10,23,33
8,8480802,Ryan McLeod,C,BUF,25,69,10,23,33
8,8477435,Ryan Graves,D,PIT,29,79,7,26,33
8,8475763,Kevin Hayes,R,PIT,32,67,6,27,33
8,8473563,Nicklas Backstrom,C,WSH,37,57,5,28,33
8,8476463,Jonas Brodin,D,MIN,31,77,4,29,33
8,8480113,Alex Iafallo,L,WPG,31,60,16,16,32
8,8475722,Jason Zucker,L,BUF,32,64,15,17,32
8,8480459,Pius Suter,C,VAN,28,71,13,19,32
8,8482133,Thomas Bordeleau,C,SJS,22,65,13,19,32
8,8477505,Alexander Wennberg,C,SJS,30,64,7,25,32
8,8470621,Corey Perry,R,EDM,39,73,22,9,31
8,8482475,Yegor Chinakhov,R,CBJ,23,63,17,14,31
8,8474189,Lars Eller,C,PIT,35,58,17,14,31
8,8480855,Jack McBain,C,UTA,24,66,14,17,31
8,8481624,Ilya Mikheyev,R,CHI,30,63,11,20,31
8,8482105,Jake Sanderson,D,OTT,22,68,9,22,31
8,8477498,Darnell Nurse,D,EDM,29,72,7,24,31
8,8476958,Jaccob Slavin,D,CAR,30,71,4,27,31
8,8478020,Michael Amadio,R,OTT,28,77,19,11,30
8,8482705,Cole Sillinger,C,CBJ,21,68,14,16,30
8,8476278,Colin Blackwell,C,DAL,31,80,14,16,30
8,8479591,Michael Eyssimont,C,TBL,28,81,14,16,30
8,8475760,Nick Bjugstad,C,UTA,32,72,13,17,30
8,8477507,Nikita Zadorov,D,BOS,29,73,12,18,30
8,8477425,Miles Wood,L,COL,29,80,11,19,30
8,8482712,Oskar Olausson,R,COL,22,76,10,20,30
8,8478891,Mason Appleton,C,WPG,28,63,10,20,30
8,8477969,Marcus Pettersson,D,PIT,28,79,6,24,30
8,8482175,JJ Peterka,R,BUF,22,63,20,9,29
8,8483457,Lane Hutson,D,MTL,20,61,18,11,29
8,8476921,Jordan Martinook,L,CAR,32,61,16,13,29
8,8478413,Jordan Greenway,L,BUF,27,69,14,15,29
8,8479345,Jakob Chychrun,D,WSH,26,65,12,17,29
8,8478115,Pierre Engvall,L,NYI,28,77,11,18,29
8,8480068,Ryan Poehling,C,PHI,25,71,11,18,29
8,8482111,Justin Barron,D,MTL,23,71,11,18,29
8,8476902,Esa Lindell,D,DAL,30,77,4,25,29
8,8478508,Yakov Trenin,C,MIN,27,57,20,8,28
8,8481582,Nicholas Robertson,L,TOR,23,69,13,15,28
8,8481553,Bobby Brink,R,PHI,23,62,13,15,28
8,8481704,Juuso Parssinen,C,NSH,23,62,12,16,28
8,8478507,John Marino,D,UTA,27,66,4,24,28
8,8482074,Connor Zary,C,CGY,23,69,18,9,27
8,8480893,Kirill Marchenko,R,CBJ,24,67,16,11,27
8,8483493,Frank Nazar,C,CHI,20,61,15,12,27
8,8477353,Tyler Motte,C,DET,29,70,12,15,27
8,8478057,Dakota Joshua,C,VAN,28,56,11,16,27
8,8477987,Ryan Donato,C,CHI,28,57,11,16,27
8,8482079,Marco Rossi,C,MIN,23,59,11,16,27
8,8476329,Travis Boyd,C,MIN,31,57,11,16,27
8,8476392,Adam Lowry,C,WPG,31,61,9,18,27
8,8478472,Mathieu Joseph,R,STL,27,69,8,19,27
8,8475233,David Savard,D,MTL,34,66,8,19,27
8,8479639,Dylan Coghlan,D,WPG,26,63,5,22,27
8,8476885,Jacob Trouba,D,NYR,30,67,5,22,27
8,8474151,Ryan McDonagh,D,TBL,35,76,4,23,27
8,8480205,Emil Bemstrom,C,PIT,25,60,13,13,26
8,8477220,Nate Schmidt,D,FLA,33,68,11,15,26
8,8477508,Curtis Lazar,C,NJD,29,52,11,15,26
8,8478136,Jake Middleton,D,MIN,28,75,8,18,26
8,8474673,TJ Brodie,D,CHI,34,63,8,18,26
8,8480144,David Kampf,C,TOR,29,71,7,19,26
8,8483499,Liam Ohgren,L,MIN,20,60,7,19,26
8,8481523,Kirby Dach,C,MTL,23,65,6,20,26
8,8479983,Mario Ferraro,D,SJS,26,70,5,21,26
8,8480817,K'Andre Miller,D,NYR,24,71,4,22,26
8,8479976,Juuso Valimaki,D,UTA,26,70,4,22,26
8,8479982,Conor Timmins,D,TOR,26,65,4,22,26
8,8480049,Dylan Samberg,D,WPG,25,64,2,24,26
8,8482655,Janis Moser,D,TBL,24,78,1,25,26
8,8482089,Jake Neighbours,L,STL,22,69,16,9,25
8,8482092,Ridly Greig,C,OTT,22,77,11,14,25
8,8482101,Danil Gushchin,L,SJS,22,60,11,14,25
8,8478109,Victor Olofsson,L,VGK,29,70,11,14,25
8,8482142,Jamie Drysdale,D,PHI,22,67,9,16,25
8,8476461,Sean Couturier,C,PHI,32,62,8,17,25
8,8478882,Vladislav Gavrikov,D,LAK,29,68,7,18,25
8,8476917,Adam Pelech,D,NYI,30,79,6,19,25
8,8475171,Oliver Ekman-Larsson,D,TOR,33,65,6,19,25
8,8476979,Erik Gustafsson,D,DET,32,77,5,20,25
8,8475181,Nick Leddy,D,STL,33,71,4,21,25
8,8483468,Jiri Kulich,C,BUF,20,62,4,21,25
8,8477488,Brett Pesce,D,NJD,30,68,2,23,25
8,8473507,Jeff Petry,D,DET,37,74,1,24,25
8,8479619,Michael Carcone,L,UTA,28,62,14,10,24
8,8477952,Robby Fabbri,C,ANA,28,61,14,10,24
8,8476374,Sean Kuraly,C,CBJ,31,57,13,11,24
8,8477903,Garnet Hathaway,R,PHI,33,62,12,12,24
8,8476960,Andreas Athanasiou,C,CHI,30,54,12,12,24
8,8476981,Josh Anderson,R,MTL,30,71,9,15,24
8,8476312,Josh Manson,D,COL,33,62,9,15,24
8,8482062,Cole Smith,L,NSH,29,54,9,15,24
8,8477392,Hudson Fasching,R,NYI,29,67,9,15,24
8,8479718,Alex Barré-Boulet,C,MTL,27,58,9,15,24
8,8477989,Christian Dvorak,C,MTL,28,66,8,16,24
8,8480878,Nils Lundkvist,D,DAL,24,68,5,19,24
8,8478970,Jalen Chatfield,D,CAR,28,75,5,19,24
8,8478500,Ivan Provorov,D,CBJ,27,77,4,20,24
8,8476856,Mathew Dumba,D,DAL,30,68,3,21,24
8,8480748,Kiefer Sherwood,L,VAN,29,58,15,8,23
8,8480813,Joe Veleno,C,DET,24,76,14,9,23
8,8482679,Matt Coronato,R,CGY,22,70,13,10,23
8,8478432,Christian Fischer,R,DET,27,76,12,11,23
8,8477953,Kasperi Kapanen,R,STL,28,67,11,12,23
8,8479393,Noah Gregor,L,OTT,26,68,11,12,23
8,8481481,Blake Lizotte,C,PIT,27,56,11,12,23
8,8479390,Taylor Raddysh,R,WSH,26,65,9,14,23
8,8481521,Ronnie Attard,D,PHI,25,64,9,14,23
8,8475220,Marcus Foligno,L,MIN,33,58,8,15,23
8,8481014,Alexander Romanov,D,NYI,24,80,4,19,23
8,8480807,Mattias Samuelsson,D,BUF,24,56,3,20,23
8,8476892,Colton Parayko,D,STL,31,75,1,22,23
8,8482749,Joshua Roy,R,MTL,21,58,11,11,22
8,8483524,Shane Wright,C,SEA,20,58,11,11,22
8,8473533,Jordan Staal,C,CAR,36,61,11,11,22
8,8482809,Jackson Blake,R,CAR,21,60,11,11,22
8,8473453,Trevor Lewis,C,LAK,37,71,11,11,22
8,8480281,Alexey Toropchenko,R,STL,25,58,10,12,22
8,8482117,Lukas Reichel,L,CHI,22,57,9,13,22
8,8480003,Jesper Boqvist,C,FLA,26,66,8,14,22
8,8480336,Sean Walker,D,CAR,30,73,7,15,22
8,8478013,Jake Walman,D,SJS,28,68,7,15,22
8,8476474,Stefan Noesen,R,NJD,31,65,6,16,22
8,8476967,Brett Kulak,D,EDM,30,60,6,16,22
8,8480789,Oliver Wahlstrom,R,NYI,24,70,5,17,22
8,8482073,Braden Schneider,D,NYR,23,67,5,17,22
8,8481568,Alex Vlasic,D,CHI,23,56,4,18,22
8,8476931,Jake McCabe,D,TOR,31,67,2,20,22
8,8475790,Erik Gudbranson,D,CBJ,32,73,2,20,22
8,8479336,Carl Grundstrom,R,SJS,27,48,16,5,21
8,8478463,Anthony Beauvillier,L,PIT,27,69,13,8,21
8,8479293,Brandon Tanev,L,SEA,33,70,11,10,21
8,8476469,Joel Armia,R,MTL,31,66,10,11,21
8,8473422,Nick Foligno,L,CHI,37,60,10,11,21
8,8479353,Brett Howden,C,VGK,26,70,10,11,21
8,8479316,Luke Kunin,C,SJS,27,58,10,11,21
8,8479066,Ryan Lomberg,L,CGY,30,66,9,12,21
8,8477369,Carson Soucy,D,VAN,30,65,7,14,21
8,8482067,Connor Mackey,D,NYR,28,64,6,15,21
8,8478851,Alexandre Carrier,D,NSH,28,71,4,17,21
8,8479414,Nathan Bastian,R,NJD,27,63,13,7,20
8,8479368,Max Jones,L,BOS,26,68,12,8,20
8,8478569,Noel Acciari,C,PIT,33,65,12,8,20
8,8476934,Brock McGinn,L,ANA,30,50,11,9,20
8,8474715,Cameron Atkinson,R,TBL,35,81,10,10,20
8,8480980,Connor Dewar,C,TOR,25,69,8,12,20
8,8479442,Troy Stecher,D,EDM,30,55,8,12,20
8,8475343,Nic Dowd,C,WSH,34,62,7,13,20
8,8482803,Olen Zellweger,D,ANA,21,68,7,13,20
8,8480995,Pontus Holmberg,R,TOR,25,66,7,13,20
8,8478585,Derek Ryan,C,EDM,38,65,7,13,20
8,8480025,MacKenzie Entwistle,R,FLA,25,60,6,14,20
8,8482192,Isaak Phillips,D,CHI,23,54,5,15,20
8,8475179,Dmitry Kulikov,D,FLA,34,60,4,16,20
8,8475324,Nick Jensen,D,OTT,34,65,4,16,20
8,8480762,Eric Robinson,L,CAR,29,54,3,17,20
8,8476467,Jamie Oleksiak,D,SEA,32,75,3,17,20
8,8480043,Timothy Liljegren,D,TOR,25,67,2,18,20
8,8474574,Tyler Myers,D,VAN,34,72,2,18,20
8,8480727,Zach Whitecloud,D,VGK,28,56,2,18,20
8,8476331,Dylan DeMelo,D,WPG,31,74,2,18,20
8,8480074,Alexandre Texier,C,STL,25,54,15,4,19
8,8481716,Dmitri Voronkov,L,CBJ,24,49,12,7,19
8,8476858,Phillip Di Giuseppe,L,VAN,31,49,12,7,19
8,8481522,Peyton Krebs,C,BUF,23,58,8,11,19
8,8480835,Jack Drury,C,CAR,24,57,7,12,19
8,8478911,Matt Roy,D,WSH,29,58,6,13,19
8,8482624,Daniil Miromanov,D,CGY,27,67,6,13,19
8,8479980,Nicolas Hague,D,VGK,26,53,6,13,19
8,8476422,Mike Reilly,D,NYI,31,73,6,13,19
8,8480073,Erik Brannstrom,D,COL,25,61,5,14,19
8,8477450,Jason Dickinson,C,CHI,29,53,5,14,19
8,8476525,Colin Miller,D,WPG,32,61,5,14,19
8,8482087,Kaiden Guhle,D,MTL,22,62,4,15,19
8,8480222,Sebastian Aho,D,PIT,28,69,3,16,19
8,8479370,Tyson Jost,C,CAR,26,48,10,8,18
8,8483491,Ivan Miroshnichenko,L,WSH,20,54,9,9,18
8,8475855,Jesper Fast,R,CAR,33,55,6,12,18
8,8477947,Sonny Milano,L,WSH,28,60,5,13,18
8,8476457,Adam Larsson,D,SEA,32,67,4,14,18
8,8476429,Scott Mayfield,D,NYI,32,77,3,15,18
8,8480891,Michael Kesselring,D,UTA,24,54,2,16,18
8,8481580,Connor McMichael,C,WSH,23,57,13,4,17
8,8480448,Parker Kelly,L,COL,25,72,9,8,17
8,8480289,Morgan Barron,C,WPG,26,60,9,8,17
8,8477979,Nicolas Aube-Kubel,R,BUF,28,53,9,8,17
8,8478434,Keegan Kolesar,R,VGK,27,61,8,9,17
8,8476918,Jimmy Vesey,L,NYR,31,64,6,11,17
8,8481441,Joe Snively,C,DET,28,64,6,11,17
8,8476873,Mark Jankowski,C,NSH,30,45,5,12,17
8,8480873,Rasmus Sandin,D,WSH,24,63,3,14,17
8,8476988,Matt Benning,D,SJS,30,59,3,14,17
8,8478178,Darren Raddysh,D,TBL,28,70,3,14,17
8,8475690,Chris Tanev,D,TOR,35,58,1,16,17
8,8478043,Sam Lafferty,C,BUF,29,57,11,5,16
8,8476878,Zemgus Girgensons,C,TBL,30,81,11,5,16
8,8481093,Rafael Harvey-Pinard,L,MTL,25,60,9,7,16
8,8479941,Justin Danforth,R,CBJ,31,45,9,7,16
8,8476889,Radek Faksa,C,STL,30,67,9,7,16
8,8482737,Zack Bolduc,C,STL,21,62,8,8,16
8,8482157,Will Cuylle,L,NYR,22,61,8,8,16
8,8480806,Isac Lundestrom,C,ANA,25,58,8,8,16
8,8481617,Vasily Podkolzin,R,VAN,23,50,8,8,16
8,8481546,Cam York,D,PHI,23,62,7,9,16
8,8475231,Casey Cizikas,C,NYI,33,71,7,9,16
8,8479402,Jake Bean,D,CGY,26,62,6,10,16
8,8482730,Brandt Clarke,D,LAK,21,53,6,10,16
8,8478133,Jake Evans,C,MTL,28,67,5,11,16
8,8484149,Gavin Brindley,C,CBJ,20,46,5,11,16
8,8475188,Brayden McNabb,D,VGK,33,49,4,12,16
8,8476879,Cody Ceci,D,EDM,31,71,3,13,16
8,8479026,Philippe Myers,D,TOR,27,56,3,13,16
8,8477845,Trevor van Riemsdyk,D,WSH,33,62,3,13,16
8,8480246,Nick Perbix,D,TBL,26,75,2,14,16
8,8478416,Erik Cernak,D,TBL,27,70,2,14,16
8,8479398,Samuel Girard,D,COL,26,64,1,15,16
8,8478859,Niko Mikkola,D,FLA,28,51,1,15,16
8,8471709,Marc-Edouard Vlasic,D,SJS,37,53,1,15,16
8,8477499,Rasmus Ristolainen,D,PHI,30,53,9,6,15
8,8481032,Paul Cotter,C,NJD,25,58,9,6,15
8,8481028,Martin Pospisil,C,CGY,25,52,9,6,15
8,8478421,A.J. Greer,L,FLA,28,60,9,6,15
8,8479344,Jesse Puljujarvi,R,PIT,26,43,7,8,15
8,8481641,Joel Kiviranta,L,COL,28,71,6,9,15
8,8482807,Ethan Del Mastro,D,CHI,21,42,6,9,15
8,8481754,Nikita Nesterenko,C,ANA,23,36,6,9,15
8,8476624,Barclay Goodrow,C,SJS,31,58,5,10,15
8,8476874,Olli Maatta,D,DET,30,59,5,10,15
8,8481537,Nikita Okhotiuk,D,CGY,24,53,4,11,15
8,8479371,Dante Fabbro,D,NSH,26,59,3,12,15
8,8481600,Tobias Bjornfot,D,FLA,23,43,3,12,15
8,8475462,Radko Gudas,D,ANA,34,64,2,13,15
8,8478443,Brandon Carlo,D,BOS,28,63,2,13,15
8,8478840,Will Borgen,D,SEA,28,59,1,14,15
8,8480035,Henri Jokiharju,D,BUF,25,53,1,14,15
8,8482259,Bobby McMann,C,TOR,28,51,11,3,14
8,8483482,Tristan Luneau,D,ANA,20,57,7,7,14
8,8479439,Jacob MacDonald,D,COL,31,60,7,7,14
8,8481477,Nico Sturm,C,SJS,29,49,7,7,14
8,8481592,Jakob Pelletier,L,CGY,23,37,7,7,14
8,8476897,Oskar Sundqvist,C,STL,30,62,6,8,14
8,8477070,Liam O'Brien,C,UTA,30,54,5,9,14
8,8480070,Ian Mitchell,D,BOS,25,43,5,9,14
8,8479315,Joey Anderson,R,CHI,26,45,4,10,14
8,8481751,Lukas Rousek,R,BUF,25,43,4,10,14
8,8481019,David Gustafsson,C,WPG,24,49,4,10,14
8,8476952,Dominic Toninato,C,WPG,30,37,4,10,14
8,8478451,Ethan Bear,D,WSH,27,53,4,10,14
8,8475750,Jon Merrill,D,MIN,32,58,2,12,14
8,8480001,Urho Vaakanainen,D,ANA,25,57,2,12,14
8,8479543,Michael Pezzetta,L,MTL,26,52,2,12,14
8,8479998,Mikey Anderson,D,LAK,25,62,2,12,14
8,8478468,Jeremy Lauzon,D,NSH,27,55,2,12,14
8,8481599,Victor Soderstrom,D,UTA,23,51,2,12,14
8,8477446,Michael McCarron,R,NSH,29,53,10,3,13
8,8480011,Klim Kostin,C,SJS,25,58,8,5,13
8,8477406,Mattias Janmark,C,EDM,32,59,7,6,13
8,8480441,Trey Fix-Wolansky,R,CBJ,25,34,6,7,13
8,8481532,Alex Turcotte,C,LAK,23,42,6,7,13
8,8476473,Connor Murphy,D,CHI,31,38,5,8,13
8,8483549,Lucas Condotta,L,MTL,27,40,4,9,13
8,8480007,Jonas Rondbjerg,R,VGK,25,42,4,9,13
8,8479981,Jonah Gadjovich,L,FLA,26,47,4,9,13
8,8477015,Connor Brown,R,EDM,30,58,3,10,13
8,8477365,Connor Clifton,D,BUF,29,55,3,10,13
8,8483565,Nick Blankenburg,D,NSH,26,53,2,11,13
8,8478399,Jonas Siegenthaler,D,NJD,27,66,2,11,13
8,8482245,Artem Zub,D,OTT,29,71,2,11,13
8,8479372,Joshua Mahura,D,SEA,26,45,2,11,13
8,8481056,Spencer Stastney,D,NSH,24,37,2,11,13
8,8481178,Egor Zamula,D,PHI,24,58,1,12,13
8,8480860,Kevin Bahl,D,CGY,24,54,1,12,13
8,8474013,Ian Cole,D,UTA,35,48,1,12,13
8,8474090,Brendan Smith,D,DAL,35,55,1,12,13
8,8479328,Julien Gauthier,R,NYI,27,61,8,4,12
8,8478831,Kevin Stenlund,C,UTA,28,53,8,4,12
8,8480355,Mark Kastelic,C,BOS,25,60,7,5,12
8,8482784,Zach Dean,C,STL,21,42,7,5,12
8,8481517,Brett Leason,R,ANA,25,58,7,5,12
8,8478211,Dryden Hunt,L,CGY,29,51,6,6,12
8,8475225,Craig Smith,C,CHI,35,44,5,7,12
8,8480021,Jack Studnicka,C,LAK,25,57,5,7,12
8,8482148,Hendrix Lapierre,C,WSH,22,55,5,7,12
8,8482634,Alex Steeves,C,TOR,25,41,5,7,12
8,8477482,Zachary Sanford,L,CHI,30,41,5,7,12
8,8480058,Pierre-Olivier Joseph,D,STL,25,54,5,7,12
8,8471677,Jack Johnson,D,CBJ,37,62,4,8,12
8,8482744,James Malatesta,L,CBJ,21,43,4,8,12
8,8483495,Simon Nemec,D,NJD,20,52,4,8,12
8,8480950,Ilya Lyubushkin,D,DAL,30,62,3,9,12
8,8480172,Jan Rutta,D,SJS,34,70,3,9,12
8,8478452,Caleb Jones,D,LAK,27,57,2,10,12
8,8481708,Zac Jones,D,NYR,24,48,2,10,12
8,8481567,Henry Thrun,D,SJS,23,53,2,10,12
8,8474567,Zach Bogosian,D,MIN,34,68,2,10,12
8,8475208,Brian Dumoulin,D,ANA,33,62,1,11,12
8,8482155,Alex Laferriere,R,LAK,23,68,9,2,11
8,8482077,Dylan Holloway,L,EDM,23,50,8,3,11
8,8476822,Luke Glendening,C,TBL,35,79,6,5,11
8,8481013,Jonatan Berggren,R,DET,24,55,6,5,11
8,8477018,Ben Hutton,D,VGK,31,45,6,5,11
8,8478017,Mark Friedman,D,VAN,29,39,6,5,11
8,8479291,Kevin Rooney,C,CGY,31,44,6,5,11
8,8477931,Tomas Nosek,L,FLA,32,55,5,6,11
8,8482070,Mitchell Chaffee,R,TBL,26,52,5,6,11
8,8479968,Vinni Lettieri,C,BOS,29,41,5,6,11
8,8477380,Jonny Brodzinski,C,NYR,31,50,4,7,11
8,8477034,Jaycob Megna,D,FLA,32,46,4,7,11
8,8479536,Axel Jonsson-Fjallby,L,WPG,26,36,4,7,11
8,8478424,Jansen Harkins,C,ANA,27,38,4,7,11
8,8474034,Patrick Maroon,L,CHI,36,50,3,8,11
8,8482176,Wyatt Kaiser,D,CHI,22,59,3,8,11
8,8470600,Ryan Suter,D,STL,39,60,3,8,11
8,8482166,Shakir Mukhamadullin,D,SJS,22,60,3,8,11
8,8483460,David Jiricek,D,CBJ,21,62,2,9,11
8,8481605,Jackson LaCombe,D,ANA,23,35,2,9,11
8,8476891,Matthew Grzelcyk,D,PIT,30,76,1,10,11
8,8479671,Mathieu Olivier,R,CBJ,27,54,1,10,11
8,8475718,Justin Holl,D,DET,32,64,1,10,11
8,8480887,Jordan Harris,D,MTL,24,55,1,10,11
8,8474568,Luke Schenn,D,NSH,35,50,1,10,11
8,8479324,Ryan Lindgren,D,NYR,26,62,0,11,11
8,8482145,Mavrik Bourque,C,DAL,22,52,7,3,10
8,8481601,Simon Holmstrom,R,NYI,23,71,6,4,10
8,8471817,Ryan Reaves,R,TOR,37,56,6,4,10
8,8480880,Jakub Lauko,C,MIN,24,31,5,5,10
8,8477401,John Hayden,C,SEA,29,30,5,5,10
8,8482733,Logan Mailloux,D,MTL,31,33,5,5,10
8,8480252,Cole Guttman,C,CHI,25,43,4,6,10
8,8479520,Brandon Duhaime,R,WSH,27,56,4,6,10
8,8475455,Brenden Dillon,D,NJD,34,60,4,6,10
8,8477887,Patrick Brown,C,BOS,32,50,4,6,10
8,8482451,Mikael Pyyhtia,L,CBJ,23,32,3,7,10
8,8481527,Kaedan Korczak,D,VGK,23,47,2,8,10
8,8474166,Alec Martinez,D,CHI,37,55,2,8,10
8,8480192,Johnathan Kovacevic,D,NJD,27,46,2,8,10
8,8483630,Pavol Regenda,L,ANA,25,34,2,8,10
8,8484254,Akito Hirose,D,VAN,25,40,1,9,10
8,8481059,Scott Perunovich,D,STL,26,57,0,10,10
8,8475279,Ben Chiarot,D,DET,33,63,0,10,10
8,8479638,Justin Brazeau,R,BOS,26,36,7,2,9
8,8482762,Simon Edvinsson,D,DET,21,57,6,3,9
8,8475842,Sam Carrick,C,NYR,32,59,6,3,9
8,8483466,Kevin Korchinski,D,CHI,20,44,5,4,9
8,8482141,Lukas Cormier,D,VGK,22,31,5,4,9
8,8476442,Matt Nieto,L,PIT,32,51,4,5,9
8,8479378,Logan Stanley,D,WPG,26,42,4,5,9
8,8479369,Andrew Peeke,D,BOS,26,55,3,6,9
8,8477962,Brendan Lemieux,L,CAR,28,42,3,6,9
8,8476994,Vinnie Hinostroza,C,NSH,30,51,3,6,9
8,8477938,Haydn Fleury,D,WPG,28,35,3,6,9
8,8481550,Adam Beckman,L,NJD,23,36,2,7,9
8,8477851,Jordan Oesterle,D,BOS,32,42,2,7,9
8,8479986,Kole Lind,R,DAL,26,44,2,7,9
8,8475762,Derek Forbort,D,VAN,32,42,1,8,9
8,8482659,Josh Doan,R,UTA,22,53,5,3,8
8,8481518,Nolan Foote,L,NJD,24,36,4,4,8
8,8481789,Tye Kartye,L,SEA,23,40,4,4,8
8,8482496,Nils Aman,C,VAN,24,39,4,4,8
8,8480848,Ty Dellandrea,C,SJS,24,43,3,5,8
8,8479944,Zach Aston-Reese,C,VGK,30,42,2,6,8
8,8482859,Zack Ostapchuk,C,OTT,21,49,2,6,8
8,8480990,Declan Chisholm,D,MIN,24,42,2,6,8
8,8482095,Tyler Kleven,D,OTT,22,43,1,7,8
8,8481147,Reese Johnson,C,MIN,26,40,5,2,7
8,8483619,Filip Roos,D,OTT,25,37,4,3,7
8,8481161,Jake Christiansen,D,CBJ,25,56,4,3,7
8,8482747,Brennan Othmann,L,NYR,21,40,3,4,7
8,8482153,Brendan Brisson,C,VGK,23,40,3,4,7
8,8476372,Nick Seeler,D,PHI,31,40,3,4,7
8,8480157,Calle Rosen,D,COL,30,49,2,5,7
8,8480796,Martin Fehervary,D,WSH,25,58,2,5,7
8,8476441,Joel Edmundson,D,LAK,31,41,2,5,7
8,8481167,Brayden Pachal,D,CGY,25,37,1,6,7
8,8477384,Joshua Brown,D,EDM,30,42,1,6,7
8,8479772,Zack MacEwen,R,OTT,28,58,4,2,6
8,8482652,Walker Duehr,R,CGY,27,40,4,2,6
8,8480844,Grigori Denisenko,L,VGK,24,32,3,3,6
8,8481556,John Beecher,C,BOS,23,32,3,3,6
8,8482964,Arber Xhekaj,D,MTL,23,49,2,4,6
8,8480845,Rasmus Kupari,C,WPG,24,45,2,4,6
8,8479576,Vincent Desharnais,D,VAN,28,35,2,4,6
8,8482666,Scott Morrow,D,CAR,22,48,2,4,6
8,8479348,Kale Clague,D,BUF,26,39,2,4,6
8,8477573,Nathan Walker,L,STL,30,42,1,5,6
8,8474612,Travis Hamonic,D,OTT,34,51,1,5,6
8,8475177,Calvin de Haan,D,COL,33,34,0,6,6
8,8480879,Jacob Bernard-Docker,D,OTT,24,43,0,6,6
8,8481578,Graeme Clarke,R,MIN,23,14,4,1,5
8,8482751,Ryan Winterton,C,SEA,21,31,3,2,5
8,8478146,Matthew Highmore,C,OTT,28,32,3,2,5
8,8475235,Nicolas Deslauriers,L,PHI,33,43,3,2,5
8,8479379,Givani Smith,R,SJS,26,34,3,2,5
8,8481679,Maxence Guenette,D,OTT,23,37,3,2,5
8,8480851,Akil Thomas,C,LAK,24,14,3,2,5
8,8481543,Nikita Alexandrov,C,STL,24,19,3,2,5
8,8479985,Cale Fleury,D,SEA,26,22,3,2,5
8,8481422,Jake Lucchini,C,NSH,29,16,3,2,5
8,8479972,Mason Shaw,C,WPG,26,31,2,3,5
8,8483397,Marc McLaughlin,C,BOS,25,29,2,3,5
8,8478874,Adam Gaudette,R,OTT,28,35,2,3,5
8,8477073,Kurtis MacDermid,L,NJD,30,31,2,3,5
8,8481609,Vladislav Kolyachonok,D,UTA,23,30,2,3,5
8,8478502,Dennis Gilbert,D,BUF,28,20,2,3,5
8,8482144,Jack Thompson,D,SJS,22,31,2,3,5
8,8482516,Matthew Kessel,D,STL,24,25,2,3,5
8,8481585,Egor Afanasyev,L,SJS,23,14,2,3,5
8,8473446,Erik Johnson,D,PHI,36,50,1,4,5
8,8481701,Santeri Hatakka,D,NJD,23,37,1,4,5
8,8480834,Ty Emberson,D,SJS,24,28,1,4,5
8,8478454,Noah Juulsen,D,VAN,27,34,1,4,5
8,8484258,Sam Malinski,D,COL,26,27,1,4,5
8,8480890,Jan Jenik,C,OTT,24,29,1,4,5
8,8477335,Kyle Burroughs,D,LAK,29,44,0,5,5
8,8479249,Andrew Poturalski,C,SJS,30,30,0,5,5
8,8475958,Michael Sgarbossa,C,WSH,32,27,3,1,4
8,8483570,Ben Meyers,C,SEA,26,28,3,1,4
8,8479320,Maxime Lajoie,D,SEA,27,25,3,1,4
8,8479359,Beck Malenstyn,L,BUF,26,40,2,2,4
8,8476913,Devin Shore,C,MIN,30,31,2,2,4
8,8482511,Mason Lohrei,D,BOS,23,31,2,2,4
8,8482765,Isak Rosen,R,BUF,21,31,2,2,4
8,8483763,Maksymilian Szuber,D,UTA,22,26,2,2,4
8,8482470,Ilya Solovyov,D,CGY,24,26,2,2,4
8,8476867,Brendan Gaunce,C,MIN,30,30,1,3,4
8,8480870,Bo Groulx,C,NYR,24,33,1,3,4
8,8481743,Marc Del Gaizo,D,NSH,25,16,1,3,4
8,8482177,Marat Khusnutdinov,C,MIN,22,28,1,3,4
8,8478409,Anthony Richard,C,PHI,28,38,1,3,4
8,8481593,Jayden Struble,D,MTL,23,26,1,3,4
8,8481030,Jack St. Ivany,D,PIT,25,14,1,3,4
8,8483489,Fraser Minten,C,TOR,31,11,1,3,4
8,8481806,Louis Crevier,D,CHI,23,13,1,3,4
8,8478477,Mitchell Stephens,C,SEA,27,27,1,3,4
8,8480292,Carson Meyer,R,ANA,27,36,0,4,4
8,8482861,Vincent Iorio,D,WSH,22,30,0,4,4
8,8477244,Chad Ruhwedel,D,NYR,34,37,0,4,4
8,8481237,Kyle MacLean,C,NYI,25,19,0,4,4
8,8477971,Andreas Englund,D,LAK,28,31,0,4,4
8,8480468,James Hamblin,L,EDM,25,22,3,0,3
8,8482172,Landon Slaggert,L,CHI,22,25,3,0,3
8,8484287,Cole McWard,D,VAN,23,18,2,1,3
8,8479367,William Lockwood,R,FLA,26,27,2,1,3
8,8484325,Waltteri Merela,C,TBL,26,19,2,1,3
8,8482858,Ryker Evans,D,SEA,23,22,2,1,3
8,8479362,Riley Tufte,L,BOS,26,22,2,1,3
8,8483012,Logan Morrison,C,SEA,22,33,1,2,3
8,8478450,Parker Wotherspoon,D,BOS,27,35,1,2,3
8,8483395,Arshdeep Bains,L,VAN,23,6,1,2,3
8,8481564,Ryan Johnson,D,BUF,23,9,1,2,3
8,8477810,Joel Hanley,D,CGY,33,25,1,2,3
8,8478011,Louie Belpedio,D,PHI,28,11,1,2,3
8,8481598,Philip Broberg,D,EDM,23,41,0,3,3
8,8480196,Jacob Bryson,D,BUF,27,46,0,3,3
8,8481122,Simon Benoit,D,TOR,26,35,0,3,3
8,8479587,Rhett Gardner,C,PHI,28,19,0,3,3
8,8482929,Emil Lilleberg,D,TBL,23,21,0,3,3
8,8483512,Matthew Savoie,C,EDM,20,30,0,3,3
8,8482061,Brandon Biro,L,SEA,26,10,2,0,2
8,8482118,Sam Colangelo,R,ANA,23,16,2,0,2
8,8481655,Cole Schwindt,R,CGY,23,7,2,0,2
8,8484326,Patrik Koch,D,UTA,28,4,2,0,2
8,8480245,Olle Lycksell,R,PHI,25,33,1,1,2
8,8481006,Tyler Tucker,D,STL,24,15,1,1,2
8,8478881,Brett Seney,L,CHI,28,13,1,1,2
8,8474062,Riley Nash,C,NYR,35,17,1,1,2
8,8481206,John Ludvig,D,PIT,24,10,1,1,2
8,8482250,Callahan Burke,C,VGK,27,18,1,1,2
8,8480032,Shane Bowers,C,NJD,25,18,1,1,2
8,8475413,Justin Dowling,C,NJD,34,18,1,1,2
8,8482197,Adam Raska,R,MIN,23,6,1,1,2
8,8479994,Jaret Anderson-Dolan,C,WPG,25,29,0,2,2
8,8479991,Jake Leschyshyn,C,NYR,25,33,0,2,2
8,8477462,Robert Hagg,D,VGK,29,23,0,2,2
8,8478021,William Lagesson,D,DET,28,22,0,2,2
8,8484911,Collin Graf,R,SJS,22,40,0,2,2
8,8480267,Sammy Walker,C,MIN,25,17,0,2,2
8,8480874,Adam Ginning,D,PHI,24,13,0,2,2
8,8482102,Vasily Ponomarev,C,PIT,22,20,0,2,2
8,8481541,Samuel Bolduc,D,NYI,24,23,0,2,2
8,8482165,Yan Kuznetsov,D,CGY,22,18,0,2,2
8,8477541,Dakota Mermis,D,TOR,30,9,0,2,2
8,8482088,Justin Sourdif,R,FLA,22,13,0,2,2
8,8483471,Brad Lambert,C,WPG,31,7,0,2,2
8,8478854,Ryan Shea,D,PIT,27,9,0,2,2
8,8482713,Mackie Samoskevich,R,FLA,22,41,1,0,1
8,8477527,Ross Johnston,L,ANA,30,32,1,0,1
8,8477467,Gustav Olofsson,D,SEA,30,30,1,0,1
8,8482201,Gage Goncalves,C,TBL,23,21,1,0,1
8,8482094,Daemon Hunt,D,MIN,22,10,1,0,1
8,8478446,Glenn Gawdin,C,LAK,27,14,1,0,1
8,8480084,Nick DeSimone,D,NJD,30,18,1,0,1
8,8483407,Brandon Scanlin,D,NYR,25,4,1,0,1
8,8479330,Brandon Gignac,C,MTL,27,6,1,0,1
8,8475780,Chris Wagner,R,COL,33,14,1,0,1
8,8483609,Adam Klapka,R,CGY,24,4,1,0,1
8,8481534,Raphael Lavoie,C,EDM,24,3,1,0,1
8,8477473,Justin Bailey,R,SJS,29,17,0,1,1
8,8481043,Cole Koepke,L,BOS,26,15,0,1,1
8,8480306,Grant Hutton,D,NYI,29,4,0,1,1
8,8481024,Linus Karlsson,C,VAN,25,10,0,1,1
8,8482162,Roby Jarventie,L,EDM,22,14,0,1,1
8,8481719,Maxwell Crozier,D,TBL,24,15,0,1,1
8,8482476,Emil Heineman,L,MTL,23,9,0,1,1
8,8483432,Luca Del Bel Belluz,C,CBJ,31,3,0,1,1
8,8481699,Aku Raty,R,UTA,23,14,0,1,1
8,8475795,Dylan McIlrath,D,WSH,32,15,0,1,1
8,8478051,Max Willman,C,NJD,29,16,0,0,0
8,8477320,Anton Blidh,L,NYR,29,17,0,0,0
8,8482147,Jean-Luc Foudy,C,COL,22,21,0,0,0
8,8479419,Brett Murray,L,BUF,26,24,0,0,0
8,8483597,Milos Kelemen,L,UTA,25,11,0,0,0
8,8481462,Mason Morelli,L,VGK,28,11,0,0,0
8,8477149,Scott Sabourin,R,SJS,32,13,0,0,0
8,8480075,Cameron Crotty,D,MIN,25,7,0,0,0
8,8482460,Matt Rempe,C,NYR,22,11,0,0,0
8,8484304,Uvis Balinskis,D,FLA,28,10,0,0,0
8,8478147,Bokondji Imama,L,PIT,28,3,0,0,0
8,8484259,Ondrej Pavel,C,COL,31,3,0,0,0
8,8481726,Adam Edstrom,C,NYR,24,9,0,0,0
8,8483567,Georgii Merkulov,C,BOS,24,10,0,0,0
8,8480823,Alexander Alexeyev,D,WSH,25,13,0,0,0
8,8483398,Declan Carlile,D,TBL,31,5,0,0,0
8,8477993,Justin Kirkland,C,CGY,28,7,0,0,0
8,8481065,Angus Crookshank,L,OTT,25,19,0,0,0
8,8483920,Pierrick Dube,R,WSH,23,3,0,0,0
8,8476323,Max McCormick,L,SEA,32,5,0,0,0
8,8483546,Marshall Rifai,D,TOR,26,3,0,0,0
8,8475755,Alexander Petrovic,D,DAL,32,9,0,0,0
8,8482787,Nikita Chibrikov,R,WPG,31,8,0,0,0
8,8482126,Emil Andrae,D,PHI,31,4,0,0,0
8,8484255,Jason Polin,R,COL,25,3,0,0,0
8,8479522,Hardy Haman Aktell,D,WSH,26,3,0,0,0
8,8479421,Jacob Moverare,D,LAK,26,5,0,0,0
8,8483531,Brian Halonen,L,NJD,25,2,0,0,0
8,8470794,Joe Pavelski,C,,40,0,0,0,0
8,8479321,Lucas Johansen,D,,27,0,0,0,0
8,8477950,Tony DeAngelo,D,,29,0,0,0,0
8,8471218,Blake Wheeler,R,,38,0,0,0,0
8,8475197,Tyson Barrie,D,,33,0,0,0,0
8,8474157,Max Pacioretty,L,,36,0,0,0,0
8,8475744,Evgeny Kuznetsov,C,,32,0,0,0,0
8,8474037,James van Riemsdyk,L,,35,0,0,0,0
8,8476907,Mackenzie MacEachern,L,,30,0,0,0,0
8,8480216,Jacob Peterson,C,,25,0,0,0,0
8,8474602,Justin Schultz,D,,34,0,0,0,0
8,8482222,Alexander Barabanov,L,,30,0,0,0,0
8,8474031,Kevin Shattenkirk,D,,35,0,0,0,0
8,8477330,Dominik Kubalik,L,,29,0,0,0,0
8,8480884,Calen Addison,D,,24,0,0,0,0
8,8475906,John Klingberg,D,,32,0,0,0,0
8,8480008,Adam Ruzicka,C,,25,0,0,0,0
8,8476884,Derrick Pouliot,D,,30,0,0,0,0
8,8476919,Chris Tierney,C,,30,0,0,0,0
8,8479415,Michael McLeod,C,,26,0,0,0,0
8,8474870,Tyler Johnson,C,,34,0,0,0,0
8,8470604,Jeff Carter,C,,39,0,0,0,0
8,8478104,Sammy Blais,L,,28,0,0,0,0
8,8474884,Mike Hoffman,C,,35,0,0,0,0
8,8481591,Sam Poulin,R,,23,0,0,0,0
8,8471274,Alex Goligoski,D,,39,0,0,0,0
8,8476871,Tanner Pearson,L,,32,0,0,0,0
8,8476393,Nick Cousins,C,,31,0,0,0,0
8,8479977,Kailer Yamamoto,R,,26,0,0,0,0
8,8479346,Dillon Dube,C,,26,0,0,0,0
8,8480184,Gustav Lindstrom,D,,26,0,0,0,0
8,8479376,Victor Mete,D,,26,0,0,0,0
8,8473449,Kyle Okposo,R,,36,0,0,0,0
8,8481058,Jesse Ylonen,R,,25,0,0,0,0
8,8475752,Tyler Pitlick,C,,33,0,0,0,0
8,8481239,Samuel Fagemo,L,,24,0,0,0,0
8,8480821,Filip Zadina,R,,25,0,0,0,0
8,8470966,Mark Giordano,D,,41,0,0,0,0
8,8478495,Denis Gurianov,R,,27,0,0,0,0
8,8477464,Nic Petan,C,,29,0,0,0,0
8,8478099,Kevin Labanc,R,,29,0,0,0,0
8,8482241,Radim Zohorna,L,,28,0,0,0,0
8,8474040,Sam Gagner,C,,35,0,0,0,0
8,8479514,Rem Pitlick,C,,27,0,0,0,0
8,8478430,Oliver Kylington,D,,27,0,0,0,0
8,8479533,Joona Koppanen,L,,26,0,0,0,0
8,8479984,Cal Foote,D,,26,0,0,0,0
8,8477126,Jayson Megna,C,,34,0,0,0,0
8,8475164,Jakob Silfverberg,R,,34,0,0,0,0
8,8474009,Nick Bonino,C,,36,0,0,0,0
8,8479458,Nikita Zaitsev,D,,33,0,0,0,0
8,8477944,Jakub Vrana,L,,28,0,0,0,0
8,8471699,Andrew Cogliano,C,,37,0,0,0,0
8,8478067,Oskar Lindblom,L,,28,0,0,0,0
8,8471686,Marc Staal,D,,37,0,0,0,0
8,8470610,Zach Parise,L,,40,0,0,0,0
8,8478904,Steven Lorentz,C,,28,0,0,0,0
8,8473473,Milan Lucic,L,,36,0,0,0,0
8,8480031,Maxime Comtois,L,,25,0,0,0,0
8,8478512,Austin Czarnik,C,,32,0,0,0,0
8,8473504,Cal Clutterbuck,R,,37,0,0,0,0
8,8477454,Adam Erne,L,,29,0,0,0,0
8,8479383,Boris Katchouk,L,,26,0,0,0,0
8,8475825,Jani Hakanpää,D,,32,0,0,0,0
8,8477846,Ryan Carpenter,C,,33,0,0,0,0
8,8477930,Pierre-Edouard Bellemare,L,,39,0,0,0,0
8,8478400,Colin White,C,,27,0,0,0,0
8,8480226,Marián Studenic,R,,26,0,0,0,0
8,8480853,Liam Foudy,C,,24,0,0,0,0
8,8475797,Jarred Tinordi,D,,32,0,0,0,0
8,8479423,Alex Nylander,L,,26,0,0,0,0
8,8474618,Marco Scandella,D,,34,0,0,0,0
8,8478028,Fredrik Olofsson,L,,28,0,0,0,0
8,8474709,Matt Martin,L,,35,0,0,0,0
8,8481070,Hugh McGing,L,,26,0,0,0,0
8,8479546,Oskar Steen,C,,26,0,0,0,0
8,8474145,Robert Bortuzzo,D,,35,0,0,0,0
8,8476915,Jujhar Khaira,L,,30,0,0,0,0
8,8480274,Philip Kemp,D,EDM,25,0,0,0,0
8,8484321,Nikolas Matinpalo,D,OTT,26,2,0,0,0
8,8475278,Byron Froese,C,,33,0,0,0,0
8,8481812,Nikolai Knyzhov,D,,27,0,0,0,0
8,8478408,Travis Dermott,D,,28,0,0,0,0
8,8481077,John Leonard,L,,26,0,0,0,0
8,8479547,Matthew Phillips,R,,26,0,0,0,0
8,8480836,Jonathan Gruden,C,,24,0,0,0,0
8,8481690,Tyler Angle,C,,24,0,0,0,0
8,8475766,Austin Watson,L,,32,0,0,0,0
8,8481016,Ruslan Iskhakov,C,,24,0,0,0,0
8,8478078,Rourke Chartier,C,,28,0,0,0,0
8,8483401,Marc Johnstone,R,PIT,28,2,0,0,0
8,8480776,Sheldon Rempal,R,,29,0,0,0,0
8,8478956,Samuel Laberge,L,NJD,27,0,0,0,0
8,8483045,Cameron Butler,R,CBJ,31,0,0,0,0
8,8484314,Jiri Smejkal,L,,28,0,0,0,0
9,8478402,Connor McDavid,C,EDM,27,81,45,112,157
9,8476453,Nikita Kucherov,R,TBL,31,81,38,100,138
9,8477492,Nathan MacKinnon,C,COL,29,81,49,85,134
9,8477956,David Pastrnak,R,BOS,28,79,66,63,129
9,8477934,Leon Draisaitl,C,EDM,29,77,40,72,112
9,8478420,Mikko Rantanen,R,COL,28,81,44,63,107
9,8479314,Matthew Tkachuk,L,FLA,27,80,35,72,107
9,8479318,Auston Matthews,C,TOR,27,79,57,49,106
9,8481559,Jack Hughes,C,NJD,23,77,44,59,103
9,8476468,J.T. Miller,C,VAN,31,79,39,64,103
9,8478010,Brayden Point,C,TBL,28,82,59,43,102
9,8480023,Robert Thomas,C,STL,25,77,26,73,99
9,8478550,Artemi Panarin,L,NYR,33,78,40,58,98
9,8478483,Mitch Marner,R,TOR,27,80,22,76,98
9,8477946,Dylan Larkin,C,DET,28,79,41,55,96
9,8480027,Jason Robertson,L,DAL,25,82,39,57,96
9,8478864,Kirill Kaprizov,L,MIN,27,72,35,61,96
9,8477493,Aleksander Barkov,C,FLA,29,78,28,67,95
9,8475913,Mark Stone,R,VGK,32,76,31,63,94
9,8480801,Brady Tkachuk,L,OTT,25,79,42,51,93
9,8482116,Tim Stützle,C,OTT,22,80,33,57,90
9,8477501,Valeri Nichushkin,R,COL,29,81,47,40,87
9,8478427,Sebastian Aho,C,CAR,27,72,38,49,87
9,8480036,Miro Heiskanen,D,DAL,25,78,22,65,87
9,8478445,Mathew Barzal,C,NYI,27,80,25,61,86
9,8473419,Brad Marchand,L,BOS,36,79,25,61,86
9,8471675,Sidney Crosby,C,PIT,37,76,40,44,84
9,8477933,Sam Reinhart,C,FLA,29,80,39,44,83
9,8479420,Tage Thompson,C,BUF,27,73,38,44,82
9,8477940,Nikolaj Ehlers,L,WPG,28,76,35,47,82
9,8480012,Elias Pettersson,C,VAN,26,69,27,55,82
9,8475172,Nazem Kadri,C,CGY,34,80,38,43,81
9,8477939,William Nylander,R,TOR,28,76,36,45,81
9,8477942,Kevin Fiala,L,LAK,28,82,34,46,80
9,8477404,Jake Guentzel,C,TBL,30,82,33,47,80
9,8478403,Jack Eichel,C,VGK,28,74,36,43,79
9,8476459,Mika Zibanejad,C,NYR,31,77,25,54,79
9,8475692,Mats Zuccarello,R,MIN,37,78,19,60,79
9,8480069,Cale Makar,D,COL,26,70,16,63,79
9,8477960,Adrian Kempe,R,LAK,28,81,38,40,78
9,8476389,Vincent Trocheck,C,NYR,31,80,32,46,78
9,8478449,Roope Hintz,C,DAL,28,79,35,42,77
9,8480002,Nico Hischier,C,NJD,25,75,33,44,77
9,8476887,Filip Forsberg,L,NSH,30,72,26,51,77
9,8482665,Matty Beniers,C,SEA,22,74,26,51,77
9,8474600,Roman Josi,D,NSH,34,72,19,58,77
9,8480800,Quinn Hughes,D,VAN,25,71,11,66,77
9,8478398,Kyle Connor,L,WPG,28,68,37,38,75
9,8476539,Jonathan Marchessault,R,NSH,34,74,36,38,74
9,8480208,Drake Batherson,R,OTT,26,81,28,46,74
9,8475784,Jeff Skinner,C,EDM,32,75,36,37,73
9,8480839,Rasmus Dahlin,D,BUF,24,67,23,50,73
9,8479337,Alex DeBrincat,R,DET,27,80,33,39,72
9,8479323,Adam Fox,D,NYR,26,69,18,54,72
9,8479542,Brandon Hagel,L,TBL,26,81,29,42,71
9,8477951,Nick Schmaltz,C,UTA,28,77,28,43,71
9,8475168,Matt Duchene,C,DAL,33,81,25,46,71
9,8478440,Dylan Strome,C,WSH,27,75,22,49,71
9,8477409,Carter Verhaeghe,C,FLA,29,76,37,33,70
9,8474564,Steven Stamkos,C,NSH,34,73,33,37,70
9,8478439,Travis Konecny,R,PHI,27,75,29,41,70
9,8475184,Chris Kreider,L,NYR,33,72,41,28,69
9,8484144,Connor Bedard,C,CHI,19,69,34,35,69
9,8482078,Lucas Raymond,L,DET,22,79,33,36,69
9,8471215,Evgeni Malkin,C,PIT,38,77,30,39,69
9,8471685,Anze Kopitar,C,LAK,37,81,20,49,69
9,8476448,William Karlsson,C,VGK,31,74,30,38,68
9,8481557,Matt Boldy,L,MIN,23,74,25,43,68
9,8478873,Troy Terry,R,ANA,27,73,19,49,68
9,8476456,Jonathan Huberdeau,C,CGY,31,80,18,50,68
9,8481540,Cole Caufield,R,MTL,23,76,37,30,67
9,8479343,Clayton Keller,R,UTA,26,78,30,37,67
9,8479325,Charlie McAvoy,D,BOS,27,72,9,58,67
9,8475166,John Tavares,C,TOR,34,78,35,31,66
9,8482740,Wyatt Johnston,C,DAL,21,81,33,33,66
9,8475786,Zach Hyman,L,EDM,32,75,32,34,66
9,8482093,Seth Jarvis,C,CAR,22,69,31,35,66
9,8474141,Patrick Kane,R,DET,36,80,27,39,66
9,8482684,Luke Hughes,D,NJD,21,71,5,61,66
9,8476399,Blake Coleman,C,CGY,33,78,36,29,65
9,8479385,Jordan Kyrou,C,STL,26,77,29,36,65
9,8480018,Nick Suzuki,C,MTL,25,71,22,43,65
9,8474578,Erik Karlsson,D,PIT,34,81,15,50,65
9,8482745,Mason McTavish,C,ANA,21,69,32,32,64
9,8481533,Trevor Zegras,C,ANA,23,79,28,36,64
9,8479999,Casey Mittelstadt,C,COL,26,82,23,41,64
9,8475794,Tyler Seguin,C,DAL,32,82,23,41,64
9,8478047,Michael Bunting,L,PIT,29,67,22,42,64
9,8475167,Victor Hedman,D,TBL,34,77,9,55,64
9,8475745,Charlie Coyle,C,BOS,32,77,25,38,63
9,8479407,Jesper Bratt,L,NJD,26,73,22,41,63
9,8480865,Noah Dobson,D,NYI,24,81,10,53,63
9,8478401,Pavel Zacha,C,BOS,27,79,26,36,62
9,8478975,Mason Marchment,L,DAL,29,81,25,37,62
9,8476881,Tomas Hertl,C,VGK,31,75,25,37,62
9,8473512,Claude Giroux,R,OTT,36,75,25,37,62
9,8478397,Rasmus Andersson,D,CGY,28,74,8,54,62
9,8478414,Timo Meier,R,NJD,28,74,35,26,61
9,8474150,Mikael Backlund,C,CGY,35,77,31,30,61
9,8475754,Brock Nelson,C,NYI,33,79,27,34,61
9,8477935,Sam Bennett,C,FLA,28,79,25,36,61
9,8473994,Jamie Benn,L,DAL,35,80,24,37,61
9,8480830,Andrei Svechnikov,R,CAR,24,67,23,38,61
9,8477949,Alex Tuch,R,BUF,28,74,20,41,61
9,8476460,Mark Scheifele,C,WPG,31,65,26,34,60
9,8475158,Ryan O'Reilly,C,NSH,33,71,22,38,60
9,8477402,Pavel Buchnevich,L,STL,29,73,19,41,60
9,8478460,Zach Werenski,D,CBJ,27,80,18,42,60
9,8476479,Phillip Danault,C,LAK,31,82,17,43,60
9,8474586,Jordan Eberle,R,SEA,34,72,26,33,59
9,8477964,Ivan Barbashev,C,VGK,29,78,22,37,59
9,8475798,Mikael Granlund,C,SJS,32,68,15,44,59
9,8476875,Mike Matheson,D,MTL,30,77,14,45,59
9,8478493,Joel Eriksson Ek,C,MIN,27,71,28,30,58
9,8478856,Conor Garland,R,VAN,28,73,24,34,58
9,8475765,Vladimir Tarasenko,R,DET,33,77,21,37,58
9,8477416,Oliver Bjorkstrand,R,SEA,29,76,20,38,58
9,8476454,Ryan Nugent-Hopkins,C,EDM,31,75,17,41,58
9,8477494,Jonathan Drouin,L,COL,29,80,16,42,58
9,8478444,Brock Boeser,R,VAN,27,69,26,31,57
9,8477495,Seth Jones,D,CHI,30,71,18,39,57
9,8475810,Bryan Rust,R,PIT,32,74,31,25,56
9,8475151,Kyle Palmieri,C,NYI,33,78,25,31,56
9,8481068,Yegor Sharangovich,C,CGY,26,78,24,32,56
9,8474102,David Perron,L,OTT,36,81,20,36,56
9,8475191,Reilly Smith,R,NYR,33,75,19,37,56
9,8481528,Dylan Cozens,C,BUF,23,73,25,30,55
9,8476905,Chandler Stephenson,C,SEA,30,77,18,37,55
9,8475169,Evander Kane,L,EDM,33,75,32,22,54
9,8477476,Artturi Lehkonen,L,COL,29,81,28,26,54
9,8477500,Bo Horvat,C,NYI,29,75,27,27,54
9,8477496,Elias Lindholm,C,BOS,30,80,16,38,54
9,8482109,Alexis Lafrenière,L,NYR,23,80,29,24,53
9,8471214,Alex Ovechkin,L,WSH,39,72,28,25,53
9,8473986,Alex Killorn,L,ANA,35,75,28,25,53
9,8479675,Trevor Moore,L,LAK,29,81,27,26,53
9,8484153,Leo Carlsson,C,ANA,20,67,24,29,53
9,8480015,Owen Tippett,R,PHI,25,76,24,29,53
9,8475170,Brayden Schenn,C,STL,33,73,23,30,53
9,8480188,Fabian Zetterlund,L,SJS,25,74,23,30,53
9,8477497,Sean Monahan,C,CBJ,30,69,22,31,53
9,8480803,Evan Bouchard,D,EDM,25,78,15,38,53
9,8478407,Vince Dunn,D,SEA,28,77,14,39,53
9,8477504,Josh Morrissey,D,WPG,29,74,11,42,53
9,8482124,Quinton Byfield,R,LAK,22,80,19,33,52
9,8476853,Morgan Rielly,D,TOR,30,65,13,39,52
9,8477451,Ryan Hartman,R,MIN,30,73,28,23,51
9,8477444,Andre Burakovsky,L,SEA,29,74,17,34,51
9,8476346,Johnny Gaudreau,L,CBJ,31,69,11,40,51
9,8482702,Logan Stankoven,C,DAL,21,81,22,28,50
9,8484166,Adam Fantilli,C,CBJ,20,68,20,30,50
9,8483515,Juraj Slafkovsky,L,MTL,20,73,20,30,50
9,8476792,Torey Krug,D,STL,33,71,19,31,50
9,8479410,Mikhail Sergachev,D,UTA,26,76,9,41,50
9,8475314,Anders Lee,L,NYI,34,73,28,21,49
9,8475848,Brendan Gallagher,R,MTL,32,70,22,27,49
9,8476882,Teuvo Teravainen,C,CHI,30,71,20,29,49
9,8474053,Logan Couture,C,SJS,35,62,18,31,49
9,8482699,Dylan Guenther,R,UTA,21,75,17,32,49
9,8477447,Shea Theodore,D,VGK,29,61,13,36,49
9,8478469,Thomas Chabot,D,OTT,27,76,13,36,49
9,8476880,Tom Wilson,R,WSH,30,67,29,19,48
9,8478366,Frank Vatrano,R,ANA,30,73,28,20,48
9,8479992,Michael Rasmussen,C,DET,25,76,21,27,48
9,8482720,Matthew Knies,L,TOR,22,78,19,29,48
9,8482097,Jack Quinn,R,BUF,23,59,19,29,48
9,8474149,Evgenii Dadonov,R,DAL,35,80,19,29,48
9,8477456,J.T. Compher,L,DET,29,81,18,30,48
9,8482667,William Eklund,L,SJS,22,70,16,32,48
9,8478413,Jordan Greenway,L,BUF,27,69,14,34,48
9,8479400,Pierre-Luc Dubois,L,WSH,26,74,22,25,47
9,8482159,Tyson Foerster,R,PHI,22,75,22,25,47
9,8478474,Lawson Crouse,L,UTA,27,76,22,25,47
9,8478498,Jake DeBrusk,L,VAN,28,70,19,28,47
9,8478462,Nicolas Roy,C,VGK,27,79,19,28,47
9,8482110,Dawson Mercer,C,NJD,23,72,18,29,47
9,8476462,Dougie Hamilton,D,NJD,31,71,18,29,47
9,8478233,Andrew Mangiapane,L,WSH,28,70,18,29,47
9,8474590,John Carlson,D,WSH,34,63,16,31,47
9,8476458,Ryan Strome,C,ANA,31,74,15,32,47
9,8479345,Jakob Chychrun,D,WSH,26,72,15,32,47
9,8478396,Noah Hanifin,D,VGK,27,58,13,34,47
9,8477346,MacKenzie Weegar,D,CGY,30,69,12,35,47
9,8477955,Jared McCann,L,SEA,28,67,25,21,46
9,8480039,Martin Necas,C,CAR,25,65,22,24,46
9,8478542,Evan Rodrigues,C,FLA,31,74,21,25,46
9,8475726,Tyler Toffoli,C,SJS,32,70,27,18,45
9,8477952,Robby Fabbri,C,ANA,28,67,24,21,45
9,8474641,Adam Henrique,C,EDM,34,80,20,25,45
9,8482146,Luke Evangelista,R,NSH,22,66,18,27,45
9,8474679,Gustav Nyquist,C,NSH,35,72,14,31,45
9,8481524,Bowen Byram,D,BUF,23,62,14,31,45
9,8477986,Brandon Montour,D,SEA,30,73,12,33,45
9,8477503,Max Domi,C,TOR,29,78,9,36,45
9,8475764,Cam Fowler,D,ANA,33,76,7,38,45
9,8478519,Anthony Cirelli,C,TBL,27,82,21,23,44
9,8481618,Alex Newhook,C,MTL,23,76,19,25,44
9,8477998,Warren Foegele,L,LAK,28,81,19,25,44
9,8477407,Anthony Duclair,L,NYI,29,78,17,27,44
9,8476869,Brady Skjei,D,NSH,30,78,10,34,44
9,8481542,Moritz Seider,D,DET,23,77,4,40,44
9,8476432,Boone Jenner,C,CBJ,31,70,25,18,43
9,8480014,Gabriel Vilardi,C,WPG,25,71,24,19,43
9,8479339,Patrik Laine,L,CBJ,26,66,23,20,43
9,8478115,Pierre Engvall,L,NYI,28,77,23,20,43
9,8482175,JJ Peterka,R,BUF,22,66,22,21,43
9,8477426,Nicholas Paul,L,TBL,29,81,20,23,43
9,8475714,Calle Jarnkrok,C,TOR,33,77,18,25,43
9,8481581,Thomas Harley,D,DAL,23,75,12,31,43
9,8477429,Andrew Copp,C,DET,30,78,16,26,42
9,8478438,Tommy Novak,C,NSH,27,71,15,27,42
9,8478042,Viktor Arvidsson,L,EDM,31,74,13,29,42
9,8475218,Mattias Ekholm,D,EDM,34,77,9,33,42
9,8482671,Owen Power,D,BUF,22,72,8,34,42
9,8480829,Jesperi Kotkaniemi,C,CAR,24,71,20,21,41
9,8480078,Filip Chytil,C,NYR,25,73,19,22,41
9,8481554,Kaapo Kakko,R,NYR,23,67,18,23,41
9,8482113,Anton Lundell,C,FLA,23,74,17,24,41
9,8477479,Tyler Bertuzzi,L,CHI,29,65,15,26,41
9,8477021,Alex Kerfoot,C,UTA,30,75,15,26,41
9,8477498,Darnell Nurse,D,EDM,29,76,15,26,41
9,8474716,Jared Spurgeon,D,MIN,35,75,14,27,41
9,8481711,Matias Maccelli,L,UTA,24,73,12,29,41
9,8476906,Shayne Gostisbehere,D,CAR,31,80,10,31,41
9,8476885,Jacob Trouba,D,NYR,30,71,10,31,41
9,8478055,Gustav Forsling,D,FLA,28,69,9,32,41
9,8471724,Kris Letang,D,PIT,37,79,8,33,41
9,8480064,Josh Norris,C,OTT,25,73,23,17,40
9,8476483,Rickard Rakell,R,PIT,31,71,18,22,40
9,8483431,Logan Cooley,C,UTA,20,75,17,23,40
9,8481577,Philip Tomasino,C,NSH,23,65,16,24,40
9,8480849,Barrett Hayton,C,UTA,24,75,15,25,40
9,8480817,K'Andre Miller,D,NYR,24,69,12,28,40
9,8479525,Ross Colton,C,COL,28,78,21,18,39
9,8483808,Andrei Kuzmenko,L,CGY,28,70,19,20,39
9,8475722,Jason Zucker,L,BUF,32,70,19,20,39
9,8477511,Anthony Mantha,R,CGY,30,72,18,21,39
9,8476826,Yanni Gourde,C,SEA,33,75,18,21,39
9,8475768,Jaden Schwartz,C,SEA,32,71,16,23,39
9,8480797,Joel Farabee,L,PHI,24,76,14,25,39
9,8475799,Nino Niederreiter,R,WPG,32,65,14,25,39
9,8478046,Danton Heinen,L,VAN,29,70,13,26,39
9,8476461,Sean Couturier,C,PHI,32,67,13,26,39
9,8481596,Shane Pinto,C,OTT,24,71,12,27,39
9,8480336,Sean Walker,D,CAR,30,73,11,28,39
9,8480434,Sean Durzi,D,UTA,26,66,10,29,39
9,8478038,Devon Toews,D,COL,30,65,9,30,39
9,8480009,Eeli Tolvanen,R,SEA,25,70,17,21,38
9,8475760,Nick Bjugstad,C,UTA,32,70,16,22,38
9,8479353,Brett Howden,C,VGK,26,67,16,22,38
9,8477932,Aaron Ekblad,D,FLA,28,70,9,29,38
9,8476923,Damon Severson,D,CBJ,30,80,8,30,38
9,8479425,Filip Hronek,D,VAN,27,71,7,31,38
9,8476474,Stefan Noesen,R,NJD,31,65,19,18,37
9,8476872,Scott Laughton,C,PHI,30,72,18,19,37
9,8471698,T.J. Oshie,R,WSH,38,69,15,22,37
9,8481523,Kirby Dach,C,MTL,23,67,14,23,37
9,8482149,Cole Perfetti,C,WPG,22,70,13,24,37
9,8482105,Jake Sanderson,D,OTT,22,77,12,25,37
9,8470613,Brent Burns,D,CAR,39,72,7,30,37
9,8478458,John (Jack) Roslovic,C,CAR,27,64,7,30,37
9,8478057,Dakota Joshua,C,VAN,28,69,19,17,36
9,8479365,Trent Frederic,C,BOS,26,74,17,19,36
9,8480185,Eetu Luostarinen,C,FLA,26,74,16,20,36
9,8475193,Tomas Tatar,L,NJD,34,70,14,22,36
9,8482133,Thomas Bordeleau,C,SJS,22,61,14,22,36
9,8481624,Ilya Mikheyev,R,CHI,30,67,12,24,36
9,8477478,William Carrier,L,CAR,30,61,18,17,35
9,8475793,Ryan Johansen,C,PHI,32,74,15,20,35
9,8475763,Kevin Hayes,R,PIT,32,63,15,20,35
9,8482092,Ridly Greig,C,OTT,22,77,14,21,35
9,8484145,Zach Benson,L,BUF,19,65,13,22,35
9,8476480,Vladislav Namestnikov,C,WPG,32,69,13,22,35
9,8475791,Taylor Hall,L,CHI,33,66,12,23,35
9,8476854,Hampus Lindholm,D,BOS,30,70,8,27,35
9,8482712,Oskar Olausson,R,COL,22,76,8,27,35
9,8476917,Adam Pelech,D,NYI,30,78,6,29,35
9,8476958,Jaccob Slavin,D,CAR,30,75,3,32,35
9,8480802,Ryan McLeod,C,BUF,25,65,21,13,34
9,8478020,Michael Amadio,R,OTT,28,72,21,13,34
9,8479987,Morgan Geekie,C,BOS,26,75,18,16,34
9,8476392,Adam Lowry,C,WPG,31,64,16,18,34
9,8480028,Morgan Frost,C,PHI,25,74,13,21,34
9,8476292,Ondrej Palat,L,NJD,33,68,8,26,34
9,8475753,Justin Faulk,D,STL,32,72,8,26,34
9,8477488,Brett Pesce,D,NJD,30,66,6,28,34
9,8480835,Jack Drury,C,CAR,24,60,19,14,33
9,8474715,Cameron Atkinson,R,TBL,35,82,18,15,33
9,8473533,Jordan Staal,C,CAR,36,67,14,19,33
9,8477505,Alexander Wennberg,C,SJS,30,61,11,22,33
9,8480813,Joe Veleno,C,DET,24,81,10,23,33
9,8480871,Adam Boqvist,D,FLA,24,71,8,25,33
9,8482122,Brock Faber,D,MIN,22,78,8,25,33
9,8483490,Pavel Mintyukov,D,ANA,21,75,7,26,33
9,8480145,Neal Pionk,D,WPG,29,70,6,27,33
9,8477948,Travis Sanheim,D,PHI,28,70,4,29,33
9,8481604,Pavel Dorofeyev,L,VGK,24,66,16,16,32
9,8481535,Nils Hoglander,L,VAN,24,65,16,16,32
9,8482475,Yegor Chinakhov,R,CBJ,23,61,14,18,32
9,8478466,Daniel Sprong,R,VAN,27,68,13,19,32
9,8482705,Cole Sillinger,C,CBJ,21,70,13,19,32
9,8476921,Jordan Martinook,L,CAR,32,58,11,21,32
9,8476419,Jean-Gabriel Pageau,C,NYI,32,76,10,22,32
9,8480220,Noah Cates,L,PHI,25,71,8,24,32
9,8474565,Alex Pietrangelo,D,VGK,34,66,7,25,32
9,8482089,Jake Neighbours,L,STL,22,67,22,9,31
9,8482125,Alexander Holtz,R,VGK,22,70,18,13,31
9,8481186,Logan O'Connor,R,COL,28,79,16,15,31
9,8476438,Brandon Saad,L,STL,32,71,15,16,31
9,8480113,Alex Iafallo,L,WPG,31,64,12,19,31
9,8478472,Mathieu Joseph,R,STL,27,69,11,20,31
9,8480798,Philipp Kurashev,C,CHI,25,61,10,21,31
9,8481546,Cam York,D,PHI,23,66,8,23,31
9,8475233,David Savard,D,MTL,34,61,4,27,31
9,8480873,Rasmus Sandin,D,WSH,24,66,3,28,31
9,8477839,Conor Sheary,L,TBL,32,82,13,17,30
9,8484203,Bradly Nadeau,L,CAR,19,66,13,17,30
9,8477953,Kasperi Kapanen,R,STL,28,68,11,19,30
9,8482660,Kent Johnson,C,CBJ,22,72,10,20,30
9,8479591,Michael Eyssimont,C,TBL,28,82,8,22,30
9,8480893,Kirill Marchenko,R,CBJ,24,58,19,10,29
9,8476878,Zemgus Girgensons,C,TBL,30,78,19,10,29
9,8477425,Miles Wood,L,COL,29,78,15,14,29
9,8482117,Lukas Reichel,L,CHI,22,58,11,18,29
9,8478463,Anthony Beauvillier,L,PIT,27,65,11,18,29
9,8482074,Connor Zary,C,CGY,23,64,10,19,29
9,8481481,Blake Lizotte,C,PIT,27,64,10,19,29
9,8476469,Joel Armia,R,MTL,31,71,10,19,29
9,8483505,Matthew Poitras,C,BOS,20,74,9,20,29
9,8482624,Daniil Miromanov,D,CGY,27,65,8,21,29
9,8476988,Matt Benning,D,SJS,30,64,7,22,29
9,8474563,Drew Doughty,D,LAK,35,71,4,25,29
9,8474151,Ryan McDonagh,D,TBL,35,78,4,25,29
9,8477969,Marcus Pettersson,D,PIT,28,79,3,26,29
9,8482055,Drew O'Connor,L,PIT,26,68,17,11,28
9,8483457,Lane Hutson,D,MTL,20,68,13,15,28
9,8478970,Jalen Chatfield,D,CAR,28,67,12,16,28
9,8479351,Sam Steel,C,DAL,26,79,11,17,28
9,8476918,Jimmy Vesey,L,NYR,31,75,10,18,28
9,8482111,Justin Barron,D,MTL,23,66,9,19,28
9,8476312,Josh Manson,D,COL,33,63,8,20,28
9,8475200,Dmitry Orlov,D,CAR,33,78,7,21,28
9,8482067,Connor Mackey,D,NYR,28,67,7,21,28
9,8475171,Oliver Ekman-Larsson,D,TOR,33,68,5,23,28
9,8480878,Nils Lundkvist,D,DAL,24,71,5,23,28
9,8478507,John Marino,D,UTA,27,65,2,26,28
9,8479661,Tanner Jeannot,L,LAK,27,76,16,11,27
9,8477446,Michael McCarron,R,NSH,29,61,13,14,27
9,8476925,Colton Sissons,C,NSH,31,69,11,16,27
9,8482749,Joshua Roy,R,MTL,21,64,11,16,27
9,8481560,Arthur Kaliyev,R,LAK,23,78,10,17,27
9,8475149,Marcus Johansson,L,MIN,34,71,10,17,27
9,8481553,Bobby Brink,R,PHI,23,63,10,17,27
9,8481606,Jordan Spence,D,LAK,23,66,8,19,27
9,8478911,Matt Roy,D,WSH,29,64,7,20,27
9,8481703,Valtteri Puustinen,R,PIT,25,64,6,21,27
9,8477435,Ryan Graves,D,PIT,29,81,6,21,27
9,8477507,Nikita Zadorov,D,BOS,29,61,6,21,27
9,8476331,Dylan DeMelo,D,WPG,31,73,2,25,27
9,8481093,Rafael Harvey-Pinard,L,MTL,25,62,15,11,26
9,8480459,Pius Suter,C,VAN,28,70,14,12,26
9,8474189,Lars Eller,C,PIT,35,62,14,12,26
9,8481580,Connor McMichael,C,WSH,23,64,14,12,26
9,8475287,Erik Haula,L,NJD,33,69,13,13,26
9,8470621,Corey Perry,R,EDM,39,68,13,13,26
9,8477987,Ryan Donato,C,CHI,28,62,13,13,26
9,8480762,Eric Robinson,L,CAR,29,64,11,15,26
9,8479393,Noah Gregor,L,OTT,26,68,10,16,26
9,8479639,Dylan Coghlan,D,WPG,26,61,8,18,26
9,8476979,Erik Gustafsson,D,DET,32,74,5,21,26
9,8480748,Kiefer Sherwood,L,VAN,29,61,16,9,25
9,8482259,Bobby McMann,C,TOR,28,69,14,11,25
9,8477903,Garnet Hathaway,R,PHI,33,63,13,12,25
9,8473422,Nick Foligno,L,CHI,37,54,13,12,25
9,8480855,Jack McBain,C,UTA,24,66,11,14,25
9,8480021,Jack Studnicka,C,LAK,25,64,11,14,25
9,8480068,Ryan Poehling,C,PHI,25,68,10,15,25
9,8481582,Nicholas Robertson,L,TOR,23,69,10,15,25
9,8475343,Nic Dowd,C,WSH,34,62,10,15,25
9,8475231,Casey Cizikas,C,NYI,33,72,10,15,25
9,8477450,Jason Dickinson,C,CHI,29,55,9,16,25
9,8481032,Paul Cotter,C,NJD,25,63,9,16,25
9,8478891,Mason Appleton,C,WPG,28,67,8,17,25
9,8478133,Jake Evans,C,MTL,28,68,8,17,25
9,8476422,Mike Reilly,D,NYI,31,75,7,18,25
9,8473507,Jeff Petry,D,DET,37,70,6,19,25
9,8482101,Danil Gushchin,L,SJS,22,51,4,21,25
9,8479398,Samuel Girard,D,COL,26,68,3,22,25
9,8479336,Carl Grundstrom,R,SJS,27,53,15,9,24
9,8480980,Connor Dewar,C,TOR,25,66,13,11,24
9,8480789,Oliver Wahlstrom,R,NYI,24,68,12,12,24
9,8481704,Juuso Parssinen,C,NSH,23,64,11,13,24
9,8480205,Emil Bemstrom,C,PIT,25,61,11,13,24
9,8482679,Matt Coronato,R,CGY,22,59,11,13,24
9,8477947,Sonny Milano,L,WSH,28,59,10,14,24
9,8476960,Andreas Athanasiou,C,CHI,30,52,9,15,24
9,8476897,Oskar Sundqvist,C,STL,30,63,9,15,24
9,8475220,Marcus Foligno,L,MIN,33,58,8,16,24
9,8479983,Mario Ferraro,D,SJS,26,71,6,18,24
9,8478500,Ivan Provorov,D,CBJ,27,78,4,20,24
9,8479402,Jake Bean,D,CGY,26,68,4,20,24
9,8476463,Jonas Brodin,D,MIN,31,75,2,22,24
9,8476873,Mark Jankowski,C,NSH,30,52,12,11,23
9,8476457,Adam Larsson,D,SEA,32,74,7,16,23
9,8482655,Janis Moser,D,TBL,24,78,6,17,23
9,8476902,Esa Lindell,D,DAL,30,76,4,19,23
9,8481014,Alexander Romanov,D,NYI,24,74,4,19,23
9,8476891,Matthew Grzelcyk,D,PIT,30,74,4,19,23
9,8480073,Erik Brannstrom,D,COL,25,61,3,20,23
9,8480222,Sebastian Aho,D,PIT,28,65,3,20,23
9,8478399,Jonas Siegenthaler,D,NJD,27,59,3,20,23
9,8479066,Ryan Lomberg,L,CGY,30,70,13,9,22
9,8478508,Yakov Trenin,C,MIN,27,60,12,10,22
9,8478109,Victor Olofsson,L,VGK,29,67,11,11,22
9,8482079,Marco Rossi,C,MIN,23,60,10,12,22
9,8482809,Jackson Blake,R,CAR,21,52,10,12,22
9,8483491,Ivan Miroshnichenko,L,WSH,20,50,8,14,22
9,8482142,Jamie Drysdale,D,PHI,22,60,7,15,22
9,8482062,Cole Smith,L,NSH,29,51,7,15,22
9,8478416,Erik Cernak,D,TBL,27,75,7,15,22
9,8475855,Jesper Fast,R,CAR,33,61,6,16,22
9,8483565,Nick Blankenburg,D,NSH,26,62,5,17,22
9,8483445,Cutter Gauthier,L,ANA,20,67,4,18,22
9,8476892,Colton Parayko,D,STL,31,70,4,18,22
9,8479324,Ryan Lindgren,D,NYR,26,61,3,19,22
9,8475188,Brayden McNabb,D,VGK,33,53,2,20,22
9,8480281,Alexey Toropchenko,R,STL,25,61,14,7,21
9,8479390,Taylor Raddysh,R,WSH,26,66,11,10,21
9,8480355,Mark Kastelic,C,BOS,25,58,11,10,21
9,8473453,Trevor Lewis,C,LAK,37,69,9,12,21
9,8478434,Keegan Kolesar,R,VGK,27,69,9,12,21
9,8481013,Jonatan Berggren,R,DET,24,62,9,12,21
9,8476329,Travis Boyd,C,MIN,31,59,8,13,21
9,8476856,Mathew Dumba,D,DAL,30,74,8,13,21
9,8482148,Hendrix Lapierre,C,WSH,22,59,7,14,21
9,8481656,Aliaksei Protas,C,WSH,23,59,4,17,21
9,8476467,Jamie Oleksiak,D,SEA,32,69,4,17,21
9,8476429,Scott Mayfield,D,NYI,32,73,4,17,21
9,8477506,Ryan Pulock,D,NYI,30,77,3,18,21
9,8475208,Brian Dumoulin,D,ANA,33,61,1,20,21
9,8478421,A.J. Greer,L,FLA,28,50,13,7,20
9,8479996,Cody Glass,C,NSH,25,55,12,8,20
9,8479316,Luke Kunin,C,SJS,27,58,11,9,20
9,8477989,Christian Dvorak,C,MTL,28,64,10,10,20
9,8476981,Josh Anderson,R,MTL,30,64,8,12,20
9,8478851,Alexandre Carrier,D,NSH,28,62,7,13,20
9,8477406,Mattias Janmark,C,EDM,32,67,7,13,20
9,8482803,Olen Zellweger,D,ANA,21,67,6,14,20
9,8477499,Rasmus Ristolainen,D,PHI,30,61,6,14,20
9,8473563,Nicklas Backstrom,C,WSH,37,51,4,16,20
9,8478882,Vladislav Gavrikov,D,LAK,29,69,4,16,20
9,8475790,Erik Gudbranson,D,CBJ,32,73,4,16,20
9,8477979,Nicolas Aube-Kubel,R,BUF,28,61,4,16,20
9,8480246,Nick Perbix,D,TBL,26,74,4,16,20
9,8477220,Nate Schmidt,D,FLA,33,63,3,17,20
9,8480043,Timothy Liljegren,D,TOR,25,64,3,17,20
9,8482077,Dylan Holloway,L,EDM,23,52,14,5,19
9,8477353,Tyler Motte,C,DET,29,68,12,7,19
9,8479414,Nathan Bastian,R,NJD,27,57,11,8,19
9,8479941,Justin Danforth,R,CBJ,31,55,10,9,19
9,8479359,Beck Malenstyn,L,BUF,26,50,10,9,19
9,8476927,Teddy Blueger,C,VAN,30,63,8,11,19
9,8477919,Frederick Gaudreau,C,MIN,31,59,7,12,19
9,8479370,Tyson Jost,C,CAR,26,48,7,12,19
9,8476889,Radek Faksa,C,STL,30,60,6,13,19
9,8474574,Tyler Myers,D,VAN,34,66,5,14,19
9,8476525,Colin Miller,D,WPG,32,63,5,14,19
9,8478452,Caleb Jones,D,LAK,27,64,5,14,19
9,8480192,Johnathan Kovacevic,D,NJD,27,64,5,14,19
9,8479976,Juuso Valimaki,D,UTA,26,70,4,15,19
9,8475324,Nick Jensen,D,OTT,34,65,1,18,19
9,8479619,Michael Carcone,L,UTA,28,67,17,1,18
9,8479944,Zach Aston-Reese,C,VGK,30,57,12,6,18
9,8482737,Zack Bolduc,C,STL,21,54,8,10,18
9,8471817,Ryan Reaves,R,TOR,37,51,8,10,18
9,8479368,Max Jones,L,BOS,26,65,7,11,18
9,8483493,Frank Nazar,C,CHI,20,50,6,12,18
9,8479982,Conor Timmins,D,TOR,26,61,6,12,18
9,8478013,Jake Walman,D,SJS,28,65,6,12,18
9,8479543,Michael Pezzetta,L,MTL,26,59,6,12,18
9,8481521,Ronnie Attard,D,PHI,25,60,4,14,18
9,8475462,Radko Gudas,D,ANA,34,65,4,14,18
9,8480001,Urho Vaakanainen,D,ANA,25,60,3,15,18
9,8481527,Kaedan Korczak,D,VGK,23,45,3,15,18
9,8477392,Hudson Fasching,R,NYI,29,71,11,6,17
9,8476278,Colin Blackwell,C,DAL,31,77,10,7,17
9,8479293,Brandon Tanev,L,SEA,33,68,10,7,17
9,8483524,Shane Wright,C,SEA,20,54,9,8,17
9,8476374,Sean Kuraly,C,CBJ,31,59,8,9,17
9,8476624,Barclay Goodrow,C,SJS,31,51,8,9,17
9,8477369,Carson Soucy,D,VAN,30,64,7,10,17
9,8480995,Pontus Holmberg,R,TOR,25,51,7,10,17
9,8480003,Jesper Boqvist,C,FLA,26,64,6,11,17
9,8478043,Sam Lafferty,C,BUF,29,63,6,11,17
9,8479348,Kale Clague,D,BUF,26,45,6,11,17
9,8480144,David Kampf,C,TOR,29,70,5,12,17
9,8474673,TJ Brodie,D,CHI,34,57,4,13,17
9,8475179,Dmitry Kulikov,D,FLA,34,63,4,13,17
9,8482087,Kaiden Guhle,D,MTL,22,68,3,14,17
9,8476874,Olli Maatta,D,DET,30,68,3,14,17
9,8475279,Ben Chiarot,D,DET,33,67,3,14,17
9,8477365,Connor Clifton,D,BUF,29,53,2,15,17
9,8482245,Artem Zub,D,OTT,29,69,2,15,17
9,8481059,Scott Perunovich,D,STL,26,57,2,15,17
9,8478178,Darren Raddysh,D,TBL,28,73,0,17,17
9,8480035,Henri Jokiharju,D,BUF,25,63,0,17,17
9,8481517,Brett Leason,R,ANA,25,50,9,7,16
9,8482157,Will Cuylle,L,NYR,22,60,8,8,16
9,8478432,Christian Fischer,R,DET,27,72,7,9,16
9,8482192,Isaak Phillips,D,CHI,23,53,6,10,16
9,8480289,Morgan Barron,C,WPG,26,54,6,10,16
9,8477380,Jonny Brodzinski,C,NYR,31,57,6,10,16
9,8482176,Wyatt Kaiser,D,CHI,22,52,6,10,16
9,8480074,Alexandre Texier,C,STL,25,55,5,11,16
9,8477015,Connor Brown,R,EDM,30,63,5,11,16
9,8482859,Zack Ostapchuk,C,OTT,21,55,5,11,16
9,8480025,MacKenzie Entwistle,R,FLA,25,60,4,12,16
9,8474568,Luke Schenn,D,NSH,35,54,4,12,16
9,8476994,Vinnie Hinostroza,C,NSH,30,47,4,12,16
9,8479026,Philippe Myers,D,TOR,27,58,3,13,16
9,8482073,Braden Schneider,D,NYR,23,62,2,14,16
9,8477845,Trevor van Riemsdyk,D,WSH,33,61,2,14,16
9,8480172,Jan Rutta,D,SJS,34,64,2,14,16
9,8477018,Ben Hutton,D,VGK,31,58,2,14,16
9,8483468,Jiri Kulich,C,BUF,20,48,9,6,15
9,8480011,Klim Kostin,C,SJS,25,50,9,6,15
9,8480448,Parker Kelly,L,COL,25,72,7,8,15
9,8481019,David Gustafsson,C,WPG,24,48,6,9,15
9,8478451,Ethan Bear,D,WSH,27,52,5,10,15
9,8480891,Michael Kesselring,D,UTA,24,58,3,12,15
9,8475690,Chris Tanev,D,TOR,35,57,3,12,15
9,8474013,Ian Cole,D,UTA,35,56,3,12,15
9,8475455,Brenden Dillon,D,NJD,34,59,3,12,15
9,8483466,Kevin Korchinski,D,CHI,20,53,3,12,15
9,8478136,Jake Middleton,D,MIN,28,77,2,13,15
9,8475181,Nick Leddy,D,STL,33,70,2,13,15
9,8476931,Jake McCabe,D,TOR,31,64,2,13,15
9,8476879,Cody Ceci,D,EDM,31,70,2,13,15
9,8480860,Kevin Bahl,D,CGY,24,59,1,14,15
9,8475235,Nicolas Deslauriers,L,PHI,33,61,9,5,14
9,8478585,Derek Ryan,C,EDM,38,68,8,6,14
9,8481477,Nico Sturm,C,SJS,29,53,8,6,14
9,8479968,Vinni Lettieri,C,BOS,29,52,8,6,14
9,8477508,Curtis Lazar,C,NJD,29,49,7,7,14
9,8481028,Martin Pospisil,C,CGY,25,51,7,7,14
9,8482155,Alex Laferriere,R,LAK,23,64,7,7,14
9,8481518,Nolan Foote,L,NJD,24,43,7,7,14
9,8476934,Brock McGinn,L,ANA,30,53,6,8,14
9,8481441,Joe Snively,C,DET,28,71,6,8,14
9,8481751,Lukas Rousek,R,BUF,25,42,6,8,14
9,8482762,Simon Edvinsson,D,DET,21,57,6,8,14
9,8482511,Mason Lohrei,D,BOS,23,34,6,8,14
9,8479718,Alex Barré-Boulet,C,MTL,27,55,5,9,14
9,8481522,Peyton Krebs,C,BUF,23,53,5,9,14
9,8482807,Ethan Del Mastro,D,CHI,21,54,4,10,14
9,8483482,Tristan Luneau,D,ANA,20,56,4,10,14
9,8480070,Ian Mitchell,D,BOS,25,50,4,10,14
9,8478840,Will Borgen,D,SEA,28,70,3,11,14
9,8475718,Justin Holl,D,DET,32,56,3,11,14
9,8474166,Alec Martinez,D,CHI,37,53,2,12,14
9,8482666,Scott Morrow,D,CAR,22,47,2,12,14
9,8478831,Kevin Stenlund,C,UTA,28,51,9,4,13
9,8483499,Liam Ohgren,L,MIN,20,47,8,5,13
9,8480806,Isac Lundestrom,C,ANA,25,50,7,6,13
9,8475842,Sam Carrick,C,NYR,32,52,7,6,13
9,8479520,Brandon Duhaime,R,WSH,27,55,6,7,13
9,8481550,Adam Beckman,L,NJD,23,41,6,7,13
9,8481641,Joel Kiviranta,L,COL,28,74,5,8,13
9,8480441,Trey Fix-Wolansky,R,CBJ,25,40,5,8,13
9,8479372,Joshua Mahura,D,SEA,26,49,5,8,13
9,8482166,Shakir Mukhamadullin,D,SJS,22,67,5,8,13
9,8478859,Niko Mikkola,D,FLA,28,52,4,9,13
9,8479998,Mikey Anderson,D,LAK,25,58,3,10,13
9,8479249,Andrew Poturalski,C,SJS,30,31,3,10,13
9,8478450,Parker Wotherspoon,D,BOS,27,40,3,10,13
9,8480292,Carson Meyer,R,ANA,27,34,2,11,13
9,8480880,Jakub Lauko,C,MIN,24,35,8,4,12
9,8478569,Noel Acciari,C,PIT,33,48,7,5,12
9,8479972,Mason Shaw,C,WPG,26,36,7,5,12
9,8475225,Craig Smith,C,CHI,35,49,6,6,12
9,8478424,Jansen Harkins,C,ANA,27,39,6,6,12
9,8480252,Cole Guttman,C,CHI,25,46,6,6,12
9,8481537,Nikita Okhotiuk,D,CGY,24,55,5,7,12
9,8477931,Tomas Nosek,L,FLA,32,64,5,7,12
9,8480848,Ty Dellandrea,C,SJS,24,45,4,8,12
9,8482964,Arber Xhekaj,D,MTL,23,52,3,9,12
9,8481568,Alex Vlasic,D,CHI,23,55,2,10,12
9,8480058,Pierre-Olivier Joseph,D,STL,25,47,2,10,12
9,8480807,Mattias Samuelsson,D,BUF,24,53,1,11,12
9,8479980,Nicolas Hague,D,VGK,26,52,1,11,12
9,8479371,Dante Fabbro,D,NSH,26,60,1,11,12
9,8476967,Brett Kulak,D,EDM,30,65,0,12,12
9,8482634,Alex Steeves,C,TOR,25,50,6,5,11
9,8479439,Jacob MacDonald,D,COL,31,47,5,6,11
9,8481599,Victor Soderstrom,D,UTA,23,39,5,6,11
9,8478211,Dryden Hunt,L,CGY,29,56,5,6,11
9,8479536,Axel Jonsson-Fjallby,L,WPG,26,39,5,6,11
9,8480157,Calle Rosen,D,COL,30,44,5,6,11
9,8478443,Brandon Carlo,D,BOS,28,57,4,7,11
9,8479315,Joey Anderson,R,CHI,26,41,4,7,11
9,8479981,Jonah Gadjovich,L,FLA,26,51,4,7,11
9,8480950,Ilya Lyubushkin,D,DAL,30,61,4,7,11
9,8481601,Simon Holmstrom,R,NYI,23,70,4,7,11
9,8476442,Matt Nieto,L,PIT,32,54,4,7,11
9,8477851,Jordan Oesterle,D,BOS,32,47,4,7,11
9,8481679,Maxence Guenette,D,OTT,23,40,4,7,11
9,8482765,Isak Rosen,R,BUF,21,35,2,9,11
9,8480049,Dylan Samberg,D,WPG,25,70,1,10,11
9,8470600,Ryan Suter,D,STL,39,70,1,10,11
9,8482659,Josh Doan,R,UTA,22,45,7,3,10
9,8482744,James Malatesta,L,CBJ,21,45,6,4,10
9,8477573,Nathan Walker,L,STL,30,53,6,4,10
9,8481617,Vasily Podkolzin,R,VAN,23,54,5,5,10
9,8481754,Nikita Nesterenko,C,ANA,23,33,5,5,10
9,8477938,Haydn Fleury,D,WPG,28,50,5,5,10
9,8481708,Zac Jones,D,NYR,24,54,4,6,10
9,8474034,Patrick Maroon,L,CHI,36,45,4,6,10
9,8476867,Brendan Gaunce,C,MIN,30,33,4,6,10
9,8482451,Mikael Pyyhtia,L,CBJ,23,40,3,7,10
9,8480727,Zach Whitecloud,D,VGK,28,47,2,8,10
9,8484149,Gavin Brindley,C,CBJ,20,52,2,8,10
9,8479291,Kevin Rooney,C,CGY,31,50,2,8,10
9,8483460,David Jiricek,D,CBJ,21,57,2,8,10
9,8476441,Joel Edmundson,D,LAK,31,40,2,8,10
9,8471709,Marc-Edouard Vlasic,D,SJS,37,54,1,9,10
9,8481167,Brayden Pachal,D,CGY,25,48,1,9,10
9,8480834,Ty Emberson,D,SJS,24,36,1,9,10
9,8479344,Jesse Puljujarvi,R,PIT,26,51,6,3,9
9,8479328,Julien Gauthier,R,NYI,27,63,6,3,9
9,8477887,Patrick Brown,C,BOS,32,49,4,5,9
9,8481147,Reese Johnson,C,MIN,26,41,4,5,9
9,8481161,Jake Christiansen,D,CBJ,25,64,4,5,9
9,8482751,Ryan Winterton,C,SEA,21,38,4,5,9
9,8483012,Logan Morrison,C,SEA,22,38,3,6,9
9,8477070,Liam O'Brien,C,UTA,30,51,2,7,9
9,8479671,Mathieu Olivier,R,CBJ,27,42,2,7,9
9,8474612,Travis Hamonic,D,OTT,34,50,2,7,9
9,8478146,Matthew Highmore,C,OTT,28,42,2,7,9
9,8478468,Jeremy Lauzon,D,NSH,27,54,1,8,9
9,8471677,Jack Johnson,D,CBJ,37,60,1,8,9
9,8480796,Martin Fehervary,D,WSH,25,49,1,8,9
9,8481598,Philip Broberg,D,EDM,23,35,1,8,9
9,8477462,Robert Hagg,D,VGK,29,26,1,8,9
9,8481567,Henry Thrun,D,SJS,23,49,0,9,9
9,8476858,Phillip Di Giuseppe,L,VAN,31,42,6,2,8
9,8481543,Nikita Alexandrov,C,STL,24,22,6,2,8
9,8482145,Mavrik Bourque,C,DAL,22,55,5,3,8
9,8482784,Zach Dean,C,STL,21,41,4,4,8
9,8477482,Zachary Sanford,L,CHI,30,39,3,5,8
9,8479442,Troy Stecher,D,EDM,30,52,2,6,8
9,8477034,Jaycob Megna,D,FLA,32,49,2,6,8
9,8477962,Brendan Lemieux,L,CAR,28,39,2,6,8
9,8479772,Zack MacEwen,R,OTT,28,57,2,6,8
9,8478454,Noah Juulsen,D,VAN,27,40,2,6,8
9,8482730,Brandt Clarke,D,LAK,21,44,1,7,8
9,8481178,Egor Zamula,D,PHI,24,54,1,7,8
9,8480887,Jordan Harris,D,MTL,24,54,1,7,8
9,8475177,Calvin de Haan,D,COL,33,52,1,7,8
9,8479378,Logan Stanley,D,WPG,26,31,6,1,7
9,8479638,Justin Brazeau,R,BOS,26,32,5,2,7
9,8480844,Grigori Denisenko,L,VGK,24,32,5,2,7
9,8481422,Jake Lucchini,C,NSH,29,21,5,2,7
9,8481716,Dmitri Voronkov,L,CBJ,24,42,3,4,7
9,8483495,Simon Nemec,D,NJD,20,51,3,4,7
9,8482496,Nils Aman,C,VAN,24,43,3,4,7
9,8477384,Joshua Brown,D,EDM,30,39,3,4,7
9,8474567,Zach Bogosian,D,MIN,34,59,2,5,7
9,8483630,Pavol Regenda,L,ANA,25,30,2,5,7
9,8479369,Andrew Peeke,D,BOS,26,61,2,5,7
9,8476372,Nick Seeler,D,PHI,31,42,2,5,7
9,8480845,Rasmus Kupari,C,WPG,24,41,2,5,7
9,8473446,Erik Johnson,D,PHI,36,49,2,5,7
9,8477335,Kyle Burroughs,D,LAK,29,46,2,5,7
9,8479576,Vincent Desharnais,D,VAN,28,35,1,6,7
9,8481701,Santeri Hatakka,D,NJD,23,39,1,6,7
9,8476473,Connor Murphy,D,CHI,31,33,0,7,7
9,8482713,Mackie Samoskevich,R,FLA,22,38,5,1,6
9,8476822,Luke Glendening,C,TBL,35,78,4,2,6
9,8481789,Tye Kartye,L,SEA,23,44,3,3,6
9,8480990,Declan Chisholm,D,MIN,24,40,3,3,6
9,8477073,Kurtis MacDermid,L,NJD,30,31,3,3,6
9,8476913,Devin Shore,C,MIN,30,31,2,4,6
9,8480245,Olle Lycksell,R,PHI,25,24,2,4,6
9,8477320,Anton Blidh,L,NYR,29,17,2,4,6
9,8476952,Dominic Toninato,C,WPG,30,39,1,5,6
9,8480007,Jonas Rondbjerg,R,VGK,25,36,1,5,6
9,8482733,Logan Mailloux,D,MTL,31,31,1,5,6
9,8481609,Vladislav Kolyachonok,D,UTA,23,32,1,5,6
9,8480196,Jacob Bryson,D,BUF,27,40,1,5,6
9,8479587,Rhett Gardner,C,PHI,28,13,1,5,6
9,8481605,Jackson LaCombe,D,ANA,23,32,0,6,6
9,8482652,Walker Duehr,R,CGY,27,42,4,1,5
9,8481556,John Beecher,C,BOS,23,34,4,1,5
9,8480468,James Hamblin,L,EDM,25,22,4,1,5
9,8478881,Brett Seney,L,CHI,28,16,4,1,5
9,8483549,Lucas Condotta,L,MTL,27,29,3,2,5
9,8479991,Jake Leschyshyn,C,NYR,25,26,3,2,5
9,8478021,William Lagesson,D,DET,28,23,3,2,5
9,8484254,Akito Hirose,D,VAN,25,34,2,3,5
9,8482141,Lukas Cormier,D,VGK,22,26,2,3,5
9,8482177,Marat Khusnutdinov,C,MIN,22,34,2,3,5
9,8484911,Collin Graf,R,SJS,22,37,2,3,5
9,8475750,Jon Merrill,D,MIN,32,63,1,4,5
9,8474090,Brendan Smith,D,DAL,35,53,1,4,5
9,8475762,Derek Forbort,D,VAN,32,44,1,4,5
9,8482095,Tyler Kleven,D,OTT,22,40,1,4,5
9,8482153,Brendan Brisson,C,VGK,23,29,1,4,5
9,8478502,Dennis Gilbert,D,BUF,28,26,1,4,5
9,8480870,Bo Groulx,C,NYR,24,27,1,4,5
9,8482861,Vincent Iorio,D,WSH,22,31,1,4,5
9,8475958,Michael Sgarbossa,C,WSH,32,24,0,5,5
9,8477527,Ross Johnston,L,ANA,30,34,0,5,5
9,8477401,John Hayden,C,SEA,29,32,3,1,4
9,8481065,Angus Crookshank,L,OTT,25,17,3,1,4
9,8481056,Spencer Stastney,D,NSH,24,32,2,2,4
9,8479379,Givani Smith,R,SJS,26,26,2,2,4
9,8478409,Anthony Richard,C,PHI,28,32,2,2,4
9,8482858,Ryker Evans,D,SEA,23,17,2,2,4
9,8474062,Riley Nash,C,NYR,35,14,2,2,4
9,8478446,Glenn Gawdin,C,LAK,27,10,2,2,4
9,8477473,Justin Bailey,R,SJS,29,33,2,2,4
9,8481600,Tobias Bjornfot,D,FLA,23,41,1,3,4
9,8481532,Alex Turcotte,C,LAK,23,41,1,3,4
9,8482070,Mitchell Chaffee,R,TBL,26,51,1,3,4
9,8478874,Adam Gaudette,R,OTT,28,29,1,3,4
9,8484258,Sam Malinski,D,COL,26,22,1,3,4
9,8479320,Maxime Lajoie,D,SEA,27,18,1,3,4
9,8482470,Ilya Solovyov,D,CGY,24,16,1,3,4
9,8477971,Andreas Englund,D,LAK,28,25,1,3,4
9,8479994,Jaret Anderson-Dolan,C,WPG,25,27,1,3,4
9,8482147,Jean-Luc Foudy,C,COL,22,22,1,3,4
9,8480823,Alexander Alexeyev,D,WSH,25,19,1,3,4
9,8482747,Brennan Othmann,L,NYR,21,37,0,4,4
9,8481593,Jayden Struble,D,MTL,23,15,0,4,4
9,8478477,Mitchell Stephens,C,SEA,27,17,3,0,3
9,8482102,Vasily Ponomarev,C,PIT,22,16,2,1,3
9,8481592,Jakob Pelletier,L,CGY,23,40,1,2,3
9,8478017,Mark Friedman,D,VAN,29,44,1,2,3
9,8479986,Kole Lind,R,DAL,26,46,1,2,3
9,8483619,Filip Roos,D,OTT,25,29,1,2,3
9,8480879,Jacob Bernard-Docker,D,OTT,24,45,1,2,3
9,8483570,Ben Meyers,C,SEA,26,23,1,2,3
9,8477810,Joel Hanley,D,CGY,33,21,1,2,3
9,8481122,Simon Benoit,D,TOR,26,38,1,2,3
9,8481006,Tyler Tucker,D,STL,24,15,1,2,3
9,8481541,Samuel Bolduc,D,NYI,24,29,1,2,3
9,8482165,Yan Kuznetsov,D,CGY,22,17,1,2,3
9,8483407,Brandon Scanlin,D,NYR,25,9,0,3,3
9,8484304,Uvis Balinskis,D,FLA,28,14,0,3,3
9,8483489,Fraser Minten,C,TOR,31,12,2,0,2
9,8483395,Arshdeep Bains,L,VAN,23,9,2,0,2
9,8481043,Cole Koepke,L,BOS,26,17,2,0,2
9,8482144,Jack Thompson,D,SJS,22,22,1,1,2
9,8480890,Jan Jenik,C,OTT,24,27,1,1,2
9,8482172,Landon Slaggert,L,CHI,22,18,1,1,2
9,8478011,Louie Belpedio,D,PHI,28,18,1,1,2
9,8483512,Matthew Savoie,C,EDM,20,17,1,1,2
9,8477467,Gustav Olofsson,D,SEA,30,21,1,1,2
9,8483763,Maksymilian Szuber,D,UTA,22,28,0,2,2
9,8481806,Louis Crevier,D,CHI,23,11,0,2,2
9,8477244,Chad Ruhwedel,D,NYR,34,30,0,2,2
9,8481237,Kyle MacLean,C,NYI,25,24,0,2,2
9,8484287,Cole McWard,D,VAN,23,23,0,2,2
9,8481564,Ryan Johnson,D,BUF,23,11,0,2,2
9,8482201,Gage Goncalves,C,TBL,23,27,0,2,2
9,8480084,Nick DeSimone,D,NJD,30,12,0,2,2
9,8481719,Maxwell Crozier,D,TBL,24,18,0,2,2
9,8483397,Marc McLaughlin,C,BOS,25,26,1,0,1
9,8481743,Marc Del Gaizo,D,NSH,25,18,1,0,1
9,8479367,William Lockwood,R,FLA,26,23,1,0,1
9,8484325,Waltteri Merela,C,TBL,26,15,1,0,1
9,8479330,Brandon Gignac,C,MTL,27,8,1,0,1
9,8482476,Emil Heineman,L,MTL,23,7,1,0,1
9,8481699,Aku Raty,R,UTA,23,16,1,0,1
9,8478051,Max Willman,C,NJD,29,19,1,0,1
9,8481462,Mason Morelli,L,VGK,28,10,1,0,1
9,8481578,Graeme Clarke,R,MIN,23,9,0,1,1
9,8479985,Cale Fleury,D,SEA,26,24,0,1,1
9,8481030,Jack St. Ivany,D,PIT,25,19,0,1,1
9,8479362,Riley Tufte,L,BOS,26,21,0,1,1
9,8482061,Brandon Biro,L,SEA,26,9,0,1,1
9,8482118,Sam Colangelo,R,ANA,23,17,0,1,1
9,8482250,Callahan Burke,C,VGK,27,25,0,1,1
9,8480032,Shane Bowers,C,NJD,25,22,0,1,1
9,8475413,Justin Dowling,C,NJD,34,14,0,1,1
9,8480267,Sammy Walker,C,MIN,25,11,0,1,1
9,8482088,Justin Sourdif,R,FLA,22,19,0,1,1
9,8481024,Linus Karlsson,C,VAN,25,10,0,1,1
9,8482162,Roby Jarventie,L,EDM,22,14,0,1,1
9,8483432,Luca Del Bel Belluz,C,CBJ,31,5,0,1,1
9,8475795,Dylan McIlrath,D,WSH,32,14,0,1,1
9,8479419,Brett Murray,L,BUF,26,18,0,1,1
9,8477149,Scott Sabourin,R,SJS,32,20,0,1,1
9,8479522,Hardy Haman Aktell,D,WSH,26,1,0,1,1
9,8480851,Akil Thomas,C,LAK,24,14,0,0,0
9,8482516,Matthew Kessel,D,STL,24,20,0,0,0
9,8481585,Egor Afanasyev,L,SJS,23,10,0,0,0
9,8482929,Emil Lilleberg,D,TBL,23,15,0,0,0
9,8481655,Cole Schwindt,R,CGY,23,8,0,0,0
9,8484326,Patrik Koch,D,UTA,28,2,0,0,0
9,8481206,John Ludvig,D,PIT,24,7,0,0,0
9,8482197,Adam Raska,R,MIN,23,8,0,0,0
9,8480874,Adam Ginning,D,PHI,24,7,0,0,0
9,8477541,Dakota Mermis,D,TOR,30,14,0,0,0
9,8483471,Brad Lambert,C,WPG,31,13,0,0,0
9,8478854,Ryan Shea,D,PIT,27,7,0,0,0
9,8482094,Daemon Hunt,D,MIN,22,17,0,0,0
9,8475780,Chris Wagner,R,COL,33,8,0,0,0
9,8483609,Adam Klapka,R,CGY,24,4,0,0,0
9,8481534,Raphael Lavoie,C,EDM,24,1,0,0,0
9,8480306,Grant Hutton,D,NYI,29,5,0,0,0
9,8483597,Milos Kelemen,L,UTA,25,14,0,0,0
9,8480075,Cameron Crotty,D,MIN,25,8,0,0,0
9,8482460,Matt Rempe,C,NYR,22,10,0,0,0
9,8478147,Bokondji Imama,L,PIT,28,3,0,0,0
9,8484259,Ondrej Pavel,C,COL,31,2,0,0,0
9,8481726,Adam Edstrom,C,NYR,24,7,0,0,0
9,8483567,Georgii Merkulov,C,BOS,24,13,0,0,0
9,8483398,Declan Carlile,D,TBL,31,4,0,0,0
9,8477993,Justin Kirkland,C,CGY,28,5,0,0,0
9,8483920,Pierrick Dube,R,WSH,23,8,0,0,0
9,8476323,Max McCormick,L,SEA,32,5,0,0,0
9,8483546,Marshall Rifai,D,TOR,26,3,0,0,0
9,8475755,Alexander Petrovic,D,DAL,32,4,0,0,0
9,8482787,Nikita Chibrikov,R,WPG,31,8,0,0,0
9,8482126,Emil Andrae,D,PHI,31,5,0,0,0
9,8484255,Jason Polin,R,COL,25,9,0,0,0
9,8479421,Jacob Moverare,D,LAK,26,9,0,0,0
9,8483531,Brian Halonen,L,NJD,25,2,0,0,0
9,8470794,Joe Pavelski,C,,40,0,0,0,0
9,8479321,Lucas Johansen,D,,27,0,0,0,0
9,8477950,Tony DeAngelo,D,,29,0,0,0,0
9,8471218,Blake Wheeler,R,,38,0,0,0,0
9,8475197,Tyson Barrie,D,,33,0,0,0,0
9,8474157,Max Pacioretty,L,,36,0,0,0,0
9,8475744,Evgeny Kuznetsov,C,,32,0,0,0,0
9,8474037,James van Riemsdyk,L,,35,0,0,0,0
9,8476907,Mackenzie MacEachern,L,,30,0,0,0,0
9,8480216,Jacob Peterson,C,,25,0,0,0,0
9,8474602,Justin Schultz,D,,34,0,0,0,0
9,8482222,Alexander Barabanov,L,,30,0,0,0,0
9,8474031,Kevin Shattenkirk,D,,35,0,0,0,0
9,8477330,Dominik Kubalik,L,,29,0,0,0,0
9,8480884,Calen Addison,D,,24,0,0,0,0
9,8475906,John Klingberg,D,,32,0,0,0,0
9,8480008,Adam Ruzicka,C,,25,0,0,0,0
9,8476884,Derrick Pouliot,D,,30,0,0,0,0
9,8476919,Chris Tierney,C,,30,0,0,0,0
9,8479415,Michael McLeod,C,,26,0,0,0,0
9,8474870,Tyler Johnson,C,,34,0,0,0,0
9,8470604,Jeff Carter,C,,39,0,0,0,0
9,8478104,Sammy Blais,L,,28,0,0,0,0
9,8474884,Mike Hoffman,C,,35,0,0,0,0
9,8481591,Sam Poulin,R,,23,0,0,0,0
9,8471274,Alex Goligoski,D,,39,0,0,0,0
9,8476871,Tanner Pearson,L,,32,0,0,0,0
9,8476393,Nick Cousins,C,,31,0,0,0,0
9,8479977,Kailer Yamamoto,R,,26,0,0,0,0
9,8479346,Dillon Dube,C,,26,0,0,0,0
9,8480184,Gustav Lindstrom,D,,26,0,0,0,0
9,8479376,Victor Mete,D,,26,0,0,0,0
9,8473449,Kyle Okposo,R,,36,0,0,0,0
9,8481058,Jesse Ylonen,R,,25,0,0,0,0
9,8475752,Tyler Pitlick,C,,33,0,0,0,0
9,8481239,Samuel Fagemo,L,,24,0,0,0,0
9,8480821,Filip Zadina,R,,25,0,0,0,0
9,8470966,Mark Giordano,D,,41,0,0,0,0
9,8478495,Denis Gurianov,R,,27,0,0,0,0
9,8477464,Nic Petan,C,,29,0,0,0,0
9,8478099,Kevin Labanc,R,,29,0,0,0,0
9,8482241,Radim Zohorna,L,,28,0,0,0,0
9,8474040,Sam Gagner,C,,35,0,0,0,0
9,8479514,Rem Pitlick,C,,27,0,0,0,0
9,8478430,Oliver Kylington,D,,27,0,0,0,0
9,8479533,Joona Koppanen,L,,26,0,0,0,0
9,8479984,Cal Foote,D,,26,0,0,0,0
9,8477126,Jayson Megna,C,,34,0,0,0,0
9,8475164,Jakob Silfverberg,R,,34,0,0,0,0
9,8474009,Nick Bonino,C,,36,0,0,0,0
9,8479458,Nikita Zaitsev,D,,33,0,0,0,0
9,8477944,Jakub Vrana,L,,28,0,0,0,0
9,8471699,Andrew Cogliano,C,,37,0,0,0,0
9,8478067,Oskar Lindblom,L,,28,0,0,0,0
9,8471686,Marc Staal,D,,37,0,0,0,0
9,8470610,Zach Parise,L,,40,0,0,0,0
9,8478904,Steven Lorentz,C,,28,0,0,0,0
9,8473473,Milan Lucic,L,,36,0,0,0,0
9,8480031,Maxime Comtois,L,,25,0,0,0,0
9,8478512,Austin Czarnik,C,,32,0,0,0,0
9,8473504,Cal Clutterbuck,R,,37,0,0,0,0
9,8477454,Adam Erne,L,,29,0,0,0,0
9,8479383,Boris Katchouk,L,,26,0,0,0,0
9,8475825,Jani Hakanpää,D,,32,0,0,0,0
9,8477846,Ryan Carpenter,C,,33,0,0,0,0
9,8477930,Pierre-Edouard Bellemare,L,,39,0,0,0,0
9,8478400,Colin White,C,,27,0,0,0,0
9,8480226,Marián Studenic,R,,26,0,0,0,0
9,8480853,Liam Foudy,C,,24,0,0,0,0
9,8475797,Jarred Tinordi,D,,32,0,0,0,0
9,8479423,Alex Nylander,L,,26,0,0,0,0
9,8474618,Marco Scandella,D,,34,0,0,0,0
9,8478028,Fredrik Olofsson,L,,28,0,0,0,0
9,8474709,Matt Martin,L,,35,0,0,0,0
9,8481070,Hugh McGing,L,,26,0,0,0,0
9,8479546,Oskar Steen,C,,26,0,0,0,0
9,8474145,Robert Bortuzzo,D,,35,0,0,0,0
9,8476915,Jujhar Khaira,L,,30,0,0,0,0
9,8480274,Philip Kemp,D,EDM,25,0,0,0,0
9,8484321,Nikolas Matinpalo,D,OTT,26,1,0,0,0
9,8475278,Byron Froese,C,,33,0,0,0,0
9,8481812,Nikolai Knyzhov,D,,27,0,0,0,0
9,8478408,Travis Dermott,D,,28,0,0,0,0
9,8481077,John Leonard,L,,26,0,0,0,0
9,8479547,Matthew Phillips,R,,26,0,0,0,0
9,8480836,Jonathan Gruden,C,,24,0,0,0,0
9,8481690,Tyler Angle,C,,24,0,0,0,0
9,8475766,Austin Watson,L,,32,0,0,0,0
9,8481016,Ruslan Iskhakov,C,,24,0,0,0,0
9,8478078,Rourke Chartier,C,,28,0,0,0,0
9,8483401,Marc Johnstone,R,PIT,28,0,0,0,0
9,8480776,Sheldon Rempal,R,,29,0,0,0,0
9,8478956,Samuel Laberge,L,NJD,27,0,0,0,0
9,8483045,Cameron Butler,R,CBJ,31,1,0,0,0
9,8484314,Jiri Smejkal,L,,28,0,0,0,0
10,8478402,Connor McDavid,C,EDM,27,78,31,107,138
10,8476453,Nikita Kucherov,R,TBL,31,81,43,91,134
10,8477492,Nathan MacKinnon,C,COL,29,82,50,83,133
10,8478483,Mitch Marner,R,TOR,27,79,46,77,123
10,8478420,Mikko Rantanen,R,COL,28,81,45,76,121
10,8478864,Kirill Kaprizov,L,MIN,27,77,45,67,112
10,8479318,Auston Matthews,C,TOR,27,81,56,54,110
10,8477939,William Nylander,R,TOR,28,80,50,60,110
10,8480801,Brady Tkachuk,L,OTT,25,80,43,62,105
10,8477956,David Pastrnak,R,BOS,28,80,48,55,103
10,8477942,Kevin Fiala,L,LAK,28,82,41,62,103
10,8481559,Jack Hughes,C,NJD,23,72,40,60,100
10,8480012,Elias Pettersson,C,VAN,26,76,42,56,98
10,8477934,Leon Draisaitl,C,EDM,29,77,35,63,98
10,8477493,Aleksander Barkov,C,FLA,29,79,28,69,97
10,8478550,Artemi Panarin,L,NYR,33,77,40,55,95
10,8476887,Filip Forsberg,L,NSH,30,74,40,55,95
10,8482116,Tim Stützle,C,OTT,22,79,33,62,95
10,8475172,Nazem Kadri,C,CGY,34,77,39,54,93
10,8479314,Matthew Tkachuk,L,FLA,27,80,31,62,93
10,8480800,Quinn Hughes,D,VAN,25,75,15,78,93
10,8479385,Jordan Kyrou,C,STL,26,75,45,46,91
10,8477946,Dylan Larkin,C,DET,28,81,41,50,91
10,8476468,J.T. Miller,C,VAN,31,76,39,52,91
10,8476389,Vincent Trocheck,C,NYR,31,80,31,59,90
10,8479323,Adam Fox,D,NYR,26,75,15,75,90
10,8474564,Steven Stamkos,C,NSH,34,74,39,50,89
10,8478010,Brayden Point,C,TBL,28,81,43,45,88
10,8477933,Sam Reinhart,C,FLA,29,79,44,43,87
10,8477404,Jake Guentzel,C,TBL,30,81,41,46,87
10,8475810,Bryan Rust,R,PIT,32,81,29,58,87
10,8479407,Jesper Bratt,L,NJD,26,73,28,59,87
10,8480027,Jason Robertson,L,DAL,25,81,36,49,85
10,8480069,Cale Makar,D,COL,26,73,26,58,84
10,8477409,Carter Verhaeghe,C,FLA,29,79,42,41,83
10,8476459,Mika Zibanejad,C,NYR,31,77,33,50,83
10,8473419,Brad Marchand,L,BOS,36,79,37,45,82
10,8476346,Johnny Gaudreau,L,CBJ,31,71,28,54,82
10,8475913,Mark Stone,R,VGK,32,76,30,51,81
10,8477501,Valeri Nichushkin,R,COL,29,81,37,43,80
10,8478439,Travis Konecny,R,PHI,27,72,23,57,80
10,8482093,Seth Jarvis,C,CAR,22,73,30,49,79
10,8480002,Nico Hischier,C,NJD,25,71,26,53,79
10,8478445,Mathew Barzal,C,NYI,27,77,25,53,78
10,8478427,Sebastian Aho,C,CAR,27,70,34,43,77
10,8475784,Jeff Skinner,C,EDM,32,73,33,44,77
10,8471675,Sidney Crosby,C,PIT,37,72,32,45,77
10,8474578,Erik Karlsson,D,PIT,34,79,21,56,77
10,8481557,Matt Boldy,L,MIN,23,74,30,46,76
10,8471214,Alex Ovechkin,L,WSH,39,74,39,36,75
10,8477960,Adrian Kempe,R,LAK,28,80,37,38,75
10,8477949,Alex Tuch,R,BUF,28,73,28,47,75
10,8476454,Ryan Nugent-Hopkins,C,EDM,31,79,19,56,75
10,8479337,Alex DeBrincat,R,DET,27,81,27,47,74
10,8474600,Roman Josi,D,NSH,34,77,16,58,74
10,8477951,Nick Schmaltz,C,UTA,28,76,24,49,73
10,8471685,Anze Kopitar,C,LAK,37,81,22,51,73
10,8478460,Zach Werenski,D,CBJ,27,80,16,57,73
10,8480036,Miro Heiskanen,D,DAL,25,77,14,59,73
10,8478414,Timo Meier,R,NJD,28,81,35,37,72
10,8484144,Connor Bedard,C,CHI,19,66,24,48,72
10,8478403,Jack Eichel,C,VGK,28,77,32,39,71
10,8480023,Robert Thomas,C,STL,25,73,31,40,71
10,8475166,John Tavares,C,TOR,34,75,31,40,71
10,8479343,Clayton Keller,R,UTA,26,79,33,37,70
10,8478398,Kyle Connor,L,WPG,28,71,30,40,70
10,8480018,Nick Suzuki,C,MTL,25,74,22,48,70
10,8480803,Evan Bouchard,D,EDM,25,75,18,52,70
10,8481540,Cole Caufield,R,MTL,23,75,33,36,69
10,8477504,Josh Morrissey,D,WPG,29,70,19,50,69
10,8475167,Victor Hedman,D,TBL,34,78,15,53,68
10,8482740,Wyatt Johnston,C,DAL,21,81,39,28,67
10,8481068,Yegor Sharangovich,C,CGY,26,76,36,31,67
10,8477500,Bo Horvat,C,NYI,29,82,35,32,67
10,8476460,Mark Scheifele,C,WPG,31,70,30,37,67
10,8475754,Brock Nelson,C,NYI,33,79,26,41,67
10,8473994,Jamie Benn,L,DAL,35,80,24,43,67
10,8478975,Mason Marchment,L,DAL,29,81,27,39,66
10,8481528,Dylan Cozens,C,BUF,23,74,26,40,66
10,8477447,Shea Theodore,D,VGK,29,69,16,50,66
10,8479542,Brandon Hagel,L,TBL,26,82,33,32,65
10,8475158,Ryan O'Reilly,C,NSH,33,72,29,36,65
10,8477402,Pavel Buchnevich,L,STL,29,75,27,38,65
10,8479420,Tage Thompson,C,BUF,27,75,33,31,64
10,8476483,Rickard Rakell,R,PIT,31,71,30,34,64
10,8479675,Trevor Moore,L,LAK,29,80,29,35,64
10,8478873,Troy Terry,R,ANA,27,73,21,43,64
10,8478407,Vince Dunn,D,SEA,28,73,16,48,64
10,8475184,Chris Kreider,L,NYR,33,78,37,26,63
10,8480830,Andrei Svechnikov,R,CAR,24,71,26,37,63
10,8478401,Pavel Zacha,C,BOS,27,80,29,33,62
10,8478493,Joel Eriksson Ek,C,MIN,27,70,24,38,62
10,8476399,Blake Coleman,C,CGY,33,73,23,39,62
10,8480039,Martin Necas,C,CAR,25,70,16,46,62
10,8476432,Boone Jenner,C,CBJ,31,72,34,27,61
10,8476456,Jonathan Huberdeau,C,CGY,31,82,18,43,61
10,8480865,Noah Dobson,D,NYI,24,81,7,54,61
10,8478449,Roope Hintz,C,DAL,28,82,29,31,60
10,8476448,William Karlsson,C,VGK,31,74,27,33,60
10,8481533,Trevor Zegras,C,ANA,23,68,22,38,60
10,8478047,Michael Bunting,L,PIT,29,73,22,38,60
10,8477416,Oliver Bjorkstrand,R,SEA,29,71,22,38,60
10,8480839,Rasmus Dahlin,D,BUF,24,73,19,41,60
10,8476539,Jonathan Marchessault,R,NSH,34,75,34,25,59
10,8475170,Brayden Schenn,C,STL,33,75,23,36,59
10,8474150,Mikael Backlund,C,CGY,35,76,18,41,59
10,8475692,Mats Zuccarello,R,MIN,37,71,14,45,59
10,8477407,Anthony Duclair,L,NYI,29,79,31,27,58
10,8483808,Andrei Kuzmenko,L,CGY,28,79,30,28,58
10,8482078,Lucas Raymond,L,DET,22,78,29,29,58
10,8471215,Evgeni Malkin,C,PIT,38,72,23,35,58
10,8474679,Gustav Nyquist,C,NSH,35,75,20,38,58
10,8477955,Jared McCann,L,SEA,28,70,30,27,57
10,8475745,Charlie Coyle,C,BOS,32,78,29,28,57
10,8477451,Ryan Hartman,R,MIN,30,65,27,30,57
10,8482110,Dawson Mercer,C,NJD,23,76,26,31,57
10,8478856,Conor Garland,R,VAN,28,76,24,33,57
10,8473512,Claude Giroux,R,OTT,36,78,22,35,57
10,8477503,Max Domi,C,TOR,29,80,14,43,57
10,8471724,Kris Letang,D,PIT,37,78,11,46,57
10,8477935,Sam Bennett,C,FLA,28,74,29,27,56
10,8481560,Arthur Kaliyev,R,LAK,23,81,27,29,56
10,8482699,Dylan Guenther,R,UTA,21,75,23,33,56
10,8479325,Charlie McAvoy,D,BOS,27,78,14,42,56
10,8475798,Mikael Granlund,C,SJS,32,69,12,44,56
10,8475794,Tyler Seguin,C,DAL,32,82,27,28,55
10,8475765,Vladimir Tarasenko,R,DET,33,80,21,34,55
10,8484166,Adam Fantilli,C,CBJ,20,70,19,36,55
10,8475168,Matt Duchene,C,DAL,33,82,15,40,55
10,8475764,Cam Fowler,D,ANA,33,78,11,44,55
10,8478444,Brock Boeser,R,VAN,27,79,28,26,54
10,8482109,Alexis Lafrenière,L,NYR,23,74,24,30,54
10,8478462,Nicolas Roy,C,VGK,27,78,18,36,54
10,8477986,Brandon Montour,D,SEA,30,75,15,39,54
10,8477940,Nikolaj Ehlers,L,WPG,28,71,13,41,54
10,8477496,Elias Lindholm,C,BOS,30,74,18,35,53
10,8475786,Zach Hyman,L,EDM,32,76,30,22,52
10,8475191,Reilly Smith,R,NYR,33,75,27,25,52
10,8482159,Tyson Foerster,R,PHI,22,74,25,27,52
10,8474641,Adam Henrique,C,EDM,34,77,24,28,52
10,8474141,Patrick Kane,R,DET,36,80,23,29,52
10,8480208,Drake Batherson,R,OTT,26,79,18,34,52
10,8481711,Matias Maccelli,L,UTA,24,74,14,38,52
10,8476881,Tomas Hertl,C,VGK,31,72,24,27,51
10,8476853,Morgan Rielly,D,TOR,30,73,10,41,51
10,8483515,Juraj Slafkovsky,L,MTL,20,72,24,26,50
10,8476882,Teuvo Teravainen,C,CHI,30,68,21,29,50
10,8477476,Artturi Lehkonen,L,COL,29,82,19,31,50
10,8476906,Shayne Gostisbehere,D,CAR,31,75,15,35,50
10,8480797,Joel Farabee,L,PHI,24,74,15,35,50
10,8474565,Alex Pietrangelo,D,VGK,34,68,7,43,50
10,8480015,Owen Tippett,R,PHI,25,72,22,27,49
10,8473986,Alex Killorn,L,ANA,35,74,21,28,49
10,8476905,Chandler Stephenson,C,SEA,30,74,18,31,49
10,8482092,Ridly Greig,C,OTT,22,79,17,32,49
10,8476958,Jaccob Slavin,D,CAR,30,76,16,33,49
10,8479339,Patrik Laine,L,CBJ,26,67,15,34,49
10,8483431,Logan Cooley,C,UTA,20,76,15,34,49
10,8477932,Aaron Ekblad,D,FLA,28,76,14,35,49
10,8478038,Devon Toews,D,COL,30,72,11,38,49
10,8477479,Tyler Bertuzzi,L,CHI,29,65,21,27,48
10,8482097,Jack Quinn,R,BUF,23,64,19,29,48
10,8482113,Anton Lundell,C,FLA,23,75,17,31,48
10,8483505,Matthew Poitras,C,BOS,20,77,14,34,48
10,8478469,Thomas Chabot,D,OTT,27,75,9,39,48
10,8478366,Frank Vatrano,R,ANA,30,69,24,23,47
10,8477494,Jonathan Drouin,L,COL,29,81,23,24,47
10,8481604,Pavel Dorofeyev,L,VGK,24,75,21,26,47
10,8481524,Bowen Byram,D,BUF,23,68,19,28,47
10,8482124,Quinton Byfield,R,LAK,22,76,15,32,47
10,8477346,MacKenzie Weegar,D,CGY,30,72,12,35,47
10,8482684,Luke Hughes,D,NJD,21,71,10,37,47
10,8477497,Sean Monahan,C,CBJ,30,68,22,24,46
10,8481596,Shane Pinto,C,OTT,24,72,21,25,46
10,8481618,Alex Newhook,C,MTL,23,73,20,26,46
10,8477495,Seth Jones,D,CHI,30,68,12,34,46
10,8481542,Moritz Seider,D,DET,23,74,12,34,46
10,8481581,Thomas Harley,D,DAL,23,76,9,37,46
10,8475726,Tyler Toffoli,C,SJS,32,69,25,20,45
10,8480188,Fabian Zetterlund,L,SJS,25,68,17,28,45
10,8477444,Andre Burakovsky,L,SEA,29,71,12,33,45
10,8474590,John Carlson,D,WSH,34,67,9,36,45
10,8478115,Pierre Engvall,L,NYI,28,78,22,22,44
10,8475793,Ryan Johansen,C,PHI,32,75,21,23,44
10,8474053,Logan Couture,C,SJS,35,67,19,25,44
10,8478042,Viktor Arvidsson,L,EDM,31,73,19,25,44
10,8477964,Ivan Barbashev,C,VGK,29,74,16,28,44
10,8477021,Alex Kerfoot,C,UTA,30,72,13,31,44
10,8480798,Philipp Kurashev,C,CHI,25,59,13,31,44
10,8475722,Jason Zucker,L,BUF,32,64,21,22,43
10,8478519,Anthony Cirelli,C,TBL,27,82,20,23,43
10,8477456,J.T. Compher,L,DET,29,78,18,25,43
10,8479999,Casey Mittelstadt,C,COL,26,80,14,29,43
10,8480185,Eetu Luostarinen,C,FLA,26,75,13,30,43
10,8476875,Mike Matheson,D,MTL,30,74,10,33,43
10,8475768,Jaden Schwartz,C,SEA,32,72,21,21,42
10,8480220,Noah Cates,L,PHI,25,69,18,24,42
10,8482665,Matty Beniers,C,SEA,22,70,17,25,42
10,8480829,Jesperi Kotkaniemi,C,CAR,24,69,17,25,42
10,8484153,Leo Carlsson,C,ANA,20,74,15,27,42
10,8484145,Zach Benson,L,BUF,19,70,14,28,42
10,8476462,Dougie Hamilton,D,NJD,31,71,7,35,42
10,8476438,Brandon Saad,L,STL,32,73,24,17,41
10,8475169,Evander Kane,L,EDM,33,67,23,18,41
10,8480014,Gabriel Vilardi,C,WPG,25,65,22,19,41
10,8482475,Yegor Chinakhov,R,CBJ,23,64,20,21,41
10,8482149,Cole Perfetti,C,WPG,22,68,18,23,41
10,8477511,Anthony Mantha,R,CGY,30,74,17,24,41
10,8480835,Jack Drury,C,CAR,24,61,17,24,41
10,8482702,Logan Stankoven,C,DAL,21,80,15,26,41
10,8482705,Cole Sillinger,C,CBJ,21,64,15,26,41
10,8479410,Mikhail Sergachev,D,UTA,26,70,14,27,41
10,8477429,Andrew Copp,C,DET,30,76,7,34,41
10,8474563,Drew Doughty,D,LAK,35,70,6,35,41
10,8475151,Kyle Palmieri,C,NYI,33,79,19,21,40
10,8476479,Phillip Danault,C,LAK,31,80,18,22,40
10,8482660,Kent Johnson,C,CBJ,22,62,15,25,40
10,8478438,Tommy Novak,C,NSH,27,71,13,27,40
10,8480817,K'Andre Miller,D,NYR,24,73,10,30,40
10,8477498,Darnell Nurse,D,EDM,29,72,8,32,40
10,8475753,Justin Faulk,D,STL,32,71,7,33,40
10,8480145,Neal Pionk,D,WPG,29,77,6,34,40
10,8479525,Ross Colton,C,COL,28,81,19,20,39
10,8482175,JJ Peterka,R,BUF,22,67,18,21,39
10,8482745,Mason McTavish,C,ANA,21,72,17,22,39
10,8478542,Evan Rodrigues,C,FLA,31,78,15,24,39
10,8480078,Filip Chytil,C,NYR,25,68,15,24,39
10,8478458,John (Jack) Roslovic,C,CAR,27,62,15,24,39
10,8479400,Pierre-Luc Dubois,L,WSH,26,74,21,17,38
10,8478498,Jake DeBrusk,L,VAN,28,68,19,19,38
10,8479987,Morgan Geekie,C,BOS,26,77,19,19,38
10,8479992,Michael Rasmussen,C,DET,25,76,18,20,38
10,8478466,Daniel Sprong,R,VAN,27,69,13,25,38
10,8474102,David Perron,L,OTT,36,81,11,27,38
10,8478397,Rasmus Andersson,D,CGY,28,71,6,32,38
10,8476792,Torey Krug,D,STL,33,73,5,33,38
10,8476278,Colin Blackwell,C,DAL,31,81,20,17,37
10,8481523,Kirby Dach,C,MTL,23,70,17,20,37
10,8475218,Mattias Ekholm,D,EDM,34,74,16,21,37
10,8476872,Scott Laughton,C,PHI,30,70,16,21,37
10,8477953,Kasperi Kapanen,R,STL,28,71,15,22,37
10,8478440,Dylan Strome,C,WSH,27,71,13,24,37
10,8478472,Mathieu Joseph,R,STL,27,68,12,25,37
10,8477947,Sonny Milano,L,WSH,28,61,12,25,37
10,8482133,Thomas Bordeleau,C,SJS,22,63,10,27,37
10,8482712,Oskar Olausson,R,COL,22,74,9,28,37
10,8476979,Erik Gustafsson,D,DET,32,78,9,28,37
10,8476854,Hampus Lindholm,D,BOS,30,69,4,33,37
10,8476892,Colton Parayko,D,STL,31,68,4,33,37
10,8478055,Gustav Forsling,D,FLA,28,73,13,23,36
10,8474586,Jordan Eberle,R,SEA,34,73,9,27,36
10,8480434,Sean Durzi,D,UTA,26,76,9,27,36
10,8476927,Teddy Blueger,C,VAN,30,70,8,28,36
10,8479425,Filip Hronek,D,VAN,27,67,4,32,36
10,8476392,Adam Lowry,C,WPG,31,66,19,16,35
10,8480064,Josh Norris,C,OTT,25,77,17,18,35
10,8476880,Tom Wilson,R,WSH,30,68,16,19,35
10,8476480,Vladislav Namestnikov,C,WPG,32,62,15,20,35
10,8476826,Yanni Gourde,C,SEA,33,68,14,21,35
10,8474716,Jared Spurgeon,D,MIN,35,75,13,22,35
10,8479351,Sam Steel,C,DAL,26,79,11,24,35
10,8479345,Jakob Chychrun,D,WSH,26,70,8,27,35
10,8478396,Noah Hanifin,D,VGK,27,61,6,29,35
10,8476461,Sean Couturier,C,PHI,32,71,18,16,34
10,8480748,Kiefer Sherwood,L,VAN,29,61,18,16,34
10,8477952,Robby Fabbri,C,ANA,28,63,16,18,34
10,8475314,Anders Lee,L,NYI,34,78,15,19,34
10,8477998,Warren Foegele,L,LAK,28,76,14,20,34
10,8480802,Ryan McLeod,C,BUF,25,67,12,22,34
10,8481186,Logan O'Connor,R,COL,28,81,12,22,34
10,8481606,Jordan Spence,D,LAK,23,70,12,22,34
10,8478133,Jake Evans,C,MTL,28,70,12,22,34
10,8482720,Matthew Knies,L,TOR,22,73,11,23,34
10,8476419,Jean-Gabriel Pageau,C,NYI,32,76,11,23,34
10,8483490,Pavel Mintyukov,D,ANA,21,73,9,25,34
10,8481577,Philip Tomasino,C,NSH,23,62,8,26,34
10,8482122,Brock Faber,D,MIN,22,81,8,26,34
10,8481582,Nicholas Robertson,L,TOR,23,67,21,12,33
10,8475799,Nino Niederreiter,R,WPG,32,64,19,14,33
10,8476921,Jordan Martinook,L,CAR,32,68,17,16,33
10,8480113,Alex Iafallo,L,WPG,31,65,17,16,33
10,8474715,Cameron Atkinson,R,TBL,35,80,12,21,33
10,8476925,Colton Sissons,C,NSH,31,64,12,21,33
10,8482671,Owen Power,D,BUF,22,65,9,24,33
10,8477969,Marcus Pettersson,D,PIT,28,79,5,28,33
10,8475714,Calle Jarnkrok,C,TOR,33,74,17,15,32
10,8481703,Valtteri Puustinen,R,PIT,25,60,15,17,32
10,8482146,Luke Evangelista,R,NSH,22,67,12,20,32
10,8470613,Brent Burns,D,CAR,39,78,6,26,32
10,8478463,Anthony Beauvillier,L,PIT,27,62,20,11,31
10,8482089,Jake Neighbours,L,STL,22,66,19,12,31
10,8481535,Nils Hoglander,L,VAN,24,63,18,13,31
10,8480068,Ryan Poehling,C,PHI,25,70,16,15,31
10,8480459,Pius Suter,C,VAN,28,66,13,18,31
10,8474149,Evgenii Dadonov,R,DAL,35,80,11,20,31
10,8475763,Kevin Hayes,R,PIT,32,73,11,20,31
10,8478233,Andrew Mangiapane,L,WSH,28,65,10,21,31
10,8476869,Brady Skjei,D,NSH,30,69,9,22,31
10,8479365,Trent Frederic,C,BOS,26,76,9,22,31
10,8476917,Adam Pelech,D,NYI,30,80,8,23,31
10,8479661,Tanner Jeannot,L,LAK,27,79,8,23,31
10,8478474,Lawson Crouse,L,UTA,27,71,22,8,30
10,8482667,William Eklund,L,SJS,22,65,18,12,30
10,8477425,Miles Wood,L,COL,29,74,18,12,30
10,8476292,Ondrej Palat,L,NJD,33,68,17,13,30
10,8477406,Mattias Janmark,C,EDM,32,74,16,14,30
10,8480849,Barrett Hayton,C,UTA,24,76,15,15,30
10,8473422,Nick Foligno,L,CHI,37,59,14,16,30
10,8478109,Victor Olofsson,L,VGK,29,73,14,16,30
10,8480806,Isac Lundestrom,C,ANA,25,56,13,17,30
10,8480871,Adam Boqvist,D,FLA,24,71,12,18,30
10,8477426,Nicholas Paul,L,TBL,29,81,11,19,30
10,8475287,Erik Haula,L,NJD,33,70,9,21,30
10,8481014,Alexander Romanov,D,NYI,24,78,3,27,30
10,8482055,Drew O'Connor,L,PIT,26,59,18,11,29
10,8476474,Stefan Noesen,R,NJD,31,68,17,12,29
10,8480009,Eeli Tolvanen,R,SEA,25,74,16,13,29
10,8470621,Corey Perry,R,EDM,39,70,16,13,29
10,8483468,Jiri Kulich,C,BUF,20,57,16,13,29
10,8478057,Dakota Joshua,C,VAN,28,66,15,14,29
10,8480813,Joe Veleno,C,DET,24,79,15,14,29
10,8479293,Brandon Tanev,L,SEA,33,67,15,14,29
10,8478891,Mason Appleton,C,WPG,28,66,13,16,29
10,8479353,Brett Howden,C,VGK,26,64,11,18,29
10,8476374,Sean Kuraly,C,CBJ,31,57,11,18,29
10,8480028,Morgan Frost,C,PHI,25,73,10,19,29
10,8476458,Ryan Strome,C,ANA,31,69,9,20,29
10,8479591,Michael Eyssimont,C,TBL,28,81,8,21,29
10,8478500,Ivan Provorov,D,CBJ,27,76,8,21,29
10,8477220,Nate Schmidt,D,FLA,33,65,7,22,29
10,8477488,Brett Pesce,D,NJD,30,72,6,23,29
10,8480043,Timothy Liljegren,D,TOR,25,64,3,26,29
10,8480281,Alexey Toropchenko,R,STL,25,59,17,11,28
10,8476981,Josh Anderson,R,MTL,30,62,17,11,28
10,8478413,Jordan Greenway,L,BUF,27,61,12,16,28
10,8482074,Connor Zary,C,CGY,23,62,12,16,28
10,8482079,Marco Rossi,C,MIN,23,68,12,16,28
10,8479941,Justin Danforth,R,CBJ,31,50,9,19,28
10,8473533,Jordan Staal,C,CAR,36,60,6,22,28
10,8476879,Cody Ceci,D,EDM,31,71,5,23,28
10,8479398,Samuel Girard,D,COL,26,73,1,27,28
10,8480893,Kirill Marchenko,R,CBJ,24,58,18,9,27
10,8477903,Garnet Hathaway,R,PHI,33,62,16,11,27
10,8481554,Kaapo Kakko,R,NYR,23,65,15,12,27
10,8478020,Michael Amadio,R,OTT,28,77,14,13,27
10,8475343,Nic Dowd,C,WSH,34,61,13,14,27
10,8480855,Jack McBain,C,UTA,24,64,12,15,27
10,8481704,Juuso Parssinen,C,NSH,23,63,12,15,27
10,8477989,Christian Dvorak,C,MTL,28,64,12,15,27
10,8477505,Alexander Wennberg,C,SJS,30,63,8,19,27
10,8475200,Dmitry Orlov,D,CAR,33,77,8,19,27
10,8480336,Sean Walker,D,CAR,30,75,5,22,27
10,8476923,Damon Severson,D,CBJ,30,79,5,22,27
10,8482245,Artem Zub,D,OTT,29,65,2,25,27
10,8479393,Noah Gregor,L,OTT,26,72,14,12,26
10,8482259,Bobby McMann,C,TOR,28,64,14,12,26
10,8476885,Jacob Trouba,D,NYR,30,75,12,14,26
10,8484203,Bradly Nadeau,L,CAR,19,61,11,15,26
10,8477446,Michael McCarron,R,NSH,29,53,11,15,26
10,8475171,Oliver Ekman-Larsson,D,TOR,33,73,7,19,26
10,8481546,Cam York,D,PHI,23,70,6,20,26
10,8482624,Daniil Miromanov,D,CGY,27,69,5,21,26
10,8482067,Connor Mackey,D,NYR,28,64,5,21,26
10,8477948,Travis Sanheim,D,PHI,28,69,4,22,26
10,8477506,Ryan Pulock,D,NYI,30,76,4,22,26
10,8475181,Nick Leddy,D,STL,33,71,4,22,26
10,8480873,Rasmus Sandin,D,WSH,24,66,3,23,26
10,8480807,Mattias Samuelsson,D,BUF,24,52,3,23,26
10,8482125,Alexander Holtz,R,VGK,22,66,16,9,25
10,8475760,Nick Bjugstad,C,UTA,32,73,14,11,25
10,8479996,Cody Glass,C,NSH,25,60,14,11,25
10,8476897,Oskar Sundqvist,C,STL,30,66,12,13,25
10,8477919,Frederick Gaudreau,C,MIN,31,64,10,15,25
10,8481522,Peyton Krebs,C,BUF,23,59,8,17,25
10,8471698,T.J. Oshie,R,WSH,38,73,6,19,25
10,8477507,Nikita Zadorov,D,BOS,29,69,5,20,25
10,8474151,Ryan McDonagh,D,TBL,35,77,2,23,25
10,8475690,Chris Tanev,D,TOR,35,59,1,24,25
10,8479390,Taylor Raddysh,R,WSH,26,63,13,11,24
10,8478046,Danton Heinen,L,VAN,29,63,11,13,24
10,8482105,Jake Sanderson,D,OTT,22,73,11,13,24
10,8474189,Lars Eller,C,PIT,35,65,11,13,24
10,8477353,Tyler Motte,C,DET,29,73,11,13,24
10,8481553,Bobby Brink,R,PHI,23,61,10,14,24
10,8481481,Blake Lizotte,C,PIT,27,62,8,16,24
10,8480074,Alexandre Texier,C,STL,25,53,8,16,24
10,8476463,Jonas Brodin,D,MIN,31,76,5,19,24
10,8476931,Jake McCabe,D,TOR,31,62,1,23,24
10,8480144,David Kampf,C,TOR,29,77,14,9,23
10,8482117,Lukas Reichel,L,CHI,22,56,13,10,23
10,8475193,Tomas Tatar,L,NJD,34,71,11,12,23
10,8481624,Ilya Mikheyev,R,CHI,30,53,11,12,23
10,8483457,Lane Hutson,D,MTL,20,65,10,13,23
10,8473453,Trevor Lewis,C,LAK,37,75,10,13,23
10,8480003,Jesper Boqvist,C,FLA,26,67,10,13,23
10,8477839,Conor Sheary,L,TBL,32,81,9,14,23
10,8482062,Cole Smith,L,NSH,29,58,9,14,23
10,8478013,Jake Walman,D,SJS,28,71,9,14,23
10,8475848,Brendan Gallagher,R,MTL,32,70,8,15,23
10,8483524,Shane Wright,C,SEA,20,72,8,15,23
10,8483482,Tristan Luneau,D,ANA,20,68,8,15,23
10,8478452,Caleb Jones,D,LAK,27,61,6,17,23
10,8479369,Andrew Peeke,D,BOS,26,65,6,17,23
10,8480878,Nils Lundkvist,D,DAL,24,69,5,18,23
10,8478507,John Marino,D,UTA,27,63,5,18,23
10,8478882,Vladislav Gavrikov,D,LAK,29,71,5,18,23
10,8479316,Luke Kunin,C,SJS,27,58,4,19,23
10,8481032,Paul Cotter,C,NJD,25,62,14,8,22
10,8477508,Curtis Lazar,C,NJD,29,59,10,12,22
10,8480980,Connor Dewar,C,TOR,25,66,9,13,22
10,8476856,Mathew Dumba,D,DAL,30,65,8,14,22
10,8476422,Mike Reilly,D,NYI,31,69,7,15,22
10,8477392,Hudson Fasching,R,NYI,29,63,7,15,22
10,8481521,Ronnie Attard,D,PHI,25,63,6,16,22
10,8476902,Esa Lindell,D,DAL,30,74,5,17,22
10,8483565,Nick Blankenburg,D,NSH,26,69,5,17,22
10,8479371,Dante Fabbro,D,NSH,26,69,5,17,22
10,8475790,Erik Gudbranson,D,CBJ,32,77,4,18,22
10,8480891,Michael Kesselring,D,UTA,24,59,3,19,22
10,8474673,TJ Brodie,D,CHI,34,60,1,21,22
10,8482077,Dylan Holloway,L,EDM,23,48,14,7,21
10,8480789,Oliver Wahlstrom,R,NYI,24,70,13,8,21
10,8475149,Marcus Johansson,L,MIN,34,59,12,9,21
10,8482679,Matt Coronato,R,CGY,22,61,12,9,21
10,8479619,Michael Carcone,L,UTA,28,70,12,9,21
10,8475842,Sam Carrick,C,NYR,32,56,11,10,21
10,8477478,William Carrier,L,CAR,30,59,10,11,21
10,8479520,Brandon Duhaime,R,WSH,27,57,10,11,21
10,8476918,Jimmy Vesey,L,NYR,31,71,9,12,21
10,8481517,Brett Leason,R,ANA,25,54,9,12,21
10,8482111,Justin Barron,D,MTL,23,67,8,13,21
10,8481656,Aliaksei Protas,C,WSH,23,57,8,13,21
10,8476891,Matthew Grzelcyk,D,PIT,30,77,4,17,21
10,8476457,Adam Larsson,D,SEA,32,65,3,18,21
10,8478416,Erik Cernak,D,TBL,27,78,3,18,21
10,8479639,Dylan Coghlan,D,WPG,26,58,2,19,21
10,8474574,Tyler Myers,D,VAN,34,72,2,19,21
10,8475791,Taylor Hall,L,CHI,33,59,10,10,20
10,8479368,Max Jones,L,BOS,26,66,10,10,20
10,8480762,Eric Robinson,L,CAR,29,55,9,11,20
10,8476889,Radek Faksa,C,STL,30,63,9,11,20
10,8478043,Sam Lafferty,C,BUF,29,62,9,11,20
10,8477450,Jason Dickinson,C,CHI,29,57,8,12,20
10,8481093,Rafael Harvey-Pinard,L,MTL,25,62,6,14,20
10,8479982,Conor Timmins,D,TOR,26,55,6,14,20
10,8479402,Jake Bean,D,CGY,26,64,5,15,20
10,8476467,Jamie Oleksiak,D,SEA,32,69,5,15,20
10,8477435,Ryan Graves,D,PIT,29,79,4,16,20
10,8481178,Egor Zamula,D,PHI,24,53,2,18,20
10,8480355,Mark Kastelic,C,BOS,25,71,12,7,19
10,8480021,Jack Studnicka,C,LAK,25,62,9,10,19
10,8482737,Zack Bolduc,C,STL,21,51,9,10,19
10,8482101,Danil Gushchin,L,SJS,22,58,8,11,19
10,8473563,Nicklas Backstrom,C,WSH,37,51,8,11,19
10,8479718,Alex Barré-Boulet,C,MTL,27,50,8,11,19
10,8476469,Joel Armia,R,MTL,31,69,7,12,19
10,8478421,A.J. Greer,L,FLA,28,52,7,12,19
10,8477987,Ryan Donato,C,CHI,28,66,6,13,19
10,8475231,Casey Cizikas,C,NYI,33,67,6,13,19
10,8475220,Marcus Foligno,L,MIN,33,58,6,13,19
10,8482809,Jackson Blake,R,CAR,21,52,6,13,19
10,8477369,Carson Soucy,D,VAN,30,65,6,13,19
10,8481441,Joe Snively,C,DET,28,64,5,14,19
10,8475188,Brayden McNabb,D,VGK,33,58,3,16,19
10,8482087,Kaiden Guhle,D,MTL,22,65,3,16,19
10,8480727,Zach Whitecloud,D,VGK,28,47,3,16,19
10,8476331,Dylan DeMelo,D,WPG,31,72,2,17,19
10,8479998,Mikey Anderson,D,LAK,25,61,2,17,19
10,8480001,Urho Vaakanainen,D,ANA,25,57,0,19,19
10,8475855,Jesper Fast,R,CAR,33,65,13,5,18
10,8481580,Connor McMichael,C,WSH,23,65,11,7,18
10,8478432,Christian Fischer,R,DET,27,75,11,7,18
10,8482157,Will Cuylle,L,NYR,22,57,8,10,18
10,8480848,Ty Dellandrea,C,SJS,24,47,8,10,18
10,8481019,David Gustafsson,C,WPG,24,51,6,12,18
10,8481537,Nikita Okhotiuk,D,CGY,24,56,6,12,18
10,8479344,Jesse Puljujarvi,R,PIT,26,47,5,13,18
10,8476873,Mark Jankowski,C,NSH,30,54,4,14,18
10,8480246,Nick Perbix,D,TBL,26,75,4,14,18
10,8480073,Erik Brannstrom,D,COL,25,54,3,15,18
10,8479324,Ryan Lindgren,D,NYR,26,62,2,16,18
10,8471709,Marc-Edouard Vlasic,D,SJS,37,61,2,16,18
10,8482073,Braden Schneider,D,NYR,23,56,0,18,18
10,8476934,Brock McGinn,L,ANA,30,52,11,6,17
10,8479315,Joey Anderson,R,CHI,26,48,9,8,17
10,8476329,Travis Boyd,C,MIN,31,56,8,9,17
10,8482148,Hendrix Lapierre,C,WSH,22,53,8,9,17
10,8481477,Nico Sturm,C,SJS,29,52,7,10,17
10,8477931,Tomas Nosek,L,FLA,32,58,7,10,17
10,8479291,Kevin Rooney,C,CGY,31,55,7,10,17
10,8477070,Liam O'Brien,C,UTA,30,56,6,11,17
10,8478911,Matt Roy,D,WSH,29,62,5,12,17
10,8477979,Nicolas Aube-Kubel,R,BUF,28,62,5,12,17
10,8482192,Isaak Phillips,D,CHI,23,55,5,12,17
10,8470600,Ryan Suter,D,STL,39,66,5,12,17
10,8476525,Colin Miller,D,WPG,32,65,4,13,17
10,8475324,Nick Jensen,D,OTT,34,68,4,13,17
10,8480035,Henri Jokiharju,D,BUF,25,63,2,15,17
10,8478859,Niko Mikkola,D,FLA,28,56,2,15,17
10,8478443,Brandon Carlo,D,BOS,28,57,2,15,17
10,8480049,Dylan Samberg,D,WPG,25,60,1,16,17
10,8482451,Mikael Pyyhtia,L,CBJ,23,44,1,16,17
10,8478569,Noel Acciari,C,PIT,33,54,11,5,16
10,8480205,Emil Bemstrom,C,PIT,25,60,8,8,16
10,8482803,Olen Zellweger,D,ANA,21,66,8,8,16
10,8480448,Parker Kelly,L,COL,25,69,7,9,16
10,8479671,Mathieu Olivier,R,CBJ,27,48,7,9,16
10,8482749,Joshua Roy,R,MTL,21,65,6,10,16
10,8483495,Simon Nemec,D,NJD,20,57,6,10,16
10,8482176,Wyatt Kaiser,D,CHI,22,54,5,11,16
10,8474034,Patrick Maroon,L,CHI,36,52,5,11,16
10,8475233,David Savard,D,MTL,34,70,2,14,16
10,8475279,Ben Chiarot,D,DET,33,68,2,14,16
10,8480172,Jan Rutta,D,SJS,34,66,2,14,16
10,8478840,Will Borgen,D,SEA,28,64,2,14,16
10,8482655,Janis Moser,D,TBL,24,79,1,15,16
10,8479976,Juuso Valimaki,D,UTA,26,62,1,15,16
10,8478136,Jake Middleton,D,MIN,28,71,1,15,16
10,8479336,Carl Grundstrom,R,SJS,27,54,11,4,15
10,8476878,Zemgus Girgensons,C,TBL,30,80,9,6,15
10,8481617,Vasily Podkolzin,R,VAN,23,49,9,6,15
10,8479066,Ryan Lomberg,L,CGY,30,58,7,8,15
10,8480289,Morgan Barron,C,WPG,26,56,6,9,15
10,8479980,Nicolas Hague,D,VGK,26,52,6,9,15
10,8478211,Dryden Hunt,L,CGY,29,51,6,9,15
10,8476312,Josh Manson,D,COL,33,61,5,10,15
10,8476624,Barclay Goodrow,C,SJS,31,59,5,10,15
10,8481600,Tobias Bjornfot,D,FLA,23,44,5,10,15
10,8483445,Cutter Gauthier,L,ANA,20,65,4,11,15
10,8480070,Ian Mitchell,D,BOS,25,51,4,11,15
10,8483499,Liam Ohgren,L,MIN,20,50,4,11,15
10,8476967,Brett Kulak,D,EDM,30,59,4,11,15
10,8482730,Brandt Clarke,D,LAK,21,44,4,11,15
10,8479983,Mario Ferraro,D,SJS,26,76,3,12,15
10,8479442,Troy Stecher,D,EDM,30,53,3,12,15
10,8473507,Jeff Petry,D,DET,37,74,1,14,15
10,8478851,Alexandre Carrier,D,NSH,28,63,1,14,15
10,8480950,Ilya Lyubushkin,D,DAL,30,65,1,14,15
10,8479414,Nathan Bastian,R,NJD,27,61,8,6,14
10,8482784,Zach Dean,C,STL,21,44,8,6,14
10,8481716,Dmitri Voronkov,L,CBJ,24,39,8,6,14
10,8480222,Sebastian Aho,D,PIT,28,72,7,7,14
10,8478970,Jalen Chatfield,D,CAR,28,69,6,8,14
10,8476960,Andreas Athanasiou,C,CHI,30,52,5,9,14
10,8480995,Pontus Holmberg,R,TOR,25,59,5,9,14
10,8478178,Darren Raddysh,D,TBL,28,67,5,9,14
10,8474568,Luke Schenn,D,NSH,35,53,5,9,14
10,8481028,Martin Pospisil,C,CGY,25,52,5,9,14
10,8480157,Calle Rosen,D,COL,30,49,4,10,14
10,8475208,Brian Dumoulin,D,ANA,33,56,3,11,14
10,8479543,Michael Pezzetta,L,MTL,26,65,3,11,14
10,8475718,Justin Holl,D,DET,32,56,3,11,14
10,8480990,Declan Chisholm,D,MIN,24,45,3,11,14
10,8480860,Kevin Bahl,D,CGY,24,51,2,12,14
10,8477573,Nathan Walker,L,STL,30,44,2,12,14
10,8484149,Gavin Brindley,C,CBJ,20,55,2,12,14
10,8481059,Scott Perunovich,D,STL,26,60,1,13,14
10,8481601,Simon Holmstrom,R,NYI,23,71,10,3,13
10,8480011,Klim Kostin,C,SJS,25,41,9,4,13
10,8482155,Alex Laferriere,R,LAK,23,69,9,4,13
10,8475225,Craig Smith,C,CHI,35,45,9,4,13
10,8482807,Ethan Del Mastro,D,CHI,21,48,8,5,13
10,8476442,Matt Nieto,L,PIT,32,45,7,6,13
10,8482744,James Malatesta,L,CBJ,21,45,6,7,13
10,8481527,Kaedan Korczak,D,VGK,23,43,5,8,13
10,8478831,Kevin Stenlund,C,UTA,28,55,5,8,13
10,8483491,Ivan Miroshnichenko,L,WSH,20,53,4,9,13
10,8482142,Jamie Drysdale,D,PHI,22,55,4,9,13
10,8479359,Beck Malenstyn,L,BUF,26,48,4,9,13
10,8477018,Ben Hutton,D,VGK,31,47,4,9,13
10,8482166,Shakir Mukhamadullin,D,SJS,22,46,4,9,13
10,8480252,Cole Guttman,C,CHI,25,41,4,9,13
10,8475762,Derek Forbort,D,VAN,32,48,4,9,13
10,8475462,Radko Gudas,D,ANA,34,64,3,10,13
10,8481751,Lukas Rousek,R,BUF,25,42,3,10,13
10,8482634,Alex Steeves,C,TOR,25,45,3,10,13
10,8476988,Matt Benning,D,SJS,30,65,2,11,13
10,8476874,Olli Maatta,D,DET,30,66,2,11,13
10,8475750,Jon Merrill,D,MIN,32,60,2,11,13
10,8475179,Dmitry Kulikov,D,FLA,34,51,1,12,13
10,8477845,Trevor van Riemsdyk,D,WSH,33,58,1,12,13
10,8476372,Nick Seeler,D,PHI,31,37,1,12,13
10,8477499,Rasmus Ristolainen,D,PHI,30,60,0,13,13
10,8481568,Alex Vlasic,D,CHI,23,52,0,13,13
10,8482666,Scott Morrow,D,CAR,22,42,8,4,12
10,8477482,Zachary Sanford,L,CHI,30,43,7,5,12
10,8480025,MacKenzie Entwistle,R,FLA,25,64,6,6,12
10,8482659,Josh Doan,R,UTA,22,43,6,6,12
10,8477015,Connor Brown,R,EDM,30,64,5,7,12
10,8481013,Jonatan Berggren,R,DET,24,63,4,8,12
10,8479026,Philippe Myers,D,TOR,27,51,4,8,12
10,8479348,Kale Clague,D,BUF,26,39,3,9,12
10,8483460,David Jiricek,D,CBJ,21,62,3,9,12
10,8477401,John Hayden,C,SEA,29,35,3,9,12
10,8478399,Jonas Siegenthaler,D,NJD,27,53,1,11,12
10,8480887,Jordan Harris,D,MTL,24,50,0,12,12
10,8476994,Vinnie Hinostroza,C,NSH,30,44,7,4,11
10,8478508,Yakov Trenin,C,MIN,27,56,6,5,11
10,8479328,Julien Gauthier,R,NYI,27,62,6,5,11
10,8476822,Luke Glendening,C,TBL,35,76,6,5,11
10,8478434,Keegan Kolesar,R,VGK,27,68,5,6,11
10,8477380,Jonny Brodzinski,C,NYR,31,51,5,6,11
10,8481550,Adam Beckman,L,NJD,23,35,5,6,11
10,8474567,Zach Bogosian,D,MIN,34,62,5,6,11
10,8479370,Tyson Jost,C,CAR,26,51,4,7,11
10,8483493,Frank Nazar,C,CHI,20,58,4,7,11
10,8481167,Brayden Pachal,D,CGY,25,44,4,7,11
10,8480796,Martin Fehervary,D,WSH,25,50,4,7,11
10,8474090,Brendan Smith,D,DAL,35,57,4,7,11
10,8480058,Pierre-Olivier Joseph,D,STL,25,50,0,11,11
10,8482070,Mitchell Chaffee,R,TBL,26,56,7,3,10
10,8479439,Jacob MacDonald,D,COL,31,44,6,4,10
10,8481754,Nikita Nesterenko,C,ANA,23,40,6,4,10
10,8475958,Michael Sgarbossa,C,WSH,32,35,6,4,10
10,8478451,Ethan Bear,D,WSH,27,52,5,5,10
10,8481641,Joel Kiviranta,L,COL,28,74,5,5,10
10,8476867,Brendan Gaunce,C,MIN,30,41,5,5,10
10,8476473,Connor Murphy,D,CHI,31,46,5,5,10
10,8481708,Zac Jones,D,NYR,24,49,3,7,10
10,8476858,Phillip Di Giuseppe,L,VAN,31,43,3,7,10
10,8479994,Jaret Anderson-Dolan,C,WPG,25,44,3,7,10
10,8481592,Jakob Pelletier,L,CGY,23,53,3,7,10
10,8479944,Zach Aston-Reese,C,VGK,30,42,2,8,10
10,8475455,Brenden Dillon,D,NJD,34,53,2,8,10
10,8477365,Connor Clifton,D,BUF,29,62,1,9,10
10,8477851,Jordan Oesterle,D,BOS,32,40,1,9,10
10,8478468,Jeremy Lauzon,D,NSH,27,45,1,9,10
10,8476429,Scott Mayfield,D,NYI,32,72,0,10,10
10,8474166,Alec Martinez,D,CHI,37,37,0,10,10
10,8482762,Simon Edvinsson,D,DET,21,48,7,2,9
10,8481532,Alex Turcotte,C,LAK,23,42,6,3,9
10,8471817,Ryan Reaves,R,TOR,37,51,4,5,9
10,8483466,Kevin Korchinski,D,CHI,20,55,4,5,9
10,8481147,Reese Johnson,C,MIN,26,31,4,5,9
10,8471677,Jack Johnson,D,CBJ,37,64,4,5,9
10,8476952,Dominic Toninato,C,WPG,30,38,4,5,9
10,8480192,Johnathan Kovacevic,D,NJD,27,54,3,6,9
10,8482496,Nils Aman,C,VAN,24,38,3,6,9
10,8483549,Lucas Condotta,L,MTL,27,28,3,6,9
10,8481599,Victor Soderstrom,D,UTA,23,48,2,7,9
10,8481567,Henry Thrun,D,SJS,23,47,2,7,9
10,8479378,Logan Stanley,D,WPG,26,46,2,7,9
10,8480845,Rasmus Kupari,C,WPG,24,41,2,7,9
10,8480007,Jonas Rondbjerg,R,VGK,25,41,2,7,9
10,8477527,Ross Johnston,L,ANA,30,35,1,8,9
10,8475235,Nicolas Deslauriers,L,PHI,33,49,6,2,8
10,8482859,Zack Ostapchuk,C,OTT,21,47,5,3,8
10,8480441,Trey Fix-Wolansky,R,CBJ,25,40,5,3,8
10,8479772,Zack MacEwen,R,OTT,28,50,5,3,8
10,8483397,Marc McLaughlin,C,BOS,25,33,5,3,8
10,8478585,Derek Ryan,C,EDM,38,63,4,4,8
10,8478424,Jansen Harkins,C,ANA,27,37,2,6,8
10,8483630,Pavol Regenda,L,ANA,25,26,2,6,8
10,8477034,Jaycob Megna,D,FLA,32,46,1,7,8
10,8481701,Santeri Hatakka,D,NJD,23,43,1,7,8
10,8482652,Walker Duehr,R,CGY,27,35,1,7,8
10,8479536,Axel Jonsson-Fjallby,L,WPG,26,31,5,2,7
10,8482153,Brendan Brisson,C,VGK,23,33,5,2,7
10,8479968,Vinni Lettieri,C,BOS,29,48,4,3,7
10,8479972,Mason Shaw,C,WPG,26,44,4,3,7
10,8478409,Anthony Richard,C,PHI,28,31,4,3,7
10,8483570,Ben Meyers,C,SEA,26,28,4,3,7
10,8482511,Mason Lohrei,D,BOS,23,39,3,4,7
10,8480292,Carson Meyer,R,ANA,27,38,3,4,7
10,8481161,Jake Christiansen,D,CBJ,25,54,3,4,7
10,8482858,Ryker Evans,D,SEA,23,23,3,4,7
10,8482751,Ryan Winterton,C,SEA,21,34,2,5,7
10,8479991,Jake Leschyshyn,C,NYR,25,26,2,5,7
10,8482177,Marat Khusnutdinov,C,MIN,22,39,2,5,7
10,8480870,Bo Groulx,C,NYR,24,32,2,5,7
10,8482747,Brennan Othmann,L,NYR,21,41,2,5,7
10,8483619,Filip Roos,D,OTT,25,36,2,5,7
10,8480879,Jacob Bernard-Docker,D,OTT,24,46,2,5,7
10,8474013,Ian Cole,D,UTA,35,48,1,6,7
10,8479372,Joshua Mahura,D,SEA,26,56,1,6,7
10,8482095,Tyler Kleven,D,OTT,22,41,1,6,7
10,8475177,Calvin de Haan,D,COL,33,47,0,7,7
10,8484254,Akito Hirose,D,VAN,25,33,0,7,7
10,8482861,Vincent Iorio,D,WSH,22,40,0,7,7
10,8481789,Tye Kartye,L,SEA,23,40,5,1,6
10,8478017,Mark Friedman,D,VAN,29,38,4,2,6
10,8479981,Jonah Gadjovich,L,FLA,26,53,3,3,6
10,8477938,Haydn Fleury,D,WPG,28,44,3,3,6
10,8477887,Patrick Brown,C,BOS,32,45,3,3,6
10,8481609,Vladislav Kolyachonok,D,UTA,23,33,3,3,6
10,8481518,Nolan Foote,L,NJD,24,42,2,4,6
10,8480834,Ty Emberson,D,SJS,24,33,2,4,6
10,8482145,Mavrik Bourque,C,DAL,22,54,2,4,6
10,8477962,Brendan Lemieux,L,CAR,28,37,2,4,6
10,8480844,Grigori Denisenko,L,VGK,24,35,2,4,6
10,8477073,Kurtis MacDermid,L,NJD,30,31,2,4,6
10,8476913,Devin Shore,C,MIN,30,36,2,4,6
10,8482165,Yan Kuznetsov,D,CGY,22,27,2,4,6
10,8482964,Arber Xhekaj,D,MTL,23,41,1,5,6
10,8478450,Parker Wotherspoon,D,BOS,27,24,0,6,6
10,8473446,Erik Johnson,D,PHI,36,44,0,6,6
10,8477335,Kyle Burroughs,D,LAK,29,44,0,6,6
10,8481237,Kyle MacLean,C,NYI,25,23,4,1,5
10,8483512,Matthew Savoie,C,EDM,20,26,3,2,5
10,8484287,Cole McWard,D,VAN,23,23,3,2,5
10,8480880,Jakub Lauko,C,MIN,24,37,2,3,5
10,8477320,Anton Blidh,L,NYR,29,23,2,3,5
10,8478021,William Lagesson,D,DET,28,28,2,3,5
10,8477473,Justin Bailey,R,SJS,29,26,2,3,5
10,8481122,Simon Benoit,D,TOR,26,43,2,3,5
10,8477462,Robert Hagg,D,VGK,29,29,1,4,5
10,8482733,Logan Mailloux,D,MTL,31,34,1,4,5
10,8478502,Dennis Gilbert,D,BUF,28,20,1,4,5
10,8482144,Jack Thompson,D,SJS,22,27,1,4,5
10,8481743,Marc Del Gaizo,D,NSH,25,18,0,5,5
10,8481679,Maxence Guenette,D,OTT,23,40,4,0,4
10,8480468,James Hamblin,L,EDM,25,24,4,0,4
10,8480245,Olle Lycksell,R,PHI,25,37,3,1,4
10,8482147,Jean-Luc Foudy,C,COL,22,28,3,1,4
10,8479985,Cale Fleury,D,SEA,26,28,3,1,4
10,8482765,Isak Rosen,R,BUF,21,24,2,2,4
10,8482141,Lukas Cormier,D,VGK,22,18,2,2,4
10,8484911,Collin Graf,R,SJS,22,37,2,2,4
10,8482470,Ilya Solovyov,D,CGY,24,21,2,2,4
10,8477244,Chad Ruhwedel,D,NYR,34,31,2,2,4
10,8480874,Adam Ginning,D,PHI,24,13,2,2,4
10,8481598,Philip Broberg,D,EDM,23,39,1,3,4
10,8481556,John Beecher,C,BOS,23,28,1,3,4
10,8479320,Maxime Lajoie,D,SEA,27,23,1,3,4
10,8480306,Grant Hutton,D,NYI,29,14,1,3,4
10,8476441,Joel Edmundson,D,LAK,31,40,0,4,4
10,8474612,Travis Hamonic,D,OTT,34,48,0,4,4
10,8480196,Jacob Bryson,D,BUF,27,42,0,4,4
10,8479587,Rhett Gardner,C,PHI,28,24,0,4,4
10,8483763,Maksymilian Szuber,D,UTA,22,31,0,4,4
10,8479379,Givani Smith,R,SJS,26,24,3,0,3
10,8481543,Nikita Alexandrov,C,STL,24,28,2,1,3
10,8478454,Noah Juulsen,D,VAN,27,34,2,1,3
10,8481043,Cole Koepke,L,BOS,26,19,2,1,3
10,8480032,Shane Bowers,C,NJD,25,11,2,1,3
10,8483012,Logan Morrison,C,SEA,22,32,1,2,3
10,8478146,Matthew Highmore,C,OTT,28,36,1,2,3
10,8474062,Riley Nash,C,NYR,35,16,1,2,3
10,8481719,Maxwell Crozier,D,TBL,24,15,1,2,3
10,8479367,William Lockwood,R,FLA,26,21,1,2,3
10,8479362,Riley Tufte,L,BOS,26,13,1,2,3
10,8480267,Sammy Walker,C,MIN,25,15,1,2,3
10,8477384,Joshua Brown,D,EDM,30,48,0,3,3
10,8484258,Sam Malinski,D,COL,26,19,0,3,3
10,8477971,Andreas Englund,D,LAK,28,29,0,3,3
10,8481593,Jayden Struble,D,MTL,23,26,0,3,3
10,8481006,Tyler Tucker,D,STL,24,13,0,3,3
10,8482172,Landon Slaggert,L,CHI,22,28,0,3,3
10,8479638,Justin Brazeau,R,BOS,26,30,2,0,2
10,8478446,Glenn Gawdin,C,LAK,27,8,2,0,2
10,8481699,Aku Raty,R,UTA,23,16,2,0,2
10,8481462,Mason Morelli,L,VGK,28,19,2,0,2
10,8478854,Ryan Shea,D,PIT,27,8,2,0,2
10,8482094,Daemon Hunt,D,MIN,22,14,2,0,2
10,8481422,Jake Lucchini,C,NSH,29,18,1,1,2
10,8478477,Mitchell Stephens,C,SEA,27,21,1,1,2
10,8479986,Kole Lind,R,DAL,26,41,1,1,2
10,8483395,Arshdeep Bains,L,VAN,23,9,1,1,2
10,8480890,Jan Jenik,C,OTT,24,30,1,1,2
10,8478011,Louie Belpedio,D,PHI,28,22,1,1,2
10,8482201,Gage Goncalves,C,TBL,23,26,1,1,2
10,8482162,Roby Jarventie,L,EDM,22,12,1,1,2
10,8483432,Luca Del Bel Belluz,C,CBJ,31,8,1,1,2
10,8479576,Vincent Desharnais,D,VAN,28,37,0,2,2
10,8481056,Spencer Stastney,D,NSH,24,29,0,2,2
10,8478874,Adam Gaudette,R,OTT,28,35,0,2,2
10,8477810,Joel Hanley,D,CGY,33,17,0,2,2
10,8484304,Uvis Balinskis,D,FLA,28,10,0,2,2
10,8483489,Fraser Minten,C,TOR,31,13,0,2,2
10,8481806,Louis Crevier,D,CHI,23,17,0,2,2
10,8482118,Sam Colangelo,R,ANA,23,19,0,2,2
10,8475413,Justin Dowling,C,NJD,34,15,0,2,2
10,8479249,Andrew Poturalski,C,SJS,30,34,1,0,1
10,8482713,Mackie Samoskevich,R,FLA,22,29,1,0,1
10,8481605,Jackson LaCombe,D,ANA,23,30,1,0,1
10,8481065,Angus Crookshank,L,OTT,25,12,1,0,1
10,8482102,Vasily Ponomarev,C,PIT,22,23,1,0,1
10,8478051,Max Willman,C,NJD,29,15,1,0,1
10,8482061,Brandon Biro,L,SEA,26,9,1,0,1
10,8482250,Callahan Burke,C,VGK,27,17,1,0,1
10,8481024,Linus Karlsson,C,VAN,25,12,1,0,1
10,8481585,Egor Afanasyev,L,SJS,23,18,1,0,1
10,8482929,Emil Lilleberg,D,TBL,23,17,1,0,1
10,8482197,Adam Raska,R,MIN,23,6,1,0,1
10,8481534,Raphael Lavoie,C,EDM,24,3,1,0,1
10,8483597,Milos Kelemen,L,UTA,25,8,1,0,1
10,8480075,Cameron Crotty,D,MIN,25,8,1,0,1
10,8482460,Matt Rempe,C,NYR,22,13,1,0,1
10,8483920,Pierrick Dube,R,WSH,23,3,1,0,1
10,8478881,Brett Seney,L,CHI,28,9,0,1,1
10,8481541,Samuel Bolduc,D,NYI,24,22,0,1,1
10,8480084,Nick DeSimone,D,NJD,30,18,0,1,1
10,8482476,Emil Heineman,L,MTL,23,7,0,1,1
10,8481030,Jack St. Ivany,D,PIT,25,8,0,1,1
10,8482088,Justin Sourdif,R,FLA,22,21,0,1,1
10,8480851,Akil Thomas,C,LAK,24,13,0,1,1
10,8481655,Cole Schwindt,R,CGY,23,8,0,1,1
10,8481206,John Ludvig,D,PIT,24,12,0,1,1
10,8475780,Chris Wagner,R,COL,33,10,0,1,1
10,8483567,Georgii Merkulov,C,BOS,24,10,0,1,1
10,8483398,Declan Carlile,D,TBL,31,6,0,1,1
10,8480823,Alexander Alexeyev,D,WSH,25,13,0,0,0
10,8483407,Brandon Scanlin,D,NYR,25,7,0,0,0
10,8477467,Gustav Olofsson,D,SEA,30,16,0,0,0
10,8481564,Ryan Johnson,D,BUF,23,8,0,0,0
10,8484325,Waltteri Merela,C,TBL,26,16,0,0,0
10,8479330,Brandon Gignac,C,MTL,27,8,0,0,0
10,8481578,Graeme Clarke,R,MIN,23,11,0,0,0
10,8475795,Dylan McIlrath,D,WSH,32,10,0,0,0
10,8479419,Brett Murray,L,BUF,26,15,0,0,0
10,8477149,Scott Sabourin,R,SJS,32,12,0,0,0
10,8479522,Hardy Haman Aktell,D,WSH,26,4,0,0,0
10,8482516,Matthew Kessel,D,STL,24,20,0,0,0
10,8484326,Patrik Koch,D,UTA,28,2,0,0,0
10,8477541,Dakota Mermis,D,TOR,30,9,0,0,0
10,8483471,Brad Lambert,C,WPG,31,5,0,0,0
10,8483609,Adam Klapka,R,CGY,24,6,0,0,0
10,8478147,Bokondji Imama,L,PIT,28,4,0,0,0
10,8484259,Ondrej Pavel,C,COL,31,1,0,0,0
10,8481726,Adam Edstrom,C,NYR,24,4,0,0,0
10,8477993,Justin Kirkland,C,CGY,28,6,0,0,0
10,8476323,Max McCormick,L,SEA,32,3,0,0,0
10,8483546,Marshall Rifai,D,TOR,26,3,0,0,0
10,8475755,Alexander Petrovic,D,DAL,32,9,0,0,0
10,8482787,Nikita Chibrikov,R,WPG,31,6,0,0,0
10,8482126,Emil Andrae,D,PHI,31,6,0,0,0
10,8484255,Jason Polin,R,COL,25,5,0,0,0
10,8479421,Jacob Moverare,D,LAK,26,2,0,0,0
10,8483531,Brian Halonen,L,NJD,25,2,0,0,0
10,8470794,Joe Pavelski,C,,40,0,0,0,0
10,8479321,Lucas Johansen,D,,27,0,0,0,0
10,8477950,Tony DeAngelo,D,,29,0,0,0,0
10,8471218,Blake Wheeler,R,,38,0,0,0,0
10,8475197,Tyson Barrie,D,,33,0,0,0,0
10,8474157,Max Pacioretty,L,,36,0,0,0,0
10,8475744,Evgeny Kuznetsov,C,,32,0,0,0,0
10,8474037,James van Riemsdyk,L,,35,0,0,0,0
10,8476907,Mackenzie MacEachern,L,,30,0,0,0,0
10,8480216,Jacob Peterson,C,,25,0,0,0,0
10,8474602,Justin Schultz,D,,34,0,0,0,0
10,8482222,Alexander Barabanov,L,,30,0,0,0,0
10,8474031,Kevin Shattenkirk,D,,35,0,0,0,0
10,8477330,Dominik Kubalik,L,,29,0,0,0,0
10,8480884,Calen Addison,D,,24,0,0,0,0
10,8475906,John Klingberg,D,,32,0,0,0,0
10,8480008,Adam Ruzicka,C,,25,0,0,0,0
10,8476884,Derrick Pouliot,D,,30,0,0,0,0
10,8476919,Chris Tierney,C,,30,0,0,0,0
10,8479415,Michael McLeod,C,,26,0,0,0,0
10,8474870,Tyler Johnson,C,,34,0,0,0,0
10,8470604,Jeff Carter,C,,39,0,0,0,0
10,8478104,Sammy Blais,L,,28,0,0,0,0
10,8474884,Mike Hoffman,C,,35,0,0,0,0
10,8481591,Sam Poulin,R,,23,0,0,0,0
10,8471274,Alex Goligoski,D,,39,0,0,0,0
10,8476871,Tanner Pearson,L,,32,0,0,0,0
10,8476393,Nick Cousins,C,,31,0,0,0,0
10,8479977,Kailer Yamamoto,R,,26,0,0,0,0
10,8479346,Dillon Dube,C,,26,0,0,0,0
10,8480184,Gustav Lindstrom,D,,26,0,0,0,0
10,8479376,Victor Mete,D,,26,0,0,0,0
10,8473449,Kyle Okposo,R,,36,0,0,0,0
10,8481058,Jesse Ylonen,R,,25,0,0,0,0
10,8475752,Tyler Pitlick,C,,33,0,0,0,0
10,8481239,Samuel Fagemo,L,,24,0,0,0,0
10,8480821,Filip Zadina,R,,25,0,0,0,0
10,8470966,Mark Giordano,D,,41,0,0,0,0
10,8478495,Denis Gurianov,R,,27,0,0,0,0
10,8477464,Nic Petan,C,,29,0,0,0,0
10,8478099,Kevin Labanc,R,,29,0,0,0,0
10,8482241,Radim Zohorna,L,,28,0,0,0,0
10,8474040,Sam Gagner,C,,35,0,0,0,0
10,8479514,Rem Pitlick,C,,27,0,0,0,0
10,8478430,Oliver Kylington,D,,27,0,0,0,0
10,8479533,Joona Koppanen,L,,26,0,0,0,0
10,8479984,Cal Foote,D,,26,0,0,0,0
10,8477126,Jayson Megna,C,,34,0,0,0,0
10,8475164,Jakob Silfverberg,R,,34,0,0,0,0
10,8474009,Nick Bonino,C,,36,0,0,0,0
10,8479458,Nikita Zaitsev,D,,33,0,0,0,0
10,8477944,Jakub Vrana,L,,28,0,0,0,0
10,8471699,Andrew Cogliano,C,,37,0,0,0,0
10,8478067,Oskar Lindblom,L,,28,0,0,0,0
10,8471686,Marc Staal,D,,37,0,0,0,0
10,8470610,Zach Parise,L,,40,0,0,0,0
10,8478904,Steven Lorentz,C,,28,0,0,0,0
10,8473473,Milan Lucic,L,,36,0,0,0,0
10,8480031,Maxime Comtois,L,,25,0,0,0,0
10,8478512,Austin Czarnik,C,,32,0,0,0,0
10,8473504,Cal Clutterbuck,R,,37,0,0,0,0
10,8477454,Adam Erne,L,,29,0,0,0,0
10,8479383,Boris Katchouk,L,,26,0,0,0,0
10,8475825,Jani Hakanpää,D,,32,0,0,0,0
10,8477846,Ryan Carpenter,C,,33,0,0,0,0
10,8477930,Pierre-Edouard Bellemare,L,,39,0,0,0,0
10,8478400,Colin White,C,,27,0,0,0,0
10,8480226,Marián Studenic,R,,26,0,0,0,0
10,8480853,Liam Foudy,C,,24,0,0,0,0
10,8475797,Jarred Tinordi,D,,32,0,0,0,0
10,8479423,Alex Nylander,L,,26,0,0,0,0
10,8474618,Marco Scandella,D,,34,0,0,0,0
10,8478028,Fredrik Olofsson,L,,28,0,0,0,0
10,8474709,Matt Martin,L,,35,0,0,0,0
10,8481070,Hugh McGing,L,,26,0,0,0,0
10,8479546,Oskar Steen,C,,26,0,0,0,0
10,8474145,Robert Bortuzzo,D,,35,0,0,0,0
10,8476915,Jujhar Khaira,L,,30,0,0,0,0
10,8480274,Philip Kemp,D,EDM,25,1,0,0,0
10,8484321,Nikolas Matinpalo,D,OTT,26,0,0,0,0
10,8475278,Byron Froese,C,,33,0,0,0,0
10,8481812,Nikolai Knyzhov,D,,27,0,0,0,0
10,8478408,Travis Dermott,D,,28,0,0,0,0
10,8481077,John Leonard,L,,26,0,0,0,0
10,8479547,Matthew Phillips,R,,26,0,0,0,0
10,8480836,Jonathan Gruden,C,,24,0,0,0,0
10,8481690,Tyler Angle,C,,24,0,0,0,0
10,8475766,Austin Watson,L,,32,0,0,0,0
10,8481016,Ruslan Iskhakov,C,,24,0,0,0,0
10,8478078,Rourke Chartier,C,,28,0,0,0,0
10,8483401,Marc Johnstone,R,PIT,28,1,0,0,0
10,8480776,Sheldon Rempal,R,,29,0,0,0,0
10,8478956,Samuel Laberge,L,NJD,27,1,0,0,0
10,8483045,Cameron Butler,R,CBJ,31,2,0,0,0
10,8484314,Jiri Smejkal,L,,28,0,0,0,0
11,8477492,Nathan MacKinnon,C,COL,29,81,61,89,150
11,8479318,Auston Matthews,C,TOR,27,79,71,56,127
11,8477956,David Pastrnak,R,BOS,28,80,63,63,126
11,8478402,Connor McDavid,C,EDM,27,76,39,83,122
11,8478420,Mikko Rantanen,R,COL,28,81,49,70,119
11,8478483,Mitch Marner,R,TOR,27,80,24,93,117
11,8476453,Nikita Kucherov,R,TBL,31,82,38,76,114
11,8477934,Leon Draisaitl,C,EDM,29,77,50,60,110
11,8480027,Jason Robertson,L,DAL,25,82,43,65,108
11,8481559,Jack Hughes,C,NJD,23,77,49,58,107
11,8471675,Sidney Crosby,C,PIT,37,72,43,61,104
11,8479314,Matthew Tkachuk,L,FLA,27,79,29,74,103
11,8479343,Clayton Keller,R,UTA,26,79,47,55,102
11,8480069,Cale Makar,D,COL,26,72,35,67,102
11,8478550,Artemi Panarin,L,NYR,33,77,34,67,101
11,8478398,Kyle Connor,L,WPG,28,72,52,45,97
11,8475166,John Tavares,C,TOR,34,82,45,52,97
11,8477493,Aleksander Barkov,C,FLA,29,78,33,62,95
11,8477942,Kevin Fiala,L,LAK,28,82,29,66,95
11,8482116,Tim Stützle,C,OTT,22,81,29,65,94
11,8478427,Sebastian Aho,C,CAR,27,77,41,52,93
11,8474564,Steven Stamkos,C,NSH,34,75,38,55,93
11,8480801,Brady Tkachuk,L,OTT,25,80,29,63,92
11,8477939,William Nylander,R,TOR,28,80,41,50,91
11,8479407,Jesper Bratt,L,NJD,26,77,22,69,91
11,8478010,Brayden Point,C,TBL,28,82,47,43,90
11,8478403,Jack Eichel,C,VGK,28,76,36,54,90
11,8475172,Nazem Kadri,C,CGY,34,75,34,56,90
11,8478864,Kirill Kaprizov,L,MIN,27,70,43,46,89
11,8477404,Jake Guentzel,C,TBL,30,82,40,49,89
11,8480208,Drake Batherson,R,OTT,26,78,35,53,88
11,8476468,J.T. Miller,C,VAN,31,73,29,59,88
11,8480002,Nico Hischier,C,NJD,25,73,32,54,86
11,8480012,Elias Pettersson,C,VAN,26,78,34,51,85
11,8476389,Vincent Trocheck,C,NYR,31,80,34,51,85
11,8477946,Dylan Larkin,C,DET,28,82,31,54,85
11,8477951,Nick Schmaltz,C,UTA,28,80,32,52,84
11,8477504,Josh Morrissey,D,WPG,29,82,20,64,84
11,8475167,Victor Hedman,D,TBL,34,79,14,69,83
11,8476887,Filip Forsberg,L,NSH,30,74,44,38,82
11,8476454,Ryan Nugent-Hopkins,C,EDM,31,77,26,56,82
11,8474600,Roman Josi,D,NSH,34,74,17,65,82
11,8475168,Matt Duchene,C,DAL,33,81,36,45,81
11,8478445,Mathew Barzal,C,NYI,27,80,21,60,81
11,8478401,Pavel Zacha,C,BOS,27,78,36,44,80
11,8482078,Lucas Raymond,L,DET,22,80,32,48,80
11,8476456,Jonathan Huberdeau,C,CGY,31,79,17,63,80
11,8477409,Carter Verhaeghe,C,FLA,29,78,46,33,79
11,8477933,Sam Reinhart,C,FLA,29,81,38,41,79
11,8475810,Bryan Rust,R,PIT,32,72,32,47,79
11,8473419,Brad Marchand,L,BOS,36,80,30,49,79
11,8477500,Bo Horvat,C,NYI,29,80,40,37,77
11,8478449,Roope Hintz,C,DAL,28,82,34,43,77
11,8476459,Mika Zibanejad,C,NYR,31,81,33,44,77
11,8480023,Robert Thomas,C,STL,25,73,24,53,77
11,8478414,Timo Meier,R,NJD,28,73,39,37,76
11,8477501,Valeri Nichushkin,R,COL,29,80,38,38,76
11,8478444,Brock Boeser,R,VAN,27,78,35,41,76
11,8476460,Mark Scheifele,C,WPG,31,75,30,46,76
11,8475692,Mats Zuccarello,R,MIN,37,67,22,54,76
11,8478439,Travis Konecny,R,PHI,27,76,24,51,75
11,8479337,Alex DeBrincat,R,DET,27,80,30,44,74
11,8478873,Troy Terry,R,ANA,27,73,30,44,74
11,8480036,Miro Heiskanen,D,DAL,25,79,12,62,74
11,8479323,Adam Fox,D,NYR,26,73,10,61,71
11,8481068,Yegor Sharangovich,C,CGY,26,80,37,33,70
11,8479385,Jordan Kyrou,C,STL,26,74,34,36,70
11,8479420,Tage Thompson,C,BUF,27,74,34,36,70
11,8482740,Wyatt Johnston,C,DAL,21,79,33,37,70
11,8475786,Zach Hyman,L,EDM,32,77,33,36,69
11,8477496,Elias Lindholm,C,BOS,30,79,20,49,69
11,8478440,Dylan Strome,C,WSH,27,70,18,51,69
11,8481557,Matt Boldy,L,MIN,23,71,30,38,68
11,8477402,Pavel Buchnevich,L,STL,29,67,29,39,68
11,8480865,Noah Dobson,D,NYI,24,78,8,60,68
11,8478493,Joel Eriksson Ek,C,MIN,27,72,25,42,67
11,8471215,Evgeni Malkin,C,PIT,38,79,22,45,67
11,8479542,Brandon Hagel,L,TBL,26,82,27,39,66
11,8476346,Johnny Gaudreau,L,CBJ,31,73,21,45,66
11,8480800,Quinn Hughes,D,VAN,25,74,10,56,66
11,8481540,Cole Caufield,R,MTL,23,77,33,32,65
11,8480015,Owen Tippett,R,PHI,25,75,29,36,65
11,8476539,Jonathan Marchessault,R,NSH,34,74,28,37,65
11,8480039,Martin Necas,C,CAR,25,67,26,39,65
11,8484144,Connor Bedard,C,CHI,19,65,24,41,65
11,8476432,Boone Jenner,C,CBJ,31,73,41,23,64
11,8477451,Ryan Hartman,R,MIN,30,71,26,38,64
11,8471214,Alex Ovechkin,L,WSH,39,65,31,32,63
11,8477935,Sam Bennett,C,FLA,28,77,31,32,63
11,8475754,Brock Nelson,C,NYI,33,82,30,33,63
11,8477940,Nikolaj Ehlers,L,WPG,28,69,18,45,63
11,8480803,Evan Bouchard,D,EDM,25,71,15,48,63
11,8476853,Morgan Rielly,D,TOR,30,73,12,51,63
11,8478047,Michael Bunting,L,PIT,29,75,30,32,62
11,8476399,Blake Coleman,C,CGY,33,75,27,35,62
11,8479400,Pierre-Luc Dubois,L,WSH,26,70,22,40,62
11,8480830,Andrei Svechnikov,R,CAR,24,66,25,36,61
11,8480018,Nick Suzuki,C,MTL,25,77,23,38,61
11,8479999,Casey Mittelstadt,C,COL,26,79,23,38,61
11,8475745,Charlie Coyle,C,BOS,32,78,21,40,61
11,8478460,Zach Werenski,D,CBJ,27,81,13,48,61
11,8482699,Dylan Guenther,R,UTA,21,77,29,31,60
11,8474102,David Perron,L,OTT,36,81,24,36,60
11,8478498,Jake DeBrusk,L,VAN,28,72,27,32,59
11,8475913,Mark Stone,R,VGK,32,74,26,33,59
11,8475158,Ryan O'Reilly,C,NSH,33,75,22,37,59
11,8476881,Tomas Hertl,C,VGK,31,82,22,37,59
11,8475184,Chris Kreider,L,NYR,33,74,34,24,58
11,8478975,Mason Marchment,L,DAL,29,82,28,30,58
11,8475765,Vladimir Tarasenko,R,DET,33,79,26,32,58
11,8474141,Patrick Kane,R,DET,36,81,26,32,58
11,8473994,Jamie Benn,L,DAL,35,78,25,33,58
11,8471685,Anze Kopitar,C,LAK,37,80,19,39,58
11,8479675,Trevor Moore,L,LAK,29,80,31,26,57
11,8474578,Erik Karlsson,D,PIT,34,76,15,42,57
11,8473986,Alex Killorn,L,ANA,35,78,25,31,56
11,8477416,Oliver Bjorkstrand,R,SEA,29,71,23,33,56
11,8482159,Tyson Foerster,R,PHI,22,75,21,35,56
11,8482665,Matty Beniers,C,SEA,22,76,16,40,56
11,8478397,Rasmus Andersson,D,CGY,28,73,13,43,56
11,8478469,Thomas Chabot,D,OTT,27,74,12,44,56
11,8475726,Tyler Toffoli,C,SJS,32,70,32,23,55
11,8478474,Lawson Crouse,L,UTA,27,77,27,28,55
11,8477497,Sean Monahan,C,CBJ,30,72,26,29,55
11,8477960,Adrian Kempe,R,LAK,28,80,24,31,55
11,8482124,Quinton Byfield,R,LAK,22,78,17,38,55
11,8477986,Brandon Montour,D,SEA,30,73,15,40,55
11,8475798,Mikael Granlund,C,SJS,32,66,13,42,55
11,8479410,Mikhail Sergachev,D,UTA,26,68,8,47,55
11,8475151,Kyle Palmieri,C,NYI,33,78,24,30,54
11,8478438,Tommy Novak,C,NSH,27,71,20,34,54
11,8474679,Gustav Nyquist,C,NSH,35,74,14,40,54
11,8476958,Jaccob Slavin,D,CAR,30,78,10,44,54
11,8480064,Josh Norris,C,OTT,25,75,31,22,53
11,8477476,Artturi Lehkonen,L,COL,29,80,29,24,53
11,8482109,Alexis Lafrenière,L,NYR,23,75,25,28,53
11,8475784,Jeff Skinner,C,EDM,32,76,19,34,53
11,8481711,Matias Maccelli,L,UTA,24,72,17,36,53
11,8475170,Brayden Schenn,C,STL,33,75,16,37,53
11,8478542,Evan Rodrigues,C,FLA,31,76,14,39,53
11,8476438,Brandon Saad,L,STL,32,70,28,24,52
11,8482745,Mason McTavish,C,ANA,21,72,25,27,52
11,8477503,Max Domi,C,TOR,29,76,19,33,52
11,8473512,Claude Giroux,R,OTT,36,75,18,34,52
11,8477346,MacKenzie Weegar,D,CGY,30,69,13,39,52
11,8481596,Shane Pinto,C,OTT,24,75,22,29,51
11,8475191,Reilly Smith,R,NYR,33,74,21,30,51
11,8477021,Alex Kerfoot,C,UTA,30,71,14,37,51
11,8479325,Charlie McAvoy,D,BOS,27,77,11,40,51
11,8476483,Rickard Rakell,R,PIT,31,72,25,25,50
11,8475794,Tyler Seguin,C,DAL,32,81,20,30,50
11,8470613,Brent Burns,D,CAR,39,80,9,41,50
11,8476448,William Karlsson,C,VGK,31,76,24,25,49
11,8478466,Daniel Sprong,R,VAN,27,72,23,26,49
11,8477511,Anthony Mantha,R,CGY,30,74,19,30,49
11,8481528,Dylan Cozens,C,BUF,23,71,18,31,49
11,8482720,Matthew Knies,L,TOR,22,75,18,31,49
11,8479365,Trent Frederic,C,BOS,26,82,18,31,49
11,8477479,Tyler Bertuzzi,L,CHI,29,54,16,33,49
11,8478366,Frank Vatrano,R,ANA,30,75,26,22,48
11,8483808,Andrei Kuzmenko,L,CGY,28,75,23,25,48
11,8476826,Yanni Gourde,C,SEA,33,66,20,28,48
11,8478856,Conor Garland,R,VAN,28,73,15,33,48
11,8477444,Andre Burakovsky,L,SEA,29,70,14,34,48
11,8477494,Jonathan Drouin,L,COL,29,82,13,35,48
11,8471724,Kris Letang,D,PIT,37,78,12,36,48
11,8482684,Luke Hughes,D,NJD,21,70,5,43,48
11,8482093,Seth Jarvis,C,CAR,22,71,23,24,47
11,8476882,Teuvo Teravainen,C,CHI,30,62,22,25,47
11,8482113,Anton Lundell,C,FLA,23,72,21,26,47
11,8480188,Fabian Zetterlund,L,SJS,25,62,16,31,47
11,8474586,Jordan Eberle,R,SEA,34,78,14,33,47
11,8477949,Alex Tuch,R,BUF,28,73,11,36,47
11,8475218,Mattias Ekholm,D,EDM,34,77,10,37,47
11,8475764,Cam Fowler,D,ANA,33,71,5,42,47
11,8476880,Tom Wilson,R,WSH,30,75,26,20,46
11,8478042,Viktor Arvidsson,L,EDM,31,75,21,25,46
11,8477407,Anthony Duclair,L,NYI,29,76,18,28,46
11,8482092,Ridly Greig,C,OTT,22,76,18,28,46
11,8481533,Trevor Zegras,C,ANA,23,70,16,30,46
11,8479345,Jakob Chychrun,D,WSH,26,73,15,31,46
11,8478038,Devon Toews,D,COL,30,65,13,33,46
11,8478458,John (Jack) Roslovic,C,CAR,27,68,13,33,46
11,8476905,Chandler Stephenson,C,SEA,30,65,12,34,46
11,8476875,Mike Matheson,D,MTL,30,74,9,37,46
11,8475169,Evander Kane,L,EDM,33,76,29,16,45
11,8477955,Jared McCann,L,SEA,28,71,28,17,45
11,8481618,Alex Newhook,C,MTL,23,72,20,25,45
11,8483515,Juraj Slafkovsky,L,MTL,20,78,18,27,45
11,8482667,William Eklund,L,SJS,22,68,17,28,45
11,8476854,Hampus Lindholm,D,BOS,30,75,11,34,45
11,8476906,Shayne Gostisbehere,D,CAR,31,74,10,35,45
11,8477495,Seth Jones,D,CHI,30,69,10,35,45
11,8480434,Sean Durzi,D,UTA,26,75,10,35,45
11,8477447,Shea Theodore,D,VGK,29,59,4,41,45
11,8482702,Logan Stankoven,C,DAL,21,80,23,21,44
11,8474641,Adam Henrique,C,EDM,34,78,21,23,44
11,8482705,Cole Sillinger,C,CBJ,21,72,21,23,44
11,8478519,Anthony Cirelli,C,TBL,27,82,20,24,44
11,8478233,Andrew Mangiapane,L,WSH,28,68,20,24,44
11,8481577,Philip Tomasino,C,NSH,23,64,15,29,44
11,8480028,Morgan Frost,C,PHI,25,73,15,29,44
11,8478407,Vince Dunn,D,SEA,28,74,13,31,44
11,8484166,Adam Fantilli,C,CBJ,20,68,13,31,44
11,8477429,Andrew Copp,C,DET,30,80,13,31,44
11,8478472,Mathieu Joseph,R,STL,27,67,10,34,44
11,8480014,Gabriel Vilardi,C,WPG,25,66,27,16,43
11,8481624,Ilya Mikheyev,R,CHI,30,69,23,20,43
11,8483490,Pavel Mintyukov,D,ANA,21,77,6,37,43
11,8477964,Ivan Barbashev,C,VGK,29,74,20,22,42
11,8479987,Morgan Geekie,C,BOS,26,75,18,24,42
11,8476419,Jean-Gabriel Pageau,C,NYI,32,75,18,24,42
11,8480797,Joel Farabee,L,PHI,24,78,15,27,42
11,8479339,Patrik Laine,L,CBJ,26,56,14,28,42
11,8476479,Phillip Danault,C,LAK,31,80,13,29,42
11,8478020,Michael Amadio,R,OTT,28,74,26,15,41
11,8482110,Dawson Mercer,C,NJD,23,74,21,20,41
11,8475793,Ryan Johansen,C,PHI,32,71,19,22,41
11,8484153,Leo Carlsson,C,ANA,20,70,18,23,41
11,8477426,Nicholas Paul,L,TBL,29,82,17,24,41
11,8475287,Erik Haula,L,NJD,33,75,17,24,41
11,8476458,Ryan Strome,C,ANA,31,68,16,25,41
11,8475768,Jaden Schwartz,C,SEA,32,66,14,27,41
11,8474150,Mikael Backlund,C,CGY,35,77,13,28,41
11,8481542,Moritz Seider,D,DET,23,74,3,38,41
11,8476461,Sean Couturier,C,PHI,32,68,18,22,40
11,8482149,Cole Perfetti,C,WPG,22,62,17,23,40
11,8476923,Damon Severson,D,CBJ,30,78,10,30,40
11,8474590,John Carlson,D,WSH,34,64,5,35,40
11,8479390,Taylor Raddysh,R,WSH,26,72,16,23,39
11,8480849,Barrett Hayton,C,UTA,24,73,14,25,39
11,8474149,Evgenii Dadonov,R,DAL,35,80,11,28,39
11,8475314,Anders Lee,L,NYI,34,77,17,21,38
11,8482097,Jack Quinn,R,BUF,23,68,14,24,38
11,8482133,Thomas Bordeleau,C,SJS,22,57,13,25,38
11,8475753,Justin Faulk,D,STL,32,73,12,26,38
11,8478133,Jake Evans,C,MTL,28,69,10,28,38
11,8480145,Neal Pionk,D,WPG,29,69,9,29,38
11,8483431,Logan Cooley,C,UTA,20,73,19,18,37
11,8481604,Pavel Dorofeyev,L,VGK,24,75,17,20,37
11,8479525,Ross Colton,C,COL,28,80,17,20,37
11,8479992,Michael Rasmussen,C,DET,25,80,17,20,37
11,8484203,Bradly Nadeau,L,CAR,19,67,15,22,37
11,8477507,Nikita Zadorov,D,BOS,29,64,15,22,37
11,8482105,Jake Sanderson,D,OTT,22,70,14,23,37
11,8475714,Calle Jarnkrok,C,TOR,33,75,12,25,37
11,8478462,Nicolas Roy,C,VGK,27,78,11,26,37
11,8477932,Aaron Ekblad,D,FLA,28,73,10,27,37
11,8479425,Filip Hronek,D,VAN,27,71,9,28,37
11,8474053,Logan Couture,C,SJS,35,69,7,30,37
11,8476869,Brady Skjei,D,NSH,30,72,7,30,37
11,8480043,Timothy Liljegren,D,TOR,25,74,6,31,37
11,8481535,Nils Hoglander,L,VAN,24,67,18,18,36
11,8481186,Logan O'Connor,R,COL,28,79,16,20,36
11,8475848,Brendan Gallagher,R,MTL,32,71,16,20,36
11,8475760,Nick Bjugstad,C,UTA,32,73,15,21,36
11,8476462,Dougie Hamilton,D,NJD,31,73,14,22,36
11,8474565,Alex Pietrangelo,D,VGK,34,65,12,24,36
11,8476927,Teddy Blueger,C,VAN,30,69,11,25,36
11,8481581,Thomas Harley,D,DAL,23,75,10,26,36
11,8476917,Adam Pelech,D,NYI,30,80,7,29,36
11,8476331,Dylan DeMelo,D,WPG,31,71,6,30,36
11,8482712,Oskar Olausson,R,COL,22,69,1,35,36
11,8480068,Ryan Poehling,C,PHI,25,72,17,18,35
11,8476474,Stefan Noesen,R,NJD,31,72,14,21,35
11,8477919,Frederick Gaudreau,C,MIN,31,63,12,23,35
11,8482089,Jake Neighbours,L,STL,22,69,19,15,34
11,8473422,Nick Foligno,L,CHI,37,57,15,19,34
11,8480113,Alex Iafallo,L,WPG,31,68,14,20,34
11,8480871,Adam Boqvist,D,FLA,24,69,14,20,34
11,8471698,T.J. Oshie,R,WSH,38,67,14,20,34
11,8484145,Zach Benson,L,BUF,19,63,13,21,34
11,8480798,Philipp Kurashev,C,CHI,25,66,12,22,34
11,8476872,Scott Laughton,C,PHI,30,74,9,25,34
11,8476902,Esa Lindell,D,DAL,30,70,9,25,34
11,8483505,Matthew Poitras,C,BOS,20,72,8,26,34
11,8476422,Mike Reilly,D,NYI,31,77,8,26,34
11,8480817,K'Andre Miller,D,NYR,24,72,6,28,34
11,8481703,Valtteri Puustinen,R,PIT,25,57,6,28,34
11,8482122,Brock Faber,D,MIN,22,81,5,29,34
11,8480459,Pius Suter,C,VAN,28,67,20,13,33
11,8480009,Eeli Tolvanen,R,SEA,25,69,20,13,33
11,8479393,Noah Gregor,L,OTT,26,67,15,18,33
11,8480078,Filip Chytil,C,NYR,25,70,14,19,33
11,8477998,Warren Foegele,L,LAK,28,81,13,20,33
11,8479351,Sam Steel,C,DAL,26,81,10,23,33
11,8478046,Danton Heinen,L,VAN,29,72,10,23,33
11,8474563,Drew Doughty,D,LAK,35,69,9,24,33
11,8478055,Gustav Forsling,D,FLA,28,71,9,24,33
11,8473533,Jordan Staal,C,CAR,36,65,16,16,32
11,8481093,Rafael Harvey-Pinard,L,MTL,25,62,16,16,32
11,8475231,Casey Cizikas,C,NYI,33,74,16,16,32
11,8478463,Anthony Beauvillier,L,PIT,27,65,14,18,32
11,8476292,Ondrej Palat,L,NJD,33,66,14,18,32
11,8475763,Kevin Hayes,R,PIT,32,69,13,19,32
11,8480185,Eetu Luostarinen,C,FLA,26,73,12,20,32
11,8477456,J.T. Compher,L,DET,29,80,10,22,32
11,8476463,Jonas Brodin,D,MIN,31,80,10,22,32
11,8473563,Nicklas Backstrom,C,WSH,37,55,10,22,32
11,8477498,Darnell Nurse,D,EDM,29,68,5,27,32
11,8476979,Erik Gustafsson,D,DET,32,74,3,29,32
11,8481560,Arthur Kaliyev,R,LAK,23,79,19,12,31
11,8481554,Kaapo Kakko,R,NYR,23,70,18,13,31
11,8479661,Tanner Jeannot,L,LAK,27,76,17,14,31
11,8479316,Luke Kunin,C,SJS,27,63,16,15,31
11,8482055,Drew O'Connor,L,PIT,26,64,15,16,31
11,8480336,Sean Walker,D,CAR,30,72,12,19,31
11,8481656,Aliaksei Protas,C,WSH,23,68,10,21,31
11,8481523,Kirby Dach,C,MTL,23,68,9,22,31
11,8474716,Jared Spurgeon,D,MIN,35,77,8,23,31
11,8476792,Torey Krug,D,STL,33,65,7,24,31
11,8481580,Connor McMichael,C,WSH,23,62,19,11,30
11,8478109,Victor Olofsson,L,VGK,29,68,18,12,30
11,8479293,Brandon Tanev,L,SEA,33,66,17,13,30
11,8477947,Sonny Milano,L,WSH,28,59,14,16,30
11,8476392,Adam Lowry,C,WPG,31,66,14,16,30
11,8477425,Miles Wood,L,COL,29,78,14,16,30
11,8482475,Yegor Chinakhov,R,CBJ,23,63,13,17,30
11,8477952,Robby Fabbri,C,ANA,28,59,12,18,30
11,8476480,Vladislav Namestnikov,C,WPG,32,65,10,20,30
11,8483445,Cutter Gauthier,L,ANA,20,63,8,22,30
11,8478396,Noah Hanifin,D,VGK,27,66,7,23,30
11,8474715,Cameron Atkinson,R,TBL,35,81,20,9,29
11,8483493,Frank Nazar,C,CHI,20,57,19,10,29
11,8482679,Matt Coronato,R,CGY,22,65,17,12,29
11,8475722,Jason Zucker,L,BUF,32,66,15,14,29
11,8480893,Kirill Marchenko,R,CBJ,24,57,14,15,29
11,8478013,Jake Walman,D,SJS,28,77,14,15,29
11,8482117,Lukas Reichel,L,CHI,22,53,13,16,29
11,8481704,Juuso Parssinen,C,NSH,23,66,12,17,29
11,8480839,Rasmus Dahlin,D,BUF,24,75,6,23,29
11,8480813,Joe Veleno,C,DET,24,79,17,11,28
11,8475799,Nino Niederreiter,R,WPG,32,59,16,12,28
11,8482737,Zack Bolduc,C,STL,21,55,16,12,28
11,8482175,JJ Peterka,R,BUF,22,68,13,15,28
11,8482660,Kent Johnson,C,CBJ,22,57,11,17,28
11,8478891,Mason Appleton,C,WPG,28,63,11,17,28
11,8477839,Conor Sheary,L,TBL,32,80,11,17,28
11,8475149,Marcus Johansson,L,MIN,34,65,11,17,28
11,8475200,Dmitry Orlov,D,CAR,33,76,10,18,28
11,8479368,Max Jones,L,BOS,26,61,10,18,28
11,8477989,Christian Dvorak,C,MTL,28,58,14,13,27
11,8480835,Jack Drury,C,CAR,24,61,10,17,27
11,8476925,Colton Sissons,C,NSH,31,67,10,17,27
11,8482809,Jackson Blake,R,CAR,21,54,10,17,27
11,8479591,Michael Eyssimont,C,TBL,28,81,8,19,27
11,8475171,Oliver Ekman-Larsson,D,TOR,33,68,8,19,27
11,8476429,Scott Mayfield,D,NYI,32,75,7,20,27
11,8476885,Jacob Trouba,D,NYR,30,71,6,21,27
11,8477506,Ryan Pulock,D,NYI,30,77,6,21,27
11,8476892,Colton Parayko,D,STL,31,70,5,22,27
11,8479982,Conor Timmins,D,TOR,26,54,5,22,27
11,8478057,Dakota Joshua,C,VAN,28,61,16,10,26
11,8480220,Noah Cates,L,PHI,25,65,14,12,26
11,8480980,Connor Dewar,C,TOR,25,68,13,13,26
11,8477392,Hudson Fasching,R,NYI,29,68,13,13,26
11,8476981,Josh Anderson,R,MTL,30,70,11,15,26
11,8478413,Jordan Greenway,L,BUF,27,60,9,17,26
11,8477353,Tyler Motte,C,DET,29,68,8,18,26
11,8477948,Travis Sanheim,D,PHI,28,72,6,20,26
11,8479398,Samuel Girard,D,COL,26,70,5,21,26
11,8473507,Jeff Petry,D,DET,37,70,4,22,26
11,8478500,Ivan Provorov,D,CBJ,27,79,2,24,26
11,8477450,Jason Dickinson,C,CHI,29,58,12,13,25
11,8483457,Lane Hutson,D,MTL,20,62,10,15,25
11,8482245,Artem Zub,D,OTT,29,76,5,20,25
11,8476312,Josh Manson,D,COL,33,61,5,20,25
11,8480049,Dylan Samberg,D,WPG,25,64,3,22,25
11,8480058,Pierre-Olivier Joseph,D,STL,25,64,2,23,25
11,8482074,Connor Zary,C,CGY,23,63,16,8,24
11,8470621,Corey Perry,R,EDM,39,70,15,9,24
11,8479353,Brett Howden,C,VGK,26,72,13,11,24
11,8480829,Jesperi Kotkaniemi,C,CAR,24,66,12,12,24
11,8476918,Jimmy Vesey,L,NYR,31,64,12,12,24
11,8480205,Emil Bemstrom,C,PIT,25,60,11,13,24
11,8475791,Taylor Hall,L,CHI,33,57,10,14,24
11,8482655,Janis Moser,D,TBL,24,80,6,18,24
11,8478970,Jalen Chatfield,D,CAR,28,70,6,18,24
11,8481537,Nikita Okhotiuk,D,CGY,24,50,4,20,24
11,8475233,David Savard,D,MTL,34,65,4,20,24
11,8480878,Nils Lundkvist,D,DAL,24,71,3,21,24
11,8474151,Ryan McDonagh,D,TBL,35,76,2,22,24
11,8482125,Alexander Holtz,R,VGK,22,68,15,8,23
11,8478508,Yakov Trenin,C,MIN,27,57,15,8,23
11,8482146,Luke Evangelista,R,NSH,22,63,13,10,23
11,8476921,Jordan Martinook,L,CAR,32,61,12,11,23
11,8477903,Garnet Hathaway,R,PHI,33,63,12,11,23
11,8481032,Paul Cotter,C,NJD,25,62,12,11,23
11,8479520,Brandon Duhaime,R,WSH,27,54,10,13,23
11,8482111,Justin Barron,D,MTL,23,62,9,14,23
11,8476469,Joel Armia,R,MTL,31,66,9,14,23
11,8474189,Lars Eller,C,PIT,35,66,8,15,23
11,8476329,Travis Boyd,C,MIN,31,59,8,15,23
11,8476960,Andreas Athanasiou,C,CHI,30,54,8,15,23
11,8480855,Jack McBain,C,UTA,24,67,7,16,23
11,8481524,Bowen Byram,D,BUF,23,61,5,18,23
11,8477488,Brett Pesce,D,NJD,30,69,4,19,23
11,8482624,Daniil Miromanov,D,CGY,27,66,4,19,23
11,8475324,Nick Jensen,D,OTT,34,66,2,21,23
11,8477380,Jonny Brodzinski,C,NYR,31,52,15,7,22
11,8481601,Simon Holmstrom,R,NYI,23,64,12,10,22
11,8481481,Blake Lizotte,C,PIT,27,69,11,11,22
11,8481477,Nico Sturm,C,SJS,29,58,10,12,22
11,8483499,Liam Ohgren,L,MIN,20,53,7,15,22
11,8476897,Oskar Sundqvist,C,STL,30,63,6,16,22
11,8477969,Marcus Pettersson,D,PIT,28,78,5,17,22
11,8478911,Matt Roy,D,WSH,29,63,5,17,22
11,8482749,Joshua Roy,R,MTL,21,60,5,17,22
11,8477365,Connor Clifton,D,BUF,29,57,5,17,22
11,8482067,Connor Mackey,D,NYR,28,66,4,18,22
11,8476457,Adam Larsson,D,SEA,32,70,3,19,22
11,8478840,Will Borgen,D,SEA,28,68,3,19,22
11,8476931,Jake McCabe,D,TOR,31,63,2,20,22
11,8480222,Sebastian Aho,D,PIT,28,77,2,20,22
11,8474673,TJ Brodie,D,CHI,34,67,0,22,22
11,8477478,William Carrier,L,CAR,30,56,14,7,21
11,8479336,Carl Grundstrom,R,SJS,27,54,14,7,21
11,8476873,Mark Jankowski,C,NSH,30,51,12,9,21
11,8478432,Christian Fischer,R,DET,27,74,11,10,21
11,8480802,Ryan McLeod,C,BUF,25,67,10,11,21
11,8476278,Colin Blackwell,C,DAL,31,80,9,12,21
11,8476889,Radek Faksa,C,STL,30,67,8,13,21
11,8477987,Ryan Donato,C,CHI,28,54,7,14,21
11,8482803,Olen Zellweger,D,ANA,21,66,7,14,21
11,8475279,Ben Chiarot,D,DET,33,65,6,15,21
11,8476879,Cody Ceci,D,EDM,31,76,3,18,21
11,8481546,Cam York,D,PHI,23,65,3,18,21
11,8476891,Matthew Grzelcyk,D,PIT,30,75,2,19,21
11,8478507,John Marino,D,UTA,27,67,1,20,21
11,8479619,Michael Carcone,L,UTA,28,50,14,6,20
11,8480011,Klim Kostin,C,SJS,25,52,9,11,20
11,8479996,Cody Glass,C,NSH,25,56,8,12,20
11,8478399,Jonas Siegenthaler,D,NJD,27,63,8,12,20
11,8479315,Joey Anderson,R,CHI,26,52,7,13,20
11,8480073,Erik Brannstrom,D,COL,25,62,5,15,20
11,8478178,Darren Raddysh,D,TBL,28,65,5,15,20
11,8481606,Jordan Spence,D,LAK,23,66,4,16,20
11,8475181,Nick Leddy,D,STL,33,70,4,16,20
11,8477435,Ryan Graves,D,PIT,29,78,4,16,20
11,8479976,Juuso Valimaki,D,UTA,26,63,2,18,20
11,8476967,Brett Kulak,D,EDM,30,63,2,18,20
11,8477446,Michael McCarron,R,NSH,29,53,11,8,19
11,8479344,Jesse Puljujarvi,R,PIT,26,54,11,8,19
11,8481028,Martin Pospisil,C,CGY,25,60,11,8,19
11,8481582,Nicholas Robertson,L,TOR,23,66,10,9,19
11,8478421,A.J. Greer,L,FLA,28,59,9,10,19
11,8480144,David Kampf,C,TOR,29,73,8,11,19
11,8479370,Tyson Jost,C,CAR,26,52,8,11,19
11,8482101,Danil Gushchin,L,SJS,22,55,6,13,19
11,8482671,Owen Power,D,BUF,22,71,5,14,19
11,8476525,Colin Miller,D,WPG,32,58,2,17,19
11,8475855,Jesper Fast,R,CAR,33,61,12,6,18
11,8481553,Bobby Brink,R,PHI,23,68,9,9,18
11,8482079,Marco Rossi,C,MIN,23,55,7,11,18
11,8477499,Rasmus Ristolainen,D,PHI,30,60,7,11,18
11,8475343,Nic Dowd,C,WSH,34,64,6,12,18
11,8480448,Parker Kelly,L,COL,25,78,6,12,18
11,8483491,Ivan Miroshnichenko,L,WSH,20,53,6,12,18
11,8482192,Isaak Phillips,D,CHI,23,53,5,13,18
11,8481014,Alexander Romanov,D,NYI,24,71,4,14,18
11,8476988,Matt Benning,D,SJS,30,66,4,14,18
11,8479324,Ryan Lindgren,D,NYR,26,64,3,15,18
11,8479402,Jake Bean,D,CGY,26,60,2,16,18
11,8482073,Braden Schneider,D,NYR,23,69,2,16,18
11,8481178,Egor Zamula,D,PHI,24,49,1,17,18
11,8478115,Pierre Engvall,L,NYI,28,74,10,7,17
11,8482259,Bobby McMann,C,TOR,28,62,10,7,17
11,8475220,Marcus Foligno,L,MIN,33,58,10,7,17
11,8483482,Tristan Luneau,D,ANA,20,60,9,8,17
11,8481521,Ronnie Attard,D,PHI,25,57,9,8,17
11,8477505,Alexander Wennberg,C,SJS,30,65,8,9,17
11,8480003,Jesper Boqvist,C,FLA,26,63,8,9,17
11,8476374,Sean Kuraly,C,CBJ,31,59,7,10,17
11,8481522,Peyton Krebs,C,BUF,23,63,7,10,17
11,8479718,Alex Barré-Boulet,C,MTL,27,52,7,10,17
11,8478434,Keegan Kolesar,R,VGK,27,69,7,10,17
11,8477508,Curtis Lazar,C,NJD,29,58,6,11,17
11,8477573,Nathan Walker,L,STL,30,57,6,11,17
11,8480762,Eric Robinson,L,CAR,29,59,5,12,17
11,8477369,Carson Soucy,D,VAN,30,57,5,12,17
11,8480891,Michael Kesselring,D,UTA,24,60,4,13,17
11,8475455,Brenden Dillon,D,NJD,34,54,4,13,17
11,8481059,Scott Perunovich,D,STL,26,62,3,14,17
11,8477220,Nate Schmidt,D,FLA,33,68,2,15,17
11,8484149,Gavin Brindley,C,CBJ,20,54,2,15,17
11,8481567,Henry Thrun,D,SJS,23,52,2,15,17
11,8480281,Alexey Toropchenko,R,STL,25,59,11,5,16
11,8477979,Nicolas Aube-Kubel,R,BUF,28,64,10,6,16
11,8483524,Shane Wright,C,SEA,20,63,9,7,16
11,8482155,Alex Laferriere,R,LAK,23,66,9,7,16
11,8482807,Ethan Del Mastro,D,CHI,21,50,9,7,16
11,8480806,Isac Lundestrom,C,ANA,25,51,8,8,16
11,8479941,Justin Danforth,R,CBJ,31,52,8,8,16
11,8475193,Tomas Tatar,L,NJD,34,68,8,8,16
11,8480789,Oliver Wahlstrom,R,NYI,24,70,8,8,16
11,8476822,Luke Glendening,C,TBL,35,79,8,8,16
11,8480074,Alexandre Texier,C,STL,25,58,6,10,16
11,8483565,Nick Blankenburg,D,NSH,26,62,6,10,16
11,8477931,Tomas Nosek,L,FLA,32,65,6,10,16
11,8482176,Wyatt Kaiser,D,CHI,22,48,6,10,16
11,8479983,Mario Ferraro,D,SJS,26,70,6,10,16
11,8479026,Philippe Myers,D,TOR,27,48,6,10,16
11,8476856,Mathew Dumba,D,DAL,30,67,5,11,16
11,8474574,Tyler Myers,D,VAN,34,71,5,11,16
11,8478211,Dryden Hunt,L,CGY,29,48,5,11,16
11,8478851,Alexandre Carrier,D,NSH,28,67,5,11,16
11,8479378,Logan Stanley,D,WPG,26,52,5,11,16
11,8478882,Vladislav Gavrikov,D,LAK,29,70,4,12,16
11,8476467,Jamie Oleksiak,D,SEA,32,63,3,13,16
11,8480246,Nick Perbix,D,TBL,26,79,3,13,16
11,8480995,Pontus Holmberg,R,TOR,25,56,3,13,16
11,8481708,Zac Jones,D,NYR,24,48,2,14,16
11,8482762,Simon Edvinsson,D,DET,21,58,11,4,15
11,8478569,Noel Acciari,C,PIT,33,48,10,5,15
11,8483468,Jiri Kulich,C,BUF,20,56,9,6,15
11,8481716,Dmitri Voronkov,L,CBJ,24,43,9,6,15
11,8482062,Cole Smith,L,NSH,29,53,8,7,15
11,8482166,Shakir Mukhamadullin,D,SJS,22,47,8,7,15
11,8477953,Kasperi Kapanen,R,STL,28,65,7,8,15
11,8476878,Zemgus Girgensons,C,TBL,30,78,7,8,15
11,8474090,Brendan Smith,D,DAL,35,51,7,8,15
11,8479772,Zack MacEwen,R,OTT,28,54,7,8,15
11,8482148,Hendrix Lapierre,C,WSH,22,49,6,9,15
11,8480252,Cole Guttman,C,CHI,25,35,6,9,15
11,8480796,Martin Fehervary,D,WSH,25,58,6,9,15
11,8478451,Ethan Bear,D,WSH,27,49,6,9,15
11,8481641,Joel Kiviranta,L,COL,28,69,6,9,15
11,8482142,Jamie Drysdale,D,PHI,22,63,4,11,15
11,8484254,Akito Hirose,D,VAN,25,45,4,11,15
11,8480873,Rasmus Sandin,D,WSH,24,61,3,12,15
11,8479291,Kevin Rooney,C,CGY,31,46,3,12,15
11,8474013,Ian Cole,D,UTA,35,56,2,13,15
11,8474034,Patrick Maroon,L,CHI,36,46,1,14,15
11,8475188,Brayden McNabb,D,VGK,33,59,0,15,15
11,8475208,Brian Dumoulin,D,ANA,33,62,0,15,15
11,8473453,Trevor Lewis,C,LAK,37,67,8,6,14
11,8475842,Sam Carrick,C,NYR,32,52,8,6,14
11,8478585,Derek Ryan,C,EDM,38,56,7,7,14
11,8480748,Kiefer Sherwood,L,VAN,29,64,6,8,14
11,8481019,David Gustafsson,C,WPG,24,48,6,8,14
11,8479543,Michael Pezzetta,L,MTL,26,51,6,8,14
11,8475225,Craig Smith,C,CHI,35,56,6,8,14
11,8482095,Tyler Kleven,D,OTT,22,50,6,8,14
11,8470600,Ryan Suter,D,STL,39,55,5,9,14
11,8480289,Morgan Barron,C,WPG,26,56,5,9,14
11,8476994,Vinnie Hinostroza,C,NSH,30,46,5,9,14
11,8479372,Joshua Mahura,D,SEA,26,53,5,9,14
11,8477406,Mattias Janmark,C,EDM,32,68,4,10,14
11,8475690,Chris Tanev,D,TOR,35,54,4,10,14
11,8476874,Olli Maatta,D,DET,30,61,4,10,14
11,8477015,Connor Brown,R,EDM,30,63,3,11,14
11,8475177,Calvin de Haan,D,COL,33,39,3,11,14
11,8481550,Adam Beckman,L,NJD,23,37,2,12,14
11,8480807,Mattias Samuelsson,D,BUF,24,57,1,13,14
11,8478859,Niko Mikkola,D,FLA,28,57,1,13,14
11,8475462,Radko Gudas,D,ANA,34,62,1,13,14
11,8481167,Brayden Pachal,D,CGY,25,43,1,13,14
11,8480950,Ilya Lyubushkin,D,DAL,30,69,0,14,14
11,8482730,Brandt Clarke,D,LAK,21,60,9,4,13
11,8478043,Sam Lafferty,C,BUF,29,56,8,5,13
11,8481789,Tye Kartye,L,SEA,23,49,8,5,13
11,8479066,Ryan Lomberg,L,CGY,30,67,7,6,13
11,8481617,Vasily Podkolzin,R,VAN,23,46,6,7,13
11,8479639,Dylan Coghlan,D,WPG,26,56,5,8,13
11,8480355,Mark Kastelic,C,BOS,25,70,5,8,13
11,8478831,Kevin Stenlund,C,UTA,28,51,5,8,13
11,8480887,Jordan Harris,D,MTL,24,54,5,8,13
11,8481599,Victor Soderstrom,D,UTA,23,40,5,8,13
11,8479671,Mathieu Olivier,R,CBJ,27,48,4,9,13
11,8481568,Alex Vlasic,D,CHI,23,55,4,9,13
11,8479980,Nicolas Hague,D,VGK,26,50,3,10,13
11,8479442,Troy Stecher,D,EDM,30,52,3,10,13
11,8476372,Nick Seeler,D,PHI,31,53,3,10,13
11,8475790,Erik Gudbranson,D,CBJ,32,74,2,11,13
11,8471709,Marc-Edouard Vlasic,D,SJS,37,63,2,11,13
11,8480035,Henri Jokiharju,D,BUF,25,61,2,11,13
11,8478136,Jake Middleton,D,MIN,28,78,2,11,13
11,8477018,Ben Hutton,D,VGK,31,48,2,11,13
11,8483460,David Jiricek,D,CBJ,21,64,2,11,13
11,8479371,Dante Fabbro,D,NSH,26,64,1,12,13
11,8482087,Kaiden Guhle,D,MTL,22,63,1,12,13
11,8480860,Kevin Bahl,D,CGY,24,59,0,13,13
11,8481517,Brett Leason,R,ANA,25,58,9,3,12
11,8471817,Ryan Reaves,R,TOR,37,50,9,3,12
11,8479536,Axel Jonsson-Fjallby,L,WPG,26,37,8,4,12
11,8482157,Will Cuylle,L,NYR,22,67,6,6,12
11,8482659,Josh Doan,R,UTA,22,54,6,6,12
11,8479439,Jacob MacDonald,D,COL,31,50,6,6,12
11,8476624,Barclay Goodrow,C,SJS,31,45,5,7,12
11,8479414,Nathan Bastian,R,NJD,27,55,5,7,12
11,8483466,Kevin Korchinski,D,CHI,20,50,4,8,12
11,8480880,Jakub Lauko,C,MIN,24,33,4,8,12
11,8480727,Zach Whitecloud,D,VGK,28,48,3,9,12
11,8480001,Urho Vaakanainen,D,ANA,25,56,3,9,12
11,8475179,Dmitry Kulikov,D,FLA,34,67,2,10,12
11,8478452,Caleb Jones,D,LAK,27,48,1,11,12
11,8478443,Brandon Carlo,D,BOS,28,62,1,11,12
11,8482451,Mikael Pyyhtia,L,CBJ,23,45,1,11,12
11,8481600,Tobias Bjornfot,D,FLA,23,44,1,11,12
11,8479249,Andrew Poturalski,C,SJS,30,40,1,11,12
11,8479998,Mikey Anderson,D,LAK,25,57,0,12,12
11,8481013,Jonatan Berggren,R,DET,24,56,7,4,11
11,8481518,Nolan Foote,L,NJD,24,44,7,4,11
11,8481592,Jakob Pelletier,L,CGY,23,44,6,5,11
11,8482744,James Malatesta,L,CBJ,21,44,5,6,11
11,8479944,Zach Aston-Reese,C,VGK,30,50,5,6,11
11,8480441,Trey Fix-Wolansky,R,CBJ,25,43,5,6,11
11,8480848,Ty Dellandrea,C,SJS,24,42,4,7,11
11,8471677,Jack Johnson,D,CBJ,37,72,4,7,11
11,8483549,Lucas Condotta,L,MTL,27,31,4,7,11
11,8481161,Jake Christiansen,D,CBJ,25,44,4,7,11
11,8482733,Logan Mailloux,D,MTL,31,34,3,8,11
11,8481527,Kaedan Korczak,D,VGK,23,50,2,9,11
11,8482077,Dylan Holloway,L,EDM,23,53,6,4,10
11,8479359,Beck Malenstyn,L,BUF,26,45,6,4,10
11,8478424,Jansen Harkins,C,ANA,27,42,6,4,10
11,8482652,Walker Duehr,R,CGY,27,40,6,4,10
11,8481754,Nikita Nesterenko,C,ANA,23,43,5,5,10
11,8482496,Nils Aman,C,VAN,24,34,5,5,10
11,8482713,Mackie Samoskevich,R,FLA,22,38,5,5,10
11,8481441,Joe Snively,C,DET,28,65,4,6,10
11,8476867,Brendan Gaunce,C,MIN,30,38,4,6,10
11,8477938,Haydn Fleury,D,WPG,28,40,4,6,10
11,8482784,Zach Dean,C,STL,21,38,3,7,10
11,8480157,Calle Rosen,D,COL,30,48,3,7,10
11,8477851,Jordan Oesterle,D,BOS,32,48,3,7,10
11,8481147,Reese Johnson,C,MIN,26,49,3,7,10
11,8482859,Zack Ostapchuk,C,OTT,21,57,1,9,10
11,8480879,Jacob Bernard-Docker,D,OTT,24,45,1,9,10
11,8482145,Mavrik Bourque,C,DAL,22,48,6,3,9
11,8484911,Collin Graf,R,SJS,22,43,6,3,9
11,8481532,Alex Turcotte,C,LAK,23,39,5,4,9
11,8480845,Rasmus Kupari,C,WPG,24,52,5,4,9
11,8475235,Nicolas Deslauriers,L,PHI,33,54,4,5,9
11,8480870,Bo Groulx,C,NYR,24,35,4,5,9
11,8482666,Scott Morrow,D,CAR,22,42,3,6,9
11,8474567,Zach Bogosian,D,MIN,34,60,3,6,9
11,8480192,Johnathan Kovacevic,D,NJD,27,48,3,6,9
11,8482165,Yan Kuznetsov,D,CGY,22,24,3,6,9
11,8483012,Logan Morrison,C,SEA,22,38,3,6,9
11,8479369,Andrew Peeke,D,BOS,26,52,2,7,9
11,8480196,Jacob Bryson,D,BUF,27,40,2,7,9
11,8477384,Joshua Brown,D,EDM,30,36,2,7,9
11,8479986,Kole Lind,R,DAL,26,50,2,7,9
11,8475718,Justin Holl,D,DET,32,61,1,8,9
11,8477845,Trevor van Riemsdyk,D,WSH,33,55,1,8,9
11,8474166,Alec Martinez,D,CHI,37,49,1,8,9
11,8479328,Julien Gauthier,R,NYI,27,64,6,2,8
11,8479968,Vinni Lettieri,C,BOS,29,44,5,3,8
11,8480021,Jack Studnicka,C,LAK,25,60,4,4,8
11,8482634,Alex Steeves,C,TOR,25,48,4,4,8
11,8483397,Marc McLaughlin,C,BOS,25,32,4,4,8
11,8482747,Brennan Othmann,L,NYR,21,39,4,4,8
11,8483495,Simon Nemec,D,NJD,20,54,3,5,8
11,8481751,Lukas Rousek,R,BUF,25,36,3,5,8
11,8483619,Filip Roos,D,OTT,25,32,3,5,8
11,8477482,Zachary Sanford,L,CHI,30,43,2,6,8
11,8478468,Jeremy Lauzon,D,NSH,27,53,2,6,8
11,8476913,Devin Shore,C,MIN,30,36,2,6,8
11,8482141,Lukas Cormier,D,VGK,22,27,2,6,8
11,8476441,Joel Edmundson,D,LAK,31,44,2,6,8
11,8478416,Erik Cernak,D,TBL,27,73,1,7,8
11,8480025,MacKenzie Entwistle,R,FLA,25,64,1,7,8
11,8480890,Jan Jenik,C,OTT,24,25,1,7,8
11,8480468,James Hamblin,L,EDM,25,19,6,1,7
11,8482964,Arber Xhekaj,D,MTL,23,55,5,2,7
11,8479994,Jaret Anderson-Dolan,C,WPG,25,33,4,3,7
11,8476934,Brock McGinn,L,ANA,30,55,3,4,7
11,8478021,William Lagesson,D,DET,28,29,3,4,7
11,8480292,Carson Meyer,R,ANA,27,29,2,5,7
11,8475750,Jon Merrill,D,MIN,32,62,1,6,7
11,8481701,Santeri Hatakka,D,NJD,23,38,1,6,7
11,8482861,Vincent Iorio,D,WSH,22,40,1,6,7
11,8477962,Brendan Lemieux,L,CAR,28,33,1,6,7
11,8478450,Parker Wotherspoon,D,BOS,27,37,1,6,7
11,8477335,Kyle Burroughs,D,LAK,29,48,1,6,7
11,8479576,Vincent Desharnais,D,VAN,28,36,1,6,7
11,8480172,Jan Rutta,D,SJS,34,58,0,7,7
11,8481679,Maxence Guenette,D,OTT,23,32,6,0,6
11,8477401,John Hayden,C,SEA,29,35,4,2,6
11,8479348,Kale Clague,D,BUF,26,48,3,3,6
11,8482153,Brendan Brisson,C,VGK,23,34,3,3,6
11,8482858,Ryker Evans,D,SEA,23,21,3,3,6
11,8480070,Ian Mitchell,D,BOS,25,45,2,4,6
11,8475762,Derek Forbort,D,VAN,32,44,2,4,6
11,8482177,Marat Khusnutdinov,C,MIN,22,33,2,4,6
11,8479981,Jonah Gadjovich,L,FLA,26,33,2,4,6
11,8481609,Vladislav Kolyachonok,D,UTA,23,27,2,4,6
11,8478146,Matthew Highmore,C,OTT,28,39,2,4,6
11,8478477,Mitchell Stephens,C,SEA,27,19,2,4,6
11,8481056,Spencer Stastney,D,NSH,24,30,2,4,6
11,8481605,Jackson LaCombe,D,ANA,23,38,2,4,6
11,8473446,Erik Johnson,D,PHI,36,42,1,5,6
11,8481598,Philip Broberg,D,EDM,23,49,1,5,6
11,8479972,Mason Shaw,C,WPG,26,36,0,6,6
11,8482250,Callahan Burke,C,VGK,27,13,0,6,6
11,8477070,Liam O'Brien,C,UTA,30,58,4,1,5
11,8481543,Nikita Alexandrov,C,STL,24,27,4,1,5
11,8480007,Jonas Rondbjerg,R,VGK,25,41,3,2,5
11,8478409,Anthony Richard,C,PHI,28,24,3,2,5
11,8482751,Ryan Winterton,C,SEA,21,39,3,2,5
11,8480245,Olle Lycksell,R,PHI,25,33,3,2,5
11,8479991,Jake Leschyshyn,C,NYR,25,28,2,3,5
11,8477887,Patrick Brown,C,BOS,32,47,2,3,5
11,8480834,Ty Emberson,D,SJS,24,35,2,3,5
11,8480844,Grigori Denisenko,L,VGK,24,23,2,3,5
11,8480267,Sammy Walker,C,MIN,25,17,2,3,5
11,8476442,Matt Nieto,L,PIT,32,40,1,4,5
11,8478017,Mark Friedman,D,VAN,29,37,1,4,5
11,8482765,Isak Rosen,R,BUF,21,39,1,4,5
11,8474612,Travis Hamonic,D,OTT,34,46,1,4,5
11,8483512,Matthew Savoie,C,EDM,20,24,0,5,5
11,8478454,Noah Juulsen,D,VAN,27,36,0,5,5
11,8482470,Ilya Solovyov,D,CGY,24,22,3,1,4
11,8483763,Maksymilian Szuber,D,UTA,22,33,3,1,4
11,8481422,Jake Lucchini,C,NSH,29,22,3,1,4
11,8480823,Alexander Alexeyev,D,WSH,25,14,3,1,4
11,8480990,Declan Chisholm,D,MIN,24,34,2,2,4
11,8475958,Michael Sgarbossa,C,WSH,32,29,2,2,4
11,8482511,Mason Lohrei,D,BOS,23,32,2,2,4
11,8480032,Shane Bowers,C,NJD,25,13,2,2,4
11,8479638,Justin Brazeau,R,BOS,26,29,2,2,4
11,8481699,Aku Raty,R,UTA,23,19,2,2,4
11,8480084,Nick DeSimone,D,NJD,30,23,2,2,4
11,8477993,Justin Kirkland,C,CGY,28,11,2,2,4
11,8476858,Phillip Di Giuseppe,L,VAN,31,37,1,3,4
11,8476952,Dominic Toninato,C,WPG,30,36,1,3,4
11,8481122,Simon Benoit,D,TOR,26,43,1,3,4
11,8477462,Robert Hagg,D,VGK,29,20,1,3,4
11,8478502,Dennis Gilbert,D,BUF,28,13,1,3,4
11,8479379,Givani Smith,R,SJS,26,21,1,3,4
11,8481719,Maxwell Crozier,D,TBL,24,16,1,3,4
11,8484258,Sam Malinski,D,COL,26,25,1,3,4
11,8474568,Luke Schenn,D,NSH,35,52,0,4,4
11,8481556,John Beecher,C,BOS,23,32,3,0,3
11,8483570,Ben Meyers,C,SEA,26,29,2,1,3
11,8477073,Kurtis MacDermid,L,NJD,30,31,2,1,3
11,8480874,Adam Ginning,D,PHI,24,16,2,1,3
11,8477810,Joel Hanley,D,CGY,33,26,2,1,3
11,8481237,Kyle MacLean,C,NYI,25,22,1,2,3
11,8484287,Cole McWard,D,VAN,23,21,1,2,3
11,8477473,Justin Bailey,R,SJS,29,28,1,2,3
11,8481593,Jayden Struble,D,MTL,23,23,1,2,3
11,8482201,Gage Goncalves,C,TBL,23,28,1,2,3
11,8481030,Jack St. Ivany,D,PIT,25,17,1,2,3
11,8477149,Scott Sabourin,R,SJS,32,13,1,2,3
11,8482172,Landon Slaggert,L,CHI,22,29,0,3,3
11,8480851,Akil Thomas,C,LAK,24,21,0,3,3
11,8482070,Mitchell Chaffee,R,TBL,26,46,2,0,2
11,8481462,Mason Morelli,L,VGK,28,11,2,0,2
11,8478011,Louie Belpedio,D,PHI,28,14,2,0,2
11,8482118,Sam Colangelo,R,ANA,23,21,2,0,2
11,8482102,Vasily Ponomarev,C,PIT,22,19,2,0,2
11,8483567,Georgii Merkulov,C,BOS,24,7,2,0,2
11,8483630,Pavol Regenda,L,ANA,25,29,1,1,2
11,8482144,Jack Thompson,D,SJS,22,24,1,1,2
11,8481743,Marc Del Gaizo,D,NSH,25,18,1,1,2
11,8482147,Jean-Luc Foudy,C,COL,22,24,1,1,2
11,8479985,Cale Fleury,D,SEA,26,31,1,1,2
11,8477244,Chad Ruhwedel,D,NYR,34,26,1,1,2
11,8481043,Cole Koepke,L,BOS,26,16,1,1,2
11,8477971,Andreas Englund,D,LAK,28,24,1,1,2
11,8481065,Angus Crookshank,L,OTT,25,13,1,1,2
11,8478051,Max Willman,C,NJD,29,18,1,1,2
11,8481585,Egor Afanasyev,L,SJS,23,13,1,1,2
11,8483597,Milos Kelemen,L,UTA,25,10,1,1,2
11,8481655,Cole Schwindt,R,CGY,23,3,1,1,2
11,8484259,Ondrej Pavel,C,COL,31,4,1,1,2
11,8481726,Adam Edstrom,C,NYR,24,12,1,1,2
11,8476473,Connor Murphy,D,CHI,31,38,0,2,2
11,8477527,Ross Johnston,L,ANA,30,28,0,2,2
11,8477034,Jaycob Megna,D,FLA,32,37,0,2,2
11,8479587,Rhett Gardner,C,PHI,28,15,0,2,2
11,8479367,William Lockwood,R,FLA,26,30,0,2,2
11,8481006,Tyler Tucker,D,STL,24,12,0,2,2
11,8478446,Glenn Gawdin,C,LAK,27,15,0,2,2
11,8478874,Adam Gaudette,R,OTT,28,34,0,2,2
11,8481806,Louis Crevier,D,CHI,23,13,0,2,2
11,8482929,Emil Lilleberg,D,TBL,23,19,0,2,2
11,8482088,Justin Sourdif,R,FLA,22,18,0,2,2
11,8477467,Gustav Olofsson,D,SEA,30,15,0,2,2
11,8475795,Dylan McIlrath,D,WSH,32,13,0,2,2
11,8482516,Matthew Kessel,D,STL,24,21,0,2,2
11,8477320,Anton Blidh,L,NYR,29,11,1,0,1
11,8479320,Maxime Lajoie,D,SEA,27,24,1,0,1
11,8480306,Grant Hutton,D,NYI,29,9,1,0,1
11,8479362,Riley Tufte,L,BOS,26,22,1,0,1
11,8483395,Arshdeep Bains,L,VAN,23,12,1,0,1
11,8482162,Roby Jarventie,L,EDM,22,16,1,0,1
11,8482061,Brandon Biro,L,SEA,26,12,1,0,1
11,8481024,Linus Karlsson,C,VAN,25,9,1,0,1
11,8481206,John Ludvig,D,PIT,24,7,1,0,1
11,8475780,Chris Wagner,R,COL,33,11,1,0,1
11,8484325,Waltteri Merela,C,TBL,26,19,1,0,1
11,8479330,Brandon Gignac,C,MTL,27,13,1,0,1
11,8483471,Brad Lambert,C,WPG,31,10,1,0,1
11,8476323,Max McCormick,L,SEA,32,2,1,0,1
11,8475755,Alexander Petrovic,D,DAL,32,10,1,0,1
11,8484321,Nikolas Matinpalo,D,OTT,26,1,1,0,1
11,8474062,Riley Nash,C,NYR,35,16,0,1,1
11,8478854,Ryan Shea,D,PIT,27,6,0,1,1
11,8482094,Daemon Hunt,D,MIN,22,8,0,1,1
11,8484304,Uvis Balinskis,D,FLA,28,6,0,1,1
11,8481541,Samuel Bolduc,D,NYI,24,25,0,1,1
11,8482476,Emil Heineman,L,MTL,23,9,0,1,1
11,8481578,Graeme Clarke,R,MIN,23,12,0,1,1
11,8479419,Brett Murray,L,BUF,26,15,0,1,1
11,8484255,Jason Polin,R,COL,25,9,0,1,1
11,8483432,Luca Del Bel Belluz,C,CBJ,31,5,0,0,0
11,8483489,Fraser Minten,C,TOR,31,14,0,0,0
11,8475413,Justin Dowling,C,NJD,34,9,0,0,0
11,8482197,Adam Raska,R,MIN,23,5,0,0,0
11,8481534,Raphael Lavoie,C,EDM,24,3,0,0,0
11,8480075,Cameron Crotty,D,MIN,25,12,0,0,0
11,8482460,Matt Rempe,C,NYR,22,7,0,0,0
11,8483920,Pierrick Dube,R,WSH,23,4,0,0,0
11,8478881,Brett Seney,L,CHI,28,17,0,0,0
11,8483398,Declan Carlile,D,TBL,31,5,0,0,0
11,8483407,Brandon Scanlin,D,NYR,25,3,0,0,0
11,8481564,Ryan Johnson,D,BUF,23,9,0,0,0
11,8479522,Hardy Haman Aktell,D,WSH,26,2,0,0,0
11,8484326,Patrik Koch,D,UTA,28,3,0,0,0
11,8477541,Dakota Mermis,D,TOR,30,11,0,0,0
11,8483609,Adam Klapka,R,CGY,24,2,0,0,0
11,8478147,Bokondji Imama,L,PIT,28,2,0,0,0
11,8483546,Marshall Rifai,D,TOR,26,4,0,0,0
11,8482787,Nikita Chibrikov,R,WPG,31,11,0,0,0
11,8482126,Emil Andrae,D,PHI,31,1,0,0,0
11,8479421,Jacob Moverare,D,LAK,26,6,0,0,0
11,8483531,Brian Halonen,L,NJD,25,2,0,0,0
11,8470794,Joe Pavelski,C,,40,0,0,0,0
11,8479321,Lucas Johansen,D,,27,0,0,0,0
11,8477950,Tony DeAngelo,D,,29,0,0,0,0
11,8471218,Blake Wheeler,R,,38,0,0,0,0
11,8475197,Tyson Barrie,D,,33,0,0,0,0
11,8474157,Max Pacioretty,L,,36,0,0,0,0
11,8475744,Evgeny Kuznetsov,C,,32,0,0,0,0
11,8474037,James van Riemsdyk,L,,35,0,0,0,0
11,8476907,Mackenzie MacEachern,L,,30,0,0,0,0
11,8480216,Jacob Peterson,C,,25,0,0,0,0
11,8474602,Justin Schultz,D,,34,0,0,0,0
11,8482222,Alexander Barabanov,L,,30,0,0,0,0
11,8474031,Kevin Shattenkirk,D,,35,0,0,0,0
11,8477330,Dominik Kubalik,L,,29,0,0,0,0
11,8480884,Calen Addison,D,,24,0,0,0,0
11,8475906,John Klingberg,D,,32,0,0,0,0
11,8480008,Adam Ruzicka,C,,25,0,0,0,0
11,8476884,Derrick Pouliot,D,,30,0,0,0,0
11,8476919,Chris Tierney,C,,30,0,0,0,0
11,8479415,Michael McLeod,C,,26,0,0,0,0
11,8474870,Tyler Johnson,C,,34,0,0,0,0
11,8470604,Jeff Carter,C,,39,0,0,0,0
11,8478104,Sammy Blais,L,,28,0,0,0,0
11,8474884,Mike Hoffman,C,,35,0,0,0,0
11,8481591,Sam Poulin,R,,23,0,0,0,0
11,8471274,Alex Goligoski,D,,39,0,0,0,0
11,8476871,Tanner Pearson,L,,32,0,0,0,0
11,8476393,Nick Cousins,C,,31,0,0,0,0
11,8479977,Kailer Yamamoto,R,,26,0,0,0,0
11,8479346,Dillon Dube,C,,26,0,0,0,0
11,8480184,Gustav Lindstrom,D,,26,0,0,0,0
11,8479376,Victor Mete,D,,26,0,0,0,0
11,8473449,Kyle Okposo,R,,36,0,0,0,0
11,8481058,Jesse Ylonen,R,,25,0,0,0,0
11,8475752,Tyler Pitlick,C,,33,0,0,0,0
11,8481239,Samuel Fagemo,L,,24,0,0,0,0
11,8480821,Filip Zadina,R,,25,0,0,0,0
11,8470966,Mark Giordano,D,,41,0,0,0,0
11,8478495,Denis Gurianov,R,,27,0,0,0,0
11,8477464,Nic Petan,C,,29,0,0,0,0
11,8478099,Kevin Labanc,R,,29,0,0,0,0
11,8482241,Radim Zohorna,L,,28,0,0,0,0
11,8474040,Sam Gagner,C,,35,0,0,0,0
11,8479514,Rem Pitlick,C,,27,0,0,0,0
11,8478430,Oliver Kylington,D,,27,0,0,0,0
11,8479533,Joona Koppanen,L,,26,0,0,0,0
11,8479984,Cal Foote,D,,26,0,0,0,0
11,8477126,Jayson Megna,C,,34,0,0,0,0
11,8475164,Jakob Silfverberg,R,,34,0,0,0,0
11,8474009,Nick Bonino,C,,36,0,0,0,0
11,8479458,Nikita Zaitsev,D,,33,0,0,0,0
11,8477944,Jakub Vrana,L,,28,0,0,0,0
11,8471699,Andrew Cogliano,C,,37,0,0,0,0
11,8478067,Oskar Lindblom,L,,28,0,0,0,0
11,8471686,Marc Staal,D,,37,0,0,0,0
11,8470610,Zach Parise,L,,40,0,0,0,0
11,8478904,Steven Lorentz,C,,28,0,0,0,0
11,8473473,Milan Lucic,L,,36,0,0,0,0
11,8480031,Maxime Comtois,L,,25,0,0,0,0
11,8478512,Austin Czarnik,C,,32,0,0,0,0
11,8473504,Cal Clutterbuck,R,,37,0,0,0,0
11,8477454,Adam Erne,L,,29,0,0,0,0
11,8479383,Boris Katchouk,L,,26,0,0,0,0
11,8475825,Jani Hakanpää,D,,32,0,0,0,0
11,8477846,Ryan Carpenter,C,,33,0,0,0,0
11,8477930,Pierre-Edouard Bellemare,L,,39,0,0,0,0
11,8478400,Colin White,C,,27,0,0,0,0
11,8480226,Marián Studenic,R,,26,0,0,0,0
11,8480853,Liam Foudy,C,,24,0,0,0,0
11,8475797,Jarred Tinordi,D,,32,0,0,0,0
11,8479423,Alex Nylander,L,,26,0,0,0,0
11,8474618,Marco Scandella,D,,34,0,0,0,0
11,8478028,Fredrik Olofsson,L,,28,0,0,0,0
11,8474709,Matt Martin,L,,35,0,0,0,0
11,8481070,Hugh McGing,L,,26,0,0,0,0
11,8479546,Oskar Steen,C,,26,0,0,0,0
11,8474145,Robert Bortuzzo,D,,35,0,0,0,0
11,8476915,Jujhar Khaira,L,,30,0,0,0,0
11,8480274,Philip Kemp,D,EDM,25,0,0,0,0
11,8475278,Byron Froese,C,,33,0,0,0,0
11,8481812,Nikolai Knyzhov,D,,27,0,0,0,0
11,8478408,Travis Dermott,D,,28,0,0,0,0
11,8481077,John Leonard,L,,26,0,0,0,0
11,8479547,Matthew Phillips,R,,26,0,0,0,0
11,8480836,Jonathan Gruden,C,,24,0,0,0,0
11,8481690,Tyler Angle,C,,24,0,0,0,0
11,8475766,Austin Watson,L,,32,0,0,0,0
11,8481016,Ruslan Iskhakov,C,,24,0,0,0,0
11,8478078,Rourke Chartier,C,,28,0,0,0,0
11,8483401,Marc Johnstone,R,PIT,28,1,0,0,0
11,8480776,Sheldon Rempal,R,,29,0,0,0,0
11,8478956,Samuel Laberge,L,NJD,27,0,0,0,0
11,8483045,Cameron Butler,R,CBJ,31,0,0,0,0
11,8484314,Jiri Smejkal,L,,28,0,0,0,0
12,8477492,Nathan MacKinnon,C,COL,29,80,50,95,145
12,8477956,David Pastrnak,R,BOS,28,79,57,81,138
12,8478420,Mikko Rantanen,R,COL,28,81,53,81,134
12,8481559,Jack Hughes,C,NJD,23,77,51,82,133
12,8478402,Connor McDavid,C,EDM,27,79,36,97,133
12,8476453,Nikita Kucherov,R,TBL,31,82,31,91,122
12,8479318,Auston Matthews,C,TOR,27,81,61,56,117
12,8477934,Leon Draisaitl,C,EDM,29,80,40,71,111
12,8471675,Sidney Crosby,C,PIT,37,79,53,56,109
12,8480012,Elias Pettersson,C,VAN,26,77,41,66,107
12,8476887,Filip Forsberg,L,NSH,30,74,42,62,104
12,8477942,Kevin Fiala,L,LAK,28,80,34,69,103
12,8477939,William Nylander,R,TOR,28,81,39,63,102
12,8479314,Matthew Tkachuk,L,FLA,27,79,33,69,102
12,8480069,Cale Makar,D,COL,26,72,23,78,101
12,8478483,Mitch Marner,R,TOR,27,76,33,67,100
12,8478550,Artemi Panarin,L,NYR,33,77,31,65,96
12,8477501,Valeri Nichushkin,R,COL,29,82,56,39,95
12,8477404,Jake Guentzel,C,TBL,30,80,43,51,94
12,8474564,Steven Stamkos,C,NSH,34,78,40,52,92
12,8480801,Brady Tkachuk,L,OTT,25,81,37,55,92
12,8477493,Aleksander Barkov,C,FLA,29,76,22,70,92
12,8478864,Kirill Kaprizov,L,MIN,27,77,41,50,91
12,8479407,Jesper Bratt,L,NJD,26,77,35,56,91
12,8476468,J.T. Miller,C,VAN,31,74,24,67,91
12,8475166,John Tavares,C,TOR,34,78,37,53,90
12,8482116,Tim Stützle,C,OTT,22,79,31,55,86
12,8476459,Mika Zibanejad,C,NYR,31,77,23,62,85
12,8478427,Sebastian Aho,C,CAR,27,64,36,48,84
12,8476539,Jonathan Marchessault,R,NSH,34,76,45,37,82
12,8478398,Kyle Connor,L,WPG,28,73,40,42,82
12,8478010,Brayden Point,C,TBL,28,82,37,45,82
12,8480830,Andrei Svechnikov,R,CAR,24,74,25,56,81
12,8478445,Mathew Barzal,C,NYI,27,80,23,58,81
12,8482093,Seth Jarvis,C,CAR,22,75,40,40,80
12,8479385,Jordan Kyrou,C,STL,26,78,33,47,80
12,8478460,Zach Werenski,D,CBJ,27,82,19,61,80
12,8482665,Matty Beniers,C,SEA,22,72,28,51,79
12,8475184,Chris Kreider,L,NYR,33,78,43,35,78
12,8484144,Connor Bedard,C,CHI,19,71,36,42,78
12,8477933,Sam Reinhart,C,FLA,29,76,33,44,77
12,8480002,Nico Hischier,C,NJD,25,73,23,54,77
12,8479343,Clayton Keller,R,UTA,26,73,27,49,76
12,8477496,Elias Lindholm,C,BOS,30,76,26,50,76
12,8476454,Ryan Nugent-Hopkins,C,EDM,31,78,24,52,76
12,8480018,Nick Suzuki,C,MTL,25,74,22,53,75
12,8480839,Rasmus Dahlin,D,BUF,24,66,16,59,75
12,8479420,Tage Thompson,C,BUF,27,72,42,32,74
12,8480027,Jason Robertson,L,DAL,25,80,32,42,74
12,8476460,Mark Scheifele,C,WPG,31,69,31,43,74
12,8480208,Drake Batherson,R,OTT,26,81,30,44,74
12,8473419,Brad Marchand,L,BOS,36,79,25,49,74
12,8475786,Zach Hyman,L,EDM,32,79,40,33,73
12,8473512,Claude Giroux,R,OTT,36,79,22,51,73
12,8477409,Carter Verhaeghe,C,FLA,29,80,38,34,72
12,8476906,Shayne Gostisbehere,D,CAR,31,78,20,52,72
12,8480800,Quinn Hughes,D,VAN,25,77,13,59,72
12,8479323,Adam Fox,D,NYR,26,70,10,62,72
12,8477960,Adrian Kempe,R,LAK,28,82,35,36,71
12,8476389,Vincent Trocheck,C,NYR,31,78,30,41,71
12,8477940,Nikolaj Ehlers,L,WPG,28,70,30,41,71
12,8475913,Mark Stone,R,VGK,32,74,20,51,71
12,8477504,Josh Morrissey,D,WPG,29,74,19,52,71
12,8480036,Miro Heiskanen,D,DAL,25,77,16,55,71
12,8481557,Matt Boldy,L,MIN,23,71,26,44,70
12,8475172,Nazem Kadri,C,CGY,34,75,25,45,70
12,8475168,Matt Duchene,C,DAL,33,81,23,47,70
12,8474600,Roman Josi,D,NSH,34,68,17,53,70
12,8479325,Charlie McAvoy,D,BOS,27,79,14,56,70
12,8480865,Noah Dobson,D,NYI,24,80,12,58,70
12,8476346,Johnny Gaudreau,L,CBJ,31,69,22,47,69
12,8477951,Nick Schmaltz,C,UTA,28,77,21,48,69
12,8482097,Jack Quinn,R,BUF,23,69,20,49,69
12,8475784,Jeff Skinner,C,EDM,32,79,36,32,68
12,8475158,Ryan O'Reilly,C,NSH,33,72,33,35,68
12,8477946,Dylan Larkin,C,DET,28,80,34,33,67
12,8478414,Timo Meier,R,NJD,28,72,31,36,67
12,8476881,Tomas Hertl,C,VGK,31,75,26,41,67
12,8477402,Pavel Buchnevich,L,STL,29,72,25,42,67
12,8474141,Patrick Kane,R,DET,36,82,25,42,67
12,8474578,Erik Karlsson,D,PIT,34,79,13,54,67
12,8479675,Trevor Moore,L,LAK,29,79,35,30,65
12,8478444,Brock Boeser,R,VAN,27,77,32,33,65
12,8478401,Pavel Zacha,C,BOS,27,81,29,36,65
12,8477494,Jonathan Drouin,L,COL,29,81,19,46,65
12,8480023,Robert Thomas,C,STL,25,73,18,47,65
12,8479999,Casey Mittelstadt,C,COL,26,81,16,49,65
12,8475692,Mats Zuccarello,R,MIN,37,67,15,50,65
12,8476456,Jonathan Huberdeau,C,CGY,31,77,14,51,65
12,8481540,Cole Caufield,R,MTL,23,76,37,27,64
12,8477955,Jared McCann,L,SEA,28,76,36,28,64
12,8474586,Jordan Eberle,R,SEA,34,71,28,36,64
12,8478439,Travis Konecny,R,PHI,27,76,26,38,64
12,8479542,Brandon Hagel,L,TBL,26,82,31,32,63
12,8477476,Artturi Lehkonen,L,COL,29,82,29,34,63
12,8480039,Martin Necas,C,CAR,25,69,23,40,63
12,8477949,Alex Tuch,R,BUF,28,70,20,43,63
12,8480015,Owen Tippett,R,PHI,25,73,30,32,62
12,8474102,David Perron,L,OTT,36,75,25,37,62
12,8477416,Oliver Bjorkstrand,R,SEA,29,69,24,38,62
12,8480803,Evan Bouchard,D,EDM,25,75,20,42,62
12,8478407,Vince Dunn,D,SEA,28,73,12,50,62
12,8475768,Jaden Schwartz,C,SEA,32,73,32,29,61
12,8482740,Wyatt Johnston,C,DAL,21,80,29,32,61
12,8478449,Roope Hintz,C,DAL,28,82,37,23,60
12,8480014,Gabriel Vilardi,C,WPG,25,67,35,25,60
12,8477935,Sam Bennett,C,FLA,28,77,34,26,60
12,8478403,Jack Eichel,C,VGK,28,75,28,32,60
12,8482078,Lucas Raymond,L,DET,22,79,24,36,60
12,8478038,Devon Toews,D,COL,30,75,16,44,60
12,8477500,Bo Horvat,C,NYI,29,82,34,25,59
12,8478466,Daniel Sprong,R,VAN,27,71,26,33,59
12,8476479,Phillip Danault,C,LAK,31,80,25,34,59
12,8481528,Dylan Cozens,C,BUF,23,74,22,37,59
12,8475167,Victor Hedman,D,TBL,34,80,11,48,59
12,8482684,Luke Hughes,D,NJD,21,76,11,48,59
12,8476399,Blake Coleman,C,CGY,33,76,32,26,58
12,8475765,Vladimir Tarasenko,R,DET,33,78,26,32,58
12,8478493,Joel Eriksson Ek,C,MIN,27,69,25,33,58
12,8476905,Chandler Stephenson,C,SEA,30,75,22,36,58
12,8475191,Reilly Smith,R,NYR,33,73,20,38,58
12,8471215,Evgeni Malkin,C,PIT,38,70,19,39,58
12,8482124,Quinton Byfield,R,LAK,22,81,18,40,58
12,8477407,Anthony Duclair,L,NYI,29,78,27,30,57
12,8475810,Bryan Rust,R,PIT,32,71,26,31,57
12,8477497,Sean Monahan,C,CBJ,30,63,23,34,57
12,8479425,Filip Hronek,D,VAN,27,75,15,42,57
12,8477346,MacKenzie Weegar,D,CGY,30,76,9,48,57
12,8481068,Yegor Sharangovich,C,CGY,26,75,30,26,56
12,8478440,Dylan Strome,C,WSH,27,76,21,35,56
12,8478438,Tommy Novak,C,NSH,27,74,15,41,56
12,8471685,Anze Kopitar,C,LAK,37,78,14,42,56
12,8476853,Morgan Rielly,D,TOR,30,69,11,45,56
12,8474563,Drew Doughty,D,LAK,35,71,10,46,56
12,8475754,Brock Nelson,C,NYI,33,82,30,25,55
12,8473994,Jamie Benn,L,DAL,35,82,20,35,55
12,8478366,Frank Vatrano,R,ANA,30,74,29,25,54
12,8482159,Tyson Foerster,R,PHI,22,80,22,32,54
12,8477986,Brandon Montour,D,SEA,30,74,15,39,54
12,8478397,Rasmus Andersson,D,CGY,28,69,14,40,54
12,8478519,Anthony Cirelli,C,TBL,27,82,25,28,53
12,8482699,Dylan Guenther,R,UTA,21,78,21,32,53
12,8484145,Zach Benson,L,BUF,19,73,25,27,52
12,8475169,Evander Kane,L,EDM,33,76,22,30,52
12,8477964,Ivan Barbashev,C,VGK,29,78,21,31,52
12,8479400,Pierre-Luc Dubois,L,WSH,26,69,17,35,52
12,8475753,Justin Faulk,D,STL,32,71,17,35,52
12,8475745,Charlie Coyle,C,BOS,32,79,16,36,52
12,8471214,Alex Ovechkin,L,WSH,39,70,32,19,51
12,8475726,Tyler Toffoli,C,SJS,32,66,28,23,51
12,8479987,Morgan Geekie,C,BOS,26,80,26,25,51
12,8480028,Morgan Frost,C,PHI,25,73,22,29,51
12,8479337,Alex DeBrincat,R,DET,27,79,17,34,51
12,8477021,Alex Kerfoot,C,UTA,30,76,16,35,51
12,8477932,Aaron Ekblad,D,FLA,28,74,16,35,51
12,8483808,Andrei Kuzmenko,L,CGY,28,80,14,37,51
12,8481542,Moritz Seider,D,DET,23,79,10,41,51
12,8476882,Teuvo Teravainen,C,CHI,30,70,19,31,50
12,8483431,Logan Cooley,C,UTA,20,74,19,31,50
12,8482113,Anton Lundell,C,FLA,23,76,26,23,49
12,8478498,Jake DeBrusk,L,VAN,28,72,23,26,49
12,8482720,Matthew Knies,L,TOR,22,76,21,28,49
12,8482110,Dawson Mercer,C,NJD,23,65,16,33,49
12,8481711,Matias Maccelli,L,UTA,24,74,14,35,49
12,8474679,Gustav Nyquist,C,NSH,35,65,13,36,49
12,8476448,William Karlsson,C,VGK,31,79,22,26,48
12,8474150,Mikael Backlund,C,CGY,35,75,22,26,48
12,8478458,John (Jack) Roslovic,C,CAR,27,65,21,27,48
12,8484166,Adam Fantilli,C,CBJ,20,75,21,27,48
12,8477511,Anthony Mantha,R,CGY,30,75,20,28,48
12,8475794,Tyler Seguin,C,DAL,32,81,16,32,48
12,8479345,Jakob Chychrun,D,WSH,26,63,15,33,48
12,8478856,Conor Garland,R,VAN,28,75,19,28,47
12,8476880,Tom Wilson,R,WSH,30,75,19,28,47
12,8478042,Viktor Arvidsson,L,EDM,31,79,19,28,47
12,8476826,Yanni Gourde,C,SEA,33,68,14,33,47
12,8478396,Noah Hanifin,D,VGK,27,64,11,36,47
12,8480064,Josh Norris,C,OTT,25,77,28,18,46
12,8476483,Rickard Rakell,R,PIT,31,71,26,20,46
12,8478109,Victor Olofsson,L,VGK,29,75,29,16,45
12,8482109,Alexis Lafrenière,L,NYR,23,68,28,17,45
12,8480188,Fabian Zetterlund,L,SJS,25,66,24,21,45
12,8481618,Alex Newhook,C,MTL,23,76,22,23,45
12,8482745,Mason McTavish,C,ANA,21,71,21,24,45
12,8478975,Mason Marchment,L,DAL,29,81,19,26,45
12,8480185,Eetu Luostarinen,C,FLA,26,75,17,28,45
12,8478873,Troy Terry,R,ANA,27,72,13,32,45
12,8471724,Kris Letang,D,PIT,37,80,5,40,45
12,8478474,Lawson Crouse,L,UTA,27,77,29,15,44
12,8476432,Boone Jenner,C,CBJ,31,73,24,20,44
12,8478057,Dakota Joshua,C,VAN,28,65,24,20,44
12,8478047,Michael Bunting,L,PIT,29,69,20,24,44
12,8483515,Juraj Slafkovsky,L,MTL,20,76,18,26,44
12,8481533,Trevor Zegras,C,ANA,23,67,16,28,44
12,8476792,Torey Krug,D,STL,33,75,16,28,44
12,8476854,Hampus Lindholm,D,BOS,30,71,14,30,44
12,8481577,Philip Tomasino,C,NSH,23,64,14,30,44
12,8476958,Jaccob Slavin,D,CAR,30,77,11,33,44
12,8476875,Mike Matheson,D,MTL,30,70,8,36,44
12,8482122,Brock Faber,D,MIN,22,78,8,36,44
12,8475848,Brendan Gallagher,R,MTL,32,66,20,23,43
12,8482667,William Eklund,L,SJS,22,69,19,24,43
12,8476419,Jean-Gabriel Pageau,C,NYI,32,76,17,26,43
12,8480009,Eeli Tolvanen,R,SEA,25,68,16,27,43
12,8476462,Dougie Hamilton,D,NJD,31,66,14,29,43
12,8470613,Brent Burns,D,CAR,39,77,10,33,43
12,8481596,Shane Pinto,C,OTT,24,78,23,19,42
12,8477987,Ryan Donato,C,CHI,28,63,23,19,42
12,8478115,Pierre Engvall,L,NYI,28,82,19,23,42
12,8479365,Trent Frederic,C,BOS,26,79,18,24,42
12,8478542,Evan Rodrigues,C,FLA,31,75,17,25,42
12,8477447,Shea Theodore,D,VGK,29,65,12,30,42
12,8481703,Valtteri Puustinen,R,PIT,25,62,11,31,42
12,8478055,Gustav Forsling,D,FLA,28,72,10,32,42
12,8477503,Max Domi,C,TOR,29,78,9,33,42
12,8476885,Jacob Trouba,D,NYR,30,70,8,34,42
12,8475798,Mikael Granlund,C,SJS,32,62,5,37,42
12,8477456,J.T. Compher,L,DET,29,79,24,17,41
12,8475760,Nick Bjugstad,C,UTA,32,69,23,18,41
12,8481554,Kaapo Kakko,R,NYR,23,67,22,19,41
12,8477479,Tyler Bertuzzi,L,CHI,29,65,17,24,41
12,8475287,Erik Haula,L,NJD,33,67,15,26,41
12,8482133,Thomas Bordeleau,C,SJS,22,66,14,27,41
12,8481186,Logan O'Connor,R,COL,28,80,12,29,41
12,8478469,Thomas Chabot,D,OTT,27,74,10,31,41
12,8482660,Kent Johnson,C,CBJ,22,65,10,31,41
12,8476869,Brady Skjei,D,NSH,30,72,8,33,41
12,8481581,Thomas Harley,D,DAL,23,77,7,34,41
12,8475722,Jason Zucker,L,BUF,32,63,24,16,40
12,8480893,Kirill Marchenko,R,CBJ,24,64,24,16,40
12,8475151,Kyle Palmieri,C,NYI,33,78,18,22,40
12,8476872,Scott Laughton,C,PHI,30,77,18,22,40
12,8484153,Leo Carlsson,C,ANA,20,68,16,24,40
12,8479339,Patrik Laine,L,CBJ,26,67,15,25,40
12,8474641,Adam Henrique,C,EDM,34,75,14,26,40
12,8476292,Ondrej Palat,L,NJD,33,68,13,27,40
12,8474590,John Carlson,D,WSH,34,68,10,30,40
12,8474565,Alex Pietrangelo,D,VGK,34,70,8,32,40
12,8480798,Philipp Kurashev,C,CHI,25,63,7,33,40
12,8479410,Mikhail Sergachev,D,UTA,26,67,4,36,40
12,8477451,Ryan Hartman,R,MIN,30,64,21,18,39
12,8480829,Jesperi Kotkaniemi,C,CAR,24,64,21,18,39
12,8481560,Arthur Kaliyev,R,LAK,23,81,20,19,39
12,8475314,Anders Lee,L,NYI,34,78,18,21,39
12,8475791,Taylor Hall,L,CHI,33,53,17,22,39
12,8482092,Ridly Greig,C,OTT,22,77,15,24,39
12,8473986,Alex Killorn,L,ANA,35,75,13,26,39
12,8476925,Colton Sissons,C,NSH,31,66,13,26,39
12,8477495,Seth Jones,D,CHI,30,67,9,30,39
12,8477952,Robby Fabbri,C,ANA,28,67,20,18,38
12,8480855,Jack McBain,C,UTA,24,73,18,20,38
12,8477998,Warren Foegele,L,LAK,28,80,16,22,38
12,8481604,Pavel Dorofeyev,L,VGK,24,68,14,24,38
12,8477425,Miles Wood,L,COL,29,75,22,15,37
12,8481580,Connor McMichael,C,WSH,23,64,20,17,37
12,8479525,Ross Colton,C,COL,28,82,18,19,37
12,8482089,Jake Neighbours,L,STL,22,69,18,19,37
12,8482175,JJ Peterka,R,BUF,22,71,18,19,37
12,8480797,Joel Farabee,L,PHI,24,71,15,22,37
12,8477444,Andre Burakovsky,L,SEA,29,74,13,24,37
12,8475170,Brayden Schenn,C,STL,33,77,12,25,37
12,8474716,Jared Spurgeon,D,MIN,35,74,12,25,37
12,8482149,Cole Perfetti,C,WPG,22,64,11,26,37
12,8475171,Oliver Ekman-Larsson,D,TOR,33,68,8,29,37
12,8480145,Neal Pionk,D,WPG,29,75,6,31,37
12,8478472,Mathieu Joseph,R,STL,27,70,12,24,36
12,8480871,Adam Boqvist,D,FLA,24,66,11,25,36
12,8477426,Nicholas Paul,L,TBL,29,80,20,15,35
12,8478891,Mason Appleton,C,WPG,28,65,16,19,35
12,8482702,Logan Stankoven,C,DAL,21,81,15,20,35
12,8478463,Anthony Beauvillier,L,PIT,27,70,15,20,35
12,8477429,Andrew Copp,C,DET,30,72,10,25,35
12,8477498,Darnell Nurse,D,EDM,29,75,9,26,35
12,8482671,Owen Power,D,BUF,22,70,7,28,35
12,8474189,Lars Eller,C,PIT,35,62,21,13,34
12,8475793,Ryan Johansen,C,PHI,32,74,16,18,34
12,8478046,Danton Heinen,L,VAN,29,66,14,20,34
12,8475149,Marcus Johansson,L,MIN,34,65,13,21,34
12,8476458,Ryan Strome,C,ANA,31,66,12,22,34
12,8482105,Jake Sanderson,D,OTT,22,76,8,26,34
12,8482712,Oskar Olausson,R,COL,22,77,6,28,34
12,8475181,Nick Leddy,D,STL,33,73,5,29,34
12,8482157,Will Cuylle,L,NYR,22,65,18,15,33
12,8474149,Evgenii Dadonov,R,DAL,35,82,17,16,33
12,8478233,Andrew Mangiapane,L,WSH,28,68,15,18,33
12,8476981,Josh Anderson,R,MTL,30,73,15,18,33
12,8482055,Drew O'Connor,L,PIT,26,68,14,19,33
12,8475714,Calle Jarnkrok,C,TOR,33,76,13,20,33
12,8480205,Emil Bemstrom,C,PIT,25,61,12,21,33
12,8476463,Jonas Brodin,D,MIN,31,80,10,23,33
12,8477948,Travis Sanheim,D,PHI,28,70,7,26,33
12,8480434,Sean Durzi,D,UTA,26,68,4,29,33
12,8475799,Nino Niederreiter,R,WPG,32,69,19,13,32
12,8470621,Corey Perry,R,EDM,39,69,18,14,32
12,8479390,Taylor Raddysh,R,WSH,26,67,17,15,32
12,8478413,Jordan Greenway,L,BUF,27,71,17,15,32
12,8480849,Barrett Hayton,C,UTA,24,74,16,16,32
12,8479992,Michael Rasmussen,C,DET,25,72,14,18,32
12,8478462,Nicolas Roy,C,VGK,27,77,12,20,32
12,8479353,Brett Howden,C,VGK,26,72,12,20,32
12,8481524,Bowen Byram,D,BUF,23,64,12,20,32
12,8479976,Juuso Valimaki,D,UTA,26,70,7,25,32
12,8482475,Yegor Chinakhov,R,CBJ,23,61,14,17,31
12,8477989,Christian Dvorak,C,MTL,28,68,11,20,31
12,8480113,Alex Iafallo,L,WPG,31,65,9,22,31
12,8479996,Cody Glass,C,NSH,25,57,9,22,31
12,8480043,Timothy Liljegren,D,TOR,25,74,5,26,31
12,8473533,Jordan Staal,C,CAR,36,66,19,11,30
12,8482705,Cole Sillinger,C,CBJ,21,71,15,15,30
12,8482146,Luke Evangelista,R,NSH,22,65,15,15,30
12,8471698,T.J. Oshie,R,WSH,38,69,13,17,30
12,8483505,Matthew Poitras,C,BOS,20,73,12,18,30
12,8482624,Daniil Miromanov,D,CGY,27,67,11,19,30
12,8480336,Sean Walker,D,CAR,30,64,7,23,30
12,8482655,Janis Moser,D,TBL,24,78,7,23,30
12,8475764,Cam Fowler,D,ANA,33,77,5,25,30
12,8476923,Damon Severson,D,CBJ,30,77,5,25,30
12,8477969,Marcus Pettersson,D,PIT,28,76,4,26,30
12,8476438,Brandon Saad,L,STL,32,64,19,10,29
12,8476897,Oskar Sundqvist,C,STL,30,63,13,16,29
12,8482749,Joshua Roy,R,MTL,21,71,11,18,29
12,8475763,Kevin Hayes,R,PIT,32,64,10,19,29
12,8477220,Nate Schmidt,D,FLA,33,68,4,25,29
12,8475200,Dmitry Orlov,D,CAR,33,76,3,26,29
12,8476278,Colin Blackwell,C,DAL,31,78,15,13,28
12,8476918,Jimmy Vesey,L,NYR,31,68,14,14,28
12,8477505,Alexander Wennberg,C,SJS,30,63,14,14,28
12,8476878,Zemgus Girgensons,C,TBL,30,82,14,14,28
12,8479293,Brandon Tanev,L,SEA,33,64,12,16,28
12,8480144,David Kampf,C,TOR,29,69,12,16,28
12,8475218,Mattias Ekholm,D,EDM,34,76,11,17,28
12,8480078,Filip Chytil,C,NYR,25,67,9,19,28
12,8480003,Jesper Boqvist,C,FLA,26,71,9,19,28
12,8479591,Michael Eyssimont,C,TBL,28,80,8,20,28
12,8480873,Rasmus Sandin,D,WSH,24,60,5,23,28
12,8481481,Blake Lizotte,C,PIT,27,60,20,7,27
12,8476474,Stefan Noesen,R,NJD,31,70,15,12,27
12,8479351,Sam Steel,C,DAL,26,80,14,13,27
12,8475193,Tomas Tatar,L,NJD,34,67,13,14,27
12,8481535,Nils Hoglander,L,VAN,24,66,12,15,27
12,8474053,Logan Couture,C,SJS,35,61,9,18,27
12,8483468,Jiri Kulich,C,BUF,20,65,9,18,27
12,8479661,Tanner Jeannot,L,LAK,27,72,8,19,27
12,8480835,Jack Drury,C,CAR,24,56,8,19,27
12,8481606,Jordan Spence,D,LAK,23,64,4,23,27
12,8477953,Kasperi Kapanen,R,STL,28,63,12,14,26
12,8481601,Simon Holmstrom,R,NYI,23,66,11,15,26
12,8476461,Sean Couturier,C,PHI,32,71,10,16,26
12,8480762,Eric Robinson,L,CAR,29,56,10,16,26
12,8476960,Andreas Athanasiou,C,CHI,30,43,9,17,26
12,8480789,Oliver Wahlstrom,R,NYI,24,73,9,17,26
12,8478133,Jake Evans,C,MTL,28,71,8,18,26
12,8482101,Danil Gushchin,L,SJS,22,56,8,18,26
12,8478911,Matt Roy,D,WSH,29,59,7,19,26
12,8481656,Aliaksei Protas,C,WSH,23,67,3,23,26
12,8479402,Jake Bean,D,CGY,26,62,3,23,26
12,8479369,Andrew Peeke,D,BOS,26,63,3,23,26
12,8482259,Bobby McMann,C,TOR,28,60,18,7,25
12,8481032,Paul Cotter,C,NJD,25,64,16,9,25
12,8482074,Connor Zary,C,CGY,23,66,14,11,25
12,8476392,Adam Lowry,C,WPG,31,66,13,12,25
12,8474715,Cameron Atkinson,R,TBL,35,80,13,12,25
12,8481624,Ilya Mikheyev,R,CHI,30,61,10,15,25
12,8473422,Nick Foligno,L,CHI,37,62,9,16,25
12,8477947,Sonny Milano,L,WSH,28,69,9,16,25
12,8476921,Jordan Martinook,L,CAR,32,62,8,17,25
12,8473507,Jeff Petry,D,DET,37,71,6,19,25
12,8479371,Dante Fabbro,D,NSH,26,64,4,21,25
12,8480891,Michael Kesselring,D,UTA,24,63,3,22,25
12,8479983,Mario Ferraro,D,SJS,26,69,3,22,25
12,8477506,Ryan Pulock,D,NYI,30,77,2,23,25
12,8479941,Justin Danforth,R,CBJ,31,58,15,9,24
12,8477450,Jason Dickinson,C,CHI,29,57,14,10,24
12,8482125,Alexander Holtz,R,VGK,22,70,14,10,24
12,8480802,Ryan McLeod,C,BUF,25,65,12,12,24
12,8484203,Bradly Nadeau,L,CAR,19,58,11,13,24
12,8476480,Vladislav Namestnikov,C,WPG,32,67,9,15,24
12,8479998,Mikey Anderson,D,LAK,25,68,8,16,24
12,8477507,Nikita Zadorov,D,BOS,29,74,6,18,24
12,8478178,Darren Raddysh,D,TBL,28,68,6,18,24
12,8476892,Colton Parayko,D,STL,31,63,5,19,24
12,8478500,Ivan Provorov,D,CBJ,27,78,5,19,24
12,8476312,Josh Manson,D,COL,33,62,5,19,24
12,8480995,Pontus Holmberg,R,TOR,25,60,14,9,23
12,8482079,Marco Rossi,C,MIN,23,56,12,11,23
12,8480980,Connor Dewar,C,TOR,25,71,10,13,23
12,8476927,Teddy Blueger,C,VAN,30,65,9,14,23
12,8480817,K'Andre Miller,D,NYR,24,68,8,15,23
12,8482111,Justin Barron,D,MTL,23,68,7,16,23
12,8480246,Nick Perbix,D,TBL,26,73,6,17,23
12,8476979,Erik Gustafsson,D,DET,32,72,5,18,23
12,8476879,Cody Ceci,D,EDM,31,67,5,18,23
12,8476902,Esa Lindell,D,DAL,30,71,2,21,23
12,8474151,Ryan McDonagh,D,TBL,35,80,1,22,23
12,8481582,Nicholas Robertson,L,TOR,23,63,12,10,22
12,8475855,Jesper Fast,R,CAR,33,63,11,11,22
12,8475343,Nic Dowd,C,WSH,34,59,11,11,22
12,8480074,Alexandre Texier,C,STL,25,60,11,11,22
12,8473563,Nicklas Backstrom,C,WSH,37,56,9,13,22
12,8482117,Lukas Reichel,L,CHI,22,61,9,13,22
12,8480068,Ryan Poehling,C,PHI,25,72,8,14,22
12,8483445,Cutter Gauthier,L,ANA,20,65,8,14,22
12,8481441,Joe Snively,C,DET,28,66,7,15,22
12,8476422,Mike Reilly,D,NYI,31,74,6,16,22
12,8477392,Hudson Fasching,R,NYI,29,62,6,16,22
12,8481523,Kirby Dach,C,MTL,23,65,4,18,22
12,8481546,Cam York,D,PHI,23,75,4,18,22
12,8481527,Kaedan Korczak,D,VGK,23,50,3,19,22
12,8474574,Tyler Myers,D,VAN,34,70,2,20,22
12,8475279,Ben Chiarot,D,DET,33,75,1,21,22
12,8477435,Ryan Graves,D,PIT,29,74,1,21,22
12,8481477,Nico Sturm,C,SJS,29,54,12,9,21
12,8479439,Jacob MacDonald,D,COL,31,56,12,9,21
12,8479393,Noah Gregor,L,OTT,26,69,8,13,21
12,8478507,John Marino,D,UTA,27,57,6,15,21
12,8478882,Vladislav Gavrikov,D,LAK,29,69,6,15,21
12,8483490,Pavel Mintyukov,D,ANA,21,67,5,16,21
12,8483499,Liam Ohgren,L,MIN,20,55,5,16,21
12,8480222,Sebastian Aho,D,PIT,28,72,5,16,21
12,8479982,Conor Timmins,D,TOR,26,62,4,17,21
12,8482192,Isaak Phillips,D,CHI,23,57,4,17,21
12,8470600,Ryan Suter,D,STL,39,58,4,17,21
12,8476525,Colin Miller,D,WPG,32,65,3,18,21
12,8475790,Erik Gudbranson,D,CBJ,32,75,3,18,21
12,8478840,Will Borgen,D,SEA,28,66,1,20,21
12,8478508,Yakov Trenin,C,MIN,27,58,14,6,20
12,8483524,Shane Wright,C,SEA,20,56,12,8,20
12,8476889,Radek Faksa,C,STL,30,64,11,9,20
12,8479619,Michael Carcone,L,UTA,28,59,11,9,20
12,8477446,Michael McCarron,R,NSH,29,60,10,10,20
12,8477919,Frederick Gaudreau,C,MIN,31,63,9,11,20
12,8480073,Erik Brannstrom,D,COL,25,57,9,11,20
12,8480748,Kiefer Sherwood,L,VAN,29,58,9,11,20
12,8480459,Pius Suter,C,VAN,28,72,8,12,20
12,8480025,MacKenzie Entwistle,R,FLA,25,58,6,14,20
12,8477488,Brett Pesce,D,NJD,30,70,5,15,20
12,8475188,Brayden McNabb,D,VGK,33,52,5,15,20
12,8479324,Ryan Lindgren,D,NYR,26,61,3,17,20
12,8481568,Alex Vlasic,D,CHI,23,61,1,19,20
12,8476331,Dylan DeMelo,D,WPG,31,67,0,20,20
12,8476469,Joel Armia,R,MTL,31,66,9,10,19
12,8477903,Garnet Hathaway,R,PHI,33,59,8,11,19
12,8479718,Alex Barré-Boulet,C,MTL,27,46,8,11,19
12,8476624,Barclay Goodrow,C,SJS,31,59,8,11,19
12,8481093,Rafael Harvey-Pinard,L,MTL,25,55,7,12,19
12,8482067,Connor Mackey,D,NYR,28,69,5,14,19
12,8478013,Jake Walman,D,SJS,28,71,4,15,19
12,8476967,Brett Kulak,D,EDM,30,66,4,15,19
12,8481178,Egor Zamula,D,PHI,24,61,3,16,19
12,8483565,Nick Blankenburg,D,NSH,26,62,3,16,19
12,8479398,Samuel Girard,D,COL,26,61,2,17,19
12,8478970,Jalen Chatfield,D,CAR,28,73,2,17,19
12,8480021,Jack Studnicka,C,LAK,25,65,12,6,18
12,8478569,Noel Acciari,C,PIT,33,48,11,7,18
12,8481704,Juuso Parssinen,C,NSH,23,62,9,9,18
12,8483457,Lane Hutson,D,MTL,20,62,9,9,18
12,8477380,Jonny Brodzinski,C,NYR,31,44,9,9,18
12,8475225,Craig Smith,C,CHI,35,54,9,9,18
12,8478452,Caleb Jones,D,LAK,27,60,9,9,18
12,8480813,Joe Veleno,C,DET,24,77,8,10,18
12,8482737,Zack Bolduc,C,STL,21,61,8,10,18
12,8477478,William Carrier,L,CAR,30,62,8,10,18
12,8479315,Joey Anderson,R,CHI,26,40,8,10,18
12,8482155,Alex Laferriere,R,LAK,23,64,8,10,18
12,8475220,Marcus Foligno,L,MIN,33,54,7,11,18
12,8479980,Nicolas Hague,D,VGK,26,51,7,11,18
12,8480220,Noah Cates,L,PHI,25,67,5,13,18
12,8480448,Parker Kelly,L,COL,25,79,5,13,18
12,8482073,Braden Schneider,D,NYR,23,62,4,14,18
12,8484149,Gavin Brindley,C,CBJ,20,44,4,14,18
12,8477839,Conor Sheary,L,TBL,32,81,3,15,18
12,8477499,Rasmus Ristolainen,D,PHI,30,65,3,15,18
12,8480035,Henri Jokiharju,D,BUF,25,62,3,15,18
12,8474673,TJ Brodie,D,CHI,34,54,2,16,18
12,8474567,Zach Bogosian,D,MIN,34,63,1,17,18
12,8478020,Michael Amadio,R,OTT,28,66,11,6,17
12,8477353,Tyler Motte,C,DET,29,78,9,8,17
12,8482679,Matt Coronato,R,CGY,22,63,8,9,17
12,8479344,Jesse Puljujarvi,R,PIT,26,53,8,9,17
12,8475842,Sam Carrick,C,NYR,32,60,8,9,17
12,8479066,Ryan Lomberg,L,CGY,30,59,8,9,17
12,8481553,Bobby Brink,R,PHI,23,62,7,10,17
12,8477508,Curtis Lazar,C,NJD,29,59,7,10,17
12,8480192,Johnathan Kovacevic,D,NJD,27,54,6,11,17
12,8479639,Dylan Coghlan,D,WPG,26,63,5,12,17
12,8478136,Jake Middleton,D,MIN,28,73,5,12,17
12,8476891,Matthew Grzelcyk,D,PIT,30,75,4,13,17
12,8482087,Kaiden Guhle,D,MTL,22,66,4,13,17
12,8476467,Jamie Oleksiak,D,SEA,32,67,3,14,17
12,8481708,Zac Jones,D,NYR,24,51,3,14,17
12,8471709,Marc-Edouard Vlasic,D,SJS,37,66,3,14,17
12,8474166,Alec Martinez,D,CHI,37,51,3,14,17
12,8481522,Peyton Krebs,C,BUF,23,57,2,15,17
12,8476822,Luke Glendening,C,TBL,35,80,10,6,16
12,8479414,Nathan Bastian,R,NJD,27,59,9,7,16
12,8479370,Tyson Jost,C,CAR,26,47,8,8,16
12,8480806,Isac Lundestrom,C,ANA,25,63,8,8,16
12,8479368,Max Jones,L,BOS,26,62,6,10,16
12,8478443,Brandon Carlo,D,BOS,28,55,6,10,16
12,8482784,Zach Dean,C,STL,21,38,6,10,16
12,8482859,Zack Ostapchuk,C,OTT,21,54,5,11,16
12,8476442,Matt Nieto,L,PIT,32,50,5,11,16
12,8480058,Pierre-Olivier Joseph,D,STL,25,51,4,12,16
12,8476917,Adam Pelech,D,NYI,30,74,3,13,16
12,8481014,Alexander Romanov,D,NYI,24,73,3,13,16
12,8477845,Trevor van Riemsdyk,D,WSH,33,68,3,13,16
12,8482245,Artem Zub,D,OTT,29,59,2,14,16
12,8475324,Nick Jensen,D,OTT,34,65,2,14,16
12,8480887,Jordan Harris,D,MTL,24,54,2,14,16
12,8480001,Urho Vaakanainen,D,ANA,25,61,2,14,16
12,8479638,Justin Brazeau,R,BOS,26,45,11,4,15
12,8476374,Sean Kuraly,C,CBJ,31,58,10,5,15
12,8482148,Hendrix Lapierre,C,WSH,22,42,9,6,15
12,8480355,Mark Kastelic,C,BOS,25,68,9,6,15
12,8479316,Luke Kunin,C,SJS,27,55,8,7,15
12,8483493,Frank Nazar,C,CHI,20,45,8,7,15
12,8481013,Jonatan Berggren,R,DET,24,65,8,7,15
12,8481521,Ronnie Attard,D,PHI,25,43,7,8,15
12,8477015,Connor Brown,R,EDM,30,57,7,8,15
12,8474034,Patrick Maroon,L,CHI,36,52,6,9,15
12,8482634,Alex Steeves,C,TOR,25,52,6,9,15
12,8483482,Tristan Luneau,D,ANA,20,59,5,10,15
12,8477979,Nicolas Aube-Kubel,R,BUF,28,51,4,11,15
12,8483460,David Jiricek,D,CBJ,21,52,4,11,15
12,8480860,Kevin Bahl,D,CGY,24,58,3,12,15
12,8482733,Logan Mailloux,D,MTL,31,40,3,12,15
12,8480049,Dylan Samberg,D,WPG,25,59,2,13,15
12,8481059,Scott Perunovich,D,STL,26,55,2,13,15
12,8479026,Philippe Myers,D,TOR,27,58,2,13,15
12,8476988,Matt Benning,D,SJS,30,64,1,14,15
12,8479336,Carl Grundstrom,R,SJS,27,55,11,3,14
12,8481518,Nolan Foote,L,NJD,24,44,9,5,14
12,8480157,Calle Rosen,D,COL,30,49,8,6,14
12,8473453,Trevor Lewis,C,LAK,37,70,7,7,14
12,8477406,Mattias Janmark,C,EDM,32,66,7,7,14
12,8482730,Brandt Clarke,D,LAK,21,52,7,7,14
12,8482803,Olen Zellweger,D,ANA,21,66,6,8,14
12,8476856,Mathew Dumba,D,DAL,30,71,6,8,14
12,8479543,Michael Pezzetta,L,MTL,26,55,6,8,14
12,8480880,Jakub Lauko,C,MIN,24,42,6,8,14
12,8480441,Trey Fix-Wolansky,R,CBJ,25,42,6,8,14
12,8479328,Julien Gauthier,R,NYI,27,57,6,8,14
12,8481537,Nikita Okhotiuk,D,CGY,24,55,5,9,14
12,8478432,Christian Fischer,R,DET,27,77,5,9,14
12,8481028,Martin Pospisil,C,CGY,25,57,5,9,14
12,8482807,Ethan Del Mastro,D,CHI,21,51,5,9,14
12,8480252,Cole Guttman,C,CHI,25,40,5,9,14
12,8478416,Erik Cernak,D,TBL,27,72,5,9,14
12,8475231,Casey Cizikas,C,NYI,33,71,4,10,14
12,8476429,Scott Mayfield,D,NYI,32,72,4,10,14
12,8480727,Zach Whitecloud,D,VGK,28,48,4,10,14
12,8478399,Jonas Siegenthaler,D,NJD,27,59,3,11,14
12,8478851,Alexandre Carrier,D,NSH,28,66,3,11,14
12,8480807,Mattias Samuelsson,D,BUF,24,51,3,11,14
12,8480879,Jacob Bernard-Docker,D,OTT,24,55,3,11,14
12,8475233,David Savard,D,MTL,34,65,2,12,14
12,8475179,Dmitry Kulikov,D,FLA,34,64,0,14,14
12,8478434,Keegan Kolesar,R,VGK,27,65,8,5,13
12,8480281,Alexey Toropchenko,R,STL,25,57,8,5,13
12,8482062,Cole Smith,L,NSH,29,51,7,6,13
12,8480289,Morgan Barron,C,WPG,26,52,6,7,13
12,8479972,Mason Shaw,C,WPG,26,37,6,7,13
12,8482142,Jamie Drysdale,D,PHI,22,65,5,8,13
12,8479359,Beck Malenstyn,L,BUF,26,50,5,8,13
12,8483495,Simon Nemec,D,NJD,20,57,5,8,13
12,8481019,David Gustafsson,C,WPG,24,50,4,9,13
12,8481599,Victor Soderstrom,D,UTA,23,51,4,9,13
12,8483491,Ivan Miroshnichenko,L,WSH,20,54,3,10,13
12,8477034,Jaycob Megna,D,FLA,32,51,3,10,13
12,8480878,Nils Lundkvist,D,DAL,24,69,2,11,13
12,8475718,Justin Holl,D,DET,32,57,2,11,13
12,8474090,Brendan Smith,D,DAL,35,58,0,13,13
12,8482659,Josh Doan,R,UTA,22,42,10,2,12
12,8479520,Brandon Duhaime,R,WSH,27,47,8,4,12
12,8481641,Joel Kiviranta,L,COL,28,68,7,5,12
12,8478043,Sam Lafferty,C,BUF,29,57,6,6,12
12,8482496,Nils Aman,C,VAN,24,32,6,6,12
12,8476913,Devin Shore,C,MIN,30,34,6,6,12
12,8476873,Mark Jankowski,C,NSH,30,56,5,7,12
12,8476994,Vinnie Hinostroza,C,NSH,30,46,5,7,12
12,8477369,Carson Soucy,D,VAN,30,64,4,8,12
12,8481567,Henry Thrun,D,SJS,23,49,4,8,12
12,8478859,Niko Mikkola,D,FLA,28,55,4,8,12
12,8481617,Vasily Podkolzin,R,VAN,23,50,4,8,12
12,8476934,Brock McGinn,L,ANA,30,57,4,8,12
12,8475455,Brenden Dillon,D,NJD,34,52,3,9,12
12,8475208,Brian Dumoulin,D,ANA,33,64,3,9,12
12,8475462,Radko Gudas,D,ANA,34,62,3,9,12
12,8477018,Ben Hutton,D,VGK,31,56,3,9,12
12,8475177,Calvin de Haan,D,COL,33,43,2,10,12
12,8479671,Mathieu Olivier,R,CBJ,27,40,2,10,12
12,8475690,Chris Tanev,D,TOR,35,55,1,11,12
12,8481147,Reese Johnson,C,MIN,26,39,7,4,11
12,8482809,Jackson Blake,R,CAR,21,57,5,6,11
12,8477573,Nathan Walker,L,STL,30,55,5,6,11
12,8482077,Dylan Holloway,L,EDM,23,49,5,6,11
12,8476329,Travis Boyd,C,MIN,31,50,4,7,11
12,8479291,Kevin Rooney,C,CGY,31,47,4,7,11
12,8483549,Lucas Condotta,L,MTL,27,35,4,7,11
12,8481161,Jake Christiansen,D,CBJ,25,58,4,7,11
12,8477482,Zachary Sanford,L,CHI,30,41,3,8,11
12,8471677,Jack Johnson,D,CBJ,37,70,2,9,11
12,8477365,Connor Clifton,D,BUF,29,64,1,10,11
12,8476457,Adam Larsson,D,SEA,32,66,1,10,11
12,8481716,Dmitri Voronkov,L,CBJ,24,47,6,4,10
12,8481789,Tye Kartye,L,SEA,23,36,6,4,10
12,8481754,Nikita Nesterenko,C,ANA,23,36,5,5,10
12,8482176,Wyatt Kaiser,D,CHI,22,53,4,6,10
12,8481517,Brett Leason,R,ANA,25,48,4,6,10
12,8483466,Kevin Korchinski,D,CHI,20,51,4,6,10
12,8482666,Scott Morrow,D,CAR,22,47,4,6,10
12,8481701,Santeri Hatakka,D,NJD,23,41,4,6,10
12,8474568,Luke Schenn,D,NSH,35,46,4,6,10
12,8476931,Jake McCabe,D,TOR,31,68,3,7,10
12,8480796,Martin Fehervary,D,WSH,25,59,3,7,10
12,8474013,Ian Cole,D,UTA,35,52,2,8,10
12,8482964,Arber Xhekaj,D,MTL,23,45,2,8,10
12,8477962,Brendan Lemieux,L,CAR,28,46,2,8,10
12,8479348,Kale Clague,D,BUF,26,34,2,8,10
12,8476874,Olli Maatta,D,DET,30,64,1,9,10
12,8482451,Mikael Pyyhtia,L,CBJ,23,38,1,9,10
12,8475235,Nicolas Deslauriers,L,PHI,33,46,6,3,9
12,8476858,Phillip Di Giuseppe,L,VAN,31,42,6,3,9
12,8478211,Dryden Hunt,L,CGY,29,59,5,4,9
12,8478831,Kevin Stenlund,C,UTA,28,52,5,4,9
12,8481592,Jakob Pelletier,L,CGY,23,45,5,4,9
12,8480011,Klim Kostin,C,SJS,25,43,4,5,9
12,8478585,Derek Ryan,C,EDM,38,60,4,5,9
12,8482165,Yan Kuznetsov,D,CGY,22,20,4,5,9
12,8479994,Jaret Anderson-Dolan,C,WPG,25,30,4,5,9
12,8480292,Carson Meyer,R,ANA,27,31,4,5,9
12,8477335,Kyle Burroughs,D,LAK,29,41,4,5,9
12,8477070,Liam O'Brien,C,UTA,30,57,4,5,9
12,8479772,Zack MacEwen,R,OTT,28,59,3,6,9
12,8479372,Joshua Mahura,D,SEA,26,53,3,6,9
12,8480848,Ty Dellandrea,C,SJS,24,51,3,6,9
12,8477938,Haydn Fleury,D,WPG,28,40,3,6,9
12,8480070,Ian Mitchell,D,BOS,25,48,3,6,9
12,8481598,Philip Broberg,D,EDM,23,41,3,6,9
12,8482511,Mason Lohrei,D,BOS,23,37,3,6,9
12,8478451,Ethan Bear,D,WSH,27,53,2,7,9
12,8479249,Andrew Poturalski,C,SJS,30,31,2,7,9
12,8477851,Jordan Oesterle,D,BOS,32,40,2,7,9
12,8475750,Jon Merrill,D,MIN,32,62,2,7,9
12,8477244,Chad Ruhwedel,D,NYR,34,34,1,8,9
12,8477931,Tomas Nosek,L,FLA,32,62,6,2,8
12,8479536,Axel Jonsson-Fjallby,L,WPG,26,34,6,2,8
12,8478146,Matthew Highmore,C,OTT,28,36,5,3,8
12,8476867,Brendan Gaunce,C,MIN,30,46,4,4,8
12,8482747,Brennan Othmann,L,NYR,21,42,4,4,8
12,8482751,Ryan Winterton,C,SEA,21,35,4,4,8
12,8482144,Jack Thompson,D,SJS,22,26,4,4,8
12,8482744,James Malatesta,L,CBJ,21,43,3,5,8
12,8480845,Rasmus Kupari,C,WPG,24,41,3,5,8
12,8477401,John Hayden,C,SEA,29,32,3,5,8
12,8479981,Jonah Gadjovich,L,FLA,26,46,3,5,8
12,8481550,Adam Beckman,L,NJD,23,35,2,6,8
12,8481751,Lukas Rousek,R,BUF,25,36,2,6,8
12,8480196,Jacob Bryson,D,BUF,27,43,1,7,8
12,8482762,Simon Edvinsson,D,DET,21,42,6,1,7
12,8481543,Nikita Alexandrov,C,STL,24,20,6,1,7
12,8481532,Alex Turcotte,C,LAK,23,45,5,2,7
12,8479986,Kole Lind,R,DAL,26,43,5,2,7
12,8481556,John Beecher,C,BOS,23,30,5,2,7
12,8479442,Troy Stecher,D,EDM,30,43,3,4,7
12,8482141,Lukas Cormier,D,VGK,22,20,3,4,7
12,8480890,Jan Jenik,C,OTT,24,27,3,4,7
12,8477887,Patrick Brown,C,BOS,32,42,3,4,7
12,8476441,Joel Edmundson,D,LAK,31,37,2,5,7
12,8480172,Jan Rutta,D,SJS,34,58,2,5,7
12,8480007,Jonas Rondbjerg,R,VGK,25,43,2,5,7
12,8480990,Declan Chisholm,D,MIN,24,39,1,6,7
12,8480950,Ilya Lyubushkin,D,DAL,30,59,0,7,7
12,8473446,Erik Johnson,D,PHI,36,54,0,7,7
12,8480834,Ty Emberson,D,SJS,24,38,0,7,7
12,8479968,Vinni Lettieri,C,BOS,29,47,4,2,6
12,8483619,Filip Roos,D,OTT,25,33,4,2,6
12,8481609,Vladislav Kolyachonok,D,UTA,23,32,4,2,6
12,8476952,Dominic Toninato,C,WPG,30,47,3,3,6
12,8481600,Tobias Bjornfot,D,FLA,23,34,2,4,6
12,8478468,Jeremy Lauzon,D,NSH,27,64,2,4,6
12,8480844,Grigori Denisenko,L,VGK,24,28,2,4,6
12,8471817,Ryan Reaves,R,TOR,37,54,1,5,6
12,8474612,Travis Hamonic,D,OTT,34,55,1,5,6
12,8481564,Ryan Johnson,D,BUF,23,13,1,5,6
12,8479378,Logan Stanley,D,WPG,26,49,0,6,6
12,8482095,Tyler Kleven,D,OTT,22,36,0,6,6
12,8479587,Rhett Gardner,C,PHI,28,22,0,6,6
12,8482145,Mavrik Bourque,C,DAL,22,53,4,1,5
12,8478421,A.J. Greer,L,FLA,28,54,3,2,5
12,8482652,Walker Duehr,R,CGY,27,39,3,2,5
12,8482713,Mackie Samoskevich,R,FLA,22,42,3,2,5
12,8479991,Jake Leschyshyn,C,NYR,25,29,3,2,5
12,8475958,Michael Sgarbossa,C,WSH,32,29,3,2,5
12,8482172,Landon Slaggert,L,CHI,22,32,3,2,5
12,8477320,Anton Blidh,L,NYR,29,25,3,2,5
12,8482166,Shakir Mukhamadullin,D,SJS,22,51,2,3,5
12,8479944,Zach Aston-Reese,C,VGK,30,49,2,3,5
12,8480870,Bo Groulx,C,NYR,24,25,2,3,5
12,8481679,Maxence Guenette,D,OTT,23,36,2,3,5
12,8483512,Matthew Savoie,C,EDM,20,22,2,3,5
12,8479379,Givani Smith,R,SJS,26,38,2,3,5
12,8482102,Vasily Ponomarev,C,PIT,22,20,2,3,5
12,8481167,Brayden Pachal,D,CGY,25,38,1,4,5
12,8477384,Joshua Brown,D,EDM,30,46,1,4,5
12,8482861,Vincent Iorio,D,WSH,22,35,1,4,5
12,8475762,Derek Forbort,D,VAN,32,45,1,4,5
12,8478017,Mark Friedman,D,VAN,29,48,1,4,5
12,8477473,Justin Bailey,R,SJS,29,26,1,4,5
12,8479320,Maxime Lajoie,D,SEA,27,22,1,4,5
12,8476372,Nick Seeler,D,PHI,31,34,0,5,5
12,8478450,Parker Wotherspoon,D,BOS,27,25,0,5,5
12,8477971,Andreas Englund,D,LAK,28,30,0,5,5
12,8483397,Marc McLaughlin,C,BOS,25,25,3,1,4
12,8478477,Mitchell Stephens,C,SEA,27,22,3,1,4
12,8480851,Akil Thomas,C,LAK,24,13,3,1,4
12,8481462,Mason Morelli,L,VGK,28,12,3,1,4
12,8481056,Spencer Stastney,D,NSH,24,26,2,2,4
12,8482470,Ilya Solovyov,D,CGY,24,25,2,2,4
12,8483630,Pavol Regenda,L,ANA,25,36,2,2,4
12,8478874,Adam Gaudette,R,OTT,28,31,2,2,4
12,8475755,Alexander Petrovic,D,DAL,32,10,2,2,4
12,8478424,Jansen Harkins,C,ANA,27,33,1,3,4
12,8484911,Collin Graf,R,SJS,22,38,1,3,4
12,8482153,Brendan Brisson,C,VGK,23,27,1,3,4
12,8481605,Jackson LaCombe,D,ANA,23,36,1,3,4
12,8481699,Aku Raty,R,UTA,23,22,1,3,4
12,8483570,Ben Meyers,C,SEA,26,33,1,3,4
12,8481237,Kyle MacLean,C,NYI,25,19,1,3,4
12,8481743,Marc Del Gaizo,D,NSH,25,24,1,3,4
12,8481006,Tyler Tucker,D,STL,24,18,1,3,4
12,8482516,Matthew Kessel,D,STL,24,28,1,3,4
12,8483012,Logan Morrison,C,SEA,22,37,0,4,4
12,8480267,Sammy Walker,C,MIN,25,18,0,4,4
12,8482765,Isak Rosen,R,BUF,21,22,0,4,4
12,8478454,Noah Juulsen,D,VAN,27,32,0,4,4
12,8481122,Simon Benoit,D,TOR,26,31,0,4,4
12,8481541,Samuel Bolduc,D,NYI,24,38,0,4,4
12,8484254,Akito Hirose,D,VAN,25,30,2,1,3
12,8483763,Maksymilian Szuber,D,UTA,22,32,2,1,3
12,8477149,Scott Sabourin,R,SJS,32,8,2,1,3
12,8482147,Jean-Luc Foudy,C,COL,22,20,2,1,3
12,8476473,Connor Murphy,D,CHI,31,33,2,1,3
12,8482061,Brandon Biro,L,SEA,26,20,2,1,3
12,8483471,Brad Lambert,C,WPG,31,12,2,1,3
12,8478409,Anthony Richard,C,PHI,28,30,1,2,3
12,8480245,Olle Lycksell,R,PHI,25,31,1,2,3
12,8481422,Jake Lucchini,C,NSH,29,18,1,2,3
12,8480823,Alexander Alexeyev,D,WSH,25,13,1,2,3
12,8477462,Robert Hagg,D,VGK,29,16,1,2,3
12,8484258,Sam Malinski,D,COL,26,17,1,2,3
12,8477527,Ross Johnston,L,ANA,30,34,1,2,3
12,8477467,Gustav Olofsson,D,SEA,30,21,1,2,3
12,8482162,Roby Jarventie,L,EDM,22,16,1,2,3
12,8481206,John Ludvig,D,PIT,24,14,1,2,3
12,8477073,Kurtis MacDermid,L,NJD,30,26,0,3,3
12,8477810,Joel Hanley,D,CGY,33,22,0,3,3
12,8475795,Dylan McIlrath,D,WSH,32,12,0,3,3
12,8478854,Ryan Shea,D,PIT,27,10,0,3,3
12,8479576,Vincent Desharnais,D,VAN,28,31,2,0,2
12,8481726,Adam Edstrom,C,NYR,24,10,2,0,2
12,8479367,William Lockwood,R,FLA,26,21,2,0,2
12,8483432,Luca Del Bel Belluz,C,CBJ,31,4,2,0,2
12,8478502,Dennis Gilbert,D,BUF,28,25,1,1,2
12,8481593,Jayden Struble,D,MTL,23,22,1,1,2
12,8482201,Gage Goncalves,C,TBL,23,23,1,1,2
12,8482070,Mitchell Chaffee,R,TBL,26,45,1,1,2
12,8481585,Egor Afanasyev,L,SJS,23,17,1,1,2
12,8481806,Louis Crevier,D,CHI,23,14,1,1,2
12,8482929,Emil Lilleberg,D,TBL,23,22,1,1,2
12,8484325,Waltteri Merela,C,TBL,26,25,1,1,2
12,8481578,Graeme Clarke,R,MIN,23,9,1,1,2
12,8475413,Justin Dowling,C,NJD,34,13,1,1,2
12,8482197,Adam Raska,R,MIN,23,14,1,1,2
12,8483407,Brandon Scanlin,D,NYR,25,7,1,1,2
12,8480468,James Hamblin,L,EDM,25,17,0,2,2
12,8478021,William Lagesson,D,DET,28,32,0,2,2
12,8480084,Nick DeSimone,D,NJD,30,17,0,2,2
12,8480874,Adam Ginning,D,PHI,24,8,0,2,2
12,8478011,Louie Belpedio,D,PHI,28,13,0,2,2
12,8482118,Sam Colangelo,R,ANA,23,21,0,2,2
12,8483567,Georgii Merkulov,C,BOS,24,8,0,2,2
12,8479985,Cale Fleury,D,SEA,26,30,0,2,2
12,8482858,Ryker Evans,D,SEA,23,20,1,0,1
12,8482177,Marat Khusnutdinov,C,MIN,22,33,1,0,1
12,8481043,Cole Koepke,L,BOS,26,20,1,0,1
12,8483597,Milos Kelemen,L,UTA,25,7,1,0,1
12,8481655,Cole Schwindt,R,CGY,23,5,1,0,1
12,8476323,Max McCormick,L,SEA,32,3,1,0,1
12,8483609,Adam Klapka,R,CGY,24,7,1,0,1
12,8482787,Nikita Chibrikov,R,WPG,31,6,1,0,1
12,8482250,Callahan Burke,C,VGK,27,17,0,1,1
12,8481719,Maxwell Crozier,D,TBL,24,11,0,1,1
12,8481030,Jack St. Ivany,D,PIT,25,12,0,1,1
12,8481065,Angus Crookshank,L,OTT,25,15,0,1,1
12,8478051,Max Willman,C,NJD,29,19,0,1,1
12,8478446,Glenn Gawdin,C,LAK,27,14,0,1,1
12,8482088,Justin Sourdif,R,FLA,22,16,0,1,1
12,8479362,Riley Tufte,L,BOS,26,11,0,1,1
12,8474062,Riley Nash,C,NYR,35,14,0,1,1
12,8482094,Daemon Hunt,D,MIN,22,15,0,1,1
12,8484304,Uvis Balinskis,D,FLA,28,8,0,1,1
12,8480075,Cameron Crotty,D,MIN,25,8,0,1,1
12,8482460,Matt Rempe,C,NYR,22,17,0,1,1
12,8480032,Shane Bowers,C,NJD,25,26,0,0,0
12,8477993,Justin Kirkland,C,CGY,28,4,0,0,0
12,8484287,Cole McWard,D,VAN,23,20,0,0,0
12,8484259,Ondrej Pavel,C,COL,31,1,0,0,0
12,8480306,Grant Hutton,D,NYI,29,4,0,0,0
12,8483395,Arshdeep Bains,L,VAN,23,14,0,0,0
12,8481024,Linus Karlsson,C,VAN,25,8,0,0,0
12,8475780,Chris Wagner,R,COL,33,11,0,0,0
12,8479330,Brandon Gignac,C,MTL,27,6,0,0,0
12,8484321,Nikolas Matinpalo,D,OTT,26,3,0,0,0
12,8482476,Emil Heineman,L,MTL,23,5,0,0,0
12,8479419,Brett Murray,L,BUF,26,18,0,0,0
12,8484255,Jason Polin,R,COL,25,4,0,0,0
12,8483489,Fraser Minten,C,TOR,31,9,0,0,0
12,8481534,Raphael Lavoie,C,EDM,24,3,0,0,0
12,8483920,Pierrick Dube,R,WSH,23,3,0,0,0
12,8478881,Brett Seney,L,CHI,28,11,0,0,0
12,8483398,Declan Carlile,D,TBL,31,8,0,0,0
12,8479522,Hardy Haman Aktell,D,WSH,26,2,0,0,0
12,8484326,Patrik Koch,D,UTA,28,0,0,0,0
12,8477541,Dakota Mermis,D,TOR,30,6,0,0,0
12,8478147,Bokondji Imama,L,PIT,28,4,0,0,0
12,8483546,Marshall Rifai,D,TOR,26,1,0,0,0
12,8482126,Emil Andrae,D,PHI,31,4,0,0,0
12,8479421,Jacob Moverare,D,LAK,26,0,0,0,0
12,8483531,Brian Halonen,L,NJD,25,2,0,0,0
12,8470794,Joe Pavelski,C,,40,0,0,0,0
12,8479321,Lucas Johansen,D,,27,0,0,0,0
12,8477950,Tony DeAngelo,D,,29,0,0,0,0
12,8471218,Blake Wheeler,R,,38,0,0,0,0
12,8475197,Tyson Barrie,D,,33,0,0,0,0
12,8474157,Max Pacioretty,L,,36,0,0,0,0
12,8475744,Evgeny Kuznetsov,C,,32,0,0,0,0
12,8474037,James van Riemsdyk,L,,35,0,0,0,0
12,8476907,Mackenzie MacEachern,L,,30,0,0,0,0
12,8480216,Jacob Peterson,C,,25,0,0,0,0
12,8474602,Justin Schultz,D,,34,0,0,0,0
12,8482222,Alexander Barabanov,L,,30,0,0,0,0
12,8474031,Kevin Shattenkirk,D,,35,0,0,0,0
12,8477330,Dominik Kubalik,L,,29,0,0,0,0
12,8480884,Calen Addison,D,,24,0,0,0,0
12,8475906,John Klingberg,D,,32,0,0,0,0
12,8480008,Adam Ruzicka,C,,25,0,0,0,0
12,8476884,Derrick Pouliot,D,,30,0,0,0,0
12,8476919,Chris Tierney,C,,30,0,0,0,0
12,8479415,Michael McLeod,C,,26,0,0,0,0
12,8474870,Tyler Johnson,C,,34,0,0,0,0
12,8470604,Jeff Carter,C,,39,0,0,0,0
12,8478104,Sammy Blais,L,,28,0,0,0,0
12,8474884,Mike Hoffman,C,,35,0,0,0,0
12,8481591,Sam Poulin,R,,23,0,0,0,0
12,8471274,Alex Goligoski,D,,39,0,0,0,0
12,8476871,Tanner Pearson,L,,32,0,0,0,0
12,8476393,Nick Cousins,C,,31,0,0,0,0
12,8479977,Kailer Yamamoto,R,,26,0,0,0,0
12,8479346,Dillon Dube,C,,26,0,0,0,0
12,8480184,Gustav Lindstrom,D,,26,0,0,0,0
12,8479376,Victor Mete,D,,26,0,0,0,0
12,8473449,Kyle Okposo,R,,36,0,0,0,0
12,8481058,Jesse Ylonen,R,,25,0,0,0,0
12,8475752,Tyler Pitlick,C,,33,0,0,0,0
12,8481239,Samuel Fagemo,L,,24,0,0,0,0
12,8480821,Filip Zadina,R,,25,0,0,0,0
12,8470966,Mark Giordano,D,,41,0,0,0,0
12,8478495,Denis Gurianov,R,,27,0,0,0,0
12,8477464,Nic Petan,C,,29,0,0,0,0
12,8478099,Kevin Labanc,R,,29,0,0,0,0
12,8482241,Radim Zohorna,L,,28,0,0,0,0
12,8474040,Sam Gagner,C,,35,0,0,0,0
12,8479514,Rem Pitlick,C,,27,0,0,0,0
12,8478430,Oliver Kylington,D,,27,0,0,0,0
12,8479533,Joona Koppanen,L,,26,0,0,0,0
12,8479984,Cal Foote,D,,26,0,0,0,0
12,8477126,Jayson Megna,C,,34,0,0,0,0
12,8475164,Jakob Silfverberg,R,,34,0,0,0,0
12,8474009,Nick Bonino,C,,36,0,0,0,0
12,8479458,Nikita Zaitsev,D,,33,0,0,0,0
12,8477944,Jakub Vrana,L,,28,0,0,0,0
12,8471699,Andrew Cogliano,C,,37,0,0,0,0
12,8478067,Oskar Lindblom,L,,28,0,0,0,0
12,8471686,Marc Staal,D,,37,0,0,0,0
12,8470610,Zach Parise,L,,40,0,0,0,0
12,8478904,Steven Lorentz,C,,28,0,0,0,0
12,8473473,Milan Lucic,L,,36,0,0,0,0
12,8480031,Maxime Comtois,L,,25,0,0,0,0
12,8478512,Austin Czarnik,C,,32,0,0,0,0
12,8473504,Cal Clutterbuck,R,,37,0,0,0,0
12,8477454,Adam Erne,L,,29,0,0,0,0
12,8479383,Boris Katchouk,L,,26,0,0,0,0
12,8475825,Jani Hakanpää,D,,32,0,0,0,0
12,8477846,Ryan Carpenter,C,,33,0,0,0,0
12,8477930,Pierre-Edouard Bellemare,L,,39,0,0,0,0
12,8478400,Colin White,C,,27,0,0,0,0
12,8480226,Marián Studenic,R,,26,0,0,0,0
12,8480853,Liam Foudy,C,,24,0,0,0,0
12,8475797,Jarred Tinordi,D,,32,0,0,0,0
12,8479423,Alex Nylander,L,,26,0,0,0,0
12,8474618,Marco Scandella,D,,34,0,0,0,0
12,8478028,Fredrik Olofsson,L,,28,0,0,0,0
12,8474709,Matt Martin,L,,35,0,0,0,0
12,8481070,Hugh McGing,L,,26,0,0,0,0
12,8479546,Oskar Steen,C,,26,0,0,0,0
12,8474145,Robert Bortuzzo,D,,35,0,0,0,0
12,8476915,Jujhar Khaira,L,,30,0,0,0,0
12,8480274,Philip Kemp,D,EDM,25,3,0,0,0
12,8475278,Byron Froese,C,,33,0,0,0,0
12,8481812,Nikolai Knyzhov,D,,27,0,0,0,0
12,8478408,Travis Dermott,D,,28,0,0,0,0
12,8481077,John Leonard,L,,26,0,0,0,0
12,8479547,Matthew Phillips,R,,26,0,0,0,0
12,8480836,Jonathan Gruden,C,,24,0,0,0,0
12,8481690,Tyler Angle,C,,24,0,0,0,0
12,8475766,Austin Watson,L,,32,0,0,0,0
12,8481016,Ruslan Iskhakov,C,,24,0,0,0,0
12,8478078,Rourke Chartier,C,,28,0,0,0,0
12,8483401,Marc Johnstone,R,PIT,28,2,0,0,0
12,8480776,Sheldon Rempal,R,,29,0,0,0,0
12,8478956,Samuel Laberge,L,NJD,27,1,0,0,0
12,8483045,Cameron Butler,R,CBJ,31,2,0,0,0
12,8484314,Jiri Smejkal,L,,28,0,0,0,0
13,8476453,Nikita Kucherov,R,TBL,31,82,43,96,139
13,8478402,Connor McDavid,C,EDM,27,78,48,87,135
13,8477492,Nathan MacKinnon,C,COL,29,79,41,88,129
13,8478864,Kirill Kaprizov,L,MIN,27,72,60,66,126
13,8478483,Mitch Marner,R,TOR,27,77,39,80,119
13,8479318,Auston Matthews,C,TOR,27,77,67,47,114
13,8477939,William Nylander,R,TOR,28,79,56,58,114
13,8477934,Leon Draisaitl,C,EDM,29,79,37,73,110
13,8478550,Artemi Panarin,L,NYR,33,75,34,74,108
13,8479314,Matthew Tkachuk,L,FLA,27,80,34,73,107
13,8477956,David Pastrnak,R,BOS,28,77,45,59,104
13,8477942,Kevin Fiala,L,LAK,28,82,37,65,102
13,8478420,Mikko Rantanen,R,COL,28,81,46,55,101
13,8481559,Jack Hughes,C,NJD,23,78,48,51,99
13,8480027,Jason Robertson,L,DAL,25,81,33,65,98
13,8477404,Jake Guentzel,C,TBL,30,81,38,58,96
13,8479407,Jesper Bratt,L,NJD,26,77,34,59,93
13,8477933,Sam Reinhart,C,FLA,29,77,32,60,92
13,8476887,Filip Forsberg,L,NSH,30,75,45,46,91
13,8476468,J.T. Miller,C,VAN,31,77,27,64,91
13,8475166,John Tavares,C,TOR,34,76,27,64,91
13,8474564,Steven Stamkos,C,NSH,34,76,36,53,89
13,8480012,Elias Pettersson,C,VAN,26,78,27,62,89
13,8480023,Robert Thomas,C,STL,25,79,27,62,89
13,8479323,Adam Fox,D,NYR,26,75,16,72,88
13,8478010,Brayden Point,C,TBL,28,82,43,44,87
13,8477493,Aleksander Barkov,C,FLA,29,77,22,65,87
13,8478427,Sebastian Aho,C,CAR,27,74,40,45,85
13,8477960,Adrian Kempe,R,LAK,28,79,38,47,85
13,8479385,Jordan Kyrou,C,STL,26,73,37,48,85
13,8480800,Quinn Hughes,D,VAN,25,75,13,72,85
13,8478403,Jack Eichel,C,VGK,28,77,31,53,84
13,8480069,Cale Makar,D,COL,26,63,25,59,84
13,8484144,Connor Bedard,C,CHI,19,69,24,60,84
13,8479343,Clayton Keller,R,UTA,26,78,42,41,83
13,8476459,Mika Zibanejad,C,NYR,31,78,25,57,82
13,8479325,Charlie McAvoy,D,BOS,27,78,20,60,80
13,8479337,Alex DeBrincat,R,DET,27,81,39,40,79
13,8479542,Brandon Hagel,L,TBL,26,81,35,44,79
13,8474141,Patrick Kane,R,DET,36,82,32,47,79
13,8476454,Ryan Nugent-Hopkins,C,EDM,31,79,18,60,78
13,8471214,Alex Ovechkin,L,WSH,39,76,37,40,77
13,8477946,Dylan Larkin,C,DET,28,79,35,42,77
13,8478398,Kyle Connor,L,WPG,28,72,42,34,76
13,8479420,Tage Thompson,C,BUF,27,72,40,36,76
13,8475913,Mark Stone,R,VGK,32,75,22,54,76
13,8476881,Tomas Hertl,C,VGK,31,76,39,35,74
13,8482745,Mason McTavish,C,ANA,21,70,38,36,74
13,8477935,Sam Bennett,C,FLA,28,78,36,38,74
13,8478444,Brock Boeser,R,VAN,27,77,33,41,74
13,8480830,Andrei Svechnikov,R,CAR,24,66,31,43,74
13,8480002,Nico Hischier,C,NJD,25,76,31,43,74
13,8482116,Tim Stützle,C,OTT,22,80,26,48,74
13,8471675,Sidney Crosby,C,PIT,37,70,32,41,73
13,8480801,Brady Tkachuk,L,OTT,25,80,28,45,73
13,8475172,Nazem Kadri,C,CGY,34,76,19,54,73
13,8476456,Jonathan Huberdeau,C,CGY,31,80,18,54,72
13,8476389,Vincent Trocheck,C,NYR,31,77,36,35,71
13,8471685,Anze Kopitar,C,LAK,37,80,25,46,71
13,8482078,Lucas Raymond,L,DET,22,81,24,47,71
13,8473419,Brad Marchand,L,BOS,36,81,23,48,71
13,8475692,Mats Zuccarello,R,MIN,37,75,17,54,71
13,8480803,Evan Bouchard,D,EDM,25,79,9,62,71
13,8477409,Carter Verhaeghe,C,FLA,29,77,40,30,70
13,8482740,Wyatt Johnston,C,DAL,21,82,33,37,70
13,8478414,Timo Meier,R,NJD,28,78,32,38,70
13,8480039,Martin Necas,C,CAR,25,69,29,41,70
13,8477949,Alex Tuch,R,BUF,28,73,24,46,70
13,8474600,Roman Josi,D,NSH,34,73,19,51,70
13,8475167,Victor Hedman,D,TBL,34,80,10,60,70
13,8479675,Trevor Moore,L,LAK,29,81,34,35,69
13,8478460,Zach Werenski,D,CBJ,27,82,15,54,69
13,8482093,Seth Jarvis,C,CAR,22,77,34,34,68
13,8476346,Johnny Gaudreau,L,CBJ,31,71,15,53,68
13,8478401,Pavel Zacha,C,BOS,27,79,31,36,67
13,8477940,Nikolaj Ehlers,L,WPG,28,66,29,38,67
13,8477500,Bo Horvat,C,NYI,29,81,28,39,67
13,8478438,Tommy Novak,C,NSH,27,73,20,47,67
13,8478445,Mathew Barzal,C,NYI,27,82,16,51,67
13,8475158,Ryan O'Reilly,C,NSH,33,73,24,42,66
13,8480036,Miro Heiskanen,D,DAL,25,79,17,49,66
13,8476539,Jonathan Marchessault,R,NSH,34,75,33,32,65
13,8478449,Roope Hintz,C,DAL,28,81,30,35,65
13,8482665,Matty Beniers,C,SEA,22,72,26,39,65
13,8477955,Jared McCann,L,SEA,28,74,24,40,64
13,8475184,Chris Kreider,L,NYR,33,78,38,25,63
13,8476460,Mark Scheifele,C,WPG,31,71,27,36,63
13,8477402,Pavel Buchnevich,L,STL,29,75,26,37,63
13,8478873,Troy Terry,R,ANA,27,77,23,40,63
13,8478493,Joel Eriksson Ek,C,MIN,27,74,22,41,63
13,8477951,Nick Schmaltz,C,UTA,28,77,20,42,62
13,8473512,Claude Giroux,R,OTT,36,76,19,43,62
13,8477476,Artturi Lehkonen,L,COL,29,80,27,34,61
13,8480839,Rasmus Dahlin,D,BUF,24,74,10,51,61
13,8478519,Anthony Cirelli,C,TBL,27,81,31,29,60
13,8481557,Matt Boldy,L,MIN,23,71,30,30,60
13,8471215,Evgeni Malkin,C,PIT,38,71,24,36,60
13,8477416,Oliver Bjorkstrand,R,SEA,29,75,23,37,60
13,8475786,Zach Hyman,L,EDM,32,79,38,21,59
13,8478439,Travis Konecny,R,PHI,27,78,18,41,59
13,8477504,Josh Morrissey,D,WPG,29,70,7,52,59
13,8475169,Evander Kane,L,EDM,33,78,30,28,58
13,8475745,Charlie Coyle,C,BOS,32,80,20,38,58
13,8471724,Kris Letang,D,PIT,37,80,19,39,58
13,8481540,Cole Caufield,R,MTL,23,78,27,30,57
13,8473994,Jamie Benn,L,DAL,35,81,20,37,57
13,8476792,Torey Krug,D,STL,33,73,16,41,57
13,8476875,Mike Matheson,D,MTL,30,73,12,45,57
13,8477501,Valeri Nichushkin,R,COL,29,81,33,23,56
13,8475754,Brock Nelson,C,NYI,33,77,28,28,56
13,8475168,Matt Duchene,C,DAL,33,79,26,30,56
13,8476479,Phillip Danault,C,LAK,31,81,24,32,56
13,8474586,Jordan Eberle,R,SEA,34,73,23,33,56
13,8474679,Gustav Nyquist,C,NSH,35,71,18,38,56
13,8477346,MacKenzie Weegar,D,CGY,30,74,16,40,56
13,8476853,Morgan Rielly,D,TOR,30,73,10,46,56
13,8480015,Owen Tippett,R,PHI,25,73,32,23,55
13,8475784,Jeff Skinner,C,EDM,32,74,25,30,55
13,8480208,Drake Batherson,R,OTT,26,80,21,34,55
13,8482699,Dylan Guenther,R,UTA,21,74,21,34,55
13,8478498,Jake DeBrusk,L,VAN,28,75,30,24,54
13,8475794,Tyler Seguin,C,DAL,32,81,25,29,54
13,8475170,Brayden Schenn,C,STL,33,74,23,31,54
13,8475765,Vladimir Tarasenko,R,DET,33,82,20,34,54
13,8478975,Mason Marchment,L,DAL,29,81,20,34,54
13,8482667,William Eklund,L,SJS,22,69,16,38,54
13,8474590,John Carlson,D,WSH,34,70,12,42,54
13,8483515,Juraj Slafkovsky,L,MTL,20,80,19,34,53
13,8480018,Nick Suzuki,C,MTL,25,74,12,41,53
13,8474578,Erik Karlsson,D,PIT,34,80,11,42,53
13,8480865,Noah Dobson,D,NYI,24,77,8,45,53
13,8481542,Moritz Seider,D,DET,23,74,7,46,53
13,8481068,Yegor Sharangovich,C,CGY,26,80,27,25,52
13,8484145,Zach Benson,L,BUF,19,67,22,30,52
13,8474102,David Perron,L,OTT,36,79,17,35,52
13,8474563,Drew Doughty,D,LAK,35,72,17,35,52
13,8478407,Vince Dunn,D,SEA,28,74,9,43,52
13,8475726,Tyler Toffoli,C,SJS,32,70,28,23,51
13,8475722,Jason Zucker,L,BUF,32,72,27,24,51
13,8479339,Patrik Laine,L,CBJ,26,62,25,26,51
13,8479345,Jakob Chychrun,D,WSH,26,70,21,30,51
13,8484153,Leo Carlsson,C,ANA,20,72,20,31,51
13,8470613,Brent Burns,D,CAR,39,74,15,36,51
13,8475768,Jaden Schwartz,C,SEA,32,71,24,26,50
13,8477496,Elias Lindholm,C,BOS,30,76,22,28,50
13,8477429,Andrew Copp,C,DET,30,80,21,29,50
13,8477407,Anthony Duclair,L,NYI,29,74,20,30,50
13,8475798,Mikael Granlund,C,SJS,32,67,16,34,50
13,8476905,Chandler Stephenson,C,SEA,30,74,10,40,50
13,8477426,Nicholas Paul,L,TBL,29,82,29,20,49
13,8476872,Scott Laughton,C,PHI,30,75,23,26,49
13,8482109,Alexis Lafrenière,L,NYR,23,72,22,27,49
13,8477456,J.T. Compher,L,DET,29,78,22,27,49
13,8474565,Alex Pietrangelo,D,VGK,34,61,12,37,49
13,8482124,Quinton Byfield,R,LAK,22,81,11,38,49
13,8482702,Logan Stankoven,C,DAL,21,80,24,24,48
13,8482159,Tyson Foerster,R,PHI,22,77,19,29,48
13,8479999,Casey Mittelstadt,C,COL,26,80,13,35,48
13,8482684,Luke Hughes,D,NJD,21,66,10,38,48
13,8478466,Daniel Sprong,R,VAN,27,72,24,23,47
13,8476483,Rickard Rakell,R,PIT,31,67,21,26,47
13,8475810,Bryan Rust,R,PIT,32,72,20,27,47
13,8481711,Matias Maccelli,L,UTA,24,74,13,34,47
13,8477495,Seth Jones,D,CHI,30,71,8,39,47
13,8476432,Boone Jenner,C,CBJ,31,69,28,18,46
13,8474150,Mikael Backlund,C,CGY,35,77,23,23,46
13,8484166,Adam Fantilli,C,CBJ,20,72,17,29,46
13,8473986,Alex Killorn,L,ANA,35,74,15,31,46
13,8477444,Andre Burakovsky,L,SEA,29,66,14,32,46
13,8475314,Anders Lee,L,NYI,34,78,28,17,45
13,8479365,Trent Frederic,C,BOS,26,78,21,24,45
13,8477964,Ivan Barbashev,C,VGK,29,78,16,29,45
13,8477451,Ryan Hartman,R,MIN,30,70,16,29,45
13,8477447,Shea Theodore,D,VGK,29,65,14,31,45
13,8480028,Morgan Frost,C,PHI,25,70,13,32,45
13,8477503,Max Domi,C,TOR,29,80,11,34,45
13,8476958,Jaccob Slavin,D,CAR,30,76,10,35,45
13,8481528,Dylan Cozens,C,BUF,23,66,20,24,44
13,8475151,Kyle Palmieri,C,NYI,33,80,20,24,44
13,8476880,Tom Wilson,R,WSH,30,68,18,26,44
13,8478542,Evan Rodrigues,C,FLA,31,72,18,26,44
13,8476826,Yanni Gourde,C,SEA,33,76,16,28,44
13,8482110,Dawson Mercer,C,NJD,23,68,15,29,44
13,8477998,Warren Foegele,L,LAK,28,80,15,29,44
13,8476448,William Karlsson,C,VGK,31,77,14,30,44
13,8477932,Aaron Ekblad,D,FLA,28,79,10,34,44
13,8475764,Cam Fowler,D,ANA,33,74,6,38,44
13,8476869,Brady Skjei,D,NSH,30,67,4,40,44
13,8481560,Arthur Kaliyev,R,LAK,23,80,24,19,43
13,8478233,Andrew Mangiapane,L,WSH,28,70,24,19,43
13,8483808,Andrei Kuzmenko,L,CGY,28,74,23,20,43
13,8482113,Anton Lundell,C,FLA,23,75,19,24,43
13,8482175,JJ Peterka,R,BUF,22,73,17,26,43
13,8481581,Thomas Harley,D,DAL,23,66,9,34,43
13,8482720,Matthew Knies,L,TOR,22,74,8,35,43
13,8482089,Jake Neighbours,L,STL,22,66,29,13,42
13,8476399,Blake Coleman,C,CGY,33,77,21,21,42
13,8483431,Logan Cooley,C,UTA,20,73,21,21,42
13,8481533,Trevor Zegras,C,ANA,23,72,19,23,42
13,8481577,Philip Tomasino,C,NSH,23,73,18,24,42
13,8475191,Reilly Smith,R,NYR,33,76,16,26,42
13,8478396,Noah Hanifin,D,VGK,27,60,16,26,42
13,8482097,Jack Quinn,R,BUF,23,71,13,29,42
13,8475753,Justin Faulk,D,STL,32,64,13,29,42
13,8477021,Alex Kerfoot,C,UTA,30,71,12,30,42
13,8478474,Lawson Crouse,L,UTA,27,76,24,17,41
13,8478047,Michael Bunting,L,PIT,29,72,23,18,41
13,8481624,Ilya Mikheyev,R,CHI,30,63,22,19,41
13,8480797,Joel Farabee,L,PHI,24,77,16,25,41
13,8480459,Pius Suter,C,VAN,28,68,16,25,41
13,8483505,Matthew Poitras,C,BOS,20,76,14,27,41
13,8475218,Mattias Ekholm,D,EDM,34,78,8,33,41
13,8478856,Conor Garland,R,VAN,28,70,21,19,40
13,8477497,Sean Monahan,C,CBJ,30,70,20,20,40
13,8478042,Viktor Arvidsson,L,EDM,31,72,19,21,40
13,8481618,Alex Newhook,C,MTL,23,75,19,21,40
13,8481554,Kaapo Kakko,R,NYR,23,72,20,19,39
13,8475848,Brendan Gallagher,R,MTL,32,71,17,22,39
13,8477986,Brandon Montour,D,SEA,30,70,14,25,39
13,8478472,Mathieu Joseph,R,STL,27,66,12,27,39
13,8479425,Filip Hronek,D,VAN,27,73,11,28,39
13,8480188,Fabian Zetterlund,L,SJS,25,69,11,28,39
13,8482149,Cole Perfetti,C,WPG,22,69,10,29,39
13,8482671,Owen Power,D,BUF,22,67,10,29,39
13,8474149,Evgenii Dadonov,R,DAL,35,79,10,29,39
13,8480871,Adam Boqvist,D,FLA,24,68,7,32,39
13,8478046,Danton Heinen,L,VAN,29,66,24,14,38
13,8474641,Adam Henrique,C,EDM,34,76,18,20,38
13,8482146,Luke Evangelista,R,NSH,22,63,18,20,38
13,8478057,Dakota Joshua,C,VAN,28,64,16,22,38
13,8479351,Sam Steel,C,DAL,26,82,15,23,38
13,8476292,Ondrej Palat,L,NJD,33,72,14,24,38
13,8478440,Dylan Strome,C,WSH,27,71,13,25,38
13,8478038,Devon Toews,D,COL,30,65,10,28,38
13,8476462,Dougie Hamilton,D,NJD,31,71,8,30,38
13,8474151,Ryan McDonagh,D,TBL,35,79,6,32,38
13,8481606,Jordan Spence,D,LAK,23,62,4,34,38
13,8479293,Brandon Tanev,L,SEA,33,64,21,16,37
13,8475714,Calle Jarnkrok,C,TOR,33,75,18,19,37
13,8478115,Pierre Engvall,L,NYI,28,77,17,20,37
13,8481580,Connor McMichael,C,WSH,23,66,16,21,37
13,8480009,Eeli Tolvanen,R,SEA,25,68,15,22,37
13,8479400,Pierre-Luc Dubois,L,WSH,26,66,14,23,37
13,8480185,Eetu Luostarinen,C,FLA,26,74,14,23,37
13,8480798,Philipp Kurashev,C,CHI,25,58,13,24,37
13,8480145,Neal Pionk,D,WPG,29,73,12,25,37
13,8478500,Ivan Provorov,D,CBJ,27,81,12,25,37
13,8476419,Jean-Gabriel Pageau,C,NYI,32,79,11,26,37
13,8479410,Mikhail Sergachev,D,UTA,26,71,8,29,37
13,8480064,Josh Norris,C,OTT,25,75,23,13,36
13,8480014,Gabriel Vilardi,C,WPG,25,70,22,14,36
13,8477479,Tyler Bertuzzi,L,CHI,29,65,19,17,36
13,8475149,Marcus Johansson,L,MIN,34,67,15,21,36
13,8479525,Ross Colton,C,COL,28,79,14,22,36
13,8479992,Michael Rasmussen,C,DET,25,78,13,23,36
13,8476906,Shayne Gostisbehere,D,CAR,31,76,10,26,36
13,8478458,John (Jack) Roslovic,C,CAR,27,62,9,27,36
13,8478469,Thomas Chabot,D,OTT,27,67,5,31,36
13,8481604,Pavel Dorofeyev,L,VGK,24,71,18,17,35
13,8471698,T.J. Oshie,R,WSH,38,60,17,18,35
13,8475287,Erik Haula,L,NJD,33,72,16,19,35
13,8480802,Ryan McLeod,C,BUF,25,69,16,19,35
13,8480849,Barrett Hayton,C,UTA,24,77,14,21,35
13,8475200,Dmitry Orlov,D,CAR,33,73,9,26,35
13,8477498,Darnell Nurse,D,EDM,29,72,8,27,35
13,8475760,Nick Bjugstad,C,UTA,32,69,19,15,34
13,8477494,Jonathan Drouin,L,COL,29,80,14,20,34
13,8481596,Shane Pinto,C,OTT,24,77,12,22,34
13,8475763,Kevin Hayes,R,PIT,32,73,12,22,34
13,8476882,Teuvo Teravainen,C,CHI,30,60,11,23,34
13,8480434,Sean Durzi,D,UTA,26,70,10,24,34
13,8482705,Cole Sillinger,C,CBJ,21,75,10,24,34
13,8478366,Frank Vatrano,R,ANA,30,70,17,16,33
13,8482055,Drew O'Connor,L,PIT,26,68,16,17,33
13,8477989,Christian Dvorak,C,MTL,28,61,16,17,33
13,8480220,Noah Cates,L,PHI,25,63,13,20,33
13,8480817,K'Andre Miller,D,NYR,24,67,8,25,33
13,8481703,Valtteri Puustinen,R,PIT,25,66,6,27,33
13,8476979,Erik Gustafsson,D,DET,32,74,6,27,33
13,8479987,Morgan Geekie,C,BOS,26,72,16,16,32
13,8475793,Ryan Johansen,C,PHI,32,70,16,16,32
13,8477947,Sonny Milano,L,WSH,28,60,15,17,32
13,8479591,Michael Eyssimont,C,TBL,28,82,14,18,32
13,8480748,Kiefer Sherwood,L,VAN,29,58,14,18,32
13,8481523,Kirby Dach,C,MTL,23,64,13,19,32
13,8481546,Cam York,D,PHI,23,72,9,23,32
13,8482122,Brock Faber,D,MIN,22,82,6,26,32
13,8476885,Jacob Trouba,D,NYR,30,73,5,27,32
13,8476463,Jonas Brodin,D,MIN,31,77,2,30,32
13,8480336,Sean Walker,D,CAR,30,70,9,22,31
13,8481656,Aliaksei Protas,C,WSH,23,63,9,22,31
13,8476921,Jordan Martinook,L,CAR,32,63,9,22,31
13,8477506,Ryan Pulock,D,NYI,30,81,8,23,31
13,8481186,Logan O'Connor,R,COL,28,81,7,24,31
13,8483445,Cutter Gauthier,L,ANA,20,61,7,24,31
13,8478055,Gustav Forsling,D,FLA,28,68,5,26,31
13,8480281,Alexey Toropchenko,R,STL,25,63,18,12,30
13,8476981,Josh Anderson,R,MTL,30,70,17,13,30
13,8476438,Brandon Saad,L,STL,32,67,16,14,30
13,8477987,Ryan Donato,C,CHI,28,62,15,15,30
13,8482105,Jake Sanderson,D,OTT,22,70,15,15,30
13,8478432,Christian Fischer,R,DET,27,70,15,15,30
13,8480855,Jack McBain,C,UTA,24,66,14,16,30
13,8477505,Alexander Wennberg,C,SJS,30,61,14,16,30
13,8480068,Ryan Poehling,C,PHI,25,68,13,17,30
13,8480829,Jesperi Kotkaniemi,C,CAR,24,69,12,18,30
13,8478462,Nicolas Roy,C,VGK,27,75,12,18,30
13,8481524,Bowen Byram,D,BUF,23,60,9,21,30
13,8476854,Hampus Lindholm,D,BOS,30,76,6,24,30
13,8478397,Rasmus Andersson,D,CGY,28,74,4,26,30
13,8473422,Nick Foligno,L,CHI,37,59,16,13,29
13,8482092,Ridly Greig,C,OTT,22,77,15,14,29
13,8480078,Filip Chytil,C,NYR,25,70,15,14,29
13,8478020,Michael Amadio,R,OTT,28,66,15,14,29
13,8479941,Justin Danforth,R,CBJ,31,53,14,15,29
13,8481553,Bobby Brink,R,PHI,23,66,13,16,29
13,8475791,Taylor Hall,L,CHI,33,57,11,18,29
13,8484203,Bradly Nadeau,L,CAR,19,64,10,19,29
13,8476889,Radek Faksa,C,STL,30,56,9,20,29
13,8479398,Samuel Girard,D,COL,26,67,6,23,29
13,8477948,Travis Sanheim,D,PHI,28,68,4,25,29
13,8476923,Damon Severson,D,CBJ,30,81,3,26,29
13,8481582,Nicholas Robertson,L,TOR,23,72,18,10,28
13,8477952,Robby Fabbri,C,ANA,28,60,14,14,28
13,8476461,Sean Couturier,C,PHI,32,68,12,16,28
13,8483524,Shane Wright,C,SEA,20,65,12,16,28
13,8482475,Yegor Chinakhov,R,CBJ,23,61,10,18,28
13,8477953,Kasperi Kapanen,R,STL,28,62,10,18,28
13,8483565,Nick Blankenburg,D,NSH,26,63,10,18,28
13,8478891,Mason Appleton,C,WPG,28,60,9,19,28
13,8480113,Alex Iafallo,L,WPG,31,67,9,19,28
13,8476458,Ryan Strome,C,ANA,31,70,8,20,28
13,8475343,Nic Dowd,C,WSH,34,59,8,20,28
13,8476918,Jimmy Vesey,L,NYR,31,64,15,12,27
13,8476927,Teddy Blueger,C,VAN,30,62,12,15,27
13,8477511,Anthony Mantha,R,CGY,30,76,10,17,27
13,8479353,Brett Howden,C,VGK,26,69,10,17,27
13,8478911,Matt Roy,D,WSH,29,66,10,17,27
13,8482133,Thomas Bordeleau,C,SJS,22,63,9,18,27
13,8474189,Lars Eller,C,PIT,35,63,9,18,27
13,8478013,Jake Walman,D,SJS,28,70,9,18,27
13,8473507,Jeff Petry,D,DET,37,72,4,23,27
13,8480891,Michael Kesselring,D,UTA,24,63,4,23,27
13,8477969,Marcus Pettersson,D,PIT,28,80,3,24,27
13,8478508,Yakov Trenin,C,MIN,27,66,18,8,26
13,8475799,Nino Niederreiter,R,WPG,32,70,15,11,26
13,8476480,Vladislav Namestnikov,C,WPG,32,68,12,14,26
13,8477392,Hudson Fasching,R,NYI,29,68,12,14,26
13,8481093,Rafael Harvey-Pinard,L,MTL,25,65,12,14,26
13,8481704,Juuso Parssinen,C,NSH,23,55,12,14,26
13,8480835,Jack Drury,C,CAR,24,58,10,16,26
13,8479368,Max Jones,L,BOS,26,63,10,16,26
13,8483490,Pavel Mintyukov,D,ANA,21,72,9,17,26
13,8480043,Timothy Liljegren,D,TOR,25,61,2,24,26
13,8480873,Rasmus Sandin,D,WSH,24,65,2,24,26
13,8481601,Simon Holmstrom,R,NYI,23,69,16,9,25
13,8482679,Matt Coronato,R,CGY,22,66,16,9,25
13,8482079,Marco Rossi,C,MIN,23,58,13,12,25
13,8481535,Nils Hoglander,L,VAN,24,64,11,14,25
13,8482660,Kent Johnson,C,CBJ,22,61,10,15,25
13,8476474,Stefan Noesen,R,NJD,31,62,9,16,25
13,8474716,Jared Spurgeon,D,MIN,35,80,8,17,25
13,8474053,Logan Couture,C,SJS,35,56,8,17,25
13,8480021,Jack Studnicka,C,LAK,25,62,8,17,25
13,8476931,Jake McCabe,D,TOR,31,69,7,18,25
13,8476925,Colton Sissons,C,NSH,31,68,6,19,25
13,8476422,Mike Reilly,D,NYI,31,77,6,19,25
13,8476917,Adam Pelech,D,NYI,30,76,3,22,25
13,8476331,Dylan DeMelo,D,WPG,31,65,2,23,25
13,8475181,Nick Leddy,D,STL,33,69,1,24,25
13,8482074,Connor Zary,C,CGY,23,61,18,6,24
13,8480893,Kirill Marchenko,R,CBJ,24,63,15,9,24
13,8478413,Jordan Greenway,L,BUF,27,68,12,12,24
13,8479393,Noah Gregor,L,OTT,26,75,12,12,24
13,8482737,Zack Bolduc,C,STL,21,59,11,13,24
13,8476278,Colin Blackwell,C,DAL,31,75,10,14,24
13,8480144,David Kampf,C,TOR,29,68,9,15,24
13,8483468,Jiri Kulich,C,BUF,20,57,9,15,24
13,8478133,Jake Evans,C,MTL,28,66,8,16,24
13,8482111,Justin Barron,D,MTL,23,62,7,17,24
13,8478840,Will Borgen,D,SEA,28,66,5,19,24
13,8477488,Brett Pesce,D,NJD,30,74,5,19,24
13,8482655,Janis Moser,D,TBL,24,75,4,20,24
13,8477839,Conor Sheary,L,TBL,32,81,3,21,24
13,8474673,TJ Brodie,D,CHI,34,61,2,22,24
13,8479661,Tanner Jeannot,L,LAK,27,72,15,8,23
13,8478434,Keegan Kolesar,R,VGK,27,67,13,10,23
13,8481481,Blake Lizotte,C,PIT,27,64,12,11,23
13,8476897,Oskar Sundqvist,C,STL,30,67,10,13,23
13,8476392,Adam Lowry,C,WPG,31,65,10,13,23
13,8476960,Andreas Athanasiou,C,CHI,30,59,9,14,23
13,8480878,Nils Lundkvist,D,DAL,24,70,9,14,23
13,8480980,Connor Dewar,C,TOR,25,67,8,15,23
13,8476312,Josh Manson,D,COL,33,65,7,16,23
13,8480172,Jan Rutta,D,SJS,34,62,4,19,23
13,8476892,Colton Parayko,D,STL,31,63,3,20,23
13,8481032,Paul Cotter,C,NJD,25,62,14,8,22
13,8476469,Joel Armia,R,MTL,31,64,13,9,22
13,8477425,Miles Wood,L,COL,29,73,12,10,22
13,8481477,Nico Sturm,C,SJS,29,59,12,10,22
13,8476873,Mark Jankowski,C,NSH,30,59,12,10,22
13,8479996,Cody Glass,C,NSH,25,59,11,11,22
13,8479390,Taylor Raddysh,R,WSH,26,64,9,13,22
13,8480762,Eric Robinson,L,CAR,29,59,6,16,22
13,8481441,Joe Snively,C,DET,28,59,6,16,22
13,8478851,Alexandre Carrier,D,NSH,28,65,6,16,22
13,8482712,Oskar Olausson,R,COL,22,76,5,17,22
13,8482067,Connor Mackey,D,NYR,28,64,4,18,22
13,8478136,Jake Middleton,D,MIN,28,74,4,18,22
13,8477931,Tomas Nosek,L,FLA,32,62,16,5,21
13,8480448,Parker Kelly,L,COL,25,78,12,9,21
13,8476878,Zemgus Girgensons,C,TBL,30,80,11,10,21
13,8473533,Jordan Staal,C,CAR,36,62,9,12,21
13,8481161,Jake Christiansen,D,CBJ,25,56,9,12,21
13,8475171,Oliver Ekman-Larsson,D,TOR,33,60,7,14,21
13,8481013,Jonatan Berggren,R,DET,24,63,6,15,21
13,8479982,Conor Timmins,D,TOR,26,55,5,16,21
13,8481014,Alexander Romanov,D,NYI,24,80,5,16,21
13,8476879,Cody Ceci,D,EDM,31,66,4,17,21
13,8482762,Simon Edvinsson,D,DET,21,55,12,8,20
13,8480205,Emil Bemstrom,C,PIT,25,54,11,9,20
13,8480003,Jesper Boqvist,C,FLA,26,71,11,9,20
13,8474715,Cameron Atkinson,R,TBL,35,79,10,10,20
13,8479336,Carl Grundstrom,R,SJS,27,54,10,10,20
13,8477406,Mattias Janmark,C,EDM,32,66,10,10,20
13,8482259,Bobby McMann,C,TOR,28,56,9,11,20
13,8480995,Pontus Holmberg,R,TOR,25,56,9,11,20
13,8477478,William Carrier,L,CAR,30,54,9,11,20
13,8479370,Tyson Jost,C,CAR,26,54,9,11,20
13,8478463,Anthony Beauvillier,L,PIT,27,64,8,12,20
13,8480074,Alexandre Texier,C,STL,25,66,8,12,20
13,8477903,Garnet Hathaway,R,PHI,33,67,8,12,20
13,8480806,Isac Lundestrom,C,ANA,25,51,8,12,20
13,8478043,Sam Lafferty,C,BUF,29,58,8,12,20
13,8477499,Rasmus Ristolainen,D,PHI,30,62,5,15,20
13,8474166,Alec Martinez,D,CHI,37,52,4,16,20
13,8478507,John Marino,D,UTA,27,68,3,17,20
13,8482073,Braden Schneider,D,NYR,23,67,3,17,20
13,8476891,Matthew Grzelcyk,D,PIT,30,75,2,18,20
13,8481716,Dmitri Voronkov,L,CBJ,24,51,12,7,19
13,8482125,Alexander Holtz,R,VGK,22,65,11,8,19
13,8482117,Lukas Reichel,L,CHI,22,56,10,9,19
13,8475225,Craig Smith,C,CHI,35,50,10,9,19
13,8482101,Danil Gushchin,L,SJS,22,56,8,11,19
13,8473563,Nicklas Backstrom,C,WSH,37,57,7,12,19
13,8482624,Daniil Miromanov,D,CGY,27,66,5,14,19
13,8479998,Mikey Anderson,D,LAK,25,66,5,14,19
13,8476429,Scott Mayfield,D,NYI,32,72,5,14,19
13,8476902,Esa Lindell,D,DAL,30,73,4,15,19
13,8479639,Dylan Coghlan,D,WPG,26,66,2,17,19
13,8475324,Nick Jensen,D,OTT,34,72,2,17,19
13,8475208,Brian Dumoulin,D,ANA,33,66,1,18,19
13,8470621,Corey Perry,R,EDM,39,70,12,6,18
13,8483457,Lane Hutson,D,MTL,20,66,11,7,18
13,8478569,Noel Acciari,C,PIT,33,57,10,8,18
13,8480813,Joe Veleno,C,DET,24,79,10,8,18
13,8479315,Joey Anderson,R,CHI,26,51,9,9,18
13,8478109,Victor Olofsson,L,VGK,29,64,8,10,18
13,8482809,Jackson Blake,R,CAR,21,55,8,10,18
13,8475220,Marcus Foligno,L,MIN,33,59,7,11,18
13,8477979,Nicolas Aube-Kubel,R,BUF,28,59,7,11,18
13,8476988,Matt Benning,D,SJS,30,61,7,11,18
13,8482803,Olen Zellweger,D,ANA,21,65,7,11,18
13,8477220,Nate Schmidt,D,FLA,33,65,6,12,18
13,8482176,Wyatt Kaiser,D,CHI,22,54,6,12,18
13,8482245,Artem Zub,D,OTT,29,67,5,13,18
13,8474574,Tyler Myers,D,VAN,34,62,3,15,18
13,8478882,Vladislav Gavrikov,D,LAK,29,68,2,16,18
13,8480222,Sebastian Aho,D,PIT,28,74,2,16,18
13,8479316,Luke Kunin,C,SJS,27,50,9,8,17
13,8473453,Trevor Lewis,C,LAK,37,75,8,9,17
13,8475855,Jesper Fast,R,CAR,33,57,7,10,17
13,8482634,Alex Steeves,C,TOR,25,56,7,10,17
13,8475193,Tomas Tatar,L,NJD,34,66,6,11,17
13,8477919,Frederick Gaudreau,C,MIN,31,59,6,11,17
13,8478970,Jalen Chatfield,D,CAR,28,66,6,11,17
13,8479328,Julien Gauthier,R,NYI,27,56,6,11,17
13,8477508,Curtis Lazar,C,NJD,29,59,5,12,17
13,8482807,Ethan Del Mastro,D,CHI,21,47,5,12,17
13,8475231,Casey Cizikas,C,NYI,33,74,5,12,17
13,8475455,Brenden Dillon,D,NJD,34,62,5,12,17
13,8483491,Ivan Miroshnichenko,L,WSH,20,53,4,13,17
13,8480887,Jordan Harris,D,MTL,24,59,3,14,17
13,8481521,Ronnie Attard,D,PHI,25,48,3,14,17
13,8478859,Niko Mikkola,D,FLA,28,54,3,14,17
13,8475188,Brayden McNabb,D,VGK,33,57,2,15,17
13,8475462,Radko Gudas,D,ANA,34,64,2,15,17
13,8475690,Chris Tanev,D,TOR,35,61,2,15,17
13,8476329,Travis Boyd,C,MIN,31,54,2,15,17
13,8479619,Michael Carcone,L,UTA,28,63,11,5,16
13,8481789,Tye Kartye,L,SEA,23,38,11,5,16
13,8477446,Michael McCarron,R,NSH,29,54,10,6,16
13,8477380,Jonny Brodzinski,C,NYR,31,50,9,7,16
13,8478585,Derek Ryan,C,EDM,38,64,9,7,16
13,8480289,Morgan Barron,C,WPG,26,57,8,8,16
13,8483499,Liam Ohgren,L,MIN,20,52,6,10,16
13,8483482,Tristan Luneau,D,ANA,20,64,6,10,16
13,8476856,Mathew Dumba,D,DAL,30,71,6,10,16
13,8477435,Ryan Graves,D,PIT,29,75,5,11,16
13,8481617,Vasily Podkolzin,R,VAN,23,50,5,11,16
13,8475762,Derek Forbort,D,VAN,32,58,4,12,16
13,8479980,Nicolas Hague,D,VGK,26,56,3,13,16
13,8483493,Frank Nazar,C,CHI,20,51,3,13,16
13,8475790,Erik Gudbranson,D,CBJ,32,73,1,15,16
13,8475233,David Savard,D,MTL,34,60,1,15,16
13,8475179,Dmitry Kulikov,D,FLA,34,68,1,15,16
13,8470600,Ryan Suter,D,STL,39,68,0,16,16
13,8482077,Dylan Holloway,L,EDM,23,47,9,6,15
13,8477450,Jason Dickinson,C,CHI,29,53,8,7,15
13,8480025,MacKenzie Entwistle,R,FLA,25,57,8,7,15
13,8482157,Will Cuylle,L,NYR,22,65,7,8,15
13,8479718,Alex Barré-Boulet,C,MTL,27,51,7,8,15
13,8480011,Klim Kostin,C,SJS,25,53,7,8,15
13,8479520,Brandon Duhaime,R,WSH,27,54,6,9,15
13,8477369,Carson Soucy,D,VAN,30,60,5,10,15
13,8478452,Caleb Jones,D,LAK,27,55,4,11,15
13,8478178,Darren Raddysh,D,TBL,28,71,2,13,15
13,8479324,Ryan Lindgren,D,NYR,26,60,2,13,15
13,8479976,Juuso Valimaki,D,UTA,26,60,1,14,15
13,8479372,Joshua Mahura,D,SEA,26,55,1,14,15
13,8482148,Hendrix Lapierre,C,WSH,22,54,8,6,14
13,8479972,Mason Shaw,C,WPG,26,37,8,6,14
13,8478421,A.J. Greer,L,FLA,28,60,8,6,14
13,8481522,Peyton Krebs,C,BUF,23,54,7,7,14
13,8480789,Oliver Wahlstrom,R,NYI,24,66,6,8,14
13,8484149,Gavin Brindley,C,CBJ,20,44,5,9,14
13,8477353,Tyler Motte,C,DET,29,72,5,9,14
13,8480157,Calle Rosen,D,COL,30,50,5,9,14
13,8482730,Brandt Clarke,D,LAK,21,38,5,9,14
13,8481641,Joel Kiviranta,L,COL,28,73,5,9,14
13,8479344,Jesse Puljujarvi,R,PIT,26,54,4,10,14
13,8479359,Beck Malenstyn,L,BUF,26,47,4,10,14
13,8481708,Zac Jones,D,NYR,24,51,3,11,14
13,8471709,Marc-Edouard Vlasic,D,SJS,37,62,3,11,14
13,8476457,Adam Larsson,D,SEA,32,68,3,11,14
13,8480246,Nick Perbix,D,TBL,26,77,2,12,14
13,8480001,Urho Vaakanainen,D,ANA,25,55,2,12,14
13,8475718,Justin Holl,D,DET,32,56,2,12,14
13,8476994,Vinnie Hinostroza,C,NSH,30,43,2,12,14
13,8477365,Connor Clifton,D,BUF,29,58,2,12,14
13,8479402,Jake Bean,D,CGY,26,60,1,13,14
13,8481059,Scott Perunovich,D,STL,26,60,1,13,14
13,8480950,Ilya Lyubushkin,D,DAL,30,65,1,13,14
13,8480035,Henri Jokiharju,D,BUF,25,61,0,14,14
13,8476374,Sean Kuraly,C,CBJ,31,59,6,7,13
13,8479536,Axel Jonsson-Fjallby,L,WPG,26,39,6,7,13
13,8480355,Mark Kastelic,C,BOS,25,58,5,8,13
13,8481019,David Gustafsson,C,WPG,24,45,5,8,13
13,8474568,Luke Schenn,D,NSH,35,57,5,8,13
13,8479369,Andrew Peeke,D,BOS,26,57,4,9,13
13,8479066,Ryan Lomberg,L,CGY,30,61,4,9,13
13,8479414,Nathan Bastian,R,NJD,27,59,4,9,13
13,8479371,Dante Fabbro,D,NSH,26,59,3,10,13
13,8478416,Erik Cernak,D,TBL,27,70,3,10,13
13,8476441,Joel Edmundson,D,LAK,31,45,3,10,13
13,8479983,Mario Ferraro,D,SJS,26,72,2,11,13
13,8480073,Erik Brannstrom,D,COL,25,61,2,11,13
13,8482142,Jamie Drysdale,D,PHI,22,60,2,11,13
13,8480049,Dylan Samberg,D,WPG,25,62,1,12,13
13,8479944,Zach Aston-Reese,C,VGK,30,46,9,3,12
13,8482155,Alex Laferriere,R,LAK,23,53,8,4,12
13,8482784,Zach Dean,C,STL,21,47,7,5,12
13,8480252,Cole Guttman,C,CHI,25,39,6,6,12
13,8481517,Brett Leason,R,ANA,25,56,6,6,12
13,8482666,Scott Morrow,D,CAR,22,57,5,7,12
13,8482749,Joshua Roy,R,MTL,21,61,4,8,12
13,8481028,Martin Pospisil,C,CGY,25,55,4,8,12
13,8479671,Mathieu Olivier,R,CBJ,27,48,4,8,12
13,8482087,Kaiden Guhle,D,MTL,22,54,2,10,12
13,8480058,Pierre-Olivier Joseph,D,STL,25,55,2,10,12
13,8479348,Kale Clague,D,BUF,26,41,2,10,12
13,8475750,Jon Merrill,D,MIN,32,62,2,10,12
13,8484254,Akito Hirose,D,VAN,25,38,2,10,12
13,8478443,Brandon Carlo,D,BOS,28,60,1,11,12
13,8478468,Jeremy Lauzon,D,NSH,27,62,0,12,12
13,8479439,Jacob MacDonald,D,COL,31,52,7,4,11
13,8477573,Nathan Walker,L,STL,30,46,7,4,11
13,8475842,Sam Carrick,C,NYR,32,61,6,5,11
13,8480807,Mattias Samuelsson,D,BUF,24,61,6,5,11
13,8476934,Brock McGinn,L,ANA,30,52,6,5,11
13,8480292,Carson Meyer,R,ANA,27,34,6,5,11
13,8482165,Yan Kuznetsov,D,CGY,22,25,5,6,11
13,8482747,Brennan Othmann,L,NYR,21,41,5,6,11
13,8482744,James Malatesta,L,CBJ,21,45,5,6,11
13,8482192,Isaak Phillips,D,CHI,23,40,4,7,11
13,8477015,Connor Brown,R,EDM,30,61,4,7,11
13,8474034,Patrick Maroon,L,CHI,36,54,4,7,11
13,8479543,Michael Pezzetta,L,MTL,26,57,4,7,11
13,8480834,Ty Emberson,D,SJS,24,38,4,7,11
13,8482166,Shakir Mukhamadullin,D,SJS,22,53,4,7,11
13,8475279,Ben Chiarot,D,DET,33,63,3,8,11
13,8480192,Johnathan Kovacevic,D,NJD,27,51,2,9,11
13,8476467,Jamie Oleksiak,D,SEA,32,66,2,9,11
13,8476874,Olli Maatta,D,DET,30,65,2,9,11
13,8479986,Kole Lind,R,DAL,26,43,2,9,11
13,8480879,Jacob Bernard-Docker,D,OTT,24,52,1,10,11
13,8477507,Nikita Zadorov,D,BOS,29,62,0,11,11
13,8481178,Egor Zamula,D,PHI,24,54,0,11,11
13,8477401,John Hayden,C,SEA,29,39,9,1,10
13,8479981,Jonah Gadjovich,L,FLA,26,43,8,2,10
13,8481532,Alex Turcotte,C,LAK,23,49,7,3,10
13,8481518,Nolan Foote,L,NJD,24,39,6,4,10
13,8482511,Mason Lohrei,D,BOS,23,30,6,4,10
13,8479994,Jaret Anderson-Dolan,C,WPG,25,45,4,6,10
13,8475958,Michael Sgarbossa,C,WSH,32,36,4,6,10
13,8481527,Kaedan Korczak,D,VGK,23,50,3,7,10
13,8476525,Colin Miller,D,WPG,32,69,3,7,10
13,8481599,Victor Soderstrom,D,UTA,23,51,3,7,10
13,8474090,Brendan Smith,D,DAL,35,58,3,7,10
13,8480196,Jacob Bryson,D,BUF,27,39,3,7,10
13,8481122,Simon Benoit,D,TOR,26,45,3,7,10
13,8483495,Simon Nemec,D,NJD,20,55,2,8,10
13,8482861,Vincent Iorio,D,WSH,22,36,2,8,10
13,8478450,Parker Wotherspoon,D,BOS,27,37,2,8,10
13,8474567,Zach Bogosian,D,MIN,34,60,1,9,10
13,8475177,Calvin de Haan,D,COL,33,46,1,9,10
13,8473446,Erik Johnson,D,PHI,36,52,1,9,10
13,8477845,Trevor van Riemsdyk,D,WSH,33,58,0,10,10
13,8471817,Ryan Reaves,R,TOR,37,59,8,1,9
13,8476822,Luke Glendening,C,TBL,35,80,5,4,9
13,8479638,Justin Brazeau,R,BOS,26,44,5,4,9
13,8476867,Brendan Gaunce,C,MIN,30,42,5,4,9
13,8477962,Brendan Lemieux,L,CAR,28,41,4,5,9
13,8479772,Zack MacEwen,R,OTT,28,54,4,5,9
13,8482652,Walker Duehr,R,CGY,27,43,4,5,9
13,8478424,Jansen Harkins,C,ANA,27,37,4,5,9
13,8477527,Ross Johnston,L,ANA,30,33,4,5,9
13,8482733,Logan Mailloux,D,MTL,31,42,3,6,9
13,8475235,Nicolas Deslauriers,L,PHI,33,48,3,6,9
13,8478451,Ethan Bear,D,WSH,27,46,3,6,9
13,8479968,Vinni Lettieri,C,BOS,29,51,3,6,9
13,8481568,Alex Vlasic,D,CHI,23,53,2,7,9
13,8479026,Philippe Myers,D,TOR,27,50,2,7,9
13,8480845,Rasmus Kupari,C,WPG,24,37,2,7,9
13,8482095,Tyler Kleven,D,OTT,22,44,2,7,9
13,8481056,Spencer Stastney,D,NSH,24,32,1,8,9
13,8480441,Trey Fix-Wolansky,R,CBJ,25,36,6,2,8
13,8477938,Haydn Fleury,D,WPG,28,42,5,3,8
13,8482713,Mackie Samoskevich,R,FLA,22,44,5,3,8
13,8476913,Devin Shore,C,MIN,30,30,4,4,8
13,8481751,Lukas Rousek,R,BUF,25,36,4,4,8
13,8482145,Mavrik Bourque,C,DAL,22,59,4,4,8
13,8483630,Pavol Regenda,L,ANA,25,39,4,4,8
13,8478409,Anthony Richard,C,PHI,28,36,4,4,8
13,8482062,Cole Smith,L,NSH,29,51,3,5,8
13,8481754,Nikita Nesterenko,C,ANA,23,39,3,5,8
13,8482964,Arber Xhekaj,D,MTL,23,55,3,5,8
13,8481592,Jakob Pelletier,L,CGY,23,46,3,5,8
13,8478146,Matthew Highmore,C,OTT,28,40,3,5,8
13,8476967,Brett Kulak,D,EDM,30,63,2,6,8
13,8476442,Matt Nieto,L,PIT,32,49,2,6,8
13,8481537,Nikita Okhotiuk,D,CGY,24,46,2,6,8
13,8478399,Jonas Siegenthaler,D,NJD,27,55,2,6,8
13,8477018,Ben Hutton,D,VGK,31,33,2,6,8
13,8483466,Kevin Korchinski,D,CHI,20,54,2,6,8
13,8480007,Jonas Rondbjerg,R,VGK,25,38,1,7,8
13,8479378,Logan Stanley,D,WPG,26,45,1,7,8
13,8481167,Brayden Pachal,D,CGY,25,41,1,7,8
13,8474013,Ian Cole,D,UTA,35,50,0,8,8
13,8482451,Mikael Pyyhtia,L,CBJ,23,38,0,8,8
13,8476858,Phillip Di Giuseppe,L,VAN,31,42,6,1,7
13,8481679,Maxence Guenette,D,OTT,23,32,6,1,7
13,8478831,Kevin Stenlund,C,UTA,28,56,5,2,7
13,8482859,Zack Ostapchuk,C,OTT,21,50,4,3,7
13,8482659,Josh Doan,R,UTA,22,53,4,3,7
13,8476624,Barclay Goodrow,C,SJS,31,52,3,4,7
13,8479291,Kevin Rooney,C,CGY,31,49,2,5,7
13,8481701,Santeri Hatakka,D,NJD,23,36,2,5,7
13,8480848,Ty Dellandrea,C,SJS,24,44,2,5,7
13,8479442,Troy Stecher,D,EDM,30,49,2,5,7
13,8483763,Maksymilian Szuber,D,UTA,22,27,2,5,7
13,8483460,David Jiricek,D,CBJ,21,58,1,6,7
13,8480727,Zach Whitecloud,D,VGK,28,51,1,6,7
13,8476372,Nick Seeler,D,PHI,31,43,1,6,7
13,8481605,Jackson LaCombe,D,ANA,23,32,1,6,7
13,8480796,Martin Fehervary,D,WSH,25,48,0,7,7
13,8481609,Vladislav Kolyachonok,D,UTA,23,30,0,7,7
13,8483397,Marc McLaughlin,C,BOS,25,25,6,0,6
13,8477887,Patrick Brown,C,BOS,32,42,4,2,6
13,8476473,Connor Murphy,D,CHI,31,42,4,2,6
13,8480245,Olle Lycksell,R,PHI,25,30,4,2,6
13,8482201,Gage Goncalves,C,TBL,23,26,4,2,6
13,8476952,Dominic Toninato,C,WPG,30,33,3,3,6
13,8480844,Grigori Denisenko,L,VGK,24,34,3,3,6
13,8484287,Cole McWard,D,VAN,23,23,3,3,6
13,8480860,Kevin Bahl,D,CGY,24,56,2,4,6
13,8480880,Jakub Lauko,C,MIN,24,30,2,4,6
13,8482496,Nils Aman,C,VAN,24,42,2,4,6
13,8481567,Henry Thrun,D,SJS,23,54,2,4,6
13,8478211,Dryden Hunt,L,CGY,29,52,2,4,6
13,8477473,Justin Bailey,R,SJS,29,28,2,4,6
13,8484911,Collin Graf,R,SJS,22,49,2,4,6
13,8479985,Cale Fleury,D,SEA,26,30,2,4,6
13,8477034,Jaycob Megna,D,FLA,32,47,1,5,6
13,8474612,Travis Hamonic,D,OTT,34,56,1,5,6
13,8478021,William Lagesson,D,DET,28,33,1,5,6
13,8477851,Jordan Oesterle,D,BOS,32,46,0,6,6
13,8483570,Ben Meyers,C,SEA,26,27,5,0,5
13,8482751,Ryan Winterton,C,SEA,21,38,4,1,5
13,8482141,Lukas Cormier,D,VGK,22,28,4,1,5
13,8481598,Philip Broberg,D,EDM,23,44,3,2,5
13,8478017,Mark Friedman,D,VAN,29,35,3,2,5
13,8477149,Scott Sabourin,R,SJS,32,13,3,2,5
13,8481147,Reese Johnson,C,MIN,26,38,2,3,5
13,8483619,Filip Roos,D,OTT,25,32,2,3,5
13,8477810,Joel Hanley,D,CGY,33,28,2,3,5
13,8477482,Zachary Sanford,L,CHI,30,40,1,4,5
13,8477335,Kyle Burroughs,D,LAK,29,47,1,4,5
13,8479991,Jake Leschyshyn,C,NYR,25,19,1,4,5
13,8480823,Alexander Alexeyev,D,WSH,25,10,1,4,5
13,8477467,Gustav Olofsson,D,SEA,30,20,1,4,5
13,8482250,Callahan Burke,C,VGK,27,30,1,4,5
13,8478011,Louie Belpedio,D,PHI,28,21,0,5,5
13,8482177,Marat Khusnutdinov,C,MIN,22,39,3,1,4
13,8477070,Liam O'Brien,C,UTA,30,54,2,2,4
13,8482172,Landon Slaggert,L,CHI,22,22,2,2,4
13,8481024,Linus Karlsson,C,VAN,25,10,2,2,4
13,8481550,Adam Beckman,L,NJD,23,44,1,3,4
13,8482153,Brendan Brisson,C,VGK,23,30,1,3,4
13,8483012,Logan Morrison,C,SEA,22,38,1,3,4
13,8482765,Isak Rosen,R,BUF,21,29,1,3,4
13,8482070,Mitchell Chaffee,R,TBL,26,41,1,3,4
13,8482858,Ryker Evans,D,SEA,23,24,1,3,4
13,8483549,Lucas Condotta,L,MTL,27,30,0,4,4
13,8479249,Andrew Poturalski,C,SJS,30,29,0,4,4
13,8481600,Tobias Bjornfot,D,FLA,23,32,0,4,4
13,8477384,Joshua Brown,D,EDM,30,41,0,4,4
13,8479367,William Lockwood,R,FLA,26,22,2,1,3
13,8482929,Emil Lilleberg,D,TBL,23,20,2,1,3
13,8480468,James Hamblin,L,EDM,25,21,2,1,3
13,8483597,Milos Kelemen,L,UTA,25,12,2,1,3
13,8471677,Jack Johnson,D,CBJ,37,61,1,2,3
13,8480070,Ian Mitchell,D,BOS,25,46,1,2,3
13,8477244,Chad Ruhwedel,D,NYR,34,28,1,2,3
13,8482144,Jack Thompson,D,SJS,22,20,1,2,3
13,8479587,Rhett Gardner,C,PHI,28,18,1,2,3
13,8482516,Matthew Kessel,D,STL,24,26,1,2,3
13,8478454,Noah Juulsen,D,VAN,27,32,1,2,3
13,8481806,Louis Crevier,D,CHI,23,18,1,2,3
13,8484325,Waltteri Merela,C,TBL,26,26,1,2,3
13,8474062,Riley Nash,C,NYR,35,18,1,2,3
13,8478881,Brett Seney,L,CHI,28,16,1,2,3
13,8482147,Jean-Luc Foudy,C,COL,22,27,0,3,3
13,8475413,Justin Dowling,C,NJD,34,15,0,3,3
13,8479379,Givani Smith,R,SJS,26,29,2,0,2
13,8481462,Mason Morelli,L,VGK,28,12,2,0,2
13,8477462,Robert Hagg,D,VGK,29,31,2,0,2
13,8484258,Sam Malinski,D,COL,26,23,2,0,2
13,8480032,Shane Bowers,C,NJD,25,8,2,0,2
13,8483489,Fraser Minten,C,TOR,31,12,2,0,2
13,8481543,Nikita Alexandrov,C,STL,24,18,1,1,2
13,8481556,John Beecher,C,BOS,23,38,1,1,2
13,8480851,Akil Thomas,C,LAK,24,16,1,1,2
13,8482470,Ilya Solovyov,D,CGY,24,22,1,1,2
13,8481422,Jake Lucchini,C,NSH,29,16,1,1,2
13,8477073,Kurtis MacDermid,L,NJD,30,27,1,1,2
13,8481593,Jayden Struble,D,MTL,23,21,1,1,2
13,8481578,Graeme Clarke,R,MIN,23,8,1,1,2
13,8480874,Adam Ginning,D,PHI,24,9,1,1,2
13,8481030,Jack St. Ivany,D,PIT,25,13,1,1,2
13,8478051,Max Willman,C,NJD,29,20,1,1,2
13,8482088,Justin Sourdif,R,FLA,22,15,1,1,2
13,8479419,Brett Murray,L,BUF,26,13,1,1,2
13,8483512,Matthew Savoie,C,EDM,20,23,0,2,2
13,8481541,Samuel Bolduc,D,NYI,24,22,0,2,2
13,8475795,Dylan McIlrath,D,WSH,32,20,0,2,2
13,8480990,Declan Chisholm,D,MIN,24,37,1,0,1
13,8477320,Anton Blidh,L,NYR,29,20,1,0,1
13,8480870,Bo Groulx,C,NYR,24,26,1,0,1
13,8481699,Aku Raty,R,UTA,23,11,1,0,1
13,8481006,Tyler Tucker,D,STL,24,14,1,0,1
13,8481726,Adam Edstrom,C,NYR,24,7,1,0,1
13,8482118,Sam Colangelo,R,ANA,23,17,1,0,1
13,8483567,Georgii Merkulov,C,BOS,24,15,1,0,1
13,8481043,Cole Koepke,L,BOS,26,13,1,0,1
13,8481719,Maxwell Crozier,D,TBL,24,16,1,0,1
13,8481065,Angus Crookshank,L,OTT,25,17,1,0,1
13,8478446,Glenn Gawdin,C,LAK,27,13,1,0,1
13,8479362,Riley Tufte,L,BOS,26,16,1,0,1
13,8482460,Matt Rempe,C,NYR,22,15,1,0,1
13,8480306,Grant Hutton,D,NYI,29,7,1,0,1
13,8475780,Chris Wagner,R,COL,33,11,1,0,1
13,8479330,Brandon Gignac,C,MTL,27,11,1,0,1
13,8481564,Ryan Johnson,D,BUF,23,13,0,1,1
13,8482102,Vasily Ponomarev,C,PIT,22,12,0,1,1
13,8477971,Andreas Englund,D,LAK,28,28,0,1,1
13,8475755,Alexander Petrovic,D,DAL,32,10,0,1,1
13,8481237,Kyle MacLean,C,NYI,25,23,0,1,1
13,8480267,Sammy Walker,C,MIN,25,18,0,1,1
13,8482061,Brandon Biro,L,SEA,26,10,0,1,1
13,8483471,Brad Lambert,C,WPG,31,5,0,1,1
13,8479576,Vincent Desharnais,D,VAN,28,36,0,1,1
13,8478502,Dennis Gilbert,D,BUF,28,18,0,1,1
13,8480084,Nick DeSimone,D,NJD,30,22,0,1,1
13,8477993,Justin Kirkland,C,CGY,28,5,0,1,1
13,8482476,Emil Heineman,L,MTL,23,6,0,1,1
13,8483920,Pierrick Dube,R,WSH,23,7,0,1,1
13,8480890,Jan Jenik,C,OTT,24,26,0,0,0
13,8479320,Maxime Lajoie,D,SEA,27,19,0,0,0
13,8478477,Mitchell Stephens,C,SEA,27,13,0,0,0
13,8478874,Adam Gaudette,R,OTT,28,32,0,0,0
13,8481743,Marc Del Gaizo,D,NSH,25,14,0,0,0
13,8482162,Roby Jarventie,L,EDM,22,15,0,0,0
13,8481206,John Ludvig,D,PIT,24,9,0,0,0
13,8478854,Ryan Shea,D,PIT,27,6,0,0,0
13,8483432,Luca Del Bel Belluz,C,CBJ,31,4,0,0,0
13,8481585,Egor Afanasyev,L,SJS,23,13,0,0,0
13,8482197,Adam Raska,R,MIN,23,2,0,0,0
13,8483407,Brandon Scanlin,D,NYR,25,7,0,0,0
13,8481655,Cole Schwindt,R,CGY,23,4,0,0,0
13,8476323,Max McCormick,L,SEA,32,3,0,0,0
13,8483609,Adam Klapka,R,CGY,24,2,0,0,0
13,8482787,Nikita Chibrikov,R,WPG,31,8,0,0,0
13,8482094,Daemon Hunt,D,MIN,22,12,0,0,0
13,8484304,Uvis Balinskis,D,FLA,28,11,0,0,0
13,8480075,Cameron Crotty,D,MIN,25,8,0,0,0
13,8484259,Ondrej Pavel,C,COL,31,2,0,0,0
13,8483395,Arshdeep Bains,L,VAN,23,9,0,0,0
13,8484321,Nikolas Matinpalo,D,OTT,26,0,0,0,0
13,8484255,Jason Polin,R,COL,25,3,0,0,0
13,8481534,Raphael Lavoie,C,EDM,24,2,0,0,0
13,8483398,Declan Carlile,D,TBL,31,4,0,0,0
13,8479522,Hardy Haman Aktell,D,WSH,26,3,0,0,0
13,8484326,Patrik Koch,D,UTA,28,2,0,0,0
13,8477541,Dakota Mermis,D,TOR,30,14,0,0,0
13,8478147,Bokondji Imama,L,PIT,28,3,0,0,0
13,8483546,Marshall Rifai,D,TOR,26,4,0,0,0
13,8482126,Emil Andrae,D,PHI,31,3,0,0,0
13,8479421,Jacob Moverare,D,LAK,26,11,0,0,0
13,8483531,Brian Halonen,L,NJD,25,2,0,0,0
13,8470794,Joe Pavelski,C,,40,0,0,0,0
13,8479321,Lucas Johansen,D,,27,0,0,0,0
13,8477950,Tony DeAngelo,D,,29,0,0,0,0
13,8471218,Blake Wheeler,R,,38,0,0,0,0
13,8475197,Tyson Barrie,D,,33,0,0,0,0
13,8474157,Max Pacioretty,L,,36,0,0,0,0
13,8475744,Evgeny Kuznetsov,C,,32,0,0,0,0
13,8474037,James van Riemsdyk,L,,35,0,0,0,0
13,8476907,Mackenzie MacEachern,L,,30,0,0,0,0
13,8480216,Jacob Peterson,C,,25,0,0,0,0
13,8474602,Justin Schultz,D,,34,0,0,0,0
13,8482222,Alexander Barabanov,L,,30,0,0,0,0
13,8474031,Kevin Shattenkirk,D,,35,0,0,0,0
13,8477330,Dominik Kubalik,L,,29,0,0,0,0
13,8480884,Calen Addison,D,,24,0,0,0,0
13,8475906,John Klingberg,D,,32,0,0,0,0
13,8480008,Adam Ruzicka,C,,25,0,0,0,0
13,8476884,Derrick Pouliot,D,,30,0,0,0,0
13,8476919,Chris Tierney,C,,30,0,0,0,0
13,8479415,Michael McLeod,C,,26,0,0,0,0
13,8474870,Tyler Johnson,C,,34,0,0,0,0
13,8470604,Jeff Carter,C,,39,0,0,0,0
13,8478104,Sammy Blais,L,,28,0,0,0,0
13,8474884,Mike Hoffman,C,,35,0,0,0,0
13,8481591,Sam Poulin,R,,23,0,0,0,0
13,8471274,Alex Goligoski,D,,39,0,0,0,0
13,8476871,Tanner Pearson,L,,32,0,0,0,0
13,8476393,Nick Cousins,C,,31,0,0,0,0
13,8479977,Kailer Yamamoto,R,,26,0,0,0,0
13,8479346,Dillon Dube,C,,26,0,0,0,0
13,8480184,Gustav Lindstrom,D,,26,0,0,0,0
13,8479376,Victor Mete,D,,26,0,0,0,0
13,8473449,Kyle Okposo,R,,36,0,0,0,0
13,8481058,Jesse Ylonen,R,,25,0,0,0,0
13,8475752,Tyler Pitlick,C,,33,0,0,0,0
13,8481239,Samuel Fagemo,L,,24,0,0,0,0
13,8480821,Filip Zadina,R,,25,0,0,0,0
13,8470966,Mark Giordano,D,,41,0,0,0,0
13,8478495,Denis Gurianov,R,,27,0,0,0,0
13,8477464,Nic Petan,C,,29,0,0,0,0
13,8478099,Kevin Labanc,R,,29,0,0,0,0
13,8482241,Radim Zohorna,L,,28,0,0,0,0
13,8474040,Sam Gagner,C,,35,0,0,0,0
13,8479514,Rem Pitlick,C,,27,0,0,0,0
13,8478430,Oliver Kylington,D,,27,0,0,0,0
13,8479533,Joona Koppanen,L,,26,0,0,0,0
13,8479984,Cal Foote,D,,26,0,0,0,0
13,8477126,Jayson Megna,C,,34,0,0,0,0
13,8475164,Jakob Silfverberg,R,,34,0,0,0,0
13,8474009,Nick Bonino,C,,36,0,0,0,0
13,8479458,Nikita Zaitsev,D,,33,0,0,0,0
13,8477944,Jakub Vrana,L,,28,0,0,0,0
13,8471699,Andrew Cogliano,C,,37,0,0,0,0
13,8478067,Oskar Lindblom,L,,28,0,0,0,0
13,8471686,Marc Staal,D,,37,0,0,0,0
13,8470610,Zach Parise,L,,40,0,0,0,0
13,8478904,Steven Lorentz,C,,28,0,0,0,0
13,8473473,Milan Lucic,L,,36,0,0,0,0
13,8480031,Maxime Comtois,L,,25,0,0,0,0
13,8478512,Austin Czarnik,C,,32,0,0,0,0
13,8473504,Cal Clutterbuck,R,,37,0,0,0,0
13,8477454,Adam Erne,L,,29,0,0,0,0
13,8479383,Boris Katchouk,L,,26,0,0,0,0
13,8475825,Jani Hakanpää,D,,32,0,0,0,0
13,8477846,Ryan Carpenter,C,,33,0,0,0,0
13,8477930,Pierre-Edouard Bellemare,L,,39,0,0,0,0
13,8478400,Colin White,C,,27,0,0,0,0
13,8480226,Marián Studenic,R,,26,0,0,0,0
13,8480853,Liam Foudy,C,,24,0,0,0,0
13,8475797,Jarred Tinordi,D,,32,0,0,0,0
13,8479423,Alex Nylander,L,,26,0,0,0,0
13,8474618,Marco Scandella,D,,34,0,0,0,0
13,8478028,Fredrik Olofsson,L,,28,0,0,0,0
13,8474709,Matt Martin,L,,35,0,0,0,0
13,8481070,Hugh McGing,L,,26,0,0,0,0
13,8479546,Oskar Steen,C,,26,0,0,0,0
13,8474145,Robert Bortuzzo,D,,35,0,0,0,0
13,8476915,Jujhar Khaira,L,,30,0,0,0,0
13,8480274,Philip Kemp,D,EDM,25,0,0,0,0
13,8475278,Byron Froese,C,,33,0,0,0,0
13,8481812,Nikolai Knyzhov,D,,27,0,0,0,0
13,8478408,Travis Dermott,D,,28,0,0,0,0
13,8481077,John Leonard,L,,26,0,0,0,0
13,8479547,Matthew Phillips,R,,26,0,0,0,0
13,8480836,Jonathan Gruden,C,,24,0,0,0,0
13,8481690,Tyler Angle,C,,24,0,0,0,0
13,8475766,Austin Watson,L,,32,0,0,0,0
13,8481016,Ruslan Iskhakov,C,,24,0,0,0,0
13,8478078,Rourke Chartier,C,,28,0,0,0,0
13,8483401,Marc Johnstone,R,PIT,28,5,0,0,0
13,8480776,Sheldon Rempal,R,,29,0,0,0,0
13,8478956,Samuel Laberge,L,NJD,27,0,0,0,0
13,8483045,Cameron Butler,R,CBJ,31,2,0,0,0
13,8484314,Jiri Smejkal,L,,28,0,0,0,0
14,8478402,Connor McDavid,C,EDM,27,78,45,128,173
14,8476453,Nikita Kucherov,R,TBL,31,82,46,93,139
14,8477492,Nathan MacKinnon,C,COL,29,82,53,82,135
14,8477934,Leon Draisaitl,C,EDM,29,79,54,74,128
14,8481559,Jack Hughes,C,NJD,23,71,37,78,115
14,8479318,Auston Matthews,C,TOR,27,79,57,52,109
14,8478483,Mitch Marner,R,TOR,27,78,38,70,108
14,8479314,Matthew Tkachuk,L,FLA,27,77,31,77,108
14,8484144,Connor Bedard,C,CHI,19,73,44,60,104
14,8477956,David Pastrnak,R,BOS,28,80,39,62,101
14,8471675,Sidney Crosby,C,PIT,37,76,36,64,100
14,8480023,Robert Thomas,C,STL,25,77,25,73,98
14,8476887,Filip Forsberg,L,NSH,30,74,47,50,97
14,8477404,Jake Guentzel,C,TBL,30,82,35,61,96
14,8477493,Aleksander Barkov,C,FLA,29,78,33,61,94
14,8474600,Roman Josi,D,NSH,34,78,32,62,94
14,8478010,Brayden Point,C,TBL,28,82,47,46,93
14,8477946,Dylan Larkin,C,DET,28,78,34,59,93
14,8476468,J.T. Miller,C,VAN,31,78,33,58,91
14,8480801,Brady Tkachuk,L,OTT,25,79,38,52,90
14,8476389,Vincent Trocheck,C,NYR,31,79,34,56,90
14,8476346,Johnny Gaudreau,L,CBJ,31,72,21,69,90
14,8478420,Mikko Rantanen,R,COL,28,82,39,50,89
14,8479385,Jordan Kyrou,C,STL,26,73,35,54,89
14,8480012,Elias Pettersson,C,VAN,26,75,33,56,89
14,8478864,Kirill Kaprizov,L,MIN,27,78,32,57,89
14,8478550,Artemi Panarin,L,NYR,33,74,29,60,89
14,8474141,Patrick Kane,R,DET,36,82,25,64,89
14,8480800,Quinn Hughes,D,VAN,25,74,11,77,88
14,8475172,Nazem Kadri,C,CGY,34,81,35,52,87
14,8479407,Jesper Bratt,L,NJD,26,75,28,59,87
14,8480002,Nico Hischier,C,NJD,25,75,37,49,86
14,8476460,Mark Scheifele,C,WPG,31,71,36,50,86
14,8476454,Ryan Nugent-Hopkins,C,EDM,31,80,28,58,86
14,8478398,Kyle Connor,L,WPG,28,71,45,40,85
14,8477939,William Nylander,R,TOR,28,78,28,57,85
14,8479343,Clayton Keller,R,UTA,26,76,37,47,84
14,8474564,Steven Stamkos,C,NSH,34,77,35,49,84
14,8477402,Pavel Buchnevich,L,STL,29,78,37,46,83
14,8480027,Jason Robertson,L,DAL,25,81,28,55,83
14,8478460,Zach Werenski,D,CBJ,27,81,20,63,83
14,8475166,John Tavares,C,TOR,34,81,42,40,82
14,8478414,Timo Meier,R,NJD,28,72,42,39,81
14,8479675,Trevor Moore,L,LAK,29,80,38,43,81
14,8477933,Sam Reinhart,C,FLA,29,78,37,44,81
14,8475810,Bryan Rust,R,PIT,32,74,33,47,80
14,8479337,Alex DeBrincat,R,DET,27,80,36,43,79
14,8477960,Adrian Kempe,R,LAK,28,82,35,43,78
14,8480839,Rasmus Dahlin,D,BUF,24,74,16,62,78
14,8477501,Valeri Nichushkin,R,COL,29,81,36,41,77
14,8477942,Kevin Fiala,L,LAK,28,82,29,48,77
14,8475913,Mark Stone,R,VGK,32,75,29,48,77
14,8475184,Chris Kreider,L,NYR,33,76,39,37,76
14,8476539,Jonathan Marchessault,R,NSH,34,79,30,46,76
14,8478445,Mathew Barzal,C,NYI,27,78,18,58,76
14,8477456,J.T. Compher,L,DET,29,82,31,44,75
14,8482684,Luke Hughes,D,NJD,21,75,6,69,75
14,8478403,Jack Eichel,C,VGK,28,75,39,35,74
14,8479542,Brandon Hagel,L,TBL,26,82,35,38,73
14,8475170,Brayden Schenn,C,STL,33,74,35,38,73
14,8480036,Miro Heiskanen,D,DAL,25,74,14,59,73
14,8475167,Victor Hedman,D,TBL,34,79,13,60,73
14,8473419,Brad Marchand,L,BOS,36,77,35,37,72
14,8478427,Sebastian Aho,C,CAR,27,76,29,43,72
14,8475784,Jeff Skinner,C,EDM,32,77,29,43,72
14,8480830,Andrei Svechnikov,R,CAR,24,74,28,44,72
14,8477949,Alex Tuch,R,BUF,28,75,26,46,72
14,8478444,Brock Boeser,R,VAN,27,75,39,32,71
14,8471214,Alex Ovechkin,L,WSH,39,76,32,39,71
14,8475786,Zach Hyman,L,EDM,32,75,32,39,71
14,8477409,Carter Verhaeghe,C,FLA,29,79,30,41,71
14,8482116,Tim Stützle,C,OTT,22,80,24,47,71
14,8471215,Evgeni Malkin,C,PIT,38,69,31,39,70
14,8471685,Anze Kopitar,C,LAK,37,81,21,49,70
14,8476456,Jonathan Huberdeau,C,CGY,31,81,20,50,70
14,8477951,Nick Schmaltz,C,UTA,28,80,27,42,69
14,8482093,Seth Jarvis,C,CAR,22,74,34,34,68
14,8478439,Travis Konecny,R,PHI,27,75,30,38,68
14,8475168,Matt Duchene,C,DAL,33,82,23,45,68
14,8477504,Josh Morrissey,D,WPG,29,72,16,52,68
14,8477935,Sam Bennett,C,FLA,28,76,35,32,67
14,8478975,Mason Marchment,L,DAL,29,81,25,42,67
14,8480069,Cale Makar,D,COL,26,68,21,46,67
14,8481540,Cole Caufield,R,MTL,23,74,32,34,66
14,8481068,Yegor Sharangovich,C,CGY,26,77,29,37,66
14,8480018,Nick Suzuki,C,MTL,25,76,24,42,66
14,8480208,Drake Batherson,R,OTT,26,77,21,45,66
14,8474578,Erik Karlsson,D,PIT,34,76,19,47,66
14,8476432,Boone Jenner,C,CBJ,31,70,35,29,64
14,8476853,Morgan Rielly,D,TOR,30,74,12,52,64
14,8480865,Noah Dobson,D,NYI,24,81,12,52,64
14,8482699,Dylan Guenther,R,UTA,21,78,33,30,63
14,8475726,Tyler Toffoli,C,SJS,32,76,29,34,63
14,8483515,Juraj Slafkovsky,L,MTL,20,78,24,39,63
14,8476459,Mika Zibanejad,C,NYR,31,71,21,42,63
14,8479420,Tage Thompson,C,BUF,27,68,40,22,62
14,8475765,Vladimir Tarasenko,R,DET,33,79,33,29,62
14,8474586,Jordan Eberle,R,SEA,34,75,27,35,62
14,8475798,Mikael Granlund,C,SJS,32,68,21,41,62
14,8475692,Mats Zuccarello,R,MIN,37,74,15,47,62
14,8479425,Filip Hronek,D,VAN,27,80,8,54,62
14,8478401,Pavel Zacha,C,BOS,27,79,27,34,61
14,8477940,Nikolaj Ehlers,L,WPG,28,69,26,35,61
14,8478440,Dylan Strome,C,WSH,27,70,24,37,61
14,8477416,Oliver Bjorkstrand,R,SEA,29,75,23,38,61
14,8475754,Brock Nelson,C,NYI,33,80,33,26,59
14,8477955,Jared McCann,L,SEA,28,74,27,32,59
14,8479999,Casey Mittelstadt,C,COL,26,82,17,42,59
14,8479323,Adam Fox,D,NYR,26,71,14,45,59
14,8482745,Mason McTavish,C,ANA,21,76,25,33,58
14,8481557,Matt Boldy,L,MIN,23,68,20,38,58
14,8478449,Roope Hintz,C,DAL,28,82,33,24,57
14,8474641,Adam Henrique,C,EDM,34,75,33,24,57
14,8478873,Troy Terry,R,ANA,27,72,22,35,57
14,8480803,Evan Bouchard,D,EDM,25,75,14,43,57
14,8480014,Gabriel Vilardi,C,WPG,25,68,34,22,56
14,8473512,Claude Giroux,R,OTT,36,79,21,35,56
14,8476881,Tomas Hertl,C,VGK,31,75,20,36,56
14,8480039,Martin Necas,C,CAR,25,68,20,36,56
14,8478407,Vince Dunn,D,SEA,28,76,13,43,56
14,8475169,Evander Kane,L,EDM,33,73,30,25,55
14,8473986,Alex Killorn,L,ANA,35,71,30,25,55
14,8477998,Warren Foegele,L,LAK,28,80,25,30,55
14,8477497,Sean Monahan,C,CBJ,30,67,24,31,55
14,8474150,Mikael Backlund,C,CGY,35,73,21,34,55
14,8476448,William Karlsson,C,VGK,31,78,18,37,55
14,8476399,Blake Coleman,C,CGY,33,77,28,26,54
14,8482667,William Eklund,L,SJS,22,68,23,31,54
14,8476479,Phillip Danault,C,LAK,31,82,22,32,54
14,8481533,Trevor Zegras,C,ANA,23,72,18,36,54
14,8478469,Thomas Chabot,D,OTT,27,71,13,41,54
14,8482740,Wyatt Johnston,C,DAL,21,82,28,25,53
14,8477964,Ivan Barbashev,C,VGK,29,74,25,28,53
14,8483808,Andrei Kuzmenko,L,CGY,28,78,23,30,53
14,8477494,Jonathan Drouin,L,COL,29,81,14,39,53
14,8475287,Erik Haula,L,NJD,33,68,29,23,52
14,8478498,Jake DeBrusk,L,VAN,28,74,26,26,52
14,8478519,Anthony Cirelli,C,TBL,27,82,25,27,52
14,8482665,Matty Beniers,C,SEA,22,75,22,30,52
14,8476462,Dougie Hamilton,D,NJD,31,69,16,36,52
14,8478397,Rasmus Andersson,D,CGY,28,74,11,41,52
14,8477500,Bo Horvat,C,NYI,29,79,30,21,51
14,8477407,Anthony Duclair,L,NYI,29,78,24,27,51
14,8477511,Anthony Mantha,R,CGY,30,76,24,27,51
14,8481560,Arthur Kaliyev,R,LAK,23,78,23,28,51
14,8483431,Logan Cooley,C,UTA,20,77,22,29,51
14,8478042,Viktor Arvidsson,L,EDM,31,75,20,31,51
14,8476882,Teuvo Teravainen,C,CHI,30,69,18,33,51
14,8475745,Charlie Coyle,C,BOS,32,80,17,34,51
14,8476905,Chandler Stephenson,C,SEA,30,77,14,37,51
14,8481711,Matias Maccelli,L,UTA,24,76,14,37,51
14,8471724,Kris Letang,D,PIT,37,81,12,39,51
14,8482078,Lucas Raymond,L,DET,22,78,20,30,50
14,8482149,Cole Perfetti,C,WPG,22,72,17,33,50
14,8477346,MacKenzie Weegar,D,CGY,30,74,12,38,50
14,8470613,Brent Burns,D,CAR,39,77,6,44,50
14,8478366,Frank Vatrano,R,ANA,30,74,25,24,49
14,8474102,David Perron,L,OTT,36,81,18,31,49
14,8477986,Brandon Montour,D,SEA,30,74,17,32,49
14,8477932,Aaron Ekblad,D,FLA,28,73,12,37,49
14,8482110,Dawson Mercer,C,NJD,23,71,28,20,48
14,8480064,Josh Norris,C,OTT,25,78,26,22,48
14,8475768,Jaden Schwartz,C,SEA,32,69,21,27,48
14,8478474,Lawson Crouse,L,UTA,27,74,29,18,47
14,8482109,Alexis Lafrenière,L,NYR,23,70,20,27,47
14,8478493,Joel Eriksson Ek,C,MIN,27,73,19,28,47
14,8474679,Gustav Nyquist,C,NSH,35,73,16,31,47
14,8479410,Mikhail Sergachev,D,UTA,26,66,11,36,47
14,8477503,Max Domi,C,TOR,29,79,10,37,47
14,8476958,Jaccob Slavin,D,CAR,30,75,9,38,47
14,8484166,Adam Fantilli,C,CBJ,20,73,21,25,46
14,8482124,Quinton Byfield,R,LAK,22,79,18,28,46
14,8480798,Philipp Kurashev,C,CHI,25,61,18,28,46
14,8481542,Moritz Seider,D,DET,23,75,10,36,46
14,8476880,Tom Wilson,R,WSH,30,71,23,22,45
14,8477496,Elias Lindholm,C,BOS,30,80,20,25,45
14,8478047,Michael Bunting,L,PIT,29,71,20,25,45
14,8482113,Anton Lundell,C,FLA,23,78,18,27,45
14,8479345,Jakob Chychrun,D,WSH,26,64,11,34,45
14,8477447,Shea Theodore,D,VGK,29,63,11,34,45
14,8481604,Pavel Dorofeyev,L,VGK,24,66,24,20,44
14,8477479,Tyler Bertuzzi,L,CHI,29,70,20,24,44
14,8479400,Pierre-Luc Dubois,L,WSH,26,69,17,27,44
14,8482720,Matthew Knies,L,TOR,22,78,16,28,44
14,8477444,Andre Burakovsky,L,SEA,29,72,15,29,44
14,8476875,Mike Matheson,D,MTL,30,75,13,31,44
14,8478055,Gustav Forsling,D,FLA,28,69,12,32,44
14,8479325,Charlie McAvoy,D,BOS,27,73,8,36,44
14,8475314,Anders Lee,L,NYI,34,77,29,14,43
14,8480015,Owen Tippett,R,PHI,25,76,25,18,43
14,8481596,Shane Pinto,C,OTT,24,75,22,21,43
14,8478472,Mathieu Joseph,R,STL,27,72,18,25,43
14,8475763,Kevin Hayes,R,PIT,32,71,18,25,43
14,8475191,Reilly Smith,R,NYR,33,74,17,26,43
14,8475753,Justin Faulk,D,STL,32,74,17,26,43
14,8478396,Noah Hanifin,D,VGK,27,66,10,33,43
14,8475764,Cam Fowler,D,ANA,33,77,6,37,43
14,8476483,Rickard Rakell,R,PIT,31,69,23,19,42
14,8482159,Tyson Foerster,R,PHI,22,75,22,20,42
14,8478462,Nicolas Roy,C,VGK,27,74,21,21,42
14,8479525,Ross Colton,C,COL,28,80,19,23,42
14,8484153,Leo Carlsson,C,ANA,20,69,18,24,42
14,8473994,Jamie Benn,L,DAL,35,82,16,26,42
14,8481528,Dylan Cozens,C,BUF,23,72,16,26,42
14,8475794,Tyler Seguin,C,DAL,32,81,15,27,42
14,8478466,Daniel Sprong,R,VAN,27,69,15,27,42
14,8475151,Kyle Palmieri,C,NYI,33,76,14,28,42
14,8476826,Yanni Gourde,C,SEA,33,73,12,30,42
14,8474590,John Carlson,D,WSH,34,71,10,32,42
14,8477498,Darnell Nurse,D,EDM,29,75,9,33,42
14,8478500,Ivan Provorov,D,CBJ,27,81,4,38,42
14,8471698,T.J. Oshie,R,WSH,38,61,23,18,41
14,8475848,Brendan Gallagher,R,MTL,32,68,19,22,41
14,8482702,Logan Stankoven,C,DAL,21,82,15,26,41
14,8484145,Zach Benson,L,BUF,19,72,14,27,41
14,8477021,Alex Kerfoot,C,UTA,30,69,13,28,41
14,8478038,Devon Toews,D,COL,30,64,13,28,41
14,8476869,Brady Skjei,D,NSH,30,72,8,33,41
14,8477426,Nicholas Paul,L,TBL,29,82,21,19,40
14,8477429,Andrew Copp,C,DET,30,81,20,20,40
14,8479339,Patrik Laine,L,CBJ,26,68,16,24,40
14,8477953,Kasperi Kapanen,R,STL,28,69,16,24,40
14,8476292,Ondrej Palat,L,NJD,33,66,15,25,40
14,8480434,Sean Durzi,D,UTA,26,69,6,34,40
14,8475799,Nino Niederreiter,R,WPG,32,67,17,22,39
14,8479992,Michael Rasmussen,C,DET,25,78,16,23,39
14,8475158,Ryan O'Reilly,C,NSH,33,68,11,28,39
14,8477451,Ryan Hartman,R,MIN,30,68,22,16,38
14,8482175,JJ Peterka,R,BUF,22,64,20,18,38
14,8476438,Brandon Saad,L,STL,32,68,19,19,38
14,8478057,Dakota Joshua,C,VAN,28,67,17,21,38
14,8481186,Logan O'Connor,R,COL,28,80,17,21,38
14,8478856,Conor Garland,R,VAN,28,72,15,23,38
14,8477969,Marcus Pettersson,D,PIT,28,77,4,34,38
14,8480459,Pius Suter,C,VAN,28,67,20,17,37
14,8480078,Filip Chytil,C,NYR,25,69,18,19,37
14,8478438,Tommy Novak,C,NSH,27,65,16,21,37
14,8475760,Nick Bjugstad,C,UTA,32,73,15,22,37
14,8480220,Noah Cates,L,PHI,25,69,15,22,37
14,8481581,Thomas Harley,D,DAL,23,79,14,23,37
14,8477476,Artturi Lehkonen,L,COL,29,78,18,18,36
14,8475714,Calle Jarnkrok,C,TOR,33,67,16,20,36
14,8482055,Drew O'Connor,L,PIT,26,67,16,20,36
14,8483505,Matthew Poitras,C,BOS,20,78,14,22,36
14,8479591,Michael Eyssimont,C,TBL,28,82,14,22,36
14,8476392,Adam Lowry,C,WPG,31,70,13,23,36
14,8477015,Connor Brown,R,EDM,30,63,11,25,36
14,8477948,Travis Sanheim,D,PHI,28,67,10,26,36
14,8476792,Torey Krug,D,STL,33,68,9,27,36
14,8482712,Oskar Olausson,R,COL,22,80,8,28,36
14,8477220,Nate Schmidt,D,FLA,33,75,8,28,36
14,8478233,Andrew Mangiapane,L,WSH,28,71,20,15,35
14,8482089,Jake Neighbours,L,STL,22,65,19,16,35
14,8478115,Pierre Engvall,L,NYI,28,79,18,17,35
14,8478542,Evan Rodrigues,C,FLA,31,77,15,20,35
14,8480835,Jack Drury,C,CAR,24,61,13,22,35
14,8480068,Ryan Poehling,C,PHI,25,67,11,24,35
14,8474053,Logan Couture,C,SJS,35,68,11,24,35
14,8474716,Jared Spurgeon,D,MIN,35,80,10,25,35
14,8480817,K'Andre Miller,D,NYR,24,63,7,28,35
14,8480113,Alex Iafallo,L,WPG,31,66,18,16,34
14,8470621,Corey Perry,R,EDM,39,68,17,17,34
14,8475722,Jason Zucker,L,BUF,32,62,16,18,34
14,8477839,Conor Sheary,L,TBL,32,80,14,20,34
14,8476474,Stefan Noesen,R,NJD,31,67,13,21,34
14,8480185,Eetu Luostarinen,C,FLA,26,75,12,22,34
14,8475218,Mattias Ekholm,D,EDM,34,70,11,23,34
14,8474565,Alex Pietrangelo,D,VGK,34,55,10,24,34
14,8476925,Colton Sissons,C,NSH,31,72,10,24,34
14,8476885,Jacob Trouba,D,NYR,30,72,8,26,34
14,8476923,Damon Severson,D,CBJ,30,77,8,26,34
14,8474151,Ryan McDonagh,D,TBL,35,79,6,28,34
14,8478891,Mason Appleton,C,WPG,28,70,18,15,33
14,8480009,Eeli Tolvanen,R,SEA,25,71,16,17,33
14,8482705,Cole Sillinger,C,CBJ,21,65,16,17,33
14,8476981,Josh Anderson,R,MTL,30,70,15,18,33
14,8482660,Kent Johnson,C,CBJ,22,66,15,18,33
14,8478020,Michael Amadio,R,OTT,28,73,13,20,33
14,8480813,Joe Veleno,C,DET,24,78,13,20,33
14,8481618,Alex Newhook,C,MTL,23,75,12,21,33
14,8482105,Jake Sanderson,D,OTT,22,70,11,22,33
14,8481577,Philip Tomasino,C,NSH,23,62,8,25,33
14,8479987,Morgan Geekie,C,BOS,26,75,7,26,33
14,8477495,Seth Jones,D,CHI,30,72,6,27,33
14,8480145,Neal Pionk,D,WPG,29,68,4,29,33
14,8481535,Nils Hoglander,L,VAN,24,66,19,13,32
14,8481582,Nicholas Robertson,L,TOR,23,69,18,14,32
14,8482092,Ridly Greig,C,OTT,22,73,17,15,32
14,8477505,Alexander Wennberg,C,SJS,30,65,15,17,32
14,8479941,Justin Danforth,R,CBJ,31,58,15,17,32
14,8480849,Barrett Hayton,C,UTA,24,72,14,18,32
14,8479351,Sam Steel,C,DAL,26,80,13,19,32
14,8480028,Morgan Frost,C,PHI,25,75,12,20,32
14,8476927,Teddy Blueger,C,VAN,30,67,10,22,32
14,8474563,Drew Doughty,D,LAK,35,71,9,23,32
14,8482624,Daniil Miromanov,D,CGY,27,65,8,24,32
14,8483490,Pavel Mintyukov,D,ANA,21,69,7,25,32
14,8479293,Brandon Tanev,L,SEA,33,63,17,14,31
14,8480748,Kiefer Sherwood,L,VAN,29,65,16,15,31
14,8482146,Luke Evangelista,R,NSH,22,69,14,17,31
14,8478458,John (Jack) Roslovic,C,CAR,27,68,14,17,31
14,8483445,Cutter Gauthier,L,ANA,20,61,14,17,31
14,8482097,Jack Quinn,R,BUF,23,65,13,18,31
14,8478413,Jordan Greenway,L,BUF,27,66,13,18,31
14,8475793,Ryan Johansen,C,PHI,32,71,12,19,31
14,8475171,Oliver Ekman-Larsson,D,TOR,33,70,10,21,31
14,8480188,Fabian Zetterlund,L,SJS,25,63,9,22,31
14,8478133,Jake Evans,C,MTL,28,73,8,23,31
14,8476988,Matt Benning,D,SJS,30,70,6,25,31
14,8481606,Jordan Spence,D,LAK,23,64,4,27,31
14,8482122,Brock Faber,D,MIN,22,79,4,27,31
14,8476917,Adam Pelech,D,NYI,30,80,4,27,31
14,8476892,Colton Parayko,D,STL,31,69,4,27,31
14,8483491,Ivan Miroshnichenko,L,WSH,20,60,15,15,30
14,8475149,Marcus Johansson,L,MIN,34,65,14,16,30
14,8476458,Ryan Strome,C,ANA,31,71,13,17,30
14,8481704,Juuso Parssinen,C,NSH,23,58,12,18,30
14,8476906,Shayne Gostisbehere,D,CAR,31,72,5,25,30
14,8479402,Jake Bean,D,CGY,26,68,5,25,30
14,8474149,Evgenii Dadonov,R,DAL,35,80,17,12,29
14,8479661,Tanner Jeannot,L,LAK,27,79,15,14,29
14,8476872,Scott Laughton,C,PHI,30,73,13,16,29
14,8479365,Trent Frederic,C,BOS,26,73,13,16,29
14,8478046,Danton Heinen,L,VAN,29,61,11,18,29
14,8483468,Jiri Kulich,C,BUF,20,57,11,18,29
14,8480797,Joel Farabee,L,PHI,24,76,10,19,29
14,8476419,Jean-Gabriel Pageau,C,NYI,32,78,10,19,29
14,8482133,Thomas Bordeleau,C,SJS,22,60,10,19,29
14,8475200,Dmitry Orlov,D,CAR,33,72,9,20,29
14,8484203,Bradly Nadeau,L,CAR,19,62,9,20,29
14,8482101,Danil Gushchin,L,SJS,22,59,7,22,29
14,8475791,Taylor Hall,L,CHI,33,56,6,23,29
14,8478507,John Marino,D,UTA,27,72,6,23,29
14,8476854,Hampus Lindholm,D,BOS,30,74,5,24,29
14,8476902,Esa Lindell,D,DAL,30,72,4,25,29
14,8475181,Nick Leddy,D,STL,33,72,1,28,29
14,8480762,Eric Robinson,L,CAR,29,59,16,12,28
14,8481481,Blake Lizotte,C,PIT,27,56,14,14,28
14,8483493,Frank Nazar,C,CHI,20,50,14,14,28
14,8482259,Bobby McMann,C,TOR,28,69,12,16,28
14,8478970,Jalen Chatfield,D,CAR,28,70,7,21,28
14,8482655,Janis Moser,D,TBL,24,80,4,24,28
14,8481014,Alexander Romanov,D,NYI,24,78,4,24,28
14,8480003,Jesper Boqvist,C,FLA,26,69,15,12,27
14,8483524,Shane Wright,C,SEA,20,61,14,13,27
14,8478463,Anthony Beauvillier,L,PIT,27,69,14,13,27
14,8477425,Miles Wood,L,COL,29,80,13,14,27
14,8479414,Nathan Bastian,R,NJD,27,62,13,14,27
14,8481624,Ilya Mikheyev,R,CHI,30,56,12,15,27
14,8476897,Oskar Sundqvist,C,STL,30,60,11,16,27
14,8481093,Rafael Harvey-Pinard,L,MTL,25,61,10,17,27
14,8476931,Jake McCabe,D,TOR,31,60,6,21,27
14,8482245,Artem Zub,D,OTT,29,69,5,22,27
14,8473507,Jeff Petry,D,DET,37,76,3,24,27
14,8477506,Ryan Pulock,D,NYI,30,80,2,25,27
14,8480893,Kirill Marchenko,R,CBJ,24,61,17,9,26
14,8479390,Taylor Raddysh,R,WSH,26,66,12,14,26
14,8480448,Parker Kelly,L,COL,25,73,11,15,26
14,8482475,Yegor Chinakhov,R,CBJ,23,63,10,16,26
14,8480802,Ryan McLeod,C,BUF,25,63,9,17,26
14,8477952,Robby Fabbri,C,ANA,28,63,9,17,26
14,8477987,Ryan Donato,C,CHI,28,54,7,19,26
14,8481546,Cam York,D,PHI,23,72,6,20,26
14,8481703,Valtteri Puustinen,R,PIT,25,60,5,21,26
14,8480829,Jesperi Kotkaniemi,C,CAR,24,65,20,5,25
14,8476469,Joel Armia,R,MTL,31,67,17,8,25
14,8478013,Jake Walman,D,SJS,28,70,16,9,25
14,8480205,Emil Bemstrom,C,PIT,25,59,15,10,25
14,8482117,Lukas Reichel,L,CHI,22,60,14,11,25
14,8482737,Zack Bolduc,C,STL,21,55,13,12,25
14,8481032,Paul Cotter,C,NJD,25,61,13,12,25
14,8477406,Mattias Janmark,C,EDM,32,64,13,12,25
14,8479393,Noah Gregor,L,OTT,26,77,11,14,25
14,8476278,Colin Blackwell,C,DAL,31,76,11,14,25
14,8476329,Travis Boyd,C,MIN,31,53,11,14,25
14,8477450,Jason Dickinson,C,CHI,29,57,11,14,25
14,8479353,Brett Howden,C,VGK,26,66,7,18,25
14,8476422,Mike Reilly,D,NYI,31,77,6,19,25
14,8479980,Nicolas Hague,D,VGK,26,56,6,19,25
14,8476979,Erik Gustafsson,D,DET,32,81,5,20,25
14,8479398,Samuel Girard,D,COL,26,67,5,20,25
14,8476331,Dylan DeMelo,D,WPG,31,64,4,21,25
14,8478882,Vladislav Gavrikov,D,LAK,29,66,3,22,25
14,8479996,Cody Glass,C,NSH,25,56,13,11,24
14,8475231,Casey Cizikas,C,NYI,33,71,13,11,24
14,8474189,Lars Eller,C,PIT,35,63,11,13,24
14,8474715,Cameron Atkinson,R,TBL,35,80,11,13,24
14,8476480,Vladislav Namestnikov,C,WPG,32,61,8,16,24
14,8481527,Kaedan Korczak,D,VGK,23,48,6,18,24
14,8480043,Timothy Liljegren,D,TOR,25,62,4,20,24
14,8482087,Kaiden Guhle,D,MTL,22,63,4,20,24
14,8474574,Tyler Myers,D,VAN,34,69,3,21,24
14,8480873,Rasmus Sandin,D,WSH,24,67,1,23,24
14,8480049,Dylan Samberg,D,WPG,25,70,1,23,24
14,8481013,Jonatan Berggren,R,DET,24,55,11,12,23
14,8480995,Pontus Holmberg,R,TOR,25,54,10,13,23
14,8479316,Luke Kunin,C,SJS,27,55,10,13,23
14,8482749,Joshua Roy,R,MTL,21,68,10,13,23
14,8477947,Sonny Milano,L,WSH,28,66,9,14,23
14,8481524,Bowen Byram,D,BUF,23,63,4,19,23
14,8476463,Jonas Brodin,D,MIN,31,78,3,20,23
14,8482679,Matt Coronato,R,CGY,22,65,12,10,22
14,8475193,Tomas Tatar,L,NJD,34,75,12,10,22
14,8473422,Nick Foligno,L,CHI,37,64,10,12,22
14,8477931,Tomas Nosek,L,FLA,32,67,10,12,22
14,8482125,Alexander Holtz,R,VGK,22,78,9,13,22
14,8481441,Joe Snively,C,DET,28,71,8,14,22
14,8482803,Olen Zellweger,D,ANA,21,70,8,14,22
14,8477353,Tyler Motte,C,DET,29,71,8,14,22
14,8482671,Owen Power,D,BUF,22,67,7,15,22
14,8476457,Adam Larsson,D,SEA,32,69,7,15,22
14,8475842,Sam Carrick,C,NYR,32,60,7,15,22
14,8476312,Josh Manson,D,COL,33,66,6,16,22
14,8481523,Kirby Dach,C,MTL,23,61,5,17,22
14,8482067,Connor Mackey,D,NYR,28,61,5,17,22
14,8476467,Jamie Oleksiak,D,SEA,32,62,5,17,22
14,8479639,Dylan Coghlan,D,WPG,26,67,4,18,22
14,8481019,David Gustafsson,C,WPG,24,50,4,18,22
14,8480891,Michael Kesselring,D,UTA,24,59,3,19,22
14,8481554,Kaapo Kakko,R,NYR,23,68,16,5,21
14,8482079,Marco Rossi,C,MIN,23,63,14,7,21
14,8482157,Will Cuylle,L,NYR,22,61,13,8,21
14,8481580,Connor McMichael,C,WSH,23,65,12,9,21
14,8478109,Victor Olofsson,L,VGK,29,67,11,10,21
14,8477446,Michael McCarron,R,NSH,29,58,11,10,21
14,8483457,Lane Hutson,D,MTL,20,67,10,11,21
14,8475220,Marcus Foligno,L,MIN,33,62,10,11,21
14,8475343,Nic Dowd,C,WSH,34,60,9,12,21
14,8480336,Sean Walker,D,CAR,30,72,8,13,21
14,8482111,Justin Barron,D,MTL,23,63,8,13,21
14,8479315,Joey Anderson,R,CHI,26,48,8,13,21
14,8482809,Jackson Blake,R,CAR,21,63,8,13,21
14,8480011,Klim Kostin,C,SJS,25,55,8,13,21
14,8473563,Nicklas Backstrom,C,WSH,37,54,7,14,21
14,8480855,Jack McBain,C,UTA,24,69,6,15,21
14,8476856,Mathew Dumba,D,DAL,30,73,6,15,21
14,8478911,Matt Roy,D,WSH,29,64,5,16,21
14,8475324,Nick Jensen,D,OTT,34,67,5,16,21
14,8477507,Nikita Zadorov,D,BOS,29,69,5,16,21
14,8479982,Conor Timmins,D,TOR,26,54,4,17,21
14,8475790,Erik Gudbranson,D,CBJ,32,73,4,17,21
14,8480871,Adam Boqvist,D,FLA,24,65,3,18,21
14,8473533,Jordan Staal,C,CAR,36,61,12,8,20
14,8482074,Connor Zary,C,CGY,23,61,9,11,20
14,8480289,Morgan Barron,C,WPG,26,61,9,11,20
14,8484149,Gavin Brindley,C,CBJ,20,51,9,11,20
14,8481656,Aliaksei Protas,C,WSH,23,59,7,13,20
14,8477478,William Carrier,L,CAR,30,55,6,14,20
14,8482142,Jamie Drysdale,D,PHI,22,65,6,14,20
14,8474673,TJ Brodie,D,CHI,34,69,5,15,20
14,8478178,Darren Raddysh,D,TBL,28,68,5,15,20
14,8480073,Erik Brannstrom,D,COL,25,60,4,16,20
14,8481059,Scott Perunovich,D,STL,26,60,3,17,20
14,8480035,Henri Jokiharju,D,BUF,25,58,3,17,20
14,8477488,Brett Pesce,D,NJD,30,71,2,18,20
14,8480246,Nick Perbix,D,TBL,26,71,2,18,20
14,8478831,Kevin Stenlund,C,UTA,28,60,12,7,19
14,8476918,Jimmy Vesey,L,NYR,31,69,11,8,19
14,8477919,Frederick Gaudreau,C,MIN,31,60,10,9,19
14,8481028,Martin Pospisil,C,CGY,25,59,10,9,19
14,8477989,Christian Dvorak,C,MTL,28,60,8,11,19
14,8476921,Jordan Martinook,L,CAR,32,58,8,11,19
14,8479772,Zack MacEwen,R,OTT,28,49,8,11,19
14,8483565,Nick Blankenburg,D,NSH,26,62,7,12,19
14,8477979,Nicolas Aube-Kubel,R,BUF,28,60,7,12,19
14,8480070,Ian Mitchell,D,BOS,25,55,7,12,19
14,8476461,Sean Couturier,C,PHI,32,69,6,13,19
14,8477435,Ryan Graves,D,PIT,29,76,6,13,19
14,8480878,Nils Lundkvist,D,DAL,24,74,5,14,19
14,8480806,Isac Lundestrom,C,ANA,25,63,5,14,19
14,8482730,Brandt Clarke,D,LAK,21,53,5,14,19
14,8476879,Cody Ceci,D,EDM,31,73,3,16,19
14,8476891,Matthew Grzelcyk,D,PIT,30,74,3,16,19
14,8475462,Radko Gudas,D,ANA,34,58,3,16,19
14,8481716,Dmitri Voronkov,L,CBJ,24,47,15,3,18
14,8482166,Shakir Mukhamadullin,D,SJS,22,49,14,4,18
14,8476873,Mark Jankowski,C,NSH,30,53,12,6,18
14,8480252,Cole Guttman,C,CHI,25,35,10,8,18
14,8481522,Peyton Krebs,C,BUF,23,61,8,10,18
14,8474034,Patrick Maroon,L,CHI,36,48,8,10,18
14,8473453,Trevor Lewis,C,LAK,37,76,7,11,18
14,8477369,Carson Soucy,D,VAN,30,59,7,11,18
14,8479619,Michael Carcone,L,UTA,28,65,6,12,18
14,8480980,Connor Dewar,C,TOR,25,65,5,13,18
14,8481521,Ronnie Attard,D,PHI,25,66,5,13,18
14,8476525,Colin Miller,D,WPG,32,64,5,13,18
14,8476429,Scott Mayfield,D,NYI,32,70,4,14,18
14,8479983,Mario Ferraro,D,SJS,26,68,3,15,18
14,8482192,Isaak Phillips,D,CHI,23,44,1,17,18
14,8477845,Trevor van Riemsdyk,D,WSH,33,59,1,17,18
14,8478508,Yakov Trenin,C,MIN,27,60,11,6,17
14,8476374,Sean Kuraly,C,CBJ,31,52,9,8,17
14,8480848,Ty Dellandrea,C,SJS,24,43,8,9,17
14,8480074,Alexandre Texier,C,STL,25,56,6,11,17
14,8477903,Garnet Hathaway,R,PHI,33,60,6,11,17
14,8481553,Bobby Brink,R,PHI,23,63,4,13,17
14,8476994,Vinnie Hinostroza,C,NSH,30,49,4,13,17
14,8481568,Alex Vlasic,D,CHI,23,57,4,13,17
14,8478432,Christian Fischer,R,DET,27,71,3,14,17
14,8475233,David Savard,D,MTL,34,68,3,14,17
14,8479976,Juuso Valimaki,D,UTA,26,57,3,14,17
14,8481708,Zac Jones,D,NYR,24,50,3,14,17
14,8477365,Connor Clifton,D,BUF,29,55,3,14,17
14,8479066,Ryan Lomberg,L,CGY,30,63,3,14,17
14,8479371,Dante Fabbro,D,NSH,26,66,3,14,17
14,8482073,Braden Schneider,D,NYR,23,68,2,15,17
14,8479026,Philippe Myers,D,TOR,27,53,2,15,17
14,8479336,Carl Grundstrom,R,SJS,27,50,11,5,16
14,8482062,Cole Smith,L,NSH,29,51,11,5,16
14,8478585,Derek Ryan,C,EDM,38,61,9,7,16
14,8476889,Radek Faksa,C,STL,30,64,8,8,16
14,8480281,Alexey Toropchenko,R,STL,25,58,7,9,16
14,8478434,Keegan Kolesar,R,VGK,27,64,6,10,16
14,8480172,Jan Rutta,D,SJS,34,59,4,12,16
14,8475208,Brian Dumoulin,D,ANA,33,59,4,12,16
14,8478859,Niko Mikkola,D,FLA,28,56,4,12,16
14,8478468,Jeremy Lauzon,D,NSH,27,51,4,12,16
14,8480807,Mattias Samuelsson,D,BUF,24,52,2,14,16
14,8480192,Johnathan Kovacevic,D,NJD,27,48,2,14,16
14,8479369,Andrew Peeke,D,BOS,26,57,1,15,16
14,8478851,Alexandre Carrier,D,NSH,28,67,0,16,16
14,8475225,Craig Smith,C,CHI,35,50,8,7,15
14,8482155,Alex Laferriere,R,LAK,23,64,7,8,15
14,8477499,Rasmus Ristolainen,D,PHI,30,61,5,10,15
14,8475455,Brenden Dillon,D,NJD,34,61,5,10,15
14,8479718,Alex Barré-Boulet,C,MTL,27,49,5,10,15
14,8476934,Brock McGinn,L,ANA,30,59,5,10,15
14,8474166,Alec Martinez,D,CHI,37,50,4,11,15
14,8483499,Liam Ohgren,L,MIN,20,50,4,11,15
14,8480789,Oliver Wahlstrom,R,NYI,24,73,4,11,15
14,8477962,Brendan Lemieux,L,CAR,28,36,4,11,15
14,8481167,Brayden Pachal,D,CGY,25,44,4,11,15
14,8482666,Scott Morrow,D,CAR,22,54,3,12,15
14,8477018,Ben Hutton,D,VGK,31,43,3,12,15
14,8475279,Ben Chiarot,D,DET,33,62,2,13,15
14,8476967,Brett Kulak,D,EDM,30,64,2,13,15
14,8480860,Kevin Bahl,D,CGY,24,50,2,13,15
14,8481567,Henry Thrun,D,SJS,23,52,1,14,15
14,8479368,Max Jones,L,BOS,26,65,8,6,14
14,8481617,Vasily Podkolzin,R,VAN,23,47,7,7,14
14,8481754,Nikita Nesterenko,C,ANA,23,37,7,7,14
14,8481537,Nikita Okhotiuk,D,CGY,24,53,7,7,14
14,8476960,Andreas Athanasiou,C,CHI,30,52,6,8,14
14,8479370,Tyson Jost,C,CAR,26,52,6,8,14
14,8475855,Jesper Fast,R,CAR,33,52,6,8,14
14,8476822,Luke Glendening,C,TBL,35,76,6,8,14
14,8483482,Tristan Luneau,D,ANA,20,57,5,9,14
14,8479344,Jesse Puljujarvi,R,PIT,26,51,5,9,14
14,8481517,Brett Leason,R,ANA,25,58,5,9,14
14,8479328,Julien Gauthier,R,NYI,27,60,4,10,14
14,8477508,Curtis Lazar,C,NJD,29,58,4,10,14
14,8479372,Joshua Mahura,D,SEA,26,56,4,10,14
14,8478451,Ethan Bear,D,WSH,27,51,4,10,14
14,8482964,Arber Xhekaj,D,MTL,23,49,4,10,14
14,8482176,Wyatt Kaiser,D,CHI,22,50,3,11,14
14,8480887,Jordan Harris,D,MTL,24,51,3,11,14
14,8482744,James Malatesta,L,CBJ,21,43,3,11,14
14,8479998,Mikey Anderson,D,LAK,25,65,2,12,14
14,8480058,Pierre-Olivier Joseph,D,STL,25,55,2,12,14
14,8478443,Brandon Carlo,D,BOS,28,64,2,12,14
14,8482861,Vincent Iorio,D,WSH,22,32,0,14,14
14,8477482,Zachary Sanford,L,CHI,30,39,8,5,13
14,8481601,Simon Holmstrom,R,NYI,23,67,7,6,13
14,8476867,Brendan Gaunce,C,MIN,30,39,6,7,13
14,8476858,Phillip Di Giuseppe,L,VAN,31,39,6,7,13
14,8481477,Nico Sturm,C,SJS,29,55,5,8,13
14,8478569,Noel Acciari,C,PIT,33,53,5,8,13
14,8479520,Brandon Duhaime,R,WSH,27,55,5,8,13
14,8479543,Michael Pezzetta,L,MTL,26,54,5,8,13
14,8480144,David Kampf,C,TOR,29,69,4,9,13
14,8481600,Tobias Bjornfot,D,FLA,23,44,3,10,13
14,8475188,Brayden McNabb,D,VGK,33,56,2,11,13
14,8481178,Egor Zamula,D,PHI,24,50,2,11,13
14,8479249,Andrew Poturalski,C,SJS,30,37,2,11,13
14,8475179,Dmitry Kulikov,D,FLA,34,60,1,12,13
14,8483460,David Jiricek,D,CBJ,21,66,1,12,13
14,8479944,Zach Aston-Reese,C,VGK,30,44,9,3,12
14,8479968,Vinni Lettieri,C,BOS,29,48,7,5,12
14,8476442,Matt Nieto,L,PIT,32,50,6,6,12
14,8478043,Sam Lafferty,C,BUF,29,56,5,7,12
14,8476441,Joel Edmundson,D,LAK,31,45,5,7,12
14,8479671,Mathieu Olivier,R,CBJ,27,50,5,7,12
14,8481641,Joel Kiviranta,L,COL,28,72,4,8,12
14,8475690,Chris Tanev,D,TOR,35,63,3,9,12
14,8480950,Ilya Lyubushkin,D,DAL,30,60,3,9,12
14,8483466,Kevin Korchinski,D,CHI,20,51,3,9,12
14,8482859,Zack Ostapchuk,C,OTT,21,48,3,9,12
14,8481550,Adam Beckman,L,NJD,23,31,2,10,12
14,8478136,Jake Middleton,D,MIN,28,73,1,11,12
14,8478399,Jonas Siegenthaler,D,NJD,27,53,1,11,12
14,8476878,Zemgus Girgensons,C,TBL,30,79,7,4,11
14,8480355,Mark Kastelic,C,BOS,25,52,7,4,11
14,8479981,Jonah Gadjovich,L,FLA,26,44,6,5,11
14,8482652,Walker Duehr,R,CGY,27,41,6,5,11
14,8481147,Reese Johnson,C,MIN,26,38,6,5,11
14,8476624,Barclay Goodrow,C,SJS,31,54,5,6,11
14,8482634,Alex Steeves,C,TOR,25,50,4,7,11
14,8482807,Ethan Del Mastro,D,CHI,21,53,4,7,11
14,8482077,Dylan Holloway,L,EDM,23,47,4,7,11
14,8471817,Ryan Reaves,R,TOR,37,56,4,7,11
14,8480845,Rasmus Kupari,C,WPG,24,39,4,7,11
14,8484911,Collin Graf,R,SJS,22,35,4,7,11
14,8471677,Jack Johnson,D,CBJ,37,65,4,7,11
14,8481599,Victor Soderstrom,D,UTA,23,35,3,8,11
14,8480727,Zach Whitecloud,D,VGK,28,54,3,8,11
14,8477034,Jaycob Megna,D,FLA,32,42,3,8,11
14,8480021,Jack Studnicka,C,LAK,25,60,2,9,11
14,8478840,Will Borgen,D,SEA,28,59,2,9,11
14,8479378,Logan Stanley,D,WPG,26,39,2,9,11
14,8477384,Joshua Brown,D,EDM,30,35,2,9,11
14,8478874,Adam Gaudette,R,OTT,28,43,2,9,11
14,8481556,John Beecher,C,BOS,23,41,9,1,10
14,8480025,MacKenzie Entwistle,R,FLA,25,53,6,4,10
14,8482148,Hendrix Lapierre,C,WSH,22,47,6,4,10
14,8481518,Nolan Foote,L,NJD,24,40,6,4,10
14,8479994,Jaret Anderson-Dolan,C,WPG,25,35,6,4,10
14,8470600,Ryan Suter,D,STL,39,65,5,5,10
14,8480441,Trey Fix-Wolansky,R,CBJ,25,31,5,5,10
14,8482747,Brennan Othmann,L,NYR,21,41,4,6,10
14,8482713,Mackie Samoskevich,R,FLA,22,35,4,6,10
14,8479442,Troy Stecher,D,EDM,30,52,4,6,10
14,8478421,A.J. Greer,L,FLA,28,52,3,7,10
14,8482784,Zach Dean,C,STL,21,43,3,7,10
14,8480834,Ty Emberson,D,SJS,24,41,1,9,10
14,8476874,Olli Maatta,D,DET,30,62,1,9,10
14,8478454,Noah Juulsen,D,VAN,27,29,1,9,10
14,8480222,Sebastian Aho,D,PIT,28,72,0,10,10
14,8478416,Erik Cernak,D,TBL,27,72,0,10,10
14,8479359,Beck Malenstyn,L,BUF,26,51,7,2,9
14,8482762,Simon Edvinsson,D,DET,21,47,5,4,9
14,8483495,Simon Nemec,D,NJD,20,57,5,4,9
14,8477392,Hudson Fasching,R,NYI,29,63,4,5,9
14,8479439,Jacob MacDonald,D,COL,31,50,4,5,9
14,8479291,Kevin Rooney,C,CGY,31,45,4,5,9
14,8483763,Maksymilian Szuber,D,UTA,22,38,4,5,9
14,8478211,Dryden Hunt,L,CGY,29,55,4,5,9
14,8482733,Logan Mailloux,D,MTL,31,37,3,6,9
14,8477938,Haydn Fleury,D,WPG,28,48,3,6,9
14,8477070,Liam O'Brien,C,UTA,30,45,3,6,9
14,8478452,Caleb Jones,D,LAK,27,51,2,7,9
14,8479972,Mason Shaw,C,WPG,26,27,2,7,9
14,8479348,Kale Clague,D,BUF,26,43,2,7,9
14,8474567,Zach Bogosian,D,MIN,34,60,2,7,9
14,8480796,Martin Fehervary,D,WSH,25,54,2,7,9
14,8481598,Philip Broberg,D,EDM,23,47,2,7,9
14,8478017,Mark Friedman,D,VAN,29,41,2,7,9
14,8482451,Mikael Pyyhtia,L,CBJ,23,41,1,8,9
14,8479324,Ryan Lindgren,D,NYR,26,59,0,9,9
14,8482070,Mitchell Chaffee,R,TBL,26,53,6,2,8
14,8477887,Patrick Brown,C,BOS,32,49,5,3,8
14,8482511,Mason Lohrei,D,BOS,23,38,3,5,8
14,8482751,Ryan Winterton,C,SEA,21,36,3,5,8
14,8481161,Jake Christiansen,D,CBJ,25,49,2,6,8
14,8482095,Tyler Kleven,D,OTT,22,41,2,6,8
14,8483549,Lucas Condotta,L,MTL,27,34,2,6,8
14,8475750,Jon Merrill,D,MIN,32,63,1,7,8
14,8480196,Jacob Bryson,D,BUF,27,49,0,8,8
14,8481789,Tye Kartye,L,SEA,23,39,5,2,7
14,8481679,Maxence Guenette,D,OTT,23,33,5,2,7
14,8479986,Kole Lind,R,DAL,26,47,3,4,7
14,8481122,Simon Benoit,D,TOR,26,41,3,4,7
14,8480007,Jonas Rondbjerg,R,VGK,25,48,3,4,7
14,8482858,Ryker Evans,D,SEA,23,19,3,4,7
14,8479536,Axel Jonsson-Fjallby,L,WPG,26,35,2,5,7
14,8475177,Calvin de Haan,D,COL,33,48,2,5,7
14,8475235,Nicolas Deslauriers,L,PHI,33,53,2,5,7
14,8475762,Derek Forbort,D,VAN,32,47,1,6,7
14,8476372,Nick Seeler,D,PHI,31,44,1,6,7
14,8482141,Lukas Cormier,D,VGK,22,26,1,6,7
14,8473446,Erik Johnson,D,PHI,36,46,0,7,7
14,8481056,Spencer Stastney,D,NSH,24,33,0,7,7
14,8481609,Vladislav Kolyachonok,D,UTA,23,35,0,7,7
14,8477380,Jonny Brodzinski,C,NYR,31,47,5,1,6
14,8480157,Calle Rosen,D,COL,30,52,3,3,6
14,8480292,Carson Meyer,R,ANA,27,33,3,3,6
14,8478424,Jansen Harkins,C,ANA,27,41,3,3,6
14,8477573,Nathan Walker,L,STL,30,52,2,4,6
14,8481751,Lukas Rousek,R,BUF,25,39,2,4,6
14,8481592,Jakob Pelletier,L,CGY,23,37,2,4,6
14,8482177,Marat Khusnutdinov,C,MIN,22,25,2,4,6
14,8482153,Brendan Brisson,C,VGK,23,34,2,4,6
14,8477971,Andreas Englund,D,LAK,28,28,2,4,6
14,8480001,Urho Vaakanainen,D,ANA,25,57,1,5,6
14,8475718,Justin Holl,D,DET,32,61,1,5,6
14,8478450,Parker Wotherspoon,D,BOS,27,33,1,5,6
14,8477527,Ross Johnston,L,ANA,30,26,1,5,6
14,8474013,Ian Cole,D,UTA,35,59,1,5,6
14,8476473,Connor Murphy,D,CHI,31,31,1,5,6
14,8483619,Filip Roos,D,OTT,25,41,1,5,6
14,8477335,Kyle Burroughs,D,LAK,29,45,1,5,6
14,8476913,Devin Shore,C,MIN,30,38,0,6,6
14,8480880,Jakub Lauko,C,MIN,24,38,4,1,5
14,8482145,Mavrik Bourque,C,DAL,22,48,3,2,5
14,8476952,Dominic Toninato,C,WPG,30,41,3,2,5
14,8482172,Landon Slaggert,L,CHI,22,30,3,2,5
14,8482765,Isak Rosen,R,BUF,21,32,3,2,5
14,8479367,William Lockwood,R,FLA,26,21,3,2,5
14,8481726,Adam Edstrom,C,NYR,24,16,3,2,5
14,8474612,Travis Hamonic,D,OTT,34,46,2,3,5
14,8482929,Emil Lilleberg,D,TBL,23,19,2,3,5
14,8475795,Dylan McIlrath,D,WSH,32,19,2,3,5
14,8480870,Bo Groulx,C,NYR,24,32,2,3,5
14,8479320,Maxime Lajoie,D,SEA,27,24,2,3,5
14,8484254,Akito Hirose,D,VAN,25,40,1,4,5
14,8475958,Michael Sgarbossa,C,WSH,32,29,1,4,5
14,8471709,Marc-Edouard Vlasic,D,SJS,37,55,0,5,5
14,8481701,Santeri Hatakka,D,NJD,23,42,0,5,5
14,8483512,Matthew Savoie,C,EDM,20,27,4,0,4
14,8482659,Josh Doan,R,UTA,22,48,3,1,4
14,8480245,Olle Lycksell,R,PHI,25,28,3,1,4
14,8482496,Nils Aman,C,VAN,24,38,3,1,4
14,8479576,Vincent Desharnais,D,VAN,28,35,3,1,4
14,8474568,Luke Schenn,D,NSH,35,48,2,2,4
14,8481532,Alex Turcotte,C,LAK,23,39,2,2,4
14,8478409,Anthony Richard,C,PHI,28,36,2,2,4
14,8484258,Sam Malinski,D,COL,26,17,2,2,4
14,8482470,Ilya Solovyov,D,CGY,24,19,2,2,4
14,8477073,Kurtis MacDermid,L,NJD,30,32,2,2,4
14,8481719,Maxwell Crozier,D,TBL,24,20,2,2,4
14,8479638,Justin Brazeau,R,BOS,26,37,1,3,4
14,8480844,Grigori Denisenko,L,VGK,24,29,1,3,4
14,8479991,Jake Leschyshyn,C,NYR,25,27,1,3,4
14,8479379,Givani Smith,R,SJS,26,31,1,3,4
14,8480890,Jan Jenik,C,OTT,24,25,1,3,4
14,8480879,Jacob Bernard-Docker,D,OTT,24,52,0,4,4
14,8478021,William Lagesson,D,DET,28,28,0,4,4
14,8475413,Justin Dowling,C,NJD,34,14,0,4,4
14,8480468,James Hamblin,L,EDM,25,24,3,0,3
14,8483489,Fraser Minten,C,TOR,31,12,3,0,3
14,8478146,Matthew Highmore,C,OTT,28,33,2,1,3
14,8478011,Louie Belpedio,D,PHI,28,14,2,1,3
14,8482144,Jack Thompson,D,SJS,22,28,2,1,3
14,8474062,Riley Nash,C,NYR,35,20,2,1,3
14,8480990,Declan Chisholm,D,MIN,24,40,2,1,3
14,8475755,Alexander Petrovic,D,DAL,32,12,2,1,3
14,8483920,Pierrick Dube,R,WSH,23,5,2,1,3
14,8481605,Jackson LaCombe,D,ANA,23,45,1,2,3
14,8479985,Cale Fleury,D,SEA,26,31,1,2,3
14,8477244,Chad Ruhwedel,D,NYR,34,42,1,2,3
14,8484325,Waltteri Merela,C,TBL,26,21,1,2,3
14,8481593,Jayden Struble,D,MTL,23,19,1,2,3
14,8481541,Samuel Bolduc,D,NYI,24,18,1,2,3
14,8481806,Louis Crevier,D,CHI,23,15,0,3,3
14,8477467,Gustav Olofsson,D,SEA,30,22,2,0,2
14,8480032,Shane Bowers,C,NJD,25,22,2,0,2
14,8481543,Nikita Alexandrov,C,STL,24,20,2,0,2
14,8481578,Graeme Clarke,R,MIN,23,7,2,0,2
14,8477401,John Hayden,C,SEA,29,30,1,1,2
14,8474090,Brendan Smith,D,DAL,35,48,1,1,2
14,8483397,Marc McLaughlin,C,BOS,25,24,1,1,2
14,8482201,Gage Goncalves,C,TBL,23,21,1,1,2
14,8477473,Justin Bailey,R,SJS,29,21,1,1,2
14,8478881,Brett Seney,L,CHI,28,12,1,1,2
14,8481422,Jake Lucchini,C,NSH,29,20,1,1,2
14,8481030,Jack St. Ivany,D,PIT,25,15,1,1,2
14,8478051,Max Willman,C,NJD,29,17,1,1,2
14,8481043,Cole Koepke,L,BOS,26,20,1,1,2
14,8480267,Sammy Walker,C,MIN,25,19,1,1,2
14,8478502,Dennis Gilbert,D,BUF,28,23,1,1,2
14,8480084,Nick DeSimone,D,NJD,30,16,1,1,2
14,8476323,Max McCormick,L,SEA,32,4,1,1,2
14,8482094,Daemon Hunt,D,MIN,22,15,1,1,2
14,8483398,Declan Carlile,D,TBL,31,4,1,1,2
14,8483630,Pavol Regenda,L,ANA,25,23,0,2,2
14,8477851,Jordan Oesterle,D,BOS,32,29,0,2,2
14,8483570,Ben Meyers,C,SEA,26,27,0,2,2
14,8477149,Scott Sabourin,R,SJS,32,10,0,2,2
14,8482147,Jean-Luc Foudy,C,COL,22,21,0,2,2
14,8477320,Anton Blidh,L,NYR,29,18,0,2,2
14,8481065,Angus Crookshank,L,OTT,25,14,0,2,2
14,8480306,Grant Hutton,D,NYI,29,8,0,2,2
14,8475780,Chris Wagner,R,COL,33,8,0,2,2
14,8481237,Kyle MacLean,C,NYI,25,25,0,2,2
14,8481743,Marc Del Gaizo,D,NSH,25,15,0,2,2
14,8482162,Roby Jarventie,L,EDM,22,15,0,2,2
14,8478854,Ryan Shea,D,PIT,27,9,0,2,2
14,8477541,Dakota Mermis,D,TOR,30,15,0,2,2
14,8483531,Brian Halonen,L,NJD,25,5,0,2,2
14,8482165,Yan Kuznetsov,D,CGY,22,24,1,0,1
14,8484287,Cole McWard,D,VAN,23,18,1,0,1
14,8483012,Logan Morrison,C,SEA,22,35,1,0,1
14,8480874,Adam Ginning,D,PHI,24,6,1,0,1
14,8481699,Aku Raty,R,UTA,23,11,1,0,1
14,8478446,Glenn Gawdin,C,LAK,27,3,1,0,1
14,8479330,Brandon Gignac,C,MTL,27,8,1,0,1
14,8482476,Emil Heineman,L,MTL,23,8,1,0,1
14,8483432,Luca Del Bel Belluz,C,CBJ,31,6,1,0,1
14,8477810,Joel Hanley,D,CGY,33,21,0,1,1
14,8482516,Matthew Kessel,D,STL,24,13,0,1,1
14,8481462,Mason Morelli,L,VGK,28,17,0,1,1
14,8477462,Robert Hagg,D,VGK,29,25,0,1,1
14,8482088,Justin Sourdif,R,FLA,22,25,0,1,1
14,8481006,Tyler Tucker,D,STL,24,16,0,1,1
14,8483567,Georgii Merkulov,C,BOS,24,7,0,1,1
14,8483395,Arshdeep Bains,L,VAN,23,16,0,1,1
14,8480823,Alexander Alexeyev,D,WSH,25,7,0,0,0
14,8482250,Callahan Burke,C,VGK,27,20,0,0,0
14,8481024,Linus Karlsson,C,VAN,25,8,0,0,0
14,8483597,Milos Kelemen,L,UTA,25,11,0,0,0
14,8479587,Rhett Gardner,C,PHI,28,18,0,0,0
14,8480851,Akil Thomas,C,LAK,24,19,0,0,0
14,8479419,Brett Murray,L,BUF,26,21,0,0,0
14,8482118,Sam Colangelo,R,ANA,23,15,0,0,0
14,8479362,Riley Tufte,L,BOS,26,19,0,0,0
14,8482460,Matt Rempe,C,NYR,22,12,0,0,0
14,8481564,Ryan Johnson,D,BUF,23,8,0,0,0
14,8482102,Vasily Ponomarev,C,PIT,22,19,0,0,0
14,8482061,Brandon Biro,L,SEA,26,12,0,0,0
14,8483471,Brad Lambert,C,WPG,31,6,0,0,0
14,8477993,Justin Kirkland,C,CGY,28,8,0,0,0
14,8478477,Mitchell Stephens,C,SEA,27,16,0,0,0
14,8481206,John Ludvig,D,PIT,24,12,0,0,0
14,8481585,Egor Afanasyev,L,SJS,23,11,0,0,0
14,8482197,Adam Raska,R,MIN,23,6,0,0,0
14,8483407,Brandon Scanlin,D,NYR,25,6,0,0,0
14,8481655,Cole Schwindt,R,CGY,23,4,0,0,0
14,8483609,Adam Klapka,R,CGY,24,3,0,0,0
14,8482787,Nikita Chibrikov,R,WPG,31,5,0,0,0
14,8484304,Uvis Balinskis,D,FLA,28,8,0,0,0
14,8480075,Cameron Crotty,D,MIN,25,4,0,0,0
14,8484259,Ondrej Pavel,C,COL,31,1,0,0,0
14,8484321,Nikolas Matinpalo,D,OTT,26,2,0,0,0
14,8484255,Jason Polin,R,COL,25,3,0,0,0
14,8481534,Raphael Lavoie,C,EDM,24,3,0,0,0
14,8479522,Hardy Haman Aktell,D,WSH,26,4,0,0,0
14,8484326,Patrik Koch,D,UTA,28,2,0,0,0
14,8478147,Bokondji Imama,L,PIT,28,7,0,0,0
14,8483546,Marshall Rifai,D,TOR,26,0,0,0,0
14,8482126,Emil Andrae,D,PHI,31,1,0,0,0
14,8479421,Jacob Moverare,D,LAK,26,4,0,0,0
14,8470794,Joe Pavelski,C,,40,0,0,0,0
14,8479321,Lucas Johansen,D,,27,0,0,0,0
14,8477950,Tony DeAngelo,D,,29,0,0,0,0
14,8471218,Blake Wheeler,R,,38,0,0,0,0
14,8475197,Tyson Barrie,D,,33,0,0,0,0
14,8474157,Max Pacioretty,L,,36,0,0,0,0
14,8475744,Evgeny Kuznetsov,C,,32,0,0,0,0
14,8474037,James van Riemsdyk,L,,35,0,0,0,0
14,8476907,Mackenzie MacEachern,L,,30,0,0,0,0
14,8480216,Jacob Peterson,C,,25,0,0,0,0
14,8474602,Justin Schultz,D,,34,0,0,0,0
14,8482222,Alexander Barabanov,L,,30,0,0,0,0
14,8474031,Kevin Shattenkirk,D,,35,0,0,0,0
14,8477330,Dominik Kubalik,L,,29,0,0,0,0
14,8480884,Calen Addison,D,,24,0,0,0,0
14,8475906,John Klingberg,D,,32,0,0,0,0
14,8480008,Adam Ruzicka,C,,25,0,0,0,0
14,8476884,Derrick Pouliot,D,,30,0,0,0,0
14,8476919,Chris Tierney,C,,30,0,0,0,0
14,8479415,Michael McLeod,C,,26,0,0,0,0
14,8474870,Tyler Johnson,C,,34,0,0,0,0
14,8470604,Jeff Carter,C,,39,0,0,0,0
14,8478104,Sammy Blais,L,,28,0,0,0,0
14,8474884,Mike Hoffman,C,,35,0,0,0,0
14,8481591,Sam Poulin,R,,23,0,0,0,0
14,8471274,Alex Goligoski,D,,39,0,0,0,0
14,8476871,Tanner Pearson,L,,32,0,0,0,0
14,8476393,Nick Cousins,C,,31,0,0,0,0
14,8479977,Kailer Yamamoto,R,,26,0,0,0,0
14,8479346,Dillon Dube,C,,26,0,0,0,0
14,8480184,Gustav Lindstrom,D,,26,0,0,0,0
14,8479376,Victor Mete,D,,26,0,0,0,0
14,8473449,Kyle Okposo,R,,36,0,0,0,0
14,8481058,Jesse Ylonen,R,,25,0,0,0,0
14,8475752,Tyler Pitlick,C,,33,0,0,0,0
14,8481239,Samuel Fagemo,L,,24,0,0,0,0
14,8480821,Filip Zadina,R,,25,0,0,0,0
14,8470966,Mark Giordano,D,,41,0,0,0,0
14,8478495,Denis Gurianov,R,,27,0,0,0,0
14,8477464,Nic Petan,C,,29,0,0,0,0
14,8478099,Kevin Labanc,R,,29,0,0,0,0
14,8482241,Radim Zohorna,L,,28,0,0,0,0
14,8474040,Sam Gagner,C,,35,0,0,0,0
14,8479514,Rem Pitlick,C,,27,0,0,0,0
14,8478430,Oliver Kylington,D,,27,0,0,0,0
14,8479533,Joona Koppanen,L,,26,0,0,0,0
14,8479984,Cal Foote,D,,26,0,0,0,0
14,8477126,Jayson Megna,C,,34,0,0,0,0
14,8475164,Jakob Silfverberg,R,,34,0,0,0,0
14,8474009,Nick Bonino,C,,36,0,0,0,0
14,8479458,Nikita Zaitsev,D,,33,0,0,0,0
14,8477944,Jakub Vrana,L,,28,0,0,0,0
14,8471699,Andrew Cogliano,C,,37,0,0,0,0
14,8478067,Oskar Lindblom,L,,28,0,0,0,0
14,8471686,Marc Staal,D,,37,0,0,0,0
14,8470610,Zach Parise,L,,40,0,0,0,0
14,8478904,Steven Lorentz,C,,28,0,0,0,0
14,8473473,Milan Lucic,L,,36,0,0,0,0
14,8480031,Maxime Comtois,L,,25,0,0,0,0
14,8478512,Austin Czarnik,C,,32,0,0,0,0
14,8473504,Cal Clutterbuck,R,,37,0,0,0,0
14,8477454,Adam Erne,L,,29,0,0,0,0
14,8479383,Boris Katchouk,L,,26,0,0,0,0
14,8475825,Jani Hakanpää,D,,32,0,0,0,0
14,8477846,Ryan Carpenter,C,,33,0,0,0,0
14,8477930,Pierre-Edouard Bellemare,L,,39,0,0,0,0
14,8478400,Colin White,C,,27,0,0,0,0
14,8480226,Marián Studenic,R,,26,0,0,0,0
14,8480853,Liam Foudy,C,,24,0,0,0,0
14,8475797,Jarred Tinordi,D,,32,0,0,0,0
14,8479423,Alex Nylander,L,,26,0,0,0,0
14,8474618,Marco Scandella,D,,34,0,0,0,0
14,8478028,Fredrik Olofsson,L,,28,0,0,0,0
14,8474709,Matt Martin,L,,35,0,0,0,0
14,8481070,Hugh McGing,L,,26,0,0,0,0
14,8479546,Oskar Steen,C,,26,0,0,0,0
14,8474145,Robert Bortuzzo,D,,35,0,0,0,0
14,8476915,Jujhar Khaira,L,,30,0,0,0,0
14,8480274,Philip Kemp,D,EDM,25,1,0,0,0
14,8475278,Byron Froese,C,,33,0,0,0,0
14,8481812,Nikolai Knyzhov,D,,27,0,0,0,0
14,8478408,Travis Dermott,D,,28,0,0,0,0
14,8481077,John Leonard,L,,26,0,0,0,0
14,8479547,Matthew Phillips,R,,26,0,0,0,0
14,8480836,Jonathan Gruden,C,,24,0,0,0,0
14,8481690,Tyler Angle,C,,24,0,0,0,0
14,8475766,Austin Watson,L,,32,0,0,0,0
14,8481016,Ruslan Iskhakov,C,,24,0,0,0,0
14,8478078,Rourke Chartier,C,,28,0,0,0,0
14,8483401,Marc Johnstone,R,PIT,28,0,0,0,0
14,8480776,Sheldon Rempal,R,,29,0,0,0,0
14,8478956,Samuel Laberge,L,NJD,27,2,0,0,0
14,8483045,Cameron Butler,R,CBJ,31,0,0,0,0
14,8484314,Jiri Smejkal,L,,28,0,0,0,0
15,8477492,Nathan MacKinnon,C,COL,29,82,72,95,167
15,8476453,Nikita Kucherov,R,TBL,31,82,38,100,138
15,8478402,Connor McDavid,C,EDM,27,79,48,86,134
15,8479314,Matthew Tkachuk,L,FLA,27,79,41,83,124
15,8477934,Leon Draisaitl,C,EDM,29,81,54,65,119
15,8478420,Mikko Rantanen,R,COL,28,81,40,78,118
15,8478483,Mitch Marner,R,TOR,27,82,33,85,118
15,8481559,Jack Hughes,C,NJD,23,77,42,72,114
15,8479407,Jesper Bratt,L,NJD,26,76,42,67,109
15,8478550,Artemi Panarin,L,NYR,33,77,25,84,109
15,8477956,David Pastrnak,R,BOS,28,81,44,61,105
15,8477501,Valeri Nichushkin,R,COL,29,82,57,47,104
15,8480027,Jason Robertson,L,DAL,25,82,46,58,104
15,8476468,J.T. Miller,C,VAN,31,73,43,59,102
15,8482116,Tim Stützle,C,OTT,22,78,38,64,102
15,8479318,Auston Matthews,C,TOR,27,76,50,49,99
15,8477933,Sam Reinhart,C,FLA,29,79,45,54,99
15,8477402,Pavel Buchnevich,L,STL,29,78,42,57,99
15,8471675,Sidney Crosby,C,PIT,37,75,48,50,98
15,8479343,Clayton Keller,R,UTA,26,79,45,53,98
15,8477493,Aleksander Barkov,C,FLA,29,76,33,63,96
15,8474600,Roman Josi,D,NSH,34,75,25,70,95
15,8480800,Quinn Hughes,D,VAN,25,75,9,86,95
15,8477939,William Nylander,R,TOR,28,81,45,47,92
15,8478864,Kirill Kaprizov,L,MIN,27,73,40,52,92
15,8480801,Brady Tkachuk,L,OTT,25,82,39,52,91
15,8480002,Nico Hischier,C,NJD,25,79,32,59,91
15,8477404,Jake Guentzel,C,TBL,30,82,39,50,89
15,8480012,Elias Pettersson,C,VAN,26,78,35,54,89
15,8476887,Filip Forsberg,L,NSH,30,76,41,46,87
15,8477960,Adrian Kempe,R,LAK,28,82,40,47,87
15,8477409,Carter Verhaeghe,C,FLA,29,78,41,45,86
15,8480069,Cale Makar,D,COL,26,73,22,64,86
15,8478427,Sebastian Aho,C,CAR,27,73,34,50,84
15,8477946,Dylan Larkin,C,DET,28,81,49,34,83
15,8473419,Brad Marchand,L,BOS,36,77,32,51,83
15,8478010,Brayden Point,C,TBL,28,82,43,39,82
15,8474141,Patrick Kane,R,DET,36,80,32,50,82
15,8477942,Kevin Fiala,L,LAK,28,81,29,53,82
15,8475168,Matt Duchene,C,DAL,33,82,33,48,81
15,8480208,Drake Batherson,R,OTT,26,77,29,52,81
15,8478445,Mathew Barzal,C,NYI,27,78,19,62,81
15,8478403,Jack Eichel,C,VGK,28,75,31,49,80
15,8471685,Anze Kopitar,C,LAK,37,81,31,49,80
15,8478460,Zach Werenski,D,CBJ,27,79,27,53,80
15,8482684,Luke Hughes,D,NJD,21,76,15,65,80
15,8477949,Alex Tuch,R,BUF,28,76,24,55,79
15,8475167,Victor Hedman,D,TBL,34,82,19,60,79
15,8477500,Bo Horvat,C,NYI,29,79,35,43,78
15,8475172,Nazem Kadri,C,CGY,34,80,25,53,78
15,8480023,Robert Thomas,C,STL,25,73,19,59,78
15,8480865,Noah Dobson,D,NYI,24,80,15,63,78
15,8484144,Connor Bedard,C,CHI,19,70,25,51,76
15,8476456,Jonathan Huberdeau,C,CGY,31,79,22,54,76
15,8477504,Josh Morrissey,D,WPG,29,78,14,62,76
15,8475786,Zach Hyman,L,EDM,32,76,42,33,75
15,8478493,Joel Eriksson Ek,C,MIN,27,72,36,39,75
15,8475754,Brock Nelson,C,NYI,33,80,35,40,75
15,8475810,Bryan Rust,R,PIT,32,75,27,48,75
15,8480036,Miro Heiskanen,D,DAL,25,74,11,64,75
15,8480830,Andrei Svechnikov,R,CAR,24,74,29,45,74
15,8476448,William Karlsson,C,VGK,31,76,38,35,73
15,8481528,Dylan Cozens,C,BUF,23,77,31,42,73
15,8478449,Roope Hintz,C,DAL,28,82,25,48,73
15,8478401,Pavel Zacha,C,BOS,27,78,28,44,72
15,8476389,Vincent Trocheck,C,NYR,31,75,25,47,72
15,8476454,Ryan Nugent-Hopkins,C,EDM,31,75,23,49,72
15,8475765,Vladimir Tarasenko,R,DET,33,78,23,49,72
15,8479420,Tage Thompson,C,BUF,27,78,38,33,71
15,8475166,John Tavares,C,TOR,34,78,34,37,71
15,8475913,Mark Stone,R,VGK,32,73,32,39,71
15,8480018,Nick Suzuki,C,MTL,25,76,26,45,71
15,8480839,Rasmus Dahlin,D,BUF,24,74,21,50,71
15,8478414,Timo Meier,R,NJD,28,75,41,29,70
15,8475794,Tyler Seguin,C,DAL,32,81,36,34,70
15,8474564,Steven Stamkos,C,NSH,34,73,34,36,70
15,8482740,Wyatt Johnston,C,DAL,21,81,32,38,70
15,8480039,Martin Necas,C,CAR,25,74,24,46,70
15,8477940,Nikolaj Ehlers,L,WPG,28,76,31,38,69
15,8478439,Travis Konecny,R,PHI,27,79,30,39,69
15,8481557,Matt Boldy,L,MIN,23,73,29,40,69
15,8480803,Evan Bouchard,D,EDM,25,72,23,46,69
15,8477494,Jonathan Drouin,L,COL,29,81,21,48,69
15,8476539,Jonathan Marchessault,R,NSH,34,76,39,29,68
15,8478398,Kyle Connor,L,WPG,28,76,34,34,68
15,8479385,Jordan Kyrou,C,STL,26,74,27,39,66
15,8471215,Evgeni Malkin,C,PIT,38,72,22,44,66
15,8478975,Mason Marchment,L,DAL,29,82,18,48,66
15,8479323,Adam Fox,D,NYR,26,73,18,48,66
15,8479999,Casey Mittelstadt,C,COL,26,81,18,47,65
15,8482078,Lucas Raymond,L,DET,22,81,26,38,64
15,8476346,Johnny Gaudreau,L,CBJ,31,71,15,49,64
15,8475692,Mats Zuccarello,R,MIN,37,73,9,55,64
15,8476881,Tomas Hertl,C,VGK,31,77,27,36,63
15,8477496,Elias Lindholm,C,BOS,30,80,24,39,63
15,8477955,Jared McCann,L,SEA,28,75,34,28,62
15,8476459,Mika Zibanejad,C,NYR,31,77,25,37,62
15,8471214,Alex Ovechkin,L,WSH,39,76,32,29,61
15,8476460,Mark Scheifele,C,WPG,31,77,25,36,61
15,8482113,Anton Lundell,C,FLA,23,73,25,36,61
15,8478440,Dylan Strome,C,WSH,27,75,23,38,61
15,8474679,Gustav Nyquist,C,NSH,35,72,18,43,61
15,8482093,Seth Jarvis,C,CAR,22,69,33,27,60
15,8479542,Brandon Hagel,L,TBL,26,81,27,33,60
15,8477935,Sam Bennett,C,FLA,28,79,24,36,60
15,8477986,Brandon Montour,D,SEA,30,74,19,41,60
15,8482109,Alexis Lafrenière,L,NYR,23,77,38,21,59
15,8475184,Chris Kreider,L,NYR,33,77,29,30,59
15,8473994,Jamie Benn,L,DAL,35,80,26,33,59
15,8478444,Brock Boeser,R,VAN,27,76,35,23,58
15,8479337,Alex DeBrincat,R,DET,27,81,27,31,58
15,8477476,Artturi Lehkonen,L,COL,29,81,27,31,58
15,8479675,Trevor Moore,L,LAK,29,80,25,33,58
15,8473512,Claude Giroux,R,OTT,36,80,19,39,58
15,8479325,Charlie McAvoy,D,BOS,27,81,13,45,58
15,8482110,Dawson Mercer,C,NJD,23,70,31,26,57
15,8481068,Yegor Sharangovich,C,CGY,26,78,28,29,57
15,8474102,David Perron,L,OTT,36,78,21,36,57
15,8475753,Justin Faulk,D,STL,32,74,12,45,57
15,8476432,Boone Jenner,C,CBJ,31,66,29,27,56
15,8480014,Gabriel Vilardi,C,WPG,25,72,27,29,56
15,8477456,J.T. Compher,L,DET,29,79,24,32,56
15,8475745,Charlie Coyle,C,BOS,32,79,24,32,56
15,8477951,Nick Schmaltz,C,UTA,28,79,20,36,56
15,8476875,Mike Matheson,D,MTL,30,76,15,41,56
15,8476905,Chandler Stephenson,C,SEA,30,78,14,42,56
15,8480797,Joel Farabee,L,PHI,24,73,29,26,55
15,8477447,Shea Theodore,D,VGK,29,59,13,42,55
15,8474578,Erik Karlsson,D,PIT,34,77,8,47,55
15,8483808,Andrei Kuzmenko,L,CGY,28,75,33,21,54
15,8476483,Rickard Rakell,R,PIT,31,65,28,26,54
15,8477932,Aaron Ekblad,D,FLA,28,74,17,37,54
15,8482124,Quinton Byfield,R,LAK,22,81,15,39,54
15,8475798,Mikael Granlund,C,SJS,32,70,9,45,54
15,8478366,Frank Vatrano,R,ANA,30,75,34,19,53
15,8477964,Ivan Barbashev,C,VGK,29,78,26,27,53
15,8475158,Ryan O'Reilly,C,NSH,33,73,26,27,53
15,8478462,Nicolas Roy,C,VGK,27,77,22,31,53
15,8481711,Matias Maccelli,L,UTA,24,78,18,35,53
15,8479400,Pierre-Luc Dubois,L,WSH,26,66,18,35,53
15,8477503,Max Domi,C,TOR,29,79,17,36,53
15,8478233,Andrew Mangiapane,L,WSH,28,70,22,30,52
15,8482097,Jack Quinn,R,BUF,23,67,21,31,52
15,8478469,Thomas Chabot,D,OTT,27,76,13,39,52
15,8479525,Ross Colton,C,COL,28,80,36,15,51
15,8482667,William Eklund,L,SJS,22,70,25,26,51
15,8474149,Evgenii Dadonov,R,DAL,35,82,24,27,51
15,8475768,Jaden Schwartz,C,SEA,32,72,22,29,51
15,8484153,Leo Carlsson,C,ANA,20,70,17,34,51
15,8476869,Brady Skjei,D,NSH,30,73,15,36,51
15,8478396,Noah Hanifin,D,VGK,27,69,14,37,51
15,8478498,Jake DeBrusk,L,VAN,28,70,27,23,50
15,8482159,Tyson Foerster,R,PHI,22,67,26,24,50
15,8474586,Jordan Eberle,R,SEA,34,72,19,31,50
15,8476462,Dougie Hamilton,D,NJD,31,75,18,32,50
15,8480028,Morgan Frost,C,PHI,25,78,18,32,50
15,8478519,Anthony Cirelli,C,TBL,27,80,18,31,49
15,8474563,Drew Doughty,D,LAK,35,70,9,40,49
15,8479425,Filip Hronek,D,VAN,27,76,5,44,49
15,8480188,Fabian Zetterlund,L,SJS,25,62,25,23,48
15,8475149,Marcus Johansson,L,MIN,34,66,24,24,48
15,8475169,Evander Kane,L,EDM,33,78,23,25,48
15,8476882,Teuvo Teravainen,C,CHI,30,63,22,26,48
15,8480015,Owen Tippett,R,PHI,25,75,22,26,48
15,8482175,JJ Peterka,R,BUF,22,65,22,26,48
15,8473986,Alex Killorn,L,ANA,35,68,18,30,48
15,8482745,Mason McTavish,C,ANA,21,73,15,33,48
15,8476479,Phillip Danault,C,LAK,31,76,15,33,48
15,8478042,Viktor Arvidsson,L,EDM,31,69,15,33,48
15,8477451,Ryan Hartman,R,MIN,30,66,15,33,48
15,8481540,Cole Caufield,R,MTL,23,73,26,21,47
15,8478542,Evan Rodrigues,C,FLA,31,78,21,26,47
15,8477998,Warren Foegele,L,LAK,28,80,19,28,47
15,8475784,Jeff Skinner,C,EDM,32,75,18,29,47
15,8477416,Oliver Bjorkstrand,R,SEA,29,71,16,31,47
15,8470613,Brent Burns,D,CAR,39,77,6,41,47
15,8474590,John Carlson,D,WSH,34,69,6,41,47
15,8474641,Adam Henrique,C,EDM,34,72,24,22,46
15,8476399,Blake Coleman,C,CGY,33,76,22,24,46
15,8476880,Tom Wilson,R,WSH,30,69,22,24,46
15,8478873,Troy Terry,R,ANA,27,73,20,26,46
15,8474150,Mikael Backlund,C,CGY,35,75,20,26,46
15,8478466,Daniel Sprong,R,VAN,27,75,18,28,46
15,8482105,Jake Sanderson,D,OTT,22,77,12,34,46
15,8478407,Vince Dunn,D,SEA,28,74,11,35,46
15,8480064,Josh Norris,C,OTT,25,73,27,18,45
15,8483515,Juraj Slafkovsky,L,MTL,20,71,20,25,45
15,8477407,Anthony Duclair,L,NYI,29,79,20,25,45
15,8478047,Michael Bunting,L,PIT,29,69,20,25,45
15,8482699,Dylan Guenther,R,UTA,21,74,18,27,45
15,8481618,Alex Newhook,C,MTL,23,75,17,28,45
15,8476419,Jean-Gabriel Pageau,C,NYI,32,73,16,29,45
15,8478115,Pierre Engvall,L,NYI,28,76,15,30,45
15,8481577,Philip Tomasino,C,NSH,23,61,14,31,45
15,8479410,Mikhail Sergachev,D,UTA,26,70,12,33,45
15,8478038,Devon Toews,D,COL,30,66,8,37,45
15,8471724,Kris Letang,D,PIT,37,77,5,40,45
15,8475726,Tyler Toffoli,C,SJS,32,70,26,18,44
15,8477444,Andre Burakovsky,L,SEA,29,67,18,26,44
15,8478856,Conor Garland,R,VAN,28,74,17,27,44
15,8483431,Logan Cooley,C,UTA,20,73,16,28,44
15,8477021,Alex Kerfoot,C,UTA,30,77,16,28,44
15,8471698,T.J. Oshie,R,WSH,38,73,15,29,44
15,8482067,Connor Mackey,D,NYR,28,65,15,29,44
15,8475793,Ryan Johansen,C,PHI,32,75,12,32,44
15,8476958,Jaccob Slavin,D,CAR,30,75,6,38,44
15,8481542,Moritz Seider,D,DET,23,71,5,39,44
15,8477426,Nicholas Paul,L,TBL,29,81,25,18,43
15,8475151,Kyle Palmieri,C,NYI,33,80,24,19,43
15,8481560,Arthur Kaliyev,R,LAK,23,77,20,23,43
15,8479987,Morgan Geekie,C,BOS,26,78,20,23,43
15,8481535,Nils Hoglander,L,VAN,24,69,19,24,43
15,8477497,Sean Monahan,C,CBJ,30,72,16,27,43
15,8478472,Mathieu Joseph,R,STL,27,72,14,29,43
15,8478055,Gustav Forsling,D,FLA,28,71,13,30,43
15,8478474,Lawson Crouse,L,UTA,27,73,22,20,42
15,8482149,Cole Perfetti,C,WPG,22,74,21,21,42
15,8476792,Torey Krug,D,STL,33,70,19,23,42
15,8481604,Pavel Dorofeyev,L,VGK,24,75,18,24,42
15,8482665,Matty Beniers,C,SEA,22,73,16,26,42
15,8479339,Patrik Laine,L,CBJ,26,64,16,26,42
15,8482092,Ridly Greig,C,OTT,22,77,16,26,42
15,8476853,Morgan Rielly,D,TOR,30,70,9,33,42
15,8476438,Brandon Saad,L,STL,32,69,21,20,41
15,8475722,Jason Zucker,L,BUF,32,69,21,20,41
15,8480798,Philipp Kurashev,C,CHI,25,69,13,28,41
15,8478397,Rasmus Andersson,D,CGY,28,71,10,31,41
15,8482702,Logan Stankoven,C,DAL,21,82,26,14,40
15,8479992,Michael Rasmussen,C,DET,25,77,22,18,40
15,8480185,Eetu Luostarinen,C,FLA,26,75,21,19,40
15,8475314,Anders Lee,L,NYI,34,79,20,20,40
15,8478438,Tommy Novak,C,NSH,27,68,16,24,40
15,8476826,Yanni Gourde,C,SEA,33,70,12,28,40
15,8477346,MacKenzie Weegar,D,CGY,30,72,9,31,40
15,8477495,Seth Jones,D,CHI,30,69,9,31,40
15,8476906,Shayne Gostisbehere,D,CAR,31,71,9,31,40
15,8484166,Adam Fantilli,C,CBJ,20,73,17,22,39
15,8477505,Alexander Wennberg,C,SJS,30,68,13,26,39
15,8477948,Travis Sanheim,D,PHI,28,71,10,29,39
15,8481581,Thomas Harley,D,DAL,23,70,7,32,39
15,8477506,Ryan Pulock,D,NYI,30,81,1,38,39
15,8477511,Anthony Mantha,R,CGY,30,76,19,19,38
15,8475799,Nino Niederreiter,R,WPG,32,63,18,20,38
15,8479365,Trent Frederic,C,BOS,26,73,18,20,38
15,8475191,Reilly Smith,R,NYR,33,75,15,23,38
15,8476461,Sean Couturier,C,PHI,32,69,8,30,38
15,8474565,Alex Pietrangelo,D,VGK,34,63,5,33,38
15,8478046,Danton Heinen,L,VAN,29,69,23,14,37
15,8482475,Yegor Chinakhov,R,CBJ,23,60,23,14,37
15,8476921,Jordan Martinook,L,CAR,32,63,21,16,37
15,8476872,Scott Laughton,C,PHI,30,70,14,23,37
15,8475287,Erik Haula,L,NJD,33,71,13,24,37
15,8474716,Jared Spurgeon,D,MIN,35,75,13,24,37
15,8480802,Ryan McLeod,C,BUF,25,61,13,24,37
15,8484145,Zach Benson,L,BUF,19,69,11,26,37
15,8482705,Cole Sillinger,C,CBJ,21,67,19,17,36
15,8481186,Logan O'Connor,R,COL,28,78,17,19,36
15,8475760,Nick Bjugstad,C,UTA,32,72,17,19,36
15,8476474,Stefan Noesen,R,NJD,31,64,15,21,36
15,8482146,Luke Evangelista,R,NSH,22,73,15,21,36
15,8478109,Victor Olofsson,L,VGK,29,76,14,22,36
15,8478458,John (Jack) Roslovic,C,CAR,27,62,13,23,36
15,8481553,Bobby Brink,R,PHI,23,70,13,23,36
15,8481524,Bowen Byram,D,BUF,23,71,12,24,36
15,8476892,Colton Parayko,D,STL,31,77,7,29,36
15,8480068,Ryan Poehling,C,PHI,25,70,21,14,35
15,8480113,Alex Iafallo,L,WPG,31,67,17,18,35
15,8481596,Shane Pinto,C,OTT,24,77,16,19,35
15,8481523,Kirby Dach,C,MTL,23,70,15,20,35
15,8476292,Ondrej Palat,L,NJD,33,68,11,24,35
15,8476458,Ryan Strome,C,ANA,31,75,11,24,35
15,8477479,Tyler Bertuzzi,L,CHI,29,66,10,25,35
15,8478133,Jake Evans,C,MTL,28,73,7,28,35
15,8481606,Jordan Spence,D,LAK,23,70,4,31,35
15,8475170,Brayden Schenn,C,STL,33,76,21,13,34
15,8481093,Rafael Harvey-Pinard,L,MTL,25,65,15,19,34
15,8479591,Michael Eyssimont,C,TBL,28,80,14,20,34
15,8475763,Kevin Hayes,R,PIT,32,67,12,22,34
15,8483505,Matthew Poitras,C,BOS,20,72,10,24,34
15,8477488,Brett Pesce,D,NJD,30,69,8,26,34
15,8480434,Sean Durzi,D,UTA,26,66,6,28,34
15,8480145,Neal Pionk,D,WPG,29,71,6,28,34
15,8476854,Hampus Lindholm,D,BOS,30,74,6,28,34
15,8480829,Jesperi Kotkaniemi,C,CAR,24,63,16,17,33
15,8476392,Adam Lowry,C,WPG,31,63,13,20,33
15,8480849,Barrett Hayton,C,UTA,24,69,12,21,33
15,8482720,Matthew Knies,L,TOR,22,76,10,23,33
15,8479351,Sam Steel,C,DAL,26,79,7,26,33
15,8478508,Yakov Trenin,C,MIN,27,60,18,14,32
15,8476981,Josh Anderson,R,MTL,30,64,13,19,32
15,8481533,Trevor Zegras,C,ANA,23,72,11,21,32
15,8480817,K'Andre Miller,D,NYR,24,72,11,21,32
15,8475218,Mattias Ekholm,D,EDM,34,77,7,25,32
15,8476923,Damon Severson,D,CBJ,30,80,5,27,32
15,8474189,Lars Eller,C,PIT,35,68,21,10,31
15,8470621,Corey Perry,R,EDM,39,71,14,17,31
15,8474053,Logan Couture,C,SJS,35,54,13,18,31
15,8478911,Matt Roy,D,WSH,29,64,11,20,31
15,8476480,Vladislav Namestnikov,C,WPG,32,62,8,23,31
15,8480336,Sean Walker,D,CAR,30,76,7,24,31
15,8477498,Darnell Nurse,D,EDM,29,71,3,28,31
15,8479661,Tanner Jeannot,L,LAK,27,78,17,13,30
15,8478463,Anthony Beauvillier,L,PIT,27,70,15,15,30
15,8476897,Oskar Sundqvist,C,STL,30,70,15,15,30
15,8475848,Brendan Gallagher,R,MTL,32,67,13,17,30
15,8480855,Jack McBain,C,UTA,24,65,13,17,30
15,8480459,Pius Suter,C,VAN,28,69,11,19,30
15,8481703,Valtteri Puustinen,R,PIT,25,63,8,22,30
15,8476885,Jacob Trouba,D,NYR,30,70,7,23,30
15,8476979,Erik Gustafsson,D,DET,32,71,5,25,30
15,8476463,Jonas Brodin,D,MIN,31,78,4,26,30
15,8482122,Brock Faber,D,MIN,22,79,3,27,30
15,8475188,Brayden McNabb,D,VGK,33,57,2,28,30
15,8475714,Calle Jarnkrok,C,TOR,33,74,20,9,29
15,8476918,Jimmy Vesey,L,NYR,31,63,17,12,29
15,8477987,Ryan Donato,C,CHI,28,60,16,13,29
15,8473533,Jordan Staal,C,CAR,36,68,15,14,29
15,8481582,Nicholas Robertson,L,TOR,23,69,12,17,29
15,8482133,Thomas Bordeleau,C,SJS,22,66,11,18,29
15,8484203,Bradly Nadeau,L,CAR,19,59,11,18,29
15,8481481,Blake Lizotte,C,PIT,27,67,10,19,29
15,8478882,Vladislav Gavrikov,D,LAK,29,63,10,19,29
15,8477429,Andrew Copp,C,DET,30,79,9,20,29
15,8480073,Erik Brannstrom,D,COL,25,67,8,21,29
15,8481546,Cam York,D,PHI,23,70,7,22,29
15,8482712,Oskar Olausson,R,COL,22,77,6,23,29
15,8475764,Cam Fowler,D,ANA,33,77,3,26,29
15,8479398,Samuel Girard,D,COL,26,64,3,26,29
15,8476278,Colin Blackwell,C,DAL,31,75,13,15,28
15,8477919,Frederick Gaudreau,C,MIN,31,59,13,15,28
15,8478057,Dakota Joshua,C,VAN,28,67,12,16,28
15,8479996,Cody Glass,C,NSH,25,55,12,16,28
15,8481032,Paul Cotter,C,NJD,25,65,10,18,28
15,8476429,Scott Mayfield,D,NYI,32,78,9,19,28
15,8482101,Danil Gushchin,L,SJS,22,51,8,20,28
15,8479345,Jakob Chychrun,D,WSH,26,66,7,21,28
15,8478500,Ivan Provorov,D,CBJ,27,79,7,21,28
15,8476925,Colton Sissons,C,NSH,31,63,7,21,28
15,8479368,Max Jones,L,BOS,26,67,18,9,27
15,8480009,Eeli Tolvanen,R,SEA,25,66,14,13,27
15,8475231,Casey Cizikas,C,NYI,33,71,12,15,27
15,8479316,Luke Kunin,C,SJS,27,58,12,15,27
15,8481554,Kaapo Kakko,R,NYR,23,63,12,15,27
15,8483565,Nick Blankenburg,D,NSH,26,62,12,15,27
15,8475193,Tomas Tatar,L,NJD,34,68,10,17,27
15,8481656,Aliaksei Protas,C,WSH,23,66,10,17,27
15,8482749,Joshua Roy,R,MTL,21,64,9,18,27
15,8480871,Adam Boqvist,D,FLA,24,67,9,18,27
15,8478432,Christian Fischer,R,DET,27,76,9,18,27
15,8475200,Dmitry Orlov,D,CAR,33,78,8,19,27
15,8482671,Owen Power,D,BUF,22,64,8,19,27
15,8483490,Pavel Mintyukov,D,ANA,21,72,6,21,27
15,8475790,Erik Gudbranson,D,CBJ,32,77,5,22,27
15,8480860,Kevin Bahl,D,CGY,24,63,5,22,27
15,8480893,Kirill Marchenko,R,CBJ,24,66,19,7,26
15,8482089,Jake Neighbours,L,STL,22,63,18,8,26
15,8474715,Cameron Atkinson,R,TBL,35,80,16,10,26
15,8476927,Teddy Blueger,C,VAN,30,67,8,18,26
15,8477969,Marcus Pettersson,D,PIT,28,75,6,20,26
15,8480246,Nick Perbix,D,TBL,26,79,5,21,26
15,8477839,Conor Sheary,L,TBL,32,81,3,23,26
15,8482660,Kent Johnson,C,CBJ,22,63,3,23,26
15,8473507,Jeff Petry,D,DET,37,73,2,24,26
15,8482259,Bobby McMann,C,TOR,28,62,16,9,25
15,8478020,Michael Amadio,R,OTT,28,78,15,10,25
15,8482074,Connor Zary,C,CGY,23,70,14,11,25
15,8476873,Mark Jankowski,C,NSH,30,55,14,11,25
15,8477425,Miles Wood,L,COL,29,77,13,12,25
15,8474034,Patrick Maroon,L,CHI,36,52,13,12,25
15,8477947,Sonny Milano,L,WSH,28,66,12,13,25
15,8480003,Jesper Boqvist,C,FLA,26,72,11,14,25
15,8482111,Justin Barron,D,MTL,23,62,11,14,25
15,8480789,Oliver Wahlstrom,R,NYI,24,73,11,14,25
15,8477953,Kasperi Kapanen,R,STL,28,66,9,16,25
15,8477989,Christian Dvorak,C,MTL,28,64,8,17,25
15,8480220,Noah Cates,L,PHI,25,65,5,20,25
15,8476917,Adam Pelech,D,NYI,30,78,3,22,25
15,8475690,Chris Tanev,D,TOR,35,64,3,22,25
15,8478851,Alexandre Carrier,D,NSH,28,68,2,23,25
15,8482055,Drew O'Connor,L,PIT,26,63,14,10,24
15,8481601,Simon Holmstrom,R,NYI,23,63,14,10,24
15,8480021,Jack Studnicka,C,LAK,25,66,13,11,24
15,8483524,Shane Wright,C,SEA,20,60,12,12,24
15,8475220,Marcus Foligno,L,MIN,33,62,12,12,24
15,8473563,Nicklas Backstrom,C,WSH,37,59,11,13,24
15,8480748,Kiefer Sherwood,L,VAN,29,60,10,14,24
15,8480078,Filip Chytil,C,NYR,25,64,9,15,24
15,8481704,Juuso Parssinen,C,NSH,23,54,9,15,24
15,8479353,Brett Howden,C,VGK,26,70,9,15,24
15,8473422,Nick Foligno,L,CHI,37,52,9,15,24
15,8483499,Liam Ohgren,L,MIN,20,54,9,15,24
15,8480762,Eric Robinson,L,CAR,29,62,8,16,24
15,8480878,Nils Lundkvist,D,DAL,24,71,7,17,24
15,8475855,Jesper Fast,R,CAR,33,65,7,17,24
15,8482655,Janis Moser,D,TBL,24,79,4,20,24
15,8479976,Juuso Valimaki,D,UTA,26,56,3,21,24
15,8481477,Nico Sturm,C,SJS,29,54,15,8,23
15,8479390,Taylor Raddysh,R,WSH,26,60,12,11,23
15,8477450,Jason Dickinson,C,CHI,29,57,11,12,23
15,8475225,Craig Smith,C,CHI,35,56,11,12,23
15,8482079,Marco Rossi,C,MIN,23,62,10,13,23
15,8478413,Jordan Greenway,L,BUF,27,59,9,14,23
15,8480835,Jack Drury,C,CAR,24,55,8,15,23
15,8477435,Ryan Graves,D,PIT,29,75,7,16,23
15,8476879,Cody Ceci,D,EDM,31,69,6,17,23
15,8482087,Kaiden Guhle,D,MTL,22,64,5,18,23
15,8476931,Jake McCabe,D,TOR,31,68,4,19,23
15,8477392,Hudson Fasching,R,NYI,29,69,14,8,22
15,8477903,Garnet Hathaway,R,PHI,33,65,11,11,22
15,8480813,Joe Veleno,C,DET,24,72,9,13,22
15,8475171,Oliver Ekman-Larsson,D,TOR,33,70,7,15,22
15,8482624,Daniil Miromanov,D,CGY,27,58,6,16,22
15,8483491,Ivan Miroshnichenko,L,WSH,20,60,6,16,22
15,8479639,Dylan Coghlan,D,WPG,26,66,6,16,22
15,8476856,Mathew Dumba,D,DAL,30,75,6,16,22
15,8480222,Sebastian Aho,D,PIT,28,76,4,18,22
15,8477220,Nate Schmidt,D,FLA,33,77,3,19,22
15,8479982,Conor Timmins,D,TOR,26,55,3,19,22
15,8482809,Jackson Blake,R,CAR,21,57,15,6,21
15,8475791,Taylor Hall,L,CHI,33,47,11,10,21
15,8482679,Matt Coronato,R,CGY,22,58,10,11,21
15,8478891,Mason Appleton,C,WPG,28,59,9,12,21
15,8482142,Jamie Drysdale,D,PHI,22,61,8,13,21
15,8483493,Frank Nazar,C,CHI,20,48,6,15,21
15,8479980,Nicolas Hague,D,VGK,26,64,6,15,21
15,8474151,Ryan McDonagh,D,TBL,35,78,5,16,21
15,8481178,Egor Zamula,D,PHI,24,60,3,18,21
15,8481014,Alexander Romanov,D,NYI,24,75,2,19,21
15,8480873,Rasmus Sandin,D,WSH,24,67,1,20,21
15,8482737,Zack Bolduc,C,STL,21,61,12,8,20
15,8477353,Tyler Motte,C,DET,29,72,11,9,20
15,8478043,Sam Lafferty,C,BUF,29,59,10,10,20
15,8479543,Michael Pezzetta,L,MTL,26,56,9,11,20
15,8477507,Nikita Zadorov,D,BOS,29,65,8,12,20
15,8477508,Curtis Lazar,C,NJD,29,62,8,12,20
15,8480448,Parker Kelly,L,COL,25,75,7,13,20
15,8481522,Peyton Krebs,C,BUF,23,61,7,13,20
15,8482062,Cole Smith,L,NSH,29,59,7,13,20
15,8483445,Cutter Gauthier,L,ANA,20,64,6,14,20
15,8483457,Lane Hutson,D,MTL,20,70,5,15,20
15,8476994,Vinnie Hinostroza,C,NSH,30,50,5,15,20
15,8480035,Henri Jokiharju,D,BUF,25,62,4,16,20
15,8476988,Matt Benning,D,SJS,30,69,3,17,20
15,8482245,Artem Zub,D,OTT,29,70,3,17,20
15,8480049,Dylan Samberg,D,WPG,25,61,3,17,20
15,8480807,Mattias Samuelsson,D,BUF,24,59,3,17,20
15,8476457,Adam Larsson,D,SEA,32,71,2,18,20
15,8479328,Julien Gauthier,R,NYI,27,59,11,8,19
15,8479941,Justin Danforth,R,CBJ,31,62,10,9,19
15,8481580,Connor McMichael,C,WSH,23,59,10,9,19
15,8480252,Cole Guttman,C,CHI,25,49,9,10,19
15,8479619,Michael Carcone,L,UTA,28,56,9,10,19
15,8484149,Gavin Brindley,C,CBJ,20,51,8,11,19
15,8481028,Martin Pospisil,C,CGY,25,59,8,11,19
15,8476374,Sean Kuraly,C,CBJ,31,57,8,11,19
15,8480074,Alexandre Texier,C,STL,25,56,8,11,19
15,8478434,Keegan Kolesar,R,VGK,27,68,8,11,19
15,8483482,Tristan Luneau,D,ANA,20,49,8,11,19
15,8477015,Connor Brown,R,EDM,30,69,7,12,19
15,8479315,Joey Anderson,R,CHI,26,44,7,12,19
15,8476902,Esa Lindell,D,DAL,30,73,5,14,19
15,8482730,Brandt Clarke,D,LAK,21,54,5,14,19
15,8475279,Ben Chiarot,D,DET,33,69,5,14,19
15,8471709,Marc-Edouard Vlasic,D,SJS,37,67,5,14,19
15,8475718,Justin Holl,D,DET,32,63,3,16,19
15,8478178,Darren Raddysh,D,TBL,28,66,2,17,19
15,8481568,Alex Vlasic,D,CHI,23,57,2,17,19
15,8480172,Jan Rutta,D,SJS,34,64,2,17,19
15,8480980,Connor Dewar,C,TOR,25,67,9,9,18
15,8476878,Zemgus Girgensons,C,TBL,30,82,9,9,18
15,8481624,Ilya Mikheyev,R,CHI,30,57,8,10,18
15,8476469,Joel Armia,R,MTL,31,68,8,10,18
15,8482148,Hendrix Lapierre,C,WSH,22,55,8,10,18
15,8478970,Jalen Chatfield,D,CAR,28,65,5,13,18
15,8476422,Mike Reilly,D,NYI,31,74,5,13,18
15,8480995,Pontus Holmberg,R,TOR,25,66,5,13,18
15,8482125,Alexander Holtz,R,VGK,22,67,5,13,18
15,8479439,Jacob MacDonald,D,COL,31,53,5,13,18
15,8479983,Mario Ferraro,D,SJS,26,67,4,14,18
15,8481527,Kaedan Korczak,D,VGK,23,46,3,15,18
15,8475208,Brian Dumoulin,D,ANA,33,67,3,15,18
15,8479402,Jake Bean,D,CGY,26,70,2,16,18
15,8480043,Timothy Liljegren,D,TOR,25,61,2,16,18
15,8478507,John Marino,D,UTA,27,65,1,17,18
15,8480806,Isac Lundestrom,C,ANA,25,61,12,5,17
15,8483468,Jiri Kulich,C,BUF,20,56,11,6,17
15,8482155,Alex Laferriere,R,LAK,23,58,11,6,17
15,8476960,Andreas Athanasiou,C,CHI,30,53,10,7,17
15,8482117,Lukas Reichel,L,CHI,22,56,9,8,17
15,8479393,Noah Gregor,L,OTT,26,71,8,9,17
15,8480025,MacKenzie Entwistle,R,FLA,25,63,8,9,17
15,8477380,Jonny Brodzinski,C,NYR,31,55,7,10,17
15,8478421,A.J. Greer,L,FLA,28,52,6,11,17
15,8481521,Ronnie Attard,D,PHI,25,48,5,12,17
15,8479066,Ryan Lomberg,L,CGY,30,61,5,12,17
15,8476934,Brock McGinn,L,ANA,30,51,5,12,17
15,8476312,Josh Manson,D,COL,33,60,4,13,17
15,8480891,Michael Kesselring,D,UTA,24,67,4,13,17
15,8479718,Alex Barré-Boulet,C,MTL,27,55,4,13,17
15,8478416,Erik Cernak,D,TBL,27,77,4,13,17
15,8476525,Colin Miller,D,WPG,32,61,3,14,17
15,8478452,Caleb Jones,D,LAK,27,56,3,14,17
15,8475462,Radko Gudas,D,ANA,34,65,1,16,17
15,8479371,Dante Fabbro,D,NSH,26,63,1,16,17
15,8479324,Ryan Lindgren,D,NYR,26,64,0,17,17
15,8479414,Nathan Bastian,R,NJD,27,58,11,5,16
15,8477478,William Carrier,L,CAR,30,56,11,5,16
15,8475842,Sam Carrick,C,NYR,32,61,9,7,16
15,8478569,Noel Acciari,C,PIT,33,58,9,7,16
15,8482747,Brennan Othmann,L,NYR,21,49,9,7,16
15,8481517,Brett Leason,R,ANA,25,58,8,8,16
15,8482762,Simon Edvinsson,D,DET,21,57,8,8,16
15,8473453,Trevor Lewis,C,LAK,37,74,7,9,16
15,8480011,Klim Kostin,C,SJS,25,45,6,10,16
15,8478013,Jake Walman,D,SJS,28,69,5,11,16
15,8481013,Jonatan Berggren,R,DET,24,57,5,11,16
15,8475324,Nick Jensen,D,OTT,34,67,5,11,16
15,8481701,Santeri Hatakka,D,NJD,23,37,5,11,16
15,8479372,Joshua Mahura,D,SEA,26,59,3,13,16
15,8475233,David Savard,D,MTL,34,58,2,14,16
15,8480887,Jordan Harris,D,MTL,24,57,2,14,16
15,8474090,Brendan Smith,D,DAL,35,55,2,14,16
15,8476331,Dylan DeMelo,D,WPG,31,65,1,15,16
15,8479026,Philippe Myers,D,TOR,27,54,1,15,16
15,8477952,Robby Fabbri,C,ANA,28,65,11,4,15
15,8479293,Brandon Tanev,L,SEA,33,64,9,6,15
15,8480281,Alexey Toropchenko,R,STL,25,48,9,6,15
15,8482157,Will Cuylle,L,NYR,22,59,7,8,15
15,8475343,Nic Dowd,C,WSH,34,50,6,9,15
15,8477406,Mattias Janmark,C,EDM,32,65,5,10,15
15,8482803,Olen Zellweger,D,ANA,21,69,5,10,15
15,8477979,Nicolas Aube-Kubel,R,BUF,28,51,4,11,15
15,8482073,Braden Schneider,D,NYR,23,59,4,11,15
15,8481167,Brayden Pachal,D,CGY,25,43,4,11,15
15,8482634,Alex Steeves,C,TOR,25,45,4,11,15
15,8478840,Will Borgen,D,SEA,28,64,4,11,15
15,8481537,Nikita Okhotiuk,D,CGY,24,47,3,12,15
15,8482176,Wyatt Kaiser,D,CHI,22,52,3,12,15
15,8476624,Barclay Goodrow,C,SJS,31,53,3,12,15
15,8478136,Jake Middleton,D,MIN,28,73,1,14,15
15,8481716,Dmitri Voronkov,L,CBJ,24,35,11,3,14
15,8479336,Carl Grundstrom,R,SJS,27,49,9,5,14
15,8480289,Morgan Barron,C,WPG,26,57,8,6,14
15,8481617,Vasily Podkolzin,R,VAN,23,45,7,7,14
15,8481019,David Gustafsson,C,WPG,24,42,5,9,14
15,8474673,TJ Brodie,D,CHI,34,61,5,9,14
15,8479968,Vinni Lettieri,C,BOS,29,58,5,9,14
15,8480845,Rasmus Kupari,C,WPG,24,43,5,9,14
15,8479442,Troy Stecher,D,EDM,30,59,4,10,14
15,8477446,Michael McCarron,R,NSH,29,58,3,11,14
15,8477018,Ben Hutton,D,VGK,31,44,3,11,14
15,8482095,Tyler Kleven,D,OTT,22,49,3,11,14
15,8477845,Trevor van Riemsdyk,D,WSH,33,57,2,12,14
15,8475181,Nick Leddy,D,STL,33,65,1,13,14
15,8474574,Tyler Myers,D,VAN,34,68,1,13,14
15,8481441,Joe Snively,C,DET,28,71,1,13,14
15,8481059,Scott Perunovich,D,STL,26,52,1,13,14
15,8475455,Brenden Dillon,D,NJD,34,56,1,13,14
15,8478831,Kevin Stenlund,C,UTA,28,53,8,5,13
15,8481789,Tye Kartye,L,SEA,23,47,7,6,13
15,8476822,Luke Glendening,C,TBL,35,80,6,7,13
15,8481550,Adam Beckman,L,NJD,23,42,6,7,13
15,8482166,Shakir Mukhamadullin,D,SJS,22,51,5,8,13
15,8477938,Haydn Fleury,D,WPG,28,44,5,8,13
15,8477931,Tomas Nosek,L,FLA,32,56,4,9,13
15,8478585,Derek Ryan,C,EDM,38,64,4,9,13
15,8482744,James Malatesta,L,CBJ,21,46,4,9,13
15,8482451,Mikael Pyyhtia,L,CBJ,23,46,4,9,13
15,8471677,Jack Johnson,D,CBJ,37,65,3,10,13
15,8477851,Jordan Oesterle,D,BOS,32,47,3,10,13
15,8476467,Jamie Oleksiak,D,SEA,32,63,2,11,13
15,8479348,Kale Clague,D,BUF,26,43,2,11,13
15,8474166,Alec Martinez,D,CHI,37,51,1,12,13
15,8479359,Beck Malenstyn,L,BUF,26,46,6,6,12
15,8477369,Carson Soucy,D,VAN,30,63,5,7,12
15,8478399,Jonas Siegenthaler,D,NJD,27,62,4,8,12
15,8479378,Logan Stanley,D,WPG,26,46,4,8,12
15,8479536,Axel Jonsson-Fjallby,L,WPG,26,35,4,8,12
15,8480205,Emil Bemstrom,C,PIT,25,56,3,9,12
15,8479370,Tyson Jost,C,CAR,26,43,3,9,12
15,8476867,Brendan Gaunce,C,MIN,30,32,3,9,12
15,8480950,Ilya Lyubushkin,D,DAL,30,65,2,10,12
15,8482859,Zack Ostapchuk,C,OTT,21,53,2,10,12
15,8477499,Rasmus Ristolainen,D,PHI,30,59,1,11,12
15,8477573,Nathan Walker,L,STL,30,52,7,4,11
15,8480144,David Kampf,C,TOR,29,66,6,5,11
15,8479944,Zach Aston-Reese,C,VGK,30,48,5,6,11
15,8482192,Isaak Phillips,D,CHI,23,50,4,7,11
15,8480157,Calle Rosen,D,COL,30,46,4,7,11
15,8481751,Lukas Rousek,R,BUF,25,43,4,7,11
15,8477365,Connor Clifton,D,BUF,29,48,3,8,11
15,8478443,Brandon Carlo,D,BOS,28,55,3,8,11
15,8481592,Jakob Pelletier,L,CGY,23,44,3,8,11
15,8481600,Tobias Bjornfot,D,FLA,23,43,2,9,11
15,8479249,Andrew Poturalski,C,SJS,30,35,2,9,11
15,8476891,Matthew Grzelcyk,D,PIT,30,73,1,10,11
15,8481708,Zac Jones,D,NYR,24,49,1,10,11
15,8476889,Radek Faksa,C,STL,30,56,1,10,11
15,8481518,Nolan Foote,L,NJD,24,39,7,3,10
15,8476858,Phillip Di Giuseppe,L,VAN,31,35,6,4,10
15,8482784,Zach Dean,C,STL,21,40,6,4,10
15,8483495,Simon Nemec,D,NJD,20,55,6,4,10
15,8477962,Brendan Lemieux,L,CAR,28,41,5,5,10
15,8480355,Mark Kastelic,C,BOS,25,63,5,5,10
15,8482713,Mackie Samoskevich,R,FLA,22,41,5,5,10
15,8478211,Dryden Hunt,L,CGY,29,54,5,5,10
15,8480880,Jakub Lauko,C,MIN,24,33,5,5,10
15,8476329,Travis Boyd,C,MIN,31,55,4,6,10
15,8479344,Jesse Puljujarvi,R,PIT,26,49,4,6,10
15,8479291,Kevin Rooney,C,CGY,31,49,4,6,10
15,8474567,Zach Bogosian,D,MIN,34,70,4,6,10
15,8479520,Brandon Duhaime,R,WSH,27,53,3,7,10
15,8481567,Henry Thrun,D,SJS,23,46,2,8,10
15,8479998,Mikey Anderson,D,LAK,25,56,2,8,10
15,8477034,Jaycob Megna,D,FLA,32,42,2,8,10
15,8475177,Calvin de Haan,D,COL,33,43,2,8,10
15,8478859,Niko Mikkola,D,FLA,28,56,1,9,10
15,8480058,Pierre-Olivier Joseph,D,STL,25,53,1,9,10
15,8479671,Mathieu Olivier,R,CBJ,27,47,1,9,10
15,8476372,Nick Seeler,D,PHI,31,42,1,9,10
15,8475179,Dmitry Kulikov,D,FLA,34,56,0,10,10
15,8482733,Logan Mailloux,D,MTL,31,36,7,2,9
15,8479994,Jaret Anderson-Dolan,C,WPG,25,30,6,3,9
15,8477482,Zachary Sanford,L,CHI,30,40,5,4,9
15,8476473,Connor Murphy,D,CHI,31,41,5,4,9
15,8481532,Alex Turcotte,C,LAK,23,40,5,4,9
15,8482666,Scott Morrow,D,CAR,22,50,4,5,9
15,8481599,Victor Soderstrom,D,UTA,23,42,4,5,9
15,8481161,Jake Christiansen,D,CBJ,25,53,4,5,9
15,8482659,Josh Doan,R,UTA,22,52,4,5,9
15,8480192,Johnathan Kovacevic,D,NJD,27,48,2,7,9
15,8482807,Ethan Del Mastro,D,CHI,21,47,2,7,9
15,8476952,Dominic Toninato,C,WPG,30,34,2,7,9
15,8474568,Luke Schenn,D,NSH,35,45,2,7,9
15,8483460,David Jiricek,D,CBJ,21,59,1,8,9
15,8470600,Ryan Suter,D,STL,39,65,1,8,9
15,8480796,Martin Fehervary,D,WSH,25,54,1,8,9
15,8480001,Urho Vaakanainen,D,ANA,25,60,1,8,9
15,8480196,Jacob Bryson,D,BUF,27,43,0,9,9
15,8471817,Ryan Reaves,R,TOR,37,50,6,2,8
15,8482141,Lukas Cormier,D,VGK,22,29,5,3,8
15,8476442,Matt Nieto,L,PIT,32,44,4,4,8
15,8478424,Jansen Harkins,C,ANA,27,44,4,4,8
15,8480070,Ian Mitchell,D,BOS,25,50,3,5,8
15,8483466,Kevin Korchinski,D,CHI,20,51,3,5,8
15,8480007,Jonas Rondbjerg,R,VGK,25,32,3,5,8
15,8483619,Filip Roos,D,OTT,25,41,3,5,8
15,8480990,Declan Chisholm,D,MIN,24,41,3,5,8
15,8477384,Joshua Brown,D,EDM,30,40,2,6,8
15,8480441,Trey Fix-Wolansky,R,CBJ,25,35,2,6,8
15,8480834,Ty Emberson,D,SJS,24,33,2,6,8
15,8480727,Zach Whitecloud,D,VGK,28,39,1,7,8
15,8477887,Patrick Brown,C,BOS,32,45,1,7,8
15,8473446,Erik Johnson,D,PHI,36,54,1,7,8
15,8476913,Devin Shore,C,MIN,30,34,1,7,8
15,8482145,Mavrik Bourque,C,DAL,22,48,1,7,8
15,8481641,Joel Kiviranta,L,COL,28,74,0,8,8
15,8477401,John Hayden,C,SEA,29,30,6,1,7
15,8480292,Carson Meyer,R,ANA,27,25,5,2,7
15,8481543,Nikita Alexandrov,C,STL,24,30,4,3,7
15,8478451,Ethan Bear,D,WSH,27,44,3,4,7
15,8478874,Adam Gaudette,R,OTT,28,38,3,4,7
15,8482765,Isak Rosen,R,BUF,21,33,3,4,7
15,8478409,Anthony Richard,C,PHI,28,29,3,4,7
15,8480844,Grigori Denisenko,L,VGK,24,32,3,4,7
15,8482652,Walker Duehr,R,CGY,27,41,2,5,7
15,8476874,Olli Maatta,D,DET,30,60,2,5,7
15,8475762,Derek Forbort,D,VAN,32,47,2,5,7
15,8481056,Spencer Stastney,D,NSH,24,28,2,5,7
15,8482496,Nils Aman,C,VAN,24,32,2,5,7
15,8482077,Dylan Holloway,L,EDM,23,47,1,6,7
15,8483549,Lucas Condotta,L,MTL,27,30,1,6,7
15,8478450,Parker Wotherspoon,D,BOS,27,26,1,6,7
15,8474612,Travis Hamonic,D,OTT,34,38,1,6,7
15,8480245,Olle Lycksell,R,PHI,25,35,0,7,7
15,8481754,Nikita Nesterenko,C,ANA,23,30,5,1,6
15,8480848,Ty Dellandrea,C,SJS,24,43,4,2,6
15,8481679,Maxence Guenette,D,OTT,23,29,4,2,6
15,8475958,Michael Sgarbossa,C,WSH,32,25,4,2,6
15,8479320,Maxime Lajoie,D,SEA,27,25,3,3,6
15,8479379,Givani Smith,R,SJS,26,36,3,3,6
15,8479972,Mason Shaw,C,WPG,26,39,2,4,6
15,8478017,Mark Friedman,D,VAN,29,41,2,4,6
15,8479986,Kole Lind,R,DAL,26,48,2,4,6
15,8479576,Vincent Desharnais,D,VAN,28,38,2,4,6
15,8477473,Justin Bailey,R,SJS,29,27,2,4,6
15,8477320,Anton Blidh,L,NYR,29,20,2,4,6
15,8477070,Liam O'Brien,C,UTA,30,52,1,5,6
15,8481598,Philip Broberg,D,EDM,23,41,1,5,6
15,8482858,Ryker Evans,D,SEA,23,22,1,5,6
15,8478468,Jeremy Lauzon,D,NSH,27,55,0,6,6
15,8476967,Brett Kulak,D,EDM,30,63,0,6,6
15,8482070,Mitchell Chaffee,R,TBL,26,54,5,0,5
15,8475235,Nicolas Deslauriers,L,PHI,33,49,4,1,5
15,8480267,Sammy Walker,C,MIN,25,23,4,1,5
15,8483570,Ben Meyers,C,SEA,26,30,4,1,5
15,8484911,Collin Graf,R,SJS,22,39,3,2,5
15,8483763,Maksymilian Szuber,D,UTA,22,24,3,2,5
15,8482511,Mason Lohrei,D,BOS,23,35,3,2,5
15,8480468,James Hamblin,L,EDM,25,24,3,2,5
15,8478881,Brett Seney,L,CHI,28,16,3,2,5
15,8483630,Pavol Regenda,L,ANA,25,25,3,2,5
15,8481065,Angus Crookshank,L,OTT,25,20,3,2,5
15,8481237,Kyle MacLean,C,NYI,25,25,3,2,5
15,8482172,Landon Slaggert,L,CHI,22,29,2,3,5
15,8480870,Bo Groulx,C,NYR,24,36,2,3,5
15,8479638,Justin Brazeau,R,BOS,26,38,2,3,5
15,8480890,Jan Jenik,C,OTT,24,28,2,3,5
15,8481422,Jake Lucchini,C,NSH,29,18,2,3,5
15,8481743,Marc Del Gaizo,D,NSH,25,23,2,3,5
15,8482250,Callahan Burke,C,VGK,27,23,2,3,5
15,8479772,Zack MacEwen,R,OTT,28,47,1,4,5
15,8482964,Arber Xhekaj,D,MTL,23,49,1,4,5
15,8477527,Ross Johnston,L,ANA,30,40,1,4,5
15,8474013,Ian Cole,D,UTA,35,57,1,4,5
15,8479367,William Lockwood,R,FLA,26,25,1,4,5
15,8475750,Jon Merrill,D,MIN,32,55,0,5,5
15,8477335,Kyle Burroughs,D,LAK,29,48,0,5,5
15,8479587,Rhett Gardner,C,PHI,28,15,0,5,5
15,8479981,Jonah Gadjovich,L,FLA,26,36,4,0,4
15,8477073,Kurtis MacDermid,L,NJD,30,27,3,1,4
15,8478051,Max Willman,C,NJD,29,22,3,1,4
15,8482861,Vincent Iorio,D,WSH,22,32,2,2,4
15,8481609,Vladislav Kolyachonok,D,UTA,23,44,2,2,4
15,8482153,Brendan Brisson,C,VGK,23,24,2,2,4
15,8484258,Sam Malinski,D,COL,26,20,2,2,4
15,8481593,Jayden Struble,D,MTL,23,20,2,2,4
15,8481806,Louis Crevier,D,CHI,23,13,2,2,4
15,8483397,Marc McLaughlin,C,BOS,25,29,2,2,4
15,8479369,Andrew Peeke,D,BOS,26,59,1,3,4
15,8482177,Marat Khusnutdinov,C,MIN,22,29,1,3,4
15,8480879,Jacob Bernard-Docker,D,OTT,24,43,1,3,4
15,8478146,Matthew Highmore,C,OTT,28,27,1,3,4
15,8482144,Jack Thompson,D,SJS,22,26,1,3,4
15,8482201,Gage Goncalves,C,TBL,23,21,1,3,4
15,8478502,Dennis Gilbert,D,BUF,28,17,1,3,4
15,8483597,Milos Kelemen,L,UTA,25,14,1,3,4
15,8476441,Joel Edmundson,D,LAK,31,45,0,4,4
15,8481122,Simon Benoit,D,TOR,26,37,0,4,4
15,8484254,Akito Hirose,D,VAN,25,39,0,4,4
15,8477244,Chad Ruhwedel,D,NYR,34,33,0,4,4
15,8481147,Reese Johnson,C,MIN,26,38,2,1,3
15,8482751,Ryan Winterton,C,SEA,21,36,2,1,3
15,8482470,Ilya Solovyov,D,CGY,24,22,2,1,3
15,8475755,Alexander Petrovic,D,DAL,32,9,2,1,3
15,8481006,Tyler Tucker,D,STL,24,14,1,2,3
15,8478454,Noah Juulsen,D,VAN,27,27,0,3,3
15,8481605,Jackson LaCombe,D,ANA,23,33,0,3,3
15,8481578,Graeme Clarke,R,MIN,23,11,0,3,3
15,8477149,Scott Sabourin,R,SJS,32,17,0,3,3
15,8477810,Joel Hanley,D,CGY,33,24,0,3,3
15,8482516,Matthew Kessel,D,STL,24,22,0,3,3
15,8477462,Robert Hagg,D,VGK,29,22,0,3,3
15,8479419,Brett Murray,L,BUF,26,14,0,3,3
15,8479362,Riley Tufte,L,BOS,26,19,0,3,3
15,8479991,Jake Leschyshyn,C,NYR,25,21,2,0,2
15,8482094,Daemon Hunt,D,MIN,22,12,2,0,2
15,8484287,Cole McWard,D,VAN,23,18,2,0,2
15,8480874,Adam Ginning,D,PHI,24,12,2,0,2
15,8479522,Hardy Haman Aktell,D,WSH,26,7,2,0,2
15,8481719,Maxwell Crozier,D,TBL,24,11,1,1,2
15,8479985,Cale Fleury,D,SEA,26,24,1,1,2
15,8481043,Cole Koepke,L,BOS,26,17,1,1,2
15,8482165,Yan Kuznetsov,D,CGY,22,22,1,1,2
15,8478446,Glenn Gawdin,C,LAK,27,14,1,1,2
15,8480851,Akil Thomas,C,LAK,24,16,1,1,2
15,8478477,Mitchell Stephens,C,SEA,27,23,1,1,2
15,8481585,Egor Afanasyev,L,SJS,23,17,1,1,2
15,8477971,Andreas Englund,D,LAK,28,22,0,2,2
15,8482929,Emil Lilleberg,D,TBL,23,18,0,2,2
15,8483512,Matthew Savoie,C,EDM,20,18,0,2,2
15,8478021,William Lagesson,D,DET,28,28,0,2,2
15,8483489,Fraser Minten,C,TOR,31,13,0,2,2
15,8484325,Waltteri Merela,C,TBL,26,18,0,2,2
15,8481030,Jack St. Ivany,D,PIT,25,19,0,2,2
15,8483395,Arshdeep Bains,L,VAN,23,15,0,2,2
15,8482102,Vasily Ponomarev,C,PIT,22,20,0,2,2
15,8479421,Jacob Moverare,D,LAK,26,8,0,2,2
15,8481556,John Beecher,C,BOS,23,24,1,0,1
15,8474062,Riley Nash,C,NYR,35,17,1,0,1
15,8481541,Samuel Bolduc,D,NYI,24,21,1,0,1
15,8477541,Dakota Mermis,D,TOR,30,10,1,0,1
15,8483012,Logan Morrison,C,SEA,22,34,1,0,1
15,8480823,Alexander Alexeyev,D,WSH,25,14,1,0,1
15,8482118,Sam Colangelo,R,ANA,23,15,1,0,1
15,8481564,Ryan Johnson,D,BUF,23,11,1,0,1
15,8482061,Brandon Biro,L,SEA,26,12,1,0,1
15,8482197,Adam Raska,R,MIN,23,9,1,0,1
15,8481655,Cole Schwindt,R,CGY,23,8,1,0,1
15,8481726,Adam Edstrom,C,NYR,24,8,0,1,1
15,8475795,Dylan McIlrath,D,WSH,32,18,0,1,1
15,8478011,Louie Belpedio,D,PHI,28,12,0,1,1
15,8477467,Gustav Olofsson,D,SEA,30,16,0,1,1
15,8483531,Brian Halonen,L,NJD,25,2,0,1,1
15,8481699,Aku Raty,R,UTA,23,18,0,1,1
15,8482476,Emil Heineman,L,MTL,23,8,0,1,1
15,8482088,Justin Sourdif,R,FLA,22,22,0,1,1
15,8482460,Matt Rempe,C,NYR,22,10,0,1,1
15,8483471,Brad Lambert,C,WPG,31,10,0,1,1
15,8483407,Brandon Scanlin,D,NYR,25,7,0,1,1
15,8482787,Nikita Chibrikov,R,WPG,31,5,0,1,1
15,8484255,Jason Polin,R,COL,25,6,0,1,1
15,8475413,Justin Dowling,C,NJD,34,6,0,0,0
15,8483920,Pierrick Dube,R,WSH,23,2,0,0,0
15,8480032,Shane Bowers,C,NJD,25,10,0,0,0
15,8480084,Nick DeSimone,D,NJD,30,14,0,0,0
15,8476323,Max McCormick,L,SEA,32,4,0,0,0
15,8483398,Declan Carlile,D,TBL,31,2,0,0,0
15,8482147,Jean-Luc Foudy,C,COL,22,21,0,0,0
15,8480306,Grant Hutton,D,NYI,29,5,0,0,0
15,8475780,Chris Wagner,R,COL,33,8,0,0,0
15,8482162,Roby Jarventie,L,EDM,22,20,0,0,0
15,8478854,Ryan Shea,D,PIT,27,11,0,0,0
15,8479330,Brandon Gignac,C,MTL,27,5,0,0,0
15,8483432,Luca Del Bel Belluz,C,CBJ,31,3,0,0,0
15,8481462,Mason Morelli,L,VGK,28,13,0,0,0
15,8483567,Georgii Merkulov,C,BOS,24,6,0,0,0
15,8481024,Linus Karlsson,C,VAN,25,10,0,0,0
15,8477993,Justin Kirkland,C,CGY,28,1,0,0,0
15,8481206,John Ludvig,D,PIT,24,9,0,0,0
15,8483609,Adam Klapka,R,CGY,24,0,0,0,0
15,8484304,Uvis Balinskis,D,FLA,28,6,0,0,0
15,8480075,Cameron Crotty,D,MIN,25,9,0,0,0
15,8484259,Ondrej Pavel,C,COL,31,0,0,0,0
15,8484321,Nikolas Matinpalo,D,OTT,26,2,0,0,0
15,8481534,Raphael Lavoie,C,EDM,24,1,0,0,0
15,8484326,Patrik Koch,D,UTA,28,1,0,0,0
15,8478147,Bokondji Imama,L,PIT,28,2,0,0,0
15,8483546,Marshall Rifai,D,TOR,26,3,0,0,0
15,8482126,Emil Andrae,D,PHI,31,3,0,0,0
15,8470794,Joe Pavelski,C,,40,0,0,0,0
15,8479321,Lucas Johansen,D,,27,0,0,0,0
15,8477950,Tony DeAngelo,D,,29,0,0,0,0
15,8471218,Blake Wheeler,R,,38,0,0,0,0
15,8475197,Tyson Barrie,D,,33,0,0,0,0
15,8474157,Max Pacioretty,L,,36,0,0,0,0
15,8475744,Evgeny Kuznetsov,C,,32,0,0,0,0
15,8474037,James van Riemsdyk,L,,35,0,0,0,0
15,8476907,Mackenzie MacEachern,L,,30,0,0,0,0
15,8480216,Jacob Peterson,C,,25,0,0,0,0
15,8474602,Justin Schultz,D,,34,0,0,0,0
15,8482222,Alexander Barabanov,L,,30,0,0,0,0
15,8474031,Kevin Shattenkirk,D,,35,0,0,0,0
15,8477330,Dominik Kubalik,L,,29,0,0,0,0
15,8480884,Calen Addison,D,,24,0,0,0,0
15,8475906,John Klingberg,D,,32,0,0,0,0
15,8480008,Adam Ruzicka,C,,25,0,0,0,0
15,8476884,Derrick Pouliot,D,,30,0,0,0,0
15,8476919,Chris Tierney,C,,30,0,0,0,0
15,8479415,Michael McLeod,C,,26,0,0,0,0
15,8474870,Tyler Johnson,C,,34,0,0,0,0
15,8470604,Jeff Carter,C,,39,0,0,0,0
15,8478104,Sammy Blais,L,,28,0,0,0,0
15,8474884,Mike Hoffman,C,,35,0,0,0,0
15,8481591,Sam Poulin,R,,23,0,0,0,0
15,8471274,Alex Goligoski,D,,39,0,0,0,0
15,8476871,Tanner Pearson,L,,32,0,0,0,0
15,8476393,Nick Cousins,C,,31,0,0,0,0
15,8479977,Kailer Yamamoto,R,,26,0,0,0,0
15,8479346,Dillon Dube,C,,26,0,0,0,0
15,8480184,Gustav Lindstrom,D,,26,0,0,0,0
15,8479376,Victor Mete,D,,26,0,0,0,0
15,8473449,Kyle Okposo,R,,36,0,0,0,0
15,8481058,Jesse Ylonen,R,,25,0,0,0,0
15,8475752,Tyler Pitlick,C,,33,0,0,0,0
15,8481239,Samuel Fagemo,L,,24,0,0,0,0
15,8480821,Filip Zadina,R,,25,0,0,0,0
15,8470966,Mark Giordano,D,,41,0,0,0,0
15,8478495,Denis Gurianov,R,,27,0,0,0,0
15,8477464,Nic Petan,C,,29,0,0,0,0
15,8478099,Kevin Labanc,R,,29,0,0,0,0
15,8482241,Radim Zohorna,L,,28,0,0,0,0
15,8474040,Sam Gagner,C,,35,0,0,0,0
15,8479514,Rem Pitlick,C,,27,0,0,0,0
15,8478430,Oliver Kylington,D,,27,0,0,0,0
15,8479533,Joona Koppanen,L,,26,0,0,0,0
15,8479984,Cal Foote,D,,26,0,0,0,0
15,8477126,Jayson Megna,C,,34,0,0,0,0
15,8475164,Jakob Silfverberg,R,,34,0,0,0,0
15,8474009,Nick Bonino,C,,36,0,0,0,0
15,8479458,Nikita Zaitsev,D,,33,0,0,0,0
15,8477944,Jakub Vrana,L,,28,0,0,0,0
15,8471699,Andrew Cogliano,C,,37,0,0,0,0
15,8478067,Oskar Lindblom,L,,28,0,0,0,0
15,8471686,Marc Staal,D,,37,0,0,0,0
15,8470610,Zach Parise,L,,40,0,0,0,0
15,8478904,Steven Lorentz,C,,28,0,0,0,0
15,8473473,Milan Lucic,L,,36,0,0,0,0
15,8480031,Maxime Comtois,L,,25,0,0,0,0
15,8478512,Austin Czarnik,C,,32,0,0,0,0
15,8473504,Cal Clutterbuck,R,,37,0,0,0,0
15,8477454,Adam Erne,L,,29,0,0,0,0
15,8479383,Boris Katchouk,L,,26,0,0,0,0
15,8475825,Jani Hakanpää,D,,32,0,0,0,0
15,8477846,Ryan Carpenter,C,,33,0,0,0,0
15,8477930,Pierre-Edouard Bellemare,L,,39,0,0,0,0
15,8478400,Colin White,C,,27,0,0,0,0
15,8480226,Marián Studenic,R,,26,0,0,0,0
15,8480853,Liam Foudy,C,,24,0,0,0,0
15,8475797,Jarred Tinordi,D,,32,0,0,0,0
15,8479423,Alex Nylander,L,,26,0,0,0,0
15,8474618,Marco Scandella,D,,34,0,0,0,0
15,8478028,Fredrik Olofsson,L,,28,0,0,0,0
15,8474709,Matt Martin,L,,35,0,0,0,0
15,8481070,Hugh McGing,L,,26,0,0,0,0
15,8479546,Oskar Steen,C,,26,0,0,0,0
15,8474145,Robert Bortuzzo,D,,35,0,0,0,0
15,8476915,Jujhar Khaira,L,,30,0,0,0,0
15,8480274,Philip Kemp,D,EDM,25,0,0,0,0
15,8475278,Byron Froese,C,,33,0,0,0,0
15,8481812,Nikolai Knyzhov,D,,27,0,0,0,0
15,8478408,Travis Dermott,D,,28,0,0,0,0
15,8481077,John Leonard,L,,26,0,0,0,0
15,8479547,Matthew Phillips,R,,26,0,0,0,0
15,8480836,Jonathan Gruden,C,,24,0,0,0,0
15,8481690,Tyler Angle,C,,24,0,0,0,0
15,8475766,Austin Watson,L,,32,0,0,0,0
15,8481016,Ruslan Iskhakov,C,,24,0,0,0,0
15,8478078,Rourke Chartier,C,,28,0,0,0,0
15,8483401,Marc Johnstone,R,PIT,28,1,0,0,0
15,8480776,Sheldon Rempal,R,,29,0,0,0,0
15,8478956,Samuel Laberge,L,NJD,27,3,0,0,0
15,8483045,Cameron Butler,R,CBJ,31,0,0,0,0
15,8484314,Jiri Smejkal,L,,28,0,0,0,0
16,8477492,Nathan MacKinnon,C,COL,29,81,72,82,154
16,8478402,Connor McDavid,C,EDM,27,81,48,99,147
16,8476453,Nikita Kucherov,R,TBL,31,82,42,92,134
16,8478864,Kirill Kaprizov,L,MIN,27,71,57,66,123
16,8478483,Mitch Marner,R,TOR,27,79,35,88,123
16,8479318,Auston Matthews,C,TOR,27,77,53,64,117
16,8478420,Mikko Rantanen,R,COL,28,81,44,73,117
16,8476468,J.T. Miller,C,VAN,31,74,40,73,113
16,8477934,Leon Draisaitl,C,EDM,29,80,42,70,112
16,8478445,Mathew Barzal,C,NYI,27,81,29,82,111
16,8477956,David Pastrnak,R,BOS,28,81,47,63,110
16,8479314,Matthew Tkachuk,L,FLA,27,76,28,78,106
16,8477939,William Nylander,R,TOR,28,75,54,46,100
16,8478403,Jack Eichel,C,VGK,28,81,48,51,99
16,8482116,Tim Stützle,C,OTT,22,79,31,68,99
16,8480036,Miro Heiskanen,D,DAL,25,75,17,82,99
16,8477946,Dylan Larkin,C,DET,28,80,50,48,98
16,8480801,Brady Tkachuk,L,OTT,25,82,40,58,98
16,8480002,Nico Hischier,C,NJD,25,76,32,66,98
16,8478550,Artemi Panarin,L,NYR,33,79,33,63,96
16,8478010,Brayden Point,C,TBL,28,82,52,42,94
16,8478427,Sebastian Aho,C,CAR,27,72,41,53,94
16,8476887,Filip Forsberg,L,NSH,30,69,41,52,93
16,8475913,Mark Stone,R,VGK,32,75,29,62,91
16,8480027,Jason Robertson,L,DAL,25,82,33,57,90
16,8478398,Kyle Connor,L,WPG,28,71,45,44,89
16,8477942,Kevin Fiala,L,LAK,28,80,26,63,89
16,8480069,Cale Makar,D,COL,26,70,24,65,89
16,8480800,Quinn Hughes,D,VAN,25,76,13,74,87
16,8478444,Brock Boeser,R,VAN,27,73,44,42,86
16,8478449,Roope Hintz,C,DAL,28,82,46,39,85
16,8484144,Connor Bedard,C,CHI,19,69,25,60,85
16,8479343,Clayton Keller,R,UTA,26,80,37,47,84
16,8477404,Jake Guentzel,C,TBL,30,80,37,47,84
16,8477493,Aleksander Barkov,C,FLA,29,79,25,59,84
16,8477501,Valeri Nichushkin,R,COL,29,81,35,48,83
16,8480012,Elias Pettersson,C,VAN,26,77,34,49,83
16,8473512,Claude Giroux,R,OTT,36,79,22,60,82
16,8480865,Noah Dobson,D,NYI,24,82,18,64,82
16,8474564,Steven Stamkos,C,NSH,34,74,34,47,81
16,8477933,Sam Reinhart,C,FLA,29,79,42,38,80
16,8477960,Adrian Kempe,R,LAK,28,81,39,41,80
16,8476460,Mark Scheifele,C,WPG,31,73,30,50,80
16,8481559,Jack Hughes,C,NJD,23,76,33,46,79
16,8471685,Anze Kopitar,C,LAK,37,78,27,52,79
16,8476881,Tomas Hertl,C,VGK,31,77,32,46,78
16,8480023,Robert Thomas,C,STL,25,79,28,50,78
16,8474600,Roman Josi,D,NSH,34,79,21,57,78
16,8478460,Zach Werenski,D,CBJ,27,79,21,54,75
16,8480018,Nick Suzuki,C,MTL,25,76,26,48,74
16,8475172,Nazem Kadri,C,CGY,34,77,19,55,74
16,8480208,Drake Batherson,R,OTT,26,80,29,44,73
16,8477504,Josh Morrissey,D,WPG,29,77,17,56,73
16,8479323,Adam Fox,D,NYR,26,73,15,58,73
16,8475166,John Tavares,C,TOR,34,75,32,40,72
16,8471675,Sidney Crosby,C,PIT,37,76,35,36,71
16,8479542,Brandon Hagel,L,TBL,26,82,33,38,71
16,8482665,Matty Beniers,C,SEA,22,76,25,46,71
16,8478493,Joel Eriksson Ek,C,MIN,27,75,22,49,71
16,8475167,Victor Hedman,D,TBL,34,79,18,53,71
16,8474141,Patrick Kane,R,DET,36,80,27,43,70
16,8476454,Ryan Nugent-Hopkins,C,EDM,31,75,24,46,70
16,8477409,Carter Verhaeghe,C,FLA,29,79,39,30,69
16,8475786,Zach Hyman,L,EDM,32,76,27,42,69
16,8476346,Johnny Gaudreau,L,CBJ,31,74,22,47,69
16,8481557,Matt Boldy,L,MIN,23,72,33,34,67
16,8475754,Brock Nelson,C,NYI,33,81,31,36,67
16,8479407,Jesper Bratt,L,NJD,26,76,29,38,67
16,8479675,Trevor Moore,L,LAK,29,81,27,40,67
16,8479999,Casey Mittelstadt,C,COL,26,82,23,44,67
16,8476539,Jonathan Marchessault,R,NSH,34,74,33,33,66
16,8478414,Timo Meier,R,NJD,28,77,32,34,66
16,8476459,Mika Zibanejad,C,NYR,31,79,27,39,66
16,8482093,Seth Jarvis,C,CAR,22,69,26,40,66
16,8477496,Elias Lindholm,C,BOS,30,79,25,41,66
16,8477940,Nikolaj Ehlers,L,WPG,28,65,14,52,66
16,8477951,Nick Schmaltz,C,UTA,28,73,30,35,65
16,8480830,Andrei Svechnikov,R,CAR,24,72,28,37,65
16,8479420,Tage Thompson,C,BUF,27,76,27,38,65
16,8477500,Bo Horvat,C,NYI,29,79,34,30,64
16,8475158,Ryan O'Reilly,C,NSH,33,74,27,37,64
16,8473994,Jamie Benn,L,DAL,35,80,24,40,64
16,8475765,Vladimir Tarasenko,R,DET,33,77,23,41,64
16,8480839,Rasmus Dahlin,D,BUF,24,71,17,47,64
16,8474578,Erik Karlsson,D,PIT,34,80,13,51,64
16,8482740,Wyatt Johnston,C,DAL,21,81,40,23,63
16,8475784,Jeff Skinner,C,EDM,32,76,37,26,63
16,8471214,Alex Ovechkin,L,WSH,39,71,33,30,63
16,8475810,Bryan Rust,R,PIT,32,74,30,33,63
16,8477402,Pavel Buchnevich,L,STL,29,77,25,38,63
16,8473419,Brad Marchand,L,BOS,36,79,24,39,63
16,8480803,Evan Bouchard,D,EDM,25,74,17,46,63
16,8475692,Mats Zuccarello,R,MIN,37,72,17,46,63
16,8480015,Owen Tippett,R,PHI,25,80,34,28,62
16,8477476,Artturi Lehkonen,L,COL,29,81,33,29,62
16,8476389,Vincent Trocheck,C,NYR,31,78,25,37,62
16,8482124,Quinton Byfield,R,LAK,22,79,20,42,62
16,8478975,Mason Marchment,L,DAL,29,82,27,34,61
16,8476456,Jonathan Huberdeau,C,CGY,31,78,24,37,61
16,8476448,William Karlsson,C,VGK,31,78,22,39,61
16,8478873,Troy Terry,R,ANA,27,76,22,39,61
16,8479325,Charlie McAvoy,D,BOS,27,74,14,47,61
16,8481528,Dylan Cozens,C,BUF,23,73,24,36,60
16,8482684,Luke Hughes,D,NJD,21,76,10,50,60
16,8478439,Travis Konecny,R,PHI,27,72,30,29,59
16,8475726,Tyler Toffoli,C,SJS,32,70,28,31,59
16,8480797,Joel Farabee,L,PHI,24,73,22,37,59
16,8478469,Thomas Chabot,D,OTT,27,77,16,43,59
16,8479385,Jordan Kyrou,C,STL,26,77,28,30,58
16,8475168,Matt Duchene,C,DAL,33,82,23,35,58
16,8476853,Morgan Rielly,D,TOR,30,68,9,49,58
16,8478366,Frank Vatrano,R,ANA,30,80,36,21,57
16,8475184,Chris Kreider,L,NYR,33,74,33,24,57
16,8483515,Juraj Slafkovsky,L,MTL,20,77,23,34,57
16,8477503,Max Domi,C,TOR,29,81,20,37,57
16,8475745,Charlie Coyle,C,BOS,32,80,30,26,56
16,8477511,Anthony Mantha,R,CGY,30,78,23,33,56
16,8482149,Cole Perfetti,C,WPG,22,71,22,34,56
16,8478401,Pavel Zacha,C,BOS,27,78,25,30,55
16,8480039,Martin Necas,C,CAR,25,75,24,31,55
16,8482699,Dylan Guenther,R,UTA,21,73,21,34,55
16,8476399,Blake Coleman,C,CGY,33,75,25,29,54
16,8478498,Jake DeBrusk,L,VAN,28,73,23,31,54
16,8482159,Tyson Foerster,R,PHI,22,67,18,36,54
16,8471724,Kris Letang,D,PIT,37,79,11,43,54
16,8477964,Ivan Barbashev,C,VGK,29,74,29,24,53
16,8474586,Jordan Eberle,R,SEA,34,71,26,27,53
16,8475151,Kyle Palmieri,C,NYI,33,81,25,28,53
16,8474679,Gustav Nyquist,C,NSH,35,71,12,41,53
16,8480064,Josh Norris,C,OTT,25,78,27,25,52
16,8475794,Tyler Seguin,C,DAL,32,80,25,27,52
16,8484166,Adam Fantilli,C,CBJ,20,65,20,32,52
16,8483431,Logan Cooley,C,UTA,20,77,18,34,52
16,8477494,Jonathan Drouin,L,COL,29,81,10,42,52
16,8476875,Mike Matheson,D,MTL,30,75,10,42,52
16,8481546,Cam York,D,PHI,23,70,10,42,52
16,8474590,John Carlson,D,WSH,34,68,8,44,52
16,8479425,Filip Hronek,D,VAN,27,72,6,46,52
16,8476432,Boone Jenner,C,CBJ,31,66,26,25,51
16,8481068,Yegor Sharangovich,C,CGY,26,80,25,26,51
16,8477955,Jared McCann,L,SEA,28,75,23,28,51
16,8473986,Alex Killorn,L,ANA,35,72,21,30,51
16,8482092,Ridly Greig,C,OTT,22,76,19,32,51
16,8476905,Chandler Stephenson,C,SEA,30,69,17,34,51
16,8474150,Mikael Backlund,C,CGY,35,77,13,38,51
16,8478047,Michael Bunting,L,PIT,29,76,22,28,50
16,8478440,Dylan Strome,C,WSH,27,70,20,30,50
16,8481581,Thomas Harley,D,DAL,23,78,17,33,50
16,8476462,Dougie Hamilton,D,NJD,31,73,16,34,50
16,8477447,Shea Theodore,D,VGK,29,69,8,42,50
16,8481540,Cole Caufield,R,MTL,23,73,28,21,49
16,8474641,Adam Henrique,C,EDM,34,75,27,22,49
16,8481711,Matias Maccelli,L,UTA,24,72,24,25,49
16,8476483,Rickard Rakell,R,PIT,31,68,23,26,49
16,8476461,Sean Couturier,C,PHI,32,75,22,27,49
16,8482078,Lucas Raymond,L,DET,22,81,19,30,49
16,8471215,Evgeni Malkin,C,PIT,38,74,16,33,49
16,8479400,Pierre-Luc Dubois,L,WSH,26,69,25,23,48
16,8477416,Oliver Bjorkstrand,R,SEA,29,78,22,26,48
16,8482745,Mason McTavish,C,ANA,21,72,19,29,48
16,8478519,Anthony Cirelli,C,TBL,27,82,17,31,48
16,8478396,Noah Hanifin,D,VGK,27,65,15,33,48
16,8478055,Gustav Forsling,D,FLA,28,72,11,37,48
16,8481533,Trevor Zegras,C,ANA,23,68,24,23,47
16,8477935,Sam Bennett,C,FLA,28,77,22,25,47
16,8481618,Alex Newhook,C,MTL,23,67,20,27,47
16,8481596,Shane Pinto,C,OTT,24,75,20,27,47
16,8474053,Logan Couture,C,SJS,35,64,18,29,47
16,8475848,Brendan Gallagher,R,MTL,32,75,18,29,47
16,8479337,Alex DeBrincat,R,DET,27,80,17,30,47
16,8484153,Leo Carlsson,C,ANA,20,70,15,32,47
16,8477495,Seth Jones,D,CHI,30,65,15,32,47
16,8480028,Morgan Frost,C,PHI,25,67,21,25,46
16,8477426,Nicholas Paul,L,TBL,29,82,20,26,46
16,8478438,Tommy Novak,C,NSH,27,72,17,29,46
16,8478472,Mathieu Joseph,R,STL,27,72,16,30,46
16,8481542,Moritz Seider,D,DET,23,77,9,37,46
16,8480188,Fabian Zetterlund,L,SJS,25,66,25,20,45
16,8475169,Evander Kane,L,EDM,33,80,25,20,45
16,8477456,J.T. Compher,L,DET,29,78,22,23,45
16,8474149,Evgenii Dadonov,R,DAL,35,79,20,25,45
16,8475798,Mikael Granlund,C,SJS,32,64,11,34,45
16,8481604,Pavel Dorofeyev,L,VGK,24,67,11,34,45
16,8476479,Phillip Danault,C,LAK,31,80,10,35,45
16,8478474,Lawson Crouse,L,UTA,27,78,24,20,44
16,8482109,Alexis Lafrenière,L,NYR,23,76,21,23,44
16,8476292,Ondrej Palat,L,NJD,33,72,16,28,44
16,8477429,Andrew Copp,C,DET,30,79,16,28,44
16,8478397,Rasmus Andersson,D,CGY,28,76,12,32,44
16,8475170,Brayden Schenn,C,STL,33,72,12,32,44
16,8478038,Devon Toews,D,COL,30,69,11,33,44
16,8475314,Anders Lee,L,NYI,34,78,23,20,43
16,8477949,Alex Tuch,R,BUF,28,68,19,24,43
16,8475753,Justin Faulk,D,STL,32,72,19,24,43
16,8477407,Anthony Duclair,L,NYI,29,76,18,25,43
16,8476792,Torey Krug,D,STL,33,73,13,30,43
16,8478542,Evan Rodrigues,C,FLA,31,71,11,32,43
16,8470613,Brent Burns,D,CAR,39,76,9,34,43
16,8482712,Oskar Olausson,R,COL,22,79,6,37,43
16,8476474,Stefan Noesen,R,NJD,31,64,21,21,42
16,8475768,Jaden Schwartz,C,SEA,32,60,19,23,42
16,8478856,Conor Garland,R,VAN,28,71,19,23,42
16,8480798,Philipp Kurashev,C,CHI,25,71,16,26,42
16,8478458,John (Jack) Roslovic,C,CAR,27,64,15,27,42
16,8476869,Brady Skjei,D,NSH,30,71,13,29,42
16,8482133,Thomas Bordeleau,C,SJS,22,65,11,31,42
16,8476906,Shayne Gostisbehere,D,CAR,31,72,9,33,42
16,8477986,Brandon Montour,D,SEA,30,68,8,34,42
16,8477969,Marcus Pettersson,D,PIT,28,79,4,38,42
16,8479525,Ross Colton,C,COL,28,81,25,16,41
16,8475799,Nino Niederreiter,R,WPG,32,67,23,18,41
16,8477451,Ryan Hartman,R,MIN,30,63,21,20,41
16,8475191,Reilly Smith,R,NYR,33,72,21,20,41
16,8480459,Pius Suter,C,VAN,28,70,21,20,41
16,8480849,Barrett Hayton,C,UTA,24,71,15,26,41
16,8482113,Anton Lundell,C,FLA,23,77,13,28,41
16,8481703,Valtteri Puustinen,R,PIT,25,62,9,32,41
16,8476463,Jonas Brodin,D,MIN,31,75,4,37,41
16,8475714,Calle Jarnkrok,C,TOR,33,72,22,18,40
16,8481535,Nils Hoglander,L,VAN,24,64,19,21,40
16,8474102,David Perron,L,OTT,36,78,16,24,40
16,8478233,Andrew Mangiapane,L,WSH,28,68,14,26,40
16,8478463,Anthony Beauvillier,L,PIT,27,66,22,17,39
16,8471698,T.J. Oshie,R,WSH,38,70,21,18,39
16,8477998,Warren Foegele,L,LAK,28,75,20,19,39
16,8482055,Drew O'Connor,L,PIT,26,64,19,20,39
16,8481560,Arthur Kaliyev,R,LAK,23,80,18,21,39
16,8479339,Patrik Laine,L,CBJ,26,66,17,22,39
16,8476826,Yanni Gourde,C,SEA,33,76,17,22,39
16,8475149,Marcus Johansson,L,MIN,34,63,15,24,39
16,8479345,Jakob Chychrun,D,WSH,26,58,13,26,39
16,8477479,Tyler Bertuzzi,L,CHI,29,66,12,27,39
16,8481577,Philip Tomasino,C,NSH,23,69,11,28,39
16,8476458,Ryan Strome,C,ANA,31,68,10,29,39
16,8474565,Alex Pietrangelo,D,VGK,34,61,9,30,39
16,8476958,Jaccob Slavin,D,CAR,30,76,5,34,39
16,8476880,Tom Wilson,R,WSH,30,65,23,15,38
16,8480748,Kiefer Sherwood,L,VAN,29,64,19,19,38
16,8480009,Eeli Tolvanen,R,SEA,25,68,18,20,38
16,8482667,William Eklund,L,SJS,22,65,17,21,38
16,8478046,Danton Heinen,L,VAN,29,62,17,21,38
16,8475287,Erik Haula,L,NJD,33,71,11,27,38
16,8482702,Logan Stankoven,C,DAL,21,80,10,28,38
16,8478407,Vince Dunn,D,SEA,28,67,7,31,38
16,8480113,Alex Iafallo,L,WPG,31,67,19,18,37
16,8477932,Aaron Ekblad,D,FLA,28,71,18,19,37
16,8480014,Gabriel Vilardi,C,WPG,25,63,17,20,37
16,8478466,Daniel Sprong,R,VAN,27,70,16,21,37
16,8482720,Matthew Knies,L,TOR,22,76,13,24,37
16,8476927,Teddy Blueger,C,VAN,30,67,12,25,37
16,8475218,Mattias Ekholm,D,EDM,34,76,9,28,37
16,8477948,Travis Sanheim,D,PHI,28,69,7,30,37
16,8475764,Cam Fowler,D,ANA,33,78,2,35,37
16,8478115,Pierre Engvall,L,NYI,28,78,25,11,36
16,8482110,Dawson Mercer,C,NJD,23,69,20,16,36
16,8475793,Ryan Johansen,C,PHI,32,72,18,18,36
16,8477505,Alexander Wennberg,C,SJS,30,58,15,21,36
16,8478057,Dakota Joshua,C,VAN,28,72,12,24,36
16,8477839,Conor Sheary,L,TBL,32,80,11,25,36
16,8480817,K'Andre Miller,D,NYR,24,68,9,27,36
16,8474563,Drew Doughty,D,LAK,35,68,8,28,36
16,8477506,Ryan Pulock,D,NYI,30,78,3,33,36
16,8476438,Brandon Saad,L,STL,32,69,21,14,35
16,8476921,Jordan Martinook,L,CAR,32,66,15,20,35
16,8482097,Jack Quinn,R,BUF,23,61,13,22,35
16,8476882,Teuvo Teravainen,C,CHI,30,62,12,23,35
16,8474716,Jared Spurgeon,D,MIN,35,77,7,28,35
16,8480434,Sean Durzi,D,UTA,26,73,7,28,35
16,8480829,Jesperi Kotkaniemi,C,CAR,24,61,19,15,34
16,8479987,Morgan Geekie,C,BOS,26,81,18,16,34
16,8477498,Darnell Nurse,D,EDM,29,71,15,19,34
16,8478413,Jordan Greenway,L,BUF,27,68,15,19,34
16,8482146,Luke Evangelista,R,NSH,22,71,14,20,34
16,8482475,Yegor Chinakhov,R,CBJ,23,63,13,21,34
16,8476872,Scott Laughton,C,PHI,30,75,11,23,34
16,8483505,Matthew Poitras,C,BOS,20,75,11,23,34
16,8480802,Ryan McLeod,C,BUF,25,68,10,24,34
16,8480336,Sean Walker,D,CAR,30,76,8,26,34
16,8482122,Brock Faber,D,MIN,22,79,7,27,34
16,8476892,Colton Parayko,D,STL,31,70,3,31,34
16,8477346,MacKenzie Weegar,D,CGY,30,73,12,21,33
16,8477947,Sonny Milano,L,WSH,28,59,12,21,33
16,8477497,Sean Monahan,C,CBJ,30,65,11,22,33
16,8477953,Kasperi Kapanen,R,STL,28,68,11,22,33
16,8476902,Esa Lindell,D,DAL,30,72,10,23,33
16,8476419,Jean-Gabriel Pageau,C,NYI,32,72,8,25,33
16,8477021,Alex Kerfoot,C,UTA,30,72,6,27,33
16,8480871,Adam Boqvist,D,FLA,24,70,18,14,32
16,8477425,Miles Wood,L,COL,29,75,15,17,32
16,8477952,Robby Fabbri,C,ANA,28,63,14,18,32
16,8480068,Ryan Poehling,C,PHI,25,68,13,19,32
16,8483808,Andrei Kuzmenko,L,CGY,28,74,12,20,32
16,8479365,Trent Frederic,C,BOS,26,75,12,20,32
16,8480835,Jack Drury,C,CAR,24,62,12,20,32
16,8480220,Noah Cates,L,PHI,25,73,9,23,32
16,8482175,JJ Peterka,R,BUF,22,68,17,14,31
16,8482089,Jake Neighbours,L,STL,22,69,17,14,31
16,8479293,Brandon Tanev,L,SEA,33,69,16,15,31
16,8479992,Michael Rasmussen,C,DET,25,77,13,18,31
16,8480893,Kirill Marchenko,R,CBJ,24,61,13,18,31
16,8470621,Corey Perry,R,EDM,39,70,10,21,31
16,8483445,Cutter Gauthier,L,ANA,20,62,10,21,31
16,8478133,Jake Evans,C,MTL,28,72,9,22,31
16,8476931,Jake McCabe,D,TOR,31,63,9,22,31
16,8480855,Jack McBain,C,UTA,24,59,5,26,31
16,8482259,Bobby McMann,C,TOR,28,63,19,11,30
16,8481186,Logan O'Connor,R,COL,28,80,13,17,30
16,8481554,Kaapo Kakko,R,NYR,23,67,13,17,30
16,8483490,Pavel Mintyukov,D,ANA,21,69,10,20,30
16,8474715,Cameron Atkinson,R,TBL,35,80,10,20,30
16,8481656,Aliaksei Protas,C,WSH,23,67,8,22,30
16,8476923,Damon Severson,D,CBJ,30,80,7,23,30
16,8479410,Mikhail Sergachev,D,UTA,26,72,6,24,30
16,8473507,Jeff Petry,D,DET,37,76,5,25,30
16,8479996,Cody Glass,C,NSH,25,64,14,15,29
16,8480205,Emil Bemstrom,C,PIT,25,59,13,16,29
16,8478042,Viktor Arvidsson,L,EDM,31,70,12,17,29
16,8475722,Jason Zucker,L,BUF,32,72,12,17,29
16,8476457,Adam Larsson,D,SEA,32,72,10,19,29
16,8483482,Tristan Luneau,D,ANA,20,67,10,19,29
16,8477444,Andre Burakovsky,L,SEA,29,71,6,23,29
16,8481606,Jordan Spence,D,LAK,23,68,6,23,29
16,8479398,Samuel Girard,D,COL,26,69,4,25,29
16,8478020,Michael Amadio,R,OTT,28,77,20,8,28
16,8478508,Yakov Trenin,C,MIN,27,62,17,11,28
16,8476918,Jimmy Vesey,L,NYR,31,68,17,11,28
16,8482125,Alexander Holtz,R,VGK,22,65,16,12,28
16,8481624,Ilya Mikheyev,R,CHI,30,58,9,19,28
16,8476885,Jacob Trouba,D,NYR,30,72,7,21,28
16,8476917,Adam Pelech,D,NYI,30,77,5,23,28
16,8475763,Kevin Hayes,R,PIT,32,62,16,11,27
16,8482705,Cole Sillinger,C,CBJ,21,72,12,15,27
16,8482737,Zack Bolduc,C,STL,21,60,12,15,27
16,8481553,Bobby Brink,R,PHI,23,56,11,16,27
16,8478432,Christian Fischer,R,DET,27,78,11,16,27
16,8479390,Taylor Raddysh,R,WSH,26,63,11,16,27
16,8478013,Jake Walman,D,SJS,28,74,11,16,27
16,8478462,Nicolas Roy,C,VGK,27,76,10,17,27
16,8479351,Sam Steel,C,DAL,26,80,9,18,27
16,8475791,Taylor Hall,L,CHI,33,52,9,18,27
16,8483565,Nick Blankenburg,D,NSH,26,60,8,19,27
16,8479982,Conor Timmins,D,TOR,26,65,7,20,27
16,8481524,Bowen Byram,D,BUF,23,68,6,21,27
16,8476854,Hampus Lindholm,D,BOS,30,68,1,26,27
16,8474151,Ryan McDonagh,D,TBL,35,75,1,26,27
16,8479591,Michael Eyssimont,C,TBL,28,81,16,10,26
16,8477987,Ryan Donato,C,CHI,28,59,13,13,26
16,8475760,Nick Bjugstad,C,UTA,32,75,10,16,26
16,8477919,Frederick Gaudreau,C,MIN,31,60,10,16,26
16,8473422,Nick Foligno,L,CHI,37,61,10,16,26
16,8476480,Vladislav Namestnikov,C,WPG,32,64,9,17,26
16,8480145,Neal Pionk,D,WPG,29,67,8,18,26
16,8475855,Jesper Fast,R,CAR,33,58,7,19,26
16,8477015,Connor Brown,R,EDM,30,55,7,19,26
16,8476897,Oskar Sundqvist,C,STL,30,67,6,20,26
16,8480073,Erik Brannstrom,D,COL,25,67,6,20,26
16,8477220,Nate Schmidt,D,FLA,33,62,6,20,26
16,8482079,Marco Rossi,C,MIN,23,57,17,8,25
16,8477450,Jason Dickinson,C,CHI,29,56,13,12,25
16,8484145,Zach Benson,L,BUF,19,63,12,13,25
16,8479661,Tanner Jeannot,L,LAK,27,75,12,13,25
16,8473533,Jordan Staal,C,CAR,36,59,12,13,25
16,8476981,Josh Anderson,R,MTL,30,67,11,14,25
16,8483457,Lane Hutson,D,MTL,20,67,11,14,25
16,8482117,Lukas Reichel,L,CHI,22,60,10,15,25
16,8482067,Connor Mackey,D,NYR,28,61,9,16,25
16,8476392,Adam Lowry,C,WPG,31,70,9,16,25
16,8477507,Nikita Zadorov,D,BOS,29,71,9,16,25
16,8478911,Matt Roy,D,WSH,29,63,7,18,25
16,8477488,Brett Pesce,D,NJD,30,73,4,21,25
16,8479976,Juuso Valimaki,D,UTA,26,67,4,21,25
16,8476879,Cody Ceci,D,EDM,31,75,4,21,25
16,8475171,Oliver Ekman-Larsson,D,TOR,33,61,3,22,25
16,8476469,Joel Armia,R,MTL,31,68,16,8,24
16,8482062,Cole Smith,L,NSH,29,58,15,9,24
16,8477903,Garnet Hathaway,R,PHI,33,67,14,10,24
16,8482749,Joshua Roy,R,MTL,21,66,13,11,24
16,8478891,Mason Appleton,C,WPG,28,55,12,12,24
16,8474189,Lars Eller,C,PIT,35,66,11,13,24
16,8480003,Jesper Boqvist,C,FLA,26,69,10,14,24
16,8482111,Justin Barron,D,MTL,23,69,9,15,24
16,8480878,Nils Lundkvist,D,DAL,24,67,5,19,24
16,8480049,Dylan Samberg,D,WPG,25,64,5,19,24
16,8481523,Kirby Dach,C,MTL,23,66,4,20,24
16,8480222,Sebastian Aho,D,PIT,28,74,3,21,24
16,8480873,Rasmus Sandin,D,WSH,24,62,1,23,24
16,8481481,Blake Lizotte,C,PIT,27,59,14,9,23
16,8479619,Michael Carcone,L,UTA,28,64,12,11,23
16,8476960,Andreas Athanasiou,C,CHI,30,54,12,11,23
16,8479336,Carl Grundstrom,R,SJS,27,53,12,11,23
16,8478109,Victor Olofsson,L,VGK,29,76,11,12,23
16,8484203,Bradly Nadeau,L,CAR,19,61,11,12,23
16,8481601,Simon Holmstrom,R,NYI,23,69,10,13,23
16,8475193,Tomas Tatar,L,NJD,34,72,8,15,23
16,8480789,Oliver Wahlstrom,R,NYI,24,66,7,16,23
16,8477392,Hudson Fasching,R,NYI,29,64,6,17,23
16,8476329,Travis Boyd,C,MIN,31,58,6,17,23
16,8476979,Erik Gustafsson,D,DET,32,71,5,18,23
16,8477499,Rasmus Ristolainen,D,PHI,30,57,5,18,23
16,8478970,Jalen Chatfield,D,CAR,28,73,4,19,23
16,8481178,Egor Zamula,D,PHI,24,58,2,21,23
16,8476331,Dylan DeMelo,D,WPG,31,68,2,21,23
16,8479941,Justin Danforth,R,CBJ,31,58,15,7,22
16,8483491,Ivan Miroshnichenko,L,WSH,20,63,13,9,22
16,8478043,Sam Lafferty,C,BUF,29,61,12,10,22
16,8477478,William Carrier,L,CAR,30,58,12,10,22
16,8482809,Jackson Blake,R,CAR,21,51,10,12,22
16,8476422,Mike Reilly,D,NYI,31,73,9,13,22
16,8481582,Nicholas Robertson,L,TOR,23,68,8,14,22
16,8475200,Dmitry Orlov,D,CAR,33,69,7,15,22
16,8480246,Nick Perbix,D,TBL,26,74,7,15,22
16,8478178,Darren Raddysh,D,TBL,28,69,7,15,22
16,8481527,Kaedan Korczak,D,VGK,23,47,7,15,22
16,8476925,Colton Sissons,C,NSH,31,71,6,16,22
16,8473563,Nicklas Backstrom,C,WSH,37,60,6,16,22
16,8482671,Owen Power,D,BUF,22,68,5,17,22
16,8477989,Christian Dvorak,C,MTL,28,62,5,17,22
16,8478851,Alexandre Carrier,D,NSH,28,66,5,17,22
16,8482624,Daniil Miromanov,D,CGY,27,62,5,17,22
16,8478507,John Marino,D,UTA,27,64,5,17,22
16,8476467,Jamie Oleksiak,D,SEA,32,66,5,17,22
16,8480043,Timothy Liljegren,D,TOR,25,69,3,19,22
16,8482655,Janis Moser,D,TBL,24,77,0,22,22
16,8475231,Casey Cizikas,C,NYI,33,72,13,8,21
16,8483493,Frank Nazar,C,CHI,20,47,13,8,21
16,8480448,Parker Kelly,L,COL,25,77,12,9,21
16,8478569,Noel Acciari,C,PIT,33,51,11,10,21
16,8479353,Brett Howden,C,VGK,26,66,10,11,21
16,8475225,Craig Smith,C,CHI,35,55,10,11,21
16,8481441,Joe Snively,C,DET,28,68,10,11,21
16,8480995,Pontus Holmberg,R,TOR,25,59,9,12,21
16,8473453,Trevor Lewis,C,LAK,37,69,9,12,21
16,8482105,Jake Sanderson,D,OTT,22,79,7,14,21
16,8483468,Jiri Kulich,C,BUF,20,58,7,14,21
16,8480025,MacKenzie Entwistle,R,FLA,25,60,7,14,21
16,8481014,Alexander Romanov,D,NYI,24,79,6,15,21
16,8480980,Connor Dewar,C,TOR,25,72,6,15,21
16,8481568,Alex Vlasic,D,CHI,23,61,5,16,21
16,8478500,Ivan Provorov,D,CBJ,27,80,4,17,21
16,8482073,Braden Schneider,D,NYR,23,68,4,17,21
16,8480070,Ian Mitchell,D,BOS,25,50,4,17,21
16,8475188,Brayden McNabb,D,VGK,33,56,2,19,21
16,8482155,Alex Laferriere,R,LAK,23,70,13,7,20
16,8476878,Zemgus Girgensons,C,TBL,30,80,11,9,20
16,8479368,Max Jones,L,BOS,26,63,10,10,20
16,8479393,Noah Gregor,L,OTT,26,72,10,10,20
16,8477446,Michael McCarron,R,NSH,29,54,9,11,20
16,8483495,Simon Nemec,D,NJD,20,62,9,11,20
16,8481517,Brett Leason,R,ANA,25,62,7,13,20
16,8480891,Michael Kesselring,D,UTA,24,59,6,14,20
16,8477406,Mattias Janmark,C,EDM,32,66,6,14,20
16,8480078,Filip Chytil,C,NYR,25,61,5,15,20
16,8478434,Keegan Kolesar,R,VGK,27,60,5,15,20
16,8476429,Scott Mayfield,D,NYI,32,70,4,16,20
16,8477435,Ryan Graves,D,PIT,29,75,4,16,20
16,8479026,Philippe Myers,D,TOR,27,55,4,16,20
16,8475790,Erik Gudbranson,D,CBJ,32,79,3,17,20
16,8476988,Matt Benning,D,SJS,30,65,3,17,20
16,8474574,Tyler Myers,D,VAN,34,67,3,17,20
16,8480796,Martin Fehervary,D,WSH,25,62,3,17,20
16,8480021,Jack Studnicka,C,LAK,25,63,11,8,19
16,8482101,Danil Gushchin,L,SJS,22,53,9,10,19
16,8482679,Matt Coronato,R,CGY,22,62,9,10,19
16,8480011,Klim Kostin,C,SJS,25,53,9,10,19
16,8479316,Luke Kunin,C,SJS,27,58,7,12,19
16,8478443,Brandon Carlo,D,BOS,28,61,7,12,19
16,8479543,Michael Pezzetta,L,MTL,26,60,6,13,19
16,8482245,Artem Zub,D,OTT,29,71,4,15,19
16,8478468,Jeremy Lauzon,D,NSH,27,54,4,15,19
16,8481522,Peyton Krebs,C,BUF,23,60,3,16,19
16,8479983,Mario Ferraro,D,SJS,26,66,3,16,19
16,8475462,Radko Gudas,D,ANA,34,66,3,16,19
16,8479998,Mikey Anderson,D,LAK,25,62,2,17,19
16,8480001,Urho Vaakanainen,D,ANA,25,62,2,17,19
16,8479328,Julien Gauthier,R,NYI,27,59,11,7,18
16,8482074,Connor Zary,C,CGY,23,68,10,8,18
16,8482451,Mikael Pyyhtia,L,CBJ,23,48,8,10,18
16,8480813,Joe Veleno,C,DET,24,75,7,11,18
16,8480185,Eetu Luostarinen,C,FLA,26,76,6,12,18
16,8482142,Jamie Drysdale,D,PHI,22,59,6,12,18
16,8475181,Nick Leddy,D,STL,33,66,4,14,18
16,8477845,Trevor van Riemsdyk,D,WSH,33,59,3,15,18
16,8479402,Jake Bean,D,CGY,26,64,2,16,18
16,8481716,Dmitri Voronkov,L,CBJ,24,50,11,6,17
16,8479359,Beck Malenstyn,L,BUF,26,49,9,8,17
16,8477353,Tyler Motte,C,DET,29,75,8,9,17
16,8475842,Sam Carrick,C,NYR,32,53,8,9,17
16,8480762,Eric Robinson,L,CAR,29,55,7,10,17
16,8478452,Caleb Jones,D,LAK,27,61,7,10,17
16,8474034,Patrick Maroon,L,CHI,36,56,6,11,17
16,8476312,Josh Manson,D,COL,33,53,6,11,17
16,8482660,Kent Johnson,C,CBJ,22,60,5,12,17
16,8476856,Mathew Dumba,D,DAL,30,70,5,12,17
16,8477380,Jonny Brodzinski,C,NYR,31,45,5,12,17
16,8476525,Colin Miller,D,WPG,32,67,5,12,17
16,8477369,Carson Soucy,D,VAN,30,61,5,12,17
16,8480727,Zach Whitecloud,D,VGK,28,58,5,12,17
16,8480035,Henri Jokiharju,D,BUF,25,59,4,13,17
16,8478399,Jonas Siegenthaler,D,NJD,27,57,4,13,17
16,8482087,Kaiden Guhle,D,MTL,22,63,3,14,17
16,8480807,Mattias Samuelsson,D,BUF,24,52,3,14,17
16,8482157,Will Cuylle,L,NYR,22,57,8,8,16
16,8482807,Ethan Del Mastro,D,CHI,21,52,8,8,16
16,8480144,David Kampf,C,TOR,29,68,7,9,16
16,8481521,Ronnie Attard,D,PHI,25,61,3,13,16
16,8479324,Ryan Lindgren,D,NYR,26,59,3,13,16
16,8475343,Nic Dowd,C,WSH,34,57,3,13,16
16,8479249,Andrew Poturalski,C,SJS,30,35,3,13,16
16,8480355,Mark Kastelic,C,BOS,25,66,3,13,16
16,8478416,Erik Cernak,D,TBL,27,74,2,14,16
16,8474673,TJ Brodie,D,CHI,34,57,2,14,16
16,8476891,Matthew Grzelcyk,D,PIT,30,74,2,14,16
16,8477034,Jaycob Megna,D,FLA,32,51,2,14,16
16,8475179,Dmitry Kulikov,D,FLA,34,59,1,15,16
16,8476934,Brock McGinn,L,ANA,30,54,11,4,15
16,8478831,Kevin Stenlund,C,UTA,28,53,11,4,15
16,8478421,A.J. Greer,L,FLA,28,54,10,5,15
16,8483524,Shane Wright,C,SEA,20,61,8,7,15
16,8481580,Connor McMichael,C,WSH,23,59,8,7,15
16,8476374,Sean Kuraly,C,CBJ,31,57,8,7,15
16,8480172,Jan Rutta,D,SJS,34,56,8,7,15
16,8482747,Brennan Othmann,L,NYR,21,42,8,7,15
16,8476278,Colin Blackwell,C,DAL,31,75,7,8,15
16,8481477,Nico Sturm,C,SJS,29,57,7,8,15
16,8480289,Morgan Barron,C,WPG,26,52,7,8,15
16,8477573,Nathan Walker,L,STL,30,45,7,8,15
16,8477508,Curtis Lazar,C,NJD,29,60,6,9,15
16,8481028,Martin Pospisil,C,CGY,25,54,6,9,15
16,8476624,Barclay Goodrow,C,SJS,31,53,6,9,15
16,8481093,Rafael Harvey-Pinard,L,MTL,25,58,5,10,15
16,8475220,Marcus Foligno,L,MIN,33,66,5,10,15
16,8483499,Liam Ohgren,L,MIN,20,59,4,11,15
16,8479980,Nicolas Hague,D,VGK,26,47,4,11,15
16,8479315,Joey Anderson,R,CHI,26,46,4,11,15
16,8475690,Chris Tanev,D,TOR,35,53,3,12,15
16,8479442,Troy Stecher,D,EDM,30,52,3,12,15
16,8481708,Zac Jones,D,NYR,24,47,3,12,15
16,8478211,Dryden Hunt,L,CGY,29,54,3,12,15
16,8475762,Derek Forbort,D,VAN,32,48,3,12,15
16,8482077,Dylan Holloway,L,EDM,23,58,3,12,15
16,8475208,Brian Dumoulin,D,ANA,33,67,2,13,15
16,8477979,Nicolas Aube-Kubel,R,BUF,28,55,8,6,14
16,8476873,Mark Jankowski,C,NSH,30,39,7,7,14
16,8478017,Mark Friedman,D,VAN,29,41,7,7,14
16,8479439,Jacob MacDonald,D,COL,31,53,6,8,14
16,8478585,Derek Ryan,C,EDM,38,63,6,8,14
16,8479370,Tyson Jost,C,CAR,26,58,6,8,14
16,8476994,Vinnie Hinostroza,C,NSH,30,50,5,9,14
16,8476822,Luke Glendening,C,TBL,35,80,5,9,14
16,8477938,Haydn Fleury,D,WPG,28,43,5,9,14
16,8482666,Scott Morrow,D,CAR,22,50,5,9,14
16,8481704,Juuso Parssinen,C,NSH,23,50,4,10,14
16,8475279,Ben Chiarot,D,DET,33,67,4,10,14
16,8475718,Justin Holl,D,DET,32,70,4,10,14
16,8481598,Philip Broberg,D,EDM,23,43,4,10,14
16,8479718,Alex Barré-Boulet,C,MTL,27,46,3,11,14
16,8483460,David Jiricek,D,CBJ,21,61,2,12,14
16,8475233,David Savard,D,MTL,34,67,0,14,14
16,8482148,Hendrix Lapierre,C,WSH,22,54,7,6,13
16,8479414,Nathan Bastian,R,NJD,27,54,7,6,13
16,8481537,Nikita Okhotiuk,D,CGY,24,54,7,6,13
16,8481751,Lukas Rousek,R,BUF,25,42,7,6,13
16,8479344,Jesse Puljujarvi,R,PIT,26,50,7,6,13
16,8481641,Joel Kiviranta,L,COL,28,73,7,6,13
16,8482176,Wyatt Kaiser,D,CHI,22,53,6,7,13
16,8479378,Logan Stanley,D,WPG,26,51,5,8,13
16,8475750,Jon Merrill,D,MIN,32,58,5,8,13
16,8482744,James Malatesta,L,CBJ,21,32,4,9,13
16,8476889,Radek Faksa,C,STL,30,53,4,9,13
16,8479372,Joshua Mahura,D,SEA,26,56,3,10,13
16,8481167,Brayden Pachal,D,CGY,25,44,3,10,13
16,8480845,Rasmus Kupari,C,WPG,24,49,3,10,13
16,8478859,Niko Mikkola,D,FLA,28,58,3,10,13
16,8474568,Luke Schenn,D,NSH,35,48,3,10,13
16,8478840,Will Borgen,D,SEA,28,66,2,11,13
16,8471677,Jack Johnson,D,CBJ,37,57,2,11,13
16,8478136,Jake Middleton,D,MIN,28,73,1,12,13
16,8480074,Alexandre Texier,C,STL,25,59,7,5,12
16,8481617,Vasily Podkolzin,R,VAN,23,52,6,6,12
16,8477931,Tomas Nosek,L,FLA,32,56,6,6,12
16,8479638,Justin Brazeau,R,BOS,26,33,6,6,12
16,8481032,Paul Cotter,C,NJD,25,61,5,7,12
16,8479536,Axel Jonsson-Fjallby,L,WPG,26,36,5,7,12
16,8479291,Kevin Rooney,C,CGY,31,52,5,7,12
16,8480292,Carson Meyer,R,ANA,27,38,5,7,12
16,8483549,Lucas Condotta,L,MTL,27,31,5,7,12
16,8482803,Olen Zellweger,D,ANA,21,53,4,8,12
16,8479639,Dylan Coghlan,D,WPG,26,55,3,9,12
16,8474567,Zach Bogosian,D,MIN,34,67,3,9,12
16,8479371,Dante Fabbro,D,NSH,26,67,1,11,12
16,8479369,Andrew Peeke,D,BOS,26,61,1,11,12
16,8477365,Connor Clifton,D,BUF,29,54,0,12,12
16,8480281,Alexey Toropchenko,R,STL,25,58,9,2,11
16,8480007,Jonas Rondbjerg,R,VGK,25,43,7,4,11
16,8481161,Jake Christiansen,D,CBJ,25,56,6,5,11
16,8481532,Alex Turcotte,C,LAK,23,42,5,6,11
16,8482659,Josh Doan,R,UTA,22,48,5,6,11
16,8471817,Ryan Reaves,R,TOR,37,62,5,6,11
16,8477070,Liam O'Brien,C,UTA,30,55,5,6,11
16,8482153,Brendan Brisson,C,VGK,23,35,5,6,11
16,8476442,Matt Nieto,L,PIT,32,52,4,7,11
16,8477401,John Hayden,C,SEA,29,40,4,7,11
16,8478882,Vladislav Gavrikov,D,LAK,29,66,3,8,11
16,8480860,Kevin Bahl,D,CGY,24,61,3,8,11
16,8482859,Zack Ostapchuk,C,OTT,21,58,2,9,11
16,8482784,Zach Dean,C,STL,21,39,2,9,11
16,8478451,Ethan Bear,D,WSH,27,45,2,9,11
16,8471709,Marc-Edouard Vlasic,D,SJS,37,60,1,10,11
16,8481059,Scott Perunovich,D,STL,26,62,1,10,11
16,8480157,Calle Rosen,D,COL,30,45,1,10,11
16,8481567,Henry Thrun,D,SJS,23,49,1,10,11
16,8476372,Nick Seeler,D,PHI,31,44,1,10,11
16,8476967,Brett Kulak,D,EDM,30,65,1,10,11
16,8480950,Ilya Lyubushkin,D,DAL,30,64,0,11,11
16,8479994,Jaret Anderson-Dolan,C,WPG,25,35,9,1,10
16,8481592,Jakob Pelletier,L,CGY,23,43,7,3,10
16,8481013,Jonatan Berggren,R,DET,24,56,6,4,10
16,8482166,Shakir Mukhamadullin,D,SJS,22,60,6,4,10
16,8480441,Trey Fix-Wolansky,R,CBJ,25,44,6,4,10
16,8479671,Mathieu Olivier,R,CBJ,27,45,5,5,10
16,8480252,Cole Guttman,C,CHI,25,33,4,6,10
16,8480806,Isac Lundestrom,C,ANA,25,58,4,6,10
16,8482762,Simon Edvinsson,D,DET,21,58,4,6,10
16,8481600,Tobias Bjornfot,D,FLA,23,39,4,6,10
16,8479520,Brandon Duhaime,R,WSH,27,53,4,6,10
16,8478424,Jansen Harkins,C,ANA,27,43,4,6,10
16,8481147,Reese Johnson,C,MIN,26,37,4,6,10
16,8475324,Nick Jensen,D,OTT,34,67,3,7,10
16,8477851,Jordan Oesterle,D,BOS,32,45,2,8,10
16,8477887,Patrick Brown,C,BOS,32,52,2,8,10
16,8482964,Arber Xhekaj,D,MTL,23,47,2,8,10
16,8473446,Erik Johnson,D,PHI,36,57,1,9,10
16,8481518,Nolan Foote,L,NJD,24,45,7,2,9
16,8482192,Isaak Phillips,D,CHI,23,48,5,4,9
16,8479968,Vinni Lettieri,C,BOS,29,45,4,5,9
16,8480848,Ty Dellandrea,C,SJS,24,46,4,5,9
16,8481019,David Gustafsson,C,WPG,24,47,3,6,9
16,8475177,Calvin de Haan,D,COL,33,46,3,6,9
16,8483466,Kevin Korchinski,D,CHI,20,52,3,6,9
16,8477962,Brendan Lemieux,L,CAR,28,43,2,7,9
16,8482652,Walker Duehr,R,CGY,27,35,2,7,9
16,8480245,Olle Lycksell,R,PHI,25,33,2,7,9
16,8481701,Santeri Hatakka,D,NJD,23,35,1,8,9
16,8482095,Tyler Kleven,D,OTT,22,45,1,8,9
16,8482634,Alex Steeves,C,TOR,25,42,0,9,9
16,8484254,Akito Hirose,D,VAN,25,35,0,9,9
16,8479066,Ryan Lomberg,L,CGY,30,63,4,4,8
16,8481550,Adam Beckman,L,NJD,23,36,4,4,8
16,8477384,Joshua Brown,D,EDM,30,35,3,5,8
16,8479972,Mason Shaw,C,WPG,26,40,3,5,8
16,8484911,Collin Graf,R,SJS,22,37,3,5,8
16,8481609,Vladislav Kolyachonok,D,UTA,23,29,3,5,8
16,8482751,Ryan Winterton,C,SEA,21,30,3,5,8
16,8479985,Cale Fleury,D,SEA,26,31,3,5,8
16,8480887,Jordan Harris,D,MTL,24,50,2,6,8
16,8480844,Grigori Denisenko,L,VGK,24,23,2,6,8
16,8476874,Olli Maatta,D,DET,30,52,2,6,8
16,8482496,Nils Aman,C,VAN,24,41,2,6,8
16,8479348,Kale Clague,D,BUF,26,44,1,7,8
16,8476952,Dominic Toninato,C,WPG,30,36,1,7,8
16,8480058,Pierre-Olivier Joseph,D,STL,25,50,0,8,8
16,8474612,Travis Hamonic,D,OTT,34,40,0,8,8
16,8481754,Nikita Nesterenko,C,ANA,23,29,6,1,7
16,8477335,Kyle Burroughs,D,LAK,29,40,5,2,7
16,8482713,Mackie Samoskevich,R,FLA,22,46,4,3,7
16,8483763,Maksymilian Szuber,D,UTA,22,32,4,3,7
16,8481056,Spencer Stastney,D,NSH,24,29,3,4,7
16,8481679,Maxence Guenette,D,OTT,23,40,3,4,7
16,8475795,Dylan McIlrath,D,WSH,32,21,3,4,7
16,8476858,Phillip Di Giuseppe,L,VAN,31,36,2,5,7
16,8479379,Givani Smith,R,SJS,26,31,2,5,7
16,8477320,Anton Blidh,L,NYR,29,29,2,5,7
16,8478021,William Lagesson,D,DET,28,21,2,5,7
16,8481556,John Beecher,C,BOS,23,29,2,5,7
16,8470600,Ryan Suter,D,STL,39,59,1,6,7
16,8479986,Kole Lind,R,DAL,26,49,1,6,7
16,8474166,Alec Martinez,D,CHI,37,56,0,7,7
16,8475958,Michael Sgarbossa,C,WSH,32,32,5,1,6
16,8481237,Kyle MacLean,C,NYI,25,28,5,1,6
16,8484149,Gavin Brindley,C,CBJ,20,50,4,2,6
16,8482141,Lukas Cormier,D,VGK,22,21,4,2,6
16,8479991,Jake Leschyshyn,C,NYR,25,33,4,2,6
16,8479944,Zach Aston-Reese,C,VGK,30,48,3,3,6
16,8480192,Johnathan Kovacevic,D,NJD,27,43,3,3,6
16,8475235,Nicolas Deslauriers,L,PHI,33,46,3,3,6
16,8474013,Ian Cole,D,UTA,35,51,3,3,6
16,8477482,Zachary Sanford,L,CHI,30,39,2,4,6
16,8480834,Ty Emberson,D,SJS,24,32,2,4,6
16,8478409,Anthony Richard,C,PHI,28,44,2,4,6
16,8480267,Sammy Walker,C,MIN,25,22,2,4,6
16,8479772,Zack MacEwen,R,OTT,28,47,2,4,6
16,8475455,Brenden Dillon,D,NJD,34,61,1,5,6
16,8478874,Adam Gaudette,R,OTT,28,35,1,5,6
16,8480879,Jacob Bernard-Docker,D,OTT,24,42,1,5,6
16,8478502,Dennis Gilbert,D,BUF,28,17,1,5,6
16,8481122,Simon Benoit,D,TOR,26,44,1,5,6
16,8477467,Gustav Olofsson,D,SEA,30,17,1,5,6
16,8480196,Jacob Bryson,D,BUF,27,43,0,6,6
16,8483570,Ben Meyers,C,SEA,26,25,5,0,5
16,8482730,Brandt Clarke,D,LAK,21,52,4,1,5
16,8482765,Isak Rosen,R,BUF,21,29,3,2,5
16,8482070,Mitchell Chaffee,R,TBL,26,55,3,2,5
16,8479981,Jonah Gadjovich,L,FLA,26,44,3,2,5
16,8483397,Marc McLaughlin,C,BOS,25,26,3,2,5
16,8484287,Cole McWard,D,VAN,23,20,3,2,5
16,8483012,Logan Morrison,C,SEA,22,41,3,2,5
16,8476867,Brendan Gaunce,C,MIN,30,36,2,3,5
16,8480880,Jakub Lauko,C,MIN,24,32,2,3,5
16,8482858,Ryker Evans,D,SEA,23,22,2,3,5
16,8474090,Brendan Smith,D,DAL,35,57,1,4,5
16,8476473,Connor Murphy,D,CHI,31,39,1,4,5
16,8476913,Devin Shore,C,MIN,30,32,1,4,5
16,8482145,Mavrik Bourque,C,DAL,22,52,1,4,5
16,8479367,William Lockwood,R,FLA,26,24,1,4,5
16,8482144,Jack Thompson,D,SJS,22,30,1,4,5
16,8476441,Joel Edmundson,D,LAK,31,32,0,5,5
16,8481789,Tye Kartye,L,SEA,23,37,3,1,4
16,8477473,Justin Bailey,R,SJS,29,28,3,1,4
16,8478454,Noah Juulsen,D,VAN,27,36,3,1,4
16,8480851,Akil Thomas,C,LAK,24,22,3,1,4
16,8482201,Gage Goncalves,C,TBL,23,22,2,2,4
16,8477018,Ben Hutton,D,VGK,31,42,1,3,4
16,8481599,Victor Soderstrom,D,UTA,23,42,1,3,4
16,8480990,Declan Chisholm,D,MIN,24,39,1,3,4
16,8480870,Bo Groulx,C,NYR,24,29,1,3,4
16,8482250,Callahan Burke,C,VGK,27,22,1,3,4
16,8478051,Max Willman,C,NJD,29,18,1,3,4
16,8477244,Chad Ruhwedel,D,NYR,34,37,1,3,4
16,8482470,Ilya Solovyov,D,CGY,24,22,1,3,4
16,8483597,Milos Kelemen,L,UTA,25,12,0,4,4
16,8481605,Jackson LaCombe,D,ANA,23,30,0,4,4
16,8480306,Grant Hutton,D,NYI,29,6,0,4,4
16,8482733,Logan Mailloux,D,MTL,31,37,2,1,3
16,8482511,Mason Lohrei,D,BOS,23,35,2,1,3
16,8480468,James Hamblin,L,EDM,25,19,2,1,3
16,8481006,Tyler Tucker,D,STL,24,19,2,1,3
16,8481043,Cole Koepke,L,BOS,26,21,2,1,3
16,8482861,Vincent Iorio,D,WSH,22,39,1,2,3
16,8482516,Matthew Kessel,D,STL,24,21,1,2,3
16,8478011,Louie Belpedio,D,PHI,28,10,1,2,3
16,8482787,Nikita Chibrikov,R,WPG,31,8,1,2,3
16,8478450,Parker Wotherspoon,D,BOS,27,27,0,3,3
16,8479576,Vincent Desharnais,D,VAN,28,36,0,3,3
16,8477527,Ross Johnston,L,ANA,30,34,0,3,3
16,8481578,Graeme Clarke,R,MIN,23,12,0,3,3
16,8483619,Filip Roos,D,OTT,25,26,2,0,2
16,8482094,Daemon Hunt,D,MIN,22,12,2,0,2
16,8481699,Aku Raty,R,UTA,23,22,2,0,2
16,8477993,Justin Kirkland,C,CGY,28,8,2,0,2
16,8479320,Maxime Lajoie,D,SEA,27,27,1,1,2
16,8480890,Jan Jenik,C,OTT,24,16,1,1,2
16,8481422,Jake Lucchini,C,NSH,29,24,1,1,2
16,8477073,Kurtis MacDermid,L,NJD,30,32,1,1,2
16,8484258,Sam Malinski,D,COL,26,20,1,1,2
16,8478146,Matthew Highmore,C,OTT,28,34,1,1,2
16,8477810,Joel Hanley,D,CGY,33,16,1,1,2
16,8479362,Riley Tufte,L,BOS,26,16,1,1,2
16,8477971,Andreas Englund,D,LAK,28,35,1,1,2
16,8483512,Matthew Savoie,C,EDM,20,17,1,1,2
16,8483489,Fraser Minten,C,TOR,31,15,1,1,2
16,8483432,Luca Del Bel Belluz,C,CBJ,31,8,1,1,2
16,8481543,Nikita Alexandrov,C,STL,24,20,0,2,2
16,8475755,Alexander Petrovic,D,DAL,32,9,0,2,2
16,8477149,Scott Sabourin,R,SJS,32,15,0,2,2
16,8477462,Robert Hagg,D,VGK,29,26,0,2,2
16,8482165,Yan Kuznetsov,D,CGY,22,20,0,2,2
16,8481585,Egor Afanasyev,L,SJS,23,13,0,2,2
16,8484325,Waltteri Merela,C,TBL,26,16,0,2,2
16,8479421,Jacob Moverare,D,LAK,26,8,0,2,2
16,8480823,Alexander Alexeyev,D,WSH,25,10,0,2,2
16,8482162,Roby Jarventie,L,EDM,22,23,0,2,2
16,8478881,Brett Seney,L,CHI,28,16,1,0,1
16,8482172,Landon Slaggert,L,CHI,22,24,1,0,1
16,8481593,Jayden Struble,D,MTL,23,17,1,0,1
16,8482177,Marat Khusnutdinov,C,MIN,22,32,1,0,1
16,8479419,Brett Murray,L,BUF,26,13,1,0,1
16,8482102,Vasily Ponomarev,C,PIT,22,16,1,0,1
16,8481564,Ryan Johnson,D,BUF,23,16,1,0,1
16,8482061,Brandon Biro,L,SEA,26,11,1,0,1
16,8482088,Justin Sourdif,R,FLA,22,17,1,0,1
16,8482460,Matt Rempe,C,NYR,22,15,1,0,1
16,8484255,Jason Polin,R,COL,25,3,1,0,1
16,8475413,Justin Dowling,C,NJD,34,8,1,0,1
16,8481462,Mason Morelli,L,VGK,28,18,1,0,1
16,8480075,Cameron Crotty,D,MIN,25,12,1,0,1
16,8483630,Pavol Regenda,L,ANA,25,23,0,1,1
16,8479587,Rhett Gardner,C,PHI,28,16,0,1,1
16,8481806,Louis Crevier,D,CHI,23,9,0,1,1
16,8481719,Maxwell Crozier,D,TBL,24,15,0,1,1
16,8482929,Emil Lilleberg,D,TBL,23,20,0,1,1
16,8474062,Riley Nash,C,NYR,35,21,0,1,1
16,8481541,Samuel Bolduc,D,NYI,24,27,0,1,1
16,8477541,Dakota Mermis,D,TOR,30,10,0,1,1
16,8483407,Brandon Scanlin,D,NYR,25,7,0,1,1
16,8480032,Shane Bowers,C,NJD,25,14,0,1,1
16,8480084,Nick DeSimone,D,NJD,30,12,0,1,1
16,8476323,Max McCormick,L,SEA,32,4,0,1,1
16,8479330,Brandon Gignac,C,MTL,27,13,0,1,1
16,8483567,Georgii Merkulov,C,BOS,24,5,0,1,1
16,8481024,Linus Karlsson,C,VAN,25,10,0,1,1
16,8483401,Marc Johnstone,R,PIT,28,3,0,1,1
16,8481065,Angus Crookshank,L,OTT,25,18,0,0,0
16,8481743,Marc Del Gaizo,D,NSH,25,18,0,0,0
16,8480874,Adam Ginning,D,PHI,24,6,0,0,0
16,8479522,Hardy Haman Aktell,D,WSH,26,5,0,0,0
16,8478446,Glenn Gawdin,C,LAK,27,9,0,0,0
16,8478477,Mitchell Stephens,C,SEA,27,22,0,0,0
16,8481030,Jack St. Ivany,D,PIT,25,15,0,0,0
16,8483395,Arshdeep Bains,L,VAN,23,8,0,0,0
16,8482118,Sam Colangelo,R,ANA,23,12,0,0,0
16,8482197,Adam Raska,R,MIN,23,3,0,0,0
16,8481655,Cole Schwindt,R,CGY,23,5,0,0,0
16,8481726,Adam Edstrom,C,NYR,24,6,0,0,0
16,8483531,Brian Halonen,L,NJD,25,2,0,0,0
16,8482476,Emil Heineman,L,MTL,23,7,0,0,0
16,8483471,Brad Lambert,C,WPG,31,15,0,0,0
16,8483920,Pierrick Dube,R,WSH,23,4,0,0,0
16,8483398,Declan Carlile,D,TBL,31,9,0,0,0
16,8482147,Jean-Luc Foudy,C,COL,22,18,0,0,0
16,8475780,Chris Wagner,R,COL,33,8,0,0,0
16,8478854,Ryan Shea,D,PIT,27,8,0,0,0
16,8481206,John Ludvig,D,PIT,24,8,0,0,0
16,8483609,Adam Klapka,R,CGY,24,1,0,0,0
16,8484304,Uvis Balinskis,D,FLA,28,10,0,0,0
16,8484259,Ondrej Pavel,C,COL,31,3,0,0,0
16,8484321,Nikolas Matinpalo,D,OTT,26,5,0,0,0
16,8481534,Raphael Lavoie,C,EDM,24,0,0,0,0
16,8484326,Patrik Koch,D,UTA,28,3,0,0,0
16,8478147,Bokondji Imama,L,PIT,28,6,0,0,0
16,8483546,Marshall Rifai,D,TOR,26,4,0,0,0
16,8482126,Emil Andrae,D,PHI,31,1,0,0,0
16,8470794,Joe Pavelski,C,,40,0,0,0,0
16,8479321,Lucas Johansen,D,,27,0,0,0,0
16,8477950,Tony DeAngelo,D,,29,0,0,0,0
16,8471218,Blake Wheeler,R,,38,0,0,0,0
16,8475197,Tyson Barrie,D,,33,0,0,0,0
16,8474157,Max Pacioretty,L,,36,0,0,0,0
16,8475744,Evgeny Kuznetsov,C,,32,0,0,0,0
16,8474037,James van Riemsdyk,L,,35,0,0,0,0
16,8476907,Mackenzie MacEachern,L,,30,0,0,0,0
16,8480216,Jacob Peterson,C,,25,0,0,0,0
16,8474602,Justin Schultz,D,,34,0,0,0,0
16,8482222,Alexander Barabanov,L,,30,0,0,0,0
16,8474031,Kevin Shattenkirk,D,,35,0,0,0,0
16,8477330,Dominik Kubalik,L,,29,0,0,0,0
16,8480884,Calen Addison,D,,24,0,0,0,0
16,8475906,John Klingberg,D,,32,0,0,0,0
16,8480008,Adam Ruzicka,C,,25,0,0,0,0
16,8476884,Derrick Pouliot,D,,30,0,0,0,0
16,8476919,Chris Tierney,C,,30,0,0,0,0
16,8479415,Michael McLeod,C,,26,0,0,0,0
16,8474870,Tyler Johnson,C,,34,0,0,0,0
16,8470604,Jeff Carter,C,,39,0,0,0,0
16,8478104,Sammy Blais,L,,28,0,0,0,0
16,8474884,Mike Hoffman,C,,35,0,0,0,0
16,8481591,Sam Poulin,R,,23,0,0,0,0
16,8471274,Alex Goligoski,D,,39,0,0,0,0
16,8476871,Tanner Pearson,L,,32,0,0,0,0
16,8476393,Nick Cousins,C,,31,0,0,0,0
16,8479977,Kailer Yamamoto,R,,26,0,0,0,0
16,8479346,Dillon Dube,C,,26,0,0,0,0
16,8480184,Gustav Lindstrom,D,,26,0,0,0,0
16,8479376,Victor Mete,D,,26,0,0,0,0
16,8473449,Kyle Okposo,R,,36,0,0,0,0
16,8481058,Jesse Ylonen,R,,25,0,0,0,0
16,8475752,Tyler Pitlick,C,,33,0,0,0,0
16,8481239,Samuel Fagemo,L,,24,0,0,0,0
16,8480821,Filip Zadina,R,,25,0,0,0,0
16,8470966,Mark Giordano,D,,41,0,0,0,0
16,8478495,Denis Gurianov,R,,27,0,0,0,0
16,8477464,Nic Petan,C,,29,0,0,0,0
16,8478099,Kevin Labanc,R,,29,0,0,0,0
16,8482241,Radim Zohorna,L,,28,0,0,0,0
16,8474040,Sam Gagner,C,,35,0,0,0,0
16,8479514,Rem Pitlick,C,,27,0,0,0,0
16,8478430,Oliver Kylington,D,,27,0,0,0,0
16,8479533,Joona Koppanen,L,,26,0,0,0,0
16,8479984,Cal Foote,D,,26,0,0,0,0
16,8477126,Jayson Megna,C,,34,0,0,0,0
16,8475164,Jakob Silfverberg,R,,34,0,0,0,0
16,8474009,Nick Bonino,C,,36,0,0,0,0
16,8479458,Nikita Zaitsev,D,,33,0,0,0,0
16,8477944,Jakub Vrana,L,,28,0,0,0,0
16,8471699,Andrew Cogliano,C,,37,0,0,0,0
16,8478067,Oskar Lindblom,L,,28,0,0,0,0
16,8471686,Marc Staal,D,,37,0,0,0,0
16,8470610,Zach Parise,L,,40,0,0,0,0
16,8478904,Steven Lorentz,C,,28,0,0,0,0
16,8473473,Milan Lucic,L,,36,0,0,0,0
16,8480031,Maxime Comtois,L,,25,0,0,0,0
16,8478512,Austin Czarnik,C,,32,0,0,0,0
16,8473504,Cal Clutterbuck,R,,37,0,0,0,0
16,8477454,Adam Erne,L,,29,0,0,0,0
16,8479383,Boris Katchouk,L,,26,0,0,0,0
16,8475825,Jani Hakanpää,D,,32,0,0,0,0
16,8477846,Ryan Carpenter,C,,33,0,0,0,0
16,8477930,Pierre-Edouard Bellemare,L,,39,0,0,0,0
16,8478400,Colin White,C,,27,0,0,0,0
16,8480226,Marián Studenic,R,,26,0,0,0,0
16,8480853,Liam Foudy,C,,24,0,0,0,0
16,8475797,Jarred Tinordi,D,,32,0,0,0,0
16,8479423,Alex Nylander,L,,26,0,0,0,0
16,8474618,Marco Scandella,D,,34,0,0,0,0
16,8478028,Fredrik Olofsson,L,,28,0,0,0,0
16,8474709,Matt Martin,L,,35,0,0,0,0
16,8481070,Hugh McGing,L,,26,0,0,0,0
16,8479546,Oskar Steen,C,,26,0,0,0,0
16,8474145,Robert Bortuzzo,D,,35,0,0,0,0
16,8476915,Jujhar Khaira,L,,30,0,0,0,0
16,8480274,Philip Kemp,D,EDM,25,1,0,0,0
16,8475278,Byron Froese,C,,33,0,0,0,0
16,8481812,Nikolai Knyzhov,D,,27,0,0,0,0
16,8478408,Travis Dermott,D,,28,0,0,0,0
16,8481077,John Leonard,L,,26,0,0,0,0
16,8479547,Matthew Phillips,R,,26,0,0,0,0
16,8480836,Jonathan Gruden,C,,24,0,0,0,0
16,8481690,Tyler Angle,C,,24,0,0,0,0
16,8475766,Austin Watson,L,,32,0,0,0,0
16,8481016,Ruslan Iskhakov,C,,24,0,0,0,0
16,8478078,Rourke Chartier,C,,28,0,0,0,0
16,8480776,Sheldon Rempal,R,,29,0,0,0,0
16,8478956,Samuel Laberge,L,NJD,27,1,0,0,0
16,8483045,Cameron Butler,R,CBJ,31,0,0,0,0
16,8484314,Jiri Smejkal,L,,28,0,0,0,0
17,8477492,Nathan MacKinnon,C,COL,29,82,51,92,143
17,8478420,Mikko Rantanen,R,COL,28,81,55,77,132
17,8478402,Connor McDavid,C,EDM,27,78,49,79,128
17,8476453,Nikita Kucherov,R,TBL,31,82,49,79,128
17,8477956,David Pastrnak,R,BOS,28,82,60,57,117
17,8477934,Leon Draisaitl,C,EDM,29,79,52,65,117
17,8479318,Auston Matthews,C,TOR,27,80,66,46,112
17,8479314,Matthew Tkachuk,L,FLA,27,79,32,80,112
17,8478483,Mitch Marner,R,TOR,27,78,41,70,111
17,8481559,Jack Hughes,C,NJD,23,76,39,72,111
17,8477939,William Nylander,R,TOR,28,79,43,67,110
17,8471675,Sidney Crosby,C,PIT,37,78,42,66,108
17,8477409,Carter Verhaeghe,C,FLA,29,79,49,57,106
17,8477404,Jake Guentzel,C,TBL,30,82,43,57,100
17,8478864,Kirill Kaprizov,L,MIN,27,72,49,48,97
17,8477493,Aleksander Barkov,C,FLA,29,77,23,74,97
17,8476468,J.T. Miller,C,VAN,31,75,29,67,96
17,8480012,Elias Pettersson,C,VAN,26,78,43,51,94
17,8477946,Dylan Larkin,C,DET,28,81,42,52,94
17,8477501,Valeri Nichushkin,R,COL,29,80,42,51,93
17,8476887,Filip Forsberg,L,NSH,30,71,35,58,93
17,8480027,Jason Robertson,L,DAL,25,82,33,58,91
17,8478398,Kyle Connor,L,WPG,28,70,39,51,90
17,8477942,Kevin Fiala,L,LAK,28,82,33,57,90
17,8476460,Mark Scheifele,C,WPG,31,73,39,50,89
17,8480069,Cale Makar,D,COL,26,74,26,63,89
17,8477933,Sam Reinhart,C,FLA,29,78,45,43,88
17,8475913,Mark Stone,R,VGK,32,76,32,55,87
17,8478550,Artemi Panarin,L,NYR,33,78,25,60,85
17,8480002,Nico Hischier,C,NJD,25,78,25,58,83
17,8475172,Nazem Kadri,C,CGY,34,76,24,59,83
17,8480023,Robert Thomas,C,STL,25,75,20,63,83
17,8478449,Roope Hintz,C,DAL,28,82,45,37,82
17,8478010,Brayden Point,C,TBL,28,81,42,39,81
17,8474564,Steven Stamkos,C,NSH,34,73,35,46,81
17,8475166,John Tavares,C,TOR,34,79,35,44,79
17,8479385,Jordan Kyrou,C,STL,26,74,28,51,79
17,8484144,Connor Bedard,C,CHI,19,66,32,46,78
17,8478427,Sebastian Aho,C,CAR,27,71,28,50,78
17,8477940,Nikolaj Ehlers,L,WPG,28,70,28,50,78
17,8482116,Tim Stützle,C,OTT,22,81,25,53,78
17,8474600,Roman Josi,D,NSH,34,77,23,55,78
17,8478445,Mathew Barzal,C,NYI,27,81,19,59,78
17,8476459,Mika Zibanejad,C,NYR,31,80,36,41,77
17,8474141,Patrick Kane,R,DET,36,81,31,46,77
17,8479542,Brandon Hagel,L,TBL,26,82,30,47,77
17,8478414,Timo Meier,R,NJD,28,79,40,36,76
17,8479420,Tage Thompson,C,BUF,27,75,37,39,76
17,8480801,Brady Tkachuk,L,OTT,25,79,37,37,74
17,8478439,Travis Konecny,R,PHI,27,74,27,47,74
17,8480018,Nick Suzuki,C,MTL,25,76,25,49,74
17,8482740,Wyatt Johnston,C,DAL,21,82,43,30,73
17,8479343,Clayton Keller,R,UTA,26,76,32,41,73
17,8477960,Adrian Kempe,R,LAK,28,81,25,48,73
17,8476456,Jonathan Huberdeau,C,CGY,31,78,18,55,73
17,8477949,Alex Tuch,R,BUF,28,73,29,43,72
17,8475786,Zach Hyman,L,EDM,32,77,28,44,72
17,8476454,Ryan Nugent-Hopkins,C,EDM,31,80,24,48,72
17,8480865,Noah Dobson,D,NYI,24,79,15,57,72
17,8481068,Yegor Sharangovich,C,CGY,26,76,39,32,71
17,8476881,Tomas Hertl,C,VGK,31,77,28,43,71
17,8479323,Adam Fox,D,NYR,26,74,19,52,71
17,8478403,Jack Eichel,C,VGK,28,76,37,33,70
17,8471215,Evgeni Malkin,C,PIT,38,68,35,35,70
17,8481557,Matt Boldy,L,MIN,23,75,32,38,70
17,8475158,Ryan O'Reilly,C,NSH,33,73,22,48,70
17,8480800,Quinn Hughes,D,VAN,25,77,13,57,70
17,8478440,Dylan Strome,C,WSH,27,73,22,47,69
17,8480839,Rasmus Dahlin,D,BUF,24,72,17,52,69
17,8475167,Victor Hedman,D,TBL,34,78,16,53,69
17,8477955,Jared McCann,L,SEA,28,73,34,34,68
17,8476448,William Karlsson,C,VGK,31,78,26,42,68
17,8477402,Pavel Buchnevich,L,STL,29,72,24,44,68
17,8475754,Brock Nelson,C,NYI,33,80,37,30,67
17,8477500,Bo Horvat,C,NYI,29,78,29,38,67
17,8481533,Trevor Zegras,C,ANA,23,75,24,43,67
17,8475745,Charlie Coyle,C,BOS,32,77,20,47,67
17,8479325,Charlie McAvoy,D,BOS,27,77,17,50,67
17,8483808,Andrei Kuzmenko,L,CGY,28,78,35,31,66
17,8473512,Claude Giroux,R,OTT,36,80,23,43,66
17,8475692,Mats Zuccarello,R,MIN,37,73,15,51,66
17,8480036,Miro Heiskanen,D,DAL,25,70,10,56,66
17,8480208,Drake Batherson,R,OTT,26,79,24,41,65
17,8478975,Mason Marchment,L,DAL,29,81,20,45,65
17,8480803,Evan Bouchard,D,EDM,25,78,19,46,65
17,8478460,Zach Werenski,D,CBJ,27,80,15,49,64
17,8481540,Cole Caufield,R,MTL,23,76,31,32,63
17,8475784,Jeff Skinner,C,EDM,32,77,30,33,63
17,8475810,Bryan Rust,R,PIT,32,78,27,36,63
17,8478873,Troy Terry,R,ANA,27,75,26,37,63
17,8475168,Matt Duchene,C,DAL,33,82,25,38,63
17,8481528,Dylan Cozens,C,BUF,23,73,21,42,63
17,8475765,Vladimir Tarasenko,R,DET,33,79,18,45,63
17,8474590,John Carlson,D,WSH,34,68,16,47,63
17,8479337,Alex DeBrincat,R,DET,27,79,23,39,62
17,8477951,Nick Schmaltz,C,UTA,28,77,20,42,62
17,8476905,Chandler Stephenson,C,SEA,30,76,20,42,62
17,8475798,Mikael Granlund,C,SJS,32,72,11,50,61
17,8478047,Michael Bunting,L,PIT,29,77,26,34,60
17,8482078,Lucas Raymond,L,DET,22,80,26,34,60
17,8471685,Anze Kopitar,C,LAK,37,80,16,44,60
17,8477932,Aaron Ekblad,D,FLA,28,71,16,44,60
17,8476853,Morgan Rielly,D,TOR,30,69,13,47,60
17,8471724,Kris Letang,D,PIT,37,78,11,49,60
17,8482113,Anton Lundell,C,FLA,23,79,29,30,59
17,8473419,Brad Marchand,L,BOS,36,78,24,35,59
17,8479407,Jesper Bratt,L,NJD,26,73,22,37,59
17,8476389,Vincent Trocheck,C,NYR,31,75,22,37,59
17,8474578,Erik Karlsson,D,PIT,34,80,12,47,59
17,8475184,Chris Kreider,L,NYR,33,74,33,25,58
17,8477476,Artturi Lehkonen,L,COL,29,79,24,34,58
17,8482124,Quinton Byfield,R,LAK,22,81,20,38,58
17,8477495,Seth Jones,D,CHI,30,70,18,40,58
17,8477986,Brandon Montour,D,SEA,30,74,15,43,58
17,8478366,Frank Vatrano,R,ANA,30,70,29,28,57
17,8479675,Trevor Moore,L,LAK,29,82,28,29,57
17,8473986,Alex Killorn,L,ANA,35,73,26,31,57
17,8477496,Elias Lindholm,C,BOS,30,77,24,33,57
17,8474150,Mikael Backlund,C,CGY,35,76,23,34,57
17,8482720,Matthew Knies,L,TOR,22,76,19,38,57
17,8477504,Josh Morrissey,D,WPG,29,71,14,43,57
17,8480015,Owen Tippett,R,PHI,25,74,30,26,56
17,8475726,Tyler Toffoli,C,SJS,32,69,29,27,56
17,8482665,Matty Beniers,C,SEA,22,67,22,34,56
17,8477503,Max Domi,C,TOR,29,81,16,40,56
17,8481524,Bowen Byram,D,BUF,23,69,16,40,56
17,8476539,Jonathan Marchessault,R,NSH,34,71,35,20,55
17,8482699,Dylan Guenther,R,UTA,21,78,22,33,55
17,8477416,Oliver Bjorkstrand,R,SEA,29,72,22,33,55
17,8471214,Alex Ovechkin,L,WSH,39,68,31,23,54
17,8477935,Sam Bennett,C,FLA,28,79,23,31,54
17,8482684,Luke Hughes,D,NJD,21,68,11,43,54
17,8480014,Gabriel Vilardi,C,WPG,25,74,27,26,53
17,8482149,Cole Perfetti,C,WPG,22,70,23,30,53
17,8483515,Juraj Slafkovsky,L,MTL,20,78,22,31,53
17,8477494,Jonathan Drouin,L,COL,29,80,19,34,53
17,8474563,Drew Doughty,D,LAK,35,72,17,36,53
17,8475794,Tyler Seguin,C,DAL,32,81,24,28,52
17,8479999,Casey Mittelstadt,C,COL,26,81,21,31,52
17,8473994,Jamie Benn,L,DAL,35,81,21,31,52
17,8475314,Anders Lee,L,NYI,34,77,20,32,52
17,8476479,Phillip Danault,C,LAK,31,81,16,36,52
17,8477021,Alex Kerfoot,C,UTA,30,75,14,38,52
17,8479410,Mikhail Sergachev,D,UTA,26,72,9,43,52
17,8480039,Martin Necas,C,CAR,25,77,25,26,51
17,8480797,Joel Farabee,L,PHI,24,70,20,31,51
17,8476346,Johnny Gaudreau,L,CBJ,31,76,11,40,51
17,8478038,Devon Toews,D,COL,30,71,11,40,51
17,8474102,David Perron,L,OTT,36,78,30,20,50
17,8480830,Andrei Svechnikov,R,CAR,24,70,25,25,50
17,8482745,Mason McTavish,C,ANA,21,71,21,29,50
17,8482092,Ridly Greig,C,OTT,22,76,16,34,50
17,8476875,Mike Matheson,D,MTL,30,76,8,42,50
17,8476432,Boone Jenner,C,CBJ,31,69,26,23,49
17,8482109,Alexis Lafrenière,L,NYR,23,76,26,23,49
17,8479987,Morgan Geekie,C,BOS,26,76,22,27,49
17,8478542,Evan Rodrigues,C,FLA,31,74,20,29,49
17,8478462,Nicolas Roy,C,VGK,27,74,20,29,49
17,8476882,Teuvo Teravainen,C,CHI,30,64,17,32,49
17,8478055,Gustav Forsling,D,FLA,28,71,16,33,49
17,8474679,Gustav Nyquist,C,NSH,35,77,11,38,49
17,8477407,Anthony Duclair,L,NYI,29,78,23,25,48
17,8479400,Pierre-Luc Dubois,L,WSH,26,71,20,28,48
17,8478519,Anthony Cirelli,C,TBL,27,82,20,28,48
17,8478466,Daniel Sprong,R,VAN,27,66,19,29,48
17,8484145,Zach Benson,L,BUF,19,69,19,29,48
17,8483431,Logan Cooley,C,UTA,20,74,18,30,48
17,8478401,Pavel Zacha,C,BOS,27,76,16,32,48
17,8476792,Torey Krug,D,STL,33,69,14,34,48
17,8481581,Thomas Harley,D,DAL,23,78,10,38,48
17,8480028,Morgan Frost,C,PHI,25,76,22,25,47
17,8478856,Conor Garland,R,VAN,28,76,18,29,47
17,8477479,Tyler Bertuzzi,L,CHI,29,59,15,32,47
17,8477426,Nicholas Paul,L,TBL,29,82,28,18,46
17,8475170,Brayden Schenn,C,STL,33,75,19,27,46
17,8479339,Patrik Laine,L,CBJ,26,62,18,28,46
17,8478042,Viktor Arvidsson,L,EDM,31,73,18,28,46
17,8481711,Matias Maccelli,L,UTA,24,74,15,31,46
17,8480188,Fabian Zetterlund,L,SJS,25,68,14,32,46
17,8476906,Shayne Gostisbehere,D,CAR,31,76,11,35,46
17,8478891,Mason Appleton,C,WPG,28,70,22,23,45
17,8482159,Tyson Foerster,R,PHI,22,73,19,26,45
17,8474641,Adam Henrique,C,EDM,34,78,19,26,45
17,8477497,Sean Monahan,C,CBJ,30,65,19,26,45
17,8478397,Rasmus Andersson,D,CGY,28,71,10,35,45
17,8480817,K'Andre Miller,D,NYR,24,72,10,35,45
17,8475722,Jason Zucker,L,BUF,32,67,23,21,44
17,8482093,Seth Jarvis,C,CAR,22,68,22,22,44
17,8478493,Joel Eriksson Ek,C,MIN,27,66,19,25,44
17,8474586,Jordan Eberle,R,SEA,34,72,15,29,44
17,8484153,Leo Carlsson,C,ANA,20,67,14,30,44
17,8470613,Brent Burns,D,CAR,39,74,14,30,44
17,8475753,Justin Faulk,D,STL,32,74,11,33,44
17,8475799,Nino Niederreiter,R,WPG,32,66,25,18,43
17,8478115,Pierre Engvall,L,NYI,28,77,25,18,43
17,8482702,Logan Stankoven,C,DAL,21,80,23,20,43
17,8484166,Adam Fantilli,C,CBJ,20,69,20,23,43
17,8476880,Tom Wilson,R,WSH,30,72,19,24,43
17,8475169,Evander Kane,L,EDM,33,72,18,25,43
17,8480798,Philipp Kurashev,C,CHI,25,58,18,25,43
17,8477444,Andre Burakovsky,L,SEA,29,77,16,27,43
17,8478396,Noah Hanifin,D,VGK,27,58,13,30,43
17,8477346,MacKenzie Weegar,D,CGY,30,73,10,33,43
17,8475764,Cam Fowler,D,ANA,33,65,6,37,43
17,8481606,Jordan Spence,D,LAK,23,70,6,37,43
17,8480849,Barrett Hayton,C,UTA,24,75,21,21,42
17,8478444,Brock Boeser,R,VAN,27,70,19,23,42
17,8475714,Calle Jarnkrok,C,TOR,33,76,15,27,42
17,8481624,Ilya Mikheyev,R,CHI,30,57,13,29,42
17,8476885,Jacob Trouba,D,NYR,30,66,10,32,42
17,8478407,Vince Dunn,D,SEA,28,71,7,35,42
17,8476399,Blake Coleman,C,CGY,33,78,25,16,41
17,8477511,Anthony Mantha,R,CGY,30,73,20,21,41
17,8482175,JJ Peterka,R,BUF,22,72,19,22,41
17,8478498,Jake DeBrusk,L,VAN,28,74,18,23,41
17,8475151,Kyle Palmieri,C,NYI,33,74,18,23,41
17,8482110,Dawson Mercer,C,NJD,23,71,17,24,41
17,8476461,Sean Couturier,C,PHI,32,72,15,26,41
17,8475191,Reilly Smith,R,NYR,33,73,15,26,41
17,8481577,Philip Tomasino,C,NSH,23,62,14,27,41
17,8479351,Sam Steel,C,DAL,26,78,13,28,41
17,8482624,Daniil Miromanov,D,CGY,27,68,9,32,41
17,8481604,Pavel Dorofeyev,L,VGK,24,67,19,21,40
17,8478474,Lawson Crouse,L,UTA,27,76,19,21,40
17,8474149,Evgenii Dadonov,R,DAL,35,81,16,24,40
17,8476419,Jean-Gabriel Pageau,C,NYI,32,78,15,25,40
17,8481596,Shane Pinto,C,OTT,24,77,14,26,40
17,8476826,Yanni Gourde,C,SEA,33,71,13,27,40
17,8476872,Scott Laughton,C,PHI,30,72,11,29,40
17,8479345,Jakob Chychrun,D,WSH,26,68,9,31,40
17,8482667,William Eklund,L,SJS,22,65,22,17,39
17,8481560,Arthur Kaliyev,R,LAK,23,78,20,19,39
17,8482097,Jack Quinn,R,BUF,23,66,20,19,39
17,8479365,Trent Frederic,C,BOS,26,78,19,20,39
17,8480009,Eeli Tolvanen,R,SEA,25,75,18,21,39
17,8477964,Ivan Barbashev,C,VGK,29,74,16,23,39
17,8475768,Jaden Schwartz,C,SEA,32,72,16,23,39
17,8475218,Mattias Ekholm,D,EDM,34,74,13,26,39
17,8477447,Shea Theodore,D,VGK,29,59,8,31,39
17,8476438,Brandon Saad,L,STL,32,74,27,11,38
17,8475149,Marcus Johansson,L,MIN,34,64,17,21,38
17,8480113,Alex Iafallo,L,WPG,31,58,17,21,38
17,8480871,Adam Boqvist,D,FLA,24,55,15,23,38
17,8474053,Logan Couture,C,SJS,35,56,9,29,38
17,8476923,Damon Severson,D,CBJ,30,78,8,30,38
17,8471698,T.J. Oshie,R,WSH,38,69,23,14,37
17,8479992,Michael Rasmussen,C,DET,25,72,20,17,37
17,8476483,Rickard Rakell,R,PIT,31,68,19,18,37
17,8477429,Andrew Copp,C,DET,30,80,16,21,37
17,8477948,Travis Sanheim,D,PHI,28,68,12,25,37
17,8476869,Brady Skjei,D,NSH,30,70,11,26,37
17,8479591,Michael Eyssimont,C,TBL,28,82,11,26,37
17,8476958,Jaccob Slavin,D,CAR,30,81,8,29,37
17,8479425,Filip Hronek,D,VAN,27,78,6,31,37
17,8480829,Jesperi Kotkaniemi,C,CAR,24,67,17,19,36
17,8480855,Jack McBain,C,UTA,24,63,16,20,36
17,8482705,Cole Sillinger,C,CBJ,21,73,16,20,36
17,8478463,Anthony Beauvillier,L,PIT,27,64,15,21,36
17,8475793,Ryan Johansen,C,PHI,32,70,15,21,36
17,8481618,Alex Newhook,C,MTL,23,71,11,25,36
17,8477953,Kasperi Kapanen,R,STL,28,64,11,25,36
17,8478458,John (Jack) Roslovic,C,CAR,27,62,9,27,36
17,8480434,Sean Durzi,D,UTA,26,69,9,27,36
17,8478469,Thomas Chabot,D,OTT,27,76,8,28,36
17,8475171,Oliver Ekman-Larsson,D,TOR,33,69,4,32,36
17,8477506,Ryan Pulock,D,NYI,30,75,2,34,36
17,8482089,Jake Neighbours,L,STL,22,67,26,9,35
17,8479525,Ross Colton,C,COL,28,81,22,13,35
17,8481535,Nils Hoglander,L,VAN,24,68,20,15,35
17,8475287,Erik Haula,L,NJD,33,70,19,16,35
17,8480064,Josh Norris,C,OTT,25,73,18,17,35
17,8480813,Joe Veleno,C,DET,24,77,17,18,35
17,8481553,Bobby Brink,R,PHI,23,65,16,19,35
17,8476474,Stefan Noesen,R,NJD,31,63,13,22,35
17,8475763,Kevin Hayes,R,PIT,32,64,11,24,35
17,8481546,Cam York,D,PHI,23,67,8,27,35
17,8477969,Marcus Pettersson,D,PIT,28,81,7,28,35
17,8476854,Hampus Lindholm,D,BOS,30,74,6,29,35
17,8477456,J.T. Compher,L,DET,29,79,14,20,34
17,8482146,Luke Evangelista,R,NSH,22,66,13,21,34
17,8475760,Nick Bjugstad,C,UTA,32,69,13,21,34
17,8480185,Eetu Luostarinen,C,FLA,26,74,13,21,34
17,8480078,Filip Chytil,C,NYR,25,66,12,22,34
17,8480878,Nils Lundkvist,D,DAL,24,69,5,29,34
17,8482671,Owen Power,D,BUF,22,68,5,29,34
17,8476979,Erik Gustafsson,D,DET,32,70,3,31,34
17,8477451,Ryan Hartman,R,MIN,30,69,18,15,33
17,8480205,Emil Bemstrom,C,PIT,25,66,18,15,33
17,8476462,Dougie Hamilton,D,NJD,31,69,13,20,33
17,8476292,Ondrej Palat,L,NJD,33,72,9,24,33
17,8483505,Matthew Poitras,C,BOS,20,76,9,24,33
17,8479398,Samuel Girard,D,COL,26,71,5,28,33
17,8480145,Neal Pionk,D,WPG,29,74,5,28,33
17,8480049,Dylan Samberg,D,WPG,25,69,3,30,33
17,8480873,Rasmus Sandin,D,WSH,24,65,2,31,33
17,8480459,Pius Suter,C,VAN,28,67,18,14,32
17,8475231,Casey Cizikas,C,NYI,33,74,15,17,32
17,8481704,Juuso Parssinen,C,NSH,23,59,13,19,32
17,8480802,Ryan McLeod,C,BUF,25,66,12,20,32
17,8482660,Kent Johnson,C,CBJ,22,64,12,20,32
17,8482475,Yegor Chinakhov,R,CBJ,23,69,11,21,32
17,8477952,Robby Fabbri,C,ANA,28,65,10,22,32
17,8482712,Oskar Olausson,R,COL,22,75,9,23,32
17,8478109,Victor Olofsson,L,VGK,29,69,8,24,32
17,8474565,Alex Pietrangelo,D,VGK,34,60,7,25,32
17,8478413,Jordan Greenway,L,BUF,27,70,7,25,32
17,8479315,Joey Anderson,R,CHI,26,56,7,25,32
17,8480748,Kiefer Sherwood,L,VAN,29,62,18,13,31
17,8477998,Warren Foegele,L,LAK,28,78,15,16,31
17,8479316,Luke Kunin,C,SJS,27,60,15,16,31
17,8478233,Andrew Mangiapane,L,WSH,28,75,14,17,31
17,8478438,Tommy Novak,C,NSH,27,72,11,20,31
17,8476458,Ryan Strome,C,ANA,31,65,11,20,31
17,8484203,Bradly Nadeau,L,CAR,19,55,11,20,31
17,8477488,Brett Pesce,D,NJD,30,74,9,22,31
17,8474716,Jared Spurgeon,D,MIN,35,79,8,23,31
17,8477498,Darnell Nurse,D,EDM,29,78,6,25,31
17,8476917,Adam Pelech,D,NYI,30,77,5,26,31
17,8474715,Cameron Atkinson,R,TBL,35,81,20,10,30
17,8481093,Rafael Harvey-Pinard,L,MTL,25,64,16,14,30
17,8478057,Dakota Joshua,C,VAN,28,65,15,15,30
17,8483524,Shane Wright,C,SEA,20,59,13,17,30
17,8480068,Ryan Poehling,C,PHI,25,74,11,19,30
17,8481523,Kirby Dach,C,MTL,23,60,11,19,30
17,8473422,Nick Foligno,L,CHI,37,55,10,20,30
17,8480336,Sean Walker,D,CAR,30,74,6,24,30
17,8476902,Esa Lindell,D,DAL,30,75,5,25,30
17,8482655,Janis Moser,D,TBL,24,76,3,27,30
17,8478569,Noel Acciari,C,PIT,33,57,14,15,29
17,8483445,Cutter Gauthier,L,ANA,20,59,11,18,29
17,8478046,Danton Heinen,L,VAN,29,63,10,19,29
17,8480220,Noah Cates,L,PHI,25,67,10,19,29
17,8478133,Jake Evans,C,MTL,28,64,9,20,29
17,8477989,Christian Dvorak,C,MTL,28,64,9,20,29
17,8482105,Jake Sanderson,D,OTT,22,71,9,20,29
17,8476480,Vladislav Namestnikov,C,WPG,32,66,8,21,29
17,8476429,Scott Mayfield,D,NYI,32,80,7,22,29
17,8476981,Josh Anderson,R,MTL,30,68,17,11,28
17,8481582,Nicholas Robertson,L,TOR,23,60,16,12,28
17,8479390,Taylor Raddysh,R,WSH,26,61,14,14,28
17,8478020,Michael Amadio,R,OTT,28,74,11,17,28
17,8475200,Dmitry Orlov,D,CAR,33,71,10,18,28
17,8481522,Peyton Krebs,C,BUF,23,62,10,18,28
17,8476931,Jake McCabe,D,TOR,31,63,8,20,28
17,8481014,Alexander Romanov,D,NYI,24,80,6,22,28
17,8482142,Jamie Drysdale,D,PHI,22,65,4,24,28
17,8478136,Jake Middleton,D,MIN,28,75,3,25,28
17,8479661,Tanner Jeannot,L,LAK,27,78,17,10,27
17,8481554,Kaapo Kakko,R,NYR,23,73,15,12,27
17,8480995,Pontus Holmberg,R,TOR,25,57,15,12,27
17,8480835,Jack Drury,C,CAR,24,60,12,15,27
17,8481617,Vasily Podkolzin,R,VAN,23,60,12,15,27
17,8481656,Aliaksei Protas,C,WSH,23,67,11,16,27
17,8483493,Frank Nazar,C,CHI,20,63,11,16,27
17,8477839,Conor Sheary,L,TBL,32,80,10,17,27
17,8481441,Joe Snively,C,DET,28,69,10,17,27
17,8477220,Nate Schmidt,D,FLA,33,72,7,20,27
17,8473563,Nicklas Backstrom,C,WSH,37,58,7,20,27
17,8479402,Jake Bean,D,CGY,26,62,6,21,27
17,8476892,Colton Parayko,D,STL,31,70,4,23,27
17,8480893,Kirill Marchenko,R,CBJ,24,60,16,10,26
17,8479619,Michael Carcone,L,UTA,28,64,16,10,26
17,8477478,William Carrier,L,CAR,30,62,15,11,26
17,8479414,Nathan Bastian,R,NJD,27,68,14,12,26
17,8476897,Oskar Sundqvist,C,STL,30,62,11,15,26
17,8476392,Adam Lowry,C,WPG,31,59,11,15,26
17,8482749,Joshua Roy,R,MTL,21,63,11,15,26
17,8479393,Noah Gregor,L,OTT,26,78,8,18,26
17,8477499,Rasmus Ristolainen,D,PHI,30,60,7,19,26
17,8481703,Valtteri Puustinen,R,PIT,25,60,4,22,26
17,8482122,Brock Faber,D,MIN,22,78,4,22,26
17,8476927,Teddy Blueger,C,VAN,30,59,3,23,26
17,8473507,Jeff Petry,D,DET,37,73,3,23,26
17,8476331,Dylan DeMelo,D,WPG,31,67,3,23,26
17,8474151,Ryan McDonagh,D,TBL,35,75,1,25,26
17,8475848,Brendan Gallagher,R,MTL,32,73,14,11,25
17,8476278,Colin Blackwell,C,DAL,31,75,14,11,25
17,8481186,Logan O'Connor,R,COL,28,78,12,13,25
17,8474189,Lars Eller,C,PIT,35,67,12,13,25
17,8477425,Miles Wood,L,COL,29,76,11,14,25
17,8477919,Frederick Gaudreau,C,MIN,31,69,9,16,25
17,8473533,Jordan Staal,C,CAR,36,63,9,16,25
17,8481542,Moritz Seider,D,DET,23,78,8,17,25
17,8476925,Colton Sissons,C,NSH,31,70,8,17,25
17,8482067,Connor Mackey,D,NYR,28,60,7,18,25
17,8480727,Zach Whitecloud,D,VGK,28,56,6,19,25
17,8478882,Vladislav Gavrikov,D,LAK,29,75,6,19,25
17,8475233,David Savard,D,MTL,34,67,4,21,25
17,8482451,Mikael Pyyhtia,L,CBJ,23,47,3,22,25
17,8480073,Erik Brannstrom,D,COL,25,65,2,23,25
17,8470621,Corey Perry,R,EDM,39,72,15,9,24
17,8482125,Alexander Holtz,R,VGK,22,74,15,9,24
17,8481580,Connor McMichael,C,WSH,23,62,15,9,24
17,8477903,Garnet Hathaway,R,PHI,33,68,12,12,24
17,8480806,Isac Lundestrom,C,ANA,25,62,12,12,24
17,8480003,Jesper Boqvist,C,FLA,26,63,10,14,24
17,8482133,Thomas Bordeleau,C,SJS,22,61,8,16,24
17,8483490,Pavel Mintyukov,D,ANA,21,73,7,17,24
17,8475324,Nick Jensen,D,OTT,34,67,6,18,24
17,8476463,Jonas Brodin,D,MIN,31,79,5,19,24
17,8480246,Nick Perbix,D,TBL,26,71,4,20,24
17,8480043,Timothy Liljegren,D,TOR,25,66,2,22,24
17,8481481,Blake Lizotte,C,PIT,27,54,14,9,23
17,8476918,Jimmy Vesey,L,NYR,31,64,13,10,23
17,8482055,Drew O'Connor,L,PIT,26,63,12,11,23
17,8476921,Jordan Martinook,L,CAR,32,61,12,11,23
17,8477505,Alexander Wennberg,C,SJS,30,61,11,12,23
17,8479996,Cody Glass,C,NSH,25,61,11,12,23
17,8483565,Nick Blankenburg,D,NSH,26,60,11,12,23
17,8483468,Jiri Kulich,C,BUF,20,56,11,12,23
17,8476878,Zemgus Girgensons,C,TBL,30,79,11,12,23
17,8478472,Mathieu Joseph,R,STL,27,65,6,17,23
17,8478507,John Marino,D,UTA,27,62,4,19,23
17,8475790,Erik Gudbranson,D,CBJ,32,75,4,19,23
17,8480860,Kevin Bahl,D,CGY,24,61,4,19,23
17,8483457,Lane Hutson,D,MTL,20,69,13,9,22
17,8482117,Lukas Reichel,L,CHI,22,61,13,9,22
17,8482101,Danil Gushchin,L,SJS,22,57,11,11,22
17,8475343,Nic Dowd,C,WSH,34,60,10,12,22
17,8477353,Tyler Motte,C,DET,29,72,9,13,22
17,8475220,Marcus Foligno,L,MIN,33,55,9,13,22
17,8477406,Mattias Janmark,C,EDM,32,63,8,14,22
17,8476856,Mathew Dumba,D,DAL,30,73,7,15,22
17,8476457,Adam Larsson,D,SEA,32,68,5,17,22
17,8478013,Jake Walman,D,SJS,28,68,5,17,22
17,8477507,Nikita Zadorov,D,BOS,29,67,5,17,22
17,8481527,Kaedan Korczak,D,VGK,23,51,4,18,22
17,8482259,Bobby McMann,C,TOR,28,65,13,8,21
17,8477450,Jason Dickinson,C,CHI,29,58,13,8,21
17,8479293,Brandon Tanev,L,SEA,33,61,12,9,21
17,8482679,Matt Coronato,R,CGY,22,67,11,10,21
17,8477987,Ryan Donato,C,CHI,28,63,9,12,21
17,8477508,Curtis Lazar,C,NJD,29,69,9,12,21
17,8479066,Ryan Lomberg,L,CGY,30,63,9,12,21
17,8482111,Justin Barron,D,MTL,23,62,8,13,21
17,8480172,Jan Rutta,D,SJS,34,68,8,13,21
17,8481028,Martin Pospisil,C,CGY,25,59,8,13,21
17,8476988,Matt Benning,D,SJS,30,64,7,14,21
17,8478211,Dryden Hunt,L,CGY,29,60,7,14,21
17,8476994,Vinnie Hinostroza,C,NSH,30,52,7,14,21
17,8475791,Taylor Hall,L,CHI,33,51,11,9,20
17,8476960,Andreas Athanasiou,C,CHI,30,50,11,9,20
17,8477931,Tomas Nosek,L,FLA,32,59,11,9,20
17,8479353,Brett Howden,C,VGK,26,71,10,10,20
17,8479368,Max Jones,L,BOS,26,65,9,11,20
17,8482803,Olen Zellweger,D,ANA,21,73,9,11,20
17,8476469,Joel Armia,R,MTL,31,69,8,12,20
17,8480789,Oliver Wahlstrom,R,NYI,24,69,8,12,20
17,8479026,Philippe Myers,D,TOR,27,50,7,13,20
17,8477979,Nicolas Aube-Kubel,R,BUF,28,60,7,13,20
17,8480035,Henri Jokiharju,D,BUF,25,60,4,16,20
17,8481601,Simon Holmstrom,R,NYI,23,67,11,8,19
17,8482737,Zack Bolduc,C,STL,21,61,10,9,19
17,8478432,Christian Fischer,R,DET,27,77,10,9,19
17,8475193,Tomas Tatar,L,NJD,34,62,10,9,19
17,8473453,Trevor Lewis,C,LAK,37,73,10,9,19
17,8481517,Brett Leason,R,ANA,25,54,9,10,19
17,8482074,Connor Zary,C,CGY,23,63,9,10,19
17,8482807,Ethan Del Mastro,D,CHI,21,53,9,10,19
17,8482176,Wyatt Kaiser,D,CHI,22,48,8,11,19
17,8482809,Jackson Blake,R,CAR,21,52,7,12,19
17,8480144,David Kampf,C,TOR,29,65,7,12,19
17,8476467,Jamie Oleksiak,D,SEA,32,67,5,14,19
17,8475462,Radko Gudas,D,ANA,34,64,5,14,19
17,8477369,Carson Soucy,D,VAN,30,64,5,14,19
17,8482087,Kaiden Guhle,D,MTL,22,65,5,14,19
17,8478970,Jalen Chatfield,D,CAR,28,70,4,15,19
17,8479324,Ryan Lindgren,D,NYR,26,67,4,15,19
17,8478399,Jonas Siegenthaler,D,NJD,27,58,1,18,19
17,8479941,Justin Danforth,R,CBJ,31,56,14,4,18
17,8482157,Will Cuylle,L,NYR,22,61,13,5,18
17,8480448,Parker Kelly,L,COL,25,77,12,6,18
17,8482079,Marco Rossi,C,MIN,23,58,10,8,18
17,8483491,Ivan Miroshnichenko,L,WSH,20,52,9,9,18
17,8482666,Scott Morrow,D,CAR,22,46,6,12,18
17,8477446,Michael McCarron,R,NSH,29,58,5,13,18
17,8478911,Matt Roy,D,WSH,29,60,3,15,18
17,8476525,Colin Miller,D,WPG,32,63,3,15,18
17,8481537,Nikita Okhotiuk,D,CGY,24,59,3,15,18
17,8482245,Artem Zub,D,OTT,29,72,1,17,18
17,8478500,Ivan Provorov,D,CBJ,27,80,0,18,18
17,8478043,Sam Lafferty,C,BUF,29,50,13,4,17
17,8478831,Kevin Stenlund,C,UTA,28,59,12,5,17
17,8479336,Carl Grundstrom,R,SJS,27,55,11,6,17
17,8481477,Nico Sturm,C,SJS,29,54,9,8,17
17,8482148,Hendrix Lapierre,C,WSH,22,49,9,8,17
17,8475855,Jesper Fast,R,CAR,33,58,8,9,17
17,8477015,Connor Brown,R,EDM,30,59,8,9,17
17,8477392,Hudson Fasching,R,NYI,29,66,8,9,17
17,8480980,Connor Dewar,C,TOR,25,73,6,11,17
17,8479976,Juuso Valimaki,D,UTA,26,66,5,12,17
17,8479359,Beck Malenstyn,L,BUF,26,41,5,12,17
17,8481751,Lukas Rousek,R,BUF,25,44,5,12,17
17,8477435,Ryan Graves,D,PIT,29,74,4,13,17
17,8479372,Joshua Mahura,D,SEA,26,52,4,13,17
17,8483482,Tristan Luneau,D,ANA,20,65,3,14,17
17,8474673,TJ Brodie,D,CHI,34,60,3,14,17
17,8479983,Mario Ferraro,D,SJS,26,70,2,15,17
17,8476891,Matthew Grzelcyk,D,PIT,30,75,2,15,17
17,8479986,Kole Lind,R,DAL,26,45,1,16,17
17,8482155,Alex Laferriere,R,LAK,23,58,8,8,16
17,8476329,Travis Boyd,C,MIN,31,52,7,9,16
17,8479718,Alex Barré-Boulet,C,MTL,27,49,7,9,16
17,8480074,Alexandre Texier,C,STL,25,59,7,9,16
17,8481032,Paul Cotter,C,NJD,25,52,7,9,16
17,8481521,Ronnie Attard,D,PHI,25,55,6,10,16
17,8480289,Morgan Barron,C,WPG,26,52,6,10,16
17,8479370,Tyson Jost,C,CAR,26,61,6,10,16
17,8479982,Conor Timmins,D,TOR,26,49,5,11,16
17,8476967,Brett Kulak,D,EDM,30,58,4,12,16
17,8478178,Darren Raddysh,D,TBL,28,70,3,13,16
17,8480950,Ilya Lyubushkin,D,DAL,30,66,3,13,16
17,8482192,Isaak Phillips,D,CHI,23,60,3,13,16
17,8481019,David Gustafsson,C,WPG,24,46,3,13,16
17,8477018,Ben Hutton,D,VGK,31,52,3,13,16
17,8481178,Egor Zamula,D,PHI,24,60,2,14,16
17,8480891,Michael Kesselring,D,UTA,24,58,2,14,16
17,8475179,Dmitry Kulikov,D,FLA,34,58,2,14,16
17,8478851,Alexandre Carrier,D,NSH,28,69,1,15,16
17,8482073,Braden Schneider,D,NYR,23,68,0,16,16
17,8478508,Yakov Trenin,C,MIN,27,63,10,5,15
17,8477573,Nathan Walker,L,STL,30,54,9,6,15
17,8476934,Brock McGinn,L,ANA,30,52,8,7,15
17,8478434,Keegan Kolesar,R,VGK,27,64,7,8,15
17,8479639,Dylan Coghlan,D,WPG,26,66,7,8,15
17,8479344,Jesse Puljujarvi,R,PIT,26,46,6,9,15
17,8476952,Dominic Toninato,C,WPG,30,42,4,11,15
17,8478452,Caleb Jones,D,LAK,27,62,2,13,15
17,8478451,Ethan Bear,D,WSH,27,52,2,13,15
17,8481059,Scott Perunovich,D,STL,26,60,2,13,15
17,8481567,Henry Thrun,D,SJS,23,49,2,13,15
17,8479442,Troy Stecher,D,EDM,30,51,0,15,15
17,8475208,Brian Dumoulin,D,ANA,33,56,0,15,15
17,8480025,MacKenzie Entwistle,R,FLA,25,60,9,5,14
17,8475842,Sam Carrick,C,NYR,32,56,9,5,14
17,8480011,Klim Kostin,C,SJS,25,52,8,6,14
17,8479520,Brandon Duhaime,R,WSH,27,59,7,7,14
17,8480021,Jack Studnicka,C,LAK,25,61,6,8,14
17,8479543,Michael Pezzetta,L,MTL,26,58,6,8,14
17,8480848,Ty Dellandrea,C,SJS,24,42,6,8,14
17,8482062,Cole Smith,L,NSH,29,52,5,9,14
17,8480001,Urho Vaakanainen,D,ANA,25,63,5,9,14
17,8478585,Derek Ryan,C,EDM,38,64,5,9,14
17,8477851,Jordan Oesterle,D,BOS,32,39,5,9,14
17,8481701,Santeri Hatakka,D,NJD,23,44,4,10,14
17,8480807,Mattias Samuelsson,D,BUF,24,47,3,11,14
17,8475750,Jon Merrill,D,MIN,32,66,3,11,14
17,8482859,Zack Ostapchuk,C,OTT,21,56,3,11,14
17,8471709,Marc-Edouard Vlasic,D,SJS,37,60,3,11,14
17,8476874,Olli Maatta,D,DET,30,59,3,11,14
17,8474574,Tyler Myers,D,VAN,34,59,2,12,14
17,8475690,Chris Tanev,D,TOR,35,63,2,12,14
17,8479371,Dante Fabbro,D,NSH,26,59,2,12,14
17,8474166,Alec Martinez,D,CHI,37,56,2,12,14
17,8479369,Andrew Peeke,D,BOS,26,61,1,13,14
17,8482762,Simon Edvinsson,D,DET,21,57,9,4,13
17,8479536,Axel Jonsson-Fjallby,L,WPG,26,44,7,6,13
17,8480762,Eric Robinson,L,CAR,29,54,6,7,13
17,8478421,A.J. Greer,L,FLA,28,58,6,7,13
17,8480222,Sebastian Aho,D,PIT,28,71,5,8,13
17,8480157,Calle Rosen,D,COL,30,44,5,8,13
17,8476422,Mike Reilly,D,NYI,31,76,4,9,13
17,8481568,Alex Vlasic,D,CHI,23,47,3,10,13
17,8480070,Ian Mitchell,D,BOS,25,47,3,10,13
17,8484149,Gavin Brindley,C,CBJ,20,48,3,10,13
17,8477482,Zachary Sanford,L,CHI,30,39,3,10,13
17,8476312,Josh Manson,D,COL,33,54,2,11,13
17,8475279,Ben Chiarot,D,DET,33,62,2,11,13
17,8476879,Cody Ceci,D,EDM,31,67,1,12,13
17,8475181,Nick Leddy,D,STL,33,69,1,12,13
17,8477365,Connor Clifton,D,BUF,29,64,1,12,13
17,8478416,Erik Cernak,D,TBL,27,73,0,13,13
17,8480281,Alexey Toropchenko,R,STL,25,61,9,3,12
17,8474034,Patrick Maroon,L,CHI,36,53,8,4,12
17,8481161,Jake Christiansen,D,CBJ,25,62,8,4,12
17,8483495,Simon Nemec,D,NJD,20,48,6,6,12
17,8480355,Mark Kastelic,C,BOS,25,60,6,6,12
17,8476822,Luke Glendening,C,TBL,35,80,6,6,12
17,8482166,Shakir Mukhamadullin,D,SJS,22,56,6,6,12
17,8477887,Patrick Brown,C,BOS,32,50,5,7,12
17,8477947,Sonny Milano,L,WSH,28,55,4,8,12
17,8478468,Jeremy Lauzon,D,NSH,27,60,4,8,12
17,8476624,Barclay Goodrow,C,SJS,31,45,4,8,12
17,8481013,Jonatan Berggren,R,DET,24,58,4,8,12
17,8477380,Jonny Brodzinski,C,NYR,31,55,3,9,12
17,8481708,Zac Jones,D,NYR,24,47,2,10,12
17,8482634,Alex Steeves,C,TOR,25,52,2,10,12
17,8478454,Noah Juulsen,D,VAN,27,35,2,10,12
17,8482511,Mason Lohrei,D,BOS,23,31,1,11,12
17,8480796,Martin Fehervary,D,WSH,25,50,0,12,12
17,8479980,Nicolas Hague,D,VGK,26,49,0,12,12
17,8481716,Dmitri Voronkov,L,CBJ,24,46,7,4,11
17,8479291,Kevin Rooney,C,CGY,31,46,7,4,11
17,8482784,Zach Dean,C,STL,21,38,7,4,11
17,8476858,Phillip Di Giuseppe,L,VAN,31,41,6,5,11
17,8483499,Liam Ohgren,L,MIN,20,57,5,6,11
17,8478017,Mark Friedman,D,VAN,29,35,5,6,11
17,8482730,Brandt Clarke,D,LAK,21,54,5,6,11
17,8479439,Jacob MacDonald,D,COL,31,48,4,7,11
17,8484911,Collin Graf,R,SJS,22,44,4,7,11
17,8479348,Kale Clague,D,BUF,26,37,4,7,11
17,8478874,Adam Gaudette,R,OTT,28,33,4,7,11
17,8479998,Mikey Anderson,D,LAK,25,55,3,8,11
17,8475188,Brayden McNabb,D,VGK,33,57,2,9,11
17,8476442,Matt Nieto,L,PIT,32,49,2,9,11
17,8475455,Brenden Dillon,D,NJD,34,64,2,9,11
17,8481641,Joel Kiviranta,L,COL,28,72,1,10,11
17,8474090,Brendan Smith,D,DAL,35,52,1,10,11
17,8476873,Mark Jankowski,C,NSH,30,49,6,4,10
17,8482095,Tyler Kleven,D,OTT,22,44,6,4,10
17,8475225,Craig Smith,C,CHI,35,53,5,5,10
17,8482747,Brennan Othmann,L,NYR,21,41,4,6,10
17,8480441,Trey Fix-Wolansky,R,CBJ,25,35,4,6,10
17,8479671,Mathieu Olivier,R,CBJ,27,51,4,6,10
17,8480252,Cole Guttman,C,CHI,25,36,3,7,10
17,8478443,Brandon Carlo,D,BOS,28,57,2,8,10
17,8482964,Arber Xhekaj,D,MTL,23,42,2,8,10
17,8477962,Brendan Lemieux,L,CAR,28,43,2,8,10
17,8476473,Connor Murphy,D,CHI,31,41,2,8,10
17,8476913,Devin Shore,C,MIN,30,37,2,8,10
17,8483619,Filip Roos,D,OTT,25,37,2,8,10
17,8475718,Justin Holl,D,DET,32,61,1,9,10
17,8481167,Brayden Pachal,D,CGY,25,39,1,9,10
17,8481599,Victor Soderstrom,D,UTA,23,47,1,9,10
17,8479328,Julien Gauthier,R,NYI,27,58,7,2,9
17,8479981,Jonah Gadjovich,L,FLA,26,38,7,2,9
17,8477070,Liam O'Brien,C,UTA,30,53,5,4,9
17,8480844,Grigori Denisenko,L,VGK,24,34,5,4,9
17,8479379,Givani Smith,R,SJS,26,39,5,4,9
17,8477527,Ross Johnston,L,ANA,30,40,5,4,9
17,8476374,Sean Kuraly,C,CBJ,31,50,4,5,9
17,8471677,Jack Johnson,D,CBJ,37,58,4,5,9
17,8481600,Tobias Bjornfot,D,FLA,23,48,4,5,9
17,8482652,Walker Duehr,R,CGY,27,38,4,5,9
17,8479378,Logan Stanley,D,WPG,26,41,3,6,9
17,8474013,Ian Cole,D,UTA,35,49,3,6,9
17,8480880,Jakub Lauko,C,MIN,24,31,3,6,9
17,8483549,Lucas Condotta,L,MTL,27,37,2,7,9
17,8481592,Jakob Pelletier,L,CGY,23,41,2,7,9
17,8483466,Kevin Korchinski,D,CHI,20,45,2,7,9
17,8480058,Pierre-Olivier Joseph,D,STL,25,53,2,7,9
17,8478840,Will Borgen,D,SEA,28,67,1,8,9
17,8483630,Pavol Regenda,L,ANA,25,36,1,8,9
17,8477034,Jaycob Megna,D,FLA,32,48,0,9,9
17,8481518,Nolan Foote,L,NJD,24,32,7,1,8
17,8479968,Vinni Lettieri,C,BOS,29,47,6,2,8
17,8482077,Dylan Holloway,L,EDM,23,54,5,3,8
17,8477401,John Hayden,C,SEA,29,35,5,3,8
17,8478424,Jansen Harkins,C,ANA,27,40,5,3,8
17,8482765,Isak Rosen,R,BUF,21,23,4,4,8
17,8476441,Joel Edmundson,D,LAK,31,30,4,4,8
17,8477845,Trevor van Riemsdyk,D,WSH,33,58,3,5,8
17,8480292,Carson Meyer,R,ANA,27,33,3,5,8
17,8482153,Brendan Brisson,C,VGK,23,34,3,5,8
17,8481550,Adam Beckman,L,NJD,23,39,3,5,8
17,8474612,Travis Hamonic,D,OTT,34,44,3,5,8
17,8479991,Jake Leschyshyn,C,NYR,25,28,3,5,8
17,8483570,Ben Meyers,C,SEA,26,34,3,5,8
17,8477938,Haydn Fleury,D,WPG,28,41,2,6,8
17,8474568,Luke Schenn,D,NSH,35,53,2,6,8
17,8473446,Erik Johnson,D,PHI,36,45,2,6,8
17,8475177,Calvin de Haan,D,COL,33,46,2,6,8
17,8480196,Jacob Bryson,D,BUF,27,40,2,6,8
17,8483460,David Jiricek,D,CBJ,21,59,1,7,8
17,8478859,Niko Mikkola,D,FLA,28,59,1,7,8
17,8477384,Joshua Brown,D,EDM,30,46,1,7,8
17,8480887,Jordan Harris,D,MTL,24,55,1,7,8
17,8479249,Andrew Poturalski,C,SJS,30,28,0,8,8
17,8482861,Vincent Iorio,D,WSH,22,31,0,8,8
17,8482659,Josh Doan,R,UTA,22,45,6,1,7
17,8481789,Tye Kartye,L,SEA,23,40,6,1,7
17,8483012,Logan Morrison,C,SEA,22,34,5,2,7
17,8483763,Maksymilian Szuber,D,UTA,22,34,4,3,7
17,8471817,Ryan Reaves,R,TOR,37,54,3,4,7
17,8479772,Zack MacEwen,R,OTT,28,50,3,4,7
17,8478146,Matthew Highmore,C,OTT,28,38,3,4,7
17,8480845,Rasmus Kupari,C,WPG,24,42,2,5,7
17,8474567,Zach Bogosian,D,MIN,34,68,2,5,7
17,8481532,Alex Turcotte,C,LAK,23,44,2,5,7
17,8479944,Zach Aston-Reese,C,VGK,30,41,2,5,7
17,8482929,Emil Lilleberg,D,TBL,23,25,2,5,7
17,8481598,Philip Broberg,D,EDM,23,40,1,6,7
17,8481556,John Beecher,C,BOS,23,29,4,2,6
17,8482141,Lukas Cormier,D,VGK,22,27,4,2,6
17,8480890,Jan Jenik,C,OTT,24,21,4,2,6
17,8476889,Radek Faksa,C,STL,30,55,3,3,6
17,8479994,Jaret Anderson-Dolan,C,WPG,25,36,3,3,6
17,8481609,Vladislav Kolyachonok,D,UTA,23,34,3,3,6
17,8482496,Nils Aman,C,VAN,24,35,3,3,6
17,8475958,Michael Sgarbossa,C,WSH,32,28,3,3,6
17,8480192,Johnathan Kovacevic,D,NJD,27,52,3,3,6
17,8482144,Jack Thompson,D,SJS,22,27,3,3,6
17,8475762,Derek Forbort,D,VAN,32,42,2,4,6
17,8484254,Akito Hirose,D,VAN,25,35,2,4,6
17,8479972,Mason Shaw,C,WPG,26,32,2,4,6
17,8477335,Kyle Burroughs,D,LAK,29,42,2,4,6
17,8481679,Maxence Guenette,D,OTT,23,30,2,4,6
17,8478021,William Lagesson,D,DET,28,32,2,4,6
17,8482145,Mavrik Bourque,C,DAL,22,54,2,4,6
17,8482250,Callahan Burke,C,VGK,27,22,2,4,6
17,8482172,Landon Slaggert,L,CHI,22,23,2,4,6
17,8480245,Olle Lycksell,R,PHI,25,29,1,5,6
17,8470600,Ryan Suter,D,STL,39,60,1,5,6
17,8480879,Jacob Bernard-Docker,D,OTT,24,49,1,5,6
17,8477244,Chad Ruhwedel,D,NYR,34,33,1,5,6
17,8478450,Parker Wotherspoon,D,BOS,27,39,0,6,6
17,8481237,Kyle MacLean,C,NYI,25,27,5,0,5
17,8482744,James Malatesta,L,CBJ,21,39,3,2,5
17,8481754,Nikita Nesterenko,C,ANA,23,36,3,2,5
17,8478409,Anthony Richard,C,PHI,28,32,3,2,5
17,8484287,Cole McWard,D,VAN,23,28,3,2,5
17,8476372,Nick Seeler,D,PHI,31,38,2,3,5
17,8482713,Mackie Samoskevich,R,FLA,22,37,2,3,5
17,8483397,Marc McLaughlin,C,BOS,25,35,2,3,5
17,8476867,Brendan Gaunce,C,MIN,30,29,2,3,5
17,8482858,Ryker Evans,D,SEA,23,25,2,3,5
17,8479576,Vincent Desharnais,D,VAN,28,39,2,3,5
17,8484258,Sam Malinski,D,COL,26,19,2,3,5
17,8481543,Nikita Alexandrov,C,STL,24,28,2,3,5
17,8475235,Nicolas Deslauriers,L,PHI,33,48,1,4,5
17,8477473,Justin Bailey,R,SJS,29,20,1,4,5
17,8482516,Matthew Kessel,D,STL,24,20,1,4,5
17,8479587,Rhett Gardner,C,PHI,28,20,1,4,5
17,8474062,Riley Nash,C,NYR,35,23,1,4,5
17,8480084,Nick DeSimone,D,NJD,30,15,1,4,5
17,8481593,Jayden Struble,D,MTL,23,22,0,5,5
17,8479638,Justin Brazeau,R,BOS,26,32,4,0,4
17,8481147,Reese Johnson,C,MIN,26,40,2,2,4
17,8478881,Brett Seney,L,CHI,28,19,2,2,4
17,8482751,Ryan Winterton,C,SEA,21,26,1,3,4
17,8481056,Spencer Stastney,D,NSH,24,26,1,3,4
17,8481122,Simon Benoit,D,TOR,26,41,1,3,4
17,8477467,Gustav Olofsson,D,SEA,30,19,1,3,4
17,8480007,Jonas Rondbjerg,R,VGK,25,41,0,4,4
17,8475795,Dylan McIlrath,D,WSH,32,26,0,4,4
17,8480851,Akil Thomas,C,LAK,24,19,3,0,3
17,8480870,Bo Groulx,C,NYR,24,26,3,0,3
17,8480267,Sammy Walker,C,MIN,25,25,2,1,3
17,8480032,Shane Bowers,C,NJD,25,15,2,1,3
17,8482147,Jean-Luc Foudy,C,COL,22,26,2,1,3
17,8480990,Declan Chisholm,D,MIN,24,33,1,2,3
17,8478011,Louie Belpedio,D,PHI,28,14,1,2,3
17,8481422,Jake Lucchini,C,NSH,29,18,1,2,3
17,8480468,James Hamblin,L,EDM,25,22,0,3,3
17,8481006,Tyler Tucker,D,STL,24,17,0,3,3
17,8479320,Maxime Lajoie,D,SEA,27,18,0,3,3
17,8477810,Joel Hanley,D,CGY,33,24,0,3,3
17,8477462,Robert Hagg,D,VGK,29,23,0,3,3
17,8482165,Yan Kuznetsov,D,CGY,22,18,0,3,3
17,8481541,Samuel Bolduc,D,NYI,24,20,0,3,3
17,8481043,Cole Koepke,L,BOS,26,20,2,0,2
17,8477073,Kurtis MacDermid,L,NJD,30,27,2,0,2
17,8481743,Marc Del Gaizo,D,NSH,25,18,2,0,2
17,8480874,Adam Ginning,D,PHI,24,14,2,0,2
17,8481030,Jack St. Ivany,D,PIT,25,15,2,0,2
17,8482470,Ilya Solovyov,D,CGY,24,17,1,1,2
17,8477149,Scott Sabourin,R,SJS,32,20,1,1,2
17,8482061,Brandon Biro,L,SEA,26,18,1,1,2
17,8477541,Dakota Mermis,D,TOR,30,12,1,1,2
17,8483407,Brandon Scanlin,D,NYR,25,5,1,1,2
17,8481065,Angus Crookshank,L,OTT,25,11,1,1,2
17,8483395,Arshdeep Bains,L,VAN,23,18,1,1,2
17,8482118,Sam Colangelo,R,ANA,23,11,1,1,2
17,8479985,Cale Fleury,D,SEA,26,31,0,2,2
17,8480834,Ty Emberson,D,SJS,24,30,0,2,2
17,8478051,Max Willman,C,NJD,29,21,0,2,2
17,8481605,Jackson LaCombe,D,ANA,23,33,0,2,2
17,8481699,Aku Raty,R,UTA,23,18,0,2,2
17,8482162,Roby Jarventie,L,EDM,22,16,0,2,2
17,8482088,Justin Sourdif,R,FLA,22,21,0,2,2
17,8483567,Georgii Merkulov,C,BOS,24,10,0,2,2
17,8478477,Mitchell Stephens,C,SEA,27,21,0,2,2
17,8482197,Adam Raska,R,MIN,23,9,0,2,2
17,8483471,Brad Lambert,C,WPG,31,9,0,2,2
17,8483597,Milos Kelemen,L,UTA,25,8,1,0,1
17,8479362,Riley Tufte,L,BOS,26,16,1,0,1
17,8477971,Andreas Englund,D,LAK,28,25,1,0,1
17,8484325,Waltteri Merela,C,TBL,26,25,1,0,1
17,8480823,Alexander Alexeyev,D,WSH,25,9,1,0,1
17,8479419,Brett Murray,L,BUF,26,17,1,0,1
17,8482102,Vasily Ponomarev,C,PIT,22,16,1,0,1
17,8481564,Ryan Johnson,D,BUF,23,10,1,0,1
17,8484255,Jason Polin,R,COL,25,2,1,0,1
17,8478446,Glenn Gawdin,C,LAK,27,8,1,0,1
17,8481206,John Ludvig,D,PIT,24,11,1,0,1
17,8478502,Dennis Gilbert,D,BUF,28,25,0,1,1
17,8482070,Mitchell Chaffee,R,TBL,26,47,0,1,1
17,8479367,William Lockwood,R,FLA,26,29,0,1,1
17,8482201,Gage Goncalves,C,TBL,23,19,0,1,1
17,8482733,Logan Mailloux,D,MTL,31,34,0,1,1
17,8482094,Daemon Hunt,D,MIN,22,7,0,1,1
17,8477993,Justin Kirkland,C,CGY,28,2,0,1,1
17,8483489,Fraser Minten,C,TOR,31,9,0,1,1
17,8475755,Alexander Petrovic,D,DAL,32,9,0,1,1
17,8479421,Jacob Moverare,D,LAK,26,7,0,1,1
17,8482177,Marat Khusnutdinov,C,MIN,22,31,0,1,1
17,8475413,Justin Dowling,C,NJD,34,14,0,1,1
17,8481806,Louis Crevier,D,CHI,23,12,0,1,1
17,8481719,Maxwell Crozier,D,TBL,24,18,0,1,1
17,8481024,Linus Karlsson,C,VAN,25,7,0,1,1
17,8481726,Adam Edstrom,C,NYR,24,5,0,1,1
17,8482476,Emil Heineman,L,MTL,23,8,0,1,1
17,8481534,Raphael Lavoie,C,EDM,24,1,0,1,1
17,8483546,Marshall Rifai,D,TOR,26,10,0,1,1
17,8482126,Emil Andrae,D,PHI,31,6,0,1,1
17,8477320,Anton Blidh,L,NYR,29,18,0,0,0
17,8480306,Grant Hutton,D,NYI,29,5,0,0,0
17,8482787,Nikita Chibrikov,R,WPG,31,5,0,0,0
17,8481578,Graeme Clarke,R,MIN,23,9,0,0,0
17,8483512,Matthew Savoie,C,EDM,20,19,0,0,0
17,8483432,Luca Del Bel Belluz,C,CBJ,31,4,0,0,0
17,8481585,Egor Afanasyev,L,SJS,23,16,0,0,0
17,8482460,Matt Rempe,C,NYR,22,12,0,0,0
17,8481462,Mason Morelli,L,VGK,28,12,0,0,0
17,8480075,Cameron Crotty,D,MIN,25,7,0,0,0
17,8476323,Max McCormick,L,SEA,32,1,0,0,0
17,8479330,Brandon Gignac,C,MTL,27,6,0,0,0
17,8483401,Marc Johnstone,R,PIT,28,2,0,0,0
17,8479522,Hardy Haman Aktell,D,WSH,26,5,0,0,0
17,8481655,Cole Schwindt,R,CGY,23,8,0,0,0
17,8483531,Brian Halonen,L,NJD,25,2,0,0,0
17,8483920,Pierrick Dube,R,WSH,23,5,0,0,0
17,8483398,Declan Carlile,D,TBL,31,6,0,0,0
17,8475780,Chris Wagner,R,COL,33,9,0,0,0
17,8478854,Ryan Shea,D,PIT,27,7,0,0,0
17,8483609,Adam Klapka,R,CGY,24,2,0,0,0
17,8484304,Uvis Balinskis,D,FLA,28,10,0,0,0
17,8484259,Ondrej Pavel,C,COL,31,5,0,0,0
17,8484321,Nikolas Matinpalo,D,OTT,26,2,0,0,0
17,8484326,Patrik Koch,D,UTA,28,1,0,0,0
17,8478147,Bokondji Imama,L,PIT,28,7,0,0,0
17,8470794,Joe Pavelski,C,,40,0,0,0,0
17,8479321,Lucas Johansen,D,,27,0,0,0,0
17,8477950,Tony DeAngelo,D,,29,0,0,0,0
17,8471218,Blake Wheeler,R,,38,0,0,0,0
17,8475197,Tyson Barrie,D,,33,0,0,0,0
17,8474157,Max Pacioretty,L,,36,0,0,0,0
17,8475744,Evgeny Kuznetsov,C,,32,0,0,0,0
17,8474037,James van Riemsdyk,L,,35,0,0,0,0
17,8476907,Mackenzie MacEachern,L,,30,0,0,0,0
17,8480216,Jacob Peterson,C,,25,0,0,0,0
17,8474602,Justin Schultz,D,,34,0,0,0,0
17,8482222,Alexander Barabanov,L,,30,0,0,0,0
17,8474031,Kevin Shattenkirk,D,,35,0,0,0,0
17,8477330,Dominik Kubalik,L,,29,0,0,0,0
17,8480884,Calen Addison,D,,24,0,0,0,0
17,8475906,John Klingberg,D,,32,0,0,0,0
17,8480008,Adam Ruzicka,C,,25,0,0,0,0
17,8476884,Derrick Pouliot,D,,30,0,0,0,0
17,8476919,Chris Tierney,C,,30,0,0,0,0
17,8479415,Michael McLeod,C,,26,0,0,0,0
17,8474870,Tyler Johnson,C,,34,0,0,0,0
17,8470604,Jeff Carter,C,,39,0,0,0,0
17,8478104,Sammy Blais,L,,28,0,0,0,0
17,8474884,Mike Hoffman,C,,35,0,0,0,0
17,8481591,Sam Poulin,R,,23,0,0,0,0
17,8471274,Alex Goligoski,D,,39,0,0,0,0
17,8476871,Tanner Pearson,L,,32,0,0,0,0
17,8476393,Nick Cousins,C,,31,0,0,0,0
17,8479977,Kailer Yamamoto,R,,26,0,0,0,0
17,8479346,Dillon Dube,C,,26,0,0,0,0
17,8480184,Gustav Lindstrom,D,,26,0,0,0,0
17,8479376,Victor Mete,D,,26,0,0,0,0
17,8473449,Kyle Okposo,R,,36,0,0,0,0
17,8481058,Jesse Ylonen,R,,25,0,0,0,0
17,8475752,Tyler Pitlick,C,,33,0,0,0,0
17,8481239,Samuel Fagemo,L,,24,0,0,0,0
17,8480821,Filip Zadina,R,,25,0,0,0,0
17,8470966,Mark Giordano,D,,41,0,0,0,0
17,8478495,Denis Gurianov,R,,27,0,0,0,0
17,8477464,Nic Petan,C,,29,0,0,0,0
17,8478099,Kevin Labanc,R,,29,0,0,0,0
17,8482241,Radim Zohorna,L,,28,0,0,0,0
17,8474040,Sam Gagner,C,,35,0,0,0,0
17,8479514,Rem Pitlick,C,,27,0,0,0,0
17,8478430,Oliver Kylington,D,,27,0,0,0,0
17,8479533,Joona Koppanen,L,,26,0,0,0,0
17,8479984,Cal Foote,D,,26,0,0,0,0
17,8477126,Jayson Megna,C,,34,0,0,0,0
17,8475164,Jakob Silfverberg,R,,34,0,0,0,0
17,8474009,Nick Bonino,C,,36,0,0,0,0
17,8479458,Nikita Zaitsev,D,,33,0,0,0,0
17,8477944,Jakub Vrana,L,,28,0,0,0,0
17,8471699,Andrew Cogliano,C,,37,0,0,0,0
17,8478067,Oskar Lindblom,L,,28,0,0,0,0
17,8471686,Marc Staal,D,,37,0,0,0,0
17,8470610,Zach Parise,L,,40,0,0,0,0
17,8478904,Steven Lorentz,C,,28,0,0,0,0
17,8473473,Milan Lucic,L,,36,0,0,0,0
17,8480031,Maxime Comtois,L,,25,0,0,0,0
17,8478512,Austin Czarnik,C,,32,0,0,0,0
17,8473504,Cal Clutterbuck,R,,37,0,0,0,0
17,8477454,Adam Erne,L,,29,0,0,0,0
17,8479383,Boris Katchouk,L,,26,0,0,0,0
17,8475825,Jani Hakanpää,D,,32,0,0,0,0
17,8477846,Ryan Carpenter,C,,33,0,0,0,0
17,8477930,Pierre-Edouard Bellemare,L,,39,0,0,0,0
17,8478400,Colin White,C,,27,0,0,0,0
17,8480226,Marián Studenic,R,,26,0,0,0,0
17,8480853,Liam Foudy,C,,24,0,0,0,0
17,8475797,Jarred Tinordi,D,,32,0,0,0,0
17,8479423,Alex Nylander,L,,26,0,0,0,0
17,8474618,Marco Scandella,D,,34,0,0,0,0
17,8478028,Fredrik Olofsson,L,,28,0,0,0,0
17,8474709,Matt Martin,L,,35,0,0,0,0
17,8481070,Hugh McGing,L,,26,0,0,0,0
17,8479546,Oskar Steen,C,,26,0,0,0,0
17,8474145,Robert Bortuzzo,D,,35,0,0,0,0
17,8476915,Jujhar Khaira,L,,30,0,0,0,0
17,8480274,Philip Kemp,D,EDM,25,0,0,0,0
17,8475278,Byron Froese,C,,33,0,0,0,0
17,8481812,Nikolai Knyzhov,D,,27,0,0,0,0
17,8478408,Travis Dermott,D,,28,0,0,0,0
17,8481077,John Leonard,L,,26,0,0,0,0
17,8479547,Matthew Phillips,R,,26,0,0,0,0
17,8480836,Jonathan Gruden,C,,24,0,0,0,0
17,8481690,Tyler Angle,C,,24,0,0,0,0
17,8475766,Austin Watson,L,,32,0,0,0,0
17,8481016,Ruslan Iskhakov,C,,24,0,0,0,0
17,8478078,Rourke Chartier,C,,28,0,0,0,0
17,8480776,Sheldon Rempal,R,,29,0,0,0,0
17,8478956,Samuel Laberge,L,NJD,27,1,0,0,0
17,8483045,Cameron Butler,R,CBJ,31,1,0,0,0
17,8484314,Jiri Smejkal,L,,28,0,0,0,0
18,8477492,Nathan MacKinnon,C,COL,29,81,61,86,147
18,8478402,Connor McDavid,C,EDM,27,75,43,102,145
18,8476453,Nikita Kucherov,R,TBL,31,82,40,96,136
18,8481559,Jack Hughes,C,NJD,23,77,50,84,134
18,8479318,Auston Matthews,C,TOR,27,80,83,47,130
18,8478483,Mitch Marner,R,TOR,27,77,40,83,123
18,8477934,Leon Draisaitl,C,EDM,29,77,34,84,118
18,8478420,Mikko Rantanen,R,COL,28,81,46,64,110
18,8479314,Matthew Tkachuk,L,FLA,27,76,37,72,109
18,8477956,David Pastrnak,R,BOS,28,80,54,53,107
18,8477942,Kevin Fiala,L,LAK,28,80,38,64,102
18,8478864,Kirill Kaprizov,L,MIN,27,76,54,47,101
18,8478010,Brayden Point,C,TBL,28,82,48,53,101
18,8471675,Sidney Crosby,C,PIT,37,77,42,59,101
18,8480027,Jason Robertson,L,DAL,25,82,33,68,101
18,8480012,Elias Pettersson,C,VAN,26,74,47,52,99
18,8476468,J.T. Miller,C,VAN,31,77,35,64,99
18,8477493,Aleksander Barkov,C,FLA,29,76,32,67,99
18,8477409,Carter Verhaeghe,C,FLA,29,78,45,51,96
18,8477939,William Nylander,R,TOR,28,80,35,61,96
18,8479407,Jesper Bratt,L,NJD,26,77,29,64,93
18,8478445,Mathew Barzal,C,NYI,27,80,28,65,93
18,8480036,Miro Heiskanen,D,DAL,25,81,23,70,93
18,8475172,Nazem Kadri,C,CGY,34,80,36,56,92
18,8479323,Adam Fox,D,NYR,26,72,12,79,91
18,8477946,Dylan Larkin,C,DET,28,81,45,45,90
18,8478403,Jack Eichel,C,VGK,28,76,40,50,90
18,8476454,Ryan Nugent-Hopkins,C,EDM,31,79,23,65,88
18,8478427,Sebastian Aho,C,CAR,27,74,36,51,87
18,8479343,Clayton Keller,R,UTA,26,77,33,53,86
18,8474564,Steven Stamkos,C,NSH,34,74,36,49,85
18,8477404,Jake Guentzel,C,TBL,30,81,38,46,84
18,8476887,Filip Forsberg,L,NSH,30,71,36,48,84
18,8475692,Mats Zuccarello,R,MIN,37,76,21,62,83
18,8479385,Jordan Kyrou,C,STL,26,74,33,49,82
18,8478550,Artemi Panarin,L,NYR,33,74,28,54,82
18,8477949,Alex Tuch,R,BUF,28,70,28,53,81
18,8480865,Noah Dobson,D,NYI,24,82,15,66,81
18,8480023,Robert Thomas,C,STL,25,74,24,56,80
18,8479542,Brandon Hagel,L,TBL,26,82,32,47,79
18,8475166,John Tavares,C,TOR,34,82,31,48,79
18,8475913,Mark Stone,R,VGK,32,74,27,52,79
18,8480208,Drake Batherson,R,OTT,26,79,24,55,79
18,8475798,Mikael Granlund,C,SJS,32,74,15,64,79
18,8480069,Cale Makar,D,COL,26,68,28,50,78
18,8480800,Quinn Hughes,D,VAN,25,73,9,69,78
18,8477933,Sam Reinhart,C,FLA,29,80,31,46,77
18,8476459,Mika Zibanejad,C,NYR,31,76,30,47,77
18,8478439,Travis Konecny,R,PHI,27,79,30,47,77
18,8478440,Dylan Strome,C,WSH,27,79,21,56,77
18,8478449,Roope Hintz,C,DAL,28,80,42,34,76
18,8480002,Nico Hischier,C,NJD,25,76,29,47,76
18,8482116,Tim Stützle,C,OTT,22,79,29,47,76
18,8477951,Nick Schmaltz,C,UTA,28,79,29,46,75
18,8477494,Jonathan Drouin,L,COL,29,78,27,48,75
18,8476460,Mark Scheifele,C,WPG,31,69,25,50,75
18,8476456,Jonathan Huberdeau,C,CGY,31,80,18,57,75
18,8476389,Vincent Trocheck,C,NYR,31,78,29,45,74
18,8478460,Zach Werenski,D,CBJ,27,79,14,60,74
18,8478414,Timo Meier,R,NJD,28,76,40,33,73
18,8480801,Brady Tkachuk,L,OTT,25,78,33,40,73
18,8478398,Kyle Connor,L,WPG,28,72,27,45,72
18,8471685,Anze Kopitar,C,LAK,37,78,25,46,71
18,8476346,Johnny Gaudreau,L,CBJ,31,73,21,50,71
18,8476539,Jonathan Marchessault,R,NSH,34,73,36,34,70
18,8477402,Pavel Buchnevich,L,STL,29,77,35,35,70
18,8479337,Alex DeBrincat,R,DET,27,80,28,42,70
18,8477960,Adrian Kempe,R,LAK,28,81,35,33,68
18,8473419,Brad Marchand,L,BOS,36,81,30,38,68
18,8482078,Lucas Raymond,L,DET,22,80,29,39,68
18,8480018,Nick Suzuki,C,MTL,25,76,25,43,68
18,8475184,Chris Kreider,L,NYR,33,78,35,32,67
18,8475765,Vladimir Tarasenko,R,DET,33,81,27,40,67
18,8474141,Patrick Kane,R,DET,36,78,22,45,67
18,8484144,Connor Bedard,C,CHI,19,72,30,36,66
18,8481557,Matt Boldy,L,MIN,23,64,29,37,66
18,8475754,Brock Nelson,C,NYI,33,82,29,37,66
18,8480039,Martin Necas,C,CAR,25,73,25,41,66
18,8481711,Matias Maccelli,L,UTA,24,77,22,44,66
18,8473512,Claude Giroux,R,OTT,36,81,21,45,66
18,8479420,Tage Thompson,C,BUF,27,71,37,28,65
18,8475810,Bryan Rust,R,PIT,32,75,34,31,65
18,8477501,Valeri Nichushkin,R,COL,29,81,32,33,65
18,8477940,Nikolaj Ehlers,L,WPG,28,73,31,34,65
18,8476881,Tomas Hertl,C,VGK,31,80,28,37,65
18,8477496,Elias Lindholm,C,BOS,30,79,27,38,65
18,8474600,Roman Josi,D,NSH,34,75,18,47,65
18,8476399,Blake Coleman,C,CGY,33,78,34,30,64
18,8477476,Artturi Lehkonen,L,COL,29,80,26,38,64
18,8475168,Matt Duchene,C,DAL,33,82,24,40,64
18,8476462,Dougie Hamilton,D,NJD,31,70,20,44,64
18,8475167,Victor Hedman,D,TBL,34,79,13,51,64
18,8475786,Zach Hyman,L,EDM,32,79,29,34,63
18,8478493,Joel Eriksson Ek,C,MIN,27,69,26,37,63
18,8471215,Evgeni Malkin,C,PIT,38,71,21,42,63
18,8480839,Rasmus Dahlin,D,BUF,24,75,19,44,63
18,8480015,Owen Tippett,R,PHI,25,74,29,33,62
18,8477935,Sam Bennett,C,FLA,28,76,28,34,62
18,8482740,Wyatt Johnston,C,DAL,21,79,26,36,62
18,8478401,Pavel Zacha,C,BOS,27,80,21,41,62
18,8471214,Alex Ovechkin,L,WSH,39,72,32,29,61
18,8474150,Mikael Backlund,C,CGY,35,78,19,42,61
18,8473994,Jamie Benn,L,DAL,35,82,28,32,60
18,8474102,David Perron,L,OTT,36,77,25,35,60
18,8482109,Alexis Lafrenière,L,NYR,23,76,24,36,60
18,8475158,Ryan O'Reilly,C,NSH,33,77,23,37,60
18,8478873,Troy Terry,R,ANA,27,73,17,43,60
18,8476853,Morgan Rielly,D,TOR,30,71,7,53,60
18,8474586,Jordan Eberle,R,SEA,34,76,29,30,59
18,8478474,Lawson Crouse,L,UTA,27,76,27,32,59
18,8479675,Trevor Moore,L,LAK,29,81,23,36,59
18,8478469,Thomas Chabot,D,OTT,27,75,11,48,59
18,8475784,Jeff Skinner,C,EDM,32,76,33,25,58
18,8481528,Dylan Cozens,C,BUF,23,71,26,32,58
18,8477407,Anthony Duclair,L,NYI,29,78,20,38,58
18,8474679,Gustav Nyquist,C,NSH,35,72,18,40,58
18,8478407,Vince Dunn,D,SEA,28,74,15,43,58
18,8479425,Filip Hronek,D,VAN,27,76,9,49,58
18,8475170,Brayden Schenn,C,STL,33,76,28,29,57
18,8476448,William Karlsson,C,VGK,31,79,25,32,57
18,8478856,Conor Garland,R,VAN,28,70,21,36,57
18,8477511,Anthony Mantha,R,CGY,30,77,20,37,57
18,8477346,MacKenzie Weegar,D,CGY,30,71,16,41,57
18,8476792,Torey Krug,D,STL,33,71,13,44,57
18,8481068,Yegor Sharangovich,C,CGY,26,74,30,26,56
18,8481540,Cole Caufield,R,MTL,23,77,28,28,56
18,8478444,Brock Boeser,R,VAN,27,72,28,28,56
18,8476479,Phillip Danault,C,LAK,31,80,21,35,56
18,8471724,Kris Letang,D,PIT,37,80,18,38,56
18,8476875,Mike Matheson,D,MTL,30,72,8,48,56
18,8475745,Charlie Coyle,C,BOS,32,77,19,36,55
18,8478397,Rasmus Andersson,D,CGY,28,76,15,40,55
18,8478055,Gustav Forsling,D,FLA,28,75,10,45,55
18,8480830,Andrei Svechnikov,R,CAR,24,65,24,30,54
18,8482093,Seth Jarvis,C,CAR,22,72,19,35,54
18,8476432,Boone Jenner,C,CBJ,31,70,34,19,53
18,8476483,Rickard Rakell,R,PIT,31,73,30,23,53
18,8482665,Matty Beniers,C,SEA,22,73,25,28,53
18,8473986,Alex Killorn,L,ANA,35,74,24,29,53
18,8479400,Pierre-Luc Dubois,L,WSH,26,72,23,30,53
18,8483515,Juraj Slafkovsky,L,MTL,20,74,18,35,53
18,8474578,Erik Karlsson,D,PIT,34,76,10,43,53
18,8477955,Jared McCann,L,SEA,28,74,32,20,52
18,8478366,Frank Vatrano,R,ANA,30,72,29,23,52
18,8478519,Anthony Cirelli,C,TBL,27,82,25,27,52
18,8482745,Mason McTavish,C,ANA,21,73,23,29,52
18,8474590,John Carlson,D,WSH,34,63,19,33,52
18,8479325,Charlie McAvoy,D,BOS,27,68,9,43,52
18,8475314,Anders Lee,L,NYI,34,81,32,19,51
18,8483808,Andrei Kuzmenko,L,CGY,28,74,27,24,51
18,8475726,Tyler Toffoli,C,SJS,32,69,25,26,51
18,8484153,Leo Carlsson,C,ANA,20,68,25,26,51
18,8478975,Mason Marchment,L,DAL,29,81,23,28,51
18,8482124,Quinton Byfield,R,LAK,22,81,22,29,51
18,8479339,Patrik Laine,L,CBJ,26,64,22,29,51
18,8477451,Ryan Hartman,R,MIN,30,64,22,29,51
18,8484145,Zach Benson,L,BUF,19,71,18,33,51
18,8477456,J.T. Compher,L,DET,29,79,17,34,51
18,8476906,Shayne Gostisbehere,D,CAR,31,77,15,36,51
18,8479999,Casey Mittelstadt,C,COL,26,78,11,40,51
18,8477504,Josh Morrissey,D,WPG,29,76,8,43,51
18,8475768,Jaden Schwartz,C,SEA,32,71,28,22,50
18,8474641,Adam Henrique,C,EDM,34,73,24,26,50
18,8478542,Evan Rodrigues,C,FLA,31,76,20,30,50
18,8482113,Anton Lundell,C,FLA,23,78,19,31,50
18,8482699,Dylan Guenther,R,UTA,21,73,19,31,50
18,8481618,Alex Newhook,C,MTL,23,78,19,31,50
18,8476880,Tom Wilson,R,WSH,30,61,17,33,50
18,8477986,Brandon Montour,D,SEA,30,79,15,35,50
18,8480185,Eetu Luostarinen,C,FLA,26,77,24,25,49
18,8481596,Shane Pinto,C,OTT,24,74,23,26,49
18,8482702,Logan Stankoven,C,DAL,21,80,22,27,49
18,8476905,Chandler Stephenson,C,SEA,30,76,14,35,49
18,8478042,Viktor Arvidsson,L,EDM,31,74,27,21,48
18,8475799,Nino Niederreiter,R,WPG,32,67,24,24,48
18,8482110,Dawson Mercer,C,NJD,23,77,22,26,48
18,8477998,Warren Foegele,L,LAK,28,82,20,28,48
18,8482146,Luke Evangelista,R,NSH,22,68,23,24,47
18,8475151,Kyle Palmieri,C,NYI,33,78,20,27,47
18,8477500,Bo Horvat,C,NYI,29,76,25,21,46
18,8475794,Tyler Seguin,C,DAL,32,81,22,24,46
18,8481533,Trevor Zegras,C,ANA,23,72,15,31,46
18,8478462,Nicolas Roy,C,VGK,27,74,15,31,46
18,8477495,Seth Jones,D,CHI,30,65,9,37,46
18,8480064,Josh Norris,C,OTT,25,77,24,21,45
18,8479987,Morgan Geekie,C,BOS,26,77,20,25,45
18,8477964,Ivan Barbashev,C,VGK,29,76,19,26,45
18,8471698,T.J. Oshie,R,WSH,38,66,18,27,45
18,8481186,Logan O'Connor,R,COL,28,81,18,27,45
18,8484166,Adam Fantilli,C,CBJ,20,67,17,28,45
18,8482097,Jack Quinn,R,BUF,23,66,16,29,45
18,8476826,Yanni Gourde,C,SEA,33,70,14,31,45
18,8477447,Shea Theodore,D,VGK,29,62,11,34,45
18,8475169,Evander Kane,L,EDM,33,74,26,18,44
18,8479525,Ross Colton,C,COL,28,78,23,21,44
18,8475191,Reilly Smith,R,NYR,33,75,19,25,44
18,8478463,Anthony Beauvillier,L,PIT,27,67,19,25,44
18,8478047,Michael Bunting,L,PIT,29,71,16,28,44
18,8478438,Tommy Novak,C,NSH,27,73,13,31,44
18,8477021,Alex Kerfoot,C,UTA,30,76,11,33,44
18,8476882,Teuvo Teravainen,C,CHI,30,66,19,24,43
18,8478057,Dakota Joshua,C,VAN,28,68,17,26,43
18,8482671,Owen Power,D,BUF,22,73,13,30,43
18,8482684,Luke Hughes,D,NJD,21,74,10,33,43
18,8478038,Devon Toews,D,COL,30,72,8,35,43
18,8480014,Gabriel Vilardi,C,WPG,25,74,23,19,42
18,8477479,Tyler Bertuzzi,L,CHI,29,63,20,22,42
18,8478046,Danton Heinen,L,VAN,29,69,16,26,42
18,8475793,Ryan Johansen,C,PHI,32,73,14,28,42
18,8482720,Matthew Knies,L,TOR,22,77,13,29,42
18,8478396,Noah Hanifin,D,VGK,27,59,12,30,42
18,8478458,John (Jack) Roslovic,C,CAR,27,70,12,30,42
18,8477503,Max Domi,C,TOR,29,79,11,31,42
18,8470613,Brent Burns,D,CAR,39,73,11,31,42
18,8478115,Pierre Engvall,L,NYI,28,77,20,21,41
18,8478498,Jake DeBrusk,L,VAN,28,72,19,22,41
18,8482667,William Eklund,L,SJS,22,66,19,22,41
18,8477429,Andrew Copp,C,DET,30,81,18,23,41
18,8480849,Barrett Hayton,C,UTA,24,73,17,24,41
18,8476458,Ryan Strome,C,ANA,31,73,17,24,41
18,8477444,Andre Burakovsky,L,SEA,29,72,16,25,41
18,8477416,Oliver Bjorkstrand,R,SEA,29,73,15,26,41
18,8480803,Evan Bouchard,D,EDM,25,72,8,33,41
18,8481604,Pavel Dorofeyev,L,VGK,24,68,23,17,40
18,8480798,Philipp Kurashev,C,CHI,25,69,17,23,40
18,8482712,Oskar Olausson,R,COL,22,79,14,26,40
18,8475753,Justin Faulk,D,STL,32,74,12,28,40
18,8481577,Philip Tomasino,C,NSH,23,67,11,29,40
18,8476958,Jaccob Slavin,D,CAR,30,79,10,30,40
18,8474563,Drew Doughty,D,LAK,35,71,7,33,40
18,8482159,Tyson Foerster,R,PHI,22,76,18,21,39
18,8479992,Michael Rasmussen,C,DET,25,81,17,22,39
18,8475763,Kevin Hayes,R,PIT,32,66,17,22,39
18,8482475,Yegor Chinakhov,R,CBJ,23,65,17,22,39
18,8482105,Jake Sanderson,D,OTT,22,76,13,26,39
18,8476292,Ondrej Palat,L,NJD,33,68,12,27,39
18,8483431,Logan Cooley,C,UTA,20,72,11,28,39
18,8481581,Thomas Harley,D,DAL,23,73,11,28,39
18,8481535,Nils Hoglander,L,VAN,24,63,21,17,38
18,8480797,Joel Farabee,L,PHI,24,77,19,19,38
18,8479393,Noah Gregor,L,OTT,26,77,19,19,38
18,8478233,Andrew Mangiapane,L,WSH,28,71,17,21,38
18,8482092,Ridly Greig,C,OTT,22,81,16,22,38
18,8478466,Daniel Sprong,R,VAN,27,67,16,22,38
18,8474149,Evgenii Dadonov,R,DAL,35,79,16,22,38
18,8478413,Jordan Greenway,L,BUF,27,67,16,22,38
18,8481560,Arthur Kaliyev,R,LAK,23,79,13,25,38
18,8474053,Logan Couture,C,SJS,35,63,11,27,38
18,8474565,Alex Pietrangelo,D,VGK,34,64,10,28,38
18,8477498,Darnell Nurse,D,EDM,29,75,10,28,38
18,8474151,Ryan McDonagh,D,TBL,35,75,5,33,38
18,8481554,Kaapo Kakko,R,NYR,23,68,19,18,37
18,8476921,Jordan Martinook,L,CAR,32,65,17,20,37
18,8482149,Cole Perfetti,C,WPG,22,62,16,21,37
18,8480009,Eeli Tolvanen,R,SEA,25,76,16,21,37
18,8480003,Jesper Boqvist,C,FLA,26,65,15,22,37
18,8477932,Aaron Ekblad,D,FLA,28,67,14,23,37
18,8475149,Marcus Johansson,L,MIN,34,67,14,23,37
18,8481542,Moritz Seider,D,DET,23,73,5,32,37
18,8475764,Cam Fowler,D,ANA,33,70,4,33,37
18,8482074,Connor Zary,C,CGY,23,57,23,13,36
18,8475848,Brendan Gallagher,R,MTL,32,72,20,16,36
18,8480829,Jesperi Kotkaniemi,C,CAR,24,67,16,20,36
18,8476872,Scott Laughton,C,PHI,30,74,14,22,36
18,8479345,Jakob Chychrun,D,WSH,26,67,10,26,36
18,8479410,Mikhail Sergachev,D,UTA,26,72,7,29,36
18,8480188,Fabian Zetterlund,L,SJS,25,61,20,15,35
18,8482175,JJ Peterka,R,BUF,22,72,19,16,35
18,8477426,Nicholas Paul,L,TBL,29,79,16,19,35
18,8479365,Trent Frederic,C,BOS,26,76,16,19,35
18,8476438,Brandon Saad,L,STL,32,71,16,19,35
18,8480028,Morgan Frost,C,PHI,25,72,15,20,35
18,8475193,Tomas Tatar,L,NJD,34,69,15,20,35
18,8478472,Mathieu Joseph,R,STL,27,71,13,22,35
18,8477947,Sonny Milano,L,WSH,28,66,12,23,35
18,8474716,Jared Spurgeon,D,MIN,35,81,11,24,35
18,8476925,Colton Sissons,C,NSH,31,70,11,24,35
18,8477497,Sean Monahan,C,CBJ,30,63,10,25,35
18,8476885,Jacob Trouba,D,NYR,30,70,10,25,35
18,8480145,Neal Pionk,D,WPG,29,70,9,26,35
18,8476918,Jimmy Vesey,L,NYR,31,72,21,13,34
18,8476461,Sean Couturier,C,PHI,32,67,15,19,34
18,8482055,Drew O'Connor,L,PIT,26,71,15,19,34
18,8476960,Andreas Athanasiou,C,CHI,30,59,12,22,34
18,8475218,Mattias Ekholm,D,EDM,34,72,9,25,34
18,8482067,Connor Mackey,D,NYR,28,63,9,25,34
18,8481523,Kirby Dach,C,MTL,23,73,7,27,34
18,8475714,Calle Jarnkrok,C,TOR,33,73,15,18,33
18,8478109,Victor Olofsson,L,VGK,29,69,15,18,33
18,8480078,Filip Chytil,C,NYR,25,62,14,19,33
18,8480789,Oliver Wahlstrom,R,NYI,24,70,14,19,33
18,8482117,Lukas Reichel,L,CHI,22,61,13,20,33
18,8476463,Jonas Brodin,D,MIN,31,80,6,27,33
18,8476923,Damon Severson,D,CBJ,30,78,5,28,33
18,8480873,Rasmus Sandin,D,WSH,24,64,3,30,33
18,8480893,Kirill Marchenko,R,CBJ,24,58,19,13,32
18,8481582,Nicholas Robertson,L,TOR,23,63,15,17,32
18,8478020,Michael Amadio,R,OTT,28,74,14,18,32
18,8476897,Oskar Sundqvist,C,STL,30,69,13,19,32
18,8477953,Kasperi Kapanen,R,STL,28,65,9,23,32
18,8482133,Thomas Bordeleau,C,SJS,22,66,8,24,32
18,8482624,Daniil Miromanov,D,CGY,27,66,7,25,32
18,8482122,Brock Faber,D,MIN,22,78,7,25,32
18,8477969,Marcus Pettersson,D,PIT,28,78,2,30,32
18,8477015,Connor Brown,R,EDM,30,67,13,18,31
18,8474715,Cameron Atkinson,R,TBL,35,80,11,20,31
18,8476869,Brady Skjei,D,NSH,30,66,10,21,31
18,8484203,Bradly Nadeau,L,CAR,19,64,10,21,31
18,8482101,Danil Gushchin,L,SJS,22,58,9,22,31
18,8481606,Jordan Spence,D,LAK,23,68,4,27,31
18,8479398,Samuel Girard,D,COL,26,58,3,28,31
18,8481580,Connor McMichael,C,WSH,23,62,18,12,30
18,8479390,Taylor Raddysh,R,WSH,26,62,16,14,30
18,8480220,Noah Cates,L,PHI,25,71,14,16,30
18,8482705,Cole Sillinger,C,CBJ,21,66,13,17,30
18,8480459,Pius Suter,C,VAN,28,72,13,17,30
18,8480068,Ryan Poehling,C,PHI,25,67,13,17,30
18,8479591,Michael Eyssimont,C,TBL,28,82,12,18,30
18,8479315,Joey Anderson,R,CHI,26,50,11,19,30
18,8477505,Alexander Wennberg,C,SJS,30,68,9,21,30
18,8480817,K'Andre Miller,D,NYR,24,75,7,23,30
18,8480336,Sean Walker,D,CAR,30,74,7,23,30
18,8476979,Erik Gustafsson,D,DET,32,76,5,25,30
18,8473422,Nick Foligno,L,CHI,37,58,17,12,29
18,8479316,Luke Kunin,C,SJS,27,64,14,15,29
18,8476480,Vladislav Namestnikov,C,WPG,32,63,14,15,29
18,8480835,Jack Drury,C,CAR,24,56,13,16,29
18,8477987,Ryan Donato,C,CHI,28,63,13,16,29
18,8483505,Matthew Poitras,C,BOS,20,75,10,19,29
18,8482660,Kent Johnson,C,CBJ,22,59,10,19,29
18,8478970,Jalen Chatfield,D,CAR,28,71,10,19,29
18,8475791,Taylor Hall,L,CHI,33,53,7,22,29
18,8475200,Dmitry Orlov,D,CAR,33,70,6,23,29
18,8478882,Vladislav Gavrikov,D,LAK,29,69,4,25,29
18,8477425,Miles Wood,L,COL,29,73,19,9,28
18,8476474,Stefan Noesen,R,NJD,31,69,16,12,28
18,8477952,Robby Fabbri,C,ANA,28,67,14,14,28
18,8476392,Adam Lowry,C,WPG,31,60,14,14,28
18,8475231,Casey Cizikas,C,NYI,33,74,13,15,28
18,8478508,Yakov Trenin,C,MIN,27,63,13,15,28
18,8483491,Ivan Miroshnichenko,L,WSH,20,60,12,16,28
18,8476889,Radek Faksa,C,STL,30,68,12,16,28
18,8475722,Jason Zucker,L,BUF,32,62,10,18,28
18,8476419,Jean-Gabriel Pageau,C,NYI,32,78,10,18,28
18,8481553,Bobby Brink,R,PHI,23,61,10,18,28
18,8477506,Ryan Pulock,D,NYI,30,76,7,21,28
18,8481546,Cam York,D,PHI,23,71,7,21,28
18,8482089,Jake Neighbours,L,STL,22,70,18,9,27
18,8480113,Alex Iafallo,L,WPG,31,66,15,12,27
18,8481624,Ilya Mikheyev,R,CHI,30,56,13,14,27
18,8481656,Aliaksei Protas,C,WSH,23,57,11,16,27
18,8480434,Sean Durzi,D,UTA,26,63,10,17,27
18,8477220,Nate Schmidt,D,FLA,33,69,10,17,27
18,8477989,Christian Dvorak,C,MTL,28,60,9,18,27
18,8475171,Oliver Ekman-Larsson,D,TOR,33,70,8,19,27
18,8478133,Jake Evans,C,MTL,28,67,8,19,27
18,8479351,Sam Steel,C,DAL,26,80,7,20,27
18,8481703,Valtteri Puustinen,R,PIT,25,62,4,23,27
18,8478500,Ivan Provorov,D,CBJ,27,78,2,25,27
18,8475760,Nick Bjugstad,C,UTA,32,71,16,10,26
18,8474189,Lars Eller,C,PIT,35,67,15,11,26
18,8478043,Sam Lafferty,C,BUF,29,66,14,12,26
18,8478013,Jake Walman,D,SJS,28,71,13,13,26
18,8478891,Mason Appleton,C,WPG,28,65,10,16,26
18,8476927,Teddy Blueger,C,VAN,30,65,10,16,26
18,8475287,Erik Haula,L,NJD,33,69,8,18,26
18,8476854,Hampus Lindholm,D,BOS,30,70,1,25,26
18,8480806,Isac Lundestrom,C,ANA,25,56,14,11,25
18,8482679,Matt Coronato,R,CGY,22,61,13,12,25
18,8480205,Emil Bemstrom,C,PIT,25,61,12,13,25
18,8482079,Marco Rossi,C,MIN,23,58,12,13,25
18,8483445,Cutter Gauthier,L,ANA,20,61,11,14,25
18,8482809,Jackson Blake,R,CAR,21,48,11,14,25
18,8480871,Adam Boqvist,D,FLA,24,56,10,15,25
18,8481481,Blake Lizotte,C,PIT,27,55,10,15,25
18,8475855,Jesper Fast,R,CAR,33,61,9,16,25
18,8481028,Martin Pospisil,C,CGY,25,65,8,17,25
18,8473563,Nicklas Backstrom,C,WSH,37,55,7,18,25
18,8483490,Pavel Mintyukov,D,ANA,21,70,5,20,25
18,8478911,Matt Roy,D,WSH,29,66,5,20,25
18,8476331,Dylan DeMelo,D,WPG,31,74,4,21,25
18,8477845,Trevor van Riemsdyk,D,WSH,33,60,3,22,25
18,8479661,Tanner Jeannot,L,LAK,27,75,16,8,24
18,8477353,Tyler Motte,C,DET,29,75,14,10,24
18,8477839,Conor Sheary,L,TBL,32,81,12,12,24
18,8479996,Cody Glass,C,NSH,25,59,12,12,24
18,8478434,Keegan Kolesar,R,VGK,27,72,11,13,24
18,8480855,Jack McBain,C,UTA,24,65,10,14,24
18,8477508,Curtis Lazar,C,NJD,29,61,10,14,24
18,8476873,Mark Jankowski,C,NSH,30,54,9,15,24
18,8480074,Alexandre Texier,C,STL,25,48,7,17,24
18,8476312,Josh Manson,D,COL,33,62,6,18,24
18,8480807,Mattias Samuelsson,D,BUF,24,63,4,20,24
18,8482655,Janis Moser,D,TBL,24,80,1,23,24
18,8480073,Erik Brannstrom,D,COL,25,65,0,24,24
18,8476981,Josh Anderson,R,MTL,30,69,15,8,23
18,8480281,Alexey Toropchenko,R,STL,25,56,13,10,23
18,8480813,Joe Veleno,C,DET,24,73,12,11,23
18,8479414,Nathan Bastian,R,NJD,27,62,12,11,23
18,8475220,Marcus Foligno,L,MIN,33,67,11,12,23
18,8482157,Will Cuylle,L,NYR,22,60,11,12,23
18,8481704,Juuso Parssinen,C,NSH,23,51,10,13,23
18,8479353,Brett Howden,C,VGK,26,65,10,13,23
18,8483468,Jiri Kulich,C,BUF,20,61,9,14,23
18,8480980,Connor Dewar,C,TOR,25,63,9,14,23
18,8481524,Bowen Byram,D,BUF,23,59,8,15,23
18,8482245,Artem Zub,D,OTT,29,73,7,16,23
18,8476902,Esa Lindell,D,DAL,30,78,5,18,23
18,8476457,Adam Larsson,D,SEA,32,68,5,18,23
18,8480802,Ryan McLeod,C,BUF,25,69,4,19,23
18,8477488,Brett Pesce,D,NJD,30,62,4,19,23
18,8482073,Braden Schneider,D,NYR,23,65,4,19,23
18,8473507,Jeff Petry,D,DET,37,68,3,20,23
18,8481014,Alexander Romanov,D,NYI,24,75,2,21,23
18,8476278,Colin Blackwell,C,DAL,31,78,12,10,22
18,8477450,Jason Dickinson,C,CHI,29,54,11,11,22
18,8480144,David Kampf,C,TOR,29,69,11,11,22
18,8483457,Lane Hutson,D,MTL,20,69,10,12,22
18,8479976,Juuso Valimaki,D,UTA,26,68,7,15,22
18,8478136,Jake Middleton,D,MIN,28,73,5,17,22
18,8479982,Conor Timmins,D,TOR,26,64,3,19,22
18,8476374,Sean Kuraly,C,CBJ,31,56,14,7,21
18,8477478,William Carrier,L,CAR,30,49,13,8,21
18,8470621,Corey Perry,R,EDM,39,71,13,8,21
18,8476878,Zemgus Girgensons,C,TBL,30,82,12,9,21
18,8476469,Joel Armia,R,MTL,31,69,12,9,21
18,8477446,Michael McCarron,R,NSH,29,62,9,12,21
18,8480748,Kiefer Sherwood,L,VAN,29,53,8,13,21
18,8481522,Peyton Krebs,C,BUF,23,61,8,13,21
18,8477979,Nicolas Aube-Kubel,R,BUF,28,59,7,14,21
18,8480762,Eric Robinson,L,CAR,29,58,7,14,21
18,8483565,Nick Blankenburg,D,NSH,26,67,6,15,21
18,8481527,Kaedan Korczak,D,VGK,23,48,6,15,21
18,8478432,Christian Fischer,R,DET,27,76,6,15,21
18,8476467,Jamie Oleksiak,D,SEA,32,64,6,15,21
18,8482176,Wyatt Kaiser,D,CHI,22,53,5,16,21
18,8480878,Nils Lundkvist,D,DAL,24,69,4,17,21
18,8476891,Matthew Grzelcyk,D,PIT,30,75,4,17,21
18,8475181,Nick Leddy,D,STL,33,69,3,18,21
18,8476917,Adam Pelech,D,NYI,30,79,2,19,21
18,8480222,Sebastian Aho,D,PIT,28,71,2,19,21
18,8481032,Paul Cotter,C,NJD,25,59,10,10,20
18,8482749,Joshua Roy,R,MTL,21,64,8,12,20
18,8479066,Ryan Lomberg,L,CGY,30,62,7,13,20
18,8480796,Martin Fehervary,D,WSH,25,58,7,13,20
18,8477369,Carson Soucy,D,VAN,30,64,6,14,20
18,8478421,A.J. Greer,L,FLA,28,57,6,14,20
18,8477948,Travis Sanheim,D,PHI,28,63,4,16,20
18,8475462,Radko Gudas,D,ANA,34,68,4,16,20
18,8479371,Dante Fabbro,D,NSH,26,65,4,16,20
18,8479983,Mario Ferraro,D,SJS,26,68,3,17,20
18,8478859,Niko Mikkola,D,FLA,28,62,3,17,20
18,8475324,Nick Jensen,D,OTT,34,69,2,18,20
18,8478569,Noel Acciari,C,PIT,33,57,15,4,19
18,8479619,Michael Carcone,L,UTA,28,54,14,5,19
18,8482737,Zack Bolduc,C,STL,21,55,11,8,19
18,8482747,Brennan Othmann,L,NYR,21,46,10,9,19
18,8481093,Rafael Harvey-Pinard,L,MTL,25,54,9,10,19
18,8483493,Frank Nazar,C,CHI,20,48,8,11,19
18,8479328,Julien Gauthier,R,NYI,27,53,8,11,19
18,8481617,Vasily Podkolzin,R,VAN,23,54,6,13,19
18,8479639,Dylan Coghlan,D,WPG,26,65,6,13,19
18,8474574,Tyler Myers,D,VAN,34,67,6,13,19
18,8476879,Cody Ceci,D,EDM,31,71,6,13,19
18,8476994,Vinnie Hinostroza,C,NSH,30,42,5,14,19
18,8477507,Nikita Zadorov,D,BOS,29,66,4,15,19
18,8478840,Will Borgen,D,SEA,28,62,4,15,19
18,8476892,Colton Parayko,D,STL,31,72,3,16,19
18,8482142,Jamie Drysdale,D,PHI,22,60,2,17,19
18,8480891,Michael Kesselring,D,UTA,24,68,2,17,19
18,8480035,Henri Jokiharju,D,BUF,25,56,1,18,19
18,8480011,Klim Kostin,C,SJS,25,55,11,7,18
18,8471709,Marc-Edouard Vlasic,D,SJS,37,65,10,8,18
18,8479941,Justin Danforth,R,CBJ,31,59,8,10,18
18,8482148,Hendrix Lapierre,C,WSH,22,55,8,10,18
18,8483499,Liam Ohgren,L,MIN,20,48,7,11,18
18,8479439,Jacob MacDonald,D,COL,31,50,7,11,18
18,8479293,Brandon Tanev,L,SEA,33,58,6,12,18
18,8475225,Craig Smith,C,CHI,35,49,6,12,18
18,8480441,Trey Fix-Wolansky,R,CBJ,25,37,6,12,18
18,8479671,Mathieu Olivier,R,CBJ,27,52,6,12,18
18,8477903,Garnet Hathaway,R,PHI,33,66,5,13,18
18,8476856,Mathew Dumba,D,DAL,30,75,5,13,18
18,8476429,Scott Mayfield,D,NYI,32,74,4,14,18
18,8479291,Kevin Rooney,C,CGY,31,57,4,14,18
18,8475179,Dmitry Kulikov,D,FLA,34,61,3,15,18
18,8478851,Alexandre Carrier,D,NSH,28,65,3,15,18
18,8477435,Ryan Graves,D,PIT,29,74,2,16,18
18,8478178,Darren Raddysh,D,TBL,28,73,2,16,18
18,8482087,Kaiden Guhle,D,MTL,22,64,1,17,18
18,8475343,Nic Dowd,C,WSH,34,59,10,7,17
18,8482125,Alexander Holtz,R,VGK,22,69,9,8,17
18,8479368,Max Jones,L,BOS,26,63,8,9,17
18,8473533,Jordan Staal,C,CAR,36,63,7,10,17
18,8479344,Jesse Puljujarvi,R,PIT,26,46,7,10,17
18,8474567,Zach Bogosian,D,MIN,34,62,6,11,17
18,8477919,Frederick Gaudreau,C,MIN,31,57,5,12,17
18,8476422,Mike Reilly,D,NYI,31,74,5,12,17
18,8478416,Erik Cernak,D,TBL,27,76,5,12,17
18,8475188,Brayden McNabb,D,VGK,33,57,4,13,17
18,8475790,Erik Gudbranson,D,CBJ,32,74,3,14,17
18,8480860,Kevin Bahl,D,CGY,24,56,3,14,17
18,8482111,Justin Barron,D,MTL,23,68,3,14,17
18,8479026,Philippe Myers,D,TOR,27,53,2,15,17
18,8479324,Ryan Lindgren,D,NYR,26,64,2,15,17
18,8474673,TJ Brodie,D,CHI,34,71,2,15,17
18,8478507,John Marino,D,UTA,27,67,1,16,17
18,8481178,Egor Zamula,D,PHI,24,55,1,16,17
18,8481716,Dmitri Voronkov,L,CBJ,24,46,11,5,16
18,8476822,Luke Glendening,C,TBL,35,74,9,7,16
18,8481641,Joel Kiviranta,L,COL,28,74,9,7,16
18,8473453,Trevor Lewis,C,LAK,37,72,8,8,16
18,8475842,Sam Carrick,C,NYR,32,62,8,8,16
18,8479520,Brandon Duhaime,R,WSH,27,58,8,8,16
18,8480355,Mark Kastelic,C,BOS,25,66,8,8,16
18,8474034,Patrick Maroon,L,CHI,36,47,7,9,16
18,8483495,Simon Nemec,D,NJD,20,58,7,9,16
18,8480025,MacKenzie Entwistle,R,FLA,25,70,6,10,16
18,8470600,Ryan Suter,D,STL,39,63,6,10,16
18,8483482,Tristan Luneau,D,ANA,20,64,5,11,16
18,8476329,Travis Boyd,C,MIN,31,52,5,11,16
18,8476442,Matt Nieto,L,PIT,32,47,5,11,16
18,8477406,Mattias Janmark,C,EDM,32,61,4,12,16
18,8483524,Shane Wright,C,SEA,20,56,3,13,16
18,8476525,Colin Miller,D,WPG,32,67,3,13,16
18,8479998,Mikey Anderson,D,LAK,25,63,3,13,16
18,8479402,Jake Bean,D,CGY,26,61,2,14,16
18,8481059,Scott Perunovich,D,STL,26,59,2,14,16
18,8481568,Alex Vlasic,D,CHI,23,50,0,16,16
18,8479336,Carl Grundstrom,R,SJS,27,53,10,5,15
18,8482803,Olen Zellweger,D,ANA,21,66,7,8,15
18,8480289,Morgan Barron,C,WPG,26,47,7,8,15
18,8481517,Brett Leason,R,ANA,25,50,6,9,15
18,8481477,Nico Sturm,C,SJS,29,47,6,9,15
18,8480995,Pontus Holmberg,R,TOR,25,61,5,10,15
18,8477392,Hudson Fasching,R,NYI,29,67,5,10,15
18,8482192,Isaak Phillips,D,CHI,23,54,5,10,15
18,8481550,Adam Beckman,L,NJD,23,37,5,10,15
18,8480192,Johnathan Kovacevic,D,NJD,27,50,5,10,15
18,8477931,Tomas Nosek,L,FLA,32,59,4,11,15
18,8481751,Lukas Rousek,R,BUF,25,36,4,11,15
18,8480043,Timothy Liljegren,D,TOR,25,61,0,15,15
18,8481601,Simon Holmstrom,R,NYI,23,66,9,5,14
18,8480848,Ty Dellandrea,C,SJS,24,38,7,7,14
18,8482155,Alex Laferriere,R,LAK,23,62,6,8,14
18,8484149,Gavin Brindley,C,CBJ,20,52,6,8,14
18,8480292,Carson Meyer,R,ANA,27,33,6,8,14
18,8479994,Jaret Anderson-Dolan,C,WPG,25,41,6,8,14
18,8481441,Joe Snively,C,DET,28,63,5,9,14
18,8478452,Caleb Jones,D,LAK,27,53,4,10,14
18,8481161,Jake Christiansen,D,CBJ,25,60,4,10,14
18,8480049,Dylan Samberg,D,WPG,25,61,3,11,14
18,8476874,Olli Maatta,D,DET,30,63,3,11,14
18,8476624,Barclay Goodrow,C,SJS,31,49,3,11,14
18,8479980,Nicolas Hague,D,VGK,26,53,3,11,14
18,8478451,Ethan Bear,D,WSH,27,46,2,12,14
18,8478443,Brandon Carlo,D,BOS,28,60,2,12,14
18,8475718,Justin Holl,D,DET,32,63,2,12,14
18,8480879,Jacob Bernard-Docker,D,OTT,24,47,2,12,14
18,8482259,Bobby McMann,C,TOR,28,65,11,2,13
18,8478585,Derek Ryan,C,EDM,38,65,6,7,13
18,8481013,Jonatan Berggren,R,DET,24,56,6,7,13
18,8480252,Cole Guttman,C,CHI,25,40,6,7,13
18,8482652,Walker Duehr,R,CGY,27,38,6,7,13
18,8482077,Dylan Holloway,L,EDM,23,56,5,8,13
18,8480727,Zach Whitecloud,D,VGK,28,49,4,9,13
18,8480021,Jack Studnicka,C,LAK,25,62,4,9,13
18,8479986,Kole Lind,R,DAL,26,58,3,10,13
18,8479442,Troy Stecher,D,EDM,30,59,3,10,13
18,8480157,Calle Rosen,D,COL,30,48,3,10,13
18,8476931,Jake McCabe,D,TOR,31,62,2,11,13
18,8477499,Rasmus Ristolainen,D,PHI,30,60,2,11,13
18,8477018,Ben Hutton,D,VGK,31,47,2,11,13
18,8475208,Brian Dumoulin,D,ANA,33,63,2,11,13
18,8475279,Ben Chiarot,D,DET,33,66,2,11,13
18,8474612,Travis Hamonic,D,OTT,34,44,2,11,13
18,8478211,Dryden Hunt,L,CGY,29,53,0,13,13
18,8480070,Ian Mitchell,D,BOS,25,47,0,13,13
18,8481537,Nikita Okhotiuk,D,CGY,24,46,6,6,12
18,8479968,Vinni Lettieri,C,BOS,29,43,5,7,12
18,8482062,Cole Smith,L,NSH,29,53,4,8,12
18,8480246,Nick Perbix,D,TBL,26,72,3,9,12
18,8479536,Axel Jonsson-Fjallby,L,WPG,26,43,3,9,12
18,8482730,Brandt Clarke,D,LAK,21,50,3,9,12
18,8475455,Brenden Dillon,D,NJD,34,64,3,9,12
18,8476988,Matt Benning,D,SJS,30,64,2,10,12
18,8480950,Ilya Lyubushkin,D,DAL,30,57,2,10,12
18,8475690,Chris Tanev,D,TOR,35,58,2,10,12
18,8474013,Ian Cole,D,UTA,35,61,2,10,12
18,8476967,Brett Kulak,D,EDM,30,61,1,11,12
18,8480448,Parker Kelly,L,COL,25,74,7,4,11
18,8482762,Simon Edvinsson,D,DET,21,51,7,4,11
18,8477573,Nathan Walker,L,STL,30,48,6,5,11
18,8482807,Ethan Del Mastro,D,CHI,21,43,5,6,11
18,8482634,Alex Steeves,C,TOR,25,52,5,6,11
18,8483460,David Jiricek,D,CBJ,21,58,5,6,11
18,8481147,Reese Johnson,C,MIN,26,44,5,6,11
18,8482166,Shakir Mukhamadullin,D,SJS,22,52,4,7,11
18,8471677,Jack Johnson,D,CBJ,37,65,4,7,11
18,8478424,Jansen Harkins,C,ANA,27,39,4,7,11
18,8480887,Jordan Harris,D,MTL,24,55,4,7,11
18,8471817,Ryan Reaves,R,TOR,37,53,4,7,11
18,8480845,Rasmus Kupari,C,WPG,24,50,4,7,11
18,8482095,Tyler Kleven,D,OTT,22,39,3,8,11
18,8476867,Brendan Gaunce,C,MIN,30,40,2,9,11
18,8479372,Joshua Mahura,D,SEA,26,60,1,10,11
18,8477851,Jordan Oesterle,D,BOS,32,46,1,10,11
18,8479249,Andrew Poturalski,C,SJS,30,35,1,10,11
18,8482784,Zach Dean,C,STL,21,36,6,4,10
18,8481532,Alex Turcotte,C,LAK,23,41,6,4,10
18,8482070,Mitchell Chaffee,R,TBL,26,55,6,4,10
18,8481518,Nolan Foote,L,NJD,24,38,5,5,10
18,8479772,Zack MacEwen,R,OTT,28,49,5,5,10
18,8482496,Nils Aman,C,VAN,24,43,5,5,10
18,8481521,Ronnie Attard,D,PHI,25,59,4,6,10
18,8478468,Jeremy Lauzon,D,NSH,27,52,4,6,10
18,8477070,Liam O'Brien,C,UTA,30,51,4,6,10
18,8481600,Tobias Bjornfot,D,FLA,23,47,4,6,10
18,8479370,Tyson Jost,C,CAR,26,51,3,7,10
18,8479369,Andrew Peeke,D,BOS,26,68,3,7,10
18,8477380,Jonny Brodzinski,C,NYR,31,51,3,7,10
18,8479972,Mason Shaw,C,WPG,26,38,3,7,10
18,8478399,Jonas Siegenthaler,D,NJD,27,60,1,9,10
18,8480001,Urho Vaakanainen,D,ANA,25,63,1,9,10
18,8481701,Santeri Hatakka,D,NJD,23,40,1,9,10
18,8480058,Pierre-Olivier Joseph,D,STL,25,49,1,9,10
18,8474568,Luke Schenn,D,NSH,35,52,1,9,10
18,8482141,Lukas Cormier,D,VGK,22,24,1,9,10
18,8475233,David Savard,D,MTL,34,65,0,10,10
18,8479638,Justin Brazeau,R,BOS,26,32,7,2,9
18,8476858,Phillip Di Giuseppe,L,VAN,31,42,5,4,9
18,8477962,Brendan Lemieux,L,CAR,28,48,5,4,9
18,8481592,Jakob Pelletier,L,CGY,23,42,5,4,9
18,8482451,Mikael Pyyhtia,L,CBJ,23,46,4,5,9
18,8474090,Brendan Smith,D,DAL,35,52,4,5,9
18,8481599,Victor Soderstrom,D,UTA,23,33,4,5,9
18,8481754,Nikita Nesterenko,C,ANA,23,38,4,5,9
18,8482713,Mackie Samoskevich,R,FLA,22,38,4,5,9
18,8477365,Connor Clifton,D,BUF,29,66,3,6,9
18,8480880,Jakub Lauko,C,MIN,24,42,3,6,9
18,8480870,Bo Groulx,C,NYR,24,28,3,6,9
18,8479543,Michael Pezzetta,L,MTL,26,53,2,7,9
18,8481167,Brayden Pachal,D,CGY,25,48,2,7,9
18,8481567,Henry Thrun,D,SJS,23,58,1,8,9
18,8474166,Alec Martinez,D,CHI,37,47,0,9,9
18,8478831,Kevin Stenlund,C,UTA,28,55,6,2,8
18,8482964,Arber Xhekaj,D,MTL,23,41,5,3,8
18,8482659,Josh Doan,R,UTA,22,47,5,3,8
18,8475958,Michael Sgarbossa,C,WSH,32,27,5,3,8
18,8481679,Maxence Guenette,D,OTT,23,37,5,3,8
18,8482765,Isak Rosen,R,BUF,21,31,4,4,8
18,8478146,Matthew Highmore,C,OTT,28,36,4,4,8
18,8481609,Vladislav Kolyachonok,D,UTA,23,33,4,4,8
18,8477887,Patrick Brown,C,BOS,32,44,3,5,8
18,8482744,James Malatesta,L,CBJ,21,41,3,5,8
18,8480007,Jonas Rondbjerg,R,VGK,25,37,3,5,8
18,8480172,Jan Rutta,D,SJS,34,60,2,6,8
18,8481019,David Gustafsson,C,WPG,24,41,1,7,8
18,8476441,Joel Edmundson,D,LAK,31,42,1,7,8
18,8480196,Jacob Bryson,D,BUF,27,37,1,7,8
18,8478021,William Lagesson,D,DET,28,32,1,7,8
18,8476913,Devin Shore,C,MIN,30,30,0,8,8
18,8482666,Scott Morrow,D,CAR,22,48,5,2,7
18,8478454,Noah Juulsen,D,VAN,27,38,4,3,7
18,8482153,Brendan Brisson,C,VGK,23,28,4,3,7
18,8484258,Sam Malinski,D,COL,26,23,4,3,7
18,8482859,Zack Ostapchuk,C,OTT,21,48,3,4,7
18,8481708,Zac Jones,D,NYR,24,44,3,4,7
18,8479981,Jonah Gadjovich,L,FLA,26,37,3,4,7
18,8479378,Logan Stanley,D,WPG,26,38,3,4,7
18,8479576,Vincent Desharnais,D,VAN,28,29,3,4,7
18,8475235,Nicolas Deslauriers,L,PHI,33,46,3,4,7
18,8476934,Brock McGinn,L,ANA,30,47,2,5,7
18,8478874,Adam Gaudette,R,OTT,28,30,2,5,7
18,8477527,Ross Johnston,L,ANA,30,40,2,5,7
18,8482861,Vincent Iorio,D,WSH,22,30,2,5,7
18,8477810,Joel Hanley,D,CGY,33,28,2,5,7
18,8480990,Declan Chisholm,D,MIN,24,36,1,6,7
18,8480834,Ty Emberson,D,SJS,24,29,1,6,7
18,8477938,Haydn Fleury,D,WPG,28,41,0,7,7
18,8475177,Calvin de Haan,D,COL,33,46,0,7,7
18,8481556,John Beecher,C,BOS,23,44,5,1,6
18,8479379,Givani Smith,R,SJS,26,30,3,3,6
18,8483630,Pavol Regenda,L,ANA,25,30,3,3,6
18,8479944,Zach Aston-Reese,C,VGK,30,48,3,3,6
18,8478450,Parker Wotherspoon,D,BOS,27,31,3,3,6
18,8476952,Dominic Toninato,C,WPG,30,37,2,4,6
18,8478017,Mark Friedman,D,VAN,29,34,2,4,6
18,8484911,Collin Graf,R,SJS,22,39,2,4,6
18,8481056,Spencer Stastney,D,NSH,24,35,2,4,6
18,8478011,Louie Belpedio,D,PHI,28,17,2,4,6
18,8479991,Jake Leschyshyn,C,NYR,25,27,1,5,6
18,8480245,Olle Lycksell,R,PHI,25,19,1,5,6
18,8479320,Maxime Lajoie,D,SEA,27,19,1,5,6
18,8477971,Andreas Englund,D,LAK,28,36,1,5,6
18,8475750,Jon Merrill,D,MIN,32,56,0,6,6
18,8477034,Jaycob Megna,D,FLA,32,51,0,6,6
18,8480267,Sammy Walker,C,MIN,25,13,4,1,5
18,8479718,Alex Barré-Boulet,C,MTL,27,46,3,2,5
18,8477384,Joshua Brown,D,EDM,30,41,3,2,5
18,8478409,Anthony Richard,C,PHI,28,34,3,2,5
18,8480468,James Hamblin,L,EDM,25,17,3,2,5
18,8479985,Cale Fleury,D,SEA,26,28,3,2,5
18,8483012,Logan Morrison,C,SEA,22,44,2,3,5
18,8483763,Maksymilian Szuber,D,UTA,22,26,2,3,5
18,8481598,Philip Broberg,D,EDM,23,41,2,3,5
18,8475762,Derek Forbort,D,VAN,32,43,2,3,5
18,8481122,Simon Benoit,D,TOR,26,42,2,3,5
18,8477482,Zachary Sanford,L,CHI,30,31,1,4,5
18,8476473,Connor Murphy,D,CHI,31,47,1,4,5
18,8483549,Lucas Condotta,L,MTL,27,35,1,4,5
18,8483466,Kevin Korchinski,D,CHI,20,52,1,4,5
18,8473446,Erik Johnson,D,PHI,36,45,1,4,5
18,8484254,Akito Hirose,D,VAN,25,42,1,4,5
18,8482250,Callahan Burke,C,VGK,27,32,1,4,5
18,8482858,Ryker Evans,D,SEA,23,25,1,4,5
18,8477073,Kurtis MacDermid,L,NJD,30,27,1,4,5
18,8476372,Nick Seeler,D,PHI,31,46,0,5,5
18,8479587,Rhett Gardner,C,PHI,28,28,0,5,5
18,8481789,Tye Kartye,L,SEA,23,41,3,1,4
18,8482511,Mason Lohrei,D,BOS,23,36,2,2,4
18,8477401,John Hayden,C,SEA,29,30,2,2,4
18,8482145,Mavrik Bourque,C,DAL,22,42,2,2,4
18,8483397,Marc McLaughlin,C,BOS,25,27,2,2,4
18,8482165,Yan Kuznetsov,D,CGY,22,23,2,2,4
18,8478477,Mitchell Stephens,C,SEA,27,19,2,2,4
18,8480890,Jan Jenik,C,OTT,24,26,1,3,4
18,8484287,Cole McWard,D,VAN,23,26,1,3,4
18,8475795,Dylan McIlrath,D,WSH,32,20,1,3,4
18,8482470,Ilya Solovyov,D,CGY,24,17,1,3,4
18,8482733,Logan Mailloux,D,MTL,31,40,1,3,4
18,8482177,Marat Khusnutdinov,C,MIN,22,38,1,3,4
18,8482751,Ryan Winterton,C,SEA,21,33,0,4,4
18,8482118,Sam Colangelo,R,ANA,23,18,3,0,3
18,8479359,Beck Malenstyn,L,BUF,26,39,2,1,3
18,8483619,Filip Roos,D,OTT,25,32,2,1,3
18,8477244,Chad Ruhwedel,D,NYR,34,33,2,1,3
18,8477467,Gustav Olofsson,D,SEA,30,13,2,1,3
18,8481422,Jake Lucchini,C,NSH,29,18,2,1,3
18,8483395,Arshdeep Bains,L,VAN,23,12,2,1,3
18,8480844,Grigori Denisenko,L,VGK,24,25,1,2,3
18,8482172,Landon Slaggert,L,CHI,22,30,1,2,3
18,8478051,Max Willman,C,NJD,29,17,1,2,3
18,8479362,Riley Tufte,L,BOS,26,17,1,2,3
18,8477335,Kyle Burroughs,D,LAK,29,34,0,3,3
18,8481006,Tyler Tucker,D,STL,24,14,0,3,3
18,8481541,Samuel Bolduc,D,NYI,24,25,0,3,3
18,8475413,Justin Dowling,C,NJD,34,15,0,3,3
18,8482144,Jack Thompson,D,SJS,22,25,1,1,2
18,8481237,Kyle MacLean,C,NYI,25,24,1,1,2
18,8481543,Nikita Alexandrov,C,STL,24,26,1,1,2
18,8477473,Justin Bailey,R,SJS,29,23,1,1,2
18,8482147,Jean-Luc Foudy,C,COL,22,27,1,1,2
18,8481743,Marc Del Gaizo,D,NSH,25,15,1,1,2
18,8482061,Brandon Biro,L,SEA,26,11,1,1,2
18,8477541,Dakota Mermis,D,TOR,30,8,1,1,2
18,8481065,Angus Crookshank,L,OTT,25,18,1,1,2
18,8483471,Brad Lambert,C,WPG,31,10,1,1,2
18,8479367,William Lockwood,R,FLA,26,23,1,1,2
18,8482094,Daemon Hunt,D,MIN,22,14,1,1,2
18,8479421,Jacob Moverare,D,LAK,26,6,1,1,2
18,8481578,Graeme Clarke,R,MIN,23,10,1,1,2
18,8484304,Uvis Balinskis,D,FLA,28,4,1,1,2
18,8479348,Kale Clague,D,BUF,26,41,0,2,2
18,8482516,Matthew Kessel,D,STL,24,21,0,2,2
18,8481593,Jayden Struble,D,MTL,23,18,0,2,2
18,8478881,Brett Seney,L,CHI,28,15,0,2,2
18,8481030,Jack St. Ivany,D,PIT,25,19,0,2,2
18,8481605,Jackson LaCombe,D,ANA,23,28,0,2,2
18,8482162,Roby Jarventie,L,EDM,22,21,0,2,2
18,8479419,Brett Murray,L,BUF,26,12,0,2,2
18,8482201,Gage Goncalves,C,TBL,23,25,0,2,2
18,8482460,Matt Rempe,C,NYR,22,16,0,2,2
18,8480075,Cameron Crotty,D,MIN,25,12,0,2,2
18,8482929,Emil Lilleberg,D,TBL,23,21,1,0,1
18,8480851,Akil Thomas,C,LAK,24,15,1,0,1
18,8481043,Cole Koepke,L,BOS,26,14,1,0,1
18,8481699,Aku Raty,R,UTA,23,18,1,0,1
18,8484325,Waltteri Merela,C,TBL,26,17,1,0,1
18,8478502,Dennis Gilbert,D,BUF,28,10,1,0,1
18,8475755,Alexander Petrovic,D,DAL,32,7,1,0,1
18,8482476,Emil Heineman,L,MTL,23,9,1,0,1
18,8481585,Egor Afanasyev,L,SJS,23,9,1,0,1
18,8483920,Pierrick Dube,R,WSH,23,2,1,0,1
18,8483398,Declan Carlile,D,TBL,31,4,1,0,1
18,8475780,Chris Wagner,R,COL,33,9,1,0,1
18,8483570,Ben Meyers,C,SEA,26,28,0,1,1
18,8474062,Riley Nash,C,NYR,35,12,0,1,1
18,8480084,Nick DeSimone,D,NJD,30,14,0,1,1
18,8480032,Shane Bowers,C,NJD,25,9,0,1,1
18,8477462,Robert Hagg,D,VGK,29,29,0,1,1
18,8483407,Brandon Scanlin,D,NYR,25,6,0,1,1
18,8482088,Justin Sourdif,R,FLA,22,18,0,1,1
18,8483567,Georgii Merkulov,C,BOS,24,9,0,1,1
18,8478446,Glenn Gawdin,C,LAK,27,15,0,1,1
18,8481806,Louis Crevier,D,CHI,23,10,0,1,1
18,8481719,Maxwell Crozier,D,TBL,24,12,0,1,1
18,8481024,Linus Karlsson,C,VAN,25,11,0,1,1
18,8482126,Emil Andrae,D,PHI,31,6,0,1,1
18,8481462,Mason Morelli,L,VGK,28,12,0,1,1
18,8478854,Ryan Shea,D,PIT,27,6,0,1,1
18,8480874,Adam Ginning,D,PHI,24,10,0,0,0
18,8477149,Scott Sabourin,R,SJS,32,17,0,0,0
18,8482197,Adam Raska,R,MIN,23,6,0,0,0
18,8483597,Milos Kelemen,L,UTA,25,20,0,0,0
18,8480823,Alexander Alexeyev,D,WSH,25,10,0,0,0
18,8482102,Vasily Ponomarev,C,PIT,22,13,0,0,0
18,8481564,Ryan Johnson,D,BUF,23,12,0,0,0
18,8484255,Jason Polin,R,COL,25,3,0,0,0
18,8481206,John Ludvig,D,PIT,24,13,0,0,0
18,8477993,Justin Kirkland,C,CGY,28,4,0,0,0
18,8483489,Fraser Minten,C,TOR,31,10,0,0,0
18,8481726,Adam Edstrom,C,NYR,24,6,0,0,0
18,8481534,Raphael Lavoie,C,EDM,24,4,0,0,0
18,8483546,Marshall Rifai,D,TOR,26,3,0,0,0
18,8477320,Anton Blidh,L,NYR,29,17,0,0,0
18,8480306,Grant Hutton,D,NYI,29,7,0,0,0
18,8482787,Nikita Chibrikov,R,WPG,31,6,0,0,0
18,8483512,Matthew Savoie,C,EDM,20,15,0,0,0
18,8483432,Luca Del Bel Belluz,C,CBJ,31,8,0,0,0
18,8476323,Max McCormick,L,SEA,32,3,0,0,0
18,8479330,Brandon Gignac,C,MTL,27,8,0,0,0
18,8483401,Marc Johnstone,R,PIT,28,3,0,0,0
18,8479522,Hardy Haman Aktell,D,WSH,26,8,0,0,0
18,8481655,Cole Schwindt,R,CGY,23,3,0,0,0
18,8483531,Brian Halonen,L,NJD,25,1,0,0,0
18,8483609,Adam Klapka,R,CGY,24,1,0,0,0
18,8484259,Ondrej Pavel,C,COL,31,7,0,0,0
18,8484321,Nikolas Matinpalo,D,OTT,26,0,0,0,0
18,8484326,Patrik Koch,D,UTA,28,1,0,0,0
18,8478147,Bokondji Imama,L,PIT,28,2,0,0,0
18,8470794,Joe Pavelski,C,,40,0,0,0,0
18,8479321,Lucas Johansen,D,,27,0,0,0,0
18,8477950,Tony DeAngelo,D,,29,0,0,0,0
18,8471218,Blake Wheeler,R,,38,0,0,0,0
18,8475197,Tyson Barrie,D,,33,0,0,0,0
18,8474157,Max Pacioretty,L,,36,0,0,0,0
18,8475744,Evgeny Kuznetsov,C,,32,0,0,0,0
18,8474037,James van Riemsdyk,L,,35,0,0,0,0
18,8476907,Mackenzie MacEachern,L,,30,0,0,0,0
18,8480216,Jacob Peterson,C,,25,0,0,0,0
18,8474602,Justin Schultz,D,,34,0,0,0,0
18,8482222,Alexander Barabanov,L,,30,0,0,0,0
18,8474031,Kevin Shattenkirk,D,,35,0,0,0,0
18,8477330,Dominik Kubalik,L,,29,0,0,0,0
18,8480884,Calen Addison,D,,24,0,0,0,0
18,8475906,John Klingberg,D,,32,0,0,0,0
18,8480008,Adam Ruzicka,C,,25,0,0,0,0
18,8476884,Derrick Pouliot,D,,30,0,0,0,0
18,8476919,Chris Tierney,C,,30,0,0,0,0
18,8479415,Michael McLeod,C,,26,0,0,0,0
18,8474870,Tyler Johnson,C,,34,0,0,0,0
18,8470604,Jeff Carter,C,,39,0,0,0,0
18,8478104,Sammy Blais,L,,28,0,0,0,0
18,8474884,Mike Hoffman,C,,35,0,0,0,0
18,8481591,Sam Poulin,R,,23,0,0,0,0
18,8471274,Alex Goligoski,D,,39,0,0,0,0
18,8476871,Tanner Pearson,L,,32,0,0,0,0
18,8476393,Nick Cousins,C,,31,0,0,0,0
18,8479977,Kailer Yamamoto,R,,26,0,0,0,0
18,8479346,Dillon Dube,C,,26,0,0,0,0
18,8480184,Gustav Lindstrom,D,,26,0,0,0,0
18,8479376,Victor Mete,D,,26,0,0,0,0
18,8473449,Kyle Okposo,R,,36,0,0,0,0
18,8481058,Jesse Ylonen,R,,25,0,0,0,0
18,8475752,Tyler Pitlick,C,,33,0,0,0,0
18,8481239,Samuel Fagemo,L,,24,0,0,0,0
18,8480821,Filip Zadina,R,,25,0,0,0,0
18,8470966,Mark Giordano,D,,41,0,0,0,0
18,8478495,Denis Gurianov,R,,27,0,0,0,0
18,8477464,Nic Petan,C,,29,0,0,0,0
18,8478099,Kevin Labanc,R,,29,0,0,0,0
18,8482241,Radim Zohorna,L,,28,0,0,0,0
18,8474040,Sam Gagner,C,,35,0,0,0,0
18,8479514,Rem Pitlick,C,,27,0,0,0,0
18,8478430,Oliver Kylington,D,,27,0,0,0,0
18,8479533,Joona Koppanen,L,,26,0,0,0,0
18,8479984,Cal Foote,D,,26,0,0,0,0
18,8477126,Jayson Megna,C,,34,0,0,0,0
18,8475164,Jakob Silfverberg,R,,34,0,0,0,0
18,8474009,Nick Bonino,C,,36,0,0,0,0
18,8479458,Nikita Zaitsev,D,,33,0,0,0,0
18,8477944,Jakub Vrana,L,,28,0,0,0,0
18,8471699,Andrew Cogliano,C,,37,0,0,0,0
18,8478067,Oskar Lindblom,L,,28,0,0,0,0
18,8471686,Marc Staal,D,,37,0,0,0,0
18,8470610,Zach Parise,L,,40,0,0,0,0
18,8478904,Steven Lorentz,C,,28,0,0,0,0
18,8473473,Milan Lucic,L,,36,0,0,0,0
18,8480031,Maxime Comtois,L,,25,0,0,0,0
18,8478512,Austin Czarnik,C,,32,0,0,0,0
18,8473504,Cal Clutterbuck,R,,37,0,0,0,0
18,8477454,Adam Erne,L,,29,0,0,0,0
18,8479383,Boris Katchouk,L,,26,0,0,0,0
18,8475825,Jani Hakanpää,D,,32,0,0,0,0
18,8477846,Ryan Carpenter,C,,33,0,0,0,0
18,8477930,Pierre-Edouard Bellemare,L,,39,0,0,0,0
18,8478400,Colin White,C,,27,0,0,0,0
18,8480226,Marián Studenic,R,,26,0,0,0,0
18,8480853,Liam Foudy,C,,24,0,0,0,0
18,8475797,Jarred Tinordi,D,,32,0,0,0,0
18,8479423,Alex Nylander,L,,26,0,0,0,0
18,8474618,Marco Scandella,D,,34,0,0,0,0
18,8478028,Fredrik Olofsson,L,,28,0,0,0,0
18,8474709,Matt Martin,L,,35,0,0,0,0
18,8481070,Hugh McGing,L,,26,0,0,0,0
18,8479546,Oskar Steen,C,,26,0,0,0,0
18,8474145,Robert Bortuzzo,D,,35,0,0,0,0
18,8476915,Jujhar Khaira,L,,30,0,0,0,0
18,8480274,Philip Kemp,D,EDM,25,0,0,0,0
18,8475278,Byron Froese,C,,33,0,0,0,0
18,8481812,Nikolai Knyzhov,D,,27,0,0,0,0
18,8478408,Travis Dermott,D,,28,0,0,0,0
18,8481077,John Leonard,L,,26,0,0,0,0
18,8479547,Matthew Phillips,R,,26,0,0,0,0
18,8480836,Jonathan Gruden,C,,24,0,0,0,0
18,8481690,Tyler Angle,C,,24,0,0,0,0
18,8475766,Austin Watson,L,,32,0,0,0,0
18,8481016,Ruslan Iskhakov,C,,24,0,0,0,0
18,8478078,Rourke Chartier,C,,28,0,0,0,0
18,8480776,Sheldon Rempal,R,,29,0,0,0,0
18,8478956,Samuel Laberge,L,NJD,27,0,0,0,0
18,8483045,Cameron Butler,R,CBJ,31,2,0,0,0
18,8484314,Jiri Smejkal,L,,28,0,0,0,0
19,8476453,Nikita Kucherov,R,TBL,31,81,42,100,142
19,8477492,Nathan MacKinnon,C,COL,29,80,60,77,137
19,8477956,David Pastrnak,R,BOS,28,80,51,74,125
19,8479318,Auston Matthews,C,TOR,27,79,64,57,121
19,8478483,Mitch Marner,R,TOR,27,82,31,87,118
19,8479314,Matthew Tkachuk,L,FLA,27,78,33,81,114
19,8478402,Connor McDavid,C,EDM,27,78,33,78,111
19,8477934,Leon Draisaitl,C,EDM,29,81,39,71,110
19,8480027,Jason Robertson,L,DAL,25,82,32,78,110
19,8478420,Mikko Rantanen,R,COL,28,80,46,61,107
19,8481559,Jack Hughes,C,NJD,23,74,50,56,106
19,8478427,Sebastian Aho,C,CAR,27,76,41,59,100
19,8477939,William Nylander,R,TOR,28,81,40,60,100
19,8477946,Dylan Larkin,C,DET,28,82,47,50,97
19,8477942,Kevin Fiala,L,LAK,28,81,42,55,97
19,8477404,Jake Guentzel,C,TBL,30,82,39,56,95
19,8478864,Kirill Kaprizov,L,MIN,27,64,48,46,94
19,8478550,Artemi Panarin,L,NYR,33,76,27,67,94
19,8480023,Robert Thomas,C,STL,25,73,27,67,94
19,8484144,Connor Bedard,C,CHI,19,77,41,52,93
19,8480002,Nico Hischier,C,NJD,25,77,33,60,93
19,8480069,Cale Makar,D,COL,26,75,24,69,93
19,8478398,Kyle Connor,L,WPG,28,73,44,48,92
19,8480801,Brady Tkachuk,L,OTT,25,82,43,49,92
19,8477493,Aleksander Barkov,C,FLA,29,77,22,68,90
19,8478010,Brayden Point,C,TBL,28,82,45,44,89
19,8478403,Jack Eichel,C,VGK,28,77,37,51,88
19,8476389,Vincent Trocheck,C,NYR,31,80,34,54,88
19,8476459,Mika Zibanejad,C,NYR,31,76,30,57,87
19,8480012,Elias Pettersson,C,VAN,26,69,31,53,84
19,8476468,J.T. Miller,C,VAN,31,75,35,48,83
19,8475166,John Tavares,C,TOR,34,80,34,49,83
19,8476887,Filip Forsberg,L,NSH,30,73,35,47,82
19,8474600,Roman Josi,D,NSH,34,77,19,63,82
19,8475172,Nazem Kadri,C,CGY,34,79,30,51,81
19,8478449,Roope Hintz,C,DAL,28,82,37,43,80
19,8477933,Sam Reinhart,C,FLA,29,79,34,46,80
19,8471675,Sidney Crosby,C,PIT,37,75,33,47,80
19,8478445,Mathew Barzal,C,NYI,27,81,18,62,80
19,8478493,Joel Eriksson Ek,C,MIN,27,71,37,42,79
19,8480830,Andrei Svechnikov,R,CAR,24,73,34,45,79
19,8480208,Drake Batherson,R,OTT,26,78,33,46,79
19,8476460,Mark Scheifele,C,WPG,31,69,29,50,79
19,8477501,Valeri Nichushkin,R,COL,29,81,38,40,78
19,8478975,Mason Marchment,L,DAL,29,82,36,42,78
19,8476454,Ryan Nugent-Hopkins,C,EDM,31,79,31,47,78
19,8471214,Alex Ovechkin,L,WSH,39,74,45,31,76
19,8478444,Brock Boeser,R,VAN,27,78,43,33,76
19,8479385,Jordan Kyrou,C,STL,26,75,40,35,75
19,8475754,Brock Nelson,C,NYI,33,80,35,40,75
19,8477940,Nikolaj Ehlers,L,WPG,28,73,25,50,75
19,8474141,Patrick Kane,R,DET,36,80,29,45,74
19,8482116,Tim Stützle,C,OTT,22,78,17,57,74
19,8475168,Matt Duchene,C,DAL,33,82,32,41,73
19,8475794,Tyler Seguin,C,DAL,32,81,30,43,73
19,8479337,Alex DeBrincat,R,DET,27,82,29,44,73
19,8475692,Mats Zuccarello,R,MIN,37,75,16,57,73
19,8480036,Miro Heiskanen,D,DAL,25,78,15,58,73
19,8475167,Victor Hedman,D,TBL,34,78,9,64,73
19,8479542,Brandon Hagel,L,TBL,26,82,35,37,72
19,8475913,Mark Stone,R,VGK,32,76,33,39,72
19,8473419,Brad Marchand,L,BOS,36,79,28,44,72
19,8479999,Casey Mittelstadt,C,COL,26,81,28,44,72
19,8480865,Noah Dobson,D,NYI,24,80,9,63,72
19,8481557,Matt Boldy,L,MIN,23,72,29,42,71
19,8479407,Jesper Bratt,L,NJD,26,71,25,46,71
19,8477409,Carter Verhaeghe,C,FLA,29,78,42,28,70
19,8482740,Wyatt Johnston,C,DAL,21,81,29,41,70
19,8474564,Steven Stamkos,C,NSH,34,71,27,43,70
19,8478439,Travis Konecny,R,PHI,27,75,24,46,70
19,8480800,Quinn Hughes,D,VAN,25,75,16,54,70
19,8480803,Evan Bouchard,D,EDM,25,74,14,56,70
19,8476539,Jonathan Marchessault,R,NSH,34,74,40,29,69
19,8478047,Michael Bunting,L,PIT,29,80,35,34,69
19,8478414,Timo Meier,R,NJD,28,73,32,37,69
19,8479675,Trevor Moore,L,LAK,29,81,32,37,69
19,8471685,Anze Kopitar,C,LAK,37,81,18,51,69
19,8476346,Johnny Gaudreau,L,CBJ,31,73,15,54,69
19,8475184,Chris Kreider,L,NYR,33,73,40,28,68
19,8479343,Clayton Keller,R,UTA,26,78,33,34,67
19,8482078,Lucas Raymond,L,DET,22,81,28,39,67
19,8478401,Pavel Zacha,C,BOS,27,77,25,42,67
19,8477951,Nick Schmaltz,C,UTA,28,80,20,47,67
19,8478460,Zach Werenski,D,CBJ,27,80,19,48,67
19,8475765,Vladimir Tarasenko,R,DET,33,81,30,36,66
19,8477960,Adrian Kempe,R,LAK,28,81,28,38,66
19,8475170,Brayden Schenn,C,STL,33,74,28,38,66
19,8476906,Shayne Gostisbehere,D,CAR,31,77,12,54,66
19,8477949,Alex Tuch,R,BUF,28,77,25,40,65
19,8478440,Dylan Strome,C,WSH,27,73,20,44,64
19,8479425,Filip Hronek,D,VAN,27,74,13,51,64
19,8479420,Tage Thompson,C,BUF,27,77,28,35,63
19,8475786,Zach Hyman,L,EDM,32,80,28,35,63
19,8475810,Bryan Rust,R,PIT,32,68,25,38,63
19,8479325,Charlie McAvoy,D,BOS,27,78,18,45,63
19,8477504,Josh Morrissey,D,WPG,29,74,13,50,63
19,8476881,Tomas Hertl,C,VGK,31,73,25,37,62
19,8476456,Jonathan Huberdeau,C,CGY,31,80,19,43,62
19,8482684,Luke Hughes,D,NJD,21,73,12,49,61
19,8482124,Quinton Byfield,R,LAK,22,80,28,32,60
19,8476448,William Karlsson,C,VGK,31,76,27,33,60
19,8478873,Troy Terry,R,ANA,27,75,22,38,60
19,8474578,Erik Karlsson,D,PIT,34,80,13,47,60
19,8477955,Jared McCann,L,SEA,28,72,27,32,59
19,8482093,Seth Jarvis,C,CAR,22,72,23,36,59
19,8474102,David Perron,L,OTT,36,74,22,37,59
19,8478407,Vince Dunn,D,SEA,28,75,10,49,59
19,8480014,Gabriel Vilardi,C,WPG,25,69,33,25,58
19,8481596,Shane Pinto,C,OTT,24,76,30,28,58
19,8480064,Josh Norris,C,OTT,25,77,28,30,58
19,8481540,Cole Caufield,R,MTL,23,73,25,33,58
19,8471215,Evgeni Malkin,C,PIT,38,72,24,34,58
19,8477476,Artturi Lehkonen,L,COL,29,79,23,35,58
19,8473512,Claude Giroux,R,OTT,36,80,18,40,58
19,8477500,Bo Horvat,C,NYI,29,81,32,25,57
19,8476483,Rickard Rakell,R,PIT,31,70,23,34,57
19,8480018,Nick Suzuki,C,MTL,25,74,22,35,57
19,8473986,Alex Killorn,L,ANA,35,79,19,38,57
19,8477494,Jonathan Drouin,L,COL,29,82,13,44,57
19,8480839,Rasmus Dahlin,D,BUF,24,70,11,46,57
19,8479323,Adam Fox,D,NYR,26,77,5,52,57
19,8481068,Yegor Sharangovich,C,CGY,26,77,26,30,56
19,8480039,Martin Necas,C,CAR,25,72,25,31,56
19,8477402,Pavel Buchnevich,L,STL,29,76,22,34,56
19,8475158,Ryan O'Reilly,C,NSH,33,74,22,34,56
19,8476853,Morgan Rielly,D,TOR,30,70,10,46,56
19,8474679,Gustav Nyquist,C,NSH,35,73,20,35,55
19,8482109,Alexis Lafrenière,L,NYR,23,75,29,25,54
19,8481528,Dylan Cozens,C,BUF,23,74,24,30,54
19,8481618,Alex Newhook,C,MTL,23,72,20,34,54
19,8477986,Brandon Montour,D,SEA,30,69,19,35,54
19,8476880,Tom Wilson,R,WSH,30,71,30,23,53
19,8473994,Jamie Benn,L,DAL,35,82,20,33,53
19,8477496,Elias Lindholm,C,BOS,30,77,16,37,53
19,8476905,Chandler Stephenson,C,SEA,30,74,16,37,53
19,8480015,Owen Tippett,R,PHI,25,76,20,32,52
19,8475798,Mikael Granlund,C,SJS,32,68,10,42,52
19,8475726,Tyler Toffoli,C,SJS,32,66,29,22,51
19,8477964,Ivan Barbashev,C,VGK,29,80,28,23,51
19,8482110,Dawson Mercer,C,NJD,23,73,25,25,50
19,8475784,Jeff Skinner,C,EDM,32,78,23,27,50
19,8475745,Charlie Coyle,C,BOS,32,82,20,30,50
19,8477416,Oliver Bjorkstrand,R,SEA,29,79,19,31,50
19,8477456,J.T. Compher,L,DET,29,78,18,32,50
19,8475151,Kyle Palmieri,C,NYI,33,77,23,26,49
19,8479525,Ross Colton,C,COL,28,81,22,27,49
19,8483431,Logan Cooley,C,UTA,20,76,22,27,49
19,8477479,Tyler Bertuzzi,L,CHI,29,73,21,28,49
19,8474586,Jordan Eberle,R,SEA,34,72,18,31,49
19,8480798,Philipp Kurashev,C,CHI,25,65,12,37,49
19,8478469,Thomas Chabot,D,OTT,27,71,11,38,49
19,8474590,John Carlson,D,WSH,34,73,4,45,49
19,8478474,Lawson Crouse,L,UTA,27,77,28,20,48
19,8475314,Anders Lee,L,NYI,34,79,22,26,48
19,8477451,Ryan Hartman,R,MIN,30,70,21,27,48
19,8482720,Matthew Knies,L,TOR,22,75,19,29,48
19,8478891,Mason Appleton,C,WPG,28,67,17,31,48
19,8477503,Max Domi,C,TOR,29,80,15,33,48
19,8476462,Dougie Hamilton,D,NJD,31,69,13,35,48
19,8476875,Mike Matheson,D,MTL,30,76,9,39,48
19,8484153,Leo Carlsson,C,ANA,20,74,27,20,47
19,8477998,Warren Foegele,L,LAK,28,80,25,22,47
19,8475768,Jaden Schwartz,C,SEA,32,69,21,26,47
19,8481533,Trevor Zegras,C,ANA,23,75,21,26,47
19,8479339,Patrik Laine,L,CBJ,26,67,19,28,47
19,8482665,Matty Beniers,C,SEA,22,70,18,29,47
19,8484166,Adam Fantilli,C,CBJ,20,69,18,29,47
19,8478462,Nicolas Roy,C,VGK,27,73,16,31,47
19,8477495,Seth Jones,D,CHI,30,68,16,31,47
19,8479400,Pierre-Luc Dubois,L,WSH,26,71,15,32,47
19,8475753,Justin Faulk,D,STL,32,77,15,32,47
19,8476458,Ryan Strome,C,ANA,31,73,13,34,47
19,8471724,Kris Letang,D,PIT,37,79,11,36,47
19,8478396,Noah Hanifin,D,VGK,27,62,9,38,47
19,8474565,Alex Pietrangelo,D,VGK,34,63,8,39,47
19,8474641,Adam Henrique,C,EDM,34,73,25,21,46
19,8481604,Pavel Dorofeyev,L,VGK,24,73,23,23,46
19,8483808,Andrei Kuzmenko,L,CGY,28,72,19,27,46
19,8478438,Tommy Novak,C,NSH,27,70,15,31,46
19,8476882,Teuvo Teravainen,C,CHI,30,71,15,31,46
19,8478042,Viktor Arvidsson,L,EDM,31,76,14,32,46
19,8478397,Rasmus Andersson,D,CGY,28,75,11,35,46
19,8477511,Anthony Mantha,R,CGY,30,75,26,19,45
19,8479351,Sam Steel,C,DAL,26,80,20,25,45
19,8477021,Alex Kerfoot,C,UTA,30,77,14,31,45
19,8477932,Aaron Ekblad,D,FLA,28,71,9,36,45
19,8478366,Frank Vatrano,R,ANA,30,75,25,19,44
19,8482667,William Eklund,L,SJS,22,65,25,19,44
19,8477935,Sam Bennett,C,FLA,28,74,24,20,44
19,8483515,Juraj Slafkovsky,L,MTL,20,76,20,24,44
19,8482159,Tyson Foerster,R,PHI,22,74,19,25,44
19,8478856,Conor Garland,R,VAN,28,70,18,26,44
19,8484145,Zach Benson,L,BUF,19,71,17,27,44
19,8481577,Philip Tomasino,C,NSH,23,67,15,29,44
19,8475722,Jason Zucker,L,BUF,32,61,24,19,43
19,8480009,Eeli Tolvanen,R,SEA,25,77,21,22,43
19,8481560,Arthur Kaliyev,R,LAK,23,79,19,24,43
19,8478519,Anthony Cirelli,C,TBL,27,81,18,25,43
19,8482745,Mason McTavish,C,ANA,21,69,17,26,43
19,8479365,Trent Frederic,C,BOS,26,77,17,26,43
19,8482149,Cole Perfetti,C,WPG,22,69,16,27,43
19,8470613,Brent Burns,D,CAR,39,74,12,31,43
19,8476479,Phillip Danault,C,LAK,31,78,11,32,43
19,8476923,Damon Severson,D,CBJ,30,78,11,32,43
19,8481581,Thomas Harley,D,DAL,23,68,9,34,43
19,8477407,Anthony Duclair,L,NYI,29,79,26,16,42
19,8482175,JJ Peterka,R,BUF,22,71,23,19,42
19,8474150,Mikael Backlund,C,CGY,35,77,14,28,42
19,8477497,Sean Monahan,C,CBJ,30,68,13,29,42
19,8477426,Nicholas Paul,L,TBL,29,81,21,20,41
19,8477429,Andrew Copp,C,DET,30,80,19,22,41
19,8478542,Evan Rodrigues,C,FLA,31,78,18,23,41
19,8475760,Nick Bjugstad,C,UTA,32,65,18,23,41
19,8480185,Eetu Luostarinen,C,FLA,26,77,15,26,41
19,8474716,Jared Spurgeon,D,MIN,35,79,11,30,41
19,8476854,Hampus Lindholm,D,BOS,30,65,8,33,41
19,8481542,Moritz Seider,D,DET,23,73,7,34,41
19,8471698,T.J. Oshie,R,WSH,38,65,21,19,40
19,8478020,Michael Amadio,R,OTT,28,75,21,19,40
19,8479992,Michael Rasmussen,C,DET,25,78,19,21,40
19,8478458,John (Jack) Roslovic,C,CAR,27,64,18,22,40
19,8481711,Matias Maccelli,L,UTA,24,74,17,23,40
19,8480849,Barrett Hayton,C,UTA,24,75,16,24,40
19,8476419,Jean-Gabriel Pageau,C,NYI,32,78,11,29,40
19,8477948,Travis Sanheim,D,PHI,28,69,9,31,40
19,8478498,Jake DeBrusk,L,VAN,28,71,19,20,39
19,8475763,Kevin Hayes,R,PIT,32,75,17,22,39
19,8478233,Andrew Mangiapane,L,WSH,28,68,15,24,39
19,8480028,Morgan Frost,C,PHI,25,74,15,24,39
19,8482105,Jake Sanderson,D,OTT,22,79,11,28,39
19,8478055,Gustav Forsling,D,FLA,28,75,8,31,39
19,8475287,Erik Haula,L,NJD,33,74,8,31,39
19,8481546,Cam York,D,PHI,23,73,7,32,39
19,8475764,Cam Fowler,D,ANA,33,73,5,34,39
19,8475169,Evander Kane,L,EDM,33,73,26,12,38
19,8482113,Anton Lundell,C,FLA,23,75,20,18,38
19,8480797,Joel Farabee,L,PHI,24,74,19,19,38
19,8480078,Filip Chytil,C,NYR,25,69,18,20,38
19,8475191,Reilly Smith,R,NYR,33,79,17,21,38
19,8478046,Danton Heinen,L,VAN,29,71,17,21,38
19,8480188,Fabian Zetterlund,L,SJS,25,67,16,22,38
19,8480829,Jesperi Kotkaniemi,C,CAR,24,67,14,24,38
19,8478472,Mathieu Joseph,R,STL,27,68,11,27,38
19,8477505,Alexander Wennberg,C,SJS,30,71,11,27,38
19,8478466,Daniel Sprong,R,VAN,27,72,10,28,38
19,8482055,Drew O'Connor,L,PIT,26,68,25,12,37
19,8481582,Nicholas Robertson,L,TOR,23,66,25,12,37
19,8478115,Pierre Engvall,L,NYI,28,77,19,18,37
19,8476981,Josh Anderson,R,MTL,30,72,19,18,37
19,8482146,Luke Evangelista,R,NSH,22,67,16,21,37
19,8480068,Ryan Poehling,C,PHI,25,77,16,21,37
19,8476292,Ondrej Palat,L,NJD,33,72,14,23,37
19,8474053,Logan Couture,C,SJS,35,63,13,24,37
19,8476927,Teddy Blueger,C,VAN,30,67,12,25,37
19,8479345,Jakob Chychrun,D,WSH,26,68,9,28,37
19,8477447,Shea Theodore,D,VGK,29,69,8,29,37
19,8483490,Pavel Mintyukov,D,ANA,21,73,8,29,37
19,8478038,Devon Toews,D,COL,30,65,5,32,37
19,8476979,Erik Gustafsson,D,DET,32,73,3,34,37
19,8483505,Matthew Poitras,C,BOS,20,76,16,20,36
19,8482699,Dylan Guenther,R,UTA,21,76,13,23,36
19,8482097,Jack Quinn,R,BUF,23,61,12,24,36
19,8476792,Torey Krug,D,STL,33,73,10,26,36
19,8477444,Andre Burakovsky,L,SEA,29,68,10,26,36
19,8476869,Brady Skjei,D,NSH,30,75,10,26,36
19,8477346,MacKenzie Weegar,D,CGY,30,74,9,27,36
19,8482712,Oskar Olausson,R,COL,22,73,9,27,36
19,8480434,Sean Durzi,D,UTA,26,63,9,27,36
19,8474563,Drew Doughty,D,LAK,35,65,7,29,36
19,8475799,Nino Niederreiter,R,WPG,32,71,21,14,35
19,8476399,Blake Coleman,C,CGY,33,77,20,15,35
19,8476925,Colton Sissons,C,NSH,31,63,13,22,35
19,8482809,Jackson Blake,R,CAR,21,55,8,27,35
19,8479410,Mikhail Sergachev,D,UTA,26,72,7,28,35
19,8482705,Cole Sillinger,C,CBJ,21,66,18,16,34
19,8482660,Kent Johnson,C,CBJ,22,62,16,18,34
19,8476474,Stefan Noesen,R,NJD,31,63,16,18,34
19,8470621,Corey Perry,R,EDM,39,73,16,18,34
19,8479987,Morgan Geekie,C,BOS,26,79,15,19,34
19,8482092,Ridly Greig,C,OTT,22,75,15,19,34
19,8481656,Aliaksei Protas,C,WSH,23,73,12,22,34
19,8476872,Scott Laughton,C,PHI,30,75,9,25,34
19,8480817,K'Andre Miller,D,NYR,24,74,6,28,34
19,8476432,Boone Jenner,C,CBJ,31,68,17,16,33
19,8479996,Cody Glass,C,NSH,25,60,17,16,33
19,8473422,Nick Foligno,L,CHI,37,51,13,20,33
19,8480855,Jack McBain,C,UTA,24,65,13,20,33
19,8476921,Jordan Martinook,L,CAR,32,66,11,22,33
19,8475149,Marcus Johansson,L,MIN,34,73,8,25,33
19,8476902,Esa Lindell,D,DAL,30,77,7,26,33
19,8476958,Jaccob Slavin,D,CAR,30,76,5,28,33
19,8480145,Neal Pionk,D,WPG,29,71,4,29,33
19,8474149,Evgenii Dadonov,R,DAL,35,79,19,13,32
19,8475848,Brendan Gallagher,R,MTL,32,68,19,13,32
19,8480459,Pius Suter,C,VAN,28,72,16,16,32
19,8478013,Jake Walman,D,SJS,28,74,15,17,32
19,8476461,Sean Couturier,C,PHI,32,66,13,19,32
19,8482702,Logan Stankoven,C,DAL,21,81,12,20,32
19,8476463,Jonas Brodin,D,MIN,31,77,5,27,32
19,8481606,Jordan Spence,D,LAK,23,69,5,27,32
19,8474151,Ryan McDonagh,D,TBL,35,77,3,29,32
19,8478882,Vladislav Gavrikov,D,LAK,29,72,3,29,32
19,8478507,John Marino,D,UTA,27,73,2,30,32
19,8481535,Nils Hoglander,L,VAN,24,65,16,15,31
19,8477987,Ryan Donato,C,CHI,28,54,15,16,31
19,8481523,Kirby Dach,C,MTL,23,65,14,17,31
19,8477425,Miles Wood,L,COL,29,71,14,17,31
19,8477952,Robby Fabbri,C,ANA,28,63,13,18,31
19,8475218,Mattias Ekholm,D,EDM,34,72,12,19,31
19,8482475,Yegor Chinakhov,R,CBJ,23,67,11,20,31
19,8480336,Sean Walker,D,CAR,30,77,10,21,31
19,8476885,Jacob Trouba,D,NYR,30,67,8,23,31
19,8477969,Marcus Pettersson,D,PIT,28,74,5,26,31
19,8477506,Ryan Pulock,D,NYI,30,78,1,30,31
19,8481554,Kaapo Kakko,R,NYR,23,70,18,12,30
19,8475793,Ryan Johansen,C,PHI,32,74,15,15,30
19,8481704,Juuso Parssinen,C,NSH,23,62,15,15,30
19,8482624,Daniil Miromanov,D,CGY,27,67,12,18,30
19,8476826,Yanni Gourde,C,SEA,33,72,11,19,30
19,8483445,Cutter Gauthier,L,ANA,20,63,9,21,30
19,8482133,Thomas Bordeleau,C,SJS,22,62,8,22,30
19,8482122,Brock Faber,D,MIN,22,77,4,26,30
19,8476438,Brandon Saad,L,STL,32,64,16,13,29
19,8478109,Victor Olofsson,L,VGK,29,70,15,14,29
19,8477450,Jason Dickinson,C,CHI,29,59,15,14,29
19,8482125,Alexander Holtz,R,VGK,22,64,15,14,29
19,8480113,Alex Iafallo,L,WPG,31,70,14,15,29
19,8477839,Conor Sheary,L,TBL,32,80,12,17,29
19,8478133,Jake Evans,C,MTL,28,66,11,18,29
19,8482079,Marco Rossi,C,MIN,23,63,11,18,29
19,8477919,Frederick Gaudreau,C,MIN,31,61,10,19,29
19,8478463,Anthony Beauvillier,L,PIT,27,67,9,20,29
19,8481703,Valtteri Puustinen,R,PIT,25,57,8,21,29
19,8476917,Adam Pelech,D,NYI,30,79,8,21,29
19,8478500,Ivan Provorov,D,CBJ,27,79,5,24,29
19,8480246,Nick Perbix,D,TBL,26,74,2,27,29
19,8480893,Kirill Marchenko,R,CBJ,24,64,23,5,28
19,8475714,Calle Jarnkrok,C,TOR,33,74,20,8,28
19,8478508,Yakov Trenin,C,MIN,27,61,14,14,28
19,8479941,Justin Danforth,R,CBJ,31,58,14,14,28
19,8483499,Liam Ohgren,L,MIN,20,53,14,14,28
19,8480813,Joe Veleno,C,DET,24,73,12,16,28
19,8480748,Kiefer Sherwood,L,VAN,29,63,12,16,28
19,8476392,Adam Lowry,C,WPG,31,63,10,18,28
19,8481524,Bowen Byram,D,BUF,23,73,9,19,28
19,8474673,TJ Brodie,D,CHI,34,65,3,25,28
19,8479402,Jake Bean,D,CGY,26,67,2,26,28
19,8476878,Zemgus Girgensons,C,TBL,30,80,17,10,27
19,8477947,Sonny Milano,L,WSH,28,66,13,14,27
19,8479591,Michael Eyssimont,C,TBL,28,79,12,15,27
19,8477498,Darnell Nurse,D,EDM,29,73,9,18,27
19,8481580,Connor McMichael,C,WSH,23,66,9,18,27
19,8475200,Dmitry Orlov,D,CAR,33,76,5,22,27
19,8478043,Sam Lafferty,C,BUF,29,67,16,10,26
19,8474715,Cameron Atkinson,R,TBL,35,80,14,12,26
19,8480762,Eric Robinson,L,CAR,29,57,14,12,26
19,8478413,Jordan Greenway,L,BUF,27,65,13,13,26
19,8484203,Bradly Nadeau,L,CAR,19,58,12,14,26
19,8476469,Joel Armia,R,MTL,31,65,12,14,26
19,8481186,Logan O'Connor,R,COL,28,79,11,15,26
19,8477953,Kasperi Kapanen,R,STL,28,70,11,15,26
19,8482157,Will Cuylle,L,NYR,22,66,10,16,26
19,8479393,Noah Gregor,L,OTT,26,70,9,17,26
19,8480878,Nils Lundkvist,D,DAL,24,74,8,18,26
19,8476312,Josh Manson,D,COL,33,62,6,20,26
19,8476879,Cody Ceci,D,EDM,31,72,4,22,26
19,8481014,Alexander Romanov,D,NYI,24,73,3,23,26
19,8480043,Timothy Liljegren,D,TOR,25,65,2,24,26
19,8476480,Vladislav Namestnikov,C,WPG,32,62,14,11,25
19,8479368,Max Jones,L,BOS,26,64,14,11,25
19,8480220,Noah Cates,L,PHI,25,67,13,12,25
19,8479661,Tanner Jeannot,L,LAK,27,75,12,13,25
19,8475220,Marcus Foligno,L,MIN,33,65,12,13,25
19,8482117,Lukas Reichel,L,CHI,22,56,11,14,25
19,8475343,Nic Dowd,C,WSH,34,64,11,14,25
19,8476889,Radek Faksa,C,STL,30,66,10,15,25
19,8481093,Rafael Harvey-Pinard,L,MTL,25,60,8,17,25
19,8476457,Adam Larsson,D,SEA,32,63,7,18,25
19,8476525,Colin Miller,D,WPG,32,63,6,19,25
19,8479639,Dylan Coghlan,D,WPG,26,64,5,20,25
19,8479398,Samuel Girard,D,COL,26,66,3,22,25
19,8473507,Jeff Petry,D,DET,37,77,3,22,25
19,8475231,Casey Cizikas,C,NYI,33,69,11,13,24
19,8482749,Joshua Roy,R,MTL,21,72,11,13,24
19,8482737,Zack Bolduc,C,STL,21,57,11,13,24
19,8475193,Tomas Tatar,L,NJD,34,68,10,14,24
19,8480802,Ryan McLeod,C,BUF,25,64,10,14,24
19,8479982,Conor Timmins,D,TOR,26,59,10,14,24
19,8479976,Juuso Valimaki,D,UTA,26,58,6,18,24
19,8480049,Dylan Samberg,D,WPG,25,69,6,18,24
19,8476331,Dylan DeMelo,D,WPG,31,62,3,21,24
19,8478452,Caleb Jones,D,LAK,27,59,3,21,24
19,8480289,Morgan Barron,C,WPG,26,55,14,9,23
19,8483524,Shane Wright,C,SEA,20,64,11,12,23
19,8480003,Jesper Boqvist,C,FLA,26,70,10,13,23
19,8480995,Pontus Holmberg,R,TOR,25,62,10,13,23
19,8480806,Isac Lundestrom,C,ANA,25,61,9,14,23
19,8480144,David Kampf,C,TOR,29,68,7,16,23
19,8481568,Alex Vlasic,D,CHI,23,61,6,17,23
19,8482111,Justin Barron,D,MTL,23,62,5,18,23
19,8479026,Philippe Myers,D,TOR,27,60,5,18,23
19,8482671,Owen Power,D,BUF,22,64,4,19,23
19,8475171,Oliver Ekman-Larsson,D,TOR,33,70,3,20,23
19,8474574,Tyler Myers,D,VAN,34,66,3,20,23
19,8480891,Michael Kesselring,D,UTA,24,56,3,20,23
19,8481601,Simon Holmstrom,R,NYI,23,68,14,8,22
19,8473563,Nicklas Backstrom,C,WSH,37,48,11,11,22
19,8480835,Jack Drury,C,CAR,24,51,10,12,22
19,8479353,Brett Howden,C,VGK,26,64,8,14,22
19,8479414,Nathan Bastian,R,NJD,27,65,6,16,22
19,8479324,Ryan Lindgren,D,NYR,26,56,6,16,22
19,8481019,David Gustafsson,C,WPG,24,48,6,16,22
19,8481059,Scott Perunovich,D,STL,26,62,5,17,22
19,8478136,Jake Middleton,D,MIN,28,73,3,19,22
19,8477392,Hudson Fasching,R,NYI,29,60,13,8,21
19,8481624,Ilya Mikheyev,R,CHI,30,64,11,10,21
19,8477507,Nikita Zadorov,D,BOS,29,75,11,10,21
19,8480355,Mark Kastelic,C,BOS,25,57,11,10,21
19,8482679,Matt Coronato,R,CGY,22,58,10,11,21
19,8476897,Oskar Sundqvist,C,STL,30,70,9,12,21
19,8478434,Keegan Kolesar,R,VGK,27,63,8,13,21
19,8482245,Artem Zub,D,OTT,29,70,8,13,21
19,8478432,Christian Fischer,R,DET,27,69,7,14,21
19,8478911,Matt Roy,D,WSH,29,58,6,15,21
19,8482142,Jamie Drysdale,D,PHI,22,59,6,15,21
19,8481441,Joe Snively,C,DET,28,69,5,16,21
19,8480873,Rasmus Sandin,D,WSH,24,58,4,17,21
19,8476467,Jamie Oleksiak,D,SEA,32,68,3,18,21
19,8479998,Mikey Anderson,D,LAK,25,62,3,18,21
19,8476931,Jake McCabe,D,TOR,31,64,2,19,21
19,8477903,Garnet Hathaway,R,PHI,33,69,14,6,20
19,8481599,Victor Soderstrom,D,UTA,23,49,11,9,20
19,8483482,Tristan Luneau,D,ANA,20,62,10,10,20
19,8481481,Blake Lizotte,C,PIT,27,64,9,11,20
19,8477446,Michael McCarron,R,NSH,29,58,9,11,20
19,8482074,Connor Zary,C,CGY,23,62,7,13,20
19,8481553,Bobby Brink,R,PHI,23,60,7,13,20
19,8477508,Curtis Lazar,C,NJD,29,57,5,15,20
19,8480025,MacKenzie Entwistle,R,FLA,25,65,4,16,20
19,8475181,Nick Leddy,D,STL,33,61,0,20,20
19,8482089,Jake Neighbours,L,STL,22,63,13,6,19
19,8477478,William Carrier,L,CAR,30,52,13,6,19
19,8479293,Brandon Tanev,L,SEA,33,60,10,9,19
19,8479370,Tyson Jost,C,CAR,26,55,10,9,19
19,8483491,Ivan Miroshnichenko,L,WSH,20,56,9,10,19
19,8480205,Emil Bemstrom,C,PIT,25,52,9,10,19
19,8476278,Colin Blackwell,C,DAL,31,74,9,10,19
19,8483493,Frank Nazar,C,CHI,20,45,9,10,19
19,8480871,Adam Boqvist,D,FLA,24,60,7,12,19
19,8482101,Danil Gushchin,L,SJS,22,60,5,14,19
19,8477220,Nate Schmidt,D,FLA,33,68,3,16,19
19,8479983,Mario Ferraro,D,SJS,26,70,3,16,19
19,8478859,Niko Mikkola,D,FLA,28,57,3,16,19
19,8475324,Nick Jensen,D,OTT,34,64,3,16,19
19,8476429,Scott Mayfield,D,NYI,32,76,3,16,19
19,8478851,Alexandre Carrier,D,NSH,28,69,2,17,19
19,8478569,Noel Acciari,C,PIT,33,50,11,7,18
19,8481032,Paul Cotter,C,NJD,25,59,10,8,18
19,8481641,Joel Kiviranta,L,COL,28,75,10,8,18
19,8476918,Jimmy Vesey,L,NYR,31,65,9,9,18
19,8474189,Lars Eller,C,PIT,35,62,8,10,18
19,8481522,Peyton Krebs,C,BUF,23,58,8,10,18
19,8480789,Oliver Wahlstrom,R,NYI,24,72,7,11,18
19,8477979,Nicolas Aube-Kubel,R,BUF,28,56,6,12,18
19,8482166,Shakir Mukhamadullin,D,SJS,22,55,6,12,18
19,8482655,Janis Moser,D,TBL,24,75,4,14,18
19,8482073,Braden Schneider,D,NYR,23,70,4,14,18
19,8480035,Henri Jokiharju,D,BUF,25,59,4,14,18
19,8480727,Zach Whitecloud,D,VGK,28,53,4,14,18
19,8480950,Ilya Lyubushkin,D,DAL,30,60,3,15,18
19,8479315,Joey Anderson,R,CHI,26,54,2,16,18
19,8476892,Colton Parayko,D,STL,31,71,2,16,18
19,8481518,Nolan Foote,L,NJD,24,45,12,5,17
19,8478421,A.J. Greer,L,FLA,28,52,11,6,17
19,8479359,Beck Malenstyn,L,BUF,26,41,11,6,17
19,8482077,Dylan Holloway,L,EDM,23,51,10,7,17
19,8476822,Luke Glendening,C,TBL,35,77,9,8,17
19,8473453,Trevor Lewis,C,LAK,37,73,9,8,17
19,8477353,Tyler Motte,C,DET,29,70,8,9,17
19,8479520,Brandon Duhaime,R,WSH,27,52,8,9,17
19,8481517,Brett Leason,R,ANA,25,53,7,10,17
19,8480073,Erik Brannstrom,D,COL,25,69,6,11,17
19,8483468,Jiri Kulich,C,BUF,20,57,6,11,17
19,8482803,Olen Zellweger,D,ANA,21,60,6,11,17
19,8482067,Connor Mackey,D,NYR,28,58,5,12,17
19,8475791,Taylor Hall,L,CHI,33,52,5,12,17
19,8473533,Jordan Staal,C,CAR,36,63,5,12,17
19,8477488,Brett Pesce,D,NJD,30,60,4,13,17
19,8482176,Wyatt Kaiser,D,CHI,22,56,4,13,17
19,8470600,Ryan Suter,D,STL,39,67,4,13,17
19,8476624,Barclay Goodrow,C,SJS,31,55,4,13,17
19,8480157,Calle Rosen,D,COL,30,48,4,13,17
19,8478057,Dakota Joshua,C,VAN,28,66,3,14,17
19,8478178,Darren Raddysh,D,TBL,28,72,3,14,17
19,8479369,Andrew Peeke,D,BOS,26,60,3,14,17
19,8478399,Jonas Siegenthaler,D,NJD,27,61,3,14,17
19,8482087,Kaiden Guhle,D,MTL,22,72,1,16,17
19,8478443,Brandon Carlo,D,BOS,28,63,1,16,17
19,8482155,Alex Laferriere,R,LAK,23,67,10,6,16
19,8482259,Bobby McMann,C,TOR,28,65,10,6,16
19,8480448,Parker Kelly,L,COL,25,75,10,6,16
19,8476374,Sean Kuraly,C,CBJ,31,52,8,8,16
19,8483495,Simon Nemec,D,NJD,20,56,6,10,16
19,8481521,Ronnie Attard,D,PHI,25,58,6,10,16
19,8477380,Jonny Brodzinski,C,NYR,31,60,6,10,16
19,8475790,Erik Gudbranson,D,CBJ,32,79,5,11,16
19,8481550,Adam Beckman,L,NJD,23,39,5,11,16
19,8481161,Jake Christiansen,D,CBJ,25,56,5,11,16
19,8475279,Ben Chiarot,D,DET,33,65,5,11,16
19,8476988,Matt Benning,D,SJS,30,65,4,12,16
19,8478970,Jalen Chatfield,D,CAR,28,65,3,13,16
19,8475208,Brian Dumoulin,D,ANA,33,70,3,13,16
19,8480001,Urho Vaakanainen,D,ANA,25,58,3,13,16
19,8474090,Brendan Smith,D,DAL,35,57,2,14,16
19,8483466,Kevin Korchinski,D,CHI,20,48,2,14,16
19,8475233,David Savard,D,MTL,34,56,1,15,16
19,8475690,Chris Tanev,D,TOR,35,59,0,16,16
19,8478831,Kevin Stenlund,C,UTA,28,51,10,5,15
19,8475855,Jesper Fast,R,CAR,33,64,9,6,15
19,8482807,Ethan Del Mastro,D,CHI,21,48,9,6,15
19,8480281,Alexey Toropchenko,R,STL,25,51,8,7,15
19,8479439,Jacob MacDonald,D,COL,31,43,8,7,15
19,8479718,Alex Barré-Boulet,C,MTL,27,52,8,7,15
19,8479619,Michael Carcone,L,UTA,28,62,7,8,15
19,8474034,Patrick Maroon,L,CHI,36,49,7,8,15
19,8483565,Nick Blankenburg,D,NSH,26,62,6,9,15
19,8482062,Cole Smith,L,NSH,29,49,6,9,15
19,8479390,Taylor Raddysh,R,WSH,26,54,5,10,15
19,8477989,Christian Dvorak,C,MTL,28,65,5,10,15
19,8475462,Radko Gudas,D,ANA,34,63,4,11,15
19,8481751,Lukas Rousek,R,BUF,25,43,4,11,15
19,8480860,Kevin Bahl,D,CGY,24,61,3,12,15
19,8481013,Jonatan Berggren,R,DET,24,61,3,12,15
19,8480222,Sebastian Aho,D,PIT,28,74,2,13,15
19,8477369,Carson Soucy,D,VAN,30,61,2,13,15
19,8479371,Dante Fabbro,D,NSH,26,66,1,14,15
19,8475179,Dmitry Kulikov,D,FLA,34,61,1,14,15
19,8481477,Nico Sturm,C,SJS,29,52,11,3,14
19,8483457,Lane Hutson,D,MTL,20,60,7,7,14
19,8479336,Carl Grundstrom,R,SJS,27,51,7,7,14
19,8480192,Johnathan Kovacevic,D,NJD,27,59,7,7,14
19,8481708,Zac Jones,D,NYR,24,60,6,8,14
19,8482751,Ryan Winterton,C,SEA,21,34,6,8,14
19,8480980,Connor Dewar,C,TOR,25,66,5,9,14
19,8479671,Mathieu Olivier,R,CBJ,27,46,4,10,14
19,8478416,Erik Cernak,D,TBL,27,74,4,10,14
19,8475455,Brenden Dillon,D,NJD,34,59,4,10,14
19,8481167,Brayden Pachal,D,CGY,25,39,4,10,14
19,8476856,Mathew Dumba,D,DAL,30,68,3,11,14
19,8476967,Brett Kulak,D,EDM,30,65,3,11,14
19,8480845,Rasmus Kupari,C,WPG,24,43,3,11,14
19,8479372,Joshua Mahura,D,SEA,26,54,2,12,14
19,8476874,Olli Maatta,D,DET,30,63,1,13,14
19,8476858,Phillip Di Giuseppe,L,VAN,31,41,9,4,13
19,8476960,Andreas Athanasiou,C,CHI,30,56,7,6,13
19,8476994,Vinnie Hinostroza,C,NSH,30,47,7,6,13
19,8477499,Rasmus Ristolainen,D,PHI,30,59,7,6,13
19,8482148,Hendrix Lapierre,C,WSH,22,52,6,7,13
19,8477406,Mattias Janmark,C,EDM,32,59,6,7,13
19,8476934,Brock McGinn,L,ANA,30,55,6,7,13
19,8481527,Kaedan Korczak,D,VGK,23,50,5,8,13
19,8477070,Liam O'Brien,C,UTA,30,55,5,8,13
19,8479543,Michael Pezzetta,L,MTL,26,59,5,8,13
19,8477938,Haydn Fleury,D,WPG,28,41,5,8,13
19,8482192,Isaak Phillips,D,CHI,23,56,4,9,13
19,8480021,Jack Studnicka,C,LAK,25,52,4,9,13
19,8480058,Pierre-Olivier Joseph,D,STL,25,48,4,9,13
19,8482451,Mikael Pyyhtia,L,CBJ,23,43,4,9,13
19,8476441,Joel Edmundson,D,LAK,31,40,4,9,13
19,8477015,Connor Brown,R,EDM,30,61,3,10,13
19,8481537,Nikita Okhotiuk,D,CGY,24,44,3,10,13
19,8481028,Martin Pospisil,C,CGY,25,63,2,11,13
19,8482634,Alex Steeves,C,TOR,25,41,2,11,13
19,8475188,Brayden McNabb,D,VGK,33,54,1,12,13
19,8480807,Mattias Samuelsson,D,BUF,24,48,0,13,13
19,8479066,Ryan Lomberg,L,CGY,30,61,8,4,12
19,8478211,Dryden Hunt,L,CGY,29,52,8,4,12
19,8477887,Patrick Brown,C,BOS,32,41,8,4,12
19,8475842,Sam Carrick,C,NYR,32,59,6,6,12
19,8471817,Ryan Reaves,R,TOR,37,51,6,6,12
19,8479981,Jonah Gadjovich,L,FLA,26,48,6,6,12
19,8479378,Logan Stanley,D,WPG,26,48,6,6,12
19,8475225,Craig Smith,C,CHI,35,48,5,7,12
19,8482652,Walker Duehr,R,CGY,27,38,4,8,12
19,8479986,Kole Lind,R,DAL,26,53,4,8,12
19,8481598,Philip Broberg,D,EDM,23,42,3,9,12
19,8477845,Trevor van Riemsdyk,D,WSH,33,58,2,10,12
19,8476329,Travis Boyd,C,MIN,31,56,2,10,12
19,8479980,Nicolas Hague,D,VGK,26,53,2,10,12
19,8478468,Jeremy Lauzon,D,NSH,27,53,2,10,12
19,8473446,Erik Johnson,D,PHI,36,51,2,10,12
19,8476422,Mike Reilly,D,NYI,31,76,1,11,12
19,8477931,Tomas Nosek,L,FLA,32,56,7,4,11
19,8484149,Gavin Brindley,C,CBJ,20,45,5,6,11
19,8478017,Mark Friedman,D,VAN,29,42,4,7,11
19,8476873,Mark Jankowski,C,NSH,30,55,3,8,11
19,8479344,Jesse Puljujarvi,R,PIT,26,52,3,8,11
19,8476867,Brendan Gaunce,C,MIN,30,30,3,8,11
19,8481600,Tobias Bjornfot,D,FLA,23,46,3,8,11
19,8480172,Jan Rutta,D,SJS,34,63,3,8,11
19,8481178,Egor Zamula,D,PHI,24,54,2,9,11
19,8475718,Justin Holl,D,DET,32,62,2,9,11
19,8474166,Alec Martinez,D,CHI,37,49,1,10,11
19,8478454,Noah Juulsen,D,VAN,27,37,1,10,11
19,8479328,Julien Gauthier,R,NYI,27,63,7,3,10
19,8481754,Nikita Nesterenko,C,ANA,23,30,7,3,10
19,8481716,Dmitri Voronkov,L,CBJ,24,50,6,4,10
19,8480796,Martin Fehervary,D,WSH,25,63,4,6,10
19,8482784,Zach Dean,C,STL,21,50,4,6,10
19,8480011,Klim Kostin,C,SJS,25,49,3,7,10
19,8481679,Maxence Guenette,D,OTT,23,33,3,7,10
19,8478451,Ethan Bear,D,WSH,27,43,2,8,10
19,8481532,Alex Turcotte,C,LAK,23,46,2,8,10
19,8474568,Luke Schenn,D,NSH,35,49,2,8,10
19,8481567,Henry Thrun,D,SJS,23,52,2,8,10
19,8477435,Ryan Graves,D,PIT,29,70,1,9,10
19,8476891,Matthew Grzelcyk,D,PIT,30,70,0,10,10
19,8477365,Connor Clifton,D,BUF,29,58,0,10,10
19,8482762,Simon Edvinsson,D,DET,21,56,8,1,9
19,8480074,Alexandre Texier,C,STL,25,55,6,3,9
19,8479316,Luke Kunin,C,SJS,27,55,4,5,9
19,8482747,Brennan Othmann,L,NYR,21,42,4,5,9
19,8476442,Matt Nieto,L,PIT,32,47,4,5,9
19,8480848,Ty Dellandrea,C,SJS,24,45,4,5,9
19,8477573,Nathan Walker,L,STL,30,45,4,5,9
19,8482095,Tyler Kleven,D,OTT,22,44,4,5,9
19,8478840,Will Borgen,D,SEA,28,57,0,9,9
19,8471709,Marc-Edouard Vlasic,D,SJS,37,55,0,9,9
19,8480070,Ian Mitchell,D,BOS,25,42,0,9,9
19,8480880,Jakub Lauko,C,MIN,24,34,6,2,8
19,8483570,Ben Meyers,C,SEA,26,30,6,2,8
19,8482730,Brandt Clarke,D,LAK,21,54,5,3,8
19,8477401,John Hayden,C,SEA,29,34,5,3,8
19,8482145,Mavrik Bourque,C,DAL,22,45,5,3,8
19,8482744,James Malatesta,L,CBJ,21,39,4,4,8
19,8480007,Jonas Rondbjerg,R,VGK,25,44,4,4,8
19,8479968,Vinni Lettieri,C,BOS,29,43,3,5,8
19,8483460,David Jiricek,D,CBJ,21,59,3,5,8
19,8471677,Jack Johnson,D,CBJ,37,61,3,5,8
19,8481617,Vasily Podkolzin,R,VAN,23,48,2,6,8
19,8480292,Carson Meyer,R,ANA,27,38,2,6,8
19,8479536,Axel Jonsson-Fjallby,L,WPG,26,35,2,6,8
19,8479944,Zach Aston-Reese,C,VGK,30,50,2,6,8
19,8476952,Dominic Toninato,C,WPG,30,30,2,6,8
19,8475762,Derek Forbort,D,VAN,32,44,2,6,8
19,8481122,Simon Benoit,D,TOR,26,35,2,6,8
19,8482733,Logan Mailloux,D,MTL,31,39,2,6,8
19,8474567,Zach Bogosian,D,MIN,34,55,1,7,8
19,8480887,Jordan Harris,D,MTL,24,53,1,7,8
19,8482861,Vincent Iorio,D,WSH,22,33,1,7,8
19,8479442,Troy Stecher,D,EDM,30,48,0,8,8
19,8481789,Tye Kartye,L,SEA,23,41,7,0,7
19,8480851,Akil Thomas,C,LAK,24,21,5,2,7
19,8479379,Givani Smith,R,SJS,26,30,4,3,7
19,8481543,Nikita Alexandrov,C,STL,24,27,4,3,7
19,8480441,Trey Fix-Wolansky,R,CBJ,25,38,3,4,7
19,8480879,Jacob Bernard-Docker,D,OTT,24,52,3,4,7
19,8478424,Jansen Harkins,C,ANA,27,37,3,4,7
19,8477962,Brendan Lemieux,L,CAR,28,39,3,4,7
19,8482713,Mackie Samoskevich,R,FLA,22,32,3,4,7
19,8482659,Josh Doan,R,UTA,22,48,3,4,7
19,8482666,Scott Morrow,D,CAR,22,47,3,4,7
19,8477482,Zachary Sanford,L,CHI,30,37,3,4,7
19,8474013,Ian Cole,D,UTA,35,49,2,5,7
19,8475958,Michael Sgarbossa,C,WSH,32,23,2,5,7
19,8478409,Anthony Richard,C,PHI,28,28,2,5,7
19,8480874,Adam Ginning,D,PHI,24,20,2,5,7
19,8477018,Ben Hutton,D,VGK,31,44,1,6,7
19,8481592,Jakob Pelletier,L,CGY,23,42,1,6,7
19,8484911,Collin Graf,R,SJS,22,41,1,6,7
19,8482470,Ilya Solovyov,D,CGY,24,16,1,6,7
19,8480252,Cole Guttman,C,CHI,25,33,4,2,6
19,8479320,Maxime Lajoie,D,SEA,27,31,4,2,6
19,8477384,Joshua Brown,D,EDM,30,45,4,2,6
19,8481609,Vladislav Kolyachonok,D,UTA,23,36,3,3,6
19,8482144,Jack Thompson,D,SJS,22,26,3,3,6
19,8474612,Travis Hamonic,D,OTT,34,48,2,4,6
19,8479972,Mason Shaw,C,WPG,26,33,2,4,6
19,8480196,Jacob Bryson,D,BUF,27,42,2,4,6
19,8476372,Nick Seeler,D,PHI,31,39,2,4,6
19,8482511,Mason Lohrei,D,BOS,23,35,2,4,6
19,8484287,Cole McWard,D,VAN,23,31,2,4,6
19,8482177,Marat Khusnutdinov,C,MIN,22,36,2,4,6
19,8482964,Arber Xhekaj,D,MTL,23,46,1,5,6
19,8475750,Jon Merrill,D,MIN,32,65,1,5,6
19,8477034,Jaycob Megna,D,FLA,32,46,1,5,6
19,8483763,Maksymilian Szuber,D,UTA,22,34,1,5,6
19,8479587,Rhett Gardner,C,PHI,28,17,1,5,6
19,8479249,Andrew Poturalski,C,SJS,30,33,0,6,6
19,8482153,Brendan Brisson,C,VGK,23,39,0,6,6
19,8477527,Ross Johnston,L,ANA,30,28,0,6,6
19,8483619,Filip Roos,D,OTT,25,29,0,6,6
19,8478502,Dennis Gilbert,D,BUF,28,20,0,6,6
19,8479994,Jaret Anderson-Dolan,C,WPG,25,34,4,1,5
19,8479638,Justin Brazeau,R,BOS,26,34,4,1,5
19,8475235,Nicolas Deslauriers,L,PHI,33,46,3,2,5
19,8478585,Derek Ryan,C,EDM,38,61,2,3,5
19,8482765,Isak Rosen,R,BUF,21,24,2,3,5
19,8482859,Zack Ostapchuk,C,OTT,21,50,2,3,5
19,8483012,Logan Morrison,C,SEA,22,38,2,3,5
19,8484254,Akito Hirose,D,VAN,25,31,2,3,5
19,8480890,Jan Jenik,C,OTT,24,26,2,3,5
19,8479291,Kevin Rooney,C,CGY,31,53,1,4,5
19,8478146,Matthew Highmore,C,OTT,28,37,1,4,5
19,8477335,Kyle Burroughs,D,LAK,29,41,1,4,5
19,8479348,Kale Clague,D,BUF,26,46,1,4,5
19,8482070,Mitchell Chaffee,R,TBL,26,38,3,1,4
19,8480834,Ty Emberson,D,SJS,24,32,3,1,4
19,8478881,Brett Seney,L,CHI,28,13,3,1,4
19,8484325,Waltteri Merela,C,TBL,26,22,3,1,4
19,8477462,Robert Hagg,D,VGK,29,26,3,1,4
19,8476913,Devin Shore,C,MIN,30,31,2,2,4
19,8484258,Sam Malinski,D,COL,26,26,2,2,4
19,8478874,Adam Gaudette,R,OTT,28,34,2,2,4
19,8475177,Calvin de Haan,D,COL,33,38,2,2,4
19,8479985,Cale Fleury,D,SEA,26,34,2,2,4
19,8481422,Jake Lucchini,C,NSH,29,21,2,2,4
19,8479419,Brett Murray,L,BUF,26,17,2,2,4
19,8480245,Olle Lycksell,R,PHI,25,32,1,3,4
19,8480468,James Hamblin,L,EDM,25,23,1,3,4
19,8482858,Ryker Evans,D,SEA,23,19,1,3,4
19,8478477,Mitchell Stephens,C,SEA,27,22,1,3,4
19,8479367,William Lockwood,R,FLA,26,30,1,3,4
19,8479330,Brandon Gignac,C,MTL,27,15,1,3,4
19,8482496,Nils Aman,C,VAN,24,42,0,4,4
19,8477971,Andreas Englund,D,LAK,28,25,0,4,4
19,8477244,Chad Ruhwedel,D,NYR,34,23,0,4,4
19,8481605,Jackson LaCombe,D,ANA,23,33,0,4,4
19,8481556,John Beecher,C,BOS,23,36,3,0,3
19,8482162,Roby Jarventie,L,EDM,22,14,3,0,3
19,8476473,Connor Murphy,D,CHI,31,31,2,1,3
19,8482147,Jean-Luc Foudy,C,COL,22,25,2,1,3
19,8481030,Jack St. Ivany,D,PIT,25,24,2,1,3
19,8482201,Gage Goncalves,C,TBL,23,39,2,1,3
19,8481701,Santeri Hatakka,D,NJD,23,37,1,2,3
19,8482141,Lukas Cormier,D,VGK,22,18,1,2,3
19,8479576,Vincent Desharnais,D,VAN,28,31,1,2,3
19,8477810,Joel Hanley,D,CGY,33,28,1,2,3
19,8483630,Pavol Regenda,L,ANA,25,25,1,2,3
19,8481056,Spencer Stastney,D,NSH,24,20,1,2,3
19,8480844,Grigori Denisenko,L,VGK,24,28,1,2,3
19,8482172,Landon Slaggert,L,CHI,22,27,1,2,3
19,8481743,Marc Del Gaizo,D,NSH,25,21,1,2,3
19,8481593,Jayden Struble,D,MTL,23,28,1,2,3
19,8483489,Fraser Minten,C,TOR,31,14,1,2,3
19,8478011,Louie Belpedio,D,PHI,28,5,0,3,3
19,8483549,Lucas Condotta,L,MTL,27,26,0,3,3
19,8482250,Callahan Burke,C,VGK,27,23,0,3,3
19,8480823,Alexander Alexeyev,D,WSH,25,17,0,3,3
19,8480870,Bo Groulx,C,NYR,24,28,2,0,2
19,8481147,Reese Johnson,C,MIN,26,31,1,1,2
19,8479772,Zack MacEwen,R,OTT,28,58,1,1,2
19,8480267,Sammy Walker,C,MIN,25,24,1,1,2
19,8482165,Yan Kuznetsov,D,CGY,22,21,1,1,2
19,8481541,Samuel Bolduc,D,NYI,24,25,1,1,2
19,8481585,Egor Afanasyev,L,SJS,23,13,1,1,2
19,8483407,Brandon Scanlin,D,NYR,25,7,1,1,2
19,8481206,John Ludvig,D,PIT,24,11,1,1,2
19,8477851,Jordan Oesterle,D,BOS,32,36,0,2,2
19,8480990,Declan Chisholm,D,MIN,24,40,0,2,2
19,8478450,Parker Wotherspoon,D,BOS,27,38,0,2,2
19,8479991,Jake Leschyshyn,C,NYR,25,26,0,2,2
19,8483397,Marc McLaughlin,C,BOS,25,32,0,2,2
19,8479362,Riley Tufte,L,BOS,26,28,0,2,2
19,8481006,Tyler Tucker,D,STL,24,18,0,2,2
19,8482516,Matthew Kessel,D,STL,24,15,0,2,2
19,8482929,Emil Lilleberg,D,TBL,23,21,0,2,2
19,8483920,Pierrick Dube,R,WSH,23,8,0,2,2
19,8480084,Nick DeSimone,D,NJD,30,18,0,2,2
19,8477149,Scott Sabourin,R,SJS,32,14,0,2,2
19,8481719,Maxwell Crozier,D,TBL,24,10,1,0,1
19,8481462,Mason Morelli,L,VGK,28,11,1,0,1
19,8481726,Adam Edstrom,C,NYR,24,5,1,0,1
19,8483512,Matthew Savoie,C,EDM,20,21,1,0,1
19,8478051,Max Willman,C,NJD,29,18,0,1,1
19,8475413,Justin Dowling,C,NJD,34,10,0,1,1
19,8481237,Kyle MacLean,C,NYI,25,20,0,1,1
19,8477473,Justin Bailey,R,SJS,29,24,0,1,1
19,8482061,Brandon Biro,L,SEA,26,6,0,1,1
19,8481065,Angus Crookshank,L,OTT,25,14,0,1,1
19,8483471,Brad Lambert,C,WPG,31,15,0,1,1
19,8482094,Daemon Hunt,D,MIN,22,13,0,1,1
19,8479421,Jacob Moverare,D,LAK,26,5,0,1,1
19,8484304,Uvis Balinskis,D,FLA,28,8,0,1,1
19,8483398,Declan Carlile,D,TBL,31,11,0,1,1
19,8474062,Riley Nash,C,NYR,35,13,0,1,1
19,8480032,Shane Bowers,C,NJD,25,17,0,1,1
19,8481806,Louis Crevier,D,CHI,23,10,0,1,1
19,8482102,Vasily Ponomarev,C,PIT,22,19,0,1,1
19,8483546,Marshall Rifai,D,TOR,26,2,0,1,1
19,8477320,Anton Blidh,L,NYR,29,12,0,1,1
19,8479522,Hardy Haman Aktell,D,WSH,26,4,0,1,1
19,8478021,William Lagesson,D,DET,28,23,0,0,0
19,8477073,Kurtis MacDermid,L,NJD,30,29,0,0,0
19,8475795,Dylan McIlrath,D,WSH,32,17,0,0,0
19,8482118,Sam Colangelo,R,ANA,23,11,0,0,0
19,8477467,Gustav Olofsson,D,SEA,30,22,0,0,0
19,8483395,Arshdeep Bains,L,VAN,23,8,0,0,0
19,8477541,Dakota Mermis,D,TOR,30,8,0,0,0
19,8481578,Graeme Clarke,R,MIN,23,6,0,0,0
19,8482460,Matt Rempe,C,NYR,22,10,0,0,0
19,8480075,Cameron Crotty,D,MIN,25,13,0,0,0
19,8481043,Cole Koepke,L,BOS,26,14,0,0,0
19,8481699,Aku Raty,R,UTA,23,11,0,0,0
19,8475755,Alexander Petrovic,D,DAL,32,10,0,0,0
19,8482476,Emil Heineman,L,MTL,23,4,0,0,0
19,8475780,Chris Wagner,R,COL,33,14,0,0,0
19,8482088,Justin Sourdif,R,FLA,22,15,0,0,0
19,8483567,Georgii Merkulov,C,BOS,24,8,0,0,0
19,8478446,Glenn Gawdin,C,LAK,27,9,0,0,0
19,8481024,Linus Karlsson,C,VAN,25,6,0,0,0
19,8482126,Emil Andrae,D,PHI,31,5,0,0,0
19,8478854,Ryan Shea,D,PIT,27,10,0,0,0
19,8482197,Adam Raska,R,MIN,23,8,0,0,0
19,8483597,Milos Kelemen,L,UTA,25,14,0,0,0
19,8481564,Ryan Johnson,D,BUF,23,12,0,0,0
19,8484255,Jason Polin,R,COL,25,5,0,0,0
19,8477993,Justin Kirkland,C,CGY,28,10,0,0,0
19,8481534,Raphael Lavoie,C,EDM,24,3,0,0,0
19,8480306,Grant Hutton,D,NYI,29,5,0,0,0
19,8482787,Nikita Chibrikov,R,WPG,31,5,0,0,0
19,8483432,Luca Del Bel Belluz,C,CBJ,31,8,0,0,0
19,8476323,Max McCormick,L,SEA,32,2,0,0,0
19,8483401,Marc Johnstone,R,PIT,28,2,0,0,0
19,8481655,Cole Schwindt,R,CGY,23,7,0,0,0
19,8483531,Brian Halonen,L,NJD,25,0,0,0,0
19,8483609,Adam Klapka,R,CGY,24,1,0,0,0
19,8484259,Ondrej Pavel,C,COL,31,3,0,0,0
19,8484321,Nikolas Matinpalo,D,OTT,26,2,0,0,0
19,8484326,Patrik Koch,D,UTA,28,2,0,0,0
19,8478147,Bokondji Imama,L,PIT,28,4,0,0,0
19,8470794,Joe Pavelski,C,,40,0,0,0,0
19,8479321,Lucas Johansen,D,,27,0,0,0,0
19,8477950,Tony DeAngelo,D,,29,0,0,0,0
19,8471218,Blake Wheeler,R,,38,0,0,0,0
19,8475197,Tyson Barrie,D,,33,0,0,0,0
19,8474157,Max Pacioretty,L,,36,0,0,0,0
19,8475744,Evgeny Kuznetsov,C,,32,0,0,0,0
19,8474037,James van Riemsdyk,L,,35,0,0,0,0
19,8476907,Mackenzie MacEachern,L,,30,0,0,0,0
19,8480216,Jacob Peterson,C,,25,0,0,0,0
19,8474602,Justin Schultz,D,,34,0,0,0,0
19,8482222,Alexander Barabanov,L,,30,0,0,0,0
19,8474031,Kevin Shattenkirk,D,,35,0,0,0,0
19,8477330,Dominik Kubalik,L,,29,0,0,0,0
19,8480884,Calen Addison,D,,24,0,0,0,0
19,8475906,John Klingberg,D,,32,0,0,0,0
19,8480008,Adam Ruzicka,C,,25,0,0,0,0
19,8476884,Derrick Pouliot,D,,30,0,0,0,0
19,8476919,Chris Tierney,C,,30,0,0,0,0
19,8479415,Michael McLeod,C,,26,0,0,0,0
19,8474870,Tyler Johnson,C,,34,0,0,0,0
19,8470604,Jeff Carter,C,,39,0,0,0,0
19,8478104,Sammy Blais,L,,28,0,0,0,0
19,8474884,Mike Hoffman,C,,35,0,0,0,0
19,8481591,Sam Poulin,R,,23,0,0,0,0
19,8471274,Alex Goligoski,D,,39,0,0,0,0
19,8476871,Tanner Pearson,L,,32,0,0,0,0
19,8476393,Nick Cousins,C,,31,0,0,0,0
19,8479977,Kailer Yamamoto,R,,26,0,0,0,0
19,8479346,Dillon Dube,C,,26,0,0,0,0
19,8480184,Gustav Lindstrom,D,,26,0,0,0,0
19,8479376,Victor Mete,D,,26,0,0,0,0
19,8473449,Kyle Okposo,R,,36,0,0,0,0
19,8481058,Jesse Ylonen,R,,25,0,0,0,0
19,8475752,Tyler Pitlick,C,,33,0,0,0,0
19,8481239,Samuel Fagemo,L,,24,0,0,0,0
19,8480821,Filip Zadina,R,,25,0,0,0,0
19,8470966,Mark Giordano,D,,41,0,0,0,0
19,8478495,Denis Gurianov,R,,27,0,0,0,0
19,8477464,Nic Petan,C,,29,0,0,0,0
19,8478099,Kevin Labanc,R,,29,0,0,0,0
19,8482241,Radim Zohorna,L,,28,0,0,0,0
19,8474040,Sam Gagner,C,,35,0,0,0,0
19,8479514,Rem Pitlick,C,,27,0,0,0,0
19,8478430,Oliver Kylington,D,,27,0,0,0,0
19,8479533,Joona Koppanen,L,,26,0,0,0,0
19,8479984,Cal Foote,D,,26,0,0,0,0
19,8477126,Jayson Megna,C,,34,0,0,0,0
19,8475164,Jakob Silfverberg,R,,34,0,0,0,0
19,8474009,Nick Bonino,C,,36,0,0,0,0
19,8479458,Nikita Zaitsev,D,,33,0,0,0,0
19,8477944,Jakub Vrana,L,,28,0,0,0,0
19,8471699,Andrew Cogliano,C,,37,0,0,0,0
19,8478067,Oskar Lindblom,L,,28,0,0,0,0
19,8471686,Marc Staal,D,,37,0,0,0,0
19,8470610,Zach Parise,L,,40,0,0,0,0
19,8478904,Steven Lorentz,C,,28,0,0,0,0
19,8473473,Milan Lucic,L,,36,0,0,0,0
19,8480031,Maxime Comtois,L,,25,0,0,0,0
19,8478512,Austin Czarnik,C,,32,0,0,0,0
19,8473504,Cal Clutterbuck,R,,37,0,0,0,0
19,8477454,Adam Erne,L,,29,0,0,0,0
19,8479383,Boris Katchouk,L,,26,0,0,0,0
19,8475825,Jani Hakanpää,D,,32,0,0,0,0
19,8477846,Ryan Carpenter,C,,33,0,0,0,0
19,8477930,Pierre-Edouard Bellemare,L,,39,0,0,0,0
19,8478400,Colin White,C,,27,0,0,0,0
19,8480226,Marián Studenic,R,,26,0,0,0,0
19,8480853,Liam Foudy,C,,24,0,0,0,0
19,8475797,Jarred Tinordi,D,,32,0,0,0,0
19,8479423,Alex Nylander,L,,26,0,0,0,0
19,8474618,Marco Scandella,D,,34,0,0,0,0
19,8478028,Fredrik Olofsson,L,,28,0,0,0,0
19,8474709,Matt Martin,L,,35,0,0,0,0
19,8481070,Hugh McGing,L,,26,0,0,0,0
19,8479546,Oskar Steen,C,,26,0,0,0,0
19,8474145,Robert Bortuzzo,D,,35,0,0,0,0
19,8476915,Jujhar Khaira,L,,30,0,0,0,0
19,8480274,Philip Kemp,D,EDM,25,1,0,0,0
19,8475278,Byron Froese,C,,33,0,0,0,0
19,8481812,Nikolai Knyzhov,D,,27,0,0,0,0
19,8478408,Travis Dermott,D,,28,0,0,0,0
19,8481077,John Leonard,L,,26,0,0,0,0
19,8479547,Matthew Phillips,R,,26,0,0,0,0
19,8480836,Jonathan Gruden,C,,24,0,0,0,0
19,8481690,Tyler Angle,C,,24,0,0,0,0
19,8475766,Austin Watson,L,,32,0,0,0,0
19,8481016,Ruslan Iskhakov,C,,24,0,0,0,0
19,8478078,Rourke Chartier,C,,28,0,0,0,0
19,8480776,Sheldon Rempal,R,,29,0,0,0,0
19,8478956,Samuel Laberge,L,NJD,27,0,0,0,0
19,8483045,Cameron Butler,R,CBJ,31,1,0,0,0
19,8484314,Jiri Smejkal,L,,28,0,0,0,0
20,8478402,Connor McDavid,C,EDM,27,79,40,96,136
20,8476453,Nikita Kucherov,R,TBL,31,82,35,92,127
20,8481559,Jack Hughes,C,NJD,23,77,49,77,126
20,8477492,Nathan MacKinnon,C,COL,29,81,53,72,125
20,8478420,Mikko Rantanen,R,COL,28,80,45,71,116
20,8479318,Auston Matthews,C,TOR,27,80,58,50,108
20,8477956,David Pastrnak,R,BOS,28,82,56,51,107
20,8478864,Kirill Kaprizov,L,MIN,27,72,46,59,105
20,8477939,William Nylander,R,TOR,28,80,42,60,102
20,8478483,Mitch Marner,R,TOR,27,77,26,74,100
20,8478403,Jack Eichel,C,VGK,28,78,41,58,99
20,8477942,Kevin Fiala,L,LAK,28,80,40,59,99
20,8477946,Dylan Larkin,C,DET,28,80,49,49,98
20,8478550,Artemi Panarin,L,NYR,33,78,28,70,98
20,8476887,Filip Forsberg,L,NSH,30,75,50,46,96
20,8475166,John Tavares,C,TOR,34,77,43,53,96
20,8479314,Matthew Tkachuk,L,FLA,27,78,24,72,96
20,8475172,Nazem Kadri,C,CGY,34,78,28,67,95
20,8480027,Jason Robertson,L,DAL,25,82,31,63,94
20,8479407,Jesper Bratt,L,NJD,26,75,31,62,93
20,8477934,Leon Draisaitl,C,EDM,29,76,27,65,92
20,8477409,Carter Verhaeghe,C,FLA,29,76,45,46,91
20,8476468,J.T. Miller,C,VAN,31,72,28,63,91
20,8477404,Jake Guentzel,C,TBL,30,82,35,55,90
20,8482116,Tim Stützle,C,OTT,22,79,35,55,90
20,8477493,Aleksander Barkov,C,FLA,29,81,28,62,90
20,8480023,Robert Thomas,C,STL,25,78,18,71,89
20,8480800,Quinn Hughes,D,VAN,25,76,7,81,88
20,8475913,Mark Stone,R,VGK,32,77,39,48,87
20,8478427,Sebastian Aho,C,CAR,27,76,37,50,87
20,8477501,Valeri Nichushkin,R,COL,29,82,40,45,85
20,8482078,Lucas Raymond,L,DET,22,79,28,57,85
20,8477402,Pavel Buchnevich,L,STL,29,77,33,51,84
20,8477933,Sam Reinhart,C,FLA,29,77,41,42,83
20,8481540,Cole Caufield,R,MTL,23,76,37,44,81
20,8478439,Travis Konecny,R,PHI,27,78,24,57,81
20,8480069,Cale Makar,D,COL,26,69,20,61,81
20,8473419,Brad Marchand,L,BOS,36,82,37,43,80
20,8480012,Elias Pettersson,C,VAN,26,77,31,49,80
20,8476456,Jonathan Huberdeau,C,CGY,31,80,19,61,80
20,8475754,Brock Nelson,C,NYI,33,78,39,40,79
20,8478398,Kyle Connor,L,WPG,28,69,38,41,79
20,8481557,Matt Boldy,L,MIN,23,71,26,52,78
20,8474564,Steven Stamkos,C,NSH,34,73,26,52,78
20,8479675,Trevor Moore,L,LAK,29,82,42,35,77
20,8479420,Tage Thompson,C,BUF,27,71,36,41,77
20,8479337,Alex DeBrincat,R,DET,27,80,32,45,77
20,8478445,Mathew Barzal,C,NYI,27,79,22,54,76
20,8478449,Roope Hintz,C,DAL,28,82,41,33,74
20,8471675,Sidney Crosby,C,PIT,37,71,39,35,74
20,8476459,Mika Zibanejad,C,NYR,31,80,34,40,74
20,8476399,Blake Coleman,C,CGY,33,78,34,40,74
20,8475170,Brayden Schenn,C,STL,33,73,30,44,74
20,8480801,Brady Tkachuk,L,OTT,25,80,29,45,74
20,8484144,Connor Bedard,C,CHI,19,68,28,46,74
20,8480002,Nico Hischier,C,NJD,25,74,28,46,74
20,8482665,Matty Beniers,C,SEA,22,74,27,47,74
20,8477951,Nick Schmaltz,C,UTA,28,77,26,48,74
20,8475692,Mats Zuccarello,R,MIN,37,74,25,49,74
20,8478010,Brayden Point,C,TBL,28,82,36,37,73
20,8471214,Alex Ovechkin,L,WSH,39,74,32,41,73
20,8476460,Mark Scheifele,C,WPG,31,76,28,45,73
20,8475765,Vladimir Tarasenko,R,DET,33,81,23,50,73
20,8480036,Miro Heiskanen,D,DAL,25,78,13,60,73
20,8479343,Clayton Keller,R,UTA,26,72,36,36,72
20,8474600,Roman Josi,D,NSH,34,74,26,46,72
20,8480018,Nick Suzuki,C,MTL,25,78,25,47,72
20,8475726,Tyler Toffoli,C,SJS,32,67,42,29,71
20,8475167,Victor Hedman,D,TBL,34,80,14,57,71
20,8474141,Patrick Kane,R,DET,36,79,23,47,70
20,8476389,Vincent Trocheck,C,NYR,31,77,24,45,69
20,8479385,Jordan Kyrou,C,STL,26,73,31,37,68
20,8480830,Andrei Svechnikov,R,CAR,24,71,24,44,68
20,8475798,Mikael Granlund,C,SJS,32,69,20,48,68
20,8480839,Rasmus Dahlin,D,BUF,24,71,17,51,68
20,8477500,Bo Horvat,C,NYI,29,80,32,35,67
20,8476454,Ryan Nugent-Hopkins,C,EDM,31,78,29,38,67
20,8473512,Claude Giroux,R,OTT,36,79,17,50,67
20,8479325,Charlie McAvoy,D,BOS,27,77,14,53,67
20,8477504,Josh Morrissey,D,WPG,29,76,11,56,67
20,8475184,Chris Kreider,L,NYR,33,77,39,27,66
20,8480208,Drake Batherson,R,OTT,26,77,27,39,66
20,8482699,Dylan Guenther,R,UTA,21,81,35,30,65
20,8482740,Wyatt Johnston,C,DAL,21,81,27,38,65
20,8478975,Mason Marchment,L,DAL,29,81,26,39,65
20,8481528,Dylan Cozens,C,BUF,23,69,22,43,65
20,8475786,Zach Hyman,L,EDM,32,80,38,26,64
20,8476875,Mike Matheson,D,MTL,30,73,15,49,64
20,8478460,Zach Werenski,D,CBJ,27,82,13,51,64
20,8475810,Bryan Rust,R,PIT,32,65,29,34,63
20,8477511,Anthony Mantha,R,CGY,30,81,29,34,63
20,8477496,Elias Lindholm,C,BOS,30,79,27,36,63
20,8471685,Anze Kopitar,C,LAK,37,81,20,43,63
20,8476905,Chandler Stephenson,C,SEA,30,75,20,43,63
20,8477949,Alex Tuch,R,BUF,28,71,26,36,62
20,8478440,Dylan Strome,C,WSH,27,72,22,40,62
20,8476881,Tomas Hertl,C,VGK,31,77,35,26,61
20,8476539,Jonathan Marchessault,R,NSH,34,76,33,28,61
20,8477955,Jared McCann,L,SEA,28,73,31,30,61
20,8471215,Evgeni Malkin,C,PIT,38,73,30,31,61
20,8482093,Seth Jarvis,C,CAR,22,67,29,32,61
20,8475784,Jeff Skinner,C,EDM,32,76,26,35,61
20,8478462,Nicolas Roy,C,VGK,27,80,17,44,61
20,8475158,Ryan O'Reilly,C,NSH,33,74,29,31,60
20,8478414,Timo Meier,R,NJD,28,76,26,34,60
20,8478873,Troy Terry,R,ANA,27,75,25,35,60
20,8475168,Matt Duchene,C,DAL,33,82,18,42,60
20,8479999,Casey Mittelstadt,C,COL,26,80,16,44,60
20,8482110,Dawson Mercer,C,NJD,23,76,33,26,59
20,8476346,Johnny Gaudreau,L,CBJ,31,70,20,39,59
20,8482684,Luke Hughes,D,NJD,21,72,7,52,59
20,8478042,Viktor Arvidsson,L,EDM,31,76,20,38,58
20,8483515,Juraj Slafkovsky,L,MTL,20,78,19,39,58
20,8478493,Joel Eriksson Ek,C,MIN,27,74,18,40,58
20,8476853,Morgan Rielly,D,TOR,30,74,9,49,58
20,8481560,Arthur Kaliyev,R,LAK,23,78,25,32,57
20,8477960,Adrian Kempe,R,LAK,28,81,20,37,57
20,8474578,Erik Karlsson,D,PIT,34,78,15,42,57
20,8477503,Max Domi,C,TOR,29,76,13,44,57
20,8471724,Kris Letang,D,PIT,37,80,12,45,57
20,8480865,Noah Dobson,D,NYI,24,79,10,47,57
20,8479323,Adam Fox,D,NYR,26,74,10,47,57
20,8473994,Jamie Benn,L,DAL,35,81,24,32,56
20,8483808,Andrei Kuzmenko,L,CGY,28,76,22,34,56
20,8477940,Nikolaj Ehlers,L,WPG,28,70,19,37,56
20,8480803,Evan Bouchard,D,EDM,25,78,17,39,56
20,8479345,Jakob Chychrun,D,WSH,26,64,14,42,56
20,8478498,Jake DeBrusk,L,VAN,28,73,30,25,55
20,8477935,Sam Bennett,C,FLA,28,75,27,28,55
20,8476432,Boone Jenner,C,CBJ,31,65,27,28,55
20,8476448,William Karlsson,C,VGK,31,73,23,32,55
20,8474590,John Carlson,D,WSH,34,67,15,40,55
20,8478444,Brock Boeser,R,VAN,27,67,26,27,53
20,8478401,Pavel Zacha,C,BOS,27,80,21,32,53
20,8477456,J.T. Compher,L,DET,29,82,20,33,53
20,8476479,Phillip Danault,C,LAK,31,82,16,37,53
20,8482113,Anton Lundell,C,FLA,23,79,15,38,53
20,8474149,Evgenii Dadonov,R,DAL,35,79,26,26,52
20,8475191,Reilly Smith,R,NYR,33,76,20,32,52
20,8481711,Matias Maccelli,L,UTA,24,71,12,40,52
20,8480797,Joel Farabee,L,PHI,24,75,27,24,51
20,8480039,Martin Necas,C,CAR,25,76,25,26,51
20,8482720,Matthew Knies,L,TOR,22,76,18,33,51
20,8482092,Ridly Greig,C,OTT,22,77,17,34,51
20,8476826,Yanni Gourde,C,SEA,33,75,17,34,51
20,8477346,MacKenzie Weegar,D,CGY,30,75,13,38,51
20,8477447,Shea Theodore,D,VGK,29,59,11,40,51
20,8480064,Josh Norris,C,OTT,25,75,28,22,50
20,8476438,Brandon Saad,L,STL,32,71,28,22,50
20,8478856,Conor Garland,R,VAN,28,71,27,23,50
20,8480185,Eetu Luostarinen,C,FLA,26,74,22,28,50
20,8475745,Charlie Coyle,C,BOS,32,75,17,33,50
20,8478047,Michael Bunting,L,PIT,29,71,16,34,50
20,8474563,Drew Doughty,D,LAK,35,72,16,34,50
20,8477998,Warren Foegele,L,LAK,28,80,15,35,50
20,8478407,Vince Dunn,D,SEA,28,70,10,40,50
20,8479425,Filip Hronek,D,VAN,27,74,8,42,50
20,8481596,Shane Pinto,C,OTT,24,73,19,30,49
20,8477021,Alex Kerfoot,C,UTA,30,73,19,30,49
20,8475794,Tyler Seguin,C,DAL,32,80,18,31,49
20,8478542,Evan Rodrigues,C,FLA,31,77,17,32,49
20,8482745,Mason McTavish,C,ANA,21,71,16,33,49
20,8474679,Gustav Nyquist,C,NSH,35,72,13,36,49
20,8470613,Brent Burns,D,CAR,39,76,11,38,49
20,8479542,Brandon Hagel,L,TBL,26,82,25,23,48
20,8475151,Kyle Palmieri,C,NYI,33,80,25,23,48
20,8477416,Oliver Bjorkstrand,R,SEA,29,74,22,26,48
20,8482109,Alexis Lafrenière,L,NYR,23,75,20,28,48
20,8478233,Andrew Mangiapane,L,WSH,28,72,20,28,48
20,8478469,Thomas Chabot,D,OTT,27,74,14,34,48
20,8474565,Alex Pietrangelo,D,VGK,34,63,13,35,48
20,8476958,Jaccob Slavin,D,CAR,30,77,10,38,48
20,8475793,Ryan Johansen,C,PHI,32,73,24,23,47
20,8474102,David Perron,L,OTT,36,78,20,27,47
20,8477407,Anthony Duclair,L,NYI,29,79,19,28,47
20,8482159,Tyson Foerster,R,PHI,22,78,18,29,47
20,8475169,Evander Kane,L,EDM,33,74,18,29,47
20,8479365,Trent Frederic,C,BOS,26,75,15,32,47
20,8478472,Mathieu Joseph,R,STL,27,71,14,33,47
20,8477986,Brandon Montour,D,SEA,30,74,12,35,47
20,8480015,Owen Tippett,R,PHI,25,76,19,27,46
20,8477444,Andre Burakovsky,L,SEA,29,71,18,28,46
20,8476792,Torey Krug,D,STL,33,72,14,32,46
20,8476462,Dougie Hamilton,D,NJD,31,74,13,33,46
20,8478397,Rasmus Andersson,D,CGY,28,71,9,37,46
20,8478519,Anthony Cirelli,C,TBL,27,80,18,27,45
20,8480028,Morgan Frost,C,PHI,25,71,15,30,45
20,8477494,Jonathan Drouin,L,COL,29,81,10,35,45
20,8477476,Artturi Lehkonen,L,COL,29,79,26,18,44
20,8471698,T.J. Oshie,R,WSH,38,74,21,23,44
20,8478115,Pierre Engvall,L,NYI,28,77,19,25,44
20,8476872,Scott Laughton,C,PHI,30,73,17,27,44
20,8481533,Trevor Zegras,C,ANA,23,72,16,28,44
20,8477479,Tyler Bertuzzi,L,CHI,29,65,15,29,44
20,8482702,Logan Stankoven,C,DAL,21,80,15,29,44
20,8476419,Jean-Gabriel Pageau,C,NYI,32,74,13,31,44
20,8480014,Gabriel Vilardi,C,WPG,25,65,27,16,43
20,8479992,Michael Rasmussen,C,DET,25,82,21,22,43
20,8479400,Pierre-Luc Dubois,L,WSH,26,70,20,23,43
20,8481546,Cam York,D,PHI,23,73,15,28,43
20,8479410,Mikhail Sergachev,D,UTA,26,76,11,32,43
20,8480434,Sean Durzi,D,UTA,26,69,8,35,43
20,8474150,Mikael Backlund,C,CGY,35,77,22,20,42
20,8476981,Josh Anderson,R,MTL,30,68,21,21,42
20,8476483,Rickard Rakell,R,PIT,31,68,19,23,42
20,8482055,Drew O'Connor,L,PIT,26,69,19,23,42
20,8475768,Jaden Schwartz,C,SEA,32,69,17,25,42
20,8478438,Tommy Novak,C,NSH,27,66,14,28,42
20,8479987,Morgan Geekie,C,BOS,26,75,14,28,42
20,8476927,Teddy Blueger,C,VAN,30,72,12,30,42
20,8477495,Seth Jones,D,CHI,30,72,11,31,42
20,8481581,Thomas Harley,D,DAL,23,76,11,31,42
20,8476854,Hampus Lindholm,D,BOS,30,78,9,33,42
20,8482122,Brock Faber,D,MIN,22,79,9,33,42
20,8481068,Yegor Sharangovich,C,CGY,26,75,25,16,41
20,8477451,Ryan Hartman,R,MIN,30,67,21,20,41
20,8484145,Zach Benson,L,BUF,19,67,16,25,41
20,8482124,Quinton Byfield,R,LAK,22,80,14,27,41
20,8481542,Moritz Seider,D,DET,23,76,9,32,41
20,8475314,Anders Lee,L,NYI,34,75,26,14,40
20,8484153,Leo Carlsson,C,ANA,20,70,20,20,40
20,8473986,Alex Killorn,L,ANA,35,69,19,21,40
20,8475722,Jason Zucker,L,BUF,32,61,19,21,40
20,8483431,Logan Cooley,C,UTA,20,76,18,22,40
20,8479339,Patrik Laine,L,CBJ,26,66,18,22,40
20,8481604,Pavel Dorofeyev,L,VGK,24,74,18,22,40
20,8480188,Fabian Zetterlund,L,SJS,25,64,17,23,40
20,8476880,Tom Wilson,R,WSH,30,65,16,24,40
20,8477429,Andrew Copp,C,DET,30,80,15,25,40
20,8476458,Ryan Strome,C,ANA,31,73,8,32,40
20,8475714,Calle Jarnkrok,C,TOR,33,75,20,19,39
20,8479293,Brandon Tanev,L,SEA,33,67,19,20,39
20,8480798,Philipp Kurashev,C,CHI,25,58,16,23,39
20,8480849,Barrett Hayton,C,UTA,24,72,16,23,39
20,8477497,Sean Monahan,C,CBJ,30,72,15,24,39
20,8478466,Daniel Sprong,R,VAN,27,75,15,24,39
20,8475753,Justin Faulk,D,STL,32,70,12,27,39
20,8478038,Devon Toews,D,COL,30,68,10,29,39
20,8475287,Erik Haula,L,NJD,33,72,22,16,38
20,8478474,Lawson Crouse,L,UTA,27,74,20,18,38
20,8482705,Cole Sillinger,C,CBJ,21,65,19,19,38
20,8476925,Colton Sissons,C,NSH,31,67,16,22,38
20,8476882,Teuvo Teravainen,C,CHI,30,64,13,25,38
20,8480009,Eeli Tolvanen,R,SEA,25,67,19,18,37
20,8480829,Jesperi Kotkaniemi,C,CAR,24,68,19,18,37
20,8480220,Noah Cates,L,PHI,25,66,16,21,37
20,8476906,Shayne Gostisbehere,D,CAR,31,75,11,26,37
20,8482097,Jack Quinn,R,BUF,23,70,11,26,37
20,8478055,Gustav Forsling,D,FLA,28,73,8,29,37
20,8480817,K'Andre Miller,D,NYR,24,70,7,30,37
20,8479976,Juuso Valimaki,D,UTA,26,68,6,31,37
20,8477506,Ryan Pulock,D,NYI,30,78,3,34,37
20,8478020,Michael Amadio,R,OTT,28,77,22,14,36
20,8475799,Nino Niederreiter,R,WPG,32,70,21,15,36
20,8480113,Alex Iafallo,L,WPG,31,66,16,20,36
20,8481524,Bowen Byram,D,BUF,23,68,14,22,36
20,8476923,Damon Severson,D,CBJ,30,81,12,24,36
20,8478458,John (Jack) Roslovic,C,CAR,27,69,12,24,36
20,8482660,Kent Johnson,C,CBJ,22,65,10,26,36
20,8480871,Adam Boqvist,D,FLA,24,72,9,27,36
20,8476869,Brady Skjei,D,NSH,30,69,8,28,36
20,8482105,Jake Sanderson,D,OTT,22,68,6,30,36
20,8473507,Jeff Petry,D,DET,37,71,6,30,36
20,8477987,Ryan Donato,C,CHI,28,57,19,16,35
20,8481523,Kirby Dach,C,MTL,23,62,17,18,35
20,8475763,Kevin Hayes,R,PIT,32,65,15,20,35
20,8483445,Cutter Gauthier,L,ANA,20,64,13,22,35
20,8481606,Jordan Spence,D,LAK,23,60,11,24,35
20,8477964,Ivan Barbashev,C,VGK,29,78,10,25,35
20,8477948,Travis Sanheim,D,PHI,28,71,10,25,35
20,8482671,Owen Power,D,BUF,22,71,8,27,35
20,8481582,Nicholas Robertson,L,TOR,23,73,19,15,34
20,8483505,Matthew Poitras,C,BOS,20,73,16,18,34
20,8479393,Noah Gregor,L,OTT,26,67,15,19,34
20,8479661,Tanner Jeannot,L,LAK,27,76,13,21,34
20,8482149,Cole Perfetti,C,WPG,22,69,12,22,34
20,8476917,Adam Pelech,D,NYI,30,79,4,30,34
20,8475149,Marcus Johansson,L,MIN,34,61,21,12,33
20,8482089,Jake Neighbours,L,STL,22,67,21,12,33
20,8481618,Alex Newhook,C,MTL,23,72,18,15,33
20,8474641,Adam Henrique,C,EDM,34,76,17,16,33
20,8475193,Tomas Tatar,L,NJD,34,68,17,16,33
20,8474586,Jordan Eberle,R,SEA,34,69,16,17,33
20,8478046,Danton Heinen,L,VAN,29,68,16,17,33
20,8482074,Connor Zary,C,CGY,23,56,16,17,33
20,8479390,Taylor Raddysh,R,WSH,26,63,16,17,33
20,8481441,Joe Snively,C,DET,28,61,14,19,33
20,8481577,Philip Tomasino,C,NSH,23,70,13,20,33
20,8477425,Miles Wood,L,COL,29,74,13,20,33
20,8477953,Kasperi Kapanen,R,STL,28,72,13,20,33
20,8473422,Nick Foligno,L,CHI,37,62,12,21,33
20,8480068,Ryan Poehling,C,PHI,25,67,11,22,33
20,8478133,Jake Evans,C,MTL,28,71,10,23,33
20,8478396,Noah Hanifin,D,VGK,27,55,9,24,33
20,8477969,Marcus Pettersson,D,PIT,28,79,5,28,33
20,8478366,Frank Vatrano,R,ANA,30,71,17,15,32
20,8478463,Anthony Beauvillier,L,PIT,27,69,17,15,32
20,8482146,Luke Evangelista,R,NSH,22,72,15,17,32
20,8477932,Aaron Ekblad,D,FLA,28,68,9,23,32
20,8482245,Artem Zub,D,OTT,29,67,8,24,32
20,8476278,Colin Blackwell,C,DAL,31,79,19,12,31
20,8473533,Jordan Staal,C,CAR,36,63,19,12,31
20,8477952,Robby Fabbri,C,ANA,28,67,16,15,31
20,8483457,Lane Hutson,D,MTL,20,67,13,18,31
20,8478057,Dakota Joshua,C,VAN,28,67,12,19,31
20,8479525,Ross Colton,C,COL,28,80,11,20,31
20,8476392,Adam Lowry,C,WPG,31,66,10,21,31
20,8475218,Mattias Ekholm,D,EDM,34,70,9,22,31
20,8475171,Oliver Ekman-Larsson,D,TOR,33,69,8,23,31
20,8482712,Oskar Olausson,R,COL,22,80,7,24,31
20,8476892,Colton Parayko,D,STL,31,73,6,25,31
20,8483524,Shane Wright,C,SEA,20,59,18,12,30
20,8477426,Nicholas Paul,L,TBL,29,82,17,13,30
20,8484166,Adam Fantilli,C,CBJ,20,63,14,16,30
20,8480078,Filip Chytil,C,NYR,25,66,14,16,30
20,8481186,Logan O'Connor,R,COL,28,81,13,17,30
20,8476292,Ondrej Palat,L,NJD,33,69,11,19,30
20,8480145,Neal Pionk,D,WPG,29,69,7,23,30
20,8481014,Alexander Romanov,D,NYI,24,75,5,25,30
20,8475764,Cam Fowler,D,ANA,33,72,3,27,30
20,8480813,Joe Veleno,C,DET,24,76,17,12,29
20,8481535,Nils Hoglander,L,VAN,24,68,16,13,29
20,8480459,Pius Suter,C,VAN,28,70,15,14,29
20,8479591,Michael Eyssimont,C,TBL,28,82,15,14,29
20,8476897,Oskar Sundqvist,C,STL,30,60,14,15,29
20,8482667,William Eklund,L,SJS,22,68,13,16,29
20,8481522,Peyton Krebs,C,BUF,23,56,12,17,29
20,8483490,Pavel Mintyukov,D,ANA,21,70,9,20,29
20,8477498,Darnell Nurse,D,EDM,29,71,6,23,29
20,8480043,Timothy Liljegren,D,TOR,25,70,4,25,29
20,8475181,Nick Leddy,D,STL,33,69,4,25,29
20,8479998,Mikey Anderson,D,LAK,25,59,3,26,29
20,8478432,Christian Fischer,R,DET,27,73,16,12,28
20,8481554,Kaapo Kakko,R,NYR,23,72,13,15,28
20,8481093,Rafael Harvey-Pinard,L,MTL,25,62,11,17,28
20,8477353,Tyler Motte,C,DET,29,68,11,17,28
20,8480855,Jack McBain,C,UTA,24,67,10,18,28
20,8477839,Conor Sheary,L,TBL,32,81,10,18,28
20,8473563,Nicklas Backstrom,C,WSH,37,55,7,21,28
20,8480873,Rasmus Sandin,D,WSH,24,61,6,22,28
20,8476463,Jonas Brodin,D,MIN,31,72,5,23,28
20,8476979,Erik Gustafsson,D,DET,32,76,4,24,28
20,8480049,Dylan Samberg,D,WPG,25,70,3,25,28
20,8478891,Mason Appleton,C,WPG,28,62,16,11,27
20,8474715,Cameron Atkinson,R,TBL,35,81,15,12,27
20,8481624,Ilya Mikheyev,R,CHI,30,60,14,13,27
20,8474189,Lars Eller,C,PIT,35,62,14,13,27
20,8476461,Sean Couturier,C,PHI,32,66,13,14,27
20,8482679,Matt Coronato,R,CGY,22,63,12,15,27
20,8481553,Bobby Brink,R,PHI,23,64,12,15,27
20,8475848,Brendan Gallagher,R,MTL,32,64,11,16,27
20,8480802,Ryan McLeod,C,BUF,25,65,11,16,27
20,8477989,Christian Dvorak,C,MTL,28,66,10,17,27
20,8476474,Stefan Noesen,R,NJD,31,63,8,19,27
20,8475200,Dmitry Orlov,D,CAR,33,73,7,20,27
20,8482749,Joshua Roy,R,MTL,21,73,15,11,26
20,8479941,Justin Danforth,R,CBJ,31,53,14,12,26
20,8475231,Casey Cizikas,C,NYI,33,75,12,14,26
20,8481601,Simon Holmstrom,R,NYI,23,75,12,14,26
20,8480748,Kiefer Sherwood,L,VAN,29,61,11,15,26
20,8481580,Connor McMichael,C,WSH,23,61,10,16,26
20,8480336,Sean Walker,D,CAR,30,75,8,18,26
20,8482101,Danil Gushchin,L,SJS,22,56,6,20,26
20,8482133,Thomas Bordeleau,C,SJS,22,67,5,21,26
20,8478500,Ivan Provorov,D,CBJ,27,80,4,22,26
20,8476988,Matt Benning,D,SJS,30,75,3,23,26
20,8482117,Lukas Reichel,L,CHI,22,54,16,9,25
20,8479353,Brett Howden,C,VGK,26,70,12,13,25
20,8477015,Connor Brown,R,EDM,30,69,12,13,25
20,8477947,Sonny Milano,L,WSH,28,63,11,14,25
20,8475343,Nic Dowd,C,WSH,34,63,11,14,25
20,8481481,Blake Lizotte,C,PIT,27,62,9,16,25
20,8475791,Taylor Hall,L,CHI,33,60,9,16,25
20,8475760,Nick Bjugstad,C,UTA,32,66,8,17,25
20,8474053,Logan Couture,C,SJS,35,60,8,17,25
20,8477507,Nikita Zadorov,D,BOS,29,66,7,18,25
20,8474716,Jared Spurgeon,D,MIN,35,75,5,20,25
20,8482655,Janis Moser,D,TBL,24,74,4,21,25
20,8476624,Barclay Goodrow,C,SJS,31,49,4,21,25
20,8482175,JJ Peterka,R,BUF,22,71,17,7,24
20,8482259,Bobby McMann,C,TOR,28,62,16,8,24
20,8476918,Jimmy Vesey,L,NYR,31,67,13,11,24
20,8481032,Paul Cotter,C,NJD,25,57,12,12,24
20,8476921,Jordan Martinook,L,CAR,32,63,11,13,24
20,8478413,Jordan Greenway,L,BUF,27,65,11,13,24
20,8484203,Bradly Nadeau,L,CAR,19,63,10,14,24
20,8475855,Jesper Fast,R,CAR,33,65,10,14,24
20,8476312,Josh Manson,D,COL,33,64,8,16,24
20,8481028,Martin Pospisil,C,CGY,25,57,8,16,24
20,8482073,Braden Schneider,D,NYR,23,64,6,18,24
20,8483565,Nick Blankenburg,D,NSH,26,57,6,18,24
20,8476422,Mike Reilly,D,NYI,31,72,5,19,24
20,8479369,Andrew Peeke,D,BOS,26,70,4,20,24
20,8476885,Jacob Trouba,D,NYR,30,70,3,21,24
20,8476891,Matthew Grzelcyk,D,PIT,30,79,3,21,24
20,8477505,Alexander Wennberg,C,SJS,30,69,12,11,23
20,8480144,David Kampf,C,TOR,29,75,11,12,23
20,8483493,Frank Nazar,C,CHI,20,58,11,12,23
20,8482809,Jackson Blake,R,CAR,21,50,10,13,23
20,8477450,Jason Dickinson,C,CHI,29,63,10,13,23
20,8482737,Zack Bolduc,C,STL,21,54,10,13,23
20,8480789,Oliver Wahlstrom,R,NYI,24,68,9,14,23
20,8479066,Ryan Lomberg,L,CGY,30,60,8,15,23
20,8479639,Dylan Coghlan,D,WPG,26,63,7,16,23
20,8478911,Matt Roy,D,WSH,29,69,7,16,23
20,8482624,Daniil Miromanov,D,CGY,27,69,5,18,23
20,8475324,Nick Jensen,D,OTT,34,66,4,19,23
20,8478970,Jalen Chatfield,D,CAR,28,69,4,19,23
20,8474673,TJ Brodie,D,CHI,34,61,3,20,23
20,8480891,Michael Kesselring,D,UTA,24,62,3,20,23
20,8479402,Jake Bean,D,CGY,26,70,2,21,23
20,8480222,Sebastian Aho,D,PIT,28,74,2,21,23
20,8480035,Henri Jokiharju,D,BUF,25,62,1,22,23
20,8482192,Isaak Phillips,D,CHI,23,48,1,22,23
20,8480281,Alexey Toropchenko,R,STL,25,54,19,3,22
20,8480893,Kirill Marchenko,R,CBJ,24,64,13,9,22
20,8470621,Corey Perry,R,EDM,39,67,11,11,22
20,8482125,Alexander Holtz,R,VGK,22,66,11,11,22
20,8475842,Sam Carrick,C,NYR,32,56,11,11,22
20,8482475,Yegor Chinakhov,R,CBJ,23,64,10,12,22
20,8477979,Nicolas Aube-Kubel,R,BUF,28,61,10,12,22
20,8480074,Alexandre Texier,C,STL,25,59,8,14,22
20,8480878,Nils Lundkvist,D,DAL,24,68,6,16,22
20,8481703,Valtteri Puustinen,R,PIT,25,67,4,18,22
20,8479983,Mario Ferraro,D,SJS,26,70,3,19,22
20,8478507,John Marino,D,UTA,27,62,1,21,22
20,8479414,Nathan Bastian,R,NJD,27,56,14,7,21
20,8478109,Victor Olofsson,L,VGK,29,73,10,11,21
20,8482079,Marco Rossi,C,MIN,23,55,10,11,21
20,8483482,Tristan Luneau,D,ANA,20,59,10,11,21
20,8483499,Liam Ohgren,L,MIN,20,60,8,13,21
20,8480995,Pontus Holmberg,R,TOR,25,62,8,13,21
20,8479980,Nicolas Hague,D,VGK,26,54,7,14,21
20,8479324,Ryan Lindgren,D,NYR,26,65,6,15,21
20,8481521,Ronnie Attard,D,PHI,25,55,6,15,21
20,8478043,Sam Lafferty,C,BUF,29,52,5,16,21
20,8477220,Nate Schmidt,D,FLA,33,67,4,17,21
20,8480058,Pierre-Olivier Joseph,D,STL,25,53,4,17,21
20,8475188,Brayden McNabb,D,VGK,33,54,4,17,21
20,8476931,Jake McCabe,D,TOR,31,61,2,19,21
20,8470600,Ryan Suter,D,STL,39,68,2,19,21
20,8475790,Erik Gudbranson,D,CBJ,32,76,1,20,21
20,8475179,Dmitry Kulikov,D,FLA,34,67,0,21,21
20,8482157,Will Cuylle,L,NYR,22,67,10,10,20
20,8480762,Eric Robinson,L,CAR,29,64,9,11,20
20,8482111,Justin Barron,D,MTL,23,64,9,11,20
20,8477903,Garnet Hathaway,R,PHI,33,62,9,11,20
20,8481704,Juuso Parssinen,C,NSH,23,48,8,12,20
20,8473453,Trevor Lewis,C,LAK,37,70,8,12,20
20,8482067,Connor Mackey,D,NYR,28,64,7,13,20
20,8478451,Ethan Bear,D,WSH,27,58,7,13,20
20,8481527,Kaedan Korczak,D,VGK,23,51,6,14,20
20,8478013,Jake Walman,D,SJS,28,75,5,15,20
20,8477508,Curtis Lazar,C,NJD,29,60,5,15,20
20,8476960,Andreas Athanasiou,C,CHI,30,50,5,15,20
20,8476329,Travis Boyd,C,MIN,31,58,5,15,20
20,8477488,Brett Pesce,D,NJD,30,65,4,16,20
20,8481059,Scott Perunovich,D,STL,26,62,3,17,20
20,8480887,Jordan Harris,D,MTL,24,57,3,17,20
20,8476874,Olli Maatta,D,DET,30,62,2,18,20
20,8478851,Alexandre Carrier,D,NSH,28,71,1,19,20
20,8480860,Kevin Bahl,D,CGY,24,55,1,19,20
20,8477435,Ryan Graves,D,PIT,29,79,1,19,20
20,8476878,Zemgus Girgensons,C,TBL,30,80,15,4,19
20,8480025,MacKenzie Entwistle,R,FLA,25,60,13,6,19
20,8478508,Yakov Trenin,C,MIN,27,58,12,7,19
20,8480289,Morgan Barron,C,WPG,26,61,12,7,19
20,8481537,Nikita Okhotiuk,D,CGY,24,55,12,7,19
20,8479619,Michael Carcone,L,UTA,28,57,10,9,19
20,8476480,Vladislav Namestnikov,C,WPG,32,59,8,11,19
20,8482176,Wyatt Kaiser,D,CHI,22,55,7,12,19
20,8479718,Alex Barré-Boulet,C,MTL,27,44,7,12,19
20,8479398,Samuel Girard,D,COL,26,67,6,13,19
20,8476889,Radek Faksa,C,STL,30,64,5,14,19
20,8480073,Erik Brannstrom,D,COL,25,65,5,14,19
20,8482087,Kaiden Guhle,D,MTL,22,66,4,15,19
20,8475455,Brenden Dillon,D,NJD,34,57,4,15,19
20,8478840,Will Borgen,D,SEA,28,64,3,16,19
20,8481178,Egor Zamula,D,PHI,24,60,1,18,19
20,8475225,Craig Smith,C,CHI,35,57,13,5,18
20,8478569,Noel Acciari,C,PIT,33,58,10,8,18
20,8477380,Jonny Brodzinski,C,NYR,31,41,9,9,18
20,8480806,Isac Lundestrom,C,ANA,25,62,8,10,18
20,8477478,William Carrier,L,CAR,30,51,7,11,18
20,8478882,Vladislav Gavrikov,D,LAK,29,72,5,13,18
20,8479315,Joey Anderson,R,CHI,26,53,5,13,18
20,8478416,Erik Cernak,D,TBL,27,75,2,16,18
20,8479336,Carl Grundstrom,R,SJS,27,45,10,7,17
20,8482155,Alex Laferriere,R,LAK,23,62,9,8,17
20,8480003,Jesper Boqvist,C,FLA,26,70,8,9,17
20,8483491,Ivan Miroshnichenko,L,WSH,20,54,8,9,17
20,8476374,Sean Kuraly,C,CBJ,31,60,8,9,17
20,8482148,Hendrix Lapierre,C,WSH,22,47,8,9,17
20,8477573,Nathan Walker,L,STL,30,45,6,11,17
20,8479351,Sam Steel,C,DAL,26,80,5,12,17
20,8478434,Keegan Kolesar,R,VGK,27,66,5,12,17
20,8476856,Mathew Dumba,D,DAL,30,68,5,12,17
20,8476873,Mark Jankowski,C,NSH,30,52,5,12,17
20,8478136,Jake Middleton,D,MIN,28,75,4,13,17
20,8476902,Esa Lindell,D,DAL,30,70,3,14,17
20,8475462,Radko Gudas,D,ANA,34,68,3,14,17
20,8476879,Cody Ceci,D,EDM,31,70,2,15,17
20,8476457,Adam Larsson,D,SEA,32,63,1,16,17
20,8481477,Nico Sturm,C,SJS,29,66,10,6,16
20,8477406,Mattias Janmark,C,EDM,32,61,9,7,16
20,8480848,Ty Dellandrea,C,SJS,24,51,9,7,16
20,8478585,Derek Ryan,C,EDM,38,66,8,8,16
20,8479291,Kevin Rooney,C,CGY,31,47,8,8,16
20,8477919,Frederick Gaudreau,C,MIN,31,62,7,9,16
20,8475220,Marcus Foligno,L,MIN,33,58,7,9,16
20,8480011,Klim Kostin,C,SJS,25,48,7,9,16
20,8481617,Vasily Podkolzin,R,VAN,23,56,7,9,16
20,8477392,Hudson Fasching,R,NYI,29,66,6,10,16
20,8480021,Jack Studnicka,C,LAK,25,57,6,10,16
20,8477931,Tomas Nosek,L,FLA,32,61,6,10,16
20,8479996,Cody Glass,C,NSH,25,62,5,11,16
20,8482142,Jamie Drysdale,D,PHI,22,59,5,11,16
20,8474612,Travis Hamonic,D,OTT,34,49,5,11,16
20,8482666,Scott Morrow,D,CAR,22,47,4,12,16
20,8474151,Ryan McDonagh,D,TBL,35,77,3,13,16
20,8480246,Nick Perbix,D,TBL,26,72,3,13,16
20,8471709,Marc-Edouard Vlasic,D,SJS,37,57,3,13,16
20,8479982,Conor Timmins,D,TOR,26,52,2,14,16
20,8478859,Niko Mikkola,D,FLA,28,58,1,15,16
20,8480448,Parker Kelly,L,COL,25,75,10,5,15
20,8480205,Emil Bemstrom,C,PIT,25,55,9,6,15
20,8481641,Joel Kiviranta,L,COL,28,77,8,7,15
20,8479520,Brandon Duhaime,R,WSH,27,54,8,7,15
20,8480980,Connor Dewar,C,TOR,25,62,8,7,15
20,8479368,Max Jones,L,BOS,26,63,7,8,15
20,8477446,Michael McCarron,R,NSH,29,55,7,8,15
20,8477018,Ben Hutton,D,VGK,31,47,6,9,15
20,8483495,Simon Nemec,D,NJD,20,54,5,10,15
20,8478443,Brandon Carlo,D,BOS,28,56,4,11,15
20,8482451,Mikael Pyyhtia,L,CBJ,23,53,4,11,15
20,8474567,Zach Bogosian,D,MIN,34,64,3,12,15
20,8476467,Jamie Oleksiak,D,SEA,32,65,2,13,15
20,8481122,Simon Benoit,D,TOR,26,49,9,5,14
20,8480835,Jack Drury,C,CAR,24,62,8,6,14
20,8480355,Mark Kastelic,C,BOS,25,65,8,6,14
20,8482077,Dylan Holloway,L,EDM,23,48,8,6,14
20,8481517,Brett Leason,R,ANA,25,58,7,7,14
20,8476469,Joel Armia,R,MTL,31,65,6,8,14
20,8477482,Zachary Sanford,L,CHI,30,37,6,8,14
20,8481656,Aliaksei Protas,C,WSH,23,62,5,9,14
20,8474574,Tyler Myers,D,VAN,34,69,4,10,14
20,8484149,Gavin Brindley,C,CBJ,20,54,4,10,14
20,8479370,Tyson Jost,C,CAR,26,46,3,11,14
20,8480950,Ilya Lyubushkin,D,DAL,30,68,3,11,14
20,8483466,Kevin Korchinski,D,CHI,20,52,3,11,14
20,8475690,Chris Tanev,D,TOR,35,53,3,11,14
20,8481013,Jonatan Berggren,R,DET,24,63,3,11,14
20,8481598,Philip Broberg,D,EDM,23,52,3,11,14
20,8482730,Brandt Clarke,D,LAK,21,50,3,11,14
20,8479348,Kale Clague,D,BUF,26,41,3,11,14
20,8476331,Dylan DeMelo,D,WPG,31,66,2,12,14
20,8475279,Ben Chiarot,D,DET,33,65,2,12,14
20,8475233,David Savard,D,MTL,34,63,2,12,14
20,8478421,A.J. Greer,L,FLA,28,54,9,4,13
20,8482803,Olen Zellweger,D,ANA,21,69,9,4,13
20,8479328,Julien Gauthier,R,NYI,27,57,8,5,13
20,8478211,Dryden Hunt,L,CGY,29,51,7,6,13
20,8476994,Vinnie Hinostroza,C,NSH,30,48,5,8,13
20,8482747,Brennan Othmann,L,NYR,21,45,5,8,13
20,8480252,Cole Guttman,C,CHI,25,34,5,8,13
20,8477384,Joshua Brown,D,EDM,30,48,5,8,13
20,8481019,David Gustafsson,C,WPG,24,39,4,9,13
20,8478452,Caleb Jones,D,LAK,27,61,3,10,13
20,8481568,Alex Vlasic,D,CHI,23,56,2,11,13
20,8479026,Philippe Myers,D,TOR,27,51,2,11,13
20,8477845,Trevor van Riemsdyk,D,WSH,33,58,2,11,13
20,8475762,Derek Forbort,D,VAN,32,48,2,11,13
20,8479371,Dante Fabbro,D,NSH,26,62,1,12,13
20,8482744,James Malatesta,L,CBJ,21,36,7,5,12
20,8483468,Jiri Kulich,C,BUF,20,53,6,6,12
20,8476525,Colin Miller,D,WPG,32,63,4,8,12
20,8480727,Zach Whitecloud,D,VGK,28,52,3,9,12
20,8475718,Justin Holl,D,DET,32,61,3,9,12
20,8476429,Scott Mayfield,D,NYI,32,71,2,10,12
20,8478178,Darren Raddysh,D,TBL,28,67,2,10,12
20,8482095,Tyler Kleven,D,OTT,22,40,2,10,12
20,8475208,Brian Dumoulin,D,ANA,33,62,0,12,12
20,8478468,Jeremy Lauzon,D,NSH,27,51,0,12,12
20,8481532,Alex Turcotte,C,LAK,23,46,9,2,11
20,8481716,Dmitri Voronkov,L,CBJ,24,48,8,3,11
20,8482062,Cole Smith,L,NSH,29,50,7,4,11
20,8482166,Shakir Mukhamadullin,D,SJS,22,55,6,5,11
20,8482652,Walker Duehr,R,CGY,27,46,6,5,11
20,8479359,Beck Malenstyn,L,BUF,26,45,5,6,11
20,8481161,Jake Christiansen,D,CBJ,25,57,5,6,11
20,8477401,John Hayden,C,SEA,29,33,5,6,11
20,8482659,Josh Doan,R,UTA,22,54,5,6,11
20,8481592,Jakob Pelletier,L,CGY,23,44,5,6,11
20,8479671,Mathieu Olivier,R,CBJ,27,52,4,7,11
20,8481167,Brayden Pachal,D,CGY,25,41,4,7,11
20,8477887,Patrick Brown,C,BOS,32,42,4,7,11
20,8480796,Martin Fehervary,D,WSH,25,55,4,7,11
20,8479968,Vinni Lettieri,C,BOS,29,33,4,7,11
20,8477034,Jaycob Megna,D,FLA,32,44,4,7,11
20,8479344,Jesse Puljujarvi,R,PIT,26,48,3,8,11
20,8480172,Jan Rutta,D,SJS,34,63,3,8,11
20,8474166,Alec Martinez,D,CHI,37,39,3,8,11
20,8477499,Rasmus Ristolainen,D,PHI,30,65,1,10,11
20,8481754,Nikita Nesterenko,C,ANA,23,34,7,3,10
20,8482762,Simon Edvinsson,D,DET,21,54,7,3,10
20,8481789,Tye Kartye,L,SEA,23,48,7,3,10
20,8479367,William Lockwood,R,FLA,26,22,7,3,10
20,8482807,Ethan Del Mastro,D,CHI,21,56,6,4,10
20,8481599,Victor Soderstrom,D,UTA,23,42,5,5,10
20,8481518,Nolan Foote,L,NJD,24,44,5,5,10
20,8476822,Luke Glendening,C,TBL,35,75,5,5,10
20,8479316,Luke Kunin,C,SJS,27,53,5,5,10
20,8481708,Zac Jones,D,NYR,24,47,4,6,10
20,8481567,Henry Thrun,D,SJS,23,40,4,6,10
20,8482859,Zack Ostapchuk,C,OTT,21,53,4,6,10
20,8477369,Carson Soucy,D,VAN,30,57,3,7,10
20,8479378,Logan Stanley,D,WPG,26,46,3,7,10
20,8476442,Matt Nieto,L,PIT,32,51,3,7,10
20,8480070,Ian Mitchell,D,BOS,25,48,3,7,10
20,8482964,Arber Xhekaj,D,MTL,23,46,3,7,10
20,8483619,Filip Roos,D,OTT,25,42,3,7,10
20,8481550,Adam Beckman,L,NJD,23,42,2,8,10
20,8480192,Johnathan Kovacevic,D,NJD,27,49,2,8,10
20,8476934,Brock McGinn,L,ANA,30,49,2,8,10
20,8476952,Dominic Toninato,C,WPG,30,35,2,8,10
20,8476372,Nick Seeler,D,PHI,31,42,2,8,10
20,8481701,Santeri Hatakka,D,NJD,23,40,2,8,10
20,8483460,David Jiricek,D,CBJ,21,54,1,9,10
20,8473446,Erik Johnson,D,PHI,36,47,0,10,10
20,8477070,Liam O'Brien,C,UTA,30,59,6,3,9
20,8479994,Jaret Anderson-Dolan,C,WPG,25,37,6,3,9
20,8479772,Zack MacEwen,R,OTT,28,54,6,3,9
20,8471817,Ryan Reaves,R,TOR,37,49,5,4,9
20,8474090,Brendan Smith,D,DAL,35,57,3,6,9
20,8479439,Jacob MacDonald,D,COL,31,47,3,6,9
20,8474034,Patrick Maroon,L,CHI,36,43,3,6,9
20,8481751,Lukas Rousek,R,BUF,25,46,3,6,9
20,8479986,Kole Lind,R,DAL,26,57,3,6,9
20,8482784,Zach Dean,C,STL,21,35,3,6,9
20,8482733,Logan Mailloux,D,MTL,31,37,3,6,9
20,8475958,Michael Sgarbossa,C,WSH,32,30,3,6,9
20,8477335,Kyle Burroughs,D,LAK,29,45,3,6,9
20,8478399,Jonas Siegenthaler,D,NJD,27,60,2,7,9
20,8479372,Joshua Mahura,D,SEA,26,45,2,7,9
20,8480007,Jonas Rondbjerg,R,VGK,25,37,2,7,9
20,8479972,Mason Shaw,C,WPG,26,37,2,7,9
20,8481605,Jackson LaCombe,D,ANA,23,32,2,7,9
20,8480001,Urho Vaakanainen,D,ANA,25,60,1,8,9
20,8479543,Michael Pezzetta,L,MTL,26,55,1,8,9
20,8482861,Vincent Iorio,D,WSH,22,26,1,8,9
20,8482858,Ryker Evans,D,SEA,23,28,1,8,9
20,8476967,Brett Kulak,D,EDM,30,56,0,9,9
20,8480807,Mattias Samuelsson,D,BUF,24,50,0,9,9
20,8475750,Jon Merrill,D,MIN,32,54,0,9,9
20,8479981,Jonah Gadjovich,L,FLA,26,35,5,3,8
20,8481600,Tobias Bjornfot,D,FLA,23,39,5,3,8
20,8482765,Isak Rosen,R,BUF,21,40,5,3,8
20,8479944,Zach Aston-Reese,C,VGK,30,43,4,4,8
20,8483630,Pavol Regenda,L,ANA,25,30,4,4,8
20,8482634,Alex Steeves,C,TOR,25,46,3,5,8
20,8477365,Connor Clifton,D,BUF,29,49,3,5,8
20,8481556,John Beecher,C,BOS,23,40,3,5,8
20,8483397,Marc McLaughlin,C,BOS,25,34,3,5,8
20,8480157,Calle Rosen,D,COL,30,50,2,6,8
20,8482751,Ryan Winterton,C,SEA,21,31,2,6,8
20,8476441,Joel Edmundson,D,LAK,31,37,2,6,8
20,8482070,Mitchell Chaffee,R,TBL,26,56,2,6,8
20,8476867,Brendan Gaunce,C,MIN,30,39,5,2,7
20,8481543,Nikita Alexandrov,C,STL,24,31,5,2,7
20,8478017,Mark Friedman,D,VAN,29,38,3,4,7
20,8479638,Justin Brazeau,R,BOS,26,30,3,4,7
20,8480844,Grigori Denisenko,L,VGK,24,32,3,4,7
20,8478454,Noah Juulsen,D,VAN,27,39,2,5,7
20,8478409,Anthony Richard,C,PHI,28,34,2,5,7
20,8471677,Jack Johnson,D,CBJ,37,62,1,6,7
20,8477938,Haydn Fleury,D,WPG,28,39,0,7,7
20,8475177,Calvin de Haan,D,COL,33,45,0,7,7
20,8475235,Nicolas Deslauriers,L,PHI,33,47,5,1,6
20,8480292,Carson Meyer,R,ANA,27,32,4,2,6
20,8478874,Adam Gaudette,R,OTT,28,37,4,2,6
20,8482496,Nils Aman,C,VAN,24,27,4,2,6
20,8482141,Lukas Cormier,D,VGK,22,29,4,2,6
20,8483549,Lucas Condotta,L,MTL,27,34,4,2,6
20,8480845,Rasmus Kupari,C,WPG,24,47,3,3,6
20,8480890,Jan Jenik,C,OTT,24,26,3,3,6
20,8478021,William Lagesson,D,DET,28,27,3,3,6
20,8480870,Bo Groulx,C,NYR,24,34,2,4,6
20,8483570,Ben Meyers,C,SEA,26,34,1,5,6
20,8479536,Axel Jonsson-Fjallby,L,WPG,26,34,1,5,6
20,8479442,Troy Stecher,D,EDM,30,45,1,5,6
20,8474013,Ian Cole,D,UTA,35,53,1,5,6
20,8480196,Jacob Bryson,D,BUF,27,44,1,5,6
20,8477244,Chad Ruhwedel,D,NYR,34,32,1,5,6
20,8481056,Spencer Stastney,D,NSH,24,39,1,5,6
20,8477467,Gustav Olofsson,D,SEA,30,20,1,5,6
20,8474568,Luke Schenn,D,NSH,35,48,0,6,6
20,8477462,Robert Hagg,D,VGK,29,28,0,6,6
20,8476913,Devin Shore,C,MIN,30,27,0,6,6
20,8482147,Jean-Luc Foudy,C,COL,22,20,5,0,5
20,8478831,Kevin Stenlund,C,UTA,28,53,4,1,5
20,8476858,Phillip Di Giuseppe,L,VAN,31,40,4,1,5
20,8482144,Jack Thompson,D,SJS,22,32,4,1,5
20,8484911,Collin Graf,R,SJS,22,36,3,2,5
20,8479320,Maxime Lajoie,D,SEA,27,32,3,2,5
20,8481541,Samuel Bolduc,D,NYI,24,31,3,2,5
20,8482094,Daemon Hunt,D,MIN,22,21,3,2,5
20,8482511,Mason Lohrei,D,BOS,23,35,2,3,5
20,8482153,Brendan Brisson,C,VGK,23,28,2,3,5
20,8479576,Vincent Desharnais,D,VAN,28,42,2,3,5
20,8482102,Vasily Ponomarev,C,PIT,22,20,2,3,5
20,8478424,Jansen Harkins,C,ANA,27,45,1,4,5
20,8479587,Rhett Gardner,C,PHI,28,22,1,4,5
20,8479249,Andrew Poturalski,C,SJS,30,36,1,4,5
20,8482172,Landon Slaggert,L,CHI,22,28,1,4,5
20,8476473,Connor Murphy,D,CHI,31,40,0,5,5
20,8482165,Yan Kuznetsov,D,CGY,22,19,3,1,4
20,8480851,Akil Thomas,C,LAK,24,17,2,2,4
20,8482713,Mackie Samoskevich,R,FLA,22,50,2,2,4
20,8482177,Marat Khusnutdinov,C,MIN,22,37,2,2,4
20,8483012,Logan Morrison,C,SEA,22,37,2,2,4
20,8479985,Cale Fleury,D,SEA,26,31,2,2,4
20,8479379,Givani Smith,R,SJS,26,25,1,3,4
20,8480879,Jacob Bernard-Docker,D,OTT,24,45,1,3,4
20,8477962,Brendan Lemieux,L,CAR,28,30,1,3,4
20,8481609,Vladislav Kolyachonok,D,UTA,23,28,1,3,4
20,8483763,Maksymilian Szuber,D,UTA,22,29,1,3,4
20,8478502,Dennis Gilbert,D,BUF,28,18,1,3,4
20,8480834,Ty Emberson,D,SJS,24,25,1,3,4
20,8481422,Jake Lucchini,C,NSH,29,24,1,3,4
20,8477810,Joel Hanley,D,CGY,33,19,1,3,4
20,8477851,Jordan Oesterle,D,BOS,32,34,1,3,4
20,8475795,Dylan McIlrath,D,WSH,32,22,1,3,4
20,8481699,Aku Raty,R,UTA,23,19,1,3,4
20,8482470,Ilya Solovyov,D,CGY,24,18,0,4,4
20,8482250,Callahan Burke,C,VGK,27,22,0,4,4
20,8481147,Reese Johnson,C,MIN,26,39,0,4,4
20,8484287,Cole McWard,D,VAN,23,22,3,0,3
20,8478147,Bokondji Imama,L,PIT,28,7,3,0,3
20,8480880,Jakub Lauko,C,MIN,24,35,2,1,3
20,8482061,Brandon Biro,L,SEA,26,8,2,1,3
20,8481065,Angus Crookshank,L,OTT,25,21,2,1,3
20,8481679,Maxence Guenette,D,OTT,23,40,1,2,3
20,8484254,Akito Hirose,D,VAN,25,27,1,2,3
20,8479419,Brett Murray,L,BUF,26,21,1,2,3
20,8477971,Andreas Englund,D,LAK,28,33,1,2,3
20,8480823,Alexander Alexeyev,D,WSH,25,10,1,2,3
20,8481585,Egor Afanasyev,L,SJS,23,15,1,2,3
20,8480990,Declan Chisholm,D,MIN,24,46,1,2,3
20,8479991,Jake Leschyshyn,C,NYR,25,31,1,2,3
20,8484258,Sam Malinski,D,COL,26,17,0,3,3
20,8482201,Gage Goncalves,C,TBL,23,24,0,3,3
20,8478450,Parker Wotherspoon,D,BOS,27,28,0,3,3
20,8482929,Emil Lilleberg,D,TBL,23,25,0,3,3
20,8480441,Trey Fix-Wolansky,R,CBJ,25,31,2,0,2
20,8481743,Marc Del Gaizo,D,NSH,25,21,2,0,2
20,8482145,Mavrik Bourque,C,DAL,22,40,1,1,2
20,8480874,Adam Ginning,D,PHI,24,8,1,1,2
20,8481719,Maxwell Crozier,D,TBL,24,12,1,1,2
20,8483512,Matthew Savoie,C,EDM,20,23,1,1,2
20,8477473,Justin Bailey,R,SJS,29,26,1,1,2
20,8474062,Riley Nash,C,NYR,35,14,1,1,2
20,8481806,Louis Crevier,D,CHI,23,13,1,1,2
20,8481043,Cole Koepke,L,BOS,26,20,1,1,2
20,8478446,Glenn Gawdin,C,LAK,27,12,1,1,2
20,8478146,Matthew Highmore,C,OTT,28,31,0,2,2
20,8482162,Roby Jarventie,L,EDM,22,18,0,2,2
20,8481593,Jayden Struble,D,MTL,23,19,0,2,2
20,8483489,Fraser Minten,C,TOR,31,14,0,2,2
20,8480267,Sammy Walker,C,MIN,25,18,0,2,2
20,8477149,Scott Sabourin,R,SJS,32,14,0,2,2
20,8481564,Ryan Johnson,D,BUF,23,18,0,2,2
20,8483407,Brandon Scanlin,D,NYR,25,6,1,0,1
20,8481206,John Ludvig,D,PIT,24,10,1,0,1
20,8479362,Riley Tufte,L,BOS,26,22,1,0,1
20,8481237,Kyle MacLean,C,NYI,25,21,1,0,1
20,8483471,Brad Lambert,C,WPG,31,12,1,0,1
20,8480032,Shane Bowers,C,NJD,25,10,1,0,1
20,8477320,Anton Blidh,L,NYR,29,11,1,0,1
20,8477073,Kurtis MacDermid,L,NJD,30,27,1,0,1
20,8482118,Sam Colangelo,R,ANA,23,10,1,0,1
20,8475755,Alexander Petrovic,D,DAL,32,7,1,0,1
20,8482088,Justin Sourdif,R,FLA,22,15,1,0,1
20,8483567,Georgii Merkulov,C,BOS,24,14,1,0,1
20,8478854,Ryan Shea,D,PIT,27,6,1,0,1
20,8482197,Adam Raska,R,MIN,23,11,1,0,1
20,8483597,Milos Kelemen,L,UTA,25,13,1,0,1
20,8480306,Grant Hutton,D,NYI,29,7,1,0,1
20,8478881,Brett Seney,L,CHI,28,13,0,1,1
20,8480245,Olle Lycksell,R,PHI,25,32,0,1,1
20,8478477,Mitchell Stephens,C,SEA,27,16,0,1,1
20,8481030,Jack St. Ivany,D,PIT,25,7,0,1,1
20,8475413,Justin Dowling,C,NJD,34,16,0,1,1
20,8484304,Uvis Balinskis,D,FLA,28,4,0,1,1
20,8483398,Declan Carlile,D,TBL,31,10,0,1,1
20,8477541,Dakota Mermis,D,TOR,30,10,0,1,1
20,8480075,Cameron Crotty,D,MIN,25,6,0,1,1
20,8482787,Nikita Chibrikov,R,WPG,31,10,0,1,1
20,8477527,Ross Johnston,L,ANA,30,32,0,0,0
20,8484325,Waltteri Merela,C,TBL,26,15,0,0,0
20,8480468,James Hamblin,L,EDM,25,15,0,0,0
20,8479330,Brandon Gignac,C,MTL,27,9,0,0,0
20,8478011,Louie Belpedio,D,PHI,28,10,0,0,0
20,8481006,Tyler Tucker,D,STL,24,13,0,0,0
20,8482516,Matthew Kessel,D,STL,24,12,0,0,0
20,8483920,Pierrick Dube,R,WSH,23,5,0,0,0
20,8480084,Nick DeSimone,D,NJD,30,21,0,0,0
20,8481462,Mason Morelli,L,VGK,28,10,0,0,0
20,8481726,Adam Edstrom,C,NYR,24,8,0,0,0
20,8478051,Max Willman,C,NJD,29,19,0,0,0
20,8479421,Jacob Moverare,D,LAK,26,3,0,0,0
20,8483546,Marshall Rifai,D,TOR,26,3,0,0,0
20,8479522,Hardy Haman Aktell,D,WSH,26,2,0,0,0
20,8483395,Arshdeep Bains,L,VAN,23,11,0,0,0
20,8481578,Graeme Clarke,R,MIN,23,8,0,0,0
20,8482460,Matt Rempe,C,NYR,22,9,0,0,0
20,8482476,Emil Heineman,L,MTL,23,7,0,0,0
20,8475780,Chris Wagner,R,COL,33,6,0,0,0
20,8481024,Linus Karlsson,C,VAN,25,9,0,0,0
20,8482126,Emil Andrae,D,PHI,31,2,0,0,0
20,8484255,Jason Polin,R,COL,25,3,0,0,0
20,8477993,Justin Kirkland,C,CGY,28,10,0,0,0
20,8481534,Raphael Lavoie,C,EDM,24,2,0,0,0
20,8483432,Luca Del Bel Belluz,C,CBJ,31,3,0,0,0
20,8476323,Max McCormick,L,SEA,32,4,0,0,0
20,8483401,Marc Johnstone,R,PIT,28,3,0,0,0
20,8481655,Cole Schwindt,R,CGY,23,2,0,0,0
20,8483531,Brian Halonen,L,NJD,25,2,0,0,0
20,8483609,Adam Klapka,R,CGY,24,3,0,0,0
20,8484259,Ondrej Pavel,C,COL,31,5,0,0,0
20,8484321,Nikolas Matinpalo,D,OTT,26,1,0,0,0
20,8484326,Patrik Koch,D,UTA,28,3,0,0,0
20,8470794,Joe Pavelski,C,,40,0,0,0,0
20,8479321,Lucas Johansen,D,,27,0,0,0,0
20,8477950,Tony DeAngelo,D,,29,0,0,0,0
20,8471218,Blake Wheeler,R,,38,0,0,0,0
20,8475197,Tyson Barrie,D,,33,0,0,0,0
20,8474157,Max Pacioretty,L,,36,0,0,0,0
20,8475744,Evgeny Kuznetsov,C,,32,0,0,0,0
20,8474037,James van Riemsdyk,L,,35,0,0,0,0
20,8476907,Mackenzie MacEachern,L,,30,0,0,0,0
20,8480216,Jacob Peterson,C,,25,0,0,0,0
20,8474602,Justin Schultz,D,,34,0,0,0,0
20,8482222,Alexander Barabanov,L,,30,0,0,0,0
20,8474031,Kevin Shattenkirk,D,,35,0,0,0,0
20,8477330,Dominik Kubalik,L,,29,0,0,0,0
20,8480884,Calen Addison,D,,24,0,0,0,0
20,8475906,John Klingberg,D,,32,0,0,0,0
20,8480008,Adam Ruzicka,C,,25,0,0,0,0
20,8476884,Derrick Pouliot,D,,30,0,0,0,0
20,8476919,Chris Tierney,C,,30,0,0,0,0
20,8479415,Michael McLeod,C,,26,0,0,0,0
20,8474870,Tyler Johnson,C,,34,0,0,0,0
20,8470604,Jeff Carter,C,,39,0,0,0,0
20,8478104,Sammy Blais,L,,28,0,0,0,0
20,8474884,Mike Hoffman,C,,35,0,0,0,0
20,8481591,Sam Poulin,R,,23,0,0,0,0
20,8471274,Alex Goligoski,D,,39,0,0,0,0
20,8476871,Tanner Pearson,L,,32,0,0,0,0
20,8476393,Nick Cousins,C,,31,0,0,0,0
20,8479977,Kailer Yamamoto,R,,26,0,0,0,0
20,8479346,Dillon Dube,C,,26,0,0,0,0
20,8480184,Gustav Lindstrom,D,,26,0,0,0,0
20,8479376,Victor Mete,D,,26,0,0,0,0
20,8473449,Kyle Okposo,R,,36,0,0,0,0
20,8481058,Jesse Ylonen,R,,25,0,0,0,0
20,8475752,Tyler Pitlick,C,,33,0,0,0,0
20,8481239,Samuel Fagemo,L,,24,0,0,0,0
20,8480821,Filip Zadina,R,,25,0,0,0,0
20,8470966,Mark Giordano,D,,41,0,0,0,0
20,8478495,Denis Gurianov,R,,27,0,0,0,0
20,8477464,Nic Petan,C,,29,0,0,0,0
20,8478099,Kevin Labanc,R,,29,0,0,0,0
20,8482241,Radim Zohorna,L,,28,0,0,0,0
20,8474040,Sam Gagner,C,,35,0,0,0,0
20,8479514,Rem Pitlick,C,,27,0,0,0,0
20,8478430,Oliver Kylington,D,,27,0,0,0,0
20,8479533,Joona Koppanen,L,,26,0,0,0,0
20,8479984,Cal Foote,D,,26,0,0,0,0
20,8477126,Jayson Megna,C,,34,0,0,0,0
20,8475164,Jakob Silfverberg,R,,34,0,0,0,0
20,8474009,Nick Bonino,C,,36,0,0,0,0
20,8479458,Nikita Zaitsev,D,,33,0,0,0,0
20,8477944,Jakub Vrana,L,,28,0,0,0,0
20,8471699,Andrew Cogliano,C,,37,0,0,0,0
20,8478067,Oskar Lindblom,L,,28,0,0,0,0
20,8471686,Marc Staal,D,,37,0,0,0,0
20,8470610,Zach Parise,L,,40,0,0,0,0
20,8478904,Steven Lorentz,C,,28,0,0,0,0
20,8473473,Milan Lucic,L,,36,0,0,0,0
20,8480031,Maxime Comtois,L,,25,0,0,0,0
20,8478512,Austin Czarnik,C,,32,0,0,0,0
20,8473504,Cal Clutterbuck,R,,37,0,0,0,0
20,8477454,Adam Erne,L,,29,0,0,0,0
20,8479383,Boris Katchouk,L,,26,0,0,0,0
20,8475825,Jani Hakanpää,D,,32,0,0,0,0
20,8477846,Ryan Carpenter,C,,33,0,0,0,0
20,8477930,Pierre-Edouard Bellemare,L,,39,0,0,0,0
20,8478400,Colin White,C,,27,0,0,0,0
20,8480226,Marián Studenic,R,,26,0,0,0,0
20,8480853,Liam Foudy,C,,24,0,0,0,0
20,8475797,Jarred Tinordi,D,,32,0,0,0,0
20,8479423,Alex Nylander,L,,26,0,0,0,0
20,8474618,Marco Scandella,D,,34,0,0,0,0
20,8478028,Fredrik Olofsson,L,,28,0,0,0,0
20,8474709,Matt Martin,L,,35,0,0,0,0
20,8481070,Hugh McGing,L,,26,0,0,0,0
20,8479546,Oskar Steen,C,,26,0,0,0,0
20,8474145,Robert Bortuzzo,D,,35,0,0,0,0
20,8476915,Jujhar Khaira,L,,30,0,0,0,0
20,8480274,Philip Kemp,D,EDM,25,2,0,0,0
20,8475278,Byron Froese,C,,33,0,0,0,0
20,8481812,Nikolai Knyzhov,D,,27,0,0,0,0
20,8478408,Travis Dermott,D,,28,0,0,0,0
20,8481077,John Leonard,L,,26,0,0,0,0
20,8479547,Matthew Phillips,R,,26,0,0,0,0
20,8480836,Jonathan Gruden,C,,24,0,0,0,0
20,8481690,Tyler Angle,C,,24,0,0,0,0
20,8475766,Austin Watson,L,,32,0,0,0,0
20,8481016,Ruslan Iskhakov,C,,24,0,0,0,0
20,8478078,Rourke Chartier,C,,28,0,0,0,0
20,8480776,Sheldon Rempal,R,,29,0,0,0,0
20,8478956,Samuel Laberge,L,NJD,27,1,0,0,0
20,8483045,Cameron Butler,R,CBJ,31,0,0,0,0
20,8484314,Jiri Smejkal,L,,28,0,0,0,0
21,8478402,Connor McDavid,C,EDM,27,80,51,113,164
21,8477492,Nathan MacKinnon,C,COL,29,81,56,103,159
21,8476453,Nikita Kucherov,R,TBL,31,82,46,104,150
21,8478420,Mikko Rantanen,R,COL,28,80,59,64,123
21,8481559,Jack Hughes,C,NJD,23,75,54,68,122
21,8479318,Auston Matthews,C,TOR,27,80,67,46,113
21,8476468,J.T. Miller,C,VAN,31,78,39,72,111
21,8477934,Leon Draisaitl,C,EDM,29,75,41,68,109
21,8478483,Mitch Marner,R,TOR,27,80,34,73,107
21,8480027,Jason Robertson,L,DAL,25,80,36,63,99
21,8474600,Roman Josi,D,NSH,34,78,17,82,99
21,8480069,Cale Makar,D,COL,26,73,30,67,97
21,8476887,Filip Forsberg,L,NSH,30,74,49,47,96
21,8482116,Tim Stützle,C,OTT,22,81,34,62,96
21,8477956,David Pastrnak,R,BOS,28,79,47,47,94
21,8478445,Mathew Barzal,C,NYI,27,80,19,74,93
21,8478864,Kirill Kaprizov,L,MIN,27,75,39,53,92
21,8477939,William Nylander,R,TOR,28,79,38,54,92
21,8476539,Jonathan Marchessault,R,NSH,34,73,53,37,90
21,8477493,Aleksander Barkov,C,FLA,29,82,23,67,90
21,8480012,Elias Pettersson,C,VAN,26,77,40,48,88
21,8476460,Mark Scheifele,C,WPG,31,73,38,50,88
21,8478550,Artemi Panarin,L,NYR,33,75,31,57,88
21,8480023,Robert Thomas,C,STL,25,77,29,57,86
21,8479385,Jordan Kyrou,C,STL,26,75,35,50,85
21,8477404,Jake Guentzel,C,TBL,30,82,41,42,83
21,8481557,Matt Boldy,L,MIN,23,75,37,46,83
21,8475166,John Tavares,C,TOR,34,75,34,49,83
21,8471675,Sidney Crosby,C,PIT,37,72,31,51,82
21,8479314,Matthew Tkachuk,L,FLA,27,73,22,60,82
21,8480800,Quinn Hughes,D,VAN,25,71,11,71,82
21,8475172,Nazem Kadri,C,CGY,34,78,27,54,81
21,8477946,Dylan Larkin,C,DET,28,81,39,41,80
21,8474564,Steven Stamkos,C,NSH,34,76,41,38,79
21,8478427,Sebastian Aho,C,CAR,27,70,29,50,79
21,8477960,Adrian Kempe,R,LAK,28,81,33,45,78
21,8477942,Kevin Fiala,L,LAK,28,81,30,48,78
21,8482078,Lucas Raymond,L,DET,22,82,30,48,78
21,8478439,Travis Konecny,R,PHI,27,73,27,50,77
21,8480865,Noah Dobson,D,NYI,24,80,23,54,77
21,8471685,Anze Kopitar,C,LAK,37,79,25,51,76
21,8480036,Miro Heiskanen,D,DAL,25,78,17,59,76
21,8479407,Jesper Bratt,L,NJD,26,75,29,46,75
21,8480801,Brady Tkachuk,L,OTT,25,77,32,42,74
21,8479343,Clayton Keller,R,UTA,26,77,31,43,74
21,8478414,Timo Meier,R,NJD,28,73,29,45,74
21,8476454,Ryan Nugent-Hopkins,C,EDM,31,75,16,58,74
21,8481540,Cole Caufield,R,MTL,23,76,38,34,72
21,8478403,Jack Eichel,C,VGK,28,79,32,40,72
21,8477402,Pavel Buchnevich,L,STL,29,73,31,41,72
21,8474679,Gustav Nyquist,C,NSH,35,71,25,47,72
21,8477501,Valeri Nichushkin,R,COL,29,81,39,32,71
21,8474141,Patrick Kane,R,DET,36,79,30,41,71
21,8479337,Alex DeBrincat,R,DET,27,81,28,43,71
21,8475168,Matt Duchene,C,DAL,33,82,23,48,71
21,8475692,Mats Zuccarello,R,MIN,37,67,14,57,71
21,8475184,Chris Kreider,L,NYR,33,78,46,24,70
21,8475784,Jeff Skinner,C,EDM,32,81,39,31,70
21,8478010,Brayden Point,C,TBL,28,82,34,36,70
21,8478449,Roope Hintz,C,DAL,28,79,32,38,70
21,8477951,Nick Schmaltz,C,UTA,28,79,28,42,70
21,8482665,Matty Beniers,C,SEA,22,76,27,43,70
21,8479542,Brandon Hagel,L,TBL,26,81,27,43,70
21,8480018,Nick Suzuki,C,MTL,25,76,22,48,70
21,8478398,Kyle Connor,L,WPG,28,69,39,30,69
21,8477933,Sam Reinhart,C,FLA,29,80,30,39,69
21,8475913,Mark Stone,R,VGK,32,77,26,43,69
21,8484144,Connor Bedard,C,CHI,19,67,17,52,69
21,8476448,William Karlsson,C,VGK,31,77,31,37,68
21,8476456,Jonathan Huberdeau,C,CGY,31,77,15,53,68
21,8473986,Alex Killorn,L,ANA,35,73,26,41,67
21,8477504,Josh Morrissey,D,WPG,29,76,13,54,67
21,8477409,Carter Verhaeghe,C,FLA,29,78,38,28,66
21,8478444,Brock Boeser,R,VAN,27,69,33,33,66
21,8482093,Seth Jarvis,C,CAR,22,70,30,36,66
21,8475754,Brock Nelson,C,NYI,33,80,28,38,66
21,8480002,Nico Hischier,C,NJD,25,75,26,40,66
21,8475158,Ryan O'Reilly,C,NSH,33,70,24,42,66
21,8479323,Adam Fox,D,NYR,26,71,11,55,66
21,8481528,Dylan Cozens,C,BUF,23,76,31,34,65
21,8471215,Evgeni Malkin,C,PIT,38,72,29,36,65
21,8476875,Mike Matheson,D,MTL,30,79,21,44,65
21,8476346,Johnny Gaudreau,L,CBJ,31,72,18,47,65
21,8470613,Brent Burns,D,CAR,39,74,15,50,65
21,8478460,Zach Werenski,D,CBJ,27,80,12,53,65
21,8482740,Wyatt Johnston,C,DAL,21,80,32,32,64
21,8474102,David Perron,L,OTT,36,76,29,35,64
21,8480039,Martin Necas,C,CAR,25,71,15,49,64
21,8471214,Alex Ovechkin,L,WSH,39,73,32,31,63
21,8480830,Andrei Svechnikov,R,CAR,24,71,31,32,63
21,8479675,Trevor Moore,L,LAK,29,81,27,36,63
21,8483515,Juraj Slafkovsky,L,MTL,20,76,25,38,63
21,8478873,Troy Terry,R,ANA,27,76,23,40,63
21,8475786,Zach Hyman,L,EDM,32,79,35,27,62
21,8482699,Dylan Guenther,R,UTA,21,76,27,35,62
21,8475765,Vladimir Tarasenko,R,DET,33,79,25,37,62
21,8477940,Nikolaj Ehlers,L,WPG,28,67,24,38,62
21,8478401,Pavel Zacha,C,BOS,27,80,23,39,62
21,8476853,Morgan Rielly,D,TOR,30,67,4,58,62
21,8477955,Jared McCann,L,SEA,28,75,29,32,61
21,8477986,Brandon Montour,D,SEA,30,76,21,40,61
21,8474578,Erik Karlsson,D,PIT,34,78,13,48,61
21,8477447,Shea Theodore,D,VGK,29,64,12,49,61
21,8477500,Bo Horvat,C,NYI,29,78,30,30,60
21,8473419,Brad Marchand,L,BOS,36,79,26,34,60
21,8477949,Alex Tuch,R,BUF,28,70,24,36,60
21,8473512,Claude Giroux,R,OTT,36,81,20,40,60
21,8475151,Kyle Palmieri,C,NYI,33,76,28,31,59
21,8480208,Drake Batherson,R,OTT,26,79,17,42,59
21,8479999,Casey Mittelstadt,C,COL,26,81,15,44,59
21,8473994,Jamie Benn,L,DAL,35,82,28,30,58
21,8478440,Dylan Strome,C,WSH,27,68,27,31,58
21,8480839,Rasmus Dahlin,D,BUF,24,70,17,41,58
21,8477503,Max Domi,C,TOR,29,74,24,33,57
21,8480015,Owen Tippett,R,PHI,25,78,24,33,57
21,8476459,Mika Zibanejad,C,NYR,31,74,23,34,57
21,8475726,Tyler Toffoli,C,SJS,32,71,22,35,57
21,8482684,Luke Hughes,D,NJD,21,76,9,48,57
21,8478975,Mason Marchment,L,DAL,29,81,24,32,56
21,8477497,Sean Monahan,C,CBJ,30,66,18,38,56
21,8475167,Victor Hedman,D,TBL,34,80,15,41,56
21,8481577,Philip Tomasino,C,NSH,23,68,14,41,55
21,8480014,Gabriel Vilardi,C,WPG,25,66,32,22,54
21,8478856,Conor Garland,R,VAN,28,71,24,30,54
21,8479420,Tage Thompson,C,BUF,27,70,28,25,53
21,8477932,Aaron Ekblad,D,FLA,28,79,23,30,53
21,8478047,Michael Bunting,L,PIT,29,72,22,31,53
21,8474586,Jordan Eberle,R,SEA,34,77,22,31,53
21,8478042,Viktor Arvidsson,L,EDM,31,75,16,37,53
21,8474590,John Carlson,D,WSH,34,70,12,41,53
21,8475810,Bryan Rust,R,PIT,32,68,25,27,52
21,8483808,Andrei Kuzmenko,L,CGY,28,78,25,27,52
21,8477935,Sam Bennett,C,FLA,28,75,25,27,52
21,8481068,Yegor Sharangovich,C,CGY,26,81,25,27,52
21,8475794,Tyler Seguin,C,DAL,32,79,24,28,52
21,8476483,Rickard Rakell,R,PIT,31,75,19,33,52
21,8477416,Oliver Bjorkstrand,R,SEA,29,75,16,36,52
21,8477494,Jonathan Drouin,L,COL,29,82,16,36,52
21,8474150,Mikael Backlund,C,CGY,35,78,16,36,52
21,8476792,Torey Krug,D,STL,33,74,11,41,52
21,8477346,MacKenzie Weegar,D,CGY,30,77,8,44,52
21,8478038,Devon Toews,D,COL,30,73,8,44,52
21,8477407,Anthony Duclair,L,NYI,29,77,31,20,51
21,8474641,Adam Henrique,C,EDM,34,78,26,25,51
21,8476399,Blake Coleman,C,CGY,33,78,23,28,51
21,8480028,Morgan Frost,C,PHI,25,76,20,31,51
21,8476462,Dougie Hamilton,D,NJD,31,63,15,36,51
21,8480803,Evan Bouchard,D,EDM,25,76,11,40,51
21,8475314,Anders Lee,L,NYI,34,80,30,20,50
21,8477511,Anthony Mantha,R,CGY,30,77,25,25,50
21,8476881,Tomas Hertl,C,VGK,31,70,23,27,50
21,8482159,Tyson Foerster,R,PHI,22,74,23,27,50
21,8477964,Ivan Barbashev,C,VGK,29,77,22,28,50
21,8481711,Matias Maccelli,L,UTA,24,79,19,31,50
21,8478493,Joel Eriksson Ek,C,MIN,27,72,17,33,50
21,8481533,Trevor Zegras,C,ANA,23,73,15,35,50
21,8477021,Alex Kerfoot,C,UTA,30,75,11,39,50
21,8476958,Jaccob Slavin,D,CAR,30,75,10,40,50
21,8476432,Boone Jenner,C,CBJ,31,71,29,20,49
21,8477476,Artturi Lehkonen,L,COL,29,81,25,24,49
21,8481560,Arthur Kaliyev,R,LAK,23,79,22,27,49
21,8482110,Dawson Mercer,C,NJD,23,73,17,32,49
21,8476906,Shayne Gostisbehere,D,CAR,31,72,12,37,49
21,8478519,Anthony Cirelli,C,TBL,27,82,25,23,48
21,8479400,Pierre-Luc Dubois,L,WSH,26,70,24,24,48
21,8476292,Ondrej Palat,L,NJD,33,69,16,32,48
21,8476905,Chandler Stephenson,C,SEA,30,74,15,33,48
21,8478542,Evan Rodrigues,C,FLA,31,75,14,34,48
21,8478407,Vince Dunn,D,SEA,28,74,6,42,48
21,8482097,Jack Quinn,R,BUF,23,67,22,25,47
21,8477456,J.T. Compher,L,DET,29,79,18,29,47
21,8475745,Charlie Coyle,C,BOS,32,78,18,29,47
21,8480188,Fabian Zetterlund,L,SJS,25,65,17,30,47
21,8482124,Quinton Byfield,R,LAK,22,80,16,31,47
21,8477496,Elias Lindholm,C,BOS,30,73,13,34,47
21,8478397,Rasmus Andersson,D,CGY,28,72,11,36,47
21,8478366,Frank Vatrano,R,ANA,30,76,29,17,46
21,8475218,Mattias Ekholm,D,EDM,34,73,18,28,46
21,8481581,Thomas Harley,D,DAL,23,72,12,34,46
21,8476463,Jonas Brodin,D,MIN,31,77,8,38,46
21,8480829,Jesperi Kotkaniemi,C,CAR,24,71,25,20,45
21,8475170,Brayden Schenn,C,STL,33,69,23,22,45
21,8477998,Warren Foegele,L,LAK,28,80,23,22,45
21,8471698,T.J. Oshie,R,WSH,38,64,19,26,45
21,8482113,Anton Lundell,C,FLA,23,78,18,27,45
21,8476882,Teuvo Teravainen,C,CHI,30,61,18,27,45
21,8482745,Mason McTavish,C,ANA,21,72,16,29,45
21,8476480,Vladislav Namestnikov,C,WPG,32,69,15,30,45
21,8471724,Kris Letang,D,PIT,37,77,14,31,45
21,8474563,Drew Doughty,D,LAK,35,72,12,33,45
21,8481186,Logan O'Connor,R,COL,28,80,21,23,44
21,8475287,Erik Haula,L,NJD,33,69,19,25,44
21,8480064,Josh Norris,C,OTT,25,78,18,26,44
21,8482149,Cole Perfetti,C,WPG,22,69,16,28,44
21,8478498,Jake DeBrusk,L,VAN,28,69,15,29,44
21,8481524,Bowen Byram,D,BUF,23,66,12,32,44
21,8475169,Evander Kane,L,EDM,33,73,22,21,43
21,8478115,Pierre Engvall,L,NYI,28,79,20,23,43
21,8476826,Yanni Gourde,C,SEA,33,72,16,27,43
21,8478466,Daniel Sprong,R,VAN,27,70,14,29,43
21,8475798,Mikael Granlund,C,SJS,32,71,12,31,43
21,8482092,Ridly Greig,C,OTT,22,81,22,20,42
21,8482667,William Eklund,L,SJS,22,67,21,21,42
21,8476872,Scott Laughton,C,PHI,30,79,19,23,42
21,8484153,Leo Carlsson,C,ANA,20,77,16,26,42
21,8480043,Timothy Liljegren,D,TOR,25,71,8,34,42
21,8479525,Ross Colton,C,COL,28,81,26,15,41
21,8482702,Logan Stankoven,C,DAL,21,81,20,21,41
21,8476479,Phillip Danault,C,LAK,31,82,17,24,41
21,8477479,Tyler Bertuzzi,L,CHI,29,66,14,27,41
21,8480113,Alex Iafallo,L,WPG,31,69,14,27,41
21,8482720,Matthew Knies,L,TOR,22,77,13,28,41
21,8481624,Ilya Mikheyev,R,CHI,30,68,24,16,40
21,8478474,Lawson Crouse,L,UTA,27,76,23,17,40
21,8483431,Logan Cooley,C,UTA,20,74,20,20,40
21,8478458,John (Jack) Roslovic,C,CAR,27,67,20,20,40
21,8474149,Evgenii Dadonov,R,DAL,35,80,18,22,40
21,8484166,Adam Fantilli,C,CBJ,20,65,14,26,40
21,8475191,Reilly Smith,R,NYR,33,74,13,27,40
21,8481546,Cam York,D,PHI,23,69,12,28,40
21,8478396,Noah Hanifin,D,VGK,27,69,8,32,40
21,8476438,Brandon Saad,L,STL,32,73,24,15,39
21,8475768,Jaden Schwartz,C,SEA,32,67,21,18,39
21,8481553,Bobby Brink,R,PHI,23,59,18,21,39
21,8478233,Andrew Mangiapane,L,WSH,28,69,17,22,39
21,8477451,Ryan Hartman,R,MIN,30,70,17,22,39
21,8476389,Vincent Trocheck,C,NYR,31,73,15,24,39
21,8478472,Mathieu Joseph,R,STL,27,73,12,27,39
21,8479425,Filip Hronek,D,VAN,27,68,9,30,39
21,8477948,Travis Sanheim,D,PHI,28,65,9,30,39
21,8477969,Marcus Pettersson,D,PIT,28,80,9,30,39
21,8478438,Tommy Novak,C,NSH,27,72,7,32,39
21,8479410,Mikhail Sergachev,D,UTA,26,65,5,34,39
21,8475799,Nino Niederreiter,R,WPG,32,66,26,12,38
21,8477425,Miles Wood,L,COL,29,76,26,12,38
21,8476880,Tom Wilson,R,WSH,30,69,19,19,38
21,8473422,Nick Foligno,L,CHI,37,62,17,21,38
21,8481618,Alex Newhook,C,MTL,23,71,15,23,38
21,8481596,Shane Pinto,C,OTT,24,78,13,25,38
21,8482109,Alexis Lafrenière,L,NYR,23,74,18,19,37
21,8480835,Jack Drury,C,CAR,24,59,17,20,37
21,8479339,Patrik Laine,L,CBJ,26,68,14,23,37
21,8478469,Thomas Chabot,D,OTT,27,74,13,24,37
21,8475793,Ryan Johansen,C,PHI,32,72,13,24,37
21,8483490,Pavel Mintyukov,D,ANA,21,73,13,24,37
21,8478462,Nicolas Roy,C,VGK,27,67,12,25,37
21,8476925,Colton Sissons,C,NSH,31,65,10,27,37
21,8480145,Neal Pionk,D,WPG,29,73,7,30,37
21,8481703,Valtteri Puustinen,R,PIT,25,67,7,30,37
21,8480797,Joel Farabee,L,PHI,24,71,17,19,36
21,8476419,Jean-Gabriel Pageau,C,NYI,32,76,17,19,36
21,8480220,Noah Cates,L,PHI,25,79,14,22,36
21,8476461,Sean Couturier,C,PHI,32,67,13,23,36
21,8482475,Yegor Chinakhov,R,CBJ,23,63,12,24,36
21,8476927,Teddy Blueger,C,VAN,30,65,11,25,36
21,8478970,Jalen Chatfield,D,CAR,28,73,11,25,36
21,8480789,Oliver Wahlstrom,R,NYI,24,73,10,26,36
21,8475722,Jason Zucker,L,BUF,32,66,9,27,36
21,8476923,Damon Severson,D,CBJ,30,82,9,27,36
21,8482133,Thomas Bordeleau,C,SJS,22,66,9,27,36
21,8477495,Seth Jones,D,CHI,30,63,7,29,36
21,8477506,Ryan Pulock,D,NYI,30,76,7,29,36
21,8475753,Justin Faulk,D,STL,32,71,6,30,36
21,8480893,Kirill Marchenko,R,CBJ,24,61,22,13,35
21,8479351,Sam Steel,C,DAL,26,76,14,21,35
21,8480009,Eeli Tolvanen,R,SEA,25,74,13,22,35
21,8480798,Philipp Kurashev,C,CHI,25,62,11,24,35
21,8482671,Owen Power,D,BUF,22,70,8,27,35
21,8476854,Hampus Lindholm,D,BOS,30,76,6,29,35
21,8478046,Danton Heinen,L,VAN,29,64,16,18,34
21,8477444,Andre Burakovsky,L,SEA,29,72,13,21,34
21,8484145,Zach Benson,L,BUF,19,68,13,21,34
21,8478413,Jordan Greenway,L,BUF,27,69,10,24,34
21,8479325,Charlie McAvoy,D,BOS,27,76,9,25,34
21,8476869,Brady Skjei,D,NSH,30,72,6,28,34
21,8481542,Moritz Seider,D,DET,23,75,5,29,34
21,8478057,Dakota Joshua,C,VAN,28,69,17,16,33
21,8479992,Michael Rasmussen,C,DET,25,79,15,18,33
21,8480068,Ryan Poehling,C,PHI,25,68,15,18,33
21,8483445,Cutter Gauthier,L,ANA,20,65,14,19,33
21,8478109,Victor Olofsson,L,VGK,29,68,13,20,33
21,8481656,Aliaksei Protas,C,WSH,23,70,11,22,33
21,8482660,Kent Johnson,C,CBJ,22,66,10,23,33
21,8482712,Oskar Olausson,R,COL,22,77,3,30,33
21,8481604,Pavel Dorofeyev,L,VGK,24,71,20,12,32
21,8477426,Nicholas Paul,L,TBL,29,82,19,13,32
21,8481481,Blake Lizotte,C,PIT,27,57,18,14,32
21,8482146,Luke Evangelista,R,NSH,22,68,15,17,32
21,8478891,Mason Appleton,C,WPG,28,63,15,17,32
21,8475343,Nic Dowd,C,WSH,34,63,14,18,32
21,8475231,Casey Cizikas,C,NYI,33,75,12,20,32
21,8479591,Michael Eyssimont,C,TBL,28,80,7,25,32
21,8476979,Erik Gustafsson,D,DET,32,79,5,27,32
21,8475714,Calle Jarnkrok,C,TOR,33,71,21,10,31
21,8482175,JJ Peterka,R,BUF,22,65,17,14,31
21,8482125,Alexander Holtz,R,VGK,22,59,17,14,31
21,8474715,Cameron Atkinson,R,TBL,35,80,16,15,31
21,8474053,Logan Couture,C,SJS,35,63,15,16,31
21,8479996,Cody Glass,C,NSH,25,53,15,16,31
21,8475149,Marcus Johansson,L,MIN,34,69,14,17,31
21,8477429,Andrew Copp,C,DET,30,78,13,18,31
21,8476474,Stefan Noesen,R,NJD,31,71,12,19,31
21,8474565,Alex Pietrangelo,D,VGK,34,65,7,24,31
21,8477498,Darnell Nurse,D,EDM,29,69,6,25,31
21,8481014,Alexander Romanov,D,NYI,24,75,4,27,31
21,8474151,Ryan McDonagh,D,TBL,35,80,2,29,31
21,8475848,Brendan Gallagher,R,MTL,32,73,16,14,30
21,8481523,Kirby Dach,C,MTL,23,70,13,17,30
21,8480849,Barrett Hayton,C,UTA,24,72,9,21,30
21,8480748,Kiefer Sherwood,L,VAN,29,65,9,21,30
21,8482122,Brock Faber,D,MIN,22,77,8,22,30
21,8475763,Kevin Hayes,R,PIT,32,70,7,23,30
21,8479345,Jakob Chychrun,D,WSH,26,65,5,25,30
21,8480817,K'Andre Miller,D,NYR,24,72,4,26,30
21,8480873,Rasmus Sandin,D,WSH,24,64,4,26,30
21,8481535,Nils Hoglander,L,VAN,24,68,20,9,29
21,8482055,Drew O'Connor,L,PIT,26,62,18,11,29
21,8477987,Ryan Donato,C,CHI,28,56,17,12,29
21,8482089,Jake Neighbours,L,STL,22,72,14,15,29
21,8475193,Tomas Tatar,L,NJD,34,67,14,15,29
21,8477952,Robby Fabbri,C,ANA,28,66,14,15,29
21,8476981,Josh Anderson,R,MTL,30,70,13,16,29
21,8482749,Joshua Roy,R,MTL,21,64,12,17,29
21,8480871,Adam Boqvist,D,FLA,24,71,10,19,29
21,8480336,Sean Walker,D,CAR,30,73,9,20,29
21,8479365,Trent Frederic,C,BOS,26,77,8,21,29
21,8482142,Jamie Drysdale,D,PHI,22,61,6,23,29
21,8479982,Conor Timmins,D,TOR,26,60,5,24,29
21,8476525,Colin Miller,D,WPG,32,65,5,24,29
21,8475760,Nick Bjugstad,C,UTA,32,72,18,10,28
21,8476897,Oskar Sundqvist,C,STL,30,66,13,15,28
21,8477450,Jason Dickinson,C,CHI,29,52,13,15,28
21,8482705,Cole Sillinger,C,CBJ,21,63,12,16,28
21,8483505,Matthew Poitras,C,BOS,20,75,12,16,28
21,8478463,Anthony Beauvillier,L,PIT,27,66,12,16,28
21,8479414,Nathan Bastian,R,NJD,27,57,11,17,28
21,8477505,Alexander Wennberg,C,SJS,30,70,10,18,28
21,8477947,Sonny Milano,L,WSH,28,66,9,19,28
21,8478055,Gustav Forsling,D,FLA,28,69,8,20,28
21,8481606,Jordan Spence,D,LAK,23,62,8,20,28
21,8480434,Sean Durzi,D,UTA,26,65,6,22,28
21,8475181,Nick Leddy,D,STL,33,60,6,22,28
21,8481580,Connor McMichael,C,WSH,23,66,20,7,27
21,8477478,William Carrier,L,CAR,30,59,17,10,27
21,8479661,Tanner Jeannot,L,LAK,27,76,15,12,27
21,8483524,Shane Wright,C,SEA,20,66,12,15,27
21,8480078,Filip Chytil,C,NYR,25,69,12,15,27
21,8482117,Lukas Reichel,L,CHI,22,59,12,15,27
21,8481704,Juuso Parssinen,C,NSH,23,56,10,17,27
21,8475791,Taylor Hall,L,CHI,33,56,9,18,27
21,8480762,Eric Robinson,L,CAR,29,64,9,18,27
21,8473563,Nicklas Backstrom,C,WSH,37,56,8,19,27
21,8483565,Nick Blankenburg,D,NSH,26,68,8,19,27
21,8475764,Cam Fowler,D,ANA,33,77,5,22,27
21,8474189,Lars Eller,C,PIT,35,68,13,13,26
21,8477989,Christian Dvorak,C,MTL,28,67,11,15,26
21,8476885,Jacob Trouba,D,NYR,30,69,11,15,26
21,8480448,Parker Kelly,L,COL,25,71,11,15,26
21,8477953,Kasperi Kapanen,R,STL,28,70,10,16,26
21,8475171,Oliver Ekman-Larsson,D,TOR,33,66,10,16,26
21,8482737,Zack Bolduc,C,STL,21,59,8,18,26
21,8475200,Dmitry Orlov,D,CAR,33,73,6,20,26
21,8480073,Erik Brannstrom,D,COL,25,58,4,22,26
21,8476902,Esa Lindell,D,DAL,30,75,4,22,26
21,8476331,Dylan DeMelo,D,WPG,31,64,3,23,26
21,8480459,Pius Suter,C,VAN,28,70,15,10,25
21,8482105,Jake Sanderson,D,OTT,22,74,14,11,25
21,8481582,Nicholas Robertson,L,TOR,23,67,14,11,25
21,8479390,Taylor Raddysh,R,WSH,26,61,13,12,25
21,8479987,Morgan Geekie,C,BOS,26,74,12,13,25
21,8482062,Cole Smith,L,NSH,29,58,11,14,25
21,8479316,Luke Kunin,C,SJS,27,58,11,14,25
21,8476392,Adam Lowry,C,WPG,31,68,10,15,25
21,8476921,Jordan Martinook,L,CAR,32,64,9,16,25
21,8478500,Ivan Provorov,D,CBJ,27,77,8,17,25
21,8482111,Justin Barron,D,MTL,23,69,6,19,25
21,8482067,Connor Mackey,D,NYR,28,63,6,19,25
21,8476422,Mike Reilly,D,NYI,31,74,4,21,25
21,8477435,Ryan Graves,D,PIT,29,76,3,22,25
21,8479398,Samuel Girard,D,COL,26,65,2,23,25
21,8479293,Brandon Tanev,L,SEA,33,62,15,9,24
21,8479941,Justin Danforth,R,CBJ,31,60,13,11,24
21,8473453,Trevor Lewis,C,LAK,37,72,12,12,24
21,8475220,Marcus Foligno,L,MIN,33,65,12,12,24
21,8479393,Noah Gregor,L,OTT,26,74,11,13,24
21,8478020,Michael Amadio,R,OTT,28,71,10,14,24
21,8477979,Nicolas Aube-Kubel,R,BUF,28,64,10,14,24
21,8482809,Jackson Blake,R,CAR,21,55,9,15,24
21,8477839,Conor Sheary,L,TBL,32,82,8,16,24
21,8476960,Andreas Athanasiou,C,CHI,30,52,7,17,24
21,8476458,Ryan Strome,C,ANA,31,71,6,18,24
21,8482655,Janis Moser,D,TBL,24,78,6,18,24
21,8476917,Adam Pelech,D,NYI,30,79,3,21,24
21,8476931,Jake McCabe,D,TOR,31,70,3,21,24
21,8479998,Mikey Anderson,D,LAK,25,66,2,22,24
21,8484203,Bradly Nadeau,L,CAR,19,60,12,11,23
21,8470621,Corey Perry,R,EDM,39,72,12,11,23
21,8476374,Sean Kuraly,C,CBJ,31,63,12,11,23
21,8478013,Jake Walman,D,SJS,28,72,11,12,23
21,8478133,Jake Evans,C,MTL,28,68,10,13,23
21,8476329,Travis Boyd,C,MIN,31,59,10,13,23
21,8481554,Kaapo Kakko,R,NYR,23,73,9,14,23
21,8483457,Lane Hutson,D,MTL,20,66,7,16,23
21,8480003,Jesper Boqvist,C,FLA,26,65,7,16,23
21,8478507,John Marino,D,UTA,27,70,6,17,23
21,8473507,Jeff Petry,D,DET,37,69,5,18,23
21,8478911,Matt Roy,D,WSH,29,70,4,19,23
21,8479402,Jake Bean,D,CGY,26,68,4,19,23
21,8478851,Alexandre Carrier,D,NSH,28,60,4,19,23
21,8475233,David Savard,D,MTL,34,68,3,20,23
21,8482074,Connor Zary,C,CGY,23,53,17,5,22
21,8481093,Rafael Harvey-Pinard,L,MTL,25,61,12,10,22
21,8477392,Hudson Fasching,R,NYI,29,62,11,11,22
21,8480205,Emil Bemstrom,C,PIT,25,57,11,11,22
21,8480855,Jack McBain,C,UTA,24,69,10,12,22
21,8476889,Radek Faksa,C,STL,30,56,9,13,22
21,8480185,Eetu Luostarinen,C,FLA,26,74,8,14,22
21,8479066,Ryan Lomberg,L,CGY,30,67,8,14,22
21,8482101,Danil Gushchin,L,SJS,22,58,7,15,22
21,8477488,Brett Pesce,D,NJD,30,69,6,16,22
21,8481178,Egor Zamula,D,PHI,24,62,3,19,22
21,8478136,Jake Middleton,D,MIN,28,74,3,19,22
21,8480001,Urho Vaakanainen,D,ANA,25,57,2,20,22
21,8477406,Mattias Janmark,C,EDM,32,63,15,6,21
21,8482679,Matt Coronato,R,CGY,22,66,13,8,21
21,8482259,Bobby McMann,C,TOR,28,60,12,9,21
21,8477903,Garnet Hathaway,R,PHI,33,63,11,10,21
21,8480806,Isac Lundestrom,C,ANA,25,56,11,10,21
21,8473533,Jordan Staal,C,CAR,36,62,10,11,21
21,8480995,Pontus Holmberg,R,TOR,25,58,10,11,21
21,8476878,Zemgus Girgensons,C,TBL,30,77,10,11,21
21,8478569,Noel Acciari,C,PIT,33,53,10,11,21
21,8477369,Carson Soucy,D,VAN,30,61,10,11,21
21,8476278,Colin Blackwell,C,DAL,31,79,8,13,21
21,8476312,Josh Manson,D,COL,33,59,8,13,21
21,8480144,David Kampf,C,TOR,29,73,8,13,21
21,8475462,Radko Gudas,D,ANA,34,69,7,14,21
21,8481568,Alex Vlasic,D,CHI,23,50,7,14,21
21,8474034,Patrick Maroon,L,CHI,36,60,7,14,21
21,8475790,Erik Gudbranson,D,CBJ,32,75,5,16,21
21,8476457,Adam Larsson,D,SEA,32,70,4,17,21
21,8474574,Tyler Myers,D,VAN,34,68,4,17,21
21,8476892,Colton Parayko,D,STL,31,69,3,18,21
21,8476967,Brett Kulak,D,EDM,30,63,2,19,21
21,8480049,Dylan Samberg,D,WPG,25,64,1,20,21
21,8478043,Sam Lafferty,C,BUF,29,66,11,9,20
21,8477446,Michael McCarron,R,NSH,29,55,9,11,20
21,8477015,Connor Brown,R,EDM,30,58,7,13,20
21,8476879,Cody Ceci,D,EDM,31,74,7,13,20
21,8480878,Nils Lundkvist,D,DAL,24,73,5,15,20
21,8479639,Dylan Coghlan,D,WPG,26,61,4,16,20
21,8476467,Jamie Oleksiak,D,SEA,32,63,3,17,20
21,8478399,Jonas Siegenthaler,D,NJD,27,57,3,17,20
21,8482087,Kaiden Guhle,D,MTL,22,68,1,19,20
21,8481019,David Gustafsson,C,WPG,24,52,1,19,20
21,8480807,Mattias Samuelsson,D,BUF,24,62,0,20,20
21,8478508,Yakov Trenin,C,MIN,27,61,14,5,19
21,8482079,Marco Rossi,C,MIN,23,49,12,7,19
21,8483493,Frank Nazar,C,CHI,20,54,11,8,19
21,8477919,Frederick Gaudreau,C,MIN,31,69,8,11,19
21,8479344,Jesse Puljujarvi,R,PIT,26,53,8,11,19
21,8481599,Victor Soderstrom,D,UTA,23,50,5,14,19
21,8478178,Darren Raddysh,D,TBL,28,71,4,15,19
21,8480796,Martin Fehervary,D,WSH,25,46,4,15,19
21,8476918,Jimmy Vesey,L,NYR,31,70,10,8,18
21,8481517,Brett Leason,R,ANA,25,62,10,8,18
21,8476469,Joel Armia,R,MTL,31,66,10,8,18
21,8475855,Jesper Fast,R,CAR,33,52,9,9,18
21,8479336,Carl Grundstrom,R,SJS,27,54,8,10,18
21,8483468,Jiri Kulich,C,BUF,20,59,8,10,18
21,8480813,Joe Veleno,C,DET,24,77,7,11,18
21,8481617,Vasily Podkolzin,R,VAN,23,45,6,12,18
21,8482192,Isaak Phillips,D,CHI,23,56,3,15,18
21,8480887,Jordan Harris,D,MTL,24,49,3,15,18
21,8477845,Trevor van Riemsdyk,D,WSH,33,57,3,15,18
21,8476988,Matt Benning,D,SJS,30,61,2,16,18
21,8474673,TJ Brodie,D,CHI,34,56,2,16,18
21,8482652,Walker Duehr,R,CGY,27,43,11,6,17
21,8477353,Tyler Motte,C,DET,29,74,10,7,17
21,8480802,Ryan McLeod,C,BUF,25,59,9,8,17
21,8481032,Paul Cotter,C,NJD,25,58,9,8,17
21,8480074,Alexandre Texier,C,STL,25,55,9,8,17
21,8477508,Curtis Lazar,C,NJD,29,56,9,8,17
21,8479619,Michael Carcone,L,UTA,28,53,9,8,17
21,8482148,Hendrix Lapierre,C,WSH,22,49,8,9,17
21,8479328,Julien Gauthier,R,NYI,27,61,8,9,17
21,8479315,Joey Anderson,R,CHI,26,50,6,11,17
21,8479370,Tyson Jost,C,CAR,26,47,5,12,17
21,8482803,Olen Zellweger,D,ANA,21,68,5,12,17
21,8477507,Nikita Zadorov,D,BOS,29,69,4,13,17
21,8479324,Ryan Lindgren,D,NYR,26,65,4,13,17
21,8475455,Brenden Dillon,D,NJD,34,61,4,13,17
21,8482624,Daniil Miromanov,D,CGY,27,70,3,14,17
21,8479369,Andrew Peeke,D,BOS,26,60,1,16,17
21,8478840,Will Borgen,D,SEA,28,56,1,16,17
21,8475690,Chris Tanev,D,TOR,35,56,0,17,17
21,8482730,Brandt Clarke,D,LAK,21,57,0,17,17
21,8475225,Craig Smith,C,CHI,35,49,10,6,16
21,8478421,A.J. Greer,L,FLA,28,56,9,7,16
21,8481716,Dmitri Voronkov,L,CBJ,24,40,9,7,16
21,8479368,Max Jones,L,BOS,26,64,8,8,16
21,8482659,Josh Doan,R,UTA,22,53,8,8,16
21,8479983,Mario Ferraro,D,SJS,26,73,6,10,16
21,8481537,Nikita Okhotiuk,D,CGY,24,47,6,10,16
21,8476442,Matt Nieto,L,PIT,32,48,6,10,16
21,8478882,Vladislav Gavrikov,D,LAK,29,70,5,11,16
21,8476873,Mark Jankowski,C,NSH,30,53,5,11,16
21,8479543,Michael Pezzetta,L,MTL,26,46,5,11,16
21,8479353,Brett Howden,C,VGK,26,71,4,12,16
21,8481521,Ronnie Attard,D,PHI,25,60,4,12,16
21,8479986,Kole Lind,R,DAL,26,59,4,12,16
21,8475188,Brayden McNabb,D,VGK,33,51,3,13,16
21,8481527,Kaedan Korczak,D,VGK,23,52,3,13,16
21,8471709,Marc-Edouard Vlasic,D,SJS,37,57,3,13,16
21,8475324,Nick Jensen,D,OTT,34,66,2,14,16
21,8480172,Jan Rutta,D,SJS,34,68,2,14,16
21,8480289,Morgan Barron,C,WPG,26,52,10,5,15
21,8482762,Simon Edvinsson,D,DET,21,56,10,5,15
21,8481028,Martin Pospisil,C,CGY,25,55,9,6,15
21,8481601,Simon Holmstrom,R,NYI,23,68,8,7,15
21,8480355,Mark Kastelic,C,BOS,25,62,8,7,15
21,8478432,Christian Fischer,R,DET,27,74,7,8,15
21,8481477,Nico Sturm,C,SJS,29,55,7,8,15
21,8480848,Ty Dellandrea,C,SJS,24,47,7,8,15
21,8480021,Jack Studnicka,C,LAK,25,55,7,8,15
21,8480192,Johnathan Kovacevic,D,NJD,27,51,5,10,15
21,8479976,Juuso Valimaki,D,UTA,26,63,4,11,15
21,8481522,Peyton Krebs,C,BUF,23,54,4,11,15
21,8483491,Ivan Miroshnichenko,L,WSH,20,54,4,11,15
21,8480246,Nick Perbix,D,TBL,26,76,4,11,15
21,8481641,Joel Kiviranta,L,COL,28,76,4,11,15
21,8480035,Henri Jokiharju,D,BUF,25,67,3,12,15
21,8478468,Jeremy Lauzon,D,NSH,27,56,3,12,15
21,8476429,Scott Mayfield,D,NYI,32,78,1,14,15
21,8474013,Ian Cole,D,UTA,35,62,1,14,15
21,8483499,Liam Ohgren,L,MIN,20,56,8,6,14
21,8477380,Jonny Brodzinski,C,NYR,31,50,8,6,14
21,8482245,Artem Zub,D,OTT,29,67,5,9,14
21,8478434,Keegan Kolesar,R,VGK,27,63,5,9,14
21,8481013,Jonatan Berggren,R,DET,24,57,5,9,14
21,8480007,Jonas Rondbjerg,R,VGK,25,38,5,9,14
21,8479944,Zach Aston-Reese,C,VGK,30,51,5,9,14
21,8480222,Sebastian Aho,D,PIT,28,67,3,11,14
21,8481059,Scott Perunovich,D,STL,26,61,3,11,14
21,8481598,Philip Broberg,D,EDM,23,46,3,11,14
21,8475177,Calvin de Haan,D,COL,33,41,3,11,14
21,8478452,Caleb Jones,D,LAK,27,54,2,12,14
21,8478831,Kevin Stenlund,C,UTA,28,60,11,2,13
21,8480011,Klim Kostin,C,SJS,25,39,8,5,13
21,8480980,Connor Dewar,C,TOR,25,65,8,5,13
21,8481592,Jakob Pelletier,L,CGY,23,37,8,5,13
21,8477220,Nate Schmidt,D,FLA,33,68,7,6,13
21,8474716,Jared Spurgeon,D,MIN,35,77,6,7,13
21,8477573,Nathan Walker,L,STL,30,43,6,7,13
21,8476994,Vinnie Hinostroza,C,NSH,30,48,6,7,13
21,8482807,Ethan Del Mastro,D,CHI,21,52,6,7,13
21,8482176,Wyatt Kaiser,D,CHI,22,55,5,8,13
21,8477482,Zachary Sanford,L,CHI,30,32,5,8,13
21,8478211,Dryden Hunt,L,CGY,29,56,5,8,13
21,8482784,Zach Dean,C,STL,21,42,5,8,13
21,8479536,Axel Jonsson-Fjallby,L,WPG,26,46,5,8,13
21,8476624,Barclay Goodrow,C,SJS,31,49,4,9,13
21,8480025,MacKenzie Entwistle,R,FLA,25,58,4,9,13
21,8479291,Kevin Rooney,C,CGY,31,51,4,9,13
21,8479371,Dante Fabbro,D,NSH,26,64,4,9,13
21,8478451,Ethan Bear,D,WSH,27,58,3,10,13
21,8478416,Erik Cernak,D,TBL,27,79,3,10,13
21,8482634,Alex Steeves,C,TOR,25,50,3,10,13
21,8481567,Henry Thrun,D,SJS,23,49,2,11,13
21,8480281,Alexey Toropchenko,R,STL,25,52,6,6,12
21,8483495,Simon Nemec,D,NJD,20,61,6,6,12
21,8482157,Will Cuylle,L,NYR,22,58,5,7,12
21,8484149,Gavin Brindley,C,CBJ,20,40,5,7,12
21,8479981,Jonah Gadjovich,L,FLA,26,46,5,7,12
21,8479718,Alex Barré-Boulet,C,MTL,27,50,4,8,12
21,8479520,Brandon Duhaime,R,WSH,27,54,4,8,12
21,8480252,Cole Guttman,C,CHI,25,40,4,8,12
21,8479378,Logan Stanley,D,WPG,26,53,4,8,12
21,8477962,Brendan Lemieux,L,CAR,28,42,4,8,12
21,8479980,Nicolas Hague,D,VGK,26,48,3,9,12
21,8482666,Scott Morrow,D,CAR,22,52,3,9,12
21,8474166,Alec Martinez,D,CHI,37,55,3,9,12
21,8477365,Connor Clifton,D,BUF,29,53,3,9,12
21,8471677,Jack Johnson,D,CBJ,37,66,3,9,12
21,8484254,Akito Hirose,D,VAN,25,34,3,9,12
21,8475179,Dmitry Kulikov,D,FLA,34,60,2,10,12
21,8479026,Philippe Myers,D,TOR,27,51,2,10,12
21,8473446,Erik Johnson,D,PHI,36,49,2,10,12
21,8474568,Luke Schenn,D,NSH,35,43,2,10,12
21,8480879,Jacob Bernard-Docker,D,OTT,24,46,1,11,12
21,8480891,Michael Kesselring,D,UTA,24,54,0,12,12
21,8481556,John Beecher,C,BOS,23,42,9,2,11
21,8479671,Mathieu Olivier,R,CBJ,27,50,7,4,11
21,8476822,Luke Glendening,C,TBL,35,78,6,5,11
21,8478585,Derek Ryan,C,EDM,38,60,5,6,11
21,8477931,Tomas Nosek,L,FLA,32,65,5,6,11
21,8481550,Adam Beckman,L,NJD,23,46,5,6,11
21,8483482,Tristan Luneau,D,ANA,20,56,4,7,11
21,8482155,Alex Laferriere,R,LAK,23,61,4,7,11
21,8481532,Alex Turcotte,C,LAK,23,45,4,7,11
21,8476891,Matthew Grzelcyk,D,PIT,30,80,3,8,11
21,8474612,Travis Hamonic,D,OTT,34,50,3,8,11
21,8482964,Arber Xhekaj,D,MTL,23,41,3,8,11
21,8474090,Brendan Smith,D,DAL,35,56,3,8,11
21,8477018,Ben Hutton,D,VGK,31,50,2,9,11
21,8475718,Justin Holl,D,DET,32,57,1,10,11
21,8481441,Joe Snively,C,DET,28,64,0,11,11
21,8479968,Vinni Lettieri,C,BOS,29,45,8,2,10
21,8480292,Carson Meyer,R,ANA,27,32,7,3,10
21,8479439,Jacob MacDonald,D,COL,31,45,5,5,10
21,8480441,Trey Fix-Wolansky,R,CBJ,25,42,5,5,10
21,8476952,Dominic Toninato,C,WPG,30,33,4,6,10
21,8480860,Kevin Bahl,D,CGY,24,59,3,7,10
21,8480727,Zach Whitecloud,D,VGK,28,48,3,7,10
21,8479359,Beck Malenstyn,L,BUF,26,47,3,7,10
21,8483630,Pavol Regenda,L,ANA,25,30,3,7,10
21,8478409,Anthony Richard,C,PHI,28,29,3,7,10
21,8480845,Rasmus Kupari,C,WPG,24,38,3,7,10
21,8482511,Mason Lohrei,D,BOS,23,37,3,7,10
21,8482073,Braden Schneider,D,NYR,23,60,2,8,10
21,8480058,Pierre-Olivier Joseph,D,STL,25,51,2,8,10
21,8470600,Ryan Suter,D,STL,39,59,2,8,10
21,8476856,Mathew Dumba,D,DAL,30,75,2,8,10
21,8478859,Niko Mikkola,D,FLA,28,51,2,8,10
21,8481600,Tobias Bjornfot,D,FLA,23,40,2,8,10
21,8476867,Brendan Gaunce,C,MIN,30,33,2,8,10
21,8482861,Vincent Iorio,D,WSH,22,31,1,9,10
21,8477851,Jordan Oesterle,D,BOS,32,39,1,9,10
21,8476874,Olli Maatta,D,DET,30,62,0,10,10
21,8475208,Brian Dumoulin,D,ANA,33,64,0,10,10
21,8480070,Ian Mitchell,D,BOS,25,53,0,10,10
21,8480157,Calle Rosen,D,COL,30,50,0,10,10
21,8481518,Nolan Foote,L,NJD,24,29,7,2,9
21,8482166,Shakir Mukhamadullin,D,SJS,22,59,5,4,9
21,8476858,Phillip Di Giuseppe,L,VAN,31,44,5,4,9
21,8479379,Givani Smith,R,SJS,26,31,4,5,9
21,8481161,Jake Christiansen,D,CBJ,25,50,3,6,9
21,8482713,Mackie Samoskevich,R,FLA,22,42,3,6,9
21,8481147,Reese Johnson,C,MIN,26,41,3,6,9
21,8476372,Nick Seeler,D,PHI,31,45,2,7,9
21,8481751,Lukas Rousek,R,BUF,25,39,2,7,9
21,8478454,Noah Juulsen,D,VAN,27,39,2,7,9
21,8482451,Mikael Pyyhtia,L,CBJ,23,51,1,8,9
21,8474567,Zach Bogosian,D,MIN,34,65,1,8,9
21,8481708,Zac Jones,D,NYR,24,57,1,8,9
21,8483619,Filip Roos,D,OTT,25,37,1,8,9
21,8482733,Logan Mailloux,D,MTL,31,33,1,8,9
21,8479372,Joshua Mahura,D,SEA,26,52,1,8,9
21,8480196,Jacob Bryson,D,BUF,27,32,1,8,9
21,8475842,Sam Carrick,C,NYR,32,63,5,3,8
21,8477887,Patrick Brown,C,BOS,32,46,5,3,8
21,8484911,Collin Graf,R,SJS,22,31,5,3,8
21,8480032,Shane Bowers,C,NJD,25,21,5,3,8
21,8481122,Simon Benoit,D,TOR,26,38,4,4,8
21,8471817,Ryan Reaves,R,TOR,37,57,4,4,8
21,8479348,Kale Clague,D,BUF,26,44,3,5,8
21,8482095,Tyler Kleven,D,OTT,22,45,3,5,8
21,8477499,Rasmus Ristolainen,D,PHI,30,52,3,5,8
21,8477938,Haydn Fleury,D,WPG,28,36,3,5,8
21,8481609,Vladislav Kolyachonok,D,UTA,23,33,3,5,8
21,8480950,Ilya Lyubushkin,D,DAL,30,54,2,6,8
21,8481789,Tye Kartye,L,SEA,23,37,2,6,8
21,8483460,David Jiricek,D,CBJ,21,62,2,6,8
21,8479576,Vincent Desharnais,D,VAN,28,33,2,6,8
21,8476473,Connor Murphy,D,CHI,31,47,2,6,8
21,8481701,Santeri Hatakka,D,NJD,23,42,1,7,8
21,8479772,Zack MacEwen,R,OTT,28,59,1,7,8
21,8475750,Jon Merrill,D,MIN,32,65,1,7,8
21,8478450,Parker Wotherspoon,D,BOS,27,23,1,7,8
21,8477401,John Hayden,C,SEA,29,43,6,1,7
21,8482077,Dylan Holloway,L,EDM,23,50,4,3,7
21,8482744,James Malatesta,L,CBJ,21,39,4,3,7
21,8479994,Jaret Anderson-Dolan,C,WPG,25,35,4,3,7
21,8476934,Brock McGinn,L,ANA,30,47,3,4,7
21,8479972,Mason Shaw,C,WPG,26,34,3,4,7
21,8482496,Nils Aman,C,VAN,24,40,3,4,7
21,8480880,Jakub Lauko,C,MIN,24,33,3,4,7
21,8477384,Joshua Brown,D,EDM,30,43,2,5,7
21,8481167,Brayden Pachal,D,CGY,25,38,2,5,7
21,8477070,Liam O'Brien,C,UTA,30,43,2,5,7
21,8478443,Brandon Carlo,D,BOS,28,59,1,6,7
21,8477034,Jaycob Megna,D,FLA,32,44,1,6,7
21,8482859,Zack Ostapchuk,C,OTT,21,47,1,6,7
21,8478021,William Lagesson,D,DET,28,27,1,6,7
21,8481056,Spencer Stastney,D,NSH,24,30,1,6,7
21,8484258,Sam Malinski,D,COL,26,28,1,6,7
21,8478146,Matthew Highmore,C,OTT,28,39,1,6,7
21,8477527,Ross Johnston,L,ANA,30,23,1,6,7
21,8475762,Derek Forbort,D,VAN,32,53,0,7,7
21,8482747,Brennan Othmann,L,NYR,21,37,4,2,6
21,8479991,Jake Leschyshyn,C,NYR,25,37,4,2,6
21,8482201,Gage Goncalves,C,TBL,23,23,4,2,6
21,8481543,Nikita Alexandrov,C,STL,24,29,3,3,6
21,8482153,Brendan Brisson,C,VGK,23,35,3,3,6
21,8483466,Kevin Korchinski,D,CHI,20,44,2,4,6
21,8477335,Kyle Burroughs,D,LAK,29,30,1,5,6
21,8481743,Marc Del Gaizo,D,NSH,25,21,1,5,6
21,8479442,Troy Stecher,D,EDM,30,47,0,6,6
21,8479587,Rhett Gardner,C,PHI,28,21,0,6,6
21,8481754,Nikita Nesterenko,C,ANA,23,26,4,1,5
21,8482751,Ryan Winterton,C,SEA,21,28,4,1,5
21,8482070,Mitchell Chaffee,R,TBL,26,50,3,2,5
21,8482141,Lukas Cormier,D,VGK,22,25,3,2,5
21,8477462,Robert Hagg,D,VGK,29,20,3,2,5
21,8483549,Lucas Condotta,L,MTL,27,33,2,3,5
21,8477467,Gustav Olofsson,D,SEA,30,15,2,3,5
21,8482165,Yan Kuznetsov,D,CGY,22,22,2,3,5
21,8481237,Kyle MacLean,C,NYI,25,19,2,3,5
21,8475958,Michael Sgarbossa,C,WSH,32,26,1,4,5
21,8478017,Mark Friedman,D,VAN,29,35,1,4,5
21,8480834,Ty Emberson,D,SJS,24,30,1,4,5
21,8480990,Declan Chisholm,D,MIN,24,34,1,4,5
21,8482250,Callahan Burke,C,VGK,27,30,0,5,5
21,8481679,Maxence Guenette,D,OTT,23,29,0,5,5
21,8483570,Ben Meyers,C,SEA,26,25,4,0,4
21,8482765,Isak Rosen,R,BUF,21,27,3,1,4
21,8475235,Nicolas Deslauriers,L,PHI,33,48,3,1,4
21,8476913,Devin Shore,C,MIN,30,28,2,2,4
21,8479320,Maxime Lajoie,D,SEA,27,28,2,2,4
21,8482145,Mavrik Bourque,C,DAL,22,46,2,2,4
21,8483512,Matthew Savoie,C,EDM,20,25,2,2,4
21,8482162,Roby Jarventie,L,EDM,22,20,2,2,4
21,8483489,Fraser Minten,C,TOR,31,18,2,2,4
21,8477320,Anton Blidh,L,NYR,29,28,2,2,4
21,8475279,Ben Chiarot,D,DET,33,67,1,3,4
21,8483397,Marc McLaughlin,C,BOS,25,37,1,3,4
21,8480851,Akil Thomas,C,LAK,24,20,1,3,4
21,8476441,Joel Edmundson,D,LAK,31,39,0,4,4
21,8483012,Logan Morrison,C,SEA,22,30,0,4,4
21,8477971,Andreas Englund,D,LAK,28,35,3,0,3
21,8483597,Milos Kelemen,L,UTA,25,9,3,0,3
21,8480844,Grigori Denisenko,L,VGK,24,36,2,1,3
21,8480890,Jan Jenik,C,OTT,24,20,2,1,3
21,8478424,Jansen Harkins,C,ANA,27,41,2,1,3
21,8478477,Mitchell Stephens,C,SEA,27,23,2,1,3
21,8478874,Adam Gaudette,R,OTT,28,29,1,2,3
21,8482177,Marat Khusnutdinov,C,MIN,22,30,1,2,3
21,8479985,Cale Fleury,D,SEA,26,30,1,2,3
21,8482929,Emil Lilleberg,D,TBL,23,18,1,2,3
21,8480245,Olle Lycksell,R,PHI,25,27,1,2,3
21,8484325,Waltteri Merela,C,TBL,26,23,1,2,3
21,8483395,Arshdeep Bains,L,VAN,23,14,1,2,3
21,8481541,Samuel Bolduc,D,NYI,24,25,0,3,3
21,8475795,Dylan McIlrath,D,WSH,32,19,0,3,3
21,8477073,Kurtis MacDermid,L,NJD,30,33,0,3,3
21,8480075,Cameron Crotty,D,MIN,25,12,0,3,3
21,8481065,Angus Crookshank,L,OTT,25,14,2,0,2
21,8481206,John Ludvig,D,PIT,24,14,2,0,2
21,8478011,Louie Belpedio,D,PHI,28,14,2,0,2
21,8479367,William Lockwood,R,FLA,26,22,1,1,2
21,8481605,Jackson LaCombe,D,ANA,23,28,1,1,2
21,8479638,Justin Brazeau,R,BOS,26,36,1,1,2
21,8480870,Bo Groulx,C,NYR,24,20,1,1,2
21,8482144,Jack Thompson,D,SJS,22,23,1,1,2
21,8479249,Andrew Poturalski,C,SJS,30,39,1,1,2
21,8482172,Landon Slaggert,L,CHI,22,22,1,1,2
21,8482470,Ilya Solovyov,D,CGY,24,17,1,1,2
21,8484287,Cole McWard,D,VAN,23,30,1,1,2
21,8480874,Adam Ginning,D,PHI,24,11,1,1,2
21,8481593,Jayden Struble,D,MTL,23,19,1,1,2
21,8480267,Sammy Walker,C,MIN,25,15,1,1,2
21,8482118,Sam Colangelo,R,ANA,23,18,1,1,2
21,8475755,Alexander Petrovic,D,DAL,32,9,1,1,2
21,8481726,Adam Edstrom,C,NYR,24,8,1,1,2
21,8478051,Max Willman,C,NJD,29,18,1,1,2
21,8477244,Chad Ruhwedel,D,NYR,34,32,0,2,2
21,8477810,Joel Hanley,D,CGY,33,22,0,2,2
21,8482061,Brandon Biro,L,SEA,26,6,0,2,2
21,8478854,Ryan Shea,D,PIT,27,4,0,2,2
21,8482197,Adam Raska,R,MIN,23,7,0,2,2
21,8481006,Tyler Tucker,D,STL,24,23,0,2,2
21,8478502,Dennis Gilbert,D,BUF,28,14,1,0,1
21,8481422,Jake Lucchini,C,NSH,29,24,1,0,1
21,8481585,Egor Afanasyev,L,SJS,23,11,1,0,1
21,8477473,Justin Bailey,R,SJS,29,24,1,0,1
21,8483567,Georgii Merkulov,C,BOS,24,6,1,0,1
21,8480468,James Hamblin,L,EDM,25,14,1,0,1
21,8479330,Brandon Gignac,C,MTL,27,10,1,0,1
21,8482858,Ryker Evans,D,SEA,23,28,0,1,1
21,8482094,Daemon Hunt,D,MIN,22,11,0,1,1
21,8482102,Vasily Ponomarev,C,PIT,22,21,0,1,1
21,8483763,Maksymilian Szuber,D,UTA,22,27,0,1,1
21,8479419,Brett Murray,L,BUF,26,18,0,1,1
21,8480823,Alexander Alexeyev,D,WSH,25,7,0,1,1
21,8474062,Riley Nash,C,NYR,35,15,0,1,1
21,8481806,Louis Crevier,D,CHI,23,14,0,1,1
21,8477149,Scott Sabourin,R,SJS,32,15,0,1,1
21,8482088,Justin Sourdif,R,FLA,22,15,0,1,1
21,8480306,Grant Hutton,D,NYI,29,5,0,1,1
21,8478881,Brett Seney,L,CHI,28,16,0,1,1
21,8475413,Justin Dowling,C,NJD,34,16,0,1,1
21,8480084,Nick DeSimone,D,NJD,30,12,0,1,1
21,8481578,Graeme Clarke,R,MIN,23,10,0,1,1
21,8482476,Emil Heineman,L,MTL,23,7,0,1,1
21,8482126,Emil Andrae,D,PHI,31,4,0,1,1
21,8478956,Samuel Laberge,L,NJD,27,2,0,1,1
21,8482147,Jean-Luc Foudy,C,COL,22,20,0,0,0
21,8481699,Aku Raty,R,UTA,23,17,0,0,0
21,8478147,Bokondji Imama,L,PIT,28,2,0,0,0
21,8481719,Maxwell Crozier,D,TBL,24,9,0,0,0
21,8481043,Cole Koepke,L,BOS,26,15,0,0,0
21,8478446,Glenn Gawdin,C,LAK,27,12,0,0,0
21,8481564,Ryan Johnson,D,BUF,23,14,0,0,0
21,8483407,Brandon Scanlin,D,NYR,25,3,0,0,0
21,8479362,Riley Tufte,L,BOS,26,16,0,0,0
21,8483471,Brad Lambert,C,WPG,31,9,0,0,0
21,8481030,Jack St. Ivany,D,PIT,25,16,0,0,0
21,8484304,Uvis Balinskis,D,FLA,28,10,0,0,0
21,8483398,Declan Carlile,D,TBL,31,1,0,0,0
21,8477541,Dakota Mermis,D,TOR,30,8,0,0,0
21,8482787,Nikita Chibrikov,R,WPG,31,6,0,0,0
21,8482516,Matthew Kessel,D,STL,24,24,0,0,0
21,8483920,Pierrick Dube,R,WSH,23,6,0,0,0
21,8481462,Mason Morelli,L,VGK,28,15,0,0,0
21,8479421,Jacob Moverare,D,LAK,26,7,0,0,0
21,8483546,Marshall Rifai,D,TOR,26,5,0,0,0
21,8479522,Hardy Haman Aktell,D,WSH,26,5,0,0,0
21,8482460,Matt Rempe,C,NYR,22,8,0,0,0
21,8475780,Chris Wagner,R,COL,33,9,0,0,0
21,8481024,Linus Karlsson,C,VAN,25,6,0,0,0
21,8484255,Jason Polin,R,COL,25,4,0,0,0
21,8477993,Justin Kirkland,C,CGY,28,3,0,0,0
21,8481534,Raphael Lavoie,C,EDM,24,6,0,0,0
21,8483432,Luca Del Bel Belluz,C,CBJ,31,4,0,0,0
21,8476323,Max McCormick,L,SEA,32,2,0,0,0
21,8483401,Marc Johnstone,R,PIT,28,1,0,0,0
21,8481655,Cole Schwindt,R,CGY,23,4,0,0,0
21,8483531,Brian Halonen,L,NJD,25,1,0,0,0
21,8483609,Adam Klapka,R,CGY,24,2,0,0,0
21,8484259,Ondrej Pavel,C,COL,31,4,0,0,0
21,8484321,Nikolas Matinpalo,D,OTT,26,4,0,0,0
21,8484326,Patrik Koch,D,UTA,28,3,0,0,0
21,8470794,Joe Pavelski,C,,40,0,0,0,0
21,8479321,Lucas Johansen,D,,27,0,0,0,0
21,8477950,Tony DeAngelo,D,,29,0,0,0,0
21,8471218,Blake Wheeler,R,,38,0,0,0,0
21,8475197,Tyson Barrie,D,,33,0,0,0,0
21,8474157,Max Pacioretty,L,,36,0,0,0,0
21,8475744,Evgeny Kuznetsov,C,,32,0,0,0,0
21,8474037,James van Riemsdyk,L,,35,0,0,0,0
21,8476907,Mackenzie MacEachern,L,,30,0,0,0,0
21,8480216,Jacob Peterson,C,,25,0,0,0,0
21,8474602,Justin Schultz,D,,34,0,0,0,0
21,8482222,Alexander Barabanov,L,,30,0,0,0,0
21,8474031,Kevin Shattenkirk,D,,35,0,0,0,0
21,8477330,Dominik Kubalik,L,,29,0,0,0,0
21,8480884,Calen Addison,D,,24,0,0,0,0
21,8475906,John Klingberg,D,,32,0,0,0,0
21,8480008,Adam Ruzicka,C,,25,0,0,0,0
21,8476884,Derrick Pouliot,D,,30,0,0,0,0
21,8476919,Chris Tierney,C,,30,0,0,0,0
21,8479415,Michael McLeod,C,,26,0,0,0,0
21,8474870,Tyler Johnson,C,,34,0,0,0,0
21,8470604,Jeff Carter,C,,39,0,0,0,0
21,8478104,Sammy Blais,L,,28,0,0,0,0
21,8474884,Mike Hoffman,C,,35,0,0,0,0
21,8481591,Sam Poulin,R,,23,0,0,0,0
21,8471274,Alex Goligoski,D,,39,0,0,0,0
21,8476871,Tanner Pearson,L,,32,0,0,0,0
21,8476393,Nick Cousins,C,,31,0,0,0,0
21,8479977,Kailer Yamamoto,R,,26,0,0,0,0
21,8479346,Dillon Dube,C,,26,0,0,0,0
21,8480184,Gustav Lindstrom,D,,26,0,0,0,0
21,8479376,Victor Mete,D,,26,0,0,0,0
21,8473449,Kyle Okposo,R,,36,0,0,0,0
21,8481058,Jesse Ylonen,R,,25,0,0,0,0
21,8475752,Tyler Pitlick,C,,33,0,0,0,0
21,8481239,Samuel Fagemo,L,,24,0,0,0,0
21,8480821,Filip Zadina,R,,25,0,0,0,0
21,8470966,Mark Giordano,D,,41,0,0,0,0
21,8478495,Denis Gurianov,R,,27,0,0,0,0
21,8477464,Nic Petan,C,,29,0,0,0,0
21,8478099,Kevin Labanc,R,,29,0,0,0,0
21,8482241,Radim Zohorna,L,,28,0,0,0,0
21,8474040,Sam Gagner,C,,35,0,0,0,0
21,8479514,Rem Pitlick,C,,27,0,0,0,0
21,8478430,Oliver Kylington,D,,27,0,0,0,0
21,8479533,Joona Koppanen,L,,26,0,0,0,0
21,8479984,Cal Foote,D,,26,0,0,0,0
21,8477126,Jayson Megna,C,,34,0,0,0,0
21,8475164,Jakob Silfverberg,R,,34,0,0,0,0
21,8474009,Nick Bonino,C,,36,0,0,0,0
21,8479458,Nikita Zaitsev,D,,33,0,0,0,0
21,8477944,Jakub Vrana,L,,28,0,0,0,0
21,8471699,Andrew Cogliano,C,,37,0,0,0,0
21,8478067,Oskar Lindblom,L,,28,0,0,0,0
21,8471686,Marc Staal,D,,37,0,0,0,0
21,8470610,Zach Parise,L,,40,0,0,0,0
21,8478904,Steven Lorentz,C,,28,0,0,0,0
21,8473473,Milan Lucic,L,,36,0,0,0,0
21,8480031,Maxime Comtois,L,,25,0,0,0,0
21,8478512,Austin Czarnik,C,,32,0,0,0,0
21,8473504,Cal Clutterbuck,R,,37,0,0,0,0
21,8477454,Adam Erne,L,,29,0,0,0,0
21,8479383,Boris Katchouk,L,,26,0,0,0,0
21,8475825,Jani Hakanpää,D,,32,0,0,0,0
21,8477846,Ryan Carpenter,C,,33,0,0,0,0
21,8477930,Pierre-Edouard Bellemare,L,,39,0,0,0,0
21,8478400,Colin White,C,,27,0,0,0,0
21,8480226,Marián Studenic,R,,26,0,0,0,0
21,8480853,Liam Foudy,C,,24,0,0,0,0
21,8475797,Jarred Tinordi,D,,32,0,0,0,0
21,8479423,Alex Nylander,L,,26,0,0,0,0
21,8474618,Marco Scandella,D,,34,0,0,0,0
21,8478028,Fredrik Olofsson,L,,28,0,0,0,0
21,8474709,Matt Martin,L,,35,0,0,0,0
21,8481070,Hugh McGing,L,,26,0,0,0,0
21,8479546,Oskar Steen,C,,26,0,0,0,0
21,8474145,Robert Bortuzzo,D,,35,0,0,0,0
21,8476915,Jujhar Khaira,L,,30,0,0,0,0
21,8480274,Philip Kemp,D,EDM,25,1,0,0,0
21,8475278,Byron Froese,C,,33,0,0,0,0
21,8481812,Nikolai Knyzhov,D,,27,0,0,0,0
21,8478408,Travis Dermott,D,,28,0,0,0,0
21,8481077,John Leonard,L,,26,0,0,0,0
21,8479547,Matthew Phillips,R,,26,0,0,0,0
21,8480836,Jonathan Gruden,C,,24,0,0,0,0
21,8481690,Tyler Angle,C,,24,0,0,0,0
21,8475766,Austin Watson,L,,32,0,0,0,0
21,8481016,Ruslan Iskhakov,C,,24,0,0,0,0
21,8478078,Rourke Chartier,C,,28,0,0,0,0
21,8480776,Sheldon Rempal,R,,29,0,0,0,0
21,8483045,Cameron Butler,R,CBJ,31,0,0,0,0
21,8484314,Jiri Smejkal,L,,28,0,0,0,0
22,8478402,Connor McDavid,C,EDM,27,79,52,112,164
22,8477492,Nathan MacKinnon,C,COL,29,79,50,86,136
22,8478483,Mitch Marner,R,TOR,27,81,38,83,121
22,8476453,Nikita Kucherov,R,TBL,31,82,39,79,118
22,8477956,David Pastrnak,R,BOS,28,81,45,68,113
22,8481559,Jack Hughes,C,NJD,23,75,43,70,113
22,8479318,Auston Matthews,C,TOR,27,80,62,50,112
22,8477939,William Nylander,R,TOR,28,81,47,64,111
22,8477934,Leon Draisaitl,C,EDM,29,79,32,70,102
22,8471675,Sidney Crosby,C,PIT,37,71,34,67,101
22,8480012,Elias Pettersson,C,VAN,26,77,42,56,98
22,8478550,Artemi Panarin,L,NYR,33,76,31,67,98
22,8476468,J.T. Miller,C,VAN,31,76,31,66,97
22,8477404,Jake Guentzel,C,TBL,30,82,50,46,96
22,8484144,Connor Bedard,C,CHI,19,69,39,57,96
22,8480027,Jason Robertson,L,DAL,25,80,39,56,95
22,8478445,Mathew Barzal,C,NYI,27,82,20,75,95
22,8477493,Aleksander Barkov,C,FLA,29,81,40,54,94
22,8474564,Steven Stamkos,C,NSH,34,78,31,62,93
22,8480800,Quinn Hughes,D,VAN,25,74,19,74,93
22,8476887,Filip Forsberg,L,NSH,30,77,45,47,92
22,8480002,Nico Hischier,C,NJD,25,76,29,63,92
22,8480069,Cale Makar,D,COL,26,72,23,69,92
22,8480036,Miro Heiskanen,D,DAL,25,77,13,79,92
22,8479343,Clayton Keller,R,UTA,26,77,38,53,91
22,8478864,Kirill Kaprizov,L,MIN,27,71,36,55,91
22,8477942,Kevin Fiala,L,LAK,28,81,41,49,90
22,8478398,Kyle Connor,L,WPG,28,76,36,53,89
22,8479314,Matthew Tkachuk,L,FLA,27,77,24,65,89
22,8478010,Brayden Point,C,TBL,28,82,38,50,88
22,8477409,Carter Verhaeghe,C,FLA,29,82,46,41,87
22,8480023,Robert Thomas,C,STL,25,72,20,67,87
22,8477946,Dylan Larkin,C,DET,28,82,44,42,86
22,8476460,Mark Scheifele,C,WPG,31,71,36,50,86
22,8475913,Mark Stone,R,VGK,32,74,36,50,86
22,8474141,Patrick Kane,R,DET,36,81,34,51,85
22,8476459,Mika Zibanejad,C,NYR,31,76,28,57,85
22,8482116,Tim Stützle,C,OTT,22,77,33,51,84
22,8478420,Mikko Rantanen,R,COL,28,79,39,42,81
22,8480801,Brady Tkachuk,L,OTT,25,76,39,41,80
22,8478414,Timo Meier,R,NJD,28,74,39,41,80
22,8478403,Jack Eichel,C,VGK,28,78,33,47,80
22,8480865,Noah Dobson,D,NYI,24,79,14,65,79
22,8478439,Travis Konecny,R,PHI,27,75,36,42,78
22,8476454,Ryan Nugent-Hopkins,C,EDM,31,76,32,46,78
22,8473419,Brad Marchand,L,BOS,36,78,29,48,77
22,8475166,John Tavares,C,TOR,34,80,25,52,77
22,8475786,Zach Hyman,L,EDM,32,77,41,35,76
22,8478427,Sebastian Aho,C,CAR,27,75,37,39,76
22,8480208,Drake Batherson,R,OTT,26,78,32,44,76
22,8480830,Andrei Svechnikov,R,CAR,24,75,26,50,76
22,8477501,Valeri Nichushkin,R,COL,29,82,40,35,75
22,8479385,Jordan Kyrou,C,STL,26,76,26,49,75
22,8476389,Vincent Trocheck,C,NYR,31,74,19,56,75
22,8477933,Sam Reinhart,C,FLA,29,78,34,40,74
22,8473512,Claude Giroux,R,OTT,36,79,26,47,73
22,8475692,Mats Zuccarello,R,MIN,37,75,21,52,73
22,8471685,Anze Kopitar,C,LAK,37,82,20,53,73
22,8477402,Pavel Buchnevich,L,STL,29,74,38,34,72
22,8479407,Jesper Bratt,L,NJD,26,80,29,43,72
22,8478460,Zach Werenski,D,CBJ,27,80,14,58,72
22,8475726,Tyler Toffoli,C,SJS,32,72,39,32,71
22,8481557,Matt Boldy,L,MIN,23,73,37,34,71
22,8477940,Nikolaj Ehlers,L,WPG,28,74,34,37,71
22,8477951,Nick Schmaltz,C,UTA,28,75,24,46,70
22,8476539,Jonathan Marchessault,R,NSH,34,75,33,36,69
22,8475170,Brayden Schenn,C,STL,33,74,33,36,69
22,8482078,Lucas Raymond,L,DET,22,82,21,47,68
22,8476881,Tomas Hertl,C,VGK,31,77,20,48,68
22,8474600,Roman Josi,D,NSH,34,75,17,51,68
22,8481596,Shane Pinto,C,OTT,24,76,34,32,66
22,8478449,Roope Hintz,C,DAL,28,82,30,36,66
22,8474150,Mikael Backlund,C,CGY,35,79,25,41,66
22,8471215,Evgeni Malkin,C,PIT,38,74,19,47,66
22,8479323,Adam Fox,D,NYR,26,74,15,51,66
22,8475810,Bryan Rust,R,PIT,32,73,32,33,65
22,8475172,Nazem Kadri,C,CGY,34,79,25,40,65
22,8477960,Adrian Kempe,R,LAK,28,80,23,42,65
22,8476346,Johnny Gaudreau,L,CBJ,31,69,20,45,65
22,8479420,Tage Thompson,C,BUF,27,70,30,34,64
22,8475158,Ryan O'Reilly,C,NSH,33,72,29,35,64
22,8480018,Nick Suzuki,C,MTL,25,75,17,47,64
22,8476456,Jonathan Huberdeau,C,CGY,31,78,13,51,64
22,8475167,Victor Hedman,D,TBL,34,82,11,53,64
22,8479542,Brandon Hagel,L,TBL,26,82,26,37,63
22,8477949,Alex Tuch,R,BUF,28,70,22,41,63
22,8478440,Dylan Strome,C,WSH,27,74,16,47,63
22,8475784,Jeff Skinner,C,EDM,32,80,34,28,62
22,8477496,Elias Lindholm,C,BOS,30,78,25,37,62
22,8475754,Brock Nelson,C,NYI,33,81,24,38,62
22,8475184,Chris Kreider,L,NYR,33,78,35,26,61
22,8482745,Mason McTavish,C,ANA,21,75,25,36,61
22,8477503,Max Domi,C,TOR,29,81,22,39,61
22,8479999,Casey Mittelstadt,C,COL,26,82,19,42,61
22,8477476,Artturi Lehkonen,L,COL,29,81,29,31,60
22,8478401,Pavel Zacha,C,BOS,27,79,24,36,60
22,8478975,Mason Marchment,L,DAL,29,82,22,38,60
22,8477504,Josh Morrissey,D,WPG,29,75,17,43,60
22,8482699,Dylan Guenther,R,UTA,21,78,31,28,59
22,8479675,Trevor Moore,L,LAK,29,82,26,33,59
22,8479325,Charlie McAvoy,D,BOS,27,73,15,44,59
22,8477955,Jared McCann,L,SEA,28,77,25,33,58
22,8478493,Joel Eriksson Ek,C,MIN,27,71,24,34,58
22,8477407,Anthony Duclair,L,NYI,29,77,30,27,57
22,8482109,Alexis Lafrenière,L,NYR,23,78,30,27,57
22,8476483,Rickard Rakell,R,PIT,31,69,27,30,57
22,8480039,Martin Necas,C,CAR,25,71,21,36,57
22,8483515,Juraj Slafkovsky,L,MTL,20,74,19,38,57
22,8481540,Cole Caufield,R,MTL,23,76,34,22,56
22,8482740,Wyatt Johnston,C,DAL,21,82,28,28,56
22,8477500,Bo Horvat,C,NYI,29,80,24,32,56
22,8475168,Matt Duchene,C,DAL,33,82,23,33,56
22,8482124,Quinton Byfield,R,LAK,22,81,16,40,56
22,8480803,Evan Bouchard,D,EDM,25,73,13,43,56
22,8473994,Jamie Benn,L,DAL,35,82,25,30,55
22,8478444,Brock Boeser,R,VAN,27,68,24,31,55
22,8482093,Seth Jarvis,C,CAR,22,68,24,31,55
22,8480839,Rasmus Dahlin,D,BUF,24,74,22,33,55
22,8476905,Chandler Stephenson,C,SEA,30,76,22,33,55
22,8478856,Conor Garland,R,VAN,28,74,19,36,55
22,8474578,Erik Karlsson,D,PIT,34,78,14,41,55
22,8476853,Morgan Rielly,D,TOR,30,70,8,47,55
22,8479337,Alex DeBrincat,R,DET,27,79,30,24,54
22,8480798,Philipp Kurashev,C,CHI,25,63,25,29,54
22,8482159,Tyson Foerster,R,PHI,22,74,23,31,54
22,8481533,Trevor Zegras,C,ANA,23,70,22,32,54
22,8476448,William Karlsson,C,VGK,31,76,21,33,54
22,8470613,Brent Burns,D,CAR,39,75,14,40,54
22,8476462,Dougie Hamilton,D,NJD,31,69,14,40,54
22,8475798,Mikael Granlund,C,SJS,32,66,11,43,54
22,8474590,John Carlson,D,WSH,34,67,9,45,54
22,8477416,Oliver Bjorkstrand,R,SEA,29,70,21,32,53
22,8482720,Matthew Knies,L,TOR,22,79,24,28,52
22,8482097,Jack Quinn,R,BUF,23,66,20,32,52
22,8477986,Brandon Montour,D,SEA,30,76,18,34,52
22,8479400,Pierre-Luc Dubois,L,WSH,26,74,17,35,52
22,8478407,Vince Dunn,D,SEA,28,70,7,45,52
22,8477497,Sean Monahan,C,CBJ,30,69,27,24,51
22,8475794,Tyler Seguin,C,DAL,32,81,27,24,51
22,8477935,Sam Bennett,C,FLA,28,81,25,26,51
22,8478047,Michael Bunting,L,PIT,29,71,20,31,51
22,8476479,Phillip Danault,C,LAK,31,77,20,31,51
22,8474102,David Perron,L,OTT,36,78,18,33,51
22,8477494,Jonathan Drouin,L,COL,29,80,18,33,51
22,8478519,Anthony Cirelli,C,TBL,27,80,17,34,51
22,8481528,Dylan Cozens,C,BUF,23,70,16,35,51
22,8482684,Luke Hughes,D,NJD,21,69,15,36,51
22,8481703,Valtteri Puustinen,R,PIT,25,74,11,40,51
22,8480015,Owen Tippett,R,PHI,25,75,31,19,50
22,8483808,Andrei Kuzmenko,L,CGY,28,80,29,21,50
22,8480014,Gabriel Vilardi,C,WPG,25,68,27,23,50
22,8475799,Nino Niederreiter,R,WPG,32,70,25,25,50
22,8471214,Alex Ovechkin,L,WSH,39,71,24,26,50
22,8478438,Tommy Novak,C,NSH,27,74,20,30,50
22,8478462,Nicolas Roy,C,VGK,27,78,20,30,50
22,8476882,Teuvo Teravainen,C,CHI,30,65,16,34,50
22,8475765,Vladimir Tarasenko,R,DET,33,78,15,35,50
22,8475151,Kyle Palmieri,C,NYI,33,77,30,19,49
22,8482175,JJ Peterka,R,BUF,22,72,30,19,49
22,8478498,Jake DeBrusk,L,VAN,28,70,14,35,49
22,8476792,Torey Krug,D,STL,33,74,11,38,49
22,8471724,Kris Letang,D,PIT,37,79,9,40,49
22,8481068,Yegor Sharangovich,C,CGY,26,76,25,23,48
22,8480064,Josh Norris,C,OTT,25,75,23,25,48
22,8479425,Filip Hronek,D,VAN,27,73,15,33,48
22,8476875,Mike Matheson,D,MTL,30,77,8,40,48
22,8477426,Nicholas Paul,L,TBL,29,82,22,25,47
22,8474679,Gustav Nyquist,C,NSH,35,76,20,27,47
22,8484166,Adam Fantilli,C,CBJ,20,75,20,27,47
22,8475745,Charlie Coyle,C,BOS,32,78,18,29,47
22,8478458,John (Jack) Roslovic,C,CAR,27,68,18,29,47
22,8481711,Matias Maccelli,L,UTA,24,71,15,32,47
22,8477456,J.T. Compher,L,DET,29,79,18,28,46
22,8476869,Brady Skjei,D,NSH,30,73,15,31,46
22,8477447,Shea Theodore,D,VGK,29,59,12,34,46
22,8476906,Shayne Gostisbehere,D,CAR,31,74,12,34,46
22,8478038,Devon Toews,D,COL,30,65,11,35,46
22,8477346,MacKenzie Weegar,D,CGY,30,76,10,36,46
22,8482149,Cole Perfetti,C,WPG,22,63,21,24,45
22,8482665,Matty Beniers,C,SEA,22,74,20,25,45
22,8477021,Alex Kerfoot,C,UTA,30,81,9,36,45
22,8478397,Rasmus Andersson,D,CGY,28,74,8,37,45
22,8476432,Boone Jenner,C,CBJ,31,70,24,20,44
22,8478366,Frank Vatrano,R,ANA,30,72,24,20,44
22,8473986,Alex Killorn,L,ANA,35,76,21,23,44
22,8479365,Trent Frederic,C,BOS,26,77,21,23,44
22,8477964,Ivan Barbashev,C,VGK,29,76,20,24,44
22,8478466,Daniel Sprong,R,VAN,27,71,17,27,44
22,8480797,Joel Farabee,L,PHI,24,71,17,27,44
22,8482705,Cole Sillinger,C,CBJ,21,71,25,18,43
22,8476399,Blake Coleman,C,CGY,33,81,23,20,43
22,8475169,Evander Kane,L,EDM,33,73,21,22,43
22,8478042,Viktor Arvidsson,L,EDM,31,71,18,25,43
22,8481524,Bowen Byram,D,BUF,23,72,17,26,43
22,8475793,Ryan Johansen,C,PHI,32,73,16,27,43
22,8479987,Morgan Geekie,C,BOS,26,78,16,27,43
22,8471698,T.J. Oshie,R,WSH,38,62,15,28,43
22,8477932,Aaron Ekblad,D,FLA,28,72,11,32,43
22,8479410,Mikhail Sergachev,D,UTA,26,67,10,33,43
22,8475218,Mattias Ekholm,D,EDM,34,77,9,34,43
22,8477498,Darnell Nurse,D,EDM,29,75,9,34,43
22,8481560,Arthur Kaliyev,R,LAK,23,79,24,18,42
22,8478873,Troy Terry,R,ANA,27,71,22,20,42
22,8482667,William Eklund,L,SJS,22,71,19,23,42
22,8477511,Anthony Mantha,R,CGY,30,80,18,24,42
22,8484145,Zach Benson,L,BUF,19,75,16,26,42
22,8483505,Matthew Poitras,C,BOS,20,70,16,26,42
22,8477505,Alexander Wennberg,C,SJS,30,60,14,28,42
22,8480336,Sean Walker,D,CAR,30,72,10,32,42
22,8477495,Seth Jones,D,CHI,30,67,8,34,42
22,8482122,Brock Faber,D,MIN,22,78,5,37,42
22,8482089,Jake Neighbours,L,STL,22,68,28,13,41
22,8480068,Ryan Poehling,C,PHI,25,66,21,20,41
22,8479992,Michael Rasmussen,C,DET,25,79,20,21,41
22,8476419,Jean-Gabriel Pageau,C,NYI,32,77,16,25,41
22,8477444,Andre Burakovsky,L,SEA,29,71,12,29,41
22,8480145,Neal Pionk,D,WPG,29,72,9,32,41
22,8482105,Jake Sanderson,D,OTT,22,74,8,33,41
22,8475848,Brendan Gallagher,R,MTL,32,67,22,18,40
22,8480835,Jack Drury,C,CAR,24,58,18,22,40
22,8475722,Jason Zucker,L,BUF,32,68,18,22,40
22,8483431,Logan Cooley,C,UTA,20,72,17,23,40
22,8474641,Adam Henrique,C,EDM,34,76,15,25,40
22,8480028,Morgan Frost,C,PHI,25,74,14,26,40
22,8481577,Philip Tomasino,C,NSH,23,60,11,29,40
22,8477451,Ryan Hartman,R,MIN,30,71,18,21,39
22,8478542,Evan Rodrigues,C,FLA,31,72,17,22,39
22,8482702,Logan Stankoven,C,DAL,21,81,17,22,39
22,8475714,Calle Jarnkrok,C,TOR,33,79,17,22,39
22,8477479,Tyler Bertuzzi,L,CHI,29,61,14,25,39
22,8476458,Ryan Strome,C,ANA,31,70,11,28,39
22,8482671,Owen Power,D,BUF,22,67,10,29,39
22,8484153,Leo Carlsson,C,ANA,20,73,9,30,39
22,8481542,Moritz Seider,D,DET,23,79,9,30,39
22,8475314,Anders Lee,L,NYI,34,79,26,12,38
22,8479525,Ross Colton,C,COL,28,81,20,18,38
22,8480849,Barrett Hayton,C,UTA,24,72,20,18,38
22,8478057,Dakota Joshua,C,VAN,28,70,18,20,38
22,8478115,Pierre Engvall,L,NYI,28,78,17,21,38
22,8476885,Jacob Trouba,D,NYR,30,73,17,21,38
22,8480113,Alex Iafallo,L,WPG,31,69,16,22,38
22,8476958,Jaccob Slavin,D,CAR,30,76,11,27,38
22,8476826,Yanni Gourde,C,SEA,33,70,11,27,38
22,8482624,Daniil Miromanov,D,CGY,27,71,11,27,38
22,8476854,Hampus Lindholm,D,BOS,30,74,6,32,38
22,8474715,Cameron Atkinson,R,TBL,35,81,21,16,37
22,8481604,Pavel Dorofeyev,L,VGK,24,66,20,17,37
22,8480009,Eeli Tolvanen,R,SEA,25,69,19,18,37
22,8480188,Fabian Zetterlund,L,SJS,25,68,18,19,37
22,8478396,Noah Hanifin,D,VGK,27,56,14,23,37
22,8474586,Jordan Eberle,R,SEA,34,71,13,24,37
22,8484203,Bradly Nadeau,L,CAR,19,60,12,25,37
22,8482113,Anton Lundell,C,FLA,23,72,11,26,37
22,8474149,Evgenii Dadonov,R,DAL,35,80,11,26,37
22,8475763,Kevin Hayes,R,PIT,32,66,19,17,36
22,8478474,Lawson Crouse,L,UTA,27,76,17,19,36
22,8477998,Warren Foegele,L,LAK,28,77,16,20,36
22,8482475,Yegor Chinakhov,R,CBJ,23,66,16,20,36
22,8479351,Sam Steel,C,DAL,26,78,16,20,36
22,8475768,Jaden Schwartz,C,SEA,32,74,15,21,36
22,8481618,Alex Newhook,C,MTL,23,68,11,25,36
22,8475193,Tomas Tatar,L,NJD,34,68,11,25,36
22,8474716,Jared Spurgeon,D,MIN,35,79,10,26,36
22,8478469,Thomas Chabot,D,OTT,27,70,7,29,36
22,8478500,Ivan Provorov,D,CBJ,27,80,5,31,36
22,8475191,Reilly Smith,R,NYR,33,70,22,13,35
22,8478508,Yakov Trenin,C,MIN,27,56,21,14,35
22,8479661,Tanner Jeannot,L,LAK,27,78,18,17,35
22,8475287,Erik Haula,L,NJD,33,64,14,21,35
22,8482133,Thomas Bordeleau,C,SJS,22,60,14,21,35
22,8476392,Adam Lowry,C,WPG,31,70,14,21,35
22,8476292,Ondrej Palat,L,NJD,33,66,9,26,35
22,8475753,Justin Faulk,D,STL,32,71,8,27,35
22,8476923,Damon Severson,D,CBJ,30,80,5,30,35
22,8478055,Gustav Forsling,D,FLA,28,71,5,30,35
22,8476880,Tom Wilson,R,WSH,30,71,20,14,34
22,8482055,Drew O'Connor,L,PIT,26,63,20,14,34
22,8476438,Brandon Saad,L,STL,32,67,18,16,34
22,8475760,Nick Bjugstad,C,UTA,32,72,17,17,34
22,8479339,Patrik Laine,L,CBJ,26,63,15,19,34
22,8476461,Sean Couturier,C,PHI,32,72,14,20,34
22,8479996,Cody Glass,C,NSH,25,66,14,20,34
22,8477948,Travis Sanheim,D,PHI,28,72,10,24,34
22,8478133,Jake Evans,C,MTL,28,71,10,24,34
22,8481481,Blake Lizotte,C,PIT,27,64,18,15,33
22,8480459,Pius Suter,C,VAN,28,71,17,16,33
22,8479345,Jakob Chychrun,D,WSH,26,67,16,17,33
22,8482092,Ridly Greig,C,OTT,22,77,15,18,33
22,8480185,Eetu Luostarinen,C,FLA,26,73,15,18,33
22,8476897,Oskar Sundqvist,C,STL,30,67,12,21,33
22,8476872,Scott Laughton,C,PHI,30,75,11,22,33
22,8480220,Noah Cates,L,PHI,25,65,8,25,33
22,8476329,Travis Boyd,C,MIN,31,63,16,16,32
22,8473422,Nick Foligno,L,CHI,37,58,13,19,32
22,8481656,Aliaksei Protas,C,WSH,23,65,11,21,32
22,8482117,Lukas Reichel,L,CHI,22,54,11,21,32
22,8476979,Erik Gustafsson,D,DET,32,77,6,26,32
22,8480817,K'Andre Miller,D,NYR,24,71,6,26,32
22,8473507,Jeff Petry,D,DET,37,76,5,27,32
22,8481554,Kaapo Kakko,R,NYR,23,73,16,15,31
22,8481535,Nils Hoglander,L,VAN,24,66,15,16,31
22,8478472,Mathieu Joseph,R,STL,27,72,14,17,31
22,8483445,Cutter Gauthier,L,ANA,20,62,11,20,31
22,8477953,Kasperi Kapanen,R,STL,28,63,11,20,31
22,8474563,Drew Doughty,D,LAK,35,75,8,23,31
22,8480434,Sean Durzi,D,UTA,26,74,6,25,31
22,8476925,Colton Sissons,C,NSH,31,71,15,15,30
22,8476918,Jimmy Vesey,L,NYR,31,71,15,15,30
22,8475149,Marcus Johansson,L,MIN,34,68,14,16,30
22,8476981,Josh Anderson,R,MTL,30,70,14,16,30
22,8482110,Dawson Mercer,C,NJD,23,73,13,17,30
22,8478046,Danton Heinen,L,VAN,29,65,12,18,30
22,8478109,Victor Olofsson,L,VGK,29,73,12,18,30
22,8476480,Vladislav Namestnikov,C,WPG,32,64,11,19,30
22,8480813,Joe Veleno,C,DET,24,78,11,19,30
22,8483490,Pavel Mintyukov,D,ANA,21,72,4,26,30
22,8482125,Alexander Holtz,R,VGK,22,72,17,12,29
22,8481186,Logan O'Connor,R,COL,28,81,13,16,29
22,8480871,Adam Boqvist,D,FLA,24,69,9,20,29
22,8482712,Oskar Olausson,R,COL,22,79,7,22,29
22,8481546,Cam York,D,PHI,23,70,6,23,29
22,8475790,Erik Gudbranson,D,CBJ,32,74,6,23,29
22,8480878,Nils Lundkvist,D,DAL,24,70,6,23,29
22,8474565,Alex Pietrangelo,D,VGK,34,63,5,24,29
22,8477969,Marcus Pettersson,D,PIT,28,78,4,25,29
22,8479398,Samuel Girard,D,COL,26,64,4,25,29
22,8476931,Jake McCabe,D,TOR,31,63,3,26,29
22,8481580,Connor McMichael,C,WSH,23,62,16,12,28
22,8478463,Anthony Beauvillier,L,PIT,27,60,15,13,28
22,8481093,Rafael Harvey-Pinard,L,MTL,25,68,15,13,28
22,8474189,Lars Eller,C,PIT,35,67,13,15,28
22,8475200,Dmitry Orlov,D,CAR,33,72,12,16,28
22,8477979,Nicolas Aube-Kubel,R,BUF,28,60,9,19,28
22,8478911,Matt Roy,D,WSH,29,63,9,19,28
22,8477989,Christian Dvorak,C,MTL,28,68,4,24,28
22,8482655,Janis Moser,D,TBL,24,80,3,25,28
22,8481014,Alexander Romanov,D,NYI,24,78,1,27,28
22,8476474,Stefan Noesen,R,NJD,31,59,16,11,27
22,8478233,Andrew Mangiapane,L,WSH,28,75,13,14,27
22,8477425,Miles Wood,L,COL,29,78,13,14,27
22,8475231,Casey Cizikas,C,NYI,33,77,13,14,27
22,8481624,Ilya Mikheyev,R,CHI,30,54,11,16,27
22,8477987,Ryan Donato,C,CHI,28,63,11,16,27
22,8482146,Luke Evangelista,R,NSH,22,71,9,18,27
22,8478020,Michael Amadio,R,OTT,28,77,9,18,27
22,8482809,Jackson Blake,R,CAR,21,60,9,18,27
22,8476927,Teddy Blueger,C,VAN,30,66,8,19,27
22,8478970,Jalen Chatfield,D,CAR,28,68,8,19,27
22,8478891,Mason Appleton,C,WPG,28,66,8,19,27
22,8481581,Thomas Harley,D,DAL,23,71,7,20,27
22,8477506,Ryan Pulock,D,NYI,30,77,5,22,27
22,8480043,Timothy Liljegren,D,TOR,25,61,4,23,27
22,8481606,Jordan Spence,D,LAK,23,69,4,23,27
22,8474151,Ryan McDonagh,D,TBL,35,75,3,24,27
22,8474673,TJ Brodie,D,CHI,34,63,3,24,27
22,8479390,Taylor Raddysh,R,WSH,26,64,14,12,26
22,8480078,Filip Chytil,C,NYR,25,70,13,13,26
22,8473533,Jordan Staal,C,CAR,36,63,13,13,26
22,8474053,Logan Couture,C,SJS,35,55,10,16,26
22,8482660,Kent Johnson,C,CBJ,22,64,9,17,26
22,8475171,Oliver Ekman-Larsson,D,TOR,33,69,7,19,26
22,8476921,Jordan Martinook,L,CAR,32,65,7,19,26
22,8475764,Cam Fowler,D,ANA,33,71,5,21,26
22,8476467,Jamie Oleksiak,D,SEA,32,65,5,21,26
22,8482245,Artem Zub,D,OTT,29,67,5,21,26
22,8479316,Luke Kunin,C,SJS,27,57,14,11,25
22,8480748,Kiefer Sherwood,L,VAN,29,62,13,12,25
22,8477478,William Carrier,L,CAR,30,62,13,12,25
22,8477508,Curtis Lazar,C,NJD,29,61,12,13,25
22,8481523,Kirby Dach,C,MTL,23,59,11,14,25
22,8475220,Marcus Foligno,L,MIN,33,59,11,14,25
22,8480806,Isac Lundestrom,C,ANA,25,64,11,14,25
22,8482079,Marco Rossi,C,MIN,23,53,10,15,25
22,8473563,Nicklas Backstrom,C,WSH,37,51,8,17,25
22,8478851,Alexandre Carrier,D,NSH,28,62,3,22,25
22,8476892,Colton Parayko,D,STL,31,71,2,23,25
22,8479619,Michael Carcone,L,UTA,28,68,15,9,24
22,8480893,Kirill Marchenko,R,CBJ,24,57,12,12,24
22,8475791,Taylor Hall,L,CHI,33,57,12,12,24
22,8479315,Joey Anderson,R,CHI,26,52,12,12,24
22,8478432,Christian Fischer,R,DET,27,72,12,12,24
22,8479591,Michael Eyssimont,C,TBL,28,80,11,13,24
22,8477429,Andrew Copp,C,DET,30,77,11,13,24
22,8479414,Nathan Bastian,R,NJD,27,60,11,13,24
22,8479353,Brett Howden,C,VGK,26,67,11,13,24
22,8470621,Corey Perry,R,EDM,39,70,10,14,24
22,8476374,Sean Kuraly,C,CBJ,31,48,9,15,24
22,8475462,Radko Gudas,D,ANA,34,67,7,17,24
22,8482087,Kaiden Guhle,D,MTL,22,64,6,18,24
22,8479639,Dylan Coghlan,D,WPG,26,66,5,19,24
22,8479371,Dante Fabbro,D,NSH,26,64,5,19,24
22,8482142,Jamie Drysdale,D,PHI,22,62,4,20,24
22,8477488,Brett Pesce,D,NJD,30,65,3,21,24
22,8478507,John Marino,D,UTA,27,62,0,24,24
22,8475343,Nic Dowd,C,WSH,34,67,14,9,23
22,8481553,Bobby Brink,R,PHI,23,64,12,11,23
22,8477947,Sonny Milano,L,WSH,28,64,11,12,23
22,8482155,Alex Laferriere,R,LAK,23,63,11,12,23
22,8478413,Jordan Greenway,L,BUF,27,58,9,14,23
22,8480802,Ryan McLeod,C,BUF,25,59,9,14,23
22,8480035,Henri Jokiharju,D,BUF,25,66,6,17,23
22,8478416,Erik Cernak,D,TBL,27,73,5,18,23
22,8478136,Jake Middleton,D,MIN,28,75,3,20,23
22,8479983,Mario Ferraro,D,SJS,26,71,2,21,23
22,8477952,Robby Fabbri,C,ANA,28,66,13,9,22
22,8479293,Brandon Tanev,L,SEA,33,64,12,10,22
22,8478434,Keegan Kolesar,R,VGK,27,70,10,12,22
22,8479026,Philippe Myers,D,TOR,27,60,9,13,22
22,8482101,Danil Gushchin,L,SJS,22,57,8,14,22
22,8476312,Josh Manson,D,COL,33,63,6,16,22
22,8476891,Matthew Grzelcyk,D,PIT,30,74,2,20,22
22,8479976,Juuso Valimaki,D,UTA,26,66,1,21,22
22,8483524,Shane Wright,C,SEA,20,65,15,6,21
22,8476469,Joel Armia,R,MTL,31,57,14,7,21
22,8478013,Jake Walman,D,SJS,28,71,13,8,21
22,8480980,Connor Dewar,C,TOR,25,73,13,8,21
22,8479368,Max Jones,L,BOS,26,62,12,9,21
22,8476960,Andreas Athanasiou,C,CHI,30,46,11,10,21
22,8475225,Craig Smith,C,CHI,35,50,11,10,21
22,8483499,Liam Ohgren,L,MIN,20,47,11,10,21
22,8482749,Joshua Roy,R,MTL,21,61,10,11,21
22,8482074,Connor Zary,C,CGY,23,61,10,11,21
22,8477369,Carson Soucy,D,VAN,30,65,10,11,21
22,8480281,Alexey Toropchenko,R,STL,25,63,10,11,21
22,8483565,Nick Blankenburg,D,NSH,26,61,9,12,21
22,8476422,Mike Reilly,D,NYI,31,72,9,12,21
22,8480855,Jack McBain,C,UTA,24,63,9,12,21
22,8477353,Tyler Motte,C,DET,29,74,9,12,21
22,8483468,Jiri Kulich,C,BUF,20,60,8,13,21
22,8480807,Mattias Samuelsson,D,BUF,24,51,7,14,21
22,8479402,Jake Bean,D,CGY,26,68,6,15,21
22,8476463,Jonas Brodin,D,MIN,31,77,5,16,21
22,8476873,Mark Jankowski,C,NSH,30,50,5,16,21
22,8480172,Jan Rutta,D,SJS,34,64,5,16,21
22,8474574,Tyler Myers,D,VAN,34,68,4,17,21
22,8476879,Cody Ceci,D,EDM,31,68,4,17,21
22,8475690,Chris Tanev,D,TOR,35,62,4,17,21
22,8478882,Vladislav Gavrikov,D,LAK,29,69,4,17,21
22,8480222,Sebastian Aho,D,PIT,28,69,4,17,21
22,8478399,Jonas Siegenthaler,D,NJD,27,62,3,18,21
22,8479336,Carl Grundstrom,R,SJS,27,55,13,7,20
22,8480762,Eric Robinson,L,CAR,29,54,9,11,20
22,8479941,Justin Danforth,R,CBJ,31,57,9,11,20
22,8479393,Noah Gregor,L,OTT,26,75,9,11,20
22,8480995,Pontus Holmberg,R,TOR,25,61,9,11,20
22,8480144,David Kampf,C,TOR,29,68,8,12,20
22,8481601,Simon Holmstrom,R,NYI,23,68,8,12,20
22,8481522,Peyton Krebs,C,BUF,23,61,7,13,20
22,8482067,Connor Mackey,D,NYR,28,65,5,15,20
22,8477839,Conor Sheary,L,TBL,32,82,5,15,20
22,8476856,Mathew Dumba,D,DAL,30,74,5,15,20
22,8476988,Matt Benning,D,SJS,30,69,3,17,20
22,8476917,Adam Pelech,D,NYI,30,74,2,18,20
22,8479718,Alex Barré-Boulet,C,MTL,27,56,12,7,19
22,8477406,Mattias Janmark,C,EDM,32,64,11,8,19
22,8478569,Noel Acciari,C,PIT,33,48,10,9,19
22,8480829,Jesperi Kotkaniemi,C,CAR,24,70,9,10,19
22,8476902,Esa Lindell,D,DAL,30,75,7,12,19
22,8477015,Connor Brown,R,EDM,30,68,6,13,19
22,8482111,Justin Barron,D,MTL,23,61,5,14,19
22,8477435,Ryan Graves,D,PIT,29,74,5,14,19
22,8482148,Hendrix Lapierre,C,WSH,22,55,5,14,19
22,8482730,Brandt Clarke,D,LAK,21,55,5,14,19
22,8480289,Morgan Barron,C,WPG,26,53,5,14,19
22,8481521,Ronnie Attard,D,PHI,25,58,4,15,19
22,8478043,Sam Lafferty,C,BUF,29,63,3,16,19
22,8481019,David Gustafsson,C,WPG,24,47,3,16,19
22,8475188,Brayden McNabb,D,VGK,33,61,2,17,19
22,8478443,Brandon Carlo,D,BOS,28,58,0,19,19
22,8481477,Nico Sturm,C,SJS,29,48,11,7,18
22,8481582,Nicholas Robertson,L,TOR,23,61,10,8,18
22,8480789,Oliver Wahlstrom,R,NYI,24,66,9,9,18
22,8482062,Cole Smith,L,NSH,29,57,9,9,18
22,8483482,Tristan Luneau,D,ANA,20,67,9,9,18
22,8477450,Jason Dickinson,C,CHI,29,58,8,10,18
22,8477392,Hudson Fasching,R,NYI,29,61,8,10,18
22,8477903,Garnet Hathaway,R,PHI,33,70,7,11,18
22,8477919,Frederick Gaudreau,C,MIN,31,59,7,11,18
22,8482666,Scott Morrow,D,CAR,22,55,7,11,18
22,8482077,Dylan Holloway,L,EDM,23,56,7,11,18
22,8479982,Conor Timmins,D,TOR,26,54,6,12,18
22,8475455,Brenden Dillon,D,NJD,34,62,6,12,18
22,8477220,Nate Schmidt,D,FLA,33,67,6,12,18
22,8476994,Vinnie Hinostroza,C,NSH,30,41,6,12,18
22,8476525,Colin Miller,D,WPG,32,59,5,13,18
22,8480873,Rasmus Sandin,D,WSH,24,56,4,14,18
22,8475181,Nick Leddy,D,STL,33,67,2,16,18
22,8476331,Dylan DeMelo,D,WPG,31,69,2,16,18
22,8476878,Zemgus Girgensons,C,TBL,30,76,12,5,17
22,8473453,Trevor Lewis,C,LAK,37,72,10,7,17
22,8476278,Colin Blackwell,C,DAL,31,78,8,9,17
22,8481013,Jonatan Berggren,R,DET,24,60,7,10,17
22,8482737,Zack Bolduc,C,STL,21,54,6,11,17
22,8481441,Joe Snively,C,DET,28,63,6,11,17
22,8482073,Braden Schneider,D,NYR,23,62,6,11,17
22,8477070,Liam O'Brien,C,UTA,30,53,6,11,17
22,8481599,Victor Soderstrom,D,UTA,23,54,5,12,17
22,8476457,Adam Larsson,D,SEA,32,65,3,14,17
22,8480727,Zach Whitecloud,D,VGK,28,51,3,14,17
22,8482803,Olen Zellweger,D,ANA,21,64,2,15,17
22,8480246,Nick Perbix,D,TBL,26,71,2,15,17
22,8480073,Erik Brannstrom,D,COL,25,68,1,16,17
22,8478840,Will Borgen,D,SEA,28,68,1,16,17
22,8475324,Nick Jensen,D,OTT,34,73,1,16,17
22,8479998,Mikey Anderson,D,LAK,25,60,0,17,17
22,8482259,Bobby McMann,C,TOR,28,56,11,5,16
22,8481716,Dmitri Voronkov,L,CBJ,24,46,11,5,16
22,8481032,Paul Cotter,C,NJD,25,63,10,6,16
22,8479359,Beck Malenstyn,L,BUF,26,46,10,6,16
22,8476934,Brock McGinn,L,ANA,30,49,10,6,16
22,8479066,Ryan Lomberg,L,CGY,30,66,9,7,16
22,8479344,Jesse Puljujarvi,R,PIT,26,52,8,8,16
22,8480848,Ty Dellandrea,C,SJS,24,54,8,8,16
22,8480021,Jack Studnicka,C,LAK,25,58,8,8,16
22,8475842,Sam Carrick,C,NYR,32,64,7,9,16
22,8483457,Lane Hutson,D,MTL,20,67,6,10,16
22,8482634,Alex Steeves,C,TOR,25,40,6,10,16
22,8480011,Klim Kostin,C,SJS,25,53,5,11,16
22,8475279,Ben Chiarot,D,DET,33,61,4,12,16
22,8481178,Egor Zamula,D,PHI,24,60,3,13,16
22,8476967,Brett Kulak,D,EDM,30,62,3,13,16
22,8482192,Isaak Phillips,D,CHI,23,50,3,13,16
22,8477845,Trevor van Riemsdyk,D,WSH,33,60,3,13,16
22,8475233,David Savard,D,MTL,34,71,1,15,16
22,8481568,Alex Vlasic,D,CHI,23,58,1,15,16
22,8480049,Dylan Samberg,D,WPG,25,62,1,15,16
22,8480950,Ilya Lyubushkin,D,DAL,30,60,0,16,16
22,8483495,Simon Nemec,D,NJD,20,51,11,4,15
22,8480205,Emil Bemstrom,C,PIT,25,54,9,6,15
22,8482659,Josh Doan,R,UTA,22,50,8,7,15
22,8477446,Michael McCarron,R,NSH,29,53,7,8,15
22,8480074,Alexandre Texier,C,STL,25,54,7,8,15
22,8480157,Calle Rosen,D,COL,30,50,7,8,15
22,8480003,Jesper Boqvist,C,FLA,26,70,6,9,15
22,8482744,James Malatesta,L,CBJ,21,45,6,9,15
22,8483493,Frank Nazar,C,CHI,20,53,5,10,15
22,8476624,Barclay Goodrow,C,SJS,31,60,4,11,15
22,8481708,Zac Jones,D,NYR,24,48,3,12,15
22,8481059,Scott Perunovich,D,STL,26,58,1,14,15
22,8479249,Andrew Poturalski,C,SJS,30,36,1,14,15
22,8481617,Vasily Podkolzin,R,VAN,23,49,7,7,14
22,8482762,Simon Edvinsson,D,DET,21,54,7,7,14
22,8476822,Luke Glendening,C,TBL,35,76,7,7,14
22,8482157,Will Cuylle,L,NYR,22,61,6,8,14
22,8474034,Patrick Maroon,L,CHI,36,60,5,9,14
22,8479980,Nicolas Hague,D,VGK,26,51,5,9,14
22,8480448,Parker Kelly,L,COL,25,75,4,10,14
22,8480252,Cole Guttman,C,CHI,25,43,4,10,14
22,8479324,Ryan Lindgren,D,NYR,26,64,3,11,14
22,8480891,Michael Kesselring,D,UTA,24,53,3,11,14
22,8478178,Darren Raddysh,D,TBL,28,64,2,12,14
22,8482679,Matt Coronato,R,CGY,22,66,10,3,13
22,8481147,Reese Johnson,C,MIN,26,45,7,6,13
22,8477482,Zachary Sanford,L,CHI,30,44,6,7,13
22,8476442,Matt Nieto,L,PIT,32,45,5,8,13
22,8479543,Michael Pezzetta,L,MTL,26,58,5,8,13
22,8476429,Scott Mayfield,D,NYI,32,70,5,8,13
22,8480025,MacKenzie Entwistle,R,FLA,25,61,5,8,13
22,8479985,Cale Fleury,D,SEA,26,32,5,8,13
22,8483491,Ivan Miroshnichenko,L,WSH,20,47,4,9,13
22,8479972,Mason Shaw,C,WPG,26,39,4,9,13
22,8479370,Tyson Jost,C,CAR,26,49,3,10,13
22,8477507,Nikita Zadorov,D,BOS,29,66,3,10,13
22,8481527,Kaedan Korczak,D,VGK,23,50,3,10,13
22,8480070,Ian Mitchell,D,BOS,25,54,3,10,13
22,8475718,Justin Holl,D,DET,32,58,2,11,13
22,8480860,Kevin Bahl,D,CGY,24,52,2,11,13
22,8474567,Zach Bogosian,D,MIN,34,64,2,11,13
22,8475750,Jon Merrill,D,MIN,32,59,2,11,13
22,8484149,Gavin Brindley,C,CBJ,20,49,1,12,13
22,8477499,Rasmus Ristolainen,D,PHI,30,57,1,12,13
22,8481517,Brett Leason,R,ANA,25,51,0,13,13
22,8476858,Phillip Di Giuseppe,L,VAN,31,48,9,3,12
22,8475855,Jesper Fast,R,CAR,33,50,7,5,12
22,8481161,Jake Christiansen,D,CBJ,25,53,7,5,12
22,8481789,Tye Kartye,L,SEA,23,41,7,5,12
22,8479328,Julien Gauthier,R,NYI,27,58,6,6,12
22,8481704,Juuso Parssinen,C,NSH,23,44,5,7,12
22,8480845,Rasmus Kupari,C,WPG,24,41,4,8,12
22,8478468,Jeremy Lauzon,D,NSH,27,57,3,9,12
22,8474013,Ian Cole,D,UTA,35,50,3,9,12
22,8477380,Jonny Brodzinski,C,NYR,31,54,3,9,12
22,8480879,Jacob Bernard-Docker,D,OTT,24,50,3,9,12
22,8477018,Ben Hutton,D,VGK,31,48,3,9,12
22,8482166,Shakir Mukhamadullin,D,SJS,22,54,3,9,12
22,8482451,Mikael Pyyhtia,L,CBJ,23,44,3,9,12
22,8481701,Santeri Hatakka,D,NJD,23,38,2,10,12
22,8473446,Erik Johnson,D,PHI,36,55,1,11,12
22,8475208,Brian Dumoulin,D,ANA,33,66,1,11,12
22,8478859,Niko Mikkola,D,FLA,28,62,0,12,12
22,8480355,Mark Kastelic,C,BOS,25,59,6,5,11
22,8478211,Dryden Hunt,L,CGY,29,52,6,5,11
22,8479520,Brandon Duhaime,R,WSH,27,53,6,5,11
22,8478585,Derek Ryan,C,EDM,38,57,6,5,11
22,8482751,Ryan Winterton,C,SEA,21,35,6,5,11
22,8476889,Radek Faksa,C,STL,30,65,5,6,11
22,8478421,A.J. Greer,L,FLA,28,59,4,7,11
22,8481028,Martin Pospisil,C,CGY,25,61,4,7,11
22,8475958,Michael Sgarbossa,C,WSH,32,27,4,7,11
22,8476913,Devin Shore,C,MIN,30,41,4,7,11
22,8475179,Dmitry Kulikov,D,FLA,34,52,2,9,11
22,8483460,David Jiricek,D,CBJ,21,60,2,9,11
22,8477365,Connor Clifton,D,BUF,29,57,1,10,11
22,8474568,Luke Schenn,D,NSH,35,45,0,11,11
22,8479968,Vinni Lettieri,C,BOS,29,52,6,4,10
22,8482713,Mackie Samoskevich,R,FLA,22,40,6,4,10
22,8481641,Joel Kiviranta,L,COL,28,71,5,5,10
22,8481567,Henry Thrun,D,SJS,23,49,4,6,10
22,8479439,Jacob MacDonald,D,COL,31,40,4,6,10
22,8483549,Lucas Condotta,L,MTL,27,37,4,6,10
22,8479378,Logan Stanley,D,WPG,26,42,3,7,10
22,8480441,Trey Fix-Wolansky,R,CBJ,25,37,3,7,10
22,8476867,Brendan Gaunce,C,MIN,30,38,2,8,10
22,8470600,Ryan Suter,D,STL,39,61,1,9,10
22,8479348,Kale Clague,D,BUF,26,35,1,9,10
22,8480058,Pierre-Olivier Joseph,D,STL,25,56,0,10,10
22,8477573,Nathan Walker,L,STL,30,48,5,4,9
22,8479671,Mathieu Olivier,R,CBJ,27,50,5,4,9
22,8481518,Nolan Foote,L,NJD,24,42,5,4,9
22,8482747,Brennan Othmann,L,NYR,21,39,4,5,9
22,8477335,Kyle Burroughs,D,LAK,29,40,4,5,9
22,8479369,Andrew Peeke,D,BOS,26,60,3,6,9
22,8476372,Nick Seeler,D,PHI,31,41,3,6,9
22,8481543,Nikita Alexandrov,C,STL,24,36,3,6,9
22,8479442,Troy Stecher,D,EDM,30,59,3,6,9
22,8477931,Tomas Nosek,L,FLA,32,62,2,7,9
22,8482807,Ethan Del Mastro,D,CHI,21,51,1,8,9
22,8482176,Wyatt Kaiser,D,CHI,22,62,1,8,9
22,8484254,Akito Hirose,D,VAN,25,45,1,8,9
22,8481122,Simon Benoit,D,TOR,26,40,1,8,9
22,8482861,Vincent Iorio,D,WSH,22,39,0,9,9
22,8479638,Justin Brazeau,R,BOS,26,41,6,2,8
22,8480844,Grigori Denisenko,L,VGK,24,32,5,3,8
22,8482141,Lukas Cormier,D,VGK,22,30,4,4,8
22,8481532,Alex Turcotte,C,LAK,23,43,3,5,8
22,8479372,Joshua Mahura,D,SEA,26,60,3,5,8
22,8471817,Ryan Reaves,R,TOR,37,56,3,5,8
22,8479772,Zack MacEwen,R,OTT,28,50,3,5,8
22,8480880,Jakub Lauko,C,MIN,24,26,3,5,8
22,8481537,Nikita Okhotiuk,D,CGY,24,53,2,6,8
22,8480192,Johnathan Kovacevic,D,NJD,27,53,2,6,8
22,8481600,Tobias Bjornfot,D,FLA,23,37,2,6,8
22,8475235,Nicolas Deslauriers,L,PHI,33,50,2,6,8
22,8482964,Arber Xhekaj,D,MTL,23,48,1,7,8
22,8476874,Olli Maatta,D,DET,30,60,1,7,8
22,8481056,Spencer Stastney,D,NSH,24,38,1,7,8
22,8480990,Declan Chisholm,D,MIN,24,35,1,7,8
22,8480796,Martin Fehervary,D,WSH,25,50,0,8,8
22,8480887,Jordan Harris,D,MTL,24,52,0,8,8
22,8475177,Calvin de Haan,D,COL,33,41,0,8,8
22,8480196,Jacob Bryson,D,BUF,27,44,0,8,8
22,8482858,Ryker Evans,D,SEA,23,21,5,2,7
22,8482784,Zach Dean,C,STL,21,31,4,3,7
22,8482070,Mitchell Chaffee,R,TBL,26,52,4,3,7
22,8480007,Jonas Rondbjerg,R,VGK,25,33,3,4,7
22,8482095,Tyler Kleven,D,OTT,22,45,3,4,7
22,8477462,Robert Hagg,D,VGK,29,23,3,4,7
22,8480001,Urho Vaakanainen,D,ANA,25,51,2,5,7
22,8478452,Caleb Jones,D,LAK,27,59,2,5,7
22,8479379,Givani Smith,R,SJS,26,21,2,5,7
22,8482859,Zack Ostapchuk,C,OTT,21,51,2,5,7
22,8471677,Jack Johnson,D,CBJ,37,65,1,6,7
22,8482165,Yan Kuznetsov,D,CGY,22,13,1,6,7
22,8474062,Riley Nash,C,NYR,35,24,1,6,7
22,8471709,Marc-Edouard Vlasic,D,SJS,37,58,0,7,7
22,8481550,Adam Beckman,L,NJD,23,42,0,7,7
22,8478874,Adam Gaudette,R,OTT,28,38,0,7,7
22,8481605,Jackson LaCombe,D,ANA,23,34,0,7,7
22,8479536,Axel Jonsson-Fjallby,L,WPG,26,33,4,2,6
22,8483630,Pavol Regenda,L,ANA,25,33,4,2,6
22,8478409,Anthony Richard,C,PHI,28,25,4,2,6
22,8481754,Nikita Nesterenko,C,ANA,23,37,4,2,6
22,8480267,Sammy Walker,C,MIN,25,20,4,2,6
22,8478881,Brett Seney,L,CHI,28,12,4,2,6
22,8479291,Kevin Rooney,C,CGY,31,49,3,3,6
22,8481679,Maxence Guenette,D,OTT,23,37,3,3,6
22,8482145,Mavrik Bourque,C,DAL,22,52,3,3,6
22,8482177,Marat Khusnutdinov,C,MIN,22,33,3,3,6
22,8478451,Ethan Bear,D,WSH,27,50,2,4,6
22,8477887,Patrick Brown,C,BOS,32,47,2,4,6
22,8478146,Matthew Highmore,C,OTT,28,35,2,4,6
22,8478424,Jansen Harkins,C,ANA,27,40,2,4,6
22,8475795,Dylan McIlrath,D,WSH,32,19,2,4,6
22,8481751,Lukas Rousek,R,BUF,25,36,1,5,6
22,8482733,Logan Mailloux,D,MTL,31,35,1,5,6
22,8475762,Derek Forbort,D,VAN,32,42,1,5,6
22,8476441,Joel Edmundson,D,LAK,31,37,1,5,6
22,8477034,Jaycob Megna,D,FLA,32,55,0,6,6
22,8481556,John Beecher,C,BOS,23,30,4,1,5
22,8474090,Brendan Smith,D,DAL,35,52,4,1,5
22,8480032,Shane Bowers,C,NJD,25,16,4,1,5
22,8479994,Jaret Anderson-Dolan,C,WPG,25,29,4,1,5
22,8478454,Noah Juulsen,D,VAN,27,35,3,2,5
22,8483466,Kevin Korchinski,D,CHI,20,52,3,2,5
22,8483397,Marc McLaughlin,C,BOS,25,25,3,2,5
22,8482172,Landon Slaggert,L,CHI,22,22,3,2,5
22,8475755,Alexander Petrovic,D,DAL,32,13,3,2,5
22,8479986,Kole Lind,R,DAL,26,44,2,3,5
22,8481609,Vladislav Kolyachonok,D,UTA,23,35,2,3,5
22,8482153,Brendan Brisson,C,VGK,23,33,2,3,5
22,8478017,Mark Friedman,D,VAN,29,30,2,3,5
22,8482470,Ilya Solovyov,D,CGY,24,22,2,3,5
22,8477244,Chad Ruhwedel,D,NYR,34,29,2,3,5
22,8481699,Aku Raty,R,UTA,23,17,2,3,5
22,8481719,Maxwell Crozier,D,TBL,24,19,2,3,5
22,8479944,Zach Aston-Reese,C,VGK,30,45,1,4,5
22,8478831,Kevin Stenlund,C,UTA,28,46,1,4,5
22,8481592,Jakob Pelletier,L,CGY,23,30,1,4,5
22,8474166,Alec Martinez,D,CHI,37,45,1,4,5
22,8481167,Brayden Pachal,D,CGY,25,42,1,4,5
22,8476952,Dominic Toninato,C,WPG,30,29,0,5,5
22,8478450,Parker Wotherspoon,D,BOS,27,30,0,5,5
22,8479981,Jonah Gadjovich,L,FLA,26,44,3,1,4
22,8482144,Jack Thompson,D,SJS,22,21,3,1,4
22,8477473,Justin Bailey,R,SJS,29,23,3,1,4
22,8482102,Vasily Ponomarev,C,PIT,22,23,3,1,4
22,8483763,Maksymilian Szuber,D,UTA,22,25,3,1,4
22,8482652,Walker Duehr,R,CGY,27,29,2,2,4
22,8481598,Philip Broberg,D,EDM,23,36,2,2,4
22,8482511,Mason Lohrei,D,BOS,23,36,2,2,4
22,8482765,Isak Rosen,R,BUF,21,29,2,2,4
22,8477320,Anton Blidh,L,NYR,29,16,2,2,4
22,8483012,Logan Morrison,C,SEA,22,39,2,2,4
22,8480245,Olle Lycksell,R,PHI,25,31,2,2,4
22,8474612,Travis Hamonic,D,OTT,34,45,1,3,4
22,8483619,Filip Roos,D,OTT,25,31,1,3,4
22,8477384,Joshua Brown,D,EDM,30,42,1,3,4
22,8477527,Ross Johnston,L,ANA,30,26,1,3,4
22,8480834,Ty Emberson,D,SJS,24,35,1,3,4
22,8478051,Max Willman,C,NJD,29,24,1,3,4
22,8481585,Egor Afanasyev,L,SJS,23,13,1,3,4
22,8480292,Carson Meyer,R,ANA,27,32,0,4,4
22,8477851,Jordan Oesterle,D,BOS,32,41,0,4,4
22,8484911,Collin Graf,R,SJS,22,41,0,4,4
22,8477467,Gustav Olofsson,D,SEA,30,17,0,4,4
22,8479362,Riley Tufte,L,BOS,26,19,3,0,3
22,8477962,Brendan Lemieux,L,CAR,28,36,2,1,3
22,8482496,Nils Aman,C,VAN,24,33,2,1,3
22,8482201,Gage Goncalves,C,TBL,23,26,2,1,3
22,8481206,John Ludvig,D,PIT,24,14,2,1,3
22,8480870,Bo Groulx,C,NYR,24,26,2,1,3
22,8477810,Joel Hanley,D,CGY,33,21,2,1,3
22,8482061,Brandon Biro,L,SEA,26,10,2,1,3
22,8481422,Jake Lucchini,C,NSH,29,19,2,1,3
22,8477541,Dakota Mermis,D,TOR,30,8,2,1,3
22,8479991,Jake Leschyshyn,C,NYR,25,23,1,2,3
22,8481743,Marc Del Gaizo,D,NSH,25,17,1,2,3
22,8481237,Kyle MacLean,C,NYI,25,23,1,2,3
22,8482250,Callahan Burke,C,VGK,27,23,1,2,3
22,8483570,Ben Meyers,C,SEA,26,27,1,2,3
22,8481541,Samuel Bolduc,D,NYI,24,32,1,2,3
22,8477073,Kurtis MacDermid,L,NJD,30,22,1,2,3
22,8482118,Sam Colangelo,R,ANA,23,17,1,2,3
22,8478446,Glenn Gawdin,C,LAK,27,10,1,2,3
22,8477938,Haydn Fleury,D,WPG,28,47,0,3,3
22,8484258,Sam Malinski,D,COL,26,29,0,3,3
22,8477971,Andreas Englund,D,LAK,28,23,0,3,3
22,8480075,Cameron Crotty,D,MIN,25,10,0,3,3
22,8481593,Jayden Struble,D,MTL,23,17,0,3,3
22,8480823,Alexander Alexeyev,D,WSH,25,17,0,3,3
22,8480084,Nick DeSimone,D,NJD,30,23,0,3,3
22,8477401,John Hayden,C,SEA,29,32,2,0,2
22,8478021,William Lagesson,D,DET,28,27,1,1,2
22,8482162,Roby Jarventie,L,EDM,22,14,1,1,2
22,8483489,Fraser Minten,C,TOR,31,8,1,1,2
22,8480890,Jan Jenik,C,OTT,24,24,1,1,2
22,8478477,Mitchell Stephens,C,SEA,27,14,1,1,2
22,8484325,Waltteri Merela,C,TBL,26,21,1,1,2
22,8479367,William Lockwood,R,FLA,26,19,1,1,2
22,8484287,Cole McWard,D,VAN,23,27,1,1,2
22,8478854,Ryan Shea,D,PIT,27,7,1,1,2
22,8478502,Dennis Gilbert,D,BUF,28,16,1,1,2
22,8479419,Brett Murray,L,BUF,26,21,1,1,2
22,8481564,Ryan Johnson,D,BUF,23,10,1,1,2
22,8479576,Vincent Desharnais,D,VAN,28,33,0,2,2
22,8476473,Connor Murphy,D,CHI,31,38,0,2,2
22,8479587,Rhett Gardner,C,PHI,28,24,0,2,2
22,8482929,Emil Lilleberg,D,TBL,23,23,0,2,2
22,8483395,Arshdeep Bains,L,VAN,23,10,0,2,2
22,8481006,Tyler Tucker,D,STL,24,18,0,2,2
22,8482094,Daemon Hunt,D,MIN,22,15,0,2,2
22,8481462,Mason Morelli,L,VGK,28,11,0,2,2
22,8483597,Milos Kelemen,L,UTA,25,13,1,0,1
22,8482088,Justin Sourdif,R,FLA,22,13,1,0,1
22,8481578,Graeme Clarke,R,MIN,23,9,1,0,1
22,8482147,Jean-Luc Foudy,C,COL,22,25,1,0,1
22,8483471,Brad Lambert,C,WPG,31,16,1,0,1
22,8481030,Jack St. Ivany,D,PIT,25,19,1,0,1
22,8479522,Hardy Haman Aktell,D,WSH,26,4,1,0,1
22,8481655,Cole Schwindt,R,CGY,23,6,1,0,1
22,8483609,Adam Klapka,R,CGY,24,7,1,0,1
22,8483512,Matthew Savoie,C,EDM,20,17,0,1,1
22,8481065,Angus Crookshank,L,OTT,25,18,0,1,1
22,8480874,Adam Ginning,D,PHI,24,6,0,1,1
22,8480468,James Hamblin,L,EDM,25,25,0,1,1
22,8477149,Scott Sabourin,R,SJS,32,14,0,1,1
22,8482476,Emil Heineman,L,MTL,23,9,0,1,1
22,8483398,Declan Carlile,D,TBL,31,5,0,1,1
22,8482516,Matthew Kessel,D,STL,24,16,0,1,1
22,8484255,Jason Polin,R,COL,25,4,0,1,1
22,8484326,Patrik Koch,D,UTA,28,6,0,1,1
22,8479320,Maxime Lajoie,D,SEA,27,18,0,0,0
22,8480851,Akil Thomas,C,LAK,24,21,0,0,0
22,8478011,Louie Belpedio,D,PHI,28,9,0,0,0
22,8481726,Adam Edstrom,C,NYR,24,5,0,0,0
22,8482197,Adam Raska,R,MIN,23,6,0,0,0
22,8483567,Georgii Merkulov,C,BOS,24,13,0,0,0
22,8479330,Brandon Gignac,C,MTL,27,10,0,0,0
22,8481806,Louis Crevier,D,CHI,23,6,0,0,0
22,8480306,Grant Hutton,D,NYI,29,10,0,0,0
22,8475413,Justin Dowling,C,NJD,34,14,0,0,0
22,8482126,Emil Andrae,D,PHI,31,2,0,0,0
22,8478956,Samuel Laberge,L,NJD,27,2,0,0,0
22,8478147,Bokondji Imama,L,PIT,28,9,0,0,0
22,8481043,Cole Koepke,L,BOS,26,17,0,0,0
22,8483407,Brandon Scanlin,D,NYR,25,6,0,0,0
22,8484304,Uvis Balinskis,D,FLA,28,7,0,0,0
22,8482787,Nikita Chibrikov,R,WPG,31,6,0,0,0
22,8483920,Pierrick Dube,R,WSH,23,2,0,0,0
22,8479421,Jacob Moverare,D,LAK,26,5,0,0,0
22,8483546,Marshall Rifai,D,TOR,26,5,0,0,0
22,8482460,Matt Rempe,C,NYR,22,6,0,0,0
22,8475780,Chris Wagner,R,COL,33,4,0,0,0
22,8481024,Linus Karlsson,C,VAN,25,8,0,0,0
22,8477993,Justin Kirkland,C,CGY,28,4,0,0,0
22,8481534,Raphael Lavoie,C,EDM,24,2,0,0,0
22,8483432,Luca Del Bel Belluz,C,CBJ,31,4,0,0,0
22,8476323,Max McCormick,L,SEA,32,5,0,0,0
22,8483401,Marc Johnstone,R,PIT,28,1,0,0,0
22,8483531,Brian Halonen,L,NJD,25,3,0,0,0
22,8484259,Ondrej Pavel,C,COL,31,3,0,0,0
22,8484321,Nikolas Matinpalo,D,OTT,26,0,0,0,0
22,8470794,Joe Pavelski,C,,40,0,0,0,0
22,8479321,Lucas Johansen,D,,27,0,0,0,0
22,8477950,Tony DeAngelo,D,,29,0,0,0,0
22,8471218,Blake Wheeler,R,,38,0,0,0,0
22,8475197,Tyson Barrie,D,,33,0,0,0,0
22,8474157,Max Pacioretty,L,,36,0,0,0,0
22,8475744,Evgeny Kuznetsov,C,,32,0,0,0,0
22,8474037,James van Riemsdyk,L,,35,0,0,0,0
22,8476907,Mackenzie MacEachern,L,,30,0,0,0,0
22,8480216,Jacob Peterson,C,,25,0,0,0,0
22,8474602,Justin Schultz,D,,34,0,0,0,0
22,8482222,Alexander Barabanov,L,,30,0,0,0,0
22,8474031,Kevin Shattenkirk,D,,35,0,0,0,0
22,8477330,Dominik Kubalik,L,,29,0,0,0,0
22,8480884,Calen Addison,D,,24,0,0,0,0
22,8475906,John Klingberg,D,,32,0,0,0,0
22,8480008,Adam Ruzicka,C,,25,0,0,0,0
22,8476884,Derrick Pouliot,D,,30,0,0,0,0
22,8476919,Chris Tierney,C,,30,0,0,0,0
22,8479415,Michael McLeod,C,,26,0,0,0,0
22,8474870,Tyler Johnson,C,,34,0,0,0,0
22,8470604,Jeff Carter,C,,39,0,0,0,0
22,8478104,Sammy Blais,L,,28,0,0,0,0
22,8474884,Mike Hoffman,C,,35,0,0,0,0
22,8481591,Sam Poulin,R,,23,0,0,0,0
22,8471274,Alex Goligoski,D,,39,0,0,0,0
22,8476871,Tanner Pearson,L,,32,0,0,0,0
22,8476393,Nick Cousins,C,,31,0,0,0,0
22,8479977,Kailer Yamamoto,R,,26,0,0,0,0
22,8479346,Dillon Dube,C,,26,0,0,0,0
22,8480184,Gustav Lindstrom,D,,26,0,0,0,0
22,8479376,Victor Mete,D,,26,0,0,0,0
22,8473449,Kyle Okposo,R,,36,0,0,0,0
22,8481058,Jesse Ylonen,R,,25,0,0,0,0
22,8475752,Tyler Pitlick,C,,33,0,0,0,0
22,8481239,Samuel Fagemo,L,,24,0,0,0,0
22,8480821,Filip Zadina,R,,25,0,0,0,0
22,8470966,Mark Giordano,D,,41,0,0,0,0
22,8478495,Denis Gurianov,R,,27,0,0,0,0
22,8477464,Nic Petan,C,,29,0,0,0,0
22,8478099,Kevin Labanc,R,,29,0,0,0,0
22,8482241,Radim Zohorna,L,,28,0,0,0,0
22,8474040,Sam Gagner,C,,35,0,0,0,0
22,8479514,Rem Pitlick,C,,27,0,0,0,0
22,8478430,Oliver Kylington,D,,27,0,0,0,0
22,8479533,Joona Koppanen,L,,26,0,0,0,0
22,8479984,Cal Foote,D,,26,0,0,0,0
22,8477126,Jayson Megna,C,,34,0,0,0,0
22,8475164,Jakob Silfverberg,R,,34,0,0,0,0
22,8474009,Nick Bonino,C,,36,0,0,0,0
22,8479458,Nikita Zaitsev,D,,33,0,0,0,0
22,8477944,Jakub Vrana,L,,28,0,0,0,0
22,8471699,Andrew Cogliano,C,,37,0,0,0,0
22,8478067,Oskar Lindblom,L,,28,0,0,0,0
22,8471686,Marc Staal,D,,37,0,0,0,0
22,8470610,Zach Parise,L,,40,0,0,0,0
22,8478904,Steven Lorentz,C,,28,0,0,0,0
22,8473473,Milan Lucic,L,,36,0,0,0,0
22,8480031,Maxime Comtois,L,,25,0,0,0,0
22,8478512,Austin Czarnik,C,,32,0,0,0,0
22,8473504,Cal Clutterbuck,R,,37,0,0,0,0
22,8477454,Adam Erne,L,,29,0,0,0,0
22,8479383,Boris Katchouk,L,,26,0,0,0,0
22,8475825,Jani Hakanpää,D,,32,0,0,0,0
22,8477846,Ryan Carpenter,C,,33,0,0,0,0
22,8477930,Pierre-Edouard Bellemare,L,,39,0,0,0,0
22,8478400,Colin White,C,,27,0,0,0,0
22,8480226,Marián Studenic,R,,26,0,0,0,0
22,8480853,Liam Foudy,C,,24,0,0,0,0
22,8475797,Jarred Tinordi,D,,32,0,0,0,0
22,8479423,Alex Nylander,L,,26,0,0,0,0
22,8474618,Marco Scandella,D,,34,0,0,0,0
22,8478028,Fredrik Olofsson,L,,28,0,0,0,0
22,8474709,Matt Martin,L,,35,0,0,0,0
22,8481070,Hugh McGing,L,,26,0,0,0,0
22,8479546,Oskar Steen,C,,26,0,0,0,0
22,8474145,Robert Bortuzzo,D,,35,0,0,0,0
22,8476915,Jujhar Khaira,L,,30,0,0,0,0
22,8480274,Philip Kemp,D,EDM,25,0,0,0,0
22,8475278,Byron Froese,C,,33,0,0,0,0
22,8481812,Nikolai Knyzhov,D,,27,0,0,0,0
22,8478408,Travis Dermott,D,,28,0,0,0,0
22,8481077,John Leonard,L,,26,0,0,0,0
22,8479547,Matthew Phillips,R,,26,0,0,0,0
22,8480836,Jonathan Gruden,C,,24,0,0,0,0
22,8481690,Tyler Angle,C,,24,0,0,0,0
22,8475766,Austin Watson,L,,32,0,0,0,0
22,8481016,Ruslan Iskhakov,C,,24,0,0,0,0
22,8478078,Rourke Chartier,C,,28,0,0,0,0
22,8480776,Sheldon Rempal,R,,29,0,0,0,0
22,8483045,Cameron Butler,R,CBJ,31,0,0,0,0
22,8484314,Jiri Smejkal,L,,28,0,0,0,0
23,8478402,Connor McDavid,C,EDM,27,81,51,108,159
23,8476453,Nikita Kucherov,R,TBL,31,82,45,97,142
23,8477492,Nathan MacKinnon,C,COL,29,82,51,87,138
23,8477934,Leon Draisaitl,C,EDM,29,78,54,80,134
23,8479314,Matthew Tkachuk,L,FLA,27,79,42,82,124
23,8477956,David Pastrnak,R,BOS,28,80,57,63,120
23,8478420,Mikko Rantanen,R,COL,28,79,53,67,120
23,8477493,Aleksander Barkov,C,FLA,29,79,34,86,120
23,8479318,Auston Matthews,C,TOR,27,81,65,43,108
23,8481559,Jack Hughes,C,NJD,23,76,34,74,108
23,8478550,Artemi Panarin,L,NYR,33,79,32,76,108
23,8476468,J.T. Miller,C,VAN,31,74,42,65,107
23,8480002,Nico Hischier,C,NJD,25,78,38,67,105
23,8478864,Kirill Kaprizov,L,MIN,27,70,48,55,103
23,8471675,Sidney Crosby,C,PIT,37,72,44,59,103
23,8476887,Filip Forsberg,L,NSH,30,74,41,59,100
23,8477404,Jake Guentzel,C,TBL,30,82,34,66,100
23,8478483,Mitch Marner,R,TOR,27,79,27,72,99
23,8480069,Cale Makar,D,COL,26,69,21,77,98
23,8477942,Kevin Fiala,L,LAK,28,79,34,63,97
23,8480012,Elias Pettersson,C,VAN,26,79,37,57,94
23,8479407,Jesper Bratt,L,NJD,26,77,31,63,94
23,8480027,Jason Robertson,L,DAL,25,82,32,60,92
23,8478445,Mathew Barzal,C,NYI,27,80,22,70,92
23,8482116,Tim Stützle,C,OTT,22,78,38,53,91
23,8480801,Brady Tkachuk,L,OTT,25,81,35,56,91
23,8484144,Connor Bedard,C,CHI,19,71,32,59,91
23,8480208,Drake Batherson,R,OTT,26,80,32,59,91
23,8477933,Sam Reinhart,C,FLA,29,76,44,46,90
23,8481557,Matt Boldy,L,MIN,23,73,30,57,87
23,8479420,Tage Thompson,C,BUF,27,78,46,40,86
23,8478403,Jack Eichel,C,VGK,28,76,34,52,86
23,8477946,Dylan Larkin,C,DET,28,80,38,46,84
23,8475172,Nazem Kadri,C,CGY,34,80,33,51,84
23,8480800,Quinn Hughes,D,VAN,25,75,20,64,84
23,8477939,William Nylander,R,TOR,28,79,31,52,83
23,8476460,Mark Scheifele,C,WPG,31,75,28,55,83
23,8474600,Roman Josi,D,NSH,34,75,14,69,83
23,8475168,Matt Duchene,C,DAL,33,82,39,43,82
23,8479542,Brandon Hagel,L,TBL,26,82,38,44,82
23,8478010,Brayden Point,C,TBL,28,82,34,47,81
23,8478398,Kyle Connor,L,WPG,28,70,40,40,80
23,8474564,Steven Stamkos,C,NSH,34,75,35,45,80
23,8479323,Adam Fox,D,NYR,26,76,13,66,79
23,8476881,Tomas Hertl,C,VGK,31,77,34,44,78
23,8476454,Ryan Nugent-Hopkins,C,EDM,31,79,18,60,78
23,8478449,Roope Hintz,C,DAL,28,81,35,40,75
23,8478439,Travis Konecny,R,PHI,27,78,30,45,75
23,8478460,Zach Werenski,D,CBJ,27,77,21,54,75
23,8474578,Erik Karlsson,D,PIT,34,76,16,59,75
23,8475754,Brock Nelson,C,NYI,33,81,41,33,74
23,8477501,Valeri Nichushkin,R,COL,29,82,36,38,74
23,8477504,Josh Morrissey,D,WPG,29,72,18,56,74
23,8473512,Claude Giroux,R,OTT,36,79,26,47,73
23,8476459,Mika Zibanejad,C,NYR,31,79,24,49,73
23,8480036,Miro Heiskanen,D,DAL,25,78,13,60,73
23,8476853,Morgan Rielly,D,TOR,30,73,13,60,73
23,8475786,Zach Hyman,L,EDM,32,76,40,32,72
23,8478975,Mason Marchment,L,DAL,29,81,35,37,72
23,8480015,Owen Tippett,R,PHI,25,75,35,37,72
23,8480023,Robert Thomas,C,STL,25,79,25,46,71
23,8475913,Mark Stone,R,VGK,32,74,27,43,70
23,8477503,Max Domi,C,TOR,29,81,20,50,70
23,8478366,Frank Vatrano,R,ANA,30,74,36,33,69
23,8482740,Wyatt Johnston,C,DAL,21,82,34,35,69
23,8479675,Trevor Moore,L,LAK,29,79,33,36,69
23,8478444,Brock Boeser,R,VAN,27,73,32,37,69
23,8479385,Jordan Kyrou,C,STL,26,76,31,38,69
23,8477409,Carter Verhaeghe,C,FLA,29,74,30,39,69
23,8476448,William Karlsson,C,VGK,31,75,22,47,69
23,8476539,Jonathan Marchessault,R,NSH,34,76,35,33,68
23,8476389,Vincent Trocheck,C,NYR,31,78,28,40,68
23,8477496,Elias Lindholm,C,BOS,30,78,26,42,68
23,8476346,Johnny Gaudreau,L,CBJ,31,72,19,49,68
23,8478493,Joel Eriksson Ek,C,MIN,27,76,32,35,67
23,8475692,Mats Zuccarello,R,MIN,37,66,20,47,67
23,8478414,Timo Meier,R,NJD,28,78,29,37,66
23,8473419,Brad Marchand,L,BOS,36,79,27,39,66
23,8471214,Alex Ovechkin,L,WSH,39,74,32,33,65
23,8476456,Jonathan Huberdeau,C,CGY,31,81,18,47,65
23,8482078,Lucas Raymond,L,DET,22,80,30,34,64
23,8475784,Jeff Skinner,C,EDM,32,75,27,37,64
23,8477951,Nick Schmaltz,C,UTA,28,75,23,41,64
23,8471685,Anze Kopitar,C,LAK,37,80,19,45,64
23,8479425,Filip Hronek,D,VAN,27,78,16,48,64
23,8475184,Chris Kreider,L,NYR,33,74,40,23,63
23,8480830,Andrei Svechnikov,R,CAR,24,77,32,31,63
23,8475810,Bryan Rust,R,PIT,32,75,29,34,63
23,8474141,Patrick Kane,R,DET,36,80,27,36,63
23,8477960,Adrian Kempe,R,LAK,28,82,25,38,63
23,8477940,Nikolaj Ehlers,L,WPG,28,72,23,40,63
23,8478047,Michael Bunting,L,PIT,29,73,22,41,63
23,8475166,John Tavares,C,TOR,34,77,30,32,62
23,8481596,Shane Pinto,C,OTT,24,79,26,36,62
23,8477402,Pavel Buchnevich,L,STL,29,68,25,37,62
23,8481533,Trevor Zegras,C,ANA,23,73,22,40,62
23,8480865,Noah Dobson,D,NYI,24,78,12,50,62
23,8475167,Victor Hedman,D,TBL,34,75,12,50,62
23,8475794,Tyler Seguin,C,DAL,32,81,27,34,61
23,8479337,Alex DeBrincat,R,DET,27,82,26,35,61
23,8477451,Ryan Hartman,R,MIN,30,69,25,36,61
23,8477494,Jonathan Drouin,L,COL,29,80,15,46,61
23,8482684,Luke Hughes,D,NJD,21,71,15,46,61
23,8479325,Charlie McAvoy,D,BOS,27,75,12,49,61
23,8481540,Cole Caufield,R,MTL,23,67,29,31,60
23,8482093,Seth Jarvis,C,CAR,22,67,29,31,60
23,8482745,Mason McTavish,C,ANA,21,73,27,33,60
23,8479343,Clayton Keller,R,UTA,26,76,23,37,60
23,8478401,Pavel Zacha,C,BOS,27,76,21,39,60
23,8476875,Mike Matheson,D,MTL,30,72,11,49,60
23,8480803,Evan Bouchard,D,EDM,25,76,9,51,60
23,8477500,Bo Horvat,C,NYI,29,81,32,27,59
23,8478873,Troy Terry,R,ANA,27,73,26,33,59
23,8475745,Charlie Coyle,C,BOS,32,75,22,37,59
23,8477949,Alex Tuch,R,BUF,28,71,20,39,59
23,8480839,Rasmus Dahlin,D,BUF,24,71,19,40,59
23,8484166,Adam Fantilli,C,CBJ,20,70,19,40,59
23,8477986,Brandon Montour,D,SEA,30,75,17,42,59
23,8473986,Alex Killorn,L,ANA,35,72,26,32,58
23,8477955,Jared McCann,L,SEA,28,78,28,28,56
23,8482159,Tyson Foerster,R,PHI,22,75,25,31,56
23,8479999,Casey Mittelstadt,C,COL,26,81,20,36,56
23,8474641,Adam Henrique,C,EDM,34,76,29,26,55
23,8478519,Anthony Cirelli,C,TBL,27,82,20,35,55
23,8471215,Evgeni Malkin,C,PIT,38,75,19,36,55
23,8480797,Joel Farabee,L,PHI,24,77,19,36,55
23,8473994,Jamie Benn,L,DAL,35,82,17,38,55
23,8474590,John Carlson,D,WSH,34,65,10,45,55
23,8481560,Arthur Kaliyev,R,LAK,23,82,28,26,54
23,8477998,Warren Foegele,L,LAK,28,78,22,32,54
23,8474150,Mikael Backlund,C,CGY,35,76,16,38,54
23,8478469,Thomas Chabot,D,OTT,27,78,15,39,54
23,8477407,Anthony Duclair,L,NYI,29,82,24,29,53
23,8474586,Jordan Eberle,R,SEA,34,75,24,29,53
23,8480039,Martin Necas,C,CAR,25,72,21,32,53
23,8478042,Viktor Arvidsson,L,EDM,31,72,21,32,53
23,8480018,Nick Suzuki,C,MTL,25,75,20,33,53
23,8481604,Pavel Dorofeyev,L,VGK,24,72,20,33,53
23,8481711,Matias Maccelli,L,UTA,24,77,16,37,53
23,8482124,Quinton Byfield,R,LAK,22,77,12,41,53
23,8478396,Noah Hanifin,D,VGK,27,60,12,41,53
23,8478440,Dylan Strome,C,WSH,27,71,23,29,52
23,8474102,David Perron,L,OTT,36,79,20,32,52
23,8477447,Shea Theodore,D,VGK,29,67,10,42,52
23,8478498,Jake DeBrusk,L,VAN,28,71,28,23,51
23,8475314,Anders Lee,L,NYI,34,78,28,23,51
23,8475151,Kyle Palmieri,C,NYI,33,78,25,26,51
23,8482149,Cole Perfetti,C,WPG,22,72,25,26,51
23,8475170,Brayden Schenn,C,STL,33,70,24,27,51
23,8482699,Dylan Guenther,R,UTA,21,71,18,33,51
23,8475765,Vladimir Tarasenko,R,DET,33,81,16,35,51
23,8476882,Teuvo Teravainen,C,CHI,30,67,15,36,51
23,8476792,Torey Krug,D,STL,33,75,15,36,51
23,8480014,Gabriel Vilardi,C,WPG,25,68,33,17,50
23,8471698,T.J. Oshie,R,WSH,38,63,26,24,50
23,8474149,Evgenii Dadonov,R,DAL,35,79,23,27,50
23,8476880,Tom Wilson,R,WSH,30,71,20,30,50
23,8476399,Blake Coleman,C,CGY,33,72,19,31,50
23,8481528,Dylan Cozens,C,BUF,23,76,17,33,50
23,8478438,Tommy Novak,C,NSH,27,69,16,34,50
23,8480434,Sean Durzi,D,UTA,26,72,9,41,50
23,8482110,Dawson Mercer,C,NJD,23,71,26,23,49
23,8474679,Gustav Nyquist,C,NSH,35,72,18,31,49
23,8477416,Oliver Bjorkstrand,R,SEA,29,74,16,33,49
23,8477964,Ivan Barbashev,C,VGK,29,75,14,35,49
23,8475768,Jaden Schwartz,C,SEA,32,73,27,21,48
23,8478542,Evan Rodrigues,C,FLA,31,74,22,26,48
23,8478427,Sebastian Aho,C,CAR,27,72,21,27,48
23,8479987,Morgan Geekie,C,BOS,26,78,21,27,48
23,8476479,Phillip Danault,C,LAK,31,80,18,30,48
23,8477479,Tyler Bertuzzi,L,CHI,29,63,17,31,48
23,8477932,Aaron Ekblad,D,FLA,28,72,16,32,48
23,8475798,Mikael Granlund,C,SJS,32,72,15,33,48
23,8477429,Andrew Copp,C,DET,30,79,13,35,48
23,8482109,Alexis Lafrenière,L,NYR,23,77,23,24,47
23,8482113,Anton Lundell,C,FLA,23,73,21,26,47
23,8477456,J.T. Compher,L,DET,29,79,20,27,47
23,8478856,Conor Garland,R,VAN,28,66,18,29,47
23,8482702,Logan Stankoven,C,DAL,21,78,18,29,47
23,8480145,Neal Pionk,D,WPG,29,72,10,37,47
23,8475726,Tyler Toffoli,C,SJS,32,69,28,18,46
23,8481068,Yegor Sharangovich,C,CGY,26,79,23,23,46
23,8479365,Trent Frederic,C,BOS,26,78,22,24,46
23,8475158,Ryan O'Reilly,C,NSH,33,75,21,25,46
23,8480185,Eetu Luostarinen,C,FLA,26,75,19,27,46
23,8478472,Mathieu Joseph,R,STL,27,75,18,28,46
23,8481581,Thomas Harley,D,DAL,23,76,12,34,46
23,8480028,Morgan Frost,C,PHI,25,74,11,35,46
23,8475764,Cam Fowler,D,ANA,33,72,0,46,46
23,8477476,Artturi Lehkonen,L,COL,29,80,28,17,45
23,8477426,Nicholas Paul,L,TBL,29,79,26,19,45
23,8476483,Rickard Rakell,R,PIT,31,68,16,29,45
23,8478038,Devon Toews,D,COL,30,68,8,37,45
23,8476958,Jaccob Slavin,D,CAR,30,75,8,37,45
23,8481186,Logan O'Connor,R,COL,28,74,23,21,44
23,8478474,Lawson Crouse,L,UTA,27,72,22,22,44
23,8476826,Yanni Gourde,C,SEA,33,78,21,23,44
23,8480064,Josh Norris,C,OTT,25,78,19,25,44
23,8474565,Alex Pietrangelo,D,VGK,34,59,17,27,44
23,8482665,Matty Beniers,C,SEA,22,78,13,31,44
23,8479410,Mikhail Sergachev,D,UTA,26,71,10,34,44
23,8474053,Logan Couture,C,SJS,35,70,10,34,44
23,8477935,Sam Bennett,C,FLA,28,74,22,21,43
23,8477497,Sean Monahan,C,CBJ,30,69,21,22,43
23,8481535,Nils Hoglander,L,VAN,24,71,21,22,43
23,8475169,Evander Kane,L,EDM,33,73,19,24,43
23,8475760,Nick Bjugstad,C,UTA,32,74,18,25,43
23,8474563,Drew Doughty,D,LAK,35,73,15,28,43
23,8483515,Juraj Slafkovsky,L,MTL,20,80,14,29,43
23,8478233,Andrew Mangiapane,L,WSH,28,65,13,30,43
23,8476906,Shayne Gostisbehere,D,CAR,31,78,8,35,43
23,8475793,Ryan Johansen,C,PHI,32,72,16,26,42
23,8483431,Logan Cooley,C,UTA,20,74,15,27,42
23,8479345,Jakob Chychrun,D,WSH,26,67,13,29,42
23,8482092,Ridly Greig,C,OTT,22,76,13,29,42
23,8470613,Brent Burns,D,CAR,39,78,11,31,42
23,8477948,Travis Sanheim,D,PHI,28,68,11,31,42
23,8478407,Vince Dunn,D,SEA,28,74,6,36,42
23,8480849,Barrett Hayton,C,UTA,24,72,28,13,41
23,8476438,Brandon Saad,L,STL,32,69,25,16,41
23,8480009,Eeli Tolvanen,R,SEA,25,73,23,18,41
23,8478462,Nicolas Roy,C,VGK,27,72,17,24,41
23,8482720,Matthew Knies,L,TOR,22,71,16,25,41
23,8481524,Bowen Byram,D,BUF,23,71,15,26,41
23,8476462,Dougie Hamilton,D,NJD,31,69,14,27,41
23,8476905,Chandler Stephenson,C,SEA,30,67,13,28,41
23,8477498,Darnell Nurse,D,EDM,29,76,12,29,41
23,8471724,Kris Letang,D,PIT,37,80,10,31,41
23,8476432,Boone Jenner,C,CBJ,31,67,23,17,40
23,8479525,Ross Colton,C,COL,28,82,22,18,40
23,8475191,Reilly Smith,R,NYR,33,77,19,21,40
23,8477511,Anthony Mantha,R,CGY,30,74,18,22,40
23,8484153,Leo Carlsson,C,ANA,20,73,16,24,40
23,8477021,Alex Kerfoot,C,UTA,30,76,14,26,40
23,8479351,Sam Steel,C,DAL,26,80,10,30,40
23,8477495,Seth Jones,D,CHI,30,72,9,31,40
23,8473422,Nick Foligno,L,CHI,37,62,23,16,39
23,8482146,Luke Evangelista,R,NSH,22,69,20,19,39
23,8479400,Pierre-Luc Dubois,L,WSH,26,70,19,20,39
23,8480113,Alex Iafallo,L,WPG,31,65,16,23,39
23,8475763,Kevin Hayes,R,PIT,32,67,15,24,39
23,8480829,Jesperi Kotkaniemi,C,CAR,24,65,15,24,39
23,8483808,Andrei Kuzmenko,L,CGY,28,75,13,26,39
23,8474716,Jared Spurgeon,D,MIN,35,78,13,26,39
23,8477346,MacKenzie Weegar,D,CGY,30,74,11,28,39
23,8478458,John (Jack) Roslovic,C,CAR,27,66,18,20,38
23,8482667,William Eklund,L,SJS,22,70,12,26,38
23,8476869,Brady Skjei,D,NSH,30,73,11,27,38
23,8475722,Jason Zucker,L,BUF,32,64,19,18,37
23,8484145,Zach Benson,L,BUF,19,65,16,21,37
23,8477505,Alexander Wennberg,C,SJS,30,66,11,26,37
23,8481577,Philip Tomasino,C,NSH,23,67,10,27,37
23,8478055,Gustav Forsling,D,FLA,28,74,10,27,37
23,8474715,Cameron Atkinson,R,TBL,35,81,18,18,36
23,8476292,Ondrej Palat,L,NJD,33,65,17,19,36
23,8476474,Stefan Noesen,R,NJD,31,73,17,19,36
23,8476885,Jacob Trouba,D,NYR,30,69,13,23,36
23,8480798,Philipp Kurashev,C,CHI,25,67,12,24,36
23,8476461,Sean Couturier,C,PHI,32,64,11,25,36
23,8482097,Jack Quinn,R,BUF,23,64,9,27,36
23,8479591,Michael Eyssimont,C,TBL,28,81,18,17,35
23,8479661,Tanner Jeannot,L,LAK,27,77,17,18,35
23,8482475,Yegor Chinakhov,R,CBJ,23,68,16,19,35
23,8477406,Mattias Janmark,C,EDM,32,69,16,19,35
23,8481618,Alex Newhook,C,MTL,23,73,15,20,35
23,8484203,Bradly Nadeau,L,CAR,19,67,11,24,35
23,8482067,Connor Mackey,D,NYR,28,65,10,25,35
23,8481542,Moritz Seider,D,DET,23,76,7,28,35
23,8476923,Damon Severson,D,CBJ,30,81,5,30,35
23,8479339,Patrik Laine,L,CBJ,26,62,14,20,34
23,8482705,Cole Sillinger,C,CBJ,21,67,12,22,34
23,8483490,Pavel Mintyukov,D,ANA,21,76,6,28,34
23,8481546,Cam York,D,PHI,23,66,6,28,34
23,8476392,Adam Lowry,C,WPG,31,67,18,15,33
23,8478020,Michael Amadio,R,OTT,28,69,18,15,33
23,8481624,Ilya Mikheyev,R,CHI,30,62,16,17,33
23,8480802,Ryan McLeod,C,BUF,25,64,16,17,33
23,8476458,Ryan Strome,C,ANA,31,66,12,21,33
23,8482671,Owen Power,D,BUF,22,70,7,26,33
23,8475753,Justin Faulk,D,STL,32,68,7,26,33
23,8476917,Adam Pelech,D,NYI,30,77,7,26,33
23,8476918,Jimmy Vesey,L,NYR,31,66,17,15,32
23,8475287,Erik Haula,L,NJD,33,75,16,16,32
23,8481582,Nicholas Robertson,L,TOR,23,74,16,16,32
23,8475791,Taylor Hall,L,CHI,33,60,15,17,32
23,8480068,Ryan Poehling,C,PHI,25,71,12,20,32
23,8480459,Pius Suter,C,VAN,28,66,11,21,32
23,8481554,Kaapo Kakko,R,NYR,23,74,11,21,32
23,8475149,Marcus Johansson,L,MIN,34,70,11,21,32
23,8480220,Noah Cates,L,PHI,25,66,10,22,32
23,8477953,Kasperi Kapanen,R,STL,28,72,10,22,32
23,8475218,Mattias Ekholm,D,EDM,34,68,8,24,32
23,8478046,Danton Heinen,L,VAN,29,71,7,25,32
23,8482712,Oskar Olausson,R,COL,22,80,5,27,32
23,8477488,Brett Pesce,D,NJD,30,72,4,28,32
23,8475799,Nino Niederreiter,R,WPG,32,67,16,15,31
23,8480188,Fabian Zetterlund,L,SJS,25,67,15,16,31
23,8482660,Kent Johnson,C,CBJ,22,62,13,18,31
23,8477444,Andre Burakovsky,L,SEA,29,71,12,19,31
23,8481523,Kirby Dach,C,MTL,23,60,11,20,31
23,8476854,Hampus Lindholm,D,BOS,30,74,7,24,31
23,8476979,Erik Gustafsson,D,DET,32,72,7,24,31
23,8482122,Brock Faber,D,MIN,22,79,6,25,31
23,8480817,K'Andre Miller,D,NYR,24,69,5,26,31
23,8480078,Filip Chytil,C,NYR,25,62,17,13,30
23,8482055,Drew O'Connor,L,PIT,26,66,16,14,30
23,8477952,Robby Fabbri,C,ANA,28,68,15,15,30
23,8477987,Ryan Donato,C,CHI,28,62,12,18,30
23,8483499,Liam Ohgren,L,MIN,20,60,12,18,30
23,8478115,Pierre Engvall,L,NYI,28,74,11,19,30
23,8481703,Valtteri Puustinen,R,PIT,25,55,10,20,30
23,8479992,Michael Rasmussen,C,DET,25,79,10,20,30
23,8479393,Noah Gregor,L,OTT,26,73,10,20,30
23,8476419,Jean-Gabriel Pageau,C,NYI,32,80,9,21,30
23,8482105,Jake Sanderson,D,OTT,22,74,8,22,30
23,8482133,Thomas Bordeleau,C,SJS,22,66,7,23,30
23,8480873,Rasmus Sandin,D,WSH,24,64,7,23,30
23,8475181,Nick Leddy,D,STL,33,68,3,27,30
23,8475200,Dmitry Orlov,D,CAR,33,71,2,28,30
23,8480144,David Kampf,C,TOR,29,74,19,10,29
23,8482079,Marco Rossi,C,MIN,23,54,17,12,29
23,8476925,Colton Sissons,C,NSH,31,65,16,13,29
23,8474189,Lars Eller,C,PIT,35,63,14,15,29
23,8477989,Christian Dvorak,C,MTL,28,62,13,16,29
23,8476278,Colin Blackwell,C,DAL,31,76,12,17,29
23,8481580,Connor McMichael,C,WSH,23,62,11,18,29
23,8476921,Jordan Martinook,L,CAR,32,61,11,18,29
23,8476463,Jonas Brodin,D,MIN,31,75,11,18,29
23,8475193,Tomas Tatar,L,NJD,34,68,10,19,29
23,8478891,Mason Appleton,C,WPG,28,64,10,19,29
23,8481441,Joe Snively,C,DET,28,62,10,19,29
23,8476891,Matthew Grzelcyk,D,PIT,30,77,6,23,29
23,8473507,Jeff Petry,D,DET,37,75,5,24,29
23,8474151,Ryan McDonagh,D,TBL,35,78,5,24,29
23,8482655,Janis Moser,D,TBL,24,76,4,25,29
23,8476872,Scott Laughton,C,PHI,30,66,11,17,28
23,8483445,Cutter Gauthier,L,ANA,20,70,9,19,28
23,8478500,Ivan Provorov,D,CBJ,27,80,6,22,28
23,8480878,Nils Lundkvist,D,DAL,24,70,6,22,28
23,8476892,Colton Parayko,D,STL,31,71,3,25,28
23,8478397,Rasmus Andersson,D,CGY,28,70,1,27,28
23,8479941,Justin Danforth,R,CBJ,31,57,16,11,27
23,8482259,Bobby McMann,C,TOR,28,59,16,11,27
23,8475848,Brendan Gallagher,R,MTL,32,72,14,13,27
23,8482089,Jake Neighbours,L,STL,22,66,13,14,27
23,8478109,Victor Olofsson,L,VGK,29,72,13,14,27
23,8470621,Corey Perry,R,EDM,39,66,12,15,27
23,8482142,Jamie Drysdale,D,PHI,22,58,12,15,27
23,8478466,Daniel Sprong,R,VAN,27,67,11,16,27
23,8476480,Vladislav Namestnikov,C,WPG,32,59,11,16,27
23,8478463,Anthony Beauvillier,L,PIT,27,67,11,16,27
23,8481656,Aliaksei Protas,C,WSH,23,64,10,17,27
23,8477919,Frederick Gaudreau,C,MIN,31,63,10,17,27
23,8475714,Calle Jarnkrok,C,TOR,33,73,9,18,27
23,8483524,Shane Wright,C,SEA,20,63,9,18,27
23,8476312,Josh Manson,D,COL,33,63,8,19,27
23,8482175,JJ Peterka,R,BUF,22,72,14,12,26
23,8480806,Isac Lundestrom,C,ANA,25,62,12,14,26
23,8482062,Cole Smith,L,NSH,29,53,12,14,26
23,8473533,Jordan Staal,C,CAR,36,63,10,16,26
23,8477969,Marcus Pettersson,D,PIT,28,73,8,18,26
23,8475231,Casey Cizikas,C,NYI,33,71,8,18,26
23,8479390,Taylor Raddysh,R,WSH,26,63,8,18,26
23,8482073,Braden Schneider,D,NYR,23,64,8,18,26
23,8481606,Jordan Spence,D,LAK,23,67,7,19,26
23,8480003,Jesper Boqvist,C,FLA,26,67,7,19,26
23,8477506,Ryan Pulock,D,NYI,30,74,5,21,26
23,8478882,Vladislav Gavrikov,D,LAK,29,62,5,21,26
23,8480043,Timothy Liljegren,D,TOR,25,71,3,23,26
23,8482125,Alexander Holtz,R,VGK,22,71,17,8,25
23,8478434,Keegan Kolesar,R,VGK,27,62,15,10,25
23,8480893,Kirill Marchenko,R,CBJ,24,63,14,11,25
23,8480205,Emil Bemstrom,C,PIT,25,63,13,12,25
23,8481481,Blake Lizotte,C,PIT,27,61,11,14,25
23,8476981,Josh Anderson,R,MTL,30,74,11,14,25
23,8483493,Frank Nazar,C,CHI,20,42,10,15,25
23,8480336,Sean Walker,D,CAR,30,77,9,16,25
23,8475220,Marcus Foligno,L,MIN,33,59,8,17,25
23,8483505,Matthew Poitras,C,BOS,20,72,6,19,25
23,8477947,Sonny Milano,L,WSH,28,64,14,10,24
23,8479353,Brett Howden,C,VGK,26,68,12,12,24
23,8479293,Brandon Tanev,L,SEA,33,58,9,15,24
23,8473563,Nicklas Backstrom,C,WSH,37,55,7,17,24
23,8481014,Alexander Romanov,D,NYI,24,76,1,23,24
23,8480789,Oliver Wahlstrom,R,NYI,24,67,14,9,23
23,8476878,Zemgus Girgensons,C,TBL,30,78,14,9,23
23,8480835,Jack Drury,C,CAR,24,59,13,10,23
23,8477425,Miles Wood,L,COL,29,74,13,10,23
23,8476960,Andreas Athanasiou,C,CHI,30,47,12,11,23
23,8482111,Justin Barron,D,MTL,23,70,12,11,23
23,8480762,Eric Robinson,L,CAR,29,57,11,12,23
23,8475343,Nic Dowd,C,WSH,34,62,9,14,23
23,8477499,Rasmus Ristolainen,D,PHI,30,64,9,14,23
23,8478421,A.J. Greer,L,FLA,28,58,8,15,23
23,8478416,Erik Cernak,D,TBL,27,77,7,16,23
23,8480871,Adam Boqvist,D,FLA,24,65,3,20,23
23,8476931,Jake McCabe,D,TOR,31,69,1,22,23
23,8480448,Parker Kelly,L,COL,25,75,12,10,22
23,8477478,William Carrier,L,CAR,30,58,11,11,22
23,8480855,Jack McBain,C,UTA,24,69,11,11,22
23,8482157,Will Cuylle,L,NYR,22,57,11,11,22
23,8480252,Cole Guttman,C,CHI,25,39,10,12,22
23,8478043,Sam Lafferty,C,BUF,29,63,9,13,22
23,8477446,Michael McCarron,R,NSH,29,64,9,13,22
23,8476897,Oskar Sundqvist,C,STL,30,64,8,14,22
23,8481521,Ronnie Attard,D,PHI,25,59,6,16,22
23,8478452,Caleb Jones,D,LAK,27,55,6,16,22
23,8479996,Cody Glass,C,NSH,25,53,5,17,22
23,8482245,Artem Zub,D,OTT,29,72,5,17,22
23,8475790,Erik Gudbranson,D,CBJ,32,77,4,18,22
23,8479402,Jake Bean,D,CGY,26,65,4,18,22
23,8474673,TJ Brodie,D,CHI,34,65,3,19,22
23,8478507,John Marino,D,UTA,27,72,3,19,22
23,8479982,Conor Timmins,D,TOR,26,59,2,20,22
23,8475225,Craig Smith,C,CHI,35,56,14,7,21
23,8479316,Luke Kunin,C,SJS,27,57,12,9,21
23,8478432,Christian Fischer,R,DET,27,73,11,10,21
23,8476469,Joel Armia,R,MTL,31,65,11,10,21
23,8479368,Max Jones,L,BOS,26,70,11,10,21
23,8480289,Morgan Barron,C,WPG,26,56,10,11,21
23,8482749,Joshua Roy,R,MTL,21,58,8,13,21
23,8476927,Teddy Blueger,C,VAN,30,66,6,15,21
23,8477839,Conor Sheary,L,TBL,32,82,6,15,21
23,8477450,Jason Dickinson,C,CHI,29,58,6,15,21
23,8476467,Jamie Oleksiak,D,SEA,32,74,5,16,21
23,8477220,Nate Schmidt,D,FLA,33,68,4,17,21
23,8479398,Samuel Girard,D,COL,26,65,3,18,21
23,8480049,Dylan Samberg,D,WPG,25,67,2,19,21
23,8479324,Ryan Lindgren,D,NYR,26,63,1,20,21
23,8473453,Trevor Lewis,C,LAK,37,71,13,7,20
23,8476889,Radek Faksa,C,STL,30,60,13,7,20
23,8482074,Connor Zary,C,CGY,23,59,11,9,20
23,8481601,Simon Holmstrom,R,NYI,23,65,10,10,20
23,8477903,Garnet Hathaway,R,PHI,33,69,10,10,20
23,8478211,Dryden Hunt,L,CGY,29,52,10,10,20
23,8482737,Zack Bolduc,C,STL,21,52,9,11,20
23,8477979,Nicolas Aube-Kubel,R,BUF,28,55,8,12,20
23,8477508,Curtis Lazar,C,NJD,29,63,8,12,20
23,8481013,Jonatan Berggren,R,DET,24,63,8,12,20
23,8474034,Patrick Maroon,L,CHI,36,51,8,12,20
23,8482117,Lukas Reichel,L,CHI,22,59,7,13,20
23,8476422,Mike Reilly,D,NYI,31,75,6,14,20
23,8476856,Mathew Dumba,D,DAL,30,73,6,14,20
23,8475462,Radko Gudas,D,ANA,34,69,4,16,20
23,8479980,Nicolas Hague,D,VGK,26,58,4,16,20
23,8482451,Mikael Pyyhtia,L,CBJ,23,41,4,16,20
23,8475179,Dmitry Kulikov,D,FLA,34,63,4,16,20
23,8479976,Juuso Valimaki,D,UTA,26,65,3,17,20
23,8479998,Mikey Anderson,D,LAK,25,59,3,17,20
23,8480001,Urho Vaakanainen,D,ANA,25,62,2,18,20
23,8479371,Dante Fabbro,D,NSH,26,65,1,19,20
23,8476331,Dylan DeMelo,D,WPG,31,67,1,19,20
23,8479369,Andrew Peeke,D,BOS,26,66,1,19,20
23,8481592,Jakob Pelletier,L,CGY,23,44,14,5,19
23,8482148,Hendrix Lapierre,C,WSH,22,48,11,8,19
23,8478585,Derek Ryan,C,EDM,38,67,11,8,19
23,8480281,Alexey Toropchenko,R,STL,25,58,10,9,19
23,8479359,Beck Malenstyn,L,BUF,26,46,10,9,19
23,8481553,Bobby Brink,R,PHI,23,60,9,10,19
23,8479315,Joey Anderson,R,CHI,26,52,8,11,19
23,8479370,Tyson Jost,C,CAR,26,52,6,13,19
23,8481641,Joel Kiviranta,L,COL,28,76,6,13,19
23,8475171,Oliver Ekman-Larsson,D,TOR,33,66,5,14,19
23,8479639,Dylan Coghlan,D,WPG,26,65,5,14,19
23,8480860,Kevin Bahl,D,CGY,24,63,5,14,19
23,8479520,Brandon Duhaime,R,WSH,27,56,4,15,19
23,8478911,Matt Roy,D,WSH,29,64,3,16,19
23,8475188,Brayden McNabb,D,VGK,33,55,3,16,19
23,8482679,Matt Coronato,R,CGY,22,64,11,7,18
23,8480813,Joe Veleno,C,DET,24,75,10,8,18
23,8478057,Dakota Joshua,C,VAN,28,69,9,9,18
23,8481704,Juuso Parssinen,C,NSH,23,55,9,9,18
23,8480073,Erik Brannstrom,D,COL,25,63,7,11,18
23,8481477,Nico Sturm,C,SJS,29,51,6,12,18
23,8479983,Mario Ferraro,D,SJS,26,69,5,13,18
23,8480222,Sebastian Aho,D,PIT,28,73,5,13,18
23,8482176,Wyatt Kaiser,D,CHI,22,50,5,13,18
23,8478851,Alexandre Carrier,D,NSH,28,72,2,16,18
23,8475233,David Savard,D,MTL,34,65,2,16,18
23,8481568,Alex Vlasic,D,CHI,23,58,2,16,18
23,8477507,Nikita Zadorov,D,BOS,29,74,2,16,18
23,8478840,Will Borgen,D,SEA,28,57,1,17,18
23,8479619,Michael Carcone,L,UTA,28,62,11,6,17
23,8477015,Connor Brown,R,EDM,30,66,11,6,17
23,8478013,Jake Walman,D,SJS,28,69,10,7,17
23,8477392,Hudson Fasching,R,NYI,29,68,9,8,17
23,8484149,Gavin Brindley,C,CBJ,20,53,9,8,17
23,8479328,Julien Gauthier,R,NYI,27,57,8,9,17
23,8477369,Carson Soucy,D,VAN,30,62,6,11,17
23,8480035,Henri Jokiharju,D,BUF,25,58,5,12,17
23,8482192,Isaak Phillips,D,CHI,23,54,5,12,17
23,8478178,Darren Raddysh,D,TBL,28,71,5,12,17
23,8479439,Jacob MacDonald,D,COL,31,56,5,12,17
23,8478136,Jake Middleton,D,MIN,28,77,3,14,17
23,8478399,Jonas Siegenthaler,D,NJD,27,63,3,14,17
23,8481527,Kaedan Korczak,D,VGK,23,43,3,14,17
23,8479378,Logan Stanley,D,WPG,26,45,3,14,17
23,8483482,Tristan Luneau,D,ANA,20,62,2,15,17
23,8470600,Ryan Suter,D,STL,39,60,2,15,17
23,8476902,Esa Lindell,D,DAL,30,76,1,16,17
23,8476822,Luke Glendening,C,TBL,35,80,12,4,16
23,8479414,Nathan Bastian,R,NJD,27,54,10,6,16
23,8476873,Mark Jankowski,C,NSH,30,49,8,8,16
23,8471817,Ryan Reaves,R,TOR,37,62,8,8,16
23,8479718,Alex Barré-Boulet,C,MTL,27,49,7,9,16
23,8480355,Mark Kastelic,C,BOS,25,67,7,9,16
23,8477931,Tomas Nosek,L,FLA,32,62,7,9,16
23,8481537,Nikita Okhotiuk,D,CGY,24,51,7,9,16
23,8482087,Kaiden Guhle,D,MTL,22,68,6,10,16
23,8481028,Martin Pospisil,C,CGY,25,51,5,11,16
23,8476329,Travis Boyd,C,MIN,31,51,3,13,16
23,8483565,Nick Blankenburg,D,NSH,26,60,3,13,16
23,8480246,Nick Perbix,D,TBL,26,73,3,13,16
23,8475279,Ben Chiarot,D,DET,33,69,3,13,16
23,8476429,Scott Mayfield,D,NYI,32,77,3,13,16
23,8476457,Adam Larsson,D,SEA,32,64,1,15,16
23,8480021,Jack Studnicka,C,LAK,25,55,9,6,15
23,8478508,Yakov Trenin,C,MIN,27,63,7,8,15
23,8482166,Shakir Mukhamadullin,D,SJS,22,53,7,8,15
23,8480074,Alexandre Texier,C,STL,25,53,6,9,15
23,8478970,Jalen Chatfield,D,CAR,28,71,5,10,15
23,8480011,Klim Kostin,C,SJS,25,47,5,10,15
23,8483468,Jiri Kulich,C,BUF,20,56,4,11,15
23,8482634,Alex Steeves,C,TOR,25,45,4,11,15
23,8476879,Cody Ceci,D,EDM,31,69,3,12,15
23,8475690,Chris Tanev,D,TOR,35,64,3,12,15
23,8480727,Zach Whitecloud,D,VGK,28,46,3,12,15
23,8482809,Jackson Blake,R,CAR,21,59,2,13,15
23,8481059,Scott Perunovich,D,STL,26,57,2,13,15
23,8474567,Zach Bogosian,D,MIN,34,61,1,14,15
23,8480995,Pontus Holmberg,R,TOR,25,63,9,5,14
23,8477070,Liam O'Brien,C,UTA,30,50,9,5,14
23,8480980,Connor Dewar,C,TOR,25,56,7,7,14
23,8476988,Matt Benning,D,SJS,30,66,7,7,14
23,8476994,Vinnie Hinostroza,C,NSH,30,45,5,9,14
23,8481093,Rafael Harvey-Pinard,L,MTL,25,61,4,10,14
23,8478413,Jordan Greenway,L,BUF,27,63,4,10,14
23,8477435,Ryan Graves,D,PIT,29,74,4,10,14
23,8479972,Mason Shaw,C,WPG,26,42,4,10,14
23,8480796,Martin Fehervary,D,WSH,25,56,4,10,14
23,8478451,Ethan Bear,D,WSH,27,50,4,10,14
23,8481019,David Gustafsson,C,WPG,24,48,2,12,14
23,8481178,Egor Zamula,D,PHI,24,61,1,13,14
23,8478133,Jake Evans,C,MTL,28,71,0,14,14
23,8477353,Tyler Motte,C,DET,29,71,8,5,13
23,8479336,Carl Grundstrom,R,SJS,27,56,8,5,13
23,8481517,Brett Leason,R,ANA,25,47,8,5,13
23,8479026,Philippe Myers,D,TOR,27,45,7,6,13
23,8482762,Simon Edvinsson,D,DET,21,53,7,6,13
23,8480441,Trey Fix-Wolansky,R,CBJ,25,40,6,7,13
23,8481532,Alex Turcotte,C,LAK,23,47,6,7,13
23,8474574,Tyler Myers,D,VAN,34,71,5,8,13
23,8482101,Danil Gushchin,L,SJS,22,58,4,9,13
23,8480070,Ian Mitchell,D,BOS,25,44,4,9,13
23,8482807,Ethan Del Mastro,D,CHI,21,44,4,9,13
23,8479772,Zack MacEwen,R,OTT,28,53,4,9,13
23,8482624,Daniil Miromanov,D,CGY,27,56,3,10,13
23,8480748,Kiefer Sherwood,L,VAN,29,60,3,10,13
23,8482730,Brandt Clarke,D,LAK,21,50,3,10,13
23,8482095,Tyler Kleven,D,OTT,22,40,3,10,13
23,8476441,Joel Edmundson,D,LAK,31,47,3,10,13
23,8475324,Nick Jensen,D,OTT,34,58,2,11,13
23,8481708,Zac Jones,D,NYR,24,53,2,11,13
23,8481701,Santeri Hatakka,D,NJD,23,45,2,11,13
23,8476967,Brett Kulak,D,EDM,30,64,1,12,13
23,8476525,Colin Miller,D,WPG,32,57,0,13,13
23,8477365,Connor Clifton,D,BUF,29,60,0,13,13
23,8474090,Brendan Smith,D,DAL,35,50,0,13,13
23,8475842,Sam Carrick,C,NYR,32,60,9,3,12
23,8481716,Dmitri Voronkov,L,CBJ,24,52,7,5,12
23,8479344,Jesse Puljujarvi,R,PIT,26,51,7,5,12
23,8476624,Barclay Goodrow,C,SJS,31,51,7,5,12
23,8479066,Ryan Lomberg,L,CGY,30,66,6,6,12
23,8478424,Jansen Harkins,C,ANA,27,48,6,6,12
23,8479543,Michael Pezzetta,L,MTL,26,54,5,7,12
23,8475855,Jesper Fast,R,CAR,33,55,5,7,12
23,8481161,Jake Christiansen,D,CBJ,25,65,5,7,12
23,8477018,Ben Hutton,D,VGK,31,50,5,7,12
23,8478443,Brandon Carlo,D,BOS,28,59,4,8,12
23,8481032,Paul Cotter,C,NJD,25,60,4,8,12
23,8481617,Vasily Podkolzin,R,VAN,23,52,3,9,12
23,8481751,Lukas Rousek,R,BUF,25,31,3,9,12
23,8480950,Ilya Lyubushkin,D,DAL,30,62,2,10,12
23,8480891,Michael Kesselring,D,UTA,24,56,2,10,12
23,8483460,David Jiricek,D,CBJ,21,50,2,10,12
23,8481567,Henry Thrun,D,SJS,23,44,2,10,12
23,8480157,Calle Rosen,D,COL,30,43,1,11,12
23,8479442,Troy Stecher,D,EDM,30,47,1,11,12
23,8480196,Jacob Bryson,D,BUF,27,45,1,11,12
23,8474612,Travis Hamonic,D,OTT,34,47,1,11,12
23,8482496,Nils Aman,C,VAN,24,39,8,3,11
23,8481522,Peyton Krebs,C,BUF,23,56,6,5,11
23,8478569,Noel Acciari,C,PIT,33,48,6,5,11
23,8480848,Ty Dellandrea,C,SJS,24,38,6,5,11
23,8483457,Lane Hutson,D,MTL,20,64,5,6,11
23,8477573,Nathan Walker,L,STL,30,47,5,6,11
23,8479944,Zach Aston-Reese,C,VGK,30,47,5,6,11
23,8480058,Pierre-Olivier Joseph,D,STL,25,55,4,7,11
23,8476374,Sean Kuraly,C,CBJ,31,51,3,8,11
23,8477845,Trevor van Riemsdyk,D,WSH,33,55,3,8,11
23,8475208,Brian Dumoulin,D,ANA,33,56,3,8,11
23,8481167,Brayden Pachal,D,CGY,25,41,3,8,11
23,8477938,Haydn Fleury,D,WPG,28,47,3,8,11
23,8479372,Joshua Mahura,D,SEA,26,52,2,9,11
23,8474166,Alec Martinez,D,CHI,37,52,2,9,11
23,8480172,Jan Rutta,D,SJS,34,68,0,11,11
23,8480887,Jordan Harris,D,MTL,24,53,0,11,11
23,8481679,Maxence Guenette,D,OTT,23,35,7,3,10
23,8477380,Jonny Brodzinski,C,NYR,31,48,6,4,10
23,8478409,Anthony Richard,C,PHI,28,33,6,4,10
23,8480025,MacKenzie Entwistle,R,FLA,25,59,4,6,10
23,8483491,Ivan Miroshnichenko,L,WSH,20,62,4,6,10
23,8477335,Kyle Burroughs,D,LAK,29,50,4,6,10
23,8481600,Tobias Bjornfot,D,FLA,23,41,4,6,10
23,8483466,Kevin Korchinski,D,CHI,20,48,4,6,10
23,8480245,Olle Lycksell,R,PHI,25,36,4,6,10
23,8482964,Arber Xhekaj,D,MTL,23,47,3,7,10
23,8481599,Victor Soderstrom,D,UTA,23,43,2,8,10
23,8480879,Jacob Bernard-Docker,D,OTT,24,47,2,8,10
23,8476874,Olli Maatta,D,DET,30,57,2,8,10
23,8480807,Mattias Samuelsson,D,BUF,24,42,1,9,10
23,8475455,Brenden Dillon,D,NJD,34,56,1,9,10
23,8475718,Justin Holl,D,DET,32,63,1,9,10
23,8477034,Jaycob Megna,D,FLA,32,44,1,9,10
23,8482070,Mitchell Chaffee,R,TBL,26,46,7,2,9
23,8479367,William Lockwood,R,FLA,26,31,7,2,9
23,8476858,Phillip Di Giuseppe,L,VAN,31,43,6,3,9
23,8479671,Mathieu Olivier,R,CBJ,27,42,6,3,9
23,8479994,Jaret Anderson-Dolan,C,WPG,25,35,6,3,9
23,8482155,Alex Laferriere,R,LAK,23,70,5,4,9
23,8483495,Simon Nemec,D,NJD,20,48,5,4,9
23,8481754,Nikita Nesterenko,C,ANA,23,27,5,4,9
23,8482652,Walker Duehr,R,CGY,27,43,5,4,9
23,8480292,Carson Meyer,R,ANA,27,35,5,4,9
23,8482145,Mavrik Bourque,C,DAL,22,48,4,5,9
23,8483549,Lucas Condotta,L,MTL,27,42,3,6,9
23,8477527,Ross Johnston,L,ANA,30,32,3,6,9
23,8479991,Jake Leschyshyn,C,NYR,25,33,3,6,9
23,8480192,Johnathan Kovacevic,D,NJD,27,50,2,7,9
23,8481550,Adam Beckman,L,NJD,23,42,2,7,9
23,8477384,Joshua Brown,D,EDM,30,48,2,7,9
23,8475750,Jon Merrill,D,MIN,32,60,1,8,9
23,8482861,Vincent Iorio,D,WSH,22,31,1,8,9
23,8471677,Jack Johnson,D,CBJ,37,62,1,8,9
23,8476473,Connor Murphy,D,CHI,31,40,1,8,9
23,8474568,Luke Schenn,D,NSH,35,45,0,9,9
23,8471709,Marc-Edouard Vlasic,D,SJS,37,58,0,9,9
23,8478454,Noah Juulsen,D,VAN,27,35,0,9,9
23,8477482,Zachary Sanford,L,CHI,30,32,5,3,8
23,8479291,Kevin Rooney,C,CGY,31,58,5,3,8
23,8478831,Kevin Stenlund,C,UTA,28,58,5,3,8
23,8477401,John Hayden,C,SEA,29,26,5,3,8
23,8482666,Scott Morrow,D,CAR,22,42,4,4,8
23,8482803,Olen Zellweger,D,ANA,21,56,3,5,8
23,8476442,Matt Nieto,L,PIT,32,49,3,5,8
23,8479638,Justin Brazeau,R,BOS,26,40,3,5,8
23,8482141,Lukas Cormier,D,VGK,22,26,3,5,8
23,8482929,Emil Lilleberg,D,TBL,23,23,3,5,8
23,8482744,James Malatesta,L,CBJ,21,42,2,6,8
23,8476372,Nick Seeler,D,PHI,31,35,2,6,8
23,8478468,Jeremy Lauzon,D,NSH,27,51,1,7,8
23,8481598,Philip Broberg,D,EDM,23,44,1,7,8
23,8481056,Spencer Stastney,D,NSH,24,33,0,8,8
23,8482747,Brennan Othmann,L,NYR,21,40,5,2,7
23,8482147,Jean-Luc Foudy,C,COL,22,24,5,2,7
23,8476934,Brock McGinn,L,ANA,30,44,4,3,7
23,8479968,Vinni Lettieri,C,BOS,29,51,3,4,7
23,8482153,Brendan Brisson,C,VGK,23,38,3,4,7
23,8478017,Mark Friedman,D,VAN,29,41,3,4,7
23,8479981,Jonah Gadjovich,L,FLA,26,46,3,4,7
23,8477473,Justin Bailey,R,SJS,29,28,3,4,7
23,8477320,Anton Blidh,L,NYR,29,18,3,4,7
23,8483619,Filip Roos,D,OTT,25,38,3,4,7
23,8477962,Brendan Lemieux,L,CAR,28,34,3,4,7
23,8482077,Dylan Holloway,L,EDM,23,49,2,5,7
23,8476913,Devin Shore,C,MIN,30,33,2,5,7
23,8484254,Akito Hirose,D,VAN,25,38,2,5,7
23,8478146,Matthew Highmore,C,OTT,28,37,2,5,7
23,8479986,Kole Lind,R,DAL,26,52,2,5,7
23,8477244,Chad Ruhwedel,D,NYR,34,30,2,5,7
23,8476952,Dominic Toninato,C,WPG,30,27,2,5,7
23,8480845,Rasmus Kupari,C,WPG,24,43,1,6,7
23,8479348,Kale Clague,D,BUF,26,39,1,6,7
23,8475177,Calvin de Haan,D,COL,33,49,1,6,7
23,8475795,Dylan McIlrath,D,WSH,32,21,0,7,7
23,8482659,Josh Doan,R,UTA,22,50,5,1,6
23,8475958,Michael Sgarbossa,C,WSH,32,31,4,2,6
23,8481789,Tye Kartye,L,SEA,23,33,3,3,6
23,8476867,Brendan Gaunce,C,MIN,30,35,3,3,6
23,8479536,Axel Jonsson-Fjallby,L,WPG,26,37,3,3,6
23,8482511,Mason Lohrei,D,BOS,23,26,3,3,6
23,8481147,Reese Johnson,C,MIN,26,34,2,4,6
23,8474013,Ian Cole,D,UTA,35,47,2,4,6
23,8480844,Grigori Denisenko,L,VGK,24,38,2,4,6
23,8477462,Robert Hagg,D,VGK,29,28,2,4,6
23,8482859,Zack Ostapchuk,C,OTT,21,45,2,4,6
23,8482165,Yan Kuznetsov,D,CGY,22,23,2,4,6
23,8482733,Logan Mailloux,D,MTL,31,35,2,4,6
23,8475762,Derek Forbort,D,VAN,32,40,1,5,6
23,8483763,Maksymilian Szuber,D,UTA,22,33,1,5,6
23,8482250,Callahan Burke,C,VGK,27,22,1,5,6
23,8473446,Erik Johnson,D,PHI,36,55,0,6,6
23,8481518,Nolan Foote,L,NJD,24,32,4,1,5
23,8481556,John Beecher,C,BOS,23,34,4,1,5
23,8484258,Sam Malinski,D,COL,26,16,4,1,5
23,8480990,Declan Chisholm,D,MIN,24,39,3,2,5
23,8480007,Jonas Rondbjerg,R,VGK,25,36,3,2,5
23,8481609,Vladislav Kolyachonok,D,UTA,23,32,3,2,5
23,8480890,Jan Jenik,C,OTT,24,29,3,2,5
23,8482784,Zach Dean,C,STL,21,47,2,3,5
23,8480267,Sammy Walker,C,MIN,25,18,2,3,5
23,8480834,Ty Emberson,D,SJS,24,35,2,3,5
23,8478874,Adam Gaudette,R,OTT,28,35,1,4,5
23,8483630,Pavol Regenda,L,ANA,25,29,1,4,5
23,8483570,Ben Meyers,C,SEA,26,36,4,0,4
23,8483397,Marc McLaughlin,C,BOS,25,28,3,1,4
23,8479985,Cale Fleury,D,SEA,26,27,2,2,4
23,8483597,Milos Kelemen,L,UTA,25,15,2,2,4
23,8479320,Maxime Lajoie,D,SEA,27,23,2,2,4
23,8478859,Niko Mikkola,D,FLA,28,52,1,3,4
23,8481122,Simon Benoit,D,TOR,26,31,1,3,4
23,8475235,Nicolas Deslauriers,L,PHI,33,50,1,3,4
23,8482172,Landon Slaggert,L,CHI,22,22,1,3,4
23,8477851,Jordan Oesterle,D,BOS,32,42,1,3,4
23,8477467,Gustav Olofsson,D,SEA,30,18,1,3,4
23,8480870,Bo Groulx,C,NYR,24,27,1,3,4
23,8477073,Kurtis MacDermid,L,NJD,30,24,1,3,4
23,8477971,Andreas Englund,D,LAK,28,24,1,3,4
23,8479576,Vincent Desharnais,D,VAN,28,33,1,3,4
23,8479249,Andrew Poturalski,C,SJS,30,30,0,4,4
23,8480880,Jakub Lauko,C,MIN,24,36,0,4,4
23,8477887,Patrick Brown,C,BOS,32,39,0,4,4
23,8482751,Ryan Winterton,C,SEA,21,30,2,1,3
23,8482177,Marat Khusnutdinov,C,MIN,22,35,2,1,3
23,8483012,Logan Morrison,C,SEA,22,36,2,1,3
23,8477810,Joel Hanley,D,CGY,33,25,2,1,3
23,8478021,William Lagesson,D,DET,28,27,2,1,3
23,8484325,Waltteri Merela,C,TBL,26,27,2,1,3
23,8480468,James Hamblin,L,EDM,25,20,2,1,3
23,8482476,Emil Heineman,L,MTL,23,9,2,1,3
23,8474062,Riley Nash,C,NYR,35,13,1,2,3
23,8478450,Parker Wotherspoon,D,BOS,27,32,1,2,3
23,8479362,Riley Tufte,L,BOS,26,16,1,2,3
23,8482118,Sam Colangelo,R,ANA,23,18,1,2,3
23,8480084,Nick DeSimone,D,NJD,30,18,1,2,3
23,8482088,Justin Sourdif,R,FLA,22,24,1,2,3
23,8475413,Justin Dowling,C,NJD,34,15,1,2,3
23,8482144,Jack Thompson,D,SJS,22,30,0,3,3
23,8481030,Jack St. Ivany,D,PIT,25,20,0,3,3
23,8481726,Adam Edstrom,C,NYR,24,11,0,3,3
23,8478881,Brett Seney,L,CHI,28,12,2,0,2
23,8480032,Shane Bowers,C,NJD,25,12,2,0,2
23,8484911,Collin Graf,R,SJS,22,31,2,0,2
23,8482858,Ryker Evans,D,SEA,23,28,1,1,2
23,8482470,Ilya Solovyov,D,CGY,24,24,1,1,2
23,8482102,Vasily Ponomarev,C,PIT,22,22,1,1,2
23,8482765,Isak Rosen,R,BUF,21,37,1,1,2
23,8482201,Gage Goncalves,C,TBL,23,20,1,1,2
23,8481743,Marc Del Gaizo,D,NSH,25,18,1,1,2
23,8481593,Jayden Struble,D,MTL,23,18,1,1,2
23,8477149,Scott Sabourin,R,SJS,32,13,1,1,2
23,8479330,Brandon Gignac,C,MTL,27,12,1,1,2
23,8480306,Grant Hutton,D,NYI,29,12,1,1,2
23,8477993,Justin Kirkland,C,CGY,28,5,1,1,2
23,8482713,Mackie Samoskevich,R,FLA,22,33,0,2,2
23,8481543,Nikita Alexandrov,C,STL,24,28,0,2,2
23,8479379,Givani Smith,R,SJS,26,31,0,2,2
23,8481605,Jackson LaCombe,D,ANA,23,39,0,2,2
23,8481206,John Ludvig,D,PIT,24,12,0,2,2
23,8482061,Brandon Biro,L,SEA,26,13,0,2,2
23,8481237,Kyle MacLean,C,NYI,25,22,0,2,2
23,8481564,Ryan Johnson,D,BUF,23,18,0,2,2
23,8475755,Alexander Petrovic,D,DAL,32,7,1,0,1
23,8481699,Aku Raty,R,UTA,23,13,1,0,1
23,8478051,Max Willman,C,NJD,29,17,1,0,1
23,8481422,Jake Lucchini,C,NSH,29,23,1,0,1
23,8478854,Ryan Shea,D,PIT,27,7,1,0,1
23,8481462,Mason Morelli,L,VGK,28,9,1,0,1
23,8483471,Brad Lambert,C,WPG,31,11,1,0,1
23,8479522,Hardy Haman Aktell,D,WSH,26,4,1,0,1
23,8482516,Matthew Kessel,D,STL,24,19,1,0,1
23,8484326,Patrik Koch,D,UTA,28,1,1,0,1
23,8478011,Louie Belpedio,D,PHI,28,11,1,0,1
23,8478147,Bokondji Imama,L,PIT,28,8,1,0,1
23,8484304,Uvis Balinskis,D,FLA,28,13,1,0,1
23,8483531,Brian Halonen,L,NJD,25,3,1,0,1
23,8481719,Maxwell Crozier,D,TBL,24,17,0,1,1
23,8481585,Egor Afanasyev,L,SJS,23,13,0,1,1
23,8477541,Dakota Mermis,D,TOR,30,9,0,1,1
23,8480075,Cameron Crotty,D,MIN,25,10,0,1,1
23,8480823,Alexander Alexeyev,D,WSH,25,15,0,1,1
23,8482162,Roby Jarventie,L,EDM,22,11,0,1,1
23,8478502,Dennis Gilbert,D,BUF,28,18,0,1,1
23,8482094,Daemon Hunt,D,MIN,22,13,0,1,1
23,8481065,Angus Crookshank,L,OTT,25,13,0,1,1
23,8483398,Declan Carlile,D,TBL,31,2,0,1,1
23,8480851,Akil Thomas,C,LAK,24,19,0,1,1
23,8482197,Adam Raska,R,MIN,23,7,0,1,1
23,8481024,Linus Karlsson,C,VAN,25,6,0,1,1
23,8481534,Raphael Lavoie,C,EDM,24,7,0,1,1
23,8476323,Max McCormick,L,SEA,32,4,0,1,1
23,8481541,Samuel Bolduc,D,NYI,24,23,0,0,0
23,8478446,Glenn Gawdin,C,LAK,27,8,0,0,0
23,8483489,Fraser Minten,C,TOR,31,10,0,0,0
23,8478477,Mitchell Stephens,C,SEA,27,18,0,0,0
23,8484287,Cole McWard,D,VAN,23,19,0,0,0
23,8479419,Brett Murray,L,BUF,26,23,0,0,0
23,8479587,Rhett Gardner,C,PHI,28,18,0,0,0
23,8483395,Arshdeep Bains,L,VAN,23,11,0,0,0
23,8481006,Tyler Tucker,D,STL,24,19,0,0,0
23,8481578,Graeme Clarke,R,MIN,23,12,0,0,0
23,8481655,Cole Schwindt,R,CGY,23,4,0,0,0
23,8483609,Adam Klapka,R,CGY,24,1,0,0,0
23,8483512,Matthew Savoie,C,EDM,20,19,0,0,0
23,8480874,Adam Ginning,D,PHI,24,14,0,0,0
23,8484255,Jason Polin,R,COL,25,7,0,0,0
23,8483567,Georgii Merkulov,C,BOS,24,6,0,0,0
23,8481806,Louis Crevier,D,CHI,23,9,0,0,0
23,8482126,Emil Andrae,D,PHI,31,1,0,0,0
23,8478956,Samuel Laberge,L,NJD,27,1,0,0,0
23,8481043,Cole Koepke,L,BOS,26,17,0,0,0
23,8483407,Brandon Scanlin,D,NYR,25,3,0,0,0
23,8482787,Nikita Chibrikov,R,WPG,31,6,0,0,0
23,8483920,Pierrick Dube,R,WSH,23,3,0,0,0
23,8479421,Jacob Moverare,D,LAK,26,5,0,0,0
23,8483546,Marshall Rifai,D,TOR,26,5,0,0,0
23,8482460,Matt Rempe,C,NYR,22,11,0,0,0
23,8475780,Chris Wagner,R,COL,33,5,0,0,0
23,8483432,Luca Del Bel Belluz,C,CBJ,31,6,0,0,0
23,8483401,Marc Johnstone,R,PIT,28,1,0,0,0
23,8484259,Ondrej Pavel,C,COL,31,3,0,0,0
23,8484321,Nikolas Matinpalo,D,OTT,26,3,0,0,0
23,8470794,Joe Pavelski,C,,40,0,0,0,0
23,8479321,Lucas Johansen,D,,27,0,0,0,0
23,8477950,Tony DeAngelo,D,,29,0,0,0,0
23,8471218,Blake Wheeler,R,,38,0,0,0,0
23,8475197,Tyson Barrie,D,,33,0,0,0,0
23,8474157,Max Pacioretty,L,,36,0,0,0,0
23,8475744,Evgeny Kuznetsov,C,,32,0,0,0,0
23,8474037,James van Riemsdyk,L,,35,0,0,0,0
23,8476907,Mackenzie MacEachern,L,,30,0,0,0,0
23,8480216,Jacob Peterson,C,,25,0,0,0,0
23,8474602,Justin Schultz,D,,34,0,0,0,0
23,8482222,Alexander Barabanov,L,,30,0,0,0,0
23,8474031,Kevin Shattenkirk,D,,35,0,0,0,0
23,8477330,Dominik Kubalik,L,,29,0,0,0,0
23,8480884,Calen Addison,D,,24,0,0,0,0
23,8475906,John Klingberg,D,,32,0,0,0,0
23,8480008,Adam Ruzicka,C,,25,0,0,0,0
23,8476884,Derrick Pouliot,D,,30,0,0,0,0
23,8476919,Chris Tierney,C,,30,0,0,0,0
23,8479415,Michael McLeod,C,,26,0,0,0,0
23,8474870,Tyler Johnson,C,,34,0,0,0,0
23,8470604,Jeff Carter,C,,39,0,0,0,0
23,8478104,Sammy Blais,L,,28,0,0,0,0
23,8474884,Mike Hoffman,C,,35,0,0,0,0
23,8481591,Sam Poulin,R,,23,0,0,0,0
23,8471274,Alex Goligoski,D,,39,0,0,0,0
23,8476871,Tanner Pearson,L,,32,0,0,0,0
23,8476393,Nick Cousins,C,,31,0,0,0,0
23,8479977,Kailer Yamamoto,R,,26,0,0,0,0
23,8479346,Dillon Dube,C,,26,0,0,0,0
23,8480184,Gustav Lindstrom,D,,26,0,0,0,0
23,8479376,Victor Mete,D,,26,0,0,0,0
23,8473449,Kyle Okposo,R,,36,0,0,0,0
23,8481058,Jesse Ylonen,R,,25,0,0,0,0
23,8475752,Tyler Pitlick,C,,33,0,0,0,0
23,8481239,Samuel Fagemo,L,,24,0,0,0,0
23,8480821,Filip Zadina,R,,25,0,0,0,0
23,8470966,Mark Giordano,D,,41,0,0,0,0
23,8478495,Denis Gurianov,R,,27,0,0,0,0
23,8477464,Nic Petan,C,,29,0,0,0,0
23,8478099,Kevin Labanc,R,,29,0,0,0,0
23,8482241,Radim Zohorna,L,,28,0,0,0,0
23,8474040,Sam Gagner,C,,35,0,0,0,0
23,8479514,Rem Pitlick,C,,27,0,0,0,0
23,8478430,Oliver Kylington,D,,27,0,0,0,0
23,8479533,Joona Koppanen,L,,26,0,0,0,0
23,8479984,Cal Foote,D,,26,0,0,0,0
23,8477126,Jayson Megna,C,,34,0,0,0,0
23,8475164,Jakob Silfverberg,R,,34,0,0,0,0
23,8474009,Nick Bonino,C,,36,0,0,0,0
23,8479458,Nikita Zaitsev,D,,33,0,0,0,0
23,8477944,Jakub Vrana,L,,28,0,0,0,0
23,8471699,Andrew Cogliano,C,,37,0,0,0,0
23,8478067,Oskar Lindblom,L,,28,0,0,0,0
23,8471686,Marc Staal,D,,37,0,0,0,0
23,8470610,Zach Parise,L,,40,0,0,0,0
23,8478904,Steven Lorentz,C,,28,0,0,0,0
23,8473473,Milan Lucic,L,,36,0,0,0,0
23,8480031,Maxime Comtois,L,,25,0,0,0,0
23,8478512,Austin Czarnik,C,,32,0,0,0,0
23,8473504,Cal Clutterbuck,R,,37,0,0,0,0
23,8477454,Adam Erne,L,,29,0,0,0,0
23,8479383,Boris Katchouk,L,,26,0,0,0,0
23,8475825,Jani Hakanpää,D,,32,0,0,0,0
23,8477846,Ryan Carpenter,C,,33,0,0,0,0
23,8477930,Pierre-Edouard Bellemare,L,,39,0,0,0,0
23,8478400,Colin White,C,,27,0,0,0,0
23,8480226,Marián Studenic,R,,26,0,0,0,0
23,8480853,Liam Foudy,C,,24,0,0,0,0
23,8475797,Jarred Tinordi,D,,32,0,0,0,0
23,8479423,Alex Nylander,L,,26,0,0,0,0
23,8474618,Marco Scandella,D,,34,0,0,0,0
23,8478028,Fredrik Olofsson,L,,28,0,0,0,0
23,8474709,Matt Martin,L,,35,0,0,0,0
23,8481070,Hugh McGing,L,,26,0,0,0,0
23,8479546,Oskar Steen,C,,26,0,0,0,0
23,8474145,Robert Bortuzzo,D,,35,0,0,0,0
23,8476915,Jujhar Khaira,L,,30,0,0,0,0
23,8480274,Philip Kemp,D,EDM,25,0,0,0,0
23,8475278,Byron Froese,C,,33,0,0,0,0
23,8481812,Nikolai Knyzhov,D,,27,0,0,0,0
23,8478408,Travis Dermott,D,,28,0,0,0,0
23,8481077,John Leonard,L,,26,0,0,0,0
23,8479547,Matthew Phillips,R,,26,0,0,0,0
23,8480836,Jonathan Gruden,C,,24,0,0,0,0
23,8481690,Tyler Angle,C,,24,0,0,0,0
23,8475766,Austin Watson,L,,32,0,0,0,0
23,8481016,Ruslan Iskhakov,C,,24,0,0,0,0
23,8478078,Rourke Chartier,C,,28,0,0,0,0
23,8480776,Sheldon Rempal,R,,29,0,0,0,0
23,8483045,Cameron Butler,R,CBJ,31,0,0,0,0
23,8484314,Jiri Smejkal,L,,28,0,0,0,0
24,8476453,Nikita Kucherov,R,TBL,31,82,46,98,144
24,8478402,Connor McDavid,C,EDM,27,78,38,101,139
24,8477492,Nathan MacKinnon,C,COL,29,82,47,88,135
24,8479318,Auston Matthews,C,TOR,27,80,67,50,117
24,8477956,David Pastrnak,R,BOS,28,80,49,64,113
24,8478483,Mitch Marner,R,TOR,27,80,31,77,108
24,8477404,Jake Guentzel,C,TBL,30,82,44,63,107
24,8477939,William Nylander,R,TOR,28,80,46,60,106
24,8477946,Dylan Larkin,C,DET,28,82,52,50,102
24,8478864,Kirill Kaprizov,L,MIN,27,74,46,55,101
24,8477934,Leon Draisaitl,C,EDM,29,78,43,58,101
24,8480801,Brady Tkachuk,L,OTT,25,81,45,55,100
24,8476468,J.T. Miller,C,VAN,31,69,36,64,100
24,8480800,Quinn Hughes,D,VAN,25,74,13,86,99
24,8481559,Jack Hughes,C,NJD,23,77,34,62,96
24,8479314,Matthew Tkachuk,L,FLA,27,76,19,77,96
24,8476454,Ryan Nugent-Hopkins,C,EDM,31,79,32,62,94
24,8478398,Kyle Connor,L,WPG,28,78,53,40,93
24,8482116,Tim Stützle,C,OTT,22,78,32,59,91
24,8478550,Artemi Panarin,L,NYR,33,80,19,72,91
24,8480036,Miro Heiskanen,D,DAL,25,78,11,79,90
24,8476887,Filip Forsberg,L,NSH,30,73,37,52,89
24,8477942,Kevin Fiala,L,LAK,28,82,27,61,88
24,8478420,Mikko Rantanen,R,COL,28,79,37,50,87
24,8476389,Vincent Trocheck,C,NYR,31,79,33,54,87
24,8477933,Sam Reinhart,C,FLA,29,81,40,45,85
24,8475166,John Tavares,C,TOR,34,80,25,60,85
24,8480027,Jason Robertson,L,DAL,25,81,32,52,84
24,8475172,Nazem Kadri,C,CGY,34,77,32,50,82
24,8473512,Claude Giroux,R,OTT,36,79,25,57,82
24,8475913,Mark Stone,R,VGK,32,79,26,55,81
24,8478445,Mathew Barzal,C,NYI,27,76,24,56,80
24,8477501,Valeri Nichushkin,R,COL,29,81,48,31,79
24,8479343,Clayton Keller,R,UTA,26,78,35,44,79
24,8480023,Robert Thomas,C,STL,25,76,29,50,79
24,8476346,Johnny Gaudreau,L,CBJ,31,73,20,59,79
24,8479542,Brandon Hagel,L,TBL,26,82,37,41,78
24,8480208,Drake Batherson,R,OTT,26,77,26,52,78
24,8484144,Connor Bedard,C,CHI,19,70,24,54,78
24,8480865,Noah Dobson,D,NYI,24,78,12,66,78
24,8473419,Brad Marchand,L,BOS,36,81,33,44,77
24,8480012,Elias Pettersson,C,VAN,26,70,28,49,77
24,8477960,Adrian Kempe,R,LAK,28,81,36,40,76
24,8471675,Sidney Crosby,C,PIT,37,75,27,49,76
24,8477402,Pavel Buchnevich,L,STL,29,75,36,39,75
24,8477416,Oliver Bjorkstrand,R,SEA,29,74,35,40,75
24,8479407,Jesper Bratt,L,NJD,26,72,28,47,75
24,8477949,Alex Tuch,R,BUF,28,71,21,54,75
24,8478010,Brayden Point,C,TBL,28,82,40,34,74
24,8478427,Sebastian Aho,C,CAR,27,74,33,41,74
24,8478414,Timo Meier,R,NJD,28,78,43,30,73
24,8479420,Tage Thompson,C,BUF,27,74,42,31,73
24,8477493,Aleksander Barkov,C,FLA,29,74,19,54,73
24,8480069,Cale Makar,D,COL,26,66,24,48,72
24,8475167,Victor Hedman,D,TBL,34,80,18,54,72
24,8475168,Matt Duchene,C,DAL,33,82,32,39,71
24,8478873,Troy Terry,R,ANA,27,77,32,39,71
24,8476460,Mark Scheifele,C,WPG,31,75,30,41,71
24,8476459,Mika Zibanejad,C,NYR,31,78,30,41,71
24,8476539,Jonathan Marchessault,R,NSH,34,78,44,26,70
24,8478444,Brock Boeser,R,VAN,27,74,36,34,70
24,8480002,Nico Hischier,C,NJD,25,75,30,40,70
24,8479385,Jordan Kyrou,C,STL,26,73,29,41,70
24,8479323,Adam Fox,D,NYR,26,72,18,52,70
24,8475810,Bryan Rust,R,PIT,32,70,39,30,69
24,8480803,Evan Bouchard,D,EDM,25,76,15,54,69
24,8478439,Travis Konecny,R,PHI,27,80,26,42,68
24,8479675,Trevor Moore,L,LAK,29,81,25,43,68
24,8477940,Nikolaj Ehlers,L,WPG,28,68,23,45,68
24,8477504,Josh Morrissey,D,WPG,29,74,11,57,68
24,8481540,Cole Caufield,R,MTL,23,72,35,32,67
24,8474141,Patrick Kane,R,DET,36,80,28,39,67
24,8471215,Evgeni Malkin,C,PIT,38,70,28,39,67
24,8478493,Joel Eriksson Ek,C,MIN,27,70,23,44,67
24,8471685,Anze Kopitar,C,LAK,37,82,20,47,67
24,8475184,Chris Kreider,L,NYR,33,78,41,25,66
24,8478403,Jack Eichel,C,VGK,28,74,28,38,66
24,8477951,Nick Schmaltz,C,UTA,28,79,19,47,66
24,8475754,Brock Nelson,C,NYI,33,80,30,35,65
24,8474150,Mikael Backlund,C,CGY,35,76,29,36,65
24,8479337,Alex DeBrincat,R,DET,27,80,22,43,65
24,8477409,Carter Verhaeghe,C,FLA,29,76,36,28,64
24,8474564,Steven Stamkos,C,NSH,34,74,24,40,64
24,8480830,Andrei Svechnikov,R,CAR,24,69,20,44,64
24,8476456,Jonathan Huberdeau,C,CGY,31,80,15,49,64
24,8477935,Sam Bennett,C,FLA,28,79,28,35,63
24,8481557,Matt Boldy,L,MIN,23,73,25,38,63
24,8478401,Pavel Zacha,C,BOS,27,81,23,40,63
24,8476479,Phillip Danault,C,LAK,31,79,22,41,63
24,8478460,Zach Werenski,D,CBJ,27,81,20,43,63
24,8475692,Mats Zuccarello,R,MIN,37,77,13,50,63
24,8474102,David Perron,L,OTT,36,79,29,33,62
24,8477456,J.T. Compher,L,DET,29,78,28,34,62
24,8478440,Dylan Strome,C,WSH,27,71,23,39,62
24,8474600,Roman Josi,D,NSH,34,73,15,47,62
24,8478397,Rasmus Andersson,D,CGY,28,74,15,47,62
24,8482740,Wyatt Johnston,C,DAL,21,81,30,31,61
24,8478856,Conor Garland,R,VAN,28,69,25,36,61
24,8477496,Elias Lindholm,C,BOS,30,81,24,37,61
24,8474641,Adam Henrique,C,EDM,34,75,32,28,60
24,8476881,Tomas Hertl,C,VGK,31,76,27,33,60
24,8481528,Dylan Cozens,C,BUF,23,70,26,34,60
24,8481533,Trevor Zegras,C,ANA,23,77,21,39,60
24,8474578,Erik Karlsson,D,PIT,34,76,12,48,60
24,8480839,Rasmus Dahlin,D,BUF,24,73,12,48,60
24,8481068,Yegor Sharangovich,C,CGY,26,76,29,30,59
24,8475784,Jeff Skinner,C,EDM,32,80,26,33,59
24,8482745,Mason McTavish,C,ANA,21,72,26,33,59
24,8482124,Quinton Byfield,R,LAK,22,78,24,35,59
24,8480018,Nick Suzuki,C,MTL,25,75,21,38,59
24,8475765,Vladimir Tarasenko,R,DET,33,81,21,38,59
24,8478975,Mason Marchment,L,DAL,29,80,14,45,59
24,8482684,Luke Hughes,D,NJD,21,73,6,53,59
24,8475314,Anders Lee,L,NYI,34,80,34,24,58
24,8475726,Tyler Toffoli,C,SJS,32,68,30,28,58
24,8477503,Max Domi,C,TOR,29,79,24,34,58
24,8478407,Vince Dunn,D,SEA,28,77,22,36,58
24,8482078,Lucas Raymond,L,DET,22,79,19,39,58
24,8475170,Brayden Schenn,C,STL,33,75,25,32,57
24,8475786,Zach Hyman,L,EDM,32,77,34,22,56
24,8482699,Dylan Guenther,R,UTA,21,75,30,26,56
24,8482093,Seth Jarvis,C,CAR,22,68,22,34,56
24,8482665,Matty Beniers,C,SEA,22,78,22,34,56
24,8475794,Tyler Seguin,C,DAL,32,82,20,36,56
24,8477500,Bo Horvat,C,NYI,29,80,30,25,55
24,8478519,Anthony Cirelli,C,TBL,27,82,25,30,55
24,8477494,Jonathan Drouin,L,COL,29,79,13,42,55
24,8481711,Matias Maccelli,L,UTA,24,78,11,44,55
24,8479999,Casey Mittelstadt,C,COL,26,80,7,48,55
24,8475722,Jason Zucker,L,BUF,32,71,23,31,54
24,8477986,Brandon Montour,D,SEA,30,70,17,37,54
24,8477447,Shea Theodore,D,VGK,29,59,16,38,54
24,8471214,Alex Ovechkin,L,WSH,39,73,33,20,53
24,8478449,Roope Hintz,C,DAL,28,82,30,23,53
24,8478498,Jake DeBrusk,L,VAN,28,73,26,27,53
24,8482110,Dawson Mercer,C,NJD,23,74,25,28,53
24,8477964,Ivan Barbashev,C,VGK,29,77,19,34,53
24,8479339,Patrik Laine,L,CBJ,26,63,23,29,52
24,8477998,Warren Foegele,L,LAK,28,78,21,31,52
24,8483431,Logan Cooley,C,UTA,20,75,21,31,52
24,8484153,Leo Carlsson,C,ANA,20,72,19,33,52
24,8484145,Zach Benson,L,BUF,19,71,18,34,52
24,8476905,Chandler Stephenson,C,SEA,30,69,15,37,52
24,8478469,Thomas Chabot,D,OTT,27,74,13,39,52
24,8477955,Jared McCann,L,SEA,28,73,26,25,51
24,8475745,Charlie Coyle,C,BOS,32,79,25,26,51
24,8481618,Alex Newhook,C,MTL,23,77,23,28,51
24,8476399,Blake Coleman,C,CGY,33,77,21,30,51
24,8482092,Ridly Greig,C,OTT,22,78,21,30,51
24,8480039,Martin Necas,C,CAR,25,70,17,34,51
24,8475753,Justin Faulk,D,STL,32,73,12,39,51
24,8471724,Kris Letang,D,PIT,37,81,10,41,51
24,8479325,Charlie McAvoy,D,BOS,27,69,5,46,51
24,8475158,Ryan O'Reilly,C,NSH,33,72,23,27,50
24,8480064,Josh Norris,C,OTT,25,77,22,28,50
24,8478047,Michael Bunting,L,PIT,29,71,18,32,50
24,8482113,Anton Lundell,C,FLA,23,75,17,33,50
24,8474586,Jordan Eberle,R,SEA,34,75,14,36,50
24,8479425,Filip Hronek,D,VAN,27,73,10,40,50
24,8476875,Mike Matheson,D,MTL,30,72,7,43,50
24,8475169,Evander Kane,L,EDM,33,73,23,26,49
24,8482097,Jack Quinn,R,BUF,23,64,21,28,49
24,8477021,Alex Kerfoot,C,UTA,30,74,15,34,49
24,8477932,Aaron Ekblad,D,FLA,28,71,14,35,49
24,8470613,Brent Burns,D,CAR,39,75,11,38,49
24,8480014,Gabriel Vilardi,C,WPG,25,69,30,18,48
24,8476483,Rickard Rakell,R,PIT,31,64,24,24,48
24,8482175,JJ Peterka,R,BUF,22,69,24,24,48
24,8481596,Shane Pinto,C,OTT,24,78,23,25,48
24,8477476,Artturi Lehkonen,L,COL,29,80,21,27,48
24,8477497,Sean Monahan,C,CBJ,30,71,20,28,48
24,8477511,Anthony Mantha,R,CGY,30,76,17,31,48
24,8476826,Yanni Gourde,C,SEA,33,68,16,32,48
24,8477444,Andre Burakovsky,L,SEA,29,70,15,33,48
24,8476438,Brandon Saad,L,STL,32,73,22,25,47
24,8482149,Cole Perfetti,C,WPG,22,71,19,28,47
24,8479345,Jakob Chychrun,D,WSH,26,68,11,36,47
24,8476854,Hampus Lindholm,D,BOS,30,73,9,38,47
24,8473986,Alex Killorn,L,ANA,35,73,23,23,46
24,8477407,Anthony Duclair,L,NYI,29,78,22,24,46
24,8478462,Nicolas Roy,C,VGK,27,71,20,26,46
24,8476958,Jaccob Slavin,D,CAR,30,75,17,29,46
24,8483515,Juraj Slafkovsky,L,MTL,20,72,17,29,46
24,8479987,Morgan Geekie,C,BOS,26,75,16,30,46
24,8479410,Mikhail Sergachev,D,UTA,26,70,7,39,46
24,8476432,Boone Jenner,C,CBJ,31,70,28,17,45
24,8482702,Logan Stankoven,C,DAL,21,82,24,21,45
24,8480015,Owen Tippett,R,PHI,25,80,23,22,45
24,8476880,Tom Wilson,R,WSH,30,72,18,27,45
24,8473994,Jamie Benn,L,DAL,35,81,17,28,45
24,8478542,Evan Rodrigues,C,FLA,31,71,17,28,45
24,8481524,Bowen Byram,D,BUF,23,65,17,28,45
24,8476869,Brady Skjei,D,NSH,30,71,14,31,45
24,8475798,Mikael Granlund,C,SJS,32,67,12,33,45
24,8477346,MacKenzie Weegar,D,CGY,30,76,10,35,45
24,8482667,William Eklund,L,SJS,22,62,19,25,44
24,8480798,Philipp Kurashev,C,CHI,25,66,17,27,44
24,8476292,Ondrej Palat,L,NJD,33,69,9,35,44
24,8479525,Ross Colton,C,COL,28,80,23,20,43
24,8475191,Reilly Smith,R,NYR,33,70,19,24,43
24,8482655,Janis Moser,D,TBL,24,75,2,41,43
24,8477451,Ryan Hartman,R,MIN,30,62,24,18,42
24,8482109,Alexis Lafrenière,L,NYR,23,75,23,19,42
24,8478115,Pierre Engvall,L,NYI,28,74,23,19,42
24,8477426,Nicholas Paul,L,TBL,29,82,22,20,42
24,8481582,Nicholas Robertson,L,TOR,23,67,22,20,42
24,8479992,Michael Rasmussen,C,DET,25,77,21,21,42
24,8482159,Tyson Foerster,R,PHI,22,69,20,22,42
24,8483808,Andrei Kuzmenko,L,CGY,28,74,20,22,42
24,8476882,Teuvo Teravainen,C,CHI,30,65,18,24,42
24,8476927,Teddy Blueger,C,VAN,30,72,15,27,42
24,8474590,John Carlson,D,WSH,34,69,12,30,42
24,8477495,Seth Jones,D,CHI,30,65,6,36,42
24,8481560,Arthur Kaliyev,R,LAK,23,80,22,19,41
24,8476448,William Karlsson,C,VGK,31,74,21,20,41
24,8471698,T.J. Oshie,R,WSH,38,74,19,22,41
24,8482705,Cole Sillinger,C,CBJ,21,64,18,23,41
24,8478042,Viktor Arvidsson,L,EDM,31,76,17,24,41
24,8480009,Eeli Tolvanen,R,SEA,25,70,17,24,41
24,8476853,Morgan Rielly,D,TOR,30,67,8,33,41
24,8477948,Travis Sanheim,D,PHI,28,71,6,35,41
24,8478366,Frank Vatrano,R,ANA,30,72,24,16,40
24,8476981,Josh Anderson,R,MTL,30,71,18,22,40
24,8478438,Tommy Novak,C,NSH,27,63,16,24,40
24,8484166,Adam Fantilli,C,CBJ,20,67,15,25,40
24,8474679,Gustav Nyquist,C,NSH,35,70,7,33,40
24,8480220,Noah Cates,L,PHI,25,72,17,22,39
24,8478046,Danton Heinen,L,VAN,29,70,16,23,39
24,8478463,Anthony Beauvillier,L,PIT,27,71,15,24,39
24,8481577,Philip Tomasino,C,NSH,23,63,11,28,39
24,8482475,Yegor Chinakhov,R,CBJ,23,73,11,28,39
24,8482089,Jake Neighbours,L,STL,22,67,26,12,38
24,8480802,Ryan McLeod,C,BUF,25,66,16,22,38
24,8474563,Drew Doughty,D,LAK,35,71,15,23,38
24,8479591,Michael Eyssimont,C,TBL,28,82,13,25,38
24,8482671,Owen Power,D,BUF,22,64,11,27,38
24,8476419,Jean-Gabriel Pageau,C,NYI,32,75,8,30,38
24,8482720,Matthew Knies,L,TOR,22,71,7,31,38
24,8476792,Torey Krug,D,STL,33,72,4,34,38
24,8475151,Kyle Palmieri,C,NYI,33,77,21,16,37
24,8475848,Brendan Gallagher,R,MTL,32,71,18,19,37
24,8477479,Tyler Bertuzzi,L,CHI,29,67,15,22,37
24,8476872,Scott Laughton,C,PHI,30,72,15,22,37
24,8475287,Erik Haula,L,NJD,33,73,14,23,37
24,8478466,Daniel Sprong,R,VAN,27,70,13,24,37
24,8478055,Gustav Forsling,D,FLA,28,73,12,25,37
24,8475149,Marcus Johansson,L,MIN,34,71,12,25,37
24,8480459,Pius Suter,C,VAN,28,74,24,12,36
24,8478474,Lawson Crouse,L,UTA,27,75,16,20,36
24,8476462,Dougie Hamilton,D,NJD,31,63,14,22,36
24,8483565,Nick Blankenburg,D,NSH,26,61,11,25,36
24,8480817,K'Andre Miller,D,NYR,24,71,8,28,36
24,8475764,Cam Fowler,D,ANA,33,74,6,30,36
24,8474565,Alex Pietrangelo,D,VGK,34,66,6,30,36
24,8482055,Drew O'Connor,L,PIT,26,62,18,17,35
24,8475793,Ryan Johansen,C,PHI,32,72,17,18,35
24,8478472,Mathieu Joseph,R,STL,27,68,16,19,35
24,8478233,Andrew Mangiapane,L,WSH,28,73,15,20,35
24,8479400,Pierre-Luc Dubois,L,WSH,26,73,13,22,35
24,8483505,Matthew Poitras,C,BOS,20,74,12,23,35
24,8482133,Thomas Bordeleau,C,SJS,22,60,10,25,35
24,8482624,Daniil Miromanov,D,CGY,27,60,9,26,35
24,8481542,Moritz Seider,D,DET,23,74,5,30,35
24,8480028,Morgan Frost,C,PHI,25,72,16,18,34
24,8479941,Justin Danforth,R,CBJ,31,60,15,19,34
24,8480188,Fabian Zetterlund,L,SJS,25,63,14,20,34
24,8482142,Jamie Drysdale,D,PHI,22,70,13,21,34
24,8474053,Logan Couture,C,SJS,35,61,9,25,34
24,8478038,Devon Toews,D,COL,30,69,8,26,34
24,8476474,Stefan Noesen,R,NJD,31,66,20,13,33
24,8475768,Jaden Schwartz,C,SEA,32,70,17,16,33
24,8480185,Eetu Luostarinen,C,FLA,26,75,17,16,33
24,8477987,Ryan Donato,C,CHI,28,60,15,18,33
24,8482146,Luke Evangelista,R,NSH,22,64,14,19,33
24,8474715,Cameron Atkinson,R,TBL,35,82,14,19,33
24,8478020,Michael Amadio,R,OTT,28,71,14,19,33
24,8475763,Kevin Hayes,R,PIT,32,76,13,20,33
24,8482105,Jake Sanderson,D,OTT,22,76,9,24,33
24,8477969,Marcus Pettersson,D,PIT,28,79,2,31,33
24,8473422,Nick Foligno,L,CHI,37,59,19,13,32
24,8475193,Tomas Tatar,L,NJD,34,59,18,14,32
24,8478891,Mason Appleton,C,WPG,28,65,15,17,32
24,8476480,Vladislav Namestnikov,C,WPG,32,63,15,17,32
24,8481604,Pavel Dorofeyev,L,VGK,24,69,14,18,32
24,8476469,Joel Armia,R,MTL,31,64,14,18,32
24,8476461,Sean Couturier,C,PHI,32,65,10,22,32
24,8484203,Bradly Nadeau,L,CAR,19,59,10,22,32
24,8481703,Valtteri Puustinen,R,PIT,25,64,10,22,32
24,8478458,John (Jack) Roslovic,C,CAR,27,71,8,24,32
24,8477488,Brett Pesce,D,NJD,30,68,6,26,32
24,8482712,Oskar Olausson,R,COL,22,76,5,27,32
24,8479393,Noah Gregor,L,OTT,26,73,16,15,31
24,8481581,Thomas Harley,D,DAL,23,78,14,17,31
24,8480871,Adam Boqvist,D,FLA,24,71,14,17,31
24,8482117,Lukas Reichel,L,CHI,22,56,13,18,31
24,8482101,Danil Gushchin,L,SJS,22,68,13,18,31
24,8475231,Casey Cizikas,C,NYI,33,76,10,21,31
24,8476906,Shayne Gostisbehere,D,CAR,31,79,6,25,31
24,8474716,Jared Spurgeon,D,MIN,35,75,6,25,31
24,8483490,Pavel Mintyukov,D,ANA,21,77,6,25,31
24,8476892,Colton Parayko,D,STL,31,70,2,29,31
24,8482259,Bobby McMann,C,TOR,28,61,19,11,30
24,8476878,Zemgus Girgensons,C,TBL,30,81,19,11,30
24,8482074,Connor Zary,C,CGY,23,65,19,11,30
24,8475760,Nick Bjugstad,C,UTA,32,75,17,13,30
24,8475799,Nino Niederreiter,R,WPG,32,68,15,15,30
24,8479365,Trent Frederic,C,BOS,26,75,13,17,30
24,8480855,Jack McBain,C,UTA,24,62,13,17,30
24,8481186,Logan O'Connor,R,COL,28,80,11,19,30
24,8474151,Ryan McDonagh,D,TBL,35,80,2,28,30
24,8475714,Calle Jarnkrok,C,TOR,33,73,17,12,29
24,8480849,Barrett Hayton,C,UTA,24,74,16,13,29
24,8480829,Jesperi Kotkaniemi,C,CAR,24,67,15,14,29
24,8474149,Evgenii Dadonov,R,DAL,35,81,14,15,29
24,8477919,Frederick Gaudreau,C,MIN,31,61,14,15,29
24,8475220,Marcus Foligno,L,MIN,33,64,13,16,29
24,8482660,Kent Johnson,C,CBJ,22,58,11,18,29
24,8477947,Sonny Milano,L,WSH,28,61,10,19,29
24,8481704,Juuso Parssinen,C,NSH,23,62,10,19,29
24,8482122,Brock Faber,D,MIN,22,79,7,22,29
24,8482067,Connor Mackey,D,NYR,28,65,5,24,29
24,8479402,Jake Bean,D,CGY,26,69,5,24,29
24,8474574,Tyler Myers,D,VAN,34,70,3,26,29
24,8478013,Jake Walman,D,SJS,28,67,15,13,28
24,8479661,Tanner Jeannot,L,LAK,27,76,14,14,28
24,8481523,Kirby Dach,C,MTL,23,70,14,14,28
24,8478413,Jordan Greenway,L,BUF,27,64,13,15,28
24,8479351,Sam Steel,C,DAL,26,76,9,19,28
24,8480078,Filip Chytil,C,NYR,25,69,9,19,28
24,8476885,Jacob Trouba,D,NYR,30,70,7,21,28
24,8476458,Ryan Strome,C,ANA,31,72,7,21,28
24,8476923,Damon Severson,D,CBJ,30,80,5,23,28
24,8478396,Noah Hanifin,D,VGK,27,56,4,24,28
24,8476979,Erik Gustafsson,D,DET,32,73,3,25,28
24,8481535,Nils Hoglander,L,VAN,24,68,13,14,27
24,8480113,Alex Iafallo,L,WPG,31,67,13,14,27
24,8480797,Joel Farabee,L,PHI,24,72,12,15,27
24,8481093,Rafael Harvey-Pinard,L,MTL,25,62,11,16,27
24,8475171,Oliver Ekman-Larsson,D,TOR,33,65,8,19,27
24,8481606,Jordan Spence,D,LAK,23,70,7,20,27
24,8475218,Mattias Ekholm,D,EDM,34,73,5,22,27
24,8477506,Ryan Pulock,D,NYI,30,79,3,24,27
24,8479982,Conor Timmins,D,TOR,26,59,2,25,27
24,8477446,Michael McCarron,R,NSH,29,62,17,9,26
24,8474189,Lars Eller,C,PIT,35,64,16,10,26
24,8478508,Yakov Trenin,C,MIN,27,57,13,13,26
24,8481554,Kaapo Kakko,R,NYR,23,74,12,14,26
24,8480003,Jesper Boqvist,C,FLA,26,71,12,14,26
24,8480835,Jack Drury,C,CAR,24,62,12,14,26
24,8479316,Luke Kunin,C,SJS,27,55,12,14,26
24,8482737,Zack Bolduc,C,STL,21,60,11,15,26
24,8475200,Dmitry Orlov,D,CAR,33,73,9,17,26
24,8480336,Sean Walker,D,CAR,30,70,9,17,26
24,8477429,Andrew Copp,C,DET,30,77,7,19,26
24,8480145,Neal Pionk,D,WPG,29,67,6,20,26
24,8481546,Cam York,D,PHI,23,69,6,20,26
24,8474673,TJ Brodie,D,CHI,34,61,4,22,26
24,8479976,Juuso Valimaki,D,UTA,26,66,3,23,26
24,8480893,Kirill Marchenko,R,CBJ,24,61,17,8,25
24,8482125,Alexander Holtz,R,VGK,22,68,14,11,25
24,8478057,Dakota Joshua,C,VAN,28,66,13,12,25
24,8480068,Ryan Poehling,C,PHI,25,71,11,14,25
24,8477498,Darnell Nurse,D,EDM,29,70,10,15,25
24,8476921,Jordan Martinook,L,CAR,32,70,10,15,25
24,8480748,Kiefer Sherwood,L,VAN,29,56,10,15,25
24,8476392,Adam Lowry,C,WPG,31,64,8,17,25
24,8480434,Sean Durzi,D,UTA,26,61,7,18,25
24,8477505,Alexander Wennberg,C,SJS,30,66,7,18,25
24,8481656,Aliaksei Protas,C,WSH,23,61,6,19,25
24,8480049,Dylan Samberg,D,WPG,25,66,2,23,25
24,8476918,Jimmy Vesey,L,NYR,31,67,13,11,24
24,8475791,Taylor Hall,L,CHI,33,54,12,12,24
24,8481553,Bobby Brink,R,PHI,23,66,11,13,24
24,8477953,Kasperi Kapanen,R,STL,28,59,10,14,24
24,8481522,Peyton Krebs,C,BUF,23,58,10,14,24
24,8482679,Matt Coronato,R,CGY,22,66,8,16,24
24,8476917,Adam Pelech,D,NYI,30,77,7,17,24
24,8476467,Jamie Oleksiak,D,SEA,32,65,7,17,24
24,8480043,Timothy Liljegren,D,TOR,25,63,5,19,24
24,8478882,Vladislav Gavrikov,D,LAK,29,72,4,20,24
24,8475790,Erik Gudbranson,D,CBJ,32,77,4,20,24
24,8475233,David Savard,D,MTL,34,64,4,20,24
24,8473507,Jeff Petry,D,DET,37,71,3,21,24
24,8479371,Dante Fabbro,D,NSH,26,69,2,22,24
24,8477425,Miles Wood,L,COL,29,79,16,7,23
24,8479390,Taylor Raddysh,R,WSH,26,58,12,11,23
24,8477450,Jason Dickinson,C,CHI,29,60,12,11,23
24,8481537,Nikita Okhotiuk,D,CGY,24,51,12,11,23
24,8470621,Corey Perry,R,EDM,39,64,11,12,23
24,8477406,Mattias Janmark,C,EDM,32,66,10,13,23
24,8480205,Emil Bemstrom,C,PIT,25,56,10,13,23
24,8477989,Christian Dvorak,C,MTL,28,67,9,14,23
24,8480789,Oliver Wahlstrom,R,NYI,24,67,9,14,23
24,8478569,Noel Acciari,C,PIT,33,48,9,14,23
24,8483457,Lane Hutson,D,MTL,20,66,9,14,23
24,8482749,Joshua Roy,R,MTL,21,61,8,15,23
24,8476422,Mike Reilly,D,NYI,31,76,8,15,23
24,8473453,Trevor Lewis,C,LAK,37,69,7,16,23
24,8477508,Curtis Lazar,C,NJD,29,60,5,18,23
24,8478851,Alexandre Carrier,D,NSH,28,68,3,20,23
24,8475324,Nick Jensen,D,OTT,34,73,3,20,23
24,8476463,Jonas Brodin,D,MIN,31,78,2,21,23
24,8477952,Robby Fabbri,C,ANA,28,58,11,11,22
24,8481580,Connor McMichael,C,WSH,23,62,11,11,22
24,8476960,Andreas Athanasiou,C,CHI,30,51,11,11,22
24,8482809,Jackson Blake,R,CAR,21,54,10,12,22
24,8481441,Joe Snively,C,DET,28,63,9,13,22
24,8481481,Blake Lizotte,C,PIT,27,56,8,14,22
24,8480813,Joe Veleno,C,DET,24,79,7,15,22
24,8476329,Travis Boyd,C,MIN,31,50,7,15,22
24,8474034,Patrick Maroon,L,CHI,36,47,6,16,22
24,8476902,Esa Lindell,D,DAL,30,75,6,16,22
24,8480035,Henri Jokiharju,D,BUF,25,73,4,18,22
24,8482087,Kaiden Guhle,D,MTL,22,69,4,18,22
24,8476879,Cody Ceci,D,EDM,31,69,3,19,22
24,8480025,MacKenzie Entwistle,R,FLA,25,65,14,7,21
24,8481032,Paul Cotter,C,NJD,25,61,13,8,21
24,8483482,Tristan Luneau,D,ANA,20,62,12,9,21
24,8482157,Will Cuylle,L,NYR,22,69,9,12,21
24,8478970,Jalen Chatfield,D,CAR,28,73,9,12,21
24,8483495,Simon Nemec,D,NJD,20,58,9,12,21
24,8479996,Cody Glass,C,NSH,25,64,8,13,21
24,8477979,Nicolas Aube-Kubel,R,BUF,28,52,8,13,21
24,8476925,Colton Sissons,C,NSH,31,62,7,14,21
24,8477903,Garnet Hathaway,R,PHI,33,57,7,14,21
24,8478136,Jake Middleton,D,MIN,28,70,6,15,21
24,8478133,Jake Evans,C,MTL,28,65,5,16,21
24,8481014,Alexander Romanov,D,NYI,24,78,4,17,21
24,8480058,Pierre-Olivier Joseph,D,STL,25,58,3,18,21
24,8478500,Ivan Provorov,D,CBJ,27,77,2,19,21
24,8476931,Jake McCabe,D,TOR,31,64,2,19,21
24,8479619,Michael Carcone,L,UTA,28,56,13,7,20
24,8483493,Frank Nazar,C,CHI,20,44,11,9,20
24,8476374,Sean Kuraly,C,CBJ,31,53,11,9,20
24,8483524,Shane Wright,C,SEA,20,65,10,10,20
24,8480806,Isac Lundestrom,C,ANA,25,65,10,10,20
24,8481013,Jonatan Berggren,R,DET,24,60,10,10,20
24,8476873,Mark Jankowski,C,NSH,30,54,10,10,20
24,8475343,Nic Dowd,C,WSH,34,61,9,11,20
24,8479315,Joey Anderson,R,CHI,26,52,9,11,20
24,8479414,Nathan Bastian,R,NJD,27,57,9,11,20
24,8477839,Conor Sheary,L,TBL,32,82,8,12,20
24,8480144,David Kampf,C,TOR,29,70,7,13,20
24,8477220,Nate Schmidt,D,FLA,33,64,6,14,20
24,8482245,Artem Zub,D,OTT,29,67,5,15,20
24,8479671,Mathieu Olivier,R,CBJ,27,51,5,15,20
24,8480246,Nick Perbix,D,TBL,26,70,3,17,20
24,8475208,Brian Dumoulin,D,ANA,33,64,2,18,20
24,8476331,Dylan DeMelo,D,WPG,31,68,1,19,20
24,8476278,Colin Blackwell,C,DAL,31,76,14,5,19
24,8475855,Jesper Fast,R,CAR,33,59,12,7,19
24,8483445,Cutter Gauthier,L,ANA,20,58,8,11,19
24,8473533,Jordan Staal,C,CAR,36,60,8,11,19
24,8473563,Nicklas Backstrom,C,WSH,37,57,8,11,19
24,8481477,Nico Sturm,C,SJS,29,55,7,12,19
24,8481624,Ilya Mikheyev,R,CHI,30,58,6,13,19
24,8482111,Justin Barron,D,MTL,23,63,6,13,19
24,8476457,Adam Larsson,D,SEA,32,71,6,13,19
24,8478911,Matt Roy,D,WSH,29,65,5,14,19
24,8482176,Wyatt Kaiser,D,CHI,22,49,4,15,19
24,8479344,Jesse Puljujarvi,R,PIT,26,51,4,15,19
24,8478416,Erik Cernak,D,TBL,27,69,3,16,19
24,8476429,Scott Mayfield,D,NYI,32,74,3,16,19
24,8480860,Kevin Bahl,D,CGY,24,61,2,17,19
24,8479983,Mario Ferraro,D,SJS,26,70,2,17,19
24,8477365,Connor Clifton,D,BUF,29,48,2,17,19
24,8481617,Vasily Podkolzin,R,VAN,23,49,11,7,18
24,8478421,A.J. Greer,L,FLA,28,61,10,8,18
24,8480980,Connor Dewar,C,TOR,25,66,10,8,18
24,8480762,Eric Robinson,L,CAR,29,62,9,9,18
24,8477353,Tyler Motte,C,DET,29,75,8,10,18
24,8479353,Brett Howden,C,VGK,26,66,7,11,18
24,8480073,Erik Brannstrom,D,COL,25,63,7,11,18
24,8476312,Josh Manson,D,COL,33,62,5,13,18
24,8477507,Nikita Zadorov,D,BOS,29,62,5,13,18
24,8482062,Cole Smith,L,NSH,29,60,4,14,18
24,8482803,Olen Zellweger,D,ANA,21,68,4,14,18
24,8480878,Nils Lundkvist,D,DAL,24,71,3,15,18
24,8479639,Dylan Coghlan,D,WPG,26,67,3,15,18
24,8475188,Brayden McNabb,D,VGK,33,57,3,15,18
24,8480873,Rasmus Sandin,D,WSH,24,60,2,16,18
24,8481601,Simon Holmstrom,R,NYI,23,70,12,5,17
24,8475225,Craig Smith,C,CHI,35,46,11,6,17
24,8481028,Martin Pospisil,C,CGY,25,50,10,7,17
24,8479336,Carl Grundstrom,R,SJS,27,53,10,7,17
24,8479968,Vinni Lettieri,C,BOS,29,55,10,7,17
24,8477478,William Carrier,L,CAR,30,61,8,9,17
24,8476897,Oskar Sundqvist,C,STL,30,56,7,10,17
24,8484149,Gavin Brindley,C,CBJ,20,48,6,11,17
24,8480995,Pontus Holmberg,R,TOR,25,61,6,11,17
24,8483468,Jiri Kulich,C,BUF,20,54,5,12,17
24,8480011,Klim Kostin,C,SJS,25,53,4,13,17
24,8476988,Matt Benning,D,SJS,30,64,4,13,17
24,8479398,Samuel Girard,D,COL,26,62,3,14,17
24,8475181,Nick Leddy,D,STL,33,71,2,15,17
24,8478399,Jonas Siegenthaler,D,NJD,27,61,2,15,17
24,8478434,Keegan Kolesar,R,VGK,27,65,11,5,16
24,8480252,Cole Guttman,C,CHI,25,41,10,6,16
24,8478432,Christian Fischer,R,DET,27,73,9,7,16
24,8479291,Kevin Rooney,C,CGY,31,50,8,8,16
24,8482077,Dylan Holloway,L,EDM,23,50,8,8,16
24,8479066,Ryan Lomberg,L,CGY,30,62,7,9,16
24,8476856,Mathew Dumba,D,DAL,30,74,4,12,16
24,8479026,Philippe Myers,D,TOR,27,53,4,12,16
24,8479543,Michael Pezzetta,L,MTL,26,57,4,12,16
24,8479372,Joshua Mahura,D,SEA,26,55,4,12,16
24,8480448,Parker Kelly,L,COL,25,74,3,13,16
24,8480727,Zach Whitecloud,D,VGK,28,51,3,13,16
24,8476874,Olli Maatta,D,DET,30,63,3,13,16
24,8476891,Matthew Grzelcyk,D,PIT,30,77,2,14,16
24,8475690,Chris Tanev,D,TOR,35,64,2,14,16
24,8476525,Colin Miller,D,WPG,32,65,2,14,16
24,8480891,Michael Kesselring,D,UTA,24,62,2,14,16
24,8475179,Dmitry Kulikov,D,FLA,34,63,1,15,16
24,8477845,Trevor van Riemsdyk,D,WSH,33,59,1,15,16
24,8480281,Alexey Toropchenko,R,STL,25,56,11,4,15
24,8478109,Victor Olofsson,L,VGK,29,64,9,6,15
24,8480289,Morgan Barron,C,WPG,26,50,9,6,15
24,8477380,Jonny Brodzinski,C,NYR,31,58,6,9,15
24,8483499,Liam Ohgren,L,MIN,20,52,5,10,15
24,8482079,Marco Rossi,C,MIN,23,53,5,10,15
24,8482095,Tyler Kleven,D,OTT,22,48,5,10,15
24,8481599,Victor Soderstrom,D,UTA,23,53,5,10,15
24,8478043,Sam Lafferty,C,BUF,29,59,4,11,15
24,8478452,Caleb Jones,D,LAK,27,58,4,11,15
24,8478840,Will Borgen,D,SEA,28,69,4,11,15
24,8477435,Ryan Graves,D,PIT,29,72,4,11,15
24,8480157,Calle Rosen,D,COL,30,49,4,11,15
24,8483549,Lucas Condotta,L,MTL,27,36,4,11,15
24,8482634,Alex Steeves,C,TOR,25,49,3,12,15
24,8478178,Darren Raddysh,D,TBL,28,72,2,13,15
24,8481550,Adam Beckman,L,NJD,23,47,2,13,15
24,8476934,Brock McGinn,L,ANA,30,43,2,13,15
24,8478507,John Marino,D,UTA,27,63,1,14,15
24,8479293,Brandon Tanev,L,SEA,33,61,8,6,14
24,8478585,Derek Ryan,C,EDM,38,63,8,6,14
24,8480355,Mark Kastelic,C,BOS,25,55,8,6,14
24,8476889,Radek Faksa,C,STL,30,65,7,7,14
24,8480074,Alexandre Texier,C,STL,25,55,7,7,14
24,8476442,Matt Nieto,L,PIT,32,56,6,8,14
24,8482148,Hendrix Lapierre,C,WSH,22,60,5,9,14
24,8480021,Jack Studnicka,C,LAK,25,54,5,9,14
24,8482730,Brandt Clarke,D,LAK,21,45,5,9,14
24,8475462,Radko Gudas,D,ANA,34,65,4,10,14
24,8479369,Andrew Peeke,D,BOS,26,57,4,10,14
24,8477369,Carson Soucy,D,VAN,30,69,4,10,14
24,8481521,Ronnie Attard,D,PHI,25,49,3,11,14
24,8479324,Ryan Lindgren,D,NYR,26,60,3,11,14
24,8479980,Nicolas Hague,D,VGK,26,59,3,11,14
24,8481019,David Gustafsson,C,WPG,24,46,3,11,14
24,8477573,Nathan Walker,L,STL,30,56,3,11,14
24,8480807,Mattias Samuelsson,D,BUF,24,57,3,11,14
24,8479249,Andrew Poturalski,C,SJS,30,32,3,11,14
24,8480001,Urho Vaakanainen,D,ANA,25,54,2,12,14
24,8481568,Alex Vlasic,D,CHI,23,55,2,12,14
24,8478874,Adam Gaudette,R,OTT,28,38,2,12,14
24,8478859,Niko Mikkola,D,FLA,28,60,2,12,14
24,8479998,Mikey Anderson,D,LAK,25,64,0,14,14
24,8481641,Joel Kiviranta,L,COL,28,68,9,4,13
24,8479368,Max Jones,L,BOS,26,63,8,5,13
24,8476994,Vinnie Hinostroza,C,NSH,30,53,7,6,13
24,8476624,Barclay Goodrow,C,SJS,31,49,7,6,13
24,8479536,Axel Jonsson-Fjallby,L,WPG,26,38,6,7,13
24,8477015,Connor Brown,R,EDM,30,63,5,8,13
24,8482807,Ethan Del Mastro,D,CHI,21,49,3,10,13
24,8478443,Brandon Carlo,D,BOS,28,64,3,10,13
24,8477392,Hudson Fasching,R,NYI,29,63,2,11,13
24,8477499,Rasmus Ristolainen,D,PHI,30,62,1,12,13
24,8482155,Alex Laferriere,R,LAK,23,62,9,3,12
24,8482659,Josh Doan,R,UTA,22,50,9,3,12
24,8479370,Tyson Jost,C,CAR,26,42,8,4,12
24,8479328,Julien Gauthier,R,NYI,27,69,8,4,12
24,8475842,Sam Carrick,C,NYR,32,63,8,4,12
24,8479520,Brandon Duhaime,R,WSH,27,50,7,5,12
24,8482762,Simon Edvinsson,D,DET,21,52,7,5,12
24,8478211,Dryden Hunt,L,CGY,29,54,5,7,12
24,8481567,Henry Thrun,D,SJS,23,56,5,7,12
24,8477962,Brendan Lemieux,L,CAR,28,36,5,7,12
24,8482451,Mikael Pyyhtia,L,CBJ,23,44,4,8,12
24,8481527,Kaedan Korczak,D,VGK,23,47,4,8,12
24,8470600,Ryan Suter,D,STL,39,60,4,8,12
24,8475279,Ben Chiarot,D,DET,33,75,3,9,12
24,8476441,Joel Edmundson,D,LAK,31,45,3,9,12
24,8481161,Jake Christiansen,D,CBJ,25,57,3,9,12
24,8481598,Philip Broberg,D,EDM,23,47,3,9,12
24,8476967,Brett Kulak,D,EDM,30,59,2,10,12
24,8474090,Brendan Smith,D,DAL,35,51,2,10,12
24,8480950,Ilya Lyubushkin,D,DAL,30,57,2,10,12
24,8480887,Jordan Harris,D,MTL,24,61,2,10,12
24,8475455,Brenden Dillon,D,NJD,34,60,1,11,12
24,8481178,Egor Zamula,D,PHI,24,62,0,12,12
24,8481517,Brett Leason,R,ANA,25,53,9,2,11
24,8476822,Luke Glendening,C,TBL,35,78,8,3,11
24,8479981,Jonah Gadjovich,L,FLA,26,42,6,5,11
24,8481708,Zac Jones,D,NYR,24,47,5,6,11
24,8480172,Jan Rutta,D,SJS,34,65,5,6,11
24,8482166,Shakir Mukhamadullin,D,SJS,22,47,4,7,11
24,8483763,Maksymilian Szuber,D,UTA,22,33,4,7,11
24,8474166,Alec Martinez,D,CHI,37,51,3,8,11
24,8480222,Sebastian Aho,D,PIT,28,70,2,9,11
24,8474567,Zach Bogosian,D,MIN,34,61,1,10,11
24,8479442,Troy Stecher,D,EDM,30,58,1,10,11
24,8477034,Jaycob Megna,D,FLA,32,45,1,10,11
24,8481716,Dmitri Voronkov,L,CBJ,24,45,7,3,10
24,8476858,Phillip Di Giuseppe,L,VAN,31,45,7,3,10
24,8475235,Nicolas Deslauriers,L,PHI,33,57,7,3,10
24,8482859,Zack Ostapchuk,C,OTT,21,52,5,5,10
24,8479439,Jacob MacDonald,D,COL,31,48,4,6,10
24,8481751,Lukas Rousek,R,BUF,25,46,4,6,10
24,8474612,Travis Hamonic,D,OTT,34,41,4,6,10
24,8481600,Tobias Bjornfot,D,FLA,23,36,4,6,10
24,8482153,Brendan Brisson,C,VGK,23,38,4,6,10
24,8480007,Jonas Rondbjerg,R,VGK,25,35,4,6,10
24,8477018,Ben Hutton,D,VGK,31,48,3,7,10
24,8477938,Haydn Fleury,D,WPG,28,43,3,7,10
24,8481679,Maxence Guenette,D,OTT,23,34,3,7,10
24,8482192,Isaak Phillips,D,CHI,23,59,2,8,10
24,8483460,David Jiricek,D,CBJ,21,62,2,8,10
24,8483491,Ivan Miroshnichenko,L,WSH,20,47,2,8,10
24,8477482,Zachary Sanford,L,CHI,30,48,2,8,10
24,8480834,Ty Emberson,D,SJS,24,31,2,8,10
24,8481059,Scott Perunovich,D,STL,26,61,1,9,10
24,8480441,Trey Fix-Wolansky,R,CBJ,25,36,1,9,10
24,8474568,Luke Schenn,D,NSH,35,56,1,9,10
24,8480880,Jakub Lauko,C,MIN,24,36,8,1,9
24,8479718,Alex Barré-Boulet,C,MTL,27,42,6,3,9
24,8481789,Tye Kartye,L,SEA,23,45,6,3,9
24,8481147,Reese Johnson,C,MIN,26,36,6,3,9
24,8479359,Beck Malenstyn,L,BUF,26,45,5,4,9
24,8471817,Ryan Reaves,R,TOR,37,57,5,4,9
24,8482652,Walker Duehr,R,CGY,27,38,5,4,9
24,8480845,Rasmus Kupari,C,WPG,24,40,5,4,9
24,8476867,Brendan Gaunce,C,MIN,30,42,5,4,9
24,8478424,Jansen Harkins,C,ANA,27,52,4,5,9
24,8476913,Devin Shore,C,MIN,30,39,4,5,9
24,8477931,Tomas Nosek,L,FLA,32,64,3,6,9
24,8478451,Ethan Bear,D,WSH,27,43,3,6,9
24,8471677,Jack Johnson,D,CBJ,37,58,3,6,9
24,8478831,Kevin Stenlund,C,UTA,28,55,3,6,9
24,8474013,Ian Cole,D,UTA,35,53,3,6,9
24,8482496,Nils Aman,C,VAN,24,40,2,7,9
24,8483466,Kevin Korchinski,D,CHI,20,47,2,7,9
24,8471709,Marc-Edouard Vlasic,D,SJS,37,64,2,7,9
24,8480796,Martin Fehervary,D,WSH,25,62,1,8,9
24,8481701,Santeri Hatakka,D,NJD,23,43,1,8,9
24,8481532,Alex Turcotte,C,LAK,23,52,7,1,8
24,8481518,Nolan Foote,L,NJD,24,45,6,2,8
24,8479772,Zack MacEwen,R,OTT,28,45,4,4,8
24,8482145,Mavrik Bourque,C,DAL,22,48,4,4,8
24,8482073,Braden Schneider,D,NYR,23,61,3,5,8
24,8478468,Jeremy Lauzon,D,NSH,27,51,3,5,8
24,8481167,Brayden Pachal,D,CGY,25,39,2,6,8
24,8477401,John Hayden,C,SEA,29,33,2,6,8
24,8477851,Jordan Oesterle,D,BOS,32,39,2,6,8
24,8479378,Logan Stanley,D,WPG,26,42,1,7,8
24,8480879,Jacob Bernard-Docker,D,OTT,24,42,1,7,8
24,8480070,Ian Mitchell,D,BOS,25,56,0,8,8
24,8479944,Zach Aston-Reese,C,VGK,30,51,5,2,7
24,8480192,Johnathan Kovacevic,D,NJD,27,43,4,3,7
24,8482744,James Malatesta,L,CBJ,21,40,3,4,7
24,8483630,Pavol Regenda,L,ANA,25,27,3,4,7
24,8482070,Mitchell Chaffee,R,TBL,26,42,2,5,7
24,8475762,Derek Forbort,D,VAN,32,36,2,5,7
24,8483570,Ben Meyers,C,SEA,26,25,2,5,7
24,8477335,Kyle Burroughs,D,LAK,29,37,1,6,7
24,8482964,Arber Xhekaj,D,MTL,23,43,1,6,7
24,8479348,Kale Clague,D,BUF,26,45,1,6,7
24,8479576,Vincent Desharnais,D,VAN,28,32,1,6,7
24,8484254,Akito Hirose,D,VAN,25,43,0,7,7
24,8475177,Calvin de Haan,D,COL,33,46,0,7,7
24,8477070,Liam O'Brien,C,UTA,30,48,4,2,6
24,8479994,Jaret Anderson-Dolan,C,WPG,25,38,4,2,6
24,8480844,Grigori Denisenko,L,VGK,24,40,4,2,6
24,8479638,Justin Brazeau,R,BOS,26,41,3,3,6
24,8482747,Brennan Othmann,L,NYR,21,38,3,3,6
24,8477887,Patrick Brown,C,BOS,32,38,3,3,6
24,8482144,Jack Thompson,D,SJS,22,28,3,3,6
24,8481592,Jakob Pelletier,L,CGY,23,45,2,4,6
24,8481609,Vladislav Kolyachonok,D,UTA,23,27,2,4,6
24,8479985,Cale Fleury,D,SEA,26,27,2,4,6
24,8481543,Nikita Alexandrov,C,STL,24,26,2,4,6
24,8479379,Givani Smith,R,SJS,26,29,2,4,6
24,8479587,Rhett Gardner,C,PHI,28,19,2,4,6
24,8480848,Ty Dellandrea,C,SJS,24,44,1,5,6
24,8478017,Mark Friedman,D,VAN,29,38,1,5,6
24,8479972,Mason Shaw,C,WPG,26,36,0,6,6
24,8482147,Jean-Luc Foudy,C,COL,22,30,4,1,5
24,8482733,Logan Mailloux,D,MTL,31,37,4,1,5
24,8477467,Gustav Olofsson,D,SEA,30,22,4,1,5
24,8480468,James Hamblin,L,EDM,25,26,4,1,5
24,8478409,Anthony Richard,C,PHI,28,31,3,2,5
24,8480245,Olle Lycksell,R,PHI,25,29,3,2,5
24,8483619,Filip Roos,D,OTT,25,37,3,2,5
24,8475958,Michael Sgarbossa,C,WSH,32,27,3,2,5
24,8484287,Cole McWard,D,VAN,23,17,3,2,5
24,8482861,Vincent Iorio,D,WSH,22,33,2,3,5
24,8482141,Lukas Cormier,D,VGK,22,26,2,3,5
24,8481556,John Beecher,C,BOS,23,34,2,3,5
24,8481030,Jack St. Ivany,D,PIT,25,13,2,3,5
24,8482713,Mackie Samoskevich,R,FLA,22,29,2,3,5
24,8480196,Jacob Bryson,D,BUF,27,41,1,4,5
24,8475718,Justin Holl,D,DET,32,59,1,4,5
24,8476473,Connor Murphy,D,CHI,31,41,1,4,5
24,8478146,Matthew Highmore,C,OTT,28,37,1,4,5
24,8473446,Erik Johnson,D,PHI,36,45,1,4,5
24,8480990,Declan Chisholm,D,MIN,24,36,1,4,5
24,8482751,Ryan Winterton,C,SEA,21,33,1,4,5
24,8476372,Nick Seeler,D,PHI,31,36,0,5,5
24,8482784,Zach Dean,C,STL,21,44,0,5,5
24,8482162,Roby Jarventie,L,EDM,22,19,0,5,5
24,8483397,Marc McLaughlin,C,BOS,25,31,4,0,4
24,8481206,John Ludvig,D,PIT,24,18,3,1,4
24,8478454,Noah Juulsen,D,VAN,27,40,2,2,4
24,8482511,Mason Lohrei,D,BOS,23,37,2,2,4
24,8480890,Jan Jenik,C,OTT,24,26,2,2,4
24,8477971,Andreas Englund,D,LAK,28,27,2,2,4
24,8478051,Max Willman,C,NJD,29,17,2,2,4
24,8481806,Louis Crevier,D,CHI,23,15,2,2,4
24,8480292,Carson Meyer,R,ANA,27,43,1,3,4
24,8482666,Scott Morrow,D,CAR,22,47,1,3,4
24,8476952,Dominic Toninato,C,WPG,30,31,1,3,4
24,8483012,Logan Morrison,C,SEA,22,38,1,3,4
24,8484911,Collin Graf,R,SJS,22,40,1,3,4
24,8482765,Isak Rosen,R,BUF,21,29,1,3,4
24,8477149,Scott Sabourin,R,SJS,32,20,1,3,4
24,8477527,Ross Johnston,L,ANA,30,26,0,4,4
24,8475750,Jon Merrill,D,MIN,32,66,0,4,4
24,8481056,Spencer Stastney,D,NSH,24,23,0,4,4
24,8479320,Maxime Lajoie,D,SEA,27,14,0,4,4
24,8481122,Simon Benoit,D,TOR,26,37,0,4,4
24,8482118,Sam Colangelo,R,ANA,23,13,0,4,4
24,8480084,Nick DeSimone,D,NJD,30,23,0,4,4
24,8481605,Jackson LaCombe,D,ANA,23,28,0,4,4
24,8480870,Bo Groulx,C,NYR,24,20,3,0,3
24,8484258,Sam Malinski,D,COL,26,27,2,1,3
24,8479362,Riley Tufte,L,BOS,26,17,2,1,3
24,8481719,Maxwell Crozier,D,TBL,24,19,2,1,3
24,8481754,Nikita Nesterenko,C,ANA,23,31,1,2,3
24,8479986,Kole Lind,R,DAL,26,52,1,2,3
24,8482250,Callahan Burke,C,VGK,27,27,1,2,3
24,8480267,Sammy Walker,C,MIN,25,23,1,2,3
24,8482172,Landon Slaggert,L,CHI,22,23,1,2,3
24,8478881,Brett Seney,L,CHI,28,17,1,2,3
24,8482858,Ryker Evans,D,SEA,23,22,1,2,3
24,8481743,Marc Del Gaizo,D,NSH,25,20,1,2,3
24,8481237,Kyle MacLean,C,NYI,25,19,1,2,3
24,8481699,Aku Raty,R,UTA,23,17,1,2,3
24,8478477,Mitchell Stephens,C,SEA,27,16,1,2,3
24,8479419,Brett Murray,L,BUF,26,21,1,2,3
24,8477462,Robert Hagg,D,VGK,29,23,0,3,3
24,8482470,Ilya Solovyov,D,CGY,24,16,0,3,3
24,8481422,Jake Lucchini,C,NSH,29,10,2,0,2
24,8483471,Brad Lambert,C,WPG,31,11,2,0,2
24,8481585,Egor Afanasyev,L,SJS,23,14,2,0,2
24,8481541,Samuel Bolduc,D,NYI,24,24,2,0,2
24,8477473,Justin Bailey,R,SJS,29,25,1,1,2
24,8478021,William Lagesson,D,DET,28,25,1,1,2
24,8482061,Brandon Biro,L,SEA,26,16,1,1,2
24,8477541,Dakota Mermis,D,TOR,30,15,1,1,2
24,8481065,Angus Crookshank,L,OTT,25,15,1,1,2
24,8483398,Declan Carlile,D,TBL,31,7,1,1,2
24,8480851,Akil Thomas,C,LAK,24,20,1,1,2
24,8481534,Raphael Lavoie,C,EDM,24,2,1,1,2
24,8483489,Fraser Minten,C,TOR,31,10,1,1,2
24,8481043,Cole Koepke,L,BOS,26,17,1,1,2
24,8483546,Marshall Rifai,D,TOR,26,5,1,1,2
24,8477384,Joshua Brown,D,EDM,30,38,0,2,2
24,8477244,Chad Ruhwedel,D,NYR,34,40,0,2,2
24,8482165,Yan Kuznetsov,D,CGY,22,20,0,2,2
24,8477810,Joel Hanley,D,CGY,33,26,0,2,2
24,8478450,Parker Wotherspoon,D,BOS,27,35,0,2,2
24,8482102,Vasily Ponomarev,C,PIT,22,17,0,2,2
24,8481593,Jayden Struble,D,MTL,23,17,0,2,2
24,8478502,Dennis Gilbert,D,BUF,28,15,0,2,2
24,8479367,William Lockwood,R,FLA,26,25,1,0,1
24,8482088,Justin Sourdif,R,FLA,22,20,1,0,1
24,8482201,Gage Goncalves,C,TBL,23,23,1,0,1
24,8482094,Daemon Hunt,D,MIN,22,15,1,0,1
24,8481024,Linus Karlsson,C,VAN,25,8,1,0,1
24,8476323,Max McCormick,L,SEA,32,5,1,0,1
24,8477320,Anton Blidh,L,NYR,29,13,0,1,1
24,8477073,Kurtis MacDermid,L,NJD,30,24,0,1,1
24,8482177,Marat Khusnutdinov,C,MIN,22,30,0,1,1
24,8484325,Waltteri Merela,C,TBL,26,22,0,1,1
24,8477993,Justin Kirkland,C,CGY,28,6,0,1,1
24,8479522,Hardy Haman Aktell,D,WSH,26,6,0,1,1
24,8478147,Bokondji Imama,L,PIT,28,7,0,1,1
24,8484304,Uvis Balinskis,D,FLA,28,9,0,1,1
24,8478446,Glenn Gawdin,C,LAK,27,10,0,1,1
24,8481655,Cole Schwindt,R,CGY,23,11,0,1,1
24,8483512,Matthew Savoie,C,EDM,20,15,0,1,1
24,8480874,Adam Ginning,D,PHI,24,15,0,1,1
24,8483407,Brandon Scanlin,D,NYR,25,6,0,1,1
24,8482460,Matt Rempe,C,NYR,22,16,0,1,1
24,8484259,Ondrej Pavel,C,COL,31,5,0,1,1
24,8479991,Jake Leschyshyn,C,NYR,25,19,0,0,0
24,8482929,Emil Lilleberg,D,TBL,23,20,0,0,0
24,8475795,Dylan McIlrath,D,WSH,32,17,0,0,0
24,8483597,Milos Kelemen,L,UTA,25,13,0,0,0
24,8482476,Emil Heineman,L,MTL,23,7,0,0,0
24,8474062,Riley Nash,C,NYR,35,10,0,0,0
24,8475413,Justin Dowling,C,NJD,34,10,0,0,0
24,8481726,Adam Edstrom,C,NYR,24,8,0,0,0
24,8480032,Shane Bowers,C,NJD,25,19,0,0,0
24,8479330,Brandon Gignac,C,MTL,27,15,0,0,0
24,8480306,Grant Hutton,D,NYI,29,6,0,0,0
24,8481564,Ryan Johnson,D,BUF,23,11,0,0,0
24,8475755,Alexander Petrovic,D,DAL,32,8,0,0,0
24,8478854,Ryan Shea,D,PIT,27,6,0,0,0
24,8481462,Mason Morelli,L,VGK,28,10,0,0,0
24,8482516,Matthew Kessel,D,STL,24,16,0,0,0
24,8484326,Patrik Koch,D,UTA,28,4,0,0,0
24,8478011,Louie Belpedio,D,PHI,28,12,0,0,0
24,8483531,Brian Halonen,L,NJD,25,0,0,0,0
24,8480075,Cameron Crotty,D,MIN,25,12,0,0,0
24,8480823,Alexander Alexeyev,D,WSH,25,10,0,0,0
24,8482197,Adam Raska,R,MIN,23,9,0,0,0
24,8483395,Arshdeep Bains,L,VAN,23,11,0,0,0
24,8481006,Tyler Tucker,D,STL,24,11,0,0,0
24,8481578,Graeme Clarke,R,MIN,23,5,0,0,0
24,8483609,Adam Klapka,R,CGY,24,1,0,0,0
24,8484255,Jason Polin,R,COL,25,5,0,0,0
24,8483567,Georgii Merkulov,C,BOS,24,7,0,0,0
24,8482126,Emil Andrae,D,PHI,31,1,0,0,0
24,8478956,Samuel Laberge,L,NJD,27,1,0,0,0
24,8482787,Nikita Chibrikov,R,WPG,31,6,0,0,0
24,8483920,Pierrick Dube,R,WSH,23,4,0,0,0
24,8479421,Jacob Moverare,D,LAK,26,3,0,0,0
24,8475780,Chris Wagner,R,COL,33,6,0,0,0
24,8483432,Luca Del Bel Belluz,C,CBJ,31,7,0,0,0
24,8483401,Marc Johnstone,R,PIT,28,6,0,0,0
24,8484321,Nikolas Matinpalo,D,OTT,26,0,0,0,0
24,8470794,Joe Pavelski,C,,40,0,0,0,0
24,8479321,Lucas Johansen,D,,27,0,0,0,0
24,8477950,Tony DeAngelo,D,,29,0,0,0,0
24,8471218,Blake Wheeler,R,,38,0,0,0,0
24,8475197,Tyson Barrie,D,,33,0,0,0,0
24,8474157,Max Pacioretty,L,,36,0,0,0,0
24,8475744,Evgeny Kuznetsov,C,,32,0,0,0,0
24,8474037,James van Riemsdyk,L,,35,0,0,0,0
24,8476907,Mackenzie MacEachern,L,,30,0,0,0,0
24,8480216,Jacob Peterson,C,,25,0,0,0,0
24,8474602,Justin Schultz,D,,34,0,0,0,0
24,8482222,Alexander Barabanov,L,,30,0,0,0,0
24,8474031,Kevin Shattenkirk,D,,35,0,0,0,0
24,8477330,Dominik Kubalik,L,,29,0,0,0,0
24,8480884,Calen Addison,D,,24,0,0,0,0
24,8475906,John Klingberg,D,,32,0,0,0,0
24,8480008,Adam Ruzicka,C,,25,0,0,0,0
24,8476884,Derrick Pouliot,D,,30,0,0,0,0
24,8476919,Chris Tierney,C,,30,0,0,0,0
24,8479415,Michael McLeod,C,,26,0,0,0,0
24,8474870,Tyler Johnson,C,,34,0,0,0,0
24,8470604,Jeff Carter,C,,39,0,0,0,0
24,8478104,Sammy Blais,L,,28,0,0,0,0
24,8474884,Mike Hoffman,C,,35,0,0,0,0
24,8481591,Sam Poulin,R,,23,0,0,0,0
24,8471274,Alex Goligoski,D,,39,0,0,0,0
24,8476871,Tanner Pearson,L,,32,0,0,0,0
24,8476393,Nick Cousins,C,,31,0,0,0,0
24,8479977,Kailer Yamamoto,R,,26,0,0,0,0
24,8479346,Dillon Dube,C,,26,0,0,0,0
24,8480184,Gustav Lindstrom,D,,26,0,0,0,0
24,8479376,Victor Mete,D,,26,0,0,0,0
24,8473449,Kyle Okposo,R,,36,0,0,0,0
24,8481058,Jesse Ylonen,R,,25,0,0,0,0
24,8475752,Tyler Pitlick,C,,33,0,0,0,0
24,8481239,Samuel Fagemo,L,,24,0,0,0,0
24,8480821,Filip Zadina,R,,25,0,0,0,0
24,8470966,Mark Giordano,D,,41,0,0,0,0
24,8478495,Denis Gurianov,R,,27,0,0,0,0
24,8477464,Nic Petan,C,,29,0,0,0,0
24,8478099,Kevin Labanc,R,,29,0,0,0,0
24,8482241,Radim Zohorna,L,,28,0,0,0,0
24,8474040,Sam Gagner,C,,35,0,0,0,0
24,8479514,Rem Pitlick,C,,27,0,0,0,0
24,8478430,Oliver Kylington,D,,27,0,0,0,0
24,8479533,Joona Koppanen,L,,26,0,0,0,0
24,8479984,Cal Foote,D,,26,0,0,0,0
24,8477126,Jayson Megna,C,,34,0,0,0,0
24,8475164,Jakob Silfverberg,R,,34,0,0,0,0
24,8474009,Nick Bonino,C,,36,0,0,0,0
24,8479458,Nikita Zaitsev,D,,33,0,0,0,0
24,8477944,Jakub Vrana,L,,28,0,0,0,0
24,8471699,Andrew Cogliano,C,,37,0,0,0,0
24,8478067,Oskar Lindblom,L,,28,0,0,0,0
24,8471686,Marc Staal,D,,37,0,0,0,0
24,8470610,Zach Parise,L,,40,0,0,0,0
24,8478904,Steven Lorentz,C,,28,0,0,0,0
24,8473473,Milan Lucic,L,,36,0,0,0,0
24,8480031,Maxime Comtois,L,,25,0,0,0,0
24,8478512,Austin Czarnik,C,,32,0,0,0,0
24,8473504,Cal Clutterbuck,R,,37,0,0,0,0
24,8477454,Adam Erne,L,,29,0,0,0,0
24,8479383,Boris Katchouk,L,,26,0,0,0,0
24,8475825,Jani Hakanpää,D,,32,0,0,0,0
24,8477846,Ryan Carpenter,C,,33,0,0,0,0
24,8477930,Pierre-Edouard Bellemare,L,,39,0,0,0,0
24,8478400,Colin White,C,,27,0,0,0,0
24,8480226,Marián Studenic,R,,26,0,0,0,0
24,8480853,Liam Foudy,C,,24,0,0,0,0
24,8475797,Jarred Tinordi,D,,32,0,0,0,0
24,8479423,Alex Nylander,L,,26,0,0,0,0
24,8474618,Marco Scandella,D,,34,0,0,0,0
24,8478028,Fredrik Olofsson,L,,28,0,0,0,0
24,8474709,Matt Martin,L,,35,0,0,0,0
24,8481070,Hugh McGing,L,,26,0,0,0,0
24,8479546,Oskar Steen,C,,26,0,0,0,0
24,8474145,Robert Bortuzzo,D,,35,0,0,0,0
24,8476915,Jujhar Khaira,L,,30,0,0,0,0
24,8480274,Philip Kemp,D,EDM,25,2,0,0,0
24,8475278,Byron Froese,C,,33,0,0,0,0
24,8481812,Nikolai Knyzhov,D,,27,0,0,0,0
24,8478408,Travis Dermott,D,,28,0,0,0,0
24,8481077,John Leonard,L,,26,0,0,0,0
24,8479547,Matthew Phillips,R,,26,0,0,0,0
24,8480836,Jonathan Gruden,C,,24,0,0,0,0
24,8481690,Tyler Angle,C,,24,0,0,0,0
24,8475766,Austin Watson,L,,32,0,0,0,0
24,8481016,Ruslan Iskhakov,C,,24,0,0,0,0
24,8478078,Rourke Chartier,C,,28,0,0,0,0
24,8480776,Sheldon Rempal,R,,29,0,0,0,0
24,8483045,Cameron Butler,R,CBJ,31,0,0,0,0
24,8484314,Jiri Smejkal,L,,28,0,0,0,0
25,8477492,Nathan MacKinnon,C,COL,29,82,62,79,141
25,8476453,Nikita Kucherov,R,TBL,31,82,50,89,139
25,8478402,Connor McDavid,C,EDM,27,77,40,94,134
25,8478420,Mikko Rantanen,R,COL,28,82,60,69,129
25,8477934,Leon Draisaitl,C,EDM,29,79,55,71,126
25,8471675,Sidney Crosby,C,PIT,37,76,52,61,113
25,8477956,David Pastrnak,R,BOS,28,81,49,64,113
25,8478445,Mathew Barzal,C,NYI,27,79,27,86,113
25,8479318,Auston Matthews,C,TOR,27,77,60,52,112
25,8478483,Mitch Marner,R,TOR,27,78,38,74,112
25,8477493,Aleksander Barkov,C,FLA,29,80,32,73,105
25,8478010,Brayden Point,C,TBL,28,82,52,52,104
25,8476887,Filip Forsberg,L,NSH,30,75,49,52,101
25,8479314,Matthew Tkachuk,L,FLA,27,79,32,69,101
25,8477939,William Nylander,R,TOR,28,79,45,55,100
25,8480012,Elias Pettersson,C,VAN,26,75,36,64,100
25,8481559,Jack Hughes,C,NJD,23,71,32,68,100
25,8478550,Artemi Panarin,L,NYR,33,74,35,61,96
25,8477933,Sam Reinhart,C,FLA,29,79,50,45,95
25,8477946,Dylan Larkin,C,DET,28,80,35,60,95
25,8478864,Kirill Kaprizov,L,MIN,27,71,42,52,94
25,8480027,Jason Robertson,L,DAL,25,82,36,56,92
25,8478398,Kyle Connor,L,WPG,28,74,44,47,91
25,8480023,Robert Thomas,C,STL,25,75,23,68,91
25,8480800,Quinn Hughes,D,VAN,25,76,13,78,91
25,8480801,Brady Tkachuk,L,OTT,25,81,39,51,90
25,8474564,Steven Stamkos,C,NSH,34,75,36,54,90
25,8475754,Brock Nelson,C,NYI,33,79,46,43,89
25,8476454,Ryan Nugent-Hopkins,C,EDM,31,78,28,61,89
25,8479343,Clayton Keller,R,UTA,26,78,37,49,86
25,8478427,Sebastian Aho,C,CAR,27,69,37,49,86
25,8477404,Jake Guentzel,C,TBL,30,81,33,53,86
25,8476468,J.T. Miller,C,VAN,31,73,24,61,85
25,8479407,Jesper Bratt,L,NJD,26,74,36,48,84
25,8474141,Patrick Kane,R,DET,36,80,31,53,84
25,8482116,Tim Stützle,C,OTT,22,82,27,56,83
25,8475765,Vladimir Tarasenko,R,DET,33,78,34,47,81
25,8475810,Bryan Rust,R,PIT,32,74,29,52,81
25,8471215,Evgeni Malkin,C,PIT,38,70,27,54,81
25,8474600,Roman Josi,D,NSH,34,75,15,66,81
25,8475692,Mats Zuccarello,R,MIN,37,72,21,59,80
25,8476539,Jonathan Marchessault,R,NSH,34,73,42,36,78
25,8476389,Vincent Trocheck,C,NYR,31,76,32,46,78
25,8477960,Adrian Kempe,R,LAK,28,81,32,46,78
25,8471214,Alex Ovechkin,L,WSH,39,73,37,40,77
25,8477409,Carter Verhaeghe,C,FLA,29,78,36,41,77
25,8477942,Kevin Fiala,L,LAK,28,82,35,42,77
25,8477501,Valeri Nichushkin,R,COL,29,81,29,48,77
25,8480865,Noah Dobson,D,NYI,24,80,11,66,77
25,8478403,Jack Eichel,C,VGK,28,80,32,44,76
25,8480208,Drake Batherson,R,OTT,26,80,26,49,75
25,8480002,Nico Hischier,C,NJD,25,76,25,50,75
25,8479323,Adam Fox,D,NYR,26,76,15,60,75
25,8479337,Alex DeBrincat,R,DET,27,79,33,41,74
25,8477476,Artturi Lehkonen,L,COL,29,80,31,43,74
25,8471685,Anze Kopitar,C,LAK,37,81,24,50,74
25,8475166,John Tavares,C,TOR,34,82,33,40,73
25,8475913,Mark Stone,R,VGK,32,78,23,50,73
25,8477949,Alex Tuch,R,BUF,28,78,20,53,73
25,8480830,Andrei Svechnikov,R,CAR,24,70,34,38,72
25,8477402,Pavel Buchnevich,L,STL,29,76,33,39,72
25,8478047,Michael Bunting,L,PIT,29,72,30,41,71
25,8474679,Gustav Nyquist,C,NSH,35,78,29,42,71
25,8476456,Jonathan Huberdeau,C,CGY,31,81,20,51,71
25,8480069,Cale Makar,D,COL,26,66,19,52,71
25,8476448,William Karlsson,C,VGK,31,78,31,39,70
25,8477940,Nikolaj Ehlers,L,WPG,28,71,27,43,70
25,8477496,Elias Lindholm,C,BOS,30,81,24,46,70
25,8480036,Miro Heiskanen,D,DAL,25,79,18,52,70
25,8484144,Connor Bedard,C,CHI,19,65,24,45,69
25,8478449,Roope Hintz,C,DAL,28,80,36,32,68
25,8481557,Matt Boldy,L,MIN,23,73,28,40,68
25,8477951,Nick Schmaltz,C,UTA,28,75,20,48,68
25,8482684,Luke Hughes,D,NJD,21,71,12,56,68
25,8478439,Travis Konecny,R,PHI,27,77,27,40,67
25,8479542,Brandon Hagel,L,TBL,26,82,31,35,66
25,8482740,Wyatt Johnston,C,DAL,21,82,30,36,66
25,8482078,Lucas Raymond,L,DET,22,79,28,38,66
25,8475784,Jeff Skinner,C,EDM,32,78,26,40,66
25,8475172,Nazem Kadri,C,CGY,34,75,22,44,66
25,8476459,Mika Zibanejad,C,NYR,31,79,21,45,66
25,8474150,Mikael Backlund,C,CGY,35,76,20,46,66
25,8473419,Brad Marchand,L,BOS,36,80,18,48,66
25,8481528,Dylan Cozens,C,BUF,23,72,32,33,65
25,8478414,Timo Meier,R,NJD,28,77,30,35,65
25,8479385,Jordan Kyrou,C,STL,26,73,26,39,65
25,8476881,Tomas Hertl,C,VGK,31,73,24,41,65
25,8474578,Erik Karlsson,D,PIT,34,78,16,49,65
25,8476346,Johnny Gaudreau,L,CBJ,31,73,13,52,65
25,8475786,Zach Hyman,L,EDM,32,80,39,25,64
25,8477935,Sam Bennett,C,FLA,28,79,31,33,64
25,8482699,Dylan Guenther,R,UTA,21,73,26,38,64
25,8477444,Andre Burakovsky,L,SEA,29,73,21,43,64
25,8477447,Shea Theodore,D,VGK,29,60,12,51,63
25,8478397,Rasmus Andersson,D,CGY,28,77,12,50,62
25,8478493,Joel Eriksson Ek,C,MIN,27,70,32,29,61
25,8475168,Matt Duchene,C,DAL,33,81,27,34,61
25,8479999,Casey Mittelstadt,C,COL,26,81,22,39,61
25,8478401,Pavel Zacha,C,BOS,27,77,19,42,61
25,8478460,Zach Werenski,D,CBJ,27,81,8,53,61
25,8477500,Bo Horvat,C,NYI,29,78,25,35,60
25,8475158,Ryan O'Reilly,C,NSH,33,74,18,42,60
25,8471724,Kris Letang,D,PIT,37,80,15,45,60
25,8477504,Josh Morrissey,D,WPG,29,74,12,48,60
25,8475794,Tyler Seguin,C,DAL,32,81,28,31,59
25,8475745,Charlie Coyle,C,BOS,32,78,24,35,59
25,8476483,Rickard Rakell,R,PIT,31,66,24,35,59
25,8473986,Alex Killorn,L,ANA,35,74,24,35,59
25,8478444,Brock Boeser,R,VAN,27,71,23,36,59
25,8478975,Mason Marchment,L,DAL,29,82,23,36,59
25,8477986,Brandon Montour,D,SEA,30,74,20,39,59
25,8483515,Juraj Slafkovsky,L,MTL,20,75,27,31,58
25,8476460,Mark Scheifele,C,WPG,31,74,25,33,58
25,8477494,Jonathan Drouin,L,COL,29,82,21,37,58
25,8478440,Dylan Strome,C,WSH,27,72,20,38,58
25,8475167,Victor Hedman,D,TBL,34,81,12,46,58
25,8476853,Morgan Rielly,D,TOR,30,67,9,49,58
25,8477407,Anthony Duclair,L,NYI,29,81,35,22,57
25,8479420,Tage Thompson,C,BUF,27,70,28,29,57
25,8478519,Anthony Cirelli,C,TBL,27,82,23,34,57
25,8476826,Yanni Gourde,C,SEA,33,78,23,34,57
25,8478856,Conor Garland,R,VAN,28,74,21,36,57
25,8480839,Rasmus Dahlin,D,BUF,24,64,17,40,57
25,8475184,Chris Kreider,L,NYR,33,74,36,20,56
25,8479675,Trevor Moore,L,LAK,29,80,27,29,56
25,8481533,Trevor Zegras,C,ANA,23,74,27,29,56
25,8482745,Mason McTavish,C,ANA,21,71,26,30,56
25,8482093,Seth Jarvis,C,CAR,22,71,26,30,56
25,8478873,Troy Terry,R,ANA,27,71,20,36,56
25,8477497,Sean Monahan,C,CBJ,30,72,19,37,56
25,8480803,Evan Bouchard,D,EDM,25,76,15,41,56
25,8478038,Devon Toews,D,COL,30,73,7,49,56
25,8481540,Cole Caufield,R,MTL,23,74,26,29,55
25,8482113,Anton Lundell,C,FLA,23,76,23,32,55
25,8475151,Kyle Palmieri,C,NYI,33,79,23,32,55
25,8474590,John Carlson,D,WSH,34,72,12,43,55
25,8482124,Quinton Byfield,R,LAK,22,79,21,33,54
25,8473512,Claude Giroux,R,OTT,36,80,17,37,54
25,8476292,Ondrej Palat,L,NJD,33,73,17,37,54
25,8479325,Charlie McAvoy,D,BOS,27,74,15,39,54
25,8478396,Noah Hanifin,D,VGK,27,56,11,43,54
25,8476399,Blake Coleman,C,CGY,33,76,22,31,53
25,8473994,Jamie Benn,L,DAL,35,81,19,34,53
25,8481711,Matias Maccelli,L,UTA,24,76,18,35,53
25,8480018,Nick Suzuki,C,MTL,25,74,17,36,53
25,8484166,Adam Fantilli,C,CBJ,20,67,28,24,52
25,8471698,T.J. Oshie,R,WSH,38,74,25,27,52
25,8474586,Jordan Eberle,R,SEA,34,75,23,29,52
25,8482109,Alexis Lafrenière,L,NYR,23,71,22,30,52
25,8476882,Teuvo Teravainen,C,CHI,30,65,20,32,52
25,8477955,Jared McCann,L,SEA,28,76,26,25,51
25,8479339,Patrik Laine,L,CBJ,26,66,24,27,51
25,8477456,J.T. Compher,L,DET,29,81,23,28,51
25,8477998,Warren Foegele,L,LAK,28,82,23,28,51
25,8474102,David Perron,L,OTT,36,77,20,31,51
25,8479400,Pierre-Luc Dubois,L,WSH,26,67,17,34,51
25,8478366,Frank Vatrano,R,ANA,30,69,24,26,50
25,8475169,Evander Kane,L,EDM,33,72,21,29,50
25,8477416,Oliver Bjorkstrand,R,SEA,29,72,19,31,50
25,8476419,Jean-Gabriel Pageau,C,NYI,32,78,16,34,50
25,8478407,Vince Dunn,D,SEA,28,73,11,39,50
25,8476792,Torey Krug,D,STL,33,79,8,42,50
25,8479525,Ross Colton,C,COL,28,80,31,18,49
25,8481068,Yegor Sharangovich,C,CGY,26,78,23,26,49
25,8484153,Leo Carlsson,C,ANA,20,65,16,33,49
25,8476906,Shayne Gostisbehere,D,CAR,31,77,13,36,49
25,8482712,Oskar Olausson,R,COL,22,78,11,38,49
25,8477964,Ivan Barbashev,C,VGK,29,74,26,22,48
25,8475799,Nino Niederreiter,R,WPG,32,74,25,23,48
25,8480014,Gabriel Vilardi,C,WPG,25,66,24,24,48
25,8478462,Nicolas Roy,C,VGK,27,79,22,26,48
25,8484145,Zach Benson,L,BUF,19,66,21,27,48
25,8475798,Mikael Granlund,C,SJS,32,67,19,29,48
25,8480188,Fabian Zetterlund,L,SJS,25,65,16,32,48
25,8478542,Evan Rodrigues,C,FLA,31,75,14,34,48
25,8477495,Seth Jones,D,CHI,30,67,12,36,48
25,8480015,Owen Tippett,R,PHI,25,72,24,23,47
25,8478469,Thomas Chabot,D,OTT,27,76,18,29,47
25,8475753,Justin Faulk,D,STL,32,70,16,31,47
25,8475768,Jaden Schwartz,C,SEA,32,70,13,34,47
25,8476875,Mike Matheson,D,MTL,30,75,10,37,47
25,8477346,MacKenzie Weegar,D,CGY,30,75,9,38,47
25,8479425,Filip Hronek,D,VAN,27,77,8,39,47
25,8482665,Matty Beniers,C,SEA,22,74,24,22,46
25,8478498,Jake DeBrusk,L,VAN,28,70,23,23,46
25,8483808,Andrei Kuzmenko,L,CGY,28,76,23,23,46
25,8476880,Tom Wilson,R,WSH,30,70,19,27,46
25,8475191,Reilly Smith,R,NYR,33,75,19,27,46
25,8474565,Alex Pietrangelo,D,VGK,34,65,7,39,46
25,8479365,Trent Frederic,C,BOS,26,79,25,20,45
25,8476432,Boone Jenner,C,CBJ,31,64,24,21,45
25,8475314,Anders Lee,L,NYI,34,76,22,23,45
25,8479992,Michael Rasmussen,C,DET,25,78,22,23,45
25,8482720,Matthew Knies,L,TOR,22,74,18,27,45
25,8477503,Max Domi,C,TOR,29,74,16,29,45
25,8474149,Evgenii Dadonov,R,DAL,35,79,16,29,45
25,8481542,Moritz Seider,D,DET,23,74,8,37,45
25,8481604,Pavel Dorofeyev,L,VGK,24,70,25,19,44
25,8480009,Eeli Tolvanen,R,SEA,25,74,20,24,44
25,8477451,Ryan Hartman,R,MIN,30,65,18,26,44
25,8476905,Chandler Stephenson,C,SEA,30,73,16,28,44
25,8482149,Cole Perfetti,C,WPG,22,68,16,28,44
25,8480798,Philipp Kurashev,C,CHI,25,70,12,32,44
25,8478466,Daniel Sprong,R,VAN,27,67,25,18,43
25,8475170,Brayden Schenn,C,STL,33,74,24,19,43
25,8474641,Adam Henrique,C,EDM,34,79,16,27,43
25,8480797,Joel Farabee,L,PHI,24,77,15,28,43
25,8476479,Phillip Danault,C,LAK,31,78,10,33,43
25,8476958,Jaccob Slavin,D,CAR,30,71,10,33,43
25,8475764,Cam Fowler,D,ANA,33,69,7,36,43
25,8476438,Brandon Saad,L,STL,32,73,27,15,42
25,8477953,Kasperi Kapanen,R,STL,28,67,21,21,42
25,8476462,Dougie Hamilton,D,NJD,31,70,19,23,42
25,8482097,Jack Quinn,R,BUF,23,61,16,26,42
25,8481596,Shane Pinto,C,OTT,24,77,16,26,42
25,8477429,Andrew Copp,C,DET,30,78,15,27,42
25,8475149,Marcus Johansson,L,MIN,34,67,13,29,42
25,8476458,Ryan Strome,C,ANA,31,70,8,34,42
25,8481560,Arthur Kaliyev,R,LAK,23,79,25,16,41
25,8475793,Ryan Johansen,C,PHI,32,71,23,18,41
25,8475287,Erik Haula,L,NJD,33,71,21,20,41
25,8478474,Lawson Crouse,L,UTA,27,73,20,21,41
25,8478233,Andrew Mangiapane,L,WSH,28,67,18,23,41
25,8481618,Alex Newhook,C,MTL,23,67,15,26,41
25,8475726,Tyler Toffoli,C,SJS,32,72,13,28,41
25,8477021,Alex Kerfoot,C,UTA,30,72,13,28,41
25,8480039,Martin Necas,C,CAR,25,73,11,30,41
25,8478472,Mathieu Joseph,R,STL,27,68,9,32,41
25,8477498,Darnell Nurse,D,EDM,29,74,9,32,41
25,8476854,Hampus Lindholm,D,BOS,30,76,6,35,41
25,8476979,Erik Gustafsson,D,DET,32,77,3,38,41
25,8482159,Tyson Foerster,R,PHI,22,79,21,19,40
25,8483431,Logan Cooley,C,UTA,20,75,18,22,40
25,8476927,Teddy Blueger,C,VAN,30,67,15,25,40
25,8479591,Michael Eyssimont,C,TBL,28,81,13,27,40
25,8479410,Mikhail Sergachev,D,UTA,26,68,8,32,40
25,8475722,Jason Zucker,L,BUF,32,65,21,18,39
25,8474715,Cameron Atkinson,R,TBL,35,79,17,22,39
25,8482055,Drew O'Connor,L,PIT,26,68,16,23,39
25,8477987,Ryan Donato,C,CHI,28,60,16,23,39
25,8480434,Sean Durzi,D,UTA,26,69,13,26,39
25,8479345,Jakob Chychrun,D,WSH,26,68,12,27,39
25,8477479,Tyler Bertuzzi,L,CHI,29,65,12,27,39
25,8481581,Thomas Harley,D,DAL,23,76,11,28,39
25,8474563,Drew Doughty,D,LAK,35,73,5,34,39
25,8480113,Alex Iafallo,L,WPG,31,66,25,13,38
25,8481554,Kaapo Kakko,R,NYR,23,69,19,19,38
25,8478115,Pierre Engvall,L,NYI,28,79,18,20,38
25,8481582,Nicholas Robertson,L,TOR,23,70,16,22,38
25,8481577,Philip Tomasino,C,NSH,23,66,15,23,38
25,8480336,Sean Walker,D,CAR,30,79,14,24,38
25,8477948,Travis Sanheim,D,PHI,28,70,2,36,38
25,8478046,Danton Heinen,L,VAN,29,74,20,17,37
25,8480893,Kirill Marchenko,R,CBJ,24,67,19,18,37
25,8480855,Jack McBain,C,UTA,24,72,13,24,37
25,8470613,Brent Burns,D,CAR,39,77,7,30,37
25,8473422,Nick Foligno,L,CHI,37,62,25,11,36
25,8482475,Yegor Chinakhov,R,CBJ,23,64,22,14,36
25,8482110,Dawson Mercer,C,NJD,23,69,19,17,36
25,8478463,Anthony Beauvillier,L,PIT,27,70,18,18,36
25,8477989,Christian Dvorak,C,MTL,28,65,15,21,36
25,8475193,Tomas Tatar,L,NJD,34,70,10,26,36
25,8481523,Kirby Dach,C,MTL,23,71,9,27,36
25,8481703,Valtteri Puustinen,R,PIT,25,65,8,28,36
25,8476869,Brady Skjei,D,NSH,30,72,7,29,36
25,8481606,Jordan Spence,D,LAK,23,66,7,29,36
25,8480849,Barrett Hayton,C,UTA,24,68,17,18,35
25,8475763,Kevin Hayes,R,PIT,32,66,15,20,35
25,8475714,Calle Jarnkrok,C,TOR,33,72,15,20,35
25,8476474,Stefan Noesen,R,NJD,31,62,14,21,35
25,8480078,Filip Chytil,C,NYR,25,68,13,22,35
25,8475855,Jesper Fast,R,CAR,33,60,13,22,35
25,8480817,K'Andre Miller,D,NYR,24,77,11,24,35
25,8478438,Tommy Novak,C,NSH,27,64,9,26,35
25,8477932,Aaron Ekblad,D,FLA,28,71,7,28,35
25,8475218,Mattias Ekholm,D,EDM,34,67,7,28,35
25,8482671,Owen Power,D,BUF,22,70,4,31,35
25,8476981,Josh Anderson,R,MTL,30,70,21,13,34
25,8480064,Josh Norris,C,OTT,25,76,19,15,34
25,8477511,Anthony Mantha,R,CGY,30,73,15,19,34
25,8480028,Morgan Frost,C,PHI,25,74,15,19,34
25,8482667,William Eklund,L,SJS,22,70,13,21,34
25,8482702,Logan Stankoven,C,DAL,21,78,9,25,34
25,8478055,Gustav Forsling,D,FLA,28,71,8,26,34
25,8480185,Eetu Luostarinen,C,FLA,26,69,8,26,34
25,8480145,Neal Pionk,D,WPG,29,69,7,27,34
25,8477506,Ryan Pulock,D,NYI,30,78,3,31,34
25,8482175,JJ Peterka,R,BUF,22,68,18,15,33
25,8480748,Kiefer Sherwood,L,VAN,29,61,18,15,33
25,8479987,Morgan Geekie,C,BOS,26,79,16,17,33
25,8479393,Noah Gregor,L,OTT,26,72,15,18,33
25,8480829,Jesperi Kotkaniemi,C,CAR,24,66,15,18,33
25,8475791,Taylor Hall,L,CHI,33,58,15,18,33
25,8479353,Brett Howden,C,VGK,26,67,15,18,33
25,8474716,Jared Spurgeon,D,MIN,35,78,14,19,33
25,8476885,Jacob Trouba,D,NYR,30,70,9,24,33
25,8481546,Cam York,D,PHI,23,68,9,24,33
25,8483490,Pavel Mintyukov,D,ANA,21,70,7,26,33
25,8476891,Matthew Grzelcyk,D,PIT,30,72,6,27,33
25,8481535,Nils Hoglander,L,VAN,24,69,19,13,32
25,8476392,Adam Lowry,C,WPG,31,68,17,15,32
25,8478109,Victor Olofsson,L,VGK,29,70,15,17,32
25,8481524,Bowen Byram,D,BUF,23,61,14,18,32
25,8476480,Vladislav Namestnikov,C,WPG,32,65,14,18,32
25,8480871,Adam Boqvist,D,FLA,24,66,12,20,32
25,8477839,Conor Sheary,L,TBL,32,81,11,21,32
25,8477425,Miles Wood,L,COL,29,77,23,8,31
25,8475760,Nick Bjugstad,C,UTA,32,73,16,15,31
25,8470621,Corey Perry,R,EDM,39,72,16,15,31
25,8482092,Ridly Greig,C,OTT,22,74,14,17,31
25,8480459,Pius Suter,C,VAN,28,71,13,18,31
25,8478042,Viktor Arvidsson,L,EDM,31,72,12,19,31
25,8483491,Ivan Miroshnichenko,L,WSH,20,63,12,19,31
25,8475200,Dmitry Orlov,D,CAR,33,74,9,22,31
25,8482122,Brock Faber,D,MIN,22,78,3,28,31
25,8482655,Janis Moser,D,TBL,24,78,2,29,31
25,8478057,Dakota Joshua,C,VAN,28,65,17,13,30
25,8477952,Robby Fabbri,C,ANA,28,65,17,13,30
25,8482624,Daniil Miromanov,D,CGY,27,64,14,16,30
25,8480802,Ryan McLeod,C,BUF,25,64,11,19,30
25,8475848,Brendan Gallagher,R,MTL,32,71,11,19,30
25,8476872,Scott Laughton,C,PHI,30,71,11,19,30
25,8478432,Christian Fischer,R,DET,27,74,11,19,30
25,8483505,Matthew Poitras,C,BOS,20,76,9,21,30
25,8476917,Adam Pelech,D,NYI,30,77,8,22,30
25,8476923,Damon Severson,D,CBJ,30,78,6,24,30
25,8478851,Alexandre Carrier,D,NSH,28,67,5,25,30
25,8480873,Rasmus Sandin,D,WSH,24,58,3,27,30
25,8481032,Paul Cotter,C,NJD,25,60,22,7,29
25,8476278,Colin Blackwell,C,DAL,31,76,19,10,29
25,8480813,Joe Veleno,C,DET,24,78,17,12,29
25,8482749,Joshua Roy,R,MTL,21,63,14,15,29
25,8477426,Nicholas Paul,L,TBL,29,80,13,16,29
25,8476469,Joel Armia,R,MTL,31,64,12,17,29
25,8478413,Jordan Greenway,L,BUF,27,54,11,18,29
25,8478891,Mason Appleton,C,WPG,28,63,10,19,29
25,8476897,Oskar Sundqvist,C,STL,30,65,10,19,29
25,8479402,Jake Bean,D,CGY,26,67,9,20,29
25,8477969,Marcus Pettersson,D,PIT,28,77,3,26,29
25,8477435,Ryan Graves,D,PIT,29,77,3,26,29
25,8479398,Samuel Girard,D,COL,26,63,2,27,29
25,8478020,Michael Amadio,R,OTT,28,71,16,12,28
25,8484203,Bradly Nadeau,L,CAR,19,65,11,17,28
25,8480806,Isac Lundestrom,C,ANA,25,60,10,18,28
25,8477507,Nikita Zadorov,D,BOS,29,73,10,18,28
25,8474151,Ryan McDonagh,D,TBL,35,78,4,24,28
25,8476902,Esa Lindell,D,DAL,30,74,3,25,28
25,8482089,Jake Neighbours,L,STL,22,62,19,8,27
25,8474189,Lars Eller,C,PIT,35,58,17,10,27
25,8482705,Cole Sillinger,C,CBJ,21,63,14,13,27
25,8482146,Luke Evangelista,R,NSH,22,65,13,14,27
25,8481186,Logan O'Connor,R,COL,28,80,13,14,27
25,8476925,Colton Sissons,C,NSH,31,69,9,18,27
25,8478013,Jake Walman,D,SJS,28,70,8,19,27
25,8482111,Justin Barron,D,MTL,23,66,7,20,27
25,8474053,Logan Couture,C,SJS,35,64,17,9,26
25,8479390,Taylor Raddysh,R,WSH,26,67,16,10,26
25,8482157,Will Cuylle,L,NYR,22,63,14,12,26
25,8479066,Ryan Lomberg,L,CGY,30,62,14,12,26
25,8483468,Jiri Kulich,C,BUF,20,53,13,13,26
25,8479661,Tanner Jeannot,L,LAK,27,75,12,14,26
25,8479619,Michael Carcone,L,UTA,28,69,12,14,26
25,8481580,Connor McMichael,C,WSH,23,62,11,15,26
25,8482067,Connor Mackey,D,NYR,28,64,8,18,26
25,8480878,Nils Lundkvist,D,DAL,24,72,8,18,26
25,8476892,Colton Parayko,D,STL,31,64,6,20,26
25,8482660,Kent Johnson,C,CBJ,22,62,5,21,26
25,8475181,Nick Leddy,D,STL,33,69,2,24,26
25,8480789,Oliver Wahlstrom,R,NYI,24,70,11,14,25
25,8482133,Thomas Bordeleau,C,SJS,22,66,8,17,25
25,8483457,Lane Hutson,D,MTL,20,66,7,18,25
25,8481059,Scott Perunovich,D,STL,26,62,5,20,25
25,8482679,Matt Coronato,R,CGY,22,66,16,8,24
25,8482737,Zack Bolduc,C,STL,21,52,15,9,24
25,8482259,Bobby McMann,C,TOR,28,71,13,11,24
25,8473533,Jordan Staal,C,CAR,36,67,13,11,24
25,8479941,Justin Danforth,R,CBJ,31,62,11,13,24
25,8475231,Casey Cizikas,C,NYI,33,76,11,13,24
25,8483524,Shane Wright,C,SEA,20,60,11,13,24
25,8479996,Cody Glass,C,NSH,25,63,9,15,24
25,8477947,Sonny Milano,L,WSH,28,60,8,16,24
25,8481481,Blake Lizotte,C,PIT,27,60,7,17,24
25,8478882,Vladislav Gavrikov,D,LAK,29,69,3,21,24
25,8476312,Josh Manson,D,COL,33,60,3,21,24
25,8482142,Jamie Drysdale,D,PHI,22,71,2,22,24
25,8476960,Andreas Athanasiou,C,CHI,30,56,14,9,23
25,8482079,Marco Rossi,C,MIN,23,58,14,9,23
25,8477446,Michael McCarron,R,NSH,29,58,13,10,23
25,8480068,Ryan Poehling,C,PHI,25,70,11,12,23
25,8481553,Bobby Brink,R,PHI,23,55,11,12,23
25,8475343,Nic Dowd,C,WSH,34,67,11,12,23
25,8479328,Julien Gauthier,R,NYI,27,60,10,13,23
25,8483565,Nick Blankenburg,D,NSH,26,62,9,14,23
25,8476461,Sean Couturier,C,PHI,32,62,9,14,23
25,8476918,Jimmy Vesey,L,NYR,31,68,9,14,23
25,8482105,Jake Sanderson,D,OTT,22,75,8,15,23
25,8478458,John (Jack) Roslovic,C,CAR,27,63,8,15,23
25,8477220,Nate Schmidt,D,FLA,33,73,8,15,23
25,8478136,Jake Middleton,D,MIN,28,73,6,17,23
25,8473563,Nicklas Backstrom,C,WSH,37,57,6,17,23
25,8476463,Jonas Brodin,D,MIN,31,80,5,18,23
25,8476467,Jamie Oleksiak,D,SEA,32,70,4,19,23
25,8477488,Brett Pesce,D,NJD,30,69,3,20,23
25,8482074,Connor Zary,C,CGY,23,60,14,8,22
25,8478569,Noel Acciari,C,PIT,33,52,14,8,22
25,8476873,Mark Jankowski,C,NSH,30,48,13,9,22
25,8483549,Lucas Condotta,L,MTL,27,37,13,9,22
25,8477505,Alexander Wennberg,C,SJS,30,57,11,11,22
25,8481641,Joel Kiviranta,L,COL,28,78,11,11,22
25,8479718,Alex Barré-Boulet,C,MTL,27,54,11,11,22
25,8476921,Jordan Martinook,L,CAR,32,56,10,12,22
25,8473453,Trevor Lewis,C,LAK,37,71,10,12,22
25,8478970,Jalen Chatfield,D,CAR,28,72,8,14,22
25,8480220,Noah Cates,L,PHI,25,68,7,15,22
25,8482101,Danil Gushchin,L,SJS,22,57,7,15,22
25,8477979,Nicolas Aube-Kubel,R,BUF,28,65,7,15,22
25,8482803,Olen Zellweger,D,ANA,21,71,7,15,22
25,8476422,Mike Reilly,D,NYI,31,68,6,16,22
25,8478133,Jake Evans,C,MTL,28,70,6,16,22
25,8475188,Brayden McNabb,D,VGK,33,60,5,17,22
25,8479982,Conor Timmins,D,TOR,26,63,3,19,22
25,8479983,Mario Ferraro,D,SJS,26,74,2,20,22
25,8480021,Jack Studnicka,C,LAK,25,55,12,9,21
25,8482807,Ethan Del Mastro,D,CHI,21,49,12,9,21
25,8477353,Tyler Motte,C,DET,29,70,9,12,21
25,8478043,Sam Lafferty,C,BUF,29,62,9,12,21
25,8482117,Lukas Reichel,L,CHI,22,61,8,13,21
25,8476329,Travis Boyd,C,MIN,31,60,8,13,21
25,8479315,Joey Anderson,R,CHI,26,50,8,13,21
25,8482125,Alexander Holtz,R,VGK,22,67,7,14,21
25,8476988,Matt Benning,D,SJS,30,62,7,14,21
25,8476457,Adam Larsson,D,SEA,32,69,5,16,21
25,8480043,Timothy Liljegren,D,TOR,25,65,4,17,21
25,8475179,Dmitry Kulikov,D,FLA,34,67,4,17,21
25,8482073,Braden Schneider,D,NYR,23,61,3,18,21
25,8479368,Max Jones,L,BOS,26,65,14,6,20
25,8478508,Yakov Trenin,C,MIN,27,62,12,8,20
25,8477392,Hudson Fasching,R,NYI,29,69,10,10,20
25,8481704,Juuso Parssinen,C,NSH,23,60,9,11,20
25,8480003,Jesper Boqvist,C,FLA,26,67,9,11,20
25,8481624,Ilya Mikheyev,R,CHI,30,51,9,11,20
25,8479344,Jesse Puljujarvi,R,PIT,26,49,9,11,20
25,8477478,William Carrier,L,CAR,30,51,9,11,20
25,8480074,Alexandre Texier,C,STL,25,63,8,12,20
25,8482809,Jackson Blake,R,CAR,21,57,7,13,20
25,8481441,Joe Snively,C,DET,28,69,7,13,20
25,8482087,Kaiden Guhle,D,MTL,22,61,7,13,20
25,8479639,Dylan Coghlan,D,WPG,26,66,7,13,20
25,8479976,Juuso Valimaki,D,UTA,26,67,6,14,20
25,8476931,Jake McCabe,D,TOR,31,61,4,16,20
25,8476429,Scott Mayfield,D,NYI,32,73,3,17,20
25,8480222,Sebastian Aho,D,PIT,28,71,3,17,20
25,8475233,David Savard,D,MTL,34,64,2,18,20
25,8478840,Will Borgen,D,SEA,28,68,2,18,20
25,8474673,TJ Brodie,D,CHI,34,66,1,19,20
25,8481019,David Gustafsson,C,WPG,24,47,1,19,20
25,8476878,Zemgus Girgensons,C,TBL,30,80,13,6,19
25,8477450,Jason Dickinson,C,CHI,29,54,11,8,19
25,8477508,Curtis Lazar,C,NJD,29,57,11,8,19
25,8481656,Aliaksei Protas,C,WSH,23,59,10,9,19
25,8479293,Brandon Tanev,L,SEA,33,61,10,9,19
25,8482166,Shakir Mukhamadullin,D,SJS,22,58,10,9,19
25,8480835,Jack Drury,C,CAR,24,63,8,11,19
25,8475208,Brian Dumoulin,D,ANA,33,62,7,12,19
25,8480144,David Kampf,C,TOR,29,68,6,13,19
25,8481521,Ronnie Attard,D,PHI,25,58,6,13,19
25,8479351,Sam Steel,C,DAL,26,80,5,14,19
25,8479998,Mikey Anderson,D,LAK,25,61,5,14,19
25,8475279,Ben Chiarot,D,DET,33,71,4,15,19
25,8480049,Dylan Samberg,D,WPG,25,64,2,17,19
25,8480246,Nick Perbix,D,TBL,26,74,1,18,19
25,8481601,Simon Holmstrom,R,NYI,23,60,16,2,18
25,8477903,Garnet Hathaway,R,PHI,33,65,13,5,18
25,8480205,Emil Bemstrom,C,PIT,25,61,12,6,18
25,8482762,Simon Edvinsson,D,DET,21,52,12,6,18
25,8476889,Radek Faksa,C,STL,30,68,10,8,18
25,8484149,Gavin Brindley,C,CBJ,20,57,9,9,18
25,8477919,Frederick Gaudreau,C,MIN,31,58,7,11,18
25,8477406,Mattias Janmark,C,EDM,32,64,7,11,18
25,8480252,Cole Guttman,C,CHI,25,42,6,12,18
25,8480441,Trey Fix-Wolansky,R,CBJ,25,41,6,12,18
25,8479980,Nicolas Hague,D,VGK,26,51,5,13,18
25,8482451,Mikael Pyyhtia,L,CBJ,23,38,5,13,18
25,8477369,Carson Soucy,D,VAN,30,62,4,14,18
25,8477015,Connor Brown,R,EDM,30,62,4,14,18
25,8480035,Henri Jokiharju,D,BUF,25,66,3,15,18
25,8478416,Erik Cernak,D,TBL,27,73,3,15,18
25,8480887,Jordan Harris,D,MTL,24,55,3,15,18
25,8482192,Isaak Phillips,D,CHI,23,52,3,15,18
25,8482245,Artem Zub,D,OTT,29,70,2,16,18
25,8476331,Dylan DeMelo,D,WPG,31,72,2,16,18
25,8479324,Ryan Lindgren,D,NYR,26,59,2,16,18
25,8481178,Egor Zamula,D,PHI,24,56,2,16,18
25,8476934,Brock McGinn,L,ANA,30,48,10,7,17
25,8481522,Peyton Krebs,C,BUF,23,63,9,8,17
25,8481013,Jonatan Berggren,R,DET,24,60,9,8,17
25,8475171,Oliver Ekman-Larsson,D,TOR,33,67,6,11,17
25,8480995,Pontus Holmberg,R,TOR,25,56,5,12,17
25,8481093,Rafael Harvey-Pinard,L,MTL,25,56,4,13,17
25,8480157,Calle Rosen,D,COL,30,51,4,13,17
25,8475462,Radko Gudas,D,ANA,34,64,4,13,17
25,8480727,Zach Whitecloud,D,VGK,28,52,3,14,17
25,8479371,Dante Fabbro,D,NSH,26,56,2,15,17
25,8479336,Carl Grundstrom,R,SJS,27,60,10,6,16
25,8481751,Lukas Rousek,R,BUF,25,35,9,7,16
25,8480011,Klim Kostin,C,SJS,25,59,8,8,16
25,8476624,Barclay Goodrow,C,SJS,31,56,7,9,16
25,8474034,Patrick Maroon,L,CHI,36,49,6,10,16
25,8480448,Parker Kelly,L,COL,25,73,6,10,16
25,8479520,Brandon Duhaime,R,WSH,27,57,6,10,16
25,8483445,Cutter Gauthier,L,ANA,20,63,5,11,16
25,8481537,Nikita Okhotiuk,D,CGY,24,52,4,12,16
25,8480025,MacKenzie Entwistle,R,FLA,25,67,4,12,16
25,8481550,Adam Beckman,L,NJD,23,46,4,12,16
25,8474574,Tyler Myers,D,VAN,34,66,3,13,16
25,8478500,Ivan Provorov,D,CBJ,27,79,3,13,16
25,8480073,Erik Brannstrom,D,COL,25,58,3,13,16
25,8482634,Alex Steeves,C,TOR,25,53,3,13,16
25,8479026,Philippe Myers,D,TOR,27,52,2,14,16
25,8473507,Jeff Petry,D,DET,37,74,1,15,16
25,8478507,John Marino,D,UTA,27,64,1,15,16
25,8480980,Connor Dewar,C,TOR,25,69,9,6,15
25,8478585,Derek Ryan,C,EDM,38,68,9,6,15
25,8480762,Eric Robinson,L,CAR,29,57,8,7,15
25,8481754,Nikita Nesterenko,C,ANA,23,36,8,7,15
25,8478911,Matt Roy,D,WSH,29,69,7,8,15
25,8482062,Cole Smith,L,NSH,29,58,6,9,15
25,8483493,Frank Nazar,C,CHI,20,40,5,10,15
25,8480289,Morgan Barron,C,WPG,26,55,5,10,15
25,8475790,Erik Gudbranson,D,CBJ,32,78,4,11,15
25,8480001,Urho Vaakanainen,D,ANA,25,62,2,13,15
25,8476967,Brett Kulak,D,EDM,30,65,1,14,15
25,8479671,Mathieu Olivier,R,CBJ,27,49,9,5,14
25,8479414,Nathan Bastian,R,NJD,27,54,7,7,14
25,8478434,Keegan Kolesar,R,VGK,27,72,7,7,14
25,8480281,Alexey Toropchenko,R,STL,25,51,7,7,14
25,8481477,Nico Sturm,C,SJS,29,55,6,8,14
25,8479543,Michael Pezzetta,L,MTL,26,56,6,8,14
25,8479291,Kevin Rooney,C,CGY,31,53,5,9,14
25,8476856,Mathew Dumba,D,DAL,30,66,4,10,14
25,8481568,Alex Vlasic,D,CHI,23,42,4,10,14
25,8481028,Martin Pospisil,C,CGY,25,58,3,11,14
25,8480807,Mattias Samuelsson,D,BUF,24,58,3,11,14
25,8481527,Kaedan Korczak,D,VGK,23,50,3,11,14
25,8483460,David Jiricek,D,CBJ,21,55,3,11,14
25,8477931,Tomas Nosek,L,FLA,32,58,3,11,14
25,8480796,Martin Fehervary,D,WSH,25,52,3,11,14
25,8477887,Patrick Brown,C,BOS,32,48,3,11,14
25,8477845,Trevor van Riemsdyk,D,WSH,33,53,2,12,14
25,8478178,Darren Raddysh,D,TBL,28,68,2,12,14
25,8476879,Cody Ceci,D,EDM,31,70,1,13,14
25,8478451,Ethan Bear,D,WSH,27,46,1,13,14
25,8477365,Connor Clifton,D,BUF,29,56,0,14,14
25,8478831,Kevin Stenlund,C,UTA,28,57,10,3,13
25,8482155,Alex Laferriere,R,LAK,23,64,8,5,13
25,8479359,Beck Malenstyn,L,BUF,26,48,8,5,13
25,8481517,Brett Leason,R,ANA,25,60,7,6,13
25,8483499,Liam Ohgren,L,MIN,20,47,6,7,13
25,8483482,Tristan Luneau,D,ANA,20,58,5,8,13
25,8475225,Craig Smith,C,CHI,35,52,5,8,13
25,8482964,Arber Xhekaj,D,MTL,23,47,5,8,13
25,8475220,Marcus Foligno,L,MIN,33,64,4,9,13
25,8479316,Luke Kunin,C,SJS,27,56,4,9,13
25,8477018,Ben Hutton,D,VGK,31,43,4,9,13
25,8480070,Ian Mitchell,D,BOS,25,43,4,9,13
25,8476525,Colin Miller,D,WPG,32,63,3,10,13
25,8474567,Zach Bogosian,D,MIN,34,68,3,10,13
25,8483466,Kevin Korchinski,D,CHI,20,58,3,10,13
25,8481014,Alexander Romanov,D,NYI,24,76,2,11,13
25,8478421,A.J. Greer,L,FLA,28,54,2,11,13
25,8481708,Zac Jones,D,NYR,24,48,2,11,13
25,8475324,Nick Jensen,D,OTT,34,61,1,12,13
25,8480058,Pierre-Olivier Joseph,D,STL,25,55,0,13,13
25,8478452,Caleb Jones,D,LAK,27,58,0,13,13
25,8475455,Brenden Dillon,D,NJD,34,57,0,13,13
25,8479638,Justin Brazeau,R,BOS,26,38,9,3,12
25,8476822,Luke Glendening,C,TBL,35,78,7,5,12
25,8481518,Nolan Foote,L,NJD,24,47,6,6,12
25,8476442,Matt Nieto,L,PIT,32,48,5,7,12
25,8475842,Sam Carrick,C,NYR,32,50,5,7,12
25,8478211,Dryden Hunt,L,CGY,29,50,5,7,12
25,8482859,Zack Ostapchuk,C,OTT,21,52,5,7,12
25,8479378,Logan Stanley,D,WPG,26,48,5,7,12
25,8479944,Zach Aston-Reese,C,VGK,30,41,5,7,12
25,8476374,Sean Kuraly,C,CBJ,31,53,4,8,12
25,8476874,Olli Maatta,D,DET,30,61,3,9,12
25,8481617,Vasily Podkolzin,R,VAN,23,48,7,4,11
25,8477573,Nathan Walker,L,STL,30,49,7,4,11
25,8479968,Vinni Lettieri,C,BOS,29,43,6,5,11
25,8480172,Jan Rutta,D,SJS,34,59,6,5,11
25,8482659,Josh Doan,R,UTA,22,53,5,6,11
25,8482176,Wyatt Kaiser,D,CHI,22,53,4,7,11
25,8476994,Vinnie Hinostroza,C,NSH,30,46,4,7,11
25,8477034,Jaycob Megna,D,FLA,32,50,4,7,11
25,8481599,Victor Soderstrom,D,UTA,23,45,3,8,11
25,8471709,Marc-Edouard Vlasic,D,SJS,37,53,3,8,11
25,8480879,Jacob Bernard-Docker,D,OTT,24,48,3,8,11
25,8480860,Kevin Bahl,D,CGY,24,64,2,9,11
25,8480891,Michael Kesselring,D,UTA,24,57,2,9,11
25,8479370,Tyson Jost,C,CAR,26,55,2,9,11
25,8480192,Johnathan Kovacevic,D,NJD,27,50,2,9,11
25,8479972,Mason Shaw,C,WPG,26,32,2,9,11
25,8475750,Jon Merrill,D,MIN,32,62,2,9,11
25,8478443,Brandon Carlo,D,BOS,28,59,1,10,11
25,8481716,Dmitri Voronkov,L,CBJ,24,44,7,3,10
25,8478859,Niko Mikkola,D,FLA,28,52,6,4,10
25,8482077,Dylan Holloway,L,EDM,23,49,5,5,10
25,8480355,Mark Kastelic,C,BOS,25,51,5,5,10
25,8480844,Grigori Denisenko,L,VGK,24,31,5,5,10
25,8481147,Reese Johnson,C,MIN,26,45,4,6,10
25,8481167,Brayden Pachal,D,CGY,25,31,4,6,10
25,8479372,Joshua Mahura,D,SEA,26,54,3,7,10
25,8477499,Rasmus Ristolainen,D,PHI,30,54,3,7,10
25,8481161,Jake Christiansen,D,CBJ,25,55,3,7,10
25,8475235,Nicolas Deslauriers,L,PHI,33,59,3,7,10
25,8482511,Mason Lohrei,D,BOS,23,37,3,7,10
25,8479369,Andrew Peeke,D,BOS,26,58,2,8,10
25,8470600,Ryan Suter,D,STL,39,63,2,8,10
25,8471677,Jack Johnson,D,CBJ,37,66,2,8,10
25,8475690,Chris Tanev,D,TOR,35,56,1,9,10
25,8481567,Henry Thrun,D,SJS,23,54,1,9,10
25,8480196,Jacob Bryson,D,BUF,27,37,0,10,10
25,8476858,Phillip Di Giuseppe,L,VAN,31,48,8,1,9
25,8477380,Jonny Brodzinski,C,NYR,31,54,5,4,9
25,8482730,Brandt Clarke,D,LAK,21,49,4,5,9
25,8482095,Tyler Kleven,D,OTT,22,46,3,6,9
25,8481598,Philip Broberg,D,EDM,23,43,3,6,9
25,8476867,Brendan Gaunce,C,MIN,30,27,3,6,9
25,8477401,John Hayden,C,SEA,29,29,3,6,9
25,8480845,Rasmus Kupari,C,WPG,24,43,2,7,9
25,8476372,Nick Seeler,D,PHI,31,41,2,7,9
25,8480950,Ilya Lyubushkin,D,DAL,30,66,1,8,9
25,8477938,Haydn Fleury,D,WPG,28,36,1,8,9
25,8479986,Kole Lind,R,DAL,26,53,1,8,9
25,8478399,Jonas Siegenthaler,D,NJD,27,60,0,9,9
25,8482148,Hendrix Lapierre,C,WSH,22,49,5,3,8
25,8479981,Jonah Gadjovich,L,FLA,26,42,5,3,8
25,8480007,Jonas Rondbjerg,R,VGK,25,32,4,4,8
25,8480848,Ty Dellandrea,C,SJS,24,40,4,4,8
25,8482733,Logan Mailloux,D,MTL,31,37,4,4,8
25,8482153,Brendan Brisson,C,VGK,23,35,3,5,8
25,8474568,Luke Schenn,D,NSH,35,50,3,5,8
25,8482652,Walker Duehr,R,CGY,27,45,3,5,8
25,8474013,Ian Cole,D,UTA,35,49,3,5,8
25,8477851,Jordan Oesterle,D,BOS,32,37,3,5,8
25,8475718,Justin Holl,D,DET,32,59,3,5,8
25,8480292,Carson Meyer,R,ANA,27,37,3,5,8
25,8482172,Landon Slaggert,L,CHI,22,29,3,5,8
25,8483495,Simon Nemec,D,NJD,20,57,2,6,8
25,8476441,Joel Edmundson,D,LAK,31,48,2,6,8
25,8480880,Jakub Lauko,C,MIN,24,42,2,6,8
25,8482145,Mavrik Bourque,C,DAL,22,49,2,6,8
25,8483630,Pavol Regenda,L,ANA,25,28,2,6,8
25,8481609,Vladislav Kolyachonok,D,UTA,23,39,2,6,8
25,8479249,Andrew Poturalski,C,SJS,30,25,1,7,8
25,8474612,Travis Hamonic,D,OTT,34,42,1,7,8
25,8481532,Alex Turcotte,C,LAK,23,44,1,7,8
25,8475762,Derek Forbort,D,VAN,32,45,1,7,8
25,8478017,Mark Friedman,D,VAN,29,40,1,7,8
25,8476473,Connor Murphy,D,CHI,31,44,0,8,8
25,8478409,Anthony Richard,C,PHI,28,34,5,2,7
25,8482141,Lukas Cormier,D,VGK,22,29,5,2,7
25,8481556,John Beecher,C,BOS,23,35,5,2,7
25,8483397,Marc McLaughlin,C,BOS,25,29,5,2,7
25,8479442,Troy Stecher,D,EDM,30,57,4,3,7
25,8475177,Calvin de Haan,D,COL,33,41,4,3,7
25,8474090,Brendan Smith,D,DAL,35,49,3,4,7
25,8480245,Olle Lycksell,R,PHI,25,30,3,4,7
25,8482751,Ryan Winterton,C,SEA,21,32,3,4,7
25,8482666,Scott Morrow,D,CAR,22,42,3,4,7
25,8484254,Akito Hirose,D,VAN,25,35,2,5,7
25,8476913,Devin Shore,C,MIN,30,34,1,6,7
25,8479994,Jaret Anderson-Dolan,C,WPG,25,38,1,6,7
25,8473446,Erik Johnson,D,PHI,36,48,0,7,7
25,8478454,Noah Juulsen,D,VAN,27,38,0,7,7
25,8477527,Ross Johnston,L,ANA,30,39,0,7,7
25,8481789,Tye Kartye,L,SEA,23,38,4,2,6
25,8471817,Ryan Reaves,R,TOR,37,54,3,3,6
25,8479379,Givani Smith,R,SJS,26,32,3,3,6
25,8479772,Zack MacEwen,R,OTT,28,52,2,4,6
25,8482747,Brennan Othmann,L,NYR,21,41,2,4,6
25,8484258,Sam Malinski,D,COL,26,24,2,4,6
25,8474166,Alec Martinez,D,CHI,37,51,1,5,6
25,8481701,Santeri Hatakka,D,NJD,23,39,1,5,6
25,8477335,Kyle Burroughs,D,LAK,29,45,1,5,6
25,8477070,Liam O'Brien,C,UTA,30,49,1,5,6
25,8481592,Jakob Pelletier,L,CGY,23,40,1,5,6
25,8482784,Zach Dean,C,STL,21,46,1,5,6
25,8480267,Sammy Walker,C,MIN,25,21,1,5,6
25,8477810,Joel Hanley,D,CGY,33,23,1,5,6
25,8478146,Matthew Highmore,C,OTT,28,35,0,6,6
25,8477384,Joshua Brown,D,EDM,30,37,0,6,6
25,8475795,Dylan McIlrath,D,WSH,32,19,0,6,6
25,8482070,Mitchell Chaffee,R,TBL,26,51,5,0,5
25,8477962,Brendan Lemieux,L,CAR,28,41,4,1,5
25,8478424,Jansen Harkins,C,ANA,27,40,3,2,5
25,8482744,James Malatesta,L,CBJ,21,39,3,2,5
25,8482765,Isak Rosen,R,BUF,21,38,3,2,5
25,8481237,Kyle MacLean,C,NYI,25,20,3,2,5
25,8479439,Jacob MacDonald,D,COL,31,56,2,3,5
25,8481679,Maxence Guenette,D,OTT,23,32,2,3,5
25,8482496,Nils Aman,C,VAN,24,33,2,3,5
25,8481122,Simon Benoit,D,TOR,26,41,2,3,5
25,8480834,Ty Emberson,D,SJS,24,32,1,4,5
25,8478468,Jeremy Lauzon,D,NSH,27,48,1,4,5
25,8479348,Kale Clague,D,BUF,26,42,1,4,5
25,8477467,Gustav Olofsson,D,SEA,30,21,1,4,5
25,8483619,Filip Roos,D,OTT,25,39,1,4,5
25,8482861,Vincent Iorio,D,WSH,22,37,1,4,5
25,8476952,Dominic Toninato,C,WPG,30,33,1,4,5
25,8477482,Zachary Sanford,L,CHI,30,40,0,5,5
25,8484911,Collin Graf,R,SJS,22,29,0,5,5
25,8482147,Jean-Luc Foudy,C,COL,22,17,3,1,4
25,8480990,Declan Chisholm,D,MIN,24,33,2,2,4
25,8480890,Jan Jenik,C,OTT,24,19,2,2,4
25,8482177,Marat Khusnutdinov,C,MIN,22,28,2,2,4
25,8483512,Matthew Savoie,C,EDM,20,22,2,2,4
25,8479991,Jake Leschyshyn,C,NYR,25,28,2,2,4
25,8479985,Cale Fleury,D,SEA,26,26,1,3,4
25,8482250,Callahan Burke,C,VGK,27,22,1,3,4
25,8481541,Samuel Bolduc,D,NYI,24,32,1,3,4
25,8482102,Vasily Ponomarev,C,PIT,22,21,1,3,4
25,8477073,Kurtis MacDermid,L,NJD,30,28,1,3,4
25,8481056,Spencer Stastney,D,NSH,24,43,0,4,4
25,8478450,Parker Wotherspoon,D,BOS,27,35,0,4,4
25,8478881,Brett Seney,L,CHI,28,15,3,0,3
25,8484287,Cole McWard,D,VAN,23,20,2,1,3
25,8482713,Mackie Samoskevich,R,FLA,22,36,2,1,3
25,8481065,Angus Crookshank,L,OTT,25,14,2,1,3
25,8479367,William Lockwood,R,FLA,26,25,2,1,3
25,8475413,Justin Dowling,C,NJD,34,15,2,1,3
25,8478874,Adam Gaudette,R,OTT,28,42,1,2,3
25,8479536,Axel Jonsson-Fjallby,L,WPG,26,28,1,2,3
25,8483763,Maksymilian Szuber,D,UTA,22,30,1,2,3
25,8482144,Jack Thompson,D,SJS,22,30,1,2,3
25,8481543,Nikita Alexandrov,C,STL,24,22,1,2,3
25,8483012,Logan Morrison,C,SEA,22,35,1,2,3
25,8480870,Bo Groulx,C,NYR,24,29,1,2,3
25,8477462,Robert Hagg,D,VGK,29,26,1,2,3
25,8480851,Akil Thomas,C,LAK,24,21,1,2,3
25,8474062,Riley Nash,C,NYR,35,26,1,2,3
25,8481600,Tobias Bjornfot,D,FLA,23,30,0,3,3
25,8479419,Brett Murray,L,BUF,26,22,0,3,3
25,8481564,Ryan Johnson,D,BUF,23,16,0,3,3
25,8482516,Matthew Kessel,D,STL,24,18,0,3,3
25,8481422,Jake Lucchini,C,NSH,29,12,2,0,2
25,8475755,Alexander Petrovic,D,DAL,32,10,2,0,2
25,8478011,Louie Belpedio,D,PHI,28,12,2,0,2
25,8483570,Ben Meyers,C,SEA,26,30,1,1,2
25,8480468,James Hamblin,L,EDM,25,17,1,1,2
25,8475958,Michael Sgarbossa,C,WSH,32,15,1,1,2
25,8477149,Scott Sabourin,R,SJS,32,15,1,1,2
25,8479362,Riley Tufte,L,BOS,26,20,1,1,2
25,8481593,Jayden Struble,D,MTL,23,21,1,1,2
25,8477993,Justin Kirkland,C,CGY,28,6,1,1,2
25,8478446,Glenn Gawdin,C,LAK,27,12,1,1,2
25,8480823,Alexander Alexeyev,D,WSH,25,16,1,1,2
25,8479587,Rhett Gardner,C,PHI,28,20,0,2,2
25,8479320,Maxime Lajoie,D,SEA,27,20,0,2,2
25,8481743,Marc Del Gaizo,D,NSH,25,19,0,2,2
25,8478477,Mitchell Stephens,C,SEA,27,18,0,2,2
25,8481585,Egor Afanasyev,L,SJS,23,16,0,2,2
25,8477473,Justin Bailey,R,SJS,29,23,0,2,2
25,8478021,William Lagesson,D,DET,28,24,0,2,2
25,8478502,Dennis Gilbert,D,BUF,28,22,0,2,2
25,8482088,Justin Sourdif,R,FLA,22,20,0,2,2
25,8482094,Daemon Hunt,D,MIN,22,13,0,2,2
25,8477320,Anton Blidh,L,NYR,29,24,0,2,2
25,8481462,Mason Morelli,L,VGK,28,15,0,2,2
25,8483395,Arshdeep Bains,L,VAN,23,11,0,2,2
25,8481030,Jack St. Ivany,D,PIT,25,19,1,0,1
25,8482162,Roby Jarventie,L,EDM,22,11,1,0,1
25,8478051,Max Willman,C,NJD,29,20,1,0,1
25,8481605,Jackson LaCombe,D,ANA,23,36,1,0,1
25,8481719,Maxwell Crozier,D,TBL,24,15,1,0,1
25,8482061,Brandon Biro,L,SEA,26,11,1,0,1
25,8482165,Yan Kuznetsov,D,CGY,22,26,1,0,1
25,8476323,Max McCormick,L,SEA,32,5,1,0,1
25,8482460,Matt Rempe,C,NYR,22,8,1,0,1
25,8483597,Milos Kelemen,L,UTA,25,13,1,0,1
25,8479330,Brandon Gignac,C,MTL,27,13,1,0,1
25,8481578,Graeme Clarke,R,MIN,23,15,1,0,1
25,8479421,Jacob Moverare,D,LAK,26,4,1,0,1
25,8480274,Philip Kemp,D,EDM,25,3,1,0,1
25,8479576,Vincent Desharnais,D,VAN,28,33,0,1,1
25,8477971,Andreas Englund,D,LAK,28,19,0,1,1
25,8481806,Louis Crevier,D,CHI,23,10,0,1,1
25,8477541,Dakota Mermis,D,TOR,30,14,0,1,1
25,8483398,Declan Carlile,D,TBL,31,6,0,1,1
25,8483546,Marshall Rifai,D,TOR,26,6,0,1,1
25,8477244,Chad Ruhwedel,D,NYR,34,29,0,1,1
25,8482201,Gage Goncalves,C,TBL,23,29,0,1,1
25,8478147,Bokondji Imama,L,PIT,28,5,0,1,1
25,8484304,Uvis Balinskis,D,FLA,28,12,0,1,1
25,8480874,Adam Ginning,D,PHI,24,10,0,1,1
25,8482476,Emil Heineman,L,MTL,23,4,0,1,1
25,8482197,Adam Raska,R,MIN,23,5,0,1,1
25,8475780,Chris Wagner,R,COL,33,6,0,1,1
25,8483401,Marc Johnstone,R,PIT,28,3,0,1,1
25,8481206,John Ludvig,D,PIT,24,10,0,0,0
25,8482118,Sam Colangelo,R,ANA,23,14,0,0,0
25,8480084,Nick DeSimone,D,NJD,30,19,0,0,0
25,8482858,Ryker Evans,D,SEA,23,17,0,0,0
25,8481699,Aku Raty,R,UTA,23,8,0,0,0
25,8482470,Ilya Solovyov,D,CGY,24,13,0,0,0
25,8483471,Brad Lambert,C,WPG,31,11,0,0,0
25,8481534,Raphael Lavoie,C,EDM,24,4,0,0,0
25,8483489,Fraser Minten,C,TOR,31,7,0,0,0
25,8481043,Cole Koepke,L,BOS,26,17,0,0,0
25,8481024,Linus Karlsson,C,VAN,25,7,0,0,0
25,8484325,Waltteri Merela,C,TBL,26,16,0,0,0
25,8479522,Hardy Haman Aktell,D,WSH,26,2,0,0,0
25,8481655,Cole Schwindt,R,CGY,23,5,0,0,0
25,8483407,Brandon Scanlin,D,NYR,25,8,0,0,0
25,8484259,Ondrej Pavel,C,COL,31,1,0,0,0
25,8482929,Emil Lilleberg,D,TBL,23,19,0,0,0
25,8481726,Adam Edstrom,C,NYR,24,7,0,0,0
25,8480032,Shane Bowers,C,NJD,25,13,0,0,0
25,8480306,Grant Hutton,D,NYI,29,8,0,0,0
25,8478854,Ryan Shea,D,PIT,27,8,0,0,0
25,8484326,Patrik Koch,D,UTA,28,4,0,0,0
25,8483531,Brian Halonen,L,NJD,25,0,0,0,0
25,8480075,Cameron Crotty,D,MIN,25,7,0,0,0
25,8481006,Tyler Tucker,D,STL,24,12,0,0,0
25,8483609,Adam Klapka,R,CGY,24,4,0,0,0
25,8484255,Jason Polin,R,COL,25,6,0,0,0
25,8483567,Georgii Merkulov,C,BOS,24,7,0,0,0
25,8482126,Emil Andrae,D,PHI,31,4,0,0,0
25,8478956,Samuel Laberge,L,NJD,27,1,0,0,0
25,8482787,Nikita Chibrikov,R,WPG,31,8,0,0,0
25,8483920,Pierrick Dube,R,WSH,23,5,0,0,0
25,8483432,Luca Del Bel Belluz,C,CBJ,31,3,0,0,0
25,8484321,Nikolas Matinpalo,D,OTT,26,3,0,0,0
25,8470794,Joe Pavelski,C,,40,0,0,0,0
25,8479321,Lucas Johansen,D,,27,0,0,0,0
25,8477950,Tony DeAngelo,D,,29,0,0,0,0
25,8471218,Blake Wheeler,R,,38,0,0,0,0
25,8475197,Tyson Barrie,D,,33,0,0,0,0
25,8474157,Max Pacioretty,L,,36,0,0,0,0
25,8475744,Evgeny Kuznetsov,C,,32,0,0,0,0
25,8474037,James van Riemsdyk,L,,35,0,0,0,0
25,8476907,Mackenzie MacEachern,L,,30,0,0,0,0
25,8480216,Jacob Peterson,C,,25,0,0,0,0
25,8474602,Justin Schultz,D,,34,0,0,0,0
25,8482222,Alexander Barabanov,L,,30,0,0,0,0
25,8474031,Kevin Shattenkirk,D,,35,0,0,0,0
25,8477330,Dominik Kubalik,L,,29,0,0,0,0
25,8480884,Calen Addison,D,,24,0,0,0,0
25,8475906,John Klingberg,D,,32,0,0,0,0
25,8480008,Adam Ruzicka,C,,25,0,0,0,0
25,8476884,Derrick Pouliot,D,,30,0,0,0,0
25,8476919,Chris Tierney,C,,30,0,0,0,0
25,8479415,Michael McLeod,C,,26,0,0,0,0
25,8474870,Tyler Johnson,C,,34,0,0,0,0
25,8470604,Jeff Carter,C,,39,0,0,0,0
25,8478104,Sammy Blais,L,,28,0,0,0,0
25,8474884,Mike Hoffman,C,,35,0,0,0,0
25,8481591,Sam Poulin,R,,23,0,0,0,0
25,8471274,Alex Goligoski,D,,39,0,0,0,0
25,8476871,Tanner Pearson,L,,32,0,0,0,0
25,8476393,Nick Cousins,C,,31,0,0,0,0
25,8479977,Kailer Yamamoto,R,,26,0,0,0,0
25,8479346,Dillon Dube,C,,26,0,0,0,0
25,8480184,Gustav Lindstrom,D,,26,0,0,0,0
25,8479376,Victor Mete,D,,26,0,0,0,0
25,8473449,Kyle Okposo,R,,36,0,0,0,0
25,8481058,Jesse Ylonen,R,,25,0,0,0,0
25,8475752,Tyler Pitlick,C,,33,0,0,0,0
25,8481239,Samuel Fagemo,L,,24,0,0,0,0
25,8480821,Filip Zadina,R,,25,0,0,0,0
25,8470966,Mark Giordano,D,,41,0,0,0,0
25,8478495,Denis Gurianov,R,,27,0,0,0,0
25,8477464,Nic Petan,C,,29,0,0,0,0
25,8478099,Kevin Labanc,R,,29,0,0,0,0
25,8482241,Radim Zohorna,L,,28,0,0,0,0
25,8474040,Sam Gagner,C,,35,0,0,0,0
25,8479514,Rem Pitlick,C,,27,0,0,0,0
25,8478430,Oliver Kylington,D,,27,0,0,0,0
25,8479533,Joona Koppanen,L,,26,0,0,0,0
25,8479984,Cal Foote,D,,26,0,0,0,0
25,8477126,Jayson Megna,C,,34,0,0,0,0
25,8475164,Jakob Silfverberg,R,,34,0,0,0,0
25,8474009,Nick Bonino,C,,36,0,0,0,0
25,8479458,Nikita Zaitsev,D,,33,0,0,0,0
25,8477944,Jakub Vrana,L,,28,0,0,0,0
25,8471699,Andrew Cogliano,C,,37,0,0,0,0
25,8478067,Oskar Lindblom,L,,28,0,0,0,0
25,8471686,Marc Staal,D,,37,0,0,0,0
25,8470610,Zach Parise,L,,40,0,0,0,0
25,8478904,Steven Lorentz,C,,28,0,0,0,0
25,8473473,Milan Lucic,L,,36,0,0,0,0
25,8480031,Maxime Comtois,L,,25,0,0,0,0
25,8478512,Austin Czarnik,C,,32,0,0,0,0
25,8473504,Cal Clutterbuck,R,,37,0,0,0,0
25,8477454,Adam Erne,L,,29,0,0,0,0
25,8479383,Boris Katchouk,L,,26,0,0,0,0
25,8475825,Jani Hakanpää,D,,32,0,0,0,0
25,8477846,Ryan Carpenter,C,,33,0,0,0,0
25,8477930,Pierre-Edouard Bellemare,L,,39,0,0,0,0
25,8478400,Colin White,C,,27,0,0,0,0
25,8480226,Marián Studenic,R,,26,0,0,0,0
25,8480853,Liam Foudy,C,,24,0,0,0,0
25,8475797,Jarred Tinordi,D,,32,0,0,0,0
25,8479423,Alex Nylander,L,,26,0,0,0,0
25,8474618,Marco Scandella,D,,34,0,0,0,0
25,8478028,Fredrik Olofsson,L,,28,0,0,0,0
25,8474709,Matt Martin,L,,35,0,0,0,0
25,8481070,Hugh McGing,L,,26,0,0,0,0
25,8479546,Oskar Steen,C,,26,0,0,0,0
25,8474145,Robert Bortuzzo,D,,35,0,0,0,0
25,8476915,Jujhar Khaira,L,,30,0,0,0,0
25,8475278,Byron Froese,C,,33,0,0,0,0
25,8481812,Nikolai Knyzhov,D,,27,0,0,0,0
25,8478408,Travis Dermott,D,,28,0,0,0,0
25,8481077,John Leonard,L,,26,0,0,0,0
25,8479547,Matthew Phillips,R,,26,0,0,0,0
25,8480836,Jonathan Gruden,C,,24,0,0,0,0
25,8481690,Tyler Angle,C,,24,0,0,0,0
25,8475766,Austin Watson,L,,32,0,0,0,0
25,8481016,Ruslan Iskhakov,C,,24,0,0,0,0
25,8478078,Rourke Chartier,C,,28,0,0,0,0
25,8480776,Sheldon Rempal,R,,29,0,0,0,0
25,8483045,Cameron Butler,R,CBJ,31,0,0,0,0
25,8484314,Jiri Smejkal,L,,28,0,0,0,0
26,8478402,Connor McDavid,C,EDM,27,74,41,113,154
26,8477492,Nathan MacKinnon,C,COL,29,82,44,83,127
26,8477934,Leon Draisaitl,C,EDM,29,78,48,78,126
26,8476453,Nikita Kucherov,R,TBL,31,82,37,85,122
26,8478550,Artemi Panarin,L,NYR,33,77,37,85,122
26,8479318,Auston Matthews,C,TOR,27,81,59,59,118
26,8479314,Matthew Tkachuk,L,FLA,27,79,37,81,118
26,8477956,David Pastrnak,R,BOS,28,81,50,62,112
26,8478445,Mathew Barzal,C,NYI,27,80,34,77,111
26,8478483,Mitch Marner,R,TOR,27,79,34,77,111
26,8478864,Kirill Kaprizov,L,MIN,27,77,53,57,110
26,8477939,William Nylander,R,TOR,28,78,51,58,109
26,8481559,Jack Hughes,C,NJD,23,72,50,54,104
26,8480023,Robert Thomas,C,STL,25,76,31,69,100
26,8477493,Aleksander Barkov,C,FLA,29,77,28,71,99
26,8476468,J.T. Miller,C,VAN,31,72,35,63,98
26,8480027,Jason Robertson,L,DAL,25,82,34,64,98
26,8480069,Cale Makar,D,COL,26,69,29,67,96
26,8475913,Mark Stone,R,VGK,32,77,30,65,95
26,8476389,Vincent Trocheck,C,NYR,31,78,27,68,95
26,8478420,Mikko Rantanen,R,COL,28,82,49,44,93
26,8482078,Lucas Raymond,L,DET,22,81,32,61,93
26,8482116,Tim Stützle,C,OTT,22,80,24,68,92
26,8474564,Steven Stamkos,C,NSH,34,73,44,46,90
26,8476459,Mika Zibanejad,C,NYR,31,81,30,60,90
26,8475692,Mats Zuccarello,R,MIN,37,73,25,65,90
26,8477946,Dylan Larkin,C,DET,28,82,40,49,89
26,8477942,Kevin Fiala,L,LAK,28,80,30,59,89
26,8478010,Brayden Point,C,TBL,28,82,45,43,88
26,8477960,Adrian Kempe,R,LAK,28,79,38,50,88
26,8475184,Chris Kreider,L,NYR,33,76,50,37,87
26,8477940,Nikolaj Ehlers,L,WPG,28,76,39,48,87
26,8478427,Sebastian Aho,C,CAR,27,76,35,52,87
26,8478403,Jack Eichel,C,VGK,28,74,40,45,85
26,8478398,Kyle Connor,L,WPG,28,71,39,46,85
26,8479323,Adam Fox,D,NYR,26,75,21,62,83
26,8476887,Filip Forsberg,L,NSH,30,73,42,40,82
26,8475166,John Tavares,C,TOR,34,80,31,51,82
26,8476539,Jonathan Marchessault,R,NSH,34,77,36,45,81
26,8480208,Drake Batherson,R,OTT,26,81,35,46,81
26,8471675,Sidney Crosby,C,PIT,37,71,25,56,81
26,8473419,Brad Marchand,L,BOS,36,79,24,57,81
26,8479420,Tage Thompson,C,BUF,27,74,44,36,80
26,8480002,Nico Hischier,C,NJD,25,80,25,55,80
26,8479407,Jesper Bratt,L,NJD,26,76,21,59,80
26,8480800,Quinn Hughes,D,VAN,25,76,14,66,80
26,8480830,Andrei Svechnikov,R,CAR,24,65,35,44,79
26,8480801,Brady Tkachuk,L,OTT,25,77,35,43,78
26,8479542,Brandon Hagel,L,TBL,26,82,35,43,78
26,8480012,Elias Pettersson,C,VAN,26,79,30,48,78
26,8477402,Pavel Buchnevich,L,STL,29,78,26,52,78
26,8484144,Connor Bedard,C,CHI,19,71,25,53,78
26,8474578,Erik Karlsson,D,PIT,34,80,19,59,78
26,8475167,Victor Hedman,D,TBL,34,79,19,59,78
26,8477504,Josh Morrissey,D,WPG,29,74,10,68,78
26,8475754,Brock Nelson,C,NYI,33,82,35,42,77
26,8471215,Evgeni Malkin,C,PIT,38,78,29,48,77
26,8476460,Mark Scheifele,C,WPG,31,75,26,51,77
26,8480036,Miro Heiskanen,D,DAL,25,78,17,60,77
26,8477404,Jake Guentzel,C,TBL,30,82,32,44,76
26,8478493,Joel Eriksson Ek,C,MIN,27,67,32,44,76
26,8477933,Sam Reinhart,C,FLA,29,78,42,33,75
26,8481557,Matt Boldy,L,MIN,23,70,34,41,75
26,8478444,Brock Boeser,R,VAN,27,72,41,33,74
26,8476881,Tomas Hertl,C,VGK,31,78,32,42,74
26,8475172,Nazem Kadri,C,CGY,34,78,26,48,74
26,8475158,Ryan O'Reilly,C,NSH,33,75,25,49,74
26,8475786,Zach Hyman,L,EDM,32,78,43,30,73
26,8479343,Clayton Keller,R,UTA,26,78,32,41,73
26,8478439,Travis Konecny,R,PHI,27,81,29,44,73
26,8476454,Ryan Nugent-Hopkins,C,EDM,31,82,21,52,73
26,8479385,Jordan Kyrou,C,STL,26,73,34,37,71
26,8477409,Carter Verhaeghe,C,FLA,29,74,33,38,71
26,8478401,Pavel Zacha,C,BOS,27,80,25,46,71
26,8475798,Mikael Granlund,C,SJS,32,64,16,55,71
26,8482745,Mason McTavish,C,ANA,21,70,36,34,70
26,8477501,Valeri Nichushkin,R,COL,29,81,33,37,70
26,8478449,Roope Hintz,C,DAL,28,81,31,39,70
26,8474600,Roman Josi,D,NSH,34,68,15,55,70
26,8473512,Claude Giroux,R,OTT,36,81,19,50,69
26,8480839,Rasmus Dahlin,D,BUF,24,73,14,55,69
26,8475784,Jeff Skinner,C,EDM,32,80,36,32,68
26,8476448,William Karlsson,C,VGK,31,77,35,33,68
26,8477496,Elias Lindholm,C,BOS,30,78,32,36,68
26,8474141,Patrick Kane,R,DET,36,80,20,48,68
26,8476456,Jonathan Huberdeau,C,CGY,31,78,19,49,68
26,8474590,John Carlson,D,WSH,34,71,12,56,68
26,8475726,Tyler Toffoli,C,SJS,32,71,42,25,67
26,8477500,Bo Horvat,C,NYI,29,81,30,37,67
26,8481528,Dylan Cozens,C,BUF,23,72,25,42,67
26,8477447,Shea Theodore,D,VGK,29,60,5,62,67
26,8480865,Noah Dobson,D,NYI,24,80,18,48,66
26,8478414,Timo Meier,R,NJD,28,75,29,36,65
26,8476346,Johnny Gaudreau,L,CBJ,31,71,20,44,64
26,8475765,Vladimir Tarasenko,R,DET,33,81,17,47,64
26,8476853,Morgan Rielly,D,TOR,30,64,13,51,64
26,8478440,Dylan Strome,C,WSH,27,72,29,34,63
26,8482684,Luke Hughes,D,NJD,21,73,11,52,63
26,8478873,Troy Terry,R,ANA,27,73,25,37,62
26,8477949,Alex Tuch,R,BUF,28,73,24,38,62
26,8478460,Zach Werenski,D,CBJ,27,80,14,48,62
26,8475810,Bryan Rust,R,PIT,32,72,29,32,61
26,8474102,David Perron,L,OTT,36,79,28,33,61
26,8479337,Alex DeBrincat,R,DET,27,80,26,35,61
26,8480015,Owen Tippett,R,PHI,25,73,24,37,61
26,8479325,Charlie McAvoy,D,BOS,27,76,13,48,61
26,8475799,Nino Niederreiter,R,WPG,32,73,33,27,60
26,8481540,Cole Caufield,R,MTL,23,72,28,32,60
26,8477407,Anthony Duclair,L,NYI,29,79,27,33,60
26,8480803,Evan Bouchard,D,EDM,25,76,14,46,60
26,8482740,Wyatt Johnston,C,DAL,21,82,32,27,59
26,8476432,Boone Jenner,C,CBJ,31,68,30,29,59
26,8479987,Morgan Geekie,C,BOS,26,73,28,31,59
26,8471685,Anze Kopitar,C,LAK,37,81,18,41,59
26,8478407,Vince Dunn,D,SEA,28,73,10,49,59
26,8477456,J.T. Compher,L,DET,29,80,28,30,58
26,8477955,Jared McCann,L,SEA,28,71,27,31,58
26,8475168,Matt Duchene,C,DAL,33,81,24,34,58
26,8480018,Nick Suzuki,C,MTL,25,78,20,38,58
26,8482124,Quinton Byfield,R,LAK,22,80,19,39,58
26,8478047,Michael Bunting,L,PIT,29,72,26,31,57
26,8479675,Trevor Moore,L,LAK,29,78,27,29,56
26,8476399,Blake Coleman,C,CGY,33,78,26,30,56
26,8484153,Leo Carlsson,C,ANA,20,72,19,37,56
26,8481604,Pavel Dorofeyev,L,VGK,24,67,33,22,55
26,8475151,Kyle Palmieri,C,NYI,33,75,25,30,55
26,8475170,Brayden Schenn,C,STL,33,71,25,30,55
26,8477951,Nick Schmaltz,C,UTA,28,73,23,32,55
26,8475794,Tyler Seguin,C,DAL,32,81,18,37,55
26,8476905,Chandler Stephenson,C,SEA,30,73,15,40,55
26,8481533,Trevor Zegras,C,ANA,23,74,26,28,54
26,8478975,Mason Marchment,L,DAL,29,82,25,29,54
26,8484166,Adam Fantilli,C,CBJ,20,63,24,30,54
26,8474150,Mikael Backlund,C,CGY,35,77,20,34,54
26,8474679,Gustav Nyquist,C,NSH,35,71,17,37,54
26,8482699,Dylan Guenther,R,UTA,21,75,17,37,54
26,8481542,Moritz Seider,D,DET,23,79,14,40,54
26,8478519,Anthony Cirelli,C,TBL,27,81,25,28,53
26,8478462,Nicolas Roy,C,VGK,27,75,22,31,53
26,8478458,John (Jack) Roslovic,C,CAR,27,68,15,38,53
26,8471724,Kris Letang,D,PIT,37,80,8,45,53
26,8475314,Anders Lee,L,NYI,34,79,34,18,52
26,8479425,Filip Hronek,D,VAN,27,73,12,40,52
26,8478498,Jake DeBrusk,L,VAN,28,73,27,24,51
26,8480028,Morgan Frost,C,PHI,25,76,21,30,51
26,8478233,Andrew Mangiapane,L,WSH,28,71,19,32,51
26,8475745,Charlie Coyle,C,BOS,32,75,17,34,51
26,8479999,Casey Mittelstadt,C,COL,26,81,14,37,51
26,8476875,Mike Matheson,D,MTL,30,74,12,39,51
26,8482665,Matty Beniers,C,SEA,22,75,23,27,50
26,8477416,Oliver Bjorkstrand,R,SEA,29,69,19,31,50
26,8482109,Alexis Lafrenière,L,NYR,23,70,18,32,50
26,8477451,Ryan Hartman,R,MIN,30,67,18,32,50
26,8473986,Alex Killorn,L,ANA,35,71,16,34,50
26,8476462,Dougie Hamilton,D,NJD,31,75,15,35,50
26,8482110,Dawson Mercer,C,NJD,23,73,25,24,49
26,8483515,Juraj Slafkovsky,L,MTL,20,72,22,27,49
26,8481596,Shane Pinto,C,OTT,24,77,22,27,49
26,8478856,Conor Garland,R,VAN,28,74,21,28,49
26,8474641,Adam Henrique,C,EDM,34,77,18,31,49
26,8477998,Warren Foegele,L,LAK,28,80,16,33,49
26,8482720,Matthew Knies,L,TOR,22,75,16,33,49
26,8471698,T.J. Oshie,R,WSH,38,66,30,18,48
26,8471214,Alex Ovechkin,L,WSH,39,73,24,24,48
26,8480797,Joel Farabee,L,PHI,24,70,24,24,48
26,8479365,Trent Frederic,C,BOS,26,79,23,25,48
26,8473994,Jamie Benn,L,DAL,35,82,20,28,48
26,8480039,Martin Necas,C,CAR,25,65,17,31,48
26,8477346,MacKenzie Weegar,D,CGY,30,75,16,32,48
26,8481577,Philip Tomasino,C,NSH,23,61,15,33,48
26,8476882,Teuvo Teravainen,C,CHI,30,68,13,35,48
26,8478438,Tommy Novak,C,NSH,27,71,9,39,48
26,8470613,Brent Burns,D,CAR,39,76,6,42,48
26,8476483,Rickard Rakell,R,PIT,31,72,26,21,47
26,8482702,Logan Stankoven,C,DAL,21,79,22,25,47
26,8474586,Jordan Eberle,R,SEA,34,75,19,28,47
26,8476479,Phillip Danault,C,LAK,31,78,14,33,47
26,8477986,Brandon Montour,D,SEA,30,72,12,35,47
26,8478469,Thomas Chabot,D,OTT,27,70,11,36,47
26,8481560,Arthur Kaliyev,R,LAK,23,78,26,20,46
26,8476880,Tom Wilson,R,WSH,30,68,21,25,46
26,8483431,Logan Cooley,C,UTA,20,77,19,27,46
26,8484145,Zach Benson,L,BUF,19,66,17,29,46
26,8478042,Viktor Arvidsson,L,EDM,31,77,14,32,46
26,8477932,Aaron Ekblad,D,FLA,28,72,13,33,46
26,8476792,Torey Krug,D,STL,33,65,6,40,46
26,8478396,Noah Hanifin,D,VGK,27,60,17,28,45
26,8482667,William Eklund,L,SJS,22,68,12,33,45
26,8474565,Alex Pietrangelo,D,VGK,34,64,10,35,45
26,8476854,Hampus Lindholm,D,BOS,30,75,10,35,45
26,8474563,Drew Doughty,D,LAK,35,63,10,35,45
26,8480188,Fabian Zetterlund,L,SJS,25,62,27,17,44
26,8482113,Anton Lundell,C,FLA,23,80,26,18,44
26,8481068,Yegor Sharangovich,C,CGY,26,76,26,18,44
26,8479353,Brett Howden,C,VGK,26,67,19,25,44
26,8477964,Ivan Barbashev,C,VGK,29,71,16,28,44
26,8479345,Jakob Chychrun,D,WSH,26,68,15,29,44
26,8480145,Neal Pionk,D,WPG,29,72,11,33,44
26,8481703,Valtteri Puustinen,R,PIT,25,67,10,34,44
26,8476872,Scott Laughton,C,PHI,30,74,9,35,44
26,8480014,Gabriel Vilardi,C,WPG,25,64,28,15,43
26,8477476,Artturi Lehkonen,L,COL,29,81,21,22,43
26,8476906,Shayne Gostisbehere,D,CAR,31,76,10,33,43
26,8475764,Cam Fowler,D,ANA,33,75,0,43,43
26,8482089,Jake Neighbours,L,STL,22,73,27,15,42
26,8477952,Robby Fabbri,C,ANA,28,63,20,22,42
26,8477444,Andre Burakovsky,L,SEA,29,68,18,24,42
26,8479400,Pierre-Luc Dubois,L,WSH,26,65,17,25,42
26,8480798,Philipp Kurashev,C,CHI,25,68,15,27,42
26,8479525,Ross Colton,C,COL,28,78,14,28,42
26,8482097,Jack Quinn,R,BUF,23,65,14,28,42
26,8483505,Matthew Poitras,C,BOS,20,74,14,28,42
26,8477948,Travis Sanheim,D,PHI,28,65,11,31,42
26,8476869,Brady Skjei,D,NSH,30,67,11,31,42
26,8479339,Patrik Laine,L,CBJ,26,63,10,32,42
26,8476923,Damon Severson,D,CBJ,30,79,9,33,42
26,8482133,Thomas Bordeleau,C,SJS,22,65,9,33,42
26,8475753,Justin Faulk,D,STL,32,76,7,35,42
26,8478366,Frank Vatrano,R,ANA,30,69,22,19,41
26,8476474,Stefan Noesen,R,NJD,31,72,20,21,41
26,8482093,Seth Jarvis,C,CAR,22,61,19,22,41
26,8478474,Lawson Crouse,L,UTA,27,72,19,22,41
26,8475191,Reilly Smith,R,NYR,33,75,18,23,41
26,8475848,Brendan Gallagher,R,MTL,32,68,18,23,41
26,8482149,Cole Perfetti,C,WPG,22,67,12,29,41
26,8477503,Max Domi,C,TOR,29,72,11,30,41
26,8481524,Bowen Byram,D,BUF,23,70,10,31,41
26,8477494,Jonathan Drouin,L,COL,29,81,9,32,41
26,8477498,Darnell Nurse,D,EDM,29,72,9,32,41
26,8480009,Eeli Tolvanen,R,SEA,25,68,21,19,40
26,8482159,Tyson Foerster,R,PHI,22,71,21,19,40
26,8482074,Connor Zary,C,CGY,23,64,21,19,40
26,8476925,Colton Sissons,C,NSH,31,70,18,22,40
26,8473422,Nick Foligno,L,CHI,37,66,17,23,40
26,8479661,Tanner Jeannot,L,LAK,27,76,17,23,40
26,8474149,Evgenii Dadonov,R,DAL,35,79,14,26,40
26,8476958,Jaccob Slavin,D,CAR,30,76,6,34,40
26,8477935,Sam Bennett,C,FLA,28,76,22,17,39
26,8480064,Josh Norris,C,OTT,25,76,22,17,39
26,8477426,Nicholas Paul,L,TBL,29,82,20,19,39
26,8479591,Michael Eyssimont,C,TBL,28,82,18,21,39
26,8476826,Yanni Gourde,C,SEA,33,73,13,26,39
26,8477495,Seth Jones,D,CHI,30,70,13,26,39
26,8476292,Ondrej Palat,L,NJD,33,70,11,28,39
26,8478055,Gustav Forsling,D,FLA,28,71,10,29,39
26,8477425,Miles Wood,L,COL,29,76,20,18,38
26,8475287,Erik Haula,L,NJD,33,72,14,24,38
26,8478463,Anthony Beauvillier,L,PIT,27,68,14,24,38
26,8477429,Andrew Copp,C,DET,30,76,13,25,38
26,8475218,Mattias Ekholm,D,EDM,34,74,11,27,38
26,8476917,Adam Pelech,D,NYI,30,81,8,30,38
26,8474151,Ryan McDonagh,D,TBL,35,79,5,33,38
26,8475768,Jaden Schwartz,C,SEA,32,74,23,14,37
26,8479293,Brandon Tanev,L,SEA,33,68,19,18,37
26,8477953,Kasperi Kapanen,R,STL,28,65,17,20,37
26,8479996,Cody Glass,C,NSH,25,62,17,20,37
26,8477839,Conor Sheary,L,TBL,32,81,14,23,37
26,8481581,Thomas Harley,D,DAL,23,76,13,24,37
26,8477021,Alex Kerfoot,C,UTA,30,73,11,26,37
26,8475722,Jason Zucker,L,BUF,32,63,9,28,37
26,8482475,Yegor Chinakhov,R,CBJ,23,63,22,14,36
26,8475763,Kevin Hayes,R,PIT,32,68,20,16,36
26,8478020,Michael Amadio,R,OTT,28,75,18,18,36
26,8482092,Ridly Greig,C,OTT,22,73,17,19,36
26,8480813,Joe Veleno,C,DET,24,78,17,19,36
26,8483808,Andrei Kuzmenko,L,CGY,28,75,16,20,36
26,8481618,Alex Newhook,C,MTL,23,69,15,21,36
26,8481186,Logan O'Connor,R,COL,28,81,15,21,36
26,8475169,Evander Kane,L,EDM,33,70,24,11,35
26,8478115,Pierre Engvall,L,NYI,28,76,24,11,35
26,8480459,Pius Suter,C,VAN,28,67,20,15,35
26,8477497,Sean Monahan,C,CBJ,30,70,17,18,35
26,8476392,Adam Lowry,C,WPG,31,64,17,18,35
26,8475760,Nick Bjugstad,C,UTA,32,72,16,19,35
26,8474716,Jared Spurgeon,D,MIN,35,77,13,22,35
26,8476927,Teddy Blueger,C,VAN,30,71,11,24,35
26,8477479,Tyler Bertuzzi,L,CHI,29,61,11,24,35
26,8478882,Vladislav Gavrikov,D,LAK,29,73,10,25,35
26,8480434,Sean Durzi,D,UTA,26,66,9,26,35
26,8482105,Jake Sanderson,D,OTT,22,75,9,26,35
26,8478911,Matt Roy,D,WSH,29,71,9,26,35
26,8482055,Drew O'Connor,L,PIT,26,63,19,15,34
26,8476438,Brandon Saad,L,STL,32,70,16,18,34
26,8477989,Christian Dvorak,C,MTL,28,70,13,21,34
26,8478542,Evan Rodrigues,C,FLA,31,74,10,24,34
26,8478038,Devon Toews,D,COL,30,65,8,26,34
26,8479410,Mikhail Sergachev,D,UTA,26,72,7,27,34
26,8480817,K'Andre Miller,D,NYR,24,70,5,29,34
26,8482671,Owen Power,D,BUF,22,59,10,23,33
26,8482660,Kent Johnson,C,CBJ,22,68,10,23,33
26,8474053,Logan Couture,C,SJS,35,63,8,25,33
26,8482122,Brock Faber,D,MIN,22,78,4,29,33
26,8480893,Kirill Marchenko,R,CBJ,24,60,20,12,32
26,8478466,Daniel Sprong,R,VAN,27,71,16,16,32
26,8480829,Jesperi Kotkaniemi,C,CAR,24,70,15,17,32
26,8482157,Will Cuylle,L,NYR,22,62,15,17,32
26,8477987,Ryan Donato,C,CHI,28,53,14,18,32
26,8477969,Marcus Pettersson,D,PIT,28,80,6,26,32
26,8483490,Pavel Mintyukov,D,ANA,21,75,5,27,32
26,8482705,Cole Sillinger,C,CBJ,21,64,17,14,31
26,8476921,Jordan Martinook,L,CAR,32,59,16,15,31
26,8479351,Sam Steel,C,DAL,26,78,15,16,31
26,8480185,Eetu Luostarinen,C,FLA,26,78,14,17,31
26,8478013,Jake Walman,D,SJS,28,73,13,18,31
26,8476885,Jacob Trouba,D,NYR,30,71,12,19,31
26,8480113,Alex Iafallo,L,WPG,31,58,11,20,31
26,8481711,Matias Maccelli,L,UTA,24,77,10,21,31
26,8475793,Ryan Johansen,C,PHI,32,73,10,21,31
26,8476480,Vladislav Namestnikov,C,WPG,32,64,9,22,31
26,8482175,JJ Peterka,R,BUF,22,72,21,9,30
26,8481517,Brett Leason,R,ANA,25,57,20,10,30
26,8482146,Luke Evangelista,R,NSH,22,67,15,15,30
26,8477505,Alexander Wennberg,C,SJS,30,63,15,15,30
26,8481535,Nils Hoglander,L,VAN,24,69,14,16,30
26,8474715,Cameron Atkinson,R,TBL,35,82,13,17,30
26,8478057,Dakota Joshua,C,VAN,28,64,13,17,30
26,8478891,Mason Appleton,C,WPG,28,56,13,17,30
26,8480802,Ryan McLeod,C,BUF,25,65,12,18,30
26,8476461,Sean Couturier,C,PHI,32,70,10,20,30
26,8480003,Jesper Boqvist,C,FLA,26,74,10,20,30
26,8475193,Tomas Tatar,L,NJD,34,70,9,21,30
26,8480871,Adam Boqvist,D,FLA,24,70,9,21,30
26,8479639,Dylan Coghlan,D,WPG,26,62,9,21,30
26,8482148,Hendrix Lapierre,C,WSH,22,56,9,21,30
26,8479402,Jake Bean,D,CGY,26,64,4,26,30
26,8477506,Ryan Pulock,D,NYI,30,76,2,28,30
26,8480049,Dylan Samberg,D,WPG,25,64,2,28,30
26,8479393,Noah Gregor,L,OTT,26,70,20,9,29
26,8482079,Marco Rossi,C,MIN,23,69,19,10,29
26,8479992,Michael Rasmussen,C,DET,25,78,17,12,29
26,8478413,Jordan Greenway,L,BUF,27,64,15,14,29
26,8480068,Ryan Poehling,C,PHI,25,67,15,14,29
26,8481523,Kirby Dach,C,MTL,23,64,12,17,29
26,8477446,Michael McCarron,R,NSH,29,59,12,17,29
26,8481441,Joe Snively,C,DET,28,63,12,17,29
26,8475200,Dmitry Orlov,D,CAR,33,75,11,18,29
26,8481704,Juuso Parssinen,C,NSH,23,53,11,18,29
26,8476419,Jean-Gabriel Pageau,C,NYI,32,79,9,20,29
26,8477499,Rasmus Ristolainen,D,PHI,30,61,9,20,29
26,8476879,Cody Ceci,D,EDM,31,71,7,22,29
26,8476902,Esa Lindell,D,DAL,30,75,5,24,29
26,8478397,Rasmus Andersson,D,CGY,28,67,4,25,29
26,8482712,Oskar Olausson,R,COL,22,77,2,27,29
26,8481582,Nicholas Robertson,L,TOR,23,72,20,8,28
26,8470621,Corey Perry,R,EDM,39,72,17,11,28
26,8478109,Victor Olofsson,L,VGK,29,73,14,14,28
26,8480078,Filip Chytil,C,NYR,25,70,13,15,28
26,8479336,Carl Grundstrom,R,SJS,27,59,12,16,28
26,8480835,Jack Drury,C,CAR,24,57,11,17,28
26,8476458,Ryan Strome,C,ANA,31,70,9,19,28
26,8484203,Bradly Nadeau,L,CAR,19,69,9,19,28
26,8477511,Anthony Mantha,R,CGY,30,75,8,20,28
26,8478133,Jake Evans,C,MTL,28,70,4,24,28
26,8478500,Ivan Provorov,D,CBJ,27,78,2,26,28
26,8481606,Jordan Spence,D,LAK,23,59,1,27,28
26,8479941,Justin Danforth,R,CBJ,31,65,15,12,27
26,8475791,Taylor Hall,L,CHI,33,61,13,14,27
26,8476878,Zemgus Girgensons,C,TBL,30,79,13,14,27
26,8475714,Calle Jarnkrok,C,TOR,33,78,12,15,27
26,8475149,Marcus Johansson,L,MIN,34,59,10,17,27
26,8478046,Danton Heinen,L,VAN,29,63,9,18,27
26,8482111,Justin Barron,D,MTL,23,69,9,18,27
26,8477220,Nate Schmidt,D,FLA,33,65,5,22,27
26,8481624,Ilya Mikheyev,R,CHI,30,56,16,10,26
26,8476960,Andreas Athanasiou,C,CHI,30,56,14,12,26
26,8477392,Hudson Fasching,R,NYI,29,61,13,13,26
26,8479316,Luke Kunin,C,SJS,27,66,13,13,26
26,8483491,Ivan Miroshnichenko,L,WSH,20,60,12,14,26
26,8474189,Lars Eller,C,PIT,35,66,12,14,26
26,8482749,Joshua Roy,R,MTL,21,67,10,16,26
26,8482101,Danil Gushchin,L,SJS,22,52,10,16,26
26,8476278,Colin Blackwell,C,DAL,31,79,9,17,26
26,8475171,Oliver Ekman-Larsson,D,TOR,33,68,7,19,26
26,8476312,Josh Manson,D,COL,33,66,5,21,26
26,8476463,Jonas Brodin,D,MIN,31,76,5,21,26
26,8479983,Mario Ferraro,D,SJS,26,68,5,21,26
26,8480873,Rasmus Sandin,D,WSH,24,68,3,23,26
26,8477353,Tyler Motte,C,DET,29,75,16,9,25
26,8476469,Joel Armia,R,MTL,31,66,13,12,25
26,8473533,Jordan Staal,C,CAR,36,66,13,12,25
26,8483493,Frank Nazar,C,CHI,20,56,10,15,25
26,8482117,Lukas Reichel,L,CHI,22,51,9,16,25
26,8483565,Nick Blankenburg,D,NSH,26,64,8,17,25
26,8480222,Sebastian Aho,D,PIT,28,71,8,17,25
26,8479398,Samuel Girard,D,COL,26,58,4,21,25
26,8482087,Kaiden Guhle,D,MTL,22,70,1,24,25
26,8481032,Paul Cotter,C,NJD,25,60,15,9,24
26,8476897,Oskar Sundqvist,C,STL,30,67,11,13,24
26,8480849,Barrett Hayton,C,UTA,24,77,10,14,24
26,8481553,Bobby Brink,R,PHI,23,61,10,14,24
26,8483524,Shane Wright,C,SEA,20,62,9,15,24
26,8475181,Nick Leddy,D,STL,33,73,5,19,24
26,8475188,Brayden McNabb,D,VGK,33,62,2,22,24
26,8478585,Derek Ryan,C,EDM,38,59,10,13,23
26,8476467,Jamie Oleksiak,D,SEA,32,68,9,14,23
26,8477947,Sonny Milano,L,WSH,28,63,8,15,23
26,8481656,Aliaksei Protas,C,WSH,23,64,8,15,23
26,8478136,Jake Middleton,D,MIN,28,75,7,16,23
26,8482624,Daniil Miromanov,D,CGY,27,63,6,17,23
26,8479324,Ryan Lindgren,D,NYR,26,61,6,17,23
26,8478434,Keegan Kolesar,R,VGK,27,68,6,17,23
26,8479371,Dante Fabbro,D,NSH,26,66,4,19,23
26,8483445,Cutter Gauthier,L,ANA,20,71,4,19,23
26,8482067,Connor Mackey,D,NYR,28,66,3,20,23
26,8476422,Mike Reilly,D,NYI,31,74,2,21,23
26,8481059,Scott Perunovich,D,STL,26,62,0,23,23
26,8480220,Noah Cates,L,PHI,25,72,13,9,22
26,8475855,Jesper Fast,R,CAR,33,55,11,11,22
26,8476981,Josh Anderson,R,MTL,30,73,11,11,22
26,8478432,Christian Fischer,R,DET,27,69,10,12,22
26,8483495,Simon Nemec,D,NJD,20,60,10,12,22
26,8480748,Kiefer Sherwood,L,VAN,29,61,9,13,22
26,8478508,Yakov Trenin,C,MIN,27,59,9,13,22
26,8481601,Simon Holmstrom,R,NYI,23,69,9,13,22
26,8481028,Martin Pospisil,C,CGY,25,56,9,13,22
26,8475231,Casey Cizikas,C,NYI,33,73,8,14,22
26,8475220,Marcus Foligno,L,MIN,33,61,7,15,22
26,8480172,Jan Rutta,D,SJS,34,67,7,15,22
26,8480355,Mark Kastelic,C,BOS,25,53,7,15,22
26,8475343,Nic Dowd,C,WSH,34,66,6,16,22
26,8476856,Mathew Dumba,D,DAL,30,65,6,16,22
26,8478970,Jalen Chatfield,D,CAR,28,65,5,17,22
26,8481014,Alexander Romanov,D,NYI,24,74,5,17,22
26,8481546,Cam York,D,PHI,23,67,4,18,22
26,8480043,Timothy Liljegren,D,TOR,25,68,4,18,22
26,8482451,Mikael Pyyhtia,L,CBJ,23,45,4,18,22
26,8478851,Alexandre Carrier,D,NSH,28,68,2,20,22
26,8475324,Nick Jensen,D,OTT,34,72,2,20,22
26,8480762,Eric Robinson,L,CAR,29,58,15,6,21
26,8478043,Sam Lafferty,C,BUF,29,60,14,7,21
26,8480995,Pontus Holmberg,R,TOR,25,62,14,7,21
26,8479619,Michael Carcone,L,UTA,28,61,13,8,21
26,8480205,Emil Bemstrom,C,PIT,25,53,13,8,21
26,8477380,Jonny Brodzinski,C,NYR,31,57,12,9,21
26,8482125,Alexander Holtz,R,VGK,22,70,11,10,21
26,8477508,Curtis Lazar,C,NJD,29,55,11,10,21
26,8481554,Kaapo Kakko,R,NYR,23,65,10,11,21
26,8476918,Jimmy Vesey,L,NYR,31,67,10,11,21
26,8479520,Brandon Duhaime,R,WSH,27,54,10,11,21
26,8483468,Jiri Kulich,C,BUF,20,52,7,14,21
26,8481013,Jonatan Berggren,R,DET,24,61,7,14,21
26,8476891,Matthew Grzelcyk,D,PIT,30,78,5,16,21
26,8476892,Colton Parayko,D,STL,31,71,4,17,21
26,8473563,Nicklas Backstrom,C,WSH,37,52,4,17,21
26,8481522,Peyton Krebs,C,BUF,23,61,4,17,21
26,8482655,Janis Moser,D,TBL,24,77,2,19,21
26,8479982,Conor Timmins,D,TOR,26,57,2,19,21
26,8477406,Mattias Janmark,C,EDM,32,63,11,9,20
26,8476374,Sean Kuraly,C,CBJ,31,58,11,9,20
26,8480789,Oliver Wahlstrom,R,NYI,24,70,9,11,20
26,8484149,Gavin Brindley,C,CBJ,20,46,9,11,20
26,8476889,Radek Faksa,C,STL,30,64,8,12,20
26,8476873,Mark Jankowski,C,NSH,30,55,7,13,20
26,8479315,Joey Anderson,R,CHI,26,51,7,13,20
26,8480336,Sean Walker,D,CAR,30,68,6,14,20
26,8481527,Kaedan Korczak,D,VGK,23,52,6,14,20
26,8477488,Brett Pesce,D,NJD,30,72,5,15,20
26,8474673,TJ Brodie,D,CHI,34,60,5,15,20
26,8476457,Adam Larsson,D,SEA,32,64,4,16,20
26,8476525,Colin Miller,D,WPG,32,64,4,16,20
26,8477435,Ryan Graves,D,PIT,29,76,3,17,20
26,8482142,Jamie Drysdale,D,PHI,22,65,3,17,20
26,8476979,Erik Gustafsson,D,DET,32,75,2,18,20
26,8481580,Connor McMichael,C,WSH,23,57,14,5,19
26,8479368,Max Jones,L,BOS,26,67,10,9,19
26,8482809,Jackson Blake,R,CAR,21,63,9,10,19
26,8473453,Trevor Lewis,C,LAK,37,73,8,11,19
26,8480144,David Kampf,C,TOR,29,67,8,11,19
26,8479328,Julien Gauthier,R,NYI,27,60,7,12,19
26,8479980,Nicolas Hague,D,VGK,26,55,7,12,19
26,8479390,Taylor Raddysh,R,WSH,26,59,6,13,19
26,8480950,Ilya Lyubushkin,D,DAL,30,62,5,14,19
26,8479026,Philippe Myers,D,TOR,27,57,4,15,19
26,8480891,Michael Kesselring,D,UTA,24,65,4,15,19
26,8480727,Zach Whitecloud,D,VGK,28,45,3,16,19
26,8474574,Tyler Myers,D,VAN,34,65,3,16,19
26,8483499,Liam Ohgren,L,MIN,20,55,3,16,19
26,8477369,Carson Soucy,D,VAN,30,70,2,17,19
26,8482245,Artem Zub,D,OTT,29,70,2,17,19
26,8475690,Chris Tanev,D,TOR,35,66,2,17,19
26,8479414,Nathan Bastian,R,NJD,27,58,11,7,18
26,8483482,Tristan Luneau,D,ANA,20,62,11,7,18
26,8477478,William Carrier,L,CAR,30,61,10,8,18
26,8477903,Garnet Hathaway,R,PHI,33,63,9,9,18
26,8483457,Lane Hutson,D,MTL,20,68,8,10,18
26,8481481,Blake Lizotte,C,PIT,27,55,8,10,18
26,8478451,Ethan Bear,D,WSH,27,59,8,10,18
26,8482803,Olen Zellweger,D,ANA,21,67,7,11,18
26,8475279,Ben Chiarot,D,DET,33,66,6,12,18
26,8477015,Connor Brown,R,EDM,30,60,6,12,18
26,8476624,Barclay Goodrow,C,SJS,31,51,6,12,18
26,8480073,Erik Brannstrom,D,COL,25,61,6,12,18
26,8477507,Nikita Zadorov,D,BOS,29,69,4,14,18
26,8482192,Isaak Phillips,D,CHI,23,53,4,14,18
26,8476331,Dylan DeMelo,D,WPG,31,66,4,14,18
26,8480860,Kevin Bahl,D,CGY,24,58,4,14,18
26,8473507,Jeff Petry,D,DET,37,70,2,16,18
26,8477365,Connor Clifton,D,BUF,29,51,2,16,18
26,8481178,Egor Zamula,D,PHI,24,58,1,17,18
26,8480289,Morgan Barron,C,WPG,26,56,10,7,17
26,8480281,Alexey Toropchenko,R,STL,25,58,10,7,17
26,8480448,Parker Kelly,L,COL,25,73,9,8,17
26,8482679,Matt Coronato,R,CGY,22,66,8,9,17
26,8482259,Bobby McMann,C,TOR,28,69,8,9,17
26,8477450,Jason Dickinson,C,CHI,29,58,8,9,17
26,8480855,Jack McBain,C,UTA,24,67,7,10,17
26,8480011,Klim Kostin,C,SJS,25,53,7,10,17
26,8481019,David Gustafsson,C,WPG,24,51,4,13,17
26,8478507,John Marino,D,UTA,27,71,4,13,17
26,8470600,Ryan Suter,D,STL,39,59,4,13,17
26,8480878,Nils Lundkvist,D,DAL,24,75,3,14,17
26,8479998,Mikey Anderson,D,LAK,25,71,1,16,17
26,8480021,Jack Studnicka,C,LAK,25,60,12,4,16
26,8475842,Sam Carrick,C,NYR,32,53,12,4,16
26,8482737,Zack Bolduc,C,STL,21,57,10,6,16
26,8481093,Rafael Harvey-Pinard,L,MTL,25,55,9,7,16
26,8479344,Jesse Puljujarvi,R,PIT,26,60,8,8,16
26,8479718,Alex Barré-Boulet,C,MTL,27,54,7,9,16
26,8476988,Matt Benning,D,SJS,30,71,5,11,16
26,8480246,Nick Perbix,D,TBL,26,73,4,12,16
26,8477919,Frederick Gaudreau,C,MIN,31,62,4,12,16
26,8482807,Ethan Del Mastro,D,CHI,21,49,3,13,16
26,8480035,Henri Jokiharju,D,BUF,25,60,3,13,16
26,8482176,Wyatt Kaiser,D,CHI,22,57,2,14,16
26,8476931,Jake McCabe,D,TOR,31,67,1,15,16
26,8480074,Alexandre Texier,C,STL,25,52,10,5,15
26,8477979,Nicolas Aube-Kubel,R,BUF,28,55,8,7,15
26,8479066,Ryan Lomberg,L,CGY,30,67,7,8,15
26,8478472,Mathieu Joseph,R,STL,27,62,6,9,15
26,8481567,Henry Thrun,D,SJS,23,50,6,9,15
26,8482666,Scott Morrow,D,CAR,22,56,6,9,15
26,8480070,Ian Mitchell,D,BOS,25,48,4,11,15
26,8481477,Nico Sturm,C,SJS,29,53,3,12,15
26,8481568,Alex Vlasic,D,CHI,23,53,3,12,15
26,8478178,Darren Raddysh,D,TBL,28,72,3,12,15
26,8481161,Jake Christiansen,D,CBJ,25,57,3,12,15
26,8479249,Andrew Poturalski,C,SJS,30,38,3,12,15
26,8480807,Mattias Samuelsson,D,BUF,24,55,2,13,15
26,8481641,Joel Kiviranta,L,COL,28,71,11,3,14
26,8482077,Dylan Holloway,L,EDM,23,58,10,4,14
26,8482155,Alex Laferriere,R,LAK,23,62,9,5,14
26,8478211,Dryden Hunt,L,CGY,29,53,9,5,14
26,8481617,Vasily Podkolzin,R,VAN,23,48,9,5,14
26,8480252,Cole Guttman,C,CHI,25,44,8,6,14
26,8476822,Luke Glendening,C,TBL,35,79,8,6,14
26,8477573,Nathan Walker,L,STL,30,45,5,9,14
26,8476329,Travis Boyd,C,MIN,31,59,4,10,14
26,8480441,Trey Fix-Wolansky,R,CBJ,25,36,4,10,14
26,8480980,Connor Dewar,C,TOR,25,62,4,10,14
26,8480796,Martin Fehervary,D,WSH,25,53,4,10,14
26,8481167,Brayden Pachal,D,CGY,25,49,4,10,14
26,8479369,Andrew Peeke,D,BOS,26,65,4,10,14
26,8474612,Travis Hamonic,D,OTT,34,47,4,10,14
26,8474166,Alec Martinez,D,CHI,37,55,4,10,14
26,8479976,Juuso Valimaki,D,UTA,26,61,3,11,14
26,8475208,Brian Dumoulin,D,ANA,33,63,3,11,14
26,8482744,James Malatesta,L,CBJ,21,48,3,11,14
26,8475790,Erik Gudbranson,D,CBJ,32,76,2,12,14
26,8476967,Brett Kulak,D,EDM,30,63,2,12,14
26,8477034,Jaycob Megna,D,FLA,32,52,2,12,14
26,8478416,Erik Cernak,D,TBL,27,74,1,13,14
26,8480001,Urho Vaakanainen,D,ANA,25,58,1,13,14
26,8476429,Scott Mayfield,D,NYI,32,75,0,14,14
26,8478831,Kevin Stenlund,C,UTA,28,54,9,4,13
26,8481789,Tye Kartye,L,SEA,23,42,7,6,13
26,8474034,Patrick Maroon,L,CHI,36,47,6,7,13
26,8478859,Niko Mikkola,D,FLA,28,60,5,8,13
26,8478569,Noel Acciari,C,PIT,33,50,4,9,13
26,8479378,Logan Stanley,D,WPG,26,49,4,9,13
26,8479543,Michael Pezzetta,L,MTL,26,59,3,10,13
26,8478443,Brandon Carlo,D,BOS,28,57,3,10,13
26,8475718,Justin Holl,D,DET,32,62,2,11,13
26,8477845,Trevor van Riemsdyk,D,WSH,33,48,1,12,13
26,8481708,Zac Jones,D,NYR,24,52,1,12,13
26,8475455,Brenden Dillon,D,NJD,34,62,1,12,13
26,8480025,MacKenzie Entwistle,R,FLA,25,62,9,3,12
26,8482659,Josh Doan,R,UTA,22,55,8,4,12
26,8479972,Mason Shaw,C,WPG,26,39,8,4,12
26,8481754,Nikita Nesterenko,C,ANA,23,35,7,5,12
26,8483466,Kevin Korchinski,D,CHI,20,51,6,6,12
26,8478421,A.J. Greer,L,FLA,28,58,5,7,12
26,8482859,Zack Ostapchuk,C,OTT,21,52,5,7,12
26,8476994,Vinnie Hinostroza,C,NSH,30,39,5,7,12
26,8481532,Alex Turcotte,C,LAK,23,48,5,7,12
26,8480157,Calle Rosen,D,COL,30,45,4,8,12
26,8477018,Ben Hutton,D,VGK,31,43,4,8,12
26,8479370,Tyson Jost,C,CAR,26,55,4,8,12
26,8480007,Jonas Rondbjerg,R,VGK,25,44,3,9,12
26,8475462,Radko Gudas,D,ANA,34,58,2,10,12
26,8479348,Kale Clague,D,BUF,26,47,2,10,12
26,8482073,Braden Schneider,D,NYR,23,61,1,11,12
26,8479291,Kevin Rooney,C,CGY,31,46,8,3,11
26,8482062,Cole Smith,L,NSH,29,61,7,4,11
26,8476867,Brendan Gaunce,C,MIN,30,30,6,5,11
26,8479994,Jaret Anderson-Dolan,C,WPG,25,34,6,5,11
26,8480806,Isac Lundestrom,C,ANA,25,56,5,6,11
26,8483549,Lucas Condotta,L,MTL,27,33,5,6,11
26,8480192,Johnathan Kovacevic,D,NJD,27,47,5,6,11
26,8481521,Ronnie Attard,D,PHI,25,57,4,7,11
26,8475235,Nicolas Deslauriers,L,PHI,33,54,3,8,11
26,8477070,Liam O'Brien,C,UTA,30,46,3,8,11
26,8474567,Zach Bogosian,D,MIN,34,61,2,9,11
26,8471677,Jack Johnson,D,CBJ,37,69,2,9,11
26,8478840,Will Borgen,D,SEA,28,62,1,10,11
26,8480879,Jacob Bernard-Docker,D,OTT,24,48,1,10,11
26,8476441,Joel Edmundson,D,LAK,31,49,1,10,11
26,8478450,Parker Wotherspoon,D,BOS,27,32,1,10,11
26,8476858,Phillip Di Giuseppe,L,VAN,31,40,8,2,10
26,8481716,Dmitri Voronkov,L,CBJ,24,50,6,4,10
26,8482730,Brandt Clarke,D,LAK,21,45,6,4,10
26,8477938,Haydn Fleury,D,WPG,28,41,5,5,10
26,8481592,Jakob Pelletier,L,CGY,23,40,5,5,10
26,8475225,Craig Smith,C,CHI,35,40,4,6,10
26,8480845,Rasmus Kupari,C,WPG,24,40,4,6,10
26,8479671,Mathieu Olivier,R,CBJ,27,39,3,7,10
26,8475177,Calvin de Haan,D,COL,33,51,3,7,10
26,8481056,Spencer Stastney,D,NSH,24,38,2,8,10
26,8475179,Dmitry Kulikov,D,FLA,34,64,1,9,10
26,8479372,Joshua Mahura,D,SEA,26,54,1,9,10
26,8479442,Troy Stecher,D,EDM,30,45,1,9,10
26,8479359,Beck Malenstyn,L,BUF,26,40,5,4,9
26,8481543,Nikita Alexandrov,C,STL,24,30,5,4,9
26,8479981,Jonah Gadjovich,L,FLA,26,45,4,5,9
26,8482765,Isak Rosen,R,BUF,21,38,4,5,9
26,8481537,Nikita Okhotiuk,D,CGY,24,51,3,6,9
26,8482634,Alex Steeves,C,TOR,25,44,3,6,9
26,8478452,Caleb Jones,D,LAK,27,51,3,6,9
26,8471709,Marc-Edouard Vlasic,D,SJS,37,62,3,6,9
26,8475750,Jon Merrill,D,MIN,32,59,3,6,9
26,8482784,Zach Dean,C,STL,21,43,3,6,9
26,8476874,Olli Maatta,D,DET,30,60,2,7,9
26,8481598,Philip Broberg,D,EDM,23,43,2,7,9
26,8478424,Jansen Harkins,C,ANA,27,42,2,7,9
26,8480058,Pierre-Olivier Joseph,D,STL,25,55,1,8,9
26,8475233,David Savard,D,MTL,34,65,0,9,9
26,8474013,Ian Cole,D,UTA,35,49,0,9,9
26,8481518,Nolan Foote,L,NJD,24,41,5,3,8
26,8482511,Mason Lohrei,D,BOS,23,33,5,3,8
26,8484287,Cole McWard,D,VAN,23,27,5,3,8
26,8477887,Patrick Brown,C,BOS,32,50,4,4,8
26,8477482,Zachary Sanford,L,CHI,30,39,4,4,8
26,8475958,Michael Sgarbossa,C,WSH,32,36,4,4,8
26,8483460,David Jiricek,D,CBJ,21,53,3,5,8
26,8477931,Tomas Nosek,L,FLA,32,51,3,5,8
26,8476372,Nick Seeler,D,PHI,31,44,3,5,8
26,8482153,Brendan Brisson,C,VGK,23,29,3,5,8
26,8480292,Carson Meyer,R,ANA,27,38,3,5,8
26,8481556,John Beecher,C,BOS,23,35,3,5,8
26,8481701,Santeri Hatakka,D,NJD,23,35,3,5,8
26,8483619,Filip Roos,D,OTT,25,27,3,5,8
26,8483763,Maksymilian Szuber,D,UTA,22,35,3,5,8
26,8479944,Zach Aston-Reese,C,VGK,30,47,2,6,8
26,8482095,Tyler Kleven,D,OTT,22,50,2,6,8
26,8482652,Walker Duehr,R,CGY,27,41,2,6,8
26,8473446,Erik Johnson,D,PHI,36,49,2,6,8
26,8477384,Joshua Brown,D,EDM,30,47,2,6,8
26,8480990,Declan Chisholm,D,MIN,24,37,2,6,8
26,8481600,Tobias Bjornfot,D,FLA,23,33,2,6,8
26,8474568,Luke Schenn,D,NSH,35,46,1,7,8
26,8474090,Brendan Smith,D,DAL,35,51,1,7,8
26,8480887,Jordan Harris,D,MTL,24,52,0,8,8
26,8480870,Bo Groulx,C,NYR,24,32,6,1,7
26,8480844,Grigori Denisenko,L,VGK,24,38,4,3,7
26,8481147,Reese Johnson,C,MIN,26,40,4,3,7
26,8478409,Anthony Richard,C,PHI,28,29,4,3,7
26,8483397,Marc McLaughlin,C,BOS,25,35,4,3,7
26,8477335,Kyle Burroughs,D,LAK,29,49,4,3,7
26,8478146,Matthew Highmore,C,OTT,28,39,4,3,7
26,8482747,Brennan Othmann,L,NYR,21,46,3,4,7
26,8484911,Collin Graf,R,SJS,22,39,3,4,7
26,8482177,Marat Khusnutdinov,C,MIN,22,32,3,4,7
26,8479536,Axel Jonsson-Fjallby,L,WPG,26,40,3,4,7
26,8481605,Jackson LaCombe,D,ANA,23,34,3,4,7
26,8481751,Lukas Rousek,R,BUF,25,41,2,5,7
26,8477401,John Hayden,C,SEA,29,36,2,5,7
26,8480848,Ty Dellandrea,C,SJS,24,34,2,5,7
26,8477527,Ross Johnston,L,ANA,30,29,2,5,7
26,8478399,Jonas Siegenthaler,D,NJD,27,60,1,6,7
26,8479772,Zack MacEwen,R,OTT,28,49,1,6,7
26,8479968,Vinni Lettieri,C,BOS,29,47,4,2,6
26,8482141,Lukas Cormier,D,VGK,22,27,4,2,6
26,8481679,Maxence Guenette,D,OTT,23,33,4,2,6
26,8483597,Milos Kelemen,L,UTA,25,14,4,2,6
26,8476442,Matt Nieto,L,PIT,32,44,3,3,6
26,8482733,Logan Mailloux,D,MTL,31,33,3,3,6
26,8482145,Mavrik Bourque,C,DAL,22,50,3,3,6
26,8475762,Derek Forbort,D,VAN,32,42,3,3,6
26,8482166,Shakir Mukhamadullin,D,SJS,22,48,2,4,6
26,8480880,Jakub Lauko,C,MIN,24,38,2,4,6
26,8482070,Mitchell Chaffee,R,TBL,26,48,2,4,6
26,8479439,Jacob MacDonald,D,COL,31,51,2,4,6
26,8477467,Gustav Olofsson,D,SEA,30,19,2,4,6
26,8477473,Justin Bailey,R,SJS,29,19,2,4,6
26,8481609,Vladislav Kolyachonok,D,UTA,23,31,1,5,6
26,8476952,Dominic Toninato,C,WPG,30,40,1,5,6
26,8484254,Akito Hirose,D,VAN,25,38,0,6,6
26,8478874,Adam Gaudette,R,OTT,28,33,0,6,6
26,8479576,Vincent Desharnais,D,VAN,28,37,0,6,6
26,8482762,Simon Edvinsson,D,DET,21,56,5,0,5
26,8471817,Ryan Reaves,R,TOR,37,56,5,0,5
26,8482964,Arber Xhekaj,D,MTL,23,44,3,2,5
26,8479986,Kole Lind,R,DAL,26,48,3,2,5
26,8480267,Sammy Walker,C,MIN,25,18,3,2,5
26,8477962,Brendan Lemieux,L,CAR,28,36,3,2,5
26,8479985,Cale Fleury,D,SEA,26,31,3,2,5
26,8481599,Victor Soderstrom,D,UTA,23,42,2,3,5
26,8476913,Devin Shore,C,MIN,30,31,2,3,5
26,8481122,Simon Benoit,D,TOR,26,34,2,3,5
26,8478468,Jeremy Lauzon,D,NSH,27,54,2,3,5
26,8482713,Mackie Samoskevich,R,FLA,22,36,2,3,5
26,8477462,Robert Hagg,D,VGK,29,24,2,3,5
26,8481578,Graeme Clarke,R,MIN,23,9,2,3,5
26,8481550,Adam Beckman,L,NJD,23,31,1,4,5
26,8479320,Maxime Lajoie,D,SEA,27,24,1,4,5
26,8478477,Mitchell Stephens,C,SEA,27,21,1,4,5
26,8478454,Noah Juulsen,D,VAN,27,35,0,5,5
26,8480834,Ty Emberson,D,SJS,24,32,0,5,5
26,8480468,James Hamblin,L,EDM,25,20,3,1,4
26,8479638,Justin Brazeau,R,BOS,26,29,2,2,4
26,8484258,Sam Malinski,D,COL,26,26,2,2,4
26,8479991,Jake Leschyshyn,C,NYR,25,27,2,2,4
26,8482144,Jack Thompson,D,SJS,22,21,2,2,4
26,8482496,Nils Aman,C,VAN,24,37,1,3,4
26,8481006,Tyler Tucker,D,STL,24,13,1,3,4
26,8478017,Mark Friedman,D,VAN,29,29,0,4,4
26,8477149,Scott Sabourin,R,SJS,32,13,0,4,4
26,8478502,Dennis Gilbert,D,BUF,28,23,0,4,4
26,8482165,Yan Kuznetsov,D,CGY,22,20,0,4,4
26,8480032,Shane Bowers,C,NJD,25,19,3,0,3
26,8482172,Landon Slaggert,L,CHI,22,27,2,1,3
26,8483570,Ben Meyers,C,SEA,26,24,2,1,3
26,8478051,Max Willman,C,NJD,29,16,2,1,3
26,8481043,Cole Koepke,L,BOS,26,13,2,1,3
26,8476934,Brock McGinn,L,ANA,30,46,1,2,3
26,8477851,Jordan Oesterle,D,BOS,32,37,1,2,3
26,8483630,Pavol Regenda,L,ANA,25,32,1,2,3
26,8476473,Connor Murphy,D,CHI,31,34,1,2,3
26,8480245,Olle Lycksell,R,PHI,25,32,1,2,3
26,8482861,Vincent Iorio,D,WSH,22,29,1,2,3
26,8481541,Samuel Bolduc,D,NYI,24,26,1,2,3
26,8479419,Brett Murray,L,BUF,26,23,1,2,3
26,8479587,Rhett Gardner,C,PHI,28,18,1,2,3
26,8482460,Matt Rempe,C,NYR,22,11,1,2,3
26,8480084,Nick DeSimone,D,NJD,30,8,1,2,3
26,8482751,Ryan Winterton,C,SEA,21,38,0,3,3
26,8481564,Ryan Johnson,D,BUF,23,17,0,3,3
26,8482516,Matthew Kessel,D,STL,24,18,0,3,3
26,8482470,Ilya Solovyov,D,CGY,24,22,0,3,3
26,8480306,Grant Hutton,D,NYI,29,6,0,3,3
26,8479379,Givani Smith,R,SJS,26,36,2,0,2
26,8474062,Riley Nash,C,NYR,35,13,2,0,2
26,8481422,Jake Lucchini,C,NSH,29,17,2,0,2
26,8475780,Chris Wagner,R,COL,33,10,2,0,2
26,8481024,Linus Karlsson,C,VAN,25,9,2,0,2
26,8478881,Brett Seney,L,CHI,28,11,1,1,2
26,8475413,Justin Dowling,C,NJD,34,10,1,1,2
26,8475755,Alexander Petrovic,D,DAL,32,10,1,1,2
26,8477993,Justin Kirkland,C,CGY,28,7,1,1,2
26,8481743,Marc Del Gaizo,D,NSH,25,21,1,1,2
26,8478021,William Lagesson,D,DET,28,24,1,1,2
26,8482094,Daemon Hunt,D,MIN,22,17,1,1,2
26,8479330,Brandon Gignac,C,MTL,27,6,1,1,2
26,8482201,Gage Goncalves,C,TBL,23,25,1,1,2
26,8480874,Adam Ginning,D,PHI,24,11,1,1,2
26,8475795,Dylan McIlrath,D,WSH,32,15,0,2,2
26,8483512,Matthew Savoie,C,EDM,20,22,0,2,2
26,8482250,Callahan Burke,C,VGK,27,18,0,2,2
26,8482102,Vasily Ponomarev,C,PIT,22,22,0,2,2
26,8481593,Jayden Struble,D,MTL,23,17,0,2,2
26,8481719,Maxwell Crozier,D,TBL,24,16,0,2,2
26,8477971,Andreas Englund,D,LAK,28,31,0,2,2
26,8477244,Chad Ruhwedel,D,NYR,34,30,0,2,2
26,8484304,Uvis Balinskis,D,FLA,28,5,0,2,2
26,8481206,John Ludvig,D,PIT,24,14,0,2,2
26,8482118,Sam Colangelo,R,ANA,23,16,0,2,2
26,8482858,Ryker Evans,D,SEA,23,25,0,2,2
26,8484325,Waltteri Merela,C,TBL,26,17,0,2,2
26,8482147,Jean-Luc Foudy,C,COL,22,27,1,0,1
26,8479367,William Lockwood,R,FLA,26,22,1,0,1
26,8480851,Akil Thomas,C,LAK,24,16,1,0,1
26,8478446,Glenn Gawdin,C,LAK,27,15,1,0,1
26,8480823,Alexander Alexeyev,D,WSH,25,7,1,0,1
26,8482088,Justin Sourdif,R,FLA,22,20,1,0,1
26,8477320,Anton Blidh,L,NYR,29,18,1,0,1
26,8483471,Brad Lambert,C,WPG,31,8,1,0,1
26,8482787,Nikita Chibrikov,R,WPG,31,8,1,0,1
26,8480196,Jacob Bryson,D,BUF,27,37,0,1,1
26,8477810,Joel Hanley,D,CGY,33,23,0,1,1
26,8481237,Kyle MacLean,C,NYI,25,20,0,1,1
26,8477073,Kurtis MacDermid,L,NJD,30,28,0,1,1
26,8483012,Logan Morrison,C,SEA,22,35,0,1,1
26,8481462,Mason Morelli,L,VGK,28,11,0,1,1
26,8481030,Jack St. Ivany,D,PIT,25,8,0,1,1
26,8481806,Louis Crevier,D,CHI,23,10,0,1,1
26,8477541,Dakota Mermis,D,TOR,30,9,0,1,1
26,8482476,Emil Heineman,L,MTL,23,8,0,1,1
26,8483489,Fraser Minten,C,TOR,31,9,0,1,1
26,8483407,Brandon Scanlin,D,NYR,25,6,0,1,1
26,8483531,Brian Halonen,L,NJD,25,4,0,1,1
26,8480075,Cameron Crotty,D,MIN,25,12,0,1,1
26,8483567,Georgii Merkulov,C,BOS,24,17,0,1,1
26,8483920,Pierrick Dube,R,WSH,23,2,0,1,1
26,8480890,Jan Jenik,C,OTT,24,28,0,0,0
26,8481065,Angus Crookshank,L,OTT,25,14,0,0,0
26,8478011,Louie Belpedio,D,PHI,28,13,0,0,0
26,8479362,Riley Tufte,L,BOS,26,19,0,0,0
26,8481585,Egor Afanasyev,L,SJS,23,15,0,0,0
26,8483395,Arshdeep Bains,L,VAN,23,14,0,0,0
26,8482162,Roby Jarventie,L,EDM,22,11,0,0,0
26,8482061,Brandon Biro,L,SEA,26,11,0,0,0
26,8476323,Max McCormick,L,SEA,32,1,0,0,0
26,8479421,Jacob Moverare,D,LAK,26,1,0,0,0
26,8480274,Philip Kemp,D,EDM,25,1,0,0,0
26,8483398,Declan Carlile,D,TBL,31,6,0,0,0
26,8483546,Marshall Rifai,D,TOR,26,2,0,0,0
26,8478147,Bokondji Imama,L,PIT,28,2,0,0,0
26,8482197,Adam Raska,R,MIN,23,8,0,0,0
26,8483401,Marc Johnstone,R,PIT,28,1,0,0,0
26,8481699,Aku Raty,R,UTA,23,13,0,0,0
26,8481534,Raphael Lavoie,C,EDM,24,3,0,0,0
26,8479522,Hardy Haman Aktell,D,WSH,26,3,0,0,0
26,8481655,Cole Schwindt,R,CGY,23,2,0,0,0
26,8484259,Ondrej Pavel,C,COL,31,2,0,0,0
26,8482929,Emil Lilleberg,D,TBL,23,16,0,0,0
26,8481726,Adam Edstrom,C,NYR,24,6,0,0,0
26,8478854,Ryan Shea,D,PIT,27,5,0,0,0
26,8484326,Patrik Koch,D,UTA,28,0,0,0,0
26,8483609,Adam Klapka,R,CGY,24,5,0,0,0
26,8484255,Jason Polin,R,COL,25,1,0,0,0
26,8482126,Emil Andrae,D,PHI,31,2,0,0,0
26,8478956,Samuel Laberge,L,NJD,27,2,0,0,0
26,8483432,Luca Del Bel Belluz,C,CBJ,31,6,0,0,0
26,8484321,Nikolas Matinpalo,D,OTT,26,0,0,0,0
26,8470794,Joe Pavelski,C,,40,0,0,0,0
26,8479321,Lucas Johansen,D,,27,0,0,0,0
26,8477950,Tony DeAngelo,D,,29,0,0,0,0
26,8471218,Blake Wheeler,R,,38,0,0,0,0
26,8475197,Tyson Barrie,D,,33,0,0,0,0
26,8474157,Max Pacioretty,L,,36,0,0,0,0
26,8475744,Evgeny Kuznetsov,C,,32,0,0,0,0
26,8474037,James van Riemsdyk,L,,35,0,0,0,0
26,8476907,Mackenzie MacEachern,L,,30,0,0,0,0
26,8480216,Jacob Peterson,C,,25,0,0,0,0
26,8474602,Justin Schultz,D,,34,0,0,0,0
26,8482222,Alexander Barabanov,L,,30,0,0,0,0
26,8474031,Kevin Shattenkirk,D,,35,0,0,0,0
26,8477330,Dominik Kubalik,L,,29,0,0,0,0
26,8480884,Calen Addison,D,,24,0,0,0,0
26,8475906,John Klingberg,D,,32,0,0,0,0
26,8480008,Adam Ruzicka,C,,25,0,0,0,0
26,8476884,Derrick Pouliot,D,,30,0,0,0,0
26,8476919,Chris Tierney,C,,30,0,0,0,0
26,8479415,Michael McLeod,C,,26,0,0,0,0
26,8474870,Tyler Johnson,C,,34,0,0,0,0
26,8470604,Jeff Carter,C,,39,0,0,0,0
26,8478104,Sammy Blais,L,,28,0,0,0,0
26,8474884,Mike Hoffman,C,,35,0,0,0,0
26,8481591,Sam Poulin,R,,23,0,0,0,0
26,8471274,Alex Goligoski,D,,39,0,0,0,0
26,8476871,Tanner Pearson,L,,32,0,0,0,0
26,8476393,Nick Cousins,C,,31,0,0,0,0
26,8479977,Kailer Yamamoto,R,,26,0,0,0,0
26,8479346,Dillon Dube,C,,26,0,0,0,0
26,8480184,Gustav Lindstrom,D,,26,0,0,0,0
26,8479376,Victor Mete,D,,26,0,0,0,0
26,8473449,Kyle Okposo,R,,36,0,0,0,0
26,8481058,Jesse Ylonen,R,,25,0,0,0,0
26,8475752,Tyler Pitlick,C,,33,0,0,0,0
26,8481239,Samuel Fagemo,L,,24,0,0,0,0
26,8480821,Filip Zadina,R,,25,0,0,0,0
26,8470966,Mark Giordano,D,,41,0,0,0,0
26,8478495,Denis Gurianov,R,,27,0,0,0,0
26,8477464,Nic Petan,C,,29,0,0,0,0
26,8478099,Kevin Labanc,R,,29,0,0,0,0
26,8482241,Radim Zohorna,L,,28,0,0,0,0
26,8474040,Sam Gagner,C,,35,0,0,0,0
26,8479514,Rem Pitlick,C,,27,0,0,0,0
26,8478430,Oliver Kylington,D,,27,0,0,0,0
26,8479533,Joona Koppanen,L,,26,0,0,0,0
26,8479984,Cal Foote,D,,26,0,0,0,0
26,8477126,Jayson Megna,C,,34,0,0,0,0
26,8475164,Jakob Silfverberg,R,,34,0,0,0,0
26,8474009,Nick Bonino,C,,36,0,0,0,0
26,8479458,Nikita Zaitsev,D,,33,0,0,0,0
26,8477944,Jakub Vrana,L,,28,0,0,0,0
26,8471699,Andrew Cogliano,C,,37,0,0,0,0
26,8478067,Oskar Lindblom,L,,28,0,0,0,0
26,8471686,Marc Staal,D,,37,0,0,0,0
26,8470610,Zach Parise,L,,40,0,0,0,0
26,8478904,Steven Lorentz,C,,28,0,0,0,0
26,8473473,Milan Lucic,L,,36,0,0,0,0
26,8480031,Maxime Comtois,L,,25,0,0,0,0
26,8478512,Austin Czarnik,C,,32,0,0,0,0
26,8473504,Cal Clutterbuck,R,,37,0,0,0,0
26,8477454,Adam Erne,L,,29,0,0,0,0
26,8479383,Boris Katchouk,L,,26,0,0,0,0
26,8475825,Jani Hakanpää,D,,32,0,0,0,0
26,8477846,Ryan Carpenter,C,,33,0,0,0,0
26,8477930,Pierre-Edouard Bellemare,L,,39,0,0,0,0
26,8478400,Colin White,C,,27,0,0,0,0
26,8480226,Marián Studenic,R,,26,0,0,0,0
26,8480853,Liam Foudy,C,,24,0,0,0,0
26,8475797,Jarred Tinordi,D,,32,0,0,0,0
26,8479423,Alex Nylander,L,,26,0,0,0,0
26,8474618,Marco Scandella,D,,34,0,0,0,0
26,8478028,Fredrik Olofsson,L,,28,0,0,0,0
26,8474709,Matt Martin,L,,35,0,0,0,0
26,8481070,Hugh McGing,L,,26,0,0,0,0
26,8479546,Oskar Steen,C,,26,0,0,0,0
26,8474145,Robert Bortuzzo,D,,35,0,0,0,0
26,8476915,Jujhar Khaira,L,,30,0,0,0,0
26,8475278,Byron Froese,C,,33,0,0,0,0
26,8481812,Nikolai Knyzhov,D,,27,0,0,0,0
26,8478408,Travis Dermott,D,,28,0,0,0,0
26,8481077,John Leonard,L,,26,0,0,0,0
26,8479547,Matthew Phillips,R,,26,0,0,0,0
26,8480836,Jonathan Gruden,C,,24,0,0,0,0
26,8481690,Tyler Angle,C,,24,0,0,0,0
26,8475766,Austin Watson,L,,32,0,0,0,0
26,8481016,Ruslan Iskhakov,C,,24,0,0,0,0
26,8478078,Rourke Chartier,C,,28,0,0,0,0
26,8480776,Sheldon Rempal,R,,29,0,0,0,0
26,8483045,Cameron Butler,R,CBJ,31,1,0,0,0
26,8484314,Jiri Smejkal,L,,28,0,0,0,0
27,8478402,Connor McDavid,C,EDM,27,78,49,104,153
27,8477492,Nathan MacKinnon,C,COL,29,81,49,82,131
27,8476453,Nikita Kucherov,R,TBL,31,82,45,85,130
27,8477934,Leon Draisaitl,C,EDM,29,77,55,70,125
27,8477956,David Pastrnak,R,BOS,28,79,59,63,122
27,8481559,Jack Hughes,C,NJD,23,77,47,67,114
27,8482116,Tim Stützle,C,OTT,22,80,42,69,111
27,8479343,Clayton Keller,R,UTA,26,79,45,61,106
27,8476468,J.T. Miller,C,VAN,31,77,33,72,105
27,8478445,Mathew Barzal,C,NYI,27,82,23,80,103
27,8477404,Jake Guentzel,C,TBL,30,82,46,56,102
27,8479314,Matthew Tkachuk,L,FLA,27,81,31,71,102
27,8477493,Aleksander Barkov,C,FLA,29,78,37,63,100
27,8474600,Roman Josi,D,NSH,34,75,28,71,99
27,8477939,William Nylander,R,TOR,28,82,44,54,98
27,8478427,Sebastian Aho,C,CAR,27,73,38,60,98
27,8480002,Nico Hischier,C,NJD,25,77,30,68,98
27,8478483,Mitch Marner,R,TOR,27,80,28,70,98
27,8478864,Kirill Kaprizov,L,MIN,27,71,44,53,97
27,8480012,Elias Pettersson,C,VAN,26,76,42,53,95
27,8479318,Auston Matthews,C,TOR,27,78,46,47,93
27,8477942,Kevin Fiala,L,LAK,28,82,35,56,91
27,8475172,Nazem Kadri,C,CGY,34,79,29,62,91
27,8478398,Kyle Connor,L,WPG,28,75,39,48,87
27,8475166,John Tavares,C,TOR,34,77,35,52,87
27,8478420,Mikko Rantanen,R,COL,28,80,35,51,86
27,8478550,Artemi Panarin,L,NYR,33,75,25,61,86
27,8480027,Jason Robertson,L,DAL,25,82,35,50,85
27,8480801,Brady Tkachuk,L,OTT,25,81,41,43,84
27,8477946,Dylan Larkin,C,DET,28,81,36,48,84
27,8481557,Matt Boldy,L,MIN,23,64,32,52,84
27,8476459,Mika Zibanejad,C,NYR,31,78,29,55,84
27,8477933,Sam Reinhart,C,FLA,29,79,48,35,83
27,8478439,Travis Konecny,R,PHI,27,76,30,53,83
27,8480036,Miro Heiskanen,D,DAL,25,78,10,73,83
27,8478403,Jack Eichel,C,VGK,28,74,39,43,82
27,8478010,Brayden Point,C,TBL,28,82,37,45,82
27,8476887,Filip Forsberg,L,NSH,30,77,37,44,81
27,8480023,Robert Thomas,C,STL,25,72,28,53,81
27,8480208,Drake Batherson,R,OTT,26,79,35,45,80
27,8480800,Quinn Hughes,D,VAN,25,74,14,66,80
27,8474564,Steven Stamkos,C,NSH,34,74,33,46,79
27,8479337,Alex DeBrincat,R,DET,27,80,32,47,79
27,8471675,Sidney Crosby,C,PIT,37,76,33,45,78
27,8475754,Brock Nelson,C,NYI,33,79,41,36,77
27,8479407,Jesper Bratt,L,NJD,26,80,21,56,77
27,8474141,Patrick Kane,R,DET,36,79,29,47,76
27,8473994,Jamie Benn,L,DAL,35,81,34,41,75
27,8476460,Mark Scheifele,C,WPG,31,70,31,44,75
27,8471214,Alex Ovechkin,L,WSH,39,76,31,44,75
27,8475692,Mats Zuccarello,R,MIN,37,77,23,52,75
27,8476346,Johnny Gaudreau,L,CBJ,31,77,20,55,75
27,8479323,Adam Fox,D,NYR,26,73,9,66,75
27,8478449,Roope Hintz,C,DAL,28,82,36,38,74
27,8475798,Mikael Granlund,C,SJS,32,70,19,55,74
27,8477500,Bo Horvat,C,NYI,29,82,38,35,73
27,8476389,Vincent Trocheck,C,NYR,31,80,27,46,73
27,8477960,Adrian Kempe,R,LAK,28,82,24,49,73
27,8476456,Jonathan Huberdeau,C,CGY,31,79,16,57,73
27,8477402,Pavel Buchnevich,L,STL,29,75,32,40,72
27,8477409,Carter Verhaeghe,C,FLA,29,81,35,36,71
27,8478401,Pavel Zacha,C,BOS,27,79,33,38,71
27,8477501,Valeri Nichushkin,R,COL,29,80,28,43,71
27,8471215,Evgeni Malkin,C,PIT,38,75,25,46,71
27,8475786,Zach Hyman,L,EDM,32,79,39,31,70
27,8476881,Tomas Hertl,C,VGK,31,79,36,34,70
27,8480830,Andrei Svechnikov,R,CAR,24,73,32,38,70
27,8473419,Brad Marchand,L,BOS,36,79,31,39,70
27,8471685,Anze Kopitar,C,LAK,37,80,27,43,70
27,8482124,Quinton Byfield,R,LAK,22,79,27,43,70
27,8473512,Claude Giroux,R,OTT,36,80,18,52,70
27,8478460,Zach Werenski,D,CBJ,27,81,17,53,70
27,8475184,Chris Kreider,L,NYR,33,75,42,27,69
27,8482699,Dylan Guenther,R,UTA,21,76,35,34,69
27,8477496,Elias Lindholm,C,BOS,30,78,25,44,69
27,8477951,Nick Schmaltz,C,UTA,28,76,28,40,68
27,8479385,Jordan Kyrou,C,STL,26,73,26,42,68
27,8480069,Cale Makar,D,COL,26,64,23,45,68
27,8475913,Mark Stone,R,VGK,32,73,18,50,68
27,8484144,Connor Bedard,C,CHI,19,69,18,50,68
27,8482740,Wyatt Johnston,C,DAL,21,81,31,36,67
27,8479675,Trevor Moore,L,LAK,29,79,30,37,67
27,8481540,Cole Caufield,R,MTL,23,77,26,41,67
27,8478407,Vince Dunn,D,SEA,28,76,11,56,67
27,8477955,Jared McCann,L,SEA,28,76,30,36,66
27,8475784,Jeff Skinner,C,EDM,32,81,27,39,66
27,8477504,Josh Morrissey,D,WPG,29,72,12,54,66
27,8480803,Evan Bouchard,D,EDM,25,79,17,48,65
27,8474578,Erik Karlsson,D,PIT,34,81,15,50,65
27,8475167,Victor Hedman,D,TBL,34,81,10,55,65
27,8479542,Brandon Hagel,L,TBL,26,82,29,35,64
27,8482665,Matty Beniers,C,SEA,22,79,26,38,64
27,8475810,Bryan Rust,R,PIT,32,69,36,27,63
27,8477935,Sam Bennett,C,FLA,28,81,29,34,63
27,8482745,Mason McTavish,C,ANA,21,70,28,35,63
27,8482159,Tyson Foerster,R,PHI,22,74,28,34,62
27,8474150,Mikael Backlund,C,CGY,35,80,27,35,62
27,8480039,Martin Necas,C,CAR,25,66,21,41,62
27,8479325,Charlie McAvoy,D,BOS,27,79,4,58,62
27,8476539,Jonathan Marchessault,R,NSH,34,70,37,24,61
27,8476454,Ryan Nugent-Hopkins,C,EDM,31,76,18,43,61
27,8480865,Noah Dobson,D,NYI,24,81,13,48,61
27,8480009,Eeli Tolvanen,R,SEA,25,69,35,25,60
27,8476448,William Karlsson,C,VGK,31,80,31,29,60
27,8480018,Nick Suzuki,C,MTL,25,74,23,37,60
27,8476853,Morgan Rielly,D,TOR,30,73,11,49,60
27,8478444,Brock Boeser,R,VAN,27,74,33,26,59
27,8475765,Vladimir Tarasenko,R,DET,33,78,24,35,59
27,8477416,Oliver Bjorkstrand,R,SEA,29,78,23,36,59
27,8476479,Phillip Danault,C,LAK,31,79,26,32,58
27,8478493,Joel Eriksson Ek,C,MIN,27,74,23,35,58
27,8478873,Troy Terry,R,ANA,27,75,23,35,58
27,8478047,Michael Bunting,L,PIT,29,70,20,38,58
27,8475158,Ryan O'Reilly,C,NSH,33,72,19,39,58
27,8479999,Casey Mittelstadt,C,COL,26,81,18,40,58
27,8477940,Nikolaj Ehlers,L,WPG,28,70,21,36,57
27,8477949,Alex Tuch,R,BUF,28,75,20,37,57
27,8471724,Kris Letang,D,PIT,37,79,13,44,57
27,8479420,Tage Thompson,C,BUF,27,70,27,29,56
27,8478366,Frank Vatrano,R,ANA,30,71,27,29,56
27,8482109,Alexis Lafrenière,L,NYR,23,75,26,30,56
27,8481068,Yegor Sharangovich,C,CGY,26,77,26,30,56
27,8482093,Seth Jarvis,C,CAR,22,72,22,34,56
27,8475745,Charlie Coyle,C,BOS,32,77,15,41,56
27,8482684,Luke Hughes,D,NJD,21,74,11,45,56
27,8477407,Anthony Duclair,L,NYI,29,80,26,29,55
27,8478975,Mason Marchment,L,DAL,29,82,25,30,55
27,8478440,Dylan Strome,C,WSH,27,70,17,38,55
27,8470613,Brent Burns,D,CAR,39,80,15,40,55
27,8481533,Trevor Zegras,C,ANA,23,73,25,29,54
27,8482078,Lucas Raymond,L,DET,22,80,22,32,54
27,8481711,Matias Maccelli,L,UTA,24,79,15,39,54
27,8477447,Shea Theodore,D,VGK,29,64,11,43,54
27,8473986,Alex Killorn,L,ANA,35,76,25,28,53
27,8477964,Ivan Barbashev,C,VGK,29,79,21,32,53
27,8477476,Artturi Lehkonen,L,COL,29,80,35,17,52
27,8478414,Timo Meier,R,NJD,28,72,27,25,52
27,8483431,Logan Cooley,C,UTA,20,77,21,31,52
27,8483515,Juraj Slafkovsky,L,MTL,20,77,20,32,52
27,8478397,Rasmus Andersson,D,CGY,28,72,10,42,52
27,8479987,Morgan Geekie,C,BOS,26,74,23,28,51
27,8476432,Boone Jenner,C,CBJ,31,69,21,30,51
27,8476906,Shayne Gostisbehere,D,CAR,31,76,15,36,51
27,8475151,Kyle Palmieri,C,NYI,33,76,14,37,51
27,8477346,MacKenzie Weegar,D,CGY,30,74,9,42,51
27,8476483,Rickard Rakell,R,PIT,31,69,27,23,50
27,8474102,David Perron,L,OTT,36,77,24,26,50
27,8476880,Tom Wilson,R,WSH,30,72,23,27,50
27,8478519,Anthony Cirelli,C,TBL,27,82,22,28,50
27,8477456,J.T. Compher,L,DET,29,81,18,32,50
27,8477497,Sean Monahan,C,CBJ,30,68,18,32,50
27,8480220,Noah Cates,L,PHI,25,80,18,32,50
27,8476905,Chandler Stephenson,C,SEA,30,66,17,33,50
27,8478462,Nicolas Roy,C,VGK,27,75,17,33,50
27,8474590,John Carlson,D,WSH,34,63,16,34,50
27,8478055,Gustav Forsling,D,FLA,28,76,15,35,50
27,8480839,Rasmus Dahlin,D,BUF,24,73,14,36,50
27,8478856,Conor Garland,R,VAN,28,72,13,37,50
27,8480014,Gabriel Vilardi,C,WPG,25,72,28,21,49
27,8475169,Evander Kane,L,EDM,33,77,26,23,49
27,8482110,Dawson Mercer,C,NJD,23,72,23,26,49
27,8475794,Tyler Seguin,C,DAL,32,81,16,33,49
27,8474563,Drew Doughty,D,LAK,35,74,7,42,49
27,8475726,Tyler Toffoli,C,SJS,32,68,27,21,48
27,8477479,Tyler Bertuzzi,L,CHI,29,62,24,24,48
27,8477426,Nicholas Paul,L,TBL,29,81,22,26,48
27,8480028,Morgan Frost,C,PHI,25,73,21,27,48
27,8484153,Leo Carlsson,C,ANA,20,76,17,31,48
27,8474641,Adam Henrique,C,EDM,34,77,16,32,48
27,8484166,Adam Fantilli,C,CBJ,20,72,27,20,47
27,8471698,T.J. Oshie,R,WSH,38,70,26,21,47
27,8481560,Arthur Kaliyev,R,LAK,23,76,24,23,47
27,8475168,Matt Duchene,C,DAL,33,79,21,26,47
27,8477998,Warren Foegele,L,LAK,28,78,20,27,47
27,8480188,Fabian Zetterlund,L,SJS,25,69,18,29,47
27,8477429,Andrew Copp,C,DET,30,80,18,29,47
27,8478498,Jake DeBrusk,L,VAN,28,77,28,18,46
27,8474586,Jordan Eberle,R,SEA,34,68,21,25,46
27,8481618,Alex Newhook,C,MTL,23,76,15,31,46
27,8476869,Brady Skjei,D,NSH,30,73,13,33,46
27,8477494,Jonathan Drouin,L,COL,29,81,13,33,46
27,8478469,Thomas Chabot,D,OTT,27,73,10,36,46
27,8478038,Devon Toews,D,COL,30,67,10,36,46
27,8480064,Josh Norris,C,OTT,25,74,25,20,45
27,8481604,Pavel Dorofeyev,L,VGK,24,66,22,23,45
27,8482113,Anton Lundell,C,FLA,23,77,18,27,45
27,8482720,Matthew Knies,L,TOR,22,69,17,28,45
27,8478542,Evan Rodrigues,C,FLA,31,77,15,30,45
27,8478396,Noah Hanifin,D,VGK,27,63,12,33,45
27,8476399,Blake Coleman,C,CGY,33,78,29,15,44
27,8479525,Ross Colton,C,COL,28,80,22,22,44
27,8479400,Pierre-Luc Dubois,L,WSH,26,71,20,24,44
27,8480797,Joel Farabee,L,PHI,24,67,18,26,44
27,8476882,Teuvo Teravainen,C,CHI,30,61,18,26,44
27,8474565,Alex Pietrangelo,D,VGK,34,63,11,33,44
27,8479410,Mikhail Sergachev,D,UTA,26,70,7,37,44
27,8476826,Yanni Gourde,C,SEA,33,70,21,22,43
27,8475768,Jaden Schwartz,C,SEA,32,71,17,26,43
27,8478458,John (Jack) Roslovic,C,CAR,27,65,14,29,43
27,8474679,Gustav Nyquist,C,NSH,35,77,13,30,43
27,8480434,Sean Durzi,D,UTA,26,67,7,36,43
27,8476854,Hampus Lindholm,D,BOS,30,74,6,37,43
27,8481542,Moritz Seider,D,DET,23,74,5,38,43
27,8475764,Cam Fowler,D,ANA,33,75,1,42,43
27,8482702,Logan Stankoven,C,DAL,21,78,21,21,42
27,8482097,Jack Quinn,R,BUF,23,65,19,23,42
27,8477503,Max Domi,C,TOR,29,76,12,30,42
27,8476792,Torey Krug,D,STL,33,71,10,32,42
27,8479425,Filip Hronek,D,VAN,27,71,4,38,42
27,8477989,Christian Dvorak,C,MTL,28,61,19,22,41
27,8477511,Anthony Mantha,R,CGY,30,77,16,25,41
27,8481596,Shane Pinto,C,OTT,24,77,15,26,41
27,8483808,Andrei Kuzmenko,L,CGY,28,66,14,27,41
27,8478042,Viktor Arvidsson,L,EDM,31,76,13,28,41
27,8482149,Cole Perfetti,C,WPG,22,63,12,29,41
27,8476875,Mike Matheson,D,MTL,30,68,10,31,41
27,8481546,Cam York,D,PHI,23,68,10,31,41
27,8475170,Brayden Schenn,C,STL,33,75,9,32,41
27,8476438,Brandon Saad,L,STL,32,72,23,17,40
27,8475799,Nino Niederreiter,R,WPG,32,70,22,18,40
27,8481535,Nils Hoglander,L,VAN,24,70,22,18,40
27,8480015,Owen Tippett,R,PHI,25,74,20,20,40
27,8482705,Cole Sillinger,C,CBJ,21,71,19,21,40
27,8478466,Daniel Sprong,R,VAN,27,65,13,27,40
27,8476958,Jaccob Slavin,D,CAR,30,76,7,33,40
27,8475191,Reilly Smith,R,NYR,33,74,18,21,39
27,8480459,Pius Suter,C,VAN,28,72,18,21,39
27,8479365,Trent Frederic,C,BOS,26,79,17,22,39
27,8474149,Evgenii Dadonov,R,DAL,35,79,13,26,39
27,8476458,Ryan Strome,C,ANA,31,72,13,26,39
27,8479339,Patrik Laine,L,CBJ,26,55,11,28,39
27,8476923,Damon Severson,D,CBJ,30,80,10,29,39
27,8477495,Seth Jones,D,CHI,30,74,10,29,39
27,8480871,Adam Boqvist,D,FLA,24,72,9,30,39
27,8482146,Luke Evangelista,R,NSH,22,66,20,18,38
27,8484203,Bradly Nadeau,L,CAR,19,63,17,21,38
27,8482667,William Eklund,L,SJS,22,66,16,22,38
27,8478233,Andrew Mangiapane,L,WSH,28,65,15,23,38
27,8483505,Matthew Poitras,C,BOS,20,72,14,24,38
27,8481703,Valtteri Puustinen,R,PIT,25,63,10,28,38
27,8477021,Alex Kerfoot,C,UTA,30,73,10,28,38
27,8484145,Zach Benson,L,BUF,19,67,19,18,37
27,8478474,Lawson Crouse,L,UTA,27,74,18,19,37
27,8476392,Adam Lowry,C,WPG,31,70,18,19,37
27,8476927,Teddy Blueger,C,VAN,30,68,16,21,37
27,8481528,Dylan Cozens,C,BUF,23,68,14,23,37
27,8479992,Michael Rasmussen,C,DET,25,79,14,23,37
27,8474053,Logan Couture,C,SJS,35,59,13,24,37
27,8477498,Darnell Nurse,D,EDM,29,77,12,25,37
27,8476462,Dougie Hamilton,D,NJD,31,76,11,26,37
27,8477986,Brandon Montour,D,SEA,30,67,10,27,37
27,8482475,Yegor Chinakhov,R,CBJ,23,67,24,12,36
27,8478115,Pierre Engvall,L,NYI,28,74,21,15,36
27,8475793,Ryan Johansen,C,PHI,32,76,16,20,36
27,8476419,Jean-Gabriel Pageau,C,NYI,32,76,12,24,36
27,8481581,Thomas Harley,D,DAL,23,74,10,26,36
27,8477444,Andre Burakovsky,L,SEA,29,64,8,28,36
27,8481606,Jordan Spence,D,LAK,23,70,3,33,36
27,8475760,Nick Bjugstad,C,UTA,32,73,21,14,35
27,8480893,Kirill Marchenko,R,CBJ,24,69,19,16,35
27,8477952,Robby Fabbri,C,ANA,28,63,18,17,35
27,8475722,Jason Zucker,L,BUF,32,65,16,19,35
27,8480185,Eetu Luostarinen,C,FLA,26,73,14,21,35
27,8479351,Sam Steel,C,DAL,26,80,13,22,35
27,8476292,Ondrej Palat,L,NJD,33,68,10,25,35
27,8482660,Kent Johnson,C,CBJ,22,66,10,25,35
27,8482122,Brock Faber,D,MIN,22,76,9,26,35
27,8476917,Adam Pelech,D,NYI,30,79,8,27,35
27,8477969,Marcus Pettersson,D,PIT,28,77,5,30,35
27,8475314,Anders Lee,L,NYI,34,78,21,13,34
27,8480813,Joe Veleno,C,DET,24,76,18,16,34
27,8482133,Thomas Bordeleau,C,SJS,22,55,13,21,34
27,8481577,Philip Tomasino,C,NSH,23,66,12,22,34
27,8478891,Mason Appleton,C,WPG,28,60,11,23,34
27,8475171,Oliver Ekman-Larsson,D,TOR,33,75,7,27,34
27,8480817,K'Andre Miller,D,NYR,24,69,6,28,34
27,8476331,Dylan DeMelo,D,WPG,31,67,5,29,34
27,8480068,Ryan Poehling,C,PHI,25,78,18,15,33
27,8478463,Anthony Beauvillier,L,PIT,27,69,16,17,33
27,8481624,Ilya Mikheyev,R,CHI,30,61,13,20,33
27,8482092,Ridly Greig,C,OTT,22,76,10,23,33
27,8475763,Kevin Hayes,R,PIT,32,69,8,25,33
27,8477505,Alexander Wennberg,C,SJS,30,68,6,27,33
27,8482655,Janis Moser,D,TBL,24,76,6,27,33
27,8477932,Aaron Ekblad,D,FLA,28,68,5,28,33
27,8477948,Travis Sanheim,D,PHI,28,69,3,30,33
27,8480829,Jesperi Kotkaniemi,C,CAR,24,66,19,13,32
27,8482125,Alexander Holtz,R,VGK,22,68,18,14,32
27,8480849,Barrett Hayton,C,UTA,24,66,15,17,32
27,8478432,Christian Fischer,R,DET,27,73,15,17,32
27,8479353,Brett Howden,C,VGK,26,71,14,18,32
27,8481523,Kirby Dach,C,MTL,23,72,14,18,32
27,8482055,Drew O'Connor,L,PIT,26,62,13,19,32
27,8476921,Jordan Martinook,L,CAR,32,61,13,19,32
27,8477839,Conor Sheary,L,TBL,32,81,12,20,32
27,8481186,Logan O'Connor,R,COL,28,81,12,20,32
27,8482624,Daniil Miromanov,D,CGY,27,57,9,23,32
27,8473533,Jordan Staal,C,CAR,36,63,18,13,31
27,8482074,Connor Zary,C,CGY,23,65,17,14,31
27,8475848,Brendan Gallagher,R,MTL,32,75,13,18,31
27,8475287,Erik Haula,L,NJD,33,71,13,18,31
27,8479293,Brandon Tanev,L,SEA,33,62,13,18,31
27,8473563,Nicklas Backstrom,C,WSH,37,58,11,20,31
27,8478438,Tommy Novak,C,NSH,27,70,10,21,31
27,8476461,Sean Couturier,C,PHI,32,68,10,21,31
27,8480336,Sean Walker,D,CAR,30,67,10,21,31
27,8482712,Oskar Olausson,R,COL,22,77,9,22,31
27,8480145,Neal Pionk,D,WPG,29,68,6,25,31
27,8473507,Jeff Petry,D,DET,37,71,4,27,31
27,8476918,Jimmy Vesey,L,NYR,31,72,17,13,30
27,8477987,Ryan Donato,C,CHI,28,64,14,16,30
27,8478046,Danton Heinen,L,VAN,29,68,14,16,30
27,8475193,Tomas Tatar,L,NJD,34,69,13,17,30
27,8478109,Victor Olofsson,L,VGK,29,69,11,19,30
27,8479345,Jakob Chychrun,D,WSH,26,64,9,21,30
27,8483490,Pavel Mintyukov,D,ANA,21,72,9,21,30
27,8479983,Mario Ferraro,D,SJS,26,66,9,21,30
27,8476885,Jacob Trouba,D,NYR,30,68,8,22,30
27,8475753,Justin Faulk,D,STL,32,67,7,23,30
27,8475200,Dmitry Orlov,D,CAR,33,72,7,23,30
27,8478851,Alexandre Carrier,D,NSH,28,69,4,26,30
27,8477451,Ryan Hartman,R,MIN,30,73,19,10,29
27,8482259,Bobby McMann,C,TOR,28,69,18,11,29
27,8475714,Calle Jarnkrok,C,TOR,33,75,17,12,29
27,8474715,Cameron Atkinson,R,TBL,35,82,11,18,29
27,8481601,Simon Holmstrom,R,NYI,23,64,11,18,29
27,8478472,Mathieu Joseph,R,STL,27,71,11,18,29
27,8480802,Ryan McLeod,C,BUF,25,63,9,20,29
27,8477435,Ryan Graves,D,PIT,29,78,9,20,29
27,8477507,Nikita Zadorov,D,BOS,29,68,9,20,29
27,8482809,Jackson Blake,R,CAR,21,63,6,23,29
27,8482089,Jake Neighbours,L,STL,22,70,19,9,28
27,8477919,Frederick Gaudreau,C,MIN,31,66,15,13,28
27,8475218,Mattias Ekholm,D,EDM,34,75,11,17,28
27,8476480,Vladislav Namestnikov,C,WPG,32,60,11,17,28
27,8475149,Marcus Johansson,L,MIN,34,67,11,17,28
27,8480144,David Kampf,C,TOR,29,70,11,17,28
27,8480003,Jesper Boqvist,C,FLA,26,66,10,18,28
27,8481656,Aliaksei Protas,C,WSH,23,67,10,18,28
27,8475855,Jesper Fast,R,CAR,33,58,10,18,28
27,8476891,Matthew Grzelcyk,D,PIT,30,75,9,19,28
27,8482749,Joshua Roy,R,MTL,21,60,8,20,28
27,8480001,Urho Vaakanainen,D,ANA,25,63,7,21,28
27,8478911,Matt Roy,D,WSH,29,69,5,23,28
27,8476979,Erik Gustafsson,D,DET,32,78,4,24,28
27,8480748,Kiefer Sherwood,L,VAN,29,58,15,12,27
27,8477425,Miles Wood,L,COL,29,81,14,13,27
27,8481093,Rafael Harvey-Pinard,L,MTL,25,62,13,14,27
27,8482101,Danil Gushchin,L,SJS,22,60,12,15,27
27,8479619,Michael Carcone,L,UTA,28,66,12,15,27
27,8478057,Dakota Joshua,C,VAN,28,65,9,18,27
27,8481524,Bowen Byram,D,BUF,23,64,8,19,27
27,8482671,Owen Power,D,BUF,22,59,8,19,27
27,8482105,Jake Sanderson,D,OTT,22,75,7,20,27
27,8477488,Brett Pesce,D,NJD,30,74,7,20,27
27,8475790,Erik Gudbranson,D,CBJ,32,79,2,25,27
27,8480246,Nick Perbix,D,TBL,26,74,1,26,27
27,8479066,Ryan Lomberg,L,CGY,30,63,14,12,26
27,8476872,Scott Laughton,C,PHI,30,70,13,13,26
27,8476474,Stefan Noesen,R,NJD,31,65,13,13,26
27,8480078,Filip Chytil,C,NYR,25,61,13,13,26
27,8476981,Josh Anderson,R,MTL,30,69,13,13,26
27,8483457,Lane Hutson,D,MTL,20,78,13,13,26
27,8477947,Sonny Milano,L,WSH,28,56,12,14,26
27,8481580,Connor McMichael,C,WSH,23,65,11,15,26
27,8479390,Taylor Raddysh,R,WSH,26,60,11,15,26
27,8480798,Philipp Kurashev,C,CHI,25,59,10,16,26
27,8479402,Jake Bean,D,CGY,26,69,7,19,26
27,8474716,Jared Spurgeon,D,MIN,35,79,6,20,26
27,8483499,Liam Ohgren,L,MIN,20,53,4,22,26
27,8477506,Ryan Pulock,D,NYI,30,75,3,23,26
27,8476879,Cody Ceci,D,EDM,31,71,3,23,26
27,8478500,Ivan Provorov,D,CBJ,27,80,3,23,26
27,8481014,Alexander Romanov,D,NYI,24,78,2,24,26
27,8481582,Nicholas Robertson,L,TOR,23,64,14,11,25
27,8479393,Noah Gregor,L,OTT,26,74,13,12,25
27,8474189,Lars Eller,C,PIT,35,63,12,13,25
27,8480113,Alex Iafallo,L,WPG,31,66,10,15,25
27,8479996,Cody Glass,C,NSH,25,67,9,16,25
27,8483524,Shane Wright,C,SEA,20,64,8,17,25
27,8470621,Corey Perry,R,EDM,39,72,6,19,25
27,8480806,Isac Lundestrom,C,ANA,25,65,6,19,25
27,8476463,Jonas Brodin,D,MIN,31,78,5,20,25
27,8479976,Juuso Valimaki,D,UTA,26,61,4,21,25
27,8479316,Luke Kunin,C,SJS,27,58,15,9,24
27,8479661,Tanner Jeannot,L,LAK,27,75,13,11,24
27,8473422,Nick Foligno,L,CHI,37,53,9,15,24
27,8479639,Dylan Coghlan,D,WPG,26,62,8,16,24
27,8476329,Travis Boyd,C,MIN,31,59,8,16,24
27,8479591,Michael Eyssimont,C,TBL,28,82,7,17,24
27,8481481,Blake Lizotte,C,PIT,27,61,7,17,24
27,8479982,Conor Timmins,D,TOR,26,59,3,21,24
27,8476931,Jake McCabe,D,TOR,31,67,3,21,24
27,8478507,John Marino,D,UTA,27,65,2,22,24
27,8478020,Michael Amadio,R,OTT,28,71,13,10,23
27,8475791,Taylor Hall,L,CHI,33,53,12,11,23
27,8480205,Emil Bemstrom,C,PIT,25,53,11,12,23
27,8480980,Connor Dewar,C,TOR,25,71,11,12,23
27,8478413,Jordan Greenway,L,BUF,27,66,10,13,23
27,8480835,Jack Drury,C,CAR,24,66,9,14,23
27,8482142,Jamie Drysdale,D,PHI,22,60,7,16,23
27,8480873,Rasmus Sandin,D,WSH,24,63,5,18,23
27,8479671,Mathieu Olivier,R,CBJ,27,44,13,9,22
27,8481554,Kaapo Kakko,R,NYR,23,63,11,11,22
27,8480855,Jack McBain,C,UTA,24,60,10,12,22
27,8476278,Colin Blackwell,C,DAL,31,79,9,13,22
27,8477353,Tyler Motte,C,DET,29,73,9,13,22
27,8482067,Connor Mackey,D,NYR,28,57,9,13,22
27,8478211,Dryden Hunt,L,CGY,29,53,9,13,22
27,8477953,Kasperi Kapanen,R,STL,28,65,6,16,22
27,8483565,Nick Blankenburg,D,NSH,26,54,6,16,22
27,8474151,Ryan McDonagh,D,TBL,35,76,5,17,22
27,8476467,Jamie Oleksiak,D,SEA,32,66,5,17,22
27,8482073,Braden Schneider,D,NYR,23,73,5,17,22
27,8478178,Darren Raddysh,D,TBL,28,71,4,18,22
27,8475179,Dmitry Kulikov,D,FLA,34,64,1,21,22
27,8481032,Paul Cotter,C,NJD,25,54,13,8,21
27,8476897,Oskar Sundqvist,C,STL,30,65,11,10,21
27,8479414,Nathan Bastian,R,NJD,27,68,11,10,21
27,8479941,Justin Danforth,R,CBJ,31,61,10,11,21
27,8477903,Garnet Hathaway,R,PHI,33,61,10,11,21
27,8482079,Marco Rossi,C,MIN,23,54,9,12,21
27,8475231,Casey Cizikas,C,NYI,33,74,9,12,21
27,8483493,Frank Nazar,C,CHI,20,53,8,13,21
27,8481553,Bobby Brink,R,PHI,23,62,8,13,21
27,8476994,Vinnie Hinostroza,C,NSH,30,49,8,13,21
27,8480762,Eric Robinson,L,CAR,29,50,7,14,21
27,8482803,Olen Zellweger,D,ANA,21,66,5,16,21
27,8482192,Isaak Phillips,D,CHI,23,50,5,16,21
27,8479371,Dante Fabbro,D,NSH,26,66,4,17,21
27,8476422,Mike Reilly,D,NYI,31,70,4,17,21
27,8480049,Dylan Samberg,D,WPG,25,61,3,18,21
27,8478133,Jake Evans,C,MTL,28,73,3,18,21
27,8476429,Scott Mayfield,D,NYI,32,73,3,18,21
27,8482087,Kaiden Guhle,D,MTL,22,65,2,19,21
27,8482175,JJ Peterka,R,BUF,22,67,12,8,20
27,8475343,Nic Dowd,C,WSH,34,58,12,8,20
27,8474034,Patrick Maroon,L,CHI,36,53,12,8,20
27,8477392,Hudson Fasching,R,NYI,29,64,10,10,20
27,8477380,Jonny Brodzinski,C,NYR,31,53,10,10,20
27,8482062,Cole Smith,L,NSH,29,60,10,10,20
27,8480789,Oliver Wahlstrom,R,NYI,24,70,9,11,20
27,8475220,Marcus Foligno,L,MIN,33,62,8,12,20
27,8481708,Zac Jones,D,NYR,24,53,6,14,20
27,8480891,Michael Kesselring,D,UTA,24,57,5,15,20
27,8480878,Nils Lundkvist,D,DAL,24,73,5,15,20
27,8478416,Erik Cernak,D,TBL,27,69,3,17,20
27,8475181,Nick Leddy,D,STL,33,71,1,19,20
27,8481477,Nico Sturm,C,SJS,29,52,11,8,19
27,8482451,Mikael Pyyhtia,L,CBJ,23,48,9,10,19
27,8479439,Jacob MacDonald,D,COL,31,47,9,10,19
27,8476889,Radek Faksa,C,STL,30,66,8,11,19
27,8477446,Michael McCarron,R,NSH,29,53,7,12,19
27,8476457,Adam Larsson,D,SEA,32,65,7,12,19
27,8477931,Tomas Nosek,L,FLA,32,62,7,12,19
27,8476925,Colton Sissons,C,NSH,31,65,6,13,19
27,8478882,Vladislav Gavrikov,D,LAK,29,68,6,13,19
27,8476902,Esa Lindell,D,DAL,30,76,6,13,19
27,8479026,Philippe Myers,D,TOR,27,49,6,13,19
27,8480035,Henri Jokiharju,D,BUF,25,60,5,14,19
27,8476312,Josh Manson,D,COL,33,67,4,15,19
27,8481019,David Gustafsson,C,WPG,24,50,4,15,19
27,8476988,Matt Benning,D,SJS,30,66,4,15,19
27,8479398,Samuel Girard,D,COL,26,68,3,16,19
27,8480796,Martin Fehervary,D,WSH,25,58,3,16,19
27,8476967,Brett Kulak,D,EDM,30,59,2,17,19
27,8476878,Zemgus Girgensons,C,TBL,30,81,11,7,18
27,8476469,Joel Armia,R,MTL,31,62,11,7,18
27,8481028,Martin Pospisil,C,CGY,25,57,11,7,18
27,8473453,Trevor Lewis,C,LAK,37,70,11,7,18
27,8481716,Dmitri Voronkov,L,CBJ,24,44,11,7,18
27,8482737,Zack Bolduc,C,STL,21,56,10,8,18
27,8475225,Craig Smith,C,CHI,35,57,8,10,18
27,8483491,Ivan Miroshnichenko,L,WSH,20,47,7,11,18
27,8483445,Cutter Gauthier,L,ANA,20,61,7,11,18
27,8478508,Yakov Trenin,C,MIN,27,48,7,11,18
27,8478013,Jake Walman,D,SJS,28,70,6,12,18
27,8477220,Nate Schmidt,D,FLA,33,69,6,12,18
27,8476960,Andreas Athanasiou,C,CHI,30,51,6,12,18
27,8476624,Barclay Goodrow,C,SJS,31,60,6,12,18
27,8479372,Joshua Mahura,D,SEA,26,57,5,13,18
27,8478136,Jake Middleton,D,MIN,28,71,4,14,18
27,8479324,Ryan Lindgren,D,NYR,26,66,4,14,18
27,8480073,Erik Brannstrom,D,COL,25,60,4,14,18
27,8480860,Kevin Bahl,D,CGY,24,56,3,15,18
27,8481517,Brett Leason,R,ANA,25,56,9,8,17
27,8482157,Will Cuylle,L,NYR,22,64,8,9,17
27,8479718,Alex Barré-Boulet,C,MTL,27,46,8,9,17
27,8477015,Connor Brown,R,EDM,30,63,6,11,17
27,8477450,Jason Dickinson,C,CHI,29,57,6,11,17
27,8482176,Wyatt Kaiser,D,CHI,22,54,6,11,17
27,8480025,MacKenzie Entwistle,R,FLA,25,65,5,12,17
27,8482095,Tyler Kleven,D,OTT,22,51,5,12,17
27,8478399,Jonas Siegenthaler,D,NJD,27,56,5,12,17
27,8481441,Joe Snively,C,DET,28,68,4,13,17
27,8476892,Colton Parayko,D,STL,31,73,4,13,17
27,8477499,Rasmus Ristolainen,D,PHI,30,65,2,15,17
27,8481059,Scott Perunovich,D,STL,26,61,1,16,17
27,8478043,Sam Lafferty,C,BUF,29,66,10,6,16
27,8479368,Max Jones,L,BOS,26,66,10,6,16
27,8478569,Noel Acciari,C,PIT,33,52,9,7,16
27,8482111,Justin Barron,D,MTL,23,64,8,8,16
27,8479315,Joey Anderson,R,CHI,26,50,8,8,16
27,8480021,Jack Studnicka,C,LAK,25,62,8,8,16
27,8480252,Cole Guttman,C,CHI,25,46,7,9,16
27,8476856,Mathew Dumba,D,DAL,30,70,5,11,16
27,8483482,Tristan Luneau,D,ANA,20,55,5,11,16
27,8480222,Sebastian Aho,D,PIT,28,69,4,12,16
27,8476874,Olli Maatta,D,DET,30,71,4,12,16
27,8474673,TJ Brodie,D,CHI,34,58,0,16,16
27,8474574,Tyler Myers,D,VAN,34,65,0,16,16
27,8480281,Alexey Toropchenko,R,STL,25,57,9,6,15
27,8479336,Carl Grundstrom,R,SJS,27,52,8,7,15
27,8483468,Jiri Kulich,C,BUF,20,58,8,7,15
27,8476858,Phillip Di Giuseppe,L,VAN,31,47,8,7,15
27,8481704,Juuso Parssinen,C,NSH,23,52,7,8,15
27,8480995,Pontus Holmberg,R,TOR,25,59,7,8,15
27,8477406,Mattias Janmark,C,EDM,32,62,7,8,15
27,8481537,Nikita Okhotiuk,D,CGY,24,53,7,8,15
27,8478970,Jalen Chatfield,D,CAR,28,74,5,10,15
27,8474567,Zach Bogosian,D,MIN,34,56,5,10,15
27,8481550,Adam Beckman,L,NJD,23,44,5,10,15
27,8479980,Nicolas Hague,D,VGK,26,57,4,11,15
27,8479972,Mason Shaw,C,WPG,26,37,4,11,15
27,8477018,Ben Hutton,D,VGK,31,51,4,11,15
27,8474013,Ian Cole,D,UTA,35,55,4,11,15
27,8475324,Nick Jensen,D,OTT,34,65,3,12,15
27,8481527,Kaedan Korczak,D,VGK,23,49,2,13,15
27,8481178,Egor Zamula,D,PHI,24,59,2,13,15
27,8480043,Timothy Liljegren,D,TOR,25,60,1,14,15
27,8481568,Alex Vlasic,D,CHI,23,59,1,14,15
27,8478452,Caleb Jones,D,LAK,27,51,1,14,15
27,8480289,Morgan Barron,C,WPG,26,56,11,3,14
27,8476822,Luke Glendening,C,TBL,35,72,9,5,14
27,8484149,Gavin Brindley,C,CBJ,20,47,7,7,14
27,8482117,Lukas Reichel,L,CHI,22,60,6,8,14
27,8478434,Keegan Kolesar,R,VGK,27,73,6,8,14
27,8476374,Sean Kuraly,C,CBJ,31,50,6,8,14
27,8470600,Ryan Suter,D,STL,39,64,6,8,14
27,8482155,Alex Laferriere,R,LAK,23,65,6,8,14
27,8481592,Jakob Pelletier,L,CGY,23,46,6,8,14
27,8482496,Nils Aman,C,VAN,24,34,5,9,14
27,8478443,Brandon Carlo,D,BOS,28,54,4,10,14
27,8475455,Brenden Dillon,D,NJD,34,65,4,10,14
27,8483466,Kevin Korchinski,D,CHI,20,46,4,10,14
27,8477508,Curtis Lazar,C,NJD,29,59,3,11,14
27,8475279,Ben Chiarot,D,DET,33,66,3,11,14
27,8480070,Ian Mitchell,D,BOS,25,48,3,11,14
27,8481641,Joel Kiviranta,L,COL,28,73,3,11,14
27,8479369,Andrew Peeke,D,BOS,26,63,3,11,14
27,8471709,Marc-Edouard Vlasic,D,SJS,37,61,3,11,14
27,8474568,Luke Schenn,D,NSH,35,55,3,11,14
27,8482634,Alex Steeves,C,TOR,25,46,2,12,14
27,8480887,Jordan Harris,D,MTL,24,59,1,13,14
27,8480172,Jan Rutta,D,SJS,34,61,0,14,14
27,8479520,Brandon Duhaime,R,WSH,27,59,8,5,13
27,8482762,Simon Edvinsson,D,DET,21,48,8,5,13
27,8479328,Julien Gauthier,R,NYI,27,57,7,6,13
27,8477070,Liam O'Brien,C,UTA,30,51,7,6,13
27,8481522,Peyton Krebs,C,BUF,23,56,6,7,13
27,8480074,Alexandre Texier,C,STL,25,57,6,7,13
27,8479344,Jesse Puljujarvi,R,PIT,26,56,5,8,13
27,8482679,Matt Coronato,R,CGY,22,59,4,9,13
27,8477979,Nicolas Aube-Kubel,R,BUF,28,57,3,10,13
27,8480058,Pierre-Olivier Joseph,D,STL,25,53,3,10,13
27,8475233,David Savard,D,MTL,34,57,1,12,13
27,8477845,Trevor van Riemsdyk,D,WSH,33,59,0,13,13
27,8478840,Will Borgen,D,SEA,28,62,0,13,13
27,8478421,A.J. Greer,L,FLA,28,58,6,6,12
27,8479536,Axel Jonsson-Fjallby,L,WPG,26,35,6,6,12
27,8481013,Jonatan Berggren,R,DET,24,56,5,7,12
27,8476525,Colin Miller,D,WPG,32,62,5,7,12
27,8482659,Josh Doan,R,UTA,22,50,5,7,12
27,8479370,Tyson Jost,C,CAR,26,48,5,7,12
27,8476952,Dominic Toninato,C,WPG,30,41,5,7,12
27,8481521,Ronnie Attard,D,PHI,25,58,4,8,12
27,8482166,Shakir Mukhamadullin,D,SJS,22,56,4,8,12
27,8480355,Mark Kastelic,C,BOS,25,56,3,9,12
27,8482245,Artem Zub,D,OTT,29,67,2,10,12
27,8475462,Radko Gudas,D,ANA,34,74,2,10,12
27,8478468,Jeremy Lauzon,D,NSH,27,61,2,10,12
27,8481599,Victor Soderstrom,D,UTA,23,48,1,11,12
27,8479291,Kevin Rooney,C,CGY,31,53,6,5,11
27,8477482,Zachary Sanford,L,CHI,30,40,6,5,11
27,8480848,Ty Dellandrea,C,SJS,24,40,6,5,11
27,8480845,Rasmus Kupari,C,WPG,24,41,5,6,11
27,8483012,Logan Morrison,C,SEA,22,37,5,6,11
27,8477369,Carson Soucy,D,VAN,30,63,3,8,11
27,8477365,Connor Clifton,D,BUF,29,59,3,8,11
27,8474166,Alec Martinez,D,CHI,37,44,2,9,11
27,8482861,Vincent Iorio,D,WSH,22,37,2,9,11
27,8481167,Brayden Pachal,D,CGY,25,46,1,10,11
27,8475750,Jon Merrill,D,MIN,32,63,1,10,11
27,8478831,Kevin Stenlund,C,UTA,28,56,7,3,10
27,8478585,Derek Ryan,C,EDM,38,64,6,4,10
27,8476442,Matt Nieto,L,PIT,32,50,6,4,10
27,8483630,Pavol Regenda,L,ANA,25,25,5,5,10
27,8482077,Dylan Holloway,L,EDM,23,50,4,6,10
27,8482744,James Malatesta,L,CBJ,21,38,4,6,10
27,8480844,Grigori Denisenko,L,VGK,24,36,4,6,10
27,8479968,Vinni Lettieri,C,BOS,29,53,4,6,10
27,8479378,Logan Stanley,D,WPG,26,53,3,7,10
27,8480192,Johnathan Kovacevic,D,NJD,27,50,3,7,10
27,8475762,Derek Forbort,D,VAN,32,47,3,7,10
27,8477034,Jaycob Megna,D,FLA,32,52,1,9,10
27,8480879,Jacob Bernard-Docker,D,OTT,24,38,1,9,10
27,8475188,Brayden McNabb,D,VGK,33,58,0,10,10
27,8477478,William Carrier,L,CAR,30,58,8,1,9
27,8482807,Ethan Del Mastro,D,CHI,21,53,6,3,9
27,8482747,Brennan Othmann,L,NYR,21,41,6,3,9
27,8481161,Jake Christiansen,D,CBJ,25,61,5,4,9
27,8480157,Calle Rosen,D,COL,30,56,5,4,9
27,8475235,Nicolas Deslauriers,L,PHI,33,52,5,4,9
27,8476934,Brock McGinn,L,ANA,30,57,5,4,9
27,8483495,Simon Nemec,D,NJD,20,55,4,5,9
27,8480011,Klim Kostin,C,SJS,25,45,4,5,9
27,8483619,Filip Roos,D,OTT,25,41,4,5,9
27,8482153,Brendan Brisson,C,VGK,23,34,3,6,9
27,8481600,Tobias Bjornfot,D,FLA,23,36,3,6,9
27,8476473,Connor Murphy,D,CHI,31,41,3,6,9
27,8480727,Zach Whitecloud,D,VGK,28,45,2,7,9
27,8475842,Sam Carrick,C,NYR,32,62,2,7,9
27,8475208,Brian Dumoulin,D,ANA,33,55,2,7,9
27,8471677,Jack Johnson,D,CBJ,37,59,2,7,9
27,8477887,Patrick Brown,C,BOS,32,43,2,7,9
27,8474090,Brendan Smith,D,DAL,35,54,2,7,9
27,8479772,Zack MacEwen,R,OTT,28,51,2,7,9
27,8482148,Hendrix Lapierre,C,WSH,22,51,1,8,9
27,8478451,Ethan Bear,D,WSH,27,50,1,8,9
27,8475718,Justin Holl,D,DET,32,55,1,8,9
27,8480950,Ilya Lyubushkin,D,DAL,30,58,0,9,9
27,8482765,Isak Rosen,R,BUF,21,33,0,9,9
27,8479638,Justin Brazeau,R,BOS,26,42,6,2,8
27,8476873,Mark Jankowski,C,NSH,30,44,5,3,8
27,8477573,Nathan Walker,L,STL,30,44,5,3,8
27,8480441,Trey Fix-Wolansky,R,CBJ,25,33,5,3,8
27,8482652,Walker Duehr,R,CGY,27,36,5,3,8
27,8480448,Parker Kelly,L,COL,25,73,4,4,8
27,8482730,Brandt Clarke,D,LAK,21,48,4,4,8
27,8475958,Michael Sgarbossa,C,WSH,32,38,4,4,8
27,8481679,Maxence Guenette,D,OTT,23,33,4,4,8
27,8480245,Olle Lycksell,R,PHI,25,31,4,4,8
27,8479359,Beck Malenstyn,L,BUF,26,54,3,5,8
27,8479985,Cale Fleury,D,SEA,26,27,3,5,8
27,8482666,Scott Morrow,D,CAR,22,47,2,6,8
27,8481532,Alex Turcotte,C,LAK,23,43,2,6,8
27,8479348,Kale Clague,D,BUF,26,45,2,6,8
27,8483549,Lucas Condotta,L,MTL,27,34,2,6,8
27,8478424,Jansen Harkins,C,ANA,27,36,2,6,8
27,8479944,Zach Aston-Reese,C,VGK,30,43,2,6,8
27,8478146,Matthew Highmore,C,OTT,28,35,2,6,8
27,8477962,Brendan Lemieux,L,CAR,28,39,2,6,8
27,8482751,Ryan Winterton,C,SEA,21,37,2,6,8
27,8481122,Simon Benoit,D,TOR,26,35,1,7,8
27,8480807,Mattias Samuelsson,D,BUF,24,51,0,8,8
27,8474612,Travis Hamonic,D,OTT,34,47,0,8,8
27,8476867,Brendan Gaunce,C,MIN,30,33,4,3,7
27,8480870,Bo Groulx,C,NYR,24,35,4,3,7
27,8477467,Gustav Olofsson,D,SEA,30,28,4,3,7
27,8481743,Marc Del Gaizo,D,NSH,25,17,4,3,7
27,8481617,Vasily Podkolzin,R,VAN,23,47,3,4,7
27,8484911,Collin Graf,R,SJS,22,44,3,4,7
27,8482964,Arber Xhekaj,D,MTL,23,45,3,4,7
27,8483570,Ben Meyers,C,SEA,26,34,3,4,7
27,8481598,Philip Broberg,D,EDM,23,42,2,5,7
27,8480292,Carson Meyer,R,ANA,27,33,2,5,7
27,8477401,John Hayden,C,SEA,29,36,2,5,7
27,8478454,Noah Juulsen,D,VAN,27,31,2,5,7
27,8479998,Mikey Anderson,D,LAK,25,60,1,6,7
27,8484254,Akito Hirose,D,VAN,25,43,1,6,7
27,8478859,Niko Mikkola,D,FLA,28,50,0,7,7
27,8483460,David Jiricek,D,CBJ,21,52,0,7,7
27,8477384,Joshua Brown,D,EDM,30,36,0,7,7
27,8481147,Reese Johnson,C,MIN,26,40,4,2,6
27,8471817,Ryan Reaves,R,TOR,37,60,4,2,6
27,8479991,Jake Leschyshyn,C,NYR,25,33,4,2,6
27,8482784,Zach Dean,C,STL,21,35,3,3,6
27,8481701,Santeri Hatakka,D,NJD,23,30,3,3,6
27,8481751,Lukas Rousek,R,BUF,25,39,3,3,6
27,8479379,Givani Smith,R,SJS,26,31,3,3,6
27,8477971,Andreas Englund,D,LAK,28,32,3,3,6
27,8475690,Chris Tanev,D,TOR,35,62,2,4,6
27,8481789,Tye Kartye,L,SEA,23,33,2,4,6
27,8481754,Nikita Nesterenko,C,ANA,23,30,2,4,6
27,8476441,Joel Edmundson,D,LAK,31,44,2,4,6
27,8479442,Troy Stecher,D,EDM,30,52,2,4,6
27,8479986,Kole Lind,R,DAL,26,53,2,4,6
27,8481567,Henry Thrun,D,SJS,23,49,1,5,6
27,8479543,Michael Pezzetta,L,MTL,26,49,1,5,6
27,8480834,Ty Emberson,D,SJS,24,37,1,5,6
27,8480196,Jacob Bryson,D,BUF,27,51,0,6,6
27,8481556,John Beecher,C,BOS,23,28,3,2,5
27,8483397,Marc McLaughlin,C,BOS,25,30,3,2,5
27,8481605,Jackson LaCombe,D,ANA,23,32,3,2,5
27,8480880,Jakub Lauko,C,MIN,24,35,3,2,5
27,8481609,Vladislav Kolyachonok,D,UTA,23,36,3,2,5
27,8476913,Devin Shore,C,MIN,30,41,3,2,5
27,8482859,Zack Ostapchuk,C,OTT,21,53,2,3,5
27,8478450,Parker Wotherspoon,D,BOS,27,34,2,3,5
27,8477473,Justin Bailey,R,SJS,29,24,2,3,5
27,8482165,Yan Kuznetsov,D,CGY,22,25,2,3,5
27,8482858,Ryker Evans,D,SEA,23,21,2,3,5
27,8481237,Kyle MacLean,C,NYI,25,28,2,3,5
27,8481543,Nikita Alexandrov,C,STL,24,31,1,4,5
27,8475795,Dylan McIlrath,D,WSH,32,15,1,4,5
27,8477073,Kurtis MacDermid,L,NJD,30,28,1,4,5
27,8481699,Aku Raty,R,UTA,23,15,1,4,5
27,8478874,Adam Gaudette,R,OTT,28,27,0,5,5
27,8482733,Logan Mailloux,D,MTL,31,40,3,1,4
27,8478477,Mitchell Stephens,C,SEA,27,23,3,1,4
27,8482172,Landon Slaggert,L,CHI,22,29,3,1,4
27,8480851,Akil Thomas,C,LAK,24,18,3,1,4
27,8479994,Jaret Anderson-Dolan,C,WPG,25,33,2,2,4
27,8481518,Nolan Foote,L,NJD,24,39,2,2,4
27,8482141,Lukas Cormier,D,VGK,22,23,2,2,4
27,8478017,Mark Friedman,D,VAN,29,41,2,2,4
27,8482470,Ilya Solovyov,D,CGY,24,22,2,2,4
27,8482094,Daemon Hunt,D,MIN,22,21,2,2,4
27,8482201,Gage Goncalves,C,TBL,23,17,2,2,4
27,8484325,Waltteri Merela,C,TBL,26,31,2,2,4
27,8479249,Andrew Poturalski,C,SJS,30,32,1,3,4
27,8480990,Declan Chisholm,D,MIN,24,39,1,3,4
27,8479576,Vincent Desharnais,D,VAN,28,35,1,3,4
27,8477851,Jordan Oesterle,D,BOS,32,40,1,3,4
27,8478011,Louie Belpedio,D,PHI,28,13,1,3,4
27,8477938,Haydn Fleury,D,WPG,28,47,0,4,4
27,8477335,Kyle Burroughs,D,LAK,29,41,0,4,4
27,8481541,Samuel Bolduc,D,NYI,24,29,0,4,4
27,8477244,Chad Ruhwedel,D,NYR,34,28,0,4,4
27,8480890,Jan Jenik,C,OTT,24,28,0,4,4
27,8482713,Mackie Samoskevich,R,FLA,22,37,2,1,3
27,8478881,Brett Seney,L,CHI,28,6,2,1,3
27,8481719,Maxwell Crozier,D,TBL,24,14,2,1,3
27,8479367,William Lockwood,R,FLA,26,21,2,1,3
27,8482061,Brandon Biro,L,SEA,26,14,2,1,3
27,8483609,Adam Klapka,R,CGY,24,2,2,1,3
27,8480007,Jonas Rondbjerg,R,VGK,25,32,1,2,3
27,8479981,Jonah Gadjovich,L,FLA,26,37,1,2,3
27,8473446,Erik Johnson,D,PHI,36,43,1,2,3
27,8477527,Ross Johnston,L,ANA,30,28,1,2,3
27,8482145,Mavrik Bourque,C,DAL,22,47,1,2,3
27,8480267,Sammy Walker,C,MIN,25,18,1,2,3
27,8479320,Maxime Lajoie,D,SEA,27,23,1,2,3
27,8482516,Matthew Kessel,D,STL,24,13,1,2,3
27,8475177,Calvin de Haan,D,COL,33,47,0,3,3
27,8481056,Spencer Stastney,D,NSH,24,22,0,3,3
27,8482511,Mason Lohrei,D,BOS,23,32,0,3,3
27,8476372,Nick Seeler,D,PHI,31,44,0,3,3
27,8482177,Marat Khusnutdinov,C,MIN,22,29,0,3,3
27,8479587,Rhett Gardner,C,PHI,28,17,0,3,3
27,8481593,Jayden Struble,D,MTL,23,16,0,3,3
27,8484287,Cole McWard,D,VAN,23,22,2,0,2
27,8483763,Maksymilian Szuber,D,UTA,22,32,2,0,2
27,8480468,James Hamblin,L,EDM,25,22,2,0,2
27,8480874,Adam Ginning,D,PHI,24,12,2,0,2
27,8481585,Egor Afanasyev,L,SJS,23,18,2,0,2
27,8483395,Arshdeep Bains,L,VAN,23,8,2,0,2
27,8478409,Anthony Richard,C,PHI,28,25,1,1,2
27,8482070,Mitchell Chaffee,R,TBL,26,47,1,1,2
27,8482144,Jack Thompson,D,SJS,22,26,1,1,2
27,8478502,Dennis Gilbert,D,BUF,28,15,1,1,2
27,8478051,Max Willman,C,NJD,29,17,1,1,2
27,8474062,Riley Nash,C,NYR,35,14,1,1,2
27,8482118,Sam Colangelo,R,ANA,23,17,1,1,2
27,8482147,Jean-Luc Foudy,C,COL,22,22,1,1,2
27,8481030,Jack St. Ivany,D,PIT,25,20,1,1,2
27,8477541,Dakota Mermis,D,TOR,30,10,1,1,2
27,8483489,Fraser Minten,C,TOR,31,8,1,1,2
27,8483407,Brandon Scanlin,D,NYR,25,5,1,1,2
27,8481065,Angus Crookshank,L,OTT,25,21,1,1,2
27,8481578,Graeme Clarke,R,MIN,23,13,0,2,2
27,8477149,Scott Sabourin,R,SJS,32,13,0,2,2
27,8481564,Ryan Johnson,D,BUF,23,15,0,2,2
27,8481422,Jake Lucchini,C,NSH,29,22,0,2,2
27,8482102,Vasily Ponomarev,C,PIT,22,21,0,2,2
27,8479362,Riley Tufte,L,BOS,26,15,0,2,2
27,8477462,Robert Hagg,D,VGK,29,19,1,0,1
27,8484258,Sam Malinski,D,COL,26,16,1,0,1
27,8481043,Cole Koepke,L,BOS,26,18,1,0,1
27,8479419,Brett Murray,L,BUF,26,15,1,0,1
27,8482250,Callahan Burke,C,VGK,27,21,1,0,1
27,8483567,Georgii Merkulov,C,BOS,24,16,1,0,1
27,8482162,Roby Jarventie,L,EDM,22,10,1,0,1
27,8483398,Declan Carlile,D,TBL,31,10,1,0,1
27,8482929,Emil Lilleberg,D,TBL,23,21,1,0,1
27,8483597,Milos Kelemen,L,UTA,25,13,0,1,1
27,8481006,Tyler Tucker,D,STL,24,19,0,1,1
27,8480084,Nick DeSimone,D,NJD,30,12,0,1,1
27,8480306,Grant Hutton,D,NYI,29,7,0,1,1
27,8475413,Justin Dowling,C,NJD,34,14,0,1,1
27,8477993,Justin Kirkland,C,CGY,28,5,0,1,1
27,8478021,William Lagesson,D,DET,28,29,0,1,1
27,8483512,Matthew Savoie,C,EDM,20,20,0,1,1
27,8484304,Uvis Balinskis,D,FLA,28,5,0,1,1
27,8480823,Alexander Alexeyev,D,WSH,25,11,0,1,1
27,8477320,Anton Blidh,L,NYR,29,16,0,1,1
27,8477810,Joel Hanley,D,CGY,33,18,0,1,1
27,8482476,Emil Heineman,L,MTL,23,4,0,1,1
27,8476323,Max McCormick,L,SEA,32,3,0,1,1
27,8481655,Cole Schwindt,R,CGY,23,9,0,1,1
27,8484255,Jason Polin,R,COL,25,5,0,1,1
27,8478956,Samuel Laberge,L,NJD,27,1,0,1,1
27,8480032,Shane Bowers,C,NJD,25,6,0,0,0
27,8482460,Matt Rempe,C,NYR,22,9,0,0,0
27,8475780,Chris Wagner,R,COL,33,7,0,0,0
27,8481024,Linus Karlsson,C,VAN,25,6,0,0,0
27,8475755,Alexander Petrovic,D,DAL,32,9,0,0,0
27,8479330,Brandon Gignac,C,MTL,27,13,0,0,0
27,8481206,John Ludvig,D,PIT,24,7,0,0,0
27,8478446,Glenn Gawdin,C,LAK,27,16,0,0,0
27,8482088,Justin Sourdif,R,FLA,22,11,0,0,0
27,8483471,Brad Lambert,C,WPG,31,8,0,0,0
27,8482787,Nikita Chibrikov,R,WPG,31,7,0,0,0
27,8481462,Mason Morelli,L,VGK,28,11,0,0,0
27,8481806,Louis Crevier,D,CHI,23,13,0,0,0
27,8483531,Brian Halonen,L,NJD,25,3,0,0,0
27,8480075,Cameron Crotty,D,MIN,25,9,0,0,0
27,8483920,Pierrick Dube,R,WSH,23,1,0,0,0
27,8479421,Jacob Moverare,D,LAK,26,4,0,0,0
27,8480274,Philip Kemp,D,EDM,25,1,0,0,0
27,8483546,Marshall Rifai,D,TOR,26,2,0,0,0
27,8478147,Bokondji Imama,L,PIT,28,6,0,0,0
27,8482197,Adam Raska,R,MIN,23,7,0,0,0
27,8483401,Marc Johnstone,R,PIT,28,0,0,0,0
27,8481534,Raphael Lavoie,C,EDM,24,0,0,0,0
27,8479522,Hardy Haman Aktell,D,WSH,26,3,0,0,0
27,8484259,Ondrej Pavel,C,COL,31,2,0,0,0
27,8481726,Adam Edstrom,C,NYR,24,4,0,0,0
27,8478854,Ryan Shea,D,PIT,27,6,0,0,0
27,8484326,Patrik Koch,D,UTA,28,1,0,0,0
27,8482126,Emil Andrae,D,PHI,31,1,0,0,0
27,8483432,Luca Del Bel Belluz,C,CBJ,31,3,0,0,0
27,8484321,Nikolas Matinpalo,D,OTT,26,2,0,0,0
27,8470794,Joe Pavelski,C,,40,0,0,0,0
27,8479321,Lucas Johansen,D,,27,0,0,0,0
27,8477950,Tony DeAngelo,D,,29,0,0,0,0
27,8471218,Blake Wheeler,R,,38,0,0,0,0
27,8475197,Tyson Barrie,D,,33,0,0,0,0
27,8474157,Max Pacioretty,L,,36,0,0,0,0
27,8475744,Evgeny Kuznetsov,C,,32,0,0,0,0
27,8474037,James van Riemsdyk,L,,35,0,0,0,0
27,8476907,Mackenzie MacEachern,L,,30,0,0,0,0
27,8480216,Jacob Peterson,C,,25,0,0,0,0
27,8474602,Justin Schultz,D,,34,0,0,0,0
27,8482222,Alexander Barabanov,L,,30,0,0,0,0
27,8474031,Kevin Shattenkirk,D,,35,0,0,0,0
27,8477330,Dominik Kubalik,L,,29,0,0,0,0
27,8480884,Calen Addison,D,,24,0,0,0,0
27,8475906,John Klingberg,D,,32,0,0,0,0
27,8480008,Adam Ruzicka,C,,25,0,0,0,0
27,8476884,Derrick Pouliot,D,,30,0,0,0,0
27,8476919,Chris Tierney,C,,30,0,0,0,0
27,8479415,Michael McLeod,C,,26,0,0,0,0
27,8474870,Tyler Johnson,C,,34,0,0,0,0
27,8470604,Jeff Carter,C,,39,0,0,0,0
27,8478104,Sammy Blais,L,,28,0,0,0,0
27,8474884,Mike Hoffman,C,,35,0,0,0,0
27,8481591,Sam Poulin,R,,23,0,0,0,0
27,8471274,Alex Goligoski,D,,39,0,0,0,0
27,8476871,Tanner Pearson,L,,32,0,0,0,0
27,8476393,Nick Cousins,C,,31,0,0,0,0
27,8479977,Kailer Yamamoto,R,,26,0,0,0,0
27,8479346,Dillon Dube,C,,26,0,0,0,0
27,8480184,Gustav Lindstrom,D,,26,0,0,0,0
27,8479376,Victor Mete,D,,26,0,0,0,0
27,8473449,Kyle Okposo,R,,36,0,0,0,0
27,8481058,Jesse Ylonen,R,,25,0,0,0,0
27,8475752,Tyler Pitlick,C,,33,0,0,0,0
27,8481239,Samuel Fagemo,L,,24,0,0,0,0
27,8480821,Filip Zadina,R,,25,0,0,0,0
27,8470966,Mark Giordano,D,,41,0,0,0,0
27,8478495,Denis Gurianov,R,,27,0,0,0,0
27,8477464,Nic Petan,C,,29,0,0,0,0
27,8478099,Kevin Labanc,R,,29,0,0,0,0
27,8482241,Radim Zohorna,L,,28,0,0,0,0
27,8474040,Sam Gagner,C,,35,0,0,0,0
27,8479514,Rem Pitlick,C,,27,0,0,0,0
27,8478430,Oliver Kylington,D,,27,0,0,0,0
27,8479533,Joona Koppanen,L,,26,0,0,0,0
27,8479984,Cal Foote,D,,26,0,0,0,0
27,8477126,Jayson Megna,C,,34,0,0,0,0
27,8475164,Jakob Silfverberg,R,,34,0,0,0,0
27,8474009,Nick Bonino,C,,36,0,0,0,0
27,8479458,Nikita Zaitsev,D,,33,0,0,0,0
27,8477944,Jakub Vrana,L,,28,0,0,0,0
27,8471699,Andrew Cogliano,C,,37,0,0,0,0
27,8478067,Oskar Lindblom,L,,28,0,0,0,0
27,8471686,Marc Staal,D,,37,0,0,0,0
27,8470610,Zach Parise,L,,40,0,0,0,0
27,8478904,Steven Lorentz,C,,28,0,0,0,0
27,8473473,Milan Lucic,L,,36,0,0,0,0
27,8480031,Maxime Comtois,L,,25,0,0,0,0
27,8478512,Austin Czarnik,C,,32,0,0,0,0
27,8473504,Cal Clutterbuck,R,,37,0,0,0,0
27,8477454,Adam Erne,L,,29,0,0,0,0
27,8479383,Boris Katchouk,L,,26,0,0,0,0
27,8475825,Jani Hakanpää,D,,32,0,0,0,0
27,8477846,Ryan Carpenter,C,,33,0,0,0,0
27,8477930,Pierre-Edouard Bellemare,L,,39,0,0,0,0
27,8478400,Colin White,C,,27,0,0,0,0
27,8480226,Marián Studenic,R,,26,0,0,0,0
27,8480853,Liam Foudy,C,,24,0,0,0,0
27,8475797,Jarred Tinordi,D,,32,0,0,0,0
27,8479423,Alex Nylander,L,,26,0,0,0,0
27,8474618,Marco Scandella,D,,34,0,0,0,0
27,8478028,Fredrik Olofsson,L,,28,0,0,0,0
27,8474709,Matt Martin,L,,35,0,0,0,0
27,8481070,Hugh McGing,L,,26,0,0,0,0
27,8479546,Oskar Steen,C,,26,0,0,0,0
27,8474145,Robert Bortuzzo,D,,35,0,0,0,0
27,8476915,Jujhar Khaira,L,,30,0,0,0,0
27,8475278,Byron Froese,C,,33,0,0,0,0
27,8481812,Nikolai Knyzhov,D,,27,0,0,0,0
27,8478408,Travis Dermott,D,,28,0,0,0,0
27,8481077,John Leonard,L,,26,0,0,0,0
27,8479547,Matthew Phillips,R,,26,0,0,0,0
27,8480836,Jonathan Gruden,C,,24,0,0,0,0
27,8481690,Tyler Angle,C,,24,0,0,0,0
27,8475766,Austin Watson,L,,32,0,0,0,0
27,8481016,Ruslan Iskhakov,C,,24,0,0,0,0
27,8478078,Rourke Chartier,C,,28,0,0,0,0
27,8480776,Sheldon Rempal,R,,29,0,0,0,0
27,8483045,Cameron Butler,R,CBJ,31,2,0,0,0
27,8484314,Jiri Smejkal,L,,28,0,0,0,0
28,8477492,Nathan MacKinnon,C,COL,29,81,55,105,160
28,8476453,Nikita Kucherov,R,TBL,31,82,44,92,136
28,8478402,Connor McDavid,C,EDM,27,78,43,93,136
28,8479314,Matthew Tkachuk,L,FLA,27,78,42,80,122
28,8480027,Jason Robertson,L,DAL,25,82,46,71,117
28,8478420,Mikko Rantanen,R,COL,28,79,51,62,113
28,8478864,Kirill Kaprizov,L,MIN,27,71,47,59,106
28,8478550,Artemi Panarin,L,NYR,33,82,45,61,106
28,8477934,Leon Draisaitl,C,EDM,29,80,36,68,104
28,8481559,Jack Hughes,C,NJD,23,75,42,60,102
28,8477939,William Nylander,R,TOR,28,82,51,49,100
28,8477956,David Pastrnak,R,BOS,28,78,45,55,100
28,8477933,Sam Reinhart,C,FLA,29,78,42,58,100
28,8480800,Quinn Hughes,D,VAN,25,77,13,86,99
28,8479318,Auston Matthews,C,TOR,27,74,51,46,97
28,8477493,Aleksander Barkov,C,FLA,29,82,28,69,97
28,8480023,Robert Thomas,C,STL,25,77,26,71,97
28,8476468,J.T. Miller,C,VAN,31,79,32,64,96
28,8477946,Dylan Larkin,C,DET,28,82,44,50,94
28,8478483,Mitch Marner,R,TOR,27,80,30,64,94
28,8476887,Filip Forsberg,L,NSH,30,72,46,47,93
28,8477942,Kevin Fiala,L,LAK,28,81,32,60,92
28,8480012,Elias Pettersson,C,VAN,26,79,39,51,90
28,8482116,Tim Stützle,C,OTT,22,81,32,58,90
28,8476454,Ryan Nugent-Hopkins,C,EDM,31,81,26,62,88
28,8474564,Steven Stamkos,C,NSH,34,77,39,46,85
28,8480002,Nico Hischier,C,NJD,25,76,24,60,84
28,8476539,Jonathan Marchessault,R,NSH,34,79,43,40,83
28,8478445,Mathew Barzal,C,NYI,27,81,20,63,83
28,8478010,Brayden Point,C,TBL,28,82,47,35,82
28,8476460,Mark Scheifele,C,WPG,31,71,29,53,82
28,8476456,Jonathan Huberdeau,C,CGY,31,76,21,61,82
28,8478427,Sebastian Aho,C,CAR,27,69,43,38,81
28,8478398,Kyle Connor,L,WPG,28,70,37,44,81
28,8471215,Evgeni Malkin,C,PIT,38,73,29,52,81
28,8475765,Vladimir Tarasenko,R,DET,33,79,28,53,81
28,8475172,Nazem Kadri,C,CGY,34,80,36,44,80
28,8471214,Alex Ovechkin,L,WSH,39,70,35,45,80
28,8471675,Sidney Crosby,C,PIT,37,73,29,51,80
28,8475913,Mark Stone,R,VGK,32,79,27,53,80
28,8482093,Seth Jarvis,C,CAR,22,74,40,39,79
28,8477404,Jake Guentzel,C,TBL,30,82,32,47,79
28,8479343,Clayton Keller,R,UTA,26,77,32,46,78
28,8480208,Drake Batherson,R,OTT,26,77,25,52,77
28,8475799,Nino Niederreiter,R,WPG,32,67,47,29,76
28,8478403,Jack Eichel,C,VGK,28,77,36,40,76
28,8479407,Jesper Bratt,L,NJD,26,72,25,51,76
28,8475786,Zach Hyman,L,EDM,32,76,35,40,75
28,8474600,Roman Josi,D,NSH,34,73,19,56,75
28,8480865,Noah Dobson,D,NYI,24,80,13,62,75
28,8479542,Brandon Hagel,L,TBL,26,81,32,42,74
28,8476905,Chandler Stephenson,C,SEA,30,76,27,47,74
28,8476346,Johnny Gaudreau,L,CBJ,31,71,17,57,74
28,8476389,Vincent Trocheck,C,NYR,31,75,35,38,73
28,8477501,Valeri Nichushkin,R,COL,29,80,33,40,73
28,8479337,Alex DeBrincat,R,DET,27,78,31,42,73
28,8477504,Josh Morrissey,D,WPG,29,75,19,54,73
28,8475810,Bryan Rust,R,PIT,32,74,34,38,72
28,8480018,Nick Suzuki,C,MTL,25,76,24,47,71
28,8480803,Evan Bouchard,D,EDM,25,75,19,52,71
28,8480036,Miro Heiskanen,D,DAL,25,77,16,55,71
28,8477409,Carter Verhaeghe,C,FLA,29,78,34,36,70
28,8478439,Travis Konecny,R,PHI,27,79,27,43,70
28,8479420,Tage Thompson,C,BUF,27,77,33,36,69
28,8483515,Juraj Slafkovsky,L,MTL,20,73,26,43,69
28,8478414,Timo Meier,R,NJD,28,74,40,28,68
28,8475754,Brock Nelson,C,NYI,33,81,30,38,68
28,8477960,Adrian Kempe,R,LAK,28,80,30,38,68
28,8484144,Connor Bedard,C,CHI,19,72,30,38,68
28,8477940,Nikolaj Ehlers,L,WPG,28,73,24,44,68
28,8478460,Zach Werenski,D,CBJ,27,80,14,54,68
28,8478440,Dylan Strome,C,WSH,27,77,25,42,67
28,8478873,Troy Terry,R,ANA,27,72,25,41,66
28,8481533,Trevor Zegras,C,ANA,23,65,23,43,66
28,8473419,Brad Marchand,L,BOS,36,79,22,44,66
28,8475166,John Tavares,C,TOR,34,78,27,38,65
28,8480801,Brady Tkachuk,L,OTT,25,79,23,42,65
28,8477496,Elias Lindholm,C,BOS,30,78,18,47,65
28,8480069,Cale Makar,D,COL,26,64,18,47,65
28,8473986,Alex Killorn,L,ANA,35,75,35,29,64
28,8476459,Mika Zibanejad,C,NYR,31,75,27,37,64
28,8479675,Trevor Moore,L,LAK,29,81,25,39,64
28,8471685,Anze Kopitar,C,LAK,37,80,24,40,64
28,8481528,Dylan Cozens,C,BUF,23,73,22,42,64
28,8474679,Gustav Nyquist,C,NSH,35,78,19,45,64
28,8476462,Dougie Hamilton,D,NJD,31,72,18,46,64
28,8479323,Adam Fox,D,NYR,26,72,14,50,64
28,8482078,Lucas Raymond,L,DET,22,82,24,39,63
28,8478449,Roope Hintz,C,DAL,28,82,22,41,63
28,8475184,Chris Kreider,L,NYR,33,74,37,25,62
28,8482665,Matty Beniers,C,SEA,22,72,29,33,62
28,8481560,Arthur Kaliyev,R,LAK,23,78,28,34,62
28,8475168,Matt Duchene,C,DAL,33,79,23,39,62
28,8477951,Nick Schmaltz,C,UTA,28,79,22,40,62
28,8474578,Erik Karlsson,D,PIT,34,76,19,43,62
28,8478366,Frank Vatrano,R,ANA,30,76,33,28,61
28,8475794,Tyler Seguin,C,DAL,32,82,30,31,61
28,8477402,Pavel Buchnevich,L,STL,29,77,23,38,61
28,8475745,Charlie Coyle,C,BOS,32,80,18,43,61
28,8482684,Luke Hughes,D,NJD,21,72,14,47,61
28,8478493,Joel Eriksson Ek,C,MIN,27,71,32,28,60
28,8479385,Jordan Kyrou,C,STL,26,74,28,32,60
28,8475798,Mikael Granlund,C,SJS,32,64,12,48,60
28,8477500,Bo Horvat,C,NYI,29,79,31,28,59
28,8480014,Gabriel Vilardi,C,WPG,25,71,30,29,59
28,8482740,Wyatt Johnston,C,DAL,21,82,27,32,59
28,8474141,Patrick Kane,R,DET,36,78,23,36,59
28,8477949,Alex Tuch,R,BUF,28,70,23,36,59
28,8473994,Jamie Benn,L,DAL,35,80,22,37,59
28,8475692,Mats Zuccarello,R,MIN,37,74,17,42,59
28,8478407,Vince Dunn,D,SEA,28,75,17,42,59
28,8477447,Shea Theodore,D,VGK,29,61,15,44,59
28,8475167,Victor Hedman,D,TBL,34,80,10,49,59
28,8478401,Pavel Zacha,C,BOS,27,76,23,35,58
28,8473512,Claude Giroux,R,OTT,36,79,17,41,58
28,8475726,Tyler Toffoli,C,SJS,32,68,36,21,57
28,8480064,Josh Norris,C,OTT,25,77,27,30,57
28,8477416,Oliver Bjorkstrand,R,SEA,29,74,24,33,57
28,8478047,Michael Bunting,L,PIT,29,70,24,33,57
28,8482109,Alexis Lafrenière,L,NYR,23,76,18,39,57
28,8480839,Rasmus Dahlin,D,BUF,24,74,11,46,57
28,8476853,Morgan Rielly,D,TOR,30,69,9,48,57
28,8477935,Sam Bennett,C,FLA,28,73,28,28,56
28,8478444,Brock Boeser,R,VAN,27,75,27,29,56
28,8477476,Artturi Lehkonen,L,COL,29,78,27,29,56
28,8479999,Casey Mittelstadt,C,COL,26,80,25,31,56
28,8475158,Ryan O'Reilly,C,NSH,33,72,22,34,56
28,8476880,Tom Wilson,R,WSH,30,71,29,26,55
28,8481557,Matt Boldy,L,MIN,23,72,28,27,55
28,8474102,David Perron,L,OTT,36,76,27,28,55
28,8476448,William Karlsson,C,VGK,31,77,25,30,55
28,8477456,J.T. Compher,L,DET,29,77,19,36,55
28,8476958,Jaccob Slavin,D,CAR,30,75,10,45,55
28,8478498,Jake DeBrusk,L,VAN,28,67,28,26,54
28,8475784,Jeff Skinner,C,EDM,32,79,27,27,54
28,8474641,Adam Henrique,C,EDM,34,74,26,28,54
28,8481068,Yegor Sharangovich,C,CGY,26,76,25,29,54
28,8476483,Rickard Rakell,R,PIT,31,66,25,29,54
28,8482097,Jack Quinn,R,BUF,23,71,20,34,54
28,8480015,Owen Tippett,R,PHI,25,74,18,36,54
28,8480830,Andrei Svechnikov,R,CAR,24,69,16,38,54
28,8481711,Matias Maccelli,L,UTA,24,75,15,39,54
28,8476882,Teuvo Teravainen,C,CHI,30,67,22,31,53
28,8481540,Cole Caufield,R,MTL,23,77,21,32,53
28,8478462,Nicolas Roy,C,VGK,27,76,21,32,53
28,8479325,Charlie McAvoy,D,BOS,27,75,11,42,53
28,8477511,Anthony Mantha,R,CGY,30,76,26,26,52
28,8482667,William Eklund,L,SJS,22,68,24,28,52
28,8484153,Leo Carlsson,C,ANA,20,75,15,37,52
28,8482133,Thomas Bordeleau,C,SJS,22,65,15,37,52
28,8476432,Boone Jenner,C,CBJ,31,65,35,16,51
28,8482159,Tyson Foerster,R,PHI,22,74,26,25,51
28,8476399,Blake Coleman,C,CGY,33,77,24,27,51
28,8476881,Tomas Hertl,C,VGK,31,79,22,29,51
28,8477955,Jared McCann,L,SEA,28,72,22,29,51
28,8482702,Logan Stankoven,C,DAL,21,79,15,36,51
28,8477346,MacKenzie Weegar,D,CGY,30,73,11,40,51
28,8474586,Jordan Eberle,R,SEA,34,73,14,36,50
28,8478474,Lawson Crouse,L,UTA,27,77,25,24,49
28,8481596,Shane Pinto,C,OTT,24,76,20,29,49
28,8478519,Anthony Cirelli,C,TBL,27,82,18,31,49
28,8475287,Erik Haula,L,NJD,33,74,17,32,49
28,8478396,Noah Hanifin,D,VGK,27,62,11,38,49
28,8482110,Dawson Mercer,C,NJD,23,75,30,18,48
28,8475151,Kyle Palmieri,C,NYI,33,78,28,20,48
28,8483808,Andrei Kuzmenko,L,CGY,28,75,27,21,48
28,8478975,Mason Marchment,L,DAL,29,81,24,24,48
28,8475170,Brayden Schenn,C,STL,33,74,19,29,48
28,8481703,Valtteri Puustinen,R,PIT,25,62,16,32,48
28,8474563,Drew Doughty,D,LAK,35,73,13,35,48
28,8478438,Tommy Novak,C,NSH,27,72,11,37,48
28,8477494,Jonathan Drouin,L,COL,29,81,20,27,47
28,8480039,Martin Necas,C,CAR,25,73,13,34,47
28,8471724,Kris Letang,D,PIT,37,78,13,34,47
28,8476906,Shayne Gostisbehere,D,CAR,31,78,12,35,47
28,8477986,Brandon Montour,D,SEA,30,75,10,37,47
28,8478038,Devon Toews,D,COL,30,72,6,41,47
28,8479400,Pierre-Luc Dubois,L,WSH,26,62,16,30,46
28,8477503,Max Domi,C,TOR,29,78,14,32,46
28,8484166,Adam Fantilli,C,CBJ,20,71,21,24,45
28,8481618,Alex Newhook,C,MTL,23,75,20,25,45
28,8477021,Alex Kerfoot,C,UTA,30,73,19,26,45
28,8482745,Mason McTavish,C,ANA,21,72,18,27,45
28,8478469,Thomas Chabot,D,OTT,27,73,11,34,45
28,8478397,Rasmus Andersson,D,CGY,28,77,9,36,45
28,8482124,Quinton Byfield,R,LAK,22,80,17,27,44
28,8476826,Yanni Gourde,C,SEA,33,74,16,28,44
28,8476479,Phillip Danault,C,LAK,31,76,15,29,44
28,8470613,Brent Burns,D,CAR,39,76,13,31,44
28,8479410,Mikhail Sergachev,D,UTA,26,66,10,34,44
28,8481542,Moritz Seider,D,DET,23,76,9,35,44
28,8474150,Mikael Backlund,C,CGY,35,74,8,36,44
28,8476875,Mike Matheson,D,MTL,30,71,7,37,44
28,8482122,Brock Faber,D,MIN,22,79,5,39,44
28,8483431,Logan Cooley,C,UTA,20,70,19,24,43
28,8477429,Andrew Copp,C,DET,30,81,18,25,43
28,8482113,Anton Lundell,C,FLA,23,77,16,27,43
28,8476872,Scott Laughton,C,PHI,30,74,14,29,43
28,8482175,JJ Peterka,R,BUF,22,62,29,13,42
28,8475763,Kevin Hayes,R,PIT,32,70,20,22,42
28,8480009,Eeli Tolvanen,R,SEA,25,72,16,26,42
28,8478856,Conor Garland,R,VAN,28,74,16,26,42
28,8482720,Matthew Knies,L,TOR,22,76,15,27,42
28,8480028,Morgan Frost,C,PHI,25,72,12,30,42
28,8475314,Anders Lee,L,NYI,34,79,29,12,41
28,8475169,Evander Kane,L,EDM,33,73,23,18,41
28,8471698,T.J. Oshie,R,WSH,38,70,19,22,41
28,8477407,Anthony Duclair,L,NYI,29,77,18,23,41
28,8480798,Philipp Kurashev,C,CHI,25,67,17,24,41
28,8474053,Logan Couture,C,SJS,35,60,14,27,41
28,8482105,Jake Sanderson,D,OTT,22,79,12,29,41
28,8476474,Stefan Noesen,R,NJD,31,63,25,15,40
28,8478133,Jake Evans,C,MTL,28,70,19,21,40
28,8482092,Ridly Greig,C,OTT,22,80,17,23,40
28,8477998,Warren Foegele,L,LAK,28,78,16,24,40
28,8481186,Logan O'Connor,R,COL,28,77,16,24,40
28,8479987,Morgan Geekie,C,BOS,26,75,14,26,40
28,8476923,Damon Severson,D,CBJ,30,80,13,27,40
28,8481581,Thomas Harley,D,DAL,23,72,13,27,40
28,8476792,Torey Krug,D,STL,33,76,7,33,40
28,8482699,Dylan Guenther,R,UTA,21,77,21,18,39
28,8477426,Nicholas Paul,L,TBL,29,81,17,22,39
28,8479351,Sam Steel,C,DAL,26,80,17,22,39
28,8478891,Mason Appleton,C,WPG,28,63,15,24,39
28,8477839,Conor Sheary,L,TBL,32,79,15,24,39
28,8484145,Zach Benson,L,BUF,19,66,14,25,39
28,8479992,Michael Rasmussen,C,DET,25,78,13,26,39
28,8475193,Tomas Tatar,L,NJD,34,63,12,27,39
28,8479345,Jakob Chychrun,D,WSH,26,67,12,27,39
28,8478458,John (Jack) Roslovic,C,CAR,27,63,10,29,39
28,8476292,Ondrej Palat,L,NJD,33,70,16,22,38
28,8476458,Ryan Strome,C,ANA,31,64,11,27,38
28,8475753,Justin Faulk,D,STL,32,67,11,27,38
28,8480434,Sean Durzi,D,UTA,26,70,10,28,38
28,8475764,Cam Fowler,D,ANA,33,72,1,37,38
28,8479525,Ross Colton,C,COL,28,81,21,16,37
28,8478542,Evan Rodrigues,C,FLA,31,79,17,20,37
28,8479365,Trent Frederic,C,BOS,26,77,17,20,37
28,8477932,Aaron Ekblad,D,FLA,28,72,13,24,37
28,8475171,Oliver Ekman-Larsson,D,TOR,33,67,11,26,37
28,8478055,Gustav Forsling,D,FLA,28,68,8,29,37
28,8476438,Brandon Saad,L,STL,32,67,22,14,36
28,8475768,Jaden Schwartz,C,SEA,32,70,18,18,36
28,8480849,Barrett Hayton,C,UTA,24,75,18,18,36
28,8475760,Nick Bjugstad,C,UTA,32,74,17,19,36
28,8477444,Andre Burakovsky,L,SEA,29,74,16,20,36
28,8478466,Daniel Sprong,R,VAN,27,75,15,21,36
28,8478115,Pierre Engvall,L,NYI,28,76,15,21,36
28,8478046,Danton Heinen,L,VAN,29,70,15,21,36
28,8478472,Mathieu Joseph,R,STL,27,65,15,21,36
28,8475191,Reilly Smith,R,NYR,33,73,14,22,36
28,8481524,Bowen Byram,D,BUF,23,65,12,24,36
28,8480145,Neal Pionk,D,WPG,29,76,6,30,36
28,8474590,John Carlson,D,WSH,34,66,3,33,36
28,8477479,Tyler Bertuzzi,L,CHI,29,62,17,18,35
28,8480762,Eric Robinson,L,CAR,29,60,17,18,35
28,8476392,Adam Lowry,C,WPG,31,71,16,19,35
28,8480829,Jesperi Kotkaniemi,C,CAR,24,68,16,19,35
28,8474565,Alex Pietrangelo,D,VGK,34,62,15,20,35
28,8476419,Jean-Gabriel Pageau,C,NYI,32,77,12,23,35
28,8477964,Ivan Barbashev,C,VGK,29,77,11,24,35
28,8475149,Marcus Johansson,L,MIN,34,66,11,24,35
28,8479425,Filip Hronek,D,VAN,27,74,6,29,35
28,8482712,Oskar Olausson,R,COL,22,79,6,29,35
28,8480185,Eetu Luostarinen,C,FLA,26,74,17,17,34
28,8475714,Calle Jarnkrok,C,TOR,33,76,17,17,34
28,8481481,Blake Lizotte,C,PIT,27,66,15,19,34
28,8474149,Evgenii Dadonov,R,DAL,35,80,14,20,34
28,8483505,Matthew Poitras,C,BOS,20,74,14,20,34
28,8477497,Sean Monahan,C,CBJ,30,70,13,21,34
28,8480188,Fabian Zetterlund,L,SJS,25,60,13,21,34
28,8475848,Brendan Gallagher,R,MTL,32,59,12,22,34
28,8480073,Erik Brannstrom,D,COL,25,62,9,25,34
28,8480817,K'Andre Miller,D,NYR,24,74,8,26,34
28,8479661,Tanner Jeannot,L,LAK,27,79,18,15,33
28,8476461,Sean Couturier,C,PHI,32,75,17,16,33
28,8480797,Joel Farabee,L,PHI,24,76,15,18,33
28,8481624,Ilya Mikheyev,R,CHI,30,62,15,18,33
28,8477425,Miles Wood,L,COL,29,81,15,18,33
28,8477495,Seth Jones,D,CHI,30,67,6,27,33
28,8478882,Vladislav Gavrikov,D,LAK,29,72,6,27,33
28,8474151,Ryan McDonagh,D,TBL,35,78,2,31,33
28,8470621,Corey Perry,R,EDM,39,67,22,10,32
28,8478042,Viktor Arvidsson,L,EDM,31,73,14,18,32
28,8480813,Joe Veleno,C,DET,24,80,14,18,32
28,8482055,Drew O'Connor,L,PIT,26,62,14,18,32
28,8479591,Michael Eyssimont,C,TBL,28,78,14,18,32
28,8482146,Luke Evangelista,R,NSH,22,63,13,19,32
28,8481604,Pavel Dorofeyev,L,VGK,24,69,12,20,32
28,8480802,Ryan McLeod,C,BUF,25,70,10,22,32
28,8482671,Owen Power,D,BUF,22,66,10,22,32
28,8481577,Philip Tomasino,C,NSH,23,62,7,25,32
28,8476854,Hampus Lindholm,D,BOS,30,72,6,26,32
28,8476917,Adam Pelech,D,NYI,30,75,6,26,32
28,8483490,Pavel Mintyukov,D,ANA,21,72,4,28,32
28,8479402,Jake Bean,D,CGY,26,65,4,28,32
28,8476981,Josh Anderson,R,MTL,30,68,18,13,31
28,8477505,Alexander Wennberg,C,SJS,30,58,14,17,31
28,8477451,Ryan Hartman,R,MIN,30,64,13,18,31
28,8480078,Filip Chytil,C,NYR,25,64,13,18,31
28,8475791,Taylor Hall,L,CHI,33,51,9,22,31
28,8479982,Conor Timmins,D,TOR,26,59,8,23,31
28,8476869,Brady Skjei,D,NSH,30,74,7,24,31
28,8480871,Adam Boqvist,D,FLA,24,67,7,24,31
28,8476979,Erik Gustafsson,D,DET,32,74,7,24,31
28,8479639,Dylan Coghlan,D,WPG,26,59,7,24,31
28,8477506,Ryan Pulock,D,NYI,30,76,6,25,31
28,8478500,Ivan Provorov,D,CBJ,27,80,5,26,31
28,8484203,Bradly Nadeau,L,CAR,19,65,18,12,30
28,8482705,Cole Sillinger,C,CBJ,21,65,17,13,30
28,8482089,Jake Neighbours,L,STL,22,66,17,13,30
28,8481580,Connor McMichael,C,WSH,23,59,17,13,30
28,8480220,Noah Cates,L,PHI,25,66,14,16,30
28,8477919,Frederick Gaudreau,C,MIN,31,62,14,16,30
28,8476878,Zemgus Girgensons,C,TBL,30,81,13,17,30
28,8477953,Kasperi Kapanen,R,STL,28,64,11,19,30
28,8476885,Jacob Trouba,D,NYR,30,73,7,23,30
28,8476469,Joel Armia,R,MTL,31,66,16,13,29
28,8476897,Oskar Sundqvist,C,STL,30,63,15,14,29
28,8474189,Lars Eller,C,PIT,35,60,13,16,29
28,8478413,Jordan Greenway,L,BUF,27,61,13,16,29
28,8476927,Teddy Blueger,C,VAN,30,65,12,17,29
28,8480074,Alexandre Texier,C,STL,25,64,12,17,29
28,8475855,Jesper Fast,R,CAR,33,58,11,18,29
28,8482101,Danil Gushchin,L,SJS,22,63,10,19,29
28,8474716,Jared Spurgeon,D,MIN,35,76,10,19,29
28,8477498,Darnell Nurse,D,EDM,29,74,8,21,29
28,8481606,Jordan Spence,D,LAK,23,65,6,23,29
28,8474574,Tyler Myers,D,VAN,34,70,6,23,29
28,8477435,Ryan Graves,D,PIT,29,75,5,24,29
28,8483524,Shane Wright,C,SEA,20,62,17,11,28
28,8478057,Dakota Joshua,C,VAN,28,67,16,12,28
28,8479336,Carl Grundstrom,R,SJS,27,58,16,12,28
28,8477987,Ryan Donato,C,CHI,28,61,13,15,28
28,8480289,Morgan Barron,C,WPG,26,62,13,15,28
28,8473422,Nick Foligno,L,CHI,37,57,11,17,28
28,8483445,Cutter Gauthier,L,ANA,20,66,11,17,28
28,8478233,Andrew Mangiapane,L,WSH,28,68,10,18,28
28,8478463,Anthony Beauvillier,L,PIT,27,67,10,18,28
28,8477948,Travis Sanheim,D,PHI,28,69,9,19,28
28,8476480,Vladislav Namestnikov,C,WPG,32,55,9,19,28
28,8482149,Cole Perfetti,C,WPG,22,66,8,20,28
28,8475218,Mattias Ekholm,D,EDM,34,71,6,22,28
28,8482655,Janis Moser,D,TBL,24,78,5,23,28
28,8476463,Jonas Brodin,D,MIN,31,79,5,23,28
28,8476892,Colton Parayko,D,STL,31,72,5,23,28
28,8478043,Sam Lafferty,C,BUF,29,59,14,13,27
28,8480113,Alex Iafallo,L,WPG,31,68,13,14,27
28,8478109,Victor Olofsson,L,VGK,29,73,12,15,27
28,8477947,Sonny Milano,L,WSH,28,65,12,15,27
28,8479339,Patrik Laine,L,CBJ,26,62,9,18,27
28,8477989,Christian Dvorak,C,MTL,28,69,8,19,27
28,8480855,Jack McBain,C,UTA,24,62,8,19,27
28,8473563,Nicklas Backstrom,C,WSH,37,56,7,20,27
28,8477969,Marcus Pettersson,D,PIT,28,78,5,22,27
28,8475790,Erik Gudbranson,D,CBJ,32,76,5,22,27
28,8480873,Rasmus Sandin,D,WSH,24,61,4,23,27
28,8479324,Ryan Lindgren,D,NYR,26,63,1,26,27
28,8480893,Kirill Marchenko,R,CBJ,24,62,18,8,26
28,8480003,Jesper Boqvist,C,FLA,26,71,17,9,26
28,8479393,Noah Gregor,L,OTT,26,79,15,11,26
28,8481535,Nils Hoglander,L,VAN,24,62,14,12,26
28,8477952,Robby Fabbri,C,ANA,28,58,14,12,26
28,8476925,Colton Sissons,C,NSH,31,60,12,14,26
28,8481546,Cam York,D,PHI,23,70,11,15,26
28,8475722,Jason Zucker,L,BUF,32,68,9,17,26
28,8482809,Jackson Blake,R,CAR,21,61,8,18,26
28,8475200,Dmitry Orlov,D,CAR,33,73,3,23,26
28,8476931,Jake McCabe,D,TOR,31,70,3,23,26
28,8481582,Nicholas Robertson,L,TOR,23,69,19,6,25
28,8479390,Taylor Raddysh,R,WSH,26,68,15,10,25
28,8481032,Paul Cotter,C,NJD,25,55,13,12,25
28,8482125,Alexander Holtz,R,VGK,22,65,12,13,25
28,8480459,Pius Suter,C,VAN,28,68,10,15,25
28,8482475,Yegor Chinakhov,R,CBJ,23,58,10,15,25
28,8483457,Lane Hutson,D,MTL,20,62,9,16,25
28,8482660,Kent Johnson,C,CBJ,22,62,7,18,25
28,8471709,Marc-Edouard Vlasic,D,SJS,37,65,4,21,25
28,8476331,Dylan DeMelo,D,WPG,31,70,3,22,25
28,8480878,Nils Lundkvist,D,DAL,24,73,3,22,25
28,8480049,Dylan Samberg,D,WPG,25,68,2,23,25
28,8475793,Ryan Johansen,C,PHI,32,72,12,12,24
28,8476918,Jimmy Vesey,L,NYR,31,63,12,12,24
28,8483468,Jiri Kulich,C,BUF,20,52,12,12,24
28,8477450,Jason Dickinson,C,CHI,29,63,8,16,24
28,8481523,Kirby Dach,C,MTL,23,61,7,17,24
28,8478970,Jalen Chatfield,D,CAR,28,69,7,17,24
28,8481522,Peyton Krebs,C,BUF,23,62,6,18,24
28,8478911,Matt Roy,D,WSH,29,60,4,20,24
28,8482259,Bobby McMann,C,TOR,28,60,16,7,23
28,8482079,Marco Rossi,C,MIN,23,58,16,7,23
28,8477903,Garnet Hathaway,R,PHI,33,60,15,8,23
28,8473533,Jordan Staal,C,CAR,36,56,14,9,23
28,8479066,Ryan Lomberg,L,CGY,30,65,11,12,23
28,8480806,Isac Lundestrom,C,ANA,25,53,11,12,23
28,8477353,Tyler Motte,C,DET,29,76,11,12,23
28,8482111,Justin Barron,D,MTL,23,66,11,12,23
28,8481517,Brett Leason,R,ANA,25,54,10,13,23
28,8475343,Nic Dowd,C,WSH,34,62,9,14,23
28,8479543,Michael Pezzetta,L,MTL,26,58,9,14,23
28,8478013,Jake Walman,D,SJS,28,70,8,15,23
28,8482245,Artem Zub,D,OTT,29,71,6,17,23
28,8482624,Daniil Miromanov,D,CGY,27,61,5,18,23
28,8480336,Sean Walker,D,CAR,30,74,5,18,23
28,8475324,Nick Jensen,D,OTT,34,68,4,19,23
28,8480043,Timothy Liljegren,D,TOR,25,66,1,22,23
28,8479370,Tyson Jost,C,CAR,26,55,13,9,22
28,8481554,Kaapo Kakko,R,NYR,23,65,12,10,22
28,8479293,Brandon Tanev,L,SEA,33,56,10,12,22
28,8479316,Luke Kunin,C,SJS,27,63,10,12,22
28,8480835,Jack Drury,C,CAR,24,58,9,13,22
28,8479315,Joey Anderson,R,CHI,26,54,7,15,22
28,8477369,Carson Soucy,D,VAN,30,63,7,15,22
28,8473507,Jeff Petry,D,DET,37,69,5,17,22
28,8479371,Dante Fabbro,D,NSH,26,65,5,17,22
28,8481014,Alexander Romanov,D,NYI,24,76,4,18,22
28,8478859,Niko Mikkola,D,FLA,28,65,4,18,22
28,8478178,Darren Raddysh,D,TBL,28,73,1,21,22
28,8478136,Jake Middleton,D,MIN,28,75,0,22,22
28,8480448,Parker Kelly,L,COL,25,77,17,4,21
28,8482074,Connor Zary,C,CGY,23,63,14,7,21
28,8474715,Cameron Atkinson,R,TBL,35,81,14,7,21
28,8478432,Christian Fischer,R,DET,27,77,13,8,21
28,8478020,Michael Amadio,R,OTT,28,71,13,8,21
28,8476921,Jordan Martinook,L,CAR,32,64,12,9,21
28,8479353,Brett Howden,C,VGK,26,61,11,10,21
28,8478508,Yakov Trenin,C,MIN,27,59,11,10,21
28,8481601,Simon Holmstrom,R,NYI,23,64,10,11,21
28,8477406,Mattias Janmark,C,EDM,32,62,9,12,21
28,8477508,Curtis Lazar,C,NJD,29,55,8,13,21
28,8481013,Jonatan Berggren,R,DET,24,57,8,13,21
28,8481656,Aliaksei Protas,C,WSH,23,66,7,14,21
28,8479414,Nathan Bastian,R,NJD,27,61,7,14,21
28,8481553,Bobby Brink,R,PHI,23,62,7,14,21
28,8482067,Connor Mackey,D,NYR,28,63,6,15,21
28,8482142,Jamie Drysdale,D,PHI,22,63,5,16,21
28,8476902,Esa Lindell,D,DAL,30,73,5,16,21
28,8477220,Nate Schmidt,D,FLA,33,74,5,16,21
28,8482634,Alex Steeves,C,TOR,25,53,5,16,21
28,8476312,Josh Manson,D,COL,33,63,3,18,21
28,8478851,Alexandre Carrier,D,NSH,28,62,2,19,21
28,8477488,Brett Pesce,D,NJD,30,65,2,19,21
28,8479980,Nicolas Hague,D,VGK,26,54,2,19,21
28,8476278,Colin Blackwell,C,DAL,31,75,12,8,20
28,8480748,Kiefer Sherwood,L,VAN,29,64,10,10,20
28,8481704,Juuso Parssinen,C,NSH,23,66,9,11,20
28,8480068,Ryan Poehling,C,PHI,25,69,7,13,20
28,8476457,Adam Larsson,D,SEA,32,68,6,14,20
28,8480891,Michael Kesselring,D,UTA,24,61,5,15,20
28,8482087,Kaiden Guhle,D,MTL,22,65,4,16,20
28,8481441,Joe Snively,C,DET,28,59,4,16,20
28,8479398,Samuel Girard,D,COL,26,69,3,17,20
28,8482679,Matt Coronato,R,CGY,22,67,13,6,19
28,8482749,Joshua Roy,R,MTL,21,65,11,8,19
28,8481477,Nico Sturm,C,SJS,29,59,11,8,19
28,8477446,Michael McCarron,R,NSH,29,59,9,10,19
28,8477392,Hudson Fasching,R,NYI,29,68,8,11,19
28,8477931,Tomas Nosek,L,FLA,32,61,8,11,19
28,8476873,Mark Jankowski,C,NSH,30,50,8,11,19
28,8476422,Mike Reilly,D,NYI,31,75,7,12,19
28,8480789,Oliver Wahlstrom,R,NYI,24,68,7,12,19
28,8480144,David Kampf,C,TOR,29,66,5,14,19
28,8476329,Travis Boyd,C,MIN,31,54,5,14,19
28,8476889,Radek Faksa,C,STL,30,60,5,14,19
28,8476988,Matt Benning,D,SJS,30,62,5,14,19
28,8481059,Scott Perunovich,D,STL,26,60,5,14,19
28,8478507,John Marino,D,UTA,27,66,0,19,19
28,8480995,Pontus Holmberg,R,TOR,25,61,11,7,18
28,8480021,Jack Studnicka,C,LAK,25,62,9,9,18
28,8479941,Justin Danforth,R,CBJ,31,57,8,10,18
28,8479368,Max Jones,L,BOS,26,63,8,10,18
28,8477478,William Carrier,L,CAR,30,53,8,10,18
28,8475220,Marcus Foligno,L,MIN,33,63,7,11,18
28,8477365,Connor Clifton,D,BUF,29,52,6,12,18
28,8475231,Casey Cizikas,C,NYI,33,72,5,13,18
28,8481751,Lukas Rousek,R,BUF,25,36,5,13,18
28,8476879,Cody Ceci,D,EDM,31,68,3,15,18
28,8481178,Egor Zamula,D,PHI,24,51,3,15,18
28,8480252,Cole Guttman,C,CHI,25,36,10,7,17
28,8478585,Derek Ryan,C,EDM,38,68,10,7,17
28,8477018,Ben Hutton,D,VGK,31,48,8,9,17
28,8478451,Ethan Bear,D,WSH,27,59,8,9,17
28,8476374,Sean Kuraly,C,CBJ,31,57,7,10,17
28,8482166,Shakir Mukhamadullin,D,SJS,22,54,7,10,17
28,8481641,Joel Kiviranta,L,COL,28,71,6,11,17
28,8482157,Will Cuylle,L,NYR,22,67,5,12,17
28,8483482,Tristan Luneau,D,ANA,20,62,5,12,17
28,8478434,Keegan Kolesar,R,VGK,27,65,5,12,17
28,8470600,Ryan Suter,D,STL,39,64,5,12,17
28,8480001,Urho Vaakanainen,D,ANA,25,62,4,13,17
28,8481521,Ronnie Attard,D,PHI,25,54,4,13,17
28,8479976,Juuso Valimaki,D,UTA,26,63,3,14,17
28,8474013,Ian Cole,D,UTA,35,52,3,14,17
28,8481567,Henry Thrun,D,SJS,23,52,3,14,17
28,8475179,Dmitry Kulikov,D,FLA,34,53,2,15,17
28,8475462,Radko Gudas,D,ANA,34,66,1,16,17
28,8474673,TJ Brodie,D,CHI,34,62,0,17,17
28,8480281,Alexey Toropchenko,R,STL,25,58,11,5,16
28,8480025,MacKenzie Entwistle,R,FLA,25,60,9,7,16
28,8484149,Gavin Brindley,C,CBJ,20,53,9,7,16
28,8482803,Olen Zellweger,D,ANA,21,65,8,8,16
28,8481716,Dmitri Voronkov,L,CBJ,24,45,8,8,16
28,8479359,Beck Malenstyn,L,BUF,26,44,8,8,16
28,8473453,Trevor Lewis,C,LAK,37,74,7,9,16
28,8482176,Wyatt Kaiser,D,CHI,22,46,7,9,16
28,8477507,Nikita Zadorov,D,BOS,29,74,4,12,16
28,8477015,Connor Brown,R,EDM,30,65,4,12,16
28,8478399,Jonas Siegenthaler,D,NJD,27,63,4,12,16
28,8477979,Nicolas Aube-Kubel,R,BUF,28,58,4,12,16
28,8479983,Mario Ferraro,D,SJS,26,65,3,13,16
28,8477499,Rasmus Ristolainen,D,PHI,30,65,3,13,16
28,8479998,Mikey Anderson,D,LAK,25,56,3,13,16
28,8475181,Nick Leddy,D,STL,33,67,2,14,16
28,8475279,Ben Chiarot,D,DET,33,68,2,14,16
28,8480058,Pierre-Olivier Joseph,D,STL,25,55,2,14,16
28,8476525,Colin Miller,D,WPG,32,61,1,15,16
28,8479249,Andrew Poturalski,C,SJS,30,38,1,15,16
28,8476822,Luke Glendening,C,TBL,35,77,10,5,15
28,8480011,Klim Kostin,C,SJS,25,47,8,7,15
28,8483499,Liam Ohgren,L,MIN,20,52,7,8,15
28,8481093,Rafael Harvey-Pinard,L,MTL,25,56,6,9,15
28,8478569,Noel Acciari,C,PIT,33,56,6,9,15
28,8479671,Mathieu Olivier,R,CBJ,27,53,5,10,15
28,8481028,Martin Pospisil,C,CGY,25,51,4,11,15
28,8475225,Craig Smith,C,CHI,35,57,4,11,15
28,8480172,Jan Rutta,D,SJS,34,56,4,11,15
28,8482730,Brandt Clarke,D,LAK,21,58,4,11,15
28,8478416,Erik Cernak,D,TBL,27,72,3,12,15
28,8476856,Mathew Dumba,D,DAL,30,69,3,12,15
28,8480035,Henri Jokiharju,D,BUF,25,68,2,13,15
28,8476967,Brett Kulak,D,EDM,30,62,2,13,15
28,8480950,Ilya Lyubushkin,D,DAL,30,61,2,13,15
28,8479026,Philippe Myers,D,TOR,27,52,1,14,15
28,8475455,Brenden Dillon,D,NJD,34,57,1,14,15
28,8477845,Trevor van Riemsdyk,D,WSH,33,60,1,14,15
28,8478840,Will Borgen,D,SEA,28,63,0,15,15
28,8479520,Brandon Duhaime,R,WSH,27,51,8,6,14
28,8482737,Zack Bolduc,C,STL,21,55,7,7,14
28,8482148,Hendrix Lapierre,C,WSH,22,60,7,7,14
28,8480980,Connor Dewar,C,TOR,25,71,6,8,14
28,8483565,Nick Blankenburg,D,NSH,26,57,6,8,14
28,8482744,James Malatesta,L,CBJ,21,43,6,8,14
28,8482077,Dylan Holloway,L,EDM,23,47,5,9,14
28,8483466,Kevin Korchinski,D,CHI,20,56,4,10,14
28,8482652,Walker Duehr,R,CGY,27,42,4,10,14
28,8479986,Kole Lind,R,DAL,26,54,4,10,14
28,8476467,Jamie Oleksiak,D,SEA,32,69,3,11,14
28,8480796,Martin Fehervary,D,WSH,25,54,3,11,14
28,8480196,Jacob Bryson,D,BUF,27,41,3,11,14
28,8474567,Zach Bogosian,D,MIN,34,58,2,12,14
28,8475233,David Savard,D,MTL,34,66,2,12,14
28,8480860,Kevin Bahl,D,CGY,24,57,1,13,14
28,8475690,Chris Tanev,D,TOR,35,57,1,13,14
28,8478452,Caleb Jones,D,LAK,27,52,0,14,14
28,8479994,Jaret Anderson-Dolan,C,WPG,25,37,8,5,13
28,8477380,Jonny Brodzinski,C,NYR,31,54,7,6,13
28,8479718,Alex Barré-Boulet,C,MTL,27,45,7,6,13
28,8478831,Kevin Stenlund,C,UTA,28,55,7,6,13
28,8482117,Lukas Reichel,L,CHI,22,48,6,7,13
28,8481161,Jake Christiansen,D,CBJ,25,59,6,7,13
28,8481527,Kaedan Korczak,D,VGK,23,40,5,8,13
28,8476891,Matthew Grzelcyk,D,PIT,30,72,4,9,13
28,8482451,Mikael Pyyhtia,L,CBJ,23,41,4,9,13
28,8476960,Andreas Athanasiou,C,CHI,30,52,4,9,13
28,8481599,Victor Soderstrom,D,UTA,23,42,4,9,13
28,8483493,Frank Nazar,C,CHI,20,49,3,10,13
28,8481019,David Gustafsson,C,WPG,24,53,3,10,13
28,8478443,Brandon Carlo,D,BOS,28,63,3,10,13
28,8482073,Braden Schneider,D,NYR,23,62,2,11,13
28,8480355,Mark Kastelic,C,BOS,25,56,9,3,12
28,8481532,Alex Turcotte,C,LAK,23,40,8,4,12
28,8478424,Jansen Harkins,C,ANA,27,43,8,4,12
28,8482062,Cole Smith,L,NSH,29,54,7,5,12
28,8477573,Nathan Walker,L,STL,30,52,7,5,12
28,8479996,Cody Glass,C,NSH,25,59,6,6,12
28,8480205,Emil Bemstrom,C,PIT,25,53,6,6,12
28,8476429,Scott Mayfield,D,NYI,32,75,4,8,12
28,8474034,Patrick Maroon,L,CHI,36,48,4,8,12
28,8479344,Jesse Puljujarvi,R,PIT,26,52,4,8,12
28,8474090,Brendan Smith,D,DAL,35,55,4,8,12
28,8481550,Adam Beckman,L,NJD,23,33,3,9,12
28,8478468,Jeremy Lauzon,D,NSH,27,54,3,9,12
28,8479378,Logan Stanley,D,WPG,26,43,3,9,12
28,8475188,Brayden McNabb,D,VGK,33,57,3,9,12
28,8476994,Vinnie Hinostroza,C,NSH,30,45,2,10,12
28,8482153,Brendan Brisson,C,VGK,23,37,2,10,12
28,8480222,Sebastian Aho,D,PIT,28,72,1,11,12
28,8480887,Jordan Harris,D,MTL,24,58,1,11,12
28,8480848,Ty Dellandrea,C,SJS,24,44,6,5,11
28,8480727,Zach Whitecloud,D,VGK,28,54,6,5,11
28,8481789,Tye Kartye,L,SEA,23,35,6,5,11
28,8481537,Nikita Okhotiuk,D,CGY,24,47,4,7,11
28,8476934,Brock McGinn,L,ANA,30,54,4,7,11
28,8480192,Johnathan Kovacevic,D,NJD,27,52,3,8,11
28,8480157,Calle Rosen,D,COL,30,44,3,8,11
28,8483495,Simon Nemec,D,NJD,20,52,3,8,11
28,8475842,Sam Carrick,C,NYR,32,63,3,8,11
28,8475208,Brian Dumoulin,D,ANA,33,64,3,8,11
28,8481617,Vasily Podkolzin,R,VAN,23,48,3,8,11
28,8481708,Zac Jones,D,NYR,24,51,2,9,11
28,8479328,Julien Gauthier,R,NYI,27,56,2,9,11
28,8480441,Trey Fix-Wolansky,R,CBJ,25,47,2,9,11
28,8480807,Mattias Samuelsson,D,BUF,24,49,2,9,11
28,8476372,Nick Seeler,D,PHI,31,48,2,9,11
28,8479369,Andrew Peeke,D,BOS,26,60,1,10,11
28,8479348,Kale Clague,D,BUF,26,43,1,10,11
28,8480070,Ian Mitchell,D,BOS,25,54,6,4,10
28,8482762,Simon Edvinsson,D,DET,21,57,6,4,10
28,8479968,Vinni Lettieri,C,BOS,29,46,6,4,10
28,8483491,Ivan Miroshnichenko,L,WSH,20,56,5,5,10
28,8482155,Alex Laferriere,R,LAK,23,62,5,5,10
28,8482659,Josh Doan,R,UTA,22,53,5,5,10
28,8480845,Rasmus Kupari,C,WPG,24,44,4,6,10
28,8483460,David Jiricek,D,CBJ,21,54,4,6,10
28,8477938,Haydn Fleury,D,WPG,28,40,4,6,10
28,8479372,Joshua Mahura,D,SEA,26,50,3,7,10
28,8482192,Isaak Phillips,D,CHI,23,55,2,8,10
28,8481167,Brayden Pachal,D,CGY,25,47,1,9,10
28,8482859,Zack Ostapchuk,C,OTT,21,58,1,9,10
28,8479619,Michael Carcone,L,UTA,28,57,6,3,9
28,8479772,Zack MacEwen,R,OTT,28,47,6,3,9
28,8482807,Ethan Del Mastro,D,CHI,21,54,5,4,9
28,8475235,Nicolas Deslauriers,L,PHI,33,53,5,4,9
28,8476624,Barclay Goodrow,C,SJS,31,49,4,5,9
28,8482964,Arber Xhekaj,D,MTL,23,51,4,5,9
28,8476952,Dominic Toninato,C,WPG,30,25,3,6,9
28,8474166,Alec Martinez,D,CHI,37,54,3,6,9
28,8482747,Brennan Othmann,L,NYR,21,41,3,6,9
28,8478409,Anthony Richard,C,PHI,28,31,3,6,9
28,8478421,A.J. Greer,L,FLA,28,59,2,7,9
28,8482861,Vincent Iorio,D,WSH,22,36,2,7,9
28,8480007,Jonas Rondbjerg,R,VGK,25,42,2,7,9
28,8475750,Jon Merrill,D,MIN,32,57,1,8,9
28,8475177,Calvin de Haan,D,COL,33,49,0,9,9
28,8479291,Kevin Rooney,C,CGY,31,49,5,3,8
28,8481679,Maxence Guenette,D,OTT,23,35,5,3,8
28,8481518,Nolan Foote,L,NJD,24,41,5,3,8
28,8479985,Cale Fleury,D,SEA,26,30,4,4,8
28,8480292,Carson Meyer,R,ANA,27,32,4,4,8
28,8481754,Nikita Nesterenko,C,ANA,23,42,4,4,8
28,8480890,Jan Jenik,C,OTT,24,24,4,4,8
28,8478211,Dryden Hunt,L,CGY,29,52,3,5,8
28,8483012,Logan Morrison,C,SEA,22,40,3,5,8
28,8482765,Isak Rosen,R,BUF,21,33,3,5,8
28,8484911,Collin Graf,R,SJS,22,36,3,5,8
28,8477384,Joshua Brown,D,EDM,30,42,3,5,8
28,8481147,Reese Johnson,C,MIN,26,37,3,5,8
28,8473446,Erik Johnson,D,PHI,36,51,3,5,8
28,8479439,Jacob MacDonald,D,COL,31,42,2,6,8
28,8477034,Jaycob Megna,D,FLA,32,52,2,6,8
28,8475718,Justin Holl,D,DET,32,64,2,6,8
28,8477401,John Hayden,C,SEA,29,32,2,6,8
28,8471677,Jack Johnson,D,CBJ,37,63,1,7,8
28,8474612,Travis Hamonic,D,OTT,34,43,1,7,8
28,8476867,Brendan Gaunce,C,MIN,30,36,1,7,8
28,8480879,Jacob Bernard-Docker,D,OTT,24,44,0,8,8
28,8479638,Justin Brazeau,R,BOS,26,44,5,2,7
28,8481556,John Beecher,C,BOS,23,39,5,2,7
28,8482070,Mitchell Chaffee,R,TBL,26,52,5,2,7
28,8477482,Zachary Sanford,L,CHI,30,34,4,3,7
28,8476442,Matt Nieto,L,PIT,32,43,4,3,7
28,8480246,Nick Perbix,D,TBL,26,69,3,4,7
28,8481592,Jakob Pelletier,L,CGY,23,44,3,4,7
28,8481600,Tobias Bjornfot,D,FLA,23,34,3,4,7
28,8479944,Zach Aston-Reese,C,VGK,30,42,3,4,7
28,8481598,Philip Broberg,D,EDM,23,53,3,4,7
28,8480990,Declan Chisholm,D,MIN,24,36,3,4,7
28,8483630,Pavol Regenda,L,ANA,25,32,2,5,7
28,8480245,Olle Lycksell,R,PHI,25,25,2,5,7
28,8471817,Ryan Reaves,R,TOR,37,51,2,5,7
28,8477851,Jordan Oesterle,D,BOS,32,40,2,5,7
28,8481568,Alex Vlasic,D,CHI,23,54,1,6,7
28,8474568,Luke Schenn,D,NSH,35,50,1,6,7
28,8475762,Derek Forbort,D,VAN,32,46,1,6,7
28,8483549,Lucas Condotta,L,MTL,27,45,1,6,7
28,8484254,Akito Hirose,D,VAN,25,48,1,6,7
28,8478021,William Lagesson,D,DET,28,28,1,6,7
28,8482095,Tyler Kleven,D,OTT,22,45,0,7,7
28,8479442,Troy Stecher,D,EDM,30,46,0,7,7
28,8476858,Phillip Di Giuseppe,L,VAN,31,42,5,1,6
28,8481543,Nikita Alexandrov,C,STL,24,28,5,1,6
28,8477070,Liam O'Brien,C,UTA,30,55,4,2,6
28,8479536,Axel Jonsson-Fjallby,L,WPG,26,37,4,2,6
28,8481609,Vladislav Kolyachonok,D,UTA,23,38,4,2,6
28,8478146,Matthew Highmore,C,OTT,28,33,3,3,6
28,8482784,Zach Dean,C,STL,21,40,3,3,6
28,8478874,Adam Gaudette,R,OTT,28,36,3,3,6
28,8482141,Lukas Cormier,D,VGK,22,23,3,3,6
28,8480880,Jakub Lauko,C,MIN,24,33,2,4,6
28,8476913,Devin Shore,C,MIN,30,40,2,4,6
28,8482470,Ilya Solovyov,D,CGY,24,19,2,4,6
28,8481056,Spencer Stastney,D,NSH,24,36,2,4,6
28,8482144,Jack Thompson,D,SJS,22,28,2,4,6
28,8482102,Vasily Ponomarev,C,PIT,22,26,2,4,6
28,8478017,Mark Friedman,D,VAN,29,43,1,5,6
28,8477335,Kyle Burroughs,D,LAK,29,43,1,5,6
28,8476874,Olli Maatta,D,DET,30,56,0,6,6
28,8480844,Grigori Denisenko,L,VGK,24,29,0,6,6
28,8481701,Santeri Hatakka,D,NJD,23,40,0,6,6
28,8477527,Ross Johnston,L,ANA,30,34,0,6,6
28,8482511,Mason Lohrei,D,BOS,23,27,4,1,5
28,8481605,Jackson LaCombe,D,ANA,23,29,3,2,5
28,8482172,Landon Slaggert,L,CHI,22,29,3,2,5
28,8476441,Joel Edmundson,D,LAK,31,39,2,3,5
28,8477462,Robert Hagg,D,VGK,29,31,2,3,5
28,8476473,Connor Murphy,D,CHI,31,37,1,4,5
28,8477887,Patrick Brown,C,BOS,32,42,1,4,5
28,8477244,Chad Ruhwedel,D,NYR,34,30,1,4,5
28,8479367,William Lockwood,R,FLA,26,21,1,4,5
28,8479981,Jonah Gadjovich,L,FLA,26,47,1,4,5
28,8478051,Max Willman,C,NJD,29,29,1,4,5
28,8480834,Ty Emberson,D,SJS,24,40,0,5,5
28,8484258,Sam Malinski,D,COL,26,27,0,5,5
28,8479972,Mason Shaw,C,WPG,26,33,2,2,4
28,8482666,Scott Morrow,D,CAR,22,47,2,2,4
28,8477467,Gustav Olofsson,D,SEA,30,21,2,2,4
28,8478450,Parker Wotherspoon,D,BOS,27,27,2,2,4
28,8477473,Justin Bailey,R,SJS,29,25,2,2,4
28,8481237,Kyle MacLean,C,NYI,25,28,2,2,4
28,8482733,Logan Mailloux,D,MTL,31,39,2,2,4
28,8481541,Samuel Bolduc,D,NYI,24,28,2,2,4
28,8483619,Filip Roos,D,OTT,25,32,1,3,4
28,8478454,Noah Juulsen,D,VAN,27,28,1,3,4
28,8482201,Gage Goncalves,C,TBL,23,30,1,3,4
28,8479587,Rhett Gardner,C,PHI,28,22,1,3,4
28,8482162,Roby Jarventie,L,EDM,22,17,1,3,4
28,8478502,Dennis Gilbert,D,BUF,28,19,0,4,4
28,8477320,Anton Blidh,L,NYR,29,19,0,4,4
28,8480032,Shane Bowers,C,NJD,25,11,3,0,3
28,8479991,Jake Leschyshyn,C,NYR,25,33,2,1,3
28,8482118,Sam Colangelo,R,ANA,23,17,2,1,3
28,8482147,Jean-Luc Foudy,C,COL,22,24,2,1,3
28,8481065,Angus Crookshank,L,OTT,25,11,2,1,3
28,8480084,Nick DeSimone,D,NJD,30,19,2,1,3
28,8475413,Justin Dowling,C,NJD,34,17,2,1,3
28,8483512,Matthew Savoie,C,EDM,20,21,2,1,3
28,8482496,Nils Aman,C,VAN,24,29,1,2,3
28,8481122,Simon Benoit,D,TOR,26,40,1,2,3
28,8481743,Marc Del Gaizo,D,NSH,25,21,1,2,3
28,8482165,Yan Kuznetsov,D,CGY,22,20,1,2,3
28,8477073,Kurtis MacDermid,L,NJD,30,36,1,2,3
28,8478477,Mitchell Stephens,C,SEA,27,18,1,2,3
28,8480851,Akil Thomas,C,LAK,24,22,1,2,3
28,8479576,Vincent Desharnais,D,VAN,28,30,1,2,3
28,8482713,Mackie Samoskevich,R,FLA,22,30,1,2,3
28,8482145,Mavrik Bourque,C,DAL,22,48,1,2,3
28,8479320,Maxime Lajoie,D,SEA,27,21,1,2,3
28,8479419,Brett Murray,L,BUF,26,22,1,2,3
28,8481206,John Ludvig,D,PIT,24,10,1,2,3
28,8481462,Mason Morelli,L,VGK,28,13,1,2,3
28,8481806,Louis Crevier,D,CHI,23,7,1,2,3
28,8477962,Brendan Lemieux,L,CAR,28,38,0,3,3
28,8482751,Ryan Winterton,C,SEA,21,36,0,3,3
28,8482177,Marat Khusnutdinov,C,MIN,22,38,0,3,3
28,8483763,Maksymilian Szuber,D,UTA,22,32,0,3,3
28,8480468,James Hamblin,L,EDM,25,20,0,3,3
28,8482250,Callahan Burke,C,VGK,27,23,0,3,3
28,8483397,Marc McLaughlin,C,BOS,25,32,2,0,2
28,8482858,Ryker Evans,D,SEA,23,20,2,0,2
28,8481719,Maxwell Crozier,D,TBL,24,19,2,0,2
28,8481422,Jake Lucchini,C,NSH,29,16,2,0,2
28,8475755,Alexander Petrovic,D,DAL,32,12,2,0,2
28,8479330,Brandon Gignac,C,MTL,27,11,2,0,2
28,8478854,Ryan Shea,D,PIT,27,12,2,0,2
28,8483570,Ben Meyers,C,SEA,26,32,1,1,2
28,8484287,Cole McWard,D,VAN,23,13,1,1,2
28,8482929,Emil Lilleberg,D,TBL,23,16,1,1,2
28,8481655,Cole Schwindt,R,CGY,23,7,1,1,2
28,8475958,Michael Sgarbossa,C,WSH,32,18,0,2,2
28,8477541,Dakota Mermis,D,TOR,30,9,0,2,2
28,8483398,Declan Carlile,D,TBL,31,7,0,2,2
28,8477810,Joel Hanley,D,CGY,33,26,0,2,2
28,8478446,Glenn Gawdin,C,LAK,27,11,0,2,2
28,8482197,Adam Raska,R,MIN,23,10,0,2,2
28,8477971,Andreas Englund,D,LAK,28,26,1,0,1
28,8478881,Brett Seney,L,CHI,28,15,1,0,1
28,8481585,Egor Afanasyev,L,SJS,23,17,1,0,1
28,8483395,Arshdeep Bains,L,VAN,23,10,1,0,1
28,8483407,Brandon Scanlin,D,NYR,25,4,1,0,1
28,8481578,Graeme Clarke,R,MIN,23,9,1,0,1
28,8479362,Riley Tufte,L,BOS,26,21,1,0,1
28,8477993,Justin Kirkland,C,CGY,28,9,1,0,1
28,8475780,Chris Wagner,R,COL,33,10,1,0,1
28,8482088,Justin Sourdif,R,FLA,22,16,1,0,1
28,8482787,Nikita Chibrikov,R,WPG,31,8,1,0,1
28,8480870,Bo Groulx,C,NYR,24,27,0,1,1
28,8479379,Givani Smith,R,SJS,26,27,0,1,1
28,8475795,Dylan McIlrath,D,WSH,32,11,0,1,1
28,8482516,Matthew Kessel,D,STL,24,18,0,1,1
28,8474062,Riley Nash,C,NYR,35,14,0,1,1
28,8477149,Scott Sabourin,R,SJS,32,15,0,1,1
28,8481564,Ryan Johnson,D,BUF,23,15,0,1,1
28,8483597,Milos Kelemen,L,UTA,25,11,0,1,1
28,8481006,Tyler Tucker,D,STL,24,13,0,1,1
28,8484304,Uvis Balinskis,D,FLA,28,7,0,1,1
28,8480823,Alexander Alexeyev,D,WSH,25,15,0,1,1
28,8482476,Emil Heineman,L,MTL,23,10,0,1,1
28,8476323,Max McCormick,L,SEA,32,5,0,1,1
28,8481024,Linus Karlsson,C,VAN,25,10,0,1,1
28,8483920,Pierrick Dube,R,WSH,23,5,0,1,1
28,8483401,Marc Johnstone,R,PIT,28,5,0,1,1
28,8481726,Adam Edstrom,C,NYR,24,8,0,1,1
28,8481699,Aku Raty,R,UTA,23,14,0,0,0
28,8482094,Daemon Hunt,D,MIN,22,22,0,0,0
28,8484325,Waltteri Merela,C,TBL,26,16,0,0,0
28,8478011,Louie Belpedio,D,PHI,28,9,0,0,0
28,8482061,Brandon Biro,L,SEA,26,11,0,0,0
28,8483609,Adam Klapka,R,CGY,24,1,0,0,0
28,8480267,Sammy Walker,C,MIN,25,15,0,0,0
28,8481593,Jayden Struble,D,MTL,23,14,0,0,0
28,8480874,Adam Ginning,D,PHI,24,7,0,0,0
28,8481030,Jack St. Ivany,D,PIT,25,19,0,0,0
28,8483489,Fraser Minten,C,TOR,31,9,0,0,0
28,8481043,Cole Koepke,L,BOS,26,18,0,0,0
28,8483567,Georgii Merkulov,C,BOS,24,6,0,0,0
28,8480306,Grant Hutton,D,NYI,29,7,0,0,0
28,8484255,Jason Polin,R,COL,25,3,0,0,0
28,8478956,Samuel Laberge,L,NJD,27,2,0,0,0
28,8482460,Matt Rempe,C,NYR,22,11,0,0,0
28,8483471,Brad Lambert,C,WPG,31,10,0,0,0
28,8483531,Brian Halonen,L,NJD,25,2,0,0,0
28,8480075,Cameron Crotty,D,MIN,25,10,0,0,0
28,8479421,Jacob Moverare,D,LAK,26,8,0,0,0
28,8480274,Philip Kemp,D,EDM,25,1,0,0,0
28,8483546,Marshall Rifai,D,TOR,26,3,0,0,0
28,8478147,Bokondji Imama,L,PIT,28,6,0,0,0
28,8481534,Raphael Lavoie,C,EDM,24,3,0,0,0
28,8479522,Hardy Haman Aktell,D,WSH,26,3,0,0,0
28,8484259,Ondrej Pavel,C,COL,31,2,0,0,0
28,8484326,Patrik Koch,D,UTA,28,2,0,0,0
28,8482126,Emil Andrae,D,PHI,31,5,0,0,0
28,8483432,Luca Del Bel Belluz,C,CBJ,31,1,0,0,0
28,8484321,Nikolas Matinpalo,D,OTT,26,2,0,0,0
28,8470794,Joe Pavelski,C,,40,0,0,0,0
28,8479321,Lucas Johansen,D,,27,0,0,0,0
28,8477950,Tony DeAngelo,D,,29,0,0,0,0
28,8471218,Blake Wheeler,R,,38,0,0,0,0
28,8475197,Tyson Barrie,D,,33,0,0,0,0
28,8474157,Max Pacioretty,L,,36,0,0,0,0
28,8475744,Evgeny Kuznetsov,C,,32,0,0,0,0
28,8474037,James van Riemsdyk,L,,35,0,0,0,0
28,8476907,Mackenzie MacEachern,L,,30,0,0,0,0
28,8480216,Jacob Peterson,C,,25,0,0,0,0
28,8474602,Justin Schultz,D,,34,0,0,0,0
28,8482222,Alexander Barabanov,L,,30,0,0,0,0
28,8474031,Kevin Shattenkirk,D,,35,0,0,0,0
28,8477330,Dominik Kubalik,L,,29,0,0,0,0
28,8480884,Calen Addison,D,,24,0,0,0,0
28,8475906,John Klingberg,D,,32,0,0,0,0
28,8480008,Adam Ruzicka,C,,25,0,0,0,0
28,8476884,Derrick Pouliot,D,,30,0,0,0,0
28,8476919,Chris Tierney,C,,30,0,0,0,0
28,8479415,Michael McLeod,C,,26,0,0,0,0
28,8474870,Tyler Johnson,C,,34,0,0,0,0
28,8470604,Jeff Carter,C,,39,0,0,0,0
28,8478104,Sammy Blais,L,,28,0,0,0,0
28,8474884,Mike Hoffman,C,,35,0,0,0,0
28,8481591,Sam Poulin,R,,23,0,0,0,0
28,8471274,Alex Goligoski,D,,39,0,0,0,0
28,8476871,Tanner Pearson,L,,32,0,0,0,0
28,8476393,Nick Cousins,C,,31,0,0,0,0
28,8479977,Kailer Yamamoto,R,,26,0,0,0,0
28,8479346,Dillon Dube,C,,26,0,0,0,0
28,8480184,Gustav Lindstrom,D,,26,0,0,0,0
28,8479376,Victor Mete,D,,26,0,0,0,0
28,8473449,Kyle Okposo,R,,36,0,0,0,0
28,8481058,Jesse Ylonen,R,,25,0,0,0,0
28,8475752,Tyler Pitlick,C,,33,0,0,0,0
28,8481239,Samuel Fagemo,L,,24,0,0,0,0
28,8480821,Filip Zadina,R,,25,0,0,0,0
28,8470966,Mark Giordano,D,,41,0,0,0,0
28,8478495,Denis Gurianov,R,,27,0,0,0,0
28,8477464,Nic Petan,C,,29,0,0,0,0
28,8478099,Kevin Labanc,R,,29,0,0,0,0
28,8482241,Radim Zohorna,L,,28,0,0,0,0
28,8474040,Sam Gagner,C,,35,0,0,0,0
28,8479514,Rem Pitlick,C,,27,0,0,0,0
28,8478430,Oliver Kylington,D,,27,0,0,0,0
28,8479533,Joona Koppanen,L,,26,0,0,0,0
28,8479984,Cal Foote,D,,26,0,0,0,0
28,8477126,Jayson Megna,C,,34,0,0,0,0
28,8475164,Jakob Silfverberg,R,,34,0,0,0,0
28,8474009,Nick Bonino,C,,36,0,0,0,0
28,8479458,Nikita Zaitsev,D,,33,0,0,0,0
28,8477944,Jakub Vrana,L,,28,0,0,0,0
28,8471699,Andrew Cogliano,C,,37,0,0,0,0
28,8478067,Oskar Lindblom,L,,28,0,0,0,0
28,8471686,Marc Staal,D,,37,0,0,0,0
28,8470610,Zach Parise,L,,40,0,0,0,0
28,8478904,Steven Lorentz,C,,28,0,0,0,0
28,8473473,Milan Lucic,L,,36,0,0,0,0
28,8480031,Maxime Comtois,L,,25,0,0,0,0
28,8478512,Austin Czarnik,C,,32,0,0,0,0
28,8473504,Cal Clutterbuck,R,,37,0,0,0,0
28,8477454,Adam Erne,L,,29,0,0,0,0
28,8479383,Boris Katchouk,L,,26,0,0,0,0
28,8475825,Jani Hakanpää,D,,32,0,0,0,0
28,8477846,Ryan Carpenter,C,,33,0,0,0,0
28,8477930,Pierre-Edouard Bellemare,L,,39,0,0,0,0
28,8478400,Colin White,C,,27,0,0,0,0
28,8480226,Marián Studenic,R,,26,0,0,0,0
28,8480853,Liam Foudy,C,,24,0,0,0,0
28,8475797,Jarred Tinordi,D,,32,0,0,0,0
28,8479423,Alex Nylander,L,,26,0,0,0,0
28,8474618,Marco Scandella,D,,34,0,0,0,0
28,8478028,Fredrik Olofsson,L,,28,0,0,0,0
28,8474709,Matt Martin,L,,35,0,0,0,0
28,8481070,Hugh McGing,L,,26,0,0,0,0
28,8479546,Oskar Steen,C,,26,0,0,0,0
28,8474145,Robert Bortuzzo,D,,35,0,0,0,0
28,8476915,Jujhar Khaira,L,,30,0,0,0,0
28,8475278,Byron Froese,C,,33,0,0,0,0
28,8481812,Nikolai Knyzhov,D,,27,0,0,0,0
28,8478408,Travis Dermott,D,,28,0,0,0,0
28,8481077,John Leonard,L,,26,0,0,0,0
28,8479547,Matthew Phillips,R,,26,0,0,0,0
28,8480836,Jonathan Gruden,C,,24,0,0,0,0
28,8481690,Tyler Angle,C,,24,0,0,0,0
28,8475766,Austin Watson,L,,32,0,0,0,0
28,8481016,Ruslan Iskhakov,C,,24,0,0,0,0
28,8478078,Rourke Chartier,C,,28,0,0,0,0
28,8480776,Sheldon Rempal,R,,29,0,0,0,0
28,8483045,Cameron Butler,R,CBJ,31,1,0,0,0
28,8484314,Jiri Smejkal,L,,28,0,0,0,0
29,8478402,Connor McDavid,C,EDM,27,80,50,95,145
29,8477492,Nathan MacKinnon,C,COL,29,81,47,80,127
29,8481559,Jack Hughes,C,NJD,23,73,50,75,125
29,8476453,Nikita Kucherov,R,TBL,31,82,24,98,122
29,8477404,Jake Guentzel,C,TBL,30,82,50,68,118
29,8478420,Mikko Rantanen,R,COL,28,82,50,63,113
29,8478483,Mitch Marner,R,TOR,27,78,34,79,113
29,8477934,Leon Draisaitl,C,EDM,29,77,41,67,108
29,8476468,J.T. Miller,C,VAN,31,75,37,69,106
29,8478864,Kirill Kaprizov,L,MIN,27,73,51,54,105
29,8479314,Matthew Tkachuk,L,FLA,27,78,31,73,104
29,8479318,Auston Matthews,C,TOR,27,78,53,49,102
29,8480012,Elias Pettersson,C,VAN,26,75,46,55,101
29,8477946,Dylan Larkin,C,DET,28,81,35,66,101
29,8478550,Artemi Panarin,L,NYR,33,78,28,69,97
29,8480069,Cale Makar,D,COL,26,75,25,70,95
29,8481557,Matt Boldy,L,MIN,23,75,33,60,93
29,8480800,Quinn Hughes,D,VAN,25,73,11,81,92
29,8477939,William Nylander,R,TOR,28,79,40,51,91
29,8478403,Jack Eichel,C,VGK,28,80,51,38,89
29,8480801,Brady Tkachuk,L,OTT,25,80,42,46,88
29,8477493,Aleksander Barkov,C,FLA,29,75,22,66,88
29,8479420,Tage Thompson,C,BUF,27,73,44,43,87
29,8479343,Clayton Keller,R,UTA,26,79,35,52,87
29,8477942,Kevin Fiala,L,LAK,28,76,31,56,87
29,8479407,Jesper Bratt,L,NJD,26,74,37,49,86
29,8476887,Filip Forsberg,L,NSH,30,72,32,54,86
29,8477933,Sam Reinhart,C,FLA,29,79,38,47,85
29,8475166,John Tavares,C,TOR,34,79,37,48,85
29,8477956,David Pastrnak,R,BOS,28,80,40,44,84
29,8477960,Adrian Kempe,R,LAK,28,81,42,40,82
29,8480027,Jason Robertson,L,DAL,25,81,36,46,82
29,8482116,Tim Stützle,C,OTT,22,81,29,53,82
29,8480023,Robert Thomas,C,STL,25,71,26,56,82
29,8478010,Brayden Point,C,TBL,28,82,46,35,81
29,8477951,Nick Schmaltz,C,UTA,28,75,35,45,80
29,8475692,Mats Zuccarello,R,MIN,37,69,18,62,80
29,8475172,Nazem Kadri,C,CGY,34,77,32,45,77
29,8478439,Travis Konecny,R,PHI,27,76,28,49,77
29,8480036,Miro Heiskanen,D,DAL,25,80,13,64,77
29,8478449,Roope Hintz,C,DAL,28,82,39,37,76
29,8482078,Lucas Raymond,L,DET,22,77,27,49,76
29,8478427,Sebastian Aho,C,CAR,27,74,24,52,76
29,8478445,Mathew Barzal,C,NYI,27,81,25,50,75
29,8474141,Patrick Kane,R,DET,36,82,21,54,75
29,8477949,Alex Tuch,R,BUF,28,77,18,57,75
29,8475765,Vladimir Tarasenko,R,DET,33,80,27,47,74
29,8480002,Nico Hischier,C,NJD,25,76,23,51,74
29,8477501,Valeri Nichushkin,R,COL,29,80,39,34,73
29,8482093,Seth Jarvis,C,CAR,22,75,34,39,73
29,8478493,Joel Eriksson Ek,C,MIN,27,66,28,45,73
29,8471214,Alex Ovechkin,L,WSH,39,74,36,36,72
29,8479385,Jordan Kyrou,C,STL,26,72,29,43,72
29,8475913,Mark Stone,R,VGK,32,72,26,46,72
29,8478414,Timo Meier,R,NJD,28,74,25,47,72
29,8474600,Roman Josi,D,NSH,34,74,20,52,72
29,8475167,Victor Hedman,D,TBL,34,80,18,54,72
29,8476459,Mika Zibanejad,C,NYR,31,75,22,48,70
29,8474578,Erik Karlsson,D,PIT,34,77,21,49,70
29,8477500,Bo Horvat,C,NYI,29,79,37,32,69
29,8476460,Mark Scheifele,C,WPG,31,79,28,41,69
29,8471685,Anze Kopitar,C,LAK,37,79,25,44,69
29,8480839,Rasmus Dahlin,D,BUF,24,72,19,50,69
29,8476456,Jonathan Huberdeau,C,CGY,31,77,14,55,69
29,8477409,Carter Verhaeghe,C,FLA,29,75,32,36,68
29,8478397,Rasmus Andersson,D,CGY,28,76,12,56,68
29,8478398,Kyle Connor,L,WPG,28,74,34,33,67
29,8471215,Evgeni Malkin,C,PIT,38,74,33,34,67
29,8480039,Martin Necas,C,CAR,25,71,28,39,67
29,8474564,Steven Stamkos,C,NSH,34,72,26,41,67
29,8476539,Jonathan Marchessault,R,NSH,34,73,35,31,66
29,8476389,Vincent Trocheck,C,NYR,31,79,29,37,66
29,8477402,Pavel Buchnevich,L,STL,29,77,26,40,66
29,8475184,Chris Kreider,L,NYR,33,77,35,30,65
29,8477955,Jared McCann,L,SEA,28,74,35,30,65
29,8479337,Alex DeBrincat,R,DET,27,80,32,33,65
29,8471675,Sidney Crosby,C,PIT,37,74,27,38,65
29,8480208,Drake Batherson,R,OTT,26,80,23,42,65
29,8484144,Connor Bedard,C,CHI,19,66,20,45,65
29,8476346,Johnny Gaudreau,L,CBJ,31,73,16,49,65
29,8475786,Zach Hyman,L,EDM,32,79,27,37,64
29,8481528,Dylan Cozens,C,BUF,23,73,32,31,63
29,8482665,Matty Beniers,C,SEA,22,76,22,41,63
29,8479323,Adam Fox,D,NYR,26,74,21,42,63
29,8476454,Ryan Nugent-Hopkins,C,EDM,31,80,20,43,63
29,8478498,Jake DeBrusk,L,VAN,28,73,36,26,62
29,8478444,Brock Boeser,R,VAN,27,75,25,37,62
29,8477504,Josh Morrissey,D,WPG,29,74,7,55,62
29,8479542,Brandon Hagel,L,TBL,26,82,31,30,61
29,8475158,Ryan O'Reilly,C,NSH,33,76,28,33,61
29,8476881,Tomas Hertl,C,VGK,31,74,28,33,61
29,8477940,Nikolaj Ehlers,L,WPG,28,68,21,40,61
29,8478401,Pavel Zacha,C,BOS,27,80,21,40,61
29,8478460,Zach Werenski,D,CBJ,27,79,14,47,61
29,8480830,Andrei Svechnikov,R,CAR,24,76,23,37,60
29,8477416,Oliver Bjorkstrand,R,SEA,29,72,21,39,60
29,8477503,Max Domi,C,TOR,29,79,16,44,60
29,8479425,Filip Hronek,D,VAN,27,75,12,48,60
29,8475726,Tyler Toffoli,C,SJS,32,70,33,26,59
29,8480797,Joel Farabee,L,PHI,24,71,32,27,59
29,8479675,Trevor Moore,L,LAK,29,81,29,30,59
29,8480803,Evan Bouchard,D,EDM,25,71,15,44,59
29,8480865,Noah Dobson,D,NYI,24,82,9,50,59
29,8477447,Shea Theodore,D,VGK,29,64,6,53,59
29,8475784,Jeff Skinner,C,EDM,32,76,33,25,58
29,8478440,Dylan Strome,C,WSH,27,73,25,33,58
29,8482740,Wyatt Johnston,C,DAL,21,81,25,33,58
29,8478873,Troy Terry,R,ANA,27,75,22,36,58
29,8473419,Brad Marchand,L,BOS,36,81,22,36,58
29,8478047,Michael Bunting,L,PIT,29,73,20,38,58
29,8477494,Jonathan Drouin,L,COL,29,79,18,40,58
29,8476399,Blake Coleman,C,CGY,33,77,34,23,57
29,8475168,Matt Duchene,C,DAL,33,81,29,28,57
29,8475745,Charlie Coyle,C,BOS,32,78,29,28,57
29,8483515,Juraj Slafkovsky,L,MTL,20,76,28,29,57
29,8476448,William Karlsson,C,VGK,31,76,24,33,57
29,8481068,Yegor Sharangovich,C,CGY,26,79,30,26,56
29,8477496,Elias Lindholm,C,BOS,30,78,20,36,56
29,8477932,Aaron Ekblad,D,FLA,28,74,16,40,56
29,8477407,Anthony Duclair,L,NYI,29,78,21,34,55
29,8480018,Nick Suzuki,C,MTL,25,75,19,36,55
29,8482124,Quinton Byfield,R,LAK,22,80,19,36,55
29,8475170,Brayden Schenn,C,STL,33,71,18,37,55
29,8482159,Tyson Foerster,R,PHI,22,74,25,29,54
29,8479339,Patrik Laine,L,CBJ,26,65,20,34,54
29,8473512,Claude Giroux,R,OTT,36,80,14,40,54
29,8475798,Mikael Granlund,C,SJS,32,68,12,42,54
29,8478407,Vince Dunn,D,SEA,28,73,9,45,54
29,8475810,Bryan Rust,R,PIT,32,72,27,26,53
29,8476483,Rickard Rakell,R,PIT,31,67,27,26,53
29,8480185,Eetu Luostarinen,C,FLA,26,74,21,32,53
29,8478856,Conor Garland,R,VAN,28,73,16,37,53
29,8476958,Jaccob Slavin,D,CAR,30,79,11,42,53
29,8475151,Kyle Palmieri,C,NYI,33,81,27,25,52
29,8476875,Mike Matheson,D,MTL,30,72,12,40,52
29,8482684,Luke Hughes,D,NJD,21,65,10,42,52
29,8477935,Sam Bennett,C,FLA,28,78,25,26,51
29,8478042,Viktor Arvidsson,L,EDM,31,70,24,27,51
29,8482745,Mason McTavish,C,ANA,21,73,21,30,51
29,8482699,Dylan Guenther,R,UTA,21,76,21,30,51
29,8476479,Phillip Danault,C,LAK,31,79,20,31,51
29,8478542,Evan Rodrigues,C,FLA,31,80,20,31,51
29,8474150,Mikael Backlund,C,CGY,35,77,15,36,51
29,8479999,Casey Mittelstadt,C,COL,26,81,10,41,51
29,8475794,Tyler Seguin,C,DAL,32,80,25,25,50
29,8483808,Andrei Kuzmenko,L,CGY,28,74,22,28,50
29,8475768,Jaden Schwartz,C,SEA,32,73,22,28,50
29,8482109,Alexis Lafrenière,L,NYR,23,76,21,29,50
29,8480015,Owen Tippett,R,PHI,25,73,21,29,50
29,8477476,Artturi Lehkonen,L,COL,29,81,29,20,49
29,8475754,Brock Nelson,C,NYI,33,79,25,24,49
29,8481533,Trevor Zegras,C,ANA,23,73,24,25,49
29,8474102,David Perron,L,OTT,36,77,23,26,49
29,8481711,Matias Maccelli,L,UTA,24,75,12,37,49
29,8482720,Matthew Knies,L,TOR,22,76,12,37,49
29,8471724,Kris Letang,D,PIT,37,79,11,38,49
29,8479325,Charlie McAvoy,D,BOS,27,72,8,41,49
29,8480014,Gabriel Vilardi,C,WPG,25,67,29,19,48
29,8476880,Tom Wilson,R,WSH,30,67,26,22,48
29,8478519,Anthony Cirelli,C,TBL,27,82,21,27,48
29,8479400,Pierre-Luc Dubois,L,WSH,26,72,21,27,48
29,8481560,Arthur Kaliyev,R,LAK,23,82,18,30,48
29,8474590,John Carlson,D,WSH,34,67,11,37,48
29,8478469,Thomas Chabot,D,OTT,27,74,10,38,48
29,8476853,Morgan Rielly,D,TOR,30,72,8,40,48
29,8480064,Josh Norris,C,OTT,25,77,24,23,47
29,8476432,Boone Jenner,C,CBJ,31,71,24,23,47
29,8477456,J.T. Compher,L,DET,29,81,22,25,47
29,8478975,Mason Marchment,L,DAL,29,81,20,27,47
29,8478233,Andrew Mangiapane,L,WSH,28,70,20,27,47
29,8483431,Logan Cooley,C,UTA,20,75,19,28,47
29,8471698,T.J. Oshie,R,WSH,38,71,19,28,47
29,8474679,Gustav Nyquist,C,NSH,35,70,15,32,47
29,8477948,Travis Sanheim,D,PHI,28,70,12,35,47
29,8482113,Anton Lundell,C,FLA,23,81,20,26,46
29,8484166,Adam Fantilli,C,CBJ,20,64,18,28,46
29,8476461,Sean Couturier,C,PHI,32,68,16,30,46
29,8476906,Shayne Gostisbehere,D,CAR,31,77,8,38,46
29,8478055,Gustav Forsling,D,FLA,28,78,8,38,46
29,8482705,Cole Sillinger,C,CBJ,21,71,19,26,45
29,8477987,Ryan Donato,C,CHI,28,64,18,27,45
29,8477986,Brandon Montour,D,SEA,30,73,16,29,45
29,8480028,Morgan Frost,C,PHI,25,72,15,30,45
29,8477444,Andre Burakovsky,L,SEA,29,70,15,30,45
29,8475793,Ryan Johansen,C,PHI,32,71,15,30,45
29,8476905,Chandler Stephenson,C,SEA,30,67,14,31,45
29,8476826,Yanni Gourde,C,SEA,33,72,12,33,45
29,8476438,Brandon Saad,L,STL,32,72,26,18,44
29,8478366,Frank Vatrano,R,ANA,30,67,24,20,44
29,8477998,Warren Foegele,L,LAK,28,79,23,21,44
29,8477426,Nicholas Paul,L,TBL,29,82,18,26,44
29,8477498,Darnell Nurse,D,EDM,29,67,11,33,44
29,8475722,Jason Zucker,L,BUF,32,73,23,20,43
29,8475314,Anders Lee,L,NYI,34,75,18,25,43
29,8478458,John (Jack) Roslovic,C,CAR,27,74,18,25,43
29,8473994,Jamie Benn,L,DAL,35,82,17,26,43
29,8477021,Alex Kerfoot,C,UTA,30,75,16,27,43
29,8484145,Zach Benson,L,BUF,19,68,16,27,43
29,8477451,Ryan Hartman,R,MIN,30,69,16,27,43
29,8478472,Mathieu Joseph,R,STL,27,68,14,29,43
29,8476872,Scott Laughton,C,PHI,30,72,12,31,43
29,8476463,Jonas Brodin,D,MIN,31,73,11,32,43
29,8479992,Michael Rasmussen,C,DET,25,78,21,21,42
29,8476882,Teuvo Teravainen,C,CHI,30,69,19,23,42
29,8474641,Adam Henrique,C,EDM,34,76,18,24,42
29,8473986,Alex Killorn,L,ANA,35,72,17,25,42
29,8478462,Nicolas Roy,C,VGK,27,78,17,25,42
29,8475287,Erik Haula,L,NJD,33,70,17,25,42
29,8479591,Michael Eyssimont,C,TBL,28,80,16,26,42
29,8478466,Daniel Sprong,R,VAN,27,73,15,27,42
29,8475169,Evander Kane,L,EDM,33,75,22,19,41
29,8484153,Leo Carlsson,C,ANA,20,73,17,24,41
29,8475753,Justin Faulk,D,STL,32,75,16,25,41
29,8481703,Valtteri Puustinen,R,PIT,25,60,10,31,41
29,8478046,Danton Heinen,L,VAN,29,70,23,17,40
29,8479525,Ross Colton,C,COL,28,80,20,20,40
29,8477964,Ivan Barbashev,C,VGK,29,76,20,20,40
29,8482149,Cole Perfetti,C,WPG,22,66,20,20,40
29,8481554,Kaapo Kakko,R,NYR,23,74,20,20,40
29,8481540,Cole Caufield,R,MTL,23,76,19,21,40
29,8477511,Anthony Mantha,R,CGY,30,79,18,22,40
29,8474586,Jordan Eberle,R,SEA,34,70,18,22,40
29,8482055,Drew O'Connor,L,PIT,26,68,18,22,40
29,8478115,Pierre Engvall,L,NYI,28,80,14,26,40
29,8476419,Jean-Gabriel Pageau,C,NYI,32,74,14,26,40
29,8482671,Owen Power,D,BUF,22,71,13,27,40
29,8476792,Torey Krug,D,STL,33,74,9,31,40
29,8479345,Jakob Chychrun,D,WSH,26,62,9,31,40
29,8481546,Cam York,D,PHI,23,69,8,32,40
29,8479410,Mikhail Sergachev,D,UTA,26,64,7,33,40
29,8478038,Devon Toews,D,COL,30,69,3,37,40
29,8475764,Cam Fowler,D,ANA,33,74,2,38,40
29,8479365,Trent Frederic,C,BOS,26,76,21,18,39
29,8481553,Bobby Brink,R,PHI,23,60,20,19,39
29,8477429,Andrew Copp,C,DET,30,80,18,21,39
29,8477479,Tyler Bertuzzi,L,CHI,29,71,17,22,39
29,8481618,Alex Newhook,C,MTL,23,69,16,23,39
29,8476927,Teddy Blueger,C,VAN,30,68,15,24,39
29,8482097,Jack Quinn,R,BUF,23,66,13,26,39
29,8475763,Kevin Hayes,R,PIT,32,62,9,30,39
29,8480434,Sean Durzi,D,UTA,26,71,8,31,39
29,8481581,Thomas Harley,D,DAL,23,73,7,32,39
29,8481535,Nils Hoglander,L,VAN,24,68,23,15,38
29,8482660,Kent Johnson,C,CBJ,22,67,19,19,38
29,8480798,Philipp Kurashev,C,CHI,25,63,16,22,38
29,8475760,Nick Bjugstad,C,UTA,32,77,15,23,38
29,8477497,Sean Monahan,C,CBJ,30,68,15,23,38
29,8482667,William Eklund,L,SJS,22,72,14,24,38
29,8481596,Shane Pinto,C,OTT,24,70,14,24,38
29,8477839,Conor Sheary,L,TBL,32,80,13,25,38
29,8481577,Philip Tomasino,C,NSH,23,71,9,29,38
29,8482122,Brock Faber,D,MIN,22,75,6,32,38
29,8480188,Fabian Zetterlund,L,SJS,25,65,17,20,37
29,8480220,Noah Cates,L,PHI,25,74,17,20,37
29,8476392,Adam Lowry,C,WPG,31,64,16,21,37
29,8476918,Jimmy Vesey,L,NYR,31,71,15,22,37
29,8480113,Alex Iafallo,L,WPG,31,69,14,23,37
29,8479987,Morgan Geekie,C,BOS,26,78,13,24,37
29,8470613,Brent Burns,D,CAR,39,76,12,25,37
29,8475191,Reilly Smith,R,NYR,33,77,11,26,37
29,8476923,Damon Severson,D,CBJ,30,76,8,29,37
29,8477346,MacKenzie Weegar,D,CGY,30,73,5,32,37
29,8478396,Noah Hanifin,D,VGK,27,62,5,32,37
29,8474563,Drew Doughty,D,LAK,35,73,4,33,37
29,8475714,Calle Jarnkrok,C,TOR,33,78,25,11,36
29,8482089,Jake Neighbours,L,STL,22,68,25,11,36
29,8481582,Nicholas Robertson,L,TOR,23,69,23,13,36
29,8478474,Lawson Crouse,L,UTA,27,74,19,17,36
29,8479393,Noah Gregor,L,OTT,26,70,19,17,36
29,8474715,Cameron Atkinson,R,TBL,35,79,19,17,36
29,8476981,Josh Anderson,R,MTL,30,71,18,18,36
29,8482146,Luke Evangelista,R,NSH,22,67,17,19,36
29,8482110,Dawson Mercer,C,NJD,23,75,16,20,36
29,8480849,Barrett Hayton,C,UTA,24,74,16,20,36
29,8476925,Colton Sissons,C,NSH,31,65,14,22,36
29,8475218,Mattias Ekholm,D,EDM,34,78,10,26,36
29,8477495,Seth Jones,D,CHI,30,66,8,28,36
29,8479414,Nathan Bastian,R,NJD,27,62,15,20,35
29,8478020,Michael Amadio,R,OTT,28,75,14,21,35
29,8480459,Pius Suter,C,VAN,28,70,13,22,35
29,8477505,Alexander Wennberg,C,SJS,30,66,12,23,35
29,8474149,Evgenii Dadonov,R,DAL,35,78,9,26,35
29,8476892,Colton Parayko,D,STL,31,68,2,33,35
29,8475799,Nino Niederreiter,R,WPG,32,61,20,14,34
29,8476469,Joel Armia,R,MTL,31,71,20,14,34
29,8476462,Dougie Hamilton,D,NJD,31,67,15,19,34
29,8480078,Filip Chytil,C,NYR,25,66,13,21,34
29,8482105,Jake Sanderson,D,OTT,22,77,11,23,34
29,8480068,Ryan Poehling,C,PHI,25,71,11,23,34
29,8475200,Dmitry Orlov,D,CAR,33,71,9,25,34
29,8474565,Alex Pietrangelo,D,VGK,34,65,6,28,34
29,8480748,Kiefer Sherwood,L,VAN,29,61,18,15,33
29,8481604,Pavel Dorofeyev,L,VGK,24,71,14,19,33
29,8481522,Peyton Krebs,C,BUF,23,62,9,24,33
29,8481542,Moritz Seider,D,DET,23,74,8,25,33
29,8478133,Jake Evans,C,MTL,28,67,8,25,33
29,8476869,Brady Skjei,D,NSH,30,73,8,25,33
29,8478500,Ivan Provorov,D,CBJ,27,80,5,28,33
29,8482175,JJ Peterka,R,BUF,22,69,19,13,32
29,8482702,Logan Stankoven,C,DAL,21,80,17,15,32
29,8475149,Marcus Johansson,L,MIN,34,68,16,16,32
29,8482475,Yegor Chinakhov,R,CBJ,23,65,16,16,32
29,8478891,Mason Appleton,C,WPG,28,69,14,18,32
29,8481524,Bowen Byram,D,BUF,23,68,14,18,32
29,8478463,Anthony Beauvillier,L,PIT,27,64,13,19,32
29,8482092,Ridly Greig,C,OTT,22,76,12,20,32
29,8476885,Jacob Trouba,D,NYR,30,72,11,21,32
29,8478438,Tommy Novak,C,NSH,27,68,9,23,32
29,8480145,Neal Pionk,D,WPG,29,71,9,23,32
29,8482624,Daniil Miromanov,D,CGY,27,67,9,23,32
29,8483505,Matthew Poitras,C,BOS,20,78,7,25,32
29,8476278,Colin Blackwell,C,DAL,31,78,18,13,31
29,8482079,Marco Rossi,C,MIN,23,59,17,14,31
29,8470621,Corey Perry,R,EDM,39,71,16,15,31
29,8479941,Justin Danforth,R,CBJ,31,57,14,17,31
29,8480802,Ryan McLeod,C,BUF,25,61,12,19,31
29,8482749,Joshua Roy,R,MTL,21,65,9,22,31
29,8476458,Ryan Strome,C,ANA,31,72,6,25,31
29,8478911,Matt Roy,D,WSH,29,61,6,25,31
29,8476979,Erik Gustafsson,D,DET,32,77,5,26,31
29,8474151,Ryan McDonagh,D,TBL,35,77,2,29,31
29,8473422,Nick Foligno,L,CHI,37,66,15,15,30
29,8474716,Jared Spurgeon,D,MIN,35,77,12,18,30
29,8475791,Taylor Hall,L,CHI,33,56,10,20,30
29,8480893,Kirill Marchenko,R,CBJ,24,66,25,4,29
29,8476878,Zemgus Girgensons,C,TBL,30,79,17,12,29
29,8477952,Robby Fabbri,C,ANA,28,67,15,14,29
29,8476480,Vladislav Namestnikov,C,WPG,32,67,14,15,29
29,8480835,Jack Drury,C,CAR,24,59,12,17,29
29,8478043,Sam Lafferty,C,BUF,29,60,11,18,29
29,8481656,Aliaksei Protas,C,WSH,23,61,8,21,29
29,8476854,Hampus Lindholm,D,BOS,30,73,6,23,29
29,8477488,Brett Pesce,D,NJD,30,70,6,23,29
29,8477969,Marcus Pettersson,D,PIT,28,81,3,26,29
29,8481624,Ilya Mikheyev,R,CHI,30,58,15,13,28
29,8480813,Joe Veleno,C,DET,24,78,15,13,28
29,8480205,Emil Bemstrom,C,PIT,25,54,15,13,28
29,8477953,Kasperi Kapanen,R,STL,28,66,13,15,28
29,8481186,Logan O'Connor,R,COL,28,82,12,16,28
29,8481032,Paul Cotter,C,NJD,25,53,12,16,28
29,8476329,Travis Boyd,C,MIN,31,57,12,16,28
29,8480336,Sean Walker,D,CAR,30,73,8,20,28
29,8480817,K'Andre Miller,D,NYR,24,78,7,21,28
29,8483490,Pavel Mintyukov,D,ANA,21,65,7,21,28
29,8479351,Sam Steel,C,DAL,26,80,5,23,28
29,8476891,Matthew Grzelcyk,D,PIT,30,73,4,24,28
29,8480009,Eeli Tolvanen,R,SEA,25,71,13,14,27
29,8474189,Lars Eller,C,PIT,35,66,12,15,27
29,8475848,Brendan Gallagher,R,MTL,32,68,10,17,27
29,8473533,Jordan Staal,C,CAR,36,61,9,18,27
29,8476917,Adam Pelech,D,NYI,30,79,8,19,27
29,8476292,Ondrej Palat,L,NJD,33,67,7,20,27
29,8475171,Oliver Ekman-Larsson,D,TOR,33,68,6,21,27
29,8476429,Scott Mayfield,D,NYI,32,67,5,22,27
29,8475181,Nick Leddy,D,STL,33,71,2,25,27
29,8479353,Brett Howden,C,VGK,26,67,17,9,26
29,8479390,Taylor Raddysh,R,WSH,26,67,15,11,26
29,8482074,Connor Zary,C,CGY,23,63,14,12,26
29,8475220,Marcus Foligno,L,MIN,33,61,12,14,26
29,8479520,Brandon Duhaime,R,WSH,27,54,10,16,26
29,8477989,Christian Dvorak,C,MTL,28,65,9,17,26
29,8475193,Tomas Tatar,L,NJD,34,66,7,19,26
29,8480246,Nick Perbix,D,TBL,26,74,5,21,26
29,8478136,Jake Middleton,D,MIN,28,77,4,22,26
29,8476331,Dylan DeMelo,D,WPG,31,73,3,23,26
29,8479619,Michael Carcone,L,UTA,28,65,17,8,25
29,8480789,Oliver Wahlstrom,R,NYI,24,66,13,12,25
29,8477425,Miles Wood,L,COL,29,79,12,13,25
29,8484203,Bradly Nadeau,L,CAR,19,58,12,13,25
29,8482142,Jamie Drysdale,D,PHI,22,64,12,13,25
29,8480855,Jack McBain,C,UTA,24,66,11,14,25
29,8478413,Jordan Greenway,L,BUF,27,60,10,15,25
29,8479293,Brandon Tanev,L,SEA,33,64,10,15,25
29,8480762,Eric Robinson,L,CAR,29,60,8,17,25
29,8482712,Oskar Olausson,R,COL,22,76,8,17,25
29,8476902,Esa Lindell,D,DAL,30,73,7,18,25
29,8476856,Mathew Dumba,D,DAL,30,72,7,18,25
29,8479324,Ryan Lindgren,D,NYR,26,66,4,21,25
29,8480043,Timothy Liljegren,D,TOR,25,71,4,21,25
29,8482737,Zack Bolduc,C,STL,21,66,15,9,24
29,8476474,Stefan Noesen,R,NJD,31,64,14,10,24
29,8480003,Jesper Boqvist,C,FLA,26,59,12,12,24
29,8477450,Jason Dickinson,C,CHI,29,60,12,12,24
29,8475343,Nic Dowd,C,WSH,34,62,12,12,24
29,8480144,David Kampf,C,TOR,29,72,12,12,24
29,8480025,MacKenzie Entwistle,R,FLA,25,64,12,12,24
29,8479439,Jacob MacDonald,D,COL,31,56,12,12,24
29,8481481,Blake Lizotte,C,PIT,27,56,11,13,24
29,8480871,Adam Boqvist,D,FLA,24,67,7,17,24
29,8475324,Nick Jensen,D,OTT,34,66,5,19,24
29,8479398,Samuel Girard,D,COL,26,63,3,21,24
29,8476422,Mike Reilly,D,NYI,31,75,3,21,24
29,8480891,Michael Kesselring,D,UTA,24,51,2,22,24
29,8480829,Jesperi Kotkaniemi,C,CAR,24,67,12,11,23
29,8482111,Justin Barron,D,MTL,23,64,12,11,23
29,8478970,Jalen Chatfield,D,CAR,28,72,11,12,23
29,8480448,Parker Kelly,L,COL,25,76,11,12,23
29,8483524,Shane Wright,C,SEA,20,61,10,13,23
29,8479336,Carl Grundstrom,R,SJS,27,59,10,13,23
29,8477903,Garnet Hathaway,R,PHI,33,64,10,13,23
29,8477220,Nate Schmidt,D,FLA,33,67,10,13,23
29,8478109,Victor Olofsson,L,VGK,29,69,8,15,23
29,8482133,Thomas Bordeleau,C,SJS,22,53,7,16,23
29,8482117,Lukas Reichel,L,CHI,22,53,7,16,23
29,8473563,Nicklas Backstrom,C,WSH,37,55,6,17,23
29,8476457,Adam Larsson,D,SEA,32,69,6,17,23
29,8482087,Kaiden Guhle,D,MTL,22,63,6,17,23
29,8476931,Jake McCabe,D,TOR,31,64,4,19,23
29,8476873,Mark Jankowski,C,NSH,30,57,13,9,22
29,8476897,Oskar Sundqvist,C,STL,30,65,12,10,22
29,8477931,Tomas Nosek,L,FLA,32,65,11,11,22
29,8482157,Will Cuylle,L,NYR,22,60,11,11,22
29,8477979,Nicolas Aube-Kubel,R,BUF,28,59,11,11,22
29,8481523,Kirby Dach,C,MTL,23,67,9,13,22
29,8479996,Cody Glass,C,NSH,25,57,8,14,22
29,8481028,Martin Pospisil,C,CGY,25,52,7,15,22
29,8483468,Jiri Kulich,C,BUF,20,63,5,17,22
29,8483493,Frank Nazar,C,CHI,20,58,5,17,22
29,8480878,Nils Lundkvist,D,DAL,24,77,4,18,22
29,8481059,Scott Perunovich,D,STL,26,56,2,20,22
29,8479368,Max Jones,L,BOS,26,68,13,8,21
29,8476889,Radek Faksa,C,STL,30,64,11,10,21
29,8478013,Jake Walman,D,SJS,28,72,10,11,21
29,8482809,Jackson Blake,R,CAR,21,50,9,12,21
29,8477478,William Carrier,L,CAR,30,55,8,13,21
29,8477015,Connor Brown,R,EDM,30,59,7,14,21
29,8481019,David Gustafsson,C,WPG,24,49,7,14,21
29,8479315,Joey Anderson,R,CHI,26,53,6,15,21
29,8475279,Ben Chiarot,D,DET,33,65,6,15,21
29,8478840,Will Borgen,D,SEA,28,70,6,15,21
29,8482148,Hendrix Lapierre,C,WSH,22,48,6,15,21
29,8477506,Ryan Pulock,D,NYI,30,80,4,17,21
29,8478882,Vladislav Gavrikov,D,LAK,29,74,3,18,21
29,8477435,Ryan Graves,D,PIT,29,77,3,18,21
29,8479998,Mikey Anderson,D,LAK,25,56,3,18,21
29,8482655,Janis Moser,D,TBL,24,74,2,19,21
29,8475790,Erik Gudbranson,D,CBJ,32,79,0,21,21
29,8478057,Dakota Joshua,C,VAN,28,64,12,8,20
29,8481601,Simon Holmstrom,R,NYI,23,70,12,8,20
29,8477406,Mattias Janmark,C,EDM,32,67,11,9,20
29,8475855,Jesper Fast,R,CAR,33,60,9,11,20
29,8480806,Isac Lundestrom,C,ANA,25,65,9,11,20
29,8477353,Tyler Motte,C,DET,29,73,9,11,20
29,8480995,Pontus Holmberg,R,TOR,25,61,9,11,20
29,8478569,Noel Acciari,C,PIT,33,58,9,11,20
29,8476960,Andreas Athanasiou,C,CHI,30,51,9,11,20
29,8482101,Danil Gushchin,L,SJS,22,53,8,12,20
29,8481093,Rafael Harvey-Pinard,L,MTL,25,63,7,13,20
29,8478851,Alexandre Carrier,D,NSH,28,66,5,15,20
29,8482245,Artem Zub,D,OTT,29,73,3,17,20
29,8470600,Ryan Suter,D,STL,39,66,3,17,20
29,8479983,Mario Ferraro,D,SJS,26,72,2,18,20
29,8479328,Julien Gauthier,R,NYI,27,65,12,7,19
29,8480252,Cole Guttman,C,CHI,25,40,10,9,19
29,8481441,Joe Snively,C,DET,28,61,7,12,19
29,8481521,Ronnie Attard,D,PHI,25,57,7,12,19
29,8476374,Sean Kuraly,C,CBJ,31,54,6,13,19
29,8483565,Nick Blankenburg,D,NSH,26,51,6,13,19
29,8479402,Jake Bean,D,CGY,26,66,4,15,19
29,8475231,Casey Cizikas,C,NYI,33,73,4,15,19
29,8475718,Justin Holl,D,DET,32,64,4,15,19
29,8479976,Juuso Valimaki,D,UTA,26,65,2,17,19
29,8480035,Henri Jokiharju,D,BUF,25,60,2,17,19
29,8482679,Matt Coronato,R,CGY,22,59,14,4,18
29,8477919,Frederick Gaudreau,C,MIN,31,62,10,8,18
29,8478508,Yakov Trenin,C,MIN,27,58,10,8,18
29,8481704,Juuso Parssinen,C,NSH,23,53,10,8,18
29,8480281,Alexey Toropchenko,R,STL,25,59,10,8,18
29,8479661,Tanner Jeannot,L,LAK,27,77,9,9,18
29,8479344,Jesse Puljujarvi,R,PIT,26,56,9,9,18
29,8479370,Tyson Jost,C,CAR,26,46,8,10,18
29,8481606,Jordan Spence,D,LAK,23,68,7,11,18
29,8482125,Alexander Holtz,R,VGK,22,67,6,12,18
29,8477507,Nikita Zadorov,D,BOS,29,68,6,12,18
29,8477499,Rasmus Ristolainen,D,PHI,30,62,6,12,18
29,8479371,Dante Fabbro,D,NSH,26,64,5,13,18
29,8476467,Jamie Oleksiak,D,SEA,32,73,5,13,18
29,8481178,Egor Zamula,D,PHI,24,53,3,15,18
29,8475462,Radko Gudas,D,ANA,34,67,3,15,18
29,8480222,Sebastian Aho,D,PIT,28,65,3,15,18
29,8480887,Jordan Harris,D,MTL,24,56,3,15,18
29,8481014,Alexander Romanov,D,NYI,24,77,2,16,18
29,8476879,Cody Ceci,D,EDM,31,70,2,16,18
29,8475233,David Savard,D,MTL,34,70,2,16,18
29,8476988,Matt Benning,D,SJS,30,68,1,17,18
29,8478507,John Marino,D,UTA,27,66,1,17,18
29,8480873,Rasmus Sandin,D,WSH,24,61,0,18,18
29,8480049,Dylan Samberg,D,WPG,25,64,0,18,18
29,8481477,Nico Sturm,C,SJS,29,61,10,7,17
29,8478432,Christian Fischer,R,DET,27,74,8,9,17
29,8481592,Jakob Pelletier,L,CGY,23,41,8,9,17
29,8481580,Connor McMichael,C,WSH,23,63,7,10,17
29,8480021,Jack Studnicka,C,LAK,25,64,7,10,17
29,8480289,Morgan Barron,C,WPG,26,53,6,11,17
29,8482803,Olen Zellweger,D,ANA,21,63,6,11,17
29,8477938,Haydn Fleury,D,WPG,28,47,6,11,17
29,8481599,Victor Soderstrom,D,UTA,23,44,5,12,17
29,8480074,Alexandre Texier,C,STL,25,56,4,13,17
29,8482067,Connor Mackey,D,NYR,28,64,4,13,17
29,8479980,Nicolas Hague,D,VGK,26,62,3,14,17
29,8475179,Dmitry Kulikov,D,FLA,34,62,3,14,17
29,8475188,Brayden McNabb,D,VGK,33,49,3,14,17
29,8479982,Conor Timmins,D,TOR,26,59,2,15,17
29,8477365,Connor Clifton,D,BUF,29,58,1,16,17
29,8478416,Erik Cernak,D,TBL,27,74,1,16,17
29,8482259,Bobby McMann,C,TOR,28,64,12,4,16
29,8475225,Craig Smith,C,CHI,35,55,10,6,16
29,8480980,Connor Dewar,C,TOR,25,65,9,7,16
29,8482166,Shakir Mukhamadullin,D,SJS,22,51,8,8,16
29,8480011,Klim Kostin,C,SJS,25,46,8,8,16
29,8476312,Josh Manson,D,COL,33,69,7,9,16
29,8482062,Cole Smith,L,NSH,29,57,7,9,16
29,8483457,Lane Hutson,D,MTL,20,68,6,10,16
29,8479536,Axel Jonsson-Fjallby,L,WPG,26,45,6,10,16
29,8480001,Urho Vaakanainen,D,ANA,25,57,5,11,16
29,8480848,Ty Dellandrea,C,SJS,24,49,5,11,16
29,8481568,Alex Vlasic,D,CHI,23,63,5,11,16
29,8480073,Erik Brannstrom,D,COL,25,66,2,14,16
29,8474673,TJ Brodie,D,CHI,34,58,2,14,16
29,8476525,Colin Miller,D,WPG,32,60,1,15,16
29,8477508,Curtis Lazar,C,NJD,29,51,8,7,15
29,8477947,Sonny Milano,L,WSH,28,64,7,8,15
29,8476867,Brendan Gaunce,C,MIN,30,37,7,8,15
29,8476921,Jordan Martinook,L,CAR,32,60,6,9,15
29,8482807,Ethan Del Mastro,D,CHI,21,47,6,9,15
29,8481517,Brett Leason,R,ANA,25,52,5,10,15
29,8473453,Trevor Lewis,C,LAK,37,70,5,10,15
29,8479369,Andrew Peeke,D,BOS,26,56,5,10,15
29,8474053,Logan Couture,C,SJS,35,52,4,11,15
29,8478399,Jonas Siegenthaler,D,NJD,27,53,4,11,15
29,8479639,Dylan Coghlan,D,WPG,26,61,3,12,15
29,8477369,Carson Soucy,D,VAN,30,59,3,12,15
29,8480058,Pierre-Olivier Joseph,D,STL,25,49,3,12,15
29,8480796,Martin Fehervary,D,WSH,25,64,2,13,15
29,8482451,Mikael Pyyhtia,L,CBJ,23,46,2,13,15
29,8480950,Ilya Lyubushkin,D,DAL,30,57,0,15,15
29,8478434,Keegan Kolesar,R,VGK,27,66,7,7,14
29,8478831,Kevin Stenlund,C,UTA,28,50,7,7,14
29,8483482,Tristan Luneau,D,ANA,20,67,6,8,14
29,8483499,Liam Ohgren,L,MIN,20,54,6,8,14
29,8479671,Mathieu Olivier,R,CBJ,27,51,6,8,14
29,8479291,Kevin Rooney,C,CGY,31,53,6,8,14
29,8481013,Jonatan Berggren,R,DET,24,59,5,9,14
29,8482744,James Malatesta,L,CBJ,21,40,5,9,14
29,8481527,Kaedan Korczak,D,VGK,23,44,4,10,14
29,8479543,Michael Pezzetta,L,MTL,26,53,3,11,14
29,8480727,Zach Whitecloud,D,VGK,28,48,3,11,14
29,8474574,Tyler Myers,D,VAN,34,66,1,13,14
29,8477392,Hudson Fasching,R,NYI,29,58,8,5,13
29,8482762,Simon Edvinsson,D,DET,21,51,8,5,13
29,8482784,Zach Dean,C,STL,21,39,8,5,13
29,8477446,Michael McCarron,R,NSH,29,62,7,6,13
29,8476442,Matt Nieto,L,PIT,32,50,7,6,13
29,8477380,Jonny Brodzinski,C,NYR,31,51,6,7,13
29,8483495,Simon Nemec,D,NJD,20,51,6,7,13
29,8483549,Lucas Condotta,L,MTL,27,38,6,7,13
29,8483445,Cutter Gauthier,L,ANA,20,50,5,8,13
29,8476934,Brock McGinn,L,ANA,30,52,4,9,13
29,8484149,Gavin Brindley,C,CBJ,20,54,3,10,13
29,8480172,Jan Rutta,D,SJS,34,66,3,10,13
29,8481708,Zac Jones,D,NYR,24,43,3,10,13
29,8477845,Trevor van Riemsdyk,D,WSH,33,62,2,11,13
29,8480860,Kevin Bahl,D,CGY,24,62,2,11,13
29,8479378,Logan Stanley,D,WPG,26,42,2,11,13
29,8480807,Mattias Samuelsson,D,BUF,24,53,2,11,13
29,8480070,Ian Mitchell,D,BOS,25,52,2,11,13
29,8474612,Travis Hamonic,D,OTT,34,46,2,11,13
29,8482659,Josh Doan,R,UTA,22,45,10,2,12
29,8479359,Beck Malenstyn,L,BUF,26,46,9,3,12
29,8476822,Luke Glendening,C,TBL,35,80,8,4,12
29,8482652,Walker Duehr,R,CGY,27,43,8,4,12
29,8483491,Ivan Miroshnichenko,L,WSH,20,49,8,4,12
29,8478585,Derek Ryan,C,EDM,38,58,7,5,12
29,8477962,Brendan Lemieux,L,CAR,28,38,7,5,12
29,8481537,Nikita Okhotiuk,D,CGY,24,61,5,7,12
29,8475208,Brian Dumoulin,D,ANA,33,61,5,7,12
29,8480441,Trey Fix-Wolansky,R,CBJ,25,34,5,7,12
29,8478421,A.J. Greer,L,FLA,28,59,5,7,12
29,8480245,Olle Lycksell,R,PHI,25,42,5,7,12
29,8477070,Liam O'Brien,C,UTA,30,52,5,7,12
29,8481751,Lukas Rousek,R,BUF,25,36,4,8,12
29,8481641,Joel Kiviranta,L,COL,28,68,4,8,12
29,8482964,Arber Xhekaj,D,MTL,23,50,4,8,12
29,8482176,Wyatt Kaiser,D,CHI,22,58,3,9,12
29,8479249,Andrew Poturalski,C,SJS,30,43,3,9,12
29,8475690,Chris Tanev,D,TOR,35,52,3,9,12
29,8477851,Jordan Oesterle,D,BOS,32,46,3,9,12
29,8482073,Braden Schneider,D,NYR,23,61,2,10,12
29,8474166,Alec Martinez,D,CHI,37,48,2,10,12
29,8481518,Nolan Foote,L,NJD,24,48,8,3,11
29,8479316,Luke Kunin,C,SJS,27,56,6,5,11
29,8476372,Nick Seeler,D,PHI,31,40,6,5,11
29,8480007,Jonas Rondbjerg,R,VGK,25,42,6,5,11
29,8479066,Ryan Lomberg,L,CGY,30,64,5,6,11
29,8477018,Ben Hutton,D,VGK,31,51,4,7,11
29,8482730,Brandt Clarke,D,LAK,21,42,4,7,11
29,8482077,Dylan Holloway,L,EDM,23,51,4,7,11
29,8476952,Dominic Toninato,C,WPG,30,35,4,7,11
29,8482095,Tyler Kleven,D,OTT,22,38,4,7,11
29,8482192,Isaak Phillips,D,CHI,23,50,3,8,11
29,8478451,Ethan Bear,D,WSH,27,42,2,9,11
29,8480192,Johnathan Kovacevic,D,NJD,27,59,2,9,11
29,8473507,Jeff Petry,D,DET,37,73,1,10,11
29,8478468,Jeremy Lauzon,D,NSH,27,54,1,10,11
29,8476874,Olli Maatta,D,DET,30,62,1,10,11
29,8480355,Mark Kastelic,C,BOS,25,61,7,3,10
29,8482155,Alex Laferriere,R,LAK,23,62,7,3,10
29,8477573,Nathan Walker,L,STL,30,49,5,5,10
29,8484911,Collin Graf,R,SJS,22,41,5,5,10
29,8480844,Grigori Denisenko,L,VGK,24,32,5,5,10
29,8479972,Mason Shaw,C,WPG,26,32,5,5,10
29,8478859,Niko Mikkola,D,FLA,28,61,4,6,10
29,8479994,Jaret Anderson-Dolan,C,WPG,25,34,4,6,10
29,8482747,Brennan Othmann,L,NYR,21,42,4,6,10
29,8478211,Dryden Hunt,L,CGY,29,52,4,6,10
29,8481609,Vladislav Kolyachonok,D,UTA,23,44,4,6,10
29,8479372,Joshua Mahura,D,SEA,26,52,3,7,10
29,8479968,Vinni Lettieri,C,BOS,29,55,2,8,10
29,8478409,Anthony Richard,C,PHI,28,30,2,8,10
29,8476441,Joel Edmundson,D,LAK,31,48,2,8,10
29,8478443,Brandon Carlo,D,BOS,28,62,1,9,10
29,8476994,Vinnie Hinostroza,C,NSH,30,47,1,9,10
29,8483460,David Jiricek,D,CBJ,21,52,1,9,10
29,8476967,Brett Kulak,D,EDM,30,64,0,10,10
29,8479026,Philippe Myers,D,TOR,27,48,0,10,10
29,8481161,Jake Christiansen,D,CBJ,25,54,6,3,9
29,8478424,Jansen Harkins,C,ANA,27,49,6,3,9
29,8479986,Kole Lind,R,DAL,26,56,4,5,9
29,8482070,Mitchell Chaffee,R,TBL,26,52,4,5,9
29,8479944,Zach Aston-Reese,C,VGK,30,46,3,6,9
29,8482733,Logan Mailloux,D,MTL,31,34,3,6,9
29,8480157,Calle Rosen,D,COL,30,38,2,7,9
29,8477034,Jaycob Megna,D,FLA,32,37,2,7,9
29,8480990,Declan Chisholm,D,MIN,24,37,2,7,9
29,8474568,Luke Schenn,D,NSH,35,51,2,7,9
29,8483619,Filip Roos,D,OTT,25,33,2,7,9
29,8482496,Nils Aman,C,VAN,24,40,2,7,9
29,8476624,Barclay Goodrow,C,SJS,31,50,1,8,9
29,8479772,Zack MacEwen,R,OTT,28,51,6,2,8
29,8478178,Darren Raddysh,D,TBL,28,69,3,5,8
29,8479718,Alex Barré-Boulet,C,MTL,27,49,3,5,8
29,8482153,Brendan Brisson,C,VGK,23,37,3,5,8
29,8481147,Reese Johnson,C,MIN,26,38,3,5,8
29,8477887,Patrick Brown,C,BOS,32,42,3,5,8
29,8479981,Jonah Gadjovich,L,FLA,26,43,3,5,8
29,8478454,Noah Juulsen,D,VAN,27,36,3,5,8
29,8474013,Ian Cole,D,UTA,35,54,2,6,8
29,8474090,Brendan Smith,D,DAL,35,53,2,6,8
29,8471817,Ryan Reaves,R,TOR,37,49,2,6,8
29,8480834,Ty Emberson,D,SJS,24,30,2,6,8
29,8482634,Alex Steeves,C,TOR,25,46,1,7,8
29,8474567,Zach Bogosian,D,MIN,34,59,1,7,8
29,8478452,Caleb Jones,D,LAK,27,53,1,7,8
29,8475235,Nicolas Deslauriers,L,PHI,33,51,1,7,8
29,8475750,Jon Merrill,D,MIN,32,65,1,7,8
29,8473446,Erik Johnson,D,PHI,36,48,1,7,8
29,8477384,Joshua Brown,D,EDM,30,51,0,8,8
29,8476473,Connor Murphy,D,CHI,31,43,0,8,8
29,8479367,William Lockwood,R,FLA,26,26,6,1,7
29,8481716,Dmitri Voronkov,L,CBJ,24,33,5,2,7
29,8476858,Phillip Di Giuseppe,L,VAN,31,41,4,3,7
29,8482666,Scott Morrow,D,CAR,22,44,4,3,7
29,8481679,Maxence Guenette,D,OTT,23,39,3,4,7
29,8477482,Zachary Sanford,L,CHI,30,31,3,4,7
29,8479442,Troy Stecher,D,EDM,30,52,3,4,7
29,8481065,Angus Crookshank,L,OTT,25,21,3,4,7
29,8482177,Marat Khusnutdinov,C,MIN,22,32,3,4,7
29,8481600,Tobias Bjornfot,D,FLA,23,38,2,5,7
29,8484254,Akito Hirose,D,VAN,25,37,2,5,7
29,8481701,Santeri Hatakka,D,NJD,23,48,2,5,7
29,8479576,Vincent Desharnais,D,VAN,28,37,1,6,7
29,8475455,Brenden Dillon,D,NJD,34,61,0,7,7
29,8482861,Vincent Iorio,D,WSH,22,35,0,7,7
29,8477401,John Hayden,C,SEA,29,32,4,2,6
29,8480870,Bo Groulx,C,NYR,24,32,4,2,6
29,8475842,Sam Carrick,C,NYR,32,50,3,3,6
29,8480845,Rasmus Kupari,C,WPG,24,42,3,3,6
29,8480292,Carson Meyer,R,ANA,27,27,3,3,6
29,8471709,Marc-Edouard Vlasic,D,SJS,37,57,2,4,6
29,8481550,Adam Beckman,L,NJD,23,45,2,4,6
29,8481617,Vasily Podkolzin,R,VAN,23,39,2,4,6
29,8475762,Derek Forbort,D,VAN,32,47,2,4,6
29,8474034,Patrick Maroon,L,CHI,36,43,1,5,6
29,8480879,Jacob Bernard-Docker,D,OTT,24,44,1,5,6
29,8481598,Philip Broberg,D,EDM,23,39,1,5,6
29,8481605,Jackson LaCombe,D,ANA,23,38,1,5,6
29,8482250,Callahan Burke,C,VGK,27,24,1,5,6
29,8479348,Kale Clague,D,BUF,26,41,0,6,6
29,8480468,James Hamblin,L,EDM,25,21,5,0,5
29,8481789,Tye Kartye,L,SEA,23,40,4,1,5
29,8478874,Adam Gaudette,R,OTT,28,36,4,1,5
29,8483397,Marc McLaughlin,C,BOS,25,24,4,1,5
29,8481567,Henry Thrun,D,SJS,23,52,3,2,5
29,8483466,Kevin Korchinski,D,CHI,20,46,3,2,5
29,8475177,Calvin de Haan,D,COL,33,36,3,2,5
29,8484258,Sam Malinski,D,COL,26,20,3,2,5
29,8482145,Mavrik Bourque,C,DAL,22,44,3,2,5
29,8482859,Zack Ostapchuk,C,OTT,21,50,2,3,5
29,8482511,Mason Lohrei,D,BOS,23,32,2,3,5
29,8479991,Jake Leschyshyn,C,NYR,25,27,2,3,5
29,8480196,Jacob Bryson,D,BUF,27,30,1,4,5
29,8479985,Cale Fleury,D,SEA,26,18,1,4,5
29,8478146,Matthew Highmore,C,OTT,28,35,1,4,5
29,8482470,Ilya Solovyov,D,CGY,24,15,1,4,5
29,8481167,Brayden Pachal,D,CGY,25,32,0,5,5
29,8480880,Jakub Lauko,C,MIN,24,34,0,5,5
29,8477320,Anton Blidh,L,NYR,29,17,0,5,5
29,8482765,Isak Rosen,R,BUF,21,24,3,1,4
29,8482147,Jean-Luc Foudy,C,COL,22,24,3,1,4
29,8482094,Daemon Hunt,D,MIN,22,15,3,1,4
29,8481532,Alex Turcotte,C,LAK,23,43,2,2,4
29,8481237,Kyle MacLean,C,NYI,25,25,2,2,4
29,8482713,Mackie Samoskevich,R,FLA,22,33,2,2,4
29,8480890,Jan Jenik,C,OTT,24,25,1,3,4
29,8478021,William Lagesson,D,DET,28,26,1,3,4
29,8478017,Mark Friedman,D,VAN,29,44,1,3,4
29,8477335,Kyle Burroughs,D,LAK,29,36,1,3,4
29,8477527,Ross Johnston,L,ANA,30,40,1,3,4
29,8482858,Ryker Evans,D,SEA,23,26,1,3,4
29,8479379,Givani Smith,R,SJS,26,31,1,3,4
29,8476913,Devin Shore,C,MIN,30,31,0,4,4
29,8482516,Matthew Kessel,D,STL,24,18,0,4,4
29,8481699,Aku Raty,R,UTA,23,14,0,4,4
29,8481556,John Beecher,C,BOS,23,28,3,0,3
29,8477244,Chad Ruhwedel,D,NYR,34,26,3,0,3
29,8480032,Shane Bowers,C,NJD,25,19,3,0,3
29,8481754,Nikita Nesterenko,C,ANA,23,37,2,1,3
29,8478450,Parker Wotherspoon,D,BOS,27,31,2,1,3
29,8483512,Matthew Savoie,C,EDM,20,26,2,1,3
29,8481743,Marc Del Gaizo,D,NSH,25,24,2,1,3
29,8484287,Cole McWard,D,VAN,23,18,2,1,3
29,8471677,Jack Johnson,D,CBJ,37,72,1,2,3
29,8483630,Pavol Regenda,L,ANA,25,34,1,2,3
29,8482144,Jack Thompson,D,SJS,22,24,1,2,3
29,8477467,Gustav Olofsson,D,SEA,30,21,1,2,3
29,8477473,Justin Bailey,R,SJS,29,26,1,2,3
29,8481541,Samuel Bolduc,D,NYI,24,25,1,2,3
29,8482201,Gage Goncalves,C,TBL,23,21,1,2,3
29,8477073,Kurtis MacDermid,L,NJD,30,26,1,2,3
29,8482929,Emil Lilleberg,D,TBL,23,23,1,2,3
29,8475795,Dylan McIlrath,D,WSH,32,17,1,2,3
29,8481024,Linus Karlsson,C,VAN,25,9,1,2,3
29,8481056,Spencer Stastney,D,NSH,24,35,0,3,3
29,8479587,Rhett Gardner,C,PHI,28,15,0,3,3
29,8481122,Simon Benoit,D,TOR,26,42,0,3,3
29,8481422,Jake Lucchini,C,NSH,29,17,0,3,3
29,8477971,Andreas Englund,D,LAK,28,32,0,3,3
29,8477149,Scott Sabourin,R,SJS,32,13,0,3,3
29,8480874,Adam Ginning,D,PHI,24,11,0,3,3
29,8483012,Logan Morrison,C,SEA,22,32,2,0,2
29,8481806,Louis Crevier,D,CHI,23,13,2,0,2
29,8481719,Maxwell Crozier,D,TBL,24,18,2,0,2
29,8477993,Justin Kirkland,C,CGY,28,8,2,0,2
29,8483609,Adam Klapka,R,CGY,24,3,2,0,2
29,8481543,Nikita Alexandrov,C,STL,24,21,1,1,2
29,8482141,Lukas Cormier,D,VGK,22,22,1,1,2
29,8482102,Vasily Ponomarev,C,PIT,22,25,1,1,2
29,8478051,Max Willman,C,NJD,29,20,1,1,2
29,8475413,Justin Dowling,C,NJD,34,17,1,1,2
29,8482165,Yan Kuznetsov,D,CGY,22,16,1,1,2
29,8478477,Mitchell Stephens,C,SEA,27,25,1,1,2
29,8480851,Akil Thomas,C,LAK,24,20,1,1,2
29,8481462,Mason Morelli,L,VGK,28,7,1,1,2
29,8483763,Maksymilian Szuber,D,UTA,22,32,1,1,2
29,8475958,Michael Sgarbossa,C,WSH,32,28,1,1,2
29,8480823,Alexander Alexeyev,D,WSH,25,18,1,1,2
29,8478011,Louie Belpedio,D,PHI,28,17,1,1,2
29,8483471,Brad Lambert,C,WPG,31,5,1,1,2
29,8478502,Dennis Gilbert,D,BUF,28,29,0,2,2
29,8483570,Ben Meyers,C,SEA,26,36,0,2,2
29,8478881,Brett Seney,L,CHI,28,7,0,2,2
29,8481593,Jayden Struble,D,MTL,23,15,0,2,2
29,8479421,Jacob Moverare,D,LAK,26,10,0,2,2
29,8479638,Justin Brazeau,R,BOS,26,37,1,0,1
29,8482172,Landon Slaggert,L,CHI,22,20,1,0,1
29,8477462,Robert Hagg,D,VGK,29,25,1,0,1
29,8480084,Nick DeSimone,D,NJD,30,18,1,0,1
29,8479320,Maxime Lajoie,D,SEA,27,17,1,0,1
29,8481206,John Ludvig,D,PIT,24,18,1,0,1
29,8475755,Alexander Petrovic,D,DAL,32,7,1,0,1
29,8477810,Joel Hanley,D,CGY,33,24,1,0,1
29,8481585,Egor Afanasyev,L,SJS,23,10,1,0,1
29,8482476,Emil Heineman,L,MTL,23,7,1,0,1
29,8476323,Max McCormick,L,SEA,32,5,1,0,1
29,8481726,Adam Edstrom,C,NYR,24,6,1,0,1
29,8480267,Sammy Walker,C,MIN,25,22,1,0,1
29,8482162,Roby Jarventie,L,EDM,22,16,0,1,1
29,8482118,Sam Colangelo,R,ANA,23,6,0,1,1
29,8477541,Dakota Mermis,D,TOR,30,6,0,1,1
29,8481578,Graeme Clarke,R,MIN,23,10,0,1,1
29,8482088,Justin Sourdif,R,FLA,22,15,0,1,1
29,8474062,Riley Nash,C,NYR,35,17,0,1,1
29,8483920,Pierrick Dube,R,WSH,23,6,0,1,1
29,8481043,Cole Koepke,L,BOS,26,18,0,1,1
29,8480306,Grant Hutton,D,NYI,29,7,0,1,1
29,8478147,Bokondji Imama,L,PIT,28,4,0,1,1
29,8483432,Luca Del Bel Belluz,C,CBJ,31,4,0,1,1
29,8479419,Brett Murray,L,BUF,26,14,0,0,0
29,8482751,Ryan Winterton,C,SEA,21,30,0,0,0
29,8479330,Brandon Gignac,C,MTL,27,4,0,0,0
29,8478854,Ryan Shea,D,PIT,27,11,0,0,0
29,8481655,Cole Schwindt,R,CGY,23,6,0,0,0
29,8483398,Declan Carlile,D,TBL,31,3,0,0,0
29,8478446,Glenn Gawdin,C,LAK,27,11,0,0,0
29,8482197,Adam Raska,R,MIN,23,9,0,0,0
29,8483395,Arshdeep Bains,L,VAN,23,10,0,0,0
29,8483407,Brandon Scanlin,D,NYR,25,8,0,0,0
29,8479362,Riley Tufte,L,BOS,26,16,0,0,0
29,8475780,Chris Wagner,R,COL,33,10,0,0,0
29,8482787,Nikita Chibrikov,R,WPG,31,5,0,0,0
29,8481564,Ryan Johnson,D,BUF,23,10,0,0,0
29,8483597,Milos Kelemen,L,UTA,25,12,0,0,0
29,8481006,Tyler Tucker,D,STL,24,15,0,0,0
29,8484304,Uvis Balinskis,D,FLA,28,8,0,0,0
29,8483401,Marc Johnstone,R,PIT,28,1,0,0,0
29,8484325,Waltteri Merela,C,TBL,26,21,0,0,0
29,8482061,Brandon Biro,L,SEA,26,14,0,0,0
29,8481030,Jack St. Ivany,D,PIT,25,11,0,0,0
29,8483489,Fraser Minten,C,TOR,31,11,0,0,0
29,8483567,Georgii Merkulov,C,BOS,24,6,0,0,0
29,8484255,Jason Polin,R,COL,25,3,0,0,0
29,8478956,Samuel Laberge,L,NJD,27,0,0,0,0
29,8482460,Matt Rempe,C,NYR,22,9,0,0,0
29,8483531,Brian Halonen,L,NJD,25,4,0,0,0
29,8480075,Cameron Crotty,D,MIN,25,14,0,0,0
29,8480274,Philip Kemp,D,EDM,25,0,0,0,0
29,8483546,Marshall Rifai,D,TOR,26,10,0,0,0
29,8481534,Raphael Lavoie,C,EDM,24,2,0,0,0
29,8479522,Hardy Haman Aktell,D,WSH,26,3,0,0,0
29,8484259,Ondrej Pavel,C,COL,31,2,0,0,0
29,8484326,Patrik Koch,D,UTA,28,1,0,0,0
29,8482126,Emil Andrae,D,PHI,31,1,0,0,0
29,8484321,Nikolas Matinpalo,D,OTT,26,2,0,0,0
29,8470794,Joe Pavelski,C,,40,0,0,0,0
29,8479321,Lucas Johansen,D,,27,0,0,0,0
29,8477950,Tony DeAngelo,D,,29,0,0,0,0
29,8471218,Blake Wheeler,R,,38,0,0,0,0
29,8475197,Tyson Barrie,D,,33,0,0,0,0
29,8474157,Max Pacioretty,L,,36,0,0,0,0
29,8475744,Evgeny Kuznetsov,C,,32,0,0,0,0
29,8474037,James van Riemsdyk,L,,35,0,0,0,0
29,8476907,Mackenzie MacEachern,L,,30,0,0,0,0
29,8480216,Jacob Peterson,C,,25,0,0,0,0
29,8474602,Justin Schultz,D,,34,0,0,0,0
29,8482222,Alexander Barabanov,L,,30,0,0,0,0
29,8474031,Kevin Shattenkirk,D,,35,0,0,0,0
29,8477330,Dominik Kubalik,L,,29,0,0,0,0
29,8480884,Calen Addison,D,,24,0,0,0,0
29,8475906,John Klingberg,D,,32,0,0,0,0
29,8480008,Adam Ruzicka,C,,25,0,0,0,0
29,8476884,Derrick Pouliot,D,,30,0,0,0,0
29,8476919,Chris Tierney,C,,30,0,0,0,0
29,8479415,Michael McLeod,C,,26,0,0,0,0
29,8474870,Tyler Johnson,C,,34,0,0,0,0
29,8470604,Jeff Carter,C,,39,0,0,0,0
29,8478104,Sammy Blais,L,,28,0,0,0,0
29,8474884,Mike Hoffman,C,,35,0,0,0,0
29,8481591,Sam Poulin,R,,23,0,0,0,0
29,8471274,Alex Goligoski,D,,39,0,0,0,0
29,8476871,Tanner Pearson,L,,32,0,0,0,0
29,8476393,Nick Cousins,C,,31,0,0,0,0
29,8479977,Kailer Yamamoto,R,,26,0,0,0,0
29,8479346,Dillon Dube,C,,26,0,0,0,0
29,8480184,Gustav Lindstrom,D,,26,0,0,0,0
29,8479376,Victor Mete,D,,26,0,0,0,0
29,8473449,Kyle Okposo,R,,36,0,0,0,0
29,8481058,Jesse Ylonen,R,,25,0,0,0,0
29,8475752,Tyler Pitlick,C,,33,0,0,0,0
29,8481239,Samuel Fagemo,L,,24,0,0,0,0
29,8480821,Filip Zadina,R,,25,0,0,0,0
29,8470966,Mark Giordano,D,,41,0,0,0,0
29,8478495,Denis Gurianov,R,,27,0,0,0,0
29,8477464,Nic Petan,C,,29,0,0,0,0
29,8478099,Kevin Labanc,R,,29,0,0,0,0
29,8482241,Radim Zohorna,L,,28,0,0,0,0
29,8474040,Sam Gagner,C,,35,0,0,0,0
29,8479514,Rem Pitlick,C,,27,0,0,0,0
29,8478430,Oliver Kylington,D,,27,0,0,0,0
29,8479533,Joona Koppanen,L,,26,0,0,0,0
29,8479984,Cal Foote,D,,26,0,0,0,0
29,8477126,Jayson Megna,C,,34,0,0,0,0
29,8475164,Jakob Silfverberg,R,,34,0,0,0,0
29,8474009,Nick Bonino,C,,36,0,0,0,0
29,8479458,Nikita Zaitsev,D,,33,0,0,0,0
29,8477944,Jakub Vrana,L,,28,0,0,0,0
29,8471699,Andrew Cogliano,C,,37,0,0,0,0
29,8478067,Oskar Lindblom,L,,28,0,0,0,0
29,8471686,Marc Staal,D,,37,0,0,0,0
29,8470610,Zach Parise,L,,40,0,0,0,0
29,8478904,Steven Lorentz,C,,28,0,0,0,0
29,8473473,Milan Lucic,L,,36,0,0,0,0
29,8480031,Maxime Comtois,L,,25,0,0,0,0
29,8478512,Austin Czarnik,C,,32,0,0,0,0
29,8473504,Cal Clutterbuck,R,,37,0,0,0,0
29,8477454,Adam Erne,L,,29,0,0,0,0
29,8479383,Boris Katchouk,L,,26,0,0,0,0
29,8475825,Jani Hakanpää,D,,32,0,0,0,0
29,8477846,Ryan Carpenter,C,,33,0,0,0,0
29,8477930,Pierre-Edouard Bellemare,L,,39,0,0,0,0
29,8478400,Colin White,C,,27,0,0,0,0
29,8480226,Marián Studenic,R,,26,0,0,0,0
29,8480853,Liam Foudy,C,,24,0,0,0,0
29,8475797,Jarred Tinordi,D,,32,0,0,0,0
29,8479423,Alex Nylander,L,,26,0,0,0,0
29,8474618,Marco Scandella,D,,34,0,0,0,0
29,8478028,Fredrik Olofsson,L,,28,0,0,0,0
29,8474709,Matt Martin,L,,35,0,0,0,0
29,8481070,Hugh McGing,L,,26,0,0,0,0
29,8479546,Oskar Steen,C,,26,0,0,0,0
29,8474145,Robert Bortuzzo,D,,35,0,0,0,0
29,8476915,Jujhar Khaira,L,,30,0,0,0,0
29,8475278,Byron Froese,C,,33,0,0,0,0
29,8481812,Nikolai Knyzhov,D,,27,0,0,0,0
29,8478408,Travis Dermott,D,,28,0,0,0,0
29,8481077,John Leonard,L,,26,0,0,0,0
29,8479547,Matthew Phillips,R,,26,0,0,0,0
29,8480836,Jonathan Gruden,C,,24,0,0,0,0
29,8481690,Tyler Angle,C,,24,0,0,0,0
29,8475766,Austin Watson,L,,32,0,0,0,0
29,8481016,Ruslan Iskhakov,C,,24,0,0,0,0
29,8478078,Rourke Chartier,C,,28,0,0,0,0
29,8480776,Sheldon Rempal,R,,29,0,0,0,0
29,8483045,Cameron Butler,R,CBJ,31,1,0,0,0
29,8484314,Jiri Smejkal,L,,28,0,0,0,0
30,8478402,Connor McDavid,C,EDM,27,79,51,103,154
30,8477492,Nathan MacKinnon,C,COL,29,82,62,78,140
30,8477956,David Pastrnak,R,BOS,28,80,45,79,124
30,8476453,Nikita Kucherov,R,TBL,31,82,38,83,121
30,8479318,Auston Matthews,C,TOR,27,80,69,48,117
30,8480069,Cale Makar,D,COL,26,74,31,85,116
30,8478420,Mikko Rantanen,R,COL,28,81,57,58,115
30,8479314,Matthew Tkachuk,L,FLA,27,78,39,74,113
30,8480027,Jason Robertson,L,DAL,25,81,42,66,108
30,8478550,Artemi Panarin,L,NYR,33,79,38,69,107
30,8480023,Robert Thomas,C,STL,25,80,31,75,106
30,8478864,Kirill Kaprizov,L,MIN,27,73,39,66,105
30,8477404,Jake Guentzel,C,TBL,30,81,45,59,104
30,8478445,Mathew Barzal,C,NYI,27,80,24,80,104
30,8477934,Leon Draisaitl,C,EDM,29,80,47,54,101
30,8478483,Mitch Marner,R,TOR,27,80,29,72,101
30,8476887,Filip Forsberg,L,NSH,30,77,48,52,100
30,8477939,William Nylander,R,TOR,28,80,38,62,100
30,8478427,Sebastian Aho,C,CAR,27,74,41,58,99
30,8477946,Dylan Larkin,C,DET,28,82,32,67,99
30,8476454,Ryan Nugent-Hopkins,C,EDM,31,82,31,66,97
30,8477942,Kevin Fiala,L,LAK,28,78,28,68,96
30,8478010,Brayden Point,C,TBL,28,82,52,42,94
30,8481559,Jack Hughes,C,NJD,23,72,44,50,94
30,8477493,Aleksander Barkov,C,FLA,29,80,25,68,93
30,8477409,Carter Verhaeghe,C,FLA,29,76,46,46,92
30,8476468,J.T. Miller,C,VAN,31,75,33,58,91
30,8478403,Jack Eichel,C,VGK,28,74,40,50,90
30,8477949,Alex Tuch,R,BUF,28,72,38,52,90
30,8475913,Mark Stone,R,VGK,32,79,26,60,86
30,8479407,Jesper Bratt,L,NJD,26,75,23,63,86
30,8477933,Sam Reinhart,C,FLA,29,75,42,43,85
30,8479343,Clayton Keller,R,UTA,26,77,32,52,84
30,8477501,Valeri Nichushkin,R,COL,29,82,43,40,83
30,8479385,Jordan Kyrou,C,STL,26,80,36,46,82
30,8478444,Brock Boeser,R,VAN,27,75,35,46,81
30,8475184,Chris Kreider,L,NYR,33,73,34,46,80
30,8471675,Sidney Crosby,C,PIT,37,71,46,33,79
30,8480830,Andrei Svechnikov,R,CAR,24,71,35,44,79
30,8482116,Tim Stützle,C,OTT,22,79,31,48,79
30,8480839,Rasmus Dahlin,D,BUF,24,73,21,58,79
30,8480012,Elias Pettersson,C,VAN,26,78,33,45,78
30,8471685,Anze Kopitar,C,LAK,37,79,32,46,78
30,8480800,Quinn Hughes,D,VAN,25,74,11,66,77
30,8476460,Mark Scheifele,C,WPG,31,76,33,43,76
30,8475166,John Tavares,C,TOR,34,79,36,39,75
30,8480018,Nick Suzuki,C,MTL,25,73,30,45,75
30,8475172,Nazem Kadri,C,CGY,34,79,26,49,75
30,8476459,Mika Zibanejad,C,NYR,31,74,25,50,75
30,8480036,Miro Heiskanen,D,DAL,25,77,16,59,75
30,8476389,Vincent Trocheck,C,NYR,31,77,39,35,74
30,8474564,Steven Stamkos,C,NSH,34,73,30,44,74
30,8484144,Connor Bedard,C,CHI,19,69,25,49,74
30,8478873,Troy Terry,R,ANA,27,77,24,50,74
30,8481557,Matt Boldy,L,MIN,23,71,36,37,73
30,8475168,Matt Duchene,C,DAL,33,81,30,43,73
30,8474141,Patrick Kane,R,DET,36,80,26,47,73
30,8475692,Mats Zuccarello,R,MIN,37,70,25,48,73
30,8476456,Jonathan Huberdeau,C,CGY,31,79,19,54,73
30,8478398,Kyle Connor,L,WPG,28,77,37,35,72
30,8478449,Roope Hintz,C,DAL,28,81,35,37,72
30,8475786,Zach Hyman,L,EDM,32,78,34,37,71
30,8473419,Brad Marchand,L,BOS,36,79,28,43,71
30,8471215,Evgeni Malkin,C,PIT,38,72,34,36,70
30,8480865,Noah Dobson,D,NYI,24,82,12,58,70
30,8477940,Nikolaj Ehlers,L,WPG,28,75,24,45,69
30,8479420,Tage Thompson,C,BUF,27,71,31,37,68
30,8480002,Nico Hischier,C,NJD,25,76,31,37,68
30,8479323,Adam Fox,D,NYR,26,73,11,57,68
30,8479337,Alex DeBrincat,R,DET,27,81,36,31,67
30,8476346,Johnny Gaudreau,L,CBJ,31,71,17,50,67
30,8476853,Morgan Rielly,D,TOR,30,71,14,53,67
30,8475754,Brock Nelson,C,NYI,33,80,29,37,66
30,8480015,Owen Tippett,R,PHI,25,77,28,38,66
30,8478439,Travis Konecny,R,PHI,27,76,33,32,65
30,8473512,Claude Giroux,R,OTT,36,79,28,37,65
30,8478414,Timo Meier,R,NJD,28,75,25,40,65
30,8483431,Logan Cooley,C,UTA,20,78,23,42,65
30,8477951,Nick Schmaltz,C,UTA,28,76,22,43,65
30,8475167,Victor Hedman,D,TBL,34,80,13,52,65
30,8475794,Tyler Seguin,C,DAL,32,80,30,34,64
30,8480801,Brady Tkachuk,L,OTT,25,82,29,35,64
30,8481528,Dylan Cozens,C,BUF,23,72,28,36,64
30,8477456,J.T. Compher,L,DET,29,81,27,37,64
30,8482684,Luke Hughes,D,NJD,21,74,13,51,64
30,8471214,Alex Ovechkin,L,WSH,39,69,29,34,63
30,8476448,William Karlsson,C,VGK,31,76,22,41,63
30,8478407,Vince Dunn,D,SEA,28,74,13,50,63
30,8477955,Jared McCann,L,SEA,28,72,23,39,62
30,8478975,Mason Marchment,L,DAL,29,82,21,41,62
30,8477960,Adrian Kempe,R,LAK,28,82,35,26,61
30,8476539,Jonathan Marchessault,R,NSH,34,73,35,26,61
30,8477496,Elias Lindholm,C,BOS,30,79,26,35,61
30,8482699,Dylan Guenther,R,UTA,21,77,26,35,61
30,8479542,Brandon Hagel,L,TBL,26,82,24,37,61
30,8478460,Zach Werenski,D,CBJ,27,78,22,39,61
30,8474600,Roman Josi,D,NSH,34,74,13,48,61
30,8477402,Pavel Buchnevich,L,STL,29,77,26,34,60
30,8480208,Drake Batherson,R,OTT,26,81,22,38,60
30,8479325,Charlie McAvoy,D,BOS,27,79,11,49,60
30,8482093,Seth Jarvis,C,CAR,22,74,31,28,59
30,8475810,Bryan Rust,R,PIT,32,71,30,29,59
30,8482740,Wyatt Johnston,C,DAL,21,81,27,32,59
30,8478440,Dylan Strome,C,WSH,27,77,24,35,59
30,8474578,Erik Karlsson,D,PIT,34,79,13,46,59
30,8477416,Oliver Bjorkstrand,R,SEA,29,70,22,36,58
30,8479410,Mikhail Sergachev,D,UTA,26,68,10,48,58
30,8477935,Sam Bennett,C,FLA,28,75,25,32,57
30,8475170,Brayden Schenn,C,STL,33,77,20,37,57
30,8476881,Tomas Hertl,C,VGK,31,77,28,28,56
30,8475169,Evander Kane,L,EDM,33,76,28,28,56
30,8482702,Logan Stankoven,C,DAL,21,81,26,30,56
30,8473994,Jamie Benn,L,DAL,35,81,20,36,56
30,8479999,Casey Mittelstadt,C,COL,26,81,17,39,56
30,8474679,Gustav Nyquist,C,NSH,35,73,17,39,56
30,8475798,Mikael Granlund,C,SJS,32,71,14,42,56
30,8479675,Trevor Moore,L,LAK,29,80,26,29,55
30,8481540,Cole Caufield,R,MTL,23,76,23,32,55
30,8471724,Kris Letang,D,PIT,37,77,11,44,55
30,8477447,Shea Theodore,D,VGK,29,68,10,45,55
30,8481542,Moritz Seider,D,DET,23,77,8,47,55
30,8482078,Lucas Raymond,L,DET,22,81,26,28,54
30,8482665,Matty Beniers,C,SEA,22,74,24,30,54
30,8475784,Jeff Skinner,C,EDM,32,77,22,32,54
30,8480028,Morgan Frost,C,PHI,25,77,20,34,54
30,8478366,Frank Vatrano,R,ANA,30,72,33,20,53
30,8482175,JJ Peterka,R,BUF,22,66,33,20,53
30,8476399,Blake Coleman,C,CGY,33,76,28,25,53
30,8483515,Juraj Slafkovsky,L,MTL,20,75,25,28,53
30,8478401,Pavel Zacha,C,BOS,27,77,15,38,53
30,8479400,Pierre-Luc Dubois,L,WSH,26,68,23,29,52
30,8475158,Ryan O'Reilly,C,NSH,33,69,22,30,52
30,8478519,Anthony Cirelli,C,TBL,27,82,21,31,52
30,8476479,Phillip Danault,C,LAK,31,79,20,32,52
30,8482124,Quinton Byfield,R,LAK,22,79,17,35,52
30,8477494,Jonathan Drouin,L,COL,29,79,15,37,52
30,8480803,Evan Bouchard,D,EDM,25,79,13,39,52
30,8478474,Lawson Crouse,L,UTA,27,75,30,21,51
30,8475726,Tyler Toffoli,C,SJS,32,64,24,27,51
30,8477504,Josh Morrissey,D,WPG,29,74,20,31,51
30,8480798,Philipp Kurashev,C,CHI,25,63,20,31,51
30,8477500,Bo Horvat,C,NYI,29,79,32,18,50
30,8482113,Anton Lundell,C,FLA,23,78,26,24,50
30,8474641,Adam Henrique,C,EDM,34,72,25,25,50
30,8483808,Andrei Kuzmenko,L,CGY,28,77,19,31,50
30,8478042,Viktor Arvidsson,L,EDM,31,70,18,32,50
30,8474102,David Perron,L,OTT,36,78,16,34,50
30,8475745,Charlie Coyle,C,BOS,32,75,14,36,50
30,8476905,Chandler Stephenson,C,SEA,30,74,11,39,50
30,8476792,Torey Krug,D,STL,33,73,8,42,50
30,8480014,Gabriel Vilardi,C,WPG,25,71,29,20,49
30,8475151,Kyle Palmieri,C,NYI,33,78,28,21,49
30,8477503,Max Domi,C,TOR,29,78,15,34,49
30,8478493,Joel Eriksson Ek,C,MIN,27,64,19,29,48
30,8481581,Thomas Harley,D,DAL,23,73,11,37,48
30,8477346,MacKenzie Weegar,D,CGY,30,75,11,37,48
30,8480185,Eetu Luostarinen,C,FLA,26,76,21,26,47
30,8478856,Conor Garland,R,VAN,28,72,19,28,47
30,8477511,Anthony Mantha,R,CGY,30,76,19,28,47
30,8480188,Fabian Zetterlund,L,SJS,25,72,19,28,47
30,8477497,Sean Monahan,C,CBJ,30,71,15,32,47
30,8476906,Shayne Gostisbehere,D,CAR,31,73,11,36,47
30,8474590,John Carlson,D,WSH,34,71,8,39,47
30,8477964,Ivan Barbashev,C,VGK,29,75,25,21,46
30,8475763,Kevin Hayes,R,PIT,32,70,22,24,46
30,8476483,Rickard Rakell,R,PIT,31,61,20,26,46
30,8477998,Warren Foegele,L,LAK,28,79,20,26,46
30,8470613,Brent Burns,D,CAR,39,79,17,29,46
30,8481596,Shane Pinto,C,OTT,24,72,15,31,46
30,8480039,Martin Necas,C,CAR,25,63,12,34,46
30,8476875,Mike Matheson,D,MTL,30,76,7,39,46
30,8481068,Yegor Sharangovich,C,CGY,26,77,22,23,45
30,8482745,Mason McTavish,C,ANA,21,74,22,23,45
30,8480064,Josh Norris,C,OTT,25,73,22,23,45
30,8475793,Ryan Johansen,C,PHI,32,72,20,25,45
30,8482667,William Eklund,L,SJS,22,69,18,27,45
30,8475765,Vladimir Tarasenko,R,DET,33,79,15,30,45
30,8482097,Jack Quinn,R,BUF,23,61,13,32,45
30,8478498,Jake DeBrusk,L,VAN,28,72,22,22,44
30,8477407,Anthony Duclair,L,NYI,29,77,21,23,44
30,8481533,Trevor Zegras,C,ANA,23,75,19,25,44
30,8475799,Nino Niederreiter,R,WPG,32,68,18,26,44
30,8479992,Michael Rasmussen,C,DET,25,79,19,24,43
30,8481711,Matias Maccelli,L,UTA,24,72,18,25,43
30,8478396,Noah Hanifin,D,VGK,27,57,18,25,43
30,8474716,Jared Spurgeon,D,MIN,35,74,13,30,43
30,8478397,Rasmus Andersson,D,CGY,28,76,12,31,43
30,8478458,John (Jack) Roslovic,C,CAR,27,71,12,31,43
30,8482110,Dawson Mercer,C,NJD,23,71,21,21,42
30,8477444,Andre Burakovsky,L,SEA,29,73,20,22,42
30,8478472,Mathieu Joseph,R,STL,27,71,19,23,42
30,8478233,Andrew Mangiapane,L,WSH,28,71,18,24,42
30,8478438,Tommy Novak,C,NSH,27,71,16,26,42
30,8477476,Artturi Lehkonen,L,COL,29,80,15,27,42
30,8482720,Matthew Knies,L,TOR,22,72,15,27,42
30,8476462,Dougie Hamilton,D,NJD,31,71,14,28,42
30,8478542,Evan Rodrigues,C,FLA,31,77,13,29,42
30,8478469,Thomas Chabot,D,OTT,27,71,11,31,42
30,8478462,Nicolas Roy,C,VGK,27,76,11,31,42
30,8479425,Filip Hronek,D,VAN,27,75,6,36,42
30,8473422,Nick Foligno,L,CHI,37,64,23,18,41
30,8480829,Jesperi Kotkaniemi,C,CAR,24,65,21,20,41
30,8479293,Brandon Tanev,L,SEA,33,65,20,21,41
30,8473986,Alex Killorn,L,ANA,35,68,18,23,41
30,8477479,Tyler Bertuzzi,L,CHI,29,67,18,23,41
30,8481604,Pavel Dorofeyev,L,VGK,24,71,18,23,41
30,8484166,Adam Fantilli,C,CBJ,20,69,16,25,41
30,8482105,Jake Sanderson,D,OTT,22,77,14,27,41
30,8477932,Aaron Ekblad,D,FLA,28,71,11,30,41
30,8477495,Seth Jones,D,CHI,30,70,10,31,41
30,8478046,Danton Heinen,L,VAN,29,75,20,20,40
30,8479525,Ross Colton,C,COL,28,81,20,20,40
30,8480459,Pius Suter,C,VAN,28,73,19,21,40
30,8474586,Jordan Eberle,R,SEA,34,73,18,22,40
30,8483505,Matthew Poitras,C,BOS,20,77,18,22,40
30,8479987,Morgan Geekie,C,BOS,26,78,17,23,40
30,8471698,T.J. Oshie,R,WSH,38,62,16,24,40
30,8477986,Brandon Montour,D,SEA,30,74,15,25,40
30,8484145,Zach Benson,L,BUF,19,67,15,25,40
30,8480220,Noah Cates,L,PHI,25,76,13,27,40
30,8475218,Mattias Ekholm,D,EDM,34,76,13,27,40
30,8478047,Michael Bunting,L,PIT,29,71,18,21,39
30,8482159,Tyson Foerster,R,PHI,22,76,18,21,39
30,8481560,Arthur Kaliyev,R,LAK,23,78,17,22,39
30,8479591,Michael Eyssimont,C,TBL,28,80,17,22,39
30,8478466,Daniel Sprong,R,VAN,27,78,17,22,39
30,8475760,Nick Bjugstad,C,UTA,32,73,16,23,39
30,8477505,Alexander Wennberg,C,SJS,30,61,16,23,39
30,8476880,Tom Wilson,R,WSH,30,73,15,24,39
30,8479345,Jakob Chychrun,D,WSH,26,63,11,28,39
30,8484153,Leo Carlsson,C,ANA,20,69,10,29,39
30,8477948,Travis Sanheim,D,PHI,28,67,8,31,39
30,8478038,Devon Toews,D,COL,30,69,6,33,39
30,8476432,Boone Jenner,C,CBJ,31,69,23,15,38
30,8480849,Barrett Hayton,C,UTA,24,71,18,20,38
30,8479365,Trent Frederic,C,BOS,26,75,15,23,38
30,8476869,Brady Skjei,D,NSH,30,72,12,26,38
30,8478055,Gustav Forsling,D,FLA,28,75,11,27,38
30,8480871,Adam Boqvist,D,FLA,24,69,9,29,38
30,8482089,Jake Neighbours,L,STL,22,63,24,13,37
30,8476826,Yanni Gourde,C,SEA,33,74,19,18,37
30,8476461,Sean Couturier,C,PHI,32,67,18,19,37
30,8476882,Teuvo Teravainen,C,CHI,30,58,18,19,37
30,8482109,Alexis Lafrenière,L,NYR,23,74,17,20,37
30,8475191,Reilly Smith,R,NYR,33,70,17,20,37
30,8479353,Brett Howden,C,VGK,26,76,17,20,37
30,8480113,Alex Iafallo,L,WPG,31,70,14,23,37
30,8476419,Jean-Gabriel Pageau,C,NYI,32,78,13,24,37
30,8476872,Scott Laughton,C,PHI,30,76,12,25,37
30,8481524,Bowen Byram,D,BUF,23,65,12,25,37
30,8480797,Joel Farabee,L,PHI,24,70,10,27,37
30,8474563,Drew Doughty,D,LAK,35,72,10,27,37
30,8476923,Damon Severson,D,CBJ,30,81,7,30,37
30,8481606,Jordan Spence,D,LAK,23,69,6,31,37
30,8480009,Eeli Tolvanen,R,SEA,25,73,26,10,36
30,8476438,Brandon Saad,L,STL,32,72,20,16,36
30,8482125,Alexander Holtz,R,VGK,22,70,19,17,36
30,8477451,Ryan Hartman,R,MIN,30,69,18,18,36
30,8475314,Anders Lee,L,NYI,34,79,16,20,36
30,8481656,Aliaksei Protas,C,WSH,23,63,15,21,36
30,8477429,Andrew Copp,C,DET,30,81,14,22,36
30,8481618,Alex Newhook,C,MTL,23,69,13,23,36
30,8477021,Alex Kerfoot,C,UTA,30,71,8,28,36
30,8481703,Valtteri Puustinen,R,PIT,25,63,6,30,36
30,8476463,Jonas Brodin,D,MIN,31,78,4,32,36
30,8474149,Evgenii Dadonov,R,DAL,35,80,18,17,35
30,8481554,Kaapo Kakko,R,NYR,23,76,17,18,35
30,8478115,Pierre Engvall,L,NYI,28,75,16,19,35
30,8478013,Jake Walman,D,SJS,28,71,15,20,35
30,8474053,Logan Couture,C,SJS,35,57,14,21,35
30,8476292,Ondrej Palat,L,NJD,33,66,12,23,35
30,8480068,Ryan Poehling,C,PHI,25,70,9,26,35
30,8481535,Nils Hoglander,L,VAN,24,59,17,17,34
30,8475287,Erik Haula,L,NJD,33,71,16,18,34
30,8473533,Jordan Staal,C,CAR,36,64,13,21,34
30,8482146,Luke Evangelista,R,NSH,22,68,12,22,34
30,8482055,Drew O'Connor,L,PIT,26,71,21,12,33
30,8482133,Thomas Bordeleau,C,SJS,22,60,14,19,33
30,8482149,Cole Perfetti,C,WPG,22,63,12,21,33
30,8481624,Ilya Mikheyev,R,CHI,30,62,12,21,33
30,8480434,Sean Durzi,D,UTA,26,64,9,24,33
30,8475764,Cam Fowler,D,ANA,33,77,6,27,33
30,8483490,Pavel Mintyukov,D,ANA,21,74,6,27,33
30,8476958,Jaccob Slavin,D,CAR,30,71,3,30,33
30,8477952,Robby Fabbri,C,ANA,28,67,14,18,32
30,8483493,Frank Nazar,C,CHI,20,63,14,18,32
30,8475149,Marcus Johansson,L,MIN,34,71,13,19,32
30,8480336,Sean Walker,D,CAR,30,77,13,19,32
30,8477425,Miles Wood,L,COL,29,76,11,21,32
30,8484203,Bradly Nadeau,L,CAR,19,61,11,21,32
30,8475768,Jaden Schwartz,C,SEA,32,75,9,23,32
30,8478891,Mason Appleton,C,WPG,28,61,6,26,32
30,8476921,Jordan Martinook,L,CAR,32,55,14,17,31
30,8474150,Mikael Backlund,C,CGY,35,78,13,18,31
30,8481523,Kirby Dach,C,MTL,23,67,13,18,31
30,8479661,Tanner Jeannot,L,LAK,27,75,13,18,31
30,8479351,Sam Steel,C,DAL,26,82,11,20,31
30,8480855,Jack McBain,C,UTA,24,70,11,20,31
30,8475753,Justin Faulk,D,STL,32,73,7,24,31
30,8477969,Marcus Pettersson,D,PIT,28,80,6,25,31
30,8479976,Juuso Valimaki,D,UTA,26,66,6,25,31
30,8479398,Samuel Girard,D,COL,26,65,5,26,31
30,8478500,Ivan Provorov,D,CBJ,27,74,1,30,31
30,8480893,Kirill Marchenko,R,CBJ,24,60,17,13,30
30,8477426,Nicholas Paul,L,TBL,29,81,15,15,30
30,8474189,Lars Eller,C,PIT,35,63,14,16,30
30,8482092,Ridly Greig,C,OTT,22,76,13,17,30
30,8476458,Ryan Strome,C,ANA,31,70,13,17,30
30,8481186,Logan O'Connor,R,COL,28,76,13,17,30
30,8481553,Bobby Brink,R,PHI,23,62,12,18,30
30,8478413,Jordan Greenway,L,BUF,27,68,12,18,30
30,8475791,Taylor Hall,L,CHI,33,59,11,19,30
30,8481577,Philip Tomasino,C,NSH,23,67,10,20,30
30,8478911,Matt Roy,D,WSH,29,68,10,20,30
30,8475722,Jason Zucker,L,BUF,32,70,8,22,30
30,8480145,Neal Pionk,D,WPG,29,70,6,24,30
30,8479316,Luke Kunin,C,SJS,27,63,15,14,29
30,8476392,Adam Lowry,C,WPG,31,60,14,15,29
30,8482475,Yegor Chinakhov,R,CBJ,23,65,14,15,29
30,8475848,Brendan Gallagher,R,MTL,32,67,14,15,29
30,8475193,Tomas Tatar,L,NJD,34,63,13,16,29
30,8477498,Darnell Nurse,D,EDM,29,67,11,18,29
30,8482660,Kent Johnson,C,CBJ,22,60,10,19,29
30,8480817,K'Andre Miller,D,NYR,24,70,7,22,29
30,8475181,Nick Leddy,D,STL,33,71,7,22,29
30,8481014,Alexander Romanov,D,NYI,24,79,7,22,29
30,8476902,Esa Lindell,D,DAL,30,74,4,25,29
30,8482705,Cole Sillinger,C,CBJ,21,65,15,13,28
30,8475714,Calle Jarnkrok,C,TOR,33,75,13,15,28
30,8476480,Vladislav Namestnikov,C,WPG,32,62,11,17,28
30,8476927,Teddy Blueger,C,VAN,30,64,10,18,28
30,8479980,Nicolas Hague,D,VGK,26,63,7,21,28
30,8475200,Dmitry Orlov,D,CAR,33,72,6,22,28
30,8478133,Jake Evans,C,MTL,28,74,5,23,28
30,8476892,Colton Parayko,D,STL,31,67,3,25,28
30,8482079,Marco Rossi,C,MIN,23,59,18,9,27
30,8479368,Max Jones,L,BOS,26,64,15,12,27
30,8482117,Lukas Reichel,L,CHI,22,59,14,13,27
30,8476278,Colin Blackwell,C,DAL,31,78,12,15,27
30,8477953,Kasperi Kapanen,R,STL,28,62,12,15,27
30,8477450,Jason Dickinson,C,CHI,29,54,12,15,27
30,8480144,David Kampf,C,TOR,29,70,11,16,27
30,8477507,Nikita Zadorov,D,BOS,29,68,10,17,27
30,8477947,Sonny Milano,L,WSH,28,64,10,17,27
30,8474565,Alex Pietrangelo,D,VGK,34,59,9,18,27
30,8478463,Anthony Beauvillier,L,PIT,27,67,9,18,27
30,8478109,Victor Olofsson,L,VGK,29,70,9,18,27
30,8481481,Blake Lizotte,C,PIT,27,70,8,19,27
30,8482712,Oskar Olausson,R,COL,22,74,7,20,27
30,8477506,Ryan Pulock,D,NYI,30,82,7,20,27
30,8473507,Jeff Petry,D,DET,37,74,7,20,27
30,8476879,Cody Ceci,D,EDM,31,68,5,22,27
30,8476918,Jimmy Vesey,L,NYR,31,65,15,11,26
30,8474715,Cameron Atkinson,R,TBL,35,81,15,11,26
30,8482074,Connor Zary,C,CGY,23,59,14,12,26
30,8477987,Ryan Donato,C,CHI,28,59,12,14,26
30,8476474,Stefan Noesen,R,NJD,31,71,12,14,26
30,8482101,Danil Gushchin,L,SJS,22,63,12,14,26
30,8477380,Jonny Brodzinski,C,NYR,31,54,10,16,26
30,8477478,William Carrier,L,CAR,30,61,9,17,26
30,8479315,Joey Anderson,R,CHI,26,46,9,17,26
30,8476885,Jacob Trouba,D,NYR,30,70,6,20,26
30,8476854,Hampus Lindholm,D,BOS,30,71,6,20,26
30,8476917,Adam Pelech,D,NYI,30,78,2,24,26
30,8478507,John Marino,D,UTA,27,63,2,24,26
30,8481582,Nicholas Robertson,L,TOR,23,67,14,11,25
30,8482737,Zack Bolduc,C,STL,21,54,13,12,25
30,8481580,Connor McMichael,C,WSH,23,56,12,13,25
30,8480748,Kiefer Sherwood,L,VAN,29,62,10,15,25
30,8480835,Jack Drury,C,CAR,24,63,10,15,25
30,8482624,Daniil Miromanov,D,CGY,27,66,9,16,25
30,8478057,Dakota Joshua,C,VAN,28,62,9,16,25
30,8475220,Marcus Foligno,L,MIN,33,65,8,17,25
30,8477839,Conor Sheary,L,TBL,32,82,7,18,25
30,8478970,Jalen Chatfield,D,CAR,28,70,5,20,25
30,8477435,Ryan Graves,D,PIT,29,74,5,20,25
30,8482122,Brock Faber,D,MIN,22,77,4,21,25
30,8479998,Mikey Anderson,D,LAK,25,64,3,22,25
30,8476981,Josh Anderson,R,MTL,30,68,16,8,24
30,8478043,Sam Lafferty,C,BUF,29,66,12,12,24
30,8480078,Filip Chytil,C,NYR,25,64,11,13,24
30,8478508,Yakov Trenin,C,MIN,27,55,11,13,24
30,8475171,Oliver Ekman-Larsson,D,TOR,33,64,5,19,24
30,8480891,Michael Kesselring,D,UTA,24,69,5,19,24
30,8483457,Lane Hutson,D,MTL,20,68,5,19,24
30,8479339,Patrik Laine,L,CBJ,26,63,16,7,23
30,8480813,Joe Veleno,C,DET,24,80,16,7,23
30,8479619,Michael Carcone,L,UTA,28,64,16,7,23
30,8477989,Christian Dvorak,C,MTL,28,60,9,14,23
30,8478020,Michael Amadio,R,OTT,28,73,8,15,23
30,8470621,Corey Perry,R,EDM,39,75,8,15,23
30,8482111,Justin Barron,D,MTL,23,69,8,15,23
30,8482087,Kaiden Guhle,D,MTL,22,64,7,16,23
30,8480035,Henri Jokiharju,D,BUF,25,59,5,18,23
30,8480860,Kevin Bahl,D,CGY,24,57,4,19,23
30,8476457,Adam Larsson,D,SEA,32,67,3,20,23
30,8480878,Nils Lundkvist,D,DAL,24,69,2,21,23
30,8479336,Carl Grundstrom,R,SJS,27,51,13,9,22
30,8482077,Dylan Holloway,L,EDM,23,53,13,9,22
30,8482749,Joshua Roy,R,MTL,21,62,12,10,22
30,8483524,Shane Wright,C,SEA,20,62,11,11,22
30,8475231,Casey Cizikas,C,NYI,33,74,11,11,22
30,8476469,Joel Armia,R,MTL,31,69,10,12,22
30,8478882,Vladislav Gavrikov,D,LAK,29,67,8,14,22
30,8476467,Jamie Oleksiak,D,SEA,32,64,8,14,22
30,8479066,Ryan Lomberg,L,CGY,30,62,8,14,22
30,8481522,Peyton Krebs,C,BUF,23,57,7,15,22
30,8481477,Nico Sturm,C,SJS,29,53,7,15,22
30,8482067,Connor Mackey,D,NYR,28,59,6,16,22
30,8478416,Erik Cernak,D,TBL,27,73,4,18,22
30,8477018,Ben Hutton,D,VGK,31,51,4,18,22
30,8481019,David Gustafsson,C,WPG,24,47,3,19,22
30,8474151,Ryan McDonagh,D,TBL,35,72,2,20,22
30,8476891,Matthew Grzelcyk,D,PIT,30,75,2,20,22
30,8483468,Jiri Kulich,C,BUF,20,64,9,12,21
30,8482671,Owen Power,D,BUF,22,63,8,13,21
30,8479941,Justin Danforth,R,CBJ,31,62,8,13,21
30,8479390,Taylor Raddysh,R,WSH,26,67,8,13,21
30,8477220,Nate Schmidt,D,FLA,33,60,8,13,21
30,8479983,Mario Ferraro,D,SJS,26,66,8,13,21
30,8476889,Radek Faksa,C,STL,30,56,6,15,21
30,8483445,Cutter Gauthier,L,ANA,20,69,6,15,21
30,8479324,Ryan Lindgren,D,NYR,26,64,5,16,21
30,8477919,Frederick Gaudreau,C,MIN,31,64,5,16,21
30,8476925,Colton Sissons,C,NSH,31,69,4,17,21
30,8483466,Kevin Korchinski,D,CHI,20,55,4,17,21
30,8477488,Brett Pesce,D,NJD,30,70,3,18,21
30,8476979,Erik Gustafsson,D,DET,32,72,2,19,21
30,8480043,Timothy Liljegren,D,TOR,25,63,2,19,21
30,8481598,Philip Broberg,D,EDM,23,41,2,19,21
30,8475462,Radko Gudas,D,ANA,34,59,1,20,21
30,8480222,Sebastian Aho,D,PIT,28,71,1,20,21
30,8478178,Darren Raddysh,D,TBL,28,73,1,20,21
30,8481601,Simon Holmstrom,R,NYI,23,67,13,7,20
30,8480980,Connor Dewar,C,TOR,25,66,12,8,20
30,8480802,Ryan McLeod,C,BUF,25,57,11,9,20
30,8480074,Alexandre Texier,C,STL,25,59,10,10,20
30,8482142,Jamie Drysdale,D,PHI,22,65,9,11,20
30,8482809,Jackson Blake,R,CAR,21,56,8,12,20
30,8478432,Christian Fischer,R,DET,27,72,8,12,20
30,8477392,Hudson Fasching,R,NYI,29,64,8,12,20
30,8479370,Tyson Jost,C,CAR,26,52,7,13,20
30,8481521,Ronnie Attard,D,PHI,25,55,5,15,20
30,8476312,Josh Manson,D,COL,33,63,5,15,20
30,8482655,Janis Moser,D,TBL,24,76,4,16,20
30,8480073,Erik Brannstrom,D,COL,25,62,4,16,20
30,8479369,Andrew Peeke,D,BOS,26,60,4,16,20
30,8481568,Alex Vlasic,D,CHI,23,61,2,18,20
30,8474673,TJ Brodie,D,CHI,34,60,2,18,20
30,8480289,Morgan Barron,C,WPG,26,53,10,9,19
30,8479414,Nathan Bastian,R,NJD,27,58,9,10,19
30,8479996,Cody Glass,C,NSH,25,64,8,11,19
30,8479344,Jesse Puljujarvi,R,PIT,26,47,8,11,19
30,8480205,Emil Bemstrom,C,PIT,25,57,7,12,19
30,8483499,Liam Ohgren,L,MIN,20,46,7,12,19
30,8475343,Nic Dowd,C,WSH,34,61,6,13,19
30,8478569,Noel Acciari,C,PIT,33,56,5,14,19
30,8479402,Jake Bean,D,CGY,26,71,5,14,19
30,8475188,Brayden McNabb,D,VGK,33,64,5,14,19
30,8479639,Dylan Coghlan,D,WPG,26,59,5,14,19
30,8476331,Dylan DeMelo,D,WPG,31,72,4,15,19
30,8476422,Mike Reilly,D,NYI,31,75,4,15,19
30,8482245,Artem Zub,D,OTT,29,66,3,16,19
30,8478851,Alexandre Carrier,D,NSH,28,63,2,17,19
30,8482155,Alex Laferriere,R,LAK,23,70,15,3,18
30,8476994,Vinnie Hinostroza,C,NSH,30,57,11,7,18
30,8480448,Parker Kelly,L,COL,25,76,10,8,18
30,8482259,Bobby McMann,C,TOR,28,59,10,8,18
30,8481028,Martin Pospisil,C,CGY,25,54,9,9,18
30,8476960,Andreas Athanasiou,C,CHI,30,48,9,9,18
30,8481592,Jakob Pelletier,L,CGY,23,43,9,9,18
30,8481093,Rafael Harvey-Pinard,L,MTL,25,59,6,12,18
30,8478434,Keegan Kolesar,R,VGK,27,65,6,12,18
30,8480003,Jesper Boqvist,C,FLA,26,68,5,13,18
30,8473563,Nicklas Backstrom,C,WSH,37,59,5,13,18
30,8477931,Tomas Nosek,L,FLA,32,60,5,13,18
30,8480762,Eric Robinson,L,CAR,29,59,9,8,17
30,8477353,Tyler Motte,C,DET,29,65,9,8,17
30,8481032,Paul Cotter,C,NJD,25,64,7,10,17
30,8477508,Curtis Lazar,C,NJD,29,61,7,10,17
30,8478211,Dryden Hunt,L,CGY,29,56,7,10,17
30,8478443,Brandon Carlo,D,BOS,28,62,7,10,17
30,8476897,Oskar Sundqvist,C,STL,30,70,6,11,17
30,8480021,Jack Studnicka,C,LAK,25,63,6,11,17
30,8481546,Cam York,D,PHI,23,66,5,12,17
30,8481599,Victor Soderstrom,D,UTA,23,48,5,12,17
30,8475855,Jesper Fast,R,CAR,33,57,4,13,17
30,8480049,Dylan Samberg,D,WPG,25,71,4,13,17
30,8482166,Shakir Mukhamadullin,D,SJS,22,61,4,13,17
30,8482634,Alex Steeves,C,TOR,25,44,4,13,17
30,8481441,Joe Snively,C,DET,28,67,3,14,17
30,8480001,Urho Vaakanainen,D,ANA,25,62,3,14,17
30,8479982,Conor Timmins,D,TOR,26,67,2,15,17
30,8480807,Mattias Samuelsson,D,BUF,24,59,2,15,17
30,8476525,Colin Miller,D,WPG,32,64,1,16,17
30,8480172,Jan Rutta,D,SJS,34,66,1,16,17
30,8477845,Trevor van Riemsdyk,D,WSH,33,63,1,16,17
30,8482762,Simon Edvinsson,D,DET,21,59,12,4,16
30,8479393,Noah Gregor,L,OTT,26,73,10,6,16
30,8482659,Josh Doan,R,UTA,22,46,10,6,16
30,8482157,Will Cuylle,L,NYR,22,62,9,7,16
30,8476374,Sean Kuraly,C,CBJ,31,61,9,7,16
30,8481704,Juuso Parssinen,C,NSH,23,56,9,7,16
30,8480848,Ty Dellandrea,C,SJS,24,42,9,7,16
30,8483482,Tristan Luneau,D,ANA,20,61,8,8,16
30,8484149,Gavin Brindley,C,CBJ,20,52,7,9,16
30,8477015,Connor Brown,R,EDM,30,67,6,10,16
30,8482679,Matt Coronato,R,CGY,22,64,6,10,16
30,8475225,Craig Smith,C,CHI,35,52,3,13,16
30,8481527,Kaedan Korczak,D,VGK,23,47,3,13,16
30,8482730,Brandt Clarke,D,LAK,21,46,3,13,16
30,8475455,Brenden Dillon,D,NJD,34,54,3,13,16
30,8477365,Connor Clifton,D,BUF,29,52,2,14,16
30,8478399,Jonas Siegenthaler,D,NJD,27,65,1,15,16
30,8479372,Joshua Mahura,D,SEA,26,54,1,15,16
30,8476878,Zemgus Girgensons,C,TBL,30,81,9,6,15
30,8480011,Klim Kostin,C,SJS,25,53,7,8,15
30,8483491,Ivan Miroshnichenko,L,WSH,20,57,7,8,15
30,8481537,Nikita Okhotiuk,D,CGY,24,39,7,8,15
30,8474034,Patrick Maroon,L,CHI,36,56,7,8,15
30,8480796,Martin Fehervary,D,WSH,25,52,6,9,15
30,8479291,Kevin Rooney,C,CGY,31,51,6,9,15
30,8477446,Michael McCarron,R,NSH,29,54,6,9,15
30,8483460,David Jiricek,D,CBJ,21,62,6,9,15
30,8476329,Travis Boyd,C,MIN,31,59,5,10,15
30,8477070,Liam O'Brien,C,UTA,30,54,5,10,15
30,8482148,Hendrix Lapierre,C,WSH,22,56,3,12,15
30,8470600,Ryan Suter,D,STL,39,63,3,12,15
30,8476931,Jake McCabe,D,TOR,31,65,2,13,15
30,8478840,Will Borgen,D,SEA,28,61,2,13,15
30,8475790,Erik Gudbranson,D,CBJ,32,74,2,13,15
30,8475233,David Savard,D,MTL,34,64,2,13,15
30,8482192,Isaak Phillips,D,CHI,23,54,1,14,15
30,8479520,Brandon Duhaime,R,WSH,27,57,9,5,14
30,8480806,Isac Lundestrom,C,ANA,25,59,8,6,14
30,8477979,Nicolas Aube-Kubel,R,BUF,28,54,6,8,14
30,8483565,Nick Blankenburg,D,NSH,26,64,5,9,14
30,8477499,Rasmus Ristolainen,D,PHI,30,60,5,9,14
30,8480789,Oliver Wahlstrom,R,NYI,24,65,4,10,14
30,8475690,Chris Tanev,D,TOR,35,54,4,10,14
30,8478451,Ethan Bear,D,WSH,27,50,4,10,14
30,8476429,Scott Mayfield,D,NYI,32,71,3,11,14
30,8481708,Zac Jones,D,NYR,24,58,3,11,14
30,8477903,Garnet Hathaway,R,PHI,33,57,2,12,14
30,8475279,Ben Chiarot,D,DET,33,67,2,12,14
30,8480070,Ian Mitchell,D,BOS,25,55,2,12,14
30,8475179,Dmitry Kulikov,D,FLA,34,65,1,13,14
30,8482807,Ethan Del Mastro,D,CHI,21,45,8,5,13
30,8481641,Joel Kiviranta,L,COL,28,73,8,5,13
30,8479968,Vinni Lettieri,C,BOS,29,48,8,5,13
30,8480252,Cole Guttman,C,CHI,25,39,7,6,13
30,8480995,Pontus Holmberg,R,TOR,25,67,6,7,13
30,8475842,Sam Carrick,C,NYR,32,60,6,7,13
30,8481751,Lukas Rousek,R,BUF,25,44,5,8,13
30,8479671,Mathieu Olivier,R,CBJ,27,49,4,9,13
30,8477573,Nathan Walker,L,STL,30,46,4,9,13
30,8481517,Brett Leason,R,ANA,25,54,3,10,13
30,8481013,Jonatan Berggren,R,DET,24,56,3,10,13
30,8481567,Henry Thrun,D,SJS,23,54,3,10,13
30,8475324,Nick Jensen,D,OTT,34,71,2,11,13
30,8481178,Egor Zamula,D,PHI,24,56,2,11,13
30,8477369,Carson Soucy,D,VAN,30,61,2,11,13
30,8476967,Brett Kulak,D,EDM,30,63,2,11,13
30,8474567,Zach Bogosian,D,MIN,34,63,2,11,13
30,8475762,Derek Forbort,D,VAN,32,53,2,11,13
30,8479371,Dante Fabbro,D,NSH,26,59,1,12,13
30,8479944,Zach Aston-Reese,C,VGK,30,43,8,4,12
30,8480281,Alexey Toropchenko,R,STL,25,54,7,5,12
30,8479439,Jacob MacDonald,D,COL,31,49,6,6,12
30,8476822,Luke Glendening,C,TBL,35,73,6,6,12
30,8481161,Jake Christiansen,D,CBJ,25,59,6,6,12
30,8482803,Olen Zellweger,D,ANA,21,66,5,7,12
30,8474568,Luke Schenn,D,NSH,35,47,5,7,12
30,8473453,Trevor Lewis,C,LAK,37,67,4,8,12
30,8478585,Derek Ryan,C,EDM,38,62,4,8,12
30,8482073,Braden Schneider,D,NYR,23,60,4,8,12
30,8479718,Alex Barré-Boulet,C,MTL,27,54,4,8,12
30,8475718,Justin Holl,D,DET,32,56,3,9,12
30,8480727,Zach Whitecloud,D,VGK,28,36,3,9,12
30,8475177,Calvin de Haan,D,COL,33,48,3,9,12
30,8478136,Jake Middleton,D,MIN,28,75,2,10,12
30,8476988,Matt Benning,D,SJS,30,61,2,10,12
30,8481059,Scott Perunovich,D,STL,26,58,1,11,12
30,8480887,Jordan Harris,D,MTL,24,50,1,11,12
30,8479378,Logan Stanley,D,WPG,26,41,1,11,12
30,8482095,Tyler Kleven,D,OTT,22,49,1,11,12
30,8479026,Philippe Myers,D,TOR,27,49,1,11,12
30,8483397,Marc McLaughlin,C,BOS,25,42,7,4,11
30,8479328,Julien Gauthier,R,NYI,27,59,6,5,11
30,8477938,Haydn Fleury,D,WPG,28,41,5,6,11
30,8481518,Nolan Foote,L,NJD,24,44,5,6,11
30,8479994,Jaret Anderson-Dolan,C,WPG,25,34,5,6,11
30,8479543,Michael Pezzetta,L,MTL,26,59,4,7,11
30,8482176,Wyatt Kaiser,D,CHI,22,49,4,7,11
30,8478452,Caleb Jones,D,LAK,27,48,4,7,11
30,8476856,Mathew Dumba,D,DAL,30,72,3,8,11
30,8477384,Joshua Brown,D,EDM,30,40,3,8,11
30,8481167,Brayden Pachal,D,CGY,25,48,3,8,11
30,8480873,Rasmus Sandin,D,WSH,24,56,2,9,11
30,8474574,Tyler Myers,D,VAN,34,69,2,9,11
30,8479359,Beck Malenstyn,L,BUF,26,39,2,9,11
30,8476624,Barclay Goodrow,C,SJS,31,54,2,9,11
30,8478831,Kevin Stenlund,C,UTA,28,52,8,2,10
30,8476934,Brock McGinn,L,ANA,30,46,8,2,10
30,8480845,Rasmus Kupari,C,WPG,24,37,7,3,10
30,8482062,Cole Smith,L,NSH,29,51,6,4,10
30,8482496,Nils Aman,C,VAN,24,44,6,4,10
30,8482666,Scott Morrow,D,CAR,22,50,6,4,10
30,8478017,Mark Friedman,D,VAN,29,42,6,4,10
30,8476867,Brendan Gaunce,C,MIN,30,38,5,5,10
30,8476442,Matt Nieto,L,PIT,32,49,5,5,10
30,8481532,Alex Turcotte,C,LAK,23,45,5,5,10
30,8477406,Mattias Janmark,C,EDM,32,63,4,6,10
30,8482964,Arber Xhekaj,D,MTL,23,48,4,6,10
30,8481701,Santeri Hatakka,D,NJD,23,45,4,6,10
30,8480058,Pierre-Olivier Joseph,D,STL,25,54,3,7,10
30,8483495,Simon Nemec,D,NJD,20,49,3,7,10
30,8478859,Niko Mikkola,D,FLA,28,57,3,7,10
30,8480157,Calle Rosen,D,COL,30,43,3,7,10
30,8481617,Vasily Podkolzin,R,VAN,23,41,3,7,10
30,8480950,Ilya Lyubushkin,D,DAL,30,63,2,8,10
30,8475208,Brian Dumoulin,D,ANA,33,61,2,8,10
30,8474013,Ian Cole,D,UTA,35,51,2,8,10
30,8479348,Kale Clague,D,BUF,26,45,2,8,10
30,8480246,Nick Perbix,D,TBL,26,72,1,9,10
30,8476874,Olli Maatta,D,DET,30,59,1,9,10
30,8473446,Erik Johnson,D,PHI,36,42,1,9,10
30,8482747,Brennan Othmann,L,NYR,21,38,5,4,9
30,8476873,Mark Jankowski,C,NSH,30,46,4,5,9
30,8480355,Mark Kastelic,C,BOS,25,62,4,5,9
30,8476441,Joel Edmundson,D,LAK,31,47,4,5,9
30,8480025,MacKenzie Entwistle,R,FLA,25,59,3,6,9
30,8477962,Brendan Lemieux,L,CAR,28,38,3,6,9
30,8477482,Zachary Sanford,L,CHI,30,38,3,6,9
30,8482859,Zack Ostapchuk,C,OTT,21,55,3,6,9
30,8482511,Mason Lohrei,D,BOS,23,31,3,6,9
30,8482144,Jack Thompson,D,SJS,22,28,3,6,9
30,8482744,James Malatesta,L,CBJ,21,33,2,7,9
30,8484911,Collin Graf,R,SJS,22,35,2,7,9
30,8474090,Brendan Smith,D,DAL,35,56,2,7,9
30,8482451,Mikael Pyyhtia,L,CBJ,23,44,1,8,9
30,8481147,Reese Johnson,C,MIN,26,36,7,1,8
30,8480007,Jonas Rondbjerg,R,VGK,25,34,6,2,8
30,8477887,Patrick Brown,C,BOS,32,52,5,3,8
30,8480441,Trey Fix-Wolansky,R,CBJ,25,44,4,4,8
30,8478424,Jansen Harkins,C,ANA,27,39,4,4,8
30,8483619,Filip Roos,D,OTT,25,39,4,4,8
30,8481754,Nikita Nesterenko,C,ANA,23,40,4,4,8
30,8477851,Jordan Oesterle,D,BOS,32,33,3,5,8
30,8475750,Jon Merrill,D,MIN,32,58,3,5,8
30,8476913,Devin Shore,C,MIN,30,38,3,5,8
30,8481122,Simon Benoit,D,TOR,26,48,3,5,8
30,8480192,Johnathan Kovacevic,D,NJD,27,49,2,6,8
30,8482861,Vincent Iorio,D,WSH,22,39,2,6,8
30,8477335,Kyle Burroughs,D,LAK,29,44,2,6,8
30,8476372,Nick Seeler,D,PHI,31,43,1,7,8
30,8480844,Grigori Denisenko,L,VGK,24,32,1,7,8
30,8471709,Marc-Edouard Vlasic,D,SJS,37,59,1,7,8
30,8479249,Andrew Poturalski,C,SJS,30,34,0,8,8
30,8478421,A.J. Greer,L,FLA,28,56,4,3,7
30,8482713,Mackie Samoskevich,R,FLA,22,39,4,3,7
30,8482733,Logan Mailloux,D,MTL,31,41,3,4,7
30,8480834,Ty Emberson,D,SJS,24,26,3,4,7
30,8482751,Ryan Winterton,C,SEA,21,30,3,4,7
30,8476952,Dominic Toninato,C,WPG,30,35,2,5,7
30,8478468,Jeremy Lauzon,D,NSH,27,57,2,5,7
30,8482765,Isak Rosen,R,BUF,21,35,2,5,7
30,8479986,Kole Lind,R,DAL,26,49,1,6,7
30,8476858,Phillip Di Giuseppe,L,VAN,31,38,1,6,7
30,8477320,Anton Blidh,L,NYR,29,20,1,6,7
30,8477462,Robert Hagg,D,VGK,29,23,1,6,7
30,8474612,Travis Hamonic,D,OTT,34,44,0,7,7
30,8474166,Alec Martinez,D,CHI,37,50,0,7,7
30,8477034,Jaycob Megna,D,FLA,32,46,0,7,7
30,8479587,Rhett Gardner,C,PHI,28,21,0,7,7
30,8480245,Olle Lycksell,R,PHI,25,19,6,0,6
30,8479772,Zack MacEwen,R,OTT,28,49,4,2,6
30,8471817,Ryan Reaves,R,TOR,37,54,4,2,6
30,8481789,Tye Kartye,L,SEA,23,36,4,2,6
30,8481556,John Beecher,C,BOS,23,30,4,2,6
30,8479536,Axel Jonsson-Fjallby,L,WPG,26,39,3,3,6
30,8480870,Bo Groulx,C,NYR,24,32,3,3,6
30,8479985,Cale Fleury,D,SEA,26,28,3,3,6
30,8483549,Lucas Condotta,L,MTL,27,24,2,4,6
30,8482652,Walker Duehr,R,CGY,27,39,2,4,6
30,8479972,Mason Shaw,C,WPG,26,35,2,4,6
30,8475235,Nicolas Deslauriers,L,PHI,33,53,2,4,6
30,8480292,Carson Meyer,R,ANA,27,32,2,4,6
30,8481550,Adam Beckman,L,NJD,23,50,2,4,6
30,8479442,Troy Stecher,D,EDM,30,57,1,5,6
30,8481600,Tobias Bjornfot,D,FLA,23,39,1,5,6
30,8477401,John Hayden,C,SEA,29,32,1,5,6
30,8480879,Jacob Bernard-Docker,D,OTT,24,43,1,5,6
30,8480196,Jacob Bryson,D,BUF,27,41,1,5,6
30,8471677,Jack Johnson,D,CBJ,37,64,1,5,6
30,8478146,Matthew Highmore,C,OTT,28,39,0,6,6
30,8481543,Nikita Alexandrov,C,STL,24,27,5,0,5
30,8482153,Brendan Brisson,C,VGK,23,33,4,1,5
30,8479367,William Lockwood,R,FLA,26,32,4,1,5
30,8481716,Dmitri Voronkov,L,CBJ,24,39,4,1,5
30,8481609,Vladislav Kolyachonok,D,UTA,23,34,3,2,5
30,8480880,Jakub Lauko,C,MIN,24,34,2,3,5
30,8479379,Givani Smith,R,SJS,26,26,2,3,5
30,8479638,Justin Brazeau,R,BOS,26,33,2,3,5
30,8481006,Tyler Tucker,D,STL,24,21,2,3,5
30,8480990,Declan Chisholm,D,MIN,24,39,1,4,5
30,8479981,Jonah Gadjovich,L,FLA,26,41,1,4,5
30,8477473,Justin Bailey,R,SJS,29,26,1,4,5
30,8481056,Spencer Stastney,D,NSH,24,27,1,4,5
30,8483012,Logan Morrison,C,SEA,22,29,1,4,5
30,8484254,Akito Hirose,D,VAN,25,33,0,5,5
30,8481605,Jackson LaCombe,D,ANA,23,32,0,5,5
30,8477244,Chad Ruhwedel,D,NYR,34,31,0,5,5
30,8477971,Andreas Englund,D,LAK,28,26,0,5,5
30,8474062,Riley Nash,C,NYR,35,18,0,5,5
30,8482070,Mitchell Chaffee,R,TBL,26,56,4,0,4
30,8481237,Kyle MacLean,C,NYI,25,29,3,1,4
30,8477527,Ross Johnston,L,ANA,30,35,2,2,4
30,8482858,Ryker Evans,D,SEA,23,28,2,2,4
30,8482784,Zach Dean,C,STL,21,36,1,3,4
30,8478409,Anthony Richard,C,PHI,28,35,1,3,4
30,8482177,Marat Khusnutdinov,C,MIN,22,35,1,3,4
30,8479991,Jake Leschyshyn,C,NYR,25,32,1,3,4
30,8478450,Parker Wotherspoon,D,BOS,27,33,1,3,4
30,8482141,Lukas Cormier,D,VGK,22,24,1,3,4
30,8478477,Mitchell Stephens,C,SEA,27,23,1,3,4
30,8480267,Sammy Walker,C,MIN,25,22,0,4,4
30,8481699,Aku Raty,R,UTA,23,14,2,1,3
30,8481422,Jake Lucchini,C,NSH,29,16,2,1,3
30,8480874,Adam Ginning,D,PHI,24,14,2,1,3
30,8481462,Mason Morelli,L,VGK,28,16,2,1,3
30,8475958,Michael Sgarbossa,C,WSH,32,20,2,1,3
30,8482787,Nikita Chibrikov,R,WPG,31,12,2,1,3
30,8476473,Connor Murphy,D,CHI,31,34,1,2,3
30,8481743,Marc Del Gaizo,D,NSH,25,29,1,2,3
30,8483630,Pavol Regenda,L,ANA,25,30,1,2,3
30,8475795,Dylan McIlrath,D,WSH,32,17,1,2,3
30,8478446,Glenn Gawdin,C,LAK,27,20,1,2,3
30,8481719,Maxwell Crozier,D,TBL,24,16,0,3,3
30,8477810,Joel Hanley,D,CGY,33,24,0,3,3
30,8482476,Emil Heineman,L,MTL,23,13,0,3,3
30,8481564,Ryan Johnson,D,BUF,23,13,0,3,3
30,8482165,Yan Kuznetsov,D,CGY,22,15,2,0,2
30,8483471,Brad Lambert,C,WPG,31,9,2,0,2
30,8481726,Adam Edstrom,C,NYR,24,9,2,0,2
30,8483489,Fraser Minten,C,TOR,31,13,2,0,2
30,8478454,Noah Juulsen,D,VAN,27,31,1,1,2
30,8481679,Maxence Guenette,D,OTT,23,31,1,1,2
30,8482145,Mavrik Bourque,C,DAL,22,47,1,1,2
30,8477149,Scott Sabourin,R,SJS,32,13,1,1,2
30,8482102,Vasily Ponomarev,C,PIT,22,16,1,1,2
30,8480851,Akil Thomas,C,LAK,24,10,1,1,2
30,8481043,Cole Koepke,L,BOS,26,16,1,1,2
30,8479330,Brandon Gignac,C,MTL,27,15,1,1,2
30,8483407,Brandon Scanlin,D,NYR,25,7,1,1,2
30,8484304,Uvis Balinskis,D,FLA,28,10,1,1,2
30,8481065,Angus Crookshank,L,OTT,25,13,0,2,2
30,8479576,Vincent Desharnais,D,VAN,28,31,0,2,2
30,8482147,Jean-Luc Foudy,C,COL,22,24,0,2,2
30,8480890,Jan Jenik,C,OTT,24,24,0,2,2
30,8483512,Matthew Savoie,C,EDM,20,19,0,2,2
30,8477467,Gustav Olofsson,D,SEA,30,19,0,2,2
30,8482201,Gage Goncalves,C,TBL,23,19,0,2,2
30,8477073,Kurtis MacDermid,L,NJD,30,23,0,2,2
30,8482929,Emil Lilleberg,D,TBL,23,22,0,2,2
30,8481806,Louis Crevier,D,CHI,23,14,0,2,2
30,8475413,Justin Dowling,C,NJD,34,11,0,2,2
30,8478011,Louie Belpedio,D,PHI,28,19,0,2,2
30,8479419,Brett Murray,L,BUF,26,21,0,2,2
30,8483597,Milos Kelemen,L,UTA,25,14,0,2,2
30,8482061,Brandon Biro,L,SEA,26,13,0,2,2
30,8482250,Callahan Burke,C,VGK,27,17,1,0,1
30,8482094,Daemon Hunt,D,MIN,22,19,1,0,1
30,8484287,Cole McWard,D,VAN,23,23,1,0,1
30,8483763,Maksymilian Szuber,D,UTA,22,27,1,0,1
30,8483570,Ben Meyers,C,SEA,26,30,1,0,1
30,8482172,Landon Slaggert,L,CHI,22,14,1,0,1
30,8479320,Maxime Lajoie,D,SEA,27,23,1,0,1
30,8481206,John Ludvig,D,PIT,24,16,1,0,1
30,8475755,Alexander Petrovic,D,DAL,32,8,1,0,1
30,8481585,Egor Afanasyev,L,SJS,23,17,1,0,1
30,8476323,Max McCormick,L,SEA,32,6,1,0,1
30,8479362,Riley Tufte,L,BOS,26,10,1,0,1
30,8484255,Jason Polin,R,COL,25,7,1,0,1
30,8483531,Brian Halonen,L,NJD,25,5,1,0,1
30,8481534,Raphael Lavoie,C,EDM,24,3,1,0,1
30,8482126,Emil Andrae,D,PHI,31,5,1,0,1
30,8478874,Adam Gaudette,R,OTT,28,38,0,1,1
30,8484258,Sam Malinski,D,COL,26,19,0,1,1
30,8478021,William Lagesson,D,DET,28,28,0,1,1
30,8482516,Matthew Kessel,D,STL,24,12,0,1,1
30,8478502,Dennis Gilbert,D,BUF,28,22,0,1,1
30,8481593,Jayden Struble,D,MTL,23,12,0,1,1
30,8480084,Nick DeSimone,D,NJD,30,15,0,1,1
30,8481030,Jack St. Ivany,D,PIT,25,15,0,1,1
30,8480075,Cameron Crotty,D,MIN,25,9,0,1,1
30,8480468,James Hamblin,L,EDM,25,18,0,0,0
30,8482470,Ilya Solovyov,D,CGY,24,21,0,0,0
30,8480032,Shane Bowers,C,NJD,25,13,0,0,0
30,8481541,Samuel Bolduc,D,NYI,24,20,0,0,0
30,8481024,Linus Karlsson,C,VAN,25,8,0,0,0
30,8477993,Justin Kirkland,C,CGY,28,5,0,0,0
30,8483609,Adam Klapka,R,CGY,24,4,0,0,0
30,8478051,Max Willman,C,NJD,29,12,0,0,0
30,8480823,Alexander Alexeyev,D,WSH,25,12,0,0,0
30,8478881,Brett Seney,L,CHI,28,14,0,0,0
30,8479421,Jacob Moverare,D,LAK,26,9,0,0,0
30,8482162,Roby Jarventie,L,EDM,22,10,0,0,0
30,8482118,Sam Colangelo,R,ANA,23,8,0,0,0
30,8477541,Dakota Mermis,D,TOR,30,7,0,0,0
30,8481578,Graeme Clarke,R,MIN,23,8,0,0,0
30,8482088,Justin Sourdif,R,FLA,22,14,0,0,0
30,8483920,Pierrick Dube,R,WSH,23,4,0,0,0
30,8480306,Grant Hutton,D,NYI,29,5,0,0,0
30,8478147,Bokondji Imama,L,PIT,28,9,0,0,0
30,8483432,Luca Del Bel Belluz,C,CBJ,31,6,0,0,0
30,8478854,Ryan Shea,D,PIT,27,5,0,0,0
30,8481655,Cole Schwindt,R,CGY,23,5,0,0,0
30,8483398,Declan Carlile,D,TBL,31,8,0,0,0
30,8482197,Adam Raska,R,MIN,23,7,0,0,0
30,8483395,Arshdeep Bains,L,VAN,23,8,0,0,0
30,8475780,Chris Wagner,R,COL,33,9,0,0,0
30,8483401,Marc Johnstone,R,PIT,28,0,0,0,0
30,8484325,Waltteri Merela,C,TBL,26,22,0,0,0
30,8483567,Georgii Merkulov,C,BOS,24,7,0,0,0
30,8478956,Samuel Laberge,L,NJD,27,3,0,0,0
30,8482460,Matt Rempe,C,NYR,22,7,0,0,0
30,8480274,Philip Kemp,D,EDM,25,1,0,0,0
30,8483546,Marshall Rifai,D,TOR,26,4,0,0,0
30,8479522,Hardy Haman Aktell,D,WSH,26,1,0,0,0
30,8484259,Ondrej Pavel,C,COL,31,3,0,0,0
30,8484326,Patrik Koch,D,UTA,28,2,0,0,0
30,8484321,Nikolas Matinpalo,D,OTT,26,1,0,0,0
30,8470794,Joe Pavelski,C,,40,0,0,0,0
30,8479321,Lucas Johansen,D,,27,0,0,0,0
30,8477950,Tony DeAngelo,D,,29,0,0,0,0
30,8471218,Blake Wheeler,R,,38,0,0,0,0
30,8475197,Tyson Barrie,D,,33,0,0,0,0
30,8474157,Max Pacioretty,L,,36,0,0,0,0
30,8475744,Evgeny Kuznetsov,C,,32,0,0,0,0
30,8474037,James van Riemsdyk,L,,35,0,0,0,0
30,8476907,Mackenzie MacEachern,L,,30,0,0,0,0
30,8480216,Jacob Peterson,C,,25,0,0,0,0
30,8474602,Justin Schultz,D,,34,0,0,0,0
30,8482222,Alexander Barabanov,L,,30,0,0,0,0
30,8474031,Kevin Shattenkirk,D,,35,0,0,0,0
30,8477330,Dominik Kubalik,L,,29,0,0,0,0
30,8480884,Calen Addison,D,,24,0,0,0,0
30,8475906,John Klingberg,D,,32,0,0,0,0
30,8480008,Adam Ruzicka,C,,25,0,0,0,0
30,8476884,Derrick Pouliot,D,,30,0,0,0,0
30,8476919,Chris Tierney,C,,30,0,0,0,0
30,8479415,Michael McLeod,C,,26,0,0,0,0
30,8474870,Tyler Johnson,C,,34,0,0,0,0
30,8470604,Jeff Carter,C,,39,0,0,0,0
30,8478104,Sammy Blais,L,,28,0,0,0,0
30,8474884,Mike Hoffman,C,,35,0,0,0,0
30,8481591,Sam Poulin,R,,23,0,0,0,0
30,8471274,Alex Goligoski,D,,39,0,0,0,0
30,8476871,Tanner Pearson,L,,32,0,0,0,0
30,8476393,Nick Cousins,C,,31,0,0,0,0
30,8479977,Kailer Yamamoto,R,,26,0,0,0,0
30,8479346,Dillon Dube,C,,26,0,0,0,0
30,8480184,Gustav Lindstrom,D,,26,0,0,0,0
30,8479376,Victor Mete,D,,26,0,0,0,0
30,8473449,Kyle Okposo,R,,36,0,0,0,0
30,8481058,Jesse Ylonen,R,,25,0,0,0,0
30,8475752,Tyler Pitlick,C,,33,0,0,0,0
30,8481239,Samuel Fagemo,L,,24,0,0,0,0
30,8480821,Filip Zadina,R,,25,0,0,0,0
30,8470966,Mark Giordano,D,,41,0,0,0,0
30,8478495,Denis Gurianov,R,,27,0,0,0,0
30,8477464,Nic Petan,C,,29,0,0,0,0
30,8478099,Kevin Labanc,R,,29,0,0,0,0
30,8482241,Radim Zohorna,L,,28,0,0,0,0
30,8474040,Sam Gagner,C,,35,0,0,0,0
30,8479514,Rem Pitlick,C,,27,0,0,0,0
30,8478430,Oliver Kylington,D,,27,0,0,0,0
30,8479533,Joona Koppanen,L,,26,0,0,0,0
30,8479984,Cal Foote,D,,26,0,0,0,0
30,8477126,Jayson Megna,C,,34,0,0,0,0
30,8475164,Jakob Silfverberg,R,,34,0,0,0,0
30,8474009,Nick Bonino,C,,36,0,0,0,0
30,8479458,Nikita Zaitsev,D,,33,0,0,0,0
30,8477944,Jakub Vrana,L,,28,0,0,0,0
30,8471699,Andrew Cogliano,C,,37,0,0,0,0
30,8478067,Oskar Lindblom,L,,28,0,0,0,0
30,8471686,Marc Staal,D,,37,0,0,0,0
30,8470610,Zach Parise,L,,40,0,0,0,0
30,8478904,Steven Lorentz,C,,28,0,0,0,0
30,8473473,Milan Lucic,L,,36,0,0,0,0
30,8480031,Maxime Comtois,L,,25,0,0,0,0
30,8478512,Austin Czarnik,C,,32,0,0,0,0
30,8473504,Cal Clutterbuck,R,,37,0,0,0,0
30,8477454,Adam Erne,L,,29,0,0,0,0
30,8479383,Boris Katchouk,L,,26,0,0,0,0
30,8475825,Jani Hakanpää,D,,32,0,0,0,0
30,8477846,Ryan Carpenter,C,,33,0,0,0,0
30,8477930,Pierre-Edouard Bellemare,L,,39,0,0,0,0
30,8478400,Colin White,C,,27,0,0,0,0
30,8480226,Marián Studenic,R,,26,0,0,0,0
30,8480853,Liam Foudy,C,,24,0,0,0,0
30,8475797,Jarred Tinordi,D,,32,0,0,0,0
30,8479423,Alex Nylander,L,,26,0,0,0,0
30,8474618,Marco Scandella,D,,34,0,0,0,0
30,8478028,Fredrik Olofsson,L,,28,0,0,0,0
30,8474709,Matt Martin,L,,35,0,0,0,0
30,8481070,Hugh McGing,L,,26,0,0,0,0
30,8479546,Oskar Steen,C,,26,0,0,0,0
30,8474145,Robert Bortuzzo,D,,35,0,0,0,0
30,8476915,Jujhar Khaira,L,,30,0,0,0,0
30,8475278,Byron Froese,C,,33,0,0,0,0
30,8481812,Nikolai Knyzhov,D,,27,0,0,0,0
30,8478408,Travis Dermott,D,,28,0,0,0,0
30,8481077,John Leonard,L,,26,0,0,0,0
30,8479547,Matthew Phillips,R,,26,0,0,0,0
30,8480836,Jonathan Gruden,C,,24,0,0,0,0
30,8481690,Tyler Angle,C,,24,0,0,0,0
30,8475766,Austin Watson,L,,32,0,0,0,0
30,8481016,Ruslan Iskhakov,C,,24,0,0,0,0
30,8478078,Rourke Chartier,C,,28,0,0,0,0
30,8480776,Sheldon Rempal,R,,29,0,0,0,0
30,8483045,Cameron Butler,R,CBJ,31,1,0,0,0
30,8484314,Jiri Smejkal,L,,28,0,0,0,0
31,8478402,Connor McDavid,C,EDM,27,78,45,103,148
31,8477492,Nathan MacKinnon,C,COL,29,82,56,91,147
31,8477956,David Pastrnak,R,BOS,28,78,49,70,119
31,8476453,Nikita Kucherov,R,TBL,31,82,38,79,117
31,8479314,Matthew Tkachuk,L,FLA,27,78,38,78,116
31,8481559,Jack Hughes,C,NJD,23,78,42,70,112
31,8480800,Quinn Hughes,D,VAN,25,76,17,93,110
31,8479318,Auston Matthews,C,TOR,27,78,57,46,103
31,8480012,Elias Pettersson,C,VAN,26,78,44,59,103
31,8478864,Kirill Kaprizov,L,MIN,27,72,41,61,102
31,8477934,Leon Draisaitl,C,EDM,29,76,41,61,102
31,8478550,Artemi Panarin,L,NYR,33,75,29,73,102
31,8482116,Tim Stützle,C,OTT,22,81,31,66,97
31,8477946,Dylan Larkin,C,DET,28,81,46,50,96
31,8478420,Mikko Rantanen,R,COL,28,82,38,57,95
31,8480830,Andrei Svechnikov,R,CAR,24,74,33,62,95
31,8475172,Nazem Kadri,C,CGY,34,78,37,57,94
31,8476468,J.T. Miller,C,VAN,31,76,27,66,93
31,8477933,Sam Reinhart,C,FLA,29,81,45,46,91
31,8471675,Sidney Crosby,C,PIT,37,71,34,57,91
31,8479407,Jesper Bratt,L,NJD,26,78,29,62,91
31,8478483,Mitch Marner,R,TOR,27,80,31,59,90
31,8480023,Robert Thomas,C,STL,25,77,26,63,89
31,8477501,Valeri Nichushkin,R,COL,29,82,39,49,88
31,8477942,Kevin Fiala,L,LAK,28,80,24,63,87
31,8476389,Vincent Trocheck,C,NYR,31,78,29,57,86
31,8478445,Mathew Barzal,C,NYI,27,80,18,68,86
31,8476887,Filip Forsberg,L,NSH,30,74,40,45,85
31,8478444,Brock Boeser,R,VAN,27,74,34,51,85
31,8477493,Aleksander Barkov,C,FLA,29,76,28,56,84
31,8475810,Bryan Rust,R,PIT,32,76,40,42,82
31,8479343,Clayton Keller,R,UTA,26,75,37,45,82
31,8477402,Pavel Buchnevich,L,STL,29,76,36,45,81
31,8477949,Alex Tuch,R,BUF,28,76,30,51,81
31,8474564,Steven Stamkos,C,NSH,34,74,36,44,80
31,8484144,Connor Bedard,C,CHI,19,76,32,48,80
31,8479323,Adam Fox,D,NYR,26,73,19,61,80
31,8479420,Tage Thompson,C,BUF,27,75,42,37,79
31,8480002,Nico Hischier,C,NJD,25,73,29,50,79
31,8474578,Erik Karlsson,D,PIT,34,79,22,57,79
31,8475184,Chris Kreider,L,NYR,33,78,52,26,78
31,8478439,Travis Konecny,R,PHI,27,77,35,43,78
31,8478010,Brayden Point,C,TBL,28,81,34,44,78
31,8477960,Adrian Kempe,R,LAK,28,82,31,47,78
31,8473419,Brad Marchand,L,BOS,36,80,27,51,78
31,8477951,Nick Schmaltz,C,UTA,28,71,21,56,77
31,8477939,William Nylander,R,TOR,28,79,27,49,76
31,8478414,Timo Meier,R,NJD,28,79,38,37,75
31,8478427,Sebastian Aho,C,CAR,27,72,30,45,75
31,8476454,Ryan Nugent-Hopkins,C,EDM,31,79,22,53,75
31,8476456,Jonathan Huberdeau,C,CGY,31,78,13,62,75
31,8480801,Brady Tkachuk,L,OTT,25,79,38,36,74
31,8477404,Jake Guentzel,C,TBL,30,82,36,38,74
31,8478449,Roope Hintz,C,DAL,28,80,27,47,74
31,8471215,Evgeni Malkin,C,PIT,38,71,25,49,74
31,8477409,Carter Verhaeghe,C,FLA,29,78,39,34,73
31,8478398,Kyle Connor,L,WPG,28,71,33,40,73
31,8476448,William Karlsson,C,VGK,31,79,27,46,73
31,8482078,Lucas Raymond,L,DET,22,81,26,47,73
31,8480069,Cale Makar,D,COL,26,72,23,50,73
31,8480036,Miro Heiskanen,D,DAL,25,80,15,58,73
31,8479337,Alex DeBrincat,R,DET,27,81,35,37,72
31,8474141,Patrick Kane,R,DET,36,81,27,45,72
31,8477500,Bo Horvat,C,NYI,29,80,37,34,71
31,8477940,Nikolaj Ehlers,L,WPG,28,68,27,44,71
31,8479385,Jordan Kyrou,C,STL,26,79,33,37,70
31,8479542,Brandon Hagel,L,TBL,26,82,30,40,70
31,8474600,Roman Josi,D,NSH,34,71,13,57,70
31,8476459,Mika Zibanejad,C,NYR,31,73,25,44,69
31,8473512,Claude Giroux,R,OTT,36,79,24,45,69
31,8478403,Jack Eichel,C,VGK,28,77,28,40,68
31,8481528,Dylan Cozens,C,BUF,23,71,25,43,68
31,8480865,Noah Dobson,D,NYI,24,80,8,60,68
31,8475786,Zach Hyman,L,EDM,32,79,30,37,67
31,8480208,Drake Batherson,R,OTT,26,78,26,41,67
31,8475913,Mark Stone,R,VGK,32,78,23,44,67
31,8475754,Brock Nelson,C,NYI,33,78,32,34,66
31,8474590,John Carlson,D,WSH,34,61,16,50,66
31,8475166,John Tavares,C,TOR,34,75,31,34,65
31,8476460,Mark Scheifele,C,WPG,31,71,28,37,65
31,8478493,Joel Eriksson Ek,C,MIN,27,72,28,37,65
31,8480018,Nick Suzuki,C,MTL,25,74,18,47,65
31,8478047,Michael Bunting,L,PIT,29,72,29,35,64
31,8481540,Cole Caufield,R,MTL,23,71,28,36,64
31,8478873,Troy Terry,R,ANA,27,75,22,42,64
31,8476905,Chandler Stephenson,C,SEA,30,75,15,49,64
31,8482109,Alexis Lafrenière,L,NYR,23,79,32,31,63
31,8482665,Matty Beniers,C,SEA,22,72,28,35,63
31,8477496,Elias Lindholm,C,BOS,30,80,26,37,63
31,8471685,Anze Kopitar,C,LAK,37,81,19,44,63
31,8479999,Casey Mittelstadt,C,COL,26,81,15,48,63
31,8475692,Mats Zuccarello,R,MIN,37,71,12,51,63
31,8478460,Zach Werenski,D,CBJ,27,79,10,53,63
31,8478498,Jake DeBrusk,L,VAN,28,74,39,23,62
31,8479675,Trevor Moore,L,LAK,29,81,32,30,62
31,8475158,Ryan O'Reilly,C,NSH,33,75,22,40,62
31,8475784,Jeff Skinner,C,EDM,32,76,30,31,61
31,8474150,Mikael Backlund,C,CGY,35,73,28,33,61
31,8476539,Jonathan Marchessault,R,NSH,34,69,26,35,61
31,8475765,Vladimir Tarasenko,R,DET,33,80,22,39,61
31,8477955,Jared McCann,L,SEA,28,73,29,31,60
31,8476399,Blake Coleman,C,CGY,33,77,25,35,60
31,8481533,Trevor Zegras,C,ANA,23,73,23,37,60
31,8475168,Matt Duchene,C,DAL,33,82,31,28,59
31,8478440,Dylan Strome,C,WSH,27,65,22,37,59
31,8480803,Evan Bouchard,D,EDM,25,75,15,44,59
31,8475167,Victor Hedman,D,TBL,34,78,13,46,59
31,8482684,Luke Hughes,D,NJD,21,71,8,51,59
31,8474102,David Perron,L,OTT,36,76,26,32,58
31,8478856,Conor Garland,R,VAN,28,73,26,32,58
31,8479400,Pierre-Luc Dubois,L,WSH,26,73,25,33,58
31,8481557,Matt Boldy,L,MIN,23,66,20,38,58
31,8481711,Matias Maccelli,L,UTA,24,72,16,42,58
31,8476958,Jaccob Slavin,D,CAR,30,75,15,43,58
31,8480027,Jason Robertson,L,DAL,25,81,14,44,58
31,8477504,Josh Morrissey,D,WPG,29,67,12,46,58
31,8471214,Alex Ovechkin,L,WSH,39,79,36,21,57
31,8482093,Seth Jarvis,C,CAR,22,71,29,28,57
31,8482745,Mason McTavish,C,ANA,21,76,24,33,57
31,8479345,Jakob Chychrun,D,WSH,26,70,21,36,57
31,8477416,Oliver Bjorkstrand,R,SEA,29,78,19,38,57
31,8482699,Dylan Guenther,R,UTA,21,78,27,29,56
31,8476881,Tomas Hertl,C,VGK,31,79,27,29,56
31,8477935,Sam Bennett,C,FLA,28,78,22,34,56
31,8480028,Morgan Frost,C,PHI,25,69,17,39,56
31,8477447,Shea Theodore,D,VGK,29,65,10,46,56
31,8477407,Anthony Duclair,L,NYI,29,75,31,24,55
31,8476483,Rickard Rakell,R,PIT,31,71,30,25,55
31,8482740,Wyatt Johnston,C,DAL,21,81,27,28,55
31,8482110,Dawson Mercer,C,NJD,23,73,26,29,55
31,8474641,Adam Henrique,C,EDM,34,76,24,31,55
31,8480009,Eeli Tolvanen,R,SEA,25,72,24,31,55
31,8476346,Johnny Gaudreau,L,CBJ,31,74,17,38,55
31,8475745,Charlie Coyle,C,BOS,32,76,17,38,55
31,8478407,Vince Dunn,D,SEA,28,76,14,41,55
31,8476432,Boone Jenner,C,CBJ,31,69,28,26,54
31,8478042,Viktor Arvidsson,L,EDM,31,75,25,29,54
31,8478401,Pavel Zacha,C,BOS,27,77,24,30,54
31,8482113,Anton Lundell,C,FLA,23,75,16,38,54
31,8477503,Max Domi,C,TOR,29,77,10,44,54
31,8476853,Morgan Rielly,D,TOR,30,75,9,45,54
31,8476875,Mike Matheson,D,MTL,30,71,9,45,54
31,8481068,Yegor Sharangovich,C,CGY,26,79,28,25,53
31,8474586,Jordan Eberle,R,SEA,34,73,27,26,53
31,8478438,Tommy Novak,C,NSH,27,70,22,31,53
31,8471698,T.J. Oshie,R,WSH,38,70,22,31,53
31,8479325,Charlie McAvoy,D,BOS,27,74,10,43,53
31,8479425,Filip Hronek,D,VAN,27,70,9,44,53
31,8477456,J.T. Compher,L,DET,29,78,25,27,52
31,8477986,Brandon Montour,D,SEA,30,74,21,31,52
31,8480849,Barrett Hayton,C,UTA,24,72,19,33,52
31,8484153,Leo Carlsson,C,ANA,20,72,18,34,52
31,8480839,Rasmus Dahlin,D,BUF,24,73,14,38,52
31,8476479,Phillip Danault,C,LAK,31,75,26,25,51
31,8476882,Teuvo Teravainen,C,CHI,30,74,21,30,51
31,8473986,Alex Killorn,L,ANA,35,66,20,31,51
31,8478975,Mason Marchment,L,DAL,29,82,19,32,51
31,8476826,Yanni Gourde,C,SEA,33,72,17,34,51
31,8477346,MacKenzie Weegar,D,CGY,30,72,11,40,51
31,8480015,Owen Tippett,R,PHI,25,78,23,27,50
31,8473994,Jamie Benn,L,DAL,35,82,23,27,50
31,8480039,Martin Necas,C,CAR,25,74,21,29,50
31,8484166,Adam Fantilli,C,CBJ,20,68,20,30,50
31,8476462,Dougie Hamilton,D,NJD,31,72,11,39,50
31,8483515,Juraj Slafkovsky,L,MTL,20,74,23,26,49
31,8482124,Quinton Byfield,R,LAK,22,79,16,33,49
31,8474679,Gustav Nyquist,C,NSH,35,69,14,35,49
31,8471724,Kris Letang,D,PIT,37,78,6,43,49
31,8478474,Lawson Crouse,L,UTA,27,72,27,21,48
31,8475726,Tyler Toffoli,C,SJS,32,68,24,24,48
31,8482055,Drew O'Connor,L,PIT,26,61,17,31,48
31,8477932,Aaron Ekblad,D,FLA,28,71,12,36,48
31,8475714,Calle Jarnkrok,C,TOR,33,75,23,24,47
31,8483808,Andrei Kuzmenko,L,CGY,28,71,22,25,47
31,8477964,Ivan Barbashev,C,VGK,29,70,22,25,47
31,8481596,Shane Pinto,C,OTT,24,73,21,26,47
31,8477511,Anthony Mantha,R,CGY,30,75,19,28,47
31,8478519,Anthony Cirelli,C,TBL,27,80,18,29,47
31,8480188,Fabian Zetterlund,L,SJS,25,71,17,30,47
31,8478458,John (Jack) Roslovic,C,CAR,27,65,15,32,47
31,8476869,Brady Skjei,D,NSH,30,75,13,34,47
31,8480434,Sean Durzi,D,UTA,26,68,13,34,47
31,8481703,Valtteri Puustinen,R,PIT,25,62,11,36,47
31,8479410,Mikhail Sergachev,D,UTA,26,70,9,38,47
31,8481186,Logan O'Connor,R,COL,28,77,26,20,46
31,8478462,Nicolas Roy,C,VGK,27,74,24,22,46
31,8480064,Josh Norris,C,OTT,25,72,21,25,46
31,8476880,Tom Wilson,R,WSH,30,71,18,28,46
31,8476906,Shayne Gostisbehere,D,CAR,31,76,10,36,46
31,8477476,Artturi Lehkonen,L,COL,29,77,24,21,45
31,8477494,Jonathan Drouin,L,COL,29,82,19,26,45
31,8481581,Thomas Harley,D,DAL,23,77,14,31,45
31,8475798,Mikael Granlund,C,SJS,32,70,13,32,45
31,8478038,Devon Toews,D,COL,30,73,6,39,45
31,8479992,Michael Rasmussen,C,DET,25,81,20,24,44
31,8484145,Zach Benson,L,BUF,19,67,18,26,44
31,8481560,Arthur Kaliyev,R,LAK,23,78,18,26,44
31,8482097,Jack Quinn,R,BUF,23,66,15,29,44
31,8482720,Matthew Knies,L,TOR,22,78,14,30,44
31,8475170,Brayden Schenn,C,STL,33,74,13,31,44
31,8478469,Thomas Chabot,D,OTT,27,73,7,37,44
31,8480014,Gabriel Vilardi,C,WPG,25,66,29,14,43
31,8477426,Nicholas Paul,L,TBL,29,81,23,20,43
31,8479365,Trent Frederic,C,BOS,26,80,18,25,43
31,8482159,Tyson Foerster,R,PHI,22,76,17,26,43
31,8475722,Jason Zucker,L,BUF,32,64,16,27,43
31,8477495,Seth Jones,D,CHI,30,70,7,36,43
31,8480145,Neal Pionk,D,WPG,29,72,7,36,43
31,8475169,Evander Kane,L,EDM,33,78,23,19,42
31,8477451,Ryan Hartman,R,MIN,30,63,22,20,42
31,8475314,Anders Lee,L,NYI,34,70,21,21,42
31,8477947,Sonny Milano,L,WSH,28,68,19,23,42
31,8475763,Kevin Hayes,R,PIT,32,69,16,26,42
31,8478233,Andrew Mangiapane,L,WSH,28,70,16,26,42
31,8480797,Joel Farabee,L,PHI,24,79,15,27,42
31,8480185,Eetu Luostarinen,C,FLA,26,75,14,28,42
31,8475191,Reilly Smith,R,NYR,33,75,14,28,42
31,8481542,Moritz Seider,D,DET,23,79,8,34,42
31,8478046,Danton Heinen,L,VAN,29,65,20,21,41
31,8477444,Andre Burakovsky,L,SEA,29,70,16,25,41
31,8476292,Ondrej Palat,L,NJD,33,68,16,25,41
31,8484203,Bradly Nadeau,L,CAR,19,61,16,25,41
31,8483505,Matthew Poitras,C,BOS,20,72,12,29,41
31,8475753,Justin Faulk,D,STL,32,74,10,31,41
31,8477021,Alex Kerfoot,C,UTA,30,71,8,33,41
31,8477497,Sean Monahan,C,CBJ,30,63,29,11,40
31,8475794,Tyler Seguin,C,DAL,32,82,22,18,40
31,8481604,Pavel Dorofeyev,L,VGK,24,73,18,22,40
31,8478466,Daniel Sprong,R,VAN,27,74,17,23,40
31,8479339,Patrik Laine,L,CBJ,26,66,17,23,40
31,8477998,Warren Foegele,L,LAK,28,80,16,24,40
31,8470613,Brent Burns,D,CAR,39,77,5,35,40
31,8480798,Philipp Kurashev,C,CHI,25,65,13,26,39
31,8482712,Oskar Olausson,R,COL,22,79,8,31,39
31,8478397,Rasmus Andersson,D,CGY,28,72,4,35,39
31,8482667,William Eklund,L,SJS,22,63,20,18,38
31,8477505,Alexander Wennberg,C,SJS,30,63,15,23,38
31,8482702,Logan Stankoven,C,DAL,21,81,13,25,38
31,8476419,Jean-Gabriel Pageau,C,NYI,32,78,13,25,38
31,8482092,Ridly Greig,C,OTT,22,74,13,25,38
31,8474716,Jared Spurgeon,D,MIN,35,81,12,26,38
31,8483431,Logan Cooley,C,UTA,20,74,17,20,37
31,8478057,Dakota Joshua,C,VAN,28,70,17,20,37
31,8481618,Alex Newhook,C,MTL,23,72,16,21,37
31,8475793,Ryan Johansen,C,PHI,32,76,15,22,37
31,8475218,Mattias Ekholm,D,EDM,34,77,12,25,37
31,8477479,Tyler Bertuzzi,L,CHI,29,63,22,14,36
31,8482089,Jake Neighbours,L,STL,22,66,20,16,36
31,8479987,Morgan Geekie,C,BOS,26,77,17,19,36
31,8478366,Frank Vatrano,R,ANA,30,71,16,20,36
31,8475768,Jaden Schwartz,C,SEA,32,70,15,21,36
31,8474053,Logan Couture,C,SJS,35,58,13,23,36
31,8476458,Ryan Strome,C,ANA,31,69,13,23,36
31,8477948,Travis Sanheim,D,PHI,28,67,12,24,36
31,8481523,Kirby Dach,C,MTL,23,67,11,25,36
31,8476792,Torey Krug,D,STL,33,73,9,27,36
31,8480113,Alex Iafallo,L,WPG,31,68,20,15,35
31,8480893,Kirill Marchenko,R,CBJ,24,64,19,16,35
31,8475220,Marcus Foligno,L,MIN,33,65,18,17,35
31,8482149,Cole Perfetti,C,WPG,22,68,17,18,35
31,8480829,Jesperi Kotkaniemi,C,CAR,24,70,16,19,35
31,8475848,Brendan Gallagher,R,MTL,32,70,16,19,35
31,8475799,Nino Niederreiter,R,WPG,32,68,14,21,35
31,8478542,Evan Rodrigues,C,FLA,31,77,11,24,35
31,8482671,Owen Power,D,BUF,22,63,10,25,35
31,8476854,Hampus Lindholm,D,BOS,30,73,7,28,35
31,8478396,Noah Hanifin,D,VGK,27,56,6,29,35
31,8481582,Nicholas Robertson,L,TOR,23,68,21,13,34
31,8480220,Noah Cates,L,PHI,25,72,15,19,34
31,8482475,Yegor Chinakhov,R,CBJ,23,65,14,20,34
31,8483445,Cutter Gauthier,L,ANA,20,61,13,21,34
31,8475287,Erik Haula,L,NJD,33,72,12,22,34
31,8475231,Casey Cizikas,C,NYI,33,75,12,22,34
31,8481656,Aliaksei Protas,C,WSH,23,63,9,25,34
31,8474563,Drew Doughty,D,LAK,35,72,5,29,34
31,8474565,Alex Pietrangelo,D,VGK,34,61,5,29,34
31,8476892,Colton Parayko,D,STL,31,69,2,32,34
31,8479525,Ross Colton,C,COL,28,82,18,15,33
31,8483524,Shane Wright,C,SEA,20,61,16,17,33
31,8478891,Mason Appleton,C,WPG,28,62,13,20,33
31,8480802,Ryan McLeod,C,BUF,25,63,13,20,33
31,8478472,Mathieu Joseph,R,STL,27,66,12,21,33
31,8478013,Jake Walman,D,SJS,28,70,12,21,33
31,8478055,Gustav Forsling,D,FLA,28,75,11,22,33
31,8476981,Josh Anderson,R,MTL,30,68,20,12,32
31,8478020,Michael Amadio,R,OTT,28,79,20,12,32
31,8474149,Evgenii Dadonov,R,DAL,35,76,15,17,32
31,8477953,Kasperi Kapanen,R,STL,28,65,15,17,32
31,8479591,Michael Eyssimont,C,TBL,28,81,14,18,32
31,8481524,Bowen Byram,D,BUF,23,70,13,19,32
31,8476927,Teddy Blueger,C,VAN,30,69,13,19,32
31,8475760,Nick Bjugstad,C,UTA,32,72,12,20,32
31,8477429,Andrew Copp,C,DET,30,76,11,21,32
31,8478911,Matt Roy,D,WSH,29,64,11,21,32
31,8476885,Jacob Trouba,D,NYR,30,66,9,23,32
31,8482245,Artem Zub,D,OTT,29,75,6,26,32
31,8478500,Ivan Provorov,D,CBJ,27,78,3,29,32
31,8477392,Hudson Fasching,R,NYI,29,68,17,14,31
31,8475151,Kyle Palmieri,C,NYI,33,76,16,15,31
31,8473422,Nick Foligno,L,CHI,37,64,16,15,31
31,8480068,Ryan Poehling,C,PHI,25,68,15,16,31
31,8479393,Noah Gregor,L,OTT,26,77,15,16,31
31,8476480,Vladislav Namestnikov,C,WPG,32,66,13,18,31
31,8480748,Kiefer Sherwood,L,VAN,29,57,13,18,31
31,8482146,Luke Evangelista,R,NSH,22,71,12,19,31
31,8474715,Cameron Atkinson,R,TBL,35,81,12,19,31
31,8482624,Daniil Miromanov,D,CGY,27,67,12,19,31
31,8481546,Cam York,D,PHI,23,68,7,24,31
31,8477969,Marcus Pettersson,D,PIT,28,78,6,25,31
31,8477506,Ryan Pulock,D,NYI,30,80,6,25,31
31,8476331,Dylan DeMelo,D,WPG,31,70,5,26,31
31,8476917,Adam Pelech,D,NYI,30,79,3,28,31
31,8480855,Jack McBain,C,UTA,24,66,13,17,30
31,8476925,Colton Sissons,C,NSH,31,73,13,17,30
31,8482175,JJ Peterka,R,BUF,22,65,12,18,30
31,8481577,Philip Tomasino,C,NSH,23,65,11,19,30
31,8477987,Ryan Donato,C,CHI,28,60,10,20,30
31,8483490,Pavel Mintyukov,D,ANA,21,70,9,21,30
31,8480817,K'Andre Miller,D,NYR,24,74,6,24,30
31,8482705,Cole Sillinger,C,CBJ,21,65,20,9,29
31,8479390,Taylor Raddysh,R,WSH,26,66,18,11,29
31,8481032,Paul Cotter,C,NJD,25,65,17,12,29
31,8480813,Joe Veleno,C,DET,24,73,16,13,29
31,8481535,Nils Hoglander,L,VAN,24,67,14,15,29
31,8476474,Stefan Noesen,R,NJD,31,60,14,15,29
31,8482105,Jake Sanderson,D,OTT,22,72,11,18,29
31,8482133,Thomas Bordeleau,C,SJS,22,60,11,18,29
31,8480871,Adam Boqvist,D,FLA,24,68,9,20,29
31,8481606,Jordan Spence,D,LAK,23,68,8,21,29
31,8476461,Sean Couturier,C,PHI,32,68,7,22,29
31,8479398,Samuel Girard,D,COL,26,67,7,22,29
31,8479982,Conor Timmins,D,TOR,26,66,7,22,29
31,8475200,Dmitry Orlov,D,CAR,33,75,6,23,29
31,8478413,Jordan Greenway,L,BUF,27,67,5,24,29
31,8480873,Rasmus Sandin,D,WSH,24,67,3,26,29
31,8474574,Tyler Myers,D,VAN,34,71,1,28,29
31,8479351,Sam Steel,C,DAL,26,80,14,14,28
31,8481481,Blake Lizotte,C,PIT,27,66,12,16,28
31,8477507,Nikita Zadorov,D,BOS,29,75,10,18,28
31,8473563,Nicklas Backstrom,C,WSH,37,55,9,19,28
31,8476872,Scott Laughton,C,PHI,30,72,8,20,28
31,8476923,Damon Severson,D,CBJ,30,79,6,22,28
31,8482122,Brock Faber,D,MIN,22,78,2,26,28
31,8481554,Kaapo Kakko,R,NYR,23,63,17,10,27
31,8478109,Victor Olofsson,L,VGK,29,75,17,10,27
31,8479619,Michael Carcone,L,UTA,28,62,17,10,27
31,8482079,Marco Rossi,C,MIN,23,60,15,12,27
31,8473533,Jordan Staal,C,CAR,36,58,14,13,27
31,8477839,Conor Sheary,L,TBL,32,80,12,15,27
31,8481477,Nico Sturm,C,SJS,29,56,12,15,27
31,8476921,Jordan Martinook,L,CAR,32,58,11,16,27
31,8478133,Jake Evans,C,MTL,28,68,10,17,27
31,8476467,Jamie Oleksiak,D,SEA,32,73,10,17,27
31,8479066,Ryan Lomberg,L,CGY,30,72,10,17,27
31,8476438,Brandon Saad,L,STL,32,67,17,9,26
31,8480459,Pius Suter,C,VAN,28,65,16,10,26
31,8476918,Jimmy Vesey,L,NYR,31,65,15,11,26
31,8476878,Zemgus Girgensons,C,TBL,30,78,14,12,26
31,8477478,William Carrier,L,CAR,30,56,13,13,26
31,8482749,Joshua Roy,R,MTL,21,66,13,13,26
31,8478115,Pierre Engvall,L,NYI,28,75,12,14,26
31,8481553,Bobby Brink,R,PHI,23,61,12,14,26
31,8479353,Brett Howden,C,VGK,26,69,11,15,26
31,8482111,Justin Barron,D,MTL,23,67,10,16,26
31,8476329,Travis Boyd,C,MIN,31,53,10,16,26
31,8476422,Mike Reilly,D,NYI,31,77,8,18,26
31,8481441,Joe Snively,C,DET,28,71,7,19,26
31,8477498,Darnell Nurse,D,EDM,29,76,5,21,26
31,8481014,Alexander Romanov,D,NYI,24,77,4,22,26
31,8482655,Janis Moser,D,TBL,24,77,4,22,26
31,8475764,Cam Fowler,D,ANA,33,78,3,23,26
31,8477845,Trevor van Riemsdyk,D,WSH,33,60,3,23,26
31,8480049,Dylan Samberg,D,WPG,25,63,1,25,26
31,8479661,Tanner Jeannot,L,LAK,27,81,12,13,25
31,8480078,Filip Chytil,C,NYR,25,69,12,13,25
31,8482117,Lukas Reichel,L,CHI,22,62,11,14,25
31,8483565,Nick Blankenburg,D,NSH,26,60,11,14,25
31,8480336,Sean Walker,D,CAR,30,72,10,15,25
31,8483457,Lane Hutson,D,MTL,20,68,10,15,25
31,8481624,Ilya Mikheyev,R,CHI,30,55,9,16,25
31,8482660,Kent Johnson,C,CBJ,22,60,8,17,25
31,8479639,Dylan Coghlan,D,WPG,26,66,7,18,25
31,8476463,Jonas Brodin,D,MIN,31,79,5,20,25
31,8478882,Vladislav Gavrikov,D,LAK,29,62,4,21,25
31,8473453,Trevor Lewis,C,LAK,37,75,14,10,24
31,8479368,Max Jones,L,BOS,26,69,12,12,24
31,8476897,Oskar Sundqvist,C,STL,30,63,11,13,24
31,8478463,Anthony Beauvillier,L,PIT,27,69,10,14,24
31,8480205,Emil Bemstrom,C,PIT,25,50,10,14,24
31,8470621,Corey Perry,R,EDM,39,71,8,16,24
31,8476960,Andreas Athanasiou,C,CHI,30,55,8,16,24
31,8482067,Connor Mackey,D,NYR,28,66,6,18,24
31,8478178,Darren Raddysh,D,TBL,28,69,6,18,24
31,8476979,Erik Gustafsson,D,DET,32,77,3,21,24
31,8478569,Noel Acciari,C,PIT,33,62,16,7,23
31,8476278,Colin Blackwell,C,DAL,31,80,15,8,23
31,8480762,Eric Robinson,L,CAR,29,52,14,9,23
31,8480281,Alexey Toropchenko,R,STL,25,55,14,9,23
31,8482259,Bobby McMann,C,TOR,28,67,13,10,23
31,8483493,Frank Nazar,C,CHI,20,52,11,12,23
31,8475149,Marcus Johansson,L,MIN,34,64,11,12,23
31,8475193,Tomas Tatar,L,NJD,34,64,11,12,23
31,8479414,Nathan Bastian,R,NJD,27,58,10,13,23
31,8477989,Christian Dvorak,C,MTL,28,64,9,14,23
31,8475171,Oliver Ekman-Larsson,D,TOR,33,69,6,17,23
31,8484149,Gavin Brindley,C,CBJ,20,56,6,17,23
31,8476442,Matt Nieto,L,PIT,32,47,6,17,23
31,8475462,Radko Gudas,D,ANA,34,68,5,18,23
31,8470600,Ryan Suter,D,STL,39,62,5,18,23
31,8481708,Zac Jones,D,NYR,24,54,5,18,23
31,8476429,Scott Mayfield,D,NYI,32,76,3,20,23
31,8478851,Alexandre Carrier,D,NSH,28,68,2,21,23
31,8473507,Jeff Petry,D,DET,37,74,1,22,23
31,8480789,Oliver Wahlstrom,R,NYI,24,69,16,6,22
31,8477425,Miles Wood,L,COL,29,74,13,9,22
31,8478043,Sam Lafferty,C,BUF,29,65,12,10,22
31,8481704,Juuso Parssinen,C,NSH,23,54,11,11,22
31,8477446,Michael McCarron,R,NSH,29,62,11,11,22
31,8477450,Jason Dickinson,C,CHI,29,54,10,12,22
31,8482809,Jackson Blake,R,CAR,21,65,10,12,22
31,8479293,Brandon Tanev,L,SEA,33,54,9,13,22
31,8476525,Colin Miller,D,WPG,32,68,8,14,22
31,8477919,Frederick Gaudreau,C,MIN,31,65,7,15,22
31,8477015,Connor Brown,R,EDM,30,62,7,15,22
31,8477369,Carson Soucy,D,VAN,30,66,6,16,22
31,8475791,Taylor Hall,L,CHI,33,55,5,17,22
31,8479980,Nicolas Hague,D,VGK,26,60,5,17,22
31,8474151,Ryan McDonagh,D,TBL,35,75,5,17,22
31,8478416,Erik Cernak,D,TBL,27,75,4,18,22
31,8476891,Matthew Grzelcyk,D,PIT,30,73,4,18,22
31,8476931,Jake McCabe,D,TOR,31,63,2,20,22
31,8481601,Simon Holmstrom,R,NYI,23,65,15,6,21
31,8477952,Robby Fabbri,C,ANA,28,65,13,8,21
31,8478508,Yakov Trenin,C,MIN,27,57,11,10,21
31,8481522,Peyton Krebs,C,BUF,23,63,10,11,21
31,8480289,Morgan Barron,C,WPG,26,59,10,11,21
31,8483491,Ivan Miroshnichenko,L,WSH,20,54,10,11,21
31,8480980,Connor Dewar,C,TOR,25,68,9,12,21
31,8480835,Jack Drury,C,CAR,24,57,8,13,21
31,8480003,Jesper Boqvist,C,FLA,26,68,8,13,21
31,8478970,Jalen Chatfield,D,CAR,28,69,6,15,21
31,8482142,Jamie Drysdale,D,PHI,22,63,6,15,21
31,8476624,Barclay Goodrow,C,SJS,31,49,6,15,21
31,8475855,Jesper Fast,R,CAR,33,62,5,16,21
31,8476879,Cody Ceci,D,EDM,31,72,3,18,21
31,8478507,John Marino,D,UTA,27,67,3,18,21
31,8480246,Nick Perbix,D,TBL,26,71,3,18,21
31,8480807,Mattias Samuelsson,D,BUF,24,61,2,19,21
31,8478831,Kevin Stenlund,C,UTA,28,54,15,5,20
31,8482074,Connor Zary,C,CGY,23,60,13,7,20
31,8481617,Vasily Podkolzin,R,VAN,23,55,12,8,20
31,8480074,Alexandre Texier,C,STL,25,63,10,10,20
31,8476392,Adam Lowry,C,WPG,31,60,9,11,20
31,8479336,Carl Grundstrom,R,SJS,27,56,9,11,20
31,8483499,Liam Ohgren,L,MIN,20,57,9,11,20
31,8475343,Nic Dowd,C,WSH,34,58,8,12,20
31,8481093,Rafael Harvey-Pinard,L,MTL,25,61,7,13,20
31,8480878,Nils Lundkvist,D,DAL,24,71,5,15,20
31,8477488,Brett Pesce,D,NJD,30,69,4,16,20
31,8476988,Matt Benning,D,SJS,30,64,4,16,20
31,8475790,Erik Gudbranson,D,CBJ,32,77,2,18,20
31,8475179,Dmitry Kulikov,D,FLA,34,65,2,18,20
31,8475324,Nick Jensen,D,OTT,34,70,2,18,20
31,8482125,Alexander Holtz,R,VGK,22,65,12,7,19
31,8482101,Danil Gushchin,L,SJS,22,67,8,11,19
31,8479996,Cody Glass,C,NSH,25,55,8,11,19
31,8478211,Dryden Hunt,L,CGY,29,52,8,11,19
31,8482679,Matt Coronato,R,CGY,22,66,8,11,19
31,8481580,Connor McMichael,C,WSH,23,55,7,12,19
31,8482157,Will Cuylle,L,NYR,22,63,7,12,19
31,8476469,Joel Armia,R,MTL,31,65,6,13,19
31,8476822,Luke Glendening,C,TBL,35,76,6,13,19
31,8479328,Julien Gauthier,R,NYI,27,64,6,13,19
31,8478399,Jonas Siegenthaler,D,NJD,27,60,5,14,19
31,8480035,Henri Jokiharju,D,BUF,25,60,4,15,19
31,8476856,Mathew Dumba,D,DAL,30,70,4,15,19
31,8474013,Ian Cole,D,UTA,35,52,4,15,19
31,8479402,Jake Bean,D,CGY,26,61,3,16,19
31,8480172,Jan Rutta,D,SJS,34,45,3,16,19
31,8475233,David Savard,D,MTL,34,74,2,17,19
31,8478585,Derek Ryan,C,EDM,38,60,13,5,18
31,8479344,Jesse Puljujarvi,R,PIT,26,50,10,8,18
31,8479543,Michael Pezzetta,L,MTL,26,55,9,9,18
31,8478432,Christian Fischer,R,DET,27,71,7,11,18
31,8479316,Luke Kunin,C,SJS,27,53,6,12,18
31,8477380,Jonny Brodzinski,C,NYR,31,58,5,13,18
31,8479998,Mikey Anderson,D,LAK,25,60,4,14,18
31,8478136,Jake Middleton,D,MIN,28,72,3,15,18
31,8479976,Juuso Valimaki,D,UTA,26,65,2,16,18
31,8475181,Nick Leddy,D,STL,33,70,1,17,18
31,8482062,Cole Smith,L,NSH,29,56,13,4,17
31,8482762,Simon Edvinsson,D,DET,21,50,10,7,17
31,8482155,Alex Laferriere,R,LAK,23,66,9,8,17
31,8480448,Parker Kelly,L,COL,25,73,9,8,17
31,8477931,Tomas Nosek,L,FLA,32,56,9,8,17
31,8482634,Alex Steeves,C,TOR,25,46,9,8,17
31,8480355,Mark Kastelic,C,BOS,25,57,9,8,17
31,8480025,MacKenzie Entwistle,R,FLA,25,64,8,9,17
31,8483468,Jiri Kulich,C,BUF,20,50,7,10,17
31,8477353,Tyler Motte,C,DET,29,74,6,11,17
31,8479983,Mario Ferraro,D,SJS,26,71,5,12,17
31,8482730,Brandt Clarke,D,LAK,21,53,5,12,17
31,8481568,Alex Vlasic,D,CHI,23,57,3,14,17
31,8478840,Will Borgen,D,SEA,28,66,3,14,17
31,8480058,Pierre-Olivier Joseph,D,STL,25,48,3,14,17
31,8476874,Olli Maatta,D,DET,30,60,3,14,17
31,8479324,Ryan Lindgren,D,NYR,26,60,2,15,17
31,8475188,Brayden McNabb,D,VGK,33,57,1,16,17
31,8478434,Keegan Kolesar,R,VGK,27,63,11,5,16
31,8481517,Brett Leason,R,ANA,25,63,9,7,16
31,8474189,Lars Eller,C,PIT,35,62,8,8,16
31,8476873,Mark Jankowski,C,NSH,30,52,7,9,16
31,8481019,David Gustafsson,C,WPG,24,46,6,10,16
31,8480144,David Kampf,C,TOR,29,69,3,13,16
31,8477435,Ryan Graves,D,PIT,29,71,2,14,16
31,8480727,Zach Whitecloud,D,VGK,28,52,2,14,16
31,8481028,Martin Pospisil,C,CGY,25,46,11,4,15
31,8480806,Isac Lundestrom,C,ANA,25,57,7,8,15
31,8477979,Nicolas Aube-Kubel,R,BUF,28,57,7,8,15
31,8482859,Zack Ostapchuk,C,OTT,21,43,7,8,15
31,8477406,Mattias Janmark,C,EDM,32,63,6,9,15
31,8479986,Kole Lind,R,DAL,26,54,6,9,15
31,8476902,Esa Lindell,D,DAL,30,74,5,10,15
31,8477018,Ben Hutton,D,VGK,31,47,5,10,15
31,8479536,Axel Jonsson-Fjallby,L,WPG,26,39,5,10,15
31,8480222,Sebastian Aho,D,PIT,28,77,4,11,15
31,8481537,Nikita Okhotiuk,D,CGY,24,54,4,11,15
31,8477903,Garnet Hathaway,R,PHI,33,57,4,11,15
31,8482073,Braden Schneider,D,NYR,23,63,4,11,15
31,8479026,Philippe Myers,D,TOR,27,46,4,11,15
31,8478859,Niko Mikkola,D,FLA,28,55,4,11,15
31,8484254,Akito Hirose,D,VAN,25,38,4,11,15
31,8474673,TJ Brodie,D,CHI,34,60,2,13,15
31,8479372,Joshua Mahura,D,SEA,26,49,2,13,15
31,8479371,Dante Fabbro,D,NSH,26,62,2,13,15
31,8482095,Tyler Kleven,D,OTT,22,48,1,14,15
31,8480073,Erik Brannstrom,D,COL,25,60,0,15,15
31,8475279,Ben Chiarot,D,DET,33,70,0,15,15
31,8482148,Hendrix Lapierre,C,WSH,22,52,10,4,14
31,8476374,Sean Kuraly,C,CBJ,31,56,8,6,14
31,8481641,Joel Kiviranta,L,COL,28,72,8,6,14
31,8480252,Cole Guttman,C,CHI,25,29,8,6,14
31,8482652,Walker Duehr,R,CGY,27,44,8,6,14
31,8476889,Radek Faksa,C,STL,30,59,6,8,14
31,8483482,Tristan Luneau,D,ANA,20,63,6,8,14
31,8477070,Liam O'Brien,C,UTA,30,58,6,8,14
31,8483495,Simon Nemec,D,NJD,20,54,6,8,14
31,8477962,Brendan Lemieux,L,CAR,28,37,6,8,14
31,8479772,Zack MacEwen,R,OTT,28,56,4,10,14
31,8480891,Michael Kesselring,D,UTA,24,55,3,11,14
31,8476967,Brett Kulak,D,EDM,30,62,3,11,14
31,8481059,Scott Perunovich,D,STL,26,59,3,11,14
31,8480887,Jordan Harris,D,MTL,24,56,3,11,14
31,8475690,Chris Tanev,D,TOR,35,58,2,12,14
31,8478451,Ethan Bear,D,WSH,27,48,2,12,14
31,8474090,Brendan Smith,D,DAL,35,53,2,12,14
31,8480950,Ilya Lyubushkin,D,DAL,30,59,1,13,14
31,8473446,Erik Johnson,D,PHI,36,61,1,13,14
31,8471709,Marc-Edouard Vlasic,D,SJS,37,64,0,14,14
31,8475842,Sam Carrick,C,NYR,32,58,10,3,13
31,8481518,Nolan Foote,L,NJD,24,49,9,4,13
31,8479370,Tyson Jost,C,CAR,26,52,7,6,13
31,8480021,Jack Studnicka,C,LAK,25,59,7,6,13
31,8479359,Beck Malenstyn,L,BUF,26,46,7,6,13
31,8482666,Scott Morrow,D,CAR,22,48,7,6,13
31,8477499,Rasmus Ristolainen,D,PHI,30,57,5,8,13
31,8482803,Olen Zellweger,D,ANA,21,61,5,8,13
31,8479718,Alex Barré-Boulet,C,MTL,27,53,5,8,13
31,8481609,Vladislav Kolyachonok,D,UTA,23,43,4,9,13
31,8477365,Connor Clifton,D,BUF,29,55,3,10,13
31,8482176,Wyatt Kaiser,D,CHI,22,51,3,10,13
31,8476457,Adam Larsson,D,SEA,32,67,2,11,13
31,8480043,Timothy Liljegren,D,TOR,25,59,2,11,13
31,8481167,Brayden Pachal,D,CGY,25,41,2,11,13
31,8482861,Vincent Iorio,D,WSH,22,31,2,11,13
31,8481178,Egor Zamula,D,PHI,24,47,1,12,13
31,8480860,Kevin Bahl,D,CGY,24,64,0,13,13
31,8479638,Justin Brazeau,R,BOS,26,37,9,3,12
31,8482166,Shakir Mukhamadullin,D,SJS,22,59,7,5,12
31,8479941,Justin Danforth,R,CBJ,31,53,6,6,12
31,8483466,Kevin Korchinski,D,CHI,20,45,6,6,12
31,8478421,A.J. Greer,L,FLA,28,57,6,6,12
31,8478424,Jansen Harkins,C,ANA,27,46,5,7,12
31,8480192,Johnathan Kovacevic,D,NJD,27,52,5,7,12
31,8481527,Kaedan Korczak,D,VGK,23,46,3,9,12
31,8475455,Brenden Dillon,D,NJD,34,58,3,9,12
31,8482192,Isaak Phillips,D,CHI,23,56,3,9,12
31,8481751,Lukas Rousek,R,BUF,25,38,3,9,12
31,8479671,Mathieu Olivier,R,CBJ,27,48,3,9,12
31,8480834,Ty Emberson,D,SJS,24,35,3,9,12
31,8478443,Brandon Carlo,D,BOS,28,55,2,10,12
31,8479315,Joey Anderson,R,CHI,26,50,1,11,12
31,8480796,Martin Fehervary,D,WSH,25,59,1,11,12
31,8480070,Ian Mitchell,D,BOS,25,47,1,11,12
31,8480157,Calle Rosen,D,COL,30,49,1,11,12
31,8478468,Jeremy Lauzon,D,NSH,27,55,1,11,12
31,8481592,Jakob Pelletier,L,CGY,23,44,8,3,11
31,8477573,Nathan Walker,L,STL,30,51,7,4,11
31,8477482,Zachary Sanford,L,CHI,30,35,7,4,11
31,8477220,Nate Schmidt,D,FLA,33,65,6,5,11
31,8481013,Jonatan Berggren,R,DET,24,56,6,5,11
31,8482737,Zack Bolduc,C,STL,21,51,5,6,11
31,8477508,Curtis Lazar,C,NJD,29,53,5,6,11
31,8480848,Ty Dellandrea,C,SJS,24,47,5,6,11
31,8479520,Brandon Duhaime,R,WSH,27,55,5,6,11
31,8479442,Troy Stecher,D,EDM,30,48,5,6,11
31,8481521,Ronnie Attard,D,PHI,25,57,4,7,11
31,8474567,Zach Bogosian,D,MIN,34,58,4,7,11
31,8477938,Haydn Fleury,D,WPG,28,39,4,7,11
31,8478452,Caleb Jones,D,LAK,27,52,4,7,11
31,8477887,Patrick Brown,C,BOS,32,48,4,7,11
31,8476312,Josh Manson,D,COL,33,60,3,8,11
31,8475225,Craig Smith,C,CHI,35,49,3,8,11
31,8474612,Travis Hamonic,D,OTT,34,49,2,9,11
31,8480011,Klim Kostin,C,SJS,25,50,9,1,10
31,8482077,Dylan Holloway,L,EDM,23,58,7,3,10
31,8476934,Brock McGinn,L,ANA,30,47,6,4,10
31,8481532,Alex Turcotte,C,LAK,23,40,6,4,10
31,8481754,Nikita Nesterenko,C,ANA,23,42,6,4,10
31,8479291,Kevin Rooney,C,CGY,31,57,5,5,10
31,8480995,Pontus Holmberg,R,TOR,25,64,5,5,10
31,8476867,Brendan Gaunce,C,MIN,30,37,5,5,10
31,8471817,Ryan Reaves,R,TOR,37,50,5,5,10
31,8483570,Ben Meyers,C,SEA,26,34,5,5,10
31,8476994,Vinnie Hinostroza,C,NSH,30,45,3,7,10
31,8474034,Patrick Maroon,L,CHI,36,47,3,7,10
31,8475750,Jon Merrill,D,MIN,32,57,3,7,10
31,8474166,Alec Martinez,D,CHI,37,58,3,7,10
31,8479378,Logan Stanley,D,WPG,26,47,2,8,10
31,8479249,Andrew Poturalski,C,SJS,30,30,1,9,10
31,8479968,Vinni Lettieri,C,BOS,29,52,6,3,9
31,8479972,Mason Shaw,C,WPG,26,39,5,4,9
31,8482153,Brendan Brisson,C,VGK,23,37,5,4,9
31,8482807,Ethan Del Mastro,D,CHI,21,39,3,6,9
31,8479439,Jacob MacDonald,D,COL,31,49,3,6,9
31,8475718,Justin Holl,D,DET,32,59,3,6,9
31,8479994,Jaret Anderson-Dolan,C,WPG,25,39,3,6,9
31,8482733,Logan Mailloux,D,MTL,31,34,3,6,9
31,8481600,Tobias Bjornfot,D,FLA,23,41,3,6,9
31,8483012,Logan Morrison,C,SEA,22,40,3,6,9
31,8480441,Trey Fix-Wolansky,R,CBJ,25,38,2,7,9
31,8481550,Adam Beckman,L,NJD,23,44,2,7,9
31,8480879,Jacob Bernard-Docker,D,OTT,24,35,2,7,9
31,8476441,Joel Edmundson,D,LAK,31,40,1,8,9
31,8481567,Henry Thrun,D,SJS,23,51,0,9,9
31,8477034,Jaycob Megna,D,FLA,32,42,0,9,9
31,8479981,Jonah Gadjovich,L,FLA,26,43,6,2,8
31,8480245,Olle Lycksell,R,PHI,25,31,5,3,8
31,8481543,Nikita Alexandrov,C,STL,24,30,5,3,8
31,8481716,Dmitri Voronkov,L,CBJ,24,38,5,3,8
31,8476858,Phillip Di Giuseppe,L,VAN,31,33,4,4,8
31,8479379,Givani Smith,R,SJS,26,29,4,4,8
31,8479369,Andrew Peeke,D,BOS,26,59,3,5,8
31,8475208,Brian Dumoulin,D,ANA,33,68,3,5,8
31,8476913,Devin Shore,C,MIN,30,36,3,5,8
31,8480196,Jacob Bryson,D,BUF,27,41,3,5,8
31,8484287,Cole McWard,D,VAN,23,22,3,5,8
31,8481599,Victor Soderstrom,D,UTA,23,43,2,6,8
31,8476473,Connor Murphy,D,CHI,31,41,2,6,8
31,8480001,Urho Vaakanainen,D,ANA,25,57,1,7,8
31,8475762,Derek Forbort,D,VAN,32,39,1,7,8
31,8481161,Jake Christiansen,D,CBJ,25,57,1,7,8
31,8481701,Santeri Hatakka,D,NJD,23,40,1,7,8
31,8482451,Mikael Pyyhtia,L,CBJ,23,49,1,7,8
31,8482659,Josh Doan,R,UTA,22,53,5,2,7
31,8482496,Nils Aman,C,VAN,24,39,5,2,7
31,8479944,Zach Aston-Reese,C,VGK,30,53,4,3,7
31,8482744,James Malatesta,L,CBJ,21,45,3,4,7
31,8482784,Zach Dean,C,STL,21,42,3,4,7
31,8482087,Kaiden Guhle,D,MTL,22,61,2,5,7
31,8477384,Joshua Brown,D,EDM,30,45,2,5,7
31,8481122,Simon Benoit,D,TOR,26,43,2,5,7
31,8474568,Luke Schenn,D,NSH,35,47,1,6,7
31,8477335,Kyle Burroughs,D,LAK,29,47,1,6,7
31,8483460,David Jiricek,D,CBJ,21,65,0,7,7
31,8483397,Marc McLaughlin,C,BOS,25,20,4,2,6
31,8482747,Brennan Othmann,L,NYR,21,41,3,3,6
31,8484911,Collin Graf,R,SJS,22,43,3,3,6
31,8482751,Ryan Winterton,C,SEA,21,33,3,3,6
31,8483549,Lucas Condotta,L,MTL,27,33,3,3,6
31,8481605,Jackson LaCombe,D,ANA,23,27,3,3,6
31,8474062,Riley Nash,C,NYR,35,12,3,3,6
31,8482141,Lukas Cormier,D,VGK,22,25,3,3,6
31,8481679,Maxence Guenette,D,OTT,23,33,3,3,6
31,8481598,Philip Broberg,D,EDM,23,36,2,4,6
31,8482511,Mason Lohrei,D,BOS,23,40,2,4,6
31,8480007,Jonas Rondbjerg,R,VGK,25,33,2,4,6
31,8482172,Landon Slaggert,L,CHI,22,28,2,4,6
31,8476372,Nick Seeler,D,PHI,31,41,1,5,6
31,8471677,Jack Johnson,D,CBJ,37,57,1,5,6
31,8478454,Noah Juulsen,D,VAN,27,35,1,5,6
31,8482964,Arber Xhekaj,D,MTL,23,40,4,1,5
31,8481789,Tye Kartye,L,SEA,23,45,4,1,5
31,8483763,Maksymilian Szuber,D,UTA,22,29,4,1,5
31,8483619,Filip Roos,D,OTT,25,33,3,2,5
31,8477320,Anton Blidh,L,NYR,29,20,3,2,5
31,8480880,Jakub Lauko,C,MIN,24,40,3,2,5
31,8479348,Kale Clague,D,BUF,26,30,2,3,5
31,8475235,Nicolas Deslauriers,L,PHI,33,47,2,3,5
31,8477473,Justin Bailey,R,SJS,29,19,2,3,5
31,8477971,Andreas Englund,D,LAK,28,34,2,3,5
31,8480890,Jan Jenik,C,OTT,24,24,2,3,5
31,8484325,Waltteri Merela,C,TBL,26,21,2,3,5
31,8477851,Jordan Oesterle,D,BOS,32,38,1,4,5
31,8482765,Isak Rosen,R,BUF,21,32,1,4,5
31,8477401,John Hayden,C,SEA,29,29,1,4,5
31,8477527,Ross Johnston,L,ANA,30,31,1,4,5
31,8483630,Pavol Regenda,L,ANA,25,26,1,4,5
31,8478017,Mark Friedman,D,VAN,29,43,0,5,5
31,8478874,Adam Gaudette,R,OTT,28,42,0,5,5
31,8484258,Sam Malinski,D,COL,26,25,0,5,5
31,8475177,Calvin de Haan,D,COL,33,37,3,1,4
31,8480845,Rasmus Kupari,C,WPG,24,46,3,1,4
31,8481556,John Beecher,C,BOS,23,35,3,1,4
31,8480990,Declan Chisholm,D,MIN,24,38,3,1,4
31,8482070,Mitchell Chaffee,R,TBL,26,58,3,1,4
31,8482165,Yan Kuznetsov,D,CGY,22,17,3,1,4
31,8482145,Mavrik Bourque,C,DAL,22,43,2,2,4
31,8482470,Ilya Solovyov,D,CGY,24,18,2,2,4
31,8478409,Anthony Richard,C,PHI,28,34,1,3,4
31,8478021,William Lagesson,D,DET,28,23,1,3,4
31,8480292,Carson Meyer,R,ANA,27,30,0,4,4
31,8478450,Parker Wotherspoon,D,BOS,27,31,0,4,4
31,8481699,Aku Raty,R,UTA,23,19,0,4,4
31,8477810,Joel Hanley,D,CGY,33,26,0,4,4
31,8482713,Mackie Samoskevich,R,FLA,22,39,2,1,3
31,8479367,William Lockwood,R,FLA,26,22,2,1,3
31,8481422,Jake Lucchini,C,NSH,29,20,2,1,3
31,8481056,Spencer Stastney,D,NSH,24,33,1,2,3
31,8475958,Michael Sgarbossa,C,WSH,32,23,1,2,3
31,8481743,Marc Del Gaizo,D,NSH,25,21,1,2,3
31,8475795,Dylan McIlrath,D,WSH,32,13,1,2,3
31,8481564,Ryan Johnson,D,BUF,23,19,1,2,3
31,8483471,Brad Lambert,C,WPG,31,12,1,2,3
31,8479419,Brett Murray,L,BUF,26,19,1,2,3
31,8482061,Brandon Biro,L,SEA,26,10,1,2,3
31,8477462,Robert Hagg,D,VGK,29,23,0,3,3
31,8479576,Vincent Desharnais,D,VAN,28,32,0,3,3
31,8482250,Callahan Burke,C,VGK,27,20,0,3,3
31,8479320,Maxime Lajoie,D,SEA,27,22,0,3,3
31,8481147,Reese Johnson,C,MIN,26,42,2,0,2
31,8481065,Angus Crookshank,L,OTT,25,18,2,0,2
31,8482147,Jean-Luc Foudy,C,COL,22,28,2,0,2
31,8478147,Bokondji Imama,L,PIT,28,9,2,0,2
31,8482144,Jack Thompson,D,SJS,22,33,1,1,2
31,8476952,Dominic Toninato,C,WPG,30,30,1,1,2
31,8478146,Matthew Highmore,C,OTT,28,33,1,1,2
31,8481237,Kyle MacLean,C,NYI,25,31,1,1,2
31,8482858,Ryker Evans,D,SEA,23,21,1,1,2
31,8481719,Maxwell Crozier,D,TBL,24,13,1,1,2
31,8483512,Matthew Savoie,C,EDM,20,22,1,1,2
31,8481806,Louis Crevier,D,CHI,23,15,1,1,2
31,8482094,Daemon Hunt,D,MIN,22,21,1,1,2
31,8481585,Egor Afanasyev,L,SJS,23,18,1,1,2
31,8479362,Riley Tufte,L,BOS,26,22,1,1,2
31,8483395,Arshdeep Bains,L,VAN,23,10,1,1,2
31,8480870,Bo Groulx,C,NYR,24,28,0,2,2
31,8481006,Tyler Tucker,D,STL,24,18,0,2,2
31,8479991,Jake Leschyshyn,C,NYR,25,28,0,2,2
31,8482102,Vasily Ponomarev,C,PIT,22,14,0,2,2
31,8479330,Brandon Gignac,C,MTL,27,14,0,2,2
31,8482201,Gage Goncalves,C,TBL,23,21,0,2,2
31,8481206,John Ludvig,D,PIT,24,16,0,2,2
31,8478502,Dennis Gilbert,D,BUF,28,20,0,2,2
31,8481541,Samuel Bolduc,D,NYI,24,16,0,2,2
31,8478051,Max Willman,C,NJD,29,18,0,2,2
31,8480823,Alexander Alexeyev,D,WSH,25,14,0,2,2
31,8480267,Sammy Walker,C,MIN,25,11,1,0,1
31,8480874,Adam Ginning,D,PHI,24,10,1,0,1
31,8482476,Emil Heineman,L,MTL,23,9,1,0,1
31,8483407,Brandon Scanlin,D,NYR,25,5,1,0,1
31,8477073,Kurtis MacDermid,L,NJD,30,28,1,0,1
31,8475413,Justin Dowling,C,NJD,34,10,1,0,1
31,8483597,Milos Kelemen,L,UTA,25,15,1,0,1
31,8480032,Shane Bowers,C,NJD,25,13,1,0,1
31,8478881,Brett Seney,L,CHI,28,11,1,0,1
31,8482162,Roby Jarventie,L,EDM,22,12,1,0,1
31,8481578,Graeme Clarke,R,MIN,23,10,1,0,1
31,8481655,Cole Schwindt,R,CGY,23,5,1,0,1
31,8480844,Grigori Denisenko,L,VGK,24,26,0,1,1
31,8479587,Rhett Gardner,C,PHI,28,19,0,1,1
31,8479985,Cale Fleury,D,SEA,26,21,0,1,1
31,8477244,Chad Ruhwedel,D,NYR,34,31,0,1,1
31,8482177,Marat Khusnutdinov,C,MIN,22,37,0,1,1
31,8483489,Fraser Minten,C,TOR,31,10,0,1,1
31,8477149,Scott Sabourin,R,SJS,32,14,0,1,1
31,8480851,Akil Thomas,C,LAK,24,19,0,1,1
31,8484304,Uvis Balinskis,D,FLA,28,10,0,1,1
31,8477467,Gustav Olofsson,D,SEA,30,23,0,1,1
31,8482929,Emil Lilleberg,D,TBL,23,28,0,1,1
31,8481593,Jayden Struble,D,MTL,23,21,0,1,1
31,8480468,James Hamblin,L,EDM,25,17,0,1,1
31,8482118,Sam Colangelo,R,ANA,23,14,0,1,1
31,8477541,Dakota Mermis,D,TOR,30,8,0,1,1
31,8483920,Pierrick Dube,R,WSH,23,7,0,1,1
31,8483432,Luca Del Bel Belluz,C,CBJ,31,5,0,1,1
31,8482197,Adam Raska,R,MIN,23,6,0,1,1
31,8479522,Hardy Haman Aktell,D,WSH,26,5,0,1,1
31,8483045,Cameron Butler,R,CBJ,31,2,0,1,1
31,8478477,Mitchell Stephens,C,SEA,27,20,0,0,0
31,8481462,Mason Morelli,L,VGK,28,13,0,0,0
31,8482787,Nikita Chibrikov,R,WPG,31,6,0,0,0
31,8478446,Glenn Gawdin,C,LAK,27,8,0,0,0
31,8481726,Adam Edstrom,C,NYR,24,7,0,0,0
31,8481043,Cole Koepke,L,BOS,26,13,0,0,0
31,8478011,Louie Belpedio,D,PHI,28,16,0,0,0
31,8475755,Alexander Petrovic,D,DAL,32,8,0,0,0
31,8476323,Max McCormick,L,SEA,32,3,0,0,0
31,8484255,Jason Polin,R,COL,25,6,0,0,0
31,8483531,Brian Halonen,L,NJD,25,1,0,0,0
31,8481534,Raphael Lavoie,C,EDM,24,2,0,0,0
31,8482126,Emil Andrae,D,PHI,31,5,0,0,0
31,8482516,Matthew Kessel,D,STL,24,19,0,0,0
31,8480084,Nick DeSimone,D,NJD,30,16,0,0,0
31,8481030,Jack St. Ivany,D,PIT,25,12,0,0,0
31,8480075,Cameron Crotty,D,MIN,25,8,0,0,0
31,8481024,Linus Karlsson,C,VAN,25,5,0,0,0
31,8477993,Justin Kirkland,C,CGY,28,3,0,0,0
31,8483609,Adam Klapka,R,CGY,24,4,0,0,0
31,8479421,Jacob Moverare,D,LAK,26,4,0,0,0
31,8482088,Justin Sourdif,R,FLA,22,17,0,0,0
31,8480306,Grant Hutton,D,NYI,29,7,0,0,0
31,8478854,Ryan Shea,D,PIT,27,8,0,0,0
31,8483398,Declan Carlile,D,TBL,31,6,0,0,0
31,8475780,Chris Wagner,R,COL,33,6,0,0,0
31,8483401,Marc Johnstone,R,PIT,28,2,0,0,0
31,8483567,Georgii Merkulov,C,BOS,24,11,0,0,0
31,8478956,Samuel Laberge,L,NJD,27,0,0,0,0
31,8482460,Matt Rempe,C,NYR,22,14,0,0,0
31,8480274,Philip Kemp,D,EDM,25,1,0,0,0
31,8483546,Marshall Rifai,D,TOR,26,5,0,0,0
31,8484259,Ondrej Pavel,C,COL,31,1,0,0,0
31,8484326,Patrik Koch,D,UTA,28,0,0,0,0
31,8484321,Nikolas Matinpalo,D,OTT,26,4,0,0,0
31,8470794,Joe Pavelski,C,,40,0,0,0,0
31,8479321,Lucas Johansen,D,,27,0,0,0,0
31,8477950,Tony DeAngelo,D,,29,0,0,0,0
31,8471218,Blake Wheeler,R,,38,0,0,0,0
31,8475197,Tyson Barrie,D,,33,0,0,0,0
31,8474157,Max Pacioretty,L,,36,0,0,0,0
31,8475744,Evgeny Kuznetsov,C,,32,0,0,0,0
31,8474037,James van Riemsdyk,L,,35,0,0,0,0
31,8476907,Mackenzie MacEachern,L,,30,0,0,0,0
31,8480216,Jacob Peterson,C,,25,0,0,0,0
31,8474602,Justin Schultz,D,,34,0,0,0,0
31,8482222,Alexander Barabanov,L,,30,0,0,0,0
31,8474031,Kevin Shattenkirk,D,,35,0,0,0,0
31,8477330,Dominik Kubalik,L,,29,0,0,0,0
31,8480884,Calen Addison,D,,24,0,0,0,0
31,8475906,John Klingberg,D,,32,0,0,0,0
31,8480008,Adam Ruzicka,C,,25,0,0,0,0
31,8476884,Derrick Pouliot,D,,30,0,0,0,0
31,8476919,Chris Tierney,C,,30,0,0,0,0
31,8479415,Michael McLeod,C,,26,0,0,0,0
31,8474870,Tyler Johnson,C,,34,0,0,0,0
31,8470604,Jeff Carter,C,,39,0,0,0,0
31,8478104,Sammy Blais,L,,28,0,0,0,0
31,8474884,Mike Hoffman,C,,35,0,0,0,0
31,8481591,Sam Poulin,R,,23,0,0,0,0
31,8471274,Alex Goligoski,D,,39,0,0,0,0
31,8476871,Tanner Pearson,L,,32,0,0,0,0
31,8476393,Nick Cousins,C,,31,0,0,0,0
31,8479977,Kailer Yamamoto,R,,26,0,0,0,0
31,8479346,Dillon Dube,C,,26,0,0,0,0
31,8480184,Gustav Lindstrom,D,,26,0,0,0,0
31,8479376,Victor Mete,D,,26,0,0,0,0
31,8473449,Kyle Okposo,R,,36,0,0,0,0
31,8481058,Jesse Ylonen,R,,25,0,0,0,0
31,8475752,Tyler Pitlick,C,,33,0,0,0,0
31,8481239,Samuel Fagemo,L,,24,0,0,0,0
31,8480821,Filip Zadina,R,,25,0,0,0,0
31,8470966,Mark Giordano,D,,41,0,0,0,0
31,8478495,Denis Gurianov,R,,27,0,0,0,0
31,8477464,Nic Petan,C,,29,0,0,0,0
31,8478099,Kevin Labanc,R,,29,0,0,0,0
31,8482241,Radim Zohorna,L,,28,0,0,0,0
31,8474040,Sam Gagner,C,,35,0,0,0,0
31,8479514,Rem Pitlick,C,,27,0,0,0,0
31,8478430,Oliver Kylington,D,,27,0,0,0,0
31,8479533,Joona Koppanen,L,,26,0,0,0,0
31,8479984,Cal Foote,D,,26,0,0,0,0
31,8477126,Jayson Megna,C,,34,0,0,0,0
31,8475164,Jakob Silfverberg,R,,34,0,0,0,0
31,8474009,Nick Bonino,C,,36,0,0,0,0
31,8479458,Nikita Zaitsev,D,,33,0,0,0,0
31,8477944,Jakub Vrana,L,,28,0,0,0,0
31,8471699,Andrew Cogliano,C,,37,0,0,0,0
31,8478067,Oskar Lindblom,L,,28,0,0,0,0
31,8471686,Marc Staal,D,,37,0,0,0,0
31,8470610,Zach Parise,L,,40,0,0,0,0
31,8478904,Steven Lorentz,C,,28,0,0,0,0
31,8473473,Milan Lucic,L,,36,0,0,0,0
31,8480031,Maxime Comtois,L,,25,0,0,0,0
31,8478512,Austin Czarnik,C,,32,0,0,0,0
31,8473504,Cal Clutterbuck,R,,37,0,0,0,0
31,8477454,Adam Erne,L,,29,0,0,0,0
31,8479383,Boris Katchouk,L,,26,0,0,0,0
31,8475825,Jani Hakanpää,D,,32,0,0,0,0
31,8477846,Ryan Carpenter,C,,33,0,0,0,0
31,8477930,Pierre-Edouard Bellemare,L,,39,0,0,0,0
31,8478400,Colin White,C,,27,0,0,0,0
31,8480226,Marián Studenic,R,,26,0,0,0,0
31,8480853,Liam Foudy,C,,24,0,0,0,0
31,8475797,Jarred Tinordi,D,,32,0,0,0,0
31,8479423,Alex Nylander,L,,26,0,0,0,0
31,8474618,Marco Scandella,D,,34,0,0,0,0
31,8478028,Fredrik Olofsson,L,,28,0,0,0,0
31,8474709,Matt Martin,L,,35,0,0,0,0
31,8481070,Hugh McGing,L,,26,0,0,0,0
31,8479546,Oskar Steen,C,,26,0,0,0,0
31,8474145,Robert Bortuzzo,D,,35,0,0,0,0
31,8476915,Jujhar Khaira,L,,30,0,0,0,0
31,8475278,Byron Froese,C,,33,0,0,0,0
31,8481812,Nikolai Knyzhov,D,,27,0,0,0,0
31,8478408,Travis Dermott,D,,28,0,0,0,0
31,8481077,John Leonard,L,,26,0,0,0,0
31,8479547,Matthew Phillips,R,,26,0,0,0,0
31,8480836,Jonathan Gruden,C,,24,0,0,0,0
31,8481690,Tyler Angle,C,,24,0,0,0,0
31,8475766,Austin Watson,L,,32,0,0,0,0
31,8481016,Ruslan Iskhakov,C,,24,0,0,0,0
31,8478078,Rourke Chartier,C,,28,0,0,0,0
31,8480776,Sheldon Rempal,R,,29,0,0,0,0
31,8484314,Jiri Smejkal,L,,28,0,0,0,0
32,8478402,Connor McDavid,C,EDM,27,79,46,99,145
32,8476453,Nikita Kucherov,R,TBL,31,82,40,103,143
32,8477492,Nathan MacKinnon,C,COL,29,82,47,89,136
32,8481559,Jack Hughes,C,NJD,23,78,54,79,133
32,8478420,Mikko Rantanen,R,COL,28,81,57,72,129
32,8477956,David Pastrnak,R,BOS,28,77,70,56,126
32,8479318,Auston Matthews,C,TOR,27,80,68,49,117
32,8479314,Matthew Tkachuk,L,FLA,27,80,35,80,115
32,8478403,Jack Eichel,C,VGK,28,80,56,57,113
32,8477934,Leon Draisaitl,C,EDM,29,78,42,66,108
32,8478427,Sebastian Aho,C,CAR,27,71,43,63,106
32,8476468,J.T. Miller,C,VAN,31,79,38,66,104
32,8480023,Robert Thomas,C,STL,25,80,34,68,102
32,8478864,Kirill Kaprizov,L,MIN,27,72,39,62,101
32,8480027,Jason Robertson,L,DAL,25,82,34,67,101
32,8477493,Aleksander Barkov,C,FLA,29,79,29,69,98
32,8477946,Dylan Larkin,C,DET,28,81,38,59,97
32,8480012,Elias Pettersson,C,VAN,26,77,43,53,96
32,8477404,Jake Guentzel,C,TBL,30,82,42,54,96
32,8476887,Filip Forsberg,L,NSH,30,76,39,53,92
32,8477939,William Nylander,R,TOR,28,77,39,53,92
32,8476389,Vincent Trocheck,C,NYR,31,77,38,53,91
32,8478010,Brayden Point,C,TBL,28,81,48,42,90
32,8477942,Kevin Fiala,L,LAK,28,82,37,53,90
32,8471675,Sidney Crosby,C,PIT,37,76,44,45,89
32,8478550,Artemi Panarin,L,NYR,33,77,29,60,89
32,8479343,Clayton Keller,R,UTA,26,73,40,48,88
32,8478449,Roope Hintz,C,DAL,28,82,40,48,88
32,8474564,Steven Stamkos,C,NSH,34,75,39,49,88
32,8482116,Tim Stützle,C,OTT,22,79,36,50,86
32,8480069,Cale Makar,D,COL,26,68,26,60,86
32,8478445,Mathew Barzal,C,NYI,27,80,26,59,85
32,8480800,Quinn Hughes,D,VAN,25,78,13,72,85
32,8475810,Bryan Rust,R,PIT,32,78,35,49,84
32,8484144,Connor Bedard,C,CHI,19,62,35,49,84
32,8481557,Matt Boldy,L,MIN,23,72,40,43,83
32,8478398,Kyle Connor,L,WPG,28,76,36,47,83
32,8477933,Sam Reinhart,C,FLA,29,79,37,45,82
32,8479385,Jordan Kyrou,C,STL,26,77,33,49,82
32,8480002,Nico Hischier,C,NJD,25,76,34,47,81
32,8475172,Nazem Kadri,C,CGY,34,79,29,52,81
32,8474141,Patrick Kane,R,DET,36,80,30,50,80
32,8476456,Jonathan Huberdeau,C,CGY,31,77,24,56,80
32,8475692,Mats Zuccarello,R,MIN,37,70,28,51,79
32,8478483,Mitch Marner,R,TOR,27,74,27,52,79
32,8473512,Claude Giroux,R,OTT,36,79,23,56,79
32,8482078,Lucas Raymond,L,DET,22,81,39,39,78
32,8478414,Timo Meier,R,NJD,28,76,31,47,78
32,8476459,Mika Zibanejad,C,NYR,31,78,28,50,78
32,8479407,Jesper Bratt,L,NJD,26,72,26,52,78
32,8480830,Andrei Svechnikov,R,CAR,24,76,35,42,77
32,8476346,Johnny Gaudreau,L,CBJ,31,73,23,54,77
32,8480036,Miro Heiskanen,D,DAL,25,75,18,59,77
32,8479337,Alex DeBrincat,R,DET,27,82,32,44,76
32,8478975,Mason Marchment,L,DAL,29,81,31,45,76
32,8480208,Drake Batherson,R,OTT,26,77,30,46,76
32,8473419,Brad Marchand,L,BOS,36,79,23,53,76
32,8477501,Valeri Nichushkin,R,COL,29,78,33,42,75
32,8475166,John Tavares,C,TOR,34,80,26,49,75
32,8479323,Adam Fox,D,NYR,26,70,17,58,75
32,8475184,Chris Kreider,L,NYR,33,72,44,30,74
32,8471215,Evgeni Malkin,C,PIT,38,72,29,45,74
32,8475913,Mark Stone,R,VGK,32,77,28,45,73
32,8477940,Nikolaj Ehlers,L,WPG,28,71,23,50,73
32,8481711,Matias Maccelli,L,UTA,24,78,16,57,73
32,8480018,Nick Suzuki,C,MTL,25,76,21,51,72
32,8480865,Noah Dobson,D,NYI,24,79,13,59,72
32,8477500,Bo Horvat,C,NYI,29,78,36,35,71
32,8477402,Pavel Buchnevich,L,STL,29,77,18,53,71
32,8482093,Seth Jarvis,C,CAR,22,70,35,35,70
32,8475765,Vladimir Tarasenko,R,DET,33,80,25,45,70
32,8477951,Nick Schmaltz,C,UTA,28,77,24,46,70
32,8477504,Josh Morrissey,D,WPG,29,76,13,56,69
32,8477409,Carter Verhaeghe,C,FLA,29,79,43,25,68
32,8478493,Joel Eriksson Ek,C,MIN,27,69,36,32,68
32,8475168,Matt Duchene,C,DAL,33,81,32,36,68
32,8479542,Brandon Hagel,L,TBL,26,82,31,37,68
32,8474600,Roman Josi,D,NSH,34,72,23,45,68
32,8471214,Alex Ovechkin,L,WSH,39,73,36,31,67
32,8478873,Troy Terry,R,ANA,27,76,33,34,67
32,8477955,Jared McCann,L,SEA,28,80,32,35,67
32,8481528,Dylan Cozens,C,BUF,23,73,24,43,67
32,8476454,Ryan Nugent-Hopkins,C,EDM,31,77,23,44,67
32,8475798,Mikael Granlund,C,SJS,32,74,13,54,67
32,8481540,Cole Caufield,R,MTL,23,76,31,35,66
32,8478460,Zach Werenski,D,CBJ,27,79,14,52,66
32,8475786,Zach Hyman,L,EDM,32,78,36,29,65
32,8476539,Jonathan Marchessault,R,NSH,34,74,36,29,65
32,8475754,Brock Nelson,C,NYI,33,79,32,32,64
32,8482740,Wyatt Johnston,C,DAL,21,81,32,32,64
32,8477964,Ivan Barbashev,C,VGK,29,74,27,37,64
32,8477494,Jonathan Drouin,L,COL,29,82,25,39,64
32,8475158,Ryan O'Reilly,C,NSH,33,73,20,44,64
32,8476905,Chandler Stephenson,C,SEA,30,74,19,45,64
32,8474578,Erik Karlsson,D,PIT,34,81,16,48,64
32,8477935,Sam Bennett,C,FLA,28,78,32,31,63
32,8477960,Adrian Kempe,R,LAK,28,81,31,32,63
32,8480801,Brady Tkachuk,L,OTT,25,81,28,35,63
32,8480039,Martin Necas,C,CAR,25,70,28,35,63
32,8478047,Michael Bunting,L,PIT,29,66,26,37,63
32,8477416,Oliver Bjorkstrand,R,SEA,29,76,25,38,63
32,8475167,Victor Hedman,D,TBL,34,80,14,49,63
32,8478444,Brock Boeser,R,VAN,27,72,30,32,62
32,8477496,Elias Lindholm,C,BOS,30,79,26,36,62
32,8482113,Anton Lundell,C,FLA,23,78,25,37,62
32,8481533,Trevor Zegras,C,ANA,23,68,18,44,62
32,8478440,Dylan Strome,C,WSH,27,70,18,44,62
32,8477511,Anthony Mantha,R,CGY,30,74,30,31,61
32,8480064,Josh Norris,C,OTT,25,80,32,28,60
32,8480188,Fabian Zetterlund,L,SJS,25,66,28,32,60
32,8482159,Tyson Foerster,R,PHI,22,73,27,33,60
32,8474150,Mikael Backlund,C,CGY,35,78,25,35,60
32,8481596,Shane Pinto,C,OTT,24,71,24,36,60
32,8475170,Brayden Schenn,C,STL,33,74,24,36,60
32,8478439,Travis Konecny,R,PHI,27,74,23,37,60
32,8478396,Noah Hanifin,D,VGK,27,56,17,43,60
32,8478469,Thomas Chabot,D,OTT,27,75,15,45,60
32,8478038,Devon Toews,D,COL,30,66,13,47,60
32,8476462,Dougie Hamilton,D,NJD,31,71,12,48,60
32,8478401,Pavel Zacha,C,BOS,27,78,26,33,59
32,8476881,Tomas Hertl,C,VGK,31,80,21,38,59
32,8475726,Tyler Toffoli,C,SJS,32,71,35,23,58
32,8476460,Mark Scheifele,C,WPG,31,76,27,31,58
32,8478042,Viktor Arvidsson,L,EDM,31,79,27,31,58
32,8475794,Tyler Seguin,C,DAL,32,80,27,31,58
32,8476448,William Karlsson,C,VGK,31,74,26,32,58
32,8482665,Matty Beniers,C,SEA,22,77,17,41,58
32,8480803,Evan Bouchard,D,EDM,25,76,14,44,58
32,8478397,Rasmus Andersson,D,CGY,28,72,12,46,58
32,8479675,Trevor Moore,L,LAK,29,77,28,29,57
32,8479420,Tage Thompson,C,BUF,27,76,26,31,57
32,8477949,Alex Tuch,R,BUF,28,73,20,37,57
32,8476880,Tom Wilson,R,WSH,30,71,23,33,56
32,8477447,Shea Theodore,D,VGK,29,69,15,41,56
32,8476906,Shayne Gostisbehere,D,CAR,31,76,12,44,56
32,8481068,Yegor Sharangovich,C,CGY,26,79,31,24,55
32,8475169,Evander Kane,L,EDM,33,77,27,28,55
32,8473994,Jamie Benn,L,DAL,35,81,18,37,55
32,8478407,Vince Dunn,D,SEA,28,77,17,38,55
32,8478438,Tommy Novak,C,NSH,27,74,17,38,55
32,8484153,Leo Carlsson,C,ANA,20,71,16,39,55
32,8477476,Artturi Lehkonen,L,COL,29,80,25,29,54
32,8483808,Andrei Kuzmenko,L,CGY,28,79,20,34,54
32,8482124,Quinton Byfield,R,LAK,22,81,19,35,54
32,8474679,Gustav Nyquist,C,NSH,35,75,12,42,54
32,8480434,Sean Durzi,D,UTA,26,73,10,44,54
32,8477407,Anthony Duclair,L,NYI,29,78,28,25,53
32,8474102,David Perron,L,OTT,36,80,20,33,53
32,8475745,Charlie Coyle,C,BOS,32,75,16,37,53
32,8480839,Rasmus Dahlin,D,BUF,24,66,16,37,53
32,8476875,Mike Matheson,D,MTL,30,76,12,41,53
32,8479325,Charlie McAvoy,D,BOS,27,71,3,50,53
32,8478498,Jake DeBrusk,L,VAN,28,67,28,24,52
32,8482699,Dylan Guenther,R,UTA,21,72,25,27,52
32,8477021,Alex Kerfoot,C,UTA,30,72,19,33,52
32,8479999,Casey Mittelstadt,C,COL,26,81,15,37,52
32,8481703,Valtteri Puustinen,R,PIT,25,61,13,39,52
32,8476399,Blake Coleman,C,CGY,33,80,29,22,51
32,8480015,Owen Tippett,R,PHI,25,75,24,27,51
32,8478856,Conor Garland,R,VAN,28,69,21,30,51
32,8482745,Mason McTavish,C,ANA,21,69,20,31,51
32,8478466,Daniel Sprong,R,VAN,27,71,18,33,51
32,8470613,Brent Burns,D,CAR,39,77,17,34,51
32,8476483,Rickard Rakell,R,PIT,31,75,24,26,50
32,8475314,Anders Lee,L,NYI,34,80,23,27,50
32,8477456,J.T. Compher,L,DET,29,80,18,32,50
32,8477495,Seth Jones,D,CHI,30,70,13,37,50
32,8474565,Alex Pietrangelo,D,VGK,34,66,11,39,50
32,8477839,Conor Sheary,L,TBL,32,81,19,30,49
32,8475784,Jeff Skinner,C,EDM,32,76,17,32,49
32,8481656,Aliaksei Protas,C,WSH,23,69,13,36,49
32,8479987,Morgan Geekie,C,BOS,26,78,22,26,48
32,8482149,Cole Perfetti,C,WPG,22,68,19,29,48
32,8478542,Evan Rodrigues,C,FLA,31,80,17,31,48
32,8483505,Matthew Poitras,C,BOS,20,77,14,34,48
32,8481542,Moritz Seider,D,DET,23,76,9,39,48
32,8471724,Kris Letang,D,PIT,37,80,8,40,48
32,8482684,Luke Hughes,D,NJD,21,69,2,46,48
32,8478474,Lawson Crouse,L,UTA,27,75,23,24,47
32,8482109,Alexis Lafrenière,L,NYR,23,74,20,27,47
32,8480797,Joel Farabee,L,PHI,24,71,19,28,47
32,8477497,Sean Monahan,C,CBJ,30,63,19,28,47
32,8476479,Phillip Danault,C,LAK,31,79,15,32,47
32,8476958,Jaccob Slavin,D,CAR,30,73,6,41,47
32,8476432,Boone Jenner,C,CBJ,31,69,26,20,46
32,8480849,Barrett Hayton,C,UTA,24,70,23,23,46
32,8483431,Logan Cooley,C,UTA,20,77,14,32,46
32,8471685,Anze Kopitar,C,LAK,37,78,11,35,46
32,8476853,Morgan Rielly,D,TOR,30,66,8,38,46
32,8482110,Dawson Mercer,C,NJD,23,74,25,20,45
32,8477451,Ryan Hartman,R,MIN,30,67,19,26,45
32,8475191,Reilly Smith,R,NYR,33,76,19,26,45
32,8473986,Alex Killorn,L,ANA,35,74,18,27,45
32,8479400,Pierre-Luc Dubois,L,WSH,26,71,17,28,45
32,8484166,Adam Fantilli,C,CBJ,20,68,17,28,45
32,8477444,Andre Burakovsky,L,SEA,29,71,16,29,45
32,8479425,Filip Hronek,D,VAN,27,69,14,31,45
32,8476869,Brady Skjei,D,NSH,30,75,8,37,45
32,8474641,Adam Henrique,C,EDM,34,71,27,17,44
32,8479525,Ross Colton,C,COL,28,82,23,21,44
32,8476826,Yanni Gourde,C,SEA,33,67,18,26,44
32,8476419,Jean-Gabriel Pageau,C,NYI,32,77,17,27,44
32,8480336,Sean Walker,D,CAR,30,78,16,28,44
32,8477503,Max Domi,C,TOR,29,79,10,34,44
32,8474716,Jared Spurgeon,D,MIN,35,77,7,37,44
32,8475764,Cam Fowler,D,ANA,33,73,7,37,44
32,8480014,Gabriel Vilardi,C,WPG,25,67,26,17,43
32,8475151,Kyle Palmieri,C,NYI,33,78,23,20,43
32,8483515,Juraj Slafkovsky,L,MTL,20,73,21,22,43
32,8481581,Thomas Harley,D,DAL,23,72,13,30,43
32,8476458,Ryan Strome,C,ANA,31,66,11,32,43
32,8474590,John Carlson,D,WSH,34,64,10,33,43
32,8475753,Justin Faulk,D,STL,32,78,10,33,43
32,8474563,Drew Doughty,D,LAK,35,72,7,36,43
32,8480873,Rasmus Sandin,D,WSH,24,69,6,37,43
32,8475763,Kevin Hayes,R,PIT,32,66,21,21,42
32,8479345,Jakob Chychrun,D,WSH,26,64,19,23,42
32,8477998,Warren Foegele,L,LAK,28,79,19,23,42
32,8474149,Evgenii Dadonov,R,DAL,35,79,19,23,42
32,8477429,Andrew Copp,C,DET,30,81,19,23,42
32,8479339,Patrik Laine,L,CBJ,26,62,17,25,42
32,8476872,Scott Laughton,C,PHI,30,74,17,25,42
32,8478055,Gustav Forsling,D,FLA,28,66,14,28,42
32,8480028,Morgan Frost,C,PHI,25,75,13,29,42
32,8478519,Anthony Cirelli,C,TBL,27,82,13,29,42
32,8476792,Torey Krug,D,STL,33,69,13,29,42
32,8476461,Sean Couturier,C,PHI,32,70,9,33,42
32,8479410,Mikhail Sergachev,D,UTA,26,72,7,35,42
32,8475793,Ryan Johansen,C,PHI,32,68,23,18,41
32,8471698,T.J. Oshie,R,WSH,38,68,16,25,41
32,8482097,Jack Quinn,R,BUF,23,61,16,25,41
32,8478462,Nicolas Roy,C,VGK,27,78,14,27,41
32,8475218,Mattias Ekholm,D,EDM,34,76,12,29,41
32,8475287,Erik Haula,L,NJD,33,64,17,23,40
32,8482720,Matthew Knies,L,TOR,22,76,16,24,40
32,8474053,Logan Couture,C,SJS,35,62,16,24,40
32,8482475,Yegor Chinakhov,R,CBJ,23,66,14,26,40
32,8476438,Brandon Saad,L,STL,32,76,23,16,39
32,8481604,Pavel Dorofeyev,L,VGK,24,71,22,17,39
32,8475768,Jaden Schwartz,C,SEA,32,74,22,17,39
32,8478233,Andrew Mangiapane,L,WSH,28,72,21,18,39
32,8479591,Michael Eyssimont,C,TBL,28,81,19,20,39
32,8480068,Ryan Poehling,C,PHI,25,71,19,20,39
32,8481618,Alex Newhook,C,MTL,23,74,15,24,39
32,8478458,John (Jack) Roslovic,C,CAR,27,63,10,29,39
32,8478046,Danton Heinen,L,VAN,29,73,17,21,38
32,8478115,Pierre Engvall,L,NYI,28,76,16,22,38
32,8480802,Ryan McLeod,C,BUF,25,66,14,24,38
32,8477953,Kasperi Kapanen,R,STL,28,71,13,25,38
32,8476480,Vladislav Namestnikov,C,WPG,32,66,13,25,38
32,8480009,Eeli Tolvanen,R,SEA,25,73,12,26,38
32,8482146,Luke Evangelista,R,NSH,22,64,11,27,38
32,8477986,Brandon Montour,D,SEA,30,74,9,29,38
32,8478057,Dakota Joshua,C,VAN,28,63,9,29,38
32,8482089,Jake Neighbours,L,STL,22,68,24,13,37
32,8481560,Arthur Kaliyev,R,LAK,23,75,19,18,37
32,8484145,Zach Benson,L,BUF,19,70,18,19,37
32,8482702,Logan Stankoven,C,DAL,21,82,18,19,37
32,8476882,Teuvo Teravainen,C,CHI,30,67,17,20,37
32,8479992,Michael Rasmussen,C,DET,25,79,17,20,37
32,8480220,Noah Cates,L,PHI,25,72,13,24,37
32,8482667,William Eklund,L,SJS,22,56,12,25,37
32,8481546,Cam York,D,PHI,23,71,10,27,37
32,8482660,Kent Johnson,C,CBJ,22,63,10,27,37
32,8477346,MacKenzie Weegar,D,CGY,30,73,8,29,37
32,8482712,Oskar Olausson,R,COL,22,78,8,29,37
32,8483490,Pavel Mintyukov,D,ANA,21,76,8,29,37
32,8479365,Trent Frederic,C,BOS,26,81,15,21,36
32,8478366,Frank Vatrano,R,ANA,30,70,15,21,36
32,8481523,Kirby Dach,C,MTL,23,69,14,22,36
32,8474586,Jordan Eberle,R,SEA,34,76,13,23,36
32,8481524,Bowen Byram,D,BUF,23,74,13,23,36
32,8477932,Aaron Ekblad,D,FLA,28,73,11,25,36
32,8480798,Philipp Kurashev,C,CHI,25,66,11,25,36
32,8478109,Victor Olofsson,L,VGK,29,74,21,14,35
32,8475799,Nino Niederreiter,R,WPG,32,69,20,15,35
32,8475722,Jason Zucker,L,BUF,32,70,19,16,35
32,8480113,Alex Iafallo,L,WPG,31,65,12,23,35
32,8482671,Owen Power,D,BUF,22,68,10,25,35
32,8481441,Joe Snively,C,DET,28,67,10,25,35
32,8482122,Brock Faber,D,MIN,22,75,4,31,35
32,8477426,Nicholas Paul,L,TBL,29,82,21,13,34
32,8481186,Logan O'Connor,R,COL,28,78,18,16,34
32,8477505,Alexander Wennberg,C,SJS,30,61,17,17,34
32,8476927,Teddy Blueger,C,VAN,30,67,15,19,34
32,8482175,JJ Peterka,R,BUF,22,74,15,19,34
32,8478013,Jake Walman,D,SJS,28,72,11,23,34
32,8480871,Adam Boqvist,D,FLA,24,72,10,24,34
32,8480043,Timothy Liljegren,D,TOR,25,63,3,31,34
32,8474715,Cameron Atkinson,R,TBL,35,80,19,14,33
32,8477952,Robby Fabbri,C,ANA,28,65,19,14,33
32,8482133,Thomas Bordeleau,C,SJS,22,62,12,21,33
32,8476885,Jacob Trouba,D,NYR,30,72,10,23,33
32,8482092,Ridly Greig,C,OTT,22,77,9,24,33
32,8477425,Miles Wood,L,COL,29,77,21,11,32
32,8482105,Jake Sanderson,D,OTT,22,77,15,17,32
32,8479996,Cody Glass,C,NSH,25,67,13,19,32
32,8482624,Daniil Miromanov,D,CGY,27,65,11,21,32
32,8481577,Philip Tomasino,C,NSH,23,67,10,22,32
32,8482809,Jackson Blake,R,CAR,21,59,10,22,32
32,8481553,Bobby Brink,R,PHI,23,66,9,23,32
32,8477488,Brett Pesce,D,NJD,30,71,8,24,32
32,8478507,John Marino,D,UTA,27,66,6,26,32
32,8476463,Jonas Brodin,D,MIN,31,79,4,28,32
32,8478020,Michael Amadio,R,OTT,28,74,17,14,31
32,8481554,Kaapo Kakko,R,NYR,23,70,14,17,31
32,8477987,Ryan Donato,C,CHI,28,66,13,18,31
32,8477478,William Carrier,L,CAR,30,53,13,18,31
32,8481535,Nils Hoglander,L,VAN,24,73,12,19,31
32,8476979,Erik Gustafsson,D,DET,32,77,5,26,31
32,8482245,Artem Zub,D,OTT,29,77,4,27,31
32,8478891,Mason Appleton,C,WPG,28,69,20,10,30
32,8475714,Calle Jarnkrok,C,TOR,33,77,15,15,30
32,8478413,Jordan Greenway,L,BUF,27,59,15,15,30
32,8480829,Jesperi Kotkaniemi,C,CAR,24,64,11,19,30
32,8480185,Eetu Luostarinen,C,FLA,26,75,9,21,30
32,8476292,Ondrej Palat,L,NJD,33,69,8,22,30
32,8480817,K'Andre Miller,D,NYR,24,75,6,24,30
32,8475760,Nick Bjugstad,C,UTA,32,73,19,10,29
32,8476474,Stefan Noesen,R,NJD,31,70,18,11,29
32,8483524,Shane Wright,C,SEA,20,62,14,15,29
32,8482055,Drew O'Connor,L,PIT,26,66,13,16,29
32,8475848,Brendan Gallagher,R,MTL,32,71,13,16,29
32,8476878,Zemgus Girgensons,C,TBL,30,81,13,16,29
32,8474189,Lars Eller,C,PIT,35,51,13,16,29
32,8479368,Max Jones,L,BOS,26,63,12,17,29
32,8475193,Tomas Tatar,L,NJD,34,67,12,17,29
32,8479983,Mario Ferraro,D,SJS,26,74,9,20,29
32,8484203,Bradly Nadeau,L,CAR,19,60,7,22,29
32,8480145,Neal Pionk,D,WPG,29,74,6,23,29
32,8480893,Kirill Marchenko,R,CBJ,24,66,20,8,28
32,8475343,Nic Dowd,C,WSH,34,56,18,10,28
32,8476873,Mark Jankowski,C,NSH,30,49,16,12,28
32,8482705,Cole Sillinger,C,CBJ,21,68,14,14,28
32,8480855,Jack McBain,C,UTA,24,68,13,15,28
32,8473533,Jordan Staal,C,CAR,36,69,11,17,28
32,8477479,Tyler Bertuzzi,L,CHI,29,67,9,19,28
32,8475231,Casey Cizikas,C,NYI,33,70,6,22,28
32,8477969,Marcus Pettersson,D,PIT,28,77,6,22,28
32,8477506,Ryan Pulock,D,NYI,30,78,6,22,28
32,8477498,Darnell Nurse,D,EDM,29,68,6,22,28
32,8474151,Ryan McDonagh,D,TBL,35,77,4,24,28
32,8476917,Adam Pelech,D,NYI,30,77,1,27,28
32,8480459,Pius Suter,C,VAN,28,68,14,13,27
32,8480813,Joe Veleno,C,DET,24,78,13,14,27
32,8476921,Jordan Martinook,L,CAR,32,58,13,14,27
32,8481580,Connor McMichael,C,WSH,23,63,13,14,27
32,8473422,Nick Foligno,L,CHI,37,69,11,16,27
32,8476923,Damon Severson,D,CBJ,30,79,10,17,27
32,8480835,Jack Drury,C,CAR,24,66,9,18,27
32,8476331,Dylan DeMelo,D,WPG,31,69,5,22,27
32,8475790,Erik Gudbranson,D,CBJ,32,73,0,27,27
32,8475791,Taylor Hall,L,CHI,33,53,14,12,26
32,8476278,Colin Blackwell,C,DAL,31,76,12,14,26
32,8480748,Kiefer Sherwood,L,VAN,29,62,10,16,26
32,8476918,Jimmy Vesey,L,NYR,31,70,10,16,26
32,8483565,Nick Blankenburg,D,NSH,26,52,10,16,26
32,8476457,Adam Larsson,D,SEA,32,65,9,17,26
32,8478911,Matt Roy,D,WSH,29,64,7,19,26
32,8475200,Dmitry Orlov,D,CAR,33,69,6,20,26
32,8478882,Vladislav Gavrikov,D,LAK,29,67,6,20,26
32,8475149,Marcus Johansson,L,MIN,34,72,5,21,26
32,8477435,Ryan Graves,D,PIT,29,77,1,25,26
32,8480205,Emil Bemstrom,C,PIT,25,62,15,10,25
32,8477947,Sonny Milano,L,WSH,28,57,14,11,25
32,8482259,Bobby McMann,C,TOR,28,71,13,12,25
32,8481481,Blake Lizotte,C,PIT,27,57,12,13,25
32,8475855,Jesper Fast,R,CAR,33,62,12,13,25
32,8478463,Anthony Beauvillier,L,PIT,27,68,10,15,25
32,8480003,Jesper Boqvist,C,FLA,26,71,10,15,25
32,8470621,Corey Perry,R,EDM,39,71,9,16,25
32,8476429,Scott Mayfield,D,NYI,32,75,8,17,25
32,8480878,Nils Lundkvist,D,DAL,24,69,8,17,25
32,8479324,Ryan Lindgren,D,NYR,26,57,8,17,25
32,8476854,Hampus Lindholm,D,BOS,30,75,7,18,25
32,8479639,Dylan Coghlan,D,WPG,26,60,6,19,25
32,8481093,Rafael Harvey-Pinard,L,MTL,25,60,6,19,25
32,8482087,Kaiden Guhle,D,MTL,22,65,4,21,25
32,8482655,Janis Moser,D,TBL,24,76,3,22,25
32,8476879,Cody Ceci,D,EDM,31,70,1,24,25
32,8482079,Marco Rossi,C,MIN,23,57,12,12,24
32,8482125,Alexander Holtz,R,VGK,22,67,12,12,24
32,8481624,Ilya Mikheyev,R,CHI,30,63,11,13,24
32,8479393,Noah Gregor,L,OTT,26,72,10,14,24
32,8476925,Colton Sissons,C,NSH,31,66,10,14,24
32,8479976,Juuso Valimaki,D,UTA,26,65,8,16,24
32,8477948,Travis Sanheim,D,PHI,28,73,7,17,24
32,8475171,Oliver Ekman-Larsson,D,TOR,33,67,7,17,24
32,8479353,Brett Howden,C,VGK,26,65,6,18,24
32,8480035,Henri Jokiharju,D,BUF,25,67,5,19,24
32,8482067,Connor Mackey,D,NYR,28,62,4,20,24
32,8479398,Samuel Girard,D,COL,26,65,2,22,24
32,8479414,Nathan Bastian,R,NJD,27,59,15,8,23
32,8475225,Craig Smith,C,CHI,35,60,12,11,23
32,8482737,Zack Bolduc,C,STL,21,63,11,12,23
32,8478472,Mathieu Joseph,R,STL,27,67,9,14,23
32,8478133,Jake Evans,C,MTL,28,69,8,15,23
32,8482749,Joshua Roy,R,MTL,21,65,8,15,23
32,8477979,Nicolas Aube-Kubel,R,BUF,28,63,5,18,23
32,8483445,Cutter Gauthier,L,ANA,20,62,4,19,23
32,8476892,Colton Parayko,D,STL,31,73,3,20,23
32,8474574,Tyler Myers,D,VAN,34,66,3,20,23
32,8475208,Brian Dumoulin,D,ANA,33,54,3,20,23
32,8480078,Filip Chytil,C,NYR,25,64,11,11,22
32,8481582,Nicholas Robertson,L,TOR,23,64,10,12,22
32,8477446,Michael McCarron,R,NSH,29,55,10,12,22
32,8477450,Jason Dickinson,C,CHI,29,55,10,12,22
32,8481032,Paul Cotter,C,NJD,25,50,9,13,22
32,8477989,Christian Dvorak,C,MTL,28,58,9,13,22
32,8479941,Justin Danforth,R,CBJ,31,56,9,13,22
32,8476392,Adam Lowry,C,WPG,31,63,7,15,22
32,8482192,Isaak Phillips,D,CHI,23,53,7,15,22
32,8481059,Scott Perunovich,D,STL,26,52,4,18,22
32,8481606,Jordan Spence,D,LAK,23,69,3,19,22
32,8481704,Juuso Parssinen,C,NSH,23,53,13,8,21
32,8476981,Josh Anderson,R,MTL,30,65,12,9,21
32,8482117,Lukas Reichel,L,CHI,22,49,12,9,21
32,8479316,Luke Kunin,C,SJS,27,58,12,9,21
32,8481601,Simon Holmstrom,R,NYI,23,70,11,10,21
32,8479293,Brandon Tanev,L,SEA,33,67,10,11,21
32,8476897,Oskar Sundqvist,C,STL,30,65,9,12,21
32,8480762,Eric Robinson,L,CAR,29,54,9,12,21
32,8477508,Curtis Lazar,C,NJD,29,61,9,12,21
32,8484149,Gavin Brindley,C,CBJ,20,49,8,13,21
32,8479344,Jesse Puljujarvi,R,PIT,26,51,8,13,21
32,8476525,Colin Miller,D,WPG,32,63,7,14,21
32,8477919,Frederick Gaudreau,C,MIN,31,61,7,14,21
32,8478432,Christian Fischer,R,DET,27,76,6,15,21
32,8479351,Sam Steel,C,DAL,26,80,5,16,21
32,8478178,Darren Raddysh,D,TBL,28,72,4,17,21
32,8475181,Nick Leddy,D,STL,33,61,4,17,21
32,8478851,Alexandre Carrier,D,NSH,28,65,3,18,21
32,8480246,Nick Perbix,D,TBL,26,71,2,19,21
32,8480222,Sebastian Aho,D,PIT,28,74,0,21,21
32,8479619,Michael Carcone,L,UTA,28,68,15,5,20
32,8483493,Frank Nazar,C,CHI,20,50,12,8,20
32,8482111,Justin Barron,D,MTL,23,71,11,9,20
32,8480355,Mark Kastelic,C,BOS,25,67,10,10,20
32,8478043,Sam Lafferty,C,BUF,29,52,9,11,20
32,8483468,Jiri Kulich,C,BUF,20,54,9,11,20
32,8477353,Tyler Motte,C,DET,29,71,8,12,20
32,8477220,Nate Schmidt,D,FLA,33,70,7,13,20
32,8481708,Zac Jones,D,NYR,24,53,6,14,20
32,8482166,Shakir Mukhamadullin,D,SJS,22,50,6,14,20
32,8479026,Philippe Myers,D,TOR,27,59,5,15,20
32,8480049,Dylan Samberg,D,WPG,25,58,3,17,20
32,8480950,Ilya Lyubushkin,D,DAL,30,68,2,18,20
32,8482074,Connor Zary,C,CGY,23,60,11,8,19
32,8477015,Connor Brown,R,EDM,30,65,10,9,19
32,8481522,Peyton Krebs,C,BUF,23,54,10,9,19
32,8481477,Nico Sturm,C,SJS,29,51,9,10,19
32,8483491,Ivan Miroshnichenko,L,WSH,20,52,9,10,19
32,8476469,Joel Armia,R,MTL,31,70,9,10,19
32,8479390,Taylor Raddysh,R,WSH,26,62,8,11,19
32,8482101,Danil Gushchin,L,SJS,22,61,8,11,19
32,8480144,David Kampf,C,TOR,29,70,8,11,19
32,8478970,Jalen Chatfield,D,CAR,28,73,7,12,19
32,8477499,Rasmus Ristolainen,D,PHI,30,58,7,12,19
32,8476312,Josh Manson,D,COL,33,62,6,13,19
32,8480074,Alexandre Texier,C,STL,25,53,5,14,19
32,8482451,Mikael Pyyhtia,L,CBJ,23,53,5,14,19
32,8478569,Noel Acciari,C,PIT,33,54,4,15,19
32,8482142,Jamie Drysdale,D,PHI,22,67,4,15,19
32,8480073,Erik Brannstrom,D,COL,25,65,3,16,19
32,8473507,Jeff Petry,D,DET,37,74,2,17,19
32,8474673,TJ Brodie,D,CHI,34,59,2,17,19
32,8475324,Nick Jensen,D,OTT,34,71,1,18,19
32,8476902,Esa Lindell,D,DAL,30,75,1,18,19
32,8482073,Braden Schneider,D,NYR,23,61,1,18,19
32,8482062,Cole Smith,L,NSH,29,57,11,7,18
32,8482803,Olen Zellweger,D,ANA,21,66,11,7,18
32,8477380,Jonny Brodzinski,C,NYR,31,53,7,11,18
32,8477018,Ben Hutton,D,VGK,31,46,5,13,18
32,8482176,Wyatt Kaiser,D,CHI,22,56,5,13,18
32,8478443,Brandon Carlo,D,BOS,28,64,5,13,18
32,8476856,Mathew Dumba,D,DAL,30,69,4,14,18
32,8481028,Martin Pospisil,C,CGY,25,51,4,14,18
32,8479315,Joey Anderson,R,CHI,26,44,4,14,18
32,8478500,Ivan Provorov,D,CBJ,27,80,3,15,18
32,8479348,Kale Clague,D,BUF,26,38,3,15,18
32,8476467,Jamie Oleksiak,D,SEA,32,67,2,16,18
32,8476422,Mike Reilly,D,NYI,31,75,2,16,18
32,8481521,Ronnie Attard,D,PHI,25,51,2,16,18
32,8480879,Jacob Bernard-Docker,D,OTT,24,46,2,16,18
32,8475179,Dmitry Kulikov,D,FLA,34,61,1,17,18
32,8479402,Jake Bean,D,CGY,26,66,1,17,18
32,8478840,Will Borgen,D,SEA,28,65,1,17,18
32,8475188,Brayden McNabb,D,VGK,33,54,1,17,18
32,8478508,Yakov Trenin,C,MIN,27,55,9,8,17
32,8482157,Will Cuylle,L,NYR,22,61,9,8,17
32,8480252,Cole Guttman,C,CHI,25,39,9,8,17
32,8479370,Tyson Jost,C,CAR,26,54,9,8,17
32,8479066,Ryan Lomberg,L,CGY,30,66,8,9,17
32,8476329,Travis Boyd,C,MIN,31,56,8,9,17
32,8482730,Brandt Clarke,D,LAK,21,53,8,9,17
32,8475220,Marcus Foligno,L,MIN,33,55,7,10,17
32,8479998,Mikey Anderson,D,LAK,25,62,7,10,17
32,8476624,Barclay Goodrow,C,SJS,31,47,6,11,17
32,8473563,Nicklas Backstrom,C,WSH,37,54,5,12,17
32,8478434,Keegan Kolesar,R,VGK,27,64,4,13,17
32,8477845,Trevor van Riemsdyk,D,WSH,33,49,3,14,17
32,8478136,Jake Middleton,D,MIN,28,75,3,14,17
32,8474090,Brendan Smith,D,DAL,35,53,3,14,17
32,8478451,Ethan Bear,D,WSH,27,54,2,15,17
32,8482807,Ethan Del Mastro,D,CHI,21,44,9,7,16
32,8479336,Carl Grundstrom,R,SJS,27,51,8,8,16
32,8477406,Mattias Janmark,C,EDM,32,65,8,8,16
32,8477392,Hudson Fasching,R,NYI,29,65,7,9,16
32,8481019,David Gustafsson,C,WPG,24,45,7,9,16
32,8483482,Tristan Luneau,D,ANA,20,66,7,9,16
32,8474567,Zach Bogosian,D,MIN,34,56,7,9,16
32,8481716,Dmitri Voronkov,L,CBJ,24,42,7,9,16
32,8479328,Julien Gauthier,R,NYI,27,62,6,10,16
32,8479982,Conor Timmins,D,TOR,26,59,4,12,16
32,8476931,Jake McCabe,D,TOR,31,67,4,12,16
32,8479442,Troy Stecher,D,EDM,30,57,4,12,16
32,8483457,Lane Hutson,D,MTL,20,67,3,13,16
32,8479371,Dante Fabbro,D,NSH,26,65,3,13,16
32,8480796,Martin Fehervary,D,WSH,25,62,3,13,16
32,8481014,Alexander Romanov,D,NYI,24,76,2,14,16
32,8480891,Michael Kesselring,D,UTA,24,55,2,14,16
32,8476473,Connor Murphy,D,CHI,31,43,1,15,16
32,8480441,Trey Fix-Wolansky,R,CBJ,25,46,13,2,15
32,8482659,Josh Doan,R,UTA,22,45,10,5,15
32,8477369,Carson Soucy,D,VAN,30,59,7,8,15
32,8483466,Kevin Korchinski,D,CHI,20,51,7,8,15
32,8476960,Andreas Athanasiou,C,CHI,30,53,6,9,15
32,8481641,Joel Kiviranta,L,COL,28,64,6,9,15
32,8477070,Liam O'Brien,C,UTA,30,63,6,9,15
32,8476891,Matthew Grzelcyk,D,PIT,30,77,5,10,15
32,8480289,Morgan Barron,C,WPG,26,57,5,10,15
32,8479718,Alex Barré-Boulet,C,MTL,27,57,5,10,15
32,8481751,Lukas Rousek,R,BUF,25,38,5,10,15
32,8482634,Alex Steeves,C,TOR,25,49,4,11,15
32,8481527,Kaedan Korczak,D,VGK,23,48,4,11,15
32,8480025,MacKenzie Entwistle,R,FLA,25,61,3,12,15
32,8482095,Tyler Kleven,D,OTT,22,43,2,13,15
32,8478416,Erik Cernak,D,TBL,27,74,0,15,15
32,8482155,Alex Laferriere,R,LAK,23,70,12,2,14
32,8481754,Nikita Nesterenko,C,ANA,23,49,10,4,14
32,8480448,Parker Kelly,L,COL,25,72,9,5,14
32,8481517,Brett Leason,R,ANA,25,49,8,6,14
32,8481617,Vasily Podkolzin,R,VAN,23,45,7,7,14
32,8483499,Liam Ohgren,L,MIN,20,46,7,7,14
32,8479439,Jacob MacDonald,D,COL,31,49,7,7,14
32,8479543,Michael Pezzetta,L,MTL,26,58,6,8,14
32,8482652,Walker Duehr,R,CGY,27,39,6,8,14
32,8473453,Trevor Lewis,C,LAK,37,74,5,9,14
32,8482679,Matt Coronato,R,CGY,22,66,5,9,14
32,8475279,Ben Chiarot,D,DET,33,65,4,10,14
32,8477365,Connor Clifton,D,BUF,29,57,1,13,14
32,8478211,Dryden Hunt,L,CGY,29,56,10,3,13
32,8480281,Alexey Toropchenko,R,STL,25,55,8,5,13
32,8478831,Kevin Stenlund,C,UTA,28,54,8,5,13
32,8482496,Nils Aman,C,VAN,24,39,8,5,13
32,8480789,Oliver Wahlstrom,R,NYI,24,68,7,6,13
32,8480806,Isac Lundestrom,C,ANA,25,67,7,6,13
32,8481161,Jake Christiansen,D,CBJ,25,56,7,6,13
32,8477507,Nikita Zadorov,D,BOS,29,65,6,7,13
32,8471709,Marc-Edouard Vlasic,D,SJS,37,61,5,8,13
32,8480011,Klim Kostin,C,SJS,25,56,5,8,13
32,8476442,Matt Nieto,L,PIT,32,60,4,9,13
32,8480727,Zach Whitecloud,D,VGK,28,49,4,9,13
32,8476889,Radek Faksa,C,STL,30,51,4,9,13
32,8480995,Pontus Holmberg,R,TOR,25,62,4,9,13
32,8476913,Devin Shore,C,MIN,30,42,4,9,13
32,8480980,Connor Dewar,C,TOR,25,62,3,10,13
32,8480807,Mattias Samuelsson,D,BUF,24,51,3,10,13
32,8474166,Alec Martinez,D,CHI,37,51,3,10,13
32,8475462,Radko Gudas,D,ANA,34,66,2,11,13
32,8476988,Matt Benning,D,SJS,30,65,2,11,13
32,8476967,Brett Kulak,D,EDM,30,68,2,11,13
32,8479249,Andrew Poturalski,C,SJS,30,35,1,12,13
32,8479661,Tanner Jeannot,L,LAK,27,76,6,6,12
32,8482859,Zack Ostapchuk,C,OTT,21,54,5,7,12
32,8477903,Garnet Hathaway,R,PHI,33,64,5,7,12
32,8478421,A.J. Greer,L,FLA,28,56,4,8,12
32,8475750,Jon Merrill,D,MIN,32,58,4,8,12
32,8479981,Jonah Gadjovich,L,FLA,26,38,4,8,12
32,8478399,Jonas Siegenthaler,D,NJD,27,57,3,9,12
32,8480058,Pierre-Olivier Joseph,D,STL,25,53,3,9,12
32,8476874,Olli Maatta,D,DET,30,62,3,9,12
32,8481537,Nikita Okhotiuk,D,CGY,24,55,3,9,12
32,8479369,Andrew Peeke,D,BOS,26,57,3,9,12
32,8482077,Dylan Holloway,L,EDM,23,51,2,10,12
32,8475718,Justin Holl,D,DET,32,63,2,10,12
32,8477034,Jaycob Megna,D,FLA,32,41,2,10,12
32,8481568,Alex Vlasic,D,CHI,23,55,1,11,12
32,8479980,Nicolas Hague,D,VGK,26,50,0,12,12
32,8479772,Zack MacEwen,R,OTT,28,56,7,4,11
32,8479671,Mathieu Olivier,R,CBJ,27,40,6,5,11
32,8483495,Simon Nemec,D,NJD,20,59,5,6,11
32,8475235,Nicolas Deslauriers,L,PHI,33,52,5,6,11
32,8478585,Derek Ryan,C,EDM,38,64,4,7,11
32,8480192,Johnathan Kovacevic,D,NJD,27,54,4,7,11
32,8478468,Jeremy Lauzon,D,NSH,27,57,4,7,11
32,8476441,Joel Edmundson,D,LAK,31,41,4,7,11
32,8484911,Collin Graf,R,SJS,22,46,4,7,11
32,8476952,Dominic Toninato,C,WPG,30,33,4,7,11
32,8474013,Ian Cole,D,UTA,35,53,3,8,11
32,8475233,David Savard,D,MTL,34,61,3,8,11
32,8475455,Brenden Dillon,D,NJD,34,55,2,9,11
32,8479378,Logan Stanley,D,WPG,26,47,2,9,11
32,8481567,Henry Thrun,D,SJS,23,50,2,9,11
32,8482148,Hendrix Lapierre,C,WSH,22,55,1,10,11
32,8478454,Noah Juulsen,D,VAN,27,32,0,11,11
32,8478424,Jansen Harkins,C,ANA,27,41,7,3,10
32,8475842,Sam Carrick,C,NYR,32,61,6,4,10
32,8477573,Nathan Walker,L,STL,30,51,6,4,10
32,8478859,Niko Mikkola,D,FLA,28,59,5,5,10
32,8475762,Derek Forbort,D,VAN,32,46,5,5,10
32,8482747,Brennan Othmann,L,NYR,21,39,5,5,10
32,8481518,Nolan Foote,L,NJD,24,46,4,6,10
32,8480021,Jack Studnicka,C,LAK,25,60,4,6,10
32,8476858,Phillip Di Giuseppe,L,VAN,31,35,4,6,10
32,8475958,Michael Sgarbossa,C,WSH,32,37,4,6,10
32,8479372,Joshua Mahura,D,SEA,26,56,3,7,10
32,8473446,Erik Johnson,D,PHI,36,48,3,7,10
32,8481178,Egor Zamula,D,PHI,24,52,3,7,10
32,8479520,Brandon Duhaime,R,WSH,27,51,3,7,10
32,8480887,Jordan Harris,D,MTL,24,54,2,8,10
32,8474034,Patrick Maroon,L,CHI,36,56,2,8,10
32,8481701,Santeri Hatakka,D,NJD,23,37,2,8,10
32,8479986,Kole Lind,R,DAL,26,51,1,9,10
32,8481167,Brayden Pachal,D,CGY,25,41,0,10,10
32,8476822,Luke Glendening,C,TBL,35,75,8,1,9
32,8481550,Adam Beckman,L,NJD,23,34,7,2,9
32,8476934,Brock McGinn,L,ANA,30,52,6,3,9
32,8481147,Reese Johnson,C,MIN,26,38,6,3,9
32,8482666,Scott Morrow,D,CAR,22,46,5,4,9
32,8476994,Vinnie Hinostroza,C,NSH,30,44,4,5,9
32,8482784,Zach Dean,C,STL,21,28,4,5,9
32,8482751,Ryan Winterton,C,SEA,21,34,4,5,9
32,8482765,Isak Rosen,R,BUF,21,34,4,5,9
32,8477384,Joshua Brown,D,EDM,30,42,3,6,9
32,8474568,Luke Schenn,D,NSH,35,48,3,6,9
32,8480007,Jonas Rondbjerg,R,VGK,25,44,3,6,9
32,8480172,Jan Rutta,D,SJS,34,59,2,7,9
32,8481609,Vladislav Kolyachonok,D,UTA,23,35,2,7,9
32,8476867,Brendan Gaunce,C,MIN,30,42,2,7,9
32,8481599,Victor Soderstrom,D,UTA,23,40,2,7,9
32,8480880,Jakub Lauko,C,MIN,24,39,2,7,9
32,8482744,James Malatesta,L,CBJ,21,46,1,8,9
32,8483460,David Jiricek,D,CBJ,21,58,1,8,9
32,8483570,Ben Meyers,C,SEA,26,28,6,2,8
32,8481013,Jonatan Berggren,R,DET,24,48,5,3,8
32,8479359,Beck Malenstyn,L,BUF,26,46,4,4,8
32,8481679,Maxence Guenette,D,OTT,23,30,4,4,8
32,8470600,Ryan Suter,D,STL,39,64,3,5,8
32,8479379,Givani Smith,R,SJS,26,37,3,5,8
32,8480001,Urho Vaakanainen,D,ANA,25,58,3,5,8
32,8483549,Lucas Condotta,L,MTL,27,27,3,5,8
32,8471677,Jack Johnson,D,CBJ,37,67,3,5,8
32,8479576,Vincent Desharnais,D,VAN,28,44,3,5,8
32,8480157,Calle Rosen,D,COL,30,50,2,6,8
32,8478452,Caleb Jones,D,LAK,27,56,2,6,8
32,8481600,Tobias Bjornfot,D,FLA,23,36,2,6,8
32,8480196,Jacob Bryson,D,BUF,27,41,2,6,8
32,8484254,Akito Hirose,D,VAN,25,37,1,7,8
32,8474612,Travis Hamonic,D,OTT,34,39,1,7,8
32,8476372,Nick Seeler,D,PHI,31,46,1,7,8
32,8478017,Mark Friedman,D,VAN,29,39,1,7,8
32,8477938,Haydn Fleury,D,WPG,28,45,0,8,8
32,8482762,Simon Edvinsson,D,DET,21,47,5,2,7
32,8482511,Mason Lohrei,D,BOS,23,37,5,2,7
32,8481789,Tye Kartye,L,SEA,23,35,5,2,7
32,8480990,Declan Chisholm,D,MIN,24,43,5,2,7
32,8480267,Sammy Walker,C,MIN,25,26,5,2,7
32,8476374,Sean Kuraly,C,CBJ,31,49,4,3,7
32,8481592,Jakob Pelletier,L,CGY,23,35,4,3,7
32,8479291,Kevin Rooney,C,CGY,31,46,4,3,7
32,8479972,Mason Shaw,C,WPG,26,34,4,3,7
32,8483763,Maksymilian Szuber,D,UTA,22,29,3,4,7
32,8483619,Filip Roos,D,OTT,25,32,3,4,7
32,8478874,Adam Gaudette,R,OTT,28,40,3,4,7
32,8477962,Brendan Lemieux,L,CAR,28,35,2,5,7
32,8477887,Patrick Brown,C,BOS,32,48,2,5,7
32,8482153,Brendan Brisson,C,VGK,23,31,2,5,7
32,8479944,Zach Aston-Reese,C,VGK,30,49,2,5,7
32,8480845,Rasmus Kupari,C,WPG,24,47,2,5,7
32,8480292,Carson Meyer,R,ANA,27,36,2,5,7
32,8482144,Jack Thompson,D,SJS,22,35,2,5,7
32,8480860,Kevin Bahl,D,CGY,24,57,1,6,7
32,8482964,Arber Xhekaj,D,MTL,23,48,1,6,7
32,8478146,Matthew Highmore,C,OTT,28,36,1,6,7
32,8477931,Tomas Nosek,L,FLA,32,51,5,1,6
32,8479991,Jake Leschyshyn,C,NYR,25,25,5,1,6
32,8479638,Justin Brazeau,R,BOS,26,39,4,2,6
32,8479968,Vinni Lettieri,C,BOS,29,39,4,2,6
32,8477401,John Hayden,C,SEA,29,32,4,2,6
32,8477482,Zachary Sanford,L,CHI,30,30,3,3,6
32,8475690,Chris Tanev,D,TOR,35,60,2,4,6
32,8481532,Alex Turcotte,C,LAK,23,40,2,4,6
32,8484287,Cole McWard,D,VAN,23,22,2,4,6
32,8482713,Mackie Samoskevich,R,FLA,22,32,2,4,6
32,8479367,William Lockwood,R,FLA,26,32,2,4,6
32,8482177,Marat Khusnutdinov,C,MIN,22,33,2,4,6
32,8477244,Chad Ruhwedel,D,NYR,34,37,0,6,6
32,8481043,Cole Koepke,L,BOS,26,25,5,0,5
32,8479536,Axel Jonsson-Fjallby,L,WPG,26,27,4,1,5
32,8482733,Logan Mailloux,D,MTL,31,33,3,2,5
32,8481543,Nikita Alexandrov,C,STL,24,28,3,2,5
32,8479362,Riley Tufte,L,BOS,26,16,3,2,5
32,8479994,Jaret Anderson-Dolan,C,WPG,25,33,2,3,5
32,8479320,Maxime Lajoie,D,SEA,27,29,2,3,5
32,8481237,Kyle MacLean,C,NYI,25,23,2,3,5
32,8482118,Sam Colangelo,R,ANA,23,8,2,3,5
32,8482141,Lukas Cormier,D,VGK,22,28,1,4,5
32,8477971,Andreas Englund,D,LAK,28,26,1,4,5
32,8481056,Spencer Stastney,D,NSH,24,40,1,4,5
32,8479587,Rhett Gardner,C,PHI,28,23,1,4,5
32,8480070,Ian Mitchell,D,BOS,25,41,0,5,5
32,8477851,Jordan Oesterle,D,BOS,32,49,0,5,5
32,8475177,Calvin de Haan,D,COL,33,49,0,5,5
32,8478450,Parker Wotherspoon,D,BOS,27,33,0,5,5
32,8480084,Nick DeSimone,D,NJD,30,19,0,5,5
32,8471817,Ryan Reaves,R,TOR,37,53,3,1,4
32,8481556,John Beecher,C,BOS,23,27,3,1,4
32,8481605,Jackson LaCombe,D,ANA,23,33,2,2,4
32,8481598,Philip Broberg,D,EDM,23,34,2,2,4
32,8482145,Mavrik Bourque,C,DAL,22,48,2,2,4
32,8478409,Anthony Richard,C,PHI,28,27,2,2,4
32,8478021,William Lagesson,D,DET,28,28,2,2,4
32,8480870,Bo Groulx,C,NYR,24,31,2,2,4
32,8477810,Joel Hanley,D,CGY,33,30,0,4,4
32,8483512,Matthew Savoie,C,EDM,20,24,0,4,4
32,8477149,Scott Sabourin,R,SJS,32,16,0,4,4
32,8481585,Egor Afanasyev,L,SJS,23,14,3,0,3
32,8482201,Gage Goncalves,C,TBL,23,26,3,0,3
32,8477462,Robert Hagg,D,VGK,29,26,2,1,3
32,8482147,Jean-Luc Foudy,C,COL,22,30,2,1,3
32,8481578,Graeme Clarke,R,MIN,23,6,2,1,3
32,8483630,Pavol Regenda,L,ANA,25,29,1,2,3
32,8482070,Mitchell Chaffee,R,TBL,26,50,1,2,3
32,8482165,Yan Kuznetsov,D,CGY,22,20,1,2,3
32,8482162,Roby Jarventie,L,EDM,22,13,1,2,3
32,8484304,Uvis Balinskis,D,FLA,28,14,1,2,3
32,8482861,Vincent Iorio,D,WSH,22,36,0,3,3
32,8480834,Ty Emberson,D,SJS,24,26,0,3,3
32,8481122,Simon Benoit,D,TOR,26,37,0,3,3
32,8477335,Kyle Burroughs,D,LAK,29,40,0,3,3
32,8477527,Ross Johnston,L,ANA,30,32,0,3,3
32,8484258,Sam Malinski,D,COL,26,18,0,3,3
32,8482470,Ilya Solovyov,D,CGY,24,13,0,3,3
32,8479419,Brett Murray,L,BUF,26,21,0,3,3
32,8480823,Alexander Alexeyev,D,WSH,25,12,0,3,3
32,8480844,Grigori Denisenko,L,VGK,24,29,0,3,3
32,8479985,Cale Fleury,D,SEA,26,20,0,3,3
32,8482516,Matthew Kessel,D,STL,24,24,0,3,3
32,8484325,Waltteri Merela,C,TBL,26,19,2,0,2
32,8481699,Aku Raty,R,UTA,23,13,2,0,2
32,8481422,Jake Lucchini,C,NSH,29,15,2,0,2
32,8477467,Gustav Olofsson,D,SEA,30,18,2,0,2
32,8483531,Brian Halonen,L,NJD,25,5,2,0,2
32,8479421,Jacob Moverare,D,LAK,26,6,2,0,2
32,8480848,Ty Dellandrea,C,SJS,24,46,1,1,2
32,8474062,Riley Nash,C,NYR,35,19,1,1,2
32,8482172,Landon Slaggert,L,CHI,22,25,1,1,2
32,8480890,Jan Jenik,C,OTT,24,16,1,1,2
32,8481719,Maxwell Crozier,D,TBL,24,14,1,1,2
32,8481006,Tyler Tucker,D,STL,24,18,1,1,2
32,8480032,Shane Bowers,C,NJD,25,18,1,1,2
32,8478011,Louie Belpedio,D,PHI,28,10,1,1,2
32,8483397,Marc McLaughlin,C,BOS,25,25,0,2,2
32,8482858,Ryker Evans,D,SEA,23,21,0,2,2
32,8481806,Louis Crevier,D,CHI,23,10,0,2,2
32,8482094,Daemon Hunt,D,MIN,22,17,0,2,2
32,8483395,Arshdeep Bains,L,VAN,23,14,0,2,2
32,8481541,Samuel Bolduc,D,NYI,24,24,0,2,2
32,8477073,Kurtis MacDermid,L,NJD,30,37,0,2,2
32,8478477,Mitchell Stephens,C,SEA,27,14,0,2,2
32,8483609,Adam Klapka,R,CGY,24,4,0,2,2
32,8480245,Olle Lycksell,R,PHI,25,29,1,0,1
32,8481065,Angus Crookshank,L,OTT,25,12,1,0,1
32,8479330,Brandon Gignac,C,MTL,27,10,1,0,1
32,8482476,Emil Heineman,L,MTL,23,6,1,0,1
32,8483432,Luca Del Bel Belluz,C,CBJ,31,5,1,0,1
32,8481024,Linus Karlsson,C,VAN,25,10,1,0,1
32,8480306,Grant Hutton,D,NYI,29,8,1,0,1
32,8483012,Logan Morrison,C,SEA,22,28,0,1,1
32,8477473,Justin Bailey,R,SJS,29,14,0,1,1
32,8481743,Marc Del Gaizo,D,NSH,25,18,0,1,1
32,8475795,Dylan McIlrath,D,WSH,32,14,0,1,1
32,8481564,Ryan Johnson,D,BUF,23,16,0,1,1
32,8482061,Brandon Biro,L,SEA,26,10,0,1,1
32,8482250,Callahan Burke,C,VGK,27,16,0,1,1
32,8482102,Vasily Ponomarev,C,PIT,22,17,0,1,1
32,8478502,Dennis Gilbert,D,BUF,28,14,0,1,1
32,8478051,Max Willman,C,NJD,29,18,0,1,1
32,8480874,Adam Ginning,D,PHI,24,14,0,1,1
32,8475413,Justin Dowling,C,NJD,34,10,0,1,1
32,8478881,Brett Seney,L,CHI,28,10,0,1,1
32,8482929,Emil Lilleberg,D,TBL,23,23,0,1,1
32,8481593,Jayden Struble,D,MTL,23,17,0,1,1
32,8476323,Max McCormick,L,SEA,32,6,0,1,1
32,8477993,Justin Kirkland,C,CGY,28,9,0,1,1
32,8478854,Ryan Shea,D,PIT,27,7,0,1,1
32,8475780,Chris Wagner,R,COL,33,11,0,1,1
32,8483401,Marc Johnstone,R,PIT,28,2,0,1,1
32,8483567,Georgii Merkulov,C,BOS,24,11,0,1,1
32,8482460,Matt Rempe,C,NYR,22,13,0,1,1
32,8477320,Anton Blidh,L,NYR,29,15,0,0,0
32,8483471,Brad Lambert,C,WPG,31,14,0,0,0
32,8478147,Bokondji Imama,L,PIT,28,2,0,0,0
32,8481206,John Ludvig,D,PIT,24,8,0,0,0
32,8483407,Brandon Scanlin,D,NYR,25,5,0,0,0
32,8483597,Milos Kelemen,L,UTA,25,6,0,0,0
32,8481655,Cole Schwindt,R,CGY,23,6,0,0,0
32,8483489,Fraser Minten,C,TOR,31,10,0,0,0
32,8480851,Akil Thomas,C,LAK,24,16,0,0,0
32,8480468,James Hamblin,L,EDM,25,15,0,0,0
32,8477541,Dakota Mermis,D,TOR,30,10,0,0,0
32,8483920,Pierrick Dube,R,WSH,23,3,0,0,0
32,8482197,Adam Raska,R,MIN,23,6,0,0,0
32,8479522,Hardy Haman Aktell,D,WSH,26,4,0,0,0
32,8483045,Cameron Butler,R,CBJ,31,0,0,0,0
32,8481462,Mason Morelli,L,VGK,28,11,0,0,0
32,8482787,Nikita Chibrikov,R,WPG,31,4,0,0,0
32,8478446,Glenn Gawdin,C,LAK,27,16,0,0,0
32,8481726,Adam Edstrom,C,NYR,24,9,0,0,0
32,8475755,Alexander Petrovic,D,DAL,32,11,0,0,0
32,8484255,Jason Polin,R,COL,25,5,0,0,0
32,8481534,Raphael Lavoie,C,EDM,24,1,0,0,0
32,8482126,Emil Andrae,D,PHI,31,2,0,0,0
32,8481030,Jack St. Ivany,D,PIT,25,11,0,0,0
32,8480075,Cameron Crotty,D,MIN,25,12,0,0,0
32,8482088,Justin Sourdif,R,FLA,22,15,0,0,0
32,8483398,Declan Carlile,D,TBL,31,5,0,0,0
32,8478956,Samuel Laberge,L,NJD,27,0,0,0,0
32,8480274,Philip Kemp,D,EDM,25,1,0,0,0
32,8483546,Marshall Rifai,D,TOR,26,4,0,0,0
32,8484259,Ondrej Pavel,C,COL,31,3,0,0,0
32,8484326,Patrik Koch,D,UTA,28,4,0,0,0
32,8484321,Nikolas Matinpalo,D,OTT,26,2,0,0,0
32,8470794,Joe Pavelski,C,,40,0,0,0,0
32,8479321,Lucas Johansen,D,,27,0,0,0,0
32,8477950,Tony DeAngelo,D,,29,0,0,0,0
32,8471218,Blake Wheeler,R,,38,0,0,0,0
32,8475197,Tyson Barrie,D,,33,0,0,0,0
32,8474157,Max Pacioretty,L,,36,0,0,0,0
32,8475744,Evgeny Kuznetsov,C,,32,0,0,0,0
32,8474037,James van Riemsdyk,L,,35,0,0,0,0
32,8476907,Mackenzie MacEachern,L,,30,0,0,0,0
32,8480216,Jacob Peterson,C,,25,0,0,0,0
32,8474602,Justin Schultz,D,,34,0,0,0,0
32,8482222,Alexander Barabanov,L,,30,0,0,0,0
32,8474031,Kevin Shattenkirk,D,,35,0,0,0,0
32,8477330,Dominik Kubalik,L,,29,0,0,0,0
32,8480884,Calen Addison,D,,24,0,0,0,0
32,8475906,John Klingberg,D,,32,0,0,0,0
32,8480008,Adam Ruzicka,C,,25,0,0,0,0
32,8476884,Derrick Pouliot,D,,30,0,0,0,0
32,8476919,Chris Tierney,C,,30,0,0,0,0
32,8479415,Michael McLeod,C,,26,0,0,0,0
32,8474870,Tyler Johnson,C,,34,0,0,0,0
32,8470604,Jeff Carter,C,,39,0,0,0,0
32,8478104,Sammy Blais,L,,28,0,0,0,0
32,8474884,Mike Hoffman,C,,35,0,0,0,0
32,8481591,Sam Poulin,R,,23,0,0,0,0
32,8471274,Alex Goligoski,D,,39,0,0,0,0
32,8476871,Tanner Pearson,L,,32,0,0,0,0
32,8476393,Nick Cousins,C,,31,0,0,0,0
32,8479977,Kailer Yamamoto,R,,26,0,0,0,0
32,8479346,Dillon Dube,C,,26,0,0,0,0
32,8480184,Gustav Lindstrom,D,,26,0,0,0,0
32,8479376,Victor Mete,D,,26,0,0,0,0
32,8473449,Kyle Okposo,R,,36,0,0,0,0
32,8481058,Jesse Ylonen,R,,25,0,0,0,0
32,8475752,Tyler Pitlick,C,,33,0,0,0,0
32,8481239,Samuel Fagemo,L,,24,0,0,0,0
32,8480821,Filip Zadina,R,,25,0,0,0,0
32,8470966,Mark Giordano,D,,41,0,0,0,0
32,8478495,Denis Gurianov,R,,27,0,0,0,0
32,8477464,Nic Petan,C,,29,0,0,0,0
32,8478099,Kevin Labanc,R,,29,0,0,0,0
32,8482241,Radim Zohorna,L,,28,0,0,0,0
32,8474040,Sam Gagner,C,,35,0,0,0,0
32,8479514,Rem Pitlick,C,,27,0,0,0,0
32,8478430,Oliver Kylington,D,,27,0,0,0,0
32,8479533,Joona Koppanen,L,,26,0,0,0,0
32,8479984,Cal Foote,D,,26,0,0,0,0
32,8477126,Jayson Megna,C,,34,0,0,0,0
32,8475164,Jakob Silfverberg,R,,34,0,0,0,0
32,8474009,Nick Bonino,C,,36,0,0,0,0
32,8479458,Nikita Zaitsev,D,,33,0,0,0,0
32,8477944,Jakub Vrana,L,,28,0,0,0,0
32,8471699,Andrew Cogliano,C,,37,0,0,0,0
32,8478067,Oskar Lindblom,L,,28,0,0,0,0
32,8471686,Marc Staal,D,,37,0,0,0,0
32,8470610,Zach Parise,L,,40,0,0,0,0
32,8478904,Steven Lorentz,C,,28,0,0,0,0
32,8473473,Milan Lucic,L,,36,0,0,0,0
32,8480031,Maxime Comtois,L,,25,0,0,0,0
32,8478512,Austin Czarnik,C,,32,0,0,0,0
32,8473504,Cal Clutterbuck,R,,37,0,0,0,0
32,8477454,Adam Erne,L,,29,0,0,0,0
32,8479383,Boris Katchouk,L,,26,0,0,0,0
32,8475825,Jani Hakanpää,D,,32,0,0,0,0
32,8477846,Ryan Carpenter,C,,33,0,0,0,0
32,8477930,Pierre-Edouard Bellemare,L,,39,0,0,0,0
32,8478400,Colin White,C,,27,0,0,0,0
32,8480226,Marián Studenic,R,,26,0,0,0,0
32,8480853,Liam Foudy,C,,24,0,0,0,0
32,8475797,Jarred Tinordi,D,,32,0,0,0,0
32,8479423,Alex Nylander,L,,26,0,0,0,0
32,8474618,Marco Scandella,D,,34,0,0,0,0
32,8478028,Fredrik Olofsson,L,,28,0,0,0,0
32,8474709,Matt Martin,L,,35,0,0,0,0
32,8481070,Hugh McGing,L,,26,0,0,0,0
32,8479546,Oskar Steen,C,,26,0,0,0,0
32,8474145,Robert Bortuzzo,D,,35,0,0,0,0
32,8476915,Jujhar Khaira,L,,30,0,0,0,0
32,8475278,Byron Froese,C,,33,0,0,0,0
32,8481812,Nikolai Knyzhov,D,,27,0,0,0,0
32,8478408,Travis Dermott,D,,28,0,0,0,0
32,8481077,John Leonard,L,,26,0,0,0,0
32,8479547,Matthew Phillips,R,,26,0,0,0,0
32,8480836,Jonathan Gruden,C,,24,0,0,0,0
32,8481690,Tyler Angle,C,,24,0,0,0,0
32,8475766,Austin Watson,L,,32,0,0,0,0
32,8481016,Ruslan Iskhakov,C,,24,0,0,0,0
32,8478078,Rourke Chartier,C,,28,0,0,0,0
32,8480776,Sheldon Rempal,R,,29,0,0,0,0
32,8484314,Jiri Smejkal,L,,28,0,0,0,0
33,8476453,Nikita Kucherov,R,TBL,31,81,46,105,151
33,8477492,Nathan MacKinnon,C,COL,29,82,55,89,144
33,8478402,Connor McDavid,C,EDM,27,79,38,100,138
33,8479314,Matthew Tkachuk,L,FLA,27,79,38,90,128
33,8481559,Jack Hughes,C,NJD,23,76,53,69,122
33,8477934,Leon Draisaitl,C,EDM,29,79,47,73,120
33,8478550,Artemi Panarin,L,NYR,33,78,37,83,120
33,8477493,Aleksander Barkov,C,FLA,29,81,31,82,113
33,8477956,David Pastrnak,R,BOS,28,81,49,62,111
33,8477939,William Nylander,R,TOR,28,81,51,58,109
33,8478420,Mikko Rantanen,R,COL,28,80,32,76,108
33,8480023,Robert Thomas,C,STL,25,80,37,68,105
33,8477942,Kevin Fiala,L,LAK,28,82,34,71,105
33,8480012,Elias Pettersson,C,VAN,26,77,37,62,99
33,8479323,Adam Fox,D,NYR,26,75,27,72,99
33,8479318,Auston Matthews,C,TOR,27,82,58,40,98
33,8480800,Quinn Hughes,D,VAN,25,76,19,77,96
33,8476454,Ryan Nugent-Hopkins,C,EDM,31,77,36,58,94
33,8480801,Brady Tkachuk,L,OTT,25,78,46,47,93
33,8479407,Jesper Bratt,L,NJD,26,75,32,61,93
33,8480002,Nico Hischier,C,NJD,25,77,40,52,92
33,8480027,Jason Robertson,L,DAL,25,82,37,55,92
33,8477404,Jake Guentzel,C,TBL,30,82,45,46,91
33,8471675,Sidney Crosby,C,PIT,37,76,44,47,91
33,8481557,Matt Boldy,L,MIN,23,74,39,52,91
33,8480069,Cale Makar,D,COL,26,65,23,68,91
33,8476468,J.T. Miller,C,VAN,31,74,31,59,90
33,8477933,Sam Reinhart,C,FLA,29,78,39,50,89
33,8477501,Valeri Nichushkin,R,COL,29,79,39,50,89
33,8479343,Clayton Keller,R,UTA,26,81,32,56,88
33,8476887,Filip Forsberg,L,NSH,30,77,38,49,87
33,8478445,Mathew Barzal,C,NYI,27,79,24,63,87
33,8473512,Claude Giroux,R,OTT,36,80,23,64,87
33,8476459,Mika Zibanejad,C,NYR,31,79,30,56,86
33,8479337,Alex DeBrincat,R,DET,27,81,37,48,85
33,8480036,Miro Heiskanen,D,DAL,25,80,19,66,85
33,8471685,Anze Kopitar,C,LAK,37,79,28,56,84
33,8475166,John Tavares,C,TOR,34,78,37,46,83
33,8478483,Mitch Marner,R,TOR,27,79,24,59,83
33,8478427,Sebastian Aho,C,CAR,27,73,41,41,82
33,8478864,Kirill Kaprizov,L,MIN,27,72,37,45,82
33,8471215,Evgeni Malkin,C,PIT,38,71,35,46,81
33,8477409,Carter Verhaeghe,C,FLA,29,75,35,46,81
33,8477960,Adrian Kempe,R,LAK,28,82,37,43,80
33,8474600,Roman Josi,D,NSH,34,78,17,63,80
33,8474564,Steven Stamkos,C,NSH,34,75,32,47,79
33,8480208,Drake Batherson,R,OTT,26,78,31,48,79
33,8482116,Tim Stützle,C,OTT,22,79,27,52,79
33,8476853,Morgan Rielly,D,TOR,30,75,14,65,79
33,8478403,Jack Eichel,C,VGK,28,76,32,46,78
33,8478010,Brayden Point,C,TBL,28,82,36,41,77
33,8480018,Nick Suzuki,C,MTL,25,76,24,53,77
33,8478414,Timo Meier,R,NJD,28,76,41,35,76
33,8478398,Kyle Connor,L,WPG,28,70,31,45,76
33,8477402,Pavel Buchnevich,L,STL,29,68,33,42,75
33,8476460,Mark Scheifele,C,WPG,31,76,30,45,75
33,8475167,Victor Hedman,D,TBL,34,77,14,61,75
33,8477946,Dylan Larkin,C,DET,28,80,30,43,73
33,8475184,Chris Kreider,L,NYR,33,79,37,35,72
33,8479420,Tage Thompson,C,BUF,27,76,36,35,71
33,8479999,Casey Mittelstadt,C,COL,26,82,23,48,71
33,8480865,Noah Dobson,D,NYI,24,82,12,59,71
33,8479542,Brandon Hagel,L,TBL,26,82,31,39,70
33,8481540,Cole Caufield,R,MTL,23,78,40,29,69
33,8475913,Mark Stone,R,VGK,32,72,23,46,69
33,8477949,Alex Tuch,R,BUF,28,76,17,52,69
33,8479385,Jordan Kyrou,C,STL,26,72,29,39,68
33,8476456,Jonathan Huberdeau,C,CGY,31,80,23,45,68
33,8473419,Brad Marchand,L,BOS,36,80,23,45,68
33,8475172,Nazem Kadri,C,CGY,34,81,21,47,68
33,8477951,Nick Schmaltz,C,UTA,28,76,20,48,68
33,8476389,Vincent Trocheck,C,NYR,31,77,32,35,67
33,8478449,Roope Hintz,C,DAL,28,81,30,37,67
33,8478444,Brock Boeser,R,VAN,27,74,26,41,67
33,8477500,Bo Horvat,C,NYI,29,76,35,31,66
33,8482740,Wyatt Johnston,C,DAL,21,80,35,31,66
33,8478401,Pavel Zacha,C,BOS,27,77,34,32,66
33,8476448,William Karlsson,C,VGK,31,77,30,36,66
33,8483515,Juraj Slafkovsky,L,MTL,20,76,20,46,66
33,8475754,Brock Nelson,C,NYI,33,80,37,28,65
33,8482078,Lucas Raymond,L,DET,22,82,31,34,65
33,8482699,Dylan Guenther,R,UTA,21,75,27,38,65
33,8475692,Mats Zuccarello,R,MIN,37,71,16,49,65
33,8480839,Rasmus Dahlin,D,BUF,24,67,10,55,65
33,8474141,Patrick Kane,R,DET,36,79,25,39,64
33,8477416,Oliver Bjorkstrand,R,SEA,29,76,30,33,63
33,8475810,Bryan Rust,R,PIT,32,74,26,37,63
33,8476346,Johnny Gaudreau,L,CBJ,31,74,9,54,63
33,8479325,Charlie McAvoy,D,BOS,27,76,5,58,63
33,8475168,Matt Duchene,C,DAL,33,82,24,38,62
33,8475169,Evander Kane,L,EDM,33,73,34,27,61
33,8476539,Jonathan Marchessault,R,NSH,34,74,33,28,61
33,8480064,Josh Norris,C,OTT,25,74,30,31,61
33,8477998,Warren Foegele,L,LAK,28,80,29,32,61
33,8478439,Travis Konecny,R,PHI,27,74,28,33,61
33,8477940,Nikolaj Ehlers,L,WPG,28,68,24,37,61
33,8473994,Jamie Benn,L,DAL,35,81,20,41,61
33,8480803,Evan Bouchard,D,EDM,25,74,13,48,61
33,8475798,Mikael Granlund,C,SJS,32,70,9,52,61
33,8483431,Logan Cooley,C,UTA,20,78,29,31,60
33,8476881,Tomas Hertl,C,VGK,31,77,27,33,60
33,8479675,Trevor Moore,L,LAK,29,82,27,33,60
33,8475170,Brayden Schenn,C,STL,33,75,24,36,60
33,8475765,Vladimir Tarasenko,R,DET,33,80,23,37,60
33,8475768,Jaden Schwartz,C,SEA,32,77,20,40,60
33,8482113,Anton Lundell,C,FLA,23,76,31,28,59
33,8480830,Andrei Svechnikov,R,CAR,24,76,28,31,59
33,8475786,Zach Hyman,L,EDM,32,77,28,31,59
33,8482745,Mason McTavish,C,ANA,21,75,25,34,59
33,8475794,Tyler Seguin,C,DAL,32,82,24,35,59
33,8470613,Brent Burns,D,CAR,39,75,13,46,59
33,8478366,Frank Vatrano,R,ANA,30,79,36,22,58
33,8475726,Tyler Toffoli,C,SJS,32,70,31,27,58
33,8475760,Nick Bjugstad,C,UTA,32,79,30,28,58
33,8480039,Martin Necas,C,CAR,25,72,27,31,58
33,8476462,Dougie Hamilton,D,NJD,31,75,16,42,58
33,8476438,Brandon Saad,L,STL,32,68,33,24,57
33,8481068,Yegor Sharangovich,C,CGY,26,80,26,31,57
33,8478542,Evan Rodrigues,C,FLA,31,74,25,32,57
33,8478047,Michael Bunting,L,PIT,29,68,24,33,57
33,8474102,David Perron,L,OTT,36,80,22,35,57
33,8484144,Connor Bedard,C,CHI,19,64,15,42,57
33,8474150,Mikael Backlund,C,CGY,35,75,22,34,56
33,8482665,Matty Beniers,C,SEA,22,73,22,34,56
33,8477451,Ryan Hartman,R,MIN,30,73,22,34,56
33,8482124,Quinton Byfield,R,LAK,22,80,16,40,56
33,8482684,Luke Hughes,D,NJD,21,69,9,47,56
33,8477955,Jared McCann,L,SEA,28,75,31,24,55
33,8484166,Adam Fantilli,C,CBJ,20,69,19,36,55
33,8474578,Erik Karlsson,D,PIT,34,78,12,43,55
33,8479410,Mikhail Sergachev,D,UTA,26,71,10,45,55
33,8477476,Artturi Lehkonen,L,COL,29,81,20,34,54
33,8480797,Joel Farabee,L,PHI,24,74,20,34,54
33,8477504,Josh Morrissey,D,WPG,29,71,16,38,54
33,8477494,Jonathan Drouin,L,COL,29,80,16,38,54
33,8478856,Conor Garland,R,VAN,28,71,16,38,54
33,8478460,Zach Werenski,D,CBJ,27,77,13,41,54
33,8477935,Sam Bennett,C,FLA,28,73,31,22,53
33,8482109,Alexis Lafrenière,L,NYR,23,74,29,24,53
33,8478498,Jake DeBrusk,L,VAN,28,76,26,27,53
33,8480015,Owen Tippett,R,PHI,25,74,26,27,53
33,8478519,Anthony Cirelli,C,TBL,27,82,23,30,53
33,8478493,Joel Eriksson Ek,C,MIN,27,75,22,31,53
33,8480185,Eetu Luostarinen,C,FLA,26,74,21,32,53
33,8478873,Troy Terry,R,ANA,27,74,19,34,53
33,8482159,Tyson Foerster,R,PHI,22,75,29,23,52
33,8477496,Elias Lindholm,C,BOS,30,78,26,26,52
33,8484153,Leo Carlsson,C,ANA,20,77,20,32,52
33,8478055,Gustav Forsling,D,FLA,28,71,15,37,52
33,8478407,Vince Dunn,D,SEA,28,73,13,39,52
33,8477503,Max Domi,C,TOR,29,78,11,41,52
33,8474563,Drew Doughty,D,LAK,35,73,10,42,52
33,8481542,Moritz Seider,D,DET,23,77,6,46,52
33,8481560,Arthur Kaliyev,R,LAK,23,82,23,28,51
33,8475793,Ryan Johansen,C,PHI,32,73,20,31,51
33,8477964,Ivan Barbashev,C,VGK,29,77,19,32,51
33,8477456,J.T. Compher,L,DET,29,80,17,34,51
33,8471724,Kris Letang,D,PIT,37,77,11,40,51
33,8476854,Hampus Lindholm,D,BOS,30,78,8,43,51
33,8476483,Rickard Rakell,R,PIT,31,75,27,23,50
33,8480188,Fabian Zetterlund,L,SJS,25,65,25,25,50
33,8482133,Thomas Bordeleau,C,SJS,22,74,16,34,50
33,8477932,Aaron Ekblad,D,FLA,28,70,15,35,50
33,8478046,Danton Heinen,L,VAN,29,68,22,27,49
33,8478440,Dylan Strome,C,WSH,27,69,19,30,49
33,8477021,Alex Kerfoot,C,UTA,30,74,19,30,49
33,8475151,Kyle Palmieri,C,NYI,33,81,19,30,49
33,8481528,Dylan Cozens,C,BUF,23,75,18,31,49
33,8475218,Mattias Ekholm,D,EDM,34,77,17,32,49
33,8476479,Phillip Danault,C,LAK,31,80,15,34,49
33,8476905,Chandler Stephenson,C,SEA,30,72,12,37,49
33,8476869,Brady Skjei,D,NSH,30,73,7,42,49
33,8475314,Anders Lee,L,NYI,34,77,27,21,48
33,8483808,Andrei Kuzmenko,L,CGY,28,69,23,25,48
33,8471214,Alex Ovechkin,L,WSH,39,69,22,26,48
33,8474586,Jordan Eberle,R,SEA,34,75,15,33,48
33,8476875,Mike Matheson,D,MTL,30,72,9,39,48
33,8476880,Tom Wilson,R,WSH,30,69,23,24,47
33,8476399,Blake Coleman,C,CGY,33,77,23,24,47
33,8478975,Mason Marchment,L,DAL,29,82,18,29,47
33,8474679,Gustav Nyquist,C,NSH,35,70,17,30,47
33,8477447,Shea Theodore,D,VGK,29,62,9,38,47
33,8476906,Shayne Gostisbehere,D,CAR,31,75,8,39,47
33,8477426,Nicholas Paul,L,TBL,29,82,24,22,46
33,8474641,Adam Henrique,C,EDM,34,75,22,24,46
33,8482092,Ridly Greig,C,OTT,22,80,22,24,46
33,8476925,Colton Sissons,C,NSH,31,67,22,24,46
33,8477407,Anthony Duclair,L,NYI,29,80,21,25,46
33,8476882,Teuvo Teravainen,C,CHI,30,64,19,27,46
33,8481711,Matias Maccelli,L,UTA,24,76,18,28,46
33,8477497,Sean Monahan,C,CBJ,30,76,17,29,46
33,8474590,John Carlson,D,WSH,34,71,7,39,46
33,8478438,Tommy Novak,C,NSH,27,68,17,28,45
33,8479339,Patrik Laine,L,CBJ,26,67,15,30,45
33,8481703,Valtteri Puustinen,R,PIT,25,62,12,33,45
33,8476958,Jaccob Slavin,D,CAR,30,76,7,38,45
33,8479525,Ross Colton,C,COL,28,79,26,18,44
33,8475784,Jeff Skinner,C,EDM,32,78,22,22,44
33,8482110,Dawson Mercer,C,NJD,23,65,21,23,44
33,8477429,Andrew Copp,C,DET,30,78,21,23,44
33,8482097,Jack Quinn,R,BUF,23,59,20,24,44
33,8482093,Seth Jarvis,C,CAR,22,71,18,26,44
33,8480028,Morgan Frost,C,PHI,25,75,14,30,44
33,8481596,Shane Pinto,C,OTT,24,76,13,31,44
33,8481581,Thomas Harley,D,DAL,23,74,11,33,44
33,8480813,Joe Veleno,C,DET,24,73,20,23,43
33,8475158,Ryan O'Reilly,C,NSH,33,71,19,24,43
33,8479992,Michael Rasmussen,C,DET,25,78,19,24,43
33,8475191,Reilly Smith,R,NYR,33,76,18,25,43
33,8482702,Logan Stankoven,C,DAL,21,82,17,26,43
33,8480798,Philipp Kurashev,C,CHI,25,63,15,28,43
33,8476923,Damon Severson,D,CBJ,30,79,13,30,43
33,8476458,Ryan Strome,C,ANA,31,73,12,31,43
33,8475753,Justin Faulk,D,STL,32,70,11,32,43
33,8479425,Filip Hronek,D,VAN,27,70,9,34,43
33,8480009,Eeli Tolvanen,R,SEA,25,71,23,19,42
33,8481604,Pavel Dorofeyev,L,VGK,24,73,20,22,42
33,8479400,Pierre-Luc Dubois,L,WSH,26,68,14,28,42
33,8475745,Charlie Coyle,C,BOS,32,77,9,33,42
33,8478038,Devon Toews,D,COL,30,66,5,37,42
33,8480014,Gabriel Vilardi,C,WPG,25,71,23,18,41
33,8482720,Matthew Knies,L,TOR,22,75,14,27,41
33,8478469,Thomas Chabot,D,OTT,27,66,13,28,41
33,8482667,William Eklund,L,SJS,22,68,12,29,41
33,8480893,Kirill Marchenko,R,CBJ,24,61,26,14,40
33,8476432,Boone Jenner,C,CBJ,31,74,22,18,40
33,8477505,Alexander Wennberg,C,SJS,30,65,16,24,40
33,8476927,Teddy Blueger,C,VAN,30,68,16,24,40
33,8477479,Tyler Bertuzzi,L,CHI,29,62,15,25,40
33,8477495,Seth Jones,D,CHI,30,66,10,30,40
33,8482712,Oskar Olausson,R,COL,22,74,5,35,40
33,8477511,Anthony Mantha,R,CGY,30,77,22,17,39
33,8478474,Lawson Crouse,L,UTA,27,74,19,20,39
33,8482475,Yegor Chinakhov,R,CBJ,23,65,19,20,39
33,8480829,Jesperi Kotkaniemi,C,CAR,24,70,17,22,39
33,8481618,Alex Newhook,C,MTL,23,74,16,23,39
33,8477346,MacKenzie Weegar,D,CGY,30,72,15,24,39
33,8471698,T.J. Oshie,R,WSH,38,65,14,25,39
33,8478472,Mathieu Joseph,R,STL,27,67,14,25,39
33,8476872,Scott Laughton,C,PHI,30,73,13,26,39
33,8475343,Nic Dowd,C,WSH,34,66,13,26,39
33,8478466,Daniel Sprong,R,VAN,27,73,12,27,39
33,8476792,Torey Krug,D,STL,33,75,10,29,39
33,8475799,Nino Niederreiter,R,WPG,32,69,24,14,38
33,8478462,Nicolas Roy,C,VGK,27,79,14,24,38
33,8478458,John (Jack) Roslovic,C,CAR,27,68,14,24,38
33,8477444,Andre Burakovsky,L,SEA,29,73,12,26,38
33,8481533,Trevor Zegras,C,ANA,23,69,10,28,38
33,8476463,Jonas Brodin,D,MIN,31,79,9,29,38
33,8482122,Brock Faber,D,MIN,22,80,8,30,38
33,8478397,Rasmus Andersson,D,CGY,28,71,6,32,38
33,8481186,Logan O'Connor,R,COL,28,80,22,15,37
33,8478057,Dakota Joshua,C,VAN,28,72,20,17,37
33,8480459,Pius Suter,C,VAN,28,69,17,20,37
33,8474716,Jared Spurgeon,D,MIN,35,76,14,23,37
33,8479345,Jakob Chychrun,D,WSH,26,67,14,23,37
33,8480817,K'Andre Miller,D,NYR,24,71,8,29,37
33,8480849,Barrett Hayton,C,UTA,24,76,20,16,36
33,8475763,Kevin Hayes,R,PIT,32,74,18,18,36
33,8482055,Drew O'Connor,L,PIT,26,60,18,18,36
33,8476474,Stefan Noesen,R,NJD,31,67,15,21,36
33,8482149,Cole Perfetti,C,WPG,22,63,14,22,36
33,8476292,Ondrej Palat,L,NJD,33,71,12,24,36
33,8478233,Andrew Mangiapane,L,WSH,28,66,10,26,36
33,8482105,Jake Sanderson,D,OTT,22,75,3,33,36
33,8482175,JJ Peterka,R,BUF,22,72,24,11,35
33,8474149,Evgenii Dadonov,R,DAL,35,81,18,17,35
33,8473986,Alex Killorn,L,ANA,35,75,16,19,35
33,8482671,Owen Power,D,BUF,22,73,13,22,35
33,8476480,Vladislav Namestnikov,C,WPG,32,62,12,23,35
33,8475193,Tomas Tatar,L,NJD,34,67,12,23,35
33,8475764,Cam Fowler,D,ANA,33,75,6,29,35
33,8477425,Miles Wood,L,COL,29,78,19,15,34
33,8478413,Jordan Greenway,L,BUF,27,63,17,17,34
33,8478020,Michael Amadio,R,OTT,28,76,16,18,34
33,8481535,Nils Hoglander,L,VAN,24,67,16,18,34
33,8479987,Morgan Geekie,C,BOS,26,81,15,19,34
33,8475287,Erik Haula,L,NJD,33,71,15,19,34
33,8481606,Jordan Spence,D,LAK,23,66,13,21,34
33,8480871,Adam Boqvist,D,FLA,24,74,9,25,34
33,8480434,Sean Durzi,D,UTA,26,67,6,28,34
33,8480145,Neal Pionk,D,WPG,29,69,5,29,34
33,8476979,Erik Gustafsson,D,DET,32,77,4,30,34
33,8475714,Calle Jarnkrok,C,TOR,33,66,18,15,33
33,8483505,Matthew Poitras,C,BOS,20,79,16,17,33
33,8477989,Christian Dvorak,C,MTL,28,66,15,18,33
33,8476392,Adam Lowry,C,WPG,31,70,14,19,33
33,8479365,Trent Frederic,C,BOS,26,77,12,21,33
33,8478463,Anthony Beauvillier,L,PIT,27,67,12,21,33
33,8477948,Travis Sanheim,D,PHI,28,69,1,32,33
33,8478911,Matt Roy,D,WSH,29,66,16,16,32
33,8476419,Jean-Gabriel Pageau,C,NYI,32,76,15,17,32
33,8474715,Cameron Atkinson,R,TBL,35,82,15,17,32
33,8478042,Viktor Arvidsson,L,EDM,31,73,11,21,32
33,8481523,Kirby Dach,C,MTL,23,72,11,21,32
33,8477488,Brett Pesce,D,NJD,30,74,10,22,32
33,8477953,Kasperi Kapanen,R,STL,28,64,8,24,32
33,8475149,Marcus Johansson,L,MIN,34,65,12,19,31
33,8482655,Janis Moser,D,TBL,24,79,10,21,31
33,8477986,Brandon Montour,D,SEA,30,73,9,22,31
33,8476826,Yanni Gourde,C,SEA,33,71,6,25,31
33,8482067,Connor Mackey,D,NYR,28,55,4,27,31
33,8481624,Ilya Mikheyev,R,CHI,30,59,18,12,30
33,8479390,Taylor Raddysh,R,WSH,26,65,17,13,30
33,8481554,Kaapo Kakko,R,NYR,23,71,15,15,30
33,8482101,Danil Gushchin,L,SJS,22,59,15,15,30
33,8479393,Noah Gregor,L,OTT,26,72,14,16,30
33,8478115,Pierre Engvall,L,NYI,28,78,12,18,30
33,8484203,Bradly Nadeau,L,CAR,19,66,12,18,30
33,8476278,Colin Blackwell,C,DAL,31,76,12,18,30
33,8483490,Pavel Mintyukov,D,ANA,21,75,11,19,30
33,8480220,Noah Cates,L,PHI,25,75,8,22,30
33,8480336,Sean Walker,D,CAR,30,76,7,23,30
33,8481577,Philip Tomasino,C,NSH,23,67,7,23,30
33,8482624,Daniil Miromanov,D,CGY,27,66,5,25,30
33,8478133,Jake Evans,C,MTL,28,72,5,25,30
33,8480891,Michael Kesselring,D,UTA,24,64,5,25,30
33,8476878,Zemgus Girgensons,C,TBL,30,80,20,9,29
33,8480748,Kiefer Sherwood,L,VAN,29,61,17,12,29
33,8479661,Tanner Jeannot,L,LAK,27,76,17,12,29
33,8482089,Jake Neighbours,L,STL,22,64,16,13,29
33,8475722,Jason Zucker,L,BUF,32,67,16,13,29
33,8481582,Nicholas Robertson,L,TOR,23,65,13,16,29
33,8479591,Michael Eyssimont,C,TBL,28,82,12,17,29
33,8480074,Alexandre Texier,C,STL,25,59,10,19,29
33,8477506,Ryan Pulock,D,NYI,30,80,5,24,29
33,8476917,Adam Pelech,D,NYI,30,80,5,24,29
33,8476331,Dylan DeMelo,D,WPG,31,72,4,25,29
33,8478500,Ivan Provorov,D,CBJ,27,80,3,26,29
33,8478507,John Marino,D,UTA,27,68,2,27,29
33,8480113,Alex Iafallo,L,WPG,31,68,15,13,28
33,8477450,Jason Dickinson,C,CHI,29,61,14,14,28
33,8477015,Connor Brown,R,EDM,30,65,14,14,28
33,8481656,Aliaksei Protas,C,WSH,23,62,12,16,28
33,8476461,Sean Couturier,C,PHI,32,69,12,16,28
33,8482705,Cole Sillinger,C,CBJ,21,63,12,16,28
33,8484145,Zach Benson,L,BUF,19,72,11,17,28
33,8477947,Sonny Milano,L,WSH,28,63,11,17,28
33,8483445,Cutter Gauthier,L,ANA,20,61,11,17,28
33,8475231,Casey Cizikas,C,NYI,33,71,10,18,28
33,8477839,Conor Sheary,L,TBL,32,82,9,19,28
33,8476312,Josh Manson,D,COL,33,63,9,19,28
33,8479351,Sam Steel,C,DAL,26,79,8,20,28
33,8474565,Alex Pietrangelo,D,VGK,34,59,7,21,28
33,8478396,Noah Hanifin,D,VGK,27,62,5,23,28
33,8480873,Rasmus Sandin,D,WSH,24,64,4,24,28
33,8475848,Brendan Gallagher,R,MTL,32,71,19,8,27
33,8482259,Bobby McMann,C,TOR,28,63,14,13,27
33,8476897,Oskar Sundqvist,C,STL,30,68,13,14,27
33,8478891,Mason Appleton,C,WPG,28,64,12,15,27
33,8474053,Logan Couture,C,SJS,35,61,7,20,27
33,8479982,Conor Timmins,D,TOR,26,53,7,20,27
33,8482245,Artem Zub,D,OTT,29,69,6,21,27
33,8482111,Justin Barron,D,MTL,23,72,6,21,27
33,8476891,Matthew Grzelcyk,D,PIT,30,74,4,23,27
33,8475233,David Savard,D,MTL,34,67,4,23,27
33,8477969,Marcus Pettersson,D,PIT,28,79,3,24,27
33,8478109,Victor Olofsson,L,VGK,29,63,15,11,26
33,8479414,Nathan Bastian,R,NJD,27,64,12,14,26
33,8479353,Brett Howden,C,VGK,26,74,11,15,26
33,8480003,Jesper Boqvist,C,FLA,26,66,10,16,26
33,8481546,Cam York,D,PHI,23,70,9,17,26
33,8476892,Colton Parayko,D,STL,31,69,5,21,26
33,8478882,Vladislav Gavrikov,D,LAK,29,66,4,22,26
33,8480246,Nick Perbix,D,TBL,26,74,4,22,26
33,8480448,Parker Kelly,L,COL,25,74,17,8,25
33,8479941,Justin Danforth,R,CBJ,31,51,16,9,25
33,8479336,Carl Grundstrom,R,SJS,27,57,15,10,25
33,8473533,Jordan Staal,C,CAR,36,58,12,13,25
33,8482079,Marco Rossi,C,MIN,23,57,12,13,25
33,8483565,Nick Blankenburg,D,NSH,26,62,9,16,25
33,8480144,David Kampf,C,TOR,29,73,8,17,25
33,8474574,Tyler Myers,D,VAN,34,71,7,18,25
33,8477498,Darnell Nurse,D,EDM,29,74,6,19,25
33,8482142,Jamie Drysdale,D,PHI,22,59,6,19,25
33,8480043,Timothy Liljegren,D,TOR,25,60,5,20,25
33,8479983,Mario Ferraro,D,SJS,26,71,5,20,25
33,8479398,Samuel Girard,D,COL,26,68,5,20,25
33,8475171,Oliver Ekman-Larsson,D,TOR,33,65,4,21,25
33,8479980,Nicolas Hague,D,VGK,26,55,4,21,25
33,8479293,Brandon Tanev,L,SEA,33,68,18,6,24
33,8480855,Jack McBain,C,UTA,24,71,12,12,24
33,8477392,Hudson Fasching,R,NYI,29,60,11,13,24
33,8482146,Luke Evangelista,R,NSH,22,61,10,14,24
33,8479996,Cody Glass,C,NSH,25,55,10,14,24
33,8480068,Ryan Poehling,C,PHI,25,68,9,15,24
33,8476329,Travis Boyd,C,MIN,31,61,9,15,24
33,8480025,MacKenzie Entwistle,R,FLA,25,65,9,15,24
33,8477952,Robby Fabbri,C,ANA,28,63,8,16,24
33,8479026,Philippe Myers,D,TOR,27,57,7,17,24
33,8481522,Peyton Krebs,C,BUF,23,60,6,18,24
33,8476960,Andreas Athanasiou,C,CHI,30,57,6,18,24
33,8476967,Brett Kulak,D,EDM,30,62,4,20,24
33,8482074,Connor Zary,C,CGY,23,65,11,12,23
33,8480222,Sebastian Aho,D,PIT,28,70,8,15,23
33,8476994,Vinnie Hinostroza,C,NSH,30,53,8,15,23
33,8478840,Will Borgen,D,SEA,28,69,5,18,23
33,8474151,Ryan McDonagh,D,TBL,35,78,3,20,23
33,8479619,Michael Carcone,L,UTA,28,55,14,8,22
33,8476469,Joel Armia,R,MTL,31,64,14,8,22
33,8481580,Connor McMichael,C,WSH,23,68,13,9,22
33,8481553,Bobby Brink,R,PHI,23,60,12,10,22
33,8476918,Jimmy Vesey,L,NYR,31,67,11,11,22
33,8475225,Craig Smith,C,CHI,35,58,11,11,22
33,8479316,Luke Kunin,C,SJS,27,53,11,11,22
33,8476885,Jacob Trouba,D,NYR,30,67,9,13,22
33,8481481,Blake Lizotte,C,PIT,27,54,9,13,22
33,8470621,Corey Perry,R,EDM,39,71,9,13,22
33,8481093,Rafael Harvey-Pinard,L,MTL,25,59,9,13,22
33,8476921,Jordan Martinook,L,CAR,32,62,8,14,22
33,8480789,Oliver Wahlstrom,R,NYI,24,71,8,14,22
33,8481441,Joe Snively,C,DET,28,67,7,15,22
33,8473422,Nick Foligno,L,CHI,37,63,7,15,22
33,8481537,Nikita Okhotiuk,D,CGY,24,49,7,15,22
33,8477508,Curtis Lazar,C,NJD,29,64,6,16,22
33,8478136,Jake Middleton,D,MIN,28,77,6,16,22
33,8476931,Jake McCabe,D,TOR,31,61,6,16,22
33,8483457,Lane Hutson,D,MTL,20,67,6,16,22
33,8475690,Chris Tanev,D,TOR,35,65,5,17,22
33,8482155,Alex Laferriere,R,LAK,23,59,16,5,21
33,8480802,Ryan McLeod,C,BUF,25,67,13,8,21
33,8483524,Shane Wright,C,SEA,20,60,10,11,21
33,8476981,Josh Anderson,R,MTL,30,64,10,11,21
33,8482192,Isaak Phillips,D,CHI,23,53,9,12,21
33,8473453,Trevor Lewis,C,LAK,37,77,9,12,21
33,8480011,Klim Kostin,C,SJS,25,54,9,12,21
33,8476374,Sean Kuraly,C,CBJ,31,58,9,12,21
33,8474189,Lars Eller,C,PIT,35,64,8,13,21
33,8480078,Filip Chytil,C,NYR,25,62,8,13,21
33,8480806,Isac Lundestrom,C,ANA,25,61,8,13,21
33,8478421,A.J. Greer,L,FLA,28,62,8,13,21
33,8477987,Ryan Donato,C,CHI,28,64,7,14,21
33,8483493,Frank Nazar,C,CHI,20,53,7,14,21
33,8479976,Juuso Valimaki,D,UTA,26,58,6,15,21
33,8481019,David Gustafsson,C,WPG,24,50,6,15,21
33,8477507,Nikita Zadorov,D,BOS,29,66,6,15,21
33,8480835,Jack Drury,C,CAR,24,60,5,16,21
33,8476467,Jamie Oleksiak,D,SEA,32,70,3,18,21
33,8475181,Nick Leddy,D,STL,33,66,2,19,21
33,8475790,Erik Gudbranson,D,CBJ,32,80,1,20,21
33,8480762,Eric Robinson,L,CAR,29,55,12,8,20
33,8478508,Yakov Trenin,C,MIN,27,54,11,9,20
33,8475791,Taylor Hall,L,CHI,33,55,10,10,20
33,8477353,Tyler Motte,C,DET,29,74,10,10,20
33,8476889,Radek Faksa,C,STL,30,57,10,10,20
33,8481032,Paul Cotter,C,NJD,25,53,9,11,20
33,8478434,Keegan Kolesar,R,VGK,27,65,9,11,20
33,8480021,Jack Studnicka,C,LAK,25,61,9,11,20
33,8483468,Jiri Kulich,C,BUF,20,61,8,12,20
33,8479639,Dylan Coghlan,D,WPG,26,63,7,13,20
33,8477919,Frederick Gaudreau,C,MIN,31,65,7,13,20
33,8477220,Nate Schmidt,D,FLA,33,73,7,13,20
33,8477369,Carson Soucy,D,VAN,30,63,7,13,20
33,8482073,Braden Schneider,D,NYR,23,66,6,14,20
33,8483499,Liam Ohgren,L,MIN,20,50,6,14,20
33,8475200,Dmitry Orlov,D,CAR,33,70,5,15,20
33,8477435,Ryan Graves,D,PIT,29,74,5,15,20
33,8482087,Kaiden Guhle,D,MTL,22,62,5,15,20
33,8483491,Ivan Miroshnichenko,L,WSH,20,52,5,15,20
33,8476879,Cody Ceci,D,EDM,31,66,3,17,20
33,8473507,Jeff Petry,D,DET,37,71,3,17,20
33,8478178,Darren Raddysh,D,TBL,28,66,1,19,20
33,8482679,Matt Coronato,R,CGY,22,60,9,10,19
33,8477931,Tomas Nosek,L,FLA,32,63,9,10,19
33,8482125,Alexander Holtz,R,VGK,22,67,8,11,19
33,8478013,Jake Walman,D,SJS,28,69,7,12,19
33,8473563,Nicklas Backstrom,C,WSH,37,57,6,13,19
33,8480796,Martin Fehervary,D,WSH,25,59,5,14,19
33,8481524,Bowen Byram,D,BUF,23,62,4,15,19
33,8477903,Garnet Hathaway,R,PHI,33,62,10,8,18
33,8482062,Cole Smith,L,NSH,29,57,9,9,18
33,8476934,Brock McGinn,L,ANA,30,49,9,9,18
33,8482660,Kent Johnson,C,CBJ,22,53,8,10,18
33,8482809,Jackson Blake,R,CAR,21,57,7,11,18
33,8475855,Jesper Fast,R,CAR,33,55,5,13,18
33,8477573,Nathan Walker,L,STL,30,57,5,13,18
33,8476856,Mathew Dumba,D,DAL,30,70,4,14,18
33,8475462,Radko Gudas,D,ANA,34,66,4,14,18
33,8476988,Matt Benning,D,SJS,30,60,4,14,18
33,8475455,Brenden Dillon,D,NJD,34,56,3,15,18
33,8479998,Mikey Anderson,D,LAK,25,60,2,16,18
33,8481599,Victor Soderstrom,D,UTA,23,44,2,16,18
33,8475188,Brayden McNabb,D,VGK,33,49,1,17,18
33,8474673,TJ Brodie,D,CHI,34,71,0,18,18
33,8482744,James Malatesta,L,CBJ,21,49,13,4,17
33,8482749,Joshua Roy,R,MTL,21,57,11,6,17
33,8478831,Kevin Stenlund,C,UTA,28,60,11,6,17
33,8480205,Emil Bemstrom,C,PIT,25,56,10,7,17
33,8477979,Nicolas Aube-Kubel,R,BUF,28,52,10,7,17
33,8480995,Pontus Holmberg,R,TOR,25,66,9,8,17
33,8479368,Max Jones,L,BOS,26,67,8,9,17
33,8478432,Christian Fischer,R,DET,27,73,8,9,17
33,8480281,Alexey Toropchenko,R,STL,25,57,8,9,17
33,8481601,Simon Holmstrom,R,NYI,23,69,7,10,17
33,8483482,Tristan Luneau,D,ANA,20,64,7,10,17
33,8481013,Jonatan Berggren,R,DET,24,59,7,10,17
33,8479315,Joey Anderson,R,CHI,26,43,6,11,17
33,8482157,Will Cuylle,L,NYR,22,61,6,11,17
33,8476457,Adam Larsson,D,SEA,32,63,3,14,17
33,8480878,Nils Lundkvist,D,DAL,24,72,2,15,17
33,8475324,Nick Jensen,D,OTT,34,67,2,15,17
33,8479369,Andrew Peeke,D,BOS,26,62,2,15,17
33,8481059,Scott Perunovich,D,STL,26,63,1,16,17
33,8478851,Alexandre Carrier,D,NSH,28,60,1,16,17
33,8479402,Jake Bean,D,CGY,26,67,1,16,17
33,8481704,Juuso Parssinen,C,NSH,23,61,10,6,16
33,8482176,Wyatt Kaiser,D,CHI,22,52,8,8,16
33,8479066,Ryan Lomberg,L,CGY,30,56,8,8,16
33,8479439,Jacob MacDonald,D,COL,31,58,8,8,16
33,8482117,Lukas Reichel,L,CHI,22,52,7,9,16
33,8482803,Olen Zellweger,D,ANA,21,65,7,9,16
33,8479718,Alex Barré-Boulet,C,MTL,27,45,7,9,16
33,8477478,William Carrier,L,CAR,30,45,6,10,16
33,8480441,Trey Fix-Wolansky,R,CBJ,25,35,6,10,16
33,8478970,Jalen Chatfield,D,CAR,28,70,5,11,16
33,8481014,Alexander Romanov,D,NYI,24,77,5,11,16
33,8480035,Henri Jokiharju,D,BUF,25,58,4,12,16
33,8475179,Dmitry Kulikov,D,FLA,34,63,4,12,16
33,8481708,Zac Jones,D,NYR,24,56,3,13,16
33,8479371,Dante Fabbro,D,NSH,26,67,3,13,16
33,8476525,Colin Miller,D,WPG,32,68,2,14,16
33,8480070,Ian Mitchell,D,BOS,25,47,2,14,16
33,8482762,Simon Edvinsson,D,DET,21,57,9,6,15
33,8476873,Mark Jankowski,C,NSH,30,53,8,7,15
33,8482730,Brandt Clarke,D,LAK,21,49,8,7,15
33,8481617,Vasily Podkolzin,R,VAN,23,53,8,7,15
33,8482077,Dylan Holloway,L,EDM,23,46,8,7,15
33,8479328,Julien Gauthier,R,NYI,27,65,7,8,15
33,8482451,Mikael Pyyhtia,L,CBJ,23,42,6,9,15
33,8477018,Ben Hutton,D,VGK,31,50,6,9,15
33,8480252,Cole Guttman,C,CHI,25,40,6,9,15
33,8482148,Hendrix Lapierre,C,WSH,22,54,6,9,15
33,8478211,Dryden Hunt,L,CGY,29,55,5,10,15
33,8476429,Scott Mayfield,D,NYI,32,73,3,12,15
33,8476902,Esa Lindell,D,DAL,30,72,3,12,15
33,8475279,Ben Chiarot,D,DET,33,62,3,12,15
33,8477499,Rasmus Ristolainen,D,PHI,30,64,2,13,15
33,8481178,Egor Zamula,D,PHI,24,54,2,13,15
33,8478399,Jonas Siegenthaler,D,NJD,27,58,0,15,15
33,8475842,Sam Carrick,C,NYR,32,58,9,5,14
33,8482859,Zack Ostapchuk,C,OTT,21,53,8,6,14
33,8481641,Joel Kiviranta,L,COL,28,70,7,7,14
33,8480980,Connor Dewar,C,TOR,25,63,7,7,14
33,8476858,Phillip Di Giuseppe,L,VAN,31,37,7,7,14
33,8482737,Zack Bolduc,C,STL,21,59,6,8,14
33,8484149,Gavin Brindley,C,CBJ,20,54,6,8,14
33,8478017,Mark Friedman,D,VAN,29,42,6,8,14
33,8480834,Ty Emberson,D,SJS,24,36,6,8,14
33,8478569,Noel Acciari,C,PIT,33,52,5,9,14
33,8477406,Mattias Janmark,C,EDM,32,70,5,9,14
33,8479442,Troy Stecher,D,EDM,30,57,5,9,14
33,8481161,Jake Christiansen,D,CBJ,25,57,5,9,14
33,8480157,Calle Rosen,D,COL,30,45,5,9,14
33,8477380,Jonny Brodzinski,C,NYR,31,45,4,10,14
33,8480289,Morgan Barron,C,WPG,26,56,4,10,14
33,8481568,Alex Vlasic,D,CHI,23,52,4,10,14
33,8481567,Henry Thrun,D,SJS,23,52,4,10,14
33,8479324,Ryan Lindgren,D,NYR,26,62,2,12,14
33,8477034,Jaycob Megna,D,FLA,32,44,2,12,14
33,8470600,Ryan Suter,D,STL,39,62,1,13,14
33,8478452,Caleb Jones,D,LAK,27,54,1,13,14
33,8481477,Nico Sturm,C,SJS,29,44,10,3,13
33,8478585,Derek Ryan,C,EDM,38,64,10,3,13
33,8481556,John Beecher,C,BOS,23,41,10,3,13
33,8480355,Mark Kastelic,C,BOS,25,52,8,5,13
33,8480192,Johnathan Kovacevic,D,NJD,27,50,8,5,13
33,8481716,Dmitri Voronkov,L,CBJ,24,38,7,6,13
33,8478443,Brandon Carlo,D,BOS,28,59,5,8,13
33,8475220,Marcus Foligno,L,MIN,33,59,5,8,13
33,8482713,Mackie Samoskevich,R,FLA,22,42,5,8,13
33,8482861,Vincent Iorio,D,WSH,22,32,4,9,13
33,8475718,Justin Holl,D,DET,32,63,3,10,13
33,8479772,Zack MacEwen,R,OTT,28,56,3,10,13
33,8479372,Joshua Mahura,D,SEA,26,58,3,10,13
33,8483460,David Jiricek,D,CBJ,21,55,3,10,13
33,8482964,Arber Xhekaj,D,MTL,23,51,3,10,13
33,8480049,Dylan Samberg,D,WPG,25,60,2,11,13
33,8479370,Tyson Jost,C,CAR,26,55,2,11,13
33,8474567,Zach Bogosian,D,MIN,34,58,1,12,13
33,8481167,Brayden Pachal,D,CGY,25,47,1,12,13
33,8477845,Trevor van Riemsdyk,D,WSH,33,58,0,13,13
33,8481789,Tye Kartye,L,SEA,23,45,8,4,12
33,8483495,Simon Nemec,D,NJD,20,50,6,6,12
33,8479968,Vinni Lettieri,C,BOS,29,51,6,6,12
33,8475958,Michael Sgarbossa,C,WSH,32,32,5,7,12
33,8480007,Jonas Rondbjerg,R,VGK,25,38,5,7,12
33,8479344,Jesse Puljujarvi,R,PIT,26,57,4,8,12
33,8478451,Ethan Bear,D,WSH,27,49,4,8,12
33,8481527,Kaedan Korczak,D,VGK,23,45,4,8,12
33,8481701,Santeri Hatakka,D,NJD,23,41,4,8,12
33,8475177,Calvin de Haan,D,COL,33,52,4,8,12
33,8475208,Brian Dumoulin,D,ANA,33,67,3,9,12
33,8479972,Mason Shaw,C,WPG,26,41,3,9,12
33,8478416,Erik Cernak,D,TBL,27,72,2,10,12
33,8471709,Marc-Edouard Vlasic,D,SJS,37,67,2,10,12
33,8478859,Niko Mikkola,D,FLA,28,61,2,10,12
33,8477365,Connor Clifton,D,BUF,29,60,1,11,12
33,8479520,Brandon Duhaime,R,WSH,27,55,7,4,11
33,8481028,Martin Pospisil,C,CGY,25,49,6,5,11
33,8480073,Erik Brannstrom,D,COL,25,54,5,6,11
33,8481517,Brett Leason,R,ANA,25,58,5,6,11
33,8474166,Alec Martinez,D,CHI,37,44,5,6,11
33,8482747,Brennan Othmann,L,NYR,21,42,5,6,11
33,8477446,Michael McCarron,R,NSH,29,50,4,7,11
33,8481521,Ronnie Attard,D,PHI,25,56,4,7,11
33,8478468,Jeremy Lauzon,D,NSH,27,48,4,7,11
33,8479359,Beck Malenstyn,L,BUF,26,51,4,7,11
33,8477482,Zachary Sanford,L,CHI,30,35,4,7,11
33,8480807,Mattias Samuelsson,D,BUF,24,56,3,8,11
33,8476422,Mike Reilly,D,NYI,31,76,1,10,11
33,8479671,Mathieu Olivier,R,CBJ,27,50,7,3,10
33,8482784,Zach Dean,C,STL,21,48,7,3,10
33,8481592,Jakob Pelletier,L,CGY,23,43,5,5,10
33,8474034,Patrick Maroon,L,CHI,36,50,4,6,10
33,8482511,Mason Lohrei,D,BOS,23,36,4,6,10
33,8476874,Olli Maatta,D,DET,30,60,3,7,10
33,8478043,Sam Lafferty,C,BUF,29,60,2,8,10
33,8483466,Kevin Korchinski,D,CHI,20,45,2,8,10
33,8479249,Andrew Poturalski,C,SJS,30,28,2,8,10
33,8474013,Ian Cole,D,UTA,35,53,2,8,10
33,8480845,Rasmus Kupari,C,WPG,24,38,2,8,10
33,8476442,Matt Nieto,L,PIT,32,47,1,9,10
33,8479638,Justin Brazeau,R,BOS,26,39,7,2,9
33,8481147,Reese Johnson,C,MIN,26,38,6,3,9
33,8482666,Scott Morrow,D,CAR,22,50,6,3,9
33,8477070,Liam O'Brien,C,UTA,30,40,5,4,9
33,8480727,Zach Whitecloud,D,VGK,28,47,5,4,9
33,8479986,Kole Lind,R,DAL,26,48,4,5,9
33,8477938,Haydn Fleury,D,WPG,28,55,4,5,9
33,8481532,Alex Turcotte,C,LAK,23,34,3,6,9
33,8475750,Jon Merrill,D,MIN,32,58,2,7,9
33,8479944,Zach Aston-Reese,C,VGK,30,55,2,7,9
33,8480001,Urho Vaakanainen,D,ANA,25,50,1,8,9
33,8480860,Kevin Bahl,D,CGY,24,56,1,8,9
33,8479348,Kale Clague,D,BUF,26,35,0,9,9
33,8480058,Pierre-Olivier Joseph,D,STL,25,51,0,9,9
33,8477962,Brendan Lemieux,L,CAR,28,41,6,2,8
33,8474090,Brendan Smith,D,DAL,35,56,4,4,8
33,8482095,Tyler Kleven,D,OTT,22,41,4,4,8
33,8482652,Walker Duehr,R,CGY,27,47,4,4,8
33,8476624,Barclay Goodrow,C,SJS,31,53,3,5,8
33,8475762,Derek Forbort,D,VAN,32,44,3,5,8
33,8482177,Marat Khusnutdinov,C,MIN,22,35,3,5,8
33,8477810,Joel Hanley,D,CGY,33,29,3,5,8
33,8481751,Lukas Rousek,R,BUF,25,34,2,6,8
33,8479994,Jaret Anderson-Dolan,C,WPG,25,32,2,6,8
33,8480887,Jordan Harris,D,MTL,24,50,1,7,8
33,8481600,Tobias Bjornfot,D,FLA,23,32,1,7,8
33,8482147,Jean-Luc Foudy,C,COL,22,29,5,2,7
33,8480848,Ty Dellandrea,C,SJS,24,37,5,2,7
33,8479981,Jonah Gadjovich,L,FLA,26,43,3,4,7
33,8479378,Logan Stanley,D,WPG,26,34,3,4,7
33,8480870,Bo Groulx,C,NYR,24,34,3,4,7
33,8480950,Ilya Lyubushkin,D,DAL,30,56,2,5,7
33,8482807,Ethan Del Mastro,D,CHI,21,53,2,5,7
33,8482634,Alex Steeves,C,TOR,25,42,2,5,7
33,8476913,Devin Shore,C,MIN,30,33,2,5,7
33,8475235,Nicolas Deslauriers,L,PHI,33,44,2,5,7
33,8480172,Jan Rutta,D,SJS,34,64,2,5,7
33,8477971,Andreas Englund,D,LAK,28,36,2,5,7
33,8471817,Ryan Reaves,R,TOR,37,62,2,5,7
33,8477335,Kyle Burroughs,D,LAK,29,42,2,5,7
33,8480879,Jacob Bernard-Docker,D,OTT,24,39,1,6,7
33,8481056,Spencer Stastney,D,NSH,24,33,1,6,7
33,8478409,Anthony Richard,C,PHI,28,34,1,6,7
33,8479576,Vincent Desharnais,D,VAN,28,29,0,7,7
33,8476372,Nick Seeler,D,PHI,31,46,0,7,7
33,8476867,Brendan Gaunce,C,MIN,30,35,5,1,6
33,8479543,Michael Pezzetta,L,MTL,26,64,4,2,6
33,8481462,Mason Morelli,L,VGK,28,17,4,2,6
33,8481518,Nolan Foote,L,NJD,24,34,3,3,6
33,8480990,Declan Chisholm,D,MIN,24,37,3,3,6
33,8479362,Riley Tufte,L,BOS,26,18,3,3,6
33,8482166,Shakir Mukhamadullin,D,SJS,22,48,2,4,6
33,8477384,Joshua Brown,D,EDM,30,41,2,4,6
33,8471677,Jack Johnson,D,CBJ,37,64,2,4,6
33,8483763,Maksymilian Szuber,D,UTA,22,34,2,4,6
33,8477887,Patrick Brown,C,BOS,32,39,2,4,6
33,8482153,Brendan Brisson,C,VGK,23,32,2,4,6
33,8478146,Matthew Highmore,C,OTT,28,36,2,4,6
33,8477851,Jordan Oesterle,D,BOS,32,39,2,4,6
33,8481122,Simon Benoit,D,TOR,26,40,2,4,6
33,8481754,Nikita Nesterenko,C,ANA,23,29,1,5,6
33,8480292,Carson Meyer,R,ANA,27,29,1,5,6
33,8479985,Cale Fleury,D,SEA,26,30,1,5,6
33,8476822,Luke Glendening,C,TBL,35,78,0,6,6
33,8479379,Givani Smith,R,SJS,26,32,0,6,6
33,8480196,Jacob Bryson,D,BUF,27,45,0,6,6
33,8481564,Ryan Johnson,D,BUF,23,18,0,6,6
33,8477401,John Hayden,C,SEA,29,23,4,1,5
33,8482496,Nils Aman,C,VAN,24,21,3,2,5
33,8482141,Lukas Cormier,D,VGK,22,33,3,2,5
33,8482145,Mavrik Bourque,C,DAL,22,48,3,2,5
33,8482070,Mitchell Chaffee,R,TBL,26,52,3,2,5
33,8482659,Josh Doan,R,UTA,22,45,2,3,5
33,8478454,Noah Juulsen,D,VAN,27,41,2,3,5
33,8473446,Erik Johnson,D,PHI,36,46,2,3,5
33,8479291,Kevin Rooney,C,CGY,31,52,2,3,5
33,8482144,Jack Thompson,D,SJS,22,25,2,3,5
33,8477527,Ross Johnston,L,ANA,30,39,2,3,5
33,8476952,Dominic Toninato,C,WPG,30,32,1,4,5
33,8480084,Nick DeSimone,D,NJD,30,19,1,4,5
33,8484258,Sam Malinski,D,COL,26,21,1,4,5
33,8484911,Collin Graf,R,SJS,22,38,0,5,5
33,8474612,Travis Hamonic,D,OTT,34,56,0,5,5
33,8483397,Marc McLaughlin,C,BOS,25,24,3,1,4
33,8480245,Olle Lycksell,R,PHI,25,29,3,1,4
33,8484287,Cole McWard,D,VAN,23,25,2,2,4
33,8479536,Axel Jonsson-Fjallby,L,WPG,26,34,2,2,4
33,8482733,Logan Mailloux,D,MTL,31,32,2,2,4
33,8482516,Matthew Kessel,D,STL,24,22,2,2,4
33,8482858,Ryker Evans,D,SEA,23,23,2,2,4
33,8477473,Justin Bailey,R,SJS,29,20,2,2,4
33,8475795,Dylan McIlrath,D,WSH,32,16,2,2,4
33,8478854,Ryan Shea,D,PIT,27,13,2,2,4
33,8476441,Joel Edmundson,D,LAK,31,39,1,3,4
33,8478424,Jansen Harkins,C,ANA,27,44,1,3,4
33,8482765,Isak Rosen,R,BUF,21,26,1,3,4
33,8483549,Lucas Condotta,L,MTL,27,33,1,3,4
33,8484254,Akito Hirose,D,VAN,25,31,1,3,4
33,8479320,Maxime Lajoie,D,SEA,27,20,1,3,4
33,8478450,Parker Wotherspoon,D,BOS,27,29,1,3,4
33,8481422,Jake Lucchini,C,NSH,29,25,1,3,4
33,8482250,Callahan Burke,C,VGK,27,21,1,3,4
33,8481699,Aku Raty,R,UTA,23,14,3,0,3
33,8480880,Jakub Lauko,C,MIN,24,33,2,1,3
33,8481679,Maxence Guenette,D,OTT,23,34,2,1,3
33,8482118,Sam Colangelo,R,ANA,23,13,2,1,3
33,8481598,Philip Broberg,D,EDM,23,40,2,1,3
33,8482172,Landon Slaggert,L,CHI,22,29,2,1,3
33,8481719,Maxwell Crozier,D,TBL,24,22,2,1,3
33,8482102,Vasily Ponomarev,C,PIT,22,20,2,1,3
33,8481593,Jayden Struble,D,MTL,23,19,2,1,3
33,8480468,James Hamblin,L,EDM,25,18,2,1,3
33,8481030,Jack St. Ivany,D,PIT,25,17,2,1,3
33,8480075,Cameron Crotty,D,MIN,25,10,2,1,3
33,8481550,Adam Beckman,L,NJD,23,35,1,2,3
33,8482751,Ryan Winterton,C,SEA,21,35,1,2,3
33,8482201,Gage Goncalves,C,TBL,23,24,1,2,3
33,8477462,Robert Hagg,D,VGK,29,30,1,2,3
33,8483630,Pavol Regenda,L,ANA,25,16,1,2,3
33,8482165,Yan Kuznetsov,D,CGY,22,19,1,2,3
33,8481743,Marc Del Gaizo,D,NSH,25,21,1,2,3
33,8478881,Brett Seney,L,CHI,28,12,1,2,3
33,8483407,Brandon Scanlin,D,NYR,25,10,1,2,3
33,8474568,Luke Schenn,D,NSH,35,50,0,3,3
33,8480267,Sammy Walker,C,MIN,25,20,0,3,3
33,8483619,Filip Roos,D,OTT,25,44,0,3,3
33,8478874,Adam Gaudette,R,OTT,28,24,0,3,3
33,8481237,Kyle MacLean,C,NYI,25,21,0,3,3
33,8478021,William Lagesson,D,DET,28,25,0,3,3
33,8480874,Adam Ginning,D,PHI,24,10,0,3,3
33,8482929,Emil Lilleberg,D,TBL,23,21,0,3,3
33,8479367,William Lockwood,R,FLA,26,15,2,0,2
33,8479587,Rhett Gardner,C,PHI,28,25,2,0,2
33,8480823,Alexander Alexeyev,D,WSH,25,5,2,0,2
33,8477467,Gustav Olofsson,D,SEA,30,13,2,0,2
33,8483471,Brad Lambert,C,WPG,31,12,2,0,2
33,8478446,Glenn Gawdin,C,LAK,27,16,2,0,2
33,8481543,Nikita Alexandrov,C,STL,24,21,1,1,2
33,8477149,Scott Sabourin,R,SJS,32,17,1,1,2
33,8482162,Roby Jarventie,L,EDM,22,15,1,1,2
33,8484325,Waltteri Merela,C,TBL,26,13,1,1,2
33,8483395,Arshdeep Bains,L,VAN,23,12,1,1,2
33,8479330,Brandon Gignac,C,MTL,27,5,1,1,2
33,8483012,Logan Morrison,C,SEA,22,29,1,1,2
33,8478502,Dennis Gilbert,D,BUF,28,18,1,1,2
33,8478051,Max Willman,C,NJD,29,18,1,1,2
33,8475413,Justin Dowling,C,NJD,34,15,1,1,2
33,8475780,Chris Wagner,R,COL,33,13,1,1,2
33,8477320,Anton Blidh,L,NYR,29,18,1,1,2
33,8477541,Dakota Mermis,D,TOR,30,11,1,1,2
33,8482787,Nikita Chibrikov,R,WPG,31,8,1,1,2
33,8481726,Adam Edstrom,C,NYR,24,10,1,1,2
33,8477244,Chad Ruhwedel,D,NYR,34,30,0,2,2
33,8481605,Jackson LaCombe,D,ANA,23,30,0,2,2
33,8483512,Matthew Savoie,C,EDM,20,22,0,2,2
33,8482470,Ilya Solovyov,D,CGY,24,16,0,2,2
33,8482094,Daemon Hunt,D,MIN,22,17,0,2,2
33,8477073,Kurtis MacDermid,L,NJD,30,34,0,2,2
33,8478477,Mitchell Stephens,C,SEA,27,23,0,2,2
33,8475755,Alexander Petrovic,D,DAL,32,12,0,2,2
33,8481609,Vladislav Kolyachonok,D,UTA,23,32,1,0,1
33,8481043,Cole Koepke,L,BOS,26,17,1,0,1
33,8481585,Egor Afanasyev,L,SJS,23,19,1,0,1
33,8479419,Brett Murray,L,BUF,26,13,1,0,1
33,8481065,Angus Crookshank,L,OTT,25,17,1,0,1
33,8480306,Grant Hutton,D,NYI,29,4,1,0,1
33,8482061,Brandon Biro,L,SEA,26,10,1,0,1
33,8477993,Justin Kirkland,C,CGY,28,4,1,0,1
33,8481206,John Ludvig,D,PIT,24,10,1,0,1
33,8481655,Cole Schwindt,R,CGY,23,7,1,0,1
33,8483546,Marshall Rifai,D,TOR,26,5,1,0,1
33,8476473,Connor Murphy,D,CHI,31,41,0,1,1
33,8483570,Ben Meyers,C,SEA,26,24,0,1,1
33,8479991,Jake Leschyshyn,C,NYR,25,27,0,1,1
33,8480844,Grigori Denisenko,L,VGK,24,21,0,1,1
33,8480890,Jan Jenik,C,OTT,24,25,0,1,1
33,8481006,Tyler Tucker,D,STL,24,14,0,1,1
33,8481806,Louis Crevier,D,CHI,23,15,0,1,1
33,8481541,Samuel Bolduc,D,NYI,24,20,0,1,1
33,8481024,Linus Karlsson,C,VAN,25,11,0,1,1
33,8483597,Milos Kelemen,L,UTA,25,10,0,1,1
33,8479522,Hardy Haman Aktell,D,WSH,26,5,0,1,1
33,8484255,Jason Polin,R,COL,25,2,0,1,1
33,8481578,Graeme Clarke,R,MIN,23,6,0,0,0
33,8484304,Uvis Balinskis,D,FLA,28,4,0,0,0
33,8483531,Brian Halonen,L,NJD,25,1,0,0,0
33,8479421,Jacob Moverare,D,LAK,26,7,0,0,0
33,8474062,Riley Nash,C,NYR,35,17,0,0,0
33,8480032,Shane Bowers,C,NJD,25,19,0,0,0
33,8478011,Louie Belpedio,D,PHI,28,15,0,0,0
33,8483609,Adam Klapka,R,CGY,24,7,0,0,0
33,8482476,Emil Heineman,L,MTL,23,8,0,0,0
33,8483432,Luca Del Bel Belluz,C,CBJ,31,4,0,0,0
33,8476323,Max McCormick,L,SEA,32,4,0,0,0
33,8483401,Marc Johnstone,R,PIT,28,1,0,0,0
33,8483567,Georgii Merkulov,C,BOS,24,6,0,0,0
33,8482460,Matt Rempe,C,NYR,22,9,0,0,0
33,8478147,Bokondji Imama,L,PIT,28,6,0,0,0
33,8483489,Fraser Minten,C,TOR,31,11,0,0,0
33,8480851,Akil Thomas,C,LAK,24,14,0,0,0
33,8483920,Pierrick Dube,R,WSH,23,4,0,0,0
33,8482197,Adam Raska,R,MIN,23,8,0,0,0
33,8483045,Cameron Butler,R,CBJ,31,1,0,0,0
33,8481534,Raphael Lavoie,C,EDM,24,2,0,0,0
33,8482126,Emil Andrae,D,PHI,31,3,0,0,0
33,8482088,Justin Sourdif,R,FLA,22,18,0,0,0
33,8483398,Declan Carlile,D,TBL,31,3,0,0,0
33,8478956,Samuel Laberge,L,NJD,27,2,0,0,0
33,8480274,Philip Kemp,D,EDM,25,1,0,0,0
33,8484259,Ondrej Pavel,C,COL,31,1,0,0,0
33,8484326,Patrik Koch,D,UTA,28,1,0,0,0
33,8484321,Nikolas Matinpalo,D,OTT,26,1,0,0,0
33,8470794,Joe Pavelski,C,,40,0,0,0,0
33,8479321,Lucas Johansen,D,,27,0,0,0,0
33,8477950,Tony DeAngelo,D,,29,0,0,0,0
33,8471218,Blake Wheeler,R,,38,0,0,0,0
33,8475197,Tyson Barrie,D,,33,0,0,0,0
33,8474157,Max Pacioretty,L,,36,0,0,0,0
33,8475744,Evgeny Kuznetsov,C,,32,0,0,0,0
33,8474037,James van Riemsdyk,L,,35,0,0,0,0
33,8476907,Mackenzie MacEachern,L,,30,0,0,0,0
33,8480216,Jacob Peterson,C,,25,0,0,0,0
33,8474602,Justin Schultz,D,,34,0,0,0,0
33,8482222,Alexander Barabanov,L,,30,0,0,0,0
33,8474031,Kevin Shattenkirk,D,,35,0,0,0,0
33,8477330,Dominik Kubalik,L,,29,0,0,0,0
33,8480884,Calen Addison,D,,24,0,0,0,0
33,8475906,John Klingberg,D,,32,0,0,0,0
33,8480008,Adam Ruzicka,C,,25,0,0,0,0
33,8476884,Derrick Pouliot,D,,30,0,0,0,0
33,8476919,Chris Tierney,C,,30,0,0,0,0
33,8479415,Michael McLeod,C,,26,0,0,0,0
33,8474870,Tyler Johnson,C,,34,0,0,0,0
33,8470604,Jeff Carter,C,,39,0,0,0,0
33,8478104,Sammy Blais,L,,28,0,0,0,0
33,8474884,Mike Hoffman,C,,35,0,0,0,0
33,8481591,Sam Poulin,R,,23,0,0,0,0
33,8471274,Alex Goligoski,D,,39,0,0,0,0
33,8476871,Tanner Pearson,L,,32,0,0,0,0
33,8476393,Nick Cousins,C,,31,0,0,0,0
33,8479977,Kailer Yamamoto,R,,26,0,0,0,0
33,8479346,Dillon Dube,C,,26,0,0,0,0
33,8480184,Gustav Lindstrom,D,,26,0,0,0,0
33,8479376,Victor Mete,D,,26,0,0,0,0
33,8473449,Kyle Okposo,R,,36,0,0,0,0
33,8481058,Jesse Ylonen,R,,25,0,0,0,0
33,8475752,Tyler Pitlick,C,,33,0,0,0,0
33,8481239,Samuel Fagemo,L,,24,0,0,0,0
33,8480821,Filip Zadina,R,,25,0,0,0,0
33,8470966,Mark Giordano,D,,41,0,0,0,0
33,8478495,Denis Gurianov,R,,27,0,0,0,0
33,8477464,Nic Petan,C,,29,0,0,0,0
33,8478099,Kevin Labanc,R,,29,0,0,0,0
33,8482241,Radim Zohorna,L,,28,0,0,0,0
33,8474040,Sam Gagner,C,,35,0,0,0,0
33,8479514,Rem Pitlick,C,,27,0,0,0,0
33,8478430,Oliver Kylington,D,,27,0,0,0,0
33,8479533,Joona Koppanen,L,,26,0,0,0,0
33,8479984,Cal Foote,D,,26,0,0,0,0
33,8477126,Jayson Megna,C,,34,0,0,0,0
33,8475164,Jakob Silfverberg,R,,34,0,0,0,0
33,8474009,Nick Bonino,C,,36,0,0,0,0
33,8479458,Nikita Zaitsev,D,,33,0,0,0,0
33,8477944,Jakub Vrana,L,,28,0,0,0,0
33,8471699,Andrew Cogliano,C,,37,0,0,0,0
33,8478067,Oskar Lindblom,L,,28,0,0,0,0
33,8471686,Marc Staal,D,,37,0,0,0,0
33,8470610,Zach Parise,L,,40,0,0,0,0
33,8478904,Steven Lorentz,C,,28,0,0,0,0
33,8473473,Milan Lucic,L,,36,0,0,0,0
33,8480031,Maxime Comtois,L,,25,0,0,0,0
33,8478512,Austin Czarnik,C,,32,0,0,0,0
33,8473504,Cal Clutterbuck,R,,37,0,0,0,0
33,8477454,Adam Erne,L,,29,0,0,0,0
33,8479383,Boris Katchouk,L,,26,0,0,0,0
33,8475825,Jani Hakanpää,D,,32,0,0,0,0
33,8477846,Ryan Carpenter,C,,33,0,0,0,0
33,8477930,Pierre-Edouard Bellemare,L,,39,0,0,0,0
33,8478400,Colin White,C,,27,0,0,0,0
33,8480226,Marián Studenic,R,,26,0,0,0,0
33,8480853,Liam Foudy,C,,24,0,0,0,0
33,8475797,Jarred Tinordi,D,,32,0,0,0,0
33,8479423,Alex Nylander,L,,26,0,0,0,0
33,8474618,Marco Scandella,D,,34,0,0,0,0
33,8478028,Fredrik Olofsson,L,,28,0,0,0,0
33,8474709,Matt Martin,L,,35,0,0,0,0
33,8481070,Hugh McGing,L,,26,0,0,0,0
33,8479546,Oskar Steen,C,,26,0,0,0,0
33,8474145,Robert Bortuzzo,D,,35,0,0,0,0
33,8476915,Jujhar Khaira,L,,30,0,0,0,0
33,8475278,Byron Froese,C,,33,0,0,0,0
33,8481812,Nikolai Knyzhov,D,,27,0,0,0,0
33,8478408,Travis Dermott,D,,28,0,0,0,0
33,8481077,John Leonard,L,,26,0,0,0,0
33,8479547,Matthew Phillips,R,,26,0,0,0,0
33,8480836,Jonathan Gruden,C,,24,0,0,0,0
33,8481690,Tyler Angle,C,,24,0,0,0,0
33,8475766,Austin Watson,L,,32,0,0,0,0
33,8481016,Ruslan Iskhakov,C,,24,0,0,0,0
33,8478078,Rourke Chartier,C,,28,0,0,0,0
33,8480776,Sheldon Rempal,R,,29,0,0,0,0
33,8484314,Jiri Smejkal,L,,28,0,0,0,0
34,8476453,Nikita Kucherov,R,TBL,31,82,54,94,148
34,8478402,Connor McDavid,C,EDM,27,81,48,94,142
34,8477492,Nathan MacKinnon,C,COL,29,81,49,86,135
34,8478483,Mitch Marner,R,TOR,27,80,38,81,119
34,8477934,Leon Draisaitl,C,EDM,29,77,50,68,118
34,8479314,Matthew Tkachuk,L,FLA,27,81,38,76,114
34,8478420,Mikko Rantanen,R,COL,28,82,49,64,113
34,8478550,Artemi Panarin,L,NYR,33,74,33,78,111
34,8481559,Jack Hughes,C,NJD,23,75,40,70,110
34,8477942,Kevin Fiala,L,LAK,28,82,32,72,104
34,8479318,Auston Matthews,C,TOR,27,80,57,46,103
34,8477956,David Pastrnak,R,BOS,28,80,52,51,103
34,8478864,Kirill Kaprizov,L,MIN,27,77,39,60,99
34,8477939,William Nylander,R,TOR,28,79,52,46,98
34,8477404,Jake Guentzel,C,TBL,30,82,38,59,97
34,8479420,Tage Thompson,C,BUF,27,74,42,52,94
34,8478010,Brayden Point,C,TBL,28,82,50,43,93
34,8475166,John Tavares,C,TOR,34,80,39,54,93
34,8480830,Andrei Svechnikov,R,CAR,24,72,33,60,93
34,8477493,Aleksander Barkov,C,FLA,29,74,26,67,93
34,8476468,J.T. Miller,C,VAN,31,75,26,67,93
34,8480012,Elias Pettersson,C,VAN,26,78,25,67,92
34,8480036,Miro Heiskanen,D,DAL,25,79,15,77,92
34,8482116,Tim Stützle,C,OTT,22,82,34,57,91
34,8475172,Nazem Kadri,C,CGY,34,78,32,59,91
34,8480027,Jason Robertson,L,DAL,25,81,33,56,89
34,8476459,Mika Zibanejad,C,NYR,31,76,28,61,89
34,8479385,Jordan Kyrou,C,STL,26,75,40,48,88
34,8471214,Alex Ovechkin,L,WSH,39,74,43,44,87
34,8478403,Jack Eichel,C,VGK,28,81,39,48,87
34,8479542,Brandon Hagel,L,TBL,26,82,36,51,87
34,8480023,Robert Thomas,C,STL,25,71,27,60,87
34,8479323,Adam Fox,D,NYR,26,71,18,69,87
34,8478439,Travis Konecny,R,PHI,27,78,39,47,86
34,8480800,Quinn Hughes,D,VAN,25,76,17,69,86
34,8477496,Elias Lindholm,C,BOS,30,80,41,44,85
34,8484144,Connor Bedard,C,CHI,19,74,35,50,85
34,8480801,Brady Tkachuk,L,OTT,25,80,31,54,85
34,8478445,Mathew Barzal,C,NYI,27,82,28,56,84
34,8475754,Brock Nelson,C,NYI,33,80,42,41,83
34,8477402,Pavel Buchnevich,L,STL,29,77,31,52,83
34,8480018,Nick Suzuki,C,MTL,25,77,29,52,81
34,8476456,Jonathan Huberdeau,C,CGY,31,80,19,62,81
34,8474600,Roman Josi,D,NSH,34,71,22,58,80
34,8477949,Alex Tuch,R,BUF,28,71,27,52,79
34,8476346,Johnny Gaudreau,L,CBJ,31,72,21,58,79
34,8479407,Jesper Bratt,L,NJD,26,78,20,58,78
34,8475692,Mats Zuccarello,R,MIN,37,71,24,53,77
34,8473419,Brad Marchand,L,BOS,36,79,24,51,75
34,8481557,Matt Boldy,L,MIN,23,69,33,40,73
34,8474564,Steven Stamkos,C,NSH,34,79,30,43,73
34,8477500,Bo Horvat,C,NYI,29,81,29,44,73
34,8477940,Nikolaj Ehlers,L,WPG,28,75,25,48,73
34,8473512,Claude Giroux,R,OTT,36,78,23,49,72
34,8478493,Joel Eriksson Ek,C,MIN,27,77,37,34,71
34,8478414,Timo Meier,R,NJD,28,75,33,38,71
34,8478398,Kyle Connor,L,WPG,28,72,32,39,71
34,8479343,Clayton Keller,R,UTA,26,77,29,42,71
34,8476389,Vincent Trocheck,C,NYR,31,74,25,46,71
34,8476887,Filip Forsberg,L,NSH,30,70,33,37,70
34,8477501,Valeri Nichushkin,R,COL,29,81,32,38,70
34,8477504,Josh Morrissey,D,WPG,29,76,13,57,70
34,8478975,Mason Marchment,L,DAL,29,81,26,43,69
34,8480803,Evan Bouchard,D,EDM,25,75,19,50,69
34,8479337,Alex DeBrincat,R,DET,27,81,33,35,68
34,8473994,Jamie Benn,L,DAL,35,81,23,45,68
34,8477933,Sam Reinhart,C,FLA,29,74,35,32,67
34,8480002,Nico Hischier,C,NJD,25,76,29,38,67
34,8475913,Mark Stone,R,VGK,32,77,18,49,67
34,8477409,Carter Verhaeghe,C,FLA,29,76,34,32,66
34,8477946,Dylan Larkin,C,DET,28,82,32,34,66
34,8481528,Dylan Cozens,C,BUF,23,66,30,36,66
34,8478427,Sebastian Aho,C,CAR,27,70,26,40,66
34,8476853,Morgan Rielly,D,TOR,30,72,11,55,66
34,8476454,Ryan Nugent-Hopkins,C,EDM,31,77,25,40,65
34,8476460,Mark Scheifele,C,WPG,31,69,25,40,65
34,8480865,Noah Dobson,D,NYI,24,81,17,48,65
34,8476539,Jonathan Marchessault,R,NSH,34,75,38,26,64
34,8476448,William Karlsson,C,VGK,31,75,31,33,64
34,8474141,Patrick Kane,R,DET,36,80,27,37,64
34,8478438,Tommy Novak,C,NSH,27,72,27,37,64
34,8476905,Chandler Stephenson,C,SEA,30,74,24,40,64
34,8471685,Anze Kopitar,C,LAK,37,81,22,42,64
34,8479325,Charlie McAvoy,D,BOS,27,77,15,49,64
34,8475168,Matt Duchene,C,DAL,33,82,32,30,62
34,8482699,Dylan Guenther,R,UTA,21,75,28,34,62
34,8478449,Roope Hintz,C,DAL,28,81,29,32,61
34,8482078,Lucas Raymond,L,DET,22,80,27,34,61
34,8484166,Adam Fantilli,C,CBJ,20,71,27,34,61
34,8475184,Chris Kreider,L,NYR,33,79,42,18,60
34,8476881,Tomas Hertl,C,VGK,31,75,30,30,60
34,8475170,Brayden Schenn,C,STL,33,71,30,30,60
34,8475786,Zach Hyman,L,EDM,32,74,25,35,60
34,8476479,Phillip Danault,C,LAK,31,79,22,38,60
34,8482740,Wyatt Johnston,C,DAL,21,81,34,25,59
34,8477935,Sam Bennett,C,FLA,28,72,34,25,59
34,8475810,Bryan Rust,R,PIT,32,73,27,32,59
34,8475158,Ryan O'Reilly,C,NSH,33,69,20,39,59
34,8481596,Shane Pinto,C,OTT,24,78,19,40,59
34,8478460,Zach Werenski,D,CBJ,27,80,17,42,59
34,8480839,Rasmus Dahlin,D,BUF,24,69,14,45,59
34,8475167,Victor Hedman,D,TBL,34,78,10,49,59
34,8478366,Frank Vatrano,R,ANA,30,75,30,28,58
34,8471215,Evgeni Malkin,C,PIT,38,71,25,33,58
34,8478873,Troy Terry,R,ANA,27,75,24,34,58
34,8480069,Cale Makar,D,COL,26,65,18,40,58
34,8477494,Jonathan Drouin,L,COL,29,81,14,44,58
34,8475798,Mikael Granlund,C,SJS,32,71,12,46,58
34,8476792,Torey Krug,D,STL,33,76,12,46,58
34,8471724,Kris Letang,D,PIT,37,79,9,49,58
34,8480208,Drake Batherson,R,OTT,26,77,24,33,57
34,8477451,Ryan Hartman,R,MIN,30,73,19,38,57
34,8474586,Jordan Eberle,R,SEA,34,71,19,38,57
34,8475753,Justin Faulk,D,STL,32,74,19,38,57
34,8479675,Trevor Moore,L,LAK,29,82,30,26,56
34,8471675,Sidney Crosby,C,PIT,37,72,29,27,56
34,8477955,Jared McCann,L,SEA,28,74,25,31,56
34,8481068,Yegor Sharangovich,C,CGY,26,77,23,33,56
34,8480039,Martin Necas,C,CAR,25,67,21,35,56
34,8477476,Artturi Lehkonen,L,COL,29,82,26,29,55
34,8477960,Adrian Kempe,R,LAK,28,80,25,30,55
34,8476882,Teuvo Teravainen,C,CHI,30,67,19,36,55
34,8478498,Jake DeBrusk,L,VAN,28,76,36,18,54
34,8483431,Logan Cooley,C,UTA,20,74,28,26,54
34,8475169,Evander Kane,L,EDM,33,69,26,28,54
34,8478462,Nicolas Roy,C,VGK,27,77,22,32,54
34,8474102,David Perron,L,OTT,36,80,18,36,54
34,8478407,Vince Dunn,D,SEA,28,74,11,43,54
34,8482093,Seth Jarvis,C,CAR,22,68,32,21,53
34,8482109,Alexis Lafrenière,L,NYR,23,77,26,27,53
34,8482110,Dawson Mercer,C,NJD,23,71,25,28,53
34,8475794,Tyler Seguin,C,DAL,32,81,24,29,53
34,8477511,Anthony Mantha,R,CGY,30,74,21,32,53
34,8477951,Nick Schmaltz,C,UTA,28,81,18,35,53
34,8477346,MacKenzie Weegar,D,CGY,30,74,14,39,53
34,8479999,Casey Mittelstadt,C,COL,26,81,13,40,53
34,8475722,Jason Zucker,L,BUF,32,69,23,29,52
34,8482665,Matty Beniers,C,SEA,22,73,21,31,52
34,8482159,Tyson Foerster,R,PHI,22,73,20,32,52
34,8482745,Mason McTavish,C,ANA,21,67,24,27,51
34,8474150,Mikael Backlund,C,CGY,35,77,23,28,51
34,8478444,Brock Boeser,R,VAN,27,71,21,30,51
34,8477416,Oliver Bjorkstrand,R,SEA,29,69,21,30,51
34,8482175,JJ Peterka,R,BUF,22,72,21,30,51
34,8483515,Juraj Slafkovsky,L,MTL,20,75,20,31,51
34,8477932,Aaron Ekblad,D,FLA,28,71,16,35,51
34,8475745,Charlie Coyle,C,BOS,32,77,16,35,51
34,8475765,Vladimir Tarasenko,R,DET,33,81,15,36,51
34,8481711,Matias Maccelli,L,UTA,24,69,15,36,51
34,8477986,Brandon Montour,D,SEA,30,68,15,36,51
34,8478472,Mathieu Joseph,R,STL,27,71,14,37,51
34,8481581,Thomas Harley,D,DAL,23,75,12,39,51
34,8477497,Sean Monahan,C,CBJ,30,69,23,27,50
34,8484145,Zach Benson,L,BUF,19,69,16,34,50
34,8478542,Evan Rodrigues,C,FLA,31,78,14,36,50
34,8478856,Conor Garland,R,VAN,28,78,27,22,49
34,8479987,Morgan Geekie,C,BOS,26,81,25,24,49
34,8475726,Tyler Toffoli,C,SJS,32,72,23,26,49
34,8477964,Ivan Barbashev,C,VGK,29,76,22,27,49
34,8475784,Jeff Skinner,C,EDM,32,78,21,28,49
34,8480188,Fabian Zetterlund,L,SJS,25,65,19,30,49
34,8478469,Thomas Chabot,D,OTT,27,77,18,31,49
34,8478401,Pavel Zacha,C,BOS,27,80,17,32,49
34,8474565,Alex Pietrangelo,D,VGK,34,68,16,33,49
34,8481533,Trevor Zegras,C,ANA,23,73,20,28,48
34,8478047,Michael Bunting,L,PIT,29,72,17,31,48
34,8477456,J.T. Compher,L,DET,29,81,15,33,48
34,8478397,Rasmus Andersson,D,CGY,28,73,8,40,48
34,8483808,Andrei Kuzmenko,L,CGY,28,75,25,22,47
34,8480015,Owen Tippett,R,PHI,25,73,24,23,47
34,8476432,Boone Jenner,C,CBJ,31,71,24,23,47
34,8479400,Pierre-Luc Dubois,L,WSH,26,74,23,24,47
34,8475314,Anders Lee,L,NYI,34,79,22,25,47
34,8480185,Eetu Luostarinen,C,FLA,26,74,21,26,47
34,8482097,Jack Quinn,R,BUF,23,68,21,26,47
34,8477479,Tyler Bertuzzi,L,CHI,29,62,19,28,47
34,8479351,Sam Steel,C,DAL,26,81,18,29,47
34,8476880,Tom Wilson,R,WSH,30,68,17,30,47
34,8475191,Reilly Smith,R,NYR,33,71,16,31,47
34,8477503,Max Domi,C,TOR,29,75,14,33,47
34,8482684,Luke Hughes,D,NJD,21,73,8,39,47
34,8481540,Cole Caufield,R,MTL,23,73,27,19,46
34,8477426,Nicholas Paul,L,TBL,29,81,24,22,46
34,8475768,Jaden Schwartz,C,SEA,32,73,22,24,46
34,8476292,Ondrej Palat,L,NJD,33,66,22,24,46
34,8475151,Kyle Palmieri,C,NYI,33,78,21,25,46
34,8477444,Andre Burakovsky,L,SEA,29,74,16,30,46
34,8474679,Gustav Nyquist,C,NSH,35,73,13,33,46
34,8482720,Matthew Knies,L,TOR,22,78,13,33,46
34,8478396,Noah Hanifin,D,VGK,27,66,13,33,46
34,8476906,Shayne Gostisbehere,D,CAR,31,78,11,35,46
34,8474590,John Carlson,D,WSH,34,65,8,38,46
34,8482113,Anton Lundell,C,FLA,23,77,18,27,45
34,8474641,Adam Henrique,C,EDM,34,73,17,28,45
34,8479345,Jakob Chychrun,D,WSH,26,69,11,34,45
34,8480797,Joel Farabee,L,PHI,24,75,19,25,44
34,8477407,Anthony Duclair,L,NYI,29,79,18,26,44
34,8480113,Alex Iafallo,L,WPG,31,75,18,26,44
34,8475848,Brendan Gallagher,R,MTL,32,71,17,27,44
34,8477998,Warren Foegele,L,LAK,28,80,16,28,44
34,8478042,Viktor Arvidsson,L,EDM,31,76,15,29,44
34,8475218,Mattias Ekholm,D,EDM,34,67,13,31,44
34,8477429,Andrew Copp,C,DET,30,76,11,33,44
34,8475799,Nino Niederreiter,R,WPG,32,68,24,19,43
34,8476438,Brandon Saad,L,STL,32,68,22,21,43
34,8476399,Blake Coleman,C,CGY,33,77,21,22,43
34,8482092,Ridly Greig,C,OTT,22,72,19,24,43
34,8482124,Quinton Byfield,R,LAK,22,79,9,34,43
34,8476875,Mike Matheson,D,MTL,30,75,7,36,43
34,8480434,Sean Durzi,D,UTA,26,72,7,36,43
34,8480064,Josh Norris,C,OTT,25,72,24,18,42
34,8478474,Lawson Crouse,L,UTA,27,76,22,20,42
34,8476869,Brady Skjei,D,NSH,30,74,13,29,42
34,8474578,Erik Karlsson,D,PIT,34,78,12,30,42
34,8478055,Gustav Forsling,D,FLA,28,73,12,30,42
34,8482122,Brock Faber,D,MIN,22,78,10,32,42
34,8479425,Filip Hronek,D,VAN,27,73,9,33,42
34,8476483,Rickard Rakell,R,PIT,31,70,23,18,41
34,8484153,Leo Carlsson,C,ANA,20,73,20,21,41
34,8479992,Michael Rasmussen,C,DET,25,81,17,24,41
34,8474149,Evgenii Dadonov,R,DAL,35,78,17,24,41
34,8481560,Arthur Kaliyev,R,LAK,23,75,14,27,41
34,8478440,Dylan Strome,C,WSH,27,69,14,27,41
34,8479410,Mikhail Sergachev,D,UTA,26,73,7,34,41
34,8476923,Damon Severson,D,CBJ,30,80,4,37,41
34,8479525,Ross Colton,C,COL,28,81,16,24,40
34,8478891,Mason Appleton,C,WPG,28,69,16,24,40
34,8478519,Anthony Cirelli,C,TBL,27,82,14,26,40
34,8475793,Ryan Johansen,C,PHI,32,65,13,27,40
34,8476854,Hampus Lindholm,D,BOS,30,74,11,29,40
34,8477447,Shea Theodore,D,VGK,29,56,8,32,40
34,8480336,Sean Walker,D,CAR,30,72,7,33,40
34,8480009,Eeli Tolvanen,R,SEA,25,71,19,20,39
34,8482475,Yegor Chinakhov,R,CBJ,23,64,17,22,39
34,8473986,Alex Killorn,L,ANA,35,71,14,25,39
34,8481577,Philip Tomasino,C,NSH,23,68,14,25,39
34,8477506,Ryan Pulock,D,NYI,30,76,4,35,39
34,8481186,Logan O'Connor,R,COL,28,80,22,16,38
34,8481582,Nicholas Robertson,L,TOR,23,68,20,18,38
34,8481604,Pavel Dorofeyev,L,VGK,24,73,16,22,38
34,8479365,Trent Frederic,C,BOS,26,73,16,22,38
34,8480028,Morgan Frost,C,PHI,25,72,13,25,38
34,8476462,Dougie Hamilton,D,NJD,31,67,11,27,38
34,8477021,Alex Kerfoot,C,UTA,30,77,11,27,38
34,8474716,Jared Spurgeon,D,MIN,35,77,9,29,38
34,8482705,Cole Sillinger,C,CBJ,21,65,18,19,37
34,8478466,Daniel Sprong,R,VAN,27,71,17,20,37
34,8483490,Pavel Mintyukov,D,ANA,21,67,14,23,37
34,8481656,Aliaksei Protas,C,WSH,23,64,13,24,37
34,8476469,Joel Armia,R,MTL,31,68,11,26,37
34,8476826,Yanni Gourde,C,SEA,33,69,10,27,37
34,8476463,Jonas Brodin,D,MIN,31,79,8,29,37
34,8476931,Jake McCabe,D,TOR,31,66,7,30,37
34,8477952,Robby Fabbri,C,ANA,28,69,19,17,36
34,8482624,Daniil Miromanov,D,CGY,27,63,15,21,36
34,8482671,Owen Power,D,BUF,22,66,13,23,36
34,8480220,Noah Cates,L,PHI,25,76,13,23,36
34,8471698,T.J. Oshie,R,WSH,38,68,21,14,35
34,8480829,Jesperi Kotkaniemi,C,CAR,24,69,19,16,35
34,8479293,Brandon Tanev,L,SEA,33,66,19,16,35
34,8480798,Philipp Kurashev,C,CHI,25,64,16,19,35
34,8481618,Alex Newhook,C,MTL,23,73,15,20,35
34,8478463,Anthony Beauvillier,L,PIT,27,68,12,23,35
34,8478038,Devon Toews,D,COL,30,71,9,26,35
34,8476879,Cody Ceci,D,EDM,31,77,5,30,35
34,8477969,Marcus Pettersson,D,PIT,28,78,2,33,35
34,8478109,Victor Olofsson,L,VGK,29,69,19,15,34
34,8475763,Kevin Hayes,R,PIT,32,66,17,17,34
34,8475220,Marcus Foligno,L,MIN,33,63,15,19,34
34,8483468,Jiri Kulich,C,BUF,20,57,13,21,34
34,8481524,Bowen Byram,D,BUF,23,63,12,22,34
34,8480145,Neal Pionk,D,WPG,29,73,11,23,34
34,8475171,Oliver Ekman-Larsson,D,TOR,33,65,9,25,34
34,8470613,Brent Burns,D,CAR,39,74,6,28,34
34,8481014,Alexander Romanov,D,NYI,24,80,6,28,34
34,8477488,Brett Pesce,D,NJD,30,70,5,29,34
34,8477495,Seth Jones,D,CHI,30,73,4,30,34
34,8480873,Rasmus Sandin,D,WSH,24,66,1,33,34
34,8482702,Logan Stankoven,C,DAL,21,79,18,15,33
34,8476461,Sean Couturier,C,PHI,32,70,17,16,33
34,8476419,Jean-Gabriel Pageau,C,NYI,32,74,16,17,33
34,8478115,Pierre Engvall,L,NYI,28,80,14,19,33
34,8478046,Danton Heinen,L,VAN,29,73,13,20,33
34,8474563,Drew Doughty,D,LAK,35,72,12,21,33
34,8476958,Jaccob Slavin,D,CAR,30,76,8,25,33
34,8482067,Connor Mackey,D,NYR,28,62,7,26,33
34,8482105,Jake Sanderson,D,OTT,22,73,6,27,33
34,8480043,Timothy Liljegren,D,TOR,25,73,4,29,33
34,8482055,Drew O'Connor,L,PIT,26,66,22,10,32
34,8483524,Shane Wright,C,SEA,20,72,18,14,32
34,8476925,Colton Sissons,C,NSH,31,53,16,16,32
34,8475714,Calle Jarnkrok,C,TOR,33,73,16,16,32
34,8482146,Luke Evangelista,R,NSH,22,71,14,18,32
34,8480835,Jack Drury,C,CAR,24,62,14,18,32
34,8479339,Patrik Laine,L,CBJ,26,61,12,20,32
34,8482149,Cole Perfetti,C,WPG,22,65,12,20,32
34,8477919,Frederick Gaudreau,C,MIN,31,66,12,20,32
34,8476927,Teddy Blueger,C,VAN,30,70,11,21,32
34,8475287,Erik Haula,L,NJD,33,72,10,22,32
34,8476458,Ryan Strome,C,ANA,31,72,9,23,32
34,8477498,Darnell Nurse,D,EDM,29,73,9,23,32
34,8482712,Oskar Olausson,R,COL,22,80,7,25,32
34,8473563,Nicklas Backstrom,C,WSH,37,58,7,25,32
34,8482660,Kent Johnson,C,CBJ,22,65,7,25,32
34,8482087,Kaiden Guhle,D,MTL,22,65,6,26,32
34,8481542,Moritz Seider,D,DET,23,77,4,28,32
34,8476331,Dylan DeMelo,D,WPG,31,71,2,30,32
34,8478233,Andrew Mangiapane,L,WSH,28,67,17,14,31
34,8477987,Ryan Donato,C,CHI,28,58,17,14,31
34,8478432,Christian Fischer,R,DET,27,73,14,17,31
34,8473533,Jordan Staal,C,CAR,36,70,11,20,31
34,8475764,Cam Fowler,D,ANA,33,69,3,28,31
34,8474151,Ryan McDonagh,D,TBL,35,79,3,28,31
34,8480459,Pius Suter,C,VAN,28,72,17,13,30
34,8481523,Kirby Dach,C,MTL,23,67,11,19,30
34,8481624,Ilya Mikheyev,R,CHI,30,61,11,19,30
34,8478020,Michael Amadio,R,OTT,28,76,21,8,29
34,8480893,Kirill Marchenko,R,CBJ,24,67,19,10,29
34,8476981,Josh Anderson,R,MTL,30,71,18,11,29
34,8480014,Gabriel Vilardi,C,WPG,25,68,15,14,29
34,8480849,Barrett Hayton,C,UTA,24,69,15,14,29
34,8479591,Michael Eyssimont,C,TBL,28,81,15,14,29
34,8478057,Dakota Joshua,C,VAN,28,68,13,16,29
34,8475149,Marcus Johansson,L,MIN,34,66,10,19,29
34,8476422,Mike Reilly,D,NYI,31,74,10,19,29
34,8478458,John (Jack) Roslovic,C,CAR,27,69,9,20,29
34,8479353,Brett Howden,C,VGK,26,68,8,21,29
34,8477948,Travis Sanheim,D,PHI,28,71,7,22,29
34,8473422,Nick Foligno,L,CHI,37,59,7,22,29
34,8480817,K'Andre Miller,D,NYR,24,69,4,25,29
34,8476872,Scott Laughton,C,PHI,30,73,15,13,28
34,8477015,Connor Brown,R,EDM,30,69,15,13,28
34,8481553,Bobby Brink,R,PHI,23,59,12,16,28
34,8482133,Thomas Bordeleau,C,SJS,22,61,10,18,28
34,8482667,William Eklund,L,SJS,22,63,9,19,28
34,8476467,Jamie Oleksiak,D,SEA,32,69,8,20,28
34,8482125,Alexander Holtz,R,VGK,22,67,8,20,28
34,8474715,Cameron Atkinson,R,TBL,35,81,5,23,28
34,8481546,Cam York,D,PHI,23,64,5,23,28
34,8473507,Jeff Petry,D,DET,37,73,5,23,28
34,8477450,Jason Dickinson,C,CHI,29,48,14,13,27
34,8480762,Eric Robinson,L,CAR,29,60,14,13,27
34,8475193,Tomas Tatar,L,NJD,34,66,13,14,27
34,8476278,Colin Blackwell,C,DAL,31,78,13,14,27
34,8474053,Logan Couture,C,SJS,35,62,12,15,27
34,8477425,Miles Wood,L,COL,29,77,11,16,27
34,8477839,Conor Sheary,L,TBL,32,80,11,16,27
34,8477989,Christian Dvorak,C,MTL,28,65,10,17,27
34,8476885,Jacob Trouba,D,NYR,30,69,9,18,27
34,8483505,Matthew Poitras,C,BOS,20,72,7,20,27
34,8480871,Adam Boqvist,D,FLA,24,75,6,21,27
34,8482655,Janis Moser,D,TBL,24,77,3,24,27
34,8477435,Ryan Graves,D,PIT,29,77,3,24,27
34,8479066,Ryan Lomberg,L,CGY,30,65,16,10,26
34,8482074,Connor Zary,C,CGY,23,60,13,13,26
34,8480855,Jack McBain,C,UTA,24,63,9,17,26
34,8475791,Taylor Hall,L,CHI,33,60,8,18,26
34,8478500,Ivan Provorov,D,CBJ,27,78,5,21,26
34,8482089,Jake Neighbours,L,STL,22,66,15,10,25
34,8480078,Filip Chytil,C,NYR,25,68,13,12,25
34,8480068,Ryan Poehling,C,PHI,25,63,11,14,25
34,8483493,Frank Nazar,C,CHI,20,52,11,14,25
34,8482737,Zack Bolduc,C,STL,21,52,11,14,25
34,8476480,Vladislav Namestnikov,C,WPG,32,59,9,16,25
34,8480802,Ryan McLeod,C,BUF,25,64,9,16,25
34,8481606,Jordan Spence,D,LAK,23,65,7,18,25
34,8478133,Jake Evans,C,MTL,28,69,7,18,25
34,8477979,Nicolas Aube-Kubel,R,BUF,28,62,6,19,25
34,8478851,Alexandre Carrier,D,NSH,28,68,2,23,25
34,8476392,Adam Lowry,C,WPG,31,58,14,10,24
34,8477953,Kasperi Kapanen,R,STL,28,62,12,12,24
34,8482117,Lukas Reichel,L,CHI,22,51,12,12,24
34,8480980,Connor Dewar,C,TOR,25,69,12,12,24
34,8477505,Alexander Wennberg,C,SJS,30,69,11,13,24
34,8479661,Tanner Jeannot,L,LAK,27,74,11,13,24
34,8477446,Michael McCarron,R,NSH,29,62,11,13,24
34,8479393,Noah Gregor,L,OTT,26,65,10,14,24
34,8476329,Travis Boyd,C,MIN,31,58,10,14,24
34,8483491,Ivan Miroshnichenko,L,WSH,20,58,9,15,24
34,8478970,Jalen Chatfield,D,CAR,28,68,9,15,24
34,8480789,Oliver Wahlstrom,R,NYI,24,71,8,16,24
34,8483565,Nick Blankenburg,D,NSH,26,58,6,18,24
34,8479639,Dylan Coghlan,D,WPG,26,64,6,18,24
34,8481703,Valtteri Puustinen,R,PIT,25,65,5,19,24
34,8477018,Ben Hutton,D,VGK,31,46,4,20,24
34,8482155,Alex Laferriere,R,LAK,23,65,17,6,23
34,8481601,Simon Holmstrom,R,NYI,23,68,13,10,23
34,8481537,Nikita Okhotiuk,D,CGY,24,51,12,11,23
34,8478413,Jordan Greenway,L,BUF,27,58,8,15,23
34,8476897,Oskar Sundqvist,C,STL,30,69,8,15,23
34,8480003,Jesper Boqvist,C,FLA,26,68,8,15,23
34,8478882,Vladislav Gavrikov,D,LAK,29,71,6,17,23
34,8479983,Mario Ferraro,D,SJS,26,73,6,17,23
34,8476979,Erik Gustafsson,D,DET,32,74,3,20,23
34,8482259,Bobby McMann,C,TOR,28,62,14,8,22
34,8477508,Curtis Lazar,C,NJD,29,63,12,10,22
34,8482157,Will Cuylle,L,NYR,22,52,12,10,22
34,8476960,Andreas Athanasiou,C,CHI,30,47,11,11,22
34,8478043,Sam Lafferty,C,BUF,29,65,11,11,22
34,8474189,Lars Eller,C,PIT,35,64,10,12,22
34,8477947,Sonny Milano,L,WSH,28,60,9,13,22
34,8475760,Nick Bjugstad,C,UTA,32,71,8,14,22
34,8480074,Alexandre Texier,C,STL,25,51,7,15,22
34,8482809,Jackson Blake,R,CAR,21,57,6,16,22
34,8475200,Dmitry Orlov,D,CAR,33,72,5,17,22
34,8479402,Jake Bean,D,CGY,26,69,4,18,22
34,8476892,Colton Parayko,D,STL,31,66,3,19,22
34,8478507,John Marino,D,UTA,27,64,2,20,22
34,8479390,Taylor Raddysh,R,WSH,26,63,14,7,21
34,8481535,Nils Hoglander,L,VAN,24,62,13,8,21
34,8482079,Marco Rossi,C,MIN,23,55,13,8,21
34,8478569,Noel Acciari,C,PIT,33,48,12,9,21
34,8473453,Trevor Lewis,C,LAK,37,74,11,10,21
34,8480448,Parker Kelly,L,COL,25,69,10,11,21
34,8479368,Max Jones,L,BOS,26,65,10,11,21
34,8482634,Alex Steeves,C,TOR,25,52,10,11,21
34,8475343,Nic Dowd,C,WSH,34,65,9,12,21
34,8479671,Mathieu Olivier,R,CBJ,27,46,9,12,21
34,8475225,Craig Smith,C,CHI,35,61,8,13,21
34,8483457,Lane Hutson,D,MTL,20,65,8,13,21
34,8481704,Juuso Parssinen,C,NSH,23,55,8,13,21
34,8478911,Matt Roy,D,WSH,29,67,7,14,21
34,8480025,MacKenzie Entwistle,R,FLA,25,63,7,14,21
34,8477369,Carson Soucy,D,VAN,30,61,5,16,21
34,8476917,Adam Pelech,D,NYI,30,76,4,17,21
34,8475790,Erik Gudbranson,D,CBJ,32,75,4,17,21
34,8480878,Nils Lundkvist,D,DAL,24,69,4,17,21
34,8482245,Artem Zub,D,OTT,29,73,2,19,21
34,8479976,Juuso Valimaki,D,UTA,26,70,2,19,21
34,8476374,Sean Kuraly,C,CBJ,31,56,13,7,20
34,8476921,Jordan Martinook,L,CAR,32,54,11,9,20
34,8476889,Radek Faksa,C,STL,30,65,11,9,20
34,8479370,Tyson Jost,C,CAR,26,50,11,9,20
34,8475231,Casey Cizikas,C,NYI,33,76,10,10,20
34,8479336,Carl Grundstrom,R,SJS,27,49,10,10,20
34,8481013,Jonatan Berggren,R,DET,24,58,10,10,20
34,8477478,William Carrier,L,CAR,30,55,10,10,20
34,8481580,Connor McMichael,C,WSH,23,64,9,11,20
34,8478508,Yakov Trenin,C,MIN,27,59,9,11,20
34,8477406,Mattias Janmark,C,EDM,32,67,9,11,20
34,8479359,Beck Malenstyn,L,BUF,26,48,9,11,20
34,8482062,Cole Smith,L,NSH,29,56,8,12,20
34,8480144,David Kampf,C,TOR,29,70,7,13,20
34,8484203,Bradly Nadeau,L,CAR,19,62,6,14,20
34,8480995,Pontus Holmberg,R,TOR,25,57,6,14,20
34,8481522,Peyton Krebs,C,BUF,23,57,5,15,20
34,8475179,Dmitry Kulikov,D,FLA,34,69,3,17,20
34,8479982,Conor Timmins,D,TOR,26,52,1,19,20
34,8479619,Michael Carcone,L,UTA,28,62,9,10,19
34,8481028,Martin Pospisil,C,CGY,25,56,9,10,19
34,8481554,Kaapo Kakko,R,NYR,23,68,8,11,19
34,8482749,Joshua Roy,R,MTL,21,61,7,12,19
34,8481093,Rafael Harvey-Pinard,L,MTL,25,57,6,13,19
34,8482803,Olen Zellweger,D,ANA,21,68,6,13,19
34,8483445,Cutter Gauthier,L,ANA,20,55,5,14,19
34,8482192,Isaak Phillips,D,CHI,23,54,4,15,19
34,8476902,Esa Lindell,D,DAL,30,77,4,15,19
34,8476457,Adam Larsson,D,SEA,32,69,3,16,19
34,8480222,Sebastian Aho,D,PIT,28,73,2,17,19
34,8475181,Nick Leddy,D,STL,33,69,2,17,19
34,8475462,Radko Gudas,D,ANA,34,71,2,17,19
34,8479324,Ryan Lindgren,D,NYR,26,65,2,17,19
34,8480813,Joe Veleno,C,DET,24,76,11,7,18
34,8476474,Stefan Noesen,R,NJD,31,65,10,8,18
34,8481032,Paul Cotter,C,NJD,25,60,9,9,18
34,8476934,Brock McGinn,L,ANA,30,56,8,10,18
34,8482148,Hendrix Lapierre,C,WSH,22,48,8,10,18
34,8477353,Tyler Motte,C,DET,29,71,7,11,18
34,8476873,Mark Jankowski,C,NSH,30,54,7,11,18
34,8482101,Danil Gushchin,L,SJS,22,55,6,12,18
34,8481751,Lukas Rousek,R,BUF,25,47,6,12,18
34,8482142,Jamie Drysdale,D,PHI,22,60,5,13,18
34,8478416,Erik Cernak,D,TBL,27,73,5,13,18
34,8477220,Nate Schmidt,D,FLA,33,62,4,14,18
34,8480355,Mark Kastelic,C,BOS,25,63,4,14,18
34,8480049,Dylan Samberg,D,WPG,25,65,3,15,18
34,8480172,Jan Rutta,D,SJS,34,59,3,15,18
34,8478840,Will Borgen,D,SEA,28,68,2,16,18
34,8475188,Brayden McNabb,D,VGK,33,58,2,16,18
34,8476891,Matthew Grzelcyk,D,PIT,30,74,1,17,18
34,8478831,Kevin Stenlund,C,UTA,28,59,13,4,17
34,8477931,Tomas Nosek,L,FLA,32,62,12,5,17
34,8480289,Morgan Barron,C,WPG,26,49,11,6,17
34,8479344,Jesse Puljujarvi,R,PIT,26,54,10,7,17
34,8476918,Jimmy Vesey,L,NYR,31,68,9,8,17
34,8483499,Liam Ohgren,L,MIN,20,52,6,11,17
34,8481441,Joe Snively,C,DET,28,64,5,12,17
34,8478434,Keegan Kolesar,R,VGK,27,60,5,12,17
34,8481517,Brett Leason,R,ANA,25,55,4,13,17
34,8480727,Zach Whitecloud,D,VGK,28,45,4,13,17
34,8480246,Nick Perbix,D,TBL,26,75,3,14,17
34,8470621,Corey Perry,R,EDM,39,70,3,14,17
34,8475208,Brian Dumoulin,D,ANA,33,62,3,14,17
34,8475233,David Savard,D,MTL,34,67,2,15,17
34,8479980,Nicolas Hague,D,VGK,26,51,2,15,17
34,8474673,TJ Brodie,D,CHI,34,66,2,15,17
34,8480748,Kiefer Sherwood,L,VAN,29,60,8,8,16
34,8479941,Justin Danforth,R,CBJ,31,60,8,8,16
34,8479543,Michael Pezzetta,L,MTL,26,55,8,8,16
34,8480806,Isac Lundestrom,C,ANA,25,59,7,9,16
34,8475855,Jesper Fast,R,CAR,33,56,6,10,16
34,8476988,Matt Benning,D,SJS,30,68,6,10,16
34,8478859,Niko Mikkola,D,FLA,28,57,6,10,16
34,8476856,Mathew Dumba,D,DAL,30,72,5,11,16
34,8479972,Mason Shaw,C,WPG,26,43,5,11,16
34,8479315,Joey Anderson,R,CHI,26,46,4,12,16
34,8477499,Rasmus Ristolainen,D,PHI,30,60,4,12,16
34,8478451,Ethan Bear,D,WSH,27,48,4,12,16
34,8479998,Mikey Anderson,D,LAK,25,65,3,13,16
34,8479371,Dante Fabbro,D,NSH,26,63,3,13,16
34,8480073,Erik Brannstrom,D,COL,25,65,3,13,16
34,8476967,Brett Kulak,D,EDM,30,68,2,14,16
34,8476429,Scott Mayfield,D,NYI,32,76,1,15,16
34,8475842,Sam Carrick,C,NYR,32,59,10,5,15
34,8481617,Vasily Podkolzin,R,VAN,23,41,9,6,15
34,8476878,Zemgus Girgensons,C,TBL,30,79,8,7,15
34,8476442,Matt Nieto,L,PIT,32,46,8,7,15
34,8480891,Michael Kesselring,D,UTA,24,57,6,9,15
34,8481019,David Gustafsson,C,WPG,24,45,6,9,15
34,8478178,Darren Raddysh,D,TBL,28,68,6,9,15
34,8478013,Jake Walman,D,SJS,28,65,6,9,15
34,8482859,Zack Ostapchuk,C,OTT,21,48,6,9,15
34,8484149,Gavin Brindley,C,CBJ,20,51,6,9,15
34,8475279,Ben Chiarot,D,DET,33,67,5,10,15
34,8478452,Caleb Jones,D,LAK,27,57,5,10,15
34,8483482,Tristan Luneau,D,ANA,20,60,4,11,15
34,8482073,Braden Schneider,D,NYR,23,63,3,12,15
34,8474013,Ian Cole,D,UTA,35,47,3,12,15
34,8481708,Zac Jones,D,NYR,24,55,1,14,15
34,8478136,Jake Middleton,D,MIN,28,75,0,15,15
34,8481178,Egor Zamula,D,PHI,24,63,0,15,15
34,8475718,Justin Holl,D,DET,32,61,0,15,15
34,8481641,Joel Kiviranta,L,COL,28,74,9,5,14
34,8477380,Jonny Brodzinski,C,NYR,31,59,8,6,14
34,8479968,Vinni Lettieri,C,BOS,29,53,8,6,14
34,8479994,Jaret Anderson-Dolan,C,WPG,25,42,8,6,14
34,8479718,Alex Barré-Boulet,C,MTL,27,49,7,7,14
34,8481716,Dmitri Voronkov,L,CBJ,24,48,7,7,14
34,8474034,Patrick Maroon,L,CHI,36,49,7,7,14
34,8476822,Luke Glendening,C,TBL,35,76,7,7,14
34,8481521,Ronnie Attard,D,PHI,25,50,6,8,14
34,8476624,Barclay Goodrow,C,SJS,31,58,6,8,14
34,8480205,Emil Bemstrom,C,PIT,25,58,4,10,14
34,8482730,Brandt Clarke,D,LAK,21,59,4,10,14
34,8476874,Olli Maatta,D,DET,30,64,4,10,14
34,8480887,Jordan Harris,D,MTL,24,54,4,10,14
34,8481568,Alex Vlasic,D,CHI,23,51,3,11,14
34,8470600,Ryan Suter,D,STL,39,67,3,11,14
34,8476952,Dominic Toninato,C,WPG,30,37,2,12,14
34,8475690,Chris Tanev,D,TOR,35,65,1,13,14
34,8480281,Alexey Toropchenko,R,STL,25,59,11,2,13
34,8482077,Dylan Holloway,L,EDM,23,50,11,2,13
34,8479328,Julien Gauthier,R,NYI,27,58,9,4,13
34,8482747,Brennan Othmann,L,NYR,21,42,9,4,13
34,8480848,Ty Dellandrea,C,SJS,24,49,8,5,13
34,8480011,Klim Kostin,C,SJS,25,48,6,7,13
34,8479520,Brandon Duhaime,R,WSH,27,46,5,8,13
34,8482111,Justin Barron,D,MTL,23,65,4,9,13
34,8483619,Filip Roos,D,OTT,25,28,4,9,13
34,8479398,Samuel Girard,D,COL,26,66,3,10,13
34,8475324,Nick Jensen,D,OTT,34,69,3,10,13
34,8476473,Connor Murphy,D,CHI,31,40,3,10,13
34,8481527,Kaedan Korczak,D,VGK,23,44,2,11,13
34,8480001,Urho Vaakanainen,D,ANA,25,59,1,12,13
34,8479996,Cody Glass,C,NSH,25,64,6,6,12
34,8480860,Kevin Bahl,D,CGY,24,62,5,7,12
34,8477392,Hudson Fasching,R,NYI,29,53,4,8,12
34,8479316,Luke Kunin,C,SJS,27,52,4,8,12
34,8476312,Josh Manson,D,COL,33,59,3,9,12
34,8480021,Jack Studnicka,C,LAK,25,57,3,9,12
34,8477903,Garnet Hathaway,R,PHI,33,56,3,9,12
34,8474568,Luke Schenn,D,NSH,35,54,3,9,12
34,8482176,Wyatt Kaiser,D,CHI,22,52,2,10,12
34,8474574,Tyler Myers,D,VAN,34,69,1,11,12
34,8480035,Henri Jokiharju,D,BUF,25,64,0,12,12
34,8480870,Bo Groulx,C,NYR,24,32,10,1,11
34,8479414,Nathan Bastian,R,NJD,27,58,6,5,11
34,8481481,Blake Lizotte,C,PIT,27,64,6,5,11
34,8477507,Nikita Zadorov,D,BOS,29,70,6,5,11
34,8482679,Matt Coronato,R,CGY,22,65,6,5,11
34,8476867,Brendan Gaunce,C,MIN,30,31,6,5,11
34,8478421,A.J. Greer,L,FLA,28,63,5,6,11
34,8479439,Jacob MacDonald,D,COL,31,51,5,6,11
34,8480192,Johnathan Kovacevic,D,NJD,27,52,5,6,11
34,8477962,Brendan Lemieux,L,CAR,28,43,5,6,11
34,8482659,Josh Doan,R,UTA,22,59,5,6,11
34,8480252,Cole Guttman,C,CHI,25,47,4,7,11
34,8479638,Justin Brazeau,R,BOS,26,37,4,7,11
34,8477573,Nathan Walker,L,STL,30,53,3,8,11
34,8482451,Mikael Pyyhtia,L,CBJ,23,41,3,8,11
34,8478211,Dryden Hunt,L,CGY,29,52,3,8,11
34,8483466,Kevin Korchinski,D,CHI,20,52,3,8,11
34,8479291,Kevin Rooney,C,CGY,31,50,3,8,11
34,8483495,Simon Nemec,D,NJD,20,55,2,9,11
34,8478468,Jeremy Lauzon,D,NSH,27,53,2,9,11
34,8480807,Mattias Samuelsson,D,BUF,24,50,2,9,11
34,8479372,Joshua Mahura,D,SEA,26,58,1,10,11
34,8479986,Kole Lind,R,DAL,26,47,1,10,11
34,8480950,Ilya Lyubushkin,D,DAL,30,67,1,10,11
34,8481059,Scott Perunovich,D,STL,26,62,0,11,11
34,8478585,Derek Ryan,C,EDM,38,58,5,5,10
34,8481679,Maxence Guenette,D,OTT,23,41,5,5,10
34,8476525,Colin Miller,D,WPG,32,61,4,6,10
34,8477845,Trevor van Riemsdyk,D,WSH,33,59,4,6,10
34,8481754,Nikita Nesterenko,C,ANA,23,33,4,6,10
34,8476858,Phillip Di Giuseppe,L,VAN,31,35,3,7,10
34,8477887,Patrick Brown,C,BOS,32,47,3,7,10
34,8480796,Martin Fehervary,D,WSH,25,50,2,8,10
34,8480157,Calle Rosen,D,COL,30,54,2,8,10
34,8475750,Jon Merrill,D,MIN,32,64,2,8,10
34,8479026,Philippe Myers,D,TOR,27,51,1,9,10
34,8477034,Jaycob Megna,D,FLA,32,43,1,9,10
34,8480070,Ian Mitchell,D,BOS,25,46,0,10,10
34,8482496,Nils Aman,C,VAN,24,32,7,2,9
34,8481592,Jakob Pelletier,L,CGY,23,43,6,3,9
34,8480990,Declan Chisholm,D,MIN,24,37,5,4,9
34,8481550,Adam Beckman,L,NJD,23,42,5,4,9
34,8476994,Vinnie Hinostroza,C,NSH,30,39,4,5,9
34,8477365,Connor Clifton,D,BUF,29,65,4,5,9
34,8474090,Brendan Smith,D,DAL,35,41,4,5,9
34,8482751,Ryan Winterton,C,SEA,21,42,4,5,9
34,8481477,Nico Sturm,C,SJS,29,46,3,6,9
34,8482666,Scott Morrow,D,CAR,22,52,3,6,9
34,8478424,Jansen Harkins,C,ANA,27,44,3,6,9
34,8482744,James Malatesta,L,CBJ,21,37,2,7,9
34,8479249,Andrew Poturalski,C,SJS,30,35,2,7,9
34,8480058,Pierre-Olivier Joseph,D,STL,25,52,2,7,9
34,8478454,Noah Juulsen,D,VAN,27,40,2,7,9
34,8479369,Andrew Peeke,D,BOS,26,63,1,8,9
34,8481567,Henry Thrun,D,SJS,23,46,1,8,9
34,8479348,Kale Clague,D,BUF,26,35,1,8,9
34,8480245,Olle Lycksell,R,PHI,25,37,0,9,9
34,8484254,Akito Hirose,D,VAN,25,32,0,9,9
34,8480292,Carson Meyer,R,ANA,27,38,6,2,8
34,8483763,Maksymilian Szuber,D,UTA,22,41,5,3,8
34,8471709,Marc-Edouard Vlasic,D,SJS,37,63,4,4,8
34,8477938,Haydn Fleury,D,WPG,28,47,4,4,8
34,8482095,Tyler Kleven,D,OTT,22,34,4,4,8
34,8482166,Shakir Mukhamadullin,D,SJS,22,54,4,4,8
34,8482153,Brendan Brisson,C,VGK,23,33,4,4,8
34,8482733,Logan Mailloux,D,MTL,31,32,4,4,8
34,8483549,Lucas Condotta,L,MTL,27,38,4,4,8
34,8477482,Zachary Sanford,L,CHI,30,35,3,5,8
34,8479944,Zach Aston-Reese,C,VGK,30,44,3,5,8
34,8481599,Victor Soderstrom,D,UTA,23,40,2,6,8
34,8481167,Brayden Pachal,D,CGY,25,42,2,6,8
34,8482784,Zach Dean,C,STL,21,48,2,6,8
34,8482652,Walker Duehr,R,CGY,27,38,2,6,8
34,8479378,Logan Stanley,D,WPG,26,35,2,6,8
34,8477851,Jordan Oesterle,D,BOS,32,39,2,6,8
34,8480890,Jan Jenik,C,OTT,24,28,2,6,8
34,8483460,David Jiricek,D,CBJ,21,52,1,7,8
34,8474166,Alec Martinez,D,CHI,37,52,1,7,8
34,8481122,Simon Benoit,D,TOR,26,41,1,7,8
34,8479442,Troy Stecher,D,EDM,30,51,0,8,8
34,8481605,Jackson LaCombe,D,ANA,23,36,0,8,8
34,8482807,Ethan Del Mastro,D,CHI,21,38,5,2,7
34,8480845,Rasmus Kupari,C,WPG,24,35,4,3,7
34,8482141,Lukas Cormier,D,VGK,22,27,4,3,7
34,8479981,Jonah Gadjovich,L,FLA,26,44,3,4,7
34,8481518,Nolan Foote,L,NJD,24,40,3,4,7
34,8481598,Philip Broberg,D,EDM,23,42,3,4,7
34,8483570,Ben Meyers,C,SEA,26,31,3,4,7
34,8480441,Trey Fix-Wolansky,R,CBJ,25,35,2,5,7
34,8481532,Alex Turcotte,C,LAK,23,47,2,5,7
34,8478450,Parker Wotherspoon,D,BOS,27,33,2,5,7
34,8479991,Jake Leschyshyn,C,NYR,25,29,2,5,7
34,8478443,Brandon Carlo,D,BOS,28,58,1,6,7
34,8478874,Adam Gaudette,R,OTT,28,35,1,6,7
34,8481701,Santeri Hatakka,D,NJD,23,41,0,7,7
34,8480196,Jacob Bryson,D,BUF,27,45,0,7,7
34,8482070,Mitchell Chaffee,R,TBL,26,57,5,1,6
34,8475235,Nicolas Deslauriers,L,PHI,33,53,4,2,6
34,8482762,Simon Edvinsson,D,DET,21,51,3,3,6
34,8481161,Jake Christiansen,D,CBJ,25,64,3,3,6
34,8482964,Arber Xhekaj,D,MTL,23,49,3,3,6
34,8482511,Mason Lohrei,D,BOS,23,32,3,3,6
34,8471817,Ryan Reaves,R,TOR,37,55,3,3,6
34,8479379,Givani Smith,R,SJS,26,32,3,3,6
34,8474612,Travis Hamonic,D,OTT,34,47,3,3,6
34,8481609,Vladislav Kolyachonok,D,UTA,23,24,3,3,6
34,8478399,Jonas Siegenthaler,D,NJD,27,55,2,4,6
34,8482861,Vincent Iorio,D,WSH,22,32,2,4,6
34,8477070,Liam O'Brien,C,UTA,30,48,2,4,6
34,8482177,Marat Khusnutdinov,C,MIN,22,35,2,4,6
34,8478409,Anthony Richard,C,PHI,28,36,2,4,6
34,8479536,Axel Jonsson-Fjallby,L,WPG,26,39,2,4,6
34,8477335,Kyle Burroughs,D,LAK,29,35,1,5,6
34,8479587,Rhett Gardner,C,PHI,28,25,1,5,6
34,8483012,Logan Morrison,C,SEA,22,28,1,5,6
34,8481789,Tye Kartye,L,SEA,23,34,4,1,5
34,8478017,Mark Friedman,D,VAN,29,30,3,2,5
34,8481556,John Beecher,C,BOS,23,27,3,2,5
34,8475958,Michael Sgarbossa,C,WSH,32,33,3,2,5
34,8481147,Reese Johnson,C,MIN,26,37,3,2,5
34,8482147,Jean-Luc Foudy,C,COL,22,21,3,2,5
34,8483397,Marc McLaughlin,C,BOS,25,23,3,2,5
34,8477462,Robert Hagg,D,VGK,29,31,3,2,5
34,8482713,Mackie Samoskevich,R,FLA,22,43,2,3,5
34,8479772,Zack MacEwen,R,OTT,28,55,2,3,5
34,8479362,Riley Tufte,L,BOS,26,23,2,3,5
34,8481564,Ryan Johnson,D,BUF,23,15,2,3,5
34,8476441,Joel Edmundson,D,LAK,31,41,2,3,5
34,8483630,Pavol Regenda,L,ANA,25,29,2,3,5
34,8480844,Grigori Denisenko,L,VGK,24,31,2,3,5
34,8474567,Zach Bogosian,D,MIN,34,58,1,4,5
34,8480007,Jonas Rondbjerg,R,VGK,25,40,1,4,5
34,8481056,Spencer Stastney,D,NSH,24,33,1,4,5
34,8479576,Vincent Desharnais,D,VAN,28,37,1,4,5
34,8477401,John Hayden,C,SEA,29,31,1,4,5
34,8475795,Dylan McIlrath,D,WSH,32,19,1,4,5
34,8481543,Nikita Alexandrov,C,STL,24,26,1,4,5
34,8477244,Chad Ruhwedel,D,NYR,34,32,1,4,5
34,8476913,Devin Shore,C,MIN,30,28,0,5,5
34,8476372,Nick Seeler,D,PHI,31,47,0,5,5
34,8481585,Egor Afanasyev,L,SJS,23,16,4,0,4
34,8477527,Ross Johnston,L,ANA,30,30,3,1,4
34,8481719,Maxwell Crozier,D,TBL,24,16,3,1,4
34,8480267,Sammy Walker,C,MIN,25,18,3,1,4
34,8482162,Roby Jarventie,L,EDM,22,18,3,1,4
34,8475762,Derek Forbort,D,VAN,32,50,2,2,4
34,8481600,Tobias Bjornfot,D,FLA,23,32,2,2,4
34,8482144,Jack Thompson,D,SJS,22,22,2,2,4
34,8484911,Collin Graf,R,SJS,22,44,2,2,4
34,8477467,Gustav Olofsson,D,SEA,30,20,2,2,4
34,8477320,Anton Blidh,L,NYR,29,21,2,2,4
34,8471677,Jack Johnson,D,CBJ,37,63,1,3,4
34,8484287,Cole McWard,D,VAN,23,24,1,3,4
34,8479320,Maxime Lajoie,D,SEA,27,23,1,3,4
34,8475455,Brenden Dillon,D,NJD,34,59,0,4,4
34,8473446,Erik Johnson,D,PHI,36,50,0,4,4
34,8482765,Isak Rosen,R,BUF,21,19,3,0,3
34,8481726,Adam Edstrom,C,NYR,24,6,3,0,3
34,8482858,Ryker Evans,D,SEA,23,20,2,1,3
34,8482250,Callahan Burke,C,VGK,27,25,2,1,3
34,8480880,Jakub Lauko,C,MIN,24,34,2,1,3
34,8482165,Yan Kuznetsov,D,CGY,22,21,2,1,3
34,8480834,Ty Emberson,D,SJS,24,42,1,2,3
34,8477384,Joshua Brown,D,EDM,30,39,1,2,3
34,8477473,Justin Bailey,R,SJS,29,25,1,2,3
34,8481593,Jayden Struble,D,MTL,23,20,1,2,3
34,8478021,William Lagesson,D,DET,28,25,1,2,3
34,8477149,Scott Sabourin,R,SJS,32,12,1,2,3
34,8478051,Max Willman,C,NJD,29,18,1,2,3
34,8478477,Mitchell Stephens,C,SEA,27,20,1,2,3
34,8481043,Cole Koepke,L,BOS,26,16,1,2,3
34,8481541,Samuel Bolduc,D,NYI,24,26,1,2,3
34,8475177,Calvin de Haan,D,COL,33,40,0,3,3
34,8480879,Jacob Bernard-Docker,D,OTT,24,50,0,3,3
34,8478146,Matthew Highmore,C,OTT,28,39,0,3,3
34,8482145,Mavrik Bourque,C,DAL,22,53,0,3,3
34,8482516,Matthew Kessel,D,STL,24,14,0,3,3
34,8479419,Brett Murray,L,BUF,26,18,2,0,2
34,8481065,Angus Crookshank,L,OTT,25,19,2,0,2
34,8481206,John Ludvig,D,PIT,24,12,2,0,2
34,8483489,Fraser Minten,C,TOR,31,6,2,0,2
34,8479985,Cale Fleury,D,SEA,26,23,1,1,2
34,8482118,Sam Colangelo,R,ANA,23,10,1,1,2
34,8480468,James Hamblin,L,EDM,25,19,1,1,2
34,8481030,Jack St. Ivany,D,PIT,25,17,1,1,2
34,8481743,Marc Del Gaizo,D,NSH,25,18,1,1,2
34,8480823,Alexander Alexeyev,D,WSH,25,10,1,1,2
34,8482094,Daemon Hunt,D,MIN,22,12,1,1,2
34,8477073,Kurtis MacDermid,L,NJD,30,27,1,1,2
34,8475755,Alexander Petrovic,D,DAL,32,12,1,1,2
34,8481655,Cole Schwindt,R,CGY,23,9,1,1,2
34,8483597,Milos Kelemen,L,UTA,25,10,1,1,2
34,8474062,Riley Nash,C,NYR,35,20,1,1,2
34,8482476,Emil Heineman,L,MTL,23,8,1,1,2
34,8481806,Louis Crevier,D,CHI,23,14,0,2,2
34,8482088,Justin Sourdif,R,FLA,22,15,0,2,2
34,8481462,Mason Morelli,L,VGK,28,13,1,0,1
34,8480084,Nick DeSimone,D,NJD,30,20,1,0,1
34,8484258,Sam Malinski,D,COL,26,21,1,0,1
34,8481422,Jake Lucchini,C,NSH,29,24,1,0,1
34,8482201,Gage Goncalves,C,TBL,23,15,1,0,1
34,8478446,Glenn Gawdin,C,LAK,27,7,1,0,1
34,8475413,Justin Dowling,C,NJD,34,19,1,0,1
34,8483512,Matthew Savoie,C,EDM,20,23,1,0,1
34,8481006,Tyler Tucker,D,STL,24,12,1,0,1
34,8484304,Uvis Balinskis,D,FLA,28,10,1,0,1
34,8483567,Georgii Merkulov,C,BOS,24,8,1,0,1
34,8477810,Joel Hanley,D,CGY,33,23,0,1,1
34,8478854,Ryan Shea,D,PIT,27,4,0,1,1
34,8482172,Landon Slaggert,L,CHI,22,30,0,1,1
34,8480075,Cameron Crotty,D,MIN,25,12,0,1,1
34,8481237,Kyle MacLean,C,NYI,25,25,0,1,1
34,8480874,Adam Ginning,D,PHI,24,11,0,1,1
34,8482929,Emil Lilleberg,D,TBL,23,21,0,1,1
34,8479367,William Lockwood,R,FLA,26,20,0,1,1
34,8484325,Waltteri Merela,C,TBL,26,24,0,1,1
34,8483395,Arshdeep Bains,L,VAN,23,9,0,1,1
34,8479330,Brandon Gignac,C,MTL,27,7,0,1,1
34,8478502,Dennis Gilbert,D,BUF,28,20,0,1,1
34,8477541,Dakota Mermis,D,TOR,30,4,0,1,1
34,8482787,Nikita Chibrikov,R,WPG,31,6,0,1,1
34,8482470,Ilya Solovyov,D,CGY,24,14,0,1,1
34,8481024,Linus Karlsson,C,VAN,25,13,0,1,1
34,8479522,Hardy Haman Aktell,D,WSH,26,7,0,1,1
34,8483531,Brian Halonen,L,NJD,25,3,0,1,1
34,8480032,Shane Bowers,C,NJD,25,9,0,1,1
34,8481534,Raphael Lavoie,C,EDM,24,5,0,1,1
34,8477971,Andreas Englund,D,LAK,28,24,0,0,0
34,8481699,Aku Raty,R,UTA,23,14,0,0,0
34,8482102,Vasily Ponomarev,C,PIT,22,19,0,0,0
34,8478881,Brett Seney,L,CHI,28,13,0,0,0
34,8483407,Brandon Scanlin,D,NYR,25,6,0,0,0
34,8483471,Brad Lambert,C,WPG,31,10,0,0,0
34,8475780,Chris Wagner,R,COL,33,7,0,0,0
34,8480306,Grant Hutton,D,NYI,29,3,0,0,0
34,8482061,Brandon Biro,L,SEA,26,9,0,0,0
34,8477993,Justin Kirkland,C,CGY,28,2,0,0,0
34,8483546,Marshall Rifai,D,TOR,26,3,0,0,0
34,8484255,Jason Polin,R,COL,25,5,0,0,0
34,8481578,Graeme Clarke,R,MIN,23,9,0,0,0
34,8479421,Jacob Moverare,D,LAK,26,3,0,0,0
34,8478011,Louie Belpedio,D,PHI,28,12,0,0,0
34,8483609,Adam Klapka,R,CGY,24,6,0,0,0
34,8483432,Luca Del Bel Belluz,C,CBJ,31,4,0,0,0
34,8476323,Max McCormick,L,SEA,32,3,0,0,0
34,8483401,Marc Johnstone,R,PIT,28,1,0,0,0
34,8482460,Matt Rempe,C,NYR,22,9,0,0,0
34,8478147,Bokondji Imama,L,PIT,28,7,0,0,0
34,8480851,Akil Thomas,C,LAK,24,22,0,0,0
34,8483920,Pierrick Dube,R,WSH,23,5,0,0,0
34,8482197,Adam Raska,R,MIN,23,6,0,0,0
34,8483045,Cameron Butler,R,CBJ,31,1,0,0,0
34,8482126,Emil Andrae,D,PHI,31,4,0,0,0
34,8483398,Declan Carlile,D,TBL,31,5,0,0,0
34,8478956,Samuel Laberge,L,NJD,27,1,0,0,0
34,8480274,Philip Kemp,D,EDM,25,0,0,0,0
34,8484259,Ondrej Pavel,C,COL,31,2,0,0,0
34,8484326,Patrik Koch,D,UTA,28,4,0,0,0
34,8484321,Nikolas Matinpalo,D,OTT,26,0,0,0,0
34,8470794,Joe Pavelski,C,,40,0,0,0,0
34,8479321,Lucas Johansen,D,,27,0,0,0,0
34,8477950,Tony DeAngelo,D,,29,0,0,0,0
34,8471218,Blake Wheeler,R,,38,0,0,0,0
34,8475197,Tyson Barrie,D,,33,0,0,0,0
34,8474157,Max Pacioretty,L,,36,0,0,0,0
34,8475744,Evgeny Kuznetsov,C,,32,0,0,0,0
34,8474037,James van Riemsdyk,L,,35,0,0,0,0
34,8476907,Mackenzie MacEachern,L,,30,0,0,0,0
34,8480216,Jacob Peterson,C,,25,0,0,0,0
34,8474602,Justin Schultz,D,,34,0,0,0,0
34,8482222,Alexander Barabanov,L,,30,0,0,0,0
34,8474031,Kevin Shattenkirk,D,,35,0,0,0,0
34,8477330,Dominik Kubalik,L,,29,0,0,0,0
34,8480884,Calen Addison,D,,24,0,0,0,0
34,8475906,John Klingberg,D,,32,0,0,0,0
34,8480008,Adam Ruzicka,C,,25,0,0,0,0
34,8476884,Derrick Pouliot,D,,30,0,0,0,0
34,8476919,Chris Tierney,C,,30,0,0,0,0
34,8479415,Michael McLeod,C,,26,0,0,0,0
34,8474870,Tyler Johnson,C,,34,0,0,0,0
34,8470604,Jeff Carter,C,,39,0,0,0,0
34,8478104,Sammy Blais,L,,28,0,0,0,0
34,8474884,Mike Hoffman,C,,35,0,0,0,0
34,8481591,Sam Poulin,R,,23,0,0,0,0
34,8471274,Alex Goligoski,D,,39,0,0,0,0
34,8476871,Tanner Pearson,L,,32,0,0,0,0
34,8476393,Nick Cousins,C,,31,0,0,0,0
34,8479977,Kailer Yamamoto,R,,26,0,0,0,0
34,8479346,Dillon Dube,C,,26,0,0,0,0
34,8480184,Gustav Lindstrom,D,,26,0,0,0,0
34,8479376,Victor Mete,D,,26,0,0,0,0
34,8473449,Kyle Okposo,R,,36,0,0,0,0
34,8481058,Jesse Ylonen,R,,25,0,0,0,0
34,8475752,Tyler Pitlick,C,,33,0,0,0,0
34,8481239,Samuel Fagemo,L,,24,0,0,0,0
34,8480821,Filip Zadina,R,,25,0,0,0,0
34,8470966,Mark Giordano,D,,41,0,0,0,0
34,8478495,Denis Gurianov,R,,27,0,0,0,0
34,8477464,Nic Petan,C,,29,0,0,0,0
34,8478099,Kevin Labanc,R,,29,0,0,0,0
34,8482241,Radim Zohorna,L,,28,0,0,0,0
34,8474040,Sam Gagner,C,,35,0,0,0,0
34,8479514,Rem Pitlick,C,,27,0,0,0,0
34,8478430,Oliver Kylington,D,,27,0,0,0,0
34,8479533,Joona Koppanen,L,,26,0,0,0,0
34,8479984,Cal Foote,D,,26,0,0,0,0
34,8477126,Jayson Megna,C,,34,0,0,0,0
34,8475164,Jakob Silfverberg,R,,34,0,0,0,0
34,8474009,Nick Bonino,C,,36,0,0,0,0
34,8479458,Nikita Zaitsev,D,,33,0,0,0,0
34,8477944,Jakub Vrana,L,,28,0,0,0,0
34,8471699,Andrew Cogliano,C,,37,0,0,0,0
34,8478067,Oskar Lindblom,L,,28,0,0,0,0
34,8471686,Marc Staal,D,,37,0,0,0,0
34,8470610,Zach Parise,L,,40,0,0,0,0
34,8478904,Steven Lorentz,C,,28,0,0,0,0
34,8473473,Milan Lucic,L,,36,0,0,0,0
34,8480031,Maxime Comtois,L,,25,0,0,0,0
34,8478512,Austin Czarnik,C,,32,0,0,0,0
34,8473504,Cal Clutterbuck,R,,37,0,0,0,0
34,8477454,Adam Erne,L,,29,0,0,0,0
34,8479383,Boris Katchouk,L,,26,0,0,0,0
34,8475825,Jani Hakanpää,D,,32,0,0,0,0
34,8477846,Ryan Carpenter,C,,33,0,0,0,0
34,8477930,Pierre-Edouard Bellemare,L,,39,0,0,0,0
34,8478400,Colin White,C,,27,0,0,0,0
34,8480226,Marián Studenic,R,,26,0,0,0,0
34,8480853,Liam Foudy,C,,24,0,0,0,0
34,8475797,Jarred Tinordi,D,,32,0,0,0,0
34,8479423,Alex Nylander,L,,26,0,0,0,0
34,8474618,Marco Scandella,D,,34,0,0,0,0
34,8478028,Fredrik Olofsson,L,,28,0,0,0,0
34,8474709,Matt Martin,L,,35,0,0,0,0
34,8481070,Hugh McGing,L,,26,0,0,0,0
34,8479546,Oskar Steen,C,,26,0,0,0,0
34,8474145,Robert Bortuzzo,D,,35,0,0,0,0
34,8476915,Jujhar Khaira,L,,30,0,0,0,0
34,8475278,Byron Froese,C,,33,0,0,0,0
34,8481812,Nikolai Knyzhov,D,,27,0,0,0,0
34,8478408,Travis Dermott,D,,28,0,0,0,0
34,8481077,John Leonard,L,,26,0,0,0,0
34,8479547,Matthew Phillips,R,,26,0,0,0,0
34,8480836,Jonathan Gruden,C,,24,0,0,0,0
34,8481690,Tyler Angle,C,,24,0,0,0,0
34,8475766,Austin Watson,L,,32,0,0,0,0
34,8481016,Ruslan Iskhakov,C,,24,0,0,0,0
34,8478078,Rourke Chartier,C,,28,0,0,0,0
34,8480776,Sheldon Rempal,R,,29,0,0,0,0
34,8484314,Jiri Smejkal,L,,28,0,0,0,0
35,8476453,Nikita Kucherov,R,TBL,31,81,45,103,148
35,8479318,Auston Matthews,C,TOR,27,82,81,58,139
35,8479314,Matthew Tkachuk,L,FLA,27,81,39,98,137
35,8477492,Nathan MacKinnon,C,COL,29,81,49,84,133
35,8478402,Connor McDavid,C,EDM,27,77,47,82,129
35,8477956,David Pastrnak,R,BOS,28,80,51,70,121
35,8481559,Jack Hughes,C,NJD,23,74,50,71,121
35,8478483,Mitch Marner,R,TOR,27,80,44,64,108
35,8476887,Filip Forsberg,L,NSH,30,76,44,59,103
35,8477493,Aleksander Barkov,C,FLA,29,81,33,70,103
35,8484144,Connor Bedard,C,CHI,19,70,35,67,102
35,8476468,J.T. Miller,C,VAN,31,75,45,56,101
35,8480023,Robert Thomas,C,STL,25,79,35,65,100
35,8480027,Jason Robertson,L,DAL,25,82,42,54,96
35,8476389,Vincent Trocheck,C,NYR,31,77,39,57,96
35,8471675,Sidney Crosby,C,PIT,37,71,39,55,94
35,8477939,William Nylander,R,TOR,28,79,37,57,94
35,8478864,Kirill Kaprizov,L,MIN,27,76,31,63,94
35,8476346,Johnny Gaudreau,L,CBJ,31,77,24,70,94
35,8477404,Jake Guentzel,C,TBL,30,80,49,44,93
35,8478403,Jack Eichel,C,VGK,28,73,37,56,93
35,8477934,Leon Draisaitl,C,EDM,29,78,41,51,92
35,8480002,Nico Hischier,C,NJD,25,75,31,61,92
35,8479407,Jesper Bratt,L,NJD,26,70,36,55,91
35,8475913,Mark Stone,R,VGK,32,78,34,57,91
35,8480012,Elias Pettersson,C,VAN,26,75,33,58,91
35,8480800,Quinn Hughes,D,VAN,25,76,10,81,91
35,8478420,Mikko Rantanen,R,COL,28,81,40,49,89
35,8475166,John Tavares,C,TOR,34,81,34,55,89
35,8478550,Artemi Panarin,L,NYR,33,75,27,62,89
35,8477933,Sam Reinhart,C,FLA,29,77,41,47,88
35,8481557,Matt Boldy,L,MIN,23,73,30,58,88
35,8477946,Dylan Larkin,C,DET,28,80,41,44,85
35,8480801,Brady Tkachuk,L,OTT,25,80,33,51,84
35,8474564,Steven Stamkos,C,NSH,34,71,35,48,83
35,8475172,Nazem Kadri,C,CGY,34,81,32,51,83
35,8474600,Roman Josi,D,NSH,34,74,20,63,83
35,8477942,Kevin Fiala,L,LAK,28,78,31,51,82
35,8479343,Clayton Keller,R,UTA,26,78,31,51,82
35,8479385,Jordan Kyrou,C,STL,26,76,38,43,81
35,8480208,Drake Batherson,R,OTT,26,79,27,54,81
35,8476456,Jonathan Huberdeau,C,CGY,31,80,26,55,81
35,8478398,Kyle Connor,L,WPG,28,74,41,39,80
35,8477501,Valeri Nichushkin,R,COL,29,80,35,45,80
35,8478439,Travis Konecny,R,PHI,27,75,36,43,79
35,8476460,Mark Scheifele,C,WPG,31,76,32,47,79
35,8482116,Tim Stützle,C,OTT,22,80,28,51,79
35,8481540,Cole Caufield,R,MTL,23,73,36,41,77
35,8480069,Cale Makar,D,COL,26,70,28,49,77
35,8476454,Ryan Nugent-Hopkins,C,EDM,31,77,18,59,77
35,8477402,Pavel Buchnevich,L,STL,29,73,33,43,76
35,8477409,Carter Verhaeghe,C,FLA,29,80,29,47,76
35,8475168,Matt Duchene,C,DAL,33,81,31,44,75
35,8480036,Miro Heiskanen,D,DAL,25,77,21,54,75
35,8477960,Adrian Kempe,R,LAK,28,81,39,35,74
35,8480018,Nick Suzuki,C,MTL,25,80,29,45,74
35,8478445,Mathew Barzal,C,NYI,27,79,16,58,74
35,8478449,Roope Hintz,C,DAL,28,82,34,39,73
35,8474141,Patrick Kane,R,DET,36,79,33,40,73
35,8479323,Adam Fox,D,NYR,26,72,21,52,73
35,8478010,Brayden Point,C,TBL,28,82,35,37,72
35,8478440,Dylan Strome,C,WSH,27,74,35,37,72
35,8478427,Sebastian Aho,C,CAR,27,74,27,44,71
35,8479337,Alex DeBrincat,R,DET,27,81,31,39,70
35,8475798,Mikael Granlund,C,SJS,32,66,21,49,70
35,8476459,Mika Zibanejad,C,NYR,31,78,27,42,69
35,8475692,Mats Zuccarello,R,MIN,37,77,19,50,69
35,8476432,Boone Jenner,C,CBJ,31,70,39,29,68
35,8482699,Dylan Guenther,R,UTA,21,77,33,35,68
35,8476448,William Karlsson,C,VGK,31,77,22,46,68
35,8479542,Brandon Hagel,L,TBL,26,82,24,43,67
35,8475184,Chris Kreider,L,NYR,33,73,43,23,66
35,8482740,Wyatt Johnston,C,DAL,21,82,36,30,66
35,8478414,Timo Meier,R,NJD,28,74,32,34,66
35,8478873,Troy Terry,R,ANA,27,73,31,35,66
35,8473994,Jamie Benn,L,DAL,35,80,28,38,66
35,8479675,Trevor Moore,L,LAK,29,80,26,40,66
35,8477940,Nikolaj Ehlers,L,WPG,28,72,21,45,66
35,8476853,Morgan Rielly,D,TOR,30,76,9,57,66
35,8482078,Lucas Raymond,L,DET,22,81,30,35,65
35,8471214,Alex Ovechkin,L,WSH,39,72,25,40,65
35,8477964,Ivan Barbashev,C,VGK,29,77,20,44,64
35,8476905,Chandler Stephenson,C,SEA,30,78,18,46,64
35,8480839,Rasmus Dahlin,D,BUF,24,69,18,46,64
35,8478460,Zach Werenski,D,CBJ,27,79,16,48,64
35,8477951,Nick Schmaltz,C,UTA,28,75,25,38,63
35,8474102,David Perron,L,OTT,36,79,19,44,63
35,8482093,Seth Jarvis,C,CAR,22,70,30,32,62
35,8476881,Tomas Hertl,C,VGK,31,78,27,35,62
35,8480803,Evan Bouchard,D,EDM,25,76,10,52,62
35,8476539,Jonathan Marchessault,R,NSH,34,71,32,29,61
35,8475784,Jeff Skinner,C,EDM,32,73,27,34,61
35,8471685,Anze Kopitar,C,LAK,37,79,17,44,61
35,8483431,Logan Cooley,C,UTA,20,80,26,34,60
35,8480830,Andrei Svechnikov,R,CAR,24,66,25,35,60
35,8477456,J.T. Compher,L,DET,29,82,24,36,60
35,8471215,Evgeni Malkin,C,PIT,38,66,21,39,60
35,8477986,Brandon Montour,D,SEA,30,74,21,39,60
35,8474578,Erik Karlsson,D,PIT,34,77,14,46,60
35,8476483,Rickard Rakell,R,PIT,31,70,38,21,59
35,8475158,Ryan O'Reilly,C,NSH,33,72,26,33,59
35,8478493,Joel Eriksson Ek,C,MIN,27,69,35,23,58
35,8475745,Charlie Coyle,C,BOS,32,77,29,29,58
35,8475726,Tyler Toffoli,C,SJS,32,67,29,29,58
35,8474586,Jordan Eberle,R,SEA,34,76,27,31,58
35,8477935,Sam Bennett,C,FLA,28,78,26,32,58
35,8475810,Bryan Rust,R,PIT,32,76,26,32,58
35,8475765,Vladimir Tarasenko,R,DET,33,80,26,32,58
35,8477496,Elias Lindholm,C,BOS,30,80,24,34,58
35,8477494,Jonathan Drouin,L,COL,29,81,18,40,58
35,8476792,Torey Krug,D,STL,33,76,18,40,58
35,8479325,Charlie McAvoy,D,BOS,27,73,11,47,58
35,8477955,Jared McCann,L,SEA,28,77,35,22,57
35,8483515,Juraj Slafkovsky,L,MTL,20,75,23,34,57
35,8479999,Casey Mittelstadt,C,COL,26,78,20,37,57
35,8471724,Kris Letang,D,PIT,37,80,15,42,57
35,8476875,Mike Matheson,D,MTL,30,77,12,45,57
35,8481068,Yegor Sharangovich,C,CGY,26,77,29,27,56
35,8473512,Claude Giroux,R,OTT,36,80,26,30,56
35,8481581,Thomas Harley,D,DAL,23,78,17,39,56
35,8478444,Brock Boeser,R,VAN,27,72,32,23,55
35,8478047,Michael Bunting,L,PIT,29,76,27,28,55
35,8474641,Adam Henrique,C,EDM,34,74,27,28,55
35,8477407,Anthony Duclair,L,NYI,29,77,27,28,55
35,8477949,Alex Tuch,R,BUF,28,75,18,37,55
35,8480064,Josh Norris,C,OTT,25,72,28,26,54
35,8473419,Brad Marchand,L,BOS,36,81,23,31,54
35,8475170,Brayden Schenn,C,STL,33,77,22,32,54
35,8477416,Oliver Bjorkstrand,R,SEA,29,68,20,34,54
35,8478396,Noah Hanifin,D,VGK,27,62,17,37,54
35,8477504,Josh Morrissey,D,WPG,29,73,15,39,54
35,8477346,MacKenzie Weegar,D,CGY,30,72,11,43,54
35,8475768,Jaden Schwartz,C,SEA,32,72,24,29,53
35,8478401,Pavel Zacha,C,BOS,27,77,23,30,53
35,8482159,Tyson Foerster,R,PHI,22,77,19,34,53
35,8476479,Phillip Danault,C,LAK,31,80,17,36,53
35,8476854,Hampus Lindholm,D,BOS,30,76,11,42,53
35,8478233,Andrew Mangiapane,L,WSH,28,66,28,24,52
35,8479420,Tage Thompson,C,BUF,27,73,27,25,52
35,8479525,Ross Colton,C,COL,28,81,23,29,52
35,8481533,Trevor Zegras,C,ANA,23,72,21,31,52
35,8479400,Pierre-Luc Dubois,L,WSH,26,65,18,34,52
35,8482720,Matthew Knies,L,TOR,22,76,14,38,52
35,8477503,Max Domi,C,TOR,29,81,13,39,52
35,8478407,Vince Dunn,D,SEA,28,74,10,42,52
35,8475167,Victor Hedman,D,TBL,34,81,9,43,52
35,8477476,Artturi Lehkonen,L,COL,29,82,27,24,51
35,8482702,Logan Stankoven,C,DAL,21,80,24,27,51
35,8475151,Kyle Palmieri,C,NYI,33,77,23,28,51
35,8475794,Tyler Seguin,C,DAL,32,81,20,31,51
35,8482665,Matty Beniers,C,SEA,22,76,17,34,51
35,8474679,Gustav Nyquist,C,NSH,35,66,16,35,51
35,8478975,Mason Marchment,L,DAL,29,81,14,37,51
35,8474590,John Carlson,D,WSH,34,68,14,37,51
35,8475786,Zach Hyman,L,EDM,32,70,29,21,50
35,8484153,Leo Carlsson,C,ANA,20,72,24,26,50
35,8480797,Joel Farabee,L,PHI,24,71,20,30,50
35,8474150,Mikael Backlund,C,CGY,35,77,18,32,50
35,8481528,Dylan Cozens,C,BUF,23,74,15,34,49
35,8474563,Drew Doughty,D,LAK,35,73,12,37,49
35,8480865,Noah Dobson,D,NYI,24,81,7,42,49
35,8481596,Shane Pinto,C,OTT,24,76,23,25,48
35,8480188,Fabian Zetterlund,L,SJS,25,68,19,29,48
35,8476880,Tom Wilson,R,WSH,30,72,18,30,48
35,8474565,Alex Pietrangelo,D,VGK,34,72,15,33,48
35,8478469,Thomas Chabot,D,OTT,27,69,8,40,48
35,8479339,Patrik Laine,L,CBJ,26,65,19,28,47
35,8482745,Mason McTavish,C,ANA,21,70,18,29,47
35,8477932,Aaron Ekblad,D,FLA,28,69,17,30,47
35,8477021,Alex Kerfoot,C,UTA,30,75,13,34,47
35,8477447,Shea Theodore,D,VGK,29,60,11,36,47
35,8482684,Luke Hughes,D,NJD,21,71,5,42,47
35,8475754,Brock Nelson,C,NYI,33,82,26,20,46
35,8480015,Owen Tippett,R,PHI,25,78,25,21,46
35,8484166,Adam Fantilli,C,CBJ,20,67,22,24,46
35,8480039,Martin Necas,C,CAR,25,69,20,26,46
35,8478474,Lawson Crouse,L,UTA,27,80,20,26,46
35,8480220,Noah Cates,L,PHI,25,68,17,29,46
35,8470613,Brent Burns,D,CAR,39,76,13,33,46
35,8479425,Filip Hronek,D,VAN,27,78,8,38,46
35,8480014,Gabriel Vilardi,C,WPG,25,70,29,16,45
35,8478366,Frank Vatrano,R,ANA,30,73,27,18,45
35,8482175,JJ Peterka,R,BUF,22,70,24,21,45
35,8483808,Andrei Kuzmenko,L,CGY,28,74,22,23,45
35,8477500,Bo Horvat,C,NYI,29,77,19,26,45
35,8481523,Kirby Dach,C,MTL,23,66,18,27,45
35,8478438,Tommy Novak,C,NSH,27,69,17,28,45
35,8480434,Sean Durzi,D,UTA,26,63,16,29,45
35,8477444,Andre Burakovsky,L,SEA,29,69,14,31,45
35,8478498,Jake DeBrusk,L,VAN,28,70,28,16,44
35,8482109,Alexis Lafrenière,L,NYR,23,78,23,21,44
35,8477451,Ryan Hartman,R,MIN,30,66,20,24,44
35,8476906,Shayne Gostisbehere,D,CAR,31,78,18,26,44
35,8482092,Ridly Greig,C,OTT,22,72,18,26,44
35,8481560,Arthur Kaliyev,R,LAK,23,80,18,26,44
35,8481711,Matias Maccelli,L,UTA,24,75,16,28,44
35,8475287,Erik Haula,L,NJD,33,68,15,29,44
35,8478856,Conor Garland,R,VAN,28,76,14,30,44
35,8476399,Blake Coleman,C,CGY,33,73,30,13,43
35,8482110,Dawson Mercer,C,NJD,23,77,23,20,43
35,8477511,Anthony Mantha,R,CGY,30,79,21,22,43
35,8481524,Bowen Byram,D,BUF,23,61,20,23,43
35,8478115,Pierre Engvall,L,NYI,28,74,20,23,43
35,8475191,Reilly Smith,R,NYR,33,67,17,26,43
35,8483505,Matthew Poitras,C,BOS,20,76,17,26,43
35,8476927,Teddy Blueger,C,VAN,30,68,16,27,43
35,8478542,Evan Rodrigues,C,FLA,31,77,15,28,43
35,8477497,Sean Monahan,C,CBJ,30,74,14,29,43
35,8475799,Nino Niederreiter,R,WPG,32,65,21,21,42
35,8475714,Calle Jarnkrok,C,TOR,33,70,17,25,42
35,8476882,Teuvo Teravainen,C,CHI,30,63,13,29,42
35,8481604,Pavel Dorofeyev,L,VGK,24,65,25,16,41
35,8475169,Evander Kane,L,EDM,33,80,21,20,41
35,8474149,Evgenii Dadonov,R,DAL,35,81,16,25,41
35,8476826,Yanni Gourde,C,SEA,33,66,16,25,41
35,8478458,John (Jack) Roslovic,C,CAR,27,71,12,29,41
35,8476923,Damon Severson,D,CBJ,30,78,10,31,41
35,8482097,Jack Quinn,R,BUF,23,63,22,18,40
35,8475793,Ryan Johansen,C,PHI,32,72,18,22,40
35,8480009,Eeli Tolvanen,R,SEA,25,71,18,22,40
35,8480028,Morgan Frost,C,PHI,25,72,17,23,40
35,8477953,Kasperi Kapanen,R,STL,28,70,17,23,40
35,8482113,Anton Lundell,C,FLA,23,75,14,26,40
35,8476462,Dougie Hamilton,D,NJD,31,69,14,26,40
35,8478466,Daniel Sprong,R,VAN,27,77,14,26,40
35,8482667,William Eklund,L,SJS,22,66,13,27,40
35,8476292,Ondrej Palat,L,NJD,33,71,12,28,40
35,8482149,Cole Perfetti,C,WPG,22,69,15,24,39
35,8482105,Jake Sanderson,D,OTT,22,76,13,26,39
35,8482124,Quinton Byfield,R,LAK,22,79,12,27,39
35,8481577,Philip Tomasino,C,NSH,23,68,12,27,39
35,8478397,Rasmus Andersson,D,CGY,28,65,6,33,39
35,8476958,Jaccob Slavin,D,CAR,30,73,5,34,39
35,8475764,Cam Fowler,D,ANA,33,77,3,36,39
35,8481542,Moritz Seider,D,DET,23,77,2,37,39
35,8481554,Kaapo Kakko,R,NYR,23,69,21,17,38
35,8478042,Viktor Arvidsson,L,EDM,31,70,19,19,38
35,8479992,Michael Rasmussen,C,DET,25,78,18,20,38
35,8479661,Tanner Jeannot,L,LAK,27,80,18,20,38
35,8476474,Stefan Noesen,R,NJD,31,64,16,22,38
35,8478462,Nicolas Roy,C,VGK,27,77,14,24,38
35,8475218,Mattias Ekholm,D,EDM,34,70,11,27,38
35,8478500,Ivan Provorov,D,CBJ,27,80,7,31,38
35,8479410,Mikhail Sergachev,D,UTA,26,66,5,33,38
35,8477426,Nicholas Paul,L,TBL,29,82,20,17,37
35,8474053,Logan Couture,C,SJS,35,61,17,20,37
35,8476392,Adam Lowry,C,WPG,31,68,17,20,37
35,8481624,Ilya Mikheyev,R,CHI,30,63,15,22,37
35,8479987,Morgan Geekie,C,BOS,26,82,13,24,37
35,8473986,Alex Killorn,L,ANA,35,75,11,26,37
35,8477429,Andrew Copp,C,DET,30,78,10,27,37
35,8478038,Devon Toews,D,COL,30,66,10,27,37
35,8478472,Mathieu Joseph,R,STL,27,70,8,29,37
35,8476869,Brady Skjei,D,NSH,30,71,7,30,37
35,8475753,Justin Faulk,D,STL,32,75,5,32,37
35,8482146,Luke Evangelista,R,NSH,22,67,22,14,36
35,8475722,Jason Zucker,L,BUF,32,71,18,18,36
35,8480849,Barrett Hayton,C,UTA,24,72,17,19,36
35,8479365,Trent Frederic,C,BOS,26,80,11,25,36
35,8478046,Danton Heinen,L,VAN,29,72,11,25,36
35,8476461,Sean Couturier,C,PHI,32,70,9,27,36
35,8481546,Cam York,D,PHI,23,68,9,27,36
35,8477495,Seth Jones,D,CHI,30,71,7,29,36
35,8483445,Cutter Gauthier,L,ANA,20,63,17,18,35
35,8471698,T.J. Oshie,R,WSH,38,63,16,19,35
35,8475763,Kevin Hayes,R,PIT,32,70,13,22,35
35,8478055,Gustav Forsling,D,FLA,28,80,12,23,35
35,8479976,Juuso Valimaki,D,UTA,26,65,10,25,35
35,8481656,Aliaksei Protas,C,WSH,23,63,9,26,35
35,8482133,Thomas Bordeleau,C,SJS,22,56,15,19,34
35,8477998,Warren Foegele,L,LAK,28,76,14,20,34
35,8476458,Ryan Strome,C,ANA,31,66,6,28,34
35,8474151,Ryan McDonagh,D,TBL,35,78,6,28,34
35,8476419,Jean-Gabriel Pageau,C,NYI,32,78,16,17,33
35,8476925,Colton Sissons,C,NSH,31,69,15,18,33
35,8473422,Nick Foligno,L,CHI,37,59,14,19,33
35,8479345,Jakob Chychrun,D,WSH,26,68,11,22,33
35,8479591,Michael Eyssimont,C,TBL,28,80,10,23,33
35,8475149,Marcus Johansson,L,MIN,34,68,9,24,33
35,8476885,Jacob Trouba,D,NYR,30,71,2,31,33
35,8476892,Colton Parayko,D,STL,31,69,2,31,33
35,8476979,Erik Gustafsson,D,DET,32,72,1,32,33
35,8480893,Kirill Marchenko,R,CBJ,24,67,20,12,32
35,8477478,William Carrier,L,CAR,30,60,17,15,32
35,8475314,Anders Lee,L,NYI,34,79,16,16,32
35,8482712,Oskar Olausson,R,COL,22,75,9,23,32
35,8482122,Brock Faber,D,MIN,22,78,4,28,32
35,8478020,Michael Amadio,R,OTT,28,72,16,15,31
35,8480185,Eetu Luostarinen,C,FLA,26,78,14,17,31
35,8476438,Brandon Saad,L,STL,32,67,14,17,31
35,8478891,Mason Appleton,C,WPG,28,64,13,18,31
35,8480068,Ryan Poehling,C,PHI,25,74,13,18,31
35,8475760,Nick Bjugstad,C,UTA,32,72,13,18,31
35,8481553,Bobby Brink,R,PHI,23,64,12,19,31
35,8480078,Filip Chytil,C,NYR,25,68,12,19,31
35,8482125,Alexander Holtz,R,VGK,22,71,23,7,30
35,8480459,Pius Suter,C,VAN,28,64,18,12,30
35,8478519,Anthony Cirelli,C,TBL,27,81,15,15,30
35,8476278,Colin Blackwell,C,DAL,31,78,9,21,30
35,8475171,Oliver Ekman-Larsson,D,TOR,33,68,7,23,30
35,8477479,Tyler Bertuzzi,L,CHI,29,70,16,13,29
35,8477353,Tyler Motte,C,DET,29,75,15,14,29
35,8475791,Taylor Hall,L,CHI,33,58,12,17,29
35,8477505,Alexander Wennberg,C,SJS,30,69,12,17,29
35,8481618,Alex Newhook,C,MTL,23,69,11,18,29
35,8482749,Joshua Roy,R,MTL,21,69,11,18,29
35,8476872,Scott Laughton,C,PHI,30,71,9,20,29
35,8475790,Erik Gudbranson,D,CBJ,32,79,6,23,29
35,8483490,Pavel Mintyukov,D,ANA,21,75,4,25,29
35,8480043,Timothy Liljegren,D,TOR,25,69,4,25,29
35,8482089,Jake Neighbours,L,STL,22,72,19,9,28
35,8477952,Robby Fabbri,C,ANA,28,72,18,10,28
35,8477987,Ryan Donato,C,CHI,28,63,16,12,28
35,8484145,Zach Benson,L,BUF,19,66,15,13,28
35,8481186,Logan O'Connor,R,COL,28,77,13,15,28
35,8480835,Jack Drury,C,CAR,24,60,12,16,28
35,8477425,Miles Wood,L,COL,29,78,12,16,28
35,8483457,Lane Hutson,D,MTL,20,70,12,16,28
35,8480789,Oliver Wahlstrom,R,NYI,24,74,11,17,28
35,8480829,Jesperi Kotkaniemi,C,CAR,24,62,10,18,28
35,8474715,Cameron Atkinson,R,TBL,35,80,10,18,28
35,8474716,Jared Spurgeon,D,MIN,35,74,9,19,28
35,8480145,Neal Pionk,D,WPG,29,70,8,20,28
35,8477498,Darnell Nurse,D,EDM,29,72,8,20,28
35,8482655,Janis Moser,D,TBL,24,76,6,22,28
35,8480873,Rasmus Sandin,D,WSH,24,65,3,25,28
35,8476902,Esa Lindell,D,DAL,30,71,2,26,28
35,8480049,Dylan Samberg,D,WPG,25,65,1,27,28
35,8482475,Yegor Chinakhov,R,CBJ,23,59,17,10,27
35,8479996,Cody Glass,C,NSH,25,57,14,13,27
35,8476480,Vladislav Namestnikov,C,WPG,32,66,13,14,27
35,8474189,Lars Eller,C,PIT,35,67,13,14,27
35,8475193,Tomas Tatar,L,NJD,34,71,12,15,27
35,8470621,Corey Perry,R,EDM,39,73,12,15,27
35,8482671,Owen Power,D,BUF,22,66,11,16,27
35,8479368,Max Jones,L,BOS,26,61,11,16,27
35,8480813,Joe Veleno,C,DET,24,74,11,16,27
35,8480798,Philipp Kurashev,C,CHI,25,64,10,17,27
35,8476917,Adam Pelech,D,NYI,30,77,9,18,27
35,8477948,Travis Sanheim,D,PHI,28,65,8,19,27
35,8477488,Brett Pesce,D,NJD,30,77,7,20,27
35,8482624,Daniil Miromanov,D,CGY,27,63,6,21,27
35,8473507,Jeff Petry,D,DET,37,74,4,23,27
35,8480336,Sean Walker,D,CAR,30,72,3,24,27
35,8479941,Justin Danforth,R,CBJ,31,61,12,14,26
35,8480205,Emil Bemstrom,C,PIT,25,57,12,14,26
35,8478109,Victor Olofsson,L,VGK,29,72,11,15,26
35,8477903,Garnet Hathaway,R,PHI,33,69,11,15,26
35,8480252,Cole Guttman,C,CHI,25,46,11,15,26
35,8476422,Mike Reilly,D,NYI,31,75,7,19,26
35,8481703,Valtteri Puustinen,R,PIT,25,58,7,19,26
35,8477969,Marcus Pettersson,D,PIT,28,75,3,23,26
35,8477435,Ryan Graves,D,PIT,29,77,2,24,26
35,8482055,Drew O'Connor,L,PIT,26,70,14,11,25
35,8476878,Zemgus Girgensons,C,TBL,30,81,14,11,25
35,8478013,Jake Walman,D,SJS,28,71,14,11,25
35,8482705,Cole Sillinger,C,CBJ,21,60,12,13,25
35,8476897,Oskar Sundqvist,C,STL,30,66,12,13,25
35,8479390,Taylor Raddysh,R,WSH,26,68,11,14,25
35,8476873,Mark Jankowski,C,NSH,30,56,11,14,25
35,8478882,Vladislav Gavrikov,D,LAK,29,62,9,16,25
35,8479414,Nathan Bastian,R,NJD,27,69,9,16,25
35,8478133,Jake Evans,C,MTL,28,70,8,17,25
35,8482101,Danil Gushchin,L,SJS,22,63,8,17,25
35,8482117,Lukas Reichel,L,CHI,22,63,7,18,25
35,8479402,Jake Bean,D,CGY,26,62,6,19,25
35,8478851,Alexandre Carrier,D,NSH,28,65,4,21,25
35,8480073,Erik Brannstrom,D,COL,25,67,3,22,25
35,8480817,K'Andre Miller,D,NYR,24,66,1,24,25
35,8473533,Jordan Staal,C,CAR,36,60,16,8,24
35,8481582,Nicholas Robertson,L,TOR,23,66,12,12,24
35,8479066,Ryan Lomberg,L,CGY,30,67,12,12,24
35,8480802,Ryan McLeod,C,BUF,25,66,12,12,24
35,8478463,Anthony Beauvillier,L,PIT,27,63,11,13,24
35,8473563,Nicklas Backstrom,C,WSH,37,53,10,14,24
35,8478057,Dakota Joshua,C,VAN,28,65,10,14,24
35,8480113,Alex Iafallo,L,WPG,31,62,9,15,24
35,8475343,Nic Dowd,C,WSH,34,63,9,15,24
35,8476467,Jamie Oleksiak,D,SEA,32,68,6,18,24
35,8481522,Peyton Krebs,C,BUF,23,62,6,18,24
35,8475200,Dmitry Orlov,D,CAR,33,73,4,20,24
35,8475181,Nick Leddy,D,STL,33,70,4,20,24
35,8478840,Will Borgen,D,SEA,28,67,3,21,24
35,8477506,Ryan Pulock,D,NYI,30,79,1,23,24
35,8476960,Andreas Athanasiou,C,CHI,30,53,15,8,23
35,8477446,Michael McCarron,R,NSH,29,64,13,10,23
35,8480289,Morgan Barron,C,WPG,26,59,13,10,23
35,8480855,Jack McBain,C,UTA,24,59,11,12,23
35,8480003,Jesper Boqvist,C,FLA,26,61,11,12,23
35,8483482,Tristan Luneau,D,ANA,20,66,11,12,23
35,8476624,Barclay Goodrow,C,SJS,31,48,11,12,23
35,8478970,Jalen Chatfield,D,CAR,28,74,10,13,23
35,8480995,Pontus Holmberg,R,TOR,25,67,10,13,23
35,8479353,Brett Howden,C,VGK,26,69,7,16,23
35,8476856,Mathew Dumba,D,DAL,30,72,5,18,23
35,8476331,Dylan DeMelo,D,WPG,31,68,4,19,23
35,8481606,Jordan Spence,D,LAK,23,69,4,19,23
35,8481580,Connor McMichael,C,WSH,23,65,17,5,22
35,8476822,Luke Glendening,C,TBL,35,81,12,10,22
35,8482111,Justin Barron,D,MTL,23,73,12,10,22
35,8483565,Nick Blankenburg,D,NSH,26,63,11,11,22
35,8481535,Nils Hoglander,L,VAN,24,61,11,11,22
35,8477919,Frederick Gaudreau,C,MIN,31,56,9,13,22
35,8481704,Juuso Parssinen,C,NSH,23,57,8,14,22
35,8481441,Joe Snively,C,DET,28,66,8,14,22
35,8482067,Connor Mackey,D,NYR,28,65,7,15,22
35,8478432,Christian Fischer,R,DET,27,74,7,15,22
35,8475324,Nick Jensen,D,OTT,34,67,7,15,22
35,8481481,Blake Lizotte,C,PIT,27,62,7,15,22
35,8474574,Tyler Myers,D,VAN,34,65,6,16,22
35,8482660,Kent Johnson,C,CBJ,22,57,4,18,22
35,8476312,Josh Manson,D,COL,33,60,4,18,22
35,8482087,Kaiden Guhle,D,MTL,22,68,2,20,22
35,8475188,Brayden McNabb,D,VGK,33,52,2,20,22
35,8481178,Egor Zamula,D,PHI,24,55,1,21,22
35,8478508,Yakov Trenin,C,MIN,27,58,15,6,21
35,8473453,Trevor Lewis,C,LAK,37,76,12,9,21
35,8475220,Marcus Foligno,L,MIN,33,55,11,10,21
35,8477450,Jason Dickinson,C,CHI,29,48,9,12,21
35,8480144,David Kampf,C,TOR,29,71,9,12,21
35,8479351,Sam Steel,C,DAL,26,74,8,13,21
35,8483468,Jiri Kulich,C,BUF,20,61,8,13,21
35,8477015,Connor Brown,R,EDM,30,67,8,13,21
35,8480871,Adam Boqvist,D,FLA,24,62,8,13,21
35,8478413,Jordan Greenway,L,BUF,27,58,8,13,21
35,8477947,Sonny Milano,L,WSH,28,62,8,13,21
35,8478434,Keegan Kolesar,R,VGK,27,66,7,14,21
35,8478178,Darren Raddysh,D,TBL,28,72,7,14,21
35,8476525,Colin Miller,D,WPG,32,65,7,14,21
35,8481527,Kaedan Korczak,D,VGK,23,48,4,17,21
35,8476463,Jonas Brodin,D,MIN,31,78,3,18,21
35,8479398,Samuel Girard,D,COL,26,65,3,18,21
35,8479619,Michael Carcone,L,UTA,28,62,12,8,20
35,8477989,Christian Dvorak,C,MTL,28,59,11,9,20
35,8476918,Jimmy Vesey,L,NYR,31,65,10,10,20
35,8483491,Ivan Miroshnichenko,L,WSH,20,58,9,11,20
35,8480762,Eric Robinson,L,CAR,29,62,8,12,20
35,8475848,Brendan Gallagher,R,MTL,32,63,7,13,20
35,8479393,Noah Gregor,L,OTT,26,75,7,13,20
35,8482142,Jamie Drysdale,D,PHI,22,65,7,13,20
35,8477507,Nikita Zadorov,D,BOS,29,63,5,15,20
35,8482809,Jackson Blake,R,CAR,21,57,4,16,20
35,8477839,Conor Sheary,L,TBL,32,80,3,17,20
35,8478507,John Marino,D,UTA,27,63,3,17,20
35,8476457,Adam Larsson,D,SEA,32,65,3,17,20
35,8479293,Brandon Tanev,L,SEA,33,62,8,11,19
35,8482074,Connor Zary,C,CGY,23,64,8,11,19
35,8484203,Bradly Nadeau,L,CAR,19,61,7,12,19
35,8480748,Kiefer Sherwood,L,VAN,29,63,7,12,19
35,8479315,Joey Anderson,R,CHI,26,46,7,12,19
35,8479982,Conor Timmins,D,TOR,26,54,3,16,19
35,8482073,Braden Schneider,D,NYR,23,67,3,16,19
35,8480860,Kevin Bahl,D,CGY,24,58,3,16,19
35,8480950,Ilya Lyubushkin,D,DAL,30,59,3,16,19
35,8480222,Sebastian Aho,D,PIT,28,66,1,18,19
35,8477220,Nate Schmidt,D,FLA,33,67,1,18,19
35,8482245,Artem Zub,D,OTT,29,65,0,19,19
35,8482259,Bobby McMann,C,TOR,28,61,12,6,18
35,8481716,Dmitri Voronkov,L,CBJ,24,44,11,7,18
35,8481477,Nico Sturm,C,SJS,29,59,11,7,18
35,8477931,Tomas Nosek,L,FLA,32,62,9,9,18
35,8482157,Will Cuylle,L,NYR,22,59,8,10,18
35,8480011,Klim Kostin,C,SJS,25,46,8,10,18
35,8478211,Dryden Hunt,L,CGY,29,49,7,11,18
35,8474034,Patrick Maroon,L,CHI,36,50,6,12,18
35,8478911,Matt Roy,D,WSH,29,65,5,13,18
35,8475455,Brenden Dillon,D,NJD,34,63,5,13,18
35,8481093,Rafael Harvey-Pinard,L,MTL,25,56,4,14,18
35,8474166,Alec Martinez,D,CHI,37,54,4,14,18
35,8481014,Alexander Romanov,D,NYI,24,73,3,15,18
35,8479983,Mario Ferraro,D,SJS,26,69,3,15,18
35,8474013,Ian Cole,D,UTA,35,53,3,15,18
35,8476967,Brett Kulak,D,EDM,30,71,1,17,18
35,8476981,Josh Anderson,R,MTL,30,69,12,5,17
35,8476374,Sean Kuraly,C,CBJ,31,58,11,6,17
35,8483524,Shane Wright,C,SEA,20,61,9,8,17
35,8480980,Connor Dewar,C,TOR,25,61,8,9,17
35,8475855,Jesper Fast,R,CAR,33,61,8,9,17
35,8479520,Brandon Duhaime,R,WSH,27,60,8,9,17
35,8480448,Parker Kelly,L,COL,25,74,7,10,17
35,8479370,Tyson Jost,C,CAR,26,46,6,11,17
35,8479718,Alex Barré-Boulet,C,MTL,27,55,6,11,17
35,8477369,Carson Soucy,D,VAN,30,59,5,12,17
35,8477406,Mattias Janmark,C,EDM,32,74,5,12,17
35,8476891,Matthew Grzelcyk,D,PIT,30,75,5,12,17
35,8476879,Cody Ceci,D,EDM,31,70,4,13,17
35,8477979,Nicolas Aube-Kubel,R,BUF,28,63,4,13,17
35,8480806,Isac Lundestrom,C,ANA,25,61,4,13,17
35,8478452,Caleb Jones,D,LAK,27,60,4,13,17
35,8475208,Brian Dumoulin,D,ANA,33,64,3,14,17
35,8480796,Martin Fehervary,D,WSH,25,54,3,14,17
35,8482079,Marco Rossi,C,MIN,23,55,11,5,16
35,8475231,Casey Cizikas,C,NYI,33,72,9,7,16
35,8480025,MacKenzie Entwistle,R,FLA,25,59,7,9,16
35,8482062,Cole Smith,L,NSH,29,57,5,11,16
35,8474673,TJ Brodie,D,CHI,34,59,5,11,16
35,8479316,Luke Kunin,C,SJS,27,55,5,11,16
35,8482095,Tyler Kleven,D,OTT,22,51,5,11,16
35,8477018,Ben Hutton,D,VGK,31,54,4,12,16
35,8475462,Radko Gudas,D,ANA,34,60,3,13,16
35,8477034,Jaycob Megna,D,FLA,32,52,3,13,16
35,8480001,Urho Vaakanainen,D,ANA,25,57,1,15,16
35,8479639,Dylan Coghlan,D,WPG,26,59,0,16,16
35,8475842,Sam Carrick,C,NYR,32,61,10,5,15
35,8481032,Paul Cotter,C,NJD,25,55,9,6,15
35,8476469,Joel Armia,R,MTL,31,70,8,7,15
35,8475225,Craig Smith,C,CHI,35,52,8,7,15
35,8478421,A.J. Greer,L,FLA,28,53,8,7,15
35,8476921,Jordan Martinook,L,CAR,32,63,7,8,15
35,8480074,Alexandre Texier,C,STL,25,49,6,9,15
35,8480878,Nils Lundkvist,D,DAL,24,74,6,9,15
35,8482803,Olen Zellweger,D,ANA,21,57,6,9,15
35,8480192,Johnathan Kovacevic,D,NJD,27,44,6,9,15
35,8483493,Frank Nazar,C,CHI,20,48,5,10,15
35,8482192,Isaak Phillips,D,CHI,23,57,5,10,15
35,8484149,Gavin Brindley,C,CBJ,20,48,5,10,15
35,8482077,Dylan Holloway,L,EDM,23,58,5,10,15
35,8479543,Michael Pezzetta,L,MTL,26,52,4,11,15
35,8480891,Michael Kesselring,D,UTA,24,67,4,11,15
35,8482451,Mikael Pyyhtia,L,CBJ,23,45,4,11,15
35,8480246,Nick Perbix,D,TBL,26,74,2,13,15
35,8479998,Mikey Anderson,D,LAK,25,62,2,13,15
35,8480807,Mattias Samuelsson,D,BUF,24,54,2,13,15
35,8476994,Vinnie Hinostroza,C,NSH,30,46,2,13,15
35,8476931,Jake McCabe,D,TOR,31,60,1,14,15
35,8480172,Jan Rutta,D,SJS,34,60,1,14,15
35,8476429,Scott Mayfield,D,NYI,32,73,1,14,15
35,8476442,Matt Nieto,L,PIT,32,49,9,5,14
35,8480281,Alexey Toropchenko,R,STL,25,54,8,6,14
35,8482155,Alex Laferriere,R,LAK,23,66,7,7,14
35,8478569,Noel Acciari,C,PIT,33,51,7,7,14
35,8480021,Jack Studnicka,C,LAK,25,57,7,7,14
35,8483499,Liam Ohgren,L,MIN,20,57,6,8,14
35,8479980,Nicolas Hague,D,VGK,26,52,6,8,14
35,8478136,Jake Middleton,D,MIN,28,77,6,8,14
35,8479291,Kevin Rooney,C,CGY,31,49,6,8,14
35,8481518,Nolan Foote,L,NJD,24,44,6,8,14
35,8480355,Mark Kastelic,C,BOS,25,55,5,9,14
35,8480070,Ian Mitchell,D,BOS,25,49,5,9,14
35,8481161,Jake Christiansen,D,CBJ,25,57,5,9,14
35,8481019,David Gustafsson,C,WPG,24,39,4,10,14
35,8476988,Matt Benning,D,SJS,30,58,3,11,14
35,8480035,Henri Jokiharju,D,BUF,25,60,3,11,14
35,8479324,Ryan Lindgren,D,NYR,26,65,1,13,14
35,8479249,Andrew Poturalski,C,SJS,30,43,0,14,14
35,8479336,Carl Grundstrom,R,SJS,27,54,10,3,13
35,8477508,Curtis Lazar,C,NJD,29,59,7,6,13
35,8479328,Julien Gauthier,R,NYI,27,59,7,6,13
35,8479439,Jacob MacDonald,D,COL,31,49,7,6,13
35,8482679,Matt Coronato,R,CGY,22,71,6,7,13
35,8480007,Jonas Rondbjerg,R,VGK,25,44,6,7,13
35,8482737,Zack Bolduc,C,STL,21,56,5,8,13
35,8481028,Martin Pospisil,C,CGY,25,53,5,8,13
35,8480848,Ty Dellandrea,C,SJS,24,42,5,8,13
35,8482176,Wyatt Kaiser,D,CHI,22,51,5,8,13
35,8480292,Carson Meyer,R,ANA,27,37,5,8,13
35,8481521,Ronnie Attard,D,PHI,25,57,4,9,13
35,8483466,Kevin Korchinski,D,CHI,20,49,4,9,13
35,8473446,Erik Johnson,D,PHI,36,47,4,9,13
35,8479986,Kole Lind,R,DAL,26,50,3,10,13
35,8481059,Scott Perunovich,D,STL,26,60,3,10,13
35,8479026,Philippe Myers,D,TOR,27,52,3,10,13
35,8478043,Sam Lafferty,C,BUF,29,54,2,11,13
35,8470600,Ryan Suter,D,STL,39,61,2,11,13
35,8471709,Marc-Edouard Vlasic,D,SJS,37,59,2,11,13
35,8476874,Olli Maatta,D,DET,30,57,1,12,13
35,8479371,Dante Fabbro,D,NSH,26,63,0,13,13
35,8481601,Simon Holmstrom,R,NYI,23,69,11,1,12
35,8479671,Mathieu Olivier,R,CBJ,27,50,7,5,12
35,8482807,Ethan Del Mastro,D,CHI,21,47,7,5,12
35,8479344,Jesse Puljujarvi,R,PIT,26,55,6,6,12
35,8482762,Simon Edvinsson,D,DET,21,54,6,6,12
35,8482145,Mavrik Bourque,C,DAL,22,52,6,6,12
35,8481013,Jonatan Berggren,R,DET,24,56,5,7,12
35,8477573,Nathan Walker,L,STL,30,45,5,7,12
35,8477499,Rasmus Ristolainen,D,PHI,30,66,4,8,12
35,8481701,Santeri Hatakka,D,NJD,23,42,4,8,12
35,8481537,Nikita Okhotiuk,D,CGY,24,62,3,9,12
35,8475233,David Savard,D,MTL,34,64,2,10,12
35,8481708,Zac Jones,D,NYR,24,49,1,11,12
35,8481567,Henry Thrun,D,SJS,23,57,1,11,12
35,8480196,Jacob Bryson,D,BUF,27,53,1,11,12
35,8475177,Calvin de Haan,D,COL,33,40,1,11,12
35,8481568,Alex Vlasic,D,CHI,23,58,0,12,12
35,8479372,Joshua Mahura,D,SEA,26,50,0,12,12
35,8482659,Josh Doan,R,UTA,22,55,8,3,11
35,8481751,Lukas Rousek,R,BUF,25,37,6,5,11
35,8474090,Brendan Smith,D,DAL,35,55,5,6,11
35,8480058,Pierre-Olivier Joseph,D,STL,25,50,5,6,11
35,8479968,Vinni Lettieri,C,BOS,29,45,4,7,11
35,8475179,Dmitry Kulikov,D,FLA,34,56,3,8,11
35,8478874,Adam Gaudette,R,OTT,28,39,3,8,11
35,8482511,Mason Lohrei,D,BOS,23,40,3,8,11
35,8480727,Zach Whitecloud,D,VGK,28,45,2,9,11
35,8478451,Ethan Bear,D,WSH,27,56,2,9,11
35,8475690,Chris Tanev,D,TOR,35,58,2,9,11
35,8478468,Jeremy Lauzon,D,NSH,27,48,2,9,11
35,8481599,Victor Soderstrom,D,UTA,23,42,2,9,11
35,8479972,Mason Shaw,C,WPG,26,33,1,10,11
35,8477845,Trevor van Riemsdyk,D,WSH,33,59,1,10,11
35,8481167,Brayden Pachal,D,CGY,25,48,1,10,11
35,8478399,Jonas Siegenthaler,D,NJD,27,56,1,10,11
35,8475762,Derek Forbort,D,VAN,32,50,1,10,11
35,8477365,Connor Clifton,D,BUF,29,60,0,11,11
35,8481679,Maxence Guenette,D,OTT,23,35,7,3,10
35,8476858,Phillip Di Giuseppe,L,VAN,31,39,6,4,10
35,8480845,Rasmus Kupari,C,WPG,24,43,6,4,10
35,8476934,Brock McGinn,L,ANA,30,50,5,5,10
35,8481556,John Beecher,C,BOS,23,41,5,5,10
35,8481617,Vasily Podkolzin,R,VAN,23,55,4,6,10
35,8480157,Calle Rosen,D,COL,30,48,4,6,10
35,8474567,Zach Bogosian,D,MIN,34,61,4,6,10
35,8481641,Joel Kiviranta,L,COL,28,61,3,7,10
35,8476473,Connor Murphy,D,CHI,31,37,3,7,10
35,8479944,Zach Aston-Reese,C,VGK,30,50,3,7,10
35,8480441,Trey Fix-Wolansky,R,CBJ,25,37,3,7,10
35,8482964,Arber Xhekaj,D,MTL,23,34,3,7,10
35,8471817,Ryan Reaves,R,TOR,37,49,3,7,10
35,8478859,Niko Mikkola,D,FLA,28,51,2,8,10
35,8475279,Ben Chiarot,D,DET,33,69,2,8,10
35,8477380,Jonny Brodzinski,C,NYR,31,48,2,8,10
35,8482652,Walker Duehr,R,CGY,27,45,2,8,10
35,8474612,Travis Hamonic,D,OTT,34,48,2,8,10
35,8476329,Travis Boyd,C,MIN,31,52,1,9,10
35,8475718,Justin Holl,D,DET,32,64,0,10,10
35,8474568,Luke Schenn,D,NSH,35,49,0,10,10
35,8478443,Brandon Carlo,D,BOS,28,59,0,10,10
35,8481543,Nikita Alexandrov,C,STL,24,32,6,3,9
35,8476889,Radek Faksa,C,STL,30,60,5,4,9
35,8482666,Scott Morrow,D,CAR,22,46,5,4,9
35,8482166,Shakir Mukhamadullin,D,SJS,22,53,5,4,9
35,8480887,Jordan Harris,D,MTL,24,59,4,5,9
35,8477392,Hudson Fasching,R,NYI,29,66,4,5,9
35,8483495,Simon Nemec,D,NJD,20,53,4,5,9
35,8479981,Jonah Gadjovich,L,FLA,26,46,4,5,9
35,8482148,Hendrix Lapierre,C,WSH,22,49,3,6,9
35,8482744,James Malatesta,L,CBJ,21,36,3,6,9
35,8477070,Liam O'Brien,C,UTA,30,51,3,6,9
35,8482747,Brennan Othmann,L,NYR,21,39,2,7,9
35,8481598,Philip Broberg,D,EDM,23,40,2,7,9
35,8476372,Nick Seeler,D,PHI,31,46,2,7,9
35,8477401,John Hayden,C,SEA,29,27,5,3,8
35,8482496,Nils Aman,C,VAN,24,39,4,4,8
35,8479359,Beck Malenstyn,L,BUF,26,45,3,5,8
35,8477962,Brendan Lemieux,L,CAR,28,42,3,5,8
35,8478585,Derek Ryan,C,EDM,38,55,3,5,8
35,8481147,Reese Johnson,C,MIN,26,43,3,5,8
35,8479772,Zack MacEwen,R,OTT,28,58,3,5,8
35,8479576,Vincent Desharnais,D,VAN,28,35,3,5,8
35,8478416,Erik Cernak,D,TBL,27,69,2,6,8
35,8484254,Akito Hirose,D,VAN,25,37,2,6,8
35,8476952,Dominic Toninato,C,WPG,30,33,1,7,8
35,8477938,Haydn Fleury,D,WPG,28,48,1,7,8
35,8479536,Axel Jonsson-Fjallby,L,WPG,26,35,1,7,8
35,8476441,Joel Edmundson,D,LAK,31,44,1,7,8
35,8484911,Collin Graf,R,SJS,22,40,1,7,8
35,8484287,Cole McWard,D,VAN,23,26,6,1,7
35,8481754,Nikita Nesterenko,C,ANA,23,29,5,2,7
35,8478424,Jansen Harkins,C,ANA,27,42,5,2,7
35,8482070,Mitchell Chaffee,R,TBL,26,51,5,2,7
35,8482859,Zack Ostapchuk,C,OTT,21,50,4,3,7
35,8483549,Lucas Condotta,L,MTL,27,34,4,3,7
35,8482141,Lukas Cormier,D,VGK,22,24,4,3,7
35,8483570,Ben Meyers,C,SEA,26,24,4,3,7
35,8478477,Mitchell Stephens,C,SEA,27,22,4,3,7
35,8479378,Logan Stanley,D,WPG,26,44,3,4,7
35,8479442,Troy Stecher,D,EDM,30,51,3,4,7
35,8482765,Isak Rosen,R,BUF,21,27,3,4,7
35,8481517,Brett Leason,R,ANA,25,59,2,5,7
35,8478450,Parker Wotherspoon,D,BOS,27,33,2,5,7
35,8477335,Kyle Burroughs,D,LAK,29,40,2,5,7
35,8481593,Jayden Struble,D,MTL,23,20,2,5,7
35,8477073,Kurtis MacDermid,L,NJD,30,28,2,5,7
35,8479369,Andrew Peeke,D,BOS,26,63,1,6,7
35,8480245,Olle Lycksell,R,PHI,25,29,1,6,7
35,8477384,Joshua Brown,D,EDM,30,40,1,6,7
35,8479638,Justin Brazeau,R,BOS,26,42,5,1,6
35,8483397,Marc McLaughlin,C,BOS,25,28,5,1,6
35,8480844,Grigori Denisenko,L,VGK,24,25,4,2,6
35,8481592,Jakob Pelletier,L,CGY,23,38,3,3,6
35,8477851,Jordan Oesterle,D,BOS,32,36,3,3,6
35,8478146,Matthew Highmore,C,OTT,28,29,3,3,6
35,8480870,Bo Groulx,C,NYR,24,32,2,4,6
35,8477887,Patrick Brown,C,BOS,32,46,2,4,6
35,8482153,Brendan Brisson,C,VGK,23,27,2,4,6
35,8481056,Spencer Stastney,D,NSH,24,34,2,4,6
35,8471677,Jack Johnson,D,CBJ,37,60,2,4,6
35,8480880,Jakub Lauko,C,MIN,24,35,2,4,6
35,8479419,Brett Murray,L,BUF,26,19,2,4,6
35,8479985,Cale Fleury,D,SEA,26,23,2,4,6
35,8482861,Vincent Iorio,D,WSH,22,26,1,5,6
35,8482733,Logan Mailloux,D,MTL,31,27,0,6,6
35,8480879,Jacob Bernard-Docker,D,OTT,24,47,0,6,6
35,8478831,Kevin Stenlund,C,UTA,28,50,3,2,5
35,8482730,Brandt Clarke,D,LAK,21,46,3,2,5
35,8482784,Zach Dean,C,STL,21,38,3,2,5
35,8479379,Givani Smith,R,SJS,26,35,3,2,5
35,8478409,Anthony Richard,C,PHI,28,30,3,2,5
35,8475958,Michael Sgarbossa,C,WSH,32,26,3,2,5
35,8483512,Matthew Savoie,C,EDM,20,27,3,2,5
35,8481605,Jackson LaCombe,D,ANA,23,36,2,3,5
35,8479320,Maxime Lajoie,D,SEA,27,30,2,3,5
35,8482634,Alex Steeves,C,TOR,25,41,1,4,5
35,8483763,Maksymilian Szuber,D,UTA,22,34,1,4,5
35,8483460,David Jiricek,D,CBJ,21,59,1,4,5
35,8479991,Jake Leschyshyn,C,NYR,25,38,1,4,5
35,8481609,Vladislav Kolyachonok,D,UTA,23,36,1,4,5
35,8481541,Samuel Bolduc,D,NYI,24,31,1,4,5
35,8481600,Tobias Bjornfot,D,FLA,23,45,0,5,5
35,8482470,Ilya Solovyov,D,CGY,24,22,0,5,5
35,8483012,Logan Morrison,C,SEA,22,41,4,0,4
35,8481789,Tye Kartye,L,SEA,23,42,4,0,4
35,8482147,Jean-Luc Foudy,C,COL,22,32,3,1,4
35,8480990,Declan Chisholm,D,MIN,24,42,2,2,4
35,8482751,Ryan Winterton,C,SEA,21,36,2,2,4
35,8481532,Alex Turcotte,C,LAK,23,43,2,2,4
35,8481699,Aku Raty,R,UTA,23,12,2,2,4
35,8481550,Adam Beckman,L,NJD,23,32,1,3,4
35,8478454,Noah Juulsen,D,VAN,27,34,1,3,4
35,8477482,Zachary Sanford,L,CHI,30,36,1,3,4
35,8480890,Jan Jenik,C,OTT,24,26,1,3,4
35,8481122,Simon Benoit,D,TOR,26,38,1,3,4
35,8482162,Roby Jarventie,L,EDM,22,14,1,3,4
35,8480834,Ty Emberson,D,SJS,24,37,1,3,4
35,8474062,Riley Nash,C,NYR,35,18,1,3,4
35,8479367,William Lockwood,R,FLA,26,24,1,3,4
35,8482787,Nikita Chibrikov,R,WPG,31,9,1,3,4
35,8478881,Brett Seney,L,CHI,28,8,1,3,4
35,8479994,Jaret Anderson-Dolan,C,WPG,25,37,0,4,4
35,8475750,Jon Merrill,D,MIN,32,55,0,4,4
35,8481030,Jack St. Ivany,D,PIT,25,18,0,4,4
35,8480084,Nick DeSimone,D,NJD,30,17,0,4,4
35,8477971,Andreas Englund,D,LAK,28,28,0,4,4
35,8475413,Justin Dowling,C,NJD,34,16,3,0,3
35,8479362,Riley Tufte,L,BOS,26,17,2,1,3
35,8475780,Chris Wagner,R,COL,33,14,2,1,3
35,8479348,Kale Clague,D,BUF,26,36,1,2,3
35,8482177,Marat Khusnutdinov,C,MIN,22,34,1,2,3
35,8478017,Mark Friedman,D,VAN,29,32,1,2,3
35,8482713,Mackie Samoskevich,R,FLA,22,38,1,2,3
35,8476913,Devin Shore,C,MIN,30,28,1,2,3
35,8482201,Gage Goncalves,C,TBL,23,26,1,2,3
35,8483630,Pavol Regenda,L,ANA,25,27,0,3,3
35,8477244,Chad Ruhwedel,D,NYR,34,32,0,3,3
35,8481719,Maxwell Crozier,D,TBL,24,17,0,3,3
35,8481743,Marc Del Gaizo,D,NSH,25,25,0,3,3
35,8481065,Angus Crookshank,L,OTT,25,17,2,0,2
35,8484325,Waltteri Merela,C,TBL,26,17,2,0,2
35,8481024,Linus Karlsson,C,VAN,25,7,2,0,2
35,8475235,Nicolas Deslauriers,L,PHI,33,48,1,1,2
35,8482858,Ryker Evans,D,SEA,23,21,1,1,2
35,8478051,Max Willman,C,NJD,29,20,1,1,2
35,8481206,John Ludvig,D,PIT,24,15,1,1,2
35,8480823,Alexander Alexeyev,D,WSH,25,13,1,1,2
35,8483597,Milos Kelemen,L,UTA,25,11,1,1,2
35,8482088,Justin Sourdif,R,FLA,22,14,1,1,2
35,8484258,Sam Malinski,D,COL,26,27,1,1,2
35,8481422,Jake Lucchini,C,NSH,29,18,1,1,2
35,8477810,Joel Hanley,D,CGY,33,22,1,1,2
35,8482929,Emil Lilleberg,D,TBL,23,18,1,1,2
35,8483546,Marshall Rifai,D,TOR,26,7,1,1,2
35,8480851,Akil Thomas,C,LAK,24,19,1,1,2
35,8483619,Filip Roos,D,OTT,25,33,0,2,2
35,8476867,Brendan Gaunce,C,MIN,30,41,0,2,2
35,8479587,Rhett Gardner,C,PHI,28,16,0,2,2
35,8481564,Ryan Johnson,D,BUF,23,18,0,2,2
35,8477467,Gustav Olofsson,D,SEA,30,20,0,2,2
35,8482250,Callahan Burke,C,VGK,27,23,0,2,2
35,8482165,Yan Kuznetsov,D,CGY,22,18,0,2,2
35,8482516,Matthew Kessel,D,STL,24,14,0,2,2
35,8482118,Sam Colangelo,R,ANA,23,23,0,2,2
35,8475755,Alexander Petrovic,D,DAL,32,6,0,2,2
35,8481237,Kyle MacLean,C,NYI,25,21,0,2,2
35,8480874,Adam Ginning,D,PHI,24,12,0,2,2
35,8479330,Brandon Gignac,C,MTL,27,13,0,2,2
35,8478011,Louie Belpedio,D,PHI,28,11,0,2,2
35,8481585,Egor Afanasyev,L,SJS,23,14,1,0,1
35,8480267,Sammy Walker,C,MIN,25,25,1,0,1
35,8482144,Jack Thompson,D,SJS,22,28,1,0,1
35,8481726,Adam Edstrom,C,NYR,24,9,1,0,1
35,8483489,Fraser Minten,C,TOR,31,19,1,0,1
35,8482172,Landon Slaggert,L,CHI,22,24,1,0,1
35,8477541,Dakota Mermis,D,TOR,30,10,1,0,1
35,8483407,Brandon Scanlin,D,NYR,25,5,1,0,1
35,8477462,Robert Hagg,D,VGK,29,23,0,1,1
35,8475795,Dylan McIlrath,D,WSH,32,15,0,1,1
35,8477527,Ross Johnston,L,ANA,30,20,0,1,1
35,8477473,Justin Bailey,R,SJS,29,17,0,1,1
35,8478021,William Lagesson,D,DET,28,25,0,1,1
35,8482094,Daemon Hunt,D,MIN,22,14,0,1,1
35,8481806,Louis Crevier,D,CHI,23,9,0,1,1
35,8483567,Georgii Merkulov,C,BOS,24,11,0,1,1
35,8478854,Ryan Shea,D,PIT,27,9,0,1,1
35,8483395,Arshdeep Bains,L,VAN,23,6,0,1,1
35,8482061,Brandon Biro,L,SEA,26,13,0,1,1
35,8484255,Jason Polin,R,COL,25,5,0,1,1
35,8481578,Graeme Clarke,R,MIN,23,8,0,1,1
35,8479421,Jacob Moverare,D,LAK,26,8,0,1,1
35,8477320,Anton Blidh,L,NYR,29,19,0,0,0
35,8477149,Scott Sabourin,R,SJS,32,15,0,0,0
35,8481043,Cole Koepke,L,BOS,26,5,0,0,0
35,8480468,James Hamblin,L,EDM,25,17,0,0,0
35,8481655,Cole Schwindt,R,CGY,23,3,0,0,0
35,8482476,Emil Heineman,L,MTL,23,11,0,0,0
35,8481462,Mason Morelli,L,VGK,28,12,0,0,0
35,8478446,Glenn Gawdin,C,LAK,27,10,0,0,0
35,8481006,Tyler Tucker,D,STL,24,17,0,0,0
35,8484304,Uvis Balinskis,D,FLA,28,10,0,0,0
35,8480075,Cameron Crotty,D,MIN,25,13,0,0,0
35,8478502,Dennis Gilbert,D,BUF,28,15,0,0,0
35,8479522,Hardy Haman Aktell,D,WSH,26,3,0,0,0
35,8483531,Brian Halonen,L,NJD,25,4,0,0,0
35,8480032,Shane Bowers,C,NJD,25,11,0,0,0
35,8481534,Raphael Lavoie,C,EDM,24,0,0,0,0
35,8482102,Vasily Ponomarev,C,PIT,22,19,0,0,0
35,8483471,Brad Lambert,C,WPG,31,10,0,0,0
35,8480306,Grant Hutton,D,NYI,29,3,0,0,0
35,8477993,Justin Kirkland,C,CGY,28,3,0,0,0
35,8483609,Adam Klapka,R,CGY,24,1,0,0,0
35,8483432,Luca Del Bel Belluz,C,CBJ,31,8,0,0,0
35,8476323,Max McCormick,L,SEA,32,3,0,0,0
35,8483401,Marc Johnstone,R,PIT,28,1,0,0,0
35,8482460,Matt Rempe,C,NYR,22,11,0,0,0
35,8478147,Bokondji Imama,L,PIT,28,3,0,0,0
35,8483920,Pierrick Dube,R,WSH,23,5,0,0,0
35,8482197,Adam Raska,R,MIN,23,8,0,0,0
35,8483045,Cameron Butler,R,CBJ,31,1,0,0,0
35,8482126,Emil Andrae,D,PHI,31,0,0,0,0
35,8483398,Declan Carlile,D,TBL,31,7,0,0,0
35,8478956,Samuel Laberge,L,NJD,27,2,0,0,0
35,8480274,Philip Kemp,D,EDM,25,2,0,0,0
35,8484259,Ondrej Pavel,C,COL,31,4,0,0,0
35,8484326,Patrik Koch,D,UTA,28,3,0,0,0
35,8484321,Nikolas Matinpalo,D,OTT,26,1,0,0,0
35,8470794,Joe Pavelski,C,,40,0,0,0,0
35,8479321,Lucas Johansen,D,,27,0,0,0,0
35,8477950,Tony DeAngelo,D,,29,0,0,0,0
35,8471218,Blake Wheeler,R,,38,0,0,0,0
35,8475197,Tyson Barrie,D,,33,0,0,0,0
35,8474157,Max Pacioretty,L,,36,0,0,0,0
35,8475744,Evgeny Kuznetsov,C,,32,0,0,0,0
35,8474037,James van Riemsdyk,L,,35,0,0,0,0
35,8476907,Mackenzie MacEachern,L,,30,0,0,0,0
35,8480216,Jacob Peterson,C,,25,0,0,0,0
35,8474602,Justin Schultz,D,,34,0,0,0,0
35,8482222,Alexander Barabanov,L,,30,0,0,0,0
35,8474031,Kevin Shattenkirk,D,,35,0,0,0,0
35,8477330,Dominik Kubalik,L,,29,0,0,0,0
35,8480884,Calen Addison,D,,24,0,0,0,0
35,8475906,John Klingberg,D,,32,0,0,0,0
35,8480008,Adam Ruzicka,C,,25,0,0,0,0
35,8476884,Derrick Pouliot,D,,30,0,0,0,0
35,8476919,Chris Tierney,C,,30,0,0,0,0
35,8479415,Michael McLeod,C,,26,0,0,0,0
35,8474870,Tyler Johnson,C,,34,0,0,0,0
35,8470604,Jeff Carter,C,,39,0,0,0,0
35,8478104,Sammy Blais,L,,28,0,0,0,0
35,8474884,Mike Hoffman,C,,35,0,0,0,0
35,8481591,Sam Poulin,R,,23,0,0,0,0
35,8471274,Alex Goligoski,D,,39,0,0,0,0
35,8476871,Tanner Pearson,L,,32,0,0,0,0
35,8476393,Nick Cousins,C,,31,0,0,0,0
35,8479977,Kailer Yamamoto,R,,26,0,0,0,0
35,8479346,Dillon Dube,C,,26,0,0,0,0
35,8480184,Gustav Lindstrom,D,,26,0,0,0,0
35,8479376,Victor Mete,D,,26,0,0,0,0
35,8473449,Kyle Okposo,R,,36,0,0,0,0
35,8481058,Jesse Ylonen,R,,25,0,0,0,0
35,8475752,Tyler Pitlick,C,,33,0,0,0,0
35,8481239,Samuel Fagemo,L,,24,0,0,0,0
35,8480821,Filip Zadina,R,,25,0,0,0,0
35,8470966,Mark Giordano,D,,41,0,0,0,0
35,8478495,Denis Gurianov,R,,27,0,0,0,0
35,8477464,Nic Petan,C,,29,0,0,0,0
35,8478099,Kevin Labanc,R,,29,0,0,0,0
35,8482241,Radim Zohorna,L,,28,0,0,0,0
35,8474040,Sam Gagner,C,,35,0,0,0,0
35,8479514,Rem Pitlick,C,,27,0,0,0,0
35,8478430,Oliver Kylington,D,,27,0,0,0,0
35,8479533,Joona Koppanen,L,,26,0,0,0,0
35,8479984,Cal Foote,D,,26,0,0,0,0
35,8477126,Jayson Megna,C,,34,0,0,0,0
35,8475164,Jakob Silfverberg,R,,34,0,0,0,0
35,8474009,Nick Bonino,C,,36,0,0,0,0
35,8479458,Nikita Zaitsev,D,,33,0,0,0,0
35,8477944,Jakub Vrana,L,,28,0,0,0,0
35,8471699,Andrew Cogliano,C,,37,0,0,0,0
35,8478067,Oskar Lindblom,L,,28,0,0,0,0
35,8471686,Marc Staal,D,,37,0,0,0,0
35,8470610,Zach Parise,L,,40,0,0,0,0
35,8478904,Steven Lorentz,C,,28,0,0,0,0
35,8473473,Milan Lucic,L,,36,0,0,0,0
35,8480031,Maxime Comtois,L,,25,0,0,0,0
35,8478512,Austin Czarnik,C,,32,0,0,0,0
35,8473504,Cal Clutterbuck,R,,37,0,0,0,0
35,8477454,Adam Erne,L,,29,0,0,0,0
35,8479383,Boris Katchouk,L,,26,0,0,0,0
35,8475825,Jani Hakanpää,D,,32,0,0,0,0
35,8477846,Ryan Carpenter,C,,33,0,0,0,0
35,8477930,Pierre-Edouard Bellemare,L,,39,0,0,0,0
35,8478400,Colin White,C,,27,0,0,0,0
35,8480226,Marián Studenic,R,,26,0,0,0,0
35,8480853,Liam Foudy,C,,24,0,0,0,0
35,8475797,Jarred Tinordi,D,,32,0,0,0,0
35,8479423,Alex Nylander,L,,26,0,0,0,0
35,8474618,Marco Scandella,D,,34,0,0,0,0
35,8478028,Fredrik Olofsson,L,,28,0,0,0,0
35,8474709,Matt Martin,L,,35,0,0,0,0
35,8481070,Hugh McGing,L,,26,0,0,0,0
35,8479546,Oskar Steen,C,,26,0,0,0,0
35,8474145,Robert Bortuzzo,D,,35,0,0,0,0
35,8476915,Jujhar Khaira,L,,30,0,0,0,0
35,8475278,Byron Froese,C,,33,0,0,0,0
35,8481812,Nikolai Knyzhov,D,,27,0,0,0,0
35,8478408,Travis Dermott,D,,28,0,0,0,0
35,8481077,John Leonard,L,,26,0,0,0,0
35,8479547,Matthew Phillips,R,,26,0,0,0,0
35,8480836,Jonathan Gruden,C,,24,0,0,0,0
35,8481690,Tyler Angle,C,,24,0,0,0,0
35,8475766,Austin Watson,L,,32,0,0,0,0
35,8481016,Ruslan Iskhakov,C,,24,0,0,0,0
35,8478078,Rourke Chartier,C,,28,0,0,0,0
35,8480776,Sheldon Rempal,R,,29,0,0,0,0
35,8484314,Jiri Smejkal,L,,28,0,0,0,0
36,8478402,Connor McDavid,C,EDM,27,76,46,87,133
36,8477492,Nathan MacKinnon,C,COL,29,82,47,84,131
36,8476453,Nikita Kucherov,R,TBL,31,82,34,96,130
36,8478550,Artemi Panarin,L,NYR,33,79,42,84,126
36,8477934,Leon Draisaitl,C,EDM,29,77,45,69,114
36,8479318,Auston Matthews,C,TOR,27,81,72,39,111
36,8481559,Jack Hughes,C,NJD,23,74,34,73,107
36,8480027,Jason Robertson,L,DAL,25,81,44,62,106
36,8476468,J.T. Miller,C,VAN,31,77,31,73,104
36,8478483,Mitch Marner,R,TOR,27,77,25,79,104
36,8477956,David Pastrnak,R,BOS,28,80,45,58,103
36,8477404,Jake Guentzel,C,TBL,30,82,53,47,100
36,8471675,Sidney Crosby,C,PIT,37,75,41,58,99
36,8477409,Carter Verhaeghe,C,FLA,29,82,47,51,98
36,8478010,Brayden Point,C,TBL,28,82,48,47,95
36,8477493,Aleksander Barkov,C,FLA,29,78,31,63,94
36,8477933,Sam Reinhart,C,FLA,29,78,43,50,93
36,8477939,William Nylander,R,TOR,28,74,40,53,93
36,8480069,Cale Makar,D,COL,26,69,32,60,92
36,8479420,Tage Thompson,C,BUF,27,70,39,51,90
36,8478414,Timo Meier,R,NJD,28,76,41,46,87
36,8477946,Dylan Larkin,C,DET,28,80,37,50,87
36,8478864,Kirill Kaprizov,L,MIN,27,73,35,52,87
36,8478445,Mathew Barzal,C,NYI,27,80,16,71,87
36,8477942,Kevin Fiala,L,LAK,28,82,32,54,86
36,8477501,Valeri Nichushkin,R,COL,29,81,38,47,85
36,8482116,Tim Stützle,C,OTT,22,82,29,56,85
36,8476887,Filip Forsberg,L,NSH,30,79,43,41,84
36,8478420,Mikko Rantanen,R,COL,28,81,35,49,84
36,8479314,Matthew Tkachuk,L,FLA,27,80,30,54,84
36,8480800,Quinn Hughes,D,VAN,25,75,11,73,84
36,8480002,Nico Hischier,C,NJD,25,79,32,51,83
36,8480865,Noah Dobson,D,NYI,24,79,13,70,83
36,8475786,Zach Hyman,L,EDM,32,77,41,41,82
36,8476389,Vincent Trocheck,C,NYR,31,74,34,47,81
36,8476460,Mark Scheifele,C,WPG,31,76,28,53,81
36,8479407,Jesper Bratt,L,NJD,26,74,36,44,80
36,8479385,Jordan Kyrou,C,STL,26,74,26,53,79
36,8474141,Patrick Kane,R,DET,36,81,30,48,78
36,8475913,Mark Stone,R,VGK,32,80,25,53,78
36,8479323,Adam Fox,D,NYR,26,73,11,67,78
36,8478403,Jack Eichel,C,VGK,28,76,41,36,77
36,8478398,Kyle Connor,L,WPG,28,71,39,38,77
36,8480023,Robert Thomas,C,STL,25,75,25,52,77
36,8475754,Brock Nelson,C,NYI,33,79,39,37,76
36,8474564,Steven Stamkos,C,NSH,34,74,31,45,76
36,8480801,Brady Tkachuk,L,OTT,25,80,39,36,75
36,8480208,Drake Batherson,R,OTT,26,80,27,48,75
36,8473419,Brad Marchand,L,BOS,36,81,27,48,75
36,8477504,Josh Morrissey,D,WPG,29,78,21,54,75
36,8475810,Bryan Rust,R,PIT,32,73,44,30,74
36,8478427,Sebastian Aho,C,CAR,27,75,32,42,74
36,8477951,Nick Schmaltz,C,UTA,28,79,31,43,74
36,8475158,Ryan O'Reilly,C,NSH,33,73,30,44,74
36,8476459,Mika Zibanejad,C,NYR,31,76,28,46,74
36,8482078,Lucas Raymond,L,DET,22,81,27,47,74
36,8471685,Anze Kopitar,C,LAK,37,79,24,50,74
36,8478460,Zach Werenski,D,CBJ,27,82,21,53,74
36,8478439,Travis Konecny,R,PHI,27,77,34,39,73
36,8479337,Alex DeBrincat,R,DET,27,79,27,46,73
36,8478449,Roope Hintz,C,DAL,28,81,34,38,72
36,8477500,Bo Horvat,C,NYI,29,80,33,39,72
36,8481557,Matt Boldy,L,MIN,23,70,30,42,72
36,8475170,Brayden Schenn,C,STL,33,75,29,43,72
36,8477940,Nikolaj Ehlers,L,WPG,28,70,20,52,72
36,8471215,Evgeni Malkin,C,PIT,38,73,24,46,70
36,8474600,Roman Josi,D,NSH,34,72,14,56,70
36,8481540,Cole Caufield,R,MTL,23,76,39,30,69
36,8479675,Trevor Moore,L,LAK,29,81,33,36,69
36,8480012,Elias Pettersson,C,VAN,26,74,32,37,69
36,8480036,Miro Heiskanen,D,DAL,25,75,7,62,69
36,8475184,Chris Kreider,L,NYR,33,75,41,27,68
36,8475726,Tyler Toffoli,C,SJS,32,74,34,34,68
36,8479542,Brandon Hagel,L,TBL,26,81,30,38,68
36,8473986,Alex Killorn,L,ANA,35,73,29,39,68
36,8475168,Matt Duchene,C,DAL,33,81,23,45,68
36,8477402,Pavel Buchnevich,L,STL,29,76,28,39,67
36,8475172,Nazem Kadri,C,CGY,34,77,20,47,67
36,8475166,John Tavares,C,TOR,34,77,33,33,66
36,8477949,Alex Tuch,R,BUF,28,72,28,38,66
36,8476448,William Karlsson,C,VGK,31,77,25,41,66
36,8476479,Phillip Danault,C,LAK,31,81,24,42,66
36,8475692,Mats Zuccarello,R,MIN,37,76,20,46,66
36,8476346,Johnny Gaudreau,L,CBJ,31,73,15,50,65
36,8477960,Adrian Kempe,R,LAK,28,78,34,30,64
36,8482740,Wyatt Johnston,C,DAL,21,82,32,32,64
36,8475784,Jeff Skinner,C,EDM,32,80,28,36,64
36,8482665,Matty Beniers,C,SEA,22,70,27,37,64
36,8478975,Mason Marchment,L,DAL,29,82,20,44,64
36,8482699,Dylan Guenther,R,UTA,21,78,29,34,63
36,8475768,Jaden Schwartz,C,SEA,32,74,28,35,63
36,8474586,Jordan Eberle,R,SEA,34,78,24,39,63
36,8473994,Jamie Benn,L,DAL,35,82,23,40,63
36,8478047,Michael Bunting,L,PIT,29,76,21,42,63
36,8482124,Quinton Byfield,R,LAK,22,77,16,47,63
36,8476432,Boone Jenner,C,CBJ,31,70,33,28,61
36,8480830,Andrei Svechnikov,R,CAR,24,72,28,33,61
36,8477955,Jared McCann,L,SEA,28,70,24,37,61
36,8478440,Dylan Strome,C,WSH,27,70,23,38,61
36,8479343,Clayton Keller,R,UTA,26,75,22,39,61
36,8477503,Max Domi,C,TOR,29,77,19,42,61
36,8476875,Mike Matheson,D,MTL,30,71,9,52,61
36,8484166,Adam Fantilli,C,CBJ,20,69,33,27,60
36,8477935,Sam Bennett,C,FLA,28,80,24,36,60
36,8476462,Dougie Hamilton,D,NJD,31,76,20,40,60
36,8475167,Victor Hedman,D,TBL,34,81,13,47,60
36,8475745,Charlie Coyle,C,BOS,32,77,31,28,59
36,8481528,Dylan Cozens,C,BUF,23,73,25,34,59
36,8480018,Nick Suzuki,C,MTL,25,75,21,38,59
36,8476454,Ryan Nugent-Hopkins,C,EDM,31,74,13,46,59
36,8482684,Luke Hughes,D,NJD,21,71,12,47,59
36,8471214,Alex Ovechkin,L,WSH,39,76,29,29,58
36,8476853,Morgan Rielly,D,TOR,30,77,13,45,58
36,8474578,Erik Karlsson,D,PIT,34,79,9,49,58
36,8482093,Seth Jarvis,C,CAR,22,73,31,26,57
36,8481068,Yegor Sharangovich,C,CGY,26,75,31,26,57
36,8475848,Brendan Gallagher,R,MTL,32,74,23,34,57
36,8475765,Vladimir Tarasenko,R,DET,33,81,22,35,57
36,8483431,Logan Cooley,C,UTA,20,75,21,36,57
36,8480839,Rasmus Dahlin,D,BUF,24,69,12,45,57
36,8478444,Brock Boeser,R,VAN,27,70,27,29,56
36,8482745,Mason McTavish,C,ANA,21,68,25,31,56
36,8478873,Troy Terry,R,ANA,27,72,22,34,56
36,8478366,Frank Vatrano,R,ANA,30,73,33,22,55
36,8476539,Jonathan Marchessault,R,NSH,34,63,32,23,55
36,8480014,Gabriel Vilardi,C,WPG,25,73,29,26,55
36,8482149,Cole Perfetti,C,WPG,22,66,27,28,55
36,8476881,Tomas Hertl,C,VGK,31,75,26,29,55
36,8478401,Pavel Zacha,C,BOS,27,79,22,33,55
36,8479999,Casey Mittelstadt,C,COL,26,81,19,36,55
36,8478407,Vince Dunn,D,SEA,28,70,12,43,55
36,8480015,Owen Tippett,R,PHI,25,77,30,24,54
36,8473512,Claude Giroux,R,OTT,36,81,22,32,54
36,8476399,Blake Coleman,C,CGY,33,77,30,23,53
36,8475794,Tyler Seguin,C,DAL,32,81,29,24,53
36,8478498,Jake DeBrusk,L,VAN,28,67,28,25,53
36,8475799,Nino Niederreiter,R,WPG,32,70,27,26,53
36,8477496,Elias Lindholm,C,BOS,30,76,16,37,53
36,8477497,Sean Monahan,C,CBJ,30,71,15,38,53
36,8480803,Evan Bouchard,D,EDM,25,80,11,42,53
36,8476958,Jaccob Slavin,D,CAR,30,77,9,44,53
36,8479339,Patrik Laine,L,CBJ,26,72,22,30,52
36,8480039,Martin Necas,C,CAR,25,73,21,31,52
36,8477986,Brandon Montour,D,SEA,30,75,19,33,52
36,8478493,Joel Eriksson Ek,C,MIN,27,70,28,23,51
36,8478438,Tommy Novak,C,NSH,27,68,18,33,51
36,8481711,Matias Maccelli,L,UTA,24,69,17,34,51
36,8474679,Gustav Nyquist,C,NSH,35,69,16,35,51
36,8480064,Josh Norris,C,OTT,25,77,27,23,50
36,8477476,Artturi Lehkonen,L,COL,29,82,26,24,50
36,8480188,Fabian Zetterlund,L,SJS,25,67,20,30,50
36,8477451,Ryan Hartman,R,MIN,30,76,22,27,49
36,8482159,Tyson Foerster,R,PHI,22,75,21,28,49
36,8475798,Mikael Granlund,C,SJS,32,70,13,36,49
36,8476456,Jonathan Huberdeau,C,CGY,31,75,8,41,49
36,8482109,Alexis Lafrenière,L,NYR,23,75,22,26,48
36,8478542,Evan Rodrigues,C,FLA,31,66,14,34,48
36,8479325,Charlie McAvoy,D,BOS,27,77,10,38,48
36,8476438,Brandon Saad,L,STL,32,77,28,19,47
36,8475314,Anders Lee,L,NYI,34,78,25,22,47
36,8476880,Tom Wilson,R,WSH,30,75,24,23,47
36,8481533,Trevor Zegras,C,ANA,23,71,20,27,47
36,8480849,Barrett Hayton,C,UTA,24,69,20,27,47
36,8477416,Oliver Bjorkstrand,R,SEA,29,73,19,28,47
36,8476826,Yanni Gourde,C,SEA,33,75,19,28,47
36,8474149,Evgenii Dadonov,R,DAL,35,81,18,29,47
36,8477429,Andrew Copp,C,DET,30,79,13,34,47
36,8474590,John Carlson,D,WSH,34,68,10,37,47
36,8479425,Filip Hronek,D,VAN,27,71,10,37,47
36,8480009,Eeli Tolvanen,R,SEA,25,74,24,22,46
36,8476792,Torey Krug,D,STL,33,73,13,33,46
36,8481596,Shane Pinto,C,OTT,24,77,11,35,46
36,8476906,Shayne Gostisbehere,D,CAR,31,77,10,36,46
36,8482089,Jake Neighbours,L,STL,22,70,29,16,45
36,8477407,Anthony Duclair,L,NYI,29,81,23,22,45
36,8474641,Adam Henrique,C,EDM,34,73,20,25,45
36,8478042,Viktor Arvidsson,L,EDM,31,75,18,27,45
36,8483515,Juraj Slafkovsky,L,MTL,20,75,17,28,45
36,8478462,Nicolas Roy,C,VGK,27,75,15,30,45
36,8471724,Kris Letang,D,PIT,37,72,13,32,45
36,8474563,Drew Doughty,D,LAK,35,75,12,33,45
36,8479525,Ross Colton,C,COL,28,80,20,24,44
36,8471698,T.J. Oshie,R,WSH,38,70,20,24,44
36,8484145,Zach Benson,L,BUF,19,67,19,25,44
36,8478458,John (Jack) Roslovic,C,CAR,27,68,17,27,44
36,8477444,Andre Burakovsky,L,SEA,29,68,14,30,44
36,8477494,Jonathan Drouin,L,COL,29,82,13,31,44
36,8478038,Devon Toews,D,COL,30,74,5,39,44
36,8482475,Yegor Chinakhov,R,CBJ,23,67,24,19,43
36,8484144,Connor Bedard,C,CHI,19,64,19,24,43
36,8474150,Mikael Backlund,C,CGY,35,70,18,25,43
36,8475722,Jason Zucker,L,BUF,32,68,18,25,43
36,8475191,Reilly Smith,R,NYR,33,71,21,21,42
36,8478856,Conor Garland,R,VAN,28,73,20,22,42
36,8476392,Adam Lowry,C,WPG,31,66,16,26,42
36,8480797,Joel Farabee,L,PHI,24,76,15,27,42
36,8482097,Jack Quinn,R,BUF,23,70,15,27,42
36,8476882,Teuvo Teravainen,C,CHI,30,71,13,29,42
36,8477495,Seth Jones,D,CHI,30,71,8,34,42
36,8476923,Damon Severson,D,CBJ,30,79,3,39,42
36,8482055,Drew O'Connor,L,PIT,26,64,23,18,41
36,8478046,Danton Heinen,L,VAN,29,72,20,21,41
36,8477479,Tyler Bertuzzi,L,CHI,29,60,20,21,41
36,8477964,Ivan Barbashev,C,VGK,29,77,19,22,41
36,8474053,Logan Couture,C,SJS,35,68,17,24,41
36,8477511,Anthony Mantha,R,CGY,30,75,16,25,41
36,8477456,J.T. Compher,L,DET,29,78,15,26,41
36,8478519,Anthony Cirelli,C,TBL,27,82,15,26,41
36,8482702,Logan Stankoven,C,DAL,21,81,14,27,41
36,8477346,MacKenzie Weegar,D,CGY,30,74,8,33,41
36,8476981,Josh Anderson,R,MTL,30,74,20,20,40
36,8474102,David Perron,L,OTT,36,78,16,24,40
36,8481581,Thomas Harley,D,DAL,23,74,15,25,40
36,8480459,Pius Suter,C,VAN,28,72,14,26,40
36,8476905,Chandler Stephenson,C,SEA,30,73,13,27,40
36,8478463,Anthony Beauvillier,L,PIT,27,65,13,27,40
36,8475714,Calle Jarnkrok,C,TOR,33,74,12,28,40
36,8470613,Brent Burns,D,CAR,39,73,10,30,40
36,8479410,Mikhail Sergachev,D,UTA,26,68,9,31,40
36,8482712,Oskar Olausson,R,COL,22,78,8,32,40
36,8475169,Evander Kane,L,EDM,33,78,23,16,39
36,8476483,Rickard Rakell,R,PIT,31,69,20,19,39
36,8482110,Dawson Mercer,C,NJD,23,71,17,22,39
36,8478233,Andrew Mangiapane,L,WSH,28,64,13,26,39
36,8475193,Tomas Tatar,L,NJD,34,74,13,26,39
36,8478466,Daniel Sprong,R,VAN,27,69,11,28,39
36,8475753,Justin Faulk,D,STL,32,64,11,28,39
36,8476854,Hampus Lindholm,D,BOS,30,74,10,29,39
36,8477447,Shea Theodore,D,VGK,29,52,9,30,39
36,8482133,Thomas Bordeleau,C,SJS,22,66,9,30,39
36,8480145,Neal Pionk,D,WPG,29,69,9,30,39
36,8477426,Nicholas Paul,L,TBL,29,82,21,17,38
36,8475151,Kyle Palmieri,C,NYI,33,73,20,18,38
36,8478474,Lawson Crouse,L,UTA,27,72,19,19,38
36,8482092,Ridly Greig,C,OTT,22,77,17,21,38
36,8480028,Morgan Frost,C,PHI,25,74,14,24,38
36,8475200,Dmitry Orlov,D,CAR,33,75,14,24,38
36,8477998,Warren Foegele,L,LAK,28,79,13,25,38
36,8477987,Ryan Donato,C,CHI,28,66,13,25,38
36,8482667,William Eklund,L,SJS,22,67,12,26,38
36,8476885,Jacob Trouba,D,NYR,30,76,8,30,38
36,8482122,Brock Faber,D,MIN,22,78,4,34,38
36,8478115,Pierre Engvall,L,NYI,28,73,21,16,37
36,8476461,Sean Couturier,C,PHI,32,69,17,20,37
36,8480078,Filip Chytil,C,NYR,25,68,17,20,37
36,8480113,Alex Iafallo,L,WPG,31,69,17,20,37
36,8484203,Bradly Nadeau,L,CAR,19,62,17,20,37
36,8479365,Trent Frederic,C,BOS,26,77,16,21,37
36,8477932,Aaron Ekblad,D,FLA,28,75,15,22,37
36,8477952,Robby Fabbri,C,ANA,28,67,15,22,37
36,8480220,Noah Cates,L,PHI,25,70,14,23,37
36,8482705,Cole Sillinger,C,CBJ,21,64,13,24,37
36,8479400,Pierre-Luc Dubois,L,WSH,26,73,12,25,37
36,8482624,Daniil Miromanov,D,CGY,27,61,12,25,37
36,8475218,Mattias Ekholm,D,EDM,34,75,10,27,37
36,8478396,Noah Hanifin,D,VGK,27,58,9,28,37
36,8479987,Morgan Geekie,C,BOS,26,79,17,19,36
36,8476419,Jean-Gabriel Pageau,C,NYI,32,76,17,19,36
36,8481523,Kirby Dach,C,MTL,23,69,13,23,36
36,8484153,Leo Carlsson,C,ANA,20,68,12,24,36
36,8477953,Kasperi Kapanen,R,STL,28,66,12,24,36
36,8482720,Matthew Knies,L,TOR,22,76,10,26,36
36,8477498,Darnell Nurse,D,EDM,29,73,7,29,36
36,8480434,Sean Durzi,D,UTA,26,68,4,32,36
36,8481560,Arthur Kaliyev,R,LAK,23,81,18,17,35
36,8479353,Brett Howden,C,VGK,26,73,17,18,35
36,8480813,Joe Veleno,C,DET,24,82,16,19,35
36,8475791,Taylor Hall,L,CHI,33,54,15,20,35
36,8483505,Matthew Poitras,C,BOS,20,75,14,21,35
36,8481577,Philip Tomasino,C,NSH,23,69,12,23,35
36,8479992,Michael Rasmussen,C,DET,25,78,12,23,35
36,8482105,Jake Sanderson,D,OTT,22,77,8,27,35
36,8478397,Rasmus Andersson,D,CGY,28,72,8,27,35
36,8474565,Alex Pietrangelo,D,VGK,34,63,5,30,35
36,8482113,Anton Lundell,C,FLA,23,72,15,19,34
36,8481524,Bowen Byram,D,BUF,23,73,14,20,34
36,8476422,Mike Reilly,D,NYI,31,75,14,20,34
36,8478057,Dakota Joshua,C,VAN,28,64,14,20,34
36,8475287,Erik Haula,L,NJD,33,69,12,22,34
36,8479591,Michael Eyssimont,C,TBL,28,80,11,23,34
36,8479345,Jakob Chychrun,D,WSH,26,67,9,25,34
36,8476927,Teddy Blueger,C,VAN,30,67,8,26,34
36,8478133,Jake Evans,C,MTL,28,70,8,26,34
36,8476979,Erik Gustafsson,D,DET,32,71,7,27,34
36,8478413,Jordan Greenway,L,BUF,27,66,7,27,34
36,8476292,Ondrej Palat,L,NJD,33,68,6,28,34
36,8475764,Cam Fowler,D,ANA,33,74,2,32,34
36,8481604,Pavel Dorofeyev,L,VGK,24,71,18,15,33
36,8481186,Logan O'Connor,R,COL,28,77,18,15,33
36,8480835,Jack Drury,C,CAR,24,62,18,15,33
36,8475760,Nick Bjugstad,C,UTA,32,74,17,16,33
36,8479315,Joey Anderson,R,CHI,26,56,15,18,33
36,8480068,Ryan Poehling,C,PHI,25,63,14,19,33
36,8480802,Ryan McLeod,C,BUF,25,67,14,19,33
36,8476856,Mathew Dumba,D,DAL,30,69,11,22,33
36,8475793,Ryan Johansen,C,PHI,32,70,8,25,33
36,8476921,Jordan Martinook,L,CAR,32,65,8,25,33
36,8480817,K'Andre Miller,D,NYR,24,70,6,27,33
36,8478500,Ivan Provorov,D,CBJ,27,80,2,31,33
36,8483808,Andrei Kuzmenko,L,CGY,28,82,17,15,32
36,8480789,Oliver Wahlstrom,R,NYI,24,70,14,18,32
36,8481618,Alex Newhook,C,MTL,23,75,11,21,32
36,8476331,Dylan DeMelo,D,WPG,31,69,5,27,32
36,8478469,Thomas Chabot,D,OTT,27,75,4,28,32
36,8477506,Ryan Pulock,D,NYI,30,80,4,28,32
36,8481542,Moritz Seider,D,DET,23,79,3,29,32
36,8480893,Kirill Marchenko,R,CBJ,24,65,19,12,31
36,8482125,Alexander Holtz,R,VGK,22,77,19,12,31
36,8473422,Nick Foligno,L,CHI,37,61,15,16,31
36,8479996,Cody Glass,C,NSH,25,62,15,16,31
36,8475220,Marcus Foligno,L,MIN,33,60,14,17,31
36,8480185,Eetu Luostarinen,C,FLA,26,76,13,18,31
36,8479351,Sam Steel,C,DAL,26,79,12,19,31
36,8478472,Mathieu Joseph,R,STL,27,72,11,20,31
36,8477839,Conor Sheary,L,TBL,32,80,9,22,31
36,8479619,Michael Carcone,L,UTA,28,69,20,10,30
36,8481554,Kaapo Kakko,R,NYR,23,65,16,14,30
36,8477425,Miles Wood,L,COL,29,78,16,14,30
36,8476918,Jimmy Vesey,L,NYR,31,66,16,14,30
36,8478891,Mason Appleton,C,WPG,28,67,15,15,30
36,8479661,Tanner Jeannot,L,LAK,27,77,12,18,30
36,8475763,Kevin Hayes,R,PIT,32,66,11,19,30
36,8477948,Travis Sanheim,D,PHI,28,67,10,20,30
36,8482660,Kent Johnson,C,CBJ,22,63,10,20,30
36,8480871,Adam Boqvist,D,FLA,24,66,10,20,30
36,8481546,Cam York,D,PHI,23,63,9,21,30
36,8476872,Scott Laughton,C,PHI,30,65,8,22,30
36,8477021,Alex Kerfoot,C,UTA,30,77,7,23,30
36,8476892,Colton Parayko,D,STL,31,74,7,23,30
36,8476463,Jonas Brodin,D,MIN,31,74,5,25,30
36,8477969,Marcus Pettersson,D,PIT,28,76,2,28,30
36,8481535,Nils Hoglander,L,VAN,24,61,20,9,29
36,8482175,JJ Peterka,R,BUF,22,61,19,10,29
36,8474715,Cameron Atkinson,R,TBL,35,81,17,12,29
36,8482737,Zack Bolduc,C,STL,21,59,14,15,29
36,8481441,Joe Snively,C,DET,28,62,13,16,29
36,8481656,Aliaksei Protas,C,WSH,23,66,12,17,29
36,8474716,Jared Spurgeon,D,MIN,35,79,11,18,29
36,8481093,Rafael Harvey-Pinard,L,MTL,25,59,10,19,29
36,8476458,Ryan Strome,C,ANA,31,67,9,20,29
36,8479316,Luke Kunin,C,SJS,27,63,9,20,29
36,8477488,Brett Pesce,D,NJD,30,71,6,23,29
36,8476931,Jake McCabe,D,TOR,31,70,4,25,29
36,8478055,Gustav Forsling,D,FLA,28,70,3,26,29
36,8481582,Nicholas Robertson,L,TOR,23,65,18,10,28
36,8482079,Marco Rossi,C,MIN,23,61,17,11,28
36,8477353,Tyler Motte,C,DET,29,77,13,15,28
36,8480205,Emil Bemstrom,C,PIT,25,61,13,15,28
36,8478109,Victor Olofsson,L,VGK,29,70,13,15,28
36,8481580,Connor McMichael,C,WSH,23,57,11,17,28
36,8474574,Tyler Myers,D,VAN,34,70,8,20,28
36,8473507,Jeff Petry,D,DET,37,71,5,23,28
36,8476917,Adam Pelech,D,NYI,30,73,4,24,28
36,8478507,John Marino,D,UTA,27,66,4,24,28
36,8480043,Timothy Liljegren,D,TOR,25,65,1,27,28
36,8474189,Lars Eller,C,PIT,35,64,15,12,27
36,8476474,Stefan Noesen,R,NJD,31,68,13,14,27
36,8482749,Joshua Roy,R,MTL,21,63,12,15,27
36,8473563,Nicklas Backstrom,C,WSH,37,53,11,16,27
36,8482111,Justin Barron,D,MTL,23,66,9,18,27
36,8476925,Colton Sissons,C,NSH,31,65,5,22,27
36,8476480,Vladislav Namestnikov,C,WPG,32,56,3,24,27
36,8478020,Michael Amadio,R,OTT,28,65,17,9,26
36,8483499,Liam Ohgren,L,MIN,20,55,14,12,26
36,8477478,William Carrier,L,CAR,30,61,13,13,26
36,8477989,Christian Dvorak,C,MTL,28,68,12,14,26
36,8482101,Danil Gushchin,L,SJS,22,55,11,15,26
36,8473533,Jordan Staal,C,CAR,36,56,11,15,26
36,8479293,Brandon Tanev,L,SEA,33,58,10,16,26
36,8477919,Frederick Gaudreau,C,MIN,31,61,9,17,26
36,8479639,Dylan Coghlan,D,WPG,26,61,8,18,26
36,8481703,Valtteri Puustinen,R,PIT,25,59,7,19,26
36,8478013,Jake Walman,D,SJS,28,67,7,19,26
36,8478911,Matt Roy,D,WSH,29,62,7,19,26
36,8476869,Brady Skjei,D,NSH,30,65,5,21,26
36,8481014,Alexander Romanov,D,NYI,24,76,5,21,26
36,8475790,Erik Gudbranson,D,CBJ,32,78,4,22,26
36,8481606,Jordan Spence,D,LAK,23,65,4,22,26
36,8481032,Paul Cotter,C,NJD,25,61,18,7,25
36,8482062,Cole Smith,L,NSH,29,65,16,9,25
36,8482762,Simon Edvinsson,D,DET,21,58,16,9,25
36,8478432,Christian Fischer,R,DET,27,70,15,10,25
36,8479393,Noah Gregor,L,OTT,26,71,14,11,25
36,8480829,Jesperi Kotkaniemi,C,CAR,24,68,13,12,25
36,8483524,Shane Wright,C,SEA,20,71,13,12,25
36,8477947,Sonny Milano,L,WSH,28,59,12,13,25
36,8470621,Corey Perry,R,EDM,39,68,11,14,25
36,8480798,Philipp Kurashev,C,CHI,25,56,10,15,25
36,8477392,Hudson Fasching,R,NYI,29,67,10,15,25
36,8483445,Cutter Gauthier,L,ANA,20,65,8,17,25
36,8480144,David Kampf,C,TOR,29,64,6,19,25
36,8478178,Darren Raddysh,D,TBL,28,73,4,21,25
36,8475181,Nick Leddy,D,STL,33,73,3,22,25
36,8479398,Samuel Girard,D,COL,26,66,3,22,25
36,8480748,Kiefer Sherwood,L,VAN,29,53,12,12,24
36,8477406,Mattias Janmark,C,EDM,32,61,12,12,24
36,8480003,Jesper Boqvist,C,FLA,26,71,11,13,24
36,8475149,Marcus Johansson,L,MIN,34,65,10,14,24
36,8480074,Alexandre Texier,C,STL,25,56,9,15,24
36,8478970,Jalen Chatfield,D,CAR,28,72,8,16,24
36,8482067,Connor Mackey,D,NYR,28,61,7,17,24
36,8480336,Sean Walker,D,CAR,30,74,3,21,24
36,8477505,Alexander Wennberg,C,SJS,30,57,14,9,23
36,8480995,Pontus Holmberg,R,TOR,25,65,12,11,23
36,8479414,Nathan Bastian,R,NJD,27,66,11,12,23
36,8477508,Curtis Lazar,C,NJD,29,60,9,14,23
36,8482803,Olen Zellweger,D,ANA,21,75,8,15,23
36,8480762,Eric Robinson,L,CAR,29,52,7,16,23
36,8475171,Oliver Ekman-Larsson,D,TOR,33,62,6,17,23
36,8482809,Jackson Blake,R,CAR,21,55,6,17,23
36,8480873,Rasmus Sandin,D,WSH,24,71,3,20,23
36,8476891,Matthew Grzelcyk,D,PIT,30,77,0,23,23
36,8480281,Alexey Toropchenko,R,STL,25,51,19,3,22
36,8480448,Parker Kelly,L,COL,25,70,16,6,22
36,8479390,Taylor Raddysh,R,WSH,26,66,11,11,22
36,8479941,Justin Danforth,R,CBJ,31,54,10,12,22
36,8476878,Zemgus Girgensons,C,TBL,30,81,10,12,22
36,8480289,Morgan Barron,C,WPG,26,53,10,12,22
36,8481477,Nico Sturm,C,SJS,29,57,10,12,22
36,8479328,Julien Gauthier,R,NYI,27,60,10,12,22
36,8476889,Radek Faksa,C,STL,30,57,10,12,22
36,8475231,Casey Cizikas,C,NYI,33,72,6,16,22
36,8482073,Braden Schneider,D,NYR,23,71,5,17,22
36,8479976,Juuso Valimaki,D,UTA,26,67,3,19,22
36,8480035,Henri Jokiharju,D,BUF,25,60,3,19,22
36,8482245,Artem Zub,D,OTT,29,66,2,20,22
36,8482117,Lukas Reichel,L,CHI,22,55,14,7,21
36,8483468,Jiri Kulich,C,BUF,20,60,12,9,21
36,8481481,Blake Lizotte,C,PIT,27,58,11,10,21
36,8480855,Jack McBain,C,UTA,24,66,10,11,21
36,8482146,Luke Evangelista,R,NSH,22,69,9,12,21
36,8476374,Sean Kuraly,C,CBJ,31,53,9,12,21
36,8477450,Jason Dickinson,C,CHI,29,55,8,13,21
36,8481704,Juuso Parssinen,C,NSH,23,57,7,14,21
36,8477979,Nicolas Aube-Kubel,R,BUF,28,62,7,14,21
36,8476902,Esa Lindell,D,DAL,30,78,5,16,21
36,8476467,Jamie Oleksiak,D,SEA,32,69,4,17,21
36,8480796,Martin Fehervary,D,WSH,25,58,3,18,21
36,8474673,TJ Brodie,D,CHI,34,62,3,18,21
36,8476988,Matt Benning,D,SJS,30,66,3,18,21
36,8475462,Radko Gudas,D,ANA,34,66,2,19,21
36,8476329,Travis Boyd,C,MIN,31,58,2,19,21
36,8480049,Dylan Samberg,D,WPG,25,65,0,21,21
36,8478840,Will Borgen,D,SEA,28,64,0,21,21
36,8477446,Michael McCarron,R,NSH,29,59,13,7,20
36,8482679,Matt Coronato,R,CGY,22,62,13,7,20
36,8481028,Martin Pospisil,C,CGY,25,56,11,9,20
36,8480073,Erik Brannstrom,D,COL,25,63,9,11,20
36,8475343,Nic Dowd,C,WSH,34,64,9,11,20
36,8482142,Jamie Drysdale,D,PHI,22,62,8,12,20
36,8481553,Bobby Brink,R,PHI,23,64,7,13,20
36,8483565,Nick Blankenburg,D,NSH,26,62,7,13,20
36,8476312,Josh Manson,D,COL,33,53,6,14,20
36,8483490,Pavel Mintyukov,D,ANA,21,73,5,15,20
36,8474151,Ryan McDonagh,D,TBL,35,75,4,16,20
36,8479983,Mario Ferraro,D,SJS,26,69,3,17,20
36,8480727,Zach Whitecloud,D,VGK,28,55,3,17,20
36,8477507,Nikita Zadorov,D,BOS,29,66,1,19,20
36,8477435,Ryan Graves,D,PIT,29,75,0,20,20
36,8480980,Connor Dewar,C,TOR,25,69,11,8,19
36,8476624,Barclay Goodrow,C,SJS,31,57,10,9,19
36,8479368,Max Jones,L,BOS,26,62,9,10,19
36,8475842,Sam Carrick,C,NYR,32,58,7,12,19
36,8478136,Jake Middleton,D,MIN,28,75,7,12,19
36,8483457,Lane Hutson,D,MTL,20,66,6,13,19
36,8478434,Keegan Kolesar,R,VGK,27,56,5,14,19
36,8480157,Calle Rosen,D,COL,30,55,4,15,19
36,8481019,David Gustafsson,C,WPG,24,51,3,16,19
36,8479371,Dante Fabbro,D,NSH,26,65,3,16,19
36,8480878,Nils Lundkvist,D,DAL,24,70,2,17,19
36,8478416,Erik Cernak,D,TBL,27,74,1,18,19
36,8478851,Alexandre Carrier,D,NSH,28,64,0,19,19
36,8476469,Joel Armia,R,MTL,31,63,12,6,18
36,8477015,Connor Brown,R,EDM,30,62,9,9,18
36,8476934,Brock McGinn,L,ANA,30,56,9,9,18
36,8477938,Haydn Fleury,D,WPG,28,51,9,9,18
36,8482964,Arber Xhekaj,D,MTL,23,45,8,10,18
36,8476822,Luke Glendening,C,TBL,35,80,7,11,18
36,8483491,Ivan Miroshnichenko,L,WSH,20,54,7,11,18
36,8479026,Philippe Myers,D,TOR,27,46,7,11,18
36,8476897,Oskar Sundqvist,C,STL,30,63,6,12,18
36,8475279,Ben Chiarot,D,DET,33,70,6,12,18
36,8482655,Janis Moser,D,TBL,24,76,4,14,18
36,8476457,Adam Larsson,D,SEA,32,63,4,14,18
36,8479980,Nicolas Hague,D,VGK,26,61,4,14,18
36,8481601,Simon Holmstrom,R,NYI,23,67,11,6,17
36,8479520,Brandon Duhaime,R,WSH,27,54,10,7,17
36,8480021,Jack Studnicka,C,LAK,25,64,9,8,17
36,8479344,Jesse Puljujarvi,R,PIT,26,52,8,9,17
36,8475855,Jesper Fast,R,CAR,33,55,7,10,17
36,8483482,Tristan Luneau,D,ANA,20,55,6,11,17
36,8481522,Peyton Krebs,C,BUF,23,61,5,12,17
36,8477220,Nate Schmidt,D,FLA,33,62,5,12,17
36,8482176,Wyatt Kaiser,D,CHI,22,47,5,12,17
36,8482671,Owen Power,D,BUF,22,68,4,13,17
36,8482634,Alex Steeves,C,TOR,25,52,4,13,17
36,8479402,Jake Bean,D,CGY,26,64,3,14,17
36,8481527,Kaedan Korczak,D,VGK,23,50,3,14,17
36,8480172,Jan Rutta,D,SJS,34,70,3,14,17
36,8481059,Scott Perunovich,D,STL,26,63,3,14,17
36,8482087,Kaiden Guhle,D,MTL,22,69,2,15,17
36,8481178,Egor Zamula,D,PHI,24,57,2,15,17
36,8480860,Kevin Bahl,D,CGY,24,58,2,15,17
36,8476429,Scott Mayfield,D,NYI,32,75,2,15,17
36,8475233,David Savard,D,MTL,34,59,2,15,17
36,8478399,Jonas Siegenthaler,D,NJD,27,64,1,16,17
36,8479359,Beck Malenstyn,L,BUF,26,43,10,6,16
36,8482074,Connor Zary,C,CGY,23,61,9,7,16
36,8481716,Dmitri Voronkov,L,CBJ,24,43,9,7,16
36,8479066,Ryan Lomberg,L,CGY,30,69,8,8,16
36,8479336,Carl Grundstrom,R,SJS,27,54,8,8,16
36,8477903,Garnet Hathaway,R,PHI,33,67,7,9,16
36,8482157,Will Cuylle,L,NYR,22,58,7,9,16
36,8483493,Frank Nazar,C,CHI,20,60,7,9,16
36,8476873,Mark Jankowski,C,NSH,30,45,6,10,16
36,8481161,Jake Christiansen,D,CBJ,25,57,6,10,16
36,8477018,Ben Hutton,D,VGK,31,51,5,11,16
36,8474013,Ian Cole,D,UTA,35,53,4,12,16
36,8478452,Caleb Jones,D,LAK,27,63,4,12,16
36,8478882,Vladislav Gavrikov,D,LAK,29,64,3,13,16
36,8477499,Rasmus Ristolainen,D,PHI,30,59,3,13,16
36,8481708,Zac Jones,D,NYR,24,41,3,13,16
36,8477845,Trevor van Riemsdyk,D,WSH,33,63,3,13,16
36,8480891,Michael Kesselring,D,UTA,24,54,2,14,16
36,8480246,Nick Perbix,D,TBL,26,71,2,14,16
36,8480001,Urho Vaakanainen,D,ANA,25,58,1,15,16
36,8480441,Trey Fix-Wolansky,R,CBJ,25,42,7,8,15
36,8481517,Brett Leason,R,ANA,25,57,7,8,15
36,8478451,Ethan Bear,D,WSH,27,47,6,9,15
36,8476994,Vinnie Hinostroza,C,NSH,30,49,5,10,15
36,8481521,Ronnie Attard,D,PHI,25,58,5,10,15
36,8477369,Carson Soucy,D,VAN,30,70,4,11,15
36,8482730,Brandt Clarke,D,LAK,21,52,4,11,15
36,8470600,Ryan Suter,D,STL,39,57,3,12,15
36,8481537,Nikita Okhotiuk,D,CGY,24,55,3,12,15
36,8481568,Alex Vlasic,D,CHI,23,60,3,12,15
36,8482451,Mikael Pyyhtia,L,CBJ,23,44,2,13,15
36,8476278,Colin Blackwell,C,DAL,31,75,10,4,14
36,8482155,Alex Laferriere,R,LAK,23,64,10,4,14
36,8476960,Andreas Athanasiou,C,CHI,30,53,7,7,14
36,8478043,Sam Lafferty,C,BUF,29,61,7,7,14
36,8478508,Yakov Trenin,C,MIN,27,59,6,8,14
36,8479370,Tyson Jost,C,CAR,26,45,6,8,14
36,8479671,Mathieu Olivier,R,CBJ,27,39,6,8,14
36,8475179,Dmitry Kulikov,D,FLA,34,60,5,9,14
36,8482744,James Malatesta,L,CBJ,21,49,5,9,14
36,8476879,Cody Ceci,D,EDM,31,71,4,10,14
36,8482859,Zack Ostapchuk,C,OTT,21,58,4,10,14
36,8479543,Michael Pezzetta,L,MTL,26,47,3,11,14
36,8475762,Derek Forbort,D,VAN,32,46,3,11,14
36,8474567,Zach Bogosian,D,MIN,34,60,3,11,14
36,8479369,Andrew Peeke,D,BOS,26,65,3,11,14
36,8476525,Colin Miller,D,WPG,32,66,2,12,14
36,8477034,Jaycob Megna,D,FLA,32,42,2,12,14
36,8479982,Conor Timmins,D,TOR,26,58,1,13,14
36,8477365,Connor Clifton,D,BUF,29,51,1,13,14
36,8480222,Sebastian Aho,D,PIT,28,73,0,14,14
36,8478569,Noel Acciari,C,PIT,33,56,9,4,13
36,8480192,Johnathan Kovacevic,D,NJD,27,46,7,6,13
36,8475718,Justin Holl,D,DET,32,62,4,9,13
36,8484911,Collin Graf,R,SJS,22,44,4,9,13
36,8478421,A.J. Greer,L,FLA,28,53,3,10,13
36,8471677,Jack Johnson,D,CBJ,37,61,3,10,13
36,8471709,Marc-Edouard Vlasic,D,SJS,37,61,2,11,13
36,8474612,Travis Hamonic,D,OTT,34,47,2,11,13
36,8478859,Niko Mikkola,D,FLA,28,64,0,13,13
36,8484149,Gavin Brindley,C,CBJ,20,42,10,2,12
36,8481617,Vasily Podkolzin,R,VAN,23,44,8,4,12
36,8478831,Kevin Stenlund,C,UTA,28,57,8,4,12
36,8480011,Klim Kostin,C,SJS,25,46,6,6,12
36,8482807,Ethan Del Mastro,D,CHI,21,47,6,6,12
36,8481641,Joel Kiviranta,L,COL,28,77,6,6,12
36,8480806,Isac Lundestrom,C,ANA,25,61,5,7,12
36,8482145,Mavrik Bourque,C,DAL,22,52,5,7,12
36,8477962,Brendan Lemieux,L,CAR,28,42,5,7,12
36,8478585,Derek Ryan,C,EDM,38,65,5,7,12
36,8473453,Trevor Lewis,C,LAK,37,72,4,8,12
36,8480950,Ilya Lyubushkin,D,DAL,30,56,4,8,12
36,8481567,Henry Thrun,D,SJS,23,52,4,8,12
36,8474090,Brendan Smith,D,DAL,35,61,4,8,12
36,8480834,Ty Emberson,D,SJS,24,34,4,8,12
36,8481599,Victor Soderstrom,D,UTA,23,42,3,9,12
36,8479442,Troy Stecher,D,EDM,30,54,3,9,12
36,8475188,Brayden McNabb,D,VGK,33,55,2,10,12
36,8474034,Patrick Maroon,L,CHI,36,46,2,10,12
36,8473446,Erik Johnson,D,PHI,36,48,2,10,12
36,8480807,Mattias Samuelsson,D,BUF,24,54,1,11,12
36,8475690,Chris Tanev,D,TOR,35,59,1,11,12
36,8481167,Brayden Pachal,D,CGY,25,44,1,11,12
36,8475225,Craig Smith,C,CHI,35,45,7,4,11
36,8477380,Jonny Brodzinski,C,NYR,31,49,7,4,11
36,8478211,Dryden Hunt,L,CGY,29,55,6,5,11
36,8479718,Alex Barré-Boulet,C,MTL,27,49,6,5,11
36,8482259,Bobby McMann,C,TOR,28,67,5,6,11
36,8482077,Dylan Holloway,L,EDM,23,51,3,8,11
36,8479291,Kevin Rooney,C,CGY,31,47,3,8,11
36,8480007,Jonas Rondbjerg,R,VGK,25,40,3,8,11
36,8481013,Jonatan Berggren,R,DET,24,56,3,8,11
36,8480887,Jordan Harris,D,MTL,24,62,3,8,11
36,8481624,Ilya Mikheyev,R,CHI,30,59,2,9,11
36,8479372,Joshua Mahura,D,SEA,26,51,2,9,11
36,8474166,Alec Martinez,D,CHI,37,53,1,10,11
36,8479324,Ryan Lindgren,D,NYR,26,60,1,10,11
36,8479249,Andrew Poturalski,C,SJS,30,31,1,10,11
36,8475208,Brian Dumoulin,D,ANA,33,59,0,11,11
36,8480058,Pierre-Olivier Joseph,D,STL,25,57,0,11,11
36,8480025,MacKenzie Entwistle,R,FLA,25,65,8,2,10
36,8482166,Shakir Mukhamadullin,D,SJS,22,51,6,4,10
36,8483495,Simon Nemec,D,NJD,20,57,6,4,10
36,8480355,Mark Kastelic,C,BOS,25,50,5,5,10
36,8479968,Vinni Lettieri,C,BOS,29,42,5,5,10
36,8480292,Carson Meyer,R,ANA,27,39,4,6,10
36,8476952,Dominic Toninato,C,WPG,30,33,4,6,10
36,8475235,Nicolas Deslauriers,L,PHI,33,57,4,6,10
36,8481701,Santeri Hatakka,D,NJD,23,35,3,7,10
36,8475177,Calvin de Haan,D,COL,33,38,3,7,10
36,8481598,Philip Broberg,D,EDM,23,43,3,7,10
36,8483630,Pavol Regenda,L,ANA,25,28,3,7,10
36,8476967,Brett Kulak,D,EDM,30,54,2,8,10
36,8475324,Nick Jensen,D,OTT,34,65,0,10,10
36,8475455,Brenden Dillon,D,NJD,34,55,0,10,10
36,8483549,Lucas Condotta,L,MTL,27,32,6,3,9
36,8477931,Tomas Nosek,L,FLA,32,50,5,4,9
36,8476442,Matt Nieto,L,PIT,32,47,4,5,9
36,8482659,Josh Doan,R,UTA,22,46,4,5,9
36,8480845,Rasmus Kupari,C,WPG,24,37,4,5,9
36,8477335,Kyle Burroughs,D,LAK,29,44,4,5,9
36,8483012,Logan Morrison,C,SEA,22,37,4,5,9
36,8483619,Filip Roos,D,OTT,25,41,4,5,9
36,8482095,Tyler Kleven,D,OTT,22,53,3,6,9
36,8477573,Nathan Walker,L,STL,30,52,3,6,9
36,8479981,Jonah Gadjovich,L,FLA,26,45,3,6,9
36,8482784,Zach Dean,C,STL,21,45,3,6,9
36,8481609,Vladislav Kolyachonok,D,UTA,23,44,3,6,9
36,8479348,Kale Clague,D,BUF,26,40,3,6,9
36,8480252,Cole Guttman,C,CHI,25,44,2,7,9
36,8476874,Olli Maatta,D,DET,30,61,2,7,9
36,8482148,Hendrix Lapierre,C,WSH,22,54,2,7,9
36,8478146,Matthew Highmore,C,OTT,28,39,2,7,9
36,8481122,Simon Benoit,D,TOR,26,38,2,7,9
36,8476858,Phillip Di Giuseppe,L,VAN,31,44,6,2,8
36,8479638,Justin Brazeau,R,BOS,26,39,6,2,8
36,8477473,Justin Bailey,R,SJS,29,22,6,2,8
36,8482192,Isaak Phillips,D,CHI,23,53,4,4,8
36,8477401,John Hayden,C,SEA,29,39,4,4,8
36,8481592,Jakob Pelletier,L,CGY,23,34,4,4,8
36,8480070,Ian Mitchell,D,BOS,25,47,3,5,8
36,8479986,Kole Lind,R,DAL,26,46,3,5,8
36,8481556,John Beecher,C,BOS,23,43,3,5,8
36,8476372,Nick Seeler,D,PHI,31,45,3,5,8
36,8479998,Mikey Anderson,D,LAK,25,60,2,6,8
36,8479972,Mason Shaw,C,WPG,26,32,2,6,8
36,8479944,Zach Aston-Reese,C,VGK,30,48,2,6,8
36,8482496,Nils Aman,C,VAN,24,48,2,6,8
36,8482733,Logan Mailloux,D,MTL,31,33,2,6,8
36,8476473,Connor Murphy,D,CHI,31,39,1,7,8
36,8481056,Spencer Stastney,D,NSH,24,31,1,7,8
36,8478443,Brandon Carlo,D,BOS,28,62,0,8,8
36,8481679,Maxence Guenette,D,OTT,23,32,5,2,7
36,8481789,Tye Kartye,L,SEA,23,35,4,3,7
36,8483471,Brad Lambert,C,WPG,31,17,4,3,7
36,8481518,Nolan Foote,L,NJD,24,30,3,4,7
36,8484258,Sam Malinski,D,COL,26,32,3,4,7
36,8481237,Kyle MacLean,C,NYI,25,28,3,4,7
36,8482666,Scott Morrow,D,CAR,22,44,2,5,7
36,8482141,Lukas Cormier,D,VGK,22,25,2,5,7
36,8477384,Joshua Brown,D,EDM,30,42,2,5,7
36,8478409,Anthony Richard,C,PHI,28,32,2,5,7
36,8479991,Jake Leschyshyn,C,NYR,25,32,2,5,7
36,8481600,Tobias Bjornfot,D,FLA,23,40,2,5,7
36,8480990,Declan Chisholm,D,MIN,24,36,2,5,7
36,8481550,Adam Beckman,L,NJD,23,27,2,5,7
36,8476913,Devin Shore,C,MIN,30,32,2,5,7
36,8478468,Jeremy Lauzon,D,NSH,27,49,1,6,7
36,8474568,Luke Schenn,D,NSH,35,52,1,6,7
36,8482652,Walker Duehr,R,CGY,27,48,4,2,6
36,8477070,Liam O'Brien,C,UTA,30,50,4,2,6
36,8479378,Logan Stanley,D,WPG,26,33,4,2,6
36,8477073,Kurtis MacDermid,L,NJD,30,28,4,2,6
36,8475958,Michael Sgarbossa,C,WSH,32,28,4,2,6
36,8481147,Reese Johnson,C,MIN,26,39,3,3,6
36,8480870,Bo Groulx,C,NYR,24,44,3,3,6
36,8479379,Givani Smith,R,SJS,26,28,3,3,6
36,8481541,Samuel Bolduc,D,NYI,24,29,3,3,6
36,8482144,Jack Thompson,D,SJS,22,22,3,3,6
36,8479439,Jacob MacDonald,D,COL,31,42,2,4,6
36,8483466,Kevin Korchinski,D,CHI,20,45,2,4,6
36,8477244,Chad Ruhwedel,D,NYR,34,34,2,4,6
36,8476867,Brendan Gaunce,C,MIN,30,27,2,4,6
36,8477541,Dakota Mermis,D,TOR,30,8,2,4,6
36,8482747,Brennan Othmann,L,NYR,21,42,1,5,6
36,8480879,Jacob Bernard-Docker,D,OTT,24,34,1,5,6
36,8483460,David Jiricek,D,CBJ,21,55,1,5,6
36,8482751,Ryan Winterton,C,SEA,21,27,1,5,6
36,8482929,Emil Lilleberg,D,TBL,23,21,1,5,6
36,8480196,Jacob Bryson,D,BUF,27,45,0,6,6
36,8483512,Matthew Savoie,C,EDM,20,29,0,6,6
36,8471817,Ryan Reaves,R,TOR,37,53,5,0,5
36,8479772,Zack MacEwen,R,OTT,28,53,4,1,5
36,8482070,Mitchell Chaffee,R,TBL,26,45,4,1,5
36,8481532,Alex Turcotte,C,LAK,23,35,4,1,5
36,8480267,Sammy Walker,C,MIN,25,23,4,1,5
36,8481043,Cole Koepke,L,BOS,26,15,4,1,5
36,8480848,Ty Dellandrea,C,SJS,24,32,3,2,5
36,8479536,Axel Jonsson-Fjallby,L,WPG,26,32,3,2,5
36,8477482,Zachary Sanford,L,CHI,30,39,3,2,5
36,8479994,Jaret Anderson-Dolan,C,WPG,25,36,3,2,5
36,8478450,Parker Wotherspoon,D,BOS,27,33,2,3,5
36,8483763,Maksymilian Szuber,D,UTA,22,29,2,3,5
36,8481743,Marc Del Gaizo,D,NSH,25,32,2,3,5
36,8478051,Max Willman,C,NJD,29,20,2,3,5
36,8482118,Sam Colangelo,R,ANA,23,19,2,3,5
36,8478874,Adam Gaudette,R,OTT,28,31,1,4,5
36,8484254,Akito Hirose,D,VAN,25,33,1,4,5
36,8475750,Jon Merrill,D,MIN,32,57,1,4,5
36,8478017,Mark Friedman,D,VAN,29,44,1,4,5
36,8482201,Gage Goncalves,C,TBL,23,27,1,4,5
36,8478011,Louie Belpedio,D,PHI,28,16,1,4,5
36,8481605,Jackson LaCombe,D,ANA,23,32,0,5,5
36,8482516,Matthew Kessel,D,STL,24,20,0,5,5
36,8484287,Cole McWard,D,VAN,23,22,4,0,4
36,8483570,Ben Meyers,C,SEA,26,27,4,0,4
36,8480245,Olle Lycksell,R,PHI,25,31,3,1,4
36,8481065,Angus Crookshank,L,OTT,25,16,3,1,4
36,8478021,William Lagesson,D,DET,28,20,3,1,4
36,8480468,James Hamblin,L,EDM,25,24,3,1,4
36,8481751,Lukas Rousek,R,BUF,25,40,2,2,4
36,8478424,Jansen Harkins,C,ANA,27,42,2,2,4
36,8480844,Grigori Denisenko,L,VGK,24,34,2,2,4
36,8477887,Patrick Brown,C,BOS,32,51,2,2,4
36,8479367,William Lockwood,R,FLA,26,33,2,2,4
36,8482511,Mason Lohrei,D,BOS,23,35,1,3,4
36,8479320,Maxime Lajoie,D,SEA,27,29,1,3,4
36,8481564,Ryan Johnson,D,BUF,23,10,1,3,4
36,8482165,Yan Kuznetsov,D,CGY,22,19,1,3,4
36,8482094,Daemon Hunt,D,MIN,22,19,1,3,4
36,8481006,Tyler Tucker,D,STL,24,11,1,3,4
36,8482858,Ryker Evans,D,SEA,23,26,0,4,4
36,8477467,Gustav Olofsson,D,SEA,30,18,0,4,4
36,8479985,Cale Fleury,D,SEA,26,27,3,0,3
36,8477320,Anton Blidh,L,NYR,29,25,3,0,3
36,8481754,Nikita Nesterenko,C,ANA,23,29,2,1,3
36,8478477,Mitchell Stephens,C,SEA,27,18,2,1,3
36,8480890,Jan Jenik,C,OTT,24,19,2,1,3
36,8475413,Justin Dowling,C,NJD,34,14,2,1,3
36,8483597,Milos Kelemen,L,UTA,25,13,2,1,3
36,8481593,Jayden Struble,D,MTL,23,21,1,2,3
36,8481030,Jack St. Ivany,D,PIT,25,23,1,2,3
36,8477971,Andreas Englund,D,LAK,28,33,1,2,3
36,8482177,Marat Khusnutdinov,C,MIN,22,40,1,2,3
36,8480851,Akil Thomas,C,LAK,24,21,1,2,3
36,8482172,Landon Slaggert,L,CHI,22,25,1,2,3
36,8477527,Ross Johnston,L,ANA,30,29,1,2,3
36,8482102,Vasily Ponomarev,C,PIT,22,19,1,2,3
36,8476441,Joel Edmundson,D,LAK,31,28,0,3,3
36,8478454,Noah Juulsen,D,VAN,27,25,0,3,3
36,8482713,Mackie Samoskevich,R,FLA,22,38,0,3,3
36,8477149,Scott Sabourin,R,SJS,32,14,0,3,3
36,8480032,Shane Bowers,C,NJD,25,19,0,3,3
36,8481543,Nikita Alexandrov,C,STL,24,16,2,0,2
36,8482153,Brendan Brisson,C,VGK,23,30,2,0,2
36,8482088,Justin Sourdif,R,FLA,22,17,2,0,2
36,8483397,Marc McLaughlin,C,BOS,25,30,1,1,2
36,8480880,Jakub Lauko,C,MIN,24,27,1,1,2
36,8480084,Nick DeSimone,D,NJD,30,17,1,1,2
36,8481422,Jake Lucchini,C,NSH,29,18,1,1,2
36,8479587,Rhett Gardner,C,PHI,28,17,1,1,2
36,8481806,Louis Crevier,D,CHI,23,15,1,1,2
36,8479421,Jacob Moverare,D,LAK,26,8,1,1,2
36,8481655,Cole Schwindt,R,CGY,23,10,1,1,2
36,8478446,Glenn Gawdin,C,LAK,27,13,1,1,2
36,8478147,Bokondji Imama,L,PIT,28,5,1,1,2
36,8477851,Jordan Oesterle,D,BOS,32,33,0,2,2
36,8479419,Brett Murray,L,BUF,26,21,0,2,2
36,8482861,Vincent Iorio,D,WSH,22,27,0,2,2
36,8475755,Alexander Petrovic,D,DAL,32,9,0,2,2
36,8477462,Robert Hagg,D,VGK,29,22,0,2,2
36,8483395,Arshdeep Bains,L,VAN,23,18,0,2,2
36,8481699,Aku Raty,R,UTA,23,15,1,0,1
36,8482162,Roby Jarventie,L,EDM,22,12,1,0,1
36,8481719,Maxwell Crozier,D,TBL,24,18,1,0,1
36,8481206,John Ludvig,D,PIT,24,9,1,0,1
36,8481585,Egor Afanasyev,L,SJS,23,12,1,0,1
36,8483489,Fraser Minten,C,TOR,31,13,1,0,1
36,8482061,Brandon Biro,L,SEA,26,15,1,0,1
36,8481462,Mason Morelli,L,VGK,28,8,1,0,1
36,8483920,Pierrick Dube,R,WSH,23,1,1,0,1
36,8479576,Vincent Desharnais,D,VAN,28,36,0,1,1
36,8482470,Ilya Solovyov,D,CGY,24,21,0,1,1
36,8482147,Jean-Luc Foudy,C,COL,22,19,0,1,1
36,8482787,Nikita Chibrikov,R,WPG,31,9,0,1,1
36,8478881,Brett Seney,L,CHI,28,15,0,1,1
36,8479362,Riley Tufte,L,BOS,26,20,0,1,1
36,8481024,Linus Karlsson,C,VAN,25,11,0,1,1
36,8477810,Joel Hanley,D,CGY,33,24,0,1,1
36,8479330,Brandon Gignac,C,MTL,27,9,0,1,1
36,8475795,Dylan McIlrath,D,WSH,32,16,0,1,1
36,8484304,Uvis Balinskis,D,FLA,28,13,0,1,1
36,8478502,Dennis Gilbert,D,BUF,28,22,0,1,1
36,8483531,Brian Halonen,L,NJD,25,5,0,1,1
36,8482197,Adam Raska,R,MIN,23,4,0,1,1
36,8482765,Isak Rosen,R,BUF,21,22,0,0,0
36,8474062,Riley Nash,C,NYR,35,11,0,0,0
36,8475780,Chris Wagner,R,COL,33,7,0,0,0
36,8484325,Waltteri Merela,C,TBL,26,19,0,0,0
36,8480823,Alexander Alexeyev,D,WSH,25,11,0,0,0
36,8483546,Marshall Rifai,D,TOR,26,9,0,0,0
36,8482250,Callahan Burke,C,VGK,27,17,0,0,0
36,8480874,Adam Ginning,D,PHI,24,12,0,0,0
36,8481726,Adam Edstrom,C,NYR,24,4,0,0,0
36,8483407,Brandon Scanlin,D,NYR,25,6,0,0,0
36,8483567,Georgii Merkulov,C,BOS,24,8,0,0,0
36,8478854,Ryan Shea,D,PIT,27,8,0,0,0
36,8484255,Jason Polin,R,COL,25,7,0,0,0
36,8481578,Graeme Clarke,R,MIN,23,8,0,0,0
36,8482476,Emil Heineman,L,MTL,23,6,0,0,0
36,8480075,Cameron Crotty,D,MIN,25,14,0,0,0
36,8479522,Hardy Haman Aktell,D,WSH,26,2,0,0,0
36,8481534,Raphael Lavoie,C,EDM,24,2,0,0,0
36,8480306,Grant Hutton,D,NYI,29,5,0,0,0
36,8477993,Justin Kirkland,C,CGY,28,8,0,0,0
36,8483609,Adam Klapka,R,CGY,24,3,0,0,0
36,8483432,Luca Del Bel Belluz,C,CBJ,31,3,0,0,0
36,8476323,Max McCormick,L,SEA,32,2,0,0,0
36,8483401,Marc Johnstone,R,PIT,28,2,0,0,0
36,8482460,Matt Rempe,C,NYR,22,12,0,0,0
36,8483045,Cameron Butler,R,CBJ,31,1,0,0,0
36,8482126,Emil Andrae,D,PHI,31,5,0,0,0
36,8483398,Declan Carlile,D,TBL,31,3,0,0,0
36,8478956,Samuel Laberge,L,NJD,27,1,0,0,0
36,8480274,Philip Kemp,D,EDM,25,0,0,0,0
36,8484259,Ondrej Pavel,C,COL,31,2,0,0,0
36,8484326,Patrik Koch,D,UTA,28,1,0,0,0
36,8484321,Nikolas Matinpalo,D,OTT,26,2,0,0,0
36,8470794,Joe Pavelski,C,,40,0,0,0,0
36,8479321,Lucas Johansen,D,,27,0,0,0,0
36,8477950,Tony DeAngelo,D,,29,0,0,0,0
36,8471218,Blake Wheeler,R,,38,0,0,0,0
36,8475197,Tyson Barrie,D,,33,0,0,0,0
36,8474157,Max Pacioretty,L,,36,0,0,0,0
36,8475744,Evgeny Kuznetsov,C,,32,0,0,0,0
36,8474037,James van Riemsdyk,L,,35,0,0,0,0
36,8476907,Mackenzie MacEachern,L,,30,0,0,0,0
36,8480216,Jacob Peterson,C,,25,0,0,0,0
36,8474602,Justin Schultz,D,,34,0,0,0,0
36,8482222,Alexander Barabanov,L,,30,0,0,0,0
36,8474031,Kevin Shattenkirk,D,,35,0,0,0,0
36,8477330,Dominik Kubalik,L,,29,0,0,0,0
36,8480884,Calen Addison,D,,24,0,0,0,0
36,8475906,John Klingberg,D,,32,0,0,0,0
36,8480008,Adam Ruzicka,C,,25,0,0,0,0
36,8476884,Derrick Pouliot,D,,30,0,0,0,0
36,8476919,Chris Tierney,C,,30,0,0,0,0
36,8479415,Michael McLeod,C,,26,0,0,0,0
36,8474870,Tyler Johnson,C,,34,0,0,0,0
36,8470604,Jeff Carter,C,,39,0,0,0,0
36,8478104,Sammy Blais,L,,28,0,0,0,0
36,8474884,Mike Hoffman,C,,35,0,0,0,0
36,8481591,Sam Poulin,R,,23,0,0,0,0
36,8471274,Alex Goligoski,D,,39,0,0,0,0
36,8476871,Tanner Pearson,L,,32,0,0,0,0
36,8476393,Nick Cousins,C,,31,0,0,0,0
36,8479977,Kailer Yamamoto,R,,26,0,0,0,0
36,8479346,Dillon Dube,C,,26,0,0,0,0
36,8480184,Gustav Lindstrom,D,,26,0,0,0,0
36,8479376,Victor Mete,D,,26,0,0,0,0
36,8473449,Kyle Okposo,R,,36,0,0,0,0
36,8481058,Jesse Ylonen,R,,25,0,0,0,0
36,8475752,Tyler Pitlick,C,,33,0,0,0,0
36,8481239,Samuel Fagemo,L,,24,0,0,0,0
36,8480821,Filip Zadina,R,,25,0,0,0,0
36,8470966,Mark Giordano,D,,41,0,0,0,0
36,8478495,Denis Gurianov,R,,27,0,0,0,0
36,8477464,Nic Petan,C,,29,0,0,0,0
36,8478099,Kevin Labanc,R,,29,0,0,0,0
36,8482241,Radim Zohorna,L,,28,0,0,0,0
36,8474040,Sam Gagner,C,,35,0,0,0,0
36,8479514,Rem Pitlick,C,,27,0,0,0,0
36,8478430,Oliver Kylington,D,,27,0,0,0,0
36,8479533,Joona Koppanen,L,,26,0,0,0,0
36,8479984,Cal Foote,D,,26,0,0,0,0
36,8477126,Jayson Megna,C,,34,0,0,0,0
36,8475164,Jakob Silfverberg,R,,34,0,0,0,0
36,8474009,Nick Bonino,C,,36,0,0,0,0
36,8479458,Nikita Zaitsev,D,,33,0,0,0,0
36,8477944,Jakub Vrana,L,,28,0,0,0,0
36,8471699,Andrew Cogliano,C,,37,0,0,0,0
36,8478067,Oskar Lindblom,L,,28,0,0,0,0
36,8471686,Marc Staal,D,,37,0,0,0,0
36,8470610,Zach Parise,L,,40,0,0,0,0
36,8478904,Steven Lorentz,C,,28,0,0,0,0
36,8473473,Milan Lucic,L,,36,0,0,0,0
36,8480031,Maxime Comtois,L,,25,0,0,0,0
36,8478512,Austin Czarnik,C,,32,0,0,0,0
36,8473504,Cal Clutterbuck,R,,37,0,0,0,0
36,8477454,Adam Erne,L,,29,0,0,0,0
36,8479383,Boris Katchouk,L,,26,0,0,0,0
36,8475825,Jani Hakanpää,D,,32,0,0,0,0
36,8477846,Ryan Carpenter,C,,33,0,0,0,0
36,8477930,Pierre-Edouard Bellemare,L,,39,0,0,0,0
36,8478400,Colin White,C,,27,0,0,0,0
36,8480226,Marián Studenic,R,,26,0,0,0,0
36,8480853,Liam Foudy,C,,24,0,0,0,0
36,8475797,Jarred Tinordi,D,,32,0,0,0,0
36,8479423,Alex Nylander,L,,26,0,0,0,0
36,8474618,Marco Scandella,D,,34,0,0,0,0
36,8478028,Fredrik Olofsson,L,,28,0,0,0,0
36,8474709,Matt Martin,L,,35,0,0,0,0
36,8481070,Hugh McGing,L,,26,0,0,0,0
36,8479546,Oskar Steen,C,,26,0,0,0,0
36,8474145,Robert Bortuzzo,D,,35,0,0,0,0
36,8476915,Jujhar Khaira,L,,30,0,0,0,0
36,8475278,Byron Froese,C,,33,0,0,0,0
36,8481812,Nikolai Knyzhov,D,,27,0,0,0,0
36,8478408,Travis Dermott,D,,28,0,0,0,0
36,8481077,John Leonard,L,,26,0,0,0,0
36,8479547,Matthew Phillips,R,,26,0,0,0,0
36,8480836,Jonathan Gruden,C,,24,0,0,0,0
36,8481690,Tyler Angle,C,,24,0,0,0,0
36,8475766,Austin Watson,L,,32,0,0,0,0
36,8481016,Ruslan Iskhakov,C,,24,0,0,0,0
36,8478078,Rourke Chartier,C,,28,0,0,0,0
36,8480776,Sheldon Rempal,R,,29,0,0,0,0
36,8484314,Jiri Smejkal,L,,28,0,0,0,0
37,8479314,Matthew Tkachuk,L,FLA,27,79,42,100,142
37,8477492,Nathan MacKinnon,C,COL,29,82,50,88,138
37,8476453,Nikita Kucherov,R,TBL,31,82,39,94,133
37,8477956,David Pastrnak,R,BOS,28,82,59,72,131
37,8478402,Connor McDavid,C,EDM,27,79,46,77,123
37,8479318,Auston Matthews,C,TOR,27,77,61,61,122
37,8477934,Leon Draisaitl,C,EDM,29,78,37,79,116
37,8482116,Tim Stützle,C,OTT,22,78,46,69,115
37,8478420,Mikko Rantanen,R,COL,28,82,48,63,111
37,8481559,Jack Hughes,C,NJD,23,80,43,66,109
37,8476468,J.T. Miller,C,VAN,31,77,28,78,106
37,8477939,William Nylander,R,TOR,28,82,43,59,102
37,8478550,Artemi Panarin,L,NYR,33,76,37,63,100
37,8479407,Jesper Bratt,L,NJD,26,78,34,61,95
37,8478483,Mitch Marner,R,TOR,27,80,33,62,95
37,8476887,Filip Forsberg,L,NSH,30,77,48,45,93
37,8480027,Jason Robertson,L,DAL,25,81,29,64,93
37,8478864,Kirill Kaprizov,L,MIN,27,73,46,46,92
37,8473419,Brad Marchand,L,BOS,36,80,31,61,92
37,8477942,Kevin Fiala,L,LAK,28,81,35,56,91
37,8479420,Tage Thompson,C,BUF,27,79,46,44,90
37,8478439,Travis Konecny,R,PHI,27,79,32,57,89
37,8475166,John Tavares,C,TOR,34,78,31,58,89
37,8475172,Nazem Kadri,C,CGY,34,80,40,48,88
37,8481557,Matt Boldy,L,MIN,23,72,35,52,87
37,8480012,Elias Pettersson,C,VAN,26,74,34,52,86
37,8477404,Jake Guentzel,C,TBL,30,80,40,45,85
37,8471675,Sidney Crosby,C,PIT,37,73,37,48,85
37,8475810,Bryan Rust,R,PIT,32,76,41,43,84
37,8478010,Brayden Point,C,TBL,28,82,39,45,84
37,8477493,Aleksander Barkov,C,FLA,29,75,28,56,84
37,8479343,Clayton Keller,R,UTA,26,79,42,41,83
37,8477946,Dylan Larkin,C,DET,28,82,41,42,83
37,8480002,Nico Hischier,C,NJD,25,78,36,47,83
37,8480801,Brady Tkachuk,L,OTT,25,80,30,53,83
37,8473512,Claude Giroux,R,OTT,36,78,24,59,83
37,8477501,Valeri Nichushkin,R,COL,29,81,38,43,81
37,8480036,Miro Heiskanen,D,DAL,25,76,17,64,81
37,8471214,Alex Ovechkin,L,WSH,39,78,39,41,80
37,8474564,Steven Stamkos,C,NSH,34,73,35,45,80
37,8478427,Sebastian Aho,C,CAR,27,74,27,53,80
37,8480069,Cale Makar,D,COL,26,70,25,55,80
37,8480023,Robert Thomas,C,STL,25,73,25,55,80
37,8476456,Jonathan Huberdeau,C,CGY,31,79,23,57,80
37,8471685,Anze Kopitar,C,LAK,37,80,19,60,79
37,8477933,Sam Reinhart,C,FLA,29,77,40,38,78
37,8478449,Roope Hintz,C,DAL,28,82,36,42,78
37,8476459,Mika Zibanejad,C,NYR,31,78,25,53,78
37,8477951,Nick Schmaltz,C,UTA,28,74,23,55,78
37,8480800,Quinn Hughes,D,VAN,25,72,11,67,78
37,8478445,Mathew Barzal,C,NYI,27,81,18,59,77
37,8482740,Wyatt Johnston,C,DAL,21,81,39,37,76
37,8476460,Mark Scheifele,C,WPG,31,72,31,45,76
37,8478398,Kyle Connor,L,WPG,28,72,30,46,76
37,8476346,Johnny Gaudreau,L,CBJ,31,76,22,53,75
37,8474600,Roman Josi,D,NSH,34,78,19,56,75
37,8475184,Chris Kreider,L,NYR,33,74,38,36,74
37,8471215,Evgeni Malkin,C,PIT,38,75,29,45,74
37,8477960,Adrian Kempe,R,LAK,28,82,28,46,74
37,8478440,Dylan Strome,C,WSH,27,72,27,47,74
37,8480865,Noah Dobson,D,NYI,24,82,19,55,74
37,8475786,Zach Hyman,L,EDM,32,79,45,28,73
37,8479385,Jordan Kyrou,C,STL,26,77,35,38,73
37,8473994,Jamie Benn,L,DAL,35,82,31,41,72
37,8476454,Ryan Nugent-Hopkins,C,EDM,31,80,21,51,72
37,8484144,Connor Bedard,C,CHI,19,68,20,52,72
37,8477409,Carter Verhaeghe,C,FLA,29,78,37,34,71
37,8477955,Jared McCann,L,SEA,28,77,33,38,71
37,8478403,Jack Eichel,C,VGK,28,78,32,39,71
37,8474141,Patrick Kane,R,DET,36,81,37,33,70
37,8475754,Brock Nelson,C,NYI,33,79,37,33,70
37,8478460,Zach Werenski,D,CBJ,27,79,17,53,70
37,8481540,Cole Caufield,R,MTL,23,77,39,29,68
37,8479675,Trevor Moore,L,LAK,29,81,31,37,68
37,8475168,Matt Duchene,C,DAL,33,79,31,37,68
37,8480208,Drake Batherson,R,OTT,26,78,27,41,68
37,8476853,Morgan Rielly,D,TOR,30,73,14,54,68
37,8474590,John Carlson,D,WSH,34,67,9,59,68
37,8475170,Brayden Schenn,C,STL,33,77,29,38,67
37,8477964,Ivan Barbashev,C,VGK,29,74,28,39,67
37,8480839,Rasmus Dahlin,D,BUF,24,69,15,52,67
37,8480018,Nick Suzuki,C,MTL,25,79,32,34,66
37,8477500,Bo Horvat,C,NYI,29,78,31,35,66
37,8479999,Casey Mittelstadt,C,COL,26,81,28,38,66
37,8476389,Vincent Trocheck,C,NYR,31,75,27,39,66
37,8476448,William Karlsson,C,VGK,31,75,27,39,66
37,8479542,Brandon Hagel,L,TBL,26,82,18,48,66
37,8477504,Josh Morrissey,D,WPG,29,66,11,55,66
37,8478414,Timo Meier,R,NJD,28,77,28,37,65
37,8478401,Pavel Zacha,C,BOS,27,77,27,38,65
37,8477402,Pavel Buchnevich,L,STL,29,71,24,41,65
37,8478975,Mason Marchment,L,DAL,29,81,24,41,65
37,8478444,Brock Boeser,R,VAN,27,76,37,27,64
37,8478856,Conor Garland,R,VAN,28,75,27,37,64
37,8477496,Elias Lindholm,C,BOS,30,78,24,40,64
37,8475692,Mats Zuccarello,R,MIN,37,77,12,52,64
37,8476539,Jonathan Marchessault,R,NSH,34,70,29,34,63
37,8480830,Andrei Svechnikov,R,CAR,24,66,23,40,63
37,8475913,Mark Stone,R,VGK,32,75,22,41,63
37,8477949,Alex Tuch,R,BUF,28,70,27,35,62
37,8482078,Lucas Raymond,L,DET,22,82,24,38,62
37,8480803,Evan Bouchard,D,EDM,25,78,13,49,62
37,8474150,Mikael Backlund,C,CGY,35,77,16,45,61
37,8476881,Tomas Hertl,C,VGK,31,75,32,28,60
37,8481528,Dylan Cozens,C,BUF,23,74,21,39,60
37,8477494,Jonathan Drouin,L,COL,29,82,17,43,60
37,8478542,Evan Rodrigues,C,FLA,31,76,23,36,59
37,8478493,Joel Eriksson Ek,C,MIN,27,67,27,31,58
37,8482699,Dylan Guenther,R,UTA,21,76,26,32,58
37,8478873,Troy Terry,R,ANA,27,74,22,36,58
37,8481618,Alex Newhook,C,MTL,23,73,22,36,58
37,8482745,Mason McTavish,C,ANA,21,74,19,39,58
37,8482665,Matty Beniers,C,SEA,22,70,28,29,57
37,8480015,Owen Tippett,R,PHI,25,81,28,29,57
37,8479337,Alex DeBrincat,R,DET,27,81,21,36,57
37,8477940,Nikolaj Ehlers,L,WPG,28,74,18,39,57
37,8474578,Erik Karlsson,D,PIT,34,78,15,42,57
37,8483808,Andrei Kuzmenko,L,CGY,28,76,23,33,56
37,8482720,Matthew Knies,L,TOR,22,79,15,41,56
37,8476462,Dougie Hamilton,D,NJD,31,75,14,42,56
37,8479425,Filip Hronek,D,VAN,27,73,12,44,56
37,8475798,Mikael Granlund,C,SJS,32,67,8,48,56
37,8482667,William Eklund,L,SJS,22,65,29,26,55
37,8477476,Artturi Lehkonen,L,COL,29,81,26,29,55
37,8477407,Anthony Duclair,L,NYI,29,75,33,21,54
37,8482109,Alexis Lafrenière,L,NYR,23,75,30,24,54
37,8478498,Jake DeBrusk,L,VAN,28,71,29,25,54
37,8476399,Blake Coleman,C,CGY,33,77,27,27,54
37,8475726,Tyler Toffoli,C,SJS,32,67,28,25,53
37,8482159,Tyson Foerster,R,PHI,22,69,26,27,53
37,8475794,Tyler Seguin,C,DAL,32,79,24,29,53
37,8478047,Michael Bunting,L,PIT,29,70,19,34,53
37,8482133,Thomas Bordeleau,C,SJS,22,70,19,34,53
37,8477986,Brandon Montour,D,SEA,30,71,18,35,53
37,8474679,Gustav Nyquist,C,NSH,35,73,18,35,53
37,8471724,Kris Letang,D,PIT,37,78,10,43,53
37,8479323,Adam Fox,D,NYR,26,70,8,45,53
37,8477935,Sam Bennett,C,FLA,28,75,27,25,52
37,8473986,Alex Killorn,L,ANA,35,73,26,26,52
37,8475765,Vladimir Tarasenko,R,DET,33,81,15,37,52
37,8476905,Chandler Stephenson,C,SEA,30,75,7,45,52
37,8482124,Quinton Byfield,R,LAK,22,80,12,39,51
37,8481560,Arthur Kaliyev,R,LAK,23,77,25,25,50
37,8482093,Seth Jarvis,C,CAR,22,69,24,26,50
37,8477429,Andrew Copp,C,DET,30,79,20,30,50
37,8481711,Matias Maccelli,L,UTA,24,75,18,32,50
37,8476875,Mike Matheson,D,MTL,30,74,14,36,50
37,8479325,Charlie McAvoy,D,BOS,27,77,11,39,50
37,8478038,Devon Toews,D,COL,30,75,11,39,50
37,8477447,Shea Theodore,D,VGK,29,68,11,39,50
37,8475169,Evander Kane,L,EDM,33,76,28,21,49
37,8476479,Phillip Danault,C,LAK,31,77,20,29,49
37,8475784,Jeff Skinner,C,EDM,32,79,20,29,49
37,8477503,Max Domi,C,TOR,29,78,20,29,49
37,8484153,Leo Carlsson,C,ANA,20,76,20,29,49
37,8477416,Oliver Bjorkstrand,R,SEA,29,77,18,31,49
37,8474565,Alex Pietrangelo,D,VGK,34,65,13,36,49
37,8475314,Anders Lee,L,NYI,34,79,28,20,48
37,8480064,Josh Norris,C,OTT,25,74,27,21,48
37,8480039,Martin Necas,C,CAR,25,67,21,27,48
37,8476882,Teuvo Teravainen,C,CHI,30,69,21,27,48
37,8483515,Juraj Slafkovsky,L,MTL,20,75,16,32,48
37,8479987,Morgan Geekie,C,BOS,26,73,16,32,48
37,8475158,Ryan O'Reilly,C,NSH,33,69,15,33,48
37,8475753,Justin Faulk,D,STL,32,70,10,38,48
37,8478366,Frank Vatrano,R,ANA,30,70,21,26,47
37,8477479,Tyler Bertuzzi,L,CHI,29,72,17,30,47
37,8481524,Bowen Byram,D,BUF,23,71,15,32,47
37,8475167,Victor Hedman,D,TBL,34,81,4,43,47
37,8477511,Anthony Mantha,R,CGY,30,75,25,21,46
37,8477426,Nicholas Paul,L,TBL,29,82,25,21,46
37,8481533,Trevor Zegras,C,ANA,23,70,21,25,46
37,8478472,Mathieu Joseph,R,STL,27,70,21,25,46
37,8483431,Logan Cooley,C,UTA,20,73,20,26,46
37,8477456,J.T. Compher,L,DET,29,79,20,26,46
37,8480188,Fabian Zetterlund,L,SJS,25,65,19,27,46
37,8475793,Ryan Johansen,C,PHI,32,74,19,27,46
37,8481068,Yegor Sharangovich,C,CGY,26,78,15,31,46
37,8474563,Drew Doughty,D,LAK,35,71,14,32,46
37,8482702,Logan Stankoven,C,DAL,21,82,28,17,45
37,8478474,Lawson Crouse,L,UTA,27,74,26,19,45
37,8481186,Logan O'Connor,R,COL,28,79,26,19,45
37,8476483,Rickard Rakell,R,PIT,31,72,24,21,45
37,8475745,Charlie Coyle,C,BOS,32,75,23,22,45
37,8475799,Nino Niederreiter,R,WPG,32,68,23,22,45
37,8480459,Pius Suter,C,VAN,28,68,20,25,45
37,8478438,Tommy Novak,C,NSH,27,69,19,26,45
37,8478462,Nicolas Roy,C,VGK,27,80,19,26,45
37,8479365,Trent Frederic,C,BOS,26,79,19,26,45
37,8480797,Joel Farabee,L,PHI,24,75,16,29,45
37,8477346,MacKenzie Weegar,D,CGY,30,72,14,31,45
37,8482684,Luke Hughes,D,NJD,21,69,12,33,45
37,8478397,Rasmus Andersson,D,CGY,28,73,12,33,45
37,8474641,Adam Henrique,C,EDM,34,72,21,23,44
37,8480798,Philipp Kurashev,C,CHI,25,68,21,23,44
37,8483505,Matthew Poitras,C,BOS,20,77,18,26,44
37,8475191,Reilly Smith,R,NYR,33,74,14,30,44
37,8478396,Noah Hanifin,D,VGK,27,61,13,31,44
37,8476869,Brady Skjei,D,NSH,30,73,13,31,44
37,8479345,Jakob Chychrun,D,WSH,26,70,10,34,44
37,8479410,Mikhail Sergachev,D,UTA,26,67,5,39,44
37,8484166,Adam Fantilli,C,CBJ,20,72,21,22,43
37,8482110,Dawson Mercer,C,NJD,23,68,20,23,43
37,8475151,Kyle Palmieri,C,NYI,33,77,20,23,43
37,8481596,Shane Pinto,C,OTT,24,78,13,30,43
37,8481577,Philip Tomasino,C,NSH,23,70,13,30,43
37,8477932,Aaron Ekblad,D,FLA,28,72,11,32,43
37,8476906,Shayne Gostisbehere,D,CAR,31,80,8,35,43
37,8477497,Sean Monahan,C,CBJ,30,59,23,19,42
37,8478519,Anthony Cirelli,C,TBL,27,81,23,19,42
37,8479525,Ross Colton,C,COL,28,80,19,23,42
37,8478466,Daniel Sprong,R,VAN,27,69,18,24,42
37,8478109,Victor Olofsson,L,VGK,29,64,18,24,42
37,8480028,Morgan Frost,C,PHI,25,71,17,25,42
37,8479339,Patrik Laine,L,CBJ,26,65,16,26,42
37,8477444,Andre Burakovsky,L,SEA,29,62,16,26,42
37,8478046,Danton Heinen,L,VAN,29,72,15,27,42
37,8480078,Filip Chytil,C,NYR,25,67,15,27,42
37,8476826,Yanni Gourde,C,SEA,33,74,14,28,42
37,8477021,Alex Kerfoot,C,UTA,30,75,12,30,42
37,8478407,Vince Dunn,D,SEA,28,72,10,32,42
37,8470613,Brent Burns,D,CAR,39,76,6,36,42
37,8481554,Kaapo Kakko,R,NYR,23,74,22,19,41
37,8481604,Pavel Dorofeyev,L,VGK,24,72,17,24,41
37,8479992,Michael Rasmussen,C,DET,25,80,16,25,41
37,8480145,Neal Pionk,D,WPG,29,69,11,30,41
37,8480014,Gabriel Vilardi,C,WPG,25,71,27,13,40
37,8476880,Tom Wilson,R,WSH,30,65,22,18,40
37,8482092,Ridly Greig,C,OTT,22,79,21,19,40
37,8476419,Jean-Gabriel Pageau,C,NYI,32,77,16,24,40
37,8475848,Brendan Gallagher,R,MTL,32,68,13,27,40
37,8475722,Jason Zucker,L,BUF,32,67,12,28,40
37,8480817,K'Andre Miller,D,NYR,24,69,11,29,40
37,8481542,Moritz Seider,D,DET,23,75,11,29,40
37,8482705,Cole Sillinger,C,CBJ,21,64,23,16,39
37,8476432,Boone Jenner,C,CBJ,31,68,21,18,39
37,8477998,Warren Foegele,L,LAK,28,80,18,21,39
37,8482113,Anton Lundell,C,FLA,23,77,18,21,39
37,8484145,Zach Benson,L,BUF,19,66,16,23,39
37,8478463,Anthony Beauvillier,L,PIT,27,65,16,23,39
37,8479400,Pierre-Luc Dubois,L,WSH,26,66,16,23,39
37,8477495,Seth Jones,D,CHI,30,66,12,27,39
37,8480849,Barrett Hayton,C,UTA,24,74,11,28,39
37,8482105,Jake Sanderson,D,OTT,22,73,11,28,39
37,8476854,Hampus Lindholm,D,BOS,30,77,9,30,39
37,8477948,Travis Sanheim,D,PHI,28,69,7,32,39
37,8482175,JJ Peterka,R,BUF,22,60,22,16,38
37,8476438,Brandon Saad,L,STL,32,71,18,20,38
37,8476480,Vladislav Namestnikov,C,WPG,32,72,14,24,38
37,8476872,Scott Laughton,C,PHI,30,66,12,26,38
37,8478500,Ivan Provorov,D,CBJ,27,76,5,33,38
37,8478042,Viktor Arvidsson,L,EDM,31,69,18,19,37
37,8475714,Calle Jarnkrok,C,TOR,33,74,17,20,37
37,8474149,Evgenii Dadonov,R,DAL,35,80,16,21,37
37,8479661,Tanner Jeannot,L,LAK,27,78,16,21,37
37,8480802,Ryan McLeod,C,BUF,25,66,15,22,37
37,8482146,Luke Evangelista,R,NSH,22,68,15,22,37
37,8474586,Jordan Eberle,R,SEA,34,72,15,21,36
37,8475287,Erik Haula,L,NJD,33,69,13,23,36
37,8478115,Pierre Engvall,L,NYI,28,80,12,24,36
37,8482122,Brock Faber,D,MIN,22,78,7,29,36
37,8475768,Jaden Schwartz,C,SEA,32,66,18,17,35
37,8480009,Eeli Tolvanen,R,SEA,25,71,17,18,35
37,8482149,Cole Perfetti,C,WPG,22,66,15,20,35
37,8482660,Kent Johnson,C,CBJ,22,63,14,21,35
37,8476458,Ryan Strome,C,ANA,31,73,14,21,35
37,8478458,John (Jack) Roslovic,C,CAR,27,63,10,25,35
37,8476792,Torey Krug,D,STL,33,74,8,27,35
37,8477498,Darnell Nurse,D,EDM,29,73,8,27,35
37,8478055,Gustav Forsling,D,FLA,28,72,7,28,35
37,8483490,Pavel Mintyukov,D,ANA,21,75,3,32,35
37,8482089,Jake Neighbours,L,STL,22,63,20,14,34
37,8477451,Ryan Hartman,R,MIN,30,71,18,16,34
37,8476461,Sean Couturier,C,PHI,32,67,17,17,34
37,8478413,Jordan Greenway,L,BUF,27,72,16,18,34
37,8478233,Andrew Mangiapane,L,WSH,28,72,14,20,34
37,8471698,T.J. Oshie,R,WSH,38,64,12,22,34
37,8477953,Kasperi Kapanen,R,STL,28,64,12,22,34
37,8479351,Sam Steel,C,DAL,26,77,8,26,34
37,8479639,Dylan Coghlan,D,WPG,26,70,7,27,34
37,8477969,Marcus Pettersson,D,PIT,28,80,6,28,34
37,8476958,Jaccob Slavin,D,CAR,30,76,5,29,34
37,8476885,Jacob Trouba,D,NYR,30,76,5,29,34
37,8476474,Stefan Noesen,R,NJD,31,66,19,14,33
37,8480113,Alex Iafallo,L,WPG,31,60,18,15,33
37,8479996,Cody Glass,C,NSH,25,60,16,17,33
37,8480185,Eetu Luostarinen,C,FLA,26,69,14,19,33
37,8481581,Thomas Harley,D,DAL,23,78,12,21,33
37,8479353,Brett Howden,C,VGK,26,75,8,25,33
37,8476292,Ondrej Palat,L,NJD,33,73,8,25,33
37,8475218,Mattias Ekholm,D,EDM,34,69,7,26,33
37,8478469,Thomas Chabot,D,OTT,27,70,6,27,33
37,8482259,Bobby McMann,C,TOR,28,66,20,12,32
37,8477952,Robby Fabbri,C,ANA,28,59,17,15,32
37,8482097,Jack Quinn,R,BUF,23,60,16,16,32
37,8474102,David Perron,L,OTT,36,76,15,17,32
37,8475760,Nick Bjugstad,C,UTA,32,73,15,17,32
37,8481535,Nils Hoglander,L,VAN,24,61,15,17,32
37,8481656,Aliaksei Protas,C,WSH,23,61,14,18,32
37,8482101,Danil Gushchin,L,SJS,22,60,11,21,32
37,8482671,Owen Power,D,BUF,22,66,11,21,32
37,8474053,Logan Couture,C,SJS,35,58,10,22,32
37,8477505,Alexander Wennberg,C,SJS,30,61,8,24,32
37,8476923,Damon Severson,D,CBJ,30,79,7,25,32
37,8481703,Valtteri Puustinen,R,PIT,25,66,5,27,32
37,8482125,Alexander Holtz,R,VGK,22,69,17,14,31
37,8480748,Kiefer Sherwood,L,VAN,29,64,16,15,31
37,8477425,Miles Wood,L,COL,29,75,14,17,31
37,8476918,Jimmy Vesey,L,NYR,31,64,13,18,31
37,8480789,Oliver Wahlstrom,R,NYI,24,69,12,19,31
37,8476902,Esa Lindell,D,DAL,30,80,5,26,31
37,8477947,Sonny Milano,L,WSH,28,64,17,13,30
37,8482809,Jackson Blake,R,CAR,21,59,16,14,30
37,8476392,Adam Lowry,C,WPG,31,73,15,15,30
37,8478057,Dakota Joshua,C,VAN,28,70,12,18,30
37,8480003,Jesper Boqvist,C,FLA,26,70,7,23,30
37,8482245,Artem Zub,D,OTT,29,66,7,23,30
37,8477220,Nate Schmidt,D,FLA,33,66,7,23,30
37,8478507,John Marino,D,UTA,27,72,4,26,30
37,8473507,Jeff Petry,D,DET,37,76,3,27,30
37,8479941,Justin Danforth,R,CBJ,31,64,22,7,29
37,8477839,Conor Sheary,L,TBL,32,80,18,11,29
37,8481580,Connor McMichael,C,WSH,23,63,12,17,29
37,8476927,Teddy Blueger,C,VAN,30,68,10,19,29
37,8481624,Ilya Mikheyev,R,CHI,30,59,10,19,29
37,8482712,Oskar Olausson,R,COL,22,77,8,21,29
37,8478882,Vladislav Gavrikov,D,LAK,29,66,7,22,29
37,8481546,Cam York,D,PHI,23,67,5,24,29
37,8479398,Samuel Girard,D,COL,26,66,4,25,29
37,8480035,Henri Jokiharju,D,BUF,25,61,0,29,29
37,8478020,Michael Amadio,R,OTT,28,67,15,13,28
37,8479591,Michael Eyssimont,C,TBL,28,81,14,14,28
37,8483468,Jiri Kulich,C,BUF,20,65,12,16,28
37,8474574,Tyler Myers,D,VAN,34,67,8,20,28
37,8478133,Jake Evans,C,MTL,28,71,7,21,28
37,8476917,Adam Pelech,D,NYI,30,76,2,26,28
37,8482055,Drew O'Connor,L,PIT,26,64,14,13,27
37,8478891,Mason Appleton,C,WPG,28,67,14,13,27
37,8476925,Colton Sissons,C,NSH,31,65,13,14,27
37,8481481,Blake Lizotte,C,PIT,27,61,13,14,27
37,8480835,Jack Drury,C,CAR,24,61,11,16,27
37,8481523,Kirby Dach,C,MTL,23,62,8,19,27
37,8482624,Daniil Miromanov,D,CGY,27,69,5,22,27
37,8477506,Ryan Pulock,D,NYI,30,80,5,22,27
37,8475791,Taylor Hall,L,CHI,33,59,14,12,26
37,8482679,Matt Coronato,R,CGY,22,68,14,12,26
37,8480893,Kirill Marchenko,R,CBJ,24,61,13,13,26
37,8476278,Colin Blackwell,C,DAL,31,77,13,13,26
37,8480220,Noah Cates,L,PHI,25,72,12,14,26
37,8481517,Brett Leason,R,ANA,25,62,12,14,26
37,8478043,Sam Lafferty,C,BUF,29,59,12,14,26
37,8475855,Jesper Fast,R,CAR,33,57,10,16,26
37,8479336,Carl Grundstrom,R,SJS,27,48,10,16,26
37,8480871,Adam Boqvist,D,FLA,24,73,9,17,26
37,8482475,Yegor Chinakhov,R,CBJ,23,65,8,18,26
37,8480813,Joe Veleno,C,DET,24,75,7,19,26
37,8477435,Ryan Graves,D,PIT,29,76,6,20,26
37,8480222,Sebastian Aho,D,PIT,28,66,6,20,26
37,8480434,Sean Durzi,D,UTA,26,69,5,21,26
37,8480043,Timothy Liljegren,D,TOR,25,67,5,21,26
37,8480049,Dylan Samberg,D,WPG,25,68,3,23,26
37,8474151,Ryan McDonagh,D,TBL,35,79,3,23,26
37,8481477,Nico Sturm,C,SJS,29,64,16,9,25
37,8476469,Joel Armia,R,MTL,31,64,16,9,25
37,8481582,Nicholas Robertson,L,TOR,23,70,14,11,25
37,8480855,Jack McBain,C,UTA,24,69,14,11,25
37,8477903,Garnet Hathaway,R,PHI,33,57,12,13,25
37,8477353,Tyler Motte,C,DET,29,74,10,15,25
37,8480448,Parker Kelly,L,COL,25,77,10,15,25
37,8479293,Brandon Tanev,L,SEA,33,68,8,17,25
37,8470621,Corey Perry,R,EDM,39,70,8,17,25
37,8480074,Alexandre Texier,C,STL,25,59,8,17,25
37,8482067,Connor Mackey,D,NYR,28,66,6,19,25
37,8476979,Erik Gustafsson,D,DET,32,72,3,22,25
37,8479402,Jake Bean,D,CGY,26,66,1,24,25
37,8480829,Jesperi Kotkaniemi,C,CAR,24,70,16,8,24
37,8474715,Cameron Atkinson,R,TBL,35,82,15,9,24
37,8476921,Jordan Martinook,L,CAR,32,62,14,10,24
37,8480144,David Kampf,C,TOR,29,74,12,12,24
37,8476981,Josh Anderson,R,MTL,30,69,11,13,24
37,8473422,Nick Foligno,L,CHI,37,53,10,14,24
37,8477987,Ryan Donato,C,CHI,28,62,9,15,24
37,8476312,Josh Manson,D,COL,33,54,9,15,24
37,8479976,Juuso Valimaki,D,UTA,26,68,8,16,24
37,8475171,Oliver Ekman-Larsson,D,TOR,33,70,7,17,24
37,8479980,Nicolas Hague,D,VGK,26,53,6,18,24
37,8475181,Nick Leddy,D,STL,33,70,5,19,24
37,8475462,Radko Gudas,D,ANA,34,72,5,19,24
37,8480878,Nils Lundkvist,D,DAL,24,69,4,20,24
37,8475324,Nick Jensen,D,OTT,34,69,4,20,24
37,8475764,Cam Fowler,D,ANA,33,75,3,21,24
37,8476892,Colton Parayko,D,STL,31,73,3,21,24
37,8479393,Noah Gregor,L,OTT,26,69,18,5,23
37,8475193,Tomas Tatar,L,NJD,34,69,13,10,23
37,8475763,Kevin Hayes,R,PIT,32,65,12,11,23
37,8476960,Andreas Athanasiou,C,CHI,30,50,12,11,23
37,8482737,Zack Bolduc,C,STL,21,56,11,12,23
37,8477015,Connor Brown,R,EDM,30,70,10,13,23
37,8483493,Frank Nazar,C,CHI,20,54,10,13,23
37,8479315,Joey Anderson,R,CHI,26,56,9,14,23
37,8477392,Hudson Fasching,R,NYI,29,68,9,14,23
37,8481704,Juuso Parssinen,C,NSH,23,58,9,14,23
37,8479390,Taylor Raddysh,R,WSH,26,65,8,15,23
37,8484203,Bradly Nadeau,L,CAR,19,63,6,17,23
37,8482087,Kaiden Guhle,D,MTL,22,70,6,17,23
37,8478416,Erik Cernak,D,TBL,27,73,5,18,23
37,8481521,Ronnie Attard,D,PHI,25,65,4,19,23
37,8478851,Alexandre Carrier,D,NSH,28,64,3,20,23
37,8482655,Janis Moser,D,TBL,24,76,3,20,23
37,8478399,Jonas Siegenthaler,D,NJD,27,61,3,20,23
37,8482073,Braden Schneider,D,NYR,23,65,2,21,23
37,8480289,Morgan Barron,C,WPG,26,59,14,8,22
37,8478508,Yakov Trenin,C,MIN,27,58,13,9,22
37,8478432,Christian Fischer,R,DET,27,70,12,10,22
37,8482157,Will Cuylle,L,NYR,22,66,12,10,22
37,8474189,Lars Eller,C,PIT,35,67,10,12,22
37,8478569,Noel Acciari,C,PIT,33,53,10,12,22
37,8475149,Marcus Johansson,L,MIN,34,60,9,13,22
37,8482117,Lukas Reichel,L,CHI,22,59,8,14,22
37,8483457,Lane Hutson,D,MTL,20,71,8,14,22
37,8477989,Christian Dvorak,C,MTL,28,57,7,15,22
37,8476331,Dylan DeMelo,D,WPG,31,72,5,17,22
37,8474716,Jared Spurgeon,D,MIN,35,78,4,18,22
37,8475790,Erik Gudbranson,D,CBJ,32,76,2,20,22
37,8479983,Mario Ferraro,D,SJS,26,76,2,20,22
37,8481014,Alexander Romanov,D,NYI,24,76,1,21,22
37,8479371,Dante Fabbro,D,NSH,26,56,1,21,22
37,8480068,Ryan Poehling,C,PHI,25,65,10,11,21
37,8477478,William Carrier,L,CAR,30,56,10,11,21
37,8475231,Casey Cizikas,C,NYI,33,72,10,11,21
37,8481553,Bobby Brink,R,PHI,23,58,9,12,21
37,8483491,Ivan Miroshnichenko,L,WSH,20,53,8,13,21
37,8481601,Simon Holmstrom,R,NYI,23,67,8,13,21
37,8479316,Luke Kunin,C,SJS,27,57,7,14,21
37,8475343,Nic Dowd,C,WSH,34,64,6,15,21
37,8477931,Tomas Nosek,L,FLA,32,54,6,15,21
37,8475279,Ben Chiarot,D,DET,33,61,5,16,21
37,8476463,Jonas Brodin,D,MIN,31,72,4,17,21
37,8483445,Cutter Gauthier,L,ANA,20,66,4,17,21
37,8477369,Carson Soucy,D,VAN,30,66,4,17,21
37,8476422,Mike Reilly,D,NYI,31,77,3,18,21
37,8476931,Jake McCabe,D,TOR,31,63,1,20,21
37,8479619,Michael Carcone,L,UTA,28,56,12,8,20
37,8479370,Tyson Jost,C,CAR,26,54,11,9,20
37,8482079,Marco Rossi,C,MIN,23,54,10,10,20
37,8480205,Emil Bemstrom,C,PIT,25,55,10,10,20
37,8478013,Jake Walman,D,SJS,28,72,10,10,20
37,8477450,Jason Dickinson,C,CHI,29,56,10,10,20
37,8478424,Jansen Harkins,C,ANA,27,47,10,10,20
37,8473563,Nicklas Backstrom,C,WSH,37,51,8,12,20
37,8481522,Peyton Krebs,C,BUF,23,66,7,13,20
37,8480336,Sean Walker,D,CAR,30,76,6,14,20
37,8477507,Nikita Zadorov,D,BOS,29,62,6,14,20
37,8478840,Will Borgen,D,SEA,28,67,4,16,20
37,8481708,Zac Jones,D,NYR,24,52,4,16,20
37,8481606,Jordan Spence,D,LAK,23,68,3,17,20
37,8479369,Andrew Peeke,D,BOS,26,62,3,17,20
37,8479998,Mikey Anderson,D,LAK,25,61,3,17,20
37,8483524,Shane Wright,C,SEA,20,56,11,8,19
37,8477446,Michael McCarron,R,NSH,29,56,10,9,19
37,8476329,Travis Boyd,C,MIN,31,56,8,11,19
37,8481567,Henry Thrun,D,SJS,23,50,8,11,19
37,8478970,Jalen Chatfield,D,CAR,28,67,7,12,19
37,8482142,Jamie Drysdale,D,PHI,22,64,7,12,19
37,8481537,Nikita Okhotiuk,D,CGY,24,58,7,12,19
37,8475225,Craig Smith,C,CHI,35,49,7,12,19
37,8480762,Eric Robinson,L,CAR,29,58,6,13,19
37,8476897,Oskar Sundqvist,C,STL,30,66,6,13,19
37,8478911,Matt Roy,D,WSH,29,63,5,14,19
37,8480073,Erik Brannstrom,D,COL,25,60,4,15,19
37,8478443,Brandon Carlo,D,BOS,28,62,3,16,19
37,8474673,TJ Brodie,D,CHI,34,57,2,17,19
37,8477845,Trevor van Riemsdyk,D,WSH,33,67,2,17,19
37,8482155,Alex Laferriere,R,LAK,23,66,15,3,18
37,8473453,Trevor Lewis,C,LAK,37,70,11,7,18
37,8480281,Alexey Toropchenko,R,STL,25,63,10,8,18
37,8483482,Tristan Luneau,D,ANA,20,55,10,8,18
37,8482749,Joshua Roy,R,MTL,21,66,9,9,18
37,8481032,Paul Cotter,C,NJD,25,64,9,9,18
37,8479414,Nathan Bastian,R,NJD,27,61,9,9,18
37,8478585,Derek Ryan,C,EDM,38,63,8,10,18
37,8477406,Mattias Janmark,C,EDM,32,67,7,11,18
37,8476624,Barclay Goodrow,C,SJS,31,51,7,11,18
37,8474034,Patrick Maroon,L,CHI,36,48,7,11,18
37,8475220,Marcus Foligno,L,MIN,33,60,6,12,18
37,8476856,Mathew Dumba,D,DAL,30,70,5,13,18
37,8476988,Matt Benning,D,SJS,30,68,5,13,18
37,8476873,Mark Jankowski,C,NSH,30,45,5,13,18
37,8481093,Rafael Harvey-Pinard,L,MTL,25,59,4,14,18
37,8477919,Frederick Gaudreau,C,MIN,31,60,4,14,18
37,8479982,Conor Timmins,D,TOR,26,57,4,14,18
37,8476467,Jamie Oleksiak,D,SEA,32,67,3,15,18
37,8475233,David Savard,D,MTL,34,67,3,15,18
37,8475179,Dmitry Kulikov,D,FLA,34,57,3,15,18
37,8476525,Colin Miller,D,WPG,32,62,3,15,18
37,8480246,Nick Perbix,D,TBL,26,72,2,16,18
37,8476374,Sean Kuraly,C,CBJ,31,57,10,7,17
37,8480980,Connor Dewar,C,TOR,25,62,9,8,17
37,8482074,Connor Zary,C,CGY,23,62,9,8,17
37,8483565,Nick Blankenburg,D,NSH,26,59,8,9,17
37,8481441,Joe Snively,C,DET,28,67,4,13,17
37,8480796,Martin Fehervary,D,WSH,25,51,3,14,17
37,8480891,Michael Kesselring,D,UTA,24,59,3,14,17
37,8484149,Gavin Brindley,C,CBJ,20,52,2,15,17
37,8479026,Philippe Myers,D,TOR,27,51,0,17,17
37,8480058,Pierre-Olivier Joseph,D,STL,25,53,0,17,17
37,8477380,Jonny Brodzinski,C,NYR,31,55,9,7,16
37,8480441,Trey Fix-Wolansky,R,CBJ,25,37,8,8,16
37,8480845,Rasmus Kupari,C,WPG,24,37,8,8,16
37,8480995,Pontus Holmberg,R,TOR,25,63,7,9,16
37,8482803,Olen Zellweger,D,ANA,21,60,7,9,16
37,8476934,Brock McGinn,L,ANA,30,52,7,9,16
37,8476994,Vinnie Hinostroza,C,NSH,30,53,7,9,16
37,8481527,Kaedan Korczak,D,VGK,23,47,6,10,16
37,8482111,Justin Barron,D,MTL,23,67,5,11,16
37,8477979,Nicolas Aube-Kubel,R,BUF,28,58,5,11,16
37,8480192,Johnathan Kovacevic,D,NJD,27,52,5,11,16
37,8479324,Ryan Lindgren,D,NYR,26,58,4,12,16
37,8476457,Adam Larsson,D,SEA,32,64,3,13,16
37,8476429,Scott Mayfield,D,NYI,32,73,3,13,16
37,8476891,Matthew Grzelcyk,D,PIT,30,73,1,15,16
37,8478136,Jake Middleton,D,MIN,28,73,1,15,16
37,8480157,Calle Rosen,D,COL,30,54,1,15,16
37,8481178,Egor Zamula,D,PHI,24,60,1,15,16
37,8475690,Chris Tanev,D,TOR,35,63,1,15,16
37,8474166,Alec Martinez,D,CHI,37,52,1,15,16
37,8476967,Brett Kulak,D,EDM,30,63,1,15,16
37,8476879,Cody Ceci,D,EDM,31,66,0,16,16
37,8475718,Justin Holl,D,DET,32,57,0,16,16
37,8482762,Simon Edvinsson,D,DET,21,58,12,3,15
37,8476878,Zemgus Girgensons,C,TBL,30,81,10,5,15
37,8479638,Justin Brazeau,R,BOS,26,39,8,7,15
37,8477482,Zachary Sanford,L,CHI,30,31,8,7,15
37,8479066,Ryan Lomberg,L,CGY,30,57,7,8,15
37,8473533,Jordan Staal,C,CAR,36,63,6,9,15
37,8482176,Wyatt Kaiser,D,CHI,22,56,6,9,15
37,8481161,Jake Christiansen,D,CBJ,25,57,5,10,15
37,8475200,Dmitry Orlov,D,CAR,33,73,4,11,15
37,8470600,Ryan Suter,D,STL,39,68,4,11,15
37,8477488,Brett Pesce,D,NJD,30,66,3,12,15
37,8480873,Rasmus Sandin,D,WSH,24,67,3,12,15
37,8481751,Lukas Rousek,R,BUF,25,35,3,12,15
37,8480172,Jan Rutta,D,SJS,34,65,2,13,15
37,8475188,Brayden McNabb,D,VGK,33,49,1,14,15
37,8482861,Vincent Iorio,D,WSH,22,34,1,14,15
37,8476822,Luke Glendening,C,TBL,35,76,10,4,14
37,8475842,Sam Carrick,C,NYR,32,60,9,5,14
37,8482166,Shakir Mukhamadullin,D,SJS,22,57,7,7,14
37,8480806,Isac Lundestrom,C,ANA,25,53,6,8,14
37,8482192,Isaak Phillips,D,CHI,23,48,6,8,14
37,8479368,Max Jones,L,BOS,26,57,5,9,14
37,8482451,Mikael Pyyhtia,L,CBJ,23,46,5,9,14
37,8482859,Zack Ostapchuk,C,OTT,21,57,4,10,14
37,8479372,Joshua Mahura,D,SEA,26,56,4,10,14
37,8480001,Urho Vaakanainen,D,ANA,25,60,3,11,14
37,8478468,Jeremy Lauzon,D,NSH,27,62,3,11,14
37,8483460,David Jiricek,D,CBJ,21,63,3,11,14
37,8481059,Scott Perunovich,D,STL,26,52,2,12,14
37,8479348,Kale Clague,D,BUF,26,44,2,12,14
37,8481013,Jonatan Berggren,R,DET,24,53,10,3,13
37,8476889,Radek Faksa,C,STL,30,56,9,4,13
37,8477508,Curtis Lazar,C,NJD,29,61,8,5,13
37,8480021,Jack Studnicka,C,LAK,25,56,7,6,13
37,8478451,Ethan Bear,D,WSH,27,50,7,6,13
37,8478211,Dryden Hunt,L,CGY,29,60,7,6,13
37,8483499,Liam Ohgren,L,MIN,20,53,6,7,13
37,8480252,Cole Guttman,C,CHI,25,45,6,7,13
37,8479671,Mathieu Olivier,R,CBJ,27,50,5,8,13
37,8478421,A.J. Greer,L,FLA,28,59,5,8,13
37,8480727,Zach Whitecloud,D,VGK,28,52,4,9,13
37,8479359,Beck Malenstyn,L,BUF,26,44,4,9,13
37,8471817,Ryan Reaves,R,TOR,37,50,4,9,13
37,8479249,Andrew Poturalski,C,SJS,30,31,3,10,13
37,8481028,Martin Pospisil,C,CGY,25,47,2,11,13
37,8479520,Brandon Duhaime,R,WSH,27,53,7,5,12
37,8477401,John Hayden,C,SEA,29,35,7,5,12
37,8483570,Ben Meyers,C,SEA,26,28,7,5,12
37,8479328,Julien Gauthier,R,NYI,27,60,6,6,12
37,8480011,Klim Kostin,C,SJS,25,52,5,7,12
37,8479718,Alex Barré-Boulet,C,MTL,27,47,5,7,12
37,8483495,Simon Nemec,D,NJD,20,53,5,7,12
37,8478434,Keegan Kolesar,R,VGK,27,67,4,8,12
37,8479944,Zach Aston-Reese,C,VGK,30,47,4,8,12
37,8479439,Jacob MacDonald,D,COL,31,45,4,8,12
37,8477499,Rasmus Ristolainen,D,PHI,30,62,3,9,12
37,8480807,Mattias Samuelsson,D,BUF,24,50,3,9,12
37,8480292,Carson Meyer,R,ANA,27,27,3,9,12
37,8481600,Tobias Bjornfot,D,FLA,23,39,2,10,12
37,8480950,Ilya Lyubushkin,D,DAL,30,58,1,11,12
37,8474090,Brendan Smith,D,DAL,35,52,1,11,12
37,8481167,Brayden Pachal,D,CGY,25,50,1,11,12
37,8481568,Alex Vlasic,D,CHI,23,54,0,12,12
37,8475235,Nicolas Deslauriers,L,PHI,33,52,9,2,11
37,8482807,Ethan Del Mastro,D,CHI,21,50,7,4,11
37,8482062,Cole Smith,L,NSH,29,51,6,5,11
37,8478831,Kevin Stenlund,C,UTA,28,51,6,5,11
37,8478017,Mark Friedman,D,VAN,29,43,5,6,11
37,8480860,Kevin Bahl,D,CGY,24,53,4,7,11
37,8480355,Mark Kastelic,C,BOS,25,57,4,7,11
37,8483549,Lucas Condotta,L,MTL,27,38,4,7,11
37,8478452,Caleb Jones,D,LAK,27,61,3,8,11
37,8474567,Zach Bogosian,D,MIN,34,61,3,8,11
37,8477573,Nathan Walker,L,STL,30,45,3,8,11
37,8479378,Logan Stanley,D,WPG,26,41,3,8,11
37,8484254,Akito Hirose,D,VAN,25,37,3,8,11
37,8478178,Darren Raddysh,D,TBL,28,71,2,9,11
37,8481019,David Gustafsson,C,WPG,24,41,2,9,11
37,8475208,Brian Dumoulin,D,ANA,33,59,2,9,11
37,8480025,MacKenzie Entwistle,R,FLA,25,64,2,9,11
37,8480070,Ian Mitchell,D,BOS,25,46,2,9,11
37,8481550,Adam Beckman,L,NJD,23,36,1,10,11
37,8475455,Brenden Dillon,D,NJD,34,50,0,11,11
37,8478454,Noah Juulsen,D,VAN,27,41,0,11,11
37,8482148,Hendrix Lapierre,C,WSH,22,57,9,1,10
37,8482744,James Malatesta,L,CBJ,21,40,5,5,10
37,8482652,Walker Duehr,R,CGY,27,45,5,5,10
37,8481716,Dmitri Voronkov,L,CBJ,24,44,4,6,10
37,8477018,Ben Hutton,D,VGK,31,40,4,6,10
37,8471709,Marc-Edouard Vlasic,D,SJS,37,51,3,7,10
37,8478859,Niko Mikkola,D,FLA,28,63,3,7,10
37,8477365,Connor Clifton,D,BUF,29,55,2,8,10
37,8479972,Mason Shaw,C,WPG,26,41,2,8,10
37,8478450,Parker Wotherspoon,D,BOS,27,38,2,8,10
37,8475750,Jon Merrill,D,MIN,32,60,1,9,10
37,8482666,Scott Morrow,D,CAR,22,44,8,1,9
37,8477962,Brendan Lemieux,L,CAR,28,42,6,3,9
37,8477938,Haydn Fleury,D,WPG,28,44,5,4,9
37,8479291,Kevin Rooney,C,CGY,31,50,5,4,9
37,8483630,Pavol Regenda,L,ANA,25,38,5,4,9
37,8480880,Jakub Lauko,C,MIN,24,39,5,4,9
37,8482964,Arber Xhekaj,D,MTL,23,45,3,6,9
37,8479543,Michael Pezzetta,L,MTL,26,65,3,6,9
37,8476372,Nick Seeler,D,PHI,31,41,3,6,9
37,8479772,Zack MacEwen,R,OTT,28,47,3,6,9
37,8483466,Kevin Korchinski,D,CHI,20,48,2,7,9
37,8474568,Luke Schenn,D,NSH,35,57,1,8,9
37,8481617,Vasily Podkolzin,R,VAN,23,39,5,3,8
37,8483397,Marc McLaughlin,C,BOS,25,30,5,3,8
37,8480007,Jonas Rondbjerg,R,VGK,25,37,4,4,8
37,8479968,Vinni Lettieri,C,BOS,29,52,4,4,8
37,8482095,Tyler Kleven,D,OTT,22,43,4,4,8
37,8481592,Jakob Pelletier,L,CGY,23,30,4,4,8
37,8481641,Joel Kiviranta,L,COL,28,66,3,5,8
37,8479981,Jonah Gadjovich,L,FLA,26,47,3,5,8
37,8481679,Maxence Guenette,D,OTT,23,36,3,5,8
37,8480844,Grigori Denisenko,L,VGK,24,34,3,5,8
37,8481599,Victor Soderstrom,D,UTA,23,41,2,6,8
37,8480848,Ty Dellandrea,C,SJS,24,44,2,6,8
37,8480245,Olle Lycksell,R,PHI,25,31,2,6,8
37,8471677,Jack Johnson,D,CBJ,37,62,1,7,8
37,8479986,Kole Lind,R,DAL,26,56,1,7,8
37,8482077,Dylan Holloway,L,EDM,23,47,6,1,7
37,8479367,William Lockwood,R,FLA,26,21,5,2,7
37,8479344,Jesse Puljujarvi,R,PIT,26,43,4,3,7
37,8482496,Nils Aman,C,VAN,24,39,4,3,7
37,8481147,Reese Johnson,C,MIN,26,32,4,3,7
37,8479362,Riley Tufte,L,BOS,26,21,4,3,7
37,8482634,Alex Steeves,C,TOR,25,43,3,4,7
37,8476442,Matt Nieto,L,PIT,32,52,3,4,7
37,8478409,Anthony Richard,C,PHI,28,37,3,4,7
37,8480196,Jacob Bryson,D,BUF,27,50,3,4,7
37,8482659,Josh Doan,R,UTA,22,58,2,5,7
37,8482784,Zach Dean,C,STL,21,43,2,5,7
37,8480990,Declan Chisholm,D,MIN,24,34,2,5,7
37,8481532,Alex Turcotte,C,LAK,23,44,2,5,7
37,8477462,Robert Hagg,D,VGK,29,33,2,5,7
37,8478146,Matthew Highmore,C,OTT,28,39,1,6,7
37,8483763,Maksymilian Szuber,D,UTA,22,31,1,6,7
37,8476441,Joel Edmundson,D,LAK,31,38,1,6,7
37,8478502,Dennis Gilbert,D,BUF,28,17,1,6,7
37,8475762,Derek Forbort,D,VAN,32,41,0,7,7
37,8479985,Cale Fleury,D,SEA,26,33,5,1,6
37,8476858,Phillip Di Giuseppe,L,VAN,31,38,4,2,6
37,8481701,Santeri Hatakka,D,NJD,23,45,3,3,6
37,8481598,Philip Broberg,D,EDM,23,52,3,3,6
37,8482144,Jack Thompson,D,SJS,22,25,3,3,6
37,8482747,Brennan Othmann,L,NYR,21,38,3,3,6
37,8479994,Jaret Anderson-Dolan,C,WPG,25,34,3,3,6
37,8477887,Patrick Brown,C,BOS,32,39,3,3,6
37,8477473,Justin Bailey,R,SJS,29,25,2,4,6
37,8477070,Liam O'Brien,C,UTA,30,55,2,4,6
37,8478874,Adam Gaudette,R,OTT,28,36,2,4,6
37,8482511,Mason Lohrei,D,BOS,23,30,2,4,6
37,8482177,Marat Khusnutdinov,C,MIN,22,34,2,4,6
37,8476473,Connor Murphy,D,CHI,31,40,1,5,6
37,8481056,Spencer Stastney,D,NSH,24,26,1,5,6
37,8477384,Joshua Brown,D,EDM,30,39,1,5,6
37,8476913,Devin Shore,C,MIN,30,34,1,5,6
37,8479587,Rhett Gardner,C,PHI,28,30,1,5,6
37,8480887,Jordan Harris,D,MTL,24,53,0,6,6
37,8476874,Olli Maatta,D,DET,30,64,0,6,6
37,8482730,Brandt Clarke,D,LAK,21,40,3,2,5
37,8483619,Filip Roos,D,OTT,25,38,3,2,5
37,8481609,Vladislav Kolyachonok,D,UTA,23,33,3,2,5
37,8481789,Tye Kartye,L,SEA,23,40,3,2,5
37,8481518,Nolan Foote,L,NJD,24,38,3,2,5
37,8476867,Brendan Gaunce,C,MIN,30,33,3,2,5
37,8481043,Cole Koepke,L,BOS,26,17,3,2,5
37,8481122,Simon Benoit,D,TOR,26,38,2,3,5
37,8480870,Bo Groulx,C,NYR,24,26,2,3,5
37,8479536,Axel Jonsson-Fjallby,L,WPG,26,36,2,3,5
37,8482713,Mackie Samoskevich,R,FLA,22,44,2,3,5
37,8479442,Troy Stecher,D,EDM,30,51,1,4,5
37,8475958,Michael Sgarbossa,C,WSH,32,29,1,4,5
37,8482516,Matthew Kessel,D,STL,24,18,1,4,5
37,8478021,William Lagesson,D,DET,28,29,1,4,5
37,8479576,Vincent Desharnais,D,VAN,28,27,1,4,5
37,8477034,Jaycob Megna,D,FLA,32,39,0,5,5
37,8476952,Dominic Toninato,C,WPG,30,30,0,5,5
37,8480879,Jacob Bernard-Docker,D,OTT,24,47,0,5,5
37,8481605,Jackson LaCombe,D,ANA,23,36,0,5,5
37,8479320,Maxime Lajoie,D,SEA,27,27,0,5,5
37,8480890,Jan Jenik,C,OTT,24,28,0,5,5
37,8481593,Jayden Struble,D,MTL,23,18,0,5,5
37,8482197,Adam Raska,R,MIN,23,10,0,5,5
37,8482250,Callahan Burke,C,VGK,27,21,0,5,5
37,8479379,Givani Smith,R,SJS,26,33,3,1,4
37,8482751,Ryan Winterton,C,SEA,21,42,3,1,4
37,8481754,Nikita Nesterenko,C,ANA,23,26,3,1,4
37,8481556,John Beecher,C,BOS,23,43,2,2,4
37,8477244,Chad Ruhwedel,D,NYR,34,33,2,2,4
37,8481699,Aku Raty,R,UTA,23,10,2,2,4
37,8481024,Linus Karlsson,C,VAN,25,9,2,2,4
37,8477810,Joel Hanley,D,CGY,33,21,2,2,4
37,8480075,Cameron Crotty,D,MIN,25,11,2,2,4
37,8477335,Kyle Burroughs,D,LAK,29,43,1,3,4
37,8481422,Jake Lucchini,C,NSH,29,27,1,3,4
37,8482147,Jean-Luc Foudy,C,COL,22,25,1,3,4
37,8474013,Ian Cole,D,UTA,35,50,0,4,4
37,8474612,Travis Hamonic,D,OTT,34,48,0,4,4
37,8482201,Gage Goncalves,C,TBL,23,29,0,4,4
37,8482094,Daemon Hunt,D,MIN,22,25,0,4,4
37,8477971,Andreas Englund,D,LAK,28,36,0,4,4
37,8477527,Ross Johnston,L,ANA,30,30,0,4,4
37,8477851,Jordan Oesterle,D,BOS,32,38,0,4,4
37,8482145,Mavrik Bourque,C,DAL,22,47,3,0,3
37,8481006,Tyler Tucker,D,STL,24,14,3,0,3
37,8484911,Collin Graf,R,SJS,22,35,2,1,3
37,8484287,Cole McWard,D,VAN,23,25,2,1,3
37,8482858,Ryker Evans,D,SEA,23,17,2,1,3
37,8481237,Kyle MacLean,C,NYI,25,22,1,2,3
37,8479991,Jake Leschyshyn,C,NYR,25,28,1,2,3
37,8481541,Samuel Bolduc,D,NYI,24,22,1,2,3
37,8482070,Mitchell Chaffee,R,TBL,26,49,1,2,3
37,8478011,Louie Belpedio,D,PHI,28,6,1,2,3
37,8481030,Jack St. Ivany,D,PIT,25,17,1,2,3
37,8477149,Scott Sabourin,R,SJS,32,18,1,2,3
37,8483395,Arshdeep Bains,L,VAN,23,14,1,2,3
37,8482470,Ilya Solovyov,D,CGY,24,17,1,2,3
37,8473446,Erik Johnson,D,PHI,36,45,0,3,3
37,8475177,Calvin de Haan,D,COL,33,52,0,3,3
37,8484258,Sam Malinski,D,COL,26,16,0,3,3
37,8482929,Emil Lilleberg,D,TBL,23,17,0,3,3
37,8481743,Marc Del Gaizo,D,NSH,25,17,0,3,3
37,8477320,Anton Blidh,L,NYR,29,20,0,3,3
37,8482102,Vasily Ponomarev,C,PIT,22,24,0,3,3
37,8480084,Nick DeSimone,D,NJD,30,21,0,3,3
37,8483012,Logan Morrison,C,SEA,22,29,2,0,2
37,8480267,Sammy Walker,C,MIN,25,28,2,0,2
37,8480468,James Hamblin,L,EDM,25,21,2,0,2
37,8480834,Ty Emberson,D,SJS,24,28,1,1,2
37,8482141,Lukas Cormier,D,VGK,22,24,1,1,2
37,8477467,Gustav Olofsson,D,SEA,30,18,1,1,2
37,8480851,Akil Thomas,C,LAK,24,22,1,1,2
37,8481806,Louis Crevier,D,CHI,23,21,1,1,2
37,8481655,Cole Schwindt,R,CGY,23,10,1,1,2
37,8481585,Egor Afanasyev,L,SJS,23,13,1,1,2
37,8478881,Brett Seney,L,CHI,28,13,1,1,2
37,8482153,Brendan Brisson,C,VGK,23,30,0,2,2
37,8482162,Roby Jarventie,L,EDM,22,14,0,2,2
37,8482061,Brandon Biro,L,SEA,26,14,0,2,2
37,8482765,Isak Rosen,R,BUF,21,23,0,2,2
37,8480874,Adam Ginning,D,PHI,24,9,0,2,2
37,8481065,Angus Crookshank,L,OTT,25,20,1,0,1
37,8478477,Mitchell Stephens,C,SEA,27,27,1,0,1
37,8483597,Milos Kelemen,L,UTA,25,12,1,0,1
37,8475795,Dylan McIlrath,D,WSH,32,13,1,0,1
37,8481726,Adam Edstrom,C,NYR,24,6,1,0,1
37,8484255,Jason Polin,R,COL,25,6,1,0,1
37,8482460,Matt Rempe,C,NYR,22,12,1,0,1
37,8482733,Logan Mailloux,D,MTL,31,27,0,1,1
37,8477541,Dakota Mermis,D,TOR,30,6,0,1,1
37,8483512,Matthew Savoie,C,EDM,20,19,0,1,1
37,8481564,Ryan Johnson,D,BUF,23,9,0,1,1
37,8475413,Justin Dowling,C,NJD,34,13,0,1,1
37,8482172,Landon Slaggert,L,CHI,22,13,0,1,1
37,8479421,Jacob Moverare,D,LAK,26,8,0,1,1
37,8479419,Brett Murray,L,BUF,26,20,0,1,1
37,8482787,Nikita Chibrikov,R,WPG,31,5,0,1,1
37,8479330,Brandon Gignac,C,MTL,27,8,0,1,1
37,8474062,Riley Nash,C,NYR,35,16,0,1,1
37,8483432,Luca Del Bel Belluz,C,CBJ,31,1,0,1,1
37,8483401,Marc Johnstone,R,PIT,28,2,0,1,1
37,8484326,Patrik Koch,D,UTA,28,2,0,1,1
37,8483471,Brad Lambert,C,WPG,31,6,0,0,0
37,8477073,Kurtis MacDermid,L,NJD,30,29,0,0,0
37,8478051,Max Willman,C,NJD,29,12,0,0,0
37,8482118,Sam Colangelo,R,ANA,23,14,0,0,0
37,8482165,Yan Kuznetsov,D,CGY,22,13,0,0,0
37,8480032,Shane Bowers,C,NJD,25,10,0,0,0
37,8481543,Nikita Alexandrov,C,STL,24,30,0,0,0
37,8482088,Justin Sourdif,R,FLA,22,19,0,0,0
37,8478446,Glenn Gawdin,C,LAK,27,10,0,0,0
37,8478147,Bokondji Imama,L,PIT,28,1,0,0,0
37,8475755,Alexander Petrovic,D,DAL,32,9,0,0,0
37,8481719,Maxwell Crozier,D,TBL,24,17,0,0,0
37,8481206,John Ludvig,D,PIT,24,13,0,0,0
37,8483489,Fraser Minten,C,TOR,31,8,0,0,0
37,8481462,Mason Morelli,L,VGK,28,11,0,0,0
37,8483920,Pierrick Dube,R,WSH,23,7,0,0,0
37,8484304,Uvis Balinskis,D,FLA,28,11,0,0,0
37,8483531,Brian Halonen,L,NJD,25,1,0,0,0
37,8475780,Chris Wagner,R,COL,33,7,0,0,0
37,8484325,Waltteri Merela,C,TBL,26,17,0,0,0
37,8480823,Alexander Alexeyev,D,WSH,25,6,0,0,0
37,8483546,Marshall Rifai,D,TOR,26,4,0,0,0
37,8483407,Brandon Scanlin,D,NYR,25,3,0,0,0
37,8483567,Georgii Merkulov,C,BOS,24,8,0,0,0
37,8478854,Ryan Shea,D,PIT,27,11,0,0,0
37,8481578,Graeme Clarke,R,MIN,23,13,0,0,0
37,8482476,Emil Heineman,L,MTL,23,6,0,0,0
37,8479522,Hardy Haman Aktell,D,WSH,26,4,0,0,0
37,8481534,Raphael Lavoie,C,EDM,24,1,0,0,0
37,8480306,Grant Hutton,D,NYI,29,6,0,0,0
37,8477993,Justin Kirkland,C,CGY,28,8,0,0,0
37,8483609,Adam Klapka,R,CGY,24,5,0,0,0
37,8476323,Max McCormick,L,SEA,32,1,0,0,0
37,8483045,Cameron Butler,R,CBJ,31,0,0,0,0
37,8482126,Emil Andrae,D,PHI,31,4,0,0,0
37,8483398,Declan Carlile,D,TBL,31,6,0,0,0
37,8478956,Samuel Laberge,L,NJD,27,1,0,0,0
37,8480274,Philip Kemp,D,EDM,25,1,0,0,0
37,8484259,Ondrej Pavel,C,COL,31,3,0,0,0
37,8484321,Nikolas Matinpalo,D,OTT,26,2,0,0,0
37,8470794,Joe Pavelski,C,,40,0,0,0,0
37,8479321,Lucas Johansen,D,,27,0,0,0,0
37,8477950,Tony DeAngelo,D,,29,0,0,0,0
37,8471218,Blake Wheeler,R,,38,0,0,0,0
37,8475197,Tyson Barrie,D,,33,0,0,0,0
37,8474157,Max Pacioretty,L,,36,0,0,0,0
37,8475744,Evgeny Kuznetsov,C,,32,0,0,0,0
37,8474037,James van Riemsdyk,L,,35,0,0,0,0
37,8476907,Mackenzie MacEachern,L,,30,0,0,0,0
37,8480216,Jacob Peterson,C,,25,0,0,0,0
37,8474602,Justin Schultz,D,,34,0,0,0,0
37,8482222,Alexander Barabanov,L,,30,0,0,0,0
37,8474031,Kevin Shattenkirk,D,,35,0,0,0,0
37,8477330,Dominik Kubalik,L,,29,0,0,0,0
37,8480884,Calen Addison,D,,24,0,0,0,0
37,8475906,John Klingberg,D,,32,0,0,0,0
37,8480008,Adam Ruzicka,C,,25,0,0,0,0
37,8476884,Derrick Pouliot,D,,30,0,0,0,0
37,8476919,Chris Tierney,C,,30,0,0,0,0
37,8479415,Michael McLeod,C,,26,0,0,0,0
37,8474870,Tyler Johnson,C,,34,0,0,0,0
37,8470604,Jeff Carter,C,,39,0,0,0,0
37,8478104,Sammy Blais,L,,28,0,0,0,0
37,8474884,Mike Hoffman,C,,35,0,0,0,0
37,8481591,Sam Poulin,R,,23,0,0,0,0
37,8471274,Alex Goligoski,D,,39,0,0,0,0
37,8476871,Tanner Pearson,L,,32,0,0,0,0
37,8476393,Nick Cousins,C,,31,0,0,0,0
37,8479977,Kailer Yamamoto,R,,26,0,0,0,0
37,8479346,Dillon Dube,C,,26,0,0,0,0
37,8480184,Gustav Lindstrom,D,,26,0,0,0,0
37,8479376,Victor Mete,D,,26,0,0,0,0
37,8473449,Kyle Okposo,R,,36,0,0,0,0
37,8481058,Jesse Ylonen,R,,25,0,0,0,0
37,8475752,Tyler Pitlick,C,,33,0,0,0,0
37,8481239,Samuel Fagemo,L,,24,0,0,0,0
37,8480821,Filip Zadina,R,,25,0,0,0,0
37,8470966,Mark Giordano,D,,41,0,0,0,0
37,8478495,Denis Gurianov,R,,27,0,0,0,0
37,8477464,Nic Petan,C,,29,0,0,0,0
37,8478099,Kevin Labanc,R,,29,0,0,0,0
37,8482241,Radim Zohorna,L,,28,0,0,0,0
37,8474040,Sam Gagner,C,,35,0,0,0,0
37,8479514,Rem Pitlick,C,,27,0,0,0,0
37,8478430,Oliver Kylington,D,,27,0,0,0,0
37,8479533,Joona Koppanen,L,,26,0,0,0,0
37,8479984,Cal Foote,D,,26,0,0,0,0
37,8477126,Jayson Megna,C,,34,0,0,0,0
37,8475164,Jakob Silfverberg,R,,34,0,0,0,0
37,8474009,Nick Bonino,C,,36,0,0,0,0
37,8479458,Nikita Zaitsev,D,,33,0,0,0,0
37,8477944,Jakub Vrana,L,,28,0,0,0,0
37,8471699,Andrew Cogliano,C,,37,0,0,0,0
37,8478067,Oskar Lindblom,L,,28,0,0,0,0
37,8471686,Marc Staal,D,,37,0,0,0,0
37,8470610,Zach Parise,L,,40,0,0,0,0
37,8478904,Steven Lorentz,C,,28,0,0,0,0
37,8473473,Milan Lucic,L,,36,0,0,0,0
37,8480031,Maxime Comtois,L,,25,0,0,0,0
37,8478512,Austin Czarnik,C,,32,0,0,0,0
37,8473504,Cal Clutterbuck,R,,37,0,0,0,0
37,8477454,Adam Erne,L,,29,0,0,0,0
37,8479383,Boris Katchouk,L,,26,0,0,0,0
37,8475825,Jani Hakanpää,D,,32,0,0,0,0
37,8477846,Ryan Carpenter,C,,33,0,0,0,0
37,8477930,Pierre-Edouard Bellemare,L,,39,0,0,0,0
37,8478400,Colin White,C,,27,0,0,0,0
37,8480226,Marián Studenic,R,,26,0,0,0,0
37,8480853,Liam Foudy,C,,24,0,0,0,0
37,8475797,Jarred Tinordi,D,,32,0,0,0,0
37,8479423,Alex Nylander,L,,26,0,0,0,0
37,8474618,Marco Scandella,D,,34,0,0,0,0
37,8478028,Fredrik Olofsson,L,,28,0,0,0,0
37,8474709,Matt Martin,L,,35,0,0,0,0
37,8481070,Hugh McGing,L,,26,0,0,0,0
37,8479546,Oskar Steen,C,,26,0,0,0,0
37,8474145,Robert Bortuzzo,D,,35,0,0,0,0
37,8476915,Jujhar Khaira,L,,30,0,0,0,0
37,8475278,Byron Froese,C,,33,0,0,0,0
37,8481812,Nikolai Knyzhov,D,,27,0,0,0,0
37,8478408,Travis Dermott,D,,28,0,0,0,0
37,8481077,John Leonard,L,,26,0,0,0,0
37,8479547,Matthew Phillips,R,,26,0,0,0,0
37,8480836,Jonathan Gruden,C,,24,0,0,0,0
37,8481690,Tyler Angle,C,,24,0,0,0,0
37,8475766,Austin Watson,L,,32,0,0,0,0
37,8481016,Ruslan Iskhakov,C,,24,0,0,0,0
37,8478078,Rourke Chartier,C,,28,0,0,0,0
37,8480776,Sheldon Rempal,R,,29,0,0,0,0
37,8484314,Jiri Smejkal,L,,28,0,0,0,0
38,8477492,Nathan MacKinnon,C,COL,29,81,50,93,143
38,8478402,Connor McDavid,C,EDM,27,78,39,95,134
38,8476453,Nikita Kucherov,R,TBL,31,82,33,98,131
38,8481559,Jack Hughes,C,NJD,23,79,47,72,119
38,8479318,Auston Matthews,C,TOR,27,81,66,51,117
38,8478420,Mikko Rantanen,R,COL,28,81,58,59,117
38,8480800,Quinn Hughes,D,VAN,25,76,18,98,116
38,8477939,William Nylander,R,TOR,28,81,49,66,115
38,8477942,Kevin Fiala,L,LAK,28,81,41,74,115
38,8478864,Kirill Kaprizov,L,MIN,27,74,53,55,108
38,8477956,David Pastrnak,R,BOS,28,81,49,58,107
38,8477934,Leon Draisaitl,C,EDM,29,79,49,57,106
38,8478483,Mitch Marner,R,TOR,27,79,33,73,106
38,8477493,Aleksander Barkov,C,FLA,29,80,27,79,106
38,8477946,Dylan Larkin,C,DET,28,79,35,69,104
38,8476887,Filip Forsberg,L,NSH,30,76,50,50,100
38,8476460,Mark Scheifele,C,WPG,31,68,48,51,99
38,8476468,J.T. Miller,C,VAN,31,74,34,63,97
38,8478550,Artemi Panarin,L,NYR,33,73,28,69,97
38,8479314,Matthew Tkachuk,L,FLA,27,79,30,66,96
38,8477951,Nick Schmaltz,C,UTA,28,77,31,64,95
38,8471675,Sidney Crosby,C,PIT,37,73,44,49,93
38,8477404,Jake Guentzel,C,TBL,30,82,39,54,93
38,8480801,Brady Tkachuk,L,OTT,25,80,39,52,91
38,8480027,Jason Robertson,L,DAL,25,82,31,60,91
38,8476456,Jonathan Huberdeau,C,CGY,31,78,28,61,89
38,8477409,Carter Verhaeghe,C,FLA,29,80,48,40,88
38,8480023,Robert Thomas,C,STL,25,74,36,51,87
38,8477933,Sam Reinhart,C,FLA,29,77,48,38,86
38,8481557,Matt Boldy,L,MIN,23,72,38,47,85
38,8477501,Valeri Nichushkin,R,COL,29,81,38,46,84
38,8480012,Elias Pettersson,C,VAN,26,75,33,51,84
38,8474578,Erik Karlsson,D,PIT,34,81,24,60,84
38,8474600,Roman Josi,D,NSH,34,72,15,69,84
38,8474141,Patrick Kane,R,DET,36,81,36,47,83
38,8475786,Zach Hyman,L,EDM,32,78,50,31,81
38,8480069,Cale Makar,D,COL,26,70,21,60,81
38,8479323,Adam Fox,D,NYR,26,78,20,61,81
38,8471215,Evgeni Malkin,C,PIT,38,76,26,54,80
38,8478445,Mathew Barzal,C,NYI,27,78,19,61,80
38,8480865,Noah Dobson,D,NYI,24,80,13,67,80
38,8477500,Bo Horvat,C,NYI,29,81,43,36,79
38,8477402,Pavel Buchnevich,L,STL,29,76,38,41,79
38,8475166,John Tavares,C,TOR,34,77,35,44,79
38,8477960,Adrian Kempe,R,LAK,28,77,33,46,79
38,8477949,Alex Tuch,R,BUF,28,76,26,53,79
38,8476539,Jonathan Marchessault,R,NSH,34,77,42,36,78
38,8475172,Nazem Kadri,C,CGY,34,79,28,50,78
38,8480002,Nico Hischier,C,NJD,25,77,25,53,78
38,8478010,Brayden Point,C,TBL,28,82,35,42,77
38,8482116,Tim Stützle,C,OTT,22,78,30,47,77
38,8479407,Jesper Bratt,L,NJD,26,77,35,41,76
38,8478444,Brock Boeser,R,VAN,27,75,32,44,76
38,8475913,Mark Stone,R,VGK,32,74,26,50,76
38,8478439,Travis Konecny,R,PHI,27,73,24,52,76
38,8479343,Clayton Keller,R,UTA,26,78,37,38,75
38,8479385,Jordan Kyrou,C,STL,26,77,33,42,75
38,8475184,Chris Kreider,L,NYR,33,78,42,32,74
38,8480018,Nick Suzuki,C,MTL,25,78,33,41,74
38,8478403,Jack Eichel,C,VGK,28,78,30,44,74
38,8473419,Brad Marchand,L,BOS,36,81,24,48,72
38,8477940,Nikolaj Ehlers,L,WPG,28,69,19,53,72
38,8478449,Roope Hintz,C,DAL,28,82,28,43,71
38,8475810,Bryan Rust,R,PIT,32,73,23,48,71
38,8480208,Drake Batherson,R,OTT,26,80,21,50,71
38,8475692,Mats Zuccarello,R,MIN,37,74,14,57,71
38,8479337,Alex DeBrincat,R,DET,27,80,36,34,70
38,8474564,Steven Stamkos,C,NSH,34,75,34,36,70
38,8471685,Anze Kopitar,C,LAK,37,82,29,41,70
38,8475158,Ryan O'Reilly,C,NSH,33,70,23,47,70
38,8477935,Sam Bennett,C,FLA,28,80,34,35,69
38,8478398,Kyle Connor,L,WPG,28,74,31,38,69
38,8484144,Connor Bedard,C,CHI,19,59,30,39,69
38,8475168,Matt Duchene,C,DAL,33,82,23,46,69
38,8475765,Vladimir Tarasenko,R,DET,33,82,23,46,69
38,8475151,Kyle Palmieri,C,NYI,33,80,30,38,68
38,8479675,Trevor Moore,L,LAK,29,82,29,39,68
38,8478414,Timo Meier,R,NJD,28,78,29,39,68
38,8477504,Josh Morrissey,D,WPG,29,73,13,55,68
38,8479325,Charlie McAvoy,D,BOS,27,79,11,57,68
38,8478975,Mason Marchment,L,DAL,29,81,27,40,67
38,8478493,Joel Eriksson Ek,C,MIN,27,69,26,41,67
38,8475167,Victor Hedman,D,TBL,34,76,13,54,67
38,8476454,Ryan Nugent-Hopkins,C,EDM,31,80,15,51,66
38,8476881,Tomas Hertl,C,VGK,31,76,29,36,65
38,8480803,Evan Bouchard,D,EDM,25,71,14,51,65
38,8473512,Claude Giroux,R,OTT,36,80,20,44,64
38,8475784,Jeff Skinner,C,EDM,32,79,34,29,63
38,8476389,Vincent Trocheck,C,NYR,31,77,27,36,63
38,8476459,Mika Zibanejad,C,NYR,31,76,22,41,63
38,8478460,Zach Werenski,D,CBJ,27,78,22,41,63
38,8475794,Tyler Seguin,C,DAL,32,82,22,41,63
38,8478440,Dylan Strome,C,WSH,27,72,16,47,63
38,8476853,Morgan Rielly,D,TOR,30,72,11,52,63
38,8479420,Tage Thompson,C,BUF,27,73,34,28,62
38,8478474,Lawson Crouse,L,UTA,27,79,25,37,62
38,8480036,Miro Heiskanen,D,DAL,25,75,11,51,62
38,8480015,Owen Tippett,R,PHI,25,77,31,30,61
38,8475726,Tyler Toffoli,C,SJS,32,68,28,33,61
38,8482093,Seth Jarvis,C,CAR,22,71,32,28,60
38,8475754,Brock Nelson,C,NYI,33,78,27,33,60
38,8478427,Sebastian Aho,C,CAR,27,66,26,34,60
38,8480830,Andrei Svechnikov,R,CAR,24,70,23,37,60
38,8482078,Lucas Raymond,L,DET,22,82,23,37,60
38,8482665,Matty Beniers,C,SEA,22,77,23,37,60
38,8482124,Quinton Byfield,R,LAK,22,77,21,39,60
38,8482149,Cole Perfetti,C,WPG,22,73,26,33,59
38,8476479,Phillip Danault,C,LAK,31,81,23,36,59
38,8481540,Cole Caufield,R,MTL,23,75,28,30,58
38,8481068,Yegor Sharangovich,C,CGY,26,78,24,34,58
38,8478498,Jake DeBrusk,L,VAN,28,76,30,27,57
38,8477407,Anthony Duclair,L,NYI,29,80,23,34,57
38,8474679,Gustav Nyquist,C,NSH,35,74,21,36,57
38,8482699,Dylan Guenther,R,UTA,21,77,28,28,56
38,8480849,Barrett Hayton,C,UTA,24,71,28,28,56
38,8478856,Conor Garland,R,VAN,28,71,25,31,56
38,8477496,Elias Lindholm,C,BOS,30,77,25,31,56
38,8480839,Rasmus Dahlin,D,BUF,24,67,16,40,56
38,8478038,Devon Toews,D,COL,30,71,11,45,56
38,8477503,Max Domi,C,TOR,29,78,22,33,55
38,8484166,Adam Fantilli,C,CBJ,20,69,22,33,55
38,8474150,Mikael Backlund,C,CGY,35,77,18,37,55
38,8471724,Kris Letang,D,PIT,37,80,17,38,55
38,8476346,Johnny Gaudreau,L,CBJ,31,72,13,42,55
38,8475170,Brayden Schenn,C,STL,33,74,23,31,54
38,8475169,Evander Kane,L,EDM,33,75,23,31,54
38,8481703,Valtteri Puustinen,R,PIT,25,65,14,40,54
38,8479999,Casey Mittelstadt,C,COL,26,81,12,42,54
38,8474563,Drew Doughty,D,LAK,35,68,7,47,54
38,8473994,Jamie Benn,L,DAL,35,79,22,31,53
38,8478438,Tommy Novak,C,NSH,27,65,19,34,53
38,8477986,Brandon Montour,D,SEA,30,70,18,35,53
38,8478407,Vince Dunn,D,SEA,28,72,10,43,53
38,8478397,Rasmus Andersson,D,CGY,28,76,9,44,53
38,8478047,Michael Bunting,L,PIT,29,75,17,35,52
38,8481533,Trevor Zegras,C,ANA,23,74,17,35,52
38,8481542,Moritz Seider,D,DET,23,77,11,41,52
38,8471214,Alex Ovechkin,L,WSH,39,75,30,21,51
38,8479542,Brandon Hagel,L,TBL,26,81,24,27,51
38,8479525,Ross Colton,C,COL,28,79,23,28,51
38,8477497,Sean Monahan,C,CBJ,30,72,21,30,51
38,8475798,Mikael Granlund,C,SJS,32,73,14,37,51
38,8476792,Torey Krug,D,STL,33,73,9,42,51
38,8480064,Josh Norris,C,OTT,25,75,28,22,50
38,8477494,Jonathan Drouin,L,COL,29,81,17,33,50
38,8482113,Anton Lundell,C,FLA,23,76,17,33,50
38,8476875,Mike Matheson,D,MTL,30,71,7,43,50
38,8482740,Wyatt Johnston,C,DAL,21,80,29,20,49
38,8477998,Warren Foegele,L,LAK,28,80,27,22,49
38,8473986,Alex Killorn,L,ANA,35,74,26,23,49
38,8477456,J.T. Compher,L,DET,29,77,26,23,49
38,8478519,Anthony Cirelli,C,TBL,27,82,25,24,49
38,8477451,Ryan Hartman,R,MIN,30,68,24,25,49
38,8474641,Adam Henrique,C,EDM,34,77,21,28,49
38,8474102,David Perron,L,OTT,36,79,21,28,49
38,8476905,Chandler Stephenson,C,SEA,30,75,17,32,49
38,8481711,Matias Maccelli,L,UTA,24,69,11,38,49
38,8476906,Shayne Gostisbehere,D,CAR,31,76,11,38,49
38,8481560,Arthur Kaliyev,R,LAK,23,78,24,24,48
38,8477416,Oliver Bjorkstrand,R,SEA,29,71,23,25,48
38,8475722,Jason Zucker,L,BUF,32,73,23,25,48
38,8480039,Martin Necas,C,CAR,25,74,20,28,48
38,8476462,Dougie Hamilton,D,NJD,31,78,16,32,48
38,8477021,Alex Kerfoot,C,UTA,30,72,15,33,48
38,8475768,Jaden Schwartz,C,SEA,32,67,15,33,48
38,8477932,Aaron Ekblad,D,FLA,28,69,13,35,48
38,8476438,Brandon Saad,L,STL,32,75,23,24,47
38,8476399,Blake Coleman,C,CGY,33,78,20,27,47
38,8476882,Teuvo Teravainen,C,CHI,30,67,17,30,47
38,8481577,Philip Tomasino,C,NSH,23,66,17,30,47
38,8478042,Viktor Arvidsson,L,EDM,31,75,14,33,47
38,8482055,Drew O'Connor,L,PIT,26,75,29,17,46
38,8477476,Artturi Lehkonen,L,COL,29,82,22,24,46
38,8476432,Boone Jenner,C,CBJ,31,70,22,24,46
38,8479400,Pierre-Luc Dubois,L,WSH,26,71,21,25,46
38,8479992,Michael Rasmussen,C,DET,25,77,18,28,46
38,8481528,Dylan Cozens,C,BUF,23,69,17,29,46
38,8478458,John (Jack) Roslovic,C,CAR,27,70,16,30,46
38,8483515,Juraj Slafkovsky,L,MTL,20,75,15,31,46
38,8480188,Fabian Zetterlund,L,SJS,25,72,15,31,46
38,8478401,Pavel Zacha,C,BOS,27,77,20,25,45
38,8480797,Joel Farabee,L,PHI,24,74,18,27,45
38,8475191,Reilly Smith,R,NYR,33,75,18,27,45
38,8470613,Brent Burns,D,CAR,39,77,14,31,45
38,8479425,Filip Hronek,D,VAN,27,73,11,34,45
38,8483808,Andrei Kuzmenko,L,CGY,28,74,24,20,44
38,8481618,Alex Newhook,C,MTL,23,73,20,24,44
38,8475745,Charlie Coyle,C,BOS,32,78,19,25,44
38,8481596,Shane Pinto,C,OTT,24,73,18,26,44
38,8478046,Danton Heinen,L,VAN,29,70,18,26,44
38,8476869,Brady Skjei,D,NSH,30,73,11,33,44
38,8480434,Sean Durzi,D,UTA,26,71,10,34,44
38,8471698,T.J. Oshie,R,WSH,38,71,28,15,43
38,8482159,Tyson Foerster,R,PHI,22,73,27,16,43
38,8482745,Mason McTavish,C,ANA,21,75,24,19,43
38,8476448,William Karlsson,C,VGK,31,76,22,21,43
38,8478542,Evan Rodrigues,C,FLA,31,74,17,26,43
38,8474586,Jordan Eberle,R,SEA,34,74,17,26,43
38,8475763,Kevin Hayes,R,PIT,32,66,17,26,43
38,8483431,Logan Cooley,C,UTA,20,74,16,27,43
38,8478466,Daniel Sprong,R,VAN,27,66,12,31,43
38,8478469,Thomas Chabot,D,OTT,27,73,11,32,43
38,8482109,Alexis Lafrenière,L,NYR,23,75,25,17,42
38,8477511,Anthony Mantha,R,CGY,30,77,22,20,42
38,8474149,Evgenii Dadonov,R,DAL,35,79,20,22,42
38,8482092,Ridly Greig,C,OTT,22,76,19,23,42
38,8480835,Jack Drury,C,CAR,24,68,17,25,42
38,8475200,Dmitry Orlov,D,CAR,33,70,14,28,42
38,8484145,Zach Benson,L,BUF,19,67,13,29,42
38,8482122,Brock Faber,D,MIN,22,80,6,36,42
38,8482702,Logan Stankoven,C,DAL,21,80,25,16,41
38,8478366,Frank Vatrano,R,ANA,30,70,18,23,41
38,8480078,Filip Chytil,C,NYR,25,69,18,23,41
38,8476826,Yanni Gourde,C,SEA,33,72,17,24,41
38,8475760,Nick Bjugstad,C,UTA,32,75,16,25,41
38,8474053,Logan Couture,C,SJS,35,63,16,25,41
38,8479339,Patrik Laine,L,CBJ,26,70,11,30,41
38,8476458,Ryan Strome,C,ANA,31,75,11,30,41
38,8478055,Gustav Forsling,D,FLA,28,72,9,32,41
38,8482105,Jake Sanderson,D,OTT,22,73,8,33,41
38,8482712,Oskar Olausson,R,COL,22,79,4,37,41
38,8480798,Philipp Kurashev,C,CHI,25,67,19,21,40
38,8484153,Leo Carlsson,C,ANA,20,74,18,22,40
38,8476483,Rickard Rakell,R,PIT,31,69,18,22,40
38,8479410,Mikhail Sergachev,D,UTA,26,68,7,33,40
38,8476958,Jaccob Slavin,D,CAR,30,73,7,33,40
38,8475799,Nino Niederreiter,R,WPG,32,68,21,18,39
38,8475314,Anders Lee,L,NYI,34,77,17,22,39
38,8478115,Pierre Engvall,L,NYI,28,76,17,22,39
38,8477955,Jared McCann,L,SEA,28,67,15,24,39
38,8480068,Ryan Poehling,C,PHI,25,72,14,25,39
38,8478233,Andrew Mangiapane,L,WSH,28,67,13,26,39
38,8478462,Nicolas Roy,C,VGK,27,75,12,27,39
38,8479987,Morgan Geekie,C,BOS,26,80,11,28,39
38,8477444,Andre Burakovsky,L,SEA,29,70,11,28,39
38,8484203,Bradly Nadeau,L,CAR,19,69,10,29,39
38,8474590,John Carlson,D,WSH,34,67,8,31,39
38,8482684,Luke Hughes,D,NJD,21,73,7,32,39
38,8475218,Mattias Ekholm,D,EDM,34,77,7,32,39
38,8482667,William Eklund,L,SJS,22,63,16,22,38
38,8482133,Thomas Bordeleau,C,SJS,22,64,14,24,38
38,8477505,Alexander Wennberg,C,SJS,30,64,13,25,38
38,8482720,Matthew Knies,L,TOR,22,75,11,27,38
38,8476474,Stefan Noesen,R,NJD,31,66,21,16,37
38,8481604,Pavel Dorofeyev,L,VGK,24,70,20,17,37
38,8480802,Ryan McLeod,C,BUF,25,69,19,18,37
38,8477964,Ivan Barbashev,C,VGK,29,76,18,19,37
38,8479661,Tanner Jeannot,L,LAK,27,80,17,20,37
38,8482705,Cole Sillinger,C,CBJ,21,61,16,21,37
38,8479365,Trent Frederic,C,BOS,26,70,15,22,37
38,8476463,Jonas Brodin,D,MIN,31,78,12,25,37
38,8476854,Hampus Lindholm,D,BOS,30,75,9,28,37
38,8474715,Cameron Atkinson,R,TBL,35,82,19,17,36
38,8482146,Luke Evangelista,R,NSH,22,67,16,20,36
38,8478472,Mathieu Joseph,R,STL,27,70,13,23,36
38,8476872,Scott Laughton,C,PHI,30,71,11,25,36
38,8477947,Sonny Milano,L,WSH,28,67,11,25,36
38,8480871,Adam Boqvist,D,FLA,24,71,11,25,36
38,8477479,Tyler Bertuzzi,L,CHI,29,69,8,28,36
38,8475181,Nick Leddy,D,STL,33,73,1,35,36
38,8476419,Jean-Gabriel Pageau,C,NYI,32,76,22,13,35
38,8477426,Nicholas Paul,L,TBL,29,81,18,17,35
38,8476880,Tom Wilson,R,WSH,30,57,18,17,35
38,8482097,Jack Quinn,R,BUF,23,69,17,18,35
38,8476927,Teddy Blueger,C,VAN,30,65,15,20,35
38,8481524,Bowen Byram,D,BUF,23,67,12,23,35
38,8477346,MacKenzie Weegar,D,CGY,30,72,11,24,35
38,8477447,Shea Theodore,D,VGK,29,62,10,25,35
38,8478891,Mason Appleton,C,WPG,28,62,10,25,35
38,8480336,Sean Walker,D,CAR,30,71,10,25,35
38,8482671,Owen Power,D,BUF,22,74,6,29,35
38,8477948,Travis Sanheim,D,PHI,28,73,4,31,35
38,8480014,Gabriel Vilardi,C,WPG,25,67,21,13,34
38,8482624,Daniil Miromanov,D,CGY,27,62,13,21,34
38,8477839,Conor Sheary,L,TBL,32,80,12,22,34
38,8483505,Matthew Poitras,C,BOS,20,78,11,23,34
38,8481581,Thomas Harley,D,DAL,23,73,11,23,34
38,8480145,Neal Pionk,D,WPG,29,72,9,25,34
38,8473563,Nicklas Backstrom,C,WSH,37,57,9,25,34
38,8477969,Marcus Pettersson,D,PIT,28,76,8,26,34
38,8474565,Alex Pietrangelo,D,VGK,34,61,6,28,34
38,8481535,Nils Hoglander,L,VAN,24,61,20,13,33
38,8474189,Lars Eller,C,PIT,35,62,17,16,33
38,8482117,Lukas Reichel,L,CHI,22,60,15,18,33
38,8482074,Connor Zary,C,CGY,23,64,15,18,33
38,8478463,Anthony Beauvillier,L,PIT,27,63,14,19,33
38,8475149,Marcus Johansson,L,MIN,34,59,11,22,33
38,8477498,Darnell Nurse,D,EDM,29,69,10,23,33
38,8476923,Damon Severson,D,CBJ,30,79,9,24,33
38,8475753,Justin Faulk,D,STL,32,73,7,26,33
38,8477495,Seth Jones,D,CHI,30,65,7,26,33
38,8477425,Miles Wood,L,COL,29,80,18,14,32
38,8475793,Ryan Johansen,C,PHI,32,70,17,15,32
38,8480813,Joe Veleno,C,DET,24,76,16,16,32
38,8482809,Jackson Blake,R,CAR,21,56,15,17,32
38,8475193,Tomas Tatar,L,NJD,34,68,12,20,32
38,8480829,Jesperi Kotkaniemi,C,CAR,24,60,11,21,32
38,8478873,Troy Terry,R,ANA,27,69,10,22,32
38,8476461,Sean Couturier,C,PHI,32,71,10,22,32
38,8479351,Sam Steel,C,DAL,26,79,10,22,32
38,8480246,Nick Perbix,D,TBL,26,75,6,26,32
38,8478882,Vladislav Gavrikov,D,LAK,29,68,3,29,32
38,8479619,Michael Carcone,L,UTA,28,64,21,10,31
38,8480893,Kirill Marchenko,R,CBJ,24,65,19,12,31
38,8483524,Shane Wright,C,SEA,20,66,17,14,31
38,8478020,Michael Amadio,R,OTT,28,75,14,17,31
38,8475287,Erik Haula,L,NJD,33,62,13,18,31
38,8474716,Jared Spurgeon,D,MIN,35,77,13,18,31
38,8475848,Brendan Gallagher,R,MTL,32,69,11,20,31
38,8476292,Ondrej Palat,L,NJD,33,65,10,21,31
38,8478970,Jalen Chatfield,D,CAR,28,74,9,22,31
38,8482475,Yegor Chinakhov,R,CBJ,23,66,18,12,30
38,8482110,Dawson Mercer,C,NJD,23,71,17,13,30
38,8480459,Pius Suter,C,VAN,28,73,16,14,30
38,8479591,Michael Eyssimont,C,TBL,28,79,15,15,30
38,8476925,Colton Sissons,C,NSH,31,63,15,15,30
38,8478057,Dakota Joshua,C,VAN,28,66,14,16,30
38,8482660,Kent Johnson,C,CBJ,22,64,12,18,30
38,8476480,Vladislav Namestnikov,C,WPG,32,71,11,19,30
38,8476981,Josh Anderson,R,MTL,30,62,11,19,30
38,8481582,Nicholas Robertson,L,TOR,23,69,10,20,30
38,8474574,Tyler Myers,D,VAN,34,71,6,24,30
38,8479393,Noah Gregor,L,OTT,26,76,19,10,29
38,8479353,Brett Howden,C,VGK,26,67,13,16,29
38,8475714,Calle Jarnkrok,C,TOR,33,72,12,17,29
38,8481523,Kirby Dach,C,MTL,23,66,11,18,29
38,8483482,Tristan Luneau,D,ANA,20,58,10,19,29
38,8480028,Morgan Frost,C,PHI,25,77,9,20,29
38,8476312,Josh Manson,D,COL,33,65,8,21,29
38,8478396,Noah Hanifin,D,VGK,27,65,4,25,29
38,8483490,Pavel Mintyukov,D,ANA,21,76,4,25,29
38,8478507,John Marino,D,UTA,27,60,3,26,29
38,8477952,Robby Fabbri,C,ANA,28,66,18,10,28
38,8482089,Jake Neighbours,L,STL,22,64,17,11,28
38,8476897,Oskar Sundqvist,C,STL,30,70,14,14,28
38,8477429,Andrew Copp,C,DET,30,80,12,16,28
38,8478109,Victor Olofsson,L,VGK,29,70,11,17,28
38,8482101,Danil Gushchin,L,SJS,22,55,10,18,28
38,8476392,Adam Lowry,C,WPG,31,68,10,18,28
38,8477919,Frederick Gaudreau,C,MIN,31,70,9,19,28
38,8479345,Jakob Chychrun,D,WSH,26,62,8,20,28
38,8480003,Jesper Boqvist,C,FLA,26,75,8,20,28
38,8482067,Connor Mackey,D,NYR,28,65,7,21,28
38,8476979,Erik Gustafsson,D,DET,32,78,5,23,28
38,8479402,Jake Bean,D,CGY,26,67,5,23,28
38,8479976,Juuso Valimaki,D,UTA,26,62,5,23,28
38,8475171,Oliver Ekman-Larsson,D,TOR,33,70,4,24,28
38,8482259,Bobby McMann,C,TOR,28,62,15,12,27
38,8480855,Jack McBain,C,UTA,24,68,13,14,27
38,8479390,Taylor Raddysh,R,WSH,26,67,13,14,27
38,8480185,Eetu Luostarinen,C,FLA,26,73,12,15,27
38,8473422,Nick Foligno,L,CHI,37,57,12,15,27
38,8470621,Corey Perry,R,EDM,39,71,11,16,27
38,8476917,Adam Pelech,D,NYI,30,80,2,25,27
38,8479398,Samuel Girard,D,COL,26,61,1,26,27
38,8480009,Eeli Tolvanen,R,SEA,25,71,14,12,26
38,8476278,Colin Blackwell,C,DAL,31,79,14,12,26
38,8482749,Joshua Roy,R,MTL,21,66,14,12,26
38,8479316,Luke Kunin,C,SJS,27,59,13,13,26
38,8482737,Zack Bolduc,C,STL,21,55,12,14,26
38,8477987,Ryan Donato,C,CHI,28,62,11,15,26
38,8475791,Taylor Hall,L,CHI,33,64,8,18,26
38,8482655,Janis Moser,D,TBL,24,76,6,20,26
38,8478416,Erik Cernak,D,TBL,27,79,4,22,26
38,8473507,Jeff Petry,D,DET,37,74,3,23,26
38,8475764,Cam Fowler,D,ANA,33,70,3,23,26
38,8476878,Zemgus Girgensons,C,TBL,30,79,11,14,25
38,8482111,Justin Barron,D,MTL,23,64,10,15,25
38,8482175,JJ Peterka,R,BUF,22,71,9,16,25
38,8481606,Jordan Spence,D,LAK,23,71,5,20,25
38,8477506,Ryan Pulock,D,NYI,30,76,4,21,25
38,8480891,Michael Kesselring,D,UTA,24,64,4,21,25
38,8482245,Artem Zub,D,OTT,29,74,3,22,25
38,8480049,Dylan Samberg,D,WPG,25,67,3,22,25
38,8481186,Logan O'Connor,R,COL,28,77,13,11,24
38,8476469,Joel Armia,R,MTL,31,64,13,11,24
38,8482079,Marco Rossi,C,MIN,23,60,13,11,24
38,8480281,Alexey Toropchenko,R,STL,25,57,11,13,24
38,8476374,Sean Kuraly,C,CBJ,31,55,11,13,24
38,8476889,Radek Faksa,C,STL,30,56,11,13,24
38,8477353,Tyler Motte,C,DET,29,74,10,14,24
38,8479414,Nathan Bastian,R,NJD,27,62,10,14,24
38,8475231,Casey Cizikas,C,NYI,33,72,9,15,24
38,8480043,Timothy Liljegren,D,TOR,25,61,5,19,24
38,8478911,Matt Roy,D,WSH,29,66,4,20,24
38,8477488,Brett Pesce,D,NJD,30,72,4,20,24
38,8480873,Rasmus Sandin,D,WSH,24,73,3,21,24
38,8478136,Jake Middleton,D,MIN,28,79,2,22,24
38,8478500,Ivan Provorov,D,CBJ,27,81,1,23,24
38,8482125,Alexander Holtz,R,VGK,22,64,14,9,23
38,8475220,Marcus Foligno,L,MIN,33,62,14,9,23
38,8483493,Frank Nazar,C,CHI,20,57,12,11,23
38,8481553,Bobby Brink,R,PHI,23,63,12,11,23
38,8475343,Nic Dowd,C,WSH,34,60,11,12,23
38,8478432,Christian Fischer,R,DET,27,74,10,13,23
38,8478413,Jordan Greenway,L,BUF,27,61,9,14,23
38,8481656,Aliaksei Protas,C,WSH,23,63,7,16,23
38,8476422,Mike Reilly,D,NYI,31,78,7,16,23
38,8483499,Liam Ohgren,L,MIN,20,63,7,16,23
38,8481546,Cam York,D,PHI,23,69,6,17,23
38,8480878,Nils Lundkvist,D,DAL,24,75,6,17,23
38,8481014,Alexander Romanov,D,NYI,24,74,5,18,23
38,8476879,Cody Ceci,D,EDM,31,71,2,21,23
38,8477478,William Carrier,L,CAR,30,58,17,5,22
38,8479941,Justin Danforth,R,CBJ,31,60,13,9,22
38,8481624,Ilya Mikheyev,R,CHI,30,52,11,11,22
38,8479293,Brandon Tanev,L,SEA,33,60,11,11,22
38,8481554,Kaapo Kakko,R,NYR,23,72,9,13,22
38,8476921,Jordan Martinook,L,CAR,32,68,9,13,22
38,8480144,David Kampf,C,TOR,29,74,9,13,22
38,8473533,Jordan Staal,C,CAR,36,66,9,13,22
38,8477953,Kasperi Kapanen,R,STL,28,68,8,14,22
38,8477406,Mattias Janmark,C,EDM,32,66,7,15,22
38,8478133,Jake Evans,C,MTL,28,67,6,16,22
38,8478013,Jake Walman,D,SJS,28,69,6,16,22
38,8476892,Colton Parayko,D,STL,31,73,5,17,22
38,8479718,Alex Barré-Boulet,C,MTL,27,54,5,17,22
38,8476856,Mathew Dumba,D,DAL,30,69,4,18,22
38,8475790,Erik Gudbranson,D,CBJ,32,73,3,19,22
38,8476931,Jake McCabe,D,TOR,31,70,2,20,22
38,8480817,K'Andre Miller,D,NYR,24,69,1,21,22
38,8480222,Sebastian Aho,D,PIT,28,72,1,21,22
38,8480113,Alex Iafallo,L,WPG,31,64,16,5,21
38,8481477,Nico Sturm,C,SJS,29,61,14,7,21
38,8478569,Noel Acciari,C,PIT,33,57,11,10,21
38,8481580,Connor McMichael,C,WSH,23,65,10,11,21
38,8480448,Parker Kelly,L,COL,25,76,10,11,21
38,8479344,Jesse Puljujarvi,R,PIT,26,58,10,11,21
38,8476918,Jimmy Vesey,L,NYR,31,67,9,12,21
38,8473453,Trevor Lewis,C,LAK,37,74,9,12,21
38,8481441,Joe Snively,C,DET,28,65,9,12,21
38,8480220,Noah Cates,L,PHI,25,69,7,14,21
38,8483457,Lane Hutson,D,MTL,20,63,6,15,21
38,8477369,Carson Soucy,D,VAN,30,64,6,15,21
38,8483565,Nick Blankenburg,D,NSH,26,65,6,15,21
38,8479998,Mikey Anderson,D,LAK,25,67,5,16,21
38,8480073,Erik Brannstrom,D,COL,25,63,5,16,21
38,8474567,Zach Bogosian,D,MIN,34,69,3,18,21
38,8482496,Nils Aman,C,VAN,24,48,15,5,20
38,8479336,Carl Grundstrom,R,SJS,27,52,11,9,20
38,8481641,Joel Kiviranta,L,COL,28,74,11,9,20
38,8477392,Hudson Fasching,R,NYI,29,63,9,11,20
38,8476329,Travis Boyd,C,MIN,31,50,8,12,20
38,8483445,Cutter Gauthier,L,ANA,20,61,7,13,20
38,8479026,Philippe Myers,D,TOR,27,58,7,13,20
38,8481521,Ronnie Attard,D,PHI,25,52,6,14,20
38,8481522,Peyton Krebs,C,BUF,23,56,6,14,20
38,8481032,Paul Cotter,C,NJD,25,60,5,15,20
38,8476885,Jacob Trouba,D,NYR,30,71,4,16,20
38,8475462,Radko Gudas,D,ANA,34,65,4,16,20
38,8476331,Dylan DeMelo,D,WPG,31,65,3,17,20
38,8478851,Alexandre Carrier,D,NSH,28,65,1,19,20
38,8481601,Simon Holmstrom,R,NYI,23,66,14,5,19
38,8479996,Cody Glass,C,NSH,25,59,11,8,19
38,8476873,Mark Jankowski,C,NSH,30,55,10,9,19
38,8481028,Martin Pospisil,C,CGY,25,61,10,9,19
38,8477380,Jonny Brodzinski,C,NYR,31,51,9,10,19
38,8479368,Max Jones,L,BOS,26,63,9,10,19
38,8476624,Barclay Goodrow,C,SJS,31,52,8,11,19
38,8482142,Jamie Drysdale,D,PHI,22,58,7,12,19
38,8480980,Connor Dewar,C,TOR,25,63,7,12,19
38,8480762,Eric Robinson,L,CAR,29,57,5,14,19
38,8479982,Conor Timmins,D,TOR,26,54,5,14,19
38,8476467,Jamie Oleksiak,D,SEA,32,66,5,14,19
38,8479371,Dante Fabbro,D,NSH,26,57,4,15,19
38,8475279,Ben Chiarot,D,DET,33,70,4,15,19
38,8475225,Craig Smith,C,CHI,35,55,10,8,18
38,8479066,Ryan Lomberg,L,CGY,30,66,10,8,18
38,8479359,Beck Malenstyn,L,BUF,26,50,10,8,18
38,8479543,Michael Pezzetta,L,MTL,26,51,10,8,18
38,8478043,Sam Lafferty,C,BUF,29,54,9,9,18
38,8482803,Olen Zellweger,D,ANA,21,63,7,11,18
38,8476457,Adam Larsson,D,SEA,32,72,7,11,18
38,8482166,Shakir Mukhamadullin,D,SJS,22,56,7,11,18
38,8477450,Jason Dickinson,C,CHI,29,55,6,12,18
38,8479639,Dylan Coghlan,D,WPG,26,62,5,13,18
38,8479324,Ryan Lindgren,D,NYR,26,62,5,13,18
38,8481568,Alex Vlasic,D,CHI,23,59,4,14,18
38,8475233,David Savard,D,MTL,34,67,2,16,18
38,8474151,Ryan McDonagh,D,TBL,35,77,1,17,18
38,8478508,Yakov Trenin,C,MIN,27,51,12,5,17
38,8482157,Will Cuylle,L,NYR,22,61,11,6,17
38,8479520,Brandon Duhaime,R,WSH,27,56,11,6,17
38,8482679,Matt Coronato,R,CGY,22,66,10,7,17
38,8476822,Luke Glendening,C,TBL,35,80,10,7,17
38,8477015,Connor Brown,R,EDM,30,63,8,9,17
38,8477446,Michael McCarron,R,NSH,29,57,8,9,17
38,8478434,Keegan Kolesar,R,VGK,27,67,8,9,17
38,8477903,Garnet Hathaway,R,PHI,33,68,7,10,17
38,8481704,Juuso Parssinen,C,NSH,23,53,7,10,17
38,8479370,Tyson Jost,C,CAR,26,44,7,10,17
38,8477507,Nikita Zadorov,D,BOS,29,68,7,10,17
38,8478451,Ethan Bear,D,WSH,27,42,6,11,17
38,8474673,TJ Brodie,D,CHI,34,63,5,12,17
38,8476891,Matthew Grzelcyk,D,PIT,30,78,5,12,17
38,8479315,Joey Anderson,R,CHI,26,50,4,13,17
38,8480807,Mattias Samuelsson,D,BUF,24,57,4,13,17
38,8478468,Jeremy Lauzon,D,NSH,27,55,2,15,17
38,8480796,Martin Fehervary,D,WSH,25,55,1,16,17
38,8474568,Luke Schenn,D,NSH,35,52,1,16,17
38,8478831,Kevin Stenlund,C,UTA,28,53,12,4,16
38,8480021,Jack Studnicka,C,LAK,25,55,10,6,16
38,8482077,Dylan Holloway,L,EDM,23,51,10,6,16
38,8480789,Oliver Wahlstrom,R,NYI,24,67,8,8,16
38,8480806,Isac Lundestrom,C,ANA,25,61,8,8,16
38,8480157,Calle Rosen,D,COL,30,51,7,9,16
38,8475842,Sam Carrick,C,NYR,32,57,7,9,16
38,8483491,Ivan Miroshnichenko,L,WSH,20,49,6,10,16
38,8481093,Rafael Harvey-Pinard,L,MTL,25,57,6,10,16
38,8482634,Alex Steeves,C,TOR,25,49,6,10,16
38,8477989,Christian Dvorak,C,MTL,28,66,5,11,16
38,8477979,Nicolas Aube-Kubel,R,BUF,28,59,5,11,16
38,8480025,MacKenzie Entwistle,R,FLA,25,61,5,11,16
38,8476902,Esa Lindell,D,DAL,30,69,3,13,16
38,8475324,Nick Jensen,D,OTT,34,69,3,13,16
38,8479983,Mario Ferraro,D,SJS,26,73,3,13,16
38,8479994,Jaret Anderson-Dolan,C,WPG,25,37,3,13,16
38,8480035,Henri Jokiharju,D,BUF,25,58,1,15,16
38,8478840,Will Borgen,D,SEA,28,64,1,15,16
38,8474034,Patrick Maroon,L,CHI,36,59,8,7,15
38,8476867,Brendan Gaunce,C,MIN,30,44,7,8,15
38,8480205,Emil Bemstrom,C,PIT,25,55,6,9,15
38,8481537,Nikita Okhotiuk,D,CGY,24,56,6,9,15
38,8476988,Matt Benning,D,SJS,30,66,6,9,15
38,8482062,Cole Smith,L,NSH,29,53,5,10,15
38,8475855,Jesper Fast,R,CAR,33,47,4,11,15
38,8477435,Ryan Graves,D,PIT,29,77,4,11,15
38,8477220,Nate Schmidt,D,FLA,33,67,3,12,15
38,8475179,Dmitry Kulikov,D,FLA,34,56,2,13,15
38,8478399,Jonas Siegenthaler,D,NJD,27,56,1,14,15
38,8476429,Scott Mayfield,D,NYI,32,72,1,14,15
38,8481716,Dmitri Voronkov,L,CBJ,24,48,10,4,14
38,8479981,Jonah Gadjovich,L,FLA,26,41,9,5,14
38,8478585,Derek Ryan,C,EDM,38,65,8,6,14
38,8477508,Curtis Lazar,C,NJD,29,61,8,6,14
38,8480995,Pontus Holmberg,R,TOR,25,57,7,7,14
38,8476960,Andreas Athanasiou,C,CHI,30,55,6,8,14
38,8480289,Morgan Barron,C,WPG,26,53,6,8,14
38,8481013,Jonatan Berggren,R,DET,24,57,6,8,14
38,8474013,Ian Cole,D,UTA,35,53,6,8,14
38,8479972,Mason Shaw,C,WPG,26,37,5,9,14
38,8479291,Kevin Rooney,C,CGY,31,44,5,9,14
38,8480172,Jan Rutta,D,SJS,34,62,4,10,14
38,8478443,Brandon Carlo,D,BOS,28,59,3,11,14
38,8482730,Brandt Clarke,D,LAK,21,57,3,11,14
38,8482087,Kaiden Guhle,D,MTL,22,56,2,12,14
38,8475188,Brayden McNabb,D,VGK,33,60,2,12,14
38,8481059,Scott Perunovich,D,STL,26,63,2,12,14
38,8477365,Connor Clifton,D,BUF,29,52,2,12,14
38,8476967,Brett Kulak,D,EDM,30,63,1,13,14
38,8476525,Colin Miller,D,WPG,32,65,0,14,14
38,8483460,David Jiricek,D,CBJ,21,67,0,14,14
38,8482148,Hendrix Lapierre,C,WSH,22,56,8,5,13
38,8481481,Blake Lizotte,C,PIT,27,48,7,6,13
38,8479671,Mathieu Olivier,R,CBJ,27,44,7,6,13
38,8477573,Nathan Walker,L,STL,30,51,7,6,13
38,8480748,Kiefer Sherwood,L,VAN,29,57,6,7,13
38,8479328,Julien Gauthier,R,NYI,27,59,6,7,13
38,8482155,Alex Laferriere,R,LAK,23,60,5,8,13
38,8478421,A.J. Greer,L,FLA,28,51,5,8,13
38,8477962,Brendan Lemieux,L,CAR,28,40,5,8,13
38,8480074,Alexandre Texier,C,STL,25,49,4,9,13
38,8481527,Kaedan Korczak,D,VGK,23,40,4,9,13
38,8482192,Isaak Phillips,D,CHI,23,46,4,9,13
38,8482451,Mikael Pyyhtia,L,CBJ,23,46,4,9,13
38,8478178,Darren Raddysh,D,TBL,28,71,4,9,13
38,8477070,Liam O'Brien,C,UTA,30,56,4,9,13
38,8482073,Braden Schneider,D,NYR,23,68,3,10,13
38,8480845,Rasmus Kupari,C,WPG,24,47,3,10,13
38,8477845,Trevor van Riemsdyk,D,WSH,33,58,2,11,13
38,8480727,Zach Whitecloud,D,VGK,28,49,2,11,13
38,8478452,Caleb Jones,D,LAK,27,53,2,11,13
38,8475208,Brian Dumoulin,D,ANA,33,62,2,11,13
38,8479249,Andrew Poturalski,C,SJS,30,40,1,12,13
38,8475750,Jon Merrill,D,MIN,32,60,0,13,13
38,8483468,Jiri Kulich,C,BUF,20,56,8,4,12
38,8480011,Klim Kostin,C,SJS,25,49,8,4,12
38,8477931,Tomas Nosek,L,FLA,32,58,5,7,12
38,8476994,Vinnie Hinostroza,C,NSH,30,46,5,7,12
38,8482176,Wyatt Kaiser,D,CHI,22,59,5,7,12
38,8483495,Simon Nemec,D,NJD,20,54,5,7,12
38,8482807,Ethan Del Mastro,D,CHI,21,48,5,7,12
38,8474166,Alec Martinez,D,CHI,37,46,4,8,12
38,8478211,Dryden Hunt,L,CGY,29,53,4,8,12
38,8480355,Mark Kastelic,C,BOS,25,64,4,8,12
38,8480879,Jacob Bernard-Docker,D,OTT,24,46,4,8,12
38,8481517,Brett Leason,R,ANA,25,57,3,9,12
38,8481019,David Gustafsson,C,WPG,24,39,3,9,12
38,8477034,Jaycob Megna,D,FLA,32,54,3,9,12
38,8480192,Johnathan Kovacevic,D,NJD,27,55,2,10,12
38,8480001,Urho Vaakanainen,D,ANA,25,61,2,10,12
38,8481600,Tobias Bjornfot,D,FLA,23,37,2,10,12
38,8480070,Ian Mitchell,D,BOS,25,39,2,10,12
38,8471709,Marc-Edouard Vlasic,D,SJS,37,58,2,10,12
38,8483466,Kevin Korchinski,D,CHI,20,51,2,10,12
38,8480860,Kevin Bahl,D,CGY,24,62,1,11,12
38,8480848,Ty Dellandrea,C,SJS,24,36,6,5,11
38,8476913,Devin Shore,C,MIN,30,36,5,6,11
38,8482859,Zack Ostapchuk,C,OTT,21,53,4,7,11
38,8475455,Brenden Dillon,D,NJD,34,53,4,7,11
38,8476934,Brock McGinn,L,ANA,30,57,3,8,11
38,8475690,Chris Tanev,D,TOR,35,53,2,9,11
38,8482652,Walker Duehr,R,CGY,27,38,2,9,11
38,8479442,Troy Stecher,D,EDM,30,50,2,9,11
38,8479369,Andrew Peeke,D,BOS,26,60,1,10,11
38,8476372,Nick Seeler,D,PHI,31,51,1,10,11
38,8479968,Vinni Lettieri,C,BOS,29,55,6,4,10
38,8482713,Mackie Samoskevich,R,FLA,22,44,6,4,10
38,8479536,Axel Jonsson-Fjallby,L,WPG,26,36,5,5,10
38,8482751,Ryan Winterton,C,SEA,21,50,5,5,10
38,8479439,Jacob MacDonald,D,COL,31,44,4,6,10
38,8478017,Mark Friedman,D,VAN,29,42,4,6,10
38,8477018,Ben Hutton,D,VGK,31,47,4,6,10
38,8480007,Jonas Rondbjerg,R,VGK,25,47,4,6,10
38,8482744,James Malatesta,L,CBJ,21,37,3,7,10
38,8479980,Nicolas Hague,D,VGK,26,50,2,8,10
38,8484149,Gavin Brindley,C,CBJ,20,40,2,8,10
38,8476874,Olli Maatta,D,DET,30,54,2,8,10
38,8470600,Ryan Suter,D,STL,39,57,1,9,10
38,8481567,Henry Thrun,D,SJS,23,45,0,10,10
38,8479372,Joshua Mahura,D,SEA,26,59,0,10,10
38,8479944,Zach Aston-Reese,C,VGK,30,51,6,3,9
38,8479378,Logan Stanley,D,WPG,26,45,6,3,9
38,8477335,Kyle Burroughs,D,LAK,29,42,6,3,9
38,8481599,Victor Soderstrom,D,UTA,23,39,4,5,9
38,8481178,Egor Zamula,D,PHI,24,57,3,6,9
38,8482666,Scott Morrow,D,CAR,22,51,3,6,9
38,8482095,Tyler Kleven,D,OTT,22,35,3,6,9
38,8476442,Matt Nieto,L,PIT,32,43,3,6,9
38,8482784,Zach Dean,C,STL,21,43,3,6,9
38,8483763,Maksymilian Szuber,D,UTA,22,36,3,6,9
38,8480950,Ilya Lyubushkin,D,DAL,30,67,2,7,9
38,8475177,Calvin de Haan,D,COL,33,47,2,7,9
38,8478859,Niko Mikkola,D,FLA,28,53,1,8,9
38,8471677,Jack Johnson,D,CBJ,37,61,1,8,9
38,8475762,Derek Forbort,D,VAN,32,42,0,9,9
38,8483619,Filip Roos,D,OTT,25,38,6,2,8
38,8481592,Jakob Pelletier,L,CGY,23,40,5,3,8
38,8482762,Simon Edvinsson,D,DET,21,59,4,4,8
38,8482733,Logan Mailloux,D,MTL,31,30,4,4,8
38,8477482,Zachary Sanford,L,CHI,30,29,2,6,8
38,8476441,Joel Edmundson,D,LAK,31,35,2,6,8
38,8480058,Pierre-Olivier Joseph,D,STL,25,45,1,7,8
38,8481550,Adam Beckman,L,NJD,23,43,1,7,8
38,8479986,Kole Lind,R,DAL,26,46,1,7,8
38,8481598,Philip Broberg,D,EDM,23,48,1,7,8
38,8480834,Ty Emberson,D,SJS,24,36,1,7,8
38,8475718,Justin Holl,D,DET,32,57,0,8,8
38,8483397,Marc McLaughlin,C,BOS,25,27,7,0,7
38,8481161,Jake Christiansen,D,CBJ,25,53,4,3,7
38,8482659,Josh Doan,R,UTA,22,47,4,3,7
38,8476858,Phillip Di Giuseppe,L,VAN,31,42,4,3,7
38,8481708,Zac Jones,D,NYR,24,45,3,4,7
38,8481751,Lukas Rousek,R,BUF,25,36,2,5,7
38,8482964,Arber Xhekaj,D,MTL,23,54,2,5,7
38,8477473,Justin Bailey,R,SJS,29,27,2,5,7
38,8474090,Brendan Smith,D,DAL,35,55,1,6,7
38,8481167,Brayden Pachal,D,CGY,25,34,1,6,7
38,8480844,Grigori Denisenko,L,VGK,24,31,1,6,7
38,8478146,Matthew Highmore,C,OTT,28,26,1,6,7
38,8480887,Jordan Harris,D,MTL,24,55,1,6,7
38,8479638,Justin Brazeau,R,BOS,26,38,5,1,6
38,8480441,Trey Fix-Wolansky,R,CBJ,25,38,4,2,6
38,8480252,Cole Guttman,C,CHI,25,31,4,2,6
38,8480245,Olle Lycksell,R,PHI,25,26,4,2,6
38,8479362,Riley Tufte,L,BOS,26,21,4,2,6
38,8482144,Jack Thompson,D,SJS,22,27,3,3,6
38,8476952,Dominic Toninato,C,WPG,30,34,3,3,6
38,8484254,Akito Hirose,D,VAN,25,35,2,4,6
38,8480880,Jakub Lauko,C,MIN,24,32,2,4,6
38,8482511,Mason Lohrei,D,BOS,23,40,2,4,6
38,8476473,Connor Murphy,D,CHI,31,36,2,4,6
38,8481605,Jackson LaCombe,D,ANA,23,37,2,4,6
38,8479379,Givani Smith,R,SJS,26,23,2,4,6
38,8473446,Erik Johnson,D,PHI,36,46,2,4,6
38,8478874,Adam Gaudette,R,OTT,28,39,1,5,6
38,8482747,Brennan Othmann,L,NYR,21,34,0,6,6
38,8481065,Angus Crookshank,L,OTT,25,15,0,6,6
38,8478424,Jansen Harkins,C,ANA,27,41,4,1,5
38,8481556,John Beecher,C,BOS,23,38,4,1,5
38,8482145,Mavrik Bourque,C,DAL,22,53,4,1,5
38,8471817,Ryan Reaves,R,TOR,37,58,3,2,5
38,8481518,Nolan Foote,L,NJD,24,41,3,2,5
38,8477499,Rasmus Ristolainen,D,PHI,30,57,2,3,5
38,8478409,Anthony Richard,C,PHI,28,33,2,3,5
38,8477462,Robert Hagg,D,VGK,29,28,2,3,5
38,8478502,Dennis Gilbert,D,BUF,28,18,2,3,5
38,8475958,Michael Sgarbossa,C,WSH,32,26,2,3,5
38,8479348,Kale Clague,D,BUF,26,44,1,4,5
38,8483549,Lucas Condotta,L,MTL,27,41,1,4,5
38,8481147,Reese Johnson,C,MIN,26,36,1,4,5
38,8480990,Declan Chisholm,D,MIN,24,29,1,4,5
38,8480870,Bo Groulx,C,NYR,24,37,1,4,5
38,8477244,Chad Ruhwedel,D,NYR,34,28,1,4,5
38,8477851,Jordan Oesterle,D,BOS,32,41,1,4,5
38,8478450,Parker Wotherspoon,D,BOS,27,31,0,5,5
38,8480196,Jacob Bryson,D,BUF,27,40,0,5,5
38,8477384,Joshua Brown,D,EDM,30,42,0,5,5
38,8475795,Dylan McIlrath,D,WSH,32,13,0,5,5
38,8479985,Cale Fleury,D,SEA,26,23,4,0,4
38,8481543,Nikita Alexandrov,C,STL,24,25,4,0,4
38,8483570,Ben Meyers,C,SEA,26,25,3,1,4
38,8482147,Jean-Luc Foudy,C,COL,22,17,3,1,4
38,8482201,Gage Goncalves,C,TBL,23,23,3,1,4
38,8482765,Isak Rosen,R,BUF,21,25,3,1,4
38,8480292,Carson Meyer,R,ANA,27,32,2,2,4
38,8481789,Tye Kartye,L,SEA,23,38,2,2,4
38,8484911,Collin Graf,R,SJS,22,41,2,2,4
38,8484258,Sam Malinski,D,COL,26,20,2,2,4
38,8482061,Brandon Biro,L,SEA,26,14,2,2,4
38,8477401,John Hayden,C,SEA,29,30,1,3,4
38,8481617,Vasily Podkolzin,R,VAN,23,41,1,3,4
38,8481754,Nikita Nesterenko,C,ANA,23,28,1,3,4
38,8477810,Joel Hanley,D,CGY,33,22,1,3,4
38,8474612,Travis Hamonic,D,OTT,34,45,1,3,4
38,8479991,Jake Leschyshyn,C,NYR,25,24,1,3,4
38,8481030,Jack St. Ivany,D,PIT,25,11,1,3,4
38,8478477,Mitchell Stephens,C,SEA,27,15,1,3,4
38,8481564,Ryan Johnson,D,BUF,23,15,1,3,4
38,8475755,Alexander Petrovic,D,DAL,32,9,1,3,4
38,8481462,Mason Morelli,L,VGK,28,18,1,3,4
38,8484325,Waltteri Merela,C,TBL,26,27,1,3,4
38,8475235,Nicolas Deslauriers,L,PHI,33,44,0,4,4
38,8481532,Alex Turcotte,C,LAK,23,45,0,4,4
38,8481701,Santeri Hatakka,D,NJD,23,34,0,4,4
38,8481056,Spencer Stastney,D,NSH,24,36,0,4,4
38,8478021,William Lagesson,D,DET,28,23,0,4,4
38,8482470,Ilya Solovyov,D,CGY,24,17,0,4,4
38,8482153,Brendan Brisson,C,VGK,23,25,0,4,4
38,8482172,Landon Slaggert,L,CHI,22,23,0,4,4
38,8478051,Max Willman,C,NJD,29,22,3,0,3
38,8479772,Zack MacEwen,R,OTT,28,52,2,1,3
38,8482070,Mitchell Chaffee,R,TBL,26,44,2,1,3
38,8477938,Haydn Fleury,D,WPG,28,43,1,2,3
38,8483630,Pavol Regenda,L,ANA,25,34,1,2,3
38,8479367,William Lockwood,R,FLA,26,23,1,2,3
38,8481043,Cole Koepke,L,BOS,26,12,1,2,3
38,8480890,Jan Jenik,C,OTT,24,27,1,2,3
38,8481593,Jayden Struble,D,MTL,23,32,1,2,3
38,8477149,Scott Sabourin,R,SJS,32,14,1,2,3
38,8481585,Egor Afanasyev,L,SJS,23,8,1,2,3
38,8479587,Rhett Gardner,C,PHI,28,23,0,3,3
38,8479320,Maxime Lajoie,D,SEA,27,26,0,3,3
38,8482250,Callahan Burke,C,VGK,27,19,0,3,3
38,8481699,Aku Raty,R,UTA,23,17,0,3,3
38,8483512,Matthew Savoie,C,EDM,20,21,0,3,3
38,8481578,Graeme Clarke,R,MIN,23,8,0,3,3
38,8481679,Maxence Guenette,D,OTT,23,37,2,0,2
38,8482177,Marat Khusnutdinov,C,MIN,22,31,2,0,2
38,8481609,Vladislav Kolyachonok,D,UTA,23,34,2,0,2
38,8481422,Jake Lucchini,C,NSH,29,28,2,0,2
38,8481541,Samuel Bolduc,D,NYI,24,25,2,0,2
38,8481743,Marc Del Gaizo,D,NSH,25,17,2,0,2
38,8484287,Cole McWard,D,VAN,23,16,1,1,2
38,8480851,Akil Thomas,C,LAK,24,21,1,1,2
38,8479419,Brett Murray,L,BUF,26,20,1,1,2
38,8482165,Yan Kuznetsov,D,CGY,22,24,1,1,2
38,8484304,Uvis Balinskis,D,FLA,28,13,1,1,2
38,8482861,Vincent Iorio,D,WSH,22,38,0,2,2
38,8482516,Matthew Kessel,D,STL,24,21,0,2,2
38,8479576,Vincent Desharnais,D,VAN,28,31,0,2,2
38,8481024,Linus Karlsson,C,VAN,25,9,0,2,2
38,8477971,Andreas Englund,D,LAK,28,28,0,2,2
38,8477527,Ross Johnston,L,ANA,30,20,0,2,2
38,8482858,Ryker Evans,D,SEA,23,17,0,2,2
38,8480084,Nick DeSimone,D,NJD,30,17,0,2,2
38,8483012,Logan Morrison,C,SEA,22,37,0,2,2
38,8480267,Sammy Walker,C,MIN,25,19,0,2,2
38,8481806,Louis Crevier,D,CHI,23,19,0,2,2
38,8477541,Dakota Mermis,D,TOR,30,9,0,2,2
38,8480823,Alexander Alexeyev,D,WSH,25,16,0,2,2
38,8483407,Brandon Scanlin,D,NYR,25,6,0,2,2
38,8481122,Simon Benoit,D,TOR,26,40,1,0,1
38,8481237,Kyle MacLean,C,NYI,25,31,1,0,1
38,8482929,Emil Lilleberg,D,TBL,23,25,1,0,1
38,8477320,Anton Blidh,L,NYR,29,23,1,0,1
38,8482102,Vasily Ponomarev,C,PIT,22,20,1,0,1
38,8480468,James Hamblin,L,EDM,25,12,1,0,1
38,8482141,Lukas Cormier,D,VGK,22,30,1,0,1
38,8477467,Gustav Olofsson,D,SEA,30,23,1,0,1
38,8480874,Adam Ginning,D,PHI,24,16,1,0,1
38,8482460,Matt Rempe,C,NYR,22,12,1,0,1
38,8482787,Nikita Chibrikov,R,WPG,31,7,1,0,1
38,8474062,Riley Nash,C,NYR,35,15,1,0,1
38,8478446,Glenn Gawdin,C,LAK,27,11,1,0,1
38,8478454,Noah Juulsen,D,VAN,27,42,0,1,1
38,8477887,Patrick Brown,C,BOS,32,36,0,1,1
38,8482094,Daemon Hunt,D,MIN,22,12,0,1,1
38,8481006,Tyler Tucker,D,STL,24,14,0,1,1
38,8478011,Louie Belpedio,D,PHI,28,8,0,1,1
38,8482162,Roby Jarventie,L,EDM,22,14,0,1,1
38,8484255,Jason Polin,R,COL,25,7,0,1,1
38,8479421,Jacob Moverare,D,LAK,26,3,0,1,1
38,8477073,Kurtis MacDermid,L,NJD,30,28,0,1,1
38,8480032,Shane Bowers,C,NJD,25,8,0,1,1
38,8481206,John Ludvig,D,PIT,24,10,0,1,1
38,8475780,Chris Wagner,R,COL,33,7,0,1,1
38,8482126,Emil Andrae,D,PHI,31,5,0,1,1
38,8482197,Adam Raska,R,MIN,23,6,0,0,0
38,8480075,Cameron Crotty,D,MIN,25,8,0,0,0
38,8483395,Arshdeep Bains,L,VAN,23,15,0,0,0
38,8481655,Cole Schwindt,R,CGY,23,7,0,0,0
38,8478881,Brett Seney,L,CHI,28,13,0,0,0
38,8483597,Milos Kelemen,L,UTA,25,7,0,0,0
38,8481726,Adam Edstrom,C,NYR,24,8,0,0,0
38,8475413,Justin Dowling,C,NJD,34,14,0,0,0
38,8479330,Brandon Gignac,C,MTL,27,11,0,0,0
38,8483432,Luca Del Bel Belluz,C,CBJ,31,7,0,0,0
38,8483401,Marc Johnstone,R,PIT,28,3,0,0,0
38,8484326,Patrik Koch,D,UTA,28,5,0,0,0
38,8483471,Brad Lambert,C,WPG,31,10,0,0,0
38,8482118,Sam Colangelo,R,ANA,23,16,0,0,0
38,8482088,Justin Sourdif,R,FLA,22,12,0,0,0
38,8478147,Bokondji Imama,L,PIT,28,3,0,0,0
38,8481719,Maxwell Crozier,D,TBL,24,11,0,0,0
38,8483489,Fraser Minten,C,TOR,31,9,0,0,0
38,8483920,Pierrick Dube,R,WSH,23,5,0,0,0
38,8483531,Brian Halonen,L,NJD,25,2,0,0,0
38,8483546,Marshall Rifai,D,TOR,26,5,0,0,0
38,8483567,Georgii Merkulov,C,BOS,24,8,0,0,0
38,8478854,Ryan Shea,D,PIT,27,7,0,0,0
38,8482476,Emil Heineman,L,MTL,23,9,0,0,0
38,8479522,Hardy Haman Aktell,D,WSH,26,2,0,0,0
38,8481534,Raphael Lavoie,C,EDM,24,0,0,0,0
38,8480306,Grant Hutton,D,NYI,29,7,0,0,0
38,8477993,Justin Kirkland,C,CGY,28,3,0,0,0
38,8483609,Adam Klapka,R,CGY,24,1,0,0,0
38,8476323,Max McCormick,L,SEA,32,5,0,0,0
38,8483045,Cameron Butler,R,CBJ,31,0,0,0,0
38,8483398,Declan Carlile,D,TBL,31,2,0,0,0
38,8478956,Samuel Laberge,L,NJD,27,0,0,0,0
38,8480274,Philip Kemp,D,EDM,25,1,0,0,0
38,8484259,Ondrej Pavel,C,COL,31,1,0,0,0
38,8484321,Nikolas Matinpalo,D,OTT,26,2,0,0,0
38,8470794,Joe Pavelski,C,,40,0,0,0,0
38,8479321,Lucas Johansen,D,,27,0,0,0,0
38,8477950,Tony DeAngelo,D,,29,0,0,0,0
38,8471218,Blake Wheeler,R,,38,0,0,0,0
38,8475197,Tyson Barrie,D,,33,0,0,0,0
38,8474157,Max Pacioretty,L,,36,0,0,0,0
38,8475744,Evgeny Kuznetsov,C,,32,0,0,0,0
38,8474037,James van Riemsdyk,L,,35,0,0,0,0
38,8476907,Mackenzie MacEachern,L,,30,0,0,0,0
38,8480216,Jacob Peterson,C,,25,0,0,0,0
38,8474602,Justin Schultz,D,,34,0,0,0,0
38,8482222,Alexander Barabanov,L,,30,0,0,0,0
38,8474031,Kevin Shattenkirk,D,,35,0,0,0,0
38,8477330,Dominik Kubalik,L,,29,0,0,0,0
38,8480884,Calen Addison,D,,24,0,0,0,0
38,8475906,John Klingberg,D,,32,0,0,0,0
38,8480008,Adam Ruzicka,C,,25,0,0,0,0
38,8476884,Derrick Pouliot,D,,30,0,0,0,0
38,8476919,Chris Tierney,C,,30,0,0,0,0
38,8479415,Michael McLeod,C,,26,0,0,0,0
38,8474870,Tyler Johnson,C,,34,0,0,0,0
38,8470604,Jeff Carter,C,,39,0,0,0,0
38,8478104,Sammy Blais,L,,28,0,0,0,0
38,8474884,Mike Hoffman,C,,35,0,0,0,0
38,8481591,Sam Poulin,R,,23,0,0,0,0
38,8471274,Alex Goligoski,D,,39,0,0,0,0
38,8476871,Tanner Pearson,L,,32,0,0,0,0
38,8476393,Nick Cousins,C,,31,0,0,0,0
38,8479977,Kailer Yamamoto,R,,26,0,0,0,0
38,8479346,Dillon Dube,C,,26,0,0,0,0
38,8480184,Gustav Lindstrom,D,,26,0,0,0,0
38,8479376,Victor Mete,D,,26,0,0,0,0
38,8473449,Kyle Okposo,R,,36,0,0,0,0
38,8481058,Jesse Ylonen,R,,25,0,0,0,0
38,8475752,Tyler Pitlick,C,,33,0,0,0,0
38,8481239,Samuel Fagemo,L,,24,0,0,0,0
38,8480821,Filip Zadina,R,,25,0,0,0,0
38,8470966,Mark Giordano,D,,41,0,0,0,0
38,8478495,Denis Gurianov,R,,27,0,0,0,0
38,8477464,Nic Petan,C,,29,0,0,0,0
38,8478099,Kevin Labanc,R,,29,0,0,0,0
38,8482241,Radim Zohorna,L,,28,0,0,0,0
38,8474040,Sam Gagner,C,,35,0,0,0,0
38,8479514,Rem Pitlick,C,,27,0,0,0,0
38,8478430,Oliver Kylington,D,,27,0,0,0,0
38,8479533,Joona Koppanen,L,,26,0,0,0,0
38,8479984,Cal Foote,D,,26,0,0,0,0
38,8477126,Jayson Megna,C,,34,0,0,0,0
38,8475164,Jakob Silfverberg,R,,34,0,0,0,0
38,8474009,Nick Bonino,C,,36,0,0,0,0
38,8479458,Nikita Zaitsev,D,,33,0,0,0,0
38,8477944,Jakub Vrana,L,,28,0,0,0,0
38,8471699,Andrew Cogliano,C,,37,0,0,0,0
38,8478067,Oskar Lindblom,L,,28,0,0,0,0
38,8471686,Marc Staal,D,,37,0,0,0,0
38,8470610,Zach Parise,L,,40,0,0,0,0
38,8478904,Steven Lorentz,C,,28,0,0,0,0
38,8473473,Milan Lucic,L,,36,0,0,0,0
38,8480031,Maxime Comtois,L,,25,0,0,0,0
38,8478512,Austin Czarnik,C,,32,0,0,0,0
38,8473504,Cal Clutterbuck,R,,37,0,0,0,0
38,8477454,Adam Erne,L,,29,0,0,0,0
38,8479383,Boris Katchouk,L,,26,0,0,0,0
38,8475825,Jani Hakanpää,D,,32,0,0,0,0
38,8477846,Ryan Carpenter,C,,33,0,0,0,0
38,8477930,Pierre-Edouard Bellemare,L,,39,0,0,0,0
38,8478400,Colin White,C,,27,0,0,0,0
38,8480226,Marián Studenic,R,,26,0,0,0,0
38,8480853,Liam Foudy,C,,24,0,0,0,0
38,8475797,Jarred Tinordi,D,,32,0,0,0,0
38,8479423,Alex Nylander,L,,26,0,0,0,0
38,8474618,Marco Scandella,D,,34,0,0,0,0
38,8478028,Fredrik Olofsson,L,,28,0,0,0,0
38,8474709,Matt Martin,L,,35,0,0,0,0
38,8481070,Hugh McGing,L,,26,0,0,0,0
38,8479546,Oskar Steen,C,,26,0,0,0,0
38,8474145,Robert Bortuzzo,D,,35,0,0,0,0
38,8476915,Jujhar Khaira,L,,30,0,0,0,0
38,8475278,Byron Froese,C,,33,0,0,0,0
38,8481812,Nikolai Knyzhov,D,,27,0,0,0,0
38,8478408,Travis Dermott,D,,28,0,0,0,0
38,8481077,John Leonard,L,,26,0,0,0,0
38,8479547,Matthew Phillips,R,,26,0,0,0,0
38,8480836,Jonathan Gruden,C,,24,0,0,0,0
38,8481690,Tyler Angle,C,,24,0,0,0,0
38,8475766,Austin Watson,L,,32,0,0,0,0
38,8481016,Ruslan Iskhakov,C,,24,0,0,0,0
38,8478078,Rourke Chartier,C,,28,0,0,0,0
38,8480776,Sheldon Rempal,R,,29,0,0,0,0
38,8484314,Jiri Smejkal,L,,28,0,0,0,0
39,8476453,Nikita Kucherov,R,TBL,31,82,55,103,158
39,8477492,Nathan MacKinnon,C,COL,29,80,46,99,145
39,8481559,Jack Hughes,C,NJD,23,76,55,82,137
39,8477956,David Pastrnak,R,BOS,28,79,61,74,135
39,8478402,Connor McDavid,C,EDM,27,79,52,81,133
39,8477934,Leon Draisaitl,C,EDM,29,79,42,86,128
39,8477939,William Nylander,R,TOR,28,78,52,59,111
39,8479314,Matthew Tkachuk,L,FLA,27,76,37,72,109
39,8478864,Kirill Kaprizov,L,MIN,27,75,42,65,107
39,8478420,Mikko Rantanen,R,COL,28,80,37,68,105
39,8479318,Auston Matthews,C,TOR,27,78,59,42,101
39,8482116,Tim Stützle,C,OTT,22,80,31,70,101
39,8478483,Mitch Marner,R,TOR,27,81,24,75,99
39,8478550,Artemi Panarin,L,NYR,33,78,27,71,98
39,8478010,Brayden Point,C,TBL,28,82,47,49,96
39,8480801,Brady Tkachuk,L,OTT,25,78,35,61,96
39,8478427,Sebastian Aho,C,CAR,27,72,51,44,95
39,8480069,Cale Makar,D,COL,26,69,27,68,95
39,8477493,Aleksander Barkov,C,FLA,29,76,24,71,95
39,8476454,Ryan Nugent-Hopkins,C,EDM,31,75,27,67,94
39,8477501,Valeri Nichushkin,R,COL,29,81,51,41,92
39,8475913,Mark Stone,R,VGK,32,79,31,61,92
39,8478403,Jack Eichel,C,VGK,28,79,34,57,91
39,8471675,Sidney Crosby,C,PIT,37,75,47,41,88
39,8476468,J.T. Miller,C,VAN,31,76,33,55,88
39,8476459,Mika Zibanejad,C,NYR,31,81,37,50,87
39,8480023,Robert Thomas,C,STL,25,77,23,64,87
39,8477946,Dylan Larkin,C,DET,28,81,40,46,86
39,8479542,Brandon Hagel,L,TBL,26,82,34,52,86
39,8477942,Kevin Fiala,L,LAK,28,80,33,53,86
39,8479407,Jesper Bratt,L,NJD,26,76,27,59,86
39,8476887,Filip Forsberg,L,NSH,30,73,37,48,85
39,8477404,Jake Guentzel,C,TBL,30,82,31,54,85
39,8473419,Brad Marchand,L,BOS,36,80,35,49,84
39,8477933,Sam Reinhart,C,FLA,29,82,32,51,83
39,8475166,John Tavares,C,TOR,34,82,29,54,83
39,8480830,Andrei Svechnikov,R,CAR,24,73,25,57,82
39,8478445,Mathew Barzal,C,NYI,27,79,17,65,82
39,8475786,Zach Hyman,L,EDM,32,79,38,43,81
39,8479343,Clayton Keller,R,UTA,26,76,37,44,81
39,8481557,Matt Boldy,L,MIN,23,75,34,47,81
39,8475172,Nazem Kadri,C,CGY,34,80,22,59,81
39,8478398,Kyle Connor,L,WPG,28,71,37,43,80
39,8476460,Mark Scheifele,C,WPG,31,71,34,46,80
39,8480027,Jason Robertson,L,DAL,25,82,33,47,80
39,8479385,Jordan Kyrou,C,STL,26,73,45,34,79
39,8475784,Jeff Skinner,C,EDM,32,77,44,35,79
39,8480002,Nico Hischier,C,NJD,25,76,26,52,78
39,8480800,Quinn Hughes,D,VAN,25,73,6,72,78
39,8477960,Adrian Kempe,R,LAK,28,81,28,49,77
39,8478460,Zach Werenski,D,CBJ,27,78,17,60,77
39,8474600,Roman Josi,D,NSH,34,74,16,61,77
39,8480208,Drake Batherson,R,OTT,26,78,31,45,76
39,8480018,Nick Suzuki,C,MTL,25,74,22,54,76
39,8474564,Steven Stamkos,C,NSH,34,73,32,43,75
39,8484144,Connor Bedard,C,CHI,19,69,23,52,75
39,8471214,Alex Ovechkin,L,WSH,39,76,45,29,74
39,8477940,Nikolaj Ehlers,L,WPG,28,71,27,47,74
39,8482665,Matty Beniers,C,SEA,22,76,37,36,73
39,8480012,Elias Pettersson,C,VAN,26,72,28,45,73
39,8477496,Elias Lindholm,C,BOS,30,81,27,46,73
39,8476346,Johnny Gaudreau,L,CBJ,31,73,11,62,73
39,8475184,Chris Kreider,L,NYR,33,78,48,24,72
39,8474141,Patrick Kane,R,DET,36,80,24,48,72
39,8477409,Carter Verhaeghe,C,FLA,29,81,43,28,71
39,8481540,Cole Caufield,R,MTL,23,78,37,34,71
39,8471685,Anze Kopitar,C,LAK,37,80,26,45,71
39,8479420,Tage Thompson,C,BUF,27,67,37,32,69
39,8477949,Alex Tuch,R,BUF,28,74,23,46,69
39,8475167,Victor Hedman,D,TBL,34,79,15,53,68
39,8480865,Noah Dobson,D,NYI,24,81,12,56,68
39,8471215,Evgeni Malkin,C,PIT,38,70,26,41,67
39,8475692,Mats Zuccarello,R,MIN,37,77,19,48,67
39,8478975,Mason Marchment,L,DAL,29,82,26,40,66
39,8473512,Claude Giroux,R,OTT,36,76,26,40,66
39,8482078,Lucas Raymond,L,DET,22,82,26,40,66
39,8473986,Alex Killorn,L,ANA,35,72,25,41,66
39,8477951,Nick Schmaltz,C,UTA,28,72,23,43,66
39,8482699,Dylan Guenther,R,UTA,21,78,22,44,66
39,8478439,Travis Konecny,R,PHI,27,76,21,45,66
39,8476905,Chandler Stephenson,C,SEA,30,70,20,46,66
39,8477402,Pavel Buchnevich,L,STL,29,78,19,47,66
39,8480839,Rasmus Dahlin,D,BUF,24,69,17,49,66
39,8482740,Wyatt Johnston,C,DAL,21,81,31,34,65
39,8478449,Roope Hintz,C,DAL,28,81,25,40,65
39,8473994,Jamie Benn,L,DAL,35,82,22,43,65
39,8482124,Quinton Byfield,R,LAK,22,81,19,46,65
39,8474590,John Carlson,D,WSH,34,69,15,50,65
39,8477426,Nicholas Paul,L,TBL,29,81,32,32,64
39,8477504,Josh Morrissey,D,WPG,29,79,8,56,64
39,8480036,Miro Heiskanen,D,DAL,25,77,6,58,64
39,8475810,Bryan Rust,R,PIT,32,74,28,35,63
39,8478493,Joel Eriksson Ek,C,MIN,27,70,25,38,63
39,8478444,Brock Boeser,R,VAN,27,73,35,27,62
39,8477416,Oliver Bjorkstrand,R,SEA,29,79,21,41,62
39,8476853,Morgan Rielly,D,TOR,30,73,14,48,62
39,8476539,Jonathan Marchessault,R,NSH,34,73,31,30,61
39,8482745,Mason McTavish,C,ANA,21,72,24,37,61
39,8479337,Alex DeBrincat,R,DET,27,79,21,40,61
39,8475798,Mikael Granlund,C,SJS,32,67,21,40,61
39,8479999,Casey Mittelstadt,C,COL,26,80,13,48,61
39,8478414,Timo Meier,R,NJD,28,71,35,25,60
39,8480015,Owen Tippett,R,PHI,25,73,29,31,60
39,8481533,Trevor Zegras,C,ANA,23,76,28,32,60
39,8482684,Luke Hughes,D,NJD,21,76,9,51,60
39,8476483,Rickard Rakell,R,PIT,31,72,28,31,59
39,8482093,Seth Jarvis,C,CAR,22,67,22,37,59
39,8482159,Tyson Foerster,R,PHI,22,80,20,39,59
39,8474578,Erik Karlsson,D,PIT,34,82,13,46,59
39,8479323,Adam Fox,D,NYR,26,73,13,46,59
39,8476389,Vincent Trocheck,C,NYR,31,79,22,36,58
39,8478401,Pavel Zacha,C,BOS,27,79,21,37,58
39,8476875,Mike Matheson,D,MTL,30,75,11,47,58
39,8479400,Pierre-Luc Dubois,L,WSH,26,68,24,33,57
39,8475158,Ryan O'Reilly,C,NSH,33,75,22,35,57
39,8478047,Michael Bunting,L,PIT,29,75,21,36,57
39,8476292,Ondrej Palat,L,NJD,33,73,19,38,57
39,8475754,Brock Nelson,C,NYI,33,79,34,22,56
39,8477476,Artturi Lehkonen,L,COL,29,79,30,26,56
39,8476479,Phillip Danault,C,LAK,31,80,26,30,56
39,8478440,Dylan Strome,C,WSH,27,69,25,31,56
39,8478407,Vince Dunn,D,SEA,28,71,12,44,56
39,8475745,Charlie Coyle,C,BOS,32,82,28,27,55
39,8475765,Vladimir Tarasenko,R,DET,33,78,27,28,55
39,8476448,William Karlsson,C,VGK,31,73,23,32,55
39,8481528,Dylan Cozens,C,BUF,23,73,21,34,55
39,8470613,Brent Burns,D,CAR,39,77,19,36,55
39,8479325,Charlie McAvoy,D,BOS,27,72,8,47,55
39,8477955,Jared McCann,L,SEA,28,74,25,29,54
39,8477456,J.T. Compher,L,DET,29,80,21,33,54
39,8474679,Gustav Nyquist,C,NSH,35,72,18,36,54
39,8476906,Shayne Gostisbehere,D,CAR,31,80,11,43,54
39,8480803,Evan Bouchard,D,EDM,25,76,8,46,54
39,8477964,Ivan Barbashev,C,VGK,29,75,29,24,53
39,8477935,Sam Bennett,C,FLA,28,76,22,31,53
39,8480039,Martin Necas,C,CAR,25,74,21,32,53
39,8479675,Trevor Moore,L,LAK,29,80,18,35,53
39,8471724,Kris Letang,D,PIT,37,79,17,36,53
39,8475753,Justin Faulk,D,STL,32,75,15,38,53
39,8477500,Bo Horvat,C,NYI,29,77,27,25,52
39,8484145,Zach Benson,L,BUF,19,66,24,28,52
39,8478042,Viktor Arvidsson,L,EDM,31,77,20,32,52
39,8478498,Jake DeBrusk,L,VAN,28,73,30,21,51
39,8483431,Logan Cooley,C,UTA,20,72,20,31,51
39,8478873,Troy Terry,R,ANA,27,76,19,32,51
39,8482110,Dawson Mercer,C,NJD,23,77,17,34,51
39,8479410,Mikhail Sergachev,D,UTA,26,64,9,42,51
39,8482109,Alexis Lafrenière,L,NYR,23,74,28,22,50
39,8479992,Michael Rasmussen,C,DET,25,78,26,24,50
39,8475169,Evander Kane,L,EDM,33,74,24,26,50
39,8478856,Conor Garland,R,VAN,28,70,21,29,50
39,8481581,Thomas Harley,D,DAL,23,74,17,33,50
39,8476792,Torey Krug,D,STL,33,74,16,34,50
39,8477986,Brandon Montour,D,SEA,30,71,13,37,50
39,8476456,Jonathan Huberdeau,C,CGY,31,73,10,40,50
39,8480064,Josh Norris,C,OTT,25,78,26,23,49
39,8482175,JJ Peterka,R,BUF,22,70,24,25,49
39,8475794,Tyler Seguin,C,DAL,32,82,22,27,49
39,8483515,Juraj Slafkovsky,L,MTL,20,76,21,28,49
39,8474586,Jordan Eberle,R,SEA,34,73,15,34,49
39,8480028,Morgan Frost,C,PHI,25,74,15,34,49
39,8477498,Darnell Nurse,D,EDM,29,73,12,37,49
39,8477932,Aaron Ekblad,D,FLA,28,68,9,40,49
39,8476854,Hampus Lindholm,D,BOS,30,73,7,42,49
39,8477495,Seth Jones,D,CHI,30,69,5,44,49
39,8475799,Nino Niederreiter,R,WPG,32,74,30,18,48
39,8481068,Yegor Sharangovich,C,CGY,26,74,27,21,48
39,8479525,Ross Colton,C,COL,28,79,26,22,48
39,8477494,Jonathan Drouin,L,COL,29,80,22,26,48
39,8478396,Noah Hanifin,D,VGK,27,66,10,38,48
39,8478469,Thomas Chabot,D,OTT,27,68,18,29,47
39,8474102,David Perron,L,OTT,36,78,17,30,47
39,8482092,Ridly Greig,C,OTT,22,80,16,30,46
39,8479425,Filip Hronek,D,VAN,27,74,11,35,46
39,8482655,Janis Moser,D,TBL,24,77,9,37,46
39,8477407,Anthony Duclair,L,NYI,29,77,25,20,45
39,8481618,Alex Newhook,C,MTL,23,73,23,22,45
39,8479339,Patrik Laine,L,CBJ,26,61,23,22,45
39,8478542,Evan Rodrigues,C,FLA,31,73,20,25,45
39,8478462,Nicolas Roy,C,VGK,27,76,17,28,45
39,8477346,MacKenzie Weegar,D,CGY,30,71,15,30,45
39,8484153,Leo Carlsson,C,ANA,20,68,14,31,45
39,8478233,Andrew Mangiapane,L,WSH,28,70,14,31,45
39,8481711,Matias Maccelli,L,UTA,24,71,13,32,45
39,8482122,Brock Faber,D,MIN,22,80,11,34,45
39,8478055,Gustav Forsling,D,FLA,28,70,10,35,45
39,8476958,Jaccob Slavin,D,CAR,30,72,5,40,45
39,8479365,Trent Frederic,C,BOS,26,77,24,20,44
39,8476399,Blake Coleman,C,CGY,33,70,23,21,44
39,8480797,Joel Farabee,L,PHI,24,74,21,23,44
39,8484166,Adam Fantilli,C,CBJ,20,71,20,24,44
39,8475760,Nick Bjugstad,C,UTA,32,73,20,24,44
39,8478519,Anthony Cirelli,C,TBL,27,81,18,26,44
39,8481524,Bowen Byram,D,BUF,23,68,17,27,44
39,8480220,Noah Cates,L,PHI,25,71,16,28,44
39,8477998,Warren Foegele,L,LAK,28,80,15,29,44
39,8480434,Sean Durzi,D,UTA,26,70,10,34,44
39,8475314,Anders Lee,L,NYI,34,78,28,15,43
39,8479987,Morgan Geekie,C,BOS,26,80,23,20,43
39,8476881,Tomas Hertl,C,VGK,31,76,21,22,43
39,8474641,Adam Henrique,C,EDM,34,74,20,23,43
39,8482475,Yegor Chinakhov,R,CBJ,23,63,19,24,43
39,8477429,Andrew Copp,C,DET,30,79,15,28,43
39,8476432,Boone Jenner,C,CBJ,31,68,26,16,42
39,8483808,Andrei Kuzmenko,L,CGY,28,77,22,20,42
39,8475726,Tyler Toffoli,C,SJS,32,70,20,22,42
39,8482667,William Eklund,L,SJS,22,59,20,22,42
39,8482097,Jack Quinn,R,BUF,23,70,20,22,42
39,8477953,Kasperi Kapanen,R,STL,28,72,20,22,42
39,8475170,Brayden Schenn,C,STL,33,69,18,24,42
39,8476880,Tom Wilson,R,WSH,30,71,14,28,42
39,8481186,Logan O'Connor,R,COL,28,79,22,19,41
39,8481582,Nicholas Robertson,L,TOR,23,64,21,20,41
39,8475287,Erik Haula,L,NJD,33,72,20,21,41
39,8476438,Brandon Saad,L,STL,32,72,18,23,41
39,8475191,Reilly Smith,R,NYR,33,75,18,23,41
39,8474150,Mikael Backlund,C,CGY,35,78,14,27,41
39,8479345,Jakob Chychrun,D,WSH,26,63,13,28,41
39,8478038,Devon Toews,D,COL,30,67,9,32,41
39,8478472,Mathieu Joseph,R,STL,27,72,9,32,41
39,8482712,Oskar Olausson,R,COL,22,76,8,33,41
39,8471698,T.J. Oshie,R,WSH,38,68,22,18,40
39,8482113,Anton Lundell,C,FLA,23,76,18,22,40
39,8477021,Alex Kerfoot,C,UTA,30,64,18,22,40
39,8475151,Kyle Palmieri,C,NYI,33,79,17,23,40
39,8477503,Max Domi,C,TOR,29,77,10,30,40
39,8474565,Alex Pietrangelo,D,VGK,34,67,10,30,40
39,8475171,Oliver Ekman-Larsson,D,TOR,33,69,10,30,40
39,8475768,Jaden Schwartz,C,SEA,32,65,20,19,39
39,8481560,Arthur Kaliyev,R,LAK,23,78,18,21,39
39,8481604,Pavel Dorofeyev,L,VGK,24,68,18,21,39
39,8475168,Matt Duchene,C,DAL,33,79,16,23,39
39,8477479,Tyler Bertuzzi,L,CHI,29,64,16,23,39
39,8475764,Cam Fowler,D,ANA,33,71,4,35,39
39,8477444,Andre Burakovsky,L,SEA,29,70,18,20,38
39,8476872,Scott Laughton,C,PHI,30,74,18,20,38
39,8481481,Blake Lizotte,C,PIT,27,65,15,23,38
39,8477447,Shea Theodore,D,VGK,29,65,14,24,38
39,8475793,Ryan Johansen,C,PHI,32,71,14,24,38
39,8476897,Oskar Sundqvist,C,STL,30,68,14,24,38
39,8474053,Logan Couture,C,SJS,35,62,12,26,38
39,8481577,Philip Tomasino,C,NSH,23,71,11,27,38
39,8482105,Jake Sanderson,D,OTT,22,71,9,29,38
39,8478397,Rasmus Andersson,D,CGY,28,72,8,30,38
39,8482720,Matthew Knies,L,TOR,22,75,17,20,37
39,8481624,Ilya Mikheyev,R,CHI,30,64,17,20,37
39,8481596,Shane Pinto,C,OTT,24,77,16,21,37
39,8481535,Nils Hoglander,L,VAN,24,64,16,21,37
39,8484203,Bradly Nadeau,L,CAR,19,66,13,24,37
39,8477511,Anthony Mantha,R,CGY,30,71,12,25,37
39,8482671,Owen Power,D,BUF,22,69,10,27,37
39,8481542,Moritz Seider,D,DET,23,73,5,32,37
39,8480849,Barrett Hayton,C,UTA,24,71,19,17,36
39,8475722,Jason Zucker,L,BUF,32,67,15,21,36
39,8475218,Mattias Ekholm,D,EDM,34,73,13,23,36
39,8480014,Gabriel Vilardi,C,WPG,25,61,24,11,35
39,8478474,Lawson Crouse,L,UTA,27,76,20,15,35
39,8476826,Yanni Gourde,C,SEA,33,78,18,17,35
39,8480188,Fabian Zetterlund,L,SJS,25,69,17,18,35
39,8478466,Daniel Sprong,R,VAN,27,66,16,19,35
39,8476981,Josh Anderson,R,MTL,30,66,15,20,35
39,8482702,Logan Stankoven,C,DAL,21,80,14,21,35
39,8477451,Ryan Hartman,R,MIN,30,62,13,22,35
39,8476458,Ryan Strome,C,ANA,31,68,13,22,35
39,8477497,Sean Monahan,C,CBJ,30,70,11,24,35
39,8482149,Cole Perfetti,C,WPG,22,66,9,26,35
39,8476462,Dougie Hamilton,D,NJD,31,69,9,26,35
39,8480336,Sean Walker,D,CAR,30,69,8,27,35
39,8478438,Tommy Novak,C,NSH,27,62,7,28,35
39,8476931,Jake McCabe,D,TOR,31,68,4,31,35
39,8478366,Frank Vatrano,R,ANA,30,69,17,17,34
39,8482117,Lukas Reichel,L,CHI,22,60,17,17,34
39,8478109,Victor Olofsson,L,VGK,29,70,17,17,34
39,8480798,Philipp Kurashev,C,CHI,25,57,14,20,34
39,8477425,Miles Wood,L,COL,29,72,14,20,34
39,8475763,Kevin Hayes,R,PIT,32,67,13,21,34
39,8477839,Conor Sheary,L,TBL,32,79,11,23,34
39,8476979,Erik Gustafsson,D,DET,32,77,9,25,34
39,8480145,Neal Pionk,D,WPG,29,68,6,28,34
39,8479976,Juuso Valimaki,D,UTA,26,68,6,28,34
39,8480068,Ryan Poehling,C,PHI,25,65,19,14,33
39,8479591,Michael Eyssimont,C,TBL,28,81,17,16,33
39,8473533,Jordan Staal,C,CAR,36,65,17,16,33
39,8478020,Michael Amadio,R,OTT,28,73,16,17,33
39,8478458,John (Jack) Roslovic,C,CAR,27,64,14,19,33
39,8476882,Teuvo Teravainen,C,CHI,30,65,13,20,33
39,8482133,Thomas Bordeleau,C,SJS,22,61,12,21,33
39,8480871,Adam Boqvist,D,FLA,24,76,11,22,33
39,8473507,Jeff Petry,D,DET,37,72,7,26,33
39,8481703,Valtteri Puustinen,R,PIT,25,58,3,30,33
39,8474715,Cameron Atkinson,R,TBL,35,81,16,16,32
39,8481523,Kirby Dach,C,MTL,23,67,14,18,32
39,8476474,Stefan Noesen,R,NJD,31,69,13,19,32
39,8474149,Evgenii Dadonov,R,DAL,35,77,12,20,32
39,8475149,Marcus Johansson,L,MIN,34,68,10,22,32
39,8476331,Dylan DeMelo,D,WPG,31,69,7,25,32
39,8481546,Cam York,D,PHI,23,65,6,26,32
39,8482146,Luke Evangelista,R,NSH,22,72,21,10,31
39,8474189,Lars Eller,C,PIT,35,65,15,16,31
39,8475714,Calle Jarnkrok,C,TOR,33,72,15,16,31
39,8482089,Jake Neighbours,L,STL,22,70,15,16,31
39,8477478,William Carrier,L,CAR,30,58,15,16,31
39,8475193,Tomas Tatar,L,NJD,34,67,14,17,31
39,8470621,Corey Perry,R,EDM,39,75,14,17,31
39,8480459,Pius Suter,C,VAN,28,67,13,18,31
39,8476885,Jacob Trouba,D,NYR,30,68,13,18,31
39,8476869,Brady Skjei,D,NSH,30,68,8,23,31
39,8480817,K'Andre Miller,D,NYR,24,73,3,28,31
39,8482809,Jackson Blake,R,CAR,21,60,16,14,30
39,8478046,Danton Heinen,L,VAN,29,74,15,15,30
39,8480829,Jesperi Kotkaniemi,C,CAR,24,66,15,15,30
39,8480009,Eeli Tolvanen,R,SEA,25,70,15,15,30
39,8481093,Rafael Harvey-Pinard,L,MTL,25,64,13,17,30
39,8482125,Alexander Holtz,R,VGK,22,68,12,18,30
39,8476921,Jordan Martinook,L,CAR,32,63,12,18,30
39,8477989,Christian Dvorak,C,MTL,28,58,11,19,30
39,8477947,Sonny Milano,L,WSH,28,63,10,20,30
39,8474563,Drew Doughty,D,LAK,35,70,8,22,30
39,8476419,Jean-Gabriel Pageau,C,NYI,32,78,7,23,30
39,8474151,Ryan McDonagh,D,TBL,35,76,3,27,30
39,8479293,Brandon Tanev,L,SEA,33,69,15,14,29
39,8483499,Liam Ohgren,L,MIN,20,56,14,15,29
39,8477505,Alexander Wennberg,C,SJS,30,65,13,16,29
39,8480762,Eric Robinson,L,CAR,29,64,13,16,29
39,8480185,Eetu Luostarinen,C,FLA,26,77,10,19,29
39,8480802,Ryan McLeod,C,BUF,25,64,7,22,29
39,8476878,Zemgus Girgensons,C,TBL,30,80,17,11,28
39,8477450,Jason Dickinson,C,CHI,29,58,15,13,28
39,8478413,Jordan Greenway,L,BUF,27,71,14,14,28
39,8473453,Trevor Lewis,C,LAK,37,76,14,14,28
39,8478115,Pierre Engvall,L,NYI,28,71,11,17,28
39,8476278,Colin Blackwell,C,DAL,31,78,11,17,28
39,8476392,Adam Lowry,C,WPG,31,63,10,18,28
39,8479393,Noah Gregor,L,OTT,26,76,9,19,28
39,8475791,Taylor Hall,L,CHI,33,58,9,19,28
39,8475200,Dmitry Orlov,D,CAR,33,72,8,20,28
39,8474716,Jared Spurgeon,D,MIN,35,77,7,21,28
39,8482087,Kaiden Guhle,D,MTL,22,66,3,25,28
39,8480873,Rasmus Sandin,D,WSH,24,66,2,26,28
39,8476917,Adam Pelech,D,NYI,30,77,1,27,28
39,8479619,Michael Carcone,L,UTA,28,67,18,9,27
39,8481032,Paul Cotter,C,NJD,25,64,17,10,27
39,8480893,Kirill Marchenko,R,CBJ,24,65,16,11,27
39,8476461,Sean Couturier,C,PHI,32,68,13,14,27
39,8473422,Nick Foligno,L,CHI,37,53,13,14,27
39,8479315,Joey Anderson,R,CHI,26,46,13,14,27
39,8478057,Dakota Joshua,C,VAN,28,63,12,15,27
39,8478911,Matt Roy,D,WSH,29,59,12,15,27
39,8477979,Nicolas Aube-Kubel,R,BUF,28,60,11,16,27
39,8481553,Bobby Brink,R,PHI,23,58,10,17,27
39,8482660,Kent Johnson,C,CBJ,22,64,8,19,27
39,8482705,Cole Sillinger,C,CBJ,21,59,18,8,26
39,8482055,Drew O'Connor,L,PIT,26,63,14,12,26
39,8480855,Jack McBain,C,UTA,24,68,14,12,26
39,8476927,Teddy Blueger,C,VAN,30,69,13,13,26
39,8475225,Craig Smith,C,CHI,35,54,13,13,26
39,8483505,Matthew Poitras,C,BOS,20,76,12,14,26
39,8480078,Filip Chytil,C,NYR,25,66,10,16,26
39,8478463,Anthony Beauvillier,L,PIT,27,62,10,16,26
39,8481606,Jordan Spence,D,LAK,23,65,8,18,26
39,8476923,Damon Severson,D,CBJ,30,82,6,20,26
39,8476463,Jonas Brodin,D,MIN,31,80,4,22,26
39,8476988,Matt Benning,D,SJS,30,66,4,22,26
39,8477948,Travis Sanheim,D,PHI,28,71,3,23,26
39,8478507,John Marino,D,UTA,27,65,3,23,26
39,8483445,Cutter Gauthier,L,ANA,20,69,14,11,25
39,8477987,Ryan Donato,C,CHI,28,61,13,12,25
39,8476469,Joel Armia,R,MTL,31,61,13,12,25
39,8479390,Taylor Raddysh,R,WSH,26,66,12,13,25
39,8480813,Joe Veleno,C,DET,24,79,10,15,25
39,8482101,Danil Gushchin,L,SJS,22,60,9,16,25
39,8479639,Dylan Coghlan,D,WPG,26,57,9,16,25
39,8475279,Ben Chiarot,D,DET,33,68,6,19,25
39,8478500,Ivan Provorov,D,CBJ,27,77,3,22,25
39,8479398,Samuel Girard,D,COL,26,70,1,24,25
39,8478891,Mason Appleton,C,WPG,28,64,11,13,24
39,8475848,Brendan Gallagher,R,MTL,32,71,11,13,24
39,8480113,Alex Iafallo,L,WPG,31,65,11,13,24
39,8480835,Jack Drury,C,CAR,24,50,10,14,24
39,8479351,Sam Steel,C,DAL,26,79,10,14,24
39,8476918,Jimmy Vesey,L,NYR,31,68,10,14,24
39,8477392,Hudson Fasching,R,NYI,29,60,9,15,24
39,8482111,Justin Barron,D,MTL,23,72,8,16,24
39,8481656,Aliaksei Protas,C,WSH,23,59,8,16,24
39,8479661,Tanner Jeannot,L,LAK,27,76,7,17,24
39,8482624,Daniil Miromanov,D,CGY,27,60,6,18,24
39,8476925,Colton Sissons,C,NSH,31,65,6,18,24
39,8477507,Nikita Zadorov,D,BOS,29,64,6,18,24
39,8482073,Braden Schneider,D,NYR,23,64,1,23,24
39,8480049,Dylan Samberg,D,WPG,25,69,0,24,24
39,8475220,Marcus Foligno,L,MIN,33,55,13,10,23
39,8475343,Nic Dowd,C,WSH,34,53,12,11,23
39,8481554,Kaapo Kakko,R,NYR,23,65,11,12,23
39,8481441,Joe Snively,C,DET,28,63,10,13,23
39,8476960,Andreas Athanasiou,C,CHI,30,56,10,13,23
39,8479353,Brett Howden,C,VGK,26,66,8,15,23
39,8481704,Juuso Parssinen,C,NSH,23,53,8,15,23
39,8477952,Robby Fabbri,C,ANA,28,62,6,17,23
39,8478133,Jake Evans,C,MTL,28,66,6,17,23
39,8479324,Ryan Lindgren,D,NYR,26,67,5,18,23
39,8478851,Alexandre Carrier,D,NSH,28,68,4,19,23
39,8483490,Pavel Mintyukov,D,ANA,21,73,3,20,23
39,8477845,Trevor van Riemsdyk,D,WSH,33,57,1,22,23
39,8480891,Michael Kesselring,D,UTA,24,63,0,23,23
39,8475231,Casey Cizikas,C,NYI,33,74,13,9,22
39,8480289,Morgan Barron,C,WPG,26,61,12,10,22
39,8476873,Mark Jankowski,C,NSH,30,52,11,11,22
39,8479941,Justin Danforth,R,CBJ,31,58,10,12,22
39,8477015,Connor Brown,R,EDM,30,69,10,12,22
39,8479543,Michael Pezzetta,L,MTL,26,60,8,14,22
39,8481178,Egor Zamula,D,PHI,24,58,8,14,22
39,8477488,Brett Pesce,D,NJD,30,71,6,16,22
39,8480172,Jan Rutta,D,SJS,34,59,6,16,22
39,8478882,Vladislav Gavrikov,D,LAK,29,70,4,18,22
39,8478416,Erik Cernak,D,TBL,27,78,4,18,22
39,8476457,Adam Larsson,D,SEA,32,72,4,18,22
39,8477506,Ryan Pulock,D,NYI,30,78,2,20,22
39,8482245,Artem Zub,D,OTT,29,71,1,21,22
39,8477353,Tyler Motte,C,DET,29,71,15,6,21
39,8477446,Michael McCarron,R,NSH,29,58,12,9,21
39,8480806,Isac Lundestrom,C,ANA,25,60,12,9,21
39,8479718,Alex Barré-Boulet,C,MTL,27,58,11,10,21
39,8479336,Carl Grundstrom,R,SJS,27,57,11,10,21
39,8482079,Marco Rossi,C,MIN,23,52,8,13,21
39,8478432,Christian Fischer,R,DET,27,76,8,13,21
39,8476480,Vladislav Namestnikov,C,WPG,32,59,7,14,21
39,8482730,Brandt Clarke,D,LAK,21,51,7,14,21
39,8476525,Colin Miller,D,WPG,32,66,7,14,21
39,8479980,Nicolas Hague,D,VGK,26,53,7,14,21
39,8482067,Connor Mackey,D,NYR,28,63,6,15,21
39,8476422,Mike Reilly,D,NYI,31,74,6,15,21
39,8475462,Radko Gudas,D,ANA,34,61,4,17,21
39,8477435,Ryan Graves,D,PIT,29,74,4,17,21
39,8481059,Scott Perunovich,D,STL,26,60,3,18,21
39,8479316,Luke Kunin,C,SJS,27,59,13,7,20
39,8481580,Connor McMichael,C,WSH,23,61,13,7,20
39,8478585,Derek Ryan,C,EDM,38,63,13,7,20
39,8478831,Kevin Stenlund,C,UTA,28,54,11,9,20
39,8483457,Lane Hutson,D,MTL,20,67,8,12,20
39,8480073,Erik Brannstrom,D,COL,25,63,8,12,20
39,8478043,Sam Lafferty,C,BUF,29,55,8,12,20
39,8480144,David Kampf,C,TOR,29,79,6,14,20
39,8481522,Peyton Krebs,C,BUF,23,56,6,14,20
39,8478013,Jake Walman,D,SJS,28,68,5,15,20
39,8478840,Will Borgen,D,SEA,28,67,5,15,20
39,8475208,Brian Dumoulin,D,ANA,33,70,5,15,20
39,8475181,Nick Leddy,D,STL,33,72,4,16,20
39,8481521,Ronnie Attard,D,PHI,25,62,4,16,20
39,8476902,Esa Lindell,D,DAL,30,64,4,16,20
39,8480043,Timothy Liljegren,D,TOR,25,67,3,17,20
39,8475233,David Savard,D,MTL,34,62,2,18,20
39,8477969,Marcus Pettersson,D,PIT,28,79,1,19,20
39,8482259,Bobby McMann,C,TOR,28,67,13,6,19
39,8482737,Zack Bolduc,C,STL,21,54,13,6,19
39,8477919,Frederick Gaudreau,C,MIN,31,61,9,10,19
39,8480281,Alexey Toropchenko,R,STL,25,56,9,10,19
39,8476329,Travis Boyd,C,MIN,31,54,9,10,19
39,8480789,Oliver Wahlstrom,R,NYI,24,79,9,10,19
39,8479996,Cody Glass,C,NSH,25,58,8,11,19
39,8477903,Garnet Hathaway,R,PHI,33,68,8,11,19
39,8476856,Mathew Dumba,D,DAL,30,72,6,13,19
39,8482142,Jamie Drysdale,D,PHI,22,62,6,13,19
39,8482807,Ethan Del Mastro,D,CHI,21,50,6,13,19
39,8483466,Kevin Korchinski,D,CHI,20,55,6,13,19
39,8478970,Jalen Chatfield,D,CAR,28,74,5,14,19
39,8479414,Nathan Bastian,R,NJD,27,51,5,14,19
39,8480035,Henri Jokiharju,D,BUF,25,66,2,17,19
39,8483468,Jiri Kulich,C,BUF,20,56,2,17,19
39,8481014,Alexander Romanov,D,NYI,24,75,1,18,19
39,8476892,Colton Parayko,D,STL,31,75,1,18,19
39,8483495,Simon Nemec,D,NJD,20,59,11,7,18
39,8480980,Connor Dewar,C,TOR,25,64,9,9,18
39,8483524,Shane Wright,C,SEA,20,60,8,10,18
39,8474034,Patrick Maroon,L,CHI,36,52,8,10,18
39,8480448,Parker Kelly,L,COL,25,76,6,12,18
39,8483565,Nick Blankenburg,D,NSH,26,55,6,12,18
39,8475855,Jesper Fast,R,CAR,33,50,6,12,18
39,8477499,Rasmus Ristolainen,D,PHI,30,51,5,13,18
39,8471709,Marc-Edouard Vlasic,D,SJS,37,63,3,15,18
39,8479369,Andrew Peeke,D,BOS,26,58,3,15,18
39,8474574,Tyler Myers,D,VAN,34,72,2,16,18
39,8475790,Erik Gudbranson,D,CBJ,32,77,1,17,18
39,8482074,Connor Zary,C,CGY,23,67,13,4,17
39,8478569,Noel Acciari,C,PIT,33,59,10,7,17
39,8481477,Nico Sturm,C,SJS,29,56,9,8,17
39,8480003,Jesper Boqvist,C,FLA,26,69,8,9,17
39,8478434,Keegan Kolesar,R,VGK,27,64,8,9,17
39,8476994,Vinnie Hinostroza,C,NSH,30,51,8,9,17
39,8481019,David Gustafsson,C,WPG,24,40,8,9,17
39,8473563,Nicklas Backstrom,C,WSH,37,54,7,10,17
39,8479066,Ryan Lomberg,L,CGY,30,65,7,10,17
39,8481517,Brett Leason,R,ANA,25,57,7,10,17
39,8482803,Olen Zellweger,D,ANA,21,68,6,11,17
39,8478452,Caleb Jones,D,LAK,27,59,6,11,17
39,8475842,Sam Carrick,C,NYR,32,59,4,13,17
39,8479983,Mario Ferraro,D,SJS,26,71,4,13,17
39,8478443,Brandon Carlo,D,BOS,28,62,4,13,17
39,8478178,Darren Raddysh,D,TBL,28,69,4,13,17
39,8476312,Josh Manson,D,COL,33,64,3,14,17
39,8481527,Kaedan Korczak,D,VGK,23,43,3,14,17
39,8479998,Mikey Anderson,D,LAK,25,63,2,15,17
39,8474673,TJ Brodie,D,CHI,34,66,2,15,17
39,8478399,Jonas Siegenthaler,D,NJD,27,63,2,15,17
39,8475690,Chris Tanev,D,TOR,35,62,2,15,17
39,8478136,Jake Middleton,D,MIN,28,72,1,16,17
39,8481716,Dmitri Voronkov,L,CBJ,24,46,13,3,16
39,8482062,Cole Smith,L,NSH,29,56,10,6,16
39,8480074,Alexandre Texier,C,STL,25,47,9,7,16
39,8480192,Johnathan Kovacevic,D,NJD,27,49,7,9,16
39,8477018,Ben Hutton,D,VGK,31,56,7,9,16
39,8476442,Matt Nieto,L,PIT,32,49,7,9,16
39,8474013,Ian Cole,D,UTA,35,58,4,12,16
39,8479982,Conor Timmins,D,TOR,26,58,3,13,16
39,8483460,David Jiricek,D,CBJ,21,56,3,13,16
39,8482192,Isaak Phillips,D,CHI,23,55,3,13,16
39,8484149,Gavin Brindley,C,CBJ,20,49,3,13,16
39,8481617,Vasily Podkolzin,R,VAN,23,54,3,13,16
39,8480246,Nick Perbix,D,TBL,26,77,2,14,16
39,8476874,Olli Maatta,D,DET,30,62,2,14,16
39,8478508,Yakov Trenin,C,MIN,27,62,11,4,15
39,8478421,A.J. Greer,L,FLA,28,54,11,4,15
39,8478211,Dryden Hunt,L,CGY,29,58,9,6,15
39,8483482,Tristan Luneau,D,ANA,20,60,8,7,15
39,8479370,Tyson Jost,C,CAR,26,51,8,7,15
39,8482634,Alex Steeves,C,TOR,25,47,8,7,15
39,8482679,Matt Coronato,R,CGY,22,67,7,8,15
39,8477508,Curtis Lazar,C,NJD,29,59,7,8,15
39,8479439,Jacob MacDonald,D,COL,31,52,7,8,15
39,8481567,Henry Thrun,D,SJS,23,53,7,8,15
39,8477369,Carson Soucy,D,VAN,30,57,6,9,15
39,8481028,Martin Pospisil,C,CGY,25,57,6,9,15
39,8482148,Hendrix Lapierre,C,WSH,22,54,6,9,15
39,8480355,Mark Kastelic,C,BOS,25,60,6,9,15
39,8480807,Mattias Samuelsson,D,BUF,24,54,3,12,15
39,8475750,Jon Merrill,D,MIN,32,60,3,12,15
39,8480887,Jordan Harris,D,MTL,24,43,3,12,15
39,8475324,Nick Jensen,D,OTT,34,61,2,13,15
39,8480222,Sebastian Aho,D,PIT,28,77,1,14,15
39,8481708,Zac Jones,D,NYR,24,48,1,14,15
39,8483493,Frank Nazar,C,CHI,20,44,10,4,14
39,8481641,Joel Kiviranta,L,COL,28,68,9,5,14
39,8476374,Sean Kuraly,C,CBJ,31,56,8,6,14
39,8480748,Kiefer Sherwood,L,VAN,29,55,7,7,14
39,8480441,Trey Fix-Wolansky,R,CBJ,25,48,7,7,14
39,8482749,Joshua Roy,R,MTL,21,59,6,8,14
39,8479328,Julien Gauthier,R,NYI,27,63,6,8,14
39,8480252,Cole Guttman,C,CHI,25,45,6,8,14
39,8477482,Zachary Sanford,L,CHI,30,35,4,10,14
39,8476467,Jamie Oleksiak,D,SEA,32,64,3,11,14
39,8476891,Matthew Grzelcyk,D,PIT,30,78,3,11,14
39,8470600,Ryan Suter,D,STL,39,63,3,11,14
39,8480879,Jacob Bernard-Docker,D,OTT,24,45,2,12,14
39,8482155,Alex Laferriere,R,LAK,23,60,11,2,13
39,8476889,Radek Faksa,C,STL,30,59,8,5,13
39,8481013,Jonatan Berggren,R,DET,24,58,7,6,13
39,8477573,Nathan Walker,L,STL,30,47,7,6,13
39,8479368,Max Jones,L,BOS,26,60,6,7,13
39,8480205,Emil Bemstrom,C,PIT,25,59,6,7,13
39,8477962,Brendan Lemieux,L,CAR,28,41,6,7,13
39,8476934,Brock McGinn,L,ANA,30,58,6,7,13
39,8476858,Phillip Di Giuseppe,L,VAN,31,46,6,7,13
39,8479671,Mathieu Olivier,R,CBJ,27,47,5,8,13
39,8480001,Urho Vaakanainen,D,ANA,25,59,5,8,13
39,8479344,Jesse Puljujarvi,R,PIT,26,52,4,9,13
39,8482451,Mikael Pyyhtia,L,CBJ,23,41,4,9,13
39,8480011,Klim Kostin,C,SJS,25,49,4,9,13
39,8476967,Brett Kulak,D,EDM,30,58,3,10,13
39,8479944,Zach Aston-Reese,C,VGK,30,44,3,10,13
39,8479402,Jake Bean,D,CGY,26,69,2,11,13
39,8475188,Brayden McNabb,D,VGK,33,57,2,11,13
39,8476879,Cody Ceci,D,EDM,31,68,1,12,13
39,8475179,Dmitry Kulikov,D,FLA,34,65,1,12,13
39,8481550,Adam Beckman,L,NJD,23,42,1,12,13
39,8481167,Brayden Pachal,D,CGY,25,47,1,12,13
39,8479520,Brandon Duhaime,R,WSH,27,61,7,5,12
39,8480025,MacKenzie Entwistle,R,FLA,25,61,7,5,12
39,8482659,Josh Doan,R,UTA,22,55,7,5,12
39,8480995,Pontus Holmberg,R,TOR,25,56,6,6,12
39,8477070,Liam O'Brien,C,UTA,30,62,5,7,12
39,8479536,Axel Jonsson-Fjallby,L,WPG,26,46,4,8,12
39,8480860,Kevin Bahl,D,CGY,24,59,3,9,12
39,8481701,Santeri Hatakka,D,NJD,23,38,3,9,12
39,8481056,Spencer Stastney,D,NSH,24,37,3,9,12
39,8479372,Joshua Mahura,D,SEA,26,51,2,10,12
39,8482511,Mason Lohrei,D,BOS,23,41,2,10,12
39,8482176,Wyatt Kaiser,D,CHI,22,49,1,11,12
39,8478468,Jeremy Lauzon,D,NSH,27,50,0,12,12
39,8482153,Brendan Brisson,C,VGK,23,39,8,3,11
39,8479772,Zack MacEwen,R,OTT,28,51,7,4,11
39,8479359,Beck Malenstyn,L,BUF,26,42,6,5,11
39,8482762,Simon Edvinsson,D,DET,21,55,6,5,11
39,8476822,Luke Glendening,C,TBL,35,74,5,6,11
39,8476952,Dominic Toninato,C,WPG,30,41,5,6,11
39,8481147,Reese Johnson,C,MIN,26,39,5,6,11
39,8483491,Ivan Miroshnichenko,L,WSH,20,55,4,7,11
39,8480245,Olle Lycksell,R,PHI,25,33,4,7,11
39,8477220,Nate Schmidt,D,FLA,33,64,3,8,11
39,8476429,Scott Mayfield,D,NYI,32,74,3,8,11
39,8475718,Justin Holl,D,DET,32,57,3,8,11
39,8482964,Arber Xhekaj,D,MTL,23,46,3,8,11
39,8478451,Ethan Bear,D,WSH,27,48,2,9,11
39,8477365,Connor Clifton,D,BUF,29,54,2,9,11
39,8475455,Brenden Dillon,D,NJD,34,56,2,9,11
39,8479986,Kole Lind,R,DAL,26,49,2,9,11
39,8481161,Jake Christiansen,D,CBJ,25,62,2,9,11
39,8484254,Akito Hirose,D,VAN,25,35,2,9,11
39,8479249,Andrew Poturalski,C,SJS,30,39,1,10,11
39,8482861,Vincent Iorio,D,WSH,22,40,0,11,11
39,8480021,Jack Studnicka,C,LAK,25,63,6,4,10
39,8481754,Nikita Nesterenko,C,ANA,23,35,6,4,10
39,8476867,Brendan Gaunce,C,MIN,30,32,5,5,10
39,8475958,Michael Sgarbossa,C,WSH,32,34,5,5,10
39,8481532,Alex Turcotte,C,LAK,23,45,5,5,10
39,8477406,Mattias Janmark,C,EDM,32,60,4,6,10
39,8481601,Simon Holmstrom,R,NYI,23,64,4,6,10
39,8482077,Dylan Holloway,L,EDM,23,49,4,6,10
39,8477931,Tomas Nosek,L,FLA,32,54,4,6,10
39,8479378,Logan Stanley,D,WPG,26,44,4,6,10
39,8480878,Nils Lundkvist,D,DAL,24,72,3,7,10
39,8480848,Ty Dellandrea,C,SJS,24,43,3,7,10
39,8471677,Jack Johnson,D,CBJ,37,60,3,7,10
39,8478424,Jansen Harkins,C,ANA,27,38,3,7,10
39,8474567,Zach Bogosian,D,MIN,34,61,2,8,10
39,8481568,Alex Vlasic,D,CHI,23,60,2,8,10
39,8480070,Ian Mitchell,D,BOS,25,47,2,8,10
39,8476473,Connor Murphy,D,CHI,31,31,2,8,10
39,8483549,Lucas Condotta,L,MTL,27,43,2,8,10
39,8480796,Martin Fehervary,D,WSH,25,50,1,9,10
39,8482157,Will Cuylle,L,NYR,22,59,5,4,9
39,8481599,Victor Soderstrom,D,UTA,23,43,5,4,9
39,8474090,Brendan Smith,D,DAL,35,61,5,4,9
39,8476624,Barclay Goodrow,C,SJS,31,46,4,5,9
39,8480157,Calle Rosen,D,COL,30,49,4,5,9
39,8483619,Filip Roos,D,OTT,25,37,4,5,9
39,8477401,John Hayden,C,SEA,29,33,4,5,9
39,8477380,Jonny Brodzinski,C,NYR,31,51,3,6,9
39,8480727,Zach Whitecloud,D,VGK,28,46,3,6,9
39,8476372,Nick Seeler,D,PHI,31,48,3,6,9
39,8473446,Erik Johnson,D,PHI,36,49,2,7,9
39,8482095,Tyler Kleven,D,OTT,22,44,1,8,9
39,8480196,Jacob Bryson,D,BUF,27,43,1,8,9
39,8480880,Jakub Lauko,C,MIN,24,32,6,2,8
39,8481518,Nolan Foote,L,NJD,24,38,5,3,8
39,8482070,Mitchell Chaffee,R,TBL,26,51,5,3,8
39,8474166,Alec Martinez,D,CHI,37,43,4,4,8
39,8481751,Lukas Rousek,R,BUF,25,50,4,4,8
39,8482747,Brennan Othmann,L,NYR,21,42,4,4,8
39,8479972,Mason Shaw,C,WPG,26,38,3,5,8
39,8481598,Philip Broberg,D,EDM,23,41,3,5,8
39,8479348,Kale Clague,D,BUF,26,37,3,5,8
39,8482496,Nils Aman,C,VAN,24,38,2,6,8
39,8479371,Dante Fabbro,D,NSH,26,66,2,6,8
39,8480950,Ilya Lyubushkin,D,DAL,30,56,2,6,8
39,8477034,Jaycob Megna,D,FLA,32,37,1,7,8
39,8482666,Scott Morrow,D,CAR,22,48,1,7,8
39,8475762,Derek Forbort,D,VAN,32,52,1,7,8
39,8482166,Shakir Mukhamadullin,D,SJS,22,57,5,2,7
39,8482652,Walker Duehr,R,CGY,27,44,5,2,7
39,8480292,Carson Meyer,R,ANA,27,26,5,2,7
39,8481537,Nikita Okhotiuk,D,CGY,24,46,4,3,7
39,8482744,James Malatesta,L,CBJ,21,43,4,3,7
39,8481592,Jakob Pelletier,L,CGY,23,40,4,3,7
39,8482145,Mavrik Bourque,C,DAL,22,52,4,3,7
39,8481543,Nikita Alexandrov,C,STL,24,34,4,3,7
39,8479994,Jaret Anderson-Dolan,C,WPG,25,41,3,4,7
39,8479291,Kevin Rooney,C,CGY,31,52,3,4,7
39,8476441,Joel Edmundson,D,LAK,31,43,3,4,7
39,8471817,Ryan Reaves,R,TOR,37,55,3,4,7
39,8475235,Nicolas Deslauriers,L,PHI,33,57,3,4,7
39,8482177,Marat Khusnutdinov,C,MIN,22,45,3,4,7
39,8479442,Troy Stecher,D,EDM,30,53,2,5,7
39,8480058,Pierre-Olivier Joseph,D,STL,25,49,2,5,7
39,8481605,Jackson LaCombe,D,ANA,23,30,2,5,7
39,8481609,Vladislav Kolyachonok,D,UTA,23,32,2,5,7
39,8478454,Noah Juulsen,D,VAN,27,27,2,5,7
39,8479026,Philippe Myers,D,TOR,27,46,1,6,7
39,8478017,Mark Friedman,D,VAN,29,47,1,6,7
39,8477887,Patrick Brown,C,BOS,32,51,1,6,7
39,8477384,Joshua Brown,D,EDM,30,50,0,7,7
39,8482751,Ryan Winterton,C,SEA,21,32,3,3,6
39,8478409,Anthony Richard,C,PHI,28,24,3,3,6
39,8480990,Declan Chisholm,D,MIN,24,31,3,3,6
39,8481122,Simon Benoit,D,TOR,26,36,3,3,6
39,8479981,Jonah Gadjovich,L,FLA,26,43,2,4,6
39,8480007,Jonas Rondbjerg,R,VGK,25,43,2,4,6
39,8478859,Niko Mikkola,D,FLA,28,59,2,4,6
39,8480844,Grigori Denisenko,L,VGK,24,29,2,4,6
39,8474612,Travis Hamonic,D,OTT,34,50,2,4,6
39,8480834,Ty Emberson,D,SJS,24,32,1,5,6
39,8477851,Jordan Oesterle,D,BOS,32,37,1,5,6
39,8484911,Collin Graf,R,SJS,22,41,1,5,6
39,8479576,Vincent Desharnais,D,VAN,28,31,1,5,6
39,8480845,Rasmus Kupari,C,WPG,24,36,0,6,6
39,8482733,Logan Mailloux,D,MTL,31,37,5,0,5
39,8478146,Matthew Highmore,C,OTT,28,35,4,1,5
39,8482147,Jean-Luc Foudy,C,COL,22,34,4,1,5
39,8481789,Tye Kartye,L,SEA,23,38,4,1,5
39,8483570,Ben Meyers,C,SEA,26,27,3,2,5
39,8479638,Justin Brazeau,R,BOS,26,35,2,3,5
39,8483630,Pavol Regenda,L,ANA,25,30,2,3,5
39,8481593,Jayden Struble,D,MTL,23,24,2,3,5
39,8484287,Cole McWard,D,VAN,23,24,2,3,5
39,8482784,Zach Dean,C,STL,21,36,1,4,5
39,8478450,Parker Wotherspoon,D,BOS,27,38,1,4,5
39,8475795,Dylan McIlrath,D,WSH,32,19,1,4,5
39,8479985,Cale Fleury,D,SEA,26,25,1,4,5
39,8477527,Ross Johnston,L,ANA,30,33,0,5,5
39,8478874,Adam Gaudette,R,OTT,28,37,4,0,4
39,8479367,William Lockwood,R,FLA,26,26,4,0,4
39,8483397,Marc McLaughlin,C,BOS,25,23,3,1,4
39,8480870,Bo Groulx,C,NYR,24,32,3,1,4
39,8481043,Cole Koepke,L,BOS,26,17,3,1,4
39,8483512,Matthew Savoie,C,EDM,20,21,3,1,4
39,8482713,Mackie Samoskevich,R,FLA,22,46,2,2,4
39,8481065,Angus Crookshank,L,OTT,25,14,2,2,4
39,8477938,Haydn Fleury,D,WPG,28,40,2,2,4
39,8481422,Jake Lucchini,C,NSH,29,20,2,2,4
39,8477467,Gustav Olofsson,D,SEA,30,17,2,2,4
39,8482094,Daemon Hunt,D,MIN,22,19,2,2,4
39,8474568,Luke Schenn,D,NSH,35,53,1,3,4
39,8476913,Devin Shore,C,MIN,30,31,1,3,4
39,8482859,Zack Ostapchuk,C,OTT,21,53,1,3,4
39,8475177,Calvin de Haan,D,COL,33,35,1,3,4
39,8477244,Chad Ruhwedel,D,NYR,34,31,1,3,4
39,8484258,Sam Malinski,D,COL,26,23,1,3,4
39,8478477,Mitchell Stephens,C,SEA,27,17,1,3,4
39,8479320,Maxime Lajoie,D,SEA,27,23,1,3,4
39,8481806,Louis Crevier,D,CHI,23,14,1,3,4
39,8482141,Lukas Cormier,D,VGK,22,21,1,3,4
39,8481743,Marc Del Gaizo,D,NSH,25,21,0,4,4
39,8483763,Maksymilian Szuber,D,UTA,22,29,2,1,3
39,8479991,Jake Leschyshyn,C,NYR,25,25,2,1,3
39,8481578,Graeme Clarke,R,MIN,23,13,2,1,3
39,8482858,Ryker Evans,D,SEA,23,31,2,1,3
39,8483012,Logan Morrison,C,SEA,22,36,2,1,3
39,8482118,Sam Colangelo,R,ANA,23,15,2,1,3
39,8481600,Tobias Bjornfot,D,FLA,23,41,1,2,3
39,8479968,Vinni Lettieri,C,BOS,29,45,1,2,3
39,8479362,Riley Tufte,L,BOS,26,20,1,2,3
39,8481679,Maxence Guenette,D,OTT,23,45,1,2,3
39,8480823,Alexander Alexeyev,D,WSH,25,20,1,2,3
39,8482929,Emil Lilleberg,D,TBL,23,21,1,2,3
39,8483395,Arshdeep Bains,L,VAN,23,16,1,2,3
39,8483597,Milos Kelemen,L,UTA,25,16,1,2,3
39,8477810,Joel Hanley,D,CGY,33,24,0,3,3
39,8482250,Callahan Burke,C,VGK,27,24,0,3,3
39,8481006,Tyler Tucker,D,STL,24,13,0,3,3
39,8481556,John Beecher,C,BOS,23,36,2,0,2
39,8478051,Max Willman,C,NJD,29,17,2,0,2
39,8480874,Adam Ginning,D,PHI,24,11,2,0,2
39,8482476,Emil Heineman,L,MTL,23,6,2,0,2
39,8477473,Justin Bailey,R,SJS,29,22,1,1,2
39,8475755,Alexander Petrovic,D,DAL,32,16,1,1,2
39,8482470,Ilya Solovyov,D,CGY,24,17,1,1,2
39,8480890,Jan Jenik,C,OTT,24,20,1,1,2
39,8481541,Samuel Bolduc,D,NYI,24,27,1,1,2
39,8482165,Yan Kuznetsov,D,CGY,22,27,1,1,2
39,8477971,Andreas Englund,D,LAK,28,28,1,1,2
39,8482144,Jack Thompson,D,SJS,22,23,0,2,2
39,8479379,Givani Smith,R,SJS,26,26,0,2,2
39,8477462,Robert Hagg,D,VGK,29,18,0,2,2
39,8481030,Jack St. Ivany,D,PIT,25,12,0,2,2
39,8484304,Uvis Balinskis,D,FLA,28,12,0,2,2
39,8480084,Nick DeSimone,D,NJD,30,11,0,2,2
39,8477320,Anton Blidh,L,NYR,29,20,0,2,2
39,8482126,Emil Andrae,D,PHI,31,1,0,2,2
39,8483471,Brad Lambert,C,WPG,31,11,0,2,2
39,8482765,Isak Rosen,R,BUF,21,27,1,0,1
39,8482061,Brandon Biro,L,SEA,26,14,1,0,1
39,8484325,Waltteri Merela,C,TBL,26,16,1,0,1
39,8478021,William Lagesson,D,DET,28,28,1,0,1
39,8481585,Egor Afanasyev,L,SJS,23,19,1,0,1
39,8481699,Aku Raty,R,UTA,23,9,1,0,1
39,8480851,Akil Thomas,C,LAK,24,18,1,0,1
39,8480267,Sammy Walker,C,MIN,25,15,1,0,1
39,8483407,Brandon Scanlin,D,NYR,25,5,1,0,1
39,8480468,James Hamblin,L,EDM,25,9,1,0,1
39,8482162,Roby Jarventie,L,EDM,22,15,1,0,1
39,8477073,Kurtis MacDermid,L,NJD,30,29,1,0,1
39,8481726,Adam Edstrom,C,NYR,24,5,1,0,1
39,8475413,Justin Dowling,C,NJD,34,14,1,0,1
39,8480306,Grant Hutton,D,NYI,29,6,1,0,1
39,8484259,Ondrej Pavel,C,COL,31,1,1,0,1
39,8482201,Gage Goncalves,C,TBL,23,32,0,1,1
39,8481462,Mason Morelli,L,VGK,28,11,0,1,1
39,8477149,Scott Sabourin,R,SJS,32,14,0,1,1
39,8479587,Rhett Gardner,C,PHI,28,18,0,1,1
39,8479419,Brett Murray,L,BUF,26,16,0,1,1
39,8481024,Linus Karlsson,C,VAN,25,8,0,1,1
39,8481237,Kyle MacLean,C,NYI,25,26,0,1,1
39,8482460,Matt Rempe,C,NYR,22,13,0,1,1
39,8478011,Louie Belpedio,D,PHI,28,14,0,1,1
39,8484255,Jason Polin,R,COL,25,9,0,1,1
39,8480032,Shane Bowers,C,NJD,25,10,0,1,1
39,8481206,John Ludvig,D,PIT,24,9,0,1,1
39,8482197,Adam Raska,R,MIN,23,10,0,1,1
39,8480075,Cameron Crotty,D,MIN,25,12,0,1,1
39,8478881,Brett Seney,L,CHI,28,11,0,1,1
39,8482088,Justin Sourdif,R,FLA,22,14,0,1,1
39,8481719,Maxwell Crozier,D,TBL,24,10,0,1,1
39,8483546,Marshall Rifai,D,TOR,26,2,0,1,1
39,8477335,Kyle Burroughs,D,LAK,29,40,0,0,0
39,8478502,Dennis Gilbert,D,BUF,28,21,0,0,0
39,8481564,Ryan Johnson,D,BUF,23,11,0,0,0
39,8482172,Landon Slaggert,L,CHI,22,32,0,0,0
39,8482516,Matthew Kessel,D,STL,24,11,0,0,0
39,8477541,Dakota Mermis,D,TOR,30,11,0,0,0
39,8482102,Vasily Ponomarev,C,PIT,22,13,0,0,0
39,8482787,Nikita Chibrikov,R,WPG,31,5,0,0,0
39,8474062,Riley Nash,C,NYR,35,14,0,0,0
39,8478446,Glenn Gawdin,C,LAK,27,6,0,0,0
39,8479421,Jacob Moverare,D,LAK,26,3,0,0,0
39,8475780,Chris Wagner,R,COL,33,10,0,0,0
39,8481655,Cole Schwindt,R,CGY,23,2,0,0,0
39,8479330,Brandon Gignac,C,MTL,27,4,0,0,0
39,8483432,Luca Del Bel Belluz,C,CBJ,31,2,0,0,0
39,8483401,Marc Johnstone,R,PIT,28,1,0,0,0
39,8484326,Patrik Koch,D,UTA,28,0,0,0,0
39,8478147,Bokondji Imama,L,PIT,28,5,0,0,0
39,8483489,Fraser Minten,C,TOR,31,9,0,0,0
39,8483920,Pierrick Dube,R,WSH,23,2,0,0,0
39,8483531,Brian Halonen,L,NJD,25,2,0,0,0
39,8483567,Georgii Merkulov,C,BOS,24,3,0,0,0
39,8478854,Ryan Shea,D,PIT,27,2,0,0,0
39,8479522,Hardy Haman Aktell,D,WSH,26,1,0,0,0
39,8481534,Raphael Lavoie,C,EDM,24,9,0,0,0
39,8477993,Justin Kirkland,C,CGY,28,6,0,0,0
39,8483609,Adam Klapka,R,CGY,24,3,0,0,0
39,8476323,Max McCormick,L,SEA,32,3,0,0,0
39,8483045,Cameron Butler,R,CBJ,31,0,0,0,0
39,8483398,Declan Carlile,D,TBL,31,5,0,0,0
39,8478956,Samuel Laberge,L,NJD,27,1,0,0,0
39,8480274,Philip Kemp,D,EDM,25,0,0,0,0
39,8484321,Nikolas Matinpalo,D,OTT,26,0,0,0,0
39,8470794,Joe Pavelski,C,,40,0,0,0,0
39,8479321,Lucas Johansen,D,,27,0,0,0,0
39,8477950,Tony DeAngelo,D,,29,0,0,0,0
39,8471218,Blake Wheeler,R,,38,0,0,0,0
39,8475197,Tyson Barrie,D,,33,0,0,0,0
39,8474157,Max Pacioretty,L,,36,0,0,0,0
39,8475744,Evgeny Kuznetsov,C,,32,0,0,0,0
39,8474037,James van Riemsdyk,L,,35,0,0,0,0
39,8476907,Mackenzie MacEachern,L,,30,0,0,0,0
39,8480216,Jacob Peterson,C,,25,0,0,0,0
39,8474602,Justin Schultz,D,,34,0,0,0,0
39,8482222,Alexander Barabanov,L,,30,0,0,0,0
39,8474031,Kevin Shattenkirk,D,,35,0,0,0,0
39,8477330,Dominik Kubalik,L,,29,0,0,0,0
39,8480884,Calen Addison,D,,24,0,0,0,0
39,8475906,John Klingberg,D,,32,0,0,0,0
39,8480008,Adam Ruzicka,C,,25,0,0,0,0
39,8476884,Derrick Pouliot,D,,30,0,0,0,0
39,8476919,Chris Tierney,C,,30,0,0,0,0
39,8479415,Michael McLeod,C,,26,0,0,0,0
39,8474870,Tyler Johnson,C,,34,0,0,0,0
39,8470604,Jeff Carter,C,,39,0,0,0,0
39,8478104,Sammy Blais,L,,28,0,0,0,0
39,8474884,Mike Hoffman,C,,35,0,0,0,0
39,8481591,Sam Poulin,R,,23,0,0,0,0
39,8471274,Alex Goligoski,D,,39,0,0,0,0
39,8476871,Tanner Pearson,L,,32,0,0,0,0
39,8476393,Nick Cousins,C,,31,0,0,0,0
39,8479977,Kailer Yamamoto,R,,26,0,0,0,0
39,8479346,Dillon Dube,C,,26,0,0,0,0
39,8480184,Gustav Lindstrom,D,,26,0,0,0,0
39,8479376,Victor Mete,D,,26,0,0,0,0
39,8473449,Kyle Okposo,R,,36,0,0,0,0
39,8481058,Jesse Ylonen,R,,25,0,0,0,0
39,8475752,Tyler Pitlick,C,,33,0,0,0,0
39,8481239,Samuel Fagemo,L,,24,0,0,0,0
39,8480821,Filip Zadina,R,,25,0,0,0,0
39,8470966,Mark Giordano,D,,41,0,0,0,0
39,8478495,Denis Gurianov,R,,27,0,0,0,0
39,8477464,Nic Petan,C,,29,0,0,0,0
39,8478099,Kevin Labanc,R,,29,0,0,0,0
39,8482241,Radim Zohorna,L,,28,0,0,0,0
39,8474040,Sam Gagner,C,,35,0,0,0,0
39,8479514,Rem Pitlick,C,,27,0,0,0,0
39,8478430,Oliver Kylington,D,,27,0,0,0,0
39,8479533,Joona Koppanen,L,,26,0,0,0,0
39,8479984,Cal Foote,D,,26,0,0,0,0
39,8477126,Jayson Megna,C,,34,0,0,0,0
39,8475164,Jakob Silfverberg,R,,34,0,0,0,0
39,8474009,Nick Bonino,C,,36,0,0,0,0
39,8479458,Nikita Zaitsev,D,,33,0,0,0,0
39,8477944,Jakub Vrana,L,,28,0,0,0,0
39,8471699,Andrew Cogliano,C,,37,0,0,0,0
39,8478067,Oskar Lindblom,L,,28,0,0,0,0
39,8471686,Marc Staal,D,,37,0,0,0,0
39,8470610,Zach Parise,L,,40,0,0,0,0
39,8478904,Steven Lorentz,C,,28,0,0,0,0
39,8473473,Milan Lucic,L,,36,0,0,0,0
39,8480031,Maxime Comtois,L,,25,0,0,0,0
39,8478512,Austin Czarnik,C,,32,0,0,0,0
39,8473504,Cal Clutterbuck,R,,37,0,0,0,0
39,8477454,Adam Erne,L,,29,0,0,0,0
39,8479383,Boris Katchouk,L,,26,0,0,0,0
39,8475825,Jani Hakanpää,D,,32,0,0,0,0
39,8477846,Ryan Carpenter,C,,33,0,0,0,0
39,8477930,Pierre-Edouard Bellemare,L,,39,0,0,0,0
39,8478400,Colin White,C,,27,0,0,0,0
39,8480226,Marián Studenic,R,,26,0,0,0,0
39,8480853,Liam Foudy,C,,24,0,0,0,0
39,8475797,Jarred Tinordi,D,,32,0,0,0,0
39,8479423,Alex Nylander,L,,26,0,0,0,0
39,8474618,Marco Scandella,D,,34,0,0,0,0
39,8478028,Fredrik Olofsson,L,,28,0,0,0,0
39,8474709,Matt Martin,L,,35,0,0,0,0
39,8481070,Hugh McGing,L,,26,0,0,0,0
39,8479546,Oskar Steen,C,,26,0,0,0,0
39,8474145,Robert Bortuzzo,D,,35,0,0,0,0
39,8476915,Jujhar Khaira,L,,30,0,0,0,0
39,8475278,Byron Froese,C,,33,0,0,0,0
39,8481812,Nikolai Knyzhov,D,,27,0,0,0,0
39,8478408,Travis Dermott,D,,28,0,0,0,0
39,8481077,John Leonard,L,,26,0,0,0,0
39,8479547,Matthew Phillips,R,,26,0,0,0,0
39,8480836,Jonathan Gruden,C,,24,0,0,0,0
39,8481690,Tyler Angle,C,,24,0,0,0,0
39,8475766,Austin Watson,L,,32,0,0,0,0
39,8481016,Ruslan Iskhakov,C,,24,0,0,0,0
39,8478078,Rourke Chartier,C,,28,0,0,0,0
39,8480776,Sheldon Rempal,R,,29,0,0,0,0
39,8484314,Jiri Smejkal,L,,28,0,0,0,0
40,8477492,Nathan MacKinnon,C,COL,29,82,46,89,135
40,8478402,Connor McDavid,C,EDM,27,80,34,100,134
40,8476453,Nikita Kucherov,R,TBL,31,82,44,84,128
40,8478483,Mitch Marner,R,TOR,27,77,31,94,125
40,8477939,William Nylander,R,TOR,28,81,54,69,123
40,8481559,Jack Hughes,C,NJD,23,73,49,74,123
40,8478550,Artemi Panarin,L,NYR,33,78,35,87,122
40,8479314,Matthew Tkachuk,L,FLA,27,81,31,84,115
40,8476468,J.T. Miller,C,VAN,31,72,39,72,111
40,8479318,Auston Matthews,C,TOR,27,77,60,48,108
40,8480027,Jason Robertson,L,DAL,25,82,42,63,105
40,8477934,Leon Draisaitl,C,EDM,29,78,42,62,104
40,8478420,Mikko Rantanen,R,COL,28,82,41,63,104
40,8477956,David Pastrnak,R,BOS,28,80,39,65,104
40,8479407,Jesper Bratt,L,NJD,26,78,28,73,101
40,8477942,Kevin Fiala,L,LAK,28,81,35,62,97
40,8480069,Cale Makar,D,COL,26,72,28,66,94
40,8471675,Sidney Crosby,C,PIT,37,72,45,47,92
40,8480012,Elias Pettersson,C,VAN,26,75,39,53,92
40,8476389,Vincent Trocheck,C,NYR,31,75,38,54,92
40,8477493,Aleksander Barkov,C,FLA,29,80,37,55,92
40,8479343,Clayton Keller,R,UTA,26,76,42,49,91
40,8476887,Filip Forsberg,L,NSH,30,75,38,53,91
40,8477933,Sam Reinhart,C,FLA,29,76,42,48,90
40,8478010,Brayden Point,C,TBL,28,81,42,47,89
40,8475166,John Tavares,C,TOR,34,81,38,51,89
40,8482116,Tim Stützle,C,OTT,22,77,32,57,89
40,8479323,Adam Fox,D,NYR,26,79,10,76,86
40,8475786,Zach Hyman,L,EDM,32,79,51,34,85
40,8480801,Brady Tkachuk,L,OTT,25,80,46,38,84
40,8478403,Jack Eichel,C,VGK,28,77,40,44,84
40,8480830,Andrei Svechnikov,R,CAR,24,73,34,50,84
40,8480002,Nico Hischier,C,NJD,25,75,29,55,84
40,8477409,Carter Verhaeghe,C,FLA,29,78,42,41,83
40,8478864,Kirill Kaprizov,L,MIN,27,72,36,46,82
40,8477960,Adrian Kempe,R,LAK,28,81,36,46,82
40,8478398,Kyle Connor,L,WPG,28,74,33,49,82
40,8474600,Roman Josi,D,NSH,34,75,22,60,82
40,8478439,Travis Konecny,R,PHI,27,79,34,47,81
40,8474564,Steven Stamkos,C,NSH,34,75,33,48,81
40,8478445,Mathew Barzal,C,NYI,27,80,24,57,81
40,8476456,Jonathan Huberdeau,C,CGY,31,80,22,59,81
40,8477501,Valeri Nichushkin,R,COL,29,79,40,40,80
40,8477404,Jake Guentzel,C,TBL,30,82,32,48,80
40,8484144,Connor Bedard,C,CHI,19,67,30,50,80
40,8479420,Tage Thompson,C,BUF,27,76,48,31,79
40,8475184,Chris Kreider,L,NYR,33,76,44,35,79
40,8478427,Sebastian Aho,C,CAR,27,75,42,37,79
40,8480800,Quinn Hughes,D,VAN,25,75,12,67,79
40,8482699,Dylan Guenther,R,UTA,21,78,35,43,78
40,8481557,Matt Boldy,L,MIN,23,70,32,46,78
40,8477946,Dylan Larkin,C,DET,28,80,39,38,77
40,8478414,Timo Meier,R,NJD,28,71,41,35,76
40,8477949,Alex Tuch,R,BUF,28,77,27,49,76
40,8482740,Wyatt Johnston,C,DAL,21,80,43,32,75
40,8475167,Victor Hedman,D,TBL,34,82,12,63,75
40,8476459,Mika Zibanejad,C,NYR,31,79,37,37,74
40,8475172,Nazem Kadri,C,CGY,34,79,28,46,74
40,8475754,Brock Nelson,C,NYI,33,75,40,33,73
40,8479542,Brandon Hagel,L,TBL,26,82,29,44,73
40,8477940,Nikolaj Ehlers,L,WPG,28,77,27,46,73
40,8481711,Matias Maccelli,L,UTA,24,77,23,50,73
40,8480036,Miro Heiskanen,D,DAL,25,79,16,57,73
40,8478444,Brock Boeser,R,VAN,27,72,34,38,72
40,8480023,Robert Thomas,C,STL,25,72,31,41,72
40,8480208,Drake Batherson,R,OTT,26,74,24,48,72
40,8474141,Patrick Kane,R,DET,36,81,22,50,72
40,8482684,Luke Hughes,D,NJD,21,70,8,64,72
40,8471214,Alex Ovechkin,L,WSH,39,75,33,38,71
40,8479385,Jordan Kyrou,C,STL,26,75,31,40,71
40,8471685,Anze Kopitar,C,LAK,37,80,25,46,71
40,8475798,Mikael Granlund,C,SJS,32,69,21,50,71
40,8473419,Brad Marchand,L,BOS,36,80,28,42,70
40,8471215,Evgeni Malkin,C,PIT,38,69,23,47,70
40,8478440,Dylan Strome,C,WSH,27,71,28,41,69
40,8475913,Mark Stone,R,VGK,32,80,22,47,69
40,8480839,Rasmus Dahlin,D,BUF,24,72,14,55,69
40,8476881,Tomas Hertl,C,VGK,31,78,34,34,68
40,8478975,Mason Marchment,L,DAL,29,82,21,47,68
40,8477503,Max Domi,C,TOR,29,76,21,47,68
40,8477494,Jonathan Drouin,L,COL,29,81,18,50,68
40,8475158,Ryan O'Reilly,C,NSH,33,75,30,36,66
40,8476448,William Karlsson,C,VGK,31,75,27,39,66
40,8477447,Shea Theodore,D,VGK,29,64,21,45,66
40,8480865,Noah Dobson,D,NYI,24,79,7,59,66
40,8477951,Nick Schmaltz,C,UTA,28,75,26,39,65
40,8476454,Ryan Nugent-Hopkins,C,EDM,31,81,19,46,65
40,8476853,Morgan Rielly,D,TOR,30,74,17,48,65
40,8475692,Mats Zuccarello,R,MIN,37,73,16,49,65
40,8482093,Seth Jarvis,C,CAR,22,73,31,33,64
40,8477416,Oliver Bjorkstrand,R,SEA,29,78,30,34,64
40,8475765,Vladimir Tarasenko,R,DET,33,77,30,34,64
40,8482124,Quinton Byfield,R,LAK,22,78,28,36,64
40,8479337,Alex DeBrincat,R,DET,27,80,28,36,64
40,8479675,Trevor Moore,L,LAK,29,78,26,38,64
40,8482078,Lucas Raymond,L,DET,22,80,25,39,64
40,8480039,Martin Necas,C,CAR,25,72,25,39,64
40,8478047,Michael Bunting,L,PIT,29,75,34,29,63
40,8481540,Cole Caufield,R,MTL,23,76,32,31,63
40,8475810,Bryan Rust,R,PIT,32,78,31,32,63
40,8477500,Bo Horvat,C,NYI,29,81,25,38,63
40,8475168,Matt Duchene,C,DAL,33,79,25,38,63
40,8473994,Jamie Benn,L,DAL,35,82,22,40,62
40,8480018,Nick Suzuki,C,MTL,25,78,21,41,62
40,8478460,Zach Werenski,D,CBJ,27,76,19,43,62
40,8475794,Tyler Seguin,C,DAL,32,82,30,31,61
40,8477504,Josh Morrissey,D,WPG,29,71,18,43,61
40,8471724,Kris Letang,D,PIT,37,81,12,49,61
40,8474578,Erik Karlsson,D,PIT,34,81,11,50,61
40,8478407,Vince Dunn,D,SEA,28,72,15,45,60
40,8479325,Charlie McAvoy,D,BOS,27,76,12,48,60
40,8478449,Roope Hintz,C,DAL,28,82,32,27,59
40,8475170,Brayden Schenn,C,STL,33,78,29,30,59
40,8477955,Jared McCann,L,SEA,28,77,26,33,59
40,8482702,Logan Stankoven,C,DAL,21,81,26,33,59
40,8480028,Morgan Frost,C,PHI,25,78,25,34,59
40,8479999,Casey Mittelstadt,C,COL,26,81,22,37,59
40,8478401,Pavel Zacha,C,BOS,27,79,20,39,59
40,8478873,Troy Terry,R,ANA,27,74,27,31,58
40,8481068,Yegor Sharangovich,C,CGY,26,78,27,31,58
40,8477402,Pavel Buchnevich,L,STL,29,74,24,34,58
40,8480064,Josh Norris,C,OTT,25,77,34,23,57
40,8477476,Artturi Lehkonen,L,COL,29,80,29,28,57
40,8482745,Mason McTavish,C,ANA,21,74,25,32,57
40,8474102,David Perron,L,OTT,36,80,22,35,57
40,8479425,Filip Hronek,D,VAN,27,75,12,45,57
40,8482110,Dawson Mercer,C,NJD,23,76,28,28,56
40,8476346,Johnny Gaudreau,L,CBJ,31,66,12,44,56
40,8476460,Mark Scheifele,C,WPG,31,73,20,35,55
40,8476826,Yanni Gourde,C,SEA,33,73,18,37,55
40,8476462,Dougie Hamilton,D,NJD,31,68,12,43,55
40,8475745,Charlie Coyle,C,BOS,32,76,28,26,54
40,8480015,Owen Tippett,R,PHI,25,72,27,27,54
40,8475784,Jeff Skinner,C,EDM,32,77,26,28,54
40,8476483,Rickard Rakell,R,PIT,31,67,26,28,54
40,8474150,Mikael Backlund,C,CGY,35,78,21,33,54
40,8474679,Gustav Nyquist,C,NSH,35,74,16,38,54
40,8476880,Tom Wilson,R,WSH,30,74,34,19,53
40,8477935,Sam Bennett,C,FLA,28,79,28,25,53
40,8482665,Matty Beniers,C,SEA,22,73,25,28,53
40,8484166,Adam Fantilli,C,CBJ,20,75,25,28,53
40,8481596,Shane Pinto,C,OTT,24,79,25,28,53
40,8482159,Tyson Foerster,R,PHI,22,75,24,29,53
40,8473512,Claude Giroux,R,OTT,36,79,21,32,53
40,8478438,Tommy Novak,C,NSH,27,69,16,37,53
40,8480798,Philipp Kurashev,C,CHI,25,68,15,38,53
40,8480803,Evan Bouchard,D,EDM,25,75,13,40,53
40,8479410,Mikhail Sergachev,D,UTA,26,69,10,43,53
40,8476539,Jonathan Marchessault,R,NSH,34,74,31,21,52
40,8478493,Joel Eriksson Ek,C,MIN,27,67,21,31,52
40,8483808,Andrei Kuzmenko,L,CGY,28,75,20,32,52
40,8476905,Chandler Stephenson,C,SEA,30,72,15,37,52
40,8481542,Moritz Seider,D,DET,23,75,14,38,52
40,8476906,Shayne Gostisbehere,D,CAR,31,78,9,43,52
40,8479525,Ross Colton,C,COL,28,80,28,23,51
40,8481533,Trevor Zegras,C,ANA,23,69,19,32,51
40,8477998,Warren Foegele,L,LAK,28,78,27,23,50
40,8477479,Tyler Bertuzzi,L,CHI,29,65,23,27,50
40,8477964,Ivan Barbashev,C,VGK,29,75,21,29,50
40,8473986,Alex Killorn,L,ANA,35,76,20,30,50
40,8474586,Jordan Eberle,R,SEA,34,75,19,31,50
40,8479345,Jakob Chychrun,D,WSH,26,61,14,36,50
40,8474590,John Carlson,D,WSH,34,65,12,38,50
40,8481581,Thomas Harley,D,DAL,23,75,9,41,50
40,8477496,Elias Lindholm,C,BOS,30,76,27,22,49
40,8478474,Lawson Crouse,L,UTA,27,72,25,24,49
40,8475714,Calle Jarnkrok,C,TOR,33,79,23,26,49
40,8482720,Matthew Knies,L,TOR,22,69,18,31,49
40,8478397,Rasmus Andersson,D,CGY,28,70,15,34,49
40,8475191,Reilly Smith,R,NYR,33,72,14,35,49
40,8478469,Thomas Chabot,D,OTT,27,72,8,41,49
40,8476399,Blake Coleman,C,CGY,33,71,22,26,48
40,8481528,Dylan Cozens,C,BUF,23,72,16,32,48
40,8476869,Brady Skjei,D,NSH,30,76,13,35,48
40,8477986,Brandon Montour,D,SEA,30,75,12,36,48
40,8475151,Kyle Palmieri,C,NYI,33,80,26,21,47
40,8478466,Daniel Sprong,R,VAN,27,70,24,23,47
40,8478366,Frank Vatrano,R,ANA,30,72,23,24,47
40,8482109,Alexis Lafrenière,L,NYR,23,75,21,26,47
40,8477497,Sean Monahan,C,CBJ,30,68,19,28,47
40,8475763,Kevin Hayes,R,PIT,32,68,19,28,47
40,8471698,T.J. Oshie,R,WSH,38,72,18,29,47
40,8476479,Phillip Danault,C,LAK,31,78,15,32,47
40,8477346,MacKenzie Weegar,D,CGY,30,73,13,34,47
40,8478472,Mathieu Joseph,R,STL,27,68,12,35,47
40,8475314,Anders Lee,L,NYI,34,76,31,15,46
40,8475169,Evander Kane,L,EDM,33,75,27,19,46
40,8482175,JJ Peterka,R,BUF,22,72,26,20,46
40,8483431,Logan Cooley,C,UTA,20,74,23,23,46
40,8480893,Kirill Marchenko,R,CBJ,24,67,23,23,46
40,8478856,Conor Garland,R,VAN,28,71,13,33,46
40,8474053,Logan Couture,C,SJS,35,64,13,33,46
40,8475726,Tyler Toffoli,C,SJS,32,67,29,16,45
40,8478519,Anthony Cirelli,C,TBL,27,81,22,23,45
40,8479400,Pierre-Luc Dubois,L,WSH,26,69,19,26,45
40,8484153,Leo Carlsson,C,ANA,20,73,19,26,45
40,8477451,Ryan Hartman,R,MIN,30,73,19,26,45
40,8479339,Patrik Laine,L,CBJ,26,62,18,27,45
40,8478500,Ivan Provorov,D,CBJ,27,79,8,37,45
40,8478038,Devon Toews,D,COL,30,63,6,39,45
40,8478462,Nicolas Roy,C,VGK,27,73,21,23,44
40,8475287,Erik Haula,L,NJD,33,68,19,25,44
40,8476925,Colton Sissons,C,NSH,31,67,15,29,44
40,8477021,Alex Kerfoot,C,UTA,30,72,11,33,44
40,8470613,Brent Burns,D,CAR,39,78,10,34,44
40,8477429,Andrew Copp,C,DET,30,78,10,34,44
40,8476882,Teuvo Teravainen,C,CHI,30,65,10,34,44
40,8477426,Nicholas Paul,L,TBL,29,81,26,17,43
40,8478498,Jake DeBrusk,L,VAN,28,74,24,19,43
40,8482146,Luke Evangelista,R,NSH,22,67,19,24,43
40,8477407,Anthony Duclair,L,NYI,29,78,18,25,43
40,8481703,Valtteri Puustinen,R,PIT,25,63,9,34,43
40,8475799,Nino Niederreiter,R,WPG,32,65,27,15,42
40,8479987,Morgan Geekie,C,BOS,26,78,18,24,42
40,8480014,Gabriel Vilardi,C,WPG,25,70,26,15,41
40,8476392,Adam Lowry,C,WPG,31,65,18,23,41
40,8478458,John (Jack) Roslovic,C,CAR,27,63,16,25,41
40,8476875,Mike Matheson,D,MTL,30,73,13,28,41
40,8476792,Torey Krug,D,STL,33,74,12,29,41
40,8474565,Alex Pietrangelo,D,VGK,34,61,10,31,41
40,8477498,Darnell Nurse,D,EDM,29,71,9,32,41
40,8474716,Jared Spurgeon,D,MIN,35,75,9,32,41
40,8476923,Damon Severson,D,CBJ,30,81,8,33,41
40,8476854,Hampus Lindholm,D,BOS,30,78,5,36,41
40,8476438,Brandon Saad,L,STL,32,73,20,20,40
40,8481560,Arthur Kaliyev,R,LAK,23,79,20,20,40
40,8477456,J.T. Compher,L,DET,29,79,18,22,40
40,8479992,Michael Rasmussen,C,DET,25,78,14,26,40
40,8480188,Fabian Zetterlund,L,SJS,25,68,13,27,40
40,8477953,Kasperi Kapanen,R,STL,28,74,12,28,40
40,8476872,Scott Laughton,C,PHI,30,71,11,29,40
40,8476958,Jaccob Slavin,D,CAR,30,79,10,30,40
40,8475218,Mattias Ekholm,D,EDM,34,77,8,32,40
40,8478055,Gustav Forsling,D,FLA,28,67,7,33,40
40,8475722,Jason Zucker,L,BUF,32,65,23,16,39
40,8479365,Trent Frederic,C,BOS,26,74,18,21,39
40,8482667,William Eklund,L,SJS,22,67,18,21,39
40,8476419,Jean-Gabriel Pageau,C,NYI,32,78,18,21,39
40,8480829,Jesperi Kotkaniemi,C,CAR,24,74,17,22,39
40,8476292,Ondrej Palat,L,NJD,33,73,16,23,39
40,8482113,Anton Lundell,C,FLA,23,80,16,23,39
40,8483515,Juraj Slafkovsky,L,MTL,20,76,15,24,39
40,8477495,Seth Jones,D,CHI,30,73,9,30,39
40,8482671,Owen Power,D,BUF,22,69,9,30,39
40,8481582,Nicholas Robertson,L,TOR,23,64,23,15,38
40,8478115,Pierre Engvall,L,NYI,28,78,14,24,38
40,8482122,Brock Faber,D,MIN,22,80,5,33,38
40,8483505,Matthew Poitras,C,BOS,20,72,5,33,38
40,8476432,Boone Jenner,C,CBJ,31,67,25,12,37
40,8481618,Alex Newhook,C,MTL,23,74,16,21,37
40,8482097,Jack Quinn,R,BUF,23,69,13,24,37
40,8482133,Thomas Bordeleau,C,SJS,22,61,12,25,37
40,8476474,Stefan Noesen,R,NJD,31,65,20,16,36
40,8474149,Evgenii Dadonov,R,DAL,35,79,14,22,36
40,8477947,Sonny Milano,L,WSH,28,68,13,23,36
40,8480797,Joel Farabee,L,PHI,24,72,12,24,36
40,8474563,Drew Doughty,D,LAK,35,77,10,26,36
40,8480434,Sean Durzi,D,UTA,26,69,4,32,36
40,8481186,Logan O'Connor,R,COL,28,77,10,25,35
40,8478396,Noah Hanifin,D,VGK,27,64,9,26,35
40,8481656,Aliaksei Protas,C,WSH,23,68,9,26,35
40,8474715,Cameron Atkinson,R,TBL,35,81,20,14,34
40,8482705,Cole Sillinger,C,CBJ,21,63,18,16,34
40,8473533,Jordan Staal,C,CAR,36,67,16,18,34
40,8477932,Aaron Ekblad,D,FLA,28,73,11,23,34
40,8477444,Andre Burakovsky,L,SEA,29,70,10,24,34
40,8481524,Bowen Byram,D,BUF,23,67,9,25,34
40,8481546,Cam York,D,PHI,23,71,8,26,34
40,8480817,K'Andre Miller,D,NYR,24,70,7,27,34
40,8481014,Alexander Romanov,D,NYI,24,80,5,29,34
40,8482055,Drew O'Connor,L,PIT,26,69,19,14,33
40,8475760,Nick Bjugstad,C,UTA,32,71,16,17,33
40,8474641,Adam Henrique,C,EDM,34,78,15,18,33
40,8479368,Max Jones,L,BOS,26,69,15,18,33
40,8477511,Anthony Mantha,R,CGY,30,77,13,20,33
40,8478042,Viktor Arvidsson,L,EDM,31,69,12,21,33
40,8476458,Ryan Strome,C,ANA,31,73,11,22,33
40,8482092,Ridly Greig,C,OTT,22,79,10,23,33
40,8484145,Zach Benson,L,BUF,19,70,9,24,33
40,8481606,Jordan Spence,D,LAK,23,72,7,26,33
40,8478507,John Marino,D,UTA,27,68,4,29,33
40,8477969,Marcus Pettersson,D,PIT,28,80,4,29,33
40,8477987,Ryan Donato,C,CHI,28,56,21,11,32
40,8475768,Jaden Schwartz,C,SEA,32,58,18,14,32
40,8480185,Eetu Luostarinen,C,FLA,26,76,17,15,32
40,8481604,Pavel Dorofeyev,L,VGK,24,69,14,18,32
40,8479661,Tanner Jeannot,L,LAK,27,78,11,21,32
40,8480835,Jack Drury,C,CAR,24,57,9,23,32
40,8477948,Travis Sanheim,D,PHI,28,71,8,24,32
40,8480043,Timothy Liljegren,D,TOR,25,66,3,29,32
40,8478057,Dakota Joshua,C,VAN,28,65,16,15,31
40,8478046,Danton Heinen,L,VAN,29,69,14,17,31
40,8480802,Ryan McLeod,C,BUF,25,60,14,17,31
40,8481577,Philip Tomasino,C,NSH,23,68,10,21,31
40,8480336,Sean Walker,D,CAR,30,71,9,22,31
40,8476463,Jonas Brodin,D,MIN,31,79,9,22,31
40,8482105,Jake Sanderson,D,OTT,22,68,7,24,31
40,8476917,Adam Pelech,D,NYI,30,77,6,25,31
40,8476931,Jake McCabe,D,TOR,31,69,5,26,31
40,8475200,Dmitry Orlov,D,CAR,33,72,5,26,31
40,8476979,Erik Gustafsson,D,DET,32,74,4,27,31
40,8476891,Matthew Grzelcyk,D,PIT,30,74,4,27,31
40,8477952,Robby Fabbri,C,ANA,28,68,19,11,30
40,8478463,Anthony Beauvillier,L,PIT,27,72,14,16,30
40,8480068,Ryan Poehling,C,PHI,25,71,12,18,30
40,8480078,Filip Chytil,C,NYR,25,70,12,18,30
40,8478413,Jordan Greenway,L,BUF,27,64,9,21,30
40,8482074,Connor Zary,C,CGY,23,66,18,11,29
40,8476981,Josh Anderson,R,MTL,30,68,17,12,29
40,8478109,Victor Olofsson,L,VGK,29,66,14,15,29
40,8478233,Andrew Mangiapane,L,WSH,28,64,13,16,29
40,8480220,Noah Cates,L,PHI,25,70,13,16,29
40,8481554,Kaapo Kakko,R,NYR,23,68,12,17,29
40,8477839,Conor Sheary,L,TBL,32,82,11,18,29
40,8476927,Teddy Blueger,C,VAN,30,66,11,18,29
40,8482149,Cole Perfetti,C,WPG,22,67,9,20,29
40,8479353,Brett Howden,C,VGK,26,63,9,20,29
40,8478970,Jalen Chatfield,D,CAR,28,69,7,22,29
40,8475753,Justin Faulk,D,STL,32,73,6,23,29
40,8473507,Jeff Petry,D,DET,37,79,6,23,29
40,8482111,Justin Barron,D,MTL,23,68,6,23,29
40,8477506,Ryan Pulock,D,NYI,30,76,5,24,29
40,8482712,Oskar Olausson,R,COL,22,77,4,25,29
40,8479371,Dante Fabbro,D,NSH,26,55,4,25,29
40,8482089,Jake Neighbours,L,STL,22,66,18,10,28
40,8476469,Joel Armia,R,MTL,31,69,16,12,28
40,8475793,Ryan Johansen,C,PHI,32,70,15,13,28
40,8479996,Cody Glass,C,NSH,25,57,13,15,28
40,8481481,Blake Lizotte,C,PIT,27,58,11,17,28
40,8478020,Michael Amadio,R,OTT,28,71,11,17,28
40,8477989,Christian Dvorak,C,MTL,28,62,11,17,28
40,8476461,Sean Couturier,C,PHI,32,67,11,17,28
40,8480855,Jack McBain,C,UTA,24,72,11,17,28
40,8479351,Sam Steel,C,DAL,26,78,11,17,28
40,8481523,Kirby Dach,C,MTL,23,66,10,18,28
40,8483490,Pavel Mintyukov,D,ANA,21,71,10,18,28
40,8475149,Marcus Johansson,L,MIN,34,61,9,19,28
40,8482624,Daniil Miromanov,D,CGY,27,67,9,19,28
40,8476892,Colton Parayko,D,STL,31,72,4,24,28
40,8480873,Rasmus Sandin,D,WSH,24,59,1,27,28
40,8477450,Jason Dickinson,C,CHI,29,56,15,12,27
40,8476918,Jimmy Vesey,L,NYR,31,69,15,12,27
40,8480009,Eeli Tolvanen,R,SEA,25,66,12,15,27
40,8473422,Nick Foligno,L,CHI,37,68,12,15,27
40,8484203,Bradly Nadeau,L,CAR,19,59,11,16,27
40,8480849,Barrett Hayton,C,UTA,24,72,11,16,27
40,8475848,Brendan Gallagher,R,MTL,32,67,11,16,27
40,8481580,Connor McMichael,C,WSH,23,59,11,16,27
40,8478542,Evan Rodrigues,C,FLA,31,69,10,17,27
40,8477505,Alexander Wennberg,C,SJS,30,62,10,17,27
40,8476480,Vladislav Namestnikov,C,WPG,32,63,10,17,27
40,8475171,Oliver Ekman-Larsson,D,TOR,33,66,6,21,27
40,8476885,Jacob Trouba,D,NYR,30,76,6,21,27
40,8477488,Brett Pesce,D,NJD,30,72,6,21,27
40,8480891,Michael Kesselring,D,UTA,24,59,5,22,27
40,8474151,Ryan McDonagh,D,TBL,35,78,2,25,27
40,8473563,Nicklas Backstrom,C,WSH,37,57,16,10,26
40,8482475,Yegor Chinakhov,R,CBJ,23,56,13,13,26
40,8477435,Ryan Graves,D,PIT,29,78,10,16,26
40,8479316,Luke Kunin,C,SJS,27,61,10,16,26
40,8479591,Michael Eyssimont,C,TBL,28,81,9,17,26
40,8480871,Adam Boqvist,D,FLA,24,73,5,21,26
40,8479639,Dylan Coghlan,D,WPG,26,66,5,21,26
40,8475764,Cam Fowler,D,ANA,33,75,4,22,26
40,8475181,Nick Leddy,D,STL,33,68,3,23,26
40,8481019,David Gustafsson,C,WPG,24,54,3,23,26
40,8480448,Parker Kelly,L,COL,25,78,17,8,25
40,8481535,Nils Hoglander,L,VAN,24,63,15,10,25
40,8476921,Jordan Martinook,L,CAR,32,63,12,13,25
40,8477425,Miles Wood,L,COL,29,76,11,14,25
40,8481093,Rafael Harvey-Pinard,L,MTL,25,60,11,14,25
40,8482660,Kent Johnson,C,CBJ,22,61,11,14,25
40,8477919,Frederick Gaudreau,C,MIN,31,54,11,14,25
40,8480144,David Kampf,C,TOR,29,76,10,15,25
40,8483524,Shane Wright,C,SEA,20,59,8,17,25
40,8475855,Jesper Fast,R,CAR,33,55,8,17,25
40,8480145,Neal Pionk,D,WPG,29,71,7,18,25
40,8480459,Pius Suter,C,VAN,28,72,7,18,25
40,8479976,Juuso Valimaki,D,UTA,26,63,4,21,25
40,8479398,Samuel Girard,D,COL,26,62,4,21,25
40,8477220,Nate Schmidt,D,FLA,33,67,3,22,25
40,8481624,Ilya Mikheyev,R,CHI,30,63,14,10,24
40,8480995,Pontus Holmberg,R,TOR,25,57,13,11,24
40,8480762,Eric Robinson,L,CAR,29,57,12,12,24
40,8482117,Lukas Reichel,L,CHI,22,54,11,13,24
40,8475193,Tomas Tatar,L,NJD,34,63,11,13,24
40,8479293,Brandon Tanev,L,SEA,33,65,11,13,24
40,8475231,Casey Cizikas,C,NYI,33,70,11,13,24
40,8483457,Lane Hutson,D,MTL,20,68,11,13,24
40,8476889,Radek Faksa,C,STL,30,60,11,13,24
40,8475343,Nic Dowd,C,WSH,34,58,10,14,24
40,8481441,Joe Snively,C,DET,28,64,10,14,24
40,8478891,Mason Appleton,C,WPG,28,69,8,16,24
40,8482067,Connor Mackey,D,NYR,28,61,7,17,24
40,8479619,Michael Carcone,L,UTA,28,57,16,7,23
40,8483493,Frank Nazar,C,CHI,20,58,12,11,23
40,8482157,Will Cuylle,L,NYR,22,58,12,11,23
40,8474189,Lars Eller,C,PIT,35,56,11,12,23
40,8479393,Noah Gregor,L,OTT,26,70,11,12,23
40,8480813,Joe Veleno,C,DET,24,78,10,13,23
40,8480748,Kiefer Sherwood,L,VAN,29,65,10,13,23
40,8483491,Ivan Miroshnichenko,L,WSH,20,57,10,13,23
40,8476374,Sean Kuraly,C,CBJ,31,61,7,16,23
40,8474574,Tyler Myers,D,VAN,34,71,6,17,23
40,8480246,Nick Perbix,D,TBL,26,74,4,19,23
40,8479982,Conor Timmins,D,TOR,26,56,3,20,23
40,8474673,TJ Brodie,D,CHI,34,60,1,22,23
40,8476429,Scott Mayfield,D,NYI,32,78,1,22,23
40,8477478,William Carrier,L,CAR,30,55,12,10,22
40,8476878,Zemgus Girgensons,C,TBL,30,73,11,11,22
40,8483499,Liam Ohgren,L,MIN,20,62,9,13,22
40,8481013,Jonatan Berggren,R,DET,24,59,7,15,22
40,8482245,Artem Zub,D,OTT,29,72,5,17,22
40,8476422,Mike Reilly,D,NYI,31,76,5,17,22
40,8476902,Esa Lindell,D,DAL,30,78,2,20,22
40,8475233,David Savard,D,MTL,34,66,2,20,22
40,8479941,Justin Danforth,R,CBJ,31,50,14,7,21
40,8479390,Taylor Raddysh,R,WSH,26,68,12,9,21
40,8478043,Sam Lafferty,C,BUF,29,66,11,10,21
40,8479066,Ryan Lomberg,L,CGY,30,66,11,10,21
40,8480113,Alex Iafallo,L,WPG,31,66,10,11,21
40,8476329,Travis Boyd,C,MIN,31,62,10,11,21
40,8480980,Connor Dewar,C,TOR,25,62,10,11,21
40,8475791,Taylor Hall,L,CHI,33,59,9,12,21
40,8479344,Jesse Puljujarvi,R,PIT,26,48,9,12,21
40,8477979,Nicolas Aube-Kubel,R,BUF,28,59,8,13,21
40,8477406,Mattias Janmark,C,EDM,32,67,7,14,21
40,8480222,Sebastian Aho,D,PIT,28,70,6,15,21
40,8483468,Jiri Kulich,C,BUF,20,55,4,17,21
40,8480172,Jan Rutta,D,SJS,34,65,3,18,21
40,8480878,Nils Lundkvist,D,DAL,24,71,1,20,21
40,8482125,Alexander Holtz,R,VGK,22,68,12,8,20
40,8482079,Marco Rossi,C,MIN,23,51,12,8,20
40,8477353,Tyler Motte,C,DET,29,75,11,9,20
40,8481601,Simon Holmstrom,R,NYI,23,72,11,9,20
40,8478013,Jake Walman,D,SJS,28,71,10,10,20
40,8481641,Joel Kiviranta,L,COL,28,78,10,10,20
40,8479348,Kale Clague,D,BUF,26,49,9,11,20
40,8476960,Andreas Athanasiou,C,CHI,30,52,8,12,20
40,8484149,Gavin Brindley,C,CBJ,20,51,8,12,20
40,8481553,Bobby Brink,R,PHI,23,59,7,13,20
40,8478882,Vladislav Gavrikov,D,LAK,29,68,7,13,20
40,8480727,Zach Whitecloud,D,VGK,28,53,7,13,20
40,8479026,Philippe Myers,D,TOR,27,53,6,14,20
40,8481522,Peyton Krebs,C,BUF,23,59,5,15,20
40,8479324,Ryan Lindgren,D,NYR,26,64,4,16,20
40,8478136,Jake Middleton,D,MIN,28,71,4,16,20
40,8479402,Jake Bean,D,CGY,26,66,4,16,20
40,8476467,Jamie Oleksiak,D,SEA,32,66,3,17,20
40,8476457,Adam Larsson,D,SEA,32,67,2,18,20
40,8482087,Kaiden Guhle,D,MTL,22,63,1,19,20
40,8478911,Matt Roy,D,WSH,29,55,1,19,20
40,8480289,Morgan Barron,C,WPG,26,50,13,6,19
40,8475842,Sam Carrick,C,NYR,32,54,12,7,19
40,8470621,Corey Perry,R,EDM,39,67,11,8,19
40,8477446,Michael McCarron,R,NSH,29,53,10,9,19
40,8478831,Kevin Stenlund,C,UTA,28,53,10,9,19
40,8477508,Curtis Lazar,C,NJD,29,64,9,10,19
40,8476822,Luke Glendening,C,TBL,35,79,9,10,19
40,8476278,Colin Blackwell,C,DAL,31,79,8,11,19
40,8478432,Christian Fischer,R,DET,27,75,8,11,19
40,8480789,Oliver Wahlstrom,R,NYI,24,70,8,11,19
40,8482142,Jamie Drysdale,D,PHI,22,59,7,12,19
40,8479442,Troy Stecher,D,EDM,30,49,7,12,19
40,8478133,Jake Evans,C,MTL,28,65,5,14,19
40,8477903,Garnet Hathaway,R,PHI,33,68,5,14,19
40,8476331,Dylan DeMelo,D,WPG,31,68,4,15,19
40,8476988,Matt Benning,D,SJS,30,66,4,15,19
40,8481521,Ronnie Attard,D,PHI,25,60,4,15,19
40,8474034,Patrick Maroon,L,CHI,36,51,4,15,19
40,8479369,Andrew Peeke,D,BOS,26,66,4,15,19
40,8475690,Chris Tanev,D,TOR,35,59,3,16,19
40,8480049,Dylan Samberg,D,WPG,25,67,2,17,19
40,8481477,Nico Sturm,C,SJS,29,56,12,6,18
40,8478569,Noel Acciari,C,PIT,33,59,11,7,18
40,8481032,Paul Cotter,C,NJD,25,56,10,8,18
40,8475220,Marcus Foligno,L,MIN,33,61,9,9,18
40,8481704,Juuso Parssinen,C,NSH,23,58,8,10,18
40,8479336,Carl Grundstrom,R,SJS,27,55,8,10,18
40,8476897,Oskar Sundqvist,C,STL,30,72,6,12,18
40,8476967,Brett Kulak,D,EDM,30,63,6,12,18
40,8475179,Dmitry Kulikov,D,FLA,34,63,5,13,18
40,8481568,Alex Vlasic,D,CHI,23,58,5,13,18
40,8482655,Janis Moser,D,TBL,24,76,3,15,18
40,8480806,Isac Lundestrom,C,ANA,25,59,3,15,18
40,8476879,Cody Ceci,D,EDM,31,71,3,15,18
40,8475324,Nick Jensen,D,OTT,34,66,1,17,18
40,8480003,Jesper Boqvist,C,FLA,26,68,10,7,17
40,8482659,Josh Doan,R,UTA,22,56,9,8,17
40,8483495,Simon Nemec,D,NJD,20,57,7,10,17
40,8482859,Zack Ostapchuk,C,OTT,21,56,7,10,17
40,8475279,Ben Chiarot,D,DET,33,65,5,12,17
40,8483445,Cutter Gauthier,L,ANA,20,61,3,14,17
40,8477845,Trevor van Riemsdyk,D,WSH,33,58,3,14,17
40,8477369,Carson Soucy,D,VAN,30,65,3,14,17
40,8470600,Ryan Suter,D,STL,39,60,3,14,17
40,8481527,Kaedan Korczak,D,VGK,23,48,2,15,17
40,8481178,Egor Zamula,D,PHI,24,56,1,16,17
40,8482744,James Malatesta,L,CBJ,21,55,9,7,16
40,8478434,Keegan Kolesar,R,VGK,27,73,8,8,16
40,8476858,Phillip Di Giuseppe,L,VAN,31,41,8,8,16
40,8480011,Klim Kostin,C,SJS,25,46,8,8,16
40,8482101,Danil Gushchin,L,SJS,22,52,7,9,16
40,8482192,Isaak Phillips,D,CHI,23,49,7,9,16
40,8480441,Trey Fix-Wolansky,R,CBJ,25,45,7,9,16
40,8477931,Tomas Nosek,L,FLA,32,57,7,9,16
40,8480157,Calle Rosen,D,COL,30,55,7,9,16
40,8473453,Trevor Lewis,C,LAK,37,75,6,10,16
40,8482749,Joshua Roy,R,MTL,21,63,6,10,16
40,8475225,Craig Smith,C,CHI,35,51,5,11,16
40,8475208,Brian Dumoulin,D,ANA,33,61,5,11,16
40,8475462,Radko Gudas,D,ANA,34,61,3,13,16
40,8476856,Mathew Dumba,D,DAL,30,73,3,13,16
40,8480001,Urho Vaakanainen,D,ANA,25,53,1,15,16
40,8476873,Mark Jankowski,C,NSH,30,50,10,5,15
40,8479328,Julien Gauthier,R,NYI,27,64,9,6,15
40,8478508,Yakov Trenin,C,MIN,27,60,8,7,15
40,8480205,Emil Bemstrom,C,PIT,25,60,8,7,15
40,8481518,Nolan Foote,L,NJD,24,35,8,7,15
40,8481028,Martin Pospisil,C,CGY,25,51,7,8,15
40,8477392,Hudson Fasching,R,NYI,29,61,6,9,15
40,8478585,Derek Ryan,C,EDM,38,54,6,9,15
40,8481161,Jake Christiansen,D,CBJ,25,54,6,9,15
40,8481754,Nikita Nesterenko,C,ANA,23,34,6,9,15
40,8479291,Kevin Rooney,C,CGY,31,47,6,9,15
40,8477015,Connor Brown,R,EDM,30,63,5,10,15
40,8480192,Johnathan Kovacevic,D,NJD,27,60,5,10,15
40,8481567,Henry Thrun,D,SJS,23,52,5,10,15
40,8479980,Nicolas Hague,D,VGK,26,50,4,11,15
40,8479370,Tyson Jost,C,CAR,26,50,4,11,15
40,8479359,Beck Malenstyn,L,BUF,26,49,4,11,15
40,8480007,Jonas Rondbjerg,R,VGK,25,39,4,11,15
40,8480845,Rasmus Kupari,C,WPG,24,38,4,11,15
40,8477507,Nikita Zadorov,D,BOS,29,71,3,12,15
40,8482730,Brandt Clarke,D,LAK,21,48,3,12,15
40,8480073,Erik Brannstrom,D,COL,25,62,3,12,15
40,8483482,Tristan Luneau,D,ANA,20,64,3,12,15
40,8482095,Tyler Kleven,D,OTT,22,49,3,12,15
40,8478399,Jonas Siegenthaler,D,NJD,27,55,2,13,15
40,8475790,Erik Gudbranson,D,CBJ,32,80,1,14,15
40,8481059,Scott Perunovich,D,STL,26,54,0,15,15
40,8471817,Ryan Reaves,R,TOR,37,67,9,5,14
40,8482737,Zack Bolduc,C,STL,21,52,8,6,14
40,8482259,Bobby McMann,C,TOR,28,60,7,7,14
40,8482809,Jackson Blake,R,CAR,21,58,6,8,14
40,8476525,Colin Miller,D,WPG,32,68,6,8,14
40,8482807,Ethan Del Mastro,D,CHI,21,57,5,9,14
40,8480021,Jack Studnicka,C,LAK,25,70,5,9,14
40,8478859,Niko Mikkola,D,FLA,28,60,5,9,14
40,8476442,Matt Nieto,L,PIT,32,47,4,10,14
40,8482679,Matt Coronato,R,CGY,22,69,4,10,14
40,8479520,Brandon Duhaime,R,WSH,27,47,4,10,14
40,8482634,Alex Steeves,C,TOR,25,47,3,11,14
40,8479944,Zach Aston-Reese,C,VGK,30,50,3,11,14
40,8482073,Braden Schneider,D,NYR,23,67,2,12,14
40,8478421,A.J. Greer,L,FLA,28,58,2,12,14
40,8475188,Brayden McNabb,D,VGK,33,56,2,12,14
40,8478416,Erik Cernak,D,TBL,27,73,1,13,14
40,8478840,Will Borgen,D,SEA,28,66,1,13,14
40,8479983,Mario Ferraro,D,SJS,26,70,0,14,14
40,8480355,Mark Kastelic,C,BOS,25,46,8,5,13
40,8481716,Dmitri Voronkov,L,CBJ,24,42,7,6,13
40,8479439,Jacob MacDonald,D,COL,31,50,7,6,13
40,8480848,Ty Dellandrea,C,SJS,24,51,7,6,13
40,8482166,Shakir Mukhamadullin,D,SJS,22,55,7,6,13
40,8480074,Alexandre Texier,C,STL,25,54,6,7,13
40,8480035,Henri Jokiharju,D,BUF,25,51,4,9,13
40,8478178,Darren Raddysh,D,TBL,28,70,4,9,13
40,8475750,Jon Merrill,D,MIN,32,60,4,9,13
40,8482451,Mikael Pyyhtia,L,CBJ,23,46,3,10,13
40,8480860,Kevin Bahl,D,CGY,24,62,2,11,13
40,8482176,Wyatt Kaiser,D,CHI,22,50,2,11,13
40,8477365,Connor Clifton,D,BUF,29,61,2,11,13
40,8478851,Alexandre Carrier,D,NSH,28,67,1,12,13
40,8477499,Rasmus Ristolainen,D,PHI,30,60,1,12,13
40,8478452,Caleb Jones,D,LAK,27,55,1,12,13
40,8480281,Alexey Toropchenko,R,STL,25,56,9,3,12
40,8482155,Alex Laferriere,R,LAK,23,58,8,4,12
40,8482062,Cole Smith,L,NSH,29,53,7,5,12
40,8481617,Vasily Podkolzin,R,VAN,23,51,5,7,12
40,8480025,MacKenzie Entwistle,R,FLA,25,59,5,7,12
40,8479372,Joshua Mahura,D,SEA,26,55,5,7,12
40,8482148,Hendrix Lapierre,C,WSH,22,54,4,8,12
40,8477034,Jaycob Megna,D,FLA,32,46,4,8,12
40,8479315,Joey Anderson,R,CHI,26,51,3,9,12
40,8476874,Olli Maatta,D,DET,30,61,3,9,12
40,8478451,Ethan Bear,D,WSH,27,63,3,9,12
40,8479543,Michael Pezzetta,L,MTL,26,57,2,10,12
40,8483565,Nick Blankenburg,D,NSH,26,57,2,10,12
40,8474013,Ian Cole,D,UTA,35,51,1,11,12
40,8476934,Brock McGinn,L,ANA,30,49,8,3,11
40,8481789,Tye Kartye,L,SEA,23,40,8,3,11
40,8479414,Nathan Bastian,R,NJD,27,55,7,4,11
40,8481517,Brett Leason,R,ANA,25,56,7,4,11
40,8479718,Alex Barré-Boulet,C,MTL,27,46,6,5,11
40,8478211,Dryden Hunt,L,CGY,29,55,6,5,11
40,8479968,Vinni Lettieri,C,BOS,29,53,6,5,11
40,8478468,Jeremy Lauzon,D,NSH,27,58,5,6,11
40,8482747,Brennan Othmann,L,NYR,21,46,5,6,11
40,8480990,Declan Chisholm,D,MIN,24,42,4,7,11
40,8477244,Chad Ruhwedel,D,NYR,34,29,4,7,11
40,8479671,Mathieu Olivier,R,CBJ,27,44,3,8,11
40,8481532,Alex Turcotte,C,LAK,23,44,2,9,11
40,8483460,David Jiricek,D,CBJ,21,62,1,10,11
40,8481599,Victor Soderstrom,D,UTA,23,47,1,10,11
40,8480807,Mattias Samuelsson,D,BUF,24,53,0,11,11
40,8482077,Dylan Holloway,L,EDM,23,54,6,4,10
40,8477482,Zachary Sanford,L,CHI,30,32,5,5,10
40,8479379,Givani Smith,R,SJS,26,36,5,5,10
40,8479378,Logan Stanley,D,WPG,26,45,4,6,10
40,8480070,Ian Mitchell,D,BOS,25,42,4,6,10
40,8482666,Scott Morrow,D,CAR,22,45,4,6,10
40,8471709,Marc-Edouard Vlasic,D,SJS,37,61,3,7,10
40,8482511,Mason Lohrei,D,BOS,23,31,2,8,10
40,8476624,Barclay Goodrow,C,SJS,31,48,2,8,10
40,8479986,Kole Lind,R,DAL,26,52,1,9,10
40,8481537,Nikita Okhotiuk,D,CGY,24,48,1,9,10
40,8482803,Olen Zellweger,D,ANA,21,68,4,5,9
40,8482964,Arber Xhekaj,D,MTL,23,44,4,5,9
40,8477380,Jonny Brodzinski,C,NYR,31,52,4,5,9
40,8480058,Pierre-Olivier Joseph,D,STL,25,54,4,5,9
40,8476994,Vinnie Hinostroza,C,NSH,30,45,3,6,9
40,8478424,Jansen Harkins,C,ANA,27,47,3,6,9
40,8473446,Erik Johnson,D,PHI,36,46,3,6,9
40,8481122,Simon Benoit,D,TOR,26,36,3,6,9
40,8482858,Ryker Evans,D,SEA,23,28,3,6,9
40,8477018,Ben Hutton,D,VGK,31,53,2,7,9
40,8481708,Zac Jones,D,NYR,24,41,2,7,9
40,8481550,Adam Beckman,L,NJD,23,43,2,7,9
40,8480196,Jacob Bryson,D,BUF,27,39,2,7,9
40,8481609,Vladislav Kolyachonok,D,UTA,23,33,2,7,9
40,8477938,Haydn Fleury,D,WPG,28,36,2,7,9
40,8478443,Brandon Carlo,D,BOS,28,60,1,8,9
40,8476312,Josh Manson,D,COL,33,63,1,8,9
40,8475718,Justin Holl,D,DET,32,59,1,8,9
40,8475455,Brenden Dillon,D,NJD,34,59,1,8,9
40,8474166,Alec Martinez,D,CHI,37,42,1,8,9
40,8480879,Jacob Bernard-Docker,D,OTT,24,43,0,9,9
40,8471677,Jack Johnson,D,CBJ,37,60,0,9,9
40,8483570,Ben Meyers,C,SEA,26,30,6,2,8
40,8475235,Nicolas Deslauriers,L,PHI,33,54,5,3,8
40,8479998,Mikey Anderson,D,LAK,25,59,4,4,8
40,8481751,Lukas Rousek,R,BUF,25,31,4,4,8
40,8474090,Brendan Smith,D,DAL,35,49,3,5,8
40,8481598,Philip Broberg,D,EDM,23,45,3,5,8
40,8482751,Ryan Winterton,C,SEA,21,44,3,5,8
40,8479985,Cale Fleury,D,SEA,26,28,3,5,8
40,8478017,Mark Friedman,D,VAN,29,40,2,6,8
40,8482784,Zach Dean,C,STL,21,41,2,6,8
40,8480887,Jordan Harris,D,MTL,24,55,1,7,8
40,8479536,Axel Jonsson-Fjallby,L,WPG,26,44,1,7,8
40,8482861,Vincent Iorio,D,WSH,22,35,1,7,8
40,8474567,Zach Bogosian,D,MIN,34,59,1,7,8
40,8476372,Nick Seeler,D,PHI,31,45,1,7,8
40,8477384,Joshua Brown,D,EDM,30,40,1,7,8
40,8478874,Adam Gaudette,R,OTT,28,30,1,7,8
40,8474612,Travis Hamonic,D,OTT,34,49,0,8,8
40,8480245,Olle Lycksell,R,PHI,25,30,5,2,7
40,8481600,Tobias Bjornfot,D,FLA,23,36,4,3,7
40,8480252,Cole Guttman,C,CHI,25,36,3,4,7
40,8477573,Nathan Walker,L,STL,30,51,3,4,7
40,8481167,Brayden Pachal,D,CGY,25,43,3,4,7
40,8482762,Simon Edvinsson,D,DET,21,57,3,4,7
40,8479994,Jaret Anderson-Dolan,C,WPG,25,32,3,4,7
40,8479981,Jonah Gadjovich,L,FLA,26,40,3,4,7
40,8477851,Jordan Oesterle,D,BOS,32,38,3,4,7
40,8476913,Devin Shore,C,MIN,30,38,3,4,7
40,8477070,Liam O'Brien,C,UTA,30,54,2,5,7
40,8481701,Santeri Hatakka,D,NJD,23,38,2,5,7
40,8479772,Zack MacEwen,R,OTT,28,47,2,5,7
40,8481147,Reese Johnson,C,MIN,26,35,2,5,7
40,8483549,Lucas Condotta,L,MTL,27,34,2,5,7
40,8480796,Martin Fehervary,D,WSH,25,57,2,5,7
40,8481592,Jakob Pelletier,L,CGY,23,34,2,5,7
40,8480844,Grigori Denisenko,L,VGK,24,29,2,5,7
40,8482733,Logan Mailloux,D,MTL,31,31,2,5,7
40,8477073,Kurtis MacDermid,L,NJD,30,35,2,5,7
40,8483466,Kevin Korchinski,D,CHI,20,50,1,6,7
40,8477335,Kyle Burroughs,D,LAK,29,41,1,6,7
40,8481056,Spencer Stastney,D,NSH,24,31,0,7,7
40,8480950,Ilya Lyubushkin,D,DAL,30,56,0,7,7
40,8475762,Derek Forbort,D,VAN,32,47,0,7,7
40,8476441,Joel Edmundson,D,LAK,31,37,0,7,7
40,8482070,Mitchell Chaffee,R,TBL,26,55,4,2,6
40,8479638,Justin Brazeau,R,BOS,26,33,4,2,6
40,8476867,Brendan Gaunce,C,MIN,30,32,3,3,6
40,8479249,Andrew Poturalski,C,SJS,30,29,2,4,6
40,8478454,Noah Juulsen,D,VAN,27,39,2,4,6
40,8477887,Patrick Brown,C,BOS,32,52,2,4,6
40,8482765,Isak Rosen,R,BUF,21,21,2,4,6
40,8480468,James Hamblin,L,EDM,25,22,2,4,6
40,8477962,Brendan Lemieux,L,CAR,28,33,1,5,6
40,8480292,Carson Meyer,R,ANA,27,33,1,5,6
40,8478450,Parker Wotherspoon,D,BOS,27,30,1,5,6
40,8477810,Joel Hanley,D,CGY,33,22,0,6,6
40,8482177,Marat Khusnutdinov,C,MIN,22,38,4,1,5
40,8482165,Yan Kuznetsov,D,CGY,22,21,4,1,5
40,8477401,John Hayden,C,SEA,29,33,3,2,5
40,8479320,Maxime Lajoie,D,SEA,27,22,3,2,5
40,8481556,John Beecher,C,BOS,23,28,3,2,5
40,8476952,Dominic Toninato,C,WPG,30,30,2,3,5
40,8483619,Filip Roos,D,OTT,25,35,2,3,5
40,8480880,Jakub Lauko,C,MIN,24,31,2,3,5
40,8484911,Collin Graf,R,SJS,22,35,2,3,5
40,8483763,Maksymilian Szuber,D,UTA,22,31,2,3,5
40,8482153,Brendan Brisson,C,VGK,23,31,1,4,5
40,8480834,Ty Emberson,D,SJS,24,27,1,4,5
40,8483512,Matthew Savoie,C,EDM,20,19,1,4,5
40,8475177,Calvin de Haan,D,COL,33,47,1,4,5
40,8479576,Vincent Desharnais,D,VAN,28,24,0,5,5
40,8474568,Luke Schenn,D,NSH,35,55,0,5,5
40,8482652,Walker Duehr,R,CGY,27,45,4,0,4
40,8483630,Pavol Regenda,L,ANA,25,27,3,1,4
40,8484254,Akito Hirose,D,VAN,25,37,2,2,4
40,8483397,Marc McLaughlin,C,BOS,25,32,2,2,4
40,8478477,Mitchell Stephens,C,SEA,27,17,2,2,4
40,8479991,Jake Leschyshyn,C,NYR,25,28,2,2,4
40,8481679,Maxence Guenette,D,OTT,23,36,2,2,4
40,8481237,Kyle MacLean,C,NYI,25,21,2,2,4
40,8482470,Ilya Solovyov,D,CGY,24,20,1,3,4
40,8480084,Nick DeSimone,D,NJD,30,13,1,3,4
40,8475958,Michael Sgarbossa,C,WSH,32,18,0,4,4
40,8478409,Anthony Richard,C,PHI,28,30,3,0,3
40,8483012,Logan Morrison,C,SEA,22,39,3,0,3
40,8477320,Anton Blidh,L,NYR,29,17,3,0,3
40,8481043,Cole Koepke,L,BOS,26,23,2,1,3
40,8482929,Emil Lilleberg,D,TBL,23,12,2,1,3
40,8480890,Jan Jenik,C,OTT,24,28,2,1,3
40,8478011,Louie Belpedio,D,PHI,28,14,2,1,3
40,8476473,Connor Murphy,D,CHI,31,39,1,2,3
40,8482713,Mackie Samoskevich,R,FLA,22,38,1,2,3
40,8477467,Gustav Olofsson,D,SEA,30,13,1,2,3
40,8482141,Lukas Cormier,D,VGK,22,23,1,2,3
40,8475755,Alexander Petrovic,D,DAL,32,11,1,2,3
40,8482061,Brandon Biro,L,SEA,26,13,1,2,3
40,8480851,Akil Thomas,C,LAK,24,15,1,2,3
40,8481564,Ryan Johnson,D,BUF,23,13,1,2,3
40,8482516,Matthew Kessel,D,STL,24,17,1,2,3
40,8479972,Mason Shaw,C,WPG,26,36,0,3,3
40,8482496,Nils Aman,C,VAN,24,37,0,3,3
40,8478146,Matthew Highmore,C,OTT,28,39,0,3,3
40,8477527,Ross Johnston,L,ANA,30,19,0,3,3
40,8484258,Sam Malinski,D,COL,26,18,0,3,3
40,8481585,Egor Afanasyev,L,SJS,23,20,0,3,3
40,8481030,Jack St. Ivany,D,PIT,25,18,2,0,2
40,8480032,Shane Bowers,C,NJD,25,16,2,0,2
40,8483609,Adam Klapka,R,CGY,24,3,2,0,2
40,8481605,Jackson LaCombe,D,ANA,23,39,1,1,2
40,8482147,Jean-Luc Foudy,C,COL,22,23,1,1,2
40,8480870,Bo Groulx,C,NYR,24,29,1,1,2
40,8481422,Jake Lucchini,C,NSH,29,24,1,1,2
40,8483395,Arshdeep Bains,L,VAN,23,13,1,1,2
40,8477473,Justin Bailey,R,SJS,29,23,1,1,2
40,8481541,Samuel Bolduc,D,NYI,24,21,1,1,2
40,8477971,Andreas Englund,D,LAK,28,25,1,1,2
40,8480267,Sammy Walker,C,MIN,25,20,1,1,2
40,8479587,Rhett Gardner,C,PHI,28,18,1,1,2
40,8481024,Linus Karlsson,C,VAN,25,8,1,1,2
40,8478881,Brett Seney,L,CHI,28,15,1,1,2
40,8482088,Justin Sourdif,R,FLA,22,18,1,1,2
40,8483567,Georgii Merkulov,C,BOS,24,16,1,1,2
40,8479522,Hardy Haman Aktell,D,WSH,26,5,1,1,2
40,8481593,Jayden Struble,D,MTL,23,24,0,2,2
40,8479367,William Lockwood,R,FLA,26,27,0,2,2
40,8481806,Louis Crevier,D,CHI,23,14,0,2,2
40,8481743,Marc Del Gaizo,D,NSH,25,18,0,2,2
40,8480823,Alexander Alexeyev,D,WSH,25,14,0,2,2
40,8482476,Emil Heineman,L,MTL,23,12,0,2,2
40,8482144,Jack Thompson,D,SJS,22,25,0,2,2
40,8477462,Robert Hagg,D,VGK,29,20,0,2,2
40,8475413,Justin Dowling,C,NJD,34,9,0,2,2
40,8479419,Brett Murray,L,BUF,26,19,0,2,2
40,8478502,Dennis Gilbert,D,BUF,28,18,0,2,2
40,8482102,Vasily Ponomarev,C,PIT,22,15,0,2,2
40,8483432,Luca Del Bel Belluz,C,CBJ,31,4,0,2,2
40,8481065,Angus Crookshank,L,OTT,25,18,1,0,1
40,8481462,Mason Morelli,L,VGK,28,9,1,0,1
40,8484255,Jason Polin,R,COL,25,4,1,0,1
40,8482172,Landon Slaggert,L,CHI,22,17,1,0,1
40,8477541,Dakota Mermis,D,TOR,30,10,1,0,1
40,8474062,Riley Nash,C,NYR,35,16,1,0,1
40,8483398,Declan Carlile,D,TBL,31,11,1,0,1
40,8482145,Mavrik Bourque,C,DAL,22,46,0,1,1
40,8484287,Cole McWard,D,VAN,23,19,0,1,1
40,8475795,Dylan McIlrath,D,WSH,32,20,0,1,1
40,8482094,Daemon Hunt,D,MIN,22,16,0,1,1
40,8482118,Sam Colangelo,R,ANA,23,20,0,1,1
40,8482250,Callahan Burke,C,VGK,27,29,0,1,1
40,8478051,Max Willman,C,NJD,29,23,0,1,1
40,8480874,Adam Ginning,D,PHI,24,9,0,1,1
40,8483471,Brad Lambert,C,WPG,31,10,0,1,1
40,8478021,William Lagesson,D,DET,28,22,0,1,1
40,8482162,Roby Jarventie,L,EDM,22,20,0,1,1
40,8482201,Gage Goncalves,C,TBL,23,18,0,1,1
40,8477149,Scott Sabourin,R,SJS,32,14,0,1,1
40,8481206,John Ludvig,D,PIT,24,7,0,1,1
40,8480075,Cameron Crotty,D,MIN,25,10,0,1,1
40,8481719,Maxwell Crozier,D,TBL,24,16,0,1,1
40,8483489,Fraser Minten,C,TOR,31,11,0,1,1
40,8478854,Ryan Shea,D,PIT,27,3,0,1,1
40,8481543,Nikita Alexandrov,C,STL,24,18,0,0,0
40,8481578,Graeme Clarke,R,MIN,23,11,0,0,0
40,8479362,Riley Tufte,L,BOS,26,17,0,0,0
40,8483597,Milos Kelemen,L,UTA,25,10,0,0,0
40,8481006,Tyler Tucker,D,STL,24,20,0,0,0
40,8484304,Uvis Balinskis,D,FLA,28,7,0,0,0
40,8482126,Emil Andrae,D,PHI,31,1,0,0,0
40,8484325,Waltteri Merela,C,TBL,26,26,0,0,0
40,8481699,Aku Raty,R,UTA,23,15,0,0,0
40,8483407,Brandon Scanlin,D,NYR,25,5,0,0,0
40,8481726,Adam Edstrom,C,NYR,24,8,0,0,0
40,8480306,Grant Hutton,D,NYI,29,5,0,0,0
40,8484259,Ondrej Pavel,C,COL,31,0,0,0,0
40,8482460,Matt Rempe,C,NYR,22,14,0,0,0
40,8482197,Adam Raska,R,MIN,23,13,0,0,0
40,8483546,Marshall Rifai,D,TOR,26,3,0,0,0
40,8482787,Nikita Chibrikov,R,WPG,31,1,0,0,0
40,8478446,Glenn Gawdin,C,LAK,27,11,0,0,0
40,8479421,Jacob Moverare,D,LAK,26,10,0,0,0
40,8475780,Chris Wagner,R,COL,33,6,0,0,0
40,8481655,Cole Schwindt,R,CGY,23,7,0,0,0
40,8479330,Brandon Gignac,C,MTL,27,11,0,0,0
40,8483401,Marc Johnstone,R,PIT,28,1,0,0,0
40,8484326,Patrik Koch,D,UTA,28,2,0,0,0
40,8478147,Bokondji Imama,L,PIT,28,7,0,0,0
40,8483920,Pierrick Dube,R,WSH,23,5,0,0,0
40,8483531,Brian Halonen,L,NJD,25,6,0,0,0
40,8481534,Raphael Lavoie,C,EDM,24,1,0,0,0
40,8477993,Justin Kirkland,C,CGY,28,3,0,0,0
40,8476323,Max McCormick,L,SEA,32,2,0,0,0
40,8483045,Cameron Butler,R,CBJ,31,1,0,0,0
40,8478956,Samuel Laberge,L,NJD,27,0,0,0,0
40,8480274,Philip Kemp,D,EDM,25,1,0,0,0
40,8484321,Nikolas Matinpalo,D,OTT,26,2,0,0,0
40,8470794,Joe Pavelski,C,,40,0,0,0,0
40,8479321,Lucas Johansen,D,,27,0,0,0,0
40,8477950,Tony DeAngelo,D,,29,0,0,0,0
40,8471218,Blake Wheeler,R,,38,0,0,0,0
40,8475197,Tyson Barrie,D,,33,0,0,0,0
40,8474157,Max Pacioretty,L,,36,0,0,0,0
40,8475744,Evgeny Kuznetsov,C,,32,0,0,0,0
40,8474037,James van Riemsdyk,L,,35,0,0,0,0
40,8476907,Mackenzie MacEachern,L,,30,0,0,0,0
40,8480216,Jacob Peterson,C,,25,0,0,0,0
40,8474602,Justin Schultz,D,,34,0,0,0,0
40,8482222,Alexander Barabanov,L,,30,0,0,0,0
40,8474031,Kevin Shattenkirk,D,,35,0,0,0,0
40,8477330,Dominik Kubalik,L,,29,0,0,0,0
40,8480884,Calen Addison,D,,24,0,0,0,0
40,8475906,John Klingberg,D,,32,0,0,0,0
40,8480008,Adam Ruzicka,C,,25,0,0,0,0
40,8476884,Derrick Pouliot,D,,30,0,0,0,0
40,8476919,Chris Tierney,C,,30,0,0,0,0
40,8479415,Michael McLeod,C,,26,0,0,0,0
40,8474870,Tyler Johnson,C,,34,0,0,0,0
40,8470604,Jeff Carter,C,,39,0,0,0,0
40,8478104,Sammy Blais,L,,28,0,0,0,0
40,8474884,Mike Hoffman,C,,35,0,0,0,0
40,8481591,Sam Poulin,R,,23,0,0,0,0
40,8471274,Alex Goligoski,D,,39,0,0,0,0
40,8476871,Tanner Pearson,L,,32,0,0,0,0
40,8476393,Nick Cousins,C,,31,0,0,0,0
40,8479977,Kailer Yamamoto,R,,26,0,0,0,0
40,8479346,Dillon Dube,C,,26,0,0,0,0
40,8480184,Gustav Lindstrom,D,,26,0,0,0,0
40,8479376,Victor Mete,D,,26,0,0,0,0
40,8473449,Kyle Okposo,R,,36,0,0,0,0
40,8481058,Jesse Ylonen,R,,25,0,0,0,0
40,8475752,Tyler Pitlick,C,,33,0,0,0,0
40,8481239,Samuel Fagemo,L,,24,0,0,0,0
40,8480821,Filip Zadina,R,,25,0,0,0,0
40,8470966,Mark Giordano,D,,41,0,0,0,0
40,8478495,Denis Gurianov,R,,27,0,0,0,0
40,8477464,Nic Petan,C,,29,0,0,0,0
40,8478099,Kevin Labanc,R,,29,0,0,0,0
40,8482241,Radim Zohorna,L,,28,0,0,0,0
40,8474040,Sam Gagner,C,,35,0,0,0,0
40,8479514,Rem Pitlick,C,,27,0,0,0,0
40,8478430,Oliver Kylington,D,,27,0,0,0,0
40,8479533,Joona Koppanen,L,,26,0,0,0,0
40,8479984,Cal Foote,D,,26,0,0,0,0
40,8477126,Jayson Megna,C,,34,0,0,0,0
40,8475164,Jakob Silfverberg,R,,34,0,0,0,0
40,8474009,Nick Bonino,C,,36,0,0,0,0
40,8479458,Nikita Zaitsev,D,,33,0,0,0,0
40,8477944,Jakub Vrana,L,,28,0,0,0,0
40,8471699,Andrew Cogliano,C,,37,0,0,0,0
40,8478067,Oskar Lindblom,L,,28,0,0,0,0
40,8471686,Marc Staal,D,,37,0,0,0,0
40,8470610,Zach Parise,L,,40,0,0,0,0
40,8478904,Steven Lorentz,C,,28,0,0,0,0
40,8473473,Milan Lucic,L,,36,0,0,0,0
40,8480031,Maxime Comtois,L,,25,0,0,0,0
40,8478512,Austin Czarnik,C,,32,0,0,0,0
40,8473504,Cal Clutterbuck,R,,37,0,0,0,0
40,8477454,Adam Erne,L,,29,0,0,0,0
40,8479383,Boris Katchouk,L,,26,0,0,0,0
40,8475825,Jani Hakanpää,D,,32,0,0,0,0
40,8477846,Ryan Carpenter,C,,33,0,0,0,0
40,8477930,Pierre-Edouard Bellemare,L,,39,0,0,0,0
40,8478400,Colin White,C,,27,0,0,0,0
40,8480226,Marián Studenic,R,,26,0,0,0,0
40,8480853,Liam Foudy,C,,24,0,0,0,0
40,8475797,Jarred Tinordi,D,,32,0,0,0,0
40,8479423,Alex Nylander,L,,26,0,0,0,0
40,8474618,Marco Scandella,D,,34,0,0,0,0
40,8478028,Fredrik Olofsson,L,,28,0,0,0,0
40,8474709,Matt Martin,L,,35,0,0,0,0
40,8481070,Hugh McGing,L,,26,0,0,0,0
40,8479546,Oskar Steen,C,,26,0,0,0,0
40,8474145,Robert Bortuzzo,D,,35,0,0,0,0
40,8476915,Jujhar Khaira,L,,30,0,0,0,0
40,8475278,Byron Froese,C,,33,0,0,0,0
40,8481812,Nikolai Knyzhov,D,,27,0,0,0,0
40,8478408,Travis Dermott,D,,28,0,0,0,0
40,8481077,John Leonard,L,,26,0,0,0,0
40,8479547,Matthew Phillips,R,,26,0,0,0,0
40,8480836,Jonathan Gruden,C,,24,0,0,0,0
40,8481690,Tyler Angle,C,,24,0,0,0,0
40,8475766,Austin Watson,L,,32,0,0,0,0
40,8481016,Ruslan Iskhakov,C,,24,0,0,0,0
40,8478078,Rourke Chartier,C,,28,0,0,0,0
40,8480776,Sheldon Rempal,R,,29,0,0,0,0
40,8484314,Jiri Smejkal,L,,28,0,0,0,0
41,8478402,Connor McDavid,C,EDM,27,82,50,114,164
41,8477492,Nathan MacKinnon,C,COL,29,82,40,93,133
41,8478420,Mikko Rantanen,R,COL,28,81,63,68,131
41,8476453,Nikita Kucherov,R,TBL,31,81,39,90,129
41,8477956,David Pastrnak,R,BOS,28,74,58,54,112
41,8478864,Kirill Kaprizov,L,MIN,27,75,52,57,109
41,8479407,Jesper Bratt,L,NJD,26,81,41,64,105
41,8478550,Artemi Panarin,L,NYR,33,76,31,74,105
41,8479318,Auston Matthews,C,TOR,27,79,62,41,103
41,8478483,Mitch Marner,R,TOR,27,78,26,77,103
41,8479314,Matthew Tkachuk,L,FLA,27,81,23,78,101
41,8477404,Jake Guentzel,C,TBL,30,80,38,62,100
41,8480800,Quinn Hughes,D,VAN,25,76,8,91,99
41,8480801,Brady Tkachuk,L,OTT,25,80,46,50,96
41,8480012,Elias Pettersson,C,VAN,26,75,29,67,96
41,8477934,Leon Draisaitl,C,EDM,29,77,45,49,94
41,8476468,J.T. Miller,C,VAN,31,79,36,58,94
41,8478403,Jack Eichel,C,VGK,28,78,50,42,92
41,8477933,Sam Reinhart,C,FLA,29,79,43,49,92
41,8471675,Sidney Crosby,C,PIT,37,77,42,50,92
41,8475172,Nazem Kadri,C,CGY,34,78,34,58,92
41,8481557,Matt Boldy,L,MIN,23,74,42,49,91
41,8477939,William Nylander,R,TOR,28,81,37,54,91
41,8479343,Clayton Keller,R,UTA,26,77,36,55,91
41,8478010,Brayden Point,C,TBL,28,82,46,43,89
41,8476454,Ryan Nugent-Hopkins,C,EDM,31,78,30,59,89
41,8481559,Jack Hughes,C,NJD,23,67,39,49,88
41,8475692,Mats Zuccarello,R,MIN,37,74,27,59,86
41,8475786,Zach Hyman,L,EDM,32,74,41,44,85
41,8479337,Alex DeBrincat,R,DET,27,82,36,47,83
41,8477942,Kevin Fiala,L,LAK,28,81,30,53,83
41,8480002,Nico Hischier,C,NJD,25,79,24,59,83
41,8480069,Cale Makar,D,COL,26,74,20,62,82
41,8471685,Anze Kopitar,C,LAK,37,79,34,47,81
41,8476887,Filip Forsberg,L,NSH,30,75,29,52,81
41,8476456,Jonathan Huberdeau,C,CGY,31,74,21,60,81
41,8474600,Roman Josi,D,NSH,34,73,15,66,81
41,8479323,Adam Fox,D,NYR,26,75,13,68,81
41,8480023,Robert Thomas,C,STL,25,74,23,57,80
41,8478398,Kyle Connor,L,WPG,28,72,42,37,79
41,8477402,Pavel Buchnevich,L,STL,29,73,35,44,79
41,8474564,Steven Stamkos,C,NSH,34,71,36,42,78
41,8480027,Jason Robertson,L,DAL,25,82,23,55,78
41,8476346,Johnny Gaudreau,L,CBJ,31,73,18,59,77
41,8478449,Roope Hintz,C,DAL,28,82,36,40,76
41,8477493,Aleksander Barkov,C,FLA,29,78,31,45,76
41,8482078,Lucas Raymond,L,DET,22,79,28,48,76
41,8478445,Mathew Barzal,C,NYI,27,78,19,57,76
41,8476389,Vincent Trocheck,C,NYR,31,75,29,46,75
41,8477501,Valeri Nichushkin,R,COL,29,80,42,32,74
41,8475913,Mark Stone,R,VGK,32,77,22,52,74
41,8480018,Nick Suzuki,C,MTL,25,78,22,52,74
41,8479420,Tage Thompson,C,BUF,27,70,33,40,73
41,8477496,Elias Lindholm,C,BOS,30,78,24,49,73
41,8475765,Vladimir Tarasenko,R,DET,33,79,29,43,72
41,8476881,Tomas Hertl,C,VGK,31,79,34,37,71
41,8476460,Mark Scheifele,C,WPG,31,74,25,46,71
41,8480208,Drake Batherson,R,OTT,26,80,24,47,71
41,8473419,Brad Marchand,L,BOS,36,79,24,47,71
41,8478427,Sebastian Aho,C,CAR,27,70,29,41,70
41,8479542,Brandon Hagel,L,TBL,26,82,24,46,70
41,8478460,Zach Werenski,D,CBJ,27,77,18,52,70
41,8480036,Miro Heiskanen,D,DAL,25,79,12,58,70
41,8478444,Brock Boeser,R,VAN,27,72,32,37,69
41,8481528,Dylan Cozens,C,BUF,23,70,30,39,69
41,8478519,Anthony Cirelli,C,TBL,27,82,26,43,69
41,8482116,Tim Stützle,C,OTT,22,79,25,44,69
41,8477960,Adrian Kempe,R,LAK,28,82,23,46,69
41,8482740,Wyatt Johnston,C,DAL,21,81,39,29,68
41,8477500,Bo Horvat,C,NYI,29,80,36,32,68
41,8480830,Andrei Svechnikov,R,CAR,24,72,31,37,68
41,8478439,Travis Konecny,R,PHI,27,73,29,39,68
41,8475168,Matt Duchene,C,DAL,33,82,29,39,68
41,8477940,Nikolaj Ehlers,L,WPG,28,71,28,40,68
41,8478401,Pavel Zacha,C,BOS,27,78,26,42,68
41,8478414,Timo Meier,R,NJD,28,70,38,29,67
41,8481540,Cole Caufield,R,MTL,23,72,36,31,67
41,8479385,Jordan Kyrou,C,STL,26,77,29,38,67
41,8479999,Casey Mittelstadt,C,COL,26,81,24,42,66
41,8480839,Rasmus Dahlin,D,BUF,24,73,17,49,66
41,8474578,Erik Karlsson,D,PIT,34,80,11,55,66
41,8480803,Evan Bouchard,D,EDM,25,73,7,59,66
41,8475184,Chris Kreider,L,NYR,33,79,47,18,65
41,8477955,Jared McCann,L,SEA,28,72,27,38,65
41,8478975,Mason Marchment,L,DAL,29,82,25,40,65
41,8477946,Dylan Larkin,C,DET,28,80,34,30,64
41,8471214,Alex Ovechkin,L,WSH,39,69,31,33,64
41,8477409,Carter Verhaeghe,C,FLA,29,80,28,36,64
41,8475166,John Tavares,C,TOR,34,79,27,37,64
41,8473994,Jamie Benn,L,DAL,35,82,22,42,64
41,8484166,Adam Fantilli,C,CBJ,20,76,38,25,63
41,8475810,Bryan Rust,R,PIT,32,73,36,27,63
41,8482109,Alexis Lafrenière,L,NYR,23,77,33,30,63
41,8481068,Yegor Sharangovich,C,CGY,26,77,32,31,63
41,8476459,Mika Zibanejad,C,NYR,31,74,22,41,63
41,8479345,Jakob Chychrun,D,WSH,26,66,20,42,62
41,8480865,Noah Dobson,D,NYI,24,80,16,46,62
41,8478469,Thomas Chabot,D,OTT,27,80,16,46,62
41,8475170,Brayden Schenn,C,STL,33,78,29,32,61
41,8478397,Rasmus Andersson,D,CGY,28,74,9,52,61
41,8478440,Dylan Strome,C,WSH,27,74,23,37,60
41,8477951,Nick Schmaltz,C,UTA,28,76,20,40,60
41,8476875,Mike Matheson,D,MTL,30,75,15,45,60
41,8477949,Alex Tuch,R,BUF,28,73,25,34,59
41,8475798,Mikael Granlund,C,SJS,32,66,22,37,59
41,8479325,Charlie McAvoy,D,BOS,27,80,12,47,59
41,8476399,Blake Coleman,C,CGY,33,76,34,24,58
41,8483431,Logan Cooley,C,UTA,20,79,31,27,58
41,8484153,Leo Carlsson,C,ANA,20,74,25,33,58
41,8481596,Shane Pinto,C,OTT,24,78,20,38,58
41,8476539,Jonathan Marchessault,R,NSH,34,70,33,24,57
41,8474141,Patrick Kane,R,DET,36,81,16,41,57
41,8477504,Josh Morrissey,D,WPG,29,76,6,51,57
41,8478498,Jake DeBrusk,L,VAN,28,71,29,27,56
41,8479675,Trevor Moore,L,LAK,29,82,23,33,56
41,8475745,Charlie Coyle,C,BOS,32,74,21,35,56
41,8474150,Mikael Backlund,C,CGY,35,76,21,35,56
41,8475218,Mattias Ekholm,D,EDM,34,79,14,42,56
41,8475754,Brock Nelson,C,NYI,33,79,28,27,55
41,8482699,Dylan Guenther,R,UTA,21,77,26,29,55
41,8477429,Andrew Copp,C,DET,30,80,25,30,55
41,8480015,Owen Tippett,R,PHI,25,77,24,31,55
41,8471215,Evgeni Malkin,C,PIT,38,73,21,34,55
41,8476882,Teuvo Teravainen,C,CHI,30,67,18,37,55
41,8478856,Conor Garland,R,VAN,28,74,28,26,54
41,8476880,Tom Wilson,R,WSH,30,70,27,27,54
41,8482110,Dawson Mercer,C,NJD,23,72,26,28,54
41,8478047,Michael Bunting,L,PIT,29,71,24,30,54
41,8475784,Jeff Skinner,C,EDM,32,76,24,30,54
41,8477456,J.T. Compher,L,DET,29,77,24,30,54
41,8481533,Trevor Zegras,C,ANA,23,79,20,34,54
41,8478873,Troy Terry,R,ANA,27,70,14,40,54
41,8478038,Devon Toews,D,COL,30,71,14,40,54
41,8475167,Victor Hedman,D,TBL,34,80,13,41,54
41,8473512,Claude Giroux,R,OTT,36,80,11,43,54
41,8474565,Alex Pietrangelo,D,VGK,34,58,11,43,54
41,8478366,Frank Vatrano,R,ANA,30,73,29,24,53
41,8476448,William Karlsson,C,VGK,31,77,25,28,53
41,8478493,Joel Eriksson Ek,C,MIN,27,66,24,29,53
41,8478466,Daniel Sprong,R,VAN,27,74,22,31,53
41,8477476,Artturi Lehkonen,L,COL,29,81,21,32,53
41,8474586,Jordan Eberle,R,SEA,34,73,21,32,53
41,8477416,Oliver Bjorkstrand,R,SEA,29,68,18,35,53
41,8477503,Max Domi,C,TOR,29,77,16,37,53
41,8477494,Jonathan Drouin,L,COL,29,80,15,38,53
41,8484144,Connor Bedard,C,CHI,19,67,13,40,53
41,8479365,Trent Frederic,C,BOS,26,77,22,30,52
41,8475287,Erik Haula,L,NJD,33,69,20,32,52
41,8476479,Phillip Danault,C,LAK,31,75,17,35,52
41,8476905,Chandler Stephenson,C,SEA,30,77,14,38,52
41,8479992,Michael Rasmussen,C,DET,25,80,27,24,51
41,8475726,Tyler Toffoli,C,SJS,32,68,25,26,51
41,8483515,Juraj Slafkovsky,L,MTL,20,72,23,28,51
41,8482665,Matty Beniers,C,SEA,22,72,16,35,51
41,8480028,Morgan Frost,C,PHI,25,71,13,37,50
41,8482624,Daniil Miromanov,D,CGY,27,58,13,37,50
41,8482684,Luke Hughes,D,NJD,21,66,10,40,50
41,8476853,Morgan Rielly,D,TOR,30,73,5,45,50
41,8474641,Adam Henrique,C,EDM,34,71,26,23,49
41,8477511,Anthony Mantha,R,CGY,30,77,24,25,49
41,8474563,Drew Doughty,D,LAK,35,69,20,29,49
41,8479400,Pierre-Luc Dubois,L,WSH,26,74,19,30,49
41,8479425,Filip Hronek,D,VAN,27,76,11,38,49
41,8471724,Kris Letang,D,PIT,37,81,10,39,49
41,8474590,John Carlson,D,WSH,34,68,10,39,49
41,8482745,Mason McTavish,C,ANA,21,71,26,22,48
41,8475794,Tyler Seguin,C,DAL,32,81,24,24,48
41,8474679,Gustav Nyquist,C,NSH,35,74,21,27,48
41,8482124,Quinton Byfield,R,LAK,22,80,20,28,48
41,8482093,Seth Jarvis,C,CAR,22,67,17,31,48
41,8478407,Vince Dunn,D,SEA,28,73,8,40,48
41,8481560,Arthur Kaliyev,R,LAK,23,79,21,26,47
41,8477935,Sam Bennett,C,FLA,28,80,19,28,47
41,8477451,Ryan Hartman,R,MIN,30,65,18,29,47
41,8475753,Justin Faulk,D,STL,32,73,12,35,47
41,8480064,Josh Norris,C,OTT,25,77,23,23,46
41,8482092,Ridly Greig,C,OTT,22,79,19,27,46
41,8475158,Ryan O'Reilly,C,NSH,33,77,15,31,46
41,8478233,Andrew Mangiapane,L,WSH,28,70,23,22,45
41,8482159,Tyson Foerster,R,PHI,22,71,22,23,45
41,8483808,Andrei Kuzmenko,L,CGY,28,75,21,24,45
41,8477479,Tyler Bertuzzi,L,CHI,29,65,21,24,45
41,8482113,Anton Lundell,C,FLA,23,76,21,24,45
41,8479339,Patrik Laine,L,CBJ,26,56,19,26,45
41,8478462,Nicolas Roy,C,VGK,27,76,19,26,45
41,8478115,Pierre Engvall,L,NYI,28,75,18,27,45
41,8477447,Shea Theodore,D,VGK,29,63,9,36,45
41,8478055,Gustav Forsling,D,FLA,28,76,9,36,45
41,8475768,Jaden Schwartz,C,SEA,32,73,23,21,44
41,8478046,Danton Heinen,L,VAN,29,72,20,24,44
41,8483505,Matthew Poitras,C,BOS,20,75,17,27,44
41,8481711,Matias Maccelli,L,UTA,24,77,14,30,44
41,8476458,Ryan Strome,C,ANA,31,71,13,31,44
41,8481542,Moritz Seider,D,DET,23,73,12,32,44
41,8476958,Jaccob Slavin,D,CAR,30,75,7,37,44
41,8475169,Evander Kane,L,EDM,33,79,25,18,43
41,8476483,Rickard Rakell,R,PIT,31,68,23,20,43
41,8480797,Joel Farabee,L,PHI,24,78,21,22,43
41,8479525,Ross Colton,C,COL,28,79,19,24,43
41,8482146,Luke Evangelista,R,NSH,22,70,19,24,43
41,8482702,Logan Stankoven,C,DAL,21,77,16,27,43
41,8477497,Sean Monahan,C,CBJ,30,69,15,28,43
41,8478458,John (Jack) Roslovic,C,CAR,27,68,13,30,43
41,8480014,Gabriel Vilardi,C,WPG,25,68,26,16,42
41,8477407,Anthony Duclair,L,NYI,29,77,22,20,42
41,8473986,Alex Killorn,L,ANA,35,74,19,23,42
41,8478438,Tommy Novak,C,NSH,27,72,15,27,42
41,8477498,Darnell Nurse,D,EDM,29,72,12,30,42
41,8477495,Seth Jones,D,CHI,30,68,11,31,42
41,8480336,Sean Walker,D,CAR,30,74,11,31,42
41,8476906,Shayne Gostisbehere,D,CAR,31,72,10,32,42
41,8476854,Hampus Lindholm,D,BOS,30,78,9,33,42
41,8477932,Aaron Ekblad,D,FLA,28,72,8,34,42
41,8478109,Victor Olofsson,L,VGK,29,69,18,23,41
41,8481604,Pavel Dorofeyev,L,VGK,24,69,17,24,41
41,8476462,Dougie Hamilton,D,NJD,31,69,16,25,41
41,8476826,Yanni Gourde,C,SEA,33,73,15,26,41
41,8476872,Scott Laughton,C,PHI,30,76,12,29,41
41,8476432,Boone Jenner,C,CBJ,31,72,23,17,40
41,8475151,Kyle Palmieri,C,NYI,33,78,19,21,40
41,8477998,Warren Foegele,L,LAK,28,78,18,22,40
41,8477986,Brandon Montour,D,SEA,30,74,16,24,40
41,8475314,Anders Lee,L,NYI,34,80,16,24,40
41,8477948,Travis Sanheim,D,PHI,28,69,8,32,40
41,8477426,Nicholas Paul,L,TBL,29,81,23,16,39
41,8479987,Morgan Geekie,C,BOS,26,79,21,18,39
41,8480188,Fabian Zetterlund,L,SJS,25,70,19,20,39
41,8478042,Viktor Arvidsson,L,EDM,31,75,19,20,39
41,8476419,Jean-Gabriel Pageau,C,NYI,32,74,18,21,39
41,8476480,Vladislav Namestnikov,C,WPG,32,56,18,21,39
41,8481524,Bowen Byram,D,BUF,23,67,16,23,39
41,8480039,Martin Necas,C,CAR,25,68,15,24,39
41,8478413,Jordan Greenway,L,BUF,27,66,14,25,39
41,8481581,Thomas Harley,D,DAL,23,77,10,29,39
41,8476869,Brady Skjei,D,NSH,30,71,6,33,39
41,8474715,Cameron Atkinson,R,TBL,35,82,22,16,38
41,8480459,Pius Suter,C,VAN,28,64,22,16,38
41,8481618,Alex Newhook,C,MTL,23,74,18,20,38
41,8477964,Ivan Barbashev,C,VGK,29,71,15,23,38
41,8480185,Eetu Luostarinen,C,FLA,26,75,15,23,38
41,8477346,MacKenzie Weegar,D,CGY,30,66,12,26,38
41,8475722,Jason Zucker,L,BUF,32,69,12,26,38
41,8477021,Alex Kerfoot,C,UTA,30,72,11,27,38
41,8479410,Mikhail Sergachev,D,UTA,26,67,10,28,38
41,8482122,Brock Faber,D,MIN,22,78,9,29,38
41,8482655,Janis Moser,D,TBL,24,78,6,32,38
41,8476923,Damon Severson,D,CBJ,30,81,3,35,38
41,8475760,Nick Bjugstad,C,UTA,32,74,22,15,37
41,8476438,Brandon Saad,L,STL,32,66,18,19,37
41,8482705,Cole Sillinger,C,CBJ,21,63,18,19,37
41,8475848,Brendan Gallagher,R,MTL,32,72,17,20,37
41,8474102,David Perron,L,OTT,36,75,16,21,37
41,8478474,Lawson Crouse,L,UTA,27,72,15,22,37
41,8477444,Andre Burakovsky,L,SEA,29,67,15,22,37
41,8476792,Torey Krug,D,STL,33,73,13,24,37
41,8482660,Kent Johnson,C,CBJ,22,67,12,25,37
41,8470613,Brent Burns,D,CAR,39,76,9,28,37
41,8482089,Jake Neighbours,L,STL,22,68,22,14,36
41,8480829,Jesperi Kotkaniemi,C,CAR,24,69,20,16,36
41,8475763,Kevin Hayes,R,PIT,32,64,16,20,36
41,8482667,William Eklund,L,SJS,22,70,13,23,36
41,8475191,Reilly Smith,R,NYR,33,73,11,25,36
41,8480817,K'Andre Miller,D,NYR,24,77,9,27,36
41,8478396,Noah Hanifin,D,VGK,27,57,7,29,36
41,8476463,Jonas Brodin,D,MIN,31,77,5,31,36
41,8480798,Philipp Kurashev,C,CHI,25,56,17,18,35
41,8477987,Ryan Donato,C,CHI,28,57,15,20,35
41,8481186,Logan O'Connor,R,COL,28,79,13,22,35
41,8477952,Robby Fabbri,C,ANA,28,62,18,16,34
41,8484203,Bradly Nadeau,L,CAR,19,61,17,17,34
41,8480009,Eeli Tolvanen,R,SEA,25,67,15,19,34
41,8482720,Matthew Knies,L,TOR,22,75,14,20,34
41,8475793,Ryan Johansen,C,PHI,32,71,13,21,34
41,8482475,Yegor Chinakhov,R,CBJ,23,62,13,21,34
41,8484145,Zach Benson,L,BUF,19,65,12,22,34
41,8476927,Teddy Blueger,C,VAN,30,62,12,22,34
41,8480855,Jack McBain,C,UTA,24,66,12,22,34
41,8475149,Marcus Johansson,L,MIN,34,62,12,22,34
41,8478542,Evan Rodrigues,C,FLA,31,68,11,23,34
41,8481606,Jordan Spence,D,LAK,23,66,9,25,34
41,8478472,Mathieu Joseph,R,STL,27,66,7,27,34
41,8475799,Nino Niederreiter,R,WPG,32,66,20,13,33
41,8479293,Brandon Tanev,L,SEA,33,62,19,14,33
41,8482149,Cole Perfetti,C,WPG,22,68,17,16,33
41,8476292,Ondrej Palat,L,NJD,33,68,16,17,33
41,8482175,JJ Peterka,R,BUF,22,64,15,18,33
41,8481577,Philip Tomasino,C,NSH,23,60,15,18,33
41,8481535,Nils Hoglander,L,VAN,24,61,14,19,33
41,8479351,Sam Steel,C,DAL,26,80,12,21,33
41,8475193,Tomas Tatar,L,NJD,34,66,12,21,33
41,8475791,Taylor Hall,L,CHI,33,57,12,21,33
41,8476474,Stefan Noesen,R,NJD,31,65,11,22,33
41,8480871,Adam Boqvist,D,FLA,24,68,11,22,33
41,8480434,Sean Durzi,D,UTA,26,71,5,28,33
41,8482097,Jack Quinn,R,BUF,23,69,15,17,32
41,8477505,Alexander Wennberg,C,SJS,30,62,15,17,32
41,8479390,Taylor Raddysh,R,WSH,26,63,15,17,32
41,8480849,Barrett Hayton,C,UTA,24,69,14,18,32
41,8479591,Michael Eyssimont,C,TBL,28,80,12,20,32
41,8478891,Mason Appleton,C,WPG,28,64,11,21,32
41,8481703,Valtteri Puustinen,R,PIT,25,59,9,23,32
41,8474151,Ryan McDonagh,D,TBL,35,76,6,26,32
41,8477506,Ryan Pulock,D,NYI,30,76,5,27,32
41,8482074,Connor Zary,C,CGY,23,55,16,15,31
41,8481554,Kaapo Kakko,R,NYR,23,73,12,19,31
41,8481523,Kirby Dach,C,MTL,23,64,9,22,31
41,8481656,Aliaksei Protas,C,WSH,23,64,8,23,31
41,8473507,Jeff Petry,D,DET,37,75,5,26,31
41,8478507,John Marino,D,UTA,27,65,2,29,31
41,8471698,T.J. Oshie,R,WSH,38,70,17,13,30
41,8480078,Filip Chytil,C,NYR,25,66,16,14,30
41,8476278,Colin Blackwell,C,DAL,31,80,16,14,30
41,8482125,Alexander Holtz,R,VGK,22,69,15,15,30
41,8477450,Jason Dickinson,C,CHI,29,61,13,17,30
41,8476892,Colton Parayko,D,STL,31,73,8,22,30
41,8479639,Dylan Coghlan,D,WPG,26,61,8,22,30
41,8474053,Logan Couture,C,SJS,35,60,7,23,30
41,8478851,Alexandre Carrier,D,NSH,28,66,6,24,30
41,8475764,Cam Fowler,D,ANA,33,72,1,29,30
41,8477953,Kasperi Kapanen,R,STL,28,75,15,14,29
41,8473533,Jordan Staal,C,CAR,36,64,14,15,29
41,8474149,Evgenii Dadonov,R,DAL,35,79,12,17,29
41,8478500,Ivan Provorov,D,CBJ,27,76,7,22,29
41,8480873,Rasmus Sandin,D,WSH,24,71,5,24,29
41,8480145,Neal Pionk,D,WPG,29,76,5,24,29
41,8476429,Scott Mayfield,D,NYI,32,70,4,25,29
41,8480222,Sebastian Aho,D,PIT,28,77,4,25,29
41,8476979,Erik Gustafsson,D,DET,32,75,3,26,29
41,8481032,Paul Cotter,C,NJD,25,66,16,12,28
41,8478463,Anthony Beauvillier,L,PIT,27,69,15,13,28
41,8482079,Marco Rossi,C,MIN,23,59,14,14,28
41,8476897,Oskar Sundqvist,C,STL,30,68,11,17,28
41,8476925,Colton Sissons,C,NSH,31,60,10,18,28
41,8474716,Jared Spurgeon,D,MIN,35,80,10,18,28
41,8482712,Oskar Olausson,R,COL,22,79,9,19,28
41,8483457,Lane Hutson,D,MTL,20,67,9,19,28
41,8479982,Conor Timmins,D,TOR,26,61,7,21,28
41,8479402,Jake Bean,D,CGY,26,68,4,24,28
41,8476331,Dylan DeMelo,D,WPG,31,69,3,25,28
41,8477488,Brett Pesce,D,NJD,30,72,2,26,28
41,8476469,Joel Armia,R,MTL,31,66,13,14,27
41,8479996,Cody Glass,C,NSH,25,62,13,14,27
41,8476392,Adam Lowry,C,WPG,31,63,12,15,27
41,8477947,Sonny Milano,L,WSH,28,68,12,15,27
41,8480802,Ryan McLeod,C,BUF,25,68,10,17,27
41,8477839,Conor Sheary,L,TBL,32,82,10,17,27
41,8482117,Lukas Reichel,L,CHI,22,64,9,18,27
41,8483490,Pavel Mintyukov,D,ANA,21,63,8,19,27
41,8482133,Thomas Bordeleau,C,SJS,22,60,7,20,27
41,8476917,Adam Pelech,D,NYI,30,77,7,20,27
41,8481546,Cam York,D,PHI,23,70,6,21,27
41,8475279,Ben Chiarot,D,DET,33,69,4,23,27
41,8475181,Nick Leddy,D,STL,33,70,3,24,27
41,8478057,Dakota Joshua,C,VAN,28,72,13,13,26
41,8480068,Ryan Poehling,C,PHI,25,69,13,13,26
41,8479941,Justin Danforth,R,CBJ,31,53,13,13,26
41,8475714,Calle Jarnkrok,C,TOR,33,75,12,14,26
41,8477903,Garnet Hathaway,R,PHI,33,68,12,14,26
41,8479336,Carl Grundstrom,R,SJS,27,62,12,14,26
41,8482671,Owen Power,D,BUF,22,66,11,15,26
41,8478133,Jake Evans,C,MTL,28,70,7,19,26
41,8475179,Dmitry Kulikov,D,FLA,34,65,6,20,26
41,8477969,Marcus Pettersson,D,PIT,28,78,2,24,26
41,8480813,Joe Veleno,C,DET,24,80,15,10,25
41,8481582,Nicholas Robertson,L,TOR,23,69,13,12,25
41,8480003,Jesper Boqvist,C,FLA,26,72,12,13,25
41,8477015,Connor Brown,R,EDM,30,61,11,14,25
41,8479315,Joey Anderson,R,CHI,26,53,11,14,25
41,8480835,Jack Drury,C,CAR,24,62,10,15,25
41,8481716,Dmitri Voronkov,L,CBJ,24,49,10,15,25
41,8483565,Nick Blankenburg,D,NSH,26,67,8,17,25
41,8480246,Nick Perbix,D,TBL,26,73,6,19,25
41,8483499,Liam Ohgren,L,MIN,20,56,5,20,25
41,8478882,Vladislav Gavrikov,D,LAK,29,68,4,21,25
41,8478508,Yakov Trenin,C,MIN,27,64,15,9,24
41,8481641,Joel Kiviranta,L,COL,28,71,13,11,24
41,8481704,Juuso Parssinen,C,NSH,23,59,13,11,24
41,8481093,Rafael Harvey-Pinard,L,MTL,25,57,12,12,24
41,8477406,Mattias Janmark,C,EDM,32,66,12,12,24
41,8482809,Jackson Blake,R,CAR,21,59,11,13,24
41,8480220,Noah Cates,L,PHI,25,67,10,14,24
41,8473422,Nick Foligno,L,CHI,37,62,10,14,24
41,8474189,Lars Eller,C,PIT,35,70,10,14,24
41,8480113,Alex Iafallo,L,WPG,31,66,10,14,24
41,8477979,Nicolas Aube-Kubel,R,BUF,28,59,10,14,24
41,8476981,Josh Anderson,R,MTL,30,69,9,15,24
41,8482111,Justin Barron,D,MTL,23,61,9,15,24
41,8477919,Frederick Gaudreau,C,MIN,31,63,8,16,24
41,8483524,Shane Wright,C,SEA,20,60,8,16,24
41,8481441,Joe Snively,C,DET,28,65,8,16,24
41,8483491,Ivan Miroshnichenko,L,WSH,20,53,8,16,24
41,8475200,Dmitry Orlov,D,CAR,33,77,7,17,24
41,8480035,Henri Jokiharju,D,BUF,25,67,5,19,24
41,8476422,Mike Reilly,D,NYI,31,73,4,20,24
41,8481522,Peyton Krebs,C,BUF,23,63,4,20,24
41,8478840,Will Borgen,D,SEA,28,68,3,21,24
41,8482259,Bobby McMann,C,TOR,28,60,14,9,23
41,8479520,Brandon Duhaime,R,WSH,27,56,13,10,23
41,8470621,Corey Perry,R,EDM,39,77,12,11,23
41,8480806,Isac Lundestrom,C,ANA,25,57,10,13,23
41,8479976,Juuso Valimaki,D,UTA,26,65,8,15,23
41,8474574,Tyler Myers,D,VAN,34,66,8,15,23
41,8480021,Jack Studnicka,C,LAK,25,59,8,15,23
41,8478970,Jalen Chatfield,D,CAR,28,71,7,16,23
41,8483482,Tristan Luneau,D,ANA,20,71,6,17,23
41,8482073,Braden Schneider,D,NYR,23,69,5,18,23
41,8475233,David Savard,D,MTL,34,70,3,20,23
41,8478020,Michael Amadio,R,OTT,28,69,15,7,22
41,8480893,Kirill Marchenko,R,CBJ,24,70,14,8,22
41,8473453,Trevor Lewis,C,LAK,37,74,12,10,22
41,8476461,Sean Couturier,C,PHI,32,71,11,11,22
41,8481028,Martin Pospisil,C,CGY,25,57,10,12,22
41,8475171,Oliver Ekman-Larsson,D,TOR,33,64,8,14,22
41,8480748,Kiefer Sherwood,L,VAN,29,61,8,14,22
41,8481014,Alexander Romanov,D,NYI,24,79,5,17,22
41,8482142,Jamie Drysdale,D,PHI,22,64,5,17,22
41,8476885,Jacob Trouba,D,NYR,30,67,3,19,22
41,8482087,Kaiden Guhle,D,MTL,22,66,3,19,22
41,8479619,Michael Carcone,L,UTA,28,65,15,6,21
41,8477425,Miles Wood,L,COL,29,75,14,7,21
41,8476374,Sean Kuraly,C,CBJ,31,55,12,9,21
41,8481580,Connor McMichael,C,WSH,23,62,11,10,21
41,8475220,Marcus Foligno,L,MIN,33,55,11,10,21
41,8477507,Nikita Zadorov,D,BOS,29,72,11,10,21
41,8480025,MacKenzie Entwistle,R,FLA,25,55,11,10,21
41,8477446,Michael McCarron,R,NSH,29,60,10,11,21
41,8480205,Emil Bemstrom,C,PIT,25,61,9,12,21
41,8482737,Zack Bolduc,C,STL,21,59,9,12,21
41,8481553,Bobby Brink,R,PHI,23,62,8,13,21
41,8479414,Nathan Bastian,R,NJD,27,62,8,13,21
41,8476457,Adam Larsson,D,SEA,32,69,7,14,21
41,8479661,Tanner Jeannot,L,LAK,27,79,6,15,21
41,8481019,David Gustafsson,C,WPG,24,57,6,15,21
41,8479291,Kevin Rooney,C,CGY,31,59,5,16,21
41,8482807,Ethan Del Mastro,D,CHI,21,53,4,17,21
41,8480043,Timothy Liljegren,D,TOR,25,68,3,18,21
41,8479371,Dante Fabbro,D,NSH,26,59,2,19,21
41,8482451,Mikael Pyyhtia,L,CBJ,23,43,2,19,21
41,8477845,Trevor van Riemsdyk,D,WSH,33,63,1,20,21
41,8479718,Alex Barré-Boulet,C,MTL,27,59,11,9,20
41,8476921,Jordan Martinook,L,CAR,32,61,10,10,20
41,8479393,Noah Gregor,L,OTT,26,70,10,10,20
41,8477369,Carson Soucy,D,VAN,30,63,9,11,20
41,8478434,Keegan Kolesar,R,VGK,27,70,9,11,20
41,8482192,Isaak Phillips,D,CHI,23,46,9,11,20
41,8479353,Brett Howden,C,VGK,26,69,7,13,20
41,8478911,Matt Roy,D,WSH,29,63,7,13,20
41,8478421,A.J. Greer,L,FLA,28,54,7,13,20
41,8480789,Oliver Wahlstrom,R,NYI,24,72,6,14,20
41,8480860,Kevin Bahl,D,CGY,24,58,5,15,20
41,8479372,Joshua Mahura,D,SEA,26,54,5,15,20
41,8479980,Nicolas Hague,D,VGK,26,53,3,17,20
41,8482062,Cole Smith,L,NSH,29,52,13,6,19
41,8481481,Blake Lizotte,C,PIT,27,64,10,9,19
41,8480074,Alexandre Texier,C,STL,25,56,10,9,19
41,8481624,Ilya Mikheyev,R,CHI,30,61,9,10,19
41,8479368,Max Jones,L,BOS,26,71,8,11,19
41,8482803,Olen Zellweger,D,ANA,21,73,8,11,19
41,8480995,Pontus Holmberg,R,TOR,25,64,7,12,19
41,8480073,Erik Brannstrom,D,COL,25,58,7,12,19
41,8482148,Hendrix Lapierre,C,WSH,22,53,7,12,19
41,8480144,David Kampf,C,TOR,29,75,6,13,19
41,8483445,Cutter Gauthier,L,ANA,20,65,6,13,19
41,8482101,Danil Gushchin,L,SJS,22,59,6,13,19
41,8478432,Christian Fischer,R,DET,27,74,5,14,19
41,8478452,Caleb Jones,D,LAK,27,56,5,14,19
41,8476856,Mathew Dumba,D,DAL,30,75,4,15,19
41,8475790,Erik Gudbranson,D,CBJ,32,79,3,16,19
41,8480878,Nils Lundkvist,D,DAL,24,73,2,17,19
41,8476879,Cody Ceci,D,EDM,31,68,2,17,19
41,8481701,Santeri Hatakka,D,NJD,23,33,2,17,19
41,8478831,Kevin Stenlund,C,UTA,28,48,12,6,18
41,8482055,Drew O'Connor,L,PIT,26,58,11,7,18
41,8479066,Ryan Lomberg,L,CGY,30,66,11,7,18
41,8480252,Cole Guttman,C,CHI,25,46,11,7,18
41,8475855,Jesper Fast,R,CAR,33,64,9,9,18
41,8482155,Alex Laferriere,R,LAK,23,66,9,9,18
41,8480448,Parker Kelly,L,COL,25,75,7,11,18
41,8477353,Tyler Motte,C,DET,29,69,7,11,18
41,8480848,Ty Dellandrea,C,SJS,24,53,7,11,18
41,8475343,Nic Dowd,C,WSH,34,60,6,12,18
41,8476624,Barclay Goodrow,C,SJS,31,56,6,12,18
41,8475231,Casey Cizikas,C,NYI,33,72,5,13,18
41,8476960,Andreas Athanasiou,C,CHI,30,56,5,13,18
41,8478451,Ethan Bear,D,WSH,27,50,5,13,18
41,8482067,Connor Mackey,D,NYR,28,65,4,14,18
41,8476329,Travis Boyd,C,MIN,31,59,4,14,18
41,8481527,Kaedan Korczak,D,VGK,23,51,4,14,18
41,8482245,Artem Zub,D,OTT,29,71,3,15,18
41,8481568,Alex Vlasic,D,CHI,23,57,3,15,18
41,8479398,Samuel Girard,D,COL,26,67,2,16,18
41,8481059,Scott Perunovich,D,STL,26,56,2,16,18
41,8476931,Jake McCabe,D,TOR,31,66,1,17,18
41,8480049,Dylan Samberg,D,WPG,25,64,1,17,18
41,8482679,Matt Coronato,R,CGY,22,67,13,4,17
41,8483468,Jiri Kulich,C,BUF,20,52,10,7,17
41,8481601,Simon Holmstrom,R,NYI,23,68,10,7,17
41,8481517,Brett Leason,R,ANA,25,56,10,7,17
41,8476878,Zemgus Girgensons,C,TBL,30,80,9,8,17
41,8477989,Christian Dvorak,C,MTL,28,62,7,10,17
41,8478013,Jake Walman,D,SJS,28,67,7,10,17
41,8476822,Luke Glendening,C,TBL,35,76,7,10,17
41,8478585,Derek Ryan,C,EDM,38,62,7,10,17
41,8479439,Jacob MacDonald,D,COL,31,51,4,13,17
41,8484254,Akito Hirose,D,VAN,25,49,4,13,17
41,8478178,Darren Raddysh,D,TBL,28,73,3,14,17
41,8476312,Josh Manson,D,COL,33,58,3,14,17
41,8476891,Matthew Grzelcyk,D,PIT,30,75,2,15,17
41,8478399,Jonas Siegenthaler,D,NJD,27,62,2,15,17
41,8476525,Colin Miller,D,WPG,32,67,2,15,17
41,8477478,William Carrier,L,CAR,30,52,10,6,16
41,8479671,Mathieu Olivier,R,CBJ,27,50,10,6,16
41,8480762,Eric Robinson,L,CAR,29,53,7,9,16
41,8481521,Ronnie Attard,D,PHI,25,59,7,9,16
41,8483493,Frank Nazar,C,CHI,20,48,6,10,16
41,8480355,Mark Kastelic,C,BOS,25,57,6,10,16
41,8477220,Nate Schmidt,D,FLA,33,67,5,11,16
41,8479359,Beck Malenstyn,L,BUF,26,50,4,12,16
41,8481167,Brayden Pachal,D,CGY,25,47,4,12,16
41,8476902,Esa Lindell,D,DAL,30,71,3,13,16
41,8476988,Matt Benning,D,SJS,30,57,3,13,16
41,8475462,Radko Gudas,D,ANA,34,62,3,13,16
41,8475188,Brayden McNabb,D,VGK,33,59,3,13,16
41,8480891,Michael Kesselring,D,UTA,24,54,2,14,16
41,8477070,Liam O'Brien,C,UTA,30,58,2,14,16
41,8477435,Ryan Graves,D,PIT,29,78,1,15,16
41,8480070,Ian Mitchell,D,BOS,25,44,0,16,16
41,8476918,Jimmy Vesey,L,NYR,31,64,11,4,15
41,8480011,Klim Kostin,C,SJS,25,45,10,5,15
41,8479328,Julien Gauthier,R,NYI,27,64,9,6,15
41,8475842,Sam Carrick,C,NYR,32,58,7,8,15
41,8478569,Noel Acciari,C,PIT,33,54,6,9,15
41,8474673,TJ Brodie,D,CHI,34,68,5,10,15
41,8479983,Mario Ferraro,D,SJS,26,72,5,10,15
41,8477499,Rasmus Ristolainen,D,PHI,30,62,5,10,15
41,8481537,Nikita Okhotiuk,D,CGY,24,54,5,10,15
41,8477508,Curtis Lazar,C,NJD,29,58,4,11,15
41,8477392,Hudson Fasching,R,NYI,29,58,4,11,15
41,8482166,Shakir Mukhamadullin,D,SJS,22,60,4,11,15
41,8479026,Philippe Myers,D,TOR,27,57,3,12,15
41,8471677,Jack Johnson,D,CBJ,37,64,3,12,15
41,8478416,Erik Cernak,D,TBL,27,72,1,14,15
41,8480980,Connor Dewar,C,TOR,25,60,8,6,14
41,8479316,Luke Kunin,C,SJS,27,51,7,7,14
41,8474034,Patrick Maroon,L,CHI,36,48,7,7,14
41,8480281,Alexey Toropchenko,R,STL,25,55,7,7,14
41,8476467,Jamie Oleksiak,D,SEA,32,69,6,8,14
41,8479442,Troy Stecher,D,EDM,30,50,6,8,14
41,8480887,Jordan Harris,D,MTL,24,53,6,8,14
41,8479344,Jesse Puljujarvi,R,PIT,26,51,5,9,14
41,8476967,Brett Kulak,D,EDM,30,67,5,9,14
41,8482859,Zack Ostapchuk,C,OTT,21,60,5,9,14
41,8482105,Jake Sanderson,D,OTT,22,69,4,10,14
41,8478136,Jake Middleton,D,MIN,28,71,4,10,14
41,8482095,Tyler Kleven,D,OTT,22,41,4,10,14
41,8483466,Kevin Korchinski,D,CHI,20,48,4,10,14
41,8473563,Nicklas Backstrom,C,WSH,37,55,3,11,14
41,8480172,Jan Rutta,D,SJS,34,58,3,11,14
41,8482749,Joshua Roy,R,MTL,21,62,3,11,14
41,8475208,Brian Dumoulin,D,ANA,33,63,3,11,14
41,8480807,Mattias Samuelsson,D,BUF,24,52,2,12,14
41,8481708,Zac Jones,D,NYR,24,49,2,12,14
41,8476874,Olli Maatta,D,DET,30,65,1,13,14
41,8479968,Vinni Lettieri,C,BOS,29,48,9,4,13
41,8479998,Mikey Anderson,D,LAK,25,68,5,8,13
41,8475762,Derek Forbort,D,VAN,32,50,4,9,13
41,8479324,Ryan Lindgren,D,NYR,26,59,3,10,13
41,8480001,Urho Vaakanainen,D,ANA,25,55,3,10,13
41,8475324,Nick Jensen,D,OTT,34,65,1,12,13
41,8481178,Egor Zamula,D,PHI,24,56,0,13,13
41,8481789,Tye Kartye,L,SEA,23,48,9,3,12
41,8481013,Jonatan Berggren,R,DET,24,58,6,6,12
41,8481518,Nolan Foote,L,NJD,24,40,5,7,12
41,8480845,Rasmus Kupari,C,WPG,24,48,5,7,12
41,8478211,Dryden Hunt,L,CGY,29,59,5,7,12
41,8476994,Vinnie Hinostroza,C,NSH,30,45,5,7,12
41,8479638,Justin Brazeau,R,BOS,26,36,5,7,12
41,8482157,Will Cuylle,L,NYR,22,57,4,8,12
41,8478043,Sam Lafferty,C,BUF,29,56,4,8,12
41,8482176,Wyatt Kaiser,D,CHI,22,55,4,8,12
41,8477482,Zachary Sanford,L,CHI,30,35,4,8,12
41,8475718,Justin Holl,D,DET,32,60,4,8,12
41,8482730,Brandt Clarke,D,LAK,21,49,3,9,12
41,8477365,Connor Clifton,D,BUF,29,54,3,9,12
41,8478468,Jeremy Lauzon,D,NSH,27,58,2,10,12
41,8481598,Philip Broberg,D,EDM,23,49,2,10,12
41,8481477,Nico Sturm,C,SJS,29,54,7,4,11
41,8476442,Matt Nieto,L,PIT,32,45,5,6,11
41,8480441,Trey Fix-Wolansky,R,CBJ,25,31,4,7,11
41,8480192,Johnathan Kovacevic,D,NJD,27,49,4,7,11
41,8480950,Ilya Lyubushkin,D,DAL,30,61,4,7,11
41,8476867,Brendan Gaunce,C,MIN,30,42,4,7,11
41,8482744,James Malatesta,L,CBJ,21,50,3,8,11
41,8475750,Jon Merrill,D,MIN,32,62,3,8,11
41,8481567,Henry Thrun,D,SJS,23,52,2,9,11
41,8478424,Jansen Harkins,C,ANA,27,47,2,9,11
41,8474166,Alec Martinez,D,CHI,37,48,2,9,11
41,8470600,Ryan Suter,D,STL,39,58,1,10,11
41,8474013,Ian Cole,D,UTA,35,54,1,10,11
41,8475455,Brenden Dillon,D,NJD,34,64,1,10,11
41,8479370,Tyson Jost,C,CAR,26,51,7,3,10
41,8480289,Morgan Barron,C,WPG,26,52,6,4,10
41,8481161,Jake Christiansen,D,CBJ,25,59,6,4,10
41,8481679,Maxence Guenette,D,OTT,23,40,6,4,10
41,8476873,Mark Jankowski,C,NSH,30,50,5,5,10
41,8481617,Vasily Podkolzin,R,VAN,23,46,5,5,10
41,8478502,Dennis Gilbert,D,BUF,28,23,5,5,10
41,8476889,Radek Faksa,C,STL,30,57,4,6,10
41,8482077,Dylan Holloway,L,EDM,23,46,4,6,10
41,8477851,Jordan Oesterle,D,BOS,32,36,4,6,10
41,8481592,Jakob Pelletier,L,CGY,23,38,4,6,10
41,8479378,Logan Stanley,D,WPG,26,42,3,7,10
41,8477380,Jonny Brodzinski,C,NYR,31,58,3,7,10
41,8478443,Brandon Carlo,D,BOS,28,58,3,7,10
41,8481751,Lukas Rousek,R,BUF,25,42,3,7,10
41,8480727,Zach Whitecloud,D,VGK,28,46,2,8,10
41,8482634,Alex Steeves,C,TOR,25,52,2,8,10
41,8471709,Marc-Edouard Vlasic,D,SJS,37,64,2,8,10
41,8477034,Jaycob Megna,D,FLA,32,51,1,9,10
41,8483460,David Jiricek,D,CBJ,21,56,1,9,10
41,8480796,Martin Fehervary,D,WSH,25,50,1,9,10
41,8482141,Lukas Cormier,D,VGK,22,27,1,9,10
41,8479369,Andrew Peeke,D,BOS,26,59,0,10,10
41,8480157,Calle Rosen,D,COL,30,54,0,10,10
41,8482070,Mitchell Chaffee,R,TBL,26,56,9,0,9
41,8479972,Mason Shaw,C,WPG,26,43,6,3,9
41,8477931,Tomas Nosek,L,FLA,32,57,5,4,9
41,8481609,Vladislav Kolyachonok,D,UTA,23,44,5,4,9
41,8479772,Zack MacEwen,R,OTT,28,54,5,4,9
41,8484149,Gavin Brindley,C,CBJ,20,38,4,5,9
41,8479543,Michael Pezzetta,L,MTL,26,58,4,5,9
41,8481600,Tobias Bjornfot,D,FLA,23,34,4,5,9
41,8477573,Nathan Walker,L,STL,30,46,4,5,9
41,8475690,Chris Tanev,D,TOR,35,49,3,6,9
41,8482659,Josh Doan,R,UTA,22,52,3,6,9
41,8480007,Jonas Rondbjerg,R,VGK,25,40,3,6,9
41,8479379,Givani Smith,R,SJS,26,31,3,6,9
41,8476952,Dominic Toninato,C,WPG,30,34,3,6,9
41,8483495,Simon Nemec,D,NJD,20,61,2,7,9
41,8474612,Travis Hamonic,D,OTT,34,50,2,7,9
41,8477962,Brendan Lemieux,L,CAR,28,43,2,7,9
41,8479576,Vincent Desharnais,D,VAN,28,33,2,7,9
41,8480058,Pierre-Olivier Joseph,D,STL,25,53,1,8,9
41,8473446,Erik Johnson,D,PHI,36,42,1,8,9
41,8477018,Ben Hutton,D,VGK,31,49,1,8,9
41,8476858,Phillip Di Giuseppe,L,VAN,31,41,7,1,8
41,8475225,Craig Smith,C,CHI,35,47,5,3,8
41,8483549,Lucas Condotta,L,MTL,27,30,5,3,8
41,8482713,Mackie Samoskevich,R,FLA,22,38,5,3,8
41,8481532,Alex Turcotte,C,LAK,23,41,4,4,8
41,8477335,Kyle Burroughs,D,LAK,29,48,4,4,8
41,8480245,Olle Lycksell,R,PHI,25,36,3,5,8
41,8482666,Scott Morrow,D,CAR,22,47,2,6,8
41,8476473,Connor Murphy,D,CHI,31,37,2,6,8
41,8478859,Niko Mikkola,D,FLA,28,52,1,7,8
41,8477810,Joel Hanley,D,CGY,33,32,1,7,8
41,8481056,Spencer Stastney,D,NSH,24,32,0,8,8
41,8478450,Parker Wotherspoon,D,BOS,27,33,0,8,8
41,8479981,Jonah Gadjovich,L,FLA,26,46,6,1,7
41,8479985,Cale Fleury,D,SEA,26,22,4,3,7
41,8479536,Axel Jonsson-Fjallby,L,WPG,26,34,4,3,7
41,8477462,Robert Hagg,D,VGK,29,29,4,3,7
41,8471817,Ryan Reaves,R,TOR,37,47,3,4,7
41,8481147,Reese Johnson,C,MIN,26,34,3,4,7
41,8474568,Luke Schenn,D,NSH,35,50,3,4,7
41,8480870,Bo Groulx,C,NYR,24,31,3,4,7
41,8479986,Kole Lind,R,DAL,26,56,2,5,7
41,8480879,Jacob Bernard-Docker,D,OTT,24,44,2,5,7
41,8477887,Patrick Brown,C,BOS,32,41,2,5,7
41,8480880,Jakub Lauko,C,MIN,24,31,2,5,7
41,8480834,Ty Emberson,D,SJS,24,38,2,5,7
41,8482496,Nils Aman,C,VAN,24,41,2,5,7
41,8475795,Dylan McIlrath,D,WSH,32,16,2,5,7
41,8474090,Brendan Smith,D,DAL,35,47,1,6,7
41,8476372,Nick Seeler,D,PHI,31,44,1,6,7
41,8482652,Walker Duehr,R,CGY,27,46,1,6,7
41,8483630,Pavol Regenda,L,ANA,25,32,1,6,7
41,8480196,Jacob Bryson,D,BUF,27,39,0,7,7
41,8476441,Joel Edmundson,D,LAK,31,35,0,7,7
41,8478017,Mark Friedman,D,VAN,29,34,4,2,6
41,8482145,Mavrik Bourque,C,DAL,22,40,4,2,6
41,8481754,Nikita Nesterenko,C,ANA,23,29,3,3,6
41,8481599,Victor Soderstrom,D,UTA,23,39,3,3,6
41,8482964,Arber Xhekaj,D,MTL,23,47,3,3,6
41,8481550,Adam Beckman,L,NJD,23,36,3,3,6
41,8482762,Simon Edvinsson,D,DET,21,51,3,3,6
41,8475958,Michael Sgarbossa,C,WSH,32,19,3,3,6
41,8479348,Kale Clague,D,BUF,26,36,2,4,6
41,8482747,Brennan Othmann,L,NYR,21,41,2,4,6
41,8480990,Declan Chisholm,D,MIN,24,42,2,4,6
41,8474567,Zach Bogosian,D,MIN,34,61,2,4,6
41,8477384,Joshua Brown,D,EDM,30,33,2,4,6
41,8483619,Filip Roos,D,OTT,25,28,2,4,6
41,8483763,Maksymilian Szuber,D,UTA,22,30,2,4,6
41,8477149,Scott Sabourin,R,SJS,32,15,2,4,6
41,8476913,Devin Shore,C,MIN,30,28,1,5,6
41,8479320,Maxime Lajoie,D,SEA,27,24,1,5,6
41,8484911,Collin Graf,R,SJS,22,37,1,5,6
41,8475177,Calvin de Haan,D,COL,33,36,1,5,6
41,8482470,Ilya Solovyov,D,CGY,24,18,1,5,6
41,8482516,Matthew Kessel,D,STL,24,23,1,5,6
41,8482861,Vincent Iorio,D,WSH,22,25,0,6,6
41,8478409,Anthony Richard,C,PHI,28,23,0,6,6
41,8479994,Jaret Anderson-Dolan,C,WPG,25,34,4,1,5
41,8479944,Zach Aston-Reese,C,VGK,30,50,3,2,5
41,8483570,Ben Meyers,C,SEA,26,34,3,2,5
41,8480844,Grigori Denisenko,L,VGK,24,32,3,2,5
41,8481556,John Beecher,C,BOS,23,37,3,2,5
41,8482765,Isak Rosen,R,BUF,21,30,2,3,5
41,8483397,Marc McLaughlin,C,BOS,25,36,2,3,5
41,8481605,Jackson LaCombe,D,ANA,23,33,2,3,5
41,8482511,Mason Lohrei,D,BOS,23,32,1,4,5
41,8482733,Logan Mailloux,D,MTL,31,39,1,4,5
41,8480890,Jan Jenik,C,OTT,24,31,1,4,5
41,8481541,Samuel Bolduc,D,NYI,24,30,1,4,5
41,8482162,Roby Jarventie,L,EDM,22,18,1,4,5
41,8478874,Adam Gaudette,R,OTT,28,32,0,5,5
41,8479249,Andrew Poturalski,C,SJS,30,36,0,5,5
41,8478454,Noah Juulsen,D,VAN,27,27,0,5,5
41,8480292,Carson Meyer,R,ANA,27,29,0,5,5
41,8476934,Brock McGinn,L,ANA,30,45,3,1,4
41,8483395,Arshdeep Bains,L,VAN,23,13,3,1,4
41,8483567,Georgii Merkulov,C,BOS,24,5,3,1,4
41,8480306,Grant Hutton,D,NYI,29,7,3,1,4
41,8475235,Nicolas Deslauriers,L,PHI,33,49,2,2,4
41,8482177,Marat Khusnutdinov,C,MIN,22,41,2,2,4
41,8480032,Shane Bowers,C,NJD,25,14,2,2,4
41,8480267,Sammy Walker,C,MIN,25,22,2,2,4
41,8481543,Nikita Alexandrov,C,STL,24,27,2,2,4
41,8477938,Haydn Fleury,D,WPG,28,37,1,3,4
41,8482165,Yan Kuznetsov,D,CGY,22,17,1,3,4
41,8481237,Kyle MacLean,C,NYI,25,29,1,3,4
41,8482476,Emil Heineman,L,MTL,23,11,1,3,4
41,8481719,Maxwell Crozier,D,TBL,24,16,1,3,4
41,8479991,Jake Leschyshyn,C,NYR,25,23,0,4,4
41,8484258,Sam Malinski,D,COL,26,23,0,4,4
41,8484287,Cole McWard,D,VAN,23,18,0,4,4
41,8482784,Zach Dean,C,STL,21,39,3,0,3
41,8482153,Brendan Brisson,C,VGK,23,28,2,1,3
41,8480084,Nick DeSimone,D,NJD,30,16,2,1,3
41,8482061,Brandon Biro,L,SEA,26,18,2,1,3
41,8477244,Chad Ruhwedel,D,NYR,34,26,1,2,3
41,8477467,Gustav Olofsson,D,SEA,30,16,1,2,3
41,8475755,Alexander Petrovic,D,DAL,32,9,1,2,3
41,8478146,Matthew Highmore,C,OTT,28,24,1,2,3
41,8482144,Jack Thompson,D,SJS,22,24,1,2,3
41,8479419,Brett Murray,L,BUF,26,18,1,2,3
41,8482172,Landon Slaggert,L,CHI,22,26,1,2,3
41,8478477,Mitchell Stephens,C,SEA,27,23,0,3,3
41,8477320,Anton Blidh,L,NYR,29,22,0,3,3
41,8475413,Justin Dowling,C,NJD,34,14,0,3,3
41,8482250,Callahan Burke,C,VGK,27,18,0,3,3
41,8482858,Ryker Evans,D,SEA,23,23,2,0,2
41,8482751,Ryan Winterton,C,SEA,21,32,2,0,2
41,8478881,Brett Seney,L,CHI,28,8,2,0,2
41,8479367,William Lockwood,R,FLA,26,30,2,0,2
41,8483489,Fraser Minten,C,TOR,31,13,2,0,2
41,8479362,Riley Tufte,L,BOS,26,19,2,0,2
41,8482126,Emil Andrae,D,PHI,31,5,2,0,2
41,8480468,James Hamblin,L,EDM,25,16,1,1,2
41,8482929,Emil Lilleberg,D,TBL,23,17,1,1,2
41,8477527,Ross Johnston,L,ANA,30,35,1,1,2
41,8482147,Jean-Luc Foudy,C,COL,22,24,1,1,2
41,8481422,Jake Lucchini,C,NSH,29,27,1,1,2
41,8477473,Justin Bailey,R,SJS,29,20,1,1,2
41,8478446,Glenn Gawdin,C,LAK,27,13,1,1,2
41,8484326,Patrik Koch,D,UTA,28,3,1,1,2
41,8477073,Kurtis MacDermid,L,NJD,30,33,0,2,2
41,8477401,John Hayden,C,SEA,29,33,0,2,2
41,8481043,Cole Koepke,L,BOS,26,20,0,2,2
41,8481743,Marc Del Gaizo,D,NSH,25,16,0,2,2
41,8474062,Riley Nash,C,NYR,35,22,0,2,2
41,8482094,Daemon Hunt,D,MIN,22,12,0,2,2
41,8478021,William Lagesson,D,DET,28,24,0,2,2
41,8482201,Gage Goncalves,C,TBL,23,20,0,2,2
41,8481006,Tyler Tucker,D,STL,24,13,0,2,2
41,8480851,Akil Thomas,C,LAK,24,16,1,0,1
41,8481585,Egor Afanasyev,L,SJS,23,9,1,0,1
41,8481024,Linus Karlsson,C,VAN,25,6,1,0,1
41,8482118,Sam Colangelo,R,ANA,23,15,1,0,1
41,8480075,Cameron Crotty,D,MIN,25,9,1,0,1
41,8483597,Milos Kelemen,L,UTA,25,12,1,0,1
41,8484304,Uvis Balinskis,D,FLA,28,7,1,0,1
41,8484259,Ondrej Pavel,C,COL,31,3,1,0,1
41,8475780,Chris Wagner,R,COL,33,8,1,0,1
41,8481122,Simon Benoit,D,TOR,26,43,0,1,1
41,8483512,Matthew Savoie,C,EDM,20,22,0,1,1
41,8481564,Ryan Johnson,D,BUF,23,15,0,1,1
41,8481030,Jack St. Ivany,D,PIT,25,5,0,1,1
41,8477971,Andreas Englund,D,LAK,28,29,0,1,1
41,8480823,Alexander Alexeyev,D,WSH,25,13,0,1,1
41,8477541,Dakota Mermis,D,TOR,30,5,0,1,1
41,8478051,Max Willman,C,NJD,29,22,0,1,1
41,8483471,Brad Lambert,C,WPG,31,10,0,1,1
41,8484325,Waltteri Merela,C,TBL,26,20,0,1,1
41,8482787,Nikita Chibrikov,R,WPG,31,4,0,1,1
41,8483920,Pierrick Dube,R,WSH,23,4,0,1,1
41,8484321,Nikolas Matinpalo,D,OTT,26,4,0,1,1
41,8483012,Logan Morrison,C,SEA,22,28,0,0,0
41,8478011,Louie Belpedio,D,PHI,28,12,0,0,0
41,8483609,Adam Klapka,R,CGY,24,1,0,0,0
41,8479587,Rhett Gardner,C,PHI,28,22,0,0,0
41,8482088,Justin Sourdif,R,FLA,22,15,0,0,0
41,8479522,Hardy Haman Aktell,D,WSH,26,7,0,0,0
41,8481593,Jayden Struble,D,MTL,23,14,0,0,0
41,8481806,Louis Crevier,D,CHI,23,12,0,0,0
41,8482102,Vasily Ponomarev,C,PIT,22,21,0,0,0
41,8483432,Luca Del Bel Belluz,C,CBJ,31,7,0,0,0
41,8481065,Angus Crookshank,L,OTT,25,16,0,0,0
41,8481462,Mason Morelli,L,VGK,28,12,0,0,0
41,8484255,Jason Polin,R,COL,25,6,0,0,0
41,8483398,Declan Carlile,D,TBL,31,7,0,0,0
41,8480874,Adam Ginning,D,PHI,24,9,0,0,0
41,8481206,John Ludvig,D,PIT,24,10,0,0,0
41,8478854,Ryan Shea,D,PIT,27,8,0,0,0
41,8481578,Graeme Clarke,R,MIN,23,9,0,0,0
41,8481699,Aku Raty,R,UTA,23,10,0,0,0
41,8483407,Brandon Scanlin,D,NYR,25,5,0,0,0
41,8481726,Adam Edstrom,C,NYR,24,6,0,0,0
41,8482460,Matt Rempe,C,NYR,22,9,0,0,0
41,8482197,Adam Raska,R,MIN,23,5,0,0,0
41,8483546,Marshall Rifai,D,TOR,26,6,0,0,0
41,8479421,Jacob Moverare,D,LAK,26,4,0,0,0
41,8481655,Cole Schwindt,R,CGY,23,1,0,0,0
41,8479330,Brandon Gignac,C,MTL,27,8,0,0,0
41,8483401,Marc Johnstone,R,PIT,28,1,0,0,0
41,8478147,Bokondji Imama,L,PIT,28,5,0,0,0
41,8483531,Brian Halonen,L,NJD,25,1,0,0,0
41,8481534,Raphael Lavoie,C,EDM,24,4,0,0,0
41,8477993,Justin Kirkland,C,CGY,28,2,0,0,0
41,8476323,Max McCormick,L,SEA,32,4,0,0,0
41,8483045,Cameron Butler,R,CBJ,31,0,0,0,0
41,8478956,Samuel Laberge,L,NJD,27,1,0,0,0
41,8480274,Philip Kemp,D,EDM,25,1,0,0,0
41,8470794,Joe Pavelski,C,,40,0,0,0,0
41,8479321,Lucas Johansen,D,,27,0,0,0,0
41,8477950,Tony DeAngelo,D,,29,0,0,0,0
41,8471218,Blake Wheeler,R,,38,0,0,0,0
41,8475197,Tyson Barrie,D,,33,0,0,0,0
41,8474157,Max Pacioretty,L,,36,0,0,0,0
41,8475744,Evgeny Kuznetsov,C,,32,0,0,0,0
41,8474037,James van Riemsdyk,L,,35,0,0,0,0
41,8476907,Mackenzie MacEachern,L,,30,0,0,0,0
41,8480216,Jacob Peterson,C,,25,0,0,0,0
41,8474602,Justin Schultz,D,,34,0,0,0,0
41,8482222,Alexander Barabanov,L,,30,0,0,0,0
41,8474031,Kevin Shattenkirk,D,,35,0,0,0,0
41,8477330,Dominik Kubalik,L,,29,0,0,0,0
41,8480884,Calen Addison,D,,24,0,0,0,0
41,8475906,John Klingberg,D,,32,0,0,0,0
41,8480008,Adam Ruzicka,C,,25,0,0,0,0
41,8476884,Derrick Pouliot,D,,30,0,0,0,0
41,8476919,Chris Tierney,C,,30,0,0,0,0
41,8479415,Michael McLeod,C,,26,0,0,0,0
41,8474870,Tyler Johnson,C,,34,0,0,0,0
41,8470604,Jeff Carter,C,,39,0,0,0,0
41,8478104,Sammy Blais,L,,28,0,0,0,0
41,8474884,Mike Hoffman,C,,35,0,0,0,0
41,8481591,Sam Poulin,R,,23,0,0,0,0
41,8471274,Alex Goligoski,D,,39,0,0,0,0
41,8476871,Tanner Pearson,L,,32,0,0,0,0
41,8476393,Nick Cousins,C,,31,0,0,0,0
41,8479977,Kailer Yamamoto,R,,26,0,0,0,0
41,8479346,Dillon Dube,C,,26,0,0,0,0
41,8480184,Gustav Lindstrom,D,,26,0,0,0,0
41,8479376,Victor Mete,D,,26,0,0,0,0
41,8473449,Kyle Okposo,R,,36,0,0,0,0
41,8481058,Jesse Ylonen,R,,25,0,0,0,0
41,8475752,Tyler Pitlick,C,,33,0,0,0,0
41,8481239,Samuel Fagemo,L,,24,0,0,0,0
41,8480821,Filip Zadina,R,,25,0,0,0,0
41,8470966,Mark Giordano,D,,41,0,0,0,0
41,8478495,Denis Gurianov,R,,27,0,0,0,0
41,8477464,Nic Petan,C,,29,0,0,0,0
41,8478099,Kevin Labanc,R,,29,0,0,0,0
41,8482241,Radim Zohorna,L,,28,0,0,0,0
41,8474040,Sam Gagner,C,,35,0,0,0,0
41,8479514,Rem Pitlick,C,,27,0,0,0,0
41,8478430,Oliver Kylington,D,,27,0,0,0,0
41,8479533,Joona Koppanen,L,,26,0,0,0,0
41,8479984,Cal Foote,D,,26,0,0,0,0
41,8477126,Jayson Megna,C,,34,0,0,0,0
41,8475164,Jakob Silfverberg,R,,34,0,0,0,0
41,8474009,Nick Bonino,C,,36,0,0,0,0
41,8479458,Nikita Zaitsev,D,,33,0,0,0,0
41,8477944,Jakub Vrana,L,,28,0,0,0,0
41,8471699,Andrew Cogliano,C,,37,0,0,0,0
41,8478067,Oskar Lindblom,L,,28,0,0,0,0
41,8471686,Marc Staal,D,,37,0,0,0,0
41,8470610,Zach Parise,L,,40,0,0,0,0
41,8478904,Steven Lorentz,C,,28,0,0,0,0
41,8473473,Milan Lucic,L,,36,0,0,0,0
41,8480031,Maxime Comtois,L,,25,0,0,0,0
41,8478512,Austin Czarnik,C,,32,0,0,0,0
41,8473504,Cal Clutterbuck,R,,37,0,0,0,0
41,8477454,Adam Erne,L,,29,0,0,0,0
41,8479383,Boris Katchouk,L,,26,0,0,0,0
41,8475825,Jani Hakanpää,D,,32,0,0,0,0
41,8477846,Ryan Carpenter,C,,33,0,0,0,0
41,8477930,Pierre-Edouard Bellemare,L,,39,0,0,0,0
41,8478400,Colin White,C,,27,0,0,0,0
41,8480226,Marián Studenic,R,,26,0,0,0,0
41,8480853,Liam Foudy,C,,24,0,0,0,0
41,8475797,Jarred Tinordi,D,,32,0,0,0,0
41,8479423,Alex Nylander,L,,26,0,0,0,0
41,8474618,Marco Scandella,D,,34,0,0,0,0
41,8478028,Fredrik Olofsson,L,,28,0,0,0,0
41,8474709,Matt Martin,L,,35,0,0,0,0
41,8481070,Hugh McGing,L,,26,0,0,0,0
41,8479546,Oskar Steen,C,,26,0,0,0,0
41,8474145,Robert Bortuzzo,D,,35,0,0,0,0
41,8476915,Jujhar Khaira,L,,30,0,0,0,0
41,8475278,Byron Froese,C,,33,0,0,0,0
41,8481812,Nikolai Knyzhov,D,,27,0,0,0,0
41,8478408,Travis Dermott,D,,28,0,0,0,0
41,8481077,John Leonard,L,,26,0,0,0,0
41,8479547,Matthew Phillips,R,,26,0,0,0,0
41,8480836,Jonathan Gruden,C,,24,0,0,0,0
41,8481690,Tyler Angle,C,,24,0,0,0,0
41,8475766,Austin Watson,L,,32,0,0,0,0
41,8481016,Ruslan Iskhakov,C,,24,0,0,0,0
41,8478078,Rourke Chartier,C,,28,0,0,0,0
41,8480776,Sheldon Rempal,R,,29,0,0,0,0
41,8484314,Jiri Smejkal,L,,28,0,0,0,0
42,8476453,Nikita Kucherov,R,TBL,31,82,39,93,132
42,8478402,Connor McDavid,C,EDM,27,77,37,95,132
42,8477492,Nathan MacKinnon,C,COL,29,80,51,75,126
42,8477956,David Pastrnak,R,BOS,28,80,54,70,124
42,8479318,Auston Matthews,C,TOR,27,81,59,56,115
42,8478483,Mitch Marner,R,TOR,27,82,39,71,110
42,8481559,Jack Hughes,C,NJD,23,75,38,71,109
42,8479343,Clayton Keller,R,UTA,26,78,35,63,98
42,8476468,J.T. Miller,C,VAN,31,74,30,68,98
42,8479314,Matthew Tkachuk,L,FLA,27,78,29,69,98
42,8477934,Leon Draisaitl,C,EDM,29,75,34,62,96
42,8478445,Mathew Barzal,C,NYI,27,78,18,78,96
42,8479337,Alex DeBrincat,R,DET,27,79,41,54,95
42,8478420,Mikko Rantanen,R,COL,28,81,38,56,94
42,8480027,Jason Robertson,L,DAL,25,81,36,57,93
42,8477942,Kevin Fiala,L,LAK,28,80,23,69,92
42,8478864,Kirill Kaprizov,L,MIN,27,76,48,43,91
42,8478427,Sebastian Aho,C,CAR,27,70,42,49,91
42,8473419,Brad Marchand,L,BOS,36,81,33,58,91
42,8477409,Carter Verhaeghe,C,FLA,29,76,45,45,90
42,8476887,Filip Forsberg,L,NSH,30,77,41,49,90
42,8478010,Brayden Point,C,TBL,28,81,44,45,89
42,8477946,Dylan Larkin,C,DET,28,81,42,46,88
42,8477960,Adrian Kempe,R,LAK,28,81,36,52,88
42,8477404,Jake Guentzel,C,TBL,30,82,36,51,87
42,8477939,William Nylander,R,TOR,28,78,44,41,85
42,8471675,Sidney Crosby,C,PIT,37,73,32,53,85
42,8479407,Jesper Bratt,L,NJD,26,73,29,56,85
42,8477951,Nick Schmaltz,C,UTA,28,78,28,57,85
42,8476454,Ryan Nugent-Hopkins,C,EDM,31,79,27,58,85
42,8476456,Jonathan Huberdeau,C,CGY,31,80,20,62,82
42,8480002,Nico Hischier,C,NJD,25,76,39,42,81
42,8480069,Cale Makar,D,COL,26,71,19,62,81
42,8478398,Kyle Connor,L,WPG,28,80,40,40,80
42,8478403,Jack Eichel,C,VGK,28,78,39,41,80
42,8477402,Pavel Buchnevich,L,STL,29,72,39,40,79
42,8484144,Connor Bedard,C,CHI,19,73,29,50,79
42,8478439,Travis Konecny,R,PHI,27,74,27,50,77
42,8478550,Artemi Panarin,L,NYR,33,74,25,52,77
42,8477933,Sam Reinhart,C,FLA,29,74,41,35,76
42,8480801,Brady Tkachuk,L,OTT,25,80,36,40,76
42,8471214,Alex Ovechkin,L,WSH,39,76,33,43,76
42,8478873,Troy Terry,R,ANA,27,78,31,45,76
42,8479385,Jordan Kyrou,C,STL,26,73,29,47,76
42,8480018,Nick Suzuki,C,MTL,25,77,27,49,76
42,8479420,Tage Thompson,C,BUF,27,74,38,36,74
42,8480036,Miro Heiskanen,D,DAL,25,78,11,63,74
42,8475172,Nazem Kadri,C,CGY,34,79,27,46,73
42,8480023,Robert Thomas,C,STL,25,74,23,50,73
42,8478449,Roope Hintz,C,DAL,28,82,42,30,72
42,8476881,Tomas Hertl,C,VGK,31,79,30,42,72
42,8474141,Patrick Kane,R,DET,36,78,24,48,72
42,8479323,Adam Fox,D,NYR,26,77,15,57,72
42,8475166,John Tavares,C,TOR,34,79,32,39,71
42,8480839,Rasmus Dahlin,D,BUF,24,73,17,54,71
42,8479542,Brandon Hagel,L,TBL,26,82,39,31,70
42,8477955,Jared McCann,L,SEA,28,75,31,39,70
42,8477940,Nikolaj Ehlers,L,WPG,28,74,29,40,69
42,8475798,Mikael Granlund,C,SJS,32,74,22,47,69
42,8477500,Bo Horvat,C,NYI,29,80,37,31,68
42,8480012,Elias Pettersson,C,VAN,26,69,30,38,68
42,8481557,Matt Boldy,L,MIN,23,73,30,38,68
42,8478460,Zach Werenski,D,CBJ,27,82,12,56,68
42,8480015,Owen Tippett,R,PHI,25,74,34,33,67
42,8471685,Anze Kopitar,C,LAK,37,80,20,47,67
42,8477949,Alex Tuch,R,BUF,28,72,18,49,67
42,8480800,Quinn Hughes,D,VAN,25,72,13,54,67
42,8482740,Wyatt Johnston,C,DAL,21,81,35,31,66
42,8474564,Steven Stamkos,C,NSH,34,72,31,35,66
42,8477496,Elias Lindholm,C,BOS,30,80,22,44,66
42,8477493,Aleksander Barkov,C,FLA,29,79,16,50,66
42,8471215,Evgeni Malkin,C,PIT,38,71,39,26,65
42,8476460,Mark Scheifele,C,WPG,31,69,25,40,65
42,8475692,Mats Zuccarello,R,MIN,37,72,15,50,65
42,8480830,Andrei Svechnikov,R,CAR,24,61,35,29,64
42,8482699,Dylan Guenther,R,UTA,21,77,26,38,64
42,8478440,Dylan Strome,C,WSH,27,73,21,43,64
42,8479999,Casey Mittelstadt,C,COL,26,81,19,45,64
42,8482078,Lucas Raymond,L,DET,22,81,32,31,63
42,8480208,Drake Batherson,R,OTT,26,81,27,36,63
42,8482124,Quinton Byfield,R,LAK,22,80,23,40,63
42,8474578,Erik Karlsson,D,PIT,34,80,16,47,63
42,8478407,Vince Dunn,D,SEA,28,70,16,47,63
42,8480803,Evan Bouchard,D,EDM,25,74,14,49,63
42,8477476,Artturi Lehkonen,L,COL,29,79,36,26,62
42,8477501,Valeri Nichushkin,R,COL,29,80,34,28,62
42,8475786,Zach Hyman,L,EDM,32,76,33,29,62
42,8478366,Frank Vatrano,R,ANA,30,74,32,30,62
42,8478493,Joel Eriksson Ek,C,MIN,27,73,32,30,62
42,8481540,Cole Caufield,R,MTL,23,76,31,31,62
42,8481528,Dylan Cozens,C,BUF,23,77,25,37,62
42,8480028,Morgan Frost,C,PHI,25,80,24,38,62
42,8478401,Pavel Zacha,C,BOS,27,80,13,49,62
42,8475726,Tyler Toffoli,C,SJS,32,70,35,26,61
42,8479675,Trevor Moore,L,LAK,29,80,33,28,61
42,8475754,Brock Nelson,C,NYI,33,80,31,30,61
42,8482665,Matty Beniers,C,SEA,22,78,30,31,61
42,8477416,Oliver Bjorkstrand,R,SEA,29,77,23,38,61
42,8474679,Gustav Nyquist,C,NSH,35,70,14,47,61
42,8475151,Kyle Palmieri,C,NYI,33,77,31,29,60
42,8482116,Tim Stützle,C,OTT,22,78,29,31,60
42,8476459,Mika Zibanejad,C,NYR,31,77,20,40,60
42,8477935,Sam Bennett,C,FLA,28,79,30,29,59
42,8478462,Nicolas Roy,C,VGK,27,79,25,34,59
42,8477503,Max Domi,C,TOR,29,79,17,42,59
42,8475170,Brayden Schenn,C,STL,33,77,28,30,58
42,8475168,Matt Duchene,C,DAL,33,82,19,39,58
42,8473512,Claude Giroux,R,OTT,36,78,19,39,58
42,8481533,Trevor Zegras,C,ANA,23,74,18,40,58
42,8476905,Chandler Stephenson,C,SEA,30,71,16,42,58
42,8475913,Mark Stone,R,VGK,32,78,13,45,58
42,8476875,Mike Matheson,D,MTL,30,77,10,48,58
42,8475167,Victor Hedman,D,TBL,34,81,9,49,58
42,8479525,Ross Colton,C,COL,28,81,30,27,57
42,8474586,Jordan Eberle,R,SEA,34,73,24,33,57
42,8475765,Vladimir Tarasenko,R,DET,33,81,23,34,57
42,8477456,J.T. Compher,L,DET,29,81,23,34,57
42,8473994,Jamie Benn,L,DAL,35,81,20,37,57
42,8477494,Jonathan Drouin,L,COL,29,82,18,39,57
42,8477504,Josh Morrissey,D,WPG,29,76,10,47,57
42,8482684,Luke Hughes,D,NJD,21,70,9,48,57
42,8480014,Gabriel Vilardi,C,WPG,25,67,35,21,56
42,8475810,Bryan Rust,R,PIT,32,68,26,30,56
42,8476389,Vincent Trocheck,C,NYR,31,78,25,31,56
42,8474600,Roman Josi,D,NSH,34,67,14,42,56
42,8478414,Timo Meier,R,NJD,28,76,23,32,55
42,8478444,Brock Boeser,R,VAN,27,71,21,34,55
42,8478047,Michael Bunting,L,PIT,29,73,21,34,55
42,8482720,Matthew Knies,L,TOR,22,78,20,35,55
42,8476479,Phillip Danault,C,LAK,31,79,19,36,55
42,8484153,Leo Carlsson,C,ANA,20,70,28,26,54
42,8482745,Mason McTavish,C,ANA,21,72,28,26,54
42,8476399,Blake Coleman,C,CGY,33,79,26,28,54
42,8482093,Seth Jarvis,C,CAR,22,68,22,32,54
42,8476462,Dougie Hamilton,D,NJD,31,71,20,34,54
42,8477986,Brandon Montour,D,SEA,30,75,20,34,54
42,8476792,Torey Krug,D,STL,33,70,18,36,54
42,8476346,Johnny Gaudreau,L,CBJ,31,69,16,38,54
42,8482109,Alexis Lafrenière,L,NYR,23,77,27,26,53
42,8476539,Jonathan Marchessault,R,NSH,34,74,27,26,53
42,8478519,Anthony Cirelli,C,TBL,27,82,22,31,53
42,8481542,Moritz Seider,D,DET,23,76,9,44,53
42,8471724,Kris Letang,D,PIT,37,80,7,46,53
42,8475784,Jeff Skinner,C,EDM,32,74,29,23,52
42,8481186,Logan O'Connor,R,COL,28,79,21,31,52
42,8482113,Anton Lundell,C,FLA,23,72,17,35,52
42,8478438,Tommy Novak,C,NSH,27,71,16,36,52
42,8480865,Noah Dobson,D,NYI,24,79,8,44,52
42,8475158,Ryan O'Reilly,C,NSH,33,71,24,27,51
42,8476882,Teuvo Teravainen,C,CHI,30,64,23,28,51
42,8478856,Conor Garland,R,VAN,28,72,21,30,51
42,8474102,David Perron,L,OTT,36,80,13,38,51
42,8474563,Drew Doughty,D,LAK,35,75,12,39,51
42,8478055,Gustav Forsling,D,FLA,28,73,10,41,51
42,8476853,Morgan Rielly,D,TOR,30,67,5,46,51
42,8475184,Chris Kreider,L,NYR,33,75,32,18,50
42,8478498,Jake DeBrusk,L,VAN,28,75,28,22,50
42,8478115,Pierre Engvall,L,NYI,28,78,23,27,50
42,8480188,Fabian Zetterlund,L,SJS,25,64,20,30,50
42,8481711,Matias Maccelli,L,UTA,24,77,16,34,50
42,8477451,Ryan Hartman,R,MIN,30,65,15,35,50
42,8483515,Juraj Slafkovsky,L,MTL,20,75,13,37,50
42,8476483,Rickard Rakell,R,PIT,31,67,27,22,49
42,8477021,Alex Kerfoot,C,UTA,30,77,17,32,49
42,8478397,Rasmus Andersson,D,CGY,28,76,11,38,49
42,8478474,Lawson Crouse,L,UTA,27,71,29,19,48
42,8482475,Yegor Chinakhov,R,CBJ,23,64,25,23,48
42,8476448,William Karlsson,C,VGK,31,76,23,25,48
42,8481596,Shane Pinto,C,OTT,24,75,16,32,48
42,8477479,Tyler Bertuzzi,L,CHI,29,60,16,32,48
42,8476869,Brady Skjei,D,NSH,30,71,16,32,48
42,8477447,Shea Theodore,D,VGK,29,54,9,39,48
42,8476958,Jaccob Slavin,D,CAR,30,73,6,42,48
42,8476432,Boone Jenner,C,CBJ,31,72,22,25,47
42,8478975,Mason Marchment,L,DAL,29,82,20,27,47
42,8473986,Alex Killorn,L,ANA,35,74,17,30,47
42,8479325,Charlie McAvoy,D,BOS,27,74,11,36,47
42,8474590,John Carlson,D,WSH,34,68,8,39,47
42,8484166,Adam Fantilli,C,CBJ,20,66,25,21,46
42,8480039,Martin Necas,C,CAR,25,71,20,26,46
42,8484145,Zach Benson,L,BUF,19,68,18,28,46
42,8474150,Mikael Backlund,C,CGY,35,78,15,31,46
42,8482149,Cole Perfetti,C,WPG,22,65,14,32,46
42,8478038,Devon Toews,D,COL,30,72,11,35,46
42,8477495,Seth Jones,D,CHI,30,61,9,37,46
42,8477511,Anthony Mantha,R,CGY,30,78,21,24,45
42,8481618,Alex Newhook,C,MTL,23,79,21,24,45
42,8475745,Charlie Coyle,C,BOS,32,77,20,25,45
42,8479992,Michael Rasmussen,C,DET,25,80,18,27,45
42,8478233,Andrew Mangiapane,L,WSH,28,74,16,29,45
42,8478469,Thomas Chabot,D,OTT,27,70,11,34,45
42,8481703,Valtteri Puustinen,R,PIT,25,65,7,38,45
42,8482110,Dawson Mercer,C,NJD,23,74,29,15,44
42,8481068,Yegor Sharangovich,C,CGY,26,79,21,23,44
42,8477932,Aaron Ekblad,D,FLA,28,72,12,32,44
42,8470613,Brent Burns,D,CAR,39,77,8,36,44
42,8476880,Tom Wilson,R,WSH,30,72,24,19,43
42,8482159,Tyson Foerster,R,PHI,22,75,24,19,43
42,8475722,Jason Zucker,L,BUF,32,74,23,20,43
42,8480797,Joel Farabee,L,PHI,24,73,22,21,43
42,8474641,Adam Henrique,C,EDM,34,76,20,23,43
42,8479400,Pierre-Luc Dubois,L,WSH,26,66,18,25,43
42,8477429,Andrew Copp,C,DET,30,81,17,26,43
42,8480829,Jesperi Kotkaniemi,C,CAR,24,70,17,26,43
42,8478542,Evan Rodrigues,C,FLA,31,73,15,28,43
42,8477497,Sean Monahan,C,CBJ,30,71,14,29,43
42,8482667,William Eklund,L,SJS,22,69,14,29,43
42,8476906,Shayne Gostisbehere,D,CAR,31,76,11,32,43
42,8475794,Tyler Seguin,C,DAL,32,81,23,19,42
42,8481560,Arthur Kaliyev,R,LAK,23,77,23,19,42
42,8482097,Jack Quinn,R,BUF,23,68,19,23,42
42,8478396,Noah Hanifin,D,VGK,27,61,14,28,42
42,8478057,Dakota Joshua,C,VAN,28,70,12,30,42
42,8482712,Oskar Olausson,R,COL,22,80,7,35,42
42,8483505,Matthew Poitras,C,BOS,20,74,17,24,41
42,8476419,Jean-Gabriel Pageau,C,NYI,32,77,13,28,41
42,8479345,Jakob Chychrun,D,WSH,26,67,12,29,41
42,8480798,Philipp Kurashev,C,CHI,25,63,12,29,41
42,8480336,Sean Walker,D,CAR,30,75,11,30,41
42,8479410,Mikhail Sergachev,D,UTA,26,68,10,31,41
42,8470621,Corey Perry,R,EDM,39,70,24,16,40
42,8477426,Nicholas Paul,L,TBL,29,82,21,19,40
42,8483808,Andrei Kuzmenko,L,CGY,28,78,20,20,40
42,8480220,Noah Cates,L,PHI,25,69,15,25,40
42,8477839,Conor Sheary,L,TBL,32,81,12,28,40
42,8483490,Pavel Mintyukov,D,ANA,21,66,11,29,40
42,8479425,Filip Hronek,D,VAN,27,75,9,31,40
42,8475169,Evander Kane,L,EDM,33,77,21,18,39
42,8476872,Scott Laughton,C,PHI,30,68,19,20,39
42,8479365,Trent Frederic,C,BOS,26,71,15,24,39
42,8482705,Cole Sillinger,C,CBJ,21,66,15,24,39
42,8476480,Vladislav Namestnikov,C,WPG,32,63,10,29,39
42,8474565,Alex Pietrangelo,D,VGK,34,69,9,30,39
42,8476923,Damon Severson,D,CBJ,30,79,7,32,39
42,8475314,Anders Lee,L,NYI,34,78,21,17,38
42,8480802,Ryan McLeod,C,BUF,25,65,17,21,38
42,8478891,Mason Appleton,C,WPG,28,74,15,23,38
42,8475768,Jaden Schwartz,C,SEA,32,70,11,27,38
42,8475848,Brendan Gallagher,R,MTL,32,72,10,28,38
42,8476392,Adam Lowry,C,WPG,31,63,9,29,38
42,8474149,Evgenii Dadonov,R,DAL,35,80,18,19,37
42,8482055,Drew O'Connor,L,PIT,26,71,18,19,37
42,8477407,Anthony Duclair,L,NYI,29,81,17,20,37
42,8480064,Josh Norris,C,OTT,25,74,16,21,37
42,8475287,Erik Haula,L,NJD,33,67,13,24,37
42,8477444,Andre Burakovsky,L,SEA,29,69,11,26,37
42,8477346,MacKenzie Weegar,D,CGY,30,71,10,27,37
42,8480145,Neal Pionk,D,WPG,29,74,8,29,37
42,8477998,Warren Foegele,L,LAK,28,79,21,15,36
42,8479987,Morgan Geekie,C,BOS,26,75,21,15,36
42,8481535,Nils Hoglander,L,VAN,24,70,19,17,36
42,8479591,Michael Eyssimont,C,TBL,28,82,17,19,36
42,8473533,Jordan Staal,C,CAR,36,61,14,22,36
42,8478472,Mathieu Joseph,R,STL,27,73,12,24,36
42,8475191,Reilly Smith,R,NYR,33,71,11,25,36
42,8482105,Jake Sanderson,D,OTT,22,75,11,25,36
42,8475753,Justin Faulk,D,STL,32,74,10,26,36
42,8481581,Thomas Harley,D,DAL,23,75,7,29,36
42,8480009,Eeli Tolvanen,R,SEA,25,70,18,17,35
42,8471698,T.J. Oshie,R,WSH,38,66,17,18,35
42,8482702,Logan Stankoven,C,DAL,21,82,15,20,35
42,8478466,Daniel Sprong,R,VAN,27,70,14,21,35
42,8480185,Eetu Luostarinen,C,FLA,26,70,12,23,35
42,8481523,Kirby Dach,C,MTL,23,64,11,24,35
42,8480434,Sean Durzi,D,UTA,26,71,10,25,35
42,8481656,Aliaksei Protas,C,WSH,23,62,10,25,35
42,8482089,Jake Neighbours,L,STL,22,65,19,15,34
42,8475793,Ryan Johansen,C,PHI,32,74,15,19,34
42,8478463,Anthony Beauvillier,L,PIT,27,59,15,19,34
42,8480835,Jack Drury,C,CAR,24,61,14,20,34
42,8477952,Robby Fabbri,C,ANA,28,71,11,23,34
42,8475218,Mattias Ekholm,D,EDM,34,73,9,25,34
42,8477969,Marcus Pettersson,D,PIT,28,79,5,29,34
42,8473507,Jeff Petry,D,DET,37,73,4,30,34
42,8476917,Adam Pelech,D,NYI,30,74,1,33,34
42,8482092,Ridly Greig,C,OTT,22,74,21,12,33
42,8478046,Danton Heinen,L,VAN,29,68,19,14,33
42,8477987,Ryan Donato,C,CHI,28,62,18,15,33
42,8483431,Logan Cooley,C,UTA,20,72,15,18,33
42,8477964,Ivan Barbashev,C,VGK,29,79,13,20,33
42,8476458,Ryan Strome,C,ANA,31,68,11,22,33
42,8475149,Marcus Johansson,L,MIN,34,68,11,22,33
42,8476927,Teddy Blueger,C,VAN,30,71,8,25,33
42,8480849,Barrett Hayton,C,UTA,24,71,20,12,32
42,8476897,Oskar Sundqvist,C,STL,30,69,16,16,32
42,8480068,Ryan Poehling,C,PHI,25,68,15,17,32
42,8478013,Jake Walman,D,SJS,28,69,14,18,32
42,8476826,Yanni Gourde,C,SEA,33,71,13,19,32
42,8476921,Jordan Martinook,L,CAR,32,64,13,19,32
42,8483445,Cutter Gauthier,L,ANA,20,58,13,19,32
42,8481524,Bowen Byram,D,BUF,23,65,9,23,32
42,8481093,Rafael Harvey-Pinard,L,MTL,25,61,17,14,31
42,8475760,Nick Bjugstad,C,UTA,32,67,14,17,31
42,8475799,Nino Niederreiter,R,WPG,32,69,14,17,31
42,8475763,Kevin Hayes,R,PIT,32,73,11,20,31
42,8476461,Sean Couturier,C,PHI,32,69,11,20,31
42,8479339,Patrik Laine,L,CBJ,26,65,10,21,31
42,8475200,Dmitry Orlov,D,CAR,33,75,9,22,31
42,8477498,Darnell Nurse,D,EDM,29,68,7,24,31
42,8481577,Philip Tomasino,C,NSH,23,61,7,24,31
42,8482655,Janis Moser,D,TBL,24,78,5,26,31
42,8475764,Cam Fowler,D,ANA,33,68,1,30,31
42,8480813,Joe Veleno,C,DET,24,76,11,19,30
42,8478042,Viktor Arvidsson,L,EDM,31,68,10,20,30
42,8477948,Travis Sanheim,D,PHI,28,71,8,22,30
42,8482117,Lukas Reichel,L,CHI,22,64,7,23,30
42,8474151,Ryan McDonagh,D,TBL,35,79,5,25,30
42,8475181,Nick Leddy,D,STL,33,73,4,26,30
42,8476892,Colton Parayko,D,STL,31,67,3,27,30
42,8474715,Cameron Atkinson,R,TBL,35,81,16,13,29
42,8479996,Cody Glass,C,NSH,25,60,14,15,29
42,8484203,Bradly Nadeau,L,CAR,19,69,10,19,29
42,8476925,Colton Sissons,C,NSH,31,66,10,19,29
42,8478458,John (Jack) Roslovic,C,CAR,27,66,9,20,29
42,8473422,Nick Foligno,L,CHI,37,61,9,20,29
42,8477919,Frederick Gaudreau,C,MIN,31,57,9,20,29
42,8482133,Thomas Bordeleau,C,SJS,22,57,8,21,29
42,8481546,Cam York,D,PHI,23,74,7,22,29
42,8476463,Jonas Brodin,D,MIN,31,80,6,23,29
42,8481606,Jordan Spence,D,LAK,23,66,6,23,29
42,8479398,Samuel Girard,D,COL,26,66,5,24,29
42,8475343,Nic Dowd,C,WSH,34,62,17,11,28
42,8480078,Filip Chytil,C,NYR,25,75,16,12,28
42,8480893,Kirill Marchenko,R,CBJ,24,60,16,12,28
42,8482660,Kent Johnson,C,CBJ,22,58,11,17,28
42,8483468,Jiri Kulich,C,BUF,20,60,11,17,28
42,8481481,Blake Lizotte,C,PIT,27,65,9,19,28
42,8479351,Sam Steel,C,DAL,26,79,8,20,28
42,8480855,Jack McBain,C,UTA,24,71,7,21,28
42,8477488,Brett Pesce,D,NJD,30,71,6,22,28
42,8482624,Daniil Miromanov,D,CGY,27,66,5,23,28
42,8476854,Hampus Lindholm,D,BOS,30,74,5,23,28
42,8475791,Taylor Hall,L,CHI,33,49,4,24,28
42,8477506,Ryan Pulock,D,NYI,30,79,4,24,28
42,8476902,Esa Lindell,D,DAL,30,79,3,25,28
42,8482175,JJ Peterka,R,BUF,22,63,15,12,27
42,8477478,William Carrier,L,CAR,30,52,14,13,27
42,8481582,Nicholas Robertson,L,TOR,23,63,13,14,27
42,8475220,Marcus Foligno,L,MIN,33,55,13,14,27
42,8481604,Pavel Dorofeyev,L,VGK,24,65,12,15,27
42,8476474,Stefan Noesen,R,NJD,31,66,10,17,27
42,8482074,Connor Zary,C,CGY,23,64,10,17,27
42,8476292,Ondrej Palat,L,NJD,33,69,8,19,27
42,8482671,Owen Power,D,BUF,22,66,8,19,27
42,8478507,John Marino,D,UTA,27,63,4,23,27
42,8480459,Pius Suter,C,VAN,28,63,15,11,26
42,8479293,Brandon Tanev,L,SEA,33,63,14,12,26
42,8474053,Logan Couture,C,SJS,35,56,14,12,26
42,8480748,Kiefer Sherwood,L,VAN,29,57,14,12,26
42,8477450,Jason Dickinson,C,CHI,29,55,13,13,26
42,8480113,Alex Iafallo,L,WPG,31,65,12,14,26
42,8479661,Tanner Jeannot,L,LAK,27,72,12,14,26
42,8478133,Jake Evans,C,MTL,28,75,10,16,26
42,8480043,Timothy Liljegren,D,TOR,25,67,5,21,26
42,8482079,Marco Rossi,C,MIN,23,54,12,13,25
42,8481704,Juuso Parssinen,C,NSH,23,60,12,13,25
42,8483491,Ivan Miroshnichenko,L,WSH,20,60,12,13,25
42,8478413,Jordan Greenway,L,BUF,27,61,11,14,25
42,8478020,Michael Amadio,R,OTT,28,72,11,14,25
42,8483457,Lane Hutson,D,MTL,20,68,10,15,25
42,8482146,Luke Evangelista,R,NSH,22,69,9,16,25
42,8479402,Jake Bean,D,CGY,26,72,7,18,25
42,8476312,Josh Manson,D,COL,33,67,7,18,25
42,8478911,Matt Roy,D,WSH,29,65,5,20,25
42,8478970,Jalen Chatfield,D,CAR,28,69,4,21,25
42,8482122,Brock Faber,D,MIN,22,81,2,23,25
42,8478399,Jonas Siegenthaler,D,NJD,27,69,2,23,25
42,8480891,Michael Kesselring,D,UTA,24,56,2,23,25
42,8481554,Kaapo Kakko,R,NYR,23,67,14,10,24
42,8482679,Matt Coronato,R,CGY,22,65,14,10,24
42,8477353,Tyler Motte,C,DET,29,76,13,11,24
42,8476873,Mark Jankowski,C,NSH,30,53,13,11,24
42,8480789,Oliver Wahlstrom,R,NYI,24,75,12,12,24
42,8476278,Colin Blackwell,C,DAL,31,79,11,13,24
42,8475714,Calle Jarnkrok,C,TOR,33,71,11,13,24
42,8481624,Ilya Mikheyev,R,CHI,30,59,11,13,24
42,8480144,David Kampf,C,TOR,29,72,11,13,24
42,8475193,Tomas Tatar,L,NJD,34,65,10,14,24
42,8480871,Adam Boqvist,D,FLA,24,68,10,14,24
42,8477505,Alexander Wennberg,C,SJS,30,63,10,14,24
42,8477953,Kasperi Kapanen,R,STL,28,71,10,14,24
42,8480003,Jesper Boqvist,C,FLA,26,67,10,14,24
42,8474189,Lars Eller,C,PIT,35,65,10,14,24
42,8482809,Jackson Blake,R,CAR,21,58,8,16,24
42,8479983,Mario Ferraro,D,SJS,26,70,8,16,24
42,8476934,Brock McGinn,L,ANA,30,47,8,16,24
42,8480878,Nils Lundkvist,D,DAL,24,69,5,19,24
42,8479982,Conor Timmins,D,TOR,26,57,2,22,24
42,8478882,Vladislav Gavrikov,D,LAK,29,67,2,22,24
42,8476981,Josh Anderson,R,MTL,30,72,16,7,23
42,8479619,Michael Carcone,L,UTA,28,56,16,7,23
42,8478109,Victor Olofsson,L,VGK,29,73,14,9,23
42,8479390,Taylor Raddysh,R,WSH,26,56,13,10,23
42,8481517,Brett Leason,R,ANA,25,57,11,12,23
42,8476878,Zemgus Girgensons,C,TBL,30,78,11,12,23
42,8480762,Eric Robinson,L,CAR,29,65,9,14,23
42,8476438,Brandon Saad,L,STL,32,69,8,15,23
42,8477392,Hudson Fasching,R,NYI,29,64,8,15,23
42,8480817,K'Andre Miller,D,NYR,24,69,6,17,23
42,8482101,Danil Gushchin,L,SJS,22,59,3,20,23
42,8476879,Cody Ceci,D,EDM,31,72,2,21,23
42,8483482,Tristan Luneau,D,ANA,20,67,1,22,23
42,8474673,TJ Brodie,D,CHI,34,63,1,22,23
42,8479336,Carl Grundstrom,R,SJS,27,50,16,6,22
42,8482155,Alex Laferriere,R,LAK,23,67,15,7,22
42,8481601,Simon Holmstrom,R,NYI,23,65,15,7,22
42,8476960,Andreas Athanasiou,C,CHI,30,58,14,8,22
42,8478569,Noel Acciari,C,PIT,33,58,13,9,22
42,8477989,Christian Dvorak,C,MTL,28,65,12,10,22
42,8480205,Emil Bemstrom,C,PIT,25,55,11,11,22
42,8481032,Paul Cotter,C,NJD,25,62,10,12,22
42,8477979,Nicolas Aube-Kubel,R,BUF,28,51,9,13,22
42,8480074,Alexandre Texier,C,STL,25,55,9,13,22
42,8482111,Justin Barron,D,MTL,23,64,8,14,22
42,8477499,Rasmus Ristolainen,D,PHI,30,60,6,16,22
42,8482749,Joshua Roy,R,MTL,21,61,5,17,22
42,8480172,Jan Rutta,D,SJS,34,62,4,18,22
42,8478500,Ivan Provorov,D,CBJ,27,76,3,19,22
42,8475233,David Savard,D,MTL,34,66,3,19,22
42,8480049,Dylan Samberg,D,WPG,25,62,3,19,22
42,8476469,Joel Armia,R,MTL,31,63,13,8,21
42,8481477,Nico Sturm,C,SJS,29,57,12,9,21
42,8476374,Sean Kuraly,C,CBJ,31,57,11,10,21
42,8477425,Miles Wood,L,COL,29,78,10,11,21
42,8474716,Jared Spurgeon,D,MIN,35,78,9,12,21
42,8477015,Connor Brown,R,EDM,30,63,9,12,21
42,8482062,Cole Smith,L,NSH,29,59,8,13,21
42,8475171,Oliver Ekman-Larsson,D,TOR,33,66,5,16,21
42,8481521,Ronnie Attard,D,PHI,25,54,5,16,21
42,8480807,Mattias Samuelsson,D,BUF,24,52,4,17,21
42,8476931,Jake McCabe,D,TOR,31,70,2,19,21
42,8478136,Jake Middleton,D,MIN,28,76,2,19,21
42,8478432,Christian Fischer,R,DET,27,72,13,7,20
42,8478508,Yakov Trenin,C,MIN,27,64,9,11,20
42,8475842,Sam Carrick,C,NYR,32,59,9,11,20
42,8482125,Alexander Holtz,R,VGK,22,67,8,12,20
42,8475231,Casey Cizikas,C,NYI,33,68,7,13,20
42,8478416,Erik Cernak,D,TBL,27,71,6,14,20
42,8481553,Bobby Brink,R,PHI,23,61,5,15,20
42,8482245,Artem Zub,D,OTT,29,69,5,15,20
42,8476525,Colin Miller,D,WPG,32,62,4,16,20
42,8481568,Alex Vlasic,D,CHI,23,56,3,17,20
42,8479998,Mikey Anderson,D,LAK,25,61,3,17,20
42,8480873,Rasmus Sandin,D,WSH,24,63,2,18,20
42,8481716,Dmitri Voronkov,L,CBJ,24,44,12,7,19
42,8482259,Bobby McMann,C,TOR,28,66,10,9,19
42,8479393,Noah Gregor,L,OTT,26,67,10,9,19
42,8477947,Sonny Milano,L,WSH,28,59,8,11,19
42,8476885,Jacob Trouba,D,NYR,30,72,8,11,19
42,8480035,Henri Jokiharju,D,BUF,25,66,7,12,19
42,8478043,Sam Lafferty,C,BUF,29,54,7,12,19
42,8481522,Peyton Krebs,C,BUF,23,58,5,14,19
42,8476889,Radek Faksa,C,STL,30,56,5,14,19
42,8476891,Matthew Grzelcyk,D,PIT,30,69,3,16,19
42,8476988,Matt Benning,D,SJS,30,68,3,16,19
42,8476624,Barclay Goodrow,C,SJS,31,50,2,17,19
42,8481028,Martin Pospisil,C,CGY,25,60,11,7,18
42,8483493,Frank Nazar,C,CHI,20,56,10,8,18
42,8479368,Max Jones,L,BOS,26,68,9,9,18
42,8476822,Luke Glendening,C,TBL,35,77,9,9,18
42,8473453,Trevor Lewis,C,LAK,37,74,7,11,18
42,8481580,Connor McMichael,C,WSH,23,60,7,11,18
42,8480025,MacKenzie Entwistle,R,FLA,25,60,7,11,18
42,8482157,Will Cuylle,L,NYR,22,69,7,11,18
42,8482451,Mikael Pyyhtia,L,CBJ,23,48,6,12,18
42,8476467,Jamie Oleksiak,D,SEA,32,70,6,12,18
42,8476422,Mike Reilly,D,NYI,31,76,5,13,18
42,8481014,Alexander Romanov,D,NYI,24,79,5,13,18
42,8479976,Juuso Valimaki,D,UTA,26,62,4,14,18
42,8482142,Jamie Drysdale,D,PHI,22,64,4,14,18
42,8479324,Ryan Lindgren,D,NYR,26,68,4,14,18
42,8475790,Erik Gudbranson,D,CBJ,32,74,0,18,18
42,8475225,Craig Smith,C,CHI,35,54,11,6,17
42,8483524,Shane Wright,C,SEA,20,60,10,7,17
42,8480980,Connor Dewar,C,TOR,25,70,9,8,17
42,8477369,Carson Soucy,D,VAN,30,67,8,9,17
42,8479353,Brett Howden,C,VGK,26,65,8,9,17
42,8477508,Curtis Lazar,C,NJD,29,59,8,9,17
42,8477573,Nathan Walker,L,STL,30,51,8,9,17
42,8482659,Josh Doan,R,UTA,22,58,8,9,17
42,8480995,Pontus Holmberg,R,TOR,25,55,7,10,17
42,8482077,Dylan Holloway,L,EDM,23,58,7,10,17
42,8477507,Nikita Zadorov,D,BOS,29,71,5,12,17
42,8482737,Zack Bolduc,C,STL,21,54,5,12,17
42,8476457,Adam Larsson,D,SEA,32,67,5,12,17
42,8476329,Travis Boyd,C,MIN,31,54,5,12,17
42,8473563,Nicklas Backstrom,C,WSH,37,54,5,12,17
42,8482634,Alex Steeves,C,TOR,25,45,5,12,17
42,8476331,Dylan DeMelo,D,WPG,31,67,4,13,17
42,8483499,Liam Ohgren,L,MIN,20,55,4,13,17
42,8475188,Brayden McNabb,D,VGK,33,63,4,13,17
42,8477435,Ryan Graves,D,PIT,29,78,4,13,17
42,8484149,Gavin Brindley,C,CBJ,20,54,4,13,17
42,8477845,Trevor van Riemsdyk,D,WSH,33,60,3,14,17
42,8475279,Ben Chiarot,D,DET,33,71,2,15,17
42,8480001,Urho Vaakanainen,D,ANA,25,60,2,15,17
42,8480073,Erik Brannstrom,D,COL,25,62,1,16,17
42,8479414,Nathan Bastian,R,NJD,27,61,10,6,16
42,8476918,Jimmy Vesey,L,NYR,31,60,9,7,16
42,8482803,Olen Zellweger,D,ANA,21,67,8,8,16
42,8475855,Jesper Fast,R,CAR,33,57,8,8,16
42,8479370,Tyson Jost,C,CAR,26,46,8,8,16
42,8479315,Joey Anderson,R,CHI,26,46,7,9,16
42,8480021,Jack Studnicka,C,LAK,25,60,7,9,16
42,8480070,Ian Mitchell,D,BOS,25,44,7,9,16
42,8481641,Joel Kiviranta,L,COL,28,68,6,10,16
42,8479316,Luke Kunin,C,SJS,27,61,6,10,16
42,8477903,Garnet Hathaway,R,PHI,33,63,5,11,16
42,8477931,Tomas Nosek,L,FLA,32,56,5,11,16
42,8475462,Radko Gudas,D,ANA,34,67,4,12,16
42,8480246,Nick Perbix,D,TBL,26,73,3,13,16
42,8481441,Joe Snively,C,DET,28,64,3,13,16
42,8482087,Kaiden Guhle,D,MTL,22,62,3,13,16
42,8475324,Nick Jensen,D,OTT,34,70,3,13,16
42,8480727,Zach Whitecloud,D,VGK,28,52,2,14,16
42,8475690,Chris Tanev,D,TOR,35,56,2,14,16
42,8480281,Alexey Toropchenko,R,STL,25,59,10,5,15
42,8480448,Parker Kelly,L,COL,25,73,9,6,15
42,8477482,Zachary Sanford,L,CHI,30,39,9,6,15
42,8477406,Mattias Janmark,C,EDM,32,61,8,7,15
42,8483466,Kevin Korchinski,D,CHI,20,49,8,7,15
42,8480289,Morgan Barron,C,WPG,26,55,8,7,15
42,8479543,Michael Pezzetta,L,MTL,26,55,8,7,15
42,8479520,Brandon Duhaime,R,WSH,27,54,7,8,15
42,8479972,Mason Shaw,C,WPG,26,33,7,8,15
42,8478585,Derek Ryan,C,EDM,38,66,6,9,15
42,8480058,Pierre-Olivier Joseph,D,STL,25,53,4,11,15
42,8479639,Dylan Coghlan,D,WPG,26,59,3,12,15
42,8476979,Erik Gustafsson,D,DET,32,73,2,13,15
42,8482067,Connor Mackey,D,NYR,28,60,2,13,15
42,8475455,Brenden Dillon,D,NJD,34,57,2,13,15
42,8482073,Braden Schneider,D,NYR,23,63,1,14,15
42,8471709,Marc-Edouard Vlasic,D,SJS,37,57,1,14,15
42,8478211,Dryden Hunt,L,CGY,29,52,8,6,14
42,8482762,Simon Edvinsson,D,DET,21,55,8,6,14
42,8479328,Julien Gauthier,R,NYI,27,60,7,7,14
42,8481789,Tye Kartye,L,SEA,23,45,7,7,14
42,8479718,Alex Barré-Boulet,C,MTL,27,43,6,8,14
42,8479066,Ryan Lomberg,L,CGY,30,55,6,8,14
42,8480355,Mark Kastelic,C,BOS,25,63,6,8,14
42,8480806,Isac Lundestrom,C,ANA,25,57,5,9,14
42,8476856,Mathew Dumba,D,DAL,30,71,5,9,14
42,8480887,Jordan Harris,D,MTL,24,57,4,10,14
42,8482176,Wyatt Kaiser,D,CHI,22,50,4,10,14
42,8478434,Keegan Kolesar,R,VGK,27,71,3,11,14
42,8481537,Nikita Okhotiuk,D,CGY,24,47,3,11,14
42,8478840,Will Borgen,D,SEA,28,67,2,12,14
42,8482192,Isaak Phillips,D,CHI,23,63,2,12,14
42,8477220,Nate Schmidt,D,FLA,33,68,2,12,14
42,8480157,Calle Rosen,D,COL,30,51,2,12,14
42,8482744,James Malatesta,L,CBJ,21,38,8,5,13
42,8477446,Michael McCarron,R,NSH,29,51,7,6,13
42,8482148,Hendrix Lapierre,C,WSH,22,54,7,6,13
42,8479439,Jacob MacDonald,D,COL,31,47,6,7,13
42,8481592,Jakob Pelletier,L,CGY,23,48,6,7,13
42,8477962,Brendan Lemieux,L,CAR,28,45,6,7,13
42,8480011,Klim Kostin,C,SJS,25,49,5,8,13
42,8474034,Patrick Maroon,L,CHI,36,50,5,8,13
42,8482153,Brendan Brisson,C,VGK,23,30,5,8,13
42,8480796,Martin Fehervary,D,WSH,25,56,4,9,13
42,8474574,Tyler Myers,D,VAN,34,75,3,10,13
42,8478451,Ethan Bear,D,WSH,27,47,3,10,13
42,8481178,Egor Zamula,D,PHI,24,53,3,10,13
42,8478851,Alexandre Carrier,D,NSH,28,66,2,11,13
42,8476874,Olli Maatta,D,DET,30,65,2,11,13
42,8479372,Joshua Mahura,D,SEA,26,53,0,13,13
42,8482807,Ethan Del Mastro,D,CHI,21,42,10,2,12
42,8481518,Nolan Foote,L,NJD,24,40,8,4,12
42,8478831,Kevin Stenlund,C,UTA,28,48,7,5,12
42,8479981,Jonah Gadjovich,L,FLA,26,54,7,5,12
42,8477938,Haydn Fleury,D,WPG,28,50,6,6,12
42,8479291,Kevin Rooney,C,CGY,31,46,5,7,12
42,8476994,Vinnie Hinostroza,C,NSH,30,49,4,8,12
42,8480192,Johnathan Kovacevic,D,NJD,27,55,4,8,12
42,8481013,Jonatan Berggren,R,DET,24,54,3,9,12
42,8484254,Akito Hirose,D,VAN,25,39,2,10,12
42,8483565,Nick Blankenburg,D,NSH,26,67,1,11,12
42,8476967,Brett Kulak,D,EDM,30,66,0,12,12
42,8481161,Jake Christiansen,D,CBJ,25,56,7,4,11
42,8479359,Beck Malenstyn,L,BUF,26,51,5,6,11
42,8482730,Brandt Clarke,D,LAK,21,48,5,6,11
42,8481147,Reese Johnson,C,MIN,26,30,5,6,11
42,8482166,Shakir Mukhamadullin,D,SJS,22,59,4,7,11
42,8476858,Phillip Di Giuseppe,L,VAN,31,39,4,7,11
42,8480860,Kevin Bahl,D,CGY,24,59,3,8,11
42,8475208,Brian Dumoulin,D,ANA,33,62,3,8,11
42,8479378,Logan Stanley,D,WPG,26,42,3,8,11
42,8483460,David Jiricek,D,CBJ,21,65,3,8,11
42,8474090,Brendan Smith,D,DAL,35,47,3,8,11
42,8478017,Mark Friedman,D,VAN,29,35,3,8,11
42,8471677,Jack Johnson,D,CBJ,37,60,2,9,11
42,8477365,Connor Clifton,D,BUF,29,61,2,9,11
42,8481567,Henry Thrun,D,SJS,23,49,2,9,11
42,8477018,Ben Hutton,D,VGK,31,42,2,9,11
42,8480879,Jacob Bernard-Docker,D,OTT,24,52,2,9,11
42,8474567,Zach Bogosian,D,MIN,34,56,2,9,11
42,8480196,Jacob Bryson,D,BUF,27,38,1,10,11
42,8478424,Jansen Harkins,C,ANA,27,36,7,3,10
42,8479344,Jesse Puljujarvi,R,PIT,26,47,6,4,10
42,8478421,A.J. Greer,L,FLA,28,56,5,5,10
42,8479980,Nicolas Hague,D,VGK,26,52,5,5,10
42,8477380,Jonny Brodzinski,C,NYR,31,51,5,5,10
42,8480252,Cole Guttman,C,CHI,25,34,4,6,10
42,8483495,Simon Nemec,D,NJD,20,48,4,6,10
42,8481019,David Gustafsson,C,WPG,24,41,3,7,10
42,8481167,Brayden Pachal,D,CGY,25,37,3,7,10
42,8481598,Philip Broberg,D,EDM,23,47,3,7,10
42,8480007,Jonas Rondbjerg,R,VGK,25,36,3,7,10
42,8483549,Lucas Condotta,L,MTL,27,33,3,7,10
42,8477335,Kyle Burroughs,D,LAK,29,47,3,7,10
42,8475179,Dmitry Kulikov,D,FLA,34,68,2,8,10
42,8479371,Dante Fabbro,D,NSH,26,63,2,8,10
42,8481527,Kaedan Korczak,D,VGK,23,45,2,8,10
42,8478443,Brandon Carlo,D,BOS,28,60,2,8,10
42,8475718,Justin Holl,D,DET,32,55,1,9,10
42,8474013,Ian Cole,D,UTA,35,51,1,9,10
42,8479369,Andrew Peeke,D,BOS,26,56,1,9,10
42,8479348,Kale Clague,D,BUF,26,38,1,9,10
42,8479249,Andrew Poturalski,C,SJS,30,34,1,9,10
42,8482141,Lukas Cormier,D,VGK,22,26,6,3,9
42,8479638,Justin Brazeau,R,BOS,26,37,5,4,9
42,8481617,Vasily Podkolzin,R,VAN,23,53,5,4,9
42,8479772,Zack MacEwen,R,OTT,28,55,5,4,9
42,8482666,Scott Morrow,D,CAR,22,47,5,4,9
42,8479941,Justin Danforth,R,CBJ,31,63,4,5,9
42,8481532,Alex Turcotte,C,LAK,23,38,4,5,9
42,8479994,Jaret Anderson-Dolan,C,WPG,25,31,4,5,9
42,8483397,Marc McLaughlin,C,BOS,25,29,4,5,9
42,8479026,Philippe Myers,D,TOR,27,48,3,6,9
42,8480245,Olle Lycksell,R,PHI,25,40,3,6,9
42,8481754,Nikita Nesterenko,C,ANA,23,31,3,6,9
42,8476429,Scott Mayfield,D,NYI,32,73,2,7,9
42,8478452,Caleb Jones,D,LAK,27,58,2,7,9
42,8481600,Tobias Bjornfot,D,FLA,23,37,2,7,9
42,8480222,Sebastian Aho,D,PIT,28,68,1,8,9
42,8473446,Erik Johnson,D,PHI,36,48,1,8,9
42,8482861,Vincent Iorio,D,WSH,22,34,1,8,9
42,8478468,Jeremy Lauzon,D,NSH,27,51,0,9,9
42,8479968,Vinni Lettieri,C,BOS,29,47,5,3,8
42,8476442,Matt Nieto,L,PIT,32,49,5,3,8
42,8479671,Mathieu Olivier,R,CBJ,27,48,3,5,8
42,8480845,Rasmus Kupari,C,WPG,24,40,3,5,8
42,8481751,Lukas Rousek,R,BUF,25,35,3,5,8
42,8478450,Parker Wotherspoon,D,BOS,27,38,3,5,8
42,8479536,Axel Jonsson-Fjallby,L,WPG,26,31,3,5,8
42,8471817,Ryan Reaves,R,TOR,37,49,3,5,8
42,8482964,Arber Xhekaj,D,MTL,23,44,3,5,8
42,8481122,Simon Benoit,D,TOR,26,47,3,5,8
42,8477070,Liam O'Brien,C,UTA,30,54,2,6,8
42,8470600,Ryan Suter,D,STL,39,56,2,6,8
42,8479985,Cale Fleury,D,SEA,26,27,2,6,8
42,8481059,Scott Perunovich,D,STL,26,58,1,7,8
42,8478178,Darren Raddysh,D,TBL,28,69,1,7,8
42,8482095,Tyler Kleven,D,OTT,22,50,1,7,8
42,8474568,Luke Schenn,D,NSH,35,47,1,7,8
42,8476372,Nick Seeler,D,PHI,31,37,1,7,8
42,8480950,Ilya Lyubushkin,D,DAL,30,65,0,8,8
42,8480468,James Hamblin,L,EDM,25,22,7,0,7
42,8480880,Jakub Lauko,C,MIN,24,38,6,1,7
42,8480848,Ty Dellandrea,C,SJS,24,44,5,2,7
42,8483630,Pavol Regenda,L,ANA,25,34,5,2,7
42,8482496,Nils Aman,C,VAN,24,42,4,3,7
42,8475958,Michael Sgarbossa,C,WSH,32,33,4,3,7
42,8481556,John Beecher,C,BOS,23,33,4,3,7
42,8481708,Zac Jones,D,NYR,24,41,3,4,7
42,8482070,Mitchell Chaffee,R,TBL,26,51,3,4,7
42,8481609,Vladislav Kolyachonok,D,UTA,23,35,3,4,7
42,8476913,Devin Shore,C,MIN,30,44,3,4,7
42,8475235,Nicolas Deslauriers,L,PHI,33,44,3,4,7
42,8478146,Matthew Highmore,C,OTT,28,38,3,4,7
42,8482859,Zack Ostapchuk,C,OTT,21,46,2,5,7
42,8474166,Alec Martinez,D,CHI,37,50,2,5,7
42,8476473,Connor Murphy,D,CHI,31,46,2,5,7
42,8481550,Adam Beckman,L,NJD,23,36,2,5,7
42,8484911,Collin Graf,R,SJS,22,42,2,5,7
42,8475177,Calvin de Haan,D,COL,33,37,1,6,7
42,8478454,Noah Juulsen,D,VAN,27,40,1,6,7
42,8484258,Sam Malinski,D,COL,26,19,1,6,7
42,8477971,Andreas Englund,D,LAK,28,25,1,6,7
42,8477887,Patrick Brown,C,BOS,32,43,4,2,6
42,8477473,Justin Bailey,R,SJS,29,25,4,2,6
42,8477401,John Hayden,C,SEA,29,36,4,2,6
42,8477851,Jordan Oesterle,D,BOS,32,38,3,3,6
42,8477384,Joshua Brown,D,EDM,30,38,3,3,6
42,8481701,Santeri Hatakka,D,NJD,23,28,2,4,6
42,8476867,Brendan Gaunce,C,MIN,30,31,2,4,6
42,8478859,Niko Mikkola,D,FLA,28,52,2,4,6
42,8478409,Anthony Richard,C,PHI,28,30,2,4,6
42,8482765,Isak Rosen,R,BUF,21,31,2,4,6
42,8477034,Jaycob Megna,D,FLA,32,40,1,5,6
42,8474612,Travis Hamonic,D,OTT,34,44,1,5,6
42,8476441,Joel Edmundson,D,LAK,31,39,1,5,6
42,8480823,Alexander Alexeyev,D,WSH,25,13,1,5,6
42,8480441,Trey Fix-Wolansky,R,CBJ,25,33,3,2,5
42,8477462,Robert Hagg,D,VGK,29,28,3,2,5
42,8478874,Adam Gaudette,R,OTT,28,38,3,2,5
42,8482784,Zach Dean,C,STL,21,39,3,2,5
42,8484325,Waltteri Merela,C,TBL,26,19,3,2,5
42,8481056,Spencer Stastney,D,NSH,24,29,2,3,5
42,8482145,Mavrik Bourque,C,DAL,22,52,2,3,5
42,8482511,Mason Lohrei,D,BOS,23,37,2,3,5
42,8481543,Nikita Alexandrov,C,STL,24,27,2,3,5
42,8482144,Jack Thompson,D,SJS,22,22,2,3,5
42,8479367,William Lockwood,R,FLA,26,34,2,3,5
42,8482201,Gage Goncalves,C,TBL,23,24,2,3,5
42,8476952,Dominic Toninato,C,WPG,30,43,1,4,5
42,8479576,Vincent Desharnais,D,VAN,28,26,1,4,5
42,8481599,Victor Soderstrom,D,UTA,23,50,1,4,5
42,8482747,Brennan Othmann,L,NYR,21,37,1,4,5
42,8482733,Logan Mailloux,D,MTL,31,36,1,4,5
42,8475750,Jon Merrill,D,MIN,32,66,0,5,5
42,8480292,Carson Meyer,R,ANA,27,30,0,5,5
42,8479991,Jake Leschyshyn,C,NYR,25,28,0,5,5
42,8479419,Brett Murray,L,BUF,26,22,3,1,4
42,8477527,Ross Johnston,L,ANA,30,38,3,1,4
42,8479442,Troy Stecher,D,EDM,30,53,2,2,4
42,8480990,Declan Chisholm,D,MIN,24,30,2,2,4
42,8483570,Ben Meyers,C,SEA,26,23,2,2,4
42,8482713,Mackie Samoskevich,R,FLA,22,38,1,3,4
42,8480870,Bo Groulx,C,NYR,24,28,1,3,4
42,8479986,Kole Lind,R,DAL,26,42,1,3,4
42,8479944,Zach Aston-Reese,C,VGK,30,48,1,3,4
42,8481743,Marc Del Gaizo,D,NSH,25,31,1,3,4
42,8483012,Logan Morrison,C,SEA,22,29,1,3,4
42,8481462,Mason Morelli,L,VGK,28,11,1,3,4
42,8482197,Adam Raska,R,MIN,23,9,1,3,4
42,8475762,Derek Forbort,D,VAN,32,44,0,4,4
42,8483512,Matthew Savoie,C,EDM,20,21,0,4,4
42,8482061,Brandon Biro,L,SEA,26,18,3,0,3
42,8481422,Jake Lucchini,C,NSH,29,21,3,0,3
42,8484287,Cole McWard,D,VAN,23,19,2,1,3
42,8477467,Gustav Olofsson,D,SEA,30,17,2,1,3
42,8482172,Landon Slaggert,L,CHI,22,27,2,1,3
42,8480851,Akil Thomas,C,LAK,24,20,2,1,3
42,8483597,Milos Kelemen,L,UTA,25,18,2,1,3
42,8481564,Ryan Johnson,D,BUF,23,16,2,1,3
42,8478051,Max Willman,C,NJD,29,26,2,1,3
42,8481679,Maxence Guenette,D,OTT,23,32,1,2,3
42,8480834,Ty Emberson,D,SJS,24,36,1,2,3
42,8483619,Filip Roos,D,OTT,25,28,1,2,3
42,8482516,Matthew Kessel,D,STL,24,21,1,2,3
42,8480084,Nick DeSimone,D,NJD,30,23,1,2,3
42,8482858,Ryker Evans,D,SEA,23,25,1,2,3
42,8482751,Ryan Winterton,C,SEA,21,27,1,2,3
42,8477073,Kurtis MacDermid,L,NJD,30,29,1,2,3
42,8481006,Tyler Tucker,D,STL,24,20,1,2,3
42,8478011,Louie Belpedio,D,PHI,28,9,1,2,3
42,8479320,Maxime Lajoie,D,SEA,27,21,0,3,3
42,8481605,Jackson LaCombe,D,ANA,23,35,0,3,3
42,8478477,Mitchell Stephens,C,SEA,27,24,0,3,3
42,8479587,Rhett Gardner,C,PHI,28,22,0,3,3
42,8481699,Aku Raty,R,UTA,23,11,0,3,3
42,8480844,Grigori Denisenko,L,VGK,24,28,2,0,2
42,8480306,Grant Hutton,D,NYI,29,7,2,0,2
42,8475755,Alexander Petrovic,D,DAL,32,8,2,0,2
42,8475780,Chris Wagner,R,COL,33,14,2,0,2
42,8483471,Brad Lambert,C,WPG,31,11,2,0,2
42,8482652,Walker Duehr,R,CGY,27,30,1,1,2
42,8483763,Maksymilian Szuber,D,UTA,22,28,1,1,2
42,8482470,Ilya Solovyov,D,CGY,24,13,1,1,2
42,8480267,Sammy Walker,C,MIN,25,15,1,1,2
42,8481237,Kyle MacLean,C,NYI,25,23,1,1,2
42,8477244,Chad Ruhwedel,D,NYR,34,35,1,1,2
42,8478881,Brett Seney,L,CHI,28,10,1,1,2
42,8479362,Riley Tufte,L,BOS,26,19,1,1,2
42,8482118,Sam Colangelo,R,ANA,23,15,1,1,2
42,8481030,Jack St. Ivany,D,PIT,25,22,1,1,2
42,8482102,Vasily Ponomarev,C,PIT,22,16,1,1,2
42,8481578,Graeme Clarke,R,MIN,23,11,1,1,2
42,8482177,Marat Khusnutdinov,C,MIN,22,40,0,2,2
42,8482929,Emil Lilleberg,D,TBL,23,18,0,2,2
42,8484326,Patrik Koch,D,UTA,28,8,0,2,2
42,8482094,Daemon Hunt,D,MIN,22,14,0,2,2
42,8481585,Egor Afanasyev,L,SJS,23,18,0,2,2
42,8481024,Linus Karlsson,C,VAN,25,10,0,2,2
42,8477541,Dakota Mermis,D,TOR,30,9,0,2,2
42,8480874,Adam Ginning,D,PHI,24,15,0,2,2
42,8482460,Matt Rempe,C,NYR,22,13,0,2,2
42,8477810,Joel Hanley,D,CGY,33,27,1,0,1
42,8483395,Arshdeep Bains,L,VAN,23,10,1,0,1
42,8483567,Georgii Merkulov,C,BOS,24,12,1,0,1
42,8481719,Maxwell Crozier,D,TBL,24,17,1,0,1
42,8477320,Anton Blidh,L,NYR,29,19,1,0,1
42,8475413,Justin Dowling,C,NJD,34,15,1,0,1
42,8482250,Callahan Burke,C,VGK,27,21,1,0,1
42,8483489,Fraser Minten,C,TOR,31,16,1,0,1
42,8482147,Jean-Luc Foudy,C,COL,22,20,1,0,1
42,8478446,Glenn Gawdin,C,LAK,27,17,1,0,1
42,8482088,Justin Sourdif,R,FLA,22,18,1,0,1
42,8483432,Luca Del Bel Belluz,C,CBJ,31,8,1,0,1
42,8481065,Angus Crookshank,L,OTT,25,22,1,0,1
42,8484255,Jason Polin,R,COL,25,7,1,0,1
42,8477993,Justin Kirkland,C,CGY,28,2,1,0,1
42,8478502,Dennis Gilbert,D,BUF,28,17,0,1,1
42,8479379,Givani Smith,R,SJS,26,28,0,1,1
42,8477149,Scott Sabourin,R,SJS,32,14,0,1,1
42,8482162,Roby Jarventie,L,EDM,22,19,0,1,1
42,8480032,Shane Bowers,C,NJD,25,11,0,1,1
42,8482165,Yan Kuznetsov,D,CGY,22,24,0,1,1
42,8481043,Cole Koepke,L,BOS,26,15,0,1,1
42,8480075,Cameron Crotty,D,MIN,25,11,0,1,1
42,8483920,Pierrick Dube,R,WSH,23,3,0,1,1
42,8479522,Hardy Haman Aktell,D,WSH,26,4,0,1,1
42,8481593,Jayden Struble,D,MTL,23,18,0,1,1
42,8478854,Ryan Shea,D,PIT,27,5,0,1,1
42,8479330,Brandon Gignac,C,MTL,27,9,0,1,1
42,8483401,Marc Johnstone,R,PIT,28,2,0,1,1
42,8475795,Dylan McIlrath,D,WSH,32,15,0,0,0
42,8480890,Jan Jenik,C,OTT,24,26,0,0,0
42,8481541,Samuel Bolduc,D,NYI,24,25,0,0,0
42,8482476,Emil Heineman,L,MTL,23,4,0,0,0
42,8482126,Emil Andrae,D,PHI,31,7,0,0,0
42,8474062,Riley Nash,C,NYR,35,17,0,0,0
42,8478021,William Lagesson,D,DET,28,24,0,0,0
42,8484304,Uvis Balinskis,D,FLA,28,14,0,0,0
42,8484259,Ondrej Pavel,C,COL,31,1,0,0,0
42,8482787,Nikita Chibrikov,R,WPG,31,10,0,0,0
42,8484321,Nikolas Matinpalo,D,OTT,26,2,0,0,0
42,8483609,Adam Klapka,R,CGY,24,5,0,0,0
42,8481806,Louis Crevier,D,CHI,23,12,0,0,0
42,8483398,Declan Carlile,D,TBL,31,6,0,0,0
42,8481206,John Ludvig,D,PIT,24,11,0,0,0
42,8483407,Brandon Scanlin,D,NYR,25,7,0,0,0
42,8481726,Adam Edstrom,C,NYR,24,9,0,0,0
42,8483546,Marshall Rifai,D,TOR,26,5,0,0,0
42,8479421,Jacob Moverare,D,LAK,26,6,0,0,0
42,8481655,Cole Schwindt,R,CGY,23,6,0,0,0
42,8478147,Bokondji Imama,L,PIT,28,7,0,0,0
42,8483531,Brian Halonen,L,NJD,25,1,0,0,0
42,8481534,Raphael Lavoie,C,EDM,24,2,0,0,0
42,8476323,Max McCormick,L,SEA,32,5,0,0,0
42,8483045,Cameron Butler,R,CBJ,31,0,0,0,0
42,8478956,Samuel Laberge,L,NJD,27,3,0,0,0
42,8480274,Philip Kemp,D,EDM,25,1,0,0,0
42,8470794,Joe Pavelski,C,,40,0,0,0,0
42,8479321,Lucas Johansen,D,,27,0,0,0,0
42,8477950,Tony DeAngelo,D,,29,0,0,0,0
42,8471218,Blake Wheeler,R,,38,0,0,0,0
42,8475197,Tyson Barrie,D,,33,0,0,0,0
42,8474157,Max Pacioretty,L,,36,0,0,0,0
42,8475744,Evgeny Kuznetsov,C,,32,0,0,0,0
42,8474037,James van Riemsdyk,L,,35,0,0,0,0
42,8476907,Mackenzie MacEachern,L,,30,0,0,0,0
42,8480216,Jacob Peterson,C,,25,0,0,0,0
42,8474602,Justin Schultz,D,,34,0,0,0,0
42,8482222,Alexander Barabanov,L,,30,0,0,0,0
42,8474031,Kevin Shattenkirk,D,,35,0,0,0,0
42,8477330,Dominik Kubalik,L,,29,0,0,0,0
42,8480884,Calen Addison,D,,24,0,0,0,0
42,8475906,John Klingberg,D,,32,0,0,0,0
42,8480008,Adam Ruzicka,C,,25,0,0,0,0
42,8476884,Derrick Pouliot,D,,30,0,0,0,0
42,8476919,Chris Tierney,C,,30,0,0,0,0
42,8479415,Michael McLeod,C,,26,0,0,0,0
42,8474870,Tyler Johnson,C,,34,0,0,0,0
42,8470604,Jeff Carter,C,,39,0,0,0,0
42,8478104,Sammy Blais,L,,28,0,0,0,0
42,8474884,Mike Hoffman,C,,35,0,0,0,0
42,8481591,Sam Poulin,R,,23,0,0,0,0
42,8471274,Alex Goligoski,D,,39,0,0,0,0
42,8476871,Tanner Pearson,L,,32,0,0,0,0
42,8476393,Nick Cousins,C,,31,0,0,0,0
42,8479977,Kailer Yamamoto,R,,26,0,0,0,0
42,8479346,Dillon Dube,C,,26,0,0,0,0
42,8480184,Gustav Lindstrom,D,,26,0,0,0,0
42,8479376,Victor Mete,D,,26,0,0,0,0
42,8473449,Kyle Okposo,R,,36,0,0,0,0
42,8481058,Jesse Ylonen,R,,25,0,0,0,0
42,8475752,Tyler Pitlick,C,,33,0,0,0,0
42,8481239,Samuel Fagemo,L,,24,0,0,0,0
42,8480821,Filip Zadina,R,,25,0,0,0,0
42,8470966,Mark Giordano,D,,41,0,0,0,0
42,8478495,Denis Gurianov,R,,27,0,0,0,0
42,8477464,Nic Petan,C,,29,0,0,0,0
42,8478099,Kevin Labanc,R,,29,0,0,0,0
42,8482241,Radim Zohorna,L,,28,0,0,0,0
42,8474040,Sam Gagner,C,,35,0,0,0,0
42,8479514,Rem Pitlick,C,,27,0,0,0,0
42,8478430,Oliver Kylington,D,,27,0,0,0,0
42,8479533,Joona Koppanen,L,,26,0,0,0,0
42,8479984,Cal Foote,D,,26,0,0,0,0
42,8477126,Jayson Megna,C,,34,0,0,0,0
42,8475164,Jakob Silfverberg,R,,34,0,0,0,0
42,8474009,Nick Bonino,C,,36,0,0,0,0
42,8479458,Nikita Zaitsev,D,,33,0,0,0,0
42,8477944,Jakub Vrana,L,,28,0,0,0,0
42,8471699,Andrew Cogliano,C,,37,0,0,0,0
42,8478067,Oskar Lindblom,L,,28,0,0,0,0
42,8471686,Marc Staal,D,,37,0,0,0,0
42,8470610,Zach Parise,L,,40,0,0,0,0
42,8478904,Steven Lorentz,C,,28,0,0,0,0
42,8473473,Milan Lucic,L,,36,0,0,0,0
42,8480031,Maxime Comtois,L,,25,0,0,0,0
42,8478512,Austin Czarnik,C,,32,0,0,0,0
42,8473504,Cal Clutterbuck,R,,37,0,0,0,0
42,8477454,Adam Erne,L,,29,0,0,0,0
42,8479383,Boris Katchouk,L,,26,0,0,0,0
42,8475825,Jani Hakanpää,D,,32,0,0,0,0
42,8477846,Ryan Carpenter,C,,33,0,0,0,0
42,8477930,Pierre-Edouard Bellemare,L,,39,0,0,0,0
42,8478400,Colin White,C,,27,0,0,0,0
42,8480226,Marián Studenic,R,,26,0,0,0,0
42,8480853,Liam Foudy,C,,24,0,0,0,0
42,8475797,Jarred Tinordi,D,,32,0,0,0,0
42,8479423,Alex Nylander,L,,26,0,0,0,0
42,8474618,Marco Scandella,D,,34,0,0,0,0
42,8478028,Fredrik Olofsson,L,,28,0,0,0,0
42,8474709,Matt Martin,L,,35,0,0,0,0
42,8481070,Hugh McGing,L,,26,0,0,0,0
42,8479546,Oskar Steen,C,,26,0,0,0,0
42,8474145,Robert Bortuzzo,D,,35,0,0,0,0
42,8476915,Jujhar Khaira,L,,30,0,0,0,0
42,8475278,Byron Froese,C,,33,0,0,0,0
42,8481812,Nikolai Knyzhov,D,,27,0,0,0,0
42,8478408,Travis Dermott,D,,28,0,0,0,0
42,8481077,John Leonard,L,,26,0,0,0,0
42,8479547,Matthew Phillips,R,,26,0,0,0,0
42,8480836,Jonathan Gruden,C,,24,0,0,0,0
42,8481690,Tyler Angle,C,,24,0,0,0,0
42,8475766,Austin Watson,L,,32,0,0,0,0
42,8481016,Ruslan Iskhakov,C,,24,0,0,0,0
42,8478078,Rourke Chartier,C,,28,0,0,0,0
42,8480776,Sheldon Rempal,R,,29,0,0,0,0
42,8484314,Jiri Smejkal,L,,28,0,0,0,0
43,8477492,Nathan MacKinnon,C,COL,29,81,56,97,153
43,8477956,David Pastrnak,R,BOS,28,79,53,71,124
43,8478402,Connor McDavid,C,EDM,27,79,33,87,120
43,8478483,Mitch Marner,R,TOR,27,78,34,85,119
43,8476468,J.T. Miller,C,VAN,31,77,44,68,112
43,8479314,Matthew Tkachuk,L,FLA,27,79,36,73,109
43,8478550,Artemi Panarin,L,NYR,33,81,34,75,109
43,8477939,William Nylander,R,TOR,28,77,50,58,108
43,8479318,Auston Matthews,C,TOR,27,82,69,37,106
43,8476453,Nikita Kucherov,R,TBL,31,82,35,71,106
43,8477934,Leon Draisaitl,C,EDM,29,77,38,67,105
43,8478864,Kirill Kaprizov,L,MIN,27,69,50,54,104
43,8477946,Dylan Larkin,C,DET,28,79,43,61,104
43,8478420,Mikko Rantanen,R,COL,28,82,42,61,103
43,8476887,Filip Forsberg,L,NSH,30,73,51,48,99
43,8481559,Jack Hughes,C,NJD,23,74,37,62,99
43,8475172,Nazem Kadri,C,CGY,34,79,36,61,97
43,8478403,Jack Eichel,C,VGK,28,77,41,54,95
43,8480800,Quinn Hughes,D,VAN,25,78,13,77,90
43,8478427,Sebastian Aho,C,CAR,27,74,43,46,89
43,8477933,Sam Reinhart,C,FLA,29,80,41,47,88
43,8479337,Alex DeBrincat,R,DET,27,80,33,55,88
43,8477493,Aleksander Barkov,C,FLA,29,81,24,64,88
43,8474564,Steven Stamkos,C,NSH,34,75,37,48,85
43,8478445,Mathew Barzal,C,NYI,27,79,17,68,85
43,8478010,Brayden Point,C,TBL,28,82,41,42,83
43,8481557,Matt Boldy,L,MIN,23,77,34,49,83
43,8480002,Nico Hischier,C,NJD,25,75,32,51,83
43,8480830,Andrei Svechnikov,R,CAR,24,74,25,57,82
43,8477501,Valeri Nichushkin,R,COL,29,79,45,36,81
43,8479343,Clayton Keller,R,UTA,26,78,36,45,81
43,8480027,Jason Robertson,L,DAL,25,82,31,50,81
43,8482116,Tim Stützle,C,OTT,22,81,30,51,81
43,8480012,Elias Pettersson,C,VAN,26,75,33,47,80
43,8479407,Jesper Bratt,L,NJD,26,76,30,50,80
43,8474600,Roman Josi,D,NSH,34,69,14,66,80
43,8476346,Johnny Gaudreau,L,CBJ,31,75,21,58,79
43,8475166,John Tavares,C,TOR,34,78,33,44,77
43,8479385,Jordan Kyrou,C,STL,26,75,29,47,76
43,8478439,Travis Konecny,R,PHI,27,78,40,35,75
43,8477404,Jake Guentzel,C,TBL,30,82,35,40,75
43,8476459,Mika Zibanejad,C,NYR,31,73,31,44,75
43,8478460,Zach Werenski,D,CBJ,27,81,15,60,75
43,8471675,Sidney Crosby,C,PIT,37,75,32,42,74
43,8475913,Mark Stone,R,VGK,32,77,28,46,74
43,8476454,Ryan Nugent-Hopkins,C,EDM,31,77,15,58,73
43,8479323,Adam Fox,D,NYR,26,73,15,58,73
43,8478444,Brock Boeser,R,VAN,27,79,34,38,72
43,8475168,Matt Duchene,C,DAL,33,79,29,43,72
43,8477402,Pavel Buchnevich,L,STL,29,75,26,46,72
43,8475692,Mats Zuccarello,R,MIN,37,74,17,55,72
43,8476456,Jonathan Huberdeau,C,CGY,31,78,8,64,72
43,8476389,Vincent Trocheck,C,NYR,31,75,33,38,71
43,8475784,Jeff Skinner,C,EDM,32,78,33,38,71
43,8477500,Bo Horvat,C,NYI,29,80,30,41,71
43,8475765,Vladimir Tarasenko,R,DET,33,79,28,43,71
43,8473994,Jamie Benn,L,DAL,35,82,28,43,71
43,8484144,Connor Bedard,C,CHI,19,67,26,45,71
43,8481528,Dylan Cozens,C,BUF,23,64,26,45,71
43,8475810,Bryan Rust,R,PIT,32,74,39,31,70
43,8471214,Alex Ovechkin,L,WSH,39,73,35,35,70
43,8480801,Brady Tkachuk,L,OTT,25,78,24,46,70
43,8479420,Tage Thompson,C,BUF,27,71,30,39,69
43,8480018,Nick Suzuki,C,MTL,25,74,25,44,69
43,8480023,Robert Thomas,C,STL,25,75,23,46,69
43,8476853,Morgan Rielly,D,TOR,30,73,14,55,69
43,8481540,Cole Caufield,R,MTL,23,75,39,29,68
43,8477942,Kevin Fiala,L,LAK,28,78,37,31,68
43,8478398,Kyle Connor,L,WPG,28,69,27,41,68
43,8475786,Zach Hyman,L,EDM,32,74,37,30,67
43,8482740,Wyatt Johnston,C,DAL,21,81,32,35,67
43,8477960,Adrian Kempe,R,LAK,28,81,31,36,67
43,8474679,Gustav Nyquist,C,NSH,35,74,24,43,67
43,8479542,Brandon Hagel,L,TBL,26,82,32,34,66
43,8474141,Patrick Kane,R,DET,36,79,26,40,66
43,8480039,Martin Necas,C,CAR,25,70,26,40,66
43,8480208,Drake Batherson,R,OTT,26,82,25,41,66
43,8478856,Conor Garland,R,VAN,28,69,24,42,66
43,8477951,Nick Schmaltz,C,UTA,28,81,19,47,66
43,8482093,Seth Jarvis,C,CAR,22,72,37,28,65
43,8477940,Nikolaj Ehlers,L,WPG,28,68,30,35,65
43,8476460,Mark Scheifele,C,WPG,31,70,30,35,65
43,8477949,Alex Tuch,R,BUF,28,67,28,37,65
43,8471685,Anze Kopitar,C,LAK,37,81,24,41,65
43,8478440,Dylan Strome,C,WSH,27,77,23,42,65
43,8480014,Gabriel Vilardi,C,WPG,25,70,33,31,64
43,8477494,Jonathan Drouin,L,COL,29,81,25,39,64
43,8476881,Tomas Hertl,C,VGK,31,75,24,40,64
43,8477503,Max Domi,C,TOR,29,80,23,41,64
43,8477504,Josh Morrissey,D,WPG,29,74,16,48,64
43,8479425,Filip Hronek,D,VAN,27,78,12,52,64
43,8473419,Brad Marchand,L,BOS,36,81,24,39,63
43,8478366,Frank Vatrano,R,ANA,30,74,31,31,62
43,8478449,Roope Hintz,C,DAL,28,80,28,34,62
43,8475158,Ryan O'Reilly,C,NSH,33,71,24,38,62
43,8480069,Cale Makar,D,COL,26,70,22,40,62
43,8480865,Noah Dobson,D,NYI,24,80,11,51,62
43,8479675,Trevor Moore,L,LAK,29,79,25,36,61
43,8476539,Jonathan Marchessault,R,NSH,34,74,35,24,59
43,8477409,Carter Verhaeghe,C,FLA,29,79,33,26,59
43,8476448,William Karlsson,C,VGK,31,78,24,35,59
43,8482745,Mason McTavish,C,ANA,21,70,22,37,59
43,8482078,Lucas Raymond,L,DET,22,77,17,42,59
43,8477955,Jared McCann,L,SEA,28,75,36,22,58
43,8475726,Tyler Toffoli,C,SJS,32,65,27,31,58
43,8478414,Timo Meier,R,NJD,28,73,24,34,58
43,8480839,Rasmus Dahlin,D,BUF,24,72,19,39,58
43,8474150,Mikael Backlund,C,CGY,35,77,19,39,58
43,8482124,Quinton Byfield,R,LAK,22,79,18,40,58
43,8479999,Casey Mittelstadt,C,COL,26,82,16,42,58
43,8475184,Chris Kreider,L,NYR,33,75,34,23,57
43,8478493,Joel Eriksson Ek,C,MIN,27,68,28,29,57
43,8482113,Anton Lundell,C,FLA,23,78,18,39,57
43,8478873,Troy Terry,R,ANA,27,68,24,32,56
43,8471215,Evgeni Malkin,C,PIT,38,71,19,37,56
43,8477346,MacKenzie Weegar,D,CGY,30,79,14,42,56
43,8478498,Jake DeBrusk,L,VAN,28,68,30,25,55
43,8482110,Dawson Mercer,C,NJD,23,73,24,31,55
43,8480064,Josh Norris,C,OTT,25,77,23,32,55
43,8474586,Jordan Eberle,R,SEA,34,77,22,33,55
43,8482720,Matthew Knies,L,TOR,22,76,17,38,55
43,8476792,Torey Krug,D,STL,33,78,16,39,55
43,8477456,J.T. Compher,L,DET,29,82,26,28,54
43,8477998,Warren Foegele,L,LAK,28,80,24,30,54
43,8478462,Nicolas Roy,C,VGK,27,80,19,35,54
43,8482097,Jack Quinn,R,BUF,23,67,17,37,54
43,8477407,Anthony Duclair,L,NYI,29,80,29,24,53
43,8479400,Pierre-Luc Dubois,L,WSH,26,73,26,27,53
43,8478975,Mason Marchment,L,DAL,29,81,25,28,53
43,8481068,Yegor Sharangovich,C,CGY,26,77,25,28,53
43,8475754,Brock Nelson,C,NYI,33,81,23,30,53
43,8484145,Zach Benson,L,BUF,19,75,21,32,53
43,8478047,Michael Bunting,L,PIT,29,71,19,34,53
43,8478401,Pavel Zacha,C,BOS,27,80,18,35,53
43,8480028,Morgan Frost,C,PHI,25,70,16,37,53
43,8474578,Erik Karlsson,D,PIT,34,80,12,41,53
43,8477496,Elias Lindholm,C,BOS,30,79,16,36,52
43,8482684,Luke Hughes,D,NJD,21,67,16,36,52
43,8476905,Chandler Stephenson,C,SEA,30,76,10,42,52
43,8482665,Matty Beniers,C,SEA,22,72,9,43,52
43,8478038,Devon Toews,D,COL,30,70,8,44,52
43,8480036,Miro Heiskanen,D,DAL,25,75,4,48,52
43,8477476,Artturi Lehkonen,L,COL,29,80,23,28,51
43,8477932,Aaron Ekblad,D,FLA,28,76,17,34,51
43,8474590,John Carlson,D,WSH,34,66,12,39,51
43,8475167,Victor Hedman,D,TBL,34,78,10,41,51
43,8478042,Viktor Arvidsson,L,EDM,31,74,21,29,50
43,8477511,Anthony Mantha,R,CGY,30,76,19,31,50
43,8473986,Alex Killorn,L,ANA,35,76,18,32,50
43,8475745,Charlie Coyle,C,BOS,32,80,16,34,50
43,8480015,Owen Tippett,R,PHI,25,74,25,24,49
43,8481560,Arthur Kaliyev,R,LAK,23,79,23,26,49
43,8475191,Reilly Smith,R,NYR,33,78,23,26,49
43,8477479,Tyler Bertuzzi,L,CHI,29,64,22,27,49
43,8483808,Andrei Kuzmenko,L,CGY,28,71,22,27,49
43,8475169,Evander Kane,L,EDM,33,78,21,28,49
43,8473512,Claude Giroux,R,OTT,36,80,20,29,49
43,8477416,Oliver Bjorkstrand,R,SEA,29,65,19,30,49
43,8476906,Shayne Gostisbehere,D,CAR,31,80,8,41,49
43,8476432,Boone Jenner,C,CBJ,31,69,30,18,48
43,8475151,Kyle Palmieri,C,NYI,33,76,25,23,48
43,8482699,Dylan Guenther,R,UTA,21,70,23,25,48
43,8482667,William Eklund,L,SJS,22,66,20,28,48
43,8482159,Tyson Foerster,R,PHI,22,74,16,32,48
43,8480803,Evan Bouchard,D,EDM,25,75,10,38,48
43,8474641,Adam Henrique,C,EDM,34,73,22,25,47
43,8482109,Alexis Lafrenière,L,NYR,23,73,21,26,47
43,8482702,Logan Stankoven,C,DAL,21,82,20,27,47
43,8477986,Brandon Montour,D,SEA,30,75,16,31,47
43,8476875,Mike Matheson,D,MTL,30,73,13,34,47
43,8481542,Moritz Seider,D,DET,23,79,8,39,47
43,8477935,Sam Bennett,C,FLA,28,77,23,23,46
43,8483515,Juraj Slafkovsky,L,MTL,20,74,18,28,46
43,8477429,Andrew Copp,C,DET,30,81,17,29,46
43,8481711,Matias Maccelli,L,UTA,24,78,16,30,46
43,8475170,Brayden Schenn,C,STL,33,75,15,31,46
43,8478397,Rasmus Andersson,D,CGY,28,77,15,31,46
43,8471724,Kris Letang,D,PIT,37,81,14,32,46
43,8477021,Alex Kerfoot,C,UTA,30,74,11,35,46
43,8482712,Oskar Olausson,R,COL,22,79,8,38,46
43,8476399,Blake Coleman,C,CGY,33,74,27,18,45
43,8477497,Sean Monahan,C,CBJ,30,71,21,24,45
43,8475794,Tyler Seguin,C,DAL,32,82,20,25,45
43,8476479,Phillip Danault,C,LAK,31,76,13,32,45
43,8475798,Mikael Granlund,C,SJS,32,71,11,34,45
43,8475764,Cam Fowler,D,ANA,33,73,9,36,45
43,8480797,Joel Farabee,L,PHI,24,66,19,25,44
43,8478542,Evan Rodrigues,C,FLA,31,72,18,26,44
43,8474102,David Perron,L,OTT,36,74,16,28,44
43,8477964,Ivan Barbashev,C,VGK,29,71,16,28,44
43,8475753,Justin Faulk,D,STL,32,72,12,32,44
43,8479345,Jakob Chychrun,D,WSH,26,66,11,33,44
43,8475218,Mattias Ekholm,D,EDM,34,78,11,33,44
43,8478407,Vince Dunn,D,SEA,28,71,4,40,44
43,8478519,Anthony Cirelli,C,TBL,27,81,24,19,43
43,8474149,Evgenii Dadonov,R,DAL,35,79,22,21,43
43,8471698,T.J. Oshie,R,WSH,38,67,22,21,43
43,8482092,Ridly Greig,C,OTT,22,76,22,21,43
43,8481618,Alex Newhook,C,MTL,23,75,19,24,43
43,8474053,Logan Couture,C,SJS,35,62,18,25,43
43,8478469,Thomas Chabot,D,OTT,27,77,14,29,43
43,8478055,Gustav Forsling,D,FLA,28,74,9,34,43
43,8475793,Ryan Johansen,C,PHI,32,76,22,20,42
43,8476483,Rickard Rakell,R,PIT,31,71,21,21,42
43,8480829,Jesperi Kotkaniemi,C,CAR,24,70,20,22,42
43,8478057,Dakota Joshua,C,VAN,28,71,20,22,42
43,8484153,Leo Carlsson,C,ANA,20,69,18,24,42
43,8481596,Shane Pinto,C,OTT,24,78,16,26,42
43,8478458,John (Jack) Roslovic,C,CAR,27,66,16,26,42
43,8479325,Charlie McAvoy,D,BOS,27,72,7,35,42
43,8475799,Nino Niederreiter,R,WPG,32,73,23,18,41
43,8482146,Luke Evangelista,R,NSH,22,71,23,18,41
43,8480009,Eeli Tolvanen,R,SEA,25,69,20,21,41
43,8483490,Pavel Mintyukov,D,ANA,21,77,12,29,41
43,8477447,Shea Theodore,D,VGK,29,62,10,31,41
43,8480188,Fabian Zetterlund,L,SJS,25,62,21,19,40
43,8478474,Lawson Crouse,L,UTA,27,69,20,20,40
43,8476880,Tom Wilson,R,WSH,30,67,19,21,40
43,8479992,Michael Rasmussen,C,DET,25,78,17,23,40
43,8483431,Logan Cooley,C,UTA,20,73,16,24,40
43,8476458,Ryan Strome,C,ANA,31,67,16,24,40
43,8478115,Pierre Engvall,L,NYI,28,75,15,25,40
43,8478233,Andrew Mangiapane,L,WSH,28,65,13,27,40
43,8475287,Erik Haula,L,NJD,33,73,12,28,40
43,8476854,Hampus Lindholm,D,BOS,30,75,10,30,40
43,8476923,Damon Severson,D,CBJ,30,81,5,35,40
43,8475768,Jaden Schwartz,C,SEA,32,68,20,19,39
43,8481524,Bowen Byram,D,BUF,23,68,16,23,39
43,8476925,Colton Sissons,C,NSH,31,66,16,23,39
43,8481533,Trevor Zegras,C,ANA,23,72,12,27,39
43,8478396,Noah Hanifin,D,VGK,27,64,10,29,39
43,8477444,Andre Burakovsky,L,SEA,29,67,14,24,38
43,8476462,Dougie Hamilton,D,NJD,31,69,10,28,38
43,8477948,Travis Sanheim,D,PHI,28,73,10,28,38
43,8479410,Mikhail Sergachev,D,UTA,26,69,9,29,38
43,8482122,Brock Faber,D,MIN,22,77,8,30,38
43,8476917,Adam Pelech,D,NYI,30,77,7,31,38
43,8470613,Brent Burns,D,CAR,39,78,6,32,38
43,8474563,Drew Doughty,D,LAK,35,70,5,33,38
43,8475314,Anders Lee,L,NYI,34,75,31,6,37
43,8479353,Brett Howden,C,VGK,26,69,18,19,37
43,8481186,Logan O'Connor,R,COL,28,79,17,20,37
43,8480068,Ryan Poehling,C,PHI,25,69,14,23,37
43,8482149,Cole Perfetti,C,WPG,22,69,13,24,37
43,8476461,Sean Couturier,C,PHI,32,73,12,25,37
43,8478438,Tommy Novak,C,NSH,27,70,8,29,37
43,8476958,Jaccob Slavin,D,CAR,30,69,5,32,37
43,8476438,Brandon Saad,L,STL,32,70,22,14,36
43,8480113,Alex Iafallo,L,WPG,31,67,20,16,36
43,8477451,Ryan Hartman,R,MIN,30,68,18,18,36
43,8476474,Stefan Noesen,R,NJD,31,69,17,19,36
43,8473422,Nick Foligno,L,CHI,37,63,16,20,36
43,8479351,Sam Steel,C,DAL,26,80,15,21,36
43,8476292,Ondrej Palat,L,NJD,33,66,11,25,36
43,8482105,Jake Sanderson,D,OTT,22,70,10,26,36
43,8481703,Valtteri Puustinen,R,PIT,25,63,6,30,36
43,8479525,Ross Colton,C,COL,28,80,17,18,35
43,8475722,Jason Zucker,L,BUF,32,63,16,19,35
43,8482175,JJ Peterka,R,BUF,22,70,14,21,35
43,8480748,Kiefer Sherwood,L,VAN,29,53,14,21,35
43,8476872,Scott Laughton,C,PHI,30,73,11,24,35
43,8478891,Mason Appleton,C,WPG,28,75,10,25,35
43,8482660,Kent Johnson,C,CBJ,22,69,8,27,35
43,8482671,Owen Power,D,BUF,22,71,8,27,35
43,8480145,Neal Pionk,D,WPG,29,72,5,30,35
43,8484166,Adam Fantilli,C,CBJ,20,61,20,14,34
43,8475791,Taylor Hall,L,CHI,33,67,16,18,34
43,8483505,Matthew Poitras,C,BOS,20,71,14,20,34
43,8479339,Patrik Laine,L,CBJ,26,65,14,20,34
43,8481535,Nils Hoglander,L,VAN,24,66,17,16,33
43,8481554,Kaapo Kakko,R,NYR,23,69,16,17,33
43,8482475,Yegor Chinakhov,R,CBJ,23,64,15,18,33
43,8475848,Brendan Gallagher,R,MTL,32,69,15,18,33
43,8477953,Kasperi Kapanen,R,STL,28,67,15,18,33
43,8478466,Daniel Sprong,R,VAN,27,72,12,21,33
43,8477498,Darnell Nurse,D,EDM,29,73,12,21,33
43,8480802,Ryan McLeod,C,BUF,25,67,11,22,33
43,8476927,Teddy Blueger,C,VAN,30,68,11,22,33
43,8476826,Yanni Gourde,C,SEA,33,75,9,24,33
43,8477495,Seth Jones,D,CHI,30,66,8,25,33
43,8475200,Dmitry Orlov,D,CAR,33,76,7,26,33
43,8480817,K'Andre Miller,D,NYR,24,73,6,27,33
43,8476885,Jacob Trouba,D,NYR,30,67,5,28,33
43,8480185,Eetu Luostarinen,C,FLA,26,73,16,16,32
43,8475763,Kevin Hayes,R,PIT,32,72,16,16,32
43,8475714,Calle Jarnkrok,C,TOR,33,71,16,16,32
43,8480789,Oliver Wahlstrom,R,NYI,24,77,15,17,32
43,8476467,Jamie Oleksiak,D,SEA,32,69,10,22,32
43,8481577,Philip Tomasino,C,NSH,23,67,9,23,32
43,8481546,Cam York,D,PHI,23,71,7,25,32
43,8480871,Adam Boqvist,D,FLA,24,75,6,26,32
43,8482055,Drew O'Connor,L,PIT,26,63,16,15,31
43,8480459,Pius Suter,C,VAN,28,67,15,16,31
43,8478046,Danton Heinen,L,VAN,29,72,13,18,31
43,8476419,Jean-Gabriel Pageau,C,NYI,32,78,12,19,31
43,8484203,Bradly Nadeau,L,CAR,19,62,12,19,31
43,8481580,Connor McMichael,C,WSH,23,62,12,19,31
43,8479661,Tanner Jeannot,L,LAK,27,77,11,20,31
43,8475193,Tomas Tatar,L,NJD,34,72,11,20,31
43,8476480,Vladislav Namestnikov,C,WPG,32,65,10,21,31
43,8476869,Brady Skjei,D,NSH,30,68,7,24,31
43,8476463,Jonas Brodin,D,MIN,31,76,5,26,31
43,8477506,Ryan Pulock,D,NYI,30,77,5,26,31
43,8481606,Jordan Spence,D,LAK,23,69,4,27,31
43,8476882,Teuvo Teravainen,C,CHI,30,57,14,16,30
43,8480855,Jack McBain,C,UTA,24,75,14,16,30
43,8477919,Frederick Gaudreau,C,MIN,31,70,12,18,30
43,8479996,Cody Glass,C,NSH,25,64,11,19,30
43,8480835,Jack Drury,C,CAR,24,61,9,21,30
43,8478133,Jake Evans,C,MTL,28,66,9,21,30
43,8481656,Aliaksei Protas,C,WSH,23,59,8,22,30
43,8478500,Ivan Provorov,D,CBJ,27,79,3,27,30
43,8480049,Dylan Samberg,D,WPG,25,66,3,27,30
43,8479365,Trent Frederic,C,BOS,26,73,19,10,29
43,8481582,Nicholas Robertson,L,TOR,23,69,19,10,29
43,8483524,Shane Wright,C,SEA,20,65,15,14,29
43,8470621,Corey Perry,R,EDM,39,69,14,15,29
43,8473533,Jordan Staal,C,CAR,36,66,14,15,29
43,8480798,Philipp Kurashev,C,CHI,25,61,12,17,29
43,8478472,Mathieu Joseph,R,STL,27,71,11,18,29
43,8480078,Filip Chytil,C,NYR,25,61,10,19,29
43,8480434,Sean Durzi,D,UTA,26,70,7,22,29
43,8483445,Cutter Gauthier,L,ANA,20,61,7,22,29
43,8476422,Mike Reilly,D,NYI,31,78,7,22,29
43,8482067,Connor Mackey,D,NYR,28,66,5,24,29
43,8477969,Marcus Pettersson,D,PIT,28,81,3,26,29
43,8476921,Jordan Martinook,L,CAR,32,55,14,14,28
43,8475760,Nick Bjugstad,C,UTA,32,74,14,14,28
43,8481032,Paul Cotter,C,NJD,25,64,13,15,28
43,8480849,Barrett Hayton,C,UTA,24,68,12,16,28
43,8481093,Rafael Harvey-Pinard,L,MTL,25,57,11,17,28
43,8477989,Christian Dvorak,C,MTL,28,71,11,17,28
43,8478043,Sam Lafferty,C,BUF,29,61,11,17,28
43,8474565,Alex Pietrangelo,D,VGK,34,58,8,20,28
43,8474716,Jared Spurgeon,D,MIN,35,75,8,20,28
43,8482624,Daniil Miromanov,D,CGY,27,67,5,23,28
43,8482705,Cole Sillinger,C,CBJ,21,61,15,12,27
43,8476981,Josh Anderson,R,MTL,30,66,15,12,27
43,8482074,Connor Zary,C,CGY,23,61,13,14,27
43,8478013,Jake Walman,D,SJS,28,68,11,16,27
43,8482111,Justin Barron,D,MTL,23,67,11,16,27
43,8478413,Jordan Greenway,L,BUF,27,65,10,17,27
43,8479390,Taylor Raddysh,R,WSH,26,62,8,19,27
43,8476902,Esa Lindell,D,DAL,30,77,6,21,27
43,8480878,Nils Lundkvist,D,DAL,24,76,5,22,27
43,8477952,Robby Fabbri,C,ANA,28,70,17,9,26
43,8481601,Simon Holmstrom,R,NYI,23,70,17,9,26
43,8476392,Adam Lowry,C,WPG,31,63,15,11,26
43,8478109,Victor Olofsson,L,VGK,29,70,15,11,26
43,8479591,Michael Eyssimont,C,TBL,28,80,14,12,26
43,8479987,Morgan Geekie,C,BOS,26,74,13,13,26
43,8478463,Anthony Beauvillier,L,PIT,27,65,13,13,26
43,8477353,Tyler Motte,C,DET,29,75,13,13,26
43,8478020,Michael Amadio,R,OTT,28,76,12,14,26
43,8482101,Danil Gushchin,L,SJS,22,59,12,14,26
43,8477406,Mattias Janmark,C,EDM,32,72,12,14,26
43,8475149,Marcus Johansson,L,MIN,34,61,11,15,26
43,8479941,Justin Danforth,R,CBJ,31,57,11,15,26
43,8481523,Kirby Dach,C,MTL,23,69,10,16,26
43,8481481,Blake Lizotte,C,PIT,27,61,10,16,26
43,8480220,Noah Cates,L,PHI,25,68,9,17,26
43,8474715,Cameron Atkinson,R,TBL,35,80,9,17,26
43,8481014,Alexander Romanov,D,NYI,24,76,6,20,26
43,8479639,Dylan Coghlan,D,WPG,26,64,5,21,26
43,8478911,Matt Roy,D,WSH,29,70,4,22,26
43,8477478,William Carrier,L,CAR,30,55,15,10,25
43,8476897,Oskar Sundqvist,C,STL,30,67,12,13,25
43,8481604,Pavel Dorofeyev,L,VGK,24,65,11,14,25
43,8473563,Nicklas Backstrom,C,WSH,37,55,11,14,25
43,8481641,Joel Kiviranta,L,COL,28,78,11,14,25
43,8477426,Nicholas Paul,L,TBL,29,82,10,15,25
43,8479316,Luke Kunin,C,SJS,27,52,7,18,25
43,8477220,Nate Schmidt,D,FLA,33,70,6,19,25
43,8482192,Isaak Phillips,D,CHI,23,53,3,22,25
43,8482089,Jake Neighbours,L,STL,22,66,15,9,24
43,8482125,Alexander Holtz,R,VGK,22,74,14,10,24
43,8481624,Ilya Mikheyev,R,CHI,30,50,13,11,24
43,8479393,Noah Gregor,L,OTT,26,74,12,12,24
43,8478432,Christian Fischer,R,DET,27,73,11,13,24
43,8476918,Jimmy Vesey,L,NYR,31,65,11,13,24
43,8478434,Keegan Kolesar,R,VGK,27,70,11,13,24
43,8480336,Sean Walker,D,CAR,30,72,8,16,24
43,8480980,Connor Dewar,C,TOR,25,74,8,16,24
43,8479976,Juuso Valimaki,D,UTA,26,69,6,18,24
43,8478882,Vladislav Gavrikov,D,LAK,29,66,4,20,24
43,8481521,Ronnie Attard,D,PHI,25,58,4,20,24
43,8480035,Henri Jokiharju,D,BUF,25,61,4,20,24
43,8482655,Janis Moser,D,TBL,24,80,3,21,24
43,8478507,John Marino,D,UTA,27,62,0,24,24
43,8475231,Casey Cizikas,C,NYI,33,69,11,12,23
43,8481704,Juuso Parssinen,C,NSH,23,58,10,13,23
43,8482737,Zack Bolduc,C,STL,21,57,10,13,23
43,8475855,Jesper Fast,R,CAR,33,52,10,13,23
43,8479293,Brandon Tanev,L,SEA,33,57,8,15,23
43,8477505,Alexander Wennberg,C,SJS,30,59,7,16,23
43,8482133,Thomas Bordeleau,C,SJS,22,65,6,17,23
43,8475171,Oliver Ekman-Larsson,D,TOR,33,69,6,17,23
43,8477488,Brett Pesce,D,NJD,30,73,5,18,23
43,8475790,Erik Gudbranson,D,CBJ,32,77,4,19,23
43,8480144,David Kampf,C,TOR,29,68,3,20,23
43,8476892,Colton Parayko,D,STL,31,74,2,21,23
43,8480893,Kirill Marchenko,R,CBJ,24,65,13,9,22
43,8477446,Michael McCarron,R,NSH,29,53,12,10,22
43,8477903,Garnet Hathaway,R,PHI,33,64,11,11,22
43,8477450,Jason Dickinson,C,CHI,29,59,10,12,22
43,8477015,Connor Brown,R,EDM,30,59,10,12,22
43,8474189,Lars Eller,C,PIT,35,65,9,13,22
43,8477947,Sonny Milano,L,WSH,28,63,9,13,22
43,8476329,Travis Boyd,C,MIN,31,61,8,14,22
43,8479414,Nathan Bastian,R,NJD,27,61,8,14,22
43,8481013,Jonatan Berggren,R,DET,24,56,7,15,22
43,8481553,Bobby Brink,R,PHI,23,64,6,16,22
43,8476525,Colin Miller,D,WPG,32,70,5,17,22
43,8474574,Tyler Myers,D,VAN,34,70,5,17,22
43,8476331,Dylan DeMelo,D,WPG,31,66,3,19,22
43,8476979,Erik Gustafsson,D,DET,32,76,3,19,22
43,8478585,Derek Ryan,C,EDM,38,62,13,8,21
43,8480205,Emil Bemstrom,C,PIT,25,50,12,9,21
43,8482809,Jackson Blake,R,CAR,21,64,11,10,21
43,8477987,Ryan Donato,C,CHI,28,62,10,11,21
43,8481522,Peyton Krebs,C,BUF,23,50,9,12,21
43,8481581,Thomas Harley,D,DAL,23,72,7,14,21
43,8481517,Brett Leason,R,ANA,25,58,7,14,21
43,8480762,Eric Robinson,L,CAR,29,53,6,15,21
43,8477507,Nikita Zadorov,D,BOS,29,69,6,15,21
43,8481527,Kaedan Korczak,D,VGK,23,42,5,16,21
43,8476278,Colin Blackwell,C,DAL,31,76,4,17,21
43,8473507,Jeff Petry,D,DET,37,70,3,18,21
43,8476312,Josh Manson,D,COL,33,62,3,18,21
43,8481059,Scott Perunovich,D,STL,26,65,2,19,21
43,8476374,Sean Kuraly,C,CBJ,31,59,10,10,20
43,8480021,Jack Studnicka,C,LAK,25,59,10,10,20
43,8483468,Jiri Kulich,C,BUF,20,58,7,13,20
43,8481441,Joe Snively,C,DET,28,68,7,13,20
43,8483565,Nick Blankenburg,D,NSH,26,65,7,13,20
43,8482117,Lukas Reichel,L,CHI,22,58,6,14,20
43,8480995,Pontus Holmberg,R,TOR,25,60,6,14,20
43,8478970,Jalen Chatfield,D,CAR,28,69,5,15,20
43,8477435,Ryan Graves,D,PIT,29,71,3,17,20
43,8478851,Alexandre Carrier,D,NSH,28,73,3,17,20
43,8478443,Brandon Carlo,D,BOS,28,63,3,17,20
43,8480222,Sebastian Aho,D,PIT,28,74,3,17,20
43,8480043,Timothy Liljegren,D,TOR,25,63,2,18,20
43,8479982,Conor Timmins,D,TOR,26,54,1,19,20
43,8482087,Kaiden Guhle,D,MTL,22,59,1,19,20
43,8482077,Dylan Holloway,L,EDM,23,55,13,6,19
43,8477425,Miles Wood,L,COL,29,75,11,8,19
43,8482803,Olen Zellweger,D,ANA,21,63,11,8,19
43,8483491,Ivan Miroshnichenko,L,WSH,20,57,10,9,19
43,8476878,Zemgus Girgensons,C,TBL,30,80,10,9,19
43,8480813,Joe Veleno,C,DET,24,77,8,11,19
43,8473453,Trevor Lewis,C,LAK,37,75,8,11,19
43,8479370,Tyson Jost,C,CAR,26,48,7,12,19
43,8475324,Nick Jensen,D,OTT,34,65,7,12,19
43,8482073,Braden Schneider,D,NYR,23,62,6,13,19
43,8477365,Connor Clifton,D,BUF,29,54,5,14,19
43,8482245,Artem Zub,D,OTT,29,76,4,15,19
43,8479324,Ryan Lindgren,D,NYR,26,70,4,15,19
43,8474151,Ryan McDonagh,D,TBL,35,79,3,16,19
43,8475233,David Savard,D,MTL,34,70,3,16,19
43,8479398,Samuel Girard,D,COL,26,61,1,18,19
43,8476988,Matt Benning,D,SJS,30,67,1,18,19
43,8482679,Matt Coronato,R,CGY,22,66,12,6,18
43,8480281,Alexey Toropchenko,R,STL,25,58,11,7,18
43,8482259,Bobby McMann,C,TOR,28,54,10,8,18
43,8479368,Max Jones,L,BOS,26,62,9,9,18
43,8480003,Jesper Boqvist,C,FLA,26,66,8,10,18
43,8476856,Mathew Dumba,D,DAL,30,63,8,10,18
43,8481751,Lukas Rousek,R,BUF,25,38,8,10,18
43,8483457,Lane Hutson,D,MTL,20,64,7,11,18
43,8477979,Nicolas Aube-Kubel,R,BUF,28,63,7,11,18
43,8477380,Jonny Brodzinski,C,NYR,31,58,7,11,18
43,8476873,Mark Jankowski,C,NSH,30,40,4,14,18
43,8476891,Matthew Grzelcyk,D,PIT,30,75,3,15,18
43,8479371,Dante Fabbro,D,NSH,26,65,3,15,18
43,8478840,Will Borgen,D,SEA,28,64,2,16,18
43,8482157,Will Cuylle,L,NYR,22,58,11,6,17
43,8479619,Michael Carcone,L,UTA,28,60,10,7,17
43,8480074,Alexandre Texier,C,STL,25,59,9,8,17
43,8477392,Hudson Fasching,R,NYI,29,68,8,9,17
43,8482079,Marco Rossi,C,MIN,23,52,7,10,17
43,8480448,Parker Kelly,L,COL,25,72,6,11,17
43,8480355,Mark Kastelic,C,BOS,25,58,6,11,17
43,8475690,Chris Tanev,D,TOR,35,60,4,13,17
43,8476874,Olli Maatta,D,DET,30,65,4,13,17
43,8478452,Caleb Jones,D,LAK,27,60,4,13,17
43,8482749,Joshua Roy,R,MTL,21,59,3,14,17
43,8479372,Joshua Mahura,D,SEA,26,53,3,14,17
43,8476931,Jake McCabe,D,TOR,31,66,1,16,17
43,8480070,Ian Mitchell,D,BOS,25,51,1,16,17
43,8479980,Nicolas Hague,D,VGK,26,47,1,16,17
43,8475842,Sam Carrick,C,NYR,32,58,10,6,16
43,8479066,Ryan Lomberg,L,CGY,30,66,9,7,16
43,8482062,Cole Smith,L,NSH,29,57,7,9,16
43,8480806,Isac Lundestrom,C,ANA,25,60,7,9,16
43,8480157,Calle Rosen,D,COL,30,47,7,9,16
43,8475181,Nick Leddy,D,STL,33,62,6,10,16
43,8479402,Jake Bean,D,CGY,26,62,6,10,16
43,8479983,Mario Ferraro,D,SJS,26,62,6,10,16
43,8480192,Johnathan Kovacevic,D,NJD,27,61,6,10,16
43,8476457,Adam Larsson,D,SEA,32,72,5,11,16
43,8482807,Ethan Del Mastro,D,CHI,21,57,5,11,16
43,8478859,Niko Mikkola,D,FLA,28,54,5,11,16
43,8483482,Tristan Luneau,D,ANA,20,63,4,12,16
43,8482730,Brandt Clarke,D,LAK,21,47,4,12,16
43,8480807,Mattias Samuelsson,D,BUF,24,54,3,13,16
43,8481178,Egor Zamula,D,PHI,24,53,3,13,16
43,8477845,Trevor van Riemsdyk,D,WSH,33,58,1,15,16
43,8481028,Martin Pospisil,C,CGY,25,54,10,5,15
43,8478569,Noel Acciari,C,PIT,33,62,8,7,15
43,8476822,Luke Glendening,C,TBL,35,81,8,7,15
43,8476960,Andreas Athanasiou,C,CHI,30,47,7,8,15
43,8481477,Nico Sturm,C,SJS,29,59,7,8,15
43,8476889,Radek Faksa,C,STL,30,57,7,8,15
43,8477839,Conor Sheary,L,TBL,32,79,6,9,15
43,8477508,Curtis Lazar,C,NJD,29,56,6,9,15
43,8478508,Yakov Trenin,C,MIN,27,58,5,10,15
43,8480873,Rasmus Sandin,D,WSH,24,58,5,10,15
43,8477369,Carson Soucy,D,VAN,30,60,5,10,15
43,8482148,Hendrix Lapierre,C,WSH,22,54,5,10,15
43,8478451,Ethan Bear,D,WSH,27,53,5,10,15
43,8482634,Alex Steeves,C,TOR,25,46,4,11,15
43,8475179,Dmitry Kulikov,D,FLA,34,63,4,11,15
43,8475343,Nic Dowd,C,WSH,34,55,3,12,15
43,8474673,TJ Brodie,D,CHI,34,55,3,12,15
43,8484149,Gavin Brindley,C,CBJ,20,49,3,12,15
43,8482176,Wyatt Kaiser,D,CHI,22,49,3,12,15
43,8481708,Zac Jones,D,NYR,24,53,2,13,15
43,8476429,Scott Mayfield,D,NYI,32,71,0,15,15
43,8482762,Simon Edvinsson,D,DET,21,55,12,2,14
43,8479336,Carl Grundstrom,R,SJS,27,53,11,3,14
43,8483499,Liam Ohgren,L,MIN,20,54,8,6,14
43,8480289,Morgan Barron,C,WPG,26,56,8,6,14
43,8475225,Craig Smith,C,CHI,35,51,7,7,14
43,8479944,Zach Aston-Reese,C,VGK,30,47,7,7,14
43,8482744,James Malatesta,L,CBJ,21,49,6,8,14
43,8477573,Nathan Walker,L,STL,30,51,5,9,14
43,8475462,Radko Gudas,D,ANA,34,66,4,10,14
43,8470600,Ryan Suter,D,STL,39,67,4,10,14
43,8475279,Ben Chiarot,D,DET,33,66,3,11,14
43,8478416,Erik Cernak,D,TBL,27,74,2,12,14
43,8480001,Urho Vaakanainen,D,ANA,25,63,0,14,14
43,8481716,Dmitri Voronkov,L,CBJ,24,42,9,4,13
43,8478831,Kevin Stenlund,C,UTA,28,57,9,4,13
43,8481518,Nolan Foote,L,NJD,24,37,8,5,13
43,8482784,Zach Dean,C,STL,21,37,8,5,13
43,8480025,MacKenzie Entwistle,R,FLA,25,62,7,6,13
43,8479718,Alex Barré-Boulet,C,MTL,27,49,7,6,13
43,8482155,Alex Laferriere,R,LAK,23,70,6,7,13
43,8479439,Jacob MacDonald,D,COL,31,55,6,7,13
43,8477482,Zachary Sanford,L,CHI,30,41,5,8,13
43,8479520,Brandon Duhaime,R,WSH,27,56,5,8,13
43,8481161,Jake Christiansen,D,CBJ,25,54,5,8,13
43,8483495,Simon Nemec,D,NJD,20,48,5,8,13
43,8477070,Liam O'Brien,C,UTA,30,54,5,8,13
43,8482166,Shakir Mukhamadullin,D,SJS,22,58,4,9,13
43,8482142,Jamie Drysdale,D,PHI,22,53,3,10,13
43,8477962,Brendan Lemieux,L,CAR,28,42,3,10,13
43,8479998,Mikey Anderson,D,LAK,25,65,2,11,13
43,8475208,Brian Dumoulin,D,ANA,33,53,2,11,13
43,8475188,Brayden McNabb,D,VGK,33,60,1,12,13
43,8480246,Nick Perbix,D,TBL,26,68,1,12,13
43,8480887,Jordan Harris,D,MTL,24,49,1,12,13
43,8480172,Jan Rutta,D,SJS,34,59,0,13,13
43,8475455,Brenden Dillon,D,NJD,34,54,0,13,13
43,8480990,Declan Chisholm,D,MIN,24,45,7,5,12
43,8479315,Joey Anderson,R,CHI,26,54,6,6,12
43,8483466,Kevin Korchinski,D,CHI,20,54,6,6,12
43,8478211,Dryden Hunt,L,CGY,29,53,6,6,12
43,8482153,Brendan Brisson,C,VGK,23,34,6,6,12
43,8476624,Barclay Goodrow,C,SJS,31,52,5,7,12
43,8477931,Tomas Nosek,L,FLA,32,56,4,8,12
43,8478399,Jonas Siegenthaler,D,NJD,27,65,3,9,12
43,8477499,Rasmus Ristolainen,D,PHI,30,59,3,9,12
43,8474567,Zach Bogosian,D,MIN,34,63,3,9,12
43,8478424,Jansen Harkins,C,ANA,27,45,3,9,12
43,8481019,David Gustafsson,C,WPG,24,42,3,9,12
43,8475718,Justin Holl,D,DET,32,58,3,9,12
43,8478178,Darren Raddysh,D,TBL,28,69,3,9,12
43,8480860,Kevin Bahl,D,CGY,24,57,2,10,12
43,8477018,Ben Hutton,D,VGK,31,50,2,10,12
43,8479369,Andrew Peeke,D,BOS,26,58,2,10,12
43,8477384,Joshua Brown,D,EDM,30,39,2,10,12
43,8476879,Cody Ceci,D,EDM,31,69,1,11,12
43,8478421,A.J. Greer,L,FLA,28,55,7,4,11
43,8477938,Haydn Fleury,D,WPG,28,45,6,5,11
43,8479772,Zack MacEwen,R,OTT,28,47,6,5,11
43,8477851,Jordan Oesterle,D,BOS,32,39,6,5,11
43,8474034,Patrick Maroon,L,CHI,36,53,5,6,11
43,8479671,Mathieu Olivier,R,CBJ,27,41,5,6,11
43,8481537,Nikita Okhotiuk,D,CGY,24,60,4,7,11
43,8476994,Vinnie Hinostroza,C,NSH,30,48,4,7,11
43,8480252,Cole Guttman,C,CHI,25,41,4,7,11
43,8482859,Zack Ostapchuk,C,OTT,21,58,4,7,11
43,8481599,Victor Soderstrom,D,UTA,23,43,4,7,11
43,8471709,Marc-Edouard Vlasic,D,SJS,37,62,3,8,11
43,8480011,Klim Kostin,C,SJS,25,51,3,8,11
43,8479348,Kale Clague,D,BUF,26,44,3,8,11
43,8474013,Ian Cole,D,UTA,35,58,2,9,11
43,8478468,Jeremy Lauzon,D,NSH,27,51,2,9,11
43,8474568,Luke Schenn,D,NSH,35,53,2,9,11
43,8479986,Kole Lind,R,DAL,26,51,2,9,11
43,8480073,Erik Brannstrom,D,COL,25,63,1,10,11
43,8481600,Tobias Bjornfot,D,FLA,23,34,1,10,11
43,8480891,Michael Kesselring,D,UTA,24,65,0,11,11
43,8478409,Anthony Richard,C,PHI,28,36,7,3,10
43,8480441,Trey Fix-Wolansky,R,CBJ,25,41,6,4,10
43,8482652,Walker Duehr,R,CGY,27,47,6,4,10
43,8481532,Alex Turcotte,C,LAK,23,44,5,5,10
43,8476442,Matt Nieto,L,PIT,32,50,5,5,10
43,8471817,Ryan Reaves,R,TOR,37,58,5,5,10
43,8479359,Beck Malenstyn,L,BUF,26,47,4,6,10
43,8475750,Jon Merrill,D,MIN,32,61,4,6,10
43,8475220,Marcus Foligno,L,MIN,33,54,3,7,10
43,8478136,Jake Middleton,D,MIN,28,73,3,7,10
43,8479291,Kevin Rooney,C,CGY,31,44,3,7,10
43,8476952,Dominic Toninato,C,WPG,30,30,3,7,10
43,8482177,Marat Khusnutdinov,C,MIN,22,38,3,7,10
43,8481567,Henry Thrun,D,SJS,23,50,2,8,10
43,8474166,Alec Martinez,D,CHI,37,47,1,9,10
43,8476967,Brett Kulak,D,EDM,30,65,0,10,10
43,8482659,Josh Doan,R,UTA,22,51,6,3,9
43,8479344,Jesse Puljujarvi,R,PIT,26,45,5,4,9
43,8480848,Ty Dellandrea,C,SJS,24,38,5,4,9
43,8476469,Joel Armia,R,MTL,31,58,4,5,9
43,8482451,Mikael Pyyhtia,L,CBJ,23,41,4,5,9
43,8480844,Grigori Denisenko,L,VGK,24,31,4,5,9
43,8479994,Jaret Anderson-Dolan,C,WPG,25,39,3,6,9
43,8475177,Calvin de Haan,D,COL,33,43,3,6,9
43,8481617,Vasily Podkolzin,R,VAN,23,50,2,7,9
43,8482095,Tyler Kleven,D,OTT,22,42,2,7,9
43,8483630,Pavol Regenda,L,ANA,25,29,2,7,9
43,8476913,Devin Shore,C,MIN,30,41,2,7,9
43,8479442,Troy Stecher,D,EDM,30,53,1,8,9
43,8479638,Justin Brazeau,R,BOS,26,37,8,0,8
43,8476934,Brock McGinn,L,ANA,30,44,5,3,8
43,8483493,Frank Nazar,C,CHI,20,54,5,3,8
43,8477401,John Hayden,C,SEA,29,28,5,3,8
43,8483397,Marc McLaughlin,C,BOS,25,31,4,4,8
43,8478146,Matthew Highmore,C,OTT,28,28,4,4,8
43,8482145,Mavrik Bourque,C,DAL,22,49,4,4,8
43,8482666,Scott Morrow,D,CAR,22,48,3,5,8
43,8479026,Philippe Myers,D,TOR,27,46,3,5,8
43,8476372,Nick Seeler,D,PHI,31,46,3,5,8
43,8476867,Brendan Gaunce,C,MIN,30,28,3,5,8
43,8480058,Pierre-Olivier Joseph,D,STL,25,48,2,6,8
43,8480950,Ilya Lyubushkin,D,DAL,30,68,2,6,8
43,8482496,Nils Aman,C,VAN,24,35,2,6,8
43,8478874,Adam Gaudette,R,OTT,28,33,2,6,8
43,8479379,Givani Smith,R,SJS,26,39,6,1,7
43,8478017,Mark Friedman,D,VAN,29,39,5,2,7
43,8479968,Vinni Lettieri,C,BOS,29,56,5,2,7
43,8475235,Nicolas Deslauriers,L,PHI,33,49,5,2,7
43,8479328,Julien Gauthier,R,NYI,27,59,4,3,7
43,8480292,Carson Meyer,R,ANA,27,35,4,3,7
43,8479536,Axel Jonsson-Fjallby,L,WPG,26,38,3,4,7
43,8475958,Michael Sgarbossa,C,WSH,32,31,3,4,7
43,8482733,Logan Mailloux,D,MTL,31,42,3,4,7
43,8480727,Zach Whitecloud,D,VGK,28,49,2,5,7
43,8480007,Jonas Rondbjerg,R,VGK,25,36,2,5,7
43,8482964,Arber Xhekaj,D,MTL,23,43,2,5,7
43,8483619,Filip Roos,D,OTT,25,37,2,5,7
43,8482102,Vasily Ponomarev,C,PIT,22,19,2,5,7
43,8481568,Alex Vlasic,D,CHI,23,45,1,6,7
43,8481592,Jakob Pelletier,L,CGY,23,49,1,6,7
43,8477335,Kyle Burroughs,D,LAK,29,41,1,6,7
43,8473446,Erik Johnson,D,PHI,36,52,1,6,7
43,8476473,Connor Murphy,D,CHI,31,50,1,6,7
43,8484911,Collin Graf,R,SJS,22,41,1,6,7
43,8484258,Sam Malinski,D,COL,26,21,1,6,7
43,8477473,Justin Bailey,R,SJS,29,23,1,6,7
43,8476441,Joel Edmundson,D,LAK,31,40,1,6,7
43,8479249,Andrew Poturalski,C,SJS,30,34,0,7,7
43,8482861,Vincent Iorio,D,WSH,22,33,0,7,7
43,8482747,Brennan Othmann,L,NYR,21,41,0,7,7
43,8479587,Rhett Gardner,C,PHI,28,21,0,7,7
43,8480245,Olle Lycksell,R,PHI,25,29,5,1,6
43,8481789,Tye Kartye,L,SEA,23,37,4,2,6
43,8471677,Jack Johnson,D,CBJ,37,64,4,2,6
43,8479985,Cale Fleury,D,SEA,26,26,4,2,6
43,8481679,Maxence Guenette,D,OTT,23,31,4,2,6
43,8481147,Reese Johnson,C,MIN,26,42,3,3,6
43,8482858,Ryker Evans,D,SEA,23,26,3,3,6
43,8479362,Riley Tufte,L,BOS,26,20,3,3,6
43,8479378,Logan Stanley,D,WPG,26,35,2,4,6
43,8481122,Simon Benoit,D,TOR,26,45,2,4,6
43,8480834,Ty Emberson,D,SJS,24,30,2,4,6
43,8484254,Akito Hirose,D,VAN,25,34,1,5,6
43,8482141,Lukas Cormier,D,VGK,22,34,1,5,6
43,8482144,Jack Thompson,D,SJS,22,36,1,5,6
43,8482751,Ryan Winterton,C,SEA,21,42,1,5,6
43,8481167,Brayden Pachal,D,CGY,25,44,0,6,6
43,8477034,Jaycob Megna,D,FLA,32,42,0,6,6
43,8481754,Nikita Nesterenko,C,ANA,23,33,3,2,5
43,8481556,John Beecher,C,BOS,23,36,3,2,5
43,8482070,Mitchell Chaffee,R,TBL,26,56,3,2,5
43,8481550,Adam Beckman,L,NJD,23,39,3,2,5
43,8484287,Cole McWard,D,VAN,23,20,3,2,5
43,8479981,Jonah Gadjovich,L,FLA,26,39,2,3,5
43,8483549,Lucas Condotta,L,MTL,27,44,2,3,5
43,8481701,Santeri Hatakka,D,NJD,23,39,2,3,5
43,8477462,Robert Hagg,D,VGK,29,26,2,3,5
43,8480796,Martin Fehervary,D,WSH,25,61,1,4,5
43,8480879,Jacob Bernard-Docker,D,OTT,24,44,1,4,5
43,8480845,Rasmus Kupari,C,WPG,24,45,1,4,5
43,8481056,Spencer Stastney,D,NSH,24,27,1,4,5
43,8480870,Bo Groulx,C,NYR,24,32,1,4,5
43,8481743,Marc Del Gaizo,D,NSH,25,21,1,4,5
43,8475762,Derek Forbort,D,VAN,32,45,1,4,5
43,8477073,Kurtis MacDermid,L,NJD,30,31,1,4,5
43,8475413,Justin Dowling,C,NJD,34,10,1,4,5
43,8478502,Dennis Gilbert,D,BUF,28,16,1,4,5
43,8474090,Brendan Smith,D,DAL,35,48,0,5,5
43,8477971,Andreas Englund,D,LAK,28,28,0,5,5
43,8479576,Vincent Desharnais,D,VAN,28,33,0,5,5
43,8482929,Emil Lilleberg,D,TBL,23,21,0,5,5
43,8482094,Daemon Hunt,D,MIN,22,15,0,5,5
43,8483570,Ben Meyers,C,SEA,26,34,4,0,4
43,8482061,Brandon Biro,L,SEA,26,16,4,0,4
43,8480851,Akil Thomas,C,LAK,24,19,3,1,4
43,8479543,Michael Pezzetta,L,MTL,26,59,2,2,4
43,8476858,Phillip Di Giuseppe,L,VAN,31,40,2,2,4
43,8479991,Jake Leschyshyn,C,NYR,25,32,2,2,4
43,8481422,Jake Lucchini,C,NSH,29,23,2,2,4
43,8481605,Jackson LaCombe,D,ANA,23,34,2,2,4
43,8482165,Yan Kuznetsov,D,CGY,22,16,2,2,4
43,8481806,Louis Crevier,D,CHI,23,16,2,2,4
43,8480196,Jacob Bryson,D,BUF,27,36,1,3,4
43,8478450,Parker Wotherspoon,D,BOS,27,30,1,3,4
43,8481609,Vladislav Kolyachonok,D,UTA,23,25,1,3,4
43,8479367,William Lockwood,R,FLA,26,21,1,3,4
43,8479419,Brett Murray,L,BUF,26,25,1,3,4
43,8481719,Maxwell Crozier,D,TBL,24,14,1,3,4
43,8477887,Patrick Brown,C,BOS,32,43,3,0,3
43,8478446,Glenn Gawdin,C,LAK,27,7,3,0,3
43,8480032,Shane Bowers,C,NJD,25,18,3,0,3
43,8483012,Logan Morrison,C,SEA,22,42,2,1,3
43,8482172,Landon Slaggert,L,CHI,22,28,2,1,3
43,8483763,Maksymilian Szuber,D,UTA,22,30,2,1,3
43,8482460,Matt Rempe,C,NYR,22,12,2,1,3
43,8478021,William Lagesson,D,DET,28,23,2,1,3
43,8481598,Philip Broberg,D,EDM,23,38,1,2,3
43,8480880,Jakub Lauko,C,MIN,24,37,1,2,3
43,8478454,Noah Juulsen,D,VAN,27,35,1,2,3
43,8482765,Isak Rosen,R,BUF,21,33,1,2,3
43,8475755,Alexander Petrovic,D,DAL,32,13,1,2,3
43,8481237,Kyle MacLean,C,NYI,25,17,1,2,3
43,8483395,Arshdeep Bains,L,VAN,23,12,1,2,3
43,8483489,Fraser Minten,C,TOR,31,13,1,2,3
43,8482088,Justin Sourdif,R,FLA,22,25,1,2,3
43,8475795,Dylan McIlrath,D,WSH,32,11,1,2,3
43,8483460,David Jiricek,D,CBJ,21,56,0,3,3
43,8482511,Mason Lohrei,D,BOS,23,35,0,3,3
43,8481543,Nikita Alexandrov,C,STL,24,24,0,3,3
43,8481564,Ryan Johnson,D,BUF,23,16,0,3,3
43,8482147,Jean-Luc Foudy,C,COL,22,22,2,0,2
43,8480823,Alexander Alexeyev,D,WSH,25,13,1,1,2
43,8484325,Waltteri Merela,C,TBL,26,16,1,1,2
43,8482713,Mackie Samoskevich,R,FLA,22,41,1,1,2
43,8483597,Milos Kelemen,L,UTA,25,8,1,1,2
43,8478051,Max Willman,C,NJD,29,10,1,1,2
43,8479320,Maxime Lajoie,D,SEA,27,22,1,1,2
43,8483471,Brad Lambert,C,WPG,31,13,1,1,2
43,8477244,Chad Ruhwedel,D,NYR,34,24,1,1,2
43,8481578,Graeme Clarke,R,MIN,23,9,1,1,2
43,8483920,Pierrick Dube,R,WSH,23,8,1,1,2
43,8484304,Uvis Balinskis,D,FLA,28,4,1,1,2
43,8482787,Nikita Chibrikov,R,WPG,31,7,1,1,2
43,8479972,Mason Shaw,C,WPG,26,25,0,2,2
43,8474612,Travis Hamonic,D,OTT,34,50,0,2,2
43,8477527,Ross Johnston,L,ANA,30,37,0,2,2
43,8481462,Mason Morelli,L,VGK,28,13,0,2,2
43,8481006,Tyler Tucker,D,STL,24,15,0,2,2
43,8478477,Mitchell Stephens,C,SEA,27,16,0,2,2
43,8481043,Cole Koepke,L,BOS,26,15,0,2,2
43,8480468,James Hamblin,L,EDM,25,21,1,0,1
43,8477467,Gustav Olofsson,D,SEA,30,14,1,0,1
43,8481065,Angus Crookshank,L,OTT,25,13,1,0,1
43,8482162,Roby Jarventie,L,EDM,22,5,1,0,1
43,8481541,Samuel Bolduc,D,NYI,24,27,1,0,1
43,8483407,Brandon Scanlin,D,NYR,25,4,1,0,1
43,8482201,Gage Goncalves,C,TBL,23,21,0,1,1
43,8483512,Matthew Savoie,C,EDM,20,27,0,1,1
43,8480084,Nick DeSimone,D,NJD,30,16,0,1,1
43,8478011,Louie Belpedio,D,PHI,28,11,0,1,1
43,8482470,Ilya Solovyov,D,CGY,24,12,0,1,1
43,8480874,Adam Ginning,D,PHI,24,13,0,1,1
43,8483567,Georgii Merkulov,C,BOS,24,9,0,1,1
43,8477320,Anton Blidh,L,NYR,29,19,0,1,1
43,8481593,Jayden Struble,D,MTL,23,25,0,1,1
43,8479330,Brandon Gignac,C,MTL,27,10,0,1,1
43,8480890,Jan Jenik,C,OTT,24,29,0,1,1
43,8474062,Riley Nash,C,NYR,35,18,0,1,1
43,8482197,Adam Raska,R,MIN,23,9,0,0,0
43,8482516,Matthew Kessel,D,STL,24,11,0,0,0
43,8481699,Aku Raty,R,UTA,23,14,0,0,0
43,8480306,Grant Hutton,D,NYI,29,6,0,0,0
43,8475780,Chris Wagner,R,COL,33,5,0,0,0
43,8480267,Sammy Walker,C,MIN,25,14,0,0,0
43,8478881,Brett Seney,L,CHI,28,7,0,0,0
43,8482118,Sam Colangelo,R,ANA,23,16,0,0,0
43,8481030,Jack St. Ivany,D,PIT,25,13,0,0,0
43,8484326,Patrik Koch,D,UTA,28,1,0,0,0
43,8481585,Egor Afanasyev,L,SJS,23,12,0,0,0
43,8481024,Linus Karlsson,C,VAN,25,10,0,0,0
43,8477541,Dakota Mermis,D,TOR,30,14,0,0,0
43,8477810,Joel Hanley,D,CGY,33,18,0,0,0
43,8482250,Callahan Burke,C,VGK,27,17,0,0,0
43,8483432,Luca Del Bel Belluz,C,CBJ,31,5,0,0,0
43,8484255,Jason Polin,R,COL,25,7,0,0,0
43,8477993,Justin Kirkland,C,CGY,28,7,0,0,0
43,8477149,Scott Sabourin,R,SJS,32,21,0,0,0
43,8480075,Cameron Crotty,D,MIN,25,7,0,0,0
43,8479522,Hardy Haman Aktell,D,WSH,26,3,0,0,0
43,8478854,Ryan Shea,D,PIT,27,7,0,0,0
43,8483401,Marc Johnstone,R,PIT,28,2,0,0,0
43,8482476,Emil Heineman,L,MTL,23,9,0,0,0
43,8482126,Emil Andrae,D,PHI,31,3,0,0,0
43,8484259,Ondrej Pavel,C,COL,31,2,0,0,0
43,8484321,Nikolas Matinpalo,D,OTT,26,0,0,0,0
43,8483609,Adam Klapka,R,CGY,24,2,0,0,0
43,8483398,Declan Carlile,D,TBL,31,9,0,0,0
43,8481206,John Ludvig,D,PIT,24,10,0,0,0
43,8481726,Adam Edstrom,C,NYR,24,6,0,0,0
43,8483546,Marshall Rifai,D,TOR,26,2,0,0,0
43,8479421,Jacob Moverare,D,LAK,26,6,0,0,0
43,8481655,Cole Schwindt,R,CGY,23,3,0,0,0
43,8478147,Bokondji Imama,L,PIT,28,5,0,0,0
43,8483531,Brian Halonen,L,NJD,25,4,0,0,0
43,8481534,Raphael Lavoie,C,EDM,24,4,0,0,0
43,8476323,Max McCormick,L,SEA,32,3,0,0,0
43,8483045,Cameron Butler,R,CBJ,31,0,0,0,0
43,8478956,Samuel Laberge,L,NJD,27,3,0,0,0
43,8480274,Philip Kemp,D,EDM,25,2,0,0,0
43,8470794,Joe Pavelski,C,,40,0,0,0,0
43,8479321,Lucas Johansen,D,,27,0,0,0,0
43,8477950,Tony DeAngelo,D,,29,0,0,0,0
43,8471218,Blake Wheeler,R,,38,0,0,0,0
43,8475197,Tyson Barrie,D,,33,0,0,0,0
43,8474157,Max Pacioretty,L,,36,0,0,0,0
43,8475744,Evgeny Kuznetsov,C,,32,0,0,0,0
43,8474037,James van Riemsdyk,L,,35,0,0,0,0
43,8476907,Mackenzie MacEachern,L,,30,0,0,0,0
43,8480216,Jacob Peterson,C,,25,0,0,0,0
43,8474602,Justin Schultz,D,,34,0,0,0,0
43,8482222,Alexander Barabanov,L,,30,0,0,0,0
43,8474031,Kevin Shattenkirk,D,,35,0,0,0,0
43,8477330,Dominik Kubalik,L,,29,0,0,0,0
43,8480884,Calen Addison,D,,24,0,0,0,0
43,8475906,John Klingberg,D,,32,0,0,0,0
43,8480008,Adam Ruzicka,C,,25,0,0,0,0
43,8476884,Derrick Pouliot,D,,30,0,0,0,0
43,8476919,Chris Tierney,C,,30,0,0,0,0
43,8479415,Michael McLeod,C,,26,0,0,0,0
43,8474870,Tyler Johnson,C,,34,0,0,0,0
43,8470604,Jeff Carter,C,,39,0,0,0,0
43,8478104,Sammy Blais,L,,28,0,0,0,0
43,8474884,Mike Hoffman,C,,35,0,0,0,0
43,8481591,Sam Poulin,R,,23,0,0,0,0
43,8471274,Alex Goligoski,D,,39,0,0,0,0
43,8476871,Tanner Pearson,L,,32,0,0,0,0
43,8476393,Nick Cousins,C,,31,0,0,0,0
43,8479977,Kailer Yamamoto,R,,26,0,0,0,0
43,8479346,Dillon Dube,C,,26,0,0,0,0
43,8480184,Gustav Lindstrom,D,,26,0,0,0,0
43,8479376,Victor Mete,D,,26,0,0,0,0
43,8473449,Kyle Okposo,R,,36,0,0,0,0
43,8481058,Jesse Ylonen,R,,25,0,0,0,0
43,8475752,Tyler Pitlick,C,,33,0,0,0,0
43,8481239,Samuel Fagemo,L,,24,0,0,0,0
43,8480821,Filip Zadina,R,,25,0,0,0,0
43,8470966,Mark Giordano,D,,41,0,0,0,0
43,8478495,Denis Gurianov,R,,27,0,0,0,0
43,8477464,Nic Petan,C,,29,0,0,0,0
43,8478099,Kevin Labanc,R,,29,0,0,0,0
43,8482241,Radim Zohorna,L,,28,0,0,0,0
43,8474040,Sam Gagner,C,,35,0,0,0,0
43,8479514,Rem Pitlick,C,,27,0,0,0,0
43,8478430,Oliver Kylington,D,,27,0,0,0,0
43,8479533,Joona Koppanen,L,,26,0,0,0,0
43,8479984,Cal Foote,D,,26,0,0,0,0
43,8477126,Jayson Megna,C,,34,0,0,0,0
43,8475164,Jakob Silfverberg,R,,34,0,0,0,0
43,8474009,Nick Bonino,C,,36,0,0,0,0
43,8479458,Nikita Zaitsev,D,,33,0,0,0,0
43,8477944,Jakub Vrana,L,,28,0,0,0,0
43,8471699,Andrew Cogliano,C,,37,0,0,0,0
43,8478067,Oskar Lindblom,L,,28,0,0,0,0
43,8471686,Marc Staal,D,,37,0,0,0,0
43,8470610,Zach Parise,L,,40,0,0,0,0
43,8478904,Steven Lorentz,C,,28,0,0,0,0
43,8473473,Milan Lucic,L,,36,0,0,0,0
43,8480031,Maxime Comtois,L,,25,0,0,0,0
43,8478512,Austin Czarnik,C,,32,0,0,0,0
43,8473504,Cal Clutterbuck,R,,37,0,0,0,0
43,8477454,Adam Erne,L,,29,0,0,0,0
43,8479383,Boris Katchouk,L,,26,0,0,0,0
43,8475825,Jani Hakanpää,D,,32,0,0,0,0
43,8477846,Ryan Carpenter,C,,33,0,0,0,0
43,8477930,Pierre-Edouard Bellemare,L,,39,0,0,0,0
43,8478400,Colin White,C,,27,0,0,0,0
43,8480226,Marián Studenic,R,,26,0,0,0,0
43,8480853,Liam Foudy,C,,24,0,0,0,0
43,8475797,Jarred Tinordi,D,,32,0,0,0,0
43,8479423,Alex Nylander,L,,26,0,0,0,0
43,8474618,Marco Scandella,D,,34,0,0,0,0
43,8478028,Fredrik Olofsson,L,,28,0,0,0,0
43,8474709,Matt Martin,L,,35,0,0,0,0
43,8481070,Hugh McGing,L,,26,0,0,0,0
43,8479546,Oskar Steen,C,,26,0,0,0,0
43,8474145,Robert Bortuzzo,D,,35,0,0,0,0
43,8476915,Jujhar Khaira,L,,30,0,0,0,0
43,8475278,Byron Froese,C,,33,0,0,0,0
43,8481812,Nikolai Knyzhov,D,,27,0,0,0,0
43,8478408,Travis Dermott,D,,28,0,0,0,0
43,8481077,John Leonard,L,,26,0,0,0,0
43,8479547,Matthew Phillips,R,,26,0,0,0,0
43,8480836,Jonathan Gruden,C,,24,0,0,0,0
43,8481690,Tyler Angle,C,,24,0,0,0,0
43,8475766,Austin Watson,L,,32,0,0,0,0
43,8481016,Ruslan Iskhakov,C,,24,0,0,0,0
43,8478078,Rourke Chartier,C,,28,0,0,0,0
43,8480776,Sheldon Rempal,R,,29,0,0,0,0
43,8484314,Jiri Smejkal,L,,28,0,0,0,0
44,8478402,Connor McDavid,C,EDM,27,80,40,109,149
44,8476453,Nikita Kucherov,R,TBL,31,82,40,109,149
44,8477492,Nathan MacKinnon,C,COL,29,79,66,78,144
44,8478483,Mitch Marner,R,TOR,27,78,32,91,123
44,8478420,Mikko Rantanen,R,COL,28,81,55,61,116
44,8477934,Leon Draisaitl,C,EDM,29,77,40,76,116
44,8479318,Auston Matthews,C,TOR,27,80,71,43,114
44,8477956,David Pastrnak,R,BOS,28,82,55,59,114
44,8477939,William Nylander,R,TOR,28,82,53,55,108
44,8478864,Kirill Kaprizov,L,MIN,27,72,44,62,106
44,8477942,Kevin Fiala,L,LAK,28,82,37,65,102
44,8475786,Zach Hyman,L,EDM,32,78,59,40,99
44,8476468,J.T. Miller,C,VAN,31,76,35,63,98
44,8471675,Sidney Crosby,C,PIT,37,76,33,65,98
44,8479407,Jesper Bratt,L,NJD,26,78,25,72,97
44,8480800,Quinn Hughes,D,VAN,25,77,3,94,97
44,8477404,Jake Guentzel,C,TBL,30,82,38,57,95
44,8481559,Jack Hughes,C,NJD,23,70,37,57,94
44,8480069,Cale Makar,D,COL,26,70,27,67,94
44,8478010,Brayden Point,C,TBL,28,82,47,45,92
44,8480801,Brady Tkachuk,L,OTT,25,79,51,40,91
44,8480036,Miro Heiskanen,D,DAL,25,79,14,77,91
44,8480012,Elias Pettersson,C,VAN,26,71,26,64,90
44,8477493,Aleksander Barkov,C,FLA,29,77,29,60,89
44,8477946,Dylan Larkin,C,DET,28,81,40,48,88
44,8479314,Matthew Tkachuk,L,FLA,27,78,24,64,88
44,8479420,Tage Thompson,C,BUF,27,73,43,44,87
44,8475166,John Tavares,C,TOR,34,80,35,52,87
44,8478398,Kyle Connor,L,WPG,28,76,48,38,86
44,8475184,Chris Kreider,L,NYR,33,78,46,40,86
44,8484144,Connor Bedard,C,CHI,19,74,35,51,86
44,8480830,Andrei Svechnikov,R,CAR,24,75,31,54,85
44,8474564,Steven Stamkos,C,NSH,34,76,37,47,84
44,8476456,Jonathan Huberdeau,C,CGY,31,81,21,63,84
44,8480027,Jason Robertson,L,DAL,25,81,36,47,83
44,8478550,Artemi Panarin,L,NYR,33,70,24,59,83
44,8478445,Mathew Barzal,C,NYI,27,79,20,63,83
44,8480002,Nico Hischier,C,NJD,25,68,34,48,82
44,8482116,Tim Stützle,C,OTT,22,78,28,54,82
44,8479343,Clayton Keller,R,UTA,26,75,32,49,81
44,8475810,Bryan Rust,R,PIT,32,76,41,39,80
44,8480839,Rasmus Dahlin,D,BUF,24,74,25,54,79
44,8475167,Victor Hedman,D,TBL,34,78,13,66,79
44,8476887,Filip Forsberg,L,NSH,30,77,37,41,78
44,8476881,Tomas Hertl,C,VGK,31,79,30,48,78
44,8476539,Jonathan Marchessault,R,NSH,34,75,41,36,77
44,8481557,Matt Boldy,L,MIN,23,73,33,43,76
44,8474600,Roman Josi,D,NSH,34,75,13,62,75
44,8478403,Jack Eichel,C,VGK,28,79,40,34,74
44,8475692,Mats Zuccarello,R,MIN,37,73,17,57,74
44,8479542,Brandon Hagel,L,TBL,26,82,39,34,73
44,8478427,Sebastian Aho,C,CAR,27,70,34,39,73
44,8477416,Oliver Bjorkstrand,R,SEA,29,74,31,42,73
44,8477501,Valeri Nichushkin,R,COL,29,82,32,40,72
44,8474141,Patrick Kane,R,DET,36,81,29,43,72
44,8476459,Mika Zibanejad,C,NYR,31,78,28,44,72
44,8478439,Travis Konecny,R,PHI,27,79,26,46,72
44,8478449,Roope Hintz,C,DAL,28,82,24,48,72
44,8475784,Jeff Skinner,C,EDM,32,77,37,34,71
44,8477960,Adrian Kempe,R,LAK,28,82,32,39,71
44,8476389,Vincent Trocheck,C,NYR,31,78,25,46,71
44,8473419,Brad Marchand,L,BOS,36,79,25,46,71
44,8478414,Timo Meier,R,NJD,28,73,39,31,70
44,8482093,Seth Jarvis,C,CAR,22,73,33,37,70
44,8476346,Johnny Gaudreau,L,CBJ,31,74,20,50,70
44,8477504,Josh Morrissey,D,WPG,29,77,20,50,70
44,8476454,Ryan Nugent-Hopkins,C,EDM,31,78,18,52,70
44,8479999,Casey Mittelstadt,C,COL,26,78,16,54,70
44,8476448,William Karlsson,C,VGK,31,79,34,35,69
44,8482665,Matty Beniers,C,SEA,22,74,31,38,69
44,8479675,Trevor Moore,L,LAK,29,80,33,35,68
44,8480018,Nick Suzuki,C,MTL,25,78,29,39,68
44,8479337,Alex DeBrincat,R,DET,27,82,25,43,68
44,8482740,Wyatt Johnston,C,DAL,21,82,36,31,67
44,8471685,Anze Kopitar,C,LAK,37,80,22,45,67
44,8478493,Joel Eriksson Ek,C,MIN,27,69,40,26,66
44,8475794,Tyler Seguin,C,DAL,32,81,35,31,66
44,8475765,Vladimir Tarasenko,R,DET,33,82,27,39,66
44,8478407,Vince Dunn,D,SEA,28,72,23,43,66
44,8475172,Nazem Kadri,C,CGY,34,79,21,45,66
44,8476460,Mark Scheifele,C,WPG,31,71,19,47,66
44,8477940,Nikolaj Ehlers,L,WPG,28,70,34,31,65
44,8483808,Andrei Kuzmenko,L,CGY,28,79,31,34,65
44,8475168,Matt Duchene,C,DAL,33,82,26,39,65
44,8475913,Mark Stone,R,VGK,32,75,25,40,65
44,8477949,Alex Tuch,R,BUF,28,74,18,47,65
44,8480865,Noah Dobson,D,NYI,24,79,18,47,65
44,8474578,Erik Karlsson,D,PIT,34,77,14,51,65
44,8477933,Sam Reinhart,C,FLA,29,80,35,29,64
44,8479385,Jordan Kyrou,C,STL,26,78,31,33,64
44,8478440,Dylan Strome,C,WSH,27,76,21,43,64
44,8480208,Drake Batherson,R,OTT,26,75,24,39,63
44,8474679,Gustav Nyquist,C,NSH,35,70,19,44,63
44,8478401,Pavel Zacha,C,BOS,27,82,19,44,63
44,8479323,Adam Fox,D,NYR,26,75,15,48,63
44,8475754,Brock Nelson,C,NYI,33,78,32,30,62
44,8471215,Evgeni Malkin,C,PIT,38,72,30,32,62
44,8478975,Mason Marchment,L,DAL,29,81,28,34,62
44,8471214,Alex Ovechkin,L,WSH,39,72,23,39,62
44,8478519,Anthony Cirelli,C,TBL,27,80,23,39,62
44,8480028,Morgan Frost,C,PHI,25,74,21,41,62
44,8477409,Carter Verhaeghe,C,FLA,29,79,29,32,61
44,8475158,Ryan O'Reilly,C,NSH,33,72,26,35,61
44,8478460,Zach Werenski,D,CBJ,27,78,20,41,61
44,8474150,Mikael Backlund,C,CGY,35,79,20,41,61
44,8482745,Mason McTavish,C,ANA,21,73,27,33,60
44,8478873,Troy Terry,R,ANA,27,70,25,35,60
44,8482078,Lucas Raymond,L,DET,22,82,23,37,60
44,8477456,J.T. Compher,L,DET,29,80,23,37,60
44,8473986,Alex Killorn,L,ANA,35,78,21,39,60
44,8481540,Cole Caufield,R,MTL,23,75,34,25,59
44,8478444,Brock Boeser,R,VAN,27,73,26,33,59
44,8475798,Mikael Granlund,C,SJS,32,69,20,39,59
44,8482110,Dawson Mercer,C,NJD,23,76,26,32,58
44,8480015,Owen Tippett,R,PHI,25,74,29,28,57
44,8482109,Alexis Lafrenière,L,NYR,23,76,29,28,57
44,8477964,Ivan Barbashev,C,VGK,29,73,21,36,57
44,8479400,Pierre-Luc Dubois,L,WSH,26,73,20,37,57
44,8478047,Michael Bunting,L,PIT,29,73,19,38,57
44,8481711,Matias Maccelli,L,UTA,24,74,17,40,57
44,8474102,David Perron,L,OTT,36,81,17,40,57
44,8477402,Pavel Buchnevich,L,STL,29,73,16,41,57
44,8482699,Dylan Guenther,R,UTA,21,75,20,36,56
44,8475745,Charlie Coyle,C,BOS,32,79,19,37,56
44,8477951,Nick Schmaltz,C,UTA,28,74,18,38,56
44,8476882,Teuvo Teravainen,C,CHI,30,65,22,33,55
44,8481528,Dylan Cozens,C,BUF,23,78,20,35,55
44,8478498,Jake DeBrusk,L,VAN,28,72,30,24,54
44,8478462,Nicolas Roy,C,VGK,27,77,28,26,54
44,8477935,Sam Bennett,C,FLA,28,74,27,27,54
44,8480039,Martin Necas,C,CAR,25,71,22,32,54
44,8477476,Artturi Lehkonen,L,COL,29,81,21,33,54
44,8473994,Jamie Benn,L,DAL,35,82,19,35,54
44,8475753,Justin Faulk,D,STL,32,76,18,36,54
44,8479987,Morgan Geekie,C,BOS,26,78,18,36,54
44,8476853,Morgan Rielly,D,TOR,30,70,8,46,54
44,8478397,Rasmus Andersson,D,CGY,28,73,5,49,54
44,8478366,Frank Vatrano,R,ANA,30,73,26,27,53
44,8478233,Andrew Mangiapane,L,WSH,28,72,21,32,53
44,8478856,Conor Garland,R,VAN,28,71,19,34,53
44,8471724,Kris Letang,D,PIT,37,79,13,40,53
44,8477986,Brandon Montour,D,SEA,30,75,12,41,53
44,8480803,Evan Bouchard,D,EDM,25,74,11,42,53
44,8482175,JJ Peterka,R,BUF,22,70,31,21,52
44,8477496,Elias Lindholm,C,BOS,30,79,18,34,52
44,8475170,Brayden Schenn,C,STL,33,73,18,34,52
44,8476462,Dougie Hamilton,D,NJD,31,71,18,34,52
44,8479339,Patrik Laine,L,CBJ,26,63,18,34,52
44,8482124,Quinton Byfield,R,LAK,22,81,17,35,52
44,8480023,Robert Thomas,C,STL,25,74,11,41,52
44,8479325,Charlie McAvoy,D,BOS,27,71,10,42,52
44,8478396,Noah Hanifin,D,VGK,27,70,10,42,52
44,8482684,Luke Hughes,D,NJD,21,72,8,44,52
44,8477500,Bo Horvat,C,NYI,29,77,24,27,51
44,8480009,Eeli Tolvanen,R,SEA,25,77,23,28,51
44,8482113,Anton Lundell,C,FLA,23,77,22,29,51
44,8473512,Claude Giroux,R,OTT,36,77,18,33,51
44,8477494,Jonathan Drouin,L,COL,29,80,13,38,51
44,8475726,Tyler Toffoli,C,SJS,32,69,23,27,50
44,8478438,Tommy Novak,C,NSH,27,71,19,31,50
44,8478038,Devon Toews,D,COL,30,70,10,40,50
44,8481068,Yegor Sharangovich,C,CGY,26,75,32,17,49
44,8481560,Arthur Kaliyev,R,LAK,23,78,25,24,49
44,8478474,Lawson Crouse,L,UTA,27,75,23,26,49
44,8475169,Evander Kane,L,EDM,33,74,22,27,49
44,8483431,Logan Cooley,C,UTA,20,73,20,29,49
44,8477955,Jared McCann,L,SEA,28,69,19,30,49
44,8481596,Shane Pinto,C,OTT,24,78,18,31,49
44,8478458,John (Jack) Roslovic,C,CAR,27,67,16,33,49
44,8477346,MacKenzie Weegar,D,CGY,30,72,12,37,49
44,8474563,Drew Doughty,D,LAK,35,72,10,39,49
44,8477426,Nicholas Paul,L,TBL,29,80,27,21,48
44,8475151,Kyle Palmieri,C,NYI,33,79,21,27,48
44,8474641,Adam Henrique,C,EDM,34,78,18,30,48
44,8476905,Chandler Stephenson,C,SEA,30,74,14,34,48
44,8480797,Joel Farabee,L,PHI,24,73,21,26,47
44,8482149,Cole Perfetti,C,WPG,22,73,17,30,47
44,8476483,Rickard Rakell,R,PIT,31,68,25,21,46
44,8479992,Michael Rasmussen,C,DET,25,74,25,20,45
44,8480064,Josh Norris,C,OTT,25,70,23,22,45
44,8478046,Danton Heinen,L,VAN,29,73,21,24,45
44,8480849,Barrett Hayton,C,UTA,24,73,19,26,45
44,8477021,Alex Kerfoot,C,UTA,30,72,17,28,45
44,8476479,Phillip Danault,C,LAK,31,81,16,29,45
44,8479351,Sam Steel,C,DAL,26,79,16,29,45
44,8482660,Kent Johnson,C,CBJ,22,66,16,29,45
44,8481577,Philip Tomasino,C,NSH,23,71,16,29,45
44,8476906,Shayne Gostisbehere,D,CAR,31,76,11,34,45
44,8477447,Shea Theodore,D,VGK,29,63,5,40,45
44,8476399,Blake Coleman,C,CGY,33,78,28,16,44
44,8475191,Reilly Smith,R,NYR,33,71,18,26,44
44,8478042,Viktor Arvidsson,L,EDM,31,79,16,28,44
44,8480113,Alex Iafallo,L,WPG,31,63,15,29,44
44,8480798,Philipp Kurashev,C,CHI,25,61,11,33,44
44,8481542,Moritz Seider,D,DET,23,77,6,38,44
44,8484145,Zach Benson,L,BUF,19,67,23,20,43
44,8475793,Ryan Johansen,C,PHI,32,68,18,25,43
44,8480434,Sean Durzi,D,UTA,26,67,10,33,43
44,8480829,Jesperi Kotkaniemi,C,CAR,24,67,23,19,42
44,8475799,Nino Niederreiter,R,WPG,32,66,22,20,42
44,8479525,Ross Colton,C,COL,28,77,22,20,42
44,8479365,Trent Frederic,C,BOS,26,70,20,22,42
44,8477503,Max Domi,C,TOR,29,79,15,27,42
44,8477479,Tyler Bertuzzi,L,CHI,29,63,14,28,42
44,8482159,Tyson Foerster,R,PHI,22,76,13,29,42
44,8477495,Seth Jones,D,CHI,30,66,13,29,42
44,8474590,John Carlson,D,WSH,34,70,12,30,42
44,8481533,Trevor Zegras,C,ANA,23,67,12,30,42
44,8479345,Jakob Chychrun,D,WSH,26,58,11,31,42
44,8470613,Brent Burns,D,CAR,39,73,9,33,42
44,8478466,Daniel Sprong,R,VAN,27,72,21,20,41
44,8482702,Logan Stankoven,C,DAL,21,80,20,21,41
44,8480188,Fabian Zetterlund,L,SJS,25,61,15,26,41
44,8484166,Adam Fantilli,C,CBJ,20,64,14,27,41
44,8476869,Brady Skjei,D,NSH,30,73,14,27,41
44,8477932,Aaron Ekblad,D,FLA,28,66,9,32,41
44,8476875,Mike Matheson,D,MTL,30,72,9,32,41
44,8478469,Thomas Chabot,D,OTT,27,71,9,32,41
44,8480014,Gabriel Vilardi,C,WPG,25,68,24,16,40
44,8478115,Pierre Engvall,L,NYI,28,75,22,18,40
44,8482667,William Eklund,L,SJS,22,64,20,20,40
44,8476880,Tom Wilson,R,WSH,30,72,20,20,40
44,8475287,Erik Haula,L,NJD,33,74,17,23,40
44,8477444,Andre Burakovsky,L,SEA,29,66,16,24,40
44,8480220,Noah Cates,L,PHI,25,68,16,24,40
44,8481618,Alex Newhook,C,MTL,23,72,14,26,40
44,8474565,Alex Pietrangelo,D,VGK,34,56,7,33,40
44,8477407,Anthony Duclair,L,NYI,29,80,22,17,39
44,8479619,Michael Carcone,L,UTA,28,60,22,17,39
44,8477998,Warren Foegele,L,LAK,28,76,20,19,39
44,8483515,Juraj Slafkovsky,L,MTL,20,71,16,23,39
44,8476826,Yanni Gourde,C,SEA,33,72,15,24,39
44,8474189,Lars Eller,C,PIT,35,68,15,24,39
44,8475848,Brendan Gallagher,R,MTL,32,73,14,25,39
44,8476461,Sean Couturier,C,PHI,32,70,13,26,39
44,8476872,Scott Laughton,C,PHI,30,71,13,26,39
44,8474586,Jordan Eberle,R,SEA,34,70,12,27,39
44,8476438,Brandon Saad,L,STL,32,75,23,15,38
44,8484153,Leo Carlsson,C,ANA,20,71,18,20,38
44,8478542,Evan Rodrigues,C,FLA,31,74,17,21,38
44,8475760,Nick Bjugstad,C,UTA,32,74,15,23,38
44,8478472,Mathieu Joseph,R,STL,27,71,13,25,38
44,8478055,Gustav Forsling,D,FLA,28,77,8,30,38
44,8482712,Oskar Olausson,R,COL,22,80,7,31,38
44,8480459,Pius Suter,C,VAN,28,67,20,17,37
44,8477429,Andrew Copp,C,DET,30,79,14,23,37
44,8475768,Jaden Schwartz,C,SEA,32,69,14,23,37
44,8476392,Adam Lowry,C,WPG,31,69,13,24,37
44,8476792,Torey Krug,D,STL,33,75,12,25,37
44,8477451,Ryan Hartman,R,MIN,30,71,12,25,37
44,8477498,Darnell Nurse,D,EDM,29,71,8,29,37
44,8479410,Mikhail Sergachev,D,UTA,26,75,7,30,37
44,8476885,Jacob Trouba,D,NYR,30,74,7,30,37
44,8477506,Ryan Pulock,D,NYI,30,80,3,34,37
44,8481535,Nils Hoglander,L,VAN,24,72,17,19,36
44,8478413,Jordan Greenway,L,BUF,27,68,16,20,36
44,8477497,Sean Monahan,C,CBJ,30,70,14,22,36
44,8483505,Matthew Poitras,C,BOS,20,74,14,22,36
44,8484203,Bradly Nadeau,L,CAR,19,63,14,22,36
44,8476463,Jonas Brodin,D,MIN,31,78,9,27,36
44,8479425,Filip Hronek,D,VAN,27,75,7,29,36
44,8475171,Oliver Ekman-Larsson,D,TOR,33,73,6,30,36
44,8474151,Ryan McDonagh,D,TBL,35,79,6,30,36
44,8476979,Erik Gustafsson,D,DET,32,75,5,31,36
44,8476958,Jaccob Slavin,D,CAR,30,77,4,32,36
44,8476432,Boone Jenner,C,CBJ,31,67,19,16,35
44,8481554,Kaapo Kakko,R,NYR,23,69,16,19,35
44,8482133,Thomas Bordeleau,C,SJS,22,66,15,20,35
44,8477511,Anthony Mantha,R,CGY,30,76,14,21,35
44,8475218,Mattias Ekholm,D,EDM,34,73,12,23,35
44,8478891,Mason Appleton,C,WPG,28,65,11,24,35
44,8474716,Jared Spurgeon,D,MIN,35,76,8,27,35
44,8477969,Marcus Pettersson,D,PIT,28,74,7,28,35
44,8481581,Thomas Harley,D,DAL,23,72,6,29,35
44,8475763,Kevin Hayes,R,PIT,32,66,19,15,34
44,8481186,Logan O'Connor,R,COL,28,80,18,16,34
44,8478020,Michael Amadio,R,OTT,28,74,18,16,34
44,8478057,Dakota Joshua,C,VAN,28,71,17,17,34
44,8475314,Anders Lee,L,NYI,34,76,17,17,34
44,8476892,Colton Parayko,D,STL,31,75,7,27,34
44,8481703,Valtteri Puustinen,R,PIT,25,57,6,28,34
44,8480145,Neal Pionk,D,WPG,29,73,5,29,34
44,8480068,Ryan Poehling,C,PHI,25,70,19,14,33
44,8479393,Noah Gregor,L,OTT,26,75,17,16,33
44,8476469,Joel Armia,R,MTL,31,66,17,16,33
44,8473533,Jordan Staal,C,CAR,36,70,16,17,33
44,8479353,Brett Howden,C,VGK,26,73,15,18,33
44,8477505,Alexander Wennberg,C,SJS,30,63,14,19,33
44,8482092,Ridly Greig,C,OTT,22,77,12,21,33
44,8476923,Damon Severson,D,CBJ,30,79,12,21,33
44,8480078,Filip Chytil,C,NYR,25,63,12,21,33
44,8476474,Stefan Noesen,R,NJD,31,73,11,22,33
44,8475764,Cam Fowler,D,ANA,33,69,9,24,33
44,8476854,Hampus Lindholm,D,BOS,30,69,7,26,33
44,8481604,Pavel Dorofeyev,L,VGK,24,69,17,15,32
44,8477425,Miles Wood,L,COL,29,77,17,15,32
44,8477952,Robby Fabbri,C,ANA,28,65,15,17,32
44,8480336,Sean Walker,D,CAR,30,76,14,18,32
44,8482079,Marco Rossi,C,MIN,23,55,12,20,32
44,8477839,Conor Sheary,L,TBL,32,79,12,20,32
44,8476458,Ryan Strome,C,ANA,31,68,11,21,32
44,8473422,Nick Foligno,L,CHI,37,58,11,21,32
44,8480871,Adam Boqvist,D,FLA,24,69,9,23,32
44,8476419,Jean-Gabriel Pageau,C,NYI,32,75,8,24,32
44,8478507,John Marino,D,UTA,27,67,8,24,32
44,8481524,Bowen Byram,D,BUF,23,69,6,26,32
44,8473507,Jeff Petry,D,DET,37,76,6,26,32
44,8477947,Sonny Milano,L,WSH,28,66,13,18,31
44,8479398,Samuel Girard,D,COL,26,69,7,24,31
44,8480043,Timothy Liljegren,D,TOR,25,64,3,28,31
44,8483490,Pavel Mintyukov,D,ANA,21,75,2,29,31
44,8482720,Matthew Knies,L,TOR,22,70,17,13,30
44,8477919,Frederick Gaudreau,C,MIN,31,67,16,14,30
44,8483524,Shane Wright,C,SEA,20,59,16,14,30
44,8479591,Michael Eyssimont,C,TBL,28,77,16,14,30
44,8480252,Cole Guttman,C,CHI,25,43,16,14,30
44,8482705,Cole Sillinger,C,CBJ,21,62,15,15,30
44,8482125,Alexander Holtz,R,VGK,22,69,15,15,30
44,8477987,Ryan Donato,C,CHI,28,61,12,18,30
44,8474053,Logan Couture,C,SJS,35,66,11,19,30
44,8475714,Calle Jarnkrok,C,TOR,33,72,11,19,30
44,8482624,Daniil Miromanov,D,CGY,27,66,10,20,30
44,8478911,Matt Roy,D,WSH,29,69,10,20,30
44,8479639,Dylan Coghlan,D,WPG,26,64,9,21,30
44,8482122,Brock Faber,D,MIN,22,80,6,24,30
44,8482074,Connor Zary,C,CGY,23,62,16,13,29
44,8480762,Eric Robinson,L,CAR,29,56,15,14,29
44,8480748,Kiefer Sherwood,L,VAN,29,57,14,15,29
44,8482055,Drew O'Connor,L,PIT,26,66,14,15,29
44,8474149,Evgenii Dadonov,R,DAL,35,77,13,16,29
44,8482101,Danil Gushchin,L,SJS,22,62,13,16,29
44,8476292,Ondrej Palat,L,NJD,33,66,12,17,29
44,8480802,Ryan McLeod,C,BUF,25,56,10,19,29
44,8482146,Luke Evangelista,R,NSH,22,69,8,21,29
44,8482105,Jake Sanderson,D,OTT,22,71,8,21,29
44,8475200,Dmitry Orlov,D,CAR,33,78,5,24,29
44,8478109,Victor Olofsson,L,VGK,29,69,14,14,28
44,8478463,Anthony Beauvillier,L,PIT,27,62,14,14,28
44,8482475,Yegor Chinakhov,R,CBJ,23,69,13,15,28
44,8476878,Zemgus Girgensons,C,TBL,30,79,13,15,28
44,8479996,Cody Glass,C,NSH,25,63,12,16,28
44,8475231,Casey Cizikas,C,NYI,33,70,10,18,28
44,8479315,Joey Anderson,R,CHI,26,53,10,18,28
44,8476312,Josh Manson,D,COL,33,56,8,20,28
44,8481546,Cam York,D,PHI,23,63,7,21,28
44,8480835,Jack Drury,C,CAR,24,55,7,21,28
44,8481656,Aliaksei Protas,C,WSH,23,64,7,21,28
44,8481582,Nicholas Robertson,L,TOR,23,68,7,21,28
44,8481606,Jordan Spence,D,LAK,23,60,6,22,28
44,8477948,Travis Sanheim,D,PHI,28,73,5,23,28
44,8479941,Justin Danforth,R,CBJ,31,61,17,10,27
44,8474715,Cameron Atkinson,R,TBL,35,80,15,12,27
44,8483445,Cutter Gauthier,L,ANA,20,63,10,17,27
44,8477953,Kasperi Kapanen,R,STL,28,68,9,18,27
44,8478133,Jake Evans,C,MTL,28,68,8,19,27
44,8477435,Ryan Graves,D,PIT,29,73,6,21,27
44,8475324,Nick Jensen,D,OTT,34,66,6,21,27
44,8480891,Michael Kesselring,D,UTA,24,59,5,22,27
44,8482655,Janis Moser,D,TBL,24,81,4,23,27
44,8478851,Alexandre Carrier,D,NSH,28,64,2,25,27
44,8471698,T.J. Oshie,R,WSH,38,62,17,9,26
44,8470621,Corey Perry,R,EDM,39,67,14,12,26
44,8480893,Kirill Marchenko,R,CBJ,24,61,14,12,26
44,8475791,Taylor Hall,L,CHI,33,52,13,13,26
44,8476925,Colton Sissons,C,NSH,31,70,11,15,26
44,8475722,Jason Zucker,L,BUF,32,64,11,15,26
44,8476927,Teddy Blueger,C,VAN,30,62,11,15,26
44,8475149,Marcus Johansson,L,MIN,34,64,11,15,26
44,8481522,Peyton Krebs,C,BUF,23,65,11,15,26
44,8481580,Connor McMichael,C,WSH,23,63,10,16,26
44,8480813,Joe Veleno,C,DET,24,75,10,16,26
44,8481523,Kirby Dach,C,MTL,23,68,8,18,26
44,8478508,Yakov Trenin,C,MIN,27,59,8,18,26
44,8476525,Colin Miller,D,WPG,32,69,6,20,26
44,8479371,Dante Fabbro,D,NSH,26,68,6,20,26
44,8480817,K'Andre Miller,D,NYR,24,72,5,21,26
44,8477220,Nate Schmidt,D,FLA,33,67,5,21,26
44,8476331,Dylan DeMelo,D,WPG,31,66,5,21,26
44,8481093,Rafael Harvey-Pinard,L,MTL,25,68,11,14,25
44,8476921,Jordan Martinook,L,CAR,32,62,10,15,25
44,8476480,Vladislav Namestnikov,C,WPG,32,65,9,16,25
44,8476917,Adam Pelech,D,NYI,30,77,7,18,25
44,8482111,Justin Barron,D,MTL,23,65,7,18,25
44,8483468,Jiri Kulich,C,BUF,20,59,7,18,25
44,8480246,Nick Perbix,D,TBL,26,68,4,21,25
44,8478500,Ivan Provorov,D,CBJ,27,78,3,22,25
44,8476981,Josh Anderson,R,MTL,30,71,13,11,24
44,8481704,Juuso Parssinen,C,NSH,23,59,12,12,24
44,8476278,Colin Blackwell,C,DAL,31,75,12,12,24
44,8476822,Luke Glendening,C,TBL,35,80,10,14,24
44,8481481,Blake Lizotte,C,PIT,27,60,9,15,24
44,8479316,Luke Kunin,C,SJS,27,64,9,15,24
44,8482097,Jack Quinn,R,BUF,23,65,8,16,24
44,8478882,Vladislav Gavrikov,D,LAK,29,69,6,18,24
44,8479661,Tanner Jeannot,L,LAK,27,79,14,9,23
44,8483491,Ivan Miroshnichenko,L,WSH,20,62,12,11,23
44,8481032,Paul Cotter,C,NJD,25,59,11,12,23
44,8482089,Jake Neighbours,L,STL,22,69,11,12,23
44,8481789,Tye Kartye,L,SEA,23,48,11,12,23
44,8483457,Lane Hutson,D,MTL,20,69,9,14,23
44,8483493,Frank Nazar,C,CHI,20,53,8,15,23
44,8480878,Nils Lundkvist,D,DAL,24,73,5,18,23
44,8477845,Trevor van Riemsdyk,D,WSH,33,60,5,18,23
44,8481568,Alex Vlasic,D,CHI,23,55,3,20,23
44,8480789,Oliver Wahlstrom,R,NYI,24,73,13,9,22
44,8480855,Jack McBain,C,UTA,24,67,11,11,22
44,8480995,Pontus Holmberg,R,TOR,25,60,11,11,22
44,8477478,William Carrier,L,CAR,30,53,10,12,22
44,8473563,Nicklas Backstrom,C,WSH,37,47,10,12,22
44,8477903,Garnet Hathaway,R,PHI,33,68,10,12,22
44,8480003,Jesper Boqvist,C,FLA,26,70,9,13,22
44,8480035,Henri Jokiharju,D,BUF,25,65,8,14,22
44,8476856,Mathew Dumba,D,DAL,30,69,6,16,22
44,8482671,Owen Power,D,BUF,22,63,5,17,22
44,8476902,Esa Lindell,D,DAL,30,71,5,17,22
44,8476624,Barclay Goodrow,C,SJS,31,47,5,17,22
44,8474574,Tyler Myers,D,VAN,34,68,4,18,22
44,8474673,TJ Brodie,D,CHI,34,62,3,19,22
44,8480873,Rasmus Sandin,D,WSH,24,64,2,20,22
44,8479390,Taylor Raddysh,R,WSH,26,65,13,8,21
44,8482259,Bobby McMann,C,TOR,28,61,13,8,21
44,8479414,Nathan Bastian,R,NJD,27,55,12,9,21
44,8477989,Christian Dvorak,C,MTL,28,61,10,11,21
44,8480448,Parker Kelly,L,COL,25,76,10,11,21
44,8475220,Marcus Foligno,L,MIN,33,58,9,12,21
44,8478432,Christian Fischer,R,DET,27,69,8,13,21
44,8475790,Erik Gudbranson,D,CBJ,32,80,8,13,21
44,8483565,Nick Blankenburg,D,NSH,26,63,6,15,21
44,8482142,Jamie Drysdale,D,PHI,22,67,6,15,21
44,8479976,Juuso Valimaki,D,UTA,26,60,5,16,21
44,8480144,David Kampf,C,TOR,29,69,5,16,21
44,8482067,Connor Mackey,D,NYR,28,59,2,19,21
44,8475233,David Savard,D,MTL,34,59,2,19,21
44,8478840,Will Borgen,D,SEA,28,61,2,19,21
44,8479402,Jake Bean,D,CGY,26,65,2,19,21
44,8482679,Matt Coronato,R,CGY,22,65,12,8,20
44,8479368,Max Jones,L,BOS,26,67,11,9,20
44,8479328,Julien Gauthier,R,NYI,27,68,11,9,20
44,8482117,Lukas Reichel,L,CHI,22,62,10,10,20
44,8481477,Nico Sturm,C,SJS,29,60,10,10,20
44,8476918,Jimmy Vesey,L,NYR,31,70,9,11,20
44,8482809,Jackson Blake,R,CAR,21,57,8,12,20
44,8477979,Nicolas Aube-Kubel,R,BUF,28,57,8,12,20
44,8475855,Jesper Fast,R,CAR,33,60,7,13,20
44,8475181,Nick Leddy,D,STL,33,67,5,15,20
44,8481059,Scott Perunovich,D,STL,26,67,4,16,20
44,8479980,Nicolas Hague,D,VGK,26,48,2,18,20
44,8475188,Brayden McNabb,D,VGK,33,61,1,19,20
44,8480185,Eetu Luostarinen,C,FLA,26,75,10,9,19
44,8481624,Ilya Mikheyev,R,CHI,30,50,10,9,19
44,8482157,Will Cuylle,L,NYR,22,60,10,9,19
44,8477015,Connor Brown,R,EDM,30,66,9,10,19
44,8482749,Joshua Roy,R,MTL,21,62,9,10,19
44,8476889,Radek Faksa,C,STL,30,59,9,10,19
44,8478043,Sam Lafferty,C,BUF,29,56,8,11,19
44,8478211,Dryden Hunt,L,CGY,29,51,8,11,19
44,8478569,Noel Acciari,C,PIT,33,55,7,12,19
44,8480070,Ian Mitchell,D,BOS,25,57,6,13,19
44,8477507,Nikita Zadorov,D,BOS,29,66,5,14,19
44,8482803,Olen Zellweger,D,ANA,21,76,5,14,19
44,8482730,Brandt Clarke,D,LAK,21,51,5,14,19
44,8476879,Cody Ceci,D,EDM,31,73,3,16,19
44,8480049,Dylan Samberg,D,WPG,25,65,2,17,19
44,8482087,Kaiden Guhle,D,MTL,22,63,2,17,19
44,8482737,Zack Bolduc,C,STL,21,56,12,6,18
44,8473453,Trevor Lewis,C,LAK,37,75,12,6,18
44,8475193,Tomas Tatar,L,NJD,34,64,10,8,18
44,8478585,Derek Ryan,C,EDM,38,63,9,9,18
44,8476873,Mark Jankowski,C,NSH,30,44,9,9,18
44,8483499,Liam Ohgren,L,MIN,20,56,9,9,18
44,8479359,Beck Malenstyn,L,BUF,26,51,9,9,18
44,8476960,Andreas Athanasiou,C,CHI,30,55,8,10,18
44,8476994,Vinnie Hinostroza,C,NSH,30,47,7,11,18
44,8478013,Jake Walman,D,SJS,28,65,5,13,18
44,8478970,Jalen Chatfield,D,CAR,28,68,5,13,18
44,8476891,Matthew Grzelcyk,D,PIT,30,74,5,13,18
44,8480172,Jan Rutta,D,SJS,34,66,5,13,18
44,8480222,Sebastian Aho,D,PIT,28,77,4,14,18
44,8479998,Mikey Anderson,D,LAK,25,67,4,14,18
44,8475455,Brenden Dillon,D,NJD,34,61,4,14,18
44,8477365,Connor Clifton,D,BUF,29,56,2,16,18
44,8478416,Erik Cernak,D,TBL,27,72,2,16,18
44,8478178,Darren Raddysh,D,TBL,28,72,2,16,18
44,8476429,Scott Mayfield,D,NYI,32,78,0,18,18
44,8480192,Johnathan Kovacevic,D,NJD,27,51,9,8,17
44,8484149,Gavin Brindley,C,CBJ,20,48,9,8,17
44,8477931,Tomas Nosek,L,FLA,32,65,8,9,17
44,8480073,Erik Brannstrom,D,COL,25,65,7,10,17
44,8479983,Mario Ferraro,D,SJS,26,67,6,11,17
44,8483495,Simon Nemec,D,NJD,20,57,6,11,17
44,8479369,Andrew Peeke,D,BOS,26,58,6,11,17
44,8476897,Oskar Sundqvist,C,STL,30,68,5,12,17
44,8477369,Carson Soucy,D,VAN,30,55,5,12,17
44,8480848,Ty Dellandrea,C,SJS,24,43,5,12,17
44,8476329,Travis Boyd,C,MIN,31,56,4,13,17
44,8478452,Caleb Jones,D,LAK,27,52,4,13,17
44,8481019,David Gustafsson,C,WPG,24,46,4,13,17
44,8474090,Brendan Smith,D,DAL,35,60,4,13,17
44,8478859,Niko Mikkola,D,FLA,28,55,3,14,17
44,8475690,Chris Tanev,D,TOR,35,57,2,15,17
44,8481537,Nikita Okhotiuk,D,CGY,24,55,2,15,17
44,8482073,Braden Schneider,D,NYR,23,68,1,16,17
44,8479026,Philippe Myers,D,TOR,27,62,1,16,17
44,8479336,Carl Grundstrom,R,SJS,27,52,9,7,16
44,8479293,Brandon Tanev,L,SEA,33,62,8,8,16
44,8477392,Hudson Fasching,R,NYI,29,64,8,8,16
44,8478421,A.J. Greer,L,FLA,28,56,8,8,16
44,8477450,Jason Dickinson,C,CHI,29,55,7,9,16
44,8481013,Jonatan Berggren,R,DET,24,63,7,9,16
44,8480806,Isac Lundestrom,C,ANA,25,54,7,9,16
44,8477406,Mattias Janmark,C,EDM,32,65,6,10,16
44,8481517,Brett Leason,R,ANA,25,60,6,10,16
44,8481751,Lukas Rousek,R,BUF,25,39,5,11,16
44,8477446,Michael McCarron,R,NSH,29,54,4,12,16
44,8481178,Egor Zamula,D,PHI,24,59,3,13,16
44,8478136,Jake Middleton,D,MIN,28,76,1,15,16
44,8480281,Alexey Toropchenko,R,STL,25,59,12,3,15
44,8477380,Jonny Brodzinski,C,NYR,31,48,12,3,15
44,8477353,Tyler Motte,C,DET,29,76,10,5,15
44,8480980,Connor Dewar,C,TOR,25,72,9,6,15
44,8480011,Klim Kostin,C,SJS,25,52,9,6,15
44,8479543,Michael Pezzetta,L,MTL,26,54,9,6,15
44,8481601,Simon Holmstrom,R,NYI,23,66,8,7,15
44,8480074,Alexandre Texier,C,STL,25,56,8,7,15
44,8480205,Emil Bemstrom,C,PIT,25,55,7,8,15
44,8477508,Curtis Lazar,C,NJD,29,55,6,9,15
44,8475279,Ben Chiarot,D,DET,33,68,6,9,15
44,8479671,Mathieu Olivier,R,CBJ,27,45,6,9,15
44,8479439,Jacob MacDonald,D,COL,31,54,5,10,15
44,8475750,Jon Merrill,D,MIN,32,69,5,10,15
44,8476988,Matt Benning,D,SJS,30,73,4,11,15
44,8483482,Tristan Luneau,D,ANA,20,66,4,11,15
44,8482155,Alex Laferriere,R,LAK,23,63,4,11,15
44,8478468,Jeremy Lauzon,D,NSH,27,52,4,11,15
44,8479372,Joshua Mahura,D,SEA,26,58,3,12,15
44,8479718,Alex Barré-Boulet,C,MTL,27,48,3,12,15
44,8480727,Zach Whitecloud,D,VGK,28,50,3,12,15
44,8477488,Brett Pesce,D,NJD,30,66,2,13,15
44,8479324,Ryan Lindgren,D,NYR,26,64,2,13,15
44,8475225,Craig Smith,C,CHI,35,51,9,5,14
44,8481617,Vasily Podkolzin,R,VAN,23,47,9,5,14
44,8476422,Mike Reilly,D,NYI,31,74,6,8,14
44,8481553,Bobby Brink,R,PHI,23,54,6,8,14
44,8480021,Jack Studnicka,C,LAK,25,60,6,8,14
44,8478443,Brandon Carlo,D,BOS,28,56,5,9,14
44,8482859,Zack Ostapchuk,C,OTT,21,57,5,9,14
44,8481167,Brayden Pachal,D,CGY,25,48,5,9,14
44,8481527,Kaedan Korczak,D,VGK,23,49,4,10,14
44,8479066,Ryan Lomberg,L,CGY,30,58,4,10,14
44,8476967,Brett Kulak,D,EDM,30,67,4,10,14
44,8476931,Jake McCabe,D,TOR,31,58,3,11,14
44,8480807,Mattias Samuelsson,D,BUF,24,54,2,12,14
44,8474013,Ian Cole,D,UTA,35,58,2,12,14
44,8482095,Tyler Kleven,D,OTT,22,46,2,12,14
44,8476467,Jamie Oleksiak,D,SEA,32,64,1,13,14
44,8475179,Dmitry Kulikov,D,FLA,34,61,1,13,14
44,8482451,Mikael Pyyhtia,L,CBJ,23,47,1,13,14
44,8480950,Ilya Lyubushkin,D,DAL,30,60,1,13,14
44,8477573,Nathan Walker,L,STL,30,43,8,5,13
44,8480289,Morgan Barron,C,WPG,26,52,7,6,13
44,8477482,Zachary Sanford,L,CHI,30,41,7,6,13
44,8479370,Tyson Jost,C,CAR,26,52,6,7,13
44,8481716,Dmitri Voronkov,L,CBJ,24,47,5,8,13
44,8479344,Jesse Puljujarvi,R,PIT,26,43,5,8,13
44,8481521,Ronnie Attard,D,PHI,25,54,4,9,13
44,8480796,Martin Fehervary,D,WSH,25,57,4,9,13
44,8480845,Rasmus Kupari,C,WPG,24,39,4,9,13
44,8480157,Calle Rosen,D,COL,30,44,3,10,13
44,8477499,Rasmus Ristolainen,D,PHI,30,55,3,10,13
44,8482245,Artem Zub,D,OTT,29,72,2,11,13
44,8471709,Marc-Edouard Vlasic,D,SJS,37,58,1,12,13
44,8474568,Luke Schenn,D,NSH,35,48,1,12,13
44,8478434,Keegan Kolesar,R,VGK,27,63,8,4,12
44,8471817,Ryan Reaves,R,TOR,37,55,8,4,12
44,8481592,Jakob Pelletier,L,CGY,23,45,8,4,12
44,8482077,Dylan Holloway,L,EDM,23,47,7,5,12
44,8482062,Cole Smith,L,NSH,29,52,7,5,12
44,8481641,Joel Kiviranta,L,COL,28,71,5,7,12
44,8475842,Sam Carrick,C,NYR,32,59,5,7,12
44,8476457,Adam Larsson,D,SEA,32,59,4,8,12
44,8475343,Nic Dowd,C,WSH,34,54,4,8,12
44,8478399,Jonas Siegenthaler,D,NJD,27,63,4,8,12
44,8480887,Jordan Harris,D,MTL,24,63,3,9,12
44,8484254,Akito Hirose,D,VAN,25,43,3,9,12
44,8470600,Ryan Suter,D,STL,39,55,2,10,12
44,8481161,Jake Christiansen,D,CBJ,25,51,2,10,12
44,8479348,Kale Clague,D,BUF,26,42,2,10,12
44,8480879,Jacob Bernard-Docker,D,OTT,24,54,2,10,12
44,8479249,Andrew Poturalski,C,SJS,30,26,1,11,12
44,8478831,Kevin Stenlund,C,UTA,28,53,9,2,11
44,8482762,Simon Edvinsson,D,DET,21,57,8,3,11
44,8482807,Ethan Del Mastro,D,CHI,21,55,7,4,11
44,8481028,Martin Pospisil,C,CGY,25,57,7,4,11
44,8478451,Ethan Bear,D,WSH,27,51,5,6,11
44,8479520,Brandon Duhaime,R,WSH,27,53,5,6,11
44,8474034,Patrick Maroon,L,CHI,36,46,5,6,11
44,8481441,Joe Snively,C,DET,28,60,4,7,11
44,8480355,Mark Kastelic,C,BOS,25,65,4,7,11
44,8482744,James Malatesta,L,CBJ,21,37,4,7,11
44,8480058,Pierre-Olivier Joseph,D,STL,25,45,4,7,11
44,8476874,Olli Maatta,D,DET,30,60,3,8,11
44,8482784,Zach Dean,C,STL,21,40,3,8,11
44,8483466,Kevin Korchinski,D,CHI,20,55,3,8,11
44,8480441,Trey Fix-Wolansky,R,CBJ,25,35,3,8,11
44,8476372,Nick Seeler,D,PHI,31,48,3,8,11
44,8482176,Wyatt Kaiser,D,CHI,22,52,2,9,11
44,8481567,Henry Thrun,D,SJS,23,49,2,9,11
44,8483549,Lucas Condotta,L,MTL,27,36,2,9,11
44,8475462,Radko Gudas,D,ANA,34,57,1,10,11
44,8481754,Nikita Nesterenko,C,ANA,23,32,8,2,10
44,8479536,Axel Jonsson-Fjallby,L,WPG,26,41,7,3,10
44,8482747,Brennan Othmann,L,NYR,21,42,7,3,10
44,8479981,Jonah Gadjovich,L,FLA,26,47,7,3,10
44,8475235,Nicolas Deslauriers,L,PHI,33,54,5,5,10
44,8481014,Alexander Romanov,D,NYI,24,75,4,6,10
44,8482148,Hendrix Lapierre,C,WSH,22,46,4,6,10
44,8474567,Zach Bogosian,D,MIN,34,62,4,6,10
44,8482659,Josh Doan,R,UTA,22,49,4,6,10
44,8482496,Nils Aman,C,VAN,24,41,4,6,10
44,8482634,Alex Steeves,C,TOR,25,45,3,7,10
44,8481599,Victor Soderstrom,D,UTA,23,42,3,7,10
44,8474166,Alec Martinez,D,CHI,37,50,3,7,10
44,8480001,Urho Vaakanainen,D,ANA,25,57,2,8,10
44,8476952,Dominic Toninato,C,WPG,30,35,2,8,10
44,8479378,Logan Stanley,D,WPG,26,40,2,8,10
44,8479982,Conor Timmins,D,TOR,26,51,1,9,10
44,8480860,Kevin Bahl,D,CGY,24,53,1,9,10
44,8477018,Ben Hutton,D,VGK,31,46,1,9,10
44,8480196,Jacob Bryson,D,BUF,27,43,0,10,10
44,8476858,Phillip Di Giuseppe,L,VAN,31,42,8,1,9
44,8480025,MacKenzie Entwistle,R,FLA,25,57,6,3,9
44,8476934,Brock McGinn,L,ANA,30,51,5,4,9
44,8479944,Zach Aston-Reese,C,VGK,30,51,4,5,9
44,8473446,Erik Johnson,D,PHI,36,46,4,5,9
44,8481550,Adam Beckman,L,NJD,23,35,4,5,9
44,8477962,Brendan Lemieux,L,CAR,28,33,3,6,9
44,8479972,Mason Shaw,C,WPG,26,36,3,6,9
44,8477938,Haydn Fleury,D,WPG,28,38,2,7,9
44,8479442,Troy Stecher,D,EDM,30,53,2,7,9
44,8483460,David Jiricek,D,CBJ,21,62,1,8,9
44,8482666,Scott Morrow,D,CAR,22,44,6,2,8
44,8483763,Maksymilian Szuber,D,UTA,22,31,6,2,8
44,8476374,Sean Kuraly,C,CBJ,31,57,5,3,8
44,8480880,Jakub Lauko,C,MIN,24,34,5,3,8
44,8476442,Matt Nieto,L,PIT,32,48,4,4,8
44,8479291,Kevin Rooney,C,CGY,31,45,4,4,8
44,8477401,John Hayden,C,SEA,29,33,4,4,8
44,8476867,Brendan Gaunce,C,MIN,30,35,4,4,8
44,8477070,Liam O'Brien,C,UTA,30,57,3,5,8
44,8478424,Jansen Harkins,C,ANA,27,38,3,5,8
44,8477851,Jordan Oesterle,D,BOS,32,46,3,5,8
44,8481600,Tobias Bjornfot,D,FLA,23,37,3,5,8
44,8481701,Santeri Hatakka,D,NJD,23,33,3,5,8
44,8479576,Vincent Desharnais,D,VAN,28,30,3,5,8
44,8480844,Grigori Denisenko,L,VGK,24,30,2,6,8
44,8482172,Landon Slaggert,L,CHI,22,29,2,6,8
44,8481598,Philip Broberg,D,EDM,23,39,2,6,8
44,8479320,Maxime Lajoie,D,SEA,27,26,2,6,8
44,8477384,Joshua Brown,D,EDM,30,42,1,7,8
44,8476441,Joel Edmundson,D,LAK,31,42,1,7,8
44,8478454,Noah Juulsen,D,VAN,27,37,1,7,8
44,8481541,Samuel Bolduc,D,NYI,24,23,1,7,8
44,8475718,Justin Holl,D,DET,32,54,0,8,8
44,8482145,Mavrik Bourque,C,DAL,22,50,5,2,7
44,8475177,Calvin de Haan,D,COL,33,45,4,3,7
44,8483630,Pavol Regenda,L,ANA,25,33,4,3,7
44,8482765,Isak Rosen,R,BUF,21,29,4,3,7
44,8481708,Zac Jones,D,NYR,24,46,3,4,7
44,8483619,Filip Roos,D,OTT,25,36,3,4,7
44,8481605,Jackson LaCombe,D,ANA,23,33,3,4,7
44,8482192,Isaak Phillips,D,CHI,23,50,2,5,7
44,8479772,Zack MacEwen,R,OTT,28,52,2,5,7
44,8475762,Derek Forbort,D,VAN,32,43,2,5,7
44,8474612,Travis Hamonic,D,OTT,34,51,2,5,7
44,8475208,Brian Dumoulin,D,ANA,33,59,1,6,7
44,8482733,Logan Mailloux,D,MTL,31,33,1,6,7
44,8471677,Jack Johnson,D,CBJ,37,64,1,6,7
44,8482751,Ryan Winterton,C,SEA,21,42,1,6,7
44,8482250,Callahan Burke,C,VGK,27,20,1,6,7
44,8477073,Kurtis MacDermid,L,NJD,30,31,0,7,7
44,8478450,Parker Wotherspoon,D,BOS,27,37,0,7,7
44,8481556,John Beecher,C,BOS,23,31,6,0,6
44,8482070,Mitchell Chaffee,R,TBL,26,42,6,0,6
44,8483012,Logan Morrison,C,SEA,22,34,4,2,6
44,8479379,Givani Smith,R,SJS,26,26,3,3,6
44,8479968,Vinni Lettieri,C,BOS,29,51,3,3,6
44,8478017,Mark Friedman,D,VAN,29,37,2,4,6
44,8484258,Sam Malinski,D,COL,26,19,2,4,6
44,8481122,Simon Benoit,D,TOR,26,40,2,4,6
44,8480834,Ty Emberson,D,SJS,24,37,2,4,6
44,8477467,Gustav Olofsson,D,SEA,30,28,2,4,6
44,8480990,Declan Chisholm,D,MIN,24,34,1,5,6
44,8478146,Matthew Highmore,C,OTT,28,35,1,5,6
44,8477335,Kyle Burroughs,D,LAK,29,41,1,5,6
44,8476473,Connor Murphy,D,CHI,31,36,1,5,6
44,8482141,Lukas Cormier,D,VGK,22,29,1,5,6
44,8478409,Anthony Richard,C,PHI,28,29,0,6,6
44,8482964,Arber Xhekaj,D,MTL,23,53,0,6,6
44,8484911,Collin Graf,R,SJS,22,37,0,6,6
44,8477971,Andreas Englund,D,LAK,28,36,0,6,6
44,8477887,Patrick Brown,C,BOS,32,53,4,1,5
44,8482153,Brendan Brisson,C,VGK,23,35,3,2,5
44,8483397,Marc McLaughlin,C,BOS,25,21,3,2,5
44,8478874,Adam Gaudette,R,OTT,28,30,3,2,5
44,8483570,Ben Meyers,C,SEA,26,36,3,2,5
44,8481609,Vladislav Kolyachonok,D,UTA,23,32,3,2,5
44,8479367,William Lockwood,R,FLA,26,24,2,3,5
44,8482713,Mackie Samoskevich,R,FLA,22,35,2,3,5
44,8481518,Nolan Foote,L,NJD,24,34,1,4,5
44,8479994,Jaret Anderson-Dolan,C,WPG,25,34,1,4,5
44,8480292,Carson Meyer,R,ANA,27,36,1,4,5
44,8482861,Vincent Iorio,D,WSH,22,33,1,4,5
44,8479985,Cale Fleury,D,SEA,26,23,1,4,5
44,8479362,Riley Tufte,L,BOS,26,21,1,4,5
44,8482511,Mason Lohrei,D,BOS,23,32,1,4,5
44,8482144,Jack Thompson,D,SJS,22,28,0,5,5
44,8477034,Jaycob Megna,D,FLA,32,48,0,5,5
44,8484325,Waltteri Merela,C,TBL,26,25,4,0,4
44,8482165,Yan Kuznetsov,D,CGY,22,18,3,1,4
44,8481043,Cole Koepke,L,BOS,26,15,3,1,4
44,8480468,James Hamblin,L,EDM,25,19,3,1,4
44,8482166,Shakir Mukhamadullin,D,SJS,22,49,2,2,4
44,8479986,Kole Lind,R,DAL,26,52,2,2,4
44,8480007,Jonas Rondbjerg,R,VGK,25,35,2,2,4
44,8482102,Vasily Ponomarev,C,PIT,22,31,2,2,4
44,8484287,Cole McWard,D,VAN,23,27,2,2,4
44,8480032,Shane Bowers,C,NJD,25,17,2,2,4
44,8483512,Matthew Savoie,C,EDM,20,20,2,2,4
44,8481030,Jack St. Ivany,D,PIT,25,18,2,2,4
44,8477462,Robert Hagg,D,VGK,29,20,1,3,4
44,8477527,Ross Johnston,L,ANA,30,33,1,3,4
44,8481065,Angus Crookshank,L,OTT,25,20,1,3,4
44,8480890,Jan Jenik,C,OTT,24,26,1,3,4
44,8477149,Scott Sabourin,R,SJS,32,23,1,3,4
44,8480870,Bo Groulx,C,NYR,24,27,0,4,4
44,8481147,Reese Johnson,C,MIN,26,36,3,0,3
44,8474062,Riley Nash,C,NYR,35,18,3,0,3
44,8479638,Justin Brazeau,R,BOS,26,28,2,1,3
44,8475958,Michael Sgarbossa,C,WSH,32,33,2,1,3
44,8481543,Nikita Alexandrov,C,STL,24,22,2,1,3
44,8482162,Roby Jarventie,L,EDM,22,12,2,1,3
44,8481699,Aku Raty,R,UTA,23,14,2,1,3
44,8481585,Egor Afanasyev,L,SJS,23,17,2,1,3
44,8481532,Alex Turcotte,C,LAK,23,43,1,2,3
44,8477473,Justin Bailey,R,SJS,29,17,1,2,3
44,8481679,Maxence Guenette,D,OTT,23,24,1,2,3
44,8478446,Glenn Gawdin,C,LAK,27,11,1,2,3
44,8478051,Max Willman,C,NJD,29,27,1,2,3
44,8484304,Uvis Balinskis,D,FLA,28,12,1,2,3
44,8481006,Tyler Tucker,D,STL,24,14,1,2,3
44,8481806,Louis Crevier,D,CHI,23,11,0,3,3
44,8481593,Jayden Struble,D,MTL,23,15,0,3,3
44,8482516,Matthew Kessel,D,STL,24,18,0,3,3
44,8482088,Justin Sourdif,R,FLA,22,16,2,0,2
44,8482201,Gage Goncalves,C,TBL,23,34,2,0,2
44,8483567,Georgii Merkulov,C,BOS,24,9,2,0,2
44,8480267,Sammy Walker,C,MIN,25,26,2,0,2
44,8481024,Linus Karlsson,C,VAN,25,9,2,0,2
44,8482177,Marat Khusnutdinov,C,MIN,22,30,1,1,2
44,8482858,Ryker Evans,D,SEA,23,26,1,1,2
44,8480823,Alexander Alexeyev,D,WSH,25,12,1,1,2
44,8483597,Milos Kelemen,L,UTA,25,19,1,1,2
44,8478477,Mitchell Stephens,C,SEA,27,16,1,1,2
44,8482118,Sam Colangelo,R,ANA,23,19,1,1,2
44,8477541,Dakota Mermis,D,TOR,30,15,1,1,2
44,8483432,Luca Del Bel Belluz,C,CBJ,31,11,1,1,2
44,8482652,Walker Duehr,R,CGY,27,35,0,2,2
44,8476913,Devin Shore,C,MIN,30,32,0,2,2
44,8480245,Olle Lycksell,R,PHI,25,30,0,2,2
44,8479419,Brett Murray,L,BUF,26,13,0,2,2
44,8478021,William Lagesson,D,DET,28,25,0,2,2
44,8482470,Ilya Solovyov,D,CGY,24,19,0,2,2
44,8477810,Joel Hanley,D,CGY,33,23,0,2,2
44,8479587,Rhett Gardner,C,PHI,28,26,1,0,1
44,8475413,Justin Dowling,C,NJD,34,23,1,0,1
44,8482929,Emil Lilleberg,D,TBL,23,15,1,0,1
44,8479991,Jake Leschyshyn,C,NYR,25,30,1,0,1
44,8481422,Jake Lucchini,C,NSH,29,14,1,0,1
44,8475755,Alexander Petrovic,D,DAL,32,8,1,0,1
44,8481237,Kyle MacLean,C,NYI,25,24,1,0,1
44,8481564,Ryan Johnson,D,BUF,23,15,1,0,1
44,8482147,Jean-Luc Foudy,C,COL,22,29,1,0,1
44,8483609,Adam Klapka,R,CGY,24,7,1,0,1
44,8481056,Spencer Stastney,D,NSH,24,30,0,1,1
44,8481743,Marc Del Gaizo,D,NSH,25,19,0,1,1
44,8482460,Matt Rempe,C,NYR,22,13,0,1,1
44,8483395,Arshdeep Bains,L,VAN,23,8,0,1,1
44,8475795,Dylan McIlrath,D,WSH,32,15,0,1,1
44,8483471,Brad Lambert,C,WPG,31,9,0,1,1
44,8477244,Chad Ruhwedel,D,NYR,34,31,0,1,1
44,8478011,Louie Belpedio,D,PHI,28,13,0,1,1
44,8477320,Anton Blidh,L,NYR,29,26,0,1,1
44,8482197,Adam Raska,R,MIN,23,11,0,1,1
44,8478881,Brett Seney,L,CHI,28,12,0,1,1
44,8483401,Marc Johnstone,R,PIT,28,1,0,1,1
44,8483546,Marshall Rifai,D,TOR,26,2,0,1,1
44,8478502,Dennis Gilbert,D,BUF,28,11,0,0,0
44,8482094,Daemon Hunt,D,MIN,22,11,0,0,0
44,8482061,Brandon Biro,L,SEA,26,6,0,0,0
44,8480851,Akil Thomas,C,LAK,24,13,0,0,0
44,8481719,Maxwell Crozier,D,TBL,24,21,0,0,0
44,8483489,Fraser Minten,C,TOR,31,13,0,0,0
44,8481578,Graeme Clarke,R,MIN,23,7,0,0,0
44,8483920,Pierrick Dube,R,WSH,23,4,0,0,0
44,8482787,Nikita Chibrikov,R,WPG,31,6,0,0,0
44,8481462,Mason Morelli,L,VGK,28,8,0,0,0
44,8483407,Brandon Scanlin,D,NYR,25,3,0,0,0
44,8480084,Nick DeSimone,D,NJD,30,18,0,0,0
44,8480874,Adam Ginning,D,PHI,24,10,0,0,0
44,8479330,Brandon Gignac,C,MTL,27,6,0,0,0
44,8480306,Grant Hutton,D,NYI,29,6,0,0,0
44,8475780,Chris Wagner,R,COL,33,5,0,0,0
44,8484326,Patrik Koch,D,UTA,28,1,0,0,0
44,8484255,Jason Polin,R,COL,25,7,0,0,0
44,8477993,Justin Kirkland,C,CGY,28,7,0,0,0
44,8480075,Cameron Crotty,D,MIN,25,6,0,0,0
44,8479522,Hardy Haman Aktell,D,WSH,26,3,0,0,0
44,8478854,Ryan Shea,D,PIT,27,4,0,0,0
44,8482476,Emil Heineman,L,MTL,23,7,0,0,0
44,8482126,Emil Andrae,D,PHI,31,4,0,0,0
44,8484259,Ondrej Pavel,C,COL,31,1,0,0,0
44,8484321,Nikolas Matinpalo,D,OTT,26,1,0,0,0
44,8483398,Declan Carlile,D,TBL,31,6,0,0,0
44,8481206,John Ludvig,D,PIT,24,16,0,0,0
44,8481726,Adam Edstrom,C,NYR,24,8,0,0,0
44,8479421,Jacob Moverare,D,LAK,26,2,0,0,0
44,8481655,Cole Schwindt,R,CGY,23,5,0,0,0
44,8478147,Bokondji Imama,L,PIT,28,7,0,0,0
44,8483531,Brian Halonen,L,NJD,25,4,0,0,0
44,8481534,Raphael Lavoie,C,EDM,24,4,0,0,0
44,8476323,Max McCormick,L,SEA,32,3,0,0,0
44,8483045,Cameron Butler,R,CBJ,31,0,0,0,0
44,8478956,Samuel Laberge,L,NJD,27,2,0,0,0
44,8480274,Philip Kemp,D,EDM,25,0,0,0,0
44,8470794,Joe Pavelski,C,,40,0,0,0,0
44,8479321,Lucas Johansen,D,,27,0,0,0,0
44,8477950,Tony DeAngelo,D,,29,0,0,0,0
44,8471218,Blake Wheeler,R,,38,0,0,0,0
44,8475197,Tyson Barrie,D,,33,0,0,0,0
44,8474157,Max Pacioretty,L,,36,0,0,0,0
44,8475744,Evgeny Kuznetsov,C,,32,0,0,0,0
44,8474037,James van Riemsdyk,L,,35,0,0,0,0
44,8476907,Mackenzie MacEachern,L,,30,0,0,0,0
44,8480216,Jacob Peterson,C,,25,0,0,0,0
44,8474602,Justin Schultz,D,,34,0,0,0,0
44,8482222,Alexander Barabanov,L,,30,0,0,0,0
44,8474031,Kevin Shattenkirk,D,,35,0,0,0,0
44,8477330,Dominik Kubalik,L,,29,0,0,0,0
44,8480884,Calen Addison,D,,24,0,0,0,0
44,8475906,John Klingberg,D,,32,0,0,0,0
44,8480008,Adam Ruzicka,C,,25,0,0,0,0
44,8476884,Derrick Pouliot,D,,30,0,0,0,0
44,8476919,Chris Tierney,C,,30,0,0,0,0
44,8479415,Michael McLeod,C,,26,0,0,0,0
44,8474870,Tyler Johnson,C,,34,0,0,0,0
44,8470604,Jeff Carter,C,,39,0,0,0,0
44,8478104,Sammy Blais,L,,28,0,0,0,0
44,8474884,Mike Hoffman,C,,35,0,0,0,0
44,8481591,Sam Poulin,R,,23,0,0,0,0
44,8471274,Alex Goligoski,D,,39,0,0,0,0
44,8476871,Tanner Pearson,L,,32,0,0,0,0
44,8476393,Nick Cousins,C,,31,0,0,0,0
44,8479977,Kailer Yamamoto,R,,26,0,0,0,0
44,8479346,Dillon Dube,C,,26,0,0,0,0
44,8480184,Gustav Lindstrom,D,,26,0,0,0,0
44,8479376,Victor Mete,D,,26,0,0,0,0
44,8473449,Kyle Okposo,R,,36,0,0,0,0
44,8481058,Jesse Ylonen,R,,25,0,0,0,0
44,8475752,Tyler Pitlick,C,,33,0,0,0,0
44,8481239,Samuel Fagemo,L,,24,0,0,0,0
44,8480821,Filip Zadina,R,,25,0,0,0,0
44,8470966,Mark Giordano,D,,41,0,0,0,0
44,8478495,Denis Gurianov,R,,27,0,0,0,0
44,8477464,Nic Petan,C,,29,0,0,0,0
44,8478099,Kevin Labanc,R,,29,0,0,0,0
44,8482241,Radim Zohorna,L,,28,0,0,0,0
44,8474040,Sam Gagner,C,,35,0,0,0,0
44,8479514,Rem Pitlick,C,,27,0,0,0,0
44,8478430,Oliver Kylington,D,,27,0,0,0,0
44,8479533,Joona Koppanen,L,,26,0,0,0,0
44,8479984,Cal Foote,D,,26,0,0,0,0
44,8477126,Jayson Megna,C,,34,0,0,0,0
44,8475164,Jakob Silfverberg,R,,34,0,0,0,0
44,8474009,Nick Bonino,C,,36,0,0,0,0
44,8479458,Nikita Zaitsev,D,,33,0,0,0,0
44,8477944,Jakub Vrana,L,,28,0,0,0,0
44,8471699,Andrew Cogliano,C,,37,0,0,0,0
44,8478067,Oskar Lindblom,L,,28,0,0,0,0
44,8471686,Marc Staal,D,,37,0,0,0,0
44,8470610,Zach Parise,L,,40,0,0,0,0
44,8478904,Steven Lorentz,C,,28,0,0,0,0
44,8473473,Milan Lucic,L,,36,0,0,0,0
44,8480031,Maxime Comtois,L,,25,0,0,0,0
44,8478512,Austin Czarnik,C,,32,0,0,0,0
44,8473504,Cal Clutterbuck,R,,37,0,0,0,0
44,8477454,Adam Erne,L,,29,0,0,0,0
44,8479383,Boris Katchouk,L,,26,0,0,0,0
44,8475825,Jani Hakanpää,D,,32,0,0,0,0
44,8477846,Ryan Carpenter,C,,33,0,0,0,0
44,8477930,Pierre-Edouard Bellemare,L,,39,0,0,0,0
44,8478400,Colin White,C,,27,0,0,0,0
44,8480226,Marián Studenic,R,,26,0,0,0,0
44,8480853,Liam Foudy,C,,24,0,0,0,0
44,8475797,Jarred Tinordi,D,,32,0,0,0,0
44,8479423,Alex Nylander,L,,26,0,0,0,0
44,8474618,Marco Scandella,D,,34,0,0,0,0
44,8478028,Fredrik Olofsson,L,,28,0,0,0,0
44,8474709,Matt Martin,L,,35,0,0,0,0
44,8481070,Hugh McGing,L,,26,0,0,0,0
44,8479546,Oskar Steen,C,,26,0,0,0,0
44,8474145,Robert Bortuzzo,D,,35,0,0,0,0
44,8476915,Jujhar Khaira,L,,30,0,0,0,0
44,8475278,Byron Froese,C,,33,0,0,0,0
44,8481812,Nikolai Knyzhov,D,,27,0,0,0,0
44,8478408,Travis Dermott,D,,28,0,0,0,0
44,8481077,John Leonard,L,,26,0,0,0,0
44,8479547,Matthew Phillips,R,,26,0,0,0,0
44,8480836,Jonathan Gruden,C,,24,0,0,0,0
44,8481690,Tyler Angle,C,,24,0,0,0,0
44,8475766,Austin Watson,L,,32,0,0,0,0
44,8481016,Ruslan Iskhakov,C,,24,0,0,0,0
44,8478078,Rourke Chartier,C,,28,0,0,0,0
44,8480776,Sheldon Rempal,R,,29,0,0,0,0
44,8484314,Jiri Smejkal,L,,28,0,0,0,0
45,8478402,Connor McDavid,C,EDM,27,82,34,98,132
45,8477492,Nathan MacKinnon,C,COL,29,81,61,69,130
45,8478420,Mikko Rantanen,R,COL,28,80,50,79,129
45,8476453,Nikita Kucherov,R,TBL,31,82,35,92,127
45,8477939,William Nylander,R,TOR,28,80,57,63,120
45,8481559,Jack Hughes,C,NJD,23,78,50,70,120
45,8477956,David Pastrnak,R,BOS,28,79,56,62,118
45,8478483,Mitch Marner,R,TOR,27,80,43,74,117
45,8479314,Matthew Tkachuk,L,FLA,27,80,43,68,111
45,8480027,Jason Robertson,L,DAL,25,80,39,69,108
45,8478864,Kirill Kaprizov,L,MIN,27,69,40,62,102
45,8479318,Auston Matthews,C,TOR,27,80,62,39,101
45,8476887,Filip Forsberg,L,NSH,30,70,34,66,100
45,8477493,Aleksander Barkov,C,FLA,29,80,38,60,98
45,8478445,Mathew Barzal,C,NYI,27,80,27,71,98
45,8478439,Travis Konecny,R,PHI,27,78,44,51,95
45,8477934,Leon Draisaitl,C,EDM,29,76,38,56,94
45,8474564,Steven Stamkos,C,NSH,34,74,47,46,93
45,8477501,Valeri Nichushkin,R,COL,29,81,44,49,93
45,8476468,J.T. Miller,C,VAN,31,76,36,55,91
45,8480012,Elias Pettersson,C,VAN,26,75,34,56,90
45,8478550,Artemi Panarin,L,NYR,33,75,33,57,90
45,8478403,Jack Eichel,C,VGK,28,80,42,47,89
45,8481557,Matt Boldy,L,MIN,23,74,34,55,89
45,8475913,Mark Stone,R,VGK,32,75,39,49,88
45,8477942,Kevin Fiala,L,LAK,28,82,31,57,88
45,8484144,Connor Bedard,C,CHI,19,64,27,61,88
45,8480801,Brady Tkachuk,L,OTT,25,80,39,48,87
45,8471675,Sidney Crosby,C,PIT,37,75,38,49,87
45,8476460,Mark Scheifele,C,WPG,31,77,34,53,87
45,8480800,Quinn Hughes,D,VAN,25,77,11,76,87
45,8475172,Nazem Kadri,C,CGY,34,82,33,53,86
45,8480023,Robert Thomas,C,STL,25,73,24,62,86
45,8480002,Nico Hischier,C,NJD,25,74,30,55,85
45,8479323,Adam Fox,D,NYR,26,71,10,75,85
45,8478010,Brayden Point,C,TBL,28,81,35,49,84
45,8479407,Jesper Bratt,L,NJD,26,78,33,51,84
45,8474600,Roman Josi,D,NSH,34,75,19,65,84
45,8476459,Mika Zibanejad,C,NYR,31,77,36,47,83
45,8480865,Noah Dobson,D,NYI,24,80,12,71,83
45,8477404,Jake Guentzel,C,TBL,30,82,39,43,82
45,8482116,Tim Stützle,C,OTT,22,81,30,51,81
45,8476456,Jonathan Huberdeau,C,CGY,31,80,18,63,81
45,8479542,Brandon Hagel,L,TBL,26,82,35,45,80
45,8479343,Clayton Keller,R,UTA,26,74,25,55,80
45,8475692,Mats Zuccarello,R,MIN,37,73,21,59,80
45,8478449,Roope Hintz,C,DAL,28,82,35,44,79
45,8477402,Pavel Buchnevich,L,STL,29,72,29,50,79
45,8476389,Vincent Trocheck,C,NYR,31,80,22,56,78
45,8479337,Alex DeBrincat,R,DET,27,80,34,43,77
45,8477933,Sam Reinhart,C,FLA,29,74,31,46,77
45,8478427,Sebastian Aho,C,CAR,27,74,32,44,76
45,8477409,Carter Verhaeghe,C,FLA,29,80,33,42,75
45,8477951,Nick Schmaltz,C,UTA,28,76,31,44,75
45,8473419,Brad Marchand,L,BOS,36,82,27,48,75
45,8475168,Matt Duchene,C,DAL,33,82,27,48,75
45,8480069,Cale Makar,D,COL,26,71,23,52,75
45,8479385,Jordan Kyrou,C,STL,26,74,27,47,74
45,8476454,Ryan Nugent-Hopkins,C,EDM,31,74,25,49,74
45,8478444,Brock Boeser,R,VAN,27,76,38,35,73
45,8474141,Patrick Kane,R,DET,36,82,28,45,73
45,8475166,John Tavares,C,TOR,34,78,25,48,73
45,8476448,William Karlsson,C,VGK,31,78,24,49,73
45,8479420,Tage Thompson,C,BUF,27,72,45,27,72
45,8480830,Andrei Svechnikov,R,CAR,24,71,35,37,72
45,8480018,Nick Suzuki,C,MTL,25,77,28,44,72
45,8480208,Drake Batherson,R,OTT,26,81,26,46,72
45,8475167,Victor Hedman,D,TBL,34,75,14,57,71
45,8477500,Bo Horvat,C,NYI,29,81,39,31,70
45,8476539,Jonathan Marchessault,R,NSH,34,76,34,36,70
45,8480839,Rasmus Dahlin,D,BUF,24,72,17,53,70
45,8473994,Jamie Benn,L,DAL,35,81,25,44,69
45,8477960,Adrian Kempe,R,LAK,28,79,27,41,68
45,8477955,Jared McCann,L,SEA,28,77,34,33,67
45,8479675,Trevor Moore,L,LAK,29,81,29,38,67
45,8471685,Anze Kopitar,C,LAK,37,81,25,42,67
45,8477496,Elias Lindholm,C,BOS,30,79,22,45,67
45,8478407,Vince Dunn,D,SEA,28,73,12,55,67
45,8475745,Charlie Coyle,C,BOS,32,79,23,43,66
45,8473512,Claude Giroux,R,OTT,36,80,19,47,66
45,8477946,Dylan Larkin,C,DET,28,81,30,35,65
45,8481540,Cole Caufield,R,MTL,23,75,30,35,65
45,8476881,Tomas Hertl,C,VGK,31,78,27,38,65
45,8477447,Shea Theodore,D,VGK,29,65,12,53,65
45,8482740,Wyatt Johnston,C,DAL,21,81,27,37,64
45,8475158,Ryan O'Reilly,C,NSH,33,72,24,40,64
45,8475810,Bryan Rust,R,PIT,32,70,28,35,63
45,8479400,Pierre-Luc Dubois,L,WSH,26,77,27,36,63
45,8482078,Lucas Raymond,L,DET,22,80,25,38,63
45,8478414,Timo Meier,R,NJD,28,75,31,31,62
45,8478398,Kyle Connor,L,WPG,28,71,29,33,62
45,8482665,Matty Beniers,C,SEA,22,74,26,36,62
45,8483515,Juraj Slafkovsky,L,MTL,20,77,23,39,62
45,8476905,Chandler Stephenson,C,SEA,30,69,18,44,62
45,8471214,Alex Ovechkin,L,WSH,39,73,29,32,61
45,8476346,Johnny Gaudreau,L,CBJ,31,75,20,41,61
45,8477949,Alex Tuch,R,BUF,28,74,17,44,61
45,8475184,Chris Kreider,L,NYR,33,77,44,16,60
45,8477940,Nikolaj Ehlers,L,WPG,28,70,28,32,60
45,8476853,Morgan Rielly,D,TOR,30,74,6,54,60
45,8475754,Brock Nelson,C,NYI,33,76,28,31,59
45,8474679,Gustav Nyquist,C,NSH,35,72,20,39,59
45,8478401,Pavel Zacha,C,BOS,27,81,20,39,59
45,8478460,Zach Werenski,D,CBJ,27,77,18,41,59
45,8479425,Filip Hronek,D,VAN,27,74,15,44,59
45,8478047,Michael Bunting,L,PIT,29,68,28,30,58
45,8482124,Quinton Byfield,R,LAK,22,76,27,31,58
45,8482093,Seth Jarvis,C,CAR,22,67,24,34,58
45,8476875,Mike Matheson,D,MTL,30,77,16,42,58
45,8482684,Luke Hughes,D,NJD,21,73,9,49,58
45,8482109,Alexis Lafrenière,L,NYR,23,76,33,24,57
45,8475170,Brayden Schenn,C,STL,33,72,25,32,57
45,8480015,Owen Tippett,R,PHI,25,76,23,34,57
45,8473986,Alex Killorn,L,ANA,35,70,21,36,57
45,8477494,Jonathan Drouin,L,COL,29,78,21,36,57
45,8475786,Zach Hyman,L,EDM,32,77,38,18,56
45,8474586,Jordan Eberle,R,SEA,34,70,28,28,56
45,8480039,Martin Necas,C,CAR,25,71,24,32,56
45,8476826,Yanni Gourde,C,SEA,33,75,20,36,56
45,8480797,Joel Farabee,L,PHI,24,72,19,37,56
45,8476399,Blake Coleman,C,CGY,33,78,28,27,55
45,8475768,Jaden Schwartz,C,SEA,32,70,27,28,55
45,8477935,Sam Bennett,C,FLA,28,78,25,30,55
45,8477407,Anthony Duclair,L,NYI,29,78,25,30,55
45,8474150,Mikael Backlund,C,CGY,35,77,24,31,55
45,8474102,David Perron,L,OTT,36,80,23,32,55
45,8482113,Anton Lundell,C,FLA,23,79,22,33,55
45,8478493,Joel Eriksson Ek,C,MIN,27,64,27,27,54
45,8478975,Mason Marchment,L,DAL,29,80,24,30,54
45,8478542,Evan Rodrigues,C,FLA,31,78,22,32,54
45,8478438,Tommy Novak,C,NSH,27,67,18,36,54
45,8477504,Josh Morrissey,D,WPG,29,76,13,41,54
45,8475794,Tyler Seguin,C,DAL,32,82,30,23,53
45,8475726,Tyler Toffoli,C,SJS,32,70,30,23,53
45,8482110,Dawson Mercer,C,NJD,23,72,28,25,53
45,8481068,Yegor Sharangovich,C,CGY,26,73,28,25,53
45,8480028,Morgan Frost,C,PHI,25,78,17,36,53
45,8480036,Miro Heiskanen,D,DAL,25,80,11,42,53
45,8476432,Boone Jenner,C,CBJ,31,67,29,23,52
45,8478474,Lawson Crouse,L,UTA,27,76,27,25,52
45,8481528,Dylan Cozens,C,BUF,23,77,19,33,52
45,8478498,Jake DeBrusk,L,VAN,28,75,19,33,52
45,8478462,Nicolas Roy,C,VGK,27,79,18,34,52
45,8476479,Phillip Danault,C,LAK,31,81,17,35,52
45,8480803,Evan Bouchard,D,EDM,25,71,15,37,52
45,8476906,Shayne Gostisbehere,D,CAR,31,76,9,43,52
45,8475765,Vladimir Tarasenko,R,DET,33,81,28,23,51
45,8475149,Marcus Johansson,L,MIN,34,66,20,31,51
45,8477429,Andrew Copp,C,DET,30,82,15,36,51
45,8475798,Mikael Granlund,C,SJS,32,65,11,40,51
45,8482159,Tyson Foerster,R,PHI,22,76,27,23,50
45,8483431,Logan Cooley,C,UTA,20,77,26,24,50
45,8475784,Jeff Skinner,C,EDM,32,78,24,26,50
45,8482667,William Eklund,L,SJS,22,69,23,27,50
45,8471215,Evgeni Malkin,C,PIT,38,75,19,31,50
45,8484166,Adam Fantilli,C,CBJ,20,70,16,34,50
45,8478440,Dylan Strome,C,WSH,27,73,14,36,50
45,8479325,Charlie McAvoy,D,BOS,27,75,13,37,50
45,8479999,Casey Mittelstadt,C,COL,26,82,9,41,50
45,8477479,Tyler Bertuzzi,L,CHI,29,63,22,27,49
45,8484153,Leo Carlsson,C,ANA,20,74,17,32,49
45,8471724,Kris Letang,D,PIT,37,78,9,40,49
45,8478038,Devon Toews,D,COL,30,70,9,40,49
45,8481604,Pavel Dorofeyev,L,VGK,24,69,26,22,48
45,8477456,J.T. Compher,L,DET,29,80,22,26,48
45,8478873,Troy Terry,R,ANA,27,74,17,31,48
45,8482699,Dylan Guenther,R,UTA,21,74,16,32,48
45,8477986,Brandon Montour,D,SEA,30,68,14,34,48
45,8474578,Erik Karlsson,D,PIT,34,80,13,35,48
45,8476792,Torey Krug,D,STL,33,75,12,36,48
45,8477416,Oliver Bjorkstrand,R,SEA,29,73,20,27,47
45,8479987,Morgan Geekie,C,BOS,26,80,18,29,47
45,8477021,Alex Kerfoot,C,UTA,30,76,18,29,47
45,8479992,Michael Rasmussen,C,DET,25,80,16,31,47
45,8477495,Seth Jones,D,CHI,30,72,13,34,47
45,8477476,Artturi Lehkonen,L,COL,29,81,22,24,46
45,8477964,Ivan Barbashev,C,VGK,29,75,14,32,46
45,8481581,Thomas Harley,D,DAL,23,70,12,34,46
45,8474590,John Carlson,D,WSH,34,70,11,35,46
45,8477346,MacKenzie Weegar,D,CGY,30,76,10,36,46
45,8476419,Jean-Gabriel Pageau,C,NYI,32,77,23,22,45
45,8475314,Anders Lee,L,NYI,34,78,29,15,44
45,8476483,Rickard Rakell,R,PIT,31,75,21,23,44
45,8476880,Tom Wilson,R,WSH,30,68,21,23,44
45,8479525,Ross Colton,C,COL,28,80,19,25,44
45,8482475,Yegor Chinakhov,R,CBJ,23,62,19,25,44
45,8476882,Teuvo Teravainen,C,CHI,30,64,17,27,44
45,8481533,Trevor Zegras,C,ANA,23,73,17,27,44
45,8475714,Calle Jarnkrok,C,TOR,33,78,17,27,44
45,8481711,Matias Maccelli,L,UTA,24,75,13,31,44
45,8478397,Rasmus Andersson,D,CGY,28,74,13,31,44
45,8482720,Matthew Knies,L,TOR,22,79,13,31,44
45,8477503,Max Domi,C,TOR,29,78,12,32,44
45,8474565,Alex Pietrangelo,D,VGK,34,65,7,37,44
45,8476438,Brandon Saad,L,STL,32,71,25,18,43
45,8481535,Nils Hoglander,L,VAN,24,72,21,22,43
45,8477497,Sean Monahan,C,CBJ,30,64,12,31,43
45,8476872,Scott Laughton,C,PHI,30,75,11,32,43
45,8482101,Danil Gushchin,L,SJS,22,57,10,33,43
45,8482745,Mason McTavish,C,ANA,21,70,15,27,42
45,8482105,Jake Sanderson,D,OTT,22,77,14,28,42
45,8476462,Dougie Hamilton,D,NJD,31,69,8,34,42
45,8482146,Luke Evangelista,R,NSH,22,69,23,18,41
45,8478366,Frank Vatrano,R,ANA,30,68,20,21,41
45,8479339,Patrik Laine,L,CBJ,26,66,20,21,41
45,8480064,Josh Norris,C,OTT,25,75,19,22,41
45,8477451,Ryan Hartman,R,MIN,30,66,19,22,41
45,8482702,Logan Stankoven,C,DAL,21,81,18,23,41
45,8481582,Nicholas Robertson,L,TOR,23,60,18,23,41
45,8479345,Jakob Chychrun,D,WSH,26,69,17,24,41
45,8475848,Brendan Gallagher,R,MTL,32,70,17,24,41
45,8481618,Alex Newhook,C,MTL,23,73,16,25,41
45,8475791,Taylor Hall,L,CHI,33,58,13,28,41
45,8481596,Shane Pinto,C,OTT,24,73,11,30,41
45,8474563,Drew Doughty,D,LAK,35,73,11,30,41
45,8477932,Aaron Ekblad,D,FLA,28,69,5,36,41
45,8477426,Nicholas Paul,L,TBL,29,81,26,14,40
45,8483808,Andrei Kuzmenko,L,CGY,28,74,23,17,40
45,8478042,Viktor Arvidsson,L,EDM,31,73,13,27,40
45,8483490,Pavel Mintyukov,D,ANA,21,75,10,30,40
45,8475151,Kyle Palmieri,C,NYI,33,78,24,15,39
45,8482092,Ridly Greig,C,OTT,22,77,21,18,39
45,8475287,Erik Haula,L,NJD,33,68,19,20,39
45,8477998,Warren Foegele,L,LAK,28,79,19,20,39
45,8475231,Casey Cizikas,C,NYI,33,72,18,21,39
45,8474641,Adam Henrique,C,EDM,34,74,17,22,39
45,8477989,Christian Dvorak,C,MTL,28,66,17,22,39
45,8478519,Anthony Cirelli,C,TBL,27,78,16,23,39
45,8480829,Jesperi Kotkaniemi,C,CAR,24,69,16,23,39
45,8477505,Alexander Wennberg,C,SJS,30,63,16,23,39
45,8478233,Andrew Mangiapane,L,WSH,28,69,15,24,39
45,8478856,Conor Garland,R,VAN,28,73,12,27,39
45,8476923,Damon Severson,D,CBJ,30,81,12,27,39
45,8476958,Jaccob Slavin,D,CAR,30,74,8,31,39
45,8481560,Arthur Kaliyev,R,LAK,23,75,20,18,38
45,8480188,Fabian Zetterlund,L,SJS,25,62,20,18,38
45,8480009,Eeli Tolvanen,R,SEA,25,70,18,20,38
45,8478115,Pierre Engvall,L,NYI,28,77,18,20,38
45,8474149,Evgenii Dadonov,R,DAL,35,80,17,21,38
45,8482149,Cole Perfetti,C,WPG,22,64,16,22,38
45,8480459,Pius Suter,C,VAN,28,70,15,23,38
45,8475218,Mattias Ekholm,D,EDM,34,76,7,31,38
45,8470613,Brent Burns,D,CAR,39,73,5,33,38
45,8478057,Dakota Joshua,C,VAN,28,68,23,14,37
45,8478109,Victor Olofsson,L,VGK,29,71,22,15,37
45,8473422,Nick Foligno,L,CHI,37,56,19,18,37
45,8482705,Cole Sillinger,C,CBJ,21,64,18,19,37
45,8477511,Anthony Mantha,R,CGY,30,67,17,20,37
45,8482097,Jack Quinn,R,BUF,23,63,17,20,37
45,8479996,Cody Glass,C,NSH,25,59,15,22,37
45,8481186,Logan O'Connor,R,COL,28,77,13,24,37
45,8476458,Ryan Strome,C,ANA,31,71,13,24,37
45,8481524,Bowen Byram,D,BUF,23,63,12,25,37
45,8476463,Jonas Brodin,D,MIN,31,79,7,30,37
45,8478055,Gustav Forsling,D,FLA,28,71,6,31,37
45,8477948,Travis Sanheim,D,PHI,28,72,4,33,37
45,8482175,JJ Peterka,R,BUF,22,71,21,15,36
45,8475191,Reilly Smith,R,NYR,33,72,17,19,36
45,8478046,Danton Heinen,L,VAN,29,67,16,20,36
45,8474053,Logan Couture,C,SJS,35,60,9,27,36
45,8482122,Brock Faber,D,MIN,22,78,8,28,36
45,8479410,Mikhail Sergachev,D,UTA,26,69,7,29,36
45,8475753,Justin Faulk,D,STL,32,72,6,30,36
45,8482089,Jake Neighbours,L,STL,22,68,27,8,35
45,8476981,Josh Anderson,R,MTL,30,72,22,13,35
45,8480849,Barrett Hayton,C,UTA,24,72,19,16,35
45,8477839,Conor Sheary,L,TBL,32,81,17,18,35
45,8482749,Joshua Roy,R,MTL,21,66,13,22,35
45,8478458,John (Jack) Roslovic,C,CAR,27,66,10,25,35
45,8476869,Brady Skjei,D,NSH,30,75,9,26,35
45,8477444,Andre Burakovsky,L,SEA,29,69,9,26,35
45,8481542,Moritz Seider,D,DET,23,77,3,32,35
45,8475169,Evander Kane,L,EDM,33,76,18,16,34
45,8481554,Kaapo Kakko,R,NYR,23,70,17,17,34
45,8480798,Philipp Kurashev,C,CHI,25,64,14,20,34
45,8484145,Zach Benson,L,BUF,19,71,14,20,34
45,8480220,Noah Cates,L,PHI,25,70,14,20,34
45,8476994,Vinnie Hinostroza,C,NSH,30,55,12,22,34
45,8478469,Thomas Chabot,D,OTT,27,70,11,23,34
45,8482133,Thomas Bordeleau,C,SJS,22,61,9,25,34
45,8480014,Gabriel Vilardi,C,WPG,25,62,25,8,33
45,8474715,Cameron Atkinson,R,TBL,35,82,14,19,33
45,8480835,Jack Drury,C,CAR,24,63,13,20,33
45,8483505,Matthew Poitras,C,BOS,20,72,12,21,33
45,8480748,Kiefer Sherwood,L,VAN,29,63,11,22,33
45,8476917,Adam Pelech,D,NYI,30,77,6,27,33
45,8480043,Timothy Liljegren,D,TOR,25,67,4,29,33
45,8480145,Neal Pionk,D,WPG,29,70,3,30,33
45,8478020,Michael Amadio,R,OTT,28,77,18,14,32
45,8479365,Trent Frederic,C,BOS,26,74,16,16,32
45,8479591,Michael Eyssimont,C,TBL,28,79,13,19,32
45,8480113,Alex Iafallo,L,WPG,31,67,12,20,32
45,8475793,Ryan Johansen,C,PHI,32,75,12,20,32
45,8476480,Vladislav Namestnikov,C,WPG,32,62,10,22,32
45,8481577,Philip Tomasino,C,NSH,23,68,7,25,32
45,8476331,Dylan DeMelo,D,WPG,31,74,3,29,32
45,8480144,David Kampf,C,TOR,29,73,16,15,31
45,8477987,Ryan Donato,C,CHI,28,65,15,16,31
45,8476474,Stefan Noesen,R,NJD,31,69,14,17,31
45,8478891,Mason Appleton,C,WPG,28,67,12,19,31
45,8476292,Ondrej Palat,L,NJD,33,71,12,19,31
45,8480802,Ryan McLeod,C,BUF,25,67,12,19,31
45,8481656,Aliaksei Protas,C,WSH,23,66,11,20,31
45,8477498,Darnell Nurse,D,EDM,29,75,10,21,31
45,8480871,Adam Boqvist,D,FLA,24,67,8,23,31
45,8479351,Sam Steel,C,DAL,26,79,6,25,31
45,8477506,Ryan Pulock,D,NYI,30,75,5,26,31
45,8477969,Marcus Pettersson,D,PIT,28,81,5,26,31
45,8476854,Hampus Lindholm,D,BOS,30,74,4,27,31
45,8475760,Nick Bjugstad,C,UTA,32,75,16,14,30
45,8476461,Sean Couturier,C,PHI,32,69,15,15,30
45,8479393,Noah Gregor,L,OTT,26,75,15,15,30
45,8482660,Kent Johnson,C,CBJ,22,61,14,16,30
45,8482679,Matt Coronato,R,CGY,22,71,14,16,30
45,8477953,Kasperi Kapanen,R,STL,28,63,12,18,30
45,8480078,Filip Chytil,C,NYR,25,64,11,19,30
45,8482117,Lukas Reichel,L,CHI,22,65,10,20,30
45,8475722,Jason Zucker,L,BUF,32,68,9,21,30
45,8474716,Jared Spurgeon,D,MIN,35,75,8,22,30
45,8478911,Matt Roy,D,WSH,29,69,7,23,30
45,8482712,Oskar Olausson,R,COL,22,76,3,27,30
45,8478882,Vladislav Gavrikov,D,LAK,29,71,2,28,30
45,8476278,Colin Blackwell,C,DAL,31,74,16,13,29
45,8482079,Marco Rossi,C,MIN,23,56,15,14,29
45,8476925,Colton Sissons,C,NSH,31,68,15,14,29
45,8474189,Lars Eller,C,PIT,35,68,14,15,29
45,8476927,Teddy Blueger,C,VAN,30,67,14,15,29
45,8480185,Eetu Luostarinen,C,FLA,26,74,13,16,29
45,8481523,Kirby Dach,C,MTL,23,65,12,17,29
45,8480855,Jack McBain,C,UTA,24,69,12,17,29
45,8481624,Ilya Mikheyev,R,CHI,30,61,12,17,29
45,8475193,Tomas Tatar,L,NJD,34,65,11,18,29
45,8478472,Mathieu Joseph,R,STL,27,66,10,19,29
45,8476885,Jacob Trouba,D,NYR,30,66,9,20,29
45,8475763,Kevin Hayes,R,PIT,32,68,9,20,29
45,8476921,Jordan Martinook,L,CAR,32,68,9,20,29
45,8481606,Jordan Spence,D,LAK,23,64,6,23,29
45,8482087,Kaiden Guhle,D,MTL,22,75,5,24,29
45,8475324,Nick Jensen,D,OTT,34,73,4,25,29
45,8480434,Sean Durzi,D,UTA,26,67,3,26,29
45,8475799,Nino Niederreiter,R,WPG,32,70,12,16,28
45,8471698,T.J. Oshie,R,WSH,38,64,12,16,28
45,8483457,Lane Hutson,D,MTL,20,63,8,20,28
45,8481703,Valtteri Puustinen,R,PIT,25,61,6,22,28
45,8474151,Ryan McDonagh,D,TBL,35,77,5,23,28
45,8478136,Jake Middleton,D,MIN,28,71,5,23,28
45,8482055,Drew O'Connor,L,PIT,26,63,17,10,27
45,8476918,Jimmy Vesey,L,NYR,31,70,16,11,27
45,8476469,Joel Armia,R,MTL,31,70,15,12,27
45,8479661,Tanner Jeannot,L,LAK,27,80,14,13,27
45,8480068,Ryan Poehling,C,PHI,25,69,12,15,27
45,8483445,Cutter Gauthier,L,ANA,20,58,12,15,27
45,8483524,Shane Wright,C,SEA,20,63,11,16,27
45,8480789,Oliver Wahlstrom,R,NYI,24,72,9,18,27
45,8475171,Oliver Ekman-Larsson,D,TOR,33,68,7,20,27
45,8476979,Erik Gustafsson,D,DET,32,77,5,22,27
45,8478500,Ivan Provorov,D,CBJ,27,81,3,24,27
45,8480893,Kirill Marchenko,R,CBJ,24,66,17,9,26
45,8478466,Daniel Sprong,R,VAN,27,68,13,13,26
45,8478508,Yakov Trenin,C,MIN,27,62,12,14,26
45,8481580,Connor McMichael,C,WSH,23,68,10,16,26
45,8481481,Blake Lizotte,C,PIT,27,60,10,16,26
45,8480336,Sean Walker,D,CAR,30,73,5,21,26
45,8475764,Cam Fowler,D,ANA,33,76,4,22,26
45,8476902,Esa Lindell,D,DAL,30,76,4,22,26
45,8479976,Juuso Valimaki,D,UTA,26,63,3,23,26
45,8484203,Bradly Nadeau,L,CAR,19,56,12,13,25
45,8476960,Andreas Athanasiou,C,CHI,30,60,11,14,25
45,8482111,Justin Barron,D,MTL,23,70,9,16,25
45,8475220,Marcus Foligno,L,MIN,33,62,9,16,25
45,8476879,Cody Ceci,D,EDM,31,71,4,21,25
45,8483482,Tristan Luneau,D,ANA,20,67,15,9,24
45,8482074,Connor Zary,C,CGY,23,62,13,11,24
45,8479293,Brandon Tanev,L,SEA,33,61,13,11,24
45,8483499,Liam Ohgren,L,MIN,20,60,12,12,24
45,8481032,Paul Cotter,C,NJD,25,57,9,15,24
45,8478396,Noah Hanifin,D,VGK,27,59,4,20,24
45,8480817,K'Andre Miller,D,NYR,24,74,4,20,24
45,8476889,Radek Faksa,C,STL,30,57,14,9,23
45,8482125,Alexander Holtz,R,VGK,22,73,11,12,23
45,8479390,Taylor Raddysh,R,WSH,26,66,11,12,23
45,8478970,Jalen Chatfield,D,CAR,28,72,11,12,23
45,8476392,Adam Lowry,C,WPG,31,64,10,13,23
45,8477919,Frederick Gaudreau,C,MIN,31,59,10,13,23
45,8480813,Joe Veleno,C,DET,24,77,10,13,23
45,8473533,Jordan Staal,C,CAR,36,59,9,14,23
45,8476312,Josh Manson,D,COL,33,64,9,14,23
45,8481522,Peyton Krebs,C,BUF,23,50,9,14,23
45,8478013,Jake Walman,D,SJS,28,74,9,14,23
45,8478133,Jake Evans,C,MTL,28,67,8,15,23
45,8482671,Owen Power,D,BUF,22,69,7,16,23
45,8478413,Jordan Greenway,L,BUF,27,66,6,17,23
45,8478851,Alexandre Carrier,D,NSH,28,70,5,18,23
45,8476892,Colton Parayko,D,STL,31,67,3,20,23
45,8476931,Jake McCabe,D,TOR,31,63,3,20,23
45,8482067,Connor Mackey,D,NYR,28,58,2,21,23
45,8480289,Morgan Barron,C,WPG,26,58,14,8,22
45,8480011,Klim Kostin,C,SJS,25,59,12,10,22
45,8479316,Luke Kunin,C,SJS,27,52,11,11,22
45,8481553,Bobby Brink,R,PHI,23,50,9,13,22
45,8473563,Nicklas Backstrom,C,WSH,37,52,7,15,22
45,8480448,Parker Kelly,L,COL,25,77,7,15,22
45,8477015,Connor Brown,R,EDM,30,63,7,15,22
45,8477488,Brett Pesce,D,NJD,30,67,4,18,22
45,8481546,Cam York,D,PHI,23,69,3,19,22
45,8482245,Artem Zub,D,OTT,29,72,3,19,22
45,8477425,Miles Wood,L,COL,29,78,13,8,21
45,8479368,Max Jones,L,BOS,26,73,12,9,21
45,8480980,Connor Dewar,C,TOR,25,66,10,11,21
45,8477947,Sonny Milano,L,WSH,28,62,9,12,21
45,8481704,Juuso Parssinen,C,NSH,23,52,9,12,21
45,8481517,Brett Leason,R,ANA,25,63,9,12,21
45,8477380,Jonny Brodzinski,C,NYR,31,54,9,12,21
45,8479353,Brett Howden,C,VGK,26,70,8,13,21
45,8475200,Dmitry Orlov,D,CAR,33,79,8,13,21
45,8481601,Simon Holmstrom,R,NYI,23,68,8,13,21
45,8480205,Emil Bemstrom,C,PIT,25,58,8,13,21
45,8482809,Jackson Blake,R,CAR,21,50,6,15,21
45,8483468,Jiri Kulich,C,BUF,20,55,5,16,21
45,8479983,Mario Ferraro,D,SJS,26,71,5,16,21
45,8480807,Mattias Samuelsson,D,BUF,24,53,5,16,21
45,8477499,Rasmus Ristolainen,D,PHI,30,67,5,16,21
45,8475343,Nic Dowd,C,WSH,34,59,5,16,21
45,8480873,Rasmus Sandin,D,WSH,24,69,4,17,21
45,8480073,Erik Brannstrom,D,COL,25,61,4,17,21
45,8482176,Wyatt Kaiser,D,CHI,22,48,3,18,21
45,8478840,Will Borgen,D,SEA,28,63,2,19,21
45,8478043,Sam Lafferty,C,BUF,29,64,11,9,20
45,8484149,Gavin Brindley,C,CBJ,20,53,8,12,20
45,8477508,Curtis Lazar,C,NJD,29,62,8,12,20
45,8477952,Robby Fabbri,C,ANA,28,66,7,13,20
45,8475855,Jesper Fast,R,CAR,33,65,7,13,20
45,8483493,Frank Nazar,C,CHI,20,51,6,14,20
45,8483565,Nick Blankenburg,D,NSH,26,62,6,14,20
45,8481093,Rafael Harvey-Pinard,L,MTL,25,56,5,15,20
45,8481019,David Gustafsson,C,WPG,24,55,5,15,20
45,8477392,Hudson Fasching,R,NYI,29,61,5,15,20
45,8479371,Dante Fabbro,D,NSH,26,61,3,17,20
45,8479402,Jake Bean,D,CGY,26,65,3,17,20
45,8476429,Scott Mayfield,D,NYI,32,75,2,18,20
45,8481014,Alexander Romanov,D,NYI,24,75,2,18,20
45,8475188,Brayden McNabb,D,VGK,33,54,1,19,20
45,8480762,Eric Robinson,L,CAR,29,57,11,8,19
45,8482062,Cole Smith,L,NSH,29,60,10,9,19
45,8482803,Olen Zellweger,D,ANA,21,64,9,10,19
45,8477353,Tyler Motte,C,DET,29,73,8,11,19
45,8482624,Daniil Miromanov,D,CGY,27,64,7,12,19
45,8478463,Anthony Beauvillier,L,PIT,27,68,7,12,19
45,8476988,Matt Benning,D,SJS,30,68,6,13,19
45,8476422,Mike Reilly,D,NYI,31,72,6,13,19
45,8476329,Travis Boyd,C,MIN,31,54,5,14,19
45,8479026,Philippe Myers,D,TOR,27,55,5,14,19
45,8476457,Adam Larsson,D,SEA,32,74,5,14,19
45,8477220,Nate Schmidt,D,FLA,33,66,4,15,19
45,8482142,Jamie Drysdale,D,PHI,22,64,4,15,19
45,8482073,Braden Schneider,D,NYR,23,72,4,15,19
45,8480891,Michael Kesselring,D,UTA,24,60,3,16,19
45,8482655,Janis Moser,D,TBL,24,72,0,19,19
45,8470621,Corey Perry,R,EDM,39,63,12,6,18
45,8480806,Isac Lundestrom,C,ANA,25,63,10,8,18
45,8480995,Pontus Holmberg,R,TOR,25,65,9,9,18
45,8483491,Ivan Miroshnichenko,L,WSH,20,52,7,11,18
45,8476624,Barclay Goodrow,C,SJS,31,48,7,11,18
45,8482192,Isaak Phillips,D,CHI,23,49,5,13,18
45,8475790,Erik Gudbranson,D,CBJ,32,76,4,14,18
45,8481521,Ronnie Attard,D,PHI,25,63,4,14,18
45,8480035,Henri Jokiharju,D,BUF,25,61,3,15,18
45,8474574,Tyler Myers,D,VAN,34,61,3,15,18
45,8475279,Ben Chiarot,D,DET,33,64,3,15,18
45,8478507,John Marino,D,UTA,27,67,2,16,18
45,8480878,Nils Lundkvist,D,DAL,24,67,2,16,18
45,8475462,Radko Gudas,D,ANA,34,57,2,16,18
45,8479324,Ryan Lindgren,D,NYR,26,63,1,17,18
45,8482155,Alex Laferriere,R,LAK,23,65,13,4,17
45,8477446,Michael McCarron,R,NSH,29,55,11,6,17
45,8476822,Luke Glendening,C,TBL,35,79,9,8,17
45,8476873,Mark Jankowski,C,NSH,30,50,9,8,17
45,8478569,Noel Acciari,C,PIT,33,53,8,9,17
45,8479439,Jacob MacDonald,D,COL,31,59,8,9,17
45,8481617,Vasily Podkolzin,R,VAN,23,42,8,9,17
45,8482737,Zack Bolduc,C,STL,21,56,7,10,17
45,8480074,Alexandre Texier,C,STL,25,62,7,10,17
45,8481716,Dmitri Voronkov,L,CBJ,24,52,7,10,17
45,8476525,Colin Miller,D,WPG,32,60,6,11,17
45,8478211,Dryden Hunt,L,CGY,29,57,6,11,17
45,8483495,Simon Nemec,D,NJD,20,61,6,11,17
45,8481178,Egor Zamula,D,PHI,24,52,6,11,17
45,8477507,Nikita Zadorov,D,BOS,29,65,4,13,17
45,8476967,Brett Kulak,D,EDM,30,63,3,14,17
45,8475233,David Savard,D,MTL,34,64,2,15,17
45,8476467,Jamie Oleksiak,D,SEA,32,67,1,16,17
45,8480860,Kevin Bahl,D,CGY,24,55,1,16,17
45,8481028,Martin Pospisil,C,CGY,25,54,10,6,16
45,8481477,Nico Sturm,C,SJS,29,57,9,7,16
45,8477450,Jason Dickinson,C,CHI,29,52,9,7,16
45,8477478,William Carrier,L,CAR,30,56,8,8,16
45,8474034,Patrick Maroon,L,CHI,36,60,8,8,16
45,8482157,Will Cuylle,L,NYR,22,60,7,9,16
45,8475225,Craig Smith,C,CHI,35,52,7,9,16
45,8475179,Dmitry Kulikov,D,FLA,34,58,7,9,16
45,8475842,Sam Carrick,C,NYR,32,58,7,9,16
45,8480003,Jesper Boqvist,C,FLA,26,67,6,10,16
45,8479639,Dylan Coghlan,D,WPG,26,67,5,11,16
45,8479718,Alex Barré-Boulet,C,MTL,27,45,5,11,16
45,8478434,Keegan Kolesar,R,VGK,27,60,5,11,16
45,8476891,Matthew Grzelcyk,D,PIT,30,77,4,12,16
45,8477435,Ryan Graves,D,PIT,29,73,2,14,16
45,8479998,Mikey Anderson,D,LAK,25,64,2,14,16
45,8475455,Brenden Dillon,D,NJD,34,61,1,15,16
45,8474568,Luke Schenn,D,NSH,35,45,1,15,16
45,8477845,Trevor van Riemsdyk,D,WSH,33,53,0,16,16
45,8476858,Phillip Di Giuseppe,L,VAN,31,39,11,4,15
45,8482259,Bobby McMann,C,TOR,28,59,10,5,15
45,8479941,Justin Danforth,R,CBJ,31,50,9,6,15
45,8476897,Oskar Sundqvist,C,STL,30,58,8,7,15
45,8477573,Nathan Walker,L,STL,30,61,7,8,15
45,8479344,Jesse Puljujarvi,R,PIT,26,50,7,8,15
45,8478432,Christian Fischer,R,DET,27,74,5,10,15
45,8481537,Nikita Okhotiuk,D,CGY,24,54,4,11,15
45,8474567,Zach Bogosian,D,MIN,34,62,4,11,15
45,8473507,Jeff Petry,D,DET,37,70,2,13,15
45,8478416,Erik Cernak,D,TBL,27,76,2,13,15
45,8480001,Urho Vaakanainen,D,ANA,25,63,2,13,15
45,8474673,TJ Brodie,D,CHI,34,62,1,14,15
45,8475181,Nick Leddy,D,STL,33,67,1,14,15
45,8475690,Chris Tanev,D,TOR,35,53,1,14,15
45,8479619,Michael Carcone,L,UTA,28,60,10,4,14
45,8481641,Joel Kiviranta,L,COL,28,67,9,5,14
45,8480025,MacKenzie Entwistle,R,FLA,25,62,9,5,14
45,8477903,Garnet Hathaway,R,PHI,33,64,7,7,14
45,8479359,Beck Malenstyn,L,BUF,26,45,5,9,14
45,8481751,Lukas Rousek,R,BUF,25,42,5,9,14
45,8479066,Ryan Lomberg,L,CGY,30,61,5,9,14
45,8480845,Rasmus Kupari,C,WPG,24,46,5,9,14
45,8477962,Brendan Lemieux,L,CAR,28,48,5,9,14
45,8482166,Shakir Mukhamadullin,D,SJS,22,60,5,9,14
45,8480848,Ty Dellandrea,C,SJS,24,52,4,10,14
45,8474166,Alec Martinez,D,CHI,37,51,4,10,14
45,8479398,Samuel Girard,D,COL,26,59,2,12,14
45,8479249,Andrew Poturalski,C,SJS,30,37,2,12,14
45,8483460,David Jiricek,D,CBJ,21,54,2,12,14
45,8480049,Dylan Samberg,D,WPG,25,65,1,13,14
45,8479982,Conor Timmins,D,TOR,26,51,1,13,14
45,8476878,Zemgus Girgensons,C,TBL,30,79,7,6,13
45,8482077,Dylan Holloway,L,EDM,23,53,7,6,13
45,8479414,Nathan Bastian,R,NJD,27,58,6,7,13
45,8483466,Kevin Korchinski,D,CHI,20,49,6,7,13
45,8476442,Matt Nieto,L,PIT,32,47,6,7,13
45,8479980,Nicolas Hague,D,VGK,26,54,5,8,13
45,8478178,Darren Raddysh,D,TBL,28,64,5,8,13
45,8479543,Michael Pezzetta,L,MTL,26,55,5,8,13
45,8479671,Mathieu Olivier,R,CBJ,27,50,5,8,13
45,8481161,Jake Christiansen,D,CBJ,25,62,5,8,13
45,8479369,Andrew Peeke,D,BOS,26,62,4,9,13
45,8481527,Kaedan Korczak,D,VGK,23,53,4,9,13
45,8479315,Joey Anderson,R,CHI,26,43,3,10,13
45,8481568,Alex Vlasic,D,CHI,23,54,3,10,13
45,8476856,Mathew Dumba,D,DAL,30,74,3,10,13
45,8477931,Tomas Nosek,L,FLA,32,63,3,10,13
45,8478859,Niko Mikkola,D,FLA,28,62,3,10,13
45,8471709,Marc-Edouard Vlasic,D,SJS,37,60,3,10,13
45,8481592,Jakob Pelletier,L,CGY,23,43,3,10,13
45,8477369,Carson Soucy,D,VAN,30,59,2,11,13
45,8474090,Brendan Smith,D,DAL,35,58,2,11,13
45,8471677,Jack Johnson,D,CBJ,37,61,2,11,13
45,8478146,Matthew Highmore,C,OTT,28,42,2,11,13
45,8481147,Reese Johnson,C,MIN,26,40,8,4,12
45,8479336,Carl Grundstrom,R,SJS,27,48,6,6,12
45,8478421,A.J. Greer,L,FLA,28,58,6,6,12
45,8480727,Zach Whitecloud,D,VGK,28,45,6,6,12
45,8480796,Martin Fehervary,D,WSH,25,53,5,7,12
45,8482634,Alex Steeves,C,TOR,25,47,5,7,12
45,8478443,Brandon Carlo,D,BOS,28,54,4,8,12
45,8481599,Victor Soderstrom,D,UTA,23,46,4,8,12
45,8477070,Liam O'Brien,C,UTA,30,48,4,8,12
45,8476441,Joel Edmundson,D,LAK,31,43,4,8,12
45,8480222,Sebastian Aho,D,PIT,28,75,3,9,12
45,8480058,Pierre-Olivier Joseph,D,STL,25,60,3,9,12
45,8481708,Zac Jones,D,NYR,24,50,3,9,12
45,8478452,Caleb Jones,D,LAK,27,54,2,10,12
45,8479576,Vincent Desharnais,D,VAN,28,31,2,10,12
45,8476473,Connor Murphy,D,CHI,31,41,2,10,12
45,8481059,Scott Perunovich,D,STL,26,62,1,11,12
45,8480070,Ian Mitchell,D,BOS,25,52,1,11,12
45,8482451,Mikael Pyyhtia,L,CBJ,23,38,1,11,12
45,8478450,Parker Wotherspoon,D,BOS,27,38,0,12,12
45,8480281,Alexey Toropchenko,R,STL,25,65,10,1,11
45,8482762,Simon Edvinsson,D,DET,21,58,8,3,11
45,8480021,Jack Studnicka,C,LAK,25,60,7,4,11
45,8478585,Derek Ryan,C,EDM,38,66,6,5,11
45,8481013,Jonatan Berggren,R,DET,24,53,6,5,11
45,8482148,Hendrix Lapierre,C,WSH,22,54,6,5,11
45,8480870,Bo Groulx,C,NYR,24,30,5,6,11
45,8477979,Nicolas Aube-Kubel,R,BUF,28,57,4,7,11
45,8473446,Erik Johnson,D,PHI,36,42,4,7,11
45,8470600,Ryan Suter,D,STL,39,59,3,8,11
45,8477938,Haydn Fleury,D,WPG,28,43,3,8,11
45,8475718,Justin Holl,D,DET,32,57,3,8,11
45,8481237,Kyle MacLean,C,NYI,25,30,3,8,11
45,8479372,Joshua Mahura,D,SEA,26,55,2,9,11
45,8474013,Ian Cole,D,UTA,35,47,2,9,11
45,8481441,Joe Snively,C,DET,28,61,2,9,11
45,8475750,Jon Merrill,D,MIN,32,57,1,10,11
45,8484254,Akito Hirose,D,VAN,25,45,0,11,11
45,8478451,Ethan Bear,D,WSH,27,46,0,11,11
45,8479520,Brandon Duhaime,R,WSH,27,57,7,3,10
45,8478424,Jansen Harkins,C,ANA,27,45,7,3,10
45,8480252,Cole Guttman,C,CHI,25,36,6,4,10
45,8478831,Kevin Stenlund,C,UTA,28,53,6,4,10
45,8481754,Nikita Nesterenko,C,ANA,23,30,6,4,10
45,8478409,Anthony Richard,C,PHI,28,32,6,4,10
45,8481518,Nolan Foote,L,NJD,24,39,6,4,10
45,8477482,Zachary Sanford,L,CHI,30,30,5,5,10
45,8477887,Patrick Brown,C,BOS,32,47,5,5,10
45,8482859,Zack Ostapchuk,C,OTT,21,51,4,6,10
45,8482666,Scott Morrow,D,CAR,22,45,4,6,10
45,8476867,Brendan Gaunce,C,MIN,30,32,4,6,10
45,8479968,Vinni Lettieri,C,BOS,29,51,4,6,10
45,8482652,Walker Duehr,R,CGY,27,42,4,6,10
45,8479328,Julien Gauthier,R,NYI,27,56,3,7,10
45,8477365,Connor Clifton,D,BUF,29,55,3,7,10
45,8475177,Calvin de Haan,D,COL,33,43,3,7,10
45,8482141,Lukas Cormier,D,VGK,22,22,3,7,10
45,8482807,Ethan Del Mastro,D,CHI,21,50,2,8,10
45,8481567,Henry Thrun,D,SJS,23,46,2,8,10
45,8482747,Brennan Othmann,L,NYR,21,41,2,8,10
45,8481550,Adam Beckman,L,NJD,23,44,2,8,10
45,8477851,Jordan Oesterle,D,BOS,32,39,2,8,10
45,8480246,Nick Perbix,D,TBL,26,71,1,9,10
45,8482095,Tyler Kleven,D,OTT,22,43,1,9,10
45,8478399,Jonas Siegenthaler,D,NJD,27,56,1,9,10
45,8475208,Brian Dumoulin,D,ANA,33,58,1,9,10
45,8471817,Ryan Reaves,R,TOR,37,56,5,4,9
45,8479944,Zach Aston-Reese,C,VGK,30,52,5,4,9
45,8476374,Sean Kuraly,C,CBJ,31,59,5,4,9
45,8473453,Trevor Lewis,C,LAK,37,73,4,5,9
45,8480192,Johnathan Kovacevic,D,NJD,27,50,4,5,9
45,8480441,Trey Fix-Wolansky,R,CBJ,25,37,4,5,9
45,8480355,Mark Kastelic,C,BOS,25,46,3,6,9
45,8481701,Santeri Hatakka,D,NJD,23,36,3,6,9
45,8482070,Mitchell Chaffee,R,TBL,26,47,3,6,9
45,8482730,Brandt Clarke,D,LAK,21,47,2,7,9
45,8479378,Logan Stanley,D,WPG,26,37,2,7,9
45,8483619,Filip Roos,D,OTT,25,31,2,7,9
45,8480172,Jan Rutta,D,SJS,34,65,1,8,9
45,8481167,Brayden Pachal,D,CGY,25,35,1,8,9
45,8481122,Simon Benoit,D,TOR,26,49,1,8,9
45,8481056,Spencer Stastney,D,NSH,24,29,0,9,9
45,8479638,Justin Brazeau,R,BOS,26,33,6,2,8
45,8479370,Tyson Jost,C,CAR,26,44,5,3,8
45,8481598,Philip Broberg,D,EDM,23,43,5,3,8
45,8482145,Mavrik Bourque,C,DAL,22,57,5,3,8
45,8484911,Collin Graf,R,SJS,22,35,5,3,8
45,8479981,Jonah Gadjovich,L,FLA,26,33,4,4,8
45,8477018,Ben Hutton,D,VGK,31,44,4,4,8
45,8483763,Maksymilian Szuber,D,UTA,22,34,4,4,8
45,8481543,Nikita Alexandrov,C,STL,24,28,4,4,8
45,8479536,Axel Jonsson-Fjallby,L,WPG,26,36,3,5,8
45,8479972,Mason Shaw,C,WPG,26,29,3,5,8
45,8483570,Ben Meyers,C,SEA,26,30,3,5,8
45,8474612,Travis Hamonic,D,OTT,34,50,2,6,8
45,8477335,Kyle Burroughs,D,LAK,29,46,2,6,8
45,8480950,Ilya Lyubushkin,D,DAL,30,60,1,7,8
45,8479442,Troy Stecher,D,EDM,30,52,1,7,8
45,8475762,Derek Forbort,D,VAN,32,53,1,7,8
45,8480887,Jordan Harris,D,MTL,24,45,0,8,8
45,8475235,Nicolas Deslauriers,L,PHI,33,44,5,2,7
45,8476913,Devin Shore,C,MIN,30,35,4,3,7
45,8477406,Mattias Janmark,C,EDM,32,66,3,4,7
45,8480879,Jacob Bernard-Docker,D,OTT,24,47,3,4,7
45,8476934,Brock McGinn,L,ANA,30,44,3,4,7
45,8483012,Logan Morrison,C,SEA,22,41,3,4,7
45,8482177,Marat Khusnutdinov,C,MIN,22,37,3,4,7
45,8481600,Tobias Bjornfot,D,FLA,23,45,2,5,7
45,8479772,Zack MacEwen,R,OTT,28,48,2,5,7
45,8477462,Robert Hagg,D,VGK,29,31,2,5,7
45,8477527,Ross Johnston,L,ANA,30,37,2,5,7
45,8479348,Kale Clague,D,BUF,26,40,1,6,7
45,8476372,Nick Seeler,D,PHI,31,42,1,6,7
45,8480196,Jacob Bryson,D,BUF,27,47,1,6,7
45,8476874,Olli Maatta,D,DET,30,58,0,7,7
45,8482659,Josh Doan,R,UTA,22,48,5,1,6
45,8481679,Maxence Guenette,D,OTT,23,26,5,1,6
45,8481556,John Beecher,C,BOS,23,35,4,2,6
45,8479994,Jaret Anderson-Dolan,C,WPG,25,43,4,2,6
45,8479291,Kevin Rooney,C,CGY,31,53,3,3,6
45,8479379,Givani Smith,R,SJS,26,36,3,3,6
45,8478021,William Lagesson,D,DET,28,31,3,3,6
45,8482861,Vincent Iorio,D,WSH,22,34,2,4,6
45,8478468,Jeremy Lauzon,D,NSH,27,56,1,5,6
45,8482784,Zach Dean,C,STL,21,38,1,5,6
45,8477384,Joshua Brown,D,EDM,30,40,0,6,6
45,8480834,Ty Emberson,D,SJS,24,28,0,6,6
45,8478874,Adam Gaudette,R,OTT,28,35,0,6,6
45,8477034,Jaycob Megna,D,FLA,32,50,0,6,6
45,8482751,Ryan Winterton,C,SEA,21,38,4,1,5
45,8482744,James Malatesta,L,CBJ,21,45,2,3,5
45,8483549,Lucas Condotta,L,MTL,27,31,2,3,5
45,8482733,Logan Mailloux,D,MTL,31,39,2,3,5
45,8482153,Brendan Brisson,C,VGK,23,27,2,3,5
45,8482713,Mackie Samoskevich,R,FLA,22,35,2,3,5
45,8482511,Mason Lohrei,D,BOS,23,33,2,3,5
45,8481699,Aku Raty,R,UTA,23,21,2,3,5
45,8477473,Justin Bailey,R,SJS,29,18,2,3,5
45,8481719,Maxwell Crozier,D,TBL,24,19,2,3,5
45,8480157,Calle Rosen,D,COL,30,46,1,4,5
45,8483630,Pavol Regenda,L,ANA,25,27,1,4,5
45,8480007,Jonas Rondbjerg,R,VGK,25,34,1,4,5
45,8481593,Jayden Struble,D,MTL,23,17,1,4,5
45,8481532,Alex Turcotte,C,LAK,23,41,0,5,5
45,8480880,Jakub Lauko,C,MIN,24,37,3,1,4
45,8481605,Jackson LaCombe,D,ANA,23,32,3,1,4
45,8482144,Jack Thompson,D,SJS,22,20,3,1,4
45,8484287,Cole McWard,D,VAN,23,21,3,1,4
45,8476952,Dominic Toninato,C,WPG,30,30,2,2,4
45,8480844,Grigori Denisenko,L,VGK,24,28,2,2,4
45,8479320,Maxime Lajoie,D,SEA,27,30,2,2,4
45,8478454,Noah Juulsen,D,VAN,27,31,2,2,4
45,8478017,Mark Friedman,D,VAN,29,40,2,2,4
45,8480292,Carson Meyer,R,ANA,27,35,2,2,4
45,8482765,Isak Rosen,R,BUF,21,28,1,3,4
45,8480990,Declan Chisholm,D,MIN,24,44,1,3,4
45,8481609,Vladislav Kolyachonok,D,UTA,23,38,1,3,4
45,8479986,Kole Lind,R,DAL,26,45,1,3,4
45,8481806,Louis Crevier,D,CHI,23,16,1,3,4
45,8482088,Justin Sourdif,R,FLA,22,23,1,3,4
45,8477244,Chad Ruhwedel,D,NYR,34,27,1,3,4
45,8482964,Arber Xhekaj,D,MTL,23,42,0,4,4
45,8477810,Joel Hanley,D,CGY,33,21,0,4,4
45,8479991,Jake Leschyshyn,C,NYR,25,20,0,4,4
45,8481789,Tye Kartye,L,SEA,23,33,2,1,3
45,8477401,John Hayden,C,SEA,29,30,2,1,3
45,8479985,Cale Fleury,D,SEA,26,28,2,1,3
45,8475958,Michael Sgarbossa,C,WSH,32,20,2,1,3
45,8482201,Gage Goncalves,C,TBL,23,29,2,1,3
45,8478477,Mitchell Stephens,C,SEA,27,19,2,1,3
45,8481743,Marc Del Gaizo,D,NSH,25,19,2,1,3
45,8482250,Callahan Burke,C,VGK,27,21,1,2,3
45,8477073,Kurtis MacDermid,L,NJD,30,24,1,2,3
45,8480267,Sammy Walker,C,MIN,25,25,1,2,3
45,8480245,Olle Lycksell,R,PHI,25,33,1,2,3
45,8479587,Rhett Gardner,C,PHI,28,23,1,2,3
45,8477320,Anton Blidh,L,NYR,29,23,1,2,3
45,8482496,Nils Aman,C,VAN,24,37,0,3,3
45,8482470,Ilya Solovyov,D,CGY,24,21,0,3,3
45,8481564,Ryan Johnson,D,BUF,23,14,0,3,3
45,8481585,Egor Afanasyev,L,SJS,23,16,2,0,2
45,8478446,Glenn Gawdin,C,LAK,27,11,2,0,2
45,8482147,Jean-Luc Foudy,C,COL,22,23,2,0,2
45,8478011,Louie Belpedio,D,PHI,28,9,2,0,2
45,8484258,Sam Malinski,D,COL,26,19,1,1,2
45,8479367,William Lockwood,R,FLA,26,20,1,1,2
45,8484325,Waltteri Merela,C,TBL,26,22,1,1,2
45,8482165,Yan Kuznetsov,D,CGY,22,27,1,1,2
45,8482102,Vasily Ponomarev,C,PIT,22,20,1,1,2
45,8483512,Matthew Savoie,C,EDM,20,21,1,1,2
45,8480890,Jan Jenik,C,OTT,24,19,1,1,2
45,8482118,Sam Colangelo,R,ANA,23,16,1,1,2
45,8475413,Justin Dowling,C,NJD,34,13,1,1,2
45,8478881,Brett Seney,L,CHI,28,18,1,1,2
45,8482094,Daemon Hunt,D,MIN,22,19,1,1,2
45,8482061,Brandon Biro,L,SEA,26,17,1,1,2
45,8480306,Grant Hutton,D,NYI,29,10,1,1,2
45,8481206,John Ludvig,D,PIT,24,8,1,1,2
45,8482172,Landon Slaggert,L,CHI,22,22,0,2,2
45,8477971,Andreas Englund,D,LAK,28,23,0,2,2
45,8477149,Scott Sabourin,R,SJS,32,19,0,2,2
45,8482516,Matthew Kessel,D,STL,24,13,0,2,2
45,8482858,Ryker Evans,D,SEA,23,19,0,2,2
45,8480823,Alexander Alexeyev,D,WSH,25,14,0,2,2
45,8477541,Dakota Mermis,D,TOR,30,10,0,2,2
45,8482929,Emil Lilleberg,D,TBL,23,29,0,2,2
45,8483397,Marc McLaughlin,C,BOS,25,26,1,0,1
45,8480468,James Hamblin,L,EDM,25,20,1,0,1
45,8478051,Max Willman,C,NJD,29,20,1,0,1
45,8481422,Jake Lucchini,C,NSH,29,17,1,0,1
45,8482460,Matt Rempe,C,NYR,22,11,1,0,1
45,8482787,Nikita Chibrikov,R,WPG,31,6,1,0,1
45,8481541,Samuel Bolduc,D,NYI,24,28,0,1,1
45,8477467,Gustav Olofsson,D,SEA,30,15,0,1,1
45,8479362,Riley Tufte,L,BOS,26,22,0,1,1
45,8480032,Shane Bowers,C,NJD,25,12,0,1,1
45,8481006,Tyler Tucker,D,STL,24,17,0,1,1
45,8483567,Georgii Merkulov,C,BOS,24,11,0,1,1
45,8483597,Milos Kelemen,L,UTA,25,10,0,1,1
45,8479419,Brett Murray,L,BUF,26,14,0,1,1
45,8475795,Dylan McIlrath,D,WSH,32,12,0,1,1
45,8483546,Marshall Rifai,D,TOR,26,2,0,1,1
45,8478502,Dennis Gilbert,D,BUF,28,18,0,1,1
45,8483489,Fraser Minten,C,TOR,31,5,0,1,1
45,8483407,Brandon Scanlin,D,NYR,25,11,0,1,1
45,8480084,Nick DeSimone,D,NJD,30,19,0,1,1
45,8479330,Brandon Gignac,C,MTL,27,10,0,1,1
45,8475780,Chris Wagner,R,COL,33,8,0,1,1
45,8479421,Jacob Moverare,D,LAK,26,7,0,1,1
45,8481043,Cole Koepke,L,BOS,26,14,0,0,0
45,8481030,Jack St. Ivany,D,PIT,25,14,0,0,0
45,8481065,Angus Crookshank,L,OTT,25,10,0,0,0
45,8474062,Riley Nash,C,NYR,35,18,0,0,0
45,8482162,Roby Jarventie,L,EDM,22,18,0,0,0
45,8484304,Uvis Balinskis,D,FLA,28,4,0,0,0
45,8481024,Linus Karlsson,C,VAN,25,11,0,0,0
45,8483432,Luca Del Bel Belluz,C,CBJ,31,4,0,0,0
45,8475755,Alexander Petrovic,D,DAL,32,7,0,0,0
45,8483609,Adam Klapka,R,CGY,24,3,0,0,0
45,8483395,Arshdeep Bains,L,VAN,23,5,0,0,0
45,8483471,Brad Lambert,C,WPG,31,7,0,0,0
45,8482197,Adam Raska,R,MIN,23,3,0,0,0
45,8483401,Marc Johnstone,R,PIT,28,1,0,0,0
45,8480851,Akil Thomas,C,LAK,24,20,0,0,0
45,8481578,Graeme Clarke,R,MIN,23,10,0,0,0
45,8483920,Pierrick Dube,R,WSH,23,4,0,0,0
45,8481462,Mason Morelli,L,VGK,28,14,0,0,0
45,8480874,Adam Ginning,D,PHI,24,9,0,0,0
45,8484326,Patrik Koch,D,UTA,28,1,0,0,0
45,8484255,Jason Polin,R,COL,25,10,0,0,0
45,8477993,Justin Kirkland,C,CGY,28,5,0,0,0
45,8480075,Cameron Crotty,D,MIN,25,7,0,0,0
45,8479522,Hardy Haman Aktell,D,WSH,26,3,0,0,0
45,8478854,Ryan Shea,D,PIT,27,6,0,0,0
45,8482476,Emil Heineman,L,MTL,23,9,0,0,0
45,8482126,Emil Andrae,D,PHI,31,3,0,0,0
45,8484259,Ondrej Pavel,C,COL,31,5,0,0,0
45,8484321,Nikolas Matinpalo,D,OTT,26,3,0,0,0
45,8483398,Declan Carlile,D,TBL,31,9,0,0,0
45,8481726,Adam Edstrom,C,NYR,24,8,0,0,0
45,8481655,Cole Schwindt,R,CGY,23,2,0,0,0
45,8478147,Bokondji Imama,L,PIT,28,4,0,0,0
45,8483531,Brian Halonen,L,NJD,25,4,0,0,0
45,8481534,Raphael Lavoie,C,EDM,24,4,0,0,0
45,8476323,Max McCormick,L,SEA,32,5,0,0,0
45,8483045,Cameron Butler,R,CBJ,31,1,0,0,0
45,8478956,Samuel Laberge,L,NJD,27,1,0,0,0
45,8480274,Philip Kemp,D,EDM,25,1,0,0,0
45,8470794,Joe Pavelski,C,,40,0,0,0,0
45,8479321,Lucas Johansen,D,,27,0,0,0,0
45,8477950,Tony DeAngelo,D,,29,0,0,0,0
45,8471218,Blake Wheeler,R,,38,0,0,0,0
45,8475197,Tyson Barrie,D,,33,0,0,0,0
45,8474157,Max Pacioretty,L,,36,0,0,0,0
45,8475744,Evgeny Kuznetsov,C,,32,0,0,0,0
45,8474037,James van Riemsdyk,L,,35,0,0,0,0
45,8476907,Mackenzie MacEachern,L,,30,0,0,0,0
45,8480216,Jacob Peterson,C,,25,0,0,0,0
45,8474602,Justin Schultz,D,,34,0,0,0,0
45,8482222,Alexander Barabanov,L,,30,0,0,0,0
45,8474031,Kevin Shattenkirk,D,,35,0,0,0,0
45,8477330,Dominik Kubalik,L,,29,0,0,0,0
45,8480884,Calen Addison,D,,24,0,0,0,0
45,8475906,John Klingberg,D,,32,0,0,0,0
45,8480008,Adam Ruzicka,C,,25,0,0,0,0
45,8476884,Derrick Pouliot,D,,30,0,0,0,0
45,8476919,Chris Tierney,C,,30,0,0,0,0
45,8479415,Michael McLeod,C,,26,0,0,0,0
45,8474870,Tyler Johnson,C,,34,0,0,0,0
45,8470604,Jeff Carter,C,,39,0,0,0,0
45,8478104,Sammy Blais,L,,28,0,0,0,0
45,8474884,Mike Hoffman,C,,35,0,0,0,0
45,8481591,Sam Poulin,R,,23,0,0,0,0
45,8471274,Alex Goligoski,D,,39,0,0,0,0
45,8476871,Tanner Pearson,L,,32,0,0,0,0
45,8476393,Nick Cousins,C,,31,0,0,0,0
45,8479977,Kailer Yamamoto,R,,26,0,0,0,0
45,8479346,Dillon Dube,C,,26,0,0,0,0
45,8480184,Gustav Lindstrom,D,,26,0,0,0,0
45,8479376,Victor Mete,D,,26,0,0,0,0
45,8473449,Kyle Okposo,R,,36,0,0,0,0
45,8481058,Jesse Ylonen,R,,25,0,0,0,0
45,8475752,Tyler Pitlick,C,,33,0,0,0,0
45,8481239,Samuel Fagemo,L,,24,0,0,0,0
45,8480821,Filip Zadina,R,,25,0,0,0,0
45,8470966,Mark Giordano,D,,41,0,0,0,0
45,8478495,Denis Gurianov,R,,27,0,0,0,0
45,8477464,Nic Petan,C,,29,0,0,0,0
45,8478099,Kevin Labanc,R,,29,0,0,0,0
45,8482241,Radim Zohorna,L,,28,0,0,0,0
45,8474040,Sam Gagner,C,,35,0,0,0,0
45,8479514,Rem Pitlick,C,,27,0,0,0,0
45,8478430,Oliver Kylington,D,,27,0,0,0,0
45,8479533,Joona Koppanen,L,,26,0,0,0,0
45,8479984,Cal Foote,D,,26,0,0,0,0
45,8477126,Jayson Megna,C,,34,0,0,0,0
45,8475164,Jakob Silfverberg,R,,34,0,0,0,0
45,8474009,Nick Bonino,C,,36,0,0,0,0
45,8479458,Nikita Zaitsev,D,,33,0,0,0,0
45,8477944,Jakub Vrana,L,,28,0,0,0,0
45,8471699,Andrew Cogliano,C,,37,0,0,0,0
45,8478067,Oskar Lindblom,L,,28,0,0,0,0
45,8471686,Marc Staal,D,,37,0,0,0,0
45,8470610,Zach Parise,L,,40,0,0,0,0
45,8478904,Steven Lorentz,C,,28,0,0,0,0
45,8473473,Milan Lucic,L,,36,0,0,0,0
45,8480031,Maxime Comtois,L,,25,0,0,0,0
45,8478512,Austin Czarnik,C,,32,0,0,0,0
45,8473504,Cal Clutterbuck,R,,37,0,0,0,0
45,8477454,Adam Erne,L,,29,0,0,0,0
45,8479383,Boris Katchouk,L,,26,0,0,0,0
45,8475825,Jani Hakanpää,D,,32,0,0,0,0
45,8477846,Ryan Carpenter,C,,33,0,0,0,0
45,8477930,Pierre-Edouard Bellemare,L,,39,0,0,0,0
45,8478400,Colin White,C,,27,0,0,0,0
45,8480226,Marián Studenic,R,,26,0,0,0,0
45,8480853,Liam Foudy,C,,24,0,0,0,0
45,8475797,Jarred Tinordi,D,,32,0,0,0,0
45,8479423,Alex Nylander,L,,26,0,0,0,0
45,8474618,Marco Scandella,D,,34,0,0,0,0
45,8478028,Fredrik Olofsson,L,,28,0,0,0,0
45,8474709,Matt Martin,L,,35,0,0,0,0
45,8481070,Hugh McGing,L,,26,0,0,0,0
45,8479546,Oskar Steen,C,,26,0,0,0,0
45,8474145,Robert Bortuzzo,D,,35,0,0,0,0
45,8476915,Jujhar Khaira,L,,30,0,0,0,0
45,8475278,Byron Froese,C,,33,0,0,0,0
45,8481812,Nikolai Knyzhov,D,,27,0,0,0,0
45,8478408,Travis Dermott,D,,28,0,0,0,0
45,8481077,John Leonard,L,,26,0,0,0,0
45,8479547,Matthew Phillips,R,,26,0,0,0,0
45,8480836,Jonathan Gruden,C,,24,0,0,0,0
45,8481690,Tyler Angle,C,,24,0,0,0,0
45,8475766,Austin Watson,L,,32,0,0,0,0
45,8481016,Ruslan Iskhakov,C,,24,0,0,0,0
45,8478078,Rourke Chartier,C,,28,0,0,0,0
45,8480776,Sheldon Rempal,R,,29,0,0,0,0
45,8484314,Jiri Smejkal,L,,28,0,0,0,0
46,8476453,Nikita Kucherov,R,TBL,31,82,46,101,147
46,8477492,Nathan MacKinnon,C,COL,29,81,49,92,141
46,8478402,Connor McDavid,C,EDM,27,78,34,97,131
46,8477939,William Nylander,R,TOR,28,81,57,71,128
46,8477956,David Pastrnak,R,BOS,28,79,52,73,125
46,8479318,Auston Matthews,C,TOR,27,80,74,48,122
46,8478483,Mitch Marner,R,TOR,27,78,42,71,113
46,8478420,Mikko Rantanen,R,COL,28,82,47,64,111
46,8479314,Matthew Tkachuk,L,FLA,27,78,39,72,111
46,8482116,Tim Stützle,C,OTT,22,78,41,69,110
46,8477934,Leon Draisaitl,C,EDM,29,81,48,55,103
46,8480801,Brady Tkachuk,L,OTT,25,76,44,59,103
46,8480036,Miro Heiskanen,D,DAL,25,80,15,88,103
46,8477404,Jake Guentzel,C,TBL,30,82,43,59,102
46,8478550,Artemi Panarin,L,NYR,33,79,29,72,101
46,8478864,Kirill Kaprizov,L,MIN,27,71,45,55,100
46,8478445,Mathew Barzal,C,NYI,27,78,30,67,97
46,8480830,Andrei Svechnikov,R,CAR,24,71,39,57,96
46,8478403,Jack Eichel,C,VGK,28,76,38,57,95
46,8477493,Aleksander Barkov,C,FLA,29,81,32,63,95
46,8481559,Jack Hughes,C,NJD,23,70,36,57,93
46,8477501,Valeri Nichushkin,R,COL,29,81,50,41,91
46,8473512,Claude Giroux,R,OTT,36,80,38,52,90
46,8477942,Kevin Fiala,L,LAK,28,80,28,61,89
46,8480027,Jason Robertson,L,DAL,25,82,42,46,88
46,8476887,Filip Forsberg,L,NSH,30,75,38,50,88
46,8476539,Jonathan Marchessault,R,NSH,34,76,54,32,86
46,8475166,John Tavares,C,TOR,34,79,34,51,85
46,8475913,Mark Stone,R,VGK,32,79,31,54,85
46,8477933,Sam Reinhart,C,FLA,29,77,31,52,83
46,8476459,Mika Zibanejad,C,NYR,31,75,31,51,82
46,8477946,Dylan Larkin,C,DET,28,81,41,40,81
46,8480012,Elias Pettersson,C,VAN,26,77,39,41,80
46,8476454,Ryan Nugent-Hopkins,C,EDM,31,80,20,60,80
46,8478439,Travis Konecny,R,PHI,27,75,32,47,79
46,8476881,Tomas Hertl,C,VGK,31,77,29,50,79
46,8475692,Mats Zuccarello,R,MIN,37,76,22,57,79
46,8474600,Roman Josi,D,NSH,34,75,18,61,79
46,8478010,Brayden Point,C,TBL,28,81,37,41,78
46,8479542,Brandon Hagel,L,TBL,26,82,34,44,78
46,8476456,Jonathan Huberdeau,C,CGY,31,79,18,60,78
46,8475184,Chris Kreider,L,NYR,33,77,38,39,77
46,8479407,Jesper Bratt,L,NJD,26,74,32,45,77
46,8479325,Charlie McAvoy,D,BOS,27,75,14,63,77
46,8471675,Sidney Crosby,C,PIT,37,75,41,35,76
46,8477402,Pavel Buchnevich,L,STL,29,74,37,39,76
46,8481557,Matt Boldy,L,MIN,23,74,31,45,76
46,8478444,Brock Boeser,R,VAN,27,76,31,45,76
46,8480002,Nico Hischier,C,NJD,25,75,28,48,76
46,8476468,J.T. Miller,C,VAN,31,74,23,53,76
46,8479385,Jordan Kyrou,C,STL,26,73,32,43,75
46,8479323,Adam Fox,D,NYR,26,73,15,60,75
46,8480800,Quinn Hughes,D,VAN,25,75,14,61,75
46,8477955,Jared McCann,L,SEA,28,74,35,39,74
46,8478975,Mason Marchment,L,DAL,29,81,33,41,74
46,8476853,Morgan Rielly,D,TOR,30,74,11,63,74
46,8480865,Noah Dobson,D,NYI,24,82,8,66,74
46,8478427,Sebastian Aho,C,CAR,27,70,38,35,73
46,8475168,Matt Duchene,C,DAL,33,80,34,39,73
46,8480208,Drake Batherson,R,OTT,26,79,30,43,73
46,8484144,Connor Bedard,C,CHI,19,70,27,46,73
46,8477960,Adrian Kempe,R,LAK,28,78,27,46,73
46,8480023,Robert Thomas,C,STL,25,76,19,54,73
46,8477500,Bo Horvat,C,NYI,29,79,33,39,72
46,8479343,Clayton Keller,R,UTA,26,75,31,41,72
46,8474564,Steven Stamkos,C,NSH,34,72,23,49,72
46,8475754,Brock Nelson,C,NYI,33,79,36,35,71
46,8479675,Trevor Moore,L,LAK,29,80,34,36,70
46,8482093,Seth Jarvis,C,CAR,22,74,32,38,70
46,8471685,Anze Kopitar,C,LAK,37,80,20,50,70
46,8478398,Kyle Connor,L,WPG,28,77,35,34,69
46,8473994,Jamie Benn,L,DAL,35,82,33,36,69
46,8477951,Nick Schmaltz,C,UTA,28,79,31,38,69
46,8476460,Mark Scheifele,C,WPG,31,76,28,41,69
46,8482740,Wyatt Johnston,C,DAL,21,79,28,41,69
46,8474102,David Perron,L,OTT,36,77,28,41,69
46,8479420,Tage Thompson,C,BUF,27,71,39,29,68
46,8475794,Tyler Seguin,C,DAL,32,82,30,38,68
46,8480069,Cale Makar,D,COL,26,64,18,50,68
46,8476346,Johnny Gaudreau,L,CBJ,31,65,17,51,68
46,8475167,Victor Hedman,D,TBL,34,80,15,53,68
46,8482078,Lucas Raymond,L,DET,22,81,23,44,67
46,8478873,Troy Terry,R,ANA,27,76,25,41,66
46,8477409,Carter Verhaeghe,C,FLA,29,77,28,37,65
46,8475172,Nazem Kadri,C,CGY,34,79,23,42,65
46,8482665,Matty Beniers,C,SEA,22,74,21,44,65
46,8477476,Artturi Lehkonen,L,COL,29,80,40,24,64
46,8471214,Alex Ovechkin,L,WSH,39,73,30,34,64
46,8475784,Jeff Skinner,C,EDM,32,73,29,35,64
46,8476399,Blake Coleman,C,CGY,33,77,28,36,64
46,8478493,Joel Eriksson Ek,C,MIN,27,71,22,42,64
46,8474578,Erik Karlsson,D,PIT,34,79,8,56,64
46,8475726,Tyler Toffoli,C,SJS,32,74,33,30,63
46,8478414,Timo Meier,R,NJD,28,70,31,32,63
46,8476389,Vincent Trocheck,C,NYR,31,77,29,34,63
46,8482699,Dylan Guenther,R,UTA,21,76,29,34,63
46,8475745,Charlie Coyle,C,BOS,32,81,27,36,63
46,8473419,Brad Marchand,L,BOS,36,78,21,42,63
46,8482745,Mason McTavish,C,ANA,21,72,25,36,61
46,8480188,Fabian Zetterlund,L,SJS,25,70,25,36,61
46,8481540,Cole Caufield,R,MTL,23,74,32,28,60
46,8474141,Patrick Kane,R,DET,36,77,29,31,60
46,8476448,William Karlsson,C,VGK,31,75,27,33,60
46,8478542,Evan Rodrigues,C,FLA,31,75,24,36,60
46,8477932,Aaron Ekblad,D,FLA,28,74,15,45,60
46,8480803,Evan Bouchard,D,EDM,25,74,13,47,60
46,8478460,Zach Werenski,D,CBJ,27,77,9,51,60
46,8475810,Bryan Rust,R,PIT,32,71,26,33,59
46,8473986,Alex Killorn,L,ANA,35,76,25,34,59
46,8480039,Martin Necas,C,CAR,25,70,24,35,59
46,8479400,Pierre-Luc Dubois,L,WSH,26,72,22,37,59
46,8480028,Morgan Frost,C,PHI,25,76,20,39,59
46,8479999,Casey Mittelstadt,C,COL,26,80,15,44,59
46,8478366,Frank Vatrano,R,ANA,30,77,34,24,58
46,8482113,Anton Lundell,C,FLA,23,78,26,32,58
46,8478401,Pavel Zacha,C,BOS,27,77,21,37,58
46,8480839,Rasmus Dahlin,D,BUF,24,69,15,43,58
46,8477940,Nikolaj Ehlers,L,WPG,28,69,27,30,57
46,8475170,Brayden Schenn,C,STL,33,73,27,30,57
46,8478449,Roope Hintz,C,DAL,28,82,26,31,57
46,8477935,Sam Bennett,C,FLA,28,69,26,31,57
46,8477998,Warren Foegele,L,LAK,28,80,23,34,57
46,8479337,Alex DeBrincat,R,DET,27,80,20,37,57
46,8476792,Torey Krug,D,STL,33,78,17,40,57
46,8475786,Zach Hyman,L,EDM,32,78,34,22,56
46,8480064,Josh Norris,C,OTT,25,75,33,23,56
46,8484153,Leo Carlsson,C,ANA,20,76,27,29,56
46,8471215,Evgeni Malkin,C,PIT,38,72,19,37,56
46,8476483,Rickard Rakell,R,PIT,31,72,29,26,55
46,8475158,Ryan O'Reilly,C,NSH,33,73,26,29,55
46,8478047,Michael Bunting,L,PIT,29,75,22,33,55
46,8476479,Phillip Danault,C,LAK,31,81,21,34,55
46,8474590,John Carlson,D,WSH,34,66,13,42,55
46,8476875,Mike Matheson,D,MTL,30,75,10,45,55
46,8477494,Jonathan Drouin,L,COL,29,78,10,45,55
46,8482109,Alexis Lafrenière,L,NYR,23,74,30,24,54
46,8481596,Shane Pinto,C,OTT,24,77,17,37,54
46,8476905,Chandler Stephenson,C,SEA,30,75,16,38,54
46,8482105,Jake Sanderson,D,OTT,22,73,13,41,54
46,8475765,Vladimir Tarasenko,R,DET,33,80,24,29,53
46,8480018,Nick Suzuki,C,MTL,25,74,21,32,53
46,8482159,Tyson Foerster,R,PHI,22,71,29,23,52
46,8482720,Matthew Knies,L,TOR,22,71,23,29,52
46,8477496,Elias Lindholm,C,BOS,30,79,21,31,52
46,8478042,Viktor Arvidsson,L,EDM,31,76,20,32,52
46,8474150,Mikael Backlund,C,CGY,35,78,16,36,52
46,8478440,Dylan Strome,C,WSH,27,70,16,36,52
46,8477495,Seth Jones,D,CHI,30,70,16,36,52
46,8474563,Drew Doughty,D,LAK,35,70,15,37,52
46,8483515,Juraj Slafkovsky,L,MTL,20,76,24,27,51
46,8475169,Evander Kane,L,EDM,33,75,22,29,51
46,8476882,Teuvo Teravainen,C,CHI,30,71,19,32,51
46,8478407,Vince Dunn,D,SEA,28,67,17,34,51
46,8477504,Josh Morrissey,D,WPG,29,75,14,37,51
46,8481711,Matias Maccelli,L,UTA,24,76,14,37,51
46,8477447,Shea Theodore,D,VGK,29,58,8,43,51
46,8479987,Morgan Geekie,C,BOS,26,78,28,22,50
46,8476880,Tom Wilson,R,WSH,30,72,26,24,50
46,8475151,Kyle Palmieri,C,NYI,33,79,24,26,50
46,8482702,Logan Stankoven,C,DAL,21,79,23,27,50
46,8477426,Nicholas Paul,L,TBL,29,81,23,27,50
46,8480014,Gabriel Vilardi,C,WPG,25,69,23,27,50
46,8477456,J.T. Compher,L,DET,29,80,18,32,50
46,8476432,Boone Jenner,C,CBJ,31,72,29,20,49
46,8477346,MacKenzie Weegar,D,CGY,30,78,14,35,49
46,8477451,Ryan Hartman,R,MIN,30,68,14,35,49
46,8477949,Alex Tuch,R,BUF,28,69,13,36,49
46,8477503,Max Domi,C,TOR,29,75,13,36,49
46,8478038,Devon Toews,D,COL,30,73,8,41,49
46,8481542,Moritz Seider,D,DET,23,75,5,44,49
46,8477497,Sean Monahan,C,CBJ,30,72,23,25,48
46,8477964,Ivan Barbashev,C,VGK,29,75,22,26,48
46,8481533,Trevor Zegras,C,ANA,23,72,15,33,48
46,8482684,Luke Hughes,D,NJD,21,73,13,35,48
46,8476906,Shayne Gostisbehere,D,CAR,31,79,13,35,48
46,8475798,Mikael Granlund,C,SJS,32,70,13,35,48
46,8476869,Brady Skjei,D,NSH,30,75,12,36,48
46,8479525,Ross Colton,C,COL,28,79,24,23,47
46,8481068,Yegor Sharangovich,C,CGY,26,78,22,25,47
46,8482667,William Eklund,L,SJS,22,63,20,27,47
46,8484166,Adam Fantilli,C,CBJ,20,64,18,29,47
46,8480798,Philipp Kurashev,C,CHI,25,71,15,32,47
46,8483808,Andrei Kuzmenko,L,CGY,28,80,28,18,46
46,8477479,Tyler Bertuzzi,L,CHI,29,60,24,22,46
46,8475314,Anders Lee,L,NYI,34,80,23,23,46
46,8478462,Nicolas Roy,C,VGK,27,75,21,25,46
46,8481528,Dylan Cozens,C,BUF,23,71,19,27,46
46,8474679,Gustav Nyquist,C,NSH,35,67,18,28,46
46,8478438,Tommy Novak,C,NSH,27,64,16,30,46
46,8478233,Andrew Mangiapane,L,WSH,28,71,16,30,46
46,8477407,Anthony Duclair,L,NYI,29,77,14,32,46
46,8478469,Thomas Chabot,D,OTT,27,76,13,33,46
46,8476854,Hampus Lindholm,D,BOS,30,70,9,37,46
46,8480829,Jesperi Kotkaniemi,C,CAR,24,64,24,21,45
46,8475714,Calle Jarnkrok,C,TOR,33,74,21,24,45
46,8478466,Daniel Sprong,R,VAN,27,70,21,24,45
46,8477429,Andrew Copp,C,DET,30,78,19,26,45
46,8477021,Alex Kerfoot,C,UTA,30,75,18,27,45
46,8474641,Adam Henrique,C,EDM,34,76,26,18,44
46,8475799,Nino Niederreiter,R,WPG,32,66,19,25,44
46,8481581,Thomas Harley,D,DAL,23,70,12,32,44
46,8477416,Oliver Bjorkstrand,R,SEA,29,70,11,33,44
46,8479992,Michael Rasmussen,C,DET,25,77,17,26,43
46,8475768,Jaden Schwartz,C,SEA,32,78,14,29,43
46,8475753,Justin Faulk,D,STL,32,73,13,30,43
46,8478397,Rasmus Andersson,D,CGY,28,68,7,36,43
46,8480015,Owen Tippett,R,PHI,25,74,22,20,42
46,8478519,Anthony Cirelli,C,TBL,27,82,18,24,42
46,8480185,Eetu Luostarinen,C,FLA,26,76,14,28,42
46,8478055,Gustav Forsling,D,FLA,28,74,12,30,42
46,8476958,Jaccob Slavin,D,CAR,30,80,9,33,42
46,8481604,Pavel Dorofeyev,L,VGK,24,67,21,20,41
46,8478856,Conor Garland,R,VAN,28,76,20,21,41
46,8476458,Ryan Strome,C,ANA,31,74,19,22,41
46,8476419,Jean-Gabriel Pageau,C,NYI,32,74,18,23,41
46,8481524,Bowen Byram,D,BUF,23,66,15,26,41
46,8479425,Filip Hronek,D,VAN,27,73,12,29,41
46,8482175,JJ Peterka,R,BUF,22,72,21,19,40
46,8475760,Nick Bjugstad,C,UTA,32,72,21,19,40
46,8480797,Joel Farabee,L,PHI,24,76,17,23,40
46,8482117,Lukas Reichel,L,CHI,22,58,17,23,40
46,8482092,Ridly Greig,C,OTT,22,80,15,25,40
46,8475191,Reilly Smith,R,NYR,33,75,15,25,40
46,8474586,Jordan Eberle,R,SEA,34,71,14,26,40
46,8479339,Patrik Laine,L,CBJ,26,64,13,27,40
46,8483505,Matthew Poitras,C,BOS,20,76,12,28,40
46,8471724,Kris Letang,D,PIT,37,77,11,29,40
46,8470613,Brent Burns,D,CAR,39,74,9,31,40
46,8476438,Brandon Saad,L,STL,32,74,26,13,39
46,8478500,Ivan Provorov,D,CBJ,27,78,5,34,39
46,8481560,Arthur Kaliyev,R,LAK,23,78,17,21,38
46,8477444,Andre Burakovsky,L,SEA,29,75,17,21,38
46,8471698,T.J. Oshie,R,WSH,38,64,17,21,38
46,8481618,Alex Newhook,C,MTL,23,69,14,24,38
46,8477987,Ryan Donato,C,CHI,28,64,14,24,38
46,8482124,Quinton Byfield,R,LAK,22,81,11,27,38
46,8480434,Sean Durzi,D,UTA,26,68,10,28,38
46,8479410,Mikhail Sergachev,D,UTA,26,66,6,32,38
46,8481703,Valtteri Puustinen,R,PIT,25,59,6,32,38
46,8480893,Kirill Marchenko,R,CBJ,24,61,20,17,37
46,8474149,Evgenii Dadonov,R,DAL,35,80,9,28,37
46,8482097,Jack Quinn,R,BUF,23,65,19,17,36
46,8476392,Adam Lowry,C,WPG,31,61,16,20,36
46,8477952,Robby Fabbri,C,ANA,28,62,16,20,36
46,8478115,Pierre Engvall,L,NYI,28,77,15,21,36
46,8482149,Cole Perfetti,C,WPG,22,66,12,24,36
46,8479591,Michael Eyssimont,C,TBL,28,81,12,24,36
46,8479345,Jakob Chychrun,D,WSH,26,64,11,25,36
46,8480220,Noah Cates,L,PHI,25,69,11,25,36
46,8478046,Danton Heinen,L,VAN,29,65,10,26,36
46,8476892,Colton Parayko,D,STL,31,70,6,30,36
46,8474715,Cameron Atkinson,R,TBL,35,80,19,16,35
46,8481186,Logan O'Connor,R,COL,28,78,18,17,35
46,8478891,Mason Appleton,C,WPG,28,63,16,19,35
46,8482146,Luke Evangelista,R,NSH,22,71,15,20,35
46,8478463,Anthony Beauvillier,L,PIT,27,61,15,20,35
46,8480849,Barrett Hayton,C,UTA,24,72,14,21,35
46,8476826,Yanni Gourde,C,SEA,33,69,13,22,35
46,8475793,Ryan Johansen,C,PHI,32,70,13,22,35
46,8477948,Travis Sanheim,D,PHI,28,73,12,23,35
46,8482475,Yegor Chinakhov,R,CBJ,23,62,11,24,35
46,8476872,Scott Laughton,C,PHI,30,70,10,25,35
46,8481577,Philip Tomasino,C,NSH,23,69,9,26,35
46,8476923,Damon Severson,D,CBJ,30,80,8,27,35
46,8482122,Brock Faber,D,MIN,22,82,6,29,35
46,8482712,Oskar Olausson,R,COL,22,80,4,31,35
46,8475764,Cam Fowler,D,ANA,33,74,4,31,35
46,8478474,Lawson Crouse,L,UTA,27,74,21,13,34
46,8482705,Cole Sillinger,C,CBJ,21,67,20,14,34
46,8481554,Kaapo Kakko,R,NYR,23,72,20,14,34
46,8479351,Sam Steel,C,DAL,26,79,16,18,34
46,8475722,Jason Zucker,L,BUF,32,66,16,18,34
46,8480459,Pius Suter,C,VAN,28,68,15,19,34
46,8482133,Thomas Bordeleau,C,SJS,22,66,15,19,34
46,8475855,Jesper Fast,R,CAR,33,64,14,20,34
46,8476462,Dougie Hamilton,D,NJD,31,71,11,23,34
46,8477986,Brandon Montour,D,SEA,30,71,10,24,34
46,8478458,John (Jack) Roslovic,C,CAR,27,67,10,24,34
46,8475200,Dmitry Orlov,D,CAR,33,74,10,24,34
46,8474565,Alex Pietrangelo,D,VGK,34,65,8,26,34
46,8477425,Miles Wood,L,COL,29,78,18,15,33
46,8478109,Victor Olofsson,L,VGK,29,76,17,16,33
46,8482125,Alexander Holtz,R,VGK,22,72,16,17,33
46,8481656,Aliaksei Protas,C,WSH,23,64,15,18,33
46,8476480,Vladislav Namestnikov,C,WPG,32,66,14,19,33
46,8476925,Colton Sissons,C,NSH,31,66,14,19,33
46,8481553,Bobby Brink,R,PHI,23,64,14,19,33
46,8483431,Logan Cooley,C,UTA,20,76,12,21,33
46,8480078,Filip Chytil,C,NYR,25,64,12,21,33
46,8478136,Jake Middleton,D,MIN,28,77,10,23,33
46,8480878,Nils Lundkvist,D,DAL,24,69,10,23,33
46,8482110,Dawson Mercer,C,NJD,23,69,9,24,33
46,8476463,Jonas Brodin,D,MIN,31,78,6,27,33
46,8476331,Dylan DeMelo,D,WPG,31,70,5,28,33
46,8477353,Tyler Motte,C,DET,29,73,17,15,32
46,8475287,Erik Haula,L,NJD,33,72,14,18,32
46,8480144,David Kampf,C,TOR,29,74,13,19,32
46,8475848,Brendan Gallagher,R,MTL,32,70,12,20,32
46,8481523,Kirby Dach,C,MTL,23,70,12,20,32
46,8477498,Darnell Nurse,D,EDM,29,74,7,25,32
46,8483490,Pavel Mintyukov,D,ANA,21,76,5,27,32
46,8478498,Jake DeBrusk,L,VAN,28,75,17,14,31
46,8480113,Alex Iafallo,L,WPG,31,67,16,15,31
46,8479996,Cody Glass,C,NSH,25,61,14,17,31
46,8476292,Ondrej Palat,L,NJD,33,74,9,22,31
46,8480871,Adam Boqvist,D,FLA,24,68,8,23,31
46,8481546,Cam York,D,PHI,23,76,8,23,31
46,8476897,Oskar Sundqvist,C,STL,30,65,8,23,31
46,8482671,Owen Power,D,BUF,22,68,4,27,31
46,8474151,Ryan McDonagh,D,TBL,35,75,2,29,31
46,8481624,Ilya Mikheyev,R,CHI,30,66,17,13,30
46,8482055,Drew O'Connor,L,PIT,26,59,16,14,30
46,8478057,Dakota Joshua,C,VAN,28,68,15,15,30
46,8475343,Nic Dowd,C,WSH,34,59,15,15,30
46,8474189,Lars Eller,C,PIT,35,69,14,16,30
46,8478472,Mathieu Joseph,R,STL,27,62,7,23,30
46,8480145,Neal Pionk,D,WPG,29,71,6,24,30
46,8477969,Marcus Pettersson,D,PIT,28,75,3,27,30
46,8477919,Frederick Gaudreau,C,MIN,31,66,18,11,29
46,8473422,Nick Foligno,L,CHI,37,60,16,13,29
46,8482079,Marco Rossi,C,MIN,23,61,15,14,29
46,8479365,Trent Frederic,C,BOS,26,79,14,15,29
46,8477953,Kasperi Kapanen,R,STL,28,72,13,16,29
46,8480068,Ryan Poehling,C,PHI,25,71,13,16,29
46,8482259,Bobby McMann,C,TOR,28,70,13,16,29
46,8477511,Anthony Mantha,R,CGY,30,75,12,17,29
46,8474053,Logan Couture,C,SJS,35,58,11,18,29
46,8476329,Travis Boyd,C,MIN,31,55,11,18,29
46,8480009,Eeli Tolvanen,R,SEA,25,76,10,19,29
46,8482749,Joshua Roy,R,MTL,21,63,9,20,29
46,8478396,Noah Hanifin,D,VGK,27,65,7,22,29
46,8478882,Vladislav Gavrikov,D,LAK,29,65,6,23,29
46,8479982,Conor Timmins,D,TOR,26,61,6,23,29
46,8476981,Josh Anderson,R,MTL,30,67,18,10,28
46,8476474,Stefan Noesen,R,NJD,31,69,14,14,28
46,8477505,Alexander Wennberg,C,SJS,30,64,7,21,28
46,8474716,Jared Spurgeon,D,MIN,35,73,7,21,28
46,8483445,Cutter Gauthier,L,ANA,20,62,7,21,28
46,8477506,Ryan Pulock,D,NYI,30,77,5,23,28
46,8480049,Dylan Samberg,D,WPG,25,65,1,27,28
46,8482245,Artem Zub,D,OTT,29,66,0,28,28
46,8481704,Juuso Parssinen,C,NSH,23,54,15,12,27
46,8475193,Tomas Tatar,L,NJD,34,69,13,14,27
46,8475231,Casey Cizikas,C,NYI,33,76,12,15,27
46,8484149,Gavin Brindley,C,CBJ,20,55,11,16,27
46,8476927,Teddy Blueger,C,VAN,30,65,6,21,27
46,8480336,Sean Walker,D,CAR,30,73,6,21,27
46,8480817,K'Andre Miller,D,NYR,24,73,5,22,27
46,8478133,Jake Evans,C,MTL,28,73,3,24,27
46,8473507,Jeff Petry,D,DET,37,71,3,24,27
46,8480073,Erik Brannstrom,D,COL,25,63,1,26,27
46,8479293,Brandon Tanev,L,SEA,33,63,15,11,26
46,8477839,Conor Sheary,L,TBL,32,79,14,12,26
46,8479661,Tanner Jeannot,L,LAK,27,77,13,13,26
46,8476918,Jimmy Vesey,L,NYR,31,64,12,14,26
46,8470621,Corey Perry,R,EDM,39,71,12,14,26
46,8483499,Liam Ohgren,L,MIN,20,59,11,15,26
46,8480789,Oliver Wahlstrom,R,NYI,24,71,10,16,26
46,8477989,Christian Dvorak,C,MTL,28,65,9,17,26
46,8482101,Danil Gushchin,L,SJS,22,58,7,19,26
46,8476885,Jacob Trouba,D,NYR,30,65,5,21,26
46,8481481,Blake Lizotte,C,PIT,27,70,14,11,25
46,8481535,Nils Hoglander,L,VAN,24,69,13,12,25
46,8480813,Joe Veleno,C,DET,24,75,13,12,25
46,8482111,Justin Barron,D,MTL,23,65,12,13,25
46,8479393,Noah Gregor,L,OTT,26,71,11,14,25
46,8480855,Jack McBain,C,UTA,24,71,9,16,25
46,8484203,Bradly Nadeau,L,CAR,19,54,7,18,25
46,8481606,Jordan Spence,D,LAK,23,68,6,19,25
46,8476461,Sean Couturier,C,PHI,32,65,5,20,25
46,8476902,Esa Lindell,D,DAL,30,76,5,20,25
46,8479980,Nicolas Hague,D,VGK,26,54,5,20,25
46,8476429,Scott Mayfield,D,NYI,32,78,4,21,25
46,8482655,Janis Moser,D,TBL,24,74,4,21,25
46,8474673,TJ Brodie,D,CHI,34,60,3,22,25
46,8480043,Timothy Liljegren,D,TOR,25,64,1,24,25
46,8482089,Jake Neighbours,L,STL,22,68,17,7,24
46,8482809,Jackson Blake,R,CAR,21,67,12,12,24
46,8480021,Jack Studnicka,C,LAK,25,55,12,12,24
46,8482660,Kent Johnson,C,CBJ,22,65,11,13,24
46,8481582,Nicholas Robertson,L,TOR,23,70,10,14,24
46,8480802,Ryan McLeod,C,BUF,25,71,10,14,24
46,8483457,Lane Hutson,D,MTL,20,69,10,14,24
46,8479315,Joey Anderson,R,CHI,26,49,10,14,24
46,8480003,Jesper Boqvist,C,FLA,26,63,9,15,24
46,8479353,Brett Howden,C,VGK,26,72,8,16,24
46,8481521,Ronnie Attard,D,PHI,25,59,7,17,24
46,8477508,Curtis Lazar,C,NJD,29,57,6,18,24
46,8476525,Colin Miller,D,WPG,32,66,6,18,24
46,8478452,Caleb Jones,D,LAK,27,62,6,18,24
46,8476988,Matt Benning,D,SJS,30,68,5,19,24
46,8471709,Marc-Edouard Vlasic,D,SJS,37,60,4,20,24
46,8479390,Taylor Raddysh,R,WSH,26,63,12,11,23
46,8476278,Colin Blackwell,C,DAL,31,76,11,12,23
46,8475220,Marcus Foligno,L,MIN,33,65,11,12,23
46,8481641,Joel Kiviranta,L,COL,28,66,9,14,23
46,8475791,Taylor Hall,L,CHI,33,53,8,15,23
46,8480835,Jack Drury,C,CAR,24,65,6,17,23
46,8478413,Jordan Greenway,L,BUF,27,69,6,17,23
46,8477947,Sonny Milano,L,WSH,28,63,6,17,23
46,8479402,Jake Bean,D,CGY,26,69,6,17,23
46,8479398,Samuel Girard,D,COL,26,65,6,17,23
46,8477488,Brett Pesce,D,NJD,30,66,4,19,23
46,8478507,John Marino,D,UTA,27,68,3,20,23
46,8475690,Chris Tanev,D,TOR,35,63,3,20,23
46,8480891,Michael Kesselring,D,UTA,24,61,1,22,23
46,8476878,Zemgus Girgensons,C,TBL,30,80,14,8,22
46,8476374,Sean Kuraly,C,CBJ,31,58,12,10,22
46,8478043,Sam Lafferty,C,BUF,29,59,11,11,22
46,8478434,Keegan Kolesar,R,VGK,27,67,11,11,22
46,8479941,Justin Danforth,R,CBJ,31,63,11,11,22
46,8484145,Zach Benson,L,BUF,19,63,9,13,22
46,8475763,Kevin Hayes,R,PIT,32,62,8,14,22
46,8477220,Nate Schmidt,D,FLA,33,71,6,16,22
46,8476624,Barclay Goodrow,C,SJS,31,60,6,16,22
46,8479639,Dylan Coghlan,D,WPG,26,55,5,17,22
46,8474574,Tyler Myers,D,VAN,34,70,4,18,22
46,8481568,Alex Vlasic,D,CHI,23,55,4,18,22
46,8476979,Erik Gustafsson,D,DET,32,73,2,20,22
46,8482074,Connor Zary,C,CGY,23,63,15,6,21
46,8481580,Connor McMichael,C,WSH,23,61,10,11,21
46,8482803,Olen Zellweger,D,ANA,21,68,10,11,21
46,8481601,Simon Holmstrom,R,NYI,23,72,9,12,21
46,8477406,Mattias Janmark,C,EDM,32,62,9,12,21
46,8476921,Jordan Martinook,L,CAR,32,58,8,13,21
46,8483468,Jiri Kulich,C,BUF,20,59,8,13,21
46,8476312,Josh Manson,D,COL,33,60,7,14,21
46,8479414,Nathan Bastian,R,NJD,27,61,7,14,21
46,8481093,Rafael Harvey-Pinard,L,MTL,25,62,6,15,21
46,8482142,Jamie Drysdale,D,PHI,22,69,6,15,21
46,8477507,Nikita Zadorov,D,BOS,29,68,6,15,21
46,8480172,Jan Rutta,D,SJS,34,63,6,15,21
46,8475171,Oliver Ekman-Larsson,D,TOR,33,66,4,17,21
46,8476467,Jamie Oleksiak,D,SEA,32,66,4,17,21
46,8478399,Jonas Siegenthaler,D,NJD,27,63,4,17,21
46,8478970,Jalen Chatfield,D,CAR,28,69,3,18,21
46,8483565,Nick Blankenburg,D,NSH,26,64,3,18,21
46,8481059,Scott Perunovich,D,STL,26,67,1,20,21
46,8479520,Brandon Duhaime,R,WSH,27,58,12,8,20
46,8481517,Brett Leason,R,ANA,25,54,10,10,20
46,8479619,Michael Carcone,L,UTA,28,56,10,10,20
46,8478020,Michael Amadio,R,OTT,28,75,9,11,20
46,8481032,Paul Cotter,C,NJD,25,66,9,11,20
46,8482148,Hendrix Lapierre,C,WSH,22,51,9,11,20
46,8476917,Adam Pelech,D,NYI,30,75,8,12,20
46,8474034,Patrick Maroon,L,CHI,36,51,8,12,20
46,8480035,Henri Jokiharju,D,BUF,25,71,7,13,20
46,8473563,Nicklas Backstrom,C,WSH,37,57,6,14,20
46,8480762,Eric Robinson,L,CAR,29,56,6,14,20
46,8480157,Calle Rosen,D,COL,30,50,6,14,20
46,8475149,Marcus Johansson,L,MIN,34,64,5,15,20
46,8476891,Matthew Grzelcyk,D,PIT,30,75,1,19,20
46,8476856,Mathew Dumba,D,DAL,30,69,1,19,20
46,8479439,Jacob MacDonald,D,COL,31,56,12,7,19
46,8476469,Joel Armia,R,MTL,31,63,11,8,19
46,8475842,Sam Carrick,C,NYR,32,56,11,8,19
46,8473453,Trevor Lewis,C,LAK,37,76,11,8,19
46,8480205,Emil Bemstrom,C,PIT,25,61,10,9,19
46,8476960,Andreas Athanasiou,C,CHI,30,56,9,10,19
46,8477478,William Carrier,L,CAR,30,55,9,10,19
46,8477979,Nicolas Aube-Kubel,R,BUF,28,54,9,10,19
46,8480995,Pontus Holmberg,R,TOR,25,55,7,12,19
46,8475179,Dmitry Kulikov,D,FLA,34,63,6,13,19
46,8477845,Trevor van Riemsdyk,D,WSH,33,58,6,13,19
46,8480727,Zach Whitecloud,D,VGK,28,55,6,13,19
46,8480980,Connor Dewar,C,TOR,25,74,5,14,19
46,8479983,Mario Ferraro,D,SJS,26,70,5,14,19
46,8475462,Radko Gudas,D,ANA,34,72,4,15,19
46,8480860,Kevin Bahl,D,CGY,24,60,2,17,19
46,8477903,Garnet Hathaway,R,PHI,33,67,14,4,18
46,8482679,Matt Coronato,R,CGY,22,57,9,9,18
46,8476873,Mark Jankowski,C,NSH,30,48,9,9,18
46,8478432,Christian Fischer,R,DET,27,77,9,9,18
46,8475218,Mattias Ekholm,D,EDM,34,73,8,10,18
46,8480748,Kiefer Sherwood,L,VAN,29,60,8,10,18
46,8477380,Jonny Brodzinski,C,NYR,31,53,8,10,18
46,8480848,Ty Dellandrea,C,SJS,24,39,8,10,18
46,8473533,Jordan Staal,C,CAR,36,60,7,11,18
46,8477015,Connor Brown,R,EDM,30,58,7,11,18
46,8477369,Carson Soucy,D,VAN,30,65,7,11,18
46,8481441,Joe Snively,C,DET,28,67,7,11,18
46,8480252,Cole Guttman,C,CHI,25,37,7,11,18
46,8481019,David Gustafsson,C,WPG,24,44,6,12,18
46,8474166,Alec Martinez,D,CHI,37,46,5,13,18
46,8482067,Connor Mackey,D,NYR,28,63,4,14,18
46,8482073,Braden Schneider,D,NYR,23,61,4,14,18
46,8475324,Nick Jensen,D,OTT,34,66,3,15,18
46,8478178,Darren Raddysh,D,TBL,28,67,3,15,18
46,8478451,Ethan Bear,D,WSH,27,61,3,15,18
46,8478911,Matt Roy,D,WSH,29,62,2,16,18
46,8475188,Brayden McNabb,D,VGK,33,52,2,16,18
46,8480873,Rasmus Sandin,D,WSH,24,67,1,17,18
46,8481014,Alexander Romanov,D,NYI,24,76,1,17,18
46,8475790,Erik Gudbranson,D,CBJ,32,78,1,17,18
46,8480289,Morgan Barron,C,WPG,26,57,11,6,17
46,8481477,Nico Sturm,C,SJS,29,58,11,6,17
46,8477392,Hudson Fasching,R,NYI,29,64,10,7,17
46,8479368,Max Jones,L,BOS,26,64,9,8,17
46,8479291,Kevin Rooney,C,CGY,31,53,9,8,17
46,8477446,Michael McCarron,R,NSH,29,52,7,10,17
46,8483493,Frank Nazar,C,CHI,20,47,5,12,17
46,8479026,Philippe Myers,D,TOR,27,53,5,12,17
46,8479249,Andrew Poturalski,C,SJS,30,41,4,13,17
46,8479998,Mikey Anderson,D,LAK,25,66,2,15,17
46,8476931,Jake McCabe,D,TOR,31,61,1,16,17
46,8478211,Dryden Hunt,L,CGY,29,60,11,5,16
46,8483524,Shane Wright,C,SEA,20,60,9,7,16
46,8479718,Alex Barré-Boulet,C,MTL,27,53,9,7,16
46,8480281,Alexey Toropchenko,R,STL,25,55,9,7,16
46,8477450,Jason Dickinson,C,CHI,29,51,8,8,16
46,8478013,Jake Walman,D,SJS,28,70,6,10,16
46,8482062,Cole Smith,L,NSH,29,67,6,10,16
46,8476879,Cody Ceci,D,EDM,31,61,5,11,16
46,8480448,Parker Kelly,L,COL,25,78,5,11,16
46,8480807,Mattias Samuelsson,D,BUF,24,59,5,11,16
46,8478840,Will Borgen,D,SEA,28,61,4,12,16
46,8470600,Ryan Suter,D,STL,39,52,4,12,16
46,8475233,David Savard,D,MTL,34,62,3,13,16
46,8480222,Sebastian Aho,D,PIT,28,74,3,13,16
46,8477499,Rasmus Ristolainen,D,PHI,30,60,2,14,16
46,8475225,Craig Smith,C,CHI,35,38,2,14,16
46,8478851,Alexandre Carrier,D,NSH,28,62,1,15,16
46,8479324,Ryan Lindgren,D,NYR,26,57,1,15,16
46,8478508,Yakov Trenin,C,MIN,27,55,11,4,15
46,8479370,Tyson Jost,C,CAR,26,41,8,7,15
46,8480806,Isac Lundestrom,C,ANA,25,57,7,8,15
46,8479359,Beck Malenstyn,L,BUF,26,50,6,9,15
46,8476889,Radek Faksa,C,STL,30,61,5,10,15
46,8476422,Mike Reilly,D,NYI,31,75,5,10,15
46,8483491,Ivan Miroshnichenko,L,WSH,20,58,5,10,15
46,8476994,Vinnie Hinostroza,C,NSH,30,46,4,11,15
46,8479976,Juuso Valimaki,D,UTA,26,67,4,11,15
46,8482624,Daniil Miromanov,D,CGY,27,63,4,11,15
46,8481708,Zac Jones,D,NYR,24,53,4,11,15
46,8479371,Dante Fabbro,D,NSH,26,67,3,12,15
46,8474013,Ian Cole,D,UTA,35,53,3,12,15
46,8479372,Joshua Mahura,D,SEA,26,56,1,14,15
46,8479344,Jesse Puljujarvi,R,PIT,26,54,10,4,14
46,8479316,Luke Kunin,C,SJS,27,45,9,5,14
46,8481028,Martin Pospisil,C,CGY,25,54,9,5,14
46,8480074,Alexandre Texier,C,STL,25,53,8,6,14
46,8482762,Simon Edvinsson,D,DET,21,61,8,6,14
46,8480025,MacKenzie Entwistle,R,FLA,25,65,7,7,14
46,8481527,Kaedan Korczak,D,VGK,23,47,7,7,14
46,8480441,Trey Fix-Wolansky,R,CBJ,25,43,7,7,14
46,8477018,Ben Hutton,D,VGK,31,48,7,7,14
46,8480011,Klim Kostin,C,SJS,25,45,6,8,14
46,8483495,Simon Nemec,D,NJD,20,60,5,9,14
46,8476442,Matt Nieto,L,PIT,32,46,5,9,14
46,8480246,Nick Perbix,D,TBL,26,76,4,10,14
46,8475279,Ben Chiarot,D,DET,33,60,3,11,14
46,8481178,Egor Zamula,D,PHI,24,53,3,11,14
46,8475750,Jon Merrill,D,MIN,32,54,3,11,14
46,8480950,Ilya Lyubushkin,D,DAL,30,64,2,12,14
46,8482087,Kaiden Guhle,D,MTL,22,71,1,13,14
46,8482155,Alex Laferriere,R,LAK,23,63,10,3,13
46,8478569,Noel Acciari,C,PIT,33,53,7,6,13
46,8477931,Tomas Nosek,L,FLA,32,62,7,6,13
46,8481592,Jakob Pelletier,L,CGY,23,42,6,7,13
46,8479336,Carl Grundstrom,R,SJS,27,48,6,7,13
46,8476934,Brock McGinn,L,ANA,30,52,6,7,13
46,8481532,Alex Turcotte,C,LAK,23,46,6,7,13
46,8483482,Tristan Luneau,D,ANA,20,53,5,8,13
46,8481522,Peyton Krebs,C,BUF,23,58,5,8,13
46,8480845,Rasmus Kupari,C,WPG,24,43,5,8,13
46,8478421,A.J. Greer,L,FLA,28,56,5,8,13
46,8482634,Alex Steeves,C,TOR,25,41,5,8,13
46,8482964,Arber Xhekaj,D,MTL,23,47,5,8,13
46,8482737,Zack Bolduc,C,STL,21,60,3,10,13
46,8477435,Ryan Graves,D,PIT,29,69,3,10,13
46,8480796,Martin Fehervary,D,WSH,25,46,3,10,13
46,8480192,Johnathan Kovacevic,D,NJD,27,48,3,10,13
46,8477034,Jaycob Megna,D,FLA,32,46,3,10,13
46,8481537,Nikita Okhotiuk,D,CGY,24,52,2,11,13
46,8474567,Zach Bogosian,D,MIN,34,59,2,11,13
46,8475181,Nick Leddy,D,STL,33,70,2,11,13
46,8477365,Connor Clifton,D,BUF,29,52,2,11,13
46,8480887,Jordan Harris,D,MTL,24,50,2,11,13
46,8480196,Jacob Bryson,D,BUF,27,38,2,11,13
46,8482659,Josh Doan,R,UTA,22,49,8,4,12
46,8479772,Zack MacEwen,R,OTT,28,54,7,5,12
46,8477962,Brendan Lemieux,L,CAR,28,48,6,6,12
46,8482166,Shakir Mukhamadullin,D,SJS,22,57,6,6,12
46,8482077,Dylan Holloway,L,EDM,23,53,6,6,12
46,8481161,Jake Christiansen,D,CBJ,25,63,6,6,12
46,8481789,Tye Kartye,L,SEA,23,36,6,6,12
46,8482807,Ethan Del Mastro,D,CHI,21,60,5,7,12
46,8477573,Nathan Walker,L,STL,30,49,4,8,12
46,8478859,Niko Mikkola,D,FLA,28,45,4,8,12
46,8478585,Derek Ryan,C,EDM,38,57,4,8,12
46,8480001,Urho Vaakanainen,D,ANA,25,54,2,10,12
46,8477851,Jordan Oesterle,D,BOS,32,45,2,10,12
46,8479348,Kale Clague,D,BUF,26,44,2,10,12
46,8482192,Isaak Phillips,D,CHI,23,47,1,11,12
46,8474568,Luke Schenn,D,NSH,35,51,1,11,12
46,8483466,Kevin Korchinski,D,CHI,20,48,1,11,12
46,8480070,Ian Mitchell,D,BOS,25,46,1,11,12
46,8482713,Mackie Samoskevich,R,FLA,22,40,7,4,11
46,8482157,Will Cuylle,L,NYR,22,65,6,5,11
46,8481518,Nolan Foote,L,NJD,24,45,6,5,11
46,8477482,Zachary Sanford,L,CHI,30,44,6,5,11
46,8477938,Haydn Fleury,D,WPG,28,53,5,6,11
46,8479328,Julien Gauthier,R,NYI,27,54,5,6,11
46,8481598,Philip Broberg,D,EDM,23,45,4,7,11
46,8482730,Brandt Clarke,D,LAK,21,48,3,8,11
46,8480879,Jacob Bernard-Docker,D,OTT,24,43,3,8,11
46,8481599,Victor Soderstrom,D,UTA,23,44,2,9,11
46,8481550,Adam Beckman,L,NJD,23,35,2,9,11
46,8482095,Tyler Kleven,D,OTT,22,44,2,9,11
46,8480058,Pierre-Olivier Joseph,D,STL,25,53,1,10,11
46,8475177,Calvin de Haan,D,COL,33,43,1,10,11
46,8475208,Brian Dumoulin,D,ANA,33,62,0,11,11
46,8476874,Olli Maatta,D,DET,30,61,0,11,11
46,8480355,Mark Kastelic,C,BOS,25,61,7,3,10
46,8479066,Ryan Lomberg,L,CGY,30,63,5,5,10
46,8479671,Mathieu Olivier,R,CBJ,27,46,5,5,10
46,8484911,Collin Graf,R,SJS,22,39,5,5,10
46,8479543,Michael Pezzetta,L,MTL,26,53,4,6,10
46,8477887,Patrick Brown,C,BOS,32,41,4,6,10
46,8482744,James Malatesta,L,CBJ,21,41,4,6,10
46,8481609,Vladislav Kolyachonok,D,UTA,23,34,4,6,10
46,8482176,Wyatt Kaiser,D,CHI,22,55,3,7,10
46,8475718,Justin Holl,D,DET,32,63,3,7,10
46,8474612,Travis Hamonic,D,OTT,34,49,2,8,10
46,8475455,Brenden Dillon,D,NJD,34,56,1,9,10
46,8471677,Jack Johnson,D,CBJ,37,64,1,9,10
46,8478831,Kevin Stenlund,C,UTA,28,46,6,3,9
46,8479638,Justin Brazeau,R,BOS,26,32,6,3,9
46,8481716,Dmitri Voronkov,L,CBJ,24,43,5,4,9
46,8480870,Bo Groulx,C,NYR,24,32,5,4,9
46,8476822,Luke Glendening,C,TBL,35,78,4,5,9
46,8482859,Zack Ostapchuk,C,OTT,21,49,4,5,9
46,8476913,Devin Shore,C,MIN,30,37,4,5,9
46,8482451,Mikael Pyyhtia,L,CBJ,23,39,3,6,9
46,8477335,Kyle Burroughs,D,LAK,29,41,3,6,9
46,8474090,Brendan Smith,D,DAL,35,56,2,7,9
46,8478443,Brandon Carlo,D,BOS,28,58,2,7,9
46,8476967,Brett Kulak,D,EDM,30,63,1,8,9
46,8479369,Andrew Peeke,D,BOS,26,58,1,8,9
46,8482861,Vincent Iorio,D,WSH,22,39,1,8,9
46,8478416,Erik Cernak,D,TBL,27,68,0,9,9
46,8481701,Santeri Hatakka,D,NJD,23,42,6,2,8
46,8476858,Phillip Di Giuseppe,L,VAN,31,34,4,4,8
46,8483460,David Jiricek,D,CBJ,21,52,4,4,8
46,8483619,Filip Roos,D,OTT,25,34,4,4,8
46,8481013,Jonatan Berggren,R,DET,24,58,3,5,8
46,8478409,Anthony Richard,C,PHI,28,28,3,5,8
46,8476867,Brendan Gaunce,C,MIN,30,32,3,5,8
46,8482747,Brennan Othmann,L,NYR,21,40,3,5,8
46,8476457,Adam Larsson,D,SEA,32,74,2,6,8
46,8481122,Simon Benoit,D,TOR,26,40,2,6,8
46,8479994,Jaret Anderson-Dolan,C,WPG,25,31,2,6,8
46,8483549,Lucas Condotta,L,MTL,27,34,2,6,8
46,8481751,Lukas Rousek,R,BUF,25,34,1,7,8
46,8482141,Lukas Cormier,D,VGK,22,23,1,7,8
46,8478468,Jeremy Lauzon,D,NSH,27,46,1,7,8
46,8478017,Mark Friedman,D,VAN,29,45,1,7,8
46,8482496,Nils Aman,C,VAN,24,47,1,7,8
46,8473446,Erik Johnson,D,PHI,36,44,0,8,8
46,8477384,Joshua Brown,D,EDM,30,50,0,8,8
46,8480844,Grigori Denisenko,L,VGK,24,30,7,0,7
46,8479968,Vinni Lettieri,C,BOS,29,46,6,1,7
46,8479981,Jonah Gadjovich,L,FLA,26,46,6,1,7
46,8481617,Vasily Podkolzin,R,VAN,23,37,4,3,7
46,8482070,Mitchell Chaffee,R,TBL,26,49,4,3,7
46,8478424,Jansen Harkins,C,ANA,27,41,3,4,7
46,8476441,Joel Edmundson,D,LAK,31,38,2,5,7
46,8483763,Maksymilian Szuber,D,UTA,22,30,2,5,7
46,8479536,Axel Jonsson-Fjallby,L,WPG,26,33,2,5,7
46,8479972,Mason Shaw,C,WPG,26,33,2,5,7
46,8479442,Troy Stecher,D,EDM,30,52,2,5,7
46,8475762,Derek Forbort,D,VAN,32,40,2,5,7
46,8482177,Marat Khusnutdinov,C,MIN,22,33,2,5,7
46,8484254,Akito Hirose,D,VAN,25,35,1,6,7
46,8481567,Henry Thrun,D,SJS,23,42,1,6,7
46,8482784,Zach Dean,C,STL,21,47,1,6,7
46,8480007,Jonas Rondbjerg,R,VGK,25,39,1,6,7
46,8478450,Parker Wotherspoon,D,BOS,27,35,0,7,7
46,8476952,Dominic Toninato,C,WPG,30,46,0,7,7
46,8478454,Noah Juulsen,D,VAN,27,30,0,7,7
46,8483570,Ben Meyers,C,SEA,26,26,4,2,6
46,8479379,Givani Smith,R,SJS,26,38,4,2,6
46,8482666,Scott Morrow,D,CAR,22,43,3,3,6
46,8481679,Maxence Guenette,D,OTT,23,39,3,3,6
46,8480245,Olle Lycksell,R,PHI,25,33,3,3,6
46,8482172,Landon Slaggert,L,CHI,22,25,3,3,6
46,8483395,Arshdeep Bains,L,VAN,23,16,3,3,6
46,8477070,Liam O'Brien,C,UTA,30,56,2,4,6
46,8476473,Connor Murphy,D,CHI,31,37,2,4,6
46,8479944,Zach Aston-Reese,C,VGK,30,54,2,4,6
46,8482145,Mavrik Bourque,C,DAL,22,54,2,4,6
46,8477462,Robert Hagg,D,VGK,29,25,2,4,6
46,8482511,Mason Lohrei,D,BOS,23,37,2,4,6
46,8479986,Kole Lind,R,DAL,26,48,2,4,6
46,8471817,Ryan Reaves,R,TOR,37,52,1,5,6
46,8482250,Callahan Burke,C,VGK,27,22,1,5,6
46,8476372,Nick Seeler,D,PHI,31,38,0,6,6
46,8481556,John Beecher,C,BOS,23,33,5,0,5
46,8479985,Cale Fleury,D,SEA,26,33,4,1,5
46,8478477,Mitchell Stephens,C,SEA,27,25,4,1,5
46,8481043,Cole Koepke,L,BOS,26,16,4,1,5
46,8475235,Nicolas Deslauriers,L,PHI,33,55,3,2,5
46,8483012,Logan Morrison,C,SEA,22,27,3,2,5
46,8484287,Cole McWard,D,VAN,23,22,3,2,5
46,8480292,Carson Meyer,R,ANA,27,27,3,2,5
46,8481147,Reese Johnson,C,MIN,26,39,2,3,5
46,8479378,Logan Stanley,D,WPG,26,37,2,3,5
46,8477527,Ross Johnston,L,ANA,30,30,2,3,5
46,8478874,Adam Gaudette,R,OTT,28,41,2,3,5
46,8480990,Declan Chisholm,D,MIN,24,45,2,3,5
46,8482201,Gage Goncalves,C,TBL,23,28,2,3,5
46,8477971,Andreas Englund,D,LAK,28,27,2,3,5
46,8483397,Marc McLaughlin,C,BOS,25,35,2,3,5
46,8478021,William Lagesson,D,DET,28,28,1,4,5
46,8482733,Logan Mailloux,D,MTL,31,33,1,4,5
46,8482765,Isak Rosen,R,BUF,21,32,1,4,5
46,8482516,Matthew Kessel,D,STL,24,15,1,4,5
46,8481541,Samuel Bolduc,D,NYI,24,23,1,4,5
46,8477244,Chad Ruhwedel,D,NYR,34,36,0,5,5
46,8482751,Ryan Winterton,C,SEA,21,33,3,1,4
46,8481719,Maxwell Crozier,D,TBL,24,24,3,1,4
46,8479362,Riley Tufte,L,BOS,26,19,3,1,4
46,8478146,Matthew Highmore,C,OTT,28,27,2,2,4
46,8481754,Nikita Nesterenko,C,ANA,23,34,2,2,4
46,8482652,Walker Duehr,R,CGY,27,28,2,2,4
46,8481593,Jayden Struble,D,MTL,23,20,2,2,4
46,8480880,Jakub Lauko,C,MIN,24,25,2,2,4
46,8482088,Justin Sourdif,R,FLA,22,22,1,3,4
46,8482165,Yan Kuznetsov,D,CGY,22,21,1,3,4
46,8481237,Kyle MacLean,C,NYI,25,24,0,4,4
46,8481167,Brayden Pachal,D,CGY,25,37,0,4,4
46,8481600,Tobias Bjornfot,D,FLA,23,38,0,4,4
46,8481605,Jackson LaCombe,D,ANA,23,33,0,4,4
46,8482470,Ilya Solovyov,D,CGY,24,20,0,4,4
46,8482061,Brandon Biro,L,SEA,26,19,3,0,3
46,8480468,James Hamblin,L,EDM,25,19,3,0,3
46,8481543,Nikita Alexandrov,C,STL,24,22,2,1,3
46,8477473,Justin Bailey,R,SJS,29,21,2,1,3
46,8479320,Maxime Lajoie,D,SEA,27,27,2,1,3
46,8480267,Sammy Walker,C,MIN,25,20,2,1,3
46,8481422,Jake Lucchini,C,NSH,29,23,2,1,3
46,8475795,Dylan McIlrath,D,WSH,32,17,2,1,3
46,8479576,Vincent Desharnais,D,VAN,28,37,1,2,3
46,8483630,Pavol Regenda,L,ANA,25,25,1,2,3
46,8480890,Jan Jenik,C,OTT,24,28,1,2,3
46,8478881,Brett Seney,L,CHI,28,13,1,2,3
46,8483567,Georgii Merkulov,C,BOS,24,10,1,2,3
46,8479419,Brett Murray,L,BUF,26,21,1,2,3
46,8484304,Uvis Balinskis,D,FLA,28,13,1,2,3
46,8481056,Spencer Stastney,D,NSH,24,30,0,3,3
46,8479991,Jake Leschyshyn,C,NYR,25,28,0,3,3
46,8479587,Rhett Gardner,C,PHI,28,20,0,3,3
46,8477320,Anton Blidh,L,NYR,29,19,0,3,3
46,8481206,John Ludvig,D,PIT,24,13,0,3,3
46,8482858,Ryker Evans,D,SEA,23,24,0,3,3
46,8482929,Emil Lilleberg,D,TBL,23,22,0,3,3
46,8475755,Alexander Petrovic,D,DAL,32,8,0,3,3
46,8477401,John Hayden,C,SEA,29,29,2,0,2
46,8479367,William Lockwood,R,FLA,26,19,2,0,2
46,8482094,Daemon Hunt,D,MIN,22,13,2,0,2
46,8482162,Roby Jarventie,L,EDM,22,20,2,0,2
46,8480851,Akil Thomas,C,LAK,24,17,2,0,2
46,8482153,Brendan Brisson,C,VGK,23,21,1,1,2
46,8484258,Sam Malinski,D,COL,26,18,1,1,2
46,8475413,Justin Dowling,C,NJD,34,19,1,1,2
46,8481806,Louis Crevier,D,CHI,23,14,0,2,2
46,8477810,Joel Hanley,D,CGY,33,24,0,2,2
46,8481743,Marc Del Gaizo,D,NSH,25,22,0,2,2
46,8483512,Matthew Savoie,C,EDM,20,23,0,2,2
46,8482118,Sam Colangelo,R,ANA,23,17,0,2,2
46,8481065,Angus Crookshank,L,OTT,25,17,0,2,2
46,8483609,Adam Klapka,R,CGY,24,7,0,2,2
46,8475958,Michael Sgarbossa,C,WSH,32,24,1,0,1
46,8482147,Jean-Luc Foudy,C,COL,22,27,1,0,1
46,8482102,Vasily Ponomarev,C,PIT,22,15,1,0,1
46,8478051,Max Willman,C,NJD,29,14,1,0,1
46,8482787,Nikita Chibrikov,R,WPG,31,6,1,0,1
46,8480032,Shane Bowers,C,NJD,25,13,1,0,1
46,8483597,Milos Kelemen,L,UTA,25,14,1,0,1
46,8483489,Fraser Minten,C,TOR,31,10,1,0,1
46,8481030,Jack St. Ivany,D,PIT,25,23,1,0,1
46,8481578,Graeme Clarke,R,MIN,23,7,1,0,1
46,8480874,Adam Ginning,D,PHI,24,8,1,0,1
46,8480075,Cameron Crotty,D,MIN,25,11,1,0,1
46,8478147,Bokondji Imama,L,PIT,28,8,1,0,1
46,8480834,Ty Emberson,D,SJS,24,35,0,1,1
46,8481699,Aku Raty,R,UTA,23,17,0,1,1
46,8482144,Jack Thompson,D,SJS,22,27,0,1,1
46,8477073,Kurtis MacDermid,L,NJD,30,31,0,1,1
46,8481585,Egor Afanasyev,L,SJS,23,13,0,1,1
46,8478011,Louie Belpedio,D,PHI,28,10,0,1,1
46,8483546,Marshall Rifai,D,TOR,26,4,0,1,1
46,8478502,Dennis Gilbert,D,BUF,28,15,0,1,1
46,8479330,Brandon Gignac,C,MTL,27,10,0,1,1
46,8474062,Riley Nash,C,NYR,35,17,0,1,1
46,8483471,Brad Lambert,C,WPG,31,11,0,1,1
46,8482476,Emil Heineman,L,MTL,23,8,0,1,1
46,8476323,Max McCormick,L,SEA,32,4,0,1,1
46,8481564,Ryan Johnson,D,BUF,23,10,0,0,0
46,8478446,Glenn Gawdin,C,LAK,27,12,0,0,0
46,8484325,Waltteri Merela,C,TBL,26,19,0,0,0
46,8480306,Grant Hutton,D,NYI,29,6,0,0,0
46,8477149,Scott Sabourin,R,SJS,32,14,0,0,0
46,8480823,Alexander Alexeyev,D,WSH,25,9,0,0,0
46,8477541,Dakota Mermis,D,TOR,30,6,0,0,0
46,8482460,Matt Rempe,C,NYR,22,10,0,0,0
46,8477467,Gustav Olofsson,D,SEA,30,13,0,0,0
46,8481006,Tyler Tucker,D,STL,24,14,0,0,0
46,8483407,Brandon Scanlin,D,NYR,25,11,0,0,0
46,8480084,Nick DeSimone,D,NJD,30,13,0,0,0
46,8475780,Chris Wagner,R,COL,33,10,0,0,0
46,8479421,Jacob Moverare,D,LAK,26,7,0,0,0
46,8481024,Linus Karlsson,C,VAN,25,7,0,0,0
46,8483432,Luca Del Bel Belluz,C,CBJ,31,3,0,0,0
46,8482197,Adam Raska,R,MIN,23,6,0,0,0
46,8483401,Marc Johnstone,R,PIT,28,2,0,0,0
46,8483920,Pierrick Dube,R,WSH,23,4,0,0,0
46,8481462,Mason Morelli,L,VGK,28,7,0,0,0
46,8484326,Patrik Koch,D,UTA,28,1,0,0,0
46,8484255,Jason Polin,R,COL,25,4,0,0,0
46,8477993,Justin Kirkland,C,CGY,28,8,0,0,0
46,8479522,Hardy Haman Aktell,D,WSH,26,3,0,0,0
46,8478854,Ryan Shea,D,PIT,27,7,0,0,0
46,8482126,Emil Andrae,D,PHI,31,2,0,0,0
46,8484259,Ondrej Pavel,C,COL,31,2,0,0,0
46,8484321,Nikolas Matinpalo,D,OTT,26,2,0,0,0
46,8483398,Declan Carlile,D,TBL,31,6,0,0,0
46,8481726,Adam Edstrom,C,NYR,24,7,0,0,0
46,8481655,Cole Schwindt,R,CGY,23,3,0,0,0
46,8483531,Brian Halonen,L,NJD,25,1,0,0,0
46,8481534,Raphael Lavoie,C,EDM,24,4,0,0,0
46,8483045,Cameron Butler,R,CBJ,31,1,0,0,0
46,8478956,Samuel Laberge,L,NJD,27,0,0,0,0
46,8480274,Philip Kemp,D,EDM,25,0,0,0,0
46,8470794,Joe Pavelski,C,,40,0,0,0,0
46,8479321,Lucas Johansen,D,,27,0,0,0,0
46,8477950,Tony DeAngelo,D,,29,0,0,0,0
46,8471218,Blake Wheeler,R,,38,0,0,0,0
46,8475197,Tyson Barrie,D,,33,0,0,0,0
46,8474157,Max Pacioretty,L,,36,0,0,0,0
46,8475744,Evgeny Kuznetsov,C,,32,0,0,0,0
46,8474037,James van Riemsdyk,L,,35,0,0,0,0
46,8476907,Mackenzie MacEachern,L,,30,0,0,0,0
46,8480216,Jacob Peterson,C,,25,0,0,0,0
46,8474602,Justin Schultz,D,,34,0,0,0,0
46,8482222,Alexander Barabanov,L,,30,0,0,0,0
46,8474031,Kevin Shattenkirk,D,,35,0,0,0,0
46,8477330,Dominik Kubalik,L,,29,0,0,0,0
46,8480884,Calen Addison,D,,24,0,0,0,0
46,8475906,John Klingberg,D,,32,0,0,0,0
46,8480008,Adam Ruzicka,C,,25,0,0,0,0
46,8476884,Derrick Pouliot,D,,30,0,0,0,0
46,8476919,Chris Tierney,C,,30,0,0,0,0
46,8479415,Michael McLeod,C,,26,0,0,0,0
46,8474870,Tyler Johnson,C,,34,0,0,0,0
46,8470604,Jeff Carter,C,,39,0,0,0,0
46,8478104,Sammy Blais,L,,28,0,0,0,0
46,8474884,Mike Hoffman,C,,35,0,0,0,0
46,8481591,Sam Poulin,R,,23,0,0,0,0
46,8471274,Alex Goligoski,D,,39,0,0,0,0
46,8476871,Tanner Pearson,L,,32,0,0,0,0
46,8476393,Nick Cousins,C,,31,0,0,0,0
46,8479977,Kailer Yamamoto,R,,26,0,0,0,0
46,8479346,Dillon Dube,C,,26,0,0,0,0
46,8480184,Gustav Lindstrom,D,,26,0,0,0,0
46,8479376,Victor Mete,D,,26,0,0,0,0
46,8473449,Kyle Okposo,R,,36,0,0,0,0
46,8481058,Jesse Ylonen,R,,25,0,0,0,0
46,8475752,Tyler Pitlick,C,,33,0,0,0,0
46,8481239,Samuel Fagemo,L,,24,0,0,0,0
46,8480821,Filip Zadina,R,,25,0,0,0,0
46,8470966,Mark Giordano,D,,41,0,0,0,0
46,8478495,Denis Gurianov,R,,27,0,0,0,0
46,8477464,Nic Petan,C,,29,0,0,0,0
46,8478099,Kevin Labanc,R,,29,0,0,0,0
46,8482241,Radim Zohorna,L,,28,0,0,0,0
46,8474040,Sam Gagner,C,,35,0,0,0,0
46,8479514,Rem Pitlick,C,,27,0,0,0,0
46,8478430,Oliver Kylington,D,,27,0,0,0,0
46,8479533,Joona Koppanen,L,,26,0,0,0,0
46,8479984,Cal Foote,D,,26,0,0,0,0
46,8477126,Jayson Megna,C,,34,0,0,0,0
46,8475164,Jakob Silfverberg,R,,34,0,0,0,0
46,8474009,Nick Bonino,C,,36,0,0,0,0
46,8479458,Nikita Zaitsev,D,,33,0,0,0,0
46,8477944,Jakub Vrana,L,,28,0,0,0,0
46,8471699,Andrew Cogliano,C,,37,0,0,0,0
46,8478067,Oskar Lindblom,L,,28,0,0,0,0
46,8471686,Marc Staal,D,,37,0,0,0,0
46,8470610,Zach Parise,L,,40,0,0,0,0
46,8478904,Steven Lorentz,C,,28,0,0,0,0
46,8473473,Milan Lucic,L,,36,0,0,0,0
46,8480031,Maxime Comtois,L,,25,0,0,0,0
46,8478512,Austin Czarnik,C,,32,0,0,0,0
46,8473504,Cal Clutterbuck,R,,37,0,0,0,0
46,8477454,Adam Erne,L,,29,0,0,0,0
46,8479383,Boris Katchouk,L,,26,0,0,0,0
46,8475825,Jani Hakanpää,D,,32,0,0,0,0
46,8477846,Ryan Carpenter,C,,33,0,0,0,0
46,8477930,Pierre-Edouard Bellemare,L,,39,0,0,0,0
46,8478400,Colin White,C,,27,0,0,0,0
46,8480226,Marián Studenic,R,,26,0,0,0,0
46,8480853,Liam Foudy,C,,24,0,0,0,0
46,8475797,Jarred Tinordi,D,,32,0,0,0,0
46,8479423,Alex Nylander,L,,26,0,0,0,0
46,8474618,Marco Scandella,D,,34,0,0,0,0
46,8478028,Fredrik Olofsson,L,,28,0,0,0,0
46,8474709,Matt Martin,L,,35,0,0,0,0
46,8481070,Hugh McGing,L,,26,0,0,0,0
46,8479546,Oskar Steen,C,,26,0,0,0,0
46,8474145,Robert Bortuzzo,D,,35,0,0,0,0
46,8476915,Jujhar Khaira,L,,30,0,0,0,0
46,8475278,Byron Froese,C,,33,0,0,0,0
46,8481812,Nikolai Knyzhov,D,,27,0,0,0,0
46,8478408,Travis Dermott,D,,28,0,0,0,0
46,8481077,John Leonard,L,,26,0,0,0,0
46,8479547,Matthew Phillips,R,,26,0,0,0,0
46,8480836,Jonathan Gruden,C,,24,0,0,0,0
46,8481690,Tyler Angle,C,,24,0,0,0,0
46,8475766,Austin Watson,L,,32,0,0,0,0
46,8481016,Ruslan Iskhakov,C,,24,0,0,0,0
46,8478078,Rourke Chartier,C,,28,0,0,0,0
46,8480776,Sheldon Rempal,R,,29,0,0,0,0
46,8484314,Jiri Smejkal,L,,28,0,0,0,0
47,8476453,Nikita Kucherov,R,TBL,31,82,53,95,148
47,8477492,Nathan MacKinnon,C,COL,29,82,54,91,145
47,8478402,Connor McDavid,C,EDM,27,75,40,90,130
47,8477934,Leon Draisaitl,C,EDM,29,81,43,84,127
47,8478483,Mitch Marner,R,TOR,27,80,43,82,125
47,8478420,Mikko Rantanen,R,COL,28,81,62,61,123
47,8479314,Matthew Tkachuk,L,FLA,27,79,32,89,121
47,8478550,Artemi Panarin,L,NYR,33,81,40,79,119
47,8479318,Auston Matthews,C,TOR,27,79,68,50,118
47,8477956,David Pastrnak,R,BOS,28,77,56,62,118
47,8477493,Aleksander Barkov,C,FLA,29,78,39,78,117
47,8477404,Jake Guentzel,C,TBL,30,82,48,66,114
47,8481559,Jack Hughes,C,NJD,23,77,40,64,104
47,8478864,Kirill Kaprizov,L,MIN,27,75,43,60,103
47,8480027,Jason Robertson,L,DAL,25,80,39,58,97
47,8474564,Steven Stamkos,C,NSH,34,78,50,45,95
47,8478403,Jack Eichel,C,VGK,28,79,46,49,95
47,8476887,Filip Forsberg,L,NSH,30,71,46,48,94
47,8477939,William Nylander,R,TOR,28,76,42,52,94
47,8480012,Elias Pettersson,C,VAN,26,74,27,67,94
47,8476468,J.T. Miller,C,VAN,31,75,35,58,93
47,8484144,Connor Bedard,C,CHI,19,72,34,59,93
47,8477960,Adrian Kempe,R,LAK,28,81,46,44,90
47,8477942,Kevin Fiala,L,LAK,28,81,28,62,90
47,8480801,Brady Tkachuk,L,OTT,25,82,47,42,89
47,8475786,Zach Hyman,L,EDM,32,78,46,43,89
47,8478010,Brayden Point,C,TBL,28,82,41,48,89
47,8474600,Roman Josi,D,NSH,34,73,19,70,89
47,8471675,Sidney Crosby,C,PIT,37,75,37,51,88
47,8480069,Cale Makar,D,COL,26,67,16,72,88
47,8478445,Mathew Barzal,C,NYI,27,81,27,60,87
47,8477946,Dylan Larkin,C,DET,28,81,46,40,86
47,8478439,Travis Konecny,R,PHI,27,80,32,54,86
47,8480023,Robert Thomas,C,STL,25,78,30,56,86
47,8476456,Jonathan Huberdeau,C,CGY,31,80,20,64,84
47,8482116,Tim Stützle,C,OTT,22,79,30,53,83
47,8479542,Brandon Hagel,L,TBL,26,82,43,39,82
47,8477933,Sam Reinhart,C,FLA,29,77,42,40,82
47,8479385,Jordan Kyrou,C,STL,26,74,34,48,82
47,8478460,Zach Werenski,D,CBJ,27,79,22,59,81
47,8475754,Brock Nelson,C,NYI,33,77,33,47,80
47,8474578,Erik Karlsson,D,PIT,34,82,21,59,80
47,8479407,Jesper Bratt,L,NJD,26,76,32,47,79
47,8480800,Quinn Hughes,D,VAN,25,77,21,58,79
47,8476539,Jonathan Marchessault,R,NSH,34,72,39,39,78
47,8473419,Brad Marchand,L,BOS,36,80,32,46,78
47,8480036,Miro Heiskanen,D,DAL,25,80,19,59,78
47,8477501,Valeri Nichushkin,R,COL,29,82,34,43,77
47,8477500,Bo Horvat,C,NYI,29,80,34,43,77
47,8477951,Nick Schmaltz,C,UTA,28,79,25,52,77
47,8482124,Quinton Byfield,R,LAK,22,79,25,52,77
47,8478398,Kyle Connor,L,WPG,28,74,34,42,76
47,8474141,Patrick Kane,R,DET,36,80,25,51,76
47,8482740,Wyatt Johnston,C,DAL,21,82,35,40,75
47,8475166,John Tavares,C,TOR,34,78,33,42,75
47,8479999,Casey Mittelstadt,C,COL,26,82,22,53,75
47,8475810,Bryan Rust,R,PIT,32,71,38,36,74
47,8478449,Roope Hintz,C,DAL,28,81,34,40,74
47,8478427,Sebastian Aho,C,CAR,27,69,32,42,74
47,8475913,Mark Stone,R,VGK,32,69,27,47,74
47,8476454,Ryan Nugent-Hopkins,C,EDM,31,80,22,52,74
47,8476459,Mika Zibanejad,C,NYR,31,76,21,53,74
47,8479337,Alex DeBrincat,R,DET,27,80,29,44,73
47,8482078,Lucas Raymond,L,DET,22,80,26,47,73
47,8479323,Adam Fox,D,NYR,26,74,10,63,73
47,8475172,Nazem Kadri,C,CGY,34,77,29,43,72
47,8480865,Noah Dobson,D,NYI,24,75,13,59,72
47,8478444,Brock Boeser,R,VAN,27,78,35,36,71
47,8475765,Vladimir Tarasenko,R,DET,33,81,22,49,71
47,8475692,Mats Zuccarello,R,MIN,37,71,18,53,71
47,8479343,Clayton Keller,R,UTA,26,74,26,44,70
47,8476389,Vincent Trocheck,C,NYR,31,79,24,46,70
47,8478401,Pavel Zacha,C,BOS,27,79,24,46,70
47,8481557,Matt Boldy,L,MIN,23,71,35,34,69
47,8476460,Mark Scheifele,C,WPG,31,72,34,35,69
47,8476346,Johnny Gaudreau,L,CBJ,31,75,25,44,69
47,8477496,Elias Lindholm,C,BOS,30,75,23,46,69
47,8475167,Victor Hedman,D,TBL,34,79,15,54,69
47,8475184,Chris Kreider,L,NYR,33,77,45,22,67
47,8480830,Andrei Svechnikov,R,CAR,24,77,27,40,67
47,8476448,William Karlsson,C,VGK,31,79,26,41,67
47,8480002,Nico Hischier,C,NJD,25,74,23,44,67
47,8475168,Matt Duchene,C,DAL,33,81,29,37,66
47,8482093,Seth Jarvis,C,CAR,22,71,27,39,66
47,8477416,Oliver Bjorkstrand,R,SEA,29,74,26,40,66
47,8476881,Tomas Hertl,C,VGK,31,80,23,43,66
47,8480839,Rasmus Dahlin,D,BUF,24,71,20,46,66
47,8480018,Nick Suzuki,C,MTL,25,72,17,49,66
47,8476853,Morgan Rielly,D,TOR,30,76,16,50,66
47,8473512,Claude Giroux,R,OTT,36,81,28,37,65
47,8475784,Jeff Skinner,C,EDM,32,78,27,38,65
47,8477409,Carter Verhaeghe,C,FLA,29,81,26,39,65
47,8475745,Charlie Coyle,C,BOS,32,80,25,40,65
47,8477402,Pavel Buchnevich,L,STL,29,76,24,41,65
47,8477949,Alex Tuch,R,BUF,28,67,20,45,65
47,8478975,Mason Marchment,L,DAL,29,81,32,32,64
47,8476432,Boone Jenner,C,CBJ,31,73,32,32,64
47,8479420,Tage Thompson,C,BUF,27,73,32,31,63
47,8478493,Joel Eriksson Ek,C,MIN,27,67,27,36,63
47,8477940,Nikolaj Ehlers,L,WPG,28,75,21,42,63
47,8474102,David Perron,L,OTT,36,77,20,43,63
47,8484153,Leo Carlsson,C,ANA,20,72,31,31,62
47,8471214,Alex Ovechkin,L,WSH,39,74,30,32,62
47,8482159,Tyson Foerster,R,PHI,22,77,28,34,62
47,8481540,Cole Caufield,R,MTL,23,77,29,32,61
47,8481528,Dylan Cozens,C,BUF,23,72,26,35,61
47,8476479,Phillip Danault,C,LAK,31,79,25,36,61
47,8477407,Anthony Duclair,L,NYI,29,74,24,37,61
47,8477504,Josh Morrissey,D,WPG,29,72,14,47,61
47,8475191,Reilly Smith,R,NYR,33,73,31,29,60
47,8471215,Evgeni Malkin,C,PIT,38,74,24,36,60
47,8478519,Anthony Cirelli,C,TBL,27,80,21,39,60
47,8477497,Sean Monahan,C,CBJ,30,72,25,34,59
47,8483431,Logan Cooley,C,UTA,20,75,25,34,59
47,8480188,Fabian Zetterlund,L,SJS,25,72,24,35,59
47,8477494,Jonathan Drouin,L,COL,29,80,19,40,59
47,8471724,Kris Letang,D,PIT,37,82,17,42,59
47,8478414,Timo Meier,R,NJD,28,74,31,27,58
47,8480208,Drake Batherson,R,OTT,26,80,22,36,58
47,8471685,Anze Kopitar,C,LAK,37,82,21,37,58
47,8478047,Michael Bunting,L,PIT,29,70,28,29,57
47,8483515,Juraj Slafkovsky,L,MTL,20,76,24,33,57
47,8474679,Gustav Nyquist,C,NSH,35,72,18,39,57
47,8480803,Evan Bouchard,D,EDM,25,74,8,49,57
47,8474590,John Carlson,D,WSH,34,72,8,49,57
47,8477429,Andrew Copp,C,DET,30,79,26,30,56
47,8478440,Dylan Strome,C,WSH,27,76,22,34,56
47,8480797,Joel Farabee,L,PHI,24,75,22,34,56
47,8481068,Yegor Sharangovich,C,CGY,26,78,20,36,56
47,8478407,Vince Dunn,D,SEA,28,75,11,45,56
47,8476399,Blake Coleman,C,CGY,33,74,32,23,55
47,8482113,Anton Lundell,C,FLA,23,81,30,25,55
47,8480015,Owen Tippett,R,PHI,25,75,30,25,55
47,8477476,Artturi Lehkonen,L,COL,29,81,27,28,55
47,8477998,Warren Foegele,L,LAK,28,81,24,31,55
47,8478233,Andrew Mangiapane,L,WSH,28,77,23,32,55
47,8479400,Pierre-Luc Dubois,L,WSH,26,72,22,33,55
47,8477503,Max Domi,C,TOR,29,77,22,33,55
47,8473994,Jamie Benn,L,DAL,35,80,21,34,55
47,8478873,Troy Terry,R,ANA,27,77,21,34,55
47,8477986,Brandon Montour,D,SEA,30,70,14,41,55
47,8479325,Charlie McAvoy,D,BOS,27,75,10,45,55
47,8482684,Luke Hughes,D,NJD,21,73,8,47,55
47,8474586,Jordan Eberle,R,SEA,34,76,28,26,54
47,8477955,Jared McCann,L,SEA,28,71,27,27,54
47,8478498,Jake DeBrusk,L,VAN,28,77,26,28,54
47,8478438,Tommy Novak,C,NSH,27,74,21,33,54
47,8475794,Tyler Seguin,C,DAL,32,80,19,35,54
47,8474563,Drew Doughty,D,LAK,35,73,8,46,54
47,8474641,Adam Henrique,C,EDM,34,79,29,23,52
47,8475151,Kyle Palmieri,C,NYI,33,76,26,26,52
47,8482097,Jack Quinn,R,BUF,23,67,19,33,52
47,8477451,Ryan Hartman,R,MIN,30,69,18,34,52
47,8475799,Nino Niederreiter,R,WPG,32,72,28,23,51
47,8475169,Evander Kane,L,EDM,33,79,27,24,51
47,8479992,Michael Rasmussen,C,DET,25,76,25,26,51
47,8480009,Eeli Tolvanen,R,SEA,25,77,23,28,51
47,8479425,Filip Hronek,D,VAN,27,72,5,46,51
47,8482699,Dylan Guenther,R,UTA,21,74,27,23,50
47,8477935,Sam Bennett,C,FLA,28,80,24,26,50
47,8482109,Alexis Lafrenière,L,NYR,23,77,24,26,50
47,8478042,Viktor Arvidsson,L,EDM,31,76,23,27,50
47,8478856,Conor Garland,R,VAN,28,72,22,28,50
47,8476461,Sean Couturier,C,PHI,32,69,21,29,50
47,8480064,Josh Norris,C,OTT,25,74,20,30,50
47,8479675,Trevor Moore,L,LAK,29,79,19,31,50
47,8473986,Alex Killorn,L,ANA,35,73,19,31,50
47,8480039,Martin Necas,C,CAR,25,64,18,32,50
47,8478469,Thomas Chabot,D,OTT,27,70,16,34,50
47,8480220,Noah Cates,L,PHI,25,69,15,35,50
47,8481711,Matias Maccelli,L,UTA,24,76,14,36,50
47,8476869,Brady Skjei,D,NSH,30,72,14,36,50
47,8482665,Matty Beniers,C,SEA,22,72,23,26,49
47,8477456,J.T. Compher,L,DET,29,80,21,28,49
47,8476483,Rickard Rakell,R,PIT,31,70,20,29,49
47,8478413,Jordan Greenway,L,BUF,27,66,19,30,49
47,8482702,Logan Stankoven,C,DAL,21,82,15,34,49
47,8479339,Patrik Laine,L,CBJ,26,67,15,34,49
47,8479525,Ross Colton,C,COL,28,81,26,22,48
47,8478466,Daniel Sprong,R,VAN,27,77,19,29,48
47,8476905,Chandler Stephenson,C,SEA,30,72,16,32,48
47,8474150,Mikael Backlund,C,CGY,35,75,14,34,48
47,8482745,Mason McTavish,C,ANA,21,73,24,23,47
47,8480068,Ryan Poehling,C,PHI,25,71,21,26,47
47,8480798,Philipp Kurashev,C,CHI,25,58,17,30,47
47,8478462,Nicolas Roy,C,VGK,27,76,17,30,47
47,8482149,Cole Perfetti,C,WPG,22,80,17,30,47
47,8470613,Brent Burns,D,CAR,39,74,15,32,47
47,8475798,Mikael Granlund,C,SJS,32,68,10,37,47
47,8478038,Devon Toews,D,COL,30,68,8,39,47
47,8476854,Hampus Lindholm,D,BOS,30,73,7,40,47
47,8479365,Trent Frederic,C,BOS,26,78,24,22,46
47,8475726,Tyler Toffoli,C,SJS,32,67,23,23,46
47,8475170,Brayden Schenn,C,STL,33,70,22,24,46
47,8483808,Andrei Kuzmenko,L,CGY,28,76,22,24,46
47,8475768,Jaden Schwartz,C,SEA,32,60,17,29,46
47,8480028,Morgan Frost,C,PHI,25,71,16,30,46
47,8477479,Tyler Bertuzzi,L,CHI,29,66,15,31,46
47,8481596,Shane Pinto,C,OTT,24,80,14,32,46
47,8477948,Travis Sanheim,D,PHI,28,71,10,36,46
47,8480434,Sean Durzi,D,UTA,26,71,8,38,46
47,8477495,Seth Jones,D,CHI,30,72,13,32,45
47,8482105,Jake Sanderson,D,OTT,22,69,11,34,45
47,8477447,Shea Theodore,D,VGK,29,58,11,34,45
47,8477426,Nicholas Paul,L,TBL,29,81,25,19,44
47,8484166,Adam Fantilli,C,CBJ,20,68,16,28,44
47,8476826,Yanni Gourde,C,SEA,33,71,16,28,44
47,8483505,Matthew Poitras,C,BOS,20,72,14,30,44
47,8476927,Teddy Blueger,C,VAN,30,68,14,30,44
47,8479987,Morgan Geekie,C,BOS,26,77,13,31,44
47,8476923,Damon Severson,D,CBJ,30,81,8,36,44
47,8475314,Anders Lee,L,NYI,34,79,24,19,43
47,8481560,Arthur Kaliyev,R,LAK,23,80,22,21,43
47,8478115,Pierre Engvall,L,NYI,28,77,19,24,43
47,8480185,Eetu Luostarinen,C,FLA,26,74,18,25,43
47,8476882,Teuvo Teravainen,C,CHI,30,72,17,26,43
47,8482720,Matthew Knies,L,TOR,22,78,11,32,43
47,8476292,Ondrej Palat,L,NJD,33,71,21,21,42
47,8482667,William Eklund,L,SJS,22,69,18,24,42
47,8481533,Trevor Zegras,C,ANA,23,69,15,27,42
47,8476906,Shayne Gostisbehere,D,CAR,31,76,15,27,42
47,8477987,Ryan Donato,C,CHI,28,62,15,27,42
47,8476880,Tom Wilson,R,WSH,30,63,19,22,41
47,8477425,Miles Wood,L,COL,29,78,19,22,41
47,8482092,Ridly Greig,C,OTT,22,75,17,24,41
47,8476480,Vladislav Namestnikov,C,WPG,32,60,16,25,41
47,8476875,Mike Matheson,D,MTL,30,73,13,28,41
47,8477444,Andre Burakovsky,L,SEA,29,74,13,27,40
47,8479410,Mikhail Sergachev,D,UTA,26,69,13,27,40
47,8477346,MacKenzie Weegar,D,CGY,30,79,12,28,40
47,8475753,Justin Faulk,D,STL,32,74,11,29,40
47,8476792,Torey Krug,D,STL,33,75,5,35,40
47,8471698,T.J. Oshie,R,WSH,38,69,20,19,39
47,8479390,Taylor Raddysh,R,WSH,26,65,19,20,39
47,8477021,Alex Kerfoot,C,UTA,30,71,18,21,39
47,8476419,Jean-Gabriel Pageau,C,NYI,32,77,17,22,39
47,8481577,Philip Tomasino,C,NSH,23,66,12,27,39
47,8477498,Darnell Nurse,D,EDM,29,77,12,27,39
47,8476872,Scott Laughton,C,PHI,30,65,11,28,39
47,8474565,Alex Pietrangelo,D,VGK,34,58,11,28,39
47,8476463,Jonas Brodin,D,MIN,31,78,10,29,39
47,8481542,Moritz Seider,D,DET,23,78,5,34,39
47,8482133,Thomas Bordeleau,C,SJS,22,69,15,23,38
47,8481524,Bowen Byram,D,BUF,23,66,13,25,38
47,8475218,Mattias Ekholm,D,EDM,34,71,12,26,38
47,8479351,Sam Steel,C,DAL,26,82,11,27,38
47,8478458,John (Jack) Roslovic,C,CAR,27,64,11,27,38
47,8476462,Dougie Hamilton,D,NJD,31,61,7,31,38
47,8476981,Josh Anderson,R,MTL,30,66,26,11,37
47,8475760,Nick Bjugstad,C,UTA,32,73,22,15,37
47,8481535,Nils Hoglander,L,VAN,24,63,20,17,37
47,8478046,Danton Heinen,L,VAN,29,65,16,21,37
47,8478542,Evan Rodrigues,C,FLA,31,76,11,26,37
47,8480145,Neal Pionk,D,WPG,29,65,8,29,37
47,8477932,Aaron Ekblad,D,FLA,28,69,7,30,37
47,8478397,Rasmus Andersson,D,CGY,28,78,7,30,37
47,8483490,Pavel Mintyukov,D,ANA,21,72,6,31,37
47,8481546,Cam York,D,PHI,23,72,6,31,37
47,8474149,Evgenii Dadonov,R,DAL,35,81,21,15,36
47,8478366,Frank Vatrano,R,ANA,30,73,18,18,36
47,8476438,Brandon Saad,L,STL,32,70,18,18,36
47,8480849,Barrett Hayton,C,UTA,24,69,16,20,36
47,8475158,Ryan O'Reilly,C,NSH,33,74,15,21,36
47,8484145,Zach Benson,L,BUF,19,65,15,21,36
47,8480802,Ryan McLeod,C,BUF,25,69,14,22,36
47,8481703,Valtteri Puustinen,R,PIT,25,60,7,29,36
47,8476958,Jaccob Slavin,D,CAR,30,76,6,30,36
47,8478020,Michael Amadio,R,OTT,28,77,19,16,35
47,8481604,Pavel Dorofeyev,L,VGK,24,71,17,18,35
47,8482705,Cole Sillinger,C,CBJ,21,62,16,19,35
47,8478463,Anthony Beauvillier,L,PIT,27,68,14,21,35
47,8474053,Logan Couture,C,SJS,35,60,13,22,35
47,8478055,Gustav Forsling,D,FLA,28,75,12,23,35
47,8480113,Alex Iafallo,L,WPG,31,62,12,23,35
47,8482146,Luke Evangelista,R,NSH,22,66,11,24,35
47,8474189,Lars Eller,C,PIT,35,70,17,17,34
47,8479293,Brandon Tanev,L,SEA,33,67,17,17,34
47,8474715,Cameron Atkinson,R,TBL,35,81,16,18,34
47,8473422,Nick Foligno,L,CHI,37,56,16,18,34
47,8479591,Michael Eyssimont,C,TBL,28,81,15,19,34
47,8478109,Victor Olofsson,L,VGK,29,72,12,22,34
47,8478396,Noah Hanifin,D,VGK,27,62,6,28,34
47,8474151,Ryan McDonagh,D,TBL,35,78,4,30,34
47,8481606,Jordan Spence,D,LAK,23,68,2,32,34
47,8477964,Ivan Barbashev,C,VGK,29,72,17,16,33
47,8477989,Christian Dvorak,C,MTL,28,68,16,17,33
47,8480813,Joe Veleno,C,DET,24,81,16,17,33
47,8476918,Jimmy Vesey,L,NYR,31,69,15,18,33
47,8482809,Jackson Blake,R,CAR,21,57,15,18,33
47,8478133,Jake Evans,C,MTL,28,72,14,19,33
47,8481618,Alex Newhook,C,MTL,23,70,12,21,33
47,8474716,Jared Spurgeon,D,MIN,35,77,12,21,33
47,8478891,Mason Appleton,C,WPG,28,62,11,22,33
47,8478500,Ivan Provorov,D,CBJ,27,78,6,27,33
47,8480014,Gabriel Vilardi,C,WPG,25,68,23,9,32
47,8482117,Lukas Reichel,L,CHI,22,50,18,14,32
47,8480893,Kirill Marchenko,R,CBJ,24,57,18,14,32
47,8481553,Bobby Brink,R,PHI,23,64,15,17,32
47,8479345,Jakob Chychrun,D,WSH,26,67,11,21,32
47,8480144,David Kampf,C,TOR,29,66,11,21,32
47,8480871,Adam Boqvist,D,FLA,24,67,10,22,32
47,8475149,Marcus Johansson,L,MIN,34,69,10,22,32
47,8475763,Kevin Hayes,R,PIT,32,64,9,23,32
47,8482671,Owen Power,D,BUF,22,73,8,24,32
47,8482712,Oskar Olausson,R,COL,22,75,7,25,32
47,8483445,Cutter Gauthier,L,ANA,20,61,7,25,32
47,8480817,K'Andre Miller,D,NYR,24,74,5,27,32
47,8476979,Erik Gustafsson,D,DET,32,73,4,28,32
47,8481624,Ilya Mikheyev,R,CHI,30,58,18,13,31
47,8482475,Yegor Chinakhov,R,CBJ,23,64,16,15,31
47,8482110,Dawson Mercer,C,NJD,23,73,16,15,31
47,8477450,Jason Dickinson,C,CHI,29,58,16,15,31
47,8482175,JJ Peterka,R,BUF,22,72,15,16,31
47,8481186,Logan O'Connor,R,COL,28,81,14,17,31
47,8475722,Jason Zucker,L,BUF,32,68,13,18,31
47,8481554,Kaapo Kakko,R,NYR,23,71,12,19,31
47,8475793,Ryan Johansen,C,PHI,32,71,11,20,31
47,8475714,Calle Jarnkrok,C,TOR,33,71,9,22,31
47,8476458,Ryan Strome,C,ANA,31,67,9,22,31
47,8477839,Conor Sheary,L,TBL,32,81,9,22,31
47,8476892,Colton Parayko,D,STL,31,74,3,28,31
47,8476917,Adam Pelech,D,NYI,30,75,2,29,31
47,8480829,Jesperi Kotkaniemi,C,CAR,24,57,19,11,30
47,8477511,Anthony Mantha,R,CGY,30,71,16,14,30
47,8483524,Shane Wright,C,SEA,20,64,13,17,30
47,8481523,Kirby Dach,C,MTL,23,69,12,18,30
47,8484203,Bradly Nadeau,L,CAR,19,62,12,18,30
47,8482660,Kent Johnson,C,CBJ,22,66,11,19,30
47,8475848,Brendan Gallagher,R,MTL,32,68,10,20,30
47,8481581,Thomas Harley,D,DAL,23,75,8,22,30
47,8480336,Sean Walker,D,CAR,30,73,8,22,30
47,8476902,Esa Lindell,D,DAL,30,77,7,23,30
47,8477506,Ryan Pulock,D,NYI,30,76,5,25,30
47,8482655,Janis Moser,D,TBL,24,79,2,28,30
47,8480448,Parker Kelly,L,COL,25,77,17,12,29
47,8479661,Tanner Jeannot,L,LAK,27,75,16,13,29
47,8478057,Dakota Joshua,C,VAN,28,65,14,15,29
47,8476878,Zemgus Girgensons,C,TBL,30,79,13,16,29
47,8475287,Erik Haula,L,NJD,33,73,10,19,29
47,8476885,Jacob Trouba,D,NYR,30,69,8,21,29
47,8475200,Dmitry Orlov,D,CAR,33,74,6,23,29
47,8477969,Marcus Pettersson,D,PIT,28,80,3,26,29
47,8481014,Alexander Romanov,D,NYI,24,76,3,26,29
47,8478851,Alexandre Carrier,D,NSH,28,66,2,27,29
47,8480459,Pius Suter,C,VAN,28,63,14,14,28
47,8481656,Aliaksei Protas,C,WSH,23,63,14,14,28
47,8476897,Oskar Sundqvist,C,STL,30,69,14,14,28
47,8478472,Mathieu Joseph,R,STL,27,71,14,14,28
47,8477015,Connor Brown,R,EDM,30,61,13,15,28
47,8478569,Noel Acciari,C,PIT,33,58,13,15,28
47,8470621,Corey Perry,R,EDM,39,70,9,19,28
47,8475791,Taylor Hall,L,CHI,33,60,9,19,28
47,8477952,Robby Fabbri,C,ANA,28,63,14,13,27
47,8475343,Nic Dowd,C,WSH,34,53,14,13,27
47,8480078,Filip Chytil,C,NYR,25,64,12,15,27
47,8482055,Drew O'Connor,L,PIT,26,56,9,18,27
47,8478013,Jake Walman,D,SJS,28,72,8,19,27
47,8480043,Timothy Liljegren,D,TOR,25,67,4,23,27
47,8474673,TJ Brodie,D,CHI,34,64,2,25,27
47,8477353,Tyler Motte,C,DET,29,72,12,14,26
47,8482157,Will Cuylle,L,NYR,22,61,12,14,26
47,8476392,Adam Lowry,C,WPG,31,67,11,15,26
47,8480789,Oliver Wahlstrom,R,NYI,24,73,11,15,26
47,8481032,Paul Cotter,C,NJD,25,65,11,15,26
47,8473563,Nicklas Backstrom,C,WSH,37,61,10,16,26
47,8482624,Daniil Miromanov,D,CGY,27,64,6,20,26
47,8480073,Erik Brannstrom,D,COL,25,65,5,21,26
47,8476467,Jamie Oleksiak,D,SEA,32,73,3,23,26
47,8479398,Samuel Girard,D,COL,26,67,2,24,26
47,8476474,Stefan Noesen,R,NJD,31,65,12,13,25
47,8483493,Frank Nazar,C,CHI,20,59,12,13,25
47,8476873,Mark Jankowski,C,NSH,30,55,11,14,25
47,8478474,Lawson Crouse,L,UTA,27,71,10,15,25
47,8479941,Justin Danforth,R,CBJ,31,59,10,15,25
47,8476925,Colton Sissons,C,NSH,31,66,9,16,25
47,8473533,Jordan Staal,C,CAR,36,65,8,17,25
47,8479998,Mikey Anderson,D,LAK,25,70,5,20,25
47,8477435,Ryan Graves,D,PIT,29,77,5,20,25
47,8475181,Nick Leddy,D,STL,33,68,2,23,25
47,8477446,Michael McCarron,R,NSH,29,55,15,9,24
47,8481582,Nicholas Robertson,L,TOR,23,71,12,12,24
47,8482089,Jake Neighbours,L,STL,22,71,11,13,24
47,8480835,Jack Drury,C,CAR,24,62,11,13,24
47,8476278,Colin Blackwell,C,DAL,31,76,10,14,24
47,8482148,Hendrix Lapierre,C,WSH,22,54,10,14,24
47,8478911,Matt Roy,D,WSH,29,58,9,15,24
47,8476422,Mike Reilly,D,NYI,31,76,9,15,24
47,8479996,Cody Glass,C,NSH,25,58,8,16,24
47,8477979,Nicolas Aube-Kubel,R,BUF,28,52,8,16,24
47,8475790,Erik Gudbranson,D,CBJ,32,76,2,22,24
47,8480995,Pontus Holmberg,R,TOR,25,67,16,7,23
47,8479368,Max Jones,L,BOS,26,63,14,9,23
47,8478508,Yakov Trenin,C,MIN,27,53,14,9,23
47,8475193,Tomas Tatar,L,NJD,34,68,11,12,23
47,8479393,Noah Gregor,L,OTT,26,64,11,12,23
47,8476329,Travis Boyd,C,MIN,31,60,10,13,23
47,8481028,Martin Pospisil,C,CGY,25,64,10,13,23
47,8480003,Jesper Boqvist,C,FLA,26,64,9,14,23
47,8477919,Frederick Gaudreau,C,MIN,31,63,8,15,23
47,8478434,Keegan Kolesar,R,VGK,27,65,8,15,23
47,8478421,A.J. Greer,L,FLA,28,63,8,15,23
47,8481580,Connor McMichael,C,WSH,23,63,7,16,23
47,8473507,Jeff Petry,D,DET,37,71,6,17,23
47,8482192,Isaak Phillips,D,CHI,23,52,6,17,23
47,8482142,Jamie Drysdale,D,PHI,22,64,5,18,23
47,8483565,Nick Blankenburg,D,NSH,26,62,5,18,23
47,8480049,Dylan Samberg,D,WPG,25,67,4,19,23
47,8480873,Rasmus Sandin,D,WSH,24,63,4,19,23
47,8480035,Henri Jokiharju,D,BUF,25,64,3,20,23
47,8482122,Brock Faber,D,MIN,22,75,2,21,23
47,8480205,Emil Bemstrom,C,PIT,25,59,15,7,22
47,8479619,Michael Carcone,L,UTA,28,69,12,10,22
47,8481481,Blake Lizotte,C,PIT,27,63,11,11,22
47,8479353,Brett Howden,C,VGK,26,64,8,14,22
47,8476624,Barclay Goodrow,C,SJS,31,46,8,14,22
47,8476921,Jordan Martinook,L,CAR,32,63,8,14,22
47,8483468,Jiri Kulich,C,BUF,20,54,6,16,22
47,8479639,Dylan Coghlan,D,WPG,26,67,5,17,22
47,8479983,Mario Ferraro,D,SJS,26,75,5,17,22
47,8480878,Nils Lundkvist,D,DAL,24,66,4,18,22
47,8480001,Urho Vaakanainen,D,ANA,25,53,3,19,22
47,8482155,Alex Laferriere,R,LAK,23,64,14,7,21
47,8481601,Simon Holmstrom,R,NYI,23,68,13,8,21
47,8480980,Connor Dewar,C,TOR,25,62,12,9,21
47,8477931,Tomas Nosek,L,FLA,32,52,10,11,21
47,8482101,Danil Gushchin,L,SJS,22,59,9,12,21
47,8480748,Kiefer Sherwood,L,VAN,29,61,9,12,21
47,8482803,Olen Zellweger,D,ANA,21,64,8,13,21
47,8481521,Ronnie Attard,D,PHI,25,50,7,14,21
47,8477947,Sonny Milano,L,WSH,28,62,6,15,21
47,8476879,Cody Ceci,D,EDM,31,77,6,15,21
47,8479371,Dante Fabbro,D,NSH,26,68,5,16,21
47,8475764,Cam Fowler,D,ANA,33,79,3,18,21
47,8476457,Adam Larsson,D,SEA,32,72,3,18,21
47,8475233,David Savard,D,MTL,34,71,2,19,21
47,8479439,Jacob MacDonald,D,COL,31,53,12,8,20
47,8480011,Klim Kostin,C,SJS,25,53,11,9,20
47,8477478,William Carrier,L,CAR,30,56,9,11,20
47,8481477,Nico Sturm,C,SJS,29,55,8,12,20
47,8477392,Hudson Fasching,R,NYI,29,64,8,12,20
47,8477505,Alexander Wennberg,C,SJS,30,58,7,13,20
47,8474034,Patrick Maroon,L,CHI,36,50,7,13,20
47,8477903,Garnet Hathaway,R,PHI,33,60,7,13,20
47,8476374,Sean Kuraly,C,CBJ,31,59,6,14,20
47,8478970,Jalen Chatfield,D,CAR,28,71,6,14,20
47,8482679,Matt Coronato,R,CGY,22,64,6,14,20
47,8476856,Mathew Dumba,D,DAL,30,71,5,15,20
47,8482067,Connor Mackey,D,NYR,28,53,5,15,20
47,8480891,Michael Kesselring,D,UTA,24,57,3,17,20
47,8475324,Nick Jensen,D,OTT,34,69,2,18,20
47,8475220,Marcus Foligno,L,MIN,33,63,10,9,19
47,8473453,Trevor Lewis,C,LAK,37,74,10,9,19
47,8480025,MacKenzie Entwistle,R,FLA,25,59,10,9,19
47,8481093,Rafael Harvey-Pinard,L,MTL,25,67,9,10,19
47,8479316,Luke Kunin,C,SJS,27,59,9,10,19
47,8482062,Cole Smith,L,NSH,29,60,8,11,19
47,8477406,Mattias Janmark,C,EDM,32,62,7,12,19
47,8476960,Andreas Athanasiou,C,CHI,30,46,7,12,19
47,8478432,Christian Fischer,R,DET,27,72,7,12,19
47,8476429,Scott Mayfield,D,NYI,32,75,5,14,19
47,8478136,Jake Middleton,D,MIN,28,73,3,16,19
47,8476931,Jake McCabe,D,TOR,31,66,3,16,19
47,8479324,Ryan Lindgren,D,NYR,26,65,3,16,19
47,8480950,Ilya Lyubushkin,D,DAL,30,63,3,16,19
47,8481568,Alex Vlasic,D,CHI,23,56,2,17,19
47,8476331,Dylan DeMelo,D,WPG,31,70,0,19,19
47,8480281,Alexey Toropchenko,R,STL,25,54,14,4,18
47,8476934,Brock McGinn,L,ANA,30,58,11,7,18
47,8482074,Connor Zary,C,CGY,23,62,10,8,18
47,8482762,Simon Edvinsson,D,DET,21,56,10,8,18
47,8481641,Joel Kiviranta,L,COL,28,71,9,9,18
47,8480074,Alexandre Texier,C,STL,25,58,7,11,18
47,8480192,Johnathan Kovacevic,D,NJD,27,58,5,13,18
47,8478859,Niko Mikkola,D,FLA,28,58,5,13,18
47,8475690,Chris Tanev,D,TOR,35,59,4,14,18
47,8480860,Kevin Bahl,D,CGY,24,53,4,14,18
47,8480222,Sebastian Aho,D,PIT,28,67,4,14,18
47,8476874,Olli Maatta,D,DET,30,63,4,14,18
47,8481441,Joe Snively,C,DET,28,62,3,15,18
47,8478840,Will Borgen,D,SEA,28,61,3,15,18
47,8477488,Brett Pesce,D,NJD,30,65,2,16,18
47,8478178,Darren Raddysh,D,TBL,28,68,2,16,18
47,8482125,Alexander Holtz,R,VGK,22,68,12,5,17
47,8481716,Dmitri Voronkov,L,CBJ,24,59,12,5,17
47,8481704,Juuso Parssinen,C,NSH,23,59,10,7,17
47,8484149,Gavin Brindley,C,CBJ,20,39,9,8,17
47,8479671,Mathieu Olivier,R,CBJ,27,44,9,8,17
47,8475231,Casey Cizikas,C,NYI,33,72,8,9,17
47,8480855,Jack McBain,C,UTA,24,65,7,10,17
47,8483457,Lane Hutson,D,MTL,20,70,7,10,17
47,8475855,Jesper Fast,R,CAR,33,61,6,11,17
47,8482259,Bobby McMann,C,TOR,28,57,6,11,17
47,8481517,Brett Leason,R,ANA,25,63,6,11,17
47,8476312,Josh Manson,D,COL,33,62,5,12,17
47,8479291,Kevin Rooney,C,CGY,31,52,5,12,17
47,8479370,Tyson Jost,C,CAR,26,57,5,12,17
47,8476994,Vinnie Hinostroza,C,NSH,30,41,5,12,17
47,8479315,Joey Anderson,R,CHI,26,45,4,13,17
47,8476891,Matthew Grzelcyk,D,PIT,30,74,4,13,17
47,8477845,Trevor van Riemsdyk,D,WSH,33,57,4,13,17
47,8482073,Braden Schneider,D,NYR,23,70,4,13,17
47,8475279,Ben Chiarot,D,DET,33,64,4,13,17
47,8478507,John Marino,D,UTA,27,68,3,14,17
47,8477507,Nikita Zadorov,D,BOS,29,69,2,15,17
47,8480246,Nick Perbix,D,TBL,26,71,1,16,17
47,8480289,Morgan Barron,C,WPG,26,51,10,6,16
47,8479359,Beck Malenstyn,L,BUF,26,47,9,7,16
47,8479066,Ryan Lomberg,L,CGY,30,62,9,7,16
47,8479980,Nicolas Hague,D,VGK,26,53,8,8,16
47,8480762,Eric Robinson,L,CAR,29,54,8,8,16
47,8481522,Peyton Krebs,C,BUF,23,58,8,8,16
47,8477953,Kasperi Kapanen,R,STL,28,69,7,9,16
47,8482166,Shakir Mukhamadullin,D,SJS,22,54,7,9,16
47,8482176,Wyatt Kaiser,D,CHI,22,51,7,9,16
47,8482077,Dylan Holloway,L,EDM,23,46,6,10,16
47,8481708,Zac Jones,D,NYR,24,52,5,11,16
47,8483482,Tristan Luneau,D,ANA,20,60,5,11,16
47,8483499,Liam Ohgren,L,MIN,20,58,4,12,16
47,8474574,Tyler Myers,D,VAN,34,62,4,12,16
47,8480807,Mattias Samuelsson,D,BUF,24,50,4,12,16
47,8476442,Matt Nieto,L,PIT,32,43,4,12,16
47,8479982,Conor Timmins,D,TOR,26,61,3,13,16
47,8480848,Ty Dellandrea,C,SJS,24,46,3,13,16
47,8475718,Justin Holl,D,DET,32,57,3,13,16
47,8482245,Artem Zub,D,OTT,29,70,2,14,16
47,8481059,Scott Perunovich,D,STL,26,57,2,14,16
47,8478882,Vladislav Gavrikov,D,LAK,29,74,1,15,16
47,8476988,Matt Benning,D,SJS,30,70,1,15,16
47,8475462,Radko Gudas,D,ANA,34,63,1,15,16
47,8478211,Dryden Hunt,L,CGY,29,50,10,5,15
47,8481019,David Gustafsson,C,WPG,24,45,6,9,15
47,8475225,Craig Smith,C,CHI,35,53,6,9,15
47,8483491,Ivan Miroshnichenko,L,WSH,20,58,6,9,15
47,8477482,Zachary Sanford,L,CHI,30,43,6,9,15
47,8480806,Isac Lundestrom,C,ANA,25,59,5,10,15
47,8481532,Alex Turcotte,C,LAK,23,46,5,10,15
47,8481161,Jake Christiansen,D,CBJ,25,66,5,10,15
47,8476469,Joel Armia,R,MTL,31,64,4,11,15
47,8480252,Cole Guttman,C,CHI,25,41,4,11,15
47,8482634,Alex Steeves,C,TOR,25,57,4,11,15
47,8477938,Haydn Fleury,D,WPG,28,45,4,11,15
47,8478443,Brandon Carlo,D,BOS,28,60,4,11,15
47,8474568,Luke Schenn,D,NSH,35,45,2,13,15
47,8475179,Dmitry Kulikov,D,FLA,34,61,1,14,15
47,8482079,Marco Rossi,C,MIN,23,57,11,3,14
47,8479336,Carl Grundstrom,R,SJS,27,54,7,7,14
47,8482111,Justin Barron,D,MTL,23,69,6,8,14
47,8482730,Brandt Clarke,D,LAK,21,50,6,8,14
47,8481751,Lukas Rousek,R,BUF,25,47,6,8,14
47,8477962,Brendan Lemieux,L,CAR,28,45,5,9,14
47,8482807,Ethan Del Mastro,D,CHI,21,45,5,9,14
47,8477220,Nate Schmidt,D,FLA,33,64,4,10,14
47,8479718,Alex Barré-Boulet,C,MTL,27,55,4,10,14
47,8479976,Juuso Valimaki,D,UTA,26,62,4,10,14
47,8480172,Jan Rutta,D,SJS,34,58,3,11,14
47,8481527,Kaedan Korczak,D,VGK,23,45,2,12,14
47,8479402,Jake Bean,D,CGY,26,58,1,13,14
47,8475455,Brenden Dillon,D,NJD,34,62,1,13,14
47,8482861,Vincent Iorio,D,WSH,22,36,1,13,14
47,8480887,Jordan Harris,D,MTL,24,46,0,14,14
47,8475842,Sam Carrick,C,NYR,32,59,10,3,13
47,8476889,Radek Faksa,C,STL,30,51,9,4,13
47,8479414,Nathan Bastian,R,NJD,27,59,8,5,13
47,8477369,Carson Soucy,D,VAN,30,67,7,6,13
47,8476822,Luke Glendening,C,TBL,35,80,7,6,13
47,8480157,Calle Rosen,D,COL,30,47,6,7,13
47,8477499,Rasmus Ristolainen,D,PHI,30,57,6,7,13
47,8482749,Joshua Roy,R,MTL,21,59,4,9,13
47,8471709,Marc-Edouard Vlasic,D,SJS,37,60,4,9,13
47,8482451,Mikael Pyyhtia,L,CBJ,23,40,4,9,13
47,8482747,Brennan Othmann,L,NYR,21,44,4,9,13
47,8479378,Logan Stanley,D,WPG,26,43,4,9,13
47,8478399,Jonas Siegenthaler,D,NJD,27,64,3,10,13
47,8482744,James Malatesta,L,CBJ,21,40,3,10,13
47,8475171,Oliver Ekman-Larsson,D,TOR,33,71,2,11,13
47,8475188,Brayden McNabb,D,VGK,33,59,2,11,13
47,8481178,Egor Zamula,D,PHI,24,59,2,11,13
47,8482666,Scott Morrow,D,CAR,22,48,2,11,13
47,8476525,Colin Miller,D,WPG,32,63,1,12,13
47,8478831,Kevin Stenlund,C,UTA,28,56,8,4,12
47,8477573,Nathan Walker,L,STL,30,47,6,6,12
47,8482141,Lukas Cormier,D,VGK,22,35,6,6,12
47,8478043,Sam Lafferty,C,BUF,29,59,5,7,12
47,8482737,Zack Bolduc,C,STL,21,56,5,7,12
47,8479328,Julien Gauthier,R,NYI,27,65,5,7,12
47,8480355,Mark Kastelic,C,BOS,25,54,5,7,12
47,8479026,Philippe Myers,D,TOR,27,47,3,9,12
47,8481598,Philip Broberg,D,EDM,23,43,3,9,12
47,8475208,Brian Dumoulin,D,ANA,33,65,3,9,12
47,8477462,Robert Hagg,D,VGK,29,29,3,9,12
47,8482087,Kaiden Guhle,D,MTL,22,64,2,10,12
47,8480058,Pierre-Olivier Joseph,D,STL,25,60,2,10,12
47,8481599,Victor Soderstrom,D,UTA,23,44,1,11,12
47,8481754,Nikita Nesterenko,C,ANA,23,29,7,4,11
47,8483495,Simon Nemec,D,NJD,20,58,6,5,11
47,8479972,Mason Shaw,C,WPG,26,32,6,5,11
47,8481556,John Beecher,C,BOS,23,34,6,5,11
47,8479344,Jesse Puljujarvi,R,PIT,26,52,5,6,11
47,8479543,Michael Pezzetta,L,MTL,26,51,5,6,11
47,8478452,Caleb Jones,D,LAK,27,54,3,8,11
47,8479520,Brandon Duhaime,R,WSH,27,51,3,8,11
47,8478451,Ethan Bear,D,WSH,27,47,3,8,11
47,8474567,Zach Bogosian,D,MIN,34,58,3,8,11
47,8482859,Zack Ostapchuk,C,OTT,21,53,3,8,11
47,8478468,Jeremy Lauzon,D,NSH,27,55,3,8,11
47,8480727,Zach Whitecloud,D,VGK,28,48,2,9,11
47,8470600,Ryan Suter,D,STL,39,57,2,9,11
47,8480796,Martin Fehervary,D,WSH,25,57,2,9,11
47,8478416,Erik Cernak,D,TBL,27,69,2,9,11
47,8479369,Andrew Peeke,D,BOS,26,58,1,10,11
47,8481518,Nolan Foote,L,NJD,24,40,8,2,10
47,8479968,Vinni Lettieri,C,BOS,29,56,7,3,10
47,8482659,Josh Doan,R,UTA,22,53,5,5,10
47,8483466,Kevin Korchinski,D,CHI,20,45,4,6,10
47,8471677,Jack Johnson,D,CBJ,37,55,4,6,10
47,8478017,Mark Friedman,D,VAN,29,41,4,6,10
47,8481567,Henry Thrun,D,SJS,23,53,4,6,10
47,8477018,Ben Hutton,D,VGK,31,45,3,7,10
47,8478585,Derek Ryan,C,EDM,38,64,3,7,10
47,8480844,Grigori Denisenko,L,VGK,24,37,3,7,10
47,8476967,Brett Kulak,D,EDM,30,55,2,8,10
47,8484254,Akito Hirose,D,VAN,25,43,2,8,10
47,8477365,Connor Clifton,D,BUF,29,56,1,9,10
47,8481701,Santeri Hatakka,D,NJD,23,41,1,9,10
47,8476441,Joel Edmundson,D,LAK,31,35,1,9,10
47,8483549,Lucas Condotta,L,MTL,27,37,0,10,10
47,8471817,Ryan Reaves,R,TOR,37,55,6,3,9
47,8475235,Nicolas Deslauriers,L,PHI,33,54,5,4,9
47,8480292,Carson Meyer,R,ANA,27,38,5,4,9
47,8477508,Curtis Lazar,C,NJD,29,47,4,5,9
47,8480441,Trey Fix-Wolansky,R,CBJ,25,34,4,5,9
47,8480845,Rasmus Kupari,C,WPG,24,48,4,5,9
47,8480870,Bo Groulx,C,NYR,24,32,4,5,9
47,8476867,Brendan Gaunce,C,MIN,30,29,4,5,9
47,8482496,Nils Aman,C,VAN,24,39,4,5,9
47,8482652,Walker Duehr,R,CGY,27,43,4,5,9
47,8480021,Jack Studnicka,C,LAK,25,53,3,6,9
47,8481592,Jakob Pelletier,L,CGY,23,44,3,6,9
47,8481537,Nikita Okhotiuk,D,CGY,24,52,3,6,9
47,8481600,Tobias Bjornfot,D,FLA,23,42,2,7,9
47,8481617,Vasily Podkolzin,R,VAN,23,42,1,8,9
47,8481789,Tye Kartye,L,SEA,23,40,7,1,8
47,8479638,Justin Brazeau,R,BOS,26,42,7,1,8
47,8481013,Jonatan Berggren,R,DET,24,60,7,1,8
47,8481609,Vladislav Kolyachonok,D,UTA,23,41,4,4,8
47,8474612,Travis Hamonic,D,OTT,34,44,4,4,8
47,8479981,Jonah Gadjovich,L,FLA,26,41,4,4,8
47,8482070,Mitchell Chaffee,R,TBL,26,49,4,4,8
47,8482751,Ryan Winterton,C,SEA,21,39,4,4,8
47,8477034,Jaycob Megna,D,FLA,32,50,3,5,8
47,8482145,Mavrik Bourque,C,DAL,22,48,3,5,8
47,8481167,Brayden Pachal,D,CGY,25,44,3,5,8
47,8476913,Devin Shore,C,MIN,30,40,2,6,8
47,8480007,Jonas Rondbjerg,R,VGK,25,36,2,6,8
47,8480990,Declan Chisholm,D,MIN,24,42,2,6,8
47,8480196,Jacob Bryson,D,BUF,27,49,1,7,8
47,8483460,David Jiricek,D,CBJ,21,57,1,7,8
47,8481056,Spencer Stastney,D,NSH,24,35,1,7,8
47,8480070,Ian Mitchell,D,BOS,25,45,0,8,8
47,8481550,Adam Beckman,L,NJD,23,38,0,8,8
47,8477380,Jonny Brodzinski,C,NYR,31,43,5,2,7
47,8481541,Samuel Bolduc,D,NYI,24,33,5,2,7
47,8477887,Patrick Brown,C,BOS,32,42,4,3,7
47,8478409,Anthony Richard,C,PHI,28,40,4,3,7
47,8478424,Jansen Harkins,C,ANA,27,33,4,3,7
47,8479536,Axel Jonsson-Fjallby,L,WPG,26,34,4,3,7
47,8482784,Zach Dean,C,STL,21,42,4,3,7
47,8477070,Liam O'Brien,C,UTA,30,53,3,4,7
47,8476473,Connor Murphy,D,CHI,31,40,3,4,7
47,8479944,Zach Aston-Reese,C,VGK,30,53,3,4,7
47,8478450,Parker Wotherspoon,D,BOS,27,38,2,5,7
47,8482511,Mason Lohrei,D,BOS,23,33,2,5,7
47,8482153,Brendan Brisson,C,VGK,23,32,2,5,7
47,8474166,Alec Martinez,D,CHI,37,51,1,6,7
47,8482964,Arber Xhekaj,D,MTL,23,45,1,6,7
47,8474090,Brendan Smith,D,DAL,35,46,1,6,7
47,8483619,Filip Roos,D,OTT,25,33,1,6,7
47,8483763,Maksymilian Szuber,D,UTA,22,21,1,6,7
47,8479372,Joshua Mahura,D,SEA,26,54,0,7,7
47,8475750,Jon Merrill,D,MIN,32,63,0,7,7
47,8479772,Zack MacEwen,R,OTT,28,50,0,7,7
47,8482177,Marat Khusnutdinov,C,MIN,22,33,4,2,6
47,8479348,Kale Clague,D,BUF,26,31,3,3,6
47,8482713,Mackie Samoskevich,R,FLA,22,40,3,3,6
47,8476858,Phillip Di Giuseppe,L,VAN,31,39,3,3,6
47,8484287,Cole McWard,D,VAN,23,29,3,3,6
47,8475177,Calvin de Haan,D,COL,33,41,2,4,6
47,8484911,Collin Graf,R,SJS,22,40,2,4,6
47,8479994,Jaret Anderson-Dolan,C,WPG,25,39,2,4,6
47,8473446,Erik Johnson,D,PHI,36,49,2,4,6
47,8479986,Kole Lind,R,DAL,26,50,2,4,6
47,8480834,Ty Emberson,D,SJS,24,29,2,4,6
47,8478874,Adam Gaudette,R,OTT,28,39,1,5,6
47,8480267,Sammy Walker,C,MIN,25,20,1,5,6
47,8474013,Ian Cole,D,UTA,35,53,0,6,6
47,8476952,Dominic Toninato,C,WPG,30,32,0,6,6
47,8482095,Tyler Kleven,D,OTT,22,45,3,2,5
47,8476372,Nick Seeler,D,PHI,31,47,3,2,5
47,8482172,Landon Slaggert,L,CHI,22,25,2,3,5
47,8483012,Logan Morrison,C,SEA,22,33,2,3,5
47,8481147,Reese Johnson,C,MIN,26,39,2,3,5
47,8479320,Maxime Lajoie,D,SEA,27,25,2,3,5
47,8483630,Pavol Regenda,L,ANA,25,34,2,3,5
47,8484258,Sam Malinski,D,COL,26,22,2,3,5
47,8480879,Jacob Bernard-Docker,D,OTT,24,51,1,4,5
47,8475762,Derek Forbort,D,VAN,32,36,1,4,5
47,8478454,Noah Juulsen,D,VAN,27,39,0,5,5
47,8481543,Nikita Alexandrov,C,STL,24,28,4,0,4
47,8477473,Justin Bailey,R,SJS,29,22,4,0,4
47,8481679,Maxence Guenette,D,OTT,23,40,3,1,4
47,8481422,Jake Lucchini,C,NSH,29,17,3,1,4
47,8479442,Troy Stecher,D,EDM,30,53,2,2,4
47,8483570,Ben Meyers,C,SEA,26,25,2,2,4
47,8478477,Mitchell Stephens,C,SEA,27,21,2,2,4
47,8483397,Marc McLaughlin,C,BOS,25,29,2,2,4
47,8479249,Andrew Poturalski,C,SJS,30,25,1,3,4
47,8479379,Givani Smith,R,SJS,26,32,1,3,4
47,8480245,Olle Lycksell,R,PHI,25,27,1,3,4
47,8478146,Matthew Highmore,C,OTT,28,34,1,3,4
47,8475795,Dylan McIlrath,D,WSH,32,19,1,3,4
47,8479367,William Lockwood,R,FLA,26,22,1,3,4
47,8478446,Glenn Gawdin,C,LAK,27,16,1,3,4
47,8481605,Jackson LaCombe,D,ANA,23,36,0,4,4
47,8482470,Ilya Solovyov,D,CGY,24,20,0,4,4
47,8479587,Rhett Gardner,C,PHI,28,16,0,4,4
47,8482858,Ryker Evans,D,SEA,23,25,0,4,4
47,8482733,Logan Mailloux,D,MTL,31,34,3,0,3
47,8482765,Isak Rosen,R,BUF,21,25,2,1,3
47,8478051,Max Willman,C,NJD,29,19,2,1,3
47,8477851,Jordan Oesterle,D,BOS,32,41,1,2,3
47,8477971,Andreas Englund,D,LAK,28,29,1,2,3
47,8480468,James Hamblin,L,EDM,25,20,1,2,3
47,8479576,Vincent Desharnais,D,VAN,28,26,1,2,3
47,8479991,Jake Leschyshyn,C,NYR,25,25,1,2,3
47,8477810,Joel Hanley,D,CGY,33,27,1,2,3
47,8483512,Matthew Savoie,C,EDM,20,24,1,2,3
47,8483489,Fraser Minten,C,TOR,31,10,1,2,3
47,8477335,Kyle Burroughs,D,LAK,29,35,0,3,3
47,8481122,Simon Benoit,D,TOR,26,37,0,3,3
47,8479985,Cale Fleury,D,SEA,26,23,0,3,3
47,8481593,Jayden Struble,D,MTL,23,20,0,3,3
47,8480890,Jan Jenik,C,OTT,24,22,0,3,3
47,8483567,Georgii Merkulov,C,BOS,24,14,0,3,3
47,8475958,Michael Sgarbossa,C,WSH,32,17,0,3,3
47,8478502,Dennis Gilbert,D,BUF,28,16,0,3,3
47,8482061,Brandon Biro,L,SEA,26,15,2,0,2
47,8478881,Brett Seney,L,CHI,28,10,2,0,2
47,8475755,Alexander Petrovic,D,DAL,32,14,2,0,2
47,8482118,Sam Colangelo,R,ANA,23,12,2,0,2
47,8477384,Joshua Brown,D,EDM,30,42,1,1,2
47,8477527,Ross Johnston,L,ANA,30,30,1,1,2
47,8477244,Chad Ruhwedel,D,NYR,34,30,1,1,2
47,8479362,Riley Tufte,L,BOS,26,13,1,1,2
47,8480880,Jakub Lauko,C,MIN,24,32,1,1,2
47,8479419,Brett Murray,L,BUF,26,23,1,1,2
47,8477401,John Hayden,C,SEA,29,28,1,1,2
47,8480851,Akil Thomas,C,LAK,24,14,1,1,2
47,8482147,Jean-Luc Foudy,C,COL,22,18,1,1,2
47,8480874,Adam Ginning,D,PHI,24,11,1,1,2
47,8482250,Callahan Burke,C,VGK,27,19,0,2,2
47,8478021,William Lagesson,D,DET,28,30,0,2,2
47,8482516,Matthew Kessel,D,STL,24,15,0,2,2
47,8481237,Kyle MacLean,C,NYI,25,21,0,2,2
47,8482929,Emil Lilleberg,D,TBL,23,23,0,2,2
47,8478011,Louie Belpedio,D,PHI,28,12,0,2,2
47,8481006,Tyler Tucker,D,STL,24,12,0,2,2
47,8480084,Nick DeSimone,D,NJD,30,10,0,2,2
47,8481719,Maxwell Crozier,D,TBL,24,19,1,0,1
47,8482165,Yan Kuznetsov,D,CGY,22,17,1,0,1
47,8481564,Ryan Johnson,D,BUF,23,16,1,0,1
47,8484325,Waltteri Merela,C,TBL,26,18,1,0,1
47,8482460,Matt Rempe,C,NYR,22,10,1,0,1
47,8481726,Adam Edstrom,C,NYR,24,8,1,0,1
47,8484304,Uvis Balinskis,D,FLA,28,6,0,1,1
47,8477320,Anton Blidh,L,NYR,29,15,0,1,1
47,8482094,Daemon Hunt,D,MIN,22,15,0,1,1
47,8482162,Roby Jarventie,L,EDM,22,9,0,1,1
47,8481806,Louis Crevier,D,CHI,23,16,0,1,1
47,8482102,Vasily Ponomarev,C,PIT,22,25,0,1,1
47,8482787,Nikita Chibrikov,R,WPG,31,6,0,1,1
47,8481030,Jack St. Ivany,D,PIT,25,17,0,1,1
47,8482144,Jack Thompson,D,SJS,22,21,0,1,1
47,8477073,Kurtis MacDermid,L,NJD,30,34,0,1,1
47,8474062,Riley Nash,C,NYR,35,20,0,1,1
47,8482476,Emil Heineman,L,MTL,23,7,0,1,1
47,8476323,Max McCormick,L,SEA,32,5,0,1,1
47,8482197,Adam Raska,R,MIN,23,5,0,1,1
47,8481462,Mason Morelli,L,VGK,28,12,0,1,1
47,8483395,Arshdeep Bains,L,VAN,23,14,0,0,0
47,8481043,Cole Koepke,L,BOS,26,19,0,0,0
47,8482201,Gage Goncalves,C,TBL,23,26,0,0,0
47,8482088,Justin Sourdif,R,FLA,22,17,0,0,0
47,8481206,John Ludvig,D,PIT,24,8,0,0,0
47,8475413,Justin Dowling,C,NJD,34,14,0,0,0
47,8481743,Marc Del Gaizo,D,NSH,25,16,0,0,0
47,8481065,Angus Crookshank,L,OTT,25,17,0,0,0
47,8483609,Adam Klapka,R,CGY,24,3,0,0,0
47,8480032,Shane Bowers,C,NJD,25,14,0,0,0
47,8483597,Milos Kelemen,L,UTA,25,11,0,0,0
47,8481578,Graeme Clarke,R,MIN,23,10,0,0,0
47,8480075,Cameron Crotty,D,MIN,25,11,0,0,0
47,8478147,Bokondji Imama,L,PIT,28,5,0,0,0
47,8481699,Aku Raty,R,UTA,23,15,0,0,0
47,8481585,Egor Afanasyev,L,SJS,23,11,0,0,0
47,8483546,Marshall Rifai,D,TOR,26,3,0,0,0
47,8479330,Brandon Gignac,C,MTL,27,6,0,0,0
47,8483471,Brad Lambert,C,WPG,31,5,0,0,0
47,8480306,Grant Hutton,D,NYI,29,6,0,0,0
47,8477149,Scott Sabourin,R,SJS,32,19,0,0,0
47,8480823,Alexander Alexeyev,D,WSH,25,13,0,0,0
47,8477541,Dakota Mermis,D,TOR,30,5,0,0,0
47,8477467,Gustav Olofsson,D,SEA,30,14,0,0,0
47,8483407,Brandon Scanlin,D,NYR,25,5,0,0,0
47,8475780,Chris Wagner,R,COL,33,8,0,0,0
47,8479421,Jacob Moverare,D,LAK,26,4,0,0,0
47,8481024,Linus Karlsson,C,VAN,25,12,0,0,0
47,8483432,Luca Del Bel Belluz,C,CBJ,31,5,0,0,0
47,8483401,Marc Johnstone,R,PIT,28,1,0,0,0
47,8483920,Pierrick Dube,R,WSH,23,6,0,0,0
47,8484326,Patrik Koch,D,UTA,28,6,0,0,0
47,8484255,Jason Polin,R,COL,25,5,0,0,0
47,8477993,Justin Kirkland,C,CGY,28,6,0,0,0
47,8479522,Hardy Haman Aktell,D,WSH,26,3,0,0,0
47,8478854,Ryan Shea,D,PIT,27,5,0,0,0
47,8482126,Emil Andrae,D,PHI,31,0,0,0,0
47,8484259,Ondrej Pavel,C,COL,31,2,0,0,0
47,8484321,Nikolas Matinpalo,D,OTT,26,1,0,0,0
47,8483398,Declan Carlile,D,TBL,31,6,0,0,0
47,8481655,Cole Schwindt,R,CGY,23,3,0,0,0
47,8483531,Brian Halonen,L,NJD,25,2,0,0,0
47,8481534,Raphael Lavoie,C,EDM,24,2,0,0,0
47,8483045,Cameron Butler,R,CBJ,31,1,0,0,0
47,8478956,Samuel Laberge,L,NJD,27,1,0,0,0
47,8480274,Philip Kemp,D,EDM,25,0,0,0,0
47,8470794,Joe Pavelski,C,,40,0,0,0,0
47,8479321,Lucas Johansen,D,,27,0,0,0,0
47,8477950,Tony DeAngelo,D,,29,0,0,0,0
47,8471218,Blake Wheeler,R,,38,0,0,0,0
47,8475197,Tyson Barrie,D,,33,0,0,0,0
47,8474157,Max Pacioretty,L,,36,0,0,0,0
47,8475744,Evgeny Kuznetsov,C,,32,0,0,0,0
47,8474037,James van Riemsdyk,L,,35,0,0,0,0
47,8476907,Mackenzie MacEachern,L,,30,0,0,0,0
47,8480216,Jacob Peterson,C,,25,0,0,0,0
47,8474602,Justin Schultz,D,,34,0,0,0,0
47,8482222,Alexander Barabanov,L,,30,0,0,0,0
47,8474031,Kevin Shattenkirk,D,,35,0,0,0,0
47,8477330,Dominik Kubalik,L,,29,0,0,0,0
47,8480884,Calen Addison,D,,24,0,0,0,0
47,8475906,John Klingberg,D,,32,0,0,0,0
47,8480008,Adam Ruzicka,C,,25,0,0,0,0
47,8476884,Derrick Pouliot,D,,30,0,0,0,0
47,8476919,Chris Tierney,C,,30,0,0,0,0
47,8479415,Michael McLeod,C,,26,0,0,0,0
47,8474870,Tyler Johnson,C,,34,0,0,0,0
47,8470604,Jeff Carter,C,,39,0,0,0,0
47,8478104,Sammy Blais,L,,28,0,0,0,0
47,8474884,Mike Hoffman,C,,35,0,0,0,0
47,8481591,Sam Poulin,R,,23,0,0,0,0
47,8471274,Alex Goligoski,D,,39,0,0,0,0
47,8476871,Tanner Pearson,L,,32,0,0,0,0
47,8476393,Nick Cousins,C,,31,0,0,0,0
47,8479977,Kailer Yamamoto,R,,26,0,0,0,0
47,8479346,Dillon Dube,C,,26,0,0,0,0
47,8480184,Gustav Lindstrom,D,,26,0,0,0,0
47,8479376,Victor Mete,D,,26,0,0,0,0
47,8473449,Kyle Okposo,R,,36,0,0,0,0
47,8481058,Jesse Ylonen,R,,25,0,0,0,0
47,8475752,Tyler Pitlick,C,,33,0,0,0,0
47,8481239,Samuel Fagemo,L,,24,0,0,0,0
47,8480821,Filip Zadina,R,,25,0,0,0,0
47,8470966,Mark Giordano,D,,41,0,0,0,0
47,8478495,Denis Gurianov,R,,27,0,0,0,0
47,8477464,Nic Petan,C,,29,0,0,0,0
47,8478099,Kevin Labanc,R,,29,0,0,0,0
47,8482241,Radim Zohorna,L,,28,0,0,0,0
47,8474040,Sam Gagner,C,,35,0,0,0,0
47,8479514,Rem Pitlick,C,,27,0,0,0,0
47,8478430,Oliver Kylington,D,,27,0,0,0,0
47,8479533,Joona Koppanen,L,,26,0,0,0,0
47,8479984,Cal Foote,D,,26,0,0,0,0
47,8477126,Jayson Megna,C,,34,0,0,0,0
47,8475164,Jakob Silfverberg,R,,34,0,0,0,0
47,8474009,Nick Bonino,C,,36,0,0,0,0
47,8479458,Nikita Zaitsev,D,,33,0,0,0,0
47,8477944,Jakub Vrana,L,,28,0,0,0,0
47,8471699,Andrew Cogliano,C,,37,0,0,0,0
47,8478067,Oskar Lindblom,L,,28,0,0,0,0
47,8471686,Marc Staal,D,,37,0,0,0,0
47,8470610,Zach Parise,L,,40,0,0,0,0
47,8478904,Steven Lorentz,C,,28,0,0,0,0
47,8473473,Milan Lucic,L,,36,0,0,0,0
47,8480031,Maxime Comtois,L,,25,0,0,0,0
47,8478512,Austin Czarnik,C,,32,0,0,0,0
47,8473504,Cal Clutterbuck,R,,37,0,0,0,0
47,8477454,Adam Erne,L,,29,0,0,0,0
47,8479383,Boris Katchouk,L,,26,0,0,0,0
47,8475825,Jani Hakanpää,D,,32,0,0,0,0
47,8477846,Ryan Carpenter,C,,33,0,0,0,0
47,8477930,Pierre-Edouard Bellemare,L,,39,0,0,0,0
47,8478400,Colin White,C,,27,0,0,0,0
47,8480226,Marián Studenic,R,,26,0,0,0,0
47,8480853,Liam Foudy,C,,24,0,0,0,0
47,8475797,Jarred Tinordi,D,,32,0,0,0,0
47,8479423,Alex Nylander,L,,26,0,0,0,0
47,8474618,Marco Scandella,D,,34,0,0,0,0
47,8478028,Fredrik Olofsson,L,,28,0,0,0,0
47,8474709,Matt Martin,L,,35,0,0,0,0
47,8481070,Hugh McGing,L,,26,0,0,0,0
47,8479546,Oskar Steen,C,,26,0,0,0,0
47,8474145,Robert Bortuzzo,D,,35,0,0,0,0
47,8476915,Jujhar Khaira,L,,30,0,0,0,0
47,8475278,Byron Froese,C,,33,0,0,0,0
47,8481812,Nikolai Knyzhov,D,,27,0,0,0,0
47,8478408,Travis Dermott,D,,28,0,0,0,0
47,8481077,John Leonard,L,,26,0,0,0,0
47,8479547,Matthew Phillips,R,,26,0,0,0,0
47,8480836,Jonathan Gruden,C,,24,0,0,0,0
47,8481690,Tyler Angle,C,,24,0,0,0,0
47,8475766,Austin Watson,L,,32,0,0,0,0
47,8481016,Ruslan Iskhakov,C,,24,0,0,0,0
47,8478078,Rourke Chartier,C,,28,0,0,0,0
47,8480776,Sheldon Rempal,R,,29,0,0,0,0
47,8484314,Jiri Smejkal,L,,28,0,0,0,0
48,8478402,Connor McDavid,C,EDM,27,79,62,121,183
48,8477956,David Pastrnak,R,BOS,28,78,61,79,140
48,8477934,Leon Draisaitl,C,EDM,29,82,43,88,131
48,8476453,Nikita Kucherov,R,TBL,31,82,42,84,126
48,8479318,Auston Matthews,C,TOR,27,80,74,51,125
48,8477492,Nathan MacKinnon,C,COL,29,80,48,77,125
48,8478483,Mitch Marner,R,TOR,27,80,34,87,121
48,8476887,Filip Forsberg,L,NSH,30,76,57,58,115
48,8479314,Matthew Tkachuk,L,FLA,27,81,30,84,114
48,8475166,John Tavares,C,TOR,34,82,42,68,110
48,8478420,Mikko Rantanen,R,COL,28,79,49,57,106
48,8480069,Cale Makar,D,COL,26,73,28,77,105
48,8478445,Mathew Barzal,C,NYI,27,79,26,79,105
48,8477409,Carter Verhaeghe,C,FLA,29,79,52,52,104
48,8477493,Aleksander Barkov,C,FLA,29,81,34,67,101
48,8477404,Jake Guentzel,C,TBL,30,82,43,57,100
48,8476468,J.T. Miller,C,VAN,31,77,34,66,100
48,8475172,Nazem Kadri,C,CGY,34,80,38,60,98
48,8478864,Kirill Kaprizov,L,MIN,27,72,42,54,96
48,8477942,Kevin Fiala,L,LAK,28,80,36,59,95
48,8477939,William Nylander,R,TOR,28,79,43,51,94
48,8480027,Jason Robertson,L,DAL,25,82,28,64,92
48,8479323,Adam Fox,D,NYR,26,74,18,74,92
48,8474600,Roman Josi,D,NSH,34,71,30,61,91
48,8480012,Elias Pettersson,C,VAN,26,77,34,56,90
48,8477504,Josh Morrissey,D,WPG,29,74,13,76,89
48,8471675,Sidney Crosby,C,PIT,37,72,41,47,88
48,8479343,Clayton Keller,R,UTA,26,79,36,52,88
48,8480208,Drake Batherson,R,OTT,26,80,35,53,88
48,8477949,Alex Tuch,R,BUF,28,71,27,60,87
48,8481557,Matt Boldy,L,MIN,23,78,41,44,85
48,8477946,Dylan Larkin,C,DET,28,82,34,51,85
48,8478550,Artemi Panarin,L,NYR,33,74,27,58,85
48,8476539,Jonathan Marchessault,R,NSH,34,72,49,35,84
48,8477501,Valeri Nichushkin,R,COL,29,79,39,45,84
48,8480830,Andrei Svechnikov,R,CAR,24,75,39,45,84
48,8480014,Gabriel Vilardi,C,WPG,25,66,47,36,83
48,8481559,Jack Hughes,C,NJD,23,72,32,51,83
48,8478439,Travis Konecny,R,PHI,27,77,34,48,82
48,8478449,Roope Hintz,C,DAL,28,81,32,50,82
48,8479407,Jesper Bratt,L,NJD,26,75,34,47,81
48,8477940,Nikolaj Ehlers,L,WPG,28,74,30,51,81
48,8480023,Robert Thomas,C,STL,25,76,25,56,81
48,8477402,Pavel Buchnevich,L,STL,29,80,34,46,80
48,8478427,Sebastian Aho,C,CAR,27,69,32,47,79
48,8482116,Tim Stützle,C,OTT,22,78,25,54,79
48,8475692,Mats Zuccarello,R,MIN,37,72,23,56,79
48,8480839,Rasmus Dahlin,D,BUF,24,74,16,63,79
48,8477960,Adrian Kempe,R,LAK,28,82,44,34,78
48,8477935,Sam Bennett,C,FLA,28,78,39,38,77
48,8477933,Sam Reinhart,C,FLA,29,76,34,43,77
48,8474564,Steven Stamkos,C,NSH,34,73,30,47,77
48,8480800,Quinn Hughes,D,VAN,25,74,11,66,77
48,8480801,Brady Tkachuk,L,OTT,25,80,34,42,76
48,8476459,Mika Zibanejad,C,NYR,31,76,32,44,76
48,8476881,Tomas Hertl,C,VGK,31,79,31,45,76
48,8484144,Connor Bedard,C,CHI,19,70,30,46,76
48,8478403,Jack Eichel,C,VGK,28,78,39,36,75
48,8479542,Brandon Hagel,L,TBL,26,81,37,38,75
48,8479385,Jordan Kyrou,C,STL,26,74,32,43,75
48,8477951,Nick Schmaltz,C,UTA,28,75,25,50,75
48,8478401,Pavel Zacha,C,BOS,27,78,24,50,74
48,8476905,Chandler Stephenson,C,SEA,30,76,24,50,74
48,8475786,Zach Hyman,L,EDM,32,78,33,40,73
48,8478398,Kyle Connor,L,WPG,28,74,31,42,73
48,8476389,Vincent Trocheck,C,NYR,31,78,23,50,73
48,8478010,Brayden Point,C,TBL,28,82,37,35,72
48,8475158,Ryan O'Reilly,C,NSH,33,75,25,47,72
48,8471685,Anze Kopitar,C,LAK,37,80,24,48,72
48,8476460,Mark Scheifele,C,WPG,31,72,37,34,71
48,8473512,Claude Giroux,R,OTT,36,78,27,44,71
48,8476454,Ryan Nugent-Hopkins,C,EDM,31,76,19,52,71
48,8476853,Morgan Rielly,D,TOR,30,73,11,60,71
48,8475168,Matt Duchene,C,DAL,33,82,37,33,70
48,8475913,Mark Stone,R,VGK,32,75,28,42,70
48,8473419,Brad Marchand,L,BOS,36,80,23,46,69
48,8475810,Bryan Rust,R,PIT,32,71,35,33,68
48,8482740,Wyatt Johnston,C,DAL,21,82,29,39,68
48,8477494,Jonathan Drouin,L,COL,29,81,25,43,68
48,8482078,Lucas Raymond,L,DET,22,81,22,46,68
48,8474578,Erik Karlsson,D,PIT,34,80,20,48,68
48,8480036,Miro Heiskanen,D,DAL,25,78,18,50,68
48,8475184,Chris Kreider,L,NYR,33,76,37,30,67
48,8475784,Jeff Skinner,C,EDM,32,77,35,32,67
48,8477500,Bo Horvat,C,NYI,29,78,28,39,67
48,8477955,Jared McCann,L,SEA,28,75,27,40,67
48,8476346,Johnny Gaudreau,L,CBJ,31,65,22,45,67
48,8476456,Jonathan Huberdeau,C,CGY,31,78,17,50,67
48,8475754,Brock Nelson,C,NYI,33,78,30,36,66
48,8478444,Brock Boeser,R,VAN,27,75,26,40,66
48,8474641,Adam Henrique,C,EDM,34,76,25,41,66
48,8474586,Jordan Eberle,R,SEA,34,77,23,43,66
48,8475167,Victor Hedman,D,TBL,34,79,10,56,66
48,8481540,Cole Caufield,R,MTL,23,75,34,31,65
48,8475794,Tyler Seguin,C,DAL,32,82,30,35,65
48,8478414,Timo Meier,R,NJD,28,78,27,38,65
48,8471215,Evgeni Malkin,C,PIT,38,71,15,50,65
48,8481068,Yegor Sharangovich,C,CGY,26,74,32,32,64
48,8480002,Nico Hischier,C,NJD,25,72,28,36,64
48,8477496,Elias Lindholm,C,BOS,30,78,19,45,64
48,8480865,Noah Dobson,D,NYI,24,81,10,54,64
48,8479420,Tage Thompson,C,BUF,27,73,33,30,63
48,8474141,Patrick Kane,R,DET,36,81,28,35,63
48,8478493,Joel Eriksson Ek,C,MIN,27,72,25,38,63
48,8475745,Charlie Coyle,C,BOS,32,78,23,40,63
48,8482702,Logan Stankoven,C,DAL,21,77,23,40,63
48,8479337,Alex DeBrincat,R,DET,27,80,22,41,63
48,8475726,Tyler Toffoli,C,SJS,32,70,32,30,62
48,8480803,Evan Bouchard,D,EDM,25,75,17,45,62
48,8478460,Zach Werenski,D,CBJ,27,79,13,49,62
48,8482093,Seth Jarvis,C,CAR,22,70,24,37,61
48,8480018,Nick Suzuki,C,MTL,25,73,24,37,61
48,8477416,Oliver Bjorkstrand,R,SEA,29,74,30,30,60
48,8480039,Martin Necas,C,CAR,25,69,26,34,60
48,8471214,Alex Ovechkin,L,WSH,39,69,25,35,60
48,8478047,Michael Bunting,L,PIT,29,69,30,29,59
48,8482110,Dawson Mercer,C,NJD,23,74,29,30,59
48,8475151,Kyle Palmieri,C,NYI,33,78,30,28,58
48,8475765,Vladimir Tarasenko,R,DET,33,81,26,32,58
48,8482699,Dylan Guenther,R,UTA,21,71,26,32,58
48,8475170,Brayden Schenn,C,STL,33,74,25,33,58
48,8473994,Jamie Benn,L,DAL,35,80,18,40,58
48,8479675,Trevor Moore,L,LAK,29,82,28,29,57
48,8483431,Logan Cooley,C,UTA,20,73,26,31,57
48,8481596,Shane Pinto,C,OTT,24,79,23,34,57
48,8477497,Sean Monahan,C,CBJ,30,69,22,35,57
48,8481533,Trevor Zegras,C,ANA,23,74,19,38,57
48,8479999,Casey Mittelstadt,C,COL,26,81,13,44,57
48,8471724,Kris Letang,D,PIT,37,80,9,48,57
48,8478873,Troy Terry,R,ANA,27,70,22,34,56
48,8476448,William Karlsson,C,VGK,31,72,21,35,56
48,8477407,Anthony Duclair,L,NYI,29,78,21,35,56
48,8479400,Pierre-Luc Dubois,L,WSH,26,67,19,37,56
48,8477986,Brandon Montour,D,SEA,30,79,16,40,56
48,8477447,Shea Theodore,D,VGK,29,65,13,43,56
48,8478498,Jake DeBrusk,L,VAN,28,70,23,32,55
48,8478440,Dylan Strome,C,WSH,27,73,21,34,55
48,8482113,Anton Lundell,C,FLA,23,73,19,36,55
48,8478438,Tommy Novak,C,NSH,27,71,18,37,55
48,8480015,Owen Tippett,R,PHI,25,77,32,22,54
48,8476399,Blake Coleman,C,CGY,33,79,27,27,54
48,8484153,Leo Carlsson,C,ANA,20,72,25,29,54
48,8478975,Mason Marchment,L,DAL,29,79,18,36,54
48,8478407,Vince Dunn,D,SEA,28,77,14,40,54
48,8476880,Tom Wilson,R,WSH,30,69,20,33,53
48,8474590,John Carlson,D,WSH,34,67,17,35,52
48,8482665,Matty Beniers,C,SEA,22,74,13,39,52
48,8482684,Luke Hughes,D,NJD,21,72,6,46,52
48,8477476,Artturi Lehkonen,L,COL,29,82,28,23,51
48,8477346,MacKenzie Weegar,D,CGY,30,73,9,42,51
48,8475764,Cam Fowler,D,ANA,33,73,8,43,51
48,8475799,Nino Niederreiter,R,WPG,32,76,27,23,50
48,8477964,Ivan Barbashev,C,VGK,29,78,27,23,50
48,8474102,David Perron,L,OTT,36,76,23,27,50
48,8479992,Michael Rasmussen,C,DET,25,78,20,30,50
48,8476479,Phillip Danault,C,LAK,31,77,18,32,50
48,8473986,Alex Killorn,L,ANA,35,76,17,33,50
48,8477479,Tyler Bertuzzi,L,CHI,29,71,15,35,50
48,8481711,Matias Maccelli,L,UTA,24,74,14,36,50
48,8482124,Quinton Byfield,R,LAK,22,80,13,37,50
48,8475169,Evander Kane,L,EDM,33,78,26,23,49
48,8480459,Pius Suter,C,VAN,28,70,26,23,49
48,8479987,Morgan Geekie,C,BOS,26,74,24,25,49
48,8476882,Teuvo Teravainen,C,CHI,30,63,24,25,49
48,8480188,Fabian Zetterlund,L,SJS,25,67,20,29,49
48,8479325,Charlie McAvoy,D,BOS,27,75,13,36,49
48,8475798,Mikael Granlund,C,SJS,32,66,9,40,49
48,8481542,Moritz Seider,D,DET,23,76,9,40,49
48,8477456,J.T. Compher,L,DET,29,82,22,26,48
48,8478366,Frank Vatrano,R,ANA,30,75,22,26,48
48,8478542,Evan Rodrigues,C,FLA,31,78,21,27,48
48,8479345,Jakob Chychrun,D,WSH,26,68,20,28,48
48,8482667,William Eklund,L,SJS,22,68,19,29,48
48,8483515,Juraj Slafkovsky,L,MTL,20,74,13,35,48
48,8474150,Mikael Backlund,C,CGY,35,79,21,26,47
48,8476432,Boone Jenner,C,CBJ,31,70,19,28,47
48,8479365,Trent Frederic,C,BOS,26,79,24,22,46
48,8476906,Shayne Gostisbehere,D,CAR,31,74,11,35,46
48,8481528,Dylan Cozens,C,BUF,23,71,18,27,45
48,8478042,Viktor Arvidsson,L,EDM,31,70,18,27,45
48,8483808,Andrei Kuzmenko,L,CGY,28,75,17,28,45
48,8476792,Torey Krug,D,STL,33,77,17,28,45
48,8474563,Drew Doughty,D,LAK,35,70,9,36,45
48,8470613,Brent Burns,D,CAR,39,76,9,36,45
48,8478397,Rasmus Andersson,D,CGY,28,78,9,36,45
48,8474679,Gustav Nyquist,C,NSH,35,71,8,37,45
48,8478519,Anthony Cirelli,C,TBL,27,81,23,21,44
48,8475768,Jaden Schwartz,C,SEA,32,73,22,22,44
48,8477021,Alex Kerfoot,C,UTA,30,75,18,26,44
48,8484145,Zach Benson,L,BUF,19,70,16,28,44
48,8480829,Jesperi Kotkaniemi,C,CAR,24,68,16,28,44
48,8481523,Kirby Dach,C,MTL,23,75,16,28,44
48,8483490,Pavel Mintyukov,D,ANA,21,77,11,33,44
48,8480873,Rasmus Sandin,D,WSH,24,63,5,39,44
48,8482109,Alexis Lafrenière,L,NYR,23,75,25,18,43
48,8478233,Andrew Mangiapane,L,WSH,28,72,22,21,43
48,8479525,Ross Colton,C,COL,28,81,22,21,43
48,8477429,Andrew Copp,C,DET,30,77,21,22,43
48,8480113,Alex Iafallo,L,WPG,31,65,20,23,43
48,8481560,Arthur Kaliyev,R,LAK,23,76,19,24,43
48,8477451,Ryan Hartman,R,MIN,30,67,17,26,43
48,8482720,Matthew Knies,L,TOR,22,75,17,26,43
48,8482092,Ridly Greig,C,OTT,22,73,17,26,43
48,8482159,Tyson Foerster,R,PHI,22,77,13,30,43
48,8482149,Cole Perfetti,C,WPG,22,64,13,30,43
48,8471698,T.J. Oshie,R,WSH,38,67,21,21,42
48,8482175,JJ Peterka,R,BUF,22,73,20,22,42
48,8484166,Adam Fantilli,C,CBJ,20,58,18,24,42
48,8478462,Nicolas Roy,C,VGK,27,73,17,25,42
48,8476958,Jaccob Slavin,D,CAR,30,77,10,32,42
48,8478038,Devon Toews,D,COL,30,69,4,38,42
48,8482745,Mason McTavish,C,ANA,21,71,21,20,41
48,8478115,Pierre Engvall,L,NYI,28,78,21,20,41
48,8477505,Alexander Wennberg,C,SJS,30,72,15,26,41
48,8477444,Andre Burakovsky,L,SEA,29,72,12,29,41
48,8479339,Patrik Laine,L,CBJ,26,70,11,30,41
48,8478396,Noah Hanifin,D,VGK,27,59,10,31,41
48,8476875,Mike Matheson,D,MTL,30,71,8,33,41
48,8475722,Jason Zucker,L,BUF,32,70,22,18,40
48,8480797,Joel Farabee,L,PHI,24,75,18,22,40
48,8481186,Logan O'Connor,R,COL,28,81,18,22,40
48,8479425,Filip Hronek,D,VAN,27,74,12,28,40
48,8476869,Brady Skjei,D,NSH,30,71,5,35,40
48,8480893,Kirill Marchenko,R,CBJ,24,64,23,16,39
48,8480009,Eeli Tolvanen,R,SEA,25,71,21,18,39
48,8476483,Rickard Rakell,R,PIT,31,67,19,20,39
48,8480849,Barrett Hayton,C,UTA,24,73,18,21,39
48,8475191,Reilly Smith,R,NYR,33,73,17,22,39
48,8478856,Conor Garland,R,VAN,28,74,13,26,39
48,8477426,Nicholas Paul,L,TBL,29,82,11,28,39
48,8477932,Aaron Ekblad,D,FLA,28,73,10,29,39
48,8478055,Gustav Forsling,D,FLA,28,67,6,33,39
48,8475760,Nick Bjugstad,C,UTA,32,71,23,15,38
48,8475793,Ryan Johansen,C,PHI,32,70,20,18,38
48,8476826,Yanni Gourde,C,SEA,33,72,17,21,38
48,8476438,Brandon Saad,L,STL,32,66,16,22,38
48,8482133,Thomas Bordeleau,C,SJS,22,67,14,24,38
48,8482097,Jack Quinn,R,BUF,23,67,13,25,38
48,8483505,Matthew Poitras,C,BOS,20,70,12,26,38
48,8480434,Sean Durzi,D,UTA,26,71,10,28,38
48,8477495,Seth Jones,D,CHI,30,68,9,29,38
48,8479410,Mikhail Sergachev,D,UTA,26,72,9,29,38
48,8476462,Dougie Hamilton,D,NJD,31,72,9,29,38
48,8481581,Thomas Harley,D,DAL,23,71,8,30,38
48,8473563,Nicklas Backstrom,C,WSH,37,56,8,30,38
48,8478469,Thomas Chabot,D,OTT,27,78,6,32,38
48,8478466,Daniel Sprong,R,VAN,27,78,21,16,37
48,8482705,Cole Sillinger,C,CBJ,21,64,18,19,37
48,8476927,Teddy Blueger,C,VAN,30,61,17,20,37
48,8476419,Jean-Gabriel Pageau,C,NYI,32,76,17,20,37
48,8475848,Brendan Gallagher,R,MTL,32,72,17,20,37
48,8476925,Colton Sissons,C,NSH,31,64,14,23,37
48,8480028,Morgan Frost,C,PHI,25,70,13,24,37
48,8476292,Ondrej Palat,L,NJD,33,72,11,26,37
48,8476463,Jonas Brodin,D,MIN,31,80,9,28,37
48,8476458,Ryan Strome,C,ANA,31,69,9,28,37
48,8476854,Hampus Lindholm,D,BOS,30,72,6,31,37
48,8476923,Damon Severson,D,CBJ,30,80,6,31,37
48,8482055,Drew O'Connor,L,PIT,26,68,21,15,36
48,8480185,Eetu Luostarinen,C,FLA,26,74,19,17,36
48,8473422,Nick Foligno,L,CHI,37,61,16,20,36
48,8479996,Cody Glass,C,NSH,25,65,16,20,36
48,8481524,Bowen Byram,D,BUF,23,62,15,21,36
48,8478891,Mason Appleton,C,WPG,28,73,14,22,36
48,8481577,Philip Tomasino,C,NSH,23,67,11,25,36
48,8480871,Adam Boqvist,D,FLA,24,65,11,25,36
48,8477498,Darnell Nurse,D,EDM,29,73,10,26,36
48,8481618,Alex Newhook,C,MTL,23,68,10,26,36
48,8475753,Justin Faulk,D,STL,32,75,8,28,36
48,8480145,Neal Pionk,D,WPG,29,73,8,28,36
48,8482122,Brock Faber,D,MIN,22,78,6,30,36
48,8481546,Cam York,D,PHI,23,63,5,31,36
48,8476392,Adam Lowry,C,WPG,31,65,17,18,35
48,8478472,Mathieu Joseph,R,STL,27,70,12,23,35
48,8474053,Logan Couture,C,SJS,35,61,10,25,35
48,8477503,Max Domi,C,TOR,29,75,9,26,35
48,8477998,Warren Foegele,L,LAK,28,77,21,13,34
48,8481580,Connor McMichael,C,WSH,23,69,21,13,34
48,8478474,Lawson Crouse,L,UTA,27,73,18,16,34
48,8482125,Alexander Holtz,R,VGK,22,71,16,18,34
48,8481656,Aliaksei Protas,C,WSH,23,58,15,19,34
48,8473533,Jordan Staal,C,CAR,36,61,13,21,34
48,8480817,K'Andre Miller,D,NYR,24,77,10,24,34
48,8474565,Alex Pietrangelo,D,VGK,34,62,6,28,34
48,8480064,Josh Norris,C,OTT,25,72,22,11,33
48,8479368,Max Jones,L,BOS,26,72,18,15,33
48,8475314,Anders Lee,L,NYI,34,78,17,16,33
48,8481604,Pavel Dorofeyev,L,VGK,24,65,16,17,33
48,8476921,Jordan Martinook,L,CAR,32,64,16,17,33
48,8477425,Miles Wood,L,COL,29,80,15,18,33
48,8476480,Vladislav Namestnikov,C,WPG,32,62,13,20,33
48,8476474,Stefan Noesen,R,NJD,31,63,13,20,33
48,8480789,Oliver Wahlstrom,R,NYI,24,71,12,21,33
48,8480336,Sean Walker,D,CAR,30,72,11,22,33
48,8478109,Victor Olofsson,L,VGK,29,75,9,24,33
48,8475149,Marcus Johansson,L,MIN,34,58,9,24,33
48,8480855,Jack McBain,C,UTA,24,67,9,24,33
48,8480802,Ryan McLeod,C,BUF,25,67,18,14,32
48,8481554,Kaapo Kakko,R,NYR,23,66,17,15,32
48,8481535,Nils Hoglander,L,VAN,24,75,16,16,32
48,8477511,Anthony Mantha,R,CGY,30,78,15,17,32
48,8478057,Dakota Joshua,C,VAN,28,60,15,17,32
48,8476872,Scott Laughton,C,PHI,30,69,13,19,32
48,8481703,Valtteri Puustinen,R,PIT,25,64,10,22,32
48,8475218,Mattias Ekholm,D,EDM,34,64,8,24,32
48,8482105,Jake Sanderson,D,OTT,22,77,5,27,32
48,8478046,Danton Heinen,L,VAN,29,66,14,17,31
48,8475763,Kevin Hayes,R,PIT,32,68,14,17,31
48,8477839,Conor Sheary,L,TBL,32,81,14,17,31
48,8478458,John (Jack) Roslovic,C,CAR,27,73,12,19,31
48,8480043,Timothy Liljegren,D,TOR,25,69,5,26,31
48,8478507,John Marino,D,UTA,27,67,5,26,31
48,8479398,Samuel Girard,D,COL,26,58,4,27,31
48,8475714,Calle Jarnkrok,C,TOR,33,75,15,15,30
48,8482475,Yegor Chinakhov,R,CBJ,23,61,14,16,30
48,8477987,Ryan Donato,C,CHI,28,64,13,17,30
48,8479591,Michael Eyssimont,C,TBL,28,76,12,18,30
48,8474716,Jared Spurgeon,D,MIN,35,72,8,22,30
48,8476885,Jacob Trouba,D,NYR,30,69,8,22,30
48,8482089,Jake Neighbours,L,STL,22,67,19,10,29
48,8482146,Luke Evangelista,R,NSH,22,70,15,14,29
48,8474149,Evgenii Dadonov,R,DAL,35,81,13,16,29
48,8480078,Filip Chytil,C,NYR,25,65,13,16,29
48,8477989,Christian Dvorak,C,MTL,28,66,10,19,29
48,8482671,Owen Power,D,BUF,22,74,9,20,29
48,8477969,Marcus Pettersson,D,PIT,28,75,7,22,29
48,8482074,Connor Zary,C,CGY,23,63,15,13,28
48,8479390,Taylor Raddysh,R,WSH,26,64,13,15,28
48,8481704,Juuso Parssinen,C,NSH,23,59,13,15,28
48,8475855,Jesper Fast,R,CAR,33,59,13,15,28
48,8481553,Bobby Brink,R,PHI,23,70,12,16,28
48,8475231,Casey Cizikas,C,NYI,33,75,12,16,28
48,8482749,Joshua Roy,R,MTL,21,66,12,16,28
48,8475287,Erik Haula,L,NJD,33,75,11,17,28
48,8477919,Frederick Gaudreau,C,MIN,31,63,8,20,28
48,8479976,Juuso Valimaki,D,UTA,26,65,7,21,28
48,8481522,Peyton Krebs,C,BUF,23,69,6,22,28
48,8478851,Alexandre Carrier,D,NSH,28,68,4,24,28
48,8476331,Dylan DeMelo,D,WPG,31,73,4,24,28
48,8477948,Travis Sanheim,D,PHI,28,68,3,25,28
48,8478882,Vladislav Gavrikov,D,LAK,29,71,2,26,28
48,8476981,Josh Anderson,R,MTL,30,64,14,13,27
48,8476897,Oskar Sundqvist,C,STL,30,66,12,15,27
48,8476918,Jimmy Vesey,L,NYR,31,64,11,16,27
48,8481582,Nicholas Robertson,L,TOR,23,70,11,16,27
48,8477450,Jason Dickinson,C,CHI,29,62,10,17,27
48,8483482,Tristan Luneau,D,ANA,20,66,9,18,27
48,8483445,Cutter Gauthier,L,ANA,20,66,7,20,27
48,8480220,Noah Cates,L,PHI,25,60,6,21,27
48,8475171,Oliver Ekman-Larsson,D,TOR,33,63,6,21,27
48,8478500,Ivan Provorov,D,CBJ,27,81,4,23,27
48,8477506,Ryan Pulock,D,NYI,30,77,4,23,27
48,8476891,Matthew Grzelcyk,D,PIT,30,79,3,24,27
48,8479293,Brandon Tanev,L,SEA,33,65,18,8,26
48,8479941,Justin Danforth,R,CBJ,31,53,17,9,26
48,8478508,Yakov Trenin,C,MIN,27,60,15,11,26
48,8480281,Alexey Toropchenko,R,STL,25,60,14,12,26
48,8478585,Derek Ryan,C,EDM,38,69,14,12,26
48,8482660,Kent Johnson,C,CBJ,22,63,10,16,26
48,8476461,Sean Couturier,C,PHI,32,70,8,18,26
48,8480068,Ryan Poehling,C,PHI,25,63,8,18,26
48,8481606,Jordan Spence,D,LAK,23,65,8,18,26
48,8478133,Jake Evans,C,MTL,28,69,8,18,26
48,8478451,Ethan Bear,D,WSH,27,61,8,18,26
48,8484203,Bradly Nadeau,L,CAR,19,64,5,21,26
48,8482712,Oskar Olausson,R,COL,22,78,3,23,26
48,8476469,Joel Armia,R,MTL,31,67,15,10,25
48,8475193,Tomas Tatar,L,NJD,34,63,12,13,25
48,8479661,Tanner Jeannot,L,LAK,27,75,11,14,25
48,8477952,Robby Fabbri,C,ANA,28,65,11,14,25
48,8480835,Jack Drury,C,CAR,24,64,11,14,25
48,8474715,Cameron Atkinson,R,TBL,35,81,10,15,25
48,8482117,Lukas Reichel,L,CHI,22,57,9,16,25
48,8482624,Daniil Miromanov,D,CGY,27,62,7,18,25
48,8480995,Pontus Holmberg,R,TOR,25,63,7,18,25
48,8479353,Brett Howden,C,VGK,26,64,7,18,25
48,8478911,Matt Roy,D,WSH,29,58,4,21,25
48,8475324,Nick Jensen,D,OTT,34,68,3,22,25
48,8475455,Brenden Dillon,D,NJD,34,57,1,24,25
48,8480798,Philipp Kurashev,C,CHI,25,65,14,10,24
48,8478413,Jordan Greenway,L,BUF,27,67,13,11,24
48,8475343,Nic Dowd,C,WSH,34,58,13,11,24
48,8481477,Nico Sturm,C,SJS,29,57,13,11,24
48,8480025,MacKenzie Entwistle,R,FLA,25,67,13,11,24
48,8482079,Marco Rossi,C,MIN,23,56,13,11,24
48,8477392,Hudson Fasching,R,NYI,29,57,12,12,24
48,8483491,Ivan Miroshnichenko,L,WSH,20,56,10,14,24
48,8478463,Anthony Beauvillier,L,PIT,27,71,9,15,24
48,8481093,Rafael Harvey-Pinard,L,MTL,25,59,9,15,24
48,8476312,Josh Manson,D,COL,33,66,9,15,24
48,8482737,Zack Bolduc,C,STL,21,53,9,15,24
48,8483468,Jiri Kulich,C,BUF,20,52,8,16,24
48,8480748,Kiefer Sherwood,L,VAN,29,66,7,17,24
48,8477953,Kasperi Kapanen,R,STL,28,68,7,17,24
48,8479351,Sam Steel,C,DAL,26,80,6,18,24
48,8476467,Jamie Oleksiak,D,SEA,32,59,6,18,24
48,8475791,Taylor Hall,L,CHI,33,54,5,19,24
48,8480878,Nils Lundkvist,D,DAL,24,70,4,20,24
48,8482067,Connor Mackey,D,NYR,28,59,4,20,24
48,8475790,Erik Gudbranson,D,CBJ,32,77,3,21,24
48,8477220,Nate Schmidt,D,FLA,33,61,1,23,24
48,8479402,Jake Bean,D,CGY,26,68,1,23,24
48,8477903,Garnet Hathaway,R,PHI,33,61,14,9,23
48,8478434,Keegan Kolesar,R,VGK,27,65,12,11,23
48,8475220,Marcus Foligno,L,MIN,33,60,12,11,23
48,8480003,Jesper Boqvist,C,FLA,26,76,11,12,23
48,8478432,Christian Fischer,R,DET,27,75,10,13,23
48,8476422,Mike Reilly,D,NYI,31,75,6,17,23
48,8478136,Jake Middleton,D,MIN,28,75,5,18,23
48,8480222,Sebastian Aho,D,PIT,28,69,5,18,23
48,8474151,Ryan McDonagh,D,TBL,35,78,3,20,23
48,8476879,Cody Ceci,D,EDM,31,70,3,20,23
48,8480035,Henri Jokiharju,D,BUF,25,59,2,21,23
48,8476874,Olli Maatta,D,DET,30,61,2,21,23
48,8481624,Ilya Mikheyev,R,CHI,30,64,13,9,22
48,8478020,Michael Amadio,R,OTT,28,74,11,11,22
48,8476878,Zemgus Girgensons,C,TBL,30,78,9,13,22
48,8475200,Dmitry Orlov,D,CAR,33,75,9,13,22
48,8477507,Nikita Zadorov,D,BOS,29,73,9,13,22
48,8482148,Hendrix Lapierre,C,WSH,22,52,8,14,22
48,8479328,Julien Gauthier,R,NYI,27,62,8,14,22
48,8476902,Esa Lindell,D,DAL,30,74,5,17,22
48,8479982,Conor Timmins,D,TOR,26,55,4,18,22
48,8482142,Jamie Drysdale,D,PHI,22,65,3,19,22
48,8482655,Janis Moser,D,TBL,24,79,2,20,22
48,8476457,Adam Larsson,D,SEA,32,70,2,20,22
48,8478840,Will Borgen,D,SEA,28,70,0,22,22
48,8481032,Paul Cotter,C,NJD,25,61,17,4,21
48,8470621,Corey Perry,R,EDM,39,70,14,7,21
48,8476278,Colin Blackwell,C,DAL,31,77,14,7,21
48,8482679,Matt Coronato,R,CGY,22,65,13,8,21
48,8480813,Joe Veleno,C,DET,24,76,12,9,21
48,8477979,Nicolas Aube-Kubel,R,BUF,28,56,10,11,21
48,8481028,Martin Pospisil,C,CGY,25,58,10,11,21
48,8480021,Jack Studnicka,C,LAK,25,57,10,11,21
48,8482809,Jackson Blake,R,CAR,21,52,9,12,21
48,8480448,Parker Kelly,L,COL,25,77,9,12,21
48,8483499,Liam Ohgren,L,MIN,20,55,8,13,21
48,8476873,Mark Jankowski,C,NSH,30,55,7,14,21
48,8479315,Joey Anderson,R,CHI,26,48,6,15,21
48,8477508,Curtis Lazar,C,NJD,29,62,6,15,21
48,8480144,David Kampf,C,TOR,29,67,5,16,21
48,8477488,Brett Pesce,D,NJD,30,64,5,16,21
48,8477353,Tyler Motte,C,DET,29,71,13,7,20
48,8481481,Blake Lizotte,C,PIT,27,67,13,7,20
48,8479718,Alex Barré-Boulet,C,MTL,27,47,10,10,20
48,8482101,Danil Gushchin,L,SJS,22,54,9,11,20
48,8479066,Ryan Lomberg,L,CGY,30,65,9,11,20
48,8474189,Lars Eller,C,PIT,35,61,8,12,20
48,8477380,Jonny Brodzinski,C,NYR,31,59,8,12,20
48,8477947,Sonny Milano,L,WSH,28,57,7,13,20
48,8479639,Dylan Coghlan,D,WPG,26,55,6,14,20
48,8476931,Jake McCabe,D,TOR,31,65,6,14,20
48,8482176,Wyatt Kaiser,D,CHI,22,53,6,14,20
48,8482111,Justin Barron,D,MTL,23,66,6,14,20
48,8478013,Jake Walman,D,SJS,28,70,5,15,20
48,8476917,Adam Pelech,D,NYI,30,78,4,16,20
48,8477435,Ryan Graves,D,PIT,29,71,4,16,20
48,8479369,Andrew Peeke,D,BOS,26,60,4,16,20
48,8476892,Colton Parayko,D,STL,31,67,3,17,20
48,8480049,Dylan Samberg,D,WPG,25,61,2,18,20
48,8477406,Mattias Janmark,C,EDM,32,66,13,6,19
48,8476374,Sean Kuraly,C,CBJ,31,55,12,7,19
48,8483493,Frank Nazar,C,CHI,20,56,9,10,19
48,8479393,Noah Gregor,L,OTT,26,76,8,11,19
48,8480205,Emil Bemstrom,C,PIT,25,58,8,11,19
48,8479983,Mario Ferraro,D,SJS,26,71,8,11,19
48,8481521,Ronnie Attard,D,PHI,25,54,8,11,19
48,8480172,Jan Rutta,D,SJS,34,66,6,13,19
48,8478970,Jalen Chatfield,D,CAR,28,65,5,14,19
48,8481441,Joe Snively,C,DET,28,62,5,14,19
48,8480891,Michael Kesselring,D,UTA,24,59,4,15,19
48,8476979,Erik Gustafsson,D,DET,32,73,3,16,19
48,8476429,Scott Mayfield,D,NYI,32,75,3,16,19
48,8475181,Nick Leddy,D,STL,33,71,1,18,19
48,8479371,Dante Fabbro,D,NSH,26,65,1,18,19
48,8481568,Alex Vlasic,D,CHI,23,50,1,18,19
48,8477446,Michael McCarron,R,NSH,29,48,13,5,18
48,8479359,Beck Malenstyn,L,BUF,26,45,10,8,18
48,8479414,Nathan Bastian,R,NJD,27,57,9,9,18
48,8477015,Connor Brown,R,EDM,30,70,6,12,18
48,8477931,Tomas Nosek,L,FLA,32,61,6,12,18
48,8479372,Joshua Mahura,D,SEA,26,51,6,12,18
48,8482087,Kaiden Guhle,D,MTL,22,66,5,13,18
48,8480762,Eric Robinson,L,CAR,29,54,4,14,18
48,8475188,Brayden McNabb,D,VGK,33,57,3,15,18
48,8482073,Braden Schneider,D,NYR,23,64,2,16,18
48,8479980,Nicolas Hague,D,VGK,26,57,2,16,18
48,8482245,Artem Zub,D,OTT,29,61,2,16,18
48,8478443,Brandon Carlo,D,BOS,28,57,1,17,18
48,8475842,Sam Carrick,C,NYR,32,60,13,4,17
48,8481601,Simon Holmstrom,R,NYI,23,72,11,6,17
48,8481517,Brett Leason,R,ANA,25,53,11,6,17
48,8476889,Radek Faksa,C,STL,30,55,9,8,17
48,8476994,Vinnie Hinostroza,C,NSH,30,47,8,9,17
48,8482451,Mikael Pyyhtia,L,CBJ,23,48,8,9,17
48,8480073,Erik Brannstrom,D,COL,25,62,6,11,17
48,8478399,Jonas Siegenthaler,D,NJD,27,61,4,13,17
48,8476525,Colin Miller,D,WPG,32,56,4,13,17
48,8479619,Michael Carcone,L,UTA,28,63,12,4,16
48,8481716,Dmitri Voronkov,L,CBJ,24,52,12,4,16
48,8482259,Bobby McMann,C,TOR,28,57,12,4,16
48,8482803,Olen Zellweger,D,ANA,21,57,7,9,16
48,8474034,Patrick Maroon,L,CHI,36,51,7,9,16
48,8476960,Andreas Athanasiou,C,CHI,30,56,7,9,16
48,8480157,Calle Rosen,D,COL,30,51,7,9,16
48,8483524,Shane Wright,C,SEA,20,59,6,10,16
48,8476822,Luke Glendening,C,TBL,35,79,6,10,16
48,8473453,Trevor Lewis,C,LAK,37,72,5,11,16
48,8483457,Lane Hutson,D,MTL,20,65,5,11,16
48,8478211,Dryden Hunt,L,CGY,29,53,5,11,16
48,8482733,Logan Mailloux,D,MTL,31,41,5,11,16
48,8483565,Nick Blankenburg,D,NSH,26,56,4,12,16
48,8477070,Liam O'Brien,C,UTA,30,55,4,12,16
48,8473507,Jeff Petry,D,DET,37,69,3,13,16
48,8478416,Erik Cernak,D,TBL,27,72,3,13,16
48,8479998,Mikey Anderson,D,LAK,25,66,2,14,16
48,8481641,Joel Kiviranta,L,COL,28,67,9,6,15
48,8480011,Klim Kostin,C,SJS,25,48,8,7,15
48,8482155,Alex Laferriere,R,LAK,23,62,7,8,15
48,8476988,Matt Benning,D,SJS,30,61,7,8,15
48,8479316,Luke Kunin,C,SJS,27,56,6,9,15
48,8484149,Gavin Brindley,C,CBJ,20,54,6,9,15
48,8481599,Victor Soderstrom,D,UTA,23,44,6,9,15
48,8482634,Alex Steeves,C,TOR,25,53,5,10,15
48,8478043,Sam Lafferty,C,BUF,29,54,5,10,15
48,8481600,Tobias Bjornfot,D,FLA,23,39,5,10,15
48,8482192,Isaak Phillips,D,CHI,23,55,4,11,15
48,8475233,David Savard,D,MTL,34,64,4,11,15
48,8475690,Chris Tanev,D,TOR,35,61,4,11,15
48,8474673,TJ Brodie,D,CHI,34,62,3,12,15
48,8478859,Niko Mikkola,D,FLA,28,56,3,12,15
48,8480246,Nick Perbix,D,TBL,26,73,3,12,15
48,8477365,Connor Clifton,D,BUF,29,52,3,12,15
48,8474013,Ian Cole,D,UTA,35,53,3,12,15
48,8474574,Tyler Myers,D,VAN,34,66,2,13,15
48,8481527,Kaedan Korczak,D,VGK,23,44,2,13,15
48,8480196,Jacob Bryson,D,BUF,27,46,1,14,15
48,8478569,Noel Acciari,C,PIT,33,58,8,6,14
48,8477478,William Carrier,L,CAR,30,55,8,6,14
48,8482744,James Malatesta,L,CBJ,21,40,7,7,14
48,8480074,Alexandre Texier,C,STL,25,59,6,8,14
48,8480355,Mark Kastelic,C,BOS,25,57,6,8,14
48,8481550,Adam Beckman,L,NJD,23,34,6,8,14
48,8479972,Mason Shaw,C,WPG,26,39,5,9,14
48,8479370,Tyson Jost,C,CAR,26,51,4,10,14
48,8479026,Philippe Myers,D,TOR,27,55,4,10,14
48,8481537,Nikita Okhotiuk,D,CGY,24,51,4,10,14
48,8478178,Darren Raddysh,D,TBL,28,64,3,11,14
48,8477845,Trevor van Riemsdyk,D,WSH,33,61,3,11,14
48,8474166,Alec Martinez,D,CHI,37,53,3,11,14
48,8475718,Justin Holl,D,DET,32,58,2,12,14
48,8481019,David Gustafsson,C,WPG,24,40,2,12,14
48,8471709,Marc-Edouard Vlasic,D,SJS,37,65,1,13,14
48,8476934,Brock McGinn,L,ANA,30,50,9,4,13
48,8479336,Carl Grundstrom,R,SJS,27,45,9,4,13
48,8476329,Travis Boyd,C,MIN,31,58,7,6,13
48,8482784,Zach Dean,C,STL,21,45,6,7,13
48,8482964,Arber Xhekaj,D,MTL,23,49,6,7,13
48,8480289,Morgan Barron,C,WPG,26,49,5,8,13
48,8479543,Michael Pezzetta,L,MTL,26,55,5,8,13
48,8478409,Anthony Richard,C,PHI,28,37,5,8,13
48,8479994,Jaret Anderson-Dolan,C,WPG,25,38,5,8,13
48,8479671,Mathieu Olivier,R,CBJ,27,45,4,9,13
48,8477499,Rasmus Ristolainen,D,PHI,30,59,4,9,13
48,8476624,Barclay Goodrow,C,SJS,31,49,3,10,13
48,8475279,Ben Chiarot,D,DET,33,70,3,10,13
48,8482166,Shakir Mukhamadullin,D,SJS,22,58,3,10,13
48,8482730,Brandt Clarke,D,LAK,21,47,3,10,13
48,8478468,Jeremy Lauzon,D,NSH,27,53,3,10,13
48,8479344,Jesse Puljujarvi,R,PIT,26,53,2,11,13
48,8470600,Ryan Suter,D,STL,39,56,2,11,13
48,8476967,Brett Kulak,D,EDM,30,66,2,11,13
48,8479348,Kale Clague,D,BUF,26,42,2,11,13
48,8476952,Dominic Toninato,C,WPG,30,40,2,11,13
48,8471677,Jack Johnson,D,CBJ,37,68,1,12,13
48,8480887,Jordan Harris,D,MTL,24,46,0,13,13
48,8475225,Craig Smith,C,CHI,35,48,8,4,12
48,8481789,Tye Kartye,L,SEA,23,41,8,4,12
48,8478424,Jansen Harkins,C,ANA,27,48,8,4,12
48,8479520,Brandon Duhaime,R,WSH,27,61,7,5,12
48,8478421,A.J. Greer,L,FLA,28,49,6,6,12
48,8477369,Carson Soucy,D,VAN,30,59,6,6,12
48,8476856,Mathew Dumba,D,DAL,30,72,5,7,12
48,8480950,Ilya Lyubushkin,D,DAL,30,64,5,7,12
48,8480845,Rasmus Kupari,C,WPG,24,46,5,7,12
48,8480058,Pierre-Olivier Joseph,D,STL,25,55,4,8,12
48,8476867,Brendan Gaunce,C,MIN,30,43,4,8,12
48,8475177,Calvin de Haan,D,COL,33,43,4,8,12
48,8479324,Ryan Lindgren,D,NYR,26,66,3,9,12
48,8475462,Radko Gudas,D,ANA,34,70,3,9,12
48,8482511,Mason Lohrei,D,BOS,23,31,3,9,12
48,8483460,David Jiricek,D,CBJ,21,57,2,10,12
48,8481014,Alexander Romanov,D,NYI,24,78,1,11,12
48,8480001,Urho Vaakanainen,D,ANA,25,57,0,12,12
48,8482157,Will Cuylle,L,NYR,22,59,6,5,11
48,8480980,Connor Dewar,C,TOR,25,64,6,5,11
48,8482659,Josh Doan,R,UTA,22,51,6,5,11
48,8483495,Simon Nemec,D,NJD,20,55,5,6,11
48,8479439,Jacob MacDonald,D,COL,31,56,4,7,11
48,8480848,Ty Dellandrea,C,SJS,24,48,4,7,11
48,8481161,Jake Christiansen,D,CBJ,25,50,4,7,11
48,8481167,Brayden Pachal,D,CGY,25,41,4,7,11
48,8475958,Michael Sgarbossa,C,WSH,32,30,4,7,11
48,8480860,Kevin Bahl,D,CGY,24,54,3,8,11
48,8480796,Martin Fehervary,D,WSH,25,55,3,8,11
48,8481592,Jakob Pelletier,L,CGY,23,41,3,8,11
48,8481013,Jonatan Berggren,R,DET,24,58,3,8,11
48,8482666,Scott Morrow,D,CAR,22,53,2,9,11
48,8481056,Spencer Stastney,D,NSH,24,41,2,9,11
48,8475750,Jon Merrill,D,MIN,32,63,2,9,11
48,8481708,Zac Jones,D,NYR,24,51,1,10,11
48,8482861,Vincent Iorio,D,WSH,22,30,1,10,11
48,8479249,Andrew Poturalski,C,SJS,30,26,1,10,11
48,8475179,Dmitry Kulikov,D,FLA,34,65,0,11,11
48,8479638,Justin Brazeau,R,BOS,26,38,8,2,10
48,8482762,Simon Edvinsson,D,DET,21,52,7,3,10
48,8475235,Nicolas Deslauriers,L,PHI,33,60,7,3,10
48,8482747,Brennan Othmann,L,NYR,21,41,6,4,10
48,8482062,Cole Smith,L,NSH,29,49,5,5,10
48,8480252,Cole Guttman,C,CHI,25,36,5,5,10
48,8480806,Isac Lundestrom,C,ANA,25,55,3,7,10
48,8482807,Ethan Del Mastro,D,CHI,21,49,3,7,10
48,8480879,Jacob Bernard-Docker,D,OTT,24,48,3,7,10
48,8481617,Vasily Podkolzin,R,VAN,23,40,2,8,10
48,8479442,Troy Stecher,D,EDM,30,49,2,8,10
48,8473446,Erik Johnson,D,PHI,36,44,1,9,10
48,8481059,Scott Perunovich,D,STL,26,55,0,10,10
48,8481178,Egor Zamula,D,PHI,24,55,0,10,10
48,8478831,Kevin Stenlund,C,UTA,28,52,5,4,9
48,8481598,Philip Broberg,D,EDM,23,51,4,5,9
48,8483549,Lucas Condotta,L,MTL,27,36,4,5,9
48,8480007,Jonas Rondbjerg,R,VGK,25,33,4,5,9
48,8476442,Matt Nieto,L,PIT,32,48,3,6,9
48,8482153,Brendan Brisson,C,VGK,23,30,3,6,9
48,8476858,Phillip Di Giuseppe,L,VAN,31,40,3,6,9
48,8479991,Jake Leschyshyn,C,NYR,25,26,3,6,9
48,8481518,Nolan Foote,L,NJD,24,44,2,7,9
48,8480870,Bo Groulx,C,NYR,24,36,2,7,9
48,8482095,Tyler Kleven,D,OTT,22,46,2,7,9
48,8483012,Logan Morrison,C,SEA,22,37,2,7,9
48,8477573,Nathan Walker,L,STL,30,47,1,8,9
48,8477034,Jaycob Megna,D,FLA,32,48,1,8,9
48,8478454,Noah Juulsen,D,VAN,27,31,1,8,9
48,8478452,Caleb Jones,D,LAK,27,61,0,9,9
48,8479968,Vinni Lettieri,C,BOS,29,50,5,3,8
48,8483466,Kevin Korchinski,D,CHI,20,49,5,3,8
48,8482077,Dylan Holloway,L,EDM,23,43,4,4,8
48,8482859,Zack Ostapchuk,C,OTT,21,50,4,4,8
48,8477482,Zachary Sanford,L,CHI,30,35,3,5,8
48,8482177,Marat Khusnutdinov,C,MIN,22,30,3,5,8
48,8481605,Jackson LaCombe,D,ANA,23,34,3,5,8
48,8480880,Jakub Lauko,C,MIN,24,33,3,5,8
48,8475208,Brian Dumoulin,D,ANA,33,58,2,6,8
48,8480292,Carson Meyer,R,ANA,27,33,2,6,8
48,8481147,Reese Johnson,C,MIN,26,39,2,6,8
48,8481609,Vladislav Kolyachonok,D,UTA,23,32,1,7,8
48,8476372,Nick Seeler,D,PHI,31,48,1,7,8
48,8481532,Alex Turcotte,C,LAK,23,46,5,2,7
48,8482070,Mitchell Chaffee,R,TBL,26,53,5,2,7
48,8480192,Johnathan Kovacevic,D,NJD,27,51,4,3,7
48,8479291,Kevin Rooney,C,CGY,31,46,4,3,7
48,8471817,Ryan Reaves,R,TOR,37,52,4,3,7
48,8474568,Luke Schenn,D,NSH,35,45,3,4,7
48,8481751,Lukas Rousek,R,BUF,25,37,3,4,7
48,8477962,Brendan Lemieux,L,CAR,28,36,3,4,7
48,8480441,Trey Fix-Wolansky,R,CBJ,25,43,3,4,7
48,8482652,Walker Duehr,R,CGY,27,38,3,4,7
48,8479985,Cale Fleury,D,SEA,26,29,3,4,7
48,8477887,Patrick Brown,C,BOS,32,50,2,5,7
48,8479944,Zach Aston-Reese,C,VGK,30,52,2,5,7
48,8479986,Kole Lind,R,DAL,26,52,2,5,7
48,8480807,Mattias Samuelsson,D,BUF,24,50,1,6,7
48,8477462,Robert Hagg,D,VGK,29,30,1,6,7
48,8480727,Zach Whitecloud,D,VGK,28,42,1,6,7
48,8477018,Ben Hutton,D,VGK,31,48,0,7,7
48,8482751,Ryan Winterton,C,SEA,21,31,5,1,6
48,8476913,Devin Shore,C,MIN,30,40,4,2,6
48,8484911,Collin Graf,R,SJS,22,41,4,2,6
48,8480245,Olle Lycksell,R,PHI,25,34,4,2,6
48,8481030,Jack St. Ivany,D,PIT,25,18,3,3,6
48,8481754,Nikita Nesterenko,C,ANA,23,27,2,4,6
48,8474567,Zach Bogosian,D,MIN,34,62,2,4,6
48,8484254,Akito Hirose,D,VAN,25,44,2,4,6
48,8480070,Ian Mitchell,D,BOS,25,46,2,4,6
48,8482765,Isak Rosen,R,BUF,21,27,2,4,6
48,8477384,Joshua Brown,D,EDM,30,44,2,4,6
48,8480084,Nick DeSimone,D,NJD,30,25,2,4,6
48,8474612,Travis Hamonic,D,OTT,34,47,1,5,6
48,8483619,Filip Roos,D,OTT,25,39,1,5,6
48,8482162,Roby Jarventie,L,EDM,22,16,5,0,5
48,8474090,Brendan Smith,D,DAL,35,52,4,1,5
48,8482496,Nils Aman,C,VAN,24,36,3,2,5
48,8482145,Mavrik Bourque,C,DAL,22,49,3,2,5
48,8482713,Mackie Samoskevich,R,FLA,22,31,3,2,5
48,8483630,Pavol Regenda,L,ANA,25,34,3,2,5
48,8477938,Haydn Fleury,D,WPG,28,52,2,3,5
48,8479378,Logan Stanley,D,WPG,26,48,2,3,5
48,8483397,Marc McLaughlin,C,BOS,25,29,2,3,5
48,8482470,Ilya Solovyov,D,CGY,24,20,2,3,5
48,8479362,Riley Tufte,L,BOS,26,19,2,3,5
48,8477320,Anton Blidh,L,NYR,29,22,2,3,5
48,8482144,Jack Thompson,D,SJS,22,28,2,3,5
48,8478017,Mark Friedman,D,VAN,29,45,1,4,5
48,8481567,Henry Thrun,D,SJS,23,44,1,4,5
48,8480834,Ty Emberson,D,SJS,24,29,1,4,5
48,8478146,Matthew Highmore,C,OTT,28,31,1,4,5
48,8482250,Callahan Burke,C,VGK,27,34,1,4,5
48,8476441,Joel Edmundson,D,LAK,31,33,0,5,5
48,8483763,Maksymilian Szuber,D,UTA,22,27,0,5,5
48,8477335,Kyle Burroughs,D,LAK,29,35,0,5,5
48,8481556,John Beecher,C,BOS,23,32,3,1,4
48,8480990,Declan Chisholm,D,MIN,24,32,3,1,4
48,8478881,Brett Seney,L,CHI,28,7,3,1,4
48,8481541,Samuel Bolduc,D,NYI,24,26,2,2,4
48,8478874,Adam Gaudette,R,OTT,28,35,2,2,4
48,8477473,Justin Bailey,R,SJS,29,25,2,2,4
48,8479379,Givani Smith,R,SJS,26,28,2,2,4
48,8480468,James Hamblin,L,EDM,25,14,2,2,4
48,8478502,Dennis Gilbert,D,BUF,28,21,2,2,4
48,8477073,Kurtis MacDermid,L,NJD,30,32,2,2,4
48,8477467,Gustav Olofsson,D,SEA,30,16,2,2,4
48,8484287,Cole McWard,D,VAN,23,25,1,3,4
48,8478477,Mitchell Stephens,C,SEA,27,24,1,3,4
48,8483512,Matthew Savoie,C,EDM,20,19,1,3,4
48,8477401,John Hayden,C,SEA,29,20,1,3,4
48,8482929,Emil Lilleberg,D,TBL,23,26,1,3,4
48,8481006,Tyler Tucker,D,STL,24,16,1,3,4
48,8481462,Mason Morelli,L,VGK,28,13,1,3,4
48,8479536,Axel Jonsson-Fjallby,L,WPG,26,29,0,4,4
48,8477810,Joel Hanley,D,CGY,33,30,0,4,4
48,8478021,William Lagesson,D,DET,28,33,0,4,4
48,8481743,Marc Del Gaizo,D,NSH,25,22,0,4,4
48,8484258,Sam Malinski,D,COL,26,14,3,0,3
48,8478051,Max Willman,C,NJD,29,18,3,0,3
48,8481237,Kyle MacLean,C,NYI,25,24,3,0,3
48,8481585,Egor Afanasyev,L,SJS,23,17,3,0,3
48,8482141,Lukas Cormier,D,VGK,22,28,2,1,3
48,8479772,Zack MacEwen,R,OTT,28,55,2,1,3
48,8478446,Glenn Gawdin,C,LAK,27,21,2,1,3
48,8482147,Jean-Luc Foudy,C,COL,22,27,2,1,3
48,8482165,Yan Kuznetsov,D,CGY,22,15,2,1,3
48,8484325,Waltteri Merela,C,TBL,26,21,2,1,3
48,8476473,Connor Murphy,D,CHI,31,36,1,2,3
48,8479367,William Lockwood,R,FLA,26,28,1,2,3
48,8479576,Vincent Desharnais,D,VAN,28,33,1,2,3
48,8482516,Matthew Kessel,D,STL,24,20,1,2,3
48,8482094,Daemon Hunt,D,MIN,22,20,1,2,3
48,8482201,Gage Goncalves,C,TBL,23,25,1,2,3
48,8479981,Jonah Gadjovich,L,FLA,26,33,0,3,3
48,8479320,Maxime Lajoie,D,SEA,27,21,0,3,3
48,8477971,Andreas Englund,D,LAK,28,33,0,3,3
48,8481679,Maxence Guenette,D,OTT,23,25,2,0,2
48,8483570,Ben Meyers,C,SEA,26,26,2,0,2
48,8482118,Sam Colangelo,R,ANA,23,18,2,0,2
48,8481726,Adam Edstrom,C,NYR,24,5,2,0,2
48,8480267,Sammy Walker,C,MIN,25,17,1,1,2
48,8481543,Nikita Alexandrov,C,STL,24,24,1,1,2
48,8481422,Jake Lucchini,C,NSH,29,22,1,1,2
48,8482858,Ryker Evans,D,SEA,23,20,1,1,2
48,8477851,Jordan Oesterle,D,BOS,32,42,1,1,2
48,8483489,Fraser Minten,C,TOR,31,12,1,1,2
48,8481593,Jayden Struble,D,MTL,23,24,1,1,2
48,8477527,Ross Johnston,L,ANA,30,28,1,1,2
48,8480851,Akil Thomas,C,LAK,24,17,1,1,2
48,8482787,Nikita Chibrikov,R,WPG,31,4,1,1,2
48,8481043,Cole Koepke,L,BOS,26,13,1,1,2
48,8482088,Justin Sourdif,R,FLA,22,19,1,1,2
48,8483597,Milos Kelemen,L,UTA,25,12,1,1,2
48,8481699,Aku Raty,R,UTA,23,20,1,1,2
48,8481024,Linus Karlsson,C,VAN,25,13,1,1,2
48,8478854,Ryan Shea,D,PIT,27,9,1,1,2
48,8481701,Santeri Hatakka,D,NJD,23,35,0,2,2
48,8478450,Parker Wotherspoon,D,BOS,27,36,0,2,2
48,8482172,Landon Slaggert,L,CHI,22,16,0,2,2
48,8475795,Dylan McIlrath,D,WSH,32,10,0,2,2
48,8479587,Rhett Gardner,C,PHI,28,14,0,2,2
48,8481122,Simon Benoit,D,TOR,26,38,0,2,2
48,8477244,Chad Ruhwedel,D,NYR,34,27,0,2,2
48,8481719,Maxwell Crozier,D,TBL,24,16,0,2,2
48,8481564,Ryan Johnson,D,BUF,23,12,0,2,2
48,8475413,Justin Dowling,C,NJD,34,11,0,2,2
48,8477149,Scott Sabourin,R,SJS,32,19,0,2,2
48,8480823,Alexander Alexeyev,D,WSH,25,15,0,2,2
48,8480844,Grigori Denisenko,L,VGK,24,27,1,0,1
48,8482061,Brandon Biro,L,SEA,26,11,1,0,1
48,8475755,Alexander Petrovic,D,DAL,32,11,1,0,1
48,8480874,Adam Ginning,D,PHI,24,14,1,0,1
48,8481578,Graeme Clarke,R,MIN,23,9,1,0,1
48,8483471,Brad Lambert,C,WPG,31,8,1,0,1
48,8483407,Brandon Scanlin,D,NYR,25,5,1,0,1
48,8481655,Cole Schwindt,R,CGY,23,3,1,0,1
48,8479419,Brett Murray,L,BUF,26,15,0,1,1
48,8481806,Louis Crevier,D,CHI,23,17,0,1,1
48,8482102,Vasily Ponomarev,C,PIT,22,13,0,1,1
48,8474062,Riley Nash,C,NYR,35,15,0,1,1
48,8481206,John Ludvig,D,PIT,24,11,0,1,1
48,8480032,Shane Bowers,C,NJD,25,15,0,1,1
48,8477541,Dakota Mermis,D,TOR,30,10,0,1,1
48,8479522,Hardy Haman Aktell,D,WSH,26,4,0,1,1
48,8483531,Brian Halonen,L,NJD,25,3,0,1,1
48,8475762,Derek Forbort,D,VAN,32,41,0,0,0
48,8480890,Jan Jenik,C,OTT,24,28,0,0,0
48,8483567,Georgii Merkulov,C,BOS,24,9,0,0,0
48,8478011,Louie Belpedio,D,PHI,28,18,0,0,0
48,8482460,Matt Rempe,C,NYR,22,14,0,0,0
48,8484304,Uvis Balinskis,D,FLA,28,18,0,0,0
48,8482476,Emil Heineman,L,MTL,23,8,0,0,0
48,8476323,Max McCormick,L,SEA,32,6,0,0,0
48,8482197,Adam Raska,R,MIN,23,2,0,0,0
48,8483395,Arshdeep Bains,L,VAN,23,6,0,0,0
48,8481065,Angus Crookshank,L,OTT,25,19,0,0,0
48,8483609,Adam Klapka,R,CGY,24,3,0,0,0
48,8480075,Cameron Crotty,D,MIN,25,10,0,0,0
48,8478147,Bokondji Imama,L,PIT,28,4,0,0,0
48,8483546,Marshall Rifai,D,TOR,26,3,0,0,0
48,8479330,Brandon Gignac,C,MTL,27,10,0,0,0
48,8480306,Grant Hutton,D,NYI,29,2,0,0,0
48,8475780,Chris Wagner,R,COL,33,4,0,0,0
48,8479421,Jacob Moverare,D,LAK,26,11,0,0,0
48,8483432,Luca Del Bel Belluz,C,CBJ,31,10,0,0,0
48,8483401,Marc Johnstone,R,PIT,28,1,0,0,0
48,8483920,Pierrick Dube,R,WSH,23,6,0,0,0
48,8484326,Patrik Koch,D,UTA,28,2,0,0,0
48,8484255,Jason Polin,R,COL,25,5,0,0,0
48,8477993,Justin Kirkland,C,CGY,28,6,0,0,0
48,8482126,Emil Andrae,D,PHI,31,4,0,0,0
48,8484259,Ondrej Pavel,C,COL,31,2,0,0,0
48,8484321,Nikolas Matinpalo,D,OTT,26,3,0,0,0
48,8483398,Declan Carlile,D,TBL,31,5,0,0,0
48,8481534,Raphael Lavoie,C,EDM,24,1,0,0,0
48,8483045,Cameron Butler,R,CBJ,31,0,0,0,0
48,8478956,Samuel Laberge,L,NJD,27,3,0,0,0
48,8480274,Philip Kemp,D,EDM,25,0,0,0,0
48,8470794,Joe Pavelski,C,,40,0,0,0,0
48,8479321,Lucas Johansen,D,,27,0,0,0,0
48,8477950,Tony DeAngelo,D,,29,0,0,0,0
48,8471218,Blake Wheeler,R,,38,0,0,0,0
48,8475197,Tyson Barrie,D,,33,0,0,0,0
48,8474157,Max Pacioretty,L,,36,0,0,0,0
48,8475744,Evgeny Kuznetsov,C,,32,0,0,0,0
48,8474037,James van Riemsdyk,L,,35,0,0,0,0
48,8476907,Mackenzie MacEachern,L,,30,0,0,0,0
48,8480216,Jacob Peterson,C,,25,0,0,0,0
48,8474602,Justin Schultz,D,,34,0,0,0,0
48,8482222,Alexander Barabanov,L,,30,0,0,0,0
48,8474031,Kevin Shattenkirk,D,,35,0,0,0,0
48,8477330,Dominik Kubalik,L,,29,0,0,0,0
48,8480884,Calen Addison,D,,24,0,0,0,0
48,8475906,John Klingberg,D,,32,0,0,0,0
48,8480008,Adam Ruzicka,C,,25,0,0,0,0
48,8476884,Derrick Pouliot,D,,30,0,0,0,0
48,8476919,Chris Tierney,C,,30,0,0,0,0
48,8479415,Michael McLeod,C,,26,0,0,0,0
48,8474870,Tyler Johnson,C,,34,0,0,0,0
48,8470604,Jeff Carter,C,,39,0,0,0,0
48,8478104,Sammy Blais,L,,28,0,0,0,0
48,8474884,Mike Hoffman,C,,35,0,0,0,0
48,8481591,Sam Poulin,R,,23,0,0,0,0
48,8471274,Alex Goligoski,D,,39,0,0,0,0
48,8476871,Tanner Pearson,L,,32,0,0,0,0
48,8476393,Nick Cousins,C,,31,0,0,0,0
48,8479977,Kailer Yamamoto,R,,26,0,0,0,0
48,8479346,Dillon Dube,C,,26,0,0,0,0
48,8480184,Gustav Lindstrom,D,,26,0,0,0,0
48,8479376,Victor Mete,D,,26,0,0,0,0
48,8473449,Kyle Okposo,R,,36,0,0,0,0
48,8481058,Jesse Ylonen,R,,25,0,0,0,0
48,8475752,Tyler Pitlick,C,,33,0,0,0,0
48,8481239,Samuel Fagemo,L,,24,0,0,0,0
48,8480821,Filip Zadina,R,,25,0,0,0,0
48,8470966,Mark Giordano,D,,41,0,0,0,0
48,8478495,Denis Gurianov,R,,27,0,0,0,0
48,8477464,Nic Petan,C,,29,0,0,0,0
48,8478099,Kevin Labanc,R,,29,0,0,0,0
48,8482241,Radim Zohorna,L,,28,0,0,0,0
48,8474040,Sam Gagner,C,,35,0,0,0,0
48,8479514,Rem Pitlick,C,,27,0,0,0,0
48,8478430,Oliver Kylington,D,,27,0,0,0,0
48,8479533,Joona Koppanen,L,,26,0,0,0,0
48,8479984,Cal Foote,D,,26,0,0,0,0
48,8477126,Jayson Megna,C,,34,0,0,0,0
48,8475164,Jakob Silfverberg,R,,34,0,0,0,0
48,8474009,Nick Bonino,C,,36,0,0,0,0
48,8479458,Nikita Zaitsev,D,,33,0,0,0,0
48,8477944,Jakub Vrana,L,,28,0,0,0,0
48,8471699,Andrew Cogliano,C,,37,0,0,0,0
48,8478067,Oskar Lindblom,L,,28,0,0,0,0
48,8471686,Marc Staal,D,,37,0,0,0,0
48,8470610,Zach Parise,L,,40,0,0,0,0
48,8478904,Steven Lorentz,C,,28,0,0,0,0
48,8473473,Milan Lucic,L,,36,0,0,0,0
48,8480031,Maxime Comtois,L,,25,0,0,0,0
48,8478512,Austin Czarnik,C,,32,0,0,0,0
48,8473504,Cal Clutterbuck,R,,37,0,0,0,0
48,8477454,Adam Erne,L,,29,0,0,0,0
48,8479383,Boris Katchouk,L,,26,0,0,0,0
48,8475825,Jani Hakanpää,D,,32,0,0,0,0
48,8477846,Ryan Carpenter,C,,33,0,0,0,0
48,8477930,Pierre-Edouard Bellemare,L,,39,0,0,0,0
48,8478400,Colin White,C,,27,0,0,0,0
48,8480226,Marián Studenic,R,,26,0,0,0,0
48,8480853,Liam Foudy,C,,24,0,0,0,0
48,8475797,Jarred Tinordi,D,,32,0,0,0,0
48,8479423,Alex Nylander,L,,26,0,0,0,0
48,8474618,Marco Scandella,D,,34,0,0,0,0
48,8478028,Fredrik Olofsson,L,,28,0,0,0,0
48,8474709,Matt Martin,L,,35,0,0,0,0
48,8481070,Hugh McGing,L,,26,0,0,0,0
48,8479546,Oskar Steen,C,,26,0,0,0,0
48,8474145,Robert Bortuzzo,D,,35,0,0,0,0
48,8476915,Jujhar Khaira,L,,30,0,0,0,0
48,8475278,Byron Froese,C,,33,0,0,0,0
48,8481812,Nikolai Knyzhov,D,,27,0,0,0,0
48,8478408,Travis Dermott,D,,28,0,0,0,0
48,8481077,John Leonard,L,,26,0,0,0,0
48,8479547,Matthew Phillips,R,,26,0,0,0,0
48,8480836,Jonathan Gruden,C,,24,0,0,0,0
48,8481690,Tyler Angle,C,,24,0,0,0,0
48,8475766,Austin Watson,L,,32,0,0,0,0
48,8481016,Ruslan Iskhakov,C,,24,0,0,0,0
48,8478078,Rourke Chartier,C,,28,0,0,0,0
48,8480776,Sheldon Rempal,R,,29,0,0,0,0
48,8484314,Jiri Smejkal,L,,28,0,0,0,0
49,8477492,Nathan MacKinnon,C,COL,29,82,54,85,139
49,8476453,Nikita Kucherov,R,TBL,31,81,48,91,139
49,8478402,Connor McDavid,C,EDM,27,79,36,99,135
49,8478483,Mitch Marner,R,TOR,27,80,38,93,131
49,8481559,Jack Hughes,C,NJD,23,73,51,66,117
49,8479314,Matthew Tkachuk,L,FLA,27,81,29,87,116
49,8477956,David Pastrnak,R,BOS,28,82,56,59,115
49,8478864,Kirill Kaprizov,L,MIN,27,74,45,65,110
49,8477934,Leon Draisaitl,C,EDM,29,76,37,72,109
49,8480027,Jason Robertson,L,DAL,25,82,39,69,108
49,8478427,Sebastian Aho,C,CAR,27,74,48,57,105
49,8479318,Auston Matthews,C,TOR,27,79,54,50,104
49,8471675,Sidney Crosby,C,PIT,37,80,49,53,102
49,8478550,Artemi Panarin,L,NYR,33,77,34,66,100
49,8477939,William Nylander,R,TOR,28,79,51,47,98
49,8478420,Mikko Rantanen,R,COL,28,82,43,54,97
49,8477493,Aleksander Barkov,C,FLA,29,73,22,73,95
49,8479343,Clayton Keller,R,UTA,26,77,44,50,94
49,8475172,Nazem Kadri,C,CGY,34,79,43,51,94
49,8482116,Tim Stützle,C,OTT,22,80,39,51,90
49,8477946,Dylan Larkin,C,DET,28,81,35,53,88
49,8477404,Jake Guentzel,C,TBL,30,82,31,57,88
49,8481557,Matt Boldy,L,MIN,23,75,37,50,87
49,8480012,Elias Pettersson,C,VAN,26,76,44,42,86
49,8479407,Jesper Bratt,L,NJD,26,70,35,51,86
49,8480800,Quinn Hughes,D,VAN,25,75,8,78,86
49,8474600,Roman Josi,D,NSH,34,76,16,69,85
49,8473419,Brad Marchand,L,BOS,36,77,25,59,84
49,8476460,Mark Scheifele,C,WPG,31,72,35,48,83
49,8480002,Nico Hischier,C,NJD,25,79,29,54,83
49,8478403,Jack Eichel,C,VGK,28,76,39,42,81
49,8478010,Brayden Point,C,TBL,28,81,28,53,81
49,8479542,Brandon Hagel,L,TBL,26,81,40,40,80
49,8474564,Steven Stamkos,C,NSH,34,77,34,46,80
49,8475913,Mark Stone,R,VGK,32,81,28,52,80
49,8480069,Cale Makar,D,COL,26,65,19,61,80
49,8480801,Brady Tkachuk,L,OTT,25,80,38,41,79
49,8477501,Valeri Nichushkin,R,COL,29,79,36,43,79
49,8484144,Connor Bedard,C,CHI,19,66,30,49,79
49,8479420,Tage Thompson,C,BUF,27,75,43,35,78
49,8476887,Filip Forsberg,L,NSH,30,71,39,39,78
49,8477409,Carter Verhaeghe,C,FLA,29,79,39,39,78
49,8482699,Dylan Guenther,R,UTA,21,76,32,46,78
49,8477951,Nick Schmaltz,C,UTA,28,78,31,47,78
49,8478493,Joel Eriksson Ek,C,MIN,27,74,29,49,78
49,8476468,J.T. Miller,C,VAN,31,76,25,53,78
49,8478440,Dylan Strome,C,WSH,27,74,32,45,77
49,8475166,John Tavares,C,TOR,34,81,29,48,77
49,8480023,Robert Thomas,C,STL,25,76,25,52,77
49,8475692,Mats Zuccarello,R,MIN,37,74,13,64,77
49,8471214,Alex Ovechkin,L,WSH,39,69,40,36,76
49,8478449,Roope Hintz,C,DAL,28,81,38,38,76
49,8477942,Kevin Fiala,L,LAK,28,82,34,42,76
49,8476459,Mika Zibanejad,C,NYR,31,77,29,47,76
49,8478398,Kyle Connor,L,WPG,28,79,38,37,75
49,8482740,Wyatt Johnston,C,DAL,21,80,37,38,75
49,8477955,Jared McCann,L,SEA,28,75,33,42,75
49,8476448,William Karlsson,C,VGK,31,78,33,41,74
49,8474578,Erik Karlsson,D,PIT,34,82,21,53,74
49,8476881,Tomas Hertl,C,VGK,31,80,34,39,73
49,8476539,Jonathan Marchessault,R,NSH,34,75,30,41,71
49,8478414,Timo Meier,R,NJD,28,75,32,38,70
49,8482665,Matty Beniers,C,SEA,22,77,31,39,70
49,8481540,Cole Caufield,R,MTL,23,80,39,30,69
49,8478439,Travis Konecny,R,PHI,27,74,25,44,69
49,8476456,Jonathan Huberdeau,C,CGY,31,79,24,45,69
49,8477949,Alex Tuch,R,BUF,28,74,16,53,69
49,8476389,Vincent Trocheck,C,NYR,31,78,26,42,68
49,8479999,Casey Mittelstadt,C,COL,26,79,19,49,68
49,8479323,Adam Fox,D,NYR,26,77,17,51,68
49,8480015,Owen Tippett,R,PHI,25,78,36,31,67
49,8477940,Nikolaj Ehlers,L,WPG,28,71,25,42,67
49,8480803,Evan Bouchard,D,EDM,25,76,22,45,67
49,8477964,Ivan Barbashev,C,VGK,29,79,30,36,66
49,8473512,Claude Giroux,R,OTT,36,81,29,37,66
49,8477500,Bo Horvat,C,NYI,29,82,28,38,66
49,8474586,Jordan Eberle,R,SEA,34,76,27,39,66
49,8478445,Mathew Barzal,C,NYI,27,80,16,50,66
49,8475784,Jeff Skinner,C,EDM,32,75,28,37,65
49,8477496,Elias Lindholm,C,BOS,30,80,24,41,65
49,8480208,Drake Batherson,R,OTT,26,80,20,45,65
49,8477494,Jonathan Drouin,L,COL,29,82,19,46,65
49,8480839,Rasmus Dahlin,D,BUF,24,73,18,47,65
49,8475168,Matt Duchene,C,DAL,33,81,21,43,64
49,8474141,Patrick Kane,R,DET,36,80,16,48,64
49,8478460,Zach Werenski,D,CBJ,27,80,12,51,63
49,8474590,John Carlson,D,WSH,34,65,12,51,63
49,8477933,Sam Reinhart,C,FLA,29,76,26,36,62
49,8480018,Nick Suzuki,C,MTL,25,76,19,43,62
49,8476853,Morgan Rielly,D,TOR,30,65,17,45,62
49,8475810,Bryan Rust,R,PIT,32,71,32,29,61
49,8477960,Adrian Kempe,R,LAK,28,81,29,32,61
49,8475158,Ryan O'Reilly,C,NSH,33,75,25,36,61
49,8479325,Charlie McAvoy,D,BOS,27,79,13,48,61
49,8482684,Luke Hughes,D,NJD,21,70,9,52,61
49,8479385,Jordan Kyrou,C,STL,26,75,25,35,60
49,8476454,Ryan Nugent-Hopkins,C,EDM,31,76,18,42,60
49,8477402,Pavel Buchnevich,L,STL,29,78,15,44,59
49,8478469,Thomas Chabot,D,OTT,27,69,11,48,59
49,8477476,Artturi Lehkonen,L,COL,29,80,35,23,58
49,8479337,Alex DeBrincat,R,DET,27,78,32,26,58
49,8480830,Andrei Svechnikov,R,CAR,24,70,26,32,58
49,8474679,Gustav Nyquist,C,NSH,35,76,19,39,58
49,8475794,Tyler Seguin,C,DAL,32,82,30,27,57
49,8476479,Phillip Danault,C,LAK,31,80,26,31,57
49,8475170,Brayden Schenn,C,STL,33,73,24,33,57
49,8479675,Trevor Moore,L,LAK,29,79,20,37,57
49,8482093,Seth Jarvis,C,CAR,22,65,34,22,56
49,8477935,Sam Bennett,C,FLA,28,75,30,26,56
49,8475151,Kyle Palmieri,C,NYI,33,81,27,29,56
49,8477451,Ryan Hartman,R,MIN,30,70,26,30,56
49,8478975,Mason Marchment,L,DAL,29,81,22,34,56
49,8481528,Dylan Cozens,C,BUF,23,71,22,34,56
49,8482078,Lucas Raymond,L,DET,22,80,21,35,56
49,8477021,Alex Kerfoot,C,UTA,30,73,14,42,56
49,8477986,Brandon Montour,D,SEA,30,70,13,43,56
49,8475167,Victor Hedman,D,TBL,34,79,11,45,56
49,8474641,Adam Henrique,C,EDM,34,79,28,27,55
49,8475786,Zach Hyman,L,EDM,32,81,27,28,55
49,8478407,Vince Dunn,D,SEA,28,76,10,45,55
49,8477416,Oliver Bjorkstrand,R,SEA,29,70,24,30,54
49,8471215,Evgeni Malkin,C,PIT,38,71,17,37,54
49,8476875,Mike Matheson,D,MTL,30,75,14,40,54
49,8474565,Alex Pietrangelo,D,VGK,34,64,12,42,54
49,8476905,Chandler Stephenson,C,SEA,30,78,11,43,54
49,8476346,Johnny Gaudreau,L,CBJ,31,70,9,45,54
49,8475754,Brock Nelson,C,NYI,33,78,29,24,53
49,8483431,Logan Cooley,C,UTA,20,74,20,33,53
49,8481711,Matias Maccelli,L,UTA,24,71,17,36,53
49,8478462,Nicolas Roy,C,VGK,27,71,16,37,53
49,8481596,Shane Pinto,C,OTT,24,75,14,39,53
49,8481068,Yegor Sharangovich,C,CGY,26,78,35,17,52
49,8476438,Brandon Saad,L,STL,32,73,28,24,52
49,8483515,Juraj Slafkovsky,L,MTL,20,74,12,40,52
49,8475184,Chris Kreider,L,NYR,33,75,28,23,51
49,8482745,Mason McTavish,C,ANA,21,70,28,23,51
49,8475726,Tyler Toffoli,C,SJS,32,66,25,26,51
49,8482113,Anton Lundell,C,FLA,23,72,25,26,51
49,8484153,Leo Carlsson,C,ANA,20,75,25,26,51
49,8475191,Reilly Smith,R,NYR,33,74,24,27,51
49,8478401,Pavel Zacha,C,BOS,27,75,22,29,51
49,8475765,Vladimir Tarasenko,R,DET,33,81,17,34,51
49,8480036,Miro Heiskanen,D,DAL,25,78,11,40,51
49,8479410,Mikhail Sergachev,D,UTA,26,72,11,40,51
49,8476432,Boone Jenner,C,CBJ,31,73,31,19,50
49,8477998,Warren Foegele,L,LAK,28,78,28,22,50
49,8475314,Anders Lee,L,NYI,34,75,24,26,50
49,8479400,Pierre-Luc Dubois,L,WSH,26,71,17,33,50
49,8477932,Aaron Ekblad,D,FLA,28,69,15,35,50
49,8480865,Noah Dobson,D,NYI,24,79,12,38,50
49,8477504,Josh Morrissey,D,WPG,29,71,7,43,50
49,8475764,Cam Fowler,D,ANA,33,70,6,44,50
49,8478397,Rasmus Andersson,D,CGY,28,75,6,44,50
49,8478856,Conor Garland,R,VAN,28,72,24,25,49
49,8478444,Brock Boeser,R,VAN,27,75,23,26,49
49,8482097,Jack Quinn,R,BUF,23,67,23,26,49
49,8483808,Andrei Kuzmenko,L,CGY,28,75,19,30,49
49,8471685,Anze Kopitar,C,LAK,37,80,11,38,49
49,8478366,Frank Vatrano,R,ANA,30,77,31,17,48
49,8475169,Evander Kane,L,EDM,33,77,24,24,48
49,8480797,Joel Farabee,L,PHI,24,74,20,28,48
49,8480028,Morgan Frost,C,PHI,25,73,17,31,48
49,8477503,Max Domi,C,TOR,29,79,14,34,48
49,8475798,Mikael Granlund,C,SJS,32,72,13,35,48
49,8478498,Jake DeBrusk,L,VAN,28,74,24,23,47
49,8475287,Erik Haula,L,NJD,33,76,20,27,47
49,8481577,Philip Tomasino,C,NSH,23,70,18,29,47
49,8471724,Kris Letang,D,PIT,37,80,17,30,47
49,8478873,Troy Terry,R,ANA,27,78,16,31,47
49,8477407,Anthony Duclair,L,NYI,29,77,19,27,46
49,8474102,David Perron,L,OTT,36,77,19,27,46
49,8475745,Charlie Coyle,C,BOS,32,71,17,29,46
49,8479425,Filip Hronek,D,VAN,27,68,11,35,46
49,8475753,Justin Faulk,D,STL,32,72,9,37,46
49,8476792,Torey Krug,D,STL,33,74,8,38,46
49,8480829,Jesperi Kotkaniemi,C,CAR,24,61,25,20,45
49,8480064,Josh Norris,C,OTT,25,72,24,21,45
49,8482110,Dawson Mercer,C,NJD,23,68,23,22,45
49,8482159,Tyson Foerster,R,PHI,22,75,22,23,45
49,8476483,Rickard Rakell,R,PIT,31,73,21,24,45
49,8478458,John (Jack) Roslovic,C,CAR,27,67,19,26,45
49,8479591,Michael Eyssimont,C,TBL,28,80,18,27,45
49,8479345,Jakob Chychrun,D,WSH,26,65,17,28,45
49,8478038,Devon Toews,D,COL,30,67,11,34,45
49,8477447,Shea Theodore,D,VGK,29,57,9,36,45
49,8470613,Brent Burns,D,CAR,39,74,7,38,45
49,8477429,Andrew Copp,C,DET,30,80,21,23,44
49,8480039,Martin Necas,C,CAR,25,72,19,25,44
49,8473994,Jamie Benn,L,DAL,35,82,18,26,44
49,8481560,Arthur Kaliyev,R,LAK,23,77,18,26,44
49,8478233,Andrew Mangiapane,L,WSH,28,75,17,27,44
49,8476462,Dougie Hamilton,D,NJD,31,73,14,30,44
49,8482124,Quinton Byfield,R,LAK,22,80,13,31,44
49,8481581,Thomas Harley,D,DAL,23,74,8,36,44
49,8476880,Tom Wilson,R,WSH,30,67,21,22,43
49,8481618,Alex Newhook,C,MTL,23,73,20,23,43
49,8481533,Trevor Zegras,C,ANA,23,72,14,29,43
49,8477495,Seth Jones,D,CHI,30,71,14,29,43
49,8480220,Noah Cates,L,PHI,25,70,14,29,43
49,8478055,Gustav Forsling,D,FLA,28,72,8,35,43
49,8476958,Jaccob Slavin,D,CAR,30,73,7,36,43
49,8482175,JJ Peterka,R,BUF,22,71,23,19,42
49,8477426,Nicholas Paul,L,TBL,29,82,23,19,42
49,8482146,Luke Evangelista,R,NSH,22,63,22,20,42
49,8479525,Ross Colton,C,COL,28,78,21,21,42
49,8480459,Pius Suter,C,VAN,28,68,19,23,42
49,8478042,Viktor Arvidsson,L,EDM,31,73,19,23,42
49,8482109,Alexis Lafrenière,L,NYR,23,72,18,24,42
49,8482149,Cole Perfetti,C,WPG,22,72,18,24,42
49,8478474,Lawson Crouse,L,UTA,27,72,18,24,42
49,8477498,Darnell Nurse,D,EDM,29,71,13,29,42
49,8480014,Gabriel Vilardi,C,WPG,25,62,26,15,41
49,8475760,Nick Bjugstad,C,UTA,32,75,20,21,41
49,8478466,Daniel Sprong,R,VAN,27,72,19,22,41
49,8478438,Tommy Novak,C,NSH,27,59,18,23,41
49,8481524,Bowen Byram,D,BUF,23,69,16,25,41
49,8482092,Ridly Greig,C,OTT,22,75,14,27,41
49,8476869,Brady Skjei,D,NSH,30,72,13,28,41
49,8478047,Michael Bunting,L,PIT,29,72,12,29,41
49,8480434,Sean Durzi,D,UTA,26,70,12,29,41
49,8480185,Eetu Luostarinen,C,FLA,26,79,20,20,40
49,8478519,Anthony Cirelli,C,TBL,27,82,18,22,40
49,8478891,Mason Appleton,C,WPG,28,65,17,23,40
49,8477497,Sean Monahan,C,CBJ,30,69,16,24,40
49,8479987,Morgan Geekie,C,BOS,26,79,16,24,40
49,8475799,Nino Niederreiter,R,WPG,32,67,20,19,39
49,8473986,Alex Killorn,L,ANA,35,76,20,19,39
49,8477456,J.T. Compher,L,DET,29,78,20,19,39
49,8482475,Yegor Chinakhov,R,CBJ,23,58,18,21,39
49,8477479,Tyler Bertuzzi,L,CHI,29,60,16,23,39
49,8476292,Ondrej Palat,L,NJD,33,70,16,23,39
49,8474150,Mikael Backlund,C,CGY,35,78,15,24,39
49,8477346,MacKenzie Weegar,D,CGY,30,72,8,31,39
49,8481542,Moritz Seider,D,DET,23,74,3,36,39
49,8476906,Shayne Gostisbehere,D,CAR,31,76,2,37,39
49,8475714,Calle Jarnkrok,C,TOR,33,75,20,18,38
49,8476399,Blake Coleman,C,CGY,33,76,18,20,38
49,8477511,Anthony Mantha,R,CGY,30,74,18,20,38
49,8481624,Ilya Mikheyev,R,CHI,30,64,18,20,38
49,8478115,Pierre Engvall,L,NYI,28,76,14,24,38
49,8476882,Teuvo Teravainen,C,CHI,30,66,11,27,38
49,8474563,Drew Doughty,D,LAK,35,70,11,27,38
49,8477488,Brett Pesce,D,NJD,30,75,7,31,38
49,8475722,Jason Zucker,L,BUF,32,60,21,16,37
49,8477450,Jason Dickinson,C,CHI,29,60,20,17,37
49,8479393,Noah Gregor,L,OTT,26,74,19,18,37
49,8484166,Adam Fantilli,C,CBJ,20,71,18,19,37
49,8479365,Trent Frederic,C,BOS,26,74,15,22,37
49,8480078,Filip Chytil,C,NYR,25,68,15,22,37
49,8482105,Jake Sanderson,D,OTT,22,74,13,24,37
49,8482702,Logan Stankoven,C,DAL,21,80,12,25,37
49,8484145,Zach Benson,L,BUF,19,66,10,27,37
49,8477948,Travis Sanheim,D,PHI,28,71,8,29,37
49,8476461,Sean Couturier,C,PHI,32,70,8,29,37
49,8481535,Nils Hoglander,L,VAN,24,67,23,13,36
49,8477444,Andre Burakovsky,L,SEA,29,67,20,16,36
49,8482660,Kent Johnson,C,CBJ,22,60,16,20,36
49,8471698,T.J. Oshie,R,WSH,38,66,15,21,36
49,8475848,Brendan Gallagher,R,MTL,32,67,11,25,36
49,8480817,K'Andre Miller,D,NYR,24,76,11,25,36
49,8479351,Sam Steel,C,DAL,26,79,11,25,36
49,8482671,Owen Power,D,BUF,22,73,8,28,36
49,8479992,Michael Rasmussen,C,DET,25,81,19,16,35
49,8475768,Jaden Schwartz,C,SEA,32,73,19,16,35
49,8481554,Kaapo Kakko,R,NYR,23,70,18,17,35
49,8474149,Evgenii Dadonov,R,DAL,35,80,17,18,35
49,8478020,Michael Amadio,R,OTT,28,71,16,19,35
49,8478542,Evan Rodrigues,C,FLA,31,73,13,22,35
49,8481186,Logan O'Connor,R,COL,28,79,11,24,35
49,8481656,Aliaksei Protas,C,WSH,23,69,10,25,35
49,8476923,Damon Severson,D,CBJ,30,78,6,29,35
49,8481604,Pavel Dorofeyev,L,VGK,24,69,17,17,34
49,8480813,Joe Veleno,C,DET,24,78,13,21,34
49,8483490,Pavel Mintyukov,D,ANA,21,70,12,22,34
49,8482720,Matthew Knies,L,TOR,22,74,12,22,34
49,8483505,Matthew Poitras,C,BOS,20,75,10,24,34
49,8482122,Brock Faber,D,MIN,22,76,10,24,34
49,8476885,Jacob Trouba,D,NYR,30,75,10,24,34
49,8480873,Rasmus Sandin,D,WSH,24,67,4,30,34
49,8480893,Kirill Marchenko,R,CBJ,24,66,27,6,33
49,8476480,Vladislav Namestnikov,C,WPG,32,64,14,19,33
49,8482705,Cole Sillinger,C,CBJ,21,66,13,20,33
49,8473563,Nicklas Backstrom,C,WSH,37,61,12,21,33
49,8476458,Ryan Strome,C,ANA,31,74,12,21,33
49,8476925,Colton Sissons,C,NSH,31,69,11,22,33
49,8478046,Danton Heinen,L,VAN,29,72,11,22,33
49,8478133,Jake Evans,C,MTL,28,69,9,24,33
49,8481703,Valtteri Puustinen,R,PIT,25,58,6,27,33
49,8476331,Dylan DeMelo,D,WPG,31,73,4,29,33
49,8482055,Drew O'Connor,L,PIT,26,61,22,10,32
49,8476278,Colin Blackwell,C,DAL,31,79,18,14,32
49,8480113,Alex Iafallo,L,WPG,31,66,16,16,32
49,8480068,Ryan Poehling,C,PHI,25,71,14,18,32
49,8480995,Pontus Holmberg,R,TOR,25,63,14,18,32
49,8475218,Mattias Ekholm,D,EDM,34,79,13,19,32
49,8476921,Jordan Martinook,L,CAR,32,61,11,21,32
49,8480009,Eeli Tolvanen,R,SEA,25,72,10,22,32
49,8476854,Hampus Lindholm,D,BOS,30,74,7,25,32
49,8475763,Kevin Hayes,R,PIT,32,68,7,25,32
49,8478413,Jordan Greenway,L,BUF,27,62,16,15,31
49,8480789,Oliver Wahlstrom,R,NYI,24,74,15,16,31
49,8479339,Patrik Laine,L,CBJ,26,61,10,21,31
49,8475200,Dmitry Orlov,D,CAR,33,70,8,23,31
49,8481606,Jordan Spence,D,LAK,23,69,3,28,31
49,8480871,Adam Boqvist,D,FLA,24,67,16,14,30
49,8480849,Barrett Hayton,C,UTA,24,74,15,15,30
49,8482089,Jake Neighbours,L,STL,22,68,15,15,30
49,8477953,Kasperi Kapanen,R,STL,28,63,14,16,30
49,8475793,Ryan Johansen,C,PHI,32,71,13,17,30
49,8481580,Connor McMichael,C,WSH,23,63,13,17,30
49,8477839,Conor Sheary,L,TBL,32,80,13,17,30
49,8480188,Fabian Zetterlund,L,SJS,25,63,11,19,30
49,8476872,Scott Laughton,C,PHI,30,69,11,19,30
49,8478911,Matt Roy,D,WSH,29,67,9,21,30
49,8474053,Logan Couture,C,SJS,35,61,8,22,30
49,8476979,Erik Gustafsson,D,DET,32,75,8,22,30
49,8480145,Neal Pionk,D,WPG,29,72,6,24,30
49,8482712,Oskar Olausson,R,COL,22,79,3,27,30
49,8479976,Juuso Valimaki,D,UTA,26,65,2,28,30
49,8475149,Marcus Johansson,L,MIN,34,64,14,15,29
49,8475855,Jesper Fast,R,CAR,33,64,14,15,29
49,8479661,Tanner Jeannot,L,LAK,27,75,14,15,29
49,8476981,Josh Anderson,R,MTL,30,67,13,16,29
49,8478472,Mathieu Joseph,R,STL,27,66,11,18,29
49,8480835,Jack Drury,C,CAR,24,63,10,19,29
49,8475791,Taylor Hall,L,CHI,33,61,10,19,29
49,8476826,Yanni Gourde,C,SEA,33,68,8,21,29
49,8476457,Adam Larsson,D,SEA,32,71,5,24,29
49,8478507,John Marino,D,UTA,27,65,1,28,29
49,8481014,Alexander Romanov,D,NYI,24,75,1,28,29
49,8479368,Max Jones,L,BOS,26,64,17,11,28
49,8470621,Corey Perry,R,EDM,39,70,15,13,28
49,8475343,Nic Dowd,C,WSH,34,66,14,14,28
49,8475193,Tomas Tatar,L,NJD,34,63,13,15,28
49,8480802,Ryan McLeod,C,BUF,25,57,12,16,28
49,8475220,Marcus Foligno,L,MIN,33,60,12,16,28
49,8477353,Tyler Motte,C,DET,29,71,11,17,28
49,8477987,Ryan Donato,C,CHI,28,63,10,18,28
49,8480798,Philipp Kurashev,C,CHI,25,65,10,18,28
49,8477478,William Carrier,L,CAR,30,59,9,19,28
49,8480336,Sean Walker,D,CAR,30,79,8,20,28
49,8474716,Jared Spurgeon,D,MIN,35,78,6,22,28
49,8474151,Ryan McDonagh,D,TBL,35,78,5,23,28
49,8481553,Bobby Brink,R,PHI,23,62,17,10,27
49,8478463,Anthony Beauvillier,L,PIT,27,69,14,13,27
49,8482737,Zack Bolduc,C,STL,21,65,14,13,27
49,8482749,Joshua Roy,R,MTL,21,70,13,14,27
49,8476878,Zemgus Girgensons,C,TBL,30,82,13,14,27
49,8476392,Adam Lowry,C,WPG,31,68,12,15,27
49,8478013,Jake Walman,D,SJS,28,74,11,16,27
49,8476419,Jean-Gabriel Pageau,C,NYI,32,79,10,17,27
49,8482667,William Eklund,L,SJS,22,64,7,20,27
49,8473422,Nick Foligno,L,CHI,37,61,14,12,26
49,8476897,Oskar Sundqvist,C,STL,30,63,14,12,26
49,8478057,Dakota Joshua,C,VAN,28,66,12,14,26
49,8480003,Jesper Boqvist,C,FLA,26,68,12,14,26
49,8484203,Bradly Nadeau,L,CAR,19,65,7,19,26
49,8482117,Lukas Reichel,L,CHI,22,63,7,19,26
49,8477507,Nikita Zadorov,D,BOS,29,65,7,19,26
49,8475462,Radko Gudas,D,ANA,34,64,4,22,26
49,8478500,Ivan Provorov,D,CBJ,27,79,3,23,26
49,8480049,Dylan Samberg,D,WPG,25,71,3,23,26
49,8477969,Marcus Pettersson,D,PIT,28,77,2,24,26
49,8480878,Nils Lundkvist,D,DAL,24,71,2,24,26
49,8475790,Erik Gudbranson,D,CBJ,32,76,2,24,26
49,8481582,Nicholas Robertson,L,TOR,23,65,16,9,25
49,8481032,Paul Cotter,C,NJD,25,62,11,14,25
49,8478882,Vladislav Gavrikov,D,LAK,29,65,7,18,25
49,8481522,Peyton Krebs,C,BUF,23,65,6,19,25
49,8480043,Timothy Liljegren,D,TOR,25,70,2,23,25
49,8479619,Michael Carcone,L,UTA,28,56,16,8,24
49,8474715,Cameron Atkinson,R,TBL,35,81,15,9,24
49,8482079,Marco Rossi,C,MIN,23,51,15,9,24
49,8482125,Alexander Holtz,R,VGK,22,63,13,11,24
49,8479390,Taylor Raddysh,R,WSH,26,65,13,11,24
49,8479941,Justin Danforth,R,CBJ,31,58,12,12,24
49,8477392,Hudson Fasching,R,NYI,29,62,12,12,24
49,8477903,Garnet Hathaway,R,PHI,33,58,12,12,24
49,8477406,Mattias Janmark,C,EDM,32,70,11,13,24
49,8476474,Stefan Noesen,R,NJD,31,71,9,15,24
49,8481704,Juuso Parssinen,C,NSH,23,57,8,16,24
49,8477947,Sonny Milano,L,WSH,28,55,7,17,24
49,8478396,Noah Hanifin,D,VGK,27,57,4,20,24
49,8479398,Samuel Girard,D,COL,26,63,4,20,24
49,8476931,Jake McCabe,D,TOR,31,65,4,20,24
49,8477425,Miles Wood,L,COL,29,80,15,8,23
49,8476469,Joel Armia,R,MTL,31,70,14,9,23
49,8483524,Shane Wright,C,SEA,20,57,13,10,23
49,8484149,Gavin Brindley,C,CBJ,20,45,11,12,23
49,8476927,Teddy Blueger,C,VAN,30,58,8,15,23
49,8480748,Kiefer Sherwood,L,VAN,29,60,7,16,23
49,8476467,Jamie Oleksiak,D,SEA,32,68,6,17,23
49,8482101,Danil Gushchin,L,SJS,22,64,5,18,23
49,8478970,Jalen Chatfield,D,CAR,28,68,5,18,23
49,8478468,Jeremy Lauzon,D,NSH,27,52,4,19,23
49,8475324,Nick Jensen,D,OTT,34,67,3,20,23
49,8479369,Andrew Peeke,D,BOS,26,57,3,20,23
49,8481178,Egor Zamula,D,PHI,24,58,3,20,23
49,8478851,Alexandre Carrier,D,NSH,28,69,2,21,23
49,8479293,Brandon Tanev,L,SEA,33,63,13,9,22
49,8477505,Alexander Wennberg,C,SJS,30,57,11,11,22
49,8479315,Joey Anderson,R,CHI,26,50,10,12,22
49,8476374,Sean Kuraly,C,CBJ,31,59,10,12,22
49,8481441,Joe Snively,C,DET,28,63,10,12,22
49,8482133,Thomas Bordeleau,C,SJS,22,64,9,13,22
49,8479414,Nathan Bastian,R,NJD,27,58,9,13,22
49,8479344,Jesse Puljujarvi,R,PIT,26,55,9,13,22
49,8479996,Cody Glass,C,NSH,25,54,7,15,22
49,8477952,Robby Fabbri,C,ANA,28,66,7,15,22
49,8477369,Carson Soucy,D,VAN,30,61,7,15,22
49,8483468,Jiri Kulich,C,BUF,20,65,6,16,22
49,8480073,Erik Brannstrom,D,COL,25,69,6,16,22
49,8482087,Kaiden Guhle,D,MTL,22,71,5,17,22
49,8476525,Colin Miller,D,WPG,32,63,5,17,22
49,8476902,Esa Lindell,D,DAL,30,74,4,18,22
49,8480891,Michael Kesselring,D,UTA,24,62,4,18,22
49,8480246,Nick Perbix,D,TBL,26,75,4,18,22
49,8482142,Jamie Drysdale,D,PHI,22,62,3,19,22
49,8474574,Tyler Myers,D,VAN,34,65,3,19,22
49,8479639,Dylan Coghlan,D,WPG,26,62,2,20,22
49,8475188,Brayden McNabb,D,VGK,33,55,0,22,22
49,8480855,Jack McBain,C,UTA,24,63,13,8,21
49,8478109,Victor Olofsson,L,VGK,29,71,11,10,21
49,8475225,Craig Smith,C,CHI,35,50,11,10,21
49,8478434,Keegan Kolesar,R,VGK,27,70,10,11,21
49,8477508,Curtis Lazar,C,NJD,29,63,10,11,21
49,8479402,Jake Bean,D,CGY,26,67,7,14,21
49,8481599,Victor Soderstrom,D,UTA,23,58,6,15,21
49,8483466,Kevin Korchinski,D,CHI,20,48,6,15,21
49,8476988,Matt Benning,D,SJS,30,64,5,16,21
49,8475171,Oliver Ekman-Larsson,D,TOR,33,68,3,18,21
49,8476917,Adam Pelech,D,NYI,30,79,3,18,21
49,8477506,Ryan Pulock,D,NYI,30,79,2,19,21
49,8473507,Jeff Petry,D,DET,37,75,2,19,21
49,8476889,Radek Faksa,C,STL,30,56,13,7,20
49,8476873,Mark Jankowski,C,NSH,30,50,11,9,20
49,8482259,Bobby McMann,C,TOR,28,61,11,9,20
49,8482157,Will Cuylle,L,NYR,22,62,11,9,20
49,8479353,Brett Howden,C,VGK,26,69,10,10,20
49,8482809,Jackson Blake,R,CAR,21,55,10,10,20
49,8480762,Eric Robinson,L,CAR,29,57,10,10,20
49,8482062,Cole Smith,L,NSH,29,61,10,10,20
49,8477989,Christian Dvorak,C,MTL,28,67,9,11,20
49,8479980,Nicolas Hague,D,VGK,26,54,9,11,20
49,8474189,Lars Eller,C,PIT,35,69,8,12,20
49,8481523,Kirby Dach,C,MTL,23,60,7,13,20
49,8475231,Casey Cizikas,C,NYI,33,69,7,13,20
49,8476312,Josh Manson,D,COL,33,64,7,13,20
49,8482803,Olen Zellweger,D,ANA,21,62,7,13,20
49,8481481,Blake Lizotte,C,PIT,27,56,6,14,20
49,8482111,Justin Barron,D,MTL,23,65,6,14,20
49,8481167,Brayden Pachal,D,CGY,25,41,6,14,20
49,8481019,David Gustafsson,C,WPG,24,55,5,15,20
49,8480796,Martin Fehervary,D,WSH,25,54,4,16,20
49,8481546,Cam York,D,PHI,23,69,3,17,20
49,8476879,Cody Ceci,D,EDM,31,67,2,18,20
49,8477446,Michael McCarron,R,NSH,29,64,13,6,19
49,8473533,Jordan Staal,C,CAR,36,62,10,9,19
49,8479671,Mathieu Olivier,R,CBJ,27,37,9,10,19
49,8483491,Ivan Miroshnichenko,L,WSH,20,49,8,11,19
49,8483565,Nick Blankenburg,D,NSH,26,69,7,12,19
49,8482655,Janis Moser,D,TBL,24,74,6,13,19
49,8478840,Will Borgen,D,SEA,28,66,6,13,19
49,8477499,Rasmus Ristolainen,D,PHI,30,60,6,13,19
49,8476463,Jonas Brodin,D,MIN,31,75,5,14,19
49,8477435,Ryan Graves,D,PIT,29,74,5,14,19
49,8478178,Darren Raddysh,D,TBL,28,65,5,14,19
49,8477931,Tomas Nosek,L,FLA,32,60,4,15,19
49,8474568,Luke Schenn,D,NSH,35,50,4,15,19
49,8480727,Zach Whitecloud,D,VGK,28,44,4,15,19
49,8478508,Yakov Trenin,C,MIN,27,59,12,6,18
49,8479336,Carl Grundstrom,R,SJS,27,46,12,6,18
49,8482679,Matt Coronato,R,CGY,22,70,10,8,18
49,8476918,Jimmy Vesey,L,NYR,31,67,8,10,18
49,8482074,Connor Zary,C,CGY,23,62,7,11,18
49,8479944,Zach Aston-Reese,C,VGK,30,50,7,11,18
49,8483499,Liam Ohgren,L,MIN,20,56,6,12,18
49,8474567,Zach Bogosian,D,MIN,34,65,6,12,18
49,8477220,Nate Schmidt,D,FLA,33,74,5,13,18
49,8480144,David Kampf,C,TOR,29,66,5,13,18
49,8481527,Kaedan Korczak,D,VGK,23,58,4,14,18
49,8475181,Nick Leddy,D,STL,33,67,3,15,18
49,8479026,Philippe Myers,D,TOR,27,50,2,16,18
49,8479328,Julien Gauthier,R,NYI,27,64,11,6,17
49,8480848,Ty Dellandrea,C,SJS,24,45,10,7,17
49,8478432,Christian Fischer,R,DET,27,71,9,8,17
49,8480074,Alexandre Texier,C,STL,25,55,9,8,17
49,8483482,Tristan Luneau,D,ANA,20,65,8,9,17
49,8475842,Sam Carrick,C,NYR,32,60,7,10,17
49,8480157,Calle Rosen,D,COL,30,54,7,10,17
49,8479066,Ryan Lomberg,L,CGY,30,65,6,11,17
49,8476960,Andreas Athanasiou,C,CHI,30,53,5,12,17
49,8474034,Patrick Maroon,L,CHI,36,47,4,13,17
49,8475690,Chris Tanev,D,TOR,35,57,4,13,17
49,8482067,Connor Mackey,D,NYR,28,66,3,14,17
49,8480205,Emil Bemstrom,C,PIT,25,57,3,14,17
49,8482245,Artem Zub,D,OTT,29,71,3,14,17
49,8476892,Colton Parayko,D,STL,31,69,2,15,17
49,8477365,Connor Clifton,D,BUF,29,58,2,15,17
49,8481601,Simon Holmstrom,R,NYI,23,65,10,6,16
49,8483457,Lane Hutson,D,MTL,20,62,9,7,16
49,8480252,Cole Guttman,C,CHI,25,37,8,8,16
49,8482451,Mikael Pyyhtia,L,CBJ,23,53,7,9,16
49,8483445,Cutter Gauthier,L,ANA,20,59,6,10,16
49,8483493,Frank Nazar,C,CHI,20,46,6,10,16
49,8482624,Daniil Miromanov,D,CGY,27,69,4,12,16
49,8479543,Michael Pezzetta,L,MTL,26,58,4,12,16
49,8480950,Ilya Lyubushkin,D,DAL,30,60,4,12,16
49,8475455,Brenden Dillon,D,NJD,34,55,3,13,16
49,8479982,Conor Timmins,D,TOR,26,61,3,13,16
49,8478454,Noah Juulsen,D,VAN,27,45,3,13,16
49,8476422,Mike Reilly,D,NYI,31,72,2,14,16
49,8481641,Joel Kiviranta,L,COL,28,74,12,3,15
49,8479316,Luke Kunin,C,SJS,27,50,11,4,15
49,8481093,Rafael Harvey-Pinard,L,MTL,25,53,9,6,15
49,8480448,Parker Kelly,L,COL,25,74,9,6,15
49,8482155,Alex Laferriere,R,LAK,23,61,8,7,15
49,8480980,Connor Dewar,C,TOR,25,67,8,7,15
49,8482077,Dylan Holloway,L,EDM,23,56,8,7,15
49,8479983,Mario Ferraro,D,SJS,26,72,6,9,15
49,8481716,Dmitri Voronkov,L,CBJ,24,51,6,9,15
49,8476856,Mathew Dumba,D,DAL,30,71,6,9,15
49,8482176,Wyatt Kaiser,D,CHI,22,52,5,10,15
49,8477015,Connor Brown,R,EDM,30,57,5,10,15
49,8479371,Dante Fabbro,D,NSH,26,63,4,11,15
49,8482073,Braden Schneider,D,NYR,23,59,4,11,15
49,8475279,Ben Chiarot,D,DET,33,66,4,11,15
49,8482730,Brandt Clarke,D,LAK,21,55,4,11,15
49,8480807,Mattias Samuelsson,D,BUF,24,51,4,11,15
49,8476874,Olli Maatta,D,DET,30,65,3,12,15
49,8478443,Brandon Carlo,D,BOS,28,60,3,12,15
49,8480058,Pierre-Olivier Joseph,D,STL,25,61,3,12,15
49,8479324,Ryan Lindgren,D,NYR,26,62,3,12,15
49,8480222,Sebastian Aho,D,PIT,28,68,2,13,15
49,8476329,Travis Boyd,C,MIN,31,53,2,13,15
49,8471677,Jack Johnson,D,CBJ,37,64,2,13,15
49,8474090,Brendan Smith,D,DAL,35,51,2,13,15
49,8475233,David Savard,D,MTL,34,64,1,14,15
49,8480355,Mark Kastelic,C,BOS,25,66,10,4,14
49,8480021,Jack Studnicka,C,LAK,25,60,9,5,14
49,8481013,Jonatan Berggren,R,DET,24,62,8,6,14
49,8481477,Nico Sturm,C,SJS,29,55,6,8,14
49,8477979,Nicolas Aube-Kubel,R,BUF,28,55,6,8,14
49,8482634,Alex Steeves,C,TOR,25,52,6,8,14
49,8481161,Jake Christiansen,D,CBJ,25,60,6,8,14
49,8482148,Hendrix Lapierre,C,WSH,22,49,5,9,14
49,8478211,Dryden Hunt,L,CGY,29,55,5,9,14
49,8477573,Nathan Walker,L,STL,30,57,5,9,14
49,8481521,Ronnie Attard,D,PHI,25,51,4,10,14
49,8478421,A.J. Greer,L,FLA,28,63,4,10,14
49,8481751,Lukas Rousek,R,BUF,25,47,4,10,14
49,8478451,Ethan Bear,D,WSH,27,51,3,11,14
49,8482095,Tyler Kleven,D,OTT,22,48,3,11,14
49,8478136,Jake Middleton,D,MIN,28,70,1,13,14
49,8481568,Alex Vlasic,D,CHI,23,61,1,13,14
49,8478416,Erik Cernak,D,TBL,27,70,1,13,14
49,8476891,Matthew Grzelcyk,D,PIT,30,73,0,14,14
49,8479359,Beck Malenstyn,L,BUF,26,46,9,4,13
49,8480281,Alexey Toropchenko,R,STL,25,60,8,5,13
49,8482964,Arber Xhekaj,D,MTL,23,52,8,5,13
49,8480806,Isac Lundestrom,C,ANA,25,56,7,6,13
49,8478043,Sam Lafferty,C,BUF,29,62,6,7,13
49,8477919,Frederick Gaudreau,C,MIN,31,63,5,8,13
49,8481517,Brett Leason,R,ANA,25,54,5,8,13
49,8479348,Kale Clague,D,BUF,26,38,5,8,13
49,8477018,Ben Hutton,D,VGK,31,38,3,10,13
49,8476967,Brett Kulak,D,EDM,30,58,2,11,13
49,8478452,Caleb Jones,D,LAK,27,65,2,11,13
49,8475208,Brian Dumoulin,D,ANA,33,61,2,11,13
49,8480035,Henri Jokiharju,D,BUF,25,60,1,12,13
49,8475718,Justin Holl,D,DET,32,61,1,12,13
49,8480879,Jacob Bernard-Docker,D,OTT,24,50,1,12,13
49,8482659,Josh Doan,R,UTA,22,49,7,5,12
49,8479439,Jacob MacDonald,D,COL,31,54,7,5,12
49,8478831,Kevin Stenlund,C,UTA,28,53,7,5,12
49,8480011,Klim Kostin,C,SJS,25,48,6,6,12
49,8481617,Vasily Podkolzin,R,VAN,23,45,6,6,12
49,8476822,Luke Glendening,C,TBL,35,75,5,7,12
49,8478569,Noel Acciari,C,PIT,33,53,5,7,12
49,8482807,Ethan Del Mastro,D,CHI,21,50,4,8,12
49,8482652,Walker Duehr,R,CGY,27,43,3,9,12
49,8475762,Derek Forbort,D,VAN,32,40,3,9,12
49,8480172,Jan Rutta,D,SJS,34,64,2,10,12
49,8478859,Niko Mikkola,D,FLA,28,59,2,10,12
49,8478409,Anthony Richard,C,PHI,28,33,2,10,12
49,8475179,Dmitry Kulikov,D,FLA,34,59,2,10,12
49,8478399,Jonas Siegenthaler,D,NJD,27,66,1,11,12
49,8480860,Kevin Bahl,D,CGY,24,57,1,11,12
49,8480001,Urho Vaakanainen,D,ANA,25,59,0,12,12
49,8482762,Simon Edvinsson,D,DET,21,54,8,3,11
49,8481028,Martin Pospisil,C,CGY,25,49,7,4,11
49,8480025,MacKenzie Entwistle,R,FLA,25,64,6,5,11
49,8479718,Alex Barré-Boulet,C,MTL,27,49,5,6,11
49,8479370,Tyson Jost,C,CAR,26,51,5,6,11
49,8481518,Nolan Foote,L,NJD,24,38,5,6,11
49,8477887,Patrick Brown,C,BOS,32,45,5,6,11
49,8476429,Scott Mayfield,D,NYI,32,74,4,7,11
49,8473453,Trevor Lewis,C,LAK,37,70,4,7,11
49,8479520,Brandon Duhaime,R,WSH,27,57,4,7,11
49,8482744,James Malatesta,L,CBJ,21,41,3,8,11
49,8478585,Derek Ryan,C,EDM,38,55,2,9,11
49,8479998,Mikey Anderson,D,LAK,25,59,1,10,11
49,8477845,Trevor van Riemsdyk,D,WSH,33,59,1,10,11
49,8479249,Andrew Poturalski,C,SJS,30,34,1,10,11
49,8473446,Erik Johnson,D,PHI,36,39,1,10,11
49,8479291,Kevin Rooney,C,CGY,31,53,1,10,11
49,8474673,TJ Brodie,D,CHI,34,59,0,11,11
49,8480196,Jacob Bryson,D,BUF,27,45,0,11,11
49,8481600,Tobias Bjornfot,D,FLA,23,36,7,3,10
49,8482859,Zack Ostapchuk,C,OTT,21,58,7,3,10
49,8477482,Zachary Sanford,L,CHI,30,42,6,4,10
49,8476934,Brock McGinn,L,ANA,30,58,5,5,10
49,8483549,Lucas Condotta,L,MTL,27,33,5,5,10
49,8481537,Nikita Okhotiuk,D,CGY,24,50,4,6,10
49,8476867,Brendan Gaunce,C,MIN,30,32,4,6,10
49,8476994,Vinnie Hinostroza,C,NSH,30,40,3,7,10
49,8483495,Simon Nemec,D,NJD,20,56,3,7,10
49,8480070,Ian Mitchell,D,BOS,25,51,3,7,10
49,8479772,Zack MacEwen,R,OTT,28,58,3,7,10
49,8479372,Joshua Mahura,D,SEA,26,49,2,8,10
49,8480887,Jordan Harris,D,MTL,24,50,2,8,10
49,8480192,Johnathan Kovacevic,D,NJD,27,53,2,8,10
49,8477971,Andreas Englund,D,LAK,28,26,2,8,10
49,8474013,Ian Cole,D,UTA,35,46,1,9,10
49,8480289,Morgan Barron,C,WPG,26,52,5,4,9
49,8475235,Nicolas Deslauriers,L,PHI,33,55,5,4,9
49,8476442,Matt Nieto,L,PIT,32,43,5,4,9
49,8479638,Justin Brazeau,R,BOS,26,34,4,5,9
49,8477070,Liam O'Brien,C,UTA,30,57,3,6,9
49,8481609,Vladislav Kolyachonok,D,UTA,23,26,3,6,9
49,8482751,Ryan Winterton,C,SEA,21,32,3,6,9
49,8477938,Haydn Fleury,D,WPG,28,38,3,6,9
49,8482192,Isaak Phillips,D,CHI,23,50,2,7,9
49,8471709,Marc-Edouard Vlasic,D,SJS,37,63,2,7,9
49,8479972,Mason Shaw,C,WPG,26,37,1,8,9
49,8474166,Alec Martinez,D,CHI,37,48,1,8,9
49,8481708,Zac Jones,D,NYR,24,51,1,8,9
49,8482861,Vincent Iorio,D,WSH,22,32,0,9,9
49,8481567,Henry Thrun,D,SJS,23,56,0,9,9
49,8481679,Maxence Guenette,D,OTT,23,36,5,3,8
49,8479994,Jaret Anderson-Dolan,C,WPG,25,31,4,4,8
49,8476624,Barclay Goodrow,C,SJS,31,54,4,4,8
49,8482153,Brendan Brisson,C,VGK,23,33,4,4,8
49,8482713,Mackie Samoskevich,R,FLA,22,41,4,4,8
49,8481550,Adam Beckman,L,NJD,23,34,3,5,8
49,8479442,Troy Stecher,D,EDM,30,54,3,5,8
49,8480007,Jonas Rondbjerg,R,VGK,25,40,3,5,8
49,8479968,Vinni Lettieri,C,BOS,29,46,3,5,8
49,8480292,Carson Meyer,R,ANA,27,33,3,5,8
49,8480245,Olle Lycksell,R,PHI,25,33,3,5,8
49,8482496,Nils Aman,C,VAN,24,42,3,5,8
49,8482666,Scott Morrow,D,CAR,22,52,1,7,8
49,8481059,Scott Perunovich,D,STL,26,57,1,7,8
49,8484254,Akito Hirose,D,VAN,25,41,1,7,8
49,8481789,Tye Kartye,L,SEA,23,39,4,3,7
49,8483012,Logan Morrison,C,SEA,22,43,4,3,7
49,8481556,John Beecher,C,BOS,23,36,4,3,7
49,8479379,Givani Smith,R,SJS,26,41,4,3,7
49,8476952,Dominic Toninato,C,WPG,30,37,3,4,7
49,8482765,Isak Rosen,R,BUF,21,26,3,4,7
49,8477401,John Hayden,C,SEA,29,29,3,4,7
49,8479536,Axel Jonsson-Fjallby,L,WPG,26,34,3,4,7
49,8479981,Jonah Gadjovich,L,FLA,26,45,3,4,7
49,8481543,Nikita Alexandrov,C,STL,24,22,3,4,7
49,8480845,Rasmus Kupari,C,WPG,24,41,2,5,7
49,8476913,Devin Shore,C,MIN,30,30,2,5,7
49,8480844,Grigori Denisenko,L,VGK,24,27,2,5,7
49,8483460,David Jiricek,D,CBJ,21,55,1,6,7
49,8481592,Jakob Pelletier,L,CGY,23,32,1,6,7
49,8479986,Kole Lind,R,DAL,26,48,1,6,7
49,8475177,Calvin de Haan,D,COL,33,36,0,7,7
49,8481422,Jake Lucchini,C,NSH,29,23,5,1,6
49,8482784,Zach Dean,C,STL,21,34,4,2,6
49,8482145,Mavrik Bourque,C,DAL,22,49,4,2,6
49,8483763,Maksymilian Szuber,D,UTA,22,26,4,2,6
49,8478011,Louie Belpedio,D,PHI,28,18,4,2,6
49,8477380,Jonny Brodzinski,C,NYR,31,52,2,4,6
49,8470600,Ryan Suter,D,STL,39,60,2,4,6
49,8475958,Michael Sgarbossa,C,WSH,32,22,2,4,6
49,8476858,Phillip Di Giuseppe,L,VAN,31,41,2,4,6
49,8477034,Jaycob Megna,D,FLA,32,48,2,4,6
49,8481532,Alex Turcotte,C,LAK,23,50,2,4,6
49,8480441,Trey Fix-Wolansky,R,CBJ,25,39,2,4,6
49,8477462,Robert Hagg,D,VGK,29,34,2,4,6
49,8481754,Nikita Nesterenko,C,ANA,23,25,2,4,6
49,8483619,Filip Roos,D,OTT,25,30,2,4,6
49,8478017,Mark Friedman,D,VAN,29,44,2,4,6
49,8476441,Joel Edmundson,D,LAK,31,40,2,4,6
49,8482141,Lukas Cormier,D,VGK,22,31,2,4,6
49,8476473,Connor Murphy,D,CHI,31,37,2,4,6
49,8481598,Philip Broberg,D,EDM,23,45,1,5,6
49,8471817,Ryan Reaves,R,TOR,37,51,1,5,6
49,8477384,Joshua Brown,D,EDM,30,42,1,5,6
49,8474612,Travis Hamonic,D,OTT,34,45,1,5,6
49,8483630,Pavol Regenda,L,ANA,25,27,1,5,6
49,8477335,Kyle Burroughs,D,LAK,29,42,1,5,6
49,8477073,Kurtis MacDermid,L,NJD,30,40,1,5,6
49,8482929,Emil Lilleberg,D,TBL,23,21,1,5,6
49,8481701,Santeri Hatakka,D,NJD,23,32,1,5,6
49,8478450,Parker Wotherspoon,D,BOS,27,34,1,5,6
49,8482733,Logan Mailloux,D,MTL,31,29,0,6,6
49,8483570,Ben Meyers,C,SEA,26,30,4,1,5
49,8477851,Jordan Oesterle,D,BOS,32,40,3,2,5
49,8481605,Jackson LaCombe,D,ANA,23,41,2,3,5
49,8477962,Brendan Lemieux,L,CAR,28,38,2,3,5
49,8481122,Simon Benoit,D,TOR,26,46,2,3,5
49,8478424,Jansen Harkins,C,ANA,27,37,1,4,5
49,8476372,Nick Seeler,D,PHI,31,50,1,4,5
49,8482511,Mason Lohrei,D,BOS,23,32,0,5,5
49,8484911,Collin Graf,R,SJS,22,46,0,5,5
49,8479576,Vincent Desharnais,D,VAN,28,31,0,5,5
49,8481593,Jayden Struble,D,MTL,23,24,0,5,5
49,8484287,Cole McWard,D,VAN,23,22,4,0,4
49,8479367,William Lockwood,R,FLA,26,20,3,1,4
49,8482166,Shakir Mukhamadullin,D,SJS,22,44,2,2,4
49,8482177,Marat Khusnutdinov,C,MIN,22,34,2,2,4
49,8483397,Marc McLaughlin,C,BOS,25,31,2,2,4
49,8480823,Alexander Alexeyev,D,WSH,25,15,2,2,4
49,8480890,Jan Jenik,C,OTT,24,27,2,2,4
49,8475750,Jon Merrill,D,MIN,32,61,1,3,4
49,8482747,Brennan Othmann,L,NYR,21,38,1,3,4
49,8479985,Cale Fleury,D,SEA,26,27,1,3,4
49,8480084,Nick DeSimone,D,NJD,30,12,1,3,4
49,8479378,Logan Stanley,D,WPG,26,42,1,3,4
49,8480834,Ty Emberson,D,SJS,24,32,1,3,4
49,8482250,Callahan Burke,C,VGK,27,17,1,3,4
49,8478051,Max Willman,C,NJD,29,17,1,3,4
49,8482165,Yan Kuznetsov,D,CGY,22,19,1,3,4
49,8481056,Spencer Stastney,D,NSH,24,29,0,4,4
49,8478874,Adam Gaudette,R,OTT,28,39,0,4,4
49,8477149,Scott Sabourin,R,SJS,32,15,0,4,4
49,8479419,Brett Murray,L,BUF,26,15,0,4,4
49,8482070,Mitchell Chaffee,R,TBL,26,56,3,0,3
49,8482144,Jack Thompson,D,SJS,22,23,3,0,3
49,8483597,Milos Kelemen,L,UTA,25,16,3,0,3
49,8481206,John Ludvig,D,PIT,24,19,3,0,3
49,8480032,Shane Bowers,C,NJD,25,11,3,0,3
49,8480870,Bo Groulx,C,NYR,24,29,2,1,3
49,8480880,Jakub Lauko,C,MIN,24,31,2,1,3
49,8480990,Declan Chisholm,D,MIN,24,35,2,1,3
49,8482147,Jean-Luc Foudy,C,COL,22,23,2,1,3
49,8478146,Matthew Highmore,C,OTT,28,24,1,2,3
49,8477473,Justin Bailey,R,SJS,29,23,1,2,3
49,8477467,Gustav Olofsson,D,SEA,30,18,1,2,3
49,8484325,Waltteri Merela,C,TBL,26,20,1,2,3
49,8479320,Maxime Lajoie,D,SEA,27,26,1,2,3
49,8477527,Ross Johnston,L,ANA,30,35,1,2,3
49,8482102,Vasily Ponomarev,C,PIT,22,22,1,2,3
49,8481147,Reese Johnson,C,MIN,26,37,0,3,3
49,8480267,Sammy Walker,C,MIN,25,24,0,3,3
49,8482858,Ryker Evans,D,SEA,23,21,0,3,3
49,8481806,Louis Crevier,D,CHI,23,16,0,3,3
49,8482162,Roby Jarventie,L,EDM,22,15,2,0,2
49,8482094,Daemon Hunt,D,MIN,22,19,2,0,2
49,8483567,Georgii Merkulov,C,BOS,24,14,2,0,2
49,8481065,Angus Crookshank,L,OTT,25,13,2,0,2
49,8480468,James Hamblin,L,EDM,25,16,1,1,2
49,8483512,Matthew Savoie,C,EDM,20,26,1,1,2
49,8484258,Sam Malinski,D,COL,26,20,1,1,2
49,8480851,Akil Thomas,C,LAK,24,22,1,1,2
49,8481043,Cole Koepke,L,BOS,26,15,1,1,2
49,8477244,Chad Ruhwedel,D,NYR,34,24,1,1,2
49,8480874,Adam Ginning,D,PHI,24,11,1,1,2
49,8481541,Samuel Bolduc,D,NYI,24,27,0,2,2
49,8478502,Dennis Gilbert,D,BUF,28,13,0,2,2
49,8477810,Joel Hanley,D,CGY,33,24,0,2,2
49,8478021,William Lagesson,D,DET,28,22,0,2,2
49,8481699,Aku Raty,R,UTA,23,20,0,2,2
49,8481719,Maxwell Crozier,D,TBL,24,21,0,2,2
49,8475755,Alexander Petrovic,D,DAL,32,13,0,2,2
49,8480306,Grant Hutton,D,NYI,29,7,0,2,2
49,8481030,Jack St. Ivany,D,PIT,25,15,1,0,1
49,8479362,Riley Tufte,L,BOS,26,20,1,0,1
49,8481237,Kyle MacLean,C,NYI,25,22,1,0,1
49,8478854,Ryan Shea,D,PIT,27,4,1,0,1
49,8482172,Landon Slaggert,L,CHI,22,21,1,0,1
49,8475413,Justin Dowling,C,NJD,34,12,1,0,1
49,8479330,Brandon Gignac,C,MTL,27,10,1,0,1
49,8484255,Jason Polin,R,COL,25,3,1,0,1
49,8479991,Jake Leschyshyn,C,NYR,25,30,0,1,1
49,8477320,Anton Blidh,L,NYR,29,19,0,1,1
49,8481743,Marc Del Gaizo,D,NSH,25,12,0,1,1
49,8481585,Egor Afanasyev,L,SJS,23,16,0,1,1
49,8482516,Matthew Kessel,D,STL,24,14,0,1,1
49,8482118,Sam Colangelo,R,ANA,23,12,0,1,1
49,8482088,Justin Sourdif,R,FLA,22,15,0,1,1
49,8481024,Linus Karlsson,C,VAN,25,10,0,1,1
49,8479587,Rhett Gardner,C,PHI,28,18,0,1,1
49,8481564,Ryan Johnson,D,BUF,23,12,0,1,1
49,8481578,Graeme Clarke,R,MIN,23,14,0,1,1
49,8474062,Riley Nash,C,NYR,35,14,0,1,1
49,8477541,Dakota Mermis,D,TOR,30,8,0,1,1
49,8484304,Uvis Balinskis,D,FLA,28,8,0,1,1
49,8482476,Emil Heineman,L,MTL,23,8,0,1,1
49,8482470,Ilya Solovyov,D,CGY,24,18,0,0,0
49,8478881,Brett Seney,L,CHI,28,9,0,0,0
49,8478477,Mitchell Stephens,C,SEA,27,17,0,0,0
49,8481006,Tyler Tucker,D,STL,24,18,0,0,0
49,8481462,Mason Morelli,L,VGK,28,10,0,0,0
49,8478446,Glenn Gawdin,C,LAK,27,9,0,0,0
49,8482201,Gage Goncalves,C,TBL,23,21,0,0,0
49,8481726,Adam Edstrom,C,NYR,24,8,0,0,0
49,8483489,Fraser Minten,C,TOR,31,12,0,0,0
49,8482787,Nikita Chibrikov,R,WPG,31,4,0,0,0
49,8475795,Dylan McIlrath,D,WSH,32,14,0,0,0
49,8482061,Brandon Biro,L,SEA,26,14,0,0,0
49,8483471,Brad Lambert,C,WPG,31,7,0,0,0
49,8483407,Brandon Scanlin,D,NYR,25,2,0,0,0
49,8481655,Cole Schwindt,R,CGY,23,4,0,0,0
49,8479522,Hardy Haman Aktell,D,WSH,26,3,0,0,0
49,8483531,Brian Halonen,L,NJD,25,3,0,0,0
49,8482460,Matt Rempe,C,NYR,22,14,0,0,0
49,8476323,Max McCormick,L,SEA,32,4,0,0,0
49,8482197,Adam Raska,R,MIN,23,9,0,0,0
49,8483395,Arshdeep Bains,L,VAN,23,10,0,0,0
49,8483609,Adam Klapka,R,CGY,24,7,0,0,0
49,8480075,Cameron Crotty,D,MIN,25,13,0,0,0
49,8478147,Bokondji Imama,L,PIT,28,5,0,0,0
49,8483546,Marshall Rifai,D,TOR,26,2,0,0,0
49,8475780,Chris Wagner,R,COL,33,9,0,0,0
49,8479421,Jacob Moverare,D,LAK,26,1,0,0,0
49,8483432,Luca Del Bel Belluz,C,CBJ,31,6,0,0,0
49,8483401,Marc Johnstone,R,PIT,28,1,0,0,0
49,8483920,Pierrick Dube,R,WSH,23,6,0,0,0
49,8484326,Patrik Koch,D,UTA,28,2,0,0,0
49,8477993,Justin Kirkland,C,CGY,28,5,0,0,0
49,8482126,Emil Andrae,D,PHI,31,3,0,0,0
49,8484259,Ondrej Pavel,C,COL,31,1,0,0,0
49,8484321,Nikolas Matinpalo,D,OTT,26,2,0,0,0
49,8483398,Declan Carlile,D,TBL,31,9,0,0,0
49,8481534,Raphael Lavoie,C,EDM,24,3,0,0,0
49,8483045,Cameron Butler,R,CBJ,31,1,0,0,0
49,8478956,Samuel Laberge,L,NJD,27,1,0,0,0
49,8480274,Philip Kemp,D,EDM,25,0,0,0,0
49,8470794,Joe Pavelski,C,,40,0,0,0,0
49,8479321,Lucas Johansen,D,,27,0,0,0,0
49,8477950,Tony DeAngelo,D,,29,0,0,0,0
49,8471218,Blake Wheeler,R,,38,0,0,0,0
49,8475197,Tyson Barrie,D,,33,0,0,0,0
49,8474157,Max Pacioretty,L,,36,0,0,0,0
49,8475744,Evgeny Kuznetsov,C,,32,0,0,0,0
49,8474037,James van Riemsdyk,L,,35,0,0,0,0
49,8476907,Mackenzie MacEachern,L,,30,0,0,0,0
49,8480216,Jacob Peterson,C,,25,0,0,0,0
49,8474602,Justin Schultz,D,,34,0,0,0,0
49,8482222,Alexander Barabanov,L,,30,0,0,0,0
49,8474031,Kevin Shattenkirk,D,,35,0,0,0,0
49,8477330,Dominik Kubalik,L,,29,0,0,0,0
49,8480884,Calen Addison,D,,24,0,0,0,0
49,8475906,John Klingberg,D,,32,0,0,0,0
49,8480008,Adam Ruzicka,C,,25,0,0,0,0
49,8476884,Derrick Pouliot,D,,30,0,0,0,0
49,8476919,Chris Tierney,C,,30,0,0,0,0
49,8479415,Michael McLeod,C,,26,0,0,0,0
49,8474870,Tyler Johnson,C,,34,0,0,0,0
49,8470604,Jeff Carter,C,,39,0,0,0,0
49,8478104,Sammy Blais,L,,28,0,0,0,0
49,8474884,Mike Hoffman,C,,35,0,0,0,0
49,8481591,Sam Poulin,R,,23,0,0,0,0
49,8471274,Alex Goligoski,D,,39,0,0,0,0
49,8476871,Tanner Pearson,L,,32,0,0,0,0
49,8476393,Nick Cousins,C,,31,0,0,0,0
49,8479977,Kailer Yamamoto,R,,26,0,0,0,0
49,8479346,Dillon Dube,C,,26,0,0,0,0
49,8480184,Gustav Lindstrom,D,,26,0,0,0,0
49,8479376,Victor Mete,D,,26,0,0,0,0
49,8473449,Kyle Okposo,R,,36,0,0,0,0
49,8481058,Jesse Ylonen,R,,25,0,0,0,0
49,8475752,Tyler Pitlick,C,,33,0,0,0,0
49,8481239,Samuel Fagemo,L,,24,0,0,0,0
49,8480821,Filip Zadina,R,,25,0,0,0,0
49,8470966,Mark Giordano,D,,41,0,0,0,0
49,8478495,Denis Gurianov,R,,27,0,0,0,0
49,8477464,Nic Petan,C,,29,0,0,0,0
49,8478099,Kevin Labanc,R,,29,0,0,0,0
49,8482241,Radim Zohorna,L,,28,0,0,0,0
49,8474040,Sam Gagner,C,,35,0,0,0,0
49,8479514,Rem Pitlick,C,,27,0,0,0,0
49,8478430,Oliver Kylington,D,,27,0,0,0,0
49,8479533,Joona Koppanen,L,,26,0,0,0,0
49,8479984,Cal Foote,D,,26,0,0,0,0
49,8477126,Jayson Megna,C,,34,0,0,0,0
49,8475164,Jakob Silfverberg,R,,34,0,0,0,0
49,8474009,Nick Bonino,C,,36,0,0,0,0
49,8479458,Nikita Zaitsev,D,,33,0,0,0,0
49,8477944,Jakub Vrana,L,,28,0,0,0,0
49,8471699,Andrew Cogliano,C,,37,0,0,0,0
49,8478067,Oskar Lindblom,L,,28,0,0,0,0
49,8471686,Marc Staal,D,,37,0,0,0,0
49,8470610,Zach Parise,L,,40,0,0,0,0
49,8478904,Steven Lorentz,C,,28,0,0,0,0
49,8473473,Milan Lucic,L,,36,0,0,0,0
49,8480031,Maxime Comtois,L,,25,0,0,0,0
49,8478512,Austin Czarnik,C,,32,0,0,0,0
49,8473504,Cal Clutterbuck,R,,37,0,0,0,0
49,8477454,Adam Erne,L,,29,0,0,0,0
49,8479383,Boris Katchouk,L,,26,0,0,0,0
49,8475825,Jani Hakanpää,D,,32,0,0,0,0
49,8477846,Ryan Carpenter,C,,33,0,0,0,0
49,8477930,Pierre-Edouard Bellemare,L,,39,0,0,0,0
49,8478400,Colin White,C,,27,0,0,0,0
49,8480226,Marián Studenic,R,,26,0,0,0,0
49,8480853,Liam Foudy,C,,24,0,0,0,0
49,8475797,Jarred Tinordi,D,,32,0,0,0,0
49,8479423,Alex Nylander,L,,26,0,0,0,0
49,8474618,Marco Scandella,D,,34,0,0,0,0
49,8478028,Fredrik Olofsson,L,,28,0,0,0,0
49,8474709,Matt Martin,L,,35,0,0,0,0
49,8481070,Hugh McGing,L,,26,0,0,0,0
49,8479546,Oskar Steen,C,,26,0,0,0,0
49,8474145,Robert Bortuzzo,D,,35,0,0,0,0
49,8476915,Jujhar Khaira,L,,30,0,0,0,0
49,8475278,Byron Froese,C,,33,0,0,0,0
49,8481812,Nikolai Knyzhov,D,,27,0,0,0,0
49,8478408,Travis Dermott,D,,28,0,0,0,0
49,8481077,John Leonard,L,,26,0,0,0,0
49,8479547,Matthew Phillips,R,,26,0,0,0,0
49,8480836,Jonathan Gruden,C,,24,0,0,0,0
49,8481690,Tyler Angle,C,,24,0,0,0,0
49,8475766,Austin Watson,L,,32,0,0,0,0
49,8481016,Ruslan Iskhakov,C,,24,0,0,0,0
49,8478078,Rourke Chartier,C,,28,0,0,0,0
49,8480776,Sheldon Rempal,R,,29,0,0,0,0
49,8484314,Jiri Smejkal,L,,28,0,0,0,0
50,8477492,Nathan MacKinnon,C,COL,29,82,56,84,140
50,8479318,Auston Matthews,C,TOR,27,81,66,64,130
50,8477956,David Pastrnak,R,BOS,28,79,68,61,129
50,8477934,Leon Draisaitl,C,EDM,29,77,52,63,115
50,8478402,Connor McDavid,C,EDM,27,78,25,87,112
50,8479314,Matthew Tkachuk,L,FLA,27,80,40,71,111
50,8478420,Mikko Rantanen,R,COL,28,82,48,60,108
50,8476453,Nikita Kucherov,R,TBL,31,81,36,72,108
50,8481559,Jack Hughes,C,NJD,23,75,40,66,106
50,8478864,Kirill Kaprizov,L,MIN,27,72,41,64,105
50,8476468,J.T. Miller,C,VAN,31,76,38,66,104
50,8477946,Dylan Larkin,C,DET,28,80,56,46,102
50,8478445,Mathew Barzal,C,NYI,27,82,34,68,102
50,8478550,Artemi Panarin,L,NYR,33,79,26,75,101
50,8480012,Elias Pettersson,C,VAN,26,77,47,51,98
50,8471675,Sidney Crosby,C,PIT,37,75,43,55,98
50,8477493,Aleksander Barkov,C,FLA,29,81,28,70,98
50,8477939,William Nylander,R,TOR,28,79,51,45,96
50,8477942,Kevin Fiala,L,LAK,28,77,27,69,96
50,8480801,Brady Tkachuk,L,OTT,25,81,43,52,95
50,8477404,Jake Guentzel,C,TBL,30,82,36,59,95
50,8478403,Jack Eichel,C,VGK,28,77,44,48,92
50,8476887,Filip Forsberg,L,NSH,30,79,46,45,91
50,8480027,Jason Robertson,L,DAL,25,79,33,58,91
50,8477933,Sam Reinhart,C,FLA,29,78,34,56,90
50,8480002,Nico Hischier,C,NJD,25,79,30,60,90
50,8480023,Robert Thomas,C,STL,25,76,26,64,90
50,8478483,Mitch Marner,R,TOR,27,76,22,68,90
50,8474564,Steven Stamkos,C,NSH,34,78,46,43,89
50,8473419,Brad Marchand,L,BOS,36,77,28,61,89
50,8480800,Quinn Hughes,D,VAN,25,78,10,78,88
50,8475913,Mark Stone,R,VGK,32,76,31,56,87
50,8481557,Matt Boldy,L,MIN,23,72,42,44,86
50,8479323,Adam Fox,D,NYR,26,76,22,64,86
50,8478398,Kyle Connor,L,WPG,28,75,40,45,85
50,8477402,Pavel Buchnevich,L,STL,29,73,30,55,85
50,8476460,Mark Scheifele,C,WPG,31,75,35,49,84
50,8480069,Cale Makar,D,COL,26,73,25,59,84
50,8479343,Clayton Keller,R,UTA,26,79,46,37,83
50,8479407,Jesper Bratt,L,NJD,26,74,38,45,83
50,8476389,Vincent Trocheck,C,NYR,31,79,29,54,83
50,8479337,Alex DeBrincat,R,DET,27,82,33,49,82
50,8477940,Nikolaj Ehlers,L,WPG,28,76,30,52,82
50,8480036,Miro Heiskanen,D,DAL,25,79,11,71,82
50,8477501,Valeri Nichushkin,R,COL,29,81,42,39,81
50,8475172,Nazem Kadri,C,CGY,34,77,36,45,81
50,8474600,Roman Josi,D,NSH,34,72,22,59,81
50,8477504,Josh Morrissey,D,WPG,29,73,20,61,81
50,8471214,Alex Ovechkin,L,WSH,39,74,37,43,80
50,8476539,Jonathan Marchessault,R,NSH,34,71,43,35,78
50,8482116,Tim Stützle,C,OTT,22,81,30,48,78
50,8478427,Sebastian Aho,C,CAR,27,73,39,38,77
50,8475158,Ryan O'Reilly,C,NSH,33,70,30,47,77
50,8471685,Anze Kopitar,C,LAK,37,79,28,49,77
50,8475166,John Tavares,C,TOR,34,80,40,36,76
50,8479385,Jordan Kyrou,C,STL,26,73,29,47,76
50,8475786,Zach Hyman,L,EDM,32,81,43,32,75
50,8477409,Carter Verhaeghe,C,FLA,29,76,40,35,75
50,8476448,William Karlsson,C,VGK,31,79,31,44,75
50,8478010,Brayden Point,C,TBL,28,81,30,45,75
50,8479999,Casey Mittelstadt,C,COL,26,81,22,53,75
50,8480865,Noah Dobson,D,NYI,24,80,16,59,75
50,8478440,Dylan Strome,C,WSH,27,76,24,50,74
50,8479420,Tage Thompson,C,BUF,27,75,37,36,73
50,8477949,Alex Tuch,R,BUF,28,69,31,42,73
50,8475754,Brock Nelson,C,NYI,33,81,31,42,73
50,8478873,Troy Terry,R,ANA,27,77,28,45,73
50,8473512,Claude Giroux,R,OTT,36,78,24,49,73
50,8478401,Pavel Zacha,C,BOS,27,79,27,45,72
50,8480208,Drake Batherson,R,OTT,26,78,26,45,71
50,8476459,Mika Zibanejad,C,NYR,31,77,25,46,71
50,8478493,Joel Eriksson Ek,C,MIN,27,73,32,38,70
50,8477500,Bo Horvat,C,NYI,29,78,31,39,70
50,8475765,Vladimir Tarasenko,R,DET,33,80,30,40,70
50,8481068,Yegor Sharangovich,C,CGY,26,80,24,46,70
50,8484144,Connor Bedard,C,CHI,19,69,21,49,70
50,8476456,Jonathan Huberdeau,C,CGY,31,77,18,52,70
50,8477960,Adrian Kempe,R,LAK,28,81,33,36,69
50,8483808,Andrei Kuzmenko,L,CGY,28,79,35,33,68
50,8478439,Travis Konecny,R,PHI,27,72,30,38,68
50,8475784,Jeff Skinner,C,EDM,32,75,29,39,68
50,8475810,Bryan Rust,R,PIT,32,74,26,42,68
50,8481540,Cole Caufield,R,MTL,23,78,33,33,66
50,8479675,Trevor Moore,L,LAK,29,80,29,37,66
50,8475168,Matt Duchene,C,DAL,33,81,26,40,66
50,8477494,Jonathan Drouin,L,COL,29,82,24,42,66
50,8477496,Elias Lindholm,C,BOS,30,82,26,39,65
50,8476881,Tomas Hertl,C,VGK,31,78,30,34,64
50,8480015,Owen Tippett,R,PHI,25,74,30,34,64
50,8478856,Conor Garland,R,VAN,28,78,19,45,64
50,8475798,Mikael Granlund,C,SJS,32,73,19,45,64
50,8482684,Luke Hughes,D,NJD,21,73,11,53,64
50,8478397,Rasmus Andersson,D,CGY,28,77,14,49,63
50,8478444,Brock Boeser,R,VAN,27,75,27,34,61
50,8473986,Alex Killorn,L,ANA,35,76,27,34,61
50,8484153,Leo Carlsson,C,ANA,20,73,24,37,61
50,8473994,Jamie Benn,L,DAL,35,82,22,39,61
50,8475692,Mats Zuccarello,R,MIN,37,74,17,44,61
50,8476454,Ryan Nugent-Hopkins,C,EDM,31,79,13,48,61
50,8482740,Wyatt Johnston,C,DAL,21,82,35,25,60
50,8475184,Chris Kreider,L,NYR,33,79,34,26,60
50,8481533,Trevor Zegras,C,ANA,23,74,28,32,60
50,8482745,Mason McTavish,C,ANA,21,75,27,33,60
50,8480830,Andrei Svechnikov,R,CAR,24,70,24,36,60
50,8474141,Patrick Kane,R,DET,36,79,16,44,60
50,8480018,Nick Suzuki,C,MTL,25,77,15,45,60
50,8475170,Brayden Schenn,C,STL,33,78,28,31,59
50,8475726,Tyler Toffoli,C,SJS,32,67,27,32,59
50,8474679,Gustav Nyquist,C,NSH,35,72,21,38,59
50,8478047,Michael Bunting,L,PIT,29,71,19,40,59
50,8482078,Lucas Raymond,L,DET,22,79,29,29,58
50,8477935,Sam Bennett,C,FLA,28,81,20,38,58
50,8480039,Martin Necas,C,CAR,25,65,17,41,58
50,8475151,Kyle Palmieri,C,NYI,33,76,27,30,57
50,8479542,Brandon Hagel,L,TBL,26,82,26,31,57
50,8478414,Timo Meier,R,NJD,28,70,26,31,57
50,8482149,Cole Perfetti,C,WPG,22,71,18,39,57
50,8478449,Roope Hintz,C,DAL,28,81,25,31,56
50,8471215,Evgeni Malkin,C,PIT,38,73,23,33,56
50,8482667,William Eklund,L,SJS,22,68,19,37,56
50,8474578,Erik Karlsson,D,PIT,34,82,18,38,56
50,8480803,Evan Bouchard,D,EDM,25,74,17,39,56
50,8474102,David Perron,L,OTT,36,77,24,31,55
50,8482097,Jack Quinn,R,BUF,23,64,20,35,55
50,8475745,Charlie Coyle,C,BOS,32,78,19,36,55
50,8476853,Morgan Rielly,D,TOR,30,74,8,47,55
50,8482665,Matty Beniers,C,SEA,22,73,23,31,54
50,8482720,Matthew Knies,L,TOR,22,74,22,32,54
50,8480839,Rasmus Dahlin,D,BUF,24,71,21,33,54
50,8477476,Artturi Lehkonen,L,COL,29,82,21,33,54
50,8476905,Chandler Stephenson,C,SEA,30,75,11,43,54
50,8481542,Moritz Seider,D,DET,23,74,10,44,54
50,8483515,Juraj Slafkovsky,L,MTL,20,77,28,25,53
50,8479400,Pierre-Luc Dubois,L,WSH,26,74,25,28,53
50,8478472,Mathieu Joseph,R,STL,27,76,24,29,53
50,8479987,Morgan Geekie,C,BOS,26,80,22,31,53
50,8480028,Morgan Frost,C,PHI,25,78,21,32,53
50,8477447,Shea Theodore,D,VGK,29,62,10,43,53
50,8478396,Noah Hanifin,D,VGK,27,67,9,44,53
50,8478366,Frank Vatrano,R,ANA,30,70,27,25,52
50,8481528,Dylan Cozens,C,BUF,23,74,26,26,52
50,8477955,Jared McCann,L,SEA,28,76,24,28,52
50,8478975,Mason Marchment,L,DAL,29,82,23,29,52
50,8474586,Jordan Eberle,R,SEA,34,71,18,34,52
50,8474150,Mikael Backlund,C,CGY,35,78,18,34,52
50,8476346,Johnny Gaudreau,L,CBJ,31,73,17,35,52
50,8477986,Brandon Montour,D,SEA,30,72,16,36,52
50,8475794,Tyler Seguin,C,DAL,32,80,26,25,51
50,8475169,Evander Kane,L,EDM,33,79,25,26,51
50,8474641,Adam Henrique,C,EDM,34,78,24,27,51
50,8479525,Ross Colton,C,COL,28,81,23,28,51
50,8482699,Dylan Guenther,R,UTA,21,71,21,30,51
50,8477407,Anthony Duclair,L,NYI,29,75,19,32,51
50,8478438,Tommy Novak,C,NSH,27,65,19,32,51
50,8477951,Nick Schmaltz,C,UTA,28,76,18,33,51
50,8477964,Ivan Barbashev,C,VGK,29,77,18,33,51
50,8475167,Victor Hedman,D,TBL,34,80,17,34,51
50,8480797,Joel Farabee,L,PHI,24,76,17,33,50
50,8476292,Ondrej Palat,L,NJD,33,76,16,34,50
50,8479425,Filip Hronek,D,VAN,27,72,9,41,50
50,8482113,Anton Lundell,C,FLA,23,72,21,28,49
50,8481596,Shane Pinto,C,OTT,24,76,19,30,49
50,8482109,Alexis Lafrenière,L,NYR,23,77,27,21,48
50,8484166,Adam Fantilli,C,CBJ,20,68,27,21,48
50,8476399,Blake Coleman,C,CGY,33,77,26,22,48
50,8475191,Reilly Smith,R,NYR,33,75,24,24,48
50,8478519,Anthony Cirelli,C,TBL,27,82,22,26,48
50,8477505,Alexander Wennberg,C,SJS,30,67,21,27,48
50,8477416,Oliver Bjorkstrand,R,SEA,29,78,23,24,47
50,8480185,Eetu Luostarinen,C,FLA,26,73,17,30,47
50,8478407,Vince Dunn,D,SEA,28,72,14,33,47
50,8476906,Shayne Gostisbehere,D,CAR,31,78,13,34,47
50,8474590,John Carlson,D,WSH,34,68,12,35,47
50,8470613,Brent Burns,D,CAR,39,79,10,37,47
50,8479325,Charlie McAvoy,D,BOS,27,77,9,38,47
50,8471724,Kris Letang,D,PIT,37,81,8,39,47
50,8477451,Ryan Hartman,R,MIN,30,70,22,24,46
50,8481604,Pavel Dorofeyev,L,VGK,24,68,17,29,46
50,8476792,Torey Krug,D,STL,33,74,13,33,46
50,8482702,Logan Stankoven,C,DAL,21,81,24,21,45
50,8482159,Tyson Foerster,R,PHI,22,76,22,23,45
50,8471698,T.J. Oshie,R,WSH,38,64,20,25,45
50,8477021,Alex Kerfoot,C,UTA,30,76,19,26,45
50,8478462,Nicolas Roy,C,VGK,27,75,19,26,45
50,8478474,Lawson Crouse,L,UTA,27,74,18,27,45
50,8478046,Danton Heinen,L,VAN,29,69,18,27,45
50,8476826,Yanni Gourde,C,SEA,33,75,17,28,45
50,8476880,Tom Wilson,R,WSH,30,69,16,29,45
50,8478542,Evan Rodrigues,C,FLA,31,78,16,29,45
50,8478469,Thomas Chabot,D,OTT,27,75,13,32,45
50,8482712,Oskar Olausson,R,COL,22,80,11,34,45
50,8482124,Quinton Byfield,R,LAK,22,82,10,35,45
50,8475764,Cam Fowler,D,ANA,33,74,8,37,45
50,8476875,Mike Matheson,D,MTL,30,69,6,39,45
50,8476483,Rickard Rakell,R,PIT,31,72,24,20,44
50,8482093,Seth Jarvis,C,CAR,22,66,22,22,44
50,8480064,Josh Norris,C,OTT,25,75,21,23,44
50,8479992,Michael Rasmussen,C,DET,25,76,17,27,44
50,8477932,Aaron Ekblad,D,FLA,28,74,15,29,44
50,8476462,Dougie Hamilton,D,NJD,31,71,14,30,44
50,8476872,Scott Laughton,C,PHI,30,74,14,30,44
50,8477495,Seth Jones,D,CHI,30,71,11,33,44
50,8476923,Damon Severson,D,CBJ,30,82,11,33,44
50,8475799,Nino Niederreiter,R,WPG,32,69,33,10,43
50,8478498,Jake DeBrusk,L,VAN,28,68,30,13,43
50,8477511,Anthony Mantha,R,CGY,30,76,20,23,43
50,8480188,Fabian Zetterlund,L,SJS,25,63,18,25,43
50,8482122,Brock Faber,D,MIN,22,78,7,36,43
50,8475314,Anders Lee,L,NYI,34,75,25,17,42
50,8482110,Dawson Mercer,C,NJD,23,74,24,18,42
50,8482175,JJ Peterka,R,BUF,22,69,24,18,42
50,8476882,Teuvo Teravainen,C,CHI,30,68,19,23,42
50,8480009,Eeli Tolvanen,R,SEA,25,74,19,23,42
50,8475287,Erik Haula,L,NJD,33,71,18,24,42
50,8480871,Adam Boqvist,D,FLA,24,70,17,25,42
50,8477953,Kasperi Kapanen,R,STL,28,74,14,28,42
50,8481711,Matias Maccelli,L,UTA,24,72,13,29,42
50,8475753,Justin Faulk,D,STL,32,69,11,31,42
50,8476979,Erik Gustafsson,D,DET,32,75,4,38,42
50,8477998,Warren Foegele,L,LAK,28,81,24,17,41
50,8476479,Phillip Danault,C,LAK,31,76,23,18,41
50,8483431,Logan Cooley,C,UTA,20,78,19,22,41
50,8478042,Viktor Arvidsson,L,EDM,31,73,16,25,41
50,8476461,Sean Couturier,C,PHI,32,69,15,26,41
50,8482146,Luke Evangelista,R,NSH,22,65,13,28,41
50,8481577,Philip Tomasino,C,NSH,23,66,12,29,41
50,8478460,Zach Werenski,D,CBJ,27,78,11,30,41
50,8478055,Gustav Forsling,D,FLA,28,70,7,34,41
50,8476432,Boone Jenner,C,CBJ,31,68,28,12,40
50,8480014,Gabriel Vilardi,C,WPG,25,65,26,14,40
50,8480113,Alex Iafallo,L,WPG,31,68,17,23,40
50,8478233,Andrew Mangiapane,L,WSH,28,66,14,26,40
50,8480434,Sean Durzi,D,UTA,26,73,12,28,40
50,8474565,Alex Pietrangelo,D,VGK,34,57,10,30,40
50,8479410,Mikhail Sergachev,D,UTA,26,73,9,31,40
50,8482133,Thomas Bordeleau,C,SJS,22,61,9,31,40
50,8475848,Brendan Gallagher,R,MTL,32,74,19,20,39
50,8476925,Colton Sissons,C,NSH,31,74,15,24,39
50,8478109,Victor Olofsson,L,VGK,29,65,13,26,39
50,8479345,Jakob Chychrun,D,WSH,26,64,12,27,39
50,8478466,Daniel Sprong,R,VAN,27,75,19,19,38
50,8479339,Patrik Laine,L,CBJ,26,56,17,21,38
50,8478057,Dakota Joshua,C,VAN,28,71,15,23,38
50,8477479,Tyler Bertuzzi,L,CHI,29,65,13,25,38
50,8477444,Andre Burakovsky,L,SEA,29,71,13,25,38
50,8475722,Jason Zucker,L,BUF,32,66,12,26,38
50,8477948,Travis Sanheim,D,PHI,28,70,8,30,38
50,8481618,Alex Newhook,C,MTL,23,69,18,19,37
50,8477456,J.T. Compher,L,DET,29,77,17,20,37
50,8477429,Andrew Copp,C,DET,30,79,16,21,37
50,8478115,Pierre Engvall,L,NYI,28,75,14,23,37
50,8484145,Zach Benson,L,BUF,19,69,13,24,37
50,8476419,Jean-Gabriel Pageau,C,NYI,32,77,13,24,37
50,8475218,Mattias Ekholm,D,EDM,34,72,12,25,37
50,8477346,MacKenzie Weegar,D,CGY,30,73,10,27,37
50,8481554,Kaapo Kakko,R,NYR,23,70,22,14,36
50,8479365,Trent Frederic,C,BOS,26,73,15,21,36
50,8478463,Anthony Beauvillier,L,PIT,27,66,15,21,36
50,8477426,Nicholas Paul,L,TBL,29,82,14,22,36
50,8475760,Nick Bjugstad,C,UTA,32,76,14,22,36
50,8481186,Logan O'Connor,R,COL,28,80,14,22,36
50,8477497,Sean Monahan,C,CBJ,30,74,10,26,36
50,8481546,Cam York,D,PHI,23,68,10,26,36
50,8476869,Brady Skjei,D,NSH,30,67,8,28,36
50,8476854,Hampus Lindholm,D,BOS,30,74,8,28,36
50,8476463,Jonas Brodin,D,MIN,31,76,8,28,36
50,8474563,Drew Doughty,D,LAK,35,71,7,29,36
50,8475793,Ryan Johansen,C,PHI,32,74,18,17,35
50,8478013,Jake Walman,D,SJS,28,68,17,18,35
50,8479390,Taylor Raddysh,R,WSH,26,71,17,18,35
50,8479353,Brett Howden,C,VGK,26,74,16,19,35
50,8478458,John (Jack) Roslovic,C,CAR,27,58,15,20,35
50,8482671,Owen Power,D,BUF,22,74,13,22,35
50,8478020,Michael Amadio,R,OTT,28,77,13,22,35
50,8476458,Ryan Strome,C,ANA,31,70,13,22,35
50,8476927,Teddy Blueger,C,VAN,30,65,11,24,35
50,8474716,Jared Spurgeon,D,MIN,35,75,8,27,35
50,8481703,Valtteri Puustinen,R,PIT,25,58,7,28,35
50,8476892,Colton Parayko,D,STL,31,71,7,28,35
50,8481581,Thomas Harley,D,DAL,23,75,5,30,35
50,8475714,Calle Jarnkrok,C,TOR,33,74,17,17,34
50,8476438,Brandon Saad,L,STL,32,68,16,18,34
50,8476958,Jaccob Slavin,D,CAR,30,79,10,24,34
50,8481704,Juuso Parssinen,C,NSH,23,58,9,25,34
50,8476917,Adam Pelech,D,NYI,30,73,9,25,34
50,8480817,K'Andre Miller,D,NYR,24,68,5,29,34
50,8480145,Neal Pionk,D,WPG,29,67,3,31,34
50,8474149,Evgenii Dadonov,R,DAL,35,80,21,12,33
50,8482125,Alexander Holtz,R,VGK,22,71,19,14,33
50,8476480,Vladislav Namestnikov,C,WPG,32,67,12,21,33
50,8479371,Dante Fabbro,D,NSH,26,63,4,29,33
50,8470621,Corey Perry,R,EDM,39,72,18,14,32
50,8479591,Michael Eyssimont,C,TBL,28,82,16,16,32
50,8481560,Arthur Kaliyev,R,LAK,23,78,15,17,32
50,8473533,Jordan Staal,C,CAR,36,65,15,17,32
50,8476392,Adam Lowry,C,WPG,31,58,14,18,32
50,8476474,Stefan Noesen,R,NJD,31,70,14,18,32
50,8480748,Kiefer Sherwood,L,VAN,29,67,12,20,32
50,8480798,Philipp Kurashev,C,CHI,25,65,11,21,32
50,8477503,Max Domi,C,TOR,29,80,10,22,32
50,8481656,Aliaksei Protas,C,WSH,23,61,6,26,32
50,8476902,Esa Lindell,D,DAL,30,74,5,27,32
50,8473422,Nick Foligno,L,CHI,37,63,14,17,31
50,8481523,Kirby Dach,C,MTL,23,69,9,22,31
50,8481606,Jordan Spence,D,LAK,23,67,8,23,31
50,8479398,Samuel Girard,D,COL,26,67,7,24,31
50,8483524,Shane Wright,C,SEA,20,62,20,10,30
50,8480829,Jesperi Kotkaniemi,C,CAR,24,62,16,14,30
50,8482092,Ridly Greig,C,OTT,22,74,15,15,30
50,8481580,Connor McMichael,C,WSH,23,66,15,15,30
50,8478891,Mason Appleton,C,WPG,28,64,14,16,30
50,8482079,Marco Rossi,C,MIN,23,57,14,16,30
50,8481624,Ilya Mikheyev,R,CHI,30,60,12,18,30
50,8482117,Lukas Reichel,L,CHI,22,50,12,18,30
50,8481441,Joe Snively,C,DET,28,63,12,18,30
50,8476422,Mike Reilly,D,NYI,31,77,11,19,30
50,8477919,Frederick Gaudreau,C,MIN,31,60,11,19,30
50,8479661,Tanner Jeannot,L,LAK,27,78,9,21,30
50,8479402,Jake Bean,D,CGY,26,71,6,24,30
50,8483490,Pavel Mintyukov,D,ANA,21,72,5,25,30
50,8478038,Devon Toews,D,COL,30,71,4,26,30
50,8483505,Matthew Poitras,C,BOS,20,71,2,28,30
50,8479414,Nathan Bastian,R,NJD,27,59,18,11,29
50,8478911,Matt Roy,D,WSH,29,63,8,21,29
50,8477989,Christian Dvorak,C,MTL,28,64,8,21,29
50,8482660,Kent Johnson,C,CBJ,22,64,7,22,29
50,8482624,Daniil Miromanov,D,CGY,27,61,6,23,29
50,8480893,Kirill Marchenko,R,CBJ,24,63,15,13,28
50,8475768,Jaden Schwartz,C,SEA,32,71,12,16,28
50,8481582,Nicholas Robertson,L,TOR,23,63,12,16,28
50,8477947,Sonny Milano,L,WSH,28,65,12,16,28
50,8480068,Ryan Poehling,C,PHI,25,72,10,18,28
50,8475200,Dmitry Orlov,D,CAR,33,69,8,20,28
50,8481521,Ronnie Attard,D,PHI,25,58,8,20,28
50,8474053,Logan Couture,C,SJS,35,62,7,21,28
50,8480336,Sean Walker,D,CAR,30,73,7,21,28
50,8482067,Connor Mackey,D,NYR,28,69,6,22,28
50,8479983,Mario Ferraro,D,SJS,26,72,4,24,28
50,8481524,Bowen Byram,D,BUF,23,67,3,25,28
50,8482055,Drew O'Connor,L,PIT,26,71,20,7,27
50,8481535,Nils Hoglander,L,VAN,24,64,18,9,27
50,8474715,Cameron Atkinson,R,TBL,35,81,16,11,27
50,8479315,Joey Anderson,R,CHI,26,56,13,14,27
50,8476981,Josh Anderson,R,MTL,30,69,12,15,27
50,8480802,Ryan McLeod,C,BUF,25,62,11,16,27
50,8482142,Jamie Drysdale,D,PHI,22,57,8,19,27
50,8476457,Adam Larsson,D,SEA,32,72,5,22,27
50,8478500,Ivan Provorov,D,CBJ,27,80,2,25,27
50,8478507,John Marino,D,UTA,27,70,0,27,27
50,8482074,Connor Zary,C,CGY,23,69,14,12,26
50,8483499,Liam Ohgren,L,MIN,20,61,14,12,26
50,8482705,Cole Sillinger,C,CBJ,21,66,13,13,26
50,8480835,Jack Drury,C,CAR,24,66,13,13,26
50,8479316,Luke Kunin,C,SJS,27,56,13,13,26
50,8476897,Oskar Sundqvist,C,STL,30,57,12,14,26
50,8480855,Jack McBain,C,UTA,24,68,12,14,26
50,8480003,Jesper Boqvist,C,FLA,26,67,11,15,26
50,8480459,Pius Suter,C,VAN,28,61,10,16,26
50,8475763,Kevin Hayes,R,PIT,32,66,10,16,26
50,8482475,Yegor Chinakhov,R,CBJ,23,65,8,18,26
50,8477488,Brett Pesce,D,NJD,30,75,8,18,26
50,8480144,David Kampf,C,TOR,29,68,8,18,26
50,8475791,Taylor Hall,L,CHI,33,61,7,19,26
50,8475790,Erik Gudbranson,D,CBJ,32,75,5,21,26
50,8474151,Ryan McDonagh,D,TBL,35,80,3,23,26
50,8477969,Marcus Pettersson,D,PIT,28,78,3,23,26
50,8476331,Dylan DeMelo,D,WPG,31,69,2,24,26
50,8479639,Dylan Coghlan,D,WPG,26,69,2,24,26
50,8481014,Alexander Romanov,D,NYI,24,75,1,25,26
50,8476278,Colin Blackwell,C,DAL,31,80,15,10,25
50,8481032,Paul Cotter,C,NJD,25,57,12,13,25
50,8482749,Joshua Roy,R,MTL,21,67,11,14,25
50,8480074,Alexandre Texier,C,STL,25,58,11,14,25
50,8479351,Sam Steel,C,DAL,26,81,8,17,25
50,8482101,Danil Gushchin,L,SJS,22,61,8,17,25
50,8477506,Ryan Pulock,D,NYI,30,80,8,17,25
50,8482105,Jake Sanderson,D,OTT,22,73,5,20,25
50,8476885,Jacob Trouba,D,NYR,30,67,5,20,25
50,8480873,Rasmus Sandin,D,WSH,24,71,4,21,25
50,8480043,Timothy Liljegren,D,TOR,25,69,3,22,25
50,8482157,Will Cuylle,L,NYR,22,59,15,9,24
50,8480813,Joe Veleno,C,DET,24,77,14,10,24
50,8482089,Jake Neighbours,L,STL,22,58,13,11,24
50,8477839,Conor Sheary,L,TBL,32,80,11,13,24
50,8477446,Michael McCarron,R,NSH,29,56,11,13,24
50,8475149,Marcus Johansson,L,MIN,34,64,7,17,24
50,8470600,Ryan Suter,D,STL,39,61,7,17,24
50,8477507,Nikita Zadorov,D,BOS,29,74,6,18,24
50,8475193,Tomas Tatar,L,NJD,34,68,5,19,24
50,8480073,Erik Brannstrom,D,COL,25,62,4,20,24
50,8479982,Conor Timmins,D,TOR,26,53,4,20,24
50,8477435,Ryan Graves,D,PIT,29,77,3,21,24
50,8473507,Jeff Petry,D,DET,37,74,2,22,24
50,8480078,Filip Chytil,C,NYR,25,65,11,12,23
50,8477987,Ryan Donato,C,CHI,28,55,11,12,23
50,8479368,Max Jones,L,BOS,26,65,10,13,23
50,8482259,Bobby McMann,C,TOR,28,63,10,13,23
50,8478432,Christian Fischer,R,DET,27,70,10,13,23
50,8476878,Zemgus Girgensons,C,TBL,30,81,9,14,23
50,8484203,Bradly Nadeau,L,CAR,19,63,9,14,23
50,8482809,Jackson Blake,R,CAR,21,60,9,14,23
50,8480806,Isac Lundestrom,C,ANA,25,55,9,14,23
50,8483482,Tristan Luneau,D,ANA,20,65,8,15,23
50,8473563,Nicklas Backstrom,C,WSH,37,51,7,16,23
50,8475855,Jesper Fast,R,CAR,33,65,7,16,23
50,8483468,Jiri Kulich,C,BUF,20,57,6,17,23
50,8476891,Matthew Grzelcyk,D,PIT,30,70,6,17,23
50,8475225,Craig Smith,C,CHI,35,51,13,9,22
50,8481477,Nico Sturm,C,SJS,29,50,13,9,22
50,8479393,Noah Gregor,L,OTT,26,79,12,10,22
50,8476469,Joel Armia,R,MTL,31,65,11,11,22
50,8481481,Blake Lizotte,C,PIT,27,59,11,11,22
50,8480220,Noah Cates,L,PHI,25,62,9,13,22
50,8480789,Oliver Wahlstrom,R,NYI,24,72,9,13,22
50,8477425,Miles Wood,L,COL,29,75,8,14,22
50,8483457,Lane Hutson,D,MTL,20,68,8,14,22
50,8475171,Oliver Ekman-Larsson,D,TOR,33,63,6,16,22
50,8483565,Nick Blankenburg,D,NSH,26,63,6,16,22
50,8481527,Kaedan Korczak,D,VGK,23,52,6,16,22
50,8478413,Jordan Greenway,L,BUF,27,58,5,17,22
50,8481553,Bobby Brink,R,PHI,23,58,5,17,22
50,8475181,Nick Leddy,D,STL,33,72,4,18,22
50,8474574,Tyler Myers,D,VAN,34,67,3,19,22
50,8474673,TJ Brodie,D,CHI,34,56,3,19,22
50,8479976,Juuso Valimaki,D,UTA,26,68,2,20,22
50,8482655,Janis Moser,D,TBL,24,79,2,20,22
50,8477220,Nate Schmidt,D,FLA,33,63,1,21,22
50,8478136,Jake Middleton,D,MIN,28,79,1,21,22
50,8482737,Zack Bolduc,C,STL,21,61,13,8,21
50,8479336,Carl Grundstrom,R,SJS,27,55,12,9,21
50,8482148,Hendrix Lapierre,C,WSH,22,53,12,9,21
50,8480205,Emil Bemstrom,C,PIT,25,62,11,10,21
50,8476960,Andreas Athanasiou,C,CHI,30,53,9,12,21
50,8476921,Jordan Martinook,L,CAR,32,71,8,13,21
50,8479293,Brandon Tanev,L,SEA,33,55,7,14,21
50,8478882,Vladislav Gavrikov,D,LAK,29,68,6,15,21
50,8477952,Robby Fabbri,C,ANA,28,67,5,16,21
50,8481178,Egor Zamula,D,PHI,24,63,4,17,21
50,8482245,Artem Zub,D,OTT,29,69,4,17,21
50,8480878,Nils Lundkvist,D,DAL,24,67,3,18,21
50,8478416,Erik Cernak,D,TBL,27,75,3,18,21
50,8478840,Will Borgen,D,SEA,28,65,1,20,21
50,8476429,Scott Mayfield,D,NYI,32,77,1,20,21
50,8480995,Pontus Holmberg,R,TOR,25,62,13,7,20
50,8477353,Tyler Motte,C,DET,29,75,9,11,20
50,8476889,Radek Faksa,C,STL,30,56,9,11,20
50,8476312,Josh Manson,D,COL,33,64,9,11,20
50,8480355,Mark Kastelic,C,BOS,25,63,7,13,20
50,8477498,Darnell Nurse,D,EDM,29,70,6,14,20
50,8479996,Cody Glass,C,NSH,25,58,6,14,20
50,8476624,Barclay Goodrow,C,SJS,31,52,5,15,20
50,8478133,Jake Evans,C,MTL,28,62,4,16,20
50,8475455,Brenden Dillon,D,NJD,34,57,3,17,20
50,8480035,Henri Jokiharju,D,BUF,25,60,2,18,20
50,8484149,Gavin Brindley,C,CBJ,20,50,9,10,19
50,8483491,Ivan Miroshnichenko,L,WSH,20,56,9,10,19
50,8477903,Garnet Hathaway,R,PHI,33,68,8,11,19
50,8481093,Rafael Harvey-Pinard,L,MTL,25,64,8,11,19
50,8480025,MacKenzie Entwistle,R,FLA,25,62,8,11,19
50,8476329,Travis Boyd,C,MIN,31,60,6,13,19
50,8481537,Nikita Okhotiuk,D,CGY,24,52,6,13,19
50,8480796,Martin Fehervary,D,WSH,25,58,5,14,19
50,8476988,Matt Benning,D,SJS,30,68,4,15,19
50,8482073,Braden Schneider,D,NYR,23,63,4,15,19
50,8476967,Brett Kulak,D,EDM,30,65,4,15,19
50,8476873,Mark Jankowski,C,NSH,30,45,3,16,19
50,8478508,Yakov Trenin,C,MIN,27,57,11,7,18
50,8480289,Morgan Barron,C,WPG,26,55,9,9,18
50,8477406,Mattias Janmark,C,EDM,32,64,8,10,18
50,8478970,Jalen Chatfield,D,CAR,28,68,8,10,18
50,8479328,Julien Gauthier,R,NYI,27,61,8,10,18
50,8477979,Nicolas Aube-Kubel,R,BUF,28,54,8,10,18
50,8478211,Dryden Hunt,L,CGY,29,59,7,11,18
50,8480762,Eric Robinson,L,CAR,29,62,6,12,18
50,8482451,Mikael Pyyhtia,L,CBJ,23,46,5,13,18
50,8484254,Akito Hirose,D,VAN,25,50,4,14,18
50,8479980,Nicolas Hague,D,VGK,26,54,3,15,18
50,8479370,Tyson Jost,C,CAR,26,58,3,15,18
50,8483460,David Jiricek,D,CBJ,21,58,3,15,18
50,8478452,Caleb Jones,D,LAK,27,57,2,16,18
50,8476879,Cody Ceci,D,EDM,31,70,1,17,18
50,8478421,A.J. Greer,L,FLA,28,53,11,6,17
50,8481601,Simon Holmstrom,R,NYI,23,64,10,7,17
50,8476934,Brock McGinn,L,ANA,30,51,10,7,17
50,8479619,Michael Carcone,L,UTA,28,61,9,8,17
50,8482111,Justin Barron,D,MTL,23,64,9,8,17
50,8477931,Tomas Nosek,L,FLA,32,61,9,8,17
50,8480011,Klim Kostin,C,SJS,25,49,9,8,17
50,8480849,Barrett Hayton,C,UTA,24,69,8,9,17
50,8479359,Beck Malenstyn,L,BUF,26,47,8,9,17
50,8474189,Lars Eller,C,PIT,35,63,7,10,17
50,8482803,Olen Zellweger,D,ANA,21,66,6,11,17
50,8480448,Parker Kelly,L,COL,25,71,6,11,17
50,8475343,Nic Dowd,C,WSH,34,57,5,12,17
50,8481019,David Gustafsson,C,WPG,24,48,5,12,17
50,8475179,Dmitry Kulikov,D,FLA,34,60,5,12,17
50,8476525,Colin Miller,D,WPG,32,61,4,13,17
50,8476931,Jake McCabe,D,TOR,31,70,3,14,17
50,8475208,Brian Dumoulin,D,ANA,33,60,2,15,17
50,8474166,Alec Martinez,D,CHI,37,49,2,15,17
50,8480807,Mattias Samuelsson,D,BUF,24,54,1,16,17
50,8477845,Trevor van Riemsdyk,D,WSH,33,52,1,16,17
50,8475690,Chris Tanev,D,TOR,35,64,0,17,17
50,8481716,Dmitri Voronkov,L,CBJ,24,43,13,3,16
50,8478831,Kevin Stenlund,C,UTA,28,56,11,5,16
50,8478043,Sam Lafferty,C,BUF,29,66,10,6,16
50,8474034,Patrick Maroon,L,CHI,36,50,7,9,16
50,8482744,James Malatesta,L,CBJ,21,42,7,9,16
50,8478585,Derek Ryan,C,EDM,38,62,6,10,16
50,8480157,Calle Rosen,D,COL,30,46,4,12,16
50,8476856,Mathew Dumba,D,DAL,30,65,3,13,16
50,8481568,Alex Vlasic,D,CHI,23,63,3,13,16
50,8480222,Sebastian Aho,D,PIT,28,74,1,15,16
50,8478451,Ethan Bear,D,WSH,27,50,1,15,16
50,8477478,William Carrier,L,CAR,30,52,11,4,15
50,8479941,Justin Danforth,R,CBJ,31,49,11,4,15
50,8479520,Brandon Duhaime,R,WSH,27,49,10,5,15
50,8479439,Jacob MacDonald,D,COL,31,51,9,6,15
50,8480980,Connor Dewar,C,TOR,25,70,8,7,15
50,8481028,Martin Pospisil,C,CGY,25,51,8,7,15
50,8475231,Casey Cizikas,C,NYI,33,69,7,8,15
50,8482679,Matt Coronato,R,CGY,22,62,7,8,15
50,8482762,Simon Edvinsson,D,DET,21,60,7,8,15
50,8478434,Keegan Kolesar,R,VGK,27,68,6,9,15
50,8474567,Zach Bogosian,D,MIN,34,59,6,9,15
50,8475842,Sam Carrick,C,NYR,32,61,5,10,15
50,8482095,Tyler Kleven,D,OTT,22,43,5,10,15
50,8476467,Jamie Oleksiak,D,SEA,32,67,4,11,15
50,8479671,Mathieu Olivier,R,CBJ,27,52,4,11,15
50,8475462,Radko Gudas,D,ANA,34,64,3,12,15
50,8481522,Peyton Krebs,C,BUF,23,63,3,12,15
50,8483445,Cutter Gauthier,L,ANA,20,58,3,12,15
50,8480172,Jan Rutta,D,SJS,34,62,3,12,15
50,8481059,Scott Perunovich,D,STL,26,58,2,13,15
50,8480049,Dylan Samberg,D,WPG,25,61,1,14,15
50,8475233,David Savard,D,MTL,34,69,1,14,15
50,8482155,Alex Laferriere,R,LAK,23,64,10,4,14
50,8477380,Jonny Brodzinski,C,NYR,31,56,10,4,14
50,8479536,Axel Jonsson-Fjallby,L,WPG,26,39,9,5,14
50,8480252,Cole Guttman,C,CHI,25,37,8,6,14
50,8482062,Cole Smith,L,NSH,29,57,6,8,14
50,8480281,Alexey Toropchenko,R,STL,25,52,6,8,14
50,8482859,Zack Ostapchuk,C,OTT,21,51,5,9,14
50,8482192,Isaak Phillips,D,CHI,23,56,4,10,14
50,8482087,Kaiden Guhle,D,MTL,22,68,3,11,14
50,8479348,Kale Clague,D,BUF,26,37,3,11,14
50,8483619,Filip Roos,D,OTT,25,37,3,11,14
50,8475188,Brayden McNabb,D,VGK,33,56,2,12,14
50,8480727,Zach Whitecloud,D,VGK,28,54,2,12,14
50,8480001,Urho Vaakanainen,D,ANA,25,63,2,12,14
50,8479324,Ryan Lindgren,D,NYR,26,65,0,14,14
50,8481518,Nolan Foote,L,NJD,24,44,8,5,13
50,8481517,Brett Leason,R,ANA,25,54,7,6,13
50,8476374,Sean Kuraly,C,CBJ,31,57,6,7,13
50,8479066,Ryan Lomberg,L,CGY,30,67,6,7,13
50,8475279,Ben Chiarot,D,DET,33,66,5,8,13
50,8476822,Luke Glendening,C,TBL,35,75,5,8,13
50,8477392,Hudson Fasching,R,NYI,29,68,4,9,13
50,8482176,Wyatt Kaiser,D,CHI,22,53,4,9,13
50,8477015,Connor Brown,R,EDM,30,62,4,9,13
50,8482634,Alex Steeves,C,TOR,25,52,4,9,13
50,8481617,Vasily Podkolzin,R,VAN,23,47,4,9,13
50,8479998,Mikey Anderson,D,LAK,25,65,4,9,13
50,8473446,Erik Johnson,D,PHI,36,51,4,9,13
50,8481167,Brayden Pachal,D,CGY,25,45,3,10,13
50,8479026,Philippe Myers,D,TOR,27,57,3,10,13
50,8482807,Ethan Del Mastro,D,CHI,21,46,3,10,13
50,8477508,Curtis Lazar,C,NJD,29,55,2,11,13
50,8476874,Olli Maatta,D,DET,30,59,2,11,13
50,8481013,Jonatan Berggren,R,DET,24,67,2,11,13
50,8480860,Kevin Bahl,D,CGY,24,53,2,11,13
50,8478851,Alexandre Carrier,D,NSH,28,65,1,12,13
50,8473453,Trevor Lewis,C,LAK,37,73,10,2,12
50,8476858,Phillip Di Giuseppe,L,VAN,31,38,10,2,12
50,8482077,Dylan Holloway,L,EDM,23,55,7,5,12
50,8479291,Kevin Rooney,C,CGY,31,44,6,6,12
50,8478569,Noel Acciari,C,PIT,33,49,5,7,12
50,8476867,Brendan Gaunce,C,MIN,30,42,5,7,12
50,8477070,Liam O'Brien,C,UTA,30,54,5,7,12
50,8475220,Marcus Foligno,L,MIN,33,56,4,8,12
50,8482730,Brandt Clarke,D,LAK,21,47,4,8,12
50,8479718,Alex Barré-Boulet,C,MTL,27,46,4,8,12
50,8477887,Patrick Brown,C,BOS,32,47,4,8,12
50,8478017,Mark Friedman,D,VAN,29,41,4,8,12
50,8471817,Ryan Reaves,R,TOR,37,47,4,8,12
50,8475324,Nick Jensen,D,OTT,34,67,3,9,12
50,8477365,Connor Clifton,D,BUF,29,57,3,9,12
50,8480192,Johnathan Kovacevic,D,NJD,27,52,3,9,12
50,8479442,Troy Stecher,D,EDM,30,55,3,9,12
50,8480441,Trey Fix-Wolansky,R,CBJ,25,40,3,9,12
50,8476994,Vinnie Hinostroza,C,NSH,30,50,2,10,12
50,8483495,Simon Nemec,D,NJD,20,54,2,10,12
50,8475750,Jon Merrill,D,MIN,32,61,2,10,12
50,8471677,Jack Johnson,D,CBJ,37,65,1,11,12
50,8478859,Niko Mikkola,D,FLA,28,67,1,11,12
50,8477450,Jason Dickinson,C,CHI,29,61,7,4,11
50,8479944,Zach Aston-Reese,C,VGK,30,44,6,5,11
50,8481641,Joel Kiviranta,L,COL,28,69,6,5,11
50,8477482,Zachary Sanford,L,CHI,30,37,6,5,11
50,8481147,Reese Johnson,C,MIN,26,32,6,5,11
50,8481161,Jake Christiansen,D,CBJ,25,54,5,6,11
50,8475958,Michael Sgarbossa,C,WSH,32,28,4,7,11
50,8478178,Darren Raddysh,D,TBL,28,67,3,8,11
50,8480021,Jack Studnicka,C,LAK,25,56,3,8,11
50,8477384,Joshua Brown,D,EDM,30,43,3,8,11
50,8482166,Shakir Mukhamadullin,D,SJS,22,61,3,8,11
50,8478399,Jonas Siegenthaler,D,NJD,27,57,2,9,11
50,8479986,Kole Lind,R,DAL,26,48,2,9,11
50,8476372,Nick Seeler,D,PHI,31,42,2,9,11
50,8481056,Spencer Stastney,D,NSH,24,34,2,9,11
50,8476952,Dominic Toninato,C,WPG,30,41,1,10,11
50,8480950,Ilya Lyubushkin,D,DAL,30,67,0,11,11
50,8477034,Jaycob Megna,D,FLA,32,41,0,11,11
50,8477573,Nathan Walker,L,STL,30,48,7,3,10
50,8479638,Justin Brazeau,R,BOS,26,33,6,4,10
50,8479981,Jonah Gadjovich,L,FLA,26,46,6,4,10
50,8479369,Andrew Peeke,D,BOS,26,54,5,5,10
50,8477018,Ben Hutton,D,VGK,31,45,5,5,10
50,8476913,Devin Shore,C,MIN,30,38,5,5,10
50,8474568,Luke Schenn,D,NSH,35,52,4,6,10
50,8476918,Jimmy Vesey,L,NYR,31,65,4,6,10
50,8480891,Michael Kesselring,D,UTA,24,52,2,8,10
50,8479543,Michael Pezzetta,L,MTL,26,53,2,8,10
50,8478443,Brandon Carlo,D,BOS,28,61,2,8,10
50,8479372,Joshua Mahura,D,SEA,26,48,2,8,10
50,8474013,Ian Cole,D,UTA,35,47,2,8,10
50,8481592,Jakob Pelletier,L,CGY,23,38,2,8,10
50,8480246,Nick Perbix,D,TBL,26,69,1,9,10
50,8480058,Pierre-Olivier Joseph,D,STL,25,55,1,9,10
50,8479249,Andrew Poturalski,C,SJS,30,40,1,9,10
50,8471709,Marc-Edouard Vlasic,D,SJS,37,57,1,9,10
50,8482652,Walker Duehr,R,CGY,27,40,7,2,9
50,8480245,Olle Lycksell,R,PHI,25,34,7,2,9
50,8479344,Jesse Puljujarvi,R,PIT,26,50,5,4,9
50,8476442,Matt Nieto,L,PIT,32,58,5,4,9
50,8480007,Jonas Rondbjerg,R,VGK,25,39,5,4,9
50,8480848,Ty Dellandrea,C,SJS,24,38,4,5,9
50,8479994,Jaret Anderson-Dolan,C,WPG,25,37,4,5,9
50,8482153,Brendan Brisson,C,VGK,23,29,4,5,9
50,8484911,Collin Graf,R,SJS,22,47,4,5,9
50,8482964,Arber Xhekaj,D,MTL,23,45,3,6,9
50,8481567,Henry Thrun,D,SJS,23,51,3,6,9
50,8480990,Declan Chisholm,D,MIN,24,33,3,6,9
50,8483493,Frank Nazar,C,CHI,20,53,2,7,9
50,8475718,Justin Holl,D,DET,32,62,2,7,9
50,8477938,Haydn Fleury,D,WPG,28,46,2,7,9
50,8480196,Jacob Bryson,D,BUF,27,41,1,8,9
50,8480070,Ian Mitchell,D,BOS,25,37,1,8,9
50,8481708,Zac Jones,D,NYR,24,43,1,8,9
50,8481122,Simon Benoit,D,TOR,26,35,0,9,9
50,8482659,Josh Doan,R,UTA,22,50,5,3,8
50,8481550,Adam Beckman,L,NJD,23,40,5,3,8
50,8475177,Calvin de Haan,D,COL,33,30,5,3,8
50,8482784,Zach Dean,C,STL,21,49,5,3,8
50,8481556,John Beecher,C,BOS,23,37,4,4,8
50,8481532,Alex Turcotte,C,LAK,23,44,4,4,8
50,8482511,Mason Lohrei,D,BOS,23,33,4,4,8
50,8477369,Carson Soucy,D,VAN,30,63,3,5,8
50,8483466,Kevin Korchinski,D,CHI,20,50,3,5,8
50,8477499,Rasmus Ristolainen,D,PHI,30,59,3,5,8
50,8479772,Zack MacEwen,R,OTT,28,50,3,5,8
50,8476473,Connor Murphy,D,CHI,31,38,3,5,8
50,8477851,Jordan Oesterle,D,BOS,32,44,3,5,8
50,8478424,Jansen Harkins,C,ANA,27,42,3,5,8
50,8475795,Dylan McIlrath,D,WSH,32,18,3,5,8
50,8474090,Brendan Smith,D,DAL,35,56,2,6,8
50,8483549,Lucas Condotta,L,MTL,27,33,2,6,8
50,8478874,Adam Gaudette,R,OTT,28,30,2,6,8
50,8480887,Jordan Harris,D,MTL,24,49,1,7,8
50,8482861,Vincent Iorio,D,WSH,22,30,1,7,8
50,8480292,Carson Meyer,R,ANA,27,31,1,7,8
50,8476441,Joel Edmundson,D,LAK,31,38,0,8,8
50,8478450,Parker Wotherspoon,D,BOS,27,38,0,8,8
50,8477401,John Hayden,C,SEA,29,33,5,2,7
50,8481754,Nikita Nesterenko,C,ANA,23,31,5,2,7
50,8481743,Marc Del Gaizo,D,NSH,25,26,5,2,7
50,8482733,Logan Mailloux,D,MTL,31,39,4,3,7
50,8482070,Mitchell Chaffee,R,TBL,26,50,4,3,7
50,8475762,Derek Forbort,D,VAN,32,39,3,4,7
50,8479968,Vinni Lettieri,C,BOS,29,39,3,4,7
50,8478468,Jeremy Lauzon,D,NSH,27,50,2,5,7
50,8481609,Vladislav Kolyachonok,D,UTA,23,35,2,5,7
50,8480845,Rasmus Kupari,C,WPG,24,36,2,5,7
50,8483763,Maksymilian Szuber,D,UTA,22,22,2,5,7
50,8477462,Robert Hagg,D,VGK,29,21,2,5,7
50,8474612,Travis Hamonic,D,OTT,34,49,2,5,7
50,8478454,Noah Juulsen,D,VAN,27,36,1,6,7
50,8479378,Logan Stanley,D,WPG,26,46,1,6,7
50,8483012,Logan Morrison,C,SEA,22,30,5,1,6
50,8481789,Tye Kartye,L,SEA,23,37,4,2,6
50,8482141,Lukas Cormier,D,VGK,22,24,3,3,6
50,8479367,William Lockwood,R,FLA,26,33,3,3,6
50,8482470,Ilya Solovyov,D,CGY,24,17,3,3,6
50,8482145,Mavrik Bourque,C,DAL,22,47,2,4,6
50,8477073,Kurtis MacDermid,L,NJD,30,30,2,4,6
50,8477962,Brendan Lemieux,L,CAR,28,28,2,4,6
50,8480880,Jakub Lauko,C,MIN,24,34,2,4,6
50,8479985,Cale Fleury,D,SEA,26,29,1,5,6
50,8480879,Jacob Bernard-Docker,D,OTT,24,47,0,6,6
50,8481701,Santeri Hatakka,D,NJD,23,38,4,1,5
50,8481541,Samuel Bolduc,D,NYI,24,27,3,2,5
50,8481598,Philip Broberg,D,EDM,23,42,2,3,5
50,8479320,Maxime Lajoie,D,SEA,27,23,2,3,5
50,8481679,Maxence Guenette,D,OTT,23,30,1,4,5
50,8482666,Scott Morrow,D,CAR,22,46,1,4,5
50,8478146,Matthew Highmore,C,OTT,28,36,1,4,5
50,8482858,Ryker Evans,D,SEA,23,26,1,4,5
50,8477244,Chad Ruhwedel,D,NYR,34,37,1,4,5
50,8479991,Jake Leschyshyn,C,NYR,25,21,1,4,5
50,8481599,Victor Soderstrom,D,UTA,23,50,0,5,5
50,8478021,William Lagesson,D,DET,28,22,0,5,5
50,8481543,Nikita Alexandrov,C,STL,24,27,3,1,4
50,8483570,Ben Meyers,C,SEA,26,25,3,1,4
50,8483397,Marc McLaughlin,C,BOS,25,33,3,1,4
50,8480834,Ty Emberson,D,SJS,24,29,3,1,4
50,8482144,Jack Thompson,D,SJS,22,24,3,1,4
50,8484258,Sam Malinski,D,COL,26,28,3,1,4
50,8481043,Cole Koepke,L,BOS,26,18,3,1,4
50,8482172,Landon Slaggert,L,CHI,22,19,3,1,4
50,8480870,Bo Groulx,C,NYR,24,28,2,2,4
50,8477467,Gustav Olofsson,D,SEA,30,18,2,2,4
50,8479587,Rhett Gardner,C,PHI,28,22,2,2,4
50,8477971,Andreas Englund,D,LAK,28,31,1,3,4
50,8475235,Nicolas Deslauriers,L,PHI,33,43,1,3,4
50,8482496,Nils Aman,C,VAN,24,30,1,3,4
50,8479379,Givani Smith,R,SJS,26,25,1,3,4
50,8477335,Kyle Burroughs,D,LAK,29,41,1,3,4
50,8481605,Jackson LaCombe,D,ANA,23,28,1,3,4
50,8481593,Jayden Struble,D,MTL,23,21,1,3,4
50,8482165,Yan Kuznetsov,D,CGY,22,20,1,3,4
50,8477810,Joel Hanley,D,CGY,33,23,1,3,4
50,8482929,Emil Lilleberg,D,TBL,23,21,0,4,4
50,8482250,Callahan Burke,C,VGK,27,20,0,4,4
50,8477473,Justin Bailey,R,SJS,29,24,0,4,4
50,8480823,Alexander Alexeyev,D,WSH,25,17,3,0,3
50,8479362,Riley Tufte,L,BOS,26,17,3,0,3
50,8477320,Anton Blidh,L,NYR,29,22,3,0,3
50,8481600,Tobias Bjornfot,D,FLA,23,37,2,1,3
50,8480844,Grigori Denisenko,L,VGK,24,27,2,1,3
50,8481422,Jake Lucchini,C,NSH,29,20,2,1,3
50,8483630,Pavol Regenda,L,ANA,25,27,2,1,3
50,8482177,Marat Khusnutdinov,C,MIN,22,32,2,1,3
50,8482747,Brennan Othmann,L,NYR,21,36,2,1,3
50,8484325,Waltteri Merela,C,TBL,26,30,2,1,3
50,8480267,Sammy Walker,C,MIN,25,16,2,1,3
50,8478502,Dennis Gilbert,D,BUF,28,17,2,1,3
50,8482751,Ryan Winterton,C,SEA,21,34,1,2,3
50,8477149,Scott Sabourin,R,SJS,32,10,1,2,3
50,8477527,Ross Johnston,L,ANA,30,33,1,2,3
50,8481237,Kyle MacLean,C,NYI,25,31,1,2,3
50,8474062,Riley Nash,C,NYR,35,12,1,2,3
50,8481462,Mason Morelli,L,VGK,28,17,1,2,3
50,8481751,Lukas Rousek,R,BUF,25,39,0,3,3
50,8483489,Fraser Minten,C,TOR,31,15,0,3,3
50,8479972,Mason Shaw,C,WPG,26,27,1,1,2
50,8482765,Isak Rosen,R,BUF,21,29,1,1,2
50,8480890,Jan Jenik,C,OTT,24,28,1,1,2
50,8482102,Vasily Ponomarev,C,PIT,22,14,1,1,2
50,8481585,Egor Afanasyev,L,SJS,23,16,1,1,2
50,8482118,Sam Colangelo,R,ANA,23,20,1,1,2
50,8478881,Brett Seney,L,CHI,28,11,1,1,2
50,8478446,Glenn Gawdin,C,LAK,27,14,1,1,2
50,8483395,Arshdeep Bains,L,VAN,23,12,1,1,2
50,8475780,Chris Wagner,R,COL,33,9,1,1,2
50,8482126,Emil Andrae,D,PHI,31,2,1,1,2
50,8478409,Anthony Richard,C,PHI,28,32,0,2,2
50,8482094,Daemon Hunt,D,MIN,22,21,0,2,2
50,8483512,Matthew Savoie,C,EDM,20,18,0,2,2
50,8481564,Ryan Johnson,D,BUF,23,14,0,2,2
50,8481578,Graeme Clarke,R,MIN,23,5,0,2,2
50,8478477,Mitchell Stephens,C,SEA,27,27,0,2,2
50,8484287,Cole McWard,D,VAN,23,16,1,0,1
50,8478051,Max Willman,C,NJD,29,19,1,0,1
50,8482147,Jean-Luc Foudy,C,COL,22,22,1,0,1
50,8481806,Louis Crevier,D,CHI,23,10,1,0,1
50,8481065,Angus Crookshank,L,OTT,25,13,1,0,1
50,8480306,Grant Hutton,D,NYI,29,3,1,0,1
50,8481024,Linus Karlsson,C,VAN,25,11,1,0,1
50,8477541,Dakota Mermis,D,TOR,30,5,1,0,1
50,8482713,Mackie Samoskevich,R,FLA,22,34,0,1,1
50,8479576,Vincent Desharnais,D,VAN,28,30,0,1,1
50,8479419,Brett Murray,L,BUF,26,23,0,1,1
50,8481206,John Ludvig,D,PIT,24,7,0,1,1
50,8482162,Roby Jarventie,L,EDM,22,14,0,1,1
50,8483567,Georgii Merkulov,C,BOS,24,13,0,1,1
50,8480874,Adam Ginning,D,PHI,24,11,0,1,1
50,8481699,Aku Raty,R,UTA,23,13,0,1,1
50,8481719,Maxwell Crozier,D,TBL,24,16,0,1,1
50,8481030,Jack St. Ivany,D,PIT,25,16,0,1,1
50,8482516,Matthew Kessel,D,STL,24,11,0,1,1
50,8481006,Tyler Tucker,D,STL,24,21,0,1,1
50,8482061,Brandon Biro,L,SEA,26,12,0,1,1
50,8483531,Brian Halonen,L,NJD,25,1,0,1,1
50,8482197,Adam Raska,R,MIN,23,9,0,1,1
50,8483432,Luca Del Bel Belluz,C,CBJ,31,8,0,1,1
50,8484326,Patrik Koch,D,UTA,28,2,0,1,1
50,8483398,Declan Carlile,D,TBL,31,5,0,1,1
50,8478011,Louie Belpedio,D,PHI,28,11,0,0,0
50,8480084,Nick DeSimone,D,NJD,30,15,0,0,0
50,8483597,Milos Kelemen,L,UTA,25,11,0,0,0
50,8480032,Shane Bowers,C,NJD,25,13,0,0,0
50,8480468,James Hamblin,L,EDM,25,16,0,0,0
50,8480851,Akil Thomas,C,LAK,24,21,0,0,0
50,8475755,Alexander Petrovic,D,DAL,32,9,0,0,0
50,8478854,Ryan Shea,D,PIT,27,7,0,0,0
50,8475413,Justin Dowling,C,NJD,34,9,0,0,0
50,8479330,Brandon Gignac,C,MTL,27,12,0,0,0
50,8484255,Jason Polin,R,COL,25,6,0,0,0
50,8482088,Justin Sourdif,R,FLA,22,9,0,0,0
50,8484304,Uvis Balinskis,D,FLA,28,10,0,0,0
50,8482476,Emil Heineman,L,MTL,23,5,0,0,0
50,8482201,Gage Goncalves,C,TBL,23,15,0,0,0
50,8481726,Adam Edstrom,C,NYR,24,10,0,0,0
50,8482787,Nikita Chibrikov,R,WPG,31,6,0,0,0
50,8483471,Brad Lambert,C,WPG,31,7,0,0,0
50,8483407,Brandon Scanlin,D,NYR,25,4,0,0,0
50,8481655,Cole Schwindt,R,CGY,23,4,0,0,0
50,8479522,Hardy Haman Aktell,D,WSH,26,1,0,0,0
50,8482460,Matt Rempe,C,NYR,22,13,0,0,0
50,8476323,Max McCormick,L,SEA,32,5,0,0,0
50,8483609,Adam Klapka,R,CGY,24,3,0,0,0
50,8480075,Cameron Crotty,D,MIN,25,10,0,0,0
50,8478147,Bokondji Imama,L,PIT,28,2,0,0,0
50,8483546,Marshall Rifai,D,TOR,26,2,0,0,0
50,8479421,Jacob Moverare,D,LAK,26,7,0,0,0
50,8483401,Marc Johnstone,R,PIT,28,1,0,0,0
50,8483920,Pierrick Dube,R,WSH,23,4,0,0,0
50,8477993,Justin Kirkland,C,CGY,28,3,0,0,0
50,8484259,Ondrej Pavel,C,COL,31,1,0,0,0
50,8484321,Nikolas Matinpalo,D,OTT,26,2,0,0,0
50,8481534,Raphael Lavoie,C,EDM,24,1,0,0,0
50,8483045,Cameron Butler,R,CBJ,31,0,0,0,0
50,8478956,Samuel Laberge,L,NJD,27,0,0,0,0
50,8480274,Philip Kemp,D,EDM,25,1,0,0,0
50,8470794,Joe Pavelski,C,,40,0,0,0,0
50,8479321,Lucas Johansen,D,,27,0,0,0,0
50,8477950,Tony DeAngelo,D,,29,0,0,0,0
50,8471218,Blake Wheeler,R,,38,0,0,0,0
50,8475197,Tyson Barrie,D,,33,0,0,0,0
50,8474157,Max Pacioretty,L,,36,0,0,0,0
50,8475744,Evgeny Kuznetsov,C,,32,0,0,0,0
50,8474037,James van Riemsdyk,L,,35,0,0,0,0
50,8476907,Mackenzie MacEachern,L,,30,0,0,0,0
50,8480216,Jacob Peterson,C,,25,0,0,0,0
50,8474602,Justin Schultz,D,,34,0,0,0,0
50,8482222,Alexander Barabanov,L,,30,0,0,0,0
50,8474031,Kevin Shattenkirk,D,,35,0,0,0,0
50,8477330,Dominik Kubalik,L,,29,0,0,0,0
50,8480884,Calen Addison,D,,24,0,0,0,0
50,8475906,John Klingberg,D,,32,0,0,0,0
50,8480008,Adam Ruzicka,C,,25,0,0,0,0
50,8476884,Derrick Pouliot,D,,30,0,0,0,0
50,8476919,Chris Tierney,C,,30,0,0,0,0
50,8479415,Michael McLeod,C,,26,0,0,0,0
50,8474870,Tyler Johnson,C,,34,0,0,0,0
50,8470604,Jeff Carter,C,,39,0,0,0,0
50,8478104,Sammy Blais,L,,28,0,0,0,0
50,8474884,Mike Hoffman,C,,35,0,0,0,0
50,8481591,Sam Poulin,R,,23,0,0,0,0
50,8471274,Alex Goligoski,D,,39,0,0,0,0
50,8476871,Tanner Pearson,L,,32,0,0,0,0
50,8476393,Nick Cousins,C,,31,0,0,0,0
50,8479977,Kailer Yamamoto,R,,26,0,0,0,0
50,8479346,Dillon Dube,C,,26,0,0,0,0
50,8480184,Gustav Lindstrom,D,,26,0,0,0,0
50,8479376,Victor Mete,D,,26,0,0,0,0
50,8473449,Kyle Okposo,R,,36,0,0,0,0
50,8481058,Jesse Ylonen,R,,25,0,0,0,0
50,8475752,Tyler Pitlick,C,,33,0,0,0,0
50,8481239,Samuel Fagemo,L,,24,0,0,0,0
50,8480821,Filip Zadina,R,,25,0,0,0,0
50,8470966,Mark Giordano,D,,41,0,0,0,0
50,8478495,Denis Gurianov,R,,27,0,0,0,0
50,8477464,Nic Petan,C,,29,0,0,0,0
50,8478099,Kevin Labanc,R,,29,0,0,0,0
50,8482241,Radim Zohorna,L,,28,0,0,0,0
50,8474040,Sam Gagner,C,,35,0,0,0,0
50,8479514,Rem Pitlick,C,,27,0,0,0,0
50,8478430,Oliver Kylington,D,,27,0,0,0,0
50,8479533,Joona Koppanen,L,,26,0,0,0,0
50,8479984,Cal Foote,D,,26,0,0,0,0
50,8477126,Jayson Megna,C,,34,0,0,0,0
50,8475164,Jakob Silfverberg,R,,34,0,0,0,0
50,8474009,Nick Bonino,C,,36,0,0,0,0
50,8479458,Nikita Zaitsev,D,,33,0,0,0,0
50,8477944,Jakub Vrana,L,,28,0,0,0,0
50,8471699,Andrew Cogliano,C,,37,0,0,0,0
50,8478067,Oskar Lindblom,L,,28,0,0,0,0
50,8471686,Marc Staal,D,,37,0,0,0,0
50,8470610,Zach Parise,L,,40,0,0,0,0
50,8478904,Steven Lorentz,C,,28,0,0,0,0
50,8473473,Milan Lucic,L,,36,0,0,0,0
50,8480031,Maxime Comtois,L,,25,0,0,0,0
50,8478512,Austin Czarnik,C,,32,0,0,0,0
50,8473504,Cal Clutterbuck,R,,37,0,0,0,0
50,8477454,Adam Erne,L,,29,0,0,0,0
50,8479383,Boris Katchouk,L,,26,0,0,0,0
50,8475825,Jani Hakanpää,D,,32,0,0,0,0
50,8477846,Ryan Carpenter,C,,33,0,0,0,0
50,8477930,Pierre-Edouard Bellemare,L,,39,0,0,0,0
50,8478400,Colin White,C,,27,0,0,0,0
50,8480226,Marián Studenic,R,,26,0,0,0,0
50,8480853,Liam Foudy,C,,24,0,0,0,0
50,8475797,Jarred Tinordi,D,,32,0,0,0,0
50,8479423,Alex Nylander,L,,26,0,0,0,0
50,8474618,Marco Scandella,D,,34,0,0,0,0
50,8478028,Fredrik Olofsson,L,,28,0,0,0,0
50,8474709,Matt Martin,L,,35,0,0,0,0
50,8481070,Hugh McGing,L,,26,0,0,0,0
50,8479546,Oskar Steen,C,,26,0,0,0,0
50,8474145,Robert Bortuzzo,D,,35,0,0,0,0
50,8476915,Jujhar Khaira,L,,30,0,0,0,0
50,8475278,Byron Froese,C,,33,0,0,0,0
50,8481812,Nikolai Knyzhov,D,,27,0,0,0,0
50,8478408,Travis Dermott,D,,28,0,0,0,0
50,8481077,John Leonard,L,,26,0,0,0,0
50,8479547,Matthew Phillips,R,,26,0,0,0,0
50,8480836,Jonathan Gruden,C,,24,0,0,0,0
50,8481690,Tyler Angle,C,,24,0,0,0,0
50,8475766,Austin Watson,L,,32,0,0,0,0
50,8481016,Ruslan Iskhakov,C,,24,0,0,0,0
50,8478078,Rourke Chartier,C,,28,0,0,0,0
50,8480776,Sheldon Rempal,R,,29,0,0,0,0
50,8484314,Jiri Smejkal,L,,28,0,0,0,0
